flowDurationMilliseconds,protocolIdentifier,TotPackets,TotBytes,packetTotalCount,octetTotalCount,averageInterarrivalTime,maxPacketSize,bytesPerPacket,reversePacketTotalCount,reverseOctetTotalCount,reverseAverageInterarrivalTime,reverseMaxPacketSize,reverseBytesPerPacket
0.056,6,10,1506,5,395,13.0,127.0,127.0,5,1111,13.0,843.0,843.0
0.013,17,2,152,1,76,0.0,48.0,48.0,1,76,0.0,48.0,48.0
0.014,6,10,1989,5,910,3.0,642.0,642.0,5,1079,3.0,811.0,811.0
0.002,17,2,180,1,66,0.0,38.0,38.0,1,114,0.0,86.0,86.0
1787.497,6,150,19350,90,13740,20084.0,302.0,302.0,60,5610,30296.0,83.0,83.0
0.012,6,10,1989,5,910,3.0,642.0,642.0,5,1079,2.0,811.0,811.0
0.009,6,10,1989,5,910,2.0,642.0,642.0,5,1079,2.0,811.0,811.0
0.009,6,12,1926,6,1189,1.0,659.0,434.0,6,737,1.0,417.0,417.0
0.001,17,2,164,1,74,0.0,46.0,46.0,1,90,0.0,62.0,62.0
0.005,6,10,2007,5,928,1.0,660.0,660.0,5,1079,1.0,811.0,811.0
0.04,17,4,284,2,120,0.0,32.0,32.0,2,164,36.0,60.0,54.0
0.166,17,2,152,1,76,0.0,48.0,48.0,1,76,0.0,48.0,48.0
0.011,6,10,1983,5,910,2.0,642.0,642.0,5,1073,2.0,805.0,805.0
0.157,6,10,1506,5,395,37.0,127.0,127.0,5,1111,35.0,843.0,843.0
0.006,17,2,144,1,64,0.0,36.0,36.0,1,80,0.0,52.0,52.0
0.019,6,10,1989,5,910,4.0,642.0,642.0,5,1079,4.0,811.0,811.0
0.008,6,12,1926,6,1189,1.0,659.0,434.0,6,737,1.0,417.0,417.0
240.156,6,45,6845,21,3168,12007.0,588.0,229.0,24,3677,10441.0,580.0,220.0
0.157,6,10,1506,5,395,33.0,127.0,127.0,5,1111,39.0,843.0,843.0
0.147,6,10,1506,5,395,26.0,127.0,127.0,5,1111,33.0,843.0,843.0
0.013,6,10,1983,5,910,3.0,642.0,642.0,5,1073,3.0,805.0,805.0
0.014,6,10,1989,5,910,3.0,642.0,642.0,5,1079,3.0,811.0,811.0
0.006,6,10,1643,5,860,1.0,592.0,592.0,5,783,1.0,515.0,515.0
311.676,17,20,1124,10,716,34616.0,48.0,43.0,10,408,34616.0,20.0,12.0
0.006,6,10,1547,5,764,1.0,496.0,496.0,5,783,1.0,515.0,515.0
0.095,6,10,1506,5,395,20.0,127.0,127.0,5,1111,22.0,843.0,843.0
0.081,6,10,1506,5,395,17.0,127.0,127.0,5,1111,17.0,843.0,843.0
308.348,17,20,1124,10,716,34252.0,48.0,43.0,10,408,34254.0,20.0,12.0
0.005,17,2,164,1,74,0.0,46.0,46.0,1,90,0.0,62.0,62.0
0.097,6,10,1506,5,395,21.0,127.0,127.0,5,1111,23.0,843.0,843.0
335.552,17,20,1124,10,716,37269.0,48.0,43.0,10,408,37269.0,20.0,12.0
0.01,6,10,1990,5,911,2.0,643.0,643.0,5,1079,2.0,811.0,811.0
0.005,6,10,1547,5,764,1.0,496.0,496.0,5,783,1.0,515.0,515.0
0.082,6,10,1506,5,395,17.0,127.0,127.0,5,1111,19.0,843.0,843.0
0.175,6,10,1506,5,395,41.0,127.0,127.0,5,1111,40.0,843.0,843.0
0.016,6,10,1983,5,910,4.0,642.0,642.0,5,1073,4.0,805.0,805.0
0.013,6,10,1631,5,848,3.0,580.0,580.0,5,783,3.0,515.0,515.0
0.009,6,10,1983,5,910,2.0,642.0,642.0,5,1073,2.0,805.0,805.0
0.005,6,13,3747,7,509,0.0,137.0,137.0,6,3238,1.0,1470.0,1459.0
0.005,6,10,1702,5,863,1.0,595.0,595.0,5,839,1.0,571.0,571.0
240.099,6,33,10042,16,7686,16006.0,2744.0,760.0,17,2356,15006.0,580.0,162.0
0.007,6,10,1702,5,863,1.0,595.0,595.0,5,839,1.0,571.0,571.0
371.987,6,22,2313,16,867,24799.0,195.0,195.0,6,1446,4637.0,419.0,398.0
0.005,6,10,1774,5,923,1.0,655.0,655.0,5,851,1.0,583.0,583.0
0.004,6,10,1774,5,923,1.0,655.0,655.0,5,851,1.0,583.0,583.0
0.005,6,10,2006,5,927,1.0,659.0,659.0,5,1079,1.0,811.0,811.0
0.005,6,14,3742,7,452,0.0,80.0,80.0,7,3290,0.0,1448.0,972.0
0.129,6,10,1506,5,395,29.0,127.0,127.0,5,1111,28.0,843.0,843.0
40.059,17,10,676,5,460,10013.0,104.0,64.0,5,216,10013.0,20.0,15.0
0.004,6,10,1702,5,863,1.0,595.0,595.0,5,839,1.0,571.0,571.0
1726.218,6,61,7124,40,4332,44262.0,1625.0,112.0,21,2792,86302.0,1111.0,85.0
173.346,17,80,11308,40,2664,4444.0,44.0,38.0,40,8644,4444.0,261.0,188.0
0.008,6,10,1547,5,764,2.0,496.0,496.0,5,783,2.0,515.0,515.0
0.012,6,10,1631,5,848,3.0,580.0,580.0,5,783,3.0,515.0,515.0
10.793,17,28,4418,14,1994,821.0,269.0,114.0,14,2424,821.0,587.0,145.0
177.281,17,70,10101,35,2339,5214.0,44.0,38.0,35,7762,5214.0,239.0,193.0
0.043,17,2,152,1,76,0.0,48.0,48.0,1,76,0.0,48.0,48.0
0.009,6,10,1972,5,910,2.0,642.0,642.0,5,1062,2.0,794.0,794.0
0.005,6,10,2007,5,928,1.0,660.0,660.0,5,1079,1.0,811.0,811.0
300.021,6,12,1782,7,1348,50003.0,494.0,494.0,5,434,75004.0,83.0,83.0
0.078,6,10,1506,5,395,18.0,127.0,127.0,5,1111,18.0,843.0,843.0
0.04,17,4,284,2,120,0.0,32.0,32.0,2,164,36.0,60.0,54.0
280.254,6,22,6035,9,1146,35031.0,267.0,156.0,13,4889,23354.0,1400.0,873.0
0.105,6,10,1506,5,395,24.0,127.0,127.0,5,1111,20.0,843.0,843.0
0.035,17,2,180,1,66,0.0,38.0,38.0,1,114,0.0,86.0,86.0
9.057,17,6,376,5,280,2264.0,28.0,28.0,1,96,0.0,68.0,68.0
0.004,6,10,1774,5,923,1.0,655.0,655.0,5,851,1.0,583.0,583.0
0.006,6,12,1698,6,863,1.0,327.0,271.0,6,835,1.0,515.0,515.0
0.09,6,10,1506,5,395,21.0,127.0,127.0,5,1111,16.0,843.0,843.0
15.07,17,15,9238,8,6902,2148.0,1350.0,834.0,7,2336,2506.0,1350.0,305.0
0.012,6,10,1989,5,910,2.0,642.0,642.0,5,1079,3.0,811.0,811.0
0.072,17,4,284,2,120,0.0,32.0,32.0,2,164,68.0,60.0,54.0
368.889,6,22,2313,16,867,24592.0,195.0,195.0,6,1446,4637.0,419.0,398.0
176.283,17,92,13026,46,3069,3917.0,44.0,38.0,46,9957,3917.0,239.0,188.0
0.004,6,10,2006,5,927,1.0,659.0,659.0,5,1079,1.0,811.0,811.0
120.835,6,61,19254,35,4911,3553.0,1054.0,221.0,26,14343,4833.0,2804.0,927.0
0.006,6,10,2006,5,927,1.0,659.0,659.0,5,1079,1.0,811.0,811.0
0.097,6,10,1506,5,395,23.0,127.0,127.0,5,1111,21.0,843.0,843.0
0.004,6,10,2007,5,928,1.0,660.0,660.0,5,1079,1.0,811.0,811.0
0.019,6,10,1972,5,910,4.0,642.0,642.0,5,1062,4.0,794.0,794.0
1794.521,6,242,46679,116,34119,15604.0,2499.0,1001.0,126,12560,14355.0,580.0,61.0
0.01,6,10,1762,5,911,2.0,643.0,643.0,5,851,2.0,583.0,583.0
0.007,6,10,1547,5,764,1.0,496.0,496.0,5,783,1.0,515.0,515.0
0.004,17,2,148,1,60,0.0,32.0,32.0,1,88,0.0,60.0,60.0
0.004,17,2,136,1,60,0.0,32.0,32.0,1,76,0.0,48.0,48.0
300.466,6,16,2170,9,684,37537.0,146.0,146.0,7,1486,50050.0,419.0,398.0
0.004,17,2,136,1,60,0.0,32.0,32.0,1,76,0.0,48.0,48.0
0.001,17,2,180,1,66,0.0,38.0,38.0,1,114,0.0,86.0,86.0
0.001,17,2,140,1,62,0.0,34.0,34.0,1,78,0.0,50.0,50.0
0.005,6,13,3747,7,509,0.0,137.0,137.0,6,3238,1.0,1470.0,1459.0
0.085,6,10,1506,5,395,19.0,127.0,127.0,5,1111,17.0,843.0,843.0
0.1,6,10,1506,5,395,19.0,127.0,127.0,5,1111,23.0,843.0,843.0
371.469,6,22,2313,16,867,24764.0,195.0,195.0,6,1446,4644.0,419.0,398.0
0.024,6,10,1983,5,910,6.0,642.0,642.0,5,1073,5.0,805.0,805.0
0.073,17,4,420,2,122,0.0,33.0,33.0,2,298,33.0,145.0,121.0
0.005,17,2,144,1,64,0.0,36.0,36.0,1,80,0.0,52.0,52.0
0.004,6,10,1702,5,863,1.0,595.0,595.0,5,839,0.0,571.0,571.0
0.006,17,2,230,1,68,0.0,40.0,40.0,1,162,0.0,134.0,134.0
0.005,6,10,1689,5,839,1.0,571.0,571.0,5,850,1.0,582.0,582.0
0.084,6,10,1506,5,395,19.0,127.0,127.0,5,1111,19.0,843.0,843.0
0.116,6,10,1506,5,395,22.0,127.0,127.0,5,1111,26.0,843.0,843.0
0.011,6,10,1990,5,911,2.0,643.0,643.0,5,1079,2.0,811.0,811.0
0.001,17,2,180,1,66,0.0,38.0,38.0,1,114,0.0,86.0,86.0
0.006,6,10,1547,5,764,1.0,496.0,496.0,5,783,1.0,515.0,515.0
0.004,6,10,2006,5,927,1.0,659.0,659.0,5,1079,1.0,811.0,811.0
0.005,6,13,3747,7,509,0.0,137.0,137.0,6,3238,1.0,1470.0,1459.0
0.005,6,10,1989,5,927,1.0,659.0,659.0,5,1062,1.0,794.0,794.0
0.005,6,10,1547,5,764,1.0,496.0,496.0,5,783,1.0,515.0,515.0
0.019,6,13,3735,7,497,3.0,125.0,125.0,6,3238,3.0,1470.0,1459.0
0.005,6,10,2006,5,927,1.0,659.0,659.0,5,1079,1.0,811.0,811.0
0.006,6,10,1689,5,839,1.0,571.0,571.0,5,850,1.0,582.0,582.0
0.066,6,10,1506,5,395,14.0,127.0,127.0,5,1111,14.0,843.0,843.0
0.014,6,10,1989,5,910,3.0,642.0,642.0,5,1079,3.0,811.0,811.0
0.006,6,14,3742,8,504,0.0,80.0,80.0,6,3238,1.0,1470.0,1459.0
1739.213,6,64,7361,42,4485,42419.0,1641.0,109.0,22,2876,82811.0,1112.0,82.0
0.005,6,10,1689,5,839,1.0,571.0,571.0,5,850,1.0,582.0,582.0
0.004,6,10,2000,5,927,1.0,659.0,659.0,5,1073,1.0,805.0,805.0
0.004,17,2,179,1,71,0.0,43.0,43.0,1,108,0.0,80.0,80.0
0.005,6,10,2007,5,928,1.0,660.0,660.0,5,1079,1.0,811.0,811.0
0.013,6,10,1972,5,910,3.0,642.0,642.0,5,1062,3.0,794.0,794.0
0.015,6,10,1631,5,848,3.0,580.0,580.0,5,783,3.0,515.0,515.0
0.066,6,10,1506,5,395,14.0,127.0,127.0,5,1111,15.0,843.0,843.0
0.006,6,10,1689,5,839,1.0,571.0,571.0,5,850,1.0,582.0,582.0
0.005,6,10,1989,5,927,1.0,659.0,659.0,5,1062,1.0,794.0,794.0
0.119,6,10,1506,5,395,25.0,127.0,127.0,5,1111,25.0,843.0,843.0
0.006,6,10,1547,5,764,1.0,496.0,496.0,5,783,1.0,515.0,515.0
0.006,6,10,1547,5,764,1.0,496.0,496.0,5,783,1.0,515.0,515.0
134.287,6,23,4097,14,3206,10329.0,494.0,494.0,9,891,16785.0,83.0,83.0
0.005,6,10,1689,5,839,1.0,571.0,571.0,5,850,1.0,582.0,582.0
0.037,6,10,1677,5,827,9.0,559.0,559.0,5,850,9.0,582.0,582.0
0.005,6,10,1779,5,928,1.0,660.0,660.0,5,851,1.0,583.0,583.0
0.001,17,2,136,1,60,0.0,32.0,32.0,1,76,0.0,48.0,48.0
0.005,6,10,1854,5,889,1.0,621.0,621.0,5,965,1.0,697.0,697.0
300.394,6,16,2170,9,684,37528.0,146.0,146.0,7,1486,50037.0,419.0,398.0
0.081,6,10,1506,5,395,17.0,127.0,127.0,5,1111,18.0,843.0,843.0
0.017,6,10,1990,5,911,4.0,643.0,643.0,5,1079,4.0,811.0,811.0
0.005,6,10,2000,5,927,1.0,659.0,659.0,5,1073,1.0,805.0,805.0
0.004,17,2,136,1,60,0.0,32.0,32.0,1,76,0.0,48.0,48.0
0.04,17,2,170,1,65,0.0,37.0,37.0,1,105,0.0,77.0,77.0
352.793,6,45,23343,31,1840,11759.0,290.0,290.0,14,21503,1772.0,2907.0,2091.0
0.138,6,10,1506,5,395,23.0,127.0,127.0,5,1111,32.0,843.0,843.0
0.005,6,10,1779,5,928,1.0,660.0,660.0,5,851,1.0,583.0,583.0
0.004,17,2,148,1,60,0.0,32.0,32.0,1,88,0.0,60.0,60.0
0.209,6,16,2670,8,1396,29.0,533.0,324.0,8,1274,18.0,529.0,212.0
127.647,6,21,8143,11,1985,85.0,1174.0,504.0,10,6158,14164.0,1791.0,957.0
0.041,17,2,152,1,76,0.0,48.0,48.0,1,76,0.0,48.0,48.0
0.005,17,2,170,1,65,0.0,37.0,37.0,1,105,0.0,77.0,77.0
0.012,6,10,1972,5,910,3.0,642.0,642.0,5,1062,2.0,794.0,794.0
0.04,17,4,284,2,120,1.0,32.0,32.0,2,164,36.0,60.0,54.0
0.034,6,10,1990,5,911,8.0,643.0,643.0,5,1079,8.0,811.0,811.0
0.002,17,2,180,1,66,0.0,38.0,38.0,1,114,0.0,86.0,86.0
0.081,6,10,1506,5,395,16.0,127.0,127.0,5,1111,19.0,843.0,843.0
0.001,17,2,136,1,60,0.0,32.0,32.0,1,76,0.0,48.0,48.0
40.074,17,10,676,5,460,10015.0,104.0,64.0,5,216,10017.0,20.0,15.0
0.011,6,10,1990,5,911,2.0,643.0,643.0,5,1079,2.0,811.0,811.0
0.067,6,10,1506,5,395,15.0,127.0,127.0,5,1111,15.0,843.0,843.0
92.337,6,22,7437,11,1305,124.0,530.0,277.0,11,6132,9217.0,2720.0,946.0
0.08,6,10,1506,5,395,16.0,127.0,127.0,5,1111,16.0,843.0,843.0
301.192,6,52,22147,27,16120,11584.0,2720.0,1364.0,25,6027,374.0,2667.0,385.0
0.006,6,10,1547,5,764,1.0,496.0,496.0,5,783,1.0,515.0,515.0
0.185,17,2,179,1,71,0.0,43.0,43.0,1,108,0.0,80.0,80.0
10.751,17,28,4422,14,1994,818.0,269.0,114.0,14,2428,818.0,587.0,145.0
0.005,6,10,2000,5,927,1.0,659.0,659.0,5,1073,1.0,805.0,805.0
0.003,17,2,148,1,60,0.0,32.0,32.0,1,88,0.0,60.0,60.0
0.005,6,10,2007,5,928,1.0,660.0,660.0,5,1079,1.0,811.0,811.0
0.11,6,10,1506,5,395,23.0,127.0,127.0,5,1111,23.0,843.0,843.0
0.006,6,10,2006,5,927,1.0,659.0,659.0,5,1079,1.0,811.0,811.0
0.004,6,10,2000,5,927,1.0,659.0,659.0,5,1073,1.0,805.0,805.0
0.123,6,10,1506,5,395,21.0,127.0,127.0,5,1111,25.0,843.0,843.0
0.003,17,2,148,1,60,0.0,32.0,32.0,1,88,0.0,60.0,60.0
0.013,6,10,1990,5,911,3.0,643.0,643.0,5,1079,3.0,811.0,811.0
0.001,17,2,179,1,62,0.0,34.0,34.0,1,117,0.0,89.0,89.0
0.012,6,10,1762,5,911,2.0,643.0,643.0,5,851,3.0,583.0,583.0
0.004,17,2,136,1,60,0.0,32.0,32.0,1,76,0.0,48.0,48.0
0.004,6,10,1702,5,863,1.0,595.0,595.0,5,839,1.0,571.0,571.0
0.004,17,2,152,1,68,0.0,40.0,40.0,1,84,0.0,56.0,56.0
0.038,17,4,352,2,130,0.0,37.0,37.0,2,222,35.0,89.0,83.0
0.005,17,2,164,1,74,0.0,46.0,46.0,1,90,0.0,62.0,62.0
40.08,17,10,676,5,460,10017.0,104.0,64.0,5,216,10017.0,20.0,15.0
0.005,6,10,2000,5,927,1.0,659.0,659.0,5,1073,1.0,805.0,805.0
0.081,6,10,1506,5,395,18.0,127.0,127.0,5,1111,17.0,843.0,843.0
40.057,17,10,676,5,460,10013.0,104.0,64.0,5,216,10012.0,20.0,15.0
0.004,6,10,2006,5,927,1.0,659.0,659.0,5,1079,1.0,811.0,811.0
40.069,17,10,676,5,460,10014.0,104.0,64.0,5,216,10016.0,20.0,15.0
0.005,17,2,268,1,70,0.0,42.0,42.0,1,198,0.0,170.0,170.0
0.001,17,2,166,1,75,0.0,47.0,47.0,1,91,0.0,63.0,63.0
0.001,17,2,180,1,66,0.0,38.0,38.0,1,114,0.0,86.0,86.0
0.04,17,4,420,2,122,0.0,33.0,33.0,2,298,36.0,145.0,121.0
0.005,17,2,169,1,62,0.0,34.0,34.0,1,107,0.0,79.0,79.0
10.839,17,28,4420,14,1993,825.0,268.0,114.0,14,2427,825.0,586.0,145.0
0.089,6,10,1506,5,395,21.0,127.0,127.0,5,1111,17.0,843.0,843.0
0.004,6,10,1702,5,863,1.0,595.0,595.0,5,839,1.0,571.0,571.0
0.006,6,10,1689,5,839,1.0,571.0,571.0,5,850,1.0,582.0,582.0
0.008,6,10,1972,5,910,1.0,642.0,642.0,5,1062,1.0,794.0,794.0
0.083,6,10,1506,5,395,19.0,127.0,127.0,5,1111,18.0,843.0,843.0
0.012,17,2,194,1,59,0.0,31.0,31.0,1,135,0.0,107.0,107.0
0.006,6,10,1989,5,927,1.0,659.0,659.0,5,1062,1.0,794.0,794.0
0.004,6,10,2007,5,928,1.0,660.0,660.0,5,1079,1.0,811.0,811.0
0.004,17,4,284,2,120,0.0,32.0,32.0,2,164,1.0,60.0,54.0
0.008,6,10,1972,5,910,2.0,642.0,642.0,5,1062,1.0,794.0,794.0
0.014,6,10,1762,5,911,3.0,643.0,643.0,5,851,3.0,583.0,583.0
1770.563,6,82,4318,41,2159,44263.0,27.0,27.0,41,2159,44263.0,27.0,27.0
0.006,6,10,1854,5,889,1.0,621.0,621.0,5,965,1.0,697.0,697.0
0.005,6,10,2006,5,927,1.0,659.0,659.0,5,1079,1.0,811.0,811.0
308.514,17,20,1124,10,716,34264.0,48.0,43.0,10,408,34265.0,20.0,12.0
0.005,17,2,170,1,65,0.0,37.0,37.0,1,105,0.0,77.0,77.0
0.005,6,13,3747,7,509,0.0,137.0,137.0,6,3238,1.0,1470.0,1459.0
0.019,6,11,1814,6,963,3.0,643.0,643.0,5,851,4.0,583.0,583.0
0.012,6,10,1989,5,910,3.0,642.0,642.0,5,1079,2.0,811.0,811.0
0.005,6,10,2000,5,927,1.0,659.0,659.0,5,1073,1.0,805.0,805.0
40.065,17,10,676,5,460,10013.0,104.0,64.0,5,216,10015.0,20.0,15.0
29.5,58,5,360,4,288,9833.0,24.0,24.0,1,72,0.0,24.0,24.0
0.008,6,12,1926,6,1189,1.0,659.0,434.0,6,737,1.0,417.0,417.0
40.074,17,10,676,5,460,10017.0,104.0,64.0,5,216,10017.0,20.0,15.0
0.089,6,10,1506,5,395,21.0,127.0,127.0,5,1111,21.0,843.0,843.0
0.007,6,10,1989,5,910,1.0,642.0,642.0,5,1079,1.0,811.0,811.0
0.011,17,2,179,1,71,0.0,43.0,43.0,1,108,0.0,80.0,80.0
0.106,6,10,1506,5,395,25.0,127.0,127.0,5,1111,24.0,843.0,843.0
0.071,17,2,170,1,65,0.0,37.0,37.0,1,105,0.0,77.0,77.0
0.007,6,10,1689,5,839,1.0,571.0,571.0,5,850,1.0,582.0,582.0
0.011,6,10,1972,5,910,2.0,642.0,642.0,5,1062,2.0,794.0,794.0
0.003,17,2,136,1,60,0.0,32.0,32.0,1,76,0.0,48.0,48.0
0.004,6,10,2006,5,927,1.0,659.0,659.0,5,1079,1.0,811.0,811.0
0.218,6,16,2669,8,1395,31.0,533.0,323.0,8,1274,19.0,529.0,212.0
0.011,6,10,1990,5,911,2.0,643.0,643.0,5,1079,2.0,811.0,811.0
0.006,6,10,1547,5,764,1.0,496.0,496.0,5,783,1.0,515.0,515.0
0.007,17,4,284,2,120,0.0,32.0,32.0,2,164,1.0,60.0,54.0
0.004,6,10,2006,5,927,1.0,659.0,659.0,5,1079,1.0,811.0,811.0
0.015,6,10,1631,5,848,3.0,580.0,580.0,5,783,3.0,515.0,515.0
309.131,17,20,1124,10,716,34333.0,48.0,43.0,10,408,34333.0,20.0,12.0
0.019,6,10,1972,5,910,4.0,642.0,642.0,5,1062,4.0,794.0,794.0
374.094,6,22,2313,16,867,24939.0,195.0,195.0,6,1446,4638.0,419.0,398.0
0.142,6,10,1506,5,395,33.0,127.0,127.0,5,1111,29.0,843.0,843.0
0.005,6,10,1643,5,860,1.0,592.0,592.0,5,783,1.0,515.0,515.0
0.005,6,10,1989,5,927,1.0,659.0,659.0,5,1062,1.0,794.0,794.0
0.096,6,10,1506,5,395,21.0,127.0,127.0,5,1111,21.0,843.0,843.0
0.006,17,2,170,1,65,0.0,37.0,37.0,1,105,0.0,77.0,77.0
0.008,6,10,1983,5,910,2.0,642.0,642.0,5,1073,2.0,805.0,805.0
0.005,6,10,1989,5,927,1.0,659.0,659.0,5,1062,1.0,794.0,794.0
0.005,6,10,2007,5,928,1.0,660.0,660.0,5,1079,1.0,811.0,811.0
0.038,17,2,412,1,61,0.0,33.0,33.0,1,351,0.0,323.0,323.0
0.172,17,2,152,1,76,0.0,48.0,48.0,1,76,0.0,48.0,48.0
0.005,6,10,1702,5,863,1.0,595.0,595.0,5,839,1.0,571.0,571.0
0.012,6,10,1702,5,863,2.0,595.0,595.0,5,839,2.0,571.0,571.0
0.01,6,13,3735,7,497,1.0,125.0,125.0,6,3238,2.0,1470.0,1459.0
0.589,6,26,8926,14,1587,36.0,517.0,211.0,12,7339,43.0,1288.0,839.0
0.012,6,10,1983,5,910,3.0,642.0,642.0,5,1073,3.0,805.0,805.0
0.102,6,10,1506,5,395,22.0,127.0,127.0,5,1111,20.0,843.0,843.0
0.006,6,13,3684,7,446,0.0,74.0,74.0,6,3238,1.0,1470.0,1459.0
0.005,6,10,1689,5,839,1.0,571.0,571.0,5,850,1.0,582.0,582.0
0.007,6,10,1689,5,839,1.0,571.0,571.0,5,850,1.0,582.0,582.0
0.01,6,13,3735,7,497,1.0,125.0,125.0,6,3238,2.0,1470.0,1459.0
300.14,6,29,10053,17,1491,18758.0,260.0,149.0,12,8562,21830.0,1561.0,991.0
0.035,6,10,1983,5,910,8.0,642.0,642.0,5,1073,8.0,805.0,805.0
361.748,6,21,1793,16,1030,24116.0,190.0,190.0,5,763,60009.0,462.0,247.0
40.05,17,10,676,5,460,10011.0,104.0,64.0,5,216,10011.0,20.0,15.0
240.53,6,33,9261,16,1833,16033.0,621.0,198.0,17,7428,15031.0,1402.0,595.0
0.01,6,10,1983,5,910,2.0,642.0,642.0,5,1073,2.0,805.0,805.0
0.093,6,10,1506,5,395,20.0,127.0,127.0,5,1111,19.0,843.0,843.0
9.039,17,6,376,5,280,2259.0,28.0,28.0,1,96,0.0,68.0,68.0
0.005,17,2,230,1,68,0.0,40.0,40.0,1,162,0.0,134.0,134.0
0.008,6,10,1972,5,910,1.0,642.0,642.0,5,1062,2.0,794.0,794.0
1778.666,17,141,44556,72,22752,25047.0,288.0,288.0,69,21804,26156.0,288.0,288.0
0.005,6,10,1774,5,923,1.0,655.0,655.0,5,851,1.0,583.0,583.0
0.095,6,10,1506,5,395,20.0,127.0,127.0,5,1111,20.0,843.0,843.0
0.007,6,10,1972,5,910,1.0,642.0,642.0,5,1062,1.0,794.0,794.0
0.003,17,2,136,1,60,0.0,32.0,32.0,1,76,0.0,48.0,48.0
0.019,6,10,1990,5,911,4.0,643.0,643.0,5,1079,4.0,811.0,811.0
0.071,17,2,136,1,60,0.0,32.0,32.0,1,76,0.0,48.0,48.0
0.04,17,2,156,1,64,0.0,36.0,36.0,1,92,0.0,64.0,64.0
0.014,17,2,152,1,56,0.0,28.0,28.0,1,96,0.0,68.0,68.0
0.006,6,10,1643,5,860,1.0,592.0,592.0,5,783,1.0,515.0,515.0
0.016,6,10,1990,5,911,4.0,643.0,643.0,5,1079,3.0,811.0,811.0
0.004,6,10,2007,5,928,1.0,660.0,660.0,5,1079,1.0,811.0,811.0
243.171,6,36,9435,15,6658,17369.0,1783.0,653.0,21,2777,12158.0,580.0,139.0
0.039,6,10,1677,5,827,9.0,559.0,559.0,5,850,9.0,582.0,582.0
0.006,17,2,170,1,65,0.0,37.0,37.0,1,105,0.0,77.0,77.0
0.005,17,2,293,1,73,0.0,45.0,45.0,1,220,0.0,192.0,192.0
0.003,17,2,136,1,60,0.0,32.0,32.0,1,76,0.0,48.0,48.0
0.012,6,10,1989,5,910,3.0,642.0,642.0,5,1079,2.0,811.0,811.0
0.01,6,10,1972,5,910,2.0,642.0,642.0,5,1062,2.0,794.0,794.0
0.012,6,10,1972,5,910,3.0,642.0,642.0,5,1062,3.0,794.0,794.0
0.005,6,10,1779,5,928,1.0,660.0,660.0,5,851,1.0,583.0,583.0
0.006,6,10,1643,5,860,1.0,592.0,592.0,5,783,1.0,515.0,515.0
0.102,6,10,1506,5,395,22.0,127.0,127.0,5,1111,21.0,843.0,843.0
0.111,6,10,1506,5,395,23.0,127.0,127.0,5,1111,24.0,843.0,843.0
0.014,6,10,1972,5,910,3.0,642.0,642.0,5,1062,3.0,794.0,794.0
0.042,6,10,1983,5,910,10.0,642.0,642.0,5,1073,10.0,805.0,805.0
1730.39,6,48,2957,31,1800,57679.0,35.0,35.0,17,1157,108144.0,31.0,31.0
327.359,17,20,1124,10,716,36366.0,48.0,43.0,10,408,36366.0,20.0,12.0
0.283,6,16,2777,8,1395,40.0,533.0,323.0,8,1382,26.0,529.0,239.0
15.071,17,11,4408,5,2355,3760.0,1350.0,443.0,6,2053,3008.0,1350.0,314.0
0.073,6,10,1506,5,395,16.0,127.0,127.0,5,1111,16.0,843.0,843.0
0.008,6,10,1989,5,910,2.0,642.0,642.0,5,1079,2.0,811.0,811.0
0.003,17,2,152,1,76,0.0,48.0,48.0,1,76,0.0,48.0,48.0
11.114,17,28,4422,14,1994,842.0,269.0,114.0,14,2428,842.0,587.0,145.0
15.075,17,14,9191,8,6902,2149.0,1350.0,834.0,6,2289,3009.0,1350.0,353.0
354.049,6,21,1795,16,1030,23603.0,190.0,190.0,5,765,60002.0,464.0,248.0
0.005,6,10,1702,5,863,1.0,595.0,595.0,5,839,1.0,571.0,571.0
0.005,6,10,2006,5,927,1.0,659.0,659.0,5,1079,1.0,811.0,811.0
40.071,17,10,676,5,460,10015.0,104.0,64.0,5,216,10017.0,20.0,15.0
0.006,17,2,179,1,71,0.0,43.0,43.0,1,108,0.0,80.0,80.0
0.005,6,10,2006,5,927,1.0,659.0,659.0,5,1079,1.0,811.0,811.0
0.012,6,10,1989,5,910,3.0,642.0,642.0,5,1079,2.0,811.0,811.0
0.039,17,4,284,2,120,0.0,32.0,32.0,2,164,35.0,60.0,54.0
0.008,6,10,1762,5,911,2.0,643.0,643.0,5,851,1.0,583.0,583.0
0.091,6,10,1506,5,395,19.0,127.0,127.0,5,1111,19.0,843.0,843.0
0.079,6,10,1506,5,395,16.0,127.0,127.0,5,1111,16.0,843.0,843.0
0.004,6,10,1989,5,927,1.0,659.0,659.0,5,1062,1.0,794.0,794.0
0.004,17,2,136,1,60,0.0,32.0,32.0,1,76,0.0,48.0,48.0
0.157,6,10,1506,5,395,34.0,127.0,127.0,5,1111,30.0,843.0,843.0
40.076,17,10,676,5,460,10018.0,104.0,64.0,5,216,10018.0,20.0,15.0
0.003,6,10,1702,5,863,0.0,595.0,595.0,5,839,0.0,571.0,571.0
0.079,6,10,1506,5,395,18.0,127.0,127.0,5,1111,18.0,843.0,843.0
0.012,6,10,1989,5,910,2.0,642.0,642.0,5,1079,3.0,811.0,811.0
0.006,6,10,1643,5,860,1.0,592.0,592.0,5,783,1.0,515.0,515.0
0.001,17,2,180,1,66,0.0,38.0,38.0,1,114,0.0,86.0,86.0
0.084,17,2,152,1,76,0.0,48.0,48.0,1,76,0.0,48.0,48.0
0.013,17,2,152,1,56,0.0,28.0,28.0,1,96,0.0,68.0,68.0
0.156,6,10,1506,5,395,38.0,127.0,127.0,5,1111,32.0,843.0,843.0
0.006,6,10,1547,5,764,1.0,496.0,496.0,5,783,1.0,515.0,515.0
300.382,6,16,2170,9,684,37526.0,146.0,146.0,7,1486,50035.0,419.0,398.0
1793.167,6,540,188461,278,163441,6473.0,2883.0,936.0,262,25020,6870.0,580.0,116.0
0.007,6,10,1547,5,764,1.0,496.0,496.0,5,783,1.0,515.0,515.0
0.013,6,10,1989,5,910,3.0,642.0,642.0,5,1079,3.0,811.0,811.0
0.014,6,10,1983,5,910,3.0,642.0,642.0,5,1073,3.0,805.0,805.0
0.07,6,10,1506,5,395,15.0,127.0,127.0,5,1111,16.0,843.0,843.0
0.04,17,2,166,1,75,0.0,47.0,47.0,1,91,0.0,63.0,63.0
389.222,6,26,3272,18,971,22895.0,195.0,195.0,8,2301,3353.0,775.0,492.0
0.112,6,10,1506,5,395,21.0,127.0,127.0,5,1111,24.0,843.0,843.0
0.013,6,10,1989,5,910,3.0,642.0,642.0,5,1079,3.0,811.0,811.0
0.254,17,40,21531,22,18423,12.0,1350.0,809.0,18,3108,11.0,1350.0,144.0
0.005,6,10,1989,5,927,1.0,659.0,659.0,5,1062,1.0,794.0,794.0
0.005,6,10,2006,5,927,1.0,659.0,659.0,5,1079,1.0,811.0,811.0
15.135,17,20,13503,10,8344,1678.0,1350.0,806.0,10,5159,1678.0,1350.0,487.0
0.005,6,10,1854,5,889,1.0,621.0,621.0,5,965,1.0,697.0,697.0
0.103,6,10,1506,5,395,24.0,127.0,127.0,5,1111,22.0,843.0,843.0
178.033,17,82,11651,41,2736,4450.0,44.0,38.0,41,8915,4450.0,261.0,189.0
310.229,17,20,1124,10,716,34455.0,48.0,43.0,10,408,34455.0,20.0,12.0
40.058,17,10,676,5,460,10013.0,104.0,64.0,5,216,10013.0,20.0,15.0
0.004,17,2,148,1,60,0.0,32.0,32.0,1,88,0.0,60.0,60.0
0.039,17,2,152,1,76,0.0,48.0,48.0,1,76,0.0,48.0,48.0
1792.683,6,490,100196,246,88846,7316.0,421.0,369.0,244,11350,7376.0,53.0,53.0
0.261,17,38,19990,21,17035,13.0,1350.0,783.0,17,2955,12.0,1350.0,145.0
0.049,17,2,152,1,76,0.0,48.0,48.0,1,76,0.0,48.0,48.0
0.113,6,10,1506,5,395,24.0,127.0,127.0,5,1111,26.0,843.0,843.0
0.005,17,2,214,1,75,0.0,47.0,47.0,1,139,0.0,111.0,111.0
0.003,17,2,136,1,60,0.0,32.0,32.0,1,76,0.0,48.0,48.0
0.096,6,10,1506,5,395,21.0,127.0,127.0,5,1111,16.0,843.0,843.0
0.006,17,2,214,1,75,0.0,47.0,47.0,1,139,0.0,111.0,111.0
0.006,6,10,1547,5,764,1.0,496.0,496.0,5,783,1.0,515.0,515.0
40.063,17,10,676,5,460,10014.0,104.0,64.0,5,216,10015.0,20.0,15.0
0.009,6,10,1762,5,911,2.0,643.0,643.0,5,851,2.0,583.0,583.0
0.012,6,10,1990,5,911,3.0,643.0,643.0,5,1079,2.0,811.0,811.0
0.004,6,10,1989,5,927,1.0,659.0,659.0,5,1062,1.0,794.0,794.0
0.038,17,2,152,1,76,0.0,48.0,48.0,1,76,0.0,48.0,48.0
0.011,6,10,1762,5,911,2.0,643.0,643.0,5,851,2.0,583.0,583.0
40.055,17,10,676,5,460,10012.0,104.0,64.0,5,216,10013.0,20.0,15.0
0.181,17,4,596,2,122,177.0,33.0,33.0,2,474,109.0,323.0,209.0
0.004,6,10,2006,5,927,1.0,659.0,659.0,5,1079,1.0,811.0,811.0
0.014,6,10,1972,5,910,3.0,642.0,642.0,5,1062,3.0,794.0,794.0
0.005,6,10,1779,5,928,1.0,660.0,660.0,5,851,1.0,583.0,583.0
0.012,6,10,1989,5,910,3.0,642.0,642.0,5,1079,2.0,811.0,811.0
0.054,6,10,1677,5,827,13.0,559.0,559.0,5,850,13.0,582.0,582.0
11.072,17,28,4422,14,1994,843.0,269.0,114.0,14,2428,843.0,587.0,145.0
0.005,17,2,225,1,65,0.0,37.0,37.0,1,160,0.0,132.0,132.0
0.005,6,10,2007,5,928,1.0,660.0,660.0,5,1079,1.0,811.0,811.0
0.005,6,10,1643,5,860,1.0,592.0,592.0,5,783,1.0,515.0,515.0
0.003,17,2,148,1,60,0.0,32.0,32.0,1,88,0.0,60.0,60.0
0.004,6,10,2006,5,927,1.0,659.0,659.0,5,1079,1.0,811.0,811.0
0.005,17,2,169,1,62,0.0,34.0,34.0,1,107,0.0,79.0,79.0
0.124,6,10,1506,5,395,29.0,127.0,127.0,5,1111,29.0,843.0,843.0
0.016,6,10,1989,5,910,3.0,642.0,642.0,5,1079,3.0,811.0,811.0
0.005,6,10,2006,5,927,1.0,659.0,659.0,5,1079,1.0,811.0,811.0
0.011,6,10,1989,5,910,2.0,642.0,642.0,5,1079,2.0,811.0,811.0
0.276,17,39,20173,21,17043,13.0,1350.0,783.0,18,3130,12.0,1350.0,145.0
0.006,6,10,1547,5,764,1.0,496.0,496.0,5,783,1.0,515.0,515.0
0.022,6,10,1983,5,910,5.0,642.0,642.0,5,1073,5.0,805.0,805.0
0.017,17,2,198,1,91,0.0,63.0,63.0,1,107,0.0,79.0,79.0
0.008,6,10,1990,5,911,2.0,643.0,643.0,5,1079,2.0,811.0,811.0
0.003,17,4,284,2,120,0.0,32.0,32.0,2,164,0.0,60.0,54.0
1778.129,17,144,41760,72,22752,25043.0,288.0,288.0,72,19008,25043.0,236.0,236.0
0.012,6,10,1631,5,848,3.0,580.0,580.0,5,783,2.0,515.0,515.0
0.079,6,10,1506,5,395,17.0,127.0,127.0,5,1111,18.0,843.0,843.0
0.01,6,10,1762,5,911,2.0,643.0,643.0,5,851,2.0,583.0,583.0
0.006,6,10,1854,5,889,1.0,621.0,621.0,5,965,1.0,697.0,697.0
0.017,6,10,1972,5,910,4.0,642.0,642.0,5,1062,4.0,794.0,794.0
0.025,6,10,1989,5,910,6.0,642.0,642.0,5,1079,6.0,811.0,811.0
0.011,6,13,3735,7,497,1.0,125.0,125.0,6,3238,2.0,1470.0,1459.0
0.07,6,10,1506,5,395,15.0,127.0,127.0,5,1111,16.0,843.0,843.0
0.014,6,10,1989,5,910,3.0,642.0,642.0,5,1079,3.0,811.0,811.0
0.004,6,10,1779,5,928,1.0,660.0,660.0,5,851,0.0,583.0,583.0
0.072,17,2,152,1,76,0.0,48.0,48.0,1,76,0.0,48.0,48.0
0.013,6,10,1990,5,911,3.0,643.0,643.0,5,1079,3.0,811.0,811.0
0.011,6,13,3735,7,497,1.0,125.0,125.0,6,3238,2.0,1470.0,1459.0
0.008,6,10,1677,5,827,1.0,559.0,559.0,5,850,2.0,582.0,582.0
0.005,6,10,1689,5,839,1.0,571.0,571.0,5,850,1.0,582.0,582.0
0.02,6,10,1983,5,910,4.0,642.0,642.0,5,1073,5.0,805.0,805.0
0.163,17,2,152,1,76,0.0,48.0,48.0,1,76,0.0,48.0,48.0
0.02,6,10,1983,5,910,4.0,642.0,642.0,5,1073,5.0,805.0,805.0
0.069,6,10,1506,5,395,15.0,127.0,127.0,5,1111,14.0,843.0,843.0
0.016,6,10,1989,5,910,4.0,642.0,642.0,5,1079,3.0,811.0,811.0
0.008,6,10,1972,5,910,1.0,642.0,642.0,5,1062,2.0,794.0,794.0
0.009,17,2,148,1,60,0.0,32.0,32.0,1,88,0.0,60.0,60.0
15.082,17,15,8173,8,6126,2150.0,1350.0,737.0,7,2047,2508.0,1350.0,264.0
0.014,6,14,3787,7,497,2.0,125.0,125.0,7,3290,2.0,1448.0,972.0
0.005,6,10,2000,5,927,1.0,659.0,659.0,5,1073,1.0,805.0,805.0
0.005,6,10,2007,5,928,1.0,660.0,660.0,5,1079,1.0,811.0,811.0
15.07,17,15,9238,8,6902,2149.0,1350.0,834.0,7,2336,2506.0,1350.0,305.0
0.004,17,2,213,1,69,0.0,41.0,41.0,1,144,0.0,116.0,116.0
0.006,6,10,2006,5,927,1.0,659.0,659.0,5,1079,1.0,811.0,811.0
0.005,6,13,3747,7,509,0.0,137.0,137.0,6,3238,1.0,1470.0,1459.0
9.04,17,6,376,5,280,2260.0,28.0,28.0,1,96,0.0,68.0,68.0
0.014,6,10,1762,5,911,3.0,643.0,643.0,5,851,3.0,583.0,583.0
0.216,17,4,352,2,130,142.0,37.0,37.0,2,222,179.0,89.0,83.0
361.781,6,21,1792,16,1030,24118.0,190.0,190.0,5,762,60012.0,461.0,247.0
0.015,6,10,2006,5,927,3.0,659.0,659.0,5,1079,3.0,811.0,811.0
0.099,6,10,1506,5,395,22.0,127.0,127.0,5,1111,21.0,843.0,843.0
0.005,6,10,2006,5,927,1.0,659.0,659.0,5,1079,1.0,811.0,811.0
0.006,6,10,1547,5,764,1.0,496.0,496.0,5,783,1.0,515.0,515.0
0.005,6,10,2006,5,927,1.0,659.0,659.0,5,1079,1.0,811.0,811.0
0.003,17,2,136,1,60,0.0,32.0,32.0,1,76,0.0,48.0,48.0
0.005,6,10,2000,5,927,1.0,659.0,659.0,5,1073,1.0,805.0,805.0
0.009,6,10,1972,5,910,2.0,642.0,642.0,5,1062,2.0,794.0,794.0
0.109,6,10,1506,5,395,24.0,127.0,127.0,5,1111,24.0,843.0,843.0
0.221,6,16,2670,8,1396,31.0,533.0,324.0,8,1274,20.0,529.0,212.0
0.007,6,10,1643,5,860,1.0,592.0,592.0,5,783,1.0,515.0,515.0
0.015,6,10,1972,5,910,3.0,642.0,642.0,5,1062,3.0,794.0,794.0
0.007,6,12,1698,6,863,1.0,327.0,271.0,6,835,1.0,515.0,515.0
0.005,6,10,1779,5,928,1.0,660.0,660.0,5,851,1.0,583.0,583.0
0.006,6,10,2007,5,928,1.0,660.0,660.0,5,1079,1.0,811.0,811.0
0.086,6,10,1506,5,395,19.0,127.0,127.0,5,1111,18.0,843.0,843.0
0.005,6,10,1989,5,927,1.0,659.0,659.0,5,1062,1.0,794.0,794.0
0.005,6,10,1989,5,927,1.0,659.0,659.0,5,1062,1.0,794.0,794.0
0.011,6,10,1989,5,910,2.0,642.0,642.0,5,1079,2.0,811.0,811.0
0.005,6,13,3747,7,509,0.0,137.0,137.0,6,3238,1.0,1470.0,1459.0
0.004,17,2,148,1,60,0.0,32.0,32.0,1,88,0.0,60.0,60.0
0.005,6,10,1689,5,839,1.0,571.0,571.0,5,850,1.0,582.0,582.0
0.007,6,10,1972,5,910,1.0,642.0,642.0,5,1062,1.0,794.0,794.0
0.006,17,2,179,1,71,0.0,43.0,43.0,1,108,0.0,80.0,80.0
0.009,6,12,1926,6,1189,1.0,659.0,434.0,6,737,1.0,417.0,417.0
0.064,17,2,152,1,76,0.0,48.0,48.0,1,76,0.0,48.0,48.0
0.122,6,10,1506,5,395,26.0,127.0,127.0,5,1111,26.0,843.0,843.0
0.026,6,13,3913,7,495,4.0,123.0,123.0,6,3418,5.0,1650.0,1549.0
0.006,17,2,169,1,62,0.0,34.0,34.0,1,107,0.0,79.0,79.0
0.006,6,10,1689,5,839,1.0,571.0,571.0,5,850,1.0,582.0,582.0
361.784,6,21,1792,16,1030,24118.0,190.0,190.0,5,762,60014.0,461.0,247.0
0.021,6,10,1631,5,848,5.0,580.0,580.0,5,783,5.0,515.0,515.0
40.055,17,10,676,5,460,10013.0,104.0,64.0,5,216,10013.0,20.0,15.0
0.006,6,10,2006,5,927,1.0,659.0,659.0,5,1079,1.0,811.0,811.0
0.021,6,13,3735,7,497,3.0,125.0,125.0,6,3238,4.0,1470.0,1459.0
0.008,6,12,1926,6,1189,1.0,659.0,434.0,6,737,1.0,417.0,417.0
0.005,6,10,2007,5,928,1.0,660.0,660.0,5,1079,1.0,811.0,811.0
0.006,6,10,1547,5,764,1.0,496.0,496.0,5,783,1.0,515.0,515.0
0.003,17,2,136,1,60,0.0,32.0,32.0,1,76,0.0,48.0,48.0
0.012,6,10,1989,5,910,3.0,642.0,642.0,5,1079,2.0,811.0,811.0
0.005,17,2,148,1,60,0.0,32.0,32.0,1,88,0.0,60.0,60.0
0.004,6,10,2006,5,927,1.0,659.0,659.0,5,1079,1.0,811.0,811.0
40.06,17,10,676,5,460,10011.0,104.0,64.0,5,216,10014.0,20.0,15.0
40.06,17,10,676,5,460,10014.0,104.0,64.0,5,216,10014.0,20.0,15.0
0.126,17,2,80,1,32,0.0,4.0,4.0,1,48,0.0,20.0,20.0
0.006,17,2,164,1,74,0.0,46.0,46.0,1,90,0.0,62.0,62.0
240.165,6,18,7342,10,2076,26685.0,1368.0,520.0,8,5266,34308.0,2802.0,1210.0
0.009,6,10,1762,5,911,2.0,643.0,643.0,5,851,2.0,583.0,583.0
11.213,17,28,4421,14,1993,849.0,268.0,114.0,14,2428,849.0,587.0,145.0
0.063,6,10,1506,5,395,14.0,127.0,127.0,5,1111,14.0,843.0,843.0
0.006,17,2,136,1,60,0.0,32.0,32.0,1,76,0.0,48.0,48.0
0.181,6,3,453,2,321,181.0,241.0,241.0,1,132,0.0,92.0,92.0
0.009,6,10,1989,5,910,2.0,642.0,642.0,5,1079,2.0,811.0,811.0
0.081,6,10,1506,5,395,17.0,127.0,127.0,5,1111,17.0,843.0,843.0
0.287,17,49,29414,29,26262,10.0,1350.0,877.0,20,3152,12.0,1350.0,129.0
0.014,6,14,3787,7,497,2.0,125.0,125.0,7,3290,2.0,1448.0,972.0
0.047,6,10,1990,5,911,11.0,643.0,643.0,5,1079,11.0,811.0,811.0
241.182,6,300,342715,123,17904,1976.0,2736.0,959.0,177,324811,1370.0,2804.0,1889.0
0.227,17,20,11042,11,8398,22.0,1350.0,735.0,9,2644,23.0,1350.0,265.0
0.004,17,2,136,1,60,0.0,32.0,32.0,1,76,0.0,48.0,48.0
0.012,6,10,1631,5,848,3.0,580.0,580.0,5,783,3.0,515.0,515.0
0.006,6,10,1689,5,839,1.0,571.0,571.0,5,850,1.0,582.0,582.0
0.012,6,13,3735,7,497,1.0,125.0,125.0,6,3238,2.0,1470.0,1459.0
0.042,17,2,144,1,64,0.0,36.0,36.0,1,80,0.0,52.0,52.0
0.005,17,2,164,1,74,0.0,46.0,46.0,1,90,0.0,62.0,62.0
351.989,6,20,2210,6,1308,12003.0,494.0,494.0,14,902,27075.0,83.0,83.0
351.994,6,20,2210,6,1308,12003.0,494.0,494.0,14,902,27076.0,83.0,83.0
0.005,6,10,2007,5,928,1.0,660.0,660.0,5,1079,1.0,811.0,811.0
0.006,17,2,170,1,65,0.0,37.0,37.0,1,105,0.0,77.0,77.0
11.18,17,28,4422,14,1994,847.0,269.0,114.0,14,2428,847.0,587.0,145.0
0.012,6,10,1972,5,910,2.0,642.0,642.0,5,1062,3.0,794.0,794.0
0.007,6,10,1989,5,910,1.0,642.0,642.0,5,1079,1.0,811.0,811.0
0.229,6,16,2777,8,1395,32.0,533.0,323.0,8,1382,21.0,529.0,239.0
0.17,17,2,152,1,76,0.0,48.0,48.0,1,76,0.0,48.0,48.0
0.001,17,2,180,1,66,0.0,38.0,38.0,1,114,0.0,86.0,86.0
0.012,6,13,3735,7,497,2.0,125.0,125.0,6,3238,2.0,1470.0,1459.0
1770.722,6,135,6510,75,3585,23925.0,39.0,39.0,60,2925,30008.0,35.0,35.0
0.005,6,10,1989,5,927,1.0,659.0,659.0,5,1062,1.0,794.0,794.0
0.073,6,10,1506,5,395,14.0,127.0,127.0,5,1111,17.0,843.0,843.0
0.011,6,10,1631,5,848,2.0,580.0,580.0,5,783,2.0,515.0,515.0
0.008,6,10,1972,5,910,2.0,642.0,642.0,5,1062,1.0,794.0,794.0
0.004,17,2,148,1,60,0.0,32.0,32.0,1,88,0.0,60.0,60.0
0.014,6,10,1989,5,910,3.0,642.0,642.0,5,1079,3.0,811.0,811.0
15.214,17,18,8978,9,6709,1898.0,1350.0,717.0,9,2269,1898.0,1350.0,224.0
0.005,6,14,3742,7,452,0.0,80.0,80.0,7,3290,0.0,1448.0,972.0
0.004,17,2,132,1,58,0.0,30.0,30.0,1,74,0.0,46.0,46.0
0.04,17,2,184,1,61,0.0,33.0,33.0,1,123,0.0,95.0,95.0
0.006,17,2,140,1,62,0.0,34.0,34.0,1,78,0.0,50.0,50.0
0.007,6,10,1989,5,910,1.0,642.0,642.0,5,1079,1.0,811.0,811.0
9.108,17,6,376,5,280,2277.0,28.0,28.0,1,96,0.0,68.0,68.0
0.125,6,10,1506,5,395,26.0,127.0,127.0,5,1111,30.0,843.0,843.0
0.075,6,10,1506,5,395,16.0,127.0,127.0,5,1111,15.0,843.0,843.0
240.49,6,36,10193,18,1887,14144.0,559.0,188.0,18,8306,14143.0,1402.0,614.0
0.002,17,2,179,1,62,0.0,34.0,34.0,1,117,0.0,89.0,89.0
0.005,6,10,2006,5,927,1.0,659.0,659.0,5,1079,1.0,811.0,811.0
0.015,6,10,1972,5,910,3.0,642.0,642.0,5,1062,3.0,794.0,794.0
0.031,6,10,1972,5,910,7.0,642.0,642.0,5,1062,7.0,794.0,794.0
0.104,6,10,1506,5,395,23.0,127.0,127.0,5,1111,24.0,843.0,843.0
0.015,6,10,1762,5,911,3.0,643.0,643.0,5,851,3.0,583.0,583.0
0.003,6,10,1702,5,863,0.0,595.0,595.0,5,839,0.0,571.0,571.0
0.13,6,10,1506,5,395,30.0,127.0,127.0,5,1111,26.0,843.0,843.0
0.014,6,10,1983,5,910,3.0,642.0,642.0,5,1073,3.0,805.0,805.0
40.067,17,10,676,5,460,10016.0,104.0,64.0,5,216,10015.0,20.0,15.0
0.004,6,10,1702,5,863,1.0,595.0,595.0,5,839,1.0,571.0,571.0
0.003,17,2,136,1,60,0.0,32.0,32.0,1,76,0.0,48.0,48.0
0.007,6,10,2006,5,927,1.0,659.0,659.0,5,1079,1.0,811.0,811.0
0.066,6,10,1506,5,395,14.0,127.0,127.0,5,1111,14.0,843.0,843.0
0.006,6,10,1854,5,889,1.0,621.0,621.0,5,965,1.0,697.0,697.0
0.078,6,10,1506,5,395,17.0,127.0,127.0,5,1111,16.0,843.0,843.0
0.004,17,2,148,1,60,0.0,32.0,32.0,1,88,0.0,60.0,60.0
0.006,6,10,1547,5,764,1.0,496.0,496.0,5,783,1.0,515.0,515.0
40.064,17,10,676,5,460,10015.0,104.0,64.0,5,216,10015.0,20.0,15.0
361.816,6,21,1792,16,1030,24121.0,190.0,190.0,5,762,60009.0,461.0,247.0
0.072,6,10,1506,5,395,17.0,127.0,127.0,5,1111,14.0,843.0,843.0
0.094,6,10,1506,5,395,20.0,127.0,127.0,5,1111,21.0,843.0,843.0
0.04,17,2,169,1,62,0.0,34.0,34.0,1,107,0.0,79.0,79.0
0.012,6,10,1990,5,911,3.0,643.0,643.0,5,1079,3.0,811.0,811.0
0.005,6,14,3736,7,446,0.0,74.0,74.0,7,3290,0.0,1448.0,972.0
0.012,6,10,1983,5,910,3.0,642.0,642.0,5,1073,2.0,805.0,805.0
0.005,17,2,178,1,81,0.0,53.0,53.0,1,97,0.0,69.0,69.0
0.021,6,10,1990,5,911,5.0,643.0,643.0,5,1079,5.0,811.0,811.0
0.009,6,10,1677,5,827,2.0,559.0,559.0,5,850,2.0,582.0,582.0
0.008,6,10,1990,5,911,2.0,643.0,643.0,5,1079,1.0,811.0,811.0
0.009,6,10,1989,5,910,2.0,642.0,642.0,5,1079,2.0,811.0,811.0
0.005,6,10,1989,5,927,1.0,659.0,659.0,5,1062,1.0,794.0,794.0
40.068,17,10,676,5,460,10016.0,104.0,64.0,5,216,10015.0,20.0,15.0
0.01,6,10,1990,5,911,2.0,643.0,643.0,5,1079,2.0,811.0,811.0
0.015,6,10,1631,5,848,3.0,580.0,580.0,5,783,3.0,515.0,515.0
0.011,6,10,1989,5,910,2.0,642.0,642.0,5,1079,2.0,811.0,811.0
10.726,17,28,4423,14,1995,816.0,270.0,114.0,14,2428,816.0,587.0,145.0
240.481,6,37,9659,19,2175,13359.0,747.0,235.0,18,7484,14145.0,1402.0,595.0
40.064,17,10,676,5,460,10015.0,104.0,64.0,5,216,10015.0,20.0,15.0
40.062,17,10,676,5,460,10012.0,104.0,64.0,5,216,10014.0,20.0,15.0
0.073,6,10,1506,5,395,15.0,127.0,127.0,5,1111,15.0,843.0,843.0
0.001,17,2,180,1,66,0.0,38.0,38.0,1,114,0.0,86.0,86.0
0.119,6,10,1506,5,395,24.0,127.0,127.0,5,1111,28.0,843.0,843.0
0.006,6,10,1547,5,764,1.0,496.0,496.0,5,783,1.0,515.0,515.0
0.005,6,10,2000,5,927,1.0,659.0,659.0,5,1073,1.0,805.0,805.0
0.006,6,10,1972,5,910,1.0,642.0,642.0,5,1062,1.0,794.0,794.0
0.083,6,10,1506,5,395,20.0,127.0,127.0,5,1111,17.0,843.0,843.0
300.303,6,16,2170,9,684,37517.0,146.0,146.0,7,1486,50023.0,419.0,398.0
0.004,6,10,2006,5,927,1.0,659.0,659.0,5,1079,1.0,811.0,811.0
0.011,6,10,1983,5,910,2.0,642.0,642.0,5,1073,2.0,805.0,805.0
0.001,17,2,166,1,75,0.0,47.0,47.0,1,91,0.0,63.0,63.0
0.005,17,2,213,1,69,0.0,41.0,41.0,1,144,0.0,116.0,116.0
0.003,17,2,148,1,60,0.0,32.0,32.0,1,88,0.0,60.0,60.0
0.016,6,10,1972,5,910,3.0,642.0,642.0,5,1062,4.0,794.0,794.0
0.015,6,10,1989,5,910,3.0,642.0,642.0,5,1079,3.0,811.0,811.0
0.005,17,4,284,2,120,1.0,32.0,32.0,2,164,0.0,60.0,54.0
0.001,17,2,180,1,66,0.0,38.0,38.0,1,114,0.0,86.0,86.0
361.67,6,25,4189,13,3142,30139.0,494.0,494.0,12,1047,32878.0,83.0,83.0
0.003,17,2,148,1,60,0.0,32.0,32.0,1,88,0.0,60.0,60.0
0.006,6,10,1689,5,839,1.0,571.0,571.0,5,850,1.0,582.0,582.0
2.127,6,26,8071,16,2267,141.0,517.0,284.0,10,5804,235.0,1402.0,753.0
40.071,17,10,676,5,460,10016.0,104.0,64.0,5,216,10017.0,20.0,15.0
0.005,6,10,2007,5,928,1.0,660.0,660.0,5,1079,1.0,811.0,811.0
0.163,17,2,152,1,76,0.0,48.0,48.0,1,76,0.0,48.0,48.0
0.008,6,10,1762,5,911,1.0,643.0,643.0,5,851,2.0,583.0,583.0
0.008,6,10,1990,5,911,2.0,643.0,643.0,5,1079,2.0,811.0,811.0
0.083,6,10,1506,5,395,19.0,127.0,127.0,5,1111,15.0,843.0,843.0
0.086,6,10,1506,5,395,18.0,127.0,127.0,5,1111,20.0,843.0,843.0
0.004,6,10,1779,5,928,1.0,660.0,660.0,5,851,1.0,583.0,583.0
0.096,6,10,1506,5,395,20.0,127.0,127.0,5,1111,17.0,843.0,843.0
0.073,6,10,1506,5,395,16.0,127.0,127.0,5,1111,16.0,843.0,843.0
0.005,6,10,2006,5,927,1.0,659.0,659.0,5,1079,1.0,811.0,811.0
0.001,17,2,180,1,66,0.0,38.0,38.0,1,114,0.0,86.0,86.0
293.833,6,391,348113,204,22171,1447.0,2736.0,888.0,187,325942,1579.0,2804.0,1827.0
0.006,6,10,1547,5,764,1.0,496.0,496.0,5,783,1.0,515.0,515.0
0.041,17,4,352,2,130,0.0,37.0,37.0,2,222,37.0,89.0,83.0
19.128,17,36,5954,18,2921,1118.0,586.0,134.0,18,3033,1118.0,586.0,140.0
0.003,17,4,284,2,120,0.0,32.0,32.0,2,164,0.0,60.0,54.0
0.014,6,10,1762,5,911,3.0,643.0,643.0,5,851,3.0,583.0,583.0
0.009,6,10,1983,5,910,2.0,642.0,642.0,5,1073,2.0,805.0,805.0
0.222,6,16,2675,8,1401,31.0,533.0,325.0,8,1274,20.0,529.0,212.0
1.222,6,33,13432,19,5933,67.0,1360.0,732.0,14,7499,78.0,2720.0,769.0
0.124,6,10,1506,5,395,29.0,127.0,127.0,5,1111,28.0,843.0,843.0
0.092,6,10,1506,5,395,20.0,127.0,127.0,5,1111,21.0,843.0,843.0
0.015,6,10,1990,5,911,3.0,643.0,643.0,5,1079,3.0,811.0,811.0
0.001,17,2,136,1,60,0.0,32.0,32.0,1,76,0.0,48.0,48.0
0.005,6,10,2007,5,928,1.0,660.0,660.0,5,1079,1.0,811.0,811.0
0.071,17,2,148,1,60,0.0,32.0,32.0,1,88,0.0,60.0,60.0
0.005,17,2,230,1,68,0.0,40.0,40.0,1,162,0.0,134.0,134.0
0.001,17,2,142,1,63,0.0,35.0,35.0,1,79,0.0,51.0,51.0
0.104,6,10,1506,5,395,20.0,127.0,127.0,5,1111,23.0,843.0,843.0
0.019,6,10,1983,5,910,4.0,642.0,642.0,5,1073,4.0,805.0,805.0
0.004,17,2,148,1,60,0.0,32.0,32.0,1,88,0.0,60.0,60.0
0.012,6,10,1972,5,910,3.0,642.0,642.0,5,1062,3.0,794.0,794.0
1.239,6,33,13432,18,5893,72.0,2074.0,854.0,15,7539,75.0,2720.0,769.0
0.006,6,10,2006,5,927,1.0,659.0,659.0,5,1079,1.0,811.0,811.0
0.011,6,13,3735,7,497,1.0,125.0,125.0,6,3238,2.0,1470.0,1459.0
326.002,6,19,2158,6,1308,12003.0,494.0,494.0,13,850,27166.0,83.0,83.0
0.005,6,14,3799,7,509,0.0,137.0,137.0,7,3290,0.0,1448.0,972.0
0.016,6,10,1677,5,827,4.0,559.0,559.0,5,850,4.0,582.0,582.0
300.026,6,11,891,6,552,60003.0,232.0,232.0,5,339,75005.0,83.0,83.0
0.009,6,10,1972,5,910,2.0,642.0,642.0,5,1062,2.0,794.0,794.0
0.031,6,10,1990,5,911,7.0,643.0,643.0,5,1079,7.0,811.0,811.0
0.015,6,10,1972,5,910,3.0,642.0,642.0,5,1062,3.0,794.0,794.0
40.064,17,10,676,5,460,10012.0,104.0,64.0,5,216,10015.0,20.0,15.0
0.001,17,2,180,1,66,0.0,38.0,38.0,1,114,0.0,86.0,86.0
0.126,6,10,1506,5,395,29.0,127.0,127.0,5,1111,25.0,843.0,843.0
152.284,6,22,9233,11,1575,83.0,794.0,367.0,11,7658,15216.0,1360.0,1029.0
0.004,6,10,2006,5,927,1.0,659.0,659.0,5,1079,1.0,811.0,811.0
0.005,6,10,1547,5,764,1.0,496.0,496.0,5,783,1.0,515.0,515.0
0.01,6,10,1989,5,910,2.0,642.0,642.0,5,1079,2.0,811.0,811.0
0.101,6,10,1506,5,395,24.0,127.0,127.0,5,1111,22.0,843.0,843.0
0.004,6,10,1779,5,928,1.0,660.0,660.0,5,851,1.0,583.0,583.0
0.005,6,10,2006,5,927,1.0,659.0,659.0,5,1079,1.0,811.0,811.0
0.07,6,10,1506,5,395,14.0,127.0,127.0,5,1111,15.0,843.0,843.0
0.013,6,10,1990,5,911,3.0,643.0,643.0,5,1079,3.0,811.0,811.0
0.004,6,10,1779,5,928,1.0,660.0,660.0,5,851,1.0,583.0,583.0
0.005,6,10,1774,5,923,1.0,655.0,655.0,5,851,1.0,583.0,583.0
1.004,6,13,3930,7,2139,125.0,1328.0,923.0,6,1791,151.0,1539.0,1539.0
0.053,6,13,3913,7,495,8.0,123.0,123.0,6,3418,10.0,1650.0,1549.0
0.004,6,10,1774,5,923,1.0,655.0,655.0,5,851,1.0,583.0,583.0
0.088,6,10,1506,5,395,20.0,127.0,127.0,5,1111,19.0,843.0,843.0
0.014,6,14,3787,7,497,2.0,125.0,125.0,7,3290,2.0,1448.0,972.0
0.001,17,2,166,1,75,0.0,47.0,47.0,1,91,0.0,63.0,63.0
0.012,6,10,1990,5,911,3.0,643.0,643.0,5,1079,2.0,811.0,811.0
240.08,6,16,4480,9,963,30010.0,238.0,166.0,7,3517,40012.0,1402.0,786.0
0.003,17,2,162,1,65,0.0,37.0,37.0,1,97,0.0,69.0,69.0
0.01,6,10,1677,5,827,2.0,559.0,559.0,5,850,2.0,582.0,582.0
0.005,6,10,2007,5,928,1.0,660.0,660.0,5,1079,1.0,811.0,811.0
0.014,6,10,1990,5,911,3.0,643.0,643.0,5,1079,3.0,811.0,811.0
0.004,6,10,2007,5,928,1.0,660.0,660.0,5,1079,1.0,811.0,811.0
0.042,17,2,152,1,76,0.0,48.0,48.0,1,76,0.0,48.0,48.0
0.009,6,13,3735,7,497,1.0,125.0,125.0,6,3238,1.0,1470.0,1459.0
240.128,6,20,6645,10,1659,26680.0,562.0,381.0,10,4986,26680.0,1657.0,891.0
308.928,17,20,1124,10,716,34311.0,48.0,43.0,10,408,34310.0,20.0,12.0
0.005,6,14,3799,7,509,0.0,137.0,137.0,7,3290,0.0,1448.0,972.0
0.019,6,10,1983,5,910,4.0,642.0,642.0,5,1073,4.0,805.0,805.0
0.003,17,2,136,1,60,0.0,32.0,32.0,1,76,0.0,48.0,48.0
1.004,6,13,3922,7,2139,126.0,1328.0,923.0,6,1783,150.0,1539.0,1539.0
40.086,17,10,676,5,460,10020.0,104.0,64.0,5,216,10020.0,20.0,15.0
0.07,17,8,3613,4,1874,23.0,1350.0,440.0,4,1739,12.0,1350.0,406.0
0.014,6,10,1989,5,910,3.0,642.0,642.0,5,1079,3.0,811.0,811.0
0.005,6,10,1779,5,928,1.0,660.0,660.0,5,851,1.0,583.0,583.0
0.004,6,10,1702,5,863,1.0,595.0,595.0,5,839,0.0,571.0,571.0
0.004,6,10,2000,5,927,1.0,659.0,659.0,5,1073,1.0,805.0,805.0
0.006,6,10,1774,5,923,1.0,655.0,655.0,5,851,1.0,583.0,583.0
177.093,17,74,10549,37,2468,4919.0,44.0,38.0,37,8081,4919.0,261.0,190.0
0.0,17,2,179,1,62,0.0,34.0,34.0,1,117,0.0,89.0,89.0
0.0,17,2,136,1,60,0.0,32.0,32.0,1,76,0.0,48.0,48.0
0.003,17,2,185,1,73,0.0,45.0,45.0,1,112,0.0,84.0,84.0
40.066,17,10,676,5,460,10015.0,104.0,64.0,5,216,10015.0,20.0,15.0
0.007,6,12,1698,6,863,1.0,327.0,271.0,6,835,1.0,515.0,515.0
40.044,17,10,676,5,460,10010.0,104.0,64.0,5,216,10010.0,20.0,15.0
0.003,17,2,136,1,60,0.0,32.0,32.0,1,76,0.0,48.0,48.0
0.071,6,10,1506,5,395,14.0,127.0,127.0,5,1111,15.0,843.0,843.0
0.006,6,10,1547,5,764,1.0,496.0,496.0,5,783,1.0,515.0,515.0
0.014,6,10,1983,5,910,3.0,642.0,642.0,5,1073,3.0,805.0,805.0
0.043,17,2,234,1,61,0.0,33.0,33.0,1,173,0.0,145.0,145.0
122.511,6,26,9525,12,1627,87.0,794.0,367.0,14,7898,9414.0,1360.0,732.0
0.004,6,10,2006,5,927,1.0,659.0,659.0,5,1079,1.0,811.0,811.0
0.001,17,2,180,1,66,0.0,38.0,38.0,1,114,0.0,86.0,86.0
0.022,6,10,1989,5,910,5.0,642.0,642.0,5,1079,5.0,811.0,811.0
0.006,6,10,2007,5,928,1.0,660.0,660.0,5,1079,1.0,811.0,811.0
0.013,6,10,1972,5,910,3.0,642.0,642.0,5,1062,3.0,794.0,794.0
0.01,6,13,3735,7,497,1.0,125.0,125.0,6,3238,2.0,1470.0,1459.0
0.004,6,10,1989,5,927,1.0,659.0,659.0,5,1062,1.0,794.0,794.0
0.085,6,10,1506,5,395,20.0,127.0,127.0,5,1111,15.0,843.0,843.0
0.014,6,10,1989,5,910,3.0,642.0,642.0,5,1079,3.0,811.0,811.0
0.104,6,10,1506,5,395,24.0,127.0,127.0,5,1111,21.0,843.0,843.0
40.054,17,10,676,5,460,10011.0,104.0,64.0,5,216,10012.0,20.0,15.0
240.021,6,9,787,5,488,60005.0,232.0,232.0,4,299,80006.0,83.0,83.0
0.006,6,10,1547,5,764,1.0,496.0,496.0,5,783,1.0,515.0,515.0
0.108,6,10,1506,5,395,25.0,127.0,127.0,5,1111,24.0,843.0,843.0
0.005,17,2,170,1,65,0.0,37.0,37.0,1,105,0.0,77.0,77.0
0.006,6,10,1689,5,839,1.0,571.0,571.0,5,850,1.0,582.0,582.0
0.093,6,10,1506,5,395,20.0,127.0,127.0,5,1111,19.0,843.0,843.0
0.005,6,10,1643,5,860,1.0,592.0,592.0,5,783,1.0,515.0,515.0
0.007,6,10,2007,5,928,1.0,660.0,660.0,5,1079,1.0,811.0,811.0
0.147,6,10,1506,5,395,32.0,127.0,127.0,5,1111,34.0,843.0,843.0
0.004,17,2,148,1,60,0.0,32.0,32.0,1,88,0.0,60.0,60.0
0.215,6,16,2779,8,1397,30.0,533.0,324.0,8,1382,19.0,529.0,239.0
0.005,6,10,1989,5,927,1.0,659.0,659.0,5,1062,1.0,794.0,794.0
0.004,17,4,284,2,120,1.0,32.0,32.0,2,164,0.0,60.0,54.0
0.072,6,10,1506,5,395,16.0,127.0,127.0,5,1111,16.0,843.0,843.0
0.005,6,10,2007,5,928,1.0,660.0,660.0,5,1079,1.0,811.0,811.0
0.004,17,4,284,2,120,1.0,32.0,32.0,2,164,0.0,60.0,54.0
0.006,6,10,2000,5,927,1.0,659.0,659.0,5,1073,1.0,805.0,805.0
240.009,6,9,787,5,488,60002.0,232.0,232.0,4,299,80002.0,83.0,83.0
0.018,6,10,1631,5,848,4.0,580.0,580.0,5,783,4.0,515.0,515.0
0.134,17,4,352,2,130,1.0,37.0,37.0,2,222,55.0,89.0,83.0
0.006,6,10,1854,5,889,1.0,621.0,621.0,5,965,1.0,697.0,697.0
0.013,17,2,152,1,56,0.0,28.0,28.0,1,96,0.0,68.0,68.0
0.006,17,2,179,1,71,0.0,43.0,43.0,1,108,0.0,80.0,80.0
0.008,6,10,1989,5,910,1.0,642.0,642.0,5,1079,1.0,811.0,811.0
0.006,6,10,1547,5,764,1.0,496.0,496.0,5,783,1.0,515.0,515.0
0.06,17,2,152,1,76,0.0,48.0,48.0,1,76,0.0,48.0,48.0
0.007,17,2,213,1,69,0.0,41.0,41.0,1,144,0.0,116.0,116.0
0.016,6,10,1972,5,910,3.0,642.0,642.0,5,1062,4.0,794.0,794.0
0.078,6,10,1506,5,395,19.0,127.0,127.0,5,1111,16.0,843.0,843.0
0.053,17,2,152,1,76,0.0,48.0,48.0,1,76,0.0,48.0,48.0
40.071,17,10,676,5,460,10014.0,104.0,64.0,5,216,10017.0,20.0,15.0
0.157,6,10,1506,5,395,38.0,127.0,127.0,5,1111,37.0,843.0,843.0
0.009,6,10,1762,5,911,2.0,643.0,643.0,5,851,2.0,583.0,583.0
305.103,17,16,928,8,608,43566.0,48.0,48.0,8,320,43566.0,12.0,12.0
0.005,6,10,1989,5,927,1.0,659.0,659.0,5,1062,1.0,794.0,794.0
0.009,6,10,1989,5,910,2.0,642.0,642.0,5,1079,2.0,811.0,811.0
0.003,17,2,136,1,60,0.0,32.0,32.0,1,76,0.0,48.0,48.0
0.007,6,10,1983,5,910,1.0,642.0,642.0,5,1073,1.0,805.0,805.0
0.005,17,2,170,1,65,0.0,37.0,37.0,1,105,0.0,77.0,77.0
0.008,6,10,1983,5,910,2.0,642.0,642.0,5,1073,2.0,805.0,805.0
0.005,6,10,2006,5,927,1.0,659.0,659.0,5,1079,1.0,811.0,811.0
0.107,6,10,1506,5,395,23.0,127.0,127.0,5,1111,20.0,843.0,843.0
356.633,6,21,1795,16,1030,23775.0,190.0,190.0,5,765,60003.0,464.0,248.0
0.004,6,10,1989,5,927,1.0,659.0,659.0,5,1062,1.0,794.0,794.0
300.083,6,22,5093,11,2369,30008.0,1026.0,447.0,11,2724,30008.0,1162.0,431.0
0.074,6,10,1506,5,395,16.0,127.0,127.0,5,1111,14.0,843.0,843.0
0.07,6,10,1506,5,395,15.0,127.0,127.0,5,1111,15.0,843.0,843.0
0.015,6,10,1631,5,848,3.0,580.0,580.0,5,783,3.0,515.0,515.0
0.005,6,10,1989,5,927,1.0,659.0,659.0,5,1062,1.0,794.0,794.0
10.942,17,28,4422,14,1994,833.0,269.0,114.0,14,2428,833.0,587.0,145.0
1741.916,6,310,98707,189,87179,9265.0,2001.0,684.0,121,11528,14515.0,452.0,70.0
0.012,17,2,146,1,65,0.0,37.0,37.0,1,81,0.0,53.0,53.0
0.073,6,10,1506,5,395,15.0,127.0,127.0,5,1111,17.0,843.0,843.0
0.005,6,10,1779,5,928,1.0,660.0,660.0,5,851,1.0,583.0,583.0
0.086,6,10,1506,5,395,17.0,127.0,127.0,5,1111,19.0,843.0,843.0
0.019,6,10,1762,5,911,4.0,643.0,643.0,5,851,4.0,583.0,583.0
0.011,6,10,1990,5,911,2.0,643.0,643.0,5,1079,2.0,811.0,811.0
0.104,6,10,1506,5,395,23.0,127.0,127.0,5,1111,22.0,843.0,843.0
0.006,6,10,1547,5,764,1.0,496.0,496.0,5,783,1.0,515.0,515.0
0.077,6,10,1506,5,395,16.0,127.0,127.0,5,1111,18.0,843.0,843.0
241.528,6,397,348252,204,22127,1189.0,2736.0,960.0,193,326125,1257.0,2804.0,1727.0
291.64,6,384,346947,198,21856,1480.0,2736.0,888.0,186,325091,1576.0,2804.0,1833.0
293.06,6,393,348265,197,21819,1495.0,2736.0,826.0,196,326446,1502.0,2914.0,1747.0
0.005,6,10,1989,5,927,1.0,659.0,659.0,5,1062,1.0,794.0,794.0
0.004,6,10,1702,5,863,1.0,595.0,595.0,5,839,0.0,571.0,571.0
0.006,6,10,1547,5,764,1.0,496.0,496.0,5,783,1.0,515.0,515.0
0.027,6,10,1989,5,910,6.0,642.0,642.0,5,1079,6.0,811.0,811.0
0.005,17,2,164,1,74,0.0,46.0,46.0,1,90,0.0,62.0,62.0
0.108,6,10,1506,5,395,23.0,127.0,127.0,5,1111,23.0,843.0,843.0
0.069,17,8,3613,4,1874,23.0,1350.0,440.0,4,1739,12.0,1350.0,406.0
0.082,6,10,1506,5,395,19.0,127.0,127.0,5,1111,19.0,843.0,843.0
0.009,6,10,1762,5,911,2.0,643.0,643.0,5,851,2.0,583.0,583.0
0.007,6,10,1774,5,923,1.0,655.0,655.0,5,851,1.0,583.0,583.0
0.006,17,2,170,1,65,0.0,37.0,37.0,1,105,0.0,77.0,77.0
241.204,6,389,347912,197,21776,1230.0,2736.0,960.0,192,326136,1262.0,2804.0,1737.0
0.012,6,10,1989,5,910,2.0,642.0,642.0,5,1079,2.0,811.0,811.0
0.001,17,2,180,1,66,0.0,38.0,38.0,1,114,0.0,86.0,86.0
0.005,6,14,3736,7,446,0.0,74.0,74.0,7,3290,0.0,1448.0,972.0
40.049,17,10,676,5,460,10011.0,104.0,64.0,5,216,10011.0,20.0,15.0
240.255,6,42,8056,21,2859,12012.0,517.0,249.0,21,5197,12012.0,1467.0,453.0
0.005,17,2,164,1,74,0.0,46.0,46.0,1,90,0.0,62.0,62.0
0.005,6,10,2006,5,927,1.0,659.0,659.0,5,1079,1.0,811.0,811.0
0.006,6,10,2007,5,928,1.0,660.0,660.0,5,1079,1.0,811.0,811.0
40.081,17,10,676,5,460,10013.0,104.0,64.0,5,216,10019.0,20.0,15.0
0.004,6,10,1774,5,923,1.0,655.0,655.0,5,851,1.0,583.0,583.0
40.068,17,10,676,5,460,10015.0,104.0,64.0,5,216,10016.0,20.0,15.0
0.014,6,10,1989,5,910,3.0,642.0,642.0,5,1079,3.0,811.0,811.0
0.005,6,10,1547,5,764,1.0,496.0,496.0,5,783,1.0,515.0,515.0
40.053,17,10,676,5,460,10012.0,104.0,64.0,5,216,10012.0,20.0,15.0
0.017,6,10,1983,5,910,4.0,642.0,642.0,5,1073,4.0,805.0,805.0
0.003,17,2,148,1,60,0.0,32.0,32.0,1,88,0.0,60.0,60.0
0.004,17,2,148,1,60,0.0,32.0,32.0,1,88,0.0,60.0,60.0
0.014,6,10,1983,5,910,3.0,642.0,642.0,5,1073,3.0,805.0,805.0
0.163,6,10,1506,5,395,37.0,127.0,127.0,5,1111,32.0,843.0,843.0
0.009,6,10,1972,5,910,2.0,642.0,642.0,5,1062,2.0,794.0,794.0
0.015,6,10,1983,5,910,3.0,642.0,642.0,5,1073,3.0,805.0,805.0
0.011,6,10,1990,5,911,2.0,643.0,643.0,5,1079,2.0,811.0,811.0
0.178,17,2,152,1,76,0.0,48.0,48.0,1,76,0.0,48.0,48.0
300.726,6,37,9902,20,4424,15827.0,1848.0,718.0,17,5478,534.0,2667.0,435.0
0.013,6,10,1972,5,910,3.0,642.0,642.0,5,1062,3.0,794.0,794.0
0.004,6,10,2006,5,927,1.0,659.0,659.0,5,1079,1.0,811.0,811.0
0.001,17,2,136,1,60,0.0,32.0,32.0,1,76,0.0,48.0,48.0
0.019,6,10,1990,5,911,4.0,643.0,643.0,5,1079,4.0,811.0,811.0
0.006,6,10,1643,5,860,1.0,592.0,592.0,5,783,1.0,515.0,515.0
0.005,6,10,2006,5,927,1.0,659.0,659.0,5,1079,1.0,811.0,811.0
240.115,6,16,4481,9,963,30014.0,238.0,166.0,7,3518,40018.0,1402.0,786.0
40.06,17,10,676,5,460,10014.0,104.0,64.0,5,216,10014.0,20.0,15.0
300.876,6,38,12569,20,7051,15835.0,4080.0,1243.0,18,5518,512.0,2667.0,435.0
0.088,6,10,1506,5,395,21.0,127.0,127.0,5,1111,21.0,843.0,843.0
293.336,6,330,345779,120,19117,2465.0,2692.0,858.0,210,326662,1403.0,2804.0,1627.0
0.009,6,10,1990,5,911,2.0,643.0,643.0,5,1079,2.0,811.0,811.0
0.001,17,2,180,1,66,0.0,38.0,38.0,1,114,0.0,86.0,86.0
0.006,6,10,1643,5,860,1.0,592.0,592.0,5,783,1.0,515.0,515.0
0.003,17,2,136,1,60,0.0,32.0,32.0,1,76,0.0,48.0,48.0
0.03,6,13,3735,7,497,5.0,125.0,125.0,6,3238,6.0,1470.0,1459.0
0.004,6,10,1989,5,927,1.0,659.0,659.0,5,1062,1.0,794.0,794.0
0.084,6,10,1506,5,395,18.0,127.0,127.0,5,1111,20.0,843.0,843.0
0.011,6,10,1983,5,910,2.0,642.0,642.0,5,1073,2.0,805.0,805.0
0.005,6,10,2006,5,927,1.0,659.0,659.0,5,1079,1.0,811.0,811.0
0.005,17,2,170,1,65,0.0,37.0,37.0,1,105,0.0,77.0,77.0
0.008,6,10,1983,5,910,2.0,642.0,642.0,5,1073,1.0,805.0,805.0
360.03,6,21,3981,13,3142,30002.0,494.0,494.0,8,839,51432.0,83.0,83.0
0.011,6,13,3735,7,497,1.0,125.0,125.0,6,3238,2.0,1470.0,1459.0
0.102,6,10,1506,5,395,24.0,127.0,127.0,5,1111,20.0,843.0,843.0
15.219,17,38,20012,21,17015,759.0,1350.0,782.0,17,2997,949.0,1350.0,148.0
0.009,6,10,1989,5,910,2.0,642.0,642.0,5,1079,2.0,811.0,811.0
0.015,6,10,1677,5,827,3.0,559.0,559.0,5,850,3.0,582.0,582.0
1799.913,6,137,6590,76,3625,23995.0,39.0,39.0,61,2965,29994.0,35.0,35.0
0.004,6,10,2006,5,927,1.0,659.0,659.0,5,1079,1.0,811.0,811.0
0.005,6,13,3747,7,509,0.0,137.0,137.0,6,3238,0.0,1470.0,1459.0
0.009,6,10,1972,5,910,2.0,642.0,642.0,5,1062,2.0,794.0,794.0
0.005,6,10,1989,5,927,1.0,659.0,659.0,5,1062,1.0,794.0,794.0
0.006,17,2,169,1,62,0.0,34.0,34.0,1,107,0.0,79.0,79.0
0.005,6,10,1989,5,927,1.0,659.0,659.0,5,1062,1.0,794.0,794.0
0.005,6,10,2007,5,928,1.0,660.0,660.0,5,1079,1.0,811.0,811.0
0.005,6,10,2006,5,927,1.0,659.0,659.0,5,1079,1.0,811.0,811.0
0.074,6,10,1506,5,395,15.0,127.0,127.0,5,1111,14.0,843.0,843.0
0.012,6,10,1989,5,910,2.0,642.0,642.0,5,1079,2.0,811.0,811.0
0.001,17,2,136,1,60,0.0,32.0,32.0,1,76,0.0,48.0,48.0
173.032,17,84,12220,42,2826,4220.0,44.0,39.0,42,9394,4220.0,261.0,195.0
300.524,6,27,7433,16,1409,20034.0,217.0,142.0,11,6024,24044.0,1679.0,777.0
0.005,17,2,148,1,60,0.0,32.0,32.0,1,88,0.0,60.0,60.0
0.004,6,10,1989,5,927,1.0,659.0,659.0,5,1062,1.0,794.0,794.0
0.005,17,2,170,1,65,0.0,37.0,37.0,1,105,0.0,77.0,77.0
0.101,6,10,1506,5,395,24.0,127.0,127.0,5,1111,22.0,843.0,843.0
0.02,6,10,1762,5,911,4.0,643.0,643.0,5,851,4.0,583.0,583.0
300.347,6,16,2170,9,684,37522.0,146.0,146.0,7,1486,50029.0,419.0,398.0
0.01,6,10,1990,5,911,2.0,643.0,643.0,5,1079,2.0,811.0,811.0
285.231,6,30,6574,16,1433,19015.0,517.0,290.0,14,5141,21940.0,2379.0,1104.0
0.005,6,13,3747,7,509,0.0,137.0,137.0,6,3238,0.0,1470.0,1459.0
10.822,17,28,4416,14,1993,824.0,268.0,114.0,14,2423,823.0,586.0,145.0
0.013,6,10,1972,5,910,3.0,642.0,642.0,5,1062,3.0,794.0,794.0
0.062,6,10,1506,5,395,15.0,127.0,127.0,5,1111,13.0,843.0,843.0
0.01,6,10,1631,5,848,2.0,580.0,580.0,5,783,2.0,515.0,515.0
0.005,6,10,2007,5,928,1.0,660.0,660.0,5,1079,1.0,811.0,811.0
0.005,6,10,2006,5,927,1.0,659.0,659.0,5,1079,1.0,811.0,811.0
0.064,6,10,1506,5,395,13.0,127.0,127.0,5,1111,14.0,843.0,843.0
0.003,17,2,160,1,72,0.0,44.0,44.0,1,88,0.0,60.0,60.0
0.014,6,10,1631,5,848,3.0,580.0,580.0,5,783,3.0,515.0,515.0
40.053,17,10,676,5,460,10012.0,104.0,64.0,5,216,10012.0,20.0,15.0
0.005,17,2,214,1,75,0.0,47.0,47.0,1,139,0.0,111.0,111.0
300.275,6,17,2222,10,736,33345.0,146.0,146.0,7,1486,50018.0,419.0,398.0
0.005,6,10,2006,5,927,1.0,659.0,659.0,5,1079,1.0,811.0,811.0
0.015,6,13,3735,7,497,2.0,125.0,125.0,6,3238,3.0,1470.0,1459.0
0.005,17,2,180,1,66,0.0,38.0,38.0,1,114,0.0,86.0,86.0
0.008,6,10,1689,5,839,1.0,571.0,571.0,5,850,2.0,582.0,582.0
0.006,6,10,1779,5,928,1.0,660.0,660.0,5,851,1.0,583.0,583.0
0.005,17,2,180,1,66,0.0,38.0,38.0,1,114,0.0,86.0,86.0
11.475,17,28,4391,14,2313,870.0,588.0,137.0,14,2078,870.0,269.0,120.0
40.077,17,10,676,5,460,10014.0,104.0,64.0,5,216,10015.0,20.0,15.0
0.005,17,2,170,1,65,0.0,37.0,37.0,1,105,0.0,77.0,77.0
0.001,17,2,180,1,66,0.0,38.0,38.0,1,114,0.0,86.0,86.0
0.094,6,10,1506,5,395,20.0,127.0,127.0,5,1111,21.0,843.0,843.0
0.005,6,10,2007,5,928,1.0,660.0,660.0,5,1079,1.0,811.0,811.0
0.006,17,2,212,1,74,0.0,46.0,46.0,1,138,0.0,110.0,110.0
0.004,6,10,1989,5,927,1.0,659.0,659.0,5,1062,1.0,794.0,794.0
0.173,6,3,453,2,321,173.0,241.0,241.0,1,132,0.0,92.0,92.0
0.098,6,10,1506,5,395,21.0,127.0,127.0,5,1111,20.0,843.0,843.0
40.07,17,10,676,5,460,10016.0,104.0,64.0,5,216,10016.0,20.0,15.0
0.004,6,10,2007,5,928,1.0,660.0,660.0,5,1079,1.0,811.0,811.0
240.049,6,9,799,5,500,60012.0,232.0,232.0,4,299,80002.0,83.0,83.0
0.012,6,10,1983,5,910,2.0,642.0,642.0,5,1073,2.0,805.0,805.0
0.004,6,10,2006,5,927,1.0,659.0,659.0,5,1079,1.0,811.0,811.0
0.012,6,10,1677,5,827,2.0,559.0,559.0,5,850,3.0,582.0,582.0
0.005,6,10,1774,5,923,1.0,655.0,655.0,5,851,1.0,583.0,583.0
0.005,17,2,144,1,64,0.0,36.0,36.0,1,80,0.0,52.0,52.0
0.041,17,2,148,1,60,0.0,32.0,32.0,1,88,0.0,60.0,60.0
0.009,6,12,1926,6,1189,1.0,659.0,434.0,6,737,1.0,417.0,417.0
0.055,6,10,1506,5,395,11.0,127.0,127.0,5,1111,13.0,843.0,843.0
0.12,6,10,1506,5,395,28.0,127.0,127.0,5,1111,27.0,843.0,843.0
0.014,6,10,1972,5,910,3.0,642.0,642.0,5,1062,3.0,794.0,794.0
240.081,6,16,4481,9,963,30010.0,238.0,166.0,7,3518,40012.0,1402.0,786.0
240.11,6,16,4481,9,963,30013.0,238.0,166.0,7,3518,40017.0,1402.0,786.0
295.152,6,412,349103,204,22170,1453.0,2691.0,825.0,208,326933,1425.0,2804.0,1629.0
0.01,6,10,1989,5,910,2.0,642.0,642.0,5,1079,2.0,811.0,811.0
0.018,6,10,1990,5,911,4.0,643.0,643.0,5,1079,4.0,811.0,811.0
0.008,17,2,194,1,59,0.0,31.0,31.0,1,135,0.0,107.0,107.0
600.418,6,40,14571,21,3908,30020.0,655.0,401.0,19,10663,33356.0,1402.0,879.0
11.212,17,28,4421,14,1993,849.0,268.0,114.0,14,2428,849.0,587.0,145.0
0.006,6,10,2000,5,927,1.0,659.0,659.0,5,1073,1.0,805.0,805.0
0.126,17,4,420,2,122,0.0,33.0,33.0,2,298,122.0,145.0,121.0
0.191,6,3,453,2,321,191.0,241.0,241.0,1,132,0.0,92.0,92.0
1.065,6,30,12709,17,3312,66.0,1360.0,517.0,13,9397,74.0,2720.0,985.0
0.005,6,13,3747,7,509,0.0,137.0,137.0,6,3238,0.0,1470.0,1459.0
0.014,6,13,3735,7,497,2.0,125.0,125.0,6,3238,2.0,1470.0,1459.0
40.07,17,10,676,5,460,10012.0,104.0,64.0,5,216,10014.0,20.0,15.0
0.005,6,10,2006,5,927,1.0,659.0,659.0,5,1079,1.0,811.0,811.0
0.005,17,2,144,1,64,0.0,36.0,36.0,1,80,0.0,52.0,52.0
0.005,6,10,2007,5,928,1.0,660.0,660.0,5,1079,1.0,811.0,811.0
0.049,6,19,9922,11,704,4.0,124.0,124.0,8,9218,6.0,2896.0,2198.0
0.005,17,2,164,1,74,0.0,46.0,46.0,1,90,0.0,62.0,62.0
0.236,6,16,2777,8,1395,33.0,533.0,323.0,8,1382,22.0,529.0,239.0
0.01,6,10,1689,5,839,2.0,571.0,571.0,5,850,2.0,582.0,582.0
0.006,17,2,179,1,71,0.0,43.0,43.0,1,108,0.0,80.0,80.0
0.016,6,10,1677,5,827,4.0,559.0,559.0,5,850,3.0,582.0,582.0
0.072,17,2,166,1,75,0.0,47.0,47.0,1,91,0.0,63.0,63.0
0.005,17,2,164,1,74,0.0,46.0,46.0,1,90,0.0,62.0,62.0
0.006,6,10,1547,5,764,1.0,496.0,496.0,5,783,1.0,515.0,515.0
0.006,6,10,1547,5,764,1.0,496.0,496.0,5,783,1.0,515.0,515.0
0.009,6,10,1990,5,911,2.0,643.0,643.0,5,1079,2.0,811.0,811.0
0.011,6,10,1972,5,910,2.0,642.0,642.0,5,1062,2.0,794.0,794.0
0.088,6,10,1506,5,395,20.0,127.0,127.0,5,1111,19.0,843.0,843.0
0.098,6,10,1506,5,395,22.0,127.0,127.0,5,1111,23.0,843.0,843.0
0.008,6,12,1926,6,1189,1.0,659.0,434.0,6,737,1.0,417.0,417.0
0.006,6,10,1643,5,860,1.0,592.0,592.0,5,783,1.0,515.0,515.0
0.112,6,10,1506,5,395,24.0,127.0,127.0,5,1111,25.0,843.0,843.0
300.317,6,16,2170,9,684,37519.0,146.0,146.0,7,1486,50025.0,419.0,398.0
0.003,17,2,136,1,60,0.0,32.0,32.0,1,76,0.0,48.0,48.0
0.004,6,10,2006,5,927,1.0,659.0,659.0,5,1079,1.0,811.0,811.0
0.005,6,10,1702,5,863,1.0,595.0,595.0,5,839,1.0,571.0,571.0
0.006,6,10,1547,5,764,1.0,496.0,496.0,5,783,1.0,515.0,515.0
162.354,17,80,11240,40,2672,4162.0,44.0,38.0,40,8568,4162.0,239.0,186.0
0.004,17,2,148,1,60,0.0,32.0,32.0,1,88,0.0,60.0,60.0
0.005,6,10,2000,5,927,1.0,659.0,659.0,5,1073,1.0,805.0,805.0
0.01,6,13,3735,7,497,1.0,125.0,125.0,6,3238,2.0,1470.0,1459.0
0.012,6,10,1983,5,910,3.0,642.0,642.0,5,1073,2.0,805.0,805.0
0.001,17,2,180,1,66,0.0,38.0,38.0,1,114,0.0,86.0,86.0
0.042,17,2,148,1,60,0.0,32.0,32.0,1,88,0.0,60.0,60.0
240.014,6,9,787,5,488,60003.0,232.0,232.0,4,299,80003.0,83.0,83.0
0.006,6,10,2006,5,927,1.0,659.0,659.0,5,1079,1.0,811.0,811.0
0.077,6,10,1506,5,395,18.0,127.0,127.0,5,1111,15.0,843.0,843.0
0.005,6,10,1547,5,764,1.0,496.0,496.0,5,783,1.0,515.0,515.0
0.01,6,10,1631,5,848,2.0,580.0,580.0,5,783,2.0,515.0,515.0
0.092,6,10,1506,5,395,19.0,127.0,127.0,5,1111,21.0,843.0,843.0
308.645,17,20,1124,10,716,34287.0,48.0,43.0,10,408,34287.0,20.0,12.0
0.124,6,10,1506,5,395,25.0,127.0,127.0,5,1111,30.0,843.0,843.0
40.071,17,10,676,5,460,10014.0,104.0,64.0,5,216,10016.0,20.0,15.0
0.014,6,10,1990,5,911,3.0,643.0,643.0,5,1079,3.0,811.0,811.0
290.571,6,392,348106,187,21296,1562.0,2736.0,889.0,205,326810,1424.0,2804.0,1655.0
0.007,6,10,1989,5,910,1.0,642.0,642.0,5,1079,1.0,811.0,811.0
0.005,6,10,2006,5,927,1.0,659.0,659.0,5,1079,1.0,811.0,811.0
0.013,6,10,1989,5,910,3.0,642.0,642.0,5,1079,3.0,811.0,811.0
0.006,6,10,1547,5,764,1.0,496.0,496.0,5,783,1.0,515.0,515.0
15.073,17,16,10617,9,8280,1880.0,1350.0,892.0,7,2337,2509.0,1350.0,305.0
0.009,6,10,1990,5,911,2.0,643.0,643.0,5,1079,2.0,811.0,811.0
0.004,6,10,1702,5,863,0.0,595.0,595.0,5,839,1.0,571.0,571.0
0.006,6,10,1547,5,764,1.0,496.0,496.0,5,783,1.0,515.0,515.0
0.038,17,2,182,1,65,0.0,37.0,37.0,1,117,0.0,89.0,89.0
0.007,6,10,1547,5,764,1.0,496.0,496.0,5,783,1.0,515.0,515.0
0.019,6,10,1983,5,910,4.0,642.0,642.0,5,1073,4.0,805.0,805.0
0.005,17,2,152,1,68,0.0,40.0,40.0,1,84,0.0,56.0,56.0
0.004,6,10,1702,5,863,1.0,595.0,595.0,5,839,1.0,571.0,571.0
40.072,17,10,676,5,460,10012.0,104.0,64.0,5,216,10017.0,20.0,15.0
308.512,17,20,1124,10,716,34264.0,48.0,43.0,10,408,34264.0,20.0,12.0
0.101,6,10,1506,5,395,24.0,127.0,127.0,5,1111,20.0,843.0,843.0
0.005,6,10,2006,5,927,1.0,659.0,659.0,5,1079,1.0,811.0,811.0
0.004,6,10,2006,5,927,1.0,659.0,659.0,5,1079,1.0,811.0,811.0
0.006,6,10,1547,5,764,1.0,496.0,496.0,5,783,1.0,515.0,515.0
0.005,6,10,1989,5,927,1.0,659.0,659.0,5,1062,1.0,794.0,794.0
0.005,6,10,2006,5,927,1.0,659.0,659.0,5,1079,1.0,811.0,811.0
0.082,6,10,1506,5,395,20.0,127.0,127.0,5,1111,16.0,843.0,843.0
0.005,6,10,2007,5,928,1.0,660.0,660.0,5,1079,1.0,811.0,811.0
0.005,17,2,213,1,69,0.0,41.0,41.0,1,144,0.0,116.0,116.0
11.14,17,28,4422,14,1994,844.0,269.0,114.0,14,2428,844.0,587.0,145.0
0.005,17,2,222,1,65,0.0,37.0,37.0,1,157,0.0,129.0,129.0
0.008,17,2,194,1,59,0.0,31.0,31.0,1,135,0.0,107.0,107.0
0.004,17,2,148,1,60,0.0,32.0,32.0,1,88,0.0,60.0,60.0
0.013,6,10,1989,5,910,3.0,642.0,642.0,5,1079,3.0,811.0,811.0
0.001,17,2,180,1,66,0.0,38.0,38.0,1,114,0.0,86.0,86.0
300.326,6,27,7433,16,1409,20021.0,217.0,142.0,11,6024,24028.0,1679.0,777.0
0.007,6,10,1547,5,764,1.0,496.0,496.0,5,783,1.0,515.0,515.0
0.04,17,2,182,1,65,0.0,37.0,37.0,1,117,0.0,89.0,89.0
0.123,17,2,80,1,32,0.0,4.0,4.0,1,48,0.0,20.0,20.0
40.073,17,10,676,5,460,10015.0,104.0,64.0,5,216,10017.0,20.0,15.0
0.034,17,2,198,1,91,0.0,63.0,63.0,1,107,0.0,79.0,79.0
0.005,6,10,1989,5,927,1.0,659.0,659.0,5,1062,1.0,794.0,794.0
0.008,6,10,1989,5,910,2.0,642.0,642.0,5,1079,2.0,811.0,811.0
0.005,6,10,1779,5,928,1.0,660.0,660.0,5,851,1.0,583.0,583.0
0.02,6,10,1989,5,910,5.0,642.0,642.0,5,1079,5.0,811.0,811.0
0.129,17,2,80,1,32,0.0,4.0,4.0,1,48,0.0,20.0,20.0
0.011,6,10,1972,5,910,2.0,642.0,642.0,5,1062,2.0,794.0,794.0
0.006,6,10,1547,5,764,1.0,496.0,496.0,5,783,1.0,515.0,515.0
0.005,6,13,3747,7,509,0.0,137.0,137.0,6,3238,1.0,1470.0,1459.0
0.005,6,10,1854,5,889,1.0,621.0,621.0,5,965,1.0,697.0,697.0
0.002,17,2,136,1,60,0.0,32.0,32.0,1,76,0.0,48.0,48.0
0.005,6,10,2006,5,927,1.0,659.0,659.0,5,1079,1.0,811.0,811.0
0.001,17,2,180,1,66,0.0,38.0,38.0,1,114,0.0,86.0,86.0
0.109,6,10,1506,5,395,25.0,127.0,127.0,5,1111,25.0,843.0,843.0
0.002,17,2,136,1,60,0.0,32.0,32.0,1,76,0.0,48.0,48.0
0.006,6,10,1547,5,764,1.0,496.0,496.0,5,783,1.0,515.0,515.0
0.005,6,13,3747,7,509,0.0,137.0,137.0,6,3238,0.0,1470.0,1459.0
0.014,6,10,1990,5,911,3.0,643.0,643.0,5,1079,3.0,811.0,811.0
0.004,17,2,136,1,60,0.0,32.0,32.0,1,76,0.0,48.0,48.0
0.004,6,10,2000,5,927,1.0,659.0,659.0,5,1073,1.0,805.0,805.0
0.006,6,10,1854,5,889,1.0,621.0,621.0,5,965,1.0,697.0,697.0
0.216,6,16,2778,8,1396,30.0,533.0,324.0,8,1382,19.0,529.0,239.0
0.013,6,10,1762,5,911,3.0,643.0,643.0,5,851,3.0,583.0,583.0
0.007,6,10,1972,5,910,1.0,642.0,642.0,5,1062,1.0,794.0,794.0
0.133,6,10,1506,5,395,32.0,127.0,127.0,5,1111,28.0,843.0,843.0
0.107,6,10,1506,5,395,24.0,127.0,127.0,5,1111,25.0,843.0,843.0
11.559,17,28,4389,14,2312,876.0,587.0,137.0,14,2077,876.0,268.0,120.0
0.013,6,10,1677,5,827,3.0,559.0,559.0,5,850,3.0,582.0,582.0
0.082,6,10,1506,5,395,19.0,127.0,127.0,5,1111,16.0,843.0,843.0
0.068,6,10,1506,5,395,14.0,127.0,127.0,5,1111,16.0,843.0,843.0
0.007,6,10,1689,5,839,1.0,571.0,571.0,5,850,1.0,582.0,582.0
0.005,6,10,1779,5,928,1.0,660.0,660.0,5,851,1.0,583.0,583.0
0.006,6,14,3799,7,509,0.0,137.0,137.0,7,3290,1.0,1448.0,972.0
0.005,6,13,3747,7,509,0.0,137.0,137.0,6,3238,0.0,1470.0,1459.0
0.006,6,10,1547,5,764,1.0,496.0,496.0,5,783,1.0,515.0,515.0
0.072,6,10,1506,5,395,14.0,127.0,127.0,5,1111,15.0,843.0,843.0
0.012,6,10,1631,5,848,2.0,580.0,580.0,5,783,3.0,515.0,515.0
11.102,17,28,4423,14,1994,841.0,269.0,114.0,14,2429,841.0,588.0,145.0
0.04,17,4,352,2,130,0.0,37.0,37.0,2,222,3.0,89.0,83.0
0.004,6,10,2000,5,927,1.0,659.0,659.0,5,1073,1.0,805.0,805.0
0.004,17,2,136,1,60,0.0,32.0,32.0,1,76,0.0,48.0,48.0
170.218,17,76,10680,38,2537,4600.0,44.0,38.0,38,8143,4600.0,239.0,186.0
0.005,17,2,144,1,64,0.0,36.0,36.0,1,80,0.0,52.0,52.0
0.005,6,10,2006,5,927,1.0,659.0,659.0,5,1079,1.0,811.0,811.0
0.125,6,10,1506,5,395,25.0,127.0,127.0,5,1111,28.0,843.0,843.0
0.005,6,14,3799,7,509,0.0,137.0,137.0,7,3290,0.0,1448.0,972.0
0.005,6,10,1989,5,927,1.0,659.0,659.0,5,1062,1.0,794.0,794.0
0.005,6,13,3747,7,509,0.0,137.0,137.0,6,3238,0.0,1470.0,1459.0
0.149,6,10,1506,5,395,35.0,127.0,127.0,5,1111,33.0,843.0,843.0
0.111,6,10,1506,5,395,25.0,127.0,127.0,5,1111,26.0,843.0,843.0
0.127,17,2,80,1,32,0.0,4.0,4.0,1,48,0.0,20.0,20.0
0.061,17,2,80,1,32,0.0,4.0,4.0,1,48,0.0,20.0,20.0
0.005,6,10,1989,5,927,1.0,659.0,659.0,5,1062,1.0,794.0,794.0
0.006,17,2,144,1,64,0.0,36.0,36.0,1,80,0.0,52.0,52.0
0.119,6,10,1506,5,395,26.0,127.0,127.0,5,1111,25.0,843.0,843.0
0.009,6,10,1983,5,910,2.0,642.0,642.0,5,1073,2.0,805.0,805.0
0.015,6,10,1989,5,910,3.0,642.0,642.0,5,1079,3.0,811.0,811.0
0.006,6,10,2000,5,927,1.0,659.0,659.0,5,1073,1.0,805.0,805.0
240.127,6,32,9308,16,6737,16008.0,1808.0,656.0,16,2571,16008.0,580.0,216.0
0.014,6,10,1972,5,910,3.0,642.0,642.0,5,1062,3.0,794.0,794.0
0.075,6,10,1506,5,395,16.0,127.0,127.0,5,1111,16.0,843.0,843.0
0.007,6,10,1547,5,764,1.0,496.0,496.0,5,783,1.0,515.0,515.0
1771.626,17,120,11460,60,5460,30027.0,63.0,63.0,60,6000,30027.0,72.0,72.0
0.006,6,10,1689,5,839,1.0,571.0,571.0,5,850,1.0,582.0,582.0
0.014,6,10,1631,5,848,3.0,580.0,580.0,5,783,3.0,515.0,515.0
0.074,6,10,1506,5,395,14.0,127.0,127.0,5,1111,16.0,843.0,843.0
0.004,6,10,2007,5,928,1.0,660.0,660.0,5,1079,1.0,811.0,811.0
0.146,17,4,580,2,122,142.0,33.0,33.0,2,458,108.0,307.0,201.0
0.009,6,14,3787,7,497,1.0,125.0,125.0,7,3290,1.0,1448.0,972.0
0.063,6,10,1506,5,395,14.0,127.0,127.0,5,1111,11.0,843.0,843.0
0.014,6,10,1989,5,910,3.0,642.0,642.0,5,1079,3.0,811.0,811.0
0.005,6,10,1689,5,839,1.0,571.0,571.0,5,850,1.0,582.0,582.0
40.072,17,10,676,5,460,10015.0,104.0,64.0,5,216,10017.0,20.0,15.0
0.005,6,10,1689,5,839,1.0,571.0,571.0,5,850,1.0,582.0,582.0
0.016,6,10,1972,5,910,3.0,642.0,642.0,5,1062,3.0,794.0,794.0
0.01,6,10,1983,5,910,2.0,642.0,642.0,5,1073,2.0,805.0,805.0
0.015,6,10,1631,5,848,3.0,580.0,580.0,5,783,3.0,515.0,515.0
0.004,17,2,148,1,60,0.0,32.0,32.0,1,88,0.0,60.0,60.0
0.015,6,10,1689,5,839,3.0,571.0,571.0,5,850,3.0,582.0,582.0
0.038,17,2,136,1,60,0.0,32.0,32.0,1,76,0.0,48.0,48.0
0.014,6,10,1972,5,910,3.0,642.0,642.0,5,1062,3.0,794.0,794.0
0.013,6,10,1990,5,911,3.0,643.0,643.0,5,1079,3.0,811.0,811.0
0.118,6,10,1506,5,395,25.0,127.0,127.0,5,1111,25.0,843.0,843.0
0.04,17,2,148,1,60,0.0,32.0,32.0,1,88,0.0,60.0,60.0
1778.201,17,140,44240,72,22752,25040.0,288.0,288.0,68,21488,26529.0,288.0,288.0
0.038,17,2,182,1,65,0.0,37.0,37.0,1,117,0.0,89.0,89.0
0.007,17,2,166,1,75,0.0,47.0,47.0,1,91,0.0,63.0,63.0
15.072,17,14,9191,8,6902,2148.0,1350.0,834.0,6,2289,3008.0,1350.0,353.0
0.006,17,2,179,1,71,0.0,43.0,43.0,1,108,0.0,80.0,80.0
0.011,6,10,1972,5,910,2.0,642.0,642.0,5,1062,2.0,794.0,794.0
0.069,6,10,1506,5,395,15.0,127.0,127.0,5,1111,13.0,843.0,843.0
0.012,6,10,1983,5,910,2.0,642.0,642.0,5,1073,3.0,805.0,805.0
0.005,6,10,1779,5,928,1.0,660.0,660.0,5,851,1.0,583.0,583.0
0.005,6,10,2006,5,927,1.0,659.0,659.0,5,1079,1.0,811.0,811.0
0.006,17,2,170,1,65,0.0,37.0,37.0,1,105,0.0,77.0,77.0
0.004,6,10,1779,5,928,1.0,660.0,660.0,5,851,1.0,583.0,583.0
0.153,6,12,2996,7,549,25.0,177.0,177.0,5,2447,33.0,1402.0,1089.0
0.005,6,10,1989,5,927,1.0,659.0,659.0,5,1062,1.0,794.0,794.0
0.038,17,2,152,1,76,0.0,48.0,48.0,1,76,0.0,48.0,48.0
0.005,6,10,1989,5,927,1.0,659.0,659.0,5,1062,1.0,794.0,794.0
0.009,6,12,1926,6,1189,1.0,659.0,434.0,6,737,1.0,417.0,417.0
40.066,17,10,676,5,460,10015.0,104.0,64.0,5,216,10015.0,20.0,15.0
0.005,17,2,152,1,68,0.0,40.0,40.0,1,84,0.0,56.0,56.0
240.012,6,9,787,5,488,60003.0,232.0,232.0,4,299,80003.0,83.0,83.0
0.004,6,10,1989,5,927,1.0,659.0,659.0,5,1062,1.0,794.0,794.0
0.082,6,10,1506,5,395,14.0,127.0,127.0,5,1111,19.0,843.0,843.0
354.027,6,21,1795,16,1030,23601.0,190.0,190.0,5,765,60002.0,464.0,248.0
0.017,6,10,1990,5,911,4.0,643.0,643.0,5,1079,4.0,811.0,811.0
40.07,17,10,676,5,460,10016.0,104.0,64.0,5,216,10016.0,20.0,15.0
40.074,17,10,676,5,460,10017.0,104.0,64.0,5,216,10017.0,20.0,15.0
0.005,6,10,2007,5,928,1.0,660.0,660.0,5,1079,1.0,811.0,811.0
0.01,6,10,1989,5,910,2.0,642.0,642.0,5,1079,2.0,811.0,811.0
0.004,17,2,136,1,60,0.0,32.0,32.0,1,76,0.0,48.0,48.0
0.006,17,2,170,1,65,0.0,37.0,37.0,1,105,0.0,77.0,77.0
0.001,17,2,136,1,60,0.0,32.0,32.0,1,76,0.0,48.0,48.0
0.014,6,10,1990,5,911,3.0,643.0,643.0,5,1079,3.0,811.0,811.0
0.016,6,10,1972,5,910,3.0,642.0,642.0,5,1062,3.0,794.0,794.0
0.115,17,2,144,1,64,0.0,36.0,36.0,1,80,0.0,52.0,52.0
0.003,17,4,284,2,120,0.0,32.0,32.0,2,164,0.0,60.0,54.0
40.057,17,10,676,5,460,10012.0,104.0,64.0,5,216,10013.0,20.0,15.0
0.001,17,2,166,1,75,0.0,47.0,47.0,1,91,0.0,63.0,63.0
0.114,6,10,1506,5,395,26.0,127.0,127.0,5,1111,26.0,843.0,843.0
0.004,6,10,1779,5,928,1.0,660.0,660.0,5,851,1.0,583.0,583.0
0.093,6,10,1506,5,395,19.0,127.0,127.0,5,1111,21.0,843.0,843.0
0.015,6,10,1990,5,911,3.0,643.0,643.0,5,1079,3.0,811.0,811.0
0.001,17,2,180,1,66,0.0,38.0,38.0,1,114,0.0,86.0,86.0
0.005,6,10,2007,5,928,1.0,660.0,660.0,5,1079,1.0,811.0,811.0
0.004,17,4,284,2,120,1.0,32.0,32.0,2,164,0.0,60.0,54.0
0.092,6,10,1506,5,395,15.0,127.0,127.0,5,1111,21.0,843.0,843.0
0.005,6,10,1989,5,927,1.0,659.0,659.0,5,1062,1.0,794.0,794.0
1.221,6,32,13391,18,5892,71.0,2720.0,854.0,14,7499,80.0,2720.0,769.0
40.062,17,10,676,5,460,10013.0,104.0,64.0,5,216,10014.0,20.0,15.0
0.005,6,10,2006,5,927,1.0,659.0,659.0,5,1079,1.0,811.0,811.0
0.015,6,10,1631,5,848,3.0,580.0,580.0,5,783,3.0,515.0,515.0
0.124,17,2,184,1,61,0.0,33.0,33.0,1,123,0.0,95.0,95.0
0.005,6,10,2000,5,927,1.0,659.0,659.0,5,1073,1.0,805.0,805.0
0.071,17,2,184,1,61,0.0,33.0,33.0,1,123,0.0,95.0,95.0
0.124,6,10,1506,5,395,27.0,127.0,127.0,5,1111,27.0,843.0,843.0
0.094,6,10,1506,5,395,18.0,127.0,127.0,5,1111,20.0,843.0,843.0
0.043,17,2,170,1,65,0.0,37.0,37.0,1,105,0.0,77.0,77.0
0.005,6,10,1547,5,764,1.0,496.0,496.0,5,783,1.0,515.0,515.0
0.124,6,10,1506,5,395,27.0,127.0,127.0,5,1111,26.0,843.0,843.0
0.008,6,10,1972,5,910,2.0,642.0,642.0,5,1062,1.0,794.0,794.0
40.053,17,10,676,5,460,10012.0,104.0,64.0,5,216,10012.0,20.0,15.0
0.013,6,10,1989,5,910,3.0,642.0,642.0,5,1079,3.0,811.0,811.0
0.075,6,10,1506,5,395,18.0,127.0,127.0,5,1111,14.0,843.0,843.0
0.004,17,2,132,1,58,0.0,30.0,30.0,1,74,0.0,46.0,46.0
0.005,17,4,420,2,122,0.0,33.0,33.0,2,298,0.0,145.0,121.0
0.015,6,10,1989,5,910,3.0,642.0,642.0,5,1079,3.0,811.0,811.0
0.17,17,2,152,1,76,0.0,48.0,48.0,1,76,0.0,48.0,48.0
0.005,6,10,2007,5,928,1.0,660.0,660.0,5,1079,1.0,811.0,811.0
0.115,6,10,1506,5,395,26.0,127.0,127.0,5,1111,27.0,843.0,843.0
10.748,17,24,3782,12,1673,966.0,268.0,111.0,12,2109,967.0,588.0,147.0
0.005,6,10,2006,5,927,1.0,659.0,659.0,5,1079,1.0,811.0,811.0
0.006,6,10,1547,5,764,1.0,496.0,496.0,5,783,1.0,515.0,515.0
0.005,6,14,3799,7,509,0.0,137.0,137.0,7,3290,0.0,1448.0,972.0
0.041,17,2,148,1,60,0.0,32.0,32.0,1,88,0.0,60.0,60.0
0.012,6,10,1762,5,911,3.0,643.0,643.0,5,851,3.0,583.0,583.0
0.006,17,2,180,1,66,0.0,38.0,38.0,1,114,0.0,86.0,86.0
0.001,17,2,136,1,60,0.0,32.0,32.0,1,76,0.0,48.0,48.0
0.005,17,2,170,1,65,0.0,37.0,37.0,1,105,0.0,77.0,77.0
0.005,6,10,1643,5,860,1.0,592.0,592.0,5,783,1.0,515.0,515.0
0.012,6,10,1990,5,911,2.0,643.0,643.0,5,1079,2.0,811.0,811.0
0.005,6,10,2007,5,928,1.0,660.0,660.0,5,1079,1.0,811.0,811.0
0.005,6,10,2000,5,927,1.0,659.0,659.0,5,1073,1.0,805.0,805.0
0.007,17,2,179,1,71,0.0,43.0,43.0,1,108,0.0,80.0,80.0
0.013,6,10,1972,5,910,3.0,642.0,642.0,5,1062,3.0,794.0,794.0
0.013,6,10,1972,5,910,3.0,642.0,642.0,5,1062,3.0,794.0,794.0
0.012,6,10,1972,5,910,3.0,642.0,642.0,5,1062,3.0,794.0,794.0
300.296,6,27,7433,16,1409,20019.0,217.0,142.0,11,6024,24024.0,1679.0,777.0
0.088,6,10,1506,5,395,19.0,127.0,127.0,5,1111,19.0,843.0,843.0
0.006,17,2,136,1,60,0.0,32.0,32.0,1,76,0.0,48.0,48.0
0.006,6,10,1547,5,764,1.0,496.0,496.0,5,783,1.0,515.0,515.0
0.006,6,10,1643,5,860,1.0,592.0,592.0,5,783,1.0,515.0,515.0
0.08,6,10,1506,5,395,16.0,127.0,127.0,5,1111,19.0,843.0,843.0
0.005,6,10,1547,5,764,1.0,496.0,496.0,5,783,1.0,515.0,515.0
0.004,17,2,148,1,60,0.0,32.0,32.0,1,88,0.0,60.0,60.0
0.119,6,10,1506,5,395,26.0,127.0,127.0,5,1111,24.0,843.0,843.0
0.005,6,10,2006,5,927,1.0,659.0,659.0,5,1079,1.0,811.0,811.0
0.005,6,10,2006,5,927,1.0,659.0,659.0,5,1079,1.0,811.0,811.0
0.103,6,10,1506,5,395,23.0,127.0,127.0,5,1111,23.0,843.0,843.0
0.011,6,10,1677,5,827,2.0,559.0,559.0,5,850,2.0,582.0,582.0
40.056,17,10,676,5,460,10013.0,104.0,64.0,5,216,10013.0,20.0,15.0
0.152,6,10,1506,5,395,29.0,127.0,127.0,5,1111,36.0,843.0,843.0
0.005,6,10,2000,5,927,1.0,659.0,659.0,5,1073,1.0,805.0,805.0
0.152,6,10,1506,5,395,36.0,127.0,127.0,5,1111,22.0,843.0,843.0
0.122,6,10,1506,5,395,24.0,127.0,127.0,5,1111,25.0,843.0,843.0
0.005,6,10,2007,5,928,1.0,660.0,660.0,5,1079,1.0,811.0,811.0
0.004,6,10,1989,5,927,1.0,659.0,659.0,5,1062,0.0,794.0,794.0
0.009,6,10,1989,5,910,2.0,642.0,642.0,5,1079,2.0,811.0,811.0
0.025,6,10,1983,5,910,6.0,642.0,642.0,5,1073,6.0,805.0,805.0
0.005,6,10,1989,5,927,1.0,659.0,659.0,5,1062,1.0,794.0,794.0
0.005,6,10,1774,5,923,1.0,655.0,655.0,5,851,1.0,583.0,583.0
0.093,6,10,1506,5,395,19.0,127.0,127.0,5,1111,21.0,843.0,843.0
40.066,17,10,676,5,460,10015.0,104.0,64.0,5,216,10015.0,20.0,15.0
0.004,6,10,1702,5,863,1.0,595.0,595.0,5,839,1.0,571.0,571.0
11.18,17,28,4420,14,1993,847.0,268.0,114.0,14,2427,847.0,586.0,145.0
0.005,6,10,1854,5,889,1.0,621.0,621.0,5,965,1.0,697.0,697.0
0.12,6,10,1506,5,395,27.0,127.0,127.0,5,1111,28.0,843.0,843.0
168.03,17,70,10093,35,2331,4941.0,44.0,38.0,35,7762,4941.0,239.0,193.0
0.123,17,2,179,1,71,0.0,43.0,43.0,1,108,0.0,80.0,80.0
0.109,6,10,1506,5,395,21.0,127.0,127.0,5,1111,23.0,843.0,843.0
0.168,17,2,152,1,76,0.0,48.0,48.0,1,76,0.0,48.0,48.0
0.006,6,10,1547,5,764,1.0,496.0,496.0,5,783,1.0,515.0,515.0
240.017,6,9,787,5,488,60004.0,232.0,232.0,4,299,80004.0,83.0,83.0
0.001,17,2,180,1,66,0.0,38.0,38.0,1,114,0.0,86.0,86.0
0.011,6,10,1677,5,827,2.0,559.0,559.0,5,850,2.0,582.0,582.0
0.003,17,2,136,1,60,0.0,32.0,32.0,1,76,0.0,48.0,48.0
0.005,6,10,1689,5,839,1.0,571.0,571.0,5,850,1.0,582.0,582.0
0.003,17,4,284,2,120,0.0,32.0,32.0,2,164,0.0,60.0,54.0
0.003,17,2,148,1,60,0.0,32.0,32.0,1,88,0.0,60.0,60.0
40.074,17,10,676,5,460,10014.0,104.0,64.0,5,216,10017.0,20.0,15.0
0.016,6,10,1990,5,911,3.0,643.0,643.0,5,1079,4.0,811.0,811.0
0.005,6,10,2007,5,928,1.0,660.0,660.0,5,1079,1.0,811.0,811.0
0.009,6,10,1972,5,910,2.0,642.0,642.0,5,1062,2.0,794.0,794.0
0.008,6,10,2006,5,927,2.0,659.0,659.0,5,1079,2.0,811.0,811.0
352.71,6,20,2210,6,1308,12004.0,494.0,494.0,14,902,27131.0,83.0,83.0
0.072,17,2,148,1,60,0.0,32.0,32.0,1,88,0.0,60.0,60.0
40.067,17,10,676,5,460,10013.0,104.0,64.0,5,216,10016.0,20.0,15.0
0.004,17,4,284,2,120,1.0,32.0,32.0,2,164,0.0,60.0,54.0
0.095,6,10,1506,5,395,18.0,127.0,127.0,5,1111,21.0,843.0,843.0
0.017,17,2,198,1,91,0.0,63.0,63.0,1,107,0.0,79.0,79.0
0.052,17,2,152,1,76,0.0,48.0,48.0,1,76,0.0,48.0,48.0
0.004,17,4,284,2,120,0.0,32.0,32.0,2,164,0.0,60.0,54.0
0.005,6,10,2006,5,927,1.0,659.0,659.0,5,1079,1.0,811.0,811.0
0.015,6,10,1972,5,910,3.0,642.0,642.0,5,1062,3.0,794.0,794.0
15.071,17,15,9238,8,6902,2148.0,1350.0,834.0,7,2336,2507.0,1350.0,305.0
0.005,6,10,2006,5,927,1.0,659.0,659.0,5,1079,1.0,811.0,811.0
0.1,6,10,1506,5,395,22.0,127.0,127.0,5,1111,23.0,843.0,843.0
0.005,6,10,2000,5,927,1.0,659.0,659.0,5,1073,1.0,805.0,805.0
352.252,6,20,2210,6,1308,12003.0,494.0,494.0,14,902,27096.0,83.0,83.0
0.016,6,10,1990,5,911,4.0,643.0,643.0,5,1079,4.0,811.0,811.0
0.088,6,10,1506,5,395,20.0,127.0,127.0,5,1111,18.0,843.0,843.0
241.708,6,355,346629,182,20983,1335.0,2689.0,885.0,173,325646,1405.0,2804.0,1942.0
0.004,6,10,1779,5,928,1.0,660.0,660.0,5,851,1.0,583.0,583.0
0.004,17,2,136,1,60,0.0,32.0,32.0,1,76,0.0,48.0,48.0
0.044,17,2,156,1,64,0.0,36.0,36.0,1,92,0.0,64.0,64.0
0.009,6,10,2000,5,927,2.0,659.0,659.0,5,1073,2.0,805.0,805.0
0.013,6,10,1677,5,827,3.0,559.0,559.0,5,850,3.0,582.0,582.0
40.065,17,10,676,5,460,10014.0,104.0,64.0,5,216,10014.0,20.0,15.0
0.006,6,10,1854,5,889,1.0,621.0,621.0,5,965,1.0,697.0,697.0
0.135,6,10,1506,5,395,30.0,127.0,127.0,5,1111,32.0,843.0,843.0
0.005,6,10,1989,5,927,1.0,659.0,659.0,5,1062,1.0,794.0,794.0
0.097,6,10,1506,5,395,22.0,127.0,127.0,5,1111,20.0,843.0,843.0
0.171,6,3,453,2,321,171.0,241.0,241.0,1,132,0.0,92.0,92.0
0.105,6,10,1506,5,395,25.0,127.0,127.0,5,1111,24.0,843.0,843.0
0.04,17,2,412,1,61,0.0,33.0,33.0,1,351,0.0,323.0,323.0
0.073,6,10,1506,5,395,16.0,127.0,127.0,5,1111,15.0,843.0,843.0
0.001,17,2,180,1,65,0.0,37.0,37.0,1,115,0.0,87.0,87.0
0.037,17,2,164,1,74,0.0,46.0,46.0,1,90,0.0,62.0,62.0
0.082,6,10,1506,5,395,18.0,127.0,127.0,5,1111,17.0,843.0,843.0
353.36,6,20,2210,6,1308,12003.0,494.0,494.0,14,902,27181.0,83.0,83.0
0.004,6,10,2007,5,928,1.0,660.0,660.0,5,1079,1.0,811.0,811.0
0.005,17,2,230,1,68,0.0,40.0,40.0,1,162,0.0,134.0,134.0
0.005,6,13,3747,7,509,0.0,137.0,137.0,6,3238,1.0,1470.0,1459.0
0.004,17,2,136,1,60,0.0,32.0,32.0,1,76,0.0,48.0,48.0
0.013,6,10,1990,5,911,3.0,643.0,643.0,5,1079,3.0,811.0,811.0
0.012,6,10,1989,5,910,3.0,642.0,642.0,5,1079,2.0,811.0,811.0
0.011,6,10,1631,5,848,2.0,580.0,580.0,5,783,2.0,515.0,515.0
240.106,6,16,4481,9,963,30013.0,238.0,166.0,7,3518,40017.0,1402.0,786.0
1762.368,6,459,66561,257,35550,6884.0,613.0,194.0,202,31011,8767.0,453.0,143.0
0.13,17,4,352,2,130,6.0,37.0,37.0,2,222,127.0,89.0,83.0
0.092,6,10,1506,5,395,21.0,127.0,127.0,5,1111,22.0,843.0,843.0
0.011,6,10,1990,5,911,2.0,643.0,643.0,5,1079,2.0,811.0,811.0
0.083,6,10,1506,5,395,16.0,127.0,127.0,5,1111,20.0,843.0,843.0
0.006,6,10,1689,5,839,1.0,571.0,571.0,5,850,1.0,582.0,582.0
0.008,6,10,1972,5,910,2.0,642.0,642.0,5,1062,1.0,794.0,794.0
0.004,6,10,2000,5,927,1.0,659.0,659.0,5,1073,1.0,805.0,805.0
10.811,17,28,4422,14,1994,823.0,269.0,114.0,14,2428,823.0,587.0,145.0
240.099,6,30,9053,15,6550,17149.0,1673.0,641.0,15,2503,17149.0,580.0,214.0
0.079,6,10,1506,5,395,18.0,127.0,127.0,5,1111,16.0,843.0,843.0
0.116,6,10,1506,5,395,22.0,127.0,127.0,5,1111,25.0,843.0,843.0
178.113,17,68,9669,34,2258,5397.0,44.0,38.0,34,7411,5397.0,261.0,189.0
0.271,17,43,24306,24,21160,11.0,1350.0,853.0,19,3146,11.0,1350.0,137.0
176.395,17,74,10375,37,2465,4899.0,44.0,38.0,37,7910,4899.0,261.0,185.0
0.005,17,2,164,1,74,0.0,46.0,46.0,1,90,0.0,62.0,62.0
0.055,6,10,1506,5,395,13.0,127.0,127.0,5,1111,12.0,843.0,843.0
0.001,17,2,136,1,60,0.0,32.0,32.0,1,76,0.0,48.0,48.0
0.001,17,2,180,1,66,0.0,38.0,38.0,1,114,0.0,86.0,86.0
0.009,6,13,3735,7,497,1.0,125.0,125.0,6,3238,1.0,1470.0,1459.0
0.005,6,10,2006,5,927,1.0,659.0,659.0,5,1079,1.0,811.0,811.0
177.318,17,78,11191,39,2605,4666.0,44.0,38.0,39,8586,4666.0,239.0,192.0
0.124,6,10,1506,5,395,29.0,127.0,127.0,5,1111,30.0,843.0,843.0
0.004,6,10,2007,5,928,1.0,660.0,660.0,5,1079,1.0,811.0,811.0
0.006,6,10,1643,5,860,1.0,592.0,592.0,5,783,1.0,515.0,515.0
0.124,6,10,1506,5,395,26.0,127.0,127.0,5,1111,27.0,843.0,843.0
0.093,6,10,1506,5,395,20.0,127.0,127.0,5,1111,18.0,843.0,843.0
0.121,6,10,1506,5,395,27.0,127.0,127.0,5,1111,26.0,843.0,843.0
0.019,6,10,1989,5,910,4.0,642.0,642.0,5,1079,4.0,811.0,811.0
240.019,6,9,787,5,488,60004.0,232.0,232.0,4,299,80005.0,83.0,83.0
0.116,6,10,1506,5,395,24.0,127.0,127.0,5,1111,26.0,843.0,843.0
0.014,6,10,1989,5,910,3.0,642.0,642.0,5,1079,3.0,811.0,811.0
0.098,6,10,1506,5,395,22.0,127.0,127.0,5,1111,21.0,843.0,843.0
0.005,6,10,2000,5,927,1.0,659.0,659.0,5,1073,1.0,805.0,805.0
0.016,6,10,1762,5,911,4.0,643.0,643.0,5,851,3.0,583.0,583.0
0.006,6,10,2006,5,927,1.0,659.0,659.0,5,1079,1.0,811.0,811.0
0.004,6,10,1702,5,863,1.0,595.0,595.0,5,839,1.0,571.0,571.0
0.009,6,10,1989,5,910,2.0,642.0,642.0,5,1079,2.0,811.0,811.0
240.093,6,16,4481,9,963,30011.0,238.0,166.0,7,3518,40014.0,1402.0,786.0
0.012,6,10,1990,5,911,2.0,643.0,643.0,5,1079,3.0,811.0,811.0
1.018,6,12,3134,6,2099,153.0,1328.0,923.0,6,1035,153.0,791.0,791.0
0.023,6,10,1677,5,827,5.0,559.0,559.0,5,850,5.0,582.0,582.0
0.005,6,10,1643,5,860,1.0,592.0,592.0,5,783,1.0,515.0,515.0
40.053,17,10,676,5,460,10012.0,104.0,64.0,5,216,10012.0,20.0,15.0
0.004,17,4,284,2,120,0.0,32.0,32.0,2,164,0.0,60.0,54.0
0.133,6,10,1506,5,395,30.0,127.0,127.0,5,1111,31.0,843.0,843.0
40.066,17,10,676,5,460,10015.0,104.0,64.0,5,216,10015.0,20.0,15.0
1799.581,6,243,35755,151,25972,11997.0,302.0,302.0,92,9783,19775.0,102.0,83.0
0.004,6,10,1702,5,863,0.0,595.0,595.0,5,839,1.0,571.0,571.0
0.009,6,10,1989,5,910,2.0,642.0,642.0,5,1079,2.0,811.0,811.0
0.005,17,2,140,1,62,0.0,34.0,34.0,1,78,0.0,50.0,50.0
0.166,6,10,1506,5,395,36.0,127.0,127.0,5,1111,39.0,843.0,843.0
0.005,6,10,1547,5,764,1.0,496.0,496.0,5,783,1.0,515.0,515.0
0.0,17,2,166,1,75,0.0,47.0,47.0,1,91,0.0,63.0,63.0
0.006,6,10,1547,5,764,1.0,496.0,496.0,5,783,1.0,515.0,515.0
0.008,6,10,1990,5,911,2.0,643.0,643.0,5,1079,2.0,811.0,811.0
0.006,6,10,1547,5,764,1.0,496.0,496.0,5,783,1.0,515.0,515.0
40.054,17,10,676,5,460,10012.0,104.0,64.0,5,216,10012.0,20.0,15.0
0.004,6,10,2006,5,927,1.0,659.0,659.0,5,1079,1.0,811.0,811.0
0.039,17,2,144,1,64,0.0,36.0,36.0,1,80,0.0,52.0,52.0
0.019,6,10,1677,5,827,4.0,559.0,559.0,5,850,4.0,582.0,582.0
0.006,6,10,1547,5,764,1.0,496.0,496.0,5,783,1.0,515.0,515.0
0.135,17,2,80,1,32,0.0,4.0,4.0,1,48,0.0,20.0,20.0
10.825,17,28,4421,14,1994,823.0,269.0,114.0,14,2427,824.0,586.0,145.0
0.008,17,2,170,1,65,0.0,37.0,37.0,1,105,0.0,77.0,77.0
0.005,6,10,2000,5,927,1.0,659.0,659.0,5,1073,1.0,805.0,805.0
0.014,17,2,152,1,56,0.0,28.0,28.0,1,96,0.0,68.0,68.0
178.185,17,72,10442,36,2403,5090.0,44.0,38.0,36,8039,5090.0,249.0,195.0
0.01,17,2,175,1,65,0.0,37.0,37.0,1,110,0.0,82.0,82.0
0.002,17,2,152,1,76,0.0,48.0,48.0,1,76,0.0,48.0,48.0
0.005,6,10,2000,5,927,1.0,659.0,659.0,5,1073,1.0,805.0,805.0
0.007,6,10,1762,5,911,1.0,643.0,643.0,5,851,1.0,583.0,583.0
0.001,17,2,166,1,75,0.0,47.0,47.0,1,91,0.0,63.0,63.0
0.011,6,10,1989,5,910,2.0,642.0,642.0,5,1079,2.0,811.0,811.0
0.1,6,10,1506,5,395,17.0,127.0,127.0,5,1111,22.0,843.0,843.0
0.175,17,2,152,1,76,0.0,48.0,48.0,1,76,0.0,48.0,48.0
0.005,6,10,2006,5,927,1.0,659.0,659.0,5,1079,1.0,811.0,811.0
0.005,6,10,2007,5,928,1.0,660.0,660.0,5,1079,1.0,811.0,811.0
0.004,6,10,1702,5,863,0.0,595.0,595.0,5,839,1.0,571.0,571.0
0.005,6,10,2007,5,928,1.0,660.0,660.0,5,1079,1.0,811.0,811.0
0.018,6,10,1990,5,911,4.0,643.0,643.0,5,1079,4.0,811.0,811.0
0.006,6,10,2006,5,927,1.0,659.0,659.0,5,1079,1.0,811.0,811.0
0.012,6,10,1677,5,827,2.0,559.0,559.0,5,850,2.0,582.0,582.0
1791.483,6,492,99492,248,88142,7252.0,421.0,365.0,244,11350,7371.0,53.0,53.0
0.009,6,10,1762,5,911,2.0,643.0,643.0,5,851,2.0,583.0,583.0
300.361,6,16,2170,9,684,37524.0,146.0,146.0,7,1486,50033.0,419.0,398.0
0.005,6,10,1854,5,889,1.0,621.0,621.0,5,965,1.0,697.0,697.0
0.098,6,10,1506,5,395,20.0,127.0,127.0,5,1111,22.0,843.0,843.0
11.229,17,28,4424,14,1995,851.0,270.0,114.0,14,2429,851.0,588.0,145.0
0.007,17,2,148,1,60,0.0,32.0,32.0,1,88,0.0,60.0,60.0
40.048,17,10,676,5,460,10011.0,104.0,64.0,5,216,10011.0,20.0,15.0
0.008,6,10,1983,5,910,2.0,642.0,642.0,5,1073,2.0,805.0,805.0
0.004,6,10,2006,5,927,1.0,659.0,659.0,5,1079,1.0,811.0,811.0
0.087,6,10,1506,5,395,19.0,127.0,127.0,5,1111,19.0,843.0,843.0
0.113,6,10,1506,5,395,23.0,127.0,127.0,5,1111,25.0,843.0,843.0
242.903,6,393,347387,188,21300,1298.0,2736.0,959.0,205,326087,1190.0,2804.0,1617.0
0.72,6,22,5072,11,1250,61.0,325.0,133.0,11,3822,61.0,1414.0,563.0
0.017,6,10,1990,5,911,4.0,643.0,643.0,5,1079,4.0,811.0,811.0
0.09,17,2,156,1,64,0.0,36.0,36.0,1,92,0.0,64.0,64.0
0.013,6,10,1989,5,910,3.0,642.0,642.0,5,1079,3.0,811.0,811.0
40.076,17,10,676,5,460,10015.0,104.0,64.0,5,216,10010.0,20.0,15.0
0.003,17,2,148,1,60,0.0,32.0,32.0,1,88,0.0,60.0,60.0
0.04,17,2,136,1,60,0.0,32.0,32.0,1,76,0.0,48.0,48.0
0.154,6,10,1506,5,395,37.0,127.0,127.0,5,1111,35.0,843.0,843.0
0.139,17,4,352,2,130,101.0,37.0,37.0,2,222,68.0,89.0,83.0
0.004,6,10,2006,5,927,1.0,659.0,659.0,5,1079,1.0,811.0,811.0
0.013,6,10,1990,5,911,3.0,643.0,643.0,5,1079,3.0,811.0,811.0
300.986,6,43,11391,23,5564,13681.0,1360.0,658.0,20,5827,464.0,2667.0,385.0
0.085,6,10,1506,5,395,17.0,127.0,127.0,5,1111,16.0,843.0,843.0
0.005,6,10,2006,5,927,1.0,659.0,659.0,5,1079,1.0,811.0,811.0
0.136,6,10,1506,5,395,31.0,127.0,127.0,5,1111,31.0,843.0,843.0
0.003,17,2,185,1,73,0.0,45.0,45.0,1,112,0.0,84.0,84.0
0.005,17,2,160,1,72,0.0,44.0,44.0,1,88,0.0,60.0,60.0
0.001,17,2,180,1,66,0.0,38.0,38.0,1,114,0.0,86.0,86.0
0.016,17,2,198,1,91,0.0,63.0,63.0,1,107,0.0,79.0,79.0
0.011,6,10,1762,5,911,2.0,643.0,643.0,5,851,2.0,583.0,583.0
0.098,6,10,1506,5,395,23.0,127.0,127.0,5,1111,23.0,843.0,843.0
0.006,6,10,1689,5,839,1.0,571.0,571.0,5,850,1.0,582.0,582.0
0.006,6,10,1547,5,764,1.0,496.0,496.0,5,783,1.0,515.0,515.0
0.005,6,10,2007,5,928,1.0,660.0,660.0,5,1079,1.0,811.0,811.0
0.003,17,2,148,1,60,0.0,32.0,32.0,1,88,0.0,60.0,60.0
0.005,6,10,1643,5,860,1.0,592.0,592.0,5,783,1.0,515.0,515.0
0.009,6,10,1990,5,911,2.0,643.0,643.0,5,1079,2.0,811.0,811.0
0.115,6,29,9254,15,6928,8.0,2039.0,682.0,14,2326,8.0,580.0,227.0
0.007,17,2,132,1,58,0.0,30.0,30.0,1,74,0.0,46.0,46.0
0.005,17,2,144,1,64,0.0,36.0,36.0,1,80,0.0,52.0,52.0
0.006,6,10,1989,5,927,1.0,659.0,659.0,5,1062,1.0,794.0,794.0
0.017,6,10,1989,5,910,4.0,642.0,642.0,5,1079,4.0,811.0,811.0
0.004,17,2,132,1,58,0.0,30.0,30.0,1,74,0.0,46.0,46.0
0.008,6,10,1990,5,911,2.0,643.0,643.0,5,1079,2.0,811.0,811.0
0.004,17,2,170,1,65,0.0,37.0,37.0,1,105,0.0,77.0,77.0
0.041,17,2,152,1,76,0.0,48.0,48.0,1,76,0.0,48.0,48.0
0.005,17,2,214,1,75,0.0,47.0,47.0,1,139,0.0,111.0,111.0
0.011,6,10,1989,5,910,2.0,642.0,642.0,5,1079,2.0,811.0,811.0
0.015,6,10,1972,5,910,3.0,642.0,642.0,5,1062,3.0,794.0,794.0
0.004,6,10,2007,5,928,1.0,660.0,660.0,5,1079,1.0,811.0,811.0
0.008,6,13,3735,7,497,1.0,125.0,125.0,6,3238,1.0,1470.0,1459.0
0.001,17,2,180,1,66,0.0,38.0,38.0,1,114,0.0,86.0,86.0
0.004,6,10,1774,5,923,1.0,655.0,655.0,5,851,1.0,583.0,583.0
0.005,17,2,146,1,65,0.0,37.0,37.0,1,81,0.0,53.0,53.0
0.097,6,10,1506,5,395,19.0,127.0,127.0,5,1111,23.0,843.0,843.0
0.089,6,10,1506,5,395,21.0,127.0,127.0,5,1111,20.0,843.0,843.0
40.064,17,10,676,5,460,10015.0,104.0,64.0,5,216,10015.0,20.0,15.0
0.015,6,10,1983,5,910,3.0,642.0,642.0,5,1073,3.0,805.0,805.0
0.005,6,10,1989,5,927,1.0,659.0,659.0,5,1062,1.0,794.0,794.0
0.004,17,4,284,2,120,1.0,32.0,32.0,2,164,0.0,60.0,54.0
0.023,6,10,1762,5,911,5.0,643.0,643.0,5,851,5.0,583.0,583.0
0.003,17,2,152,1,76,0.0,48.0,48.0,1,76,0.0,48.0,48.0
0.009,6,10,1972,5,910,2.0,642.0,642.0,5,1062,2.0,794.0,794.0
0.005,6,10,2000,5,927,1.0,659.0,659.0,5,1073,1.0,805.0,805.0
172.32,17,82,11447,41,2727,4307.0,44.0,38.0,41,8720,4307.0,239.0,184.0
0.005,6,10,2007,5,928,1.0,660.0,660.0,5,1079,1.0,811.0,811.0
11.109,17,28,4422,14,1994,842.0,269.0,114.0,14,2428,842.0,587.0,145.0
0.005,6,10,1643,5,860,1.0,592.0,592.0,5,783,1.0,515.0,515.0
0.132,6,10,1506,5,395,30.0,127.0,127.0,5,1111,29.0,843.0,843.0
0.016,6,14,3787,7,497,2.0,125.0,125.0,7,3290,2.0,1448.0,972.0
0.006,17,2,179,1,71,0.0,43.0,43.0,1,108,0.0,80.0,80.0
0.041,17,2,136,1,60,0.0,32.0,32.0,1,76,0.0,48.0,48.0
240.226,6,25,11314,13,6256,20018.0,2659.0,1116.0,12,5058,21838.0,1592.0,735.0
0.018,6,10,1972,5,910,4.0,642.0,642.0,5,1062,4.0,794.0,794.0
0.004,6,10,1702,5,863,1.0,595.0,595.0,5,839,0.0,571.0,571.0
0.005,6,10,1779,5,928,1.0,660.0,660.0,5,851,1.0,583.0,583.0
0.008,17,2,222,1,65,0.0,37.0,37.0,1,157,0.0,129.0,129.0
0.112,6,10,1506,5,395,24.0,127.0,127.0,5,1111,26.0,843.0,843.0
0.005,6,10,1774,5,923,1.0,655.0,655.0,5,851,1.0,583.0,583.0
0.005,6,10,2006,5,927,1.0,659.0,659.0,5,1079,1.0,811.0,811.0
0.005,6,10,2006,5,927,1.0,659.0,659.0,5,1079,1.0,811.0,811.0
240.084,6,16,4481,9,963,30010.0,238.0,166.0,7,3518,40013.0,1402.0,786.0
0.004,6,10,1702,5,863,1.0,595.0,595.0,5,839,1.0,571.0,571.0
0.004,6,10,1702,5,863,0.0,595.0,595.0,5,839,1.0,571.0,571.0
0.125,17,2,80,1,32,0.0,4.0,4.0,1,48,0.0,20.0,20.0
0.009,6,10,1972,5,910,2.0,642.0,642.0,5,1062,2.0,794.0,794.0
0.005,6,10,2000,5,927,1.0,659.0,659.0,5,1073,1.0,805.0,805.0
0.012,6,10,1990,5,911,3.0,643.0,643.0,5,1079,2.0,811.0,811.0
0.109,6,10,1506,5,395,23.0,127.0,127.0,5,1111,20.0,843.0,843.0
0.006,6,10,2006,5,927,1.0,659.0,659.0,5,1079,1.0,811.0,811.0
0.07,17,8,3613,4,1874,23.0,1350.0,440.0,4,1739,11.0,1350.0,406.0
0.005,6,10,2006,5,927,1.0,659.0,659.0,5,1079,1.0,811.0,811.0
61.16,6,25,17931,14,10020,4704.0,2804.0,1549.0,11,7911,6102.0,2334.0,1221.0
241.57,6,391,347636,190,21393,1278.0,2736.0,958.0,201,326243,1207.0,2804.0,1653.0
0.006,6,10,1689,5,839,1.0,571.0,571.0,5,850,1.0,582.0,582.0
0.004,6,10,2006,5,927,1.0,659.0,659.0,5,1079,1.0,811.0,811.0
0.011,6,10,1762,5,911,2.0,643.0,643.0,5,851,2.0,583.0,583.0
0.005,6,10,1689,5,839,1.0,571.0,571.0,5,850,1.0,582.0,582.0
0.003,6,10,1702,5,863,0.0,595.0,595.0,5,839,0.0,571.0,571.0
0.093,6,10,1506,5,395,21.0,127.0,127.0,5,1111,19.0,843.0,843.0
0.827,6,10,2009,6,1655,165.0,1403.0,1403.0,4,354,196.0,182.0,182.0
0.005,6,10,1779,5,928,1.0,660.0,660.0,5,851,1.0,583.0,583.0
0.004,6,10,2006,5,927,1.0,659.0,659.0,5,1079,1.0,811.0,811.0
0.012,6,10,1990,5,911,3.0,643.0,643.0,5,1079,2.0,811.0,811.0
0.011,6,10,1989,5,910,2.0,642.0,642.0,5,1079,2.0,811.0,811.0
0.006,6,10,1643,5,860,1.0,592.0,592.0,5,783,1.0,515.0,515.0
0.008,6,10,1762,5,911,1.0,643.0,643.0,5,851,2.0,583.0,583.0
0.009,6,12,1926,6,1189,1.0,659.0,434.0,6,737,1.0,417.0,417.0
0.005,6,10,2006,5,927,1.0,659.0,659.0,5,1079,1.0,811.0,811.0
0.005,6,10,1774,5,923,1.0,655.0,655.0,5,851,1.0,583.0,583.0
0.022,6,10,1990,5,911,5.0,643.0,643.0,5,1079,5.0,811.0,811.0
292.884,6,381,346916,198,21861,1486.0,2736.0,889.0,183,325055,1609.0,2804.0,1867.0
0.008,6,12,1926,6,1189,1.0,659.0,434.0,6,737,1.0,417.0,417.0
353.486,6,20,2210,6,1308,12004.0,494.0,494.0,14,902,27191.0,83.0,83.0
0.04,17,2,234,1,61,0.0,33.0,33.0,1,173,0.0,145.0,145.0
0.003,17,2,148,1,60,0.0,32.0,32.0,1,88,0.0,60.0,60.0
0.01,6,10,1989,5,910,2.0,642.0,642.0,5,1079,2.0,811.0,811.0
0.172,6,3,453,2,321,172.0,241.0,241.0,1,132,0.0,92.0,92.0
15.078,17,15,8246,8,5987,2149.0,1350.0,720.0,7,2259,2508.0,1350.0,294.0
290.681,6,312,343398,117,17627,2505.0,2736.0,888.0,195,325771,1498.0,4136.0,1753.0
0.005,17,2,166,1,75,0.0,47.0,47.0,1,91,0.0,63.0,63.0
0.014,6,10,2006,5,927,3.0,659.0,659.0,5,1079,3.0,811.0,811.0
0.005,17,2,170,1,65,0.0,37.0,37.0,1,105,0.0,77.0,77.0
240.306,6,24,6795,13,1597,20025.0,238.0,182.0,11,5198,24030.0,1402.0,767.0
0.005,6,10,2007,5,928,1.0,660.0,660.0,5,1079,1.0,811.0,811.0
0.005,6,10,1774,5,923,1.0,655.0,655.0,5,851,1.0,583.0,583.0
0.005,6,10,1547,5,764,1.0,496.0,496.0,5,783,1.0,515.0,515.0
40.061,17,10,676,5,460,10012.0,104.0,64.0,5,216,10014.0,20.0,15.0
0.004,6,10,1779,5,928,1.0,660.0,660.0,5,851,1.0,583.0,583.0
0.006,6,12,1698,6,863,1.0,327.0,271.0,6,835,1.0,515.0,515.0
0.015,6,10,1989,5,910,3.0,642.0,642.0,5,1079,3.0,811.0,811.0
40.052,17,10,676,5,460,10012.0,104.0,64.0,5,216,10012.0,20.0,15.0
0.004,6,10,2007,5,928,1.0,660.0,660.0,5,1079,1.0,811.0,811.0
0.012,6,10,1990,5,911,2.0,643.0,643.0,5,1079,3.0,811.0,811.0
0.011,6,10,1989,5,910,2.0,642.0,642.0,5,1079,2.0,811.0,811.0
0.015,6,10,1631,5,848,3.0,580.0,580.0,5,783,3.0,515.0,515.0
167.091,17,70,10093,35,2331,4914.0,44.0,38.0,35,7762,4914.0,239.0,193.0
40.075,17,10,676,5,460,10018.0,104.0,64.0,5,216,10017.0,20.0,15.0
0.005,17,2,170,1,65,0.0,37.0,37.0,1,105,0.0,77.0,77.0
0.015,6,10,1972,5,910,3.0,642.0,642.0,5,1062,3.0,794.0,794.0
0.012,6,10,1762,5,911,2.0,643.0,643.0,5,851,2.0,583.0,583.0
0.008,6,10,1677,5,827,2.0,559.0,559.0,5,850,1.0,582.0,582.0
0.011,6,10,1762,5,911,2.0,643.0,643.0,5,851,2.0,583.0,583.0
300.759,6,35,7961,19,2523,16708.0,1347.0,432.0,16,5438,572.0,2667.0,435.0
0.121,6,10,1506,5,395,27.0,127.0,127.0,5,1111,25.0,843.0,843.0
352.246,6,20,2210,6,1308,12004.0,494.0,494.0,14,902,27095.0,83.0,83.0
0.005,6,10,2007,5,928,1.0,660.0,660.0,5,1079,1.0,811.0,811.0
0.005,6,10,1779,5,928,1.0,660.0,660.0,5,851,1.0,583.0,583.0
0.009,6,10,1631,5,848,2.0,580.0,580.0,5,783,2.0,515.0,515.0
369.032,6,22,2313,16,867,24602.0,195.0,195.0,6,1446,4637.0,419.0,398.0
0.017,6,10,1972,5,910,4.0,642.0,642.0,5,1062,4.0,794.0,794.0
0.01,6,10,1989,5,910,2.0,642.0,642.0,5,1079,2.0,811.0,811.0
0.001,17,2,180,1,66,0.0,38.0,38.0,1,114,0.0,86.0,86.0
0.005,17,2,170,1,65,0.0,37.0,37.0,1,105,0.0,77.0,77.0
0.008,6,10,1854,5,889,2.0,621.0,621.0,5,965,2.0,697.0,697.0
0.006,6,10,2000,5,927,1.0,659.0,659.0,5,1073,1.0,805.0,805.0
0.004,6,10,2007,5,928,1.0,660.0,660.0,5,1079,1.0,811.0,811.0
0.005,6,10,2007,5,928,1.0,660.0,660.0,5,1079,1.0,811.0,811.0
0.004,17,2,148,1,60,0.0,32.0,32.0,1,88,0.0,60.0,60.0
0.005,6,10,1989,5,927,1.0,659.0,659.0,5,1062,1.0,794.0,794.0
369.539,6,22,2313,16,867,24635.0,195.0,195.0,6,1446,4640.0,419.0,398.0
0.074,6,10,1506,5,395,15.0,127.0,127.0,5,1111,17.0,843.0,843.0
0.097,6,10,1506,5,395,22.0,127.0,127.0,5,1111,20.0,843.0,843.0
0.001,17,2,180,1,66,0.0,38.0,38.0,1,114,0.0,86.0,86.0
0.004,6,10,2006,5,927,1.0,659.0,659.0,5,1079,1.0,811.0,811.0
0.014,6,10,1989,5,910,3.0,642.0,642.0,5,1079,3.0,811.0,811.0
309.141,17,20,1124,10,716,34335.0,48.0,43.0,10,408,34335.0,20.0,12.0
0.009,6,13,3735,7,497,1.0,125.0,125.0,6,3238,1.0,1470.0,1459.0
0.017,6,10,1989,5,910,4.0,642.0,642.0,5,1079,4.0,811.0,811.0
0.005,6,10,1989,5,927,1.0,659.0,659.0,5,1062,1.0,794.0,794.0
0.019,6,10,1762,5,911,4.0,643.0,643.0,5,851,4.0,583.0,583.0
0.018,6,10,1972,5,910,4.0,642.0,642.0,5,1062,4.0,794.0,794.0
0.17,6,10,1506,5,395,38.0,127.0,127.0,5,1111,36.0,843.0,843.0
0.042,17,4,364,2,160,0.0,52.0,52.0,2,204,6.0,80.0,74.0
0.09,6,10,1506,5,395,17.0,127.0,127.0,5,1111,21.0,843.0,843.0
240.098,6,16,4481,9,963,30012.0,238.0,166.0,7,3518,40015.0,1402.0,786.0
0.085,6,10,1506,5,395,20.0,127.0,127.0,5,1111,17.0,843.0,843.0
0.004,6,10,2006,5,927,1.0,659.0,659.0,5,1079,1.0,811.0,811.0
351.989,6,20,2210,6,1308,12003.0,494.0,494.0,14,902,27075.0,83.0,83.0
1729.203,6,60,4400,40,2740,44338.0,33.0,33.0,20,1660,91001.0,31.0,31.0
0.003,17,4,284,2,120,0.0,32.0,32.0,2,164,0.0,60.0,54.0
0.17,17,2,152,1,76,0.0,48.0,48.0,1,76,0.0,48.0,48.0
0.082,6,10,1506,5,395,18.0,127.0,127.0,5,1111,16.0,843.0,843.0
40.051,17,10,676,5,460,10012.0,104.0,64.0,5,216,10011.0,20.0,15.0
0.009,6,10,1972,5,910,2.0,642.0,642.0,5,1062,2.0,794.0,794.0
0.169,17,2,152,1,76,0.0,48.0,48.0,1,76,0.0,48.0,48.0
0.003,17,2,148,1,60,0.0,32.0,32.0,1,88,0.0,60.0,60.0
40.07,17,10,676,5,460,10016.0,104.0,64.0,5,216,10016.0,20.0,15.0
0.011,6,10,1972,5,910,2.0,642.0,642.0,5,1062,2.0,794.0,794.0
0.018,17,4,284,2,120,15.0,32.0,32.0,2,164,14.0,60.0,54.0
40.063,17,10,676,5,460,10014.0,104.0,64.0,5,216,10015.0,20.0,15.0
0.005,6,13,3690,7,452,0.0,80.0,80.0,6,3238,1.0,1470.0,1459.0
0.013,6,10,1990,5,911,3.0,643.0,643.0,5,1079,3.0,811.0,811.0
0.011,6,10,1989,5,910,2.0,642.0,642.0,5,1079,2.0,811.0,811.0
0.007,6,10,1547,5,764,1.0,496.0,496.0,5,783,1.0,515.0,515.0
40.078,17,10,676,5,460,10018.0,104.0,64.0,5,216,10018.0,20.0,15.0
0.013,6,10,1990,5,911,3.0,643.0,643.0,5,1079,3.0,811.0,811.0
0.005,6,10,2007,5,928,1.0,660.0,660.0,5,1079,1.0,811.0,811.0
0.01,6,10,1989,5,910,2.0,642.0,642.0,5,1079,2.0,811.0,811.0
0.013,6,10,1972,5,910,3.0,642.0,642.0,5,1062,3.0,794.0,794.0
0.039,17,2,136,1,60,0.0,32.0,32.0,1,76,0.0,48.0,48.0
240.54,6,286,336671,110,9501,2206.0,1578.0,537.0,176,327170,1374.0,4206.0,1950.0
0.167,17,2,152,1,76,0.0,48.0,48.0,1,76,0.0,48.0,48.0
0.003,17,4,284,2,120,0.0,32.0,32.0,2,164,0.0,60.0,54.0
0.033,17,2,152,1,76,0.0,48.0,48.0,1,76,0.0,48.0,48.0
0.006,17,2,166,1,75,0.0,47.0,47.0,1,91,0.0,63.0,63.0
0.012,6,10,1990,5,911,3.0,643.0,643.0,5,1079,3.0,811.0,811.0
0.007,6,10,1702,5,863,1.0,595.0,595.0,5,839,1.0,571.0,571.0
0.022,6,10,1989,5,910,5.0,642.0,642.0,5,1079,5.0,811.0,811.0
38.431,6,36,9669,18,4151,521.0,1360.0,679.0,18,5518,2250.0,2667.0,435.0
0.006,6,10,1547,5,764,1.0,496.0,496.0,5,783,1.0,515.0,515.0
0.001,17,2,180,1,66,0.0,38.0,38.0,1,114,0.0,86.0,86.0
0.068,17,8,3613,4,1874,22.0,1350.0,440.0,4,1739,11.0,1350.0,406.0
0.005,6,10,2006,5,927,1.0,659.0,659.0,5,1079,1.0,811.0,811.0
0.005,6,10,1989,5,927,1.0,659.0,659.0,5,1062,1.0,794.0,794.0
0.005,17,2,132,1,58,0.0,30.0,30.0,1,74,0.0,46.0,46.0
0.061,6,10,1506,5,395,13.0,127.0,127.0,5,1111,13.0,843.0,843.0
0.005,17,2,144,1,64,0.0,36.0,36.0,1,80,0.0,52.0,52.0
0.006,6,10,1689,5,839,1.0,571.0,571.0,5,850,1.0,582.0,582.0
0.004,6,10,2007,5,928,1.0,660.0,660.0,5,1079,1.0,811.0,811.0
0.023,6,10,1989,5,910,5.0,642.0,642.0,5,1079,5.0,811.0,811.0
0.011,17,4,284,2,120,0.0,32.0,32.0,2,164,1.0,60.0,54.0
0.005,6,10,2007,5,928,1.0,660.0,660.0,5,1079,1.0,811.0,811.0
0.004,6,10,1702,5,863,1.0,595.0,595.0,5,839,1.0,571.0,571.0
0.002,17,2,180,1,66,0.0,38.0,38.0,1,114,0.0,86.0,86.0
0.087,6,10,1506,5,395,20.0,127.0,127.0,5,1111,19.0,843.0,843.0
168.385,17,70,10097,35,2332,4952.0,44.0,38.0,35,7765,4952.0,239.0,193.0
240.1,6,16,4480,9,963,30012.0,238.0,166.0,7,3517,40016.0,1402.0,786.0
0.005,6,10,1774,5,923,1.0,655.0,655.0,5,851,1.0,583.0,583.0
10.83,17,28,4422,14,1994,824.0,269.0,114.0,14,2428,824.0,587.0,145.0
0.006,6,10,1854,5,889,1.0,621.0,621.0,5,965,1.0,697.0,697.0
0.004,17,2,170,1,65,0.0,37.0,37.0,1,105,0.0,77.0,77.0
0.139,6,10,1506,5,395,32.0,127.0,127.0,5,1111,30.0,843.0,843.0
0.001,17,2,180,1,66,0.0,38.0,38.0,1,114,0.0,86.0,86.0
0.039,17,2,182,1,65,0.0,37.0,37.0,1,117,0.0,89.0,89.0
0.012,6,10,1989,5,910,3.0,642.0,642.0,5,1079,3.0,811.0,811.0
0.137,17,2,152,1,76,0.0,48.0,48.0,1,76,0.0,48.0,48.0
0.01,17,2,194,1,59,0.0,31.0,31.0,1,135,0.0,107.0,107.0
0.006,17,2,166,1,75,0.0,47.0,47.0,1,91,0.0,63.0,63.0
0.001,17,2,180,1,65,0.0,37.0,37.0,1,115,0.0,87.0,87.0
1785.024,6,248,31432,96,21703,18788.0,2720.0,223.0,152,9729,11820.0,242.0,51.0
0.04,17,4,420,2,122,0.0,33.0,33.0,2,298,0.0,145.0,121.0
0.008,17,2,194,1,59,0.0,31.0,31.0,1,135,0.0,107.0,107.0
11.32,17,28,4422,14,1995,858.0,270.0,114.0,14,2427,858.0,586.0,145.0
0.005,6,10,1689,5,839,1.0,571.0,571.0,5,850,1.0,582.0,582.0
0.006,6,10,1547,5,764,1.0,496.0,496.0,5,783,1.0,515.0,515.0
0.12,6,10,1506,5,395,24.0,127.0,127.0,5,1111,26.0,843.0,843.0
0.109,6,10,1506,5,395,26.0,127.0,127.0,5,1111,24.0,843.0,843.0
300.789,6,37,9265,20,3787,15831.0,1360.0,591.0,17,5478,540.0,2667.0,435.0
0.006,6,10,2000,5,927,1.0,659.0,659.0,5,1073,1.0,805.0,805.0
0.005,6,10,2006,5,927,1.0,659.0,659.0,5,1079,1.0,811.0,811.0
0.003,17,2,136,1,60,0.0,32.0,32.0,1,76,0.0,48.0,48.0
0.013,17,2,152,1,56,0.0,28.0,28.0,1,96,0.0,68.0,68.0
0.008,6,10,1972,5,910,2.0,642.0,642.0,5,1062,2.0,794.0,794.0
0.001,17,2,180,1,66,0.0,38.0,38.0,1,114,0.0,86.0,86.0
0.011,6,10,1677,5,827,2.0,559.0,559.0,5,850,2.0,582.0,582.0
0.005,6,14,3799,7,509,0.0,137.0,137.0,7,3290,0.0,1448.0,972.0
0.215,6,16,2777,8,1395,30.0,533.0,323.0,8,1382,20.0,529.0,239.0
240.089,6,16,4481,9,963,30011.0,238.0,166.0,7,3518,40014.0,1402.0,786.0
309.328,17,20,1124,10,716,34354.0,48.0,43.0,10,408,34354.0,20.0,12.0
0.095,6,10,1506,5,395,20.0,127.0,127.0,5,1111,23.0,843.0,843.0
354.026,6,21,1795,16,1030,23601.0,190.0,190.0,5,765,60002.0,464.0,248.0
0.014,6,10,1631,5,848,3.0,580.0,580.0,5,783,3.0,515.0,515.0
0.11,6,10,1506,5,395,25.0,127.0,127.0,5,1111,23.0,843.0,843.0
0.131,6,10,1506,5,395,29.0,127.0,127.0,5,1111,26.0,843.0,843.0
0.011,6,10,1983,5,910,2.0,642.0,642.0,5,1073,2.0,805.0,805.0
0.006,6,10,1547,5,764,1.0,496.0,496.0,5,783,1.0,515.0,515.0
0.005,17,2,230,1,68,0.0,40.0,40.0,1,162,0.0,134.0,134.0
0.016,6,10,1989,5,910,3.0,642.0,642.0,5,1079,3.0,811.0,811.0
0.088,6,10,1506,5,395,20.0,127.0,127.0,5,1111,19.0,843.0,843.0
0.006,17,2,169,1,62,0.0,34.0,34.0,1,107,0.0,79.0,79.0
0.004,17,2,136,1,60,0.0,32.0,32.0,1,76,0.0,48.0,48.0
0.004,6,10,2000,5,927,1.0,659.0,659.0,5,1073,1.0,805.0,805.0
0.007,6,10,1547,5,764,1.0,496.0,496.0,5,783,1.0,515.0,515.0
0.085,6,10,1506,5,395,15.0,127.0,127.0,5,1111,19.0,843.0,843.0
0.008,6,10,2006,5,927,1.0,659.0,659.0,5,1079,2.0,811.0,811.0
0.005,6,10,1689,5,839,1.0,571.0,571.0,5,850,1.0,582.0,582.0
0.001,17,2,180,1,66,0.0,38.0,38.0,1,114,0.0,86.0,86.0
0.006,6,10,1547,5,764,1.0,496.0,496.0,5,783,1.0,515.0,515.0
30.898,6,28,9605,14,1707,2376.0,794.0,367.0,14,7898,2367.0,1360.0,732.0
0.076,6,10,1506,5,395,16.0,127.0,127.0,5,1111,15.0,843.0,843.0
0.097,6,10,1506,5,395,21.0,127.0,127.0,5,1111,17.0,843.0,843.0
0.08,6,10,1506,5,395,18.0,127.0,127.0,5,1111,17.0,843.0,843.0
0.005,6,10,1989,5,927,1.0,659.0,659.0,5,1062,1.0,794.0,794.0
0.028,6,10,1677,5,827,6.0,559.0,559.0,5,850,7.0,582.0,582.0
0.004,17,2,166,1,75,0.0,47.0,47.0,1,91,0.0,63.0,63.0
0.007,6,10,1547,5,764,1.0,496.0,496.0,5,783,1.0,515.0,515.0
0.009,6,12,1926,6,1189,1.0,659.0,434.0,6,737,1.0,417.0,417.0
0.001,17,2,140,1,62,0.0,34.0,34.0,1,78,0.0,50.0,50.0
0.008,6,10,1689,5,839,2.0,571.0,571.0,5,850,1.0,582.0,582.0
0.135,6,10,1506,5,395,33.0,127.0,127.0,5,1111,28.0,843.0,843.0
0.004,17,4,284,2,120,1.0,32.0,32.0,2,164,0.0,60.0,54.0
0.005,6,10,1774,5,923,1.0,655.0,655.0,5,851,1.0,583.0,583.0
0.005,17,2,168,1,76,0.0,48.0,48.0,1,92,0.0,64.0,64.0
0.008,6,12,1926,6,1189,1.0,659.0,434.0,6,737,1.0,417.0,417.0
0.005,6,13,3690,7,452,0.0,80.0,80.0,6,3238,1.0,1470.0,1459.0
10.84,17,28,4422,14,1995,825.0,270.0,114.0,14,2427,825.0,586.0,145.0
0.005,6,10,1779,5,928,1.0,660.0,660.0,5,851,1.0,583.0,583.0
0.006,6,10,1689,5,839,1.0,571.0,571.0,5,850,1.0,582.0,582.0
1.06,6,31,12743,17,3312,66.0,1360.0,517.0,14,9431,68.0,2720.0,984.0
240.103,6,16,4482,9,963,30012.0,238.0,166.0,7,3519,40016.0,1402.0,786.0
0.006,6,10,1547,5,764,1.0,496.0,496.0,5,783,1.0,515.0,515.0
0.058,6,10,1506,5,395,14.0,127.0,127.0,5,1111,13.0,843.0,843.0
0.079,6,10,1506,5,395,16.0,127.0,127.0,5,1111,16.0,843.0,843.0
0.005,6,10,2006,5,927,1.0,659.0,659.0,5,1079,1.0,811.0,811.0
0.006,6,10,1547,5,764,1.0,496.0,496.0,5,783,1.0,515.0,515.0
0.003,17,4,284,2,120,0.0,32.0,32.0,2,164,0.0,60.0,54.0
0.006,6,10,1689,5,839,1.0,571.0,571.0,5,850,1.0,582.0,582.0
412.679,6,29,4409,12,3102,10912.0,494.0,494.0,17,1307,25792.0,83.0,83.0
0.006,6,11,2041,6,979,1.0,659.0,659.0,5,1062,1.0,794.0,794.0
0.005,6,10,1689,5,839,1.0,571.0,571.0,5,850,1.0,582.0,582.0
0.017,6,10,1972,5,910,4.0,642.0,642.0,5,1062,4.0,794.0,794.0
0.041,17,2,166,1,75,0.0,47.0,47.0,1,91,0.0,63.0,63.0
0.073,6,10,1506,5,395,15.0,127.0,127.0,5,1111,16.0,843.0,843.0
0.006,6,10,1689,5,839,1.0,571.0,571.0,5,850,1.0,582.0,582.0
0.019,6,10,1972,5,910,4.0,642.0,642.0,5,1062,4.0,794.0,794.0
11.153,17,28,4420,14,1995,845.0,270.0,114.0,14,2425,845.0,588.0,145.0
0.013,6,10,1972,5,910,3.0,642.0,642.0,5,1062,3.0,794.0,794.0
40.064,17,10,676,5,460,10014.0,104.0,64.0,5,216,10015.0,20.0,15.0
0.005,6,10,1689,5,839,1.0,571.0,571.0,5,850,1.0,582.0,582.0
44.494,6,44,14813,22,8906,430.0,2033.0,1142.0,22,5907,2110.0,2667.0,385.0
0.006,6,10,1547,5,764,1.0,496.0,496.0,5,783,1.0,515.0,515.0
0.011,6,10,1983,5,910,2.0,642.0,642.0,5,1073,2.0,805.0,805.0
0.012,6,10,1989,5,910,3.0,642.0,642.0,5,1079,3.0,811.0,811.0
0.006,6,10,1547,5,764,1.0,496.0,496.0,5,783,1.0,515.0,515.0
0.017,6,10,1972,5,910,4.0,642.0,642.0,5,1062,4.0,794.0,794.0
0.004,17,4,284,2,120,0.0,32.0,32.0,2,164,1.0,60.0,54.0
0.013,6,10,1990,5,911,3.0,643.0,643.0,5,1079,3.0,811.0,811.0
0.005,6,10,2006,5,927,1.0,659.0,659.0,5,1079,1.0,811.0,811.0
0.005,6,10,2007,5,928,1.0,660.0,660.0,5,1079,1.0,811.0,811.0
0.004,6,10,1989,5,927,1.0,659.0,659.0,5,1062,1.0,794.0,794.0
0.137,17,2,80,1,32,0.0,4.0,4.0,1,48,0.0,20.0,20.0
0.005,6,10,2006,5,927,1.0,659.0,659.0,5,1079,1.0,811.0,811.0
0.004,17,2,148,1,60,0.0,32.0,32.0,1,88,0.0,60.0,60.0
0.004,6,10,1989,5,927,1.0,659.0,659.0,5,1062,1.0,794.0,794.0
0.051,17,4,352,2,130,8.0,37.0,37.0,2,222,47.0,89.0,83.0
0.005,6,14,3736,7,446,0.0,74.0,74.0,7,3290,0.0,1448.0,972.0
0.005,17,2,193,1,71,0.0,43.0,43.0,1,122,0.0,94.0,94.0
293.042,6,309,343296,126,18103,2344.0,2736.0,888.0,183,325193,1610.0,2804.0,1867.0
0.005,17,2,169,1,62,0.0,34.0,34.0,1,107,0.0,79.0,79.0
0.097,6,10,1506,5,395,22.0,127.0,127.0,5,1111,21.0,843.0,843.0
240.022,6,9,787,5,488,60005.0,232.0,232.0,4,299,80006.0,83.0,83.0
0.084,6,10,1506,5,395,19.0,127.0,127.0,5,1111,20.0,843.0,843.0
0.007,6,10,2007,5,928,1.0,660.0,660.0,5,1079,1.0,811.0,811.0
0.01,17,2,144,1,64,0.0,36.0,36.0,1,80,0.0,52.0,52.0
0.045,17,2,152,1,76,0.0,48.0,48.0,1,76,0.0,48.0,48.0
366.42,6,22,2313,16,867,24428.0,195.0,195.0,6,1446,4634.0,419.0,398.0
0.005,6,13,3747,7,509,0.0,137.0,137.0,6,3238,0.0,1470.0,1459.0
0.004,17,4,284,2,120,0.0,32.0,32.0,2,164,0.0,60.0,54.0
0.01,6,10,1972,5,910,2.0,642.0,642.0,5,1062,2.0,794.0,794.0
0.029,17,2,214,1,75,0.0,47.0,47.0,1,139,0.0,111.0,111.0
0.005,6,10,2007,5,928,1.0,660.0,660.0,5,1079,1.0,811.0,811.0
0.098,6,10,1506,5,395,22.0,127.0,127.0,5,1111,18.0,843.0,843.0
0.018,6,13,3735,7,497,3.0,125.0,125.0,6,3238,3.0,1470.0,1459.0
0.212,6,16,2669,8,1395,30.0,533.0,323.0,8,1274,19.0,529.0,212.0
0.005,17,2,214,1,75,0.0,47.0,47.0,1,139,0.0,111.0,111.0
0.018,6,10,1989,5,910,4.0,642.0,642.0,5,1079,4.0,811.0,811.0
0.006,6,10,1689,5,839,1.0,571.0,571.0,5,850,1.0,582.0,582.0
0.014,6,10,1989,5,910,3.0,642.0,642.0,5,1079,3.0,811.0,811.0
0.001,17,2,142,1,63,0.0,35.0,35.0,1,79,0.0,51.0,51.0
0.006,17,2,144,1,64,0.0,36.0,36.0,1,80,0.0,52.0,52.0
0.001,17,2,180,1,66,0.0,38.0,38.0,1,114,0.0,86.0,86.0
292.265,6,381,347843,188,21346,1562.0,2736.0,889.0,193,326497,1522.0,2804.0,1767.0
0.005,17,2,230,1,68,0.0,40.0,40.0,1,162,0.0,134.0,134.0
0.016,6,10,1989,5,910,4.0,642.0,642.0,5,1079,3.0,811.0,811.0
10.984,17,28,4420,14,1993,834.0,268.0,114.0,14,2427,834.0,586.0,145.0
0.041,17,2,186,1,61,0.0,33.0,33.0,1,125,0.0,97.0,97.0
0.018,6,10,1989,5,910,4.0,642.0,642.0,5,1079,4.0,811.0,811.0
0.005,6,10,2000,5,927,1.0,659.0,659.0,5,1073,1.0,805.0,805.0
0.018,6,10,1989,5,910,4.0,642.0,642.0,5,1079,4.0,811.0,811.0
0.005,6,10,2007,5,928,1.0,660.0,660.0,5,1079,1.0,811.0,811.0
0.102,6,10,1506,5,395,21.0,127.0,127.0,5,1111,22.0,843.0,843.0
0.015,6,10,1631,5,848,3.0,580.0,580.0,5,783,3.0,515.0,515.0
0.012,6,10,1989,5,910,3.0,642.0,642.0,5,1079,2.0,811.0,811.0
0.016,6,10,1762,5,911,4.0,643.0,643.0,5,851,3.0,583.0,583.0
0.005,6,13,3747,7,509,0.0,137.0,137.0,6,3238,0.0,1470.0,1459.0
0.005,6,10,1989,5,927,1.0,659.0,659.0,5,1062,1.0,794.0,794.0
0.075,6,10,1506,5,395,17.0,127.0,127.0,5,1111,17.0,843.0,843.0
0.039,17,4,284,2,120,0.0,32.0,32.0,2,164,35.0,60.0,54.0
11.542,17,28,4400,14,2313,875.0,588.0,137.0,14,2087,875.0,270.0,121.0
0.01,6,10,1990,5,911,2.0,643.0,643.0,5,1079,2.0,811.0,811.0
0.005,17,2,230,1,68,0.0,40.0,40.0,1,162,0.0,134.0,134.0
0.086,6,10,1506,5,395,19.0,127.0,127.0,5,1111,19.0,843.0,843.0
0.079,6,10,1506,5,395,16.0,127.0,127.0,5,1111,16.0,843.0,843.0
0.08,6,10,1506,5,395,17.0,127.0,127.0,5,1111,18.0,843.0,843.0
0.074,6,10,1506,5,395,17.0,127.0,127.0,5,1111,18.0,843.0,843.0
0.011,6,10,1972,5,910,2.0,642.0,642.0,5,1062,2.0,794.0,794.0
1729.222,6,65,7413,43,4537,41171.0,1402.0,104.0,22,2876,82335.0,1112.0,82.0
0.039,17,2,144,1,64,0.0,36.0,36.0,1,80,0.0,52.0,52.0
0.004,6,10,2006,5,927,1.0,659.0,659.0,5,1079,1.0,811.0,811.0
0.005,6,10,2000,5,927,1.0,659.0,659.0,5,1073,1.0,805.0,805.0
0.093,6,10,1506,5,395,21.0,127.0,127.0,5,1111,22.0,843.0,843.0
0.096,6,10,1506,5,395,19.0,127.0,127.0,5,1111,21.0,843.0,843.0
0.013,6,10,1972,5,910,3.0,642.0,642.0,5,1062,3.0,794.0,794.0
0.005,17,2,228,1,82,0.0,54.0,54.0,1,146,0.0,118.0,118.0
0.075,6,10,1506,5,395,16.0,127.0,127.0,5,1111,15.0,843.0,843.0
0.005,17,2,166,1,75,0.0,47.0,47.0,1,91,0.0,63.0,63.0
0.005,6,10,1643,5,860,1.0,592.0,592.0,5,783,1.0,515.0,515.0
0.006,17,2,169,1,62,0.0,34.0,34.0,1,107,0.0,79.0,79.0
0.004,6,10,2007,5,928,1.0,660.0,660.0,5,1079,1.0,811.0,811.0
0.109,6,10,1506,5,395,26.0,127.0,127.0,5,1111,26.0,843.0,843.0
0.012,6,10,1762,5,911,3.0,643.0,643.0,5,851,2.0,583.0,583.0
0.01,6,10,1989,5,910,2.0,642.0,642.0,5,1079,2.0,811.0,811.0
0.007,6,10,1983,5,910,1.0,642.0,642.0,5,1073,1.0,805.0,805.0
0.127,6,10,1506,5,395,31.0,127.0,127.0,5,1111,16.0,843.0,843.0
0.005,6,10,1774,5,923,1.0,655.0,655.0,5,851,1.0,583.0,583.0
0.001,17,2,180,1,66,0.0,38.0,38.0,1,114,0.0,86.0,86.0
0.004,17,4,284,2,120,0.0,32.0,32.0,2,164,0.0,60.0,54.0
0.005,17,2,164,1,74,0.0,46.0,46.0,1,90,0.0,62.0,62.0
0.079,6,10,1506,5,395,16.0,127.0,127.0,5,1111,16.0,843.0,843.0
1793.269,6,547,190308,272,163690,6617.0,2883.0,952.0,275,26618,6544.0,580.0,119.0
40.069,17,10,676,5,460,10016.0,104.0,64.0,5,216,10016.0,20.0,15.0
0.005,6,10,2007,5,928,1.0,660.0,660.0,5,1079,1.0,811.0,811.0
0.043,17,2,152,1,76,0.0,48.0,48.0,1,76,0.0,48.0,48.0
0.116,6,10,1506,5,395,24.0,127.0,127.0,5,1111,24.0,843.0,843.0
0.01,6,10,1989,5,910,2.0,642.0,642.0,5,1079,2.0,811.0,811.0
0.01,6,10,1990,5,911,2.0,643.0,643.0,5,1079,2.0,811.0,811.0
0.168,17,2,152,1,76,0.0,48.0,48.0,1,76,0.0,48.0,48.0
0.02,6,10,1990,5,911,5.0,643.0,643.0,5,1079,5.0,811.0,811.0
0.085,6,10,1506,5,395,18.0,127.0,127.0,5,1111,17.0,843.0,843.0
0.112,6,10,1506,5,395,26.0,127.0,127.0,5,1111,24.0,843.0,843.0
40.077,17,10,676,5,460,10018.0,104.0,64.0,5,216,10018.0,20.0,15.0
15.07,17,15,9238,8,6902,2148.0,1350.0,834.0,7,2336,2506.0,1350.0,305.0
178.399,17,78,10971,39,2608,4694.0,44.0,38.0,39,8363,4694.0,261.0,186.0
0.104,6,10,1506,5,395,23.0,127.0,127.0,5,1111,23.0,843.0,843.0
0.126,17,4,596,2,122,0.0,33.0,33.0,2,474,86.0,323.0,209.0
10.876,17,26,4097,13,1846,897.0,269.0,114.0,13,2251,897.0,586.0,145.0
0.006,6,10,1547,5,764,1.0,496.0,496.0,5,783,1.0,515.0,515.0
15.072,17,15,9238,8,6902,2149.0,1350.0,834.0,7,2336,2507.0,1350.0,305.0
0.004,17,2,144,1,64,0.0,36.0,36.0,1,80,0.0,52.0,52.0
0.005,17,2,166,1,75,0.0,47.0,47.0,1,91,0.0,63.0,63.0
0.112,6,10,1506,5,395,25.0,127.0,127.0,5,1111,26.0,843.0,843.0
0.004,6,10,1702,5,863,1.0,595.0,595.0,5,839,0.0,571.0,571.0
10.82,17,28,4422,14,1994,823.0,269.0,114.0,14,2428,823.0,587.0,145.0
40.065,17,10,676,5,460,10015.0,104.0,64.0,5,216,10015.0,20.0,15.0
15.306,17,49,29572,30,26298,527.0,1350.0,848.0,19,3274,849.0,1350.0,144.0
0.016,6,10,1990,5,911,4.0,643.0,643.0,5,1079,4.0,811.0,811.0
0.005,6,10,2006,5,927,1.0,659.0,659.0,5,1079,1.0,811.0,811.0
0.067,6,10,1506,5,395,16.0,127.0,127.0,5,1111,15.0,843.0,843.0
319.584,17,20,1124,10,716,35502.0,48.0,43.0,10,408,35502.0,20.0,12.0
0.21,6,16,2668,8,1394,30.0,533.0,323.0,8,1274,19.0,529.0,212.0
0.013,6,10,1972,5,910,3.0,642.0,642.0,5,1062,3.0,794.0,794.0
0.011,6,10,1677,5,827,2.0,559.0,559.0,5,850,2.0,582.0,582.0
0.099,6,10,1506,5,395,21.0,127.0,127.0,5,1111,21.0,843.0,843.0
0.01,6,13,3735,7,497,1.0,125.0,125.0,6,3238,2.0,1470.0,1459.0
0.01,6,10,1990,5,911,2.0,643.0,643.0,5,1079,2.0,811.0,811.0
0.006,17,2,166,1,75,0.0,47.0,47.0,1,91,0.0,63.0,63.0
0.075,17,2,412,1,61,0.0,33.0,33.0,1,351,0.0,323.0,323.0
177.234,17,86,12532,43,2894,4219.0,44.0,39.0,43,9638,4219.0,260.0,196.0
0.009,6,10,1989,5,910,2.0,642.0,642.0,5,1079,2.0,811.0,811.0
0.005,6,10,1989,5,927,1.0,659.0,659.0,5,1062,1.0,794.0,794.0
313.145,17,20,1124,10,716,34780.0,48.0,43.0,10,408,34780.0,20.0,12.0
0.001,17,2,136,1,60,0.0,32.0,32.0,1,76,0.0,48.0,48.0
0.005,6,10,1774,5,923,1.0,655.0,655.0,5,851,1.0,583.0,583.0
0.011,6,10,1762,5,911,2.0,643.0,643.0,5,851,2.0,583.0,583.0
40.068,17,10,676,5,460,10015.0,104.0,64.0,5,216,10016.0,20.0,15.0
0.004,17,2,136,1,60,0.0,32.0,32.0,1,76,0.0,48.0,48.0
0.004,6,10,2006,5,927,1.0,659.0,659.0,5,1079,1.0,811.0,811.0
11.105,17,28,4422,14,1994,842.0,269.0,114.0,14,2428,842.0,587.0,145.0
0.128,6,10,1506,5,395,29.0,127.0,127.0,5,1111,29.0,843.0,843.0
0.121,6,10,1506,5,395,27.0,127.0,127.0,5,1111,27.0,843.0,843.0
0.092,6,10,1506,5,395,20.0,127.0,127.0,5,1111,20.0,843.0,843.0
0.012,6,10,1989,5,910,2.0,642.0,642.0,5,1079,3.0,811.0,811.0
0.005,6,10,1779,5,928,1.0,660.0,660.0,5,851,1.0,583.0,583.0
0.009,17,2,427,1,129,0.0,101.0,101.0,1,298,0.0,270.0,270.0
10.849,17,28,4422,14,1995,826.0,270.0,114.0,14,2427,826.0,586.0,145.0
0.011,6,10,1990,5,911,2.0,643.0,643.0,5,1079,2.0,811.0,811.0
0.108,6,10,1506,5,395,24.0,127.0,127.0,5,1111,23.0,843.0,843.0
0.008,6,10,1989,5,927,2.0,659.0,659.0,5,1062,2.0,794.0,794.0
40.061,17,10,676,5,460,10014.0,104.0,64.0,5,216,10014.0,20.0,15.0
0.006,6,10,2007,5,928,1.0,660.0,660.0,5,1079,1.0,811.0,811.0
1.01,6,12,2974,6,1939,152.0,1168.0,843.0,6,1035,152.0,791.0,791.0
0.014,6,14,3965,7,495,2.0,123.0,123.0,7,3470,2.0,1448.0,1032.0
0.004,17,2,166,1,75,0.0,47.0,47.0,1,91,0.0,63.0,63.0
0.012,6,10,1989,5,910,3.0,642.0,642.0,5,1079,2.0,811.0,811.0
0.009,6,10,1989,5,910,2.0,642.0,642.0,5,1079,2.0,811.0,811.0
0.006,17,2,169,1,62,0.0,34.0,34.0,1,107,0.0,79.0,79.0
0.006,6,10,1689,5,839,1.0,571.0,571.0,5,850,1.0,582.0,582.0
0.001,17,2,142,1,63,0.0,35.0,35.0,1,79,0.0,51.0,51.0
0.177,17,2,152,1,76,0.0,48.0,48.0,1,76,0.0,48.0,48.0
0.006,6,10,1643,5,860,1.0,592.0,592.0,5,783,1.0,515.0,515.0
0.008,6,10,1989,5,910,2.0,642.0,642.0,5,1079,2.0,811.0,811.0
10.816,17,28,4423,14,1994,823.0,269.0,114.0,14,2429,823.0,588.0,145.0
0.084,6,10,1506,5,395,18.0,127.0,127.0,5,1111,15.0,843.0,843.0
0.008,6,10,1989,5,910,1.0,642.0,642.0,5,1079,2.0,811.0,811.0
0.114,6,10,1506,5,395,24.0,127.0,127.0,5,1111,26.0,843.0,843.0
0.008,6,12,1926,6,1189,1.0,659.0,434.0,6,737,1.0,417.0,417.0
0.005,6,14,3799,7,509,0.0,137.0,137.0,7,3290,0.0,1448.0,972.0
0.007,6,10,1547,5,764,1.0,496.0,496.0,5,783,1.0,515.0,515.0
0.012,6,10,1990,5,911,3.0,643.0,643.0,5,1079,3.0,811.0,811.0
0.005,6,10,1989,5,927,1.0,659.0,659.0,5,1062,1.0,794.0,794.0
0.006,6,10,1643,5,860,1.0,592.0,592.0,5,783,1.0,515.0,515.0
0.012,6,10,1989,5,910,3.0,642.0,642.0,5,1079,3.0,811.0,811.0
0.012,6,10,1631,5,848,3.0,580.0,580.0,5,783,3.0,515.0,515.0
0.09,6,10,1506,5,395,19.0,127.0,127.0,5,1111,20.0,843.0,843.0
0.016,6,10,1972,5,910,4.0,642.0,642.0,5,1062,4.0,794.0,794.0
164.472,17,76,10878,38,2530,4445.0,44.0,38.0,38,8348,4445.0,261.0,191.0
0.042,17,2,136,1,60,0.0,32.0,32.0,1,76,0.0,48.0,48.0
0.005,17,2,214,1,75,0.0,47.0,47.0,1,139,0.0,111.0,111.0
0.001,17,2,136,1,60,0.0,32.0,32.0,1,76,0.0,48.0,48.0
0.005,6,10,1779,5,928,1.0,660.0,660.0,5,851,1.0,583.0,583.0
0.005,17,2,222,1,65,0.0,37.0,37.0,1,157,0.0,129.0,129.0
519.126,6,59,23074,31,5375,17304.0,676.0,469.0,28,17699,17003.0,1402.0,854.0
11.271,17,28,4417,14,1994,854.0,269.0,114.0,14,2423,854.0,586.0,145.0
0.005,6,10,1774,5,923,1.0,655.0,655.0,5,851,1.0,583.0,583.0
0.008,6,10,1990,5,911,2.0,643.0,643.0,5,1079,2.0,811.0,811.0
40.078,17,10,676,5,460,10016.0,104.0,64.0,5,216,10018.0,20.0,15.0
0.005,6,10,2006,5,927,1.0,659.0,659.0,5,1079,1.0,811.0,811.0
0.005,6,10,1989,5,927,1.0,659.0,659.0,5,1062,1.0,794.0,794.0
0.005,17,2,148,1,60,0.0,32.0,32.0,1,88,0.0,60.0,60.0
0.006,6,10,1547,5,764,1.0,496.0,496.0,5,783,1.0,515.0,515.0
240.016,6,9,787,5,488,60004.0,232.0,232.0,4,299,80004.0,83.0,83.0
0.018,6,10,1990,5,911,4.0,643.0,643.0,5,1079,4.0,811.0,811.0
0.008,6,10,1989,5,910,2.0,642.0,642.0,5,1079,2.0,811.0,811.0
0.008,6,10,1983,5,910,2.0,642.0,642.0,5,1073,2.0,805.0,805.0
0.007,6,10,1989,5,910,1.0,642.0,642.0,5,1079,1.0,811.0,811.0
0.004,6,10,1989,5,927,1.0,659.0,659.0,5,1062,1.0,794.0,794.0
0.005,6,10,2006,5,927,1.0,659.0,659.0,5,1079,1.0,811.0,811.0
0.012,6,10,1990,5,911,3.0,643.0,643.0,5,1079,2.0,811.0,811.0
0.016,6,10,1631,5,848,3.0,580.0,580.0,5,783,3.0,515.0,515.0
0.011,6,10,1990,5,911,2.0,643.0,643.0,5,1079,2.0,811.0,811.0
0.037,17,2,136,1,60,0.0,32.0,32.0,1,76,0.0,48.0,48.0
240.089,6,16,4480,9,963,30011.0,238.0,166.0,7,3517,40014.0,1402.0,786.0
0.073,6,10,1506,5,395,15.0,127.0,127.0,5,1111,17.0,843.0,843.0
15.215,17,44,24484,24,21174,660.0,1350.0,854.0,20,3310,799.0,1350.0,137.0
0.131,6,10,1506,5,395,23.0,127.0,127.0,5,1111,25.0,843.0,843.0
0.006,17,2,148,1,60,0.0,32.0,32.0,1,88,0.0,60.0,60.0
0.014,6,10,1631,5,848,3.0,580.0,580.0,5,783,3.0,515.0,515.0
0.009,6,10,1972,5,910,2.0,642.0,642.0,5,1062,2.0,794.0,794.0
0.005,6,10,1989,5,927,1.0,659.0,659.0,5,1062,1.0,794.0,794.0
39.451,6,38,11262,19,5704,495.0,2720.0,982.0,19,5558,2181.0,2667.0,435.0
0.012,6,10,1990,5,911,3.0,643.0,643.0,5,1079,2.0,811.0,811.0
0.009,6,10,1983,5,910,2.0,642.0,642.0,5,1073,2.0,805.0,805.0
0.03,17,2,136,1,60,0.0,32.0,32.0,1,76,0.0,48.0,48.0
0.118,6,10,1506,5,395,26.0,127.0,127.0,5,1111,24.0,843.0,843.0
0.117,6,10,1506,5,395,17.0,127.0,127.0,5,1111,26.0,843.0,843.0
0.004,6,10,2000,5,927,1.0,659.0,659.0,5,1073,1.0,805.0,805.0
0.006,6,10,1689,5,839,1.0,571.0,571.0,5,850,1.0,582.0,582.0
0.004,6,10,1989,5,927,1.0,659.0,659.0,5,1062,1.0,794.0,794.0
0.009,6,10,1989,5,910,2.0,642.0,642.0,5,1079,2.0,811.0,811.0
0.143,6,10,1506,5,395,33.0,127.0,127.0,5,1111,30.0,843.0,843.0
0.027,6,10,1677,5,827,6.0,559.0,559.0,5,850,6.0,582.0,582.0
0.095,6,10,1506,5,395,20.0,127.0,127.0,5,1111,22.0,843.0,843.0
0.006,6,10,2006,5,927,1.0,659.0,659.0,5,1079,1.0,811.0,811.0
0.015,6,10,1983,5,910,3.0,642.0,642.0,5,1073,3.0,805.0,805.0
0.126,6,10,1506,5,395,30.0,127.0,127.0,5,1111,21.0,843.0,843.0
0.016,6,10,1972,5,910,4.0,642.0,642.0,5,1062,3.0,794.0,794.0
0.136,6,10,1506,5,395,33.0,127.0,127.0,5,1111,28.0,843.0,843.0
0.005,17,2,164,1,74,0.0,46.0,46.0,1,90,0.0,62.0,62.0
40.075,17,10,676,5,460,10014.0,104.0,64.0,5,216,10016.0,20.0,15.0
352.247,6,20,2210,6,1308,12003.0,494.0,494.0,14,902,27095.0,83.0,83.0
240.092,6,15,6556,7,5839,40015.0,3202.0,1826.0,8,717,34298.0,293.0,293.0
0.109,17,2,179,1,71,0.0,43.0,43.0,1,108,0.0,80.0,80.0
0.017,6,10,1762,5,911,4.0,643.0,643.0,5,851,4.0,583.0,583.0
0.159,6,10,1506,5,395,37.0,127.0,127.0,5,1111,32.0,843.0,843.0
10.919,17,28,4422,14,1994,831.0,269.0,114.0,14,2428,831.0,587.0,145.0
0.012,6,10,1972,5,910,2.0,642.0,642.0,5,1062,2.0,794.0,794.0
0.006,6,10,1547,5,764,1.0,496.0,496.0,5,783,1.0,515.0,515.0
9.037,17,6,376,5,280,2259.0,28.0,28.0,1,96,0.0,68.0,68.0
0.025,6,10,1989,5,910,6.0,642.0,642.0,5,1079,6.0,811.0,811.0
10.818,17,28,4423,14,1994,823.0,269.0,114.0,14,2429,823.0,588.0,145.0
0.06,6,10,1506,5,395,13.0,127.0,127.0,5,1111,14.0,843.0,843.0
0.087,6,10,1506,5,395,20.0,127.0,127.0,5,1111,21.0,843.0,843.0
0.168,17,2,152,1,76,0.0,48.0,48.0,1,76,0.0,48.0,48.0
0.012,6,10,1989,5,910,3.0,642.0,642.0,5,1079,3.0,811.0,811.0
0.015,17,2,136,1,60,0.0,32.0,32.0,1,76,0.0,48.0,48.0
0.005,17,2,170,1,65,0.0,37.0,37.0,1,105,0.0,77.0,77.0
40.068,17,10,676,5,460,10015.0,104.0,64.0,5,216,10016.0,20.0,15.0
0.073,17,8,3613,4,1874,24.0,1350.0,440.0,4,1739,13.0,1350.0,406.0
40.06,17,10,676,5,460,10014.0,104.0,64.0,5,216,10014.0,20.0,15.0
0.012,6,10,1983,5,910,3.0,642.0,642.0,5,1073,2.0,805.0,805.0
0.017,17,2,198,1,91,0.0,63.0,63.0,1,107,0.0,79.0,79.0
0.005,6,15,3794,8,504,0.0,80.0,80.0,7,3290,0.0,1448.0,972.0
0.004,6,10,1989,5,927,1.0,659.0,659.0,5,1062,1.0,794.0,794.0
0.011,6,10,1762,5,911,2.0,643.0,643.0,5,851,2.0,583.0,583.0
0.005,6,10,2007,5,928,1.0,660.0,660.0,5,1079,1.0,811.0,811.0
240.011,6,9,787,5,488,60002.0,232.0,232.0,4,299,80002.0,83.0,83.0
0.007,6,10,1689,5,839,1.0,571.0,571.0,5,850,1.0,582.0,582.0
0.003,17,2,136,1,60,0.0,32.0,32.0,1,76,0.0,48.0,48.0
0.083,6,10,1506,5,395,17.0,127.0,127.0,5,1111,18.0,843.0,843.0
0.005,6,10,2006,5,927,1.0,659.0,659.0,5,1079,1.0,811.0,811.0
0.203,6,16,2669,8,1395,29.0,533.0,323.0,8,1274,18.0,529.0,212.0
40.057,17,10,676,5,460,10013.0,104.0,64.0,5,216,10012.0,20.0,15.0
0.005,6,10,1547,5,764,1.0,496.0,496.0,5,783,1.0,515.0,515.0
0.011,6,10,1989,5,910,2.0,642.0,642.0,5,1079,2.0,811.0,811.0
0.067,6,10,1506,5,395,14.0,127.0,127.0,5,1111,15.0,843.0,843.0
0.011,6,10,1972,5,910,2.0,642.0,642.0,5,1062,2.0,794.0,794.0
0.005,6,10,1547,5,764,1.0,496.0,496.0,5,783,1.0,515.0,515.0
1.021,6,13,3922,7,2139,127.0,1328.0,923.0,6,1783,153.0,1539.0,1539.0
0.01,6,10,1677,5,827,2.0,559.0,559.0,5,850,2.0,582.0,582.0
0.005,6,14,3799,7,509,0.0,137.0,137.0,7,3290,0.0,1448.0,972.0
0.01,6,10,1989,5,910,2.0,642.0,642.0,5,1079,2.0,811.0,811.0
0.012,6,10,1762,5,911,3.0,643.0,643.0,5,851,3.0,583.0,583.0
0.01,6,10,1972,5,910,2.0,642.0,642.0,5,1062,2.0,794.0,794.0
0.001,17,2,140,1,62,0.0,34.0,34.0,1,78,0.0,50.0,50.0
0.005,6,10,2007,5,928,1.0,660.0,660.0,5,1079,1.0,811.0,811.0
0.014,6,10,1972,5,910,3.0,642.0,642.0,5,1062,3.0,794.0,794.0
171.435,17,76,10736,38,2529,4633.0,44.0,38.0,38,8207,4633.0,239.0,187.0
0.007,6,10,1547,5,764,1.0,496.0,496.0,5,783,1.0,515.0,515.0
0.079,6,10,1506,5,395,17.0,127.0,127.0,5,1111,15.0,843.0,843.0
0.004,6,10,2006,5,927,1.0,659.0,659.0,5,1079,1.0,811.0,811.0
0.005,6,10,1774,5,923,1.0,655.0,655.0,5,851,1.0,583.0,583.0
0.011,6,10,1631,5,848,2.0,580.0,580.0,5,783,2.0,515.0,515.0
0.004,6,10,2006,5,927,1.0,659.0,659.0,5,1079,1.0,811.0,811.0
0.003,17,2,148,1,60,0.0,32.0,32.0,1,88,0.0,60.0,60.0
242.06,6,379,346774,186,21200,1308.0,2736.0,960.0,193,325574,1260.0,2804.0,1724.0
0.006,6,10,1689,5,839,1.0,571.0,571.0,5,850,1.0,582.0,582.0
0.097,6,10,1506,5,395,21.0,127.0,127.0,5,1111,19.0,843.0,843.0
0.003,17,2,148,1,60,0.0,32.0,32.0,1,88,0.0,60.0,60.0
0.004,6,10,2000,5,927,1.0,659.0,659.0,5,1073,1.0,805.0,805.0
0.075,6,10,1506,5,395,17.0,127.0,127.0,5,1111,16.0,843.0,843.0
0.118,6,10,1506,5,395,25.0,127.0,127.0,5,1111,25.0,843.0,843.0
0.005,6,10,1989,5,927,1.0,659.0,659.0,5,1062,1.0,794.0,794.0
0.005,17,2,193,1,71,0.0,43.0,43.0,1,122,0.0,94.0,94.0
40.059,17,10,676,5,460,10012.0,104.0,64.0,5,216,10013.0,20.0,15.0
0.018,6,10,1631,5,848,4.0,580.0,580.0,5,783,4.0,515.0,515.0
170.923,6,26,9525,12,1627,80.0,794.0,367.0,14,7898,13138.0,1360.0,732.0
0.01,6,10,1989,5,910,2.0,642.0,642.0,5,1079,2.0,811.0,811.0
11.139,17,28,4398,14,2312,848.0,587.0,137.0,14,2086,848.0,269.0,121.0
0.004,17,2,412,1,61,0.0,33.0,33.0,1,351,0.0,323.0,323.0
0.004,6,10,2007,5,928,1.0,660.0,660.0,5,1079,1.0,811.0,811.0
0.004,6,10,1989,5,927,1.0,659.0,659.0,5,1062,1.0,794.0,794.0
0.005,17,2,140,1,62,0.0,34.0,34.0,1,78,0.0,50.0,50.0
0.015,6,10,1989,5,910,3.0,642.0,642.0,5,1079,3.0,811.0,811.0
0.04,17,4,284,2,120,0.0,32.0,32.0,2,164,36.0,60.0,54.0
0.039,17,2,148,1,60,0.0,32.0,32.0,1,88,0.0,60.0,60.0
0.005,6,10,2006,5,927,1.0,659.0,659.0,5,1079,1.0,811.0,811.0
0.007,17,2,179,1,71,0.0,43.0,43.0,1,108,0.0,80.0,80.0
0.005,6,10,2006,5,927,1.0,659.0,659.0,5,1079,1.0,811.0,811.0
175.346,17,76,10842,38,2540,4739.0,44.0,38.0,38,8302,4739.0,239.0,190.0
253.156,6,38,9661,15,6710,18082.0,1835.0,659.0,23,2951,11506.0,580.0,124.0
0.087,6,10,1506,5,395,20.0,127.0,127.0,5,1111,17.0,843.0,843.0
10.826,17,28,4424,14,1995,824.0,270.0,114.0,14,2429,824.0,588.0,145.0
240.012,6,9,787,5,488,60003.0,232.0,232.0,4,299,80003.0,83.0,83.0
0.004,6,10,1989,5,927,1.0,659.0,659.0,5,1062,1.0,794.0,794.0
0.005,6,10,1689,5,839,1.0,571.0,571.0,5,850,1.0,582.0,582.0
1763.869,6,305,97645,188,86377,9432.0,1402.0,677.0,117,11268,15205.0,452.0,71.0
0.015,6,10,1989,5,910,3.0,642.0,642.0,5,1079,3.0,811.0,811.0
0.005,6,10,1854,5,889,1.0,621.0,621.0,5,965,1.0,697.0,697.0
240.091,6,32,9550,16,7127,16006.0,2198.0,699.0,16,2423,16005.0,580.0,197.0
0.006,6,10,1547,5,764,1.0,496.0,496.0,5,783,1.0,515.0,515.0
0.004,6,10,1989,5,927,1.0,659.0,659.0,5,1062,1.0,794.0,794.0
0.074,6,10,1506,5,395,18.0,127.0,127.0,5,1111,17.0,843.0,843.0
0.012,6,10,1989,5,910,3.0,642.0,642.0,5,1079,2.0,811.0,811.0
0.005,6,10,2006,5,927,1.0,659.0,659.0,5,1079,1.0,811.0,811.0
0.005,6,10,1689,5,839,1.0,571.0,571.0,5,850,1.0,582.0,582.0
0.003,17,4,284,2,120,0.0,32.0,32.0,2,164,0.0,60.0,54.0
0.071,6,10,1506,5,395,15.0,127.0,127.0,5,1111,15.0,843.0,843.0
0.109,6,10,1506,5,395,23.0,127.0,127.0,5,1111,23.0,843.0,843.0
0.004,17,2,136,1,60,0.0,32.0,32.0,1,76,0.0,48.0,48.0
0.001,17,2,142,1,63,0.0,35.0,35.0,1,79,0.0,51.0,51.0
0.123,6,10,1506,5,395,28.0,127.0,127.0,5,1111,28.0,843.0,843.0
0.061,6,10,1506,5,395,13.0,127.0,127.0,5,1111,13.0,843.0,843.0
0.004,6,10,2000,5,927,1.0,659.0,659.0,5,1073,1.0,805.0,805.0
0.005,6,10,2007,5,928,1.0,660.0,660.0,5,1079,1.0,811.0,811.0
40.066,17,10,676,5,460,10015.0,104.0,64.0,5,216,10014.0,20.0,15.0
0.086,6,10,1506,5,395,19.0,127.0,127.0,5,1111,18.0,843.0,843.0
15.263,17,47,27345,25,21229,634.0,1350.0,821.0,22,6116,725.0,1350.0,250.0
0.09,6,10,1506,5,395,19.0,127.0,127.0,5,1111,20.0,843.0,843.0
0.005,6,10,2006,5,927,1.0,659.0,659.0,5,1079,1.0,811.0,811.0
0.016,6,10,1989,5,910,3.0,642.0,642.0,5,1079,3.0,811.0,811.0
0.02,6,10,1972,5,910,5.0,642.0,642.0,5,1062,5.0,794.0,794.0
0.012,6,10,1989,5,910,3.0,642.0,642.0,5,1079,3.0,811.0,811.0
308.677,17,20,1124,10,716,34282.0,48.0,43.0,10,408,34282.0,20.0,12.0
0.005,6,10,2000,5,927,1.0,659.0,659.0,5,1073,1.0,805.0,805.0
0.018,6,10,1989,5,910,4.0,642.0,642.0,5,1079,4.0,811.0,811.0
0.046,17,2,152,1,76,0.0,48.0,48.0,1,76,0.0,48.0,48.0
0.006,6,10,1689,5,839,1.0,571.0,571.0,5,850,1.0,582.0,582.0
0.009,6,13,3735,7,497,1.0,125.0,125.0,6,3238,1.0,1470.0,1459.0
0.004,17,2,148,1,60,0.0,32.0,32.0,1,88,0.0,60.0,60.0
0.125,6,10,1506,5,395,27.0,127.0,127.0,5,1111,25.0,843.0,843.0
0.01,6,10,1983,5,910,2.0,642.0,642.0,5,1073,2.0,805.0,805.0
0.088,6,10,1506,5,395,21.0,127.0,127.0,5,1111,19.0,843.0,843.0
0.006,6,10,1689,5,839,1.0,571.0,571.0,5,850,1.0,582.0,582.0
0.006,6,13,3747,7,509,1.0,137.0,137.0,6,3238,1.0,1470.0,1459.0
0.014,6,10,1989,5,910,3.0,642.0,642.0,5,1079,3.0,811.0,811.0
40.061,17,10,676,5,460,10014.0,104.0,64.0,5,216,10014.0,20.0,15.0
0.273,17,37,19958,21,17031,13.0,1350.0,783.0,16,2927,13.0,1350.0,154.0
0.005,6,10,2007,5,928,1.0,660.0,660.0,5,1079,1.0,811.0,811.0
0.011,6,10,1972,5,910,2.0,642.0,642.0,5,1062,2.0,794.0,794.0
0.005,6,10,1854,5,889,1.0,621.0,621.0,5,965,1.0,697.0,697.0
0.019,6,10,1983,5,910,4.0,642.0,642.0,5,1073,4.0,805.0,805.0
8.631,6,36,8343,19,1911,479.0,763.0,373.0,17,6432,529.0,2720.0,478.0
15.082,17,17,10262,9,7973,1881.0,1350.0,857.0,8,2289,2150.0,1350.0,258.0
0.005,6,10,1547,5,764,1.0,496.0,496.0,5,783,1.0,515.0,515.0
0.016,6,10,1990,5,911,4.0,643.0,643.0,5,1079,4.0,811.0,811.0
15.072,17,15,9238,8,6902,2149.0,1350.0,834.0,7,2336,2507.0,1350.0,305.0
0.006,6,10,1547,5,764,1.0,496.0,496.0,5,783,1.0,515.0,515.0
0.012,6,10,1762,5,911,3.0,643.0,643.0,5,851,3.0,583.0,583.0
0.129,6,10,1506,5,395,29.0,127.0,127.0,5,1111,30.0,843.0,843.0
0.013,6,10,1983,5,910,3.0,642.0,642.0,5,1073,3.0,805.0,805.0
40.071,17,10,676,5,460,10016.0,104.0,64.0,5,216,10015.0,20.0,15.0
0.168,17,2,152,1,76,0.0,48.0,48.0,1,76,0.0,48.0,48.0
0.089,6,10,1506,5,395,20.0,127.0,127.0,5,1111,21.0,843.0,843.0
10.828,17,28,4417,14,1993,824.0,268.0,114.0,14,2424,824.0,587.0,145.0
0.016,6,13,3735,7,497,2.0,125.0,125.0,6,3238,3.0,1470.0,1459.0
15.076,17,15,9238,8,6902,2149.0,1350.0,834.0,7,2336,2507.0,1350.0,305.0
0.005,17,2,170,1,65,0.0,37.0,37.0,1,105,0.0,77.0,77.0
0.007,6,10,1990,5,911,1.0,643.0,643.0,5,1079,1.0,811.0,811.0
0.011,6,10,1677,5,827,2.0,559.0,559.0,5,850,2.0,582.0,582.0
0.006,17,2,170,1,65,0.0,37.0,37.0,1,105,0.0,77.0,77.0
0.09,6,10,1506,5,395,19.0,127.0,127.0,5,1111,20.0,843.0,843.0
0.004,6,10,1779,5,928,1.0,660.0,660.0,5,851,1.0,583.0,583.0
175.061,17,74,10293,37,2478,4862.0,44.0,38.0,37,7815,4862.0,239.0,183.0
40.089,17,10,676,5,460,10020.0,104.0,64.0,5,216,10021.0,20.0,15.0
0.005,6,10,1689,5,839,1.0,571.0,571.0,5,850,1.0,582.0,582.0
0.004,6,10,1702,5,863,1.0,595.0,595.0,5,839,0.0,571.0,571.0
0.004,6,10,2007,5,928,1.0,660.0,660.0,5,1079,1.0,811.0,811.0
0.011,6,10,1990,5,911,2.0,643.0,643.0,5,1079,2.0,811.0,811.0
0.013,6,10,1972,5,910,3.0,642.0,642.0,5,1062,3.0,794.0,794.0
0.08,17,2,136,1,60,0.0,32.0,32.0,1,76,0.0,48.0,48.0
0.037,17,4,284,2,120,0.0,32.0,32.0,2,164,34.0,60.0,54.0
0.077,6,10,1506,5,395,16.0,127.0,127.0,5,1111,17.0,843.0,843.0
0.225,6,16,2674,8,1400,32.0,533.0,325.0,8,1274,20.0,529.0,212.0
0.006,6,10,1547,5,764,1.0,496.0,496.0,5,783,1.0,515.0,515.0
354.013,6,21,1795,16,1030,23600.0,190.0,190.0,5,765,60003.0,464.0,248.0
1.055,6,12,3134,6,2099,158.0,1328.0,923.0,6,1035,159.0,791.0,791.0
172.386,17,88,12724,44,2960,4008.0,44.0,39.0,44,9764,4008.0,239.0,193.0
0.012,6,10,1990,5,911,3.0,643.0,643.0,5,1079,3.0,811.0,811.0
0.006,6,10,2007,5,928,1.0,660.0,660.0,5,1079,1.0,811.0,811.0
0.009,6,10,1983,5,910,2.0,642.0,642.0,5,1073,2.0,805.0,805.0
0.037,6,10,1990,5,911,9.0,643.0,643.0,5,1079,9.0,811.0,811.0
0.14,6,10,1506,5,395,34.0,127.0,127.0,5,1111,29.0,843.0,843.0
290.043,6,401,348582,193,21604,1510.0,2736.0,889.0,208,326978,1401.0,2804.0,1629.0
0.038,6,13,3735,7,497,6.0,125.0,125.0,6,3238,7.0,1470.0,1459.0
0.084,6,10,1506,5,395,18.0,127.0,127.0,5,1111,18.0,843.0,843.0
0.083,6,10,1506,5,395,18.0,127.0,127.0,5,1111,16.0,843.0,843.0
40.069,17,10,676,5,460,10016.0,104.0,64.0,5,216,10016.0,20.0,15.0
0.05,17,2,148,1,60,0.0,32.0,32.0,1,88,0.0,60.0,60.0
1196.013,6,173,37701,92,29171,13143.0,2474.0,696.0,81,8530,14950.0,580.0,71.0
293.758,6,398,348934,191,21498,1546.0,2736.0,889.0,207,327436,1425.0,2933.0,1640.0
0.159,6,10,1506,5,395,32.0,127.0,127.0,5,1111,37.0,843.0,843.0
0.006,17,2,169,1,62,0.0,34.0,34.0,1,107,0.0,79.0,79.0
10.845,17,28,4423,14,1995,826.0,270.0,114.0,14,2428,825.0,587.0,145.0
0.005,6,10,1689,5,839,1.0,571.0,571.0,5,850,1.0,582.0,582.0
0.002,17,2,180,1,66,0.0,38.0,38.0,1,114,0.0,86.0,86.0
0.034,6,10,1972,5,910,8.0,642.0,642.0,5,1062,8.0,794.0,794.0
0.006,6,10,1689,5,839,1.0,571.0,571.0,5,850,1.0,582.0,582.0
0.012,6,10,1972,5,910,2.0,642.0,642.0,5,1062,2.0,794.0,794.0
15.296,17,20,8210,10,5865,1696.0,1350.0,558.0,10,2345,1696.0,1350.0,206.0
241.477,6,383,348145,199,21864,1219.0,2736.0,959.0,184,326281,1319.0,2804.0,1820.0
10.931,17,28,4420,14,1995,832.0,270.0,114.0,14,2425,832.0,588.0,145.0
0.005,6,10,1854,5,889,1.0,621.0,621.0,5,965,1.0,697.0,697.0
0.125,6,10,1506,5,395,30.0,127.0,127.0,5,1111,29.0,843.0,843.0
0.001,17,2,180,1,66,0.0,38.0,38.0,1,114,0.0,86.0,86.0
0.013,6,10,1972,5,910,3.0,642.0,642.0,5,1062,3.0,794.0,794.0
0.006,6,10,1547,5,764,1.0,496.0,496.0,5,783,1.0,515.0,515.0
0.006,6,10,1547,5,764,1.0,496.0,496.0,5,783,1.0,515.0,515.0
0.008,6,10,1989,5,910,2.0,642.0,642.0,5,1079,2.0,811.0,811.0
0.075,6,10,1506,5,395,16.0,127.0,127.0,5,1111,16.0,843.0,843.0
0.008,6,12,1926,6,1189,1.0,659.0,434.0,6,737,1.0,417.0,417.0
0.004,6,10,1989,5,927,1.0,659.0,659.0,5,1062,1.0,794.0,794.0
0.012,6,10,1990,5,911,3.0,643.0,643.0,5,1079,3.0,811.0,811.0
0.072,17,2,144,1,64,0.0,36.0,36.0,1,80,0.0,52.0,52.0
0.087,6,10,1506,5,395,19.0,127.0,127.0,5,1111,20.0,843.0,843.0
0.014,6,10,1972,5,910,3.0,642.0,642.0,5,1062,3.0,794.0,794.0
0.04,17,2,182,1,65,0.0,37.0,37.0,1,117,0.0,89.0,89.0
0.013,6,10,1990,5,911,3.0,643.0,643.0,5,1079,3.0,811.0,811.0
0.101,6,10,1506,5,395,24.0,127.0,127.0,5,1111,22.0,843.0,843.0
0.005,6,10,2007,5,928,1.0,660.0,660.0,5,1079,1.0,811.0,811.0
0.083,6,10,1506,5,395,20.0,127.0,127.0,5,1111,18.0,843.0,843.0
0.007,17,2,209,1,64,0.0,36.0,36.0,1,145,0.0,117.0,117.0
11.39,17,28,4399,14,2313,863.0,588.0,137.0,14,2086,863.0,269.0,121.0
0.005,6,10,1779,5,928,1.0,660.0,660.0,5,851,1.0,583.0,583.0
0.101,6,10,1506,5,395,22.0,127.0,127.0,5,1111,23.0,843.0,843.0
173.114,17,92,13078,46,3103,3846.0,44.0,39.0,46,9975,3846.0,239.0,188.0
0.084,6,10,1506,5,395,19.0,127.0,127.0,5,1111,19.0,843.0,843.0
0.004,6,10,1702,5,863,1.0,595.0,595.0,5,839,1.0,571.0,571.0
0.013,6,10,1989,5,910,3.0,642.0,642.0,5,1079,3.0,811.0,811.0
0.005,6,10,1547,5,764,1.0,496.0,496.0,5,783,1.0,515.0,515.0
0.005,6,10,2007,5,928,1.0,660.0,660.0,5,1079,1.0,811.0,811.0
0.005,17,2,136,1,60,0.0,32.0,32.0,1,76,0.0,48.0,48.0
293.118,6,307,343466,123,17950,2402.0,2736.0,889.0,184,325516,1601.0,2804.0,1847.0
0.01,6,10,1989,5,910,2.0,642.0,642.0,5,1079,2.0,811.0,811.0
0.01,6,10,1677,5,827,2.0,559.0,559.0,5,850,2.0,582.0,582.0
0.028,6,10,1631,5,848,7.0,580.0,580.0,5,783,6.0,515.0,515.0
0.127,6,10,1506,5,395,24.0,127.0,127.0,5,1111,25.0,843.0,843.0
0.07,6,10,1506,5,395,15.0,127.0,127.0,5,1111,14.0,843.0,843.0
0.005,6,13,3747,7,509,0.0,137.0,137.0,6,3238,1.0,1470.0,1459.0
0.005,6,10,2006,5,927,1.0,659.0,659.0,5,1079,1.0,811.0,811.0
0.013,6,10,1983,5,910,3.0,642.0,642.0,5,1073,3.0,805.0,805.0
0.04,17,2,148,1,60,0.0,32.0,32.0,1,88,0.0,60.0,60.0
0.205,6,16,2669,8,1395,29.0,533.0,323.0,8,1274,19.0,529.0,212.0
0.006,6,10,1547,5,764,1.0,496.0,496.0,5,783,1.0,515.0,515.0
0.01,6,10,1972,5,910,2.0,642.0,642.0,5,1062,2.0,794.0,794.0
0.011,6,12,1926,6,1189,2.0,659.0,434.0,6,737,2.0,417.0,417.0
0.038,17,2,184,1,61,0.0,33.0,33.0,1,123,0.0,95.0,95.0
0.004,17,2,170,1,65,0.0,37.0,37.0,1,105,0.0,77.0,77.0
169.344,17,82,11817,41,2756,4233.0,44.0,39.0,41,9061,4233.0,239.0,193.0
0.106,6,10,1506,5,395,22.0,127.0,127.0,5,1111,23.0,843.0,843.0
0.013,6,10,1677,5,827,3.0,559.0,559.0,5,850,3.0,582.0,582.0
0.013,6,10,1972,5,910,3.0,642.0,642.0,5,1062,3.0,794.0,794.0
0.005,6,10,2000,5,927,1.0,659.0,659.0,5,1073,1.0,805.0,805.0
0.005,6,10,2006,5,927,1.0,659.0,659.0,5,1079,1.0,811.0,811.0
0.126,6,10,1506,5,395,28.0,127.0,127.0,5,1111,29.0,843.0,843.0
0.008,6,10,2006,5,927,2.0,659.0,659.0,5,1079,1.0,811.0,811.0
0.006,6,10,1643,5,860,1.0,592.0,592.0,5,783,1.0,515.0,515.0
0.02,6,10,1972,5,910,5.0,642.0,642.0,5,1062,4.0,794.0,794.0
0.061,6,10,1506,5,395,12.0,127.0,127.0,5,1111,12.0,843.0,843.0
40.058,17,10,676,5,460,10013.0,104.0,64.0,5,216,10013.0,20.0,15.0
15.07,17,15,9238,8,6902,2148.0,1350.0,834.0,7,2336,2506.0,1350.0,305.0
0.008,6,10,1972,5,910,1.0,642.0,642.0,5,1062,1.0,794.0,794.0
0.006,6,10,1547,5,764,1.0,496.0,496.0,5,783,1.0,515.0,515.0
0.008,6,10,1677,5,827,1.0,559.0,559.0,5,850,1.0,582.0,582.0
0.011,6,10,1990,5,911,2.0,643.0,643.0,5,1079,2.0,811.0,811.0
0.004,6,10,2006,5,927,1.0,659.0,659.0,5,1079,1.0,811.0,811.0
0.003,17,2,148,1,60,0.0,32.0,32.0,1,88,0.0,60.0,60.0
0.01,6,13,3735,7,497,1.0,125.0,125.0,6,3238,1.0,1470.0,1459.0
10.824,17,28,4394,14,1994,824.0,269.0,114.0,14,2400,824.0,587.0,143.0
0.099,6,10,1506,5,395,16.0,127.0,127.0,5,1111,21.0,843.0,843.0
0.004,6,10,2006,5,927,1.0,659.0,659.0,5,1079,1.0,811.0,811.0
0.066,17,8,3613,4,1874,22.0,1350.0,440.0,4,1739,10.0,1350.0,406.0
0.015,6,10,1762,5,911,3.0,643.0,643.0,5,851,3.0,583.0,583.0
0.008,6,10,1989,5,910,1.0,642.0,642.0,5,1079,1.0,811.0,811.0
0.077,6,10,1506,5,395,18.0,127.0,127.0,5,1111,16.0,843.0,843.0
0.01,6,10,1990,5,911,2.0,643.0,643.0,5,1079,2.0,811.0,811.0
0.005,6,13,3747,7,509,0.0,137.0,137.0,6,3238,0.0,1470.0,1459.0
40.064,17,10,676,5,460,10014.0,104.0,64.0,5,216,10015.0,20.0,15.0
0.013,6,10,1989,5,910,3.0,642.0,642.0,5,1079,3.0,811.0,811.0
9.036,17,6,376,5,280,2259.0,28.0,28.0,1,96,0.0,68.0,68.0
0.016,6,10,1972,5,910,4.0,642.0,642.0,5,1062,4.0,794.0,794.0
0.091,6,10,1506,5,395,20.0,127.0,127.0,5,1111,20.0,843.0,843.0
0.006,17,4,284,2,120,0.0,32.0,32.0,2,164,0.0,60.0,54.0
0.014,6,10,1990,5,911,3.0,643.0,643.0,5,1079,3.0,811.0,811.0
0.005,6,10,1689,5,839,1.0,571.0,571.0,5,850,1.0,582.0,582.0
0.001,17,2,248,1,68,0.0,40.0,40.0,1,180,0.0,152.0,152.0
300.019,6,12,1782,7,1348,50003.0,494.0,494.0,5,434,75004.0,83.0,83.0
0.004,6,10,1989,5,927,1.0,659.0,659.0,5,1062,1.0,794.0,794.0
0.073,6,10,1506,5,395,15.0,127.0,127.0,5,1111,16.0,843.0,843.0
0.155,6,10,1506,5,395,33.0,127.0,127.0,5,1111,37.0,843.0,843.0
0.014,6,10,1677,5,827,3.0,559.0,559.0,5,850,3.0,582.0,582.0
0.012,6,10,1983,5,910,2.0,642.0,642.0,5,1073,2.0,805.0,805.0
0.008,6,10,1631,5,848,2.0,580.0,580.0,5,783,2.0,515.0,515.0
0.059,6,10,1677,5,827,14.0,559.0,559.0,5,850,14.0,582.0,582.0
0.083,6,10,1506,5,395,18.0,127.0,127.0,5,1111,20.0,843.0,843.0
15.075,17,15,9238,8,6902,2149.0,1350.0,834.0,7,2336,2507.0,1350.0,305.0
0.011,6,12,1926,6,1189,2.0,659.0,434.0,6,737,2.0,417.0,417.0
40.062,17,10,676,5,460,10014.0,104.0,64.0,5,216,10014.0,20.0,15.0
0.005,6,10,2006,5,927,1.0,659.0,659.0,5,1079,1.0,811.0,811.0
0.004,6,10,1702,5,863,1.0,595.0,595.0,5,839,0.0,571.0,571.0
0.006,6,10,1689,5,839,1.0,571.0,571.0,5,850,1.0,582.0,582.0
0.005,17,2,214,1,75,0.0,47.0,47.0,1,139,0.0,111.0,111.0
0.001,17,2,180,1,66,0.0,38.0,38.0,1,114,0.0,86.0,86.0
0.039,17,2,152,1,76,0.0,48.0,48.0,1,76,0.0,48.0,48.0
0.109,6,10,1506,5,395,25.0,127.0,127.0,5,1111,25.0,843.0,843.0
0.106,6,10,1506,5,395,24.0,127.0,127.0,5,1111,21.0,843.0,843.0
11.181,17,28,4424,14,1995,847.0,270.0,114.0,14,2429,847.0,588.0,145.0
0.016,6,10,1990,5,911,4.0,643.0,643.0,5,1079,4.0,811.0,811.0
0.004,6,10,2006,5,927,1.0,659.0,659.0,5,1079,1.0,811.0,811.0
0.005,17,2,214,1,75,0.0,47.0,47.0,1,139,0.0,111.0,111.0
40.065,17,10,676,5,460,10015.0,104.0,64.0,5,216,10015.0,20.0,15.0
0.106,6,10,1506,5,395,16.0,127.0,127.0,5,1111,23.0,843.0,843.0
0.004,6,10,1989,5,927,1.0,659.0,659.0,5,1062,1.0,794.0,794.0
0.01,6,14,3787,7,497,1.0,125.0,125.0,7,3290,1.0,1448.0,972.0
11.157,17,28,4421,14,1994,845.0,269.0,114.0,14,2427,845.0,586.0,145.0
0.039,17,2,184,1,61,0.0,33.0,33.0,1,123,0.0,95.0,95.0
0.003,17,2,136,1,60,0.0,32.0,32.0,1,76,0.0,48.0,48.0
1772.509,6,105,6270,60,3525,30041.0,27.0,27.0,45,2745,40283.0,27.0,27.0
0.017,6,10,1990,5,911,4.0,643.0,643.0,5,1079,4.0,811.0,811.0
0.015,6,10,1762,5,911,3.0,643.0,643.0,5,851,3.0,583.0,583.0
0.005,17,2,170,1,65,0.0,37.0,37.0,1,105,0.0,77.0,77.0
0.106,6,10,1506,5,395,24.0,127.0,127.0,5,1111,23.0,843.0,843.0
1772.451,6,105,6270,60,3525,30040.0,27.0,27.0,45,2745,40282.0,27.0,27.0
40.066,17,10,676,5,460,10015.0,104.0,64.0,5,216,10015.0,20.0,15.0
0.247,6,26,10172,12,3980,22.0,1491.0,669.0,14,6192,18.0,1592.0,606.0
0.006,6,10,1547,5,764,1.0,496.0,496.0,5,783,1.0,515.0,515.0
0.073,6,10,1506,5,395,16.0,127.0,127.0,5,1111,16.0,843.0,843.0
0.004,17,2,148,1,60,0.0,32.0,32.0,1,88,0.0,60.0,60.0
0.11,6,10,1506,5,395,24.0,127.0,127.0,5,1111,26.0,843.0,843.0
0.005,17,2,214,1,75,0.0,47.0,47.0,1,139,0.0,111.0,111.0
0.005,6,10,1989,5,927,1.0,659.0,659.0,5,1062,1.0,794.0,794.0
0.011,6,10,1972,5,910,2.0,642.0,642.0,5,1062,2.0,794.0,794.0
240.505,6,37,9657,19,2174,13361.0,746.0,235.0,18,7483,14147.0,1402.0,595.0
0.03,6,10,1990,5,911,7.0,643.0,643.0,5,1079,7.0,811.0,811.0
0.005,6,10,2006,5,927,1.0,659.0,659.0,5,1079,1.0,811.0,811.0
0.259,6,16,2669,8,1395,37.0,533.0,323.0,8,1274,24.0,529.0,212.0
0.016,17,2,198,1,91,0.0,63.0,63.0,1,107,0.0,79.0,79.0
0.084,6,10,1506,5,395,19.0,127.0,127.0,5,1111,17.0,843.0,843.0
0.007,6,10,1547,5,764,1.0,496.0,496.0,5,783,1.0,515.0,515.0
0.084,6,10,1506,5,395,18.0,127.0,127.0,5,1111,19.0,843.0,843.0
0.005,6,14,3799,7,509,0.0,137.0,137.0,7,3290,0.0,1448.0,972.0
0.13,17,4,284,2,120,0.0,32.0,32.0,2,164,126.0,60.0,54.0
240.088,6,16,4481,9,963,30011.0,238.0,166.0,7,3518,40014.0,1402.0,786.0
0.001,17,2,180,1,65,0.0,37.0,37.0,1,115,0.0,87.0,87.0
10.773,17,28,4424,14,1995,819.0,270.0,114.0,14,2429,819.0,588.0,145.0
15.086,17,16,8328,8,6145,2151.0,1350.0,740.0,8,2183,2151.0,1350.0,244.0
0.005,6,10,2007,5,928,1.0,660.0,660.0,5,1079,1.0,811.0,811.0
0.007,6,10,1972,5,910,1.0,642.0,642.0,5,1062,1.0,794.0,794.0
0.003,17,2,136,1,60,0.0,32.0,32.0,1,76,0.0,48.0,48.0
0.011,6,10,1631,5,848,2.0,580.0,580.0,5,783,2.0,515.0,515.0
40.061,17,10,676,5,460,10014.0,104.0,64.0,5,216,10014.0,20.0,15.0
366.095,6,22,2313,16,867,24406.0,195.0,195.0,6,1446,4641.0,419.0,398.0
0.001,17,2,179,1,62,0.0,34.0,34.0,1,117,0.0,89.0,89.0
0.005,17,2,154,1,69,0.0,41.0,41.0,1,85,0.0,57.0,57.0
0.098,6,10,1506,5,395,22.0,127.0,127.0,5,1111,21.0,843.0,843.0
0.004,17,4,284,2,120,1.0,32.0,32.0,2,164,0.0,60.0,54.0
0.004,6,10,1779,5,928,1.0,660.0,660.0,5,851,1.0,583.0,583.0
0.008,6,10,1989,5,910,2.0,642.0,642.0,5,1079,2.0,811.0,811.0
0.006,17,4,284,2,120,0.0,32.0,32.0,2,164,0.0,60.0,54.0
0.007,6,10,1689,5,839,1.0,571.0,571.0,5,850,1.0,582.0,582.0
1792.814,6,490,99412,246,88062,7317.0,421.0,365.0,244,11350,7377.0,53.0,53.0
0.007,17,2,148,1,60,0.0,32.0,32.0,1,88,0.0,60.0,60.0
308.527,17,20,1124,10,716,34268.0,48.0,43.0,10,408,34271.0,20.0,12.0
0.017,6,10,1983,5,910,4.0,642.0,642.0,5,1073,4.0,805.0,805.0
0.095,6,10,1506,5,395,22.0,127.0,127.0,5,1111,22.0,843.0,843.0
177.206,17,70,9806,35,2330,5211.0,44.0,38.0,35,7476,5211.0,252.0,185.0
0.022,6,10,1990,5,911,5.0,643.0,643.0,5,1079,5.0,811.0,811.0
0.012,6,10,1972,5,910,3.0,642.0,642.0,5,1062,2.0,794.0,794.0
0.272,17,41,20295,22,17109,12.0,1350.0,749.0,19,3186,13.0,1350.0,139.0
0.004,6,10,1702,5,863,0.0,595.0,595.0,5,839,1.0,571.0,571.0
0.099,17,2,80,1,32,0.0,4.0,4.0,1,48,0.0,20.0,20.0
0.018,6,10,1631,5,848,4.0,580.0,580.0,5,783,4.0,515.0,515.0
354.025,6,21,1795,16,1030,23601.0,190.0,190.0,5,765,60001.0,464.0,248.0
0.015,6,10,1677,5,827,3.0,559.0,559.0,5,850,3.0,582.0,582.0
0.016,6,10,1762,5,911,4.0,643.0,643.0,5,851,3.0,583.0,583.0
0.005,6,13,3747,7,509,0.0,137.0,137.0,6,3238,0.0,1470.0,1459.0
0.013,6,10,1989,5,910,3.0,642.0,642.0,5,1079,3.0,811.0,811.0
0.005,6,13,3747,7,509,0.0,137.0,137.0,6,3238,0.0,1470.0,1459.0
0.084,6,10,1506,5,395,18.0,127.0,127.0,5,1111,18.0,843.0,843.0
0.004,17,2,148,1,60,0.0,32.0,32.0,1,88,0.0,60.0,60.0
0.009,6,10,1972,5,910,2.0,642.0,642.0,5,1062,1.0,794.0,794.0
0.006,6,10,1689,5,839,1.0,571.0,571.0,5,850,1.0,582.0,582.0
0.06,6,10,1506,5,395,13.0,127.0,127.0,5,1111,14.0,843.0,843.0
0.013,6,10,1983,5,910,3.0,642.0,642.0,5,1073,3.0,805.0,805.0
40.064,17,10,676,5,460,10015.0,104.0,64.0,5,216,10015.0,20.0,15.0
0.003,17,2,185,1,73,0.0,45.0,45.0,1,112,0.0,84.0,84.0
353.992,6,21,1795,16,1030,23599.0,190.0,190.0,5,765,60002.0,464.0,248.0
0.006,6,10,2006,5,927,1.0,659.0,659.0,5,1079,1.0,811.0,811.0
0.011,6,10,1989,5,910,2.0,642.0,642.0,5,1079,2.0,811.0,811.0
0.013,6,10,1972,5,910,3.0,642.0,642.0,5,1062,3.0,794.0,794.0
40.079,17,10,676,5,460,10014.0,104.0,64.0,5,216,10018.0,20.0,15.0
0.114,6,10,1506,5,395,25.0,127.0,127.0,5,1111,27.0,843.0,843.0
0.007,17,2,169,1,62,0.0,34.0,34.0,1,107,0.0,79.0,79.0
0.068,17,8,3613,4,1874,22.0,1350.0,440.0,4,1739,11.0,1350.0,406.0
15.163,17,44,20544,23,17143,687.0,1350.0,717.0,21,3401,756.0,1350.0,133.0
0.016,6,10,1989,5,910,4.0,642.0,642.0,5,1079,3.0,811.0,811.0
0.013,6,10,1983,5,910,3.0,642.0,642.0,5,1073,3.0,805.0,805.0
0.085,6,10,1506,5,395,18.0,127.0,127.0,5,1111,18.0,843.0,843.0
10.861,17,28,4423,14,1994,827.0,269.0,114.0,14,2429,826.0,588.0,145.0
0.004,17,2,148,1,60,0.0,32.0,32.0,1,88,0.0,60.0,60.0
361.78,6,21,1793,16,1030,24118.0,190.0,190.0,5,763,60009.0,462.0,247.0
1744.249,6,64,7344,42,4469,42542.0,1625.0,108.0,22,2875,83051.0,1111.0,82.0
0.123,6,10,1506,5,395,28.0,127.0,127.0,5,1111,30.0,843.0,843.0
0.075,6,10,1506,5,395,16.0,127.0,127.0,5,1111,18.0,843.0,843.0
0.004,6,10,2000,5,927,1.0,659.0,659.0,5,1073,1.0,805.0,805.0
0.016,6,10,1989,5,910,4.0,642.0,642.0,5,1079,3.0,811.0,811.0
0.112,6,10,1506,5,395,26.0,127.0,127.0,5,1111,24.0,843.0,843.0
0.005,17,2,180,1,66,0.0,38.0,38.0,1,114,0.0,86.0,86.0
0.087,6,10,1506,5,395,18.0,127.0,127.0,5,1111,19.0,843.0,843.0
0.103,6,10,1506,5,395,23.0,127.0,127.0,5,1111,21.0,843.0,843.0
0.006,6,10,1854,5,889,1.0,621.0,621.0,5,965,1.0,697.0,697.0
15.072,17,15,9239,8,6902,2149.0,1350.0,834.0,7,2337,2507.0,1350.0,305.0
0.077,6,10,1506,5,395,15.0,127.0,127.0,5,1111,16.0,843.0,843.0
15.38,17,41,21655,23,18453,697.0,1350.0,774.0,18,3202,903.0,1350.0,149.0
0.019,6,10,1983,5,910,4.0,642.0,642.0,5,1073,4.0,805.0,805.0
0.008,6,12,1926,6,1189,1.0,659.0,434.0,6,737,1.0,417.0,417.0
0.004,17,2,412,1,61,0.0,33.0,33.0,1,351,0.0,323.0,323.0
0.008,6,10,1989,5,910,2.0,642.0,642.0,5,1079,1.0,811.0,811.0
0.788,6,10,937,6,427,157.0,107.0,107.0,4,510,175.0,294.0,294.0
0.005,6,10,1689,5,839,1.0,571.0,571.0,5,850,1.0,582.0,582.0
0.005,6,10,2006,5,927,1.0,659.0,659.0,5,1079,1.0,811.0,811.0
175.203,6,24,9413,11,1575,59.0,794.0,367.0,13,7838,14589.0,1360.0,811.0
300.94,6,35,10520,19,2942,16718.0,801.0,389.0,16,7578,16062.0,1402.0,673.0
0.006,6,10,1547,5,764,1.0,496.0,496.0,5,783,1.0,515.0,515.0
0.124,17,2,136,1,60,0.0,32.0,32.0,1,76,0.0,48.0,48.0
10.954,17,28,4396,14,2311,834.0,586.0,137.0,14,2085,834.0,268.0,120.0
0.01,6,10,1972,5,910,2.0,642.0,642.0,5,1062,2.0,794.0,794.0
0.005,6,10,1989,5,927,1.0,659.0,659.0,5,1062,1.0,794.0,794.0
0.019,6,14,3787,7,497,3.0,125.0,125.0,7,3290,3.0,1448.0,972.0
0.006,6,10,2007,5,928,1.0,660.0,660.0,5,1079,1.0,811.0,811.0
0.013,6,10,1989,5,910,3.0,642.0,642.0,5,1079,3.0,811.0,811.0
0.02,6,10,1972,5,910,4.0,642.0,642.0,5,1062,5.0,794.0,794.0
0.004,6,10,1989,5,927,1.0,659.0,659.0,5,1062,1.0,794.0,794.0
0.009,6,10,1989,5,910,2.0,642.0,642.0,5,1079,2.0,811.0,811.0
0.003,17,2,148,1,60,0.0,32.0,32.0,1,88,0.0,60.0,60.0
11.206,17,28,4422,14,1993,849.0,268.0,114.0,14,2429,849.0,588.0,145.0
0.001,17,2,166,1,75,0.0,47.0,47.0,1,91,0.0,63.0,63.0
0.008,6,10,1990,5,911,2.0,643.0,643.0,5,1079,1.0,811.0,811.0
62.274,6,21,8145,11,1985,81.0,1174.0,504.0,10,6160,6900.0,2720.0,958.0
0.037,17,4,284,2,120,0.0,32.0,32.0,2,164,34.0,60.0,54.0
0.018,6,10,1989,5,910,4.0,642.0,642.0,5,1079,4.0,811.0,811.0
0.167,17,2,152,1,76,0.0,48.0,48.0,1,76,0.0,48.0,48.0
0.004,6,10,1989,5,927,1.0,659.0,659.0,5,1062,1.0,794.0,794.0
0.005,6,10,1689,5,839,1.0,571.0,571.0,5,850,1.0,582.0,582.0
0.07,17,8,3613,4,1874,23.0,1350.0,440.0,4,1739,11.0,1350.0,406.0
240.183,6,23,7730,12,2773,21834.0,1368.0,535.0,11,4957,24018.0,1656.0,875.0
0.042,17,2,182,1,65,0.0,37.0,37.0,1,117,0.0,89.0,89.0
0.005,6,10,2006,5,927,1.0,659.0,659.0,5,1079,1.0,811.0,811.0
0.011,6,10,1990,5,911,2.0,643.0,643.0,5,1079,2.0,811.0,811.0
0.01,6,10,1989,5,910,2.0,642.0,642.0,5,1079,2.0,811.0,811.0
78.512,6,28,9605,14,1707,6039.0,794.0,367.0,14,7898,6029.0,1360.0,732.0
0.014,6,10,1989,5,910,3.0,642.0,642.0,5,1079,3.0,811.0,811.0
0.005,17,2,179,1,71,0.0,43.0,43.0,1,108,0.0,80.0,80.0
0.088,6,10,1506,5,395,19.0,127.0,127.0,5,1111,20.0,843.0,843.0
0.043,17,4,352,2,130,1.0,37.0,37.0,2,222,34.0,89.0,83.0
0.076,6,10,1506,5,395,16.0,127.0,127.0,5,1111,17.0,843.0,843.0
0.015,6,10,1972,5,910,3.0,642.0,642.0,5,1062,3.0,794.0,794.0
0.005,17,2,140,1,62,0.0,34.0,34.0,1,78,0.0,50.0,50.0
0.001,17,2,180,1,66,0.0,38.0,38.0,1,114,0.0,86.0,86.0
0.015,6,10,1983,5,910,3.0,642.0,642.0,5,1073,3.0,805.0,805.0
0.095,6,10,1506,5,395,21.0,127.0,127.0,5,1111,17.0,843.0,843.0
0.099,6,10,1506,5,395,17.0,127.0,127.0,5,1111,22.0,843.0,843.0
0.022,6,20,9974,11,704,2.0,124.0,124.0,9,9270,2.0,2896.0,1758.0
0.001,17,2,180,1,66,0.0,38.0,38.0,1,114,0.0,86.0,86.0
0.015,6,10,1762,5,911,3.0,643.0,643.0,5,851,3.0,583.0,583.0
0.005,6,10,1854,5,889,1.0,621.0,621.0,5,965,1.0,697.0,697.0
0.016,17,2,198,1,91,0.0,63.0,63.0,1,107,0.0,79.0,79.0
0.084,6,10,1506,5,395,19.0,127.0,127.0,5,1111,19.0,843.0,843.0
0.008,17,2,179,1,71,0.0,43.0,43.0,1,108,0.0,80.0,80.0
0.021,6,10,1983,5,910,5.0,642.0,642.0,5,1073,5.0,805.0,805.0
0.006,6,10,1547,5,764,1.0,496.0,496.0,5,783,1.0,515.0,515.0
0.014,6,10,1989,5,910,3.0,642.0,642.0,5,1079,3.0,811.0,811.0
0.014,6,10,2006,5,927,3.0,659.0,659.0,5,1079,3.0,811.0,811.0
0.004,6,10,2006,5,927,1.0,659.0,659.0,5,1079,1.0,811.0,811.0
0.014,6,10,1631,5,848,3.0,580.0,580.0,5,783,3.0,515.0,515.0
0.005,6,10,1547,5,764,1.0,496.0,496.0,5,783,1.0,515.0,515.0
0.004,6,10,2007,5,928,1.0,660.0,660.0,5,1079,1.0,811.0,811.0
0.27,17,40,20134,20,16994,14.0,1350.0,821.0,20,3140,11.0,1350.0,129.0
0.005,17,2,214,1,75,0.0,47.0,47.0,1,139,0.0,111.0,111.0
40.054,17,10,676,5,460,10011.0,104.0,64.0,5,216,10012.0,20.0,15.0
0.105,6,10,1506,5,395,25.0,127.0,127.0,5,1111,24.0,843.0,843.0
0.012,6,10,1990,5,911,2.0,643.0,643.0,5,1079,3.0,811.0,811.0
0.004,6,10,1779,5,928,1.0,660.0,660.0,5,851,1.0,583.0,583.0
0.006,6,10,1689,5,839,1.0,571.0,571.0,5,850,1.0,582.0,582.0
0.038,17,2,152,1,76,0.0,48.0,48.0,1,76,0.0,48.0,48.0
0.006,6,10,1689,5,839,1.0,571.0,571.0,5,850,1.0,582.0,582.0
0.004,6,10,1774,5,923,1.0,655.0,655.0,5,851,0.0,583.0,583.0
40.059,17,10,676,5,460,10014.0,104.0,64.0,5,216,10014.0,20.0,15.0
0.01,6,10,1990,5,911,2.0,643.0,643.0,5,1079,2.0,811.0,811.0
0.005,6,10,2007,5,928,1.0,660.0,660.0,5,1079,1.0,811.0,811.0
0.017,6,10,1677,5,827,4.0,559.0,559.0,5,850,4.0,582.0,582.0
0.038,17,2,412,1,61,0.0,33.0,33.0,1,351,0.0,323.0,323.0
0.005,17,2,148,1,60,0.0,32.0,32.0,1,88,0.0,60.0,60.0
0.01,6,10,1983,5,910,2.0,642.0,642.0,5,1073,2.0,805.0,805.0
0.006,6,10,1547,5,764,1.0,496.0,496.0,5,783,1.0,515.0,515.0
0.008,6,10,1989,5,910,2.0,642.0,642.0,5,1079,2.0,811.0,811.0
0.009,6,10,1989,5,910,2.0,642.0,642.0,5,1079,2.0,811.0,811.0
0.072,17,2,166,1,75,0.0,47.0,47.0,1,91,0.0,63.0,63.0
1771.814,17,120,11460,60,5460,30030.0,63.0,63.0,60,6000,30030.0,72.0,72.0
40.058,17,10,676,5,460,10013.0,104.0,64.0,5,216,10013.0,20.0,15.0
0.005,6,10,2006,5,927,1.0,659.0,659.0,5,1079,1.0,811.0,811.0
0.039,17,4,364,2,160,0.0,52.0,52.0,2,204,2.0,80.0,74.0
0.01,6,13,3735,7,497,1.0,125.0,125.0,6,3238,2.0,1470.0,1459.0
10.754,17,28,4423,14,1995,818.0,270.0,114.0,14,2428,818.0,587.0,145.0
0.084,6,10,1506,5,395,20.0,127.0,127.0,5,1111,18.0,843.0,843.0
0.006,6,10,1547,5,764,1.0,496.0,496.0,5,783,1.0,515.0,515.0
284.968,6,28,9509,15,2606,20352.0,676.0,363.0,13,6903,23744.0,1402.0,890.0
0.004,6,10,2006,5,927,1.0,659.0,659.0,5,1079,1.0,811.0,811.0
40.063,17,10,676,5,460,10013.0,104.0,64.0,5,216,10014.0,20.0,15.0
0.011,6,10,1762,5,911,2.0,643.0,643.0,5,851,2.0,583.0,583.0
0.005,6,10,1779,5,928,1.0,660.0,660.0,5,851,1.0,583.0,583.0
0.095,17,2,152,1,76,0.0,48.0,48.0,1,76,0.0,48.0,48.0
0.108,6,10,1506,5,395,25.0,127.0,127.0,5,1111,23.0,843.0,843.0
0.004,6,10,2006,5,927,1.0,659.0,659.0,5,1079,1.0,811.0,811.0
0.041,17,2,152,1,76,0.0,48.0,48.0,1,76,0.0,48.0,48.0
300.378,6,16,2170,9,684,37527.0,146.0,146.0,7,1486,50035.0,419.0,398.0
0.198,17,2,194,1,59,0.0,31.0,31.0,1,135,0.0,107.0,107.0
40.06,17,10,676,5,460,10014.0,104.0,64.0,5,216,10013.0,20.0,15.0
0.014,6,10,1990,5,911,3.0,643.0,643.0,5,1079,3.0,811.0,811.0
0.001,17,2,166,1,75,0.0,47.0,47.0,1,91,0.0,63.0,63.0
15.077,17,15,8108,8,6000,2149.0,1350.0,722.0,7,2108,2507.0,1350.0,273.0
0.056,17,2,179,1,71,0.0,43.0,43.0,1,108,0.0,80.0,80.0
0.004,17,4,284,2,120,0.0,32.0,32.0,2,164,0.0,60.0,54.0
0.021,17,2,136,1,60,0.0,32.0,32.0,1,76,0.0,48.0,48.0
0.011,6,10,1677,5,827,2.0,559.0,559.0,5,850,2.0,582.0,582.0
0.001,17,2,180,1,66,0.0,38.0,38.0,1,114,0.0,86.0,86.0
241.489,6,312,344377,115,17496,2118.0,2736.0,886.0,197,326881,1232.0,2968.0,1693.0
0.01,6,10,1990,5,911,2.0,643.0,643.0,5,1079,2.0,811.0,811.0
0.004,6,10,1702,5,863,1.0,595.0,595.0,5,839,1.0,571.0,571.0
0.016,6,10,1989,5,910,3.0,642.0,642.0,5,1079,3.0,811.0,811.0
0.108,6,10,1506,5,395,23.0,127.0,127.0,5,1111,20.0,843.0,843.0
0.008,6,10,1631,5,848,1.0,580.0,580.0,5,783,2.0,515.0,515.0
0.005,6,10,2007,5,928,1.0,660.0,660.0,5,1079,1.0,811.0,811.0
0.004,6,10,1702,5,863,1.0,595.0,595.0,5,839,0.0,571.0,571.0
0.009,6,10,1972,5,910,2.0,642.0,642.0,5,1062,2.0,794.0,794.0
0.007,6,13,3735,7,497,1.0,125.0,125.0,6,3238,1.0,1470.0,1459.0
0.09,6,10,1506,5,395,16.0,127.0,127.0,5,1111,21.0,843.0,843.0
0.006,6,10,2007,5,928,1.0,660.0,660.0,5,1079,1.0,811.0,811.0
0.006,6,10,1689,5,839,1.0,571.0,571.0,5,850,1.0,582.0,582.0
0.005,6,10,1547,5,764,1.0,496.0,496.0,5,783,1.0,515.0,515.0
0.005,6,10,2007,5,928,1.0,660.0,660.0,5,1079,1.0,811.0,811.0
0.081,6,10,1506,5,395,18.0,127.0,127.0,5,1111,16.0,843.0,843.0
0.015,6,10,1631,5,848,3.0,580.0,580.0,5,783,3.0,515.0,515.0
15.072,17,15,9238,8,6902,2149.0,1350.0,834.0,7,2336,2507.0,1350.0,305.0
0.005,17,2,180,1,66,0.0,38.0,38.0,1,114,0.0,86.0,86.0
412.254,6,29,4409,12,3102,10911.0,494.0,494.0,17,1307,25765.0,83.0,83.0
0.01,6,10,1762,5,911,2.0,643.0,643.0,5,851,2.0,583.0,583.0
0.073,6,10,1506,5,395,13.0,127.0,127.0,5,1111,17.0,843.0,843.0
0.004,6,10,2000,5,927,1.0,659.0,659.0,5,1073,1.0,805.0,805.0
0.098,6,10,1506,5,395,19.0,127.0,127.0,5,1111,23.0,843.0,843.0
0.006,6,10,1547,5,764,1.0,496.0,496.0,5,783,1.0,515.0,515.0
0.012,6,10,1990,5,911,2.0,643.0,643.0,5,1079,3.0,811.0,811.0
0.201,6,10,1506,5,395,46.0,127.0,127.0,5,1111,44.0,843.0,843.0
0.012,6,10,1677,5,827,3.0,559.0,559.0,5,850,2.0,582.0,582.0
0.024,6,10,1631,5,848,5.0,580.0,580.0,5,783,5.0,515.0,515.0
0.005,6,10,2006,5,927,1.0,659.0,659.0,5,1079,1.0,811.0,811.0
0.006,6,10,1643,5,860,1.0,592.0,592.0,5,783,1.0,515.0,515.0
0.013,6,10,1972,5,910,3.0,642.0,642.0,5,1062,3.0,794.0,794.0
0.766,6,11,3130,6,1415,102.0,1163.0,1163.0,5,1715,128.0,1503.0,1503.0
0.013,6,10,1983,5,910,3.0,642.0,642.0,5,1073,3.0,805.0,805.0
0.004,6,10,2006,5,927,1.0,659.0,659.0,5,1079,1.0,811.0,811.0
0.005,6,10,2000,5,927,1.0,659.0,659.0,5,1073,1.0,805.0,805.0
0.004,6,10,1989,5,927,1.0,659.0,659.0,5,1062,1.0,794.0,794.0
1.151,6,32,13391,18,5892,67.0,2073.0,854.0,14,7499,74.0,2720.0,769.0
40.062,17,10,676,5,460,10014.0,104.0,64.0,5,216,10014.0,20.0,15.0
0.005,17,2,179,1,71,0.0,43.0,43.0,1,108,0.0,80.0,80.0
0.107,6,10,1506,5,395,24.0,127.0,127.0,5,1111,20.0,843.0,843.0
0.127,17,2,234,1,61,0.0,33.0,33.0,1,173,0.0,145.0,145.0
0.015,6,10,1631,5,848,3.0,580.0,580.0,5,783,3.0,515.0,515.0
0.001,17,2,174,1,72,0.0,44.0,44.0,1,102,0.0,74.0,74.0
0.004,6,10,1702,5,863,0.0,595.0,595.0,5,839,1.0,571.0,571.0
0.015,6,10,1762,5,911,3.0,643.0,643.0,5,851,3.0,583.0,583.0
27.587,6,44,18226,23,12588,412.0,2720.0,1292.0,21,5638,1370.0,2667.0,435.0
0.071,17,2,182,1,65,0.0,37.0,37.0,1,117,0.0,89.0,89.0
0.018,6,10,1989,5,910,4.0,642.0,642.0,5,1079,4.0,811.0,811.0
0.003,17,4,284,2,120,0.0,32.0,32.0,2,164,0.0,60.0,54.0
0.005,6,13,3684,7,446,0.0,74.0,74.0,6,3238,1.0,1470.0,1459.0
0.01,6,10,1972,5,910,2.0,642.0,642.0,5,1062,2.0,794.0,794.0
0.012,6,10,1989,5,910,3.0,642.0,642.0,5,1079,2.0,811.0,811.0
0.019,6,10,1990,5,911,4.0,643.0,643.0,5,1079,4.0,811.0,811.0
0.008,6,10,1983,5,910,2.0,642.0,642.0,5,1073,1.0,805.0,805.0
0.041,17,2,136,1,60,0.0,32.0,32.0,1,76,0.0,48.0,48.0
0.01,6,10,1989,5,910,2.0,642.0,642.0,5,1079,2.0,811.0,811.0
40.082,17,10,676,5,460,10019.0,104.0,64.0,5,216,10019.0,20.0,15.0
0.006,17,2,412,1,61,0.0,33.0,33.0,1,351,0.0,323.0,323.0
178.493,17,74,10567,37,2465,4958.0,44.0,38.0,37,8102,4958.0,239.0,190.0
1787.82,6,110,12466,55,3924,33106.0,517.0,176.0,55,8542,33107.0,1402.0,567.0
0.012,6,13,3816,7,578,2.0,206.0,206.0,6,3238,2.0,1470.0,1459.0
0.004,6,10,2006,5,927,1.0,659.0,659.0,5,1079,1.0,811.0,811.0
0.025,6,10,1972,5,910,6.0,642.0,642.0,5,1062,6.0,794.0,794.0
0.226,6,16,2669,8,1395,32.0,533.0,323.0,8,1274,21.0,529.0,212.0
0.005,6,10,2007,5,928,1.0,660.0,660.0,5,1079,1.0,811.0,811.0
0.039,17,4,420,2,122,0.0,33.0,33.0,2,298,2.0,145.0,121.0
10.947,17,28,4420,14,1993,833.0,268.0,114.0,14,2427,833.0,586.0,145.0
0.014,6,10,1989,5,910,3.0,642.0,642.0,5,1079,3.0,811.0,811.0
176.107,17,90,12764,45,3024,4002.0,44.0,39.0,45,9740,4002.0,261.0,188.0
0.007,6,10,1547,5,764,1.0,496.0,496.0,5,783,1.0,515.0,515.0
0.001,17,2,154,1,69,0.0,41.0,41.0,1,85,0.0,57.0,57.0
0.167,6,10,1506,5,395,37.0,127.0,127.0,5,1111,37.0,843.0,843.0
0.014,6,10,1972,5,910,3.0,642.0,642.0,5,1062,3.0,794.0,794.0
0.09,6,10,1506,5,395,21.0,127.0,127.0,5,1111,16.0,843.0,843.0
0.038,17,2,152,1,76,0.0,48.0,48.0,1,76,0.0,48.0,48.0
0.012,6,10,1990,5,911,2.0,643.0,643.0,5,1079,2.0,811.0,811.0
0.004,6,10,1774,5,923,1.0,655.0,655.0,5,851,0.0,583.0,583.0
0.105,6,10,1506,5,395,23.0,127.0,127.0,5,1111,24.0,843.0,843.0
0.006,6,10,1547,5,764,1.0,496.0,496.0,5,783,1.0,515.0,515.0
0.096,6,10,1506,5,395,20.0,127.0,127.0,5,1111,22.0,843.0,843.0
0.005,6,10,2006,5,927,1.0,659.0,659.0,5,1079,1.0,811.0,811.0
0.005,17,2,214,1,75,0.0,47.0,47.0,1,139,0.0,111.0,111.0
0.379,17,64,46570,40,40458,9.0,1350.0,983.0,24,6112,14.0,1350.0,226.0
0.095,6,10,1506,5,395,22.0,127.0,127.0,5,1111,23.0,843.0,843.0
0.259,17,40,20482,22,17095,12.0,1350.0,749.0,18,3387,12.0,1350.0,160.0
0.006,6,10,1547,5,764,1.0,496.0,496.0,5,783,1.0,515.0,515.0
0.009,6,10,1989,5,910,2.0,642.0,642.0,5,1079,2.0,811.0,811.0
0.072,17,2,136,1,60,0.0,32.0,32.0,1,76,0.0,48.0,48.0
10.916,17,28,4422,14,1995,831.0,270.0,114.0,14,2427,831.0,586.0,145.0
175.338,17,90,12823,45,2998,3984.0,44.0,38.0,45,9825,3984.0,239.0,190.0
0.072,17,2,182,1,65,0.0,37.0,37.0,1,117,0.0,89.0,89.0
10.71,17,28,4421,14,1994,815.0,269.0,114.0,14,2427,815.0,586.0,145.0
0.012,6,10,1990,5,911,2.0,643.0,643.0,5,1079,2.0,811.0,811.0
0.042,17,2,152,1,76,0.0,48.0,48.0,1,76,0.0,48.0,48.0
0.005,6,10,1779,5,928,1.0,660.0,660.0,5,851,1.0,583.0,583.0
0.011,6,10,1983,5,910,2.0,642.0,642.0,5,1073,2.0,805.0,805.0
361.801,6,21,1792,16,1030,24120.0,190.0,190.0,5,762,60009.0,461.0,247.0
0.007,6,10,1702,5,863,1.0,595.0,595.0,5,839,1.0,571.0,571.0
0.087,6,10,1506,5,395,18.0,127.0,127.0,5,1111,20.0,843.0,843.0
0.211,6,16,2669,8,1395,30.0,533.0,323.0,8,1274,18.0,529.0,212.0
0.012,6,10,1989,5,910,3.0,642.0,642.0,5,1079,2.0,811.0,811.0
0.015,6,10,1983,5,910,3.0,642.0,642.0,5,1073,3.0,805.0,805.0
300.332,6,16,2170,9,684,37520.0,146.0,146.0,7,1486,50027.0,419.0,398.0
11.186,17,28,4421,14,1994,848.0,269.0,114.0,14,2427,848.0,586.0,145.0
0.004,6,10,2006,5,927,1.0,659.0,659.0,5,1079,1.0,811.0,811.0
0.004,6,10,2006,5,927,1.0,659.0,659.0,5,1079,1.0,811.0,811.0
0.102,6,10,1506,5,395,24.0,127.0,127.0,5,1111,23.0,843.0,843.0
0.008,6,10,1972,5,910,1.0,642.0,642.0,5,1062,1.0,794.0,794.0
0.066,17,8,3613,4,1874,22.0,1350.0,440.0,4,1739,10.0,1350.0,406.0
0.077,6,10,1506,5,395,18.0,127.0,127.0,5,1111,18.0,843.0,843.0
0.038,17,2,136,1,60,0.0,32.0,32.0,1,76,0.0,48.0,48.0
0.006,6,10,1547,5,764,1.0,496.0,496.0,5,783,1.0,515.0,515.0
0.005,17,2,166,1,75,0.0,47.0,47.0,1,91,0.0,63.0,63.0
0.069,17,8,3613,4,1874,23.0,1350.0,440.0,4,1739,11.0,1350.0,406.0
0.006,6,10,2000,5,927,1.0,659.0,659.0,5,1073,1.0,805.0,805.0
0.005,6,10,2000,5,927,1.0,659.0,659.0,5,1073,1.0,805.0,805.0
0.005,6,10,1989,5,927,1.0,659.0,659.0,5,1062,1.0,794.0,794.0
0.006,6,10,1547,5,764,1.0,496.0,496.0,5,783,1.0,515.0,515.0
0.005,6,10,2006,5,927,1.0,659.0,659.0,5,1079,1.0,811.0,811.0
0.005,6,10,1774,5,923,1.0,655.0,655.0,5,851,1.0,583.0,583.0
0.174,6,3,453,2,321,174.0,241.0,241.0,1,132,0.0,92.0,92.0
0.006,17,2,230,1,68,0.0,40.0,40.0,1,162,0.0,134.0,134.0
0.011,6,10,1989,5,910,2.0,642.0,642.0,5,1079,2.0,811.0,811.0
0.004,6,10,2007,5,928,1.0,660.0,660.0,5,1079,1.0,811.0,811.0
0.007,6,10,1989,5,927,1.0,659.0,659.0,5,1062,1.0,794.0,794.0
40.05,17,10,676,5,460,10009.0,104.0,64.0,5,216,10011.0,20.0,15.0
0.006,6,10,1547,5,764,1.0,496.0,496.0,5,783,1.0,515.0,515.0
0.008,6,10,1762,5,911,2.0,643.0,643.0,5,851,1.0,583.0,583.0
0.11,6,10,1506,5,395,23.0,127.0,127.0,5,1111,23.0,843.0,843.0
0.005,6,10,1702,5,863,1.0,595.0,595.0,5,839,1.0,571.0,571.0
0.011,6,10,1990,5,911,2.0,643.0,643.0,5,1079,2.0,811.0,811.0
0.011,6,10,1989,5,910,2.0,642.0,642.0,5,1079,2.0,811.0,811.0
0.008,6,10,1631,5,848,2.0,580.0,580.0,5,783,2.0,515.0,515.0
0.005,6,10,2006,5,927,1.0,659.0,659.0,5,1079,1.0,811.0,811.0
333.539,17,20,1124,10,716,37053.0,48.0,43.0,10,408,37053.0,20.0,12.0
0.005,6,10,1547,5,764,1.0,496.0,496.0,5,783,1.0,515.0,515.0
10.939,17,28,4423,14,1995,832.0,270.0,114.0,14,2428,832.0,587.0,145.0
0.003,17,2,148,1,60,0.0,32.0,32.0,1,88,0.0,60.0,60.0
0.015,6,10,1983,5,910,3.0,642.0,642.0,5,1073,3.0,805.0,805.0
0.013,17,2,152,1,56,0.0,28.0,28.0,1,96,0.0,68.0,68.0
0.103,6,10,1506,5,395,23.0,127.0,127.0,5,1111,21.0,843.0,843.0
0.005,6,14,3742,8,504,0.0,80.0,80.0,6,3238,0.0,1470.0,1459.0
0.006,17,2,144,1,64,0.0,36.0,36.0,1,80,0.0,52.0,52.0
0.104,6,10,1506,5,395,23.0,127.0,127.0,5,1111,23.0,843.0,843.0
0.008,6,10,2006,5,927,1.0,659.0,659.0,5,1079,2.0,811.0,811.0
0.006,6,10,1547,5,764,1.0,496.0,496.0,5,783,1.0,515.0,515.0
0.005,17,2,222,1,65,0.0,37.0,37.0,1,157,0.0,129.0,129.0
0.005,6,10,1774,5,923,1.0,655.0,655.0,5,851,1.0,583.0,583.0
0.005,6,10,2006,5,927,1.0,659.0,659.0,5,1079,1.0,811.0,811.0
0.013,6,10,1983,5,910,3.0,642.0,642.0,5,1073,3.0,805.0,805.0
0.004,6,10,2007,5,928,1.0,660.0,660.0,5,1079,1.0,811.0,811.0
0.005,6,10,2006,5,927,1.0,659.0,659.0,5,1079,1.0,811.0,811.0
0.079,6,10,1506,5,395,16.0,127.0,127.0,5,1111,16.0,843.0,843.0
0.084,6,10,1506,5,395,18.0,127.0,127.0,5,1111,16.0,843.0,843.0
0.001,17,2,180,1,66,0.0,38.0,38.0,1,114,0.0,86.0,86.0
0.04,17,4,284,2,120,0.0,32.0,32.0,2,164,36.0,60.0,54.0
0.007,17,2,164,1,74,0.0,46.0,46.0,1,90,0.0,62.0,62.0
0.001,17,2,136,1,60,0.0,32.0,32.0,1,76,0.0,48.0,48.0
0.001,17,2,174,1,72,0.0,44.0,44.0,1,102,0.0,74.0,74.0
0.038,17,2,136,1,60,0.0,32.0,32.0,1,76,0.0,48.0,48.0
0.089,6,10,1983,5,910,22.0,642.0,642.0,5,1073,22.0,805.0,805.0
0.008,6,10,1972,5,910,2.0,642.0,642.0,5,1062,1.0,794.0,794.0
1772.501,6,105,6270,60,3525,30041.0,27.0,27.0,45,2745,40283.0,27.0,27.0
0.006,6,10,2000,5,927,1.0,659.0,659.0,5,1073,1.0,805.0,805.0
0.005,6,10,1689,5,839,1.0,571.0,571.0,5,850,1.0,582.0,582.0
0.013,6,10,1990,5,911,3.0,643.0,643.0,5,1079,3.0,811.0,811.0
0.013,6,10,1990,5,911,3.0,643.0,643.0,5,1079,3.0,811.0,811.0
15.077,17,16,8175,8,6093,2149.0,1350.0,733.0,8,2082,2149.0,1350.0,232.0
0.115,6,10,1506,5,395,28.0,127.0,127.0,5,1111,25.0,843.0,843.0
0.007,6,10,1989,5,910,1.0,642.0,642.0,5,1079,1.0,811.0,811.0
0.01,6,10,1989,5,910,2.0,642.0,642.0,5,1079,2.0,811.0,811.0
0.005,6,10,2006,5,927,1.0,659.0,659.0,5,1079,1.0,811.0,811.0
0.059,17,2,152,1,76,0.0,48.0,48.0,1,76,0.0,48.0,48.0
0.005,6,10,2006,5,927,1.0,659.0,659.0,5,1079,1.0,811.0,811.0
177.521,17,70,10067,35,2325,5221.0,44.0,38.0,35,7742,5221.0,239.0,193.0
0.006,6,10,1547,5,764,1.0,496.0,496.0,5,783,1.0,515.0,515.0
0.005,6,10,1689,5,839,1.0,571.0,571.0,5,850,1.0,582.0,582.0
0.005,6,10,2000,5,927,1.0,659.0,659.0,5,1073,1.0,805.0,805.0
0.014,6,10,1762,5,911,3.0,643.0,643.0,5,851,3.0,583.0,583.0
0.005,6,10,1689,5,839,1.0,571.0,571.0,5,850,1.0,582.0,582.0
0.004,17,2,148,1,60,0.0,32.0,32.0,1,88,0.0,60.0,60.0
0.012,6,10,1972,5,910,3.0,642.0,642.0,5,1062,3.0,794.0,794.0
0.005,6,10,2006,5,927,1.0,659.0,659.0,5,1079,1.0,811.0,811.0
0.014,6,10,1972,5,910,3.0,642.0,642.0,5,1062,3.0,794.0,794.0
240.102,6,16,4480,9,963,30012.0,238.0,166.0,7,3517,40016.0,1402.0,786.0
0.097,6,10,1506,5,395,21.0,127.0,127.0,5,1111,22.0,843.0,843.0
0.015,6,10,1972,5,910,3.0,642.0,642.0,5,1062,3.0,794.0,794.0
0.023,6,10,1989,5,910,5.0,642.0,642.0,5,1079,5.0,811.0,811.0
0.028,6,10,1989,5,910,6.0,642.0,642.0,5,1079,7.0,811.0,811.0
240.014,6,9,787,5,488,60003.0,232.0,232.0,4,299,80004.0,83.0,83.0
0.072,6,10,1506,5,395,16.0,127.0,127.0,5,1111,16.0,843.0,843.0
0.099,6,10,1506,5,395,21.0,127.0,127.0,5,1111,21.0,843.0,843.0
1772.045,6,105,6270,60,3525,30033.0,27.0,27.0,45,2745,40272.0,27.0,27.0
0.004,6,10,1774,5,923,1.0,655.0,655.0,5,851,1.0,583.0,583.0
0.009,17,2,148,1,60,0.0,32.0,32.0,1,88,0.0,60.0,60.0
0.11,6,10,1506,5,395,24.0,127.0,127.0,5,1111,25.0,843.0,843.0
0.011,6,10,1989,5,910,2.0,642.0,642.0,5,1079,2.0,811.0,811.0
324.073,17,20,1124,10,716,35993.0,48.0,43.0,10,408,35993.0,20.0,12.0
0.004,6,10,2006,5,927,1.0,659.0,659.0,5,1079,1.0,811.0,811.0
0.026,6,10,1989,5,910,6.0,642.0,642.0,5,1079,6.0,811.0,811.0
0.006,6,10,1547,5,764,1.0,496.0,496.0,5,783,1.0,515.0,515.0
0.012,6,10,1972,5,910,3.0,642.0,642.0,5,1062,3.0,794.0,794.0
0.012,6,10,1989,5,910,3.0,642.0,642.0,5,1079,2.0,811.0,811.0
0.005,6,10,1854,5,889,1.0,621.0,621.0,5,965,1.0,697.0,697.0
0.011,6,10,1677,5,827,2.0,559.0,559.0,5,850,2.0,582.0,582.0
0.075,6,10,1506,5,395,16.0,127.0,127.0,5,1111,17.0,843.0,843.0
0.083,6,10,1506,5,395,18.0,127.0,127.0,5,1111,18.0,843.0,843.0
40.066,17,10,676,5,460,10014.0,104.0,64.0,5,216,10015.0,20.0,15.0
0.103,6,10,1506,5,395,23.0,127.0,127.0,5,1111,23.0,843.0,843.0
0.008,6,10,1631,5,848,2.0,580.0,580.0,5,783,2.0,515.0,515.0
178.433,17,88,12386,44,2927,4149.0,44.0,38.0,44,9459,4149.0,239.0,186.0
0.004,6,10,2007,5,928,1.0,660.0,660.0,5,1079,1.0,811.0,811.0
0.169,6,10,1506,5,395,16.0,127.0,127.0,5,1111,40.0,843.0,843.0
0.089,6,10,1506,5,395,21.0,127.0,127.0,5,1111,20.0,843.0,843.0
240.089,6,16,4482,9,963,30011.0,238.0,166.0,7,3519,40014.0,1402.0,786.0
0.009,6,10,1774,5,923,2.0,655.0,655.0,5,851,2.0,583.0,583.0
0.011,6,10,1972,5,910,2.0,642.0,642.0,5,1062,2.0,794.0,794.0
0.006,6,10,1547,5,764,1.0,496.0,496.0,5,783,1.0,515.0,515.0
0.153,6,10,1506,5,395,33.0,127.0,127.0,5,1111,29.0,843.0,843.0
0.037,17,2,148,1,60,0.0,32.0,32.0,1,88,0.0,60.0,60.0
174.115,17,80,11416,40,2672,4464.0,44.0,38.0,40,8744,4464.0,239.0,190.0
2.639,6,33,10461,17,9046,164.0,1368.0,906.0,16,1415,175.0,197.0,97.0
0.01,6,10,1762,5,911,2.0,643.0,643.0,5,851,2.0,583.0,583.0
0.014,6,10,1989,5,910,3.0,642.0,642.0,5,1079,3.0,811.0,811.0
15.033,17,41,21653,23,18461,682.0,1350.0,774.0,18,3192,882.0,1350.0,149.0
0.096,6,10,1506,5,395,22.0,127.0,127.0,5,1111,18.0,843.0,843.0
0.006,6,10,1854,5,889,1.0,621.0,621.0,5,965,1.0,697.0,697.0
0.014,6,10,1983,5,910,3.0,642.0,642.0,5,1073,3.0,805.0,805.0
0.016,6,10,1989,5,910,4.0,642.0,642.0,5,1079,3.0,811.0,811.0
0.082,6,10,1506,5,395,17.0,127.0,127.0,5,1111,19.0,843.0,843.0
10.997,17,28,4424,14,1995,836.0,270.0,114.0,14,2429,837.0,588.0,145.0
0.008,6,14,3787,7,497,1.0,125.0,125.0,7,3290,1.0,1448.0,972.0
0.004,6,10,1774,5,923,1.0,655.0,655.0,5,851,1.0,583.0,583.0
0.08,6,10,1506,5,395,18.0,127.0,127.0,5,1111,17.0,843.0,843.0
40.065,17,10,676,5,460,10015.0,104.0,64.0,5,216,10015.0,20.0,15.0
0.02,6,10,1989,5,910,5.0,642.0,642.0,5,1079,5.0,811.0,811.0
0.003,17,2,148,1,60,0.0,32.0,32.0,1,88,0.0,60.0,60.0
0.127,17,2,182,1,65,0.0,37.0,37.0,1,117,0.0,89.0,89.0
0.006,6,10,1547,5,764,1.0,496.0,496.0,5,783,1.0,515.0,515.0
0.017,6,10,1990,5,911,4.0,643.0,643.0,5,1079,4.0,811.0,811.0
40.082,17,10,676,5,460,10018.0,104.0,64.0,5,216,10019.0,20.0,15.0
0.016,6,10,1989,5,910,4.0,642.0,642.0,5,1079,3.0,811.0,811.0
0.071,17,2,148,1,60,0.0,32.0,32.0,1,88,0.0,60.0,60.0
0.016,17,2,198,1,91,0.0,63.0,63.0,1,107,0.0,79.0,79.0
0.001,17,2,179,1,62,0.0,34.0,34.0,1,117,0.0,89.0,89.0
0.003,17,2,148,1,60,0.0,32.0,32.0,1,88,0.0,60.0,60.0
0.006,6,10,1689,5,839,1.0,571.0,571.0,5,850,1.0,582.0,582.0
0.01,6,10,1983,5,910,2.0,642.0,642.0,5,1073,2.0,805.0,805.0
0.014,6,10,1989,5,910,3.0,642.0,642.0,5,1079,3.0,811.0,811.0
40.063,17,10,676,5,460,10014.0,104.0,64.0,5,216,10015.0,20.0,15.0
0.009,6,10,1989,5,910,2.0,642.0,642.0,5,1079,2.0,811.0,811.0
40.061,17,10,676,5,460,10012.0,104.0,64.0,5,216,10014.0,20.0,15.0
0.005,6,13,3684,7,446,0.0,74.0,74.0,6,3238,1.0,1470.0,1459.0
0.004,6,10,1702,5,863,1.0,595.0,595.0,5,839,1.0,571.0,571.0
0.005,6,10,2000,5,927,1.0,659.0,659.0,5,1073,1.0,805.0,805.0
0.003,17,2,148,1,60,0.0,32.0,32.0,1,88,0.0,60.0,60.0
0.011,6,10,1990,5,911,2.0,643.0,643.0,5,1079,2.0,811.0,811.0
0.006,17,2,214,1,75,0.0,47.0,47.0,1,139,0.0,111.0,111.0
0.006,6,12,1698,6,863,1.0,327.0,271.0,6,835,1.0,515.0,515.0
0.004,17,4,284,2,120,1.0,32.0,32.0,2,164,0.0,60.0,54.0
40.054,17,10,676,5,460,10011.0,104.0,64.0,5,216,10012.0,20.0,15.0
0.085,6,10,1506,5,395,18.0,127.0,127.0,5,1111,19.0,843.0,843.0
0.004,17,2,187,1,74,0.0,46.0,46.0,1,113,0.0,85.0,85.0
0.004,6,10,1989,5,927,1.0,659.0,659.0,5,1062,1.0,794.0,794.0
0.004,6,10,1779,5,928,1.0,660.0,660.0,5,851,1.0,583.0,583.0
0.005,6,13,3747,7,509,0.0,137.0,137.0,6,3238,0.0,1470.0,1459.0
0.004,17,4,284,2,120,0.0,32.0,32.0,2,164,1.0,60.0,54.0
0.004,17,2,148,1,60,0.0,32.0,32.0,1,88,0.0,60.0,60.0
0.001,17,2,136,1,60,0.0,32.0,32.0,1,76,0.0,48.0,48.0
0.004,6,10,1774,5,923,1.0,655.0,655.0,5,851,1.0,583.0,583.0
0.018,6,10,1990,5,911,4.0,643.0,643.0,5,1079,4.0,811.0,811.0
0.011,6,10,1990,5,911,2.0,643.0,643.0,5,1079,2.0,811.0,811.0
0.005,6,10,2007,5,928,1.0,660.0,660.0,5,1079,1.0,811.0,811.0
0.005,6,10,1989,5,927,1.0,659.0,659.0,5,1062,1.0,794.0,794.0
0.005,17,2,230,1,68,0.0,40.0,40.0,1,162,0.0,134.0,134.0
0.012,6,10,1972,5,910,2.0,642.0,642.0,5,1062,2.0,794.0,794.0
0.082,6,10,1506,5,395,16.0,127.0,127.0,5,1111,17.0,843.0,843.0
0.005,6,10,1854,5,889,1.0,621.0,621.0,5,965,1.0,697.0,697.0
0.01,6,10,1762,5,911,2.0,643.0,643.0,5,851,2.0,583.0,583.0
0.011,17,2,299,1,65,0.0,37.0,37.0,1,234,0.0,206.0,206.0
0.042,17,4,284,2,120,0.0,32.0,32.0,2,164,39.0,60.0,54.0
0.006,17,2,164,1,74,0.0,46.0,46.0,1,90,0.0,62.0,62.0
0.021,6,10,1983,5,910,5.0,642.0,642.0,5,1073,5.0,805.0,805.0
0.005,6,10,2007,5,928,1.0,660.0,660.0,5,1079,1.0,811.0,811.0
10.93,17,24,3782,12,1674,984.0,269.0,111.0,12,2108,984.0,587.0,147.0
0.077,6,10,1506,5,395,17.0,127.0,127.0,5,1111,15.0,843.0,843.0
0.006,17,2,140,1,62,0.0,34.0,34.0,1,78,0.0,50.0,50.0
40.069,17,10,676,5,460,10015.0,104.0,64.0,5,216,10016.0,20.0,15.0
0.043,17,2,148,1,60,0.0,32.0,32.0,1,88,0.0,60.0,60.0
0.005,17,2,214,1,75,0.0,47.0,47.0,1,139,0.0,111.0,111.0
0.008,6,14,3742,7,452,1.0,80.0,80.0,7,3290,1.0,1448.0,972.0
0.008,17,2,299,1,65,0.0,37.0,37.0,1,234,0.0,206.0,206.0
0.006,17,2,144,1,64,0.0,36.0,36.0,1,80,0.0,52.0,52.0
0.004,6,10,2006,5,927,1.0,659.0,659.0,5,1079,1.0,811.0,811.0
0.105,6,10,1506,5,395,23.0,127.0,127.0,5,1111,24.0,843.0,843.0
0.103,6,10,1506,5,395,24.0,127.0,127.0,5,1111,21.0,843.0,843.0
300.027,6,12,1782,7,1348,50004.0,494.0,494.0,5,434,75006.0,83.0,83.0
0.021,6,10,1631,5,848,5.0,580.0,580.0,5,783,5.0,515.0,515.0
0.018,6,10,1990,5,911,4.0,643.0,643.0,5,1079,4.0,811.0,811.0
0.005,6,10,2007,5,928,1.0,660.0,660.0,5,1079,1.0,811.0,811.0
0.087,6,10,1506,5,395,20.0,127.0,127.0,5,1111,14.0,843.0,843.0
0.005,17,2,213,1,69,0.0,41.0,41.0,1,144,0.0,116.0,116.0
0.009,6,10,1989,5,910,2.0,642.0,642.0,5,1079,2.0,811.0,811.0
0.079,6,10,1506,5,395,17.0,127.0,127.0,5,1111,19.0,843.0,843.0
0.113,6,10,1506,5,395,24.0,127.0,127.0,5,1111,27.0,843.0,843.0
0.004,6,10,1702,5,863,1.0,595.0,595.0,5,839,0.0,571.0,571.0
8.956,6,39,10487,20,4929,471.0,1360.0,682.0,19,5558,485.0,2667.0,435.0
0.016,6,10,1989,5,910,3.0,642.0,642.0,5,1079,3.0,811.0,811.0
240.088,6,34,9502,18,6894,14122.0,1861.0,662.0,16,2608,16005.0,580.0,221.0
0.005,6,13,3747,7,509,0.0,137.0,137.0,6,3238,1.0,1470.0,1459.0
0.006,17,2,302,1,65,0.0,37.0,37.0,1,237,0.0,209.0,209.0
1771.643,17,120,11460,60,5460,30027.0,63.0,63.0,60,6000,30027.0,72.0,72.0
0.006,6,10,1689,5,839,1.0,571.0,571.0,5,850,1.0,582.0,582.0
15.07,17,15,9239,8,6902,2148.0,1350.0,834.0,7,2337,2506.0,1350.0,305.0
0.123,17,2,80,1,32,0.0,4.0,4.0,1,48,0.0,20.0,20.0
0.005,6,13,3747,7,509,0.0,137.0,137.0,6,3238,1.0,1470.0,1459.0
0.005,6,10,1989,5,927,1.0,659.0,659.0,5,1062,1.0,794.0,794.0
0.012,6,10,1972,5,910,3.0,642.0,642.0,5,1062,3.0,794.0,794.0
0.004,6,10,1702,5,863,1.0,595.0,595.0,5,839,1.0,571.0,571.0
0.011,6,10,1989,5,910,2.0,642.0,642.0,5,1079,2.0,811.0,811.0
0.015,6,10,1989,5,910,3.0,642.0,642.0,5,1079,3.0,811.0,811.0
0.005,6,10,1989,5,927,1.0,659.0,659.0,5,1062,1.0,794.0,794.0
0.005,6,10,2007,5,928,1.0,660.0,660.0,5,1079,1.0,811.0,811.0
169.162,6,20,3480,10,1537,18790.0,533.0,252.0,10,1943,18791.0,529.0,283.0
0.005,17,2,230,1,68,0.0,40.0,40.0,1,162,0.0,134.0,134.0
0.039,17,2,140,1,62,0.0,34.0,34.0,1,78,0.0,50.0,50.0
1770.66,6,88,4703,44,2342,41177.0,27.0,27.0,44,2361,41177.0,26.0,24.0
0.012,6,10,1972,5,910,3.0,642.0,642.0,5,1062,3.0,794.0,794.0
0.111,6,10,1506,5,395,20.0,127.0,127.0,5,1111,25.0,843.0,843.0
0.006,6,10,1643,5,860,1.0,592.0,592.0,5,783,1.0,515.0,515.0
0.006,6,10,2006,5,927,1.0,659.0,659.0,5,1079,1.0,811.0,811.0
0.01,6,13,3735,7,497,1.0,125.0,125.0,6,3238,1.0,1470.0,1459.0
0.004,6,10,1774,5,923,1.0,655.0,655.0,5,851,1.0,583.0,583.0
0.094,6,10,1506,5,395,18.0,127.0,127.0,5,1111,22.0,843.0,843.0
0.167,17,2,152,1,76,0.0,48.0,48.0,1,76,0.0,48.0,48.0
0.156,6,10,1506,5,395,35.0,127.0,127.0,5,1111,36.0,843.0,843.0
373.843,6,22,2313,16,867,24922.0,195.0,195.0,6,1446,4671.0,419.0,398.0
0.013,6,10,1677,5,827,3.0,559.0,559.0,5,850,3.0,582.0,582.0
0.13,6,10,1506,5,395,31.0,127.0,127.0,5,1111,29.0,843.0,843.0
0.12,6,10,1506,5,395,23.0,127.0,127.0,5,1111,26.0,843.0,843.0
0.096,6,10,1506,5,395,20.0,127.0,127.0,5,1111,20.0,843.0,843.0
0.095,6,10,1506,5,395,21.0,127.0,127.0,5,1111,19.0,843.0,843.0
0.005,6,13,3747,7,509,0.0,137.0,137.0,6,3238,1.0,1470.0,1459.0
10.811,17,28,4422,14,1994,823.0,269.0,114.0,14,2428,823.0,587.0,145.0
0.013,6,10,1990,5,911,3.0,643.0,643.0,5,1079,3.0,811.0,811.0
0.005,6,14,3742,7,452,0.0,80.0,80.0,7,3290,0.0,1448.0,972.0
0.005,6,10,1779,5,928,1.0,660.0,660.0,5,851,1.0,583.0,583.0
0.001,17,2,180,1,66,0.0,38.0,38.0,1,114,0.0,86.0,86.0
0.016,6,10,1972,5,910,4.0,642.0,642.0,5,1062,3.0,794.0,794.0
0.006,6,10,2000,5,927,1.0,659.0,659.0,5,1073,1.0,805.0,805.0
0.038,17,4,284,2,120,1.0,32.0,32.0,2,164,34.0,60.0,54.0
240.357,6,24,4122,11,1756,24033.0,539.0,235.0,13,2366,20026.0,1320.0,242.0
0.007,6,10,1854,5,889,1.0,621.0,621.0,5,965,1.0,697.0,697.0
0.008,6,10,1989,5,910,2.0,642.0,642.0,5,1079,2.0,811.0,811.0
40.03,17,10,676,5,460,10004.0,104.0,64.0,5,216,10006.0,20.0,15.0
0.014,6,10,1972,5,910,3.0,642.0,642.0,5,1062,3.0,794.0,794.0
0.018,6,10,1990,5,911,4.0,643.0,643.0,5,1079,4.0,811.0,811.0
0.005,6,10,2007,5,928,1.0,660.0,660.0,5,1079,1.0,811.0,811.0
40.043,17,10,676,5,460,10010.0,104.0,64.0,5,216,10008.0,20.0,15.0
0.009,6,10,1989,5,910,2.0,642.0,642.0,5,1079,2.0,811.0,811.0
0.016,6,10,1989,5,910,4.0,642.0,642.0,5,1079,4.0,811.0,811.0
0.004,6,10,2000,5,927,1.0,659.0,659.0,5,1073,1.0,805.0,805.0
0.005,6,10,2007,5,928,1.0,660.0,660.0,5,1079,1.0,811.0,811.0
0.081,6,10,1506,5,395,17.0,127.0,127.0,5,1111,16.0,843.0,843.0
0.006,6,10,1643,5,860,1.0,592.0,592.0,5,783,1.0,515.0,515.0
0.013,6,10,1989,5,910,3.0,642.0,642.0,5,1079,3.0,811.0,811.0
0.009,6,10,1983,5,910,2.0,642.0,642.0,5,1073,2.0,805.0,805.0
308.716,17,20,1124,10,716,34287.0,48.0,43.0,10,408,34287.0,20.0,12.0
0.016,17,2,198,1,91,0.0,63.0,63.0,1,107,0.0,79.0,79.0
0.106,6,10,1506,5,395,23.0,127.0,127.0,5,1111,21.0,843.0,843.0
1756.151,6,478,68514,262,36040,6728.0,613.0,193.0,216,32474,8167.0,469.0,145.0
293.431,6,379,346778,193,21594,1528.0,2736.0,888.0,186,325184,1586.0,2804.0,1834.0
0.005,6,10,1779,5,928,1.0,660.0,660.0,5,851,1.0,583.0,583.0
0.001,17,2,180,1,66,0.0,38.0,38.0,1,114,0.0,86.0,86.0
0.097,6,10,1506,5,395,13.0,127.0,127.0,5,1111,23.0,843.0,843.0
354.059,6,21,1795,16,1030,23603.0,190.0,190.0,5,765,60001.0,464.0,248.0
0.005,6,10,1689,5,839,1.0,571.0,571.0,5,850,1.0,582.0,582.0
11.217,17,28,4423,14,1995,850.0,270.0,114.0,14,2428,850.0,587.0,145.0
0.039,17,2,152,1,76,0.0,48.0,48.0,1,76,0.0,48.0,48.0
0.005,6,13,3690,7,452,0.0,80.0,80.0,6,3238,0.0,1470.0,1459.0
0.109,6,10,1506,5,395,25.0,127.0,127.0,5,1111,25.0,843.0,843.0
300.746,6,37,8061,19,2543,16708.0,1367.0,437.0,18,5518,504.0,1360.0,398.0
0.005,6,10,1989,5,927,1.0,659.0,659.0,5,1062,1.0,794.0,794.0
0.005,6,10,1989,5,927,1.0,659.0,659.0,5,1062,1.0,794.0,794.0
0.007,17,2,194,1,59,0.0,31.0,31.0,1,135,0.0,107.0,107.0
0.005,6,10,2007,5,928,1.0,660.0,660.0,5,1079,1.0,811.0,811.0
0.081,6,10,1506,5,395,18.0,127.0,127.0,5,1111,17.0,843.0,843.0
0.016,6,14,3787,7,497,2.0,125.0,125.0,7,3290,2.0,1448.0,972.0
0.013,6,6,716,3,458,4.0,302.0,302.0,3,258,4.0,102.0,102.0
40.055,17,10,676,5,460,10012.0,104.0,64.0,5,216,10012.0,20.0,15.0
0.004,17,2,412,1,61,0.0,33.0,33.0,1,351,0.0,323.0,323.0
0.005,6,10,2006,5,927,1.0,659.0,659.0,5,1079,1.0,811.0,811.0
0.084,6,10,1506,5,395,18.0,127.0,127.0,5,1111,18.0,843.0,843.0
0.043,17,2,182,1,65,0.0,37.0,37.0,1,117,0.0,89.0,89.0
0.076,6,10,1506,5,395,17.0,127.0,127.0,5,1111,16.0,843.0,843.0
0.005,6,10,2000,5,927,1.0,659.0,659.0,5,1073,1.0,805.0,805.0
240.09,6,16,4481,9,963,30011.0,238.0,166.0,7,3518,40014.0,1402.0,786.0
0.009,6,10,1972,5,910,2.0,642.0,642.0,5,1062,2.0,794.0,794.0
0.005,6,10,2006,5,927,1.0,659.0,659.0,5,1079,1.0,811.0,811.0
0.123,17,2,80,1,32,0.0,4.0,4.0,1,48,0.0,20.0,20.0
0.004,6,10,2007,5,928,1.0,660.0,660.0,5,1079,1.0,811.0,811.0
0.218,17,4,596,2,122,179.0,33.0,33.0,2,474,146.0,323.0,209.0
0.006,17,2,166,1,75,0.0,47.0,47.0,1,91,0.0,63.0,63.0
0.014,6,10,1972,5,910,3.0,642.0,642.0,5,1062,3.0,794.0,794.0
0.084,17,8,3613,4,1874,28.0,1350.0,440.0,4,1739,12.0,1350.0,406.0
0.005,6,10,1854,5,889,1.0,621.0,621.0,5,965,1.0,697.0,697.0
65.821,6,26,10460,12,3961,5983.0,1402.0,668.0,14,6499,5052.0,2111.0,576.0
0.006,17,2,166,1,75,0.0,47.0,47.0,1,91,0.0,63.0,63.0
312.837,17,20,1124,10,716,34752.0,48.0,43.0,10,408,34752.0,20.0,12.0
0.01,6,12,1926,6,1189,1.0,659.0,434.0,6,737,1.0,417.0,417.0
0.005,17,2,170,1,65,0.0,37.0,37.0,1,105,0.0,77.0,77.0
310.779,17,20,1124,10,716,34516.0,48.0,43.0,10,408,34516.0,20.0,12.0
0.14,6,10,1506,5,395,30.0,127.0,127.0,5,1111,26.0,843.0,843.0
0.008,6,10,1990,5,911,1.0,643.0,643.0,5,1079,2.0,811.0,811.0
0.015,6,10,1990,5,911,3.0,643.0,643.0,5,1079,3.0,811.0,811.0
0.005,6,10,2007,5,928,1.0,660.0,660.0,5,1079,1.0,811.0,811.0
0.01,6,10,1983,5,910,2.0,642.0,642.0,5,1073,2.0,805.0,805.0
0.006,6,10,1689,5,839,1.0,571.0,571.0,5,850,1.0,582.0,582.0
0.009,17,2,170,1,65,0.0,37.0,37.0,1,105,0.0,77.0,77.0
0.079,6,10,1506,5,395,17.0,127.0,127.0,5,1111,18.0,843.0,843.0
0.354,6,10,1506,5,395,86.0,127.0,127.0,5,1111,39.0,843.0,843.0
0.006,6,10,1547,5,764,1.0,496.0,496.0,5,783,1.0,515.0,515.0
1798.557,17,3255,248290,1617,131123,1112.0,84.0,53.0,1638,117167,1098.0,227.0,43.0
0.168,6,10,1506,5,395,39.0,127.0,127.0,5,1111,40.0,843.0,843.0
0.012,6,10,1631,5,848,3.0,580.0,580.0,5,783,3.0,515.0,515.0
0.088,6,10,1506,5,395,21.0,127.0,127.0,5,1111,18.0,843.0,843.0
0.013,6,10,1989,5,910,3.0,642.0,642.0,5,1079,3.0,811.0,811.0
0.004,6,10,1702,5,863,1.0,595.0,595.0,5,839,0.0,571.0,571.0
0.005,6,10,2006,5,927,1.0,659.0,659.0,5,1079,1.0,811.0,811.0
0.011,6,10,1990,5,911,2.0,643.0,643.0,5,1079,2.0,811.0,811.0
0.004,6,10,2007,5,928,1.0,660.0,660.0,5,1079,1.0,811.0,811.0
0.005,6,10,1989,5,927,1.0,659.0,659.0,5,1062,1.0,794.0,794.0
11.178,17,28,4421,14,1993,847.0,268.0,114.0,14,2428,847.0,587.0,145.0
0.01,6,10,1677,5,827,2.0,559.0,559.0,5,850,2.0,582.0,582.0
0.098,6,10,1506,5,395,19.0,127.0,127.0,5,1111,21.0,843.0,843.0
0.019,6,10,1677,5,827,4.0,559.0,559.0,5,850,4.0,582.0,582.0
300.139,6,26,7929,14,2893,23087.0,1368.0,429.0,12,5036,27285.0,1655.0,883.0
0.082,6,10,1506,5,395,19.0,127.0,127.0,5,1111,18.0,843.0,843.0
40.068,17,10,676,5,460,10014.0,104.0,64.0,5,216,10016.0,20.0,15.0
0.012,6,10,1989,5,910,2.0,642.0,642.0,5,1079,2.0,811.0,811.0
0.001,17,2,180,1,66,0.0,38.0,38.0,1,114,0.0,86.0,86.0
0.104,6,10,1506,5,395,24.0,127.0,127.0,5,1111,22.0,843.0,843.0
0.238,6,19,6500,9,1446,29.0,533.0,323.0,10,5054,20.0,1402.0,754.0
0.005,6,10,1779,5,928,1.0,660.0,660.0,5,851,1.0,583.0,583.0
0.005,6,10,1854,5,889,1.0,621.0,621.0,5,965,1.0,697.0,697.0
0.072,17,4,596,2,122,1.0,33.0,33.0,2,474,68.0,323.0,209.0
0.005,6,10,1989,5,927,1.0,659.0,659.0,5,1062,1.0,794.0,794.0
1.548,6,143,99630,71,96561,18.0,2828.0,1398.0,72,3069,18.0,177.0,177.0
0.006,6,12,1698,6,863,1.0,327.0,271.0,6,835,1.0,515.0,515.0
0.084,6,10,1506,5,395,18.0,127.0,127.0,5,1111,19.0,843.0,843.0
0.006,6,10,1689,5,839,1.0,571.0,571.0,5,850,1.0,582.0,582.0
0.019,6,10,1989,5,910,4.0,642.0,642.0,5,1079,4.0,811.0,811.0
0.001,17,2,166,1,75,0.0,47.0,47.0,1,91,0.0,63.0,63.0
0.005,6,10,2007,5,928,1.0,660.0,660.0,5,1079,1.0,811.0,811.0
0.004,17,2,148,1,60,0.0,32.0,32.0,1,88,0.0,60.0,60.0
0.082,6,10,1506,5,395,20.0,127.0,127.0,5,1111,19.0,843.0,843.0
0.006,6,10,1547,5,764,1.0,496.0,496.0,5,783,1.0,515.0,515.0
0.072,6,10,1506,5,395,16.0,127.0,127.0,5,1111,15.0,843.0,843.0
0.006,6,10,1547,5,764,1.0,496.0,496.0,5,783,1.0,515.0,515.0
0.012,6,10,1631,5,848,2.0,580.0,580.0,5,783,3.0,515.0,515.0
0.005,6,10,2007,5,928,1.0,660.0,660.0,5,1079,1.0,811.0,811.0
1796.896,6,244,35804,152,26032,11899.0,302.0,302.0,92,9772,19746.0,83.0,83.0
0.013,6,10,1990,5,911,3.0,643.0,643.0,5,1079,3.0,811.0,811.0
0.005,6,10,1643,5,860,1.0,592.0,592.0,5,783,1.0,515.0,515.0
0.006,6,10,1643,5,860,1.0,592.0,592.0,5,783,1.0,515.0,515.0
0.005,6,10,1547,5,764,1.0,496.0,496.0,5,783,1.0,515.0,515.0
0.076,6,10,1506,5,395,17.0,127.0,127.0,5,1111,17.0,843.0,843.0
0.016,6,10,1989,5,910,4.0,642.0,642.0,5,1079,4.0,811.0,811.0
15.074,17,15,9239,8,6902,2149.0,1350.0,834.0,7,2337,2507.0,1350.0,305.0
0.005,6,10,1643,5,860,1.0,592.0,592.0,5,783,1.0,515.0,515.0
0.076,6,10,1506,5,395,17.0,127.0,127.0,5,1111,17.0,843.0,843.0
242.984,6,308,343291,118,17644,2076.0,2736.0,885.0,190,325647,1285.0,2804.0,1754.0
0.005,6,13,3684,7,446,0.0,74.0,74.0,6,3238,0.0,1470.0,1459.0
0.005,17,2,170,1,65,0.0,37.0,37.0,1,105,0.0,77.0,77.0
0.012,6,10,1983,5,910,2.0,642.0,642.0,5,1073,3.0,805.0,805.0
0.005,17,2,144,1,64,0.0,36.0,36.0,1,80,0.0,52.0,52.0
0.012,6,10,1989,5,910,2.0,642.0,642.0,5,1079,2.0,811.0,811.0
0.007,6,10,1972,5,910,1.0,642.0,642.0,5,1062,1.0,794.0,794.0
0.013,6,10,1989,5,910,3.0,642.0,642.0,5,1079,3.0,811.0,811.0
0.052,17,2,152,1,76,0.0,48.0,48.0,1,76,0.0,48.0,48.0
0.014,6,10,1762,5,911,3.0,643.0,643.0,5,851,3.0,583.0,583.0
240.099,6,16,4481,9,963,30012.0,238.0,166.0,7,3518,40016.0,1402.0,786.0
0.016,6,10,1990,5,911,3.0,643.0,643.0,5,1079,4.0,811.0,811.0
0.003,17,2,136,1,60,0.0,32.0,32.0,1,76,0.0,48.0,48.0
40.049,17,10,676,5,460,10011.0,104.0,64.0,5,216,10011.0,20.0,15.0
0.005,17,2,170,1,65,0.0,37.0,37.0,1,105,0.0,77.0,77.0
0.005,17,2,164,1,74,0.0,46.0,46.0,1,90,0.0,62.0,62.0
0.009,6,10,1989,5,910,2.0,642.0,642.0,5,1079,2.0,811.0,811.0
0.017,6,10,1990,5,911,4.0,643.0,643.0,5,1079,4.0,811.0,811.0
361.766,6,21,1793,16,1030,24117.0,190.0,190.0,5,763,60010.0,462.0,247.0
427.576,6,29,4409,12,3102,10914.0,494.0,494.0,17,1307,26722.0,83.0,83.0
0.105,6,10,1506,5,395,23.0,127.0,127.0,5,1111,24.0,843.0,843.0
0.005,6,10,1689,5,839,1.0,571.0,571.0,5,850,1.0,582.0,582.0
0.117,6,10,1506,5,395,24.0,127.0,127.0,5,1111,25.0,843.0,843.0
0.001,17,2,180,1,66,0.0,38.0,38.0,1,114,0.0,86.0,86.0
0.06,6,10,1506,5,395,14.0,127.0,127.0,5,1111,12.0,843.0,843.0
0.084,6,10,1506,5,395,18.0,127.0,127.0,5,1111,18.0,843.0,843.0
0.003,6,10,1702,5,863,0.0,595.0,595.0,5,839,0.0,571.0,571.0
0.011,6,10,1972,5,910,2.0,642.0,642.0,5,1062,2.0,794.0,794.0
0.005,6,10,2007,5,928,1.0,660.0,660.0,5,1079,1.0,811.0,811.0
0.009,6,13,3735,7,497,1.0,125.0,125.0,6,3238,1.0,1470.0,1459.0
30.376,6,44,18602,23,12964,409.0,2720.0,1334.0,21,5638,1510.0,2667.0,435.0
0.246,17,43,24449,24,21167,10.0,1350.0,853.0,19,3282,10.0,1350.0,144.0
0.006,6,10,1989,5,927,1.0,659.0,659.0,5,1062,1.0,794.0,794.0
0.152,6,10,1506,5,395,36.0,127.0,127.0,5,1111,37.0,843.0,843.0
175.219,17,92,12994,46,3081,3893.0,44.0,38.0,46,9913,3893.0,239.0,187.0
0.004,6,10,2006,5,927,1.0,659.0,659.0,5,1079,1.0,811.0,811.0
0.008,17,2,194,1,59,0.0,31.0,31.0,1,135,0.0,107.0,107.0
0.005,6,10,1854,5,889,1.0,621.0,621.0,5,965,1.0,697.0,697.0
0.012,6,10,1990,5,911,3.0,643.0,643.0,5,1079,2.0,811.0,811.0
0.022,6,10,1631,5,848,5.0,580.0,580.0,5,783,5.0,515.0,515.0
0.003,17,2,136,1,60,0.0,32.0,32.0,1,76,0.0,48.0,48.0
0.039,17,2,412,1,61,0.0,33.0,33.0,1,351,0.0,323.0,323.0
0.004,17,4,284,2,120,0.0,32.0,32.0,2,164,1.0,60.0,54.0
0.072,6,10,1506,5,395,16.0,127.0,127.0,5,1111,15.0,843.0,843.0
0.08,6,10,1506,5,395,17.0,127.0,127.0,5,1111,17.0,843.0,843.0
0.018,6,10,1989,5,910,4.0,642.0,642.0,5,1079,4.0,811.0,811.0
0.006,6,10,1689,5,839,1.0,571.0,571.0,5,850,1.0,582.0,582.0
0.097,6,10,1506,5,395,21.0,127.0,127.0,5,1111,19.0,843.0,843.0
0.011,6,10,1972,5,910,2.0,642.0,642.0,5,1062,2.0,794.0,794.0
0.003,17,2,152,1,76,0.0,48.0,48.0,1,76,0.0,48.0,48.0
0.006,6,10,1854,5,889,1.0,621.0,621.0,5,965,1.0,697.0,697.0
0.014,6,10,1677,5,827,3.0,559.0,559.0,5,850,3.0,582.0,582.0
0.005,6,10,2006,5,927,1.0,659.0,659.0,5,1079,1.0,811.0,811.0
0.008,6,10,1990,5,911,2.0,643.0,643.0,5,1079,2.0,811.0,811.0
0.005,6,10,2007,5,928,1.0,660.0,660.0,5,1079,1.0,811.0,811.0
0.117,6,10,1506,5,395,27.0,127.0,127.0,5,1111,24.0,843.0,843.0
0.008,6,10,1990,5,911,2.0,643.0,643.0,5,1079,2.0,811.0,811.0
0.004,6,10,1779,5,928,1.0,660.0,660.0,5,851,1.0,583.0,583.0
0.012,6,10,1990,5,911,3.0,643.0,643.0,5,1079,3.0,811.0,811.0
0.005,17,2,154,1,69,0.0,41.0,41.0,1,85,0.0,57.0,57.0
0.269,17,40,21441,22,18412,12.0,1350.0,808.0,18,3029,11.0,1350.0,140.0
0.043,6,10,1989,5,910,10.0,642.0,642.0,5,1079,10.0,811.0,811.0
0.006,6,10,2006,5,927,1.0,659.0,659.0,5,1079,1.0,811.0,811.0
0.077,6,10,1506,5,395,17.0,127.0,127.0,5,1111,16.0,843.0,843.0
0.017,6,10,1989,5,910,4.0,642.0,642.0,5,1079,4.0,811.0,811.0
0.01,6,10,1762,5,911,2.0,643.0,643.0,5,851,2.0,583.0,583.0
0.001,17,2,180,1,66,0.0,38.0,38.0,1,114,0.0,86.0,86.0
0.002,17,2,136,1,60,0.0,32.0,32.0,1,76,0.0,48.0,48.0
0.074,6,10,1506,5,395,17.0,127.0,127.0,5,1111,15.0,843.0,843.0
0.012,6,10,1983,5,910,3.0,642.0,642.0,5,1073,2.0,805.0,805.0
0.101,6,10,1506,5,395,22.0,127.0,127.0,5,1111,19.0,843.0,843.0
0.001,17,2,180,1,66,0.0,38.0,38.0,1,114,0.0,86.0,86.0
0.005,6,10,1774,5,923,1.0,655.0,655.0,5,851,1.0,583.0,583.0
0.016,6,10,1972,5,910,3.0,642.0,642.0,5,1062,4.0,794.0,794.0
0.006,6,10,1989,5,927,1.0,659.0,659.0,5,1062,1.0,794.0,794.0
21.196,17,24,14848,13,12031,1764.0,1350.0,897.0,11,2817,2116.0,1350.0,228.0
0.152,6,10,1506,5,395,34.0,127.0,127.0,5,1111,33.0,843.0,843.0
10.823,17,28,4422,14,1995,824.0,270.0,114.0,14,2427,824.0,586.0,145.0
0.018,6,10,1989,5,910,4.0,642.0,642.0,5,1079,4.0,811.0,811.0
0.004,6,10,1989,5,927,1.0,659.0,659.0,5,1062,1.0,794.0,794.0
0.004,17,2,136,1,60,0.0,32.0,32.0,1,76,0.0,48.0,48.0
0.006,6,10,1689,5,839,1.0,571.0,571.0,5,850,1.0,582.0,582.0
0.005,6,13,3690,7,452,0.0,80.0,80.0,6,3238,0.0,1470.0,1459.0
0.003,17,2,148,1,60,0.0,32.0,32.0,1,88,0.0,60.0,60.0
10.937,17,28,4423,14,1994,833.0,269.0,114.0,14,2429,833.0,588.0,145.0
0.033,6,10,1990,5,911,8.0,643.0,643.0,5,1079,8.0,811.0,811.0
361.808,6,21,1793,16,1030,24120.0,190.0,190.0,5,763,60010.0,462.0,247.0
0.015,6,10,1983,5,910,3.0,642.0,642.0,5,1073,3.0,805.0,805.0
0.001,17,2,136,1,60,0.0,32.0,32.0,1,76,0.0,48.0,48.0
0.358,17,50,25160,25,21232,14.0,1350.0,821.0,25,3928,12.0,1350.0,129.0
0.111,6,10,1506,5,395,18.0,127.0,127.0,5,1111,21.0,843.0,843.0
0.014,6,10,1990,5,911,3.0,643.0,643.0,5,1079,3.0,811.0,811.0
0.006,6,10,1774,5,923,1.0,655.0,655.0,5,851,1.0,583.0,583.0
0.007,6,10,1989,5,910,1.0,642.0,642.0,5,1079,1.0,811.0,811.0
0.06,17,2,80,1,32,0.0,4.0,4.0,1,48,0.0,20.0,20.0
0.044,17,2,152,1,76,0.0,48.0,48.0,1,76,0.0,48.0,48.0
0.005,6,10,1774,5,923,1.0,655.0,655.0,5,851,1.0,583.0,583.0
0.005,6,10,2000,5,927,1.0,659.0,659.0,5,1073,1.0,805.0,805.0
0.006,17,2,164,1,74,0.0,46.0,46.0,1,90,0.0,62.0,62.0
0.006,6,10,1547,5,764,1.0,496.0,496.0,5,783,1.0,515.0,515.0
308.598,17,20,1124,10,716,34273.0,48.0,43.0,10,408,34273.0,20.0,12.0
0.001,17,2,166,1,75,0.0,47.0,47.0,1,91,0.0,63.0,63.0
0.011,6,14,3799,7,509,1.0,137.0,137.0,7,3290,1.0,1448.0,972.0
0.004,6,10,2006,5,927,1.0,659.0,659.0,5,1079,1.0,811.0,811.0
40.088,17,10,676,5,460,10021.0,104.0,64.0,5,216,10021.0,20.0,15.0
0.093,6,10,1506,5,395,20.0,127.0,127.0,5,1111,22.0,843.0,843.0
0.01,6,10,1989,5,910,2.0,642.0,642.0,5,1079,2.0,811.0,811.0
0.09,6,10,1506,5,395,20.0,127.0,127.0,5,1111,18.0,843.0,843.0
10.986,17,28,4398,14,2313,836.0,588.0,137.0,14,2085,836.0,268.0,120.0
0.017,17,2,180,1,66,0.0,38.0,38.0,1,114,0.0,86.0,86.0
0.008,6,10,1972,5,910,2.0,642.0,642.0,5,1062,2.0,794.0,794.0
1799.9,6,137,6590,76,3625,23995.0,39.0,39.0,61,2965,29993.0,35.0,35.0
0.005,6,10,2007,5,928,1.0,660.0,660.0,5,1079,1.0,811.0,811.0
0.139,17,2,144,1,64,0.0,36.0,36.0,1,80,0.0,52.0,52.0
0.022,6,10,1989,5,910,5.0,642.0,642.0,5,1079,5.0,811.0,811.0
0.001,17,2,136,1,60,0.0,32.0,32.0,1,76,0.0,48.0,48.0
0.01,6,13,3735,7,497,1.0,125.0,125.0,6,3238,1.0,1470.0,1459.0
0.016,6,10,1989,5,910,3.0,642.0,642.0,5,1079,4.0,811.0,811.0
0.01,6,10,1989,5,910,2.0,642.0,642.0,5,1079,2.0,811.0,811.0
0.084,6,10,1506,5,395,20.0,127.0,127.0,5,1111,18.0,843.0,843.0
0.011,6,10,1972,5,910,2.0,642.0,642.0,5,1062,2.0,794.0,794.0
0.008,6,10,1972,5,910,2.0,642.0,642.0,5,1062,2.0,794.0,794.0
0.005,6,10,2000,5,927,1.0,659.0,659.0,5,1073,1.0,805.0,805.0
0.004,6,10,2000,5,927,1.0,659.0,659.0,5,1073,1.0,805.0,805.0
0.011,6,10,1989,5,910,2.0,642.0,642.0,5,1079,2.0,811.0,811.0
0.004,6,10,2007,5,928,1.0,660.0,660.0,5,1079,1.0,811.0,811.0
0.004,6,10,2000,5,927,1.0,659.0,659.0,5,1073,1.0,805.0,805.0
0.013,6,10,1989,5,910,2.0,642.0,642.0,5,1079,3.0,811.0,811.0
0.005,6,10,2006,5,927,1.0,659.0,659.0,5,1079,1.0,811.0,811.0
0.072,17,4,284,2,120,1.0,32.0,32.0,2,164,68.0,60.0,54.0
0.005,6,13,3747,7,509,0.0,137.0,137.0,6,3238,0.0,1470.0,1459.0
0.005,6,10,1989,5,927,1.0,659.0,659.0,5,1062,1.0,794.0,794.0
0.121,6,10,1506,5,395,28.0,127.0,127.0,5,1111,26.0,843.0,843.0
0.005,6,10,2006,5,927,1.0,659.0,659.0,5,1079,1.0,811.0,811.0
0.11,6,10,1506,5,395,22.0,127.0,127.0,5,1111,22.0,843.0,843.0
0.006,6,10,1689,5,839,1.0,571.0,571.0,5,850,1.0,582.0,582.0
0.041,6,10,1990,5,911,10.0,643.0,643.0,5,1079,10.0,811.0,811.0
0.078,6,10,1506,5,395,18.0,127.0,127.0,5,1111,19.0,843.0,843.0
0.004,6,10,2006,5,927,1.0,659.0,659.0,5,1079,1.0,811.0,811.0
0.099,6,10,1506,5,395,20.0,127.0,127.0,5,1111,19.0,843.0,843.0
0.003,17,2,148,1,60,0.0,32.0,32.0,1,88,0.0,60.0,60.0
0.004,17,2,148,1,60,0.0,32.0,32.0,1,88,0.0,60.0,60.0
0.006,17,2,157,1,59,0.0,31.0,31.0,1,98,0.0,70.0,70.0
0.017,6,10,1989,5,910,4.0,642.0,642.0,5,1079,4.0,811.0,811.0
0.066,6,10,1506,5,395,14.0,127.0,127.0,5,1111,16.0,843.0,843.0
0.003,17,2,148,1,60,0.0,32.0,32.0,1,88,0.0,60.0,60.0
0.084,6,10,1506,5,395,20.0,127.0,127.0,5,1111,17.0,843.0,843.0
0.093,6,10,1506,5,395,23.0,127.0,127.0,5,1111,19.0,843.0,843.0
0.01,6,10,1989,5,910,2.0,642.0,642.0,5,1079,2.0,811.0,811.0
0.02,6,10,1989,5,910,5.0,642.0,642.0,5,1079,4.0,811.0,811.0
0.167,17,2,152,1,76,0.0,48.0,48.0,1,76,0.0,48.0,48.0
0.006,17,2,193,1,71,0.0,43.0,43.0,1,122,0.0,94.0,94.0
241.272,6,358,346634,179,20827,1355.0,2736.0,959.0,179,325807,1355.0,2804.0,1861.0
0.006,6,10,2006,5,927,1.0,659.0,659.0,5,1079,1.0,811.0,811.0
0.004,6,10,2006,5,927,1.0,659.0,659.0,5,1079,1.0,811.0,811.0
0.005,6,10,2007,5,928,1.0,660.0,660.0,5,1079,1.0,811.0,811.0
0.006,17,2,175,1,65,0.0,37.0,37.0,1,110,0.0,82.0,82.0
0.004,17,4,284,2,120,1.0,32.0,32.0,2,164,0.0,60.0,54.0
0.006,6,10,1547,5,764,1.0,496.0,496.0,5,783,1.0,515.0,515.0
0.005,6,10,2007,5,928,1.0,660.0,660.0,5,1079,1.0,811.0,811.0
0.005,6,10,2006,5,927,1.0,659.0,659.0,5,1079,1.0,811.0,811.0
0.133,17,2,186,1,61,0.0,33.0,33.0,1,125,0.0,97.0,97.0
0.012,6,10,1990,5,911,3.0,643.0,643.0,5,1079,3.0,811.0,811.0
0.005,6,13,3747,7,509,0.0,137.0,137.0,6,3238,0.0,1470.0,1459.0
0.014,6,10,1989,5,910,3.0,642.0,642.0,5,1079,3.0,811.0,811.0
326.911,17,20,1124,10,716,36309.0,48.0,43.0,10,408,36309.0,20.0,12.0
0.005,6,10,2006,5,927,1.0,659.0,659.0,5,1079,1.0,811.0,811.0
0.005,6,10,2007,5,928,1.0,660.0,660.0,5,1079,1.0,811.0,811.0
0.096,6,10,1506,5,395,19.0,127.0,127.0,5,1111,21.0,843.0,843.0
0.012,6,10,1990,5,911,3.0,643.0,643.0,5,1079,2.0,811.0,811.0
0.004,6,10,1702,5,863,1.0,595.0,595.0,5,839,0.0,571.0,571.0
0.005,6,10,1702,5,863,1.0,595.0,595.0,5,839,1.0,571.0,571.0
0.01,6,10,1972,5,910,2.0,642.0,642.0,5,1062,2.0,794.0,794.0
40.072,17,10,676,5,460,10015.0,104.0,64.0,5,216,10017.0,20.0,15.0
171.202,17,80,11264,40,2664,4389.0,44.0,38.0,40,8600,4389.0,261.0,187.0
0.124,17,4,284,2,120,0.0,32.0,32.0,2,164,121.0,60.0,54.0
0.008,6,13,3735,7,497,1.0,125.0,125.0,6,3238,1.0,1470.0,1459.0
0.013,6,13,3735,7,497,2.0,125.0,125.0,6,3238,2.0,1470.0,1459.0
0.003,17,2,136,1,60,0.0,32.0,32.0,1,76,0.0,48.0,48.0
0.007,17,2,170,1,65,0.0,37.0,37.0,1,105,0.0,77.0,77.0
0.121,6,10,1506,5,395,28.0,127.0,127.0,5,1111,28.0,843.0,843.0
0.004,6,10,1702,5,863,1.0,595.0,595.0,5,839,1.0,571.0,571.0
0.004,17,2,136,1,60,0.0,32.0,32.0,1,76,0.0,48.0,48.0
10.981,17,28,4398,14,2312,836.0,587.0,137.0,14,2086,836.0,269.0,121.0
0.007,17,2,179,1,71,0.0,43.0,43.0,1,108,0.0,80.0,80.0
0.005,6,10,1547,5,764,1.0,496.0,496.0,5,783,1.0,515.0,515.0
0.006,17,2,230,1,68,0.0,40.0,40.0,1,162,0.0,134.0,134.0
0.005,6,13,3747,7,509,0.0,137.0,137.0,6,3238,0.0,1470.0,1459.0
0.015,6,10,1989,5,910,3.0,642.0,642.0,5,1079,3.0,811.0,811.0
40.059,17,10,676,5,460,10013.0,104.0,64.0,5,216,10013.0,20.0,15.0
292.371,6,393,348250,190,21455,1546.0,2736.0,889.0,203,326795,1447.0,2804.0,1673.0
0.015,6,10,1989,5,910,3.0,642.0,642.0,5,1079,3.0,811.0,811.0
0.003,17,2,136,1,60,0.0,32.0,32.0,1,76,0.0,48.0,48.0
0.004,6,10,1702,5,863,1.0,595.0,595.0,5,839,1.0,571.0,571.0
40.066,17,10,676,5,460,10013.0,104.0,64.0,5,216,10014.0,20.0,15.0
0.068,6,10,1506,5,395,15.0,127.0,127.0,5,1111,15.0,843.0,843.0
21.043,6,33,6264,18,1338,1237.0,267.0,195.0,15,4926,611.0,1823.0,392.0
0.085,6,10,1506,5,395,18.0,127.0,127.0,5,1111,19.0,843.0,843.0
0.005,6,10,1989,5,927,1.0,659.0,659.0,5,1062,1.0,794.0,794.0
40.067,17,10,676,5,460,10016.0,104.0,64.0,5,216,10015.0,20.0,15.0
0.021,6,10,1762,5,911,5.0,643.0,643.0,5,851,5.0,583.0,583.0
0.005,17,2,214,1,75,0.0,47.0,47.0,1,139,0.0,111.0,111.0
0.01,17,2,194,1,59,0.0,31.0,31.0,1,135,0.0,107.0,107.0
0.017,17,2,213,1,69,0.0,41.0,41.0,1,144,0.0,116.0,116.0
0.006,6,10,2007,5,928,1.0,660.0,660.0,5,1079,1.0,811.0,811.0
0.001,17,2,136,1,60,0.0,32.0,32.0,1,76,0.0,48.0,48.0
0.011,6,10,1677,5,827,2.0,559.0,559.0,5,850,2.0,582.0,582.0
0.008,6,12,1926,6,1189,1.0,659.0,434.0,6,737,1.0,417.0,417.0
0.002,17,2,180,1,66,0.0,38.0,38.0,1,114,0.0,86.0,86.0
0.008,6,10,1677,5,827,2.0,559.0,559.0,5,850,2.0,582.0,582.0
0.004,17,2,186,1,61,0.0,33.0,33.0,1,125,0.0,97.0,97.0
0.088,6,10,1506,5,395,19.0,127.0,127.0,5,1111,20.0,843.0,843.0
40.058,17,10,676,5,460,10013.0,104.0,64.0,5,216,10013.0,20.0,15.0
0.01,6,10,1989,5,910,2.0,642.0,642.0,5,1079,2.0,811.0,811.0
0.059,17,2,152,1,76,0.0,48.0,48.0,1,76,0.0,48.0,48.0
0.008,6,10,1989,5,910,2.0,642.0,642.0,5,1079,1.0,811.0,811.0
0.112,6,10,1506,5,395,22.0,127.0,127.0,5,1111,26.0,843.0,843.0
0.098,6,10,1506,5,395,18.0,127.0,127.0,5,1111,22.0,843.0,843.0
167.13,17,88,12627,44,2957,3886.0,44.0,39.0,44,9670,3886.0,239.0,191.0
0.004,6,10,1774,5,923,1.0,655.0,655.0,5,851,1.0,583.0,583.0
0.006,17,2,164,1,74,0.0,46.0,46.0,1,90,0.0,62.0,62.0
0.005,6,10,2006,5,927,1.0,659.0,659.0,5,1079,1.0,811.0,811.0
0.019,6,10,1990,5,911,4.0,643.0,643.0,5,1079,4.0,811.0,811.0
0.005,6,10,1989,5,927,1.0,659.0,659.0,5,1062,1.0,794.0,794.0
0.155,6,10,1506,5,395,37.0,127.0,127.0,5,1111,37.0,843.0,843.0
0.005,6,13,3747,7,509,0.0,137.0,137.0,6,3238,1.0,1470.0,1459.0
0.087,6,10,1506,5,395,19.0,127.0,127.0,5,1111,18.0,843.0,843.0
0.006,17,2,166,1,75,0.0,47.0,47.0,1,91,0.0,63.0,63.0
0.014,6,10,1990,5,911,3.0,643.0,643.0,5,1079,3.0,811.0,811.0
0.006,17,2,214,1,75,0.0,47.0,47.0,1,139,0.0,111.0,111.0
0.004,17,4,284,2,120,0.0,32.0,32.0,2,164,0.0,60.0,54.0
0.013,6,10,1631,5,848,3.0,580.0,580.0,5,783,3.0,515.0,515.0
0.009,6,10,1989,5,910,2.0,642.0,642.0,5,1079,2.0,811.0,811.0
0.005,6,10,1989,5,927,1.0,659.0,659.0,5,1062,1.0,794.0,794.0
0.006,17,2,230,1,68,0.0,40.0,40.0,1,162,0.0,134.0,134.0
0.129,6,10,1506,5,395,29.0,127.0,127.0,5,1111,27.0,843.0,843.0
0.084,6,10,1506,5,395,18.0,127.0,127.0,5,1111,19.0,843.0,843.0
0.005,6,14,3736,7,446,0.0,74.0,74.0,7,3290,0.0,1448.0,972.0
40.063,17,10,676,5,460,10014.0,104.0,64.0,5,216,10014.0,20.0,15.0
0.005,17,2,148,1,60,0.0,32.0,32.0,1,88,0.0,60.0,60.0
0.005,6,10,1702,5,863,1.0,595.0,595.0,5,839,1.0,571.0,571.0
0.005,6,10,2000,5,927,1.0,659.0,659.0,5,1073,1.0,805.0,805.0
0.012,6,10,1989,5,910,2.0,642.0,642.0,5,1079,2.0,811.0,811.0
0.005,6,10,1547,5,764,1.0,496.0,496.0,5,783,1.0,515.0,515.0
0.005,6,10,2006,5,927,1.0,659.0,659.0,5,1079,1.0,811.0,811.0
0.004,6,10,2006,5,927,1.0,659.0,659.0,5,1079,1.0,811.0,811.0
240.008,6,9,787,5,488,60002.0,232.0,232.0,4,299,80001.0,83.0,83.0
0.005,17,2,230,1,68,0.0,40.0,40.0,1,162,0.0,134.0,134.0
0.006,6,10,1689,5,839,1.0,571.0,571.0,5,850,1.0,582.0,582.0
0.117,6,10,1506,5,395,26.0,127.0,127.0,5,1111,18.0,843.0,843.0
240.069,6,21,4925,11,941,24006.0,180.0,93.0,10,3984,26674.0,1592.0,576.0
0.005,6,10,2007,5,928,1.0,660.0,660.0,5,1079,1.0,811.0,811.0
0.017,6,10,1762,5,911,4.0,643.0,643.0,5,851,4.0,583.0,583.0
0.096,6,10,1506,5,395,22.0,127.0,127.0,5,1111,20.0,843.0,843.0
0.003,17,2,152,1,76,0.0,48.0,48.0,1,76,0.0,48.0,48.0
178.044,17,70,9981,35,2345,5236.0,44.0,39.0,35,7636,5236.0,239.0,190.0
0.003,17,2,185,1,73,0.0,45.0,45.0,1,112,0.0,84.0,84.0
0.005,6,10,1779,5,928,1.0,660.0,660.0,5,851,1.0,583.0,583.0
0.019,6,10,1983,5,910,4.0,642.0,642.0,5,1073,4.0,805.0,805.0
0.116,6,10,1506,5,395,27.0,127.0,127.0,5,1111,27.0,843.0,843.0
0.006,6,10,1547,5,764,1.0,496.0,496.0,5,783,1.0,515.0,515.0
0.156,6,10,1506,5,395,37.0,127.0,127.0,5,1111,33.0,843.0,843.0
521.038,6,46,17666,25,3788,21709.0,676.0,413.0,21,13878,23049.0,1411.0,912.0
0.039,17,4,596,2,122,0.0,33.0,33.0,2,474,2.0,323.0,209.0
0.112,6,10,1506,5,395,24.0,127.0,127.0,5,1111,23.0,843.0,843.0
240.09,6,16,4480,9,963,30011.0,238.0,166.0,7,3517,40014.0,1402.0,786.0
240.013,6,9,787,5,488,60003.0,232.0,232.0,4,299,80003.0,83.0,83.0
0.006,17,2,294,1,64,0.0,36.0,36.0,1,230,0.0,202.0,202.0
0.024,6,10,1989,5,910,6.0,642.0,642.0,5,1079,5.0,811.0,811.0
0.075,17,8,3613,4,1874,25.0,1350.0,440.0,4,1739,8.0,1350.0,406.0
0.006,6,10,2000,5,927,1.0,659.0,659.0,5,1073,1.0,805.0,805.0
0.008,6,10,1989,5,910,2.0,642.0,642.0,5,1079,2.0,811.0,811.0
0.014,6,10,1972,5,910,3.0,642.0,642.0,5,1062,3.0,794.0,794.0
353.291,6,20,2210,6,1308,12004.0,494.0,494.0,14,902,27176.0,83.0,83.0
40.063,17,10,676,5,460,10015.0,104.0,64.0,5,216,10014.0,20.0,15.0
0.005,6,14,3742,7,452,0.0,80.0,80.0,7,3290,0.0,1448.0,972.0
0.003,17,2,148,1,60,0.0,32.0,32.0,1,88,0.0,60.0,60.0
1.023,6,13,3921,7,2138,127.0,1328.0,923.0,6,1783,154.0,1539.0,1539.0
0.005,6,10,1643,5,860,1.0,592.0,592.0,5,783,1.0,515.0,515.0
0.004,17,2,140,1,62,0.0,34.0,34.0,1,78,0.0,50.0,50.0
0.005,6,10,2007,5,928,1.0,660.0,660.0,5,1079,1.0,811.0,811.0
0.087,6,10,1506,5,395,17.0,127.0,127.0,5,1111,20.0,843.0,843.0
0.005,6,10,1854,5,889,1.0,621.0,621.0,5,965,1.0,697.0,697.0
0.012,6,11,1683,6,900,2.0,580.0,580.0,5,783,2.0,515.0,515.0
11.218,17,28,4420,14,1993,850.0,268.0,114.0,14,2427,850.0,586.0,145.0
40.051,6,68,31479,37,3355,1112.0,628.0,177.0,31,28124,1334.0,2092.0,1060.0
0.832,17,2,144,1,64,0.0,36.0,36.0,1,80,0.0,52.0,52.0
0.009,6,12,1926,6,1189,1.0,659.0,434.0,6,737,1.0,417.0,417.0
0.01,6,10,1677,5,827,2.0,559.0,559.0,5,850,2.0,582.0,582.0
0.124,6,10,1506,5,395,28.0,127.0,127.0,5,1111,22.0,843.0,843.0
0.116,6,10,1506,5,395,26.0,127.0,127.0,5,1111,28.0,843.0,843.0
0.018,6,10,1983,5,910,4.0,642.0,642.0,5,1073,4.0,805.0,805.0
0.014,6,10,1631,5,848,3.0,580.0,580.0,5,783,3.0,515.0,515.0
0.068,17,8,3613,4,1874,22.0,1350.0,440.0,4,1739,12.0,1350.0,406.0
308.747,17,20,1124,10,716,34291.0,48.0,43.0,10,408,34291.0,20.0,12.0
0.004,17,2,136,1,60,0.0,32.0,32.0,1,76,0.0,48.0,48.0
15.073,17,15,9239,8,6902,2149.0,1350.0,834.0,7,2337,2507.0,1350.0,305.0
0.125,17,2,80,1,32,0.0,4.0,4.0,1,48,0.0,20.0,20.0
0.009,17,2,307,1,61,0.0,33.0,33.0,1,246,0.0,218.0,218.0
0.102,6,10,1506,5,395,23.0,127.0,127.0,5,1111,23.0,843.0,843.0
240.097,6,16,4482,9,963,30012.0,238.0,166.0,7,3519,40015.0,1402.0,786.0
0.005,6,10,2000,5,927,1.0,659.0,659.0,5,1073,1.0,805.0,805.0
0.018,6,10,1989,5,910,4.0,642.0,642.0,5,1079,4.0,811.0,811.0
40.052,17,10,676,5,460,10012.0,104.0,64.0,5,216,10012.0,20.0,15.0
0.012,6,10,1972,5,910,2.0,642.0,642.0,5,1062,3.0,794.0,794.0
0.004,17,2,185,1,73,0.0,45.0,45.0,1,112,0.0,84.0,84.0
300.453,6,16,2170,9,684,37535.0,146.0,146.0,7,1486,50047.0,419.0,398.0
0.001,17,2,180,1,66,0.0,38.0,38.0,1,114,0.0,86.0,86.0
0.004,17,4,420,2,122,0.0,33.0,33.0,2,298,0.0,145.0,121.0
0.006,6,10,1547,5,764,1.0,496.0,496.0,5,783,1.0,515.0,515.0
0.174,17,2,152,1,76,0.0,48.0,48.0,1,76,0.0,48.0,48.0
0.006,17,4,284,2,120,0.0,32.0,32.0,2,164,0.0,60.0,54.0
0.005,6,10,1989,5,927,1.0,659.0,659.0,5,1062,1.0,794.0,794.0
0.003,17,2,136,1,60,0.0,32.0,32.0,1,76,0.0,48.0,48.0
0.009,6,10,1631,5,848,2.0,580.0,580.0,5,783,2.0,515.0,515.0
0.005,6,10,1989,5,927,1.0,659.0,659.0,5,1062,1.0,794.0,794.0
240.089,6,31,9433,15,6865,17149.0,1987.0,676.0,16,2568,16005.0,580.0,216.0
0.17,17,2,152,1,76,0.0,48.0,48.0,1,76,0.0,48.0,48.0
0.007,6,10,1989,5,910,1.0,642.0,642.0,5,1079,1.0,811.0,811.0
0.019,6,10,1990,5,911,4.0,643.0,643.0,5,1079,4.0,811.0,811.0
433.738,6,28,7743,15,3116,30981.0,676.0,388.0,13,4627,31142.0,1402.0,657.0
0.079,6,10,1506,5,395,19.0,127.0,127.0,5,1111,17.0,843.0,843.0
40.072,17,10,676,5,460,10015.0,104.0,64.0,5,216,10017.0,20.0,15.0
0.007,6,10,1983,5,910,1.0,642.0,642.0,5,1073,1.0,805.0,805.0
354.063,6,19,1691,15,978,25290.0,190.0,190.0,4,713,80008.0,497.0,497.0
11.132,17,28,4418,14,1994,843.0,269.0,114.0,14,2424,843.0,587.0,145.0
0.005,6,10,2006,5,927,1.0,659.0,659.0,5,1079,1.0,811.0,811.0
0.013,6,10,1631,5,848,3.0,580.0,580.0,5,783,3.0,515.0,515.0
0.022,6,10,1989,5,910,5.0,642.0,642.0,5,1079,5.0,811.0,811.0
0.005,17,2,169,1,62,0.0,34.0,34.0,1,107,0.0,79.0,79.0
0.004,6,14,3742,7,452,0.0,80.0,80.0,7,3290,0.0,1448.0,972.0
0.015,6,10,1989,5,910,3.0,642.0,642.0,5,1079,3.0,811.0,811.0
0.013,6,10,1990,5,911,3.0,643.0,643.0,5,1079,3.0,811.0,811.0
0.147,17,4,352,2,130,106.0,37.0,37.0,2,222,144.0,89.0,83.0
0.007,17,2,162,1,65,0.0,37.0,37.0,1,97,0.0,69.0,69.0
0.005,6,10,1989,5,927,1.0,659.0,659.0,5,1062,1.0,794.0,794.0
0.009,6,10,2007,5,928,2.0,660.0,660.0,5,1079,2.0,811.0,811.0
0.023,6,10,1990,5,911,5.0,643.0,643.0,5,1079,5.0,811.0,811.0
0.043,17,2,180,1,58,0.0,30.0,30.0,1,122,0.0,94.0,94.0
0.019,6,10,1983,5,910,4.0,642.0,642.0,5,1073,4.0,805.0,805.0
0.114,6,10,1506,5,395,25.0,127.0,127.0,5,1111,27.0,843.0,843.0
0.037,17,2,184,1,61,0.0,33.0,33.0,1,123,0.0,95.0,95.0
0.094,6,10,1506,5,395,22.0,127.0,127.0,5,1111,20.0,843.0,843.0
0.005,6,10,2007,5,928,1.0,660.0,660.0,5,1079,1.0,811.0,811.0
0.082,6,10,1506,5,395,20.0,127.0,127.0,5,1111,14.0,843.0,843.0
0.007,6,12,1698,6,863,1.0,327.0,271.0,6,835,1.0,515.0,515.0
1778.4,17,143,45188,72,22752,25046.0,288.0,288.0,71,22436,25404.0,288.0,288.0
240.239,6,46,6814,22,3221,11439.0,588.0,229.0,24,3593,10442.0,580.0,212.0
0.001,17,2,180,1,66,0.0,38.0,38.0,1,114,0.0,86.0,86.0
0.024,6,10,1989,5,910,6.0,642.0,642.0,5,1079,5.0,811.0,811.0
0.012,6,10,1972,5,910,2.0,642.0,642.0,5,1062,3.0,794.0,794.0
40.054,17,10,676,5,460,10012.0,104.0,64.0,5,216,10012.0,20.0,15.0
0.004,6,10,2007,5,928,1.0,660.0,660.0,5,1079,1.0,811.0,811.0
0.068,17,8,3613,4,1874,22.0,1350.0,440.0,4,1739,11.0,1350.0,406.0
0.006,6,10,1547,5,764,1.0,496.0,496.0,5,783,1.0,515.0,515.0
0.007,17,2,213,1,69,0.0,41.0,41.0,1,144,0.0,116.0,116.0
0.004,6,10,2006,5,927,1.0,659.0,659.0,5,1079,1.0,811.0,811.0
0.01,6,10,1990,5,911,2.0,643.0,643.0,5,1079,2.0,811.0,811.0
0.083,6,10,1506,5,395,17.0,127.0,127.0,5,1111,19.0,843.0,843.0
0.008,17,2,169,1,62,0.0,34.0,34.0,1,107,0.0,79.0,79.0
0.004,17,2,136,1,60,0.0,32.0,32.0,1,76,0.0,48.0,48.0
0.009,6,10,1989,5,910,2.0,642.0,642.0,5,1079,2.0,811.0,811.0
0.02,6,10,1990,5,911,5.0,643.0,643.0,5,1079,5.0,811.0,811.0
0.005,17,2,144,1,64,0.0,36.0,36.0,1,80,0.0,52.0,52.0
1778.418,17,144,45504,72,22752,25048.0,288.0,288.0,72,22752,25048.0,288.0,288.0
40.053,17,10,676,5,460,10012.0,104.0,64.0,5,216,10012.0,20.0,15.0
300.312,6,16,2170,9,684,37518.0,146.0,146.0,7,1486,50025.0,419.0,398.0
0.006,6,10,2006,5,927,1.0,659.0,659.0,5,1079,1.0,811.0,811.0
0.005,17,2,136,1,60,0.0,32.0,32.0,1,76,0.0,48.0,48.0
0.017,6,10,1983,5,910,4.0,642.0,642.0,5,1073,4.0,805.0,805.0
0.04,17,4,284,2,120,0.0,32.0,32.0,2,164,33.0,60.0,54.0
0.093,6,10,1506,5,395,21.0,127.0,127.0,5,1111,20.0,843.0,843.0
0.006,17,2,170,1,65,0.0,37.0,37.0,1,105,0.0,77.0,77.0
0.112,6,10,1506,5,395,21.0,127.0,127.0,5,1111,23.0,843.0,843.0
0.022,6,10,1972,5,910,5.0,642.0,642.0,5,1062,5.0,794.0,794.0
0.005,6,10,2006,5,927,1.0,659.0,659.0,5,1079,1.0,811.0,811.0
0.008,6,10,1989,5,910,2.0,642.0,642.0,5,1079,2.0,811.0,811.0
0.222,6,16,2783,8,1401,31.0,533.0,325.0,8,1382,20.0,529.0,239.0
0.119,6,10,1506,5,395,24.0,127.0,127.0,5,1111,25.0,843.0,843.0
0.092,6,10,1506,5,395,20.0,127.0,127.0,5,1111,20.0,843.0,843.0
0.001,17,2,180,1,66,0.0,38.0,38.0,1,114,0.0,86.0,86.0
0.012,6,10,1989,5,910,3.0,642.0,642.0,5,1079,3.0,811.0,811.0
0.004,17,2,148,1,60,0.0,32.0,32.0,1,88,0.0,60.0,60.0
0.006,6,10,1643,5,860,1.0,592.0,592.0,5,783,1.0,515.0,515.0
0.09,6,10,1506,5,395,19.0,127.0,127.0,5,1111,19.0,843.0,843.0
0.01,6,10,1762,5,911,2.0,643.0,643.0,5,851,2.0,583.0,583.0
0.072,17,2,136,1,60,0.0,32.0,32.0,1,76,0.0,48.0,48.0
0.004,6,10,2007,5,928,1.0,660.0,660.0,5,1079,1.0,811.0,811.0
0.008,6,10,1989,5,910,2.0,642.0,642.0,5,1079,1.0,811.0,811.0
0.044,6,10,1989,5,910,10.0,642.0,642.0,5,1079,11.0,811.0,811.0
0.019,6,10,1605,5,388,4.0,120.0,120.0,5,1217,4.0,949.0,949.0
0.001,17,2,180,1,66,0.0,38.0,38.0,1,114,0.0,86.0,86.0
0.005,6,10,2007,5,928,1.0,660.0,660.0,5,1079,1.0,811.0,811.0
0.02,6,10,1989,5,910,4.0,642.0,642.0,5,1079,4.0,811.0,811.0
0.004,6,10,2006,5,927,1.0,659.0,659.0,5,1079,1.0,811.0,811.0
0.006,6,10,1689,5,839,1.0,571.0,571.0,5,850,1.0,582.0,582.0
0.072,17,2,148,1,60,0.0,32.0,32.0,1,88,0.0,60.0,60.0
0.006,6,10,2006,5,927,1.0,659.0,659.0,5,1079,1.0,811.0,811.0
0.088,6,10,1506,5,395,19.0,127.0,127.0,5,1111,18.0,843.0,843.0
0.097,6,10,1506,5,395,21.0,127.0,127.0,5,1111,20.0,843.0,843.0
0.013,6,10,1989,5,910,3.0,642.0,642.0,5,1079,3.0,811.0,811.0
0.006,17,2,179,1,71,0.0,43.0,43.0,1,108,0.0,80.0,80.0
0.018,6,10,1762,5,911,4.0,643.0,643.0,5,851,4.0,583.0,583.0
0.012,6,10,1983,5,910,2.0,642.0,642.0,5,1073,2.0,805.0,805.0
0.006,6,10,2000,5,927,1.0,659.0,659.0,5,1073,1.0,805.0,805.0
10.825,17,28,4423,14,1995,824.0,270.0,114.0,14,2428,824.0,587.0,145.0
0.006,6,10,2006,5,927,1.0,659.0,659.0,5,1079,1.0,811.0,811.0
0.005,17,2,168,1,76,0.0,48.0,48.0,1,92,0.0,64.0,64.0
0.145,6,10,1506,5,395,33.0,127.0,127.0,5,1111,32.0,843.0,843.0
0.005,6,10,1989,5,927,1.0,659.0,659.0,5,1062,1.0,794.0,794.0
0.006,6,10,1547,5,764,1.0,496.0,496.0,5,783,1.0,515.0,515.0
0.012,6,10,1972,5,910,2.0,642.0,642.0,5,1062,2.0,794.0,794.0
0.067,17,8,3613,4,1874,22.0,1350.0,440.0,4,1739,11.0,1350.0,406.0
0.011,6,10,1983,5,910,2.0,642.0,642.0,5,1073,2.0,805.0,805.0
0.004,17,2,148,1,60,0.0,32.0,32.0,1,88,0.0,60.0,60.0
0.013,6,10,1989,5,910,3.0,642.0,642.0,5,1079,3.0,811.0,811.0
33.14,58,5,360,4,288,11046.0,24.0,24.0,1,72,0.0,24.0,24.0
0.008,17,2,194,1,59,0.0,31.0,31.0,1,135,0.0,107.0,107.0
0.002,17,2,180,1,66,0.0,38.0,38.0,1,114,0.0,86.0,86.0
0.01,17,2,169,1,62,0.0,34.0,34.0,1,107,0.0,79.0,79.0
0.004,17,2,148,1,60,0.0,32.0,32.0,1,88,0.0,60.0,60.0
1771.666,17,120,11460,60,5460,30027.0,63.0,63.0,60,6000,30027.0,72.0,72.0
0.014,6,10,1990,5,911,3.0,643.0,643.0,5,1079,3.0,811.0,811.0
0.005,6,10,1989,5,927,1.0,659.0,659.0,5,1062,1.0,794.0,794.0
0.005,17,2,213,1,69,0.0,41.0,41.0,1,144,0.0,116.0,116.0
40.058,17,10,676,5,460,10012.0,104.0,64.0,5,216,10013.0,20.0,15.0
0.003,17,4,284,2,120,0.0,32.0,32.0,2,164,0.0,60.0,54.0
0.004,6,10,2007,5,928,1.0,660.0,660.0,5,1079,1.0,811.0,811.0
0.01,6,10,1983,5,910,2.0,642.0,642.0,5,1073,2.0,805.0,805.0
0.008,6,10,1989,5,910,2.0,642.0,642.0,5,1079,2.0,811.0,811.0
0.155,6,12,2996,7,549,25.0,177.0,177.0,5,2447,37.0,1402.0,1089.0
0.004,17,2,148,1,60,0.0,32.0,32.0,1,88,0.0,60.0,60.0
0.198,6,10,1506,5,395,47.0,127.0,127.0,5,1111,38.0,843.0,843.0
0.068,17,8,3613,4,1874,22.0,1350.0,440.0,4,1739,11.0,1350.0,406.0
0.107,6,10,1506,5,395,25.0,127.0,127.0,5,1111,19.0,843.0,843.0
0.06,17,2,80,1,32,0.0,4.0,4.0,1,48,0.0,20.0,20.0
0.014,6,10,1990,5,911,3.0,643.0,643.0,5,1079,3.0,811.0,811.0
0.069,6,10,1506,5,395,16.0,127.0,127.0,5,1111,15.0,843.0,843.0
0.066,6,10,1983,5,910,16.0,642.0,642.0,5,1073,16.0,805.0,805.0
0.081,6,10,1506,5,395,18.0,127.0,127.0,5,1111,18.0,843.0,843.0
0.008,6,10,1643,5,860,2.0,592.0,592.0,5,783,2.0,515.0,515.0
0.017,6,10,1990,5,911,4.0,643.0,643.0,5,1079,4.0,811.0,811.0
0.012,6,10,1989,5,910,3.0,642.0,642.0,5,1079,2.0,811.0,811.0
0.011,6,10,1972,5,910,2.0,642.0,642.0,5,1062,2.0,794.0,794.0
0.012,6,10,1990,5,911,3.0,643.0,643.0,5,1079,2.0,811.0,811.0
0.008,17,2,179,1,71,0.0,43.0,43.0,1,108,0.0,80.0,80.0
0.008,6,10,1990,5,911,2.0,643.0,643.0,5,1079,2.0,811.0,811.0
40.067,17,10,676,5,460,10013.0,104.0,64.0,5,216,10016.0,20.0,15.0
0.012,6,10,1631,5,848,2.0,580.0,580.0,5,783,3.0,515.0,515.0
0.013,6,10,1972,5,910,3.0,642.0,642.0,5,1062,3.0,794.0,794.0
0.005,6,13,3747,7,509,0.0,137.0,137.0,6,3238,1.0,1470.0,1459.0
0.028,6,13,4121,7,671,4.0,295.0,295.0,6,3450,4.0,1402.0,1043.0
0.022,6,10,1972,5,910,5.0,642.0,642.0,5,1062,5.0,794.0,794.0
0.005,6,10,1774,5,923,1.0,655.0,655.0,5,851,1.0,583.0,583.0
0.009,6,10,1989,5,927,2.0,659.0,659.0,5,1062,2.0,794.0,794.0
0.004,17,2,148,1,60,0.0,32.0,32.0,1,88,0.0,60.0,60.0
0.005,6,10,1989,5,927,1.0,659.0,659.0,5,1062,1.0,794.0,794.0
0.005,6,10,2000,5,927,1.0,659.0,659.0,5,1073,1.0,805.0,805.0
15.073,17,14,9190,8,6902,2149.0,1350.0,834.0,6,2288,3008.0,1350.0,353.0
0.075,6,10,1506,5,395,16.0,127.0,127.0,5,1111,18.0,843.0,843.0
0.027,17,2,148,1,60,0.0,32.0,32.0,1,88,0.0,60.0,60.0
0.014,6,10,1972,5,910,3.0,642.0,642.0,5,1062,3.0,794.0,794.0
0.005,6,10,2006,5,927,1.0,659.0,659.0,5,1079,1.0,811.0,811.0
0.175,17,4,596,2,122,43.0,33.0,33.0,2,474,134.0,323.0,209.0
0.004,17,2,148,1,60,0.0,32.0,32.0,1,88,0.0,60.0,60.0
0.276,17,2,152,1,76,0.0,48.0,48.0,1,76,0.0,48.0,48.0
0.011,6,10,1972,5,910,2.0,642.0,642.0,5,1062,2.0,794.0,794.0
0.004,17,2,136,1,60,0.0,32.0,32.0,1,76,0.0,48.0,48.0
15.073,17,15,9238,8,6902,2149.0,1350.0,834.0,7,2336,2507.0,1350.0,305.0
0.004,17,2,136,1,60,0.0,32.0,32.0,1,76,0.0,48.0,48.0
0.016,6,10,1631,5,848,4.0,580.0,580.0,5,783,3.0,515.0,515.0
0.005,6,10,2007,5,928,1.0,660.0,660.0,5,1079,1.0,811.0,811.0
240.326,6,43,8771,22,5738,11443.0,2883.0,573.0,21,3033,12016.0,580.0,241.0
368.62,6,22,2313,16,867,24574.0,195.0,195.0,6,1446,4637.0,419.0,398.0
0.169,17,2,152,1,76,0.0,48.0,48.0,1,76,0.0,48.0,48.0
0.04,17,2,136,1,60,0.0,32.0,32.0,1,76,0.0,48.0,48.0
0.091,6,10,1506,5,395,19.0,127.0,127.0,5,1111,20.0,843.0,843.0
0.006,6,10,1547,5,764,1.0,496.0,496.0,5,783,1.0,515.0,515.0
0.011,6,10,1983,5,910,2.0,642.0,642.0,5,1073,2.0,805.0,805.0
0.096,6,10,1506,5,395,20.0,127.0,127.0,5,1111,20.0,843.0,843.0
0.076,6,10,1506,5,395,16.0,127.0,127.0,5,1111,18.0,843.0,843.0
15.073,17,14,9191,8,6902,2149.0,1350.0,834.0,6,2289,3008.0,1350.0,353.0
0.085,6,10,1506,5,395,17.0,127.0,127.0,5,1111,18.0,843.0,843.0
0.002,17,2,180,1,66,0.0,38.0,38.0,1,114,0.0,86.0,86.0
40.076,17,10,676,5,460,10016.0,104.0,64.0,5,216,10018.0,20.0,15.0
0.004,6,10,1702,5,863,0.0,595.0,595.0,5,839,1.0,571.0,571.0
126.056,6,14,2938,8,2504,17974.0,1414.0,1086.0,6,434,25164.0,182.0,182.0
40.091,17,10,676,5,460,10022.0,104.0,64.0,5,216,10021.0,20.0,15.0
0.012,6,10,1983,5,910,3.0,642.0,642.0,5,1073,2.0,805.0,805.0
0.084,6,10,1506,5,395,18.0,127.0,127.0,5,1111,16.0,843.0,843.0
0.74,6,22,5072,11,1250,63.0,325.0,133.0,11,3822,63.0,1414.0,563.0
0.006,17,2,168,1,76,0.0,48.0,48.0,1,92,0.0,64.0,64.0
10.823,17,28,4421,14,1993,823.0,268.0,114.0,14,2428,823.0,587.0,145.0
0.038,6,13,3735,7,497,6.0,125.0,125.0,6,3238,7.0,1470.0,1459.0
11.046,17,28,4399,14,2313,840.0,588.0,137.0,14,2086,841.0,269.0,121.0
0.003,17,2,148,1,60,0.0,32.0,32.0,1,88,0.0,60.0,60.0
0.005,6,13,3690,7,452,0.0,80.0,80.0,6,3238,1.0,1470.0,1459.0
0.022,6,10,1990,5,911,5.0,643.0,643.0,5,1079,5.0,811.0,811.0
0.007,17,2,179,1,71,0.0,43.0,43.0,1,108,0.0,80.0,80.0
0.005,6,10,2006,5,927,1.0,659.0,659.0,5,1079,1.0,811.0,811.0
40.06,17,10,676,5,460,10014.0,104.0,64.0,5,216,10014.0,20.0,15.0
0.1,6,10,1506,5,395,21.0,127.0,127.0,5,1111,22.0,843.0,843.0
0.006,17,2,148,1,60,0.0,32.0,32.0,1,88,0.0,60.0,60.0
0.217,6,16,2777,8,1395,31.0,533.0,323.0,8,1382,19.0,529.0,239.0
0.008,6,10,1677,5,827,2.0,559.0,559.0,5,850,1.0,582.0,582.0
0.01,6,12,1926,6,1189,2.0,659.0,434.0,6,737,1.0,417.0,417.0
0.115,6,10,1506,5,395,23.0,127.0,127.0,5,1111,27.0,843.0,843.0
240.255,6,39,5163,19,2378,13347.0,581.0,195.0,20,2785,12644.0,566.0,248.0
0.001,17,2,180,1,66,0.0,38.0,38.0,1,114,0.0,86.0,86.0
0.001,17,2,180,1,66,0.0,38.0,38.0,1,114,0.0,86.0,86.0
0.001,17,2,174,1,72,0.0,44.0,44.0,1,102,0.0,74.0,74.0
0.071,17,8,3613,4,1874,23.0,1350.0,440.0,4,1739,12.0,1350.0,406.0
281.259,6,25,6155,11,1226,28125.0,267.0,156.0,14,4929,21634.0,1400.0,873.0
0.009,6,10,1972,5,910,2.0,642.0,642.0,5,1062,2.0,794.0,794.0
0.064,17,2,152,1,76,0.0,48.0,48.0,1,76,0.0,48.0,48.0
0.111,6,10,1506,5,395,24.0,127.0,127.0,5,1111,26.0,843.0,843.0
0.093,6,10,1506,5,395,19.0,127.0,127.0,5,1111,22.0,843.0,843.0
0.01,6,10,1972,5,910,2.0,642.0,642.0,5,1062,2.0,794.0,794.0
0.005,6,10,2000,5,927,1.0,659.0,659.0,5,1073,1.0,805.0,805.0
353.232,6,20,2210,6,1308,12003.0,494.0,494.0,14,902,27171.0,83.0,83.0
0.005,6,10,2007,5,928,1.0,660.0,660.0,5,1079,1.0,811.0,811.0
0.014,6,10,1989,5,910,3.0,642.0,642.0,5,1079,3.0,811.0,811.0
0.085,6,10,1506,5,395,19.0,127.0,127.0,5,1111,19.0,843.0,843.0
0.005,6,10,1989,5,927,1.0,659.0,659.0,5,1062,1.0,794.0,794.0
0.004,17,4,284,2,120,0.0,32.0,32.0,2,164,0.0,60.0,54.0
240.024,6,9,787,5,488,60006.0,232.0,232.0,4,299,80006.0,83.0,83.0
0.037,6,10,1983,5,910,9.0,642.0,642.0,5,1073,9.0,805.0,805.0
0.005,6,10,1689,5,839,1.0,571.0,571.0,5,850,1.0,582.0,582.0
0.014,6,10,1989,5,910,3.0,642.0,642.0,5,1079,3.0,811.0,811.0
0.007,6,10,2007,5,928,1.0,660.0,660.0,5,1079,1.0,811.0,811.0
0.006,6,10,1547,5,764,1.0,496.0,496.0,5,783,1.0,515.0,515.0
40.068,17,10,676,5,460,10013.0,104.0,64.0,5,216,10016.0,20.0,15.0
0.01,6,10,1989,5,910,2.0,642.0,642.0,5,1079,2.0,811.0,811.0
0.017,6,10,1762,5,911,4.0,643.0,643.0,5,851,4.0,583.0,583.0
40.066,17,10,676,5,460,10013.0,104.0,64.0,5,216,10015.0,20.0,15.0
0.018,6,10,1989,5,910,4.0,642.0,642.0,5,1079,4.0,811.0,811.0
0.12,6,10,1506,5,395,23.0,127.0,127.0,5,1111,26.0,843.0,843.0
0.006,6,10,1689,5,839,1.0,571.0,571.0,5,850,1.0,582.0,582.0
0.001,17,2,180,1,66,0.0,38.0,38.0,1,114,0.0,86.0,86.0
0.017,6,10,1983,5,910,4.0,642.0,642.0,5,1073,4.0,805.0,805.0
0.084,6,10,1506,5,395,19.0,127.0,127.0,5,1111,17.0,843.0,843.0
0.009,6,10,1972,5,910,2.0,642.0,642.0,5,1062,2.0,794.0,794.0
0.013,6,10,1989,5,910,3.0,642.0,642.0,5,1079,3.0,811.0,811.0
0.101,6,10,1506,5,395,24.0,127.0,127.0,5,1111,25.0,843.0,843.0
15.074,17,15,9238,8,6902,2148.0,1350.0,834.0,7,2336,2507.0,1350.0,305.0
0.005,6,10,2006,5,927,1.0,659.0,659.0,5,1079,1.0,811.0,811.0
0.005,6,14,3736,7,446,0.0,74.0,74.0,7,3290,0.0,1448.0,972.0
300.153,6,47,18782,25,13059,12498.0,4080.0,1501.0,22,5723,14284.0,2667.0,402.0
0.001,17,2,140,1,62,0.0,34.0,34.0,1,78,0.0,50.0,50.0
0.038,17,2,412,1,61,0.0,33.0,33.0,1,351,0.0,323.0,323.0
0.122,17,2,80,1,32,0.0,4.0,4.0,1,48,0.0,20.0,20.0
0.007,6,10,1547,5,764,1.0,496.0,496.0,5,783,1.0,515.0,515.0
0.016,6,10,1631,5,848,3.0,580.0,580.0,5,783,4.0,515.0,515.0
0.071,6,10,1506,5,395,16.0,127.0,127.0,5,1111,14.0,843.0,843.0
0.004,6,10,1774,5,923,1.0,655.0,655.0,5,851,1.0,583.0,583.0
0.007,6,10,1989,5,910,1.0,642.0,642.0,5,1079,1.0,811.0,811.0
1796.711,6,317,51271,134,30977,13508.0,2720.0,253.0,183,20294,9871.0,1360.0,148.0
40.049,17,10,676,5,460,10011.0,104.0,64.0,5,216,10011.0,20.0,15.0
1799.982,6,138,6704,77,3704,23683.0,39.0,39.0,61,3000,29995.0,35.0,35.0
0.012,6,10,1983,5,910,3.0,642.0,642.0,5,1073,2.0,805.0,805.0
0.001,17,2,166,1,75,0.0,47.0,47.0,1,91,0.0,63.0,63.0
0.006,17,2,157,1,59,0.0,31.0,31.0,1,98,0.0,70.0,70.0
0.001,17,2,179,1,62,0.0,34.0,34.0,1,117,0.0,89.0,89.0
10.917,17,28,4421,14,1994,831.0,269.0,114.0,14,2427,831.0,586.0,145.0
160.03,17,82,12120,41,2750,4000.0,44.0,39.0,41,9370,4000.0,279.0,200.0
0.004,6,10,1702,5,863,0.0,595.0,595.0,5,839,1.0,571.0,571.0
0.014,6,10,1989,5,910,3.0,642.0,642.0,5,1079,3.0,811.0,811.0
0.017,6,10,1762,5,911,4.0,643.0,643.0,5,851,4.0,583.0,583.0
0.222,6,16,2669,8,1395,31.0,533.0,323.0,8,1274,19.0,529.0,212.0
240.105,6,16,4481,9,963,30013.0,238.0,166.0,7,3518,40017.0,1402.0,786.0
0.081,6,10,1506,5,395,18.0,127.0,127.0,5,1111,17.0,843.0,843.0
1770.583,6,85,4496,42,2211,43184.0,27.0,27.0,43,2285,42155.0,26.0,24.0
0.016,6,10,1677,5,827,4.0,559.0,559.0,5,850,4.0,582.0,582.0
0.006,17,2,164,1,74,0.0,46.0,46.0,1,90,0.0,62.0,62.0
0.087,6,10,1506,5,395,20.0,127.0,127.0,5,1111,20.0,843.0,843.0
0.005,6,10,2006,5,927,1.0,659.0,659.0,5,1079,1.0,811.0,811.0
0.081,6,10,1506,5,395,18.0,127.0,127.0,5,1111,19.0,843.0,843.0
40.056,17,10,676,5,460,10013.0,104.0,64.0,5,216,10013.0,20.0,15.0
172.435,17,80,11638,40,2689,4421.0,44.0,39.0,40,8949,4421.0,239.0,195.0
0.005,17,2,164,1,74,0.0,46.0,46.0,1,90,0.0,62.0,62.0
241.337,6,387,348221,191,21464,1270.0,2736.0,960.0,196,326757,1237.0,2830.0,1701.0
0.005,6,10,1989,5,927,1.0,659.0,659.0,5,1062,1.0,794.0,794.0
0.053,17,2,152,1,76,0.0,48.0,48.0,1,76,0.0,48.0,48.0
40.047,17,10,676,5,460,10011.0,104.0,64.0,5,216,10011.0,20.0,15.0
0.082,6,10,1506,5,395,18.0,127.0,127.0,5,1111,19.0,843.0,843.0
0.011,6,10,1972,5,910,2.0,642.0,642.0,5,1062,2.0,794.0,794.0
0.063,6,10,1506,5,395,15.0,127.0,127.0,5,1111,13.0,843.0,843.0
0.824,6,10,2009,6,1655,164.0,1403.0,1403.0,4,354,196.0,182.0,182.0
0.164,6,10,1506,5,395,36.0,127.0,127.0,5,1111,36.0,843.0,843.0
0.082,6,10,1506,5,395,19.0,127.0,127.0,5,1111,17.0,843.0,843.0
0.01,6,10,1774,5,923,2.0,655.0,655.0,5,851,2.0,583.0,583.0
0.004,17,2,132,1,58,0.0,30.0,30.0,1,74,0.0,46.0,46.0
0.012,6,10,1677,5,827,2.0,559.0,559.0,5,850,2.0,582.0,582.0
0.012,6,10,1989,5,910,2.0,642.0,642.0,5,1079,3.0,811.0,811.0
0.006,6,10,1547,5,764,1.0,496.0,496.0,5,783,1.0,515.0,515.0
0.019,6,10,1990,5,911,4.0,643.0,643.0,5,1079,4.0,811.0,811.0
0.004,17,2,148,1,60,0.0,32.0,32.0,1,88,0.0,60.0,60.0
0.008,6,12,1926,6,1189,1.0,659.0,434.0,6,737,1.0,417.0,417.0
0.007,6,10,1989,5,910,1.0,642.0,642.0,5,1079,1.0,811.0,811.0
0.004,6,10,1989,5,927,1.0,659.0,659.0,5,1062,1.0,794.0,794.0
0.079,6,10,1506,5,395,19.0,127.0,127.0,5,1111,19.0,843.0,843.0
0.006,6,10,1547,5,764,1.0,496.0,496.0,5,783,1.0,515.0,515.0
0.015,6,10,1762,5,911,3.0,643.0,643.0,5,851,3.0,583.0,583.0
0.004,6,10,1702,5,863,1.0,595.0,595.0,5,839,1.0,571.0,571.0
0.006,17,2,225,1,65,0.0,37.0,37.0,1,160,0.0,132.0,132.0
0.005,6,14,3736,7,446,0.0,74.0,74.0,7,3290,0.0,1448.0,972.0
0.069,17,8,3613,4,1874,23.0,1350.0,440.0,4,1739,11.0,1350.0,406.0
0.014,6,10,1762,5,911,3.0,643.0,643.0,5,851,3.0,583.0,583.0
15.072,17,14,9190,8,6902,2149.0,1350.0,834.0,6,2288,3008.0,1350.0,353.0
0.005,6,10,2000,5,927,1.0,659.0,659.0,5,1073,1.0,805.0,805.0
0.014,6,10,1677,5,827,3.0,559.0,559.0,5,850,3.0,582.0,582.0
10.817,17,28,4423,14,1995,823.0,270.0,114.0,14,2428,823.0,587.0,145.0
0.005,6,10,2006,5,927,1.0,659.0,659.0,5,1079,1.0,811.0,811.0
0.006,6,10,1989,5,927,1.0,659.0,659.0,5,1062,1.0,794.0,794.0
242.146,6,309,343401,124,17957,1968.0,2736.0,959.0,185,325444,1315.0,2804.0,1804.0
0.006,17,2,144,1,64,0.0,36.0,36.0,1,80,0.0,52.0,52.0
0.013,6,10,1990,5,911,3.0,643.0,643.0,5,1079,3.0,811.0,811.0
0.028,17,2,148,1,60,0.0,32.0,32.0,1,88,0.0,60.0,60.0
0.005,6,10,1774,5,923,1.0,655.0,655.0,5,851,1.0,583.0,583.0
240.092,6,30,9554,15,7131,17149.0,2256.0,706.0,15,2423,17149.0,580.0,233.0
176.073,17,90,12802,45,3013,4001.0,44.0,38.0,45,9789,4001.0,279.0,189.0
0.009,6,10,1989,5,910,2.0,642.0,642.0,5,1079,2.0,811.0,811.0
0.01,6,10,1762,5,911,2.0,643.0,643.0,5,851,2.0,583.0,583.0
0.333,17,47,29528,27,26142,12.0,1350.0,940.0,20,3386,14.0,1350.0,141.0
0.004,6,10,2000,5,927,1.0,659.0,659.0,5,1073,1.0,805.0,805.0
0.011,6,13,3735,7,497,1.0,125.0,125.0,6,3238,2.0,1470.0,1459.0
0.009,6,10,1990,5,911,2.0,643.0,643.0,5,1079,2.0,811.0,811.0
0.006,6,10,1547,5,764,1.0,496.0,496.0,5,783,1.0,515.0,515.0
0.006,6,10,1989,5,910,1.0,642.0,642.0,5,1079,1.0,811.0,811.0
0.005,17,2,170,1,65,0.0,37.0,37.0,1,105,0.0,77.0,77.0
0.006,6,10,1689,5,839,1.0,571.0,571.0,5,850,1.0,582.0,582.0
0.004,17,2,136,1,60,0.0,32.0,32.0,1,76,0.0,48.0,48.0
240.436,6,43,8771,21,5686,12021.0,1515.0,509.0,22,3085,11449.0,580.0,241.0
40.073,17,10,676,5,460,10016.0,104.0,64.0,5,216,10017.0,20.0,15.0
0.004,17,2,136,1,60,0.0,32.0,32.0,1,76,0.0,48.0,48.0
0.005,6,10,2006,5,927,1.0,659.0,659.0,5,1079,1.0,811.0,811.0
0.076,6,10,1506,5,395,16.0,127.0,127.0,5,1111,15.0,843.0,843.0
0.013,6,10,1972,5,910,3.0,642.0,642.0,5,1062,3.0,794.0,794.0
0.005,17,2,144,1,64,0.0,36.0,36.0,1,80,0.0,52.0,52.0
0.005,6,10,1689,5,839,1.0,571.0,571.0,5,850,1.0,582.0,582.0
0.005,6,10,2006,5,927,1.0,659.0,659.0,5,1079,1.0,811.0,811.0
0.006,6,10,1854,5,889,1.0,621.0,621.0,5,965,1.0,697.0,697.0
0.004,17,2,144,1,64,0.0,36.0,36.0,1,80,0.0,52.0,52.0
0.009,6,10,1972,5,910,2.0,642.0,642.0,5,1062,2.0,794.0,794.0
40.077,17,10,676,5,460,10018.0,104.0,64.0,5,216,10018.0,20.0,15.0
0.006,6,10,1854,5,889,1.0,621.0,621.0,5,965,1.0,697.0,697.0
0.172,17,2,194,1,59,0.0,31.0,31.0,1,135,0.0,107.0,107.0
0.013,6,10,1972,5,910,3.0,642.0,642.0,5,1062,3.0,794.0,794.0
40.062,17,10,676,5,460,10014.0,104.0,64.0,5,216,10014.0,20.0,15.0
240.02,6,9,787,5,488,60005.0,232.0,232.0,4,299,80006.0,83.0,83.0
0.008,17,2,179,1,71,0.0,43.0,43.0,1,108,0.0,80.0,80.0
0.011,6,10,1989,5,910,2.0,642.0,642.0,5,1079,2.0,811.0,811.0
0.004,6,10,2006,5,927,1.0,659.0,659.0,5,1079,1.0,811.0,811.0
314.308,17,20,1124,10,716,34916.0,48.0,43.0,10,408,34916.0,20.0,12.0
0.006,6,10,1547,5,764,1.0,496.0,496.0,5,783,1.0,515.0,515.0
0.005,6,10,2007,5,928,1.0,660.0,660.0,5,1079,1.0,811.0,811.0
277.401,6,25,7265,15,1811,19814.0,253.0,207.0,10,5454,30822.0,1402.0,703.0
0.012,6,10,1972,5,910,3.0,642.0,642.0,5,1062,2.0,794.0,794.0
0.005,6,10,2000,5,927,1.0,659.0,659.0,5,1073,1.0,805.0,805.0
0.101,6,10,1506,5,395,24.0,127.0,127.0,5,1111,23.0,843.0,843.0
0.005,17,2,208,1,72,0.0,44.0,44.0,1,136,0.0,108.0,108.0
0.009,6,10,1989,5,910,2.0,642.0,642.0,5,1079,2.0,811.0,811.0
11.5,17,28,4397,14,2312,872.0,587.0,137.0,14,2085,872.0,268.0,120.0
0.015,6,10,1990,5,911,3.0,643.0,643.0,5,1079,3.0,811.0,811.0
0.001,17,2,136,1,60,0.0,32.0,32.0,1,76,0.0,48.0,48.0
0.006,6,10,1774,5,923,1.0,655.0,655.0,5,851,1.0,583.0,583.0
0.18,17,4,352,2,130,107.0,37.0,37.0,2,222,176.0,89.0,83.0
0.004,6,10,2007,5,928,1.0,660.0,660.0,5,1079,1.0,811.0,811.0
0.095,6,10,1506,5,395,22.0,127.0,127.0,5,1111,17.0,843.0,843.0
0.127,6,10,1506,5,395,29.0,127.0,127.0,5,1111,30.0,843.0,843.0
361.784,6,19,1688,15,978,25841.0,190.0,190.0,4,710,80013.0,494.0,494.0
0.122,17,2,80,1,32,0.0,4.0,4.0,1,48,0.0,20.0,20.0
0.016,6,10,1983,5,910,3.0,642.0,642.0,5,1073,3.0,805.0,805.0
0.018,6,10,1990,5,911,4.0,643.0,643.0,5,1079,4.0,811.0,811.0
0.01,17,2,148,1,60,0.0,32.0,32.0,1,88,0.0,60.0,60.0
0.005,6,10,2006,5,927,1.0,659.0,659.0,5,1079,1.0,811.0,811.0
0.297,17,41,20398,22,17090,13.0,1350.0,748.0,19,3308,14.0,1350.0,146.0
0.006,6,10,1643,5,860,1.0,592.0,592.0,5,783,1.0,515.0,515.0
0.005,17,2,179,1,71,0.0,43.0,43.0,1,108,0.0,80.0,80.0
0.714,6,25,5459,12,1557,55.0,325.0,152.0,13,3902,50.0,1414.0,563.0
0.001,17,2,180,1,66,0.0,38.0,38.0,1,114,0.0,86.0,86.0
0.005,6,10,2000,5,927,1.0,659.0,659.0,5,1073,1.0,805.0,805.0
40.066,17,10,676,5,460,10015.0,104.0,64.0,5,216,10015.0,20.0,15.0
0.017,6,10,1989,5,910,4.0,642.0,642.0,5,1079,4.0,811.0,811.0
0.014,6,10,1983,5,910,3.0,642.0,642.0,5,1073,3.0,805.0,805.0
0.005,6,10,1989,5,927,1.0,659.0,659.0,5,1062,1.0,794.0,794.0
0.004,17,2,136,1,60,0.0,32.0,32.0,1,76,0.0,48.0,48.0
0.006,6,10,1547,5,764,1.0,496.0,496.0,5,783,1.0,515.0,515.0
0.006,6,10,1547,5,764,1.0,496.0,496.0,5,783,1.0,515.0,515.0
40.059,17,10,676,5,460,10012.0,104.0,64.0,5,216,10013.0,20.0,15.0
0.004,6,10,1989,5,927,1.0,659.0,659.0,5,1062,1.0,794.0,794.0
0.071,6,10,1506,5,395,15.0,127.0,127.0,5,1111,15.0,843.0,843.0
0.005,17,2,214,1,75,0.0,47.0,47.0,1,139,0.0,111.0,111.0
0.005,17,2,140,1,62,0.0,34.0,34.0,1,78,0.0,50.0,50.0
0.105,6,10,1506,5,395,24.0,127.0,127.0,5,1111,24.0,843.0,843.0
0.004,6,10,1989,5,927,1.0,659.0,659.0,5,1062,1.0,794.0,794.0
0.009,6,10,1677,5,827,2.0,559.0,559.0,5,850,2.0,582.0,582.0
0.006,6,10,1547,5,764,1.0,496.0,496.0,5,783,1.0,515.0,515.0
0.014,6,10,1990,5,911,3.0,643.0,643.0,5,1079,3.0,811.0,811.0
0.016,6,10,1677,5,827,4.0,559.0,559.0,5,850,3.0,582.0,582.0
0.077,6,10,1506,5,395,16.0,127.0,127.0,5,1111,17.0,843.0,843.0
0.006,6,13,3747,7,509,1.0,137.0,137.0,6,3238,1.0,1470.0,1459.0
0.01,17,2,234,1,61,0.0,33.0,33.0,1,173,0.0,145.0,145.0
0.004,6,10,1702,5,863,0.0,595.0,595.0,5,839,1.0,571.0,571.0
0.005,17,2,230,1,68,0.0,40.0,40.0,1,162,0.0,134.0,134.0
0.008,6,10,1990,5,911,2.0,643.0,643.0,5,1079,1.0,811.0,811.0
0.005,6,10,2007,5,928,1.0,660.0,660.0,5,1079,1.0,811.0,811.0
0.005,6,10,2006,5,927,1.0,659.0,659.0,5,1079,1.0,811.0,811.0
0.075,6,10,1506,5,395,17.0,127.0,127.0,5,1111,16.0,843.0,843.0
0.108,6,10,1506,5,395,25.0,127.0,127.0,5,1111,21.0,843.0,843.0
0.005,6,10,2007,5,928,1.0,660.0,660.0,5,1079,1.0,811.0,811.0
0.005,6,10,1547,5,764,1.0,496.0,496.0,5,783,1.0,515.0,515.0
0.008,6,10,1989,5,910,2.0,642.0,642.0,5,1079,2.0,811.0,811.0
0.013,6,10,1631,5,848,3.0,580.0,580.0,5,783,3.0,515.0,515.0
0.006,6,10,1547,5,764,1.0,496.0,496.0,5,783,1.0,515.0,515.0
0.004,6,10,2006,5,927,1.0,659.0,659.0,5,1079,1.0,811.0,811.0
0.005,17,2,170,1,65,0.0,37.0,37.0,1,105,0.0,77.0,77.0
11.076,17,28,4367,14,2312,843.0,587.0,137.0,14,2055,842.0,270.0,118.0
0.009,6,10,1990,5,911,2.0,643.0,643.0,5,1079,2.0,811.0,811.0
0.007,6,13,3690,7,452,1.0,80.0,80.0,6,3238,1.0,1470.0,1459.0
0.004,17,2,166,1,75,0.0,47.0,47.0,1,91,0.0,63.0,63.0
0.052,17,2,152,1,76,0.0,48.0,48.0,1,76,0.0,48.0,48.0
0.076,6,10,1506,5,395,17.0,127.0,127.0,5,1111,17.0,843.0,843.0
0.004,6,10,1779,5,928,1.0,660.0,660.0,5,851,1.0,583.0,583.0
173.488,17,72,10210,36,2401,4956.0,44.0,38.0,36,7809,4956.0,239.0,188.0
1730.211,6,64,7361,42,4485,42200.0,1641.0,109.0,22,2876,82382.0,1112.0,82.0
0.003,17,2,136,1,60,0.0,32.0,32.0,1,76,0.0,48.0,48.0
0.067,6,10,1506,5,395,15.0,127.0,127.0,5,1111,14.0,843.0,843.0
0.106,6,10,1506,5,395,25.0,127.0,127.0,5,1111,22.0,843.0,843.0
0.012,6,10,1989,5,910,2.0,642.0,642.0,5,1079,2.0,811.0,811.0
0.082,6,10,1506,5,395,19.0,127.0,127.0,5,1111,16.0,843.0,843.0
0.175,17,2,152,1,76,0.0,48.0,48.0,1,76,0.0,48.0,48.0
0.094,6,10,1506,5,395,18.0,127.0,127.0,5,1111,20.0,843.0,843.0
0.001,17,2,136,1,60,0.0,32.0,32.0,1,76,0.0,48.0,48.0
0.005,6,10,1689,5,839,1.0,571.0,571.0,5,850,1.0,582.0,582.0
0.016,6,10,1989,5,910,3.0,642.0,642.0,5,1079,4.0,811.0,811.0
0.012,6,10,1983,5,910,3.0,642.0,642.0,5,1073,3.0,805.0,805.0
0.004,6,10,1989,5,927,1.0,659.0,659.0,5,1062,1.0,794.0,794.0
0.013,6,10,1990,5,911,3.0,643.0,643.0,5,1079,3.0,811.0,811.0
0.005,17,2,140,1,62,0.0,34.0,34.0,1,78,0.0,50.0,50.0
0.132,6,10,1506,5,395,30.0,127.0,127.0,5,1111,30.0,843.0,843.0
0.098,6,10,1506,5,395,22.0,127.0,127.0,5,1111,22.0,843.0,843.0
0.007,17,2,132,1,58,0.0,30.0,30.0,1,74,0.0,46.0,46.0
0.008,6,10,1983,5,910,2.0,642.0,642.0,5,1073,2.0,805.0,805.0
0.005,6,10,2006,5,927,1.0,659.0,659.0,5,1079,1.0,811.0,811.0
0.077,6,10,1506,5,395,17.0,127.0,127.0,5,1111,15.0,843.0,843.0
0.005,6,13,3747,7,509,0.0,137.0,137.0,6,3238,1.0,1470.0,1459.0
0.005,6,10,1689,5,839,1.0,571.0,571.0,5,850,1.0,582.0,582.0
0.014,6,10,1990,5,911,3.0,643.0,643.0,5,1079,3.0,811.0,811.0
0.005,17,2,152,1,68,0.0,40.0,40.0,1,84,0.0,56.0,56.0
0.021,6,10,1677,5,827,5.0,559.0,559.0,5,850,5.0,582.0,582.0
173.138,17,80,11459,40,2665,4439.0,44.0,38.0,40,8794,4439.0,260.0,191.0
0.038,17,2,152,1,76,0.0,48.0,48.0,1,76,0.0,48.0,48.0
0.007,17,2,194,1,59,0.0,31.0,31.0,1,135,0.0,107.0,107.0
0.016,6,10,1989,5,910,4.0,642.0,642.0,5,1079,4.0,811.0,811.0
246.558,6,39,10198,18,7072,14503.0,2040.0,682.0,21,3126,12327.0,580.0,155.0
0.005,6,10,1989,5,927,1.0,659.0,659.0,5,1062,1.0,794.0,794.0
0.012,6,10,1983,5,910,3.0,642.0,642.0,5,1073,3.0,805.0,805.0
0.008,6,12,1926,6,1189,1.0,659.0,434.0,6,737,1.0,417.0,417.0
308.604,17,20,1124,10,716,34273.0,48.0,43.0,10,408,34275.0,20.0,12.0
0.006,6,10,1689,5,839,1.0,571.0,571.0,5,850,1.0,582.0,582.0
0.136,6,10,1506,5,395,33.0,127.0,127.0,5,1111,30.0,843.0,843.0
0.004,6,10,2006,5,927,1.0,659.0,659.0,5,1079,1.0,811.0,811.0
0.005,6,10,2007,5,928,1.0,660.0,660.0,5,1079,1.0,811.0,811.0
0.014,6,10,1990,5,911,3.0,643.0,643.0,5,1079,3.0,811.0,811.0
0.004,17,2,148,1,60,0.0,32.0,32.0,1,88,0.0,60.0,60.0
40.066,17,10,676,5,460,10015.0,104.0,64.0,5,216,10015.0,20.0,15.0
0.004,17,2,136,1,60,0.0,32.0,32.0,1,76,0.0,48.0,48.0
0.022,6,10,1972,5,910,5.0,642.0,642.0,5,1062,5.0,794.0,794.0
0.004,6,10,2007,5,928,1.0,660.0,660.0,5,1079,1.0,811.0,811.0
0.09,6,10,1506,5,395,21.0,127.0,127.0,5,1111,20.0,843.0,843.0
0.004,6,10,2007,5,928,1.0,660.0,660.0,5,1079,1.0,811.0,811.0
0.005,17,2,178,1,65,0.0,37.0,37.0,1,113,0.0,85.0,85.0
0.006,17,2,166,1,75,0.0,47.0,47.0,1,91,0.0,63.0,63.0
0.09,6,10,1506,5,395,18.0,127.0,127.0,5,1111,22.0,843.0,843.0
40.053,17,10,676,5,460,10012.0,104.0,64.0,5,216,10012.0,20.0,15.0
11.157,17,28,4394,14,2313,849.0,588.0,137.0,14,2081,849.0,268.0,120.0
1799.916,17,2968,227357,1474,119491,1221.0,84.0,53.0,1494,107866,1205.0,225.0,44.0
0.01,6,10,1677,5,827,2.0,559.0,559.0,5,850,2.0,582.0,582.0
0.007,6,10,1989,5,927,1.0,659.0,659.0,5,1062,1.0,794.0,794.0
0.014,6,10,1972,5,910,3.0,642.0,642.0,5,1062,3.0,794.0,794.0
0.003,17,2,203,1,61,0.0,33.0,33.0,1,142,0.0,114.0,114.0
0.007,6,10,2006,5,927,1.0,659.0,659.0,5,1079,1.0,811.0,811.0
0.112,6,10,1506,5,395,25.0,127.0,127.0,5,1111,23.0,843.0,843.0
293.749,6,381,347402,193,21606,1529.0,2736.0,889.0,188,325796,1570.0,4136.0,1826.0
300.388,6,16,2170,9,684,37526.0,146.0,146.0,7,1486,50035.0,419.0,398.0
0.011,6,10,1983,5,910,2.0,642.0,642.0,5,1073,2.0,805.0,805.0
0.006,17,2,230,1,68,0.0,40.0,40.0,1,162,0.0,134.0,134.0
10.742,17,28,4418,14,1994,818.0,269.0,114.0,14,2424,818.0,587.0,145.0
40.056,17,10,676,5,460,10011.0,104.0,64.0,5,216,10013.0,20.0,15.0
0.004,6,10,2006,5,927,1.0,659.0,659.0,5,1079,1.0,811.0,811.0
0.01,6,10,1972,5,910,2.0,642.0,642.0,5,1062,2.0,794.0,794.0
0.017,6,10,1983,5,910,4.0,642.0,642.0,5,1073,4.0,805.0,805.0
0.04,17,2,182,1,65,0.0,37.0,37.0,1,117,0.0,89.0,89.0
0.076,6,10,1506,5,395,17.0,127.0,127.0,5,1111,18.0,843.0,843.0
0.005,6,10,2006,5,927,1.0,659.0,659.0,5,1079,1.0,811.0,811.0
0.005,6,10,2000,5,927,1.0,659.0,659.0,5,1073,1.0,805.0,805.0
0.005,6,10,1989,5,927,1.0,659.0,659.0,5,1062,1.0,794.0,794.0
0.012,6,10,1990,5,911,2.0,643.0,643.0,5,1079,2.0,811.0,811.0
0.019,6,10,1972,5,910,4.0,642.0,642.0,5,1062,4.0,794.0,794.0
0.005,6,10,1989,5,927,1.0,659.0,659.0,5,1062,1.0,794.0,794.0
10.758,17,28,4421,14,1993,819.0,268.0,114.0,14,2428,819.0,587.0,145.0
0.076,6,10,1506,5,395,17.0,127.0,127.0,5,1111,15.0,843.0,843.0
0.003,17,2,185,1,73,0.0,45.0,45.0,1,112,0.0,84.0,84.0
0.015,6,10,1990,5,911,3.0,643.0,643.0,5,1079,3.0,811.0,811.0
40.071,17,10,676,5,460,10012.0,104.0,64.0,5,216,10016.0,20.0,15.0
0.629,6,28,6699,16,2025,34.0,517.0,272.0,12,4674,46.0,1330.0,597.0
0.039,17,2,170,1,65,0.0,37.0,37.0,1,105,0.0,77.0,77.0
171.123,17,90,13149,45,3034,3889.0,44.0,39.0,45,10115,3889.0,239.0,196.0
40.075,17,10,676,5,460,10016.0,104.0,64.0,5,216,10017.0,20.0,15.0
0.102,6,10,1506,5,395,22.0,127.0,127.0,5,1111,24.0,843.0,843.0
0.005,6,10,2006,5,927,1.0,659.0,659.0,5,1079,1.0,811.0,811.0
360.048,6,21,3981,13,3142,30004.0,494.0,494.0,8,839,51434.0,83.0,83.0
0.04,17,2,152,1,76,0.0,48.0,48.0,1,76,0.0,48.0,48.0
0.004,17,4,284,2,120,0.0,32.0,32.0,2,164,0.0,60.0,54.0
0.013,6,10,1972,5,910,3.0,642.0,642.0,5,1062,3.0,794.0,794.0
0.001,17,2,180,1,66,0.0,38.0,38.0,1,114,0.0,86.0,86.0
0.016,6,10,1990,5,911,3.0,643.0,643.0,5,1079,4.0,811.0,811.0
40.059,17,10,676,5,460,10013.0,104.0,64.0,5,216,10013.0,20.0,15.0
0.095,6,10,1506,5,395,20.0,127.0,127.0,5,1111,22.0,843.0,843.0
0.013,6,10,1990,5,911,3.0,643.0,643.0,5,1079,3.0,811.0,811.0
0.006,6,10,1643,5,860,1.0,592.0,592.0,5,783,1.0,515.0,515.0
0.005,6,10,1989,5,927,1.0,659.0,659.0,5,1062,1.0,794.0,794.0
0.137,6,10,1506,5,395,29.0,127.0,127.0,5,1111,30.0,843.0,843.0
0.004,6,10,1989,5,927,1.0,659.0,659.0,5,1062,1.0,794.0,794.0
164.231,17,82,11787,41,2740,4103.0,44.0,38.0,41,9047,4105.0,261.0,192.0
0.068,17,8,3613,4,1874,22.0,1350.0,440.0,4,1739,11.0,1350.0,406.0
352.901,6,20,2210,6,1308,12003.0,494.0,494.0,14,902,27146.0,83.0,83.0
0.155,6,10,1506,5,395,36.0,127.0,127.0,5,1111,35.0,843.0,843.0
0.071,6,10,1506,5,395,15.0,127.0,127.0,5,1111,16.0,843.0,843.0
0.013,6,10,1972,5,910,3.0,642.0,642.0,5,1062,3.0,794.0,794.0
0.018,6,10,1983,5,910,4.0,642.0,642.0,5,1073,4.0,805.0,805.0
0.006,6,10,1854,5,889,1.0,621.0,621.0,5,965,1.0,697.0,697.0
0.005,6,10,2000,5,927,1.0,659.0,659.0,5,1073,1.0,805.0,805.0
0.005,6,10,2006,5,927,1.0,659.0,659.0,5,1079,1.0,811.0,811.0
0.004,6,10,2007,5,928,1.0,660.0,660.0,5,1079,1.0,811.0,811.0
0.015,6,10,1983,5,910,3.0,642.0,642.0,5,1073,3.0,805.0,805.0
0.011,6,13,3735,7,497,1.0,125.0,125.0,6,3238,2.0,1470.0,1459.0
0.001,17,2,180,1,66,0.0,38.0,38.0,1,114,0.0,86.0,86.0
240.126,6,31,9380,15,6953,17151.0,2076.0,686.0,16,2427,16008.0,580.0,198.0
0.012,6,10,1983,5,910,3.0,642.0,642.0,5,1073,3.0,805.0,805.0
0.004,6,10,1779,5,928,1.0,660.0,660.0,5,851,1.0,583.0,583.0
0.057,17,2,179,1,71,0.0,43.0,43.0,1,108,0.0,80.0,80.0
0.005,6,14,3799,7,509,0.0,137.0,137.0,7,3290,0.0,1448.0,972.0
0.097,6,10,1506,5,395,19.0,127.0,127.0,5,1111,20.0,843.0,843.0
0.005,6,10,1643,5,860,1.0,592.0,592.0,5,783,1.0,515.0,515.0
0.005,6,10,1989,5,927,1.0,659.0,659.0,5,1062,1.0,794.0,794.0
0.004,17,2,148,1,60,0.0,32.0,32.0,1,88,0.0,60.0,60.0
0.016,6,10,1989,5,910,3.0,642.0,642.0,5,1079,4.0,811.0,811.0
10.914,17,26,4102,13,1847,900.0,270.0,114.0,13,2255,900.0,586.0,145.0
0.01,6,13,3735,7,497,1.0,125.0,125.0,6,3238,2.0,1470.0,1459.0
0.087,6,10,1506,5,395,20.0,127.0,127.0,5,1111,19.0,843.0,843.0
0.01,6,10,1677,5,827,2.0,559.0,559.0,5,850,2.0,582.0,582.0
0.004,6,10,1774,5,923,1.0,655.0,655.0,5,851,1.0,583.0,583.0
0.004,6,10,1702,5,863,1.0,595.0,595.0,5,839,0.0,571.0,571.0
0.234,17,4,352,2,130,107.0,37.0,37.0,2,222,230.0,89.0,83.0
0.008,6,10,1989,5,910,2.0,642.0,642.0,5,1079,2.0,811.0,811.0
0.004,6,10,2006,5,927,1.0,659.0,659.0,5,1079,1.0,811.0,811.0
0.005,6,10,2006,5,927,1.0,659.0,659.0,5,1079,1.0,811.0,811.0
0.005,17,2,212,1,74,0.0,46.0,46.0,1,138,0.0,110.0,110.0
39.911,17,10,676,5,460,9975.0,104.0,64.0,5,216,9976.0,20.0,15.0
0.01,6,10,1990,5,911,2.0,643.0,643.0,5,1079,2.0,811.0,811.0
0.016,6,13,3735,7,497,2.0,125.0,125.0,6,3238,3.0,1470.0,1459.0
0.009,6,10,1762,5,911,2.0,643.0,643.0,5,851,2.0,583.0,583.0
40.071,17,10,676,5,460,10016.0,104.0,64.0,5,216,10017.0,20.0,15.0
0.005,17,2,144,1,64,0.0,36.0,36.0,1,80,0.0,52.0,52.0
0.012,6,10,1631,5,848,3.0,580.0,580.0,5,783,2.0,515.0,515.0
0.02,6,10,1631,5,848,4.0,580.0,580.0,5,783,4.0,515.0,515.0
371.387,6,22,2313,16,867,24759.0,195.0,195.0,6,1446,4641.0,419.0,398.0
0.005,17,2,154,1,69,0.0,41.0,41.0,1,85,0.0,57.0,57.0
0.006,6,10,1643,5,860,1.0,592.0,592.0,5,783,1.0,515.0,515.0
352.243,6,20,2210,6,1308,12004.0,494.0,494.0,14,902,27095.0,83.0,83.0
0.067,17,8,3613,4,1874,22.0,1350.0,440.0,4,1739,11.0,1350.0,406.0
0.005,6,10,1779,5,928,1.0,660.0,660.0,5,851,1.0,583.0,583.0
40.057,17,10,676,5,460,10013.0,104.0,64.0,5,216,10013.0,20.0,15.0
0.043,17,2,412,1,61,0.0,33.0,33.0,1,351,0.0,323.0,323.0
0.005,6,10,2007,5,928,1.0,660.0,660.0,5,1079,1.0,811.0,811.0
0.004,6,10,1702,5,863,0.0,595.0,595.0,5,839,1.0,571.0,571.0
0.073,6,10,1506,5,395,15.0,127.0,127.0,5,1111,16.0,843.0,843.0
0.005,6,10,1989,5,927,1.0,659.0,659.0,5,1062,1.0,794.0,794.0
0.012,6,12,1926,6,1189,2.0,659.0,434.0,6,737,2.0,417.0,417.0
0.123,6,10,1506,5,395,27.0,127.0,127.0,5,1111,28.0,843.0,843.0
40.054,17,10,676,5,460,10012.0,104.0,64.0,5,216,10012.0,20.0,15.0
0.01,6,10,1989,5,910,2.0,642.0,642.0,5,1079,2.0,811.0,811.0
0.117,6,10,1506,5,395,27.0,127.0,127.0,5,1111,23.0,843.0,843.0
0.112,6,10,1506,5,395,24.0,127.0,127.0,5,1111,24.0,843.0,843.0
0.005,6,10,2006,5,927,1.0,659.0,659.0,5,1079,1.0,811.0,811.0
0.164,17,2,152,1,76,0.0,48.0,48.0,1,76,0.0,48.0,48.0
0.04,17,2,136,1,60,0.0,32.0,32.0,1,76,0.0,48.0,48.0
0.004,17,2,148,1,60,0.0,32.0,32.0,1,88,0.0,60.0,60.0
240.011,6,9,787,5,488,60002.0,232.0,232.0,4,299,80003.0,83.0,83.0
0.006,6,10,1547,5,764,1.0,496.0,496.0,5,783,1.0,515.0,515.0
0.004,6,10,1989,5,927,1.0,659.0,659.0,5,1062,1.0,794.0,794.0
0.01,6,13,3735,7,497,1.0,125.0,125.0,6,3238,1.0,1470.0,1459.0
0.005,17,2,166,1,75,0.0,47.0,47.0,1,91,0.0,63.0,63.0
0.009,6,12,1926,6,1189,1.0,659.0,434.0,6,737,1.0,417.0,417.0
0.001,17,2,166,1,75,0.0,47.0,47.0,1,91,0.0,63.0,63.0
0.005,6,10,1989,5,927,1.0,659.0,659.0,5,1062,1.0,794.0,794.0
0.198,17,2,162,1,65,0.0,37.0,37.0,1,97,0.0,69.0,69.0
40.06,17,10,676,5,460,10014.0,104.0,64.0,5,216,10014.0,20.0,15.0
0.089,6,10,1506,5,395,20.0,127.0,127.0,5,1111,16.0,843.0,843.0
0.012,6,10,1989,5,910,3.0,642.0,642.0,5,1079,2.0,811.0,811.0
40.045,17,10,676,5,460,10010.0,104.0,64.0,5,216,10010.0,20.0,15.0
0.116,6,10,1506,5,395,26.0,127.0,127.0,5,1111,24.0,843.0,843.0
0.006,6,10,2000,5,927,1.0,659.0,659.0,5,1073,1.0,805.0,805.0
0.023,6,10,1972,5,910,5.0,642.0,642.0,5,1062,5.0,794.0,794.0
15.074,17,15,9239,8,6902,2149.0,1350.0,834.0,7,2337,2507.0,1350.0,305.0
353.259,6,20,2210,6,1308,12004.0,494.0,494.0,14,902,27173.0,83.0,83.0
0.088,6,10,1506,5,395,19.0,127.0,127.0,5,1111,17.0,843.0,843.0
300.354,6,33,12381,17,6283,18772.0,2072.0,896.0,16,6098,20023.0,1657.0,752.0
0.042,17,2,144,1,64,0.0,36.0,36.0,1,80,0.0,52.0,52.0
361.834,6,21,1792,16,1030,24122.0,190.0,190.0,5,762,60010.0,461.0,247.0
0.001,17,2,179,1,62,0.0,34.0,34.0,1,117,0.0,89.0,89.0
0.005,6,10,2006,5,927,1.0,659.0,659.0,5,1079,1.0,811.0,811.0
0.108,6,10,1506,5,395,23.0,127.0,127.0,5,1111,25.0,843.0,843.0
0.006,6,10,1547,5,764,1.0,496.0,496.0,5,783,1.0,515.0,515.0
0.004,6,10,1702,5,863,0.0,595.0,595.0,5,839,1.0,571.0,571.0
175.473,17,78,11031,39,2587,4617.0,44.0,38.0,39,8444,4617.0,261.0,188.0
0.005,6,10,2000,5,927,1.0,659.0,659.0,5,1073,1.0,805.0,805.0
0.007,17,2,194,1,59,0.0,31.0,31.0,1,135,0.0,107.0,107.0
0.183,6,44,11610,24,3282,7.0,1082.0,203.0,20,8328,9.0,1402.0,606.0
0.008,6,12,1926,6,1189,1.0,659.0,434.0,6,737,1.0,417.0,417.0
0.003,17,2,148,1,60,0.0,32.0,32.0,1,88,0.0,60.0,60.0
0.006,6,10,1547,5,764,1.0,496.0,496.0,5,783,1.0,515.0,515.0
0.006,6,10,1547,5,764,1.0,496.0,496.0,5,783,1.0,515.0,515.0
0.005,6,10,1643,5,860,1.0,592.0,592.0,5,783,1.0,515.0,515.0
166.356,17,80,11167,40,2668,4265.0,44.0,38.0,40,8499,4265.0,260.0,184.0
0.158,6,10,1506,5,395,37.0,127.0,127.0,5,1111,36.0,843.0,843.0
0.013,6,10,1983,5,910,3.0,642.0,642.0,5,1073,3.0,805.0,805.0
0.012,6,10,1990,5,911,3.0,643.0,643.0,5,1079,2.0,811.0,811.0
240.429,6,11,891,5,488,60107.0,232.0,232.0,6,403,48085.0,83.0,83.0
0.004,17,4,284,2,120,0.0,32.0,32.0,2,164,0.0,60.0,54.0
0.005,6,10,1547,5,764,1.0,496.0,496.0,5,783,1.0,515.0,515.0
0.001,17,2,180,1,66,0.0,38.0,38.0,1,114,0.0,86.0,86.0
0.009,6,10,1989,5,910,2.0,642.0,642.0,5,1079,2.0,811.0,811.0
0.104,6,10,1506,5,395,24.0,127.0,127.0,5,1111,20.0,843.0,843.0
0.006,6,10,2006,5,927,1.0,659.0,659.0,5,1079,1.0,811.0,811.0
361.788,6,19,1689,15,978,25842.0,190.0,190.0,4,711,80014.0,495.0,495.0
0.006,6,10,1972,5,910,1.0,642.0,642.0,5,1062,1.0,794.0,794.0
0.006,6,10,2007,5,928,1.0,660.0,660.0,5,1079,1.0,811.0,811.0
0.005,6,10,2006,5,927,1.0,659.0,659.0,5,1079,1.0,811.0,811.0
0.001,17,2,180,1,66,0.0,38.0,38.0,1,114,0.0,86.0,86.0
27.009,17,27,3805,14,950,2077.0,44.0,39.0,13,2855,2086.0,239.0,191.0
0.005,6,14,3799,7,509,0.0,137.0,137.0,7,3290,0.0,1448.0,972.0
40.058,17,10,676,5,460,10013.0,104.0,64.0,5,216,10013.0,20.0,15.0
0.009,6,10,1762,5,911,2.0,643.0,643.0,5,851,2.0,583.0,583.0
0.005,6,13,3747,7,509,0.0,137.0,137.0,6,3238,0.0,1470.0,1459.0
40.059,17,10,676,5,460,10012.0,104.0,64.0,5,216,10014.0,20.0,15.0
0.016,6,10,1762,5,911,4.0,643.0,643.0,5,851,4.0,583.0,583.0
40.074,17,10,676,5,460,10017.0,104.0,64.0,5,216,10017.0,20.0,15.0
0.006,6,14,3799,7,509,1.0,137.0,137.0,7,3290,0.0,1448.0,972.0
0.001,17,2,178,1,81,0.0,53.0,53.0,1,97,0.0,69.0,69.0
0.213,6,16,2777,8,1395,30.0,533.0,323.0,8,1382,19.0,529.0,239.0
301.032,6,48,18259,25,12312,12543.0,2720.0,1253.0,23,5947,403.0,2667.0,385.0
0.005,6,10,1689,5,839,1.0,571.0,571.0,5,850,1.0,582.0,582.0
0.004,6,10,1989,5,927,1.0,659.0,659.0,5,1062,1.0,794.0,794.0
0.095,6,10,1506,5,395,17.0,127.0,127.0,5,1111,22.0,843.0,843.0
0.025,6,10,1989,5,910,6.0,642.0,642.0,5,1079,6.0,811.0,811.0
0.009,6,13,3735,7,497,1.0,125.0,125.0,6,3238,1.0,1470.0,1459.0
0.087,6,10,1762,5,911,21.0,643.0,643.0,5,851,21.0,583.0,583.0
0.014,6,10,1972,5,910,3.0,642.0,642.0,5,1062,3.0,794.0,794.0
0.04,17,2,148,1,60,0.0,32.0,32.0,1,88,0.0,60.0,60.0
0.005,6,10,2000,5,927,1.0,659.0,659.0,5,1073,1.0,805.0,805.0
0.093,6,10,1506,5,395,21.0,127.0,127.0,5,1111,22.0,843.0,843.0
0.01,6,14,3787,7,497,1.0,125.0,125.0,7,3290,1.0,1448.0,972.0
0.04,17,4,284,2,120,1.0,32.0,32.0,2,164,36.0,60.0,54.0
15.072,17,15,9238,8,6902,2149.0,1350.0,834.0,7,2336,2507.0,1350.0,305.0
0.007,6,10,1643,5,860,1.0,592.0,592.0,5,783,1.0,515.0,515.0
0.088,6,10,1506,5,395,18.0,127.0,127.0,5,1111,21.0,843.0,843.0
0.106,17,2,184,1,61,0.0,33.0,33.0,1,123,0.0,95.0,95.0
1778.058,17,144,45504,72,22752,25042.0,288.0,288.0,72,22752,25042.0,288.0,288.0
0.068,6,10,1506,5,395,16.0,127.0,127.0,5,1111,15.0,843.0,843.0
0.01,6,10,1972,5,910,2.0,642.0,642.0,5,1062,2.0,794.0,794.0
0.091,6,10,1506,5,395,20.0,127.0,127.0,5,1111,20.0,843.0,843.0
0.013,6,10,1762,5,911,3.0,643.0,643.0,5,851,3.0,583.0,583.0
0.013,6,10,1972,5,910,3.0,642.0,642.0,5,1062,3.0,794.0,794.0
0.005,6,10,1989,5,927,1.0,659.0,659.0,5,1062,1.0,794.0,794.0
0.008,6,10,1989,5,910,1.0,642.0,642.0,5,1079,2.0,811.0,811.0
10.842,17,28,4424,14,1995,825.0,270.0,114.0,14,2429,825.0,588.0,145.0
0.02,6,10,1989,5,910,4.0,642.0,642.0,5,1079,4.0,811.0,811.0
0.075,6,10,1506,5,395,17.0,127.0,127.0,5,1111,16.0,843.0,843.0
0.067,6,10,1506,5,395,14.0,127.0,127.0,5,1111,14.0,843.0,843.0
0.011,6,10,1990,5,911,2.0,643.0,643.0,5,1079,2.0,811.0,811.0
0.044,17,2,396,1,61,0.0,33.0,33.0,1,335,0.0,307.0,307.0
11.042,17,28,4391,14,2313,840.0,588.0,137.0,14,2078,840.0,269.0,120.0
0.076,6,10,1506,5,395,15.0,127.0,127.0,5,1111,17.0,843.0,843.0
0.004,6,10,2007,5,928,1.0,660.0,660.0,5,1079,1.0,811.0,811.0
0.013,6,10,1990,5,911,3.0,643.0,643.0,5,1079,3.0,811.0,811.0
40.054,17,10,676,5,460,10012.0,104.0,64.0,5,216,10012.0,20.0,15.0
40.057,17,10,676,5,460,10010.0,104.0,64.0,5,216,10013.0,20.0,15.0
0.001,17,2,180,1,66,0.0,38.0,38.0,1,114,0.0,86.0,86.0
40.053,17,10,676,5,460,10012.0,104.0,64.0,5,216,10012.0,20.0,15.0
176.25,17,84,11932,42,2804,4298.0,44.0,38.0,42,9128,4298.0,239.0,189.0
0.112,6,10,1506,5,395,24.0,127.0,127.0,5,1111,23.0,843.0,843.0
0.086,6,10,1506,5,395,20.0,127.0,127.0,5,1111,19.0,843.0,843.0
0.013,6,10,1989,5,910,3.0,642.0,642.0,5,1079,3.0,811.0,811.0
243.231,6,384,348178,198,21839,1234.0,2736.0,960.0,186,326339,1314.0,4206.0,1799.0
0.105,6,10,1506,5,395,20.0,127.0,127.0,5,1111,20.0,843.0,843.0
0.005,6,10,2000,5,927,1.0,659.0,659.0,5,1073,1.0,805.0,805.0
0.005,6,10,2006,5,927,1.0,659.0,659.0,5,1079,1.0,811.0,811.0
0.072,6,10,1506,5,395,15.0,127.0,127.0,5,1111,16.0,843.0,843.0
0.084,6,10,1506,5,395,18.0,127.0,127.0,5,1111,17.0,843.0,843.0
0.007,6,10,1547,5,764,1.0,496.0,496.0,5,783,1.0,515.0,515.0
0.111,6,10,1506,5,395,25.0,127.0,127.0,5,1111,25.0,843.0,843.0
0.003,17,4,284,2,120,0.0,32.0,32.0,2,164,0.0,60.0,54.0
0.088,6,10,1506,5,395,20.0,127.0,127.0,5,1111,19.0,843.0,843.0
0.003,17,2,136,1,60,0.0,32.0,32.0,1,76,0.0,48.0,48.0
0.005,6,10,1989,5,927,1.0,659.0,659.0,5,1062,1.0,794.0,794.0
0.012,6,10,1989,5,910,3.0,642.0,642.0,5,1079,3.0,811.0,811.0
0.006,17,2,146,1,65,0.0,37.0,37.0,1,81,0.0,53.0,53.0
10.901,17,28,4421,14,1994,830.0,269.0,114.0,14,2427,830.0,586.0,145.0
40.075,17,10,676,5,460,10015.0,104.0,64.0,5,216,10015.0,20.0,15.0
0.001,17,2,180,1,66,0.0,38.0,38.0,1,114,0.0,86.0,86.0
0.004,17,2,148,1,60,0.0,32.0,32.0,1,88,0.0,60.0,60.0
0.072,17,2,184,1,61,0.0,33.0,33.0,1,123,0.0,95.0,95.0
0.007,6,10,1762,5,911,1.0,643.0,643.0,5,851,1.0,583.0,583.0
120.623,6,26,9525,12,1627,73.0,794.0,367.0,14,7898,9269.0,1360.0,732.0
0.001,17,2,180,1,66,0.0,38.0,38.0,1,114,0.0,86.0,86.0
0.005,6,10,2000,5,927,1.0,659.0,659.0,5,1073,1.0,805.0,805.0
0.006,6,10,1689,5,839,1.0,571.0,571.0,5,850,1.0,582.0,582.0
0.217,6,16,2670,8,1396,31.0,533.0,324.0,8,1274,19.0,529.0,212.0
0.073,17,8,3613,4,1874,24.0,1350.0,440.0,4,1739,11.0,1350.0,406.0
0.01,6,10,1677,5,827,2.0,559.0,559.0,5,850,2.0,582.0,582.0
0.007,17,2,179,1,71,0.0,43.0,43.0,1,108,0.0,80.0,80.0
0.006,17,2,214,1,75,0.0,47.0,47.0,1,139,0.0,111.0,111.0
0.109,6,10,1506,5,395,23.0,127.0,127.0,5,1111,25.0,843.0,843.0
0.004,6,10,2006,5,927,1.0,659.0,659.0,5,1079,1.0,811.0,811.0
0.006,17,2,294,1,64,0.0,36.0,36.0,1,230,0.0,202.0,202.0
40.056,17,10,676,5,460,10013.0,104.0,64.0,5,216,10013.0,20.0,15.0
0.005,6,10,2007,5,928,1.0,660.0,660.0,5,1079,1.0,811.0,811.0
0.005,6,10,2007,5,928,1.0,660.0,660.0,5,1079,1.0,811.0,811.0
0.003,17,2,148,1,60,0.0,32.0,32.0,1,88,0.0,60.0,60.0
240.013,6,9,787,5,488,60003.0,232.0,232.0,4,299,80003.0,83.0,83.0
0.004,6,10,1989,5,927,1.0,659.0,659.0,5,1062,1.0,794.0,794.0
0.01,6,10,1989,5,910,2.0,642.0,642.0,5,1079,2.0,811.0,811.0
0.005,6,14,3736,7,446,0.0,74.0,74.0,7,3290,0.0,1448.0,972.0
371.57,6,22,2313,16,867,24771.0,195.0,195.0,6,1446,4686.0,419.0,398.0
0.01,6,10,1989,5,910,2.0,642.0,642.0,5,1079,2.0,811.0,811.0
0.005,6,10,2006,5,927,1.0,659.0,659.0,5,1079,1.0,811.0,811.0
0.011,6,10,1989,5,910,2.0,642.0,642.0,5,1079,2.0,811.0,811.0
0.081,6,10,1506,5,395,18.0,127.0,127.0,5,1111,18.0,843.0,843.0
0.017,6,10,1989,5,910,4.0,642.0,642.0,5,1079,4.0,811.0,811.0
0.11,6,10,1506,5,395,25.0,127.0,127.0,5,1111,23.0,843.0,843.0
0.005,6,10,2006,5,927,1.0,659.0,659.0,5,1079,1.0,811.0,811.0
0.009,6,12,1926,6,1189,1.0,659.0,434.0,6,737,1.0,417.0,417.0
0.013,17,2,230,1,68,0.0,40.0,40.0,1,162,0.0,134.0,134.0
0.001,17,2,136,1,60,0.0,32.0,32.0,1,76,0.0,48.0,48.0
0.014,6,10,1989,5,910,3.0,642.0,642.0,5,1079,3.0,811.0,811.0
0.079,6,10,1506,5,395,17.0,127.0,127.0,5,1111,17.0,843.0,843.0
0.017,6,10,1677,5,827,4.0,559.0,559.0,5,850,4.0,582.0,582.0
0.006,6,10,1547,5,764,1.0,496.0,496.0,5,783,1.0,515.0,515.0
0.085,6,10,1506,5,395,20.0,127.0,127.0,5,1111,19.0,843.0,843.0
308.373,17,20,1124,10,716,34250.0,48.0,43.0,10,408,34250.0,20.0,12.0
0.115,6,10,1506,5,395,26.0,127.0,127.0,5,1111,25.0,843.0,843.0
0.005,17,2,170,1,65,0.0,37.0,37.0,1,105,0.0,77.0,77.0
0.005,6,10,2000,5,927,1.0,659.0,659.0,5,1073,1.0,805.0,805.0
0.015,6,10,1972,5,910,3.0,642.0,642.0,5,1062,3.0,794.0,794.0
0.1,6,10,1506,5,395,22.0,127.0,127.0,5,1111,21.0,843.0,843.0
0.012,6,10,1677,5,827,2.0,559.0,559.0,5,850,2.0,582.0,582.0
0.006,6,10,1689,5,839,1.0,571.0,571.0,5,850,1.0,582.0,582.0
0.004,6,10,2006,5,927,1.0,659.0,659.0,5,1079,1.0,811.0,811.0
40.066,17,10,676,5,460,10013.0,104.0,64.0,5,216,10014.0,20.0,15.0
0.081,6,10,1506,5,395,18.0,127.0,127.0,5,1111,18.0,843.0,843.0
0.011,6,13,3735,7,497,1.0,125.0,125.0,6,3238,2.0,1470.0,1459.0
0.005,6,10,2006,5,927,1.0,659.0,659.0,5,1079,1.0,811.0,811.0
0.015,6,10,1983,5,910,3.0,642.0,642.0,5,1073,3.0,805.0,805.0
40.077,17,10,676,5,460,10018.0,104.0,64.0,5,216,10018.0,20.0,15.0
300.019,6,12,1782,7,1348,50003.0,494.0,494.0,5,434,75004.0,83.0,83.0
0.005,6,10,2006,5,927,1.0,659.0,659.0,5,1079,1.0,811.0,811.0
0.144,17,2,144,1,64,0.0,36.0,36.0,1,80,0.0,52.0,52.0
0.01,17,2,136,1,60,0.0,32.0,32.0,1,76,0.0,48.0,48.0
0.006,17,2,170,1,65,0.0,37.0,37.0,1,105,0.0,77.0,77.0
0.068,17,8,3613,4,1874,22.0,1350.0,440.0,4,1739,11.0,1350.0,406.0
0.117,6,10,1506,5,395,24.0,127.0,127.0,5,1111,26.0,843.0,843.0
0.109,6,10,1506,5,395,25.0,127.0,127.0,5,1111,22.0,843.0,843.0
0.013,6,10,1983,5,910,3.0,642.0,642.0,5,1073,3.0,805.0,805.0
0.005,17,2,140,1,62,0.0,34.0,34.0,1,78,0.0,50.0,50.0
0.108,6,10,1506,5,395,22.0,127.0,127.0,5,1111,24.0,843.0,843.0
0.004,17,2,136,1,60,0.0,32.0,32.0,1,76,0.0,48.0,48.0
0.007,6,10,1854,5,889,1.0,621.0,621.0,5,965,1.0,697.0,697.0
0.005,17,2,170,1,65,0.0,37.0,37.0,1,105,0.0,77.0,77.0
15.075,17,15,9239,8,6902,2149.0,1350.0,834.0,7,2337,2506.0,1350.0,305.0
0.001,17,2,180,1,66,0.0,38.0,38.0,1,114,0.0,86.0,86.0
0.017,6,13,3735,7,497,2.0,125.0,125.0,6,3238,3.0,1470.0,1459.0
0.005,6,10,1989,5,927,1.0,659.0,659.0,5,1062,1.0,794.0,794.0
0.004,6,10,2006,5,927,1.0,659.0,659.0,5,1079,1.0,811.0,811.0
0.005,6,10,1779,5,928,1.0,660.0,660.0,5,851,1.0,583.0,583.0
0.006,6,10,1989,5,927,1.0,659.0,659.0,5,1062,1.0,794.0,794.0
0.007,6,10,1989,5,910,1.0,642.0,642.0,5,1079,1.0,811.0,811.0
0.008,6,10,1972,5,910,2.0,642.0,642.0,5,1062,2.0,794.0,794.0
0.009,6,10,1990,5,911,2.0,643.0,643.0,5,1079,2.0,811.0,811.0
0.016,6,10,1972,5,910,4.0,642.0,642.0,5,1062,3.0,794.0,794.0
0.003,17,4,284,2,120,0.0,32.0,32.0,2,164,1.0,60.0,54.0
0.008,6,10,1989,5,910,2.0,642.0,642.0,5,1079,2.0,811.0,811.0
0.001,17,2,180,1,66,0.0,38.0,38.0,1,114,0.0,86.0,86.0
0.005,6,10,1779,5,928,1.0,660.0,660.0,5,851,1.0,583.0,583.0
0.005,6,10,1689,5,839,1.0,571.0,571.0,5,850,1.0,582.0,582.0
318.493,17,20,1124,10,716,35373.0,48.0,43.0,10,408,35373.0,20.0,12.0
309.948,17,20,1124,10,716,34423.0,48.0,43.0,10,408,34423.0,20.0,12.0
0.012,17,2,132,1,58,0.0,30.0,30.0,1,74,0.0,46.0,46.0
0.005,6,10,1989,5,927,1.0,659.0,659.0,5,1062,1.0,794.0,794.0
291.179,6,329,344228,125,18055,2348.0,2736.0,825.0,204,326173,1434.0,2804.0,1669.0
0.054,17,2,152,1,76,0.0,48.0,48.0,1,76,0.0,48.0,48.0
0.005,6,10,1689,5,839,1.0,571.0,571.0,5,850,1.0,582.0,582.0
0.004,6,10,1989,5,927,1.0,659.0,659.0,5,1062,1.0,794.0,794.0
0.017,6,10,1989,5,910,4.0,642.0,642.0,5,1079,4.0,811.0,811.0
292.893,6,413,349829,200,21978,1471.0,2736.0,889.0,213,327851,1381.0,2999.0,1591.0
0.087,6,10,1506,5,395,19.0,127.0,127.0,5,1111,18.0,843.0,843.0
0.114,6,10,1506,5,395,25.0,127.0,127.0,5,1111,25.0,843.0,843.0
0.006,6,10,1547,5,764,1.0,496.0,496.0,5,783,1.0,515.0,515.0
0.013,17,2,156,1,64,0.0,36.0,36.0,1,92,0.0,64.0,64.0
0.005,6,10,1547,5,764,1.0,496.0,496.0,5,783,1.0,515.0,515.0
354.067,6,21,1795,16,1030,23604.0,190.0,190.0,5,765,60002.0,464.0,248.0
0.005,17,2,164,1,74,0.0,46.0,46.0,1,90,0.0,62.0,62.0
30.302,6,87,74319,43,3308,721.0,517.0,262.0,44,71011,704.0,2804.0,1675.0
0.004,6,10,2006,5,927,1.0,659.0,659.0,5,1079,1.0,811.0,811.0
0.003,17,2,148,1,60,0.0,32.0,32.0,1,88,0.0,60.0,60.0
11.32,17,34,6368,17,2656,700.0,269.0,128.0,17,3712,700.0,1145.0,190.0
0.011,6,10,1983,5,910,2.0,642.0,642.0,5,1073,2.0,805.0,805.0
0.008,17,4,284,2,120,5.0,32.0,32.0,2,164,4.0,60.0,54.0
0.005,6,10,1547,5,764,1.0,496.0,496.0,5,783,1.0,515.0,515.0
0.004,6,10,2007,5,928,1.0,660.0,660.0,5,1079,1.0,811.0,811.0
301.187,6,53,24072,27,18005,11584.0,4080.0,1535.0,26,6067,360.0,2667.0,385.0
0.005,17,2,144,1,64,0.0,36.0,36.0,1,80,0.0,52.0,52.0
0.009,6,10,1972,5,910,2.0,642.0,642.0,5,1062,2.0,794.0,794.0
0.021,6,10,1972,5,910,5.0,642.0,642.0,5,1062,5.0,794.0,794.0
0.01,6,10,1631,5,848,2.0,580.0,580.0,5,783,2.0,515.0,515.0
0.005,6,10,2006,5,927,1.0,659.0,659.0,5,1079,1.0,811.0,811.0
0.009,6,10,1972,5,910,2.0,642.0,642.0,5,1062,2.0,794.0,794.0
0.006,6,10,2007,5,928,1.0,660.0,660.0,5,1079,1.0,811.0,811.0
0.009,6,12,1926,6,1189,1.0,659.0,434.0,6,737,1.0,417.0,417.0
0.008,17,2,148,1,60,0.0,32.0,32.0,1,88,0.0,60.0,60.0
0.077,6,10,1506,5,395,18.0,127.0,127.0,5,1111,17.0,843.0,843.0
0.006,6,10,2006,5,927,1.0,659.0,659.0,5,1079,1.0,811.0,811.0
0.005,17,4,284,2,120,0.0,32.0,32.0,2,164,0.0,60.0,54.0
0.005,6,10,2006,5,927,1.0,659.0,659.0,5,1079,1.0,811.0,811.0
40.08,17,10,676,5,460,10018.0,104.0,64.0,5,216,10019.0,20.0,15.0
0.005,6,10,2006,5,927,1.0,659.0,659.0,5,1079,1.0,811.0,811.0
0.008,6,10,1990,5,911,2.0,643.0,643.0,5,1079,2.0,811.0,811.0
0.012,6,10,1989,5,910,2.0,642.0,642.0,5,1079,3.0,811.0,811.0
334.76,17,20,1124,10,716,37188.0,48.0,43.0,10,408,37187.0,20.0,12.0
0.122,17,2,80,1,32,0.0,4.0,4.0,1,48,0.0,20.0,20.0
15.074,17,15,9238,8,6902,2149.0,1350.0,834.0,7,2336,2507.0,1350.0,305.0
0.083,6,10,1506,5,395,19.0,127.0,127.0,5,1111,17.0,843.0,843.0
0.005,17,2,170,1,65,0.0,37.0,37.0,1,105,0.0,77.0,77.0
0.005,6,10,1989,5,927,1.0,659.0,659.0,5,1062,1.0,794.0,794.0
0.006,6,10,1547,5,764,1.0,496.0,496.0,5,783,1.0,515.0,515.0
40.071,17,10,676,5,460,10015.0,104.0,64.0,5,216,10016.0,20.0,15.0
0.005,6,10,1779,5,928,1.0,660.0,660.0,5,851,1.0,583.0,583.0
0.005,17,2,164,1,74,0.0,46.0,46.0,1,90,0.0,62.0,62.0
0.074,6,10,1506,5,395,16.0,127.0,127.0,5,1111,14.0,843.0,843.0
0.006,6,10,1854,5,889,1.0,621.0,621.0,5,965,1.0,697.0,697.0
0.126,6,10,1506,5,395,28.0,127.0,127.0,5,1111,26.0,843.0,843.0
0.011,6,10,1989,5,910,2.0,642.0,642.0,5,1079,2.0,811.0,811.0
0.003,17,2,148,1,60,0.0,32.0,32.0,1,88,0.0,60.0,60.0
0.111,6,10,1506,5,395,21.0,127.0,127.0,5,1111,27.0,843.0,843.0
353.379,6,20,2210,6,1308,12004.0,494.0,494.0,14,902,27182.0,83.0,83.0
0.097,6,10,1506,5,395,19.0,127.0,127.0,5,1111,21.0,843.0,843.0
0.016,17,2,152,1,56,0.0,28.0,28.0,1,96,0.0,68.0,68.0
0.096,6,10,1506,5,395,22.0,127.0,127.0,5,1111,22.0,843.0,843.0
0.008,6,10,1990,5,911,2.0,643.0,643.0,5,1079,1.0,811.0,811.0
240.387,6,34,9318,17,1888,15023.0,624.0,199.0,17,7430,15023.0,1402.0,595.0
0.143,6,10,1506,5,395,26.0,127.0,127.0,5,1111,30.0,843.0,843.0
0.012,6,10,1983,5,910,3.0,642.0,642.0,5,1073,2.0,805.0,805.0
0.109,6,10,1506,5,395,22.0,127.0,127.0,5,1111,25.0,843.0,843.0
0.333,17,44,24427,24,21181,14.0,1350.0,854.0,20,3246,14.0,1350.0,134.0
0.119,6,10,1506,5,395,27.0,127.0,127.0,5,1111,29.0,843.0,843.0
0.039,17,2,136,1,60,0.0,32.0,32.0,1,76,0.0,48.0,48.0
292.414,6,314,348171,121,17836,2436.0,2736.0,888.0,193,330335,1522.0,2804.0,1789.0
0.006,6,10,1689,5,839,1.0,571.0,571.0,5,850,1.0,582.0,582.0
1770.311,6,84,4420,42,2210,43177.0,26.0,26.0,42,2210,43177.0,26.0,26.0
0.007,17,2,194,1,59,0.0,31.0,31.0,1,135,0.0,107.0,107.0
0.006,6,10,1547,5,764,1.0,496.0,496.0,5,783,1.0,515.0,515.0
0.006,6,10,1643,5,860,1.0,592.0,592.0,5,783,1.0,515.0,515.0
0.004,6,10,2006,5,927,1.0,659.0,659.0,5,1079,1.0,811.0,811.0
0.005,6,10,2006,5,927,1.0,659.0,659.0,5,1079,1.0,811.0,811.0
0.001,17,2,180,1,66,0.0,38.0,38.0,1,114,0.0,86.0,86.0
0.085,6,10,1506,5,395,20.0,127.0,127.0,5,1111,16.0,843.0,843.0
0.004,6,10,1774,5,923,1.0,655.0,655.0,5,851,1.0,583.0,583.0
0.003,17,2,186,1,61,0.0,33.0,33.0,1,125,0.0,97.0,97.0
0.005,6,10,1779,5,928,1.0,660.0,660.0,5,851,1.0,583.0,583.0
0.004,6,10,1702,5,863,1.0,595.0,595.0,5,839,0.0,571.0,571.0
0.012,6,10,1972,5,910,3.0,642.0,642.0,5,1062,3.0,794.0,794.0
0.042,17,4,284,2,120,0.0,32.0,32.0,2,164,5.0,60.0,54.0
174.229,17,82,11969,41,2762,4355.0,44.0,39.0,41,9207,4355.0,239.0,196.0
0.004,17,2,136,1,60,0.0,32.0,32.0,1,76,0.0,48.0,48.0
0.005,17,2,144,1,64,0.0,36.0,36.0,1,80,0.0,52.0,52.0
0.004,6,10,2006,5,927,1.0,659.0,659.0,5,1079,1.0,811.0,811.0
0.006,6,10,1854,5,889,1.0,621.0,621.0,5,965,1.0,697.0,697.0
0.003,17,4,284,2,120,0.0,32.0,32.0,2,164,0.0,60.0,54.0
1749.572,6,439,65754,254,35296,6915.0,613.0,197.0,185,30458,9507.0,453.0,146.0
0.006,6,10,1854,5,889,1.0,621.0,621.0,5,965,1.0,697.0,697.0
0.005,6,10,1989,5,927,1.0,659.0,659.0,5,1062,1.0,794.0,794.0
0.004,6,10,2007,5,928,1.0,660.0,660.0,5,1079,1.0,811.0,811.0
0.013,17,2,180,1,66,0.0,38.0,38.0,1,114,0.0,86.0,86.0
0.005,6,10,1547,5,764,1.0,496.0,496.0,5,783,1.0,515.0,515.0
0.008,6,10,1972,5,910,2.0,642.0,642.0,5,1062,1.0,794.0,794.0
40.067,17,10,676,5,460,10014.0,104.0,64.0,5,216,10015.0,20.0,15.0
0.102,6,10,1506,5,395,24.0,127.0,127.0,5,1111,23.0,843.0,843.0
0.066,6,10,1506,5,395,13.0,127.0,127.0,5,1111,15.0,843.0,843.0
0.01,6,10,1989,5,910,2.0,642.0,642.0,5,1079,2.0,811.0,811.0
0.032,6,10,1990,5,911,8.0,643.0,643.0,5,1079,7.0,811.0,811.0
0.006,6,10,1643,5,860,1.0,592.0,592.0,5,783,1.0,515.0,515.0
0.005,6,10,2007,5,928,1.0,660.0,660.0,5,1079,1.0,811.0,811.0
0.005,6,10,1689,5,839,1.0,571.0,571.0,5,850,1.0,582.0,582.0
0.006,17,2,166,1,75,0.0,47.0,47.0,1,91,0.0,63.0,63.0
40.062,17,10,676,5,460,10013.0,104.0,64.0,5,216,10014.0,20.0,15.0
0.039,17,2,148,1,60,0.0,32.0,32.0,1,88,0.0,60.0,60.0
15.096,17,16,8212,8,6063,2152.0,1350.0,729.0,8,2149,2150.0,1350.0,240.0
0.077,6,10,1506,5,395,16.0,127.0,127.0,5,1111,17.0,843.0,843.0
0.013,6,10,1989,5,910,3.0,642.0,642.0,5,1079,3.0,811.0,811.0
240.112,6,32,9569,16,6980,16007.0,2052.0,683.0,16,2589,16007.0,580.0,218.0
0.005,6,10,2000,5,927,1.0,659.0,659.0,5,1073,1.0,805.0,805.0
40.06,17,10,676,5,460,10013.0,104.0,64.0,5,216,10014.0,20.0,15.0
241.623,6,382,347039,200,21919,1214.0,2736.0,885.0,182,325120,1334.0,2804.0,1835.0
0.012,6,10,1989,5,910,3.0,642.0,642.0,5,1079,2.0,811.0,811.0
0.005,6,10,1689,5,839,1.0,571.0,571.0,5,850,1.0,582.0,582.0
0.006,6,10,1689,5,839,1.0,571.0,571.0,5,850,1.0,582.0,582.0
0.009,6,10,1989,5,910,2.0,642.0,642.0,5,1079,2.0,811.0,811.0
300.381,6,16,2170,9,684,37526.0,146.0,146.0,7,1486,50035.0,419.0,398.0
0.066,6,10,1506,5,395,14.0,127.0,127.0,5,1111,15.0,843.0,843.0
293.241,6,406,350696,208,22385,1416.0,2736.0,888.0,198,328311,1488.0,4127.0,1728.0
0.006,6,10,1547,5,764,1.0,496.0,496.0,5,783,1.0,515.0,515.0
308.732,17,20,1124,10,716,34289.0,48.0,43.0,10,408,34290.0,20.0,12.0
0.006,6,14,3799,7,509,0.0,137.0,137.0,7,3290,0.0,1448.0,972.0
0.008,6,10,1989,5,910,2.0,642.0,642.0,5,1079,2.0,811.0,811.0
0.005,17,2,136,1,60,0.0,32.0,32.0,1,76,0.0,48.0,48.0
0.065,6,10,1506,5,395,13.0,127.0,127.0,5,1111,14.0,843.0,843.0
0.085,6,10,1506,5,395,17.0,127.0,127.0,5,1111,17.0,843.0,843.0
240.093,6,16,4481,9,963,30011.0,238.0,166.0,7,3518,40014.0,1402.0,786.0
0.01,6,10,1972,5,910,2.0,642.0,642.0,5,1062,2.0,794.0,794.0
241.4,6,411,348573,199,21876,1219.0,2736.0,960.0,212,326697,1144.0,2804.0,1562.0
0.005,6,10,2006,5,927,1.0,659.0,659.0,5,1079,1.0,811.0,811.0
1766.665,6,555,187619,289,163439,6134.0,2883.0,945.0,266,24180,6666.0,359.0,102.0
0.006,6,10,1689,5,839,1.0,571.0,571.0,5,850,1.0,582.0,582.0
0.007,6,10,1972,5,910,1.0,642.0,642.0,5,1062,1.0,794.0,794.0
837.592,6,57,21706,27,5741,32215.0,676.0,481.0,30,15965,26812.0,1402.0,719.0
0.113,6,10,1506,5,395,24.0,127.0,127.0,5,1111,26.0,843.0,843.0
0.006,6,10,1547,5,764,1.0,496.0,496.0,5,783,1.0,515.0,515.0
0.003,17,2,148,1,60,0.0,32.0,32.0,1,88,0.0,60.0,60.0
0.004,6,10,1989,5,927,1.0,659.0,659.0,5,1062,1.0,794.0,794.0
0.003,17,2,148,1,60,0.0,32.0,32.0,1,88,0.0,60.0,60.0
0.003,17,2,185,1,73,0.0,45.0,45.0,1,112,0.0,84.0,84.0
0.004,6,10,2000,5,927,1.0,659.0,659.0,5,1073,1.0,805.0,805.0
0.713,6,22,5072,11,1250,60.0,325.0,133.0,11,3822,60.0,1414.0,563.0
0.014,6,10,1972,5,910,3.0,642.0,642.0,5,1062,3.0,794.0,794.0
0.124,17,2,80,1,32,0.0,4.0,4.0,1,48,0.0,20.0,20.0
0.006,17,2,148,1,60,0.0,32.0,32.0,1,88,0.0,60.0,60.0
0.014,6,10,1990,5,911,3.0,643.0,643.0,5,1079,3.0,811.0,811.0
0.015,6,10,1989,5,910,3.0,642.0,642.0,5,1079,3.0,811.0,811.0
0.005,6,10,2006,5,927,1.0,659.0,659.0,5,1079,1.0,811.0,811.0
0.006,6,10,1989,5,927,1.0,659.0,659.0,5,1062,1.0,794.0,794.0
0.009,6,10,1989,5,910,2.0,642.0,642.0,5,1079,2.0,811.0,811.0
0.005,6,10,1779,5,928,1.0,660.0,660.0,5,851,1.0,583.0,583.0
0.005,6,10,1774,5,923,1.0,655.0,655.0,5,851,1.0,583.0,583.0
40.059,17,10,676,5,460,10012.0,104.0,64.0,5,216,10011.0,20.0,15.0
40.062,17,10,676,5,460,10013.0,104.0,64.0,5,216,10014.0,20.0,15.0
0.003,17,2,136,1,60,0.0,32.0,32.0,1,76,0.0,48.0,48.0
0.017,6,10,1990,5,911,4.0,643.0,643.0,5,1079,4.0,811.0,811.0
0.016,6,10,1677,5,827,3.0,559.0,559.0,5,850,3.0,582.0,582.0
0.222,6,16,2674,8,1400,31.0,533.0,325.0,8,1274,20.0,529.0,212.0
0.005,17,2,144,1,64,0.0,36.0,36.0,1,80,0.0,52.0,52.0
0.005,6,10,1989,5,927,1.0,659.0,659.0,5,1062,1.0,794.0,794.0
172.34,17,86,12289,43,2889,4103.0,44.0,39.0,43,9400,4103.0,249.0,190.0
0.072,6,10,1506,5,395,17.0,127.0,127.0,5,1111,14.0,843.0,843.0
0.018,6,10,1989,5,910,4.0,642.0,642.0,5,1079,4.0,811.0,811.0
0.006,6,10,1689,5,839,1.0,571.0,571.0,5,850,1.0,582.0,582.0
0.074,6,10,1506,5,395,12.0,127.0,127.0,5,1111,17.0,843.0,843.0
0.008,6,10,2000,5,927,2.0,659.0,659.0,5,1073,2.0,805.0,805.0
0.009,6,10,1972,5,910,2.0,642.0,642.0,5,1062,2.0,794.0,794.0
0.003,17,2,136,1,60,0.0,32.0,32.0,1,76,0.0,48.0,48.0
0.023,6,10,1631,5,848,5.0,580.0,580.0,5,783,5.0,515.0,515.0
0.013,6,10,1631,5,848,3.0,580.0,580.0,5,783,3.0,515.0,515.0
280.755,6,26,6520,12,1266,25523.0,267.0,156.0,14,5254,21595.0,1400.0,781.0
0.011,17,2,136,1,60,0.0,32.0,32.0,1,76,0.0,48.0,48.0
0.099,6,10,1506,5,395,19.0,127.0,127.0,5,1111,22.0,843.0,843.0
0.079,6,10,1506,5,395,18.0,127.0,127.0,5,1111,16.0,843.0,843.0
0.012,6,10,1983,5,910,3.0,642.0,642.0,5,1073,2.0,805.0,805.0
0.005,6,13,3747,7,509,0.0,137.0,137.0,6,3238,0.0,1470.0,1459.0
10.763,17,28,4421,14,1993,819.0,268.0,114.0,14,2428,819.0,587.0,145.0
0.006,6,10,1547,5,764,1.0,496.0,496.0,5,783,1.0,515.0,515.0
0.013,6,10,1990,5,911,3.0,643.0,643.0,5,1079,3.0,811.0,811.0
0.001,17,2,180,1,66,0.0,38.0,38.0,1,114,0.0,86.0,86.0
15.072,17,15,9239,8,6902,2149.0,1350.0,834.0,7,2337,2507.0,1350.0,305.0
0.012,6,10,1990,5,911,2.0,643.0,643.0,5,1079,3.0,811.0,811.0
0.005,6,10,1779,5,928,1.0,660.0,660.0,5,851,1.0,583.0,583.0
0.006,6,10,2006,5,927,1.0,659.0,659.0,5,1079,1.0,811.0,811.0
0.209,6,10,1506,5,395,48.0,127.0,127.0,5,1111,49.0,843.0,843.0
0.166,17,2,152,1,76,0.0,48.0,48.0,1,76,0.0,48.0,48.0
0.015,6,10,1989,5,910,3.0,642.0,642.0,5,1079,3.0,811.0,811.0
0.097,6,10,1506,5,395,20.0,127.0,127.0,5,1111,23.0,843.0,843.0
0.106,6,10,1506,5,395,25.0,127.0,127.0,5,1111,25.0,843.0,843.0
0.111,6,10,1506,5,395,23.0,127.0,127.0,5,1111,25.0,843.0,843.0
354.001,6,21,1795,16,1030,23600.0,190.0,190.0,5,765,60003.0,464.0,248.0
0.005,6,10,2007,5,928,1.0,660.0,660.0,5,1079,1.0,811.0,811.0
40.079,17,10,676,5,460,10018.0,104.0,64.0,5,216,10019.0,20.0,15.0
0.005,6,10,2006,5,927,1.0,659.0,659.0,5,1079,1.0,811.0,811.0
0.012,6,10,1677,5,827,3.0,559.0,559.0,5,850,3.0,582.0,582.0
0.01,6,10,1990,5,911,2.0,643.0,643.0,5,1079,2.0,811.0,811.0
240.095,6,16,4482,9,963,30011.0,238.0,166.0,7,3519,40015.0,1402.0,786.0
0.085,6,10,1506,5,395,17.0,127.0,127.0,5,1111,19.0,843.0,843.0
0.038,17,2,152,1,76,0.0,48.0,48.0,1,76,0.0,48.0,48.0
35.855,6,178,179499,85,5759,426.0,504.0,329.0,93,173740,389.0,4206.0,1856.0
40.052,17,10,676,5,460,10012.0,104.0,64.0,5,216,10012.0,20.0,15.0
0.001,17,2,180,1,66,0.0,38.0,38.0,1,114,0.0,86.0,86.0
0.062,6,10,1506,5,395,13.0,127.0,127.0,5,1111,13.0,843.0,843.0
0.004,6,10,2006,5,927,1.0,659.0,659.0,5,1079,1.0,811.0,811.0
125.61,58,5,360,4,288,41870.0,24.0,24.0,1,72,0.0,24.0,24.0
0.129,17,2,80,1,32,0.0,4.0,4.0,1,48,0.0,20.0,20.0
0.005,6,10,1989,5,927,1.0,659.0,659.0,5,1062,1.0,794.0,794.0
0.039,17,4,420,2,122,0.0,33.0,33.0,2,298,36.0,145.0,121.0
0.006,6,10,1547,5,764,1.0,496.0,496.0,5,783,1.0,515.0,515.0
0.007,6,10,1972,5,910,1.0,642.0,642.0,5,1062,1.0,794.0,794.0
0.016,17,2,198,1,91,0.0,63.0,63.0,1,107,0.0,79.0,79.0
0.004,6,10,2007,5,928,1.0,660.0,660.0,5,1079,1.0,811.0,811.0
300.543,6,16,2170,9,684,37541.0,146.0,146.0,7,1486,50056.0,419.0,398.0
23.039,6,41,23320,21,1150,1151.0,290.0,290.0,20,22170,1212.0,1414.0,1256.0
0.008,6,10,1762,5,911,2.0,643.0,643.0,5,851,2.0,583.0,583.0
0.037,17,2,136,1,60,0.0,32.0,32.0,1,76,0.0,48.0,48.0
240.097,6,16,4481,9,963,30012.0,238.0,166.0,7,3518,40015.0,1402.0,786.0
0.013,6,10,1983,5,910,3.0,642.0,642.0,5,1073,3.0,805.0,805.0
308.906,17,20,1124,10,716,34308.0,48.0,43.0,10,408,34308.0,20.0,12.0
0.006,17,2,136,1,60,0.0,32.0,32.0,1,76,0.0,48.0,48.0
0.018,17,2,230,1,68,0.0,40.0,40.0,1,162,0.0,134.0,134.0
240.111,6,16,4480,9,963,30013.0,238.0,166.0,7,3517,40017.0,1402.0,786.0
0.004,6,10,1989,5,927,1.0,659.0,659.0,5,1062,1.0,794.0,794.0
0.005,6,10,2000,5,927,1.0,659.0,659.0,5,1073,1.0,805.0,805.0
0.004,17,2,136,1,60,0.0,32.0,32.0,1,76,0.0,48.0,48.0
0.016,6,10,1989,5,910,3.0,642.0,642.0,5,1079,4.0,811.0,811.0
0.005,6,13,3747,7,509,0.0,137.0,137.0,6,3238,1.0,1470.0,1459.0
0.004,17,4,284,2,120,0.0,32.0,32.0,2,164,1.0,60.0,54.0
0.017,6,10,1972,5,910,4.0,642.0,642.0,5,1062,4.0,794.0,794.0
0.012,6,10,1972,5,910,3.0,642.0,642.0,5,1062,3.0,794.0,794.0
0.013,6,10,1972,5,910,3.0,642.0,642.0,5,1062,3.0,794.0,794.0
0.011,6,10,1972,5,910,2.0,642.0,642.0,5,1062,2.0,794.0,794.0
0.009,6,10,1972,5,910,2.0,642.0,642.0,5,1062,2.0,794.0,794.0
0.006,6,10,1779,5,928,1.0,660.0,660.0,5,851,1.0,583.0,583.0
0.09,6,10,1506,5,395,21.0,127.0,127.0,5,1111,20.0,843.0,843.0
0.023,6,10,1989,5,910,5.0,642.0,642.0,5,1079,5.0,811.0,811.0
0.009,6,10,1990,5,911,2.0,643.0,643.0,5,1079,2.0,811.0,811.0
0.029,6,13,3735,7,497,4.0,125.0,125.0,6,3238,5.0,1470.0,1459.0
287.547,6,24,6115,10,1186,31949.0,267.0,156.0,14,4929,22118.0,1400.0,873.0
0.026,17,2,136,1,60,0.0,32.0,32.0,1,76,0.0,48.0,48.0
361.746,6,21,1792,16,1030,24116.0,190.0,190.0,5,762,60009.0,461.0,247.0
0.006,17,2,168,1,76,0.0,48.0,48.0,1,92,0.0,64.0,64.0
0.085,6,10,1506,5,395,19.0,127.0,127.0,5,1111,18.0,843.0,843.0
0.001,17,2,180,1,66,0.0,38.0,38.0,1,114,0.0,86.0,86.0
0.004,17,4,284,2,120,0.0,32.0,32.0,2,164,0.0,60.0,54.0
0.006,6,10,1643,5,860,1.0,592.0,592.0,5,783,1.0,515.0,515.0
300.38,6,16,2170,9,684,37526.0,146.0,146.0,7,1486,50035.0,419.0,398.0
0.09,6,10,1506,5,395,19.0,127.0,127.0,5,1111,19.0,843.0,843.0
0.004,6,10,2007,5,928,1.0,660.0,660.0,5,1079,1.0,811.0,811.0
0.006,6,10,1547,5,764,1.0,496.0,496.0,5,783,1.0,515.0,515.0
15.119,17,19,13436,9,8280,1886.0,1350.0,892.0,10,5156,1676.0,1350.0,487.0
5.082,6,21,5923,12,1436,461.0,474.0,201.0,9,4487,634.0,1925.0,804.0
11.147,17,28,4421,14,1994,844.0,269.0,114.0,14,2427,844.0,586.0,145.0
0.008,6,10,1989,5,910,2.0,642.0,642.0,5,1079,1.0,811.0,811.0
240.035,6,9,787,5,488,60008.0,232.0,232.0,4,299,80010.0,83.0,83.0
0.004,17,2,136,1,60,0.0,32.0,32.0,1,76,0.0,48.0,48.0
0.101,6,10,1506,5,395,22.0,127.0,127.0,5,1111,21.0,843.0,843.0
0.003,17,2,148,1,60,0.0,32.0,32.0,1,88,0.0,60.0,60.0
0.005,6,10,2006,5,927,1.0,659.0,659.0,5,1079,1.0,811.0,811.0
0.006,6,10,1547,5,764,1.0,496.0,496.0,5,783,1.0,515.0,515.0
0.04,17,4,284,2,120,0.0,32.0,32.0,2,164,37.0,60.0,54.0
0.005,17,2,230,1,68,0.0,40.0,40.0,1,162,0.0,134.0,134.0
0.001,17,2,136,1,60,0.0,32.0,32.0,1,76,0.0,48.0,48.0
0.011,6,10,1983,5,910,2.0,642.0,642.0,5,1073,2.0,805.0,805.0
0.006,6,10,1547,5,764,1.0,496.0,496.0,5,783,1.0,515.0,515.0
0.004,6,10,2007,5,928,1.0,660.0,660.0,5,1079,1.0,811.0,811.0
0.011,6,13,3735,7,497,1.0,125.0,125.0,6,3238,2.0,1470.0,1459.0
0.005,6,10,2000,5,927,1.0,659.0,659.0,5,1073,1.0,805.0,805.0
40.067,17,10,676,5,460,10016.0,104.0,64.0,5,216,10015.0,20.0,15.0
0.081,6,10,1506,5,395,18.0,127.0,127.0,5,1111,19.0,843.0,843.0
0.075,6,10,1506,5,395,16.0,127.0,127.0,5,1111,16.0,843.0,843.0
11.156,17,28,4422,14,1994,845.0,269.0,114.0,14,2428,845.0,587.0,145.0
0.005,17,2,169,1,62,0.0,34.0,34.0,1,107,0.0,79.0,79.0
0.127,17,2,80,1,32,0.0,4.0,4.0,1,48,0.0,20.0,20.0
0.006,6,10,1854,5,889,1.0,621.0,621.0,5,965,1.0,697.0,697.0
0.32,17,46,27932,27,24844,12.0,1350.0,892.0,19,3088,14.0,1350.0,134.0
0.005,6,10,1854,5,889,1.0,621.0,621.0,5,965,1.0,697.0,697.0
0.076,6,10,1506,5,395,17.0,127.0,127.0,5,1111,16.0,843.0,843.0
0.005,6,10,2007,5,928,1.0,660.0,660.0,5,1079,1.0,811.0,811.0
0.012,6,10,1762,5,911,3.0,643.0,643.0,5,851,3.0,583.0,583.0
0.118,6,10,1506,5,395,26.0,127.0,127.0,5,1111,24.0,843.0,843.0
0.124,17,2,182,1,65,0.0,37.0,37.0,1,117,0.0,89.0,89.0
300.312,6,16,2170,9,684,37518.0,146.0,146.0,7,1486,50024.0,419.0,398.0
40.058,17,10,676,5,460,10013.0,104.0,64.0,5,216,10013.0,20.0,15.0
0.019,6,10,1983,5,910,4.0,642.0,642.0,5,1073,4.0,805.0,805.0
0.017,6,10,1990,5,911,4.0,643.0,643.0,5,1079,4.0,811.0,811.0
0.003,17,2,148,1,60,0.0,32.0,32.0,1,88,0.0,60.0,60.0
0.018,6,10,1989,5,910,4.0,642.0,642.0,5,1079,4.0,811.0,811.0
0.136,6,10,1506,5,395,29.0,127.0,127.0,5,1111,32.0,843.0,843.0
0.019,6,10,1972,5,910,4.0,642.0,642.0,5,1062,4.0,794.0,794.0
0.005,6,10,1643,5,860,1.0,592.0,592.0,5,783,1.0,515.0,515.0
0.005,6,10,2006,5,927,1.0,659.0,659.0,5,1079,1.0,811.0,811.0
364.386,6,21,1793,16,1030,24292.0,190.0,190.0,5,763,60011.0,462.0,247.0
300.348,6,16,2170,9,684,37522.0,146.0,146.0,7,1486,50030.0,419.0,398.0
0.049,17,4,596,2,122,46.0,33.0,33.0,2,474,9.0,323.0,209.0
0.004,17,4,284,2,120,0.0,32.0,32.0,2,164,0.0,60.0,54.0
1.033,6,12,3134,6,2099,155.0,1328.0,923.0,6,1035,155.0,791.0,791.0
0.005,6,10,1989,5,927,1.0,659.0,659.0,5,1062,1.0,794.0,794.0
0.086,6,10,1506,5,395,19.0,127.0,127.0,5,1111,19.0,843.0,843.0
1787.355,6,154,19574,92,13852,19641.0,302.0,302.0,62,5722,29300.0,83.0,83.0
1757.237,6,105,6270,60,3525,29783.0,27.0,27.0,45,2745,39936.0,27.0,27.0
0.006,6,10,2006,5,927,1.0,659.0,659.0,5,1079,1.0,811.0,811.0
0.004,6,10,1989,5,927,1.0,659.0,659.0,5,1062,1.0,794.0,794.0
11.128,17,28,4388,14,2311,847.0,586.0,137.0,14,2077,847.0,268.0,120.0
0.004,6,10,2007,5,928,1.0,660.0,660.0,5,1079,1.0,811.0,811.0
240.115,6,31,9431,15,7124,17151.0,2248.0,705.0,16,2307,16007.0,580.0,183.0
0.007,6,10,1989,5,910,1.0,642.0,642.0,5,1079,1.0,811.0,811.0
0.091,6,10,1506,5,395,22.0,127.0,127.0,5,1111,21.0,843.0,843.0
0.014,6,10,1631,5,848,3.0,580.0,580.0,5,783,3.0,515.0,515.0
10.928,17,28,4423,14,1995,831.0,270.0,114.0,14,2428,829.0,587.0,145.0
40.071,17,10,676,5,460,10015.0,104.0,64.0,5,216,10017.0,20.0,15.0
0.007,6,10,2007,5,928,1.0,660.0,660.0,5,1079,1.0,811.0,811.0
0.005,17,2,214,1,75,0.0,47.0,47.0,1,139,0.0,111.0,111.0
0.012,6,10,1989,5,910,3.0,642.0,642.0,5,1079,2.0,811.0,811.0
1757.149,6,111,6699,62,3680,28805.0,27.0,27.0,49,3019,36606.0,27.0,27.0
0.006,17,2,170,1,65,0.0,37.0,37.0,1,105,0.0,77.0,77.0
0.082,6,10,1506,5,395,18.0,127.0,127.0,5,1111,17.0,843.0,843.0
0.107,6,10,1506,5,395,23.0,127.0,127.0,5,1111,23.0,843.0,843.0
311.859,17,20,1124,10,716,34636.0,48.0,43.0,10,408,34636.0,20.0,12.0
0.004,6,10,2006,5,927,1.0,659.0,659.0,5,1079,1.0,811.0,811.0
0.006,6,10,1854,5,889,1.0,621.0,621.0,5,965,1.0,697.0,697.0
0.001,17,2,179,1,62,0.0,34.0,34.0,1,117,0.0,89.0,89.0
0.009,17,2,179,1,71,0.0,43.0,43.0,1,108,0.0,80.0,80.0
0.006,17,2,170,1,65,0.0,37.0,37.0,1,105,0.0,77.0,77.0
0.082,6,10,1506,5,395,18.0,127.0,127.0,5,1111,17.0,843.0,843.0
0.009,6,10,1972,5,910,2.0,642.0,642.0,5,1062,2.0,794.0,794.0
0.004,6,10,2006,5,927,1.0,659.0,659.0,5,1079,1.0,811.0,811.0
0.005,17,2,169,1,62,0.0,34.0,34.0,1,107,0.0,79.0,79.0
0.006,6,13,3747,7,509,0.0,137.0,137.0,6,3238,1.0,1470.0,1459.0
0.041,17,4,284,2,120,0.0,32.0,32.0,2,164,38.0,60.0,54.0
0.067,17,8,3613,4,1874,22.0,1350.0,440.0,4,1739,11.0,1350.0,406.0
0.074,17,2,148,1,60,0.0,32.0,32.0,1,88,0.0,60.0,60.0
0.004,6,10,2006,5,927,1.0,659.0,659.0,5,1079,1.0,811.0,811.0
0.004,17,2,186,1,61,0.0,33.0,33.0,1,125,0.0,97.0,97.0
0.018,6,10,1983,5,910,4.0,642.0,642.0,5,1073,4.0,805.0,805.0
0.001,17,2,136,1,60,0.0,32.0,32.0,1,76,0.0,48.0,48.0
0.013,6,10,1762,5,911,3.0,643.0,643.0,5,851,3.0,583.0,583.0
0.005,6,10,2000,5,927,1.0,659.0,659.0,5,1073,1.0,805.0,805.0
0.15,6,10,1506,5,395,36.0,127.0,127.0,5,1111,34.0,843.0,843.0
40.019,17,10,676,5,460,10002.0,104.0,64.0,5,216,10004.0,20.0,15.0
0.005,6,10,2006,5,927,1.0,659.0,659.0,5,1079,1.0,811.0,811.0
0.005,6,10,2006,5,927,1.0,659.0,659.0,5,1079,1.0,811.0,811.0
0.014,6,10,1990,5,911,3.0,643.0,643.0,5,1079,3.0,811.0,811.0
0.004,6,10,2006,5,927,1.0,659.0,659.0,5,1079,1.0,811.0,811.0
0.015,6,10,1989,5,910,3.0,642.0,642.0,5,1079,3.0,811.0,811.0
0.086,6,10,1506,5,395,19.0,127.0,127.0,5,1111,19.0,843.0,843.0
0.007,17,2,230,1,68,0.0,40.0,40.0,1,162,0.0,134.0,134.0
0.115,6,10,1506,5,395,26.0,127.0,127.0,5,1111,26.0,843.0,843.0
0.003,17,2,136,1,60,0.0,32.0,32.0,1,76,0.0,48.0,48.0
0.005,6,10,1989,5,927,1.0,659.0,659.0,5,1062,1.0,794.0,794.0
0.159,6,10,1506,5,395,34.0,127.0,127.0,5,1111,23.0,843.0,843.0
0.329,6,10,1506,5,395,79.0,127.0,127.0,5,1111,53.0,843.0,843.0
0.003,17,2,148,1,60,0.0,32.0,32.0,1,88,0.0,60.0,60.0
0.053,17,2,152,1,76,0.0,48.0,48.0,1,76,0.0,48.0,48.0
315.302,17,20,1124,10,716,35018.0,48.0,43.0,10,408,35018.0,20.0,12.0
0.018,6,10,1631,5,848,4.0,580.0,580.0,5,783,4.0,515.0,515.0
0.006,6,10,1689,5,839,1.0,571.0,571.0,5,850,1.0,582.0,582.0
0.004,6,10,1774,5,923,1.0,655.0,655.0,5,851,1.0,583.0,583.0
10.928,17,28,4416,14,1993,831.0,268.0,114.0,14,2423,831.0,586.0,145.0
0.006,6,10,1547,5,764,1.0,496.0,496.0,5,783,1.0,515.0,515.0
0.006,6,10,1689,5,839,1.0,571.0,571.0,5,850,1.0,582.0,582.0
0.005,6,10,2007,5,928,1.0,660.0,660.0,5,1079,1.0,811.0,811.0
0.005,6,10,1643,5,860,1.0,592.0,592.0,5,783,1.0,515.0,515.0
0.009,6,10,1989,5,910,2.0,642.0,642.0,5,1079,2.0,811.0,811.0
0.091,6,10,1506,5,395,22.0,127.0,127.0,5,1111,20.0,843.0,843.0
0.005,6,10,1989,5,927,1.0,659.0,659.0,5,1062,1.0,794.0,794.0
0.004,6,10,2007,5,928,1.0,660.0,660.0,5,1079,1.0,811.0,811.0
0.07,6,10,1506,5,395,16.0,127.0,127.0,5,1111,14.0,843.0,843.0
0.225,6,16,2777,8,1395,32.0,533.0,323.0,8,1382,20.0,529.0,239.0
0.004,6,10,2007,5,928,1.0,660.0,660.0,5,1079,1.0,811.0,811.0
1792.541,6,487,99234,245,87964,7346.0,421.0,368.0,242,11270,7437.0,53.0,53.0
0.004,6,13,3747,7,509,0.0,137.0,137.0,6,3238,0.0,1470.0,1459.0
0.004,17,4,284,2,120,0.0,32.0,32.0,2,164,1.0,60.0,54.0
0.084,6,10,1506,5,395,18.0,127.0,127.0,5,1111,19.0,843.0,843.0
0.005,6,10,2006,5,927,1.0,659.0,659.0,5,1079,1.0,811.0,811.0
0.005,6,10,1779,5,928,1.0,660.0,660.0,5,851,1.0,583.0,583.0
0.004,6,10,2006,5,927,1.0,659.0,659.0,5,1079,1.0,811.0,811.0
0.006,6,10,1989,5,927,1.0,659.0,659.0,5,1062,1.0,794.0,794.0
0.006,6,10,1547,5,764,1.0,496.0,496.0,5,783,1.0,515.0,515.0
0.108,6,10,1506,5,395,21.0,127.0,127.0,5,1111,21.0,843.0,843.0
0.076,6,10,1506,5,395,17.0,127.0,127.0,5,1111,16.0,843.0,843.0
0.001,17,2,180,1,66,0.0,38.0,38.0,1,114,0.0,86.0,86.0
0.009,6,12,1926,6,1189,1.0,659.0,434.0,6,737,1.0,417.0,417.0
15.135,17,20,14815,10,9658,1678.0,1350.0,937.0,10,5157,1676.0,1350.0,487.0
0.142,17,4,596,2,122,103.0,33.0,33.0,2,474,103.0,323.0,209.0
371.163,6,22,2313,16,867,24744.0,195.0,195.0,6,1446,4642.0,419.0,398.0
0.133,17,2,80,1,32,0.0,4.0,4.0,1,48,0.0,20.0,20.0
0.004,6,10,2000,5,927,1.0,659.0,659.0,5,1073,1.0,805.0,805.0
0.005,6,10,2006,5,927,1.0,659.0,659.0,5,1079,1.0,811.0,811.0
0.018,6,10,1972,5,910,4.0,642.0,642.0,5,1062,4.0,794.0,794.0
0.008,6,10,1989,5,910,1.0,642.0,642.0,5,1079,2.0,811.0,811.0
0.012,6,10,1631,5,848,3.0,580.0,580.0,5,783,3.0,515.0,515.0
0.041,17,4,284,2,120,0.0,32.0,32.0,2,164,0.0,60.0,54.0
0.124,17,4,284,2,120,0.0,32.0,32.0,2,164,120.0,60.0,54.0
0.005,6,13,3747,7,509,0.0,137.0,137.0,6,3238,0.0,1470.0,1459.0
40.073,17,10,676,5,460,10017.0,104.0,64.0,5,216,10017.0,20.0,15.0
0.004,17,4,284,2,120,0.0,32.0,32.0,2,164,1.0,60.0,54.0
0.006,17,2,179,1,71,0.0,43.0,43.0,1,108,0.0,80.0,80.0
0.004,6,10,2000,5,927,1.0,659.0,659.0,5,1073,1.0,805.0,805.0
354.037,6,21,1795,16,1030,23602.0,190.0,190.0,5,765,60003.0,464.0,248.0
0.011,6,10,1989,5,910,2.0,642.0,642.0,5,1079,2.0,811.0,811.0
0.008,6,12,1926,6,1189,1.0,659.0,434.0,6,737,1.0,417.0,417.0
0.005,6,10,2006,5,927,1.0,659.0,659.0,5,1079,1.0,811.0,811.0
0.011,6,10,1989,5,910,2.0,642.0,642.0,5,1079,2.0,811.0,811.0
0.075,6,10,1506,5,395,16.0,127.0,127.0,5,1111,15.0,843.0,843.0
40.069,17,10,676,5,460,10014.0,104.0,64.0,5,216,10016.0,20.0,15.0
0.017,6,10,1972,5,910,4.0,642.0,642.0,5,1062,4.0,794.0,794.0
0.009,6,10,1762,5,911,2.0,643.0,643.0,5,851,2.0,583.0,583.0
40.071,17,10,676,5,460,10017.0,104.0,64.0,5,216,10016.0,20.0,15.0
0.015,6,10,1631,5,848,3.0,580.0,580.0,5,783,3.0,515.0,515.0
40.072,17,10,676,5,460,10015.0,104.0,64.0,5,216,10017.0,20.0,15.0
0.005,6,10,2006,5,927,1.0,659.0,659.0,5,1079,1.0,811.0,811.0
0.005,6,14,3742,8,504,0.0,80.0,80.0,6,3238,1.0,1470.0,1459.0
0.005,6,10,1779,5,928,1.0,660.0,660.0,5,851,1.0,583.0,583.0
0.021,6,10,1989,5,910,5.0,642.0,642.0,5,1079,5.0,811.0,811.0
0.017,6,10,1989,5,910,4.0,642.0,642.0,5,1079,4.0,811.0,811.0
0.225,6,16,2777,8,1395,32.0,533.0,323.0,8,1382,21.0,529.0,239.0
0.004,6,10,2000,5,927,1.0,659.0,659.0,5,1073,1.0,805.0,805.0
0.003,17,2,136,1,60,0.0,32.0,32.0,1,76,0.0,48.0,48.0
0.012,6,10,1972,5,910,3.0,642.0,642.0,5,1062,2.0,794.0,794.0
0.012,17,2,164,1,74,0.0,46.0,46.0,1,90,0.0,62.0,62.0
0.116,6,10,1506,5,395,24.0,127.0,127.0,5,1111,26.0,843.0,843.0
0.005,6,10,1689,5,839,1.0,571.0,571.0,5,850,1.0,582.0,582.0
361.832,6,19,1688,15,978,25845.0,190.0,190.0,4,710,80012.0,494.0,494.0
0.01,6,12,1926,6,1189,2.0,659.0,434.0,6,737,1.0,417.0,417.0
0.015,6,10,1989,5,910,3.0,642.0,642.0,5,1079,3.0,811.0,811.0
0.011,6,10,1677,5,827,2.0,559.0,559.0,5,850,2.0,582.0,582.0
0.005,6,10,2006,5,927,1.0,659.0,659.0,5,1079,1.0,811.0,811.0
0.008,17,2,194,1,59,0.0,31.0,31.0,1,135,0.0,107.0,107.0
0.015,6,10,1762,5,911,3.0,643.0,643.0,5,851,3.0,583.0,583.0
0.128,6,10,1506,5,395,30.0,127.0,127.0,5,1111,24.0,843.0,843.0
0.005,6,10,1689,5,839,1.0,571.0,571.0,5,850,1.0,582.0,582.0
240.019,6,22,3474,12,1820,21819.0,599.0,171.0,10,1654,26668.0,580.0,225.0
0.006,6,10,1547,5,764,1.0,496.0,496.0,5,783,1.0,515.0,515.0
0.015,6,10,1983,5,910,3.0,642.0,642.0,5,1073,3.0,805.0,805.0
0.005,6,10,2007,5,928,1.0,660.0,660.0,5,1079,1.0,811.0,811.0
0.005,6,10,1989,5,927,1.0,659.0,659.0,5,1062,1.0,794.0,794.0
0.005,6,10,1989,5,927,1.0,659.0,659.0,5,1062,1.0,794.0,794.0
0.038,17,4,284,2,120,0.0,32.0,32.0,2,164,34.0,60.0,54.0
0.004,17,2,148,1,60,0.0,32.0,32.0,1,88,0.0,60.0,60.0
0.006,6,10,2006,5,927,1.0,659.0,659.0,5,1079,1.0,811.0,811.0
0.002,17,2,180,1,66,0.0,38.0,38.0,1,114,0.0,86.0,86.0
0.005,6,10,2007,5,928,1.0,660.0,660.0,5,1079,1.0,811.0,811.0
0.076,6,10,1506,5,395,17.0,127.0,127.0,5,1111,15.0,843.0,843.0
0.012,6,10,1983,5,910,3.0,642.0,642.0,5,1073,3.0,805.0,805.0
40.054,17,10,676,5,460,10012.0,104.0,64.0,5,216,10012.0,20.0,15.0
0.02,6,10,1989,5,910,4.0,642.0,642.0,5,1079,4.0,811.0,811.0
0.123,6,10,1506,5,395,29.0,127.0,127.0,5,1111,27.0,843.0,843.0
40.059,17,10,676,5,460,10014.0,104.0,64.0,5,216,10014.0,20.0,15.0
0.004,17,2,136,1,60,0.0,32.0,32.0,1,76,0.0,48.0,48.0
0.004,6,10,2006,5,927,1.0,659.0,659.0,5,1079,1.0,811.0,811.0
0.006,6,10,1547,5,764,1.0,496.0,496.0,5,783,1.0,515.0,515.0
0.005,6,10,2000,5,927,1.0,659.0,659.0,5,1073,1.0,805.0,805.0
309.451,17,20,1124,10,716,34369.0,48.0,43.0,10,408,34369.0,20.0,12.0
0.005,6,10,2006,5,927,1.0,659.0,659.0,5,1079,1.0,811.0,811.0
0.018,6,10,1972,5,910,4.0,642.0,642.0,5,1062,4.0,794.0,794.0
0.01,6,10,1989,5,910,2.0,642.0,642.0,5,1079,2.0,811.0,811.0
0.009,6,10,1983,5,910,2.0,642.0,642.0,5,1073,2.0,805.0,805.0
0.068,17,2,80,1,32,0.0,4.0,4.0,1,48,0.0,20.0,20.0
0.005,17,2,169,1,62,0.0,34.0,34.0,1,107,0.0,79.0,79.0
0.016,6,10,1990,5,911,4.0,643.0,643.0,5,1079,4.0,811.0,811.0
0.013,6,10,1677,5,827,3.0,559.0,559.0,5,850,3.0,582.0,582.0
240.081,6,21,4925,11,941,24008.0,180.0,93.0,10,3984,26675.0,1592.0,576.0
0.038,17,2,136,1,60,0.0,32.0,32.0,1,76,0.0,48.0,48.0
0.004,6,10,2000,5,927,1.0,659.0,659.0,5,1073,1.0,805.0,805.0
0.015,6,10,1989,5,910,3.0,642.0,642.0,5,1079,3.0,811.0,811.0
0.013,6,10,1972,5,910,3.0,642.0,642.0,5,1062,3.0,794.0,794.0
0.004,6,10,2006,5,927,1.0,659.0,659.0,5,1079,1.0,811.0,811.0
0.005,6,10,2006,5,927,1.0,659.0,659.0,5,1079,1.0,811.0,811.0
0.012,6,10,1989,5,910,2.0,642.0,642.0,5,1079,2.0,811.0,811.0
0.13,6,10,1506,5,395,30.0,127.0,127.0,5,1111,28.0,843.0,843.0
0.129,17,2,80,1,32,0.0,4.0,4.0,1,48,0.0,20.0,20.0
0.008,6,13,3735,7,497,1.0,125.0,125.0,6,3238,1.0,1470.0,1459.0
0.124,17,2,80,1,32,0.0,4.0,4.0,1,48,0.0,20.0,20.0
0.006,6,10,1689,5,839,1.0,571.0,571.0,5,850,1.0,582.0,582.0
0.073,6,10,1506,5,395,15.0,127.0,127.0,5,1111,16.0,843.0,843.0
0.073,6,10,1506,5,395,16.0,127.0,127.0,5,1111,16.0,843.0,843.0
0.002,17,2,180,1,66,0.0,38.0,38.0,1,114,0.0,86.0,86.0
0.006,17,2,144,1,64,0.0,36.0,36.0,1,80,0.0,52.0,52.0
15.071,17,15,9238,8,6902,2148.0,1350.0,834.0,7,2336,2507.0,1350.0,305.0
0.005,6,14,3742,8,504,0.0,80.0,80.0,6,3238,0.0,1470.0,1459.0
0.086,6,10,1506,5,395,19.0,127.0,127.0,5,1111,19.0,843.0,843.0
0.005,17,2,166,1,75,0.0,47.0,47.0,1,91,0.0,63.0,63.0
0.005,6,10,2006,5,927,1.0,659.0,659.0,5,1079,1.0,811.0,811.0
0.085,6,10,1506,5,395,19.0,127.0,127.0,5,1111,19.0,843.0,843.0
0.005,6,13,3747,7,509,0.0,137.0,137.0,6,3238,1.0,1470.0,1459.0
0.005,6,13,3747,7,509,0.0,137.0,137.0,6,3238,1.0,1470.0,1459.0
0.078,6,10,1506,5,395,17.0,127.0,127.0,5,1111,17.0,843.0,843.0
0.001,17,2,180,1,66,0.0,38.0,38.0,1,114,0.0,86.0,86.0
0.005,6,10,1774,5,923,1.0,655.0,655.0,5,851,1.0,583.0,583.0
0.163,17,2,152,1,76,0.0,48.0,48.0,1,76,0.0,48.0,48.0
0.005,17,2,169,1,62,0.0,34.0,34.0,1,107,0.0,79.0,79.0
0.141,6,10,1506,5,395,27.0,127.0,127.0,5,1111,32.0,843.0,843.0
0.043,17,2,148,1,60,0.0,32.0,32.0,1,88,0.0,60.0,60.0
0.108,6,10,1506,5,395,24.0,127.0,127.0,5,1111,26.0,843.0,843.0
0.009,6,12,1926,6,1189,1.0,659.0,434.0,6,737,1.0,417.0,417.0
0.005,6,10,2006,5,927,1.0,659.0,659.0,5,1079,1.0,811.0,811.0
40.074,17,10,676,5,460,10015.0,104.0,64.0,5,216,10017.0,20.0,15.0
1788.742,6,299,45128,124,25369,14541.0,2720.0,214.0,175,19759,10279.0,1360.0,151.0
241.639,6,401,348605,207,22285,1173.0,2736.0,960.0,194,326320,1252.0,2804.0,1718.0
1794.192,6,566,191575,289,164283,6229.0,2883.0,927.0,277,27292,6500.0,386.0,118.0
0.015,6,10,1677,5,827,3.0,559.0,559.0,5,850,3.0,582.0,582.0
300.016,6,12,1782,7,1348,50002.0,494.0,494.0,5,434,75003.0,83.0,83.0
0.08,6,10,1506,5,395,17.0,127.0,127.0,5,1111,18.0,843.0,843.0
0.007,6,10,1989,5,927,1.0,659.0,659.0,5,1062,1.0,794.0,794.0
40.053,17,10,676,5,460,10012.0,104.0,64.0,5,216,10010.0,20.0,15.0
177.463,17,80,11642,40,2690,4550.0,44.0,39.0,40,8952,4550.0,239.0,195.0
0.006,6,10,1547,5,764,1.0,496.0,496.0,5,783,1.0,515.0,515.0
0.064,6,10,1506,5,395,13.0,127.0,127.0,5,1111,15.0,843.0,843.0
0.173,17,2,152,1,76,0.0,48.0,48.0,1,76,0.0,48.0,48.0
0.005,6,10,1989,5,927,1.0,659.0,659.0,5,1062,1.0,794.0,794.0
40.062,17,10,676,5,460,10014.0,104.0,64.0,5,216,10014.0,20.0,15.0
0.005,6,14,3736,7,446,0.0,74.0,74.0,7,3290,0.0,1448.0,972.0
0.071,17,2,136,1,60,0.0,32.0,32.0,1,76,0.0,48.0,48.0
240.523,6,33,9300,16,1832,16032.0,620.0,198.0,17,7468,15030.0,2804.0,598.0
311.144,17,20,1124,10,716,34557.0,48.0,43.0,10,408,34557.0,20.0,12.0
0.062,6,10,1983,5,910,15.0,642.0,642.0,5,1073,15.0,805.0,805.0
0.005,17,2,144,1,64,0.0,36.0,36.0,1,80,0.0,52.0,52.0
0.005,6,10,1689,5,839,1.0,571.0,571.0,5,850,1.0,582.0,582.0
0.007,6,10,1989,5,927,1.0,659.0,659.0,5,1062,1.0,794.0,794.0
240.017,6,9,787,5,488,60004.0,232.0,232.0,4,299,80004.0,83.0,83.0
0.693,6,22,5072,11,1250,58.0,325.0,133.0,11,3822,58.0,1414.0,563.0
0.177,6,10,1506,5,395,42.0,127.0,127.0,5,1111,22.0,843.0,843.0
40.073,17,10,676,5,460,10013.0,104.0,64.0,5,216,10017.0,20.0,15.0
0.005,6,14,3736,7,446,0.0,74.0,74.0,7,3290,0.0,1448.0,972.0
1777.665,17,144,45504,72,22752,25037.0,288.0,288.0,72,22752,25037.0,288.0,288.0
0.011,6,10,1983,5,910,2.0,642.0,642.0,5,1073,2.0,805.0,805.0
0.112,6,10,1506,5,395,23.0,127.0,127.0,5,1111,24.0,843.0,843.0
0.004,17,4,284,2,120,0.0,32.0,32.0,2,164,0.0,60.0,54.0
0.014,6,10,1631,5,848,3.0,580.0,580.0,5,783,3.0,515.0,515.0
0.007,6,10,1689,5,839,1.0,571.0,571.0,5,850,1.0,582.0,582.0
0.117,6,10,1506,5,395,26.0,127.0,127.0,5,1111,25.0,843.0,843.0
0.011,6,10,1972,5,910,2.0,642.0,642.0,5,1062,2.0,794.0,794.0
1756.713,6,437,65747,254,35308,6943.0,613.0,197.0,183,30439,9651.0,453.0,146.0
0.005,6,10,2006,5,927,1.0,659.0,659.0,5,1079,1.0,811.0,811.0
173.191,17,80,11387,40,2671,4440.0,44.0,38.0,40,8716,4440.0,261.0,189.0
15.079,17,16,8765,8,6490,2150.0,1350.0,783.0,8,2275,2150.0,1350.0,256.0
0.011,6,10,1990,5,911,2.0,643.0,643.0,5,1079,2.0,811.0,811.0
0.004,6,10,1989,5,927,1.0,659.0,659.0,5,1062,1.0,794.0,794.0
0.101,6,10,1506,5,395,22.0,127.0,127.0,5,1111,18.0,843.0,843.0
0.018,6,10,1762,5,911,4.0,643.0,643.0,5,851,4.0,583.0,583.0
242.178,6,290,343163,115,17495,2124.0,2736.0,959.0,175,325668,1391.0,2930.0,1918.0
0.07,6,10,1506,5,395,15.0,127.0,127.0,5,1111,16.0,843.0,843.0
35.521,6,49,22442,25,16455,387.0,2720.0,1542.0,24,5987,1537.0,2667.0,385.0
0.001,17,2,166,1,75,0.0,47.0,47.0,1,91,0.0,63.0,63.0
0.287,6,10,1506,5,395,67.0,127.0,127.0,5,1111,22.0,843.0,843.0
240.011,6,9,787,5,488,60002.0,232.0,232.0,4,299,80002.0,83.0,83.0
0.069,17,8,3613,4,1874,23.0,1350.0,440.0,4,1739,12.0,1350.0,406.0
40.059,17,10,676,5,460,10012.0,104.0,64.0,5,216,10014.0,20.0,15.0
1781.138,6,86,4576,44,2340,41421.0,26.0,26.0,42,2236,43441.0,26.0,26.0
0.005,6,10,1643,5,860,1.0,592.0,592.0,5,783,1.0,515.0,515.0
0.013,6,7,695,4,448,4.0,232.0,232.0,3,247,5.0,83.0,83.0
0.005,6,10,2006,5,927,1.0,659.0,659.0,5,1079,1.0,811.0,811.0
0.037,6,10,1983,5,910,9.0,642.0,642.0,5,1073,9.0,805.0,805.0
0.004,6,10,2006,5,927,1.0,659.0,659.0,5,1079,1.0,811.0,811.0
300.085,6,19,4661,11,1102,30008.0,238.0,130.0,8,3559,42868.0,1402.0,786.0
0.001,17,2,180,1,66,0.0,38.0,38.0,1,114,0.0,86.0,86.0
0.005,6,10,1989,5,927,1.0,659.0,659.0,5,1062,1.0,794.0,794.0
0.005,17,2,164,1,74,0.0,46.0,46.0,1,90,0.0,62.0,62.0
0.079,6,10,1506,5,395,17.0,127.0,127.0,5,1111,17.0,843.0,843.0
0.001,17,2,174,1,72,0.0,44.0,44.0,1,102,0.0,74.0,74.0
0.005,6,10,1643,5,860,1.0,592.0,592.0,5,783,1.0,515.0,515.0
0.005,17,2,164,1,74,0.0,46.0,46.0,1,90,0.0,62.0,62.0
0.005,6,10,2006,5,927,1.0,659.0,659.0,5,1079,1.0,811.0,811.0
119.246,6,24,9399,11,1575,78.0,794.0,367.0,13,7824,9925.0,1360.0,810.0
0.004,17,2,136,1,60,0.0,32.0,32.0,1,76,0.0,48.0,48.0
0.001,17,2,180,1,66,0.0,38.0,38.0,1,114,0.0,86.0,86.0
0.004,6,10,1779,5,928,1.0,660.0,660.0,5,851,1.0,583.0,583.0
0.072,6,10,1506,5,395,16.0,127.0,127.0,5,1111,16.0,843.0,843.0
0.096,6,10,1506,5,395,21.0,127.0,127.0,5,1111,21.0,843.0,843.0
0.002,17,2,180,1,66,0.0,38.0,38.0,1,114,0.0,86.0,86.0
0.005,6,10,1779,5,928,1.0,660.0,660.0,5,851,1.0,583.0,583.0
300.379,6,16,2170,9,684,37526.0,146.0,146.0,7,1486,50025.0,419.0,398.0
366.889,6,22,2313,16,867,24459.0,195.0,195.0,6,1446,4638.0,419.0,398.0
0.067,6,10,1506,5,395,14.0,127.0,127.0,5,1111,14.0,843.0,843.0
0.019,6,10,1989,5,910,4.0,642.0,642.0,5,1079,4.0,811.0,811.0
0.096,6,10,1506,5,395,21.0,127.0,127.0,5,1111,21.0,843.0,843.0
0.005,6,10,1774,5,923,1.0,655.0,655.0,5,851,1.0,583.0,583.0
0.009,6,10,1990,5,911,2.0,643.0,643.0,5,1079,2.0,811.0,811.0
0.045,17,2,152,1,76,0.0,48.0,48.0,1,76,0.0,48.0,48.0
0.003,17,2,136,1,60,0.0,32.0,32.0,1,76,0.0,48.0,48.0
0.004,6,10,1774,5,923,1.0,655.0,655.0,5,851,0.0,583.0,583.0
0.001,17,2,180,1,66,0.0,38.0,38.0,1,114,0.0,86.0,86.0
0.121,6,10,1506,5,395,24.0,127.0,127.0,5,1111,25.0,843.0,843.0
0.041,17,2,136,1,60,0.0,32.0,32.0,1,76,0.0,48.0,48.0
40.079,17,10,676,5,460,10016.0,104.0,64.0,5,216,10018.0,20.0,15.0
0.005,6,10,2006,5,927,1.0,659.0,659.0,5,1079,1.0,811.0,811.0
0.005,6,10,2006,5,927,1.0,659.0,659.0,5,1079,1.0,811.0,811.0
0.008,6,10,1989,5,910,2.0,642.0,642.0,5,1079,1.0,811.0,811.0
0.005,6,10,2006,5,927,1.0,659.0,659.0,5,1079,1.0,811.0,811.0
0.039,17,2,148,1,60,0.0,32.0,32.0,1,88,0.0,60.0,60.0
0.005,17,2,213,1,69,0.0,41.0,41.0,1,144,0.0,116.0,116.0
0.005,6,10,2006,5,927,1.0,659.0,659.0,5,1079,1.0,811.0,811.0
0.005,17,2,144,1,64,0.0,36.0,36.0,1,80,0.0,52.0,52.0
308.519,17,19,1076,10,716,34269.0,48.0,43.0,9,360,38550.0,12.0,12.0
0.011,6,10,1983,5,910,2.0,642.0,642.0,5,1073,2.0,805.0,805.0
0.006,6,10,1547,5,764,1.0,496.0,496.0,5,783,1.0,515.0,515.0
0.008,6,10,1854,5,889,2.0,621.0,621.0,5,965,2.0,697.0,697.0
0.006,6,10,1689,5,839,1.0,571.0,571.0,5,850,1.0,582.0,582.0
0.005,6,10,2007,5,928,1.0,660.0,660.0,5,1079,1.0,811.0,811.0
0.014,6,10,1972,5,910,3.0,642.0,642.0,5,1062,3.0,794.0,794.0
0.008,6,10,1989,5,910,1.0,642.0,642.0,5,1079,2.0,811.0,811.0
0.008,6,12,1926,6,1189,1.0,659.0,434.0,6,737,1.0,417.0,417.0
0.115,6,10,1506,5,395,26.0,127.0,127.0,5,1111,27.0,843.0,843.0
0.011,6,10,1989,5,910,2.0,642.0,642.0,5,1079,2.0,811.0,811.0
0.078,6,10,1506,5,395,17.0,127.0,127.0,5,1111,19.0,843.0,843.0
0.001,17,2,179,1,62,0.0,34.0,34.0,1,117,0.0,89.0,89.0
0.005,6,10,1643,5,860,1.0,592.0,592.0,5,783,1.0,515.0,515.0
0.001,17,2,132,1,58,0.0,30.0,30.0,1,74,0.0,46.0,46.0
0.09,6,10,1506,5,395,21.0,127.0,127.0,5,1111,21.0,843.0,843.0
10.869,17,28,4422,14,1994,827.0,269.0,114.0,14,2428,826.0,587.0,145.0
0.11,6,10,1506,5,395,24.0,127.0,127.0,5,1111,24.0,843.0,843.0
0.142,6,10,1506,5,395,35.0,127.0,127.0,5,1111,31.0,843.0,843.0
308.388,17,20,1124,10,716,34251.0,48.0,43.0,10,408,34251.0,20.0,12.0
0.006,6,10,2000,5,927,1.0,659.0,659.0,5,1073,1.0,805.0,805.0
0.021,6,10,1983,5,910,5.0,642.0,642.0,5,1073,5.0,805.0,805.0
177.135,17,84,12044,42,2790,4320.0,44.0,38.0,42,9254,4320.0,239.0,192.0
0.005,6,14,3799,7,509,0.0,137.0,137.0,7,3290,0.0,1448.0,972.0
0.001,17,2,140,1,62,0.0,34.0,34.0,1,78,0.0,50.0,50.0
0.005,6,10,2007,5,928,1.0,660.0,660.0,5,1079,1.0,811.0,811.0
0.005,17,2,214,1,75,0.0,47.0,47.0,1,139,0.0,111.0,111.0
0.13,17,2,80,1,32,0.0,4.0,4.0,1,48,0.0,20.0,20.0
0.012,6,10,1677,5,827,3.0,559.0,559.0,5,850,2.0,582.0,582.0
0.006,6,10,1854,5,889,1.0,621.0,621.0,5,965,1.0,697.0,697.0
0.006,6,10,1689,5,839,1.0,571.0,571.0,5,850,1.0,582.0,582.0
0.004,17,4,420,2,122,0.0,33.0,33.0,2,298,1.0,145.0,121.0
0.004,6,10,1702,5,863,1.0,595.0,595.0,5,839,0.0,571.0,571.0
0.009,6,10,1989,5,910,2.0,642.0,642.0,5,1079,2.0,811.0,811.0
40.071,17,10,676,5,460,10015.0,104.0,64.0,5,216,10016.0,20.0,15.0
0.014,6,10,1983,5,910,3.0,642.0,642.0,5,1073,3.0,805.0,805.0
0.092,6,10,1506,5,395,20.0,127.0,127.0,5,1111,17.0,843.0,843.0
241.372,6,403,347849,207,22272,1171.0,2736.0,959.0,196,325577,1237.0,2804.0,1695.0
0.009,6,10,1972,5,910,2.0,642.0,642.0,5,1062,2.0,794.0,794.0
0.068,17,8,3613,4,1874,22.0,1350.0,440.0,4,1739,11.0,1350.0,406.0
0.009,6,10,1972,5,910,2.0,642.0,642.0,5,1062,2.0,794.0,794.0
0.01,6,10,1989,5,910,2.0,642.0,642.0,5,1079,2.0,811.0,811.0
0.006,6,10,1547,5,764,1.0,496.0,496.0,5,783,1.0,515.0,515.0
0.005,6,10,2007,5,928,1.0,660.0,660.0,5,1079,1.0,811.0,811.0
0.005,6,10,2007,5,928,1.0,660.0,660.0,5,1079,1.0,811.0,811.0
0.004,6,10,2000,5,927,1.0,659.0,659.0,5,1073,1.0,805.0,805.0
0.005,6,10,2006,5,927,1.0,659.0,659.0,5,1079,1.0,811.0,811.0
0.017,6,10,1631,5,848,4.0,580.0,580.0,5,783,4.0,515.0,515.0
240.012,6,9,787,5,488,60003.0,232.0,232.0,4,299,80003.0,83.0,83.0
0.074,6,10,1506,5,395,16.0,127.0,127.0,5,1111,16.0,843.0,843.0
0.006,6,14,3736,7,446,0.0,74.0,74.0,7,3290,0.0,1448.0,972.0
0.037,17,2,152,1,76,0.0,48.0,48.0,1,76,0.0,48.0,48.0
0.079,6,10,1506,5,395,17.0,127.0,127.0,5,1111,17.0,843.0,843.0
0.005,17,2,144,1,64,0.0,36.0,36.0,1,80,0.0,52.0,52.0
0.004,17,2,193,1,71,0.0,43.0,43.0,1,122,0.0,94.0,94.0
9.038,17,6,376,5,280,2259.0,28.0,28.0,1,96,0.0,68.0,68.0
0.006,6,10,1547,5,764,1.0,496.0,496.0,5,783,1.0,515.0,515.0
0.137,6,10,1506,5,395,29.0,127.0,127.0,5,1111,33.0,843.0,843.0
0.004,6,10,2007,5,928,1.0,660.0,660.0,5,1079,1.0,811.0,811.0
15.08,17,15,9239,8,6902,2149.0,1350.0,834.0,7,2337,2508.0,1350.0,305.0
0.005,17,2,154,1,69,0.0,41.0,41.0,1,85,0.0,57.0,57.0
0.003,17,2,148,1,60,0.0,32.0,32.0,1,88,0.0,60.0,60.0
0.092,6,10,1506,5,395,21.0,127.0,127.0,5,1111,20.0,843.0,843.0
0.006,6,10,1547,5,764,1.0,496.0,496.0,5,783,1.0,515.0,515.0
351.991,6,20,2210,6,1308,12003.0,494.0,494.0,14,902,27076.0,83.0,83.0
0.105,6,10,1506,5,395,24.0,127.0,127.0,5,1111,22.0,843.0,843.0
280.226,6,23,6075,10,1186,31136.0,267.0,156.0,13,4889,23351.0,1400.0,873.0
0.073,6,10,1506,5,395,16.0,127.0,127.0,5,1111,16.0,843.0,843.0
0.005,17,2,169,1,62,0.0,34.0,34.0,1,107,0.0,79.0,79.0
0.015,6,13,3735,7,497,2.0,125.0,125.0,6,3238,3.0,1470.0,1459.0
0.005,6,10,2006,5,927,1.0,659.0,659.0,5,1079,1.0,811.0,811.0
240.012,6,9,787,5,488,60003.0,232.0,232.0,4,299,80003.0,83.0,83.0
0.088,6,10,1506,5,395,18.0,127.0,127.0,5,1111,19.0,843.0,843.0
0.013,6,10,1989,5,910,3.0,642.0,642.0,5,1079,3.0,811.0,811.0
240.022,6,9,787,5,488,60005.0,232.0,232.0,4,299,80006.0,83.0,83.0
15.071,17,15,9238,8,6902,2149.0,1350.0,834.0,7,2336,2507.0,1350.0,305.0
0.008,6,10,1989,5,910,1.0,642.0,642.0,5,1079,2.0,811.0,811.0
0.298,17,4,596,2,122,146.0,33.0,33.0,2,474,257.0,323.0,209.0
0.075,6,10,1506,5,395,16.0,127.0,127.0,5,1111,15.0,843.0,843.0
0.071,6,10,1506,5,395,15.0,127.0,127.0,5,1111,14.0,843.0,843.0
0.004,17,2,179,1,71,0.0,43.0,43.0,1,108,0.0,80.0,80.0
0.066,17,8,3613,4,1874,22.0,1350.0,440.0,4,1739,11.0,1350.0,406.0
0.041,17,2,412,1,61,0.0,33.0,33.0,1,351,0.0,323.0,323.0
40.079,17,10,676,5,460,10018.0,104.0,64.0,5,216,10018.0,20.0,15.0
0.005,6,10,1989,5,927,1.0,659.0,659.0,5,1062,1.0,794.0,794.0
0.011,6,10,1989,5,910,2.0,642.0,642.0,5,1079,2.0,811.0,811.0
308.693,17,20,1124,10,716,34285.0,48.0,43.0,10,408,34285.0,20.0,12.0
434.689,6,29,4409,12,3102,10915.0,494.0,494.0,17,1307,27167.0,83.0,83.0
0.004,6,10,2007,5,928,1.0,660.0,660.0,5,1079,1.0,811.0,811.0
0.006,6,13,3690,7,452,0.0,80.0,80.0,6,3238,1.0,1470.0,1459.0
40.059,17,10,676,5,460,10013.0,104.0,64.0,5,216,10014.0,20.0,15.0
0.009,6,10,1990,5,911,2.0,643.0,643.0,5,1079,2.0,811.0,811.0
0.126,6,10,1506,5,395,29.0,127.0,127.0,5,1111,25.0,843.0,843.0
0.003,17,2,148,1,60,0.0,32.0,32.0,1,88,0.0,60.0,60.0
0.015,6,10,1631,5,848,3.0,580.0,580.0,5,783,3.0,515.0,515.0
0.009,6,10,1989,5,910,2.0,642.0,642.0,5,1079,2.0,811.0,811.0
0.005,17,2,166,1,75,0.0,47.0,47.0,1,91,0.0,63.0,63.0
0.033,17,2,152,1,76,0.0,48.0,48.0,1,76,0.0,48.0,48.0
0.02,6,10,1989,5,910,5.0,642.0,642.0,5,1079,4.0,811.0,811.0
240.268,6,41,8669,20,5634,12645.0,2883.0,573.0,21,3035,12013.0,580.0,241.0
0.002,17,2,180,1,66,0.0,38.0,38.0,1,114,0.0,86.0,86.0
0.006,6,10,2006,5,927,1.0,659.0,659.0,5,1079,1.0,811.0,811.0
0.005,6,10,1989,5,927,1.0,659.0,659.0,5,1062,1.0,794.0,794.0
0.005,6,10,1989,5,927,1.0,659.0,659.0,5,1062,1.0,794.0,794.0
0.01,6,12,1926,6,1189,1.0,659.0,434.0,6,737,2.0,417.0,417.0
10.789,17,28,4422,14,1994,821.0,269.0,114.0,14,2428,821.0,587.0,145.0
0.019,6,14,3787,7,497,3.0,125.0,125.0,7,3290,3.0,1448.0,972.0
0.004,17,2,148,1,60,0.0,32.0,32.0,1,88,0.0,60.0,60.0
0.004,17,2,148,1,60,0.0,32.0,32.0,1,88,0.0,60.0,60.0
317.095,17,138,20028,69,4638,4663.0,44.0,39.0,69,15390,4663.0,261.0,195.0
0.008,6,10,2000,5,927,2.0,659.0,659.0,5,1073,1.0,805.0,805.0
0.006,6,10,1854,5,889,1.0,621.0,621.0,5,965,1.0,697.0,697.0
0.012,6,10,1983,5,910,3.0,642.0,642.0,5,1073,3.0,805.0,805.0
1757.017,6,110,6530,60,3525,29779.0,27.0,27.0,50,3005,35856.0,27.0,27.0
0.004,17,4,284,2,120,0.0,32.0,32.0,2,164,1.0,60.0,54.0
176.163,17,78,11102,39,2592,4635.0,44.0,38.0,39,8510,4635.0,261.0,190.0
0.017,6,10,1989,5,910,4.0,642.0,642.0,5,1079,4.0,811.0,811.0
0.106,6,10,1506,5,395,24.0,127.0,127.0,5,1111,14.0,843.0,843.0
0.006,17,2,230,1,68,0.0,40.0,40.0,1,162,0.0,134.0,134.0
0.004,6,10,1702,5,863,1.0,595.0,595.0,5,839,0.0,571.0,571.0
0.006,6,10,1854,5,889,1.0,621.0,621.0,5,965,1.0,697.0,697.0
0.001,17,2,166,1,75,0.0,47.0,47.0,1,91,0.0,63.0,63.0
0.007,6,10,1547,5,764,1.0,496.0,496.0,5,783,1.0,515.0,515.0
0.015,6,10,1990,5,911,3.0,643.0,643.0,5,1079,3.0,811.0,811.0
0.01,6,10,1762,5,911,2.0,643.0,643.0,5,851,2.0,583.0,583.0
0.014,6,10,2006,5,927,3.0,659.0,659.0,5,1079,3.0,811.0,811.0
0.005,6,10,1643,5,860,1.0,592.0,592.0,5,783,1.0,515.0,515.0
0.004,6,10,1779,5,928,1.0,660.0,660.0,5,851,1.0,583.0,583.0
0.013,6,10,1989,5,910,3.0,642.0,642.0,5,1079,3.0,811.0,811.0
308.695,17,20,1124,10,716,34285.0,48.0,43.0,10,408,34285.0,20.0,12.0
0.013,6,10,1990,5,911,3.0,643.0,643.0,5,1079,3.0,811.0,811.0
0.015,6,10,1677,5,827,3.0,559.0,559.0,5,850,3.0,582.0,582.0
0.001,17,2,164,1,74,0.0,46.0,46.0,1,90,0.0,62.0,62.0
0.087,6,10,1506,5,395,19.0,127.0,127.0,5,1111,20.0,843.0,843.0
0.004,6,10,2007,5,928,1.0,660.0,660.0,5,1079,1.0,811.0,811.0
0.005,17,2,136,1,60,0.0,32.0,32.0,1,76,0.0,48.0,48.0
1778.025,17,144,45504,72,22752,25042.0,288.0,288.0,72,22752,25042.0,288.0,288.0
0.005,6,10,2006,5,927,1.0,659.0,659.0,5,1079,1.0,811.0,811.0
0.107,6,10,1506,5,395,23.0,127.0,127.0,5,1111,24.0,843.0,843.0
0.004,6,10,2000,5,927,1.0,659.0,659.0,5,1073,1.0,805.0,805.0
0.006,6,10,1547,5,764,1.0,496.0,496.0,5,783,1.0,515.0,515.0
0.007,6,10,1989,5,910,1.0,642.0,642.0,5,1079,1.0,811.0,811.0
0.004,6,10,1989,5,927,1.0,659.0,659.0,5,1062,1.0,794.0,794.0
0.006,6,10,2006,5,927,1.0,659.0,659.0,5,1079,1.0,811.0,811.0
1779.216,6,64,7361,42,4485,43395.0,1641.0,109.0,22,2876,84716.0,1112.0,82.0
0.005,6,10,1779,5,928,1.0,660.0,660.0,5,851,1.0,583.0,583.0
0.009,6,12,1926,6,1189,1.0,659.0,434.0,6,737,1.0,417.0,417.0
0.004,6,10,2007,5,928,1.0,660.0,660.0,5,1079,1.0,811.0,811.0
0.013,6,10,1983,5,910,3.0,642.0,642.0,5,1073,3.0,805.0,805.0
0.005,6,10,1989,5,927,1.0,659.0,659.0,5,1062,1.0,794.0,794.0
1756.131,6,105,6270,60,3525,29764.0,27.0,27.0,45,2745,39911.0,27.0,27.0
163.458,17,82,11683,41,2737,4086.0,44.0,38.0,41,8946,4086.0,239.0,190.0
0.072,6,10,1506,5,395,17.0,127.0,127.0,5,1111,13.0,843.0,843.0
282.038,6,25,8100,9,2024,35254.0,1496.0,780.0,16,6076,18801.0,2804.0,476.0
0.001,17,2,180,1,66,0.0,38.0,38.0,1,114,0.0,86.0,86.0
40.14,17,10,676,5,460,10034.0,104.0,64.0,5,216,10034.0,20.0,15.0
0.038,17,2,152,1,76,0.0,48.0,48.0,1,76,0.0,48.0,48.0
0.012,6,10,1631,5,848,2.0,580.0,580.0,5,783,3.0,515.0,515.0
0.004,6,10,2000,5,927,1.0,659.0,659.0,5,1073,1.0,805.0,805.0
0.005,6,10,1989,5,927,1.0,659.0,659.0,5,1062,1.0,794.0,794.0
0.016,6,10,1990,5,911,4.0,643.0,643.0,5,1079,3.0,811.0,811.0
0.004,6,10,2006,5,927,1.0,659.0,659.0,5,1079,1.0,811.0,811.0
1769.358,17,92,8096,46,4048,39318.0,60.0,60.0,46,4048,39318.0,60.0,60.0
66.168,6,30,17863,14,9592,5089.0,2804.0,1478.0,16,8271,4402.0,2310.0,743.0
0.005,17,2,170,1,65,0.0,37.0,37.0,1,105,0.0,77.0,77.0
709.105,6,39,14347,21,3503,35455.0,676.0,400.0,18,10844,38182.0,1402.0,900.0
121.912,6,22,7437,11,1305,107.0,530.0,277.0,11,6132,12175.0,2720.0,946.0
0.008,6,10,1972,5,910,2.0,642.0,642.0,5,1062,1.0,794.0,794.0
176.212,17,76,11088,38,2542,4762.0,44.0,38.0,38,8546,4762.0,252.0,196.0
0.081,6,10,1506,5,395,18.0,127.0,127.0,5,1111,19.0,843.0,843.0
0.006,6,10,1547,5,764,1.0,496.0,496.0,5,783,1.0,515.0,515.0
0.094,6,10,1506,5,395,22.0,127.0,127.0,5,1111,21.0,843.0,843.0
0.169,17,2,152,1,76,0.0,48.0,48.0,1,76,0.0,48.0,48.0
0.005,6,10,1989,5,927,1.0,659.0,659.0,5,1062,1.0,794.0,794.0
0.004,6,10,2000,5,927,1.0,659.0,659.0,5,1073,1.0,805.0,805.0
0.005,6,10,2007,5,928,1.0,660.0,660.0,5,1079,1.0,811.0,811.0
0.084,6,10,1506,5,395,19.0,127.0,127.0,5,1111,16.0,843.0,843.0
0.005,6,10,1689,5,839,1.0,571.0,571.0,5,850,1.0,582.0,582.0
0.005,17,2,168,1,76,0.0,48.0,48.0,1,92,0.0,64.0,64.0
0.005,6,10,1989,5,927,1.0,659.0,659.0,5,1062,1.0,794.0,794.0
0.009,6,10,1989,5,910,2.0,642.0,642.0,5,1079,2.0,811.0,811.0
0.004,17,2,136,1,60,0.0,32.0,32.0,1,76,0.0,48.0,48.0
0.005,6,10,1854,5,889,1.0,621.0,621.0,5,965,1.0,697.0,697.0
40.076,17,10,676,5,460,10017.0,104.0,64.0,5,216,10018.0,20.0,15.0
0.115,6,10,1506,5,395,20.0,127.0,127.0,5,1111,24.0,843.0,843.0
0.037,6,10,1762,5,911,9.0,643.0,643.0,5,851,9.0,583.0,583.0
0.014,6,10,2006,5,927,3.0,659.0,659.0,5,1079,3.0,811.0,811.0
0.017,17,2,198,1,91,0.0,63.0,63.0,1,107,0.0,79.0,79.0
0.086,6,10,1506,5,395,18.0,127.0,127.0,5,1111,20.0,843.0,843.0
0.016,6,10,1989,5,910,3.0,642.0,642.0,5,1079,3.0,811.0,811.0
0.071,6,10,1506,5,395,16.0,127.0,127.0,5,1111,15.0,843.0,843.0
0.073,6,10,1506,5,395,17.0,127.0,127.0,5,1111,15.0,843.0,843.0
0.007,6,10,2006,5,927,1.0,659.0,659.0,5,1079,1.0,811.0,811.0
0.092,6,10,1506,5,395,20.0,127.0,127.0,5,1111,20.0,843.0,843.0
166.197,17,76,10877,38,2543,4491.0,44.0,38.0,38,8334,4491.0,249.0,191.0
0.013,6,10,1677,5,827,3.0,559.0,559.0,5,850,3.0,582.0,582.0
308.314,17,20,1124,10,716,34247.0,48.0,43.0,10,408,34246.0,20.0,12.0
0.078,6,10,1506,5,395,13.0,127.0,127.0,5,1111,17.0,843.0,843.0
0.014,6,13,3735,7,497,2.0,125.0,125.0,6,3238,2.0,1470.0,1459.0
354.022,6,19,1691,15,978,25287.0,190.0,190.0,4,713,80002.0,497.0,497.0
0.013,6,10,1762,5,911,3.0,643.0,643.0,5,851,3.0,583.0,583.0
0.015,6,10,1762,5,911,3.0,643.0,643.0,5,851,3.0,583.0,583.0
0.005,6,11,2058,6,979,1.0,659.0,659.0,5,1079,1.0,811.0,811.0
0.169,17,2,152,1,76,0.0,48.0,48.0,1,76,0.0,48.0,48.0
240.022,6,9,787,5,488,60005.0,232.0,232.0,4,299,80006.0,83.0,83.0
0.013,6,10,1989,5,910,3.0,642.0,642.0,5,1079,3.0,811.0,811.0
0.004,6,10,1702,5,863,1.0,595.0,595.0,5,839,1.0,571.0,571.0
0.005,6,10,2006,5,927,1.0,659.0,659.0,5,1079,1.0,811.0,811.0
0.079,6,10,1506,5,395,18.0,127.0,127.0,5,1111,19.0,843.0,843.0
177.28,17,84,12142,42,2818,4323.0,44.0,39.0,42,9324,4323.0,239.0,194.0
0.083,6,10,1506,5,395,19.0,127.0,127.0,5,1111,19.0,843.0,843.0
0.009,6,10,1989,5,910,2.0,642.0,642.0,5,1079,2.0,811.0,811.0
0.006,6,10,1547,5,764,1.0,496.0,496.0,5,783,1.0,515.0,515.0
0.012,6,10,1983,5,910,3.0,642.0,642.0,5,1073,2.0,805.0,805.0
0.07,17,8,3613,4,1874,23.0,1350.0,440.0,4,1739,11.0,1350.0,406.0
0.007,6,10,1689,5,839,1.0,571.0,571.0,5,850,1.0,582.0,582.0
0.013,6,10,1983,5,910,3.0,642.0,642.0,5,1073,3.0,805.0,805.0
0.015,6,10,1762,5,911,3.0,643.0,643.0,5,851,3.0,583.0,583.0
0.006,6,10,1547,5,764,1.0,496.0,496.0,5,783,1.0,515.0,515.0
0.005,17,2,170,1,65,0.0,37.0,37.0,1,105,0.0,77.0,77.0
0.01,6,10,1983,5,910,2.0,642.0,642.0,5,1073,2.0,805.0,805.0
0.006,17,2,179,1,71,0.0,43.0,43.0,1,108,0.0,80.0,80.0
0.014,6,10,1762,5,911,3.0,643.0,643.0,5,851,3.0,583.0,583.0
0.016,6,10,1972,5,910,4.0,642.0,642.0,5,1062,4.0,794.0,794.0
0.023,6,10,1989,5,910,5.0,642.0,642.0,5,1079,5.0,811.0,811.0
0.019,6,10,1989,5,910,4.0,642.0,642.0,5,1079,4.0,811.0,811.0
0.016,6,10,1983,5,910,4.0,642.0,642.0,5,1073,4.0,805.0,805.0
0.012,6,10,1989,5,910,3.0,642.0,642.0,5,1079,3.0,811.0,811.0
0.004,17,2,164,1,74,0.0,46.0,46.0,1,90,0.0,62.0,62.0
0.001,17,2,136,1,60,0.0,32.0,32.0,1,76,0.0,48.0,48.0
0.006,6,10,1547,5,764,1.0,496.0,496.0,5,783,1.0,515.0,515.0
0.004,17,2,140,1,62,0.0,34.0,34.0,1,78,0.0,50.0,50.0
0.005,6,10,2006,5,927,1.0,659.0,659.0,5,1079,1.0,811.0,811.0
0.081,6,10,1506,5,395,18.0,127.0,127.0,5,1111,17.0,843.0,843.0
0.016,6,10,1983,5,910,3.0,642.0,642.0,5,1073,3.0,805.0,805.0
0.113,6,10,1506,5,395,23.0,127.0,127.0,5,1111,26.0,843.0,843.0
0.005,17,2,179,1,71,0.0,43.0,43.0,1,108,0.0,80.0,80.0
0.014,17,2,148,1,60,0.0,32.0,32.0,1,88,0.0,60.0,60.0
0.01,6,10,1989,5,910,2.0,642.0,642.0,5,1079,2.0,811.0,811.0
0.11,6,10,1506,5,395,24.0,127.0,127.0,5,1111,22.0,843.0,843.0
0.005,6,10,2006,5,927,1.0,659.0,659.0,5,1079,1.0,811.0,811.0
0.006,17,2,169,1,62,0.0,34.0,34.0,1,107,0.0,79.0,79.0
0.078,6,10,1506,5,395,17.0,127.0,127.0,5,1111,17.0,843.0,843.0
40.036,17,10,676,5,460,10008.0,104.0,64.0,5,216,10008.0,20.0,15.0
0.001,17,2,180,1,66,0.0,38.0,38.0,1,114,0.0,86.0,86.0
0.006,6,10,1547,5,764,1.0,496.0,496.0,5,783,1.0,515.0,515.0
1770.382,6,83,4370,42,2211,43179.0,27.0,27.0,41,2159,44258.0,27.0,27.0
0.094,6,10,1506,5,395,20.0,127.0,127.0,5,1111,22.0,843.0,843.0
0.154,17,2,142,1,63,0.0,35.0,35.0,1,79,0.0,51.0,51.0
0.005,6,10,1989,5,927,1.0,659.0,659.0,5,1062,1.0,794.0,794.0
0.067,6,10,1506,5,395,15.0,127.0,127.0,5,1111,14.0,843.0,843.0
171.326,17,74,10391,37,2465,4758.0,44.0,38.0,37,7926,4758.0,239.0,186.0
0.005,6,10,1643,5,860,1.0,592.0,592.0,5,783,1.0,515.0,515.0
0.006,6,10,1547,5,764,1.0,496.0,496.0,5,783,1.0,515.0,515.0
0.005,6,10,2000,5,927,1.0,659.0,659.0,5,1073,1.0,805.0,805.0
0.011,6,10,1989,5,910,2.0,642.0,642.0,5,1079,2.0,811.0,811.0
0.008,6,10,1983,5,910,1.0,642.0,642.0,5,1073,2.0,805.0,805.0
308.652,17,20,1124,10,716,34281.0,48.0,43.0,10,408,34281.0,20.0,12.0
0.001,17,2,180,1,66,0.0,38.0,38.0,1,114,0.0,86.0,86.0
0.011,6,10,1989,5,910,2.0,642.0,642.0,5,1079,2.0,811.0,811.0
0.04,17,2,144,1,64,0.0,36.0,36.0,1,80,0.0,52.0,52.0
0.013,6,10,1989,5,910,3.0,642.0,642.0,5,1079,3.0,811.0,811.0
0.001,17,2,180,1,66,0.0,38.0,38.0,1,114,0.0,86.0,86.0
0.07,6,10,1506,5,395,15.0,127.0,127.0,5,1111,15.0,843.0,843.0
1798.776,6,296,42939,122,25306,14864.0,2720.0,214.0,174,17633,10396.0,1360.0,130.0
0.005,17,2,160,1,72,0.0,44.0,44.0,1,88,0.0,60.0,60.0
0.006,6,10,1547,5,764,1.0,496.0,496.0,5,783,1.0,515.0,515.0
0.068,17,8,3613,4,1874,22.0,1350.0,440.0,4,1739,11.0,1350.0,406.0
0.217,6,16,2778,8,1396,31.0,533.0,324.0,8,1382,19.0,529.0,239.0
0.016,17,2,198,1,91,0.0,63.0,63.0,1,107,0.0,79.0,79.0
0.004,17,4,420,2,122,0.0,33.0,33.0,2,298,0.0,145.0,121.0
0.013,6,10,1983,5,910,3.0,642.0,642.0,5,1073,3.0,805.0,805.0
0.105,6,10,1506,5,395,24.0,127.0,127.0,5,1111,25.0,843.0,843.0
0.006,6,10,1547,5,764,1.0,496.0,496.0,5,783,1.0,515.0,515.0
0.007,17,2,179,1,71,0.0,43.0,43.0,1,108,0.0,80.0,80.0
0.004,6,10,2000,5,927,1.0,659.0,659.0,5,1073,1.0,805.0,805.0
0.01,6,10,1972,5,910,2.0,642.0,642.0,5,1062,2.0,794.0,794.0
0.011,6,10,1983,5,910,2.0,642.0,642.0,5,1073,2.0,805.0,805.0
0.072,17,2,412,1,61,0.0,33.0,33.0,1,351,0.0,323.0,323.0
0.086,6,10,1506,5,395,21.0,127.0,127.0,5,1111,18.0,843.0,843.0
0.005,6,10,1854,5,889,1.0,621.0,621.0,5,965,1.0,697.0,697.0
0.006,6,10,1547,5,764,1.0,496.0,496.0,5,783,1.0,515.0,515.0
0.008,6,10,1989,5,910,2.0,642.0,642.0,5,1079,2.0,811.0,811.0
15.147,17,15,9238,8,6902,2151.0,1350.0,834.0,7,2336,2516.0,1350.0,305.0
0.077,6,10,1506,5,395,16.0,127.0,127.0,5,1111,16.0,843.0,843.0
0.004,6,10,2007,5,928,1.0,660.0,660.0,5,1079,1.0,811.0,811.0
40.062,17,10,676,5,460,10012.0,104.0,64.0,5,216,10014.0,20.0,15.0
0.003,17,4,284,2,120,0.0,32.0,32.0,2,164,0.0,60.0,54.0
0.041,17,2,152,1,76,0.0,48.0,48.0,1,76,0.0,48.0,48.0
0.004,6,10,2006,5,927,1.0,659.0,659.0,5,1079,1.0,811.0,811.0
0.005,6,10,2007,5,928,1.0,660.0,660.0,5,1079,1.0,811.0,811.0
0.065,6,10,1506,5,395,14.0,127.0,127.0,5,1111,13.0,843.0,843.0
0.005,6,10,1989,5,927,1.0,659.0,659.0,5,1062,1.0,794.0,794.0
0.011,6,10,1972,5,910,2.0,642.0,642.0,5,1062,2.0,794.0,794.0
0.005,6,10,2006,5,927,1.0,659.0,659.0,5,1079,1.0,811.0,811.0
0.006,6,10,1547,5,764,1.0,496.0,496.0,5,783,1.0,515.0,515.0
0.152,6,10,1506,5,395,35.0,127.0,127.0,5,1111,34.0,843.0,843.0
0.047,6,10,1989,5,910,11.0,642.0,642.0,5,1079,11.0,811.0,811.0
0.042,6,10,1990,5,911,10.0,643.0,643.0,5,1079,10.0,811.0,811.0
0.005,6,10,2000,5,927,1.0,659.0,659.0,5,1073,1.0,805.0,805.0
0.008,6,10,1989,5,910,2.0,642.0,642.0,5,1079,2.0,811.0,811.0
0.014,6,10,1972,5,910,3.0,642.0,642.0,5,1062,3.0,794.0,794.0
0.006,6,12,1698,6,863,1.0,327.0,271.0,6,835,1.0,515.0,515.0
0.005,17,2,166,1,75,0.0,47.0,47.0,1,91,0.0,63.0,63.0
240.091,6,16,4481,9,963,30011.0,238.0,166.0,7,3518,40014.0,1402.0,786.0
0.004,17,2,136,1,60,0.0,32.0,32.0,1,76,0.0,48.0,48.0
0.011,6,10,1972,5,910,2.0,642.0,642.0,5,1062,2.0,794.0,794.0
0.004,17,2,136,1,60,0.0,32.0,32.0,1,76,0.0,48.0,48.0
293.563,6,375,347753,189,21383,1561.0,2736.0,888.0,186,326370,1586.0,2804.0,1841.0
0.005,6,10,1779,5,928,1.0,660.0,660.0,5,851,1.0,583.0,583.0
10.851,17,28,4418,14,1994,826.0,269.0,114.0,14,2424,826.0,587.0,145.0
0.006,17,2,225,1,65,0.0,37.0,37.0,1,160,0.0,132.0,132.0
0.006,6,10,1854,5,889,1.0,621.0,621.0,5,965,1.0,697.0,697.0
0.008,6,10,1989,5,910,1.0,642.0,642.0,5,1079,2.0,811.0,811.0
0.004,6,10,2006,5,927,1.0,659.0,659.0,5,1079,1.0,811.0,811.0
10.823,17,28,4422,14,1994,823.0,269.0,114.0,14,2428,823.0,587.0,145.0
0.019,6,10,1972,5,910,4.0,642.0,642.0,5,1062,4.0,794.0,794.0
15.083,17,16,8176,8,5959,2150.0,1350.0,716.0,8,2217,2150.0,1350.0,249.0
0.012,6,10,1989,5,910,3.0,642.0,642.0,5,1079,2.0,811.0,811.0
0.103,6,10,1506,5,395,22.0,127.0,127.0,5,1111,23.0,843.0,843.0
0.007,6,10,2007,5,928,1.0,660.0,660.0,5,1079,1.0,811.0,811.0
0.001,17,2,180,1,66,0.0,38.0,38.0,1,114,0.0,86.0,86.0
0.006,17,2,144,1,64,0.0,36.0,36.0,1,80,0.0,52.0,52.0
0.074,6,10,1506,5,395,16.0,127.0,127.0,5,1111,14.0,843.0,843.0
0.024,6,10,1989,5,910,5.0,642.0,642.0,5,1079,5.0,811.0,811.0
0.005,6,10,2006,5,927,1.0,659.0,659.0,5,1079,1.0,811.0,811.0
0.008,6,12,1926,6,1189,1.0,659.0,434.0,6,737,1.0,417.0,417.0
0.043,17,2,152,1,76,0.0,48.0,48.0,1,76,0.0,48.0,48.0
40.066,17,10,676,5,460,10015.0,104.0,64.0,5,216,10015.0,20.0,15.0
0.006,6,10,2007,5,928,1.0,660.0,660.0,5,1079,1.0,811.0,811.0
0.005,6,10,2007,5,928,1.0,660.0,660.0,5,1079,1.0,811.0,811.0
0.005,6,10,2007,5,928,1.0,660.0,660.0,5,1079,1.0,811.0,811.0
0.005,6,10,1989,5,927,1.0,659.0,659.0,5,1062,1.0,794.0,794.0
0.005,6,10,2006,5,927,1.0,659.0,659.0,5,1079,1.0,811.0,811.0
175.039,17,80,11646,40,2685,4488.0,44.0,39.0,40,8961,4488.0,239.0,196.0
0.005,6,10,1989,5,927,1.0,659.0,659.0,5,1062,1.0,794.0,794.0
0.001,17,2,136,1,60,0.0,32.0,32.0,1,76,0.0,48.0,48.0
0.144,6,10,1506,5,395,29.0,127.0,127.0,5,1111,33.0,843.0,843.0
0.005,17,4,495,2,132,0.0,38.0,38.0,2,363,2.0,176.0,153.0
0.104,6,10,1506,5,395,24.0,127.0,127.0,5,1111,22.0,843.0,843.0
0.017,6,10,1631,5,848,4.0,580.0,580.0,5,783,4.0,515.0,515.0
0.117,6,10,1506,5,395,27.0,127.0,127.0,5,1111,26.0,843.0,843.0
0.079,6,10,1506,5,395,17.0,127.0,127.0,5,1111,19.0,843.0,843.0
0.005,6,10,2006,5,927,1.0,659.0,659.0,5,1079,1.0,811.0,811.0
0.098,6,10,1506,5,395,22.0,127.0,127.0,5,1111,19.0,843.0,843.0
0.014,6,10,1972,5,910,3.0,642.0,642.0,5,1062,3.0,794.0,794.0
0.006,6,10,1689,5,839,1.0,571.0,571.0,5,850,1.0,582.0,582.0
0.005,6,10,1989,5,927,1.0,659.0,659.0,5,1062,1.0,794.0,794.0
0.01,6,10,1983,5,910,2.0,642.0,642.0,5,1073,2.0,805.0,805.0
0.015,6,13,3735,7,497,2.0,125.0,125.0,6,3238,3.0,1470.0,1459.0
0.005,6,10,1689,5,839,1.0,571.0,571.0,5,850,1.0,582.0,582.0
0.004,6,10,2006,5,927,1.0,659.0,659.0,5,1079,1.0,811.0,811.0
0.004,6,10,1989,5,927,1.0,659.0,659.0,5,1062,1.0,794.0,794.0
40.068,17,10,676,5,460,10014.0,104.0,64.0,5,216,10016.0,20.0,15.0
40.055,17,10,676,5,460,10012.0,104.0,64.0,5,216,10013.0,20.0,15.0
0.005,17,2,180,1,66,0.0,38.0,38.0,1,114,0.0,86.0,86.0
0.014,6,14,3787,7,497,2.0,125.0,125.0,7,3290,2.0,1448.0,972.0
0.001,17,2,136,1,60,0.0,32.0,32.0,1,76,0.0,48.0,48.0
0.018,6,10,1631,5,848,4.0,580.0,580.0,5,783,4.0,515.0,515.0
0.006,6,10,2007,5,928,1.0,660.0,660.0,5,1079,1.0,811.0,811.0
311.096,17,20,1124,10,716,34552.0,48.0,43.0,10,408,34552.0,20.0,12.0
0.072,17,4,284,2,120,0.0,32.0,32.0,2,164,67.0,60.0,54.0
177.472,17,84,11672,42,2807,4328.0,44.0,38.0,42,8865,4328.0,252.0,183.0
0.006,17,2,214,1,75,0.0,47.0,47.0,1,139,0.0,111.0,111.0
0.016,6,10,1989,5,910,4.0,642.0,642.0,5,1079,3.0,811.0,811.0
0.084,6,10,1506,5,395,19.0,127.0,127.0,5,1111,17.0,843.0,843.0
0.001,17,2,180,1,66,0.0,38.0,38.0,1,114,0.0,86.0,86.0
0.005,6,10,2006,5,927,1.0,659.0,659.0,5,1079,1.0,811.0,811.0
240.012,6,9,787,5,488,60003.0,232.0,232.0,4,299,80003.0,83.0,83.0
0.065,6,10,1506,5,395,14.0,127.0,127.0,5,1111,14.0,843.0,843.0
0.008,6,10,1972,5,910,2.0,642.0,642.0,5,1062,2.0,794.0,794.0
0.005,6,10,2007,5,928,1.0,660.0,660.0,5,1079,1.0,811.0,811.0
0.015,6,10,1990,5,911,3.0,643.0,643.0,5,1079,3.0,811.0,811.0
0.006,6,10,1547,5,764,1.0,496.0,496.0,5,783,1.0,515.0,515.0
0.004,17,2,136,1,60,0.0,32.0,32.0,1,76,0.0,48.0,48.0
40.065,17,10,676,5,460,10012.0,104.0,64.0,5,216,10015.0,20.0,15.0
0.184,6,10,1506,5,395,45.0,127.0,127.0,5,1111,45.0,843.0,843.0
0.008,6,10,1989,5,910,1.0,642.0,642.0,5,1079,1.0,811.0,811.0
0.183,6,43,11560,24,3283,7.0,1083.0,203.0,19,8277,9.0,1402.0,606.0
0.007,17,2,179,1,71,0.0,43.0,43.0,1,108,0.0,80.0,80.0
0.019,6,10,1631,5,848,4.0,580.0,580.0,5,783,4.0,515.0,515.0
0.004,6,10,2006,5,927,1.0,659.0,659.0,5,1079,1.0,811.0,811.0
0.006,6,10,1689,5,839,1.0,571.0,571.0,5,850,1.0,582.0,582.0
0.003,17,2,148,1,60,0.0,32.0,32.0,1,88,0.0,60.0,60.0
0.005,6,10,1989,5,927,1.0,659.0,659.0,5,1062,1.0,794.0,794.0
0.017,6,10,1989,5,910,4.0,642.0,642.0,5,1079,4.0,811.0,811.0
0.005,6,10,1989,5,927,1.0,659.0,659.0,5,1062,1.0,794.0,794.0
0.005,6,13,3747,7,509,0.0,137.0,137.0,6,3238,1.0,1470.0,1459.0
0.168,17,2,152,1,76,0.0,48.0,48.0,1,76,0.0,48.0,48.0
0.005,6,10,2007,5,928,1.0,660.0,660.0,5,1079,1.0,811.0,811.0
0.012,6,10,1989,5,910,3.0,642.0,642.0,5,1079,2.0,811.0,811.0
292.637,6,388,347242,198,21871,1485.0,2736.0,888.0,190,325371,1548.0,2804.0,1792.0
0.082,6,10,1506,5,395,18.0,127.0,127.0,5,1111,19.0,843.0,843.0
0.082,6,10,1506,5,395,16.0,127.0,127.0,5,1111,18.0,843.0,843.0
0.006,6,10,1689,5,839,1.0,571.0,571.0,5,850,1.0,582.0,582.0
0.015,6,10,1989,5,910,3.0,642.0,642.0,5,1079,3.0,811.0,811.0
0.01,6,10,1631,5,848,2.0,580.0,580.0,5,783,2.0,515.0,515.0
240.049,6,9,787,5,488,60012.0,232.0,232.0,4,299,80015.0,83.0,83.0
0.097,6,10,1506,5,395,22.0,127.0,127.0,5,1111,20.0,843.0,843.0
0.013,6,10,1989,5,910,3.0,642.0,642.0,5,1079,3.0,811.0,811.0
371.879,6,22,2313,16,867,24791.0,195.0,195.0,6,1446,4638.0,419.0,398.0
0.004,17,2,136,1,60,0.0,32.0,32.0,1,76,0.0,48.0,48.0
0.011,6,10,1972,5,910,2.0,642.0,642.0,5,1062,2.0,794.0,794.0
1770.799,6,135,6510,75,3585,23926.0,39.0,39.0,60,2925,30009.0,35.0,35.0
0.007,6,10,1547,5,764,1.0,496.0,496.0,5,783,1.0,515.0,515.0
0.006,6,10,2000,5,927,1.0,659.0,659.0,5,1073,1.0,805.0,805.0
10.737,17,28,4422,14,1994,817.0,269.0,114.0,14,2428,817.0,587.0,145.0
0.003,17,4,284,2,120,0.0,32.0,32.0,2,164,0.0,60.0,54.0
0.083,6,10,1506,5,395,20.0,127.0,127.0,5,1111,17.0,843.0,843.0
0.081,6,10,1506,5,395,19.0,127.0,127.0,5,1111,14.0,843.0,843.0
0.071,17,4,420,2,122,0.0,33.0,33.0,2,298,68.0,145.0,121.0
0.001,17,2,180,1,66,0.0,38.0,38.0,1,114,0.0,86.0,86.0
412.013,6,29,4409,12,3102,10912.0,494.0,494.0,17,1307,25750.0,83.0,83.0
300.78,6,37,9597,20,4119,15830.0,1543.0,657.0,17,5478,538.0,2667.0,435.0
0.041,17,2,152,1,76,0.0,48.0,48.0,1,76,0.0,48.0,48.0
0.092,6,10,1506,5,395,21.0,127.0,127.0,5,1111,21.0,843.0,843.0
0.006,6,10,1547,5,764,1.0,496.0,496.0,5,783,1.0,515.0,515.0
0.143,6,10,1506,5,395,29.0,127.0,127.0,5,1111,28.0,843.0,843.0
0.011,6,10,1989,5,910,2.0,642.0,642.0,5,1079,2.0,811.0,811.0
0.037,17,4,352,2,130,0.0,37.0,37.0,2,222,33.0,89.0,83.0
242.63,6,314,344166,134,18994,1824.0,2736.0,959.0,180,325172,1355.0,3542.0,1857.0
0.018,6,10,1989,5,910,4.0,642.0,642.0,5,1079,4.0,811.0,811.0
300.25,6,32,16281,17,7101,18765.0,2736.0,885.0,15,9180,21446.0,1908.0,1050.0
0.004,6,10,2007,5,928,1.0,660.0,660.0,5,1079,1.0,811.0,811.0
1799.573,17,2828,212910,1407,112604,1279.0,82.0,52.0,1421,100306,1265.0,226.0,42.0
0.008,17,2,164,1,74,0.0,46.0,46.0,1,90,0.0,62.0,62.0
0.021,6,10,1983,5,910,5.0,642.0,642.0,5,1073,5.0,805.0,805.0
0.006,6,10,1547,5,764,1.0,496.0,496.0,5,783,1.0,515.0,515.0
0.021,6,10,1677,5,827,5.0,559.0,559.0,5,850,5.0,582.0,582.0
0.004,17,2,152,1,76,0.0,48.0,48.0,1,76,0.0,48.0,48.0
0.112,6,10,1506,5,395,20.0,127.0,127.0,5,1111,26.0,843.0,843.0
0.013,6,10,1983,5,910,3.0,642.0,642.0,5,1073,3.0,805.0,805.0
312.898,17,20,1124,10,716,34752.0,48.0,43.0,10,408,34752.0,20.0,12.0
0.004,17,2,136,1,60,0.0,32.0,32.0,1,76,0.0,48.0,48.0
0.155,6,10,1506,5,395,36.0,127.0,127.0,5,1111,24.0,843.0,843.0
0.006,6,10,1774,5,923,1.0,655.0,655.0,5,851,1.0,583.0,583.0
0.013,6,10,1983,5,910,3.0,642.0,642.0,5,1073,3.0,805.0,805.0
0.012,17,2,154,1,69,0.0,41.0,41.0,1,85,0.0,57.0,57.0
0.072,17,2,148,1,60,0.0,32.0,32.0,1,88,0.0,60.0,60.0
352.505,6,20,2210,6,1308,12004.0,494.0,494.0,14,902,27115.0,83.0,83.0
0.014,6,10,1990,5,911,3.0,643.0,643.0,5,1079,3.0,811.0,811.0
0.009,6,10,1990,5,911,2.0,643.0,643.0,5,1079,2.0,811.0,811.0
0.01,6,10,1989,5,910,2.0,642.0,642.0,5,1079,2.0,811.0,811.0
0.004,6,10,2006,5,927,1.0,659.0,659.0,5,1079,1.0,811.0,811.0
0.011,6,10,1972,5,910,2.0,642.0,642.0,5,1062,2.0,794.0,794.0
0.005,6,10,2007,5,928,1.0,660.0,660.0,5,1079,1.0,811.0,811.0
366.192,6,22,2313,16,867,24412.0,195.0,195.0,6,1446,4638.0,419.0,398.0
0.003,6,10,1702,5,863,0.0,595.0,595.0,5,839,0.0,571.0,571.0
0.013,6,10,1983,5,910,3.0,642.0,642.0,5,1073,3.0,805.0,805.0
0.008,6,12,1698,6,863,1.0,327.0,271.0,6,835,1.0,515.0,515.0
0.003,17,2,148,1,60,0.0,32.0,32.0,1,88,0.0,60.0,60.0
0.129,6,10,1506,5,395,29.0,127.0,127.0,5,1111,23.0,843.0,843.0
0.004,6,10,1702,5,863,1.0,595.0,595.0,5,839,0.0,571.0,571.0
1777.938,17,144,45504,72,22752,25041.0,288.0,288.0,72,22752,25041.0,288.0,288.0
0.005,6,10,2007,5,928,1.0,660.0,660.0,5,1079,1.0,811.0,811.0
0.005,6,10,1547,5,764,1.0,496.0,496.0,5,783,1.0,515.0,515.0
0.091,6,10,1506,5,395,19.0,127.0,127.0,5,1111,20.0,843.0,843.0
0.096,6,10,1506,5,395,19.0,127.0,127.0,5,1111,20.0,843.0,843.0
0.005,17,2,170,1,65,0.0,37.0,37.0,1,105,0.0,77.0,77.0
0.003,17,2,148,1,60,0.0,32.0,32.0,1,88,0.0,60.0,60.0
0.005,6,10,1989,5,927,1.0,659.0,659.0,5,1062,1.0,794.0,794.0
0.005,6,10,1989,5,927,1.0,659.0,659.0,5,1062,1.0,794.0,794.0
176.395,17,74,10391,37,2465,4899.0,44.0,38.0,37,7926,4899.0,239.0,186.0
0.005,17,2,136,1,60,0.0,32.0,32.0,1,76,0.0,48.0,48.0
0.063,6,14,3868,7,578,10.0,206.0,206.0,7,3290,10.0,1448.0,972.0
0.005,6,10,1989,5,927,1.0,659.0,659.0,5,1062,1.0,794.0,794.0
0.005,6,10,1774,5,923,1.0,655.0,655.0,5,851,1.0,583.0,583.0
0.005,17,2,214,1,75,0.0,47.0,47.0,1,139,0.0,111.0,111.0
8.96,6,39,10487,20,4929,471.0,1360.0,682.0,19,5558,486.0,2667.0,435.0
360.026,6,21,3981,13,3142,30002.0,494.0,494.0,8,839,51431.0,83.0,83.0
0.004,6,10,2006,5,927,1.0,659.0,659.0,5,1079,1.0,811.0,811.0
0.067,6,10,1506,5,395,14.0,127.0,127.0,5,1111,14.0,843.0,843.0
0.004,6,10,2006,5,927,1.0,659.0,659.0,5,1079,1.0,811.0,811.0
0.022,6,10,1989,5,910,5.0,642.0,642.0,5,1079,5.0,811.0,811.0
0.072,17,2,136,1,60,0.0,32.0,32.0,1,76,0.0,48.0,48.0
0.005,6,13,3690,7,452,0.0,80.0,80.0,6,3238,1.0,1470.0,1459.0
0.005,6,10,2006,5,927,1.0,659.0,659.0,5,1079,1.0,811.0,811.0
0.006,17,2,212,1,74,0.0,46.0,46.0,1,138,0.0,110.0,110.0
0.005,6,10,1989,5,927,1.0,659.0,659.0,5,1062,1.0,794.0,794.0
10.973,17,28,4419,14,1994,835.0,269.0,114.0,14,2425,835.0,588.0,145.0
0.007,6,12,1698,6,863,1.0,327.0,271.0,6,835,1.0,515.0,515.0
0.005,17,2,169,1,62,0.0,34.0,34.0,1,107,0.0,79.0,79.0
0.01,6,10,1972,5,910,2.0,642.0,642.0,5,1062,2.0,794.0,794.0
0.009,6,10,1990,5,911,2.0,643.0,643.0,5,1079,2.0,811.0,811.0
0.004,6,10,2000,5,927,1.0,659.0,659.0,5,1073,1.0,805.0,805.0
0.001,17,2,179,1,62,0.0,34.0,34.0,1,117,0.0,89.0,89.0
0.005,6,10,1989,5,927,1.0,659.0,659.0,5,1062,1.0,794.0,794.0
0.005,6,10,2006,5,927,1.0,659.0,659.0,5,1079,1.0,811.0,811.0
0.006,6,10,2006,5,927,1.0,659.0,659.0,5,1079,1.0,811.0,811.0
0.011,6,10,1677,5,827,2.0,559.0,559.0,5,850,2.0,582.0,582.0
300.017,6,12,1782,7,1348,50002.0,494.0,494.0,5,434,75003.0,83.0,83.0
0.02,17,2,140,1,62,0.0,34.0,34.0,1,78,0.0,50.0,50.0
0.005,6,10,2000,5,927,1.0,659.0,659.0,5,1073,1.0,805.0,805.0
0.005,17,2,170,1,65,0.0,37.0,37.0,1,105,0.0,77.0,77.0
10.829,17,28,4419,14,1995,823.0,270.0,114.0,14,2424,824.0,587.0,145.0
0.04,17,2,136,1,60,0.0,32.0,32.0,1,76,0.0,48.0,48.0
0.003,17,2,148,1,60,0.0,32.0,32.0,1,88,0.0,60.0,60.0
0.006,6,10,1854,5,889,1.0,621.0,621.0,5,965,1.0,697.0,697.0
0.006,6,10,1854,5,889,1.0,621.0,621.0,5,965,1.0,697.0,697.0
0.005,6,10,1689,5,839,1.0,571.0,571.0,5,850,1.0,582.0,582.0
0.043,6,14,3868,7,578,7.0,206.0,206.0,7,3290,7.0,1448.0,972.0
0.039,17,2,170,1,65,0.0,37.0,37.0,1,105,0.0,77.0,77.0
0.005,6,10,2000,5,927,1.0,659.0,659.0,5,1073,1.0,805.0,805.0
0.038,17,4,284,2,120,0.0,32.0,32.0,2,164,35.0,60.0,54.0
0.005,6,10,1689,5,839,1.0,571.0,571.0,5,850,1.0,582.0,582.0
0.006,6,10,1689,5,839,1.0,571.0,571.0,5,850,1.0,582.0,582.0
0.017,6,10,1989,5,910,4.0,642.0,642.0,5,1079,4.0,811.0,811.0
0.011,6,10,1983,5,910,2.0,642.0,642.0,5,1073,2.0,805.0,805.0
0.006,17,2,230,1,68,0.0,40.0,40.0,1,162,0.0,134.0,134.0
0.011,6,10,1972,5,910,2.0,642.0,642.0,5,1062,2.0,794.0,794.0
0.017,6,10,1762,5,911,4.0,643.0,643.0,5,851,4.0,583.0,583.0
0.005,6,10,2007,5,928,1.0,660.0,660.0,5,1079,1.0,811.0,811.0
40.056,17,10,676,5,460,10011.0,104.0,64.0,5,216,10013.0,20.0,15.0
0.169,17,2,152,1,76,0.0,48.0,48.0,1,76,0.0,48.0,48.0
0.005,6,10,1779,5,928,1.0,660.0,660.0,5,851,1.0,583.0,583.0
0.106,6,10,1506,5,395,25.0,127.0,127.0,5,1111,24.0,843.0,843.0
0.005,6,14,3742,7,452,0.0,80.0,80.0,7,3290,0.0,1448.0,972.0
0.005,17,2,213,1,69,0.0,41.0,41.0,1,144,0.0,116.0,116.0
0.006,6,10,1547,5,764,1.0,496.0,496.0,5,783,1.0,515.0,515.0
0.067,17,8,3613,4,1874,22.0,1350.0,440.0,4,1739,10.0,1350.0,406.0
0.115,6,10,1506,5,395,26.0,127.0,127.0,5,1111,24.0,843.0,843.0
0.011,6,10,1989,5,910,2.0,642.0,642.0,5,1079,2.0,811.0,811.0
242.486,6,378,347273,179,20837,1362.0,2736.0,960.0,199,326436,1224.0,2804.0,1672.0
0.003,17,2,148,1,60,0.0,32.0,32.0,1,88,0.0,60.0,60.0
0.001,17,2,180,1,66,0.0,38.0,38.0,1,114,0.0,86.0,86.0
0.01,6,10,1990,5,911,2.0,643.0,643.0,5,1079,2.0,811.0,811.0
40.063,17,10,676,5,460,10013.0,104.0,64.0,5,216,10014.0,20.0,15.0
0.004,17,2,136,1,60,0.0,32.0,32.0,1,76,0.0,48.0,48.0
0.011,6,10,1983,5,910,2.0,642.0,642.0,5,1073,2.0,805.0,805.0
0.012,6,10,1972,5,910,2.0,642.0,642.0,5,1062,3.0,794.0,794.0
0.012,6,10,2006,5,927,2.0,659.0,659.0,5,1079,2.0,811.0,811.0
0.007,6,10,2006,5,927,1.0,659.0,659.0,5,1079,1.0,811.0,811.0
0.012,6,10,1677,5,827,3.0,559.0,559.0,5,850,2.0,582.0,582.0
0.005,6,10,2007,5,928,1.0,660.0,660.0,5,1079,1.0,811.0,811.0
15.076,17,15,9238,8,6902,2149.0,1350.0,834.0,7,2336,2507.0,1350.0,305.0
0.037,17,2,148,1,60,0.0,32.0,32.0,1,88,0.0,60.0,60.0
177.033,17,76,10710,38,2529,4784.0,44.0,38.0,38,8181,4784.0,239.0,187.0
0.035,6,10,1631,5,848,8.0,580.0,580.0,5,783,8.0,515.0,515.0
0.037,17,2,148,1,60,0.0,32.0,32.0,1,88,0.0,60.0,60.0
0.008,6,12,1926,6,1189,1.0,659.0,434.0,6,737,1.0,417.0,417.0
0.117,6,10,1506,5,395,27.0,127.0,127.0,5,1111,27.0,843.0,843.0
0.007,17,2,179,1,71,0.0,43.0,43.0,1,108,0.0,80.0,80.0
0.008,6,10,1990,5,911,1.0,643.0,643.0,5,1079,2.0,811.0,811.0
0.001,17,2,180,1,66,0.0,38.0,38.0,1,114,0.0,86.0,86.0
0.014,6,10,1989,5,910,3.0,642.0,642.0,5,1079,3.0,811.0,811.0
0.013,6,12,1926,6,1189,2.0,659.0,434.0,6,737,2.0,417.0,417.0
0.502,17,55,34552,31,28522,16.0,1350.0,892.0,24,6030,19.0,1350.0,223.0
325.455,17,20,1124,10,716,36153.0,48.0,43.0,10,408,36151.0,20.0,12.0
0.006,17,2,179,1,71,0.0,43.0,43.0,1,108,0.0,80.0,80.0
0.225,6,16,2669,8,1395,32.0,533.0,323.0,8,1274,20.0,529.0,212.0
40.058,17,10,676,5,460,10011.0,104.0,64.0,5,216,10013.0,20.0,15.0
0.014,6,10,1677,5,827,3.0,559.0,559.0,5,850,3.0,582.0,582.0
0.006,6,10,1854,5,889,1.0,621.0,621.0,5,965,1.0,697.0,697.0
0.004,6,10,2000,5,927,1.0,659.0,659.0,5,1073,1.0,805.0,805.0
0.086,17,2,148,1,60,0.0,32.0,32.0,1,88,0.0,60.0,60.0
0.106,6,10,1506,5,395,23.0,127.0,127.0,5,1111,23.0,843.0,843.0
0.008,6,12,1926,6,1189,1.0,659.0,434.0,6,737,1.0,417.0,417.0
369.571,6,22,2313,16,867,24638.0,195.0,195.0,6,1446,4652.0,419.0,398.0
0.008,6,10,1990,5,911,2.0,643.0,643.0,5,1079,2.0,811.0,811.0
0.009,6,10,1990,5,911,2.0,643.0,643.0,5,1079,2.0,811.0,811.0
0.132,6,10,1506,5,395,31.0,127.0,127.0,5,1111,27.0,843.0,843.0
0.107,6,10,1506,5,395,25.0,127.0,127.0,5,1111,22.0,843.0,843.0
0.014,6,10,1631,5,848,3.0,580.0,580.0,5,783,3.0,515.0,515.0
0.003,17,4,284,2,120,0.0,32.0,32.0,2,164,0.0,60.0,54.0
0.014,6,10,1972,5,910,3.0,642.0,642.0,5,1062,3.0,794.0,794.0
0.005,6,10,1779,5,928,1.0,660.0,660.0,5,851,1.0,583.0,583.0
0.017,6,10,1990,5,911,4.0,643.0,643.0,5,1079,4.0,811.0,811.0
0.004,6,10,1989,5,927,1.0,659.0,659.0,5,1062,1.0,794.0,794.0
10.945,17,32,6051,16,2510,722.0,270.0,128.0,16,3541,722.0,1143.0,193.0
40.061,17,10,676,5,460,10014.0,104.0,64.0,5,216,10014.0,20.0,15.0
0.006,6,10,1689,5,839,1.0,571.0,571.0,5,850,1.0,582.0,582.0
0.066,17,8,3613,4,1874,22.0,1350.0,440.0,4,1739,11.0,1350.0,406.0
0.1,6,10,1506,5,395,21.0,127.0,127.0,5,1111,20.0,843.0,843.0
1.076,6,30,12711,17,3312,67.0,1360.0,517.0,13,9399,75.0,2720.0,985.0
0.082,6,10,1506,5,395,15.0,127.0,127.0,5,1111,19.0,843.0,843.0
0.099,17,2,80,1,32,0.0,4.0,4.0,1,48,0.0,20.0,20.0
11.498,17,28,4400,14,2313,872.0,588.0,137.0,14,2087,872.0,270.0,121.0
175.023,17,70,9753,35,2329,5147.0,44.0,38.0,35,7424,5147.0,249.0,184.0
0.004,6,10,2006,5,927,1.0,659.0,659.0,5,1079,1.0,811.0,811.0
0.004,6,10,1779,5,928,1.0,660.0,660.0,5,851,1.0,583.0,583.0
0.003,17,2,136,1,60,0.0,32.0,32.0,1,76,0.0,48.0,48.0
0.006,17,2,178,1,81,0.0,53.0,53.0,1,97,0.0,69.0,69.0
0.009,17,2,144,1,64,0.0,36.0,36.0,1,80,0.0,52.0,52.0
300.186,6,39,9922,21,4404,15001.0,1360.0,588.0,18,5518,17648.0,2667.0,435.0
1787.445,6,150,19350,90,13740,20083.0,302.0,302.0,60,5610,30295.0,83.0,83.0
0.006,6,10,1854,5,889,1.0,621.0,621.0,5,965,1.0,697.0,697.0
519.794,6,35,12075,19,3490,28877.0,676.0,415.0,16,8585,30650.0,1402.0,860.0
0.021,6,10,1762,5,911,5.0,643.0,643.0,5,851,5.0,583.0,583.0
0.006,17,2,179,1,71,0.0,43.0,43.0,1,108,0.0,80.0,80.0
72.614,6,32,17967,15,9759,5186.0,2804.0,1497.0,17,8208,4530.0,2319.0,1219.0
0.075,6,10,1506,5,395,15.0,127.0,127.0,5,1111,16.0,843.0,843.0
0.004,6,10,1989,5,927,1.0,659.0,659.0,5,1062,1.0,794.0,794.0
0.005,17,2,213,1,69,0.0,41.0,41.0,1,144,0.0,116.0,116.0
0.093,6,10,1506,5,395,20.0,127.0,127.0,5,1111,22.0,843.0,843.0
0.071,6,10,1506,5,395,15.0,127.0,127.0,5,1111,16.0,843.0,843.0
0.006,6,10,1547,5,764,1.0,496.0,496.0,5,783,1.0,515.0,515.0
0.006,6,10,1547,5,764,1.0,496.0,496.0,5,783,1.0,515.0,515.0
0.006,17,2,152,1,68,0.0,40.0,40.0,1,84,0.0,56.0,56.0
0.003,17,2,162,1,65,0.0,37.0,37.0,1,97,0.0,69.0,69.0
0.06,17,2,80,1,32,0.0,4.0,4.0,1,48,0.0,20.0,20.0
0.005,17,2,164,1,74,0.0,46.0,46.0,1,90,0.0,62.0,62.0
240.48,6,37,9659,19,2175,13359.0,747.0,235.0,18,7484,14145.0,1402.0,595.0
0.001,17,2,179,1,62,0.0,34.0,34.0,1,117,0.0,89.0,89.0
0.158,6,10,1506,5,395,29.0,127.0,127.0,5,1111,37.0,843.0,843.0
0.004,6,10,2007,5,928,1.0,660.0,660.0,5,1079,1.0,811.0,811.0
0.004,17,2,148,1,60,0.0,32.0,32.0,1,88,0.0,60.0,60.0
0.072,6,10,1506,5,395,17.0,127.0,127.0,5,1111,16.0,843.0,843.0
0.005,17,2,180,1,66,0.0,38.0,38.0,1,114,0.0,86.0,86.0
0.013,17,2,164,1,74,0.0,46.0,46.0,1,90,0.0,62.0,62.0
361.841,6,21,1792,16,1030,24122.0,190.0,190.0,5,762,60009.0,461.0,247.0
34.29,6,24,7517,13,1385,2857.0,530.0,277.0,11,6132,3411.0,1823.0,946.0
0.006,6,10,1689,5,839,1.0,571.0,571.0,5,850,1.0,582.0,582.0
0.009,6,12,1926,6,1189,1.0,659.0,434.0,6,737,1.0,417.0,417.0
0.168,6,10,1506,5,395,37.0,127.0,127.0,5,1111,38.0,843.0,843.0
0.005,17,2,213,1,69,0.0,41.0,41.0,1,144,0.0,116.0,116.0
69.324,6,26,12024,15,5408,4951.0,2804.0,924.0,11,6616,6916.0,2111.0,1006.0
240.195,6,63,52902,32,3167,7748.0,1226.0,498.0,31,49735,8006.0,2804.0,1782.0
40.06,17,10,676,5,460,10014.0,104.0,64.0,5,216,10012.0,20.0,15.0
0.01,6,10,1972,5,910,2.0,642.0,642.0,5,1062,2.0,794.0,794.0
0.052,17,2,152,1,76,0.0,48.0,48.0,1,76,0.0,48.0,48.0
0.006,6,10,1854,5,889,1.0,621.0,621.0,5,965,1.0,697.0,697.0
0.016,6,10,1983,5,910,4.0,642.0,642.0,5,1073,3.0,805.0,805.0
354.035,6,21,1795,16,1030,23602.0,190.0,190.0,5,765,60006.0,464.0,248.0
0.007,6,10,1547,5,764,1.0,496.0,496.0,5,783,1.0,515.0,515.0
0.015,6,10,1972,5,910,3.0,642.0,642.0,5,1062,3.0,794.0,794.0
0.004,17,2,148,1,60,0.0,32.0,32.0,1,88,0.0,60.0,60.0
0.021,6,10,1989,5,910,5.0,642.0,642.0,5,1079,5.0,811.0,811.0
0.015,6,10,1983,5,910,3.0,642.0,642.0,5,1073,3.0,805.0,805.0
0.004,6,10,1702,5,863,1.0,595.0,595.0,5,839,0.0,571.0,571.0
0.001,17,2,164,1,74,0.0,46.0,46.0,1,90,0.0,62.0,62.0
0.006,6,10,1547,5,764,1.0,496.0,496.0,5,783,1.0,515.0,515.0
0.253,6,16,2889,8,1507,36.0,533.0,361.0,8,1382,23.0,529.0,239.0
40.057,17,10,676,5,460,10013.0,104.0,64.0,5,216,10007.0,20.0,15.0
0.009,6,10,1972,5,910,2.0,642.0,642.0,5,1062,2.0,794.0,794.0
0.006,6,10,1689,5,839,1.0,571.0,571.0,5,850,1.0,582.0,582.0
0.005,6,13,3747,7,509,0.0,137.0,137.0,6,3238,1.0,1470.0,1459.0
0.113,6,10,1506,5,395,24.0,127.0,127.0,5,1111,26.0,843.0,843.0
0.043,17,2,412,1,61,0.0,33.0,33.0,1,351,0.0,323.0,323.0
0.008,6,12,1926,6,1189,1.0,659.0,434.0,6,737,1.0,417.0,417.0
0.014,6,10,1983,5,910,3.0,642.0,642.0,5,1073,3.0,805.0,805.0
0.001,17,2,180,1,66,0.0,38.0,38.0,1,114,0.0,86.0,86.0
0.04,17,2,170,1,65,0.0,37.0,37.0,1,105,0.0,77.0,77.0
0.004,6,10,2006,5,927,1.0,659.0,659.0,5,1079,1.0,811.0,811.0
0.025,6,10,1990,5,911,6.0,643.0,643.0,5,1079,6.0,811.0,811.0
0.005,17,2,166,1,75,0.0,47.0,47.0,1,91,0.0,63.0,63.0
0.005,6,10,1989,5,927,1.0,659.0,659.0,5,1062,1.0,794.0,794.0
9.036,17,6,376,5,280,2259.0,28.0,28.0,1,96,0.0,68.0,68.0
1778.273,17,142,41232,72,22752,25045.0,288.0,288.0,70,18480,25771.0,236.0,236.0
371.475,6,22,2313,16,867,24765.0,195.0,195.0,6,1446,4642.0,419.0,398.0
0.092,6,10,1506,5,395,20.0,127.0,127.0,5,1111,20.0,843.0,843.0
0.001,17,2,180,1,65,0.0,37.0,37.0,1,115,0.0,87.0,87.0
0.002,17,2,142,1,63,0.0,35.0,35.0,1,79,0.0,51.0,51.0
0.004,17,2,148,1,60,0.0,32.0,32.0,1,88,0.0,60.0,60.0
0.014,6,10,1972,5,910,3.0,642.0,642.0,5,1062,3.0,794.0,794.0
0.005,6,10,1989,5,927,1.0,659.0,659.0,5,1062,1.0,794.0,794.0
361.774,6,21,1793,16,1030,24118.0,190.0,190.0,5,763,60009.0,462.0,247.0
0.005,6,10,1989,5,927,1.0,659.0,659.0,5,1062,1.0,794.0,794.0
240.463,6,28,4473,15,2405,17175.0,598.0,232.0,13,2068,20038.0,580.0,197.0
0.004,6,10,2006,5,927,1.0,659.0,659.0,5,1079,1.0,811.0,811.0
0.094,6,10,1506,5,395,20.0,127.0,127.0,5,1111,21.0,843.0,843.0
0.022,6,10,1989,5,910,5.0,642.0,642.0,5,1079,5.0,811.0,811.0
0.005,6,10,2007,5,928,1.0,660.0,660.0,5,1079,1.0,811.0,811.0
0.038,17,2,152,1,76,0.0,48.0,48.0,1,76,0.0,48.0,48.0
0.004,6,10,2006,5,927,1.0,659.0,659.0,5,1079,1.0,811.0,811.0
11.173,17,28,4420,14,1993,847.0,268.0,114.0,14,2427,847.0,586.0,145.0
0.004,6,10,1774,5,923,1.0,655.0,655.0,5,851,1.0,583.0,583.0
0.005,6,13,3747,7,509,0.0,137.0,137.0,6,3238,0.0,1470.0,1459.0
0.006,6,12,1698,6,863,1.0,327.0,271.0,6,835,1.0,515.0,515.0
1756.386,6,109,6478,60,3525,29768.0,27.0,27.0,49,2953,36590.0,27.0,27.0
0.006,6,10,1854,5,889,1.0,621.0,621.0,5,965,1.0,697.0,697.0
0.005,17,2,179,1,71,0.0,43.0,43.0,1,108,0.0,80.0,80.0
0.006,6,10,1689,5,839,1.0,571.0,571.0,5,850,1.0,582.0,582.0
0.004,17,2,148,1,60,0.0,32.0,32.0,1,88,0.0,60.0,60.0
0.004,17,2,164,1,74,0.0,46.0,46.0,1,90,0.0,62.0,62.0
0.015,6,10,1972,5,910,3.0,642.0,642.0,5,1062,3.0,794.0,794.0
0.004,6,10,2006,5,927,1.0,659.0,659.0,5,1079,1.0,811.0,811.0
0.135,17,2,80,1,32,0.0,4.0,4.0,1,48,0.0,20.0,20.0
0.01,6,10,1983,5,910,2.0,642.0,642.0,5,1073,2.0,805.0,805.0
0.009,6,10,1989,5,910,2.0,642.0,642.0,5,1079,2.0,811.0,811.0
0.005,6,10,2000,5,927,1.0,659.0,659.0,5,1073,1.0,805.0,805.0
0.005,17,2,168,1,76,0.0,48.0,48.0,1,92,0.0,64.0,64.0
0.007,6,10,1689,5,839,1.0,571.0,571.0,5,850,1.0,582.0,582.0
306.189,6,16,1151,5,488,76547.0,232.0,232.0,11,663,30618.0,83.0,83.0
0.006,6,13,3747,7,509,0.0,137.0,137.0,6,3238,1.0,1470.0,1459.0
0.003,17,2,136,1,60,0.0,32.0,32.0,1,76,0.0,48.0,48.0
0.02,6,13,3735,7,497,3.0,125.0,125.0,6,3238,4.0,1470.0,1459.0
0.025,6,10,1989,5,910,6.0,642.0,642.0,5,1079,6.0,811.0,811.0
0.003,17,2,136,1,60,0.0,32.0,32.0,1,76,0.0,48.0,48.0
10.779,17,28,4420,14,1993,820.0,268.0,114.0,14,2427,820.0,586.0,145.0
0.005,6,10,2006,5,927,1.0,659.0,659.0,5,1079,1.0,811.0,811.0
40.078,17,10,676,5,460,10018.0,104.0,64.0,5,216,10018.0,20.0,15.0
0.004,6,10,2006,5,927,1.0,659.0,659.0,5,1079,1.0,811.0,811.0
0.012,6,10,1990,5,911,3.0,643.0,643.0,5,1079,2.0,811.0,811.0
0.044,6,10,1989,5,910,11.0,642.0,642.0,5,1079,11.0,811.0,811.0
0.012,6,10,1972,5,910,3.0,642.0,642.0,5,1062,2.0,794.0,794.0
125.974,6,14,2938,8,2504,17962.0,1414.0,1086.0,6,434,25147.0,182.0,182.0
0.206,6,16,2777,8,1395,29.0,533.0,323.0,8,1382,18.0,529.0,239.0
0.09,6,10,1506,5,395,19.0,127.0,127.0,5,1111,19.0,843.0,843.0
0.015,6,10,1762,5,911,3.0,643.0,643.0,5,851,3.0,583.0,583.0
0.011,6,10,1990,5,911,2.0,643.0,643.0,5,1079,2.0,811.0,811.0
0.006,6,10,1547,5,764,1.0,496.0,496.0,5,783,1.0,515.0,515.0
0.006,6,10,1547,5,764,1.0,496.0,496.0,5,783,1.0,515.0,515.0
0.09,6,10,1506,5,395,20.0,127.0,127.0,5,1111,19.0,843.0,843.0
240.326,6,30,11769,15,5765,17166.0,1368.0,829.0,15,6004,17165.0,1656.0,745.0
0.116,6,10,1506,5,395,27.0,127.0,127.0,5,1111,22.0,843.0,843.0
0.013,6,10,1990,5,911,3.0,643.0,643.0,5,1079,3.0,811.0,811.0
15.072,17,14,9190,8,6902,2149.0,1350.0,834.0,6,2288,3008.0,1350.0,353.0
0.019,6,10,1677,5,827,4.0,559.0,559.0,5,850,4.0,582.0,582.0
0.013,6,10,1631,5,848,3.0,580.0,580.0,5,783,3.0,515.0,515.0
0.008,6,13,3735,7,497,1.0,125.0,125.0,6,3238,1.0,1470.0,1459.0
0.005,17,2,164,1,74,0.0,46.0,46.0,1,90,0.0,62.0,62.0
0.013,6,10,1989,5,910,3.0,642.0,642.0,5,1079,3.0,811.0,811.0
300.371,6,16,2170,9,684,37525.0,146.0,146.0,7,1486,50034.0,419.0,398.0
40.07,17,10,676,5,460,10014.0,104.0,64.0,5,216,10016.0,20.0,15.0
0.004,17,4,284,2,120,0.0,32.0,32.0,2,164,0.0,60.0,54.0
166.253,17,76,10744,38,2530,4493.0,44.0,38.0,38,8214,4493.0,261.0,188.0
0.014,6,10,1762,5,911,3.0,643.0,643.0,5,851,3.0,583.0,583.0
0.008,6,10,1854,5,889,2.0,621.0,621.0,5,965,2.0,697.0,697.0
0.005,6,14,3742,7,452,0.0,80.0,80.0,7,3290,0.0,1448.0,972.0
0.005,6,13,3747,7,509,0.0,137.0,137.0,6,3238,0.0,1470.0,1459.0
0.004,6,10,1702,5,863,1.0,595.0,595.0,5,839,1.0,571.0,571.0
15.082,17,14,9190,8,6902,2149.0,1350.0,834.0,6,2288,3009.0,1350.0,353.0
0.038,17,2,184,1,61,0.0,33.0,33.0,1,123,0.0,95.0,95.0
10.81,17,28,4419,14,1994,823.0,269.0,114.0,14,2425,823.0,588.0,145.0
0.006,6,10,2006,5,927,1.0,659.0,659.0,5,1079,1.0,811.0,811.0
0.018,6,14,3787,7,497,3.0,125.0,125.0,7,3290,2.0,1448.0,972.0
0.005,6,10,1989,5,927,1.0,659.0,659.0,5,1062,1.0,794.0,794.0
0.005,6,10,1989,5,927,1.0,659.0,659.0,5,1062,1.0,794.0,794.0
0.005,6,10,1989,5,927,1.0,659.0,659.0,5,1062,1.0,794.0,794.0
0.006,6,10,1689,5,839,1.0,571.0,571.0,5,850,1.0,582.0,582.0
0.005,6,10,1643,5,860,1.0,592.0,592.0,5,783,1.0,515.0,515.0
1749.392,6,64,7358,42,4484,42668.0,1640.0,109.0,22,2874,83294.0,1110.0,82.0
240.315,6,44,8823,23,5790,10922.0,1515.0,509.0,21,3033,12015.0,580.0,241.0
0.015,6,10,1989,5,910,3.0,642.0,642.0,5,1079,3.0,811.0,811.0
0.005,6,10,2000,5,927,1.0,659.0,659.0,5,1073,1.0,805.0,805.0
0.006,6,10,1643,5,860,1.0,592.0,592.0,5,783,1.0,515.0,515.0
40.068,17,10,676,5,460,10014.0,104.0,64.0,5,216,10015.0,20.0,15.0
40.064,17,10,676,5,460,10015.0,104.0,64.0,5,216,10015.0,20.0,15.0
0.011,17,2,230,1,68,0.0,40.0,40.0,1,162,0.0,134.0,134.0
0.005,6,10,2000,5,927,1.0,659.0,659.0,5,1073,1.0,805.0,805.0
0.004,17,2,136,1,60,0.0,32.0,32.0,1,76,0.0,48.0,48.0
0.08,6,10,1506,5,395,18.0,127.0,127.0,5,1111,17.0,843.0,843.0
0.009,6,10,1983,5,910,2.0,642.0,642.0,5,1073,2.0,805.0,805.0
0.01,6,10,1972,5,910,2.0,642.0,642.0,5,1062,2.0,794.0,794.0
0.004,6,10,2007,5,928,1.0,660.0,660.0,5,1079,1.0,811.0,811.0
0.005,6,10,2006,5,927,1.0,659.0,659.0,5,1079,1.0,811.0,811.0
0.013,6,10,1983,5,910,3.0,642.0,642.0,5,1073,3.0,805.0,805.0
0.013,6,10,1677,5,827,3.0,559.0,559.0,5,850,3.0,582.0,582.0
0.006,6,10,1547,5,764,1.0,496.0,496.0,5,783,1.0,515.0,515.0
0.006,17,2,179,1,71,0.0,43.0,43.0,1,108,0.0,80.0,80.0
309.792,17,20,1124,10,716,34407.0,48.0,43.0,10,408,34407.0,20.0,12.0
0.005,6,10,1643,5,860,1.0,592.0,592.0,5,783,1.0,515.0,515.0
0.004,17,2,148,1,60,0.0,32.0,32.0,1,88,0.0,60.0,60.0
0.041,17,4,596,2,122,0.0,33.0,33.0,2,474,1.0,323.0,209.0
0.005,6,10,2006,5,927,1.0,659.0,659.0,5,1079,1.0,811.0,811.0
0.003,17,2,234,1,61,0.0,33.0,33.0,1,173,0.0,145.0,145.0
0.004,6,10,1702,5,863,1.0,595.0,595.0,5,839,0.0,571.0,571.0
0.061,6,13,3913,7,495,10.0,123.0,123.0,6,3418,12.0,1650.0,1549.0
0.013,6,10,1983,5,910,3.0,642.0,642.0,5,1073,3.0,805.0,805.0
0.005,6,10,2000,5,927,1.0,659.0,659.0,5,1073,1.0,805.0,805.0
0.005,6,10,2006,5,927,1.0,659.0,659.0,5,1079,1.0,811.0,811.0
0.003,17,2,148,1,60,0.0,32.0,32.0,1,88,0.0,60.0,60.0
308.543,17,19,1084,10,716,34258.0,48.0,43.0,9,368,38548.0,20.0,12.0
0.004,6,10,1774,5,923,1.0,655.0,655.0,5,851,1.0,583.0,583.0
0.005,17,2,148,1,60,0.0,32.0,32.0,1,88,0.0,60.0,60.0
308.363,17,20,1124,10,716,34249.0,48.0,43.0,10,408,34248.0,20.0,12.0
0.006,6,10,1547,5,764,1.0,496.0,496.0,5,783,1.0,515.0,515.0
0.008,6,10,1989,5,910,2.0,642.0,642.0,5,1079,2.0,811.0,811.0
0.118,6,10,1506,5,395,26.0,127.0,127.0,5,1111,28.0,843.0,843.0
300.373,6,16,2170,9,684,37526.0,146.0,146.0,7,1486,50035.0,419.0,398.0
0.005,6,10,1779,5,928,1.0,660.0,660.0,5,851,1.0,583.0,583.0
0.038,17,2,152,1,76,0.0,48.0,48.0,1,76,0.0,48.0,48.0
40.058,17,10,676,5,460,10013.0,104.0,64.0,5,216,10013.0,20.0,15.0
10.825,17,28,4419,14,1993,824.0,268.0,114.0,14,2426,824.0,585.0,145.0
0.009,6,10,1972,5,910,2.0,642.0,642.0,5,1062,2.0,794.0,794.0
0.003,17,2,170,1,65,0.0,37.0,37.0,1,105,0.0,77.0,77.0
0.078,6,10,1506,5,395,16.0,127.0,127.0,5,1111,17.0,843.0,843.0
0.095,6,10,1506,5,395,22.0,127.0,127.0,5,1111,19.0,843.0,843.0
0.04,17,4,284,2,120,1.0,32.0,32.0,2,164,2.0,60.0,54.0
0.005,6,10,2006,5,927,1.0,659.0,659.0,5,1079,1.0,811.0,811.0
0.135,6,10,1506,5,395,28.0,127.0,127.0,5,1111,31.0,843.0,843.0
0.006,17,2,214,1,75,0.0,47.0,47.0,1,139,0.0,111.0,111.0
0.005,6,10,1643,5,860,1.0,592.0,592.0,5,783,1.0,515.0,515.0
0.005,6,10,2006,5,927,1.0,659.0,659.0,5,1079,1.0,811.0,811.0
0.118,6,10,1506,5,395,28.0,127.0,127.0,5,1111,24.0,843.0,843.0
0.005,6,10,2007,5,928,1.0,660.0,660.0,5,1079,1.0,811.0,811.0
0.005,17,2,170,1,65,0.0,37.0,37.0,1,105,0.0,77.0,77.0
40.105,17,10,676,5,460,10019.0,104.0,64.0,5,216,10025.0,20.0,15.0
0.074,17,4,284,2,120,0.0,32.0,32.0,2,164,33.0,60.0,54.0
0.012,6,10,1983,5,910,3.0,642.0,642.0,5,1073,3.0,805.0,805.0
0.007,6,10,1689,5,839,1.0,571.0,571.0,5,850,1.0,582.0,582.0
0.012,6,10,1972,5,910,3.0,642.0,642.0,5,1062,2.0,794.0,794.0
0.014,6,10,1972,5,910,3.0,642.0,642.0,5,1062,3.0,794.0,794.0
0.009,6,10,1972,5,910,2.0,642.0,642.0,5,1062,2.0,794.0,794.0
0.105,6,10,1506,5,395,24.0,127.0,127.0,5,1111,24.0,843.0,843.0
41.342,6,52,22604,26,16537,367.0,2720.0,1405.0,26,6067,1647.0,2667.0,385.0
0.09,6,10,1506,5,395,20.0,127.0,127.0,5,1111,21.0,843.0,843.0
0.004,17,2,136,1,60,0.0,32.0,32.0,1,76,0.0,48.0,48.0
0.005,6,13,3747,7,509,0.0,137.0,137.0,6,3238,0.0,1470.0,1459.0
10.95,17,28,4422,14,1993,833.0,268.0,114.0,14,2429,833.0,588.0,145.0
0.017,6,10,1983,5,910,4.0,642.0,642.0,5,1073,4.0,805.0,805.0
0.074,6,10,1506,5,395,16.0,127.0,127.0,5,1111,17.0,843.0,843.0
0.018,6,10,1989,5,910,4.0,642.0,642.0,5,1079,4.0,811.0,811.0
0.021,6,13,3735,7,497,3.0,125.0,125.0,6,3238,4.0,1470.0,1459.0
0.005,6,10,1989,5,927,1.0,659.0,659.0,5,1062,1.0,794.0,794.0
0.006,6,10,2006,5,927,1.0,659.0,659.0,5,1079,1.0,811.0,811.0
10.723,17,28,4421,14,1993,816.0,268.0,114.0,14,2428,816.0,587.0,145.0
0.008,17,2,179,1,71,0.0,43.0,43.0,1,108,0.0,80.0,80.0
0.077,6,10,1506,5,395,14.0,127.0,127.0,5,1111,16.0,843.0,843.0
0.006,6,10,1547,5,764,1.0,496.0,496.0,5,783,1.0,515.0,515.0
40.061,17,10,676,5,460,10014.0,104.0,64.0,5,216,10014.0,20.0,15.0
40.06,17,10,676,5,460,10014.0,104.0,64.0,5,216,10014.0,20.0,15.0
0.004,6,10,1774,5,923,1.0,655.0,655.0,5,851,1.0,583.0,583.0
240.114,6,31,9524,15,7040,17151.0,2166.0,696.0,16,2484,16007.0,580.0,205.0
0.003,17,2,136,1,60,0.0,32.0,32.0,1,76,0.0,48.0,48.0
1778.836,17,143,41496,72,22752,25053.0,288.0,288.0,71,18744,25411.0,236.0,236.0
0.06,17,2,152,1,76,0.0,48.0,48.0,1,76,0.0,48.0,48.0
0.004,6,10,2006,5,927,1.0,659.0,659.0,5,1079,1.0,811.0,811.0
0.011,6,10,1989,5,910,2.0,642.0,642.0,5,1079,2.0,811.0,811.0
0.016,6,10,1990,5,911,4.0,643.0,643.0,5,1079,4.0,811.0,811.0
0.064,6,10,1506,5,395,15.0,127.0,127.0,5,1111,12.0,843.0,843.0
0.108,6,10,1506,5,395,26.0,127.0,127.0,5,1111,24.0,843.0,843.0
0.013,17,2,152,1,56,0.0,28.0,28.0,1,96,0.0,68.0,68.0
0.006,17,2,214,1,75,0.0,47.0,47.0,1,139,0.0,111.0,111.0
0.085,6,10,1506,5,395,19.0,127.0,127.0,5,1111,20.0,843.0,843.0
0.006,17,2,142,1,63,0.0,35.0,35.0,1,79,0.0,51.0,51.0
0.013,6,10,1972,5,910,3.0,642.0,642.0,5,1062,3.0,794.0,794.0
0.005,6,10,2006,5,927,1.0,659.0,659.0,5,1079,1.0,811.0,811.0
30.84,6,17,6879,9,689,3855.0,209.0,209.0,8,6190,4404.0,1402.0,1153.0
0.094,6,10,1506,5,395,20.0,127.0,127.0,5,1111,20.0,843.0,843.0
0.005,6,10,2006,5,927,1.0,659.0,659.0,5,1079,1.0,811.0,811.0
0.012,6,10,1972,5,910,2.0,642.0,642.0,5,1062,2.0,794.0,794.0
0.109,6,10,1506,5,395,22.0,127.0,127.0,5,1111,21.0,843.0,843.0
0.005,6,10,2006,5,927,1.0,659.0,659.0,5,1079,1.0,811.0,811.0
0.006,6,10,1643,5,860,1.0,592.0,592.0,5,783,1.0,515.0,515.0
264.353,17,18,1008,9,640,33028.0,48.0,43.0,9,368,33028.0,20.0,12.0
0.07,6,10,1506,5,395,16.0,127.0,127.0,5,1111,14.0,843.0,843.0
0.005,17,2,154,1,69,0.0,41.0,41.0,1,85,0.0,57.0,57.0
0.004,6,10,2006,5,927,1.0,659.0,659.0,5,1079,1.0,811.0,811.0
0.005,6,10,2006,5,927,1.0,659.0,659.0,5,1079,1.0,811.0,811.0
0.001,17,2,180,1,66,0.0,38.0,38.0,1,114,0.0,86.0,86.0
0.005,6,10,1989,5,927,1.0,659.0,659.0,5,1062,1.0,794.0,794.0
0.005,17,2,180,1,66,0.0,38.0,38.0,1,114,0.0,86.0,86.0
40.078,17,10,676,5,460,10018.0,104.0,64.0,5,216,10018.0,20.0,15.0
0.094,6,10,1506,5,395,19.0,127.0,127.0,5,1111,18.0,843.0,843.0
0.005,6,10,2006,5,927,1.0,659.0,659.0,5,1079,1.0,811.0,811.0
0.013,6,10,1631,5,848,3.0,580.0,580.0,5,783,3.0,515.0,515.0
0.131,17,2,80,1,32,0.0,4.0,4.0,1,48,0.0,20.0,20.0
0.006,6,10,1547,5,764,1.0,496.0,496.0,5,783,1.0,515.0,515.0
0.011,6,10,1989,5,910,2.0,642.0,642.0,5,1079,2.0,811.0,811.0
0.089,6,10,1506,5,395,19.0,127.0,127.0,5,1111,20.0,843.0,843.0
0.01,6,10,1989,5,910,2.0,642.0,642.0,5,1079,2.0,811.0,811.0
0.004,17,4,284,2,120,1.0,32.0,32.0,2,164,0.0,60.0,54.0
10.731,17,28,4422,14,1995,817.0,270.0,114.0,14,2427,816.0,586.0,145.0
0.004,6,10,2006,5,927,1.0,659.0,659.0,5,1079,1.0,811.0,811.0
0.117,6,10,1506,5,395,26.0,127.0,127.0,5,1111,25.0,843.0,843.0
0.004,6,10,2006,5,927,1.0,659.0,659.0,5,1079,1.0,811.0,811.0
0.017,6,10,1989,5,910,4.0,642.0,642.0,5,1079,4.0,811.0,811.0
0.016,6,10,1989,5,910,4.0,642.0,642.0,5,1079,3.0,811.0,811.0
0.085,6,10,1506,5,395,19.0,127.0,127.0,5,1111,20.0,843.0,843.0
0.084,6,10,1506,5,395,19.0,127.0,127.0,5,1111,17.0,843.0,843.0
0.113,6,10,1506,5,395,25.0,127.0,127.0,5,1111,23.0,843.0,843.0
0.005,6,10,2006,5,927,1.0,659.0,659.0,5,1079,1.0,811.0,811.0
0.007,6,10,2006,5,927,1.0,659.0,659.0,5,1079,1.0,811.0,811.0
0.101,6,10,1506,5,395,21.0,127.0,127.0,5,1111,21.0,843.0,843.0
0.069,17,8,3613,4,1874,23.0,1350.0,440.0,4,1739,11.0,1350.0,406.0
40.058,17,10,676,5,460,10013.0,104.0,64.0,5,216,10013.0,20.0,15.0
0.008,17,2,307,1,61,0.0,33.0,33.0,1,246,0.0,218.0,218.0
0.018,6,10,1972,5,910,4.0,642.0,642.0,5,1062,4.0,794.0,794.0
40.069,17,10,676,5,460,10016.0,104.0,64.0,5,216,10016.0,20.0,15.0
0.011,6,10,1989,5,910,2.0,642.0,642.0,5,1079,2.0,811.0,811.0
0.006,6,10,1547,5,764,1.0,496.0,496.0,5,783,1.0,515.0,515.0
0.004,17,2,164,1,74,0.0,46.0,46.0,1,90,0.0,62.0,62.0
0.009,6,10,1677,5,827,2.0,559.0,559.0,5,850,2.0,582.0,582.0
0.087,6,10,1506,5,395,20.0,127.0,127.0,5,1111,14.0,843.0,843.0
0.012,6,10,1972,5,910,3.0,642.0,642.0,5,1062,3.0,794.0,794.0
0.011,6,10,1989,5,910,2.0,642.0,642.0,5,1079,2.0,811.0,811.0
0.011,6,10,1989,5,910,2.0,642.0,642.0,5,1079,2.0,811.0,811.0
0.082,6,10,1506,5,395,17.0,127.0,127.0,5,1111,17.0,843.0,843.0
0.009,6,10,1983,5,910,2.0,642.0,642.0,5,1073,2.0,805.0,805.0
0.013,6,13,3735,7,497,2.0,125.0,125.0,6,3238,2.0,1470.0,1459.0
0.005,6,10,1989,5,927,1.0,659.0,659.0,5,1062,1.0,794.0,794.0
0.006,6,10,1547,5,764,1.0,496.0,496.0,5,783,1.0,515.0,515.0
0.005,6,13,3747,7,509,0.0,137.0,137.0,6,3238,0.0,1470.0,1459.0
0.081,6,10,1506,5,395,19.0,127.0,127.0,5,1111,19.0,843.0,843.0
0.005,17,2,144,1,64,0.0,36.0,36.0,1,80,0.0,52.0,52.0
0.083,6,10,1506,5,395,19.0,127.0,127.0,5,1111,17.0,843.0,843.0
0.005,6,10,1854,5,889,1.0,621.0,621.0,5,965,1.0,697.0,697.0
300.47,6,16,2170,9,684,37538.0,146.0,146.0,7,1486,50051.0,419.0,398.0
0.011,6,10,1989,5,910,2.0,642.0,642.0,5,1079,2.0,811.0,811.0
0.005,6,10,2006,5,927,1.0,659.0,659.0,5,1079,1.0,811.0,811.0
0.008,6,10,1972,5,910,1.0,642.0,642.0,5,1062,1.0,794.0,794.0
10.736,17,28,4421,14,1994,817.0,269.0,114.0,14,2427,817.0,586.0,145.0
0.005,6,10,2007,5,928,1.0,660.0,660.0,5,1079,1.0,811.0,811.0
0.005,17,2,179,1,71,0.0,43.0,43.0,1,108,0.0,80.0,80.0
0.005,17,2,166,1,75,0.0,47.0,47.0,1,91,0.0,63.0,63.0
0.009,6,10,1989,5,910,2.0,642.0,642.0,5,1079,2.0,811.0,811.0
0.017,6,20,9974,11,704,1.0,124.0,124.0,9,9270,2.0,2896.0,1758.0
0.006,6,10,1854,5,889,1.0,621.0,621.0,5,965,1.0,697.0,697.0
0.006,6,10,1547,5,764,1.0,496.0,496.0,5,783,1.0,515.0,515.0
300.095,6,23,5014,12,2421,27280.0,1026.0,447.0,11,2593,30009.0,1162.0,405.0
0.051,6,10,1506,5,395,11.0,127.0,127.0,5,1111,11.0,843.0,843.0
356.592,6,21,1795,16,1030,23772.0,190.0,190.0,5,765,60004.0,464.0,248.0
0.006,17,2,230,1,68,0.0,40.0,40.0,1,162,0.0,134.0,134.0
0.005,6,10,2000,5,927,1.0,659.0,659.0,5,1073,1.0,805.0,805.0
1798.569,17,2981,227793,1482,120051,1214.0,84.0,53.0,1499,107742,1200.0,227.0,43.0
0.005,17,2,179,1,71,0.0,43.0,43.0,1,108,0.0,80.0,80.0
0.118,6,10,1506,5,395,23.0,127.0,127.0,5,1111,23.0,843.0,843.0
0.005,6,10,1989,5,927,1.0,659.0,659.0,5,1062,1.0,794.0,794.0
0.006,6,10,1643,5,860,1.0,592.0,592.0,5,783,1.0,515.0,515.0
0.008,6,10,1989,5,910,2.0,642.0,642.0,5,1079,2.0,811.0,811.0
0.01,17,4,284,2,120,0.0,32.0,32.0,2,164,0.0,60.0,54.0
0.004,6,10,2006,5,927,1.0,659.0,659.0,5,1079,1.0,811.0,811.0
174.079,17,82,11576,41,2736,4351.0,44.0,38.0,41,8840,4351.0,260.0,187.0
174.359,17,86,12251,43,2868,4151.0,44.0,38.0,43,9383,4151.0,239.0,190.0
0.04,17,4,284,2,120,0.0,32.0,32.0,2,164,36.0,60.0,54.0
0.081,6,10,1506,5,395,18.0,127.0,127.0,5,1111,19.0,843.0,843.0
0.126,17,4,284,2,120,0.0,32.0,32.0,2,164,123.0,60.0,54.0
0.004,6,10,1702,5,863,1.0,595.0,595.0,5,839,0.0,571.0,571.0
0.005,17,2,140,1,62,0.0,34.0,34.0,1,78,0.0,50.0,50.0
0.004,6,10,2007,5,928,1.0,660.0,660.0,5,1079,1.0,811.0,811.0
0.081,6,10,1506,5,395,18.0,127.0,127.0,5,1111,17.0,843.0,843.0
0.005,6,10,2000,5,927,1.0,659.0,659.0,5,1073,1.0,805.0,805.0
40.061,17,10,676,5,460,10012.0,104.0,64.0,5,216,10014.0,20.0,15.0
0.101,6,10,1506,5,395,24.0,127.0,127.0,5,1111,23.0,843.0,843.0
0.005,17,2,194,1,59,0.0,31.0,31.0,1,135,0.0,107.0,107.0
40.083,17,10,676,5,460,10019.0,104.0,64.0,5,216,10009.0,20.0,15.0
40.054,17,10,676,5,460,10012.0,104.0,64.0,5,216,10012.0,20.0,15.0
0.006,17,2,170,1,65,0.0,37.0,37.0,1,105,0.0,77.0,77.0
0.074,6,10,1506,5,395,17.0,127.0,127.0,5,1111,17.0,843.0,843.0
0.011,6,10,1972,5,910,2.0,642.0,642.0,5,1062,2.0,794.0,794.0
0.111,17,2,194,1,59,0.0,31.0,31.0,1,135,0.0,107.0,107.0
1771.846,6,107,6374,60,3525,30030.0,27.0,27.0,47,2849,38517.0,27.0,27.0
40.063,17,10,676,5,460,10014.0,104.0,64.0,5,216,10014.0,20.0,15.0
0.004,6,10,1702,5,863,1.0,595.0,595.0,5,839,0.0,571.0,571.0
0.011,6,10,1990,5,911,2.0,643.0,643.0,5,1079,2.0,811.0,811.0
0.028,6,10,1990,5,911,6.0,643.0,643.0,5,1079,7.0,811.0,811.0
0.005,17,2,162,1,73,0.0,45.0,45.0,1,89,0.0,61.0,61.0
0.009,6,12,1926,6,1189,1.0,659.0,434.0,6,737,1.0,417.0,417.0
0.067,6,10,1506,5,395,14.0,127.0,127.0,5,1111,14.0,843.0,843.0
0.016,6,10,1983,5,910,3.0,642.0,642.0,5,1073,4.0,805.0,805.0
0.116,6,10,1506,5,395,27.0,127.0,127.0,5,1111,27.0,843.0,843.0
240.831,6,171,148391,99,8011,2457.0,923.0,475.0,72,140380,3391.0,3698.0,2039.0
0.011,6,10,1983,5,910,2.0,642.0,642.0,5,1073,2.0,805.0,805.0
0.005,17,2,170,1,65,0.0,37.0,37.0,1,105,0.0,77.0,77.0
0.004,6,10,2000,5,927,1.0,659.0,659.0,5,1073,1.0,805.0,805.0
0.006,6,10,1547,5,764,1.0,496.0,496.0,5,783,1.0,515.0,515.0
0.073,6,10,1506,5,395,17.0,127.0,127.0,5,1111,15.0,843.0,843.0
0.003,6,10,1702,5,863,0.0,595.0,595.0,5,839,0.0,571.0,571.0
0.004,17,4,284,2,120,0.0,32.0,32.0,2,164,0.0,60.0,54.0
0.089,6,10,1506,5,395,20.0,127.0,127.0,5,1111,19.0,843.0,843.0
0.004,6,10,2007,5,928,1.0,660.0,660.0,5,1079,1.0,811.0,811.0
0.005,6,10,1989,5,927,1.0,659.0,659.0,5,1062,1.0,794.0,794.0
0.128,6,10,1506,5,395,30.0,127.0,127.0,5,1111,26.0,843.0,843.0
0.088,6,10,1506,5,395,20.0,127.0,127.0,5,1111,18.0,843.0,843.0
0.004,6,10,1989,5,927,1.0,659.0,659.0,5,1062,1.0,794.0,794.0
0.07,6,10,1506,5,395,16.0,127.0,127.0,5,1111,15.0,843.0,843.0
0.1,6,10,1506,5,395,22.0,127.0,127.0,5,1111,21.0,843.0,843.0
0.003,17,2,160,1,72,0.0,44.0,44.0,1,88,0.0,60.0,60.0
0.017,6,10,1631,5,848,4.0,580.0,580.0,5,783,4.0,515.0,515.0
0.005,17,2,230,1,68,0.0,40.0,40.0,1,162,0.0,134.0,134.0
0.048,6,10,1989,5,910,11.0,642.0,642.0,5,1079,12.0,811.0,811.0
0.097,6,10,1506,5,395,23.0,127.0,127.0,5,1111,22.0,843.0,843.0
15.077,17,16,9302,8,6912,2149.0,1350.0,836.0,8,2390,2149.0,1350.0,270.0
300.755,6,28,9139,17,1632,18797.0,370.0,182.0,11,7507,24070.0,2804.0,989.0
292.376,6,389,348408,201,22018,1461.0,2736.0,889.0,188,326390,1563.0,4171.0,1830.0
0.006,17,2,144,1,64,0.0,36.0,36.0,1,80,0.0,52.0,52.0
1790.345,6,84,5221,42,2256,43666.0,36.0,36.0,42,2965,43665.0,432.0,390.0
40.073,17,10,676,5,460,10015.0,104.0,64.0,5,216,10017.0,20.0,15.0
0.039,17,2,186,1,61,0.0,33.0,33.0,1,125,0.0,97.0,97.0
0.005,6,10,1989,5,927,1.0,659.0,659.0,5,1062,1.0,794.0,794.0
0.005,17,2,170,1,65,0.0,37.0,37.0,1,105,0.0,77.0,77.0
0.001,17,2,136,1,60,0.0,32.0,32.0,1,76,0.0,48.0,48.0
0.012,6,10,1990,5,911,3.0,643.0,643.0,5,1079,3.0,811.0,811.0
0.039,6,10,1989,5,910,9.0,642.0,642.0,5,1079,9.0,811.0,811.0
0.173,6,3,453,2,321,173.0,241.0,241.0,1,132,0.0,92.0,92.0
0.005,6,13,3747,7,509,0.0,137.0,137.0,6,3238,1.0,1470.0,1459.0
0.001,17,2,136,1,60,0.0,32.0,32.0,1,76,0.0,48.0,48.0
0.072,17,2,412,1,61,0.0,33.0,33.0,1,351,0.0,323.0,323.0
0.072,6,10,1506,5,395,15.0,127.0,127.0,5,1111,16.0,843.0,843.0
240.031,6,9,787,5,488,60007.0,232.0,232.0,4,299,80007.0,83.0,83.0
0.005,6,10,2007,5,928,1.0,660.0,660.0,5,1079,1.0,811.0,811.0
300.024,6,12,1782,7,1348,50004.0,494.0,494.0,5,434,75005.0,83.0,83.0
0.072,6,45,14100,25,2617,3.0,517.0,146.0,20,11483,3.0,1402.0,745.0
0.011,6,10,1990,5,911,2.0,643.0,643.0,5,1079,2.0,811.0,811.0
1786.599,6,150,19350,90,13740,20074.0,302.0,302.0,60,5610,30280.0,83.0,83.0
0.005,17,2,144,1,64,0.0,36.0,36.0,1,80,0.0,52.0,52.0
0.015,6,10,1972,5,910,3.0,642.0,642.0,5,1062,3.0,794.0,794.0
0.005,6,10,1854,5,889,1.0,621.0,621.0,5,965,1.0,697.0,697.0
0.016,6,10,1972,5,910,4.0,642.0,642.0,5,1062,3.0,794.0,794.0
0.065,6,10,1506,5,395,16.0,127.0,127.0,5,1111,13.0,843.0,843.0
0.005,6,10,1989,5,927,1.0,659.0,659.0,5,1062,1.0,794.0,794.0
240.089,6,16,4481,9,963,30011.0,238.0,166.0,7,3518,40014.0,1402.0,786.0
0.013,6,10,1631,5,848,3.0,580.0,580.0,5,783,3.0,515.0,515.0
0.018,6,10,1972,5,910,4.0,642.0,642.0,5,1062,4.0,794.0,794.0
0.005,6,10,1774,5,923,1.0,655.0,655.0,5,851,1.0,583.0,583.0
0.012,6,10,1989,5,910,3.0,642.0,642.0,5,1079,3.0,811.0,811.0
0.005,6,10,1989,5,927,1.0,659.0,659.0,5,1062,1.0,794.0,794.0
0.011,6,10,1983,5,910,2.0,642.0,642.0,5,1073,2.0,805.0,805.0
0.005,17,2,166,1,75,0.0,47.0,47.0,1,91,0.0,63.0,63.0
0.043,17,2,184,1,61,0.0,33.0,33.0,1,123,0.0,95.0,95.0
300.344,6,16,2170,9,684,37522.0,146.0,146.0,7,1486,50030.0,419.0,398.0
0.005,6,10,1989,5,927,1.0,659.0,659.0,5,1062,1.0,794.0,794.0
0.005,6,10,1643,5,860,1.0,592.0,592.0,5,783,1.0,515.0,515.0
0.038,17,4,284,2,120,0.0,32.0,32.0,2,164,35.0,60.0,54.0
0.106,6,10,1506,5,395,25.0,127.0,127.0,5,1111,25.0,843.0,843.0
0.005,6,10,2006,5,927,1.0,659.0,659.0,5,1079,1.0,811.0,811.0
0.089,6,10,1506,5,395,17.0,127.0,127.0,5,1111,19.0,843.0,843.0
0.013,17,2,152,1,76,0.0,48.0,48.0,1,76,0.0,48.0,48.0
0.102,6,10,1506,5,395,24.0,127.0,127.0,5,1111,19.0,843.0,843.0
0.005,6,10,1774,5,923,1.0,655.0,655.0,5,851,1.0,583.0,583.0
0.005,6,10,2007,5,928,1.0,660.0,660.0,5,1079,1.0,811.0,811.0
0.086,6,10,1506,5,395,18.0,127.0,127.0,5,1111,20.0,843.0,843.0
0.001,17,2,136,1,60,0.0,32.0,32.0,1,76,0.0,48.0,48.0
0.044,17,2,182,1,65,0.0,37.0,37.0,1,117,0.0,89.0,89.0
0.038,17,4,284,2,120,0.0,32.0,32.0,2,164,33.0,60.0,54.0
0.011,6,10,1762,5,911,2.0,643.0,643.0,5,851,2.0,583.0,583.0
0.011,6,13,3735,7,497,1.0,125.0,125.0,6,3238,2.0,1470.0,1459.0
240.089,6,31,9474,16,7045,16005.0,2116.0,690.0,15,2429,17149.0,580.0,205.0
0.019,6,10,1989,5,910,4.0,642.0,642.0,5,1079,4.0,811.0,811.0
240.118,6,16,4480,9,963,30014.0,238.0,166.0,7,3517,40019.0,1402.0,786.0
0.006,6,10,1689,5,839,1.0,571.0,571.0,5,850,1.0,582.0,582.0
0.01,6,10,1983,5,910,2.0,642.0,642.0,5,1073,2.0,805.0,805.0
40.054,17,10,676,5,460,10012.0,104.0,64.0,5,216,10012.0,20.0,15.0
0.012,6,10,1972,5,910,3.0,642.0,642.0,5,1062,2.0,794.0,794.0
0.001,17,2,180,1,66,0.0,38.0,38.0,1,114,0.0,86.0,86.0
240.328,6,43,8773,22,5738,11444.0,1368.0,458.0,21,3035,12016.0,580.0,241.0
0.044,17,4,284,2,120,0.0,32.0,32.0,2,164,37.0,60.0,54.0
0.098,6,10,1506,5,395,22.0,127.0,127.0,5,1111,21.0,843.0,843.0
0.006,6,10,1689,5,839,1.0,571.0,571.0,5,850,1.0,582.0,582.0
0.009,17,2,170,1,65,0.0,37.0,37.0,1,105,0.0,77.0,77.0
0.004,6,10,1702,5,863,1.0,595.0,595.0,5,839,0.0,571.0,571.0
0.009,6,10,1983,5,910,2.0,642.0,642.0,5,1073,2.0,805.0,805.0
0.012,6,13,3735,7,497,1.0,125.0,125.0,6,3238,2.0,1470.0,1459.0
0.016,6,10,1990,5,911,3.0,643.0,643.0,5,1079,3.0,811.0,811.0
0.007,6,10,1989,5,910,1.0,642.0,642.0,5,1079,1.0,811.0,811.0
0.073,6,10,1506,5,395,13.0,127.0,127.0,5,1111,16.0,843.0,843.0
11.051,17,28,4399,14,2313,841.0,588.0,137.0,14,2086,841.0,269.0,121.0
0.005,6,10,2006,5,927,1.0,659.0,659.0,5,1079,1.0,811.0,811.0
0.005,17,2,214,1,75,0.0,47.0,47.0,1,139,0.0,111.0,111.0
0.005,6,10,2007,5,928,1.0,660.0,660.0,5,1079,1.0,811.0,811.0
308.663,17,20,1124,10,716,34281.0,48.0,43.0,10,408,34281.0,20.0,12.0
0.107,6,10,1506,5,395,22.0,127.0,127.0,5,1111,23.0,843.0,843.0
0.003,17,4,284,2,120,0.0,32.0,32.0,2,164,0.0,60.0,54.0
40.065,17,10,676,5,460,10012.0,104.0,64.0,5,216,10015.0,20.0,15.0
0.005,6,10,2006,5,927,1.0,659.0,659.0,5,1079,1.0,811.0,811.0
0.012,6,10,1983,5,910,3.0,642.0,642.0,5,1073,2.0,805.0,805.0
0.005,6,10,2006,5,927,1.0,659.0,659.0,5,1079,1.0,811.0,811.0
0.004,6,10,2006,5,927,1.0,659.0,659.0,5,1079,1.0,811.0,811.0
0.005,6,10,2007,5,928,1.0,660.0,660.0,5,1079,1.0,811.0,811.0
0.004,6,10,1774,5,923,1.0,655.0,655.0,5,851,1.0,583.0,583.0
0.004,6,10,1774,5,923,1.0,655.0,655.0,5,851,1.0,583.0,583.0
0.005,6,10,1547,5,764,1.0,496.0,496.0,5,783,1.0,515.0,515.0
0.099,6,10,1506,5,395,21.0,127.0,127.0,5,1111,22.0,843.0,843.0
0.141,6,10,1506,5,395,31.0,127.0,127.0,5,1111,31.0,843.0,843.0
0.111,6,10,1506,5,395,23.0,127.0,127.0,5,1111,25.0,843.0,843.0
0.005,6,10,1989,5,927,1.0,659.0,659.0,5,1062,1.0,794.0,794.0
0.007,6,10,1972,5,910,1.0,642.0,642.0,5,1062,1.0,794.0,794.0
0.005,6,10,2007,5,928,1.0,660.0,660.0,5,1079,1.0,811.0,811.0
0.005,6,10,2007,5,928,1.0,660.0,660.0,5,1079,1.0,811.0,811.0
0.005,6,10,1689,5,839,1.0,571.0,571.0,5,850,1.0,582.0,582.0
0.023,6,10,1990,5,911,5.0,643.0,643.0,5,1079,5.0,811.0,811.0
0.006,17,2,164,1,74,0.0,46.0,46.0,1,90,0.0,62.0,62.0
0.071,6,10,1506,5,395,16.0,127.0,127.0,5,1111,16.0,843.0,843.0
0.013,6,10,1989,5,910,3.0,642.0,642.0,5,1079,3.0,811.0,811.0
0.068,17,8,3613,4,1874,22.0,1350.0,440.0,4,1739,11.0,1350.0,406.0
0.124,17,2,80,1,32,0.0,4.0,4.0,1,48,0.0,20.0,20.0
240.104,6,31,9341,15,7021,17150.0,2144.0,693.0,16,2320,16006.0,580.0,185.0
0.005,6,14,3736,7,446,0.0,74.0,74.0,7,3290,0.0,1448.0,972.0
0.005,6,10,1689,5,839,1.0,571.0,571.0,5,850,1.0,582.0,582.0
309.712,17,20,1124,10,716,34401.0,48.0,43.0,10,408,34400.0,20.0,12.0
0.009,6,12,1926,6,1189,1.0,659.0,434.0,6,737,1.0,417.0,417.0
0.009,6,10,1989,5,910,2.0,642.0,642.0,5,1079,2.0,811.0,811.0
40.081,17,10,676,5,460,10016.0,104.0,64.0,5,216,10019.0,20.0,15.0
0.186,6,10,1506,5,395,44.0,127.0,127.0,5,1111,30.0,843.0,843.0
0.005,6,10,2000,5,927,1.0,659.0,659.0,5,1073,1.0,805.0,805.0
0.006,17,2,170,1,65,0.0,37.0,37.0,1,105,0.0,77.0,77.0
0.004,17,2,136,1,60,0.0,32.0,32.0,1,76,0.0,48.0,48.0
40.078,17,10,676,5,460,10018.0,104.0,64.0,5,216,10018.0,20.0,15.0
0.038,17,2,166,1,75,0.0,47.0,47.0,1,91,0.0,63.0,63.0
0.005,6,10,1689,5,839,1.0,571.0,571.0,5,850,1.0,582.0,582.0
0.11,6,10,1506,5,395,23.0,127.0,127.0,5,1111,25.0,843.0,843.0
0.012,6,10,1989,5,910,3.0,642.0,642.0,5,1079,3.0,811.0,811.0
0.01,6,10,1972,5,910,2.0,642.0,642.0,5,1062,2.0,794.0,794.0
0.014,6,10,1677,5,827,3.0,559.0,559.0,5,850,3.0,582.0,582.0
0.001,17,2,180,1,66,0.0,38.0,38.0,1,114,0.0,86.0,86.0
300.815,6,36,9557,19,4079,16711.0,2903.0,821.0,17,5478,539.0,2667.0,435.0
0.006,6,10,1547,5,764,1.0,496.0,496.0,5,783,1.0,515.0,515.0
0.011,6,10,1990,5,911,2.0,643.0,643.0,5,1079,2.0,811.0,811.0
0.01,6,10,1990,5,911,2.0,643.0,643.0,5,1079,2.0,811.0,811.0
40.068,17,10,676,5,460,10014.0,104.0,64.0,5,216,10012.0,20.0,15.0
0.013,6,10,1631,5,848,3.0,580.0,580.0,5,783,3.0,515.0,515.0
279.418,6,60,24760,31,17886,9313.0,1935.0,1384.0,29,6874,339.0,2667.0,300.0
0.014,6,10,1983,5,910,3.0,642.0,642.0,5,1073,3.0,805.0,805.0
0.005,6,10,1689,5,839,1.0,571.0,571.0,5,850,1.0,582.0,582.0
0.082,6,10,1506,5,395,19.0,127.0,127.0,5,1111,16.0,843.0,843.0
0.129,17,2,80,1,32,0.0,4.0,4.0,1,48,0.0,20.0,20.0
0.06,6,10,1506,5,395,14.0,127.0,127.0,5,1111,12.0,843.0,843.0
0.004,6,10,1779,5,928,1.0,660.0,660.0,5,851,0.0,583.0,583.0
0.013,6,10,1989,5,910,3.0,642.0,642.0,5,1079,3.0,811.0,811.0
0.005,6,10,2007,5,928,1.0,660.0,660.0,5,1079,1.0,811.0,811.0
0.075,6,10,1506,5,395,16.0,127.0,127.0,5,1111,16.0,843.0,843.0
0.005,6,10,1779,5,928,1.0,660.0,660.0,5,851,1.0,583.0,583.0
40.06,17,10,676,5,460,10013.0,104.0,64.0,5,216,10013.0,20.0,15.0
0.008,6,10,1774,5,923,1.0,655.0,655.0,5,851,2.0,583.0,583.0
0.005,6,10,2006,5,927,1.0,659.0,659.0,5,1079,1.0,811.0,811.0
40.059,17,10,676,5,460,10011.0,104.0,64.0,5,216,10014.0,20.0,15.0
0.009,6,10,1989,5,910,2.0,642.0,642.0,5,1079,2.0,811.0,811.0
0.015,6,10,1677,5,827,3.0,559.0,559.0,5,850,3.0,582.0,582.0
0.134,6,10,1506,5,395,32.0,127.0,127.0,5,1111,29.0,843.0,843.0
0.215,6,16,2778,8,1396,30.0,533.0,324.0,8,1382,19.0,529.0,239.0
240.092,6,16,4481,9,963,30011.0,238.0,166.0,7,3518,40014.0,1402.0,786.0
0.08,6,10,1506,5,395,18.0,127.0,127.0,5,1111,17.0,843.0,843.0
0.123,6,10,1506,5,395,28.0,127.0,127.0,5,1111,28.0,843.0,843.0
0.006,6,10,1547,5,764,1.0,496.0,496.0,5,783,1.0,515.0,515.0
0.001,17,2,180,1,66,0.0,38.0,38.0,1,114,0.0,86.0,86.0
0.013,6,10,1762,5,911,3.0,643.0,643.0,5,851,3.0,583.0,583.0
1770.608,17,120,11460,60,5460,30009.0,63.0,63.0,60,6000,30009.0,72.0,72.0
0.005,6,10,1779,5,928,1.0,660.0,660.0,5,851,1.0,583.0,583.0
0.013,6,10,1631,5,848,3.0,580.0,580.0,5,783,3.0,515.0,515.0
0.006,6,10,1547,5,764,1.0,496.0,496.0,5,783,1.0,515.0,515.0
0.008,6,10,1983,5,910,2.0,642.0,642.0,5,1073,2.0,805.0,805.0
0.005,17,2,255,1,82,0.0,54.0,54.0,1,173,0.0,145.0,145.0
371.401,6,22,2313,16,867,24760.0,195.0,195.0,6,1446,4665.0,419.0,398.0
0.005,6,10,2006,5,927,1.0,659.0,659.0,5,1079,1.0,811.0,811.0
0.141,6,10,1506,5,395,17.0,127.0,127.0,5,1111,34.0,843.0,843.0
0.001,17,2,180,1,66,0.0,38.0,38.0,1,114,0.0,86.0,86.0
40.065,17,10,676,5,460,10015.0,104.0,64.0,5,216,10015.0,20.0,15.0
301.188,6,37,8261,20,1830,15852.0,651.0,249.0,17,6431,565.0,2126.0,478.0
0.013,6,10,1989,5,910,3.0,642.0,642.0,5,1079,3.0,811.0,811.0
0.008,6,10,1972,5,910,2.0,642.0,642.0,5,1062,2.0,794.0,794.0
0.003,17,2,148,1,60,0.0,32.0,32.0,1,88,0.0,60.0,60.0
0.001,17,2,136,1,60,0.0,32.0,32.0,1,76,0.0,48.0,48.0
40.082,17,10,676,5,460,10019.0,104.0,64.0,5,216,10019.0,20.0,15.0
0.005,6,14,3736,7,446,0.0,74.0,74.0,7,3290,0.0,1448.0,972.0
0.072,17,4,284,2,120,1.0,32.0,32.0,2,164,69.0,60.0,54.0
0.012,6,10,1677,5,827,3.0,559.0,559.0,5,850,2.0,582.0,582.0
0.005,6,10,2006,5,927,1.0,659.0,659.0,5,1079,1.0,811.0,811.0
0.016,6,10,1983,5,910,4.0,642.0,642.0,5,1073,3.0,805.0,805.0
0.004,17,2,148,1,60,0.0,32.0,32.0,1,88,0.0,60.0,60.0
0.008,6,10,1689,5,839,1.0,571.0,571.0,5,850,1.0,582.0,582.0
0.109,6,10,1506,5,395,25.0,127.0,127.0,5,1111,25.0,843.0,843.0
0.005,6,10,2007,5,928,1.0,660.0,660.0,5,1079,1.0,811.0,811.0
0.001,17,2,180,1,66,0.0,38.0,38.0,1,114,0.0,86.0,86.0
0.004,6,10,1989,5,927,1.0,659.0,659.0,5,1062,1.0,794.0,794.0
40.069,17,10,676,5,460,10015.0,104.0,64.0,5,216,10016.0,20.0,15.0
164.091,17,80,11120,40,2664,4207.0,44.0,38.0,40,8456,4207.0,239.0,183.0
0.005,6,10,2006,5,927,1.0,659.0,659.0,5,1079,1.0,811.0,811.0
292.852,6,381,346820,185,21182,1591.0,2736.0,888.0,196,325638,1501.0,2804.0,1733.0
0.009,6,12,1926,6,1189,1.0,659.0,434.0,6,737,1.0,417.0,417.0
1770.353,17,92,8096,46,4048,39341.0,60.0,60.0,46,4048,39341.0,60.0,60.0
240.09,6,16,4481,9,963,30011.0,238.0,166.0,7,3518,40014.0,1402.0,786.0
0.079,6,10,1506,5,395,18.0,127.0,127.0,5,1111,14.0,843.0,843.0
0.005,6,10,1547,5,764,1.0,496.0,496.0,5,783,1.0,515.0,515.0
0.005,6,10,1989,5,927,1.0,659.0,659.0,5,1062,1.0,794.0,794.0
0.028,6,10,1989,5,910,7.0,642.0,642.0,5,1079,7.0,811.0,811.0
15.087,17,15,8033,8,5865,2151.0,1350.0,705.0,7,2168,2509.0,1350.0,281.0
0.006,17,2,164,1,74,0.0,46.0,46.0,1,90,0.0,62.0,62.0
0.005,6,10,2006,5,927,1.0,659.0,659.0,5,1079,1.0,811.0,811.0
0.011,17,2,166,1,75,0.0,47.0,47.0,1,91,0.0,63.0,63.0
40.051,17,10,676,5,460,10011.0,104.0,64.0,5,216,10012.0,20.0,15.0
0.012,6,10,1972,5,910,3.0,642.0,642.0,5,1062,2.0,794.0,794.0
0.004,6,10,2000,5,927,1.0,659.0,659.0,5,1073,1.0,805.0,805.0
0.009,6,10,1990,5,911,2.0,643.0,643.0,5,1079,2.0,811.0,811.0
0.073,6,10,1506,5,395,15.0,127.0,127.0,5,1111,14.0,843.0,843.0
40.051,17,10,676,5,460,10011.0,104.0,64.0,5,216,10012.0,20.0,15.0
11.127,17,28,4421,14,1993,843.0,268.0,114.0,14,2428,843.0,587.0,145.0
0.097,6,10,1506,5,395,20.0,127.0,127.0,5,1111,22.0,843.0,843.0
0.005,6,10,2006,5,927,1.0,659.0,659.0,5,1079,1.0,811.0,811.0
0.005,6,10,2006,5,927,1.0,659.0,659.0,5,1079,1.0,811.0,811.0
0.005,6,10,2007,5,928,1.0,660.0,660.0,5,1079,1.0,811.0,811.0
0.022,6,10,1989,5,910,5.0,642.0,642.0,5,1079,5.0,811.0,811.0
308.306,17,20,1124,10,716,34242.0,48.0,43.0,10,408,34242.0,20.0,12.0
0.005,6,14,3799,7,509,0.0,137.0,137.0,7,3290,0.0,1448.0,972.0
0.007,6,12,1698,6,863,1.0,327.0,271.0,6,835,1.0,515.0,515.0
0.006,6,10,1547,5,764,1.0,496.0,496.0,5,783,1.0,515.0,515.0
11.164,17,28,4421,14,1994,846.0,269.0,114.0,14,2427,846.0,586.0,145.0
0.127,6,10,1506,5,395,31.0,127.0,127.0,5,1111,31.0,843.0,843.0
0.005,17,2,136,1,60,0.0,32.0,32.0,1,76,0.0,48.0,48.0
0.005,6,13,3747,7,509,0.0,137.0,137.0,6,3238,0.0,1470.0,1459.0
1.094,6,22,7070,13,1693,91.0,517.0,251.0,9,5377,136.0,1402.0,816.0
300.226,6,16,2170,9,684,37507.0,146.0,146.0,7,1486,50009.0,419.0,398.0
0.134,6,10,1506,5,395,30.0,127.0,127.0,5,1111,30.0,843.0,843.0
0.001,17,2,180,1,66,0.0,38.0,38.0,1,114,0.0,86.0,86.0
0.005,6,13,3690,7,452,0.0,80.0,80.0,6,3238,1.0,1470.0,1459.0
0.012,6,10,1990,5,911,3.0,643.0,643.0,5,1079,2.0,811.0,811.0
0.012,6,10,1989,5,910,3.0,642.0,642.0,5,1079,2.0,811.0,811.0
240.717,6,37,9658,19,2176,13371.0,748.0,236.0,18,7482,14157.0,1402.0,595.0
1759.657,6,471,68879,267,36326,6615.0,613.0,190.0,204,32553,8667.0,613.0,147.0
240.108,6,31,9456,16,6988,16007.0,1515.0,616.0,15,2468,17150.0,580.0,240.0
0.039,17,2,152,1,76,0.0,48.0,48.0,1,76,0.0,48.0,48.0
0.01,6,10,1972,5,910,2.0,642.0,642.0,5,1062,2.0,794.0,794.0
0.04,17,2,152,1,76,0.0,48.0,48.0,1,76,0.0,48.0,48.0
240.13,6,28,6735,14,4427,18471.0,1368.0,462.0,14,2308,18471.0,580.0,196.0
0.021,6,10,1989,5,910,5.0,642.0,642.0,5,1079,5.0,811.0,811.0
0.142,17,2,152,1,76,0.0,48.0,48.0,1,76,0.0,48.0,48.0
174.082,17,70,9815,35,2326,5119.0,44.0,38.0,35,7489,5119.0,239.0,185.0
11.074,17,26,4070,13,2164,913.0,587.0,138.0,13,1906,913.0,269.0,118.0
0.202,6,16,2778,8,1396,28.0,533.0,324.0,8,1382,18.0,529.0,239.0
40.048,17,10,676,5,460,10011.0,104.0,64.0,5,216,10011.0,20.0,15.0
0.009,6,10,1677,5,827,2.0,559.0,559.0,5,850,2.0,582.0,582.0
0.005,6,10,2006,5,927,1.0,659.0,659.0,5,1079,1.0,811.0,811.0
10.869,17,28,4423,14,1995,827.0,270.0,114.0,14,2428,827.0,587.0,145.0
0.008,6,13,3735,7,497,1.0,125.0,125.0,6,3238,1.0,1470.0,1459.0
0.005,6,10,1689,5,839,1.0,571.0,571.0,5,850,1.0,582.0,582.0
0.076,6,10,1506,5,395,15.0,127.0,127.0,5,1111,15.0,843.0,843.0
0.01,6,10,1989,5,910,2.0,642.0,642.0,5,1079,2.0,811.0,811.0
0.016,6,10,1677,5,827,3.0,559.0,559.0,5,850,3.0,582.0,582.0
0.021,6,10,1972,5,910,5.0,642.0,642.0,5,1062,5.0,794.0,794.0
0.001,17,2,136,1,60,0.0,32.0,32.0,1,76,0.0,48.0,48.0
0.005,6,10,2007,5,928,1.0,660.0,660.0,5,1079,1.0,811.0,811.0
0.005,6,10,2006,5,927,1.0,659.0,659.0,5,1079,1.0,811.0,811.0
0.004,6,11,1754,6,915,0.0,595.0,595.0,5,839,1.0,571.0,571.0
0.005,17,2,214,1,75,0.0,47.0,47.0,1,139,0.0,111.0,111.0
171.493,17,80,11200,40,2665,4397.0,44.0,38.0,40,8535,4397.0,239.0,185.0
240.087,6,16,4480,9,963,30010.0,238.0,166.0,7,3517,40013.0,1402.0,786.0
292.84,6,303,342862,122,17884,2420.0,2736.0,888.0,181,324978,1626.0,2804.0,1889.0
0.005,6,10,1643,5,860,1.0,592.0,592.0,5,783,1.0,515.0,515.0
0.011,6,10,1990,5,911,2.0,643.0,643.0,5,1079,2.0,811.0,811.0
0.072,6,10,1506,5,395,16.0,127.0,127.0,5,1111,16.0,843.0,843.0
0.015,6,10,1990,5,911,3.0,643.0,643.0,5,1079,3.0,811.0,811.0
0.017,6,10,1677,5,827,4.0,559.0,559.0,5,850,4.0,582.0,582.0
0.01,6,10,1989,5,910,2.0,642.0,642.0,5,1079,2.0,811.0,811.0
0.005,6,10,2006,5,927,1.0,659.0,659.0,5,1079,1.0,811.0,811.0
0.005,6,10,2007,5,928,1.0,660.0,660.0,5,1079,1.0,811.0,811.0
0.006,6,10,2000,5,927,1.0,659.0,659.0,5,1073,1.0,805.0,805.0
0.005,17,2,140,1,62,0.0,34.0,34.0,1,78,0.0,50.0,50.0
0.004,6,10,2000,5,927,1.0,659.0,659.0,5,1073,1.0,805.0,805.0
0.081,17,2,396,1,61,0.0,33.0,33.0,1,335,0.0,307.0,307.0
0.059,6,10,1989,5,910,14.0,642.0,642.0,5,1079,14.0,811.0,811.0
0.04,17,2,380,1,61,0.0,33.0,33.0,1,319,0.0,291.0,291.0
0.005,17,2,166,1,75,0.0,47.0,47.0,1,91,0.0,63.0,63.0
0.005,17,2,180,1,66,0.0,38.0,38.0,1,114,0.0,86.0,86.0
40.074,17,10,676,5,460,10017.0,104.0,64.0,5,216,10017.0,20.0,15.0
15.073,17,15,9238,8,6902,2149.0,1350.0,834.0,7,2336,2507.0,1350.0,305.0
0.006,6,10,1547,5,764,1.0,496.0,496.0,5,783,1.0,515.0,515.0
1777.839,17,144,41760,72,22752,25039.0,288.0,288.0,72,19008,25039.0,236.0,236.0
0.024,6,10,1983,5,910,6.0,642.0,642.0,5,1073,6.0,805.0,805.0
0.077,6,10,1506,5,395,15.0,127.0,127.0,5,1111,17.0,843.0,843.0
0.061,6,10,1506,5,395,13.0,127.0,127.0,5,1111,14.0,843.0,843.0
65.608,6,25,5158,14,1186,5046.0,180.0,75.0,11,3972,6560.0,1591.0,678.0
0.268,17,44,24380,24,21170,11.0,1350.0,854.0,20,3210,10.0,1350.0,132.0
0.001,17,2,180,1,66,0.0,38.0,38.0,1,114,0.0,86.0,86.0
0.166,6,10,1506,5,395,36.0,127.0,127.0,5,1111,30.0,843.0,843.0
0.006,6,10,1547,5,764,1.0,496.0,496.0,5,783,1.0,515.0,515.0
0.017,6,10,1989,5,910,4.0,642.0,642.0,5,1079,4.0,811.0,811.0
0.008,6,10,1989,5,910,2.0,642.0,642.0,5,1079,2.0,811.0,811.0
0.011,6,10,1677,5,827,2.0,559.0,559.0,5,850,2.0,582.0,582.0
0.004,6,10,2006,5,927,1.0,659.0,659.0,5,1079,1.0,811.0,811.0
11.374,17,28,4397,14,2311,866.0,586.0,137.0,14,2086,866.0,269.0,121.0
0.006,6,10,1689,5,839,1.0,571.0,571.0,5,850,1.0,582.0,582.0
0.006,6,10,1547,5,764,1.0,496.0,496.0,5,783,1.0,515.0,515.0
0.01,6,10,1989,5,910,2.0,642.0,642.0,5,1079,2.0,811.0,811.0
0.004,17,2,148,1,60,0.0,32.0,32.0,1,88,0.0,60.0,60.0
0.057,6,13,3735,7,497,9.0,125.0,125.0,6,3238,11.0,1470.0,1459.0
0.008,6,12,1926,6,1189,1.0,659.0,434.0,6,737,1.0,417.0,417.0
0.005,17,2,166,1,75,0.0,47.0,47.0,1,91,0.0,63.0,63.0
0.014,6,10,1990,5,911,3.0,643.0,643.0,5,1079,3.0,811.0,811.0
0.013,6,10,1677,5,827,3.0,559.0,559.0,5,850,3.0,582.0,582.0
312.289,17,20,1124,10,716,34685.0,48.0,43.0,10,408,34685.0,20.0,12.0
0.005,6,10,2007,5,928,1.0,660.0,660.0,5,1079,1.0,811.0,811.0
158.538,17,76,10794,38,2529,4284.0,44.0,38.0,38,8265,4284.0,261.0,189.0
0.041,17,2,152,1,76,0.0,48.0,48.0,1,76,0.0,48.0,48.0
0.128,17,2,80,1,32,0.0,4.0,4.0,1,48,0.0,20.0,20.0
0.012,6,10,1972,5,910,3.0,642.0,642.0,5,1062,3.0,794.0,794.0
0.004,6,10,1702,5,863,1.0,595.0,595.0,5,839,0.0,571.0,571.0
0.009,6,13,3735,7,497,1.0,125.0,125.0,6,3238,1.0,1470.0,1459.0
0.097,6,10,1506,5,395,21.0,127.0,127.0,5,1111,20.0,843.0,843.0
0.096,6,10,1506,5,395,21.0,127.0,127.0,5,1111,20.0,843.0,843.0
10.766,17,28,4421,14,1993,819.0,268.0,114.0,14,2428,819.0,587.0,145.0
0.172,17,2,152,1,76,0.0,48.0,48.0,1,76,0.0,48.0,48.0
0.094,6,10,1506,5,395,21.0,127.0,127.0,5,1111,22.0,843.0,843.0
0.006,17,2,178,1,81,0.0,53.0,53.0,1,97,0.0,69.0,69.0
0.005,6,10,1989,5,927,1.0,659.0,659.0,5,1062,1.0,794.0,794.0
0.005,17,2,170,1,65,0.0,37.0,37.0,1,105,0.0,77.0,77.0
0.004,6,10,1702,5,863,1.0,595.0,595.0,5,839,1.0,571.0,571.0
360.037,6,21,3981,13,3142,30003.0,494.0,494.0,8,839,51433.0,83.0,83.0
0.127,17,2,136,1,60,0.0,32.0,32.0,1,76,0.0,48.0,48.0
40.069,17,10,676,5,460,10016.0,104.0,64.0,5,216,10013.0,20.0,15.0
0.004,17,2,148,1,60,0.0,32.0,32.0,1,88,0.0,60.0,60.0
0.099,6,10,1506,5,395,23.0,127.0,127.0,5,1111,21.0,843.0,843.0
0.085,6,10,1506,5,395,17.0,127.0,127.0,5,1111,17.0,843.0,843.0
308.38,17,20,1124,10,716,34250.0,48.0,43.0,10,408,34250.0,20.0,12.0
0.084,6,10,1506,5,395,17.0,127.0,127.0,5,1111,18.0,843.0,843.0
0.006,6,10,1643,5,860,1.0,592.0,592.0,5,783,1.0,515.0,515.0
0.005,6,13,3747,7,509,0.0,137.0,137.0,6,3238,0.0,1470.0,1459.0
0.08,6,10,1506,5,395,19.0,127.0,127.0,5,1111,15.0,843.0,843.0
0.104,6,10,1506,5,395,21.0,127.0,127.0,5,1111,23.0,843.0,843.0
0.027,6,10,1989,5,910,6.0,642.0,642.0,5,1079,6.0,811.0,811.0
0.005,6,10,1689,5,839,1.0,571.0,571.0,5,850,1.0,582.0,582.0
0.005,17,2,169,1,62,0.0,34.0,34.0,1,107,0.0,79.0,79.0
2.785,6,25,6056,14,2100,214.0,517.0,303.0,11,3956,262.0,1330.0,700.0
0.083,6,10,1506,5,395,19.0,127.0,127.0,5,1111,17.0,843.0,843.0
0.005,6,10,1689,5,839,1.0,571.0,571.0,5,850,1.0,582.0,582.0
0.013,6,10,1990,5,911,3.0,643.0,643.0,5,1079,3.0,811.0,811.0
0.005,6,10,2000,5,927,1.0,659.0,659.0,5,1073,1.0,805.0,805.0
40.079,17,10,676,5,460,10016.0,104.0,64.0,5,216,10018.0,20.0,15.0
0.177,17,4,352,2,130,106.0,37.0,37.0,2,222,174.0,89.0,83.0
240.254,6,39,5018,18,2320,14132.0,588.0,196.0,21,2698,12012.0,580.0,199.0
11.224,17,28,4423,14,1994,850.0,269.0,114.0,14,2429,850.0,588.0,145.0
0.005,17,2,179,1,71,0.0,43.0,43.0,1,108,0.0,80.0,80.0
0.113,6,10,1506,5,395,25.0,127.0,127.0,5,1111,24.0,843.0,843.0
0.011,6,10,1989,5,910,2.0,642.0,642.0,5,1079,2.0,811.0,811.0
0.015,6,10,1677,5,827,3.0,559.0,559.0,5,850,3.0,582.0,582.0
0.005,6,10,2006,5,927,1.0,659.0,659.0,5,1079,1.0,811.0,811.0
0.005,6,10,1774,5,923,1.0,655.0,655.0,5,851,1.0,583.0,583.0
0.005,6,10,1854,5,889,1.0,621.0,621.0,5,965,1.0,697.0,697.0
0.003,17,2,186,1,61,0.0,33.0,33.0,1,125,0.0,97.0,97.0
0.006,6,10,1854,5,889,1.0,621.0,621.0,5,965,1.0,697.0,697.0
0.009,6,10,1972,5,910,2.0,642.0,642.0,5,1062,2.0,794.0,794.0
243.358,6,401,348004,203,22075,1204.0,2736.0,959.0,198,325929,1235.0,2804.0,1678.0
0.007,6,10,1547,5,764,1.0,496.0,496.0,5,783,1.0,515.0,515.0
0.043,17,4,596,2,122,7.0,33.0,33.0,2,474,3.0,323.0,209.0
10.966,17,28,4391,14,2313,835.0,588.0,137.0,14,2078,834.0,269.0,120.0
0.005,17,2,144,1,64,0.0,36.0,36.0,1,80,0.0,52.0,52.0
0.006,17,2,180,1,66,0.0,38.0,38.0,1,114,0.0,86.0,86.0
0.009,6,10,1989,5,910,2.0,642.0,642.0,5,1079,2.0,811.0,811.0
0.037,17,2,144,1,64,0.0,36.0,36.0,1,80,0.0,52.0,52.0
0.082,6,10,1506,5,395,19.0,127.0,127.0,5,1111,15.0,843.0,843.0
0.007,6,13,3684,7,446,1.0,74.0,74.0,6,3238,1.0,1470.0,1459.0
0.01,6,10,1972,5,910,2.0,642.0,642.0,5,1062,2.0,794.0,794.0
0.005,6,10,2007,5,928,1.0,660.0,660.0,5,1079,1.0,811.0,811.0
0.004,6,10,2007,5,928,1.0,660.0,660.0,5,1079,1.0,811.0,811.0
0.079,6,10,1506,5,395,16.0,127.0,127.0,5,1111,18.0,843.0,843.0
0.006,17,2,179,1,71,0.0,43.0,43.0,1,108,0.0,80.0,80.0
0.01,6,10,1989,5,910,2.0,642.0,642.0,5,1079,2.0,811.0,811.0
0.006,6,10,1689,5,839,1.0,571.0,571.0,5,850,1.0,582.0,582.0
0.106,6,10,1506,5,395,23.0,127.0,127.0,5,1111,21.0,843.0,843.0
0.02,6,10,1990,5,911,5.0,643.0,643.0,5,1079,5.0,811.0,811.0
0.006,6,10,1854,5,889,1.0,621.0,621.0,5,965,1.0,697.0,697.0
40.065,17,10,676,5,460,10013.0,104.0,64.0,5,216,10015.0,20.0,15.0
0.091,6,10,1506,5,395,20.0,127.0,127.0,5,1111,20.0,843.0,843.0
0.009,6,13,3735,7,497,1.0,125.0,125.0,6,3238,1.0,1470.0,1459.0
0.005,6,10,2006,5,927,1.0,659.0,659.0,5,1079,1.0,811.0,811.0
0.005,17,2,170,1,65,0.0,37.0,37.0,1,105,0.0,77.0,77.0
0.006,6,10,1547,5,764,1.0,496.0,496.0,5,783,1.0,515.0,515.0
0.016,6,10,1989,5,910,4.0,642.0,642.0,5,1079,3.0,811.0,811.0
0.005,6,10,1989,5,927,1.0,659.0,659.0,5,1062,1.0,794.0,794.0
240.259,6,43,8771,21,5686,12012.0,1515.0,509.0,22,3085,11440.0,580.0,241.0
0.009,6,10,1989,5,910,2.0,642.0,642.0,5,1079,2.0,811.0,811.0
0.006,6,10,1689,5,839,1.0,571.0,571.0,5,850,1.0,582.0,582.0
0.005,6,10,1547,5,764,1.0,496.0,496.0,5,783,1.0,515.0,515.0
0.074,6,10,1506,5,395,16.0,127.0,127.0,5,1111,15.0,843.0,843.0
0.004,6,10,2006,5,927,1.0,659.0,659.0,5,1079,1.0,811.0,811.0
167.182,17,88,12672,44,2961,3887.0,44.0,39.0,44,9711,3887.0,239.0,192.0
0.02,6,10,1983,5,910,5.0,642.0,642.0,5,1073,4.0,805.0,805.0
0.003,17,2,132,1,58,0.0,30.0,30.0,1,74,0.0,46.0,46.0
0.04,17,2,182,1,65,0.0,37.0,37.0,1,117,0.0,89.0,89.0
40.056,17,10,676,5,460,10012.0,104.0,64.0,5,216,10013.0,20.0,15.0
0.004,6,10,1702,5,863,1.0,595.0,595.0,5,839,0.0,571.0,571.0
240.011,6,9,787,5,488,60002.0,232.0,232.0,4,299,80003.0,83.0,83.0
240.147,6,52,7433,25,3435,10006.0,588.0,211.0,27,3998,9236.0,580.0,198.0
0.003,17,2,170,1,65,0.0,37.0,37.0,1,105,0.0,77.0,77.0
0.011,6,10,1989,5,910,2.0,642.0,642.0,5,1079,2.0,811.0,811.0
0.01,6,13,3735,7,497,1.0,125.0,125.0,6,3238,1.0,1470.0,1459.0
0.128,17,2,80,1,32,0.0,4.0,4.0,1,48,0.0,20.0,20.0
0.103,6,10,1506,5,395,23.0,127.0,127.0,5,1111,22.0,843.0,843.0
0.059,17,2,152,1,76,0.0,48.0,48.0,1,76,0.0,48.0,48.0
0.009,6,10,1631,5,848,2.0,580.0,580.0,5,783,2.0,515.0,515.0
0.01,6,10,1677,5,827,2.0,559.0,559.0,5,850,2.0,582.0,582.0
0.025,6,10,1605,5,388,6.0,120.0,120.0,5,1217,6.0,949.0,949.0
0.009,6,10,2007,5,928,2.0,660.0,660.0,5,1079,2.0,811.0,811.0
0.021,6,10,1990,5,911,5.0,643.0,643.0,5,1079,5.0,811.0,811.0
0.004,6,10,1779,5,928,1.0,660.0,660.0,5,851,1.0,583.0,583.0
0.011,6,10,1990,5,911,2.0,643.0,643.0,5,1079,2.0,811.0,811.0
0.005,17,2,170,1,65,0.0,37.0,37.0,1,105,0.0,77.0,77.0
0.076,6,10,1506,5,395,14.0,127.0,127.0,5,1111,18.0,843.0,843.0
0.005,6,10,2006,5,927,1.0,659.0,659.0,5,1079,1.0,811.0,811.0
11.202,17,28,4421,14,1993,849.0,268.0,114.0,14,2428,849.0,587.0,145.0
0.006,6,10,1689,5,839,1.0,571.0,571.0,5,850,1.0,582.0,582.0
0.005,6,10,2006,5,927,1.0,659.0,659.0,5,1079,1.0,811.0,811.0
0.007,6,10,1762,5,911,1.0,643.0,643.0,5,851,1.0,583.0,583.0
0.011,6,10,1989,5,910,2.0,642.0,642.0,5,1079,2.0,811.0,811.0
0.005,6,10,2007,5,928,1.0,660.0,660.0,5,1079,1.0,811.0,811.0
0.012,6,10,1989,5,910,3.0,642.0,642.0,5,1079,2.0,811.0,811.0
0.077,6,18,4718,10,901,7.0,180.0,93.0,8,3817,10.0,1592.0,678.0
0.005,6,10,1547,5,764,1.0,496.0,496.0,5,783,1.0,515.0,515.0
0.005,6,10,1989,5,927,1.0,659.0,659.0,5,1062,1.0,794.0,794.0
0.003,17,2,136,1,60,0.0,32.0,32.0,1,76,0.0,48.0,48.0
0.07,6,10,1506,5,395,15.0,127.0,127.0,5,1111,16.0,843.0,843.0
0.005,6,10,1989,5,927,1.0,659.0,659.0,5,1062,1.0,794.0,794.0
0.01,6,10,1643,5,860,2.0,592.0,592.0,5,783,2.0,515.0,515.0
0.116,6,10,1506,5,395,25.0,127.0,127.0,5,1111,22.0,843.0,843.0
0.073,6,10,1506,5,395,16.0,127.0,127.0,5,1111,17.0,843.0,843.0
0.004,6,10,1779,5,928,1.0,660.0,660.0,5,851,1.0,583.0,583.0
0.006,6,10,1547,5,764,1.0,496.0,496.0,5,783,1.0,515.0,515.0
0.009,6,10,1972,5,910,2.0,642.0,642.0,5,1062,2.0,794.0,794.0
293.831,6,401,349185,201,22002,1469.0,2736.0,888.0,200,327183,1476.0,2804.0,1703.0
0.006,6,10,1547,5,764,1.0,496.0,496.0,5,783,1.0,515.0,515.0
0.004,6,10,1989,5,927,1.0,659.0,659.0,5,1062,1.0,794.0,794.0
300.47,6,28,7488,16,1409,20031.0,217.0,142.0,12,6079,21852.0,1402.0,680.0
0.012,6,10,1762,5,911,3.0,643.0,643.0,5,851,3.0,583.0,583.0
0.005,17,2,230,1,68,0.0,40.0,40.0,1,162,0.0,134.0,134.0
0.005,6,10,2006,5,927,1.0,659.0,659.0,5,1079,1.0,811.0,811.0
55.513,6,36,9771,18,4253,527.0,1360.0,700.0,18,5518,3255.0,2667.0,435.0
0.003,17,2,148,1,60,0.0,32.0,32.0,1,88,0.0,60.0,60.0
0.012,6,10,1972,5,910,3.0,642.0,642.0,5,1062,2.0,794.0,794.0
0.004,6,10,2006,5,927,1.0,659.0,659.0,5,1079,1.0,811.0,811.0
0.006,6,10,1689,5,839,1.0,571.0,571.0,5,850,1.0,582.0,582.0
0.012,6,10,1983,5,910,2.0,642.0,642.0,5,1073,3.0,805.0,805.0
0.011,6,10,1983,5,910,2.0,642.0,642.0,5,1073,2.0,805.0,805.0
0.001,17,2,180,1,66,0.0,38.0,38.0,1,114,0.0,86.0,86.0
10.809,17,28,4422,14,1994,823.0,269.0,114.0,14,2428,823.0,587.0,145.0
0.101,6,10,1506,5,395,22.0,127.0,127.0,5,1111,21.0,843.0,843.0
240.08,6,16,4480,9,963,30010.0,238.0,166.0,7,3517,40013.0,1402.0,786.0
0.011,6,10,1989,5,910,2.0,642.0,642.0,5,1079,2.0,811.0,811.0
0.005,17,2,209,1,64,0.0,36.0,36.0,1,145,0.0,117.0,117.0
300.406,6,16,2170,9,684,37530.0,146.0,146.0,7,1486,50040.0,419.0,398.0
0.005,6,10,2007,5,928,1.0,660.0,660.0,5,1079,1.0,811.0,811.0
0.006,17,2,179,1,71,0.0,43.0,43.0,1,108,0.0,80.0,80.0
0.001,17,2,180,1,66,0.0,38.0,38.0,1,114,0.0,86.0,86.0
0.132,6,10,1506,5,395,25.0,127.0,127.0,5,1111,26.0,843.0,843.0
66.528,6,22,10162,12,3995,6048.0,1601.0,840.0,10,6167,7373.0,2111.0,939.0
0.004,6,10,2007,5,928,1.0,660.0,660.0,5,1079,1.0,811.0,811.0
0.005,17,2,146,1,65,0.0,37.0,37.0,1,81,0.0,53.0,53.0
0.002,17,2,166,1,75,0.0,47.0,47.0,1,91,0.0,63.0,63.0
352.249,6,20,2210,6,1308,12003.0,494.0,494.0,14,902,27095.0,83.0,83.0
0.085,6,10,1506,5,395,19.0,127.0,127.0,5,1111,17.0,843.0,843.0
11.18,17,28,4424,14,1995,847.0,270.0,114.0,14,2429,847.0,588.0,145.0
0.074,6,10,1506,5,395,17.0,127.0,127.0,5,1111,16.0,843.0,843.0
0.005,6,10,1779,5,928,1.0,660.0,660.0,5,851,1.0,583.0,583.0
40.086,17,10,676,5,460,10020.0,104.0,64.0,5,216,10020.0,20.0,15.0
0.005,6,10,2006,5,927,1.0,659.0,659.0,5,1079,1.0,811.0,811.0
0.001,17,2,180,1,65,0.0,37.0,37.0,1,115,0.0,87.0,87.0
300.366,6,16,2170,9,684,37521.0,146.0,146.0,7,1486,50031.0,419.0,398.0
0.09,6,10,1506,5,395,20.0,127.0,127.0,5,1111,18.0,843.0,843.0
0.004,6,10,2007,5,928,1.0,660.0,660.0,5,1079,1.0,811.0,811.0
0.007,6,10,1547,5,764,1.0,496.0,496.0,5,783,1.0,515.0,515.0
0.008,6,10,1990,5,911,2.0,643.0,643.0,5,1079,2.0,811.0,811.0
0.004,6,10,1779,5,928,1.0,660.0,660.0,5,851,1.0,583.0,583.0
0.764,6,10,2009,6,1655,152.0,1403.0,1403.0,4,354,176.0,182.0,182.0
0.095,6,10,1506,5,395,20.0,127.0,127.0,5,1111,22.0,843.0,843.0
0.004,17,4,284,2,120,0.0,32.0,32.0,2,164,1.0,60.0,54.0
40.059,17,10,676,5,460,10013.0,104.0,64.0,5,216,10014.0,20.0,15.0
0.005,6,10,1643,5,860,1.0,592.0,592.0,5,783,1.0,515.0,515.0
0.005,6,10,2006,5,927,1.0,659.0,659.0,5,1079,1.0,811.0,811.0
10.797,17,28,4421,14,1994,822.0,269.0,114.0,14,2427,822.0,586.0,145.0
0.004,6,10,1774,5,923,1.0,655.0,655.0,5,851,0.0,583.0,583.0
0.091,6,10,1506,5,395,18.0,127.0,127.0,5,1111,19.0,843.0,843.0
0.009,6,10,1983,5,910,2.0,642.0,642.0,5,1073,2.0,805.0,805.0
0.01,6,10,1989,5,910,2.0,642.0,642.0,5,1079,2.0,811.0,811.0
0.148,6,10,1506,5,395,34.0,127.0,127.0,5,1111,33.0,843.0,843.0
0.096,6,10,1506,5,395,23.0,127.0,127.0,5,1111,20.0,843.0,843.0
0.004,6,10,1702,5,863,1.0,595.0,595.0,5,839,0.0,571.0,571.0
0.006,6,10,1547,5,764,1.0,496.0,496.0,5,783,1.0,515.0,515.0
0.007,6,10,1689,5,839,1.0,571.0,571.0,5,850,1.0,582.0,582.0
0.124,17,2,136,1,60,0.0,32.0,32.0,1,76,0.0,48.0,48.0
0.015,6,10,1762,5,911,3.0,643.0,643.0,5,851,3.0,583.0,583.0
0.132,6,10,1506,5,395,32.0,127.0,127.0,5,1111,25.0,843.0,843.0
300.481,6,16,1559,9,690,37546.0,190.0,190.0,7,869,50061.0,464.0,248.0
0.005,6,10,2000,5,927,1.0,659.0,659.0,5,1073,1.0,805.0,805.0
0.119,6,10,1506,5,395,25.0,127.0,127.0,5,1111,25.0,843.0,843.0
308.41,17,20,1124,10,716,34261.0,48.0,43.0,10,408,34261.0,20.0,12.0
0.009,6,10,2006,5,927,2.0,659.0,659.0,5,1079,2.0,811.0,811.0
0.01,6,10,1989,5,910,2.0,642.0,642.0,5,1079,2.0,811.0,811.0
0.008,6,10,1990,5,911,2.0,643.0,643.0,5,1079,2.0,811.0,811.0
0.011,6,10,1989,5,910,2.0,642.0,642.0,5,1079,2.0,811.0,811.0
0.011,6,13,3816,7,578,1.0,206.0,206.0,6,3238,2.0,1470.0,1459.0
0.004,17,4,284,2,120,0.0,32.0,32.0,2,164,0.0,60.0,54.0
0.006,6,10,1547,5,764,1.0,496.0,496.0,5,783,1.0,515.0,515.0
0.006,6,13,3690,7,452,1.0,80.0,80.0,6,3238,1.0,1470.0,1459.0
0.018,6,10,1972,5,910,4.0,642.0,642.0,5,1062,4.0,794.0,794.0
0.006,17,2,225,1,65,0.0,37.0,37.0,1,160,0.0,132.0,132.0
0.076,6,10,1506,5,395,16.0,127.0,127.0,5,1111,17.0,843.0,843.0
0.005,17,2,146,1,65,0.0,37.0,37.0,1,81,0.0,53.0,53.0
0.007,6,10,1547,5,764,1.0,496.0,496.0,5,783,1.0,515.0,515.0
40.059,17,10,676,5,460,10012.0,104.0,64.0,5,216,10013.0,20.0,15.0
300.249,6,37,14535,20,2383,15802.0,661.0,333.0,17,12152,15014.0,1402.0,938.0
1.194,6,30,12348,18,3340,70.0,1360.0,517.0,12,9008,93.0,2720.0,1064.0
0.001,17,2,180,1,66,0.0,38.0,38.0,1,114,0.0,86.0,86.0
0.005,6,10,1689,5,839,1.0,571.0,571.0,5,850,1.0,582.0,582.0
0.044,17,4,284,2,120,41.0,32.0,32.0,2,164,6.0,60.0,54.0
0.1,6,10,1506,5,395,22.0,127.0,127.0,5,1111,22.0,843.0,843.0
0.017,6,10,1990,5,911,4.0,643.0,643.0,5,1079,4.0,811.0,811.0
0.005,17,2,230,1,68,0.0,40.0,40.0,1,162,0.0,134.0,134.0
0.004,6,10,2006,5,927,1.0,659.0,659.0,5,1079,1.0,811.0,811.0
0.011,6,10,1990,5,911,2.0,643.0,643.0,5,1079,2.0,811.0,811.0
0.078,6,10,1506,5,395,16.0,127.0,127.0,5,1111,17.0,843.0,843.0
0.005,17,2,214,1,75,0.0,47.0,47.0,1,139,0.0,111.0,111.0
0.005,6,10,2000,5,927,1.0,659.0,659.0,5,1073,1.0,805.0,805.0
0.086,6,10,1506,5,395,19.0,127.0,127.0,5,1111,17.0,843.0,843.0
15.078,17,16,8135,8,6009,2150.0,1350.0,723.0,8,2126,2149.0,1350.0,237.0
1778.343,17,142,44872,72,22752,25045.0,288.0,288.0,70,22120,25771.0,288.0,288.0
40.052,17,10,676,5,460,10012.0,104.0,64.0,5,216,10012.0,20.0,15.0
0.118,6,10,1506,5,395,24.0,127.0,127.0,5,1111,24.0,843.0,843.0
0.084,17,2,144,1,64,0.0,36.0,36.0,1,80,0.0,52.0,52.0
0.079,6,10,1506,5,395,16.0,127.0,127.0,5,1111,16.0,843.0,843.0
0.001,17,2,180,1,66,0.0,38.0,38.0,1,114,0.0,86.0,86.0
15.075,17,16,9302,8,6912,2149.0,1350.0,836.0,8,2390,2149.0,1350.0,270.0
0.003,17,4,284,2,120,0.0,32.0,32.0,2,164,0.0,60.0,54.0
0.092,6,10,1506,5,395,20.0,127.0,127.0,5,1111,22.0,843.0,843.0
0.001,17,2,180,1,66,0.0,38.0,38.0,1,114,0.0,86.0,86.0
0.006,6,10,1547,5,764,1.0,496.0,496.0,5,783,1.0,515.0,515.0
308.777,17,18,1008,9,640,38581.0,48.0,43.0,9,368,38581.0,20.0,12.0
240.092,6,16,4481,9,963,30011.0,238.0,166.0,7,3518,40014.0,1402.0,786.0
0.006,6,10,1854,5,889,1.0,621.0,621.0,5,965,1.0,697.0,697.0
0.016,6,10,1983,5,910,4.0,642.0,642.0,5,1073,4.0,805.0,805.0
0.004,6,10,1702,5,863,1.0,595.0,595.0,5,839,0.0,571.0,571.0
0.004,6,10,1702,5,863,1.0,595.0,595.0,5,839,0.0,571.0,571.0
0.089,6,10,1506,5,395,21.0,127.0,127.0,5,1111,15.0,843.0,843.0
0.001,17,2,136,1,60,0.0,32.0,32.0,1,76,0.0,48.0,48.0
40.07,17,10,676,5,460,10014.0,104.0,64.0,5,216,10015.0,20.0,15.0
300.407,6,16,2170,9,684,37530.0,146.0,146.0,7,1486,50039.0,419.0,398.0
0.015,6,10,1989,5,910,3.0,642.0,642.0,5,1079,3.0,811.0,811.0
0.006,6,10,1547,5,764,1.0,496.0,496.0,5,783,1.0,515.0,515.0
0.006,6,10,1547,5,764,1.0,496.0,496.0,5,783,1.0,515.0,515.0
0.005,6,10,2007,5,928,1.0,660.0,660.0,5,1079,1.0,811.0,811.0
0.092,6,10,1506,5,395,19.0,127.0,127.0,5,1111,21.0,843.0,843.0
0.01,6,10,1990,5,911,2.0,643.0,643.0,5,1079,2.0,811.0,811.0
0.005,6,10,2006,5,927,1.0,659.0,659.0,5,1079,1.0,811.0,811.0
0.001,17,2,180,1,66,0.0,38.0,38.0,1,114,0.0,86.0,86.0
169.297,17,86,12237,43,2881,4030.0,44.0,39.0,43,9356,4030.0,239.0,189.0
0.082,6,10,1506,5,395,19.0,127.0,127.0,5,1111,17.0,843.0,843.0
0.02,6,10,1762,5,911,4.0,643.0,643.0,5,851,5.0,583.0,583.0
0.007,6,10,1762,5,911,1.0,643.0,643.0,5,851,1.0,583.0,583.0
40.089,17,10,676,5,460,10019.0,104.0,64.0,5,216,10018.0,20.0,15.0
0.006,6,10,2006,5,927,1.0,659.0,659.0,5,1079,1.0,811.0,811.0
0.042,17,2,412,1,61,0.0,33.0,33.0,1,351,0.0,323.0,323.0
0.076,6,10,1506,5,395,16.0,127.0,127.0,5,1111,17.0,843.0,843.0
0.068,17,8,3613,4,1874,22.0,1350.0,440.0,4,1739,12.0,1350.0,406.0
11.092,17,28,4422,14,1994,844.0,269.0,114.0,14,2428,845.0,587.0,145.0
0.005,6,10,2000,5,927,1.0,659.0,659.0,5,1073,1.0,805.0,805.0
0.019,6,13,3816,7,578,3.0,206.0,206.0,6,3238,3.0,1470.0,1459.0
0.008,6,10,1990,5,911,2.0,643.0,643.0,5,1079,2.0,811.0,811.0
0.006,17,2,214,1,75,0.0,47.0,47.0,1,139,0.0,111.0,111.0
0.012,6,10,1989,5,910,3.0,642.0,642.0,5,1079,2.0,811.0,811.0
0.013,6,10,1989,5,910,3.0,642.0,642.0,5,1079,3.0,811.0,811.0
0.016,6,10,1631,5,848,3.0,580.0,580.0,5,783,4.0,515.0,515.0
167.122,17,78,11183,39,2609,4397.0,44.0,38.0,39,8574,4397.0,239.0,191.0
0.072,17,2,170,1,65,0.0,37.0,37.0,1,105,0.0,77.0,77.0
0.073,6,10,1506,5,395,16.0,127.0,127.0,5,1111,15.0,843.0,843.0
0.098,6,10,1506,5,395,23.0,127.0,127.0,5,1111,23.0,843.0,843.0
0.029,6,10,1631,5,848,7.0,580.0,580.0,5,783,7.0,515.0,515.0
0.001,17,2,179,1,62,0.0,34.0,34.0,1,117,0.0,89.0,89.0
15.073,17,15,9238,8,6902,2149.0,1350.0,834.0,7,2336,2507.0,1350.0,305.0
0.005,17,2,214,1,75,0.0,47.0,47.0,1,139,0.0,111.0,111.0
0.005,6,10,2007,5,928,1.0,660.0,660.0,5,1079,1.0,811.0,811.0
0.112,6,10,1506,5,395,25.0,127.0,127.0,5,1111,25.0,843.0,843.0
0.097,6,10,1506,5,395,21.0,127.0,127.0,5,1111,21.0,843.0,843.0
0.333,17,44,21831,24,18516,14.0,1350.0,743.0,20,3315,14.0,1350.0,137.0
0.098,6,10,1506,5,395,19.0,127.0,127.0,5,1111,19.0,843.0,843.0
0.074,6,10,1506,5,395,17.0,127.0,127.0,5,1111,15.0,843.0,843.0
0.038,17,2,170,1,65,0.0,37.0,37.0,1,105,0.0,77.0,77.0
0.07,6,10,1506,5,395,14.0,127.0,127.0,5,1111,15.0,843.0,843.0
1.07,6,32,13391,18,5892,62.0,2073.0,854.0,14,7499,69.0,2720.0,769.0
0.005,6,10,1989,5,927,1.0,659.0,659.0,5,1062,1.0,794.0,794.0
0.005,6,10,1774,5,923,1.0,655.0,655.0,5,851,1.0,583.0,583.0
0.068,6,10,1506,5,395,16.0,127.0,127.0,5,1111,14.0,843.0,843.0
0.006,6,10,1547,5,764,1.0,496.0,496.0,5,783,1.0,515.0,515.0
0.006,6,10,1689,5,839,1.0,571.0,571.0,5,850,1.0,582.0,582.0
0.005,6,10,2006,5,927,1.0,659.0,659.0,5,1079,1.0,811.0,811.0
40.078,17,10,676,5,460,10013.0,104.0,64.0,5,216,10009.0,20.0,15.0
0.004,6,10,2000,5,927,1.0,659.0,659.0,5,1073,1.0,805.0,805.0
0.005,6,10,2000,5,927,1.0,659.0,659.0,5,1073,1.0,805.0,805.0
0.012,6,14,3787,7,497,2.0,125.0,125.0,7,3290,2.0,1448.0,972.0
0.005,6,13,3747,7,509,0.0,137.0,137.0,6,3238,0.0,1470.0,1459.0
0.101,6,10,1506,5,395,22.0,127.0,127.0,5,1111,23.0,843.0,843.0
0.005,6,10,2006,5,927,1.0,659.0,659.0,5,1079,1.0,811.0,811.0
0.001,17,2,166,1,75,0.0,47.0,47.0,1,91,0.0,63.0,63.0
240.086,6,16,4480,9,963,30010.0,238.0,166.0,7,3517,40013.0,1402.0,786.0
0.005,6,10,1989,5,927,1.0,659.0,659.0,5,1062,1.0,794.0,794.0
0.005,6,10,1989,5,927,1.0,659.0,659.0,5,1062,1.0,794.0,794.0
1770.829,6,87,4626,44,2340,41180.0,26.0,26.0,43,2286,42161.0,26.0,25.0
0.016,6,10,1972,5,910,4.0,642.0,642.0,5,1062,3.0,794.0,794.0
0.014,6,10,1972,5,910,3.0,642.0,642.0,5,1062,3.0,794.0,794.0
0.007,17,2,179,1,71,0.0,43.0,43.0,1,108,0.0,80.0,80.0
0.005,6,10,1689,5,839,1.0,571.0,571.0,5,850,1.0,582.0,582.0
0.005,6,10,2006,5,927,1.0,659.0,659.0,5,1079,1.0,811.0,811.0
1777.769,17,143,45188,72,22752,25038.0,288.0,288.0,71,22436,25396.0,288.0,288.0
0.005,6,10,2006,5,927,1.0,659.0,659.0,5,1079,1.0,811.0,811.0
240.088,6,16,4482,9,963,30011.0,238.0,166.0,7,3519,40014.0,1402.0,786.0
0.006,6,10,1547,5,764,1.0,496.0,496.0,5,783,1.0,515.0,515.0
0.004,6,10,1989,5,927,1.0,659.0,659.0,5,1062,1.0,794.0,794.0
0.009,6,10,1990,5,911,2.0,643.0,643.0,5,1079,2.0,811.0,811.0
0.174,17,2,152,1,76,0.0,48.0,48.0,1,76,0.0,48.0,48.0
0.015,6,10,1972,5,910,3.0,642.0,642.0,5,1062,3.0,794.0,794.0
15.079,17,16,8427,8,6136,2150.0,1350.0,739.0,8,2291,2149.0,1350.0,258.0
240.103,6,16,4482,9,963,30012.0,238.0,166.0,7,3519,40016.0,1402.0,786.0
0.005,6,10,1779,5,928,1.0,660.0,660.0,5,851,1.0,583.0,583.0
300.396,6,16,2170,9,684,37527.0,146.0,146.0,7,1486,50037.0,419.0,398.0
0.005,6,10,1774,5,923,1.0,655.0,655.0,5,851,1.0,583.0,583.0
0.017,6,10,1762,5,911,4.0,643.0,643.0,5,851,4.0,583.0,583.0
0.005,6,10,2000,5,927,1.0,659.0,659.0,5,1073,1.0,805.0,805.0
0.016,6,10,1989,5,910,3.0,642.0,642.0,5,1079,4.0,811.0,811.0
0.016,6,10,1972,5,910,4.0,642.0,642.0,5,1062,4.0,794.0,794.0
0.003,17,2,148,1,60,0.0,32.0,32.0,1,88,0.0,60.0,60.0
0.005,6,10,2007,5,928,1.0,660.0,660.0,5,1079,1.0,811.0,811.0
0.004,6,10,2000,5,927,1.0,659.0,659.0,5,1073,1.0,805.0,805.0
0.01,6,10,1989,5,910,2.0,642.0,642.0,5,1079,2.0,811.0,811.0
0.005,6,13,3747,7,509,0.0,137.0,137.0,6,3238,1.0,1470.0,1459.0
0.082,6,10,1506,5,395,19.0,127.0,127.0,5,1111,16.0,843.0,843.0
0.019,6,10,1990,5,911,4.0,643.0,643.0,5,1079,4.0,811.0,811.0
0.008,17,2,194,1,59,0.0,31.0,31.0,1,135,0.0,107.0,107.0
0.005,6,10,2006,5,927,1.0,659.0,659.0,5,1079,1.0,811.0,811.0
0.001,17,2,136,1,60,0.0,32.0,32.0,1,76,0.0,48.0,48.0
0.072,6,10,1506,5,395,15.0,127.0,127.0,5,1111,14.0,843.0,843.0
0.001,17,2,180,1,66,0.0,38.0,38.0,1,114,0.0,86.0,86.0
0.001,17,2,180,1,66,0.0,38.0,38.0,1,114,0.0,86.0,86.0
0.006,6,10,1689,5,839,1.0,571.0,571.0,5,850,1.0,582.0,582.0
0.005,6,10,2000,5,927,1.0,659.0,659.0,5,1073,1.0,805.0,805.0
0.005,6,10,2006,5,927,1.0,659.0,659.0,5,1079,1.0,811.0,811.0
0.004,17,4,284,2,120,0.0,32.0,32.0,2,164,0.0,60.0,54.0
240.106,6,30,9223,15,6997,17150.0,2122.0,691.0,15,2226,17150.0,580.0,205.0
0.005,6,10,2007,5,928,1.0,660.0,660.0,5,1079,1.0,811.0,811.0
0.089,6,10,1506,5,395,21.0,127.0,127.0,5,1111,20.0,843.0,843.0
0.005,6,10,1689,5,839,1.0,571.0,571.0,5,850,1.0,582.0,582.0
40.069,17,10,676,5,460,10014.0,104.0,64.0,5,216,10016.0,20.0,15.0
0.004,6,10,1779,5,928,1.0,660.0,660.0,5,851,1.0,583.0,583.0
0.006,6,10,2007,5,928,1.0,660.0,660.0,5,1079,1.0,811.0,811.0
0.02,6,10,1972,5,910,4.0,642.0,642.0,5,1062,4.0,794.0,794.0
0.011,6,10,1990,5,911,2.0,643.0,643.0,5,1079,2.0,811.0,811.0
0.006,6,10,1643,5,860,1.0,592.0,592.0,5,783,1.0,515.0,515.0
0.005,6,10,2007,5,928,1.0,660.0,660.0,5,1079,1.0,811.0,811.0
0.169,17,2,152,1,76,0.0,48.0,48.0,1,76,0.0,48.0,48.0
0.04,17,2,412,1,61,0.0,33.0,33.0,1,351,0.0,323.0,323.0
0.014,6,10,1983,5,910,3.0,642.0,642.0,5,1073,3.0,805.0,805.0
0.022,6,10,1989,5,910,5.0,642.0,642.0,5,1079,5.0,811.0,811.0
0.025,6,10,1989,5,910,6.0,642.0,642.0,5,1079,6.0,811.0,811.0
0.007,6,10,1989,5,910,1.0,642.0,642.0,5,1079,1.0,811.0,811.0
295.516,6,371,347535,198,21864,1500.0,2736.0,889.0,173,325671,1718.0,4171.0,1991.0
0.014,6,10,1989,5,910,3.0,642.0,642.0,5,1079,3.0,811.0,811.0
0.01,6,10,1989,5,910,2.0,642.0,642.0,5,1079,2.0,811.0,811.0
0.094,6,10,1506,5,395,22.0,127.0,127.0,5,1111,18.0,843.0,843.0
0.081,6,10,1506,5,395,18.0,127.0,127.0,5,1111,18.0,843.0,843.0
0.02,6,10,1989,5,910,5.0,642.0,642.0,5,1079,4.0,811.0,811.0
0.006,6,10,1547,5,764,1.0,496.0,496.0,5,783,1.0,515.0,515.0
40.067,17,10,676,5,460,10015.0,104.0,64.0,5,216,10016.0,20.0,15.0
0.183,6,10,1506,5,395,42.0,127.0,127.0,5,1111,24.0,843.0,843.0
1786.108,6,150,19350,90,13740,20068.0,302.0,302.0,60,5610,30272.0,83.0,83.0
11.48,17,34,6374,17,2659,707.0,270.0,128.0,17,3715,707.0,1144.0,190.0
0.041,17,2,152,1,76,0.0,48.0,48.0,1,76,0.0,48.0,48.0
0.006,6,10,1547,5,764,1.0,496.0,496.0,5,783,1.0,515.0,515.0
10.83,17,28,4420,14,1995,825.0,270.0,114.0,14,2425,824.0,588.0,145.0
369.79,6,24,2405,17,919,23111.0,195.0,195.0,7,1486,3904.0,419.0,398.0
0.004,17,2,148,1,60,0.0,32.0,32.0,1,88,0.0,60.0,60.0
0.006,6,10,1547,5,764,1.0,496.0,496.0,5,783,1.0,515.0,515.0
0.099,6,10,1506,5,395,22.0,127.0,127.0,5,1111,21.0,843.0,843.0
0.003,17,4,284,2,120,0.0,32.0,32.0,2,164,0.0,60.0,54.0
0.004,6,10,2006,5,927,1.0,659.0,659.0,5,1079,1.0,811.0,811.0
0.004,6,10,1702,5,863,1.0,595.0,595.0,5,839,0.0,571.0,571.0
0.005,17,2,179,1,71,0.0,43.0,43.0,1,108,0.0,80.0,80.0
10.799,17,26,4102,13,1822,891.0,269.0,112.0,13,2280,891.0,587.0,147.0
0.005,6,10,2000,5,927,1.0,659.0,659.0,5,1073,1.0,805.0,805.0
0.006,6,10,2000,5,927,1.0,659.0,659.0,5,1073,1.0,805.0,805.0
40.061,17,10,676,5,460,10013.0,104.0,64.0,5,216,10014.0,20.0,15.0
0.005,6,10,2000,5,927,1.0,659.0,659.0,5,1073,1.0,805.0,805.0
0.003,17,2,136,1,60,0.0,32.0,32.0,1,76,0.0,48.0,48.0
0.005,6,13,3747,7,509,0.0,137.0,137.0,6,3238,1.0,1470.0,1459.0
0.005,6,13,3747,7,509,0.0,137.0,137.0,6,3238,1.0,1470.0,1459.0
0.014,6,10,1983,5,910,3.0,642.0,642.0,5,1073,3.0,805.0,805.0
0.004,17,2,412,1,61,0.0,33.0,33.0,1,351,0.0,323.0,323.0
0.005,17,2,166,1,75,0.0,47.0,47.0,1,91,0.0,63.0,63.0
0.005,6,15,3794,8,504,0.0,80.0,80.0,7,3290,0.0,1448.0,972.0
15.074,17,15,9238,8,6902,2149.0,1350.0,834.0,7,2336,2507.0,1350.0,305.0
300.385,6,16,2170,9,684,37526.0,146.0,146.0,7,1486,50035.0,419.0,398.0
0.011,6,10,1983,5,910,2.0,642.0,642.0,5,1073,2.0,805.0,805.0
0.006,17,2,170,1,65,0.0,37.0,37.0,1,105,0.0,77.0,77.0
40.072,17,10,676,5,460,10011.0,104.0,64.0,5,216,10015.0,20.0,15.0
0.19,17,4,352,2,130,145.0,37.0,37.0,2,222,149.0,89.0,83.0
0.007,17,4,284,2,120,0.0,32.0,32.0,2,164,1.0,60.0,54.0
0.005,6,10,2006,5,927,1.0,659.0,659.0,5,1079,1.0,811.0,811.0
0.029,6,10,1972,5,910,7.0,642.0,642.0,5,1062,7.0,794.0,794.0
0.005,17,2,144,1,64,0.0,36.0,36.0,1,80,0.0,52.0,52.0
0.008,6,10,1677,5,827,2.0,559.0,559.0,5,850,2.0,582.0,582.0
0.003,6,10,1702,5,863,0.0,595.0,595.0,5,839,0.0,571.0,571.0
0.009,6,10,1989,5,910,2.0,642.0,642.0,5,1079,2.0,811.0,811.0
0.131,6,10,1506,5,395,31.0,127.0,127.0,5,1111,29.0,843.0,843.0
0.001,17,2,180,1,66,0.0,38.0,38.0,1,114,0.0,86.0,86.0
1770.531,17,92,8096,46,4048,39344.0,60.0,60.0,46,4048,39345.0,60.0,60.0
177.084,17,84,12330,42,2836,4319.0,44.0,39.0,42,9494,4319.0,239.0,198.0
0.075,6,10,1506,5,395,16.0,127.0,127.0,5,1111,15.0,843.0,843.0
0.017,6,10,1989,5,910,4.0,642.0,642.0,5,1079,4.0,811.0,811.0
0.005,6,10,2000,5,927,1.0,659.0,659.0,5,1073,1.0,805.0,805.0
40.071,17,10,676,5,460,10016.0,104.0,64.0,5,216,10017.0,20.0,15.0
0.038,17,2,186,1,61,0.0,33.0,33.0,1,125,0.0,97.0,97.0
367.154,6,22,2313,16,867,24476.0,195.0,195.0,6,1446,4638.0,419.0,398.0
1746.604,6,298,97179,184,86159,9544.0,2001.0,683.0,114,11020,15456.0,452.0,70.0
0.015,6,10,1990,5,911,3.0,643.0,643.0,5,1079,3.0,811.0,811.0
367.094,6,22,2313,16,867,24472.0,195.0,195.0,6,1446,4637.0,419.0,398.0
0.005,6,13,3747,7,509,0.0,137.0,137.0,6,3238,0.0,1470.0,1459.0
0.008,6,10,1989,5,910,1.0,642.0,642.0,5,1079,1.0,811.0,811.0
0.006,6,10,1643,5,860,1.0,592.0,592.0,5,783,1.0,515.0,515.0
0.005,17,2,169,1,62,0.0,34.0,34.0,1,107,0.0,79.0,79.0
0.078,6,10,1506,5,395,17.0,127.0,127.0,5,1111,15.0,843.0,843.0
0.006,6,10,1547,5,764,1.0,496.0,496.0,5,783,1.0,515.0,515.0
0.005,6,10,2000,5,927,1.0,659.0,659.0,5,1073,1.0,805.0,805.0
0.019,6,20,9974,11,704,1.0,124.0,124.0,9,9270,2.0,2896.0,1758.0
0.006,17,2,170,1,65,0.0,37.0,37.0,1,105,0.0,77.0,77.0
0.009,6,10,1989,5,910,2.0,642.0,642.0,5,1079,2.0,811.0,811.0
0.009,6,10,1989,5,910,2.0,642.0,642.0,5,1079,2.0,811.0,811.0
0.012,6,10,1990,5,911,2.0,643.0,643.0,5,1079,2.0,811.0,811.0
240.138,6,16,4493,9,975,30017.0,238.0,166.0,7,3518,40015.0,1402.0,786.0
0.012,6,10,1983,5,910,3.0,642.0,642.0,5,1073,3.0,805.0,805.0
0.031,6,10,1972,5,910,7.0,642.0,642.0,5,1062,7.0,794.0,794.0
0.006,6,10,1547,5,764,1.0,496.0,496.0,5,783,1.0,515.0,515.0
0.011,6,10,1631,5,848,2.0,580.0,580.0,5,783,2.0,515.0,515.0
0.005,6,10,2006,5,927,1.0,659.0,659.0,5,1079,1.0,811.0,811.0
0.005,6,10,1989,5,927,1.0,659.0,659.0,5,1062,1.0,794.0,794.0
0.005,6,10,2006,5,927,1.0,659.0,659.0,5,1079,1.0,811.0,811.0
178.481,17,78,11169,39,2594,4696.0,44.0,38.0,39,8575,4696.0,239.0,191.0
0.076,6,10,1506,5,395,16.0,127.0,127.0,5,1111,17.0,843.0,843.0
0.005,6,10,1779,5,928,1.0,660.0,660.0,5,851,1.0,583.0,583.0
240.155,6,46,6786,22,3224,11435.0,588.0,230.0,24,3562,10441.0,580.0,209.0
0.004,17,2,148,1,60,0.0,32.0,32.0,1,88,0.0,60.0,60.0
0.001,17,2,166,1,75,0.0,47.0,47.0,1,91,0.0,63.0,63.0
0.004,17,2,148,1,60,0.0,32.0,32.0,1,88,0.0,60.0,60.0
0.016,6,10,1631,5,848,4.0,580.0,580.0,5,783,3.0,515.0,515.0
0.175,6,14,3108,8,601,25.0,177.0,177.0,6,2507,33.0,1402.0,1089.0
0.014,6,10,1990,5,911,3.0,643.0,643.0,5,1079,3.0,811.0,811.0
0.09,6,10,1506,5,395,18.0,127.0,127.0,5,1111,16.0,843.0,843.0
0.012,6,10,1990,5,911,2.0,643.0,643.0,5,1079,2.0,811.0,811.0
0.04,17,2,136,1,60,0.0,32.0,32.0,1,76,0.0,48.0,48.0
0.087,6,10,1506,5,395,19.0,127.0,127.0,5,1111,18.0,843.0,843.0
0.028,6,10,1631,5,848,7.0,580.0,580.0,5,783,6.0,515.0,515.0
0.111,6,10,1506,5,395,20.0,127.0,127.0,5,1111,25.0,843.0,843.0
0.013,6,10,1989,5,910,3.0,642.0,642.0,5,1079,3.0,811.0,811.0
40.076,17,10,676,5,460,10015.0,104.0,64.0,5,216,10018.0,20.0,15.0
0.17,6,3,453,2,321,170.0,241.0,241.0,1,132,0.0,92.0,92.0
10.827,17,26,4103,13,1822,893.0,269.0,112.0,13,2281,893.0,588.0,147.0
0.066,17,8,3613,4,1874,22.0,1350.0,440.0,4,1739,11.0,1350.0,406.0
0.054,17,2,152,1,76,0.0,48.0,48.0,1,76,0.0,48.0,48.0
0.011,6,10,1990,5,911,2.0,643.0,643.0,5,1079,2.0,811.0,811.0
0.01,6,10,1989,5,910,2.0,642.0,642.0,5,1079,2.0,811.0,811.0
351.988,6,20,2210,6,1308,12003.0,494.0,494.0,14,902,27075.0,83.0,83.0
15.071,17,15,9238,8,6902,2149.0,1350.0,834.0,7,2336,2506.0,1350.0,305.0
0.02,6,10,1989,5,910,4.0,642.0,642.0,5,1079,4.0,811.0,811.0
40.075,17,10,676,5,460,10017.0,104.0,64.0,5,216,10012.0,20.0,15.0
0.117,6,10,1506,5,395,25.0,127.0,127.0,5,1111,24.0,843.0,843.0
0.127,17,2,182,1,65,0.0,37.0,37.0,1,117,0.0,89.0,89.0
0.004,17,2,148,1,60,0.0,32.0,32.0,1,88,0.0,60.0,60.0
0.006,6,10,1689,5,839,1.0,571.0,571.0,5,850,1.0,582.0,582.0
0.01,6,10,1990,5,911,2.0,643.0,643.0,5,1079,2.0,811.0,811.0
0.069,6,10,1506,5,395,15.0,127.0,127.0,5,1111,15.0,843.0,843.0
0.006,6,10,1547,5,764,1.0,496.0,496.0,5,783,1.0,515.0,515.0
0.008,6,10,1547,5,764,1.0,496.0,496.0,5,783,1.0,515.0,515.0
352.499,6,20,2210,6,1308,12004.0,494.0,494.0,14,902,27115.0,83.0,83.0
175.516,17,76,10802,38,2542,4743.0,44.0,38.0,38,8260,4743.0,239.0,189.0
0.003,17,2,136,1,60,0.0,32.0,32.0,1,76,0.0,48.0,48.0
0.081,6,10,1506,5,395,19.0,127.0,127.0,5,1111,14.0,843.0,843.0
0.01,6,10,1989,5,910,2.0,642.0,642.0,5,1079,2.0,811.0,811.0
0.001,17,2,180,1,66,0.0,38.0,38.0,1,114,0.0,86.0,86.0
0.005,6,10,1989,5,927,1.0,659.0,659.0,5,1062,1.0,794.0,794.0
0.008,6,10,1990,5,911,1.0,643.0,643.0,5,1079,2.0,811.0,811.0
0.018,6,10,1983,5,910,4.0,642.0,642.0,5,1073,4.0,805.0,805.0
0.005,17,2,170,1,65,0.0,37.0,37.0,1,105,0.0,77.0,77.0
0.01,6,10,1762,5,911,2.0,643.0,643.0,5,851,2.0,583.0,583.0
0.012,6,10,1989,5,910,2.0,642.0,642.0,5,1079,3.0,811.0,811.0
0.085,6,10,1506,5,395,20.0,127.0,127.0,5,1111,19.0,843.0,843.0
0.002,17,2,180,1,66,0.0,38.0,38.0,1,114,0.0,86.0,86.0
0.116,6,10,1506,5,395,24.0,127.0,127.0,5,1111,25.0,843.0,843.0
0.071,17,2,136,1,60,0.0,32.0,32.0,1,76,0.0,48.0,48.0
0.006,17,2,170,1,65,0.0,37.0,37.0,1,105,0.0,77.0,77.0
0.013,6,10,1990,5,911,3.0,643.0,643.0,5,1079,3.0,811.0,811.0
0.009,6,10,1983,5,910,2.0,642.0,642.0,5,1073,2.0,805.0,805.0
0.003,17,2,136,1,60,0.0,32.0,32.0,1,76,0.0,48.0,48.0
0.005,6,10,2007,5,928,1.0,660.0,660.0,5,1079,1.0,811.0,811.0
0.012,6,10,1990,5,911,3.0,643.0,643.0,5,1079,2.0,811.0,811.0
0.004,6,10,1779,5,928,1.0,660.0,660.0,5,851,1.0,583.0,583.0
0.005,17,2,144,1,64,0.0,36.0,36.0,1,80,0.0,52.0,52.0
0.128,17,2,80,1,32,0.0,4.0,4.0,1,48,0.0,20.0,20.0
364.355,6,22,2313,16,867,24290.0,195.0,195.0,6,1446,4640.0,419.0,398.0
0.001,17,2,180,1,66,0.0,38.0,38.0,1,114,0.0,86.0,86.0
0.005,6,10,2006,5,927,1.0,659.0,659.0,5,1079,1.0,811.0,811.0
0.006,6,10,1702,5,863,1.0,595.0,595.0,5,839,1.0,571.0,571.0
0.065,6,10,1506,5,395,14.0,127.0,127.0,5,1111,15.0,843.0,843.0
0.071,6,10,1506,5,395,17.0,127.0,127.0,5,1111,14.0,843.0,843.0
0.003,17,2,136,1,60,0.0,32.0,32.0,1,76,0.0,48.0,48.0
0.112,6,10,1506,5,395,25.0,127.0,127.0,5,1111,23.0,843.0,843.0
0.067,6,10,1506,5,395,15.0,127.0,127.0,5,1111,15.0,843.0,843.0
0.003,17,2,136,1,60,0.0,32.0,32.0,1,76,0.0,48.0,48.0
0.009,6,10,1989,5,910,2.0,642.0,642.0,5,1079,2.0,811.0,811.0
0.098,6,10,1506,5,395,20.0,127.0,127.0,5,1111,23.0,843.0,843.0
0.008,6,10,1762,5,911,2.0,643.0,643.0,5,851,2.0,583.0,583.0
40.069,17,10,676,5,460,10016.0,104.0,64.0,5,216,10016.0,20.0,15.0
0.011,6,10,1989,5,910,2.0,642.0,642.0,5,1079,2.0,811.0,811.0
0.002,17,2,152,1,76,0.0,48.0,48.0,1,76,0.0,48.0,48.0
0.002,17,2,152,1,76,0.0,48.0,48.0,1,76,0.0,48.0,48.0
0.006,6,10,1643,5,860,1.0,592.0,592.0,5,783,1.0,515.0,515.0
0.017,6,10,1990,5,911,4.0,643.0,643.0,5,1079,4.0,811.0,811.0
0.077,6,10,1506,5,395,17.0,127.0,127.0,5,1111,15.0,843.0,843.0
0.006,6,10,1547,5,764,1.0,496.0,496.0,5,783,1.0,515.0,515.0
0.011,6,10,1989,5,910,2.0,642.0,642.0,5,1079,2.0,811.0,811.0
0.114,6,10,1506,5,395,25.0,127.0,127.0,5,1111,27.0,843.0,843.0
0.121,6,10,1506,5,395,28.0,127.0,127.0,5,1111,25.0,843.0,843.0
0.211,6,16,2669,8,1395,30.0,533.0,323.0,8,1274,19.0,529.0,212.0
0.001,17,2,136,1,60,0.0,32.0,32.0,1,76,0.0,48.0,48.0
0.009,6,10,1972,5,910,2.0,642.0,642.0,5,1062,2.0,794.0,794.0
0.021,6,10,1762,5,911,5.0,643.0,643.0,5,851,5.0,583.0,583.0
0.001,17,2,180,1,66,0.0,38.0,38.0,1,114,0.0,86.0,86.0
0.014,6,10,1762,5,911,3.0,643.0,643.0,5,851,3.0,583.0,583.0
0.04,17,2,152,1,76,0.0,48.0,48.0,1,76,0.0,48.0,48.0
0.014,6,10,1983,5,910,3.0,642.0,642.0,5,1073,3.0,805.0,805.0
0.003,17,4,284,2,120,0.0,32.0,32.0,2,164,0.0,60.0,54.0
0.005,17,2,164,1,74,0.0,46.0,46.0,1,90,0.0,62.0,62.0
0.006,6,10,2000,5,927,1.0,659.0,659.0,5,1073,1.0,805.0,805.0
0.001,17,2,140,1,62,0.0,34.0,34.0,1,78,0.0,50.0,50.0
0.011,6,10,1990,5,911,2.0,643.0,643.0,5,1079,2.0,811.0,811.0
0.008,6,10,1547,5,764,2.0,496.0,496.0,5,783,1.0,515.0,515.0
40.076,17,10,676,5,460,10018.0,104.0,64.0,5,216,10018.0,20.0,15.0
0.03,6,10,1990,5,911,7.0,643.0,643.0,5,1079,7.0,811.0,811.0
0.005,17,2,222,1,65,0.0,37.0,37.0,1,157,0.0,129.0,129.0
0.008,6,12,1926,6,1189,1.0,659.0,434.0,6,737,1.0,417.0,417.0
0.126,6,10,1506,5,395,29.0,127.0,127.0,5,1111,30.0,843.0,843.0
0.005,6,10,1989,5,927,1.0,659.0,659.0,5,1062,1.0,794.0,794.0
0.006,6,10,1689,5,839,1.0,571.0,571.0,5,850,1.0,582.0,582.0
0.005,6,10,2007,5,928,1.0,660.0,660.0,5,1079,1.0,811.0,811.0
0.01,6,10,1983,5,910,2.0,642.0,642.0,5,1073,2.0,805.0,805.0
0.082,6,10,1506,5,395,18.0,127.0,127.0,5,1111,19.0,843.0,843.0
0.007,17,2,179,1,71,0.0,43.0,43.0,1,108,0.0,80.0,80.0
0.009,6,10,1990,5,911,2.0,643.0,643.0,5,1079,2.0,811.0,811.0
0.017,6,10,1989,5,910,4.0,642.0,642.0,5,1079,4.0,811.0,811.0
40.075,17,10,676,5,460,10017.0,104.0,64.0,5,216,10017.0,20.0,15.0
15.072,17,15,9238,8,6902,2149.0,1350.0,834.0,7,2336,2507.0,1350.0,305.0
0.006,6,10,1547,5,764,1.0,496.0,496.0,5,783,1.0,515.0,515.0
0.004,17,2,136,1,60,0.0,32.0,32.0,1,76,0.0,48.0,48.0
240.086,6,15,6493,7,5776,40014.0,3139.0,1805.0,8,717,34297.0,293.0,293.0
0.018,6,10,1989,5,910,4.0,642.0,642.0,5,1079,4.0,811.0,811.0
0.004,17,2,148,1,60,0.0,32.0,32.0,1,88,0.0,60.0,60.0
40.065,17,10,676,5,460,10015.0,104.0,64.0,5,216,10015.0,20.0,15.0
0.042,17,2,148,1,60,0.0,32.0,32.0,1,88,0.0,60.0,60.0
0.011,6,10,1989,5,910,2.0,642.0,642.0,5,1079,2.0,811.0,811.0
0.011,6,10,1983,5,910,2.0,642.0,642.0,5,1073,2.0,805.0,805.0
1756.597,6,106,6322,60,3525,29772.0,27.0,27.0,46,2797,39034.0,27.0,27.0
0.012,6,10,1972,5,910,2.0,642.0,642.0,5,1062,2.0,794.0,794.0
0.009,6,10,1972,5,910,2.0,642.0,642.0,5,1062,2.0,794.0,794.0
0.098,6,10,1506,5,395,19.0,127.0,127.0,5,1111,24.0,843.0,843.0
0.041,17,2,170,1,65,0.0,37.0,37.0,1,105,0.0,77.0,77.0
0.216,17,4,352,2,130,176.0,37.0,37.0,2,222,144.0,89.0,83.0
178.362,17,82,11520,41,2751,4458.0,44.0,39.0,41,8769,4459.0,261.0,185.0
0.001,17,2,142,1,63,0.0,35.0,35.0,1,79,0.0,51.0,51.0
99.485,6,25,9452,12,1627,73.0,794.0,367.0,13,7825,8279.0,1360.0,810.0
0.138,6,10,1506,5,395,34.0,127.0,127.0,5,1111,29.0,843.0,843.0
40.056,17,10,676,5,460,10013.0,104.0,64.0,5,216,10013.0,20.0,15.0
40.063,17,10,676,5,460,10012.0,104.0,64.0,5,216,10014.0,20.0,15.0
0.101,6,10,1506,5,395,24.0,127.0,127.0,5,1111,21.0,843.0,843.0
0.005,6,10,2000,5,927,1.0,659.0,659.0,5,1073,1.0,805.0,805.0
10.831,17,28,4422,14,1994,824.0,269.0,114.0,14,2428,824.0,587.0,145.0
0.132,17,4,420,2,122,0.0,33.0,33.0,2,298,129.0,145.0,121.0
0.147,6,10,1506,5,395,22.0,127.0,127.0,5,1111,34.0,843.0,843.0
0.075,6,10,1506,5,395,16.0,127.0,127.0,5,1111,16.0,843.0,843.0
0.104,6,10,1506,5,395,20.0,127.0,127.0,5,1111,21.0,843.0,843.0
300.018,6,11,891,6,552,60003.0,232.0,232.0,5,339,75003.0,83.0,83.0
0.039,17,2,234,1,61,0.0,33.0,33.0,1,173,0.0,145.0,145.0
0.005,6,10,1689,5,839,1.0,571.0,571.0,5,850,1.0,582.0,582.0
0.01,6,10,1972,5,910,2.0,642.0,642.0,5,1062,2.0,794.0,794.0
0.01,6,10,1762,5,911,2.0,643.0,643.0,5,851,2.0,583.0,583.0
0.117,6,10,1506,5,395,27.0,127.0,127.0,5,1111,27.0,843.0,843.0
0.005,6,10,2006,5,927,1.0,659.0,659.0,5,1079,1.0,811.0,811.0
0.006,6,10,1989,5,927,1.0,659.0,659.0,5,1062,1.0,794.0,794.0
0.009,6,10,1762,5,911,2.0,643.0,643.0,5,851,2.0,583.0,583.0
0.005,6,10,1643,5,860,1.0,592.0,592.0,5,783,1.0,515.0,515.0
0.132,6,10,1506,5,395,31.0,127.0,127.0,5,1111,20.0,843.0,843.0
0.001,17,2,142,1,63,0.0,35.0,35.0,1,79,0.0,51.0,51.0
0.006,6,12,1698,6,863,1.0,327.0,271.0,6,835,1.0,515.0,515.0
0.005,6,10,1643,5,860,1.0,592.0,592.0,5,783,1.0,515.0,515.0
0.11,6,10,1506,5,395,26.0,127.0,127.0,5,1111,21.0,843.0,843.0
0.023,6,10,1762,5,911,5.0,643.0,643.0,5,851,5.0,583.0,583.0
0.013,6,10,1989,5,910,3.0,642.0,642.0,5,1079,3.0,811.0,811.0
0.005,6,10,2006,5,927,1.0,659.0,659.0,5,1079,1.0,811.0,811.0
0.009,6,10,2006,5,927,2.0,659.0,659.0,5,1079,2.0,811.0,811.0
0.009,6,10,1989,5,910,2.0,642.0,642.0,5,1079,2.0,811.0,811.0
0.008,6,10,1972,5,910,2.0,642.0,642.0,5,1062,1.0,794.0,794.0
0.011,6,10,1762,5,911,2.0,643.0,643.0,5,851,2.0,583.0,583.0
0.015,6,13,3735,7,497,2.0,125.0,125.0,6,3238,3.0,1470.0,1459.0
0.006,6,10,1547,5,764,1.0,496.0,496.0,5,783,1.0,515.0,515.0
0.072,17,2,182,1,65,0.0,37.0,37.0,1,117,0.0,89.0,89.0
0.005,6,10,1779,5,928,1.0,660.0,660.0,5,851,1.0,583.0,583.0
40.069,17,10,676,5,460,10015.0,104.0,64.0,5,216,10016.0,20.0,15.0
0.083,6,10,1506,5,395,18.0,127.0,127.0,5,1111,15.0,843.0,843.0
8.979,6,36,9962,19,4484,498.0,1360.0,738.0,17,5478,547.0,2667.0,435.0
0.009,6,10,1990,5,911,2.0,643.0,643.0,5,1079,2.0,811.0,811.0
0.013,6,10,1677,5,827,3.0,559.0,559.0,5,850,3.0,582.0,582.0
0.082,6,10,1506,5,395,19.0,127.0,127.0,5,1111,20.0,843.0,843.0
369.756,6,22,2313,16,867,24650.0,195.0,195.0,6,1446,4636.0,419.0,398.0
0.003,17,2,160,1,72,0.0,44.0,44.0,1,88,0.0,60.0,60.0
0.01,6,10,1972,5,910,2.0,642.0,642.0,5,1062,2.0,794.0,794.0
0.005,6,10,1989,5,927,1.0,659.0,659.0,5,1062,1.0,794.0,794.0
40.064,17,10,676,5,460,10013.0,104.0,64.0,5,216,10015.0,20.0,15.0
0.006,6,10,2007,5,928,1.0,660.0,660.0,5,1079,1.0,811.0,811.0
0.012,6,10,1990,5,911,3.0,643.0,643.0,5,1079,3.0,811.0,811.0
0.002,17,2,174,1,72,0.0,44.0,44.0,1,102,0.0,74.0,74.0
0.006,6,10,1643,5,860,1.0,592.0,592.0,5,783,1.0,515.0,515.0
0.008,6,10,1983,5,910,2.0,642.0,642.0,5,1073,2.0,805.0,805.0
0.004,17,2,136,1,60,0.0,32.0,32.0,1,76,0.0,48.0,48.0
0.005,6,10,1689,5,839,1.0,571.0,571.0,5,850,1.0,582.0,582.0
40.061,17,10,676,5,460,10012.0,104.0,64.0,5,216,10014.0,20.0,15.0
0.259,6,10,1506,5,395,59.0,127.0,127.0,5,1111,60.0,843.0,843.0
0.036,17,2,152,1,76,0.0,48.0,48.0,1,76,0.0,48.0,48.0
10.803,17,28,4422,14,1994,822.0,269.0,114.0,14,2428,822.0,587.0,145.0
0.021,6,10,1762,5,911,5.0,643.0,643.0,5,851,5.0,583.0,583.0
0.005,6,10,2000,5,927,1.0,659.0,659.0,5,1073,1.0,805.0,805.0
0.005,6,10,2000,5,927,1.0,659.0,659.0,5,1073,1.0,805.0,805.0
0.117,6,10,1506,5,395,27.0,127.0,127.0,5,1111,26.0,843.0,843.0
0.175,6,10,1506,5,395,41.0,127.0,127.0,5,1111,33.0,843.0,843.0
0.011,6,10,1983,5,910,2.0,642.0,642.0,5,1073,2.0,805.0,805.0
0.04,17,2,182,1,65,0.0,37.0,37.0,1,117,0.0,89.0,89.0
0.074,6,10,1506,5,395,18.0,127.0,127.0,5,1111,16.0,843.0,843.0
0.006,6,10,1547,5,764,1.0,496.0,496.0,5,783,1.0,515.0,515.0
15.356,17,47,24558,25,21220,638.0,1350.0,820.0,22,3338,729.0,1350.0,123.0
40.054,17,10,676,5,460,10012.0,104.0,64.0,5,216,10012.0,20.0,15.0
40.066,17,10,676,5,460,10015.0,104.0,64.0,5,216,10015.0,20.0,15.0
0.005,17,2,170,1,65,0.0,37.0,37.0,1,105,0.0,77.0,77.0
300.023,6,12,1782,7,1348,50003.0,494.0,494.0,5,434,75005.0,83.0,83.0
0.04,17,2,136,1,60,0.0,32.0,32.0,1,76,0.0,48.0,48.0
0.246,17,39,20241,21,17032,12.0,1350.0,783.0,18,3209,10.0,1350.0,150.0
11.437,17,28,4398,14,2312,867.0,587.0,137.0,14,2086,867.0,269.0,121.0
0.137,6,10,1506,5,395,32.0,127.0,127.0,5,1111,31.0,843.0,843.0
0.042,17,2,412,1,61,0.0,33.0,33.0,1,351,0.0,323.0,323.0
0.005,6,10,2007,5,928,1.0,660.0,660.0,5,1079,1.0,811.0,811.0
0.005,6,10,2007,5,928,1.0,660.0,660.0,5,1079,1.0,811.0,811.0
0.01,6,10,1972,5,910,2.0,642.0,642.0,5,1062,2.0,794.0,794.0
0.007,6,10,1990,5,911,1.0,643.0,643.0,5,1079,1.0,811.0,811.0
0.005,6,13,3690,7,452,0.0,80.0,80.0,6,3238,0.0,1470.0,1459.0
0.085,6,10,1506,5,395,20.0,127.0,127.0,5,1111,16.0,843.0,843.0
0.006,6,13,3747,7,509,0.0,137.0,137.0,6,3238,1.0,1470.0,1459.0
40.063,17,10,676,5,460,10014.0,104.0,64.0,5,216,10014.0,20.0,15.0
0.007,6,10,1547,5,764,1.0,496.0,496.0,5,783,1.0,515.0,515.0
0.005,6,10,2007,5,928,1.0,660.0,660.0,5,1079,1.0,811.0,811.0
0.005,6,10,2007,5,928,1.0,660.0,660.0,5,1079,1.0,811.0,811.0
0.005,6,10,1547,5,764,1.0,496.0,496.0,5,783,1.0,515.0,515.0
0.005,6,14,3742,8,504,0.0,80.0,80.0,6,3238,0.0,1470.0,1459.0
273.34,17,18,1008,9,640,34152.0,48.0,43.0,9,368,34152.0,20.0,12.0
0.013,6,10,1972,5,910,3.0,642.0,642.0,5,1062,3.0,794.0,794.0
0.017,6,10,1762,5,911,4.0,643.0,643.0,5,851,4.0,583.0,583.0
0.005,17,2,160,1,72,0.0,44.0,44.0,1,88,0.0,60.0,60.0
0.004,6,10,2007,5,928,1.0,660.0,660.0,5,1079,1.0,811.0,811.0
0.008,6,12,1926,6,1189,1.0,659.0,434.0,6,737,1.0,417.0,417.0
0.009,6,10,1989,5,910,2.0,642.0,642.0,5,1079,2.0,811.0,811.0
0.078,6,10,1506,5,395,19.0,127.0,127.0,5,1111,14.0,843.0,843.0
0.004,6,10,2006,5,927,1.0,659.0,659.0,5,1079,1.0,811.0,811.0
0.005,17,2,154,1,69,0.0,41.0,41.0,1,85,0.0,57.0,57.0
0.216,6,16,2669,8,1395,30.0,533.0,323.0,8,1274,19.0,529.0,212.0
0.006,6,10,1854,5,889,1.0,621.0,621.0,5,965,1.0,697.0,697.0
0.004,6,10,1702,5,863,1.0,595.0,595.0,5,839,0.0,571.0,571.0
0.005,6,10,1989,5,927,1.0,659.0,659.0,5,1062,1.0,794.0,794.0
0.005,6,10,1989,5,927,1.0,659.0,659.0,5,1062,1.0,794.0,794.0
0.006,17,2,164,1,74,0.0,46.0,46.0,1,90,0.0,62.0,62.0
0.005,6,10,2006,5,927,1.0,659.0,659.0,5,1079,1.0,811.0,811.0
0.07,6,10,1506,5,395,15.0,127.0,127.0,5,1111,16.0,843.0,843.0
0.005,6,10,1989,5,927,1.0,659.0,659.0,5,1062,1.0,794.0,794.0
40.063,17,10,676,5,460,10013.0,104.0,64.0,5,216,10014.0,20.0,15.0
0.006,6,10,1854,5,889,1.0,621.0,621.0,5,965,1.0,697.0,697.0
0.222,6,16,2777,8,1395,31.0,533.0,323.0,8,1382,20.0,529.0,239.0
0.082,6,10,1506,5,395,17.0,127.0,127.0,5,1111,19.0,843.0,843.0
0.004,6,10,2007,5,928,1.0,660.0,660.0,5,1079,1.0,811.0,811.0
0.114,6,10,1506,5,395,25.0,127.0,127.0,5,1111,26.0,843.0,843.0
0.012,6,10,1989,5,910,2.0,642.0,642.0,5,1079,3.0,811.0,811.0
0.006,6,10,1689,5,839,1.0,571.0,571.0,5,850,1.0,582.0,582.0
0.117,6,10,1506,5,395,25.0,127.0,127.0,5,1111,26.0,843.0,843.0
0.073,6,10,1506,5,395,15.0,127.0,127.0,5,1111,16.0,843.0,843.0
0.004,6,10,1774,5,923,1.0,655.0,655.0,5,851,1.0,583.0,583.0
9.041,17,6,376,5,280,2260.0,28.0,28.0,1,96,0.0,68.0,68.0
1772.597,17,120,11460,60,5460,30043.0,63.0,63.0,60,6000,30043.0,72.0,72.0
0.014,6,10,1689,5,839,3.0,571.0,571.0,5,850,3.0,582.0,582.0
0.005,6,10,2007,5,928,1.0,660.0,660.0,5,1079,1.0,811.0,811.0
0.066,17,8,3613,4,1874,22.0,1350.0,440.0,4,1739,10.0,1350.0,406.0
0.005,6,10,1774,5,923,1.0,655.0,655.0,5,851,1.0,583.0,583.0
240.099,6,32,9259,16,6976,16006.0,2048.0,683.0,16,2283,16006.0,580.0,180.0
0.017,6,10,1972,5,910,4.0,642.0,642.0,5,1062,4.0,794.0,794.0
241.035,6,28,9376,15,2788,17216.0,990.0,503.0,13,6588,20086.0,1592.0,738.0
0.017,6,10,1983,5,910,4.0,642.0,642.0,5,1073,4.0,805.0,805.0
0.093,6,10,1506,5,395,19.0,127.0,127.0,5,1111,22.0,843.0,843.0
174.549,17,92,13057,46,3076,3878.0,44.0,38.0,46,9981,3878.0,261.0,188.0
0.013,17,2,152,1,56,0.0,28.0,28.0,1,96,0.0,68.0,68.0
0.029,6,12,4070,7,671,4.0,295.0,295.0,5,3399,5.0,1729.0,1565.0
0.001,17,2,136,1,60,0.0,32.0,32.0,1,76,0.0,48.0,48.0
15.069,17,15,9239,8,6902,2148.0,1350.0,834.0,7,2337,2506.0,1350.0,305.0
40.046,17,10,676,5,460,10010.0,104.0,64.0,5,216,10010.0,20.0,15.0
0.003,17,2,136,1,60,0.0,32.0,32.0,1,76,0.0,48.0,48.0
0.007,6,10,1702,5,863,1.0,595.0,595.0,5,839,1.0,571.0,571.0
0.134,6,10,1506,5,395,25.0,127.0,127.0,5,1111,26.0,843.0,843.0
0.005,6,10,1643,5,860,1.0,592.0,592.0,5,783,1.0,515.0,515.0
0.236,17,15,8641,8,4076,33.0,1350.0,481.0,7,4565,30.0,1350.0,624.0
15.076,17,15,9238,8,6902,2149.0,1350.0,834.0,7,2336,2507.0,1350.0,305.0
0.005,17,2,170,1,65,0.0,37.0,37.0,1,105,0.0,77.0,77.0
40.075,17,10,676,5,460,10016.0,104.0,64.0,5,216,10017.0,20.0,15.0
616.125,6,54,19354,29,4345,22004.0,676.0,404.0,25,15009,23171.0,1437.0,805.0
326.949,6,40,14968,21,4167,16347.0,676.0,438.0,19,10801,18162.0,1402.0,892.0
10.835,17,29,4549,14,1994,824.0,269.0,114.0,15,2555,765.0,586.0,142.0
351.985,6,20,2210,6,1308,12003.0,494.0,494.0,14,902,27075.0,83.0,83.0
0.09,6,10,1506,5,395,21.0,127.0,127.0,5,1111,20.0,843.0,843.0
0.013,6,10,1972,5,910,3.0,642.0,642.0,5,1062,3.0,794.0,794.0
0.1,6,10,1506,5,395,23.0,127.0,127.0,5,1111,23.0,843.0,843.0
308.63,17,20,1124,10,716,34277.0,48.0,43.0,10,408,34278.0,20.0,12.0
0.001,17,2,180,1,66,0.0,38.0,38.0,1,114,0.0,86.0,86.0
0.004,6,10,2006,5,927,1.0,659.0,659.0,5,1079,1.0,811.0,811.0
0.005,6,10,2006,5,927,1.0,659.0,659.0,5,1079,1.0,811.0,811.0
40.05,17,10,676,5,460,10011.0,104.0,64.0,5,216,10011.0,20.0,15.0
0.078,6,10,1506,5,395,17.0,127.0,127.0,5,1111,16.0,843.0,843.0
0.01,6,10,1983,5,910,2.0,642.0,642.0,5,1073,2.0,805.0,805.0
0.012,6,10,1989,5,910,3.0,642.0,642.0,5,1079,2.0,811.0,811.0
0.005,17,2,184,1,61,0.0,33.0,33.0,1,123,0.0,95.0,95.0
280.365,6,23,6075,10,1186,31151.0,267.0,156.0,13,4889,23362.0,1400.0,873.0
0.005,6,13,3747,7,509,0.0,137.0,137.0,6,3238,1.0,1470.0,1459.0
0.011,6,10,1983,5,910,2.0,642.0,642.0,5,1073,2.0,805.0,805.0
0.004,17,2,148,1,60,0.0,32.0,32.0,1,88,0.0,60.0,60.0
0.006,6,10,1547,5,764,1.0,496.0,496.0,5,783,1.0,515.0,515.0
0.121,17,2,80,1,32,0.0,4.0,4.0,1,48,0.0,20.0,20.0
0.006,6,10,1547,5,764,1.0,496.0,496.0,5,783,1.0,515.0,515.0
0.005,6,10,1774,5,923,1.0,655.0,655.0,5,851,1.0,583.0,583.0
0.071,17,2,144,1,64,0.0,36.0,36.0,1,80,0.0,52.0,52.0
0.012,6,10,1983,5,910,2.0,642.0,642.0,5,1073,2.0,805.0,805.0
0.005,6,10,1689,5,839,1.0,571.0,571.0,5,850,1.0,582.0,582.0
0.125,17,2,396,1,61,0.0,33.0,33.0,1,335,0.0,307.0,307.0
0.081,6,10,1506,5,395,17.0,127.0,127.0,5,1111,17.0,843.0,843.0
0.006,6,10,1547,5,764,1.0,496.0,496.0,5,783,1.0,515.0,515.0
0.086,6,10,1506,5,395,18.0,127.0,127.0,5,1111,19.0,843.0,843.0
1771.85,17,120,11460,60,5460,30031.0,63.0,63.0,60,6000,30031.0,72.0,72.0
0.042,17,4,420,2,122,0.0,33.0,33.0,2,298,38.0,145.0,121.0
0.005,6,10,2006,5,927,1.0,659.0,659.0,5,1079,1.0,811.0,811.0
0.005,17,2,169,1,62,0.0,34.0,34.0,1,107,0.0,79.0,79.0
0.012,6,10,1989,5,910,2.0,642.0,642.0,5,1079,3.0,811.0,811.0
0.007,6,10,1989,5,910,1.0,642.0,642.0,5,1079,1.0,811.0,811.0
0.013,6,10,1990,5,911,3.0,643.0,643.0,5,1079,3.0,811.0,811.0
40.065,17,10,676,5,460,10014.0,104.0,64.0,5,216,10015.0,20.0,15.0
367.347,6,22,2313,16,867,24489.0,195.0,195.0,6,1446,4651.0,419.0,398.0
0.265,6,22,7134,11,1609,26.0,746.0,257.0,11,5525,26.0,2334.0,989.0
0.193,6,10,1506,5,395,46.0,127.0,127.0,5,1111,31.0,843.0,843.0
0.017,6,10,1677,5,827,4.0,559.0,559.0,5,850,4.0,582.0,582.0
0.087,6,10,1506,5,395,20.0,127.0,127.0,5,1111,17.0,843.0,843.0
0.013,6,10,1972,5,910,3.0,642.0,642.0,5,1062,3.0,794.0,794.0
0.119,6,10,1506,5,395,27.0,127.0,127.0,5,1111,27.0,843.0,843.0
0.004,6,10,2007,5,928,1.0,660.0,660.0,5,1079,1.0,811.0,811.0
0.087,6,10,1506,5,395,19.0,127.0,127.0,5,1111,17.0,843.0,843.0
0.004,6,10,1774,5,923,1.0,655.0,655.0,5,851,1.0,583.0,583.0
9.039,17,6,376,5,280,2259.0,28.0,28.0,1,96,0.0,68.0,68.0
40.081,17,10,676,5,460,10017.0,104.0,64.0,5,216,10019.0,20.0,15.0
40.061,17,10,676,5,460,10011.0,104.0,64.0,5,216,10014.0,20.0,15.0
0.004,17,2,148,1,60,0.0,32.0,32.0,1,88,0.0,60.0,60.0
0.004,6,10,1702,5,863,1.0,595.0,595.0,5,839,0.0,571.0,571.0
0.011,6,10,1677,5,827,2.0,559.0,559.0,5,850,2.0,582.0,582.0
0.005,6,10,2000,5,927,1.0,659.0,659.0,5,1073,1.0,805.0,805.0
173.061,17,70,9903,35,2331,5089.0,44.0,38.0,35,7572,5089.0,252.0,188.0
0.006,6,10,1547,5,764,1.0,496.0,496.0,5,783,1.0,515.0,515.0
0.014,6,10,1990,5,911,3.0,643.0,643.0,5,1079,3.0,811.0,811.0
0.012,6,10,1983,5,910,2.0,642.0,642.0,5,1073,3.0,805.0,805.0
0.013,6,10,1989,5,910,3.0,642.0,642.0,5,1079,3.0,811.0,811.0
0.01,6,10,1643,5,860,2.0,592.0,592.0,5,783,2.0,515.0,515.0
1798.86,17,3059,234628,1523,123403,1181.0,84.0,53.0,1536,111225,1171.0,227.0,44.0
0.013,6,10,1677,5,827,3.0,559.0,559.0,5,850,3.0,582.0,582.0
0.006,6,10,1689,5,839,1.0,571.0,571.0,5,850,1.0,582.0,582.0
0.01,6,10,1972,5,910,2.0,642.0,642.0,5,1062,2.0,794.0,794.0
0.101,6,10,1506,5,395,23.0,127.0,127.0,5,1111,23.0,843.0,843.0
0.016,6,10,1762,5,911,4.0,643.0,643.0,5,851,3.0,583.0,583.0
310.481,17,20,1124,10,716,34485.0,48.0,43.0,10,408,34487.0,20.0,12.0
0.006,6,10,1547,5,764,1.0,496.0,496.0,5,783,1.0,515.0,515.0
0.153,6,10,1506,5,395,34.0,127.0,127.0,5,1111,22.0,843.0,843.0
132.63,58,5,360,4,288,44210.0,24.0,24.0,1,72,0.0,24.0,24.0
0.065,17,2,236,1,68,0.0,40.0,40.0,1,168,0.0,140.0,140.0
0.097,6,10,1506,5,395,21.0,127.0,127.0,5,1111,21.0,843.0,843.0
0.012,6,10,1990,5,911,3.0,643.0,643.0,5,1079,2.0,811.0,811.0
0.025,6,10,1989,5,910,6.0,642.0,642.0,5,1079,6.0,811.0,811.0
24.078,6,36,8466,18,1994,505.0,886.0,414.0,18,6472,1408.0,2720.0,478.0
0.004,17,2,136,1,60,0.0,32.0,32.0,1,76,0.0,48.0,48.0
0.018,6,10,1989,5,910,4.0,642.0,642.0,5,1079,4.0,811.0,811.0
0.005,6,10,2006,5,927,1.0,659.0,659.0,5,1079,1.0,811.0,811.0
0.004,6,10,1989,5,927,1.0,659.0,659.0,5,1062,1.0,794.0,794.0
176.401,17,78,11067,39,2593,4642.0,44.0,38.0,39,8474,4642.0,239.0,189.0
0.013,6,10,1972,5,910,3.0,642.0,642.0,5,1062,3.0,794.0,794.0
0.005,6,10,1774,5,923,1.0,655.0,655.0,5,851,1.0,583.0,583.0
0.001,17,2,180,1,66,0.0,38.0,38.0,1,114,0.0,86.0,86.0
40.055,17,10,676,5,460,10013.0,104.0,64.0,5,216,10013.0,20.0,15.0
0.019,6,10,1990,5,911,4.0,643.0,643.0,5,1079,4.0,811.0,811.0
40.077,17,10,676,5,460,10017.0,104.0,64.0,5,216,10018.0,20.0,15.0
0.724,6,22,5072,11,1250,61.0,325.0,133.0,11,3822,61.0,1414.0,563.0
11.473,17,28,4394,14,2312,870.0,587.0,137.0,14,2082,869.0,269.0,120.0
0.013,6,10,1972,5,910,3.0,642.0,642.0,5,1062,3.0,794.0,794.0
0.006,6,10,1689,5,839,1.0,571.0,571.0,5,850,1.0,582.0,582.0
0.006,17,2,284,1,69,0.0,41.0,41.0,1,215,0.0,187.0,187.0
0.006,6,10,1989,5,927,1.0,659.0,659.0,5,1062,1.0,794.0,794.0
0.005,6,10,1989,5,927,1.0,659.0,659.0,5,1062,1.0,794.0,794.0
15.077,17,15,7961,8,5927,2149.0,1350.0,712.0,7,2034,2508.0,1350.0,262.0
0.005,6,10,2007,5,928,1.0,660.0,660.0,5,1079,1.0,811.0,811.0
0.013,6,10,1631,5,848,3.0,580.0,580.0,5,783,3.0,515.0,515.0
0.074,6,10,1506,5,395,16.0,127.0,127.0,5,1111,17.0,843.0,843.0
0.094,6,10,1506,5,395,19.0,127.0,127.0,5,1111,22.0,843.0,843.0
0.011,6,10,1989,5,910,2.0,642.0,642.0,5,1079,2.0,811.0,811.0
0.005,6,10,2007,5,928,1.0,660.0,660.0,5,1079,1.0,811.0,811.0
0.01,6,10,1989,5,910,2.0,642.0,642.0,5,1079,2.0,811.0,811.0
15.079,17,15,8629,8,6389,2150.0,1350.0,770.0,7,2240,2508.0,1350.0,292.0
0.003,17,2,148,1,60,0.0,32.0,32.0,1,88,0.0,60.0,60.0
172.168,17,70,10069,35,2339,5063.0,44.0,38.0,35,7730,5063.0,249.0,192.0
0.014,6,10,1972,5,910,3.0,642.0,642.0,5,1062,3.0,794.0,794.0
0.001,17,2,180,1,66,0.0,38.0,38.0,1,114,0.0,86.0,86.0
0.006,6,10,1989,5,927,1.0,659.0,659.0,5,1062,1.0,794.0,794.0
0.006,6,10,1547,5,764,1.0,496.0,496.0,5,783,1.0,515.0,515.0
0.016,6,10,1983,5,910,4.0,642.0,642.0,5,1073,4.0,805.0,805.0
0.091,6,10,1506,5,395,20.0,127.0,127.0,5,1111,12.0,843.0,843.0
0.29,17,47,27324,26,21281,11.0,1350.0,790.0,21,6043,11.0,1350.0,259.0
0.004,6,10,2007,5,928,1.0,660.0,660.0,5,1079,1.0,811.0,811.0
0.017,6,10,1989,5,910,4.0,642.0,642.0,5,1079,4.0,811.0,811.0
10.853,17,28,4422,14,1995,826.0,270.0,114.0,14,2427,826.0,586.0,145.0
0.153,6,10,1506,5,395,35.0,127.0,127.0,5,1111,37.0,843.0,843.0
0.001,17,2,180,1,66,0.0,38.0,38.0,1,114,0.0,86.0,86.0
0.099,6,10,1506,5,395,22.0,127.0,127.0,5,1111,15.0,843.0,843.0
0.015,6,10,1972,5,910,3.0,642.0,642.0,5,1062,3.0,794.0,794.0
0.006,6,10,1547,5,764,1.0,496.0,496.0,5,783,1.0,515.0,515.0
0.005,17,2,212,1,74,0.0,46.0,46.0,1,138,0.0,110.0,110.0
0.005,6,10,2000,5,927,1.0,659.0,659.0,5,1073,1.0,805.0,805.0
0.119,6,10,1506,5,395,25.0,127.0,127.0,5,1111,24.0,843.0,843.0
0.005,6,10,2006,5,927,1.0,659.0,659.0,5,1079,1.0,811.0,811.0
0.006,6,10,1643,5,860,1.0,592.0,592.0,5,783,1.0,515.0,515.0
0.001,17,2,136,1,60,0.0,32.0,32.0,1,76,0.0,48.0,48.0
291.821,6,378,346834,192,21549,1527.0,2736.0,889.0,186,325285,1577.0,2804.0,1834.0
0.005,6,13,3747,7,509,0.0,137.0,137.0,6,3238,0.0,1470.0,1459.0
0.006,17,2,184,1,68,0.0,40.0,40.0,1,116,0.0,88.0,88.0
0.012,6,10,1983,5,910,3.0,642.0,642.0,5,1073,3.0,805.0,805.0
0.008,6,10,1983,5,910,2.0,642.0,642.0,5,1073,2.0,805.0,805.0
40.082,17,10,676,5,460,10019.0,104.0,64.0,5,216,10019.0,20.0,15.0
0.007,6,10,1547,5,764,1.0,496.0,496.0,5,783,1.0,515.0,515.0
366.287,6,24,2405,17,919,22892.0,195.0,195.0,7,1486,3904.0,419.0,398.0
0.005,17,2,214,1,75,0.0,47.0,47.0,1,139,0.0,111.0,111.0
0.005,6,10,2000,5,927,1.0,659.0,659.0,5,1073,1.0,805.0,805.0
0.117,6,10,1506,5,395,24.0,127.0,127.0,5,1111,27.0,843.0,843.0
0.005,17,2,164,1,74,0.0,46.0,46.0,1,90,0.0,62.0,62.0
352.995,6,20,2210,6,1308,12003.0,494.0,494.0,14,902,27153.0,83.0,83.0
0.016,6,10,1631,5,848,3.0,580.0,580.0,5,783,3.0,515.0,515.0
0.005,17,2,179,1,71,0.0,43.0,43.0,1,108,0.0,80.0,80.0
308.831,17,18,1008,9,640,38587.0,48.0,43.0,9,368,38587.0,20.0,12.0
0.006,17,2,214,1,75,0.0,47.0,47.0,1,139,0.0,111.0,111.0
354.044,6,21,1795,16,1030,23602.0,190.0,190.0,5,765,60003.0,464.0,248.0
0.006,6,10,1990,5,928,1.0,660.0,660.0,5,1062,1.0,794.0,794.0
0.005,6,10,2007,5,928,1.0,660.0,660.0,5,1079,1.0,811.0,811.0
0.079,6,10,1506,5,395,18.0,127.0,127.0,5,1111,16.0,843.0,843.0
308.948,17,19,1076,10,716,34302.0,48.0,43.0,9,360,38590.0,12.0,12.0
175.184,17,76,10873,38,2537,4734.0,44.0,38.0,38,8336,4734.0,261.0,191.0
0.086,6,10,1506,5,395,19.0,127.0,127.0,5,1111,16.0,843.0,843.0
0.001,17,2,180,1,66,0.0,38.0,38.0,1,114,0.0,86.0,86.0
0.005,17,2,240,1,61,0.0,33.0,33.0,1,179,0.0,151.0,151.0
0.013,6,10,1989,5,910,3.0,642.0,642.0,5,1079,3.0,811.0,811.0
40.065,17,10,676,5,460,10015.0,104.0,64.0,5,216,10015.0,20.0,15.0
0.006,17,2,179,1,71,0.0,43.0,43.0,1,108,0.0,80.0,80.0
0.005,6,10,2007,5,928,1.0,660.0,660.0,5,1079,1.0,811.0,811.0
0.352,17,51,26366,28,22714,13.0,1350.0,783.0,23,3652,13.0,1350.0,130.0
8.98,6,39,10487,20,4929,472.0,1360.0,682.0,19,5558,487.0,2720.0,435.0
240.22,6,28,13209,13,6828,20018.0,2349.0,1231.0,15,6381,17158.0,1728.0,932.0
176.138,17,78,10937,39,2604,4635.0,44.0,38.0,39,8333,4635.0,252.0,185.0
15.284,17,42,24761,24,19836,663.0,1350.0,798.0,18,4925,897.0,1350.0,245.0
0.013,6,10,1983,5,910,3.0,642.0,642.0,5,1073,3.0,805.0,805.0
0.005,6,14,3799,7,509,0.0,137.0,137.0,7,3290,0.0,1448.0,972.0
0.005,17,2,144,1,64,0.0,36.0,36.0,1,80,0.0,52.0,52.0
0.069,17,8,3613,4,1874,23.0,1350.0,440.0,4,1739,12.0,1350.0,406.0
0.004,6,10,1774,5,923,1.0,655.0,655.0,5,851,1.0,583.0,583.0
0.007,6,10,1689,5,839,1.0,571.0,571.0,5,850,1.0,582.0,582.0
0.047,17,2,152,1,76,0.0,48.0,48.0,1,76,0.0,48.0,48.0
0.006,6,10,1779,5,928,1.0,660.0,660.0,5,851,1.0,583.0,583.0
0.007,17,2,179,1,71,0.0,43.0,43.0,1,108,0.0,80.0,80.0
0.003,17,2,136,1,60,0.0,32.0,32.0,1,76,0.0,48.0,48.0
0.006,6,10,2007,5,928,1.0,660.0,660.0,5,1079,1.0,811.0,811.0
0.011,6,10,1989,5,910,2.0,642.0,642.0,5,1079,2.0,811.0,811.0
0.022,6,10,1972,5,910,5.0,642.0,642.0,5,1062,5.0,794.0,794.0
0.011,6,10,1677,5,827,2.0,559.0,559.0,5,850,2.0,582.0,582.0
0.005,17,2,144,1,64,0.0,36.0,36.0,1,80,0.0,52.0,52.0
0.019,6,13,3735,7,497,3.0,125.0,125.0,6,3238,3.0,1470.0,1459.0
0.005,17,2,214,1,75,0.0,47.0,47.0,1,139,0.0,111.0,111.0
0.005,6,10,2006,5,927,1.0,659.0,659.0,5,1079,1.0,811.0,811.0
0.02,6,10,1631,5,848,4.0,580.0,580.0,5,783,5.0,515.0,515.0
0.009,6,10,1677,5,827,2.0,559.0,559.0,5,850,2.0,582.0,582.0
40.058,17,10,676,5,460,10013.0,104.0,64.0,5,216,10013.0,20.0,15.0
0.226,6,16,2669,8,1395,32.0,533.0,323.0,8,1274,20.0,529.0,212.0
0.006,6,10,1689,5,839,1.0,571.0,571.0,5,850,1.0,582.0,582.0
0.108,6,10,1506,5,395,24.0,127.0,127.0,5,1111,26.0,843.0,843.0
0.005,6,10,2006,5,927,1.0,659.0,659.0,5,1079,1.0,811.0,811.0
300.395,6,16,2170,9,684,37528.0,146.0,146.0,7,1486,50037.0,419.0,398.0
0.003,17,2,162,1,65,0.0,37.0,37.0,1,97,0.0,69.0,69.0
240.378,6,44,8823,22,5738,11446.0,1515.0,509.0,22,3085,11446.0,580.0,241.0
0.061,17,2,80,1,32,0.0,4.0,4.0,1,48,0.0,20.0,20.0
0.008,6,12,1926,6,1189,1.0,659.0,434.0,6,737,1.0,417.0,417.0
0.002,17,2,192,1,71,0.0,43.0,43.0,1,121,0.0,93.0,93.0
0.018,6,10,1972,5,910,4.0,642.0,642.0,5,1062,4.0,794.0,794.0
0.004,6,13,3690,7,452,0.0,80.0,80.0,6,3238,0.0,1470.0,1459.0
0.015,6,10,1989,5,910,3.0,642.0,642.0,5,1079,3.0,811.0,811.0
9.037,17,6,376,5,280,2259.0,28.0,28.0,1,96,0.0,68.0,68.0
0.007,6,10,1547,5,764,1.0,496.0,496.0,5,783,1.0,515.0,515.0
0.011,6,10,1972,5,910,2.0,642.0,642.0,5,1062,2.0,794.0,794.0
0.006,17,2,180,1,66,0.0,38.0,38.0,1,114,0.0,86.0,86.0
360.028,6,21,3981,13,3142,30002.0,494.0,494.0,8,839,51432.0,83.0,83.0
301.266,6,57,25364,30,19212,10388.0,4080.0,1497.0,27,6152,352.0,1360.0,337.0
0.004,6,10,1989,5,927,1.0,659.0,659.0,5,1062,1.0,794.0,794.0
40.052,17,10,676,5,460,10012.0,104.0,64.0,5,216,10012.0,20.0,15.0
0.006,17,2,136,1,60,0.0,32.0,32.0,1,76,0.0,48.0,48.0
0.004,6,10,2006,5,927,1.0,659.0,659.0,5,1079,1.0,811.0,811.0
40.073,17,10,676,5,460,10017.0,104.0,64.0,5,216,10017.0,20.0,15.0
60.231,6,40,10527,20,4929,471.0,1360.0,682.0,20,5598,3161.0,2667.0,435.0
0.086,6,10,1506,5,395,21.0,127.0,127.0,5,1111,19.0,843.0,843.0
0.149,17,4,596,2,122,110.0,33.0,33.0,2,474,145.0,323.0,209.0
0.013,6,10,1989,5,910,3.0,642.0,642.0,5,1079,3.0,811.0,811.0
0.145,6,10,1506,5,395,33.0,127.0,127.0,5,1111,35.0,843.0,843.0
0.001,17,2,180,1,66,0.0,38.0,38.0,1,114,0.0,86.0,86.0
0.059,6,10,1506,5,395,12.0,127.0,127.0,5,1111,14.0,843.0,843.0
0.005,6,10,2007,5,928,1.0,660.0,660.0,5,1079,1.0,811.0,811.0
0.113,6,10,1506,5,395,26.0,127.0,127.0,5,1111,23.0,843.0,843.0
0.005,6,10,1643,5,860,1.0,592.0,592.0,5,783,1.0,515.0,515.0
40.061,17,10,676,5,460,10012.0,104.0,64.0,5,216,10014.0,20.0,15.0
0.013,6,10,1677,5,827,3.0,559.0,559.0,5,850,3.0,582.0,582.0
0.005,6,10,1854,5,889,1.0,621.0,621.0,5,965,1.0,697.0,697.0
0.011,6,10,1631,5,848,2.0,580.0,580.0,5,783,2.0,515.0,515.0
0.169,6,10,1506,5,395,40.0,127.0,127.0,5,1111,39.0,843.0,843.0
0.004,6,10,1774,5,923,1.0,655.0,655.0,5,851,1.0,583.0,583.0
0.01,6,10,1972,5,910,2.0,642.0,642.0,5,1062,2.0,794.0,794.0
15.171,17,20,11161,10,7437,1682.0,1350.0,715.0,10,3724,1682.0,1350.0,344.0
0.098,6,10,1506,5,395,22.0,127.0,127.0,5,1111,22.0,843.0,843.0
0.011,6,10,1990,5,911,2.0,643.0,643.0,5,1079,2.0,811.0,811.0
0.017,6,10,1989,5,910,4.0,642.0,642.0,5,1079,4.0,811.0,811.0
0.012,6,10,1989,5,910,3.0,642.0,642.0,5,1079,3.0,811.0,811.0
300.016,6,11,891,6,552,60002.0,232.0,232.0,5,339,75003.0,83.0,83.0
0.013,17,2,152,1,56,0.0,28.0,28.0,1,96,0.0,68.0,68.0
0.004,6,10,2006,5,927,1.0,659.0,659.0,5,1079,1.0,811.0,811.0
0.146,6,10,1506,5,395,29.0,127.0,127.0,5,1111,34.0,843.0,843.0
0.004,17,2,136,1,60,0.0,32.0,32.0,1,76,0.0,48.0,48.0
0.087,6,10,1506,5,395,18.0,127.0,127.0,5,1111,18.0,843.0,843.0
0.015,6,10,1989,5,910,3.0,642.0,642.0,5,1079,3.0,811.0,811.0
0.006,6,10,1854,5,889,1.0,621.0,621.0,5,965,1.0,697.0,697.0
0.001,17,2,136,1,60,0.0,32.0,32.0,1,76,0.0,48.0,48.0
1799.275,6,243,35755,151,25972,11995.0,302.0,302.0,92,9783,19772.0,102.0,83.0
0.103,6,10,1506,5,395,23.0,127.0,127.0,5,1111,20.0,843.0,843.0
308.842,17,20,1124,10,716,34309.0,48.0,43.0,10,408,34309.0,20.0,12.0
0.009,6,10,1689,5,839,2.0,571.0,571.0,5,850,2.0,582.0,582.0
40.062,17,10,676,5,460,10012.0,104.0,64.0,5,216,10014.0,20.0,15.0
0.002,17,2,136,1,60,0.0,32.0,32.0,1,76,0.0,48.0,48.0
0.005,17,2,166,1,75,0.0,47.0,47.0,1,91,0.0,63.0,63.0
0.018,6,10,1990,5,911,4.0,643.0,643.0,5,1079,4.0,811.0,811.0
0.086,6,10,1506,5,395,18.0,127.0,127.0,5,1111,18.0,843.0,843.0
0.008,6,10,1990,5,911,1.0,643.0,643.0,5,1079,2.0,811.0,811.0
0.123,6,10,1506,5,395,27.0,127.0,127.0,5,1111,28.0,843.0,843.0
0.021,6,10,1989,5,910,5.0,642.0,642.0,5,1079,5.0,811.0,811.0
0.005,6,10,2006,5,927,1.0,659.0,659.0,5,1079,1.0,811.0,811.0
0.073,6,10,1506,5,395,16.0,127.0,127.0,5,1111,13.0,843.0,843.0
128.581,6,26,9525,12,1627,77.0,794.0,367.0,14,7898,9881.0,1360.0,732.0
0.007,17,2,132,1,58,0.0,30.0,30.0,1,74,0.0,46.0,46.0
0.005,6,10,1689,5,839,1.0,571.0,571.0,5,850,1.0,582.0,582.0
0.014,6,10,1990,5,911,3.0,643.0,643.0,5,1079,3.0,811.0,811.0
11.161,17,28,4419,14,1994,846.0,269.0,114.0,14,2425,845.0,588.0,145.0
0.009,6,10,1631,5,848,2.0,580.0,580.0,5,783,2.0,515.0,515.0
0.004,17,4,284,2,120,0.0,32.0,32.0,2,164,0.0,60.0,54.0
0.005,17,2,166,1,75,0.0,47.0,47.0,1,91,0.0,63.0,63.0
0.005,6,10,2006,5,927,1.0,659.0,659.0,5,1079,1.0,811.0,811.0
0.09,6,10,1506,5,395,20.0,127.0,127.0,5,1111,19.0,843.0,843.0
240.098,6,16,4481,9,963,30012.0,238.0,166.0,7,3518,40015.0,1402.0,786.0
0.006,6,10,2000,5,927,1.0,659.0,659.0,5,1073,1.0,805.0,805.0
0.009,6,10,1983,5,910,2.0,642.0,642.0,5,1073,2.0,805.0,805.0
0.007,6,10,1989,5,927,1.0,659.0,659.0,5,1062,1.0,794.0,794.0
300.196,6,31,11108,16,5449,20012.0,1368.0,766.0,15,5659,21442.0,1656.0,697.0
0.139,6,10,1506,5,395,33.0,127.0,127.0,5,1111,31.0,843.0,843.0
0.014,6,10,1990,5,911,3.0,643.0,643.0,5,1079,3.0,811.0,811.0
0.001,17,2,180,1,66,0.0,38.0,38.0,1,114,0.0,86.0,86.0
0.009,6,13,3747,7,509,1.0,137.0,137.0,6,3238,1.0,1470.0,1459.0
0.006,6,10,1689,5,839,1.0,571.0,571.0,5,850,1.0,582.0,582.0
15.07,17,15,9238,8,6902,2149.0,1350.0,834.0,7,2336,2506.0,1350.0,305.0
0.013,6,10,1989,5,910,3.0,642.0,642.0,5,1079,3.0,811.0,811.0
0.008,17,4,284,2,120,1.0,32.0,32.0,2,164,2.0,60.0,54.0
0.005,6,14,3799,7,509,0.0,137.0,137.0,7,3290,0.0,1448.0,972.0
0.005,6,10,2007,5,928,1.0,660.0,660.0,5,1079,1.0,811.0,811.0
175.153,17,78,10947,39,2599,4609.0,44.0,38.0,39,8348,4609.0,239.0,186.0
0.014,6,10,1989,5,910,3.0,642.0,642.0,5,1079,3.0,811.0,811.0
0.077,6,10,1506,5,395,18.0,127.0,127.0,5,1111,17.0,843.0,843.0
0.077,6,10,1506,5,395,16.0,127.0,127.0,5,1111,16.0,843.0,843.0
0.219,6,16,2669,8,1395,31.0,533.0,323.0,8,1274,19.0,529.0,212.0
0.01,6,10,1990,5,911,2.0,643.0,643.0,5,1079,2.0,811.0,811.0
240.088,6,33,9718,17,7140,15005.0,1515.0,626.0,16,2578,16005.0,580.0,217.0
0.013,6,10,1990,5,911,3.0,643.0,643.0,5,1079,3.0,811.0,811.0
310.695,17,20,1124,10,716,34507.0,48.0,43.0,10,408,34507.0,20.0,12.0
0.008,6,12,1926,6,1189,1.0,659.0,434.0,6,737,1.0,417.0,417.0
0.015,6,10,1989,5,910,3.0,642.0,642.0,5,1079,3.0,811.0,811.0
240.108,6,31,9099,15,6817,17150.0,1941.0,671.0,16,2282,16007.0,580.0,180.0
1770.487,6,83,4368,42,2210,43181.0,26.0,26.0,41,2158,44261.0,26.0,26.0
0.015,6,10,1631,5,848,3.0,580.0,580.0,5,783,3.0,515.0,515.0
0.089,6,10,1506,5,395,20.0,127.0,127.0,5,1111,20.0,843.0,843.0
0.06,17,2,152,1,76,0.0,48.0,48.0,1,76,0.0,48.0,48.0
0.071,6,10,1506,5,395,12.0,127.0,127.0,5,1111,17.0,843.0,843.0
0.009,6,10,1989,5,910,2.0,642.0,642.0,5,1079,2.0,811.0,811.0
0.011,6,10,1989,5,910,2.0,642.0,642.0,5,1079,2.0,811.0,811.0
353.217,6,20,2210,6,1308,12003.0,494.0,494.0,14,902,27170.0,83.0,83.0
0.013,17,2,152,1,56,0.0,28.0,28.0,1,96,0.0,68.0,68.0
0.007,6,10,2007,5,928,1.0,660.0,660.0,5,1079,1.0,811.0,811.0
11.158,17,28,4423,14,1995,845.0,270.0,114.0,14,2428,845.0,587.0,145.0
294.032,6,407,348379,202,22056,1462.0,2736.0,888.0,205,326323,1441.0,2804.0,1652.0
0.011,6,10,1989,5,910,2.0,642.0,642.0,5,1079,2.0,811.0,811.0
0.009,6,10,1990,5,911,2.0,643.0,643.0,5,1079,2.0,811.0,811.0
0.016,6,10,1989,5,910,3.0,642.0,642.0,5,1079,4.0,811.0,811.0
240.076,6,22,4978,12,993,21825.0,180.0,93.0,10,3985,26674.0,1593.0,576.0
0.012,6,10,1989,5,910,3.0,642.0,642.0,5,1079,3.0,811.0,811.0
11.141,17,26,4078,13,2139,919.0,586.0,136.0,13,1939,919.0,270.0,121.0
367.186,6,22,2313,16,867,24479.0,195.0,195.0,6,1446,4640.0,419.0,398.0
0.003,17,2,148,1,60,0.0,32.0,32.0,1,88,0.0,60.0,60.0
0.745,6,14,5367,8,4933,106.0,2828.0,1533.0,6,434,100.0,182.0,182.0
0.011,6,10,1972,5,910,2.0,642.0,642.0,5,1062,2.0,794.0,794.0
0.136,6,10,1506,5,395,27.0,127.0,127.0,5,1111,28.0,843.0,843.0
240.078,6,16,4481,9,963,30009.0,238.0,166.0,7,3518,40012.0,1402.0,786.0
0.005,6,10,1689,5,839,1.0,571.0,571.0,5,850,1.0,582.0,582.0
0.053,6,10,1990,5,911,13.0,643.0,643.0,5,1079,13.0,811.0,811.0
10.945,17,28,4422,14,1994,831.0,269.0,114.0,14,2428,831.0,587.0,145.0
0.215,6,16,2777,8,1395,30.0,533.0,323.0,8,1382,19.0,529.0,239.0
0.005,6,10,1689,5,839,1.0,571.0,571.0,5,850,1.0,582.0,582.0
0.008,6,10,1989,5,910,2.0,642.0,642.0,5,1079,1.0,811.0,811.0
300.328,6,16,2170,9,684,37519.0,146.0,146.0,7,1486,50025.0,419.0,398.0
0.013,6,10,1972,5,910,3.0,642.0,642.0,5,1062,3.0,794.0,794.0
15.236,17,17,8942,9,6683,1900.0,1350.0,714.0,8,2259,2172.0,1350.0,254.0
0.0,17,2,136,1,60,0.0,32.0,32.0,1,76,0.0,48.0,48.0
0.038,17,4,284,2,120,0.0,32.0,32.0,2,164,35.0,60.0,54.0
241.322,6,374,346351,187,21247,1297.0,2736.0,959.0,187,325104,1297.0,4206.0,1781.0
0.116,6,10,1506,5,395,25.0,127.0,127.0,5,1111,24.0,843.0,843.0
0.101,17,2,144,1,64,0.0,36.0,36.0,1,80,0.0,52.0,52.0
0.072,6,10,1506,5,395,16.0,127.0,127.0,5,1111,16.0,843.0,843.0
0.016,6,10,1989,5,910,4.0,642.0,642.0,5,1079,3.0,811.0,811.0
0.0,17,2,154,1,69,0.0,41.0,41.0,1,85,0.0,57.0,57.0
0.001,17,2,136,1,60,0.0,32.0,32.0,1,76,0.0,48.0,48.0
288.856,6,402,349221,191,21484,1520.0,2736.0,824.0,211,327737,1375.0,2804.0,1607.0
0.005,6,10,2006,5,927,1.0,659.0,659.0,5,1079,1.0,811.0,811.0
0.005,17,2,169,1,62,0.0,34.0,34.0,1,107,0.0,79.0,79.0
0.033,17,2,136,1,60,0.0,32.0,32.0,1,76,0.0,48.0,48.0
0.093,6,10,1506,5,395,20.0,127.0,127.0,5,1111,19.0,843.0,843.0
0.006,6,10,2007,5,928,1.0,660.0,660.0,5,1079,1.0,811.0,811.0
300.028,6,12,1782,7,1348,50004.0,494.0,494.0,5,434,75006.0,83.0,83.0
40.087,17,10,676,5,460,10020.0,104.0,64.0,5,216,10020.0,20.0,15.0
0.004,17,2,136,1,60,0.0,32.0,32.0,1,76,0.0,48.0,48.0
0.006,17,2,144,1,64,0.0,36.0,36.0,1,80,0.0,52.0,52.0
0.005,6,10,1689,5,839,1.0,571.0,571.0,5,850,1.0,582.0,582.0
300.991,6,43,12894,23,7067,13681.0,1799.0,873.0,20,5827,464.0,2667.0,385.0
0.082,6,10,1506,5,395,17.0,127.0,127.0,5,1111,18.0,843.0,843.0
0.005,6,10,2006,5,927,1.0,659.0,659.0,5,1079,1.0,811.0,811.0
0.005,6,10,2006,5,927,1.0,659.0,659.0,5,1079,1.0,811.0,811.0
0.112,6,10,1506,5,395,26.0,127.0,127.0,5,1111,25.0,843.0,843.0
0.005,6,10,2000,5,927,1.0,659.0,659.0,5,1073,1.0,805.0,805.0
0.005,6,14,3799,7,509,0.0,137.0,137.0,7,3290,0.0,1448.0,972.0
0.005,6,10,2007,5,928,1.0,660.0,660.0,5,1079,1.0,811.0,811.0
0.085,6,10,1506,5,395,18.0,127.0,127.0,5,1111,19.0,843.0,843.0
0.076,6,10,1506,5,395,15.0,127.0,127.0,5,1111,18.0,843.0,843.0
0.005,6,10,2007,5,928,1.0,660.0,660.0,5,1079,1.0,811.0,811.0
0.004,6,10,2007,5,928,1.0,660.0,660.0,5,1079,1.0,811.0,811.0
0.016,6,10,1990,5,911,3.0,643.0,643.0,5,1079,4.0,811.0,811.0
0.01,6,10,1983,5,910,2.0,642.0,642.0,5,1073,2.0,805.0,805.0
0.005,6,10,1547,5,764,1.0,496.0,496.0,5,783,1.0,515.0,515.0
40.051,17,10,676,5,460,10011.0,104.0,64.0,5,216,10012.0,20.0,15.0
0.005,6,10,2006,5,927,1.0,659.0,659.0,5,1079,1.0,811.0,811.0
0.022,6,10,1631,5,848,5.0,580.0,580.0,5,783,5.0,515.0,515.0
1730.373,6,45,2790,30,1725,59668.0,35.0,35.0,15,1065,123592.0,31.0,31.0
0.005,6,10,1989,5,927,1.0,659.0,659.0,5,1062,1.0,794.0,794.0
0.004,6,10,2006,5,927,1.0,659.0,659.0,5,1079,1.0,811.0,811.0
1756.223,6,106,6361,60,3537,29765.0,27.0,27.0,46,2824,39026.0,27.0,27.0
0.008,6,10,1989,5,910,2.0,642.0,642.0,5,1079,1.0,811.0,811.0
364.358,6,21,1793,16,1030,24290.0,190.0,190.0,5,763,60009.0,462.0,247.0
0.012,6,10,1989,5,910,3.0,642.0,642.0,5,1079,2.0,811.0,811.0
0.039,17,4,352,2,130,3.0,37.0,37.0,2,222,1.0,89.0,83.0
0.005,6,10,1989,5,927,1.0,659.0,659.0,5,1062,1.0,794.0,794.0
0.008,6,10,1989,5,910,2.0,642.0,642.0,5,1079,2.0,811.0,811.0
0.006,6,10,1547,5,764,1.0,496.0,496.0,5,783,1.0,515.0,515.0
40.063,17,10,676,5,460,10014.0,104.0,64.0,5,216,10014.0,20.0,15.0
0.014,6,10,1972,5,910,3.0,642.0,642.0,5,1062,3.0,794.0,794.0
0.018,6,10,1983,5,910,4.0,642.0,642.0,5,1073,4.0,805.0,805.0
0.001,17,2,136,1,60,0.0,32.0,32.0,1,76,0.0,48.0,48.0
0.004,6,10,1702,5,863,0.0,595.0,595.0,5,839,1.0,571.0,571.0
11.158,17,28,4422,14,1995,845.0,270.0,114.0,14,2427,845.0,586.0,145.0
0.013,6,10,1989,5,910,3.0,642.0,642.0,5,1079,3.0,811.0,811.0
0.005,6,10,2007,5,928,1.0,660.0,660.0,5,1079,1.0,811.0,811.0
0.005,17,2,164,1,74,0.0,46.0,46.0,1,90,0.0,62.0,62.0
0.005,6,10,2006,5,927,1.0,659.0,659.0,5,1079,1.0,811.0,811.0
0.13,6,10,1506,5,395,29.0,127.0,127.0,5,1111,29.0,843.0,843.0
12.448,17,42,9465,21,5174,614.0,1337.0,218.0,21,4291,614.0,863.0,176.0
0.012,6,10,1990,5,911,3.0,643.0,643.0,5,1079,2.0,811.0,811.0
240.174,6,51,7227,24,3378,10442.0,588.0,211.0,27,3849,9237.0,580.0,203.0
0.014,6,10,1983,5,910,3.0,642.0,642.0,5,1073,3.0,805.0,805.0
0.005,17,2,179,1,71,0.0,43.0,43.0,1,108,0.0,80.0,80.0
10.819,17,28,4418,14,1994,823.0,269.0,114.0,14,2424,823.0,587.0,145.0
0.081,6,10,1506,5,395,19.0,127.0,127.0,5,1111,18.0,843.0,843.0
0.111,6,10,1506,5,395,25.0,127.0,127.0,5,1111,23.0,843.0,843.0
0.011,6,10,1762,5,911,2.0,643.0,643.0,5,851,2.0,583.0,583.0
0.004,6,10,1779,5,928,1.0,660.0,660.0,5,851,1.0,583.0,583.0
0.019,17,2,164,1,74,0.0,46.0,46.0,1,90,0.0,62.0,62.0
10.82,17,28,4421,14,1993,823.0,268.0,114.0,14,2428,823.0,587.0,145.0
0.095,6,10,1506,5,395,21.0,127.0,127.0,5,1111,20.0,843.0,843.0
0.013,6,10,1990,5,911,3.0,643.0,643.0,5,1079,3.0,811.0,811.0
0.079,6,10,1506,5,395,19.0,127.0,127.0,5,1111,15.0,843.0,843.0
0.079,6,10,1506,5,395,16.0,127.0,127.0,5,1111,18.0,843.0,843.0
0.004,17,4,284,2,120,1.0,32.0,32.0,2,164,0.0,60.0,54.0
0.005,6,10,1779,5,928,1.0,660.0,660.0,5,851,1.0,583.0,583.0
0.061,6,10,1506,5,395,13.0,127.0,127.0,5,1111,14.0,843.0,843.0
0.129,6,10,1506,5,395,21.0,127.0,127.0,5,1111,28.0,843.0,843.0
0.012,6,10,1972,5,910,2.0,642.0,642.0,5,1062,2.0,794.0,794.0
0.077,6,8,3114,4,2314,25.0,1124.0,1053.0,4,800,24.0,296.0,296.0
0.005,17,2,193,1,71,0.0,43.0,43.0,1,122,0.0,94.0,94.0
0.088,6,10,1506,5,395,20.0,127.0,127.0,5,1111,20.0,843.0,843.0
0.006,17,2,166,1,75,0.0,47.0,47.0,1,91,0.0,63.0,63.0
0.75,6,22,5168,11,1138,62.0,267.0,115.0,11,4030,62.0,1414.0,597.0
0.005,6,10,1989,5,927,1.0,659.0,659.0,5,1062,1.0,794.0,794.0
0.005,6,10,1547,5,764,1.0,496.0,496.0,5,783,1.0,515.0,515.0
0.005,6,10,1989,5,927,1.0,659.0,659.0,5,1062,1.0,794.0,794.0
0.783,6,11,3130,6,1415,104.0,1163.0,1163.0,5,1715,131.0,1503.0,1503.0
0.004,17,2,144,1,64,0.0,36.0,36.0,1,80,0.0,52.0,52.0
10.748,17,28,4421,14,1993,818.0,268.0,114.0,14,2428,818.0,587.0,145.0
0.006,6,10,1547,5,764,1.0,496.0,496.0,5,783,1.0,515.0,515.0
0.012,6,10,1989,5,910,2.0,642.0,642.0,5,1079,3.0,811.0,811.0
0.015,6,10,1989,5,910,3.0,642.0,642.0,5,1079,3.0,811.0,811.0
0.001,17,2,180,1,66,0.0,38.0,38.0,1,114,0.0,86.0,86.0
0.006,17,2,144,1,64,0.0,36.0,36.0,1,80,0.0,52.0,52.0
0.019,6,10,1989,5,910,4.0,642.0,642.0,5,1079,4.0,811.0,811.0
0.006,6,10,1643,5,860,1.0,592.0,592.0,5,783,1.0,515.0,515.0
0.013,6,10,1990,5,911,3.0,643.0,643.0,5,1079,3.0,811.0,811.0
0.053,17,2,152,1,76,0.0,48.0,48.0,1,76,0.0,48.0,48.0
0.077,6,10,1506,5,395,17.0,127.0,127.0,5,1111,15.0,843.0,843.0
0.006,6,10,1689,5,839,1.0,571.0,571.0,5,850,1.0,582.0,582.0
10.874,17,28,4423,14,1994,827.0,269.0,114.0,14,2429,827.0,588.0,145.0
0.009,6,10,1990,5,911,2.0,643.0,643.0,5,1079,2.0,811.0,811.0
0.018,6,10,1677,5,827,4.0,559.0,559.0,5,850,4.0,582.0,582.0
240.142,6,31,9182,16,6904,16009.0,1977.0,607.0,15,2278,17152.0,580.0,212.0
0.005,17,2,169,1,62,0.0,34.0,34.0,1,107,0.0,79.0,79.0
0.077,6,10,1506,5,395,16.0,127.0,127.0,5,1111,17.0,843.0,843.0
40.068,17,10,676,5,460,10014.0,104.0,64.0,5,216,10016.0,20.0,15.0
0.004,6,10,2006,5,927,1.0,659.0,659.0,5,1079,1.0,811.0,811.0
0.01,6,10,1983,5,910,2.0,642.0,642.0,5,1073,2.0,805.0,805.0
0.038,17,4,352,2,130,0.0,37.0,37.0,2,222,33.0,89.0,83.0
0.004,17,4,284,2,120,0.0,32.0,32.0,2,164,1.0,60.0,54.0
0.04,17,2,182,1,65,0.0,37.0,37.0,1,117,0.0,89.0,89.0
0.005,6,10,1643,5,860,1.0,592.0,592.0,5,783,1.0,515.0,515.0
0.001,17,2,180,1,66,0.0,38.0,38.0,1,114,0.0,86.0,86.0
0.098,6,10,1506,5,395,19.0,127.0,127.0,5,1111,21.0,843.0,843.0
240.094,6,16,4481,9,963,30011.0,238.0,166.0,7,3518,40015.0,1402.0,786.0
0.005,17,2,144,1,64,0.0,36.0,36.0,1,80,0.0,52.0,52.0
0.01,17,2,170,1,65,0.0,37.0,37.0,1,105,0.0,77.0,77.0
0.005,6,10,1989,5,927,1.0,659.0,659.0,5,1062,1.0,794.0,794.0
0.13,6,10,1506,5,395,28.0,127.0,127.0,5,1111,29.0,843.0,843.0
0.113,6,10,1506,5,395,24.0,127.0,127.0,5,1111,26.0,843.0,843.0
0.004,6,10,1779,5,928,1.0,660.0,660.0,5,851,1.0,583.0,583.0
0.012,6,10,1631,5,848,3.0,580.0,580.0,5,783,3.0,515.0,515.0
0.015,6,10,1631,5,848,3.0,580.0,580.0,5,783,3.0,515.0,515.0
0.005,6,10,2006,5,927,1.0,659.0,659.0,5,1079,1.0,811.0,811.0
0.01,6,10,1990,5,911,2.0,643.0,643.0,5,1079,2.0,811.0,811.0
0.006,6,10,1689,5,839,1.0,571.0,571.0,5,850,1.0,582.0,582.0
10.749,17,28,4419,14,1994,818.0,269.0,114.0,14,2425,818.0,588.0,145.0
0.02,6,10,1972,5,910,4.0,642.0,642.0,5,1062,4.0,794.0,794.0
0.014,17,2,136,1,60,0.0,32.0,32.0,1,76,0.0,48.0,48.0
0.008,6,10,1989,5,910,2.0,642.0,642.0,5,1079,1.0,811.0,811.0
0.008,6,10,1989,5,910,1.0,642.0,642.0,5,1079,1.0,811.0,811.0
0.005,17,2,180,1,66,0.0,38.0,38.0,1,114,0.0,86.0,86.0
40.06,17,10,676,5,460,10014.0,104.0,64.0,5,216,10014.0,20.0,15.0
0.006,6,10,1854,5,889,1.0,621.0,621.0,5,965,1.0,697.0,697.0
172.07,17,100,14626,50,3373,3511.0,44.0,39.0,50,11253,3511.0,239.0,197.0
0.36,17,42,24215,24,19841,15.0,1350.0,798.0,18,4374,16.0,1350.0,215.0
300.261,6,16,2170,9,684,37511.0,146.0,146.0,7,1486,50015.0,419.0,398.0
0.01,6,10,1990,5,911,2.0,643.0,643.0,5,1079,2.0,811.0,811.0
0.004,17,2,148,1,60,0.0,32.0,32.0,1,88,0.0,60.0,60.0
0.005,6,10,1643,5,860,1.0,592.0,592.0,5,783,1.0,515.0,515.0
0.001,17,2,180,1,66,0.0,38.0,38.0,1,114,0.0,86.0,86.0
0.012,6,10,1972,5,910,3.0,642.0,642.0,5,1062,2.0,794.0,794.0
0.005,17,2,222,1,65,0.0,37.0,37.0,1,157,0.0,129.0,129.0
0.104,6,10,1506,5,395,23.0,127.0,127.0,5,1111,20.0,843.0,843.0
0.005,6,10,1689,5,839,1.0,571.0,571.0,5,850,1.0,582.0,582.0
0.01,6,10,1983,5,910,2.0,642.0,642.0,5,1073,2.0,805.0,805.0
0.006,17,2,160,1,72,0.0,44.0,44.0,1,88,0.0,60.0,60.0
0.038,17,2,166,1,75,0.0,47.0,47.0,1,91,0.0,63.0,63.0
0.004,17,4,284,2,120,1.0,32.0,32.0,2,164,0.0,60.0,54.0
0.006,17,2,154,1,69,0.0,41.0,41.0,1,85,0.0,57.0,57.0
0.13,6,10,1506,5,395,30.0,127.0,127.0,5,1111,30.0,843.0,843.0
0.018,6,10,1762,5,911,4.0,643.0,643.0,5,851,4.0,583.0,583.0
0.016,6,10,1989,5,910,3.0,642.0,642.0,5,1079,4.0,811.0,811.0
15.071,17,15,9238,8,6902,2149.0,1350.0,834.0,7,2336,2507.0,1350.0,305.0
0.031,6,10,1990,5,911,7.0,643.0,643.0,5,1079,7.0,811.0,811.0
280.673,6,32,9335,15,6905,20048.0,2029.0,681.0,17,2430,17541.0,580.0,153.0
0.005,17,2,230,1,68,0.0,40.0,40.0,1,162,0.0,134.0,134.0
0.005,6,10,2007,5,928,1.0,660.0,660.0,5,1079,1.0,811.0,811.0
0.041,17,2,152,1,76,0.0,48.0,48.0,1,76,0.0,48.0,48.0
367.272,6,22,2313,16,867,24484.0,195.0,195.0,6,1446,4635.0,419.0,398.0
15.072,17,15,9238,8,6902,2149.0,1350.0,834.0,7,2336,2507.0,1350.0,305.0
0.013,6,10,1989,5,910,3.0,642.0,642.0,5,1079,3.0,811.0,811.0
172.304,17,76,10896,38,2528,4656.0,44.0,38.0,38,8368,4656.0,261.0,192.0
0.005,6,10,2000,5,927,1.0,659.0,659.0,5,1073,1.0,805.0,805.0
269.417,6,65,31978,29,4477,9622.0,944.0,297.0,36,27501,7697.0,2790.0,948.0
0.005,6,10,1989,5,927,1.0,659.0,659.0,5,1062,1.0,794.0,794.0
1.025,6,12,3134,6,2099,154.0,1328.0,923.0,6,1035,154.0,791.0,791.0
0.005,17,2,170,1,65,0.0,37.0,37.0,1,105,0.0,77.0,77.0
371.505,6,22,2313,16,867,24767.0,195.0,195.0,6,1446,4635.0,419.0,398.0
0.004,6,14,3742,7,452,0.0,80.0,80.0,7,3290,0.0,1448.0,972.0
0.018,6,10,1990,5,911,4.0,643.0,643.0,5,1079,4.0,811.0,811.0
0.009,6,10,1990,5,911,2.0,643.0,643.0,5,1079,2.0,811.0,811.0
0.005,6,10,1689,5,839,1.0,571.0,571.0,5,850,1.0,582.0,582.0
164.239,17,76,11135,38,2529,4438.0,44.0,38.0,38,8606,4438.0,261.0,198.0
0.072,17,2,144,1,64,0.0,36.0,36.0,1,80,0.0,52.0,52.0
0.005,6,10,2007,5,928,1.0,660.0,660.0,5,1079,1.0,811.0,811.0
0.091,6,10,1506,5,395,19.0,127.0,127.0,5,1111,20.0,843.0,843.0
0.01,6,10,1989,5,910,2.0,642.0,642.0,5,1079,2.0,811.0,811.0
0.005,6,14,3736,7,446,0.0,74.0,74.0,7,3290,0.0,1448.0,972.0
0.011,6,10,1989,5,910,2.0,642.0,642.0,5,1079,2.0,811.0,811.0
0.005,6,10,2006,5,927,1.0,659.0,659.0,5,1079,1.0,811.0,811.0
0.081,6,10,1506,5,395,16.0,127.0,127.0,5,1111,17.0,843.0,843.0
1.096,6,33,13431,19,5932,60.0,1360.0,732.0,14,7499,71.0,2720.0,769.0
0.009,6,10,1972,5,910,2.0,642.0,642.0,5,1062,2.0,794.0,794.0
354.0,6,21,1795,16,1030,23600.0,190.0,190.0,5,765,60004.0,464.0,248.0
37.11,6,44,15347,22,9440,431.0,2238.0,1218.0,22,5907,1759.0,2667.0,385.0
0.005,17,2,148,1,60,0.0,32.0,32.0,1,88,0.0,60.0,60.0
240.025,6,9,787,5,488,60006.0,232.0,232.0,4,299,80005.0,83.0,83.0
0.014,6,10,1983,5,910,3.0,642.0,642.0,5,1073,3.0,805.0,805.0
0.098,6,10,1506,5,395,24.0,127.0,127.0,5,1111,23.0,843.0,843.0
0.004,6,10,2006,5,927,1.0,659.0,659.0,5,1079,1.0,811.0,811.0
0.092,6,10,1506,5,395,21.0,127.0,127.0,5,1111,19.0,843.0,843.0
0.071,6,10,1506,5,395,16.0,127.0,127.0,5,1111,15.0,843.0,843.0
0.005,6,10,2007,5,928,1.0,660.0,660.0,5,1079,1.0,811.0,811.0
0.014,6,10,1989,5,910,3.0,642.0,642.0,5,1079,3.0,811.0,811.0
0.077,6,10,1506,5,395,17.0,127.0,127.0,5,1111,18.0,843.0,843.0
0.004,6,10,2007,5,928,1.0,660.0,660.0,5,1079,1.0,811.0,811.0
0.005,6,10,2006,5,927,1.0,659.0,659.0,5,1079,1.0,811.0,811.0
0.224,6,16,2777,8,1395,32.0,533.0,323.0,8,1382,20.0,529.0,239.0
0.005,6,10,1547,5,764,1.0,496.0,496.0,5,783,1.0,515.0,515.0
0.119,6,10,1506,5,395,27.0,127.0,127.0,5,1111,23.0,843.0,843.0
240.012,6,9,787,5,488,60003.0,232.0,232.0,4,299,80003.0,83.0,83.0
11.592,17,28,4395,14,2313,879.0,588.0,137.0,14,2082,879.0,269.0,120.0
0.005,6,13,3747,7,509,0.0,137.0,137.0,6,3238,0.0,1470.0,1459.0
0.024,6,10,1990,5,911,5.0,643.0,643.0,5,1079,6.0,811.0,811.0
240.014,6,9,787,5,488,60003.0,232.0,232.0,4,299,80003.0,83.0,83.0
0.004,6,10,2007,5,928,1.0,660.0,660.0,5,1079,1.0,811.0,811.0
0.006,6,10,1689,5,839,1.0,571.0,571.0,5,850,1.0,582.0,582.0
0.005,6,10,2007,5,928,1.0,660.0,660.0,5,1079,1.0,811.0,811.0
0.008,6,10,1983,5,910,1.0,642.0,642.0,5,1073,1.0,805.0,805.0
0.006,6,10,1854,5,889,1.0,621.0,621.0,5,965,1.0,697.0,697.0
0.016,6,10,1990,5,911,4.0,643.0,643.0,5,1079,3.0,811.0,811.0
0.039,17,2,182,1,65,0.0,37.0,37.0,1,117,0.0,89.0,89.0
40.069,17,10,676,5,460,10016.0,104.0,64.0,5,216,10016.0,20.0,15.0
0.015,17,2,198,1,91,0.0,63.0,63.0,1,107,0.0,79.0,79.0
0.013,6,10,1989,5,910,3.0,642.0,642.0,5,1079,3.0,811.0,811.0
0.009,6,10,1762,5,911,2.0,643.0,643.0,5,851,2.0,583.0,583.0
1741.671,6,301,97473,187,86390,9363.0,1402.0,672.0,114,11083,15412.0,452.0,70.0
0.015,6,10,1990,5,911,3.0,643.0,643.0,5,1079,3.0,811.0,811.0
40.06,17,10,676,5,460,10014.0,104.0,64.0,5,216,10014.0,20.0,15.0
0.009,6,10,1989,5,910,2.0,642.0,642.0,5,1079,2.0,811.0,811.0
0.181,17,4,352,2,130,143.0,37.0,37.0,2,222,140.0,89.0,83.0
0.086,6,10,1506,5,395,18.0,127.0,127.0,5,1111,20.0,843.0,843.0
0.096,6,10,1506,5,395,22.0,127.0,127.0,5,1111,21.0,843.0,843.0
0.007,6,10,1547,5,764,1.0,496.0,496.0,5,783,1.0,515.0,515.0
0.012,6,10,1972,5,910,3.0,642.0,642.0,5,1062,3.0,794.0,794.0
374.407,6,22,2313,16,867,24960.0,195.0,195.0,6,1446,4636.0,419.0,398.0
0.006,6,10,1854,5,889,1.0,621.0,621.0,5,965,1.0,697.0,697.0
0.014,6,10,1989,5,910,3.0,642.0,642.0,5,1079,3.0,811.0,811.0
0.005,17,2,214,1,75,0.0,47.0,47.0,1,139,0.0,111.0,111.0
0.103,6,10,1506,5,395,22.0,127.0,127.0,5,1111,23.0,843.0,843.0
308.339,17,20,1124,10,716,34246.0,48.0,43.0,10,408,34246.0,20.0,12.0
0.01,6,10,1972,5,910,2.0,642.0,642.0,5,1062,2.0,794.0,794.0
0.013,6,10,1990,5,911,3.0,643.0,643.0,5,1079,3.0,811.0,811.0
0.097,6,10,1506,5,395,18.0,127.0,127.0,5,1111,22.0,843.0,843.0
0.015,6,10,2007,5,928,3.0,660.0,660.0,5,1079,3.0,811.0,811.0
0.016,6,10,1983,5,910,4.0,642.0,642.0,5,1073,4.0,805.0,805.0
0.01,6,10,1677,5,827,2.0,559.0,559.0,5,850,2.0,582.0,582.0
0.003,17,2,136,1,60,0.0,32.0,32.0,1,76,0.0,48.0,48.0
0.011,6,10,1989,5,910,2.0,642.0,642.0,5,1079,2.0,811.0,811.0
0.017,6,10,1631,5,848,4.0,580.0,580.0,5,783,4.0,515.0,515.0
0.813,6,38,22419,21,15766,40.0,2720.0,1241.0,17,6653,39.0,2720.0,851.0
0.013,6,10,1972,5,910,3.0,642.0,642.0,5,1062,3.0,794.0,794.0
0.009,6,10,1989,5,910,2.0,642.0,642.0,5,1079,2.0,811.0,811.0
0.002,17,2,180,1,66,0.0,38.0,38.0,1,114,0.0,86.0,86.0
0.014,6,10,1972,5,910,3.0,642.0,642.0,5,1062,3.0,794.0,794.0
0.038,17,2,152,1,76,0.0,48.0,48.0,1,76,0.0,48.0,48.0
0.005,17,2,166,1,75,0.0,47.0,47.0,1,91,0.0,63.0,63.0
0.089,6,10,1506,5,395,21.0,127.0,127.0,5,1111,18.0,843.0,843.0
53.917,17,26,14947,14,12082,4145.0,1350.0,835.0,12,2865,4898.0,1350.0,210.0
0.17,6,10,1506,5,395,40.0,127.0,127.0,5,1111,33.0,843.0,843.0
0.003,17,2,170,1,65,0.0,37.0,37.0,1,105,0.0,77.0,77.0
0.018,6,10,1990,5,911,4.0,643.0,643.0,5,1079,4.0,811.0,811.0
0.003,17,2,148,1,60,0.0,32.0,32.0,1,88,0.0,60.0,60.0
0.009,6,10,1983,5,910,2.0,642.0,642.0,5,1073,2.0,805.0,805.0
0.011,6,10,1990,5,911,2.0,643.0,643.0,5,1079,2.0,811.0,811.0
0.01,6,10,1989,5,910,2.0,642.0,642.0,5,1079,2.0,811.0,811.0
0.005,6,10,2000,5,927,1.0,659.0,659.0,5,1073,1.0,805.0,805.0
0.001,17,2,136,1,60,0.0,32.0,32.0,1,76,0.0,48.0,48.0
0.007,6,10,1547,5,764,1.0,496.0,496.0,5,783,1.0,515.0,515.0
0.001,17,2,136,1,60,0.0,32.0,32.0,1,76,0.0,48.0,48.0
300.818,6,37,9740,20,4262,15832.0,1686.0,686.0,17,5478,541.0,2667.0,435.0
0.083,6,10,1506,5,395,16.0,127.0,127.0,5,1111,17.0,843.0,843.0
0.072,17,2,412,1,61,0.0,33.0,33.0,1,351,0.0,323.0,323.0
353.564,6,20,2210,6,1308,12003.0,494.0,494.0,14,902,27197.0,83.0,83.0
0.005,6,10,1779,5,928,1.0,660.0,660.0,5,851,1.0,583.0,583.0
0.081,6,10,1506,5,395,19.0,127.0,127.0,5,1111,18.0,843.0,843.0
0.004,6,10,2006,5,927,1.0,659.0,659.0,5,1079,1.0,811.0,811.0
0.005,6,10,2007,5,928,1.0,660.0,660.0,5,1079,1.0,811.0,811.0
0.004,17,2,136,1,60,0.0,32.0,32.0,1,76,0.0,48.0,48.0
40.048,17,10,676,5,460,10011.0,104.0,64.0,5,216,10011.0,20.0,15.0
10.793,17,28,4422,14,1995,821.0,270.0,114.0,14,2427,821.0,586.0,145.0
0.089,6,10,1506,5,395,19.0,127.0,127.0,5,1111,20.0,843.0,843.0
0.015,6,13,3735,7,497,2.0,125.0,125.0,6,3238,3.0,1470.0,1459.0
0.004,6,10,1779,5,928,1.0,660.0,660.0,5,851,1.0,583.0,583.0
0.006,6,10,1689,5,839,1.0,571.0,571.0,5,850,1.0,582.0,582.0
0.006,6,10,1689,5,839,1.0,571.0,571.0,5,850,1.0,582.0,582.0
11.133,17,28,4423,14,1994,843.0,269.0,114.0,14,2429,843.0,588.0,145.0
0.005,6,10,1689,5,839,1.0,571.0,571.0,5,850,1.0,582.0,582.0
11.129,17,28,4422,14,1993,843.0,268.0,114.0,14,2429,843.0,588.0,145.0
0.007,17,2,179,1,71,0.0,43.0,43.0,1,108,0.0,80.0,80.0
0.055,6,10,1506,5,395,12.0,127.0,127.0,5,1111,12.0,843.0,843.0
262.664,6,256,201500,128,188322,8.0,3990.0,1831.0,128,13178,2068.0,1330.0,321.0
366.921,6,22,2313,16,867,24461.0,195.0,195.0,6,1446,4678.0,419.0,398.0
0.006,6,10,1689,5,839,1.0,571.0,571.0,5,850,1.0,582.0,582.0
0.005,6,10,2000,5,927,1.0,659.0,659.0,5,1073,1.0,805.0,805.0
0.02,6,10,1990,5,911,5.0,643.0,643.0,5,1079,4.0,811.0,811.0
0.004,6,10,1989,5,927,1.0,659.0,659.0,5,1062,1.0,794.0,794.0
0.004,17,2,170,1,65,0.0,37.0,37.0,1,105,0.0,77.0,77.0
0.013,6,10,1989,5,910,3.0,642.0,642.0,5,1079,3.0,811.0,811.0
0.011,6,10,1972,5,910,2.0,642.0,642.0,5,1062,2.0,794.0,794.0
0.003,17,2,132,1,58,0.0,30.0,30.0,1,74,0.0,46.0,46.0
0.008,6,10,1989,5,910,2.0,642.0,642.0,5,1079,1.0,811.0,811.0
0.085,6,10,1506,5,395,16.0,127.0,127.0,5,1111,19.0,843.0,843.0
291.767,6,405,349253,199,21913,1473.0,2736.0,889.0,206,327340,1423.0,2804.0,1649.0
0.005,6,10,2000,5,927,1.0,659.0,659.0,5,1073,1.0,805.0,805.0
0.003,17,4,284,2,120,0.0,32.0,32.0,2,164,0.0,60.0,54.0
166.343,17,78,11037,39,2601,4377.0,44.0,38.0,39,8436,4376.0,239.0,188.0
0.009,6,10,1990,5,911,2.0,643.0,643.0,5,1079,2.0,811.0,811.0
0.01,6,10,1972,5,910,2.0,642.0,642.0,5,1062,2.0,794.0,794.0
0.005,6,10,1989,5,927,1.0,659.0,659.0,5,1062,1.0,794.0,794.0
0.015,6,10,1989,5,910,3.0,642.0,642.0,5,1079,3.0,811.0,811.0
0.004,17,2,148,1,60,0.0,32.0,32.0,1,88,0.0,60.0,60.0
0.006,6,13,3747,7,509,0.0,137.0,137.0,6,3238,1.0,1470.0,1459.0
0.006,17,2,230,1,68,0.0,40.0,40.0,1,162,0.0,134.0,134.0
0.364,17,50,28272,28,23567,13.0,1350.0,813.0,22,4705,14.0,1350.0,185.0
0.029,6,10,1677,5,827,7.0,559.0,559.0,5,850,7.0,582.0,582.0
1778.322,17,147,46452,74,23384,24360.0,288.0,288.0,73,23068,24697.0,288.0,288.0
0.228,6,16,2777,8,1395,32.0,533.0,323.0,8,1382,21.0,529.0,239.0
0.016,17,2,180,1,66,0.0,38.0,38.0,1,114,0.0,86.0,86.0
0.006,6,10,1689,5,839,1.0,571.0,571.0,5,850,1.0,582.0,582.0
0.025,6,10,1972,5,910,6.0,642.0,642.0,5,1062,6.0,794.0,794.0
0.095,6,10,1506,5,395,21.0,127.0,127.0,5,1111,21.0,843.0,843.0
0.009,6,10,1989,5,910,2.0,642.0,642.0,5,1079,2.0,811.0,811.0
352.772,6,20,2210,6,1308,12007.0,494.0,494.0,14,902,27136.0,83.0,83.0
241.487,6,389,348505,185,21144,1312.0,2736.0,959.0,204,327361,1189.0,2804.0,1632.0
0.005,6,10,2007,5,928,1.0,660.0,660.0,5,1079,1.0,811.0,811.0
0.016,6,10,1677,5,827,4.0,559.0,559.0,5,850,3.0,582.0,582.0
0.006,17,2,294,1,64,0.0,36.0,36.0,1,230,0.0,202.0,202.0
0.071,17,8,3613,4,1874,23.0,1350.0,440.0,4,1739,13.0,1350.0,406.0
0.005,6,10,1547,5,764,1.0,496.0,496.0,5,783,1.0,515.0,515.0
0.006,17,2,214,1,75,0.0,47.0,47.0,1,139,0.0,111.0,111.0
0.001,17,2,180,1,65,0.0,37.0,37.0,1,115,0.0,87.0,87.0
0.004,17,4,284,2,120,0.0,32.0,32.0,2,164,0.0,60.0,54.0
0.04,17,2,186,1,61,0.0,33.0,33.0,1,125,0.0,97.0,97.0
0.004,6,14,3742,8,504,0.0,80.0,80.0,6,3238,0.0,1470.0,1459.0
15.222,17,17,8458,9,6357,1899.0,1350.0,678.0,8,2101,2170.0,1350.0,234.0
300.341,6,16,2170,9,684,37521.0,146.0,146.0,7,1486,50028.0,419.0,398.0
0.004,6,10,2006,5,927,1.0,659.0,659.0,5,1079,1.0,811.0,811.0
0.005,17,2,170,1,65,0.0,37.0,37.0,1,105,0.0,77.0,77.0
0.013,6,10,1972,5,910,3.0,642.0,642.0,5,1062,3.0,794.0,794.0
0.005,6,10,2006,5,927,1.0,659.0,659.0,5,1079,1.0,811.0,811.0
0.004,6,10,1702,5,863,1.0,595.0,595.0,5,839,0.0,571.0,571.0
0.125,6,10,1506,5,395,27.0,127.0,127.0,5,1111,28.0,843.0,843.0
0.006,6,10,1854,5,889,1.0,621.0,621.0,5,965,1.0,697.0,697.0
0.005,6,14,3742,7,452,0.0,80.0,80.0,7,3290,0.0,1448.0,972.0
15.086,17,15,8726,8,6607,2151.0,1350.0,797.0,7,2119,2509.0,1350.0,274.0
0.005,6,10,2007,5,928,1.0,660.0,660.0,5,1079,1.0,811.0,811.0
0.004,17,4,284,2,120,0.0,32.0,32.0,2,164,0.0,60.0,54.0
0.012,6,10,1989,5,910,3.0,642.0,642.0,5,1079,3.0,811.0,811.0
15.127,17,20,10888,10,7342,1677.0,1350.0,706.0,10,3546,1677.0,1350.0,326.0
0.008,17,2,166,1,75,0.0,47.0,47.0,1,91,0.0,63.0,63.0
0.005,6,10,1689,5,839,1.0,571.0,571.0,5,850,1.0,582.0,582.0
0.009,6,10,1631,5,848,2.0,580.0,580.0,5,783,2.0,515.0,515.0
0.005,6,10,2007,5,928,1.0,660.0,660.0,5,1079,1.0,811.0,811.0
0.005,6,10,2006,5,927,1.0,659.0,659.0,5,1079,1.0,811.0,811.0
0.12,6,10,1506,5,395,24.0,127.0,127.0,5,1111,25.0,843.0,843.0
40.058,17,10,676,5,460,10013.0,104.0,64.0,5,216,10013.0,20.0,15.0
0.013,6,10,1972,5,910,3.0,642.0,642.0,5,1062,3.0,794.0,794.0
0.02,6,10,1677,5,827,4.0,559.0,559.0,5,850,5.0,582.0,582.0
0.005,17,2,169,1,62,0.0,34.0,34.0,1,107,0.0,79.0,79.0
0.006,6,10,1547,5,764,1.0,496.0,496.0,5,783,1.0,515.0,515.0
0.013,6,10,1989,5,910,3.0,642.0,642.0,5,1079,3.0,811.0,811.0
0.018,6,10,1989,5,910,4.0,642.0,642.0,5,1079,4.0,811.0,811.0
240.213,6,22,7542,12,2696,21837.0,1368.0,519.0,10,4846,26690.0,1656.0,1079.0
0.001,17,2,180,1,66,0.0,38.0,38.0,1,114,0.0,86.0,86.0
0.005,6,10,1547,5,764,1.0,496.0,496.0,5,783,1.0,515.0,515.0
173.293,17,82,11630,41,2739,4332.0,44.0,38.0,41,8891,4332.0,252.0,188.0
0.005,6,10,2007,5,928,1.0,660.0,660.0,5,1079,1.0,811.0,811.0
0.005,6,14,3799,7,509,0.0,137.0,137.0,7,3290,0.0,1448.0,972.0
0.105,6,10,1506,5,395,25.0,127.0,127.0,5,1111,20.0,843.0,843.0
0.1,6,10,1506,5,395,16.0,127.0,127.0,5,1111,23.0,843.0,843.0
0.022,6,10,1677,5,827,5.0,559.0,559.0,5,850,5.0,582.0,582.0
15.073,17,14,9190,8,6902,2149.0,1350.0,834.0,6,2288,3008.0,1350.0,353.0
0.012,6,10,1989,5,910,3.0,642.0,642.0,5,1079,2.0,811.0,811.0
0.003,17,2,148,1,60,0.0,32.0,32.0,1,88,0.0,60.0,60.0
308.707,17,20,1124,10,716,34294.0,48.0,43.0,10,408,34294.0,20.0,12.0
0.004,6,10,1779,5,928,1.0,660.0,660.0,5,851,1.0,583.0,583.0
0.006,6,10,1689,5,839,1.0,571.0,571.0,5,850,1.0,582.0,582.0
9.047,17,6,376,5,280,2261.0,28.0,28.0,1,96,0.0,68.0,68.0
0.04,17,4,284,2,120,1.0,32.0,32.0,2,164,37.0,60.0,54.0
0.109,6,10,1506,5,395,21.0,127.0,127.0,5,1111,21.0,843.0,843.0
0.013,6,10,1989,5,910,3.0,642.0,642.0,5,1079,3.0,811.0,811.0
0.005,6,10,2006,5,927,1.0,659.0,659.0,5,1079,1.0,811.0,811.0
0.09,6,10,1506,5,395,17.0,127.0,127.0,5,1111,21.0,843.0,843.0
0.003,17,2,148,1,60,0.0,32.0,32.0,1,88,0.0,60.0,60.0
0.005,6,10,2006,5,927,1.0,659.0,659.0,5,1079,1.0,811.0,811.0
0.1,6,10,1506,5,395,20.0,127.0,127.0,5,1111,23.0,843.0,843.0
0.728,6,22,5072,11,1250,61.0,325.0,133.0,11,3822,61.0,1414.0,563.0
0.008,17,2,214,1,75,0.0,47.0,47.0,1,139,0.0,111.0,111.0
1778.633,17,142,44872,72,22752,25050.0,288.0,288.0,70,22120,25770.0,288.0,288.0
242.616,6,396,348859,204,22131,1195.0,2736.0,885.0,192,326728,1270.0,3123.0,1740.0
240.086,6,16,4480,9,963,30010.0,238.0,166.0,7,3517,40013.0,1402.0,786.0
0.127,17,2,170,1,65,0.0,37.0,37.0,1,105,0.0,77.0,77.0
40.05,17,10,676,5,460,10011.0,104.0,64.0,5,216,10011.0,20.0,15.0
0.107,6,10,1506,5,395,24.0,127.0,127.0,5,1111,23.0,843.0,843.0
0.083,6,10,1506,5,395,18.0,127.0,127.0,5,1111,17.0,843.0,843.0
0.004,17,2,148,1,60,0.0,32.0,32.0,1,88,0.0,60.0,60.0
0.004,6,10,1702,5,863,1.0,595.0,595.0,5,839,1.0,571.0,571.0
0.005,6,10,1689,5,839,1.0,571.0,571.0,5,850,1.0,582.0,582.0
0.005,17,2,160,1,72,0.0,44.0,44.0,1,88,0.0,60.0,60.0
0.001,17,2,136,1,60,0.0,32.0,32.0,1,76,0.0,48.0,48.0
40.082,17,10,676,5,460,10018.0,104.0,64.0,5,216,10019.0,20.0,15.0
0.011,6,10,1990,5,911,2.0,643.0,643.0,5,1079,2.0,811.0,811.0
0.005,6,13,3747,7,509,0.0,137.0,137.0,6,3238,0.0,1470.0,1459.0
5.08,6,22,6403,13,1815,423.0,801.0,282.0,9,4588,634.0,1925.0,824.0
0.066,17,8,3613,4,1874,22.0,1350.0,440.0,4,1739,11.0,1350.0,406.0
0.027,6,14,3868,7,578,4.0,206.0,206.0,7,3290,4.0,1448.0,972.0
0.014,6,10,1631,5,848,3.0,580.0,580.0,5,783,3.0,515.0,515.0
40.082,17,10,676,5,460,10018.0,104.0,64.0,5,216,10019.0,20.0,15.0
0.102,6,10,1506,5,395,22.0,127.0,127.0,5,1111,23.0,843.0,843.0
0.144,6,10,1242,5,751,36.0,495.0,495.0,5,491,33.0,223.0,223.0
0.006,6,10,1547,5,764,1.0,496.0,496.0,5,783,1.0,515.0,515.0
0.005,6,10,1989,5,927,1.0,659.0,659.0,5,1062,1.0,794.0,794.0
2.531,6,26,6262,15,2306,180.0,519.0,336.0,11,3956,241.0,1330.0,700.0
0.005,6,10,1774,5,923,1.0,655.0,655.0,5,851,1.0,583.0,583.0
0.125,6,10,1506,5,395,27.0,127.0,127.0,5,1111,28.0,843.0,843.0
0.004,6,10,2000,5,927,1.0,659.0,659.0,5,1073,1.0,805.0,805.0
0.169,17,2,152,1,76,0.0,48.0,48.0,1,76,0.0,48.0,48.0
1770.595,6,86,4575,43,2289,42156.0,27.0,26.0,43,2286,42156.0,26.0,25.0
0.0,17,2,136,1,60,0.0,32.0,32.0,1,76,0.0,48.0,48.0
0.008,6,12,1926,6,1189,1.0,659.0,434.0,6,737,1.0,417.0,417.0
0.004,6,10,2006,5,927,1.0,659.0,659.0,5,1079,1.0,811.0,811.0
0.005,6,10,1989,5,927,1.0,659.0,659.0,5,1062,1.0,794.0,794.0
0.015,6,10,1972,5,910,3.0,642.0,642.0,5,1062,3.0,794.0,794.0
0.005,17,2,212,1,74,0.0,46.0,46.0,1,138,0.0,110.0,110.0
240.089,6,16,4480,9,963,30011.0,238.0,166.0,7,3517,40014.0,1402.0,786.0
0.074,17,8,3613,4,1874,24.0,1350.0,440.0,4,1739,12.0,1350.0,406.0
10.781,17,26,4101,13,1822,889.0,269.0,112.0,13,2279,889.0,586.0,147.0
0.01,6,10,1972,5,910,2.0,642.0,642.0,5,1062,2.0,794.0,794.0
369.833,6,24,2405,17,919,23114.0,195.0,195.0,7,1486,3907.0,419.0,398.0
0.095,6,10,1506,5,395,20.0,127.0,127.0,5,1111,19.0,843.0,843.0
0.005,6,10,1854,5,889,1.0,621.0,621.0,5,965,1.0,697.0,697.0
0.004,6,10,2000,5,927,1.0,659.0,659.0,5,1073,1.0,805.0,805.0
0.007,6,10,1972,5,910,1.0,642.0,642.0,5,1062,1.0,794.0,794.0
0.013,6,10,1989,5,910,3.0,642.0,642.0,5,1079,3.0,811.0,811.0
0.22,6,16,2777,8,1395,31.0,533.0,323.0,8,1382,20.0,529.0,239.0
0.005,6,14,3736,7,446,0.0,74.0,74.0,7,3290,0.0,1448.0,972.0
0.062,6,10,1506,5,395,13.0,127.0,127.0,5,1111,14.0,843.0,843.0
0.005,6,10,2007,5,928,1.0,660.0,660.0,5,1079,1.0,811.0,811.0
0.012,6,10,1989,5,910,3.0,642.0,642.0,5,1079,2.0,811.0,811.0
0.007,17,2,179,1,71,0.0,43.0,43.0,1,108,0.0,80.0,80.0
0.005,6,10,2006,5,927,1.0,659.0,659.0,5,1079,1.0,811.0,811.0
0.004,6,10,2007,5,928,1.0,660.0,660.0,5,1079,1.0,811.0,811.0
0.013,6,10,1989,5,910,3.0,642.0,642.0,5,1079,3.0,811.0,811.0
0.017,6,10,1631,5,848,4.0,580.0,580.0,5,783,4.0,515.0,515.0
0.056,17,2,179,1,71,0.0,43.0,43.0,1,108,0.0,80.0,80.0
0.079,6,10,1506,5,395,17.0,127.0,127.0,5,1111,17.0,843.0,843.0
0.06,17,2,152,1,76,0.0,48.0,48.0,1,76,0.0,48.0,48.0
0.01,6,12,1926,6,1189,2.0,659.0,434.0,6,737,2.0,417.0,417.0
0.016,6,10,1990,5,911,4.0,643.0,643.0,5,1079,3.0,811.0,811.0
0.009,6,10,1989,5,910,2.0,642.0,642.0,5,1079,2.0,811.0,811.0
0.006,6,14,3736,7,446,0.0,74.0,74.0,7,3290,0.0,1448.0,972.0
0.004,6,10,2006,5,927,1.0,659.0,659.0,5,1079,1.0,811.0,811.0
0.004,6,10,1989,5,927,1.0,659.0,659.0,5,1062,1.0,794.0,794.0
0.006,17,2,222,1,65,0.0,37.0,37.0,1,157,0.0,129.0,129.0
0.006,6,10,1547,5,764,1.0,496.0,496.0,5,783,1.0,515.0,515.0
40.054,17,10,676,5,460,10012.0,104.0,64.0,5,216,10012.0,20.0,15.0
0.066,17,8,3613,4,1874,22.0,1350.0,440.0,4,1739,11.0,1350.0,406.0
0.004,17,4,284,2,120,0.0,32.0,32.0,2,164,1.0,60.0,54.0
0.092,6,10,1506,5,395,20.0,127.0,127.0,5,1111,20.0,843.0,843.0
0.008,6,10,1983,5,910,2.0,642.0,642.0,5,1073,2.0,805.0,805.0
0.108,6,10,1506,5,395,22.0,127.0,127.0,5,1111,23.0,843.0,843.0
1699.14,6,221,20018,85,11494,20227.0,1938.0,115.0,136,8524,12585.0,148.0,47.0
0.093,6,10,1506,5,395,21.0,127.0,127.0,5,1111,17.0,843.0,843.0
0.074,6,10,1506,5,395,14.0,127.0,127.0,5,1111,17.0,843.0,843.0
40.056,17,10,676,5,460,10013.0,104.0,64.0,5,216,10013.0,20.0,15.0
0.262,17,15,8641,8,4076,37.0,1350.0,481.0,7,4565,33.0,1350.0,624.0
0.005,6,10,2007,5,928,1.0,660.0,660.0,5,1079,1.0,811.0,811.0
0.004,6,10,1989,5,927,1.0,659.0,659.0,5,1062,1.0,794.0,794.0
0.007,17,2,299,1,65,0.0,37.0,37.0,1,234,0.0,206.0,206.0
0.001,17,2,180,1,66,0.0,38.0,38.0,1,114,0.0,86.0,86.0
0.004,6,10,2006,5,927,1.0,659.0,659.0,5,1079,1.0,811.0,811.0
0.011,6,10,1972,5,910,2.0,642.0,642.0,5,1062,2.0,794.0,794.0
0.01,6,10,1989,5,910,2.0,642.0,642.0,5,1079,2.0,811.0,811.0
0.009,6,10,1989,5,910,2.0,642.0,642.0,5,1079,2.0,811.0,811.0
0.02,6,10,1989,5,910,5.0,642.0,642.0,5,1079,4.0,811.0,811.0
0.053,17,2,152,1,76,0.0,48.0,48.0,1,76,0.0,48.0,48.0
0.005,17,2,180,1,66,0.0,38.0,38.0,1,114,0.0,86.0,86.0
0.086,6,10,1506,5,395,18.0,127.0,127.0,5,1111,20.0,843.0,843.0
0.096,6,10,1506,5,395,21.0,127.0,127.0,5,1111,20.0,843.0,843.0
0.043,17,4,352,2,130,0.0,37.0,37.0,2,222,3.0,89.0,83.0
0.005,17,2,144,1,64,0.0,36.0,36.0,1,80,0.0,52.0,52.0
240.103,6,16,4482,9,963,30012.0,238.0,166.0,7,3519,40014.0,1402.0,786.0
0.014,6,10,1989,5,910,3.0,642.0,642.0,5,1079,3.0,811.0,811.0
0.012,6,10,1989,5,910,3.0,642.0,642.0,5,1079,3.0,811.0,811.0
0.005,6,10,2000,5,927,1.0,659.0,659.0,5,1073,1.0,805.0,805.0
300.482,6,16,2170,9,684,37539.0,146.0,146.0,7,1486,50052.0,419.0,398.0
0.005,6,10,2006,5,927,1.0,659.0,659.0,5,1079,1.0,811.0,811.0
0.016,6,10,1989,5,910,4.0,642.0,642.0,5,1079,3.0,811.0,811.0
0.004,6,10,1989,5,927,1.0,659.0,659.0,5,1062,1.0,794.0,794.0
0.081,6,10,1506,5,395,17.0,127.0,127.0,5,1111,16.0,843.0,843.0
0.005,6,10,1689,5,839,1.0,571.0,571.0,5,850,1.0,582.0,582.0
0.039,17,2,184,1,61,0.0,33.0,33.0,1,123,0.0,95.0,95.0
0.008,6,10,1972,5,910,2.0,642.0,642.0,5,1062,2.0,794.0,794.0
0.008,6,10,1983,5,910,2.0,642.0,642.0,5,1073,2.0,805.0,805.0
0.005,6,10,2006,5,927,1.0,659.0,659.0,5,1079,1.0,811.0,811.0
11.172,17,28,4421,14,1993,847.0,268.0,114.0,14,2428,847.0,587.0,145.0
0.006,6,10,2006,5,927,1.0,659.0,659.0,5,1079,1.0,811.0,811.0
40.09,17,10,676,5,460,10021.0,104.0,64.0,5,216,10020.0,20.0,15.0
0.016,6,10,1989,5,910,4.0,642.0,642.0,5,1079,4.0,811.0,811.0
0.009,6,12,1926,6,1189,1.0,659.0,434.0,6,737,1.0,417.0,417.0
0.015,17,2,136,1,60,0.0,32.0,32.0,1,76,0.0,48.0,48.0
0.104,6,10,1506,5,395,25.0,127.0,127.0,5,1111,21.0,843.0,843.0
0.124,6,10,1506,5,395,25.0,127.0,127.0,5,1111,25.0,843.0,843.0
0.011,6,10,1989,5,910,2.0,642.0,642.0,5,1079,2.0,811.0,811.0
0.005,6,10,1702,5,863,1.0,595.0,595.0,5,839,1.0,571.0,571.0
0.006,6,10,1689,5,839,1.0,571.0,571.0,5,850,1.0,582.0,582.0
0.017,6,14,3787,7,497,2.0,125.0,125.0,7,3290,2.0,1448.0,972.0
0.007,17,2,194,1,59,0.0,31.0,31.0,1,135,0.0,107.0,107.0
0.008,6,10,1989,5,910,2.0,642.0,642.0,5,1079,2.0,811.0,811.0
0.008,6,10,1989,5,910,2.0,642.0,642.0,5,1079,2.0,811.0,811.0
0.056,17,2,182,1,65,0.0,37.0,37.0,1,117,0.0,89.0,89.0
0.009,6,10,1854,5,889,2.0,621.0,621.0,5,965,2.0,697.0,697.0
0.009,6,10,1989,5,910,2.0,642.0,642.0,5,1079,2.0,811.0,811.0
0.009,6,10,1989,5,910,2.0,642.0,642.0,5,1079,2.0,811.0,811.0
0.014,6,10,1631,5,848,3.0,580.0,580.0,5,783,3.0,515.0,515.0
0.017,6,10,1990,5,911,4.0,643.0,643.0,5,1079,4.0,811.0,811.0
0.106,6,10,1506,5,395,24.0,127.0,127.0,5,1111,23.0,843.0,843.0
0.005,6,10,2006,5,927,1.0,659.0,659.0,5,1079,1.0,811.0,811.0
65.827,6,27,17547,15,9603,4701.0,2804.0,1469.0,12,7944,5969.0,2315.0,1218.0
0.076,6,10,1506,5,395,18.0,127.0,127.0,5,1111,16.0,843.0,843.0
0.012,6,10,1989,5,910,3.0,642.0,642.0,5,1079,2.0,811.0,811.0
0.006,17,2,170,1,65,0.0,37.0,37.0,1,105,0.0,77.0,77.0
0.085,6,10,1506,5,395,17.0,127.0,127.0,5,1111,18.0,843.0,843.0
240.013,6,9,787,5,488,60003.0,232.0,232.0,4,299,80003.0,83.0,83.0
0.04,17,4,284,2,120,0.0,32.0,32.0,2,164,37.0,60.0,54.0
0.011,17,2,136,1,60,0.0,32.0,32.0,1,76,0.0,48.0,48.0
0.101,6,10,1506,5,395,20.0,127.0,127.0,5,1111,23.0,843.0,843.0
0.017,6,10,1989,5,910,4.0,642.0,642.0,5,1079,4.0,811.0,811.0
0.076,6,10,1506,5,395,16.0,127.0,127.0,5,1111,16.0,843.0,843.0
0.009,6,12,1926,6,1189,1.0,659.0,434.0,6,737,1.0,417.0,417.0
0.005,6,10,2006,5,927,1.0,659.0,659.0,5,1079,1.0,811.0,811.0
0.005,17,2,170,1,65,0.0,37.0,37.0,1,105,0.0,77.0,77.0
0.004,6,10,1774,5,923,1.0,655.0,655.0,5,851,1.0,583.0,583.0
40.104,17,10,676,5,460,10014.0,104.0,64.0,5,216,10022.0,20.0,15.0
0.008,17,2,194,1,59,0.0,31.0,31.0,1,135,0.0,107.0,107.0
0.216,6,16,2778,8,1396,30.0,533.0,324.0,8,1382,19.0,529.0,239.0
0.001,17,2,180,1,66,0.0,38.0,38.0,1,114,0.0,86.0,86.0
0.073,17,4,352,2,130,1.0,37.0,37.0,2,222,31.0,89.0,83.0
0.011,6,10,1990,5,911,2.0,643.0,643.0,5,1079,2.0,811.0,811.0
178.066,17,70,10007,35,2330,5237.0,44.0,38.0,35,7677,5237.0,239.0,191.0
66.578,6,95,85881,50,11720,1358.0,2832.0,1300.0,45,74161,1509.0,2804.0,1889.0
0.107,6,10,1506,5,395,25.0,127.0,127.0,5,1111,23.0,843.0,843.0
0.006,6,10,1547,5,764,1.0,496.0,496.0,5,783,1.0,515.0,515.0
0.006,6,12,1698,6,863,1.0,327.0,271.0,6,835,1.0,515.0,515.0
0.005,6,10,2007,5,928,1.0,660.0,660.0,5,1079,1.0,811.0,811.0
40.066,17,10,676,5,460,10015.0,104.0,64.0,5,216,10015.0,20.0,15.0
0.026,6,10,1631,5,848,6.0,580.0,580.0,5,783,6.0,515.0,515.0
0.011,6,10,1972,5,910,2.0,642.0,642.0,5,1062,2.0,794.0,794.0
0.016,17,2,198,1,91,0.0,63.0,63.0,1,107,0.0,79.0,79.0
0.01,6,10,1677,5,827,2.0,559.0,559.0,5,850,2.0,582.0,582.0
308.401,17,20,1124,10,716,34252.0,48.0,43.0,10,408,34252.0,20.0,12.0
0.024,6,12,1926,6,1189,4.0,659.0,434.0,6,737,4.0,417.0,417.0
0.007,17,2,222,1,65,0.0,37.0,37.0,1,157,0.0,129.0,129.0
11.184,17,28,4418,14,1994,848.0,269.0,114.0,14,2424,848.0,587.0,145.0
0.005,17,2,214,1,75,0.0,47.0,47.0,1,139,0.0,111.0,111.0
369.663,6,22,2313,16,867,24644.0,195.0,195.0,6,1446,4640.0,419.0,398.0
0.008,17,2,194,1,59,0.0,31.0,31.0,1,135,0.0,107.0,107.0
0.011,6,10,1990,5,911,2.0,643.0,643.0,5,1079,2.0,811.0,811.0
0.004,6,14,3736,7,446,0.0,74.0,74.0,7,3290,0.0,1448.0,972.0
0.019,6,10,1989,5,910,4.0,642.0,642.0,5,1079,4.0,811.0,811.0
0.009,6,12,1926,6,1189,1.0,659.0,434.0,6,737,1.0,417.0,417.0
0.005,17,2,178,1,81,0.0,53.0,53.0,1,97,0.0,69.0,69.0
0.006,6,10,1689,5,839,1.0,571.0,571.0,5,850,1.0,582.0,582.0
0.039,17,4,284,2,120,1.0,32.0,32.0,2,164,35.0,60.0,54.0
0.005,6,10,2000,5,927,1.0,659.0,659.0,5,1073,1.0,805.0,805.0
0.094,6,10,1506,5,395,20.0,127.0,127.0,5,1111,19.0,843.0,843.0
0.001,17,2,166,1,75,0.0,47.0,47.0,1,91,0.0,63.0,63.0
0.016,6,10,1972,5,910,4.0,642.0,642.0,5,1062,3.0,794.0,794.0
0.001,17,2,180,1,66,0.0,38.0,38.0,1,114,0.0,86.0,86.0
0.069,6,10,1506,5,395,16.0,127.0,127.0,5,1111,14.0,843.0,843.0
0.124,6,10,1506,5,395,29.0,127.0,127.0,5,1111,28.0,843.0,843.0
0.041,17,2,152,1,76,0.0,48.0,48.0,1,76,0.0,48.0,48.0
0.014,6,10,1989,5,910,3.0,642.0,642.0,5,1079,3.0,811.0,811.0
0.07,6,10,1506,5,395,17.0,127.0,127.0,5,1111,15.0,843.0,843.0
354.047,6,21,1795,16,1030,23603.0,190.0,190.0,5,765,60003.0,464.0,248.0
0.041,17,2,412,1,61,0.0,33.0,33.0,1,351,0.0,323.0,323.0
178.149,17,78,11401,39,2615,4688.0,44.0,39.0,39,8786,4688.0,261.0,197.0
0.021,6,10,1989,5,910,5.0,642.0,642.0,5,1079,5.0,811.0,811.0
0.008,6,12,1926,6,1189,1.0,659.0,434.0,6,737,1.0,417.0,417.0
0.107,6,10,1506,5,395,26.0,127.0,127.0,5,1111,23.0,843.0,843.0
0.237,17,39,20272,22,17093,11.0,1350.0,748.0,17,3179,11.0,1350.0,159.0
0.013,6,10,1989,5,910,3.0,642.0,642.0,5,1079,3.0,811.0,811.0
0.005,6,10,1854,5,889,1.0,621.0,621.0,5,965,1.0,697.0,697.0
0.011,6,10,1989,5,910,2.0,642.0,642.0,5,1079,2.0,811.0,811.0
120.346,6,21,8147,11,1985,83.0,1174.0,504.0,10,6162,13353.0,2720.0,958.0
308.498,17,20,1124,10,716,34263.0,48.0,43.0,10,408,34263.0,20.0,12.0
0.006,17,2,230,1,68,0.0,40.0,40.0,1,162,0.0,134.0,134.0
0.015,6,10,1989,5,910,3.0,642.0,642.0,5,1079,3.0,811.0,811.0
0.005,6,10,1774,5,923,1.0,655.0,655.0,5,851,1.0,583.0,583.0
0.011,6,10,1762,5,911,2.0,643.0,643.0,5,851,2.0,583.0,583.0
40.061,17,10,676,5,460,10012.0,104.0,64.0,5,216,10014.0,20.0,15.0
0.101,6,10,1506,5,395,23.0,127.0,127.0,5,1111,21.0,843.0,843.0
240.158,6,46,6720,22,3224,11436.0,588.0,230.0,24,3496,10441.0,580.0,203.0
0.005,6,10,1643,5,860,1.0,592.0,592.0,5,783,1.0,515.0,515.0
0.078,6,10,1506,5,395,18.0,127.0,127.0,5,1111,14.0,843.0,843.0
0.007,6,10,1762,5,911,1.0,643.0,643.0,5,851,1.0,583.0,583.0
0.01,6,10,1983,5,910,2.0,642.0,642.0,5,1073,2.0,805.0,805.0
0.097,6,10,1506,5,395,22.0,127.0,127.0,5,1111,20.0,843.0,843.0
0.099,6,10,1506,5,395,20.0,127.0,127.0,5,1111,23.0,843.0,843.0
0.009,6,10,1989,5,910,2.0,642.0,642.0,5,1079,2.0,811.0,811.0
40.068,17,10,676,5,460,10016.0,104.0,64.0,5,216,10015.0,20.0,15.0
0.012,6,10,1989,5,910,3.0,642.0,642.0,5,1079,3.0,811.0,811.0
0.005,6,10,2000,5,927,1.0,659.0,659.0,5,1073,1.0,805.0,805.0
0.021,6,10,1677,5,827,5.0,559.0,559.0,5,850,5.0,582.0,582.0
0.068,6,10,1506,5,395,14.0,127.0,127.0,5,1111,15.0,843.0,843.0
40.096,17,10,676,5,460,10022.0,104.0,64.0,5,216,10023.0,20.0,15.0
0.171,17,2,152,1,76,0.0,48.0,48.0,1,76,0.0,48.0,48.0
0.014,6,10,1983,5,910,3.0,642.0,642.0,5,1073,3.0,805.0,805.0
0.014,6,10,1762,5,911,3.0,643.0,643.0,5,851,3.0,583.0,583.0
0.072,6,10,1506,5,395,15.0,127.0,127.0,5,1111,15.0,843.0,843.0
0.004,17,4,284,2,120,0.0,32.0,32.0,2,164,1.0,60.0,54.0
240.174,6,52,25648,24,2240,10442.0,590.0,196.0,28,23408,8895.0,1577.0,1045.0
0.005,6,10,1779,5,928,1.0,660.0,660.0,5,851,1.0,583.0,583.0
0.006,6,10,1689,5,839,1.0,571.0,571.0,5,850,1.0,582.0,582.0
0.007,17,2,179,1,71,0.0,43.0,43.0,1,108,0.0,80.0,80.0
0.012,6,10,1677,5,827,2.0,559.0,559.0,5,850,3.0,582.0,582.0
0.128,6,10,1506,5,395,30.0,127.0,127.0,5,1111,26.0,843.0,843.0
1729.247,6,61,4464,41,2804,43231.0,33.0,33.0,20,1660,91004.0,31.0,31.0
0.005,17,2,170,1,65,0.0,37.0,37.0,1,105,0.0,77.0,77.0
0.005,6,10,1774,5,923,1.0,655.0,655.0,5,851,1.0,583.0,583.0
0.004,6,10,1989,5,927,1.0,659.0,659.0,5,1062,1.0,794.0,794.0
0.006,6,10,1689,5,839,1.0,571.0,571.0,5,850,1.0,582.0,582.0
0.118,17,2,80,1,32,0.0,4.0,4.0,1,48,0.0,20.0,20.0
0.005,17,2,170,1,65,0.0,37.0,37.0,1,105,0.0,77.0,77.0
0.015,6,10,1631,5,848,3.0,580.0,580.0,5,783,3.0,515.0,515.0
0.0,17,2,166,1,75,0.0,47.0,47.0,1,91,0.0,63.0,63.0
10.793,17,28,4424,14,1995,821.0,270.0,114.0,14,2429,821.0,588.0,145.0
0.006,17,2,293,1,73,0.0,45.0,45.0,1,220,0.0,192.0,192.0
0.004,6,10,1774,5,923,1.0,655.0,655.0,5,851,1.0,583.0,583.0
0.005,17,2,214,1,75,0.0,47.0,47.0,1,139,0.0,111.0,111.0
0.123,6,10,1506,5,395,28.0,127.0,127.0,5,1111,30.0,843.0,843.0
0.128,6,10,1506,5,395,25.0,127.0,127.0,5,1111,26.0,843.0,843.0
0.005,6,10,2006,5,927,1.0,659.0,659.0,5,1079,1.0,811.0,811.0
40.083,17,10,676,5,460,10018.0,104.0,64.0,5,216,10019.0,20.0,15.0
0.011,17,2,169,1,62,0.0,34.0,34.0,1,107,0.0,79.0,79.0
0.006,6,10,1547,5,764,1.0,496.0,496.0,5,783,1.0,515.0,515.0
40.05,17,10,676,5,460,10011.0,104.0,64.0,5,216,10011.0,20.0,15.0
0.017,6,10,1989,5,910,4.0,642.0,642.0,5,1079,4.0,811.0,811.0
0.005,6,13,3684,7,446,0.0,74.0,74.0,6,3238,1.0,1470.0,1459.0
240.199,6,28,10303,13,3886,20016.0,1368.0,642.0,15,6417,17156.0,1592.0,625.0
0.021,6,10,1631,5,848,5.0,580.0,580.0,5,783,5.0,515.0,515.0
9.037,17,6,376,5,280,2259.0,28.0,28.0,1,96,0.0,68.0,68.0
0.001,17,2,180,1,66,0.0,38.0,38.0,1,114,0.0,86.0,86.0
10.981,17,26,4068,13,2163,906.0,586.0,138.0,13,1905,906.0,268.0,118.0
0.005,6,10,2006,5,927,1.0,659.0,659.0,5,1079,1.0,811.0,811.0
0.091,6,10,1506,5,395,18.0,127.0,127.0,5,1111,19.0,843.0,843.0
0.005,6,10,1989,5,927,1.0,659.0,659.0,5,1062,1.0,794.0,794.0
1799.825,17,2822,216152,1400,113577,1286.0,84.0,53.0,1422,102575,1266.0,227.0,44.0
0.001,17,2,180,1,66,0.0,38.0,38.0,1,114,0.0,86.0,86.0
240.13,6,36,12320,19,3158,13340.0,1488.0,270.0,17,9162,15007.0,2804.0,825.0
0.093,6,10,1506,5,395,19.0,127.0,127.0,5,1111,20.0,843.0,843.0
0.006,6,10,1547,5,764,1.0,496.0,496.0,5,783,1.0,515.0,515.0
0.005,17,2,222,1,65,0.0,37.0,37.0,1,157,0.0,129.0,129.0
0.024,6,10,1989,5,910,6.0,642.0,642.0,5,1079,6.0,811.0,811.0
0.003,17,2,148,1,60,0.0,32.0,32.0,1,88,0.0,60.0,60.0
0.108,6,10,1506,5,395,24.0,127.0,127.0,5,1111,26.0,843.0,843.0
178.127,17,70,9955,35,2331,5238.0,44.0,38.0,35,7624,5238.0,239.0,189.0
0.009,6,7,695,4,448,3.0,232.0,232.0,3,247,2.0,83.0,83.0
0.008,6,12,1926,6,1189,1.0,659.0,434.0,6,737,1.0,417.0,417.0
0.097,6,10,1506,5,395,23.0,127.0,127.0,5,1111,21.0,843.0,843.0
0.005,17,2,169,1,62,0.0,34.0,34.0,1,107,0.0,79.0,79.0
0.007,6,10,2007,5,928,1.0,660.0,660.0,5,1079,1.0,811.0,811.0
0.006,17,2,179,1,71,0.0,43.0,43.0,1,108,0.0,80.0,80.0
0.003,17,2,148,1,60,0.0,32.0,32.0,1,88,0.0,60.0,60.0
0.005,17,2,170,1,65,0.0,37.0,37.0,1,105,0.0,77.0,77.0
300.019,6,12,1782,7,1348,50003.0,494.0,494.0,5,434,75003.0,83.0,83.0
0.01,6,10,1989,5,910,2.0,642.0,642.0,5,1079,2.0,811.0,811.0
0.006,17,2,170,1,65,0.0,37.0,37.0,1,105,0.0,77.0,77.0
0.015,6,10,1990,5,911,3.0,643.0,643.0,5,1079,3.0,811.0,811.0
0.012,6,10,1983,5,910,3.0,642.0,642.0,5,1073,3.0,805.0,805.0
0.005,6,10,2006,5,927,1.0,659.0,659.0,5,1079,1.0,811.0,811.0
352.248,6,20,2210,6,1308,12003.0,494.0,494.0,14,902,27095.0,83.0,83.0
0.001,17,2,180,1,66,0.0,38.0,38.0,1,114,0.0,86.0,86.0
0.088,6,10,1506,5,395,19.0,127.0,127.0,5,1111,21.0,843.0,843.0
0.011,6,10,1972,5,910,2.0,642.0,642.0,5,1062,2.0,794.0,794.0
0.037,17,4,284,2,120,0.0,32.0,32.0,2,164,33.0,60.0,54.0
15.072,17,15,9238,8,6902,2149.0,1350.0,834.0,7,2336,2507.0,1350.0,305.0
0.006,6,13,3747,7,509,0.0,137.0,137.0,6,3238,1.0,1470.0,1459.0
0.075,6,10,1506,5,395,18.0,127.0,127.0,5,1111,16.0,843.0,843.0
0.243,6,16,2777,8,1395,34.0,533.0,323.0,8,1382,22.0,529.0,239.0
0.005,6,10,2006,5,927,1.0,659.0,659.0,5,1079,1.0,811.0,811.0
40.085,17,10,676,5,460,10019.0,104.0,64.0,5,216,10020.0,20.0,15.0
0.012,6,10,1972,5,910,2.0,642.0,642.0,5,1062,3.0,794.0,794.0
0.014,6,10,1989,5,910,3.0,642.0,642.0,5,1079,3.0,811.0,811.0
15.075,17,15,9238,8,6902,2149.0,1350.0,834.0,7,2336,2507.0,1350.0,305.0
0.006,6,10,1854,5,889,1.0,621.0,621.0,5,965,1.0,697.0,697.0
0.005,17,2,164,1,74,0.0,46.0,46.0,1,90,0.0,62.0,62.0
0.005,6,10,2007,5,928,1.0,660.0,660.0,5,1079,1.0,811.0,811.0
40.07,17,10,676,5,460,10016.0,104.0,64.0,5,216,10016.0,20.0,15.0
0.013,6,10,1989,5,910,3.0,642.0,642.0,5,1079,3.0,811.0,811.0
0.013,6,10,1631,5,848,3.0,580.0,580.0,5,783,3.0,515.0,515.0
0.004,6,10,1774,5,923,1.0,655.0,655.0,5,851,1.0,583.0,583.0
40.065,17,10,676,5,460,10015.0,104.0,64.0,5,216,10015.0,20.0,15.0
40.066,17,10,676,5,460,10015.0,104.0,64.0,5,216,10015.0,20.0,15.0
0.005,6,10,1989,5,927,1.0,659.0,659.0,5,1062,1.0,794.0,794.0
415.569,6,41,13310,22,4232,19789.0,676.0,440.0,19,9078,19752.0,1402.0,734.0
0.006,6,10,1689,5,839,1.0,571.0,571.0,5,850,1.0,582.0,582.0
0.005,6,10,1989,5,927,1.0,659.0,659.0,5,1062,1.0,794.0,794.0
0.001,17,2,136,1,60,0.0,32.0,32.0,1,76,0.0,48.0,48.0
0.005,6,10,1989,5,927,1.0,659.0,659.0,5,1062,1.0,794.0,794.0
0.012,6,10,1989,5,910,3.0,642.0,642.0,5,1079,2.0,811.0,811.0
0.02,6,10,1990,5,911,4.0,643.0,643.0,5,1079,5.0,811.0,811.0
11.172,17,28,4419,14,1994,847.0,269.0,114.0,14,2425,846.0,588.0,145.0
0.016,6,10,1983,5,910,4.0,642.0,642.0,5,1073,4.0,805.0,805.0
0.005,6,10,2007,5,928,1.0,660.0,660.0,5,1079,1.0,811.0,811.0
0.004,17,2,169,1,62,0.0,34.0,34.0,1,107,0.0,79.0,79.0
10.916,17,28,4422,14,1994,831.0,269.0,114.0,14,2428,831.0,587.0,145.0
0.028,6,10,1972,5,910,7.0,642.0,642.0,5,1062,7.0,794.0,794.0
9.039,17,6,376,5,280,2259.0,28.0,28.0,1,96,0.0,68.0,68.0
300.992,6,44,13223,23,7356,13681.0,2720.0,914.0,21,5867,441.0,2667.0,385.0
308.717,17,20,1124,10,716,34287.0,48.0,43.0,10,408,34287.0,20.0,12.0
0.028,6,10,1972,5,910,6.0,642.0,642.0,5,1062,7.0,794.0,794.0
0.004,17,2,136,1,60,0.0,32.0,32.0,1,76,0.0,48.0,48.0
0.004,17,4,284,2,120,0.0,32.0,32.0,2,164,0.0,60.0,54.0
300.392,6,16,2170,9,684,37527.0,146.0,146.0,7,1486,50036.0,419.0,398.0
0.223,6,16,2776,8,1394,31.0,533.0,323.0,8,1382,20.0,529.0,239.0
0.154,17,2,136,1,60,0.0,32.0,32.0,1,76,0.0,48.0,48.0
0.019,6,10,1990,5,911,4.0,643.0,643.0,5,1079,4.0,811.0,811.0
0.005,6,13,3690,7,452,0.0,80.0,80.0,6,3238,1.0,1470.0,1459.0
0.004,17,4,284,2,120,0.0,32.0,32.0,2,164,0.0,60.0,54.0
0.005,6,10,2000,5,927,1.0,659.0,659.0,5,1073,1.0,805.0,805.0
0.008,17,2,194,1,59,0.0,31.0,31.0,1,135,0.0,107.0,107.0
0.004,6,10,2000,5,927,1.0,659.0,659.0,5,1073,1.0,805.0,805.0
0.127,6,10,1506,5,395,29.0,127.0,127.0,5,1111,28.0,843.0,843.0
0.014,6,10,1989,5,910,3.0,642.0,642.0,5,1079,3.0,811.0,811.0
0.005,6,10,2006,5,927,1.0,659.0,659.0,5,1079,1.0,811.0,811.0
0.003,17,2,148,1,60,0.0,32.0,32.0,1,88,0.0,60.0,60.0
0.004,17,4,284,2,120,0.0,32.0,32.0,2,164,0.0,60.0,54.0
0.071,17,2,156,1,64,0.0,36.0,36.0,1,92,0.0,64.0,64.0
0.02,6,10,1762,5,911,4.0,643.0,643.0,5,851,4.0,583.0,583.0
0.02,6,10,1990,5,911,5.0,643.0,643.0,5,1079,4.0,811.0,811.0
0.004,6,10,2007,5,928,1.0,660.0,660.0,5,1079,1.0,811.0,811.0
0.014,6,10,1762,5,911,3.0,643.0,643.0,5,851,3.0,583.0,583.0
300.109,6,19,4660,11,1102,30010.0,238.0,130.0,8,3558,42872.0,1402.0,786.0
11.505,17,28,4399,14,2313,872.0,588.0,137.0,14,2086,872.0,269.0,121.0
0.092,6,10,1506,5,395,18.0,127.0,127.0,5,1111,21.0,843.0,843.0
0.155,6,10,1506,5,395,31.0,127.0,127.0,5,1111,33.0,843.0,843.0
0.021,6,10,1990,5,911,5.0,643.0,643.0,5,1079,5.0,811.0,811.0
0.016,6,10,1990,5,911,4.0,643.0,643.0,5,1079,3.0,811.0,811.0
0.006,6,10,1854,5,889,1.0,621.0,621.0,5,965,1.0,697.0,697.0
0.079,6,10,1506,5,395,18.0,127.0,127.0,5,1111,15.0,843.0,843.0
0.014,6,10,1989,5,910,3.0,642.0,642.0,5,1079,3.0,811.0,811.0
0.006,6,10,1547,5,764,1.0,496.0,496.0,5,783,1.0,515.0,515.0
0.013,6,10,1990,5,911,3.0,643.0,643.0,5,1079,3.0,811.0,811.0
0.013,6,10,1972,5,910,3.0,642.0,642.0,5,1062,3.0,794.0,794.0
0.077,6,10,1506,5,395,17.0,127.0,127.0,5,1111,17.0,843.0,843.0
0.004,17,2,154,1,69,0.0,41.0,41.0,1,85,0.0,57.0,57.0
0.005,6,10,2000,5,927,1.0,659.0,659.0,5,1073,1.0,805.0,805.0
241.172,6,394,348238,192,21511,1262.0,2736.0,959.0,202,326727,1199.0,2804.0,1646.0
0.009,6,10,1762,5,911,2.0,643.0,643.0,5,851,2.0,583.0,583.0
0.005,6,14,3742,7,452,0.0,80.0,80.0,7,3290,0.0,1448.0,972.0
168.13,17,92,13352,46,3107,3736.0,44.0,39.0,46,10245,3736.0,239.0,194.0
0.005,6,10,2006,5,927,1.0,659.0,659.0,5,1079,1.0,811.0,811.0
0.005,6,10,1689,5,839,1.0,571.0,571.0,5,850,1.0,582.0,582.0
88.449,6,22,8496,12,2236,76.0,1345.0,574.0,10,6260,9809.0,1776.0,974.0
0.015,6,10,1972,5,910,3.0,642.0,642.0,5,1062,3.0,794.0,794.0
0.094,6,10,1506,5,395,20.0,127.0,127.0,5,1111,22.0,843.0,843.0
8.785,6,35,9731,18,4253,516.0,1498.0,875.0,17,5478,536.0,2667.0,435.0
0.005,6,10,1689,5,839,1.0,571.0,571.0,5,850,1.0,582.0,582.0
0.066,17,2,148,1,60,0.0,32.0,32.0,1,88,0.0,60.0,60.0
0.011,6,10,1972,5,910,2.0,642.0,642.0,5,1062,2.0,794.0,794.0
0.005,6,10,1989,5,927,1.0,659.0,659.0,5,1062,1.0,794.0,794.0
240.092,6,16,4481,9,963,30011.0,238.0,166.0,7,3518,40014.0,1402.0,786.0
0.004,6,10,2000,5,927,1.0,659.0,659.0,5,1073,1.0,805.0,805.0
0.005,6,10,2000,5,927,1.0,659.0,659.0,5,1073,1.0,805.0,805.0
0.219,6,16,2777,8,1395,31.0,533.0,323.0,8,1382,20.0,529.0,239.0
0.011,6,10,1677,5,827,2.0,559.0,559.0,5,850,2.0,582.0,582.0
0.004,6,10,1989,5,927,1.0,659.0,659.0,5,1062,1.0,794.0,794.0
0.024,17,2,213,1,69,0.0,41.0,41.0,1,144,0.0,116.0,116.0
0.005,6,10,1989,5,927,1.0,659.0,659.0,5,1062,1.0,794.0,794.0
0.08,6,10,1506,5,395,12.0,127.0,127.0,5,1111,18.0,843.0,843.0
0.008,6,10,1677,5,827,1.0,559.0,559.0,5,850,2.0,582.0,582.0
0.4,6,24,7644,12,1699,36.0,748.0,263.0,12,5945,36.0,2333.0,885.0
0.001,17,2,179,1,62,0.0,34.0,34.0,1,117,0.0,89.0,89.0
0.019,6,10,1983,5,910,4.0,642.0,642.0,5,1073,4.0,805.0,805.0
0.024,6,10,1989,5,910,5.0,642.0,642.0,5,1079,6.0,811.0,811.0
0.039,17,2,148,1,60,0.0,32.0,32.0,1,88,0.0,60.0,60.0
0.006,6,10,2007,5,928,1.0,660.0,660.0,5,1079,1.0,811.0,811.0
0.087,6,10,1506,5,395,18.0,127.0,127.0,5,1111,19.0,843.0,843.0
289.587,6,391,347381,199,21906,1462.0,2736.0,888.0,192,325475,1516.0,2804.0,1782.0
0.074,6,10,1506,5,395,16.0,127.0,127.0,5,1111,16.0,843.0,843.0
0.091,6,10,1506,5,395,19.0,127.0,127.0,5,1111,22.0,843.0,843.0
309.163,17,20,1124,10,716,34337.0,48.0,43.0,10,408,34337.0,20.0,12.0
0.015,17,2,198,1,91,0.0,63.0,63.0,1,107,0.0,79.0,79.0
0.013,6,10,1989,5,910,3.0,642.0,642.0,5,1079,3.0,811.0,811.0
0.005,17,2,179,1,71,0.0,43.0,43.0,1,108,0.0,80.0,80.0
40.08,17,10,676,5,460,10017.0,104.0,64.0,5,216,10019.0,20.0,15.0
0.006,6,10,1854,5,889,1.0,621.0,621.0,5,965,1.0,697.0,697.0
240.1,6,16,4481,9,963,30012.0,238.0,166.0,7,3518,40016.0,1402.0,786.0
0.095,6,10,1506,5,395,20.0,127.0,127.0,5,1111,23.0,843.0,843.0
0.011,6,10,1972,5,910,2.0,642.0,642.0,5,1062,2.0,794.0,794.0
0.009,6,10,1990,5,911,2.0,643.0,643.0,5,1079,2.0,811.0,811.0
0.072,17,2,136,1,60,0.0,32.0,32.0,1,76,0.0,48.0,48.0
0.142,6,10,1506,5,395,34.0,127.0,127.0,5,1111,33.0,843.0,843.0
0.011,6,10,1989,5,910,2.0,642.0,642.0,5,1079,2.0,811.0,811.0
0.016,6,10,1990,5,911,3.0,643.0,643.0,5,1079,3.0,811.0,811.0
0.005,6,10,1689,5,839,1.0,571.0,571.0,5,850,1.0,582.0,582.0
0.083,6,10,1506,5,395,18.0,127.0,127.0,5,1111,18.0,843.0,843.0
0.04,17,2,152,1,76,0.0,48.0,48.0,1,76,0.0,48.0,48.0
0.118,6,10,1506,5,395,28.0,127.0,127.0,5,1111,26.0,843.0,843.0
0.004,6,10,1989,5,927,1.0,659.0,659.0,5,1062,1.0,794.0,794.0
0.006,6,10,1547,5,764,1.0,496.0,496.0,5,783,1.0,515.0,515.0
0.004,17,2,136,1,60,0.0,32.0,32.0,1,76,0.0,48.0,48.0
0.004,17,2,136,1,60,0.0,32.0,32.0,1,76,0.0,48.0,48.0
0.001,17,2,136,1,60,0.0,32.0,32.0,1,76,0.0,48.0,48.0
0.014,6,10,1990,5,911,3.0,643.0,643.0,5,1079,3.0,811.0,811.0
0.09,6,10,1506,5,395,20.0,127.0,127.0,5,1111,18.0,843.0,843.0
11.177,17,28,4423,14,1995,847.0,270.0,114.0,14,2428,847.0,587.0,145.0
0.042,17,4,284,2,120,1.0,32.0,32.0,2,164,39.0,60.0,54.0
17.009,6,34,12313,19,5519,944.0,1402.0,646.0,15,6794,1205.0,1402.0,667.0
0.077,6,10,1506,5,395,15.0,127.0,127.0,5,1111,18.0,843.0,843.0
0.008,6,10,1983,5,910,2.0,642.0,642.0,5,1073,1.0,805.0,805.0
0.005,6,10,2006,5,927,1.0,659.0,659.0,5,1079,1.0,811.0,811.0
0.009,6,10,1972,5,910,2.0,642.0,642.0,5,1062,2.0,794.0,794.0
0.005,6,10,2006,5,927,1.0,659.0,659.0,5,1079,1.0,811.0,811.0
0.005,6,10,2007,5,928,1.0,660.0,660.0,5,1079,1.0,811.0,811.0
0.006,6,10,1689,5,839,1.0,571.0,571.0,5,850,1.0,582.0,582.0
0.005,17,2,169,1,62,0.0,34.0,34.0,1,107,0.0,79.0,79.0
0.103,6,10,1506,5,395,19.0,127.0,127.0,5,1111,21.0,843.0,843.0
0.108,6,10,1506,5,395,23.0,127.0,127.0,5,1111,24.0,843.0,843.0
0.005,6,10,2000,5,927,1.0,659.0,659.0,5,1073,1.0,805.0,805.0
15.125,17,47,28069,29,24932,539.0,1350.0,831.0,18,3137,888.0,1350.0,146.0
0.071,6,10,1506,5,395,17.0,127.0,127.0,5,1111,15.0,843.0,843.0
0.068,6,10,1506,5,395,15.0,127.0,127.0,5,1111,15.0,843.0,843.0
0.129,6,10,1506,5,395,27.0,127.0,127.0,5,1111,30.0,843.0,843.0
0.005,6,10,1779,5,928,1.0,660.0,660.0,5,851,1.0,583.0,583.0
0.004,6,10,2007,5,928,1.0,660.0,660.0,5,1079,1.0,811.0,811.0
0.1,6,10,1506,5,395,23.0,127.0,127.0,5,1111,22.0,843.0,843.0
0.004,17,2,136,1,60,0.0,32.0,32.0,1,76,0.0,48.0,48.0
0.008,6,10,1989,5,910,2.0,642.0,642.0,5,1079,2.0,811.0,811.0
0.004,6,10,2006,5,927,1.0,659.0,659.0,5,1079,1.0,811.0,811.0
0.005,6,10,1989,5,927,1.0,659.0,659.0,5,1062,1.0,794.0,794.0
0.02,6,10,1972,5,910,4.0,642.0,642.0,5,1062,4.0,794.0,794.0
0.134,17,2,80,1,32,0.0,4.0,4.0,1,48,0.0,20.0,20.0
142.939,6,22,9233,11,1575,89.0,794.0,367.0,11,7658,14281.0,1360.0,1029.0
0.006,6,10,1547,5,764,1.0,496.0,496.0,5,783,1.0,515.0,515.0
0.006,6,10,1854,5,889,1.0,621.0,621.0,5,965,1.0,697.0,697.0
0.013,6,10,1990,5,911,3.0,643.0,643.0,5,1079,3.0,811.0,811.0
0.006,6,10,1547,5,764,1.0,496.0,496.0,5,783,1.0,515.0,515.0
0.015,6,10,1989,5,910,3.0,642.0,642.0,5,1079,3.0,811.0,811.0
0.001,17,2,136,1,60,0.0,32.0,32.0,1,76,0.0,48.0,48.0
0.005,17,2,180,1,66,0.0,38.0,38.0,1,114,0.0,86.0,86.0
0.001,17,2,179,1,62,0.0,34.0,34.0,1,117,0.0,89.0,89.0
0.006,6,10,1547,5,764,1.0,496.0,496.0,5,783,1.0,515.0,515.0
0.05,17,2,152,1,76,0.0,48.0,48.0,1,76,0.0,48.0,48.0
0.001,17,2,136,1,60,0.0,32.0,32.0,1,76,0.0,48.0,48.0
0.014,6,10,1989,5,910,3.0,642.0,642.0,5,1079,3.0,811.0,811.0
0.003,6,10,1702,5,863,0.0,595.0,595.0,5,839,0.0,571.0,571.0
313.006,17,20,1124,10,716,34763.0,48.0,43.0,10,408,34763.0,20.0,12.0
0.372,17,41,20509,22,17085,17.0,1350.0,748.0,19,3424,16.0,1350.0,152.0
0.011,6,10,1989,5,910,2.0,642.0,642.0,5,1079,2.0,811.0,811.0
0.22,6,10,1506,5,395,47.0,127.0,127.0,5,1111,52.0,843.0,843.0
0.096,6,10,1506,5,395,22.0,127.0,127.0,5,1111,22.0,843.0,843.0
0.181,6,10,1506,5,395,42.0,127.0,127.0,5,1111,40.0,843.0,843.0
0.018,6,10,1983,5,910,4.0,642.0,642.0,5,1073,4.0,805.0,805.0
0.021,6,10,1677,5,827,5.0,559.0,559.0,5,850,5.0,582.0,582.0
0.003,17,4,284,2,120,0.0,32.0,32.0,2,164,0.0,60.0,54.0
0.004,6,10,1702,5,863,1.0,595.0,595.0,5,839,0.0,571.0,571.0
0.006,17,2,169,1,62,0.0,34.0,34.0,1,107,0.0,79.0,79.0
0.013,6,10,1989,5,910,3.0,642.0,642.0,5,1079,3.0,811.0,811.0
0.008,6,10,1989,5,927,2.0,659.0,659.0,5,1062,2.0,794.0,794.0
0.096,6,10,1506,5,395,19.0,127.0,127.0,5,1111,20.0,843.0,843.0
0.024,6,10,1605,5,388,5.0,120.0,120.0,5,1217,6.0,949.0,949.0
0.007,6,10,1547,5,764,1.0,496.0,496.0,5,783,1.0,515.0,515.0
0.014,6,10,2007,5,928,3.0,660.0,660.0,5,1079,3.0,811.0,811.0
1727.856,6,48,2957,31,1800,57595.0,35.0,35.0,17,1157,107980.0,31.0,31.0
0.011,6,10,1677,5,827,2.0,559.0,559.0,5,850,2.0,582.0,582.0
40.052,17,10,676,5,460,10012.0,104.0,64.0,5,216,10012.0,20.0,15.0
11.073,17,28,4395,14,2313,842.0,588.0,137.0,14,2082,842.0,269.0,120.0
0.001,17,2,136,1,60,0.0,32.0,32.0,1,76,0.0,48.0,48.0
0.17,17,2,152,1,76,0.0,48.0,48.0,1,76,0.0,48.0,48.0
0.008,6,10,1989,5,910,2.0,642.0,642.0,5,1079,2.0,811.0,811.0
0.097,6,10,1506,5,395,22.0,127.0,127.0,5,1111,21.0,843.0,843.0
40.068,17,10,676,5,460,10015.0,104.0,64.0,5,216,10016.0,20.0,15.0
10.846,17,28,4423,14,1994,825.0,269.0,114.0,14,2429,825.0,588.0,145.0
15.182,17,17,10021,9,6575,1894.0,1350.0,702.0,8,3446,2164.0,1350.0,402.0
0.005,17,2,170,1,65,0.0,37.0,37.0,1,105,0.0,77.0,77.0
10.813,17,28,4421,14,1993,823.0,268.0,114.0,14,2428,823.0,587.0,145.0
0.017,6,10,1972,5,910,4.0,642.0,642.0,5,1062,4.0,794.0,794.0
0.005,6,10,2000,5,927,1.0,659.0,659.0,5,1073,1.0,805.0,805.0
0.004,6,10,1779,5,928,1.0,660.0,660.0,5,851,1.0,583.0,583.0
0.093,6,10,1506,5,395,22.0,127.0,127.0,5,1111,21.0,843.0,843.0
0.01,6,10,1972,5,910,2.0,642.0,642.0,5,1062,2.0,794.0,794.0
0.01,6,6,716,3,458,3.0,302.0,302.0,3,258,3.0,102.0,102.0
1787.366,6,150,19350,90,13740,20082.0,302.0,302.0,60,5610,30294.0,83.0,83.0
0.031,17,2,214,1,75,0.0,47.0,47.0,1,139,0.0,111.0,111.0
0.001,17,2,166,1,75,0.0,47.0,47.0,1,91,0.0,63.0,63.0
1786.377,6,154,19574,92,13852,19630.0,302.0,302.0,62,5722,29284.0,83.0,83.0
177.111,17,98,14007,49,3316,3689.0,44.0,39.0,49,10691,3689.0,239.0,190.0
15.071,17,15,9239,8,6902,2149.0,1350.0,834.0,7,2337,2507.0,1350.0,305.0
277.236,6,25,7264,15,1811,19802.0,253.0,207.0,10,5453,30803.0,1402.0,703.0
0.133,17,2,136,1,60,0.0,32.0,32.0,1,76,0.0,48.0,48.0
0.092,6,10,1506,5,395,20.0,127.0,127.0,5,1111,21.0,843.0,843.0
0.014,6,10,1990,5,911,3.0,643.0,643.0,5,1079,3.0,811.0,811.0
0.005,6,10,2007,5,928,1.0,660.0,660.0,5,1079,1.0,811.0,811.0
0.001,17,2,180,1,66,0.0,38.0,38.0,1,114,0.0,86.0,86.0
0.078,6,10,1506,5,395,17.0,127.0,127.0,5,1111,17.0,843.0,843.0
300.973,6,44,18678,24,13080,13085.0,4080.0,1343.0,20,5598,464.0,2667.0,435.0
9.01,6,36,9771,19,4293,500.0,1360.0,700.0,17,5478,550.0,2667.0,435.0
0.057,6,10,1506,5,395,12.0,127.0,127.0,5,1111,12.0,843.0,843.0
0.004,17,4,284,2,120,0.0,32.0,32.0,2,164,0.0,60.0,54.0
240.086,6,16,4481,9,963,30010.0,238.0,166.0,7,3518,40014.0,1402.0,786.0
0.008,6,10,1989,5,910,2.0,642.0,642.0,5,1079,2.0,811.0,811.0
0.015,6,10,1972,5,910,3.0,642.0,642.0,5,1062,3.0,794.0,794.0
0.027,6,13,3735,7,497,4.0,125.0,125.0,6,3238,5.0,1470.0,1459.0
0.1,6,10,1506,5,395,23.0,127.0,127.0,5,1111,21.0,843.0,843.0
0.006,6,10,1854,5,889,1.0,621.0,621.0,5,965,1.0,697.0,697.0
0.004,6,10,2006,5,927,1.0,659.0,659.0,5,1079,1.0,811.0,811.0
309.775,17,20,1124,10,716,34404.0,48.0,43.0,10,408,34404.0,20.0,12.0
0.093,6,10,1506,5,395,20.0,127.0,127.0,5,1111,18.0,843.0,843.0
0.004,6,10,1774,5,923,1.0,655.0,655.0,5,851,0.0,583.0,583.0
0.012,6,10,1677,5,827,2.0,559.0,559.0,5,850,3.0,582.0,582.0
0.006,6,10,1547,5,764,1.0,496.0,496.0,5,783,1.0,515.0,515.0
0.1,6,10,1506,5,395,22.0,127.0,127.0,5,1111,21.0,843.0,843.0
0.12,6,10,1506,5,395,25.0,127.0,127.0,5,1111,26.0,843.0,843.0
0.108,6,10,1506,5,395,23.0,127.0,127.0,5,1111,24.0,843.0,843.0
0.016,17,2,198,1,91,0.0,63.0,63.0,1,107,0.0,79.0,79.0
0.016,6,13,3735,7,497,2.0,125.0,125.0,6,3238,3.0,1470.0,1459.0
0.001,17,2,180,1,66,0.0,38.0,38.0,1,114,0.0,86.0,86.0
0.004,6,10,2006,5,927,1.0,659.0,659.0,5,1079,1.0,811.0,811.0
40.069,17,10,676,5,460,10014.0,104.0,64.0,5,216,10016.0,20.0,15.0
11.178,17,28,4422,14,1994,847.0,269.0,114.0,14,2428,847.0,587.0,145.0
0.005,6,10,1547,5,764,1.0,496.0,496.0,5,783,1.0,515.0,515.0
0.005,17,2,169,1,62,0.0,34.0,34.0,1,107,0.0,79.0,79.0
290.858,6,35,10257,15,4590,20775.0,1211.0,762.0,20,5667,15308.0,1162.0,355.0
0.005,6,10,1989,5,927,1.0,659.0,659.0,5,1062,1.0,794.0,794.0
0.001,17,2,136,1,60,0.0,32.0,32.0,1,76,0.0,48.0,48.0
0.005,17,4,284,2,120,0.0,32.0,32.0,2,164,1.0,60.0,54.0
0.013,6,10,1989,5,910,3.0,642.0,642.0,5,1079,3.0,811.0,811.0
0.098,6,10,1506,5,395,21.0,127.0,127.0,5,1111,19.0,843.0,843.0
0.003,17,2,136,1,60,0.0,32.0,32.0,1,76,0.0,48.0,48.0
0.006,17,2,179,1,71,0.0,43.0,43.0,1,108,0.0,80.0,80.0
0.005,6,10,2006,5,927,1.0,659.0,659.0,5,1079,1.0,811.0,811.0
0.001,17,2,180,1,66,0.0,38.0,38.0,1,114,0.0,86.0,86.0
0.005,6,10,1989,5,927,1.0,659.0,659.0,5,1062,1.0,794.0,794.0
0.011,6,10,1990,5,911,2.0,643.0,643.0,5,1079,2.0,811.0,811.0
0.009,6,10,1990,5,911,2.0,643.0,643.0,5,1079,2.0,811.0,811.0
0.115,6,10,1506,5,395,27.0,127.0,127.0,5,1111,24.0,843.0,843.0
0.075,6,10,1506,5,395,16.0,127.0,127.0,5,1111,18.0,843.0,843.0
931.093,6,80,31993,41,7669,23277.0,676.0,551.0,39,24324,24502.0,1921.0,825.0
240.025,6,9,787,5,488,60006.0,232.0,232.0,4,299,80007.0,83.0,83.0
0.013,17,2,152,1,56,0.0,28.0,28.0,1,96,0.0,68.0,68.0
0.148,6,10,1506,5,395,31.0,127.0,127.0,5,1111,25.0,843.0,843.0
0.005,6,10,2000,5,927,1.0,659.0,659.0,5,1073,1.0,805.0,805.0
0.28,17,37,19981,21,17035,14.0,1350.0,783.0,16,2946,14.0,1350.0,156.0
0.068,17,8,3613,4,1874,22.0,1350.0,440.0,4,1739,11.0,1350.0,406.0
40.057,17,10,676,5,460,10012.0,104.0,64.0,5,216,10013.0,20.0,15.0
0.01,6,10,1983,5,910,2.0,642.0,642.0,5,1073,2.0,805.0,805.0
15.075,17,15,9239,8,6902,2149.0,1350.0,834.0,7,2337,2507.0,1350.0,305.0
0.124,6,10,1506,5,395,29.0,127.0,127.0,5,1111,24.0,843.0,843.0
0.013,6,10,1983,5,910,3.0,642.0,642.0,5,1073,3.0,805.0,805.0
0.002,17,2,136,1,60,0.0,32.0,32.0,1,76,0.0,48.0,48.0
0.111,6,10,1506,5,395,25.0,127.0,127.0,5,1111,22.0,843.0,843.0
0.004,17,2,148,1,60,0.0,32.0,32.0,1,88,0.0,60.0,60.0
0.084,6,10,1506,5,395,18.0,127.0,127.0,5,1111,14.0,843.0,843.0
0.005,6,10,2007,5,928,1.0,660.0,660.0,5,1079,1.0,811.0,811.0
300.94,6,42,11578,22,5751,14330.0,1885.0,806.0,20,5827,463.0,2667.0,385.0
0.127,17,4,596,2,122,4.0,33.0,33.0,2,474,55.0,323.0,209.0
0.001,17,2,180,1,66,0.0,38.0,38.0,1,114,0.0,86.0,86.0
0.004,6,10,1989,5,927,1.0,659.0,659.0,5,1062,1.0,794.0,794.0
0.005,6,10,2006,5,927,1.0,659.0,659.0,5,1079,1.0,811.0,811.0
0.137,17,2,80,1,32,0.0,4.0,4.0,1,48,0.0,20.0,20.0
51.023,6,384,347800,197,22453,260.0,2736.0,812.0,187,325347,274.0,4157.0,1834.0
0.015,6,10,1989,5,910,3.0,642.0,642.0,5,1079,3.0,811.0,811.0
40.084,17,10,676,5,460,10018.0,104.0,64.0,5,216,10020.0,20.0,15.0
1798.86,6,244,35804,152,26032,11912.0,302.0,302.0,92,9772,19767.0,83.0,83.0
1.357,6,33,13431,18,5892,79.0,2073.0,854.0,15,7539,83.0,2720.0,769.0
0.009,6,10,1989,5,910,2.0,642.0,642.0,5,1079,2.0,811.0,811.0
240.091,6,16,4481,9,963,30011.0,238.0,166.0,7,3518,40014.0,1402.0,786.0
0.012,6,10,1990,5,911,2.0,643.0,643.0,5,1079,2.0,811.0,811.0
0.006,6,10,1854,5,889,1.0,621.0,621.0,5,965,1.0,697.0,697.0
0.005,17,2,169,1,62,0.0,34.0,34.0,1,107,0.0,79.0,79.0
0.218,6,16,2669,8,1395,31.0,533.0,323.0,8,1274,19.0,529.0,212.0
0.061,17,2,152,1,76,0.0,48.0,48.0,1,76,0.0,48.0,48.0
0.005,6,10,2006,5,927,1.0,659.0,659.0,5,1079,1.0,811.0,811.0
0.005,6,14,3742,7,452,0.0,80.0,80.0,7,3290,0.0,1448.0,972.0
0.008,6,10,1989,5,910,2.0,642.0,642.0,5,1079,1.0,811.0,811.0
0.004,17,4,284,2,120,1.0,32.0,32.0,2,164,0.0,60.0,54.0
0.006,6,10,1643,5,860,1.0,592.0,592.0,5,783,1.0,515.0,515.0
0.119,6,10,1506,5,395,26.0,127.0,127.0,5,1111,25.0,843.0,843.0
0.003,17,2,185,1,73,0.0,45.0,45.0,1,112,0.0,84.0,84.0
0.02,6,10,1762,5,911,4.0,643.0,643.0,5,851,4.0,583.0,583.0
0.135,6,10,1506,5,395,32.0,127.0,127.0,5,1111,31.0,843.0,843.0
166.216,17,86,12495,43,2898,3957.0,44.0,39.0,43,9597,3957.0,239.0,195.0
0.005,6,10,1854,5,889,1.0,621.0,621.0,5,965,1.0,697.0,697.0
0.005,6,13,3747,7,509,0.0,137.0,137.0,6,3238,1.0,1470.0,1459.0
0.006,6,10,1547,5,764,1.0,496.0,496.0,5,783,1.0,515.0,515.0
0.006,6,10,1547,5,764,1.0,496.0,496.0,5,783,1.0,515.0,515.0
0.006,6,10,1689,5,839,1.0,571.0,571.0,5,850,1.0,582.0,582.0
0.004,17,2,136,1,60,0.0,32.0,32.0,1,76,0.0,48.0,48.0
0.006,6,10,1774,5,923,1.0,655.0,655.0,5,851,1.0,583.0,583.0
0.013,6,10,1983,5,910,3.0,642.0,642.0,5,1073,3.0,805.0,805.0
0.019,6,10,1631,5,848,4.0,580.0,580.0,5,783,4.0,515.0,515.0
0.085,6,10,1506,5,395,19.0,127.0,127.0,5,1111,19.0,843.0,843.0
0.005,6,10,2006,5,927,1.0,659.0,659.0,5,1079,1.0,811.0,811.0
0.008,6,12,1926,6,1189,1.0,659.0,434.0,6,737,1.0,417.0,417.0
0.074,6,10,1506,5,395,16.0,127.0,127.0,5,1111,14.0,843.0,843.0
0.004,6,10,1779,5,928,1.0,660.0,660.0,5,851,1.0,583.0,583.0
1622.326,6,142,18180,85,12884,19313.0,302.0,302.0,57,5296,28970.0,83.0,83.0
0.005,17,2,166,1,75,0.0,47.0,47.0,1,91,0.0,63.0,63.0
15.076,17,11,4411,5,2358,3762.0,1350.0,443.0,6,2053,3009.0,1350.0,314.0
0.003,17,2,208,1,72,0.0,44.0,44.0,1,136,0.0,108.0,108.0
0.067,17,8,3613,4,1874,22.0,1350.0,440.0,4,1739,11.0,1350.0,406.0
0.127,6,10,1506,5,395,27.0,127.0,127.0,5,1111,28.0,843.0,843.0
1778.109,17,144,45504,72,22752,25043.0,288.0,288.0,72,22752,25043.0,288.0,288.0
0.005,6,10,2006,5,927,1.0,659.0,659.0,5,1079,1.0,811.0,811.0
0.006,6,10,1689,5,839,1.0,571.0,571.0,5,850,1.0,582.0,582.0
0.012,6,10,1990,5,911,3.0,643.0,643.0,5,1079,3.0,811.0,811.0
0.004,6,10,2006,5,927,1.0,659.0,659.0,5,1079,1.0,811.0,811.0
0.11,6,10,1506,5,395,21.0,127.0,127.0,5,1111,23.0,843.0,843.0
0.016,17,2,198,1,91,0.0,63.0,63.0,1,107,0.0,79.0,79.0
0.007,6,10,1989,5,910,1.0,642.0,642.0,5,1079,1.0,811.0,811.0
0.004,6,10,1702,5,863,0.0,595.0,595.0,5,839,1.0,571.0,571.0
0.001,17,2,132,1,58,0.0,30.0,30.0,1,74,0.0,46.0,46.0
15.073,17,15,9238,8,6902,2149.0,1350.0,834.0,7,2336,2507.0,1350.0,305.0
0.006,6,10,1643,5,860,1.0,592.0,592.0,5,783,1.0,515.0,515.0
308.423,17,20,1124,10,716,34262.0,48.0,43.0,10,408,34261.0,20.0,12.0
0.006,6,10,2007,5,928,1.0,660.0,660.0,5,1079,1.0,811.0,811.0
0.013,6,10,1989,5,910,3.0,642.0,642.0,5,1079,3.0,811.0,811.0
0.008,17,2,170,1,65,0.0,37.0,37.0,1,105,0.0,77.0,77.0
40.057,17,10,676,5,460,10013.0,104.0,64.0,5,216,10013.0,20.0,15.0
0.074,6,10,1506,5,395,16.0,127.0,127.0,5,1111,16.0,843.0,843.0
66.046,6,45,17898,22,11951,431.0,4080.0,1577.0,23,5947,2994.0,2667.0,385.0
0.011,6,10,1677,5,827,2.0,559.0,559.0,5,850,2.0,582.0,582.0
0.145,6,10,1506,5,395,34.0,127.0,127.0,5,1111,33.0,843.0,843.0
0.116,6,10,1506,5,395,25.0,127.0,127.0,5,1111,22.0,843.0,843.0
0.079,6,10,1506,5,395,19.0,127.0,127.0,5,1111,19.0,843.0,843.0
0.003,17,2,152,1,76,0.0,48.0,48.0,1,76,0.0,48.0,48.0
0.006,6,10,1547,5,764,1.0,496.0,496.0,5,783,1.0,515.0,515.0
0.011,6,10,1989,5,910,2.0,642.0,642.0,5,1079,2.0,811.0,811.0
0.006,6,10,1547,5,764,1.0,496.0,496.0,5,783,1.0,515.0,515.0
0.091,6,10,1506,5,395,20.0,127.0,127.0,5,1111,20.0,843.0,843.0
0.178,6,10,1506,5,395,41.0,127.0,127.0,5,1111,34.0,843.0,843.0
0.001,17,2,180,1,66,0.0,38.0,38.0,1,114,0.0,86.0,86.0
0.001,17,2,136,1,60,0.0,32.0,32.0,1,76,0.0,48.0,48.0
0.006,17,2,148,1,60,0.0,32.0,32.0,1,88,0.0,60.0,60.0
0.001,17,2,136,1,60,0.0,32.0,32.0,1,76,0.0,48.0,48.0
240.1,6,16,4481,9,963,30012.0,238.0,166.0,7,3518,40016.0,1402.0,786.0
0.01,6,10,1990,5,911,2.0,643.0,643.0,5,1079,2.0,811.0,811.0
0.01,6,10,1990,5,911,2.0,643.0,643.0,5,1079,2.0,811.0,811.0
0.001,17,2,180,1,66,0.0,38.0,38.0,1,114,0.0,86.0,86.0
0.01,6,10,1983,5,910,2.0,642.0,642.0,5,1073,2.0,805.0,805.0
0.004,6,10,2000,5,927,1.0,659.0,659.0,5,1073,1.0,805.0,805.0
0.004,6,10,2006,5,927,1.0,659.0,659.0,5,1079,1.0,811.0,811.0
11.162,17,28,4417,14,1994,846.0,269.0,114.0,14,2423,846.0,586.0,145.0
0.011,6,10,1983,5,910,2.0,642.0,642.0,5,1073,2.0,805.0,805.0
0.007,6,10,2007,5,928,1.0,660.0,660.0,5,1079,1.0,811.0,811.0
413.651,6,29,4409,12,3102,10911.0,494.0,494.0,17,1307,25853.0,83.0,83.0
0.071,6,10,1506,5,395,15.0,127.0,127.0,5,1111,14.0,843.0,843.0
0.156,6,10,1506,5,395,36.0,127.0,127.0,5,1111,30.0,843.0,843.0
40.068,17,10,676,5,460,10016.0,104.0,64.0,5,216,10016.0,20.0,15.0
0.003,17,4,284,2,120,0.0,32.0,32.0,2,164,0.0,60.0,54.0
0.071,17,2,156,1,64,0.0,36.0,36.0,1,92,0.0,64.0,64.0
0.007,6,10,1547,5,764,1.0,496.0,496.0,5,783,1.0,515.0,515.0
0.052,6,10,1506,5,395,12.0,127.0,127.0,5,1111,12.0,843.0,843.0
0.001,17,2,180,1,66,0.0,38.0,38.0,1,114,0.0,86.0,86.0
40.07,17,10,676,5,460,10016.0,104.0,64.0,5,216,10016.0,20.0,15.0
167.225,17,72,9996,36,2396,4777.0,44.0,38.0,36,7600,4777.0,249.0,183.0
0.016,6,10,1989,5,910,4.0,642.0,642.0,5,1079,3.0,811.0,811.0
0.008,6,10,1689,5,839,2.0,571.0,571.0,5,850,2.0,582.0,582.0
0.124,6,10,1506,5,395,28.0,127.0,127.0,5,1111,29.0,843.0,843.0
0.086,17,4,596,2,122,15.0,33.0,33.0,2,474,13.0,323.0,209.0
0.085,6,10,1506,5,395,19.0,127.0,127.0,5,1111,16.0,843.0,843.0
309.21,17,20,1124,10,716,34345.0,48.0,43.0,10,408,34343.0,20.0,12.0
0.101,6,10,1506,5,395,19.0,127.0,127.0,5,1111,20.0,843.0,843.0
0.005,6,10,2007,5,928,1.0,660.0,660.0,5,1079,1.0,811.0,811.0
0.009,6,10,1989,5,910,2.0,642.0,642.0,5,1079,2.0,811.0,811.0
40.052,17,10,676,5,460,10012.0,104.0,64.0,5,216,10012.0,20.0,15.0
10.813,17,26,4102,13,1846,892.0,269.0,114.0,13,2256,892.0,587.0,145.0
0.007,6,10,2006,5,927,1.0,659.0,659.0,5,1079,1.0,811.0,811.0
0.006,17,2,148,1,60,0.0,32.0,32.0,1,88,0.0,60.0,60.0
0.005,6,10,2006,5,927,1.0,659.0,659.0,5,1079,1.0,811.0,811.0
0.009,6,10,1989,5,910,2.0,642.0,642.0,5,1079,2.0,811.0,811.0
0.005,17,2,170,1,65,0.0,37.0,37.0,1,105,0.0,77.0,77.0
670.406,6,77,29714,40,7168,17189.0,676.0,508.0,37,22546,16954.0,1402.0,792.0
177.204,17,80,11608,40,2685,4543.0,44.0,39.0,40,8923,4543.0,239.0,195.0
0.005,6,10,2000,5,927,1.0,659.0,659.0,5,1073,1.0,805.0,805.0
0.047,6,19,9922,11,704,4.0,124.0,124.0,8,9218,6.0,2896.0,2198.0
0.086,6,10,1506,5,395,19.0,127.0,127.0,5,1111,17.0,843.0,843.0
0.098,6,10,1506,5,395,20.0,127.0,127.0,5,1111,20.0,843.0,843.0
0.005,6,13,3747,7,509,0.0,137.0,137.0,6,3238,0.0,1470.0,1459.0
0.009,6,10,1631,5,848,2.0,580.0,580.0,5,783,2.0,515.0,515.0
0.01,6,10,1989,5,910,2.0,642.0,642.0,5,1079,2.0,811.0,811.0
240.015,6,9,787,5,488,60003.0,232.0,232.0,4,299,80003.0,83.0,83.0
15.085,17,16,8726,8,6522,2150.0,1350.0,787.0,8,2204,2150.0,1350.0,247.0
0.004,6,10,2007,5,928,1.0,660.0,660.0,5,1079,1.0,811.0,811.0
0.019,6,10,1972,5,910,4.0,642.0,642.0,5,1062,4.0,794.0,794.0
0.008,6,10,1990,5,911,2.0,643.0,643.0,5,1079,2.0,811.0,811.0
1770.574,6,88,4703,44,2342,41175.0,27.0,27.0,44,2361,41175.0,26.0,24.0
0.008,6,12,1926,6,1189,1.0,659.0,434.0,6,737,1.0,417.0,417.0
0.805,6,10,1809,6,1455,161.0,1203.0,1203.0,4,354,189.0,182.0,182.0
0.004,17,2,136,1,60,0.0,32.0,32.0,1,76,0.0,48.0,48.0
40.062,17,10,676,5,460,10014.0,104.0,64.0,5,216,10014.0,20.0,15.0
0.005,17,2,164,1,74,0.0,46.0,46.0,1,90,0.0,62.0,62.0
0.014,6,10,1990,5,911,3.0,643.0,643.0,5,1079,3.0,811.0,811.0
0.005,6,10,2006,5,927,1.0,659.0,659.0,5,1079,1.0,811.0,811.0
0.127,17,2,80,1,32,0.0,4.0,4.0,1,48,0.0,20.0,20.0
0.005,6,10,2000,5,927,1.0,659.0,659.0,5,1073,1.0,805.0,805.0
0.013,6,10,1990,5,911,3.0,643.0,643.0,5,1079,3.0,811.0,811.0
0.037,17,4,284,2,120,3.0,32.0,32.0,2,164,31.0,60.0,54.0
313.845,17,18,1008,9,640,39221.0,48.0,43.0,9,368,39222.0,20.0,12.0
0.04,17,4,284,2,120,0.0,32.0,32.0,2,164,36.0,60.0,54.0
0.001,17,2,140,1,62,0.0,34.0,34.0,1,78,0.0,50.0,50.0
0.01,6,10,1989,5,910,2.0,642.0,642.0,5,1079,2.0,811.0,811.0
0.111,6,10,1506,5,395,25.0,127.0,127.0,5,1111,20.0,843.0,843.0
0.005,6,10,2007,5,928,1.0,660.0,660.0,5,1079,1.0,811.0,811.0
0.007,6,10,1989,5,910,1.0,642.0,642.0,5,1079,1.0,811.0,811.0
0.138,6,10,1506,5,395,26.0,127.0,127.0,5,1111,30.0,843.0,843.0
0.005,6,10,1989,5,927,1.0,659.0,659.0,5,1062,1.0,794.0,794.0
0.111,6,10,1506,5,395,23.0,127.0,127.0,5,1111,24.0,843.0,843.0
0.013,6,10,1983,5,910,3.0,642.0,642.0,5,1073,3.0,805.0,805.0
292.582,6,384,348072,205,22227,1434.0,2692.0,889.0,179,325845,1643.0,2804.0,1918.0
333.496,6,52,21374,27,5167,12825.0,676.0,469.0,25,16207,13894.0,1402.0,931.0
0.004,17,4,284,2,120,0.0,32.0,32.0,2,164,1.0,60.0,54.0
0.005,6,14,3736,7,446,0.0,74.0,74.0,7,3290,0.0,1448.0,972.0
0.01,6,10,1990,5,911,2.0,643.0,643.0,5,1079,2.0,811.0,811.0
0.017,6,10,1989,5,910,4.0,642.0,642.0,5,1079,4.0,811.0,811.0
0.008,6,10,1983,5,910,2.0,642.0,642.0,5,1073,2.0,805.0,805.0
0.004,6,10,2006,5,927,1.0,659.0,659.0,5,1079,1.0,811.0,811.0
0.113,6,10,1506,5,395,22.0,127.0,127.0,5,1111,26.0,843.0,843.0
0.001,17,2,180,1,66,0.0,38.0,38.0,1,114,0.0,86.0,86.0
0.004,17,2,152,1,76,0.0,48.0,48.0,1,76,0.0,48.0,48.0
30.087,6,88,74420,44,3372,699.0,517.0,262.0,44,71048,699.0,2899.0,1676.0
0.014,6,10,1972,5,910,3.0,642.0,642.0,5,1062,3.0,794.0,794.0
0.004,6,10,1702,5,863,1.0,595.0,595.0,5,839,0.0,571.0,571.0
0.021,6,10,1983,5,910,5.0,642.0,642.0,5,1073,5.0,805.0,805.0
0.004,6,10,1779,5,928,1.0,660.0,660.0,5,851,1.0,583.0,583.0
0.073,6,10,1506,5,395,15.0,127.0,127.0,5,1111,17.0,843.0,843.0
2.099,6,66,35297,32,3529,67.0,517.0,266.0,34,31768,63.0,1402.0,1070.0
0.012,6,10,1989,5,910,3.0,642.0,642.0,5,1079,3.0,811.0,811.0
0.137,17,2,136,1,60,0.0,32.0,32.0,1,76,0.0,48.0,48.0
0.008,17,2,169,1,47,0.0,19.0,19.0,1,122,0.0,94.0,94.0
0.014,6,10,1989,5,910,3.0,642.0,642.0,5,1079,3.0,811.0,811.0
0.011,6,10,1989,5,910,2.0,642.0,642.0,5,1079,2.0,811.0,811.0
0.156,6,10,1506,5,395,37.0,127.0,127.0,5,1111,25.0,843.0,843.0
0.042,17,2,182,1,65,0.0,37.0,37.0,1,117,0.0,89.0,89.0
0.008,17,2,212,1,74,0.0,46.0,46.0,1,138,0.0,110.0,110.0
0.022,6,10,1989,5,910,5.0,642.0,642.0,5,1079,5.0,811.0,811.0
0.247,17,38,20031,21,17045,12.0,1350.0,783.0,17,2986,11.0,1350.0,147.0
367.017,6,22,2264,16,818,24467.0,146.0,146.0,6,1446,4634.0,419.0,398.0
40.058,17,10,676,5,460,10013.0,104.0,64.0,5,216,10012.0,20.0,15.0
11.301,17,28,4389,14,2312,860.0,587.0,137.0,14,2077,860.0,268.0,120.0
0.006,17,2,154,1,69,0.0,41.0,41.0,1,85,0.0,57.0,57.0
0.008,6,10,1989,5,910,2.0,642.0,642.0,5,1079,1.0,811.0,811.0
0.004,6,10,2006,5,927,1.0,659.0,659.0,5,1079,1.0,811.0,811.0
0.005,6,10,2006,5,927,1.0,659.0,659.0,5,1079,1.0,811.0,811.0
0.005,6,10,2006,5,927,1.0,659.0,659.0,5,1079,1.0,811.0,811.0
0.012,6,19,9922,11,704,1.0,124.0,124.0,8,9218,1.0,2896.0,2198.0
0.004,6,10,2000,5,927,1.0,659.0,659.0,5,1073,1.0,805.0,805.0
240.111,6,30,9404,15,6913,17150.0,2037.0,681.0,15,2491,17150.0,580.0,243.0
15.076,17,16,9027,8,6932,2149.0,1350.0,838.0,8,2095,2149.0,1350.0,233.0
0.07,6,10,1506,5,395,16.0,127.0,127.0,5,1111,16.0,843.0,843.0
10.846,17,28,4421,14,1994,825.0,269.0,114.0,14,2427,825.0,586.0,145.0
0.016,6,10,1972,5,910,4.0,642.0,642.0,5,1062,4.0,794.0,794.0
0.04,17,4,420,2,122,0.0,33.0,33.0,2,298,1.0,145.0,121.0
0.005,6,10,1547,5,764,1.0,496.0,496.0,5,783,1.0,515.0,515.0
0.006,6,10,1547,5,764,1.0,496.0,496.0,5,783,1.0,515.0,515.0
0.04,17,2,170,1,65,0.0,37.0,37.0,1,105,0.0,77.0,77.0
0.005,6,10,2006,5,927,1.0,659.0,659.0,5,1079,1.0,811.0,811.0
0.008,6,10,1989,5,910,2.0,642.0,642.0,5,1079,2.0,811.0,811.0
0.005,6,10,2007,5,928,1.0,660.0,660.0,5,1079,1.0,811.0,811.0
10.919,17,28,4419,14,1994,831.0,269.0,114.0,14,2425,831.0,588.0,145.0
0.099,6,10,1506,5,395,19.0,127.0,127.0,5,1111,22.0,843.0,843.0
0.008,6,10,1989,5,910,2.0,642.0,642.0,5,1079,2.0,811.0,811.0
0.072,6,10,1506,5,395,17.0,127.0,127.0,5,1111,15.0,843.0,843.0
240.035,6,9,787,5,488,60008.0,232.0,232.0,4,299,80010.0,83.0,83.0
0.01,17,2,214,1,75,0.0,47.0,47.0,1,139,0.0,111.0,111.0
0.015,6,10,1972,5,910,3.0,642.0,642.0,5,1062,3.0,794.0,794.0
0.001,17,2,142,1,63,0.0,35.0,35.0,1,79,0.0,51.0,51.0
0.001,17,2,146,1,65,0.0,37.0,37.0,1,81,0.0,53.0,53.0
0.083,6,10,1506,5,395,17.0,127.0,127.0,5,1111,19.0,843.0,843.0
0.015,6,10,1990,5,911,3.0,643.0,643.0,5,1079,3.0,811.0,811.0
0.13,6,10,1506,5,395,31.0,127.0,127.0,5,1111,29.0,843.0,843.0
0.053,17,4,284,2,120,0.0,32.0,32.0,2,164,42.0,60.0,54.0
0.003,17,2,148,1,60,0.0,32.0,32.0,1,88,0.0,60.0,60.0
0.003,17,2,136,1,60,0.0,32.0,32.0,1,76,0.0,48.0,48.0
0.116,6,10,1506,5,395,23.0,127.0,127.0,5,1111,26.0,843.0,843.0
0.001,17,2,136,1,60,0.0,32.0,32.0,1,76,0.0,48.0,48.0
0.005,17,2,169,1,62,0.0,34.0,34.0,1,107,0.0,79.0,79.0
0.008,17,2,136,1,60,0.0,32.0,32.0,1,76,0.0,48.0,48.0
0.005,6,13,3747,7,509,0.0,137.0,137.0,6,3238,1.0,1470.0,1459.0
0.071,6,10,1506,5,395,13.0,127.0,127.0,5,1111,16.0,843.0,843.0
0.005,6,10,1774,5,923,1.0,655.0,655.0,5,851,1.0,583.0,583.0
0.009,6,10,1990,5,911,2.0,643.0,643.0,5,1079,2.0,811.0,811.0
0.006,6,10,1854,5,889,1.0,621.0,621.0,5,965,1.0,697.0,697.0
11.305,17,28,4422,14,1994,854.0,269.0,114.0,14,2428,855.0,587.0,145.0
0.006,6,10,1854,5,889,1.0,621.0,621.0,5,965,1.0,697.0,697.0
0.009,6,10,1677,5,827,2.0,559.0,559.0,5,850,2.0,582.0,582.0
240.233,6,37,5156,18,2330,14131.0,588.0,196.0,19,2826,13346.0,580.0,261.0
177.622,17,76,10500,38,2550,4799.0,44.0,39.0,38,7950,4799.0,239.0,181.0
0.014,6,10,1989,5,910,3.0,642.0,642.0,5,1079,3.0,811.0,811.0
308.844,17,20,1124,10,716,34302.0,48.0,43.0,10,408,34302.0,20.0,12.0
11.244,17,28,4422,14,1995,852.0,270.0,114.0,14,2427,852.0,586.0,145.0
0.009,6,10,1972,5,910,2.0,642.0,642.0,5,1062,2.0,794.0,794.0
0.012,6,10,1983,5,910,3.0,642.0,642.0,5,1073,3.0,805.0,805.0
0.017,6,10,1989,5,910,4.0,642.0,642.0,5,1079,4.0,811.0,811.0
0.007,6,10,1983,5,910,1.0,642.0,642.0,5,1073,1.0,805.0,805.0
0.004,6,10,1774,5,923,1.0,655.0,655.0,5,851,1.0,583.0,583.0
0.081,6,10,1506,5,395,15.0,127.0,127.0,5,1111,17.0,843.0,843.0
40.084,17,10,676,5,460,10018.0,104.0,64.0,5,216,10019.0,20.0,15.0
0.006,6,10,1547,5,764,1.0,496.0,496.0,5,783,1.0,515.0,515.0
0.07,6,41,10648,23,2513,3.0,517.0,146.0,18,8135,3.0,1402.0,599.0
0.006,6,10,1689,5,839,1.0,571.0,571.0,5,850,1.0,582.0,582.0
0.013,6,10,1989,5,910,3.0,642.0,642.0,5,1079,3.0,811.0,811.0
0.001,17,2,180,1,66,0.0,38.0,38.0,1,114,0.0,86.0,86.0
0.445,17,19,12202,9,8314,55.0,1350.0,895.0,10,3888,43.0,1350.0,360.0
0.01,6,12,1926,6,1189,2.0,659.0,434.0,6,737,2.0,417.0,417.0
0.162,6,22,6483,11,2013,14.0,746.0,286.0,11,4470,15.0,1324.0,778.0
0.021,6,10,1989,5,910,5.0,642.0,642.0,5,1079,5.0,811.0,811.0
240.334,6,33,8641,17,1840,15020.0,573.0,189.0,16,6801,16022.0,1402.0,597.0
0.009,6,12,1926,6,1189,1.0,659.0,434.0,6,737,1.0,417.0,417.0
0.006,6,10,1547,5,764,1.0,496.0,496.0,5,783,1.0,515.0,515.0
9.036,17,6,376,5,280,2259.0,28.0,28.0,1,96,0.0,68.0,68.0
0.113,6,10,1506,5,395,25.0,127.0,127.0,5,1111,23.0,843.0,843.0
240.089,6,16,4480,9,963,30011.0,238.0,166.0,7,3517,40014.0,1402.0,786.0
0.005,6,10,2006,5,927,1.0,659.0,659.0,5,1079,1.0,811.0,811.0
0.001,17,2,180,1,66,0.0,38.0,38.0,1,114,0.0,86.0,86.0
0.006,6,10,1854,5,889,1.0,621.0,621.0,5,965,1.0,697.0,697.0
0.004,6,10,1702,5,863,1.0,595.0,595.0,5,839,0.0,571.0,571.0
0.07,6,10,1506,5,395,13.0,127.0,127.0,5,1111,16.0,843.0,843.0
0.006,6,10,1689,5,839,1.0,571.0,571.0,5,850,1.0,582.0,582.0
0.21,6,16,2669,8,1395,30.0,533.0,323.0,8,1274,19.0,529.0,212.0
0.015,6,14,3787,7,497,2.0,125.0,125.0,7,3290,2.0,1448.0,972.0
0.005,6,10,1689,5,839,1.0,571.0,571.0,5,850,1.0,582.0,582.0
0.008,6,10,1989,5,910,2.0,642.0,642.0,5,1079,2.0,811.0,811.0
0.069,17,8,3613,4,1874,23.0,1350.0,440.0,4,1739,11.0,1350.0,406.0
0.014,6,10,1983,5,910,3.0,642.0,642.0,5,1073,3.0,805.0,805.0
0.004,6,10,2006,5,927,1.0,659.0,659.0,5,1079,1.0,811.0,811.0
0.102,6,10,1506,5,395,23.0,127.0,127.0,5,1111,21.0,843.0,843.0
0.004,6,10,2000,5,927,1.0,659.0,659.0,5,1073,1.0,805.0,805.0
0.014,6,10,1983,5,910,3.0,642.0,642.0,5,1073,3.0,805.0,805.0
0.012,6,10,1989,5,910,3.0,642.0,642.0,5,1079,2.0,811.0,811.0
0.014,6,10,1989,5,910,3.0,642.0,642.0,5,1079,3.0,811.0,811.0
0.1,6,10,1506,5,395,23.0,127.0,127.0,5,1111,23.0,843.0,843.0
9.037,17,6,376,5,280,2259.0,28.0,28.0,1,96,0.0,68.0,68.0
0.003,17,2,136,1,60,0.0,32.0,32.0,1,76,0.0,48.0,48.0
0.005,6,10,1989,5,927,1.0,659.0,659.0,5,1062,1.0,794.0,794.0
0.005,17,2,190,1,63,0.0,35.0,35.0,1,127,0.0,99.0,99.0
0.005,6,14,3742,7,452,0.0,80.0,80.0,7,3290,0.0,1448.0,972.0
0.162,6,10,1506,5,395,36.0,127.0,127.0,5,1111,27.0,843.0,843.0
0.078,6,10,1506,5,395,18.0,127.0,127.0,5,1111,16.0,843.0,843.0
0.004,17,2,148,1,60,0.0,32.0,32.0,1,88,0.0,60.0,60.0
0.004,17,4,284,2,120,0.0,32.0,32.0,2,164,0.0,60.0,54.0
0.008,6,10,1989,5,910,2.0,642.0,642.0,5,1079,1.0,811.0,811.0
0.094,6,10,1506,5,395,21.0,127.0,127.0,5,1111,22.0,843.0,843.0
0.131,6,10,1506,5,395,26.0,127.0,127.0,5,1111,31.0,843.0,843.0
9.04,17,6,376,5,280,2260.0,28.0,28.0,1,96,0.0,68.0,68.0
371.274,6,22,2313,16,867,24751.0,195.0,195.0,6,1446,4636.0,419.0,398.0
0.127,6,10,1506,5,395,21.0,127.0,127.0,5,1111,22.0,843.0,843.0
0.004,17,4,284,2,120,0.0,32.0,32.0,2,164,0.0,60.0,54.0
0.026,6,13,3735,7,497,4.0,125.0,125.0,6,3238,5.0,1470.0,1459.0
0.005,6,10,1689,5,839,1.0,571.0,571.0,5,850,1.0,582.0,582.0
0.072,17,2,148,1,60,0.0,32.0,32.0,1,88,0.0,60.0,60.0
0.013,17,2,152,1,56,0.0,28.0,28.0,1,96,0.0,68.0,68.0
1770.466,6,84,4418,42,2210,43181.0,26.0,26.0,42,2208,43181.0,24.0,24.0
0.038,17,2,184,1,61,0.0,33.0,33.0,1,123,0.0,95.0,95.0
40.059,17,10,676,5,460,10013.0,104.0,64.0,5,216,10014.0,20.0,15.0
241.532,6,305,343958,118,17663,2064.0,2736.0,959.0,187,326295,1298.0,2828.0,1788.0
0.007,6,10,1702,5,863,1.0,595.0,595.0,5,839,1.0,571.0,571.0
40.057,17,10,676,5,460,10013.0,104.0,64.0,5,216,10013.0,20.0,15.0
0.001,17,2,180,1,66,0.0,38.0,38.0,1,114,0.0,86.0,86.0
0.042,17,2,136,1,60,0.0,32.0,32.0,1,76,0.0,48.0,48.0
0.008,6,12,1926,6,1189,1.0,659.0,434.0,6,737,1.0,417.0,417.0
0.04,17,2,136,1,60,0.0,32.0,32.0,1,76,0.0,48.0,48.0
0.069,6,10,1506,5,395,16.0,127.0,127.0,5,1111,14.0,843.0,843.0
0.005,6,10,1989,5,927,1.0,659.0,659.0,5,1062,1.0,794.0,794.0
0.241,17,15,8641,8,4076,34.0,1350.0,481.0,7,4565,30.0,1350.0,624.0
0.108,6,10,1506,5,395,26.0,127.0,127.0,5,1111,21.0,843.0,843.0
0.005,6,10,2007,5,928,1.0,660.0,660.0,5,1079,1.0,811.0,811.0
0.005,6,10,2000,5,927,1.0,659.0,659.0,5,1073,1.0,805.0,805.0
0.013,6,10,1762,5,911,3.0,643.0,643.0,5,851,3.0,583.0,583.0
0.018,6,10,1990,5,911,4.0,643.0,643.0,5,1079,4.0,811.0,811.0
0.005,6,13,3747,7,509,0.0,137.0,137.0,6,3238,1.0,1470.0,1459.0
0.009,6,12,1926,6,1189,1.0,659.0,434.0,6,737,1.0,417.0,417.0
0.005,6,10,2006,5,927,1.0,659.0,659.0,5,1079,1.0,811.0,811.0
0.014,6,10,1677,5,827,3.0,559.0,559.0,5,850,3.0,582.0,582.0
297.708,6,400,349122,189,21389,1583.0,2736.0,888.0,211,327733,1417.0,2804.0,1607.0
0.079,6,10,1506,5,395,17.0,127.0,127.0,5,1111,17.0,843.0,843.0
0.008,6,12,1926,6,1189,1.0,659.0,434.0,6,737,1.0,417.0,417.0
0.005,6,10,2007,5,928,1.0,660.0,660.0,5,1079,1.0,811.0,811.0
0.004,6,10,2006,5,927,1.0,659.0,659.0,5,1079,1.0,811.0,811.0
0.005,17,2,170,1,65,0.0,37.0,37.0,1,105,0.0,77.0,77.0
0.004,6,10,2006,5,927,1.0,659.0,659.0,5,1079,1.0,811.0,811.0
0.743,6,28,12498,15,6005,53.0,2720.0,895.0,13,6493,47.0,2720.0,851.0
0.004,17,2,136,1,60,0.0,32.0,32.0,1,76,0.0,48.0,48.0
0.081,6,10,1506,5,395,18.0,127.0,127.0,5,1111,18.0,843.0,843.0
0.007,6,10,1854,5,889,1.0,621.0,621.0,5,965,1.0,697.0,697.0
0.005,6,10,1689,5,839,1.0,571.0,571.0,5,850,1.0,582.0,582.0
15.036,17,40,20313,22,17082,714.0,1350.0,748.0,18,3231,882.0,1350.0,151.0
1.208,6,32,6224,17,1298,75.0,267.0,195.0,15,4926,77.0,1823.0,392.0
0.014,6,13,3735,7,497,2.0,125.0,125.0,6,3238,2.0,1470.0,1459.0
0.054,17,2,152,1,76,0.0,48.0,48.0,1,76,0.0,48.0,48.0
0.104,6,10,1506,5,395,23.0,127.0,127.0,5,1111,23.0,843.0,843.0
0.004,6,10,1702,5,863,1.0,595.0,595.0,5,839,1.0,571.0,571.0
0.023,6,10,1989,5,910,5.0,642.0,642.0,5,1079,5.0,811.0,811.0
0.004,17,2,170,1,65,0.0,37.0,37.0,1,105,0.0,77.0,77.0
0.127,6,10,1506,5,395,29.0,127.0,127.0,5,1111,30.0,843.0,843.0
0.22,6,16,2669,8,1395,31.0,533.0,323.0,8,1274,20.0,529.0,212.0
0.016,6,10,1983,5,910,4.0,642.0,642.0,5,1073,3.0,805.0,805.0
0.114,6,10,1506,5,395,26.0,127.0,127.0,5,1111,25.0,843.0,843.0
0.005,6,10,1689,5,839,1.0,571.0,571.0,5,850,1.0,582.0,582.0
75.714,6,26,9525,12,1627,83.0,794.0,367.0,14,7898,5814.0,1360.0,732.0
0.082,6,10,1506,5,395,18.0,127.0,127.0,5,1111,19.0,843.0,843.0
0.014,6,10,1990,5,911,3.0,643.0,643.0,5,1079,3.0,811.0,811.0
0.005,6,10,2006,5,927,1.0,659.0,659.0,5,1079,1.0,811.0,811.0
0.005,6,10,1989,5,927,1.0,659.0,659.0,5,1062,1.0,794.0,794.0
0.01,6,10,1989,5,910,2.0,642.0,642.0,5,1079,2.0,811.0,811.0
0.233,6,16,2777,8,1395,33.0,533.0,323.0,8,1382,21.0,529.0,239.0
0.008,6,10,1972,5,910,2.0,642.0,642.0,5,1062,2.0,794.0,794.0
0.096,6,10,1506,5,395,22.0,127.0,127.0,5,1111,22.0,843.0,843.0
0.012,6,10,1631,5,848,3.0,580.0,580.0,5,783,2.0,515.0,515.0
0.005,17,4,284,2,120,1.0,32.0,32.0,2,164,1.0,60.0,54.0
0.006,17,2,136,1,60,0.0,32.0,32.0,1,76,0.0,48.0,48.0
0.106,6,10,1506,5,395,24.0,127.0,127.0,5,1111,21.0,843.0,843.0
0.096,6,10,1506,5,395,20.0,127.0,127.0,5,1111,23.0,843.0,843.0
0.02,6,10,1989,5,910,5.0,642.0,642.0,5,1079,5.0,811.0,811.0
0.146,6,10,1506,5,395,36.0,127.0,127.0,5,1111,31.0,843.0,843.0
0.004,6,10,2006,5,927,1.0,659.0,659.0,5,1079,1.0,811.0,811.0
0.007,6,10,1547,5,764,1.0,496.0,496.0,5,783,1.0,515.0,515.0
0.09,6,10,1506,5,395,21.0,127.0,127.0,5,1111,19.0,843.0,843.0
0.005,6,10,1689,5,839,1.0,571.0,571.0,5,850,1.0,582.0,582.0
0.011,6,10,1972,5,910,2.0,642.0,642.0,5,1062,2.0,794.0,794.0
0.006,6,10,1547,5,764,1.0,496.0,496.0,5,783,1.0,515.0,515.0
0.017,6,10,1972,5,910,4.0,642.0,642.0,5,1062,4.0,794.0,794.0
0.015,6,10,1989,5,910,3.0,642.0,642.0,5,1079,3.0,811.0,811.0
0.014,6,10,1989,5,910,3.0,642.0,642.0,5,1079,3.0,811.0,811.0
240.24,6,33,9672,16,1763,16015.0,539.0,184.0,17,7909,15014.0,1402.0,639.0
0.014,6,10,1990,5,911,3.0,643.0,643.0,5,1079,3.0,811.0,811.0
0.083,6,10,1506,5,395,18.0,127.0,127.0,5,1111,18.0,843.0,843.0
0.087,6,10,1506,5,395,19.0,127.0,127.0,5,1111,15.0,843.0,843.0
0.005,6,10,1643,5,860,1.0,592.0,592.0,5,783,1.0,515.0,515.0
0.015,6,10,1989,5,910,3.0,642.0,642.0,5,1079,3.0,811.0,811.0
0.005,6,10,2007,5,928,1.0,660.0,660.0,5,1079,1.0,811.0,811.0
40.063,17,10,676,5,460,10013.0,104.0,64.0,5,216,10015.0,20.0,15.0
0.017,6,10,1990,5,911,4.0,643.0,643.0,5,1079,4.0,811.0,811.0
0.009,6,10,1990,5,911,2.0,643.0,643.0,5,1079,2.0,811.0,811.0
0.005,6,10,2007,5,928,1.0,660.0,660.0,5,1079,1.0,811.0,811.0
0.005,17,2,168,1,76,0.0,48.0,48.0,1,92,0.0,64.0,64.0
40.054,17,10,676,5,460,10012.0,104.0,64.0,5,216,10012.0,20.0,15.0
0.004,6,10,2007,5,928,1.0,660.0,660.0,5,1079,1.0,811.0,811.0
0.004,17,4,284,2,120,0.0,32.0,32.0,2,164,1.0,60.0,54.0
0.005,6,10,1689,5,839,1.0,571.0,571.0,5,850,1.0,582.0,582.0
0.076,6,10,1506,5,395,17.0,127.0,127.0,5,1111,16.0,843.0,843.0
0.008,6,10,1989,5,910,2.0,642.0,642.0,5,1079,2.0,811.0,811.0
0.005,17,2,164,1,74,0.0,46.0,46.0,1,90,0.0,62.0,62.0
15.069,17,15,9238,8,6902,2148.0,1350.0,834.0,7,2336,2506.0,1350.0,305.0
0.01,6,10,1989,5,910,2.0,642.0,642.0,5,1079,2.0,811.0,811.0
0.005,6,10,2006,5,927,1.0,659.0,659.0,5,1079,1.0,811.0,811.0
0.005,6,10,2006,5,927,1.0,659.0,659.0,5,1079,1.0,811.0,811.0
65.614,6,27,17800,15,9859,4686.0,2804.0,1511.0,12,7941,5950.0,2312.0,1218.0
0.003,17,2,148,1,60,0.0,32.0,32.0,1,88,0.0,60.0,60.0
0.005,6,10,2006,5,927,1.0,659.0,659.0,5,1079,1.0,811.0,811.0
0.013,17,2,152,1,56,0.0,28.0,28.0,1,96,0.0,68.0,68.0
0.005,6,10,1989,5,927,1.0,659.0,659.0,5,1062,1.0,794.0,794.0
0.005,6,10,1547,5,764,1.0,496.0,496.0,5,783,1.0,515.0,515.0
0.005,6,10,1774,5,923,1.0,655.0,655.0,5,851,1.0,583.0,583.0
0.013,6,10,1972,5,910,3.0,642.0,642.0,5,1062,3.0,794.0,794.0
0.006,6,10,1547,5,764,1.0,496.0,496.0,5,783,1.0,515.0,515.0
0.005,17,2,169,1,62,0.0,34.0,34.0,1,107,0.0,79.0,79.0
0.005,6,10,2006,5,927,1.0,659.0,659.0,5,1079,1.0,811.0,811.0
167.18,17,74,10616,37,2470,4643.0,44.0,38.0,37,8146,4643.0,261.0,192.0
0.144,6,10,1506,5,395,33.0,127.0,127.0,5,1111,32.0,843.0,843.0
0.003,17,2,148,1,60,0.0,32.0,32.0,1,88,0.0,60.0,60.0
0.003,17,2,136,1,60,0.0,32.0,32.0,1,76,0.0,48.0,48.0
0.013,17,2,148,1,60,0.0,32.0,32.0,1,88,0.0,60.0,60.0
0.038,17,2,182,1,65,0.0,37.0,37.0,1,117,0.0,89.0,89.0
0.005,6,10,2007,5,928,1.0,660.0,660.0,5,1079,1.0,811.0,811.0
11.214,17,27,4291,14,2312,854.0,587.0,137.0,13,1979,925.0,270.0,124.0
0.038,17,2,136,1,60,0.0,32.0,32.0,1,76,0.0,48.0,48.0
0.227,6,16,2782,8,1400,32.0,533.0,325.0,8,1382,21.0,529.0,239.0
240.453,6,35,10429,18,2215,14142.0,559.0,254.0,17,8214,15026.0,1610.0,666.0
0.011,6,10,1990,5,911,2.0,643.0,643.0,5,1079,2.0,811.0,811.0
0.005,6,10,1689,5,839,1.0,571.0,571.0,5,850,1.0,582.0,582.0
0.01,6,10,1631,5,848,2.0,580.0,580.0,5,783,2.0,515.0,515.0
0.006,6,10,1547,5,764,1.0,496.0,496.0,5,783,1.0,515.0,515.0
0.011,17,2,225,1,65,0.0,37.0,37.0,1,160,0.0,132.0,132.0
241.271,6,319,344340,120,17743,2027.0,2736.0,885.0,199,326597,1218.0,2804.0,1673.0
0.004,6,10,2006,5,927,1.0,659.0,659.0,5,1079,1.0,811.0,811.0
0.005,6,10,2007,5,928,1.0,660.0,660.0,5,1079,1.0,811.0,811.0
0.102,6,10,1506,5,395,23.0,127.0,127.0,5,1111,17.0,843.0,843.0
0.015,6,10,1989,5,910,3.0,642.0,642.0,5,1079,3.0,811.0,811.0
15.072,17,15,9238,8,6902,2149.0,1350.0,834.0,7,2336,2507.0,1350.0,305.0
0.011,6,10,1989,5,910,2.0,642.0,642.0,5,1079,2.0,811.0,811.0
0.005,6,10,1854,5,889,1.0,621.0,621.0,5,965,1.0,697.0,697.0
0.016,6,10,1631,5,848,3.0,580.0,580.0,5,783,4.0,515.0,515.0
40.08,17,10,676,5,460,10018.0,104.0,64.0,5,216,10019.0,20.0,15.0
0.005,6,10,1689,5,839,1.0,571.0,571.0,5,850,1.0,582.0,582.0
0.096,6,10,1506,5,395,21.0,127.0,127.0,5,1111,22.0,843.0,843.0
0.004,17,2,412,1,61,0.0,33.0,33.0,1,351,0.0,323.0,323.0
0.005,6,10,2000,5,927,1.0,659.0,659.0,5,1073,1.0,805.0,805.0
0.002,17,2,180,1,66,0.0,38.0,38.0,1,114,0.0,86.0,86.0
0.005,6,10,1547,5,764,1.0,496.0,496.0,5,783,1.0,515.0,515.0
0.038,17,4,284,2,120,0.0,32.0,32.0,2,164,35.0,60.0,54.0
0.013,6,10,1983,5,910,3.0,642.0,642.0,5,1073,3.0,805.0,805.0
0.035,6,10,1989,5,910,8.0,642.0,642.0,5,1079,8.0,811.0,811.0
0.005,6,10,1774,5,923,1.0,655.0,655.0,5,851,1.0,583.0,583.0
0.482,6,14,6510,6,1342,96.0,517.0,517.0,8,5168,68.0,1665.0,1183.0
0.005,6,10,1689,5,839,1.0,571.0,571.0,5,850,1.0,582.0,582.0
0.004,6,10,1989,5,927,1.0,659.0,659.0,5,1062,1.0,794.0,794.0
0.073,17,4,284,2,120,0.0,32.0,32.0,2,164,68.0,60.0,54.0
0.005,6,10,2007,5,928,1.0,660.0,660.0,5,1079,1.0,811.0,811.0
0.006,6,10,1547,5,764,1.0,496.0,496.0,5,783,1.0,515.0,515.0
0.006,6,10,1547,5,764,1.0,496.0,496.0,5,783,1.0,515.0,515.0
40.061,17,10,676,5,460,10014.0,104.0,64.0,5,216,10012.0,20.0,15.0
0.158,6,10,1506,5,395,36.0,127.0,127.0,5,1111,37.0,843.0,843.0
0.006,6,10,1643,5,860,1.0,592.0,592.0,5,783,1.0,515.0,515.0
0.005,6,10,1989,5,927,1.0,659.0,659.0,5,1062,1.0,794.0,794.0
0.005,17,2,166,1,75,0.0,47.0,47.0,1,91,0.0,63.0,63.0
0.015,6,10,1762,5,911,3.0,643.0,643.0,5,851,3.0,583.0,583.0
0.079,6,10,1506,5,395,17.0,127.0,127.0,5,1111,15.0,843.0,843.0
40.052,17,10,676,5,460,10012.0,104.0,64.0,5,216,10012.0,20.0,15.0
0.003,17,2,136,1,60,0.0,32.0,32.0,1,76,0.0,48.0,48.0
0.092,6,10,1506,5,395,22.0,127.0,127.0,5,1111,19.0,843.0,843.0
0.006,6,10,2006,5,927,1.0,659.0,659.0,5,1079,1.0,811.0,811.0
0.091,6,10,1506,5,395,16.0,127.0,127.0,5,1111,21.0,843.0,843.0
0.005,6,10,1854,5,889,1.0,621.0,621.0,5,965,1.0,697.0,697.0
0.008,6,10,1989,5,910,2.0,642.0,642.0,5,1079,1.0,811.0,811.0
0.006,17,2,179,1,71,0.0,43.0,43.0,1,108,0.0,80.0,80.0
0.01,6,10,1990,5,911,2.0,643.0,643.0,5,1079,2.0,811.0,811.0
0.072,17,4,284,2,120,0.0,32.0,32.0,2,164,68.0,60.0,54.0
0.039,17,2,148,1,60,0.0,32.0,32.0,1,88,0.0,60.0,60.0
0.043,17,2,152,1,76,0.0,48.0,48.0,1,76,0.0,48.0,48.0
0.004,6,10,2000,5,927,1.0,659.0,659.0,5,1073,1.0,805.0,805.0
0.161,6,25,6544,13,2401,12.0,746.0,341.0,12,4143,13.0,1324.0,585.0
0.013,6,10,1983,5,910,3.0,642.0,642.0,5,1073,3.0,805.0,805.0
0.112,6,10,1506,5,395,26.0,127.0,127.0,5,1111,22.0,843.0,843.0
0.013,6,10,1989,5,910,3.0,642.0,642.0,5,1079,3.0,811.0,811.0
0.003,17,2,136,1,60,0.0,32.0,32.0,1,76,0.0,48.0,48.0
0.124,6,10,1506,5,395,28.0,127.0,127.0,5,1111,26.0,843.0,843.0
0.004,17,2,136,1,60,0.0,32.0,32.0,1,76,0.0,48.0,48.0
0.005,6,10,2006,5,927,1.0,659.0,659.0,5,1079,1.0,811.0,811.0
0.014,6,10,1983,5,910,3.0,642.0,642.0,5,1073,3.0,805.0,805.0
0.001,17,2,180,1,66,0.0,38.0,38.0,1,114,0.0,86.0,86.0
0.04,17,2,146,1,65,0.0,37.0,37.0,1,81,0.0,53.0,53.0
0.021,6,10,1989,5,910,5.0,642.0,642.0,5,1079,5.0,811.0,811.0
1795.809,6,244,35804,152,26032,11892.0,302.0,302.0,92,9772,19734.0,83.0,83.0
0.005,6,10,2000,5,927,1.0,659.0,659.0,5,1073,1.0,805.0,805.0
0.173,6,3,453,2,321,173.0,241.0,241.0,1,132,0.0,92.0,92.0
0.008,6,10,1972,5,910,2.0,642.0,642.0,5,1062,1.0,794.0,794.0
0.009,6,12,1926,6,1189,1.0,659.0,434.0,6,737,1.0,417.0,417.0
0.005,6,10,1779,5,928,1.0,660.0,660.0,5,851,1.0,583.0,583.0
0.17,17,2,152,1,76,0.0,48.0,48.0,1,76,0.0,48.0,48.0
15.077,17,15,7960,8,5854,2149.0,1350.0,703.0,7,2106,2507.0,1350.0,272.0
0.011,6,10,1631,5,848,2.0,580.0,580.0,5,783,2.0,515.0,515.0
0.182,6,10,1506,5,395,42.0,127.0,127.0,5,1111,36.0,843.0,843.0
0.004,6,10,1774,5,923,1.0,655.0,655.0,5,851,1.0,583.0,583.0
0.005,6,10,1854,5,889,1.0,621.0,621.0,5,965,1.0,697.0,697.0
0.081,6,10,1506,5,395,19.0,127.0,127.0,5,1111,17.0,843.0,843.0
0.014,6,10,1631,5,848,3.0,580.0,580.0,5,783,3.0,515.0,515.0
0.005,6,10,2007,5,928,1.0,660.0,660.0,5,1079,1.0,811.0,811.0
0.005,6,10,2000,5,927,1.0,659.0,659.0,5,1073,1.0,805.0,805.0
0.013,6,10,1989,5,910,3.0,642.0,642.0,5,1079,3.0,811.0,811.0
0.007,6,10,1990,5,911,1.0,643.0,643.0,5,1079,1.0,811.0,811.0
0.068,17,8,3613,4,1874,22.0,1350.0,440.0,4,1739,11.0,1350.0,406.0
0.001,17,2,180,1,66,0.0,38.0,38.0,1,114,0.0,86.0,86.0
0.077,6,10,1506,5,395,18.0,127.0,127.0,5,1111,16.0,843.0,843.0
0.011,6,10,1762,5,911,2.0,643.0,643.0,5,851,2.0,583.0,583.0
0.005,17,2,166,1,75,0.0,47.0,47.0,1,91,0.0,63.0,63.0
0.04,17,2,152,1,76,0.0,48.0,48.0,1,76,0.0,48.0,48.0
0.003,17,2,136,1,60,0.0,32.0,32.0,1,76,0.0,48.0,48.0
0.012,6,13,3735,7,497,2.0,125.0,125.0,6,3238,2.0,1470.0,1459.0
0.114,6,10,1506,5,395,25.0,127.0,127.0,5,1111,25.0,843.0,843.0
0.147,6,10,1506,5,395,22.0,127.0,127.0,5,1111,35.0,843.0,843.0
0.0,17,2,164,1,74,0.0,46.0,46.0,1,90,0.0,62.0,62.0
0.005,6,10,1689,5,839,1.0,571.0,571.0,5,850,1.0,582.0,582.0
0.057,6,10,1506,5,395,11.0,127.0,127.0,5,1111,13.0,843.0,843.0
0.004,17,4,284,2,120,1.0,32.0,32.0,2,164,0.0,60.0,54.0
0.012,6,10,1989,5,910,3.0,642.0,642.0,5,1079,2.0,811.0,811.0
0.006,17,2,214,1,75,0.0,47.0,47.0,1,139,0.0,111.0,111.0
0.004,6,10,2006,5,927,1.0,659.0,659.0,5,1079,1.0,811.0,811.0
0.006,6,10,1547,5,764,1.0,496.0,496.0,5,783,1.0,515.0,515.0
1730.393,6,48,2957,31,1800,57679.0,35.0,35.0,17,1157,108144.0,31.0,31.0
0.005,17,2,170,1,65,0.0,37.0,37.0,1,105,0.0,77.0,77.0
0.012,6,10,1972,5,910,3.0,642.0,642.0,5,1062,2.0,794.0,794.0
0.008,6,10,1989,5,910,1.0,642.0,642.0,5,1079,1.0,811.0,811.0
0.01,6,10,1972,5,910,2.0,642.0,642.0,5,1062,2.0,794.0,794.0
0.016,6,13,3735,7,497,2.0,125.0,125.0,6,3238,3.0,1470.0,1459.0
0.004,6,10,2007,5,928,1.0,660.0,660.0,5,1079,1.0,811.0,811.0
0.008,6,10,1990,5,911,2.0,643.0,643.0,5,1079,2.0,811.0,811.0
0.005,17,2,140,1,62,0.0,34.0,34.0,1,78,0.0,50.0,50.0
0.004,6,10,2006,5,927,1.0,659.0,659.0,5,1079,1.0,811.0,811.0
0.012,6,10,1989,5,910,3.0,642.0,642.0,5,1079,3.0,811.0,811.0
0.009,6,12,1926,6,1189,1.0,659.0,434.0,6,737,1.0,417.0,417.0
240.116,6,16,4481,9,963,30014.0,238.0,166.0,7,3518,40017.0,1402.0,786.0
0.014,6,10,1990,5,911,3.0,643.0,643.0,5,1079,3.0,811.0,811.0
0.104,6,10,1506,5,395,24.0,127.0,127.0,5,1111,23.0,843.0,843.0
0.12,6,10,1506,5,395,28.0,127.0,127.0,5,1111,24.0,843.0,843.0
0.007,6,10,2006,5,927,1.0,659.0,659.0,5,1079,1.0,811.0,811.0
0.01,6,10,1972,5,910,2.0,642.0,642.0,5,1062,2.0,794.0,794.0
0.091,6,10,1506,5,395,19.0,127.0,127.0,5,1111,18.0,843.0,843.0
0.003,17,2,162,1,65,0.0,37.0,37.0,1,97,0.0,69.0,69.0
0.005,17,2,194,1,59,0.0,31.0,31.0,1,135,0.0,107.0,107.0
0.006,6,10,1854,5,889,1.0,621.0,621.0,5,965,1.0,697.0,697.0
0.015,6,10,1972,5,910,3.0,642.0,642.0,5,1062,3.0,794.0,794.0
0.012,6,10,1983,5,910,3.0,642.0,642.0,5,1073,2.0,805.0,805.0
0.012,6,10,1972,5,910,2.0,642.0,642.0,5,1062,3.0,794.0,794.0
0.005,6,10,2006,5,927,1.0,659.0,659.0,5,1079,1.0,811.0,811.0
0.012,6,10,1989,5,910,3.0,642.0,642.0,5,1079,3.0,811.0,811.0
0.004,6,10,2006,5,927,1.0,659.0,659.0,5,1079,1.0,811.0,811.0
1755.988,6,106,6292,60,3510,29761.0,26.0,26.0,46,2782,39021.0,26.0,26.0
300.768,6,39,11172,21,5654,15038.0,1678.0,797.0,18,5518,506.0,2667.0,435.0
0.006,6,10,1854,5,889,1.0,621.0,621.0,5,965,1.0,697.0,697.0
0.005,6,10,2007,5,928,1.0,660.0,660.0,5,1079,1.0,811.0,811.0
0.108,6,10,1506,5,395,24.0,127.0,127.0,5,1111,18.0,843.0,843.0
40.055,17,10,676,5,460,10013.0,104.0,64.0,5,216,10013.0,20.0,15.0
0.122,6,10,1506,5,395,28.0,127.0,127.0,5,1111,28.0,843.0,843.0
0.015,6,14,3787,7,497,2.0,125.0,125.0,7,3290,2.0,1448.0,972.0
1735.201,6,67,7528,42,4484,42321.0,1640.0,109.0,25,3044,72293.0,1112.0,82.0
0.006,6,10,2007,5,928,1.0,660.0,660.0,5,1079,1.0,811.0,811.0
0.082,6,10,1506,5,395,18.0,127.0,127.0,5,1111,16.0,843.0,843.0
0.001,17,2,180,1,66,0.0,38.0,38.0,1,114,0.0,86.0,86.0
40.074,17,10,676,5,460,10017.0,104.0,64.0,5,216,10017.0,20.0,15.0
0.09,6,10,1506,5,395,17.0,127.0,127.0,5,1111,21.0,843.0,843.0
0.021,6,10,1972,5,910,5.0,642.0,642.0,5,1062,5.0,794.0,794.0
0.012,6,10,1990,5,911,3.0,643.0,643.0,5,1079,3.0,811.0,811.0
0.001,17,2,179,1,62,0.0,34.0,34.0,1,117,0.0,89.0,89.0
40.097,17,10,676,5,460,10023.0,104.0,64.0,5,216,10023.0,20.0,15.0
0.005,6,10,1779,5,928,1.0,660.0,660.0,5,851,1.0,583.0,583.0
0.012,6,10,1631,5,848,3.0,580.0,580.0,5,783,3.0,515.0,515.0
0.012,6,10,1972,5,910,3.0,642.0,642.0,5,1062,2.0,794.0,794.0
0.102,6,10,1506,5,395,22.0,127.0,127.0,5,1111,22.0,843.0,843.0
0.211,6,16,2670,8,1396,30.0,533.0,324.0,8,1274,18.0,529.0,212.0
0.009,6,10,1990,5,911,2.0,643.0,643.0,5,1079,2.0,811.0,811.0
368.873,6,22,2313,16,867,24591.0,195.0,195.0,6,1446,4641.0,419.0,398.0
40.07,17,10,676,5,460,10015.0,104.0,64.0,5,216,10016.0,20.0,15.0
0.009,6,10,1990,5,911,2.0,643.0,643.0,5,1079,2.0,811.0,811.0
0.001,17,2,140,1,62,0.0,34.0,34.0,1,78,0.0,50.0,50.0
176.092,17,72,10307,36,2410,5031.0,44.0,38.0,36,7897,5031.0,261.0,191.0
308.395,17,20,1124,10,716,34251.0,48.0,43.0,10,408,34251.0,20.0,12.0
0.04,17,2,136,1,60,0.0,32.0,32.0,1,76,0.0,48.0,48.0
241.661,6,299,343591,120,17749,2030.0,2736.0,959.0,179,325842,1357.0,2804.0,1872.0
0.006,17,2,166,1,75,0.0,47.0,47.0,1,91,0.0,63.0,63.0
0.015,6,10,1972,5,910,3.0,642.0,642.0,5,1062,3.0,794.0,794.0
0.01,6,10,1983,5,910,2.0,642.0,642.0,5,1073,2.0,805.0,805.0
0.015,6,10,1990,5,911,3.0,643.0,643.0,5,1079,3.0,811.0,811.0
0.008,6,12,1926,6,1189,1.0,659.0,434.0,6,737,1.0,417.0,417.0
0.132,6,10,1506,5,395,31.0,127.0,127.0,5,1111,28.0,843.0,843.0
0.034,6,10,1972,5,910,8.0,642.0,642.0,5,1062,8.0,794.0,794.0
300.031,6,12,1782,7,1348,50005.0,494.0,494.0,5,434,75007.0,83.0,83.0
0.07,6,10,1506,5,395,16.0,127.0,127.0,5,1111,14.0,843.0,843.0
0.013,6,10,1990,5,911,3.0,643.0,643.0,5,1079,3.0,811.0,811.0
0.005,6,10,1689,5,839,1.0,571.0,571.0,5,850,1.0,582.0,582.0
0.005,17,2,169,1,62,0.0,34.0,34.0,1,107,0.0,79.0,79.0
0.005,6,10,2006,5,927,1.0,659.0,659.0,5,1079,1.0,811.0,811.0
15.076,17,15,8161,8,5975,2149.0,1350.0,718.0,7,2186,2507.0,1350.0,284.0
0.005,17,2,179,1,71,0.0,43.0,43.0,1,108,0.0,80.0,80.0
0.019,6,10,1990,5,911,4.0,643.0,643.0,5,1079,4.0,811.0,811.0
0.005,6,10,2006,5,927,1.0,659.0,659.0,5,1079,1.0,811.0,811.0
0.006,6,10,2000,5,927,1.0,659.0,659.0,5,1073,1.0,805.0,805.0
0.009,6,10,1989,5,910,2.0,642.0,642.0,5,1079,2.0,811.0,811.0
0.014,6,10,1677,5,827,3.0,559.0,559.0,5,850,3.0,582.0,582.0
0.005,6,14,3742,7,452,0.0,80.0,80.0,7,3290,0.0,1448.0,972.0
0.038,17,2,412,1,61,0.0,33.0,33.0,1,351,0.0,323.0,323.0
0.086,6,10,1506,5,395,17.0,127.0,127.0,5,1111,20.0,843.0,843.0
0.005,6,10,1989,5,927,1.0,659.0,659.0,5,1062,1.0,794.0,794.0
0.005,6,10,1989,5,927,1.0,659.0,659.0,5,1062,1.0,794.0,794.0
0.01,6,10,1972,5,910,2.0,642.0,642.0,5,1062,2.0,794.0,794.0
0.004,6,10,2000,5,927,1.0,659.0,659.0,5,1073,1.0,805.0,805.0
240.658,6,37,9656,19,2173,13368.0,745.0,235.0,18,7483,14154.0,1402.0,595.0
0.015,6,10,1989,5,910,3.0,642.0,642.0,5,1079,3.0,811.0,811.0
0.005,17,2,170,1,65,0.0,37.0,37.0,1,105,0.0,77.0,77.0
0.042,17,2,182,1,65,0.0,37.0,37.0,1,117,0.0,89.0,89.0
0.103,6,10,1506,5,395,24.0,127.0,127.0,5,1111,22.0,843.0,843.0
0.009,6,10,1989,5,910,2.0,642.0,642.0,5,1079,2.0,811.0,811.0
0.021,6,10,1990,5,911,5.0,643.0,643.0,5,1079,5.0,811.0,811.0
0.018,6,10,1631,5,848,4.0,580.0,580.0,5,783,4.0,515.0,515.0
0.005,6,10,2006,5,927,1.0,659.0,659.0,5,1079,1.0,811.0,811.0
0.006,17,2,230,1,68,0.0,40.0,40.0,1,162,0.0,134.0,134.0
0.039,17,2,184,1,61,0.0,33.0,33.0,1,123,0.0,95.0,95.0
0.005,6,10,2007,5,928,1.0,660.0,660.0,5,1079,1.0,811.0,811.0
0.09,6,10,1506,5,395,21.0,127.0,127.0,5,1111,20.0,843.0,843.0
0.01,6,10,1989,5,910,2.0,642.0,642.0,5,1079,2.0,811.0,811.0
0.006,6,10,1689,5,839,1.0,571.0,571.0,5,850,1.0,582.0,582.0
0.006,17,2,222,1,65,0.0,37.0,37.0,1,157,0.0,129.0,129.0
0.005,17,2,213,1,69,0.0,41.0,41.0,1,144,0.0,116.0,116.0
0.009,6,13,3735,7,497,1.0,125.0,125.0,6,3238,1.0,1470.0,1459.0
0.009,6,10,1989,5,910,2.0,642.0,642.0,5,1079,2.0,811.0,811.0
0.005,6,10,1989,5,927,1.0,659.0,659.0,5,1062,1.0,794.0,794.0
40.059,17,10,676,5,460,10014.0,104.0,64.0,5,216,10013.0,20.0,15.0
10.871,17,28,4423,14,1995,827.0,270.0,114.0,14,2428,827.0,587.0,145.0
0.06,6,10,1506,5,395,13.0,127.0,127.0,5,1111,14.0,843.0,843.0
40.065,17,10,676,5,460,10013.0,104.0,64.0,5,216,10015.0,20.0,15.0
0.078,6,10,1506,5,395,15.0,127.0,127.0,5,1111,18.0,843.0,843.0
0.164,17,2,152,1,76,0.0,48.0,48.0,1,76,0.0,48.0,48.0
0.014,6,10,1989,5,910,3.0,642.0,642.0,5,1079,3.0,811.0,811.0
0.029,6,10,1972,5,910,7.0,642.0,642.0,5,1062,7.0,794.0,794.0
1763.229,6,67,7506,43,4522,41981.0,1402.0,103.0,24,2984,76654.0,1116.0,82.0
0.001,17,2,136,1,60,0.0,32.0,32.0,1,76,0.0,48.0,48.0
0.005,6,13,3747,7,509,0.0,137.0,137.0,6,3238,0.0,1470.0,1459.0
240.247,6,31,11970,16,5802,16016.0,1374.0,829.0,15,6168,17160.0,1654.0,896.0
40.054,17,10,676,5,460,10012.0,104.0,64.0,5,216,10011.0,20.0,15.0
0.116,6,10,1506,5,395,26.0,127.0,127.0,5,1111,27.0,843.0,843.0
40.079,17,10,676,5,460,10019.0,104.0,64.0,5,216,10018.0,20.0,15.0
0.006,6,10,1643,5,860,1.0,592.0,592.0,5,783,1.0,515.0,515.0
0.001,17,2,180,1,66,0.0,38.0,38.0,1,114,0.0,86.0,86.0
0.068,6,10,1506,5,395,16.0,127.0,127.0,5,1111,14.0,843.0,843.0
0.012,6,10,1762,5,911,3.0,643.0,643.0,5,851,3.0,583.0,583.0
0.03,6,10,1989,5,910,7.0,642.0,642.0,5,1079,7.0,811.0,811.0
0.001,17,2,132,1,58,0.0,30.0,30.0,1,74,0.0,46.0,46.0
40.067,17,10,676,5,460,10013.0,104.0,64.0,5,216,10015.0,20.0,15.0
0.005,6,10,2006,5,927,1.0,659.0,659.0,5,1079,1.0,811.0,811.0
0.005,17,2,214,1,75,0.0,47.0,47.0,1,139,0.0,111.0,111.0
0.009,6,10,1989,5,910,2.0,642.0,642.0,5,1079,2.0,811.0,811.0
0.012,6,10,1972,5,910,2.0,642.0,642.0,5,1062,2.0,794.0,794.0
0.016,6,10,1989,5,910,3.0,642.0,642.0,5,1079,4.0,811.0,811.0
0.008,17,2,179,1,71,0.0,43.0,43.0,1,108,0.0,80.0,80.0
0.018,6,10,1989,5,910,4.0,642.0,642.0,5,1079,4.0,811.0,811.0
0.024,6,10,1762,5,911,6.0,643.0,643.0,5,851,6.0,583.0,583.0
0.007,17,2,194,1,59,0.0,31.0,31.0,1,135,0.0,107.0,107.0
0.106,6,10,1506,5,395,22.0,127.0,127.0,5,1111,25.0,843.0,843.0
0.098,6,10,1506,5,395,20.0,127.0,127.0,5,1111,23.0,843.0,843.0
0.004,17,2,179,1,71,0.0,43.0,43.0,1,108,0.0,80.0,80.0
2.063,6,23,7757,13,1537,171.0,517.0,287.0,10,6220,18.0,1402.0,813.0
0.004,6,10,2006,5,927,1.0,659.0,659.0,5,1079,1.0,811.0,811.0
0.006,17,2,179,1,71,0.0,43.0,43.0,1,108,0.0,80.0,80.0
0.004,17,2,148,1,60,0.0,32.0,32.0,1,88,0.0,60.0,60.0
0.001,17,2,180,1,66,0.0,38.0,38.0,1,114,0.0,86.0,86.0
1770.673,17,120,11460,60,5460,30011.0,63.0,63.0,60,6000,30011.0,72.0,72.0
0.013,6,10,1990,5,911,3.0,643.0,643.0,5,1079,3.0,811.0,811.0
0.003,6,10,1702,5,863,0.0,595.0,595.0,5,839,0.0,571.0,571.0
0.004,6,10,1989,5,927,1.0,659.0,659.0,5,1062,1.0,794.0,794.0
0.084,6,10,1506,5,395,17.0,127.0,127.0,5,1111,20.0,843.0,843.0
175.294,17,90,12371,45,3050,3983.0,44.0,39.0,45,9321,3983.0,239.0,179.0
0.005,6,10,1989,5,927,1.0,659.0,659.0,5,1062,1.0,794.0,794.0
0.001,17,2,180,1,66,0.0,38.0,38.0,1,114,0.0,86.0,86.0
0.117,6,10,1506,5,395,26.0,127.0,127.0,5,1111,27.0,843.0,843.0
40.046,17,10,676,5,460,10010.0,104.0,64.0,5,216,10010.0,20.0,15.0
0.006,6,10,2000,5,927,1.0,659.0,659.0,5,1073,1.0,805.0,805.0
0.086,6,10,1506,5,395,20.0,127.0,127.0,5,1111,18.0,843.0,843.0
0.004,6,10,1779,5,928,1.0,660.0,660.0,5,851,1.0,583.0,583.0
0.006,6,10,1854,5,889,1.0,621.0,621.0,5,965,1.0,697.0,697.0
0.113,6,10,1506,5,395,26.0,127.0,127.0,5,1111,26.0,843.0,843.0
0.004,6,10,2006,5,927,1.0,659.0,659.0,5,1079,1.0,811.0,811.0
0.001,17,2,180,1,66,0.0,38.0,38.0,1,114,0.0,86.0,86.0
0.005,17,4,420,2,122,0.0,33.0,33.0,2,298,1.0,145.0,121.0
0.004,6,10,2007,5,928,1.0,660.0,660.0,5,1079,1.0,811.0,811.0
0.016,6,10,1989,5,910,3.0,642.0,642.0,5,1079,4.0,811.0,811.0
0.009,6,10,1990,5,911,2.0,643.0,643.0,5,1079,2.0,811.0,811.0
40.094,17,10,676,5,460,10020.0,104.0,64.0,5,216,10022.0,20.0,15.0
0.004,6,10,2006,5,927,1.0,659.0,659.0,5,1079,1.0,811.0,811.0
0.004,6,10,1702,5,863,1.0,595.0,595.0,5,839,0.0,571.0,571.0
11.439,17,29,4565,15,2165,805.0,268.0,116.0,14,2400,867.0,587.0,143.0
0.006,6,10,1547,5,764,1.0,496.0,496.0,5,783,1.0,515.0,515.0
0.005,6,10,2007,5,928,1.0,660.0,660.0,5,1079,1.0,811.0,811.0
0.011,6,10,1972,5,910,2.0,642.0,642.0,5,1062,2.0,794.0,794.0
0.748,6,10,1873,6,1519,149.0,1267.0,1267.0,4,354,171.0,182.0,182.0
0.004,6,10,2000,5,927,1.0,659.0,659.0,5,1073,1.0,805.0,805.0
0.042,17,2,152,1,76,0.0,48.0,48.0,1,76,0.0,48.0,48.0
0.065,6,10,1506,5,395,15.0,127.0,127.0,5,1111,12.0,843.0,843.0
40.08,17,10,676,5,460,10017.0,104.0,64.0,5,216,10019.0,20.0,15.0
0.006,6,10,1547,5,764,1.0,496.0,496.0,5,783,1.0,515.0,515.0
0.005,17,2,178,1,81,0.0,53.0,53.0,1,97,0.0,69.0,69.0
0.014,6,10,1989,5,910,3.0,642.0,642.0,5,1079,3.0,811.0,811.0
0.005,6,10,2007,5,928,1.0,660.0,660.0,5,1079,1.0,811.0,811.0
0.005,6,10,2006,5,927,1.0,659.0,659.0,5,1079,1.0,811.0,811.0
0.775,6,22,5168,11,1138,65.0,267.0,115.0,11,4030,65.0,1414.0,597.0
0.004,6,10,1779,5,928,1.0,660.0,660.0,5,851,1.0,583.0,583.0
0.016,6,10,1631,5,848,3.0,580.0,580.0,5,783,4.0,515.0,515.0
0.01,17,4,284,2,120,0.0,32.0,32.0,2,164,0.0,60.0,54.0
1792.82,6,486,98773,245,87543,7346.0,421.0,368.0,241,11230,7469.0,53.0,53.0
40.06,17,10,676,5,460,10011.0,104.0,64.0,5,216,10014.0,20.0,15.0
0.008,6,10,1983,5,910,2.0,642.0,642.0,5,1073,1.0,805.0,805.0
0.013,17,2,152,1,56,0.0,28.0,28.0,1,96,0.0,68.0,68.0
0.009,6,13,3747,7,509,1.0,137.0,137.0,6,3238,1.0,1470.0,1459.0
0.005,6,10,2006,5,927,1.0,659.0,659.0,5,1079,1.0,811.0,811.0
0.041,17,2,136,1,60,0.0,32.0,32.0,1,76,0.0,48.0,48.0
0.004,17,2,152,1,76,0.0,48.0,48.0,1,76,0.0,48.0,48.0
240.114,6,16,4480,9,963,30014.0,238.0,166.0,7,3517,40017.0,1402.0,786.0
0.078,6,10,1506,5,395,17.0,127.0,127.0,5,1111,16.0,843.0,843.0
0.014,6,10,1989,5,910,3.0,642.0,642.0,5,1079,3.0,811.0,811.0
0.089,6,10,1506,5,395,20.0,127.0,127.0,5,1111,21.0,843.0,843.0
0.013,6,10,1989,5,910,3.0,642.0,642.0,5,1079,3.0,811.0,811.0
0.006,6,10,1989,5,927,1.0,659.0,659.0,5,1062,1.0,794.0,794.0
1778.859,17,144,45504,72,22752,25054.0,288.0,288.0,72,22752,25054.0,288.0,288.0
0.005,6,10,2006,5,927,1.0,659.0,659.0,5,1079,1.0,811.0,811.0
0.028,6,10,1989,5,910,7.0,642.0,642.0,5,1079,7.0,811.0,811.0
0.104,6,10,1506,5,395,23.0,127.0,127.0,5,1111,23.0,843.0,843.0
11.106,17,28,4423,14,1995,842.0,270.0,114.0,14,2428,842.0,587.0,145.0
0.004,6,10,2006,5,927,1.0,659.0,659.0,5,1079,1.0,811.0,811.0
0.007,17,2,299,1,65,0.0,37.0,37.0,1,234,0.0,206.0,206.0
0.009,6,12,1926,6,1189,1.0,659.0,434.0,6,737,1.0,417.0,417.0
0.005,6,13,3747,7,509,0.0,137.0,137.0,6,3238,1.0,1470.0,1459.0
0.017,6,10,1762,5,911,4.0,643.0,643.0,5,851,4.0,583.0,583.0
0.012,6,10,1983,5,910,2.0,642.0,642.0,5,1073,2.0,805.0,805.0
0.018,6,10,1983,5,910,4.0,642.0,642.0,5,1073,4.0,805.0,805.0
0.017,6,10,1989,5,910,4.0,642.0,642.0,5,1079,4.0,811.0,811.0
0.001,17,2,180,1,66,0.0,38.0,38.0,1,114,0.0,86.0,86.0
0.012,6,10,1989,5,910,2.0,642.0,642.0,5,1079,2.0,811.0,811.0
0.013,6,10,1990,5,911,3.0,643.0,643.0,5,1079,3.0,811.0,811.0
0.006,6,10,1547,5,764,1.0,496.0,496.0,5,783,1.0,515.0,515.0
0.068,17,8,3613,4,1874,22.0,1350.0,440.0,4,1739,11.0,1350.0,406.0
0.011,6,10,1631,5,848,2.0,580.0,580.0,5,783,2.0,515.0,515.0
0.125,6,10,1506,5,395,20.0,127.0,127.0,5,1111,27.0,843.0,843.0
0.009,6,10,1989,5,910,2.0,642.0,642.0,5,1079,2.0,811.0,811.0
0.037,17,2,136,1,60,0.0,32.0,32.0,1,76,0.0,48.0,48.0
66.253,6,22,8549,12,2328,6023.0,1002.0,424.0,10,6221,7343.0,2355.0,948.0
0.009,6,10,1989,5,910,2.0,642.0,642.0,5,1079,2.0,811.0,811.0
0.004,17,2,152,1,76,0.0,48.0,48.0,1,76,0.0,48.0,48.0
0.008,6,10,1989,5,910,2.0,642.0,642.0,5,1079,2.0,811.0,811.0
0.013,6,10,1983,5,910,3.0,642.0,642.0,5,1073,3.0,805.0,805.0
0.116,6,10,1506,5,395,25.0,127.0,127.0,5,1111,26.0,843.0,843.0
0.005,6,10,2006,5,927,1.0,659.0,659.0,5,1079,1.0,811.0,811.0
0.009,6,10,1983,5,910,2.0,642.0,642.0,5,1073,2.0,805.0,805.0
0.005,6,10,2006,5,927,1.0,659.0,659.0,5,1079,1.0,811.0,811.0
0.001,17,2,180,1,66,0.0,38.0,38.0,1,114,0.0,86.0,86.0
40.06,17,10,676,5,460,10014.0,104.0,64.0,5,216,10014.0,20.0,15.0
0.713,6,24,5152,11,1250,60.0,325.0,133.0,13,3902,50.0,1414.0,563.0
0.075,6,10,1506,5,395,17.0,127.0,127.0,5,1111,16.0,843.0,843.0
0.005,6,10,2006,5,927,1.0,659.0,659.0,5,1079,1.0,811.0,811.0
0.011,6,10,1990,5,911,2.0,643.0,643.0,5,1079,2.0,811.0,811.0
0.006,6,10,1547,5,764,1.0,496.0,496.0,5,783,1.0,515.0,515.0
361.812,6,21,1793,16,1030,24120.0,190.0,190.0,5,763,60009.0,462.0,247.0
0.009,17,2,170,1,65,0.0,37.0,37.0,1,105,0.0,77.0,77.0
0.094,17,2,144,1,64,0.0,36.0,36.0,1,80,0.0,52.0,52.0
0.016,6,10,1689,5,839,4.0,571.0,571.0,5,850,3.0,582.0,582.0
0.009,6,10,1990,5,911,2.0,643.0,643.0,5,1079,2.0,811.0,811.0
0.005,6,10,2007,5,928,1.0,660.0,660.0,5,1079,1.0,811.0,811.0
0.011,6,10,1972,5,910,2.0,642.0,642.0,5,1062,2.0,794.0,794.0
0.006,17,2,148,1,60,0.0,32.0,32.0,1,88,0.0,60.0,60.0
0.105,6,10,1506,5,395,26.0,127.0,127.0,5,1111,22.0,843.0,843.0
0.007,6,10,1990,5,911,1.0,643.0,643.0,5,1079,1.0,811.0,811.0
0.092,6,10,1506,5,395,21.0,127.0,127.0,5,1111,20.0,843.0,843.0
0.013,6,10,1989,5,910,3.0,642.0,642.0,5,1079,3.0,811.0,811.0
0.058,6,10,1506,5,395,11.0,127.0,127.0,5,1111,13.0,843.0,843.0
240.133,6,30,9256,15,6939,17152.0,2063.0,684.0,15,2317,17152.0,580.0,218.0
0.004,6,10,2000,5,927,1.0,659.0,659.0,5,1073,1.0,805.0,805.0
0.004,6,10,1702,5,863,1.0,595.0,595.0,5,839,1.0,571.0,571.0
0.006,6,10,1854,5,889,1.0,621.0,621.0,5,965,1.0,697.0,697.0
0.12,6,10,1506,5,395,26.0,127.0,127.0,5,1111,26.0,843.0,843.0
126.057,6,14,2938,8,2504,17973.0,1414.0,1086.0,6,434,25165.0,182.0,182.0
40.069,17,10,676,5,460,10013.0,104.0,64.0,5,216,10014.0,20.0,15.0
0.019,6,10,1762,5,911,4.0,643.0,643.0,5,851,4.0,583.0,583.0
0.004,6,10,1702,5,863,0.0,595.0,595.0,5,839,1.0,571.0,571.0
40.064,17,10,676,5,460,10014.0,104.0,64.0,5,216,10015.0,20.0,15.0
0.014,6,10,1972,5,910,3.0,642.0,642.0,5,1062,3.0,794.0,794.0
0.003,17,4,284,2,120,0.0,32.0,32.0,2,164,0.0,60.0,54.0
0.005,6,10,1547,5,764,1.0,496.0,496.0,5,783,1.0,515.0,515.0
0.08,17,2,152,1,76,0.0,48.0,48.0,1,76,0.0,48.0,48.0
0.16,6,10,1506,5,395,39.0,127.0,127.0,5,1111,24.0,843.0,843.0
0.005,6,10,2006,5,927,1.0,659.0,659.0,5,1079,1.0,811.0,811.0
0.001,17,2,180,1,66,0.0,38.0,38.0,1,114,0.0,86.0,86.0
0.005,6,10,2006,5,927,1.0,659.0,659.0,5,1079,1.0,811.0,811.0
0.011,6,10,1989,5,910,2.0,642.0,642.0,5,1079,2.0,811.0,811.0
0.004,6,10,2006,5,927,1.0,659.0,659.0,5,1079,1.0,811.0,811.0
0.011,6,10,1983,5,910,2.0,642.0,642.0,5,1073,2.0,805.0,805.0
0.018,6,10,1989,5,910,4.0,642.0,642.0,5,1079,4.0,811.0,811.0
0.074,17,8,3613,4,1874,24.0,1350.0,440.0,4,1739,10.0,1350.0,406.0
291.422,6,313,345057,124,18644,2369.0,2736.0,871.0,189,326413,1550.0,2804.0,1819.0
0.001,17,2,136,1,60,0.0,32.0,32.0,1,76,0.0,48.0,48.0
0.213,6,16,2669,8,1395,30.0,533.0,323.0,8,1274,19.0,529.0,212.0
0.018,6,10,1605,5,388,4.0,120.0,120.0,5,1217,4.0,949.0,949.0
40.049,17,10,676,5,460,10011.0,104.0,64.0,5,216,10011.0,20.0,15.0
0.008,6,12,1926,6,1189,1.0,659.0,434.0,6,737,1.0,417.0,417.0
0.004,17,2,136,1,60,0.0,32.0,32.0,1,76,0.0,48.0,48.0
0.005,6,10,1774,5,923,1.0,655.0,655.0,5,851,1.0,583.0,583.0
0.014,6,10,1983,5,910,3.0,642.0,642.0,5,1073,3.0,805.0,805.0
0.082,6,10,1506,5,395,19.0,127.0,127.0,5,1111,16.0,843.0,843.0
300.536,6,31,10172,17,2173,18783.0,468.0,256.0,14,7999,18501.0,1402.0,907.0
0.012,6,10,1972,5,910,3.0,642.0,642.0,5,1062,2.0,794.0,794.0
0.011,6,12,1926,6,1189,2.0,659.0,434.0,6,737,2.0,417.0,417.0
0.117,6,10,1506,5,395,27.0,127.0,127.0,5,1111,22.0,843.0,843.0
40.074,17,10,676,5,460,10017.0,104.0,64.0,5,216,10017.0,20.0,15.0
0.005,17,2,157,1,59,0.0,31.0,31.0,1,98,0.0,70.0,70.0
0.007,17,2,194,1,59,0.0,31.0,31.0,1,135,0.0,107.0,107.0
240.085,6,16,4482,9,963,30010.0,238.0,166.0,7,3519,40013.0,1402.0,786.0
0.081,6,10,1506,5,395,16.0,127.0,127.0,5,1111,18.0,843.0,843.0
0.215,6,16,2777,8,1395,30.0,533.0,323.0,8,1382,19.0,529.0,239.0
240.017,6,9,787,5,488,60004.0,232.0,232.0,4,299,80004.0,83.0,83.0
120.038,6,19,3889,12,3102,10912.0,494.0,494.0,7,787,20005.0,83.0,83.0
0.004,6,10,2006,5,927,1.0,659.0,659.0,5,1079,1.0,811.0,811.0
0.001,17,2,166,1,75,0.0,47.0,47.0,1,91,0.0,63.0,63.0
0.005,17,2,170,1,65,0.0,37.0,37.0,1,105,0.0,77.0,77.0
1786.762,6,304,97733,188,86455,9554.0,1402.0,672.0,116,11278,15536.0,452.0,70.0
0.004,6,10,1702,5,863,1.0,595.0,595.0,5,839,1.0,571.0,571.0
0.016,6,10,1972,5,910,4.0,642.0,642.0,5,1062,4.0,794.0,794.0
0.006,6,10,1547,5,764,1.0,496.0,496.0,5,783,1.0,515.0,515.0
0.005,6,13,3684,7,446,0.0,74.0,74.0,6,3238,0.0,1470.0,1459.0
0.04,17,2,148,1,60,0.0,32.0,32.0,1,88,0.0,60.0,60.0
0.111,6,10,1506,5,395,25.0,127.0,127.0,5,1111,26.0,843.0,843.0
0.069,6,10,1506,5,395,15.0,127.0,127.0,5,1111,14.0,843.0,843.0
300.837,6,40,9774,22,4211,14325.0,1543.0,657.0,18,5563,510.0,2667.0,402.0
0.003,17,2,136,1,60,0.0,32.0,32.0,1,76,0.0,48.0,48.0
0.006,6,10,1689,5,839,1.0,571.0,571.0,5,850,1.0,582.0,582.0
0.006,17,4,284,2,120,0.0,32.0,32.0,2,164,1.0,60.0,54.0
0.015,6,10,1989,5,910,3.0,642.0,642.0,5,1079,3.0,811.0,811.0
0.005,17,2,144,1,64,0.0,36.0,36.0,1,80,0.0,52.0,52.0
1756.471,6,124,12587,69,4792,25829.0,517.0,66.0,55,7795,32526.0,1402.0,234.0
0.004,6,10,2006,5,927,1.0,659.0,659.0,5,1079,1.0,811.0,811.0
1.049,6,13,3930,7,2139,131.0,1328.0,923.0,6,1791,157.0,1539.0,1539.0
0.081,6,10,1506,5,395,16.0,127.0,127.0,5,1111,17.0,843.0,843.0
0.013,6,10,1990,5,911,3.0,643.0,643.0,5,1079,3.0,811.0,811.0
0.005,6,13,3747,7,509,0.0,137.0,137.0,6,3238,1.0,1470.0,1459.0
371.109,6,22,2313,16,867,24740.0,195.0,195.0,6,1446,4635.0,419.0,398.0
0.004,6,10,1702,5,863,1.0,595.0,595.0,5,839,1.0,571.0,571.0
40.065,17,10,676,5,460,10014.0,104.0,64.0,5,216,10015.0,20.0,15.0
1786.281,6,155,20019,92,14158,19629.0,302.0,302.0,63,5861,28810.0,83.0,83.0
0.088,6,10,1506,5,395,21.0,127.0,127.0,5,1111,18.0,843.0,843.0
0.087,6,10,1506,5,395,17.0,127.0,127.0,5,1111,20.0,843.0,843.0
0.005,6,10,2006,5,927,1.0,659.0,659.0,5,1079,1.0,811.0,811.0
0.067,6,10,1506,5,395,16.0,127.0,127.0,5,1111,14.0,843.0,843.0
0.005,17,2,154,1,69,0.0,41.0,41.0,1,85,0.0,57.0,57.0
0.076,6,10,1506,5,395,18.0,127.0,127.0,5,1111,13.0,843.0,843.0
40.064,17,10,676,5,460,10015.0,104.0,64.0,5,216,10015.0,20.0,15.0
0.071,6,10,1506,5,395,15.0,127.0,127.0,5,1111,13.0,843.0,843.0
240.022,6,9,787,5,488,60005.0,232.0,232.0,4,299,80006.0,83.0,83.0
0.071,17,8,3613,4,1874,23.0,1350.0,440.0,4,1739,13.0,1350.0,406.0
0.01,6,10,1631,5,848,2.0,580.0,580.0,5,783,2.0,515.0,515.0
15.073,17,15,9239,8,6902,2149.0,1350.0,834.0,7,2337,2507.0,1350.0,305.0
0.767,6,10,2009,6,1655,153.0,1403.0,1403.0,4,354,175.0,182.0,182.0
0.006,6,10,1854,5,889,1.0,621.0,621.0,5,965,1.0,697.0,697.0
0.01,6,10,1631,5,848,2.0,580.0,580.0,5,783,2.0,515.0,515.0
0.006,6,10,1547,5,764,1.0,496.0,496.0,5,783,1.0,515.0,515.0
0.011,6,10,1989,5,910,2.0,642.0,642.0,5,1079,2.0,811.0,811.0
0.013,6,10,1643,5,860,3.0,592.0,592.0,5,783,3.0,515.0,515.0
0.005,6,13,3747,7,509,0.0,137.0,137.0,6,3238,1.0,1470.0,1459.0
0.097,6,10,1506,5,395,18.0,127.0,127.0,5,1111,20.0,843.0,843.0
0.225,6,16,2778,8,1396,32.0,533.0,324.0,8,1382,20.0,529.0,239.0
0.011,6,10,1972,5,910,2.0,642.0,642.0,5,1062,2.0,794.0,794.0
0.005,6,10,2006,5,927,1.0,659.0,659.0,5,1079,1.0,811.0,811.0
15.121,17,19,13436,9,8280,1886.0,1350.0,892.0,10,5156,1676.0,1350.0,487.0
0.092,6,10,1506,5,395,19.0,127.0,127.0,5,1111,22.0,843.0,843.0
240.012,6,9,787,5,488,60003.0,232.0,232.0,4,299,80003.0,83.0,83.0
0.082,6,10,1506,5,395,17.0,127.0,127.0,5,1111,18.0,843.0,843.0
0.014,6,10,1762,5,911,3.0,643.0,643.0,5,851,3.0,583.0,583.0
0.131,6,10,1506,5,395,26.0,127.0,127.0,5,1111,30.0,843.0,843.0
0.052,17,2,152,1,76,0.0,48.0,48.0,1,76,0.0,48.0,48.0
40.059,17,10,676,5,460,10014.0,104.0,64.0,5,216,10013.0,20.0,15.0
0.005,6,10,1854,5,889,1.0,621.0,621.0,5,965,1.0,697.0,697.0
0.076,6,10,1506,5,395,17.0,127.0,127.0,5,1111,16.0,843.0,843.0
0.001,17,2,180,1,66,0.0,38.0,38.0,1,114,0.0,86.0,86.0
0.088,6,10,1506,5,395,20.0,127.0,127.0,5,1111,17.0,843.0,843.0
0.01,6,10,1677,5,827,2.0,559.0,559.0,5,850,2.0,582.0,582.0
0.006,6,10,1547,5,764,1.0,496.0,496.0,5,783,1.0,515.0,515.0
0.005,17,2,140,1,62,0.0,34.0,34.0,1,78,0.0,50.0,50.0
0.218,6,16,2670,8,1396,31.0,533.0,324.0,8,1274,20.0,529.0,212.0
1772.981,6,302,99278,186,88072,9583.0,3403.0,699.0,116,11206,15417.0,452.0,70.0
0.083,6,10,1506,5,395,16.0,127.0,127.0,5,1111,19.0,843.0,843.0
0.009,6,10,1990,5,911,2.0,643.0,643.0,5,1079,2.0,811.0,811.0
40.056,17,10,676,5,460,10013.0,104.0,64.0,5,216,10013.0,20.0,15.0
0.014,6,10,1989,5,910,3.0,642.0,642.0,5,1079,3.0,811.0,811.0
0.005,6,10,1643,5,860,1.0,592.0,592.0,5,783,1.0,515.0,515.0
0.005,6,10,1989,5,927,1.0,659.0,659.0,5,1062,1.0,794.0,794.0
0.015,6,13,3735,7,497,2.0,125.0,125.0,6,3238,2.0,1470.0,1459.0
0.007,6,10,1972,5,910,1.0,642.0,642.0,5,1062,1.0,794.0,794.0
11.159,17,28,4419,14,1995,845.0,270.0,114.0,14,2424,845.0,587.0,145.0
0.005,6,10,1989,5,927,1.0,659.0,659.0,5,1062,1.0,794.0,794.0
0.004,6,10,1989,5,927,1.0,659.0,659.0,5,1062,1.0,794.0,794.0
0.039,17,4,352,2,130,0.0,37.0,37.0,2,222,35.0,89.0,83.0
173.139,17,78,10909,39,2601,4556.0,44.0,38.0,39,8308,4556.0,239.0,185.0
0.116,6,10,1506,5,395,26.0,127.0,127.0,5,1111,22.0,843.0,843.0
0.017,6,10,1989,5,910,4.0,642.0,642.0,5,1079,4.0,811.0,811.0
0.004,6,10,2000,5,927,1.0,659.0,659.0,5,1073,1.0,805.0,805.0
0.01,6,10,1983,5,910,2.0,642.0,642.0,5,1073,2.0,805.0,805.0
0.005,6,13,3747,7,509,0.0,137.0,137.0,6,3238,0.0,1470.0,1459.0
40.059,17,10,676,5,460,10014.0,104.0,64.0,5,216,10013.0,20.0,15.0
0.005,6,10,2006,5,927,1.0,659.0,659.0,5,1079,1.0,811.0,811.0
0.004,17,2,148,1,60,0.0,32.0,32.0,1,88,0.0,60.0,60.0
0.01,6,10,1972,5,910,2.0,642.0,642.0,5,1062,2.0,794.0,794.0
0.005,6,10,1779,5,928,1.0,660.0,660.0,5,851,1.0,583.0,583.0
0.039,17,2,186,1,61,0.0,33.0,33.0,1,125,0.0,97.0,97.0
0.125,6,31,10372,18,9098,7.0,1515.0,816.0,13,1274,9.0,357.0,99.0
0.005,6,10,1779,5,928,1.0,660.0,660.0,5,851,1.0,583.0,583.0
0.007,6,10,1972,5,910,1.0,642.0,642.0,5,1062,1.0,794.0,794.0
0.118,6,10,1506,5,395,28.0,127.0,127.0,5,1111,27.0,843.0,843.0
0.005,17,2,230,1,68,0.0,40.0,40.0,1,162,0.0,134.0,134.0
300.326,6,16,2170,9,684,37520.0,146.0,146.0,7,1486,50025.0,419.0,398.0
1770.493,17,92,8096,46,4048,39344.0,60.0,60.0,46,4048,39344.0,60.0,60.0
0.013,6,10,1990,5,911,3.0,643.0,643.0,5,1079,3.0,811.0,811.0
0.005,6,10,1989,5,927,1.0,659.0,659.0,5,1062,1.0,794.0,794.0
0.005,6,10,2007,5,928,1.0,660.0,660.0,5,1079,1.0,811.0,811.0
0.012,6,10,1677,5,827,3.0,559.0,559.0,5,850,2.0,582.0,582.0
0.006,6,10,1989,5,927,1.0,659.0,659.0,5,1062,1.0,794.0,794.0
0.005,6,10,2006,5,927,1.0,659.0,659.0,5,1079,1.0,811.0,811.0
40.098,17,10,676,5,460,10023.0,104.0,64.0,5,216,10023.0,20.0,15.0
0.001,17,2,180,1,66,0.0,38.0,38.0,1,114,0.0,86.0,86.0
0.012,6,10,1990,5,911,2.0,643.0,643.0,5,1079,3.0,811.0,811.0
0.004,17,2,136,1,60,0.0,32.0,32.0,1,76,0.0,48.0,48.0
0.107,6,10,1506,5,395,23.0,127.0,127.0,5,1111,21.0,843.0,843.0
0.086,6,10,1506,5,395,19.0,127.0,127.0,5,1111,19.0,843.0,843.0
11.122,17,28,4419,14,1994,843.0,269.0,114.0,14,2425,843.0,588.0,145.0
0.573,6,27,8978,15,1639,32.0,517.0,211.0,12,7339,42.0,1288.0,839.0
0.005,6,10,1774,5,923,1.0,655.0,655.0,5,851,1.0,583.0,583.0
0.005,6,10,2006,5,927,1.0,659.0,659.0,5,1079,1.0,811.0,811.0
0.112,6,10,1506,5,395,23.0,127.0,127.0,5,1111,23.0,843.0,843.0
0.014,6,10,1989,5,910,3.0,642.0,642.0,5,1079,3.0,811.0,811.0
240.089,6,31,9415,15,7076,17149.0,2200.0,700.0,16,2339,16005.0,580.0,187.0
0.217,6,16,2777,8,1395,31.0,533.0,323.0,8,1382,20.0,529.0,239.0
40.076,17,10,676,5,460,10016.0,104.0,64.0,5,216,10017.0,20.0,15.0
0.01,6,10,1989,5,910,2.0,642.0,642.0,5,1079,2.0,811.0,811.0
0.004,6,10,2006,5,927,1.0,659.0,659.0,5,1079,1.0,811.0,811.0
0.021,6,10,1983,5,910,5.0,642.0,642.0,5,1073,5.0,805.0,805.0
0.005,6,10,2000,5,927,1.0,659.0,659.0,5,1073,1.0,805.0,805.0
15.079,17,14,9190,8,6902,2150.0,1350.0,834.0,6,2288,3009.0,1350.0,353.0
0.016,6,14,3787,7,497,2.0,125.0,125.0,7,3290,2.0,1448.0,972.0
158.654,17,68,9792,34,2267,4807.0,44.0,38.0,34,7525,4807.0,261.0,193.0
0.213,6,16,2777,8,1395,30.0,533.0,323.0,8,1382,19.0,529.0,239.0
40.059,17,10,676,5,460,10013.0,104.0,64.0,5,216,10014.0,20.0,15.0
40.079,17,10,676,5,460,10018.0,104.0,64.0,5,216,10019.0,20.0,15.0
0.008,6,10,1989,5,910,2.0,642.0,642.0,5,1079,1.0,811.0,811.0
0.203,6,16,2777,8,1395,29.0,533.0,323.0,8,1382,18.0,529.0,239.0
0.009,6,10,1989,5,910,2.0,642.0,642.0,5,1079,2.0,811.0,811.0
0.005,6,10,2007,5,928,1.0,660.0,660.0,5,1079,1.0,811.0,811.0
0.004,17,2,234,1,61,0.0,33.0,33.0,1,173,0.0,145.0,145.0
0.015,6,10,1989,5,910,3.0,642.0,642.0,5,1079,3.0,811.0,811.0
0.007,6,10,2007,5,928,1.0,660.0,660.0,5,1079,1.0,811.0,811.0
0.011,6,10,1990,5,911,2.0,643.0,643.0,5,1079,2.0,811.0,811.0
0.269,17,39,20247,21,17035,13.0,1350.0,783.0,18,3212,12.0,1350.0,150.0
0.005,6,10,1989,5,927,1.0,659.0,659.0,5,1062,1.0,794.0,794.0
0.076,6,10,1506,5,395,16.0,127.0,127.0,5,1111,16.0,843.0,843.0
0.088,6,10,1506,5,395,21.0,127.0,127.0,5,1111,21.0,843.0,843.0
290.928,6,317,343873,113,17428,2597.0,2736.0,888.0,204,326445,1433.0,2804.0,1662.0
0.004,6,10,1702,5,863,1.0,595.0,595.0,5,839,0.0,571.0,571.0
0.005,6,10,1643,5,860,1.0,592.0,592.0,5,783,1.0,515.0,515.0
0.01,6,10,1990,5,911,2.0,643.0,643.0,5,1079,2.0,811.0,811.0
0.079,6,10,1506,5,395,19.0,127.0,127.0,5,1111,17.0,843.0,843.0
240.158,6,19,5438,9,1236,30019.0,495.0,253.0,10,4202,26679.0,1402.0,612.0
0.076,6,10,1506,5,395,18.0,127.0,127.0,5,1111,15.0,843.0,843.0
240.02,6,9,787,5,488,60005.0,232.0,232.0,4,299,80006.0,83.0,83.0
0.087,6,10,1506,5,395,19.0,127.0,127.0,5,1111,18.0,843.0,843.0
0.005,17,2,136,1,60,0.0,32.0,32.0,1,76,0.0,48.0,48.0
0.006,6,10,1547,5,764,1.0,496.0,496.0,5,783,1.0,515.0,515.0
0.001,17,2,136,1,60,0.0,32.0,32.0,1,76,0.0,48.0,48.0
0.005,6,10,2007,5,928,1.0,660.0,660.0,5,1079,1.0,811.0,811.0
0.074,6,10,1506,5,395,16.0,127.0,127.0,5,1111,18.0,843.0,843.0
0.069,6,10,1506,5,395,13.0,127.0,127.0,5,1111,16.0,843.0,843.0
0.074,6,10,1506,5,395,17.0,127.0,127.0,5,1111,16.0,843.0,843.0
0.004,6,10,1702,5,863,1.0,595.0,595.0,5,839,1.0,571.0,571.0
0.01,6,10,1989,5,910,2.0,642.0,642.0,5,1079,2.0,811.0,811.0
0.018,6,10,1990,5,911,4.0,643.0,643.0,5,1079,4.0,811.0,811.0
0.076,6,10,1506,5,395,14.0,127.0,127.0,5,1111,18.0,843.0,843.0
0.005,6,10,1989,5,927,1.0,659.0,659.0,5,1062,1.0,794.0,794.0
0.005,17,2,175,1,65,0.0,37.0,37.0,1,110,0.0,82.0,82.0
0.005,6,14,3742,7,452,0.0,80.0,80.0,7,3290,0.0,1448.0,972.0
0.004,6,13,3747,7,509,0.0,137.0,137.0,6,3238,0.0,1470.0,1459.0
9.037,17,6,376,5,280,2259.0,28.0,28.0,1,96,0.0,68.0,68.0
0.004,6,10,1702,5,863,1.0,595.0,595.0,5,839,1.0,571.0,571.0
240.028,6,9,787,5,488,60007.0,232.0,232.0,4,299,80008.0,83.0,83.0
240.014,6,9,787,5,488,60003.0,232.0,232.0,4,299,80003.0,83.0,83.0
0.001,17,2,180,1,66,0.0,38.0,38.0,1,114,0.0,86.0,86.0
0.006,6,10,1547,5,764,1.0,496.0,496.0,5,783,1.0,515.0,515.0
0.006,6,10,1547,5,764,1.0,496.0,496.0,5,783,1.0,515.0,515.0
0.006,17,2,179,1,71,0.0,43.0,43.0,1,108,0.0,80.0,80.0
0.009,6,10,1989,5,910,2.0,642.0,642.0,5,1079,2.0,811.0,811.0
0.006,17,2,170,1,65,0.0,37.0,37.0,1,105,0.0,77.0,77.0
0.008,6,10,1989,5,910,2.0,642.0,642.0,5,1079,2.0,811.0,811.0
0.01,6,10,1989,5,910,2.0,642.0,642.0,5,1079,2.0,811.0,811.0
0.009,6,10,1989,5,910,2.0,642.0,642.0,5,1079,2.0,811.0,811.0
0.013,6,10,1631,5,848,3.0,580.0,580.0,5,783,3.0,515.0,515.0
0.164,17,2,152,1,76,0.0,48.0,48.0,1,76,0.0,48.0,48.0
0.001,17,2,180,1,66,0.0,38.0,38.0,1,114,0.0,86.0,86.0
0.004,6,10,2007,5,928,1.0,660.0,660.0,5,1079,1.0,811.0,811.0
0.11,17,2,146,1,65,0.0,37.0,37.0,1,81,0.0,53.0,53.0
0.019,6,10,1990,5,911,4.0,643.0,643.0,5,1079,4.0,811.0,811.0
172.507,17,80,11120,40,2664,4423.0,44.0,38.0,40,8456,4423.0,239.0,183.0
0.005,6,10,2006,5,927,1.0,659.0,659.0,5,1079,1.0,811.0,811.0
0.013,6,10,1989,5,910,3.0,642.0,642.0,5,1079,3.0,811.0,811.0
0.003,17,2,185,1,73,0.0,45.0,45.0,1,112,0.0,84.0,84.0
367.533,6,30,6180,19,4936,20418.0,494.0,494.0,11,1244,36753.0,83.0,83.0
0.125,6,10,1506,5,395,23.0,127.0,127.0,5,1111,29.0,843.0,843.0
0.095,6,10,1506,5,395,20.0,127.0,127.0,5,1111,21.0,843.0,843.0
40.059,17,10,676,5,460,10013.0,104.0,64.0,5,216,10014.0,20.0,15.0
0.005,6,10,1854,5,889,1.0,621.0,621.0,5,965,1.0,697.0,697.0
0.862,6,25,5555,12,1445,66.0,267.0,136.0,13,4110,60.0,1414.0,597.0
0.014,6,10,1983,5,910,3.0,642.0,642.0,5,1073,3.0,805.0,805.0
0.083,6,10,1506,5,395,16.0,127.0,127.0,5,1111,20.0,843.0,843.0
0.005,6,10,2006,5,927,1.0,659.0,659.0,5,1079,1.0,811.0,811.0
0.004,6,10,2000,5,927,1.0,659.0,659.0,5,1073,1.0,805.0,805.0
0.007,6,10,1643,5,860,1.0,592.0,592.0,5,783,1.0,515.0,515.0
0.019,6,10,1631,5,848,4.0,580.0,580.0,5,783,4.0,515.0,515.0
0.011,6,10,1972,5,910,2.0,642.0,642.0,5,1062,2.0,794.0,794.0
241.219,6,421,350170,205,22185,1182.0,2736.0,885.0,216,327985,1121.0,2804.0,1537.0
0.071,6,10,1506,5,395,17.0,127.0,127.0,5,1111,16.0,843.0,843.0
0.001,17,2,136,1,60,0.0,32.0,32.0,1,76,0.0,48.0,48.0
0.014,6,10,1972,5,910,3.0,642.0,642.0,5,1062,3.0,794.0,794.0
0.088,6,10,1506,5,395,18.0,127.0,127.0,5,1111,20.0,843.0,843.0
0.022,6,10,1972,5,910,5.0,642.0,642.0,5,1062,5.0,794.0,794.0
0.005,6,10,2006,5,927,1.0,659.0,659.0,5,1079,1.0,811.0,811.0
0.007,6,10,1547,5,764,1.0,496.0,496.0,5,783,1.0,515.0,515.0
0.012,6,13,3735,7,497,1.0,125.0,125.0,6,3238,2.0,1470.0,1459.0
0.014,6,10,1762,5,911,3.0,643.0,643.0,5,851,3.0,583.0,583.0
0.01,6,10,1989,5,910,2.0,642.0,642.0,5,1079,2.0,811.0,811.0
0.004,17,4,284,2,120,0.0,32.0,32.0,2,164,1.0,60.0,54.0
40.072,17,10,676,5,460,10015.0,104.0,64.0,5,216,10017.0,20.0,15.0
0.087,6,10,1506,5,395,19.0,127.0,127.0,5,1111,17.0,843.0,843.0
0.013,6,10,1972,5,910,3.0,642.0,642.0,5,1062,3.0,794.0,794.0
0.095,6,10,1506,5,395,22.0,127.0,127.0,5,1111,20.0,843.0,843.0
40.057,17,10,676,5,460,10013.0,104.0,64.0,5,216,10013.0,20.0,15.0
0.073,17,2,136,1,60,0.0,32.0,32.0,1,76,0.0,48.0,48.0
0.005,6,10,2007,5,928,1.0,660.0,660.0,5,1079,1.0,811.0,811.0
0.1,6,10,1506,5,395,17.0,127.0,127.0,5,1111,21.0,843.0,843.0
0.005,6,10,1989,5,927,1.0,659.0,659.0,5,1062,1.0,794.0,794.0
0.004,17,4,284,2,120,1.0,32.0,32.0,2,164,1.0,60.0,54.0
0.123,17,2,80,1,32,0.0,4.0,4.0,1,48,0.0,20.0,20.0
0.005,6,13,3690,7,452,0.0,80.0,80.0,6,3238,1.0,1470.0,1459.0
0.009,6,12,1926,6,1189,1.0,659.0,434.0,6,737,1.0,417.0,417.0
0.019,6,10,1677,5,827,4.0,559.0,559.0,5,850,4.0,582.0,582.0
0.006,6,10,1547,5,764,1.0,496.0,496.0,5,783,1.0,515.0,515.0
0.005,6,10,1774,5,923,1.0,655.0,655.0,5,851,1.0,583.0,583.0
0.005,6,10,1643,5,860,1.0,592.0,592.0,5,783,1.0,515.0,515.0
0.005,6,10,2000,5,927,1.0,659.0,659.0,5,1073,1.0,805.0,805.0
0.014,6,13,3735,7,497,2.0,125.0,125.0,6,3238,2.0,1470.0,1459.0
0.004,17,2,136,1,60,0.0,32.0,32.0,1,76,0.0,48.0,48.0
0.012,6,10,1983,5,910,3.0,642.0,642.0,5,1073,2.0,805.0,805.0
0.016,6,10,1989,5,910,4.0,642.0,642.0,5,1079,4.0,811.0,811.0
40.069,17,10,676,5,460,10015.0,104.0,64.0,5,216,10016.0,20.0,15.0
0.01,6,10,1989,5,910,2.0,642.0,642.0,5,1079,2.0,811.0,811.0
0.005,6,10,2006,5,927,1.0,659.0,659.0,5,1079,1.0,811.0,811.0
0.075,6,10,1506,5,395,16.0,127.0,127.0,5,1111,18.0,843.0,843.0
0.005,17,2,164,1,74,0.0,46.0,46.0,1,90,0.0,62.0,62.0
0.082,6,10,1506,5,395,17.0,127.0,127.0,5,1111,19.0,843.0,843.0
0.082,6,10,1506,5,395,18.0,127.0,127.0,5,1111,19.0,843.0,843.0
0.011,6,10,1972,5,910,2.0,642.0,642.0,5,1062,2.0,794.0,794.0
0.005,6,10,2006,5,927,1.0,659.0,659.0,5,1079,1.0,811.0,811.0
0.013,6,10,1972,5,910,3.0,642.0,642.0,5,1062,3.0,794.0,794.0
0.017,6,10,1990,5,911,4.0,643.0,643.0,5,1079,4.0,811.0,811.0
0.013,6,10,1990,5,911,3.0,643.0,643.0,5,1079,3.0,811.0,811.0
0.006,6,10,2000,5,927,1.0,659.0,659.0,5,1073,1.0,805.0,805.0
0.007,17,2,179,1,71,0.0,43.0,43.0,1,108,0.0,80.0,80.0
0.013,6,10,1972,5,910,3.0,642.0,642.0,5,1062,3.0,794.0,794.0
0.005,17,2,164,1,74,0.0,46.0,46.0,1,90,0.0,62.0,62.0
0.004,17,2,148,1,60,0.0,32.0,32.0,1,88,0.0,60.0,60.0
0.094,6,10,1506,5,395,20.0,127.0,127.0,5,1111,19.0,843.0,843.0
0.003,17,2,136,1,60,0.0,32.0,32.0,1,76,0.0,48.0,48.0
0.005,17,2,222,1,65,0.0,37.0,37.0,1,157,0.0,129.0,129.0
0.005,6,10,2006,5,927,1.0,659.0,659.0,5,1079,1.0,811.0,811.0
11.067,17,28,4423,14,1995,839.0,270.0,114.0,14,2428,839.0,587.0,145.0
292.238,6,403,347967,199,21913,1475.0,2736.0,889.0,204,326054,1439.0,2804.0,1660.0
0.016,6,13,3735,7,497,2.0,125.0,125.0,6,3238,3.0,1470.0,1459.0
0.005,6,10,2006,5,927,1.0,659.0,659.0,5,1079,1.0,811.0,811.0
0.116,6,10,1506,5,395,25.0,127.0,127.0,5,1111,24.0,843.0,843.0
0.01,6,10,1989,5,910,2.0,642.0,642.0,5,1079,2.0,811.0,811.0
1385.244,6,170,11584,65,4992,21644.0,46.0,46.0,105,6592,13318.0,46.0,46.0
0.024,6,10,1983,5,910,5.0,642.0,642.0,5,1073,6.0,805.0,805.0
0.005,17,2,164,1,74,0.0,46.0,46.0,1,90,0.0,62.0,62.0
15.072,17,15,9239,8,6902,2149.0,1350.0,834.0,7,2337,2507.0,1350.0,305.0
0.003,17,2,132,1,58,0.0,30.0,30.0,1,74,0.0,46.0,46.0
0.073,6,10,1506,5,395,17.0,127.0,127.0,5,1111,14.0,843.0,843.0
10.745,17,28,4422,14,1993,818.0,268.0,114.0,14,2429,818.0,588.0,145.0
1770.296,6,83,4368,42,2210,43176.0,26.0,26.0,41,2158,44256.0,26.0,26.0
0.011,6,10,1972,5,910,2.0,642.0,642.0,5,1062,2.0,794.0,794.0
0.04,17,2,136,1,60,0.0,32.0,32.0,1,76,0.0,48.0,48.0
0.016,6,10,1677,5,827,4.0,559.0,559.0,5,850,3.0,582.0,582.0
0.073,6,10,1506,5,395,17.0,127.0,127.0,5,1111,17.0,843.0,843.0
0.005,6,10,1547,5,764,1.0,496.0,496.0,5,783,1.0,515.0,515.0
0.011,6,10,1762,5,911,2.0,643.0,643.0,5,851,2.0,583.0,583.0
167.168,17,80,11270,40,2664,4286.0,44.0,38.0,40,8606,4286.0,239.0,187.0
0.018,17,2,144,1,64,0.0,36.0,36.0,1,80,0.0,52.0,52.0
0.006,6,10,1547,5,764,1.0,496.0,496.0,5,783,1.0,515.0,515.0
509.972,6,27,6784,14,3709,39228.0,676.0,495.0,13,3075,42497.0,824.0,480.0
0.122,6,10,1506,5,395,26.0,127.0,127.0,5,1111,25.0,843.0,843.0
0.011,6,10,1983,5,910,2.0,642.0,642.0,5,1073,2.0,805.0,805.0
0.004,17,2,148,1,60,0.0,32.0,32.0,1,88,0.0,60.0,60.0
0.126,6,10,1506,5,395,30.0,127.0,127.0,5,1111,28.0,843.0,843.0
0.004,17,2,136,1,60,0.0,32.0,32.0,1,76,0.0,48.0,48.0
300.33,6,35,12328,18,6193,17666.0,1766.0,748.0,17,6135,18770.0,1656.0,750.0
1753.119,6,303,97512,187,86388,9425.0,1402.0,678.0,116,11124,15244.0,452.0,70.0
0.012,6,10,1990,5,911,2.0,643.0,643.0,5,1079,3.0,811.0,811.0
0.026,6,10,1983,5,910,6.0,642.0,642.0,5,1073,6.0,805.0,805.0
1.154,6,30,13311,17,5852,72.0,2720.0,854.0,13,7459,81.0,2720.0,769.0
0.037,17,4,420,2,122,0.0,33.0,33.0,2,298,33.0,145.0,121.0
0.003,17,4,284,2,120,0.0,32.0,32.0,2,164,0.0,60.0,54.0
368.507,6,22,2313,16,867,24567.0,195.0,195.0,6,1446,4638.0,419.0,398.0
0.009,6,10,1989,5,910,2.0,642.0,642.0,5,1079,2.0,811.0,811.0
15.082,17,15,7969,8,5929,2150.0,1350.0,713.0,7,2040,2508.0,1350.0,263.0
11.222,17,28,4395,14,1995,850.0,270.0,114.0,14,2400,850.0,587.0,143.0
0.006,6,10,1547,5,764,1.0,496.0,496.0,5,783,1.0,515.0,515.0
0.092,6,10,1506,5,395,18.0,127.0,127.0,5,1111,21.0,843.0,843.0
0.001,17,2,180,1,65,0.0,37.0,37.0,1,115,0.0,87.0,87.0
0.01,6,10,1972,5,910,2.0,642.0,642.0,5,1062,2.0,794.0,794.0
0.005,6,10,2006,5,927,1.0,659.0,659.0,5,1079,1.0,811.0,811.0
0.015,17,2,214,1,75,0.0,47.0,47.0,1,139,0.0,111.0,111.0
0.018,6,10,1983,5,910,4.0,642.0,642.0,5,1073,4.0,805.0,805.0
175.202,17,78,11195,39,2612,4610.0,44.0,38.0,39,8583,4610.0,239.0,192.0
0.004,17,4,284,2,120,0.0,32.0,32.0,2,164,0.0,60.0,54.0
0.011,6,10,1972,5,910,2.0,642.0,642.0,5,1062,2.0,794.0,794.0
0.009,6,12,1926,6,1189,1.0,659.0,434.0,6,737,1.0,417.0,417.0
0.018,6,10,1972,5,910,4.0,642.0,642.0,5,1062,4.0,794.0,794.0
0.005,6,10,2000,5,927,1.0,659.0,659.0,5,1073,1.0,805.0,805.0
0.007,6,10,1989,5,910,1.0,642.0,642.0,5,1079,1.0,811.0,811.0
309.143,17,20,1124,10,716,34335.0,48.0,43.0,10,408,34335.0,20.0,12.0
0.003,17,2,136,1,60,0.0,32.0,32.0,1,76,0.0,48.0,48.0
0.058,6,10,1506,5,395,12.0,127.0,127.0,5,1111,14.0,843.0,843.0
11.096,17,30,5332,15,2290,780.0,269.0,124.0,15,3042,780.0,1144.0,174.0
0.013,17,2,152,1,56,0.0,28.0,28.0,1,96,0.0,68.0,68.0
0.008,6,10,1990,5,911,1.0,643.0,643.0,5,1079,2.0,811.0,811.0
0.01,6,10,1972,5,910,2.0,642.0,642.0,5,1062,2.0,794.0,794.0
0.057,17,2,232,1,92,0.0,64.0,64.0,1,140,0.0,112.0,112.0
241.314,6,364,346621,186,21191,1304.0,2736.0,959.0,178,325430,1363.0,4206.0,1881.0
0.006,6,10,1689,5,839,1.0,571.0,571.0,5,850,1.0,582.0,582.0
0.009,6,10,1972,5,910,2.0,642.0,642.0,5,1062,2.0,794.0,794.0
361.795,6,19,1688,15,978,25842.0,190.0,190.0,4,710,80014.0,494.0,494.0
0.005,6,10,2006,5,927,1.0,659.0,659.0,5,1079,1.0,811.0,811.0
0.091,6,10,1506,5,395,21.0,127.0,127.0,5,1111,17.0,843.0,843.0
0.003,17,2,170,1,65,0.0,37.0,37.0,1,105,0.0,77.0,77.0
0.011,6,10,1989,5,910,2.0,642.0,642.0,5,1079,2.0,811.0,811.0
0.015,6,11,2042,6,963,3.0,643.0,643.0,5,1079,3.0,811.0,811.0
0.006,6,10,2000,5,927,1.0,659.0,659.0,5,1073,1.0,805.0,805.0
0.024,6,10,1983,5,910,5.0,642.0,642.0,5,1073,5.0,805.0,805.0
0.005,6,13,3747,7,509,0.0,137.0,137.0,6,3238,1.0,1470.0,1459.0
0.039,17,2,136,1,60,0.0,32.0,32.0,1,76,0.0,48.0,48.0
0.064,6,10,1506,5,395,13.0,127.0,127.0,5,1111,15.0,843.0,843.0
11.143,17,28,4421,14,1994,844.0,269.0,114.0,14,2427,844.0,586.0,145.0
0.106,6,10,1506,5,395,24.0,127.0,127.0,5,1111,23.0,843.0,843.0
0.015,6,10,1989,5,910,3.0,642.0,642.0,5,1079,3.0,811.0,811.0
0.014,6,10,1989,5,910,3.0,642.0,642.0,5,1079,3.0,811.0,811.0
0.106,6,10,1506,5,395,22.0,127.0,127.0,5,1111,21.0,843.0,843.0
0.014,6,10,1989,5,910,3.0,642.0,642.0,5,1079,3.0,811.0,811.0
0.004,6,10,2000,5,927,1.0,659.0,659.0,5,1073,1.0,805.0,805.0
0.005,6,14,3799,7,509,0.0,137.0,137.0,7,3290,0.0,1448.0,972.0
15.168,17,20,10916,10,7384,1682.0,1350.0,710.0,10,3532,1682.0,1350.0,325.0
0.006,6,10,1547,5,764,1.0,496.0,496.0,5,783,1.0,515.0,515.0
0.014,6,10,1989,5,910,3.0,642.0,642.0,5,1079,3.0,811.0,811.0
0.01,17,2,230,1,68,0.0,40.0,40.0,1,162,0.0,134.0,134.0
0.005,6,10,2007,5,928,1.0,660.0,660.0,5,1079,1.0,811.0,811.0
308.645,17,18,1008,9,640,38573.0,48.0,43.0,9,368,38573.0,20.0,12.0
0.068,6,10,1506,5,395,16.0,127.0,127.0,5,1111,15.0,843.0,843.0
0.084,6,10,1506,5,395,17.0,127.0,127.0,5,1111,19.0,843.0,843.0
0.001,17,2,154,1,69,0.0,41.0,41.0,1,85,0.0,57.0,57.0
0.011,6,10,1990,5,911,2.0,643.0,643.0,5,1079,2.0,811.0,811.0
0.005,6,10,2006,5,927,1.0,659.0,659.0,5,1079,1.0,811.0,811.0
0.005,6,10,2007,5,928,1.0,660.0,660.0,5,1079,1.0,811.0,811.0
0.005,6,10,2006,5,927,1.0,659.0,659.0,5,1079,1.0,811.0,811.0
0.011,6,10,1990,5,911,2.0,643.0,643.0,5,1079,2.0,811.0,811.0
0.127,6,10,1506,5,395,28.0,127.0,127.0,5,1111,29.0,843.0,843.0
1778.564,17,144,45504,72,22752,25048.0,288.0,288.0,72,22752,25049.0,288.0,288.0
367.101,6,22,2313,16,867,24473.0,195.0,195.0,6,1446,4644.0,419.0,398.0
0.006,6,10,1547,5,764,1.0,496.0,496.0,5,783,1.0,515.0,515.0
0.068,6,10,1506,5,395,14.0,127.0,127.0,5,1111,16.0,843.0,843.0
0.006,6,10,2007,5,928,1.0,660.0,660.0,5,1079,1.0,811.0,811.0
241.166,6,399,348140,192,21507,1262.0,2736.0,959.0,207,326633,1170.0,2804.0,1603.0
1790.926,6,284,26940,142,9824,12701.0,747.0,270.0,142,17116,12701.0,1624.0,72.0
0.004,6,10,1774,5,923,1.0,655.0,655.0,5,851,1.0,583.0,583.0
0.015,6,10,1983,5,910,3.0,642.0,642.0,5,1073,3.0,805.0,805.0
0.022,6,19,9922,11,704,2.0,124.0,124.0,8,9218,3.0,2896.0,2198.0
0.005,6,10,1689,5,839,1.0,571.0,571.0,5,850,1.0,582.0,582.0
0.006,6,10,1547,5,764,1.0,496.0,496.0,5,783,1.0,515.0,515.0
0.013,6,13,3735,7,497,2.0,125.0,125.0,6,3238,2.0,1470.0,1459.0
0.107,6,10,1506,5,395,24.0,127.0,127.0,5,1111,25.0,843.0,843.0
0.009,6,12,1926,6,1189,1.0,659.0,434.0,6,737,1.0,417.0,417.0
0.006,6,10,1643,5,860,1.0,592.0,592.0,5,783,1.0,515.0,515.0
0.011,6,10,1762,5,911,2.0,643.0,643.0,5,851,2.0,583.0,583.0
0.005,6,10,2007,5,928,1.0,660.0,660.0,5,1079,1.0,811.0,811.0
0.212,6,16,2669,8,1395,30.0,533.0,323.0,8,1274,19.0,529.0,212.0
1770.254,17,92,8096,46,4048,39338.0,60.0,60.0,46,4048,39338.0,60.0,60.0
240.14,6,46,6910,22,3223,11435.0,588.0,230.0,24,3687,10440.0,580.0,221.0
0.005,6,10,2000,5,927,1.0,659.0,659.0,5,1073,1.0,805.0,805.0
40.059,17,10,676,5,460,10013.0,104.0,64.0,5,216,10014.0,20.0,15.0
0.039,17,4,284,2,120,1.0,32.0,32.0,2,164,36.0,60.0,54.0
0.371,17,47,24968,25,21216,15.0,1350.0,820.0,22,3752,14.0,1350.0,142.0
290.127,6,376,346762,195,21706,1495.0,2736.0,889.0,181,325056,1611.0,2999.0,1890.0
0.009,6,13,3735,7,497,1.0,125.0,125.0,6,3238,1.0,1470.0,1459.0
0.198,6,10,1506,5,395,48.0,127.0,127.0,5,1111,45.0,843.0,843.0
40.071,17,10,676,5,460,10015.0,104.0,64.0,5,216,10017.0,20.0,15.0
0.001,17,2,136,1,60,0.0,32.0,32.0,1,76,0.0,48.0,48.0
300.903,6,37,8261,20,1830,15837.0,651.0,249.0,17,6431,547.0,2126.0,478.0
0.006,6,10,1643,5,860,1.0,592.0,592.0,5,783,1.0,515.0,515.0
0.015,6,10,1989,5,910,3.0,642.0,642.0,5,1079,3.0,811.0,811.0
0.036,17,2,148,1,60,0.0,32.0,32.0,1,88,0.0,60.0,60.0
293.45,6,317,344340,122,17901,2425.0,2736.0,825.0,195,326439,1512.0,2804.0,1747.0
0.004,6,10,1989,5,927,1.0,659.0,659.0,5,1062,1.0,794.0,794.0
0.001,17,2,180,1,66,0.0,38.0,38.0,1,114,0.0,86.0,86.0
0.014,6,10,1972,5,910,3.0,642.0,642.0,5,1062,3.0,794.0,794.0
0.013,6,10,1972,5,910,3.0,642.0,642.0,5,1062,3.0,794.0,794.0
0.009,6,14,3787,7,497,1.0,125.0,125.0,7,3290,1.0,1448.0,972.0
0.004,6,10,2007,5,928,1.0,660.0,660.0,5,1079,1.0,811.0,811.0
0.006,17,2,179,1,71,0.0,43.0,43.0,1,108,0.0,80.0,80.0
0.003,17,2,136,1,60,0.0,32.0,32.0,1,76,0.0,48.0,48.0
0.009,6,10,1989,5,910,2.0,642.0,642.0,5,1079,2.0,811.0,811.0
0.127,6,10,1506,5,395,28.0,127.0,127.0,5,1111,25.0,843.0,843.0
0.012,6,10,1989,5,910,2.0,642.0,642.0,5,1079,3.0,811.0,811.0
300.271,6,16,2170,9,684,37513.0,146.0,146.0,7,1486,50017.0,419.0,398.0
240.153,6,34,13204,17,7187,15009.0,2208.0,700.0,17,6017,15009.0,2376.0,569.0
240.092,6,16,4482,9,963,30011.0,238.0,166.0,7,3519,40014.0,1402.0,786.0
0.08,6,10,1506,5,395,16.0,127.0,127.0,5,1111,19.0,843.0,843.0
0.008,6,12,1698,6,863,1.0,327.0,271.0,6,835,1.0,515.0,515.0
0.017,6,10,1631,5,848,4.0,580.0,580.0,5,783,4.0,515.0,515.0
0.004,6,10,2006,5,927,1.0,659.0,659.0,5,1079,1.0,811.0,811.0
0.01,6,12,1926,6,1189,2.0,659.0,434.0,6,737,2.0,417.0,417.0
0.018,6,10,1989,5,910,4.0,642.0,642.0,5,1079,4.0,811.0,811.0
0.005,17,2,179,1,71,0.0,43.0,43.0,1,108,0.0,80.0,80.0
15.073,17,15,9239,8,6902,2149.0,1350.0,834.0,7,2337,2507.0,1350.0,305.0
0.005,17,2,164,1,74,0.0,46.0,46.0,1,90,0.0,62.0,62.0
0.01,6,10,1972,5,910,2.0,642.0,642.0,5,1062,2.0,794.0,794.0
0.009,6,12,1926,6,1189,1.0,659.0,434.0,6,737,1.0,417.0,417.0
0.091,6,10,1506,5,395,16.0,127.0,127.0,5,1111,21.0,843.0,843.0
9.037,17,6,376,5,280,2259.0,28.0,28.0,1,96,0.0,68.0,68.0
0.003,17,2,148,1,60,0.0,32.0,32.0,1,88,0.0,60.0,60.0
0.007,6,10,1547,5,764,1.0,496.0,496.0,5,783,1.0,515.0,515.0
0.011,6,10,1677,5,827,2.0,559.0,559.0,5,850,2.0,582.0,582.0
0.097,6,10,1506,5,395,22.0,127.0,127.0,5,1111,22.0,843.0,843.0
0.115,6,10,1506,5,395,26.0,127.0,127.0,5,1111,25.0,843.0,843.0
0.001,17,2,179,1,62,0.0,34.0,34.0,1,117,0.0,89.0,89.0
0.054,17,2,144,1,64,0.0,36.0,36.0,1,80,0.0,52.0,52.0
0.004,6,10,1702,5,863,0.0,595.0,595.0,5,839,1.0,571.0,571.0
0.011,6,10,1989,5,910,2.0,642.0,642.0,5,1079,2.0,811.0,811.0
0.006,6,10,1547,5,764,1.0,496.0,496.0,5,783,1.0,515.0,515.0
0.005,6,10,1989,5,927,1.0,659.0,659.0,5,1062,1.0,794.0,794.0
0.013,6,10,1631,5,848,3.0,580.0,580.0,5,783,3.0,515.0,515.0
0.005,17,2,230,1,68,0.0,40.0,40.0,1,162,0.0,134.0,134.0
15.088,17,15,7975,8,5938,2150.0,1350.0,714.0,7,2037,2509.0,1350.0,263.0
0.005,6,10,2006,5,927,1.0,659.0,659.0,5,1079,1.0,811.0,811.0
0.005,17,2,230,1,68,0.0,40.0,40.0,1,162,0.0,134.0,134.0
0.005,6,10,2007,5,928,1.0,660.0,660.0,5,1079,1.0,811.0,811.0
0.005,6,10,2000,5,927,1.0,659.0,659.0,5,1073,1.0,805.0,805.0
0.008,6,10,1989,5,910,2.0,642.0,642.0,5,1079,1.0,811.0,811.0
0.006,6,10,1547,5,764,1.0,496.0,496.0,5,783,1.0,515.0,515.0
0.004,17,2,136,1,60,0.0,32.0,32.0,1,76,0.0,48.0,48.0
10.926,17,28,4422,14,1994,831.0,269.0,114.0,14,2428,831.0,587.0,145.0
0.009,6,12,1926,6,1189,1.0,659.0,434.0,6,737,1.0,417.0,417.0
0.005,6,10,2006,5,927,1.0,659.0,659.0,5,1079,1.0,811.0,811.0
0.107,6,10,1506,5,395,24.0,127.0,127.0,5,1111,23.0,843.0,843.0
0.005,6,10,2006,5,927,1.0,659.0,659.0,5,1079,1.0,811.0,811.0
0.025,17,2,152,1,56,0.0,28.0,28.0,1,96,0.0,68.0,68.0
1777.211,6,64,7344,42,4469,43346.0,1625.0,108.0,22,2875,84621.0,1111.0,82.0
0.013,17,2,152,1,56,0.0,28.0,28.0,1,96,0.0,68.0,68.0
0.006,6,10,1547,5,764,1.0,496.0,496.0,5,783,1.0,515.0,515.0
0.04,17,2,184,1,61,0.0,33.0,33.0,1,123,0.0,95.0,95.0
0.008,6,12,1926,6,1189,1.0,659.0,434.0,6,737,1.0,417.0,417.0
0.092,6,10,1506,5,395,21.0,127.0,127.0,5,1111,22.0,843.0,843.0
0.005,17,2,166,1,75,0.0,47.0,47.0,1,91,0.0,63.0,63.0
0.131,6,10,1506,5,395,26.0,127.0,127.0,5,1111,29.0,843.0,843.0
0.013,17,2,152,1,56,0.0,28.0,28.0,1,96,0.0,68.0,68.0
174.32,17,102,15189,51,3452,3486.0,44.0,39.0,51,11737,3486.0,279.0,202.0
0.008,6,10,1989,5,910,2.0,642.0,642.0,5,1079,2.0,811.0,811.0
0.009,6,10,1762,5,911,2.0,643.0,643.0,5,851,2.0,583.0,583.0
0.009,6,10,1989,5,910,2.0,642.0,642.0,5,1079,2.0,811.0,811.0
0.125,6,10,1506,5,395,29.0,127.0,127.0,5,1111,26.0,843.0,843.0
0.136,6,10,1506,5,395,31.0,127.0,127.0,5,1111,26.0,843.0,843.0
0.059,17,2,152,1,76,0.0,48.0,48.0,1,76,0.0,48.0,48.0
0.066,6,10,1506,5,395,15.0,127.0,127.0,5,1111,14.0,843.0,843.0
0.005,6,10,1774,5,923,1.0,655.0,655.0,5,851,1.0,583.0,583.0
0.002,17,2,152,1,76,0.0,48.0,48.0,1,76,0.0,48.0,48.0
0.005,17,2,179,1,71,0.0,43.0,43.0,1,108,0.0,80.0,80.0
40.064,17,10,676,5,460,10014.0,104.0,64.0,5,216,10015.0,20.0,15.0
0.013,17,2,152,1,56,0.0,28.0,28.0,1,96,0.0,68.0,68.0
40.06,17,10,676,5,460,10011.0,104.0,64.0,5,216,10013.0,20.0,15.0
0.008,6,10,1689,5,839,1.0,571.0,571.0,5,850,1.0,582.0,582.0
0.082,6,10,1506,5,395,16.0,127.0,127.0,5,1111,19.0,843.0,843.0
0.005,6,10,1774,5,923,1.0,655.0,655.0,5,851,1.0,583.0,583.0
0.005,17,2,230,1,68,0.0,40.0,40.0,1,162,0.0,134.0,134.0
0.01,6,10,1989,5,910,2.0,642.0,642.0,5,1079,2.0,811.0,811.0
0.021,6,10,1983,5,910,5.0,642.0,642.0,5,1073,5.0,805.0,805.0
0.005,6,10,2000,5,927,1.0,659.0,659.0,5,1073,1.0,805.0,805.0
0.085,6,10,1506,5,395,18.0,127.0,127.0,5,1111,16.0,843.0,843.0
0.004,6,10,2007,5,928,1.0,660.0,660.0,5,1079,1.0,811.0,811.0
0.09,6,10,1506,5,395,20.0,127.0,127.0,5,1111,18.0,843.0,843.0
0.006,6,10,1547,5,764,1.0,496.0,496.0,5,783,1.0,515.0,515.0
0.008,6,10,1972,5,910,2.0,642.0,642.0,5,1062,1.0,794.0,794.0
0.005,17,2,164,1,74,0.0,46.0,46.0,1,90,0.0,62.0,62.0
0.005,6,10,2007,5,928,1.0,660.0,660.0,5,1079,1.0,811.0,811.0
0.12,6,10,1506,5,395,27.0,127.0,127.0,5,1111,23.0,843.0,843.0
0.009,6,10,1989,5,910,2.0,642.0,642.0,5,1079,2.0,811.0,811.0
0.223,6,16,2669,8,1395,31.0,533.0,323.0,8,1274,20.0,529.0,212.0
353.395,6,20,2210,6,1308,12004.0,494.0,494.0,14,902,27184.0,83.0,83.0
177.379,17,74,10537,37,2473,4926.0,44.0,38.0,37,8064,4927.0,239.0,189.0
0.013,6,10,1983,5,910,3.0,642.0,642.0,5,1073,3.0,805.0,805.0
0.013,6,10,1990,5,911,3.0,643.0,643.0,5,1079,3.0,811.0,811.0
240.108,6,32,9315,16,7054,16007.0,1515.0,622.0,16,2261,16007.0,580.0,177.0
0.005,6,10,1989,5,927,1.0,659.0,659.0,5,1062,1.0,794.0,794.0
361.825,6,19,1689,15,978,25844.0,190.0,190.0,4,711,80013.0,495.0,495.0
0.004,6,10,1702,5,863,0.0,595.0,595.0,5,839,1.0,571.0,571.0
0.112,6,10,1506,5,395,23.0,127.0,127.0,5,1111,21.0,843.0,843.0
0.008,17,2,144,1,64,0.0,36.0,36.0,1,80,0.0,52.0,52.0
352.257,6,20,2210,6,1308,12004.0,494.0,494.0,14,902,27096.0,83.0,83.0
0.013,17,2,136,1,60,0.0,32.0,32.0,1,76,0.0,48.0,48.0
1769.364,17,92,8096,46,4048,39317.0,60.0,60.0,46,4048,39319.0,60.0,60.0
0.28,17,4,352,2,130,243.0,37.0,37.0,2,222,144.0,89.0,83.0
0.005,6,10,2006,5,927,1.0,659.0,659.0,5,1079,1.0,811.0,811.0
40.044,17,10,676,5,460,10010.0,104.0,64.0,5,216,10010.0,20.0,15.0
0.006,6,10,1689,5,839,1.0,571.0,571.0,5,850,1.0,582.0,582.0
0.098,6,10,1506,5,395,20.0,127.0,127.0,5,1111,23.0,843.0,843.0
0.001,17,2,166,1,75,0.0,47.0,47.0,1,91,0.0,63.0,63.0
0.011,6,10,1972,5,910,2.0,642.0,642.0,5,1062,2.0,794.0,794.0
0.005,6,10,1689,5,839,1.0,571.0,571.0,5,850,1.0,582.0,582.0
0.006,6,12,1698,6,863,1.0,327.0,271.0,6,835,1.0,515.0,515.0
0.006,6,10,2007,5,928,1.0,660.0,660.0,5,1079,1.0,811.0,811.0
0.013,6,10,1762,5,911,3.0,643.0,643.0,5,851,3.0,583.0,583.0
0.003,17,2,136,1,60,0.0,32.0,32.0,1,76,0.0,48.0,48.0
40.065,17,10,676,5,460,10015.0,104.0,64.0,5,216,10014.0,20.0,15.0
0.019,6,10,1989,5,910,4.0,642.0,642.0,5,1079,4.0,811.0,811.0
0.009,6,10,1972,5,910,2.0,642.0,642.0,5,1062,2.0,794.0,794.0
240.101,6,16,4481,9,963,30012.0,238.0,166.0,7,3518,40016.0,1402.0,786.0
1770.463,6,83,4368,42,2210,43181.0,26.0,26.0,41,2158,44260.0,26.0,26.0
0.015,6,10,1989,5,910,3.0,642.0,642.0,5,1079,3.0,811.0,811.0
10.787,17,28,4423,14,1994,821.0,269.0,114.0,14,2429,821.0,588.0,145.0
0.087,6,10,1506,5,395,19.0,127.0,127.0,5,1111,18.0,843.0,843.0
0.008,6,10,1989,5,910,2.0,642.0,642.0,5,1079,1.0,811.0,811.0
0.006,6,10,1547,5,764,1.0,496.0,496.0,5,783,1.0,515.0,515.0
0.063,6,10,1506,5,395,14.0,127.0,127.0,5,1111,13.0,843.0,843.0
0.087,6,10,1506,5,395,20.0,127.0,127.0,5,1111,19.0,843.0,843.0
0.053,17,2,152,1,76,0.0,48.0,48.0,1,76,0.0,48.0,48.0
0.011,6,10,1983,5,910,2.0,642.0,642.0,5,1073,2.0,805.0,805.0
0.006,6,10,1689,5,839,1.0,571.0,571.0,5,850,1.0,582.0,582.0
0.011,6,10,1972,5,910,2.0,642.0,642.0,5,1062,2.0,794.0,794.0
0.007,6,10,1547,5,764,1.0,496.0,496.0,5,783,1.0,515.0,515.0
0.003,17,4,284,2,120,0.0,32.0,32.0,2,164,0.0,60.0,54.0
0.007,6,10,2006,5,927,1.0,659.0,659.0,5,1079,1.0,811.0,811.0
0.066,17,8,3613,4,1874,22.0,1350.0,440.0,4,1739,10.0,1350.0,406.0
0.078,6,10,1506,5,395,17.0,127.0,127.0,5,1111,17.0,843.0,843.0
0.005,6,10,1989,5,927,1.0,659.0,659.0,5,1062,1.0,794.0,794.0
0.015,6,10,1972,5,910,3.0,642.0,642.0,5,1062,3.0,794.0,794.0
0.008,6,10,1972,5,910,1.0,642.0,642.0,5,1062,2.0,794.0,794.0
0.136,6,10,1506,5,395,33.0,127.0,127.0,5,1111,32.0,843.0,843.0
0.004,6,10,1989,5,927,1.0,659.0,659.0,5,1062,1.0,794.0,794.0
0.005,6,10,1989,5,927,1.0,659.0,659.0,5,1062,1.0,794.0,794.0
0.012,6,10,1983,5,910,3.0,642.0,642.0,5,1073,3.0,805.0,805.0
0.006,6,10,1643,5,860,1.0,592.0,592.0,5,783,1.0,515.0,515.0
0.006,6,10,1547,5,764,1.0,496.0,496.0,5,783,1.0,515.0,515.0
0.014,6,10,1989,5,910,3.0,642.0,642.0,5,1079,3.0,811.0,811.0
0.008,17,2,194,1,59,0.0,31.0,31.0,1,135,0.0,107.0,107.0
0.015,17,4,284,2,120,0.0,32.0,32.0,2,164,0.0,60.0,54.0
0.017,6,10,1762,5,911,4.0,643.0,643.0,5,851,4.0,583.0,583.0
0.022,6,10,1990,5,911,5.0,643.0,643.0,5,1079,5.0,811.0,811.0
40.062,17,10,676,5,460,10012.0,104.0,64.0,5,216,10014.0,20.0,15.0
0.006,6,14,3742,8,504,0.0,80.0,80.0,6,3238,1.0,1470.0,1459.0
40.099,17,10,676,5,460,10021.0,104.0,64.0,5,216,10023.0,20.0,15.0
0.004,17,2,148,1,60,0.0,32.0,32.0,1,88,0.0,60.0,60.0
0.006,17,2,408,1,72,0.0,44.0,44.0,1,336,0.0,308.0,308.0
0.024,6,10,1990,5,911,5.0,643.0,643.0,5,1079,6.0,811.0,811.0
0.007,17,2,179,1,71,0.0,43.0,43.0,1,108,0.0,80.0,80.0
0.009,6,10,1631,5,848,2.0,580.0,580.0,5,783,2.0,515.0,515.0
0.005,6,10,2000,5,927,1.0,659.0,659.0,5,1073,1.0,805.0,805.0
40.07,17,10,676,5,460,10014.0,104.0,64.0,5,216,10016.0,20.0,15.0
240.026,6,9,787,5,488,60006.0,232.0,232.0,4,299,80007.0,83.0,83.0
0.005,17,2,144,1,64,0.0,36.0,36.0,1,80,0.0,52.0,52.0
0.072,6,10,1506,5,395,16.0,127.0,127.0,5,1111,13.0,843.0,843.0
0.037,6,10,1972,5,910,9.0,642.0,642.0,5,1062,9.0,794.0,794.0
0.013,6,10,1990,5,911,3.0,643.0,643.0,5,1079,3.0,811.0,811.0
0.006,6,10,1689,5,839,1.0,571.0,571.0,5,850,1.0,582.0,582.0
51.288,6,28,9605,14,1707,3945.0,794.0,367.0,14,7898,3933.0,1360.0,732.0
0.02,6,10,1972,5,910,4.0,642.0,642.0,5,1062,5.0,794.0,794.0
0.015,6,10,1677,5,827,3.0,559.0,559.0,5,850,3.0,582.0,582.0
0.097,6,10,1506,5,395,22.0,127.0,127.0,5,1111,19.0,843.0,843.0
11.214,17,28,4422,14,1993,850.0,268.0,114.0,14,2429,850.0,588.0,145.0
0.009,6,10,1972,5,910,2.0,642.0,642.0,5,1062,2.0,794.0,794.0
0.01,6,10,1989,5,910,2.0,642.0,642.0,5,1079,2.0,811.0,811.0
0.004,6,10,1702,5,863,1.0,595.0,595.0,5,839,1.0,571.0,571.0
0.005,17,2,186,1,60,0.0,32.0,32.0,1,126,0.0,98.0,98.0
11.179,17,28,4422,14,1994,847.0,269.0,114.0,14,2428,847.0,587.0,145.0
0.005,6,10,2006,5,927,1.0,659.0,659.0,5,1079,1.0,811.0,811.0
240.265,6,28,15902,15,6973,17161.0,2736.0,1032.0,13,8929,20021.0,1908.0,1177.0
0.131,6,10,1506,5,395,29.0,127.0,127.0,5,1111,27.0,843.0,843.0
0.005,17,2,230,1,68,0.0,40.0,40.0,1,162,0.0,134.0,134.0
0.011,6,10,1990,5,911,2.0,643.0,643.0,5,1079,2.0,811.0,811.0
40.055,17,10,676,5,460,10012.0,104.0,64.0,5,216,10013.0,20.0,15.0
0.125,6,10,1506,5,395,27.0,127.0,127.0,5,1111,29.0,843.0,843.0
0.06,17,2,152,1,76,0.0,48.0,48.0,1,76,0.0,48.0,48.0
240.012,6,9,787,5,488,60003.0,232.0,232.0,4,299,80003.0,83.0,83.0
0.013,6,10,1990,5,911,3.0,643.0,643.0,5,1079,3.0,811.0,811.0
40.065,17,10,676,5,460,10014.0,104.0,64.0,5,216,10015.0,20.0,15.0
0.005,6,10,1989,5,927,1.0,659.0,659.0,5,1062,1.0,794.0,794.0
40.071,17,10,676,5,460,10015.0,104.0,64.0,5,216,10016.0,20.0,15.0
15.082,17,15,8074,8,6060,2150.0,1350.0,729.0,7,2014,2508.0,1350.0,259.0
0.014,6,10,1989,5,910,3.0,642.0,642.0,5,1079,3.0,811.0,811.0
0.004,17,2,148,1,60,0.0,32.0,32.0,1,88,0.0,60.0,60.0
0.004,6,10,2006,5,927,1.0,659.0,659.0,5,1079,1.0,811.0,811.0
0.005,6,10,1779,5,928,1.0,660.0,660.0,5,851,1.0,583.0,583.0
0.004,17,2,148,1,60,0.0,32.0,32.0,1,88,0.0,60.0,60.0
0.005,6,10,2007,5,928,1.0,660.0,660.0,5,1079,1.0,811.0,811.0
0.005,6,10,1643,5,860,1.0,592.0,592.0,5,783,1.0,515.0,515.0
0.005,6,10,1779,5,928,1.0,660.0,660.0,5,851,1.0,583.0,583.0
293.509,6,415,349885,201,22013,1467.0,2736.0,888.0,214,327872,1377.0,2804.0,1583.0
0.078,6,10,1506,5,395,18.0,127.0,127.0,5,1111,16.0,843.0,843.0
240.084,6,19,5036,9,2305,30010.0,1102.0,613.0,10,2731,26675.0,1162.0,440.0
0.012,6,10,1631,5,848,3.0,580.0,580.0,5,783,3.0,515.0,515.0
0.009,6,12,1926,6,1189,1.0,659.0,434.0,6,737,1.0,417.0,417.0
0.073,6,10,1506,5,395,16.0,127.0,127.0,5,1111,16.0,843.0,843.0
0.007,6,10,1547,5,764,1.0,496.0,496.0,5,783,1.0,515.0,515.0
0.044,6,14,3965,7,495,7.0,123.0,123.0,7,3470,7.0,1448.0,1032.0
0.005,6,10,1689,5,839,1.0,571.0,571.0,5,850,1.0,582.0,582.0
0.013,17,2,148,1,60,0.0,32.0,32.0,1,88,0.0,60.0,60.0
0.069,6,10,1506,5,395,15.0,127.0,127.0,5,1111,15.0,843.0,843.0
61.218,6,25,11151,12,1696,5565.0,538.0,350.0,13,9455,5100.0,2624.0,1096.0
0.107,17,2,152,1,76,0.0,48.0,48.0,1,76,0.0,48.0,48.0
0.799,6,25,5555,12,1445,61.0,267.0,136.0,13,4110,55.0,1414.0,597.0
0.169,6,10,1506,5,395,41.0,127.0,127.0,5,1111,20.0,843.0,843.0
0.004,6,10,2000,5,927,1.0,659.0,659.0,5,1073,1.0,805.0,805.0
0.005,6,10,1779,5,928,1.0,660.0,660.0,5,851,1.0,583.0,583.0
0.005,6,10,1547,5,764,1.0,496.0,496.0,5,783,1.0,515.0,515.0
0.014,6,10,1677,5,827,3.0,559.0,559.0,5,850,3.0,582.0,582.0
0.011,6,10,1631,5,848,2.0,580.0,580.0,5,783,2.0,515.0,515.0
0.005,6,10,1689,5,839,1.0,571.0,571.0,5,850,1.0,582.0,582.0
0.005,6,10,1854,5,889,1.0,621.0,621.0,5,965,1.0,697.0,697.0
11.165,17,28,4422,14,1994,846.0,269.0,114.0,14,2428,846.0,587.0,145.0
0.219,6,16,2777,8,1395,31.0,533.0,323.0,8,1382,20.0,529.0,239.0
0.008,6,12,1926,6,1189,1.0,659.0,434.0,6,737,1.0,417.0,417.0
0.008,6,10,1989,5,910,2.0,642.0,642.0,5,1079,1.0,811.0,811.0
0.005,17,2,230,1,68,0.0,40.0,40.0,1,162,0.0,134.0,134.0
0.076,6,10,1506,5,395,16.0,127.0,127.0,5,1111,16.0,843.0,843.0
0.001,17,2,154,1,69,0.0,41.0,41.0,1,85,0.0,57.0,57.0
40.055,17,10,676,5,460,10012.0,104.0,64.0,5,216,10013.0,20.0,15.0
0.001,17,2,166,1,75,0.0,47.0,47.0,1,91,0.0,63.0,63.0
0.04,17,2,136,1,60,0.0,32.0,32.0,1,76,0.0,48.0,48.0
0.124,17,2,136,1,60,0.0,32.0,32.0,1,76,0.0,48.0,48.0
0.005,6,10,2000,5,927,1.0,659.0,659.0,5,1073,1.0,805.0,805.0
0.078,6,10,1506,5,395,17.0,127.0,127.0,5,1111,17.0,843.0,843.0
0.005,6,10,2000,5,927,1.0,659.0,659.0,5,1073,1.0,805.0,805.0
40.078,17,10,676,5,460,10018.0,104.0,64.0,5,216,10018.0,20.0,15.0
0.073,6,10,1506,5,395,15.0,127.0,127.0,5,1111,17.0,843.0,843.0
0.011,6,10,1983,5,910,2.0,642.0,642.0,5,1073,2.0,805.0,805.0
0.001,17,2,136,1,60,0.0,32.0,32.0,1,76,0.0,48.0,48.0
0.005,17,2,144,1,64,0.0,36.0,36.0,1,80,0.0,52.0,52.0
40.07,17,10,676,5,460,10016.0,104.0,64.0,5,216,10016.0,20.0,15.0
0.003,17,2,148,1,60,0.0,32.0,32.0,1,88,0.0,60.0,60.0
0.012,6,10,1989,5,927,3.0,659.0,659.0,5,1062,2.0,794.0,794.0
0.001,17,2,180,1,65,0.0,37.0,37.0,1,115,0.0,87.0,87.0
0.088,6,10,1506,5,395,19.0,127.0,127.0,5,1111,17.0,843.0,843.0
0.006,6,10,1547,5,764,1.0,496.0,496.0,5,783,1.0,515.0,515.0
0.007,6,10,1643,5,860,1.0,592.0,592.0,5,783,1.0,515.0,515.0
0.007,6,10,1547,5,764,1.0,496.0,496.0,5,783,1.0,515.0,515.0
0.02,6,10,1990,5,911,4.0,643.0,643.0,5,1079,4.0,811.0,811.0
0.071,17,8,3613,4,1874,23.0,1350.0,440.0,4,1739,12.0,1350.0,406.0
0.005,17,2,140,1,62,0.0,34.0,34.0,1,78,0.0,50.0,50.0
0.127,17,4,284,2,120,0.0,32.0,32.0,2,164,3.0,60.0,54.0
0.091,6,10,1506,5,395,20.0,127.0,127.0,5,1111,20.0,843.0,843.0
240.1,6,31,9343,15,6857,17150.0,1982.0,675.0,16,2486,16006.0,580.0,205.0
0.024,6,10,1677,5,827,6.0,559.0,559.0,5,850,5.0,582.0,582.0
0.006,6,10,1547,5,764,1.0,496.0,496.0,5,783,1.0,515.0,515.0
40.091,17,10,676,5,460,10021.0,104.0,64.0,5,216,10021.0,20.0,15.0
0.087,6,10,1506,5,395,18.0,127.0,127.0,5,1111,16.0,843.0,843.0
0.015,6,10,1983,5,910,3.0,642.0,642.0,5,1073,3.0,805.0,805.0
0.099,6,10,1506,5,395,21.0,127.0,127.0,5,1111,23.0,843.0,843.0
0.004,6,10,2000,5,927,1.0,659.0,659.0,5,1073,1.0,805.0,805.0
0.014,6,10,1990,5,911,3.0,643.0,643.0,5,1079,3.0,811.0,811.0
369.706,6,22,2313,16,867,24647.0,195.0,195.0,6,1446,4640.0,419.0,398.0
309.476,17,20,1124,10,716,34372.0,48.0,43.0,10,408,34372.0,20.0,12.0
309.079,17,20,1124,10,716,34335.0,48.0,43.0,10,408,34335.0,20.0,12.0
0.005,17,2,170,1,65,0.0,37.0,37.0,1,105,0.0,77.0,77.0
0.006,6,10,1547,5,764,1.0,496.0,496.0,5,783,1.0,515.0,515.0
0.005,17,2,154,1,69,0.0,41.0,41.0,1,85,0.0,57.0,57.0
0.006,6,10,2006,5,927,1.0,659.0,659.0,5,1079,1.0,811.0,811.0
0.005,6,10,1989,5,927,1.0,659.0,659.0,5,1062,1.0,794.0,794.0
0.091,6,10,1506,5,395,21.0,127.0,127.0,5,1111,18.0,843.0,843.0
0.004,6,10,1774,5,923,1.0,655.0,655.0,5,851,1.0,583.0,583.0
40.052,17,10,676,5,460,10012.0,104.0,64.0,5,216,10012.0,20.0,15.0
0.103,6,10,1506,5,395,23.0,127.0,127.0,5,1111,21.0,843.0,843.0
0.005,6,10,2006,5,927,1.0,659.0,659.0,5,1079,1.0,811.0,811.0
0.005,17,2,164,1,74,0.0,46.0,46.0,1,90,0.0,62.0,62.0
0.023,6,10,1677,5,827,5.0,559.0,559.0,5,850,5.0,582.0,582.0
0.013,6,10,1989,5,910,3.0,642.0,642.0,5,1079,3.0,811.0,811.0
0.005,6,10,1774,5,923,1.0,655.0,655.0,5,851,1.0,583.0,583.0
0.096,6,10,1506,5,395,20.0,127.0,127.0,5,1111,22.0,843.0,843.0
281.668,6,24,6115,11,1226,28166.0,267.0,156.0,13,4889,23467.0,1400.0,873.0
0.005,6,10,1989,5,927,1.0,659.0,659.0,5,1062,1.0,794.0,794.0
0.006,6,10,1547,5,764,1.0,496.0,496.0,5,783,1.0,515.0,515.0
0.077,6,10,1506,5,395,17.0,127.0,127.0,5,1111,16.0,843.0,843.0
0.014,6,10,1989,5,910,3.0,642.0,642.0,5,1079,3.0,811.0,811.0
0.013,6,10,1983,5,910,3.0,642.0,642.0,5,1073,3.0,805.0,805.0
0.013,17,4,284,2,120,0.0,32.0,32.0,2,164,1.0,60.0,54.0
0.005,6,10,1689,5,839,1.0,571.0,571.0,5,850,1.0,582.0,582.0
0.006,6,10,2007,5,928,1.0,660.0,660.0,5,1079,1.0,811.0,811.0
0.005,6,10,1854,5,889,1.0,621.0,621.0,5,965,1.0,697.0,697.0
0.134,6,10,1506,5,395,29.0,127.0,127.0,5,1111,29.0,843.0,843.0
40.063,17,10,676,5,460,10013.0,104.0,64.0,5,216,10015.0,20.0,15.0
8.958,6,36,9771,19,4293,497.0,1360.0,700.0,17,5478,547.0,2667.0,435.0
0.025,6,10,1989,5,910,6.0,642.0,642.0,5,1079,6.0,811.0,811.0
0.005,6,10,1689,5,839,1.0,571.0,571.0,5,850,1.0,582.0,582.0
0.004,6,10,2006,5,927,1.0,659.0,659.0,5,1079,1.0,811.0,811.0
0.071,17,4,284,2,120,0.0,32.0,32.0,2,164,68.0,60.0,54.0
365.906,6,22,2313,16,867,24393.0,195.0,195.0,6,1446,4636.0,419.0,398.0
96.319,6,26,9525,12,1627,74.0,794.0,367.0,14,7898,7399.0,1360.0,732.0
0.005,6,10,2006,5,927,1.0,659.0,659.0,5,1079,1.0,811.0,811.0
40.065,17,10,676,5,460,10014.0,104.0,64.0,5,216,10015.0,20.0,15.0
0.129,6,10,1506,5,395,28.0,127.0,127.0,5,1111,29.0,843.0,843.0
0.188,6,10,1506,5,395,39.0,127.0,127.0,5,1111,40.0,843.0,843.0
0.011,6,10,1983,5,910,2.0,642.0,642.0,5,1073,2.0,805.0,805.0
0.006,6,10,1547,5,764,1.0,496.0,496.0,5,783,1.0,515.0,515.0
0.005,6,10,1989,5,927,1.0,659.0,659.0,5,1062,1.0,794.0,794.0
0.005,6,10,2006,5,927,1.0,659.0,659.0,5,1079,1.0,811.0,811.0
0.011,6,10,1989,5,910,2.0,642.0,642.0,5,1079,2.0,811.0,811.0
0.089,6,10,1506,5,395,15.0,127.0,127.0,5,1111,20.0,843.0,843.0
0.089,6,10,1506,5,395,19.0,127.0,127.0,5,1111,19.0,843.0,843.0
0.131,6,10,1506,5,395,30.0,127.0,127.0,5,1111,24.0,843.0,843.0
0.001,17,2,136,1,60,0.0,32.0,32.0,1,76,0.0,48.0,48.0
40.055,17,10,676,5,460,10012.0,104.0,64.0,5,216,10012.0,20.0,15.0
0.171,17,2,152,1,76,0.0,48.0,48.0,1,76,0.0,48.0,48.0
0.098,6,10,1506,5,395,22.0,127.0,127.0,5,1111,20.0,843.0,843.0
11.155,17,28,4422,14,1994,847.0,269.0,114.0,14,2428,847.0,587.0,145.0
40.054,17,10,676,5,460,10012.0,104.0,64.0,5,216,10012.0,20.0,15.0
0.005,17,2,180,1,66,0.0,38.0,38.0,1,114,0.0,86.0,86.0
0.004,17,2,152,1,76,0.0,48.0,48.0,1,76,0.0,48.0,48.0
0.053,17,2,152,1,76,0.0,48.0,48.0,1,76,0.0,48.0,48.0
0.006,6,10,1547,5,764,1.0,496.0,496.0,5,783,1.0,515.0,515.0
0.024,6,10,1972,5,910,5.0,642.0,642.0,5,1062,6.0,794.0,794.0
0.01,17,2,138,1,61,0.0,33.0,33.0,1,77,0.0,49.0,49.0
0.005,6,10,2006,5,927,1.0,659.0,659.0,5,1079,1.0,811.0,811.0
0.005,6,10,2000,5,927,1.0,659.0,659.0,5,1073,1.0,805.0,805.0
0.004,17,2,148,1,60,0.0,32.0,32.0,1,88,0.0,60.0,60.0
0.006,6,10,1547,5,764,1.0,496.0,496.0,5,783,1.0,515.0,515.0
0.068,6,10,1506,5,395,15.0,127.0,127.0,5,1111,13.0,843.0,843.0
240.043,6,9,787,5,488,60010.0,232.0,232.0,4,299,80013.0,83.0,83.0
0.005,6,10,1989,5,927,1.0,659.0,659.0,5,1062,1.0,794.0,794.0
0.068,6,10,1506,5,395,14.0,127.0,127.0,5,1111,14.0,843.0,843.0
0.084,6,10,1506,5,395,16.0,127.0,127.0,5,1111,19.0,843.0,843.0
0.118,6,10,1506,5,395,26.0,127.0,127.0,5,1111,25.0,843.0,843.0
0.005,6,10,1547,5,764,1.0,496.0,496.0,5,783,1.0,515.0,515.0
40.069,17,10,676,5,460,10016.0,104.0,64.0,5,216,10016.0,20.0,15.0
0.001,17,2,174,1,72,0.0,44.0,44.0,1,102,0.0,74.0,74.0
0.009,6,10,1972,5,910,2.0,642.0,642.0,5,1062,2.0,794.0,794.0
0.106,6,10,1506,5,395,21.0,127.0,127.0,5,1111,24.0,843.0,843.0
0.004,6,10,2007,5,928,1.0,660.0,660.0,5,1079,1.0,811.0,811.0
0.004,6,10,1779,5,928,1.0,660.0,660.0,5,851,1.0,583.0,583.0
0.005,17,2,146,1,65,0.0,37.0,37.0,1,81,0.0,53.0,53.0
0.012,6,10,1762,5,911,3.0,643.0,643.0,5,851,2.0,583.0,583.0
0.005,6,10,1989,5,927,1.0,659.0,659.0,5,1062,1.0,794.0,794.0
0.005,6,10,2006,5,927,1.0,659.0,659.0,5,1079,1.0,811.0,811.0
0.006,6,10,1643,5,860,1.0,592.0,592.0,5,783,1.0,515.0,515.0
40.063,17,10,676,5,460,10015.0,104.0,64.0,5,216,10015.0,20.0,15.0
0.006,6,10,1547,5,764,1.0,496.0,496.0,5,783,1.0,515.0,515.0
0.014,6,10,1677,5,827,3.0,559.0,559.0,5,850,3.0,582.0,582.0
73.376,6,22,8496,12,2236,73.0,1345.0,574.0,10,6260,8134.0,2720.0,974.0
40.067,17,10,676,5,460,10014.0,104.0,64.0,5,216,10015.0,20.0,15.0
0.006,17,2,170,1,65,0.0,37.0,37.0,1,105,0.0,77.0,77.0
0.0,17,2,136,1,60,0.0,32.0,32.0,1,76,0.0,48.0,48.0
0.022,6,10,1990,5,911,5.0,643.0,643.0,5,1079,5.0,811.0,811.0
0.007,6,10,1854,5,889,1.0,621.0,621.0,5,965,1.0,697.0,697.0
0.005,6,14,3736,7,446,0.0,74.0,74.0,7,3290,0.0,1448.0,972.0
0.012,6,10,1631,5,848,2.0,580.0,580.0,5,783,3.0,515.0,515.0
240.032,6,9,787,5,488,60008.0,232.0,232.0,4,299,80009.0,83.0,83.0
289.861,6,393,348557,186,21242,1566.0,2736.0,889.0,207,327315,1407.0,2813.0,1640.0
0.108,6,10,1506,5,395,25.0,127.0,127.0,5,1111,24.0,843.0,843.0
0.004,6,10,1989,5,927,1.0,659.0,659.0,5,1062,1.0,794.0,794.0
0.013,6,10,1990,5,911,3.0,643.0,643.0,5,1079,3.0,811.0,811.0
0.005,6,10,2007,5,928,1.0,660.0,660.0,5,1079,1.0,811.0,811.0
40.066,17,10,676,5,460,10014.0,104.0,64.0,5,216,10015.0,20.0,15.0
0.012,6,10,1677,5,827,3.0,559.0,559.0,5,850,3.0,582.0,582.0
0.012,6,10,1983,5,910,3.0,642.0,642.0,5,1073,3.0,805.0,805.0
40.103,17,10,676,5,460,10024.0,104.0,64.0,5,216,10024.0,20.0,15.0
0.082,6,10,1506,5,395,18.0,127.0,127.0,5,1111,17.0,843.0,843.0
0.008,6,14,3787,7,497,1.0,125.0,125.0,7,3290,1.0,1448.0,972.0
0.01,6,10,1972,5,910,2.0,642.0,642.0,5,1062,2.0,794.0,794.0
0.003,17,4,284,2,120,0.0,32.0,32.0,2,164,0.0,60.0,54.0
0.012,6,10,1972,5,910,3.0,642.0,642.0,5,1062,2.0,794.0,794.0
11.171,17,28,4423,14,1994,846.0,269.0,114.0,14,2429,846.0,588.0,145.0
0.108,6,10,1506,5,395,24.0,127.0,127.0,5,1111,25.0,843.0,843.0
0.015,6,10,1990,5,911,3.0,643.0,643.0,5,1079,3.0,811.0,811.0
0.008,6,10,1990,5,911,1.0,643.0,643.0,5,1079,2.0,811.0,811.0
0.009,6,10,1989,5,910,2.0,642.0,642.0,5,1079,2.0,811.0,811.0
0.011,6,10,1983,5,910,2.0,642.0,642.0,5,1073,2.0,805.0,805.0
0.004,6,13,3690,7,452,0.0,80.0,80.0,6,3238,0.0,1470.0,1459.0
309.205,17,20,1124,10,716,34342.0,48.0,43.0,10,408,34342.0,20.0,12.0
0.07,17,8,3613,4,1874,23.0,1350.0,440.0,4,1739,12.0,1350.0,406.0
40.071,17,10,676,5,460,10014.0,104.0,64.0,5,216,10016.0,20.0,15.0
0.014,6,10,1972,5,910,3.0,642.0,642.0,5,1062,3.0,794.0,794.0
0.013,6,10,1989,5,910,3.0,642.0,642.0,5,1079,3.0,811.0,811.0
0.001,17,2,166,1,75,0.0,47.0,47.0,1,91,0.0,63.0,63.0
0.004,6,10,2007,5,928,1.0,660.0,660.0,5,1079,1.0,811.0,811.0
0.001,17,2,184,1,68,0.0,40.0,40.0,1,116,0.0,88.0,88.0
0.005,6,10,2007,5,928,1.0,660.0,660.0,5,1079,1.0,811.0,811.0
0.004,6,10,2006,5,927,1.0,659.0,659.0,5,1079,1.0,811.0,811.0
0.012,6,10,1990,5,911,3.0,643.0,643.0,5,1079,3.0,811.0,811.0
0.117,6,10,1506,5,395,27.0,127.0,127.0,5,1111,27.0,843.0,843.0
0.011,6,10,1762,5,911,2.0,643.0,643.0,5,851,2.0,583.0,583.0
0.005,6,13,3690,7,452,0.0,80.0,80.0,6,3238,0.0,1470.0,1459.0
0.095,6,10,1506,5,395,20.0,127.0,127.0,5,1111,19.0,843.0,843.0
64.401,6,39,12698,20,7140,467.0,2720.0,1051.0,19,5558,3568.0,2667.0,435.0
0.012,6,10,1631,5,848,2.0,580.0,580.0,5,783,2.0,515.0,515.0
0.001,17,2,180,1,66,0.0,38.0,38.0,1,114,0.0,86.0,86.0
0.03,17,2,146,1,65,0.0,37.0,37.0,1,81,0.0,53.0,53.0
0.005,17,2,144,1,64,0.0,36.0,36.0,1,80,0.0,52.0,52.0
0.004,6,13,3690,7,452,0.0,80.0,80.0,6,3238,0.0,1470.0,1459.0
0.274,17,38,20045,21,17022,13.0,1350.0,782.0,17,3023,13.0,1350.0,149.0
0.005,6,10,1989,5,927,1.0,659.0,659.0,5,1062,1.0,794.0,794.0
0.039,17,2,136,1,60,0.0,32.0,32.0,1,76,0.0,48.0,48.0
0.011,6,10,1983,5,910,2.0,642.0,642.0,5,1073,2.0,805.0,805.0
0.012,6,10,1989,5,910,2.0,642.0,642.0,5,1079,2.0,811.0,811.0
0.009,6,10,1990,5,911,2.0,643.0,643.0,5,1079,2.0,811.0,811.0
240.01,6,9,787,5,488,60002.0,232.0,232.0,4,299,80002.0,83.0,83.0
15.074,17,14,9190,8,6902,2149.0,1350.0,834.0,6,2288,3008.0,1350.0,353.0
0.124,6,10,1506,5,395,28.0,127.0,127.0,5,1111,25.0,843.0,843.0
0.011,6,10,1972,5,910,2.0,642.0,642.0,5,1062,2.0,794.0,794.0
0.017,6,13,3735,7,497,2.0,125.0,125.0,6,3238,3.0,1470.0,1459.0
0.113,6,10,1506,5,395,24.0,127.0,127.0,5,1111,26.0,843.0,843.0
0.188,6,44,11610,24,3282,8.0,1082.0,203.0,20,8328,9.0,1402.0,606.0
0.004,6,10,1989,5,927,1.0,659.0,659.0,5,1062,1.0,794.0,794.0
0.01,6,10,1677,5,827,2.0,559.0,559.0,5,850,2.0,582.0,582.0
0.015,6,10,1677,5,827,3.0,559.0,559.0,5,850,3.0,582.0,582.0
0.01,6,13,3735,7,497,1.0,125.0,125.0,6,3238,1.0,1470.0,1459.0
0.016,6,10,1989,5,910,4.0,642.0,642.0,5,1079,4.0,811.0,811.0
0.005,17,2,230,1,68,0.0,40.0,40.0,1,162,0.0,134.0,134.0
0.012,6,10,1677,5,827,2.0,559.0,559.0,5,850,3.0,582.0,582.0
0.071,6,10,1506,5,395,15.0,127.0,127.0,5,1111,16.0,843.0,843.0
0.005,6,10,2007,5,928,1.0,660.0,660.0,5,1079,1.0,811.0,811.0
0.011,6,10,1983,5,910,2.0,642.0,642.0,5,1073,2.0,805.0,805.0
40.087,17,10,676,5,460,10019.0,104.0,64.0,5,216,10021.0,20.0,15.0
0.005,17,2,170,1,65,0.0,37.0,37.0,1,105,0.0,77.0,77.0
0.008,17,2,299,1,65,0.0,37.0,37.0,1,234,0.0,206.0,206.0
0.016,6,10,1677,5,827,3.0,559.0,559.0,5,850,3.0,582.0,582.0
15.072,17,15,9238,8,6902,2149.0,1350.0,834.0,7,2336,2507.0,1350.0,305.0
413.688,6,29,4409,12,3102,10912.0,494.0,494.0,17,1307,25855.0,83.0,83.0
0.004,6,10,2007,5,928,1.0,660.0,660.0,5,1079,1.0,811.0,811.0
0.005,17,2,214,1,75,0.0,47.0,47.0,1,139,0.0,111.0,111.0
0.007,6,10,1547,5,764,1.0,496.0,496.0,5,783,1.0,515.0,515.0
0.006,6,10,1547,5,764,1.0,496.0,496.0,5,783,1.0,515.0,515.0
0.001,17,2,166,1,75,0.0,47.0,47.0,1,91,0.0,63.0,63.0
0.005,6,10,1779,5,928,1.0,660.0,660.0,5,851,1.0,583.0,583.0
0.013,6,10,1989,5,910,3.0,642.0,642.0,5,1079,3.0,811.0,811.0
0.006,6,10,1854,5,889,1.0,621.0,621.0,5,965,1.0,697.0,697.0
952.797,6,50,9540,26,7288,26422.0,494.0,494.0,24,2252,41425.0,83.0,83.0
0.015,6,10,1990,5,911,3.0,643.0,643.0,5,1079,3.0,811.0,811.0
0.039,17,2,152,1,76,0.0,48.0,48.0,1,76,0.0,48.0,48.0
0.121,6,10,1990,5,911,30.0,643.0,643.0,5,1079,30.0,811.0,811.0
0.04,17,4,284,2,120,0.0,32.0,32.0,2,164,36.0,60.0,54.0
0.014,6,13,3735,7,497,2.0,125.0,125.0,6,3238,2.0,1470.0,1459.0
0.008,6,10,1990,5,911,2.0,643.0,643.0,5,1079,1.0,811.0,811.0
40.057,17,10,676,5,460,10013.0,104.0,64.0,5,216,10013.0,20.0,15.0
0.009,6,10,1972,5,910,2.0,642.0,642.0,5,1062,2.0,794.0,794.0
0.077,6,10,1506,5,395,16.0,127.0,127.0,5,1111,17.0,843.0,843.0
0.004,17,2,136,1,60,0.0,32.0,32.0,1,76,0.0,48.0,48.0
0.012,6,10,1990,5,911,3.0,643.0,643.0,5,1079,2.0,811.0,811.0
0.003,17,2,136,1,60,0.0,32.0,32.0,1,76,0.0,48.0,48.0
0.048,17,2,156,1,64,0.0,36.0,36.0,1,92,0.0,64.0,64.0
0.004,6,10,2006,5,927,1.0,659.0,659.0,5,1079,1.0,811.0,811.0
0.007,6,10,1689,5,839,1.0,571.0,571.0,5,850,1.0,582.0,582.0
0.026,6,10,1972,5,910,6.0,642.0,642.0,5,1062,6.0,794.0,794.0
0.227,6,21,6598,11,1545,22.0,533.0,321.0,10,5053,21.0,1402.0,754.0
0.003,17,2,136,1,60,0.0,32.0,32.0,1,76,0.0,48.0,48.0
0.001,17,2,180,1,66,0.0,38.0,38.0,1,114,0.0,86.0,86.0
0.006,6,10,1547,5,764,1.0,496.0,496.0,5,783,1.0,515.0,515.0
0.019,6,10,1677,5,827,4.0,559.0,559.0,5,850,4.0,582.0,582.0
0.001,17,2,166,1,75,0.0,47.0,47.0,1,91,0.0,63.0,63.0
0.004,6,10,2006,5,927,1.0,659.0,659.0,5,1079,1.0,811.0,811.0
173.422,17,82,11387,41,2751,4335.0,44.0,39.0,41,8636,4335.0,239.0,182.0
0.011,6,10,1677,5,827,2.0,559.0,559.0,5,850,2.0,582.0,582.0
0.012,6,10,1762,5,911,3.0,643.0,643.0,5,851,2.0,583.0,583.0
1729.239,6,60,4400,40,2740,44339.0,33.0,33.0,20,1660,91004.0,31.0,31.0
182.669,58,5,360,4,288,60889.0,24.0,24.0,1,72,0.0,24.0,24.0
0.12,6,10,1506,5,395,27.0,127.0,127.0,5,1111,20.0,843.0,843.0
15.082,17,15,8302,8,6199,2150.0,1350.0,746.0,7,2103,2508.0,1350.0,272.0
0.005,17,2,144,1,64,0.0,36.0,36.0,1,80,0.0,52.0,52.0
0.005,6,10,2006,5,927,1.0,659.0,659.0,5,1079,1.0,811.0,811.0
0.007,17,2,179,1,71,0.0,43.0,43.0,1,108,0.0,80.0,80.0
0.005,17,2,180,1,66,0.0,38.0,38.0,1,114,0.0,86.0,86.0
40.059,17,10,676,5,460,10012.0,104.0,64.0,5,216,10010.0,20.0,15.0
0.019,6,10,1990,5,911,4.0,643.0,643.0,5,1079,4.0,811.0,811.0
0.075,6,10,1506,5,395,17.0,127.0,127.0,5,1111,15.0,843.0,843.0
0.004,17,2,136,1,60,0.0,32.0,32.0,1,76,0.0,48.0,48.0
0.115,6,10,1506,5,395,26.0,127.0,127.0,5,1111,25.0,843.0,843.0
0.099,6,10,1506,5,395,23.0,127.0,127.0,5,1111,18.0,843.0,843.0
952.77,6,50,9540,26,7288,26421.0,494.0,494.0,24,2252,41424.0,83.0,83.0
0.086,6,10,1506,5,395,17.0,127.0,127.0,5,1111,20.0,843.0,843.0
0.006,17,2,238,1,66,0.0,38.0,38.0,1,172,0.0,144.0,144.0
0.212,6,16,2779,8,1397,30.0,533.0,324.0,8,1382,19.0,529.0,239.0
0.042,17,2,148,1,60,0.0,32.0,32.0,1,88,0.0,60.0,60.0
0.004,6,10,1989,5,927,1.0,659.0,659.0,5,1062,1.0,794.0,794.0
0.005,6,10,2007,5,928,1.0,660.0,660.0,5,1079,1.0,811.0,811.0
0.005,6,10,2006,5,927,1.0,659.0,659.0,5,1079,1.0,811.0,811.0
0.014,6,10,1983,5,910,3.0,642.0,642.0,5,1073,3.0,805.0,805.0
0.187,17,4,596,2,122,142.0,33.0,33.0,2,474,49.0,323.0,209.0
0.015,6,10,1989,5,910,3.0,642.0,642.0,5,1079,3.0,811.0,811.0
0.099,6,10,1506,5,395,22.0,127.0,127.0,5,1111,23.0,843.0,843.0
0.009,6,10,1989,5,910,2.0,642.0,642.0,5,1079,2.0,811.0,811.0
0.005,6,10,2006,5,927,1.0,659.0,659.0,5,1079,1.0,811.0,811.0
0.008,17,2,194,1,59,0.0,31.0,31.0,1,135,0.0,107.0,107.0
0.066,6,10,1506,5,395,13.0,127.0,127.0,5,1111,16.0,843.0,843.0
0.003,17,2,136,1,60,0.0,32.0,32.0,1,76,0.0,48.0,48.0
0.004,6,10,1779,5,928,1.0,660.0,660.0,5,851,1.0,583.0,583.0
0.007,17,2,179,1,71,0.0,43.0,43.0,1,108,0.0,80.0,80.0
0.006,17,2,214,1,75,0.0,47.0,47.0,1,139,0.0,111.0,111.0
0.011,6,13,3735,7,497,1.0,125.0,125.0,6,3238,2.0,1470.0,1459.0
0.004,17,2,148,1,60,0.0,32.0,32.0,1,88,0.0,60.0,60.0
0.037,17,2,170,1,65,0.0,37.0,37.0,1,105,0.0,77.0,77.0
0.016,6,10,1983,5,910,4.0,642.0,642.0,5,1073,4.0,805.0,805.0
468.731,6,37,14226,20,3948,24670.0,1173.0,483.0,17,10278,25544.0,1402.0,938.0
0.108,6,10,1506,5,395,23.0,127.0,127.0,5,1111,24.0,843.0,843.0
0.008,6,10,1547,5,764,2.0,496.0,496.0,5,783,1.0,515.0,515.0
0.004,6,10,2000,5,927,1.0,659.0,659.0,5,1073,1.0,805.0,805.0
0.003,17,2,148,1,60,0.0,32.0,32.0,1,88,0.0,60.0,60.0
0.003,17,2,148,1,60,0.0,32.0,32.0,1,88,0.0,60.0,60.0
6.445,6,45,30146,23,23435,292.0,2720.0,1729.0,22,6711,298.0,2720.0,969.0
0.014,6,10,1990,5,911,3.0,643.0,643.0,5,1079,3.0,811.0,811.0
0.015,6,10,1972,5,910,3.0,642.0,642.0,5,1062,3.0,794.0,794.0
0.094,6,10,1506,5,395,21.0,127.0,127.0,5,1111,21.0,843.0,843.0
0.005,6,10,2006,5,927,1.0,659.0,659.0,5,1079,1.0,811.0,811.0
0.001,17,2,142,1,63,0.0,35.0,35.0,1,79,0.0,51.0,51.0
0.006,17,2,244,1,74,0.0,46.0,46.0,1,170,0.0,142.0,142.0
0.005,17,2,214,1,75,0.0,47.0,47.0,1,139,0.0,111.0,111.0
0.005,6,10,1774,5,923,1.0,655.0,655.0,5,851,1.0,583.0,583.0
0.005,6,10,2006,5,927,1.0,659.0,659.0,5,1079,1.0,811.0,811.0
0.297,17,40,20215,22,17095,14.0,1350.0,749.0,18,3120,13.0,1350.0,145.0
1796.963,6,276,25593,139,9082,13021.0,748.0,263.0,137,16511,13212.0,1467.0,71.0
15.072,17,15,9238,8,6902,2149.0,1350.0,834.0,7,2336,2507.0,1350.0,305.0
0.068,6,10,1506,5,395,15.0,127.0,127.0,5,1111,15.0,843.0,843.0
9.036,17,6,376,5,280,2259.0,28.0,28.0,1,96,0.0,68.0,68.0
0.016,6,10,1990,5,911,3.0,643.0,643.0,5,1079,4.0,811.0,811.0
0.006,6,10,1854,5,889,1.0,621.0,621.0,5,965,1.0,697.0,697.0
0.069,17,8,3613,4,1874,23.0,1350.0,440.0,4,1739,11.0,1350.0,406.0
0.005,6,10,1689,5,839,1.0,571.0,571.0,5,850,1.0,582.0,582.0
0.005,17,2,230,1,68,0.0,40.0,40.0,1,162,0.0,134.0,134.0
0.06,6,10,1506,5,395,13.0,127.0,127.0,5,1111,14.0,843.0,843.0
0.037,17,2,170,1,65,0.0,37.0,37.0,1,105,0.0,77.0,77.0
0.004,6,10,2006,5,927,1.0,659.0,659.0,5,1079,1.0,811.0,811.0
0.005,6,10,1989,5,927,1.0,659.0,659.0,5,1062,1.0,794.0,794.0
0.179,6,43,11486,23,3171,8.0,1023.0,197.0,20,8315,9.0,1402.0,605.0
0.008,6,10,1989,5,910,2.0,642.0,642.0,5,1079,2.0,811.0,811.0
0.005,6,10,1989,5,927,1.0,659.0,659.0,5,1062,1.0,794.0,794.0
0.005,6,10,1989,5,927,1.0,659.0,659.0,5,1062,1.0,794.0,794.0
0.128,6,10,1506,5,395,30.0,127.0,127.0,5,1111,31.0,843.0,843.0
1730.383,6,45,2790,30,1725,59668.0,35.0,35.0,15,1065,123593.0,31.0,31.0
0.004,6,10,2006,5,927,1.0,659.0,659.0,5,1079,1.0,811.0,811.0
0.004,6,10,2000,5,927,1.0,659.0,659.0,5,1073,1.0,805.0,805.0
0.005,6,10,2006,5,927,1.0,659.0,659.0,5,1079,1.0,811.0,811.0
0.184,17,4,352,2,130,147.0,37.0,37.0,2,222,142.0,89.0,83.0
291.341,6,393,348791,197,21807,1486.0,2736.0,888.0,196,326984,1493.0,2804.0,1750.0
0.012,6,10,1972,5,910,3.0,642.0,642.0,5,1062,2.0,794.0,794.0
0.009,6,10,1989,5,910,2.0,642.0,642.0,5,1079,2.0,811.0,811.0
0.004,6,10,2006,5,927,1.0,659.0,659.0,5,1079,1.0,811.0,811.0
0.107,17,2,80,1,32,0.0,4.0,4.0,1,48,0.0,20.0,20.0
0.084,6,10,1506,5,395,18.0,127.0,127.0,5,1111,19.0,843.0,843.0
0.009,6,10,1989,5,910,2.0,642.0,642.0,5,1079,2.0,811.0,811.0
0.005,6,10,2006,5,927,1.0,659.0,659.0,5,1079,1.0,811.0,811.0
0.012,6,10,1762,5,911,3.0,643.0,643.0,5,851,3.0,583.0,583.0
0.005,6,10,2006,5,927,1.0,659.0,659.0,5,1079,1.0,811.0,811.0
0.016,6,13,3735,7,497,2.0,125.0,125.0,6,3238,3.0,1470.0,1459.0
0.006,6,10,2007,5,928,1.0,660.0,660.0,5,1079,1.0,811.0,811.0
0.005,6,10,1689,5,839,1.0,571.0,571.0,5,850,1.0,582.0,582.0
0.005,6,10,1689,5,839,1.0,571.0,571.0,5,850,1.0,582.0,582.0
0.018,6,10,1983,5,910,4.0,642.0,642.0,5,1073,4.0,805.0,805.0
240.191,6,41,5228,21,2476,12009.0,588.0,196.0,20,2752,12641.0,580.0,213.0
10.847,17,28,4417,14,1994,824.0,269.0,114.0,14,2423,825.0,586.0,145.0
0.088,6,10,1506,5,395,19.0,127.0,127.0,5,1111,19.0,843.0,843.0
0.072,17,2,234,1,61,0.0,33.0,33.0,1,173,0.0,145.0,145.0
0.093,6,10,1506,5,395,21.0,127.0,127.0,5,1111,18.0,843.0,843.0
0.005,6,10,2007,5,928,1.0,660.0,660.0,5,1079,1.0,811.0,811.0
0.135,17,4,284,2,120,0.0,32.0,32.0,2,164,3.0,60.0,54.0
178.195,6,26,9525,12,1627,89.0,794.0,367.0,14,7898,13697.0,1360.0,732.0
0.003,17,2,148,1,60,0.0,32.0,32.0,1,88,0.0,60.0,60.0
0.082,6,10,1506,5,395,17.0,127.0,127.0,5,1111,19.0,843.0,843.0
0.007,17,2,162,1,65,0.0,37.0,37.0,1,97,0.0,69.0,69.0
0.011,6,10,1989,5,910,2.0,642.0,642.0,5,1079,2.0,811.0,811.0
0.001,17,2,136,1,60,0.0,32.0,32.0,1,76,0.0,48.0,48.0
40.049,17,10,676,5,460,10011.0,104.0,64.0,5,216,10011.0,20.0,15.0
0.006,6,10,1547,5,764,1.0,496.0,496.0,5,783,1.0,515.0,515.0
0.006,6,10,1779,5,928,1.0,660.0,660.0,5,851,1.0,583.0,583.0
0.001,17,2,136,1,60,0.0,32.0,32.0,1,76,0.0,48.0,48.0
0.045,17,2,152,1,76,0.0,48.0,48.0,1,76,0.0,48.0,48.0
1777.844,17,143,41496,72,22752,25039.0,288.0,288.0,71,18744,25397.0,236.0,236.0
0.008,17,2,194,1,59,0.0,31.0,31.0,1,135,0.0,107.0,107.0
0.006,6,10,1547,5,764,1.0,496.0,496.0,5,783,1.0,515.0,515.0
0.016,6,10,1990,5,911,4.0,643.0,643.0,5,1079,4.0,811.0,811.0
0.018,6,10,1989,5,910,4.0,642.0,642.0,5,1079,4.0,811.0,811.0
0.088,6,10,1506,5,395,18.0,127.0,127.0,5,1111,19.0,843.0,843.0
0.002,17,2,180,1,66,0.0,38.0,38.0,1,114,0.0,86.0,86.0
10.858,17,28,4416,14,1993,826.0,268.0,114.0,14,2423,826.0,586.0,145.0
0.013,6,10,1989,5,910,3.0,642.0,642.0,5,1079,3.0,811.0,811.0
0.009,6,13,3735,7,497,1.0,125.0,125.0,6,3238,1.0,1470.0,1459.0
0.005,6,10,2007,5,928,1.0,660.0,660.0,5,1079,1.0,811.0,811.0
0.005,6,10,2007,5,928,1.0,660.0,660.0,5,1079,1.0,811.0,811.0
0.006,6,10,1689,5,839,1.0,571.0,571.0,5,850,1.0,582.0,582.0
0.005,6,10,2007,5,928,1.0,660.0,660.0,5,1079,1.0,811.0,811.0
0.067,17,8,3613,4,1874,22.0,1350.0,440.0,4,1739,11.0,1350.0,406.0
40.06,17,10,676,5,460,10014.0,104.0,64.0,5,216,10014.0,20.0,15.0
0.003,17,2,148,1,60,0.0,32.0,32.0,1,88,0.0,60.0,60.0
0.029,6,14,3787,7,497,4.0,125.0,125.0,7,3290,4.0,1448.0,972.0
0.073,17,2,148,1,60,0.0,32.0,32.0,1,88,0.0,60.0,60.0
0.011,6,10,1631,5,848,2.0,580.0,580.0,5,783,2.0,515.0,515.0
0.012,6,10,1989,5,910,2.0,642.0,642.0,5,1079,2.0,811.0,811.0
0.088,6,10,1506,5,395,16.0,127.0,127.0,5,1111,20.0,843.0,843.0
2.848,6,24,7517,13,1385,237.0,530.0,277.0,11,6132,267.0,1823.0,946.0
0.016,6,10,1989,5,910,4.0,642.0,642.0,5,1079,4.0,811.0,811.0
40.062,17,10,676,5,460,10012.0,104.0,64.0,5,216,10014.0,20.0,15.0
0.008,6,10,1989,5,910,2.0,642.0,642.0,5,1079,1.0,811.0,811.0
0.007,6,10,2006,5,927,1.0,659.0,659.0,5,1079,1.0,811.0,811.0
0.007,17,2,170,1,65,0.0,37.0,37.0,1,105,0.0,77.0,77.0
0.16,17,2,136,1,60,0.0,32.0,32.0,1,76,0.0,48.0,48.0
0.005,6,10,2007,5,928,1.0,660.0,660.0,5,1079,1.0,811.0,811.0
0.006,6,10,2000,5,927,1.0,659.0,659.0,5,1073,1.0,805.0,805.0
0.001,17,2,180,1,66,0.0,38.0,38.0,1,114,0.0,86.0,86.0
0.005,6,10,2000,5,927,1.0,659.0,659.0,5,1073,1.0,805.0,805.0
0.005,17,2,144,1,64,0.0,36.0,36.0,1,80,0.0,52.0,52.0
0.005,6,10,2006,5,927,1.0,659.0,659.0,5,1079,1.0,811.0,811.0
0.017,6,13,3735,7,497,2.0,125.0,125.0,6,3238,3.0,1470.0,1459.0
0.149,6,10,1506,5,395,33.0,127.0,127.0,5,1111,35.0,843.0,843.0
0.005,6,14,3742,7,452,0.0,80.0,80.0,7,3290,0.0,1448.0,972.0
0.069,6,10,1506,5,395,15.0,127.0,127.0,5,1111,16.0,843.0,843.0
0.005,6,10,2000,5,927,1.0,659.0,659.0,5,1073,1.0,805.0,805.0
0.005,6,10,1854,5,889,1.0,621.0,621.0,5,965,1.0,697.0,697.0
0.1,6,10,1506,5,395,24.0,127.0,127.0,5,1111,24.0,843.0,843.0
0.005,6,14,3742,8,504,0.0,80.0,80.0,6,3238,0.0,1470.0,1459.0
0.015,6,10,1989,5,910,3.0,642.0,642.0,5,1079,3.0,811.0,811.0
296.766,6,394,348517,196,21760,1521.0,2736.0,889.0,198,326757,1506.0,2804.0,1719.0
0.119,6,10,1506,5,395,28.0,127.0,127.0,5,1111,25.0,843.0,843.0
0.126,6,10,1506,5,395,29.0,127.0,127.0,5,1111,27.0,843.0,843.0
0.122,6,10,1506,5,395,25.0,127.0,127.0,5,1111,28.0,843.0,843.0
0.004,6,10,1702,5,863,1.0,595.0,595.0,5,839,1.0,571.0,571.0
0.095,6,10,1506,5,395,21.0,127.0,127.0,5,1111,21.0,843.0,843.0
0.039,17,4,596,2,122,0.0,33.0,33.0,2,474,35.0,323.0,209.0
40.085,17,10,676,5,460,10018.0,104.0,64.0,5,216,10020.0,20.0,15.0
0.007,6,10,1547,5,764,1.0,496.0,496.0,5,783,1.0,515.0,515.0
0.015,6,10,1972,5,910,3.0,642.0,642.0,5,1062,3.0,794.0,794.0
0.013,6,10,1677,5,827,3.0,559.0,559.0,5,850,3.0,582.0,582.0
0.013,6,10,1989,5,910,3.0,642.0,642.0,5,1079,3.0,811.0,811.0
0.004,17,4,284,2,120,0.0,32.0,32.0,2,164,0.0,60.0,54.0
0.014,6,10,1989,5,910,3.0,642.0,642.0,5,1079,3.0,811.0,811.0
177.119,17,70,9989,35,2338,5209.0,44.0,38.0,35,7651,5209.0,239.0,190.0
11.126,17,28,4420,14,1993,843.0,268.0,114.0,14,2427,843.0,586.0,145.0
0.005,6,14,3742,7,452,0.0,80.0,80.0,7,3290,0.0,1448.0,972.0
0.008,6,10,1972,5,910,2.0,642.0,642.0,5,1062,2.0,794.0,794.0
0.042,17,2,148,1,60,0.0,32.0,32.0,1,88,0.0,60.0,60.0
0.007,6,12,1698,6,863,1.0,327.0,271.0,6,835,1.0,515.0,515.0
0.012,6,10,1983,5,910,3.0,642.0,642.0,5,1073,2.0,805.0,805.0
0.013,6,10,1631,5,848,3.0,580.0,580.0,5,783,3.0,515.0,515.0
0.011,6,10,1983,5,910,2.0,642.0,642.0,5,1073,2.0,805.0,805.0
0.005,6,10,1547,5,764,1.0,496.0,496.0,5,783,1.0,515.0,515.0
0.005,6,10,1989,5,927,1.0,659.0,659.0,5,1062,1.0,794.0,794.0
0.005,6,10,1989,5,927,1.0,659.0,659.0,5,1062,1.0,794.0,794.0
0.006,6,14,3799,7,509,0.0,137.0,137.0,7,3290,0.0,1448.0,972.0
0.005,6,10,1989,5,927,1.0,659.0,659.0,5,1062,1.0,794.0,794.0
11.129,17,28,4422,14,1994,847.0,269.0,114.0,14,2428,847.0,587.0,145.0
0.137,6,10,1506,5,395,25.0,127.0,127.0,5,1111,31.0,843.0,843.0
0.038,17,4,284,2,120,1.0,32.0,32.0,2,164,34.0,60.0,54.0
240.036,6,9,787,5,488,60009.0,232.0,232.0,4,299,80011.0,83.0,83.0
0.004,6,10,2000,5,927,1.0,659.0,659.0,5,1073,1.0,805.0,805.0
0.017,17,2,198,1,91,0.0,63.0,63.0,1,107,0.0,79.0,79.0
56.417,6,49,20423,25,14436,387.0,2720.0,1340.0,24,5987,2445.0,2667.0,385.0
0.126,6,10,1506,5,395,23.0,127.0,127.0,5,1111,30.0,843.0,843.0
0.012,6,10,1990,5,911,3.0,643.0,643.0,5,1079,3.0,811.0,811.0
0.073,17,2,170,1,65,0.0,37.0,37.0,1,105,0.0,77.0,77.0
0.009,6,10,1989,5,910,2.0,642.0,642.0,5,1079,2.0,811.0,811.0
0.011,6,10,1972,5,910,2.0,642.0,642.0,5,1062,2.0,794.0,794.0
0.094,6,10,1506,5,395,19.0,127.0,127.0,5,1111,21.0,843.0,843.0
0.004,6,10,1989,5,927,1.0,659.0,659.0,5,1062,1.0,794.0,794.0
0.006,6,10,1689,5,839,1.0,571.0,571.0,5,850,1.0,582.0,582.0
11.18,17,28,4418,14,1994,847.0,269.0,114.0,14,2424,847.0,587.0,145.0
1756.224,6,105,6258,60,3519,29766.0,27.0,26.0,45,2739,39913.0,27.0,26.0
375.583,6,24,6647,13,2336,31298.0,585.0,330.0,11,4311,31556.0,1402.0,746.0
308.495,17,20,1124,10,716,34262.0,48.0,43.0,10,408,34262.0,20.0,12.0
0.004,6,10,2006,5,927,1.0,659.0,659.0,5,1079,1.0,811.0,811.0
308.472,17,20,1124,10,716,34260.0,48.0,43.0,10,408,34260.0,20.0,12.0
0.005,6,10,2007,5,928,1.0,660.0,660.0,5,1079,1.0,811.0,811.0
0.005,6,10,2007,5,928,1.0,660.0,660.0,5,1079,1.0,811.0,811.0
0.015,6,10,1972,5,910,3.0,642.0,642.0,5,1062,3.0,794.0,794.0
171.136,17,70,9763,35,2329,5033.0,44.0,38.0,35,7434,5033.0,239.0,184.0
0.005,6,10,2006,5,927,1.0,659.0,659.0,5,1079,1.0,811.0,811.0
0.004,6,10,2006,5,927,1.0,659.0,659.0,5,1079,1.0,811.0,811.0
0.003,17,4,284,2,120,0.0,32.0,32.0,2,164,0.0,60.0,54.0
0.01,6,10,1631,5,848,2.0,580.0,580.0,5,783,2.0,515.0,515.0
0.004,17,4,284,2,120,0.0,32.0,32.0,2,164,0.0,60.0,54.0
0.005,6,10,2007,5,928,1.0,660.0,660.0,5,1079,1.0,811.0,811.0
0.013,6,10,1972,5,910,3.0,642.0,642.0,5,1062,3.0,794.0,794.0
0.006,6,10,1547,5,764,1.0,496.0,496.0,5,783,1.0,515.0,515.0
0.001,17,2,180,1,66,0.0,38.0,38.0,1,114,0.0,86.0,86.0
0.008,17,2,194,1,59,0.0,31.0,31.0,1,135,0.0,107.0,107.0
0.005,6,13,3747,7,509,0.0,137.0,137.0,6,3238,0.0,1470.0,1459.0
1797.479,17,3356,257344,1664,134828,1080.0,75.0,53.0,1692,122516,1062.0,227.0,44.0
0.014,6,10,1989,5,910,3.0,642.0,642.0,5,1079,3.0,811.0,811.0
0.003,17,2,184,1,61,0.0,33.0,33.0,1,123,0.0,95.0,95.0
0.004,6,10,1989,5,927,1.0,659.0,659.0,5,1062,1.0,794.0,794.0
0.155,6,10,1506,5,395,37.0,127.0,127.0,5,1111,36.0,843.0,843.0
0.005,17,2,166,1,75,0.0,47.0,47.0,1,91,0.0,63.0,63.0
0.005,6,10,2007,5,928,1.0,660.0,660.0,5,1079,1.0,811.0,811.0
0.413,17,41,20753,22,17096,19.0,1350.0,749.0,19,3657,17.0,1350.0,164.0
0.09,6,10,1506,5,395,21.0,127.0,127.0,5,1111,19.0,843.0,843.0
0.013,6,10,1983,5,910,3.0,642.0,642.0,5,1073,3.0,805.0,805.0
0.017,6,10,1990,5,911,4.0,643.0,643.0,5,1079,4.0,811.0,811.0
0.004,6,10,2007,5,928,1.0,660.0,660.0,5,1079,1.0,811.0,811.0
0.008,6,10,1989,5,910,2.0,642.0,642.0,5,1079,2.0,811.0,811.0
0.005,6,10,1989,5,927,1.0,659.0,659.0,5,1062,1.0,794.0,794.0
40.064,17,10,676,5,460,10012.0,104.0,64.0,5,216,10015.0,20.0,15.0
0.005,6,10,1774,5,923,1.0,655.0,655.0,5,851,1.0,583.0,583.0
413.661,6,29,4409,12,3102,10911.0,494.0,494.0,17,1307,25853.0,83.0,83.0
0.012,6,10,1972,5,910,3.0,642.0,642.0,5,1062,2.0,794.0,794.0
0.005,6,10,1689,5,839,1.0,571.0,571.0,5,850,1.0,582.0,582.0
0.032,6,10,1989,5,910,8.0,642.0,642.0,5,1079,7.0,811.0,811.0
0.005,6,10,1989,5,927,1.0,659.0,659.0,5,1062,1.0,794.0,794.0
0.072,17,4,284,2,120,0.0,32.0,32.0,2,164,69.0,60.0,54.0
0.005,6,13,3690,7,452,0.0,80.0,80.0,6,3238,0.0,1470.0,1459.0
10.951,17,28,4422,14,1994,834.0,269.0,114.0,14,2428,833.0,587.0,145.0
0.01,17,2,148,1,60,0.0,32.0,32.0,1,88,0.0,60.0,60.0
0.019,6,10,1989,5,910,4.0,642.0,642.0,5,1079,4.0,811.0,811.0
0.104,6,10,1506,5,395,20.0,127.0,127.0,5,1111,24.0,843.0,843.0
0.085,6,10,1506,5,395,17.0,127.0,127.0,5,1111,19.0,843.0,843.0
0.005,6,13,3747,7,509,0.0,137.0,137.0,6,3238,1.0,1470.0,1459.0
0.013,6,10,1631,5,848,3.0,580.0,580.0,5,783,3.0,515.0,515.0
0.075,6,10,1506,5,395,15.0,127.0,127.0,5,1111,17.0,843.0,843.0
0.005,17,2,144,1,64,0.0,36.0,36.0,1,80,0.0,52.0,52.0
88.261,17,30,4371,15,1003,6303.0,44.0,38.0,15,3368,6304.0,239.0,196.0
0.005,6,10,1774,5,923,1.0,655.0,655.0,5,851,1.0,583.0,583.0
0.116,6,10,1506,5,395,26.0,127.0,127.0,5,1111,23.0,843.0,843.0
15.073,17,15,9238,8,6902,2149.0,1350.0,834.0,7,2336,2507.0,1350.0,305.0
65.751,6,35,9486,17,3968,554.0,2903.0,1085.0,18,5518,3857.0,2667.0,435.0
0.009,6,10,1972,5,910,2.0,642.0,642.0,5,1062,2.0,794.0,794.0
0.011,17,2,160,1,72,0.0,44.0,44.0,1,88,0.0,60.0,60.0
0.004,6,10,1702,5,863,0.0,595.0,595.0,5,839,1.0,571.0,571.0
0.041,17,4,352,2,130,0.0,37.0,37.0,2,222,1.0,89.0,83.0
0.005,6,10,1774,5,923,1.0,655.0,655.0,5,851,1.0,583.0,583.0
11.169,17,28,4422,14,1994,846.0,269.0,114.0,14,2428,846.0,587.0,145.0
0.122,6,10,1506,5,395,29.0,127.0,127.0,5,1111,24.0,843.0,843.0
0.004,6,10,2006,5,927,1.0,659.0,659.0,5,1079,1.0,811.0,811.0
0.008,17,2,194,1,59,0.0,31.0,31.0,1,135,0.0,107.0,107.0
0.074,17,8,3613,4,1874,24.0,1350.0,440.0,4,1739,12.0,1350.0,406.0
0.006,17,2,302,1,65,0.0,37.0,37.0,1,237,0.0,209.0,209.0
0.004,6,10,2006,5,927,1.0,659.0,659.0,5,1079,1.0,811.0,811.0
0.007,6,10,2006,5,927,1.0,659.0,659.0,5,1079,1.0,811.0,811.0
0.014,6,10,1989,5,910,3.0,642.0,642.0,5,1079,3.0,811.0,811.0
0.006,6,10,1547,5,764,1.0,496.0,496.0,5,783,1.0,515.0,515.0
0.001,17,2,180,1,66,0.0,38.0,38.0,1,114,0.0,86.0,86.0
0.084,6,10,1506,5,395,16.0,127.0,127.0,5,1111,19.0,843.0,843.0
0.008,6,10,1990,5,911,2.0,643.0,643.0,5,1079,1.0,811.0,811.0
0.005,6,10,1774,5,923,1.0,655.0,655.0,5,851,1.0,583.0,583.0
0.012,6,10,1989,5,910,2.0,642.0,642.0,5,1079,3.0,811.0,811.0
0.008,6,10,1762,5,911,2.0,643.0,643.0,5,851,2.0,583.0,583.0
0.016,6,10,1677,5,827,3.0,559.0,559.0,5,850,3.0,582.0,582.0
0.005,6,10,1989,5,927,1.0,659.0,659.0,5,1062,1.0,794.0,794.0
0.004,6,10,2006,5,927,1.0,659.0,659.0,5,1079,1.0,811.0,811.0
240.338,6,35,9882,18,1904,14137.0,573.0,189.0,17,7978,15020.0,1402.0,645.0
0.005,6,10,2007,5,928,1.0,660.0,660.0,5,1079,1.0,811.0,811.0
0.0,17,2,180,1,66,0.0,38.0,38.0,1,114,0.0,86.0,86.0
177.225,17,80,11244,40,2667,4544.0,44.0,38.0,40,8577,4544.0,239.0,186.0
0.006,6,10,1854,5,889,1.0,621.0,621.0,5,965,1.0,697.0,697.0
0.169,17,2,152,1,76,0.0,48.0,48.0,1,76,0.0,48.0,48.0
240.02,6,9,787,5,488,60005.0,232.0,232.0,4,299,80005.0,83.0,83.0
0.006,6,10,1547,5,764,1.0,496.0,496.0,5,783,1.0,515.0,515.0
0.011,6,10,1972,5,910,2.0,642.0,642.0,5,1062,2.0,794.0,794.0
0.081,6,10,1506,5,395,17.0,127.0,127.0,5,1111,16.0,843.0,843.0
0.005,6,10,1702,5,863,1.0,595.0,595.0,5,839,1.0,571.0,571.0
0.005,6,10,1774,5,923,1.0,655.0,655.0,5,851,1.0,583.0,583.0
0.006,6,10,1547,5,764,1.0,496.0,496.0,5,783,1.0,515.0,515.0
40.064,17,10,676,5,460,10012.0,104.0,64.0,5,216,10015.0,20.0,15.0
0.009,6,10,1989,5,910,2.0,642.0,642.0,5,1079,2.0,811.0,811.0
0.01,6,10,1972,5,910,2.0,642.0,642.0,5,1062,2.0,794.0,794.0
0.075,17,2,152,1,76,0.0,48.0,48.0,1,76,0.0,48.0,48.0
0.087,6,10,1506,5,395,20.0,127.0,127.0,5,1111,16.0,843.0,843.0
0.011,17,2,214,1,75,0.0,47.0,47.0,1,139,0.0,111.0,111.0
0.068,6,10,1506,5,395,14.0,127.0,127.0,5,1111,14.0,843.0,843.0
0.066,17,8,3613,4,1874,22.0,1350.0,440.0,4,1739,11.0,1350.0,406.0
0.017,6,10,1990,5,911,4.0,643.0,643.0,5,1079,4.0,811.0,811.0
0.005,6,10,2006,5,927,1.0,659.0,659.0,5,1079,1.0,811.0,811.0
0.075,6,10,1506,5,395,15.0,127.0,127.0,5,1111,16.0,843.0,843.0
0.167,17,2,152,1,76,0.0,48.0,48.0,1,76,0.0,48.0,48.0
0.006,6,10,1854,5,889,1.0,621.0,621.0,5,965,1.0,697.0,697.0
0.006,17,2,294,1,64,0.0,36.0,36.0,1,230,0.0,202.0,202.0
0.005,6,10,2006,5,927,1.0,659.0,659.0,5,1079,1.0,811.0,811.0
0.065,6,10,1506,5,395,14.0,127.0,127.0,5,1111,15.0,843.0,843.0
0.005,6,10,2000,5,927,1.0,659.0,659.0,5,1073,1.0,805.0,805.0
11.176,17,28,4419,14,1995,847.0,270.0,114.0,14,2424,847.0,587.0,145.0
0.005,17,2,222,1,65,0.0,37.0,37.0,1,157,0.0,129.0,129.0
0.009,6,10,1972,5,910,2.0,642.0,642.0,5,1062,2.0,794.0,794.0
0.031,6,10,1983,5,910,7.0,642.0,642.0,5,1073,7.0,805.0,805.0
0.009,6,13,3747,7,509,1.0,137.0,137.0,6,3238,1.0,1470.0,1459.0
15.075,17,16,8580,8,6271,2149.0,1350.0,755.0,8,2309,2149.0,1350.0,260.0
0.267,17,38,20112,21,17029,13.0,1350.0,782.0,17,3083,13.0,1350.0,153.0
0.012,6,10,1990,5,911,3.0,643.0,643.0,5,1079,3.0,811.0,811.0
0.005,6,10,1989,5,927,1.0,659.0,659.0,5,1062,1.0,794.0,794.0
0.009,6,10,1989,5,910,2.0,642.0,642.0,5,1079,2.0,811.0,811.0
0.006,6,10,1547,5,764,1.0,496.0,496.0,5,783,1.0,515.0,515.0
0.005,6,10,2006,5,927,1.0,659.0,659.0,5,1079,1.0,811.0,811.0
0.005,6,10,2006,5,927,1.0,659.0,659.0,5,1079,1.0,811.0,811.0
0.01,6,10,1983,5,910,2.0,642.0,642.0,5,1073,2.0,805.0,805.0
0.009,6,10,1990,5,911,2.0,643.0,643.0,5,1079,2.0,811.0,811.0
0.005,6,10,2000,5,927,1.0,659.0,659.0,5,1073,1.0,805.0,805.0
0.079,6,10,1506,5,395,17.0,127.0,127.0,5,1111,18.0,843.0,843.0
0.072,6,10,1506,5,395,16.0,127.0,127.0,5,1111,15.0,843.0,843.0
0.004,17,2,136,1,60,0.0,32.0,32.0,1,76,0.0,48.0,48.0
0.004,6,10,1989,5,927,1.0,659.0,659.0,5,1062,1.0,794.0,794.0
0.005,6,10,2007,5,928,1.0,660.0,660.0,5,1079,1.0,811.0,811.0
40.073,17,10,676,5,460,10017.0,104.0,64.0,5,216,10017.0,20.0,15.0
0.006,6,13,3747,7,509,1.0,137.0,137.0,6,3238,1.0,1470.0,1459.0
0.006,6,10,2006,5,927,1.0,659.0,659.0,5,1079,1.0,811.0,811.0
0.005,17,2,179,1,71,0.0,43.0,43.0,1,108,0.0,80.0,80.0
0.006,6,10,1689,5,839,1.0,571.0,571.0,5,850,1.0,582.0,582.0
0.039,6,10,1972,5,910,9.0,642.0,642.0,5,1062,9.0,794.0,794.0
0.116,6,10,1506,5,395,26.0,127.0,127.0,5,1111,27.0,843.0,843.0
0.007,17,2,179,1,71,0.0,43.0,43.0,1,108,0.0,80.0,80.0
0.179,6,10,1506,5,395,28.0,127.0,127.0,5,1111,34.0,843.0,843.0
0.005,6,10,1989,5,927,1.0,659.0,659.0,5,1062,1.0,794.0,794.0
0.006,17,2,225,1,65,0.0,37.0,37.0,1,160,0.0,132.0,132.0
0.006,6,10,2000,5,927,1.0,659.0,659.0,5,1073,1.0,805.0,805.0
0.332,6,10,1506,5,395,78.0,127.0,127.0,5,1111,81.0,843.0,843.0
0.006,17,2,170,1,65,0.0,37.0,37.0,1,105,0.0,77.0,77.0
0.008,6,10,1989,5,910,2.0,642.0,642.0,5,1079,2.0,811.0,811.0
0.038,17,4,284,2,120,0.0,32.0,32.0,2,164,35.0,60.0,54.0
0.013,6,10,1677,5,827,3.0,559.0,559.0,5,850,3.0,582.0,582.0
0.122,17,2,80,1,32,0.0,4.0,4.0,1,48,0.0,20.0,20.0
0.061,17,2,80,1,32,0.0,4.0,4.0,1,48,0.0,20.0,20.0
0.008,6,10,1989,5,910,1.0,642.0,642.0,5,1079,2.0,811.0,811.0
0.102,6,10,1506,5,395,20.0,127.0,127.0,5,1111,23.0,843.0,843.0
0.004,17,2,170,1,65,0.0,37.0,37.0,1,105,0.0,77.0,77.0
0.249,17,39,20083,22,17082,11.0,1350.0,748.0,17,3001,11.0,1350.0,148.0
0.992,6,46,27742,24,20918,43.0,2720.0,1423.0,22,6824,38.0,2720.0,988.0
0.259,6,10,1506,5,395,15.0,127.0,127.0,5,1111,61.0,843.0,843.0
0.004,6,10,1989,5,927,1.0,659.0,659.0,5,1062,0.0,794.0,794.0
0.005,6,10,2000,5,927,1.0,659.0,659.0,5,1073,1.0,805.0,805.0
0.006,6,10,1643,5,860,1.0,592.0,592.0,5,783,1.0,515.0,515.0
0.08,6,10,1506,5,395,16.0,127.0,127.0,5,1111,17.0,843.0,843.0
0.079,6,10,1506,5,395,18.0,127.0,127.0,5,1111,18.0,843.0,843.0
0.007,17,2,148,1,60,0.0,32.0,32.0,1,88,0.0,60.0,60.0
0.004,6,10,1774,5,923,1.0,655.0,655.0,5,851,1.0,583.0,583.0
0.004,6,10,1774,5,923,1.0,655.0,655.0,5,851,1.0,583.0,583.0
246.786,6,28,9295,15,2263,17625.0,661.0,295.0,13,7032,20562.0,1402.0,908.0
0.005,6,13,3747,7,509,0.0,137.0,137.0,6,3238,0.0,1470.0,1459.0
0.013,6,10,1983,5,910,3.0,642.0,642.0,5,1073,3.0,805.0,805.0
0.014,6,10,1990,5,911,3.0,643.0,643.0,5,1079,3.0,811.0,811.0
0.037,17,2,412,1,61,0.0,33.0,33.0,1,351,0.0,323.0,323.0
0.005,6,14,3742,7,452,0.0,80.0,80.0,7,3290,0.0,1448.0,972.0
0.009,6,6,716,3,458,3.0,302.0,302.0,3,258,3.0,102.0,102.0
0.007,6,10,1689,5,839,1.0,571.0,571.0,5,850,1.0,582.0,582.0
0.102,6,10,1506,5,395,22.0,127.0,127.0,5,1111,24.0,843.0,843.0
0.183,6,10,1506,5,395,41.0,127.0,127.0,5,1111,43.0,843.0,843.0
0.023,17,2,148,1,60,0.0,32.0,32.0,1,88,0.0,60.0,60.0
26.278,6,11,4898,6,566,5255.0,254.0,254.0,5,4332,4.0,1402.0,1354.0
0.038,17,2,148,1,60,0.0,32.0,32.0,1,88,0.0,60.0,60.0
0.081,6,10,1506,5,395,18.0,127.0,127.0,5,1111,18.0,843.0,843.0
0.004,17,2,154,1,69,0.0,41.0,41.0,1,85,0.0,57.0,57.0
0.004,17,2,136,1,60,0.0,32.0,32.0,1,76,0.0,48.0,48.0
0.004,17,2,148,1,60,0.0,32.0,32.0,1,88,0.0,60.0,60.0
241.711,6,327,344242,126,18056,1933.0,2736.0,959.0,201,326186,1208.0,2804.0,1653.0
0.006,6,10,1547,5,764,1.0,496.0,496.0,5,783,1.0,515.0,515.0
0.006,6,10,2006,5,927,1.0,659.0,659.0,5,1079,1.0,811.0,811.0
0.042,6,10,1990,5,911,10.0,643.0,643.0,5,1079,10.0,811.0,811.0
67.169,6,31,17935,14,9574,5166.0,2804.0,1475.0,17,8361,4190.0,2317.0,679.0
0.079,6,10,1506,5,395,17.0,127.0,127.0,5,1111,16.0,843.0,843.0
0.014,6,10,1983,5,910,3.0,642.0,642.0,5,1073,3.0,805.0,805.0
0.005,17,2,140,1,62,0.0,34.0,34.0,1,78,0.0,50.0,50.0
0.005,6,10,2006,5,927,1.0,659.0,659.0,5,1079,1.0,811.0,811.0
0.005,6,10,2007,5,928,1.0,660.0,660.0,5,1079,1.0,811.0,811.0
0.013,6,10,1972,5,910,3.0,642.0,642.0,5,1062,3.0,794.0,794.0
0.006,17,2,180,1,66,0.0,38.0,38.0,1,114,0.0,86.0,86.0
240.493,6,36,10045,18,1883,14144.0,555.0,187.0,18,8162,14144.0,1402.0,602.0
240.012,6,9,787,5,488,60003.0,232.0,232.0,4,299,80003.0,83.0,83.0
66.317,6,22,10140,12,3973,6028.0,1579.0,835.0,10,6167,7349.0,2111.0,939.0
0.006,6,10,1547,5,764,1.0,496.0,496.0,5,783,1.0,515.0,515.0
31.056,6,36,19420,22,6588,1478.0,1127.0,603.0,14,12832,2388.0,2804.0,1512.0
0.007,17,2,179,1,71,0.0,43.0,43.0,1,108,0.0,80.0,80.0
0.081,6,10,1506,5,395,17.0,127.0,127.0,5,1111,18.0,843.0,843.0
0.025,6,11,2041,6,962,5.0,642.0,642.0,5,1079,6.0,811.0,811.0
0.065,6,10,1506,5,395,15.0,127.0,127.0,5,1111,14.0,843.0,843.0
0.006,6,10,1989,5,927,1.0,659.0,659.0,5,1062,1.0,794.0,794.0
0.018,6,10,1972,5,910,4.0,642.0,642.0,5,1062,4.0,794.0,794.0
0.015,6,10,1983,5,910,3.0,642.0,642.0,5,1073,3.0,805.0,805.0
0.005,6,10,2006,5,927,1.0,659.0,659.0,5,1079,1.0,811.0,811.0
0.006,6,10,2000,5,927,1.0,659.0,659.0,5,1073,1.0,805.0,805.0
0.005,6,10,2006,5,927,1.0,659.0,659.0,5,1079,1.0,811.0,811.0
0.22,6,16,2777,8,1395,31.0,533.0,323.0,8,1382,20.0,529.0,239.0
0.01,6,10,1989,5,910,2.0,642.0,642.0,5,1079,2.0,811.0,811.0
0.116,6,10,1506,5,395,25.0,127.0,127.0,5,1111,28.0,843.0,843.0
0.059,6,10,1506,5,395,13.0,127.0,127.0,5,1111,14.0,843.0,843.0
0.089,6,10,1506,5,395,18.0,127.0,127.0,5,1111,21.0,843.0,843.0
0.079,6,10,1506,5,395,16.0,127.0,127.0,5,1111,18.0,843.0,843.0
0.092,6,10,1506,5,395,19.0,127.0,127.0,5,1111,20.0,843.0,843.0
0.006,6,10,2007,5,928,1.0,660.0,660.0,5,1079,1.0,811.0,811.0
0.004,6,10,2007,5,928,1.0,660.0,660.0,5,1079,1.0,811.0,811.0
0.094,6,10,1506,5,395,20.0,127.0,127.0,5,1111,19.0,843.0,843.0
308.366,17,20,1124,10,716,34256.0,48.0,43.0,10,408,34256.0,20.0,12.0
0.081,6,10,1506,5,395,17.0,127.0,127.0,5,1111,19.0,843.0,843.0
0.018,6,10,1983,5,910,4.0,642.0,642.0,5,1073,4.0,805.0,805.0
0.006,6,10,1989,5,927,1.0,659.0,659.0,5,1062,1.0,794.0,794.0
0.088,6,10,1506,5,395,19.0,127.0,127.0,5,1111,20.0,843.0,843.0
0.08,6,10,1506,5,395,18.0,127.0,127.0,5,1111,16.0,843.0,843.0
0.007,6,10,1547,5,764,1.0,496.0,496.0,5,783,1.0,515.0,515.0
10.818,17,28,4423,14,1994,823.0,269.0,114.0,14,2429,823.0,588.0,145.0
1772.121,6,105,6270,60,3525,30035.0,27.0,27.0,45,2745,40274.0,27.0,27.0
0.005,17,2,169,1,62,0.0,34.0,34.0,1,107,0.0,79.0,79.0
0.005,6,10,2006,5,927,1.0,659.0,659.0,5,1079,1.0,811.0,811.0
0.111,6,10,1506,5,395,20.0,127.0,127.0,5,1111,25.0,843.0,843.0
40.069,17,10,676,5,460,10016.0,104.0,64.0,5,216,10016.0,20.0,15.0
0.099,6,10,1506,5,395,24.0,127.0,127.0,5,1111,21.0,843.0,843.0
0.008,6,10,1972,5,910,2.0,642.0,642.0,5,1062,2.0,794.0,794.0
0.011,6,10,1989,5,910,2.0,642.0,642.0,5,1079,2.0,811.0,811.0
0.087,6,10,1506,5,395,20.0,127.0,127.0,5,1111,17.0,843.0,843.0
308.607,17,20,1124,10,716,34275.0,48.0,43.0,10,408,34275.0,20.0,12.0
40.058,17,10,676,5,460,10013.0,104.0,64.0,5,216,10013.0,20.0,15.0
0.113,6,10,1506,5,395,20.0,127.0,127.0,5,1111,24.0,843.0,843.0
0.016,6,10,1989,5,910,3.0,642.0,642.0,5,1079,3.0,811.0,811.0
0.004,6,10,2006,5,927,1.0,659.0,659.0,5,1079,1.0,811.0,811.0
0.092,6,10,1506,5,395,21.0,127.0,127.0,5,1111,19.0,843.0,843.0
0.014,6,10,1983,5,910,3.0,642.0,642.0,5,1073,3.0,805.0,805.0
0.003,17,2,152,1,76,0.0,48.0,48.0,1,76,0.0,48.0,48.0
10.96,17,28,4394,14,2311,835.0,586.0,137.0,14,2083,835.0,270.0,120.0
0.006,6,10,1547,5,764,1.0,496.0,496.0,5,783,1.0,515.0,515.0
0.09,6,10,1506,5,395,20.0,127.0,127.0,5,1111,18.0,843.0,843.0
0.005,6,10,1989,5,927,1.0,659.0,659.0,5,1062,1.0,794.0,794.0
0.007,6,10,2006,5,927,1.0,659.0,659.0,5,1079,1.0,811.0,811.0
0.014,6,10,1983,5,910,3.0,642.0,642.0,5,1073,3.0,805.0,805.0
10.715,17,28,4422,14,1993,816.0,268.0,114.0,14,2429,816.0,588.0,145.0
0.331,17,49,32244,28,26203,12.0,1350.0,907.0,21,6041,13.0,1350.0,259.0
0.003,17,2,146,1,65,0.0,37.0,37.0,1,81,0.0,53.0,53.0
0.011,6,10,1990,5,911,2.0,643.0,643.0,5,1079,2.0,811.0,811.0
0.124,6,10,1506,5,395,25.0,127.0,127.0,5,1111,27.0,843.0,843.0
0.135,6,10,1506,5,395,31.0,127.0,127.0,5,1111,31.0,843.0,843.0
0.012,6,10,1605,5,388,3.0,120.0,120.0,5,1217,2.0,949.0,949.0
0.113,6,10,1506,5,395,24.0,127.0,127.0,5,1111,24.0,843.0,843.0
0.008,6,10,1643,5,860,2.0,592.0,592.0,5,783,2.0,515.0,515.0
0.004,6,10,1989,5,927,1.0,659.0,659.0,5,1062,1.0,794.0,794.0
0.074,17,2,136,1,60,0.0,32.0,32.0,1,76,0.0,48.0,48.0
0.019,6,10,1983,5,910,4.0,642.0,642.0,5,1073,4.0,805.0,805.0
0.009,6,10,1989,5,910,2.0,642.0,642.0,5,1079,2.0,811.0,811.0
0.014,6,10,1631,5,848,3.0,580.0,580.0,5,783,3.0,515.0,515.0
75.4,6,22,8498,12,2236,76.0,1345.0,574.0,10,6262,8358.0,2720.0,975.0
0.012,6,10,1631,5,848,3.0,580.0,580.0,5,783,2.0,515.0,515.0
0.016,17,2,198,1,91,0.0,63.0,63.0,1,107,0.0,79.0,79.0
0.102,6,10,1506,5,395,22.0,127.0,127.0,5,1111,23.0,843.0,843.0
0.072,17,8,3613,4,1874,24.0,1350.0,440.0,4,1739,12.0,1350.0,406.0
0.013,17,2,152,1,56,0.0,28.0,28.0,1,96,0.0,68.0,68.0
0.043,17,4,352,2,130,1.0,37.0,37.0,2,222,39.0,89.0,83.0
120.586,6,58,19100,34,4870,3654.0,1052.0,221.0,24,14230,5242.0,2804.0,926.0
11.119,17,28,4420,14,1993,843.0,268.0,114.0,14,2427,843.0,586.0,145.0
0.013,6,10,1605,5,388,3.0,120.0,120.0,5,1217,3.0,949.0,949.0
0.005,6,10,1989,5,927,1.0,659.0,659.0,5,1062,1.0,794.0,794.0
0.103,6,10,1506,5,395,21.0,127.0,127.0,5,1111,22.0,843.0,843.0
15.073,17,15,9239,8,6902,2149.0,1350.0,834.0,7,2337,2507.0,1350.0,305.0
0.134,6,10,1506,5,395,31.0,127.0,127.0,5,1111,28.0,843.0,843.0
0.091,6,10,1506,5,395,20.0,127.0,127.0,5,1111,17.0,843.0,843.0
0.005,6,10,1854,5,889,1.0,621.0,621.0,5,965,1.0,697.0,697.0
0.005,6,10,1774,5,923,1.0,655.0,655.0,5,851,1.0,583.0,583.0
0.082,6,10,1506,5,395,19.0,127.0,127.0,5,1111,18.0,843.0,843.0
0.005,6,10,2000,5,927,1.0,659.0,659.0,5,1073,1.0,805.0,805.0
0.006,6,10,1547,5,764,1.0,496.0,496.0,5,783,1.0,515.0,515.0
0.001,17,2,136,1,60,0.0,32.0,32.0,1,76,0.0,48.0,48.0
0.108,6,10,1506,5,395,23.0,127.0,127.0,5,1111,24.0,843.0,843.0
0.013,6,10,1972,5,910,3.0,642.0,642.0,5,1062,3.0,794.0,794.0
0.005,6,10,2000,5,927,1.0,659.0,659.0,5,1073,1.0,805.0,805.0
1752.222,6,65,7396,43,4521,41719.0,1402.0,103.0,22,2875,83431.0,1111.0,82.0
0.007,6,10,1762,5,911,1.0,643.0,643.0,5,851,1.0,583.0,583.0
0.013,6,10,1677,5,827,3.0,559.0,559.0,5,850,3.0,582.0,582.0
0.008,6,10,1989,5,927,1.0,659.0,659.0,5,1062,1.0,794.0,794.0
0.012,6,10,1677,5,827,3.0,559.0,559.0,5,850,3.0,582.0,582.0
0.005,6,10,2007,5,928,1.0,660.0,660.0,5,1079,1.0,811.0,811.0
0.113,6,10,1506,5,395,27.0,127.0,127.0,5,1111,24.0,843.0,843.0
0.008,6,10,1972,5,910,1.0,642.0,642.0,5,1062,2.0,794.0,794.0
0.112,6,10,1506,5,395,26.0,127.0,127.0,5,1111,26.0,843.0,843.0
0.006,17,2,166,1,75,0.0,47.0,47.0,1,91,0.0,63.0,63.0
0.04,17,4,284,2,120,0.0,32.0,32.0,2,164,36.0,60.0,54.0
0.004,6,10,2006,5,927,1.0,659.0,659.0,5,1079,1.0,811.0,811.0
0.019,6,10,1989,5,910,4.0,642.0,642.0,5,1079,4.0,811.0,811.0
0.001,17,2,180,1,66,0.0,38.0,38.0,1,114,0.0,86.0,86.0
0.011,6,10,1677,5,827,2.0,559.0,559.0,5,850,2.0,582.0,582.0
1757.228,6,103,6166,59,3473,30296.0,27.0,27.0,44,2693,40864.0,27.0,27.0
0.216,6,16,2778,8,1396,30.0,533.0,324.0,8,1382,20.0,529.0,239.0
0.012,6,10,1677,5,827,3.0,559.0,559.0,5,850,3.0,582.0,582.0
0.005,17,2,169,1,62,0.0,34.0,34.0,1,107,0.0,79.0,79.0
0.016,6,10,1989,5,910,4.0,642.0,642.0,5,1079,4.0,811.0,811.0
0.004,6,10,1779,5,928,1.0,660.0,660.0,5,851,1.0,583.0,583.0
40.059,17,10,676,5,460,10013.0,104.0,64.0,5,216,10013.0,20.0,15.0
0.004,6,10,2000,5,927,1.0,659.0,659.0,5,1073,1.0,805.0,805.0
0.006,6,13,3747,7,509,1.0,137.0,137.0,6,3238,1.0,1470.0,1459.0
240.011,6,9,787,5,488,60002.0,232.0,232.0,4,299,80002.0,83.0,83.0
0.09,6,10,1506,5,395,20.0,127.0,127.0,5,1111,18.0,843.0,843.0
241.632,6,299,343283,121,17795,2013.0,2736.0,958.0,178,325488,1365.0,4136.0,1882.0
0.071,6,10,1506,5,395,15.0,127.0,127.0,5,1111,17.0,843.0,843.0
0.014,6,10,1990,5,911,3.0,643.0,643.0,5,1079,3.0,811.0,811.0
0.005,6,10,2006,5,927,1.0,659.0,659.0,5,1079,1.0,811.0,811.0
0.088,6,10,1506,5,395,18.0,127.0,127.0,5,1111,20.0,843.0,843.0
0.114,6,10,1506,5,395,26.0,127.0,127.0,5,1111,24.0,843.0,843.0
40.063,17,10,676,5,460,10013.0,104.0,64.0,5,216,10014.0,20.0,15.0
0.006,6,10,1547,5,764,1.0,496.0,496.0,5,783,1.0,515.0,515.0
0.007,6,10,1989,5,910,1.0,642.0,642.0,5,1079,1.0,811.0,811.0
0.005,6,10,1779,5,928,1.0,660.0,660.0,5,851,1.0,583.0,583.0
0.012,6,10,1989,5,910,3.0,642.0,642.0,5,1079,3.0,811.0,811.0
0.004,6,10,1702,5,863,1.0,595.0,595.0,5,839,1.0,571.0,571.0
10.85,17,28,4422,14,1994,826.0,269.0,114.0,14,2428,825.0,587.0,145.0
0.007,6,10,1547,5,764,1.0,496.0,496.0,5,783,1.0,515.0,515.0
40.053,17,10,676,5,460,10012.0,104.0,64.0,5,216,10012.0,20.0,15.0
0.099,6,10,1506,5,395,24.0,127.0,127.0,5,1111,22.0,843.0,843.0
0.016,6,10,1762,5,911,4.0,643.0,643.0,5,851,4.0,583.0,583.0
0.004,17,4,284,2,120,0.0,32.0,32.0,2,164,0.0,60.0,54.0
0.004,6,15,3794,8,504,0.0,80.0,80.0,7,3290,0.0,1448.0,972.0
0.006,17,2,230,1,68,0.0,40.0,40.0,1,162,0.0,134.0,134.0
0.006,6,10,1547,5,764,1.0,496.0,496.0,5,783,1.0,515.0,515.0
0.013,6,10,1972,5,910,3.0,642.0,642.0,5,1062,3.0,794.0,794.0
0.018,17,2,166,1,75,0.0,47.0,47.0,1,91,0.0,63.0,63.0
0.126,6,10,1506,5,395,27.0,127.0,127.0,5,1111,28.0,843.0,843.0
0.011,6,10,1547,5,764,2.0,496.0,496.0,5,783,2.0,515.0,515.0
0.034,6,10,1990,5,911,8.0,643.0,643.0,5,1079,8.0,811.0,811.0
0.008,6,10,1677,5,827,2.0,559.0,559.0,5,850,2.0,582.0,582.0
0.008,6,10,1983,5,910,2.0,642.0,642.0,5,1073,2.0,805.0,805.0
0.005,17,2,214,1,75,0.0,47.0,47.0,1,139,0.0,111.0,111.0
10.838,17,28,4420,14,1995,824.0,270.0,114.0,14,2425,824.0,588.0,145.0
0.005,6,10,1547,5,764,1.0,496.0,496.0,5,783,1.0,515.0,515.0
0.01,6,13,3735,7,497,1.0,125.0,125.0,6,3238,1.0,1470.0,1459.0
40.067,17,10,676,5,460,10014.0,104.0,64.0,5,216,10015.0,20.0,15.0
0.02,6,10,1989,5,910,5.0,642.0,642.0,5,1079,5.0,811.0,811.0
1778.309,17,144,45504,72,22752,25046.0,288.0,288.0,72,22752,25046.0,288.0,288.0
0.119,6,10,1506,5,395,25.0,127.0,127.0,5,1111,26.0,843.0,843.0
0.235,6,16,2669,8,1395,33.0,533.0,323.0,8,1274,22.0,529.0,212.0
0.009,6,10,1983,5,910,2.0,642.0,642.0,5,1073,2.0,805.0,805.0
0.004,6,10,1989,5,927,1.0,659.0,659.0,5,1062,1.0,794.0,794.0
0.004,6,10,1702,5,863,1.0,595.0,595.0,5,839,0.0,571.0,571.0
0.071,17,8,3613,4,1874,23.0,1350.0,440.0,4,1739,12.0,1350.0,406.0
0.012,6,10,1677,5,827,3.0,559.0,559.0,5,850,2.0,582.0,582.0
0.015,6,10,1990,5,911,3.0,643.0,643.0,5,1079,3.0,811.0,811.0
0.071,17,2,182,1,65,0.0,37.0,37.0,1,117,0.0,89.0,89.0
240.017,6,9,787,5,488,60004.0,232.0,232.0,4,299,80004.0,83.0,83.0
11.39,17,28,4394,14,1994,863.0,269.0,114.0,14,2400,863.0,587.0,143.0
0.012,6,10,1990,5,911,2.0,643.0,643.0,5,1079,2.0,811.0,811.0
0.015,6,11,2024,6,962,3.0,642.0,642.0,5,1062,3.0,794.0,794.0
0.121,6,10,1506,5,395,26.0,127.0,127.0,5,1111,26.0,843.0,843.0
0.085,6,10,1506,5,395,19.0,127.0,127.0,5,1111,19.0,843.0,843.0
0.105,6,10,1506,5,395,20.0,127.0,127.0,5,1111,19.0,843.0,843.0
0.017,6,10,1989,5,910,4.0,642.0,642.0,5,1079,4.0,811.0,811.0
10.809,17,28,4416,14,1993,823.0,268.0,114.0,14,2423,823.0,586.0,145.0
0.011,6,10,1983,5,910,2.0,642.0,642.0,5,1073,2.0,805.0,805.0
0.172,6,10,1506,5,395,39.0,127.0,127.0,5,1111,31.0,843.0,843.0
0.007,17,2,136,1,60,0.0,32.0,32.0,1,76,0.0,48.0,48.0
0.039,17,4,284,2,120,0.0,32.0,32.0,2,164,36.0,60.0,54.0
0.005,6,10,2006,5,927,1.0,659.0,659.0,5,1079,1.0,811.0,811.0
0.005,17,2,140,1,62,0.0,34.0,34.0,1,78,0.0,50.0,50.0
0.014,6,13,3735,7,497,2.0,125.0,125.0,6,3238,2.0,1470.0,1459.0
0.013,6,10,1677,5,827,3.0,559.0,559.0,5,850,3.0,582.0,582.0
0.005,6,13,3690,7,452,0.0,80.0,80.0,6,3238,1.0,1470.0,1459.0
0.062,6,10,1506,5,395,14.0,127.0,127.0,5,1111,12.0,843.0,843.0
0.122,17,2,80,1,32,0.0,4.0,4.0,1,48,0.0,20.0,20.0
0.006,6,10,1547,5,764,1.0,496.0,496.0,5,783,1.0,515.0,515.0
309.413,17,20,1124,10,716,34367.0,48.0,43.0,10,408,34366.0,20.0,12.0
0.007,6,10,1547,5,764,1.0,496.0,496.0,5,783,1.0,515.0,515.0
0.129,6,10,1506,5,395,30.0,127.0,127.0,5,1111,30.0,843.0,843.0
0.01,6,12,1926,6,1189,1.0,659.0,434.0,6,737,2.0,417.0,417.0
0.007,6,14,3742,7,452,1.0,80.0,80.0,7,3290,1.0,1448.0,972.0
1773.21,6,64,7358,42,4484,43249.0,1640.0,109.0,22,2874,84430.0,1110.0,82.0
0.006,6,10,1547,5,764,1.0,496.0,496.0,5,783,1.0,515.0,515.0
0.013,6,10,1989,5,910,3.0,642.0,642.0,5,1079,3.0,811.0,811.0
0.001,17,2,180,1,66,0.0,38.0,38.0,1,114,0.0,86.0,86.0
0.003,17,2,136,1,60,0.0,32.0,32.0,1,76,0.0,48.0,48.0
40.059,17,10,676,5,460,10012.0,104.0,64.0,5,216,10013.0,20.0,15.0
0.186,17,4,352,2,130,146.0,37.0,37.0,2,222,148.0,89.0,83.0
0.089,6,10,1506,5,395,19.0,127.0,127.0,5,1111,19.0,843.0,843.0
240.085,6,19,4839,9,2169,30010.0,966.0,568.0,10,2670,26675.0,1162.0,428.0
0.005,6,10,2007,5,928,1.0,660.0,660.0,5,1079,1.0,811.0,811.0
0.08,6,10,1506,5,395,17.0,127.0,127.0,5,1111,17.0,843.0,843.0
0.013,6,13,3735,7,497,2.0,125.0,125.0,6,3238,2.0,1470.0,1459.0
0.018,6,10,1983,5,910,4.0,642.0,642.0,5,1073,4.0,805.0,805.0
0.014,6,10,1990,5,911,3.0,643.0,643.0,5,1079,3.0,811.0,811.0
0.001,17,2,174,1,72,0.0,44.0,44.0,1,102,0.0,74.0,74.0
0.008,6,10,1989,5,910,2.0,642.0,642.0,5,1079,2.0,811.0,811.0
0.005,6,10,1989,5,927,1.0,659.0,659.0,5,1062,1.0,794.0,794.0
0.007,6,10,2006,5,927,1.0,659.0,659.0,5,1079,1.0,811.0,811.0
0.004,17,2,136,1,60,0.0,32.0,32.0,1,76,0.0,48.0,48.0
0.009,6,10,1989,5,910,2.0,642.0,642.0,5,1079,2.0,811.0,811.0
0.01,6,10,1972,5,910,2.0,642.0,642.0,5,1062,2.0,794.0,794.0
36.954,6,38,12382,19,6824,495.0,2720.0,1206.0,19,5558,2043.0,2667.0,435.0
0.006,6,13,3747,7,509,1.0,137.0,137.0,6,3238,1.0,1470.0,1459.0
172.523,17,82,11605,41,2741,4312.0,44.0,38.0,41,8864,4313.0,239.0,188.0
0.266,17,38,20164,21,17036,13.0,1350.0,783.0,17,3128,12.0,1350.0,156.0
65.82,6,49,21266,25,15279,384.0,2720.0,1424.0,24,5987,2854.0,2667.0,385.0
0.006,6,13,3747,7,509,1.0,137.0,137.0,6,3238,1.0,1470.0,1459.0
0.005,6,10,1689,5,839,1.0,571.0,571.0,5,850,1.0,582.0,582.0
0.008,6,10,1990,5,911,1.0,643.0,643.0,5,1079,2.0,811.0,811.0
0.015,6,10,1631,5,848,3.0,580.0,580.0,5,783,3.0,515.0,515.0
0.008,6,10,1983,5,910,2.0,642.0,642.0,5,1073,2.0,805.0,805.0
0.005,6,10,1989,5,927,1.0,659.0,659.0,5,1062,1.0,794.0,794.0
0.003,17,2,148,1,60,0.0,32.0,32.0,1,88,0.0,60.0,60.0
0.04,17,2,148,1,60,0.0,32.0,32.0,1,88,0.0,60.0,60.0
10.822,17,28,4423,14,1994,824.0,269.0,114.0,14,2429,824.0,588.0,145.0
0.004,6,10,2006,5,927,1.0,659.0,659.0,5,1079,1.0,811.0,811.0
0.014,6,10,1677,5,827,3.0,559.0,559.0,5,850,3.0,582.0,582.0
0.061,6,10,1506,5,395,13.0,127.0,127.0,5,1111,14.0,843.0,843.0
0.006,6,10,1643,5,860,1.0,592.0,592.0,5,783,1.0,515.0,515.0
0.037,6,10,1677,5,827,9.0,559.0,559.0,5,850,9.0,582.0,582.0
0.086,6,10,1506,5,395,17.0,127.0,127.0,5,1111,18.0,843.0,843.0
0.073,6,10,1506,5,395,15.0,127.0,127.0,5,1111,16.0,843.0,843.0
37.054,6,36,9555,18,4037,516.0,1572.0,821.0,18,5518,2170.0,2667.0,435.0
0.007,6,10,1972,5,910,1.0,642.0,642.0,5,1062,1.0,794.0,794.0
0.011,6,14,3787,7,497,1.0,125.0,125.0,7,3290,1.0,1448.0,972.0
0.006,6,10,2006,5,927,1.0,659.0,659.0,5,1079,1.0,811.0,811.0
0.127,6,10,1506,5,395,29.0,127.0,127.0,5,1111,27.0,843.0,843.0
0.004,17,2,148,1,60,0.0,32.0,32.0,1,88,0.0,60.0,60.0
0.068,6,10,1506,5,395,14.0,127.0,127.0,5,1111,15.0,843.0,843.0
0.012,6,10,1983,5,910,3.0,642.0,642.0,5,1073,3.0,805.0,805.0
241.237,6,304,342868,111,17276,2193.0,2736.0,959.0,193,325592,1256.0,2804.0,1724.0
0.006,6,10,1547,5,764,1.0,496.0,496.0,5,783,1.0,515.0,515.0
0.039,17,2,148,1,60,0.0,32.0,32.0,1,88,0.0,60.0,60.0
240.022,6,9,787,5,488,60005.0,232.0,232.0,4,299,80006.0,83.0,83.0
0.042,17,2,144,1,64,0.0,36.0,36.0,1,80,0.0,52.0,52.0
0.011,6,13,3735,7,497,1.0,125.0,125.0,6,3238,2.0,1470.0,1459.0
0.096,6,10,1506,5,395,19.0,127.0,127.0,5,1111,21.0,843.0,843.0
0.013,6,10,1989,5,910,3.0,642.0,642.0,5,1079,3.0,811.0,811.0
0.118,6,10,1506,5,395,28.0,127.0,127.0,5,1111,28.0,843.0,843.0
0.04,17,2,170,1,65,0.0,37.0,37.0,1,105,0.0,77.0,77.0
351.996,6,20,2210,6,1308,12004.0,494.0,494.0,14,902,27076.0,83.0,83.0
0.009,6,10,1762,5,911,2.0,643.0,643.0,5,851,2.0,583.0,583.0
0.001,17,2,166,1,75,0.0,47.0,47.0,1,91,0.0,63.0,63.0
0.005,6,10,1989,5,927,1.0,659.0,659.0,5,1062,1.0,794.0,794.0
11.023,17,26,4101,13,1821,909.0,268.0,112.0,13,2280,909.0,587.0,147.0
0.011,6,10,1972,5,910,2.0,642.0,642.0,5,1062,2.0,794.0,794.0
0.107,6,10,1506,5,395,25.0,127.0,127.0,5,1111,24.0,843.0,843.0
0.011,6,10,1990,5,911,2.0,643.0,643.0,5,1079,2.0,811.0,811.0
0.006,6,10,1547,5,764,1.0,496.0,496.0,5,783,1.0,515.0,515.0
0.012,6,10,1972,5,910,3.0,642.0,642.0,5,1062,2.0,794.0,794.0
0.012,6,13,3735,7,497,2.0,125.0,125.0,6,3238,2.0,1470.0,1459.0
0.038,17,2,412,1,61,0.0,33.0,33.0,1,351,0.0,323.0,323.0
0.001,17,2,136,1,60,0.0,32.0,32.0,1,76,0.0,48.0,48.0
0.047,17,2,136,1,60,0.0,32.0,32.0,1,76,0.0,48.0,48.0
0.052,6,10,1506,5,395,10.0,127.0,127.0,5,1111,12.0,843.0,843.0
0.005,6,10,2007,5,928,1.0,660.0,660.0,5,1079,1.0,811.0,811.0
10.764,17,28,4421,14,1993,819.0,268.0,114.0,14,2428,819.0,587.0,145.0
0.005,6,10,2000,5,927,1.0,659.0,659.0,5,1073,1.0,805.0,805.0
0.008,6,10,1989,5,910,1.0,642.0,642.0,5,1079,1.0,811.0,811.0
0.012,6,10,1677,5,827,3.0,559.0,559.0,5,850,2.0,582.0,582.0
0.109,6,10,1506,5,395,24.0,127.0,127.0,5,1111,26.0,843.0,843.0
0.004,6,14,3736,7,446,0.0,74.0,74.0,7,3290,0.0,1448.0,972.0
0.01,6,10,1983,5,910,2.0,642.0,642.0,5,1073,2.0,805.0,805.0
0.174,17,2,152,1,76,0.0,48.0,48.0,1,76,0.0,48.0,48.0
1786.352,6,154,19574,92,13852,19630.0,302.0,302.0,62,5722,29284.0,83.0,83.0
0.005,6,10,2007,5,928,1.0,660.0,660.0,5,1079,1.0,811.0,811.0
240.101,6,16,4481,9,963,30012.0,238.0,166.0,7,3518,40016.0,1402.0,786.0
0.006,6,10,1547,5,764,1.0,496.0,496.0,5,783,1.0,515.0,515.0
0.015,6,10,1972,5,910,3.0,642.0,642.0,5,1062,3.0,794.0,794.0
0.008,6,10,1990,5,911,2.0,643.0,643.0,5,1079,2.0,811.0,811.0
0.005,6,10,2006,5,927,1.0,659.0,659.0,5,1079,1.0,811.0,811.0
0.005,17,2,164,1,74,0.0,46.0,46.0,1,90,0.0,62.0,62.0
0.011,6,10,1983,5,910,2.0,642.0,642.0,5,1073,2.0,805.0,805.0
40.062,17,10,676,5,460,10012.0,104.0,64.0,5,216,10014.0,20.0,15.0
0.004,6,10,1989,5,927,1.0,659.0,659.0,5,1062,1.0,794.0,794.0
0.13,6,10,1506,5,395,28.0,127.0,127.0,5,1111,29.0,843.0,843.0
0.008,6,10,1631,5,848,2.0,580.0,580.0,5,783,1.0,515.0,515.0
0.003,17,4,284,2,120,0.0,32.0,32.0,2,164,0.0,60.0,54.0
0.011,6,10,1631,5,848,2.0,580.0,580.0,5,783,2.0,515.0,515.0
0.012,6,10,1983,5,910,2.0,642.0,642.0,5,1073,3.0,805.0,805.0
0.011,6,10,1989,5,910,2.0,642.0,642.0,5,1079,2.0,811.0,811.0
10.825,17,28,4419,14,1994,824.0,269.0,114.0,14,2425,824.0,588.0,145.0
11.194,17,28,4398,14,2311,852.0,586.0,137.0,14,2087,852.0,270.0,121.0
0.001,17,2,154,1,69,0.0,41.0,41.0,1,85,0.0,57.0,57.0
0.005,6,10,1547,5,764,1.0,496.0,496.0,5,783,1.0,515.0,515.0
0.008,6,10,1989,5,927,2.0,659.0,659.0,5,1062,2.0,794.0,794.0
0.01,6,10,1990,5,911,2.0,643.0,643.0,5,1079,2.0,811.0,811.0
240.117,6,32,9862,16,7238,16007.0,2310.0,712.0,16,2624,16007.0,580.0,223.0
0.001,17,2,180,1,66,0.0,38.0,38.0,1,114,0.0,86.0,86.0
0.0,17,2,166,1,75,0.0,47.0,47.0,1,91,0.0,63.0,63.0
0.007,6,10,1631,5,848,1.0,580.0,580.0,5,783,1.0,515.0,515.0
0.005,6,10,1854,5,889,1.0,621.0,621.0,5,965,1.0,697.0,697.0
0.004,6,10,1702,5,863,0.0,595.0,595.0,5,839,1.0,571.0,571.0
0.173,6,10,1506,5,395,40.0,127.0,127.0,5,1111,41.0,843.0,843.0
369.38,6,22,2313,16,867,24625.0,195.0,195.0,6,1446,4635.0,419.0,398.0
0.004,6,10,1702,5,863,1.0,595.0,595.0,5,839,1.0,571.0,571.0
0.007,6,10,1547,5,764,1.0,496.0,496.0,5,783,1.0,515.0,515.0
0.006,6,10,1854,5,889,1.0,621.0,621.0,5,965,1.0,697.0,697.0
0.005,6,10,2007,5,928,1.0,660.0,660.0,5,1079,1.0,811.0,811.0
0.005,6,10,2007,5,928,1.0,660.0,660.0,5,1079,1.0,811.0,811.0
0.017,6,10,1989,5,910,4.0,642.0,642.0,5,1079,4.0,811.0,811.0
0.015,6,10,1990,5,911,3.0,643.0,643.0,5,1079,3.0,811.0,811.0
0.009,6,10,1990,5,911,2.0,643.0,643.0,5,1079,2.0,811.0,811.0
0.005,6,10,2000,5,927,1.0,659.0,659.0,5,1073,1.0,805.0,805.0
0.014,6,10,1972,5,910,3.0,642.0,642.0,5,1062,3.0,794.0,794.0
0.004,6,10,2007,5,928,1.0,660.0,660.0,5,1079,1.0,811.0,811.0
0.012,6,10,1989,5,910,3.0,642.0,642.0,5,1079,2.0,811.0,811.0
0.116,6,10,1506,5,395,24.0,127.0,127.0,5,1111,25.0,843.0,843.0
15.089,17,16,8552,8,6308,2150.0,1350.0,760.0,8,2244,2149.0,1350.0,252.0
0.004,6,10,2006,5,927,1.0,659.0,659.0,5,1079,1.0,811.0,811.0
1.204,6,30,12711,18,3352,70.0,1360.0,517.0,12,9359,93.0,2720.0,985.0
0.004,17,2,186,1,61,0.0,33.0,33.0,1,125,0.0,97.0,97.0
0.005,6,10,1779,5,928,1.0,660.0,660.0,5,851,1.0,583.0,583.0
296.134,17,128,18222,64,4281,4700.0,44.0,38.0,64,13941,4700.0,239.0,189.0
0.001,17,2,140,1,62,0.0,34.0,34.0,1,78,0.0,50.0,50.0
0.004,6,10,2006,5,927,1.0,659.0,659.0,5,1079,1.0,811.0,811.0
0.009,6,10,1677,5,827,2.0,559.0,559.0,5,850,2.0,582.0,582.0
0.175,6,10,1506,5,395,42.0,127.0,127.0,5,1111,33.0,843.0,843.0
0.005,6,13,3747,7,509,0.0,137.0,137.0,6,3238,1.0,1470.0,1459.0
0.004,6,10,2000,5,927,1.0,659.0,659.0,5,1073,1.0,805.0,805.0
0.012,6,10,1972,5,910,3.0,642.0,642.0,5,1062,3.0,794.0,794.0
0.044,17,2,152,1,76,0.0,48.0,48.0,1,76,0.0,48.0,48.0
0.001,17,2,136,1,60,0.0,32.0,32.0,1,76,0.0,48.0,48.0
0.011,6,10,1983,5,910,2.0,642.0,642.0,5,1073,2.0,805.0,805.0
0.005,6,10,1989,5,927,1.0,659.0,659.0,5,1062,1.0,794.0,794.0
0.07,6,10,1506,5,395,16.0,127.0,127.0,5,1111,14.0,843.0,843.0
0.005,6,10,2000,5,927,1.0,659.0,659.0,5,1073,1.0,805.0,805.0
0.005,6,10,1989,5,927,1.0,659.0,659.0,5,1062,1.0,794.0,794.0
0.121,6,10,1506,5,395,29.0,127.0,127.0,5,1111,28.0,843.0,843.0
0.011,6,10,1972,5,910,2.0,642.0,642.0,5,1062,2.0,794.0,794.0
40.07,17,10,676,5,460,10016.0,104.0,64.0,5,216,10016.0,20.0,15.0
172.156,17,78,11037,39,2601,4530.0,44.0,38.0,39,8436,4530.0,239.0,188.0
0.005,6,10,2007,5,928,1.0,660.0,660.0,5,1079,1.0,811.0,811.0
0.006,17,2,164,1,74,0.0,46.0,46.0,1,90,0.0,62.0,62.0
40.076,17,10,676,5,460,10018.0,104.0,64.0,5,216,10018.0,20.0,15.0
0.133,6,10,1506,5,395,30.0,127.0,127.0,5,1111,24.0,843.0,843.0
175.027,17,93,13364,47,3163,3804.0,44.0,39.0,46,10201,3868.0,239.0,193.0
0.076,6,10,1506,5,395,16.0,127.0,127.0,5,1111,14.0,843.0,843.0
15.171,17,21,12399,11,8697,1514.0,1350.0,762.0,10,3702,1682.0,1350.0,342.0
0.013,6,10,1983,5,910,3.0,642.0,642.0,5,1073,3.0,805.0,805.0
0.056,6,13,3735,7,497,9.0,125.0,125.0,6,3238,11.0,1470.0,1459.0
0.005,6,10,1689,5,839,1.0,571.0,571.0,5,850,1.0,582.0,582.0
0.007,17,2,170,1,65,0.0,37.0,37.0,1,105,0.0,77.0,77.0
0.003,17,4,284,2,120,0.0,32.0,32.0,2,164,0.0,60.0,54.0
0.005,6,10,2007,5,928,1.0,660.0,660.0,5,1079,1.0,811.0,811.0
0.003,17,2,148,1,60,0.0,32.0,32.0,1,88,0.0,60.0,60.0
0.003,17,2,148,1,60,0.0,32.0,32.0,1,88,0.0,60.0,60.0
0.07,6,10,1506,5,395,15.0,127.0,127.0,5,1111,14.0,843.0,843.0
40.061,17,10,676,5,460,10012.0,104.0,64.0,5,216,10013.0,20.0,15.0
0.005,17,2,213,1,69,0.0,41.0,41.0,1,144,0.0,116.0,116.0
0.009,6,10,1677,5,827,2.0,559.0,559.0,5,850,2.0,582.0,582.0
512.866,6,40,7277,21,5534,25643.0,494.0,494.0,19,1743,28492.0,83.0,83.0
0.005,6,10,1854,5,889,1.0,621.0,621.0,5,965,1.0,697.0,697.0
0.103,6,10,1506,5,395,22.0,127.0,127.0,5,1111,23.0,843.0,843.0
0.045,17,2,170,1,65,0.0,37.0,37.0,1,105,0.0,77.0,77.0
40.07,17,10,676,5,460,10015.0,104.0,64.0,5,216,10016.0,20.0,15.0
0.005,6,10,1643,5,860,1.0,592.0,592.0,5,783,1.0,515.0,515.0
0.012,6,13,3735,7,497,2.0,125.0,125.0,6,3238,2.0,1470.0,1459.0
0.005,6,10,2000,5,927,1.0,659.0,659.0,5,1073,1.0,805.0,805.0
0.005,6,10,1989,5,927,1.0,659.0,659.0,5,1062,1.0,794.0,794.0
10.809,17,28,4421,14,1994,823.0,269.0,114.0,14,2427,823.0,586.0,145.0
0.01,17,2,222,1,65,0.0,37.0,37.0,1,157,0.0,129.0,129.0
0.004,17,4,284,2,120,1.0,32.0,32.0,2,164,1.0,60.0,54.0
0.004,6,10,1702,5,863,1.0,595.0,595.0,5,839,1.0,571.0,571.0
0.013,6,10,1631,5,848,3.0,580.0,580.0,5,783,3.0,515.0,515.0
0.009,6,10,1990,5,911,2.0,643.0,643.0,5,1079,2.0,811.0,811.0
0.078,6,10,1506,5,395,18.0,127.0,127.0,5,1111,17.0,843.0,843.0
0.005,6,10,2006,5,927,1.0,659.0,659.0,5,1079,1.0,811.0,811.0
0.004,6,10,2006,5,927,1.0,659.0,659.0,5,1079,1.0,811.0,811.0
0.015,6,10,1989,5,910,3.0,642.0,642.0,5,1079,3.0,811.0,811.0
326.006,6,19,2158,6,1308,12003.0,494.0,494.0,13,850,27167.0,83.0,83.0
0.084,6,10,1506,5,395,16.0,127.0,127.0,5,1111,20.0,843.0,843.0
0.052,17,2,152,1,76,0.0,48.0,48.0,1,76,0.0,48.0,48.0
40.054,17,10,676,5,460,10012.0,104.0,64.0,5,216,10012.0,20.0,15.0
0.005,6,10,1689,5,839,1.0,571.0,571.0,5,850,1.0,582.0,582.0
0.116,6,10,1506,5,395,22.0,127.0,127.0,5,1111,23.0,843.0,843.0
0.005,6,10,1989,5,927,1.0,659.0,659.0,5,1062,1.0,794.0,794.0
0.012,6,10,1972,5,910,3.0,642.0,642.0,5,1062,2.0,794.0,794.0
0.004,17,2,136,1,60,0.0,32.0,32.0,1,76,0.0,48.0,48.0
40.059,17,10,676,5,460,10011.0,104.0,64.0,5,216,10014.0,20.0,15.0
0.014,6,10,1990,5,911,3.0,643.0,643.0,5,1079,3.0,811.0,811.0
0.006,17,2,294,1,64,0.0,36.0,36.0,1,230,0.0,202.0,202.0
0.006,6,14,3799,7,509,1.0,137.0,137.0,7,3290,0.0,1448.0,972.0
0.32,17,41,20132,22,17088,15.0,1350.0,748.0,19,3044,14.0,1350.0,132.0
0.01,6,10,1989,5,910,2.0,642.0,642.0,5,1079,2.0,811.0,811.0
0.005,6,10,2006,5,927,1.0,659.0,659.0,5,1079,1.0,811.0,811.0
0.003,17,4,284,2,120,0.0,32.0,32.0,2,164,0.0,60.0,54.0
167.179,17,72,10324,36,2403,4776.0,44.0,38.0,36,7921,4775.0,239.0,192.0
0.005,17,2,230,1,68,0.0,40.0,40.0,1,162,0.0,134.0,134.0
0.005,6,10,2007,5,928,1.0,660.0,660.0,5,1079,1.0,811.0,811.0
0.005,6,10,1643,5,860,1.0,592.0,592.0,5,783,1.0,515.0,515.0
53.369,6,28,9605,14,1707,4105.0,794.0,367.0,14,7898,4093.0,1360.0,732.0
0.006,17,2,175,1,65,0.0,37.0,37.0,1,110,0.0,82.0,82.0
0.016,17,2,198,1,91,0.0,63.0,63.0,1,107,0.0,79.0,79.0
0.039,17,2,184,1,61,0.0,33.0,33.0,1,123,0.0,95.0,95.0
0.005,6,10,1989,5,927,1.0,659.0,659.0,5,1062,1.0,794.0,794.0
0.127,6,10,1506,5,395,28.0,127.0,127.0,5,1111,29.0,843.0,843.0
0.004,6,10,2007,5,928,1.0,660.0,660.0,5,1079,1.0,811.0,811.0
0.091,6,10,1506,5,395,21.0,127.0,127.0,5,1111,20.0,843.0,843.0
0.012,6,10,1972,5,910,2.0,642.0,642.0,5,1062,3.0,794.0,794.0
0.004,6,10,1702,5,863,1.0,595.0,595.0,5,839,0.0,571.0,571.0
0.014,6,10,1990,5,911,3.0,643.0,643.0,5,1079,3.0,811.0,811.0
0.013,6,10,1631,5,848,3.0,580.0,580.0,5,783,3.0,515.0,515.0
1792.59,6,490,99785,245,88395,7346.0,421.0,365.0,245,11390,7346.0,53.0,53.0
0.015,6,10,1677,5,827,3.0,559.0,559.0,5,850,3.0,582.0,582.0
0.001,17,2,180,1,66,0.0,38.0,38.0,1,114,0.0,86.0,86.0
0.001,17,2,180,1,66,0.0,38.0,38.0,1,114,0.0,86.0,86.0
0.014,17,2,152,1,56,0.0,28.0,28.0,1,96,0.0,68.0,68.0
0.115,6,10,1506,5,395,25.0,127.0,127.0,5,1111,22.0,843.0,843.0
0.005,6,10,1989,5,927,1.0,659.0,659.0,5,1062,1.0,794.0,794.0
40.056,17,10,676,5,460,10013.0,104.0,64.0,5,216,10012.0,20.0,15.0
0.008,6,10,1989,5,910,2.0,642.0,642.0,5,1079,2.0,811.0,811.0
0.004,6,10,2000,5,927,1.0,659.0,659.0,5,1073,1.0,805.0,805.0
0.001,17,2,166,1,75,0.0,47.0,47.0,1,91,0.0,63.0,63.0
0.012,17,4,284,2,120,0.0,32.0,32.0,2,164,1.0,60.0,54.0
0.012,6,10,1677,5,827,3.0,559.0,559.0,5,850,2.0,582.0,582.0
240.139,6,39,7003,19,3330,13340.0,880.0,333.0,20,3673,12638.0,1306.0,328.0
0.135,17,2,80,1,32,0.0,4.0,4.0,1,48,0.0,20.0,20.0
0.003,17,4,284,2,120,0.0,32.0,32.0,2,164,1.0,60.0,54.0
40.058,17,10,676,5,460,10013.0,104.0,64.0,5,216,10013.0,20.0,15.0
0.005,6,10,2007,5,928,1.0,660.0,660.0,5,1079,1.0,811.0,811.0
0.005,6,10,1643,5,860,1.0,592.0,592.0,5,783,1.0,515.0,515.0
0.006,6,10,1689,5,839,1.0,571.0,571.0,5,850,1.0,582.0,582.0
240.26,6,39,5431,19,2386,13347.0,588.0,196.0,20,3045,12645.0,580.0,285.0
11.002,17,28,4422,14,1994,836.0,269.0,114.0,14,2428,835.0,587.0,145.0
0.004,6,10,1774,5,923,1.0,655.0,655.0,5,851,1.0,583.0,583.0
0.005,17,2,230,1,68,0.0,40.0,40.0,1,162,0.0,134.0,134.0
0.01,6,10,1989,5,910,2.0,642.0,642.0,5,1079,2.0,811.0,811.0
0.037,17,2,144,1,64,0.0,36.0,36.0,1,80,0.0,52.0,52.0
40.059,17,10,676,5,460,10013.0,104.0,64.0,5,216,10013.0,20.0,15.0
0.218,6,16,2669,8,1395,31.0,533.0,323.0,8,1274,19.0,529.0,212.0
0.218,6,16,2776,8,1394,31.0,533.0,323.0,8,1382,20.0,529.0,239.0
0.085,6,10,1506,5,395,18.0,127.0,127.0,5,1111,20.0,843.0,843.0
0.038,17,2,136,1,60,0.0,32.0,32.0,1,76,0.0,48.0,48.0
0.008,6,10,1989,5,910,1.0,642.0,642.0,5,1079,2.0,811.0,811.0
0.015,6,10,1631,5,848,3.0,580.0,580.0,5,783,3.0,515.0,515.0
0.074,6,10,1506,5,395,15.0,127.0,127.0,5,1111,15.0,843.0,843.0
0.17,6,3,453,2,321,170.0,241.0,241.0,1,132,0.0,92.0,92.0
0.005,6,10,1643,5,860,1.0,592.0,592.0,5,783,1.0,515.0,515.0
0.004,17,2,136,1,60,0.0,32.0,32.0,1,76,0.0,48.0,48.0
0.119,6,10,1506,5,395,27.0,127.0,127.0,5,1111,24.0,843.0,843.0
0.092,6,10,1506,5,395,20.0,127.0,127.0,5,1111,22.0,843.0,843.0
0.014,6,10,1631,5,848,3.0,580.0,580.0,5,783,3.0,515.0,515.0
40.059,17,10,676,5,460,10013.0,104.0,64.0,5,216,10005.0,20.0,15.0
40.062,17,10,676,5,460,10012.0,104.0,64.0,5,216,10014.0,20.0,15.0
0.005,6,10,2006,5,927,1.0,659.0,659.0,5,1079,1.0,811.0,811.0
0.004,6,10,2007,5,928,1.0,660.0,660.0,5,1079,1.0,811.0,811.0
301.067,6,44,12909,24,7082,13089.0,1360.0,761.0,20,5827,467.0,2667.0,385.0
0.104,6,10,1506,5,395,24.0,127.0,127.0,5,1111,24.0,843.0,843.0
0.002,17,2,185,1,73,0.0,45.0,45.0,1,112,0.0,84.0,84.0
0.005,17,2,214,1,75,0.0,47.0,47.0,1,139,0.0,111.0,111.0
40.069,17,10,676,5,460,10016.0,104.0,64.0,5,216,10016.0,20.0,15.0
0.005,6,10,2000,5,927,1.0,659.0,659.0,5,1073,1.0,805.0,805.0
0.006,17,2,194,1,59,0.0,31.0,31.0,1,135,0.0,107.0,107.0
0.026,6,10,1989,5,910,6.0,642.0,642.0,5,1079,6.0,811.0,811.0
240.021,6,9,787,5,488,60005.0,232.0,232.0,4,299,80006.0,83.0,83.0
0.023,17,2,136,1,60,0.0,32.0,32.0,1,76,0.0,48.0,48.0
300.374,6,29,10173,16,1994,20024.0,517.0,285.0,13,8179,20027.0,1402.0,936.0
0.005,6,10,1989,5,927,1.0,659.0,659.0,5,1062,1.0,794.0,794.0
300.456,6,19,3081,11,1647,30045.0,517.0,266.0,8,1434,34343.0,821.0,336.0
0.003,17,2,136,1,60,0.0,32.0,32.0,1,76,0.0,48.0,48.0
0.036,6,10,1631,5,848,9.0,580.0,580.0,5,783,9.0,515.0,515.0
0.013,6,10,1990,5,911,3.0,643.0,643.0,5,1079,3.0,811.0,811.0
11.176,17,28,4423,14,1995,847.0,270.0,114.0,14,2428,847.0,587.0,145.0
0.001,17,2,180,1,66,0.0,38.0,38.0,1,114,0.0,86.0,86.0
10.933,17,28,4422,14,1995,831.0,270.0,114.0,14,2427,832.0,586.0,145.0
0.084,6,10,1506,5,395,20.0,127.0,127.0,5,1111,19.0,843.0,843.0
0.013,6,10,1989,5,910,3.0,642.0,642.0,5,1079,3.0,811.0,811.0
0.115,6,10,1506,5,395,25.0,127.0,127.0,5,1111,21.0,843.0,843.0
313.059,17,16,928,8,608,44706.0,48.0,48.0,8,320,44705.0,12.0,12.0
40.052,17,10,676,5,460,10012.0,104.0,64.0,5,216,10012.0,20.0,15.0
0.003,17,2,208,1,72,0.0,44.0,44.0,1,136,0.0,108.0,108.0
15.074,17,15,9239,8,6902,2149.0,1350.0,834.0,7,2337,2507.0,1350.0,305.0
0.016,6,10,1972,5,910,4.0,642.0,642.0,5,1062,3.0,794.0,794.0
0.003,17,2,148,1,60,0.0,32.0,32.0,1,88,0.0,60.0,60.0
11.237,17,28,4421,14,1994,850.0,269.0,114.0,14,2427,851.0,586.0,145.0
0.001,17,2,180,1,66,0.0,38.0,38.0,1,114,0.0,86.0,86.0
0.041,17,2,152,1,76,0.0,48.0,48.0,1,76,0.0,48.0,48.0
0.258,17,46,25752,25,21224,10.0,1350.0,820.0,21,4528,9.0,1350.0,187.0
0.029,6,13,3735,7,497,4.0,125.0,125.0,6,3238,5.0,1470.0,1459.0
0.008,6,10,2006,5,927,2.0,659.0,659.0,5,1079,2.0,811.0,811.0
0.005,6,10,2006,5,927,1.0,659.0,659.0,5,1079,1.0,811.0,811.0
0.082,6,10,1506,5,395,17.0,127.0,127.0,5,1111,15.0,843.0,843.0
0.005,6,10,2000,5,927,1.0,659.0,659.0,5,1073,1.0,805.0,805.0
0.006,6,10,1643,5,860,1.0,592.0,592.0,5,783,1.0,515.0,515.0
0.005,6,10,2000,5,927,1.0,659.0,659.0,5,1073,1.0,805.0,805.0
0.041,17,2,152,1,76,0.0,48.0,48.0,1,76,0.0,48.0,48.0
0.004,17,2,148,1,60,0.0,32.0,32.0,1,88,0.0,60.0,60.0
0.005,6,10,1854,5,889,1.0,621.0,621.0,5,965,1.0,697.0,697.0
0.053,17,2,152,1,76,0.0,48.0,48.0,1,76,0.0,48.0,48.0
0.005,6,10,1547,5,764,1.0,496.0,496.0,5,783,1.0,515.0,515.0
0.005,6,10,1547,5,764,1.0,496.0,496.0,5,783,1.0,515.0,515.0
0.006,6,10,1547,5,764,1.0,496.0,496.0,5,783,1.0,515.0,515.0
0.065,6,10,1506,5,395,15.0,127.0,127.0,5,1111,15.0,843.0,843.0
0.004,6,10,2007,5,928,1.0,660.0,660.0,5,1079,1.0,811.0,811.0
0.114,6,10,1506,5,395,21.0,127.0,127.0,5,1111,25.0,843.0,843.0
0.1,6,10,1506,5,395,22.0,127.0,127.0,5,1111,20.0,843.0,843.0
0.041,17,2,144,1,64,0.0,36.0,36.0,1,80,0.0,52.0,52.0
0.071,17,4,580,2,122,0.0,33.0,33.0,2,458,31.0,307.0,201.0
0.009,6,10,1972,5,910,2.0,642.0,642.0,5,1062,2.0,794.0,794.0
0.003,17,2,148,1,60,0.0,32.0,32.0,1,88,0.0,60.0,60.0
0.005,6,14,3736,7,446,0.0,74.0,74.0,7,3290,0.0,1448.0,972.0
0.125,6,10,1506,5,395,29.0,127.0,127.0,5,1111,29.0,843.0,843.0
0.015,6,10,1762,5,911,3.0,643.0,643.0,5,851,3.0,583.0,583.0
0.17,6,3,453,2,321,170.0,241.0,241.0,1,132,0.0,92.0,92.0
11.183,17,28,4421,14,1994,847.0,269.0,114.0,14,2427,847.0,586.0,145.0
40.05,17,10,676,5,460,10010.0,104.0,64.0,5,216,10011.0,20.0,15.0
0.007,6,10,1547,5,764,1.0,496.0,496.0,5,783,1.0,515.0,515.0
0.077,6,10,1506,5,395,16.0,127.0,127.0,5,1111,18.0,843.0,843.0
0.013,6,10,1762,5,911,3.0,643.0,643.0,5,851,3.0,583.0,583.0
0.006,6,10,1989,5,927,1.0,659.0,659.0,5,1062,1.0,794.0,794.0
0.011,6,10,1972,5,910,2.0,642.0,642.0,5,1062,2.0,794.0,794.0
0.069,17,8,3613,4,1874,23.0,1350.0,440.0,4,1739,11.0,1350.0,406.0
0.009,6,10,1762,5,911,2.0,643.0,643.0,5,851,2.0,583.0,583.0
40.066,17,10,676,5,460,10015.0,104.0,64.0,5,216,10015.0,20.0,15.0
0.013,6,10,1972,5,910,3.0,642.0,642.0,5,1062,3.0,794.0,794.0
0.014,6,10,1990,5,911,3.0,643.0,643.0,5,1079,3.0,811.0,811.0
0.038,17,2,182,1,65,0.0,37.0,37.0,1,117,0.0,89.0,89.0
0.019,6,10,1972,5,910,4.0,642.0,642.0,5,1062,4.0,794.0,794.0
0.09,6,10,1506,5,395,18.0,127.0,127.0,5,1111,21.0,843.0,843.0
0.005,17,2,164,1,74,0.0,46.0,46.0,1,90,0.0,62.0,62.0
0.005,6,14,3736,7,446,0.0,74.0,74.0,7,3290,0.0,1448.0,972.0
11.122,17,28,4421,14,1993,843.0,268.0,114.0,14,2428,843.0,587.0,145.0
0.008,6,12,1926,6,1189,1.0,659.0,434.0,6,737,1.0,417.0,417.0
0.092,6,10,1506,5,395,19.0,127.0,127.0,5,1111,17.0,843.0,843.0
0.026,17,2,152,1,56,0.0,28.0,28.0,1,96,0.0,68.0,68.0
40.094,17,10,676,5,460,10020.0,104.0,64.0,5,216,10021.0,20.0,15.0
0.006,6,10,1547,5,764,1.0,496.0,496.0,5,783,1.0,515.0,515.0
0.003,17,4,284,2,120,0.0,32.0,32.0,2,164,0.0,60.0,54.0
0.004,6,10,2000,5,927,1.0,659.0,659.0,5,1073,1.0,805.0,805.0
0.011,6,10,1990,5,911,2.0,643.0,643.0,5,1079,2.0,811.0,811.0
0.004,6,10,2007,5,928,1.0,660.0,660.0,5,1079,1.0,811.0,811.0
0.001,17,2,180,1,66,0.0,38.0,38.0,1,114,0.0,86.0,86.0
165.349,17,78,11183,39,2609,4351.0,44.0,38.0,39,8574,4351.0,239.0,191.0
0.005,6,10,2007,5,928,1.0,660.0,660.0,5,1079,1.0,811.0,811.0
0.071,17,4,284,2,120,0.0,32.0,32.0,2,164,34.0,60.0,54.0
0.212,6,16,2669,8,1395,30.0,533.0,323.0,8,1274,19.0,529.0,212.0
0.004,17,2,136,1,60,0.0,32.0,32.0,1,76,0.0,48.0,48.0
176.171,17,70,9961,35,2338,5181.0,44.0,38.0,35,7623,5181.0,239.0,189.0
0.006,17,2,164,1,74,0.0,46.0,46.0,1,90,0.0,62.0,62.0
0.007,6,10,2000,5,927,1.0,659.0,659.0,5,1073,1.0,805.0,805.0
0.004,6,10,2007,5,928,1.0,660.0,660.0,5,1079,1.0,811.0,811.0
0.01,6,10,1989,5,910,2.0,642.0,642.0,5,1079,2.0,811.0,811.0
0.005,6,10,2006,5,927,1.0,659.0,659.0,5,1079,1.0,811.0,811.0
0.035,6,10,1989,5,910,8.0,642.0,642.0,5,1079,8.0,811.0,811.0
0.014,17,2,152,1,56,0.0,28.0,28.0,1,96,0.0,68.0,68.0
0.12,6,10,1506,5,395,24.0,127.0,127.0,5,1111,26.0,843.0,843.0
0.013,6,10,1677,5,827,3.0,559.0,559.0,5,850,3.0,582.0,582.0
0.182,6,10,1506,5,395,36.0,127.0,127.0,5,1111,44.0,843.0,843.0
0.005,6,10,2006,5,927,1.0,659.0,659.0,5,1079,1.0,811.0,811.0
0.005,6,10,2000,5,927,1.0,659.0,659.0,5,1073,1.0,805.0,805.0
0.004,6,10,2006,5,927,1.0,659.0,659.0,5,1079,1.0,811.0,811.0
0.006,6,10,1689,5,839,1.0,571.0,571.0,5,850,1.0,582.0,582.0
0.011,6,10,1989,5,910,2.0,642.0,642.0,5,1079,2.0,811.0,811.0
0.138,6,10,1506,5,395,33.0,127.0,127.0,5,1111,30.0,843.0,843.0
0.011,6,10,1972,5,910,2.0,642.0,642.0,5,1062,2.0,794.0,794.0
0.005,6,14,3742,8,504,0.0,80.0,80.0,6,3238,1.0,1470.0,1459.0
0.097,6,10,1506,5,395,20.0,127.0,127.0,5,1111,20.0,843.0,843.0
99.27,58,5,360,4,288,33090.0,24.0,24.0,1,72,0.0,24.0,24.0
0.003,17,2,136,1,60,0.0,32.0,32.0,1,76,0.0,48.0,48.0
11.168,17,28,4423,14,1995,846.0,270.0,114.0,14,2428,846.0,587.0,145.0
0.008,6,12,1926,6,1189,1.0,659.0,434.0,6,737,1.0,417.0,417.0
0.01,6,10,1762,5,911,2.0,643.0,643.0,5,851,2.0,583.0,583.0
0.015,6,10,1762,5,911,3.0,643.0,643.0,5,851,3.0,583.0,583.0
0.004,6,10,2000,5,927,1.0,659.0,659.0,5,1073,1.0,805.0,805.0
0.001,17,2,180,1,65,0.0,37.0,37.0,1,115,0.0,87.0,87.0
0.004,6,10,1989,5,927,1.0,659.0,659.0,5,1062,1.0,794.0,794.0
11.13,17,28,4420,14,1993,844.0,268.0,114.0,14,2427,843.0,586.0,145.0
0.017,6,10,1989,5,910,4.0,642.0,642.0,5,1079,4.0,811.0,811.0
0.004,6,10,2006,5,927,1.0,659.0,659.0,5,1079,1.0,811.0,811.0
0.018,6,10,1983,5,910,4.0,642.0,642.0,5,1073,4.0,805.0,805.0
0.004,17,2,170,1,65,0.0,37.0,37.0,1,105,0.0,77.0,77.0
0.008,6,12,1926,6,1189,1.0,659.0,434.0,6,737,1.0,417.0,417.0
0.011,6,10,1983,5,910,2.0,642.0,642.0,5,1073,2.0,805.0,805.0
369.056,6,22,2313,16,867,24603.0,195.0,195.0,6,1446,4643.0,419.0,398.0
0.003,17,2,148,1,60,0.0,32.0,32.0,1,88,0.0,60.0,60.0
281.687,6,26,6195,12,1266,25607.0,267.0,156.0,14,4929,21661.0,1400.0,873.0
0.004,6,10,2006,5,927,1.0,659.0,659.0,5,1079,1.0,811.0,811.0
0.005,17,2,222,1,65,0.0,37.0,37.0,1,157,0.0,129.0,129.0
0.005,17,2,170,1,65,0.0,37.0,37.0,1,105,0.0,77.0,77.0
0.003,17,2,156,1,64,0.0,36.0,36.0,1,92,0.0,64.0,64.0
0.005,17,2,170,1,65,0.0,37.0,37.0,1,105,0.0,77.0,77.0
0.004,6,10,2006,5,927,1.0,659.0,659.0,5,1079,1.0,811.0,811.0
0.01,6,10,1972,5,910,2.0,642.0,642.0,5,1062,2.0,794.0,794.0
0.01,6,10,1990,5,911,2.0,643.0,643.0,5,1079,2.0,811.0,811.0
0.016,6,10,1972,5,910,4.0,642.0,642.0,5,1062,3.0,794.0,794.0
240.014,6,9,787,5,488,60003.0,232.0,232.0,4,299,80004.0,83.0,83.0
0.005,6,10,1989,5,927,1.0,659.0,659.0,5,1062,1.0,794.0,794.0
308.709,17,20,1124,10,716,34287.0,48.0,43.0,10,408,34287.0,20.0,12.0
0.005,6,10,2007,5,928,1.0,660.0,660.0,5,1079,1.0,811.0,811.0
0.017,6,13,3735,7,497,2.0,125.0,125.0,6,3238,3.0,1470.0,1459.0
0.001,17,2,180,1,66,0.0,38.0,38.0,1,114,0.0,86.0,86.0
0.005,6,10,2006,5,927,1.0,659.0,659.0,5,1079,1.0,811.0,811.0
0.018,6,10,1762,5,911,4.0,643.0,643.0,5,851,4.0,583.0,583.0
0.009,6,13,3735,7,497,1.0,125.0,125.0,6,3238,1.0,1470.0,1459.0
0.005,6,10,1689,5,839,1.0,571.0,571.0,5,850,1.0,582.0,582.0
0.016,6,10,1677,5,827,4.0,559.0,559.0,5,850,4.0,582.0,582.0
0.005,6,10,2006,5,927,1.0,659.0,659.0,5,1079,1.0,811.0,811.0
0.011,6,14,3787,7,497,1.0,125.0,125.0,7,3290,1.0,1448.0,972.0
11.171,17,28,4424,14,1995,846.0,270.0,114.0,14,2429,846.0,588.0,145.0
0.005,6,10,2000,5,927,1.0,659.0,659.0,5,1073,1.0,805.0,805.0
0.004,6,10,1989,5,927,1.0,659.0,659.0,5,1062,1.0,794.0,794.0
0.011,6,10,1989,5,910,2.0,642.0,642.0,5,1079,2.0,811.0,811.0
0.004,6,10,1989,5,927,1.0,659.0,659.0,5,1062,1.0,794.0,794.0
0.005,6,14,3736,7,446,0.0,74.0,74.0,7,3290,0.0,1448.0,972.0
10.807,17,26,4099,13,1847,891.0,270.0,114.0,13,2252,891.0,587.0,145.0
0.004,6,10,1779,5,928,1.0,660.0,660.0,5,851,1.0,583.0,583.0
0.008,6,10,1990,5,911,2.0,643.0,643.0,5,1079,2.0,811.0,811.0
0.005,17,2,180,1,66,0.0,38.0,38.0,1,114,0.0,86.0,86.0
264.136,17,18,1008,9,640,33002.0,48.0,43.0,9,368,33003.0,20.0,12.0
40.054,17,10,676,5,460,10012.0,104.0,64.0,5,216,10012.0,20.0,15.0
0.008,6,10,1990,5,911,2.0,643.0,643.0,5,1079,2.0,811.0,811.0
0.017,6,10,1631,5,848,4.0,580.0,580.0,5,783,4.0,515.0,515.0
0.071,17,8,3613,4,1874,23.0,1350.0,440.0,4,1739,12.0,1350.0,406.0
0.004,6,10,2006,5,927,1.0,659.0,659.0,5,1079,1.0,811.0,811.0
0.008,6,10,1989,5,927,1.0,659.0,659.0,5,1062,2.0,794.0,794.0
0.093,6,10,1506,5,395,19.0,127.0,127.0,5,1111,22.0,843.0,843.0
352.258,6,20,2210,6,1308,12003.0,494.0,494.0,14,902,27096.0,83.0,83.0
1729.211,6,60,4400,40,2740,44338.0,33.0,33.0,20,1660,91002.0,31.0,31.0
369.038,6,22,2313,16,867,24602.0,195.0,195.0,6,1446,4637.0,419.0,398.0
168.254,17,84,12142,42,2818,4103.0,44.0,39.0,42,9324,4103.0,239.0,194.0
361.843,6,21,1793,16,1030,24122.0,190.0,190.0,5,763,60011.0,462.0,247.0
0.086,6,10,1506,5,395,19.0,127.0,127.0,5,1111,18.0,843.0,843.0
0.005,6,10,2000,5,927,1.0,659.0,659.0,5,1073,1.0,805.0,805.0
0.005,17,2,193,1,71,0.0,43.0,43.0,1,122,0.0,94.0,94.0
0.005,6,10,1774,5,923,1.0,655.0,655.0,5,851,1.0,583.0,583.0
40.056,17,10,676,5,460,10012.0,104.0,64.0,5,216,10011.0,20.0,15.0
0.009,6,13,3735,7,497,1.0,125.0,125.0,6,3238,1.0,1470.0,1459.0
0.001,17,2,180,1,66,0.0,38.0,38.0,1,114,0.0,86.0,86.0
0.095,6,10,1506,5,395,21.0,127.0,127.0,5,1111,19.0,843.0,843.0
0.013,6,10,1989,5,927,3.0,659.0,659.0,5,1062,3.0,794.0,794.0
0.004,17,2,136,1,60,0.0,32.0,32.0,1,76,0.0,48.0,48.0
0.005,6,10,2000,5,927,1.0,659.0,659.0,5,1073,1.0,805.0,805.0
15.073,17,14,9190,8,6902,2149.0,1350.0,834.0,6,2288,3008.0,1350.0,353.0
0.005,6,10,2007,5,928,1.0,660.0,660.0,5,1079,1.0,811.0,811.0
0.072,17,2,412,1,61,0.0,33.0,33.0,1,351,0.0,323.0,323.0
0.018,6,10,1972,5,910,4.0,642.0,642.0,5,1062,4.0,794.0,794.0
0.001,17,2,180,1,66,0.0,38.0,38.0,1,114,0.0,86.0,86.0
1769.151,17,92,8096,46,4048,39313.0,60.0,60.0,46,4048,39314.0,60.0,60.0
0.07,6,10,1506,5,395,15.0,127.0,127.0,5,1111,15.0,843.0,843.0
0.05,6,10,1677,5,827,12.0,559.0,559.0,5,850,12.0,582.0,582.0
0.009,6,10,1989,5,910,2.0,642.0,642.0,5,1079,2.0,811.0,811.0
40.092,17,10,676,5,460,10016.0,104.0,64.0,5,216,10022.0,20.0,15.0
0.012,6,10,1631,5,848,3.0,580.0,580.0,5,783,2.0,515.0,515.0
0.007,6,10,1547,5,764,1.0,496.0,496.0,5,783,1.0,515.0,515.0
0.004,6,10,1702,5,863,1.0,595.0,595.0,5,839,1.0,571.0,571.0
0.004,17,2,136,1,60,0.0,32.0,32.0,1,76,0.0,48.0,48.0
0.011,6,10,1677,5,827,2.0,559.0,559.0,5,850,2.0,582.0,582.0
0.093,6,10,1506,5,395,19.0,127.0,127.0,5,1111,21.0,843.0,843.0
40.06,17,10,676,5,460,10013.0,104.0,64.0,5,216,10013.0,20.0,15.0
0.02,6,10,1989,5,910,4.0,642.0,642.0,5,1079,4.0,811.0,811.0
368.814,6,22,2313,16,867,24587.0,195.0,195.0,6,1446,4634.0,419.0,398.0
0.011,6,10,1990,5,911,2.0,643.0,643.0,5,1079,2.0,811.0,811.0
0.005,6,13,3747,7,509,0.0,137.0,137.0,6,3238,1.0,1470.0,1459.0
0.091,6,10,1506,5,395,19.0,127.0,127.0,5,1111,19.0,843.0,843.0
0.084,6,10,1506,5,395,20.0,127.0,127.0,5,1111,17.0,843.0,843.0
0.011,6,10,1972,5,910,2.0,642.0,642.0,5,1062,2.0,794.0,794.0
0.012,6,10,1972,5,910,3.0,642.0,642.0,5,1062,2.0,794.0,794.0
10.799,17,28,4421,14,1994,822.0,269.0,114.0,14,2427,822.0,586.0,145.0
0.005,6,10,2000,5,927,1.0,659.0,659.0,5,1073,1.0,805.0,805.0
0.007,17,2,179,1,71,0.0,43.0,43.0,1,108,0.0,80.0,80.0
0.012,6,10,1972,5,910,3.0,642.0,642.0,5,1062,3.0,794.0,794.0
0.027,6,10,1989,5,910,6.0,642.0,642.0,5,1079,6.0,811.0,811.0
10.735,17,26,4103,13,1823,885.0,270.0,112.0,13,2280,885.0,587.0,147.0
0.003,17,2,185,1,73,0.0,45.0,45.0,1,112,0.0,84.0,84.0
40.067,17,10,676,5,460,10012.0,104.0,64.0,5,216,10015.0,20.0,15.0
0.005,6,10,2006,5,927,1.0,659.0,659.0,5,1079,1.0,811.0,811.0
0.014,6,10,1972,5,910,3.0,642.0,642.0,5,1062,3.0,794.0,794.0
0.006,6,10,1854,5,889,1.0,621.0,621.0,5,965,1.0,697.0,697.0
0.095,6,10,1506,5,395,21.0,127.0,127.0,5,1111,22.0,843.0,843.0
40.074,17,10,676,5,460,10015.0,104.0,64.0,5,216,10017.0,20.0,15.0
0.006,6,10,1547,5,764,1.0,496.0,496.0,5,783,1.0,515.0,515.0
525.39,6,73,10345,45,7482,11940.0,302.0,302.0,28,2863,19458.0,83.0,83.0
0.001,17,2,180,1,66,0.0,38.0,38.0,1,114,0.0,86.0,86.0
0.033,6,10,1983,5,910,8.0,642.0,642.0,5,1073,8.0,805.0,805.0
0.006,6,10,1689,5,839,1.0,571.0,571.0,5,850,1.0,582.0,582.0
0.005,6,10,1774,5,923,1.0,655.0,655.0,5,851,1.0,583.0,583.0
40.059,17,10,676,5,460,10014.0,104.0,64.0,5,216,10014.0,20.0,15.0
240.501,6,37,9697,19,2176,13360.0,748.0,236.0,18,7521,14146.0,1402.0,599.0
0.008,6,10,1702,5,863,2.0,595.0,595.0,5,839,2.0,571.0,571.0
0.04,17,2,148,1,60,0.0,32.0,32.0,1,88,0.0,60.0,60.0
0.006,6,10,1547,5,764,1.0,496.0,496.0,5,783,1.0,515.0,515.0
0.013,6,10,1989,5,910,3.0,642.0,642.0,5,1079,3.0,811.0,811.0
0.006,6,10,1854,5,889,1.0,621.0,621.0,5,965,1.0,697.0,697.0
0.098,6,10,1506,5,395,18.0,127.0,127.0,5,1111,23.0,843.0,843.0
0.009,17,2,148,1,60,0.0,32.0,32.0,1,88,0.0,60.0,60.0
240.13,6,16,4481,9,963,30016.0,238.0,166.0,7,3518,40021.0,1402.0,786.0
0.005,17,2,166,1,75,0.0,47.0,47.0,1,91,0.0,63.0,63.0
0.005,17,2,170,1,65,0.0,37.0,37.0,1,105,0.0,77.0,77.0
0.004,17,2,136,1,60,0.0,32.0,32.0,1,76,0.0,48.0,48.0
0.001,17,2,136,1,60,0.0,32.0,32.0,1,76,0.0,48.0,48.0
10.818,17,28,4418,14,1994,823.0,269.0,114.0,14,2424,823.0,587.0,145.0
0.005,6,10,2006,5,927,1.0,659.0,659.0,5,1079,1.0,811.0,811.0
0.077,6,10,1506,5,395,18.0,127.0,127.0,5,1111,17.0,843.0,843.0
0.006,6,10,2006,5,927,1.0,659.0,659.0,5,1079,1.0,811.0,811.0
11.023,17,28,4418,14,1994,838.0,269.0,114.0,14,2424,838.0,587.0,145.0
11.507,17,28,4399,14,2313,872.0,588.0,137.0,14,2086,872.0,269.0,121.0
160.056,17,76,10680,38,2537,4325.0,44.0,38.0,38,8143,4325.0,239.0,186.0
0.001,17,2,180,1,66,0.0,38.0,38.0,1,114,0.0,86.0,86.0
0.004,17,2,136,1,60,0.0,32.0,32.0,1,76,0.0,48.0,48.0
0.04,17,2,152,1,76,0.0,48.0,48.0,1,76,0.0,48.0,48.0
0.005,17,2,170,1,65,0.0,37.0,37.0,1,105,0.0,77.0,77.0
0.006,6,10,1547,5,764,1.0,496.0,496.0,5,783,1.0,515.0,515.0
11.121,17,28,4423,14,1995,842.0,270.0,114.0,14,2428,842.0,587.0,145.0
40.058,17,10,676,5,460,10013.0,104.0,64.0,5,216,10013.0,20.0,15.0
0.008,6,10,1990,5,911,2.0,643.0,643.0,5,1079,1.0,811.0,811.0
0.039,17,4,284,2,120,1.0,32.0,32.0,2,164,36.0,60.0,54.0
0.148,17,4,352,2,130,109.0,37.0,37.0,2,222,144.0,89.0,83.0
0.005,17,2,136,1,60,0.0,32.0,32.0,1,76,0.0,48.0,48.0
0.223,6,16,2777,8,1395,31.0,533.0,323.0,8,1382,20.0,529.0,239.0
0.006,6,10,1643,5,860,1.0,592.0,592.0,5,783,1.0,515.0,515.0
0.005,6,10,1547,5,764,1.0,496.0,496.0,5,783,1.0,515.0,515.0
0.004,17,2,136,1,60,0.0,32.0,32.0,1,76,0.0,48.0,48.0
0.006,6,10,2006,5,927,1.0,659.0,659.0,5,1079,1.0,811.0,811.0
0.076,6,10,1506,5,395,13.0,127.0,127.0,5,1111,18.0,843.0,843.0
0.093,6,10,1506,5,395,22.0,127.0,127.0,5,1111,20.0,843.0,843.0
0.017,6,10,1972,5,910,4.0,642.0,642.0,5,1062,4.0,794.0,794.0
1770.304,6,83,4368,42,2210,43177.0,26.0,26.0,41,2158,44256.0,26.0,26.0
0.007,17,2,179,1,71,0.0,43.0,43.0,1,108,0.0,80.0,80.0
0.01,17,2,136,1,60,0.0,32.0,32.0,1,76,0.0,48.0,48.0
0.009,6,10,1972,5,910,2.0,642.0,642.0,5,1062,2.0,794.0,794.0
0.006,6,10,1989,5,910,1.0,642.0,642.0,5,1079,1.0,811.0,811.0
0.004,6,10,2006,5,927,1.0,659.0,659.0,5,1079,1.0,811.0,811.0
240.332,6,41,5110,19,2375,13351.0,588.0,197.0,22,2735,11444.0,580.0,197.0
0.008,6,10,1547,5,764,2.0,496.0,496.0,5,783,1.0,515.0,515.0
0.021,6,10,1762,5,911,5.0,643.0,643.0,5,851,5.0,583.0,583.0
0.004,6,10,2006,5,927,1.0,659.0,659.0,5,1079,1.0,811.0,811.0
354.064,6,21,1795,16,1030,23604.0,190.0,190.0,5,765,60001.0,464.0,248.0
10.932,17,28,4417,14,1993,831.0,268.0,114.0,14,2424,832.0,587.0,145.0
0.011,6,10,1989,5,910,2.0,642.0,642.0,5,1079,2.0,811.0,811.0
0.005,6,10,1989,5,927,1.0,659.0,659.0,5,1062,1.0,794.0,794.0
0.086,6,10,1506,5,395,18.0,127.0,127.0,5,1111,20.0,843.0,843.0
40.105,17,10,676,5,460,10025.0,104.0,64.0,5,216,10025.0,20.0,15.0
0.005,17,2,170,1,65,0.0,37.0,37.0,1,105,0.0,77.0,77.0
40.06,17,10,676,5,460,10014.0,104.0,64.0,5,216,10014.0,20.0,15.0
0.003,17,2,136,1,60,0.0,32.0,32.0,1,76,0.0,48.0,48.0
40.081,17,10,676,5,460,10019.0,104.0,64.0,5,216,10019.0,20.0,15.0
0.006,6,10,1547,5,764,1.0,496.0,496.0,5,783,1.0,515.0,515.0
0.005,6,10,1779,5,928,1.0,660.0,660.0,5,851,1.0,583.0,583.0
0.006,17,2,164,1,74,0.0,46.0,46.0,1,90,0.0,62.0,62.0
15.075,17,15,9239,8,6902,2149.0,1350.0,834.0,7,2337,2507.0,1350.0,305.0
0.016,6,10,1990,5,911,3.0,643.0,643.0,5,1079,3.0,811.0,811.0
0.01,17,4,284,2,120,0.0,32.0,32.0,2,164,0.0,60.0,54.0
0.154,6,10,1506,5,395,32.0,127.0,127.0,5,1111,29.0,843.0,843.0
0.126,6,10,1506,5,395,23.0,127.0,127.0,5,1111,26.0,843.0,843.0
0.203,6,16,2778,8,1396,29.0,533.0,324.0,8,1382,18.0,529.0,239.0
0.014,6,10,1972,5,910,3.0,642.0,642.0,5,1062,3.0,794.0,794.0
0.071,17,8,3613,4,1874,23.0,1350.0,440.0,4,1739,12.0,1350.0,406.0
40.063,17,10,676,5,460,10015.0,104.0,64.0,5,216,10014.0,20.0,15.0
0.005,17,2,230,1,68,0.0,40.0,40.0,1,162,0.0,134.0,134.0
0.004,6,10,1774,5,923,1.0,655.0,655.0,5,851,1.0,583.0,583.0
0.008,6,12,1698,6,863,1.0,327.0,271.0,6,835,1.0,515.0,515.0
0.004,6,10,1774,5,923,1.0,655.0,655.0,5,851,1.0,583.0,583.0
0.099,6,10,1506,5,395,23.0,127.0,127.0,5,1111,20.0,843.0,843.0
0.012,6,10,1762,5,911,3.0,643.0,643.0,5,851,2.0,583.0,583.0
0.127,17,2,80,1,32,0.0,4.0,4.0,1,48,0.0,20.0,20.0
0.006,6,10,1643,5,860,1.0,592.0,592.0,5,783,1.0,515.0,515.0
40.076,17,10,676,5,460,10016.0,104.0,64.0,5,216,10018.0,20.0,15.0
0.011,6,14,3787,7,497,1.0,125.0,125.0,7,3290,1.0,1448.0,972.0
0.009,6,10,1972,5,910,2.0,642.0,642.0,5,1062,2.0,794.0,794.0
0.228,6,16,2778,8,1396,32.0,533.0,324.0,8,1382,21.0,529.0,239.0
0.013,6,10,1973,5,911,3.0,643.0,643.0,5,1062,3.0,794.0,794.0
0.066,6,10,1506,5,395,14.0,127.0,127.0,5,1111,14.0,843.0,843.0
0.008,6,10,1990,5,911,2.0,643.0,643.0,5,1079,1.0,811.0,811.0
0.004,6,10,1989,5,927,1.0,659.0,659.0,5,1062,1.0,794.0,794.0
0.006,6,10,1547,5,764,1.0,496.0,496.0,5,783,1.0,515.0,515.0
266.366,6,33,9713,13,4309,22197.0,1368.0,725.0,20,5404,14019.0,1655.0,871.0
0.005,6,10,2006,5,927,1.0,659.0,659.0,5,1079,1.0,811.0,811.0
40.06,17,10,676,5,460,10014.0,104.0,64.0,5,216,10014.0,20.0,15.0
0.024,6,10,1762,5,911,5.0,643.0,643.0,5,851,5.0,583.0,583.0
0.005,6,10,1989,5,927,1.0,659.0,659.0,5,1062,1.0,794.0,794.0
0.02,6,10,1990,5,911,4.0,643.0,643.0,5,1079,5.0,811.0,811.0
0.087,6,10,1506,5,395,18.0,127.0,127.0,5,1111,19.0,843.0,843.0
40.06,17,10,676,5,460,10014.0,104.0,64.0,5,216,10014.0,20.0,15.0
240.093,6,16,4482,9,963,30011.0,238.0,166.0,7,3519,40014.0,1402.0,786.0
10.954,17,28,4419,14,1995,833.0,270.0,114.0,14,2424,833.0,587.0,145.0
240.015,6,9,787,5,488,60003.0,232.0,232.0,4,299,80002.0,83.0,83.0
0.005,17,2,170,1,65,0.0,37.0,37.0,1,105,0.0,77.0,77.0
0.039,17,2,144,1,64,0.0,36.0,36.0,1,80,0.0,52.0,52.0
0.051,17,2,144,1,64,0.0,36.0,36.0,1,80,0.0,52.0,52.0
0.997,6,12,3142,6,2099,150.0,1328.0,923.0,6,1043,149.0,791.0,791.0
0.109,6,10,1506,5,395,25.0,127.0,127.0,5,1111,24.0,843.0,843.0
0.005,6,10,1547,5,764,1.0,496.0,496.0,5,783,1.0,515.0,515.0
0.004,6,10,1774,5,923,1.0,655.0,655.0,5,851,1.0,583.0,583.0
0.01,6,10,1990,5,911,2.0,643.0,643.0,5,1079,2.0,811.0,811.0
0.109,6,10,1506,5,395,23.0,127.0,127.0,5,1111,23.0,843.0,843.0
0.018,6,10,1983,5,910,4.0,642.0,642.0,5,1073,4.0,805.0,805.0
0.012,6,10,1983,5,910,3.0,642.0,642.0,5,1073,3.0,805.0,805.0
0.003,17,4,284,2,120,0.0,32.0,32.0,2,164,0.0,60.0,54.0
0.001,17,2,136,1,60,0.0,32.0,32.0,1,76,0.0,48.0,48.0
0.012,6,10,2000,5,927,2.0,659.0,659.0,5,1073,3.0,805.0,805.0
0.012,6,10,1983,5,910,3.0,642.0,642.0,5,1073,3.0,805.0,805.0
0.005,17,2,212,1,74,0.0,46.0,46.0,1,138,0.0,110.0,110.0
0.005,6,10,1989,5,927,1.0,659.0,659.0,5,1062,1.0,794.0,794.0
0.005,6,10,2006,5,927,1.0,659.0,659.0,5,1079,1.0,811.0,811.0
0.005,6,10,2007,5,928,1.0,660.0,660.0,5,1079,1.0,811.0,811.0
240.012,6,9,787,5,488,60003.0,232.0,232.0,4,299,80002.0,83.0,83.0
0.005,17,2,136,1,60,0.0,32.0,32.0,1,76,0.0,48.0,48.0
40.055,17,10,676,5,460,10011.0,104.0,64.0,5,216,10012.0,20.0,15.0
0.004,6,10,2006,5,927,1.0,659.0,659.0,5,1079,1.0,811.0,811.0
0.002,17,2,180,1,66,0.0,38.0,38.0,1,114,0.0,86.0,86.0
15.207,17,39,20232,21,17026,758.0,1350.0,782.0,18,3206,892.0,1350.0,150.0
0.018,6,13,3735,7,497,2.0,125.0,125.0,6,3238,3.0,1470.0,1459.0
0.067,6,10,1506,5,395,15.0,127.0,127.0,5,1111,15.0,843.0,843.0
0.005,17,2,168,1,76,0.0,48.0,48.0,1,92,0.0,64.0,64.0
0.112,6,10,1506,5,395,27.0,127.0,127.0,5,1111,23.0,843.0,843.0
0.018,6,10,1983,5,910,4.0,642.0,642.0,5,1073,4.0,805.0,805.0
0.082,6,10,1506,5,395,18.0,127.0,127.0,5,1111,15.0,843.0,843.0
0.009,6,10,1677,5,827,2.0,559.0,559.0,5,850,2.0,582.0,582.0
0.005,17,2,169,1,62,0.0,34.0,34.0,1,107,0.0,79.0,79.0
0.01,6,10,1989,5,910,2.0,642.0,642.0,5,1079,2.0,811.0,811.0
0.004,6,10,1702,5,863,0.0,595.0,595.0,5,839,1.0,571.0,571.0
0.004,17,4,284,2,120,1.0,32.0,32.0,2,164,1.0,60.0,54.0
0.005,6,10,1989,5,927,1.0,659.0,659.0,5,1062,1.0,794.0,794.0
66.203,6,27,17600,15,9656,4728.0,2804.0,1478.0,12,7944,6003.0,2315.0,1218.0
240.237,6,43,5555,23,2606,10919.0,588.0,196.0,20,2949,12643.0,580.0,237.0
0.004,6,10,2000,5,927,1.0,659.0,659.0,5,1073,1.0,805.0,805.0
0.005,17,2,144,1,64,0.0,36.0,36.0,1,80,0.0,52.0,52.0
10.842,17,28,4418,14,1994,824.0,269.0,114.0,14,2424,824.0,587.0,145.0
0.014,6,10,1631,5,848,3.0,580.0,580.0,5,783,3.0,515.0,515.0
0.014,6,10,1990,5,911,3.0,643.0,643.0,5,1079,3.0,811.0,811.0
0.009,6,10,1989,5,910,2.0,642.0,642.0,5,1079,2.0,811.0,811.0
0.089,6,10,1506,5,395,19.0,127.0,127.0,5,1111,18.0,843.0,843.0
300.437,6,19,3081,11,1647,30043.0,517.0,266.0,8,1434,34342.0,821.0,336.0
0.011,6,10,1631,5,848,2.0,580.0,580.0,5,783,2.0,515.0,515.0
0.095,6,10,1506,5,395,19.0,127.0,127.0,5,1111,20.0,843.0,843.0
0.009,6,10,1972,5,910,2.0,642.0,642.0,5,1062,2.0,794.0,794.0
0.204,6,16,2777,8,1395,29.0,533.0,323.0,8,1382,18.0,529.0,239.0
9.037,17,6,376,5,280,2259.0,28.0,28.0,1,96,0.0,68.0,68.0
0.214,6,43,13592,19,8503,11.0,2893.0,748.0,24,5089,9.0,1428.0,383.0
0.005,6,10,2007,5,928,1.0,660.0,660.0,5,1079,1.0,811.0,811.0
0.006,6,10,1989,5,927,1.0,659.0,659.0,5,1062,1.0,794.0,794.0
0.005,6,10,2006,5,927,1.0,659.0,659.0,5,1079,1.0,811.0,811.0
0.109,6,10,1506,5,395,25.0,127.0,127.0,5,1111,26.0,843.0,843.0
0.005,6,10,1779,5,928,1.0,660.0,660.0,5,851,1.0,583.0,583.0
0.009,6,10,2006,5,927,2.0,659.0,659.0,5,1079,2.0,811.0,811.0
0.129,6,10,1506,5,395,28.0,127.0,127.0,5,1111,31.0,843.0,843.0
0.003,17,2,136,1,60,0.0,32.0,32.0,1,76,0.0,48.0,48.0
9.035,17,6,376,5,280,2258.0,28.0,28.0,1,96,0.0,68.0,68.0
15.072,17,14,9191,8,6902,2149.0,1350.0,834.0,6,2289,3008.0,1350.0,353.0
0.014,6,10,1972,5,910,3.0,642.0,642.0,5,1062,3.0,794.0,794.0
0.004,6,10,2000,5,927,1.0,659.0,659.0,5,1073,1.0,805.0,805.0
0.032,6,10,1989,5,910,7.0,642.0,642.0,5,1079,8.0,811.0,811.0
0.004,6,10,1702,5,863,1.0,595.0,595.0,5,839,1.0,571.0,571.0
0.085,6,10,1506,5,395,18.0,127.0,127.0,5,1111,16.0,843.0,843.0
0.009,6,10,1972,5,910,2.0,642.0,642.0,5,1062,2.0,794.0,794.0
66.09,6,27,18179,15,10237,4720.0,2804.0,1574.0,12,7942,5993.0,2313.0,1218.0
0.005,6,10,2006,5,927,1.0,659.0,659.0,5,1079,1.0,811.0,811.0
0.005,17,2,154,1,69,0.0,41.0,41.0,1,85,0.0,57.0,57.0
241.301,6,298,342468,115,17490,2116.0,2736.0,885.0,183,324978,1325.0,4206.0,1823.0
0.157,6,10,1506,5,395,34.0,127.0,127.0,5,1111,33.0,843.0,843.0
243.508,6,38,14995,20,2853,12814.0,663.0,361.0,18,12142,14322.0,1402.0,934.0
0.056,17,2,179,1,71,0.0,43.0,43.0,1,108,0.0,80.0,80.0
0.013,6,10,1989,5,910,3.0,642.0,642.0,5,1079,3.0,811.0,811.0
0.004,6,10,1779,5,928,1.0,660.0,660.0,5,851,1.0,583.0,583.0
0.005,17,2,169,1,62,0.0,34.0,34.0,1,107,0.0,79.0,79.0
354.051,6,21,1795,16,1030,23603.0,190.0,190.0,5,765,60003.0,464.0,248.0
0.003,17,2,148,1,60,0.0,32.0,32.0,1,88,0.0,60.0,60.0
0.006,17,2,214,1,75,0.0,47.0,47.0,1,139,0.0,111.0,111.0
10.88,17,28,4421,14,1994,827.0,269.0,114.0,14,2427,827.0,586.0,145.0
0.08,6,10,1506,5,395,18.0,127.0,127.0,5,1111,18.0,843.0,843.0
0.004,6,10,2006,5,927,1.0,659.0,659.0,5,1079,1.0,811.0,811.0
0.068,6,10,1506,5,395,15.0,127.0,127.0,5,1111,14.0,843.0,843.0
0.11,6,10,1506,5,395,24.0,127.0,127.0,5,1111,25.0,843.0,843.0
0.014,6,6,716,3,458,5.0,302.0,302.0,3,258,5.0,102.0,102.0
0.079,6,10,1506,5,395,16.0,127.0,127.0,5,1111,18.0,843.0,843.0
0.077,6,10,1506,5,395,17.0,127.0,127.0,5,1111,17.0,843.0,843.0
0.018,6,10,1983,5,910,4.0,642.0,642.0,5,1073,4.0,805.0,805.0
0.005,6,10,1989,5,927,1.0,659.0,659.0,5,1062,1.0,794.0,794.0
0.005,6,10,2006,5,927,1.0,659.0,659.0,5,1079,1.0,811.0,811.0
0.006,17,2,166,1,75,0.0,47.0,47.0,1,91,0.0,63.0,63.0
11.212,17,28,4390,14,2311,853.0,586.0,137.0,14,2079,853.0,270.0,120.0
40.076,17,10,676,5,460,10016.0,104.0,64.0,5,216,10018.0,20.0,15.0
0.006,6,10,1547,5,764,1.0,496.0,496.0,5,783,1.0,515.0,515.0
369.69,6,22,2313,16,867,24646.0,195.0,195.0,6,1446,4645.0,419.0,398.0
0.104,6,10,1506,5,395,21.0,127.0,127.0,5,1111,22.0,843.0,843.0
0.013,6,10,1989,5,910,3.0,642.0,642.0,5,1079,3.0,811.0,811.0
0.072,6,10,1506,5,395,16.0,127.0,127.0,5,1111,17.0,843.0,843.0
0.32,17,44,24845,24,19844,13.0,1350.0,798.0,20,5001,13.0,1350.0,222.0
0.042,17,4,596,2,122,0.0,33.0,33.0,2,474,39.0,323.0,209.0
0.091,6,10,1506,5,395,20.0,127.0,127.0,5,1111,20.0,843.0,843.0
0.006,17,2,132,1,58,0.0,30.0,30.0,1,74,0.0,46.0,46.0
0.062,6,10,1506,5,395,15.0,127.0,127.0,5,1111,14.0,843.0,843.0
0.004,6,10,2007,5,928,1.0,660.0,660.0,5,1079,1.0,811.0,811.0
0.005,6,10,2006,5,927,1.0,659.0,659.0,5,1079,1.0,811.0,811.0
0.011,6,10,1989,5,910,2.0,642.0,642.0,5,1079,2.0,811.0,811.0
0.005,17,2,170,1,65,0.0,37.0,37.0,1,105,0.0,77.0,77.0
0.006,6,10,2006,5,927,1.0,659.0,659.0,5,1079,1.0,811.0,811.0
0.089,6,10,1506,5,395,20.0,127.0,127.0,5,1111,20.0,843.0,843.0
0.005,17,2,144,1,64,0.0,36.0,36.0,1,80,0.0,52.0,52.0
0.069,6,10,1506,5,395,15.0,127.0,127.0,5,1111,15.0,843.0,843.0
0.005,6,10,2006,5,927,1.0,659.0,659.0,5,1079,1.0,811.0,811.0
0.024,6,10,1972,5,910,6.0,642.0,642.0,5,1062,5.0,794.0,794.0
0.018,6,13,3735,7,497,3.0,125.0,125.0,6,3238,3.0,1470.0,1459.0
0.011,6,10,1989,5,910,2.0,642.0,642.0,5,1079,2.0,811.0,811.0
0.005,6,10,2006,5,927,1.0,659.0,659.0,5,1079,1.0,811.0,811.0
38.866,17,25,14899,14,12082,2987.0,1350.0,835.0,11,2817,3883.0,1350.0,228.0
9.037,17,6,376,5,280,2259.0,28.0,28.0,1,96,0.0,68.0,68.0
0.017,6,10,1989,5,910,4.0,642.0,642.0,5,1079,4.0,811.0,811.0
0.021,6,13,3735,7,497,3.0,125.0,125.0,6,3238,4.0,1470.0,1459.0
0.102,6,10,1506,5,395,15.0,127.0,127.0,5,1111,24.0,843.0,843.0
0.004,17,2,148,1,60,0.0,32.0,32.0,1,88,0.0,60.0,60.0
0.074,6,10,1506,5,395,16.0,127.0,127.0,5,1111,17.0,843.0,843.0
10.828,17,26,4098,13,1847,893.0,270.0,114.0,13,2251,893.0,586.0,145.0
0.012,6,10,1990,5,911,3.0,643.0,643.0,5,1079,3.0,811.0,811.0
0.013,6,13,3735,7,497,2.0,125.0,125.0,6,3238,2.0,1470.0,1459.0
1742.66,6,300,97344,185,86223,9470.0,2001.0,690.0,115,11121,15286.0,452.0,70.0
176.151,17,78,11414,39,2614,4635.0,44.0,39.0,39,8800,4635.0,260.0,197.0
0.094,6,10,1506,5,395,20.0,127.0,127.0,5,1111,17.0,843.0,843.0
0.012,6,10,1990,5,911,3.0,643.0,643.0,5,1079,2.0,811.0,811.0
170.204,17,82,11447,41,2738,4254.0,44.0,38.0,41,8709,4254.0,239.0,184.0
0.006,17,2,278,1,77,0.0,49.0,49.0,1,201,0.0,173.0,173.0
0.124,6,10,1506,5,395,24.0,127.0,127.0,5,1111,28.0,843.0,843.0
0.006,6,10,1547,5,764,1.0,496.0,496.0,5,783,1.0,515.0,515.0
0.014,6,10,1989,5,910,3.0,642.0,642.0,5,1079,3.0,811.0,811.0
0.091,6,10,1506,5,395,19.0,127.0,127.0,5,1111,18.0,843.0,843.0
0.006,6,10,1547,5,764,1.0,496.0,496.0,5,783,1.0,515.0,515.0
0.108,6,10,1506,5,395,23.0,127.0,127.0,5,1111,20.0,843.0,843.0
0.006,6,10,1689,5,839,1.0,571.0,571.0,5,850,1.0,582.0,582.0
0.011,6,10,1989,5,910,2.0,642.0,642.0,5,1079,2.0,811.0,811.0
40.072,17,10,676,5,460,10017.0,104.0,64.0,5,216,10017.0,20.0,15.0
0.005,6,10,2006,5,927,1.0,659.0,659.0,5,1079,1.0,811.0,811.0
0.012,6,10,1972,5,910,2.0,642.0,642.0,5,1062,3.0,794.0,794.0
0.003,17,2,148,1,60,0.0,32.0,32.0,1,88,0.0,60.0,60.0
0.054,6,10,1506,5,395,12.0,127.0,127.0,5,1111,12.0,843.0,843.0
0.02,6,13,3735,7,497,3.0,125.0,125.0,6,3238,4.0,1470.0,1459.0
0.005,6,10,2007,5,928,1.0,660.0,660.0,5,1079,1.0,811.0,811.0
0.008,6,10,1983,5,910,2.0,642.0,642.0,5,1073,2.0,805.0,805.0
9.037,17,6,376,5,280,2259.0,28.0,28.0,1,96,0.0,68.0,68.0
0.01,6,12,1926,6,1189,2.0,659.0,434.0,6,737,2.0,417.0,417.0
0.009,6,12,1926,6,1189,1.0,659.0,434.0,6,737,1.0,417.0,417.0
0.001,17,2,164,1,74,0.0,46.0,46.0,1,90,0.0,62.0,62.0
0.005,6,10,2000,5,927,1.0,659.0,659.0,5,1073,1.0,805.0,805.0
0.009,6,10,1774,5,923,2.0,655.0,655.0,5,851,2.0,583.0,583.0
0.005,6,10,2000,5,927,1.0,659.0,659.0,5,1073,1.0,805.0,805.0
241.273,6,374,347444,184,21102,1318.0,2736.0,960.0,190,326342,1276.0,2935.0,1758.0
0.127,6,10,1506,5,395,29.0,127.0,127.0,5,1111,26.0,843.0,843.0
0.012,6,10,1762,5,911,3.0,643.0,643.0,5,851,3.0,583.0,583.0
0.005,17,2,136,1,60,0.0,32.0,32.0,1,76,0.0,48.0,48.0
0.005,6,10,2007,5,928,1.0,660.0,660.0,5,1079,1.0,811.0,811.0
0.004,6,10,2006,5,927,1.0,659.0,659.0,5,1079,1.0,811.0,811.0
0.005,17,2,179,1,71,0.0,43.0,43.0,1,108,0.0,80.0,80.0
0.006,6,10,2007,5,928,1.0,660.0,660.0,5,1079,1.0,811.0,811.0
0.081,6,10,1506,5,395,16.0,127.0,127.0,5,1111,18.0,843.0,843.0
0.005,6,10,2007,5,928,1.0,660.0,660.0,5,1079,1.0,811.0,811.0
0.078,6,10,1506,5,395,17.0,127.0,127.0,5,1111,18.0,843.0,843.0
0.006,6,10,1547,5,764,1.0,496.0,496.0,5,783,1.0,515.0,515.0
0.076,6,10,1506,5,395,16.0,127.0,127.0,5,1111,18.0,843.0,843.0
0.005,6,10,2006,5,927,1.0,659.0,659.0,5,1079,1.0,811.0,811.0
0.09,6,10,1506,5,395,19.0,127.0,127.0,5,1111,20.0,843.0,843.0
0.118,6,10,1506,5,395,28.0,127.0,127.0,5,1111,24.0,843.0,843.0
0.005,17,2,148,1,60,0.0,32.0,32.0,1,88,0.0,60.0,60.0
0.075,6,10,1506,5,395,17.0,127.0,127.0,5,1111,13.0,843.0,843.0
1796.274,6,287,27031,145,9908,12474.0,747.0,295.0,142,17123,12739.0,1625.0,72.0
0.02,6,10,1972,5,910,5.0,642.0,642.0,5,1062,5.0,794.0,794.0
40.069,17,10,676,5,460,10015.0,104.0,64.0,5,216,10016.0,20.0,15.0
40.054,17,10,676,5,460,10012.0,104.0,64.0,5,216,10012.0,20.0,15.0
240.288,6,41,8667,21,5686,12014.0,2883.0,573.0,20,2981,12646.0,580.0,241.0
0.001,17,2,180,1,66,0.0,38.0,38.0,1,114,0.0,86.0,86.0
0.005,17,2,166,1,75,0.0,47.0,47.0,1,91,0.0,63.0,63.0
0.169,6,3,453,2,321,169.0,241.0,241.0,1,132,0.0,92.0,92.0
0.072,6,10,1506,5,395,16.0,127.0,127.0,5,1111,15.0,843.0,843.0
0.126,6,10,1506,5,395,25.0,127.0,127.0,5,1111,28.0,843.0,843.0
0.005,6,10,2000,5,927,1.0,659.0,659.0,5,1073,1.0,805.0,805.0
0.018,6,10,1990,5,911,4.0,643.0,643.0,5,1079,4.0,811.0,811.0
0.004,6,10,2006,5,927,1.0,659.0,659.0,5,1079,1.0,811.0,811.0
0.004,6,10,1702,5,863,0.0,595.0,595.0,5,839,1.0,571.0,571.0
0.005,17,2,170,1,65,0.0,37.0,37.0,1,105,0.0,77.0,77.0
0.015,6,6,716,3,458,6.0,302.0,302.0,3,258,6.0,102.0,102.0
0.23,6,16,2777,8,1395,32.0,533.0,323.0,8,1382,21.0,529.0,239.0
0.065,6,10,1506,5,395,13.0,127.0,127.0,5,1111,15.0,843.0,843.0
0.005,6,10,2000,5,927,1.0,659.0,659.0,5,1073,1.0,805.0,805.0
0.001,17,2,180,1,66,0.0,38.0,38.0,1,114,0.0,86.0,86.0
0.005,6,10,1989,5,927,1.0,659.0,659.0,5,1062,1.0,794.0,794.0
40.08,17,10,676,5,460,10019.0,104.0,64.0,5,216,10019.0,20.0,15.0
0.038,17,4,284,2,120,0.0,32.0,32.0,2,164,35.0,60.0,54.0
0.013,6,10,1605,5,388,3.0,120.0,120.0,5,1217,3.0,949.0,949.0
0.011,6,10,1677,5,827,2.0,559.0,559.0,5,850,2.0,582.0,582.0
0.026,6,10,1990,5,911,6.0,643.0,643.0,5,1079,6.0,811.0,811.0
0.004,6,10,1702,5,863,0.0,595.0,595.0,5,839,1.0,571.0,571.0
0.016,6,10,1631,5,848,4.0,580.0,580.0,5,783,4.0,515.0,515.0
0.019,17,2,164,1,74,0.0,46.0,46.0,1,90,0.0,62.0,62.0
61.86,6,54,22508,27,16356,357.0,4080.0,1523.0,27,6152,2373.0,1360.0,337.0
0.005,6,10,2000,5,927,1.0,659.0,659.0,5,1073,1.0,805.0,805.0
0.005,6,10,1989,5,927,1.0,659.0,659.0,5,1062,1.0,794.0,794.0
375.572,6,33,8464,18,2675,22092.0,664.0,346.0,15,5789,22537.0,1402.0,555.0
0.012,6,10,1989,5,910,3.0,642.0,642.0,5,1079,3.0,811.0,811.0
0.039,17,2,152,1,76,0.0,48.0,48.0,1,76,0.0,48.0,48.0
0.089,6,10,1506,5,395,18.0,127.0,127.0,5,1111,19.0,843.0,843.0
0.009,6,10,1989,5,910,2.0,642.0,642.0,5,1079,2.0,811.0,811.0
0.012,6,10,1631,5,848,3.0,580.0,580.0,5,783,2.0,515.0,515.0
0.005,6,13,3747,7,509,0.0,137.0,137.0,6,3238,1.0,1470.0,1459.0
0.008,6,10,1989,5,910,1.0,642.0,642.0,5,1079,2.0,811.0,811.0
0.005,6,10,2006,5,927,1.0,659.0,659.0,5,1079,1.0,811.0,811.0
0.041,17,4,284,2,120,0.0,32.0,32.0,2,164,38.0,60.0,54.0
0.038,17,4,284,2,120,0.0,32.0,32.0,2,164,34.0,60.0,54.0
0.009,6,12,1926,6,1189,1.0,659.0,434.0,6,737,1.0,417.0,417.0
0.004,17,4,284,2,120,0.0,32.0,32.0,2,164,0.0,60.0,54.0
0.038,17,2,148,1,60,0.0,32.0,32.0,1,88,0.0,60.0,60.0
0.004,6,10,1774,5,923,1.0,655.0,655.0,5,851,1.0,583.0,583.0
0.013,6,10,1990,5,911,3.0,643.0,643.0,5,1079,3.0,811.0,811.0
0.016,6,10,1989,5,910,4.0,642.0,642.0,5,1079,4.0,811.0,811.0
0.073,6,10,1506,5,395,15.0,127.0,127.0,5,1111,16.0,843.0,843.0
0.236,17,4,596,2,122,196.0,33.0,33.0,2,474,108.0,323.0,209.0
0.098,6,10,1506,5,395,21.0,127.0,127.0,5,1111,22.0,843.0,843.0
174.497,17,84,12294,42,2828,4255.0,44.0,39.0,42,9466,4255.0,261.0,197.0
0.005,17,2,214,1,75,0.0,47.0,47.0,1,139,0.0,111.0,111.0
0.009,6,10,1989,5,910,2.0,642.0,642.0,5,1079,2.0,811.0,811.0
0.013,6,10,1983,5,910,3.0,642.0,642.0,5,1073,3.0,805.0,805.0
40.06,17,10,676,5,460,10014.0,104.0,64.0,5,216,10014.0,20.0,15.0
0.109,6,10,1506,5,395,23.0,127.0,127.0,5,1111,21.0,843.0,843.0
0.125,6,10,1506,5,395,30.0,127.0,127.0,5,1111,24.0,843.0,843.0
0.011,6,10,1990,5,911,2.0,643.0,643.0,5,1079,2.0,811.0,811.0
175.421,17,72,10334,36,2402,5011.0,44.0,38.0,36,7932,5011.0,239.0,192.0
0.001,17,2,180,1,66,0.0,38.0,38.0,1,114,0.0,86.0,86.0
10.749,17,28,4422,14,1994,818.0,269.0,114.0,14,2428,818.0,587.0,145.0
0.001,17,2,180,1,66,0.0,38.0,38.0,1,114,0.0,86.0,86.0
0.169,17,2,152,1,76,0.0,48.0,48.0,1,76,0.0,48.0,48.0
0.115,6,10,1506,5,395,25.0,127.0,127.0,5,1111,26.0,843.0,843.0
0.004,6,10,1779,5,928,1.0,660.0,660.0,5,851,1.0,583.0,583.0
0.013,6,10,1989,5,910,3.0,642.0,642.0,5,1079,3.0,811.0,811.0
0.018,6,10,1972,5,910,4.0,642.0,642.0,5,1062,4.0,794.0,794.0
0.005,6,10,2006,5,927,1.0,659.0,659.0,5,1079,1.0,811.0,811.0
0.08,6,10,1506,5,395,17.0,127.0,127.0,5,1111,16.0,843.0,843.0
0.045,6,10,1989,5,910,11.0,642.0,642.0,5,1079,11.0,811.0,811.0
0.004,6,10,2006,5,927,1.0,659.0,659.0,5,1079,1.0,811.0,811.0
0.007,6,10,1547,5,764,1.0,496.0,496.0,5,783,1.0,515.0,515.0
178.179,17,80,11368,40,2668,4568.0,44.0,38.0,40,8700,4568.0,239.0,189.0
0.004,17,2,136,1,60,0.0,32.0,32.0,1,76,0.0,48.0,48.0
0.099,6,10,1506,5,395,19.0,127.0,127.0,5,1111,22.0,843.0,843.0
0.082,6,10,1506,5,395,19.0,127.0,127.0,5,1111,17.0,843.0,843.0
0.006,17,2,169,1,62,0.0,34.0,34.0,1,107,0.0,79.0,79.0
0.005,6,10,2006,5,927,1.0,659.0,659.0,5,1079,1.0,811.0,811.0
0.01,6,10,1631,5,848,2.0,580.0,580.0,5,783,2.0,515.0,515.0
11.385,17,28,4418,14,1994,863.0,269.0,114.0,14,2424,863.0,587.0,145.0
0.31,17,2,152,1,76,0.0,48.0,48.0,1,76,0.0,48.0,48.0
0.011,6,13,3735,7,497,1.0,125.0,125.0,6,3238,2.0,1470.0,1459.0
0.058,6,10,1506,5,395,13.0,127.0,127.0,5,1111,11.0,843.0,843.0
10.848,17,28,4420,14,1995,826.0,270.0,114.0,14,2425,825.0,588.0,145.0
0.006,6,10,1854,5,889,1.0,621.0,621.0,5,965,1.0,697.0,697.0
0.018,6,10,1989,5,910,4.0,642.0,642.0,5,1079,4.0,811.0,811.0
0.005,6,10,1989,5,927,1.0,659.0,659.0,5,1062,1.0,794.0,794.0
40.063,17,10,676,5,460,10012.0,104.0,64.0,5,216,10014.0,20.0,15.0
0.002,17,2,174,1,72,0.0,44.0,44.0,1,102,0.0,74.0,74.0
0.009,6,10,1990,5,911,2.0,643.0,643.0,5,1079,2.0,811.0,811.0
0.016,6,10,1983,5,910,4.0,642.0,642.0,5,1073,3.0,805.0,805.0
241.17,6,309,342958,122,17854,1993.0,2736.0,959.0,187,325104,1296.0,2804.0,1781.0
293.098,6,397,348865,193,21603,1526.0,2736.0,889.0,204,327262,1443.0,2933.0,1666.0
0.01,6,10,1989,5,910,2.0,642.0,642.0,5,1079,2.0,811.0,811.0
11.548,17,28,4398,14,2313,875.0,588.0,137.0,14,2085,875.0,268.0,120.0
0.004,17,2,136,1,60,0.0,32.0,32.0,1,76,0.0,48.0,48.0
0.008,6,10,1983,5,910,1.0,642.0,642.0,5,1073,2.0,805.0,805.0
322.904,17,20,1124,10,716,35864.0,48.0,43.0,10,408,35864.0,20.0,12.0
0.019,6,10,1631,5,848,4.0,580.0,580.0,5,783,4.0,515.0,515.0
0.005,6,10,1989,5,927,1.0,659.0,659.0,5,1062,1.0,794.0,794.0
0.006,6,10,1547,5,764,1.0,496.0,496.0,5,783,1.0,515.0,515.0
0.005,6,10,1689,5,839,1.0,571.0,571.0,5,850,1.0,582.0,582.0
0.004,6,10,1989,5,927,1.0,659.0,659.0,5,1062,1.0,794.0,794.0
40.069,17,10,676,5,460,10014.0,104.0,64.0,5,216,10016.0,20.0,15.0
0.004,17,2,136,1,60,0.0,32.0,32.0,1,76,0.0,48.0,48.0
0.008,6,10,1989,5,910,2.0,642.0,642.0,5,1079,1.0,811.0,811.0
0.005,6,10,2007,5,928,1.0,660.0,660.0,5,1079,1.0,811.0,811.0
0.075,6,10,1506,5,395,15.0,127.0,127.0,5,1111,17.0,843.0,843.0
0.009,6,10,1989,5,910,2.0,642.0,642.0,5,1079,2.0,811.0,811.0
0.112,6,10,1506,5,395,26.0,127.0,127.0,5,1111,25.0,843.0,843.0
63.527,6,22,8496,12,2236,72.0,1345.0,574.0,10,6260,7040.0,2720.0,974.0
0.094,6,10,1506,5,395,21.0,127.0,127.0,5,1111,20.0,843.0,843.0
0.078,6,10,1506,5,395,17.0,127.0,127.0,5,1111,15.0,843.0,843.0
0.008,6,10,2006,5,927,1.0,659.0,659.0,5,1079,2.0,811.0,811.0
0.132,6,10,1506,5,395,31.0,127.0,127.0,5,1111,32.0,843.0,843.0
0.113,6,10,1506,5,395,26.0,127.0,127.0,5,1111,25.0,843.0,843.0
0.023,6,10,1631,5,848,5.0,580.0,580.0,5,783,5.0,515.0,515.0
0.005,17,2,168,1,76,0.0,48.0,48.0,1,92,0.0,64.0,64.0
0.068,6,10,1506,5,395,15.0,127.0,127.0,5,1111,15.0,843.0,843.0
0.009,6,10,1972,5,910,2.0,642.0,642.0,5,1062,2.0,794.0,794.0
0.003,17,2,234,1,61,0.0,33.0,33.0,1,173,0.0,145.0,145.0
0.005,6,10,1779,5,928,1.0,660.0,660.0,5,851,1.0,583.0,583.0
0.005,6,10,2006,5,927,1.0,659.0,659.0,5,1079,1.0,811.0,811.0
0.004,6,10,1989,5,927,1.0,659.0,659.0,5,1062,1.0,794.0,794.0
0.001,17,2,166,1,75,0.0,47.0,47.0,1,91,0.0,63.0,63.0
0.004,17,2,136,1,60,0.0,32.0,32.0,1,76,0.0,48.0,48.0
0.005,6,10,1989,5,927,1.0,659.0,659.0,5,1062,1.0,794.0,794.0
40.053,17,10,676,5,460,10012.0,104.0,64.0,5,216,10012.0,20.0,15.0
0.005,6,10,2006,5,927,1.0,659.0,659.0,5,1079,1.0,811.0,811.0
0.001,17,2,180,1,66,0.0,38.0,38.0,1,114,0.0,86.0,86.0
40.077,17,10,676,5,460,10016.0,104.0,64.0,5,216,10018.0,20.0,15.0
0.006,6,10,2000,5,927,1.0,659.0,659.0,5,1073,1.0,805.0,805.0
40.062,17,10,676,5,460,10014.0,104.0,64.0,5,216,10014.0,20.0,15.0
0.003,17,2,136,1,60,0.0,32.0,32.0,1,76,0.0,48.0,48.0
0.01,6,10,1990,5,911,2.0,643.0,643.0,5,1079,2.0,811.0,811.0
0.001,17,2,136,1,60,0.0,32.0,32.0,1,76,0.0,48.0,48.0
0.087,6,10,1506,5,395,19.0,127.0,127.0,5,1111,17.0,843.0,843.0
352.646,6,20,2210,6,1308,12003.0,494.0,494.0,14,902,27126.0,83.0,83.0
0.015,6,10,1677,5,827,3.0,559.0,559.0,5,850,3.0,582.0,582.0
0.001,17,2,136,1,60,0.0,32.0,32.0,1,76,0.0,48.0,48.0
0.011,6,10,1990,5,911,2.0,643.0,643.0,5,1079,2.0,811.0,811.0
10.998,17,29,4566,15,2166,777.0,269.0,116.0,14,2400,837.0,587.0,143.0
0.005,6,10,2006,5,927,1.0,659.0,659.0,5,1079,1.0,811.0,811.0
0.087,6,10,1506,5,395,21.0,127.0,127.0,5,1111,21.0,843.0,843.0
0.02,6,10,1990,5,911,5.0,643.0,643.0,5,1079,4.0,811.0,811.0
0.02,6,10,1983,5,910,4.0,642.0,642.0,5,1073,4.0,805.0,805.0
0.127,6,10,1506,5,395,28.0,127.0,127.0,5,1111,27.0,843.0,843.0
0.069,17,8,3613,4,1874,23.0,1350.0,440.0,4,1739,11.0,1350.0,406.0
0.007,6,10,1547,5,764,1.0,496.0,496.0,5,783,1.0,515.0,515.0
15.077,17,14,8756,8,6624,2149.0,1350.0,800.0,6,2132,3009.0,1350.0,327.0
0.013,6,10,1989,5,910,3.0,642.0,642.0,5,1079,3.0,811.0,811.0
0.071,6,10,1506,5,395,16.0,127.0,127.0,5,1111,16.0,843.0,843.0
0.005,6,14,3799,7,509,0.0,137.0,137.0,7,3290,0.0,1448.0,972.0
253.567,6,38,9619,15,6457,18111.0,1580.0,631.0,23,3162,11525.0,580.0,139.0
352.285,6,20,2210,6,1308,12003.0,494.0,494.0,14,902,27098.0,83.0,83.0
15.173,17,20,11125,10,7477,1682.0,1350.0,719.0,10,3648,1682.0,1350.0,336.0
0.011,6,10,1972,5,910,2.0,642.0,642.0,5,1062,2.0,794.0,794.0
0.009,6,10,1983,5,910,2.0,642.0,642.0,5,1073,2.0,805.0,805.0
0.01,6,10,1989,5,910,2.0,642.0,642.0,5,1079,2.0,811.0,811.0
0.01,6,10,1631,5,848,2.0,580.0,580.0,5,783,2.0,515.0,515.0
0.07,6,10,1506,5,395,14.0,127.0,127.0,5,1111,14.0,843.0,843.0
0.004,6,10,1702,5,863,1.0,595.0,595.0,5,839,1.0,571.0,571.0
1.156,6,31,13352,17,5853,72.0,2720.0,854.0,14,7499,76.0,2720.0,769.0
0.001,17,2,192,1,71,0.0,43.0,43.0,1,121,0.0,93.0,93.0
0.009,6,10,1990,5,911,2.0,643.0,643.0,5,1079,2.0,811.0,811.0
0.078,6,10,1506,5,395,15.0,127.0,127.0,5,1111,18.0,843.0,843.0
0.005,6,10,2006,5,927,1.0,659.0,659.0,5,1079,1.0,811.0,811.0
0.006,6,10,1854,5,889,1.0,621.0,621.0,5,965,1.0,697.0,697.0
0.005,6,10,2006,5,927,1.0,659.0,659.0,5,1079,1.0,811.0,811.0
0.045,17,2,144,1,64,0.0,36.0,36.0,1,80,0.0,52.0,52.0
0.02,6,10,1983,5,910,5.0,642.0,642.0,5,1073,5.0,805.0,805.0
0.025,6,10,1990,5,911,6.0,643.0,643.0,5,1079,6.0,811.0,811.0
0.084,6,10,1506,5,395,19.0,127.0,127.0,5,1111,18.0,843.0,843.0
0.005,17,2,179,1,71,0.0,43.0,43.0,1,108,0.0,80.0,80.0
0.009,6,10,1989,5,910,2.0,642.0,642.0,5,1079,2.0,811.0,811.0
246.542,6,14,1059,4,448,3.0,232.0,232.0,10,611,27393.0,83.0,83.0
0.129,17,2,80,1,32,0.0,4.0,4.0,1,48,0.0,20.0,20.0
0.013,6,10,1990,5,911,3.0,643.0,643.0,5,1079,3.0,811.0,811.0
40.064,17,10,676,5,460,10014.0,104.0,64.0,5,216,10015.0,20.0,15.0
0.015,6,10,1631,5,848,3.0,580.0,580.0,5,783,3.0,515.0,515.0
0.069,6,10,1506,5,395,16.0,127.0,127.0,5,1111,16.0,843.0,843.0
0.01,6,12,1926,6,1189,2.0,659.0,434.0,6,737,1.0,417.0,417.0
0.1,6,10,1506,5,395,21.0,127.0,127.0,5,1111,23.0,843.0,843.0
0.008,6,10,1972,5,910,2.0,642.0,642.0,5,1062,2.0,794.0,794.0
0.009,6,13,3735,7,497,1.0,125.0,125.0,6,3238,1.0,1470.0,1459.0
0.008,6,10,1972,5,910,2.0,642.0,642.0,5,1062,1.0,794.0,794.0
0.005,17,2,179,1,71,0.0,43.0,43.0,1,108,0.0,80.0,80.0
0.013,6,10,1631,5,848,3.0,580.0,580.0,5,783,3.0,515.0,515.0
240.185,6,45,6511,22,3227,11437.0,588.0,230.0,23,3284,10916.0,580.0,208.0
0.007,6,10,1972,5,910,1.0,642.0,642.0,5,1062,1.0,794.0,794.0
0.04,17,2,128,1,56,0.0,28.0,28.0,1,72,0.0,44.0,44.0
0.066,17,8,3613,4,1874,22.0,1350.0,440.0,4,1739,11.0,1350.0,406.0
0.011,6,10,1983,5,910,2.0,642.0,642.0,5,1073,2.0,805.0,805.0
0.029,6,10,1972,5,910,7.0,642.0,642.0,5,1062,7.0,794.0,794.0
0.004,17,4,284,2,120,0.0,32.0,32.0,2,164,0.0,60.0,54.0
15.075,17,15,9239,8,6902,2149.0,1350.0,834.0,7,2337,2507.0,1350.0,305.0
0.001,17,2,180,1,66,0.0,38.0,38.0,1,114,0.0,86.0,86.0
240.111,6,16,4480,9,963,30013.0,238.0,166.0,7,3517,40018.0,1402.0,786.0
0.085,6,10,1506,5,395,19.0,127.0,127.0,5,1111,17.0,843.0,843.0
21.381,6,45,17745,22,11798,433.0,2720.0,1555.0,23,5947,964.0,2667.0,385.0
0.084,6,10,1506,5,395,20.0,127.0,127.0,5,1111,14.0,843.0,843.0
22.685,17,44,7496,22,3534,1072.0,588.0,132.0,22,3962,1072.0,588.0,152.0
0.075,6,10,1506,5,395,16.0,127.0,127.0,5,1111,15.0,843.0,843.0
0.005,6,10,2007,5,928,1.0,660.0,660.0,5,1079,1.0,811.0,811.0
240.024,6,9,787,5,488,60006.0,232.0,232.0,4,299,80007.0,83.0,83.0
0.09,6,10,1506,5,395,16.0,127.0,127.0,5,1111,20.0,843.0,843.0
0.119,6,10,1506,5,395,27.0,127.0,127.0,5,1111,26.0,843.0,843.0
0.006,6,10,1547,5,764,1.0,496.0,496.0,5,783,1.0,515.0,515.0
300.022,6,12,1782,7,1348,50003.0,494.0,494.0,5,434,75004.0,83.0,83.0
0.039,17,2,136,1,60,0.0,32.0,32.0,1,76,0.0,48.0,48.0
0.091,6,10,1506,5,395,21.0,127.0,127.0,5,1111,20.0,843.0,843.0
0.008,6,12,1926,6,1189,1.0,659.0,434.0,6,737,1.0,417.0,417.0
0.005,6,10,2006,5,927,1.0,659.0,659.0,5,1079,1.0,811.0,811.0
0.004,6,10,1774,5,923,1.0,655.0,655.0,5,851,1.0,583.0,583.0
0.005,17,2,212,1,74,0.0,46.0,46.0,1,138,0.0,110.0,110.0
0.015,6,10,1762,5,911,3.0,643.0,643.0,5,851,3.0,583.0,583.0
10.756,17,28,4417,14,1994,818.0,269.0,114.0,14,2423,818.0,586.0,145.0
0.008,17,2,193,1,71,0.0,43.0,43.0,1,122,0.0,94.0,94.0
174.061,17,82,11948,41,2755,4351.0,44.0,39.0,41,9193,4351.0,252.0,196.0
0.091,6,10,1506,5,395,20.0,127.0,127.0,5,1111,18.0,843.0,843.0
1770.186,6,84,4422,42,2211,43174.0,27.0,27.0,42,2211,43174.0,27.0,27.0
0.004,6,10,2007,5,928,1.0,660.0,660.0,5,1079,1.0,811.0,811.0
0.135,6,10,1506,5,395,31.0,127.0,127.0,5,1111,23.0,843.0,843.0
10.813,17,28,4420,14,1993,823.0,268.0,114.0,14,2427,823.0,586.0,145.0
0.163,17,2,152,1,76,0.0,48.0,48.0,1,76,0.0,48.0,48.0
0.004,6,10,1989,5,927,1.0,659.0,659.0,5,1062,1.0,794.0,794.0
0.015,6,10,1677,5,827,3.0,559.0,559.0,5,850,3.0,582.0,582.0
0.004,6,10,2007,5,928,1.0,660.0,660.0,5,1079,1.0,811.0,811.0
0.102,6,10,1506,5,395,22.0,127.0,127.0,5,1111,24.0,843.0,843.0
0.007,17,2,179,1,71,0.0,43.0,43.0,1,108,0.0,80.0,80.0
0.003,17,2,148,1,60,0.0,32.0,32.0,1,88,0.0,60.0,60.0
0.006,6,10,2000,5,927,1.0,659.0,659.0,5,1073,1.0,805.0,805.0
0.072,17,2,148,1,60,0.0,32.0,32.0,1,88,0.0,60.0,60.0
0.009,6,12,1926,6,1189,1.0,659.0,434.0,6,737,1.0,417.0,417.0
0.014,6,10,1990,5,911,3.0,643.0,643.0,5,1079,3.0,811.0,811.0
40.051,17,10,676,5,460,10012.0,104.0,64.0,5,216,10011.0,20.0,15.0
0.012,17,2,148,1,60,0.0,32.0,32.0,1,88,0.0,60.0,60.0
0.113,6,10,1506,5,395,25.0,127.0,127.0,5,1111,25.0,843.0,843.0
0.011,6,10,1677,5,827,2.0,559.0,559.0,5,850,2.0,582.0,582.0
0.067,6,10,1506,5,395,14.0,127.0,127.0,5,1111,16.0,843.0,843.0
165.09,17,88,12934,44,2962,3839.0,44.0,39.0,44,9972,3839.0,239.0,198.0
0.013,6,10,1631,5,848,3.0,580.0,580.0,5,783,3.0,515.0,515.0
0.124,6,14,4388,8,923,17.0,238.0,166.0,6,3465,16.0,1402.0,786.0
0.027,6,10,1989,5,910,6.0,642.0,642.0,5,1079,6.0,811.0,811.0
0.011,6,13,3735,7,497,1.0,125.0,125.0,6,3238,2.0,1470.0,1459.0
22.969,6,45,18358,22,12411,430.0,3242.0,1642.0,23,5947,1036.0,2667.0,385.0
0.005,6,10,2006,5,927,1.0,659.0,659.0,5,1079,1.0,811.0,811.0
34.54,6,51,22513,25,16446,385.0,2720.0,1541.0,26,6067,1375.0,2667.0,385.0
0.004,17,2,166,1,75,0.0,47.0,47.0,1,91,0.0,63.0,63.0
0.02,6,10,1677,5,827,5.0,559.0,559.0,5,850,4.0,582.0,582.0
0.038,17,2,148,1,60,0.0,32.0,32.0,1,88,0.0,60.0,60.0
0.006,6,10,1854,5,889,1.0,621.0,621.0,5,965,1.0,697.0,697.0
40.056,17,10,676,5,460,10013.0,104.0,64.0,5,216,10013.0,20.0,15.0
0.012,6,10,1989,5,910,2.0,642.0,642.0,5,1079,3.0,811.0,811.0
0.071,17,4,364,2,160,0.0,52.0,52.0,2,204,34.0,80.0,74.0
0.005,17,2,214,1,75,0.0,47.0,47.0,1,139,0.0,111.0,111.0
0.011,6,10,1990,5,911,2.0,643.0,643.0,5,1079,2.0,811.0,811.0
0.008,6,10,1983,5,910,2.0,642.0,642.0,5,1073,2.0,805.0,805.0
0.005,17,2,136,1,60,0.0,32.0,32.0,1,76,0.0,48.0,48.0
0.014,6,10,1989,5,910,3.0,642.0,642.0,5,1079,3.0,811.0,811.0
0.009,6,10,1983,5,910,2.0,642.0,642.0,5,1073,2.0,805.0,805.0
0.073,6,10,1506,5,395,15.0,127.0,127.0,5,1111,17.0,843.0,843.0
240.095,6,16,4482,9,963,30011.0,238.0,166.0,7,3519,40015.0,1402.0,786.0
0.004,17,4,284,2,120,2.0,32.0,32.0,2,164,1.0,60.0,54.0
0.014,6,10,1990,5,911,3.0,643.0,643.0,5,1079,3.0,811.0,811.0
0.005,6,10,2006,5,927,1.0,659.0,659.0,5,1079,1.0,811.0,811.0
240.017,6,9,787,5,488,60004.0,232.0,232.0,4,299,80005.0,83.0,83.0
0.061,17,2,80,1,32,0.0,4.0,4.0,1,48,0.0,20.0,20.0
0.004,6,10,1774,5,923,1.0,655.0,655.0,5,851,1.0,583.0,583.0
0.006,6,10,1547,5,764,1.0,496.0,496.0,5,783,1.0,515.0,515.0
0.003,17,2,136,1,60,0.0,32.0,32.0,1,76,0.0,48.0,48.0
0.004,17,4,284,2,120,0.0,32.0,32.0,2,164,1.0,60.0,54.0
0.297,17,47,29312,28,24881,11.0,1350.0,860.0,19,4431,13.0,1350.0,205.0
0.071,6,10,1506,5,395,16.0,127.0,127.0,5,1111,16.0,843.0,843.0
0.005,17,2,168,1,76,0.0,48.0,48.0,1,92,0.0,64.0,64.0
0.004,17,2,179,1,71,0.0,43.0,43.0,1,108,0.0,80.0,80.0
0.091,6,10,1506,5,395,21.0,127.0,127.0,5,1111,18.0,843.0,843.0
0.011,6,10,1972,5,910,2.0,642.0,642.0,5,1062,2.0,794.0,794.0
11.029,17,28,4421,14,1994,839.0,269.0,114.0,14,2427,839.0,586.0,145.0
0.009,6,10,1989,5,910,2.0,642.0,642.0,5,1079,2.0,811.0,811.0
0.015,6,10,1989,5,910,3.0,642.0,642.0,5,1079,3.0,811.0,811.0
0.006,6,10,1854,5,889,1.0,621.0,621.0,5,965,1.0,697.0,697.0
0.005,6,10,2000,5,927,1.0,659.0,659.0,5,1073,1.0,805.0,805.0
0.037,17,4,596,2,122,1.0,33.0,33.0,2,474,33.0,323.0,209.0
0.012,6,10,1990,5,911,3.0,643.0,643.0,5,1079,3.0,811.0,811.0
0.042,17,2,166,1,75,0.0,47.0,47.0,1,91,0.0,63.0,63.0
280.889,6,36,9705,19,4227,15604.0,1754.0,858.0,17,5478,542.0,2667.0,435.0
0.005,6,10,1689,5,839,1.0,571.0,571.0,5,850,1.0,582.0,582.0
1726.85,6,102,6114,58,3421,30294.0,27.0,27.0,44,2693,40158.0,27.0,27.0
40.083,17,10,676,5,460,10018.0,104.0,64.0,5,216,10020.0,20.0,15.0
0.005,6,13,3747,7,509,0.0,137.0,137.0,6,3238,0.0,1470.0,1459.0
0.012,6,10,1989,5,910,3.0,642.0,642.0,5,1079,3.0,811.0,811.0
11.075,6,24,7517,13,1385,922.0,530.0,277.0,11,6132,1088.0,2720.0,946.0
0.069,6,10,1506,5,395,14.0,127.0,127.0,5,1111,14.0,843.0,843.0
0.006,6,10,2006,5,927,1.0,659.0,659.0,5,1079,1.0,811.0,811.0
0.111,6,10,1506,5,395,25.0,127.0,127.0,5,1111,25.0,843.0,843.0
0.055,6,10,1989,5,910,13.0,642.0,642.0,5,1079,13.0,811.0,811.0
0.005,6,10,1643,5,860,1.0,592.0,592.0,5,783,1.0,515.0,515.0
0.095,6,10,1506,5,395,22.0,127.0,127.0,5,1111,18.0,843.0,843.0
0.128,6,10,1506,5,395,29.0,127.0,127.0,5,1111,31.0,843.0,843.0
0.001,17,2,180,1,66,0.0,38.0,38.0,1,114,0.0,86.0,86.0
240.088,6,21,4924,11,941,24008.0,180.0,93.0,10,3983,26676.0,1591.0,575.0
0.015,6,10,1972,5,910,3.0,642.0,642.0,5,1062,3.0,794.0,794.0
0.04,17,2,152,1,76,0.0,48.0,48.0,1,76,0.0,48.0,48.0
0.013,6,10,1990,5,911,3.0,643.0,643.0,5,1079,3.0,811.0,811.0
40.066,17,10,676,5,460,10015.0,104.0,64.0,5,216,10015.0,20.0,15.0
0.091,6,10,1506,5,395,20.0,127.0,127.0,5,1111,21.0,843.0,843.0
0.042,17,2,182,1,65,0.0,37.0,37.0,1,117,0.0,89.0,89.0
0.015,6,10,1972,5,910,3.0,642.0,642.0,5,1062,3.0,794.0,794.0
0.009,6,12,1926,6,1189,1.0,659.0,434.0,6,737,1.0,417.0,417.0
0.103,6,10,1506,5,395,22.0,127.0,127.0,5,1111,21.0,843.0,843.0
0.005,6,10,2007,5,928,1.0,660.0,660.0,5,1079,1.0,811.0,811.0
0.065,6,10,1506,5,395,14.0,127.0,127.0,5,1111,15.0,843.0,843.0
0.01,6,10,1990,5,911,2.0,643.0,643.0,5,1079,2.0,811.0,811.0
0.137,6,10,1506,5,395,31.0,127.0,127.0,5,1111,29.0,843.0,843.0
0.009,6,10,1989,5,910,2.0,642.0,642.0,5,1079,2.0,811.0,811.0
0.014,6,10,1972,5,910,3.0,642.0,642.0,5,1062,3.0,794.0,794.0
300.957,6,44,13571,24,7744,13085.0,1360.0,844.0,20,5827,462.0,2667.0,385.0
0.012,6,10,1989,5,910,3.0,642.0,642.0,5,1079,2.0,811.0,811.0
0.004,6,10,2007,5,928,1.0,660.0,660.0,5,1079,1.0,811.0,811.0
0.003,17,2,132,1,58,0.0,30.0,30.0,1,74,0.0,46.0,46.0
0.045,17,4,352,2,130,1.0,37.0,37.0,2,222,41.0,89.0,83.0
0.008,6,10,2006,5,927,1.0,659.0,659.0,5,1079,2.0,811.0,811.0
0.006,17,2,164,1,74,0.0,46.0,46.0,1,90,0.0,62.0,62.0
0.005,17,2,136,1,60,0.0,32.0,32.0,1,76,0.0,48.0,48.0
962.058,6,79,29576,40,6886,24668.0,676.0,479.0,39,22690,23738.0,1883.0,737.0
337.597,6,389,348395,188,21345,1805.0,2736.0,889.0,201,327050,1687.0,2848.0,1683.0
0.005,6,10,2006,5,927,1.0,659.0,659.0,5,1079,1.0,811.0,811.0
0.012,6,10,1989,5,910,3.0,642.0,642.0,5,1079,2.0,811.0,811.0
0.005,6,10,2007,5,928,1.0,660.0,660.0,5,1079,1.0,811.0,811.0
0.014,6,10,1972,5,910,3.0,642.0,642.0,5,1062,3.0,794.0,794.0
0.084,6,10,1506,5,395,18.0,127.0,127.0,5,1111,16.0,843.0,843.0
0.011,6,10,1983,5,910,2.0,642.0,642.0,5,1073,2.0,805.0,805.0
11.144,17,28,4418,14,1994,844.0,269.0,114.0,14,2424,844.0,587.0,145.0
10.887,17,28,4420,14,1993,828.0,268.0,114.0,14,2427,828.0,586.0,145.0
0.08,6,10,1506,5,395,17.0,127.0,127.0,5,1111,18.0,843.0,843.0
40.055,17,10,676,5,460,10012.0,104.0,64.0,5,216,10012.0,20.0,15.0
0.011,6,10,1989,5,910,2.0,642.0,642.0,5,1079,2.0,811.0,811.0
0.001,17,2,180,1,66,0.0,38.0,38.0,1,114,0.0,86.0,86.0
0.001,17,2,180,1,65,0.0,37.0,37.0,1,115,0.0,87.0,87.0
0.005,6,10,1779,5,928,1.0,660.0,660.0,5,851,1.0,583.0,583.0
0.074,6,10,1506,5,395,16.0,127.0,127.0,5,1111,16.0,843.0,843.0
0.011,6,10,1972,5,910,2.0,642.0,642.0,5,1062,2.0,794.0,794.0
0.075,6,10,1506,5,395,16.0,127.0,127.0,5,1111,15.0,843.0,843.0
0.016,6,10,1972,5,910,3.0,642.0,642.0,5,1062,3.0,794.0,794.0
0.004,6,10,1779,5,928,1.0,660.0,660.0,5,851,1.0,583.0,583.0
0.001,17,2,180,1,66,0.0,38.0,38.0,1,114,0.0,86.0,86.0
0.005,6,10,2000,5,927,1.0,659.0,659.0,5,1073,1.0,805.0,805.0
0.011,6,10,1989,5,910,2.0,642.0,642.0,5,1079,2.0,811.0,811.0
0.006,6,10,1547,5,764,1.0,496.0,496.0,5,783,1.0,515.0,515.0
0.008,6,10,1989,5,910,2.0,642.0,642.0,5,1079,1.0,811.0,811.0
0.04,17,4,284,2,120,1.0,32.0,32.0,2,164,36.0,60.0,54.0
0.07,6,10,1506,5,395,15.0,127.0,127.0,5,1111,16.0,843.0,843.0
0.074,6,10,1506,5,395,15.0,127.0,127.0,5,1111,14.0,843.0,843.0
0.079,6,10,1506,5,395,18.0,127.0,127.0,5,1111,14.0,843.0,843.0
0.01,6,10,1677,5,827,2.0,559.0,559.0,5,850,2.0,582.0,582.0
0.001,17,2,180,1,66,0.0,38.0,38.0,1,114,0.0,86.0,86.0
0.004,6,10,2006,5,927,1.0,659.0,659.0,5,1079,1.0,811.0,811.0
128.824,6,21,8147,11,1985,83.0,1174.0,504.0,10,6162,14295.0,2720.0,958.0
0.004,17,2,136,1,60,0.0,32.0,32.0,1,76,0.0,48.0,48.0
0.006,6,10,1643,5,860,1.0,592.0,592.0,5,783,1.0,515.0,515.0
40.061,17,10,676,5,460,10013.0,104.0,64.0,5,216,10012.0,20.0,15.0
0.002,17,2,180,1,66,0.0,38.0,38.0,1,114,0.0,86.0,86.0
0.007,6,12,1698,6,863,1.0,327.0,271.0,6,835,1.0,515.0,515.0
0.004,6,10,2006,5,927,1.0,659.0,659.0,5,1079,1.0,811.0,811.0
0.005,6,10,1689,5,839,1.0,571.0,571.0,5,850,1.0,582.0,582.0
240.012,6,9,787,5,488,60003.0,232.0,232.0,4,299,80003.0,83.0,83.0
0.005,6,10,1547,5,764,1.0,496.0,496.0,5,783,1.0,515.0,515.0
0.003,17,2,148,1,60,0.0,32.0,32.0,1,88,0.0,60.0,60.0
15.078,17,16,8210,8,5944,2150.0,1350.0,715.0,8,2266,2149.0,1350.0,255.0
0.01,6,10,1677,5,827,2.0,559.0,559.0,5,850,2.0,582.0,582.0
0.023,6,10,1990,5,911,5.0,643.0,643.0,5,1079,5.0,811.0,811.0
0.083,6,10,1506,5,395,20.0,127.0,127.0,5,1111,18.0,843.0,843.0
0.243,17,47,25823,26,21261,9.0,1350.0,789.0,21,4562,8.0,1350.0,189.0
0.003,17,2,148,1,60,0.0,32.0,32.0,1,88,0.0,60.0,60.0
40.07,17,10,676,5,460,10016.0,104.0,64.0,5,216,10016.0,20.0,15.0
0.01,6,10,1989,5,910,2.0,642.0,642.0,5,1079,2.0,811.0,811.0
0.014,6,10,1990,5,911,3.0,643.0,643.0,5,1079,3.0,811.0,811.0
0.005,6,10,1989,5,927,1.0,659.0,659.0,5,1062,1.0,794.0,794.0
15.073,17,15,9238,8,6902,2149.0,1350.0,834.0,7,2336,2507.0,1350.0,305.0
0.103,6,10,1506,5,395,24.0,127.0,127.0,5,1111,24.0,843.0,843.0
0.013,6,10,1989,5,910,3.0,642.0,642.0,5,1079,3.0,811.0,811.0
0.034,17,2,170,1,65,0.0,37.0,37.0,1,105,0.0,77.0,77.0
0.006,17,2,136,1,60,0.0,32.0,32.0,1,76,0.0,48.0,48.0
0.004,6,10,1702,5,863,1.0,595.0,595.0,5,839,0.0,571.0,571.0
0.006,6,10,1643,5,860,1.0,592.0,592.0,5,783,1.0,515.0,515.0
0.089,6,10,1506,5,395,20.0,127.0,127.0,5,1111,21.0,843.0,843.0
0.005,6,14,3736,7,446,0.0,74.0,74.0,7,3290,0.0,1448.0,972.0
0.059,6,10,1506,5,395,12.0,127.0,127.0,5,1111,13.0,843.0,843.0
0.073,17,2,182,1,65,0.0,37.0,37.0,1,117,0.0,89.0,89.0
0.005,6,10,2000,5,927,1.0,659.0,659.0,5,1073,1.0,805.0,805.0
0.01,6,10,1972,5,910,2.0,642.0,642.0,5,1062,2.0,794.0,794.0
0.009,6,12,1926,6,1189,1.0,659.0,434.0,6,737,1.0,417.0,417.0
0.007,6,10,1547,5,764,1.0,496.0,496.0,5,783,1.0,515.0,515.0
0.001,17,2,180,1,66,0.0,38.0,38.0,1,114,0.0,86.0,86.0
0.001,17,2,166,1,75,0.0,47.0,47.0,1,91,0.0,63.0,63.0
0.005,6,10,1774,5,923,1.0,655.0,655.0,5,851,1.0,583.0,583.0
0.012,6,10,1677,5,827,3.0,559.0,559.0,5,850,2.0,582.0,582.0
0.009,6,10,1972,5,910,2.0,642.0,642.0,5,1062,2.0,794.0,794.0
0.008,6,10,1989,5,910,2.0,642.0,642.0,5,1079,2.0,811.0,811.0
0.006,6,10,1989,5,927,1.0,659.0,659.0,5,1062,1.0,794.0,794.0
0.004,6,10,1989,5,927,1.0,659.0,659.0,5,1062,1.0,794.0,794.0
0.076,6,10,1506,5,395,17.0,127.0,127.0,5,1111,15.0,843.0,843.0
0.037,17,2,144,1,64,0.0,36.0,36.0,1,80,0.0,52.0,52.0
0.007,6,12,1698,6,863,1.0,327.0,271.0,6,835,1.0,515.0,515.0
0.169,17,2,152,1,76,0.0,48.0,48.0,1,76,0.0,48.0,48.0
0.04,17,4,284,2,120,0.0,32.0,32.0,2,164,36.0,60.0,54.0
0.165,17,2,152,1,76,0.0,48.0,48.0,1,76,0.0,48.0,48.0
0.008,6,10,2006,5,927,2.0,659.0,659.0,5,1079,2.0,811.0,811.0
300.082,6,22,4905,11,2369,30007.0,1026.0,447.0,11,2536,30007.0,1162.0,393.0
0.003,17,2,148,1,60,0.0,32.0,32.0,1,88,0.0,60.0,60.0
0.004,6,10,2006,5,927,1.0,659.0,659.0,5,1079,1.0,811.0,811.0
0.003,17,4,420,2,122,0.0,33.0,33.0,2,298,0.0,145.0,121.0
0.615,17,20,10165,9,6973,76.0,1350.0,746.0,11,3192,54.0,1350.0,262.0
0.075,6,44,14047,25,2617,3.0,517.0,146.0,19,11430,3.0,1402.0,745.0
0.157,6,10,1506,5,395,37.0,127.0,127.0,5,1111,17.0,843.0,843.0
0.062,6,10,1990,5,911,15.0,643.0,643.0,5,1079,15.0,811.0,811.0
0.128,17,2,80,1,32,0.0,4.0,4.0,1,48,0.0,20.0,20.0
0.226,6,16,2778,8,1396,32.0,533.0,324.0,8,1382,20.0,529.0,239.0
0.001,17,2,180,1,66,0.0,38.0,38.0,1,114,0.0,86.0,86.0
0.004,6,10,2006,5,927,1.0,659.0,659.0,5,1079,1.0,811.0,811.0
0.007,6,10,1989,5,910,1.0,642.0,642.0,5,1079,1.0,811.0,811.0
1742.439,6,147,18797,88,13334,20027.0,302.0,302.0,59,5463,30041.0,83.0,83.0
0.011,6,10,1677,5,827,2.0,559.0,559.0,5,850,2.0,582.0,582.0
0.058,6,10,1631,5,848,14.0,580.0,580.0,5,783,14.0,515.0,515.0
0.014,6,10,1762,5,911,3.0,643.0,643.0,5,851,3.0,583.0,583.0
0.005,17,2,214,1,75,0.0,47.0,47.0,1,139,0.0,111.0,111.0
0.005,17,2,230,1,68,0.0,40.0,40.0,1,162,0.0,134.0,134.0
0.016,6,10,1990,5,911,4.0,643.0,643.0,5,1079,3.0,811.0,811.0
0.016,6,13,3735,7,497,2.0,125.0,125.0,6,3238,3.0,1470.0,1459.0
0.148,6,10,1506,5,395,36.0,127.0,127.0,5,1111,32.0,843.0,843.0
0.005,17,2,180,1,66,0.0,38.0,38.0,1,114,0.0,86.0,86.0
0.009,6,10,1983,5,910,2.0,642.0,642.0,5,1073,2.0,805.0,805.0
0.006,6,10,1547,5,764,1.0,496.0,496.0,5,783,1.0,515.0,515.0
0.018,6,10,1990,5,911,4.0,643.0,643.0,5,1079,4.0,811.0,811.0
0.011,6,13,3735,7,497,1.0,125.0,125.0,6,3238,2.0,1470.0,1459.0
0.011,6,10,1762,5,911,2.0,643.0,643.0,5,851,2.0,583.0,583.0
40.058,17,10,676,5,460,10013.0,104.0,64.0,5,216,10012.0,20.0,15.0
0.082,6,10,1506,5,395,20.0,127.0,127.0,5,1111,16.0,843.0,843.0
0.013,6,10,1989,5,910,3.0,642.0,642.0,5,1079,3.0,811.0,811.0
0.007,17,2,194,1,59,0.0,31.0,31.0,1,135,0.0,107.0,107.0
0.006,6,10,1547,5,764,1.0,496.0,496.0,5,783,1.0,515.0,515.0
15.072,17,14,9190,8,6902,2149.0,1350.0,834.0,6,2288,3008.0,1350.0,353.0
0.007,6,10,1643,5,860,1.0,592.0,592.0,5,783,1.0,515.0,515.0
0.005,6,10,2007,5,928,1.0,660.0,660.0,5,1079,1.0,811.0,811.0
0.113,6,10,1506,5,395,24.0,127.0,127.0,5,1111,24.0,843.0,843.0
0.005,6,10,1779,5,928,1.0,660.0,660.0,5,851,1.0,583.0,583.0
0.08,6,10,1506,5,395,18.0,127.0,127.0,5,1111,17.0,843.0,843.0
0.005,6,10,2000,5,927,1.0,659.0,659.0,5,1073,1.0,805.0,805.0
0.01,6,10,1972,5,910,2.0,642.0,642.0,5,1062,2.0,794.0,794.0
0.009,6,10,1762,5,911,2.0,643.0,643.0,5,851,2.0,583.0,583.0
0.106,6,10,1506,5,395,24.0,127.0,127.0,5,1111,22.0,843.0,843.0
0.005,6,10,1989,5,927,1.0,659.0,659.0,5,1062,1.0,794.0,794.0
0.039,17,2,412,1,61,0.0,33.0,33.0,1,351,0.0,323.0,323.0
0.006,6,10,1547,5,764,1.0,496.0,496.0,5,783,1.0,515.0,515.0
0.284,17,44,26621,26,23477,11.0,1350.0,874.0,18,3144,13.0,1350.0,146.0
353.999,6,21,1795,16,1030,23599.0,190.0,190.0,5,765,60002.0,464.0,248.0
0.004,6,10,1989,5,927,1.0,659.0,659.0,5,1062,1.0,794.0,794.0
0.006,17,2,179,1,71,0.0,43.0,43.0,1,108,0.0,80.0,80.0
308.928,17,20,1124,10,716,34318.0,48.0,43.0,10,408,34318.0,20.0,12.0
0.012,6,10,1989,5,910,2.0,642.0,642.0,5,1079,3.0,811.0,811.0
0.007,17,2,194,1,59,0.0,31.0,31.0,1,135,0.0,107.0,107.0
0.067,6,10,1506,5,395,16.0,127.0,127.0,5,1111,16.0,843.0,843.0
1792.569,6,490,99412,246,88062,7316.0,421.0,365.0,244,11350,7376.0,53.0,53.0
0.005,17,2,179,1,71,0.0,43.0,43.0,1,108,0.0,80.0,80.0
0.004,6,10,2007,5,928,1.0,660.0,660.0,5,1079,1.0,811.0,811.0
1792.817,6,303,52554,124,34963,14574.0,2720.0,302.0,179,17591,10071.0,1360.0,128.0
40.063,17,10,676,5,460,10012.0,104.0,64.0,5,216,10014.0,20.0,15.0
0.005,17,2,140,1,62,0.0,34.0,34.0,1,78,0.0,50.0,50.0
0.01,6,10,1972,5,910,2.0,642.0,642.0,5,1062,2.0,794.0,794.0
0.01,6,10,1990,5,911,2.0,643.0,643.0,5,1079,2.0,811.0,811.0
1.085,6,32,13392,18,5893,63.0,2720.0,854.0,14,7499,70.0,2720.0,769.0
0.09,6,10,1506,5,395,19.0,127.0,127.0,5,1111,20.0,843.0,843.0
0.011,6,10,1989,5,910,2.0,642.0,642.0,5,1079,2.0,811.0,811.0
1780.748,6,268,31699,109,15137,16487.0,1938.0,126.0,159,16562,11269.0,1360.0,130.0
0.068,6,10,1506,5,395,15.0,127.0,127.0,5,1111,14.0,843.0,843.0
0.005,6,10,1989,5,927,1.0,659.0,659.0,5,1062,1.0,794.0,794.0
40.056,17,10,676,5,460,10013.0,104.0,64.0,5,216,10013.0,20.0,15.0
0.004,6,10,2000,5,927,1.0,659.0,659.0,5,1073,1.0,805.0,805.0
0.087,6,10,1506,5,395,18.0,127.0,127.0,5,1111,19.0,843.0,843.0
0.004,6,10,1774,5,923,1.0,655.0,655.0,5,851,1.0,583.0,583.0
0.006,6,10,2006,5,927,1.0,659.0,659.0,5,1079,1.0,811.0,811.0
40.088,17,10,676,5,460,10020.0,104.0,64.0,5,216,10021.0,20.0,15.0
1771.835,6,99,5958,57,3369,31639.0,27.0,27.0,42,2589,43214.0,27.0,27.0
0.079,6,10,1506,5,395,18.0,127.0,127.0,5,1111,15.0,843.0,843.0
0.014,6,10,1989,5,910,3.0,642.0,642.0,5,1079,3.0,811.0,811.0
0.099,6,10,1506,5,395,23.0,127.0,127.0,5,1111,23.0,843.0,843.0
0.006,6,10,1854,5,889,1.0,621.0,621.0,5,965,1.0,697.0,697.0
0.006,17,2,170,1,65,0.0,37.0,37.0,1,105,0.0,77.0,77.0
0.016,6,10,1972,5,910,3.0,642.0,642.0,5,1062,4.0,794.0,794.0
0.006,6,10,1547,5,764,1.0,496.0,496.0,5,783,1.0,515.0,515.0
361.844,6,21,1793,16,1030,24122.0,190.0,190.0,5,763,60010.0,462.0,247.0
0.035,17,2,170,1,65,0.0,37.0,37.0,1,105,0.0,77.0,77.0
40.056,17,10,676,5,460,10013.0,104.0,64.0,5,216,10010.0,20.0,15.0
240.03,6,9,787,5,488,60007.0,232.0,232.0,4,299,80008.0,83.0,83.0
0.037,6,10,1983,5,910,9.0,642.0,642.0,5,1073,9.0,805.0,805.0
9.036,17,6,376,5,280,2259.0,28.0,28.0,1,96,0.0,68.0,68.0
0.005,6,10,1854,5,889,1.0,621.0,621.0,5,965,1.0,697.0,697.0
0.005,6,10,2006,5,927,1.0,659.0,659.0,5,1079,1.0,811.0,811.0
0.005,6,10,2007,5,928,1.0,660.0,660.0,5,1079,1.0,811.0,811.0
252.964,6,38,9864,15,6683,18068.0,1809.0,656.0,23,3181,11498.0,580.0,141.0
0.055,6,10,1506,5,395,13.0,127.0,127.0,5,1111,12.0,843.0,843.0
0.011,6,10,1762,5,911,2.0,643.0,643.0,5,851,2.0,583.0,583.0
0.007,6,10,1547,5,764,1.0,496.0,496.0,5,783,1.0,515.0,515.0
0.005,6,10,2007,5,928,1.0,660.0,660.0,5,1079,1.0,811.0,811.0
0.126,6,10,1506,5,395,26.0,127.0,127.0,5,1111,29.0,843.0,843.0
0.004,6,10,2000,5,927,1.0,659.0,659.0,5,1073,1.0,805.0,805.0
0.014,6,10,1983,5,910,3.0,642.0,642.0,5,1073,3.0,805.0,805.0
241.372,6,304,343822,114,17439,2136.0,2736.0,959.0,190,326383,1277.0,2804.0,1758.0
0.001,17,2,180,1,66,0.0,38.0,38.0,1,114,0.0,86.0,86.0
0.005,6,10,1730,5,513,1.0,245.0,245.0,5,1217,1.0,949.0,949.0
0.006,6,10,1643,5,860,1.0,592.0,592.0,5,783,1.0,515.0,515.0
0.026,6,10,1972,5,910,6.0,642.0,642.0,5,1062,6.0,794.0,794.0
0.011,6,10,1972,5,910,2.0,642.0,642.0,5,1062,2.0,794.0,794.0
0.012,6,10,1972,5,910,3.0,642.0,642.0,5,1062,3.0,794.0,794.0
15.074,17,15,9238,8,6902,2149.0,1350.0,834.0,7,2336,2507.0,1350.0,305.0
0.009,6,10,1989,5,910,2.0,642.0,642.0,5,1079,2.0,811.0,811.0
0.012,6,10,1983,5,910,2.0,642.0,642.0,5,1073,3.0,805.0,805.0
0.017,6,13,3735,7,497,2.0,125.0,125.0,6,3238,3.0,1470.0,1459.0
0.039,17,2,136,1,60,0.0,32.0,32.0,1,76,0.0,48.0,48.0
0.01,6,10,1989,5,910,2.0,642.0,642.0,5,1079,2.0,811.0,811.0
0.087,6,10,1506,5,395,19.0,127.0,127.0,5,1111,18.0,843.0,843.0
0.082,6,10,1506,5,395,18.0,127.0,127.0,5,1111,17.0,843.0,843.0
0.018,6,10,1972,5,910,4.0,642.0,642.0,5,1062,4.0,794.0,794.0
0.105,6,10,1506,5,395,22.0,127.0,127.0,5,1111,23.0,843.0,843.0
0.004,17,2,234,1,61,0.0,33.0,33.0,1,173,0.0,145.0,145.0
0.008,6,10,1990,5,911,2.0,643.0,643.0,5,1079,2.0,811.0,811.0
0.096,6,10,1506,5,395,22.0,127.0,127.0,5,1111,17.0,843.0,843.0
0.005,6,10,2006,5,927,1.0,659.0,659.0,5,1079,1.0,811.0,811.0
0.006,6,10,1547,5,764,1.0,496.0,496.0,5,783,1.0,515.0,515.0
0.072,6,10,1506,5,395,16.0,127.0,127.0,5,1111,15.0,843.0,843.0
0.009,6,10,1989,5,910,2.0,642.0,642.0,5,1079,2.0,811.0,811.0
0.031,6,10,1990,5,911,7.0,643.0,643.0,5,1079,7.0,811.0,811.0
0.012,6,10,1972,5,910,2.0,642.0,642.0,5,1062,2.0,794.0,794.0
63.538,6,37,9811,19,4293,497.0,1360.0,700.0,18,5518,3727.0,2667.0,435.0
0.01,17,4,284,2,120,1.0,32.0,32.0,2,164,1.0,60.0,54.0
0.006,6,10,2006,5,927,1.0,659.0,659.0,5,1079,1.0,811.0,811.0
0.094,6,10,1506,5,395,19.0,127.0,127.0,5,1111,19.0,843.0,843.0
0.001,17,2,179,1,62,0.0,34.0,34.0,1,117,0.0,89.0,89.0
0.115,6,10,1506,5,395,26.0,127.0,127.0,5,1111,27.0,843.0,843.0
0.009,6,10,1983,5,910,2.0,642.0,642.0,5,1073,2.0,805.0,805.0
0.016,6,13,3735,7,497,2.0,125.0,125.0,6,3238,3.0,1470.0,1459.0
47.789,6,38,12687,19,7129,493.0,2720.0,1267.0,19,5558,2645.0,2667.0,435.0
0.101,6,10,1506,5,395,23.0,127.0,127.0,5,1111,22.0,843.0,843.0
0.004,6,10,2006,5,927,1.0,659.0,659.0,5,1079,1.0,811.0,811.0
0.018,6,10,1983,5,910,4.0,642.0,642.0,5,1073,4.0,805.0,805.0
0.018,6,10,1677,5,827,4.0,559.0,559.0,5,850,4.0,582.0,582.0
0.005,6,13,3747,7,509,0.0,137.0,137.0,6,3238,0.0,1470.0,1459.0
0.074,17,4,284,2,120,0.0,32.0,32.0,2,164,70.0,60.0,54.0
0.009,6,10,1762,5,911,2.0,643.0,643.0,5,851,2.0,583.0,583.0
177.186,17,94,13503,47,3168,3851.0,44.0,39.0,47,10335,3851.0,239.0,191.0
0.007,6,10,1972,5,910,1.0,642.0,642.0,5,1062,1.0,794.0,794.0
0.005,17,2,169,1,62,0.0,34.0,34.0,1,107,0.0,79.0,79.0
0.003,17,2,136,1,60,0.0,32.0,32.0,1,76,0.0,48.0,48.0
0.016,6,10,1677,5,827,3.0,559.0,559.0,5,850,4.0,582.0,582.0
0.005,6,14,3742,7,452,0.0,80.0,80.0,7,3290,0.0,1448.0,972.0
0.006,6,10,2006,5,927,1.0,659.0,659.0,5,1079,1.0,811.0,811.0
0.008,6,10,1989,5,910,1.0,642.0,642.0,5,1079,1.0,811.0,811.0
0.003,17,2,136,1,60,0.0,32.0,32.0,1,76,0.0,48.0,48.0
0.005,17,2,170,1,65,0.0,37.0,37.0,1,105,0.0,77.0,77.0
0.004,6,10,2006,5,927,1.0,659.0,659.0,5,1079,1.0,811.0,811.0
240.09,6,16,4482,9,963,30011.0,238.0,166.0,7,3519,40014.0,1402.0,786.0
0.011,6,10,1983,5,910,2.0,642.0,642.0,5,1073,2.0,805.0,805.0
0.011,6,12,1926,6,1189,2.0,659.0,434.0,6,737,2.0,417.0,417.0
0.005,6,10,1989,5,927,1.0,659.0,659.0,5,1062,1.0,794.0,794.0
0.08,17,2,170,1,65,0.0,37.0,37.0,1,105,0.0,77.0,77.0
0.005,6,13,3747,7,509,0.0,137.0,137.0,6,3238,1.0,1470.0,1459.0
0.002,17,2,180,1,65,0.0,37.0,37.0,1,115,0.0,87.0,87.0
369.845,6,24,2405,17,919,23115.0,195.0,195.0,7,1486,3907.0,419.0,398.0
0.075,6,10,1506,5,395,17.0,127.0,127.0,5,1111,17.0,843.0,843.0
0.013,6,10,1989,5,910,3.0,642.0,642.0,5,1079,3.0,811.0,811.0
240.01,6,9,787,5,488,60002.0,232.0,232.0,4,299,80002.0,83.0,83.0
0.015,6,10,1762,5,911,3.0,643.0,643.0,5,851,3.0,583.0,583.0
0.01,6,10,2006,5,927,2.0,659.0,659.0,5,1079,2.0,811.0,811.0
178.129,17,88,12570,44,2967,4142.0,44.0,39.0,44,9603,4142.0,239.0,190.0
0.09,17,8,3613,4,1874,30.0,1350.0,440.0,4,1739,12.0,1350.0,406.0
0.013,6,10,1989,5,910,3.0,642.0,642.0,5,1079,3.0,811.0,811.0
0.013,6,10,1677,5,827,3.0,559.0,559.0,5,850,3.0,582.0,582.0
0.005,6,10,2000,5,927,1.0,659.0,659.0,5,1073,1.0,805.0,805.0
0.011,6,10,1972,5,910,2.0,642.0,642.0,5,1062,2.0,794.0,794.0
0.076,6,10,1506,5,395,17.0,127.0,127.0,5,1111,13.0,843.0,843.0
0.024,6,10,1989,5,910,5.0,642.0,642.0,5,1079,5.0,811.0,811.0
10.985,17,28,4424,14,1995,836.0,270.0,114.0,14,2429,836.0,588.0,145.0
0.042,17,2,412,1,61,0.0,33.0,33.0,1,351,0.0,323.0,323.0
0.004,6,10,2006,5,927,1.0,659.0,659.0,5,1079,1.0,811.0,811.0
0.085,6,10,1506,5,395,16.0,127.0,127.0,5,1111,17.0,843.0,843.0
0.018,17,4,284,2,120,0.0,32.0,32.0,2,164,0.0,60.0,54.0
242.086,6,384,347740,192,21510,1267.0,2736.0,959.0,192,326230,1267.0,2804.0,1776.0
0.118,6,10,1506,5,395,25.0,127.0,127.0,5,1111,26.0,843.0,843.0
0.041,17,2,412,1,61,0.0,33.0,33.0,1,351,0.0,323.0,323.0
0.019,6,10,1989,5,910,4.0,642.0,642.0,5,1079,4.0,811.0,811.0
0.001,17,2,136,1,60,0.0,32.0,32.0,1,76,0.0,48.0,48.0
0.005,6,10,2006,5,927,1.0,659.0,659.0,5,1079,1.0,811.0,811.0
0.126,17,2,148,1,60,0.0,32.0,32.0,1,88,0.0,60.0,60.0
0.012,6,10,1762,5,911,2.0,643.0,643.0,5,851,3.0,583.0,583.0
0.078,17,2,136,1,60,0.0,32.0,32.0,1,76,0.0,48.0,48.0
294.914,6,316,344589,118,17682,2520.0,2736.0,888.0,198,326907,1497.0,2917.0,1720.0
15.07,17,15,9239,8,6902,2149.0,1350.0,834.0,7,2337,2506.0,1350.0,305.0
0.087,6,10,1506,5,395,16.0,127.0,127.0,5,1111,20.0,843.0,843.0
0.006,6,13,3690,7,452,1.0,80.0,80.0,6,3238,1.0,1470.0,1459.0
0.081,6,10,1506,5,395,18.0,127.0,127.0,5,1111,18.0,843.0,843.0
0.006,6,10,1547,5,764,1.0,496.0,496.0,5,783,1.0,515.0,515.0
0.004,17,2,136,1,60,0.0,32.0,32.0,1,76,0.0,48.0,48.0
0.005,6,10,2006,5,927,1.0,659.0,659.0,5,1079,1.0,811.0,811.0
0.07,17,8,3613,4,1874,23.0,1350.0,440.0,4,1739,12.0,1350.0,406.0
0.013,6,13,3735,7,497,2.0,125.0,125.0,6,3238,2.0,1470.0,1459.0
0.003,17,2,152,1,76,0.0,48.0,48.0,1,76,0.0,48.0,48.0
0.102,6,10,1506,5,395,20.0,127.0,127.0,5,1111,22.0,843.0,843.0
0.006,6,10,1854,5,889,1.0,621.0,621.0,5,965,1.0,697.0,697.0
0.009,6,10,1990,5,911,2.0,643.0,643.0,5,1079,2.0,811.0,811.0
0.02,6,10,1989,5,927,4.0,659.0,659.0,5,1062,5.0,794.0,794.0
11.44,17,28,4388,14,2311,867.0,586.0,137.0,14,2077,867.0,268.0,120.0
1.279,6,30,12351,17,3300,79.0,1360.0,517.0,13,9051,91.0,2720.0,946.0
40.071,17,10,676,5,460,10016.0,104.0,64.0,5,216,10017.0,20.0,15.0
0.012,6,10,1989,5,910,2.0,642.0,642.0,5,1079,3.0,811.0,811.0
0.083,6,10,1506,5,395,18.0,127.0,127.0,5,1111,17.0,843.0,843.0
1.021,6,13,3922,7,2139,128.0,1328.0,923.0,6,1783,153.0,1539.0,1539.0
0.008,6,12,1926,6,1189,1.0,659.0,434.0,6,737,1.0,417.0,417.0
0.003,17,2,148,1,60,0.0,32.0,32.0,1,88,0.0,60.0,60.0
0.111,6,10,1506,5,395,22.0,127.0,127.0,5,1111,25.0,843.0,843.0
0.005,6,10,1643,5,860,1.0,592.0,592.0,5,783,1.0,515.0,515.0
10.742,17,28,4422,14,1994,817.0,269.0,114.0,14,2428,817.0,587.0,145.0
0.001,17,2,180,1,66,0.0,38.0,38.0,1,114,0.0,86.0,86.0
309.15,17,20,1124,10,716,34336.0,48.0,43.0,10,408,34336.0,20.0,12.0
240.481,6,24,10590,12,3688,21861.0,1496.0,764.0,12,6902,21861.0,2804.0,1249.0
0.085,6,10,1506,5,395,18.0,127.0,127.0,5,1111,19.0,843.0,843.0
0.003,17,2,136,1,60,0.0,32.0,32.0,1,76,0.0,48.0,48.0
0.005,6,10,1989,5,927,1.0,659.0,659.0,5,1062,1.0,794.0,794.0
0.052,6,10,1762,5,911,13.0,643.0,643.0,5,851,13.0,583.0,583.0
0.006,6,10,1989,5,927,1.0,659.0,659.0,5,1062,1.0,794.0,794.0
0.083,6,10,1506,5,395,17.0,127.0,127.0,5,1111,17.0,843.0,843.0
40.061,17,10,676,5,460,10013.0,104.0,64.0,5,216,10013.0,20.0,15.0
0.005,6,10,1989,5,927,1.0,659.0,659.0,5,1062,1.0,794.0,794.0
0.006,6,10,1762,5,911,1.0,643.0,643.0,5,851,1.0,583.0,583.0
0.005,6,10,1779,5,928,1.0,660.0,660.0,5,851,1.0,583.0,583.0
294.291,6,388,348391,200,21960,1478.0,2736.0,888.0,188,326431,1573.0,2804.0,1819.0
0.01,6,10,1972,5,910,2.0,642.0,642.0,5,1062,2.0,794.0,794.0
0.071,6,10,1506,5,395,16.0,127.0,127.0,5,1111,14.0,843.0,843.0
301.142,6,52,19564,28,13577,11153.0,2720.0,1035.0,24,5987,391.0,2667.0,385.0
0.008,6,10,1989,5,910,2.0,642.0,642.0,5,1079,2.0,811.0,811.0
0.012,6,10,1990,5,911,3.0,643.0,643.0,5,1079,3.0,811.0,811.0
0.004,6,10,2006,5,927,1.0,659.0,659.0,5,1079,1.0,811.0,811.0
171.07,17,70,10093,35,2331,5031.0,44.0,38.0,35,7762,5031.0,239.0,193.0
0.005,6,10,1854,5,889,1.0,621.0,621.0,5,965,1.0,697.0,697.0
0.013,6,10,1677,5,827,3.0,559.0,559.0,5,850,3.0,582.0,582.0
0.007,6,10,1972,5,910,1.0,642.0,642.0,5,1062,1.0,794.0,794.0
0.016,6,14,3787,7,497,2.0,125.0,125.0,7,3290,2.0,1448.0,972.0
0.003,17,2,148,1,60,0.0,32.0,32.0,1,88,0.0,60.0,60.0
0.009,6,10,1972,5,910,2.0,642.0,642.0,5,1062,2.0,794.0,794.0
0.039,17,4,284,2,120,1.0,32.0,32.0,2,164,36.0,60.0,54.0
178.131,17,78,10981,39,2615,4687.0,44.0,39.0,39,8366,4687.0,239.0,186.0
0.006,6,10,1689,5,839,1.0,571.0,571.0,5,850,1.0,582.0,582.0
171.028,17,72,10158,36,2402,4886.0,44.0,38.0,36,7756,4886.0,239.0,187.0
0.042,17,4,284,2,120,0.0,32.0,32.0,2,164,38.0,60.0,54.0
309.945,17,20,1124,10,716,34423.0,48.0,43.0,10,408,34424.0,20.0,12.0
0.005,17,2,164,1,74,0.0,46.0,46.0,1,90,0.0,62.0,62.0
0.084,6,10,1506,5,395,19.0,127.0,127.0,5,1111,18.0,843.0,843.0
0.019,6,10,1983,5,910,4.0,642.0,642.0,5,1073,4.0,805.0,805.0
40.056,17,10,676,5,460,10013.0,104.0,64.0,5,216,10013.0,20.0,15.0
0.001,17,2,179,1,62,0.0,34.0,34.0,1,117,0.0,89.0,89.0
0.02,6,10,1972,5,910,5.0,642.0,642.0,5,1062,4.0,794.0,794.0
31.007,6,36,8545,18,3027,522.0,1360.0,568.0,18,5518,1813.0,2667.0,435.0
0.013,6,13,3735,7,497,2.0,125.0,125.0,6,3238,2.0,1470.0,1459.0
0.084,6,10,1506,5,395,17.0,127.0,127.0,5,1111,18.0,843.0,843.0
0.003,17,2,136,1,60,0.0,32.0,32.0,1,76,0.0,48.0,48.0
0.005,17,2,164,1,74,0.0,46.0,46.0,1,90,0.0,62.0,62.0
240.074,6,21,4926,11,941,24007.0,180.0,93.0,10,3985,26674.0,1593.0,576.0
0.005,17,2,136,1,60,0.0,32.0,32.0,1,76,0.0,48.0,48.0
0.001,17,2,166,1,75,0.0,47.0,47.0,1,91,0.0,63.0,63.0
0.011,6,10,1677,5,827,2.0,559.0,559.0,5,850,2.0,582.0,582.0
0.001,17,2,180,1,66,0.0,38.0,38.0,1,114,0.0,86.0,86.0
240.097,6,31,9545,15,7009,17149.0,2131.0,692.0,16,2536,16006.0,580.0,212.0
0.001,17,2,180,1,66,0.0,38.0,38.0,1,114,0.0,86.0,86.0
0.079,6,10,1506,5,395,18.0,127.0,127.0,5,1111,17.0,843.0,843.0
0.004,6,10,1779,5,928,1.0,660.0,660.0,5,851,1.0,583.0,583.0
0.004,6,14,3742,8,504,0.0,80.0,80.0,6,3238,0.0,1470.0,1459.0
0.075,6,10,1506,5,395,17.0,127.0,127.0,5,1111,14.0,843.0,843.0
0.004,6,10,1989,5,927,1.0,659.0,659.0,5,1062,1.0,794.0,794.0
240.364,6,33,8637,17,1836,15022.0,569.0,188.0,16,6801,16024.0,1402.0,597.0
0.001,17,2,180,1,66,0.0,38.0,38.0,1,114,0.0,86.0,86.0
0.211,6,16,2669,8,1395,30.0,533.0,323.0,8,1274,19.0,529.0,212.0
0.005,6,10,2000,5,927,1.0,659.0,659.0,5,1073,1.0,805.0,805.0
240.161,6,31,9689,15,7245,17154.0,2370.0,718.0,16,2444,16010.0,580.0,200.0
0.006,6,10,1689,5,839,1.0,571.0,571.0,5,850,1.0,582.0,582.0
0.005,6,10,1547,5,764,1.0,496.0,496.0,5,783,1.0,515.0,515.0
0.067,6,10,1506,5,395,16.0,127.0,127.0,5,1111,15.0,843.0,843.0
0.005,6,10,2000,5,927,1.0,659.0,659.0,5,1073,1.0,805.0,805.0
0.009,6,10,1631,5,848,2.0,580.0,580.0,5,783,2.0,515.0,515.0
366.967,6,22,2313,16,867,24464.0,195.0,195.0,6,1446,4648.0,419.0,398.0
0.014,6,10,1983,5,910,3.0,642.0,642.0,5,1073,3.0,805.0,805.0
0.008,17,4,284,2,120,5.0,32.0,32.0,2,164,5.0,60.0,54.0
40.198,17,10,676,5,460,10047.0,104.0,64.0,5,216,10048.0,20.0,15.0
0.006,17,2,170,1,65,0.0,37.0,37.0,1,105,0.0,77.0,77.0
0.099,6,10,1506,5,395,23.0,127.0,127.0,5,1111,19.0,843.0,843.0
0.004,6,10,1702,5,863,1.0,595.0,595.0,5,839,1.0,571.0,571.0
0.106,6,10,1506,5,395,21.0,127.0,127.0,5,1111,23.0,843.0,843.0
0.008,6,10,1989,5,910,2.0,642.0,642.0,5,1079,2.0,811.0,811.0
0.02,6,10,1989,5,910,5.0,642.0,642.0,5,1079,5.0,811.0,811.0
0.006,6,10,1547,5,764,1.0,496.0,496.0,5,783,1.0,515.0,515.0
0.008,6,12,1698,6,863,1.0,327.0,271.0,6,835,1.0,515.0,515.0
0.015,6,10,1989,5,910,3.0,642.0,642.0,5,1079,3.0,811.0,811.0
0.005,6,10,1989,5,927,1.0,659.0,659.0,5,1062,1.0,794.0,794.0
0.004,6,10,2006,5,927,1.0,659.0,659.0,5,1079,1.0,811.0,811.0
0.005,6,10,1779,5,928,1.0,660.0,660.0,5,851,1.0,583.0,583.0
0.014,6,10,1990,5,911,3.0,643.0,643.0,5,1079,3.0,811.0,811.0
369.397,6,22,2313,16,867,24626.0,195.0,195.0,6,1446,4638.0,419.0,398.0
0.006,6,10,1643,5,860,1.0,592.0,592.0,5,783,1.0,515.0,515.0
0.121,6,10,1506,5,395,28.0,127.0,127.0,5,1111,27.0,843.0,843.0
0.076,6,10,1506,5,395,16.0,127.0,127.0,5,1111,15.0,843.0,843.0
300.302,6,16,2170,9,684,37516.0,146.0,146.0,7,1486,50021.0,419.0,398.0
0.001,17,2,180,1,66,0.0,38.0,38.0,1,114,0.0,86.0,86.0
0.006,6,10,1689,5,839,1.0,571.0,571.0,5,850,1.0,582.0,582.0
0.02,6,10,1989,5,910,4.0,642.0,642.0,5,1079,4.0,811.0,811.0
1754.961,6,471,67650,258,35614,6828.0,613.0,194.0,213,32036,8277.0,453.0,145.0
0.003,17,4,284,2,120,0.0,32.0,32.0,2,164,0.0,60.0,54.0
0.009,6,10,1989,5,910,2.0,642.0,642.0,5,1079,2.0,811.0,811.0
0.012,6,10,1631,5,848,3.0,580.0,580.0,5,783,3.0,515.0,515.0
0.018,6,10,1989,5,910,4.0,642.0,642.0,5,1079,4.0,811.0,811.0
0.006,6,10,1547,5,764,1.0,496.0,496.0,5,783,1.0,515.0,515.0
0.007,6,10,1774,5,923,1.0,655.0,655.0,5,851,1.0,583.0,583.0
0.005,6,14,3799,7,509,0.0,137.0,137.0,7,3290,0.0,1448.0,972.0
0.041,17,2,152,1,76,0.0,48.0,48.0,1,76,0.0,48.0,48.0
0.012,6,14,3787,7,497,2.0,125.0,125.0,7,3290,1.0,1448.0,972.0
0.009,6,12,1926,6,1189,1.0,659.0,434.0,6,737,1.0,417.0,417.0
95.95,58,5,360,4,288,31983.0,24.0,24.0,1,72,0.0,24.0,24.0
0.015,6,10,1983,5,910,3.0,642.0,642.0,5,1073,3.0,805.0,805.0
0.009,6,10,1972,5,910,2.0,642.0,642.0,5,1062,2.0,794.0,794.0
0.091,6,10,1506,5,395,19.0,127.0,127.0,5,1111,19.0,843.0,843.0
0.014,6,10,1989,5,910,3.0,642.0,642.0,5,1079,3.0,811.0,811.0
0.006,17,2,170,1,65,0.0,37.0,37.0,1,105,0.0,77.0,77.0
0.07,6,10,1506,5,395,13.0,127.0,127.0,5,1111,15.0,843.0,843.0
0.009,6,10,1989,5,910,2.0,642.0,642.0,5,1079,2.0,811.0,811.0
0.005,6,10,2007,5,928,1.0,660.0,660.0,5,1079,1.0,811.0,811.0
0.01,6,10,1762,5,911,2.0,643.0,643.0,5,851,2.0,583.0,583.0
0.01,6,10,1762,5,911,2.0,643.0,643.0,5,851,2.0,583.0,583.0
40.076,17,10,676,5,460,10017.0,104.0,64.0,5,216,10013.0,20.0,15.0
0.001,17,2,136,1,60,0.0,32.0,32.0,1,76,0.0,48.0,48.0
0.006,6,10,1547,5,764,1.0,496.0,496.0,5,783,1.0,515.0,515.0
0.076,6,10,1506,5,395,16.0,127.0,127.0,5,1111,16.0,843.0,843.0
0.005,6,10,2007,5,928,1.0,660.0,660.0,5,1079,1.0,811.0,811.0
0.041,17,2,148,1,60,0.0,32.0,32.0,1,88,0.0,60.0,60.0
0.006,6,10,1854,5,889,1.0,621.0,621.0,5,965,1.0,697.0,697.0
0.005,6,10,2007,5,928,1.0,660.0,660.0,5,1079,1.0,811.0,811.0
0.043,17,4,420,2,122,0.0,33.0,33.0,2,298,39.0,145.0,121.0
0.071,17,8,3613,4,1874,23.0,1350.0,440.0,4,1739,10.0,1350.0,406.0
0.037,17,2,136,1,60,0.0,32.0,32.0,1,76,0.0,48.0,48.0
0.003,17,4,284,2,120,0.0,32.0,32.0,2,164,0.0,60.0,54.0
40.079,17,10,676,5,460,10019.0,104.0,64.0,5,216,10018.0,20.0,15.0
15.079,17,15,9239,8,6902,2150.0,1350.0,834.0,7,2337,2508.0,1350.0,305.0
0.004,6,10,1702,5,863,1.0,595.0,595.0,5,839,1.0,571.0,571.0
0.018,6,13,3735,7,497,3.0,125.0,125.0,6,3238,3.0,1470.0,1459.0
0.007,6,10,1989,5,927,1.0,659.0,659.0,5,1062,1.0,794.0,794.0
0.097,6,10,1506,5,395,20.0,127.0,127.0,5,1111,22.0,843.0,843.0
0.008,6,12,1926,6,1189,1.0,659.0,434.0,6,737,1.0,417.0,417.0
0.01,6,10,1762,5,911,2.0,643.0,643.0,5,851,2.0,583.0,583.0
0.015,6,10,1989,5,910,3.0,642.0,642.0,5,1079,3.0,811.0,811.0
0.005,6,10,2006,5,927,1.0,659.0,659.0,5,1079,1.0,811.0,811.0
0.086,6,10,1506,5,395,17.0,127.0,127.0,5,1111,18.0,843.0,843.0
0.008,6,12,1926,6,1189,1.0,659.0,434.0,6,737,1.0,417.0,417.0
0.012,17,2,194,1,59,0.0,31.0,31.0,1,135,0.0,107.0,107.0
11.799,17,34,6341,17,3600,727.0,1145.0,183.0,17,2741,727.0,269.0,133.0
0.006,6,10,1689,5,839,1.0,571.0,571.0,5,850,1.0,582.0,582.0
240.09,6,33,9448,18,7163,14122.0,2130.0,692.0,15,2285,17149.0,580.0,187.0
0.2,17,4,352,2,130,0.0,37.0,37.0,2,222,3.0,89.0,83.0
0.072,17,2,136,1,60,0.0,32.0,32.0,1,76,0.0,48.0,48.0
240.039,6,22,3474,12,1820,21821.0,599.0,171.0,10,1654,26670.0,580.0,225.0
0.012,6,10,1989,5,910,3.0,642.0,642.0,5,1079,2.0,811.0,811.0
0.038,17,2,148,1,60,0.0,32.0,32.0,1,88,0.0,60.0,60.0
0.012,6,10,1972,5,910,3.0,642.0,642.0,5,1062,3.0,794.0,794.0
0.072,6,10,1506,5,395,16.0,127.0,127.0,5,1111,16.0,843.0,843.0
0.107,6,10,1506,5,395,21.0,127.0,127.0,5,1111,24.0,843.0,843.0
0.026,6,10,1972,5,910,6.0,642.0,642.0,5,1062,6.0,794.0,794.0
11.136,17,28,4422,14,1994,844.0,269.0,114.0,14,2428,844.0,587.0,145.0
0.011,6,10,1989,5,910,2.0,642.0,642.0,5,1079,2.0,811.0,811.0
0.001,17,2,180,1,65,0.0,37.0,37.0,1,115,0.0,87.0,87.0
0.01,6,10,1983,5,910,2.0,642.0,642.0,5,1073,2.0,805.0,805.0
308.91,17,20,1124,10,716,34316.0,48.0,43.0,10,408,34314.0,20.0,12.0
0.005,6,10,1643,5,860,1.0,592.0,592.0,5,783,1.0,515.0,515.0
0.039,17,4,284,2,120,0.0,32.0,32.0,2,164,36.0,60.0,54.0
40.06,17,10,676,5,460,10012.0,104.0,64.0,5,216,10013.0,20.0,15.0
0.006,6,10,1854,5,889,1.0,621.0,621.0,5,965,1.0,697.0,697.0
0.013,17,2,152,1,56,0.0,28.0,28.0,1,96,0.0,68.0,68.0
0.003,17,2,136,1,60,0.0,32.0,32.0,1,76,0.0,48.0,48.0
0.012,6,10,1972,5,910,3.0,642.0,642.0,5,1062,3.0,794.0,794.0
0.008,6,10,1983,5,910,2.0,642.0,642.0,5,1073,1.0,805.0,805.0
0.087,6,10,1506,5,395,21.0,127.0,127.0,5,1111,18.0,843.0,843.0
0.013,6,10,1990,5,911,3.0,643.0,643.0,5,1079,3.0,811.0,811.0
0.012,6,10,1983,5,910,2.0,642.0,642.0,5,1073,3.0,805.0,805.0
0.003,17,2,136,1,60,0.0,32.0,32.0,1,76,0.0,48.0,48.0
0.008,6,10,1972,5,910,2.0,642.0,642.0,5,1062,1.0,794.0,794.0
300.387,6,16,2170,9,684,37527.0,146.0,146.0,7,1486,50036.0,419.0,398.0
0.015,6,10,1972,5,910,3.0,642.0,642.0,5,1062,3.0,794.0,794.0
0.001,17,2,180,1,66,0.0,38.0,38.0,1,114,0.0,86.0,86.0
0.005,6,10,2007,5,928,1.0,660.0,660.0,5,1079,1.0,811.0,811.0
0.006,6,10,1689,5,839,1.0,571.0,571.0,5,850,1.0,582.0,582.0
0.004,17,4,420,2,122,0.0,33.0,33.0,2,298,1.0,145.0,121.0
0.013,6,10,1990,5,911,3.0,643.0,643.0,5,1079,3.0,811.0,811.0
0.124,6,10,1506,5,395,29.0,127.0,127.0,5,1111,26.0,843.0,843.0
0.005,6,10,1779,5,928,1.0,660.0,660.0,5,851,1.0,583.0,583.0
0.001,17,2,166,1,75,0.0,47.0,47.0,1,91,0.0,63.0,63.0
0.008,6,10,1989,5,910,2.0,642.0,642.0,5,1079,2.0,811.0,811.0
0.075,17,2,234,1,61,0.0,33.0,33.0,1,173,0.0,145.0,145.0
0.006,17,2,170,1,65,0.0,37.0,37.0,1,105,0.0,77.0,77.0
0.01,6,10,1989,5,910,2.0,642.0,642.0,5,1079,2.0,811.0,811.0
0.013,17,2,179,1,71,0.0,43.0,43.0,1,108,0.0,80.0,80.0
0.016,6,10,1989,5,910,4.0,642.0,642.0,5,1079,4.0,811.0,811.0
0.013,17,2,152,1,56,0.0,28.0,28.0,1,96,0.0,68.0,68.0
0.102,6,10,1506,5,395,21.0,127.0,127.0,5,1111,22.0,843.0,843.0
0.005,17,2,164,1,74,0.0,46.0,46.0,1,90,0.0,62.0,62.0
0.005,6,10,2006,5,927,1.0,659.0,659.0,5,1079,1.0,811.0,811.0
0.011,6,10,1677,5,827,2.0,559.0,559.0,5,850,2.0,582.0,582.0
0.005,6,13,3747,7,509,0.0,137.0,137.0,6,3238,0.0,1470.0,1459.0
0.005,6,13,3747,7,509,0.0,137.0,137.0,6,3238,1.0,1470.0,1459.0
0.066,6,10,1506,5,395,14.0,127.0,127.0,5,1111,12.0,843.0,843.0
40.059,17,10,676,5,460,10012.0,104.0,64.0,5,216,10013.0,20.0,15.0
0.006,6,10,1689,5,839,1.0,571.0,571.0,5,850,1.0,582.0,582.0
1777.612,17,144,45504,72,22752,25036.0,288.0,288.0,72,22752,25036.0,288.0,288.0
368.702,6,22,2313,16,867,24580.0,195.0,195.0,6,1446,4635.0,419.0,398.0
0.004,17,4,284,2,120,0.0,32.0,32.0,2,164,0.0,60.0,54.0
78.389,6,21,8146,11,1985,84.0,1174.0,504.0,10,6161,8690.0,2720.0,958.0
0.016,6,10,1990,5,911,4.0,643.0,643.0,5,1079,3.0,811.0,811.0
0.005,6,10,2006,5,927,1.0,659.0,659.0,5,1079,1.0,811.0,811.0
0.011,6,10,1972,5,910,2.0,642.0,642.0,5,1062,2.0,794.0,794.0
0.008,6,13,3684,7,446,1.0,74.0,74.0,6,3238,1.0,1470.0,1459.0
0.009,6,10,1983,5,910,2.0,642.0,642.0,5,1073,2.0,805.0,805.0
0.006,6,10,1547,5,764,1.0,496.0,496.0,5,783,1.0,515.0,515.0
0.005,6,10,2006,5,927,1.0,659.0,659.0,5,1079,1.0,811.0,811.0
11.331,17,28,4424,14,1995,863.0,270.0,114.0,14,2429,863.0,588.0,145.0
0.005,6,10,2006,5,927,1.0,659.0,659.0,5,1079,1.0,811.0,811.0
0.019,6,10,1972,5,910,4.0,642.0,642.0,5,1062,4.0,794.0,794.0
1792.481,6,571,192880,281,164765,6401.0,2883.0,904.0,290,28115,6202.0,580.0,125.0
0.005,6,14,3742,8,504,0.0,80.0,80.0,6,3238,0.0,1470.0,1459.0
0.017,6,10,1972,5,910,4.0,642.0,642.0,5,1062,4.0,794.0,794.0
0.005,17,2,148,1,60,0.0,32.0,32.0,1,88,0.0,60.0,60.0
0.006,6,10,1547,5,764,1.0,496.0,496.0,5,783,1.0,515.0,515.0
0.009,6,10,1762,5,911,2.0,643.0,643.0,5,851,2.0,583.0,583.0
0.004,17,2,148,1,60,0.0,32.0,32.0,1,88,0.0,60.0,60.0
300.351,6,16,2170,9,684,37523.0,146.0,146.0,7,1486,50031.0,419.0,398.0
0.012,6,10,1989,5,910,3.0,642.0,642.0,5,1079,2.0,811.0,811.0
0.006,6,10,1774,5,923,1.0,655.0,655.0,5,851,1.0,583.0,583.0
0.001,17,2,180,1,66,0.0,38.0,38.0,1,114,0.0,86.0,86.0
0.008,17,2,140,1,62,0.0,34.0,34.0,1,78,0.0,50.0,50.0
0.116,6,10,1506,5,395,21.0,127.0,127.0,5,1111,23.0,843.0,843.0
0.01,6,10,1989,5,910,2.0,642.0,642.0,5,1079,2.0,811.0,811.0
0.015,6,10,1989,5,910,3.0,642.0,642.0,5,1079,3.0,811.0,811.0
0.01,6,10,1677,5,827,2.0,559.0,559.0,5,850,2.0,582.0,582.0
0.024,6,10,1990,5,911,5.0,643.0,643.0,5,1079,6.0,811.0,811.0
0.005,17,2,170,1,65,0.0,37.0,37.0,1,105,0.0,77.0,77.0
40.052,17,10,676,5,460,10012.0,104.0,64.0,5,216,10012.0,20.0,15.0
1792.712,6,485,98733,244,87503,7376.0,421.0,368.0,241,11230,7469.0,53.0,53.0
0.011,6,10,1989,5,910,2.0,642.0,642.0,5,1079,2.0,811.0,811.0
0.076,6,10,1506,5,395,15.0,127.0,127.0,5,1111,17.0,843.0,843.0
0.004,6,10,2006,5,927,1.0,659.0,659.0,5,1079,1.0,811.0,811.0
0.005,6,10,2006,5,927,1.0,659.0,659.0,5,1079,1.0,811.0,811.0
0.135,6,10,1506,5,395,30.0,127.0,127.0,5,1111,30.0,843.0,843.0
0.011,6,6,716,3,458,3.0,302.0,302.0,3,258,4.0,102.0,102.0
0.052,17,2,152,1,76,0.0,48.0,48.0,1,76,0.0,48.0,48.0
0.005,6,10,1989,5,927,1.0,659.0,659.0,5,1062,1.0,794.0,794.0
1777.342,17,144,45504,72,22752,25032.0,288.0,288.0,72,22752,25032.0,288.0,288.0
0.014,6,10,1972,5,910,3.0,642.0,642.0,5,1062,3.0,794.0,794.0
0.099,6,10,1506,5,395,22.0,127.0,127.0,5,1111,20.0,843.0,843.0
0.082,6,10,1506,5,395,19.0,127.0,127.0,5,1111,14.0,843.0,843.0
0.04,17,2,152,1,76,0.0,48.0,48.0,1,76,0.0,48.0,48.0
0.001,17,2,180,1,66,0.0,38.0,38.0,1,114,0.0,86.0,86.0
0.006,6,10,2006,5,927,1.0,659.0,659.0,5,1079,1.0,811.0,811.0
11.279,17,28,4421,14,1993,855.0,268.0,114.0,14,2428,855.0,587.0,145.0
40.063,17,10,676,5,460,10014.0,104.0,64.0,5,216,10015.0,20.0,15.0
0.006,6,10,1547,5,764,1.0,496.0,496.0,5,783,1.0,515.0,515.0
0.021,6,10,1989,5,910,5.0,642.0,642.0,5,1079,5.0,811.0,811.0
0.013,6,12,1926,6,1189,2.0,659.0,434.0,6,737,2.0,417.0,417.0
0.013,6,10,1990,5,911,3.0,643.0,643.0,5,1079,3.0,811.0,811.0
0.009,6,10,1972,5,910,2.0,642.0,642.0,5,1062,2.0,794.0,794.0
10.896,17,28,4418,14,1995,829.0,270.0,114.0,14,2423,829.0,586.0,145.0
361.809,6,19,1689,15,978,25843.0,190.0,190.0,4,711,80012.0,495.0,495.0
0.004,6,10,1702,5,863,1.0,595.0,595.0,5,839,1.0,571.0,571.0
0.013,6,10,1677,5,827,3.0,559.0,559.0,5,850,3.0,582.0,582.0
0.01,6,10,1989,5,910,2.0,642.0,642.0,5,1079,2.0,811.0,811.0
0.01,6,10,1989,5,910,2.0,642.0,642.0,5,1079,2.0,811.0,811.0
0.005,17,2,164,1,74,0.0,46.0,46.0,1,90,0.0,62.0,62.0
40.056,17,10,676,5,460,10012.0,104.0,64.0,5,216,10013.0,20.0,15.0
0.038,17,2,186,1,61,0.0,33.0,33.0,1,125,0.0,97.0,97.0
0.004,17,2,148,1,60,0.0,32.0,32.0,1,88,0.0,60.0,60.0
0.005,6,10,1989,5,927,1.0,659.0,659.0,5,1062,1.0,794.0,794.0
0.005,6,14,3742,7,452,0.0,80.0,80.0,7,3290,0.0,1448.0,972.0
0.005,6,10,2007,5,928,1.0,660.0,660.0,5,1079,1.0,811.0,811.0
0.021,6,10,1631,5,848,5.0,580.0,580.0,5,783,5.0,515.0,515.0
0.071,6,10,1506,5,395,17.0,127.0,127.0,5,1111,14.0,843.0,843.0
300.329,6,16,2170,9,684,37520.0,146.0,146.0,7,1486,50022.0,419.0,398.0
0.073,6,10,1506,5,395,16.0,127.0,127.0,5,1111,16.0,843.0,843.0
0.006,17,2,299,1,65,0.0,37.0,37.0,1,234,0.0,206.0,206.0
329.81,6,33,10376,18,2434,19400.0,676.0,298.0,15,7942,19268.0,1402.0,794.0
0.01,6,10,1990,5,911,2.0,643.0,643.0,5,1079,2.0,811.0,811.0
0.201,6,16,2669,8,1395,28.0,533.0,323.0,8,1274,18.0,529.0,212.0
0.053,17,2,144,1,64,0.0,36.0,36.0,1,80,0.0,52.0,52.0
0.005,6,10,1774,5,923,1.0,655.0,655.0,5,851,1.0,583.0,583.0
40.067,17,10,676,5,460,10015.0,104.0,64.0,5,216,10016.0,20.0,15.0
180.351,6,46,12107,26,3897,7213.0,1026.0,250.0,20,8210,9491.0,2694.0,551.0
381.482,6,22,2313,16,867,25432.0,195.0,195.0,6,1446,4643.0,419.0,398.0
0.006,6,10,1689,5,839,1.0,571.0,571.0,5,850,1.0,582.0,582.0
0.005,17,2,164,1,74,0.0,46.0,46.0,1,90,0.0,62.0,62.0
0.016,6,10,1990,5,911,4.0,643.0,643.0,5,1079,4.0,811.0,811.0
0.013,6,10,1762,5,911,3.0,643.0,643.0,5,851,3.0,583.0,583.0
0.118,6,10,1506,5,395,28.0,127.0,127.0,5,1111,21.0,843.0,843.0
308.458,17,20,1124,10,716,34258.0,48.0,43.0,10,408,34258.0,20.0,12.0
0.006,6,10,1779,5,928,1.0,660.0,660.0,5,851,1.0,583.0,583.0
40.053,17,10,676,5,460,10012.0,104.0,64.0,5,216,10012.0,20.0,15.0
0.007,17,2,179,1,71,0.0,43.0,43.0,1,108,0.0,80.0,80.0
0.014,6,10,1989,5,910,3.0,642.0,642.0,5,1079,3.0,811.0,811.0
0.016,6,10,1990,5,911,3.0,643.0,643.0,5,1079,4.0,811.0,811.0
0.29,6,10,1506,5,395,69.0,127.0,127.0,5,1111,61.0,843.0,843.0
0.005,6,10,2007,5,928,1.0,660.0,660.0,5,1079,1.0,811.0,811.0
0.005,6,10,1547,5,764,1.0,496.0,496.0,5,783,1.0,515.0,515.0
0.1,17,2,80,1,32,0.0,4.0,4.0,1,48,0.0,20.0,20.0
0.009,6,10,1972,5,910,2.0,642.0,642.0,5,1062,2.0,794.0,794.0
0.005,17,2,164,1,74,0.0,46.0,46.0,1,90,0.0,62.0,62.0
0.005,6,10,1989,5,927,1.0,659.0,659.0,5,1062,1.0,794.0,794.0
0.012,6,13,3735,7,497,2.0,125.0,125.0,6,3238,2.0,1470.0,1459.0
0.006,6,10,2006,5,927,1.0,659.0,659.0,5,1079,1.0,811.0,811.0
0.106,6,10,1506,5,395,24.0,127.0,127.0,5,1111,25.0,843.0,843.0
0.001,17,2,140,1,62,0.0,34.0,34.0,1,78,0.0,50.0,50.0
0.009,6,10,1762,5,911,2.0,643.0,643.0,5,851,2.0,583.0,583.0
0.019,6,10,1972,5,910,4.0,642.0,642.0,5,1062,4.0,794.0,794.0
300.303,6,16,2170,9,684,37517.0,146.0,146.0,7,1486,50022.0,419.0,398.0
0.099,6,10,1506,5,395,19.0,127.0,127.0,5,1111,22.0,843.0,843.0
0.013,6,10,1972,5,910,3.0,642.0,642.0,5,1062,3.0,794.0,794.0
0.006,6,10,2006,5,927,1.0,659.0,659.0,5,1079,1.0,811.0,811.0
40.059,17,10,676,5,460,10012.0,104.0,64.0,5,216,10013.0,20.0,15.0
310.249,17,20,1124,10,716,34457.0,48.0,43.0,10,408,34457.0,20.0,12.0
0.005,6,10,1854,5,889,1.0,621.0,621.0,5,965,1.0,697.0,697.0
0.005,6,10,2007,5,928,1.0,660.0,660.0,5,1079,1.0,811.0,811.0
169.093,17,78,11023,39,2601,4449.0,44.0,38.0,39,8422,4449.0,261.0,187.0
0.005,6,10,1774,5,923,1.0,655.0,655.0,5,851,1.0,583.0,583.0
0.005,6,10,2006,5,927,1.0,659.0,659.0,5,1079,1.0,811.0,811.0
0.001,17,2,180,1,66,0.0,38.0,38.0,1,114,0.0,86.0,86.0
0.001,17,2,142,1,63,0.0,35.0,35.0,1,79,0.0,51.0,51.0
0.008,6,10,1643,5,860,2.0,592.0,592.0,5,783,1.0,515.0,515.0
0.006,17,2,136,1,60,0.0,32.0,32.0,1,76,0.0,48.0,48.0
0.071,17,2,170,1,65,0.0,37.0,37.0,1,105,0.0,77.0,77.0
0.005,17,2,178,1,81,0.0,53.0,53.0,1,97,0.0,69.0,69.0
0.005,6,10,1643,5,860,1.0,592.0,592.0,5,783,1.0,515.0,515.0
0.128,17,2,166,1,75,0.0,47.0,47.0,1,91,0.0,63.0,63.0
0.041,6,10,1983,5,910,10.0,642.0,642.0,5,1073,10.0,805.0,805.0
0.001,17,2,180,1,66,0.0,38.0,38.0,1,114,0.0,86.0,86.0
0.006,6,10,1547,5,764,1.0,496.0,496.0,5,783,1.0,515.0,515.0
0.01,6,10,1972,5,910,2.0,642.0,642.0,5,1062,2.0,794.0,794.0
0.13,17,2,148,1,60,0.0,32.0,32.0,1,88,0.0,60.0,60.0
0.108,6,10,1506,5,395,24.0,127.0,127.0,5,1111,23.0,843.0,843.0
0.001,17,2,136,1,60,0.0,32.0,32.0,1,76,0.0,48.0,48.0
0.001,17,2,180,1,66,0.0,38.0,38.0,1,114,0.0,86.0,86.0
0.004,17,2,136,1,60,0.0,32.0,32.0,1,76,0.0,48.0,48.0
40.067,17,10,676,5,460,10015.0,104.0,64.0,5,216,10016.0,20.0,15.0
40.061,17,10,676,5,460,10014.0,104.0,64.0,5,216,10014.0,20.0,15.0
0.009,6,12,1926,6,1189,1.0,659.0,434.0,6,737,1.0,417.0,417.0
0.008,6,12,1926,6,1189,1.0,659.0,434.0,6,737,1.0,417.0,417.0
1712.203,6,63,7242,40,4347,43902.0,1640.0,113.0,23,2895,77819.0,1110.0,84.0
0.004,17,4,284,2,120,0.0,32.0,32.0,2,164,0.0,60.0,54.0
0.006,6,10,1547,5,764,1.0,496.0,496.0,5,783,1.0,515.0,515.0
0.009,6,12,1926,6,1189,1.0,659.0,434.0,6,737,1.0,417.0,417.0
0.031,6,10,1989,5,910,7.0,642.0,642.0,5,1079,7.0,811.0,811.0
0.184,17,2,213,1,69,0.0,41.0,41.0,1,144,0.0,116.0,116.0
0.01,6,14,3787,7,497,1.0,125.0,125.0,7,3290,1.0,1448.0,972.0
0.095,6,10,1506,5,395,20.0,127.0,127.0,5,1111,19.0,843.0,843.0
0.005,6,10,2007,5,928,1.0,660.0,660.0,5,1079,1.0,811.0,811.0
1770.39,17,92,8096,46,4048,39341.0,60.0,60.0,46,4048,39341.0,60.0,60.0
377.419,6,24,2405,17,919,23588.0,195.0,195.0,7,1486,3905.0,419.0,398.0
240.084,6,16,4480,9,963,30010.0,238.0,166.0,7,3517,40013.0,1402.0,786.0
0.004,17,2,148,1,60,0.0,32.0,32.0,1,88,0.0,60.0,60.0
72.563,6,22,7437,11,1305,118.0,530.0,277.0,11,6132,7239.0,2720.0,946.0
0.022,6,10,1989,5,910,5.0,642.0,642.0,5,1079,5.0,811.0,811.0
40.083,17,10,676,5,460,10015.0,104.0,64.0,5,216,10015.0,20.0,15.0
0.011,6,10,1990,5,911,2.0,643.0,643.0,5,1079,2.0,811.0,811.0
240.091,6,16,4480,9,963,30011.0,238.0,166.0,7,3517,40014.0,1402.0,786.0
0.085,6,10,1506,5,395,17.0,127.0,127.0,5,1111,20.0,843.0,843.0
292.716,6,403,348214,208,22385,1414.0,2736.0,889.0,195,325829,1508.0,2804.0,1744.0
40.064,17,10,676,5,460,10015.0,104.0,64.0,5,216,10015.0,20.0,15.0
0.083,6,10,1506,5,395,20.0,127.0,127.0,5,1111,18.0,843.0,843.0
0.096,6,10,1506,5,395,23.0,127.0,127.0,5,1111,21.0,843.0,843.0
0.006,6,10,2007,5,928,1.0,660.0,660.0,5,1079,1.0,811.0,811.0
0.057,6,10,1506,5,395,12.0,127.0,127.0,5,1111,13.0,843.0,843.0
0.002,17,2,166,1,75,0.0,47.0,47.0,1,91,0.0,63.0,63.0
0.026,6,10,1990,5,911,6.0,643.0,643.0,5,1079,6.0,811.0,811.0
0.101,6,10,1506,5,395,20.0,127.0,127.0,5,1111,20.0,843.0,843.0
0.005,6,10,2007,5,928,1.0,660.0,660.0,5,1079,1.0,811.0,811.0
0.005,6,13,3747,7,509,0.0,137.0,137.0,6,3238,0.0,1470.0,1459.0
0.127,6,10,1506,5,395,27.0,127.0,127.0,5,1111,27.0,843.0,843.0
0.041,17,2,182,1,65,0.0,37.0,37.0,1,117,0.0,89.0,89.0
0.016,6,10,1990,5,911,4.0,643.0,643.0,5,1079,4.0,811.0,811.0
0.02,6,10,1972,5,910,5.0,642.0,642.0,5,1062,5.0,794.0,794.0
0.006,6,10,2007,5,928,1.0,660.0,660.0,5,1079,1.0,811.0,811.0
0.011,6,10,1762,5,911,2.0,643.0,643.0,5,851,2.0,583.0,583.0
0.004,17,2,136,1,60,0.0,32.0,32.0,1,76,0.0,48.0,48.0
0.094,6,10,1506,5,395,21.0,127.0,127.0,5,1111,20.0,843.0,843.0
0.013,6,10,1677,5,827,3.0,559.0,559.0,5,850,3.0,582.0,582.0
0.006,6,10,1547,5,764,1.0,496.0,496.0,5,783,1.0,515.0,515.0
0.01,6,10,2007,5,928,2.0,660.0,660.0,5,1079,2.0,811.0,811.0
0.008,6,10,1989,5,910,2.0,642.0,642.0,5,1079,2.0,811.0,811.0
0.004,6,10,2007,5,928,1.0,660.0,660.0,5,1079,1.0,811.0,811.0
0.001,17,2,180,1,66,0.0,38.0,38.0,1,114,0.0,86.0,86.0
0.164,17,2,152,1,76,0.0,48.0,48.0,1,76,0.0,48.0,48.0
0.001,17,2,180,1,66,0.0,38.0,38.0,1,114,0.0,86.0,86.0
0.008,6,10,1762,5,911,2.0,643.0,643.0,5,851,2.0,583.0,583.0
15.078,17,16,8535,8,6303,2150.0,1350.0,759.0,8,2232,2149.0,1350.0,251.0
0.006,6,10,1547,5,764,1.0,496.0,496.0,5,783,1.0,515.0,515.0
40.058,17,10,676,5,460,10013.0,104.0,64.0,5,216,10013.0,20.0,15.0
40.063,17,10,676,5,460,10014.0,104.0,64.0,5,216,10014.0,20.0,15.0
0.117,6,10,1506,5,395,24.0,127.0,127.0,5,1111,25.0,843.0,843.0
0.011,6,13,3735,7,497,1.0,125.0,125.0,6,3238,2.0,1470.0,1459.0
0.005,17,2,222,1,65,0.0,37.0,37.0,1,157,0.0,129.0,129.0
0.01,6,10,1990,5,911,2.0,643.0,643.0,5,1079,2.0,811.0,811.0
0.006,6,10,1643,5,860,1.0,592.0,592.0,5,783,1.0,515.0,515.0
0.018,6,10,1990,5,911,4.0,643.0,643.0,5,1079,4.0,811.0,811.0
0.003,17,2,148,1,60,0.0,32.0,32.0,1,88,0.0,60.0,60.0
0.008,6,12,1926,6,1189,1.0,659.0,434.0,6,737,1.0,417.0,417.0
0.006,17,2,140,1,62,0.0,34.0,34.0,1,78,0.0,50.0,50.0
0.003,17,4,284,2,120,0.0,32.0,32.0,2,164,0.0,60.0,54.0
0.079,6,10,1506,5,395,17.0,127.0,127.0,5,1111,17.0,843.0,843.0
0.044,17,2,170,1,65,0.0,37.0,37.0,1,105,0.0,77.0,77.0
0.005,6,10,2006,5,927,1.0,659.0,659.0,5,1079,1.0,811.0,811.0
0.015,6,10,1989,5,910,3.0,642.0,642.0,5,1079,3.0,811.0,811.0
0.013,6,10,1972,5,910,3.0,642.0,642.0,5,1062,3.0,794.0,794.0
0.006,6,10,1689,5,839,1.0,571.0,571.0,5,850,1.0,582.0,582.0
0.005,6,10,1547,5,764,1.0,496.0,496.0,5,783,1.0,515.0,515.0
0.096,6,10,1506,5,395,20.0,127.0,127.0,5,1111,22.0,843.0,843.0
0.003,17,2,148,1,60,0.0,32.0,32.0,1,88,0.0,60.0,60.0
40.077,17,10,676,5,460,10016.0,104.0,64.0,5,216,10018.0,20.0,15.0
0.009,6,10,1983,5,910,2.0,642.0,642.0,5,1073,2.0,805.0,805.0
11.02,17,28,4423,14,1995,839.0,270.0,114.0,14,2428,839.0,587.0,145.0
361.768,6,21,1793,16,1030,24117.0,190.0,190.0,5,763,60009.0,462.0,247.0
256.111,6,10,839,5,488,64027.0,232.0,232.0,5,351,64027.0,83.0,83.0
0.012,6,10,1990,5,911,3.0,643.0,643.0,5,1079,3.0,811.0,811.0
0.005,6,14,3799,7,509,0.0,137.0,137.0,7,3290,0.0,1448.0,972.0
0.144,6,10,1506,5,395,32.0,127.0,127.0,5,1111,33.0,843.0,843.0
0.074,6,10,1506,5,395,16.0,127.0,127.0,5,1111,16.0,843.0,843.0
0.131,17,4,284,2,120,0.0,32.0,32.0,2,164,128.0,60.0,54.0
0.09,6,10,1506,5,395,20.0,127.0,127.0,5,1111,19.0,843.0,843.0
0.005,17,2,170,1,65,0.0,37.0,37.0,1,105,0.0,77.0,77.0
0.006,17,2,214,1,75,0.0,47.0,47.0,1,139,0.0,111.0,111.0
0.077,6,10,1506,5,395,19.0,127.0,127.0,5,1111,15.0,843.0,843.0
9.041,17,6,376,5,280,2260.0,28.0,28.0,1,96,0.0,68.0,68.0
77.231,6,21,8146,11,1985,85.0,1174.0,504.0,10,6161,8562.0,2720.0,958.0
0.005,6,10,2006,5,927,1.0,659.0,659.0,5,1079,1.0,811.0,811.0
40.071,17,10,676,5,460,10015.0,104.0,64.0,5,216,10017.0,20.0,15.0
40.065,17,10,676,5,460,10014.0,104.0,64.0,5,216,10015.0,20.0,15.0
0.004,17,2,148,1,60,0.0,32.0,32.0,1,88,0.0,60.0,60.0
0.005,6,10,2006,5,927,1.0,659.0,659.0,5,1079,1.0,811.0,811.0
0.004,6,10,2000,5,927,1.0,659.0,659.0,5,1073,1.0,805.0,805.0
0.001,17,2,166,1,75,0.0,47.0,47.0,1,91,0.0,63.0,63.0
0.006,6,10,1643,5,860,1.0,592.0,592.0,5,783,1.0,515.0,515.0
15.077,17,15,9238,8,6902,2149.0,1350.0,834.0,7,2336,2507.0,1350.0,305.0
0.177,6,18,8128,10,808,19.0,280.0,280.0,8,7320,24.0,1402.0,1379.0
0.174,17,2,152,1,76,0.0,48.0,48.0,1,76,0.0,48.0,48.0
0.012,6,10,1972,5,910,3.0,642.0,642.0,5,1062,3.0,794.0,794.0
308.923,17,20,1124,10,716,34311.0,48.0,43.0,10,408,34311.0,20.0,12.0
0.039,17,4,284,2,120,0.0,32.0,32.0,2,164,35.0,60.0,54.0
0.072,17,2,170,1,65,0.0,37.0,37.0,1,105,0.0,77.0,77.0
0.003,17,2,136,1,60,0.0,32.0,32.0,1,76,0.0,48.0,48.0
0.006,6,10,1547,5,764,1.0,496.0,496.0,5,783,1.0,515.0,515.0
366.457,6,22,2313,16,867,24430.0,195.0,195.0,6,1446,4638.0,419.0,398.0
0.005,6,13,3747,7,509,0.0,137.0,137.0,6,3238,0.0,1470.0,1459.0
0.004,17,2,142,1,63,0.0,35.0,35.0,1,79,0.0,51.0,51.0
0.006,17,2,209,1,64,0.0,36.0,36.0,1,145,0.0,117.0,117.0
0.005,6,10,2000,5,927,1.0,659.0,659.0,5,1073,1.0,805.0,805.0
240.105,6,16,4482,9,963,30013.0,238.0,166.0,7,3519,40017.0,1402.0,786.0
0.001,17,2,166,1,75,0.0,47.0,47.0,1,91,0.0,63.0,63.0
0.009,6,10,1631,5,848,2.0,580.0,580.0,5,783,2.0,515.0,515.0
0.005,6,10,1779,5,928,1.0,660.0,660.0,5,851,1.0,583.0,583.0
0.069,6,10,1506,5,395,14.0,127.0,127.0,5,1111,14.0,843.0,843.0
0.164,17,2,152,1,76,0.0,48.0,48.0,1,76,0.0,48.0,48.0
0.038,17,2,412,1,61,0.0,33.0,33.0,1,351,0.0,323.0,323.0
0.091,6,10,1506,5,395,20.0,127.0,127.0,5,1111,18.0,843.0,843.0
0.037,17,2,186,1,61,0.0,33.0,33.0,1,125,0.0,97.0,97.0
0.007,6,10,1547,5,764,1.0,496.0,496.0,5,783,1.0,515.0,515.0
0.003,17,4,284,2,120,0.0,32.0,32.0,2,164,0.0,60.0,54.0
0.065,6,10,1506,5,395,15.0,127.0,127.0,5,1111,13.0,843.0,843.0
0.014,6,10,1990,5,911,3.0,643.0,643.0,5,1079,3.0,811.0,811.0
0.007,17,4,284,2,120,0.0,32.0,32.0,2,164,1.0,60.0,54.0
243.146,6,35,9403,15,6653,17367.0,1779.0,653.0,20,2750,12796.0,580.0,154.0
0.006,6,10,1547,5,764,1.0,496.0,496.0,5,783,1.0,515.0,515.0
0.003,17,2,148,1,60,0.0,32.0,32.0,1,88,0.0,60.0,60.0
11.195,17,28,4421,14,1993,848.0,268.0,114.0,14,2428,848.0,587.0,145.0
0.008,6,10,1677,5,827,2.0,559.0,559.0,5,850,1.0,582.0,582.0
0.007,17,2,200,1,68,0.0,40.0,40.0,1,132,0.0,104.0,104.0
0.037,17,2,136,1,60,0.0,32.0,32.0,1,76,0.0,48.0,48.0
0.012,6,10,1990,5,911,2.0,643.0,643.0,5,1079,2.0,811.0,811.0
0.006,6,10,1689,5,839,1.0,571.0,571.0,5,850,1.0,582.0,582.0
0.005,6,10,2000,5,927,1.0,659.0,659.0,5,1073,1.0,805.0,805.0
0.004,6,10,1774,5,923,1.0,655.0,655.0,5,851,1.0,583.0,583.0
0.005,17,2,214,1,75,0.0,47.0,47.0,1,139,0.0,111.0,111.0
0.003,17,2,148,1,60,0.0,32.0,32.0,1,88,0.0,60.0,60.0
0.004,17,2,148,1,60,0.0,32.0,32.0,1,88,0.0,60.0,60.0
0.012,6,10,1983,5,910,2.0,642.0,642.0,5,1073,2.0,805.0,805.0
0.004,17,2,136,1,60,0.0,32.0,32.0,1,76,0.0,48.0,48.0
0.114,6,10,1506,5,395,15.0,127.0,127.0,5,1111,25.0,843.0,843.0
0.005,6,10,1854,5,889,1.0,621.0,621.0,5,965,1.0,697.0,697.0
0.017,6,10,1990,5,911,4.0,643.0,643.0,5,1079,4.0,811.0,811.0
0.004,6,10,1702,5,863,1.0,595.0,595.0,5,839,1.0,571.0,571.0
0.004,17,2,148,1,60,0.0,32.0,32.0,1,88,0.0,60.0,60.0
0.014,6,13,3735,7,497,2.0,125.0,125.0,6,3238,2.0,1470.0,1459.0
0.005,6,10,2006,5,927,1.0,659.0,659.0,5,1079,1.0,811.0,811.0
0.039,17,4,284,2,120,0.0,32.0,32.0,2,164,34.0,60.0,54.0
0.01,6,13,3735,7,497,1.0,125.0,125.0,6,3238,2.0,1470.0,1459.0
0.004,6,10,1702,5,863,0.0,595.0,595.0,5,839,1.0,571.0,571.0
0.015,6,10,1990,5,911,3.0,643.0,643.0,5,1079,3.0,811.0,811.0
11.104,17,28,4422,14,1993,841.0,268.0,114.0,14,2429,841.0,588.0,145.0
0.086,6,10,1506,5,395,20.0,127.0,127.0,5,1111,16.0,843.0,843.0
0.009,6,10,1983,5,910,2.0,642.0,642.0,5,1073,2.0,805.0,805.0
240.095,6,16,4481,9,963,30011.0,238.0,166.0,7,3518,40015.0,1402.0,786.0
0.116,6,10,1506,5,395,27.0,127.0,127.0,5,1111,23.0,843.0,843.0
0.006,6,10,1547,5,764,1.0,496.0,496.0,5,783,1.0,515.0,515.0
0.006,6,10,1547,5,764,1.0,496.0,496.0,5,783,1.0,515.0,515.0
0.104,6,10,1506,5,395,23.0,127.0,127.0,5,1111,22.0,843.0,843.0
0.072,6,10,1506,5,395,15.0,127.0,127.0,5,1111,16.0,843.0,843.0
0.004,6,10,2000,5,927,1.0,659.0,659.0,5,1073,1.0,805.0,805.0
0.006,6,10,1854,5,889,1.0,621.0,621.0,5,965,1.0,697.0,697.0
0.015,6,10,1990,5,911,3.0,643.0,643.0,5,1079,3.0,811.0,811.0
0.038,6,10,1631,5,848,9.0,580.0,580.0,5,783,9.0,515.0,515.0
0.005,6,10,1689,5,839,1.0,571.0,571.0,5,850,1.0,582.0,582.0
0.005,6,10,1989,5,927,1.0,659.0,659.0,5,1062,1.0,794.0,794.0
0.017,6,10,1989,5,910,4.0,642.0,642.0,5,1079,4.0,811.0,811.0
40.062,17,10,676,5,460,10013.0,104.0,64.0,5,216,10014.0,20.0,15.0
243.122,6,21,6492,12,1402,22102.0,253.0,195.0,9,5090,30389.0,1402.0,769.0
0.004,17,4,284,2,120,0.0,32.0,32.0,2,164,0.0,60.0,54.0
0.017,6,10,1989,5,910,4.0,642.0,642.0,5,1079,4.0,811.0,811.0
0.012,6,10,1990,5,911,2.0,643.0,643.0,5,1079,3.0,811.0,811.0
0.118,17,2,80,1,32,0.0,4.0,4.0,1,48,0.0,20.0,20.0
0.174,17,2,152,1,76,0.0,48.0,48.0,1,76,0.0,48.0,48.0
0.094,6,10,1506,5,395,20.0,127.0,127.0,5,1111,22.0,843.0,843.0
0.01,6,10,1631,5,848,2.0,580.0,580.0,5,783,2.0,515.0,515.0
0.116,6,10,1506,5,395,27.0,127.0,127.0,5,1111,25.0,843.0,843.0
361.849,6,19,1689,15,978,25846.0,190.0,190.0,4,711,80013.0,495.0,495.0
0.008,6,10,1779,5,928,2.0,660.0,660.0,5,851,1.0,583.0,583.0
0.004,6,10,1774,5,923,1.0,655.0,655.0,5,851,1.0,583.0,583.0
0.097,6,10,1506,5,395,21.0,127.0,127.0,5,1111,21.0,843.0,843.0
240.011,6,9,787,5,488,60002.0,232.0,232.0,4,299,80002.0,83.0,83.0
0.071,17,4,420,2,122,0.0,33.0,33.0,2,298,30.0,145.0,121.0
0.005,6,10,2000,5,927,1.0,659.0,659.0,5,1073,1.0,805.0,805.0
0.012,6,10,1983,5,910,2.0,642.0,642.0,5,1073,3.0,805.0,805.0
0.004,17,2,136,1,60,0.0,32.0,32.0,1,76,0.0,48.0,48.0
0.005,6,10,1689,5,839,1.0,571.0,571.0,5,850,1.0,582.0,582.0
0.006,6,10,1774,5,923,1.0,655.0,655.0,5,851,1.0,583.0,583.0
0.008,6,10,1989,5,910,2.0,642.0,642.0,5,1079,1.0,811.0,811.0
0.005,6,10,1989,5,927,1.0,659.0,659.0,5,1062,1.0,794.0,794.0
0.008,6,10,1989,5,910,2.0,642.0,642.0,5,1079,2.0,811.0,811.0
0.01,6,10,1972,5,910,2.0,642.0,642.0,5,1062,2.0,794.0,794.0
0.004,6,10,1989,5,927,1.0,659.0,659.0,5,1062,1.0,794.0,794.0
0.009,6,10,1989,5,910,2.0,642.0,642.0,5,1079,2.0,811.0,811.0
0.007,6,10,1547,5,764,1.0,496.0,496.0,5,783,1.0,515.0,515.0
0.02,6,10,1989,5,910,4.0,642.0,642.0,5,1079,4.0,811.0,811.0
0.021,17,4,284,2,120,0.0,32.0,32.0,2,164,1.0,60.0,54.0
0.015,6,10,1990,5,911,3.0,643.0,643.0,5,1079,3.0,811.0,811.0
11.182,17,28,4424,14,1995,847.0,270.0,114.0,14,2429,847.0,588.0,145.0
0.004,6,10,2006,5,927,1.0,659.0,659.0,5,1079,1.0,811.0,811.0
309.767,17,20,1124,10,716,34411.0,48.0,43.0,10,408,34411.0,20.0,12.0
0.213,6,10,1506,5,395,52.0,127.0,127.0,5,1111,48.0,843.0,843.0
0.005,6,10,2006,5,927,1.0,659.0,659.0,5,1079,1.0,811.0,811.0
240.031,6,9,787,5,488,60007.0,232.0,232.0,4,299,80009.0,83.0,83.0
0.095,6,10,1506,5,395,21.0,127.0,127.0,5,1111,20.0,843.0,843.0
0.104,6,10,1506,5,395,23.0,127.0,127.0,5,1111,23.0,843.0,843.0
0.005,6,10,2006,5,927,1.0,659.0,659.0,5,1079,1.0,811.0,811.0
0.003,17,2,136,1,60,0.0,32.0,32.0,1,76,0.0,48.0,48.0
0.009,6,10,2000,5,927,2.0,659.0,659.0,5,1073,2.0,805.0,805.0
0.006,6,10,1854,5,889,1.0,621.0,621.0,5,965,1.0,697.0,697.0
0.003,17,2,148,1,60,0.0,32.0,32.0,1,88,0.0,60.0,60.0
0.015,6,10,1990,5,911,3.0,643.0,643.0,5,1079,3.0,811.0,811.0
0.011,6,10,1989,5,910,2.0,642.0,642.0,5,1079,2.0,811.0,811.0
0.011,6,10,1689,5,839,2.0,571.0,571.0,5,850,2.0,582.0,582.0
0.009,6,10,1677,5,827,2.0,559.0,559.0,5,850,2.0,582.0,582.0
167.399,17,66,9357,33,2193,5231.0,44.0,38.0,33,7164,5231.0,239.0,189.0
0.067,17,2,152,1,76,0.0,48.0,48.0,1,76,0.0,48.0,48.0
0.008,6,12,1926,6,1189,1.0,659.0,434.0,6,737,1.0,417.0,417.0
0.005,6,10,1702,5,863,1.0,595.0,595.0,5,839,1.0,571.0,571.0
366.231,6,22,2313,16,867,24415.0,195.0,195.0,6,1446,4645.0,419.0,398.0
0.024,6,10,1972,5,910,6.0,642.0,642.0,5,1062,6.0,794.0,794.0
0.012,6,10,1972,5,910,3.0,642.0,642.0,5,1062,3.0,794.0,794.0
0.005,6,10,2007,5,928,1.0,660.0,660.0,5,1079,1.0,811.0,811.0
0.005,6,10,2006,5,927,1.0,659.0,659.0,5,1079,1.0,811.0,811.0
0.005,6,10,2007,5,928,1.0,660.0,660.0,5,1079,1.0,811.0,811.0
0.066,6,10,1506,5,395,14.0,127.0,127.0,5,1111,14.0,843.0,843.0
0.005,6,10,2006,5,927,1.0,659.0,659.0,5,1079,1.0,811.0,811.0
300.213,6,19,3163,11,1855,30021.0,676.0,318.0,8,1308,34315.0,695.0,294.0
0.004,17,2,148,1,60,0.0,32.0,32.0,1,88,0.0,60.0,60.0
0.012,6,10,1983,5,910,2.0,642.0,642.0,5,1073,2.0,805.0,805.0
0.005,6,10,1779,5,928,1.0,660.0,660.0,5,851,1.0,583.0,583.0
0.097,6,10,1506,5,395,21.0,127.0,127.0,5,1111,23.0,843.0,843.0
0.006,6,10,1547,5,764,1.0,496.0,496.0,5,783,1.0,515.0,515.0
0.014,17,2,148,1,60,0.0,32.0,32.0,1,88,0.0,60.0,60.0
0.013,6,10,1983,5,910,3.0,642.0,642.0,5,1073,3.0,805.0,805.0
0.013,6,10,1972,5,910,3.0,642.0,642.0,5,1062,3.0,794.0,794.0
0.01,6,10,1990,5,911,2.0,643.0,643.0,5,1079,2.0,811.0,811.0
176.269,17,74,10538,37,2458,4896.0,44.0,38.0,37,8080,4896.0,261.0,190.0
40.05,17,10,676,5,460,10011.0,104.0,64.0,5,216,10011.0,20.0,15.0
0.107,6,10,1506,5,395,24.0,127.0,127.0,5,1111,23.0,843.0,843.0
0.016,6,10,1990,5,911,4.0,643.0,643.0,5,1079,4.0,811.0,811.0
0.005,6,10,1689,5,839,1.0,571.0,571.0,5,850,1.0,582.0,582.0
0.005,6,13,3690,7,452,0.0,80.0,80.0,6,3238,0.0,1470.0,1459.0
0.005,6,13,3747,7,509,0.0,137.0,137.0,6,3238,1.0,1470.0,1459.0
0.003,17,4,284,2,120,0.0,32.0,32.0,2,164,0.0,60.0,54.0
0.001,17,2,180,1,66,0.0,38.0,38.0,1,114,0.0,86.0,86.0
0.136,6,10,1506,5,395,30.0,127.0,127.0,5,1111,31.0,843.0,843.0
0.012,6,10,1989,5,910,2.0,642.0,642.0,5,1079,3.0,811.0,811.0
0.012,6,10,1989,5,910,2.0,642.0,642.0,5,1079,2.0,811.0,811.0
0.005,6,10,2006,5,927,1.0,659.0,659.0,5,1079,1.0,811.0,811.0
40.058,17,10,676,5,460,10013.0,104.0,64.0,5,216,10013.0,20.0,15.0
0.102,6,10,1506,5,395,21.0,127.0,127.0,5,1111,23.0,843.0,843.0
0.136,6,10,1506,5,395,31.0,127.0,127.0,5,1111,33.0,843.0,843.0
0.023,6,10,1677,5,827,5.0,559.0,559.0,5,850,5.0,582.0,582.0
0.046,17,2,170,1,65,0.0,37.0,37.0,1,105,0.0,77.0,77.0
0.005,6,10,1643,5,860,1.0,592.0,592.0,5,783,1.0,515.0,515.0
0.005,6,13,3690,7,452,0.0,80.0,80.0,6,3238,1.0,1470.0,1459.0
0.004,17,2,148,1,60,0.0,32.0,32.0,1,88,0.0,60.0,60.0
0.006,6,10,1547,5,764,1.0,496.0,496.0,5,783,1.0,515.0,515.0
40.054,17,10,676,5,460,10012.0,104.0,64.0,5,216,10012.0,20.0,15.0
1778.402,17,144,41760,72,22752,25047.0,288.0,288.0,72,19008,25047.0,236.0,236.0
0.012,6,10,1989,5,910,2.0,642.0,642.0,5,1079,2.0,811.0,811.0
0.008,6,14,3787,7,497,1.0,125.0,125.0,7,3290,1.0,1448.0,972.0
0.031,17,2,136,1,60,0.0,32.0,32.0,1,76,0.0,48.0,48.0
0.004,6,10,2000,5,927,1.0,659.0,659.0,5,1073,1.0,805.0,805.0
40.051,17,10,676,5,460,10011.0,104.0,64.0,5,216,10012.0,20.0,15.0
0.013,6,10,1983,5,910,3.0,642.0,642.0,5,1073,3.0,805.0,805.0
0.249,17,4,596,2,122,177.0,33.0,33.0,2,474,177.0,323.0,209.0
0.005,6,10,2007,5,928,1.0,660.0,660.0,5,1079,1.0,811.0,811.0
0.005,6,10,2006,5,927,1.0,659.0,659.0,5,1079,1.0,811.0,811.0
0.004,6,10,2007,5,928,1.0,660.0,660.0,5,1079,1.0,811.0,811.0
0.014,6,10,1631,5,848,3.0,580.0,580.0,5,783,3.0,515.0,515.0
0.003,17,2,148,1,60,0.0,32.0,32.0,1,88,0.0,60.0,60.0
0.001,17,2,180,1,66,0.0,38.0,38.0,1,114,0.0,86.0,86.0
0.004,6,10,1702,5,863,1.0,595.0,595.0,5,839,1.0,571.0,571.0
291.483,6,316,343843,125,18048,2350.0,2736.0,888.0,191,325795,1534.0,2804.0,1784.0
0.007,17,2,194,1,59,0.0,31.0,31.0,1,135,0.0,107.0,107.0
0.006,6,10,1689,5,839,1.0,571.0,571.0,5,850,1.0,582.0,582.0
176.095,17,86,12109,43,2876,4192.0,44.0,38.0,43,9233,4192.0,239.0,186.0
0.004,6,10,1702,5,863,0.0,595.0,595.0,5,839,1.0,571.0,571.0
0.04,17,2,412,1,61,0.0,33.0,33.0,1,351,0.0,323.0,323.0
0.006,6,10,2006,5,927,1.0,659.0,659.0,5,1079,1.0,811.0,811.0
0.005,6,10,2006,5,927,1.0,659.0,659.0,5,1079,1.0,811.0,811.0
177.389,17,84,11748,42,2808,4326.0,44.0,38.0,42,8940,4326.0,239.0,184.0
243.285,6,36,9691,15,6820,17377.0,1943.0,671.0,21,2871,12164.0,580.0,147.0
1729.229,6,62,4504,40,2740,44339.0,33.0,33.0,22,1764,82336.0,31.0,31.0
0.005,6,10,2006,5,927,1.0,659.0,659.0,5,1079,1.0,811.0,811.0
0.004,17,4,284,2,120,0.0,32.0,32.0,2,164,0.0,60.0,54.0
0.058,6,10,1506,5,395,12.0,127.0,127.0,5,1111,13.0,843.0,843.0
0.039,17,2,148,1,60,0.0,32.0,32.0,1,88,0.0,60.0,60.0
0.015,6,10,1989,5,910,3.0,642.0,642.0,5,1079,3.0,811.0,811.0
0.005,6,10,1989,5,927,1.0,659.0,659.0,5,1062,1.0,794.0,794.0
0.005,6,10,1989,5,927,1.0,659.0,659.0,5,1062,1.0,794.0,794.0
0.004,6,10,2007,5,928,1.0,660.0,660.0,5,1079,1.0,811.0,811.0
0.005,6,10,1989,5,927,1.0,659.0,659.0,5,1062,1.0,794.0,794.0
0.001,17,2,180,1,66,0.0,38.0,38.0,1,114,0.0,86.0,86.0
0.061,6,10,1506,5,395,13.0,127.0,127.0,5,1111,14.0,843.0,843.0
0.005,6,10,2000,5,927,1.0,659.0,659.0,5,1073,1.0,805.0,805.0
0.017,6,10,1989,5,910,4.0,642.0,642.0,5,1079,4.0,811.0,811.0
0.006,6,10,1547,5,764,1.0,496.0,496.0,5,783,1.0,515.0,515.0
1730.4,6,45,2790,30,1725,59668.0,35.0,35.0,15,1065,123594.0,31.0,31.0
0.005,17,2,154,1,69,0.0,41.0,41.0,1,85,0.0,57.0,57.0
0.006,6,10,1547,5,764,1.0,496.0,496.0,5,783,1.0,515.0,515.0
0.005,17,2,169,1,62,0.0,34.0,34.0,1,107,0.0,79.0,79.0
0.139,6,10,1506,5,395,33.0,127.0,127.0,5,1111,27.0,843.0,843.0
0.005,6,10,1989,5,927,1.0,659.0,659.0,5,1062,1.0,794.0,794.0
0.101,6,10,1506,5,395,22.0,127.0,127.0,5,1111,20.0,843.0,843.0
0.004,6,10,2007,5,928,1.0,660.0,660.0,5,1079,1.0,811.0,811.0
301.024,6,47,16559,25,10652,12542.0,2720.0,1068.0,22,5907,421.0,2667.0,385.0
0.001,17,2,180,1,66,0.0,38.0,38.0,1,114,0.0,86.0,86.0
0.038,17,4,284,2,120,0.0,32.0,32.0,2,164,35.0,60.0,54.0
0.016,17,2,198,1,91,0.0,63.0,63.0,1,107,0.0,79.0,79.0
0.006,6,10,2006,5,927,1.0,659.0,659.0,5,1079,1.0,811.0,811.0
0.011,6,10,1990,5,911,2.0,643.0,643.0,5,1079,2.0,811.0,811.0
0.012,6,10,1983,5,910,3.0,642.0,642.0,5,1073,2.0,805.0,805.0
0.019,6,10,1989,5,910,4.0,642.0,642.0,5,1079,4.0,811.0,811.0
0.005,6,10,2006,5,927,1.0,659.0,659.0,5,1079,1.0,811.0,811.0
300.375,6,16,2170,9,684,37525.0,146.0,146.0,7,1486,50034.0,419.0,398.0
0.005,17,2,213,1,69,0.0,41.0,41.0,1,144,0.0,116.0,116.0
9.045,17,6,376,5,280,2261.0,28.0,28.0,1,96,0.0,68.0,68.0
0.066,6,10,1506,5,395,13.0,127.0,127.0,5,1111,13.0,843.0,843.0
0.014,6,10,1972,5,910,3.0,642.0,642.0,5,1062,3.0,794.0,794.0
10.803,17,28,4418,14,1994,822.0,269.0,114.0,14,2424,822.0,587.0,145.0
0.011,6,10,1990,5,911,2.0,643.0,643.0,5,1079,2.0,811.0,811.0
0.005,6,10,1779,5,928,1.0,660.0,660.0,5,851,1.0,583.0,583.0
291.841,6,405,349406,194,21659,1512.0,2736.0,889.0,211,327747,1389.0,3036.0,1607.0
0.005,17,2,170,1,65,0.0,37.0,37.0,1,105,0.0,77.0,77.0
0.09,17,2,156,1,64,0.0,36.0,36.0,1,92,0.0,64.0,64.0
0.004,6,10,2007,5,928,1.0,660.0,660.0,5,1079,1.0,811.0,811.0
40.074,17,10,676,5,460,10017.0,104.0,64.0,5,216,10017.0,20.0,15.0
0.019,6,10,1762,5,911,4.0,643.0,643.0,5,851,4.0,583.0,583.0
0.202,6,16,2778,8,1396,28.0,533.0,324.0,8,1382,18.0,529.0,239.0
240.015,6,9,787,5,488,60003.0,232.0,232.0,4,299,80004.0,83.0,83.0
0.009,6,12,1926,6,1189,1.0,659.0,434.0,6,737,1.0,417.0,417.0
0.008,6,10,1677,5,827,2.0,559.0,559.0,5,850,2.0,582.0,582.0
0.004,17,2,144,1,64,0.0,36.0,36.0,1,80,0.0,52.0,52.0
0.013,17,2,152,1,56,0.0,28.0,28.0,1,96,0.0,68.0,68.0
0.174,6,3,453,2,321,174.0,241.0,241.0,1,132,0.0,92.0,92.0
240.083,6,16,4481,9,963,30010.0,238.0,166.0,7,3518,40013.0,1402.0,786.0
0.006,6,10,1547,5,764,1.0,496.0,496.0,5,783,1.0,515.0,515.0
0.005,6,10,2006,5,927,1.0,659.0,659.0,5,1079,1.0,811.0,811.0
0.086,6,10,1506,5,395,19.0,127.0,127.0,5,1111,20.0,843.0,843.0
240.365,6,36,9390,18,1885,14138.0,569.0,188.0,18,7505,14138.0,1402.0,547.0
0.015,6,10,1972,5,910,3.0,642.0,642.0,5,1062,3.0,794.0,794.0
0.004,17,2,396,1,61,0.0,33.0,33.0,1,335,0.0,307.0,307.0
0.005,6,10,2007,5,928,1.0,660.0,660.0,5,1079,1.0,811.0,811.0
0.031,6,10,1972,5,910,7.0,642.0,642.0,5,1062,7.0,794.0,794.0
0.014,6,10,1631,5,848,3.0,580.0,580.0,5,783,3.0,515.0,515.0
0.006,6,10,1854,5,889,1.0,621.0,621.0,5,965,1.0,697.0,697.0
0.013,6,10,1990,5,911,3.0,643.0,643.0,5,1079,3.0,811.0,811.0
240.067,6,21,4925,11,941,24006.0,180.0,93.0,10,3984,26673.0,1592.0,576.0
0.005,6,10,2007,5,928,1.0,660.0,660.0,5,1079,1.0,811.0,811.0
0.135,6,10,1506,5,395,32.0,127.0,127.0,5,1111,28.0,843.0,843.0
0.005,17,2,164,1,74,0.0,46.0,46.0,1,90,0.0,62.0,62.0
0.041,17,2,136,1,60,0.0,32.0,32.0,1,76,0.0,48.0,48.0
0.074,6,10,1506,5,395,17.0,127.0,127.0,5,1111,17.0,843.0,843.0
0.169,6,10,1506,5,395,22.0,127.0,127.0,5,1111,39.0,843.0,843.0
0.011,6,10,1989,5,910,2.0,642.0,642.0,5,1079,2.0,811.0,811.0
0.003,17,2,152,1,76,0.0,48.0,48.0,1,76,0.0,48.0,48.0
0.009,6,13,3735,7,497,1.0,125.0,125.0,6,3238,1.0,1470.0,1459.0
0.001,17,2,180,1,66,0.0,38.0,38.0,1,114,0.0,86.0,86.0
240.073,6,21,4925,11,941,24007.0,180.0,93.0,10,3984,26674.0,1592.0,576.0
0.005,6,10,1989,5,927,1.0,659.0,659.0,5,1062,1.0,794.0,794.0
0.017,6,13,3735,7,497,2.0,125.0,125.0,6,3238,3.0,1470.0,1459.0
0.008,6,10,1983,5,910,1.0,642.0,642.0,5,1073,1.0,805.0,805.0
0.005,6,10,1643,5,860,1.0,592.0,592.0,5,783,1.0,515.0,515.0
0.09,6,10,1506,5,395,20.0,127.0,127.0,5,1111,20.0,843.0,843.0
0.006,6,10,1547,5,764,1.0,496.0,496.0,5,783,1.0,515.0,515.0
0.147,6,10,1506,5,395,32.0,127.0,127.0,5,1111,32.0,843.0,843.0
0.012,6,10,1677,5,827,3.0,559.0,559.0,5,850,2.0,582.0,582.0
0.074,6,10,1506,5,395,14.0,127.0,127.0,5,1111,17.0,843.0,843.0
40.072,17,10,676,5,460,10015.0,104.0,64.0,5,216,10017.0,20.0,15.0
0.015,6,13,3735,7,497,2.0,125.0,125.0,6,3238,3.0,1470.0,1459.0
0.022,6,13,3735,7,497,3.0,125.0,125.0,6,3238,4.0,1470.0,1459.0
0.006,6,10,2007,5,928,1.0,660.0,660.0,5,1079,1.0,811.0,811.0
0.003,17,2,148,1,60,0.0,32.0,32.0,1,88,0.0,60.0,60.0
0.006,17,2,158,1,63,0.0,35.0,35.0,1,95,0.0,67.0,67.0
0.007,6,10,1547,5,764,1.0,496.0,496.0,5,783,1.0,515.0,515.0
0.009,6,12,1926,6,1189,1.0,659.0,434.0,6,737,1.0,417.0,417.0
0.007,6,10,1989,5,910,1.0,642.0,642.0,5,1079,1.0,811.0,811.0
0.004,6,10,1989,5,927,1.0,659.0,659.0,5,1062,1.0,794.0,794.0
0.005,17,2,144,1,64,0.0,36.0,36.0,1,80,0.0,52.0,52.0
240.07,6,21,4924,11,941,24007.0,180.0,93.0,10,3983,26674.0,1591.0,575.0
0.006,6,10,1854,5,889,1.0,621.0,621.0,5,965,1.0,697.0,697.0
0.006,6,10,1547,5,764,1.0,496.0,496.0,5,783,1.0,515.0,515.0
0.088,17,2,144,1,64,0.0,36.0,36.0,1,80,0.0,52.0,52.0
0.004,17,2,136,1,60,0.0,32.0,32.0,1,76,0.0,48.0,48.0
0.006,17,2,179,1,71,0.0,43.0,43.0,1,108,0.0,80.0,80.0
0.004,6,10,1989,5,927,1.0,659.0,659.0,5,1062,1.0,794.0,794.0
0.001,17,2,180,1,65,0.0,37.0,37.0,1,115,0.0,87.0,87.0
353.598,6,20,2210,6,1308,12004.0,494.0,494.0,14,902,27199.0,83.0,83.0
0.006,17,2,170,1,65,0.0,37.0,37.0,1,105,0.0,77.0,77.0
0.01,6,10,1983,5,910,2.0,642.0,642.0,5,1073,2.0,805.0,805.0
0.004,17,2,136,1,60,0.0,32.0,32.0,1,76,0.0,48.0,48.0
0.097,6,10,1506,5,395,22.0,127.0,127.0,5,1111,19.0,843.0,843.0
0.009,6,10,1677,5,827,2.0,559.0,559.0,5,850,2.0,582.0,582.0
0.005,6,10,1643,5,860,1.0,592.0,592.0,5,783,1.0,515.0,515.0
0.122,6,10,1506,5,395,25.0,127.0,127.0,5,1111,26.0,843.0,843.0
0.038,17,2,166,1,75,0.0,47.0,47.0,1,91,0.0,63.0,63.0
0.112,6,10,1506,5,395,25.0,127.0,127.0,5,1111,25.0,843.0,843.0
0.017,6,10,1677,5,827,4.0,559.0,559.0,5,850,4.0,582.0,582.0
0.015,6,10,1989,5,910,3.0,642.0,642.0,5,1079,3.0,811.0,811.0
0.019,6,10,1972,5,910,4.0,642.0,642.0,5,1062,4.0,794.0,794.0
40.055,17,10,676,5,460,10012.0,104.0,64.0,5,216,10011.0,20.0,15.0
0.005,17,2,164,1,74,0.0,46.0,46.0,1,90,0.0,62.0,62.0
0.009,6,10,1989,5,910,2.0,642.0,642.0,5,1079,2.0,811.0,811.0
171.487,17,72,10324,36,2402,4899.0,44.0,38.0,36,7922,4899.0,261.0,192.0
0.006,6,10,1689,5,839,1.0,571.0,571.0,5,850,1.0,582.0,582.0
0.005,17,2,214,1,75,0.0,47.0,47.0,1,139,0.0,111.0,111.0
0.087,6,10,1506,5,395,19.0,127.0,127.0,5,1111,18.0,843.0,843.0
0.015,6,10,1762,5,911,3.0,643.0,643.0,5,851,3.0,583.0,583.0
0.004,6,10,2006,5,927,1.0,659.0,659.0,5,1079,1.0,811.0,811.0
0.094,6,10,1506,5,395,19.0,127.0,127.0,5,1111,19.0,843.0,843.0
40.061,17,10,676,5,460,10012.0,104.0,64.0,5,216,10014.0,20.0,15.0
40.061,17,10,676,5,460,10012.0,104.0,64.0,5,216,10014.0,20.0,15.0
0.016,17,2,198,1,91,0.0,63.0,63.0,1,107,0.0,79.0,79.0
0.015,6,10,1983,5,910,3.0,642.0,642.0,5,1073,3.0,805.0,805.0
0.007,6,13,3684,7,446,1.0,74.0,74.0,6,3238,1.0,1470.0,1459.0
0.001,17,2,136,1,60,0.0,32.0,32.0,1,76,0.0,48.0,48.0
0.083,6,10,1506,5,395,17.0,127.0,127.0,5,1111,17.0,843.0,843.0
0.114,6,10,1506,5,395,26.0,127.0,127.0,5,1111,24.0,843.0,843.0
0.005,6,10,1854,5,889,1.0,621.0,621.0,5,965,1.0,697.0,697.0
0.013,6,10,1989,5,910,3.0,642.0,642.0,5,1079,3.0,811.0,811.0
0.016,6,10,1989,5,910,3.0,642.0,642.0,5,1079,4.0,811.0,811.0
545.984,6,41,15136,21,4090,27299.0,676.0,427.0,20,11046,25575.0,1436.0,833.0
0.004,6,10,1779,5,928,1.0,660.0,660.0,5,851,1.0,583.0,583.0
0.004,17,2,136,1,60,0.0,32.0,32.0,1,76,0.0,48.0,48.0
0.075,6,10,1506,5,395,16.0,127.0,127.0,5,1111,17.0,843.0,843.0
0.016,6,10,1762,5,911,4.0,643.0,643.0,5,851,3.0,583.0,583.0
0.004,17,2,148,1,60,0.0,32.0,32.0,1,88,0.0,60.0,60.0
0.011,6,13,3735,7,497,1.0,125.0,125.0,6,3238,2.0,1470.0,1459.0
0.073,17,2,184,1,61,0.0,33.0,33.0,1,123,0.0,95.0,95.0
412.015,6,29,4409,12,3102,10913.0,494.0,494.0,17,1307,25750.0,83.0,83.0
0.077,6,10,1506,5,395,18.0,127.0,127.0,5,1111,14.0,843.0,843.0
0.068,6,10,1506,5,395,15.0,127.0,127.0,5,1111,16.0,843.0,843.0
0.023,6,10,1989,5,910,5.0,642.0,642.0,5,1079,5.0,811.0,811.0
0.004,6,10,2007,5,928,1.0,660.0,660.0,5,1079,1.0,811.0,811.0
0.005,6,13,3747,7,509,0.0,137.0,137.0,6,3238,0.0,1470.0,1459.0
0.006,6,10,1547,5,764,1.0,496.0,496.0,5,783,1.0,515.0,515.0
11.377,17,34,6345,17,2657,704.0,270.0,128.0,17,3688,704.0,1146.0,188.0
0.001,17,2,180,1,66,0.0,38.0,38.0,1,114,0.0,86.0,86.0
308.371,17,20,1124,10,716,34249.0,48.0,43.0,10,408,34249.0,20.0,12.0
0.078,6,10,1506,5,395,18.0,127.0,127.0,5,1111,15.0,843.0,843.0
1799.163,17,3186,243737,1582,128266,1137.0,84.0,53.0,1604,115471,1122.0,227.0,43.0
0.01,6,10,1989,5,910,2.0,642.0,642.0,5,1079,2.0,811.0,811.0
40.059,17,10,676,5,460,10013.0,104.0,64.0,5,216,10013.0,20.0,15.0
0.015,17,2,198,1,91,0.0,63.0,63.0,1,107,0.0,79.0,79.0
0.028,6,10,1762,5,911,6.0,643.0,643.0,5,851,7.0,583.0,583.0
0.01,6,10,1643,5,860,2.0,592.0,592.0,5,783,2.0,515.0,515.0
0.009,6,10,1983,5,910,2.0,642.0,642.0,5,1073,2.0,805.0,805.0
40.061,17,10,676,5,460,10014.0,104.0,64.0,5,216,10014.0,20.0,15.0
0.001,17,2,166,1,75,0.0,47.0,47.0,1,91,0.0,63.0,63.0
0.004,6,10,2006,5,927,1.0,659.0,659.0,5,1079,1.0,811.0,811.0
0.006,6,10,1547,5,764,1.0,496.0,496.0,5,783,1.0,515.0,515.0
0.005,6,10,2007,5,928,1.0,660.0,660.0,5,1079,1.0,811.0,811.0
0.0,17,2,180,1,65,0.0,37.0,37.0,1,115,0.0,87.0,87.0
0.103,6,10,1506,5,395,22.0,127.0,127.0,5,1111,24.0,843.0,843.0
0.117,6,10,1506,5,395,26.0,127.0,127.0,5,1111,27.0,843.0,843.0
1771.709,17,120,11460,60,5460,30028.0,63.0,63.0,60,6000,30028.0,72.0,72.0
0.009,6,12,1926,6,1189,1.0,659.0,434.0,6,737,1.0,417.0,417.0
11.043,17,28,4422,14,1994,839.0,269.0,114.0,14,2428,840.0,587.0,145.0
0.005,17,2,152,1,68,0.0,40.0,40.0,1,84,0.0,56.0,56.0
0.008,6,10,1972,5,910,1.0,642.0,642.0,5,1062,2.0,794.0,794.0
0.005,17,2,170,1,65,0.0,37.0,37.0,1,105,0.0,77.0,77.0
0.099,6,10,1506,5,395,21.0,127.0,127.0,5,1111,22.0,843.0,843.0
0.066,6,10,1506,5,395,15.0,127.0,127.0,5,1111,15.0,843.0,843.0
0.01,6,10,1990,5,911,2.0,643.0,643.0,5,1079,2.0,811.0,811.0
0.011,6,10,1989,5,910,2.0,642.0,642.0,5,1079,2.0,811.0,811.0
240.352,6,33,8639,17,1839,15021.0,572.0,189.0,16,6800,16023.0,1402.0,597.0
0.005,6,10,1774,5,923,1.0,655.0,655.0,5,851,1.0,583.0,583.0
0.019,6,10,1677,5,827,4.0,559.0,559.0,5,850,4.0,582.0,582.0
0.125,6,10,1506,5,395,30.0,127.0,127.0,5,1111,29.0,843.0,843.0
0.109,6,10,1506,5,395,26.0,127.0,127.0,5,1111,23.0,843.0,843.0
0.072,6,10,1506,5,395,15.0,127.0,127.0,5,1111,15.0,843.0,843.0
0.012,6,10,1989,5,910,3.0,642.0,642.0,5,1079,3.0,811.0,811.0
9.037,17,6,376,5,280,2259.0,28.0,28.0,1,96,0.0,68.0,68.0
0.072,6,10,1506,5,395,16.0,127.0,127.0,5,1111,17.0,843.0,843.0
0.005,6,10,2000,5,927,1.0,659.0,659.0,5,1073,1.0,805.0,805.0
0.017,6,10,1983,5,910,4.0,642.0,642.0,5,1073,4.0,805.0,805.0
0.163,17,2,152,1,76,0.0,48.0,48.0,1,76,0.0,48.0,48.0
0.017,6,10,1983,5,910,4.0,642.0,642.0,5,1073,4.0,805.0,805.0
0.008,6,10,1972,5,910,2.0,642.0,642.0,5,1062,2.0,794.0,794.0
0.068,6,10,1506,5,395,15.0,127.0,127.0,5,1111,12.0,843.0,843.0
0.013,6,10,1972,5,910,3.0,642.0,642.0,5,1062,3.0,794.0,794.0
0.003,17,2,148,1,60,0.0,32.0,32.0,1,88,0.0,60.0,60.0
0.018,6,10,1989,5,910,4.0,642.0,642.0,5,1079,4.0,811.0,811.0
40.059,17,10,676,5,460,10011.0,104.0,64.0,5,216,10014.0,20.0,15.0
40.071,17,10,676,5,460,10014.0,104.0,64.0,5,216,10017.0,20.0,15.0
0.127,17,4,420,2,122,0.0,33.0,33.0,2,298,124.0,145.0,121.0
0.008,6,10,1990,5,911,2.0,643.0,643.0,5,1079,1.0,811.0,811.0
0.005,6,10,2006,5,927,1.0,659.0,659.0,5,1079,1.0,811.0,811.0
0.005,6,10,2006,5,927,1.0,659.0,659.0,5,1079,1.0,811.0,811.0
0.013,6,10,1631,5,848,3.0,580.0,580.0,5,783,3.0,515.0,515.0
0.006,6,10,1547,5,764,1.0,496.0,496.0,5,783,1.0,515.0,515.0
0.003,17,2,136,1,60,0.0,32.0,32.0,1,76,0.0,48.0,48.0
291.309,6,398,348516,192,21555,1525.0,2736.0,889.0,206,326961,1421.0,2804.0,1647.0
0.02,6,10,1972,5,910,5.0,642.0,642.0,5,1062,5.0,794.0,794.0
0.004,6,10,1702,5,863,1.0,595.0,595.0,5,839,1.0,571.0,571.0
0.005,17,2,140,1,62,0.0,34.0,34.0,1,78,0.0,50.0,50.0
40.054,17,10,676,5,460,10012.0,104.0,64.0,5,216,10012.0,20.0,15.0
0.016,6,10,1989,5,910,4.0,642.0,642.0,5,1079,4.0,811.0,811.0
0.013,17,2,169,1,62,0.0,34.0,34.0,1,107,0.0,79.0,79.0
0.005,17,2,154,1,69,0.0,41.0,41.0,1,85,0.0,57.0,57.0
0.006,6,10,1547,5,764,1.0,496.0,496.0,5,783,1.0,515.0,515.0
0.0,17,2,140,1,62,0.0,34.0,34.0,1,78,0.0,50.0,50.0
40.061,17,10,676,5,460,10013.0,104.0,64.0,5,216,10013.0,20.0,15.0
0.125,6,10,1506,5,395,29.0,127.0,127.0,5,1111,24.0,843.0,843.0
0.128,17,2,80,1,32,0.0,4.0,4.0,1,48,0.0,20.0,20.0
0.131,17,2,182,1,65,0.0,37.0,37.0,1,117,0.0,89.0,89.0
0.005,17,2,136,1,60,0.0,32.0,32.0,1,76,0.0,48.0,48.0
0.013,6,10,1989,5,910,3.0,642.0,642.0,5,1079,3.0,811.0,811.0
368.892,6,22,2313,16,867,24592.0,195.0,195.0,6,1446,4639.0,419.0,398.0
0.013,6,10,1983,5,910,3.0,642.0,642.0,5,1073,3.0,805.0,805.0
0.003,17,2,148,1,60,0.0,32.0,32.0,1,88,0.0,60.0,60.0
0.004,17,2,136,1,60,0.0,32.0,32.0,1,76,0.0,48.0,48.0
0.006,17,2,170,1,65,0.0,37.0,37.0,1,105,0.0,77.0,77.0
0.006,6,10,1779,5,928,1.0,660.0,660.0,5,851,1.0,583.0,583.0
0.004,6,10,1989,5,927,1.0,659.0,659.0,5,1062,1.0,794.0,794.0
0.005,6,13,3747,7,509,0.0,137.0,137.0,6,3238,0.0,1470.0,1459.0
361.839,6,19,1689,15,978,25845.0,190.0,190.0,4,711,80013.0,495.0,495.0
0.005,6,10,2000,5,927,1.0,659.0,659.0,5,1073,1.0,805.0,805.0
0.005,6,10,1989,5,927,1.0,659.0,659.0,5,1062,1.0,794.0,794.0
0.003,17,2,148,1,60,0.0,32.0,32.0,1,88,0.0,60.0,60.0
15.073,17,15,9238,8,6902,2149.0,1350.0,834.0,7,2336,2507.0,1350.0,305.0
0.197,6,10,1506,5,395,44.0,127.0,127.0,5,1111,48.0,843.0,843.0
0.009,6,10,1631,5,848,2.0,580.0,580.0,5,783,2.0,515.0,515.0
0.01,6,10,1989,5,910,2.0,642.0,642.0,5,1079,2.0,811.0,811.0
0.036,6,13,3816,7,578,5.0,206.0,206.0,6,3238,7.0,1470.0,1459.0
0.003,17,2,186,1,61,0.0,33.0,33.0,1,125,0.0,97.0,97.0
0.005,6,10,1774,5,923,1.0,655.0,655.0,5,851,1.0,583.0,583.0
0.005,6,10,1689,5,839,1.0,571.0,571.0,5,850,1.0,582.0,582.0
0.006,6,10,1689,5,839,1.0,571.0,571.0,5,850,1.0,582.0,582.0
0.005,17,2,170,1,65,0.0,37.0,37.0,1,105,0.0,77.0,77.0
0.004,6,10,2000,5,927,1.0,659.0,659.0,5,1073,1.0,805.0,805.0
0.005,6,10,2006,5,927,1.0,659.0,659.0,5,1079,1.0,811.0,811.0
0.129,6,10,1506,5,395,29.0,127.0,127.0,5,1111,31.0,843.0,843.0
0.004,6,10,1989,5,927,1.0,659.0,659.0,5,1062,1.0,794.0,794.0
40.066,17,10,676,5,460,10015.0,104.0,64.0,5,216,10015.0,20.0,15.0
0.015,6,10,1989,5,910,3.0,642.0,642.0,5,1079,3.0,811.0,811.0
0.089,6,10,1506,5,395,16.0,127.0,127.0,5,1111,19.0,843.0,843.0
0.098,6,10,1506,5,395,19.0,127.0,127.0,5,1111,23.0,843.0,843.0
0.006,17,2,180,1,66,0.0,38.0,38.0,1,114,0.0,86.0,86.0
0.008,6,10,1989,5,910,1.0,642.0,642.0,5,1079,1.0,811.0,811.0
0.07,6,10,1506,5,395,15.0,127.0,127.0,5,1111,14.0,843.0,843.0
0.007,6,10,1689,5,839,1.0,571.0,571.0,5,850,1.0,582.0,582.0
0.014,6,10,1762,5,911,3.0,643.0,643.0,5,851,3.0,583.0,583.0
0.005,6,10,1702,5,863,1.0,595.0,595.0,5,839,1.0,571.0,571.0
0.005,6,10,1689,5,839,1.0,571.0,571.0,5,850,1.0,582.0,582.0
0.016,6,10,1983,5,910,3.0,642.0,642.0,5,1073,3.0,805.0,805.0
0.091,6,10,1506,5,395,20.0,127.0,127.0,5,1111,18.0,843.0,843.0
0.01,6,10,1972,5,910,2.0,642.0,642.0,5,1062,2.0,794.0,794.0
0.011,6,10,1990,5,911,2.0,643.0,643.0,5,1079,2.0,811.0,811.0
0.001,17,2,180,1,66,0.0,38.0,38.0,1,114,0.0,86.0,86.0
0.011,6,10,1972,5,910,2.0,642.0,642.0,5,1062,2.0,794.0,794.0
0.005,6,10,1689,5,839,1.0,571.0,571.0,5,850,1.0,582.0,582.0
0.128,17,2,80,1,32,0.0,4.0,4.0,1,48,0.0,20.0,20.0
40.07,17,10,676,5,460,10014.0,104.0,64.0,5,216,10006.0,20.0,15.0
0.005,6,10,2000,5,927,1.0,659.0,659.0,5,1073,1.0,805.0,805.0
0.013,6,10,1631,5,848,3.0,580.0,580.0,5,783,3.0,515.0,515.0
0.087,6,10,1506,5,395,20.0,127.0,127.0,5,1111,19.0,843.0,843.0
0.08,6,10,1506,5,395,16.0,127.0,127.0,5,1111,17.0,843.0,843.0
300.273,6,16,2170,9,684,37515.0,146.0,146.0,7,1486,50018.0,419.0,398.0
240.162,6,44,6417,21,3169,12008.0,588.0,229.0,23,3248,10915.0,580.0,204.0
0.012,6,10,1990,5,911,3.0,643.0,643.0,5,1079,3.0,811.0,811.0
0.012,6,10,1989,5,910,3.0,642.0,642.0,5,1079,3.0,811.0,811.0
0.007,17,2,214,1,75,0.0,47.0,47.0,1,139,0.0,111.0,111.0
0.005,6,10,2000,5,927,1.0,659.0,659.0,5,1073,1.0,805.0,805.0
40.073,17,10,676,5,460,10015.0,104.0,64.0,5,216,10017.0,20.0,15.0
0.082,6,10,1506,5,395,17.0,127.0,127.0,5,1111,19.0,843.0,843.0
0.016,6,10,1990,5,911,4.0,643.0,643.0,5,1079,4.0,811.0,811.0
0.089,6,10,1506,5,395,18.0,127.0,127.0,5,1111,19.0,843.0,843.0
0.008,6,10,1989,5,910,2.0,642.0,642.0,5,1079,1.0,811.0,811.0
15.082,17,15,8059,8,5918,2150.0,1350.0,711.0,7,2141,2508.0,1350.0,277.0
0.011,6,10,1989,5,910,2.0,642.0,642.0,5,1079,2.0,811.0,811.0
0.114,6,10,1506,5,395,23.0,127.0,127.0,5,1111,26.0,843.0,843.0
300.405,6,16,2170,9,684,37529.0,146.0,146.0,7,1486,50039.0,419.0,398.0
0.179,6,10,1506,5,395,44.0,127.0,127.0,5,1111,39.0,843.0,843.0
177.646,17,70,10007,35,2330,5224.0,44.0,38.0,35,7677,5224.0,239.0,191.0
40.077,17,10,676,5,460,10014.0,104.0,64.0,5,216,10018.0,20.0,15.0
0.006,6,10,1643,5,860,1.0,592.0,592.0,5,783,1.0,515.0,515.0
0.004,17,4,284,2,120,0.0,32.0,32.0,2,164,0.0,60.0,54.0
0.006,6,10,1547,5,764,1.0,496.0,496.0,5,783,1.0,515.0,515.0
0.002,17,2,136,1,60,0.0,32.0,32.0,1,76,0.0,48.0,48.0
0.002,17,2,180,1,65,0.0,37.0,37.0,1,115,0.0,87.0,87.0
0.005,6,10,1989,5,927,1.0,659.0,659.0,5,1062,1.0,794.0,794.0
0.037,17,2,148,1,60,0.0,32.0,32.0,1,88,0.0,60.0,60.0
0.013,17,2,152,1,56,0.0,28.0,28.0,1,96,0.0,68.0,68.0
0.013,6,10,1989,5,910,3.0,642.0,642.0,5,1079,3.0,811.0,811.0
240.088,6,16,4482,9,963,30011.0,238.0,166.0,7,3519,40014.0,1402.0,786.0
0.001,17,2,180,1,65,0.0,37.0,37.0,1,115,0.0,87.0,87.0
0.004,6,10,2007,5,928,1.0,660.0,660.0,5,1079,1.0,811.0,811.0
1799.998,6,137,6590,76,3625,23996.0,39.0,39.0,61,2965,29996.0,35.0,35.0
0.013,17,2,179,1,71,0.0,43.0,43.0,1,108,0.0,80.0,80.0
0.008,6,10,1989,5,910,2.0,642.0,642.0,5,1079,2.0,811.0,811.0
0.006,6,10,1547,5,764,1.0,496.0,496.0,5,783,1.0,515.0,515.0
0.008,6,10,1972,5,910,2.0,642.0,642.0,5,1062,2.0,794.0,794.0
40.051,17,10,676,5,460,10012.0,104.0,64.0,5,216,10012.0,20.0,15.0
0.013,6,10,1989,5,910,3.0,642.0,642.0,5,1079,3.0,811.0,811.0
240.107,6,16,4480,9,963,30013.0,238.0,166.0,7,3517,40017.0,1402.0,786.0
0.009,6,12,1926,6,1189,1.0,659.0,434.0,6,737,1.0,417.0,417.0
0.006,6,10,1547,5,764,1.0,496.0,496.0,5,783,1.0,515.0,515.0
0.012,6,10,1989,5,910,2.0,642.0,642.0,5,1079,2.0,811.0,811.0
0.006,6,10,1547,5,764,1.0,496.0,496.0,5,783,1.0,515.0,515.0
0.005,6,10,2006,5,927,1.0,659.0,659.0,5,1079,1.0,811.0,811.0
0.014,6,10,1990,5,911,3.0,643.0,643.0,5,1079,3.0,811.0,811.0
310.795,17,20,1124,10,716,34520.0,48.0,43.0,10,408,34520.0,20.0,12.0
0.259,17,40,21651,22,18416,12.0,1350.0,809.0,18,3235,11.0,1350.0,151.0
309.225,17,20,1124,10,716,34344.0,48.0,43.0,10,408,34344.0,20.0,12.0
0.001,17,2,180,1,66,0.0,38.0,38.0,1,114,0.0,86.0,86.0
40.054,17,10,676,5,460,10012.0,104.0,64.0,5,216,10012.0,20.0,15.0
0.065,6,10,1506,5,395,14.0,127.0,127.0,5,1111,15.0,843.0,843.0
11.681,17,42,9395,21,5105,578.0,1337.0,215.0,21,4290,578.0,863.0,176.0
0.011,6,10,1972,5,910,2.0,642.0,642.0,5,1062,2.0,794.0,794.0
308.8,17,19,1084,10,716,34297.0,48.0,43.0,9,368,38584.0,20.0,12.0
0.006,6,10,1854,5,889,1.0,621.0,621.0,5,965,1.0,697.0,697.0
0.091,6,10,1506,5,395,20.0,127.0,127.0,5,1111,20.0,843.0,843.0
0.033,17,2,154,1,69,0.0,41.0,41.0,1,85,0.0,57.0,57.0
0.012,6,10,1972,5,910,3.0,642.0,642.0,5,1062,3.0,794.0,794.0
0.006,6,10,1547,5,764,1.0,496.0,496.0,5,783,1.0,515.0,515.0
0.012,6,10,1762,5,911,3.0,643.0,643.0,5,851,3.0,583.0,583.0
0.005,6,10,2006,5,927,1.0,659.0,659.0,5,1079,1.0,811.0,811.0
0.005,6,10,1774,5,923,1.0,655.0,655.0,5,851,1.0,583.0,583.0
0.006,17,2,230,1,68,0.0,40.0,40.0,1,162,0.0,134.0,134.0
0.004,6,10,1702,5,863,0.0,595.0,595.0,5,839,1.0,571.0,571.0
0.013,6,10,1990,5,911,3.0,643.0,643.0,5,1079,3.0,811.0,811.0
0.066,6,10,1506,5,395,14.0,127.0,127.0,5,1111,14.0,843.0,843.0
0.003,17,4,284,2,120,0.0,32.0,32.0,2,164,0.0,60.0,54.0
0.116,6,10,1506,5,395,26.0,127.0,127.0,5,1111,24.0,843.0,843.0
0.003,17,2,136,1,60,0.0,32.0,32.0,1,76,0.0,48.0,48.0
0.016,6,10,1990,5,911,3.0,643.0,643.0,5,1079,3.0,811.0,811.0
0.014,6,10,1972,5,910,3.0,642.0,642.0,5,1062,3.0,794.0,794.0
0.006,6,10,2006,5,927,1.0,659.0,659.0,5,1079,1.0,811.0,811.0
11.003,6,33,6264,18,1338,647.0,267.0,195.0,15,4926,610.0,1823.0,392.0
0.024,6,10,1972,5,910,6.0,642.0,642.0,5,1062,5.0,794.0,794.0
0.029,6,10,1631,5,848,7.0,580.0,580.0,5,783,7.0,515.0,515.0
40.085,17,10,676,5,460,10019.0,104.0,64.0,5,216,10020.0,20.0,15.0
0.001,17,2,180,1,66,0.0,38.0,38.0,1,114,0.0,86.0,86.0
0.005,6,10,1989,5,927,1.0,659.0,659.0,5,1062,1.0,794.0,794.0
0.014,6,10,1677,5,827,3.0,559.0,559.0,5,850,3.0,582.0,582.0
0.007,6,10,1547,5,764,1.0,496.0,496.0,5,783,1.0,515.0,515.0
0.001,17,2,180,1,66,0.0,38.0,38.0,1,114,0.0,86.0,86.0
0.006,6,10,1689,5,839,1.0,571.0,571.0,5,850,1.0,582.0,582.0
0.164,6,22,6227,11,1757,15.0,490.0,235.0,11,4470,15.0,1324.0,778.0
300.404,6,16,2170,9,684,37526.0,146.0,146.0,7,1486,50040.0,419.0,398.0
40.092,17,10,676,5,460,10022.0,104.0,64.0,5,216,10022.0,20.0,15.0
0.006,6,10,2007,5,928,1.0,660.0,660.0,5,1079,1.0,811.0,811.0
0.011,6,10,1972,5,910,2.0,642.0,642.0,5,1062,2.0,794.0,794.0
0.013,6,10,1983,5,910,3.0,642.0,642.0,5,1073,3.0,805.0,805.0
0.004,6,10,2006,5,927,1.0,659.0,659.0,5,1079,1.0,811.0,811.0
0.365,17,43,20678,23,17151,16.0,1350.0,717.0,20,3527,15.0,1350.0,148.0
0.006,6,10,1547,5,764,1.0,496.0,496.0,5,783,1.0,515.0,515.0
0.005,6,10,2006,5,927,1.0,659.0,659.0,5,1079,1.0,811.0,811.0
0.005,17,2,168,1,76,0.0,48.0,48.0,1,92,0.0,64.0,64.0
28.229,6,37,10002,19,4484,499.0,1360.0,738.0,18,5518,1650.0,2667.0,435.0
0.005,17,2,140,1,62,0.0,34.0,34.0,1,78,0.0,50.0,50.0
1787.361,6,151,19402,90,13740,20082.0,302.0,302.0,61,5662,29789.0,83.0,83.0
0.005,6,10,2006,5,927,1.0,659.0,659.0,5,1079,1.0,811.0,811.0
0.005,17,2,140,1,62,0.0,34.0,34.0,1,78,0.0,50.0,50.0
0.072,6,10,1506,5,395,15.0,127.0,127.0,5,1111,17.0,843.0,843.0
0.005,17,2,148,1,60,0.0,32.0,32.0,1,88,0.0,60.0,60.0
0.118,6,10,1506,5,395,27.0,127.0,127.0,5,1111,24.0,843.0,843.0
0.001,17,2,180,1,66,0.0,38.0,38.0,1,114,0.0,86.0,86.0
0.006,6,10,1854,5,889,1.0,621.0,621.0,5,965,1.0,697.0,697.0
0.011,6,10,1989,5,910,2.0,642.0,642.0,5,1079,2.0,811.0,811.0
0.116,6,10,1506,5,395,23.0,127.0,127.0,5,1111,24.0,843.0,843.0
0.015,6,10,1972,5,910,3.0,642.0,642.0,5,1062,3.0,794.0,794.0
0.004,6,10,2006,5,927,1.0,659.0,659.0,5,1079,1.0,811.0,811.0
0.007,6,12,1698,6,863,1.0,327.0,271.0,6,835,1.0,515.0,515.0
0.066,6,10,1506,5,395,15.0,127.0,127.0,5,1111,13.0,843.0,843.0
0.004,6,10,1702,5,863,0.0,595.0,595.0,5,839,1.0,571.0,571.0
0.041,17,2,136,1,60,0.0,32.0,32.0,1,76,0.0,48.0,48.0
0.005,6,10,2007,5,928,1.0,660.0,660.0,5,1079,1.0,811.0,811.0
0.134,6,10,1506,5,395,30.0,127.0,127.0,5,1111,26.0,843.0,843.0
0.095,6,10,1506,5,395,22.0,127.0,127.0,5,1111,20.0,843.0,843.0
0.011,6,10,1631,5,848,2.0,580.0,580.0,5,783,2.0,515.0,515.0
0.004,6,10,2006,5,927,1.0,659.0,659.0,5,1079,1.0,811.0,811.0
0.017,6,10,1989,5,910,4.0,642.0,642.0,5,1079,4.0,811.0,811.0
0.001,17,2,180,1,66,0.0,38.0,38.0,1,114,0.0,86.0,86.0
0.003,17,2,148,1,60,0.0,32.0,32.0,1,88,0.0,60.0,60.0
0.088,6,10,1506,5,395,17.0,127.0,127.0,5,1111,20.0,843.0,843.0
0.005,6,10,2000,5,927,1.0,659.0,659.0,5,1073,1.0,805.0,805.0
15.072,17,15,9238,8,6902,2149.0,1350.0,834.0,7,2336,2507.0,1350.0,305.0
0.071,6,10,1506,5,395,15.0,127.0,127.0,5,1111,14.0,843.0,843.0
0.003,6,10,1702,5,863,0.0,595.0,595.0,5,839,0.0,571.0,571.0
0.068,6,10,1506,5,395,14.0,127.0,127.0,5,1111,15.0,843.0,843.0
0.006,6,10,1989,5,927,1.0,659.0,659.0,5,1062,1.0,794.0,794.0
0.014,6,10,1989,5,910,3.0,642.0,642.0,5,1079,3.0,811.0,811.0
0.012,6,10,1990,5,911,3.0,643.0,643.0,5,1079,2.0,811.0,811.0
309.062,17,20,1124,10,716,34327.0,48.0,43.0,10,408,34327.0,20.0,12.0
0.005,6,10,2000,5,927,1.0,659.0,659.0,5,1073,1.0,805.0,805.0
0.003,17,2,170,1,65,0.0,37.0,37.0,1,105,0.0,77.0,77.0
0.064,6,10,1506,5,395,15.0,127.0,127.0,5,1111,14.0,843.0,843.0
0.012,6,10,1989,5,910,3.0,642.0,642.0,5,1079,3.0,811.0,811.0
0.099,6,10,1506,5,395,20.0,127.0,127.0,5,1111,22.0,843.0,843.0
203.408,6,338,256816,178,242412,1148.0,4080.0,1717.0,160,14404,1278.0,2667.0,204.0
0.018,6,10,1972,5,910,4.0,642.0,642.0,5,1062,4.0,794.0,794.0
0.005,6,10,2006,5,927,1.0,659.0,659.0,5,1079,1.0,811.0,811.0
0.069,17,8,3613,4,1874,23.0,1350.0,440.0,4,1739,11.0,1350.0,406.0
0.005,6,10,2006,5,927,1.0,659.0,659.0,5,1079,1.0,811.0,811.0
0.001,17,2,136,1,60,0.0,32.0,32.0,1,76,0.0,48.0,48.0
0.079,6,10,1506,5,395,15.0,127.0,127.0,5,1111,18.0,843.0,843.0
40.05,17,10,676,5,460,10011.0,104.0,64.0,5,216,10011.0,20.0,15.0
0.009,6,10,1989,5,910,2.0,642.0,642.0,5,1079,2.0,811.0,811.0
0.012,6,10,1990,5,911,3.0,643.0,643.0,5,1079,2.0,811.0,811.0
0.004,6,10,1702,5,863,1.0,595.0,595.0,5,839,0.0,571.0,571.0
353.538,6,20,2210,6,1308,12007.0,494.0,494.0,14,902,27194.0,83.0,83.0
40.056,17,10,676,5,460,10012.0,104.0,64.0,5,216,10013.0,20.0,15.0
300.318,6,16,2170,9,684,37518.0,146.0,146.0,7,1486,50025.0,419.0,398.0
0.011,6,10,1989,5,910,2.0,642.0,642.0,5,1079,2.0,811.0,811.0
0.076,17,2,184,1,61,0.0,33.0,33.0,1,123,0.0,95.0,95.0
0.006,6,10,1547,5,764,1.0,496.0,496.0,5,783,1.0,515.0,515.0
353.313,6,20,2210,6,1308,12004.0,494.0,494.0,14,902,27177.0,83.0,83.0
40.065,17,10,676,5,460,10014.0,104.0,64.0,5,216,10015.0,20.0,15.0
0.005,17,2,185,1,73,0.0,45.0,45.0,1,112,0.0,84.0,84.0
0.013,6,10,1990,5,911,3.0,643.0,643.0,5,1079,3.0,811.0,811.0
0.094,6,10,1506,5,395,21.0,127.0,127.0,5,1111,22.0,843.0,843.0
0.019,6,10,1990,5,911,4.0,643.0,643.0,5,1079,4.0,811.0,811.0
0.016,6,10,1972,5,910,4.0,642.0,642.0,5,1062,4.0,794.0,794.0
0.005,6,10,1989,5,927,1.0,659.0,659.0,5,1062,1.0,794.0,794.0
0.005,6,10,1547,5,764,1.0,496.0,496.0,5,783,1.0,515.0,515.0
0.103,6,10,1506,5,395,23.0,127.0,127.0,5,1111,22.0,843.0,843.0
0.008,17,2,132,1,58,0.0,30.0,30.0,1,74,0.0,46.0,46.0
40.074,17,10,676,5,460,10016.0,104.0,64.0,5,216,10017.0,20.0,15.0
0.089,6,10,1506,5,395,19.0,127.0,127.0,5,1111,18.0,843.0,843.0
40.062,17,10,676,5,460,10012.0,104.0,64.0,5,216,10014.0,20.0,15.0
0.006,6,10,2006,5,927,1.0,659.0,659.0,5,1079,1.0,811.0,811.0
240.658,6,35,8924,18,2073,14154.0,694.0,225.0,17,6851,15038.0,1402.0,597.0
0.016,6,10,1990,5,911,4.0,643.0,643.0,5,1079,3.0,811.0,811.0
0.007,17,2,152,1,68,0.0,40.0,40.0,1,84,0.0,56.0,56.0
0.005,17,2,170,1,65,0.0,37.0,37.0,1,105,0.0,77.0,77.0
0.004,17,4,284,2,120,0.0,32.0,32.0,2,164,0.0,60.0,54.0
0.01,6,10,1989,5,910,2.0,642.0,642.0,5,1079,2.0,811.0,811.0
0.008,6,10,1631,5,848,1.0,580.0,580.0,5,783,2.0,515.0,515.0
0.005,6,10,2000,5,927,1.0,659.0,659.0,5,1073,1.0,805.0,805.0
0.004,6,10,1702,5,863,1.0,595.0,595.0,5,839,0.0,571.0,571.0
367.054,6,22,2313,16,867,24470.0,195.0,195.0,6,1446,4637.0,419.0,398.0
0.014,6,10,1972,5,910,3.0,642.0,642.0,5,1062,3.0,794.0,794.0
371.907,6,22,2313,16,867,24793.0,195.0,195.0,6,1446,4637.0,419.0,398.0
173.223,17,80,11364,40,2673,4441.0,44.0,38.0,40,8691,4441.0,239.0,189.0
0.006,6,10,2007,5,928,1.0,660.0,660.0,5,1079,1.0,811.0,811.0
0.019,6,10,1989,5,910,4.0,642.0,642.0,5,1079,4.0,811.0,811.0
0.006,6,10,1547,5,764,1.0,496.0,496.0,5,783,1.0,515.0,515.0
0.088,6,10,1506,5,395,20.0,127.0,127.0,5,1111,16.0,843.0,843.0
0.019,6,10,1972,5,910,4.0,642.0,642.0,5,1062,4.0,794.0,794.0
40.059,17,10,676,5,460,10013.0,104.0,64.0,5,216,10014.0,20.0,15.0
0.005,6,10,2006,5,927,1.0,659.0,659.0,5,1079,1.0,811.0,811.0
0.004,17,2,148,1,60,0.0,32.0,32.0,1,88,0.0,60.0,60.0
0.043,17,2,152,1,76,0.0,48.0,48.0,1,76,0.0,48.0,48.0
0.013,6,10,1990,5,911,3.0,643.0,643.0,5,1079,3.0,811.0,811.0
40.058,17,10,676,5,460,10013.0,104.0,64.0,5,216,10013.0,20.0,15.0
0.006,17,2,169,1,62,0.0,34.0,34.0,1,107,0.0,79.0,79.0
0.167,6,10,1506,5,395,26.0,127.0,127.0,5,1111,37.0,843.0,843.0
0.009,6,10,1689,5,839,2.0,571.0,571.0,5,850,2.0,582.0,582.0
0.07,6,10,1506,5,395,16.0,127.0,127.0,5,1111,14.0,843.0,843.0
0.009,6,10,1989,5,910,2.0,642.0,642.0,5,1079,2.0,811.0,811.0
0.103,6,10,1506,5,395,24.0,127.0,127.0,5,1111,22.0,843.0,843.0
0.001,17,2,166,1,75,0.0,47.0,47.0,1,91,0.0,63.0,63.0
0.043,17,2,170,1,65,0.0,37.0,37.0,1,105,0.0,77.0,77.0
0.005,17,2,180,1,58,0.0,30.0,30.0,1,122,0.0,94.0,94.0
0.005,6,10,1989,5,927,1.0,659.0,659.0,5,1062,1.0,794.0,794.0
0.008,6,10,1972,5,910,2.0,642.0,642.0,5,1062,2.0,794.0,794.0
0.126,6,10,1506,5,395,29.0,127.0,127.0,5,1111,30.0,843.0,843.0
0.116,6,10,1506,5,395,28.0,127.0,127.0,5,1111,26.0,843.0,843.0
300.422,6,16,2170,9,684,37531.0,146.0,146.0,7,1486,50041.0,419.0,398.0
0.012,6,10,1972,5,910,3.0,642.0,642.0,5,1062,2.0,794.0,794.0
0.013,6,10,1677,5,827,3.0,559.0,559.0,5,850,3.0,582.0,582.0
0.053,17,2,152,1,76,0.0,48.0,48.0,1,76,0.0,48.0,48.0
0.005,17,2,175,1,65,0.0,37.0,37.0,1,110,0.0,82.0,82.0
0.005,6,10,2006,5,927,1.0,659.0,659.0,5,1079,1.0,811.0,811.0
0.006,17,2,424,1,72,0.0,44.0,44.0,1,352,0.0,324.0,324.0
0.004,6,10,1779,5,928,1.0,660.0,660.0,5,851,1.0,583.0,583.0
0.007,17,4,284,2,120,0.0,32.0,32.0,2,164,1.0,60.0,54.0
0.008,6,10,1677,5,827,2.0,559.0,559.0,5,850,2.0,582.0,582.0
0.003,17,2,380,1,61,0.0,33.0,33.0,1,319,0.0,291.0,291.0
0.005,6,10,2006,5,927,1.0,659.0,659.0,5,1079,1.0,811.0,811.0
0.078,6,10,1506,5,395,17.0,127.0,127.0,5,1111,16.0,843.0,843.0
0.005,6,10,2007,5,928,1.0,660.0,660.0,5,1079,1.0,811.0,811.0
0.074,6,10,1506,5,395,15.0,127.0,127.0,5,1111,16.0,843.0,843.0
0.005,6,10,2006,5,927,1.0,659.0,659.0,5,1079,1.0,811.0,811.0
0.012,6,10,1989,5,910,2.0,642.0,642.0,5,1079,3.0,811.0,811.0
0.004,17,2,148,1,60,0.0,32.0,32.0,1,88,0.0,60.0,60.0
0.069,17,8,3613,4,1874,23.0,1350.0,440.0,4,1739,12.0,1350.0,406.0
0.01,6,10,1990,5,911,2.0,643.0,643.0,5,1079,2.0,811.0,811.0
0.02,17,2,158,1,71,0.0,43.0,43.0,1,87,0.0,59.0,59.0
0.011,6,10,1989,5,910,2.0,642.0,642.0,5,1079,2.0,811.0,811.0
663.94,6,48,17383,24,5566,28866.0,676.0,538.0,24,11817,28866.0,1402.0,755.0
0.004,17,2,146,1,65,0.0,37.0,37.0,1,81,0.0,53.0,53.0
0.01,6,10,1989,5,910,2.0,642.0,642.0,5,1079,2.0,811.0,811.0
0.015,6,10,1989,5,910,3.0,642.0,642.0,5,1079,3.0,811.0,811.0
9.534,6,40,13313,21,6064,476.0,1360.0,861.0,19,7249,518.0,2720.0,539.0
0.062,6,10,1506,5,395,14.0,127.0,127.0,5,1111,15.0,843.0,843.0
0.007,6,10,1989,5,910,1.0,642.0,642.0,5,1079,1.0,811.0,811.0
174.04,17,74,10530,37,2466,4834.0,44.0,38.0,37,8064,4834.0,249.0,189.0
0.01,6,10,1983,5,910,2.0,642.0,642.0,5,1073,2.0,805.0,805.0
0.016,6,10,1972,5,910,3.0,642.0,642.0,5,1062,3.0,794.0,794.0
40.051,17,10,676,5,460,10011.0,104.0,64.0,5,216,10011.0,20.0,15.0
0.006,6,10,1547,5,764,1.0,496.0,496.0,5,783,1.0,515.0,515.0
0.054,17,2,179,1,71,0.0,43.0,43.0,1,108,0.0,80.0,80.0
0.006,17,2,140,1,62,0.0,34.0,34.0,1,78,0.0,50.0,50.0
0.088,6,10,1506,5,395,21.0,127.0,127.0,5,1111,16.0,843.0,843.0
0.004,6,10,1702,5,863,1.0,595.0,595.0,5,839,0.0,571.0,571.0
0.004,6,10,1779,5,928,1.0,660.0,660.0,5,851,1.0,583.0,583.0
0.007,6,10,1972,5,910,1.0,642.0,642.0,5,1062,1.0,794.0,794.0
0.074,6,10,1506,5,395,13.0,127.0,127.0,5,1111,15.0,843.0,843.0
0.006,6,10,1547,5,764,1.0,496.0,496.0,5,783,1.0,515.0,515.0
0.013,6,10,1990,5,911,3.0,643.0,643.0,5,1079,3.0,811.0,811.0
0.038,17,2,170,1,65,0.0,37.0,37.0,1,105,0.0,77.0,77.0
412.006,6,29,4409,12,3102,10911.0,494.0,494.0,17,1307,25750.0,83.0,83.0
0.013,6,14,3787,7,497,2.0,125.0,125.0,7,3290,2.0,1448.0,972.0
0.118,6,10,1506,5,395,28.0,127.0,127.0,5,1111,29.0,843.0,843.0
0.001,17,2,179,1,62,0.0,34.0,34.0,1,117,0.0,89.0,89.0
0.013,6,10,1990,5,911,3.0,643.0,643.0,5,1079,3.0,811.0,811.0
0.127,6,10,1506,5,395,29.0,127.0,127.0,5,1111,25.0,843.0,843.0
0.17,17,2,152,1,76,0.0,48.0,48.0,1,76,0.0,48.0,48.0
0.041,17,4,284,2,120,0.0,32.0,32.0,2,164,37.0,60.0,54.0
240.09,6,16,4480,9,963,30011.0,238.0,166.0,7,3517,40014.0,1402.0,786.0
0.014,6,10,1972,5,910,3.0,642.0,642.0,5,1062,3.0,794.0,794.0
0.005,6,13,3747,7,509,0.0,137.0,137.0,6,3238,1.0,1470.0,1459.0
0.041,17,2,152,1,76,0.0,48.0,48.0,1,76,0.0,48.0,48.0
0.109,6,10,1506,5,395,24.0,127.0,127.0,5,1111,23.0,843.0,843.0
40.055,17,10,676,5,460,10012.0,104.0,64.0,5,216,10013.0,20.0,15.0
0.039,17,2,234,1,61,0.0,33.0,33.0,1,173,0.0,145.0,145.0
0.003,17,4,284,2,120,0.0,32.0,32.0,2,164,0.0,60.0,54.0
0.069,6,10,1506,5,395,15.0,127.0,127.0,5,1111,15.0,843.0,843.0
0.01,17,4,284,2,120,6.0,32.0,32.0,2,164,6.0,60.0,54.0
0.012,6,10,1989,5,910,2.0,642.0,642.0,5,1079,3.0,811.0,811.0
15.172,17,19,10385,9,8056,1893.0,1350.0,867.0,10,2329,1682.0,1350.0,204.0
0.009,6,10,1677,5,827,2.0,559.0,559.0,5,850,2.0,582.0,582.0
0.014,6,10,1762,5,911,3.0,643.0,643.0,5,851,3.0,583.0,583.0
0.006,6,10,1547,5,764,1.0,496.0,496.0,5,783,1.0,515.0,515.0
0.008,6,11,2041,6,962,1.0,642.0,642.0,5,1079,2.0,811.0,811.0
0.005,6,10,1689,5,839,1.0,571.0,571.0,5,850,1.0,582.0,582.0
0.005,6,10,1774,5,923,1.0,655.0,655.0,5,851,1.0,583.0,583.0
0.005,6,10,2006,5,927,1.0,659.0,659.0,5,1079,1.0,811.0,811.0
11.574,17,28,4394,14,2312,877.0,587.0,137.0,14,2082,877.0,269.0,120.0
0.039,6,10,1972,5,910,9.0,642.0,642.0,5,1062,9.0,794.0,794.0
0.08,6,10,1506,5,395,16.0,127.0,127.0,5,1111,17.0,843.0,843.0
1.068,6,25,7688,15,1727,76.0,517.0,233.0,10,5961,118.0,1402.0,776.0
0.015,6,10,1989,5,910,3.0,642.0,642.0,5,1079,3.0,811.0,811.0
40.062,17,10,676,5,460,10014.0,104.0,64.0,5,216,10014.0,20.0,15.0
0.079,6,10,1506,5,395,17.0,127.0,127.0,5,1111,17.0,843.0,843.0
240.082,6,16,4481,9,963,30010.0,238.0,166.0,7,3518,40013.0,1402.0,786.0
40.059,17,10,676,5,460,10013.0,104.0,64.0,5,216,10014.0,20.0,15.0
0.01,6,10,1677,5,827,2.0,559.0,559.0,5,850,2.0,582.0,582.0
0.171,17,2,152,1,76,0.0,48.0,48.0,1,76,0.0,48.0,48.0
0.045,6,3,210,2,132,45.0,28.0,28.0,1,78,0.0,26.0,26.0
0.115,6,10,1506,5,395,26.0,127.0,127.0,5,1111,24.0,843.0,843.0
0.005,6,14,3799,7,509,0.0,137.0,137.0,7,3290,0.0,1448.0,972.0
0.02,6,10,1989,5,910,4.0,642.0,642.0,5,1079,5.0,811.0,811.0
40.079,17,10,676,5,460,10018.0,104.0,64.0,5,216,10018.0,20.0,15.0
0.032,6,10,1972,5,910,8.0,642.0,642.0,5,1062,8.0,794.0,794.0
0.005,17,2,144,1,64,0.0,36.0,36.0,1,80,0.0,52.0,52.0
0.003,17,2,136,1,60,0.0,32.0,32.0,1,76,0.0,48.0,48.0
300.685,6,29,9186,16,2169,20045.0,655.0,332.0,13,7017,20053.0,1402.0,791.0
0.006,6,10,1547,5,764,1.0,496.0,496.0,5,783,1.0,515.0,515.0
0.004,6,10,1702,5,863,1.0,595.0,595.0,5,839,0.0,571.0,571.0
11.445,17,28,4370,14,2313,867.0,588.0,137.0,14,2057,867.0,268.0,118.0
0.005,6,14,3742,8,504,0.0,80.0,80.0,6,3238,1.0,1470.0,1459.0
0.017,6,10,1762,5,911,4.0,643.0,643.0,5,851,4.0,583.0,583.0
0.042,17,2,169,1,62,0.0,34.0,34.0,1,107,0.0,79.0,79.0
0.006,6,10,2000,5,927,1.0,659.0,659.0,5,1073,1.0,805.0,805.0
0.108,6,10,1506,5,395,25.0,127.0,127.0,5,1111,22.0,843.0,843.0
0.005,6,10,2000,5,927,1.0,659.0,659.0,5,1073,1.0,805.0,805.0
0.17,6,3,453,2,321,170.0,241.0,241.0,1,132,0.0,92.0,92.0
0.105,6,10,1506,5,395,22.0,127.0,127.0,5,1111,25.0,843.0,843.0
0.004,6,10,1774,5,923,1.0,655.0,655.0,5,851,1.0,583.0,583.0
40.078,17,10,676,5,460,10016.0,104.0,64.0,5,216,10010.0,20.0,15.0
0.016,6,10,1989,5,910,3.0,642.0,642.0,5,1079,4.0,811.0,811.0
240.116,6,22,7442,12,2620,21828.0,1368.0,497.0,10,4822,26679.0,1655.0,858.0
0.075,6,10,1506,5,395,15.0,127.0,127.0,5,1111,17.0,843.0,843.0
0.014,6,10,1762,5,911,3.0,643.0,643.0,5,851,3.0,583.0,583.0
0.039,17,2,148,1,60,0.0,32.0,32.0,1,88,0.0,60.0,60.0
0.001,17,2,178,1,81,0.0,53.0,53.0,1,97,0.0,69.0,69.0
0.009,6,10,1989,5,910,2.0,642.0,642.0,5,1079,2.0,811.0,811.0
40.057,17,10,676,5,460,10012.0,104.0,64.0,5,216,10013.0,20.0,15.0
40.073,17,10,676,5,460,10015.0,104.0,64.0,5,216,10017.0,20.0,15.0
0.014,6,10,1990,5,911,3.0,643.0,643.0,5,1079,3.0,811.0,811.0
0.006,6,10,1689,5,839,1.0,571.0,571.0,5,850,1.0,582.0,582.0
0.007,17,2,179,1,71,0.0,43.0,43.0,1,108,0.0,80.0,80.0
0.007,17,2,179,1,71,0.0,43.0,43.0,1,108,0.0,80.0,80.0
0.006,6,10,1854,5,889,1.0,621.0,621.0,5,965,1.0,697.0,697.0
0.04,17,2,152,1,76,0.0,48.0,48.0,1,76,0.0,48.0,48.0
15.079,17,14,7282,7,5234,2508.0,1350.0,719.0,7,2048,2508.0,1350.0,264.0
0.064,17,2,80,1,32,0.0,4.0,4.0,1,48,0.0,20.0,20.0
0.006,17,2,180,1,66,0.0,38.0,38.0,1,114,0.0,86.0,86.0
0.005,6,14,3799,7,509,0.0,137.0,137.0,7,3290,0.0,1448.0,972.0
0.0,17,2,136,1,60,0.0,32.0,32.0,1,76,0.0,48.0,48.0
92.083,6,26,9525,12,1627,75.0,794.0,367.0,14,7898,7073.0,1360.0,732.0
0.007,6,10,1547,5,764,1.0,496.0,496.0,5,783,1.0,515.0,515.0
0.085,6,10,1506,5,395,18.0,127.0,127.0,5,1111,20.0,843.0,843.0
0.086,6,10,1506,5,395,19.0,127.0,127.0,5,1111,21.0,843.0,843.0
240.013,6,9,787,5,488,60003.0,232.0,232.0,4,299,80003.0,83.0,83.0
0.038,17,4,284,2,120,0.0,32.0,32.0,2,164,35.0,60.0,54.0
356.594,6,21,1795,16,1030,23772.0,190.0,190.0,5,765,60004.0,464.0,248.0
0.004,17,2,136,1,60,0.0,32.0,32.0,1,76,0.0,48.0,48.0
0.017,6,10,1631,5,848,4.0,580.0,580.0,5,783,4.0,515.0,515.0
0.016,6,10,1989,5,910,4.0,642.0,642.0,5,1079,3.0,811.0,811.0
0.039,6,10,1990,5,911,9.0,643.0,643.0,5,1079,9.0,811.0,811.0
0.106,6,10,1506,5,395,25.0,127.0,127.0,5,1111,25.0,843.0,843.0
0.004,17,2,136,1,60,0.0,32.0,32.0,1,76,0.0,48.0,48.0
368.684,6,22,2313,16,867,24578.0,195.0,195.0,6,1446,4636.0,419.0,398.0
0.021,6,13,3735,7,497,3.0,125.0,125.0,6,3238,4.0,1470.0,1459.0
40.059,17,10,676,5,460,10013.0,104.0,64.0,5,216,10014.0,20.0,15.0
0.071,17,2,148,1,60,0.0,32.0,32.0,1,88,0.0,60.0,60.0
0.008,6,10,1983,5,910,2.0,642.0,642.0,5,1073,2.0,805.0,805.0
0.013,6,10,1972,5,910,3.0,642.0,642.0,5,1062,3.0,794.0,794.0
0.013,17,2,136,1,60,0.0,32.0,32.0,1,76,0.0,48.0,48.0
0.009,6,10,1989,5,910,2.0,642.0,642.0,5,1079,2.0,811.0,811.0
0.004,6,10,1774,5,923,1.0,655.0,655.0,5,851,1.0,583.0,583.0
0.023,6,10,1983,5,910,5.0,642.0,642.0,5,1073,5.0,805.0,805.0
0.01,6,10,1631,5,848,2.0,580.0,580.0,5,783,2.0,515.0,515.0
0.005,6,10,1779,5,928,1.0,660.0,660.0,5,851,1.0,583.0,583.0
40.076,17,10,676,5,460,10016.0,104.0,64.0,5,216,10018.0,20.0,15.0
0.024,6,10,1989,5,910,6.0,642.0,642.0,5,1079,5.0,811.0,811.0
0.005,6,10,1989,5,927,1.0,659.0,659.0,5,1062,1.0,794.0,794.0
0.008,6,10,1990,5,911,2.0,643.0,643.0,5,1079,2.0,811.0,811.0
0.095,6,10,1506,5,395,22.0,127.0,127.0,5,1111,19.0,843.0,843.0
0.001,17,2,180,1,66,0.0,38.0,38.0,1,114,0.0,86.0,86.0
0.001,17,2,180,1,66,0.0,38.0,38.0,1,114,0.0,86.0,86.0
0.006,17,2,179,1,71,0.0,43.0,43.0,1,108,0.0,80.0,80.0
40.086,17,10,676,5,460,10019.0,104.0,64.0,5,216,10020.0,20.0,15.0
0.009,6,10,1762,5,911,2.0,643.0,643.0,5,851,2.0,583.0,583.0
0.004,17,4,284,2,120,0.0,32.0,32.0,2,164,1.0,60.0,54.0
0.016,6,10,1990,5,911,4.0,643.0,643.0,5,1079,4.0,811.0,811.0
0.005,6,10,1547,5,764,1.0,496.0,496.0,5,783,1.0,515.0,515.0
0.005,17,2,164,1,74,0.0,46.0,46.0,1,90,0.0,62.0,62.0
0.012,6,10,1972,5,910,2.0,642.0,642.0,5,1062,3.0,794.0,794.0
314.294,17,20,1124,10,716,34907.0,48.0,43.0,10,408,34907.0,20.0,12.0
0.001,17,2,180,1,65,0.0,37.0,37.0,1,115,0.0,87.0,87.0
15.075,17,15,9239,8,6902,2149.0,1350.0,834.0,7,2337,2507.0,1350.0,305.0
0.096,6,10,1506,5,395,22.0,127.0,127.0,5,1111,21.0,843.0,843.0
40.07,17,10,676,5,460,10015.0,104.0,64.0,5,216,10016.0,20.0,15.0
0.009,6,10,1990,5,911,2.0,643.0,643.0,5,1079,2.0,811.0,811.0
0.011,6,10,1989,5,910,2.0,642.0,642.0,5,1079,2.0,811.0,811.0
40.057,17,10,676,5,460,10013.0,104.0,64.0,5,216,10013.0,20.0,15.0
0.076,6,10,1506,5,395,16.0,127.0,127.0,5,1111,17.0,843.0,843.0
0.01,6,10,1989,5,910,2.0,642.0,642.0,5,1079,2.0,811.0,811.0
40.09,17,10,676,5,460,10020.0,104.0,64.0,5,216,10021.0,20.0,15.0
0.005,6,10,1989,5,927,1.0,659.0,659.0,5,1062,1.0,794.0,794.0
0.095,6,10,1506,5,395,20.0,127.0,127.0,5,1111,21.0,843.0,843.0
0.011,6,10,1989,5,910,2.0,642.0,642.0,5,1079,2.0,811.0,811.0
0.01,6,10,1972,5,910,2.0,642.0,642.0,5,1062,2.0,794.0,794.0
0.082,6,10,1506,5,395,18.0,127.0,127.0,5,1111,18.0,843.0,843.0
0.012,6,10,1989,5,910,3.0,642.0,642.0,5,1079,3.0,811.0,811.0
0.005,6,10,1547,5,764,1.0,496.0,496.0,5,783,1.0,515.0,515.0
0.015,6,10,1990,5,911,3.0,643.0,643.0,5,1079,3.0,811.0,811.0
0.069,6,10,1506,5,395,15.0,127.0,127.0,5,1111,16.0,843.0,843.0
0.016,6,10,1989,5,910,4.0,642.0,642.0,5,1079,4.0,811.0,811.0
0.001,17,2,179,1,62,0.0,34.0,34.0,1,117,0.0,89.0,89.0
0.13,17,4,596,2,122,1.0,33.0,33.0,2,474,92.0,323.0,209.0
0.022,17,2,194,1,59,0.0,31.0,31.0,1,135,0.0,107.0,107.0
0.07,6,10,1506,5,395,15.0,127.0,127.0,5,1111,15.0,843.0,843.0
24.088,17,4,670,2,136,24082.0,40.0,40.0,2,534,24082.0,239.0,239.0
0.017,6,10,1989,5,910,4.0,642.0,642.0,5,1079,4.0,811.0,811.0
0.006,6,10,1689,5,839,1.0,571.0,571.0,5,850,1.0,582.0,582.0
0.016,6,10,1990,5,911,3.0,643.0,643.0,5,1079,3.0,811.0,811.0
1.061,6,30,13240,17,5841,66.0,2720.0,854.0,13,7399,74.0,2720.0,858.0
0.005,6,10,2006,5,927,1.0,659.0,659.0,5,1079,1.0,811.0,811.0
308.417,17,20,1124,10,716,34254.0,48.0,43.0,10,408,34254.0,20.0,12.0
0.011,6,10,1983,5,910,2.0,642.0,642.0,5,1073,2.0,805.0,805.0
0.004,6,10,1702,5,863,1.0,595.0,595.0,5,839,0.0,571.0,571.0
0.009,6,10,1972,5,910,2.0,642.0,642.0,5,1062,2.0,794.0,794.0
0.005,6,10,2006,5,927,1.0,659.0,659.0,5,1079,1.0,811.0,811.0
1770.596,17,120,11460,60,5460,30009.0,63.0,63.0,60,6000,30009.0,72.0,72.0
0.163,6,10,1506,5,395,33.0,127.0,127.0,5,1111,32.0,843.0,843.0
0.018,6,10,1677,5,827,4.0,559.0,559.0,5,850,4.0,582.0,582.0
40.054,17,10,676,5,460,10012.0,104.0,64.0,5,216,10012.0,20.0,15.0
0.011,6,10,1990,5,911,2.0,643.0,643.0,5,1079,2.0,811.0,811.0
240.161,6,48,7056,24,3339,10441.0,588.0,230.0,24,3717,10441.0,580.0,205.0
0.011,6,10,1972,5,910,2.0,642.0,642.0,5,1062,2.0,794.0,794.0
108.389,6,26,9525,12,1627,80.0,794.0,367.0,14,7898,8328.0,1360.0,732.0
0.009,6,10,1989,5,910,2.0,642.0,642.0,5,1079,2.0,811.0,811.0
0.007,17,2,170,1,65,0.0,37.0,37.0,1,105,0.0,77.0,77.0
175.209,17,68,9830,34,2267,5309.0,44.0,38.0,34,7563,5309.0,239.0,194.0
0.008,6,10,1972,5,910,2.0,642.0,642.0,5,1062,2.0,794.0,794.0
0.1,6,10,1506,5,395,21.0,127.0,127.0,5,1111,22.0,843.0,843.0
0.065,6,10,1506,5,395,14.0,127.0,127.0,5,1111,14.0,843.0,843.0
0.01,6,10,1989,5,910,2.0,642.0,642.0,5,1079,2.0,811.0,811.0
0.005,6,10,2006,5,927,1.0,659.0,659.0,5,1079,1.0,811.0,811.0
0.01,6,10,1762,5,911,2.0,643.0,643.0,5,851,2.0,583.0,583.0
0.114,6,10,1506,5,395,27.0,127.0,127.0,5,1111,26.0,843.0,843.0
0.01,6,10,1677,5,827,2.0,559.0,559.0,5,850,2.0,582.0,582.0
177.116,17,78,11067,39,2593,4660.0,44.0,38.0,39,8474,4660.0,239.0,189.0
0.082,6,10,1506,5,395,17.0,127.0,127.0,5,1111,17.0,843.0,843.0
0.004,17,2,136,1,60,0.0,32.0,32.0,1,76,0.0,48.0,48.0
0.004,6,10,1702,5,863,1.0,595.0,595.0,5,839,0.0,571.0,571.0
0.122,6,10,1506,5,395,26.0,127.0,127.0,5,1111,25.0,843.0,843.0
0.1,6,10,1506,5,395,20.0,127.0,127.0,5,1111,23.0,843.0,843.0
0.014,6,10,1990,5,911,3.0,643.0,643.0,5,1079,3.0,811.0,811.0
0.004,6,10,1779,5,928,1.0,660.0,660.0,5,851,1.0,583.0,583.0
0.189,6,10,1506,5,395,43.0,127.0,127.0,5,1111,18.0,843.0,843.0
0.001,17,2,136,1,60,0.0,32.0,32.0,1,76,0.0,48.0,48.0
0.017,6,10,1990,5,911,4.0,643.0,643.0,5,1079,4.0,811.0,811.0
0.072,6,10,1506,5,395,16.0,127.0,127.0,5,1111,16.0,843.0,843.0
0.008,6,10,1989,5,910,1.0,642.0,642.0,5,1079,1.0,811.0,811.0
0.008,6,12,1926,6,1189,1.0,659.0,434.0,6,737,1.0,417.0,417.0
40.091,17,10,676,5,460,10020.0,104.0,64.0,5,216,10022.0,20.0,15.0
0.01,6,10,1677,5,827,2.0,559.0,559.0,5,850,2.0,582.0,582.0
240.431,6,36,8972,19,2120,13357.0,689.0,224.0,17,6852,15026.0,1402.0,597.0
40.05,17,10,676,5,460,10011.0,104.0,64.0,5,216,10011.0,20.0,15.0
0.005,6,13,3747,7,509,0.0,137.0,137.0,6,3238,0.0,1470.0,1459.0
0.01,17,2,136,1,60,0.0,32.0,32.0,1,76,0.0,48.0,48.0
0.019,6,10,1989,5,910,4.0,642.0,642.0,5,1079,4.0,811.0,811.0
0.015,6,10,1972,5,910,3.0,642.0,642.0,5,1062,3.0,794.0,794.0
0.081,6,10,1506,5,395,19.0,127.0,127.0,5,1111,17.0,843.0,843.0
0.005,6,14,3742,7,452,0.0,80.0,80.0,7,3290,0.0,1448.0,972.0
0.011,6,10,1972,5,910,2.0,642.0,642.0,5,1062,2.0,794.0,794.0
0.111,6,10,1506,5,395,22.0,127.0,127.0,5,1111,22.0,843.0,843.0
0.005,6,10,1547,5,764,1.0,496.0,496.0,5,783,1.0,515.0,515.0
0.012,6,10,1989,5,910,2.0,642.0,642.0,5,1079,2.0,811.0,811.0
0.009,6,10,1989,5,910,2.0,642.0,642.0,5,1079,2.0,811.0,811.0
0.008,6,10,1762,5,911,2.0,643.0,643.0,5,851,1.0,583.0,583.0
0.013,6,10,1983,5,910,3.0,642.0,642.0,5,1073,3.0,805.0,805.0
0.004,6,10,1702,5,863,0.0,595.0,595.0,5,839,1.0,571.0,571.0
308.852,17,20,1124,10,716,34303.0,48.0,43.0,10,408,34303.0,20.0,12.0
0.007,6,10,1989,5,910,1.0,642.0,642.0,5,1079,1.0,811.0,811.0
0.006,6,10,1547,5,764,1.0,496.0,496.0,5,783,1.0,515.0,515.0
0.005,6,10,2006,5,927,1.0,659.0,659.0,5,1079,1.0,811.0,811.0
0.079,6,10,1506,5,395,17.0,127.0,127.0,5,1111,19.0,843.0,843.0
0.067,6,10,1506,5,395,15.0,127.0,127.0,5,1111,12.0,843.0,843.0
178.347,17,84,11920,42,2807,4349.0,44.0,38.0,42,9113,4349.0,239.0,188.0
0.001,17,2,166,1,75,0.0,47.0,47.0,1,91,0.0,63.0,63.0
0.026,6,13,3735,7,497,4.0,125.0,125.0,6,3238,5.0,1470.0,1459.0
0.01,6,10,1989,5,910,2.0,642.0,642.0,5,1079,2.0,811.0,811.0
0.013,6,10,1677,5,827,3.0,559.0,559.0,5,850,3.0,582.0,582.0
0.009,17,2,136,1,60,0.0,32.0,32.0,1,76,0.0,48.0,48.0
0.021,6,10,1989,5,910,5.0,642.0,642.0,5,1079,5.0,811.0,811.0
0.012,6,10,1989,5,910,2.0,642.0,642.0,5,1079,3.0,811.0,811.0
0.006,6,12,1698,6,863,1.0,327.0,271.0,6,835,1.0,515.0,515.0
0.078,6,10,1506,5,395,17.0,127.0,127.0,5,1111,16.0,843.0,843.0
0.005,6,10,2006,5,927,1.0,659.0,659.0,5,1079,1.0,811.0,811.0
0.004,17,2,214,1,75,0.0,47.0,47.0,1,139,0.0,111.0,111.0
0.005,17,2,170,1,65,0.0,37.0,37.0,1,105,0.0,77.0,77.0
300.421,6,16,2170,9,684,37531.0,146.0,146.0,7,1486,50041.0,419.0,398.0
175.181,17,68,9774,34,2267,5308.0,44.0,38.0,34,7507,5308.0,239.0,192.0
0.004,6,10,2006,5,927,1.0,659.0,659.0,5,1079,1.0,811.0,811.0
0.008,6,10,1989,5,910,2.0,642.0,642.0,5,1079,2.0,811.0,811.0
0.019,6,13,3816,7,578,3.0,206.0,206.0,6,3238,3.0,1470.0,1459.0
0.134,6,10,1506,5,395,25.0,127.0,127.0,5,1111,31.0,843.0,843.0
0.005,6,10,2006,5,927,1.0,659.0,659.0,5,1079,1.0,811.0,811.0
0.01,6,10,1990,5,911,2.0,643.0,643.0,5,1079,2.0,811.0,811.0
0.069,17,8,3613,4,1874,23.0,1350.0,440.0,4,1739,11.0,1350.0,406.0
0.127,6,10,1506,5,395,26.0,127.0,127.0,5,1111,30.0,843.0,843.0
0.004,17,2,136,1,60,0.0,32.0,32.0,1,76,0.0,48.0,48.0
0.015,6,10,1989,5,910,3.0,642.0,642.0,5,1079,3.0,811.0,811.0
0.131,6,10,1506,5,395,30.0,127.0,127.0,5,1111,29.0,843.0,843.0
0.036,17,2,152,1,76,0.0,48.0,48.0,1,76,0.0,48.0,48.0
0.012,6,10,1989,5,910,2.0,642.0,642.0,5,1079,3.0,811.0,811.0
0.205,6,16,2778,8,1396,29.0,533.0,324.0,8,1382,18.0,529.0,239.0
0.094,6,10,1506,5,395,20.0,127.0,127.0,5,1111,22.0,843.0,843.0
0.086,17,2,144,1,64,0.0,36.0,36.0,1,80,0.0,52.0,52.0
0.089,6,10,1506,5,395,21.0,127.0,127.0,5,1111,17.0,843.0,843.0
0.006,6,10,1643,5,860,1.0,592.0,592.0,5,783,1.0,515.0,515.0
0.013,17,2,152,1,56,0.0,28.0,28.0,1,96,0.0,68.0,68.0
0.017,6,10,1631,5,848,4.0,580.0,580.0,5,783,4.0,515.0,515.0
0.083,6,10,1506,5,395,18.0,127.0,127.0,5,1111,19.0,843.0,843.0
0.149,6,10,1506,5,395,35.0,127.0,127.0,5,1111,32.0,843.0,843.0
0.008,17,4,284,2,120,0.0,32.0,32.0,2,164,0.0,60.0,54.0
0.011,6,10,1989,5,910,2.0,642.0,642.0,5,1079,2.0,811.0,811.0
0.006,6,10,1989,5,927,1.0,659.0,659.0,5,1062,1.0,794.0,794.0
0.005,6,10,1989,5,927,1.0,659.0,659.0,5,1062,1.0,794.0,794.0
295.683,17,122,17431,61,4065,4927.0,44.0,38.0,61,13366,4928.0,252.0,191.0
1791.486,6,488,99274,246,88004,7311.0,421.0,368.0,242,11270,7433.0,53.0,53.0
0.014,6,10,1631,5,848,3.0,580.0,580.0,5,783,3.0,515.0,515.0
368.771,6,22,2313,16,867,24584.0,195.0,195.0,6,1446,4716.0,419.0,398.0
175.076,17,92,13082,46,3096,3890.0,44.0,39.0,46,9986,3890.0,239.0,189.0
0.019,6,10,1972,5,910,4.0,642.0,642.0,5,1062,4.0,794.0,794.0
0.006,6,10,1547,5,764,1.0,496.0,496.0,5,783,1.0,515.0,515.0
0.173,17,2,152,1,76,0.0,48.0,48.0,1,76,0.0,48.0,48.0
293.811,6,313,344496,116,17581,2554.0,2736.0,888.0,197,326915,1499.0,2804.0,1730.0
0.004,6,10,2007,5,928,1.0,660.0,660.0,5,1079,1.0,811.0,811.0
0.011,6,10,1989,5,910,2.0,642.0,642.0,5,1079,2.0,811.0,811.0
0.014,6,10,1762,5,911,3.0,643.0,643.0,5,851,3.0,583.0,583.0
0.009,6,10,1989,5,910,2.0,642.0,642.0,5,1079,2.0,811.0,811.0
0.018,6,10,1677,5,827,4.0,559.0,559.0,5,850,4.0,582.0,582.0
0.001,17,2,180,1,66,0.0,38.0,38.0,1,114,0.0,86.0,86.0
0.023,6,10,1990,5,911,5.0,643.0,643.0,5,1079,5.0,811.0,811.0
0.005,6,10,2007,5,928,1.0,660.0,660.0,5,1079,1.0,811.0,811.0
0.1,6,10,1506,5,395,21.0,127.0,127.0,5,1111,22.0,843.0,843.0
0.001,17,2,179,1,62,0.0,34.0,34.0,1,117,0.0,89.0,89.0
0.041,17,4,284,2,120,0.0,32.0,32.0,2,164,37.0,60.0,54.0
0.109,6,10,1506,5,395,25.0,127.0,127.0,5,1111,26.0,843.0,843.0
0.086,6,10,1506,5,395,19.0,127.0,127.0,5,1111,17.0,843.0,843.0
0.014,6,10,1983,5,910,3.0,642.0,642.0,5,1073,3.0,805.0,805.0
0.011,6,10,1762,5,911,2.0,643.0,643.0,5,851,2.0,583.0,583.0
240.017,6,9,787,5,488,60004.0,232.0,232.0,4,299,80004.0,83.0,83.0
0.005,17,2,136,1,60,0.0,32.0,32.0,1,76,0.0,48.0,48.0
0.005,17,2,154,1,69,0.0,41.0,41.0,1,85,0.0,57.0,57.0
0.041,17,2,152,1,76,0.0,48.0,48.0,1,76,0.0,48.0,48.0
0.005,6,10,2006,5,927,1.0,659.0,659.0,5,1079,1.0,811.0,811.0
0.005,6,10,2006,5,927,1.0,659.0,659.0,5,1079,1.0,811.0,811.0
10.851,17,28,4423,14,1994,825.0,269.0,114.0,14,2429,825.0,588.0,145.0
0.014,6,10,1972,5,910,3.0,642.0,642.0,5,1062,3.0,794.0,794.0
11.291,17,28,4416,14,1993,855.0,268.0,114.0,14,2423,855.0,586.0,145.0
0.014,6,10,1989,5,910,3.0,642.0,642.0,5,1079,3.0,811.0,811.0
0.125,6,10,1506,5,395,22.0,127.0,127.0,5,1111,28.0,843.0,843.0
0.005,6,10,2007,5,928,1.0,660.0,660.0,5,1079,1.0,811.0,811.0
0.009,6,13,3735,7,497,1.0,125.0,125.0,6,3238,1.0,1470.0,1459.0
0.017,6,10,1631,5,848,4.0,580.0,580.0,5,783,4.0,515.0,515.0
1770.615,17,120,11460,60,5460,30010.0,63.0,63.0,60,6000,30010.0,72.0,72.0
0.076,6,10,1506,5,395,18.0,127.0,127.0,5,1111,17.0,843.0,843.0
0.005,6,10,2007,5,928,1.0,660.0,660.0,5,1079,1.0,811.0,811.0
0.014,6,10,1989,5,910,3.0,642.0,642.0,5,1079,3.0,811.0,811.0
0.006,6,10,2006,5,927,1.0,659.0,659.0,5,1079,1.0,811.0,811.0
0.139,6,10,1506,5,395,34.0,127.0,127.0,5,1111,32.0,843.0,843.0
0.009,6,10,1677,5,827,2.0,559.0,559.0,5,850,2.0,582.0,582.0
0.072,17,2,136,1,60,0.0,32.0,32.0,1,76,0.0,48.0,48.0
0.012,6,10,1631,5,848,3.0,580.0,580.0,5,783,2.0,515.0,515.0
0.01,6,13,3735,7,497,1.0,125.0,125.0,6,3238,1.0,1470.0,1459.0
0.006,6,10,1547,5,764,1.0,496.0,496.0,5,783,1.0,515.0,515.0
0.001,17,2,180,1,66,0.0,38.0,38.0,1,114,0.0,86.0,86.0
11.682,17,36,7283,18,2955,677.0,270.0,136.0,18,4328,677.0,1337.0,212.0
0.003,17,4,284,2,120,0.0,32.0,32.0,2,164,0.0,60.0,54.0
0.005,6,10,2006,5,927,1.0,659.0,659.0,5,1079,1.0,811.0,811.0
296.386,17,126,18119,63,4225,4780.0,44.0,39.0,63,13894,4780.0,239.0,192.0
0.077,6,10,1506,5,395,15.0,127.0,127.0,5,1111,16.0,843.0,843.0
361.842,6,21,1793,16,1030,24122.0,190.0,190.0,5,763,60009.0,462.0,247.0
0.082,6,10,1506,5,395,19.0,127.0,127.0,5,1111,19.0,843.0,843.0
0.005,6,10,2007,5,928,1.0,660.0,660.0,5,1079,1.0,811.0,811.0
0.005,6,14,3799,7,509,0.0,137.0,137.0,7,3290,0.0,1448.0,972.0
0.052,17,2,152,1,76,0.0,48.0,48.0,1,76,0.0,48.0,48.0
0.003,17,2,136,1,60,0.0,32.0,32.0,1,76,0.0,48.0,48.0
0.016,6,10,1989,5,910,3.0,642.0,642.0,5,1079,4.0,811.0,811.0
0.005,6,13,3747,7,509,0.0,137.0,137.0,6,3238,0.0,1470.0,1459.0
0.003,17,4,284,2,120,0.0,32.0,32.0,2,164,0.0,60.0,54.0
0.004,6,10,2006,5,927,1.0,659.0,659.0,5,1079,1.0,811.0,811.0
0.005,6,10,1989,5,927,1.0,659.0,659.0,5,1062,1.0,794.0,794.0
0.011,6,10,1989,5,910,2.0,642.0,642.0,5,1079,2.0,811.0,811.0
10.838,17,28,4423,14,1994,825.0,269.0,114.0,14,2429,825.0,588.0,145.0
0.005,6,10,1643,5,860,1.0,592.0,592.0,5,783,1.0,515.0,515.0
0.01,6,10,1990,5,911,2.0,643.0,643.0,5,1079,2.0,811.0,811.0
0.088,6,10,1506,5,395,17.0,127.0,127.0,5,1111,20.0,843.0,843.0
0.005,6,10,2006,5,927,1.0,659.0,659.0,5,1079,1.0,811.0,811.0
0.004,6,10,2007,5,928,1.0,660.0,660.0,5,1079,1.0,811.0,811.0
1792.781,6,569,191785,297,165156,6056.0,2883.0,885.0,272,26629,6615.0,580.0,122.0
0.112,6,10,1506,5,395,21.0,127.0,127.0,5,1111,25.0,843.0,843.0
0.005,6,10,1774,5,923,1.0,655.0,655.0,5,851,1.0,583.0,583.0
292.849,6,306,343782,126,18738,2342.0,2736.0,870.0,180,325044,1636.0,2804.0,1913.0
0.016,6,13,3735,7,497,2.0,125.0,125.0,6,3238,3.0,1470.0,1459.0
0.008,17,2,194,1,59,0.0,31.0,31.0,1,135,0.0,107.0,107.0
0.016,6,10,1983,5,910,4.0,642.0,642.0,5,1073,4.0,805.0,805.0
0.012,6,10,1989,5,910,3.0,642.0,642.0,5,1079,3.0,811.0,811.0
0.082,6,10,1506,5,395,18.0,127.0,127.0,5,1111,17.0,843.0,843.0
0.001,17,2,180,1,66,0.0,38.0,38.0,1,114,0.0,86.0,86.0
0.002,17,2,180,1,66,0.0,38.0,38.0,1,114,0.0,86.0,86.0
0.104,6,10,1506,5,395,23.0,127.0,127.0,5,1111,20.0,843.0,843.0
10.91,17,26,4098,13,1846,900.0,269.0,114.0,13,2252,900.0,587.0,145.0
0.006,6,10,1547,5,764,1.0,496.0,496.0,5,783,1.0,515.0,515.0
0.082,6,10,1506,5,395,19.0,127.0,127.0,5,1111,17.0,843.0,843.0
0.014,6,10,1677,5,827,3.0,559.0,559.0,5,850,3.0,582.0,582.0
0.005,17,2,170,1,65,0.0,37.0,37.0,1,105,0.0,77.0,77.0
0.008,6,10,1989,5,910,1.0,642.0,642.0,5,1079,2.0,811.0,811.0
0.003,17,2,148,1,60,0.0,32.0,32.0,1,88,0.0,60.0,60.0
1786.17,6,151,19402,90,13740,20069.0,302.0,302.0,61,5662,29769.0,83.0,83.0
0.005,17,2,230,1,68,0.0,40.0,40.0,1,162,0.0,134.0,134.0
0.004,6,10,1702,5,863,1.0,595.0,595.0,5,839,0.0,571.0,571.0
0.048,17,2,144,1,64,0.0,36.0,36.0,1,80,0.0,52.0,52.0
0.013,6,10,1762,5,911,3.0,643.0,643.0,5,851,3.0,583.0,583.0
0.146,6,10,1506,5,395,31.0,127.0,127.0,5,1111,34.0,843.0,843.0
0.07,17,8,3613,4,1874,23.0,1350.0,440.0,4,1739,12.0,1350.0,406.0
0.015,6,10,1631,5,848,3.0,580.0,580.0,5,783,3.0,515.0,515.0
15.071,17,14,9190,8,6902,2149.0,1350.0,834.0,6,2288,3008.0,1350.0,353.0
40.048,17,10,676,5,460,10011.0,104.0,64.0,5,216,10011.0,20.0,15.0
0.005,6,14,3799,7,509,0.0,137.0,137.0,7,3290,0.0,1448.0,972.0
0.022,6,10,1677,5,827,5.0,559.0,559.0,5,850,5.0,582.0,582.0
40.072,17,10,676,5,460,10017.0,104.0,64.0,5,216,10017.0,20.0,15.0
0.008,6,10,2000,5,927,1.0,659.0,659.0,5,1073,2.0,805.0,805.0
0.01,6,10,1972,5,910,2.0,642.0,642.0,5,1062,2.0,794.0,794.0
0.008,6,10,1989,5,910,2.0,642.0,642.0,5,1079,2.0,811.0,811.0
0.005,17,2,164,1,74,0.0,46.0,46.0,1,90,0.0,62.0,62.0
158.263,6,22,7416,11,1284,131.0,509.0,270.0,11,6132,15809.0,1823.0,946.0
0.006,17,2,170,1,65,0.0,37.0,37.0,1,105,0.0,77.0,77.0
351.991,6,20,2210,6,1308,12003.0,494.0,494.0,14,902,27076.0,83.0,83.0
0.084,6,10,1506,5,395,17.0,127.0,127.0,5,1111,17.0,843.0,843.0
1770.31,6,87,4626,44,2340,41169.0,26.0,26.0,43,2286,42149.0,26.0,25.0
0.075,6,10,1506,5,395,17.0,127.0,127.0,5,1111,14.0,843.0,843.0
0.011,6,14,3787,7,497,1.0,125.0,125.0,7,3290,1.0,1448.0,972.0
0.006,6,10,1547,5,764,1.0,496.0,496.0,5,783,1.0,515.0,515.0
0.038,17,2,136,1,60,0.0,32.0,32.0,1,76,0.0,48.0,48.0
0.005,6,10,1854,5,889,1.0,621.0,621.0,5,965,1.0,697.0,697.0
0.006,6,10,1547,5,764,1.0,496.0,496.0,5,783,1.0,515.0,515.0
0.008,6,12,1926,6,1189,1.0,659.0,434.0,6,737,1.0,417.0,417.0
0.013,6,10,1983,5,910,3.0,642.0,642.0,5,1073,3.0,805.0,805.0
0.018,6,10,1989,5,910,4.0,642.0,642.0,5,1079,4.0,811.0,811.0
0.011,6,10,1989,5,910,2.0,642.0,642.0,5,1079,2.0,811.0,811.0
60.615,6,25,17436,14,9539,4662.0,2847.0,1469.0,11,7897,6048.0,2320.0,1219.0
0.008,6,10,1677,5,827,1.0,559.0,559.0,5,850,2.0,582.0,582.0
0.005,6,10,1689,5,839,1.0,571.0,571.0,5,850,1.0,582.0,582.0
0.111,6,10,1506,5,395,25.0,127.0,127.0,5,1111,25.0,843.0,843.0
0.004,6,10,2006,5,927,1.0,659.0,659.0,5,1079,1.0,811.0,811.0
0.015,6,10,1762,5,911,3.0,643.0,643.0,5,851,3.0,583.0,583.0
0.005,17,2,213,1,69,0.0,41.0,41.0,1,144,0.0,116.0,116.0
0.01,6,10,1990,5,911,2.0,643.0,643.0,5,1079,2.0,811.0,811.0
0.009,6,10,1990,5,911,2.0,643.0,643.0,5,1079,2.0,811.0,811.0
0.092,6,10,1506,5,395,19.0,127.0,127.0,5,1111,21.0,843.0,843.0
0.007,6,10,2007,5,928,1.0,660.0,660.0,5,1079,1.0,811.0,811.0
0.006,6,10,1989,5,927,1.0,659.0,659.0,5,1062,1.0,794.0,794.0
0.004,6,10,1989,5,927,1.0,659.0,659.0,5,1062,1.0,794.0,794.0
240.1,6,31,9316,15,6908,17150.0,2032.0,681.0,16,2408,16006.0,580.0,196.0
0.014,6,10,1989,5,910,3.0,642.0,642.0,5,1079,3.0,811.0,811.0
240.097,6,31,9560,15,7169,17149.0,2293.0,710.0,16,2391,16006.0,580.0,193.0
0.005,6,10,2007,5,928,1.0,660.0,660.0,5,1079,1.0,811.0,811.0
0.014,6,10,1990,5,911,3.0,643.0,643.0,5,1079,3.0,811.0,811.0
0.004,17,2,136,1,60,0.0,32.0,32.0,1,76,0.0,48.0,48.0
0.004,17,2,132,1,58,0.0,30.0,30.0,1,74,0.0,46.0,46.0
11.169,17,28,4422,14,1993,846.0,268.0,114.0,14,2429,846.0,588.0,145.0
0.005,6,10,1854,5,889,1.0,621.0,621.0,5,965,1.0,697.0,697.0
0.068,6,10,1506,5,395,16.0,127.0,127.0,5,1111,15.0,843.0,843.0
0.074,6,10,1506,5,395,16.0,127.0,127.0,5,1111,15.0,843.0,843.0
0.006,6,10,1547,5,764,1.0,496.0,496.0,5,783,1.0,515.0,515.0
0.005,17,2,230,1,68,0.0,40.0,40.0,1,162,0.0,134.0,134.0
0.011,6,14,3787,7,497,1.0,125.0,125.0,7,3290,1.0,1448.0,972.0
0.041,6,13,3816,7,578,6.0,206.0,206.0,6,3238,8.0,1470.0,1459.0
10.744,17,28,4424,14,1995,818.0,270.0,114.0,14,2429,817.0,588.0,145.0
0.006,6,10,1689,5,839,1.0,571.0,571.0,5,850,1.0,582.0,582.0
0.004,6,10,2000,5,927,1.0,659.0,659.0,5,1073,1.0,805.0,805.0
0.005,6,10,2000,5,927,1.0,659.0,659.0,5,1073,1.0,805.0,805.0
0.089,6,10,1506,5,395,20.0,127.0,127.0,5,1111,21.0,843.0,843.0
0.089,6,10,1506,5,395,20.0,127.0,127.0,5,1111,20.0,843.0,843.0
0.005,6,10,2007,5,928,1.0,660.0,660.0,5,1079,1.0,811.0,811.0
0.004,17,2,136,1,60,0.0,32.0,32.0,1,76,0.0,48.0,48.0
0.003,17,2,136,1,60,0.0,32.0,32.0,1,76,0.0,48.0,48.0
0.001,17,2,136,1,60,0.0,32.0,32.0,1,76,0.0,48.0,48.0
0.038,17,2,148,1,60,0.0,32.0,32.0,1,88,0.0,60.0,60.0
0.006,6,10,1547,5,764,1.0,496.0,496.0,5,783,1.0,515.0,515.0
0.006,6,14,3742,7,452,0.0,80.0,80.0,7,3290,0.0,1448.0,972.0
0.005,6,10,2006,5,927,1.0,659.0,659.0,5,1079,1.0,811.0,811.0
0.162,6,10,1506,5,395,38.0,127.0,127.0,5,1111,20.0,843.0,843.0
0.04,17,4,284,2,120,0.0,32.0,32.0,2,164,36.0,60.0,54.0
0.005,6,10,1547,5,764,1.0,496.0,496.0,5,783,1.0,515.0,515.0
1730.371,6,49,2997,31,1800,57679.0,35.0,35.0,18,1197,101782.0,31.0,31.0
0.006,6,10,1989,5,927,1.0,659.0,659.0,5,1062,1.0,794.0,794.0
0.031,6,10,1990,5,911,7.0,643.0,643.0,5,1079,7.0,811.0,811.0
0.013,6,10,1989,5,910,3.0,642.0,642.0,5,1079,3.0,811.0,811.0
240.095,6,16,4481,9,963,30011.0,238.0,166.0,7,3518,40015.0,1402.0,786.0
0.006,6,10,1547,5,764,1.0,496.0,496.0,5,783,1.0,515.0,515.0
369.917,6,22,2313,16,867,24661.0,195.0,195.0,6,1446,4654.0,419.0,398.0
0.015,6,10,1677,5,827,3.0,559.0,559.0,5,850,3.0,582.0,582.0
0.011,6,10,1989,5,910,2.0,642.0,642.0,5,1079,2.0,811.0,811.0
0.001,17,2,180,1,66,0.0,38.0,38.0,1,114,0.0,86.0,86.0
0.179,17,4,352,2,130,140.0,37.0,37.0,2,222,143.0,89.0,83.0
0.13,6,10,1506,5,395,30.0,127.0,127.0,5,1111,24.0,843.0,843.0
0.004,6,10,2007,5,928,1.0,660.0,660.0,5,1079,1.0,811.0,811.0
354.028,6,19,1691,15,978,25287.0,190.0,190.0,4,713,80004.0,497.0,497.0
0.004,17,2,132,1,58,0.0,30.0,30.0,1,74,0.0,46.0,46.0
0.014,6,10,1972,5,910,3.0,642.0,642.0,5,1062,3.0,794.0,794.0
0.015,6,10,1631,5,848,3.0,580.0,580.0,5,783,3.0,515.0,515.0
0.04,17,4,420,2,122,3.0,33.0,33.0,2,298,33.0,145.0,121.0
351.99,6,20,2210,6,1308,12003.0,494.0,494.0,14,902,27076.0,83.0,83.0
0.083,6,10,1506,5,395,19.0,127.0,127.0,5,1111,18.0,843.0,843.0
0.005,6,10,1689,5,839,1.0,571.0,571.0,5,850,1.0,582.0,582.0
10.746,17,28,4418,14,1994,818.0,269.0,114.0,14,2424,818.0,587.0,145.0
0.013,6,10,1677,5,827,3.0,559.0,559.0,5,850,3.0,582.0,582.0
0.038,17,4,284,2,120,1.0,32.0,32.0,2,164,34.0,60.0,54.0
0.005,6,14,3742,7,452,0.0,80.0,80.0,7,3290,0.0,1448.0,972.0
40.069,17,10,676,5,460,10014.0,104.0,64.0,5,216,10016.0,20.0,15.0
0.138,6,10,1506,5,395,30.0,127.0,127.0,5,1111,31.0,843.0,843.0
0.133,6,10,1506,5,395,30.0,127.0,127.0,5,1111,30.0,843.0,843.0
0.004,17,2,136,1,60,0.0,32.0,32.0,1,76,0.0,48.0,48.0
0.001,17,2,180,1,66,0.0,38.0,38.0,1,114,0.0,86.0,86.0
0.006,6,12,1698,6,863,1.0,327.0,271.0,6,835,1.0,515.0,515.0
0.004,6,10,2006,5,927,1.0,659.0,659.0,5,1079,1.0,811.0,811.0
0.005,6,10,2007,5,928,1.0,660.0,660.0,5,1079,1.0,811.0,811.0
0.079,6,10,1506,5,395,18.0,127.0,127.0,5,1111,17.0,843.0,843.0
0.001,17,2,166,1,75,0.0,47.0,47.0,1,91,0.0,63.0,63.0
0.112,6,10,1506,5,395,24.0,127.0,127.0,5,1111,25.0,843.0,843.0
0.093,6,10,1506,5,395,20.0,127.0,127.0,5,1111,22.0,843.0,843.0
0.108,6,10,1506,5,395,21.0,127.0,127.0,5,1111,25.0,843.0,843.0
0.003,17,4,284,2,120,0.0,32.0,32.0,2,164,0.0,60.0,54.0
0.091,6,10,1506,5,395,20.0,127.0,127.0,5,1111,18.0,843.0,843.0
0.015,6,10,1762,5,911,3.0,643.0,643.0,5,851,3.0,583.0,583.0
0.136,6,10,1506,5,395,32.0,127.0,127.0,5,1111,27.0,843.0,843.0
289.487,6,390,348476,193,21605,1507.0,2736.0,889.0,197,326871,1476.0,2804.0,1730.0
300.75,6,37,8881,20,3403,15828.0,1360.0,514.0,17,5478,536.0,2667.0,435.0
1777.898,17,144,45504,72,22752,25040.0,288.0,288.0,72,22752,25040.0,288.0,288.0
0.004,6,10,1989,5,927,1.0,659.0,659.0,5,1062,1.0,794.0,794.0
0.006,17,2,293,1,73,0.0,45.0,45.0,1,220,0.0,192.0,192.0
0.021,17,2,144,1,64,0.0,36.0,36.0,1,80,0.0,52.0,52.0
0.013,6,10,1989,5,910,3.0,642.0,642.0,5,1079,3.0,811.0,811.0
240.546,6,63,38787,28,30801,8909.0,4104.0,1834.0,35,7986,7074.0,1656.0,769.0
0.006,17,2,170,1,65,0.0,37.0,37.0,1,105,0.0,77.0,77.0
0.006,6,10,1547,5,764,1.0,496.0,496.0,5,783,1.0,515.0,515.0
0.093,6,10,1506,5,395,22.0,127.0,127.0,5,1111,21.0,843.0,843.0
0.01,6,10,1990,5,911,2.0,643.0,643.0,5,1079,2.0,811.0,811.0
0.004,6,10,1774,5,923,1.0,655.0,655.0,5,851,1.0,583.0,583.0
0.101,6,10,1506,5,395,22.0,127.0,127.0,5,1111,21.0,843.0,843.0
0.07,6,10,1506,5,395,15.0,127.0,127.0,5,1111,16.0,843.0,843.0
0.097,6,10,1506,5,395,22.0,127.0,127.0,5,1111,22.0,843.0,843.0
0.124,6,10,1506,5,395,24.0,127.0,127.0,5,1111,22.0,843.0,843.0
0.065,6,10,1506,5,395,15.0,127.0,127.0,5,1111,12.0,843.0,843.0
0.005,17,2,179,1,71,0.0,43.0,43.0,1,108,0.0,80.0,80.0
0.044,17,2,148,1,60,0.0,32.0,32.0,1,88,0.0,60.0,60.0
0.005,6,10,2006,5,927,1.0,659.0,659.0,5,1079,1.0,811.0,811.0
0.084,6,10,1506,5,395,19.0,127.0,127.0,5,1111,19.0,843.0,843.0
0.118,6,10,1506,5,395,24.0,127.0,127.0,5,1111,26.0,843.0,843.0
0.005,6,10,2006,5,927,1.0,659.0,659.0,5,1079,1.0,811.0,811.0
40.065,17,10,676,5,460,10014.0,104.0,64.0,5,216,10015.0,20.0,15.0
308.54,17,20,1124,10,716,34268.0,48.0,43.0,10,408,34267.0,20.0,12.0
40.066,17,10,676,5,460,10013.0,104.0,64.0,5,216,10015.0,20.0,15.0
0.096,6,10,1506,5,395,22.0,127.0,127.0,5,1111,20.0,843.0,843.0
0.171,17,2,152,1,76,0.0,48.0,48.0,1,76,0.0,48.0,48.0
40.063,17,10,676,5,460,10013.0,104.0,64.0,5,216,10015.0,20.0,15.0
0.006,6,10,2006,5,927,1.0,659.0,659.0,5,1079,1.0,811.0,811.0
0.005,6,10,2006,5,927,1.0,659.0,659.0,5,1079,1.0,811.0,811.0
0.005,17,2,144,1,64,0.0,36.0,36.0,1,80,0.0,52.0,52.0
0.005,6,10,2000,5,927,1.0,659.0,659.0,5,1073,1.0,805.0,805.0
15.273,17,18,8668,9,6303,1908.0,1350.0,672.0,9,2365,1905.0,1350.0,234.0
240.117,6,34,10779,17,8176,15007.0,2883.0,729.0,17,2603,15007.0,580.0,213.0
328.349,17,20,1124,10,716,36469.0,48.0,43.0,10,408,36468.0,20.0,12.0
9.036,17,6,376,5,280,2259.0,28.0,28.0,1,96,0.0,68.0,68.0
174.491,17,77,10970,39,2599,4591.0,44.0,38.0,38,8371,4715.0,279.0,192.0
0.088,6,10,1506,5,395,18.0,127.0,127.0,5,1111,18.0,843.0,843.0
0.005,6,10,1989,5,927,1.0,659.0,659.0,5,1062,1.0,794.0,794.0
0.001,17,2,136,1,60,0.0,32.0,32.0,1,76,0.0,48.0,48.0
0.007,6,10,1854,5,1169,1.0,901.0,901.0,5,685,1.0,417.0,417.0
240.014,6,9,787,5,488,60003.0,232.0,232.0,4,299,80003.0,83.0,83.0
0.012,6,10,1990,5,911,2.0,643.0,643.0,5,1079,2.0,811.0,811.0
0.005,6,10,2007,5,928,1.0,660.0,660.0,5,1079,1.0,811.0,811.0
178.039,17,68,9770,34,2266,5395.0,44.0,38.0,34,7504,5395.0,239.0,192.0
0.004,17,4,284,2,120,0.0,32.0,32.0,2,164,1.0,60.0,54.0
172.159,17,78,10979,39,2601,4530.0,44.0,38.0,39,8378,4530.0,261.0,186.0
0.006,6,10,2007,5,928,1.0,660.0,660.0,5,1079,1.0,811.0,811.0
0.001,17,2,166,1,75,0.0,47.0,47.0,1,91,0.0,63.0,63.0
0.004,6,10,2007,5,928,1.0,660.0,660.0,5,1079,1.0,811.0,811.0
0.012,6,10,1989,5,910,2.0,642.0,642.0,5,1079,2.0,811.0,811.0
0.029,6,10,1972,5,910,7.0,642.0,642.0,5,1062,7.0,794.0,794.0
0.005,6,10,2006,5,927,1.0,659.0,659.0,5,1079,1.0,811.0,811.0
0.005,6,10,2006,5,927,1.0,659.0,659.0,5,1079,1.0,811.0,811.0
0.007,6,10,1547,5,764,1.0,496.0,496.0,5,783,1.0,515.0,515.0
0.001,17,2,136,1,60,0.0,32.0,32.0,1,76,0.0,48.0,48.0
0.01,6,10,1972,5,910,2.0,642.0,642.0,5,1062,2.0,794.0,794.0
0.095,6,10,1506,5,395,21.0,127.0,127.0,5,1111,21.0,843.0,843.0
0.007,17,2,170,1,65,0.0,37.0,37.0,1,105,0.0,77.0,77.0
0.006,17,2,154,1,69,0.0,41.0,41.0,1,85,0.0,57.0,57.0
0.005,6,10,2006,5,927,1.0,659.0,659.0,5,1079,1.0,811.0,811.0
0.005,17,2,170,1,65,0.0,37.0,37.0,1,105,0.0,77.0,77.0
0.079,6,10,1506,5,395,15.0,127.0,127.0,5,1111,18.0,843.0,843.0
0.006,6,10,1854,5,889,1.0,621.0,621.0,5,965,1.0,697.0,697.0
176.085,17,92,13070,46,3095,3912.0,44.0,39.0,46,9975,3912.0,239.0,188.0
0.004,6,10,1774,5,923,1.0,655.0,655.0,5,851,1.0,583.0,583.0
0.121,6,10,1506,5,395,25.0,127.0,127.0,5,1111,29.0,843.0,843.0
0.042,17,2,152,1,76,0.0,48.0,48.0,1,76,0.0,48.0,48.0
0.001,17,2,166,1,75,0.0,47.0,47.0,1,91,0.0,63.0,63.0
0.08,6,10,1506,5,395,17.0,127.0,127.0,5,1111,18.0,843.0,843.0
0.016,6,10,1972,5,910,3.0,642.0,642.0,5,1062,4.0,794.0,794.0
40.057,17,10,676,5,460,10013.0,104.0,64.0,5,216,10013.0,20.0,15.0
40.075,17,10,676,5,460,10018.0,104.0,64.0,5,216,10017.0,20.0,15.0
0.001,17,2,180,1,66,0.0,38.0,38.0,1,114,0.0,86.0,86.0
0.005,6,10,2006,5,927,1.0,659.0,659.0,5,1079,1.0,811.0,811.0
0.005,17,2,169,1,62,0.0,34.0,34.0,1,107,0.0,79.0,79.0
40.066,17,10,676,5,460,10013.0,104.0,64.0,5,216,10014.0,20.0,15.0
0.006,17,2,168,1,76,0.0,48.0,48.0,1,92,0.0,64.0,64.0
0.012,6,10,1972,5,910,3.0,642.0,642.0,5,1062,2.0,794.0,794.0
0.005,6,10,1989,5,927,1.0,659.0,659.0,5,1062,1.0,794.0,794.0
0.004,6,10,1702,5,863,1.0,595.0,595.0,5,839,1.0,571.0,571.0
0.006,6,10,2007,5,928,1.0,660.0,660.0,5,1079,1.0,811.0,811.0
0.007,6,10,1689,5,839,1.0,571.0,571.0,5,850,1.0,582.0,582.0
0.009,6,10,1989,5,910,2.0,642.0,642.0,5,1079,2.0,811.0,811.0
0.004,6,10,1989,5,927,1.0,659.0,659.0,5,1062,1.0,794.0,794.0
0.004,17,4,284,2,120,1.0,32.0,32.0,2,164,1.0,60.0,54.0
11.111,17,28,4418,14,1994,842.0,269.0,114.0,14,2424,842.0,587.0,145.0
0.041,17,4,284,2,120,0.0,32.0,32.0,2,164,38.0,60.0,54.0
0.01,6,10,1677,5,827,2.0,559.0,559.0,5,850,2.0,582.0,582.0
0.005,17,2,166,1,75,0.0,47.0,47.0,1,91,0.0,63.0,63.0
0.079,6,10,1506,5,395,18.0,127.0,127.0,5,1111,15.0,843.0,843.0
0.003,17,2,148,1,60,0.0,32.0,32.0,1,88,0.0,60.0,60.0
0.001,17,2,180,1,65,0.0,37.0,37.0,1,115,0.0,87.0,87.0
0.005,17,2,148,1,60,0.0,32.0,32.0,1,88,0.0,60.0,60.0
290.813,6,387,348165,199,21909,1468.0,2736.0,888.0,188,326256,1555.0,4206.0,1818.0
0.086,6,10,1506,5,395,21.0,127.0,127.0,5,1111,17.0,843.0,843.0
0.005,6,10,1989,5,927,1.0,659.0,659.0,5,1062,1.0,794.0,794.0
279.024,6,18,4586,9,963,34878.0,238.0,166.0,9,3623,34877.0,1402.0,786.0
0.008,6,10,1989,5,910,2.0,642.0,642.0,5,1079,1.0,811.0,811.0
0.005,6,10,1854,5,889,1.0,621.0,621.0,5,965,1.0,697.0,697.0
0.092,6,10,1506,5,395,18.0,127.0,127.0,5,1111,18.0,843.0,843.0
0.022,6,10,1990,5,911,5.0,643.0,643.0,5,1079,5.0,811.0,811.0
0.096,6,10,1506,5,395,21.0,127.0,127.0,5,1111,22.0,843.0,843.0
0.004,17,2,140,1,62,0.0,34.0,34.0,1,78,0.0,50.0,50.0
0.005,17,2,209,1,64,0.0,36.0,36.0,1,145,0.0,117.0,117.0
0.004,17,2,136,1,60,0.0,32.0,32.0,1,76,0.0,48.0,48.0
0.067,6,10,1506,5,395,14.0,127.0,127.0,5,1111,13.0,843.0,843.0
0.006,6,10,1854,5,889,1.0,621.0,621.0,5,965,1.0,697.0,697.0
0.011,6,10,1677,5,827,2.0,559.0,559.0,5,850,2.0,582.0,582.0
0.006,6,10,1689,5,839,1.0,571.0,571.0,5,850,1.0,582.0,582.0
0.005,6,10,2006,5,927,1.0,659.0,659.0,5,1079,1.0,811.0,811.0
0.096,6,10,1506,5,395,22.0,127.0,127.0,5,1111,20.0,843.0,843.0
0.004,6,10,1702,5,863,1.0,595.0,595.0,5,839,0.0,571.0,571.0
0.004,6,10,2006,5,927,1.0,659.0,659.0,5,1079,1.0,811.0,811.0
0.009,6,10,1972,5,910,2.0,642.0,642.0,5,1062,2.0,794.0,794.0
0.006,6,10,1643,5,860,1.0,592.0,592.0,5,783,1.0,515.0,515.0
0.004,6,10,2007,5,928,1.0,660.0,660.0,5,1079,1.0,811.0,811.0
40.06,17,10,676,5,460,10012.0,104.0,64.0,5,216,10014.0,20.0,15.0
0.018,6,10,1990,5,911,4.0,643.0,643.0,5,1079,4.0,811.0,811.0
0.009,6,10,2000,5,927,2.0,659.0,659.0,5,1073,2.0,805.0,805.0
0.018,6,10,1989,5,910,4.0,642.0,642.0,5,1079,4.0,811.0,811.0
0.006,6,10,1643,5,860,1.0,592.0,592.0,5,783,1.0,515.0,515.0
0.018,6,10,1990,5,911,4.0,643.0,643.0,5,1079,4.0,811.0,811.0
0.004,6,10,1989,5,927,1.0,659.0,659.0,5,1062,1.0,794.0,794.0
0.006,6,10,1547,5,764,1.0,496.0,496.0,5,783,1.0,515.0,515.0
174.335,17,88,12348,44,2935,4054.0,44.0,38.0,44,9413,4054.0,249.0,185.0
0.005,6,10,1774,5,923,1.0,655.0,655.0,5,851,1.0,583.0,583.0
0.073,6,10,1506,5,395,15.0,127.0,127.0,5,1111,13.0,843.0,843.0
0.161,6,10,1506,5,395,37.0,127.0,127.0,5,1111,15.0,843.0,843.0
0.017,6,10,1972,5,910,4.0,642.0,642.0,5,1062,4.0,794.0,794.0
0.004,6,10,1989,5,927,1.0,659.0,659.0,5,1062,1.0,794.0,794.0
0.01,6,10,1762,5,911,2.0,643.0,643.0,5,851,2.0,583.0,583.0
1791.5,6,484,98693,243,87463,7402.0,421.0,368.0,241,11230,7464.0,53.0,53.0
10.801,17,26,4098,13,1823,891.0,270.0,112.0,13,2275,891.0,586.0,147.0
0.125,6,10,1506,5,395,24.0,127.0,127.0,5,1111,26.0,843.0,843.0
0.077,6,10,1506,5,395,15.0,127.0,127.0,5,1111,18.0,843.0,843.0
0.005,17,2,170,1,65,0.0,37.0,37.0,1,105,0.0,77.0,77.0
174.125,17,78,11045,39,2609,4582.0,44.0,38.0,39,8436,4582.0,239.0,188.0
0.105,6,10,1506,5,395,24.0,127.0,127.0,5,1111,22.0,843.0,843.0
0.091,6,10,1506,5,395,19.0,127.0,127.0,5,1111,21.0,843.0,843.0
0.008,6,10,1989,5,910,2.0,642.0,642.0,5,1079,1.0,811.0,811.0
0.088,6,10,1506,5,395,19.0,127.0,127.0,5,1111,21.0,843.0,843.0
313.525,17,20,1124,10,716,34822.0,48.0,43.0,10,408,34822.0,20.0,12.0
0.069,17,2,148,1,60,0.0,32.0,32.0,1,88,0.0,60.0,60.0
0.013,6,10,1631,5,848,3.0,580.0,580.0,5,783,3.0,515.0,515.0
1723.45,6,276,26487,134,9325,12958.0,747.0,295.0,142,17162,12223.0,1625.0,72.0
10.753,17,28,4422,14,1995,818.0,270.0,114.0,14,2427,818.0,586.0,145.0
0.005,6,10,1779,5,928,1.0,660.0,660.0,5,851,1.0,583.0,583.0
0.071,6,10,1506,5,395,14.0,127.0,127.0,5,1111,16.0,843.0,843.0
0.009,6,10,1972,5,910,2.0,642.0,642.0,5,1062,2.0,794.0,794.0
0.004,17,2,184,1,61,0.0,33.0,33.0,1,123,0.0,95.0,95.0
0.005,6,10,2007,5,928,1.0,660.0,660.0,5,1079,1.0,811.0,811.0
0.017,6,10,1983,5,910,4.0,642.0,642.0,5,1073,4.0,805.0,805.0
0.228,6,16,2670,8,1396,32.0,533.0,324.0,8,1274,20.0,529.0,212.0
0.009,6,10,1972,5,910,2.0,642.0,642.0,5,1062,2.0,794.0,794.0
0.005,6,14,3736,7,446,0.0,74.0,74.0,7,3290,0.0,1448.0,972.0
0.004,17,4,284,2,120,0.0,32.0,32.0,2,164,0.0,60.0,54.0
0.001,17,2,180,1,66,0.0,38.0,38.0,1,114,0.0,86.0,86.0
0.001,17,2,179,1,62,0.0,34.0,34.0,1,117,0.0,89.0,89.0
0.009,6,10,1989,5,910,2.0,642.0,642.0,5,1079,2.0,811.0,811.0
0.005,6,10,1779,5,928,1.0,660.0,660.0,5,851,1.0,583.0,583.0
0.005,6,10,1689,5,839,1.0,571.0,571.0,5,850,1.0,582.0,582.0
0.001,17,2,180,1,66,0.0,38.0,38.0,1,114,0.0,86.0,86.0
0.017,6,10,1972,5,910,4.0,642.0,642.0,5,1062,4.0,794.0,794.0
0.005,17,2,230,1,68,0.0,40.0,40.0,1,162,0.0,134.0,134.0
1356.157,6,217,40811,86,30729,15954.0,2720.0,401.0,131,10082,10430.0,1062.0,83.0
0.011,6,10,1972,5,910,2.0,642.0,642.0,5,1062,2.0,794.0,794.0
0.005,6,10,2007,5,928,1.0,660.0,660.0,5,1079,1.0,811.0,811.0
0.066,6,10,1506,5,395,16.0,127.0,127.0,5,1111,14.0,843.0,843.0
15.073,17,14,9190,8,6902,2149.0,1350.0,834.0,6,2288,3008.0,1350.0,353.0
0.005,6,10,1689,5,839,1.0,571.0,571.0,5,850,1.0,582.0,582.0
0.004,17,2,148,1,60,0.0,32.0,32.0,1,88,0.0,60.0,60.0
0.005,6,10,2006,5,927,1.0,659.0,659.0,5,1079,1.0,811.0,811.0
0.005,6,10,1989,5,927,1.0,659.0,659.0,5,1062,1.0,794.0,794.0
0.004,6,10,1702,5,863,1.0,595.0,595.0,5,839,0.0,571.0,571.0
0.128,6,10,1506,5,395,26.0,127.0,127.0,5,1111,30.0,843.0,843.0
0.005,17,2,169,1,62,0.0,34.0,34.0,1,107,0.0,79.0,79.0
0.006,17,2,169,1,62,0.0,34.0,34.0,1,107,0.0,79.0,79.0
291.671,6,312,344464,115,17527,2558.0,2736.0,888.0,197,326937,1488.0,2804.0,1730.0
0.018,6,14,3787,7,497,2.0,125.0,125.0,7,3290,3.0,1448.0,972.0
0.022,6,10,1990,5,911,5.0,643.0,643.0,5,1079,5.0,811.0,811.0
0.017,6,10,1677,5,827,4.0,559.0,559.0,5,850,4.0,582.0,582.0
0.005,6,10,1989,5,927,1.0,659.0,659.0,5,1062,1.0,794.0,794.0
0.077,6,10,1506,5,395,16.0,127.0,127.0,5,1111,17.0,843.0,843.0
0.227,6,16,2782,8,1400,32.0,533.0,325.0,8,1382,20.0,529.0,239.0
0.004,17,2,136,1,60,0.0,32.0,32.0,1,76,0.0,48.0,48.0
0.072,17,2,166,1,75,0.0,47.0,47.0,1,91,0.0,63.0,63.0
0.01,6,12,1926,6,1189,2.0,659.0,434.0,6,737,1.0,417.0,417.0
0.016,6,13,3735,7,497,2.0,125.0,125.0,6,3238,3.0,1470.0,1459.0
0.095,6,10,1506,5,395,22.0,127.0,127.0,5,1111,18.0,843.0,843.0
240.18,6,23,9209,12,4276,21834.0,1368.0,731.0,11,4933,24017.0,1656.0,1088.0
0.006,6,10,1547,5,764,1.0,496.0,496.0,5,783,1.0,515.0,515.0
0.133,6,10,1506,5,395,32.0,127.0,127.0,5,1111,31.0,843.0,843.0
40.066,17,10,676,5,460,10015.0,104.0,64.0,5,216,10015.0,20.0,15.0
240.087,6,16,4481,9,963,30010.0,238.0,166.0,7,3518,40014.0,1402.0,786.0
0.006,17,2,249,1,64,0.0,36.0,36.0,1,185,0.0,157.0,157.0
0.011,6,14,3787,7,497,1.0,125.0,125.0,7,3290,1.0,1448.0,972.0
356.636,6,21,1795,16,1030,23775.0,190.0,190.0,5,765,60002.0,464.0,248.0
0.003,17,2,186,1,61,0.0,33.0,33.0,1,125,0.0,97.0,97.0
0.005,17,2,170,1,65,0.0,37.0,37.0,1,105,0.0,77.0,77.0
0.005,17,2,136,1,60,0.0,32.0,32.0,1,76,0.0,48.0,48.0
0.079,6,10,1506,5,395,16.0,127.0,127.0,5,1111,17.0,843.0,843.0
0.019,6,10,1990,5,911,4.0,643.0,643.0,5,1079,4.0,811.0,811.0
0.006,6,10,1689,5,839,1.0,571.0,571.0,5,850,1.0,582.0,582.0
164.332,17,80,11565,40,2664,4213.0,44.0,38.0,40,8901,4213.0,261.0,194.0
0.095,6,10,1506,5,395,21.0,127.0,127.0,5,1111,22.0,843.0,843.0
0.016,6,10,1990,5,911,3.0,643.0,643.0,5,1079,3.0,811.0,811.0
0.007,6,10,2006,5,927,1.0,659.0,659.0,5,1079,1.0,811.0,811.0
0.005,6,10,1779,5,928,1.0,660.0,660.0,5,851,1.0,583.0,583.0
0.019,6,10,1989,5,910,4.0,642.0,642.0,5,1079,4.0,811.0,811.0
0.009,6,10,1989,5,910,2.0,642.0,642.0,5,1079,2.0,811.0,811.0
0.004,6,10,2006,5,927,1.0,659.0,659.0,5,1079,1.0,811.0,811.0
0.172,17,2,152,1,76,0.0,48.0,48.0,1,76,0.0,48.0,48.0
0.006,17,2,164,1,74,0.0,46.0,46.0,1,90,0.0,62.0,62.0
0.006,17,2,240,1,61,0.0,33.0,33.0,1,179,0.0,151.0,151.0
15.074,17,15,9239,8,6902,2149.0,1350.0,834.0,7,2337,2507.0,1350.0,305.0
0.038,17,2,152,1,76,0.0,48.0,48.0,1,76,0.0,48.0,48.0
0.074,6,10,1506,5,395,17.0,127.0,127.0,5,1111,16.0,843.0,843.0
1770.449,6,83,4368,42,2210,43180.0,26.0,26.0,41,2158,44260.0,26.0,26.0
11.036,17,28,4397,14,2312,840.0,587.0,137.0,14,2085,840.0,268.0,120.0
0.103,6,10,1506,5,395,23.0,127.0,127.0,5,1111,25.0,843.0,843.0
0.026,6,10,1983,5,910,6.0,642.0,642.0,5,1073,6.0,805.0,805.0
0.116,6,10,1506,5,395,26.0,127.0,127.0,5,1111,23.0,843.0,843.0
0.005,6,10,1702,5,863,1.0,595.0,595.0,5,839,1.0,571.0,571.0
0.011,6,10,1983,5,910,2.0,642.0,642.0,5,1073,2.0,805.0,805.0
0.118,6,10,1506,5,395,23.0,127.0,127.0,5,1111,27.0,843.0,843.0
0.006,17,2,170,1,65,0.0,37.0,37.0,1,105,0.0,77.0,77.0
0.008,6,10,1989,5,910,1.0,642.0,642.0,5,1079,2.0,811.0,811.0
0.006,6,10,1689,5,839,1.0,571.0,571.0,5,850,1.0,582.0,582.0
0.087,6,10,1506,5,395,20.0,127.0,127.0,5,1111,19.0,843.0,843.0
0.005,6,10,1989,5,927,1.0,659.0,659.0,5,1062,1.0,794.0,794.0
0.036,17,2,148,1,60,0.0,32.0,32.0,1,88,0.0,60.0,60.0
0.005,17,2,180,1,66,0.0,38.0,38.0,1,114,0.0,86.0,86.0
0.097,6,10,1506,5,395,21.0,127.0,127.0,5,1111,22.0,843.0,843.0
0.164,17,2,152,1,76,0.0,48.0,48.0,1,76,0.0,48.0,48.0
0.005,6,10,2006,5,927,1.0,659.0,659.0,5,1079,1.0,811.0,811.0
0.004,17,2,148,1,60,0.0,32.0,32.0,1,88,0.0,60.0,60.0
0.02,6,10,1972,5,910,5.0,642.0,642.0,5,1062,5.0,794.0,794.0
0.005,6,10,2006,5,927,1.0,659.0,659.0,5,1079,1.0,811.0,811.0
15.074,17,15,9238,8,6902,2149.0,1350.0,834.0,7,2336,2507.0,1350.0,305.0
0.016,6,13,3735,7,497,2.0,125.0,125.0,6,3238,3.0,1470.0,1459.0
0.001,17,2,136,1,60,0.0,32.0,32.0,1,76,0.0,48.0,48.0
0.009,17,2,148,1,60,0.0,32.0,32.0,1,88,0.0,60.0,60.0
0.005,6,10,2000,5,927,1.0,659.0,659.0,5,1073,1.0,805.0,805.0
0.005,6,13,3747,7,509,0.0,137.0,137.0,6,3238,0.0,1470.0,1459.0
40.118,17,10,676,5,460,10028.0,104.0,64.0,5,216,10028.0,20.0,15.0
0.006,6,10,1547,5,764,1.0,496.0,496.0,5,783,1.0,515.0,515.0
0.087,6,10,1506,5,395,18.0,127.0,127.0,5,1111,20.0,843.0,843.0
0.125,6,10,1506,5,395,28.0,127.0,127.0,5,1111,27.0,843.0,843.0
0.01,6,10,1972,5,910,2.0,642.0,642.0,5,1062,2.0,794.0,794.0
310.051,17,20,1124,10,716,34437.0,48.0,43.0,10,408,34437.0,20.0,12.0
0.077,6,10,1506,5,395,15.0,127.0,127.0,5,1111,15.0,843.0,843.0
0.005,6,10,2000,5,927,1.0,659.0,659.0,5,1073,1.0,805.0,805.0
0.005,6,10,2007,5,928,1.0,660.0,660.0,5,1079,1.0,811.0,811.0
0.002,17,2,136,1,60,0.0,32.0,32.0,1,76,0.0,48.0,48.0
15.26,17,42,21720,23,17151,692.0,1350.0,717.0,19,4569,846.0,1350.0,212.0
0.006,6,10,1547,5,764,1.0,496.0,496.0,5,783,1.0,515.0,515.0
0.076,6,10,1506,5,395,17.0,127.0,127.0,5,1111,13.0,843.0,843.0
0.02,6,10,1989,5,910,4.0,642.0,642.0,5,1079,5.0,811.0,811.0
0.093,6,10,1506,5,395,21.0,127.0,127.0,5,1111,22.0,843.0,843.0
0.006,6,10,1547,5,764,1.0,496.0,496.0,5,783,1.0,515.0,515.0
0.01,6,10,1983,5,910,2.0,642.0,642.0,5,1073,2.0,805.0,805.0
0.005,17,2,170,1,65,0.0,37.0,37.0,1,105,0.0,77.0,77.0
0.005,17,2,144,1,64,0.0,36.0,36.0,1,80,0.0,52.0,52.0
0.006,6,10,1547,5,764,1.0,496.0,496.0,5,783,1.0,515.0,515.0
0.009,6,12,1926,6,1189,1.0,659.0,434.0,6,737,1.0,417.0,417.0
0.005,6,10,2006,5,927,1.0,659.0,659.0,5,1079,1.0,811.0,811.0
1730.713,6,53,3251,33,1950,54084.0,35.0,35.0,20,1301,91064.0,31.0,31.0
0.213,6,16,2777,8,1395,30.0,533.0,323.0,8,1382,19.0,529.0,239.0
40.065,17,10,676,5,460,10014.0,104.0,64.0,5,216,10015.0,20.0,15.0
0.004,6,10,2006,5,927,1.0,659.0,659.0,5,1079,1.0,811.0,811.0
0.005,6,10,1854,5,889,1.0,621.0,621.0,5,965,1.0,697.0,697.0
0.084,6,10,1506,5,395,18.0,127.0,127.0,5,1111,18.0,843.0,843.0
0.036,6,10,1989,5,910,8.0,642.0,642.0,5,1079,9.0,811.0,811.0
0.012,6,10,1989,5,910,3.0,642.0,642.0,5,1079,3.0,811.0,811.0
0.005,6,10,1779,5,928,1.0,660.0,660.0,5,851,1.0,583.0,583.0
40.065,17,10,676,5,460,10015.0,104.0,64.0,5,216,10015.0,20.0,15.0
0.005,6,10,1989,5,927,1.0,659.0,659.0,5,1062,1.0,794.0,794.0
349.001,6,34,11642,17,3311,21812.0,676.0,403.0,17,8331,18060.0,1402.0,743.0
11.5,17,28,4399,14,2313,872.0,588.0,137.0,14,2086,872.0,269.0,121.0
0.005,17,2,180,1,58,0.0,30.0,30.0,1,122,0.0,94.0,94.0
0.09,6,10,1506,5,395,18.0,127.0,127.0,5,1111,22.0,843.0,843.0
0.009,6,10,1990,5,911,2.0,643.0,643.0,5,1079,2.0,811.0,811.0
0.091,6,10,1506,5,395,20.0,127.0,127.0,5,1111,18.0,843.0,843.0
0.007,17,4,284,2,120,0.0,32.0,32.0,2,164,0.0,60.0,54.0
0.053,17,2,152,1,76,0.0,48.0,48.0,1,76,0.0,48.0,48.0
0.009,6,10,1972,5,910,2.0,642.0,642.0,5,1062,2.0,794.0,794.0
0.001,17,2,180,1,66,0.0,38.0,38.0,1,114,0.0,86.0,86.0
0.004,6,10,2007,5,928,1.0,660.0,660.0,5,1079,1.0,811.0,811.0
0.234,6,10,1506,5,395,47.0,127.0,127.0,5,1111,54.0,843.0,843.0
0.006,17,2,179,1,71,0.0,43.0,43.0,1,108,0.0,80.0,80.0
0.091,6,10,1506,5,395,19.0,127.0,127.0,5,1111,20.0,843.0,843.0
0.006,6,10,1854,5,889,1.0,621.0,621.0,5,965,1.0,697.0,697.0
0.006,6,10,1854,5,889,1.0,621.0,621.0,5,965,1.0,697.0,697.0
0.008,6,10,1854,5,889,1.0,621.0,621.0,5,965,2.0,697.0,697.0
0.001,17,2,180,1,66,0.0,38.0,38.0,1,114,0.0,86.0,86.0
11.18,17,28,4419,14,1994,847.0,269.0,114.0,14,2425,847.0,588.0,145.0
0.006,6,10,1547,5,764,1.0,496.0,496.0,5,783,1.0,515.0,515.0
240.091,6,32,9392,16,6996,16006.0,2068.0,685.0,16,2396,16005.0,580.0,194.0
0.005,6,10,1689,5,839,1.0,571.0,571.0,5,850,1.0,582.0,582.0
0.78,6,22,5168,11,1138,65.0,267.0,115.0,11,4030,65.0,1414.0,597.0
0.005,6,10,1989,5,927,1.0,659.0,659.0,5,1062,1.0,794.0,794.0
0.004,6,10,2000,5,927,1.0,659.0,659.0,5,1073,1.0,805.0,805.0
0.003,17,2,148,1,60,0.0,32.0,32.0,1,88,0.0,60.0,60.0
0.004,6,10,2007,5,928,1.0,660.0,660.0,5,1079,1.0,811.0,811.0
0.09,6,10,1506,5,395,20.0,127.0,127.0,5,1111,17.0,843.0,843.0
0.146,6,10,1506,5,395,33.0,127.0,127.0,5,1111,32.0,843.0,843.0
0.005,6,10,1774,5,923,1.0,655.0,655.0,5,851,1.0,583.0,583.0
0.01,6,10,1989,5,910,2.0,642.0,642.0,5,1079,2.0,811.0,811.0
0.129,17,2,80,1,32,0.0,4.0,4.0,1,48,0.0,20.0,20.0
178.111,17,70,10091,35,2330,5238.0,44.0,38.0,35,7761,5238.0,261.0,193.0
0.006,6,12,1698,6,863,1.0,327.0,271.0,6,835,1.0,515.0,515.0
0.005,17,2,166,1,75,0.0,47.0,47.0,1,91,0.0,63.0,63.0
0.004,6,10,1989,5,927,1.0,659.0,659.0,5,1062,1.0,794.0,794.0
0.012,6,10,1990,5,911,3.0,643.0,643.0,5,1079,3.0,811.0,811.0
0.168,6,10,1506,5,395,40.0,127.0,127.0,5,1111,26.0,843.0,843.0
0.144,6,10,1506,5,395,34.0,127.0,127.0,5,1111,26.0,843.0,843.0
0.107,6,10,1506,5,395,22.0,127.0,127.0,5,1111,24.0,843.0,843.0
0.005,6,10,2007,5,928,1.0,660.0,660.0,5,1079,1.0,811.0,811.0
0.091,6,10,1506,5,395,19.0,127.0,127.0,5,1111,21.0,843.0,843.0
0.039,17,4,352,2,130,0.0,37.0,37.0,2,222,0.0,89.0,83.0
0.005,6,10,2006,5,927,1.0,659.0,659.0,5,1079,1.0,811.0,811.0
0.01,6,10,1989,5,910,2.0,642.0,642.0,5,1079,2.0,811.0,811.0
0.009,6,10,1983,5,910,2.0,642.0,642.0,5,1073,2.0,805.0,805.0
0.005,6,10,1989,5,927,1.0,659.0,659.0,5,1062,1.0,794.0,794.0
240.281,6,43,5575,22,2540,11441.0,588.0,196.0,21,3035,12013.0,580.0,241.0
0.089,6,10,1506,5,395,20.0,127.0,127.0,5,1111,20.0,843.0,843.0
15.069,17,15,9238,8,6902,2148.0,1350.0,834.0,7,2336,2506.0,1350.0,305.0
240.013,6,9,787,5,488,60003.0,232.0,232.0,4,299,80003.0,83.0,83.0
0.006,6,10,1689,5,839,1.0,571.0,571.0,5,850,1.0,582.0,582.0
168.412,17,78,11295,39,2600,4431.0,44.0,38.0,39,8695,4431.0,261.0,194.0
0.004,6,10,1989,5,927,1.0,659.0,659.0,5,1062,1.0,794.0,794.0
0.015,6,10,1989,5,910,3.0,642.0,642.0,5,1079,3.0,811.0,811.0
0.001,17,2,166,1,75,0.0,47.0,47.0,1,91,0.0,63.0,63.0
40.06,17,10,676,5,460,10013.0,104.0,64.0,5,216,10014.0,20.0,15.0
0.012,6,10,1989,5,910,3.0,642.0,642.0,5,1079,3.0,811.0,811.0
0.015,6,10,1972,5,910,3.0,642.0,642.0,5,1062,3.0,794.0,794.0
0.013,6,10,1972,5,910,3.0,642.0,642.0,5,1062,3.0,794.0,794.0
0.017,6,10,1983,5,910,4.0,642.0,642.0,5,1073,4.0,805.0,805.0
0.008,6,12,1926,6,1189,1.0,659.0,434.0,6,737,1.0,417.0,417.0
0.127,6,10,1506,5,395,29.0,127.0,127.0,5,1111,29.0,843.0,843.0
0.12,6,10,1506,5,395,29.0,127.0,127.0,5,1111,26.0,843.0,843.0
40.069,17,10,676,5,460,10016.0,104.0,64.0,5,216,10016.0,20.0,15.0
0.017,6,10,1989,5,910,4.0,642.0,642.0,5,1079,4.0,811.0,811.0
15.092,17,15,8531,8,6332,2149.0,1350.0,763.0,7,2199,2510.0,1350.0,286.0
40.066,17,10,676,5,460,10015.0,104.0,64.0,5,216,10015.0,20.0,15.0
0.141,6,10,1506,5,395,33.0,127.0,127.0,5,1111,33.0,843.0,843.0
0.004,6,10,2006,5,927,1.0,659.0,659.0,5,1079,1.0,811.0,811.0
0.126,17,2,148,1,60,0.0,32.0,32.0,1,88,0.0,60.0,60.0
0.084,6,10,1506,5,395,19.0,127.0,127.0,5,1111,16.0,843.0,843.0
0.005,6,10,1989,5,927,1.0,659.0,659.0,5,1062,1.0,794.0,794.0
15.354,17,44,20535,23,17140,696.0,1350.0,717.0,21,3395,766.0,1350.0,133.0
0.005,6,10,1774,5,923,1.0,655.0,655.0,5,851,1.0,583.0,583.0
0.005,6,10,2006,5,927,1.0,659.0,659.0,5,1079,1.0,811.0,811.0
0.005,6,10,1989,5,927,1.0,659.0,659.0,5,1062,1.0,794.0,794.0
0.006,6,10,1689,5,839,1.0,571.0,571.0,5,850,1.0,582.0,582.0
0.114,6,10,1506,5,395,23.0,127.0,127.0,5,1111,26.0,843.0,843.0
0.004,17,2,148,1,60,0.0,32.0,32.0,1,88,0.0,60.0,60.0
0.005,17,2,179,1,71,0.0,43.0,43.0,1,108,0.0,80.0,80.0
0.019,6,10,1972,5,910,4.0,642.0,642.0,5,1062,4.0,794.0,794.0
0.104,6,10,1506,5,395,22.0,127.0,127.0,5,1111,23.0,843.0,843.0
11.035,17,26,4074,13,2140,910.0,587.0,136.0,13,1934,910.0,269.0,120.0
1726.251,6,62,7176,41,4384,43156.0,1402.0,107.0,21,2792,86304.0,1111.0,85.0
0.013,6,10,1972,5,910,3.0,642.0,642.0,5,1062,3.0,794.0,794.0
11.169,17,28,4424,14,1995,846.0,270.0,114.0,14,2429,846.0,588.0,145.0
40.064,17,10,676,5,460,10015.0,104.0,64.0,5,216,10015.0,20.0,15.0
10.909,17,28,4423,14,1995,830.0,270.0,114.0,14,2428,826.0,587.0,145.0
0.001,17,2,180,1,66,0.0,38.0,38.0,1,114,0.0,86.0,86.0
0.013,6,10,1990,5,911,3.0,643.0,643.0,5,1079,3.0,811.0,811.0
0.006,6,10,1547,5,764,1.0,496.0,496.0,5,783,1.0,515.0,515.0
308.749,17,20,1124,10,716,34298.0,48.0,43.0,10,408,34298.0,20.0,12.0
0.095,6,10,1506,5,395,21.0,127.0,127.0,5,1111,20.0,843.0,843.0
0.077,6,10,1506,5,395,15.0,127.0,127.0,5,1111,17.0,843.0,843.0
0.004,17,2,148,1,60,0.0,32.0,32.0,1,88,0.0,60.0,60.0
0.011,6,10,1983,5,910,2.0,642.0,642.0,5,1073,2.0,805.0,805.0
0.082,6,10,1506,5,395,18.0,127.0,127.0,5,1111,19.0,843.0,843.0
11.128,17,28,4423,14,1994,843.0,269.0,114.0,14,2429,843.0,588.0,145.0
0.004,6,10,1989,5,927,1.0,659.0,659.0,5,1062,1.0,794.0,794.0
0.005,17,2,170,1,65,0.0,37.0,37.0,1,105,0.0,77.0,77.0
361.799,6,21,1793,16,1030,24119.0,190.0,190.0,5,763,60009.0,462.0,247.0
0.006,6,10,1689,5,839,1.0,571.0,571.0,5,850,1.0,582.0,582.0
0.245,6,20,6558,10,1505,27.0,533.0,325.0,10,5053,18.0,1402.0,754.0
0.015,6,10,1631,5,848,3.0,580.0,580.0,5,783,3.0,515.0,515.0
0.004,6,10,2006,5,927,1.0,659.0,659.0,5,1079,1.0,811.0,811.0
0.106,6,10,1506,5,395,24.0,127.0,127.0,5,1111,20.0,843.0,843.0
0.012,6,10,1631,5,848,2.0,580.0,580.0,5,783,3.0,515.0,515.0
0.042,6,10,1972,5,910,10.0,642.0,642.0,5,1062,10.0,794.0,794.0
0.016,6,10,1990,5,911,3.0,643.0,643.0,5,1079,3.0,811.0,811.0
0.014,6,10,1990,5,911,3.0,643.0,643.0,5,1079,3.0,811.0,811.0
0.04,17,2,144,1,64,0.0,36.0,36.0,1,80,0.0,52.0,52.0
240.011,6,9,787,5,488,60002.0,232.0,232.0,4,299,80003.0,83.0,83.0
0.004,6,10,1989,5,927,1.0,659.0,659.0,5,1062,1.0,794.0,794.0
0.013,6,10,2006,5,927,3.0,659.0,659.0,5,1079,3.0,811.0,811.0
0.006,6,10,1689,5,839,1.0,571.0,571.0,5,850,1.0,582.0,582.0
0.004,6,10,1774,5,923,1.0,655.0,655.0,5,851,1.0,583.0,583.0
40.066,17,10,676,5,460,10013.0,104.0,64.0,5,216,10015.0,20.0,15.0
0.004,17,2,136,1,60,0.0,32.0,32.0,1,76,0.0,48.0,48.0
0.014,6,10,1983,5,910,3.0,642.0,642.0,5,1073,3.0,805.0,805.0
0.013,6,10,1983,5,910,3.0,642.0,642.0,5,1073,3.0,805.0,805.0
0.072,6,10,1506,5,395,16.0,127.0,127.0,5,1111,14.0,843.0,843.0
0.087,6,10,1990,5,911,21.0,643.0,643.0,5,1079,21.0,811.0,811.0
0.077,6,10,1506,5,395,16.0,127.0,127.0,5,1111,18.0,843.0,843.0
0.074,6,10,1506,5,395,18.0,127.0,127.0,5,1111,17.0,843.0,843.0
0.009,6,10,1989,5,910,2.0,642.0,642.0,5,1079,2.0,811.0,811.0
0.014,6,10,1989,5,910,3.0,642.0,642.0,5,1079,3.0,811.0,811.0
0.006,6,10,1854,5,889,1.0,621.0,621.0,5,965,1.0,697.0,697.0
885.617,6,61,24379,30,6333,30538.0,676.0,529.0,31,18046,29520.0,1943.0,821.0
0.004,6,10,2007,5,928,1.0,660.0,660.0,5,1079,1.0,811.0,811.0
40.055,17,10,676,5,460,10012.0,104.0,64.0,5,216,10013.0,20.0,15.0
11.177,17,28,4423,14,1994,847.0,269.0,114.0,14,2429,847.0,588.0,145.0
0.015,17,2,198,1,91,0.0,63.0,63.0,1,107,0.0,79.0,79.0
0.156,6,10,1506,5,395,37.0,127.0,127.0,5,1111,34.0,843.0,843.0
40.061,17,10,676,5,460,10014.0,104.0,64.0,5,216,10014.0,20.0,15.0
0.009,6,10,1989,5,910,2.0,642.0,642.0,5,1079,2.0,811.0,811.0
0.016,6,10,1762,5,911,4.0,643.0,643.0,5,851,4.0,583.0,583.0
0.129,6,10,1506,5,395,29.0,127.0,127.0,5,1111,28.0,843.0,843.0
0.007,6,10,1643,5,860,1.0,592.0,592.0,5,783,1.0,515.0,515.0
0.003,17,2,136,1,60,0.0,32.0,32.0,1,76,0.0,48.0,48.0
0.127,6,10,1506,5,395,21.0,127.0,127.0,5,1111,27.0,843.0,843.0
0.004,17,2,136,1,60,0.0,32.0,32.0,1,76,0.0,48.0,48.0
0.01,6,10,1972,5,910,2.0,642.0,642.0,5,1062,2.0,794.0,794.0
0.005,17,2,170,1,65,0.0,37.0,37.0,1,105,0.0,77.0,77.0
0.005,6,10,1643,5,860,1.0,592.0,592.0,5,783,1.0,515.0,515.0
0.016,6,10,1990,5,911,3.0,643.0,643.0,5,1079,3.0,811.0,811.0
0.011,6,12,1698,6,863,2.0,327.0,271.0,6,835,2.0,515.0,515.0
0.069,6,10,1506,5,395,16.0,127.0,127.0,5,1111,15.0,843.0,843.0
0.021,6,10,1983,5,910,5.0,642.0,642.0,5,1073,5.0,805.0,805.0
0.005,6,13,3747,7,509,0.0,137.0,137.0,6,3238,1.0,1470.0,1459.0
0.014,6,10,1990,5,911,3.0,643.0,643.0,5,1079,3.0,811.0,811.0
0.014,17,2,136,1,60,0.0,32.0,32.0,1,76,0.0,48.0,48.0
0.006,6,10,1689,5,839,1.0,571.0,571.0,5,850,1.0,582.0,582.0
11.129,17,28,4392,14,2311,847.0,586.0,137.0,14,2081,847.0,268.0,120.0
0.005,6,10,2007,5,928,1.0,660.0,660.0,5,1079,1.0,811.0,811.0
0.011,6,10,1972,5,910,2.0,642.0,642.0,5,1062,2.0,794.0,794.0
0.017,6,10,1631,5,848,4.0,580.0,580.0,5,783,4.0,515.0,515.0
125.969,6,14,2938,8,2504,17962.0,1414.0,1086.0,6,434,25146.0,182.0,182.0
0.005,17,2,169,1,62,0.0,34.0,34.0,1,107,0.0,79.0,79.0
0.17,6,3,453,2,321,170.0,241.0,241.0,1,132,0.0,92.0,92.0
0.08,6,10,1506,5,395,18.0,127.0,127.0,5,1111,19.0,843.0,843.0
301.006,6,46,18837,25,13154,12541.0,4080.0,1513.0,21,5683,442.0,2667.0,402.0
0.011,6,10,1989,5,910,2.0,642.0,642.0,5,1079,2.0,811.0,811.0
0.006,6,10,1547,5,764,1.0,496.0,496.0,5,783,1.0,515.0,515.0
0.013,6,10,1989,5,910,3.0,642.0,642.0,5,1079,3.0,811.0,811.0
0.01,6,10,1972,5,910,2.0,642.0,642.0,5,1062,2.0,794.0,794.0
0.132,17,2,80,1,32,0.0,4.0,4.0,1,48,0.0,20.0,20.0
0.026,6,10,1989,5,910,6.0,642.0,642.0,5,1079,6.0,811.0,811.0
0.004,6,10,1779,5,928,1.0,660.0,660.0,5,851,1.0,583.0,583.0
0.004,6,10,2006,5,927,1.0,659.0,659.0,5,1079,1.0,811.0,811.0
0.012,6,10,1989,5,910,3.0,642.0,642.0,5,1079,3.0,811.0,811.0
15.078,17,15,8218,8,6067,2149.0,1350.0,730.0,7,2151,2508.0,1350.0,279.0
240.679,6,35,8894,18,2043,14155.0,664.0,219.0,17,6851,15040.0,1402.0,597.0
0.005,6,10,1989,5,927,1.0,659.0,659.0,5,1062,1.0,794.0,794.0
240.107,6,16,4481,9,963,30013.0,238.0,166.0,7,3518,40017.0,1402.0,786.0
0.018,6,10,1677,5,827,4.0,559.0,559.0,5,850,4.0,582.0,582.0
0.005,17,2,179,1,71,0.0,43.0,43.0,1,108,0.0,80.0,80.0
0.104,6,10,1506,5,395,25.0,127.0,127.0,5,1111,21.0,843.0,843.0
0.038,17,4,284,2,120,0.0,32.0,32.0,2,164,34.0,60.0,54.0
0.006,6,10,1547,5,764,1.0,496.0,496.0,5,783,1.0,515.0,515.0
40.061,17,10,676,5,460,10014.0,104.0,64.0,5,216,10014.0,20.0,15.0
0.004,6,10,2006,5,927,1.0,659.0,659.0,5,1079,1.0,811.0,811.0
0.004,6,10,2006,5,927,1.0,659.0,659.0,5,1079,1.0,811.0,811.0
0.001,17,2,180,1,66,0.0,38.0,38.0,1,114,0.0,86.0,86.0
40.073,17,10,676,5,460,10015.0,104.0,64.0,5,216,10017.0,20.0,15.0
0.006,17,2,170,1,65,0.0,37.0,37.0,1,105,0.0,77.0,77.0
0.014,6,10,1983,5,910,3.0,642.0,642.0,5,1073,3.0,805.0,805.0
1786.307,6,150,19350,90,13740,20070.0,302.0,302.0,60,5610,30276.0,83.0,83.0
1769.226,17,92,8096,46,4048,39316.0,60.0,60.0,46,4048,39316.0,60.0,60.0
5.526,6,38,25524,18,15988,325.0,2804.0,2149.0,20,9536,283.0,1288.0,1212.0
0.003,17,2,148,1,60,0.0,32.0,32.0,1,88,0.0,60.0,60.0
0.069,6,10,1506,5,395,15.0,127.0,127.0,5,1111,14.0,843.0,843.0
0.015,6,10,1989,5,910,3.0,642.0,642.0,5,1079,3.0,811.0,811.0
0.005,6,10,1689,5,839,1.0,571.0,571.0,5,850,1.0,582.0,582.0
0.398,17,44,20656,23,17150,18.0,1350.0,717.0,21,3506,16.0,1350.0,138.0
40.055,17,10,676,5,460,10011.0,104.0,64.0,5,216,10013.0,20.0,15.0
0.006,6,10,1547,5,764,1.0,496.0,496.0,5,783,1.0,515.0,515.0
0.073,6,10,1506,5,395,15.0,127.0,127.0,5,1111,16.0,843.0,843.0
319.994,17,18,1008,9,640,39989.0,48.0,43.0,9,368,39986.0,20.0,12.0
0.011,6,10,1677,5,827,2.0,559.0,559.0,5,850,2.0,582.0,582.0
0.008,6,10,1689,5,839,1.0,571.0,571.0,5,850,2.0,582.0,582.0
0.131,17,2,152,1,76,0.0,48.0,48.0,1,76,0.0,48.0,48.0
0.017,6,14,3787,7,497,2.0,125.0,125.0,7,3290,2.0,1448.0,972.0
0.012,6,10,1989,5,910,3.0,642.0,642.0,5,1079,3.0,811.0,811.0
0.019,6,10,1677,5,827,4.0,559.0,559.0,5,850,4.0,582.0,582.0
1771.616,17,120,11460,60,5460,30027.0,63.0,63.0,60,6000,30027.0,72.0,72.0
0.122,6,10,1506,5,395,20.0,127.0,127.0,5,1111,29.0,843.0,843.0
0.071,17,2,156,1,64,0.0,36.0,36.0,1,92,0.0,64.0,64.0
0.004,6,10,1989,5,927,1.0,659.0,659.0,5,1062,1.0,794.0,794.0
0.004,17,2,136,1,60,0.0,32.0,32.0,1,76,0.0,48.0,48.0
0.01,6,10,1972,5,910,2.0,642.0,642.0,5,1062,2.0,794.0,794.0
11.116,17,28,4417,14,1994,842.0,269.0,114.0,14,2423,842.0,586.0,145.0
178.143,17,84,11988,42,2816,4344.0,44.0,39.0,42,9172,4344.0,239.0,190.0
0.087,6,10,1506,5,395,18.0,127.0,127.0,5,1111,17.0,843.0,843.0
0.004,6,10,1989,5,927,1.0,659.0,659.0,5,1062,1.0,794.0,794.0
0.005,6,10,1547,5,764,1.0,496.0,496.0,5,783,1.0,515.0,515.0
0.006,17,2,164,1,74,0.0,46.0,46.0,1,90,0.0,62.0,62.0
0.097,6,10,1506,5,395,22.0,127.0,127.0,5,1111,22.0,843.0,843.0
0.011,6,10,1972,5,910,2.0,642.0,642.0,5,1062,2.0,794.0,794.0
0.004,17,4,284,2,120,0.0,32.0,32.0,2,164,0.0,60.0,54.0
1288.199,6,157,10696,60,4608,21833.0,46.0,46.0,97,6088,13417.0,46.0,46.0
0.014,6,10,1989,5,910,3.0,642.0,642.0,5,1079,3.0,811.0,811.0
0.006,6,10,1989,5,927,1.0,659.0,659.0,5,1062,1.0,794.0,794.0
0.012,6,10,1990,5,911,2.0,643.0,643.0,5,1079,3.0,811.0,811.0
1.175,6,31,12747,18,3352,69.0,1360.0,517.0,13,9395,82.0,2720.0,984.0
0.004,17,4,284,2,120,0.0,32.0,32.0,2,164,0.0,60.0,54.0
0.012,6,10,1989,5,910,3.0,642.0,642.0,5,1079,3.0,811.0,811.0
0.005,17,2,140,1,62,0.0,34.0,34.0,1,78,0.0,50.0,50.0
0.006,6,10,2007,5,928,1.0,660.0,660.0,5,1079,1.0,811.0,811.0
0.022,6,13,3735,7,497,3.0,125.0,125.0,6,3238,4.0,1470.0,1459.0
0.006,6,10,1689,5,839,1.0,571.0,571.0,5,850,1.0,582.0,582.0
0.125,6,10,1506,5,395,28.0,127.0,127.0,5,1111,27.0,843.0,843.0
0.005,6,10,1854,5,889,1.0,621.0,621.0,5,965,1.0,697.0,697.0
0.008,6,12,1926,6,1189,1.0,659.0,434.0,6,737,1.0,417.0,417.0
0.001,17,2,180,1,66,0.0,38.0,38.0,1,114,0.0,86.0,86.0
0.005,6,10,2007,5,928,1.0,660.0,660.0,5,1079,1.0,811.0,811.0
0.004,6,10,2006,5,927,1.0,659.0,659.0,5,1079,1.0,811.0,811.0
0.306,17,46,28090,27,24809,11.0,1350.0,890.0,19,3281,13.0,1350.0,144.0
40.063,17,10,676,5,460,10013.0,104.0,64.0,5,216,10015.0,20.0,15.0
0.015,6,10,1983,5,910,3.0,642.0,642.0,5,1073,3.0,805.0,805.0
0.005,6,10,1989,5,927,1.0,659.0,659.0,5,1062,1.0,794.0,794.0
0.126,6,10,1506,5,395,26.0,127.0,127.0,5,1111,25.0,843.0,843.0
308.382,17,20,1124,10,716,34257.0,48.0,43.0,10,408,34257.0,20.0,12.0
0.013,6,10,1990,5,911,3.0,643.0,643.0,5,1079,3.0,811.0,811.0
0.07,6,10,1506,5,395,14.0,127.0,127.0,5,1111,16.0,843.0,843.0
0.009,6,10,1972,5,910,2.0,642.0,642.0,5,1062,2.0,794.0,794.0
0.004,17,4,284,2,120,0.0,32.0,32.0,2,164,0.0,60.0,54.0
0.04,17,2,152,1,76,0.0,48.0,48.0,1,76,0.0,48.0,48.0
0.042,17,2,152,1,76,0.0,48.0,48.0,1,76,0.0,48.0,48.0
0.003,17,2,148,1,60,0.0,32.0,32.0,1,88,0.0,60.0,60.0
40.055,17,10,676,5,460,10012.0,104.0,64.0,5,216,10013.0,20.0,15.0
0.005,6,14,3742,7,452,0.0,80.0,80.0,7,3290,0.0,1448.0,972.0
0.085,6,10,1506,5,395,18.0,127.0,127.0,5,1111,17.0,843.0,843.0
9.042,17,6,376,5,280,2260.0,28.0,28.0,1,96,0.0,68.0,68.0
0.005,17,2,169,1,62,0.0,34.0,34.0,1,107,0.0,79.0,79.0
0.024,6,10,1983,5,910,6.0,642.0,642.0,5,1073,6.0,805.0,805.0
30.283,6,59,35206,31,3038,1009.0,517.0,280.0,28,32168,1121.0,2804.0,1334.0
0.005,17,2,169,1,62,0.0,34.0,34.0,1,107,0.0,79.0,79.0
0.003,17,4,420,2,122,0.0,33.0,33.0,2,298,0.0,145.0,121.0
0.02,6,10,1762,5,911,5.0,643.0,643.0,5,851,4.0,583.0,583.0
0.072,6,10,1506,5,395,16.0,127.0,127.0,5,1111,13.0,843.0,843.0
0.006,6,10,1643,5,860,1.0,592.0,592.0,5,783,1.0,515.0,515.0
0.012,6,10,1990,5,911,3.0,643.0,643.0,5,1079,3.0,811.0,811.0
0.005,6,10,1547,5,764,1.0,496.0,496.0,5,783,1.0,515.0,515.0
0.005,17,2,170,1,65,0.0,37.0,37.0,1,105,0.0,77.0,77.0
240.254,6,40,5337,21,2483,12012.0,581.0,195.0,19,2854,13347.0,566.0,265.0
0.005,6,10,1989,5,927,1.0,659.0,659.0,5,1062,1.0,794.0,794.0
0.082,6,10,1506,5,395,18.0,127.0,127.0,5,1111,17.0,843.0,843.0
11.014,17,28,4423,14,1994,838.0,269.0,114.0,14,2429,838.0,588.0,145.0
0.005,6,10,1643,5,860,1.0,592.0,592.0,5,783,1.0,515.0,515.0
0.001,17,2,180,1,66,0.0,38.0,38.0,1,114,0.0,86.0,86.0
11.187,17,28,4418,14,1994,847.0,269.0,114.0,14,2424,847.0,587.0,145.0
0.001,17,2,164,1,74,0.0,46.0,46.0,1,90,0.0,62.0,62.0
0.017,6,10,1989,5,910,4.0,642.0,642.0,5,1079,4.0,811.0,811.0
0.001,17,2,180,1,66,0.0,38.0,38.0,1,114,0.0,86.0,86.0
0.006,17,2,148,1,60,0.0,32.0,32.0,1,88,0.0,60.0,60.0
0.195,17,2,179,1,71,0.0,43.0,43.0,1,108,0.0,80.0,80.0
0.004,17,4,284,2,120,0.0,32.0,32.0,2,164,1.0,60.0,54.0
0.005,6,10,2006,5,927,1.0,659.0,659.0,5,1079,1.0,811.0,811.0
0.005,6,10,1643,5,860,1.0,592.0,592.0,5,783,1.0,515.0,515.0
0.014,6,10,1972,5,910,3.0,642.0,642.0,5,1062,3.0,794.0,794.0
0.02,6,10,1990,5,911,4.0,643.0,643.0,5,1079,5.0,811.0,811.0
0.005,17,2,148,1,60,0.0,32.0,32.0,1,88,0.0,60.0,60.0
0.086,6,10,1506,5,395,18.0,127.0,127.0,5,1111,20.0,843.0,843.0
0.112,6,10,1506,5,395,24.0,127.0,127.0,5,1111,21.0,843.0,843.0
0.042,6,14,3965,7,495,6.0,123.0,123.0,7,3470,7.0,1448.0,1032.0
0.093,6,10,1506,5,395,20.0,127.0,127.0,5,1111,23.0,843.0,843.0
0.005,17,2,144,1,64,0.0,36.0,36.0,1,80,0.0,52.0,52.0
0.005,17,4,495,2,132,0.0,38.0,38.0,2,363,2.0,176.0,153.0
0.005,6,10,2000,5,927,1.0,659.0,659.0,5,1073,1.0,805.0,805.0
0.004,6,10,2007,5,928,1.0,660.0,660.0,5,1079,1.0,811.0,811.0
0.031,6,13,3735,7,497,5.0,125.0,125.0,6,3238,6.0,1470.0,1459.0
0.008,6,10,2006,5,927,1.0,659.0,659.0,5,1079,2.0,811.0,811.0
0.016,6,10,1989,5,910,4.0,642.0,642.0,5,1079,3.0,811.0,811.0
0.011,6,10,1989,5,910,2.0,642.0,642.0,5,1079,2.0,811.0,811.0
0.078,6,10,1506,5,395,17.0,127.0,127.0,5,1111,15.0,843.0,843.0
0.119,6,10,1506,5,395,25.0,127.0,127.0,5,1111,28.0,843.0,843.0
0.004,17,4,284,2,120,0.0,32.0,32.0,2,164,1.0,60.0,54.0
0.008,6,10,1989,5,910,2.0,642.0,642.0,5,1079,2.0,811.0,811.0
0.094,6,10,1506,5,395,19.0,127.0,127.0,5,1111,21.0,843.0,843.0
0.005,6,10,1779,5,928,1.0,660.0,660.0,5,851,1.0,583.0,583.0
0.075,6,10,1506,5,395,15.0,127.0,127.0,5,1111,16.0,843.0,843.0
0.007,6,10,1972,5,910,1.0,642.0,642.0,5,1062,1.0,794.0,794.0
0.005,6,10,1989,5,927,1.0,659.0,659.0,5,1062,1.0,794.0,794.0
0.084,6,10,1506,5,395,20.0,127.0,127.0,5,1111,16.0,843.0,843.0
0.057,6,10,1506,5,395,13.0,127.0,127.0,5,1111,13.0,843.0,843.0
0.011,6,10,1762,5,911,2.0,643.0,643.0,5,851,2.0,583.0,583.0
0.006,6,10,1547,5,764,1.0,496.0,496.0,5,783,1.0,515.0,515.0
11.171,17,28,4422,14,1994,847.0,269.0,114.0,14,2428,847.0,587.0,145.0
0.009,17,2,179,1,71,0.0,43.0,43.0,1,108,0.0,80.0,80.0
0.003,17,2,148,1,60,0.0,32.0,32.0,1,88,0.0,60.0,60.0
0.091,6,10,1506,5,395,21.0,127.0,127.0,5,1111,19.0,843.0,843.0
0.091,6,10,1506,5,395,18.0,127.0,127.0,5,1111,21.0,843.0,843.0
0.001,17,2,180,1,65,0.0,37.0,37.0,1,115,0.0,87.0,87.0
11.032,17,28,4396,14,2311,840.0,586.0,137.0,14,2085,840.0,268.0,120.0
253.033,6,38,9729,15,6541,18073.0,1666.0,640.0,23,3188,11501.0,580.0,141.0
0.006,6,10,1702,5,863,1.0,595.0,595.0,5,839,1.0,571.0,571.0
0.005,6,10,2006,5,927,1.0,659.0,659.0,5,1079,1.0,811.0,811.0
0.081,6,10,1506,5,395,16.0,127.0,127.0,5,1111,17.0,843.0,843.0
0.102,6,10,1506,5,395,20.0,127.0,127.0,5,1111,23.0,843.0,843.0
377.364,6,22,2313,16,867,25157.0,195.0,195.0,6,1446,4657.0,419.0,398.0
0.007,6,10,1547,5,764,1.0,496.0,496.0,5,783,1.0,515.0,515.0
0.012,6,10,1990,5,911,3.0,643.0,643.0,5,1079,2.0,811.0,811.0
0.014,6,10,1990,5,911,3.0,643.0,643.0,5,1079,3.0,811.0,811.0
0.006,6,10,1702,5,863,1.0,595.0,595.0,5,839,1.0,571.0,571.0
0.006,6,10,2007,5,928,1.0,660.0,660.0,5,1079,1.0,811.0,811.0
0.018,6,10,1989,5,910,4.0,642.0,642.0,5,1079,4.0,811.0,811.0
0.005,6,10,1854,5,889,1.0,621.0,621.0,5,965,1.0,697.0,697.0
0.005,17,2,169,1,62,0.0,34.0,34.0,1,107,0.0,79.0,79.0
0.301,6,16,2778,8,1396,43.0,533.0,324.0,8,1382,31.0,529.0,239.0
0.006,6,10,1547,5,764,1.0,496.0,496.0,5,783,1.0,515.0,515.0
0.005,6,10,1689,5,839,1.0,571.0,571.0,5,850,1.0,582.0,582.0
40.053,17,10,676,5,460,10010.0,104.0,64.0,5,216,10012.0,20.0,15.0
0.001,17,2,180,1,66,0.0,38.0,38.0,1,114,0.0,86.0,86.0
368.481,6,22,2264,16,818,24565.0,146.0,146.0,6,1446,4641.0,419.0,398.0
0.002,17,2,174,1,72,0.0,44.0,44.0,1,102,0.0,74.0,74.0
0.705,6,25,5459,12,1557,54.0,325.0,152.0,13,3902,49.0,1414.0,563.0
0.009,6,10,1972,5,910,2.0,642.0,642.0,5,1062,2.0,794.0,794.0
0.095,6,10,1506,5,395,21.0,127.0,127.0,5,1111,22.0,843.0,843.0
0.005,6,10,2006,5,927,1.0,659.0,659.0,5,1079,1.0,811.0,811.0
0.028,6,10,1989,5,910,6.0,642.0,642.0,5,1079,6.0,811.0,811.0
0.01,6,10,1972,5,910,2.0,642.0,642.0,5,1062,2.0,794.0,794.0
1770.309,6,83,4368,42,2210,43177.0,26.0,26.0,41,2158,44256.0,26.0,26.0
0.003,17,2,136,1,60,0.0,32.0,32.0,1,76,0.0,48.0,48.0
0.007,6,10,2006,5,927,1.0,659.0,659.0,5,1079,1.0,811.0,811.0
11.172,17,28,4423,14,1994,847.0,269.0,114.0,14,2429,847.0,588.0,145.0
0.006,6,10,1989,5,927,1.0,659.0,659.0,5,1062,1.0,794.0,794.0
0.001,17,2,178,1,81,0.0,53.0,53.0,1,97,0.0,69.0,69.0
0.005,6,10,2006,5,927,1.0,659.0,659.0,5,1079,1.0,811.0,811.0
0.004,6,10,1702,5,863,1.0,595.0,595.0,5,839,0.0,571.0,571.0
0.006,6,10,1547,5,764,1.0,496.0,496.0,5,783,1.0,515.0,515.0
0.004,6,10,2000,5,927,1.0,659.0,659.0,5,1073,1.0,805.0,805.0
0.013,6,10,1990,5,911,3.0,643.0,643.0,5,1079,3.0,811.0,811.0
0.068,6,10,1506,5,395,15.0,127.0,127.0,5,1111,14.0,843.0,843.0
11.17,17,28,4418,14,1994,847.0,269.0,114.0,14,2424,847.0,587.0,145.0
0.009,6,10,1990,5,911,2.0,643.0,643.0,5,1079,2.0,811.0,811.0
0.015,6,10,1983,5,910,3.0,642.0,642.0,5,1073,3.0,805.0,805.0
0.08,6,10,1506,5,395,15.0,127.0,127.0,5,1111,19.0,843.0,843.0
0.073,6,10,1506,5,395,16.0,127.0,127.0,5,1111,14.0,843.0,843.0
0.042,17,2,152,1,76,0.0,48.0,48.0,1,76,0.0,48.0,48.0
374.689,6,22,2313,16,867,24979.0,195.0,195.0,6,1446,4640.0,419.0,398.0
0.008,6,10,1989,5,910,1.0,642.0,642.0,5,1079,1.0,811.0,811.0
0.003,17,2,136,1,60,0.0,32.0,32.0,1,76,0.0,48.0,48.0
0.005,6,10,2006,5,927,1.0,659.0,659.0,5,1079,1.0,811.0,811.0
0.101,6,10,1506,5,395,21.0,127.0,127.0,5,1111,21.0,843.0,843.0
0.005,6,10,1989,5,927,1.0,659.0,659.0,5,1062,1.0,794.0,794.0
0.737,6,23,5112,12,1290,57.0,325.0,133.0,11,3822,62.0,1414.0,563.0
0.005,6,14,3742,7,452,0.0,80.0,80.0,7,3290,0.0,1448.0,972.0
0.005,6,10,2007,5,928,1.0,660.0,660.0,5,1079,1.0,811.0,811.0
0.005,6,10,1854,5,889,1.0,621.0,621.0,5,965,1.0,697.0,697.0
0.001,17,2,180,1,66,0.0,38.0,38.0,1,114,0.0,86.0,86.0
0.011,6,10,1989,5,910,2.0,642.0,642.0,5,1079,2.0,811.0,811.0
0.004,6,10,2006,5,927,1.0,659.0,659.0,5,1079,1.0,811.0,811.0
125.995,6,14,2938,8,2504,17965.0,1414.0,1086.0,6,434,25151.0,182.0,182.0
0.007,6,10,1547,5,764,1.0,496.0,496.0,5,783,1.0,515.0,515.0
0.013,6,10,1983,5,910,3.0,642.0,642.0,5,1073,3.0,805.0,805.0
0.005,6,10,1689,5,839,1.0,571.0,571.0,5,850,1.0,582.0,582.0
0.005,6,10,2007,5,928,1.0,660.0,660.0,5,1079,1.0,811.0,811.0
0.005,6,10,2007,5,928,1.0,660.0,660.0,5,1079,1.0,811.0,811.0
0.005,6,10,1989,5,927,1.0,659.0,659.0,5,1062,1.0,794.0,794.0
0.004,6,10,2007,5,928,1.0,660.0,660.0,5,1079,1.0,811.0,811.0
0.004,6,10,1702,5,863,1.0,595.0,595.0,5,839,0.0,571.0,571.0
0.008,6,10,1990,5,911,2.0,643.0,643.0,5,1079,2.0,811.0,811.0
0.006,6,10,1989,5,927,1.0,659.0,659.0,5,1062,1.0,794.0,794.0
0.014,6,10,1989,5,910,3.0,642.0,642.0,5,1079,3.0,811.0,811.0
0.005,6,10,1989,5,927,1.0,659.0,659.0,5,1062,1.0,794.0,794.0
300.02,6,12,1782,7,1348,50003.0,494.0,494.0,5,434,75004.0,83.0,83.0
0.072,17,2,136,1,60,0.0,32.0,32.0,1,76,0.0,48.0,48.0
0.01,6,10,1631,5,848,2.0,580.0,580.0,5,783,2.0,515.0,515.0
0.076,6,10,1506,5,395,18.0,127.0,127.0,5,1111,16.0,843.0,843.0
0.22,6,16,2669,8,1395,31.0,533.0,323.0,8,1274,20.0,529.0,212.0
0.09,6,10,1506,5,395,21.0,127.0,127.0,5,1111,18.0,843.0,843.0
0.018,6,10,1631,5,848,4.0,580.0,580.0,5,783,4.0,515.0,515.0
0.005,6,10,1774,5,923,1.0,655.0,655.0,5,851,1.0,583.0,583.0
0.004,17,4,284,2,120,0.0,32.0,32.0,2,164,0.0,60.0,54.0
0.009,6,10,1990,5,911,2.0,643.0,643.0,5,1079,2.0,811.0,811.0
0.014,6,10,1990,5,911,3.0,643.0,643.0,5,1079,3.0,811.0,811.0
0.006,17,2,158,1,71,0.0,43.0,43.0,1,87,0.0,59.0,59.0
0.006,6,10,1547,5,764,1.0,496.0,496.0,5,783,1.0,515.0,515.0
1.04,6,13,3922,7,2139,130.0,1328.0,923.0,6,1783,156.0,1539.0,1539.0
0.023,6,10,1972,5,910,5.0,642.0,642.0,5,1062,5.0,794.0,794.0
0.005,6,10,2000,5,927,1.0,659.0,659.0,5,1073,1.0,805.0,805.0
0.005,6,10,2007,5,928,1.0,660.0,660.0,5,1079,1.0,811.0,811.0
0.015,6,10,1972,5,910,3.0,642.0,642.0,5,1062,3.0,794.0,794.0
0.005,6,10,2000,5,927,1.0,659.0,659.0,5,1073,1.0,805.0,805.0
0.04,17,2,166,1,75,0.0,47.0,47.0,1,91,0.0,63.0,63.0
0.098,6,10,1506,5,395,22.0,127.0,127.0,5,1111,21.0,843.0,843.0
0.004,6,10,1989,5,927,1.0,659.0,659.0,5,1062,1.0,794.0,794.0
0.008,6,12,1926,6,1189,1.0,659.0,434.0,6,737,1.0,417.0,417.0
0.019,6,13,3735,7,497,3.0,125.0,125.0,6,3238,3.0,1470.0,1459.0
0.005,6,10,1689,5,839,1.0,571.0,571.0,5,850,1.0,582.0,582.0
0.013,6,10,1762,5,911,3.0,643.0,643.0,5,851,3.0,583.0,583.0
0.005,6,14,3799,7,509,0.0,137.0,137.0,7,3290,0.0,1448.0,972.0
0.026,6,10,1990,5,911,6.0,643.0,643.0,5,1079,6.0,811.0,811.0
0.019,6,13,3735,7,497,3.0,125.0,125.0,6,3238,3.0,1470.0,1459.0
1792.636,6,493,100374,247,88944,7286.0,421.0,366.0,246,11430,7316.0,53.0,53.0
0.001,17,2,164,1,74,0.0,46.0,46.0,1,90,0.0,62.0,62.0
0.01,6,10,1677,5,827,2.0,559.0,559.0,5,850,2.0,582.0,582.0
0.009,6,10,1702,5,863,2.0,595.0,595.0,5,839,2.0,571.0,571.0
0.124,6,15,3839,8,549,17.0,125.0,125.0,7,3290,20.0,1448.0,972.0
0.005,6,10,2007,5,928,1.0,660.0,660.0,5,1079,1.0,811.0,811.0
0.012,6,10,1762,5,911,3.0,643.0,643.0,5,851,2.0,583.0,583.0
0.114,6,10,1506,5,395,26.0,127.0,127.0,5,1111,25.0,843.0,843.0
174.297,17,80,11270,40,2664,4469.0,44.0,38.0,40,8606,4469.0,239.0,187.0
0.044,6,10,1972,5,910,11.0,642.0,642.0,5,1062,11.0,794.0,794.0
1778.809,17,144,45504,72,22752,25053.0,288.0,288.0,72,22752,25053.0,288.0,288.0
0.019,6,10,1989,5,910,4.0,642.0,642.0,5,1079,4.0,811.0,811.0
40.06,17,10,676,5,460,10013.0,104.0,64.0,5,216,10013.0,20.0,15.0
0.005,17,2,222,1,65,0.0,37.0,37.0,1,157,0.0,129.0,129.0
40.075,17,10,676,5,460,10016.0,104.0,64.0,5,216,10017.0,20.0,15.0
0.137,6,19,6452,10,1574,14.0,757.0,261.0,9,4878,16.0,1592.0,1100.0
0.005,6,10,2000,5,927,1.0,659.0,659.0,5,1073,1.0,805.0,805.0
0.052,6,10,1631,5,848,13.0,580.0,580.0,5,783,12.0,515.0,515.0
0.039,17,4,596,2,122,0.0,33.0,33.0,2,474,36.0,323.0,209.0
0.005,17,2,164,1,74,0.0,46.0,46.0,1,90,0.0,62.0,62.0
0.005,6,10,1989,5,927,1.0,659.0,659.0,5,1062,1.0,794.0,794.0
0.042,17,2,152,1,76,0.0,48.0,48.0,1,76,0.0,48.0,48.0
0.005,6,10,1989,5,927,1.0,659.0,659.0,5,1062,1.0,794.0,794.0
0.429,17,2,144,1,64,0.0,36.0,36.0,1,80,0.0,52.0,52.0
40.063,17,10,676,5,460,10015.0,104.0,64.0,5,216,10015.0,20.0,15.0
0.001,17,2,180,1,66,0.0,38.0,38.0,1,114,0.0,86.0,86.0
10.799,17,28,4417,14,1994,822.0,269.0,114.0,14,2423,822.0,586.0,145.0
0.008,17,2,214,1,75,0.0,47.0,47.0,1,139,0.0,111.0,111.0
240.013,6,9,787,5,488,60003.0,232.0,232.0,4,299,80003.0,83.0,83.0
0.006,6,10,1547,5,764,1.0,496.0,496.0,5,783,1.0,515.0,515.0
0.001,17,2,174,1,72,0.0,44.0,44.0,1,102,0.0,74.0,74.0
0.01,6,10,1990,5,911,2.0,643.0,643.0,5,1079,2.0,811.0,811.0
0.004,17,2,136,1,60,0.0,32.0,32.0,1,76,0.0,48.0,48.0
0.066,6,10,1506,5,395,15.0,127.0,127.0,5,1111,14.0,843.0,843.0
0.012,6,10,1990,5,911,3.0,643.0,643.0,5,1079,2.0,811.0,811.0
0.004,6,10,2006,5,927,1.0,659.0,659.0,5,1079,1.0,811.0,811.0
0.019,6,10,1990,5,911,4.0,643.0,643.0,5,1079,4.0,811.0,811.0
0.014,6,10,1762,5,911,3.0,643.0,643.0,5,851,3.0,583.0,583.0
0.004,17,2,208,1,72,0.0,44.0,44.0,1,136,0.0,108.0,108.0
0.004,6,10,1989,5,927,1.0,659.0,659.0,5,1062,1.0,794.0,794.0
0.008,6,10,1972,5,910,2.0,642.0,642.0,5,1062,1.0,794.0,794.0
240.01,6,9,787,5,488,60002.0,232.0,232.0,4,299,80002.0,83.0,83.0
0.005,6,10,2000,5,927,1.0,659.0,659.0,5,1073,1.0,805.0,805.0
0.017,17,2,194,1,59,0.0,31.0,31.0,1,135,0.0,107.0,107.0
0.006,6,10,2007,5,928,1.0,660.0,660.0,5,1079,1.0,811.0,811.0
0.105,6,10,1506,5,395,22.0,127.0,127.0,5,1111,19.0,843.0,843.0
0.001,17,2,180,1,66,0.0,38.0,38.0,1,114,0.0,86.0,86.0
0.003,17,2,148,1,60,0.0,32.0,32.0,1,88,0.0,60.0,60.0
0.005,6,10,2000,5,927,1.0,659.0,659.0,5,1073,1.0,805.0,805.0
0.005,6,10,2006,5,927,1.0,659.0,659.0,5,1079,1.0,811.0,811.0
0.007,17,2,180,1,66,0.0,38.0,38.0,1,114,0.0,86.0,86.0
151.971,6,21,2707,12,1408,13815.0,563.0,129.0,9,1299,18996.0,580.0,274.0
0.006,6,10,1547,5,764,1.0,496.0,496.0,5,783,1.0,515.0,515.0
0.019,6,10,1990,5,911,4.0,643.0,643.0,5,1079,4.0,811.0,811.0
0.005,6,10,1689,5,839,1.0,571.0,571.0,5,850,1.0,582.0,582.0
0.013,6,10,1990,5,911,3.0,643.0,643.0,5,1079,3.0,811.0,811.0
0.001,17,2,166,1,75,0.0,47.0,47.0,1,91,0.0,63.0,63.0
0.004,6,10,2007,5,928,1.0,660.0,660.0,5,1079,1.0,811.0,811.0
0.003,17,2,148,1,60,0.0,32.0,32.0,1,88,0.0,60.0,60.0
0.006,6,10,1547,5,764,1.0,496.0,496.0,5,783,1.0,515.0,515.0
0.018,6,10,1983,5,910,4.0,642.0,642.0,5,1073,4.0,805.0,805.0
0.081,6,10,1506,5,395,17.0,127.0,127.0,5,1111,17.0,843.0,843.0
1771.891,17,120,11460,60,5460,30031.0,63.0,63.0,60,6000,30031.0,72.0,72.0
0.006,6,10,1547,5,764,1.0,496.0,496.0,5,783,1.0,515.0,515.0
0.005,17,2,140,1,62,0.0,34.0,34.0,1,78,0.0,50.0,50.0
0.071,6,10,1506,5,395,16.0,127.0,127.0,5,1111,14.0,843.0,843.0
0.008,6,10,1989,5,910,2.0,642.0,642.0,5,1079,2.0,811.0,811.0
0.02,6,10,1762,5,911,4.0,643.0,643.0,5,851,5.0,583.0,583.0
0.01,17,2,214,1,75,0.0,47.0,47.0,1,139,0.0,111.0,111.0
0.006,17,2,166,1,75,0.0,47.0,47.0,1,91,0.0,63.0,63.0
0.079,6,10,1506,5,395,17.0,127.0,127.0,5,1111,17.0,843.0,843.0
0.005,6,10,2007,5,928,1.0,660.0,660.0,5,1079,1.0,811.0,811.0
0.009,6,10,1989,5,910,2.0,642.0,642.0,5,1079,2.0,811.0,811.0
0.014,6,10,1983,5,910,3.0,642.0,642.0,5,1073,3.0,805.0,805.0
0.109,6,10,1506,5,395,24.0,127.0,127.0,5,1111,25.0,843.0,843.0
1770.305,6,84,4420,42,2210,43177.0,26.0,26.0,42,2210,43177.0,26.0,26.0
0.004,6,10,2006,5,927,1.0,659.0,659.0,5,1079,1.0,811.0,811.0
0.013,6,10,1972,5,910,3.0,642.0,642.0,5,1062,3.0,794.0,794.0
352.242,6,20,2210,6,1308,12003.0,494.0,494.0,14,902,27095.0,83.0,83.0
0.017,6,10,1990,5,911,4.0,643.0,643.0,5,1079,4.0,811.0,811.0
522.977,6,28,7976,15,3116,37355.0,676.0,388.0,13,4860,38579.0,1402.0,696.0
0.12,6,10,1506,5,395,26.0,127.0,127.0,5,1111,26.0,843.0,843.0
0.01,6,10,1989,5,910,2.0,642.0,642.0,5,1079,2.0,811.0,811.0
0.088,6,10,1506,5,395,19.0,127.0,127.0,5,1111,18.0,843.0,843.0
0.004,6,10,2000,5,927,1.0,659.0,659.0,5,1073,1.0,805.0,805.0
0.004,6,10,2006,5,927,1.0,659.0,659.0,5,1079,1.0,811.0,811.0
0.011,6,10,1990,5,911,2.0,643.0,643.0,5,1079,2.0,811.0,811.0
0.09,6,10,1506,5,395,21.0,127.0,127.0,5,1111,16.0,843.0,843.0
40.079,17,10,676,5,460,10016.0,104.0,64.0,5,216,10019.0,20.0,15.0
0.084,6,10,1506,5,395,18.0,127.0,127.0,5,1111,18.0,843.0,843.0
0.004,6,10,2006,5,927,1.0,659.0,659.0,5,1079,1.0,811.0,811.0
0.08,6,10,1506,5,395,18.0,127.0,127.0,5,1111,17.0,843.0,843.0
0.067,6,10,1506,5,395,14.0,127.0,127.0,5,1111,14.0,843.0,843.0
0.001,17,2,180,1,66,0.0,38.0,38.0,1,114,0.0,86.0,86.0
120.845,6,55,18950,31,4713,4028.0,1054.0,221.0,24,14237,5253.0,2804.0,998.0
0.025,17,2,148,1,60,0.0,32.0,32.0,1,88,0.0,60.0,60.0
240.48,6,294,338562,113,9684,2147.0,1581.0,537.0,181,328878,1335.0,2804.0,1901.0
0.003,17,2,148,1,60,0.0,32.0,32.0,1,88,0.0,60.0,60.0
0.005,6,10,1774,5,923,1.0,655.0,655.0,5,851,1.0,583.0,583.0
266.01,6,38,10098,15,6840,19000.0,1962.0,673.0,23,3258,12091.0,580.0,146.0
0.109,6,10,1506,5,395,24.0,127.0,127.0,5,1111,25.0,843.0,843.0
0.117,6,10,1506,5,395,26.0,127.0,127.0,5,1111,25.0,843.0,843.0
0.112,6,10,1506,5,395,23.0,127.0,127.0,5,1111,25.0,843.0,843.0
0.01,6,10,1972,5,910,2.0,642.0,642.0,5,1062,2.0,794.0,794.0
523.806,6,27,6242,15,3207,37414.0,676.0,403.0,12,3035,42163.0,824.0,480.0
0.086,6,10,1506,5,395,20.0,127.0,127.0,5,1111,16.0,843.0,843.0
0.006,6,13,3747,7,509,1.0,137.0,137.0,6,3238,1.0,1470.0,1459.0
40.054,17,10,676,5,460,10012.0,104.0,64.0,5,216,10012.0,20.0,15.0
0.005,6,10,1547,5,764,1.0,496.0,496.0,5,783,1.0,515.0,515.0
0.004,6,10,2006,5,927,1.0,659.0,659.0,5,1079,1.0,811.0,811.0
0.012,6,10,1983,5,910,2.0,642.0,642.0,5,1073,3.0,805.0,805.0
0.087,6,10,1506,5,395,19.0,127.0,127.0,5,1111,21.0,843.0,843.0
0.013,6,10,1989,5,910,3.0,642.0,642.0,5,1079,3.0,811.0,811.0
167.304,17,82,11695,41,2740,4182.0,44.0,38.0,41,8955,4182.0,239.0,190.0
0.011,6,6,716,3,458,4.0,302.0,302.0,3,258,4.0,102.0,102.0
0.003,17,4,284,2,120,0.0,32.0,32.0,2,164,0.0,60.0,54.0
0.26,17,39,20080,21,17046,13.0,1350.0,783.0,18,3034,11.0,1350.0,140.0
0.012,6,10,1990,5,911,2.0,643.0,643.0,5,1079,3.0,811.0,811.0
40.068,17,10,676,5,460,10015.0,104.0,64.0,5,216,10016.0,20.0,15.0
0.005,6,10,2006,5,927,1.0,659.0,659.0,5,1079,1.0,811.0,811.0
0.001,17,2,180,1,66,0.0,38.0,38.0,1,114,0.0,86.0,86.0
171.057,17,84,11916,42,2799,4171.0,44.0,38.0,42,9117,4172.0,261.0,189.0
0.07,6,10,1506,5,395,15.0,127.0,127.0,5,1111,14.0,843.0,843.0
0.001,17,2,142,1,63,0.0,35.0,35.0,1,79,0.0,51.0,51.0
0.013,6,13,3735,7,497,2.0,125.0,125.0,6,3238,2.0,1470.0,1459.0
0.005,6,10,2006,5,927,1.0,659.0,659.0,5,1079,1.0,811.0,811.0
0.129,17,2,80,1,32,0.0,4.0,4.0,1,48,0.0,20.0,20.0
0.004,17,2,136,1,60,0.0,32.0,32.0,1,76,0.0,48.0,48.0
15.029,17,19,9417,10,4161,1666.0,1350.0,388.0,9,5256,1875.0,1350.0,556.0
0.186,6,12,2996,7,549,31.0,177.0,177.0,5,2447,43.0,1402.0,1089.0
0.007,6,10,1689,5,839,1.0,571.0,571.0,5,850,1.0,582.0,582.0
0.013,6,10,1677,5,827,3.0,559.0,559.0,5,850,3.0,582.0,582.0
0.016,6,10,1989,5,910,3.0,642.0,642.0,5,1079,3.0,811.0,811.0
40.063,17,10,676,5,460,10013.0,104.0,64.0,5,216,10015.0,20.0,15.0
0.009,6,12,1926,6,1189,1.0,659.0,434.0,6,737,1.0,417.0,417.0
0.001,17,2,180,1,66,0.0,38.0,38.0,1,114,0.0,86.0,86.0
0.001,17,2,136,1,60,0.0,32.0,32.0,1,76,0.0,48.0,48.0
0.004,6,13,3690,7,452,0.0,80.0,80.0,6,3238,0.0,1470.0,1459.0
0.006,6,10,1689,5,839,1.0,571.0,571.0,5,850,1.0,582.0,582.0
0.005,6,10,1989,5,927,1.0,659.0,659.0,5,1062,1.0,794.0,794.0
0.004,17,2,148,1,60,0.0,32.0,32.0,1,88,0.0,60.0,60.0
0.004,6,10,2006,5,927,1.0,659.0,659.0,5,1079,1.0,811.0,811.0
240.256,6,127,117989,53,4007,4620.0,517.0,207.0,74,113982,3291.0,2804.0,1776.0
0.005,6,10,1989,5,927,1.0,659.0,659.0,5,1062,1.0,794.0,794.0
240.213,6,26,4224,12,1820,21837.0,539.0,235.0,14,2404,18477.0,1306.0,240.0
0.083,6,10,1506,5,395,19.0,127.0,127.0,5,1111,18.0,843.0,843.0
0.009,6,10,2000,5,927,2.0,659.0,659.0,5,1073,2.0,805.0,805.0
0.106,6,10,1506,5,395,22.0,127.0,127.0,5,1111,22.0,843.0,843.0
0.003,17,2,162,1,65,0.0,37.0,37.0,1,97,0.0,69.0,69.0
0.113,6,10,1506,5,395,25.0,127.0,127.0,5,1111,26.0,843.0,843.0
0.005,6,10,2006,5,927,1.0,659.0,659.0,5,1079,1.0,811.0,811.0
0.016,6,10,1762,5,911,4.0,643.0,643.0,5,851,4.0,583.0,583.0
0.01,6,10,1677,5,827,2.0,559.0,559.0,5,850,2.0,582.0,582.0
0.005,6,10,1779,5,928,1.0,660.0,660.0,5,851,1.0,583.0,583.0
0.001,17,2,180,1,66,0.0,38.0,38.0,1,114,0.0,86.0,86.0
0.171,6,10,1506,5,395,39.0,127.0,127.0,5,1111,38.0,843.0,843.0
0.009,6,13,3735,7,497,1.0,125.0,125.0,6,3238,1.0,1470.0,1459.0
301.549,6,67,32352,33,25920,9423.0,4080.0,1637.0,34,6432,283.0,2667.0,361.0
0.005,6,10,1689,5,839,1.0,571.0,571.0,5,850,1.0,582.0,582.0
0.006,6,10,1547,5,764,1.0,496.0,496.0,5,783,1.0,515.0,515.0
0.01,6,10,1762,5,911,2.0,643.0,643.0,5,851,2.0,583.0,583.0
0.005,17,2,187,1,71,0.0,43.0,43.0,1,116,0.0,88.0,88.0
0.1,6,10,1506,5,395,20.0,127.0,127.0,5,1111,21.0,843.0,843.0
0.004,6,10,2006,5,927,1.0,659.0,659.0,5,1079,1.0,811.0,811.0
0.004,6,10,1779,5,928,1.0,660.0,660.0,5,851,1.0,583.0,583.0
0.095,6,10,1506,5,395,19.0,127.0,127.0,5,1111,22.0,843.0,843.0
0.079,6,10,1506,5,395,18.0,127.0,127.0,5,1111,19.0,843.0,843.0
0.009,6,10,1989,5,910,2.0,642.0,642.0,5,1079,2.0,811.0,811.0
0.008,17,2,214,1,75,0.0,47.0,47.0,1,139,0.0,111.0,111.0
0.062,6,10,1506,5,395,13.0,127.0,127.0,5,1111,14.0,843.0,843.0
0.007,6,10,2006,5,927,1.0,659.0,659.0,5,1079,1.0,811.0,811.0
0.003,6,10,1702,5,863,0.0,595.0,595.0,5,839,0.0,571.0,571.0
0.005,6,10,2000,5,927,1.0,659.0,659.0,5,1073,1.0,805.0,805.0
0.01,6,10,1972,5,910,2.0,642.0,642.0,5,1062,2.0,794.0,794.0
0.005,17,2,164,1,74,0.0,46.0,46.0,1,90,0.0,62.0,62.0
0.005,6,10,2000,5,927,1.0,659.0,659.0,5,1073,1.0,805.0,805.0
291.587,6,312,343241,118,17689,2492.0,2736.0,889.0,194,325552,1510.0,2804.0,1752.0
0.014,6,10,1990,5,911,3.0,643.0,643.0,5,1079,3.0,811.0,811.0
0.006,17,2,166,1,75,0.0,47.0,47.0,1,91,0.0,63.0,63.0
0.005,6,10,1643,5,860,1.0,592.0,592.0,5,783,1.0,515.0,515.0
0.011,6,10,1990,5,911,2.0,643.0,643.0,5,1079,2.0,811.0,811.0
0.216,17,4,352,2,130,176.0,37.0,37.0,2,222,144.0,89.0,83.0
0.013,6,10,1990,5,911,3.0,643.0,643.0,5,1079,3.0,811.0,811.0
175.489,17,84,11741,42,2795,4280.0,44.0,38.0,42,8946,4280.0,261.0,185.0
0.006,17,2,169,1,62,0.0,34.0,34.0,1,107,0.0,79.0,79.0
40.072,17,10,676,5,460,10015.0,104.0,64.0,5,216,10017.0,20.0,15.0
0.005,6,10,2007,5,928,1.0,660.0,660.0,5,1079,1.0,811.0,811.0
10.919,17,28,4420,14,1993,831.0,268.0,114.0,14,2427,831.0,586.0,145.0
0.011,17,2,170,1,65,0.0,37.0,37.0,1,105,0.0,77.0,77.0
0.008,6,10,1983,5,910,2.0,642.0,642.0,5,1073,1.0,805.0,805.0
0.096,6,10,1506,5,395,20.0,127.0,127.0,5,1111,21.0,843.0,843.0
0.005,17,2,170,1,65,0.0,37.0,37.0,1,105,0.0,77.0,77.0
0.146,6,10,1506,5,395,34.0,127.0,127.0,5,1111,27.0,843.0,843.0
0.124,6,10,1506,5,395,29.0,127.0,127.0,5,1111,28.0,843.0,843.0
0.037,17,2,136,1,60,0.0,32.0,32.0,1,76,0.0,48.0,48.0
0.003,17,2,160,1,72,0.0,44.0,44.0,1,88,0.0,60.0,60.0
0.069,17,8,3613,4,1874,23.0,1350.0,440.0,4,1739,11.0,1350.0,406.0
0.073,6,10,1506,5,395,16.0,127.0,127.0,5,1111,14.0,843.0,843.0
0.011,6,10,1989,5,910,2.0,642.0,642.0,5,1079,2.0,811.0,811.0
1778.207,17,144,45504,72,22752,25045.0,288.0,288.0,72,22752,25045.0,288.0,288.0
0.005,17,2,230,1,68,0.0,40.0,40.0,1,162,0.0,134.0,134.0
0.006,6,10,1547,5,764,1.0,496.0,496.0,5,783,1.0,515.0,515.0
0.001,17,2,180,1,66,0.0,38.0,38.0,1,114,0.0,86.0,86.0
0.006,6,10,2006,5,927,1.0,659.0,659.0,5,1079,1.0,811.0,811.0
0.015,6,10,1989,5,910,3.0,642.0,642.0,5,1079,3.0,811.0,811.0
10.799,17,28,4416,14,1993,821.0,268.0,114.0,14,2423,821.0,586.0,145.0
300.022,6,12,1782,7,1348,50003.0,494.0,494.0,5,434,75004.0,83.0,83.0
0.014,6,13,3735,7,497,2.0,125.0,125.0,6,3238,2.0,1470.0,1459.0
0.038,17,2,152,1,76,0.0,48.0,48.0,1,76,0.0,48.0,48.0
0.003,17,2,148,1,60,0.0,32.0,32.0,1,88,0.0,60.0,60.0
0.078,6,46,14148,26,2669,3.0,517.0,146.0,20,11479,3.0,1402.0,745.0
240.013,6,9,787,5,488,60003.0,232.0,232.0,4,299,80003.0,83.0,83.0
0.005,6,10,2000,5,927,1.0,659.0,659.0,5,1073,1.0,805.0,805.0
0.013,6,10,1983,5,910,3.0,642.0,642.0,5,1073,3.0,805.0,805.0
0.005,17,2,170,1,65,0.0,37.0,37.0,1,105,0.0,77.0,77.0
0.121,6,10,1506,5,395,28.0,127.0,127.0,5,1111,28.0,843.0,843.0
0.004,6,10,2006,5,927,1.0,659.0,659.0,5,1079,1.0,811.0,811.0
0.004,17,2,140,1,62,0.0,34.0,34.0,1,78,0.0,50.0,50.0
0.006,6,10,2006,5,927,1.0,659.0,659.0,5,1079,1.0,811.0,811.0
0.022,6,10,1990,5,911,5.0,643.0,643.0,5,1079,5.0,811.0,811.0
0.008,6,10,1989,5,910,2.0,642.0,642.0,5,1079,2.0,811.0,811.0
0.111,6,10,1506,5,395,22.0,127.0,127.0,5,1111,25.0,843.0,843.0
0.041,17,2,166,1,75,0.0,47.0,47.0,1,91,0.0,63.0,63.0
0.099,6,10,1506,5,395,20.0,127.0,127.0,5,1111,19.0,843.0,843.0
40.061,17,10,676,5,460,10012.0,104.0,64.0,5,216,10014.0,20.0,15.0
0.006,6,10,1547,5,764,1.0,496.0,496.0,5,783,1.0,515.0,515.0
0.004,6,10,1989,5,927,1.0,659.0,659.0,5,1062,1.0,794.0,794.0
309.182,17,20,1124,10,716,34346.0,48.0,43.0,10,408,34346.0,20.0,12.0
0.012,6,10,1972,5,910,2.0,642.0,642.0,5,1062,3.0,794.0,794.0
159.426,17,80,11429,40,2674,4087.0,44.0,38.0,40,8755,4087.0,239.0,190.0
0.006,6,10,1547,5,764,1.0,496.0,496.0,5,783,1.0,515.0,515.0
0.006,6,10,1547,5,764,1.0,496.0,496.0,5,783,1.0,515.0,515.0
0.006,6,10,1547,5,764,1.0,496.0,496.0,5,783,1.0,515.0,515.0
0.006,6,10,1854,5,889,1.0,621.0,621.0,5,965,1.0,697.0,697.0
0.082,6,10,1506,5,395,19.0,127.0,127.0,5,1111,18.0,843.0,843.0
0.037,6,10,1989,5,910,9.0,642.0,642.0,5,1079,9.0,811.0,811.0
240.116,6,16,4482,9,963,30014.0,238.0,166.0,7,3519,40018.0,1402.0,786.0
0.006,6,10,1547,5,764,1.0,496.0,496.0,5,783,1.0,515.0,515.0
0.005,6,10,2007,5,928,1.0,660.0,660.0,5,1079,1.0,811.0,811.0
0.005,6,13,3747,7,509,0.0,137.0,137.0,6,3238,0.0,1470.0,1459.0
0.001,17,2,180,1,66,0.0,38.0,38.0,1,114,0.0,86.0,86.0
1761.212,6,469,66971,255,35389,6933.0,613.0,195.0,214,31582,8268.0,453.0,144.0
308.38,17,20,1124,10,716,34250.0,48.0,43.0,10,408,34250.0,20.0,12.0
0.006,6,10,1547,5,764,1.0,496.0,496.0,5,783,1.0,515.0,515.0
0.013,6,12,1926,6,1189,2.0,659.0,434.0,6,737,2.0,417.0,417.0
0.01,6,10,1990,5,911,2.0,643.0,643.0,5,1079,2.0,811.0,811.0
0.001,17,2,180,1,66,0.0,38.0,38.0,1,114,0.0,86.0,86.0
0.07,6,10,1506,5,395,12.0,127.0,127.0,5,1111,17.0,843.0,843.0
0.004,17,4,284,2,120,0.0,32.0,32.0,2,164,0.0,60.0,54.0
0.087,6,10,1506,5,395,18.0,127.0,127.0,5,1111,18.0,843.0,843.0
0.038,17,2,148,1,60,0.0,32.0,32.0,1,88,0.0,60.0,60.0
0.007,6,10,2006,5,927,1.0,659.0,659.0,5,1079,1.0,811.0,811.0
308.581,17,20,1124,10,716,34275.0,48.0,43.0,10,408,34275.0,20.0,12.0
0.012,6,10,1989,5,910,3.0,642.0,642.0,5,1079,2.0,811.0,811.0
0.018,6,10,1983,5,910,4.0,642.0,642.0,5,1073,4.0,805.0,805.0
0.005,17,2,168,1,76,0.0,48.0,48.0,1,92,0.0,64.0,64.0
0.009,6,10,1643,5,860,2.0,592.0,592.0,5,783,2.0,515.0,515.0
0.004,6,10,2007,5,928,1.0,660.0,660.0,5,1079,1.0,811.0,811.0
0.006,6,10,1547,5,764,1.0,496.0,496.0,5,783,1.0,515.0,515.0
0.087,6,10,1506,5,395,18.0,127.0,127.0,5,1111,19.0,843.0,843.0
0.005,6,10,1547,5,764,1.0,496.0,496.0,5,783,1.0,515.0,515.0
0.001,17,2,136,1,60,0.0,32.0,32.0,1,76,0.0,48.0,48.0
40.063,17,10,676,5,460,10013.0,104.0,64.0,5,216,10014.0,20.0,15.0
0.077,6,10,1506,5,395,18.0,127.0,127.0,5,1111,17.0,843.0,843.0
0.094,6,10,1506,5,395,21.0,127.0,127.0,5,1111,18.0,843.0,843.0
0.02,6,10,1989,5,910,4.0,642.0,642.0,5,1079,4.0,811.0,811.0
40.066,17,10,676,5,460,10015.0,104.0,64.0,5,216,10015.0,20.0,15.0
0.012,6,10,1972,5,910,3.0,642.0,642.0,5,1062,2.0,794.0,794.0
0.08,6,10,1506,5,395,19.0,127.0,127.0,5,1111,18.0,843.0,843.0
0.043,6,10,1677,5,827,10.0,559.0,559.0,5,850,10.0,582.0,582.0
240.017,6,9,787,5,488,60004.0,232.0,232.0,4,299,80004.0,83.0,83.0
0.005,6,10,1989,5,927,1.0,659.0,659.0,5,1062,1.0,794.0,794.0
0.059,17,2,148,1,60,0.0,32.0,32.0,1,88,0.0,60.0,60.0
0.005,17,2,170,1,65,0.0,37.0,37.0,1,105,0.0,77.0,77.0
292.499,6,318,344333,126,18104,2339.0,2736.0,888.0,192,326229,1531.0,2804.0,1766.0
240.015,6,9,787,5,488,60003.0,232.0,232.0,4,299,80004.0,83.0,83.0
0.087,6,10,1506,5,395,20.0,127.0,127.0,5,1111,17.0,843.0,843.0
0.005,6,10,2006,5,927,1.0,659.0,659.0,5,1079,1.0,811.0,811.0
0.098,17,2,144,1,64,0.0,36.0,36.0,1,80,0.0,52.0,52.0
0.005,6,10,2006,5,927,1.0,659.0,659.0,5,1079,1.0,811.0,811.0
0.004,6,10,1774,5,923,1.0,655.0,655.0,5,851,1.0,583.0,583.0
0.311,17,4,596,2,122,240.0,33.0,33.0,2,474,183.0,323.0,209.0
0.008,6,10,1983,5,910,2.0,642.0,642.0,5,1073,2.0,805.0,805.0
0.017,6,13,3735,7,497,2.0,125.0,125.0,6,3238,3.0,1470.0,1459.0
0.006,6,10,1547,5,764,1.0,496.0,496.0,5,783,1.0,515.0,515.0
0.004,6,10,2000,5,927,1.0,659.0,659.0,5,1073,1.0,805.0,805.0
0.164,6,29,9259,15,6868,11.0,1981.0,675.0,14,2391,12.0,580.0,236.0
0.009,6,12,1926,6,1189,1.0,659.0,434.0,6,737,1.0,417.0,417.0
0.007,6,10,1547,5,764,1.0,496.0,496.0,5,783,1.0,515.0,515.0
311.048,17,20,1124,10,716,34546.0,48.0,43.0,10,408,34546.0,20.0,12.0
0.011,6,10,1989,5,910,2.0,642.0,642.0,5,1079,2.0,811.0,811.0
0.007,6,10,1547,5,764,1.0,496.0,496.0,5,783,1.0,515.0,515.0
0.005,6,10,1689,5,839,1.0,571.0,571.0,5,850,1.0,582.0,582.0
0.004,17,4,284,2,120,0.0,32.0,32.0,2,164,0.0,60.0,54.0
0.01,6,10,1983,5,910,2.0,642.0,642.0,5,1073,2.0,805.0,805.0
0.006,6,10,1854,5,889,1.0,621.0,621.0,5,965,1.0,697.0,697.0
0.113,6,10,1506,5,395,27.0,127.0,127.0,5,1111,24.0,843.0,843.0
0.004,17,4,284,2,120,0.0,32.0,32.0,2,164,0.0,60.0,54.0
40.049,17,10,676,5,460,10011.0,104.0,64.0,5,216,10007.0,20.0,15.0
0.004,6,10,2000,5,927,1.0,659.0,659.0,5,1073,1.0,805.0,805.0
0.001,17,2,180,1,66,0.0,38.0,38.0,1,114,0.0,86.0,86.0
0.068,6,10,1506,5,395,14.0,127.0,127.0,5,1111,14.0,843.0,843.0
0.137,6,10,1506,5,395,29.0,127.0,127.0,5,1111,32.0,843.0,843.0
0.008,6,12,1926,6,1189,1.0,659.0,434.0,6,737,1.0,417.0,417.0
0.068,6,10,1506,5,395,14.0,127.0,127.0,5,1111,16.0,843.0,843.0
0.005,6,10,2006,5,927,1.0,659.0,659.0,5,1079,1.0,811.0,811.0
0.016,6,10,1643,5,860,4.0,592.0,592.0,5,783,3.0,515.0,515.0
0.009,6,14,3787,7,497,1.0,125.0,125.0,7,3290,1.0,1448.0,972.0
0.004,6,10,2006,5,927,1.0,659.0,659.0,5,1079,1.0,811.0,811.0
0.005,6,10,2007,5,928,1.0,660.0,660.0,5,1079,1.0,811.0,811.0
175.071,17,78,11107,39,2585,4607.0,44.0,38.0,39,8522,4606.0,252.0,190.0
15.071,17,15,9238,8,6902,2149.0,1350.0,834.0,7,2336,2507.0,1350.0,305.0
0.086,6,10,1506,5,395,19.0,127.0,127.0,5,1111,17.0,843.0,843.0
0.054,17,2,179,1,71,0.0,43.0,43.0,1,108,0.0,80.0,80.0
353.462,6,20,2210,6,1308,12003.0,494.0,494.0,14,902,27189.0,83.0,83.0
0.111,6,10,1506,5,395,25.0,127.0,127.0,5,1111,24.0,843.0,843.0
0.129,6,10,1506,5,395,29.0,127.0,127.0,5,1111,28.0,843.0,843.0
0.01,6,10,1677,5,827,2.0,559.0,559.0,5,850,2.0,582.0,582.0
0.006,17,2,170,1,65,0.0,37.0,37.0,1,105,0.0,77.0,77.0
0.018,6,10,1983,5,910,4.0,642.0,642.0,5,1073,4.0,805.0,805.0
0.004,6,10,2006,5,927,1.0,659.0,659.0,5,1079,1.0,811.0,811.0
300.406,6,16,2170,9,684,37529.0,146.0,146.0,7,1486,50038.0,419.0,398.0
0.081,6,10,1506,5,395,17.0,127.0,127.0,5,1111,15.0,843.0,843.0
0.005,6,10,1689,5,839,1.0,571.0,571.0,5,850,1.0,582.0,582.0
66.405,6,28,18347,16,10402,4427.0,2804.0,1366.0,12,7945,6021.0,2316.0,1218.0
0.013,6,10,1972,5,910,3.0,642.0,642.0,5,1062,3.0,794.0,794.0
0.004,6,10,2007,5,928,1.0,660.0,660.0,5,1079,1.0,811.0,811.0
40.045,17,10,676,5,460,10010.0,104.0,64.0,5,216,10010.0,20.0,15.0
0.003,17,2,148,1,60,0.0,32.0,32.0,1,88,0.0,60.0,60.0
0.014,6,10,1989,5,910,3.0,642.0,642.0,5,1079,3.0,811.0,811.0
0.008,6,10,1547,5,764,1.0,496.0,496.0,5,783,1.0,515.0,515.0
0.004,6,10,2006,5,927,1.0,659.0,659.0,5,1079,1.0,811.0,811.0
0.081,6,10,1506,5,395,18.0,127.0,127.0,5,1111,18.0,843.0,843.0
0.006,6,10,1854,5,889,1.0,621.0,621.0,5,965,1.0,697.0,697.0
0.01,6,10,1989,5,910,2.0,642.0,642.0,5,1079,2.0,811.0,811.0
40.051,17,10,676,5,460,10012.0,104.0,64.0,5,216,10012.0,20.0,15.0
0.001,17,2,179,1,62,0.0,34.0,34.0,1,117,0.0,89.0,89.0
0.017,6,10,1989,5,910,4.0,642.0,642.0,5,1079,4.0,811.0,811.0
0.083,6,10,1506,5,395,17.0,127.0,127.0,5,1111,18.0,843.0,843.0
0.016,6,10,1990,5,911,3.0,643.0,643.0,5,1079,3.0,811.0,811.0
0.006,6,10,1689,5,839,1.0,571.0,571.0,5,850,1.0,582.0,582.0
0.082,6,10,1506,5,395,18.0,127.0,127.0,5,1111,17.0,843.0,843.0
0.171,17,2,213,1,69,0.0,41.0,41.0,1,144,0.0,116.0,116.0
0.005,6,10,1989,5,927,1.0,659.0,659.0,5,1062,1.0,794.0,794.0
0.001,17,2,180,1,66,0.0,38.0,38.0,1,114,0.0,86.0,86.0
0.142,6,10,1506,5,395,34.0,127.0,127.0,5,1111,30.0,843.0,843.0
0.09,6,10,1506,5,395,20.0,127.0,127.0,5,1111,20.0,843.0,843.0
40.081,17,10,676,5,460,10017.0,104.0,64.0,5,216,10019.0,20.0,15.0
25.461,17,24,14849,13,12031,2119.0,1350.0,897.0,11,2818,2541.0,1350.0,228.0
0.092,6,10,1506,5,395,20.0,127.0,127.0,5,1111,18.0,843.0,843.0
0.04,17,2,136,1,60,0.0,32.0,32.0,1,76,0.0,48.0,48.0
0.023,6,10,1989,5,910,5.0,642.0,642.0,5,1079,5.0,811.0,811.0
40.07,17,10,676,5,460,10015.0,104.0,64.0,5,216,10016.0,20.0,15.0
0.005,6,10,2006,5,927,1.0,659.0,659.0,5,1079,1.0,811.0,811.0
0.006,6,10,1779,5,928,1.0,660.0,660.0,5,851,1.0,583.0,583.0
95.557,6,21,8147,11,1985,89.0,1174.0,504.0,10,6162,10598.0,2720.0,958.0
0.005,17,2,164,1,74,0.0,46.0,46.0,1,90,0.0,62.0,62.0
0.04,17,4,596,2,122,3.0,33.0,33.0,2,474,0.0,323.0,209.0
167.06,17,68,9774,34,2267,5062.0,44.0,38.0,34,7507,5062.0,239.0,192.0
369.039,6,22,2313,16,867,24602.0,195.0,195.0,6,1446,4638.0,419.0,398.0
0.086,6,10,1506,5,395,19.0,127.0,127.0,5,1111,20.0,843.0,843.0
0.001,17,2,179,1,62,0.0,34.0,34.0,1,117,0.0,89.0,89.0
0.004,6,10,1779,5,928,1.0,660.0,660.0,5,851,0.0,583.0,583.0
0.137,6,10,1506,5,395,26.0,127.0,127.0,5,1111,30.0,843.0,843.0
0.009,6,13,3735,7,497,1.0,125.0,125.0,6,3238,1.0,1470.0,1459.0
0.009,6,10,1972,5,910,2.0,642.0,642.0,5,1062,2.0,794.0,794.0
0.005,6,10,1689,5,839,1.0,571.0,571.0,5,850,1.0,582.0,582.0
40.071,17,10,676,5,460,10015.0,104.0,64.0,5,216,10017.0,20.0,15.0
0.005,6,10,1989,5,927,1.0,659.0,659.0,5,1062,1.0,794.0,794.0
0.006,17,2,179,1,71,0.0,43.0,43.0,1,108,0.0,80.0,80.0
0.067,6,10,1506,5,395,15.0,127.0,127.0,5,1111,16.0,843.0,843.0
0.005,6,10,1989,5,927,1.0,659.0,659.0,5,1062,1.0,794.0,794.0
0.003,17,2,136,1,60,0.0,32.0,32.0,1,76,0.0,48.0,48.0
0.005,6,10,1854,5,889,1.0,621.0,621.0,5,965,1.0,697.0,697.0
0.072,6,10,1506,5,395,17.0,127.0,127.0,5,1111,14.0,843.0,843.0
0.011,17,2,136,1,60,0.0,32.0,32.0,1,76,0.0,48.0,48.0
40.055,17,10,676,5,460,10011.0,104.0,64.0,5,216,10013.0,20.0,15.0
0.205,17,2,152,1,76,0.0,48.0,48.0,1,76,0.0,48.0,48.0
173.214,17,76,10818,38,2530,4681.0,44.0,38.0,38,8288,4681.0,239.0,190.0
0.001,17,2,142,1,63,0.0,35.0,35.0,1,79,0.0,51.0,51.0
0.069,6,10,1506,5,395,14.0,127.0,127.0,5,1111,15.0,843.0,843.0
0.004,17,4,284,2,120,0.0,32.0,32.0,2,164,0.0,60.0,54.0
0.005,6,10,1989,5,927,1.0,659.0,659.0,5,1062,1.0,794.0,794.0
10.931,17,28,4422,14,1993,831.0,268.0,114.0,14,2429,831.0,588.0,145.0
0.043,17,2,152,1,76,0.0,48.0,48.0,1,76,0.0,48.0,48.0
0.006,6,10,1643,5,860,1.0,592.0,592.0,5,783,1.0,515.0,515.0
0.016,6,10,1989,5,910,3.0,642.0,642.0,5,1079,4.0,811.0,811.0
0.005,17,2,230,1,68,0.0,40.0,40.0,1,162,0.0,134.0,134.0
0.003,17,2,136,1,60,0.0,32.0,32.0,1,76,0.0,48.0,48.0
0.011,6,10,1990,5,911,2.0,643.0,643.0,5,1079,2.0,811.0,811.0
0.007,6,10,1989,5,910,1.0,642.0,642.0,5,1079,1.0,811.0,811.0
15.075,17,15,9238,8,6902,2149.0,1350.0,834.0,7,2336,2507.0,1350.0,305.0
0.068,17,8,3613,4,1874,22.0,1350.0,440.0,4,1739,11.0,1350.0,406.0
0.011,6,10,1989,5,910,2.0,642.0,642.0,5,1079,2.0,811.0,811.0
0.012,6,10,1989,5,910,3.0,642.0,642.0,5,1079,2.0,811.0,811.0
0.102,6,10,1506,5,395,24.0,127.0,127.0,5,1111,19.0,843.0,843.0
0.006,6,10,1643,5,860,1.0,592.0,592.0,5,783,1.0,515.0,515.0
0.014,6,10,1677,5,827,3.0,559.0,559.0,5,850,3.0,582.0,582.0
0.006,6,10,1689,5,839,1.0,571.0,571.0,5,850,1.0,582.0,582.0
0.003,17,4,284,2,120,0.0,32.0,32.0,2,164,0.0,60.0,54.0
0.005,6,10,2006,5,927,1.0,659.0,659.0,5,1079,1.0,811.0,811.0
0.001,17,2,180,1,66,0.0,38.0,38.0,1,114,0.0,86.0,86.0
0.039,17,2,148,1,60,0.0,32.0,32.0,1,88,0.0,60.0,60.0
11.204,17,28,4423,14,1994,848.0,269.0,114.0,14,2429,849.0,588.0,145.0
381.604,6,22,2313,16,867,25440.0,195.0,195.0,6,1446,4674.0,419.0,398.0
0.038,17,2,136,1,60,0.0,32.0,32.0,1,76,0.0,48.0,48.0
0.004,17,2,169,1,62,0.0,34.0,34.0,1,107,0.0,79.0,79.0
40.065,17,10,676,5,460,10015.0,104.0,64.0,5,216,10015.0,20.0,15.0
0.005,17,2,169,1,62,0.0,34.0,34.0,1,107,0.0,79.0,79.0
0.016,6,10,1972,5,910,4.0,642.0,642.0,5,1062,3.0,794.0,794.0
0.001,17,2,180,1,66,0.0,38.0,38.0,1,114,0.0,86.0,86.0
0.005,6,15,3794,8,504,0.0,80.0,80.0,7,3290,0.0,1448.0,972.0
0.066,6,10,1506,5,395,15.0,127.0,127.0,5,1111,13.0,843.0,843.0
0.005,6,10,2000,5,927,1.0,659.0,659.0,5,1073,1.0,805.0,805.0
0.006,6,10,1989,5,927,1.0,659.0,659.0,5,1062,1.0,794.0,794.0
0.005,6,10,2007,5,928,1.0,660.0,660.0,5,1079,1.0,811.0,811.0
0.017,6,10,1983,5,910,4.0,642.0,642.0,5,1073,4.0,805.0,805.0
0.079,6,10,1506,5,395,18.0,127.0,127.0,5,1111,18.0,843.0,843.0
40.062,17,10,676,5,460,10014.0,104.0,64.0,5,216,10014.0,20.0,15.0
0.004,6,10,1702,5,863,1.0,595.0,595.0,5,839,1.0,571.0,571.0
0.151,6,10,1506,5,395,36.0,127.0,127.0,5,1111,35.0,843.0,843.0
10.832,17,28,4423,14,1995,824.0,270.0,114.0,14,2428,824.0,587.0,145.0
0.042,17,2,128,1,56,0.0,28.0,28.0,1,72,0.0,44.0,44.0
0.005,6,10,2007,5,928,1.0,660.0,660.0,5,1079,1.0,811.0,811.0
0.097,6,10,1506,5,395,23.0,127.0,127.0,5,1111,20.0,843.0,843.0
0.005,6,10,2006,5,927,1.0,659.0,659.0,5,1079,1.0,811.0,811.0
0.005,6,10,2007,5,928,1.0,660.0,660.0,5,1079,1.0,811.0,811.0
0.005,6,10,2006,5,927,1.0,659.0,659.0,5,1079,1.0,811.0,811.0
0.004,6,10,2007,5,928,1.0,660.0,660.0,5,1079,1.0,811.0,811.0
0.004,6,10,2007,5,928,1.0,660.0,660.0,5,1079,1.0,811.0,811.0
0.004,6,10,1989,5,927,1.0,659.0,659.0,5,1062,1.0,794.0,794.0
0.061,17,2,80,1,32,0.0,4.0,4.0,1,48,0.0,20.0,20.0
0.008,6,10,1983,5,910,1.0,642.0,642.0,5,1073,2.0,805.0,805.0
0.005,6,10,1989,5,927,1.0,659.0,659.0,5,1062,1.0,794.0,794.0
1029.79,6,84,37936,44,8702,23948.0,1402.0,582.0,40,29234,24865.0,1928.0,969.0
0.077,17,2,148,1,60,0.0,32.0,32.0,1,88,0.0,60.0,60.0
0.012,6,10,1677,5,827,3.0,559.0,559.0,5,850,3.0,582.0,582.0
0.011,6,10,1989,5,910,2.0,642.0,642.0,5,1079,2.0,811.0,811.0
0.012,6,10,1983,5,910,2.0,642.0,642.0,5,1073,3.0,805.0,805.0
0.005,6,10,1689,5,839,1.0,571.0,571.0,5,850,1.0,582.0,582.0
0.005,6,10,2000,5,927,1.0,659.0,659.0,5,1073,1.0,805.0,805.0
0.08,6,10,1506,5,395,17.0,127.0,127.0,5,1111,17.0,843.0,843.0
0.004,6,10,2006,5,927,1.0,659.0,659.0,5,1079,1.0,811.0,811.0
48.176,6,42,12756,21,6889,453.0,2720.0,1002.0,21,5867,2400.0,2667.0,385.0
15.137,17,19,11015,10,7426,1678.0,1350.0,714.0,9,3589,1888.0,1350.0,370.0
0.116,6,10,1506,5,395,25.0,127.0,127.0,5,1111,25.0,843.0,843.0
0.014,6,13,3735,7,497,2.0,125.0,125.0,6,3238,2.0,1470.0,1459.0
0.005,6,14,3799,7,509,0.0,137.0,137.0,7,3290,0.0,1448.0,972.0
0.005,6,10,1689,5,839,1.0,571.0,571.0,5,850,1.0,582.0,582.0
0.004,17,2,148,1,60,0.0,32.0,32.0,1,88,0.0,60.0,60.0
0.076,6,10,1506,5,395,16.0,127.0,127.0,5,1111,15.0,843.0,843.0
0.017,17,2,214,1,75,0.0,47.0,47.0,1,139,0.0,111.0,111.0
0.011,6,10,1972,5,910,2.0,642.0,642.0,5,1062,2.0,794.0,794.0
0.011,6,10,1989,5,910,2.0,642.0,642.0,5,1079,2.0,811.0,811.0
0.001,17,2,180,1,66,0.0,38.0,38.0,1,114,0.0,86.0,86.0
0.005,6,10,1989,5,927,1.0,659.0,659.0,5,1062,1.0,794.0,794.0
0.014,6,10,1972,5,910,3.0,642.0,642.0,5,1062,3.0,794.0,794.0
0.006,6,10,1547,5,764,1.0,496.0,496.0,5,783,1.0,515.0,515.0
0.005,6,10,2006,5,927,1.0,659.0,659.0,5,1079,1.0,811.0,811.0
40.063,17,10,676,5,460,10012.0,104.0,64.0,5,216,10015.0,20.0,15.0
0.007,6,10,2006,5,927,1.0,659.0,659.0,5,1079,1.0,811.0,811.0
40.058,17,10,676,5,460,10012.0,104.0,64.0,5,216,10013.0,20.0,15.0
0.126,6,10,1506,5,395,30.0,127.0,127.0,5,1111,29.0,843.0,843.0
0.02,6,10,1989,5,910,5.0,642.0,642.0,5,1079,5.0,811.0,811.0
0.009,6,10,1983,5,910,2.0,642.0,642.0,5,1073,2.0,805.0,805.0
0.005,6,10,2006,5,927,1.0,659.0,659.0,5,1079,1.0,811.0,811.0
0.017,6,10,1990,5,911,4.0,643.0,643.0,5,1079,4.0,811.0,811.0
92.23,58,5,360,4,288,30743.0,24.0,24.0,1,72,0.0,24.0,24.0
0.079,17,2,152,1,76,0.0,48.0,48.0,1,76,0.0,48.0,48.0
0.178,6,12,2996,7,549,29.0,177.0,177.0,5,2447,43.0,1402.0,1089.0
0.019,6,10,1990,5,911,4.0,643.0,643.0,5,1079,4.0,811.0,811.0
90.214,17,6,1005,3,204,45105.0,40.0,40.0,3,801,45105.0,239.0,239.0
0.005,6,10,2000,5,927,1.0,659.0,659.0,5,1073,1.0,805.0,805.0
0.006,6,10,1547,5,764,1.0,496.0,496.0,5,783,1.0,515.0,515.0
15.08,17,16,8116,8,6051,2150.0,1350.0,728.0,8,2065,2150.0,1350.0,230.0
40.075,17,10,676,5,460,10015.0,104.0,64.0,5,216,10016.0,20.0,15.0
0.009,17,2,194,1,59,0.0,31.0,31.0,1,135,0.0,107.0,107.0
0.012,6,10,1972,5,910,2.0,642.0,642.0,5,1062,2.0,794.0,794.0
0.001,17,2,179,1,62,0.0,34.0,34.0,1,117,0.0,89.0,89.0
0.095,6,10,1506,5,395,21.0,127.0,127.0,5,1111,19.0,843.0,843.0
167.293,17,74,10653,37,2466,4646.0,44.0,38.0,37,8187,4646.0,239.0,193.0
0.004,17,2,412,1,61,0.0,33.0,33.0,1,351,0.0,323.0,323.0
0.007,17,2,179,1,71,0.0,43.0,43.0,1,108,0.0,80.0,80.0
0.005,6,10,2000,5,927,1.0,659.0,659.0,5,1073,1.0,805.0,805.0
0.03,6,10,1972,5,910,7.0,642.0,642.0,5,1062,7.0,794.0,794.0
308.419,17,20,1124,10,716,34262.0,48.0,43.0,10,408,34262.0,20.0,12.0
0.005,17,2,180,1,58,0.0,30.0,30.0,1,122,0.0,94.0,94.0
0.005,6,10,2006,5,927,1.0,659.0,659.0,5,1079,1.0,811.0,811.0
0.006,6,10,1547,5,764,1.0,496.0,496.0,5,783,1.0,515.0,515.0
0.005,6,10,2007,5,928,1.0,660.0,660.0,5,1079,1.0,811.0,811.0
0.004,6,10,2006,5,927,1.0,659.0,659.0,5,1079,1.0,811.0,811.0
0.075,6,10,1506,5,395,17.0,127.0,127.0,5,1111,17.0,843.0,843.0
0.005,6,10,2006,5,927,1.0,659.0,659.0,5,1079,1.0,811.0,811.0
0.007,6,10,1989,5,910,1.0,642.0,642.0,5,1079,1.0,811.0,811.0
0.039,6,10,1677,5,827,9.0,559.0,559.0,5,850,9.0,582.0,582.0
0.017,6,10,1989,5,910,4.0,642.0,642.0,5,1079,4.0,811.0,811.0
0.009,6,12,1926,6,1189,1.0,659.0,434.0,6,737,1.0,417.0,417.0
0.005,6,10,1989,5,927,1.0,659.0,659.0,5,1062,1.0,794.0,794.0
0.099,6,10,1506,5,395,23.0,127.0,127.0,5,1111,23.0,843.0,843.0
0.069,6,10,1506,5,395,16.0,127.0,127.0,5,1111,14.0,843.0,843.0
0.005,6,10,1689,5,839,1.0,571.0,571.0,5,850,1.0,582.0,582.0
0.003,17,2,170,1,65,0.0,37.0,37.0,1,105,0.0,77.0,77.0
40.054,17,10,676,5,460,10012.0,104.0,64.0,5,216,10012.0,20.0,15.0
0.007,6,14,3787,7,497,1.0,125.0,125.0,7,3290,1.0,1448.0,972.0
0.005,6,10,2007,5,928,1.0,660.0,660.0,5,1079,1.0,811.0,811.0
0.083,6,10,1506,5,395,19.0,127.0,127.0,5,1111,16.0,843.0,843.0
0.016,6,10,1989,5,910,3.0,642.0,642.0,5,1079,4.0,811.0,811.0
0.008,6,12,1926,6,1189,1.0,659.0,434.0,6,737,1.0,417.0,417.0
0.006,6,10,1547,5,764,1.0,496.0,496.0,5,783,1.0,515.0,515.0
40.058,17,10,676,5,460,10013.0,104.0,64.0,5,216,10013.0,20.0,15.0
0.004,6,10,2007,5,928,1.0,660.0,660.0,5,1079,1.0,811.0,811.0
40.071,17,10,676,5,460,10017.0,104.0,64.0,5,216,10016.0,20.0,15.0
0.009,6,10,1972,5,910,2.0,642.0,642.0,5,1062,2.0,794.0,794.0
0.056,17,2,179,1,71,0.0,43.0,43.0,1,108,0.0,80.0,80.0
0.007,6,13,3913,7,495,1.0,123.0,123.0,6,3418,1.0,1650.0,1549.0
0.012,6,10,1989,5,910,3.0,642.0,642.0,5,1079,2.0,811.0,811.0
0.004,17,2,164,1,74,0.0,46.0,46.0,1,90,0.0,62.0,62.0
0.013,6,10,1989,5,910,3.0,642.0,642.0,5,1079,3.0,811.0,811.0
0.005,6,10,2006,5,927,1.0,659.0,659.0,5,1079,1.0,811.0,811.0
0.004,6,10,2006,5,927,1.0,659.0,659.0,5,1079,1.0,811.0,811.0
0.005,17,2,140,1,62,0.0,34.0,34.0,1,78,0.0,50.0,50.0
0.014,6,10,1990,5,911,3.0,643.0,643.0,5,1079,3.0,811.0,811.0
0.176,6,10,1506,5,395,43.0,127.0,127.0,5,1111,27.0,843.0,843.0
0.012,6,10,1989,5,910,3.0,642.0,642.0,5,1079,2.0,811.0,811.0
10.921,17,28,4423,14,1995,831.0,270.0,114.0,14,2428,831.0,587.0,145.0
0.01,6,10,1990,5,911,2.0,643.0,643.0,5,1079,2.0,811.0,811.0
0.081,6,10,1506,5,395,19.0,127.0,127.0,5,1111,15.0,843.0,843.0
0.04,17,2,148,1,60,0.0,32.0,32.0,1,88,0.0,60.0,60.0
0.009,6,10,1677,5,827,2.0,559.0,559.0,5,850,2.0,582.0,582.0
0.071,6,10,1506,5,395,15.0,127.0,127.0,5,1111,16.0,843.0,843.0
0.04,17,4,284,2,120,0.0,32.0,32.0,2,164,36.0,60.0,54.0
0.267,17,13,9140,7,6851,44.0,1350.0,950.0,6,2289,47.0,1350.0,353.0
0.014,6,10,1677,5,827,3.0,559.0,559.0,5,850,3.0,582.0,582.0
0.014,6,10,1989,5,910,3.0,642.0,642.0,5,1079,3.0,811.0,811.0
15.179,17,17,9983,9,6379,1894.0,1350.0,680.0,8,3604,2164.0,1350.0,422.0
0.01,6,13,3735,7,497,1.0,125.0,125.0,6,3238,1.0,1470.0,1459.0
0.069,17,8,3613,4,1874,23.0,1350.0,440.0,4,1739,12.0,1350.0,406.0
0.134,6,10,1506,5,395,30.0,127.0,127.0,5,1111,28.0,843.0,843.0
0.005,6,10,1547,5,764,1.0,496.0,496.0,5,783,1.0,515.0,515.0
0.12,6,10,1506,5,395,27.0,127.0,127.0,5,1111,26.0,843.0,843.0
0.005,6,13,3690,7,452,0.0,80.0,80.0,6,3238,1.0,1470.0,1459.0
0.203,6,16,2778,8,1396,29.0,533.0,324.0,8,1382,18.0,529.0,239.0
126.013,6,13,1941,7,1507,20962.0,1215.0,1215.0,6,434,25154.0,182.0,182.0
0.006,6,10,1989,5,927,1.0,659.0,659.0,5,1062,1.0,794.0,794.0
0.004,17,2,148,1,60,0.0,32.0,32.0,1,88,0.0,60.0,60.0
240.375,6,25,8354,12,2154,21852.0,1041.0,383.0,13,6200,20030.0,1591.0,689.0
0.008,6,10,1989,5,910,2.0,642.0,642.0,5,1079,2.0,811.0,811.0
413.312,6,29,4409,12,3102,10912.0,494.0,494.0,17,1307,25831.0,83.0,83.0
0.005,6,10,2006,5,927,1.0,659.0,659.0,5,1079,1.0,811.0,811.0
0.08,6,10,1506,5,395,17.0,127.0,127.0,5,1111,17.0,843.0,843.0
0.016,6,10,1762,5,911,3.0,643.0,643.0,5,851,4.0,583.0,583.0
0.005,6,10,1547,5,764,1.0,496.0,496.0,5,783,1.0,515.0,515.0
0.091,6,10,1506,5,395,22.0,127.0,127.0,5,1111,17.0,843.0,843.0
0.001,17,2,180,1,66,0.0,38.0,38.0,1,114,0.0,86.0,86.0
0.005,17,2,178,1,81,0.0,53.0,53.0,1,97,0.0,69.0,69.0
0.081,6,10,1506,5,395,16.0,127.0,127.0,5,1111,17.0,843.0,843.0
0.014,6,10,1989,5,910,3.0,642.0,642.0,5,1079,3.0,811.0,811.0
0.13,6,10,1506,5,395,30.0,127.0,127.0,5,1111,29.0,843.0,843.0
0.012,17,2,179,1,71,0.0,43.0,43.0,1,108,0.0,80.0,80.0
0.039,17,2,136,1,60,0.0,32.0,32.0,1,76,0.0,48.0,48.0
0.071,17,2,136,1,60,0.0,32.0,32.0,1,76,0.0,48.0,48.0
0.009,6,12,1926,6,1189,1.0,659.0,434.0,6,737,1.0,417.0,417.0
0.005,6,10,1689,5,839,1.0,571.0,571.0,5,850,1.0,582.0,582.0
0.003,17,2,148,1,60,0.0,32.0,32.0,1,88,0.0,60.0,60.0
0.069,6,10,1506,5,395,15.0,127.0,127.0,5,1111,15.0,843.0,843.0
0.042,17,2,136,1,60,0.0,32.0,32.0,1,76,0.0,48.0,48.0
0.004,6,13,3747,7,509,0.0,137.0,137.0,6,3238,0.0,1470.0,1459.0
0.007,6,10,1547,5,764,1.0,496.0,496.0,5,783,1.0,515.0,515.0
0.072,17,4,596,2,122,1.0,33.0,33.0,2,474,34.0,323.0,209.0
0.041,17,2,412,1,61,0.0,33.0,33.0,1,351,0.0,323.0,323.0
0.009,6,13,3913,7,495,1.0,123.0,123.0,6,3418,1.0,1650.0,1549.0
0.005,6,10,1989,5,927,1.0,659.0,659.0,5,1062,1.0,794.0,794.0
0.008,6,10,1972,5,910,2.0,642.0,642.0,5,1062,2.0,794.0,794.0
0.005,6,10,2000,5,927,1.0,659.0,659.0,5,1073,1.0,805.0,805.0
0.006,17,2,214,1,75,0.0,47.0,47.0,1,139,0.0,111.0,111.0
0.005,6,10,2006,5,927,1.0,659.0,659.0,5,1079,1.0,811.0,811.0
40.071,17,10,676,5,460,10015.0,104.0,64.0,5,216,10016.0,20.0,15.0
0.003,17,2,136,1,60,0.0,32.0,32.0,1,76,0.0,48.0,48.0
40.05,17,10,676,5,460,10010.0,104.0,64.0,5,216,10011.0,20.0,15.0
0.006,6,10,1854,5,889,1.0,621.0,621.0,5,965,1.0,697.0,697.0
0.013,6,10,1762,5,911,3.0,643.0,643.0,5,851,3.0,583.0,583.0
0.004,6,10,1989,5,927,1.0,659.0,659.0,5,1062,1.0,794.0,794.0
0.005,6,13,3747,7,509,0.0,137.0,137.0,6,3238,1.0,1470.0,1459.0
0.086,6,10,1506,5,395,19.0,127.0,127.0,5,1111,16.0,843.0,843.0
0.005,6,10,1989,5,927,1.0,659.0,659.0,5,1062,1.0,794.0,794.0
0.005,6,10,2006,5,927,1.0,659.0,659.0,5,1079,1.0,811.0,811.0
0.004,6,10,2007,5,928,1.0,660.0,660.0,5,1079,1.0,811.0,811.0
0.081,6,10,1506,5,395,17.0,127.0,127.0,5,1111,19.0,843.0,843.0
0.005,6,10,2007,5,928,1.0,660.0,660.0,5,1079,1.0,811.0,811.0
0.013,6,10,1983,5,910,3.0,642.0,642.0,5,1073,3.0,805.0,805.0
0.005,6,10,2007,5,928,1.0,660.0,660.0,5,1079,1.0,811.0,811.0
0.061,17,2,152,1,76,0.0,48.0,48.0,1,76,0.0,48.0,48.0
0.005,17,2,166,1,75,0.0,47.0,47.0,1,91,0.0,63.0,63.0
240.187,6,38,7928,21,2108,12009.0,517.0,166.0,17,5820,15011.0,1402.0,704.0
0.011,6,10,1972,5,910,2.0,642.0,642.0,5,1062,2.0,794.0,794.0
0.109,6,10,1506,5,395,23.0,127.0,127.0,5,1111,22.0,843.0,843.0
0.066,6,10,1506,5,395,15.0,127.0,127.0,5,1111,15.0,843.0,843.0
0.004,6,10,2006,5,927,1.0,659.0,659.0,5,1079,1.0,811.0,811.0
0.006,17,2,178,1,65,0.0,37.0,37.0,1,113,0.0,85.0,85.0
15.081,17,15,8129,8,6015,2150.0,1350.0,723.0,7,2114,2508.0,1350.0,274.0
0.113,6,10,1506,5,395,23.0,127.0,127.0,5,1111,23.0,843.0,843.0
40.055,17,10,676,5,460,10011.0,104.0,64.0,5,216,10013.0,20.0,15.0
126.017,6,13,2150,7,1716,20964.0,1424.0,1424.0,6,434,25156.0,182.0,182.0
0.009,6,10,1989,5,910,2.0,642.0,642.0,5,1079,2.0,811.0,811.0
0.005,6,10,2006,5,927,1.0,659.0,659.0,5,1079,1.0,811.0,811.0
0.01,6,10,1972,5,910,2.0,642.0,642.0,5,1062,2.0,794.0,794.0
0.041,17,2,136,1,60,0.0,32.0,32.0,1,76,0.0,48.0,48.0
0.042,17,2,136,1,60,0.0,32.0,32.0,1,76,0.0,48.0,48.0
0.004,17,2,136,1,60,0.0,32.0,32.0,1,76,0.0,48.0,48.0
0.006,6,10,1689,5,839,1.0,571.0,571.0,5,850,1.0,582.0,582.0
0.007,17,2,194,1,59,0.0,31.0,31.0,1,135,0.0,107.0,107.0
0.007,6,10,1702,5,863,1.0,595.0,595.0,5,839,1.0,571.0,571.0
0.004,6,10,2006,5,927,1.0,659.0,659.0,5,1079,1.0,811.0,811.0
0.007,6,10,1689,5,839,1.0,571.0,571.0,5,850,1.0,582.0,582.0
0.081,6,10,1506,5,395,18.0,127.0,127.0,5,1111,18.0,843.0,843.0
0.071,6,10,1506,5,395,16.0,127.0,127.0,5,1111,14.0,843.0,843.0
0.004,6,10,2006,5,927,1.0,659.0,659.0,5,1079,1.0,811.0,811.0
0.095,6,10,1506,5,395,18.0,127.0,127.0,5,1111,21.0,843.0,843.0
0.011,6,10,1989,5,910,2.0,642.0,642.0,5,1079,2.0,811.0,811.0
0.005,6,13,3747,7,509,0.0,137.0,137.0,6,3238,1.0,1470.0,1459.0
0.005,6,10,1989,5,927,1.0,659.0,659.0,5,1062,1.0,794.0,794.0
0.072,6,10,1506,5,395,17.0,127.0,127.0,5,1111,16.0,843.0,843.0
0.006,6,10,1643,5,860,1.0,592.0,592.0,5,783,1.0,515.0,515.0
0.018,6,10,1990,5,911,4.0,643.0,643.0,5,1079,4.0,811.0,811.0
0.039,17,2,152,1,76,0.0,48.0,48.0,1,76,0.0,48.0,48.0
0.005,6,10,2006,5,927,1.0,659.0,659.0,5,1079,1.0,811.0,811.0
0.135,6,10,1506,5,395,31.0,127.0,127.0,5,1111,20.0,843.0,843.0
0.013,6,10,1989,5,910,3.0,642.0,642.0,5,1079,3.0,811.0,811.0
0.011,6,10,1990,5,911,2.0,643.0,643.0,5,1079,2.0,811.0,811.0
0.01,6,10,1989,5,910,2.0,642.0,642.0,5,1079,2.0,811.0,811.0
0.015,6,10,1990,5,911,3.0,643.0,643.0,5,1079,3.0,811.0,811.0
0.01,6,10,1983,5,910,2.0,642.0,642.0,5,1073,2.0,805.0,805.0
1778.965,17,143,45188,72,22752,25055.0,288.0,288.0,71,22436,25405.0,288.0,288.0
0.004,6,10,2007,5,928,1.0,660.0,660.0,5,1079,1.0,811.0,811.0
0.015,6,10,1677,5,827,3.0,559.0,559.0,5,850,3.0,582.0,582.0
0.127,6,10,1506,5,395,31.0,127.0,127.0,5,1111,28.0,843.0,843.0
0.018,6,10,1989,5,910,4.0,642.0,642.0,5,1079,4.0,811.0,811.0
0.006,6,10,1854,5,889,1.0,621.0,621.0,5,965,1.0,697.0,697.0
0.016,6,10,1972,5,910,4.0,642.0,642.0,5,1062,3.0,794.0,794.0
0.004,17,2,136,1,60,0.0,32.0,32.0,1,76,0.0,48.0,48.0
0.006,17,2,164,1,74,0.0,46.0,46.0,1,90,0.0,62.0,62.0
0.006,6,10,1643,5,860,1.0,592.0,592.0,5,783,1.0,515.0,515.0
0.01,6,12,1926,6,1189,1.0,659.0,434.0,6,737,1.0,417.0,417.0
0.001,17,2,166,1,75,0.0,47.0,47.0,1,91,0.0,63.0,63.0
0.065,6,10,1506,5,395,14.0,127.0,127.0,5,1111,14.0,843.0,843.0
0.013,6,13,3735,7,497,2.0,125.0,125.0,6,3238,2.0,1470.0,1459.0
0.004,17,2,186,1,61,0.0,33.0,33.0,1,125,0.0,97.0,97.0
0.012,6,10,1762,5,911,2.0,643.0,643.0,5,851,3.0,583.0,583.0
0.005,6,10,2006,5,927,1.0,659.0,659.0,5,1079,1.0,811.0,811.0
0.084,6,10,1506,5,395,17.0,127.0,127.0,5,1111,19.0,843.0,843.0
1778.051,17,144,41760,72,22752,25042.0,288.0,288.0,72,19008,25042.0,236.0,236.0
0.005,6,10,1989,5,927,1.0,659.0,659.0,5,1062,1.0,794.0,794.0
0.015,6,10,1990,5,911,3.0,643.0,643.0,5,1079,3.0,811.0,811.0
0.007,17,2,225,1,65,0.0,37.0,37.0,1,160,0.0,132.0,132.0
678.033,58,8,576,5,360,168227.0,24.0,24.0,3,216,319718.0,24.0,24.0
0.079,6,10,1506,5,395,18.0,127.0,127.0,5,1111,17.0,843.0,843.0
0.006,6,10,1547,5,764,1.0,496.0,496.0,5,783,1.0,515.0,515.0
0.005,6,10,1779,5,928,1.0,660.0,660.0,5,851,1.0,583.0,583.0
0.011,6,10,1989,5,910,2.0,642.0,642.0,5,1079,2.0,811.0,811.0
0.005,6,10,2007,5,928,1.0,660.0,660.0,5,1079,1.0,811.0,811.0
0.004,17,2,148,1,60,0.0,32.0,32.0,1,88,0.0,60.0,60.0
0.072,6,10,1506,5,395,14.0,127.0,127.0,5,1111,14.0,843.0,843.0
10.712,17,28,4422,14,1994,815.0,269.0,114.0,14,2428,815.0,587.0,145.0
0.006,6,10,1547,5,764,1.0,496.0,496.0,5,783,1.0,515.0,515.0
0.006,17,2,166,1,75,0.0,47.0,47.0,1,91,0.0,63.0,63.0
0.097,6,10,1506,5,395,21.0,127.0,127.0,5,1111,20.0,843.0,843.0
0.092,6,10,1506,5,395,17.0,127.0,127.0,5,1111,18.0,843.0,843.0
0.004,6,10,1702,5,863,1.0,595.0,595.0,5,839,0.0,571.0,571.0
0.001,17,2,180,1,66,0.0,38.0,38.0,1,114,0.0,86.0,86.0
0.009,6,10,1605,5,388,2.0,120.0,120.0,5,1217,2.0,949.0,949.0
0.004,6,10,2006,5,927,1.0,659.0,659.0,5,1079,1.0,811.0,811.0
0.001,17,2,180,1,66,0.0,38.0,38.0,1,114,0.0,86.0,86.0
0.102,6,10,1506,5,395,22.0,127.0,127.0,5,1111,21.0,843.0,843.0
0.005,6,10,1689,5,839,1.0,571.0,571.0,5,850,1.0,582.0,582.0
0.221,6,16,2669,8,1395,31.0,533.0,323.0,8,1274,20.0,529.0,212.0
0.005,6,10,2007,5,928,1.0,660.0,660.0,5,1079,1.0,811.0,811.0
295.07,6,408,349404,210,22476,1411.0,2736.0,889.0,198,326928,1497.0,2804.0,1720.0
0.071,17,4,420,2,122,0.0,33.0,33.0,2,298,67.0,145.0,121.0
0.034,17,2,230,1,68,0.0,40.0,40.0,1,162,0.0,134.0,134.0
0.098,6,10,1506,5,395,19.0,127.0,127.0,5,1111,19.0,843.0,843.0
40.056,17,10,676,5,460,10012.0,104.0,64.0,5,216,10013.0,20.0,15.0
9.036,17,6,376,5,280,2259.0,28.0,28.0,1,96,0.0,68.0,68.0
0.004,17,2,136,1,60,0.0,32.0,32.0,1,76,0.0,48.0,48.0
0.1,6,10,1506,5,395,22.0,127.0,127.0,5,1111,23.0,843.0,843.0
0.005,17,2,193,1,71,0.0,43.0,43.0,1,122,0.0,94.0,94.0
0.009,6,10,1990,5,911,2.0,643.0,643.0,5,1079,2.0,811.0,811.0
0.003,17,2,185,1,73,0.0,45.0,45.0,1,112,0.0,84.0,84.0
0.004,6,10,2006,5,927,1.0,659.0,659.0,5,1079,1.0,811.0,811.0
0.004,6,10,2006,5,927,1.0,659.0,659.0,5,1079,1.0,811.0,811.0
0.001,17,2,180,1,66,0.0,38.0,38.0,1,114,0.0,86.0,86.0
0.005,6,10,1774,5,923,1.0,655.0,655.0,5,851,1.0,583.0,583.0
0.084,6,10,1506,5,395,18.0,127.0,127.0,5,1111,19.0,843.0,843.0
0.005,17,2,164,1,74,0.0,46.0,46.0,1,90,0.0,62.0,62.0
168.397,17,86,12466,43,2870,4009.0,44.0,38.0,43,9596,4009.0,260.0,195.0
0.005,17,2,146,1,65,0.0,37.0,37.0,1,81,0.0,53.0,53.0
40.085,17,10,676,5,460,10018.0,104.0,64.0,5,216,10020.0,20.0,15.0
0.012,6,10,1989,5,910,3.0,642.0,642.0,5,1079,3.0,811.0,811.0
0.22,6,16,2777,8,1395,31.0,533.0,323.0,8,1382,20.0,529.0,239.0
0.004,17,2,136,1,60,0.0,32.0,32.0,1,76,0.0,48.0,48.0
176.228,17,72,10113,36,2408,5034.0,44.0,38.0,36,7705,5035.0,261.0,186.0
0.018,6,10,1989,5,910,4.0,642.0,642.0,5,1079,4.0,811.0,811.0
0.038,17,2,152,1,76,0.0,48.0,48.0,1,76,0.0,48.0,48.0
0.013,6,10,1990,5,911,3.0,643.0,643.0,5,1079,3.0,811.0,811.0
0.011,6,13,3735,7,497,1.0,125.0,125.0,6,3238,2.0,1470.0,1459.0
40.054,17,10,676,5,460,10012.0,104.0,64.0,5,216,10012.0,20.0,15.0
0.004,6,10,2007,5,928,1.0,660.0,660.0,5,1079,1.0,811.0,811.0
0.003,17,2,148,1,60,0.0,32.0,32.0,1,88,0.0,60.0,60.0
0.005,6,14,3742,8,504,0.0,80.0,80.0,6,3238,0.0,1470.0,1459.0
0.012,6,10,1990,5,911,3.0,643.0,643.0,5,1079,2.0,811.0,811.0
0.032,6,10,1762,5,911,8.0,643.0,643.0,5,851,8.0,583.0,583.0
0.766,6,22,5168,11,1138,64.0,267.0,115.0,11,4030,64.0,1414.0,597.0
0.005,6,10,2006,5,927,1.0,659.0,659.0,5,1079,1.0,811.0,811.0
0.011,6,10,1989,5,910,2.0,642.0,642.0,5,1079,2.0,811.0,811.0
0.016,17,2,198,1,91,0.0,63.0,63.0,1,107,0.0,79.0,79.0
0.065,6,10,1506,5,395,14.0,127.0,127.0,5,1111,14.0,843.0,843.0
0.017,6,14,3787,7,497,2.0,125.0,125.0,7,3290,2.0,1448.0,972.0
0.01,6,10,1972,5,910,2.0,642.0,642.0,5,1062,2.0,794.0,794.0
15.074,17,14,9190,8,6902,2149.0,1350.0,834.0,6,2288,3008.0,1350.0,353.0
0.154,6,10,1506,5,395,34.0,127.0,127.0,5,1111,36.0,843.0,843.0
0.008,6,10,1989,5,910,2.0,642.0,642.0,5,1079,1.0,811.0,811.0
0.074,6,10,1506,5,395,14.0,127.0,127.0,5,1111,17.0,843.0,843.0
0.078,6,10,1506,5,395,18.0,127.0,127.0,5,1111,16.0,843.0,843.0
0.013,6,10,1989,5,910,3.0,642.0,642.0,5,1079,3.0,811.0,811.0
0.011,6,10,1989,5,910,2.0,642.0,642.0,5,1079,2.0,811.0,811.0
0.011,6,10,1990,5,911,2.0,643.0,643.0,5,1079,2.0,811.0,811.0
0.005,17,2,230,1,68,0.0,40.0,40.0,1,162,0.0,134.0,134.0
0.012,6,10,1762,5,911,3.0,643.0,643.0,5,851,2.0,583.0,583.0
0.012,6,10,1631,5,848,3.0,580.0,580.0,5,783,3.0,515.0,515.0
0.004,6,10,1702,5,863,0.0,595.0,595.0,5,839,1.0,571.0,571.0
412.255,6,29,4409,12,3102,10911.0,494.0,494.0,17,1307,25765.0,83.0,83.0
354.055,6,21,1795,16,1030,23603.0,190.0,190.0,5,765,60002.0,464.0,248.0
15.077,17,15,9238,8,6902,2149.0,1350.0,834.0,7,2336,2507.0,1350.0,305.0
0.005,6,10,2006,5,927,1.0,659.0,659.0,5,1079,1.0,811.0,811.0
0.006,6,10,2000,5,927,1.0,659.0,659.0,5,1073,1.0,805.0,805.0
0.005,6,10,1989,5,927,1.0,659.0,659.0,5,1062,1.0,794.0,794.0
0.003,17,2,148,1,60,0.0,32.0,32.0,1,88,0.0,60.0,60.0
0.04,17,4,284,2,120,1.0,32.0,32.0,2,164,35.0,60.0,54.0
0.005,6,10,2006,5,927,1.0,659.0,659.0,5,1079,1.0,811.0,811.0
0.093,6,10,1506,5,395,21.0,127.0,127.0,5,1111,20.0,843.0,843.0
40.072,17,10,676,5,460,10014.0,104.0,64.0,5,216,10017.0,20.0,15.0
0.162,17,2,152,1,76,0.0,48.0,48.0,1,76,0.0,48.0,48.0
0.014,6,13,3735,7,497,2.0,125.0,125.0,6,3238,2.0,1470.0,1459.0
0.01,6,10,1989,5,910,2.0,642.0,642.0,5,1079,2.0,811.0,811.0
0.084,6,10,1506,5,395,18.0,127.0,127.0,5,1111,18.0,843.0,843.0
0.01,6,10,1990,5,911,2.0,643.0,643.0,5,1079,2.0,811.0,811.0
0.005,17,2,166,1,75,0.0,47.0,47.0,1,91,0.0,63.0,63.0
0.005,6,13,3747,7,509,0.0,137.0,137.0,6,3238,0.0,1470.0,1459.0
240.021,6,9,787,5,488,60005.0,232.0,232.0,4,299,80006.0,83.0,83.0
0.001,17,2,180,1,66,0.0,38.0,38.0,1,114,0.0,86.0,86.0
0.017,6,10,1989,5,910,4.0,642.0,642.0,5,1079,4.0,811.0,811.0
0.005,6,10,2006,5,927,1.0,659.0,659.0,5,1079,1.0,811.0,811.0
0.005,6,13,3747,7,509,0.0,137.0,137.0,6,3238,1.0,1470.0,1459.0
0.001,17,2,136,1,60,0.0,32.0,32.0,1,76,0.0,48.0,48.0
0.005,17,2,166,1,75,0.0,47.0,47.0,1,91,0.0,63.0,63.0
0.012,6,10,1989,5,910,3.0,642.0,642.0,5,1079,2.0,811.0,811.0
0.084,6,10,1506,5,395,16.0,127.0,127.0,5,1111,18.0,843.0,843.0
0.013,6,10,1989,5,910,3.0,642.0,642.0,5,1079,3.0,811.0,811.0
0.013,6,10,1989,5,910,3.0,642.0,642.0,5,1079,3.0,811.0,811.0
0.001,17,2,166,1,75,0.0,47.0,47.0,1,91,0.0,63.0,63.0
0.013,6,10,1989,5,910,3.0,642.0,642.0,5,1079,3.0,811.0,811.0
0.006,6,10,1854,5,889,1.0,621.0,621.0,5,965,1.0,697.0,697.0
9.036,17,6,376,5,280,2259.0,28.0,28.0,1,96,0.0,68.0,68.0
0.063,6,10,1506,5,395,13.0,127.0,127.0,5,1111,14.0,843.0,843.0
40.068,17,10,676,5,460,10014.0,104.0,64.0,5,216,10016.0,20.0,15.0
0.005,6,10,2006,5,927,1.0,659.0,659.0,5,1079,1.0,811.0,811.0
0.005,6,10,1689,5,839,1.0,571.0,571.0,5,850,1.0,582.0,582.0
10.781,17,26,4103,13,1822,889.0,269.0,112.0,13,2281,889.0,588.0,147.0
0.013,6,10,1990,5,911,3.0,643.0,643.0,5,1079,3.0,811.0,811.0
0.117,6,10,1506,5,395,25.0,127.0,127.0,5,1111,23.0,843.0,843.0
0.005,17,2,154,1,69,0.0,41.0,41.0,1,85,0.0,57.0,57.0
0.001,17,2,180,1,66,0.0,38.0,38.0,1,114,0.0,86.0,86.0
0.005,17,2,166,1,75,0.0,47.0,47.0,1,91,0.0,63.0,63.0
0.009,6,10,1989,5,910,2.0,642.0,642.0,5,1079,2.0,811.0,811.0
0.005,6,10,1854,5,889,1.0,621.0,621.0,5,965,1.0,697.0,697.0
0.023,6,10,1989,5,910,5.0,642.0,642.0,5,1079,5.0,811.0,811.0
0.006,17,2,180,1,66,0.0,38.0,38.0,1,114,0.0,86.0,86.0
0.012,6,10,1983,5,910,2.0,642.0,642.0,5,1073,3.0,805.0,805.0
0.01,6,10,1702,5,863,2.0,595.0,595.0,5,839,2.0,571.0,571.0
42.826,6,36,8190,18,1719,516.0,651.0,322.0,18,6471,2511.0,2720.0,478.0
0.003,17,2,148,1,60,0.0,32.0,32.0,1,88,0.0,60.0,60.0
0.03,17,2,136,1,60,0.0,32.0,32.0,1,76,0.0,48.0,48.0
0.005,6,10,1989,5,927,1.0,659.0,659.0,5,1062,1.0,794.0,794.0
0.011,6,10,1677,5,827,2.0,559.0,559.0,5,850,2.0,582.0,582.0
0.011,6,10,1631,5,848,2.0,580.0,580.0,5,783,2.0,515.0,515.0
0.019,6,10,1972,5,910,4.0,642.0,642.0,5,1062,4.0,794.0,794.0
0.022,6,10,1983,5,910,5.0,642.0,642.0,5,1073,5.0,805.0,805.0
0.012,6,10,1983,5,910,2.0,642.0,642.0,5,1073,3.0,805.0,805.0
0.005,6,10,1989,5,927,1.0,659.0,659.0,5,1062,1.0,794.0,794.0
0.004,6,10,2006,5,927,1.0,659.0,659.0,5,1079,1.0,811.0,811.0
240.161,6,46,6826,22,3222,11436.0,588.0,230.0,24,3604,10441.0,580.0,213.0
0.011,6,10,1972,5,910,2.0,642.0,642.0,5,1062,2.0,794.0,794.0
175.419,17,68,9594,34,2257,5315.0,44.0,38.0,34,7337,5315.0,239.0,187.0
0.004,6,10,1779,5,928,1.0,660.0,660.0,5,851,1.0,583.0,583.0
0.053,17,2,152,1,76,0.0,48.0,48.0,1,76,0.0,48.0,48.0
0.006,6,10,1689,5,839,1.0,571.0,571.0,5,850,1.0,582.0,582.0
0.006,17,4,284,2,120,0.0,32.0,32.0,2,164,1.0,60.0,54.0
11.016,17,29,4565,15,2166,779.0,269.0,116.0,14,2399,839.0,586.0,143.0
0.01,6,13,3735,7,497,1.0,125.0,125.0,6,3238,1.0,1470.0,1459.0
0.005,6,10,1689,5,839,1.0,571.0,571.0,5,850,1.0,582.0,582.0
0.064,6,10,1506,5,395,14.0,127.0,127.0,5,1111,14.0,843.0,843.0
0.005,17,2,144,1,64,0.0,36.0,36.0,1,80,0.0,52.0,52.0
0.001,17,2,180,1,66,0.0,38.0,38.0,1,114,0.0,86.0,86.0
0.012,6,10,1972,5,910,2.0,642.0,642.0,5,1062,3.0,794.0,794.0
0.063,6,10,1506,5,395,13.0,127.0,127.0,5,1111,15.0,843.0,843.0
0.005,6,10,2007,5,928,1.0,660.0,660.0,5,1079,1.0,811.0,811.0
0.005,6,10,1989,5,927,1.0,659.0,659.0,5,1062,1.0,794.0,794.0
0.004,6,10,2000,5,927,1.0,659.0,659.0,5,1073,1.0,805.0,805.0
0.134,6,10,1506,5,395,31.0,127.0,127.0,5,1111,30.0,843.0,843.0
0.039,17,2,152,1,76,0.0,48.0,48.0,1,76,0.0,48.0,48.0
0.134,6,10,1506,5,395,28.0,127.0,127.0,5,1111,29.0,843.0,843.0
0.006,6,10,2007,5,928,1.0,660.0,660.0,5,1079,1.0,811.0,811.0
0.006,6,10,1547,5,764,1.0,496.0,496.0,5,783,1.0,515.0,515.0
240.079,6,16,4482,9,963,30009.0,238.0,166.0,7,3519,40012.0,1402.0,786.0
0.112,6,10,1506,5,395,24.0,127.0,127.0,5,1111,25.0,843.0,843.0
0.012,6,10,1631,5,848,3.0,580.0,580.0,5,783,3.0,515.0,515.0
40.056,17,10,676,5,460,10013.0,104.0,64.0,5,216,10013.0,20.0,15.0
0.007,17,2,179,1,71,0.0,43.0,43.0,1,108,0.0,80.0,80.0
0.01,17,4,284,2,120,0.0,32.0,32.0,2,164,0.0,60.0,54.0
0.111,6,10,1506,5,395,24.0,127.0,127.0,5,1111,26.0,843.0,843.0
240.087,6,16,4481,9,963,30010.0,238.0,166.0,7,3518,40013.0,1402.0,786.0
40.065,17,10,676,5,460,10015.0,104.0,64.0,5,216,10012.0,20.0,15.0
0.161,6,10,1506,5,395,37.0,127.0,127.0,5,1111,33.0,843.0,843.0
0.091,6,10,1506,5,395,21.0,127.0,127.0,5,1111,18.0,843.0,843.0
0.006,6,10,1547,5,764,1.0,496.0,496.0,5,783,1.0,515.0,515.0
0.006,17,2,166,1,75,0.0,47.0,47.0,1,91,0.0,63.0,63.0
0.012,6,10,1762,5,911,3.0,643.0,643.0,5,851,3.0,583.0,583.0
0.004,6,10,1702,5,863,1.0,595.0,595.0,5,839,0.0,571.0,571.0
0.004,17,4,284,2,120,0.0,32.0,32.0,2,164,0.0,60.0,54.0
0.024,6,10,1762,5,911,5.0,643.0,643.0,5,851,6.0,583.0,583.0
0.006,6,10,1547,5,764,1.0,496.0,496.0,5,783,1.0,515.0,515.0
0.006,6,10,1854,5,889,1.0,621.0,621.0,5,965,1.0,697.0,697.0
0.005,6,10,1989,5,927,1.0,659.0,659.0,5,1062,1.0,794.0,794.0
0.007,6,10,1854,5,889,1.0,621.0,621.0,5,965,1.0,697.0,697.0
0.001,17,2,152,1,62,0.0,34.0,34.0,1,90,0.0,62.0,62.0
0.031,6,10,1989,5,910,7.0,642.0,642.0,5,1079,7.0,811.0,811.0
0.011,6,13,3735,7,497,1.0,125.0,125.0,6,3238,2.0,1470.0,1459.0
0.004,6,10,2006,5,927,1.0,659.0,659.0,5,1079,1.0,811.0,811.0
0.007,6,10,1547,5,764,1.0,496.0,496.0,5,783,1.0,515.0,515.0
1778.306,17,140,44240,72,22752,25045.0,288.0,288.0,68,21488,26541.0,288.0,288.0
0.036,6,10,1605,5,388,9.0,120.0,120.0,5,1217,8.0,949.0,949.0
0.007,17,2,194,1,59,0.0,31.0,31.0,1,135,0.0,107.0,107.0
319.274,17,20,1124,10,716,35468.0,48.0,43.0,10,408,35468.0,20.0,12.0
0.006,6,10,1547,5,764,1.0,496.0,496.0,5,783,1.0,515.0,515.0
0.037,17,2,412,1,61,0.0,33.0,33.0,1,351,0.0,323.0,323.0
0.006,17,2,170,1,65,0.0,37.0,37.0,1,105,0.0,77.0,77.0
0.126,6,10,1506,5,395,30.0,127.0,127.0,5,1111,25.0,843.0,843.0
0.124,6,10,1506,5,395,28.0,127.0,127.0,5,1111,26.0,843.0,843.0
0.021,6,10,1990,5,911,5.0,643.0,643.0,5,1079,5.0,811.0,811.0
0.011,6,10,1677,5,827,2.0,559.0,559.0,5,850,2.0,582.0,582.0
0.004,17,4,284,2,120,1.0,32.0,32.0,2,164,1.0,60.0,54.0
0.207,6,16,2669,8,1395,29.0,533.0,323.0,8,1274,18.0,529.0,212.0
0.006,6,10,1643,5,860,1.0,592.0,592.0,5,783,1.0,515.0,515.0
0.108,6,10,1506,5,395,25.0,127.0,127.0,5,1111,23.0,843.0,843.0
0.008,17,2,169,1,62,0.0,34.0,34.0,1,107,0.0,79.0,79.0
0.071,6,10,1506,5,395,15.0,127.0,127.0,5,1111,16.0,843.0,843.0
0.005,6,10,2006,5,927,1.0,659.0,659.0,5,1079,1.0,811.0,811.0
240.106,6,31,9053,15,6687,17150.0,1810.0,656.0,16,2366,16006.0,580.0,190.0
0.246,6,10,1506,5,395,54.0,127.0,127.0,5,1111,60.0,843.0,843.0
0.005,6,10,2007,5,928,1.0,660.0,660.0,5,1079,1.0,811.0,811.0
0.014,6,10,1989,5,910,3.0,642.0,642.0,5,1079,3.0,811.0,811.0
0.098,6,10,1506,5,395,22.0,127.0,127.0,5,1111,23.0,843.0,843.0
0.005,6,10,1989,5,927,1.0,659.0,659.0,5,1062,1.0,794.0,794.0
0.005,17,2,140,1,62,0.0,34.0,34.0,1,78,0.0,50.0,50.0
0.108,6,10,1506,5,395,23.0,127.0,127.0,5,1111,21.0,843.0,843.0
0.076,6,10,1506,5,395,17.0,127.0,127.0,5,1111,18.0,843.0,843.0
0.127,6,10,1506,5,395,28.0,127.0,127.0,5,1111,27.0,843.0,843.0
0.005,6,10,1774,5,923,1.0,655.0,655.0,5,851,1.0,583.0,583.0
0.11,6,10,1506,5,395,25.0,127.0,127.0,5,1111,25.0,843.0,843.0
240.279,6,32,9438,16,7186,16018.0,1515.0,635.0,16,2252,16018.0,580.0,176.0
240.012,6,9,787,5,488,60003.0,232.0,232.0,4,299,80003.0,83.0,83.0
40.043,17,10,676,5,460,10009.0,104.0,64.0,5,216,10010.0,20.0,15.0
0.003,17,2,148,1,60,0.0,32.0,32.0,1,88,0.0,60.0,60.0
0.003,17,2,170,1,65,0.0,37.0,37.0,1,105,0.0,77.0,77.0
0.007,6,10,2006,5,927,1.0,659.0,659.0,5,1079,1.0,811.0,811.0
0.006,17,2,179,1,71,0.0,43.0,43.0,1,108,0.0,80.0,80.0
0.005,6,10,2006,5,927,1.0,659.0,659.0,5,1079,1.0,811.0,811.0
0.018,6,10,1989,5,910,4.0,642.0,642.0,5,1079,4.0,811.0,811.0
0.004,17,2,148,1,60,0.0,32.0,32.0,1,88,0.0,60.0,60.0
0.065,17,8,3613,4,1874,21.0,1350.0,440.0,4,1739,11.0,1350.0,406.0
0.08,6,10,1506,5,395,18.0,127.0,127.0,5,1111,18.0,843.0,843.0
0.005,6,10,2006,5,927,1.0,659.0,659.0,5,1079,1.0,811.0,811.0
0.076,6,10,1506,5,395,17.0,127.0,127.0,5,1111,18.0,843.0,843.0
0.04,17,4,284,2,120,0.0,32.0,32.0,2,164,37.0,60.0,54.0
0.287,17,39,20228,22,17094,13.0,1350.0,749.0,17,3134,13.0,1350.0,156.0
56.55,58,5,360,4,288,18850.0,24.0,24.0,1,72,0.0,24.0,24.0
0.004,6,10,1779,5,928,1.0,660.0,660.0,5,851,1.0,583.0,583.0
0.001,17,2,180,1,66,0.0,38.0,38.0,1,114,0.0,86.0,86.0
300.344,6,16,2170,9,684,37523.0,146.0,146.0,7,1486,50030.0,419.0,398.0
40.092,17,10,676,5,460,10013.0,104.0,64.0,5,216,10009.0,20.0,15.0
0.084,6,10,1506,5,395,16.0,127.0,127.0,5,1111,19.0,843.0,843.0
0.079,6,10,1506,5,395,17.0,127.0,127.0,5,1111,17.0,843.0,843.0
0.006,6,10,1689,5,839,1.0,571.0,571.0,5,850,1.0,582.0,582.0
11.037,17,28,4392,14,2313,840.0,588.0,137.0,14,2079,840.0,270.0,120.0
0.002,17,2,140,1,62,0.0,34.0,34.0,1,78,0.0,50.0,50.0
0.012,6,10,1990,5,911,2.0,643.0,643.0,5,1079,3.0,811.0,811.0
0.004,6,10,2000,5,927,1.0,659.0,659.0,5,1073,1.0,805.0,805.0
377.386,6,22,2313,16,867,25159.0,195.0,195.0,6,1446,4644.0,419.0,398.0
259.493,6,39,9738,16,6610,17299.0,1681.0,642.0,23,3128,11795.0,580.0,137.0
0.01,6,10,1989,5,910,2.0,642.0,642.0,5,1079,2.0,811.0,811.0
0.012,6,10,1631,5,848,3.0,580.0,580.0,5,783,3.0,515.0,515.0
0.02,6,10,1990,5,911,5.0,643.0,643.0,5,1079,5.0,811.0,811.0
0.004,6,10,1702,5,863,1.0,595.0,595.0,5,839,0.0,571.0,571.0
0.005,6,13,3747,7,509,0.0,137.0,137.0,6,3238,0.0,1470.0,1459.0
0.115,6,10,1506,5,395,25.0,127.0,127.0,5,1111,24.0,843.0,843.0
0.009,6,10,1972,5,910,2.0,642.0,642.0,5,1062,2.0,794.0,794.0
0.005,6,10,2006,5,927,1.0,659.0,659.0,5,1079,1.0,811.0,811.0
0.007,6,10,1547,5,764,1.0,496.0,496.0,5,783,1.0,515.0,515.0
0.004,6,10,1779,5,928,1.0,660.0,660.0,5,851,1.0,583.0,583.0
0.005,6,14,3742,8,504,0.0,80.0,80.0,6,3238,0.0,1470.0,1459.0
0.006,6,10,1689,5,839,1.0,571.0,571.0,5,850,1.0,582.0,582.0
0.01,6,10,1972,5,910,2.0,642.0,642.0,5,1062,2.0,794.0,794.0
0.004,17,2,136,1,60,0.0,32.0,32.0,1,76,0.0,48.0,48.0
0.004,6,10,2006,5,927,1.0,659.0,659.0,5,1079,1.0,811.0,811.0
0.104,6,10,1506,5,395,20.0,127.0,127.0,5,1111,21.0,843.0,843.0
0.075,6,10,1506,5,395,16.0,127.0,127.0,5,1111,17.0,843.0,843.0
0.005,6,10,2007,5,928,1.0,660.0,660.0,5,1079,1.0,811.0,811.0
66.174,6,29,17654,17,9706,4135.0,1444.0,1101.0,12,7948,6001.0,2319.0,1219.0
0.25,17,37,20033,21,17044,12.0,1350.0,783.0,16,2989,12.0,1350.0,158.0
780.41,6,36,7646,23,6132,35473.0,494.0,494.0,13,1514,65033.0,83.0,83.0
308.702,17,20,1124,10,716,34286.0,48.0,43.0,10,408,34285.0,20.0,12.0
0.01,6,10,1989,5,910,2.0,642.0,642.0,5,1079,2.0,811.0,811.0
0.087,6,10,1506,5,395,19.0,127.0,127.0,5,1111,19.0,843.0,843.0
0.083,6,10,1506,5,395,17.0,127.0,127.0,5,1111,19.0,843.0,843.0
0.005,6,10,2006,5,927,1.0,659.0,659.0,5,1079,1.0,811.0,811.0
0.019,6,10,1990,5,911,4.0,643.0,643.0,5,1079,4.0,811.0,811.0
0.099,6,10,1506,5,395,22.0,127.0,127.0,5,1111,22.0,843.0,843.0
240.017,6,9,787,5,488,60004.0,232.0,232.0,4,299,80003.0,83.0,83.0
40.062,17,10,676,5,460,10014.0,104.0,64.0,5,216,10014.0,20.0,15.0
0.001,17,2,136,1,60,0.0,32.0,32.0,1,76,0.0,48.0,48.0
40.078,17,10,676,5,460,10016.0,104.0,64.0,5,216,10018.0,20.0,15.0
0.008,6,10,1989,5,910,2.0,642.0,642.0,5,1079,2.0,811.0,811.0
0.071,17,2,148,1,60,0.0,32.0,32.0,1,88,0.0,60.0,60.0
0.017,6,10,1990,5,911,4.0,643.0,643.0,5,1079,4.0,811.0,811.0
0.006,17,2,255,1,82,0.0,54.0,54.0,1,173,0.0,145.0,145.0
0.005,17,2,170,1,65,0.0,37.0,37.0,1,105,0.0,77.0,77.0
0.01,6,10,1972,5,910,2.0,642.0,642.0,5,1062,2.0,794.0,794.0
0.009,6,10,1989,5,910,2.0,642.0,642.0,5,1079,2.0,811.0,811.0
0.004,6,10,2006,5,927,1.0,659.0,659.0,5,1079,1.0,811.0,811.0
0.016,6,10,1972,5,910,3.0,642.0,642.0,5,1062,4.0,794.0,794.0
15.069,17,14,9190,8,6902,2148.0,1350.0,834.0,6,2288,3008.0,1350.0,353.0
0.005,17,2,166,1,75,0.0,47.0,47.0,1,91,0.0,63.0,63.0
0.02,6,10,1631,5,848,5.0,580.0,580.0,5,783,4.0,515.0,515.0
40.083,17,10,676,5,460,10017.0,104.0,64.0,5,216,10019.0,20.0,15.0
0.012,6,10,1677,5,827,3.0,559.0,559.0,5,850,2.0,582.0,582.0
0.119,6,28,10480,15,8942,8.0,2883.0,1166.0,13,1538,9.0,373.0,143.0
0.117,17,2,179,1,71,0.0,43.0,43.0,1,108,0.0,80.0,80.0
40.067,17,10,676,5,460,10013.0,104.0,64.0,5,216,10016.0,20.0,15.0
0.019,6,10,1631,5,848,4.0,580.0,580.0,5,783,4.0,515.0,515.0
0.04,17,2,396,1,61,0.0,33.0,33.0,1,335,0.0,307.0,307.0
0.017,6,10,1989,5,910,4.0,642.0,642.0,5,1079,4.0,811.0,811.0
0.005,6,10,1989,5,927,1.0,659.0,659.0,5,1062,1.0,794.0,794.0
0.103,6,10,1506,5,395,21.0,127.0,127.0,5,1111,20.0,843.0,843.0
0.005,6,13,3747,7,509,0.0,137.0,137.0,6,3238,1.0,1470.0,1459.0
0.005,6,10,2000,5,927,1.0,659.0,659.0,5,1073,1.0,805.0,805.0
0.006,6,10,2007,5,928,1.0,660.0,660.0,5,1079,1.0,811.0,811.0
0.124,6,10,1506,5,395,27.0,127.0,127.0,5,1111,29.0,843.0,843.0
0.014,6,10,1677,5,827,3.0,559.0,559.0,5,850,3.0,582.0,582.0
0.015,6,10,1762,5,911,3.0,643.0,643.0,5,851,3.0,583.0,583.0
0.094,6,10,1506,5,395,22.0,127.0,127.0,5,1111,20.0,843.0,843.0
0.004,6,10,2007,5,928,1.0,660.0,660.0,5,1079,1.0,811.0,811.0
0.004,6,10,2006,5,927,1.0,659.0,659.0,5,1079,1.0,811.0,811.0
0.013,6,10,1989,5,910,3.0,642.0,642.0,5,1079,3.0,811.0,811.0
0.005,6,10,2006,5,927,1.0,659.0,659.0,5,1079,1.0,811.0,811.0
0.011,6,10,1989,5,910,2.0,642.0,642.0,5,1079,2.0,811.0,811.0
0.006,17,2,214,1,75,0.0,47.0,47.0,1,139,0.0,111.0,111.0
0.004,6,10,1702,5,863,1.0,595.0,595.0,5,839,0.0,571.0,571.0
0.005,6,10,2006,5,927,1.0,659.0,659.0,5,1079,1.0,811.0,811.0
0.004,17,2,164,1,74,0.0,46.0,46.0,1,90,0.0,62.0,62.0
0.005,17,2,214,1,75,0.0,47.0,47.0,1,139,0.0,111.0,111.0
0.001,17,2,132,1,58,0.0,30.0,30.0,1,74,0.0,46.0,46.0
0.009,6,10,1989,5,910,2.0,642.0,642.0,5,1079,2.0,811.0,811.0
0.07,6,10,1506,5,395,16.0,127.0,127.0,5,1111,15.0,843.0,843.0
0.005,17,2,170,1,65,0.0,37.0,37.0,1,105,0.0,77.0,77.0
0.015,6,10,1989,5,910,3.0,642.0,642.0,5,1079,3.0,811.0,811.0
308.638,17,20,1124,10,716,34278.0,48.0,43.0,10,408,34278.0,20.0,12.0
0.174,17,2,152,1,76,0.0,48.0,48.0,1,76,0.0,48.0,48.0
0.013,6,10,1990,5,911,3.0,643.0,643.0,5,1079,3.0,811.0,811.0
0.705,6,26,5499,13,1597,49.0,325.0,152.0,13,3902,49.0,1414.0,563.0
0.004,17,2,136,1,60,0.0,32.0,32.0,1,76,0.0,48.0,48.0
0.004,6,10,2000,5,927,1.0,659.0,659.0,5,1073,1.0,805.0,805.0
0.142,6,10,1506,5,395,27.0,127.0,127.0,5,1111,31.0,843.0,843.0
0.005,6,10,2006,5,927,1.0,659.0,659.0,5,1079,1.0,811.0,811.0
0.006,6,10,2006,5,927,1.0,659.0,659.0,5,1079,1.0,811.0,811.0
0.004,6,10,2000,5,927,1.0,659.0,659.0,5,1073,1.0,805.0,805.0
0.004,6,10,1774,5,923,1.0,655.0,655.0,5,851,1.0,583.0,583.0
0.008,6,10,1989,5,910,1.0,642.0,642.0,5,1079,2.0,811.0,811.0
40.054,17,10,676,5,460,10012.0,104.0,64.0,5,216,10012.0,20.0,15.0
240.081,6,16,4481,9,963,30010.0,238.0,166.0,7,3518,40013.0,1402.0,786.0
0.005,6,10,1989,5,927,1.0,659.0,659.0,5,1062,1.0,794.0,794.0
0.078,6,10,1506,5,395,17.0,127.0,127.0,5,1111,19.0,843.0,843.0
0.087,6,10,1506,5,395,19.0,127.0,127.0,5,1111,17.0,843.0,843.0
66.541,6,22,10140,12,3973,6049.0,1579.0,835.0,10,6167,7375.0,2111.0,939.0
0.005,6,10,2007,5,928,1.0,660.0,660.0,5,1079,1.0,811.0,811.0
308.634,17,20,1124,10,716,34278.0,48.0,43.0,10,408,34278.0,20.0,12.0
0.005,17,2,170,1,65,0.0,37.0,37.0,1,105,0.0,77.0,77.0
0.004,17,2,166,1,75,0.0,47.0,47.0,1,91,0.0,63.0,63.0
0.006,6,10,1547,5,764,1.0,496.0,496.0,5,783,1.0,515.0,515.0
0.094,6,10,1506,5,395,21.0,127.0,127.0,5,1111,16.0,843.0,843.0
0.004,17,2,148,1,60,0.0,32.0,32.0,1,88,0.0,60.0,60.0
0.011,6,10,1983,5,910,2.0,642.0,642.0,5,1073,2.0,805.0,805.0
0.012,6,10,1989,5,910,3.0,642.0,642.0,5,1079,2.0,811.0,811.0
1.346,6,31,13279,18,5880,79.0,2720.0,854.0,13,7399,97.0,2720.0,858.0
0.006,6,10,1689,5,839,1.0,571.0,571.0,5,850,1.0,582.0,582.0
0.006,6,10,1643,5,860,1.0,592.0,592.0,5,783,1.0,515.0,515.0
0.001,17,2,180,1,66,0.0,38.0,38.0,1,114,0.0,86.0,86.0
0.005,6,10,2000,5,927,1.0,659.0,659.0,5,1073,1.0,805.0,805.0
0.01,6,10,1989,5,910,2.0,642.0,642.0,5,1079,2.0,811.0,811.0
0.004,17,4,284,2,120,1.0,32.0,32.0,2,164,0.0,60.0,54.0
0.005,6,10,2006,5,927,1.0,659.0,659.0,5,1079,1.0,811.0,811.0
0.014,6,10,1983,5,910,3.0,642.0,642.0,5,1073,3.0,805.0,805.0
0.016,6,10,1983,5,910,4.0,642.0,642.0,5,1073,4.0,805.0,805.0
0.003,17,2,148,1,60,0.0,32.0,32.0,1,88,0.0,60.0,60.0
0.013,6,10,1631,5,848,3.0,580.0,580.0,5,783,3.0,515.0,515.0
1755.984,6,106,6322,60,3525,29761.0,27.0,27.0,46,2797,39021.0,27.0,27.0
0.114,6,10,1506,5,395,23.0,127.0,127.0,5,1111,27.0,843.0,843.0
0.003,17,2,148,1,60,0.0,32.0,32.0,1,88,0.0,60.0,60.0
0.082,6,10,1506,5,395,20.0,127.0,127.0,5,1111,17.0,843.0,843.0
0.011,6,10,1972,5,910,2.0,642.0,642.0,5,1062,2.0,794.0,794.0
0.001,17,2,180,1,66,0.0,38.0,38.0,1,114,0.0,86.0,86.0
0.006,6,10,1547,5,764,1.0,496.0,496.0,5,783,1.0,515.0,515.0
0.105,6,10,1506,5,395,26.0,127.0,127.0,5,1111,21.0,843.0,843.0
0.005,17,2,170,1,65,0.0,37.0,37.0,1,105,0.0,77.0,77.0
0.053,17,2,152,1,76,0.0,48.0,48.0,1,76,0.0,48.0,48.0
0.005,6,14,3742,7,452,0.0,80.0,80.0,7,3290,0.0,1448.0,972.0
0.054,6,10,1972,5,910,13.0,642.0,642.0,5,1062,13.0,794.0,794.0
0.019,6,10,1989,5,910,4.0,642.0,642.0,5,1079,4.0,811.0,811.0
0.037,17,2,136,1,60,0.0,32.0,32.0,1,76,0.0,48.0,48.0
0.003,17,2,136,1,60,0.0,32.0,32.0,1,76,0.0,48.0,48.0
0.004,17,4,284,2,120,0.0,32.0,32.0,2,164,0.0,60.0,54.0
0.005,6,10,2000,5,927,1.0,659.0,659.0,5,1073,1.0,805.0,805.0
0.005,6,10,2006,5,927,1.0,659.0,659.0,5,1079,1.0,811.0,811.0
0.006,6,10,2006,5,927,1.0,659.0,659.0,5,1079,1.0,811.0,811.0
0.005,6,10,2007,5,928,1.0,660.0,660.0,5,1079,1.0,811.0,811.0
0.041,17,4,284,2,120,0.0,32.0,32.0,2,164,38.0,60.0,54.0
1792.693,6,483,98653,242,87423,7438.0,421.0,368.0,241,11230,7469.0,53.0,53.0
0.001,17,2,180,1,66,0.0,38.0,38.0,1,114,0.0,86.0,86.0
0.006,17,2,144,1,64,0.0,36.0,36.0,1,80,0.0,52.0,52.0
0.005,17,2,179,1,71,0.0,43.0,43.0,1,108,0.0,80.0,80.0
0.065,6,10,1506,5,395,13.0,127.0,127.0,5,1111,13.0,843.0,843.0
0.003,17,4,284,2,120,0.0,32.0,32.0,2,164,0.0,60.0,54.0
0.066,17,8,3613,4,1874,22.0,1350.0,440.0,4,1739,11.0,1350.0,406.0
0.051,17,4,352,2,130,11.0,37.0,37.0,2,222,47.0,89.0,83.0
0.065,6,10,1506,5,395,14.0,127.0,127.0,5,1111,15.0,843.0,843.0
0.011,6,10,1989,5,910,2.0,642.0,642.0,5,1079,2.0,811.0,811.0
0.003,17,4,284,2,120,0.0,32.0,32.0,2,164,0.0,60.0,54.0
0.009,6,10,1989,5,910,2.0,642.0,642.0,5,1079,2.0,811.0,811.0
0.01,6,10,1989,5,910,2.0,642.0,642.0,5,1079,2.0,811.0,811.0
411.994,6,29,4409,12,3102,10911.0,494.0,494.0,17,1307,25749.0,83.0,83.0
1786.134,6,154,19574,92,13852,19627.0,302.0,302.0,62,5722,29280.0,83.0,83.0
0.006,6,10,1547,5,764,1.0,496.0,496.0,5,783,1.0,515.0,515.0
0.01,6,10,1972,5,910,2.0,642.0,642.0,5,1062,2.0,794.0,794.0
0.221,17,15,8429,8,6019,31.0,1350.0,724.0,7,2410,24.0,1350.0,316.0
0.01,6,10,1990,5,911,2.0,643.0,643.0,5,1079,2.0,811.0,811.0
0.112,6,10,1506,5,395,24.0,127.0,127.0,5,1111,27.0,843.0,843.0
0.001,17,2,136,1,60,0.0,32.0,32.0,1,76,0.0,48.0,48.0
0.005,6,13,3747,7,509,0.0,137.0,137.0,6,3238,0.0,1470.0,1459.0
0.006,6,10,1547,5,764,1.0,496.0,496.0,5,783,1.0,515.0,515.0
0.013,6,10,1989,5,910,3.0,642.0,642.0,5,1079,3.0,811.0,811.0
0.011,6,10,1762,5,911,2.0,643.0,643.0,5,851,2.0,583.0,583.0
0.006,6,10,1547,5,764,1.0,496.0,496.0,5,783,1.0,515.0,515.0
0.127,6,10,1506,5,395,30.0,127.0,127.0,5,1111,22.0,843.0,843.0
0.011,6,10,1972,5,910,2.0,642.0,642.0,5,1062,2.0,794.0,794.0
0.011,6,10,1983,5,910,2.0,642.0,642.0,5,1073,2.0,805.0,805.0
0.013,17,2,140,1,62,0.0,34.0,34.0,1,78,0.0,50.0,50.0
0.037,17,2,170,1,65,0.0,37.0,37.0,1,105,0.0,77.0,77.0
0.005,17,2,214,1,75,0.0,47.0,47.0,1,139,0.0,111.0,111.0
240.013,6,9,787,5,488,60003.0,232.0,232.0,4,299,80003.0,83.0,83.0
0.003,17,4,284,2,120,0.0,32.0,32.0,2,164,0.0,60.0,54.0
0.012,6,10,1989,5,910,3.0,642.0,642.0,5,1079,2.0,811.0,811.0
0.004,17,2,136,1,60,0.0,32.0,32.0,1,76,0.0,48.0,48.0
0.214,6,16,2782,8,1400,30.0,533.0,325.0,8,1382,19.0,529.0,239.0
0.005,17,2,166,1,75,0.0,47.0,47.0,1,91,0.0,63.0,63.0
0.004,6,10,1989,5,927,1.0,659.0,659.0,5,1062,1.0,794.0,794.0
0.02,6,10,1631,5,848,5.0,580.0,580.0,5,783,4.0,515.0,515.0
15.076,17,15,9238,8,6902,2149.0,1350.0,834.0,7,2336,2507.0,1350.0,305.0
0.109,6,10,1506,5,395,24.0,127.0,127.0,5,1111,21.0,843.0,843.0
0.089,6,10,1506,5,395,20.0,127.0,127.0,5,1111,21.0,843.0,843.0
0.005,6,10,1989,5,927,1.0,659.0,659.0,5,1062,1.0,794.0,794.0
297.238,6,316,344806,125,18051,2397.0,2736.0,825.0,191,326755,1564.0,2804.0,1789.0
0.013,6,10,1989,5,910,3.0,642.0,642.0,5,1079,3.0,811.0,811.0
0.004,6,10,1774,5,923,0.0,655.0,655.0,5,851,1.0,583.0,583.0
0.005,6,10,2007,5,928,1.0,660.0,660.0,5,1079,1.0,811.0,811.0
0.003,17,2,136,1,60,0.0,32.0,32.0,1,76,0.0,48.0,48.0
0.006,6,10,1547,5,764,1.0,496.0,496.0,5,783,1.0,515.0,515.0
0.021,17,2,148,1,60,0.0,32.0,32.0,1,88,0.0,60.0,60.0
300.318,6,16,2170,9,684,37518.0,146.0,146.0,7,1486,50024.0,419.0,398.0
0.01,6,10,1989,5,910,2.0,642.0,642.0,5,1079,2.0,811.0,811.0
0.004,17,4,284,2,120,0.0,32.0,32.0,2,164,0.0,60.0,54.0
0.005,6,10,2000,5,927,1.0,659.0,659.0,5,1073,1.0,805.0,805.0
9.037,17,6,376,5,280,2259.0,28.0,28.0,1,96,0.0,68.0,68.0
0.014,17,2,179,1,71,0.0,43.0,43.0,1,108,0.0,80.0,80.0
0.005,6,10,2006,5,927,1.0,659.0,659.0,5,1079,1.0,811.0,811.0
0.04,17,2,182,1,65,0.0,37.0,37.0,1,117,0.0,89.0,89.0
0.012,6,10,1989,5,910,2.0,642.0,642.0,5,1079,2.0,811.0,811.0
0.074,6,10,1506,5,395,17.0,127.0,127.0,5,1111,15.0,843.0,843.0
0.003,17,2,148,1,60,0.0,32.0,32.0,1,88,0.0,60.0,60.0
0.006,6,10,1989,5,927,1.0,659.0,659.0,5,1062,1.0,794.0,794.0
1.156,6,31,13352,18,5893,68.0,2720.0,854.0,13,7459,81.0,2720.0,769.0
0.008,6,10,1989,5,910,2.0,642.0,642.0,5,1079,2.0,811.0,811.0
0.101,6,10,1506,5,395,23.0,127.0,127.0,5,1111,24.0,843.0,843.0
0.005,6,14,3799,7,509,0.0,137.0,137.0,7,3290,0.0,1448.0,972.0
0.011,6,10,1983,5,910,2.0,642.0,642.0,5,1073,2.0,805.0,805.0
0.006,6,10,1689,5,839,1.0,571.0,571.0,5,850,1.0,582.0,582.0
15.071,17,15,9239,8,6902,2149.0,1350.0,834.0,7,2337,2506.0,1350.0,305.0
0.004,17,2,136,1,60,0.0,32.0,32.0,1,76,0.0,48.0,48.0
0.005,6,10,2006,5,927,1.0,659.0,659.0,5,1079,1.0,811.0,811.0
0.01,6,13,3735,7,497,1.0,125.0,125.0,6,3238,1.0,1470.0,1459.0
0.005,6,10,2000,5,927,1.0,659.0,659.0,5,1073,1.0,805.0,805.0
0.001,17,2,180,1,66,0.0,38.0,38.0,1,114,0.0,86.0,86.0
0.0,17,2,180,1,66,0.0,38.0,38.0,1,114,0.0,86.0,86.0
0.006,17,2,170,1,65,0.0,37.0,37.0,1,105,0.0,77.0,77.0
40.063,17,10,676,5,460,10012.0,104.0,64.0,5,216,10014.0,20.0,15.0
0.005,17,2,166,1,75,0.0,47.0,47.0,1,91,0.0,63.0,63.0
1770.776,6,135,6510,75,3585,23929.0,39.0,39.0,60,2925,30009.0,35.0,35.0
0.101,6,10,1506,5,395,22.0,127.0,127.0,5,1111,21.0,843.0,843.0
0.04,17,2,152,1,76,0.0,48.0,48.0,1,76,0.0,48.0,48.0
40.078,17,10,676,5,460,10017.0,104.0,64.0,5,216,10018.0,20.0,15.0
0.01,6,10,1677,5,827,2.0,559.0,559.0,5,850,2.0,582.0,582.0
240.113,6,16,4480,9,963,30014.0,238.0,166.0,7,3517,40018.0,1402.0,786.0
40.062,17,10,676,5,460,10014.0,104.0,64.0,5,216,10010.0,20.0,15.0
40.066,17,10,676,5,460,10012.0,104.0,64.0,5,216,10015.0,20.0,15.0
0.005,6,10,1989,5,927,1.0,659.0,659.0,5,1062,1.0,794.0,794.0
0.012,6,10,1972,5,910,2.0,642.0,642.0,5,1062,3.0,794.0,794.0
0.049,17,2,138,1,61,0.0,33.0,33.0,1,77,0.0,49.0,49.0
0.219,6,16,2674,8,1400,31.0,533.0,325.0,8,1274,19.0,529.0,212.0
0.001,17,2,180,1,66,0.0,38.0,38.0,1,114,0.0,86.0,86.0
0.003,17,2,148,1,60,0.0,32.0,32.0,1,88,0.0,60.0,60.0
240.098,6,16,4480,9,963,30012.0,238.0,166.0,7,3517,40015.0,1402.0,786.0
300.1,6,19,4659,11,1102,30009.0,238.0,130.0,8,3557,42870.0,1402.0,786.0
0.104,6,10,1506,5,395,19.0,127.0,127.0,5,1111,24.0,843.0,843.0
0.001,17,2,180,1,66,0.0,38.0,38.0,1,114,0.0,86.0,86.0
0.01,6,6,716,3,458,4.0,302.0,302.0,3,258,3.0,102.0,102.0
0.095,6,10,1506,5,395,22.0,127.0,127.0,5,1111,19.0,843.0,843.0
0.005,6,10,2006,5,927,1.0,659.0,659.0,5,1079,1.0,811.0,811.0
0.01,6,10,1990,5,911,2.0,643.0,643.0,5,1079,2.0,811.0,811.0
0.01,6,10,1972,5,910,2.0,642.0,642.0,5,1062,2.0,794.0,794.0
0.015,6,10,1989,5,910,3.0,642.0,642.0,5,1079,3.0,811.0,811.0
0.009,6,10,1983,5,910,2.0,642.0,642.0,5,1073,2.0,805.0,805.0
0.079,6,10,1506,5,395,18.0,127.0,127.0,5,1111,15.0,843.0,843.0
0.004,17,2,166,1,75,0.0,47.0,47.0,1,91,0.0,63.0,63.0
0.101,6,10,1506,5,395,22.0,127.0,127.0,5,1111,23.0,843.0,843.0
0.132,6,10,1506,5,395,31.0,127.0,127.0,5,1111,30.0,843.0,843.0
0.006,6,10,1643,5,860,1.0,592.0,592.0,5,783,1.0,515.0,515.0
0.134,17,4,284,2,120,0.0,32.0,32.0,2,164,125.0,60.0,54.0
165.039,17,78,10951,39,2600,4343.0,44.0,38.0,39,8351,4343.0,239.0,186.0
0.006,6,10,2007,5,928,1.0,660.0,660.0,5,1079,1.0,811.0,811.0
0.005,6,10,2006,5,927,1.0,659.0,659.0,5,1079,1.0,811.0,811.0
10.96,17,28,4423,14,1994,832.0,269.0,114.0,14,2429,832.0,588.0,145.0
0.017,6,10,1983,5,910,4.0,642.0,642.0,5,1073,4.0,805.0,805.0
0.005,6,10,2007,5,928,1.0,660.0,660.0,5,1079,1.0,811.0,811.0
40.055,17,10,676,5,460,10013.0,104.0,64.0,5,216,10013.0,20.0,15.0
354.01,6,19,1690,15,978,25286.0,190.0,190.0,4,712,80003.0,496.0,496.0
0.095,6,10,1506,5,395,21.0,127.0,127.0,5,1111,21.0,843.0,843.0
1770.388,6,84,4495,42,2238,43179.0,27.0,27.0,42,2257,43179.0,26.0,24.0
0.005,6,10,2007,5,928,1.0,660.0,660.0,5,1079,1.0,811.0,811.0
0.01,6,10,1983,5,910,2.0,642.0,642.0,5,1073,2.0,805.0,805.0
0.005,6,10,2006,5,927,1.0,659.0,659.0,5,1079,1.0,811.0,811.0
0.017,6,10,1990,5,911,4.0,643.0,643.0,5,1079,4.0,811.0,811.0
0.002,17,2,136,1,60,0.0,32.0,32.0,1,76,0.0,48.0,48.0
0.001,17,2,166,1,75,0.0,47.0,47.0,1,91,0.0,63.0,63.0
0.006,17,2,170,1,65,0.0,37.0,37.0,1,105,0.0,77.0,77.0
0.005,6,13,3747,7,509,0.0,137.0,137.0,6,3238,1.0,1470.0,1459.0
0.012,6,14,3787,7,497,2.0,125.0,125.0,7,3290,2.0,1448.0,972.0
0.005,6,13,3747,7,509,0.0,137.0,137.0,6,3238,1.0,1470.0,1459.0
0.011,6,10,1989,5,910,2.0,642.0,642.0,5,1079,2.0,811.0,811.0
0.004,6,10,2000,5,927,1.0,659.0,659.0,5,1073,1.0,805.0,805.0
0.015,6,10,1972,5,910,3.0,642.0,642.0,5,1062,3.0,794.0,794.0
1730.414,6,45,2790,30,1725,59669.0,35.0,35.0,15,1065,123596.0,31.0,31.0
0.013,6,13,3735,7,497,2.0,125.0,125.0,6,3238,2.0,1470.0,1459.0
0.005,17,2,180,1,66,0.0,38.0,38.0,1,114,0.0,86.0,86.0
0.005,6,10,1774,5,923,1.0,655.0,655.0,5,851,1.0,583.0,583.0
0.023,6,13,3735,7,497,3.0,125.0,125.0,6,3238,4.0,1470.0,1459.0
0.019,6,10,1631,5,848,4.0,580.0,580.0,5,783,4.0,515.0,515.0
0.005,6,10,2006,5,927,1.0,659.0,659.0,5,1079,1.0,811.0,811.0
40.061,17,10,676,5,460,10014.0,104.0,64.0,5,216,10014.0,20.0,15.0
0.081,6,10,1506,5,395,17.0,127.0,127.0,5,1111,16.0,843.0,843.0
308.312,17,20,1124,10,716,34243.0,48.0,43.0,10,408,34243.0,20.0,12.0
0.006,6,10,1547,5,764,1.0,496.0,496.0,5,783,1.0,515.0,515.0
0.008,6,10,1989,5,910,2.0,642.0,642.0,5,1079,2.0,811.0,811.0
0.006,6,10,1989,5,927,1.0,659.0,659.0,5,1062,1.0,794.0,794.0
178.036,17,80,11105,40,2664,4564.0,44.0,38.0,40,8441,4564.0,239.0,183.0
0.015,6,10,1631,5,848,3.0,580.0,580.0,5,783,3.0,515.0,515.0
0.094,6,10,1506,5,395,20.0,127.0,127.0,5,1111,21.0,843.0,843.0
0.106,6,10,1506,5,395,24.0,127.0,127.0,5,1111,21.0,843.0,843.0
0.004,6,10,2007,5,928,1.0,660.0,660.0,5,1079,1.0,811.0,811.0
0.072,6,10,1506,5,395,16.0,127.0,127.0,5,1111,13.0,843.0,843.0
0.1,6,10,1506,5,395,19.0,127.0,127.0,5,1111,21.0,843.0,843.0
0.003,17,2,148,1,60,0.0,32.0,32.0,1,88,0.0,60.0,60.0
0.01,17,2,179,1,71,0.0,43.0,43.0,1,108,0.0,80.0,80.0
0.005,6,10,2006,5,927,1.0,659.0,659.0,5,1079,1.0,811.0,811.0
11.012,17,28,4394,14,2311,838.0,586.0,137.0,14,2083,838.0,270.0,120.0
0.005,17,2,170,1,65,0.0,37.0,37.0,1,105,0.0,77.0,77.0
0.009,6,12,1926,6,1189,1.0,659.0,434.0,6,737,1.0,417.0,417.0
0.006,6,10,1854,5,889,1.0,621.0,621.0,5,965,1.0,697.0,697.0
0.009,6,12,1926,6,1189,1.0,659.0,434.0,6,737,1.0,417.0,417.0
0.009,6,10,1983,5,910,2.0,642.0,642.0,5,1073,2.0,805.0,805.0
0.013,6,10,1989,5,910,3.0,642.0,642.0,5,1079,3.0,811.0,811.0
0.004,6,10,2007,5,928,1.0,660.0,660.0,5,1079,1.0,811.0,811.0
0.012,6,10,1989,5,910,3.0,642.0,642.0,5,1079,2.0,811.0,811.0
0.216,6,16,2669,8,1395,30.0,533.0,323.0,8,1274,19.0,529.0,212.0
0.012,6,10,1990,5,911,3.0,643.0,643.0,5,1079,3.0,811.0,811.0
0.215,6,16,2782,8,1400,30.0,533.0,325.0,8,1382,19.0,529.0,239.0
0.006,6,10,1547,5,764,1.0,496.0,496.0,5,783,1.0,515.0,515.0
0.008,17,2,225,1,65,0.0,37.0,37.0,1,160,0.0,132.0,132.0
0.004,17,4,284,2,120,0.0,32.0,32.0,2,164,1.0,60.0,54.0
0.012,6,10,1677,5,827,3.0,559.0,559.0,5,850,3.0,582.0,582.0
0.009,6,10,1972,5,910,2.0,642.0,642.0,5,1062,2.0,794.0,794.0
40.054,17,10,676,5,460,10012.0,104.0,64.0,5,216,10012.0,20.0,15.0
0.006,6,10,1547,5,764,1.0,496.0,496.0,5,783,1.0,515.0,515.0
0.089,6,10,1506,5,395,20.0,127.0,127.0,5,1111,20.0,843.0,843.0
0.007,6,10,1989,5,927,1.0,659.0,659.0,5,1062,1.0,794.0,794.0
361.794,6,19,1688,15,978,25842.0,190.0,190.0,4,710,80012.0,494.0,494.0
0.038,17,2,136,1,60,0.0,32.0,32.0,1,76,0.0,48.0,48.0
0.001,17,2,180,1,66,0.0,38.0,38.0,1,114,0.0,86.0,86.0
0.005,6,10,1989,5,927,1.0,659.0,659.0,5,1062,1.0,794.0,794.0
0.005,17,2,136,1,60,0.0,32.0,32.0,1,76,0.0,48.0,48.0
0.009,6,10,1762,5,911,2.0,643.0,643.0,5,851,2.0,583.0,583.0
0.039,17,4,352,2,130,1.0,37.0,37.0,2,222,1.0,89.0,83.0
0.004,17,2,170,1,65,0.0,37.0,37.0,1,105,0.0,77.0,77.0
0.012,6,10,1990,5,911,2.0,643.0,643.0,5,1079,2.0,811.0,811.0
173.456,17,74,10484,37,2465,4818.0,44.0,38.0,37,8019,4818.0,260.0,188.0
1756.63,6,106,6361,60,3537,29772.0,27.0,27.0,46,2824,39035.0,27.0,27.0
0.01,6,10,1983,5,910,2.0,642.0,642.0,5,1073,2.0,805.0,805.0
0.012,6,10,1972,5,910,3.0,642.0,642.0,5,1062,2.0,794.0,794.0
240.011,6,9,787,5,488,60002.0,232.0,232.0,4,299,80002.0,83.0,83.0
0.009,6,10,1677,5,827,2.0,559.0,559.0,5,850,2.0,582.0,582.0
0.001,17,2,180,1,66,0.0,38.0,38.0,1,114,0.0,86.0,86.0
0.006,6,10,1547,5,764,1.0,496.0,496.0,5,783,1.0,515.0,515.0
0.004,6,10,2000,5,927,1.0,659.0,659.0,5,1073,1.0,805.0,805.0
0.004,6,10,1989,5,927,1.0,659.0,659.0,5,1062,1.0,794.0,794.0
0.098,6,10,1506,5,395,21.0,127.0,127.0,5,1111,22.0,843.0,843.0
0.001,17,2,136,1,60,0.0,32.0,32.0,1,76,0.0,48.0,48.0
40.062,17,10,676,5,460,10014.0,104.0,64.0,5,216,10014.0,20.0,15.0
0.256,17,2,142,1,63,0.0,35.0,35.0,1,79,0.0,51.0,51.0
0.001,17,2,136,1,60,0.0,32.0,32.0,1,76,0.0,48.0,48.0
0.074,6,10,1506,5,395,15.0,127.0,127.0,5,1111,15.0,843.0,843.0
0.004,17,2,148,1,60,0.0,32.0,32.0,1,88,0.0,60.0,60.0
0.005,6,10,2000,5,927,1.0,659.0,659.0,5,1073,1.0,805.0,805.0
0.116,6,10,1506,5,395,27.0,127.0,127.0,5,1111,26.0,843.0,843.0
0.008,6,10,1989,5,910,2.0,642.0,642.0,5,1079,2.0,811.0,811.0
0.003,17,2,136,1,60,0.0,32.0,32.0,1,76,0.0,48.0,48.0
0.004,6,10,1774,5,923,1.0,655.0,655.0,5,851,1.0,583.0,583.0
15.072,17,15,9238,8,6902,2149.0,1350.0,834.0,7,2336,2507.0,1350.0,305.0
240.011,6,9,787,5,488,60002.0,232.0,232.0,4,299,80003.0,83.0,83.0
0.003,17,2,148,1,60,0.0,32.0,32.0,1,88,0.0,60.0,60.0
0.005,6,10,2006,5,927,1.0,659.0,659.0,5,1079,1.0,811.0,811.0
0.069,6,10,1506,5,395,14.0,127.0,127.0,5,1111,15.0,843.0,843.0
0.003,17,2,187,1,74,0.0,46.0,46.0,1,113,0.0,85.0,85.0
0.004,6,10,2007,5,928,1.0,660.0,660.0,5,1079,1.0,811.0,811.0
0.176,6,10,1506,5,395,41.0,127.0,127.0,5,1111,33.0,843.0,843.0
0.1,6,10,1506,5,395,23.0,127.0,127.0,5,1111,22.0,843.0,843.0
28.574,17,24,14849,13,12031,2378.0,1350.0,897.0,11,2818,2854.0,1350.0,228.0
0.084,6,10,1506,5,395,17.0,127.0,127.0,5,1111,18.0,843.0,843.0
0.006,17,2,179,1,71,0.0,43.0,43.0,1,108,0.0,80.0,80.0
0.005,6,10,2007,5,928,1.0,660.0,660.0,5,1079,1.0,811.0,811.0
0.17,17,2,152,1,76,0.0,48.0,48.0,1,76,0.0,48.0,48.0
371.147,6,24,2405,17,919,23196.0,195.0,195.0,7,1486,3903.0,419.0,398.0
0.079,6,10,1506,5,395,16.0,127.0,127.0,5,1111,17.0,843.0,843.0
0.094,6,10,1506,5,395,20.0,127.0,127.0,5,1111,20.0,843.0,843.0
0.006,6,13,3690,7,452,1.0,80.0,80.0,6,3238,1.0,1470.0,1459.0
0.003,17,2,148,1,60,0.0,32.0,32.0,1,88,0.0,60.0,60.0
65.8,6,27,17543,15,9603,4700.0,2804.0,1469.0,12,7940,5967.0,2311.0,1218.0
0.085,6,10,1506,5,395,17.0,127.0,127.0,5,1111,18.0,843.0,843.0
0.009,6,10,1677,5,827,2.0,559.0,559.0,5,850,2.0,582.0,582.0
0.02,6,10,1762,5,911,5.0,643.0,643.0,5,851,4.0,583.0,583.0
0.005,6,10,2000,5,927,1.0,659.0,659.0,5,1073,1.0,805.0,805.0
0.094,6,10,1506,5,395,20.0,127.0,127.0,5,1111,21.0,843.0,843.0
0.012,6,10,1677,5,827,3.0,559.0,559.0,5,850,2.0,582.0,582.0
0.005,6,13,3747,7,509,0.0,137.0,137.0,6,3238,1.0,1470.0,1459.0
0.069,6,10,1506,5,395,14.0,127.0,127.0,5,1111,14.0,843.0,843.0
0.005,6,10,2006,5,927,1.0,659.0,659.0,5,1079,1.0,811.0,811.0
10.931,17,28,4399,14,2312,832.0,587.0,137.0,14,2087,832.0,270.0,121.0
0.004,17,4,284,2,120,0.0,32.0,32.0,2,164,0.0,60.0,54.0
0.014,6,13,3735,7,497,2.0,125.0,125.0,6,3238,2.0,1470.0,1459.0
0.072,6,10,1506,5,395,15.0,127.0,127.0,5,1111,16.0,843.0,843.0
0.011,6,10,1990,5,911,2.0,643.0,643.0,5,1079,2.0,811.0,811.0
0.009,6,12,1926,6,1189,1.0,659.0,434.0,6,737,1.0,417.0,417.0
0.003,17,2,148,1,60,0.0,32.0,32.0,1,88,0.0,60.0,60.0
0.007,6,10,1774,5,923,1.0,655.0,655.0,5,851,1.0,583.0,583.0
40.094,17,10,676,5,460,10019.0,104.0,64.0,5,216,10022.0,20.0,15.0
0.008,6,10,1989,5,910,2.0,642.0,642.0,5,1079,2.0,811.0,811.0
0.003,17,2,152,1,76,0.0,48.0,48.0,1,76,0.0,48.0,48.0
0.006,6,10,1854,5,889,1.0,621.0,621.0,5,965,1.0,697.0,697.0
0.005,6,10,1989,5,927,1.0,659.0,659.0,5,1062,1.0,794.0,794.0
0.005,6,13,3747,7,509,0.0,137.0,137.0,6,3238,0.0,1470.0,1459.0
0.018,6,10,1990,5,911,4.0,643.0,643.0,5,1079,4.0,811.0,811.0
0.005,17,2,140,1,62,0.0,34.0,34.0,1,78,0.0,50.0,50.0
0.016,6,10,1983,5,910,4.0,642.0,642.0,5,1073,3.0,805.0,805.0
0.014,6,10,1677,5,827,3.0,559.0,559.0,5,850,3.0,582.0,582.0
0.005,6,10,1989,5,927,1.0,659.0,659.0,5,1062,1.0,794.0,794.0
0.007,17,2,148,1,60,0.0,32.0,32.0,1,88,0.0,60.0,60.0
0.006,6,13,3747,7,509,1.0,137.0,137.0,6,3238,1.0,1470.0,1459.0
367.304,6,22,2313,16,867,24486.0,195.0,195.0,6,1446,4659.0,419.0,398.0
0.096,6,10,1506,5,395,20.0,127.0,127.0,5,1111,21.0,843.0,843.0
353.994,6,21,1795,16,1030,23599.0,190.0,190.0,5,765,60001.0,464.0,248.0
0.091,6,10,1506,5,395,17.0,127.0,127.0,5,1111,19.0,843.0,843.0
0.005,6,10,2006,5,927,1.0,659.0,659.0,5,1079,1.0,811.0,811.0
9.038,17,6,376,5,280,2259.0,28.0,28.0,1,96,0.0,68.0,68.0
0.004,6,10,2006,5,927,1.0,659.0,659.0,5,1079,1.0,811.0,811.0
0.008,17,2,214,1,75,0.0,47.0,47.0,1,139,0.0,111.0,111.0
0.013,6,10,1983,5,910,3.0,642.0,642.0,5,1073,3.0,805.0,805.0
0.007,6,10,1547,5,764,1.0,496.0,496.0,5,783,1.0,515.0,515.0
0.021,6,10,1989,5,910,5.0,642.0,642.0,5,1079,5.0,811.0,811.0
11.145,17,28,4421,14,1994,845.0,269.0,114.0,14,2427,845.0,586.0,145.0
0.017,17,4,352,2,130,10.0,37.0,37.0,2,222,11.0,89.0,83.0
240.092,6,16,4482,9,963,30011.0,238.0,166.0,7,3519,40014.0,1402.0,786.0
40.053,17,10,676,5,460,10012.0,104.0,64.0,5,216,10011.0,20.0,15.0
309.117,17,20,1124,10,716,34338.0,48.0,43.0,10,408,34339.0,20.0,12.0
0.011,6,10,1972,5,910,2.0,642.0,642.0,5,1062,2.0,794.0,794.0
0.13,6,28,10371,15,8942,9.0,2883.0,1166.0,13,1429,9.0,277.0,125.0
0.004,6,10,2006,5,927,1.0,659.0,659.0,5,1079,1.0,811.0,811.0
0.005,17,2,170,1,65,0.0,37.0,37.0,1,105,0.0,77.0,77.0
0.012,6,13,3735,7,497,2.0,125.0,125.0,6,3238,2.0,1470.0,1459.0
0.005,6,10,1779,5,928,1.0,660.0,660.0,5,851,1.0,583.0,583.0
0.004,6,10,1702,5,863,0.0,595.0,595.0,5,839,1.0,571.0,571.0
0.001,17,2,180,1,66,0.0,38.0,38.0,1,114,0.0,86.0,86.0
0.004,17,2,136,1,60,0.0,32.0,32.0,1,76,0.0,48.0,48.0
0.005,6,10,1689,5,839,1.0,571.0,571.0,5,850,1.0,582.0,582.0
0.005,17,2,170,1,65,0.0,37.0,37.0,1,105,0.0,77.0,77.0
0.009,6,10,1990,5,911,2.0,643.0,643.0,5,1079,2.0,811.0,811.0
0.004,6,10,1989,5,927,1.0,659.0,659.0,5,1062,1.0,794.0,794.0
0.086,6,10,1506,5,395,19.0,127.0,127.0,5,1111,19.0,843.0,843.0
0.007,17,2,179,1,71,0.0,43.0,43.0,1,108,0.0,80.0,80.0
0.015,6,10,1983,5,910,3.0,642.0,642.0,5,1073,3.0,805.0,805.0
0.005,17,2,214,1,75,0.0,47.0,47.0,1,139,0.0,111.0,111.0
11.176,17,28,4422,14,1993,847.0,268.0,114.0,14,2429,847.0,588.0,145.0
0.012,6,10,1989,5,910,2.0,642.0,642.0,5,1079,2.0,811.0,811.0
0.067,17,8,3613,4,1874,22.0,1350.0,440.0,4,1739,11.0,1350.0,406.0
308.846,17,20,1124,10,716,34297.0,48.0,43.0,10,408,34300.0,20.0,12.0
0.106,6,10,1506,5,395,24.0,127.0,127.0,5,1111,24.0,843.0,843.0
0.005,6,10,2006,5,927,1.0,659.0,659.0,5,1079,1.0,811.0,811.0
0.072,6,10,1506,5,395,15.0,127.0,127.0,5,1111,15.0,843.0,843.0
0.038,17,2,148,1,60,0.0,32.0,32.0,1,88,0.0,60.0,60.0
0.004,6,10,2006,5,927,1.0,659.0,659.0,5,1079,1.0,811.0,811.0
0.01,6,10,1983,5,910,2.0,642.0,642.0,5,1073,2.0,805.0,805.0
0.01,6,10,1990,5,911,2.0,643.0,643.0,5,1079,2.0,811.0,811.0
0.008,6,10,1854,5,889,2.0,621.0,621.0,5,965,2.0,697.0,697.0
0.118,6,10,1506,5,395,28.0,127.0,127.0,5,1111,27.0,843.0,843.0
300.923,6,37,8261,20,1830,15838.0,651.0,249.0,17,6431,547.0,2126.0,478.0
10.947,17,28,4391,14,2313,833.0,588.0,137.0,14,2078,833.0,269.0,120.0
0.008,6,10,1989,5,910,2.0,642.0,642.0,5,1079,2.0,811.0,811.0
0.092,6,10,1506,5,395,20.0,127.0,127.0,5,1111,22.0,843.0,843.0
0.001,17,2,136,1,60,0.0,32.0,32.0,1,76,0.0,48.0,48.0
0.01,6,10,1972,5,910,2.0,642.0,642.0,5,1062,2.0,794.0,794.0
0.005,6,14,3736,7,446,0.0,74.0,74.0,7,3290,0.0,1448.0,972.0
0.006,6,10,1547,5,764,1.0,496.0,496.0,5,783,1.0,515.0,515.0
368.695,6,22,2313,16,867,24579.0,195.0,195.0,6,1446,4645.0,419.0,398.0
0.003,17,4,284,2,120,0.0,32.0,32.0,2,164,0.0,60.0,54.0
240.118,6,16,4481,9,963,30014.0,238.0,166.0,7,3518,40019.0,1402.0,786.0
0.077,6,10,1506,5,395,18.0,127.0,127.0,5,1111,17.0,843.0,843.0
40.063,17,10,676,5,460,10013.0,104.0,64.0,5,216,10014.0,20.0,15.0
0.017,6,10,1972,5,910,4.0,642.0,642.0,5,1062,4.0,794.0,794.0
0.012,6,10,1990,5,911,3.0,643.0,643.0,5,1079,3.0,811.0,811.0
0.037,17,2,136,1,60,0.0,32.0,32.0,1,76,0.0,48.0,48.0
0.003,17,2,148,1,60,0.0,32.0,32.0,1,88,0.0,60.0,60.0
0.009,6,10,1989,5,910,2.0,642.0,642.0,5,1079,2.0,811.0,811.0
0.006,6,10,1547,5,764,1.0,496.0,496.0,5,783,1.0,515.0,515.0
0.084,6,10,1506,5,395,20.0,127.0,127.0,5,1111,18.0,843.0,843.0
0.033,6,10,1989,5,910,8.0,642.0,642.0,5,1079,8.0,811.0,811.0
0.124,17,2,80,1,32,0.0,4.0,4.0,1,48,0.0,20.0,20.0
0.007,6,10,1990,5,911,1.0,643.0,643.0,5,1079,1.0,811.0,811.0
0.081,6,10,1506,5,395,19.0,127.0,127.0,5,1111,17.0,843.0,843.0
0.005,6,10,2000,5,927,1.0,659.0,659.0,5,1073,1.0,805.0,805.0
0.069,6,10,1506,5,395,16.0,127.0,127.0,5,1111,15.0,843.0,843.0
126.017,6,14,2938,8,2504,17968.0,1414.0,1086.0,6,434,25155.0,182.0,182.0
10.806,17,28,4421,14,1994,822.0,269.0,114.0,14,2427,822.0,586.0,145.0
0.004,17,2,214,1,75,0.0,47.0,47.0,1,139,0.0,111.0,111.0
0.004,6,10,2000,5,927,1.0,659.0,659.0,5,1073,1.0,805.0,805.0
0.005,17,2,136,1,60,0.0,32.0,32.0,1,76,0.0,48.0,48.0
0.002,17,2,180,1,66,0.0,38.0,38.0,1,114,0.0,86.0,86.0
15.213,17,18,8864,9,6608,1898.0,1350.0,706.0,9,2256,1898.0,1350.0,222.0
0.006,6,10,1689,5,839,1.0,571.0,571.0,5,850,1.0,582.0,582.0
0.074,6,10,1506,5,395,16.0,127.0,127.0,5,1111,17.0,843.0,843.0
0.091,6,10,1506,5,395,18.0,127.0,127.0,5,1111,19.0,843.0,843.0
0.005,6,10,2007,5,928,1.0,660.0,660.0,5,1079,1.0,811.0,811.0
0.005,17,2,166,1,75,0.0,47.0,47.0,1,91,0.0,63.0,63.0
0.005,6,10,2006,5,927,1.0,659.0,659.0,5,1079,1.0,811.0,811.0
0.001,17,2,180,1,66,0.0,38.0,38.0,1,114,0.0,86.0,86.0
0.005,17,2,168,1,76,0.0,48.0,48.0,1,92,0.0,64.0,64.0
0.072,17,2,166,1,75,0.0,47.0,47.0,1,91,0.0,63.0,63.0
0.012,6,10,1972,5,910,2.0,642.0,642.0,5,1062,2.0,794.0,794.0
0.004,6,10,2006,5,927,1.0,659.0,659.0,5,1079,1.0,811.0,811.0
0.109,6,10,1506,5,395,22.0,127.0,127.0,5,1111,24.0,843.0,843.0
0.115,6,10,1506,5,395,25.0,127.0,127.0,5,1111,24.0,843.0,843.0
0.004,17,4,284,2,120,0.0,32.0,32.0,2,164,1.0,60.0,54.0
0.011,6,10,1972,5,910,2.0,642.0,642.0,5,1062,2.0,794.0,794.0
0.11,6,10,1506,5,395,25.0,127.0,127.0,5,1111,25.0,843.0,843.0
123.879,6,24,9399,11,1575,83.0,794.0,367.0,13,7824,10312.0,1360.0,810.0
0.004,17,2,148,1,60,0.0,32.0,32.0,1,88,0.0,60.0,60.0
0.005,6,10,1989,5,927,1.0,659.0,659.0,5,1062,1.0,794.0,794.0
0.118,6,10,1506,5,395,26.0,127.0,127.0,5,1111,28.0,843.0,843.0
240.756,6,30,11085,14,3481,18519.0,990.0,551.0,16,7604,16050.0,1592.0,676.0
0.006,6,10,1547,5,764,1.0,496.0,496.0,5,783,1.0,515.0,515.0
0.082,6,10,1506,5,395,19.0,127.0,127.0,5,1111,18.0,843.0,843.0
0.008,6,10,1990,5,911,2.0,643.0,643.0,5,1079,1.0,811.0,811.0
0.122,6,10,1506,5,395,26.0,127.0,127.0,5,1111,25.0,843.0,843.0
0.005,6,10,2007,5,928,1.0,660.0,660.0,5,1079,1.0,811.0,811.0
11.139,17,28,4421,14,1993,843.0,268.0,114.0,14,2428,844.0,587.0,145.0
0.013,6,10,1983,5,910,3.0,642.0,642.0,5,1073,3.0,805.0,805.0
0.007,17,2,179,1,71,0.0,43.0,43.0,1,108,0.0,80.0,80.0
0.001,17,2,136,1,60,0.0,32.0,32.0,1,76,0.0,48.0,48.0
40.053,17,10,676,5,460,10012.0,104.0,64.0,5,216,10012.0,20.0,15.0
0.022,6,10,1972,5,910,5.0,642.0,642.0,5,1062,5.0,794.0,794.0
0.019,6,10,1631,5,848,4.0,580.0,580.0,5,783,4.0,515.0,515.0
0.006,6,10,1854,5,889,1.0,621.0,621.0,5,965,1.0,697.0,697.0
0.011,17,4,284,2,120,0.0,32.0,32.0,2,164,1.0,60.0,54.0
0.006,6,10,1547,5,764,1.0,496.0,496.0,5,783,1.0,515.0,515.0
240.091,6,16,4482,9,963,30011.0,238.0,166.0,7,3519,40014.0,1402.0,786.0
0.004,6,10,2006,5,927,1.0,659.0,659.0,5,1079,1.0,811.0,811.0
0.01,17,2,164,1,74,0.0,46.0,46.0,1,90,0.0,62.0,62.0
0.01,6,10,1631,5,848,2.0,580.0,580.0,5,783,2.0,515.0,515.0
0.072,6,10,1506,5,395,16.0,127.0,127.0,5,1111,15.0,843.0,843.0
0.069,17,8,3613,4,1874,23.0,1350.0,440.0,4,1739,11.0,1350.0,406.0
0.12,6,10,1506,5,395,25.0,127.0,127.0,5,1111,23.0,843.0,843.0
0.008,6,12,1926,6,1189,1.0,659.0,434.0,6,737,1.0,417.0,417.0
0.005,6,10,2006,5,927,1.0,659.0,659.0,5,1079,1.0,811.0,811.0
0.007,17,2,194,1,59,0.0,31.0,31.0,1,135,0.0,107.0,107.0
1795.234,6,64,7344,42,4469,43786.0,1625.0,108.0,22,2875,85479.0,1111.0,82.0
0.012,6,10,1989,5,910,2.0,642.0,642.0,5,1079,3.0,811.0,811.0
0.016,6,10,1989,5,910,3.0,642.0,642.0,5,1079,4.0,811.0,811.0
0.005,6,10,2006,5,927,1.0,659.0,659.0,5,1079,1.0,811.0,811.0
0.091,6,10,1506,5,395,22.0,127.0,127.0,5,1111,19.0,843.0,843.0
0.053,17,2,152,1,76,0.0,48.0,48.0,1,76,0.0,48.0,48.0
0.005,6,10,2006,5,927,1.0,659.0,659.0,5,1079,1.0,811.0,811.0
1782.01,6,243,46643,118,34060,15230.0,2476.0,962.0,125,12583,14371.0,580.0,62.0
0.081,6,10,1506,5,395,19.0,127.0,127.0,5,1111,17.0,843.0,843.0
0.069,6,10,1506,5,395,14.0,127.0,127.0,5,1111,16.0,843.0,843.0
0.009,6,10,1983,5,910,2.0,642.0,642.0,5,1073,2.0,805.0,805.0
0.008,17,4,284,2,120,5.0,32.0,32.0,2,164,5.0,60.0,54.0
0.005,17,2,148,1,60,0.0,32.0,32.0,1,88,0.0,60.0,60.0
40.065,17,10,676,5,460,10015.0,104.0,64.0,5,216,10015.0,20.0,15.0
40.082,17,10,676,5,460,10019.0,104.0,64.0,5,216,10019.0,20.0,15.0
0.001,17,2,180,1,66,0.0,38.0,38.0,1,114,0.0,86.0,86.0
0.013,6,10,1983,5,910,3.0,642.0,642.0,5,1073,3.0,805.0,805.0
0.009,6,10,1983,5,910,2.0,642.0,642.0,5,1073,2.0,805.0,805.0
0.014,6,10,1983,5,910,3.0,642.0,642.0,5,1073,3.0,805.0,805.0
0.001,17,2,180,1,65,0.0,37.0,37.0,1,115,0.0,87.0,87.0
0.001,17,2,174,1,72,0.0,44.0,44.0,1,102,0.0,74.0,74.0
240.073,6,21,4925,11,941,24007.0,180.0,93.0,10,3984,26674.0,1592.0,576.0
0.014,6,10,1972,5,910,3.0,642.0,642.0,5,1062,3.0,794.0,794.0
0.085,6,10,1506,5,395,19.0,127.0,127.0,5,1111,18.0,843.0,843.0
0.001,17,2,180,1,66,0.0,38.0,38.0,1,114,0.0,86.0,86.0
0.005,6,10,1989,5,927,1.0,659.0,659.0,5,1062,1.0,794.0,794.0
0.006,6,10,2007,5,928,1.0,660.0,660.0,5,1079,1.0,811.0,811.0
0.005,6,10,2006,5,927,1.0,659.0,659.0,5,1079,1.0,811.0,811.0
0.006,6,10,1547,5,764,1.0,496.0,496.0,5,783,1.0,515.0,515.0
0.005,6,10,1854,5,889,1.0,621.0,621.0,5,965,1.0,697.0,697.0
0.104,6,10,1506,5,395,25.0,127.0,127.0,5,1111,14.0,843.0,843.0
0.074,6,10,1506,5,395,15.0,127.0,127.0,5,1111,16.0,843.0,843.0
0.006,6,10,1547,5,764,1.0,496.0,496.0,5,783,1.0,515.0,515.0
0.003,17,2,136,1,60,0.0,32.0,32.0,1,76,0.0,48.0,48.0
0.053,6,10,1989,5,910,13.0,642.0,642.0,5,1079,13.0,811.0,811.0
0.001,17,2,194,1,57,0.0,29.0,29.0,1,137,0.0,109.0,109.0
0.014,6,10,1989,5,910,3.0,642.0,642.0,5,1079,3.0,811.0,811.0
0.17,6,3,453,2,321,170.0,241.0,241.0,1,132,0.0,92.0,92.0
0.006,6,10,1547,5,764,1.0,496.0,496.0,5,783,1.0,515.0,515.0
0.005,6,10,2007,5,928,1.0,660.0,660.0,5,1079,1.0,811.0,811.0
0.01,6,10,1677,5,827,2.0,559.0,559.0,5,850,2.0,582.0,582.0
0.006,6,12,1698,6,863,1.0,327.0,271.0,6,835,1.0,515.0,515.0
240.081,6,20,4872,10,889,26675.0,180.0,93.0,10,3983,26675.0,1591.0,575.0
0.096,6,10,1506,5,395,22.0,127.0,127.0,5,1111,20.0,843.0,843.0
0.021,6,10,1989,5,910,5.0,642.0,642.0,5,1079,5.0,811.0,811.0
0.079,6,10,1506,5,395,13.0,127.0,127.0,5,1111,17.0,843.0,843.0
0.106,6,10,1506,5,395,20.0,127.0,127.0,5,1111,22.0,843.0,843.0
170.484,17,82,11409,41,2741,4261.0,44.0,38.0,41,8668,4262.0,239.0,183.0
0.01,6,10,1989,5,910,2.0,642.0,642.0,5,1079,2.0,811.0,811.0
0.008,6,10,1677,5,827,2.0,559.0,559.0,5,850,2.0,582.0,582.0
0.005,6,10,1779,5,928,1.0,660.0,660.0,5,851,1.0,583.0,583.0
0.035,6,10,1990,5,911,8.0,643.0,643.0,5,1079,8.0,811.0,811.0
40.058,17,10,676,5,460,10013.0,104.0,64.0,5,216,10013.0,20.0,15.0
0.082,6,10,1506,5,395,18.0,127.0,127.0,5,1111,18.0,843.0,843.0
40.072,17,10,676,5,460,10015.0,104.0,64.0,5,216,10017.0,20.0,15.0
0.003,17,4,284,2,120,0.0,32.0,32.0,2,164,0.0,60.0,54.0
173.086,17,78,10977,39,2585,4554.0,44.0,38.0,39,8392,4554.0,239.0,187.0
0.005,6,10,2006,5,927,1.0,659.0,659.0,5,1079,1.0,811.0,811.0
11.098,17,28,4421,14,1994,844.0,269.0,114.0,14,2427,842.0,586.0,145.0
0.006,6,10,1547,5,764,1.0,496.0,496.0,5,783,1.0,515.0,515.0
0.003,17,2,208,1,72,0.0,44.0,44.0,1,136,0.0,108.0,108.0
0.018,6,10,1990,5,911,4.0,643.0,643.0,5,1079,4.0,811.0,811.0
0.005,6,10,1989,5,927,1.0,659.0,659.0,5,1062,1.0,794.0,794.0
0.104,6,10,1506,5,395,24.0,127.0,127.0,5,1111,20.0,843.0,843.0
0.115,6,10,1506,5,395,25.0,127.0,127.0,5,1111,23.0,843.0,843.0
0.086,6,10,1506,5,395,19.0,127.0,127.0,5,1111,19.0,843.0,843.0
0.006,17,2,162,1,73,0.0,45.0,45.0,1,89,0.0,61.0,61.0
0.007,17,2,180,1,58,0.0,30.0,30.0,1,122,0.0,94.0,94.0
0.168,17,2,152,1,76,0.0,48.0,48.0,1,76,0.0,48.0,48.0
0.004,17,2,148,1,60,0.0,32.0,32.0,1,88,0.0,60.0,60.0
0.812,6,10,937,6,427,162.0,107.0,107.0,4,510,181.0,294.0,294.0
0.011,6,10,1972,5,910,2.0,642.0,642.0,5,1062,2.0,794.0,794.0
0.009,6,10,1677,5,827,2.0,559.0,559.0,5,850,2.0,582.0,582.0
40.081,17,10,676,5,460,10014.0,104.0,64.0,5,216,10019.0,20.0,15.0
0.082,6,10,1506,5,395,19.0,127.0,127.0,5,1111,17.0,843.0,843.0
0.004,6,10,2007,5,928,1.0,660.0,660.0,5,1079,1.0,811.0,811.0
40.051,17,10,676,5,460,10011.0,104.0,64.0,5,216,10011.0,20.0,15.0
0.004,6,10,2006,5,927,1.0,659.0,659.0,5,1079,1.0,811.0,811.0
0.041,17,2,144,1,64,0.0,36.0,36.0,1,80,0.0,52.0,52.0
0.004,6,10,1774,5,923,1.0,655.0,655.0,5,851,1.0,583.0,583.0
0.003,17,2,148,1,60,0.0,32.0,32.0,1,88,0.0,60.0,60.0
0.008,6,10,1990,5,911,2.0,643.0,643.0,5,1079,2.0,811.0,811.0
0.013,6,10,1983,5,910,3.0,642.0,642.0,5,1073,3.0,805.0,805.0
0.013,6,10,1677,5,827,3.0,559.0,559.0,5,850,3.0,582.0,582.0
0.015,6,10,1989,5,910,3.0,642.0,642.0,5,1079,3.0,811.0,811.0
0.005,6,10,2007,5,928,1.0,660.0,660.0,5,1079,1.0,811.0,811.0
0.17,17,2,213,1,69,0.0,41.0,41.0,1,144,0.0,116.0,116.0
0.016,6,10,1631,5,848,3.0,580.0,580.0,5,783,3.0,515.0,515.0
0.078,6,10,1506,5,395,18.0,127.0,127.0,5,1111,16.0,843.0,843.0
0.009,6,12,1926,6,1189,1.0,659.0,434.0,6,737,1.0,417.0,417.0
0.01,6,10,1972,5,910,2.0,642.0,642.0,5,1062,2.0,794.0,794.0
0.006,6,10,1547,5,764,1.0,496.0,496.0,5,783,1.0,515.0,515.0
0.007,6,10,2007,5,928,1.0,660.0,660.0,5,1079,1.0,811.0,811.0
0.005,6,10,1643,5,860,1.0,592.0,592.0,5,783,1.0,515.0,515.0
15.093,17,18,10295,9,6625,1883.0,1350.0,708.0,9,3670,1883.0,1350.0,379.0
0.096,6,10,1506,5,395,21.0,127.0,127.0,5,1111,22.0,843.0,843.0
0.01,6,10,1989,5,910,2.0,642.0,642.0,5,1079,2.0,811.0,811.0
0.005,6,10,2006,5,927,1.0,659.0,659.0,5,1079,1.0,811.0,811.0
0.011,6,10,1989,5,910,2.0,642.0,642.0,5,1079,2.0,811.0,811.0
0.004,17,2,148,1,60,0.0,32.0,32.0,1,88,0.0,60.0,60.0
0.099,6,10,1506,5,395,21.0,127.0,127.0,5,1111,20.0,843.0,843.0
0.005,6,10,1989,5,927,1.0,659.0,659.0,5,1062,1.0,794.0,794.0
0.001,17,2,136,1,60,0.0,32.0,32.0,1,76,0.0,48.0,48.0
0.124,6,10,1506,5,395,29.0,127.0,127.0,5,1111,26.0,843.0,843.0
0.01,6,10,1990,5,911,2.0,643.0,643.0,5,1079,2.0,811.0,811.0
0.07,6,10,1506,5,395,15.0,127.0,127.0,5,1111,16.0,843.0,843.0
0.009,6,10,1989,5,910,2.0,642.0,642.0,5,1079,2.0,811.0,811.0
0.005,17,2,179,1,71,0.0,43.0,43.0,1,108,0.0,80.0,80.0
0.103,6,10,1506,5,395,23.0,127.0,127.0,5,1111,24.0,843.0,843.0
0.001,17,2,136,1,60,0.0,32.0,32.0,1,76,0.0,48.0,48.0
0.012,6,10,1677,5,827,2.0,559.0,559.0,5,850,3.0,582.0,582.0
0.006,6,10,2007,5,928,1.0,660.0,660.0,5,1079,1.0,811.0,811.0
0.004,17,2,170,1,65,0.0,37.0,37.0,1,105,0.0,77.0,77.0
1755.822,6,437,65217,253,35232,6967.0,613.0,197.0,184,29985,9594.0,453.0,144.0
0.034,17,2,152,1,76,0.0,48.0,48.0,1,76,0.0,48.0,48.0
0.008,17,2,180,1,58,0.0,30.0,30.0,1,122,0.0,94.0,94.0
0.121,6,10,1506,5,395,20.0,127.0,127.0,5,1111,26.0,843.0,843.0
0.001,17,2,180,1,66,0.0,38.0,38.0,1,114,0.0,86.0,86.0
0.007,6,10,1989,5,927,1.0,659.0,659.0,5,1062,1.0,794.0,794.0
300.36,6,16,2170,9,684,37524.0,146.0,146.0,7,1486,50032.0,419.0,398.0
11.504,17,28,4399,14,2313,872.0,588.0,137.0,14,2086,872.0,269.0,121.0
0.005,17,2,144,1,64,0.0,36.0,36.0,1,80,0.0,52.0,52.0
40.071,17,10,676,5,460,10014.0,104.0,64.0,5,216,10017.0,20.0,15.0
0.039,17,2,170,1,65,0.0,37.0,37.0,1,105,0.0,77.0,77.0
0.098,6,10,1506,5,395,20.0,127.0,127.0,5,1111,21.0,843.0,843.0
0.007,6,10,1547,5,764,1.0,496.0,496.0,5,783,1.0,515.0,515.0
0.004,17,4,284,2,120,0.0,32.0,32.0,2,164,1.0,60.0,54.0
0.005,6,10,1643,5,860,1.0,592.0,592.0,5,783,1.0,515.0,515.0
0.015,17,2,152,1,56,0.0,28.0,28.0,1,96,0.0,68.0,68.0
0.006,17,2,170,1,65,0.0,37.0,37.0,1,105,0.0,77.0,77.0
8.98,6,36,9771,19,4293,498.0,1360.0,700.0,17,5478,548.0,2667.0,435.0
0.004,6,10,2006,5,927,1.0,659.0,659.0,5,1079,1.0,811.0,811.0
0.045,6,10,1983,5,910,11.0,642.0,642.0,5,1073,11.0,805.0,805.0
0.005,6,10,1643,5,860,1.0,592.0,592.0,5,783,1.0,515.0,515.0
0.005,6,13,3690,7,452,0.0,80.0,80.0,6,3238,1.0,1470.0,1459.0
0.004,6,10,1989,5,927,1.0,659.0,659.0,5,1062,1.0,794.0,794.0
10.866,17,28,4420,14,1993,826.0,268.0,114.0,14,2427,827.0,586.0,145.0
351.987,6,20,2210,6,1308,12003.0,494.0,494.0,14,902,27075.0,83.0,83.0
0.011,6,10,1762,5,911,2.0,643.0,643.0,5,851,2.0,583.0,583.0
0.077,6,12,2073,7,1013,12.0,589.0,326.0,5,1060,16.0,580.0,396.0
40.063,17,10,676,5,460,10014.0,104.0,64.0,5,216,10015.0,20.0,15.0
40.063,17,10,676,5,460,10015.0,104.0,64.0,5,216,10014.0,20.0,15.0
0.004,6,10,2007,5,928,1.0,660.0,660.0,5,1079,1.0,811.0,811.0
0.004,6,10,1989,5,927,1.0,659.0,659.0,5,1062,1.0,794.0,794.0
0.021,6,10,1631,5,848,5.0,580.0,580.0,5,783,5.0,515.0,515.0
0.01,6,10,1983,5,910,2.0,642.0,642.0,5,1073,2.0,805.0,805.0
11.439,17,28,4391,14,2312,867.0,587.0,137.0,14,2079,867.0,270.0,120.0
0.015,6,10,1989,5,910,3.0,642.0,642.0,5,1079,3.0,811.0,811.0
0.011,6,10,1762,5,911,2.0,643.0,643.0,5,851,2.0,583.0,583.0
240.146,6,31,9392,15,6950,17153.0,2073.0,686.0,16,2442,16009.0,580.0,200.0
11.11,17,28,4420,14,1993,842.0,268.0,114.0,14,2427,842.0,586.0,145.0
0.1,6,10,1506,5,395,21.0,127.0,127.0,5,1111,23.0,843.0,843.0
0.021,6,13,3735,7,497,3.0,125.0,125.0,6,3238,4.0,1470.0,1459.0
0.096,6,10,1506,5,395,20.0,127.0,127.0,5,1111,22.0,843.0,843.0
0.001,17,2,180,1,66,0.0,38.0,38.0,1,114,0.0,86.0,86.0
0.015,6,10,1631,5,848,3.0,580.0,580.0,5,783,3.0,515.0,515.0
0.068,17,8,3613,4,1874,22.0,1350.0,440.0,4,1739,11.0,1350.0,406.0
0.029,6,10,1989,5,910,7.0,642.0,642.0,5,1079,7.0,811.0,811.0
0.01,6,10,1989,5,910,2.0,642.0,642.0,5,1079,2.0,811.0,811.0
0.005,6,10,2006,5,927,1.0,659.0,659.0,5,1079,1.0,811.0,811.0
0.005,17,2,184,1,61,0.0,33.0,33.0,1,123,0.0,95.0,95.0
0.008,6,10,1989,5,910,2.0,642.0,642.0,5,1079,2.0,811.0,811.0
0.014,6,10,1972,5,910,3.0,642.0,642.0,5,1062,3.0,794.0,794.0
0.007,6,10,1854,5,889,1.0,621.0,621.0,5,965,1.0,697.0,697.0
0.07,6,10,1506,5,395,15.0,127.0,127.0,5,1111,16.0,843.0,843.0
0.115,6,10,1506,5,395,26.0,127.0,127.0,5,1111,27.0,843.0,843.0
0.082,6,10,1506,5,395,18.0,127.0,127.0,5,1111,17.0,843.0,843.0
0.07,17,8,3613,4,1874,23.0,1350.0,440.0,4,1739,11.0,1350.0,406.0
0.011,6,10,1762,5,911,2.0,643.0,643.0,5,851,2.0,583.0,583.0
0.005,6,10,2006,5,927,1.0,659.0,659.0,5,1079,1.0,811.0,811.0
0.006,6,10,1854,5,889,1.0,621.0,621.0,5,965,1.0,697.0,697.0
0.012,6,10,1989,5,910,3.0,642.0,642.0,5,1079,2.0,811.0,811.0
0.006,17,2,194,1,59,0.0,31.0,31.0,1,135,0.0,107.0,107.0
40.06,17,10,676,5,460,10013.0,104.0,64.0,5,216,10014.0,20.0,15.0
0.048,6,10,1972,5,910,11.0,642.0,642.0,5,1062,12.0,794.0,794.0
15.088,17,16,10622,9,8280,1882.0,1350.0,892.0,7,2342,2507.0,1350.0,306.0
0.155,6,10,1506,5,395,35.0,127.0,127.0,5,1111,23.0,843.0,843.0
0.012,6,10,1983,5,910,3.0,642.0,642.0,5,1073,2.0,805.0,805.0
0.107,6,10,1506,5,395,25.0,127.0,127.0,5,1111,24.0,843.0,843.0
0.098,6,10,1506,5,395,20.0,127.0,127.0,5,1111,22.0,843.0,843.0
0.004,17,2,136,1,60,0.0,32.0,32.0,1,76,0.0,48.0,48.0
300.397,6,16,2170,9,684,37527.0,146.0,146.0,7,1486,50036.0,419.0,398.0
0.008,6,10,1989,5,910,1.0,642.0,642.0,5,1079,2.0,811.0,811.0
0.004,6,10,2007,5,928,1.0,660.0,660.0,5,1079,1.0,811.0,811.0
40.101,17,10,676,5,460,10017.0,104.0,64.0,5,216,10018.0,20.0,15.0
0.028,6,10,1989,5,910,6.0,642.0,642.0,5,1079,6.0,811.0,811.0
0.005,6,10,2007,5,928,1.0,660.0,660.0,5,1079,1.0,811.0,811.0
0.169,17,2,152,1,76,0.0,48.0,48.0,1,76,0.0,48.0,48.0
0.004,6,10,2007,5,928,1.0,660.0,660.0,5,1079,1.0,811.0,811.0
0.006,6,10,1547,5,764,1.0,496.0,496.0,5,783,1.0,515.0,515.0
0.004,17,2,148,1,60,0.0,32.0,32.0,1,88,0.0,60.0,60.0
0.04,17,2,152,1,76,0.0,48.0,48.0,1,76,0.0,48.0,48.0
15.071,17,15,9239,8,6902,2149.0,1350.0,834.0,7,2337,2506.0,1350.0,305.0
0.112,6,10,1506,5,395,16.0,127.0,127.0,5,1111,23.0,843.0,843.0
0.039,17,2,136,1,60,0.0,32.0,32.0,1,76,0.0,48.0,48.0
40.056,17,10,676,5,460,10013.0,104.0,64.0,5,216,10013.0,20.0,15.0
0.096,6,10,1506,5,395,21.0,127.0,127.0,5,1111,22.0,843.0,843.0
0.006,6,10,2007,5,928,1.0,660.0,660.0,5,1079,1.0,811.0,811.0
0.004,17,2,170,1,65,0.0,37.0,37.0,1,105,0.0,77.0,77.0
0.01,6,10,1989,5,910,2.0,642.0,642.0,5,1079,2.0,811.0,811.0
40.082,17,10,676,5,460,10017.0,104.0,64.0,5,216,10019.0,20.0,15.0
0.004,17,2,148,1,60,0.0,32.0,32.0,1,88,0.0,60.0,60.0
0.041,17,2,148,1,60,0.0,32.0,32.0,1,88,0.0,60.0,60.0
40.066,17,10,676,5,460,10013.0,104.0,64.0,5,216,10015.0,20.0,15.0
0.0,17,2,180,1,66,0.0,38.0,38.0,1,114,0.0,86.0,86.0
0.039,17,4,284,2,120,0.0,32.0,32.0,2,164,35.0,60.0,54.0
0.006,6,10,1547,5,764,1.0,496.0,496.0,5,783,1.0,515.0,515.0
0.004,17,2,136,1,60,0.0,32.0,32.0,1,76,0.0,48.0,48.0
0.006,6,10,1689,5,839,1.0,571.0,571.0,5,850,1.0,582.0,582.0
240.179,6,16,4481,9,963,30022.0,238.0,166.0,7,3518,40025.0,1402.0,786.0
0.012,6,10,1631,5,848,3.0,580.0,580.0,5,783,3.0,515.0,515.0
0.171,17,2,152,1,76,0.0,48.0,48.0,1,76,0.0,48.0,48.0
51.378,6,28,9605,14,1707,3952.0,794.0,367.0,14,7898,3942.0,1360.0,732.0
0.07,6,10,1506,5,395,15.0,127.0,127.0,5,1111,14.0,843.0,843.0
0.009,6,10,1972,5,910,2.0,642.0,642.0,5,1062,2.0,794.0,794.0
0.005,6,10,2006,5,927,1.0,659.0,659.0,5,1079,1.0,811.0,811.0
40.064,17,10,676,5,460,10013.0,104.0,64.0,5,216,10015.0,20.0,15.0
0.006,17,2,179,1,71,0.0,43.0,43.0,1,108,0.0,80.0,80.0
0.152,6,15,4569,8,993,21.0,517.0,290.0,7,3576,24.0,1402.0,1068.0
40.068,17,10,676,5,460,10016.0,104.0,64.0,5,216,10016.0,20.0,15.0
0.007,6,10,1547,5,764,1.0,496.0,496.0,5,783,1.0,515.0,515.0
0.005,6,10,1854,5,889,1.0,621.0,621.0,5,965,1.0,697.0,697.0
40.05,17,10,676,5,460,10011.0,104.0,64.0,5,216,10010.0,20.0,15.0
300.476,6,16,2170,9,684,37539.0,146.0,146.0,7,1486,50052.0,419.0,398.0
0.004,6,10,2006,5,927,1.0,659.0,659.0,5,1079,1.0,811.0,811.0
0.005,6,10,1989,5,927,1.0,659.0,659.0,5,1062,1.0,794.0,794.0
677.904,6,59,22981,31,4763,22596.0,676.0,449.0,28,18218,22883.0,1402.0,837.0
0.003,17,2,136,1,60,0.0,32.0,32.0,1,76,0.0,48.0,48.0
240.124,6,33,9221,16,6738,16008.0,1798.0,655.0,17,2483,15007.0,580.0,198.0
1729.216,6,60,4400,40,2740,44338.0,33.0,33.0,20,1660,91002.0,31.0,31.0
0.001,17,2,180,1,66,0.0,38.0,38.0,1,114,0.0,86.0,86.0
0.076,6,10,1506,5,395,17.0,127.0,127.0,5,1111,17.0,843.0,843.0
0.004,6,10,1702,5,863,1.0,595.0,595.0,5,839,1.0,571.0,571.0
0.005,6,10,1989,5,927,1.0,659.0,659.0,5,1062,1.0,794.0,794.0
0.011,6,10,1983,5,910,2.0,642.0,642.0,5,1073,2.0,805.0,805.0
15.073,17,15,9238,8,6902,2149.0,1350.0,834.0,7,2336,2507.0,1350.0,305.0
361.822,6,21,1793,16,1030,24121.0,190.0,190.0,5,763,60009.0,462.0,247.0
0.002,17,2,136,1,60,0.0,32.0,32.0,1,76,0.0,48.0,48.0
0.007,17,2,140,1,62,0.0,34.0,34.0,1,78,0.0,50.0,50.0
10.831,17,28,4416,14,1993,824.0,268.0,114.0,14,2423,824.0,586.0,145.0
0.073,17,2,412,1,61,0.0,33.0,33.0,1,351,0.0,323.0,323.0
0.001,17,2,180,1,66,0.0,38.0,38.0,1,114,0.0,86.0,86.0
0.127,6,10,1506,5,395,26.0,127.0,127.0,5,1111,28.0,843.0,843.0
0.009,6,10,1990,5,911,2.0,643.0,643.0,5,1079,2.0,811.0,811.0
0.004,6,10,2006,5,927,1.0,659.0,659.0,5,1079,1.0,811.0,811.0
0.081,17,2,152,1,76,0.0,48.0,48.0,1,76,0.0,48.0,48.0
0.005,6,14,3736,7,446,0.0,74.0,74.0,7,3290,0.0,1448.0,972.0
0.131,6,10,1506,5,395,30.0,127.0,127.0,5,1111,28.0,843.0,843.0
0.003,17,2,148,1,60,0.0,32.0,32.0,1,88,0.0,60.0,60.0
0.005,6,10,2006,5,927,1.0,659.0,659.0,5,1079,1.0,811.0,811.0
0.094,6,10,1506,5,395,19.0,127.0,127.0,5,1111,21.0,843.0,843.0
0.001,17,2,180,1,66,0.0,38.0,38.0,1,114,0.0,86.0,86.0
0.091,6,10,1506,5,395,21.0,127.0,127.0,5,1111,16.0,843.0,843.0
0.005,6,14,3736,7,446,0.0,74.0,74.0,7,3290,0.0,1448.0,972.0
0.012,6,10,1989,5,910,3.0,642.0,642.0,5,1079,3.0,811.0,811.0
0.039,17,4,352,2,130,0.0,37.0,37.0,2,222,36.0,89.0,83.0
0.033,17,2,237,1,65,0.0,37.0,37.0,1,172,0.0,144.0,144.0
0.144,6,10,1506,5,395,35.0,127.0,127.0,5,1111,31.0,843.0,843.0
0.013,6,10,1983,5,910,3.0,642.0,642.0,5,1073,3.0,805.0,805.0
0.103,6,10,1506,5,395,21.0,127.0,127.0,5,1111,22.0,843.0,843.0
0.003,17,2,136,1,60,0.0,32.0,32.0,1,76,0.0,48.0,48.0
0.115,6,10,1506,5,395,15.0,127.0,127.0,5,1111,27.0,843.0,843.0
0.005,6,10,2006,5,927,1.0,659.0,659.0,5,1079,1.0,811.0,811.0
0.004,17,4,284,2,120,0.0,32.0,32.0,2,164,1.0,60.0,54.0
0.013,6,10,1989,5,910,3.0,642.0,642.0,5,1079,3.0,811.0,811.0
252.887,6,39,9842,16,6604,16859.0,1676.0,641.0,23,3238,11494.0,580.0,145.0
0.052,17,2,152,1,76,0.0,48.0,48.0,1,76,0.0,48.0,48.0
0.091,6,10,1506,5,395,19.0,127.0,127.0,5,1111,20.0,843.0,843.0
0.012,6,13,3913,7,495,1.0,123.0,123.0,6,3418,2.0,1650.0,1549.0
0.004,17,2,148,1,60,0.0,32.0,32.0,1,88,0.0,60.0,60.0
0.014,6,10,1989,5,910,3.0,642.0,642.0,5,1079,3.0,811.0,811.0
0.007,6,10,1989,5,910,1.0,642.0,642.0,5,1079,1.0,811.0,811.0
11.035,17,28,4393,14,2312,840.0,587.0,137.0,14,2081,840.0,268.0,120.0
0.006,6,10,1547,5,764,1.0,496.0,496.0,5,783,1.0,515.0,515.0
0.005,17,2,214,1,75,0.0,47.0,47.0,1,139,0.0,111.0,111.0
0.006,6,10,1702,5,863,1.0,595.0,595.0,5,839,1.0,571.0,571.0
0.026,6,10,1990,5,911,6.0,643.0,643.0,5,1079,6.0,811.0,811.0
0.005,17,4,495,2,132,0.0,38.0,38.0,2,363,2.0,176.0,153.0
0.065,6,10,1506,5,395,13.0,127.0,127.0,5,1111,15.0,843.0,843.0
0.005,17,2,179,1,71,0.0,43.0,43.0,1,108,0.0,80.0,80.0
15.074,17,15,9238,8,6902,2149.0,1350.0,834.0,7,2336,2507.0,1350.0,305.0
0.006,17,2,187,1,71,0.0,43.0,43.0,1,116,0.0,88.0,88.0
0.065,6,10,1506,5,395,14.0,127.0,127.0,5,1111,14.0,843.0,843.0
0.006,17,2,148,1,60,0.0,32.0,32.0,1,88,0.0,60.0,60.0
0.005,6,10,1779,5,928,1.0,660.0,660.0,5,851,1.0,583.0,583.0
0.037,17,2,136,1,60,0.0,32.0,32.0,1,76,0.0,48.0,48.0
0.001,17,2,179,1,62,0.0,34.0,34.0,1,117,0.0,89.0,89.0
0.037,17,2,152,1,76,0.0,48.0,48.0,1,76,0.0,48.0,48.0
0.009,6,10,1989,5,910,2.0,642.0,642.0,5,1079,2.0,811.0,811.0
1778.543,17,144,45504,72,22752,25046.0,288.0,288.0,72,22752,25049.0,288.0,288.0
0.004,6,10,2006,5,927,1.0,659.0,659.0,5,1079,1.0,811.0,811.0
0.113,6,10,1506,5,395,21.0,127.0,127.0,5,1111,24.0,843.0,843.0
0.005,6,10,2006,5,927,1.0,659.0,659.0,5,1079,1.0,811.0,811.0
0.014,6,10,1677,5,827,3.0,559.0,559.0,5,850,3.0,582.0,582.0
0.074,6,10,1506,5,395,16.0,127.0,127.0,5,1111,16.0,843.0,843.0
0.018,6,10,1989,5,910,4.0,642.0,642.0,5,1079,4.0,811.0,811.0
0.097,6,10,1506,5,395,21.0,127.0,127.0,5,1111,21.0,843.0,843.0
0.005,6,10,2006,5,927,1.0,659.0,659.0,5,1079,1.0,811.0,811.0
0.206,6,16,2777,8,1395,29.0,533.0,323.0,8,1382,18.0,529.0,239.0
176.411,17,76,10892,38,2534,4767.0,44.0,38.0,38,8358,4767.0,261.0,191.0
0.143,6,10,1506,5,395,35.0,127.0,127.0,5,1111,30.0,843.0,843.0
0.128,17,2,80,1,32,0.0,4.0,4.0,1,48,0.0,20.0,20.0
0.043,6,13,3913,7,495,7.0,123.0,123.0,6,3418,8.0,1650.0,1549.0
1779.13,17,144,45504,72,22752,25052.0,288.0,288.0,72,22752,25055.0,288.0,288.0
40.073,17,10,676,5,460,10015.0,104.0,64.0,5,216,10017.0,20.0,15.0
15.074,17,15,9238,8,6902,2149.0,1350.0,834.0,7,2336,2507.0,1350.0,305.0
0.003,17,2,132,1,58,0.0,30.0,30.0,1,74,0.0,46.0,46.0
0.006,6,10,1643,5,860,1.0,592.0,592.0,5,783,1.0,515.0,515.0
0.005,6,10,2006,5,927,1.0,659.0,659.0,5,1079,1.0,811.0,811.0
0.202,6,10,1506,5,395,48.0,127.0,127.0,5,1111,32.0,843.0,843.0
0.013,6,10,1989,5,910,3.0,642.0,642.0,5,1079,3.0,811.0,811.0
300.035,6,12,1782,7,1348,50005.0,494.0,494.0,5,434,75006.0,83.0,83.0
40.066,17,10,676,5,460,10015.0,104.0,64.0,5,216,10015.0,20.0,15.0
0.019,6,10,1972,5,910,4.0,642.0,642.0,5,1062,4.0,794.0,794.0
0.168,17,2,152,1,76,0.0,48.0,48.0,1,76,0.0,48.0,48.0
0.005,17,2,214,1,75,0.0,47.0,47.0,1,139,0.0,111.0,111.0
0.008,6,10,1989,5,910,2.0,642.0,642.0,5,1079,2.0,811.0,811.0
0.114,6,10,1506,5,395,25.0,127.0,127.0,5,1111,25.0,843.0,843.0
0.013,6,10,1990,5,911,3.0,643.0,643.0,5,1079,3.0,811.0,811.0
0.003,17,4,284,2,120,0.0,32.0,32.0,2,164,0.0,60.0,54.0
0.001,17,2,136,1,60,0.0,32.0,32.0,1,76,0.0,48.0,48.0
0.005,6,10,1689,5,839,1.0,571.0,571.0,5,850,1.0,582.0,582.0
0.005,6,10,2000,5,927,1.0,659.0,659.0,5,1073,1.0,805.0,805.0
0.005,6,10,2000,5,927,1.0,659.0,659.0,5,1073,1.0,805.0,805.0
0.001,17,2,136,1,60,0.0,32.0,32.0,1,76,0.0,48.0,48.0
0.005,17,2,136,1,60,0.0,32.0,32.0,1,76,0.0,48.0,48.0
0.099,6,10,1506,5,395,20.0,127.0,127.0,5,1111,22.0,843.0,843.0
0.004,17,4,284,2,120,0.0,32.0,32.0,2,164,1.0,60.0,54.0
40.058,17,10,676,5,460,10013.0,104.0,64.0,5,216,10013.0,20.0,15.0
308.489,17,20,1124,10,716,34261.0,48.0,43.0,10,408,34261.0,20.0,12.0
0.006,6,10,1547,5,764,1.0,496.0,496.0,5,783,1.0,515.0,515.0
0.005,6,10,2000,5,927,1.0,659.0,659.0,5,1073,1.0,805.0,805.0
0.005,6,10,1779,5,928,1.0,660.0,660.0,5,851,1.0,583.0,583.0
0.072,6,10,1506,5,395,17.0,127.0,127.0,5,1111,15.0,843.0,843.0
40.06,17,10,676,5,460,10013.0,104.0,64.0,5,216,10013.0,20.0,15.0
0.18,6,10,1506,5,395,44.0,127.0,127.0,5,1111,40.0,843.0,843.0
0.005,17,2,412,1,61,0.0,33.0,33.0,1,351,0.0,323.0,323.0
0.023,6,10,1990,5,911,5.0,643.0,643.0,5,1079,5.0,811.0,811.0
0.016,6,10,1990,5,911,3.0,643.0,643.0,5,1079,3.0,811.0,811.0
1770.309,6,84,4420,42,2210,43177.0,26.0,26.0,42,2210,43177.0,26.0,26.0
0.052,17,2,152,1,76,0.0,48.0,48.0,1,76,0.0,48.0,48.0
0.005,6,10,1989,5,927,1.0,659.0,659.0,5,1062,1.0,794.0,794.0
0.004,6,10,2006,5,927,1.0,659.0,659.0,5,1079,1.0,811.0,811.0
15.076,17,15,8213,8,5953,2149.0,1350.0,716.0,7,2260,2507.0,1350.0,294.0
0.013,6,10,1989,5,910,3.0,642.0,642.0,5,1079,3.0,811.0,811.0
0.122,6,10,1506,5,395,27.0,127.0,127.0,5,1111,29.0,843.0,843.0
0.076,6,10,1506,5,395,16.0,127.0,127.0,5,1111,16.0,843.0,843.0
0.02,6,6,716,3,458,7.0,302.0,302.0,3,258,6.0,102.0,102.0
40.072,17,10,676,5,460,10015.0,104.0,64.0,5,216,10017.0,20.0,15.0
40.051,17,10,676,5,460,10011.0,104.0,64.0,5,216,10011.0,20.0,15.0
40.059,17,10,676,5,460,10012.0,104.0,64.0,5,216,10014.0,20.0,15.0
0.006,6,10,1547,5,764,1.0,496.0,496.0,5,783,1.0,515.0,515.0
0.004,6,10,2006,5,927,1.0,659.0,659.0,5,1079,1.0,811.0,811.0
25.693,6,39,13714,19,8116,492.0,2891.0,1464.0,20,5598,1343.0,2667.0,435.0
0.015,6,7,695,4,448,5.0,232.0,232.0,3,247,6.0,83.0,83.0
0.01,6,12,1926,6,1189,1.0,659.0,434.0,6,737,2.0,417.0,417.0
0.121,6,10,1506,5,395,29.0,127.0,127.0,5,1111,26.0,843.0,843.0
0.005,6,10,2000,5,927,1.0,659.0,659.0,5,1073,1.0,805.0,805.0
0.004,6,10,1702,5,863,1.0,595.0,595.0,5,839,1.0,571.0,571.0
60.827,6,25,17488,14,9591,4679.0,2804.0,1477.0,11,7897,6069.0,2320.0,1219.0
0.118,6,10,1506,5,395,25.0,127.0,127.0,5,1111,24.0,843.0,843.0
40.094,17,10,676,5,460,10011.0,104.0,64.0,5,216,10015.0,20.0,15.0
369.541,6,22,2313,16,867,24636.0,195.0,195.0,6,1446,4636.0,419.0,398.0
0.006,6,10,2007,5,928,1.0,660.0,660.0,5,1079,1.0,811.0,811.0
240.012,6,9,787,5,488,60003.0,232.0,232.0,4,299,80002.0,83.0,83.0
0.001,17,2,166,1,75,0.0,47.0,47.0,1,91,0.0,63.0,63.0
0.045,6,13,3735,7,497,7.0,125.0,125.0,6,3238,9.0,1470.0,1459.0
310.319,17,20,1124,10,716,34467.0,48.0,43.0,10,408,34470.0,20.0,12.0
0.09,6,10,1506,5,395,19.0,127.0,127.0,5,1111,20.0,843.0,843.0
1770.306,6,84,4420,42,2210,43177.0,26.0,26.0,42,2210,43177.0,26.0,26.0
40.069,17,10,676,5,460,10014.0,104.0,64.0,5,216,10016.0,20.0,15.0
0.006,17,2,144,1,64,0.0,36.0,36.0,1,80,0.0,52.0,52.0
0.072,6,10,1506,5,395,17.0,127.0,127.0,5,1111,16.0,843.0,843.0
0.087,6,10,1506,5,395,21.0,127.0,127.0,5,1111,17.0,843.0,843.0
0.07,6,10,1506,5,395,14.0,127.0,127.0,5,1111,16.0,843.0,843.0
0.005,6,10,1989,5,927,1.0,659.0,659.0,5,1062,1.0,794.0,794.0
0.012,6,10,1983,5,910,3.0,642.0,642.0,5,1073,2.0,805.0,805.0
0.021,17,2,198,1,91,0.0,63.0,63.0,1,107,0.0,79.0,79.0
0.004,6,10,2006,5,927,1.0,659.0,659.0,5,1079,1.0,811.0,811.0
0.007,6,10,1983,5,910,1.0,642.0,642.0,5,1073,1.0,805.0,805.0
252.902,6,39,9948,16,6691,16860.0,1763.0,651.0,23,3257,11495.0,580.0,146.0
15.076,17,16,8603,8,6362,2149.0,1350.0,767.0,8,2241,2149.0,1350.0,252.0
0.007,6,12,1698,6,863,1.0,327.0,271.0,6,835,1.0,515.0,515.0
0.086,6,10,1506,5,395,18.0,127.0,127.0,5,1111,19.0,843.0,843.0
0.121,6,10,1506,5,395,28.0,127.0,127.0,5,1111,28.0,843.0,843.0
0.005,6,10,1989,5,927,1.0,659.0,659.0,5,1062,1.0,794.0,794.0
0.004,17,2,148,1,60,0.0,32.0,32.0,1,88,0.0,60.0,60.0
0.038,17,4,284,2,120,1.0,32.0,32.0,2,164,32.0,60.0,54.0
0.005,6,10,1854,5,889,1.0,621.0,621.0,5,965,1.0,697.0,697.0
0.005,17,2,179,1,71,0.0,43.0,43.0,1,108,0.0,80.0,80.0
0.122,6,10,1506,5,395,26.0,127.0,127.0,5,1111,24.0,843.0,843.0
369.894,6,22,2313,16,867,24659.0,195.0,195.0,6,1446,4640.0,419.0,398.0
0.089,6,10,1506,5,395,20.0,127.0,127.0,5,1111,21.0,843.0,843.0
0.006,17,2,179,1,71,0.0,43.0,43.0,1,108,0.0,80.0,80.0
0.009,6,10,1972,5,910,2.0,642.0,642.0,5,1062,2.0,794.0,794.0
0.072,6,10,1506,5,395,15.0,127.0,127.0,5,1111,15.0,843.0,843.0
0.006,6,10,1547,5,764,1.0,496.0,496.0,5,783,1.0,515.0,515.0
0.006,6,10,2007,5,928,1.0,660.0,660.0,5,1079,1.0,811.0,811.0
0.172,17,2,152,1,76,0.0,48.0,48.0,1,76,0.0,48.0,48.0
40.097,17,10,676,5,460,10019.0,104.0,64.0,5,216,10020.0,20.0,15.0
0.005,6,10,1702,5,863,1.0,595.0,595.0,5,839,1.0,571.0,571.0
0.055,17,2,162,1,65,0.0,37.0,37.0,1,97,0.0,69.0,69.0
0.005,6,10,1989,5,927,1.0,659.0,659.0,5,1062,1.0,794.0,794.0
0.005,17,2,170,1,65,0.0,37.0,37.0,1,105,0.0,77.0,77.0
0.004,17,2,148,1,60,0.0,32.0,32.0,1,88,0.0,60.0,60.0
0.045,17,2,152,1,76,0.0,48.0,48.0,1,76,0.0,48.0,48.0
0.006,17,2,179,1,71,0.0,43.0,43.0,1,108,0.0,80.0,80.0
0.069,17,8,3613,4,1874,23.0,1350.0,440.0,4,1739,11.0,1350.0,406.0
0.005,17,2,152,1,68,0.0,40.0,40.0,1,84,0.0,56.0,56.0
0.014,6,10,1983,5,910,3.0,642.0,642.0,5,1073,3.0,805.0,805.0
0.008,6,10,1989,5,910,2.0,642.0,642.0,5,1079,2.0,811.0,811.0
0.005,6,13,3690,7,452,0.0,80.0,80.0,6,3238,0.0,1470.0,1459.0
0.013,6,10,1990,5,911,3.0,643.0,643.0,5,1079,3.0,811.0,811.0
0.006,6,10,1643,5,860,1.0,592.0,592.0,5,783,1.0,515.0,515.0
0.005,6,10,1854,5,889,1.0,621.0,621.0,5,965,1.0,697.0,697.0
0.013,17,2,152,1,56,0.0,28.0,28.0,1,96,0.0,68.0,68.0
0.01,6,10,1972,5,910,2.0,642.0,642.0,5,1062,2.0,794.0,794.0
0.011,6,10,1643,5,860,2.0,592.0,592.0,5,783,2.0,515.0,515.0
0.001,17,2,164,1,74,0.0,46.0,46.0,1,90,0.0,62.0,62.0
0.018,6,10,1989,5,910,4.0,642.0,642.0,5,1079,4.0,811.0,811.0
0.094,6,10,1506,5,395,21.0,127.0,127.0,5,1111,20.0,843.0,843.0
0.016,6,10,1989,5,910,4.0,642.0,642.0,5,1079,4.0,811.0,811.0
0.087,6,10,1506,5,395,18.0,127.0,127.0,5,1111,21.0,843.0,843.0
421.927,6,47,15925,25,4387,17580.0,676.0,439.0,22,11538,17232.0,1402.0,741.0
0.094,6,10,1506,5,395,22.0,127.0,127.0,5,1111,20.0,843.0,843.0
0.012,6,10,1990,5,911,2.0,643.0,643.0,5,1079,2.0,811.0,811.0
40.056,17,10,676,5,460,10013.0,104.0,64.0,5,216,10013.0,20.0,15.0
0.004,6,10,1989,5,927,1.0,659.0,659.0,5,1062,1.0,794.0,794.0
0.08,6,10,1506,5,395,17.0,127.0,127.0,5,1111,18.0,843.0,843.0
0.005,6,10,2000,5,927,1.0,659.0,659.0,5,1073,1.0,805.0,805.0
0.112,6,10,1506,5,395,23.0,127.0,127.0,5,1111,24.0,843.0,843.0
0.11,6,10,1506,5,395,24.0,127.0,127.0,5,1111,24.0,843.0,843.0
300.833,6,38,11217,20,5699,15833.0,4080.0,973.0,18,5518,508.0,2667.0,435.0
0.012,6,10,1983,5,910,2.0,642.0,642.0,5,1073,3.0,805.0,805.0
309.993,17,20,1124,10,716,34429.0,48.0,43.0,10,408,34429.0,20.0,12.0
0.005,6,10,1643,5,860,1.0,592.0,592.0,5,783,1.0,515.0,515.0
0.011,6,13,3735,7,497,1.0,125.0,125.0,6,3238,2.0,1470.0,1459.0
0.029,6,13,4115,7,675,4.0,299.0,299.0,6,3440,4.0,1402.0,1040.0
0.021,6,10,1972,5,910,5.0,642.0,642.0,5,1062,5.0,794.0,794.0
0.012,6,10,1990,5,911,3.0,643.0,643.0,5,1079,3.0,811.0,811.0
0.085,6,10,1506,5,395,18.0,127.0,127.0,5,1111,20.0,843.0,843.0
0.021,6,10,1972,5,910,5.0,642.0,642.0,5,1062,5.0,794.0,794.0
0.131,6,10,1506,5,395,28.0,127.0,127.0,5,1111,29.0,843.0,843.0
0.005,6,10,2000,5,927,1.0,659.0,659.0,5,1073,1.0,805.0,805.0
0.005,17,2,170,1,65,0.0,37.0,37.0,1,105,0.0,77.0,77.0
0.011,6,10,1972,5,910,2.0,642.0,642.0,5,1062,2.0,794.0,794.0
0.009,17,2,136,1,60,0.0,32.0,32.0,1,76,0.0,48.0,48.0
0.004,6,10,1702,5,863,0.0,595.0,595.0,5,839,1.0,571.0,571.0
0.006,6,10,1547,5,764,1.0,496.0,496.0,5,783,1.0,515.0,515.0
0.015,6,10,1989,5,910,3.0,642.0,642.0,5,1079,3.0,811.0,811.0
0.004,17,2,136,1,60,0.0,32.0,32.0,1,76,0.0,48.0,48.0
0.083,6,10,1506,5,395,18.0,127.0,127.0,5,1111,18.0,843.0,843.0
308.344,17,20,1124,10,716,34246.0,48.0,43.0,10,408,34246.0,20.0,12.0
0.04,17,2,186,1,61,0.0,33.0,33.0,1,125,0.0,97.0,97.0
0.007,17,2,166,1,75,0.0,47.0,47.0,1,91,0.0,63.0,63.0
0.01,6,10,1989,5,910,2.0,642.0,642.0,5,1079,2.0,811.0,811.0
0.001,17,2,136,1,60,0.0,32.0,32.0,1,76,0.0,48.0,48.0
0.005,6,10,1854,5,889,1.0,621.0,621.0,5,965,1.0,697.0,697.0
0.005,17,2,214,1,75,0.0,47.0,47.0,1,139,0.0,111.0,111.0
0.005,6,13,3747,7,509,0.0,137.0,137.0,6,3238,0.0,1470.0,1459.0
0.093,6,10,1506,5,395,16.0,127.0,127.0,5,1111,21.0,843.0,843.0
0.003,17,2,148,1,60,0.0,32.0,32.0,1,88,0.0,60.0,60.0
0.008,6,12,1926,6,1189,1.0,659.0,434.0,6,737,1.0,417.0,417.0
40.058,17,10,676,5,460,10013.0,104.0,64.0,5,216,10013.0,20.0,15.0
0.014,6,10,1762,5,911,3.0,643.0,643.0,5,851,3.0,583.0,583.0
0.068,6,10,1506,5,395,14.0,127.0,127.0,5,1111,16.0,843.0,843.0
0.111,6,10,1506,5,395,27.0,127.0,127.0,5,1111,25.0,843.0,843.0
0.005,6,10,1989,5,927,1.0,659.0,659.0,5,1062,1.0,794.0,794.0
240.152,6,45,6378,22,3225,11435.0,588.0,230.0,23,3153,10915.0,580.0,194.0
0.005,17,2,136,1,60,0.0,32.0,32.0,1,76,0.0,48.0,48.0
0.019,6,10,1989,5,910,4.0,642.0,642.0,5,1079,4.0,811.0,811.0
40.058,17,10,676,5,460,10013.0,104.0,64.0,5,216,10013.0,20.0,15.0
40.055,17,10,676,5,460,10013.0,104.0,64.0,5,216,10012.0,20.0,15.0
0.083,6,10,1506,5,395,19.0,127.0,127.0,5,1111,17.0,843.0,843.0
308.789,17,18,1008,9,640,38581.0,48.0,43.0,9,368,38581.0,20.0,12.0
300.453,6,16,2170,9,684,37535.0,146.0,146.0,7,1486,50047.0,419.0,398.0
0.217,6,16,2670,8,1396,31.0,533.0,324.0,8,1274,20.0,529.0,212.0
0.008,6,10,1631,5,848,2.0,580.0,580.0,5,783,2.0,515.0,515.0
0.006,17,2,170,1,65,0.0,37.0,37.0,1,105,0.0,77.0,77.0
0.005,6,10,2000,5,927,1.0,659.0,659.0,5,1073,1.0,805.0,805.0
300.032,6,12,1782,7,1348,50005.0,494.0,494.0,5,434,75007.0,83.0,83.0
0.108,6,10,1506,5,395,24.0,127.0,127.0,5,1111,24.0,843.0,843.0
0.005,6,13,3747,7,509,0.0,137.0,137.0,6,3238,1.0,1470.0,1459.0
0.012,6,10,1972,5,910,3.0,642.0,642.0,5,1062,2.0,794.0,794.0
40.068,17,10,676,5,460,10015.0,104.0,64.0,5,216,10016.0,20.0,15.0
0.062,17,2,152,1,76,0.0,48.0,48.0,1,76,0.0,48.0,48.0
0.086,6,10,1506,5,395,18.0,127.0,127.0,5,1111,18.0,843.0,843.0
308.572,17,20,1124,10,716,34279.0,48.0,43.0,10,408,34279.0,20.0,12.0
40.055,17,10,676,5,460,10013.0,104.0,64.0,5,216,10012.0,20.0,15.0
0.009,6,10,1989,5,910,2.0,642.0,642.0,5,1079,2.0,811.0,811.0
178.039,17,80,11266,40,2672,4564.0,44.0,38.0,40,8594,4564.0,239.0,186.0
0.005,6,10,1774,5,923,1.0,655.0,655.0,5,851,1.0,583.0,583.0
0.003,17,2,136,1,60,0.0,32.0,32.0,1,76,0.0,48.0,48.0
0.01,6,10,1989,5,910,2.0,642.0,642.0,5,1079,2.0,811.0,811.0
127.576,6,26,9525,12,1627,73.0,794.0,367.0,14,7898,9803.0,1360.0,732.0
373.996,6,22,2313,16,867,24933.0,195.0,195.0,6,1446,4642.0,419.0,398.0
0.018,6,10,1989,5,910,4.0,642.0,642.0,5,1079,4.0,811.0,811.0
240.008,6,9,787,5,488,60002.0,232.0,232.0,4,299,80002.0,83.0,83.0
0.011,6,10,1990,5,911,2.0,643.0,643.0,5,1079,2.0,811.0,811.0
0.004,17,2,148,1,60,0.0,32.0,32.0,1,88,0.0,60.0,60.0
0.005,6,14,3736,7,446,0.0,74.0,74.0,7,3290,0.0,1448.0,972.0
0.12,6,10,1506,5,395,26.0,127.0,127.0,5,1111,25.0,843.0,843.0
0.006,6,10,1854,5,889,1.0,621.0,621.0,5,965,1.0,697.0,697.0
0.152,6,10,1506,5,395,34.0,127.0,127.0,5,1111,36.0,843.0,843.0
0.004,6,10,1779,5,928,1.0,660.0,660.0,5,851,1.0,583.0,583.0
0.096,6,10,1506,5,395,19.0,127.0,127.0,5,1111,23.0,843.0,843.0
0.004,17,2,136,1,60,0.0,32.0,32.0,1,76,0.0,48.0,48.0
0.004,6,10,2000,5,927,1.0,659.0,659.0,5,1073,1.0,805.0,805.0
0.005,17,2,178,1,65,0.0,37.0,37.0,1,113,0.0,85.0,85.0
0.004,6,10,2007,5,928,1.0,660.0,660.0,5,1079,1.0,811.0,811.0
0.077,6,10,1506,5,395,17.0,127.0,127.0,5,1111,14.0,843.0,843.0
300.797,6,38,11450,20,5932,15831.0,4080.0,1020.0,18,5518,507.0,2667.0,435.0
0.097,6,10,1506,5,395,20.0,127.0,127.0,5,1111,20.0,843.0,843.0
240.241,6,22,11426,13,6849,20020.0,2736.0,1029.0,9,4577,30029.0,1655.0,1367.0
240.01,6,9,787,5,488,60002.0,232.0,232.0,4,299,80002.0,83.0,83.0
0.129,6,10,1506,5,395,27.0,127.0,127.0,5,1111,27.0,843.0,843.0
0.0,17,2,132,1,58,0.0,30.0,30.0,1,74,0.0,46.0,46.0
0.004,6,10,2000,5,927,1.0,659.0,659.0,5,1073,1.0,805.0,805.0
175.245,17,80,11329,40,2673,4493.0,44.0,38.0,40,8656,4493.0,261.0,188.0
0.004,17,2,148,1,60,0.0,32.0,32.0,1,88,0.0,60.0,60.0
0.015,6,10,1989,5,910,3.0,642.0,642.0,5,1079,3.0,811.0,811.0
0.004,17,2,148,1,60,0.0,32.0,32.0,1,88,0.0,60.0,60.0
0.067,17,8,3613,4,1874,22.0,1350.0,440.0,4,1739,11.0,1350.0,406.0
0.005,6,10,2006,5,927,1.0,659.0,659.0,5,1079,1.0,811.0,811.0
0.006,17,2,170,1,65,0.0,37.0,37.0,1,105,0.0,77.0,77.0
0.01,6,10,1989,5,910,2.0,642.0,642.0,5,1079,2.0,811.0,811.0
0.148,6,10,1506,5,395,35.0,127.0,127.0,5,1111,31.0,843.0,843.0
0.014,6,10,1677,5,827,3.0,559.0,559.0,5,850,3.0,582.0,582.0
240.276,6,40,8615,20,5634,12646.0,2883.0,573.0,20,2981,12646.0,580.0,241.0
0.005,6,10,1989,5,927,1.0,659.0,659.0,5,1062,1.0,794.0,794.0
0.001,17,2,136,1,60,0.0,32.0,32.0,1,76,0.0,48.0,48.0
371.312,6,22,2313,16,867,24754.0,195.0,195.0,6,1446,4650.0,419.0,398.0
0.011,6,10,1972,5,910,2.0,642.0,642.0,5,1062,2.0,794.0,794.0
0.003,17,2,148,1,60,0.0,32.0,32.0,1,88,0.0,60.0,60.0
0.008,6,10,1989,5,910,2.0,642.0,642.0,5,1079,2.0,811.0,811.0
0.001,17,2,166,1,75,0.0,47.0,47.0,1,91,0.0,63.0,63.0
309.382,17,20,1124,10,716,34362.0,48.0,43.0,10,408,34363.0,20.0,12.0
0.006,6,10,2006,5,927,1.0,659.0,659.0,5,1079,1.0,811.0,811.0
0.003,17,2,148,1,60,0.0,32.0,32.0,1,88,0.0,60.0,60.0
0.009,6,12,1926,6,1189,1.0,659.0,434.0,6,737,1.0,417.0,417.0
0.011,6,10,1972,5,910,2.0,642.0,642.0,5,1062,2.0,794.0,794.0
0.005,6,13,3690,7,452,0.0,80.0,80.0,6,3238,0.0,1470.0,1459.0
0.005,17,2,169,1,62,0.0,34.0,34.0,1,107,0.0,79.0,79.0
0.005,17,2,144,1,64,0.0,36.0,36.0,1,80,0.0,52.0,52.0
0.073,6,10,1506,5,395,16.0,127.0,127.0,5,1111,15.0,843.0,843.0
15.078,17,16,9125,8,6916,2149.0,1350.0,836.0,8,2209,2149.0,1350.0,248.0
0.005,6,10,2006,5,927,1.0,659.0,659.0,5,1079,1.0,811.0,811.0
1756.643,6,103,6166,59,3473,30286.0,27.0,27.0,44,2693,40851.0,27.0,27.0
0.01,6,14,3787,7,497,1.0,125.0,125.0,7,3290,1.0,1448.0,972.0
0.004,6,10,1774,5,923,1.0,655.0,655.0,5,851,1.0,583.0,583.0
0.101,6,10,1506,5,395,23.0,127.0,127.0,5,1111,22.0,843.0,843.0
0.006,17,2,164,1,74,0.0,46.0,46.0,1,90,0.0,62.0,62.0
0.005,6,10,1989,5,927,1.0,659.0,659.0,5,1062,1.0,794.0,794.0
0.005,6,10,2007,5,928,1.0,660.0,660.0,5,1079,1.0,811.0,811.0
0.005,6,10,2006,5,927,1.0,659.0,659.0,5,1079,1.0,811.0,811.0
0.005,6,10,1989,5,927,1.0,659.0,659.0,5,1062,1.0,794.0,794.0
0.006,17,2,152,1,68,0.0,40.0,40.0,1,84,0.0,56.0,56.0
0.02,6,10,1779,5,928,5.0,660.0,660.0,5,851,5.0,583.0,583.0
40.056,17,10,676,5,460,10013.0,104.0,64.0,5,216,10013.0,20.0,15.0
0.006,17,2,170,1,65,0.0,37.0,37.0,1,105,0.0,77.0,77.0
354.049,6,21,1794,16,1030,23603.0,190.0,190.0,5,764,60002.0,463.0,248.0
284.516,6,24,6206,11,1226,28451.0,267.0,156.0,13,4980,23708.0,1400.0,742.0
10.822,17,28,4422,14,1994,824.0,269.0,114.0,14,2428,823.0,587.0,145.0
0.124,6,10,1506,5,395,27.0,127.0,127.0,5,1111,26.0,843.0,843.0
0.006,6,10,1854,5,889,1.0,621.0,621.0,5,965,1.0,697.0,697.0
40.058,17,10,676,5,460,10012.0,104.0,64.0,5,216,10013.0,20.0,15.0
0.126,6,10,1506,5,395,27.0,127.0,127.0,5,1111,30.0,843.0,843.0
0.005,6,10,2000,5,927,1.0,659.0,659.0,5,1073,1.0,805.0,805.0
0.007,6,10,1547,5,764,1.0,496.0,496.0,5,783,1.0,515.0,515.0
0.004,17,2,148,1,60,0.0,32.0,32.0,1,88,0.0,60.0,60.0
0.011,6,10,1631,5,848,2.0,580.0,580.0,5,783,2.0,515.0,515.0
0.14,6,10,1506,5,395,33.0,127.0,127.0,5,1111,30.0,843.0,843.0
0.008,6,7,695,4,448,2.0,232.0,232.0,3,247,3.0,83.0,83.0
11.131,17,28,4421,14,1994,843.0,269.0,114.0,14,2427,843.0,586.0,145.0
0.075,6,10,1506,5,395,16.0,127.0,127.0,5,1111,16.0,843.0,843.0
367.166,6,22,2313,16,867,24477.0,195.0,195.0,6,1446,4650.0,419.0,398.0
0.007,6,10,1989,5,910,1.0,642.0,642.0,5,1079,1.0,811.0,811.0
0.091,6,10,1506,5,395,18.0,127.0,127.0,5,1111,21.0,843.0,843.0
0.005,6,10,1643,5,860,1.0,592.0,592.0,5,783,1.0,515.0,515.0
0.122,6,10,1506,5,395,28.0,127.0,127.0,5,1111,27.0,843.0,843.0
0.01,6,10,1983,5,910,2.0,642.0,642.0,5,1073,2.0,805.0,805.0
0.045,6,10,1677,5,827,11.0,559.0,559.0,5,850,11.0,582.0,582.0
0.011,6,13,3735,7,497,1.0,125.0,125.0,6,3238,2.0,1470.0,1459.0
0.006,6,10,1547,5,764,1.0,496.0,496.0,5,783,1.0,515.0,515.0
0.005,6,14,3799,7,509,0.0,137.0,137.0,7,3290,0.0,1448.0,972.0
0.005,6,10,2007,5,928,1.0,660.0,660.0,5,1079,1.0,811.0,811.0
300.255,6,16,2170,9,684,37511.0,146.0,146.0,7,1486,50014.0,419.0,398.0
0.013,6,10,1990,5,911,3.0,643.0,643.0,5,1079,3.0,811.0,811.0
0.013,6,10,1972,5,910,3.0,642.0,642.0,5,1062,3.0,794.0,794.0
0.167,17,4,596,2,122,126.0,33.0,33.0,2,474,127.0,323.0,209.0
354.055,6,20,2210,6,1308,12007.0,494.0,494.0,14,902,27234.0,83.0,83.0
0.073,6,10,1506,5,395,16.0,127.0,127.0,5,1111,15.0,843.0,843.0
313.763,17,20,1124,10,716,34848.0,48.0,43.0,10,408,34848.0,20.0,12.0
1756.063,6,105,6270,60,3525,29763.0,27.0,27.0,45,2745,39909.0,27.0,27.0
0.008,6,10,1631,5,848,2.0,580.0,580.0,5,783,1.0,515.0,515.0
0.072,17,2,148,1,60,0.0,32.0,32.0,1,88,0.0,60.0,60.0
0.111,6,10,1506,5,395,27.0,127.0,127.0,5,1111,21.0,843.0,843.0
40.048,17,10,676,5,460,10011.0,104.0,64.0,5,216,10011.0,20.0,15.0
1797.894,6,318,77467,144,60287,12572.0,2736.0,1076.0,174,17180,10392.0,580.0,69.0
0.006,6,10,1547,5,764,1.0,496.0,496.0,5,783,1.0,515.0,515.0
0.019,6,13,3735,7,497,3.0,125.0,125.0,6,3238,3.0,1470.0,1459.0
0.071,17,2,136,1,60,0.0,32.0,32.0,1,76,0.0,48.0,48.0
0.018,6,10,1631,5,848,4.0,580.0,580.0,5,783,4.0,515.0,515.0
0.006,6,10,1547,5,764,1.0,496.0,496.0,5,783,1.0,515.0,515.0
40.075,17,10,676,5,460,10016.0,104.0,64.0,5,216,10018.0,20.0,15.0
0.013,6,13,3735,7,497,2.0,125.0,125.0,6,3238,2.0,1470.0,1459.0
0.072,17,4,284,2,120,0.0,32.0,32.0,2,164,32.0,60.0,54.0
0.005,17,2,179,1,71,0.0,43.0,43.0,1,108,0.0,80.0,80.0
0.005,6,10,2000,5,927,1.0,659.0,659.0,5,1073,1.0,805.0,805.0
240.18,6,40,5489,20,2430,12640.0,581.0,195.0,20,3059,12640.0,662.0,251.0
0.006,6,10,1547,5,764,1.0,496.0,496.0,5,783,1.0,515.0,515.0
0.005,6,10,1689,5,839,1.0,571.0,571.0,5,850,1.0,582.0,582.0
352.253,6,20,2210,6,1308,12003.0,494.0,494.0,14,902,27096.0,83.0,83.0
0.005,17,2,164,1,74,0.0,46.0,46.0,1,90,0.0,62.0,62.0
0.001,17,2,180,1,66,0.0,38.0,38.0,1,114,0.0,86.0,86.0
0.006,6,10,1547,5,764,1.0,496.0,496.0,5,783,1.0,515.0,515.0
0.041,17,4,284,2,120,0.0,32.0,32.0,2,164,37.0,60.0,54.0
0.006,17,2,194,1,59,0.0,31.0,31.0,1,135,0.0,107.0,107.0
0.017,6,10,1983,5,910,4.0,642.0,642.0,5,1073,4.0,805.0,805.0
0.012,6,10,1990,5,911,2.0,643.0,643.0,5,1079,2.0,811.0,811.0
0.005,6,10,2006,5,927,1.0,659.0,659.0,5,1079,1.0,811.0,811.0
0.003,17,2,148,1,60,0.0,32.0,32.0,1,88,0.0,60.0,60.0
0.012,6,10,1972,5,910,2.0,642.0,642.0,5,1062,2.0,794.0,794.0
0.076,6,10,1506,5,395,17.0,127.0,127.0,5,1111,13.0,843.0,843.0
40.054,17,10,676,5,460,10012.0,104.0,64.0,5,216,10012.0,20.0,15.0
0.015,6,10,1990,5,911,3.0,643.0,643.0,5,1079,3.0,811.0,811.0
0.015,6,10,1677,5,827,3.0,559.0,559.0,5,850,3.0,582.0,582.0
0.006,6,10,1547,5,764,1.0,496.0,496.0,5,783,1.0,515.0,515.0
0.004,6,10,2006,5,927,1.0,659.0,659.0,5,1079,1.0,811.0,811.0
0.005,6,10,2006,5,927,1.0,659.0,659.0,5,1079,1.0,811.0,811.0
0.005,17,2,212,1,74,0.0,46.0,46.0,1,138,0.0,110.0,110.0
40.058,17,10,676,5,460,10013.0,104.0,64.0,5,216,10012.0,20.0,15.0
0.084,6,10,1506,5,395,20.0,127.0,127.0,5,1111,17.0,843.0,843.0
0.005,6,10,1779,5,928,1.0,660.0,660.0,5,851,1.0,583.0,583.0
0.004,17,2,140,1,62,0.0,34.0,34.0,1,78,0.0,50.0,50.0
0.07,6,10,1506,5,395,16.0,127.0,127.0,5,1111,13.0,843.0,843.0
0.108,6,10,1506,5,395,23.0,127.0,127.0,5,1111,21.0,843.0,843.0
0.006,6,10,1643,5,860,1.0,592.0,592.0,5,783,1.0,515.0,515.0
0.009,6,10,1990,5,911,2.0,643.0,643.0,5,1079,2.0,811.0,811.0
0.042,17,4,284,2,120,0.0,32.0,32.0,2,164,5.0,60.0,54.0
0.087,6,10,1506,5,395,20.0,127.0,127.0,5,1111,19.0,843.0,843.0
0.005,17,2,170,1,65,0.0,37.0,37.0,1,105,0.0,77.0,77.0
0.011,6,10,1972,5,910,2.0,642.0,642.0,5,1062,2.0,794.0,794.0
0.013,6,10,1677,5,827,3.0,559.0,559.0,5,850,3.0,582.0,582.0
0.133,6,10,1506,5,395,32.0,127.0,127.0,5,1111,28.0,843.0,843.0
0.012,6,10,1972,5,910,3.0,642.0,642.0,5,1062,3.0,794.0,794.0
0.005,17,2,164,1,74,0.0,46.0,46.0,1,90,0.0,62.0,62.0
0.011,17,2,157,1,59,0.0,31.0,31.0,1,98,0.0,70.0,70.0
0.013,6,10,1677,5,827,3.0,559.0,559.0,5,850,3.0,582.0,582.0
0.01,6,13,3735,7,497,1.0,125.0,125.0,6,3238,2.0,1470.0,1459.0
0.005,6,10,2000,5,927,1.0,659.0,659.0,5,1073,1.0,805.0,805.0
300.153,6,39,10113,21,4595,14999.0,1360.0,620.0,18,5518,17646.0,2667.0,435.0
0.02,6,10,1990,5,911,4.0,643.0,643.0,5,1079,4.0,811.0,811.0
0.013,6,10,1983,5,910,3.0,642.0,642.0,5,1073,3.0,805.0,805.0
240.114,6,31,9267,15,6904,17151.0,2028.0,680.0,16,2363,16007.0,580.0,190.0
0.006,6,10,1689,6,891,1.0,571.0,571.0,4,798,2.0,582.0,582.0
0.005,6,10,2007,5,928,1.0,660.0,660.0,5,1079,1.0,811.0,811.0
0.004,17,4,284,2,120,1.0,32.0,32.0,2,164,0.0,60.0,54.0
0.086,6,10,1506,5,395,19.0,127.0,127.0,5,1111,16.0,843.0,843.0
0.396,17,55,35876,32,29921,12.0,1350.0,907.0,23,5955,15.0,1350.0,230.0
0.064,6,10,1506,5,395,15.0,127.0,127.0,5,1111,14.0,843.0,843.0
0.005,17,2,170,1,65,0.0,37.0,37.0,1,105,0.0,77.0,77.0
0.01,6,10,1762,5,911,2.0,643.0,643.0,5,851,2.0,583.0,583.0
0.005,6,10,2006,5,927,1.0,659.0,659.0,5,1079,1.0,811.0,811.0
0.011,6,10,1631,5,848,2.0,580.0,580.0,5,783,2.0,515.0,515.0
0.005,6,10,2006,5,927,1.0,659.0,659.0,5,1079,1.0,811.0,811.0
0.003,17,2,162,1,65,0.0,37.0,37.0,1,97,0.0,69.0,69.0
0.007,6,10,1983,5,910,1.0,642.0,642.0,5,1073,1.0,805.0,805.0
0.009,6,10,1677,5,827,2.0,559.0,559.0,5,850,2.0,582.0,582.0
0.004,17,2,136,1,60,0.0,32.0,32.0,1,76,0.0,48.0,48.0
0.014,6,10,1762,5,911,3.0,643.0,643.0,5,851,3.0,583.0,583.0
40.08,17,10,676,5,460,10019.0,104.0,64.0,5,216,10019.0,20.0,15.0
0.081,6,10,1506,5,395,17.0,127.0,127.0,5,1111,19.0,843.0,843.0
0.008,6,12,1926,6,1189,1.0,659.0,434.0,6,737,1.0,417.0,417.0
0.001,17,2,180,1,66,0.0,38.0,38.0,1,114,0.0,86.0,86.0
0.003,17,2,136,1,60,0.0,32.0,32.0,1,76,0.0,48.0,48.0
0.016,6,10,1631,5,848,4.0,580.0,580.0,5,783,4.0,515.0,515.0
59.493,6,37,9723,18,4165,522.0,1732.0,853.0,19,5558,3295.0,1360.0,398.0
0.013,6,10,1677,5,827,3.0,559.0,559.0,5,850,3.0,582.0,582.0
0.006,6,10,1854,5,889,1.0,621.0,621.0,5,965,1.0,697.0,697.0
0.013,6,10,1989,5,910,3.0,642.0,642.0,5,1079,3.0,811.0,811.0
0.005,6,13,3747,7,509,0.0,137.0,137.0,6,3238,1.0,1470.0,1459.0
0.005,6,10,2006,5,927,1.0,659.0,659.0,5,1079,1.0,811.0,811.0
0.005,6,10,2007,5,928,1.0,660.0,660.0,5,1079,1.0,811.0,811.0
0.021,6,10,1989,5,910,5.0,642.0,642.0,5,1079,5.0,811.0,811.0
0.005,6,10,1547,5,764,1.0,496.0,496.0,5,783,1.0,515.0,515.0
0.104,6,10,1506,5,395,21.0,127.0,127.0,5,1111,21.0,843.0,843.0
40.058,17,10,676,5,460,10013.0,104.0,64.0,5,216,10013.0,20.0,15.0
0.02,6,10,1972,5,910,5.0,642.0,642.0,5,1062,4.0,794.0,794.0
0.082,17,4,284,2,120,0.0,32.0,32.0,2,164,29.0,60.0,54.0
0.009,6,13,3747,7,509,1.0,137.0,137.0,6,3238,1.0,1470.0,1459.0
0.001,17,2,179,1,62,0.0,34.0,34.0,1,117,0.0,89.0,89.0
0.01,6,10,1989,5,910,2.0,642.0,642.0,5,1079,2.0,811.0,811.0
15.074,17,16,9303,8,6912,2149.0,1350.0,836.0,8,2391,2149.0,1350.0,270.0
0.004,17,2,148,1,60,0.0,32.0,32.0,1,88,0.0,60.0,60.0
0.009,6,12,1926,6,1189,1.0,659.0,434.0,6,737,1.0,417.0,417.0
289.375,6,405,348865,198,21856,1468.0,2694.0,889.0,207,327009,1404.0,2804.0,1638.0
0.204,6,16,2669,8,1395,29.0,533.0,323.0,8,1274,18.0,529.0,212.0
0.005,17,2,170,1,65,0.0,37.0,37.0,1,105,0.0,77.0,77.0
0.016,6,10,1677,5,827,3.0,559.0,559.0,5,850,3.0,582.0,582.0
40.083,17,10,676,5,460,10017.0,104.0,64.0,5,216,10020.0,20.0,15.0
0.018,6,10,1677,5,827,4.0,559.0,559.0,5,850,4.0,582.0,582.0
0.01,6,10,1990,5,911,2.0,643.0,643.0,5,1079,2.0,811.0,811.0
0.009,6,10,1989,5,910,2.0,642.0,642.0,5,1079,2.0,811.0,811.0
0.005,6,10,2006,5,927,1.0,659.0,659.0,5,1079,1.0,811.0,811.0
0.01,6,10,1990,5,911,2.0,643.0,643.0,5,1079,2.0,811.0,811.0
0.005,6,10,2006,5,927,1.0,659.0,659.0,5,1079,1.0,811.0,811.0
0.015,6,10,1972,5,910,3.0,642.0,642.0,5,1062,3.0,794.0,794.0
0.009,6,10,1990,5,911,2.0,643.0,643.0,5,1079,2.0,811.0,811.0
0.006,17,2,214,1,75,0.0,47.0,47.0,1,139,0.0,111.0,111.0
0.011,6,10,1983,5,910,2.0,642.0,642.0,5,1073,2.0,805.0,805.0
40.055,17,10,676,5,460,10013.0,104.0,64.0,5,216,10012.0,20.0,15.0
0.048,6,20,9974,11,704,4.0,124.0,124.0,9,9270,5.0,2896.0,1758.0
0.006,17,2,214,1,75,0.0,47.0,47.0,1,139,0.0,111.0,111.0
0.068,6,10,1506,5,395,15.0,127.0,127.0,5,1111,13.0,843.0,843.0
0.013,6,10,1631,5,848,3.0,580.0,580.0,5,783,3.0,515.0,515.0
0.006,6,10,1547,5,764,1.0,496.0,496.0,5,783,1.0,515.0,515.0
0.019,6,10,1989,5,910,4.0,642.0,642.0,5,1079,4.0,811.0,811.0
0.111,6,10,1506,5,395,25.0,127.0,127.0,5,1111,25.0,843.0,843.0
0.16,6,10,1506,5,395,39.0,127.0,127.0,5,1111,37.0,843.0,843.0
0.005,6,10,2006,5,927,1.0,659.0,659.0,5,1079,1.0,811.0,811.0
0.006,6,10,1689,5,839,1.0,571.0,571.0,5,850,1.0,582.0,582.0
0.077,6,10,1506,5,395,17.0,127.0,127.0,5,1111,17.0,843.0,843.0
0.146,6,10,1506,5,395,36.0,127.0,127.0,5,1111,32.0,843.0,843.0
0.012,6,10,1972,5,910,3.0,642.0,642.0,5,1062,3.0,794.0,794.0
308.65,17,20,1124,10,716,34279.0,48.0,43.0,10,408,34279.0,20.0,12.0
0.005,6,13,3690,7,452,0.0,80.0,80.0,6,3238,1.0,1470.0,1459.0
0.073,6,10,1506,5,395,16.0,127.0,127.0,5,1111,16.0,843.0,843.0
0.006,17,2,144,1,64,0.0,36.0,36.0,1,80,0.0,52.0,52.0
40.066,17,10,676,5,460,10013.0,104.0,64.0,5,216,10015.0,20.0,15.0
0.011,6,10,1989,5,910,2.0,642.0,642.0,5,1079,2.0,811.0,811.0
0.005,6,10,1689,5,839,1.0,571.0,571.0,5,850,1.0,582.0,582.0
0.003,17,2,136,1,60,0.0,32.0,32.0,1,76,0.0,48.0,48.0
0.006,6,10,1547,5,764,1.0,496.0,496.0,5,783,1.0,515.0,515.0
0.063,6,10,1506,5,395,13.0,127.0,127.0,5,1111,14.0,843.0,843.0
0.079,6,10,1506,5,395,16.0,127.0,127.0,5,1111,19.0,843.0,843.0
0.009,6,12,1926,6,1189,1.0,659.0,434.0,6,737,1.0,417.0,417.0
0.006,6,10,1547,5,764,1.0,496.0,496.0,5,783,1.0,515.0,515.0
0.137,6,10,1506,5,395,30.0,127.0,127.0,5,1111,30.0,843.0,843.0
309.733,17,20,1124,10,716,34400.0,48.0,43.0,10,408,34400.0,20.0,12.0
0.008,6,10,1983,5,910,1.0,642.0,642.0,5,1073,1.0,805.0,805.0
0.005,6,10,2006,5,927,1.0,659.0,659.0,5,1079,1.0,811.0,811.0
0.001,17,2,180,1,66,0.0,38.0,38.0,1,114,0.0,86.0,86.0
0.015,6,10,1983,5,910,3.0,642.0,642.0,5,1073,3.0,805.0,805.0
0.004,6,10,1774,5,923,1.0,655.0,655.0,5,851,1.0,583.0,583.0
0.01,6,10,1989,5,910,2.0,642.0,642.0,5,1079,2.0,811.0,811.0
15.073,17,14,9190,8,6902,2149.0,1350.0,834.0,6,2288,3008.0,1350.0,353.0
0.006,6,10,1547,5,764,1.0,496.0,496.0,5,783,1.0,515.0,515.0
353.274,6,20,2210,6,1308,12004.0,494.0,494.0,14,902,27174.0,83.0,83.0
0.006,6,10,1989,5,927,1.0,659.0,659.0,5,1062,1.0,794.0,794.0
0.001,17,2,180,1,66,0.0,38.0,38.0,1,114,0.0,86.0,86.0
0.162,6,162,152125,96,5840,1.0,504.0,276.0,66,146285,2.0,4206.0,2231.0
0.068,6,10,1506,5,395,16.0,127.0,127.0,5,1111,15.0,843.0,843.0
0.123,6,10,1506,5,395,29.0,127.0,127.0,5,1111,26.0,843.0,843.0
0.014,6,10,1990,5,911,3.0,643.0,643.0,5,1079,3.0,811.0,811.0
0.073,6,10,1506,5,395,12.0,127.0,127.0,5,1111,16.0,843.0,843.0
0.013,6,10,1983,5,910,3.0,642.0,642.0,5,1073,3.0,805.0,805.0
11.119,17,28,4420,14,1995,842.0,270.0,114.0,14,2425,842.0,588.0,145.0
0.005,6,10,2007,5,928,1.0,660.0,660.0,5,1079,1.0,811.0,811.0
0.088,6,10,1506,5,395,19.0,127.0,127.0,5,1111,17.0,843.0,843.0
0.06,17,2,152,1,76,0.0,48.0,48.0,1,76,0.0,48.0,48.0
0.006,6,10,1989,5,927,1.0,659.0,659.0,5,1062,1.0,794.0,794.0
0.015,6,10,1631,5,848,3.0,580.0,580.0,5,783,3.0,515.0,515.0
0.005,6,10,1702,5,863,1.0,595.0,595.0,5,839,1.0,571.0,571.0
0.043,17,2,152,1,76,0.0,48.0,48.0,1,76,0.0,48.0,48.0
0.009,6,10,1989,5,910,2.0,642.0,642.0,5,1079,2.0,811.0,811.0
0.003,17,2,136,1,60,0.0,32.0,32.0,1,76,0.0,48.0,48.0
15.072,17,14,9190,8,6902,2149.0,1350.0,834.0,6,2288,3008.0,1350.0,353.0
40.056,17,10,676,5,460,10013.0,104.0,64.0,5,216,10013.0,20.0,15.0
0.015,6,10,1989,5,910,3.0,642.0,642.0,5,1079,3.0,811.0,811.0
0.014,6,10,1972,5,910,3.0,642.0,642.0,5,1062,3.0,794.0,794.0
301.314,6,59,25920,31,19773,10043.0,2720.0,1233.0,28,6147,338.0,2667.0,385.0
0.008,6,10,1762,5,911,1.0,643.0,643.0,5,851,2.0,583.0,583.0
1.029,6,13,3930,7,2139,128.0,1328.0,923.0,6,1791,154.0,1539.0,1539.0
0.005,6,10,1643,5,860,1.0,592.0,592.0,5,783,1.0,515.0,515.0
0.008,6,10,1989,5,910,1.0,642.0,642.0,5,1079,2.0,811.0,811.0
0.13,6,14,4390,8,923,18.0,238.0,166.0,6,3467,17.0,1402.0,786.0
0.001,17,2,136,1,60,0.0,32.0,32.0,1,76,0.0,48.0,48.0
0.013,6,10,1972,5,910,3.0,642.0,642.0,5,1062,3.0,794.0,794.0
0.005,6,10,1643,5,860,1.0,592.0,592.0,5,783,1.0,515.0,515.0
0.008,6,10,1989,5,927,1.0,659.0,659.0,5,1062,2.0,794.0,794.0
0.093,6,10,1506,5,395,22.0,127.0,127.0,5,1111,19.0,843.0,843.0
0.001,17,2,180,1,66,0.0,38.0,38.0,1,114,0.0,86.0,86.0
301.026,6,46,18217,24,12310,13088.0,4080.0,1414.0,22,5907,422.0,2667.0,385.0
0.005,6,14,3742,7,452,0.0,80.0,80.0,7,3290,0.0,1448.0,972.0
0.008,6,10,1989,5,910,2.0,642.0,642.0,5,1079,2.0,811.0,811.0
0.014,6,10,1989,5,910,3.0,642.0,642.0,5,1079,3.0,811.0,811.0
0.001,17,2,180,1,66,0.0,38.0,38.0,1,114,0.0,86.0,86.0
0.012,6,10,1990,5,911,2.0,643.0,643.0,5,1079,3.0,811.0,811.0
0.006,17,2,179,1,71,0.0,43.0,43.0,1,108,0.0,80.0,80.0
0.011,6,10,1983,5,910,2.0,642.0,642.0,5,1073,2.0,805.0,805.0
40.075,17,10,676,5,460,10017.0,104.0,64.0,5,216,10017.0,20.0,15.0
0.005,6,10,2006,5,927,1.0,659.0,659.0,5,1079,1.0,811.0,811.0
0.047,6,10,1762,5,911,11.0,643.0,643.0,5,851,11.0,583.0,583.0
0.108,6,10,1506,5,395,25.0,127.0,127.0,5,1111,25.0,843.0,843.0
173.277,17,82,11686,41,2745,4331.0,44.0,38.0,41,8941,4331.0,261.0,190.0
0.009,6,10,1989,5,910,2.0,642.0,642.0,5,1079,2.0,811.0,811.0
0.007,6,10,2006,5,927,1.0,659.0,659.0,5,1079,1.0,811.0,811.0
0.016,6,10,1990,5,911,4.0,643.0,643.0,5,1079,4.0,811.0,811.0
0.008,6,10,1762,5,911,2.0,643.0,643.0,5,851,2.0,583.0,583.0
0.072,6,10,1506,5,395,16.0,127.0,127.0,5,1111,13.0,843.0,843.0
0.004,17,2,148,1,60,0.0,32.0,32.0,1,88,0.0,60.0,60.0
0.037,17,2,136,1,60,0.0,32.0,32.0,1,76,0.0,48.0,48.0
0.169,17,2,152,1,76,0.0,48.0,48.0,1,76,0.0,48.0,48.0
0.006,6,10,2000,5,927,1.0,659.0,659.0,5,1073,1.0,805.0,805.0
0.012,6,13,3735,7,497,2.0,125.0,125.0,6,3238,2.0,1470.0,1459.0
40.042,17,10,676,5,460,10008.0,104.0,64.0,5,216,10009.0,20.0,15.0
0.006,17,2,170,1,65,0.0,37.0,37.0,1,105,0.0,77.0,77.0
413.353,6,29,4409,12,3102,10911.0,494.0,494.0,17,1307,25834.0,83.0,83.0
0.07,6,10,1506,5,395,15.0,127.0,127.0,5,1111,16.0,843.0,843.0
0.004,6,10,1702,5,863,1.0,595.0,595.0,5,839,0.0,571.0,571.0
0.081,6,10,1506,5,395,18.0,127.0,127.0,5,1111,17.0,843.0,843.0
0.006,17,2,170,1,65,0.0,37.0,37.0,1,105,0.0,77.0,77.0
0.003,17,4,284,2,120,0.0,32.0,32.0,2,164,0.0,60.0,54.0
0.121,6,10,1506,5,395,27.0,127.0,127.0,5,1111,23.0,843.0,843.0
0.004,17,2,148,1,60,0.0,32.0,32.0,1,88,0.0,60.0,60.0
240.103,6,18,3982,9,2240,30012.0,1216.0,592.0,9,1742,30012.0,1007.0,316.0
1756.255,6,463,66104,252,35168,6997.0,613.0,197.0,211,30936,8362.0,453.0,142.0
0.005,6,10,1989,5,927,1.0,659.0,659.0,5,1062,1.0,794.0,794.0
0.011,6,10,1989,5,910,2.0,642.0,642.0,5,1079,2.0,811.0,811.0
0.009,6,13,3735,7,497,1.0,125.0,125.0,6,3238,1.0,1470.0,1459.0
0.005,6,10,1689,5,839,1.0,571.0,571.0,5,850,1.0,582.0,582.0
0.008,6,10,1983,5,910,2.0,642.0,642.0,5,1073,2.0,805.0,805.0
0.006,6,10,1547,5,764,1.0,496.0,496.0,5,783,1.0,515.0,515.0
0.007,6,10,2007,5,928,1.0,660.0,660.0,5,1079,1.0,811.0,811.0
0.088,6,10,1506,5,395,18.0,127.0,127.0,5,1111,19.0,843.0,843.0
0.006,6,10,1547,5,764,1.0,496.0,496.0,5,783,1.0,515.0,515.0
0.005,6,10,1989,5,927,1.0,659.0,659.0,5,1062,1.0,794.0,794.0
0.006,6,10,2006,5,927,1.0,659.0,659.0,5,1079,1.0,811.0,811.0
40.057,17,10,676,5,460,10012.0,104.0,64.0,5,216,10013.0,20.0,15.0
0.072,17,4,284,2,120,0.0,32.0,32.0,2,164,32.0,60.0,54.0
0.115,6,10,1506,5,395,26.0,127.0,127.0,5,1111,25.0,843.0,843.0
0.086,6,10,1506,5,395,20.0,127.0,127.0,5,1111,19.0,843.0,843.0
0.009,6,10,1989,5,910,2.0,642.0,642.0,5,1079,2.0,811.0,811.0
0.005,6,10,2000,5,927,1.0,659.0,659.0,5,1073,1.0,805.0,805.0
40.051,17,10,676,5,460,10011.0,104.0,64.0,5,216,10011.0,20.0,15.0
0.045,17,2,179,1,71,0.0,43.0,43.0,1,108,0.0,80.0,80.0
0.03,6,10,1762,5,911,7.0,643.0,643.0,5,851,7.0,583.0,583.0
1787.107,6,150,19350,90,13740,20079.0,302.0,302.0,60,5610,30289.0,83.0,83.0
0.08,6,10,1506,5,395,17.0,127.0,127.0,5,1111,19.0,843.0,843.0
0.005,17,2,146,1,65,0.0,37.0,37.0,1,81,0.0,53.0,53.0
0.006,6,10,1854,5,889,1.0,621.0,621.0,5,965,1.0,697.0,697.0
0.01,6,12,1926,6,1189,2.0,659.0,434.0,6,737,1.0,417.0,417.0
175.102,17,76,10800,38,2528,4732.0,44.0,38.0,38,8272,4732.0,239.0,189.0
0.004,17,2,148,1,60,0.0,32.0,32.0,1,88,0.0,60.0,60.0
0.077,6,10,1506,5,395,15.0,127.0,127.0,5,1111,16.0,843.0,843.0
309.313,17,20,1124,10,716,34354.0,48.0,43.0,10,408,34354.0,20.0,12.0
0.005,17,2,168,1,76,0.0,48.0,48.0,1,92,0.0,64.0,64.0
0.153,6,10,1506,5,395,36.0,127.0,127.0,5,1111,34.0,843.0,843.0
40.057,17,10,676,5,460,10013.0,104.0,64.0,5,216,10013.0,20.0,15.0
40.061,17,10,676,5,460,10013.0,104.0,64.0,5,216,10014.0,20.0,15.0
0.006,6,10,2000,5,927,1.0,659.0,659.0,5,1073,1.0,805.0,805.0
0.007,17,2,299,1,65,0.0,37.0,37.0,1,234,0.0,206.0,206.0
0.005,6,10,2006,5,927,1.0,659.0,659.0,5,1079,1.0,811.0,811.0
0.01,6,10,1990,5,911,2.0,643.0,643.0,5,1079,2.0,811.0,811.0
0.005,6,10,1779,5,928,1.0,660.0,660.0,5,851,1.0,583.0,583.0
0.038,6,10,1989,5,910,9.0,642.0,642.0,5,1079,9.0,811.0,811.0
0.005,6,10,2006,5,927,1.0,659.0,659.0,5,1079,1.0,811.0,811.0
0.223,6,16,2669,8,1395,31.0,533.0,323.0,8,1274,20.0,529.0,212.0
0.079,6,10,1506,5,395,17.0,127.0,127.0,5,1111,16.0,843.0,843.0
0.004,17,2,136,1,60,0.0,32.0,32.0,1,76,0.0,48.0,48.0
0.073,6,10,1506,5,395,14.0,127.0,127.0,5,1111,17.0,843.0,843.0
0.011,6,10,1983,5,910,2.0,642.0,642.0,5,1073,2.0,805.0,805.0
0.005,6,13,3690,7,452,0.0,80.0,80.0,6,3238,1.0,1470.0,1459.0
40.057,17,10,676,5,460,10013.0,104.0,64.0,5,216,10010.0,20.0,15.0
0.003,17,2,136,1,60,0.0,32.0,32.0,1,76,0.0,48.0,48.0
0.006,6,10,1854,5,889,1.0,621.0,621.0,5,965,1.0,697.0,697.0
240.095,6,16,4481,9,963,30011.0,238.0,166.0,7,3518,40015.0,1402.0,786.0
0.013,6,10,1762,5,911,3.0,643.0,643.0,5,851,3.0,583.0,583.0
0.005,17,2,214,1,75,0.0,47.0,47.0,1,139,0.0,111.0,111.0
40.061,17,10,676,5,460,10013.0,104.0,64.0,5,216,10014.0,20.0,15.0
0.039,17,4,284,2,120,0.0,32.0,32.0,2,164,36.0,60.0,54.0
0.012,6,10,1972,5,910,2.0,642.0,642.0,5,1062,2.0,794.0,794.0
0.013,6,13,3735,7,497,2.0,125.0,125.0,6,3238,2.0,1470.0,1459.0
0.101,6,10,1506,5,395,22.0,127.0,127.0,5,1111,22.0,843.0,843.0
0.004,17,4,284,2,120,1.0,32.0,32.0,2,164,0.0,60.0,54.0
0.003,17,2,152,1,76,0.0,48.0,48.0,1,76,0.0,48.0,48.0
0.011,6,10,1677,5,827,2.0,559.0,559.0,5,850,2.0,582.0,582.0
0.005,6,10,2007,5,928,1.0,660.0,660.0,5,1079,1.0,811.0,811.0
0.014,6,10,1762,5,911,3.0,643.0,643.0,5,851,3.0,583.0,583.0
15.081,17,15,8191,8,6132,2150.0,1350.0,738.0,7,2059,2508.0,1350.0,266.0
10.788,17,26,4101,13,1822,889.0,269.0,112.0,13,2279,889.0,586.0,147.0
0.009,6,10,1989,5,910,2.0,642.0,642.0,5,1079,2.0,811.0,811.0
0.011,6,10,1990,5,911,2.0,643.0,643.0,5,1079,2.0,811.0,811.0
0.005,6,10,2006,5,927,1.0,659.0,659.0,5,1079,1.0,811.0,811.0
0.01,6,10,1972,5,910,2.0,642.0,642.0,5,1062,2.0,794.0,794.0
0.003,17,2,160,1,72,0.0,44.0,44.0,1,88,0.0,60.0,60.0
0.005,17,2,136,1,60,0.0,32.0,32.0,1,76,0.0,48.0,48.0
0.028,17,2,148,1,60,0.0,32.0,32.0,1,88,0.0,60.0,60.0
0.015,6,10,1677,5,827,3.0,559.0,559.0,5,850,3.0,582.0,582.0
0.006,6,10,1689,5,839,1.0,571.0,571.0,5,850,1.0,582.0,582.0
0.063,6,10,1506,5,395,14.0,127.0,127.0,5,1111,12.0,843.0,843.0
0.076,17,4,284,2,120,0.0,32.0,32.0,2,164,72.0,60.0,54.0
0.007,17,2,179,1,71,0.0,43.0,43.0,1,108,0.0,80.0,80.0
92.891,6,21,8145,11,1985,82.0,1174.0,504.0,10,6160,10301.0,2720.0,958.0
0.02,6,10,1989,5,910,4.0,642.0,642.0,5,1079,5.0,811.0,811.0
0.132,6,10,1506,5,395,30.0,127.0,127.0,5,1111,24.0,843.0,843.0
40.042,17,10,676,5,460,10009.0,104.0,64.0,5,216,10009.0,20.0,15.0
0.125,17,2,80,1,32,0.0,4.0,4.0,1,48,0.0,20.0,20.0
0.07,17,8,3613,4,1874,23.0,1350.0,440.0,4,1739,12.0,1350.0,406.0
0.005,6,14,3742,7,452,0.0,80.0,80.0,7,3290,0.0,1448.0,972.0
0.006,6,10,1689,5,839,1.0,571.0,571.0,5,850,1.0,582.0,582.0
0.006,6,10,1854,5,889,1.0,621.0,621.0,5,965,1.0,697.0,697.0
0.134,6,10,1506,5,395,31.0,127.0,127.0,5,1111,26.0,843.0,843.0
0.004,6,10,1779,5,928,1.0,660.0,660.0,5,851,1.0,583.0,583.0
0.006,6,10,1547,5,764,1.0,496.0,496.0,5,783,1.0,515.0,515.0
0.004,17,2,148,1,60,0.0,32.0,32.0,1,88,0.0,60.0,60.0
0.042,17,2,412,1,61,0.0,33.0,33.0,1,351,0.0,323.0,323.0
0.02,6,10,1972,5,910,4.0,642.0,642.0,5,1062,5.0,794.0,794.0
0.007,17,2,170,1,65,0.0,37.0,37.0,1,105,0.0,77.0,77.0
0.04,17,2,136,1,60,0.0,32.0,32.0,1,76,0.0,48.0,48.0
0.086,6,10,1506,5,395,16.0,127.0,127.0,5,1111,18.0,843.0,843.0
0.006,6,10,1547,5,764,1.0,496.0,496.0,5,783,1.0,515.0,515.0
0.012,6,10,1990,5,911,3.0,643.0,643.0,5,1079,3.0,811.0,811.0
0.007,17,2,179,1,71,0.0,43.0,43.0,1,108,0.0,80.0,80.0
0.011,6,10,1989,5,910,2.0,642.0,642.0,5,1079,2.0,811.0,811.0
0.078,6,10,1506,5,395,16.0,127.0,127.0,5,1111,18.0,843.0,843.0
40.06,17,10,676,5,460,10012.0,104.0,64.0,5,216,10014.0,20.0,15.0
0.006,17,2,166,1,75,0.0,47.0,47.0,1,91,0.0,63.0,63.0
0.005,6,10,1643,5,860,1.0,592.0,592.0,5,783,1.0,515.0,515.0
0.018,6,10,1990,5,911,4.0,643.0,643.0,5,1079,4.0,811.0,811.0
0.001,17,2,180,1,66,0.0,38.0,38.0,1,114,0.0,86.0,86.0
1734.231,6,64,7347,42,4470,42298.0,1626.0,108.0,22,2877,82574.0,1113.0,82.0
0.113,6,10,1506,5,395,21.0,127.0,127.0,5,1111,24.0,843.0,843.0
0.005,6,10,2000,5,927,1.0,659.0,659.0,5,1073,1.0,805.0,805.0
177.613,17,84,12181,42,2824,4331.0,44.0,39.0,42,9357,4332.0,261.0,194.0
0.019,6,10,1983,5,910,4.0,642.0,642.0,5,1073,4.0,805.0,805.0
0.013,6,10,1989,5,910,3.0,642.0,642.0,5,1079,3.0,811.0,811.0
0.005,6,10,2007,5,928,1.0,660.0,660.0,5,1079,1.0,811.0,811.0
40.069,17,10,676,5,460,10014.0,104.0,64.0,5,216,10016.0,20.0,15.0
0.004,17,2,136,1,60,0.0,32.0,32.0,1,76,0.0,48.0,48.0
0.004,17,2,136,1,60,0.0,32.0,32.0,1,76,0.0,48.0,48.0
240.09,6,16,4480,9,963,30011.0,238.0,166.0,7,3517,40014.0,1402.0,786.0
0.042,17,4,336,2,124,0.0,34.0,34.0,2,212,2.0,84.0,78.0
0.023,6,13,3735,7,497,3.0,125.0,125.0,6,3238,4.0,1470.0,1459.0
0.004,17,2,136,1,60,0.0,32.0,32.0,1,76,0.0,48.0,48.0
0.006,17,2,164,1,74,0.0,46.0,46.0,1,90,0.0,62.0,62.0
308.643,17,20,1124,10,716,34279.0,48.0,43.0,10,408,34279.0,20.0,12.0
0.003,17,2,136,1,60,0.0,32.0,32.0,1,76,0.0,48.0,48.0
335.006,17,20,1124,10,716,37215.0,48.0,43.0,10,408,37215.0,20.0,12.0
0.004,17,4,284,2,120,0.0,32.0,32.0,2,164,1.0,60.0,54.0
0.004,6,10,1774,5,923,1.0,655.0,655.0,5,851,1.0,583.0,583.0
0.007,17,2,179,1,71,0.0,43.0,43.0,1,108,0.0,80.0,80.0
0.004,6,10,2006,5,927,1.0,659.0,659.0,5,1079,1.0,811.0,811.0
0.006,17,2,148,1,60,0.0,32.0,32.0,1,88,0.0,60.0,60.0
0.007,6,10,1990,5,911,1.0,643.0,643.0,5,1079,1.0,811.0,811.0
0.808,6,14,5367,8,4933,115.0,2828.0,1533.0,6,434,114.0,182.0,182.0
283.264,6,24,6119,10,1186,31473.0,267.0,156.0,14,4933,21788.0,1400.0,873.0
40.061,17,10,676,5,460,10014.0,104.0,64.0,5,216,10013.0,20.0,15.0
0.01,6,10,1854,5,889,2.0,621.0,621.0,5,965,2.0,697.0,697.0
0.004,17,2,170,1,65,0.0,37.0,37.0,1,105,0.0,77.0,77.0
0.005,17,2,138,1,61,0.0,33.0,33.0,1,77,0.0,49.0,49.0
0.068,17,8,3613,4,1874,22.0,1350.0,440.0,4,1739,11.0,1350.0,406.0
0.012,6,10,1989,5,910,2.0,642.0,642.0,5,1079,2.0,811.0,811.0
0.078,6,10,1506,5,395,16.0,127.0,127.0,5,1111,16.0,843.0,843.0
0.006,6,10,1689,5,839,1.0,571.0,571.0,5,850,1.0,582.0,582.0
10.813,17,28,4422,14,1994,823.0,269.0,114.0,14,2428,823.0,587.0,145.0
0.014,6,10,1990,5,911,3.0,643.0,643.0,5,1079,3.0,811.0,811.0
0.004,6,10,2000,5,927,1.0,659.0,659.0,5,1073,1.0,805.0,805.0
0.023,6,10,1762,5,911,5.0,643.0,643.0,5,851,5.0,583.0,583.0
308.325,17,20,1124,10,716,34244.0,48.0,43.0,10,408,34244.0,20.0,12.0
40.066,17,10,676,5,460,10015.0,104.0,64.0,5,216,10015.0,20.0,15.0
0.015,6,10,1989,5,910,3.0,642.0,642.0,5,1079,3.0,811.0,811.0
0.007,17,2,179,1,71,0.0,43.0,43.0,1,108,0.0,80.0,80.0
0.039,17,2,144,1,64,0.0,36.0,36.0,1,80,0.0,52.0,52.0
0.001,17,2,136,1,60,0.0,32.0,32.0,1,76,0.0,48.0,48.0
0.011,6,10,1989,5,910,2.0,642.0,642.0,5,1079,2.0,811.0,811.0
134.567,6,22,7437,11,1305,102.0,530.0,277.0,11,6132,13440.0,2720.0,946.0
0.006,6,10,1547,5,764,1.0,496.0,496.0,5,783,1.0,515.0,515.0
0.005,6,10,2006,5,927,1.0,659.0,659.0,5,1079,1.0,811.0,811.0
0.006,6,10,1689,5,839,1.0,571.0,571.0,5,850,1.0,582.0,582.0
0.006,6,10,1547,5,764,1.0,496.0,496.0,5,783,1.0,515.0,515.0
0.008,6,10,1989,5,910,2.0,642.0,642.0,5,1079,1.0,811.0,811.0
1776.971,17,144,41760,72,22752,25027.0,288.0,288.0,72,19008,25027.0,236.0,236.0
0.011,17,2,140,1,62,0.0,34.0,34.0,1,78,0.0,50.0,50.0
40.059,17,10,676,5,460,10013.0,104.0,64.0,5,216,10013.0,20.0,15.0
0.013,6,10,1989,5,910,3.0,642.0,642.0,5,1079,3.0,811.0,811.0
0.007,6,10,1702,5,863,1.0,595.0,595.0,5,839,1.0,571.0,571.0
0.067,6,10,1506,5,395,16.0,127.0,127.0,5,1111,16.0,843.0,843.0
240.7,6,35,8926,18,2074,14156.0,695.0,226.0,17,6852,15041.0,1402.0,597.0
0.007,6,10,1779,5,928,1.0,660.0,660.0,5,851,1.0,583.0,583.0
1778.652,6,240,46351,117,33980,15333.0,2472.0,961.0,123,12371,14579.0,580.0,62.0
1771.984,6,105,6270,60,3525,30032.0,27.0,27.0,45,2745,40271.0,27.0,27.0
0.005,6,10,2006,5,927,1.0,659.0,659.0,5,1079,1.0,811.0,811.0
1770.146,6,83,4368,42,2210,43173.0,26.0,26.0,41,2158,44252.0,26.0,26.0
0.008,6,12,1926,6,1189,1.0,659.0,434.0,6,737,1.0,417.0,417.0
0.006,6,10,1547,5,764,1.0,496.0,496.0,5,783,1.0,515.0,515.0
0.014,6,10,1990,5,911,3.0,643.0,643.0,5,1079,3.0,811.0,811.0
0.039,17,2,170,1,65,0.0,37.0,37.0,1,105,0.0,77.0,77.0
0.017,6,10,1972,5,910,4.0,642.0,642.0,5,1062,4.0,794.0,794.0
0.017,6,10,1990,5,911,4.0,643.0,643.0,5,1079,4.0,811.0,811.0
167.258,17,80,11455,40,2669,4288.0,44.0,38.0,40,8786,4288.0,261.0,191.0
0.141,6,10,1506,5,395,27.0,127.0,127.0,5,1111,30.0,843.0,843.0
0.006,6,10,1547,5,764,1.0,496.0,496.0,5,783,1.0,515.0,515.0
0.004,6,10,1702,5,863,1.0,595.0,595.0,5,839,0.0,571.0,571.0
0.022,6,10,1989,5,910,5.0,642.0,642.0,5,1079,5.0,811.0,811.0
0.009,6,10,1989,5,927,2.0,659.0,659.0,5,1062,2.0,794.0,794.0
0.007,17,2,179,1,71,0.0,43.0,43.0,1,108,0.0,80.0,80.0
0.003,17,2,148,1,60,0.0,32.0,32.0,1,88,0.0,60.0,60.0
0.012,6,10,1972,5,910,2.0,642.0,642.0,5,1062,2.0,794.0,794.0
40.068,17,10,676,5,460,10016.0,104.0,64.0,5,216,10016.0,20.0,15.0
0.012,6,13,3735,7,497,1.0,125.0,125.0,6,3238,2.0,1470.0,1459.0
0.038,17,2,148,1,60,0.0,32.0,32.0,1,88,0.0,60.0,60.0
0.004,6,10,1774,5,923,1.0,655.0,655.0,5,851,1.0,583.0,583.0
40.068,17,10,676,5,460,10014.0,104.0,64.0,5,216,10014.0,20.0,15.0
0.018,6,10,1989,5,910,4.0,642.0,642.0,5,1079,4.0,811.0,811.0
0.007,6,10,1547,5,764,1.0,496.0,496.0,5,783,1.0,515.0,515.0
0.02,17,2,136,1,60,0.0,32.0,32.0,1,76,0.0,48.0,48.0
0.012,6,10,1989,5,910,3.0,642.0,642.0,5,1079,3.0,811.0,811.0
0.011,6,10,1990,5,911,2.0,643.0,643.0,5,1079,2.0,811.0,811.0
0.011,6,10,1972,5,910,2.0,642.0,642.0,5,1062,2.0,794.0,794.0
0.014,6,10,1989,5,910,3.0,642.0,642.0,5,1079,3.0,811.0,811.0
0.009,6,10,1983,5,910,2.0,642.0,642.0,5,1073,2.0,805.0,805.0
0.083,6,10,1506,5,395,20.0,127.0,127.0,5,1111,15.0,843.0,843.0
0.061,17,2,152,1,76,0.0,48.0,48.0,1,76,0.0,48.0,48.0
0.004,6,10,1702,5,863,1.0,595.0,595.0,5,839,1.0,571.0,571.0
240.294,6,40,8615,20,5634,12646.0,2883.0,573.0,20,2981,12646.0,580.0,241.0
0.005,6,10,1689,5,839,1.0,571.0,571.0,5,850,1.0,582.0,582.0
0.001,17,2,180,1,66,0.0,38.0,38.0,1,114,0.0,86.0,86.0
0.007,17,2,194,1,59,0.0,31.0,31.0,1,135,0.0,107.0,107.0
0.253,17,37,20001,21,17030,12.0,1350.0,782.0,16,2971,13.0,1350.0,157.0
0.005,6,10,1989,5,927,1.0,659.0,659.0,5,1062,1.0,794.0,794.0
0.001,17,2,140,1,62,0.0,34.0,34.0,1,78,0.0,50.0,50.0
0.005,6,10,1689,5,839,1.0,571.0,571.0,5,850,1.0,582.0,582.0
0.126,17,4,284,2,120,0.0,32.0,32.0,2,164,88.0,60.0,54.0
0.008,6,10,1989,5,910,2.0,642.0,642.0,5,1079,2.0,811.0,811.0
0.094,6,10,1506,5,395,23.0,127.0,127.0,5,1111,20.0,843.0,843.0
0.005,6,13,3747,7,509,0.0,137.0,137.0,6,3238,0.0,1470.0,1459.0
0.014,6,10,1990,5,911,3.0,643.0,643.0,5,1079,3.0,811.0,811.0
0.004,6,10,2006,5,927,1.0,659.0,659.0,5,1079,1.0,811.0,811.0
0.005,6,10,2006,5,927,1.0,659.0,659.0,5,1079,1.0,811.0,811.0
0.004,17,2,136,1,60,0.0,32.0,32.0,1,76,0.0,48.0,48.0
0.005,6,10,2006,5,927,1.0,659.0,659.0,5,1079,1.0,811.0,811.0
0.007,6,10,1779,5,928,1.0,660.0,660.0,5,851,1.0,583.0,583.0
0.004,6,10,1989,5,927,1.0,659.0,659.0,5,1062,1.0,794.0,794.0
0.005,6,10,2000,5,927,1.0,659.0,659.0,5,1073,1.0,805.0,805.0
0.004,17,2,152,1,76,0.0,48.0,48.0,1,76,0.0,48.0,48.0
0.121,6,10,1506,5,395,28.0,127.0,127.0,5,1111,26.0,843.0,843.0
0.009,6,12,1926,6,1189,1.0,659.0,434.0,6,737,1.0,417.0,417.0
0.007,6,10,1989,5,910,1.0,642.0,642.0,5,1079,1.0,811.0,811.0
0.009,6,10,1989,5,910,2.0,642.0,642.0,5,1079,2.0,811.0,811.0
0.094,6,10,1506,5,395,21.0,127.0,127.0,5,1111,21.0,843.0,843.0
283.44,6,24,6115,11,1226,28344.0,267.0,156.0,13,4889,23615.0,1400.0,873.0
0.095,6,10,1506,5,395,21.0,127.0,127.0,5,1111,20.0,843.0,843.0
0.011,6,13,3735,7,497,1.0,125.0,125.0,6,3238,2.0,1470.0,1459.0
0.005,17,2,230,1,68,0.0,40.0,40.0,1,162,0.0,134.0,134.0
0.006,6,10,1547,5,764,1.0,496.0,496.0,5,783,1.0,515.0,515.0
0.085,6,10,1506,5,395,19.0,127.0,127.0,5,1111,19.0,843.0,843.0
0.187,6,10,1506,5,395,44.0,127.0,127.0,5,1111,23.0,843.0,843.0
0.006,6,10,1689,5,839,1.0,571.0,571.0,5,850,1.0,582.0,582.0
454.728,6,35,9788,19,4000,25262.0,676.0,429.0,16,5788,26310.0,1402.0,618.0
0.007,17,2,179,1,71,0.0,43.0,43.0,1,108,0.0,80.0,80.0
0.012,6,10,1762,5,911,2.0,643.0,643.0,5,851,2.0,583.0,583.0
0.01,6,10,1762,5,911,2.0,643.0,643.0,5,851,2.0,583.0,583.0
0.005,6,14,3799,7,509,0.0,137.0,137.0,7,3290,0.0,1448.0,972.0
0.109,6,10,1506,5,395,24.0,127.0,127.0,5,1111,22.0,843.0,843.0
0.005,17,2,144,1,64,0.0,36.0,36.0,1,80,0.0,52.0,52.0
0.012,6,10,1989,5,910,3.0,642.0,642.0,5,1079,2.0,811.0,811.0
40.068,17,10,676,5,460,10016.0,104.0,64.0,5,216,10016.0,20.0,15.0
0.013,6,10,1989,5,910,3.0,642.0,642.0,5,1079,3.0,811.0,811.0
0.01,6,10,1972,5,910,2.0,642.0,642.0,5,1062,2.0,794.0,794.0
0.004,6,10,1774,5,923,1.0,655.0,655.0,5,851,1.0,583.0,583.0
0.005,6,10,1643,5,860,1.0,592.0,592.0,5,783,1.0,515.0,515.0
0.005,6,10,2006,5,927,1.0,659.0,659.0,5,1079,1.0,811.0,811.0
0.004,6,10,1989,5,927,1.0,659.0,659.0,5,1062,1.0,794.0,794.0
0.004,17,2,148,1,60,0.0,32.0,32.0,1,88,0.0,60.0,60.0
0.009,6,12,1926,6,1189,1.0,659.0,434.0,6,737,1.0,417.0,417.0
0.127,17,2,412,1,61,0.0,33.0,33.0,1,351,0.0,323.0,323.0
0.024,6,10,1989,5,910,6.0,642.0,642.0,5,1079,5.0,811.0,811.0
0.011,6,10,1762,5,911,2.0,643.0,643.0,5,851,2.0,583.0,583.0
0.005,17,2,144,1,64,0.0,36.0,36.0,1,80,0.0,52.0,52.0
0.142,6,10,1506,5,395,34.0,127.0,127.0,5,1111,31.0,843.0,843.0
0.005,6,10,1989,5,927,1.0,659.0,659.0,5,1062,1.0,794.0,794.0
0.136,6,10,1506,5,395,33.0,127.0,127.0,5,1111,29.0,843.0,843.0
0.006,6,10,2006,5,927,1.0,659.0,659.0,5,1079,1.0,811.0,811.0
40.053,17,10,676,5,460,10012.0,104.0,64.0,5,216,10012.0,20.0,15.0
0.008,6,10,1983,5,910,2.0,642.0,642.0,5,1073,2.0,805.0,805.0
0.007,6,10,1689,5,839,1.0,571.0,571.0,5,850,1.0,582.0,582.0
0.012,6,10,1972,5,910,3.0,642.0,642.0,5,1062,3.0,794.0,794.0
0.018,6,10,1989,5,910,4.0,642.0,642.0,5,1079,4.0,811.0,811.0
0.001,17,2,166,1,75,0.0,47.0,47.0,1,91,0.0,63.0,63.0
0.094,6,10,1506,5,395,22.0,127.0,127.0,5,1111,20.0,843.0,843.0
0.02,6,10,1989,5,910,5.0,642.0,642.0,5,1079,5.0,811.0,811.0
0.005,6,10,2006,5,927,1.0,659.0,659.0,5,1079,1.0,811.0,811.0
10.831,17,28,4418,14,1994,824.0,269.0,114.0,14,2424,824.0,587.0,145.0
0.103,6,10,1506,5,395,23.0,127.0,127.0,5,1111,23.0,843.0,843.0
0.006,17,2,170,1,65,0.0,37.0,37.0,1,105,0.0,77.0,77.0
0.013,6,10,1989,5,910,3.0,642.0,642.0,5,1079,3.0,811.0,811.0
40.061,17,10,676,5,460,10014.0,104.0,64.0,5,216,10014.0,20.0,15.0
15.294,17,26,17522,11,4329,1526.0,1350.0,365.0,15,13193,1090.0,1350.0,851.0
0.005,17,2,230,1,68,0.0,40.0,40.0,1,162,0.0,134.0,134.0
0.008,6,12,1926,6,1189,1.0,659.0,434.0,6,737,1.0,417.0,417.0
0.006,6,10,1547,5,764,1.0,496.0,496.0,5,783,1.0,515.0,515.0
0.118,6,10,1506,5,395,27.0,127.0,127.0,5,1111,25.0,843.0,843.0
0.064,6,10,1506,5,395,14.0,127.0,127.0,5,1111,15.0,843.0,843.0
369.791,6,22,2313,16,867,24652.0,195.0,195.0,6,1446,4642.0,419.0,398.0
0.009,6,7,695,4,448,3.0,232.0,232.0,3,247,3.0,83.0,83.0
0.012,6,10,1972,5,910,3.0,642.0,642.0,5,1062,3.0,794.0,794.0
0.006,6,10,1547,5,764,1.0,496.0,496.0,5,783,1.0,515.0,515.0
0.008,17,2,170,1,65,0.0,37.0,37.0,1,105,0.0,77.0,77.0
0.001,17,2,142,1,63,0.0,35.0,35.0,1,79,0.0,51.0,51.0
0.042,17,4,352,2,130,4.0,37.0,37.0,2,222,5.0,89.0,83.0
0.001,17,2,180,1,66,0.0,38.0,38.0,1,114,0.0,86.0,86.0
0.001,17,2,180,1,66,0.0,38.0,38.0,1,114,0.0,86.0,86.0
0.005,6,10,1689,5,839,1.0,571.0,571.0,5,850,1.0,582.0,582.0
9.01,6,39,10489,20,4931,474.0,1360.0,683.0,19,5558,489.0,2667.0,435.0
0.212,6,16,2782,8,1400,30.0,533.0,325.0,8,1382,19.0,529.0,239.0
0.009,6,10,1983,5,910,2.0,642.0,642.0,5,1073,2.0,805.0,805.0
240.076,6,21,4925,11,941,24007.0,180.0,93.0,10,3984,26674.0,1592.0,576.0
0.012,6,10,1972,5,910,3.0,642.0,642.0,5,1062,2.0,794.0,794.0
0.079,6,10,1506,5,395,18.0,127.0,127.0,5,1111,17.0,843.0,843.0
371.035,6,22,2313,16,867,24735.0,195.0,195.0,6,1446,4636.0,419.0,398.0
0.006,6,10,1547,5,764,1.0,496.0,496.0,5,783,1.0,515.0,515.0
0.07,17,8,3613,4,1874,23.0,1350.0,440.0,4,1739,12.0,1350.0,406.0
0.105,6,10,1506,5,395,23.0,127.0,127.0,5,1111,21.0,843.0,843.0
0.009,6,10,1972,5,910,2.0,642.0,642.0,5,1062,2.0,794.0,794.0
0.005,6,10,2006,5,927,1.0,659.0,659.0,5,1079,1.0,811.0,811.0
0.012,17,2,166,1,75,0.0,47.0,47.0,1,91,0.0,63.0,63.0
0.005,6,10,1774,5,923,1.0,655.0,655.0,5,851,1.0,583.0,583.0
0.014,6,10,1990,5,911,3.0,643.0,643.0,5,1079,3.0,811.0,811.0
0.095,6,10,1506,5,395,20.0,127.0,127.0,5,1111,20.0,843.0,843.0
0.005,6,10,1643,5,860,1.0,592.0,592.0,5,783,1.0,515.0,515.0
0.005,6,10,1779,5,928,1.0,660.0,660.0,5,851,1.0,583.0,583.0
0.001,17,2,136,1,60,0.0,32.0,32.0,1,76,0.0,48.0,48.0
0.013,6,10,1989,5,910,3.0,642.0,642.0,5,1079,3.0,811.0,811.0
0.053,17,2,152,1,76,0.0,48.0,48.0,1,76,0.0,48.0,48.0
0.008,6,10,1631,5,848,2.0,580.0,580.0,5,783,2.0,515.0,515.0
0.009,6,10,1983,5,910,2.0,642.0,642.0,5,1073,2.0,805.0,805.0
0.004,17,2,170,1,65,0.0,37.0,37.0,1,105,0.0,77.0,77.0
0.012,6,10,1989,5,910,3.0,642.0,642.0,5,1079,2.0,811.0,811.0
0.005,6,10,1774,5,923,1.0,655.0,655.0,5,851,1.0,583.0,583.0
0.022,6,10,1972,5,910,5.0,642.0,642.0,5,1062,5.0,794.0,794.0
324.868,17,20,1124,10,716,36082.0,48.0,43.0,10,408,36082.0,20.0,12.0
0.004,6,10,1989,5,927,1.0,659.0,659.0,5,1062,1.0,794.0,794.0
0.005,6,14,3736,7,446,0.0,74.0,74.0,7,3290,0.0,1448.0,972.0
175.543,17,76,10970,38,2538,4744.0,44.0,38.0,38,8432,4744.0,261.0,193.0
15.123,17,18,9537,9,7402,1886.0,1350.0,794.0,9,2135,1885.0,1350.0,209.0
0.004,6,10,1702,5,863,1.0,595.0,595.0,5,839,1.0,571.0,571.0
0.005,6,10,1643,5,860,1.0,592.0,592.0,5,783,1.0,515.0,515.0
0.004,6,10,2007,5,928,1.0,660.0,660.0,5,1079,1.0,811.0,811.0
0.084,6,10,1506,5,395,18.0,127.0,127.0,5,1111,20.0,843.0,843.0
9.036,17,6,376,5,280,2259.0,28.0,28.0,1,96,0.0,68.0,68.0
0.011,6,10,1677,5,827,2.0,559.0,559.0,5,850,2.0,582.0,582.0
0.006,6,10,1547,5,764,1.0,496.0,496.0,5,783,1.0,515.0,515.0
11.163,17,29,4565,15,2166,789.0,269.0,116.0,14,2399,849.0,586.0,143.0
0.104,6,10,1506,5,395,22.0,127.0,127.0,5,1111,25.0,843.0,843.0
0.006,6,10,1547,5,764,1.0,496.0,496.0,5,783,1.0,515.0,515.0
0.006,6,10,1547,5,764,1.0,496.0,496.0,5,783,1.0,515.0,515.0
242.184,6,398,348256,199,21873,1223.0,2736.0,959.0,199,326383,1223.0,2804.0,1672.0
0.125,6,10,1506,5,395,28.0,127.0,127.0,5,1111,28.0,843.0,843.0
0.017,6,13,3735,7,497,2.0,125.0,125.0,6,3238,3.0,1470.0,1459.0
0.001,17,2,180,1,66,0.0,38.0,38.0,1,114,0.0,86.0,86.0
0.006,6,10,2006,5,927,1.0,659.0,659.0,5,1079,1.0,811.0,811.0
0.014,6,10,1972,5,910,3.0,642.0,642.0,5,1062,3.0,794.0,794.0
0.15,6,10,1506,5,395,35.0,127.0,127.0,5,1111,36.0,843.0,843.0
0.007,17,2,179,1,71,0.0,43.0,43.0,1,108,0.0,80.0,80.0
0.004,17,4,284,2,120,0.0,32.0,32.0,2,164,1.0,60.0,54.0
0.103,6,10,1506,5,395,24.0,127.0,127.0,5,1111,24.0,843.0,843.0
0.104,6,10,1506,5,395,23.0,127.0,127.0,5,1111,21.0,843.0,843.0
40.064,17,10,676,5,460,10014.0,104.0,64.0,5,216,10015.0,20.0,15.0
0.09,6,10,1506,5,395,20.0,127.0,127.0,5,1111,18.0,843.0,843.0
0.01,6,10,1989,5,910,2.0,642.0,642.0,5,1079,2.0,811.0,811.0
40.055,17,10,676,5,460,10012.0,104.0,64.0,5,216,10012.0,20.0,15.0
0.001,17,2,154,1,69,0.0,41.0,41.0,1,85,0.0,57.0,57.0
0.011,6,10,1677,5,827,2.0,559.0,559.0,5,850,2.0,582.0,582.0
0.108,6,10,1506,5,395,21.0,127.0,127.0,5,1111,24.0,843.0,843.0
0.012,6,10,1983,5,910,3.0,642.0,642.0,5,1073,3.0,805.0,805.0
0.003,17,4,284,2,120,0.0,32.0,32.0,2,164,0.0,60.0,54.0
0.01,6,10,1983,5,910,2.0,642.0,642.0,5,1073,2.0,805.0,805.0
0.005,6,10,2000,5,927,1.0,659.0,659.0,5,1073,1.0,805.0,805.0
356.595,6,21,1795,16,1030,23773.0,190.0,190.0,5,765,60003.0,464.0,248.0
40.059,17,10,676,5,460,10014.0,104.0,64.0,5,216,10014.0,20.0,15.0
0.001,17,2,180,1,66,0.0,38.0,38.0,1,114,0.0,86.0,86.0
0.007,6,10,2000,5,927,1.0,659.0,659.0,5,1073,1.0,805.0,805.0
0.005,6,10,2000,5,927,1.0,659.0,659.0,5,1073,1.0,805.0,805.0
0.012,6,10,1983,5,910,3.0,642.0,642.0,5,1073,2.0,805.0,805.0
0.086,6,10,1506,5,395,18.0,127.0,127.0,5,1111,17.0,843.0,843.0
0.005,6,14,3799,7,509,0.0,137.0,137.0,7,3290,0.0,1448.0,972.0
0.005,6,10,2006,5,927,1.0,659.0,659.0,5,1079,1.0,811.0,811.0
0.085,6,10,1506,5,395,19.0,127.0,127.0,5,1111,19.0,843.0,843.0
0.005,6,10,2006,5,927,1.0,659.0,659.0,5,1079,1.0,811.0,811.0
0.006,6,10,1547,5,764,1.0,496.0,496.0,5,783,1.0,515.0,515.0
368.895,6,22,2313,16,867,24593.0,195.0,195.0,6,1446,4639.0,419.0,398.0
1772.035,6,106,6322,60,3525,30033.0,27.0,27.0,46,2797,39377.0,27.0,27.0
0.005,6,10,2006,5,927,1.0,659.0,659.0,5,1079,1.0,811.0,811.0
0.01,6,10,1989,5,910,2.0,642.0,642.0,5,1079,2.0,811.0,811.0
0.004,17,2,148,1,60,0.0,32.0,32.0,1,88,0.0,60.0,60.0
0.014,6,10,1990,5,911,3.0,643.0,643.0,5,1079,3.0,811.0,811.0
0.012,6,10,1990,5,911,3.0,643.0,643.0,5,1079,2.0,811.0,811.0
0.009,6,12,1926,6,1189,1.0,659.0,434.0,6,737,1.0,417.0,417.0
0.013,17,2,214,1,75,0.0,47.0,47.0,1,139,0.0,111.0,111.0
0.003,17,4,284,2,120,0.0,32.0,32.0,2,164,0.0,60.0,54.0
0.005,6,11,2041,6,979,1.0,659.0,659.0,5,1062,1.0,794.0,794.0
0.007,6,10,1989,5,910,1.0,642.0,642.0,5,1079,1.0,811.0,811.0
0.012,6,10,1983,5,910,2.0,642.0,642.0,5,1073,3.0,805.0,805.0
11.169,17,28,4422,14,1994,846.0,269.0,114.0,14,2428,846.0,587.0,145.0
40.058,17,10,676,5,460,10013.0,104.0,64.0,5,216,10013.0,20.0,15.0
0.006,6,10,1689,5,839,1.0,571.0,571.0,5,850,1.0,582.0,582.0
0.013,6,13,3816,7,578,2.0,206.0,206.0,6,3238,2.0,1470.0,1459.0
0.008,17,2,179,1,71,0.0,43.0,43.0,1,108,0.0,80.0,80.0
0.011,6,10,1983,5,910,2.0,642.0,642.0,5,1073,2.0,805.0,805.0
0.007,6,10,2007,5,928,1.0,660.0,660.0,5,1079,1.0,811.0,811.0
0.001,17,2,136,1,60,0.0,32.0,32.0,1,76,0.0,48.0,48.0
0.005,6,10,1774,5,923,1.0,655.0,655.0,5,851,1.0,583.0,583.0
0.006,6,10,1547,5,764,1.0,496.0,496.0,5,783,1.0,515.0,515.0
0.004,6,10,1702,5,863,0.0,595.0,595.0,5,839,1.0,571.0,571.0
0.111,6,10,1506,5,395,23.0,127.0,127.0,5,1111,21.0,843.0,843.0
0.093,6,10,1506,5,395,20.0,127.0,127.0,5,1111,19.0,843.0,843.0
0.028,6,10,1972,5,910,7.0,642.0,642.0,5,1062,6.0,794.0,794.0
0.006,17,2,247,1,68,0.0,40.0,40.0,1,179,0.0,151.0,151.0
0.022,6,10,1631,5,848,5.0,580.0,580.0,5,783,5.0,515.0,515.0
0.014,6,10,1972,5,910,3.0,642.0,642.0,5,1062,3.0,794.0,794.0
1741.889,6,303,98343,184,86867,9518.0,2001.0,708.0,119,11476,14761.0,452.0,70.0
0.069,6,10,1506,5,395,15.0,127.0,127.0,5,1111,14.0,843.0,843.0
1681.375,6,147,18825,88,13342,19326.0,302.0,302.0,59,5483,28989.0,83.0,83.0
0.075,6,10,1506,5,395,17.0,127.0,127.0,5,1111,17.0,843.0,843.0
0.096,6,10,1506,5,395,19.0,127.0,127.0,5,1111,20.0,843.0,843.0
0.004,6,10,1702,5,863,1.0,595.0,595.0,5,839,1.0,571.0,571.0
0.115,6,10,1506,5,395,27.0,127.0,127.0,5,1111,25.0,843.0,843.0
0.041,17,2,144,1,64,0.0,36.0,36.0,1,80,0.0,52.0,52.0
0.006,6,10,1689,5,839,1.0,571.0,571.0,5,850,1.0,582.0,582.0
0.004,17,2,136,1,60,0.0,32.0,32.0,1,76,0.0,48.0,48.0
0.01,6,10,1972,5,910,2.0,642.0,642.0,5,1062,2.0,794.0,794.0
0.009,6,10,1972,5,910,2.0,642.0,642.0,5,1062,2.0,794.0,794.0
1755.906,6,105,6240,60,3510,29760.0,26.0,26.0,45,2730,39906.0,26.0,26.0
0.006,6,10,1689,5,839,1.0,571.0,571.0,5,850,1.0,582.0,582.0
0.007,17,2,214,1,75,0.0,47.0,47.0,1,139,0.0,111.0,111.0
0.005,17,2,140,1,62,0.0,34.0,34.0,1,78,0.0,50.0,50.0
0.07,6,10,1506,5,395,15.0,127.0,127.0,5,1111,15.0,843.0,843.0
0.005,6,10,1774,5,923,1.0,655.0,655.0,5,851,1.0,583.0,583.0
0.005,6,10,1643,5,860,1.0,592.0,592.0,5,783,1.0,515.0,515.0
0.122,6,10,1506,5,395,27.0,127.0,127.0,5,1111,25.0,843.0,843.0
0.107,6,10,1506,5,395,23.0,127.0,127.0,5,1111,21.0,843.0,843.0
0.011,6,10,1990,5,911,2.0,643.0,643.0,5,1079,2.0,811.0,811.0
0.003,17,2,148,1,60,0.0,32.0,32.0,1,88,0.0,60.0,60.0
0.054,17,2,152,1,76,0.0,48.0,48.0,1,76,0.0,48.0,48.0
0.717,6,22,5072,11,1250,60.0,325.0,133.0,11,3822,60.0,1414.0,563.0
0.005,6,13,3747,7,509,0.0,137.0,137.0,6,3238,1.0,1470.0,1459.0
0.13,6,10,1506,5,395,29.0,127.0,127.0,5,1111,29.0,843.0,843.0
0.074,6,10,1506,5,395,16.0,127.0,127.0,5,1111,15.0,843.0,843.0
292.691,6,303,343364,114,17479,2590.0,2736.0,888.0,189,325885,1556.0,2804.0,1805.0
40.054,17,10,676,5,460,10012.0,104.0,64.0,5,216,10012.0,20.0,15.0
0.006,6,10,1547,5,764,1.0,496.0,496.0,5,783,1.0,515.0,515.0
0.006,6,10,2006,5,927,1.0,659.0,659.0,5,1079,1.0,811.0,811.0
0.01,6,10,1972,5,910,2.0,642.0,642.0,5,1062,2.0,794.0,794.0
0.01,6,7,695,4,448,3.0,232.0,232.0,3,247,3.0,83.0,83.0
0.1,6,10,1506,5,395,24.0,127.0,127.0,5,1111,22.0,843.0,843.0
0.004,17,4,284,2,120,1.0,32.0,32.0,2,164,0.0,60.0,54.0
10.98,17,28,4399,14,2313,836.0,588.0,137.0,14,2086,836.0,269.0,121.0
0.004,6,10,1989,5,927,1.0,659.0,659.0,5,1062,1.0,794.0,794.0
40.062,17,10,676,5,460,10013.0,104.0,64.0,5,216,10014.0,20.0,15.0
0.012,6,10,2006,5,927,2.0,659.0,659.0,5,1079,2.0,811.0,811.0
0.039,17,2,152,1,76,0.0,48.0,48.0,1,76,0.0,48.0,48.0
0.003,17,2,136,1,60,0.0,32.0,32.0,1,76,0.0,48.0,48.0
0.004,17,2,136,1,60,0.0,32.0,32.0,1,76,0.0,48.0,48.0
0.005,6,10,1989,5,927,1.0,659.0,659.0,5,1062,1.0,794.0,794.0
0.014,6,10,1631,5,848,3.0,580.0,580.0,5,783,3.0,515.0,515.0
0.01,6,10,1989,5,910,2.0,642.0,642.0,5,1079,2.0,811.0,811.0
0.136,17,4,352,2,130,1.0,37.0,37.0,2,222,97.0,89.0,83.0
0.131,17,2,152,1,76,0.0,48.0,48.0,1,76,0.0,48.0,48.0
240.134,6,19,4770,9,2169,30016.0,966.0,568.0,10,2601,26681.0,1162.0,414.0
0.12,6,10,1506,5,395,27.0,127.0,127.0,5,1111,28.0,843.0,843.0
0.156,6,10,1242,5,751,39.0,495.0,495.0,5,491,36.0,223.0,223.0
0.114,6,10,1506,5,395,23.0,127.0,127.0,5,1111,25.0,843.0,843.0
0.01,6,10,2007,5,928,2.0,660.0,660.0,5,1079,2.0,811.0,811.0
0.004,6,10,2006,5,927,1.0,659.0,659.0,5,1079,1.0,811.0,811.0
0.001,17,2,136,1,60,0.0,32.0,32.0,1,76,0.0,48.0,48.0
0.004,6,10,1779,5,928,1.0,660.0,660.0,5,851,1.0,583.0,583.0
0.005,6,10,2006,5,927,1.0,659.0,659.0,5,1079,1.0,811.0,811.0
0.012,6,10,1677,5,827,3.0,559.0,559.0,5,850,3.0,582.0,582.0
0.006,17,2,180,1,66,0.0,38.0,38.0,1,114,0.0,86.0,86.0
0.003,17,4,284,2,120,0.0,32.0,32.0,2,164,0.0,60.0,54.0
0.005,6,10,2000,5,927,1.0,659.0,659.0,5,1073,1.0,805.0,805.0
0.062,6,10,1506,5,395,12.0,127.0,127.0,5,1111,13.0,843.0,843.0
0.095,6,10,1506,5,395,20.0,127.0,127.0,5,1111,20.0,843.0,843.0
0.006,6,10,1547,5,764,1.0,496.0,496.0,5,783,1.0,515.0,515.0
0.006,17,2,179,1,71,0.0,43.0,43.0,1,108,0.0,80.0,80.0
0.08,6,10,1506,5,395,18.0,127.0,127.0,5,1111,17.0,843.0,843.0
2.758,6,26,6293,14,2266,212.0,519.0,336.0,12,4027,235.0,1330.0,589.0
0.001,17,2,142,1,63,0.0,35.0,35.0,1,79,0.0,51.0,51.0
0.001,17,2,180,1,66,0.0,38.0,38.0,1,114,0.0,86.0,86.0
0.249,17,14,8577,7,4012,41.0,1350.0,545.0,7,4565,30.0,1350.0,624.0
0.06,6,10,1990,5,911,15.0,643.0,643.0,5,1079,15.0,811.0,811.0
0.001,17,2,180,1,66,0.0,38.0,38.0,1,114,0.0,86.0,86.0
0.02,6,10,1990,5,911,4.0,643.0,643.0,5,1079,4.0,811.0,811.0
308.486,17,20,1124,10,716,34262.0,48.0,43.0,10,408,34259.0,20.0,12.0
0.038,17,2,148,1,60,0.0,32.0,32.0,1,88,0.0,60.0,60.0
0.005,6,10,1689,5,839,1.0,571.0,571.0,5,850,1.0,582.0,582.0
0.008,6,10,1972,5,910,2.0,642.0,642.0,5,1062,2.0,794.0,794.0
30.675,6,862,1298634,366,19930,84.0,517.0,218.0,496,1278704,61.0,4206.0,2541.0
0.005,6,10,1547,5,764,1.0,496.0,496.0,5,783,1.0,515.0,515.0
0.005,17,2,240,1,61,0.0,33.0,33.0,1,179,0.0,151.0,151.0
0.005,6,10,1547,5,764,1.0,496.0,496.0,5,783,1.0,515.0,515.0
0.132,6,10,1506,5,395,31.0,127.0,127.0,5,1111,28.0,843.0,843.0
353.246,6,20,2210,6,1308,12003.0,494.0,494.0,14,902,27172.0,83.0,83.0
0.111,6,10,1506,5,395,25.0,127.0,127.0,5,1111,24.0,843.0,843.0
0.014,6,10,1990,5,911,3.0,643.0,643.0,5,1079,3.0,811.0,811.0
0.005,6,10,1989,5,927,1.0,659.0,659.0,5,1062,1.0,794.0,794.0
0.003,17,2,136,1,60,0.0,32.0,32.0,1,76,0.0,48.0,48.0
0.359,17,44,22257,24,18520,15.0,1350.0,743.0,20,3737,15.0,1350.0,158.0
0.012,6,10,1989,5,910,2.0,642.0,642.0,5,1079,2.0,811.0,811.0
0.132,17,2,152,1,76,0.0,48.0,48.0,1,76,0.0,48.0,48.0
0.072,17,2,182,1,65,0.0,37.0,37.0,1,117,0.0,89.0,89.0
0.005,6,10,1774,5,923,1.0,655.0,655.0,5,851,1.0,583.0,583.0
0.004,6,10,1989,5,927,1.0,659.0,659.0,5,1062,1.0,794.0,794.0
0.008,17,2,179,1,71,0.0,43.0,43.0,1,108,0.0,80.0,80.0
0.014,6,13,3735,7,497,2.0,125.0,125.0,6,3238,2.0,1470.0,1459.0
0.119,6,10,1506,5,395,28.0,127.0,127.0,5,1111,24.0,843.0,843.0
0.006,6,10,1547,5,764,1.0,496.0,496.0,5,783,1.0,515.0,515.0
688.385,6,36,10356,19,4597,38243.0,1273.0,514.0,17,5759,39272.0,1402.0,540.0
0.762,6,23,8442,13,2069,63.0,1142.0,379.0,10,6373,65.0,2720.0,851.0
0.015,6,10,1989,5,910,3.0,642.0,642.0,5,1079,3.0,811.0,811.0
0.009,6,10,1989,5,910,2.0,642.0,642.0,5,1079,2.0,811.0,811.0
0.005,6,10,1774,5,923,1.0,655.0,655.0,5,851,1.0,583.0,583.0
0.011,6,10,1989,5,910,2.0,642.0,642.0,5,1079,2.0,811.0,811.0
0.001,17,2,180,1,66,0.0,38.0,38.0,1,114,0.0,86.0,86.0
0.007,17,2,194,1,59,0.0,31.0,31.0,1,135,0.0,107.0,107.0
0.004,6,10,1779,5,928,1.0,660.0,660.0,5,851,1.0,583.0,583.0
173.2,17,72,10122,36,2385,4948.0,44.0,38.0,36,7737,4948.0,252.0,186.0
0.015,6,10,1762,5,911,3.0,643.0,643.0,5,851,3.0,583.0,583.0
0.006,6,10,1547,5,764,1.0,496.0,496.0,5,783,1.0,515.0,515.0
0.092,6,10,1506,5,395,19.0,127.0,127.0,5,1111,18.0,843.0,843.0
0.011,6,10,1983,5,910,2.0,642.0,642.0,5,1073,2.0,805.0,805.0
0.802,6,28,14133,16,7680,53.0,2720.0,1001.0,12,6453,56.0,2720.0,851.0
240.012,6,9,787,5,488,60003.0,232.0,232.0,4,299,80002.0,83.0,83.0
0.069,6,10,1506,5,395,16.0,127.0,127.0,5,1111,14.0,843.0,843.0
0.038,17,4,284,2,120,0.0,32.0,32.0,2,164,35.0,60.0,54.0
0.005,6,10,1547,5,764,1.0,496.0,496.0,5,783,1.0,515.0,515.0
174.371,17,94,13277,47,3132,3790.0,44.0,38.0,47,10145,3790.0,239.0,187.0
0.012,6,10,1989,5,910,3.0,642.0,642.0,5,1079,3.0,811.0,811.0
0.009,6,10,1762,5,911,2.0,643.0,643.0,5,851,2.0,583.0,583.0
0.015,6,10,1989,5,910,3.0,642.0,642.0,5,1079,3.0,811.0,811.0
0.004,6,10,1702,5,863,0.0,595.0,595.0,5,839,1.0,571.0,571.0
0.009,6,10,1631,5,848,2.0,580.0,580.0,5,783,2.0,515.0,515.0
0.003,17,2,148,1,60,0.0,32.0,32.0,1,88,0.0,60.0,60.0
0.006,17,2,169,1,62,0.0,34.0,34.0,1,107,0.0,79.0,79.0
240.013,6,9,787,5,488,60003.0,232.0,232.0,4,299,80003.0,83.0,83.0
361.81,6,21,1792,16,1030,24120.0,190.0,190.0,5,762,60009.0,461.0,247.0
0.012,6,10,1990,5,911,3.0,643.0,643.0,5,1079,3.0,811.0,811.0
0.067,6,10,1506,5,395,16.0,127.0,127.0,5,1111,14.0,843.0,843.0
1771.987,6,111,12176,56,3774,32217.0,517.0,142.0,55,8402,32813.0,1402.0,614.0
0.083,6,10,1506,5,395,19.0,127.0,127.0,5,1111,20.0,843.0,843.0
0.013,6,10,1989,5,910,3.0,642.0,642.0,5,1079,3.0,811.0,811.0
0.005,17,2,144,1,64,0.0,36.0,36.0,1,80,0.0,52.0,52.0
0.005,6,10,2000,5,927,1.0,659.0,659.0,5,1073,1.0,805.0,805.0
0.004,6,10,1702,5,863,1.0,595.0,595.0,5,839,0.0,571.0,571.0
0.001,17,2,180,1,66,0.0,38.0,38.0,1,114,0.0,86.0,86.0
0.042,17,4,284,2,120,0.0,32.0,32.0,2,164,5.0,60.0,54.0
0.005,6,10,2006,5,927,1.0,659.0,659.0,5,1079,1.0,811.0,811.0
0.009,6,10,1972,5,910,2.0,642.0,642.0,5,1062,2.0,794.0,794.0
0.008,17,2,170,1,65,0.0,37.0,37.0,1,105,0.0,77.0,77.0
0.001,17,2,136,1,60,0.0,32.0,32.0,1,76,0.0,48.0,48.0
0.108,6,10,1506,5,395,22.0,127.0,127.0,5,1111,25.0,843.0,843.0
0.012,6,10,1762,5,911,2.0,643.0,643.0,5,851,3.0,583.0,583.0
0.005,6,10,1989,5,927,1.0,659.0,659.0,5,1062,1.0,794.0,794.0
0.11,6,10,1506,5,395,24.0,127.0,127.0,5,1111,26.0,843.0,843.0
0.005,6,10,2007,5,928,1.0,660.0,660.0,5,1079,1.0,811.0,811.0
0.012,6,10,1989,5,910,3.0,642.0,642.0,5,1079,2.0,811.0,811.0
0.005,6,10,1547,5,764,1.0,496.0,496.0,5,783,1.0,515.0,515.0
40.06,17,10,676,5,460,10014.0,104.0,64.0,5,216,10014.0,20.0,15.0
0.001,17,2,180,1,66,0.0,38.0,38.0,1,114,0.0,86.0,86.0
0.001,17,2,140,1,62,0.0,34.0,34.0,1,78,0.0,50.0,50.0
0.008,6,10,1989,5,910,2.0,642.0,642.0,5,1079,2.0,811.0,811.0
0.015,6,13,3816,7,578,2.0,206.0,206.0,6,3238,2.0,1470.0,1459.0
0.005,6,10,1702,5,863,1.0,595.0,595.0,5,839,1.0,571.0,571.0
0.005,6,10,2007,5,928,1.0,660.0,660.0,5,1079,1.0,811.0,811.0
0.013,6,10,1990,5,911,3.0,643.0,643.0,5,1079,3.0,811.0,811.0
0.076,6,10,1506,5,395,17.0,127.0,127.0,5,1111,17.0,843.0,843.0
0.01,6,10,1989,5,910,2.0,642.0,642.0,5,1079,2.0,811.0,811.0
0.013,6,13,3735,7,497,2.0,125.0,125.0,6,3238,2.0,1470.0,1459.0
0.165,6,10,1506,5,395,39.0,127.0,127.0,5,1111,37.0,843.0,843.0
0.012,6,13,3735,7,497,2.0,125.0,125.0,6,3238,2.0,1470.0,1459.0
15.069,17,15,9238,8,6902,2148.0,1350.0,834.0,7,2336,2506.0,1350.0,305.0
0.014,6,10,1983,5,910,3.0,642.0,642.0,5,1073,3.0,805.0,805.0
0.112,6,10,1506,5,395,27.0,127.0,127.0,5,1111,19.0,843.0,843.0
0.011,6,10,1631,5,848,2.0,580.0,580.0,5,783,2.0,515.0,515.0
0.066,17,8,3613,4,1874,22.0,1350.0,440.0,4,1739,10.0,1350.0,406.0
1787.306,6,150,19350,90,13740,20082.0,302.0,302.0,60,5610,30293.0,83.0,83.0
0.009,6,10,1989,5,910,2.0,642.0,642.0,5,1079,2.0,811.0,811.0
0.072,17,8,3613,4,1874,24.0,1350.0,440.0,4,1739,10.0,1350.0,406.0
1772.56,6,103,6166,59,3473,30560.0,27.0,27.0,44,2693,41221.0,27.0,27.0
0.012,6,10,1989,5,910,3.0,642.0,642.0,5,1079,2.0,811.0,811.0
0.005,6,10,1989,5,927,1.0,659.0,659.0,5,1062,1.0,794.0,794.0
0.004,6,10,1779,5,928,1.0,660.0,660.0,5,851,1.0,583.0,583.0
43.883,6,36,8190,18,1719,519.0,651.0,322.0,18,6471,2573.0,2720.0,478.0
0.005,6,10,2000,5,927,1.0,659.0,659.0,5,1073,1.0,805.0,805.0
0.006,6,10,1854,5,889,1.0,621.0,621.0,5,965,1.0,697.0,697.0
240.117,6,30,8944,15,6549,17151.0,1673.0,641.0,15,2395,17150.0,580.0,229.0
0.011,6,10,1983,5,910,2.0,642.0,642.0,5,1073,2.0,805.0,805.0
0.038,17,4,284,2,120,1.0,32.0,32.0,2,164,34.0,60.0,54.0
0.015,6,10,1990,5,911,3.0,643.0,643.0,5,1079,3.0,811.0,811.0
0.007,17,2,299,1,65,0.0,37.0,37.0,1,234,0.0,206.0,206.0
0.01,6,10,1972,5,910,2.0,642.0,642.0,5,1062,2.0,794.0,794.0
0.008,6,12,1926,6,1189,1.0,659.0,434.0,6,737,1.0,417.0,417.0
11.12,17,28,4418,14,1994,842.0,269.0,114.0,14,2424,842.0,587.0,145.0
0.003,17,4,284,2,120,0.0,32.0,32.0,2,164,0.0,60.0,54.0
0.006,6,10,1547,5,764,1.0,496.0,496.0,5,783,1.0,515.0,515.0
0.071,6,10,1506,5,395,16.0,127.0,127.0,5,1111,13.0,843.0,843.0
0.016,6,10,1989,5,910,4.0,642.0,642.0,5,1079,4.0,811.0,811.0
0.15,17,2,152,1,76,0.0,48.0,48.0,1,76,0.0,48.0,48.0
294.721,6,400,348916,197,21804,1503.0,2736.0,888.0,203,327112,1459.0,2848.0,1674.0
170.301,17,72,10210,36,2401,4865.0,44.0,38.0,36,7809,4865.0,239.0,188.0
0.005,6,10,2000,5,927,1.0,659.0,659.0,5,1073,1.0,805.0,805.0
0.005,17,2,140,1,62,0.0,34.0,34.0,1,78,0.0,50.0,50.0
0.005,6,10,1547,5,764,1.0,496.0,496.0,5,783,1.0,515.0,515.0
0.06,17,2,80,1,32,0.0,4.0,4.0,1,48,0.0,20.0,20.0
0.007,6,10,1762,5,911,1.0,643.0,643.0,5,851,1.0,583.0,583.0
0.004,6,10,2006,5,927,1.0,659.0,659.0,5,1079,1.0,811.0,811.0
360.027,6,21,3981,13,3142,30002.0,494.0,494.0,8,839,51432.0,83.0,83.0
0.004,17,2,136,1,60,0.0,32.0,32.0,1,76,0.0,48.0,48.0
0.006,6,10,2007,5,928,1.0,660.0,660.0,5,1079,1.0,811.0,811.0
0.004,17,2,148,1,60,0.0,32.0,32.0,1,88,0.0,60.0,60.0
0.005,6,10,2006,5,927,1.0,659.0,659.0,5,1079,1.0,811.0,811.0
0.138,6,10,1506,5,395,31.0,127.0,127.0,5,1111,29.0,843.0,843.0
0.011,6,10,1989,5,910,2.0,642.0,642.0,5,1079,2.0,811.0,811.0
0.041,17,4,284,2,120,0.0,32.0,32.0,2,164,38.0,60.0,54.0
0.014,6,10,1972,5,910,3.0,642.0,642.0,5,1062,3.0,794.0,794.0
0.024,6,10,1989,5,910,5.0,642.0,642.0,5,1079,6.0,811.0,811.0
0.004,6,10,2006,5,927,1.0,659.0,659.0,5,1079,1.0,811.0,811.0
0.005,6,10,1689,5,839,1.0,571.0,571.0,5,850,1.0,582.0,582.0
0.017,6,10,1990,5,911,4.0,643.0,643.0,5,1079,4.0,811.0,811.0
0.039,17,2,146,1,65,0.0,37.0,37.0,1,81,0.0,53.0,53.0
0.008,6,12,1926,6,1189,1.0,659.0,434.0,6,737,1.0,417.0,417.0
0.02,6,10,1983,5,910,5.0,642.0,642.0,5,1073,4.0,805.0,805.0
0.096,6,10,1506,5,395,21.0,127.0,127.0,5,1111,21.0,843.0,843.0
176.059,17,68,9830,34,2267,5335.0,44.0,38.0,34,7563,5335.0,239.0,194.0
0.097,6,10,1506,5,395,21.0,127.0,127.0,5,1111,19.0,843.0,843.0
0.022,6,10,1990,5,911,5.0,643.0,643.0,5,1079,5.0,811.0,811.0
0.004,17,2,166,1,75,0.0,47.0,47.0,1,91,0.0,63.0,63.0
0.055,17,2,152,1,76,0.0,48.0,48.0,1,76,0.0,48.0,48.0
0.053,17,2,152,1,76,0.0,48.0,48.0,1,76,0.0,48.0,48.0
0.005,6,10,1547,5,764,1.0,496.0,496.0,5,783,1.0,515.0,515.0
0.11,6,10,1506,5,395,23.0,127.0,127.0,5,1111,23.0,843.0,843.0
0.005,6,10,2000,5,927,1.0,659.0,659.0,5,1073,1.0,805.0,805.0
0.008,6,10,1677,5,827,1.0,559.0,559.0,5,850,2.0,582.0,582.0
0.011,6,10,1983,5,910,2.0,642.0,642.0,5,1073,2.0,805.0,805.0
167.113,17,70,10105,35,2334,4914.0,44.0,38.0,35,7771,4914.0,239.0,194.0
0.248,17,39,20134,21,17035,12.0,1350.0,783.0,18,3099,10.0,1350.0,144.0
0.011,17,2,148,1,60,0.0,32.0,32.0,1,88,0.0,60.0,60.0
240.094,6,16,4481,9,963,30011.0,238.0,166.0,7,3518,40015.0,1402.0,786.0
0.006,6,10,2000,5,927,1.0,659.0,659.0,5,1073,1.0,805.0,805.0
0.004,17,2,148,1,60,0.0,32.0,32.0,1,88,0.0,60.0,60.0
0.081,6,10,1506,5,395,18.0,127.0,127.0,5,1111,19.0,843.0,843.0
0.04,17,2,152,1,76,0.0,48.0,48.0,1,76,0.0,48.0,48.0
0.001,17,2,180,1,66,0.0,38.0,38.0,1,114,0.0,86.0,86.0
0.004,17,2,136,1,60,0.0,32.0,32.0,1,76,0.0,48.0,48.0
15.07,17,15,9238,8,6902,2148.0,1350.0,834.0,7,2336,2506.0,1350.0,305.0
0.005,6,13,3747,7,509,0.0,137.0,137.0,6,3238,1.0,1470.0,1459.0
0.095,6,10,1506,5,395,20.0,127.0,127.0,5,1111,23.0,843.0,843.0
0.005,6,10,2007,5,928,1.0,660.0,660.0,5,1079,1.0,811.0,811.0
0.005,6,10,2006,5,927,1.0,659.0,659.0,5,1079,1.0,811.0,811.0
0.012,6,10,1989,5,910,3.0,642.0,642.0,5,1079,3.0,811.0,811.0
0.016,6,10,1972,5,910,4.0,642.0,642.0,5,1062,4.0,794.0,794.0
0.074,6,10,1506,5,395,16.0,127.0,127.0,5,1111,15.0,843.0,843.0
0.004,6,10,1779,5,928,1.0,660.0,660.0,5,851,1.0,583.0,583.0
0.004,17,2,136,1,60,0.0,32.0,32.0,1,76,0.0,48.0,48.0
0.009,6,10,1990,5,911,2.0,643.0,643.0,5,1079,2.0,811.0,811.0
0.077,6,10,1506,5,395,17.0,127.0,127.0,5,1111,15.0,843.0,843.0
0.006,6,10,1547,5,764,1.0,496.0,496.0,5,783,1.0,515.0,515.0
0.004,6,10,1989,5,927,1.0,659.0,659.0,5,1062,1.0,794.0,794.0
0.126,6,10,1506,5,395,29.0,127.0,127.0,5,1111,26.0,843.0,843.0
0.004,17,2,136,1,60,0.0,32.0,32.0,1,76,0.0,48.0,48.0
0.004,6,10,1702,5,863,1.0,595.0,595.0,5,839,1.0,571.0,571.0
0.006,17,2,225,1,65,0.0,37.0,37.0,1,160,0.0,132.0,132.0
0.004,17,2,148,1,60,0.0,32.0,32.0,1,88,0.0,60.0,60.0
0.096,6,10,1506,5,395,23.0,127.0,127.0,5,1111,23.0,843.0,843.0
0.123,6,10,1506,5,395,28.0,127.0,127.0,5,1111,25.0,843.0,843.0
0.004,6,10,2006,5,927,1.0,659.0,659.0,5,1079,1.0,811.0,811.0
10.777,17,28,4421,14,1993,820.0,268.0,114.0,14,2428,820.0,587.0,145.0
0.06,17,2,152,1,76,0.0,48.0,48.0,1,76,0.0,48.0,48.0
0.005,17,2,225,1,65,0.0,37.0,37.0,1,160,0.0,132.0,132.0
0.036,17,2,148,1,60,0.0,32.0,32.0,1,88,0.0,60.0,60.0
0.017,6,10,1990,5,911,4.0,643.0,643.0,5,1079,4.0,811.0,811.0
0.012,6,10,1972,5,910,2.0,642.0,642.0,5,1062,3.0,794.0,794.0
0.131,6,10,1506,5,395,29.0,127.0,127.0,5,1111,31.0,843.0,843.0
1730.367,6,48,2957,31,1800,57678.0,35.0,35.0,17,1157,108142.0,31.0,31.0
0.008,6,10,1989,5,910,2.0,642.0,642.0,5,1079,1.0,811.0,811.0
0.006,6,10,1547,5,764,1.0,496.0,496.0,5,783,1.0,515.0,515.0
0.011,6,10,1983,5,910,2.0,642.0,642.0,5,1073,2.0,805.0,805.0
0.069,17,8,3613,4,1874,23.0,1350.0,440.0,4,1739,11.0,1350.0,406.0
300.03,6,12,1782,7,1348,50005.0,494.0,494.0,5,434,75006.0,83.0,83.0
0.001,17,2,180,1,66,0.0,38.0,38.0,1,114,0.0,86.0,86.0
9.038,17,6,376,5,280,2259.0,28.0,28.0,1,96,0.0,68.0,68.0
240.098,6,30,9121,15,6770,17149.0,1894.0,666.0,15,2351,17149.0,580.0,195.0
0.126,6,10,1506,5,395,29.0,127.0,127.0,5,1111,26.0,843.0,843.0
0.018,6,10,1990,5,911,4.0,643.0,643.0,5,1079,4.0,811.0,811.0
0.025,6,14,3787,7,497,4.0,125.0,125.0,7,3290,4.0,1448.0,972.0
0.005,17,2,170,1,65,0.0,37.0,37.0,1,105,0.0,77.0,77.0
0.005,6,10,2000,5,927,1.0,659.0,659.0,5,1073,1.0,805.0,805.0
0.005,17,4,284,2,120,0.0,32.0,32.0,2,164,0.0,60.0,54.0
40.053,17,10,676,5,460,10012.0,104.0,64.0,5,216,10012.0,20.0,15.0
0.012,6,10,1631,5,848,3.0,580.0,580.0,5,783,2.0,515.0,515.0
0.008,6,10,1779,5,928,2.0,660.0,660.0,5,851,2.0,583.0,583.0
0.005,17,2,166,1,75,0.0,47.0,47.0,1,91,0.0,63.0,63.0
0.106,6,10,1506,5,395,21.0,127.0,127.0,5,1111,21.0,843.0,843.0
353.984,6,21,1794,16,1030,23598.0,190.0,190.0,5,764,60003.0,463.0,248.0
0.996,6,13,3930,7,2139,124.0,1328.0,923.0,6,1791,149.0,1539.0,1539.0
0.039,17,2,170,1,65,0.0,37.0,37.0,1,105,0.0,77.0,77.0
0.01,6,10,1989,5,910,2.0,642.0,642.0,5,1079,2.0,811.0,811.0
0.006,6,10,2007,5,928,1.0,660.0,660.0,5,1079,1.0,811.0,811.0
0.005,17,2,166,1,75,0.0,47.0,47.0,1,91,0.0,63.0,63.0
0.01,6,10,1990,5,911,2.0,643.0,643.0,5,1079,2.0,811.0,811.0
0.001,17,2,180,1,66,0.0,38.0,38.0,1,114,0.0,86.0,86.0
55.543,6,50,19905,25,13878,381.0,2720.0,1284.0,25,6027,2307.0,2667.0,385.0
0.019,6,10,1990,5,911,4.0,643.0,643.0,5,1079,4.0,811.0,811.0
0.005,6,10,1774,5,923,1.0,655.0,655.0,5,851,1.0,583.0,583.0
0.078,6,10,1506,5,395,18.0,127.0,127.0,5,1111,18.0,843.0,843.0
0.014,6,10,1983,5,910,3.0,642.0,642.0,5,1073,3.0,805.0,805.0
0.023,6,10,1631,5,848,5.0,580.0,580.0,5,783,5.0,515.0,515.0
0.005,6,10,2006,5,927,1.0,659.0,659.0,5,1079,1.0,811.0,811.0
9.133,17,6,376,5,280,2283.0,28.0,28.0,1,96,0.0,68.0,68.0
0.005,17,2,180,1,66,0.0,38.0,38.0,1,114,0.0,86.0,86.0
0.005,17,2,136,1,60,0.0,32.0,32.0,1,76,0.0,48.0,48.0
0.001,17,2,154,1,69,0.0,41.0,41.0,1,85,0.0,57.0,57.0
0.01,6,10,1631,5,848,2.0,580.0,580.0,5,783,2.0,515.0,515.0
0.004,6,10,2006,5,927,1.0,659.0,659.0,5,1079,1.0,811.0,811.0
0.003,17,2,136,1,60,0.0,32.0,32.0,1,76,0.0,48.0,48.0
0.012,6,13,3735,7,497,2.0,125.0,125.0,6,3238,2.0,1470.0,1459.0
0.086,6,10,1506,5,395,17.0,127.0,127.0,5,1111,19.0,843.0,843.0
0.005,6,10,2006,5,927,1.0,659.0,659.0,5,1079,1.0,811.0,811.0
300.294,6,16,2170,9,684,37515.0,146.0,146.0,7,1486,50021.0,419.0,398.0
40.061,17,10,676,5,460,10014.0,104.0,64.0,5,216,10014.0,20.0,15.0
0.01,6,10,1972,5,910,2.0,642.0,642.0,5,1062,2.0,794.0,794.0
0.008,6,10,1989,5,910,2.0,642.0,642.0,5,1079,2.0,811.0,811.0
0.015,6,10,1990,5,911,3.0,643.0,643.0,5,1079,3.0,811.0,811.0
0.008,6,10,1989,5,910,1.0,642.0,642.0,5,1079,2.0,811.0,811.0
0.005,6,10,1779,5,928,1.0,660.0,660.0,5,851,1.0,583.0,583.0
0.006,6,13,3747,7,509,1.0,137.0,137.0,6,3238,1.0,1470.0,1459.0
0.086,6,10,1506,5,395,20.0,127.0,127.0,5,1111,19.0,843.0,843.0
0.092,6,10,1506,5,395,21.0,127.0,127.0,5,1111,20.0,843.0,843.0
0.001,17,2,136,1,60,0.0,32.0,32.0,1,76,0.0,48.0,48.0
0.174,6,3,453,2,321,174.0,241.0,241.0,1,132,0.0,92.0,92.0
0.024,6,10,1989,5,910,6.0,642.0,642.0,5,1079,6.0,811.0,811.0
0.027,6,10,1990,5,911,6.0,643.0,643.0,5,1079,6.0,811.0,811.0
177.132,17,80,11364,40,2673,4541.0,44.0,38.0,40,8691,4541.0,239.0,189.0
0.005,6,10,2006,5,927,1.0,659.0,659.0,5,1079,1.0,811.0,811.0
0.09,6,10,1506,5,395,19.0,127.0,127.0,5,1111,19.0,843.0,843.0
40.065,17,10,676,5,460,10013.0,104.0,64.0,5,216,10015.0,20.0,15.0
0.021,6,10,1989,5,910,5.0,642.0,642.0,5,1079,5.0,811.0,811.0
240.13,6,22,7498,11,2574,24013.0,1368.0,498.0,11,4924,24012.0,1656.0,868.0
0.005,6,10,2007,5,928,1.0,660.0,660.0,5,1079,1.0,811.0,811.0
0.112,6,10,1506,5,395,24.0,127.0,127.0,5,1111,25.0,843.0,843.0
0.001,17,2,166,1,75,0.0,47.0,47.0,1,91,0.0,63.0,63.0
0.004,6,10,1779,5,928,1.0,660.0,660.0,5,851,1.0,583.0,583.0
0.004,6,10,2006,5,927,1.0,659.0,659.0,5,1079,1.0,811.0,811.0
0.08,6,10,1506,5,395,18.0,127.0,127.0,5,1111,17.0,843.0,843.0
0.072,6,10,1506,5,395,16.0,127.0,127.0,5,1111,15.0,843.0,843.0
40.068,17,10,676,5,460,10015.0,104.0,64.0,5,216,10016.0,20.0,15.0
0.005,6,10,2000,5,927,1.0,659.0,659.0,5,1073,1.0,805.0,805.0
0.005,6,10,1854,5,889,1.0,621.0,621.0,5,965,1.0,697.0,697.0
0.005,6,10,2007,5,928,1.0,660.0,660.0,5,1079,1.0,811.0,811.0
306.313,6,26,4943,14,2479,23559.0,676.0,348.0,12,2464,27843.0,824.0,368.0
0.006,6,10,1689,5,839,1.0,571.0,571.0,5,850,1.0,582.0,582.0
0.014,6,10,1989,5,910,3.0,642.0,642.0,5,1079,3.0,811.0,811.0
1778.283,17,144,41760,72,22752,25046.0,288.0,288.0,72,19008,25046.0,236.0,236.0
0.005,6,10,1643,5,860,1.0,592.0,592.0,5,783,1.0,515.0,515.0
0.006,6,10,1547,5,764,1.0,496.0,496.0,5,783,1.0,515.0,515.0
0.12,6,10,1506,5,395,23.0,127.0,127.0,5,1111,26.0,843.0,843.0
0.118,6,10,1506,5,395,26.0,127.0,127.0,5,1111,28.0,843.0,843.0
0.084,6,10,1506,5,395,18.0,127.0,127.0,5,1111,17.0,843.0,843.0
0.006,17,2,168,1,76,0.0,48.0,48.0,1,92,0.0,64.0,64.0
0.011,6,10,1989,5,910,2.0,642.0,642.0,5,1079,2.0,811.0,811.0
0.007,6,10,1989,5,927,1.0,659.0,659.0,5,1062,1.0,794.0,794.0
0.008,6,12,1926,6,1189,1.0,659.0,434.0,6,737,1.0,417.0,417.0
0.003,17,2,136,1,60,0.0,32.0,32.0,1,76,0.0,48.0,48.0
0.004,17,2,136,1,60,0.0,32.0,32.0,1,76,0.0,48.0,48.0
0.005,6,10,1989,5,927,1.0,659.0,659.0,5,1062,1.0,794.0,794.0
0.013,6,10,1989,5,910,3.0,642.0,642.0,5,1079,3.0,811.0,811.0
0.018,6,10,1983,5,910,4.0,642.0,642.0,5,1073,4.0,805.0,805.0
0.005,6,13,3747,7,509,0.0,137.0,137.0,6,3238,0.0,1470.0,1459.0
0.001,17,2,180,1,66,0.0,38.0,38.0,1,114,0.0,86.0,86.0
0.004,6,10,2006,5,927,1.0,659.0,659.0,5,1079,1.0,811.0,811.0
0.162,17,2,152,1,76,0.0,48.0,48.0,1,76,0.0,48.0,48.0
0.005,6,10,1689,5,839,1.0,571.0,571.0,5,850,1.0,582.0,582.0
0.003,17,2,148,1,60,0.0,32.0,32.0,1,88,0.0,60.0,60.0
0.003,17,2,148,1,60,0.0,32.0,32.0,1,88,0.0,60.0,60.0
0.001,17,2,180,1,66,0.0,38.0,38.0,1,114,0.0,86.0,86.0
0.006,6,10,1643,5,860,1.0,592.0,592.0,5,783,1.0,515.0,515.0
240.1,6,19,8109,10,2075,26677.0,1495.0,779.0,9,6034,30012.0,2804.0,1111.0
0.016,6,10,1989,5,910,4.0,642.0,642.0,5,1079,4.0,811.0,811.0
0.062,6,10,1506,5,395,14.0,127.0,127.0,5,1111,13.0,843.0,843.0
0.02,6,10,1990,5,911,4.0,643.0,643.0,5,1079,4.0,811.0,811.0
0.01,6,10,1972,5,910,2.0,642.0,642.0,5,1062,2.0,794.0,794.0
266.543,6,9,787,5,488,66635.0,232.0,232.0,4,299,88846.0,83.0,83.0
0.093,6,10,1506,5,395,20.0,127.0,127.0,5,1111,22.0,843.0,843.0
0.004,6,10,1702,5,863,1.0,595.0,595.0,5,839,1.0,571.0,571.0
0.004,6,10,1702,5,863,1.0,595.0,595.0,5,839,1.0,571.0,571.0
0.016,6,10,1972,5,910,4.0,642.0,642.0,5,1062,4.0,794.0,794.0
0.005,6,10,1774,5,923,1.0,655.0,655.0,5,851,1.0,583.0,583.0
40.053,17,10,676,5,460,10012.0,104.0,64.0,5,216,10012.0,20.0,15.0
0.006,6,10,1689,5,839,1.0,571.0,571.0,5,850,1.0,582.0,582.0
0.005,17,2,156,1,70,0.0,42.0,42.0,1,86,0.0,58.0,58.0
0.129,17,2,80,1,32,0.0,4.0,4.0,1,48,0.0,20.0,20.0
0.072,17,4,420,2,122,1.0,33.0,33.0,2,298,69.0,145.0,121.0
0.094,6,10,1506,5,395,19.0,127.0,127.0,5,1111,21.0,843.0,843.0
0.027,6,10,1989,5,910,6.0,642.0,642.0,5,1079,6.0,811.0,811.0
0.048,17,4,284,2,120,0.0,32.0,32.0,2,164,38.0,60.0,54.0
0.005,6,10,1989,5,927,1.0,659.0,659.0,5,1062,1.0,794.0,794.0
0.009,6,13,3735,7,497,1.0,125.0,125.0,6,3238,1.0,1470.0,1459.0
0.005,6,10,2006,5,927,1.0,659.0,659.0,5,1079,1.0,811.0,811.0
0.005,6,13,3690,7,452,0.0,80.0,80.0,6,3238,0.0,1470.0,1459.0
0.005,6,10,2006,5,927,1.0,659.0,659.0,5,1079,1.0,811.0,811.0
240.029,6,9,787,5,488,60007.0,232.0,232.0,4,299,80008.0,83.0,83.0
308.572,17,20,1124,10,716,34272.0,48.0,43.0,10,408,34272.0,20.0,12.0
0.005,6,10,1989,5,927,1.0,659.0,659.0,5,1062,1.0,794.0,794.0
0.006,17,2,214,1,75,0.0,47.0,47.0,1,139,0.0,111.0,111.0
0.004,17,2,148,1,60,0.0,32.0,32.0,1,88,0.0,60.0,60.0
0.016,6,10,1989,5,910,4.0,642.0,642.0,5,1079,4.0,811.0,811.0
40.054,17,10,676,5,460,10012.0,104.0,64.0,5,216,10012.0,20.0,15.0
40.06,17,10,676,5,460,10014.0,104.0,64.0,5,216,10014.0,20.0,15.0
0.01,6,10,1983,5,910,2.0,642.0,642.0,5,1073,2.0,805.0,805.0
0.009,6,12,1926,6,1189,1.0,659.0,434.0,6,737,1.0,417.0,417.0
0.006,6,10,1854,5,889,1.0,621.0,621.0,5,965,1.0,697.0,697.0
0.014,6,10,1631,5,848,3.0,580.0,580.0,5,783,3.0,515.0,515.0
0.001,17,2,180,1,66,0.0,38.0,38.0,1,114,0.0,86.0,86.0
0.111,6,10,1506,5,395,26.0,127.0,127.0,5,1111,22.0,843.0,843.0
0.006,6,10,2000,5,927,1.0,659.0,659.0,5,1073,1.0,805.0,805.0
0.091,6,10,1506,5,395,21.0,127.0,127.0,5,1111,22.0,843.0,843.0
0.006,6,12,1698,6,863,1.0,327.0,271.0,6,835,1.0,515.0,515.0
0.012,6,10,1990,5,911,2.0,643.0,643.0,5,1079,3.0,811.0,811.0
0.006,17,2,170,1,65,0.0,37.0,37.0,1,105,0.0,77.0,77.0
0.103,6,10,1506,5,395,23.0,127.0,127.0,5,1111,20.0,843.0,843.0
309.494,17,20,1124,10,716,34381.0,48.0,43.0,10,408,34381.0,20.0,12.0
0.004,17,2,148,1,60,0.0,32.0,32.0,1,88,0.0,60.0,60.0
0.041,17,2,184,1,61,0.0,33.0,33.0,1,123,0.0,95.0,95.0
0.096,6,10,1506,5,395,19.0,127.0,127.0,5,1111,21.0,843.0,843.0
0.361,17,2,198,1,91,0.0,63.0,63.0,1,107,0.0,79.0,79.0
0.004,6,10,1779,5,928,1.0,660.0,660.0,5,851,0.0,583.0,583.0
0.044,6,13,3735,7,497,7.0,125.0,125.0,6,3238,8.0,1470.0,1459.0
0.005,6,10,1689,5,839,1.0,571.0,571.0,5,850,1.0,582.0,582.0
11.0,17,28,4423,14,1994,837.0,269.0,114.0,14,2429,837.0,588.0,145.0
0.016,6,10,1762,5,911,4.0,643.0,643.0,5,851,3.0,583.0,583.0
0.009,6,12,1926,6,1189,1.0,659.0,434.0,6,737,1.0,417.0,417.0
1.082,6,12,3134,6,2099,163.0,1328.0,923.0,6,1035,162.0,791.0,791.0
11.003,17,28,4423,14,1994,838.0,269.0,114.0,14,2429,838.0,588.0,145.0
0.211,6,16,2669,8,1395,30.0,533.0,323.0,8,1274,19.0,529.0,212.0
0.005,6,14,3742,7,452,0.0,80.0,80.0,7,3290,0.0,1448.0,972.0
0.104,6,10,1506,5,395,22.0,127.0,127.0,5,1111,23.0,843.0,843.0
333.997,17,20,1124,10,716,37097.0,48.0,43.0,10,408,37097.0,20.0,12.0
361.838,6,19,1688,15,978,25845.0,190.0,190.0,4,710,80012.0,494.0,494.0
1.003,6,12,3142,6,2099,151.0,1328.0,923.0,6,1043,151.0,791.0,791.0
0.007,6,10,2000,5,927,1.0,659.0,659.0,5,1073,1.0,805.0,805.0
0.108,6,10,1506,5,395,25.0,127.0,127.0,5,1111,25.0,843.0,843.0
0.006,17,2,148,1,60,0.0,32.0,32.0,1,88,0.0,60.0,60.0
0.009,6,10,1990,5,911,2.0,643.0,643.0,5,1079,2.0,811.0,811.0
0.01,6,10,1677,5,827,2.0,559.0,559.0,5,850,2.0,582.0,582.0
0.007,6,10,1547,5,764,1.0,496.0,496.0,5,783,1.0,515.0,515.0
0.001,17,2,140,1,62,0.0,34.0,34.0,1,78,0.0,50.0,50.0
0.005,6,10,2006,5,927,1.0,659.0,659.0,5,1079,1.0,811.0,811.0
0.005,6,10,1547,5,764,1.0,496.0,496.0,5,783,1.0,515.0,515.0
300.554,6,24,8033,14,2847,23119.0,1761.0,527.0,10,5186,3970.0,1559.0,776.0
0.005,6,10,1989,5,927,1.0,659.0,659.0,5,1062,1.0,794.0,794.0
0.111,6,10,1506,5,395,25.0,127.0,127.0,5,1111,24.0,843.0,843.0
1.012,6,13,3922,7,2139,126.0,1328.0,923.0,6,1783,152.0,1539.0,1539.0
40.063,17,10,676,5,460,10012.0,104.0,64.0,5,216,10014.0,20.0,15.0
0.095,6,10,1506,5,395,21.0,127.0,127.0,5,1111,21.0,843.0,843.0
0.006,6,10,1689,5,839,1.0,571.0,571.0,5,850,1.0,582.0,582.0
40.066,17,10,676,5,460,10014.0,104.0,64.0,5,216,10015.0,20.0,15.0
0.093,6,10,1506,5,395,20.0,127.0,127.0,5,1111,21.0,843.0,843.0
0.001,17,2,180,1,66,0.0,38.0,38.0,1,114,0.0,86.0,86.0
0.007,17,2,179,1,71,0.0,43.0,43.0,1,108,0.0,80.0,80.0
0.005,6,10,1779,5,928,1.0,660.0,660.0,5,851,1.0,583.0,583.0
0.005,6,10,1547,5,764,1.0,496.0,496.0,5,783,1.0,515.0,515.0
0.006,6,10,1689,5,839,1.0,571.0,571.0,5,850,1.0,582.0,582.0
0.005,17,2,179,1,71,0.0,43.0,43.0,1,108,0.0,80.0,80.0
0.012,6,10,1990,5,911,2.0,643.0,643.0,5,1079,3.0,811.0,811.0
0.789,6,10,2009,6,1655,157.0,1403.0,1403.0,4,354,183.0,182.0,182.0
0.009,6,10,1990,5,911,2.0,643.0,643.0,5,1079,2.0,811.0,811.0
40.061,17,10,676,5,460,10014.0,104.0,64.0,5,216,10014.0,20.0,15.0
0.013,6,10,1972,5,910,3.0,642.0,642.0,5,1062,3.0,794.0,794.0
0.007,6,10,1547,5,764,1.0,496.0,496.0,5,783,1.0,515.0,515.0
0.013,6,10,1972,5,910,3.0,642.0,642.0,5,1062,3.0,794.0,794.0
0.087,6,10,1506,5,395,20.0,127.0,127.0,5,1111,18.0,843.0,843.0
0.009,6,10,1989,5,910,2.0,642.0,642.0,5,1079,2.0,811.0,811.0
0.114,6,10,1506,5,395,24.0,127.0,127.0,5,1111,25.0,843.0,843.0
0.004,6,10,2007,5,928,1.0,660.0,660.0,5,1079,1.0,811.0,811.0
0.078,6,10,1506,5,395,17.0,127.0,127.0,5,1111,15.0,843.0,843.0
0.009,6,10,1983,5,910,2.0,642.0,642.0,5,1073,2.0,805.0,805.0
371.939,6,22,2313,16,867,24795.0,195.0,195.0,6,1446,4643.0,419.0,398.0
0.086,6,10,1506,5,395,16.0,127.0,127.0,5,1111,19.0,843.0,843.0
0.008,6,12,1926,6,1189,1.0,659.0,434.0,6,737,1.0,417.0,417.0
0.022,6,10,1972,5,910,5.0,642.0,642.0,5,1062,5.0,794.0,794.0
0.004,6,10,1774,5,923,1.0,655.0,655.0,5,851,1.0,583.0,583.0
0.005,6,10,2007,5,928,1.0,660.0,660.0,5,1079,1.0,811.0,811.0
0.004,6,10,1702,5,863,1.0,595.0,595.0,5,839,0.0,571.0,571.0
0.061,6,10,1506,5,395,13.0,127.0,127.0,5,1111,14.0,843.0,843.0
0.069,6,10,1506,5,395,15.0,127.0,127.0,5,1111,15.0,843.0,843.0
40.072,17,10,676,5,460,10014.0,104.0,64.0,5,216,10017.0,20.0,15.0
0.006,17,2,164,1,74,0.0,46.0,46.0,1,90,0.0,62.0,62.0
0.104,6,10,1506,5,395,24.0,127.0,127.0,5,1111,22.0,843.0,843.0
0.069,6,10,1506,5,395,15.0,127.0,127.0,5,1111,14.0,843.0,843.0
0.121,6,10,1506,5,395,28.0,127.0,127.0,5,1111,27.0,843.0,843.0
0.009,6,10,1989,5,910,2.0,642.0,642.0,5,1079,2.0,811.0,811.0
0.092,6,10,1506,5,395,16.0,127.0,127.0,5,1111,21.0,843.0,843.0
0.076,6,10,1506,5,395,16.0,127.0,127.0,5,1111,16.0,843.0,843.0
0.005,6,10,2007,5,928,1.0,660.0,660.0,5,1079,1.0,811.0,811.0
0.072,17,2,380,1,61,0.0,33.0,33.0,1,319,0.0,291.0,291.0
1787.541,6,154,19574,92,13852,19643.0,302.0,302.0,62,5722,29303.0,83.0,83.0
352.253,6,20,2210,6,1308,12003.0,494.0,494.0,14,902,27096.0,83.0,83.0
368.451,6,24,2405,17,919,23028.0,195.0,195.0,7,1486,3908.0,419.0,398.0
0.006,6,10,1547,5,764,1.0,496.0,496.0,5,783,1.0,515.0,515.0
0.003,6,10,1702,5,863,0.0,595.0,595.0,5,839,0.0,571.0,571.0
0.015,6,10,1989,5,910,3.0,642.0,642.0,5,1079,3.0,811.0,811.0
0.162,6,10,1506,5,395,38.0,127.0,127.0,5,1111,30.0,843.0,843.0
0.004,17,2,136,1,60,0.0,32.0,32.0,1,76,0.0,48.0,48.0
0.005,6,10,2007,5,928,1.0,660.0,660.0,5,1079,1.0,811.0,811.0
0.105,6,10,1506,5,395,24.0,127.0,127.0,5,1111,22.0,843.0,843.0
0.005,17,2,179,1,71,0.0,43.0,43.0,1,108,0.0,80.0,80.0
0.005,17,2,326,1,76,0.0,48.0,48.0,1,250,0.0,222.0,222.0
0.01,6,10,1990,5,911,2.0,643.0,643.0,5,1079,2.0,811.0,811.0
0.016,6,10,1972,5,910,4.0,642.0,642.0,5,1062,3.0,794.0,794.0
0.009,6,10,1972,5,910,2.0,642.0,642.0,5,1062,2.0,794.0,794.0
0.005,6,10,1643,5,860,1.0,592.0,592.0,5,783,1.0,515.0,515.0
951.816,6,44,13447,23,5961,43264.0,1273.0,527.0,21,7486,44590.0,1402.0,580.0
0.004,6,10,1989,5,927,1.0,659.0,659.0,5,1062,1.0,794.0,794.0
0.004,17,2,148,1,60,0.0,32.0,32.0,1,88,0.0,60.0,60.0
0.014,6,10,1990,5,911,3.0,643.0,643.0,5,1079,3.0,811.0,811.0
0.13,6,10,1506,5,395,30.0,127.0,127.0,5,1111,30.0,843.0,843.0
0.005,6,10,1989,5,927,1.0,659.0,659.0,5,1062,1.0,794.0,794.0
291.992,6,404,348462,205,22218,1431.0,2736.0,888.0,199,326244,1474.0,2804.0,1707.0
0.001,17,2,268,1,70,0.0,42.0,42.0,1,198,0.0,170.0,170.0
40.065,17,10,676,5,460,10014.0,104.0,64.0,5,216,10015.0,20.0,15.0
0.003,17,4,284,2,120,0.0,32.0,32.0,2,164,0.0,60.0,54.0
0.06,6,10,1506,5,395,12.0,127.0,127.0,5,1111,14.0,843.0,843.0
0.003,6,10,1702,5,863,0.0,595.0,595.0,5,839,0.0,571.0,571.0
240.108,6,33,10395,16,7909,16007.0,2883.0,708.0,17,2486,15006.0,580.0,199.0
0.028,6,10,1989,5,910,6.0,642.0,642.0,5,1079,7.0,811.0,811.0
0.005,6,14,3742,7,452,0.0,80.0,80.0,7,3290,0.0,1448.0,972.0
0.006,6,10,1689,5,839,1.0,571.0,571.0,5,850,1.0,582.0,582.0
0.06,6,10,1506,5,395,14.0,127.0,127.0,5,1111,12.0,843.0,843.0
0.011,6,10,1989,5,910,2.0,642.0,642.0,5,1079,2.0,811.0,811.0
0.005,6,10,2007,5,928,1.0,660.0,660.0,5,1079,1.0,811.0,811.0
0.015,6,10,1990,5,911,3.0,643.0,643.0,5,1079,3.0,811.0,811.0
0.008,6,10,1677,5,827,2.0,559.0,559.0,5,850,1.0,582.0,582.0
0.009,6,10,1631,5,848,2.0,580.0,580.0,5,783,2.0,515.0,515.0
0.005,17,2,230,1,68,0.0,40.0,40.0,1,162,0.0,134.0,134.0
241.714,6,377,346881,188,21306,1292.0,2736.0,960.0,189,325575,1285.0,4113.0,1763.0
0.005,6,10,1774,5,923,1.0,655.0,655.0,5,851,1.0,583.0,583.0
0.001,17,2,180,1,66,0.0,38.0,38.0,1,114,0.0,86.0,86.0
0.018,6,10,1990,5,911,4.0,643.0,643.0,5,1079,4.0,811.0,811.0
0.0,17,2,154,1,69,0.0,41.0,41.0,1,85,0.0,57.0,57.0
0.005,17,2,166,1,75,0.0,47.0,47.0,1,91,0.0,63.0,63.0
0.092,6,10,1506,5,395,18.0,127.0,127.0,5,1111,21.0,843.0,843.0
0.115,6,10,1506,5,395,27.0,127.0,127.0,5,1111,23.0,843.0,843.0
0.066,6,10,1506,5,395,14.0,127.0,127.0,5,1111,15.0,843.0,843.0
0.001,17,2,136,1,60,0.0,32.0,32.0,1,76,0.0,48.0,48.0
300.377,6,16,2170,9,684,37526.0,146.0,146.0,7,1486,50034.0,419.0,398.0
0.005,6,10,1774,5,923,1.0,655.0,655.0,5,851,1.0,583.0,583.0
0.014,6,10,1972,5,910,3.0,642.0,642.0,5,1062,3.0,794.0,794.0
10.335,6,20,6143,12,1241,939.0,517.0,201.0,8,4902,1475.0,1402.0,895.0
0.042,17,4,420,2,122,0.0,33.0,33.0,2,298,38.0,145.0,121.0
0.006,6,14,3799,7,509,0.0,137.0,137.0,7,3290,1.0,1448.0,972.0
0.005,6,10,2007,5,928,1.0,660.0,660.0,5,1079,1.0,811.0,811.0
0.009,6,10,1983,5,910,2.0,642.0,642.0,5,1073,2.0,805.0,805.0
0.026,6,10,1972,5,910,6.0,642.0,642.0,5,1062,6.0,794.0,794.0
0.005,17,2,148,1,60,0.0,32.0,32.0,1,88,0.0,60.0,60.0
0.095,6,10,1506,5,395,19.0,127.0,127.0,5,1111,21.0,843.0,843.0
0.01,6,10,1983,5,910,2.0,642.0,642.0,5,1073,2.0,805.0,805.0
0.006,6,10,1547,5,764,1.0,496.0,496.0,5,783,1.0,515.0,515.0
40.056,17,10,676,5,460,10013.0,104.0,64.0,5,216,10013.0,20.0,15.0
0.094,6,10,1506,5,395,18.0,127.0,127.0,5,1111,21.0,843.0,843.0
354.003,6,21,1795,16,1030,23600.0,190.0,190.0,5,765,60002.0,464.0,248.0
0.007,6,10,2000,5,927,1.0,659.0,659.0,5,1073,1.0,805.0,805.0
0.067,6,10,1989,5,910,16.0,642.0,642.0,5,1079,16.0,811.0,811.0
0.105,6,10,1506,5,395,24.0,127.0,127.0,5,1111,25.0,843.0,843.0
0.071,6,10,1506,5,395,14.0,127.0,127.0,5,1111,16.0,843.0,843.0
0.005,17,2,140,1,62,0.0,34.0,34.0,1,78,0.0,50.0,50.0
0.039,17,4,284,2,120,0.0,32.0,32.0,2,164,36.0,60.0,54.0
10.986,17,28,4389,14,2312,836.0,587.0,137.0,14,2077,836.0,268.0,120.0
1787.438,6,288,27196,146,10032,12327.0,747.0,270.0,142,17164,12676.0,1626.0,72.0
0.005,17,2,230,1,68,0.0,40.0,40.0,1,162,0.0,134.0,134.0
0.19,6,26,6596,14,2453,13.0,746.0,341.0,12,4143,16.0,1324.0,585.0
0.041,17,2,152,1,76,0.0,48.0,48.0,1,76,0.0,48.0,48.0
0.006,17,2,230,1,68,0.0,40.0,40.0,1,162,0.0,134.0,134.0
0.009,6,10,1990,5,911,2.0,643.0,643.0,5,1079,2.0,811.0,811.0
0.008,6,10,1989,5,910,2.0,642.0,642.0,5,1079,1.0,811.0,811.0
0.013,6,10,1677,5,827,3.0,559.0,559.0,5,850,3.0,582.0,582.0
0.017,6,10,1972,5,910,4.0,642.0,642.0,5,1062,4.0,794.0,794.0
0.013,6,10,1983,5,910,3.0,642.0,642.0,5,1073,3.0,805.0,805.0
0.014,6,10,1972,5,910,3.0,642.0,642.0,5,1062,3.0,794.0,794.0
0.011,6,10,1972,5,910,2.0,642.0,642.0,5,1062,2.0,794.0,794.0
0.005,17,2,180,1,58,0.0,30.0,30.0,1,122,0.0,94.0,94.0
0.004,6,10,2006,5,927,1.0,659.0,659.0,5,1079,1.0,811.0,811.0
0.001,17,2,180,1,66,0.0,38.0,38.0,1,114,0.0,86.0,86.0
0.11,6,10,1506,5,395,25.0,127.0,127.0,5,1111,24.0,843.0,843.0
0.052,17,2,152,1,76,0.0,48.0,48.0,1,76,0.0,48.0,48.0
0.017,6,10,1677,5,827,4.0,559.0,559.0,5,850,4.0,582.0,582.0
0.134,6,10,1506,5,395,30.0,127.0,127.0,5,1111,31.0,843.0,843.0
0.006,6,10,1547,5,764,1.0,496.0,496.0,5,783,1.0,515.0,515.0
40.058,17,10,676,5,460,10013.0,104.0,64.0,5,216,10013.0,20.0,15.0
0.073,6,10,1506,5,395,12.0,127.0,127.0,5,1111,16.0,843.0,843.0
0.006,6,10,1547,5,764,1.0,496.0,496.0,5,783,1.0,515.0,515.0
0.005,6,10,1989,5,927,1.0,659.0,659.0,5,1062,1.0,794.0,794.0
0.013,6,10,1972,5,910,3.0,642.0,642.0,5,1062,3.0,794.0,794.0
0.225,17,4,596,2,122,188.0,33.0,33.0,2,474,153.0,323.0,209.0
0.005,6,10,2007,5,928,1.0,660.0,660.0,5,1079,1.0,811.0,811.0
0.101,6,10,1506,5,395,22.0,127.0,127.0,5,1111,22.0,843.0,843.0
294.055,6,404,348086,195,21700,1515.0,2736.0,888.0,209,326386,1413.0,4171.0,1618.0
0.004,6,10,2007,5,928,1.0,660.0,660.0,5,1079,1.0,811.0,811.0
0.072,17,4,596,2,122,0.0,33.0,33.0,2,474,32.0,323.0,209.0
0.005,6,10,2006,5,927,1.0,659.0,659.0,5,1079,1.0,811.0,811.0
15.074,17,14,9190,8,6902,2149.0,1350.0,834.0,6,2288,3008.0,1350.0,353.0
0.006,6,10,1547,5,764,1.0,496.0,496.0,5,783,1.0,515.0,515.0
1777.68,17,139,43924,72,22752,25035.0,288.0,288.0,67,21172,26933.0,288.0,288.0
0.006,6,10,1547,5,764,1.0,496.0,496.0,5,783,1.0,515.0,515.0
0.01,6,14,3799,7,509,1.0,137.0,137.0,7,3290,1.0,1448.0,972.0
0.01,6,10,1989,5,910,2.0,642.0,642.0,5,1079,2.0,811.0,811.0
0.011,6,10,1990,5,911,2.0,643.0,643.0,5,1079,2.0,811.0,811.0
0.008,6,10,1990,5,911,1.0,643.0,643.0,5,1079,2.0,811.0,811.0
0.005,6,10,2006,5,927,1.0,659.0,659.0,5,1079,1.0,811.0,811.0
300.444,6,29,8776,14,2478,23110.0,1226.0,348.0,15,6298,21460.0,1592.0,613.0
0.035,6,10,1972,5,910,8.0,642.0,642.0,5,1062,8.0,794.0,794.0
175.094,17,68,9743,34,2266,5305.0,44.0,38.0,34,7477,5305.0,261.0,191.0
0.005,6,10,1989,5,927,1.0,659.0,659.0,5,1062,1.0,794.0,794.0
0.003,17,2,136,1,60,0.0,32.0,32.0,1,76,0.0,48.0,48.0
10.913,17,28,4423,14,1995,831.0,270.0,114.0,14,2428,831.0,587.0,145.0
0.001,17,2,180,1,66,0.0,38.0,38.0,1,114,0.0,86.0,86.0
0.005,17,2,154,1,69,0.0,41.0,41.0,1,85,0.0,57.0,57.0
0.013,6,10,1989,5,910,3.0,642.0,642.0,5,1079,3.0,811.0,811.0
0.001,17,2,166,1,75,0.0,47.0,47.0,1,91,0.0,63.0,63.0
0.073,17,2,184,1,61,0.0,33.0,33.0,1,123,0.0,95.0,95.0
0.006,6,10,1547,5,764,1.0,496.0,496.0,5,783,1.0,515.0,515.0
0.005,6,10,1774,5,923,1.0,655.0,655.0,5,851,1.0,583.0,583.0
0.109,6,10,1506,5,395,25.0,127.0,127.0,5,1111,25.0,843.0,843.0
0.003,17,2,136,1,60,0.0,32.0,32.0,1,76,0.0,48.0,48.0
40.073,17,10,676,5,460,10012.0,104.0,64.0,5,216,10015.0,20.0,15.0
240.016,6,9,787,5,488,60004.0,232.0,232.0,4,299,80004.0,83.0,83.0
0.077,6,10,1506,5,395,17.0,127.0,127.0,5,1111,18.0,843.0,843.0
0.004,17,2,152,1,76,0.0,48.0,48.0,1,76,0.0,48.0,48.0
10.846,17,28,4421,14,1993,825.0,268.0,114.0,14,2428,825.0,587.0,145.0
0.016,6,10,1972,5,910,4.0,642.0,642.0,5,1062,3.0,794.0,794.0
0.039,17,2,136,1,60,0.0,32.0,32.0,1,76,0.0,48.0,48.0
0.004,6,10,2006,5,927,1.0,659.0,659.0,5,1079,1.0,811.0,811.0
40.067,17,10,676,5,460,10014.0,104.0,64.0,5,216,10016.0,20.0,15.0
40.058,17,10,676,5,460,10013.0,104.0,64.0,5,216,10013.0,20.0,15.0
240.094,6,30,7266,15,4699,17149.0,1368.0,488.0,15,2567,17149.0,580.0,222.0
240.514,6,33,8637,17,1838,15029.0,571.0,189.0,16,6799,16031.0,1402.0,597.0
11.445,17,28,4399,14,2313,867.0,588.0,137.0,14,2086,867.0,269.0,121.0
0.137,6,10,1506,5,395,21.0,127.0,127.0,5,1111,31.0,843.0,843.0
0.035,6,10,1972,5,910,8.0,642.0,642.0,5,1062,8.0,794.0,794.0
0.011,6,10,1990,5,911,2.0,643.0,643.0,5,1079,2.0,811.0,811.0
0.031,6,10,1631,5,848,7.0,580.0,580.0,5,783,7.0,515.0,515.0
0.005,6,10,2006,5,927,1.0,659.0,659.0,5,1079,1.0,811.0,811.0
0.005,17,2,180,1,58,0.0,30.0,30.0,1,122,0.0,94.0,94.0
0.005,6,10,1854,5,889,1.0,621.0,621.0,5,965,1.0,697.0,697.0
0.01,6,10,1989,5,910,2.0,642.0,642.0,5,1079,2.0,811.0,811.0
300.336,6,16,2170,9,684,37520.0,146.0,146.0,7,1486,50028.0,419.0,398.0
0.005,6,10,2007,5,928,1.0,660.0,660.0,5,1079,1.0,811.0,811.0
0.139,6,10,1506,5,395,34.0,127.0,127.0,5,1111,29.0,843.0,843.0
0.004,17,2,136,1,60,0.0,32.0,32.0,1,76,0.0,48.0,48.0
0.004,6,10,1989,5,927,1.0,659.0,659.0,5,1062,1.0,794.0,794.0
0.016,6,10,1631,5,848,4.0,580.0,580.0,5,783,4.0,515.0,515.0
0.005,6,10,1989,5,927,1.0,659.0,659.0,5,1062,1.0,794.0,794.0
0.112,6,10,1506,5,395,25.0,127.0,127.0,5,1111,26.0,843.0,843.0
0.01,6,10,1972,5,910,2.0,642.0,642.0,5,1062,2.0,794.0,794.0
0.009,6,12,1926,6,1189,1.0,659.0,434.0,6,737,1.0,417.0,417.0
0.032,6,10,1989,5,910,8.0,642.0,642.0,5,1079,7.0,811.0,811.0
0.017,6,10,1762,5,911,4.0,643.0,643.0,5,851,4.0,583.0,583.0
1787.847,6,156,20087,92,14166,19646.0,302.0,302.0,64,5921,28378.0,83.0,83.0
0.019,6,10,1989,5,910,4.0,642.0,642.0,5,1079,4.0,811.0,811.0
1792.209,6,551,189949,278,163990,6470.0,2883.0,952.0,273,25959,6588.0,580.0,115.0
0.053,17,2,152,1,76,0.0,48.0,48.0,1,76,0.0,48.0,48.0
0.029,6,10,1631,5,848,7.0,580.0,580.0,5,783,7.0,515.0,515.0
0.007,6,10,1631,5,848,1.0,580.0,580.0,5,783,1.0,515.0,515.0
0.087,6,10,1506,5,395,20.0,127.0,127.0,5,1111,19.0,843.0,843.0
0.013,6,10,1983,5,910,3.0,642.0,642.0,5,1073,3.0,805.0,805.0
0.004,17,2,148,1,60,0.0,32.0,32.0,1,88,0.0,60.0,60.0
0.006,17,2,170,1,65,0.0,37.0,37.0,1,105,0.0,77.0,77.0
15.075,17,16,8821,8,6586,2149.0,1350.0,795.0,8,2235,2149.0,1350.0,251.0
310.112,17,20,1124,10,716,34442.0,48.0,43.0,10,408,34443.0,20.0,12.0
0.013,6,10,1983,5,910,3.0,642.0,642.0,5,1073,3.0,805.0,805.0
300.161,6,43,14527,23,8929,13636.0,2720.0,997.0,20,5598,15789.0,2667.0,435.0
0.004,6,10,1989,5,927,1.0,659.0,659.0,5,1062,1.0,794.0,794.0
0.113,6,10,1506,5,395,24.0,127.0,127.0,5,1111,24.0,843.0,843.0
0.005,6,10,2006,5,927,1.0,659.0,659.0,5,1079,1.0,811.0,811.0
0.006,6,10,1547,5,764,1.0,496.0,496.0,5,783,1.0,515.0,515.0
172.414,17,92,12822,46,3070,3831.0,44.0,38.0,46,9752,3831.0,239.0,184.0
0.073,6,10,1506,5,395,16.0,127.0,127.0,5,1111,15.0,843.0,843.0
0.019,6,10,1972,5,910,4.0,642.0,642.0,5,1062,4.0,794.0,794.0
0.072,17,2,170,1,65,0.0,37.0,37.0,1,105,0.0,77.0,77.0
0.011,6,10,1989,5,910,2.0,642.0,642.0,5,1079,2.0,811.0,811.0
0.007,6,14,3799,7,509,1.0,137.0,137.0,7,3290,1.0,1448.0,972.0
0.252,17,43,26591,25,23399,10.0,1350.0,907.0,18,3192,11.0,1350.0,149.0
0.005,17,2,169,1,62,0.0,34.0,34.0,1,107,0.0,79.0,79.0
0.006,6,10,1689,5,839,1.0,571.0,571.0,5,850,1.0,582.0,582.0
0.006,6,10,1689,5,839,1.0,571.0,571.0,5,850,1.0,582.0,582.0
0.113,6,10,1506,5,395,24.0,127.0,127.0,5,1111,19.0,843.0,843.0
0.097,6,10,1506,5,395,20.0,127.0,127.0,5,1111,22.0,843.0,843.0
0.013,6,10,1989,5,910,3.0,642.0,642.0,5,1079,3.0,811.0,811.0
0.001,17,2,166,1,75,0.0,47.0,47.0,1,91,0.0,63.0,63.0
0.01,6,10,1989,5,910,2.0,642.0,642.0,5,1079,2.0,811.0,811.0
10.844,17,28,4422,14,1994,825.0,269.0,114.0,14,2428,825.0,587.0,145.0
0.09,6,10,1506,5,395,20.0,127.0,127.0,5,1111,19.0,843.0,843.0
0.001,17,2,180,1,66,0.0,38.0,38.0,1,114,0.0,86.0,86.0
0.02,6,10,1972,5,910,4.0,642.0,642.0,5,1062,4.0,794.0,794.0
0.015,6,10,1972,5,910,3.0,642.0,642.0,5,1062,3.0,794.0,794.0
0.004,6,10,1989,5,927,1.0,659.0,659.0,5,1062,1.0,794.0,794.0
0.074,17,4,352,2,130,0.0,37.0,37.0,2,222,35.0,89.0,83.0
0.006,6,10,1989,5,927,1.0,659.0,659.0,5,1062,1.0,794.0,794.0
0.005,6,10,2007,5,928,1.0,660.0,660.0,5,1079,1.0,811.0,811.0
0.01,6,10,1989,5,910,2.0,642.0,642.0,5,1079,2.0,811.0,811.0
0.004,17,2,148,1,60,0.0,32.0,32.0,1,88,0.0,60.0,60.0
0.005,6,14,3742,7,452,0.0,80.0,80.0,7,3290,0.0,1448.0,972.0
0.168,17,2,152,1,76,0.0,48.0,48.0,1,76,0.0,48.0,48.0
0.013,6,10,1989,5,910,3.0,642.0,642.0,5,1079,3.0,811.0,811.0
0.005,6,10,1689,5,839,1.0,571.0,571.0,5,850,1.0,582.0,582.0
1721.226,6,61,7143,40,4348,44134.0,1641.0,113.0,21,2795,86052.0,1114.0,85.0
0.006,6,10,1547,5,764,1.0,496.0,496.0,5,783,1.0,515.0,515.0
0.009,6,10,1989,5,910,2.0,642.0,642.0,5,1079,2.0,811.0,811.0
0.128,6,10,1506,5,395,29.0,127.0,127.0,5,1111,24.0,843.0,843.0
0.014,6,10,1989,5,910,3.0,642.0,642.0,5,1079,3.0,811.0,811.0
313.68,17,20,1124,10,716,34839.0,48.0,43.0,10,408,34839.0,20.0,12.0
0.014,6,13,3735,7,497,2.0,125.0,125.0,6,3238,2.0,1470.0,1459.0
0.009,6,12,1926,6,1189,1.0,659.0,434.0,6,737,1.0,417.0,417.0
0.252,6,10,1506,5,395,60.0,127.0,127.0,5,1111,46.0,843.0,843.0
0.011,6,10,1989,5,910,2.0,642.0,642.0,5,1079,2.0,811.0,811.0
0.005,17,2,179,1,71,0.0,43.0,43.0,1,108,0.0,80.0,80.0
0.005,6,10,2006,5,927,1.0,659.0,659.0,5,1079,1.0,811.0,811.0
0.005,17,2,164,1,74,0.0,46.0,46.0,1,90,0.0,62.0,62.0
0.011,6,10,1990,5,911,2.0,643.0,643.0,5,1079,2.0,811.0,811.0
0.018,6,10,1989,5,910,4.0,642.0,642.0,5,1079,4.0,811.0,811.0
0.014,6,10,1990,5,911,3.0,643.0,643.0,5,1079,3.0,811.0,811.0
300.341,6,16,2170,9,684,37522.0,146.0,146.0,7,1486,50028.0,419.0,398.0
0.005,6,10,1689,5,839,1.0,571.0,571.0,5,850,1.0,582.0,582.0
0.005,6,10,2006,5,927,1.0,659.0,659.0,5,1079,1.0,811.0,811.0
0.021,6,10,1983,5,910,5.0,642.0,642.0,5,1073,5.0,805.0,805.0
0.006,6,10,1989,5,927,1.0,659.0,659.0,5,1062,1.0,794.0,794.0
0.015,6,10,1990,5,911,3.0,643.0,643.0,5,1079,3.0,811.0,811.0
48.411,6,36,9195,17,3637,546.0,1360.0,731.0,19,5558,2680.0,1360.0,398.0
0.005,6,13,3747,7,509,0.0,137.0,137.0,6,3238,1.0,1470.0,1459.0
0.008,6,10,1972,5,910,2.0,642.0,642.0,5,1062,2.0,794.0,794.0
0.011,6,14,3787,7,497,1.0,125.0,125.0,7,3290,1.0,1448.0,972.0
0.072,6,10,1506,5,395,16.0,127.0,127.0,5,1111,14.0,843.0,843.0
0.088,6,10,1506,5,395,19.0,127.0,127.0,5,1111,15.0,843.0,843.0
294.137,6,392,348590,192,21552,1539.0,2736.0,889.0,200,327038,1478.0,2804.0,1702.0
0.016,17,2,198,1,91,0.0,63.0,63.0,1,107,0.0,79.0,79.0
0.005,17,2,230,1,68,0.0,40.0,40.0,1,162,0.0,134.0,134.0
40.081,17,10,676,5,460,10019.0,104.0,64.0,5,216,10019.0,20.0,15.0
0.04,17,2,152,1,76,0.0,48.0,48.0,1,76,0.0,48.0,48.0
352.248,6,20,2210,6,1308,12004.0,494.0,494.0,14,902,27095.0,83.0,83.0
63.976,6,40,14109,20,8511,468.0,2720.0,1279.0,20,5598,3358.0,2667.0,435.0
0.001,17,2,180,1,66,0.0,38.0,38.0,1,114,0.0,86.0,86.0
0.012,6,14,3787,7,497,1.0,125.0,125.0,7,3290,1.0,1448.0,972.0
0.117,6,10,1506,5,395,24.0,127.0,127.0,5,1111,26.0,843.0,843.0
0.01,6,10,1972,5,910,2.0,642.0,642.0,5,1062,2.0,794.0,794.0
0.148,6,10,1506,5,395,29.0,127.0,127.0,5,1111,34.0,843.0,843.0
0.09,6,10,1506,5,395,21.0,127.0,127.0,5,1111,20.0,843.0,843.0
0.109,6,10,1506,5,395,24.0,127.0,127.0,5,1111,24.0,843.0,843.0
0.004,6,10,2007,5,928,1.0,660.0,660.0,5,1079,1.0,811.0,811.0
1.067,6,10,1690,6,1336,213.0,1084.0,1084.0,4,354,275.0,182.0,182.0
0.005,6,10,1779,5,928,1.0,660.0,660.0,5,851,1.0,583.0,583.0
0.019,6,10,1989,5,910,4.0,642.0,642.0,5,1079,4.0,811.0,811.0
0.004,17,2,166,1,75,0.0,47.0,47.0,1,91,0.0,63.0,63.0
0.01,6,10,1989,5,910,2.0,642.0,642.0,5,1079,2.0,811.0,811.0
0.004,17,4,284,2,120,0.0,32.0,32.0,2,164,0.0,60.0,54.0
0.005,6,10,2006,5,927,1.0,659.0,659.0,5,1079,1.0,811.0,811.0
412.322,6,29,4409,12,3102,10916.0,494.0,494.0,17,1307,25769.0,83.0,83.0
0.351,17,48,28460,27,24830,13.0,1350.0,891.0,21,3630,16.0,1350.0,144.0
0.001,17,2,136,1,60,0.0,32.0,32.0,1,76,0.0,48.0,48.0
0.004,6,10,2006,5,927,1.0,659.0,659.0,5,1079,1.0,811.0,811.0
0.004,6,10,2007,5,928,1.0,660.0,660.0,5,1079,1.0,811.0,811.0
0.074,6,10,1506,5,395,16.0,127.0,127.0,5,1111,15.0,843.0,843.0
0.005,6,10,1854,5,889,1.0,621.0,621.0,5,965,1.0,697.0,697.0
40.066,17,10,676,5,460,10013.0,104.0,64.0,5,216,10015.0,20.0,15.0
0.006,17,2,179,1,71,0.0,43.0,43.0,1,108,0.0,80.0,80.0
0.005,6,14,3742,7,452,0.0,80.0,80.0,7,3290,0.0,1448.0,972.0
0.011,6,10,1972,5,910,2.0,642.0,642.0,5,1062,2.0,794.0,794.0
0.005,6,10,2007,5,928,1.0,660.0,660.0,5,1079,1.0,811.0,811.0
15.074,17,14,9190,8,6902,2149.0,1350.0,834.0,6,2288,3009.0,1350.0,353.0
0.227,6,10,1506,5,395,51.0,127.0,127.0,5,1111,47.0,843.0,843.0
0.044,17,4,420,2,122,0.0,33.0,33.0,2,298,2.0,145.0,121.0
65.97,6,25,10408,11,3909,6597.0,1579.0,835.0,14,6499,5065.0,2111.0,576.0
300.383,6,16,2170,9,684,37528.0,146.0,146.0,7,1486,50036.0,419.0,398.0
308.618,17,20,1124,10,716,34276.0,48.0,43.0,10,408,34276.0,20.0,12.0
0.006,6,10,1643,5,860,1.0,592.0,592.0,5,783,1.0,515.0,515.0
0.01,6,10,2006,5,927,2.0,659.0,659.0,5,1079,2.0,811.0,811.0
0.067,17,8,3613,4,1874,22.0,1350.0,440.0,4,1739,11.0,1350.0,406.0
0.039,17,2,184,1,61,0.0,33.0,33.0,1,123,0.0,95.0,95.0
0.008,6,10,1989,5,927,1.0,659.0,659.0,5,1062,1.0,794.0,794.0
0.006,6,10,1547,5,764,1.0,496.0,496.0,5,783,1.0,515.0,515.0
0.004,6,10,2007,5,928,1.0,660.0,660.0,5,1079,1.0,811.0,811.0
0.004,17,2,164,1,74,0.0,46.0,46.0,1,90,0.0,62.0,62.0
0.004,17,2,136,1,60,0.0,32.0,32.0,1,76,0.0,48.0,48.0
0.012,6,13,3735,7,497,2.0,125.0,125.0,6,3238,2.0,1470.0,1459.0
11.092,17,26,4102,13,1822,911.0,269.0,112.0,13,2280,911.0,587.0,147.0
0.013,6,10,1990,5,911,3.0,643.0,643.0,5,1079,3.0,811.0,811.0
65.877,6,40,11058,20,5231,478.0,1360.0,879.0,20,5827,3458.0,2667.0,385.0
0.413,17,19,8972,9,6458,51.0,1350.0,689.0,10,2514,39.0,1350.0,223.0
0.005,6,10,1989,5,927,1.0,659.0,659.0,5,1062,1.0,794.0,794.0
294.071,6,321,344281,124,18010,2390.0,2694.0,889.0,197,326271,1500.0,2804.0,1726.0
0.072,6,10,1506,5,395,12.0,127.0,127.0,5,1111,16.0,843.0,843.0
0.005,6,10,1989,5,927,1.0,659.0,659.0,5,1062,1.0,794.0,794.0
40.06,17,10,676,5,460,10014.0,104.0,64.0,5,216,10014.0,20.0,15.0
0.016,6,14,3787,7,497,2.0,125.0,125.0,7,3290,2.0,1448.0,972.0
1.082,6,31,12747,18,3352,63.0,1360.0,517.0,13,9395,73.0,2720.0,984.0
0.005,6,10,2006,5,927,1.0,659.0,659.0,5,1079,1.0,811.0,811.0
0.009,6,10,1989,5,910,2.0,642.0,642.0,5,1079,2.0,811.0,811.0
0.095,6,10,1506,5,395,23.0,127.0,127.0,5,1111,21.0,843.0,843.0
0.006,6,10,1547,5,764,1.0,496.0,496.0,5,783,1.0,515.0,515.0
0.001,17,2,166,1,75,0.0,47.0,47.0,1,91,0.0,63.0,63.0
0.009,6,10,1990,5,911,2.0,643.0,643.0,5,1079,2.0,811.0,811.0
0.251,17,2,152,1,76,0.0,48.0,48.0,1,76,0.0,48.0,48.0
0.073,6,10,1506,5,395,17.0,127.0,127.0,5,1111,13.0,843.0,843.0
11.348,17,34,6342,17,3597,702.0,1143.0,183.0,17,2745,702.0,270.0,133.0
0.136,6,10,1506,5,395,32.0,127.0,127.0,5,1111,31.0,843.0,843.0
312.878,17,20,1124,10,716,34749.0,48.0,43.0,10,408,34749.0,20.0,12.0
0.113,6,10,1506,5,395,27.0,127.0,127.0,5,1111,24.0,843.0,843.0
0.061,17,2,80,1,32,0.0,4.0,4.0,1,48,0.0,20.0,20.0
0.009,6,10,1990,5,911,2.0,643.0,643.0,5,1079,2.0,811.0,811.0
0.005,6,10,2007,5,928,1.0,660.0,660.0,5,1079,1.0,811.0,811.0
0.005,17,2,170,1,65,0.0,37.0,37.0,1,105,0.0,77.0,77.0
0.019,6,10,1989,5,910,4.0,642.0,642.0,5,1079,4.0,811.0,811.0
0.113,6,10,1506,5,395,23.0,127.0,127.0,5,1111,26.0,843.0,843.0
0.013,6,10,1677,5,827,3.0,559.0,559.0,5,850,3.0,582.0,582.0
40.066,17,10,676,5,460,10015.0,104.0,64.0,5,216,10015.0,20.0,15.0
0.069,6,10,1506,5,395,14.0,127.0,127.0,5,1111,15.0,843.0,843.0
0.017,6,10,1989,5,910,4.0,642.0,642.0,5,1079,4.0,811.0,811.0
0.005,6,10,1689,5,839,1.0,571.0,571.0,5,850,1.0,582.0,582.0
0.006,6,10,1547,5,764,1.0,496.0,496.0,5,783,1.0,515.0,515.0
285.265,6,30,6573,16,1433,19017.0,517.0,290.0,14,5140,21943.0,2378.0,1104.0
0.316,17,44,20782,23,17143,14.0,1350.0,717.0,21,3639,14.0,1350.0,145.0
0.005,6,10,1547,5,764,1.0,496.0,496.0,5,783,1.0,515.0,515.0
0.006,6,10,1643,5,860,1.0,592.0,592.0,5,783,1.0,515.0,515.0
0.075,6,10,1506,5,395,15.0,127.0,127.0,5,1111,16.0,843.0,843.0
0.005,6,10,2007,5,928,1.0,660.0,660.0,5,1079,1.0,811.0,811.0
0.014,6,10,1990,5,911,3.0,643.0,643.0,5,1079,3.0,811.0,811.0
126.019,6,13,1909,7,1475,20965.0,1183.0,1183.0,6,434,25158.0,182.0,182.0
0.078,6,10,1506,5,395,19.0,127.0,127.0,5,1111,18.0,843.0,843.0
0.014,6,10,1989,5,910,3.0,642.0,642.0,5,1079,3.0,811.0,811.0
0.129,17,2,80,1,32,0.0,4.0,4.0,1,48,0.0,20.0,20.0
0.076,6,10,1506,5,395,14.0,127.0,127.0,5,1111,17.0,843.0,843.0
0.005,6,10,2000,5,927,1.0,659.0,659.0,5,1073,1.0,805.0,805.0
0.038,6,10,1990,5,911,9.0,643.0,643.0,5,1079,9.0,811.0,811.0
0.134,17,2,80,1,32,0.0,4.0,4.0,1,48,0.0,20.0,20.0
0.129,6,10,1506,5,395,29.0,127.0,127.0,5,1111,31.0,843.0,843.0
0.005,6,14,3799,7,509,0.0,137.0,137.0,7,3290,0.0,1448.0,972.0
0.013,6,10,1989,5,910,3.0,642.0,642.0,5,1079,3.0,811.0,811.0
0.008,6,10,1989,5,910,2.0,642.0,642.0,5,1079,2.0,811.0,811.0
0.108,6,10,1506,5,395,24.0,127.0,127.0,5,1111,23.0,843.0,843.0
0.012,6,10,1972,5,910,3.0,642.0,642.0,5,1062,2.0,794.0,794.0
0.111,6,10,1506,5,395,18.0,127.0,127.0,5,1111,23.0,843.0,843.0
40.074,17,10,676,5,460,10011.0,104.0,64.0,5,216,10012.0,20.0,15.0
0.178,17,17,10150,9,7572,22.0,1350.0,813.0,8,2578,16.0,1350.0,294.0
0.012,6,10,1972,5,910,3.0,642.0,642.0,5,1062,2.0,794.0,794.0
0.008,6,12,1926,6,1189,1.0,659.0,434.0,6,737,1.0,417.0,417.0
0.235,6,10,1506,5,395,55.0,127.0,127.0,5,1111,40.0,843.0,843.0
0.072,17,4,284,2,120,0.0,32.0,32.0,2,164,69.0,60.0,54.0
0.027,6,10,1990,5,911,6.0,643.0,643.0,5,1079,6.0,811.0,811.0
0.008,6,10,1972,5,910,2.0,642.0,642.0,5,1062,2.0,794.0,794.0
0.088,6,10,1506,5,395,21.0,127.0,127.0,5,1111,18.0,843.0,843.0
0.004,6,10,1779,5,928,1.0,660.0,660.0,5,851,1.0,583.0,583.0
0.042,17,4,284,2,120,1.0,32.0,32.0,2,164,38.0,60.0,54.0
10.821,17,28,4423,14,1995,823.0,270.0,114.0,14,2428,823.0,587.0,145.0
0.107,6,10,1506,5,395,24.0,127.0,127.0,5,1111,22.0,843.0,843.0
0.006,17,2,179,1,71,0.0,43.0,43.0,1,108,0.0,80.0,80.0
240.091,6,16,4481,9,963,30011.0,238.0,166.0,7,3518,40014.0,1402.0,786.0
0.007,6,10,1643,5,860,1.0,592.0,592.0,5,783,1.0,515.0,515.0
40.07,17,10,676,5,460,10016.0,104.0,64.0,5,216,10016.0,20.0,15.0
0.215,6,16,2669,8,1395,30.0,533.0,323.0,8,1274,19.0,529.0,212.0
0.006,6,10,1689,5,839,1.0,571.0,571.0,5,850,1.0,582.0,582.0
0.015,6,10,1989,5,910,3.0,642.0,642.0,5,1079,3.0,811.0,811.0
0.005,6,13,3747,7,509,0.0,137.0,137.0,6,3238,1.0,1470.0,1459.0
0.005,6,10,1989,5,927,1.0,659.0,659.0,5,1062,1.0,794.0,794.0
0.071,17,2,136,1,60,0.0,32.0,32.0,1,76,0.0,48.0,48.0
0.004,6,10,2000,5,927,1.0,659.0,659.0,5,1073,1.0,805.0,805.0
40.071,17,10,676,5,460,10014.0,104.0,64.0,5,216,10011.0,20.0,15.0
0.012,6,10,1989,5,910,3.0,642.0,642.0,5,1079,3.0,811.0,811.0
0.004,6,10,1702,5,863,1.0,595.0,595.0,5,839,0.0,571.0,571.0
0.005,6,10,2006,5,927,1.0,659.0,659.0,5,1079,1.0,811.0,811.0
1786.73,6,159,20243,94,14270,19212.0,302.0,302.0,65,5973,27917.0,83.0,83.0
40.05,17,10,676,5,460,10011.0,104.0,64.0,5,216,10011.0,20.0,15.0
0.007,17,2,230,1,68,0.0,40.0,40.0,1,162,0.0,134.0,134.0
0.103,6,10,1506,5,395,24.0,127.0,127.0,5,1111,23.0,843.0,843.0
0.004,6,10,2006,5,927,1.0,659.0,659.0,5,1079,1.0,811.0,811.0
0.006,6,10,1774,5,923,1.0,655.0,655.0,5,851,1.0,583.0,583.0
0.06,17,2,152,1,76,0.0,48.0,48.0,1,76,0.0,48.0,48.0
0.007,6,10,1689,5,839,1.0,571.0,571.0,5,850,1.0,582.0,582.0
0.005,17,2,144,1,64,0.0,36.0,36.0,1,80,0.0,52.0,52.0
0.006,6,10,1989,5,927,1.0,659.0,659.0,5,1062,1.0,794.0,794.0
1778.596,17,144,45504,72,22752,25048.0,288.0,288.0,72,22752,25047.0,288.0,288.0
0.054,17,4,336,2,124,0.0,34.0,34.0,2,212,0.0,84.0,78.0
0.008,6,14,3787,7,497,1.0,125.0,125.0,7,3290,1.0,1448.0,972.0
0.01,6,10,1972,5,910,2.0,642.0,642.0,5,1062,2.0,794.0,794.0
0.105,6,10,1506,5,395,22.0,127.0,127.0,5,1111,24.0,843.0,843.0
0.004,6,10,1702,5,863,1.0,595.0,595.0,5,839,1.0,571.0,571.0
308.579,17,20,1124,10,716,34271.0,48.0,43.0,10,408,34271.0,20.0,12.0
0.007,6,10,1989,5,910,1.0,642.0,642.0,5,1079,1.0,811.0,811.0
0.005,6,13,3747,7,509,0.0,137.0,137.0,6,3238,1.0,1470.0,1459.0
0.015,6,10,1972,5,910,3.0,642.0,642.0,5,1062,3.0,794.0,794.0
0.007,17,2,169,1,62,0.0,34.0,34.0,1,107,0.0,79.0,79.0
0.222,6,16,2778,8,1396,31.0,533.0,324.0,8,1382,20.0,529.0,239.0
0.128,17,2,80,1,32,0.0,4.0,4.0,1,48,0.0,20.0,20.0
0.012,6,10,1990,5,911,3.0,643.0,643.0,5,1079,3.0,811.0,811.0
0.012,6,10,1972,5,910,3.0,642.0,642.0,5,1062,3.0,794.0,794.0
0.001,17,2,180,1,66,0.0,38.0,38.0,1,114,0.0,86.0,86.0
11.495,17,28,4397,14,2311,871.0,586.0,137.0,14,2086,871.0,269.0,121.0
0.003,17,2,136,1,60,0.0,32.0,32.0,1,76,0.0,48.0,48.0
0.059,17,2,152,1,76,0.0,48.0,48.0,1,76,0.0,48.0,48.0
0.011,6,10,1990,5,911,2.0,643.0,643.0,5,1079,2.0,811.0,811.0
0.018,6,10,1990,5,911,4.0,643.0,643.0,5,1079,4.0,811.0,811.0
0.007,17,2,338,1,74,0.0,46.0,46.0,1,264,0.0,236.0,236.0
0.004,6,10,1702,5,863,1.0,595.0,595.0,5,839,0.0,571.0,571.0
0.001,17,2,194,1,57,0.0,29.0,29.0,1,137,0.0,109.0,109.0
0.084,6,10,1506,5,395,19.0,127.0,127.0,5,1111,19.0,843.0,843.0
0.013,6,10,1631,5,848,3.0,580.0,580.0,5,783,3.0,515.0,515.0
0.07,6,10,1506,5,395,16.0,127.0,127.0,5,1111,15.0,843.0,843.0
0.192,6,44,11551,24,3222,8.0,1022.0,197.0,20,8329,9.0,1402.0,606.0
0.019,6,10,1762,5,911,4.0,643.0,643.0,5,851,4.0,583.0,583.0
0.006,17,2,136,1,60,0.0,32.0,32.0,1,76,0.0,48.0,48.0
0.083,6,10,1506,5,395,17.0,127.0,127.0,5,1111,19.0,843.0,843.0
1756.388,6,107,6344,60,3510,29768.0,26.0,26.0,47,2834,38181.0,26.0,26.0
0.006,6,10,1689,5,839,1.0,571.0,571.0,5,850,1.0,582.0,582.0
0.019,6,10,1972,5,910,4.0,642.0,642.0,5,1062,4.0,794.0,794.0
367.303,6,22,2313,16,867,24486.0,195.0,195.0,6,1446,4643.0,419.0,398.0
0.006,6,10,1689,5,839,1.0,571.0,571.0,5,850,1.0,582.0,582.0
0.011,6,10,1972,5,910,2.0,642.0,642.0,5,1062,2.0,794.0,794.0
0.07,17,8,3613,4,1874,23.0,1350.0,440.0,4,1739,12.0,1350.0,406.0
0.009,6,10,1972,5,910,2.0,642.0,642.0,5,1062,2.0,794.0,794.0
0.025,6,10,1990,5,911,6.0,643.0,643.0,5,1079,6.0,811.0,811.0
0.005,6,10,2000,5,927,1.0,659.0,659.0,5,1073,1.0,805.0,805.0
0.012,6,10,1989,5,910,2.0,642.0,642.0,5,1079,3.0,811.0,811.0
0.001,17,2,180,1,66,0.0,38.0,38.0,1,114,0.0,86.0,86.0
0.006,6,10,1547,5,764,1.0,496.0,496.0,5,783,1.0,515.0,515.0
40.078,17,10,676,5,460,10016.0,104.0,64.0,5,216,10008.0,20.0,15.0
0.013,6,10,1989,5,910,3.0,642.0,642.0,5,1079,3.0,811.0,811.0
11.903,17,42,9390,21,5102,589.0,1337.0,214.0,21,4288,589.0,862.0,176.0
0.007,6,10,2007,5,928,1.0,660.0,660.0,5,1079,1.0,811.0,811.0
40.06,17,10,676,5,460,10013.0,104.0,64.0,5,216,10014.0,20.0,15.0
0.006,6,10,1689,5,839,1.0,571.0,571.0,5,850,1.0,582.0,582.0
0.005,6,10,2006,5,927,1.0,659.0,659.0,5,1079,1.0,811.0,811.0
0.042,17,2,148,1,60,0.0,32.0,32.0,1,88,0.0,60.0,60.0
0.075,6,10,1506,5,395,15.0,127.0,127.0,5,1111,18.0,843.0,843.0
0.01,6,10,1990,5,911,2.0,643.0,643.0,5,1079,2.0,811.0,811.0
0.001,17,2,180,1,66,0.0,38.0,38.0,1,114,0.0,86.0,86.0
173.148,17,74,10437,37,2466,4809.0,44.0,38.0,37,7971,4809.0,260.0,187.0
0.006,6,10,1689,5,839,1.0,571.0,571.0,5,850,1.0,582.0,582.0
0.008,6,10,1762,5,911,2.0,643.0,643.0,5,851,2.0,583.0,583.0
0.07,17,8,3613,4,1874,23.0,1350.0,440.0,4,1739,12.0,1350.0,406.0
0.018,6,10,1990,5,911,4.0,643.0,643.0,5,1079,4.0,811.0,811.0
11.098,17,28,4417,14,1994,841.0,269.0,114.0,14,2423,841.0,586.0,145.0
0.006,6,10,1547,5,764,1.0,496.0,496.0,5,783,1.0,515.0,515.0
0.005,6,10,2000,5,927,1.0,659.0,659.0,5,1073,1.0,805.0,805.0
0.005,6,11,2059,6,980,1.0,660.0,660.0,5,1079,1.0,811.0,811.0
0.016,6,10,1990,5,911,3.0,643.0,643.0,5,1079,4.0,811.0,811.0
0.005,6,10,1779,5,928,1.0,660.0,660.0,5,851,1.0,583.0,583.0
0.005,6,10,2000,5,927,1.0,659.0,659.0,5,1073,1.0,805.0,805.0
10.871,17,28,4423,14,1994,827.0,269.0,114.0,14,2429,827.0,588.0,145.0
0.106,6,10,1506,5,395,18.0,127.0,127.0,5,1111,23.0,843.0,843.0
0.005,6,10,1989,5,927,1.0,659.0,659.0,5,1062,1.0,794.0,794.0
0.011,6,7,695,4,448,3.0,232.0,232.0,3,247,3.0,83.0,83.0
0.126,6,10,1242,5,751,31.0,495.0,495.0,5,491,30.0,223.0,223.0
0.005,6,10,1689,5,839,1.0,571.0,571.0,5,850,1.0,582.0,582.0
40.065,17,10,676,5,460,10014.0,104.0,64.0,5,216,10015.0,20.0,15.0
0.08,6,10,1506,5,395,17.0,127.0,127.0,5,1111,18.0,843.0,843.0
0.006,6,10,1547,5,764,1.0,496.0,496.0,5,783,1.0,515.0,515.0
0.006,6,10,1547,5,764,1.0,496.0,496.0,5,783,1.0,515.0,515.0
0.004,6,10,1702,5,863,1.0,595.0,595.0,5,839,1.0,571.0,571.0
0.004,6,10,1989,5,927,1.0,659.0,659.0,5,1062,1.0,794.0,794.0
0.006,6,10,1689,5,839,1.0,571.0,571.0,5,850,1.0,582.0,582.0
0.014,6,10,1989,5,910,3.0,642.0,642.0,5,1079,3.0,811.0,811.0
300.023,6,12,1782,7,1348,50003.0,494.0,494.0,5,434,75005.0,83.0,83.0
0.003,6,10,1702,5,863,0.0,595.0,595.0,5,839,0.0,571.0,571.0
0.005,17,2,214,1,75,0.0,47.0,47.0,1,139,0.0,111.0,111.0
0.006,6,10,1689,5,839,1.0,571.0,571.0,5,850,1.0,582.0,582.0
377.325,6,21,1793,16,1030,25155.0,190.0,190.0,5,763,60022.0,462.0,247.0
0.058,17,2,152,1,76,0.0,48.0,48.0,1,76,0.0,48.0,48.0
0.001,17,2,136,1,60,0.0,32.0,32.0,1,76,0.0,48.0,48.0
0.016,6,10,1972,5,910,3.0,642.0,642.0,5,1062,3.0,794.0,794.0
0.104,6,10,1506,5,395,23.0,127.0,127.0,5,1111,23.0,843.0,843.0
0.12,6,10,1506,5,395,28.0,127.0,127.0,5,1111,25.0,843.0,843.0
0.017,6,10,1643,5,860,4.0,592.0,592.0,5,783,4.0,515.0,515.0
0.004,6,10,2006,5,927,1.0,659.0,659.0,5,1079,1.0,811.0,811.0
0.011,6,10,1990,5,911,2.0,643.0,643.0,5,1079,2.0,811.0,811.0
0.092,6,10,1506,5,395,21.0,127.0,127.0,5,1111,19.0,843.0,843.0
0.005,6,13,3747,7,509,0.0,137.0,137.0,6,3238,1.0,1470.0,1459.0
0.004,6,10,1989,5,927,1.0,659.0,659.0,5,1062,1.0,794.0,794.0
0.005,6,10,1989,5,927,1.0,659.0,659.0,5,1062,1.0,794.0,794.0
11.258,17,28,4418,14,1994,853.0,269.0,114.0,14,2424,853.0,587.0,145.0
0.092,6,10,1506,5,395,22.0,127.0,127.0,5,1111,17.0,843.0,843.0
0.024,6,10,1989,5,910,6.0,642.0,642.0,5,1079,5.0,811.0,811.0
0.001,17,2,136,1,60,0.0,32.0,32.0,1,76,0.0,48.0,48.0
0.005,6,10,2007,5,928,1.0,660.0,660.0,5,1079,1.0,811.0,811.0
0.009,6,10,1989,5,910,2.0,642.0,642.0,5,1079,2.0,811.0,811.0
0.01,6,13,3735,7,497,1.0,125.0,125.0,6,3238,2.0,1470.0,1459.0
0.005,6,10,1989,5,927,1.0,659.0,659.0,5,1062,1.0,794.0,794.0
240.021,6,9,787,5,488,60005.0,232.0,232.0,4,299,80006.0,83.0,83.0
0.11,6,10,1506,5,395,24.0,127.0,127.0,5,1111,23.0,843.0,843.0
0.005,6,10,1689,5,839,1.0,571.0,571.0,5,850,1.0,582.0,582.0
0.091,6,10,1506,5,395,20.0,127.0,127.0,5,1111,20.0,843.0,843.0
0.073,6,10,1506,5,395,16.0,127.0,127.0,5,1111,14.0,843.0,843.0
0.094,6,10,1506,5,395,19.0,127.0,127.0,5,1111,21.0,843.0,843.0
0.004,17,2,148,1,60,0.0,32.0,32.0,1,88,0.0,60.0,60.0
0.053,17,2,152,1,76,0.0,48.0,48.0,1,76,0.0,48.0,48.0
0.004,17,2,166,1,75,0.0,47.0,47.0,1,91,0.0,63.0,63.0
0.005,6,10,2006,5,927,1.0,659.0,659.0,5,1079,1.0,811.0,811.0
0.008,6,10,1972,5,910,1.0,642.0,642.0,5,1062,2.0,794.0,794.0
353.234,6,20,2210,6,1308,12004.0,494.0,494.0,14,902,27171.0,83.0,83.0
0.005,6,13,3747,7,509,0.0,137.0,137.0,6,3238,0.0,1470.0,1459.0
0.007,6,10,1547,5,764,1.0,496.0,496.0,5,783,1.0,515.0,515.0
0.009,6,10,1972,5,910,2.0,642.0,642.0,5,1062,2.0,794.0,794.0
0.005,6,10,2006,5,927,1.0,659.0,659.0,5,1079,1.0,811.0,811.0
0.04,17,2,184,1,61,0.0,33.0,33.0,1,123,0.0,95.0,95.0
0.017,6,10,1677,5,827,4.0,559.0,559.0,5,850,4.0,582.0,582.0
0.009,6,12,1926,6,1189,1.0,659.0,434.0,6,737,1.0,417.0,417.0
0.111,6,10,1506,5,395,22.0,127.0,127.0,5,1111,25.0,843.0,843.0
163.288,17,86,12548,43,2897,3887.0,44.0,39.0,43,9651,3887.0,260.0,196.0
0.005,6,10,2006,5,927,1.0,659.0,659.0,5,1079,1.0,811.0,811.0
0.001,17,2,180,1,66,0.0,38.0,38.0,1,114,0.0,86.0,86.0
0.017,6,10,1990,5,911,4.0,643.0,643.0,5,1079,4.0,811.0,811.0
0.008,6,12,1926,6,1189,1.0,659.0,434.0,6,737,1.0,417.0,417.0
0.005,6,10,1779,5,928,1.0,660.0,660.0,5,851,1.0,583.0,583.0
0.005,6,10,2006,5,927,1.0,659.0,659.0,5,1079,1.0,811.0,811.0
0.114,6,10,1506,5,395,23.0,127.0,127.0,5,1111,23.0,843.0,843.0
0.005,6,10,2006,5,927,1.0,659.0,659.0,5,1079,1.0,811.0,811.0
0.206,6,16,2670,8,1396,29.0,533.0,324.0,8,1274,19.0,529.0,212.0
40.067,17,10,676,5,460,10015.0,104.0,64.0,5,216,10014.0,20.0,15.0
0.208,6,16,2670,8,1396,29.0,533.0,324.0,8,1274,19.0,529.0,212.0
0.05,17,2,152,1,76,0.0,48.0,48.0,1,76,0.0,48.0,48.0
0.01,6,10,1677,5,827,2.0,559.0,559.0,5,850,2.0,582.0,582.0
0.004,6,10,2007,5,928,1.0,660.0,660.0,5,1079,1.0,811.0,811.0
0.069,6,10,1506,5,395,14.0,127.0,127.0,5,1111,14.0,843.0,843.0
0.005,6,10,2007,5,928,1.0,660.0,660.0,5,1079,1.0,811.0,811.0
0.005,6,10,1643,5,860,1.0,592.0,592.0,5,783,1.0,515.0,515.0
0.312,17,4,596,2,122,179.0,33.0,33.0,2,474,240.0,323.0,209.0
0.001,17,2,180,1,66,0.0,38.0,38.0,1,114,0.0,86.0,86.0
40.053,17,10,676,5,460,10010.0,104.0,64.0,5,216,10012.0,20.0,15.0
0.063,6,19,9922,11,704,6.0,124.0,124.0,8,9218,9.0,2896.0,2198.0
0.005,17,2,148,1,60,0.0,32.0,32.0,1,88,0.0,60.0,60.0
0.111,6,10,1506,5,395,23.0,127.0,127.0,5,1111,27.0,843.0,843.0
0.005,6,14,3742,8,504,0.0,80.0,80.0,6,3238,1.0,1470.0,1459.0
0.016,6,10,1972,5,910,4.0,642.0,642.0,5,1062,4.0,794.0,794.0
0.005,6,10,2006,5,927,1.0,659.0,659.0,5,1079,1.0,811.0,811.0
0.009,6,13,3735,7,497,1.0,125.0,125.0,6,3238,1.0,1470.0,1459.0
0.004,6,10,1774,5,923,1.0,655.0,655.0,5,851,1.0,583.0,583.0
0.003,17,4,284,2,120,0.0,32.0,32.0,2,164,0.0,60.0,54.0
0.005,6,14,3742,8,504,0.0,80.0,80.0,6,3238,0.0,1470.0,1459.0
0.006,6,10,1547,5,764,1.0,496.0,496.0,5,783,1.0,515.0,515.0
0.005,6,14,3742,7,452,0.0,80.0,80.0,7,3290,0.0,1448.0,972.0
0.014,6,10,1677,5,827,3.0,559.0,559.0,5,850,3.0,582.0,582.0
0.037,6,10,1990,5,911,9.0,643.0,643.0,5,1079,9.0,811.0,811.0
0.089,6,10,1506,5,395,19.0,127.0,127.0,5,1111,19.0,843.0,843.0
0.009,6,10,1990,5,911,2.0,643.0,643.0,5,1079,2.0,811.0,811.0
0.015,6,10,1983,5,910,3.0,642.0,642.0,5,1073,3.0,805.0,805.0
0.005,6,10,1989,5,927,1.0,659.0,659.0,5,1062,1.0,794.0,794.0
0.011,6,10,1972,5,910,2.0,642.0,642.0,5,1062,2.0,794.0,794.0
0.004,17,2,148,1,60,0.0,32.0,32.0,1,88,0.0,60.0,60.0
0.042,17,4,580,2,122,0.0,33.0,33.0,2,458,2.0,307.0,201.0
0.04,6,10,1605,5,388,9.0,120.0,120.0,5,1217,10.0,949.0,949.0
0.105,6,10,1506,5,395,21.0,127.0,127.0,5,1111,22.0,843.0,843.0
0.004,17,2,142,1,63,0.0,35.0,35.0,1,79,0.0,51.0,51.0
40.064,17,10,676,5,460,10012.0,104.0,64.0,5,216,10015.0,20.0,15.0
10.809,17,28,4418,14,1994,822.0,269.0,114.0,14,2424,822.0,587.0,145.0
0.02,6,10,1989,5,910,5.0,642.0,642.0,5,1079,4.0,811.0,811.0
0.086,6,10,1506,5,395,20.0,127.0,127.0,5,1111,18.0,843.0,843.0
0.009,6,10,1990,5,911,2.0,643.0,643.0,5,1079,2.0,811.0,811.0
0.008,17,2,166,1,75,0.0,47.0,47.0,1,91,0.0,63.0,63.0
0.252,17,43,26421,25,23384,10.0,1350.0,907.0,18,3037,11.0,1350.0,140.0
0.004,17,2,136,1,60,0.0,32.0,32.0,1,76,0.0,48.0,48.0
0.054,6,10,1972,5,910,13.0,642.0,642.0,5,1062,13.0,794.0,794.0
0.006,6,10,1854,5,889,1.0,621.0,621.0,5,965,1.0,697.0,697.0
0.1,6,10,1506,5,395,20.0,127.0,127.0,5,1111,21.0,843.0,843.0
0.005,6,10,1989,5,927,1.0,659.0,659.0,5,1062,1.0,794.0,794.0
0.006,6,10,1547,5,764,1.0,496.0,496.0,5,783,1.0,515.0,515.0
0.013,6,10,1989,5,910,3.0,642.0,642.0,5,1079,3.0,811.0,811.0
0.004,6,10,1702,5,863,1.0,595.0,595.0,5,839,0.0,571.0,571.0
48.51,6,35,9840,17,4322,552.0,3257.0,1203.0,18,5518,2843.0,2667.0,435.0
0.003,17,2,162,1,65,0.0,37.0,37.0,1,97,0.0,69.0,69.0
0.016,6,10,1989,5,910,3.0,642.0,642.0,5,1079,4.0,811.0,811.0
0.013,6,13,3735,7,497,2.0,125.0,125.0,6,3238,2.0,1470.0,1459.0
0.058,6,10,1506,5,395,13.0,127.0,127.0,5,1111,11.0,843.0,843.0
0.005,6,10,2007,5,928,1.0,660.0,660.0,5,1079,1.0,811.0,811.0
1770.464,6,83,4368,42,2210,43181.0,26.0,26.0,41,2158,44260.0,26.0,26.0
0.01,6,10,1989,5,910,2.0,642.0,642.0,5,1079,2.0,811.0,811.0
0.014,6,10,1972,5,910,3.0,642.0,642.0,5,1062,3.0,794.0,794.0
0.011,6,10,1631,5,848,2.0,580.0,580.0,5,783,2.0,515.0,515.0
0.004,6,10,1774,5,923,1.0,655.0,655.0,5,851,1.0,583.0,583.0
0.008,6,10,1643,5,860,2.0,592.0,592.0,5,783,1.0,515.0,515.0
0.005,6,10,1989,5,927,1.0,659.0,659.0,5,1062,1.0,794.0,794.0
0.109,6,10,1506,5,395,25.0,127.0,127.0,5,1111,24.0,843.0,843.0
0.014,6,10,1677,5,827,3.0,559.0,559.0,5,850,3.0,582.0,582.0
0.038,17,2,148,1,60,0.0,32.0,32.0,1,88,0.0,60.0,60.0
0.011,6,12,1926,6,1189,2.0,659.0,434.0,6,737,2.0,417.0,417.0
0.002,17,2,357,1,68,0.0,40.0,40.0,1,289,0.0,261.0,261.0
0.003,17,4,284,2,120,0.0,32.0,32.0,2,164,0.0,60.0,54.0
0.239,17,4,580,2,122,113.0,33.0,33.0,2,458,230.0,307.0,201.0
0.095,6,10,1506,5,395,22.0,127.0,127.0,5,1111,20.0,843.0,843.0
0.083,6,10,1506,5,395,17.0,127.0,127.0,5,1111,18.0,843.0,843.0
0.004,6,10,2007,5,928,1.0,660.0,660.0,5,1079,1.0,811.0,811.0
0.081,6,10,1506,5,395,18.0,127.0,127.0,5,1111,18.0,843.0,843.0
0.013,6,10,1972,5,910,3.0,642.0,642.0,5,1062,3.0,794.0,794.0
0.107,6,10,1506,5,395,23.0,127.0,127.0,5,1111,25.0,843.0,843.0
0.039,17,2,148,1,60,0.0,32.0,32.0,1,88,0.0,60.0,60.0
10.831,17,28,4419,14,1994,824.0,269.0,114.0,14,2425,824.0,588.0,145.0
40.054,17,10,676,5,460,10012.0,104.0,64.0,5,216,10012.0,20.0,15.0
0.013,6,10,1762,5,911,3.0,643.0,643.0,5,851,3.0,583.0,583.0
0.004,17,2,170,1,65,0.0,37.0,37.0,1,105,0.0,77.0,77.0
0.027,6,10,1631,5,848,6.0,580.0,580.0,5,783,6.0,515.0,515.0
0.044,17,2,170,1,65,0.0,37.0,37.0,1,105,0.0,77.0,77.0
0.011,6,10,1677,5,827,2.0,559.0,559.0,5,850,2.0,582.0,582.0
0.009,6,10,1972,5,910,2.0,642.0,642.0,5,1062,2.0,794.0,794.0
0.005,17,2,166,1,75,0.0,47.0,47.0,1,91,0.0,63.0,63.0
0.006,17,2,230,1,68,0.0,40.0,40.0,1,162,0.0,134.0,134.0
0.065,6,10,1506,5,395,15.0,127.0,127.0,5,1111,14.0,843.0,843.0
0.004,17,2,136,1,60,0.0,32.0,32.0,1,76,0.0,48.0,48.0
0.004,17,2,136,1,60,0.0,32.0,32.0,1,76,0.0,48.0,48.0
0.074,6,10,1506,5,395,17.0,127.0,127.0,5,1111,15.0,843.0,843.0
40.055,17,10,676,5,460,10012.0,104.0,64.0,5,216,10013.0,20.0,15.0
240.25,6,34,10813,17,2017,15015.0,606.0,187.0,17,8796,15015.0,2218.0,658.0
11.125,17,28,4423,14,1995,843.0,270.0,114.0,14,2428,843.0,587.0,145.0
0.009,6,12,1926,6,1189,1.0,659.0,434.0,6,737,1.0,417.0,417.0
0.11,6,10,1506,5,395,25.0,127.0,127.0,5,1111,22.0,843.0,843.0
0.005,6,10,1774,5,923,1.0,655.0,655.0,5,851,1.0,583.0,583.0
0.018,6,10,1631,5,848,4.0,580.0,580.0,5,783,4.0,515.0,515.0
0.004,6,10,2006,5,927,1.0,659.0,659.0,5,1079,1.0,811.0,811.0
0.006,6,10,1547,5,764,1.0,496.0,496.0,5,783,1.0,515.0,515.0
0.02,6,10,1989,5,910,4.0,642.0,642.0,5,1079,5.0,811.0,811.0
0.095,6,10,1506,5,395,19.0,127.0,127.0,5,1111,21.0,843.0,843.0
0.003,17,2,148,1,60,0.0,32.0,32.0,1,88,0.0,60.0,60.0
0.021,6,10,1989,5,910,5.0,642.0,642.0,5,1079,5.0,811.0,811.0
0.005,6,10,1702,5,863,1.0,595.0,595.0,5,839,1.0,571.0,571.0
0.004,6,10,2007,5,928,1.0,660.0,660.0,5,1079,1.0,811.0,811.0
0.005,6,10,2006,5,927,1.0,659.0,659.0,5,1079,1.0,811.0,811.0
0.161,17,2,152,1,76,0.0,48.0,48.0,1,76,0.0,48.0,48.0
10.754,17,28,4421,14,1993,818.0,268.0,114.0,14,2428,818.0,587.0,145.0
0.006,17,2,170,1,65,0.0,37.0,37.0,1,105,0.0,77.0,77.0
60.628,6,20,10024,11,3909,6062.0,1579.0,835.0,9,6115,7563.0,2225.0,939.0
0.005,6,10,1689,5,839,1.0,571.0,571.0,5,850,1.0,582.0,582.0
0.006,17,2,179,1,71,0.0,43.0,43.0,1,108,0.0,80.0,80.0
0.019,6,10,1972,5,910,4.0,642.0,642.0,5,1062,4.0,794.0,794.0
0.083,6,10,1506,5,395,18.0,127.0,127.0,5,1111,17.0,843.0,843.0
0.011,6,10,1989,5,910,2.0,642.0,642.0,5,1079,2.0,811.0,811.0
0.005,17,2,142,1,63,0.0,35.0,35.0,1,79,0.0,51.0,51.0
0.004,6,13,3690,7,452,0.0,80.0,80.0,6,3238,0.0,1470.0,1459.0
0.005,6,10,2007,5,928,1.0,660.0,660.0,5,1079,1.0,811.0,811.0
0.006,6,14,3799,7,509,0.0,137.0,137.0,7,3290,0.0,1448.0,972.0
40.063,17,10,676,5,460,10013.0,104.0,64.0,5,216,10015.0,20.0,15.0
0.071,17,2,148,1,60,0.0,32.0,32.0,1,88,0.0,60.0,60.0
0.067,6,10,1506,5,395,15.0,127.0,127.0,5,1111,15.0,843.0,843.0
0.005,6,10,1854,5,889,1.0,621.0,621.0,5,965,1.0,697.0,697.0
0.005,6,10,1547,5,764,1.0,496.0,496.0,5,783,1.0,515.0,515.0
0.024,6,19,9922,11,704,2.0,124.0,124.0,8,9218,3.0,2896.0,2198.0
0.003,17,2,148,1,60,0.0,32.0,32.0,1,88,0.0,60.0,60.0
0.011,6,10,1989,5,910,2.0,642.0,642.0,5,1079,2.0,811.0,811.0
0.007,6,10,1689,5,839,1.0,571.0,571.0,5,850,1.0,582.0,582.0
300.347,6,16,2170,9,684,37522.0,146.0,146.0,7,1486,50030.0,419.0,398.0
0.005,17,2,230,1,68,0.0,40.0,40.0,1,162,0.0,134.0,134.0
0.014,17,2,178,1,65,0.0,37.0,37.0,1,113,0.0,85.0,85.0
0.015,17,2,198,1,91,0.0,63.0,63.0,1,107,0.0,79.0,79.0
0.066,17,8,3613,4,1874,22.0,1350.0,440.0,4,1739,11.0,1350.0,406.0
0.009,6,10,1677,5,827,2.0,559.0,559.0,5,850,2.0,582.0,582.0
0.008,6,10,2000,5,927,2.0,659.0,659.0,5,1073,1.0,805.0,805.0
0.004,17,2,166,1,75,0.0,47.0,47.0,1,91,0.0,63.0,63.0
0.02,6,10,1990,5,911,4.0,643.0,643.0,5,1079,5.0,811.0,811.0
0.131,17,4,284,2,120,0.0,32.0,32.0,2,164,128.0,60.0,54.0
0.012,6,10,1983,5,910,3.0,642.0,642.0,5,1073,2.0,805.0,805.0
0.005,17,2,179,1,71,0.0,43.0,43.0,1,108,0.0,80.0,80.0
0.005,17,2,179,1,71,0.0,43.0,43.0,1,108,0.0,80.0,80.0
0.013,6,10,1989,5,910,3.0,642.0,642.0,5,1079,3.0,811.0,811.0
0.08,6,46,14080,26,2607,3.0,517.0,139.0,20,11473,4.0,1402.0,744.0
0.001,17,2,180,1,66,0.0,38.0,38.0,1,114,0.0,86.0,86.0
0.009,6,12,1926,6,1189,1.0,659.0,434.0,6,737,1.0,417.0,417.0
0.005,6,10,1547,5,764,1.0,496.0,496.0,5,783,1.0,515.0,515.0
0.007,6,10,1689,5,839,1.0,571.0,571.0,5,850,1.0,582.0,582.0
0.001,17,2,180,1,66,0.0,38.0,38.0,1,114,0.0,86.0,86.0
0.003,17,2,184,1,61,0.0,33.0,33.0,1,123,0.0,95.0,95.0
0.013,17,2,136,1,60,0.0,32.0,32.0,1,76,0.0,48.0,48.0
40.072,17,10,676,5,460,10017.0,104.0,64.0,5,216,10017.0,20.0,15.0
0.015,6,10,1677,5,827,3.0,559.0,559.0,5,850,3.0,582.0,582.0
0.019,6,10,1972,5,910,4.0,642.0,642.0,5,1062,4.0,794.0,794.0
0.006,6,10,1547,5,764,1.0,496.0,496.0,5,783,1.0,515.0,515.0
240.245,6,22,11431,13,6853,20020.0,2736.0,1030.0,9,4578,30030.0,1656.0,1367.0
0.073,6,10,1506,5,395,15.0,127.0,127.0,5,1111,16.0,843.0,843.0
0.001,17,2,136,1,60,0.0,32.0,32.0,1,76,0.0,48.0,48.0
0.09,6,10,1506,5,395,17.0,127.0,127.0,5,1111,17.0,843.0,843.0
40.073,17,10,676,5,460,10015.0,104.0,64.0,5,216,10017.0,20.0,15.0
309.098,17,20,1124,10,716,34330.0,48.0,43.0,10,408,34334.0,20.0,12.0
0.01,6,10,1972,5,910,2.0,642.0,642.0,5,1062,2.0,794.0,794.0
240.239,6,44,5626,23,2593,10919.0,588.0,196.0,21,3033,12011.0,580.0,241.0
0.007,6,10,1972,5,910,1.0,642.0,642.0,5,1062,1.0,794.0,794.0
0.006,6,12,1698,6,863,1.0,327.0,271.0,6,835,1.0,515.0,515.0
0.005,6,10,2006,5,927,1.0,659.0,659.0,5,1079,1.0,811.0,811.0
0.075,6,10,1506,5,395,16.0,127.0,127.0,5,1111,14.0,843.0,843.0
0.005,17,2,179,1,71,0.0,43.0,43.0,1,108,0.0,80.0,80.0
240.021,6,9,787,5,488,60005.0,232.0,232.0,4,299,80006.0,83.0,83.0
0.01,6,10,1677,5,827,2.0,559.0,559.0,5,850,2.0,582.0,582.0
0.128,17,2,138,1,61,0.0,33.0,33.0,1,77,0.0,49.0,49.0
0.116,6,10,1506,5,395,26.0,127.0,127.0,5,1111,24.0,843.0,843.0
0.014,6,14,3787,7,497,2.0,125.0,125.0,7,3290,2.0,1448.0,972.0
0.093,6,10,1506,5,395,21.0,127.0,127.0,5,1111,18.0,843.0,843.0
0.125,6,10,1506,5,395,29.0,127.0,127.0,5,1111,29.0,843.0,843.0
0.004,6,10,1702,5,863,1.0,595.0,595.0,5,839,0.0,571.0,571.0
0.005,17,2,170,1,65,0.0,37.0,37.0,1,105,0.0,77.0,77.0
0.006,6,10,1547,5,764,1.0,496.0,496.0,5,783,1.0,515.0,515.0
10.747,17,28,4422,14,1993,818.0,268.0,114.0,14,2429,818.0,588.0,145.0
309.762,17,20,1124,10,716,34411.0,48.0,43.0,10,408,34411.0,20.0,12.0
0.004,6,10,2006,5,927,1.0,659.0,659.0,5,1079,1.0,811.0,811.0
0.011,6,10,1983,5,910,2.0,642.0,642.0,5,1073,2.0,805.0,805.0
0.009,6,10,1989,5,910,2.0,642.0,642.0,5,1079,2.0,811.0,811.0
0.005,6,10,1779,5,928,1.0,660.0,660.0,5,851,1.0,583.0,583.0
0.091,6,10,1506,5,395,21.0,127.0,127.0,5,1111,21.0,843.0,843.0
0.04,17,2,136,1,60,0.0,32.0,32.0,1,76,0.0,48.0,48.0
0.072,6,10,1506,5,395,16.0,127.0,127.0,5,1111,16.0,843.0,843.0
0.129,6,10,1506,5,395,29.0,127.0,127.0,5,1111,28.0,843.0,843.0
0.004,6,10,2007,5,928,1.0,660.0,660.0,5,1079,1.0,811.0,811.0
10.793,17,28,4423,14,1995,821.0,270.0,114.0,14,2428,821.0,587.0,145.0
0.115,6,10,1506,5,395,27.0,127.0,127.0,5,1111,15.0,843.0,843.0
0.005,17,2,179,1,71,0.0,43.0,43.0,1,108,0.0,80.0,80.0
0.005,6,10,1989,5,927,1.0,659.0,659.0,5,1062,1.0,794.0,794.0
0.007,17,2,194,1,59,0.0,31.0,31.0,1,135,0.0,107.0,107.0
15.099,17,15,9239,8,6902,2151.0,1350.0,834.0,7,2337,2509.0,1350.0,305.0
0.016,6,10,1989,5,910,4.0,642.0,642.0,5,1079,4.0,811.0,811.0
0.004,17,2,180,1,66,0.0,38.0,38.0,1,114,0.0,86.0,86.0
0.005,6,10,2007,5,928,1.0,660.0,660.0,5,1079,1.0,811.0,811.0
0.006,17,2,170,1,65,0.0,37.0,37.0,1,105,0.0,77.0,77.0
309.486,17,20,1124,10,716,34372.0,48.0,43.0,10,408,34372.0,20.0,12.0
0.001,17,2,180,1,66,0.0,38.0,38.0,1,114,0.0,86.0,86.0
0.013,6,10,1631,5,848,3.0,580.0,580.0,5,783,3.0,515.0,515.0
0.005,6,10,2006,5,927,1.0,659.0,659.0,5,1079,1.0,811.0,811.0
0.04,17,2,152,1,76,0.0,48.0,48.0,1,76,0.0,48.0,48.0
0.004,6,10,1774,5,923,1.0,655.0,655.0,5,851,1.0,583.0,583.0
1787.216,6,150,19350,90,13740,20081.0,302.0,302.0,60,5610,30291.0,83.0,83.0
0.001,17,2,180,1,65,0.0,37.0,37.0,1,115,0.0,87.0,87.0
15.086,17,17,10673,9,8280,1882.0,1350.0,892.0,8,2393,2148.0,1350.0,271.0
0.005,17,2,412,1,61,0.0,33.0,33.0,1,351,0.0,323.0,323.0
0.203,6,16,2778,8,1396,29.0,533.0,324.0,8,1382,18.0,529.0,239.0
0.074,6,10,1506,5,395,15.0,127.0,127.0,5,1111,16.0,843.0,843.0
176.235,17,72,10221,36,2402,5035.0,44.0,38.0,36,7819,5035.0,239.0,189.0
10.923,17,28,4395,14,1995,831.0,270.0,114.0,14,2400,831.0,587.0,143.0
60.704,6,25,17404,14,9515,4669.0,2804.0,1465.0,11,7889,6057.0,2312.0,1218.0
0.113,6,10,1506,5,395,26.0,127.0,127.0,5,1111,24.0,843.0,843.0
0.005,6,13,3747,7,509,0.0,137.0,137.0,6,3238,0.0,1470.0,1459.0
0.015,6,10,1972,5,910,3.0,642.0,642.0,5,1062,3.0,794.0,794.0
0.014,17,2,146,1,65,0.0,37.0,37.0,1,81,0.0,53.0,53.0
0.006,6,10,2006,5,927,1.0,659.0,659.0,5,1079,1.0,811.0,811.0
0.005,6,10,2006,5,927,1.0,659.0,659.0,5,1079,1.0,811.0,811.0
0.005,6,10,1702,5,863,1.0,595.0,595.0,5,839,1.0,571.0,571.0
0.004,6,10,1702,5,863,1.0,595.0,595.0,5,839,0.0,571.0,571.0
10.894,17,28,4422,14,1993,829.0,268.0,114.0,14,2429,829.0,588.0,145.0
0.09,6,10,1506,5,395,20.0,127.0,127.0,5,1111,19.0,843.0,843.0
0.007,6,10,1989,5,910,1.0,642.0,642.0,5,1079,1.0,811.0,811.0
0.005,6,10,2006,5,927,1.0,659.0,659.0,5,1079,1.0,811.0,811.0
40.063,17,10,676,5,460,10014.0,104.0,64.0,5,216,10014.0,20.0,15.0
0.012,6,10,1762,5,911,2.0,643.0,643.0,5,851,3.0,583.0,583.0
0.005,17,2,164,1,74,0.0,46.0,46.0,1,90,0.0,62.0,62.0
0.068,6,10,1506,5,395,14.0,127.0,127.0,5,1111,15.0,843.0,843.0
40.076,17,10,676,5,460,10018.0,104.0,64.0,5,216,10018.0,20.0,15.0
0.004,17,2,136,1,60,0.0,32.0,32.0,1,76,0.0,48.0,48.0
0.018,17,2,152,1,68,0.0,40.0,40.0,1,84,0.0,56.0,56.0
0.002,17,2,180,1,66,0.0,38.0,38.0,1,114,0.0,86.0,86.0
0.014,6,10,1989,5,910,3.0,642.0,642.0,5,1079,3.0,811.0,811.0
0.006,17,2,222,1,65,0.0,37.0,37.0,1,157,0.0,129.0,129.0
310.226,17,20,1124,10,716,34455.0,48.0,43.0,10,408,34455.0,20.0,12.0
0.002,17,2,185,1,73,0.0,45.0,45.0,1,112,0.0,84.0,84.0
0.013,17,2,152,1,56,0.0,28.0,28.0,1,96,0.0,68.0,68.0
0.201,6,10,1506,5,395,44.0,127.0,127.0,5,1111,35.0,843.0,843.0
0.009,17,2,146,1,65,0.0,37.0,37.0,1,81,0.0,53.0,53.0
0.006,6,10,1547,5,764,1.0,496.0,496.0,5,783,1.0,515.0,515.0
0.005,6,10,2000,5,927,1.0,659.0,659.0,5,1073,1.0,805.0,805.0
0.012,6,10,1989,5,910,2.0,642.0,642.0,5,1079,2.0,811.0,811.0
0.005,6,10,1989,5,927,1.0,659.0,659.0,5,1062,1.0,794.0,794.0
0.005,6,10,2000,5,927,1.0,659.0,659.0,5,1073,1.0,805.0,805.0
0.004,6,10,1702,5,863,0.0,595.0,595.0,5,839,1.0,571.0,571.0
126.048,6,14,2938,8,2504,17970.0,1414.0,1086.0,6,434,25158.0,182.0,182.0
0.087,6,10,1506,5,395,17.0,127.0,127.0,5,1111,18.0,843.0,843.0
0.005,6,10,2000,5,927,1.0,659.0,659.0,5,1073,1.0,805.0,805.0
0.004,6,10,2007,5,928,1.0,660.0,660.0,5,1079,1.0,811.0,811.0
0.005,6,10,2006,5,927,1.0,659.0,659.0,5,1079,1.0,811.0,811.0
0.037,17,2,182,1,65,0.0,37.0,37.0,1,117,0.0,89.0,89.0
598.776,6,38,14662,20,4112,31512.0,676.0,437.0,18,10550,35219.0,1402.0,961.0
0.071,17,8,3613,4,1874,23.0,1350.0,440.0,4,1739,12.0,1350.0,406.0
0.009,6,10,1983,5,910,2.0,642.0,642.0,5,1073,2.0,805.0,805.0
0.007,6,10,1689,5,839,1.0,571.0,571.0,5,850,1.0,582.0,582.0
0.078,6,10,1506,5,395,17.0,127.0,127.0,5,1111,16.0,843.0,843.0
0.005,6,10,2006,5,927,1.0,659.0,659.0,5,1079,1.0,811.0,811.0
0.004,17,2,148,1,60,0.0,32.0,32.0,1,88,0.0,60.0,60.0
40.056,17,10,676,5,460,10011.0,104.0,64.0,5,216,10013.0,20.0,15.0
0.005,6,10,1989,5,927,1.0,659.0,659.0,5,1062,1.0,794.0,794.0
0.016,6,10,1990,5,911,3.0,643.0,643.0,5,1079,3.0,811.0,811.0
0.005,17,2,166,1,75,0.0,47.0,47.0,1,91,0.0,63.0,63.0
0.001,17,2,180,1,65,0.0,37.0,37.0,1,115,0.0,87.0,87.0
309.268,17,20,1124,10,716,34349.0,48.0,43.0,10,408,34349.0,20.0,12.0
0.011,6,10,1631,5,848,2.0,580.0,580.0,5,783,2.0,515.0,515.0
0.003,17,4,284,2,120,0.0,32.0,32.0,2,164,0.0,60.0,54.0
0.004,6,10,2007,5,928,1.0,660.0,660.0,5,1079,1.0,811.0,811.0
0.008,6,10,1990,5,911,2.0,643.0,643.0,5,1079,2.0,811.0,811.0
0.09,6,10,1506,5,395,21.0,127.0,127.0,5,1111,18.0,843.0,843.0
0.143,6,10,1506,5,395,34.0,127.0,127.0,5,1111,30.0,843.0,843.0
0.005,6,10,1989,5,927,1.0,659.0,659.0,5,1062,1.0,794.0,794.0
0.001,17,2,166,1,75,0.0,47.0,47.0,1,91,0.0,63.0,63.0
0.005,6,10,2006,5,927,1.0,659.0,659.0,5,1079,1.0,811.0,811.0
0.024,6,10,1990,5,911,5.0,643.0,643.0,5,1079,5.0,811.0,811.0
40.064,17,10,676,5,460,10014.0,104.0,64.0,5,216,10015.0,20.0,15.0
0.005,6,10,2000,5,927,1.0,659.0,659.0,5,1073,1.0,805.0,805.0
1752.235,6,65,7413,43,4537,41719.0,1402.0,104.0,22,2876,83431.0,1112.0,82.0
0.008,6,10,1854,5,889,2.0,621.0,621.0,5,965,1.0,697.0,697.0
0.005,17,2,187,1,71,0.0,43.0,43.0,1,116,0.0,88.0,88.0
40.067,17,10,676,5,460,10016.0,104.0,64.0,5,216,10015.0,20.0,15.0
0.116,6,10,1506,5,395,22.0,127.0,127.0,5,1111,23.0,843.0,843.0
1730.463,6,51,3124,32,1875,55821.0,35.0,35.0,19,1249,96132.0,31.0,31.0
0.006,6,10,1547,5,764,1.0,496.0,496.0,5,783,1.0,515.0,515.0
0.009,6,10,1972,5,910,2.0,642.0,642.0,5,1062,2.0,794.0,794.0
40.064,17,10,676,5,460,10014.0,104.0,64.0,5,216,10015.0,20.0,15.0
0.088,6,10,1506,5,395,20.0,127.0,127.0,5,1111,19.0,843.0,843.0
0.15,6,10,1506,5,395,36.0,127.0,127.0,5,1111,34.0,843.0,843.0
0.114,6,10,1506,5,395,26.0,127.0,127.0,5,1111,25.0,843.0,843.0
240.278,6,44,5470,22,2576,11441.0,581.0,175.0,22,2894,11441.0,566.0,216.0
1792.562,6,490,99412,246,88062,7316.0,421.0,365.0,244,11350,7376.0,53.0,53.0
0.069,17,8,3613,4,1874,23.0,1350.0,440.0,4,1739,12.0,1350.0,406.0
0.068,17,8,3613,4,1874,22.0,1350.0,440.0,4,1739,11.0,1350.0,406.0
0.005,6,10,1989,5,927,1.0,659.0,659.0,5,1062,1.0,794.0,794.0
0.005,17,2,158,1,63,0.0,35.0,35.0,1,95,0.0,67.0,67.0
0.136,6,10,1506,5,395,30.0,127.0,127.0,5,1111,30.0,843.0,843.0
0.017,6,10,1972,5,910,4.0,642.0,642.0,5,1062,4.0,794.0,794.0
0.01,6,10,1990,5,911,2.0,643.0,643.0,5,1079,2.0,811.0,811.0
0.001,17,2,180,1,66,0.0,38.0,38.0,1,114,0.0,86.0,86.0
0.137,17,2,234,1,61,0.0,33.0,33.0,1,173,0.0,145.0,145.0
0.009,6,12,1926,6,1189,1.0,659.0,434.0,6,737,1.0,417.0,417.0
0.011,6,10,1972,5,910,2.0,642.0,642.0,5,1062,2.0,794.0,794.0
0.005,6,10,2007,5,928,1.0,660.0,660.0,5,1079,1.0,811.0,811.0
0.005,6,10,1689,5,839,1.0,571.0,571.0,5,850,1.0,582.0,582.0
1721.209,6,62,7176,41,4384,43030.0,1402.0,107.0,21,2792,86052.0,1111.0,85.0
0.028,6,10,1989,5,910,7.0,642.0,642.0,5,1079,7.0,811.0,811.0
0.005,6,10,1989,5,927,1.0,659.0,659.0,5,1062,1.0,794.0,794.0
0.039,17,2,152,1,76,0.0,48.0,48.0,1,76,0.0,48.0,48.0
0.066,17,8,3613,4,1874,22.0,1350.0,440.0,4,1739,10.0,1350.0,406.0
40.082,17,10,676,5,460,10019.0,104.0,64.0,5,216,10019.0,20.0,15.0
0.006,6,10,1854,5,889,1.0,621.0,621.0,5,965,1.0,697.0,697.0
40.052,17,10,676,5,460,10012.0,104.0,64.0,5,216,10012.0,20.0,15.0
0.019,6,10,1677,5,827,4.0,559.0,559.0,5,850,4.0,582.0,582.0
0.007,17,2,180,1,66,0.0,38.0,38.0,1,114,0.0,86.0,86.0
15.263,17,41,22828,22,18409,725.0,1350.0,808.0,19,4419,846.0,1350.0,204.0
0.042,17,4,284,2,120,2.0,32.0,32.0,2,164,39.0,60.0,54.0
0.015,6,10,1983,5,910,3.0,642.0,642.0,5,1073,3.0,805.0,805.0
0.072,17,4,284,2,120,1.0,32.0,32.0,2,164,68.0,60.0,54.0
0.004,6,10,1989,5,927,1.0,659.0,659.0,5,1062,1.0,794.0,794.0
0.003,17,4,284,2,120,0.0,32.0,32.0,2,164,0.0,60.0,54.0
0.014,6,10,1989,5,910,3.0,642.0,642.0,5,1079,3.0,811.0,811.0
0.019,6,10,1972,5,910,4.0,642.0,642.0,5,1062,4.0,794.0,794.0
0.005,6,10,2006,5,927,1.0,659.0,659.0,5,1079,1.0,811.0,811.0
240.096,6,16,4480,9,963,30012.0,238.0,166.0,7,3517,40015.0,1402.0,786.0
0.031,6,20,9974,11,704,3.0,124.0,124.0,9,9270,3.0,2896.0,1758.0
0.005,6,10,2006,5,927,1.0,659.0,659.0,5,1079,1.0,811.0,811.0
0.015,6,10,1983,5,910,3.0,642.0,642.0,5,1073,3.0,805.0,805.0
0.014,6,10,1983,5,910,3.0,642.0,642.0,5,1073,3.0,805.0,805.0
0.079,6,10,1506,5,395,19.0,127.0,127.0,5,1111,17.0,843.0,843.0
0.008,6,10,1972,5,910,1.0,642.0,642.0,5,1062,2.0,794.0,794.0
240.158,6,37,4943,18,2320,14126.0,588.0,196.0,19,2623,13341.0,580.0,232.0
0.098,6,10,1506,5,395,21.0,127.0,127.0,5,1111,23.0,843.0,843.0
0.096,6,10,1506,5,395,22.0,127.0,127.0,5,1111,22.0,843.0,843.0
0.098,6,10,1506,5,395,21.0,127.0,127.0,5,1111,21.0,843.0,843.0
0.005,6,10,1702,5,863,1.0,595.0,595.0,5,839,1.0,571.0,571.0
0.008,6,10,2006,5,927,2.0,659.0,659.0,5,1079,2.0,811.0,811.0
0.085,6,10,1506,5,395,19.0,127.0,127.0,5,1111,20.0,843.0,843.0
0.064,6,10,1506,5,395,15.0,127.0,127.0,5,1111,14.0,843.0,843.0
267.746,6,21,5572,10,2192,29749.0,585.0,330.0,11,3380,26774.0,1402.0,703.0
11.128,17,28,4422,14,1994,847.0,269.0,114.0,14,2428,847.0,587.0,145.0
0.011,6,10,1762,5,911,2.0,643.0,643.0,5,851,2.0,583.0,583.0
0.006,6,10,2007,5,928,1.0,660.0,660.0,5,1079,1.0,811.0,811.0
0.005,6,13,3747,7,509,0.0,137.0,137.0,6,3238,1.0,1470.0,1459.0
0.012,6,10,1983,5,910,3.0,642.0,642.0,5,1073,3.0,805.0,805.0
0.006,6,10,1547,5,764,1.0,496.0,496.0,5,783,1.0,515.0,515.0
0.018,6,10,1990,5,911,4.0,643.0,643.0,5,1079,4.0,811.0,811.0
0.089,6,10,1506,5,395,19.0,127.0,127.0,5,1111,16.0,843.0,843.0
0.0,17,2,166,1,75,0.0,47.0,47.0,1,91,0.0,63.0,63.0
0.078,6,10,1506,5,395,17.0,127.0,127.0,5,1111,14.0,843.0,843.0
0.005,6,10,2006,5,927,1.0,659.0,659.0,5,1079,1.0,811.0,811.0
0.059,6,10,1506,5,395,13.0,127.0,127.0,5,1111,11.0,843.0,843.0
0.014,6,10,1631,5,848,3.0,580.0,580.0,5,783,3.0,515.0,515.0
0.013,6,10,1989,5,910,3.0,642.0,642.0,5,1079,3.0,811.0,811.0
177.135,17,84,12178,42,2801,4320.0,44.0,38.0,42,9377,4320.0,261.0,195.0
15.07,17,15,9238,8,6902,2148.0,1350.0,834.0,7,2336,2506.0,1350.0,305.0
40.075,17,10,676,5,460,10013.0,104.0,64.0,5,216,10017.0,20.0,15.0
0.004,6,15,3794,8,504,0.0,80.0,80.0,7,3290,0.0,1448.0,972.0
0.022,6,10,1983,5,910,5.0,642.0,642.0,5,1073,5.0,805.0,805.0
318.098,17,20,1124,10,716,35329.0,48.0,43.0,10,408,35329.0,20.0,12.0
0.005,6,10,1989,5,927,1.0,659.0,659.0,5,1062,1.0,794.0,794.0
300.275,6,164,164811,65,4500,4691.0,525.0,281.0,99,160311,3064.0,2804.0,1668.0
0.03,6,10,1631,5,848,7.0,580.0,580.0,5,783,7.0,515.0,515.0
0.009,6,10,1983,5,910,2.0,642.0,642.0,5,1073,2.0,805.0,805.0
0.005,6,10,2006,5,927,1.0,659.0,659.0,5,1079,1.0,811.0,811.0
0.01,6,10,1989,5,910,2.0,642.0,642.0,5,1079,2.0,811.0,811.0
11.163,17,28,4423,14,1994,846.0,269.0,114.0,14,2429,846.0,588.0,145.0
0.005,17,2,230,1,68,0.0,40.0,40.0,1,162,0.0,134.0,134.0
0.013,6,10,1972,5,910,3.0,642.0,642.0,5,1062,3.0,794.0,794.0
0.005,6,13,3747,7,509,0.0,137.0,137.0,6,3238,0.0,1470.0,1459.0
11.169,17,28,4421,14,1994,846.0,269.0,114.0,14,2427,846.0,586.0,145.0
10.877,17,28,4420,14,1993,827.0,268.0,114.0,14,2427,827.0,586.0,145.0
0.004,6,10,2000,5,927,1.0,659.0,659.0,5,1073,1.0,805.0,805.0
0.009,6,10,1989,5,910,2.0,642.0,642.0,5,1079,2.0,811.0,811.0
0.006,17,2,164,1,74,0.0,46.0,46.0,1,90,0.0,62.0,62.0
0.0,17,2,179,1,62,0.0,34.0,34.0,1,117,0.0,89.0,89.0
312.3,17,20,1124,10,716,34685.0,48.0,43.0,10,408,34685.0,20.0,12.0
0.084,6,10,1506,5,395,16.0,127.0,127.0,5,1111,17.0,843.0,843.0
0.006,17,4,284,2,120,2.0,32.0,32.0,2,164,3.0,60.0,54.0
0.003,6,10,1702,5,863,0.0,595.0,595.0,5,839,0.0,571.0,571.0
0.005,6,10,2000,5,927,1.0,659.0,659.0,5,1073,1.0,805.0,805.0
0.015,6,10,1631,5,848,3.0,580.0,580.0,5,783,3.0,515.0,515.0
177.493,17,92,13162,46,3099,3944.0,44.0,39.0,46,10063,3944.0,239.0,190.0
0.006,6,10,2006,5,927,1.0,659.0,659.0,5,1079,1.0,811.0,811.0
0.004,6,10,1989,5,927,1.0,659.0,659.0,5,1062,1.0,794.0,794.0
0.004,17,2,170,1,65,0.0,37.0,37.0,1,105,0.0,77.0,77.0
0.213,6,16,2777,8,1395,30.0,533.0,323.0,8,1382,19.0,529.0,239.0
0.004,6,10,2007,5,928,1.0,660.0,660.0,5,1079,1.0,811.0,811.0
0.072,6,10,1506,5,395,16.0,127.0,127.0,5,1111,13.0,843.0,843.0
0.014,6,10,1989,5,910,3.0,642.0,642.0,5,1079,3.0,811.0,811.0
367.316,6,22,2313,16,867,24487.0,195.0,195.0,6,1446,4664.0,419.0,398.0
0.011,6,10,1989,5,910,2.0,642.0,642.0,5,1079,2.0,811.0,811.0
0.004,6,10,2000,5,927,1.0,659.0,659.0,5,1073,1.0,805.0,805.0
15.074,17,15,9238,8,6902,2149.0,1350.0,834.0,7,2336,2507.0,1350.0,305.0
0.005,17,2,230,1,68,0.0,40.0,40.0,1,162,0.0,134.0,134.0
0.004,6,10,2006,5,927,1.0,659.0,659.0,5,1079,1.0,811.0,811.0
0.006,6,10,1547,5,764,1.0,496.0,496.0,5,783,1.0,515.0,515.0
0.135,6,10,1506,5,395,30.0,127.0,127.0,5,1111,30.0,843.0,843.0
0.006,6,20,10099,11,829,0.0,249.0,249.0,9,9270,0.0,2896.0,1758.0
0.081,6,10,1506,5,395,18.0,127.0,127.0,5,1111,15.0,843.0,843.0
0.012,6,10,1972,5,910,2.0,642.0,642.0,5,1062,2.0,794.0,794.0
0.005,6,10,2007,5,928,1.0,660.0,660.0,5,1079,1.0,811.0,811.0
363.616,6,41,14509,22,3555,17315.0,676.0,400.0,19,10954,16866.0,1402.0,829.0
0.005,6,10,2000,5,927,1.0,659.0,659.0,5,1073,1.0,805.0,805.0
0.118,6,10,1506,5,395,27.0,127.0,127.0,5,1111,24.0,843.0,843.0
0.001,17,2,179,1,62,0.0,34.0,34.0,1,117,0.0,89.0,89.0
0.096,6,10,1506,5,395,20.0,127.0,127.0,5,1111,21.0,843.0,843.0
0.005,6,10,1779,5,928,1.0,660.0,660.0,5,851,1.0,583.0,583.0
0.008,6,10,1989,5,910,2.0,642.0,642.0,5,1079,2.0,811.0,811.0
0.012,17,2,152,1,56,0.0,28.0,28.0,1,96,0.0,68.0,68.0
0.006,6,10,1643,5,860,1.0,592.0,592.0,5,783,1.0,515.0,515.0
0.005,6,10,1989,5,927,1.0,659.0,659.0,5,1062,1.0,794.0,794.0
0.006,17,2,136,1,60,0.0,32.0,32.0,1,76,0.0,48.0,48.0
40.058,17,10,676,5,460,10013.0,104.0,64.0,5,216,10013.0,20.0,15.0
0.01,6,10,1989,5,910,2.0,642.0,642.0,5,1079,2.0,811.0,811.0
0.25,17,4,596,2,122,105.0,33.0,33.0,2,474,184.0,323.0,209.0
0.003,17,2,136,1,60,0.0,32.0,32.0,1,76,0.0,48.0,48.0
0.005,6,10,1989,5,927,1.0,659.0,659.0,5,1062,1.0,794.0,794.0
0.005,6,13,3747,7,509,0.0,137.0,137.0,6,3238,1.0,1470.0,1459.0
0.123,6,10,1506,5,395,29.0,127.0,127.0,5,1111,28.0,843.0,843.0
0.011,6,10,1972,5,910,2.0,642.0,642.0,5,1062,2.0,794.0,794.0
0.014,6,10,1983,5,910,3.0,642.0,642.0,5,1073,3.0,805.0,805.0
1797.168,6,296,51742,120,34315,15102.0,2790.0,303.0,176,17427,10268.0,1360.0,129.0
11.146,17,28,4419,14,1994,844.0,269.0,114.0,14,2425,844.0,588.0,145.0
0.094,6,10,1506,5,395,22.0,127.0,127.0,5,1111,22.0,843.0,843.0
336.038,17,20,1124,10,716,37323.0,48.0,43.0,10,408,37323.0,20.0,12.0
0.036,6,10,1605,5,388,9.0,120.0,120.0,5,1217,8.0,949.0,949.0
0.003,17,2,160,1,72,0.0,44.0,44.0,1,88,0.0,60.0,60.0
0.005,6,10,1643,5,860,1.0,592.0,592.0,5,783,1.0,515.0,515.0
0.006,6,10,1547,5,764,1.0,496.0,496.0,5,783,1.0,515.0,515.0
0.005,17,2,170,1,65,0.0,37.0,37.0,1,105,0.0,77.0,77.0
0.182,6,3,453,2,321,182.0,241.0,241.0,1,132,0.0,92.0,92.0
0.001,17,2,180,1,66,0.0,38.0,38.0,1,114,0.0,86.0,86.0
0.006,6,10,1547,5,764,1.0,496.0,496.0,5,783,1.0,515.0,515.0
0.006,17,2,179,1,71,0.0,43.0,43.0,1,108,0.0,80.0,80.0
0.001,17,2,179,1,62,0.0,34.0,34.0,1,117,0.0,89.0,89.0
15.078,17,15,8250,8,6035,2149.0,1350.0,726.0,7,2215,2508.0,1350.0,288.0
0.01,6,12,1926,6,1189,1.0,659.0,434.0,6,737,1.0,417.0,417.0
0.077,6,10,1506,5,395,17.0,127.0,127.0,5,1111,16.0,843.0,843.0
0.001,17,2,180,1,66,0.0,38.0,38.0,1,114,0.0,86.0,86.0
15.082,17,15,9238,8,6902,2149.0,1350.0,834.0,7,2336,2508.0,1350.0,305.0
0.069,6,10,1506,5,395,15.0,127.0,127.0,5,1111,14.0,843.0,843.0
0.005,6,14,3742,7,452,0.0,80.0,80.0,7,3290,0.0,1448.0,972.0
309.06,17,20,1124,10,716,34325.0,48.0,43.0,10,408,34325.0,20.0,12.0
0.004,17,2,148,1,60,0.0,32.0,32.0,1,88,0.0,60.0,60.0
0.017,6,10,1762,5,911,4.0,643.0,643.0,5,851,4.0,583.0,583.0
0.006,6,10,1854,5,889,1.0,621.0,621.0,5,965,1.0,697.0,697.0
0.104,6,10,1506,5,395,21.0,127.0,127.0,5,1111,23.0,843.0,843.0
40.062,17,10,676,5,460,10014.0,104.0,64.0,5,216,10014.0,20.0,15.0
0.004,17,4,284,2,120,0.0,32.0,32.0,2,164,1.0,60.0,54.0
0.127,17,4,364,2,160,0.0,52.0,52.0,2,204,1.0,80.0,74.0
0.001,17,2,136,1,60,0.0,32.0,32.0,1,76,0.0,48.0,48.0
0.015,6,10,1989,5,910,3.0,642.0,642.0,5,1079,3.0,811.0,811.0
0.08,6,10,1506,5,395,17.0,127.0,127.0,5,1111,17.0,843.0,843.0
0.175,6,19,6438,10,1561,19.0,744.0,258.0,9,4877,21.0,1591.0,1100.0
27.926,6,46,19284,23,13566,411.0,2720.0,1401.0,23,5718,1260.0,2667.0,435.0
0.005,6,10,1702,5,863,1.0,595.0,595.0,5,839,1.0,571.0,571.0
0.004,17,2,148,1,60,0.0,32.0,32.0,1,88,0.0,60.0,60.0
0.036,6,10,1631,5,848,9.0,580.0,580.0,5,783,9.0,515.0,515.0
0.005,17,2,144,1,64,0.0,36.0,36.0,1,80,0.0,52.0,52.0
0.001,17,2,136,1,60,0.0,32.0,32.0,1,76,0.0,48.0,48.0
0.037,17,2,148,1,60,0.0,32.0,32.0,1,88,0.0,60.0,60.0
0.012,6,10,1972,5,910,3.0,642.0,642.0,5,1062,3.0,794.0,794.0
0.011,6,10,1989,5,910,2.0,642.0,642.0,5,1079,2.0,811.0,811.0
318.501,17,20,1124,10,716,35374.0,48.0,43.0,10,408,35374.0,20.0,12.0
0.006,6,10,1547,5,764,1.0,496.0,496.0,5,783,1.0,515.0,515.0
0.005,6,10,2006,5,927,1.0,659.0,659.0,5,1079,1.0,811.0,811.0
0.001,17,2,136,1,60,0.0,32.0,32.0,1,76,0.0,48.0,48.0
0.011,6,10,1989,5,910,2.0,642.0,642.0,5,1079,2.0,811.0,811.0
0.014,6,10,1990,5,911,3.0,643.0,643.0,5,1079,3.0,811.0,811.0
0.079,6,10,1506,5,395,17.0,127.0,127.0,5,1111,18.0,843.0,843.0
0.005,6,10,2006,5,927,1.0,659.0,659.0,5,1079,1.0,811.0,811.0
0.015,6,10,1677,5,827,3.0,559.0,559.0,5,850,3.0,582.0,582.0
0.17,17,2,152,1,76,0.0,48.0,48.0,1,76,0.0,48.0,48.0
0.005,6,10,2006,5,927,1.0,659.0,659.0,5,1079,1.0,811.0,811.0
0.013,6,10,1989,5,910,3.0,642.0,642.0,5,1079,3.0,811.0,811.0
0.039,17,2,170,1,65,0.0,37.0,37.0,1,105,0.0,77.0,77.0
0.005,6,10,2000,5,927,1.0,659.0,659.0,5,1073,1.0,805.0,805.0
0.009,6,10,1677,5,827,2.0,559.0,559.0,5,850,2.0,582.0,582.0
0.052,17,2,152,1,76,0.0,48.0,48.0,1,76,0.0,48.0,48.0
0.104,17,4,420,2,122,1.0,33.0,33.0,2,298,34.0,145.0,121.0
0.001,17,2,136,1,60,0.0,32.0,32.0,1,76,0.0,48.0,48.0
0.015,6,10,1972,5,910,3.0,642.0,642.0,5,1062,3.0,794.0,794.0
0.066,6,10,1506,5,395,16.0,127.0,127.0,5,1111,13.0,843.0,843.0
0.005,6,10,2007,5,928,1.0,660.0,660.0,5,1079,1.0,811.0,811.0
0.005,6,10,2006,5,927,1.0,659.0,659.0,5,1079,1.0,811.0,811.0
40.074,17,10,676,5,460,10016.0,104.0,64.0,5,216,10017.0,20.0,15.0
0.011,6,10,1989,5,927,2.0,659.0,659.0,5,1062,2.0,794.0,794.0
0.006,6,10,1643,5,860,1.0,592.0,592.0,5,783,1.0,515.0,515.0
0.007,6,10,1547,5,764,1.0,496.0,496.0,5,783,1.0,515.0,515.0
0.005,6,10,2000,5,927,1.0,659.0,659.0,5,1073,1.0,805.0,805.0
0.004,6,10,2006,5,927,1.0,659.0,659.0,5,1079,1.0,811.0,811.0
0.009,6,10,1972,5,910,2.0,642.0,642.0,5,1062,2.0,794.0,794.0
0.005,6,14,3736,7,446,0.0,74.0,74.0,7,3290,0.0,1448.0,972.0
0.005,6,10,1989,5,927,1.0,659.0,659.0,5,1062,1.0,794.0,794.0
0.004,6,10,1989,5,927,1.0,659.0,659.0,5,1062,1.0,794.0,794.0
0.105,6,10,1506,5,395,22.0,127.0,127.0,5,1111,22.0,843.0,843.0
0.005,6,10,1643,5,860,1.0,592.0,592.0,5,783,1.0,515.0,515.0
0.012,6,10,1972,5,910,3.0,642.0,642.0,5,1062,2.0,794.0,794.0
40.08,17,10,676,5,460,10013.0,104.0,64.0,5,216,10013.0,20.0,15.0
0.006,6,10,1547,5,764,1.0,496.0,496.0,5,783,1.0,515.0,515.0
0.004,6,10,2000,5,927,1.0,659.0,659.0,5,1073,1.0,805.0,805.0
0.01,6,10,1983,5,910,2.0,642.0,642.0,5,1073,2.0,805.0,805.0
0.278,17,44,27781,26,24770,11.0,1350.0,924.0,18,3011,13.0,1350.0,139.0
0.004,6,10,2006,5,927,1.0,659.0,659.0,5,1079,1.0,811.0,811.0
40.054,17,10,676,5,460,10012.0,104.0,64.0,5,216,10012.0,20.0,15.0
0.176,6,10,1506,5,395,38.0,127.0,127.0,5,1111,39.0,843.0,843.0
0.125,17,4,352,2,130,86.0,37.0,37.0,2,222,122.0,89.0,83.0
0.016,6,10,1983,5,910,4.0,642.0,642.0,5,1073,3.0,805.0,805.0
0.004,17,2,136,1,60,0.0,32.0,32.0,1,76,0.0,48.0,48.0
0.005,6,10,1643,5,860,1.0,592.0,592.0,5,783,1.0,515.0,515.0
0.016,6,10,1983,5,910,4.0,642.0,642.0,5,1073,3.0,805.0,805.0
1789.042,6,240,35580,150,25920,12006.0,302.0,302.0,90,9660,20101.0,83.0,83.0
0.037,17,2,170,1,65,0.0,37.0,37.0,1,105,0.0,77.0,77.0
0.006,17,2,214,1,75,0.0,47.0,47.0,1,139,0.0,111.0,111.0
0.004,17,2,148,1,60,0.0,32.0,32.0,1,88,0.0,60.0,60.0
280.507,6,23,6075,11,1226,28050.0,267.0,156.0,12,4849,25488.0,1400.0,873.0
175.5,17,72,10312,36,2397,5014.0,44.0,38.0,36,7915,5014.0,260.0,191.0
40.077,17,10,676,5,460,10016.0,104.0,64.0,5,216,10018.0,20.0,15.0
0.018,6,10,1989,5,910,4.0,642.0,642.0,5,1079,4.0,811.0,811.0
0.004,17,4,284,2,120,0.0,32.0,32.0,2,164,0.0,60.0,54.0
0.006,6,10,1854,5,889,1.0,621.0,621.0,5,965,1.0,697.0,697.0
0.009,6,10,1990,5,911,2.0,643.0,643.0,5,1079,2.0,811.0,811.0
0.005,17,2,144,1,64,0.0,36.0,36.0,1,80,0.0,52.0,52.0
0.009,6,12,1926,6,1189,1.0,659.0,434.0,6,737,1.0,417.0,417.0
0.005,17,2,166,1,75,0.0,47.0,47.0,1,91,0.0,63.0,63.0
0.005,6,10,1689,5,839,1.0,571.0,571.0,5,850,1.0,582.0,582.0
11.176,17,28,4416,14,1993,847.0,268.0,114.0,14,2423,847.0,586.0,145.0
0.006,6,10,1989,5,927,1.0,659.0,659.0,5,1062,1.0,794.0,794.0
0.005,6,10,2007,5,928,1.0,660.0,660.0,5,1079,1.0,811.0,811.0
0.005,6,10,1854,5,889,1.0,621.0,621.0,5,965,1.0,697.0,697.0
0.124,6,10,1506,5,395,27.0,127.0,127.0,5,1111,25.0,843.0,843.0
0.094,6,10,1506,5,395,18.0,127.0,127.0,5,1111,20.0,843.0,843.0
0.005,6,10,1989,5,927,1.0,659.0,659.0,5,1062,1.0,794.0,794.0
0.012,6,10,1972,5,910,2.0,642.0,642.0,5,1062,2.0,794.0,794.0
0.006,6,10,1989,5,927,1.0,659.0,659.0,5,1062,1.0,794.0,794.0
0.017,17,2,198,1,91,0.0,63.0,63.0,1,107,0.0,79.0,79.0
0.12,6,10,1506,5,395,29.0,127.0,127.0,5,1111,25.0,843.0,843.0
0.006,6,10,1689,5,839,1.0,571.0,571.0,5,850,1.0,582.0,582.0
0.01,6,10,1990,5,911,2.0,643.0,643.0,5,1079,2.0,811.0,811.0
15.084,17,15,8179,8,5956,2150.0,1350.0,716.0,7,2223,2509.0,1350.0,289.0
41.618,6,43,13113,21,7206,455.0,2720.0,1055.0,22,5907,1973.0,2667.0,385.0
1771.923,6,106,6361,60,3537,30031.0,27.0,27.0,46,2824,39375.0,27.0,27.0
15.071,17,15,9238,8,6902,2149.0,1350.0,834.0,7,2336,2507.0,1350.0,305.0
0.113,6,10,1506,5,395,25.0,127.0,127.0,5,1111,27.0,843.0,843.0
0.148,6,10,1506,5,395,32.0,127.0,127.0,5,1111,32.0,843.0,843.0
0.079,6,10,1506,5,395,14.0,127.0,127.0,5,1111,18.0,843.0,843.0
0.118,6,10,1506,5,395,26.0,127.0,127.0,5,1111,27.0,843.0,843.0
0.071,17,8,3613,4,1874,23.0,1350.0,440.0,4,1739,13.0,1350.0,406.0
0.005,6,10,2006,5,927,1.0,659.0,659.0,5,1079,1.0,811.0,811.0
0.005,6,10,1643,5,860,1.0,592.0,592.0,5,783,1.0,515.0,515.0
0.078,6,10,1506,5,395,18.0,127.0,127.0,5,1111,16.0,843.0,843.0
0.004,17,2,136,1,60,0.0,32.0,32.0,1,76,0.0,48.0,48.0
0.017,6,10,1983,5,910,4.0,642.0,642.0,5,1073,4.0,805.0,805.0
0.99,6,12,3134,6,2099,149.0,1328.0,923.0,6,1035,149.0,791.0,791.0
0.014,6,10,1990,5,911,3.0,643.0,643.0,5,1079,3.0,811.0,811.0
0.004,6,10,2006,5,927,1.0,659.0,659.0,5,1079,1.0,811.0,811.0
40.056,17,10,676,5,460,10012.0,104.0,64.0,5,216,10013.0,20.0,15.0
0.014,6,10,1989,5,910,3.0,642.0,642.0,5,1079,3.0,811.0,811.0
0.016,6,10,1990,5,911,3.0,643.0,643.0,5,1079,4.0,811.0,811.0
0.009,6,10,1989,5,910,2.0,642.0,642.0,5,1079,2.0,811.0,811.0
0.006,17,2,170,1,65,0.0,37.0,37.0,1,105,0.0,77.0,77.0
308.409,17,20,1124,10,716,34254.0,48.0,43.0,10,408,34254.0,20.0,12.0
0.008,6,10,1990,5,911,1.0,643.0,643.0,5,1079,1.0,811.0,811.0
0.016,6,10,1983,5,910,4.0,642.0,642.0,5,1073,4.0,805.0,805.0
0.005,6,10,2007,5,928,1.0,660.0,660.0,5,1079,1.0,811.0,811.0
96.412,6,40,10153,21,4595,4812.0,1360.0,620.0,19,5558,5346.0,1360.0,398.0
0.001,17,2,180,1,66,0.0,38.0,38.0,1,114,0.0,86.0,86.0
0.006,6,10,1547,5,764,1.0,496.0,496.0,5,783,1.0,515.0,515.0
0.009,6,10,1983,5,910,2.0,642.0,642.0,5,1073,2.0,805.0,805.0
0.005,17,2,170,1,65,0.0,37.0,37.0,1,105,0.0,77.0,77.0
0.062,6,10,1506,5,395,13.0,127.0,127.0,5,1111,14.0,843.0,843.0
0.004,6,10,2006,5,927,1.0,659.0,659.0,5,1079,1.0,811.0,811.0
0.001,17,2,136,1,60,0.0,32.0,32.0,1,76,0.0,48.0,48.0
240.272,6,36,10276,18,1883,14133.0,555.0,187.0,18,8393,14133.0,1402.0,621.0
10.86,17,28,4422,14,1994,826.0,269.0,114.0,14,2428,826.0,587.0,145.0
0.095,6,10,1506,5,395,22.0,127.0,127.0,5,1111,17.0,843.0,843.0
0.005,6,10,2006,5,927,1.0,659.0,659.0,5,1079,1.0,811.0,811.0
0.093,6,10,1506,5,395,22.0,127.0,127.0,5,1111,20.0,843.0,843.0
0.005,6,10,1989,5,927,1.0,659.0,659.0,5,1062,1.0,794.0,794.0
0.01,6,10,1990,5,911,2.0,643.0,643.0,5,1079,2.0,811.0,811.0
0.006,17,2,164,1,74,0.0,46.0,46.0,1,90,0.0,62.0,62.0
0.064,6,10,1506,5,395,14.0,127.0,127.0,5,1111,14.0,843.0,843.0
0.079,6,10,1506,5,395,17.0,127.0,127.0,5,1111,19.0,843.0,843.0
0.015,6,10,1990,5,911,3.0,643.0,643.0,5,1079,3.0,811.0,811.0
0.006,17,2,214,1,75,0.0,47.0,47.0,1,139,0.0,111.0,111.0
0.009,6,10,1677,5,827,2.0,559.0,559.0,5,850,2.0,582.0,582.0
0.004,6,10,1989,5,927,1.0,659.0,659.0,5,1062,1.0,794.0,794.0
0.004,6,10,2006,5,927,1.0,659.0,659.0,5,1079,1.0,811.0,811.0
0.004,6,10,1989,5,927,1.0,659.0,659.0,5,1062,1.0,794.0,794.0
0.007,6,10,2006,5,927,1.0,659.0,659.0,5,1079,1.0,811.0,811.0
0.074,6,10,1506,5,395,17.0,127.0,127.0,5,1111,17.0,843.0,843.0
0.003,17,2,136,1,60,0.0,32.0,32.0,1,76,0.0,48.0,48.0
0.004,17,2,136,1,60,0.0,32.0,32.0,1,76,0.0,48.0,48.0
0.005,6,10,2007,5,928,1.0,660.0,660.0,5,1079,1.0,811.0,811.0
40.053,17,10,676,5,460,10012.0,104.0,64.0,5,216,10012.0,20.0,15.0
0.012,6,12,1926,6,1189,2.0,659.0,434.0,6,737,2.0,417.0,417.0
0.017,6,10,1989,5,910,4.0,642.0,642.0,5,1079,4.0,811.0,811.0
0.005,6,10,1643,5,860,1.0,592.0,592.0,5,783,1.0,515.0,515.0
0.023,6,10,1990,5,911,5.0,643.0,643.0,5,1079,5.0,811.0,811.0
0.288,17,4,352,2,130,156.0,37.0,37.0,2,222,250.0,89.0,83.0
10.903,17,28,4423,14,1994,830.0,269.0,114.0,14,2429,830.0,588.0,145.0
0.089,6,10,1506,5,395,19.0,127.0,127.0,5,1111,16.0,843.0,843.0
0.017,6,10,1990,5,911,4.0,643.0,643.0,5,1079,4.0,811.0,811.0
0.004,17,2,132,1,58,0.0,30.0,30.0,1,74,0.0,46.0,46.0
0.017,6,10,1990,5,911,4.0,643.0,643.0,5,1079,4.0,811.0,811.0
0.003,17,2,136,1,60,0.0,32.0,32.0,1,76,0.0,48.0,48.0
0.014,6,10,1972,5,910,3.0,642.0,642.0,5,1062,3.0,794.0,794.0
0.006,6,10,1547,5,764,1.0,496.0,496.0,5,783,1.0,515.0,515.0
292.216,6,403,348001,199,21911,1475.0,2736.0,825.0,204,326090,1439.0,2804.0,1660.0
0.006,6,10,1689,5,839,1.0,571.0,571.0,5,850,1.0,582.0,582.0
0.004,17,2,186,1,61,0.0,33.0,33.0,1,125,0.0,97.0,97.0
0.015,6,10,1972,5,910,3.0,642.0,642.0,5,1062,3.0,794.0,794.0
0.001,17,2,142,1,63,0.0,35.0,35.0,1,79,0.0,51.0,51.0
0.072,17,2,144,1,64,0.0,36.0,36.0,1,80,0.0,52.0,52.0
10.85,17,28,4422,14,1993,826.0,268.0,114.0,14,2429,826.0,588.0,145.0
40.051,17,10,676,5,460,10012.0,104.0,64.0,5,216,10011.0,20.0,15.0
0.01,6,10,1762,5,911,2.0,643.0,643.0,5,851,2.0,583.0,583.0
0.004,17,4,284,2,120,0.0,32.0,32.0,2,164,0.0,60.0,54.0
0.005,6,10,2007,5,928,1.0,660.0,660.0,5,1079,1.0,811.0,811.0
0.001,17,2,180,1,66,0.0,38.0,38.0,1,114,0.0,86.0,86.0
0.114,6,10,1506,5,395,26.0,127.0,127.0,5,1111,26.0,843.0,843.0
0.011,6,10,1972,5,910,2.0,642.0,642.0,5,1062,2.0,794.0,794.0
0.011,6,10,1972,5,910,2.0,642.0,642.0,5,1062,2.0,794.0,794.0
0.005,6,10,2006,5,927,1.0,659.0,659.0,5,1079,1.0,811.0,811.0
0.015,6,10,1989,5,910,3.0,642.0,642.0,5,1079,3.0,811.0,811.0
0.005,6,10,1989,5,927,1.0,659.0,659.0,5,1062,1.0,794.0,794.0
11.268,17,28,4422,14,1994,854.0,269.0,114.0,14,2428,854.0,587.0,145.0
0.006,17,2,179,1,71,0.0,43.0,43.0,1,108,0.0,80.0,80.0
240.086,6,16,4481,9,963,30010.0,238.0,166.0,7,3518,40013.0,1402.0,786.0
0.008,6,10,1972,5,910,2.0,642.0,642.0,5,1062,2.0,794.0,794.0
0.004,17,2,148,1,60,0.0,32.0,32.0,1,88,0.0,60.0,60.0
0.137,17,2,144,1,64,0.0,36.0,36.0,1,80,0.0,52.0,52.0
0.092,6,10,1506,5,395,21.0,127.0,127.0,5,1111,21.0,843.0,843.0
0.006,6,10,1547,5,764,1.0,496.0,496.0,5,783,1.0,515.0,515.0
0.039,17,2,182,1,65,0.0,37.0,37.0,1,117,0.0,89.0,89.0
0.006,6,10,1854,5,889,1.0,621.0,621.0,5,965,1.0,697.0,697.0
0.083,6,10,1506,5,395,19.0,127.0,127.0,5,1111,17.0,843.0,843.0
0.004,17,2,148,1,60,0.0,32.0,32.0,1,88,0.0,60.0,60.0
0.012,6,13,3735,7,497,2.0,125.0,125.0,6,3238,2.0,1470.0,1459.0
172.32,17,82,11350,41,2727,4307.0,44.0,38.0,41,8623,4307.0,252.0,182.0
0.012,6,10,1677,5,827,3.0,559.0,559.0,5,850,2.0,582.0,582.0
0.004,6,10,2006,5,927,1.0,659.0,659.0,5,1079,1.0,811.0,811.0
0.118,6,10,1506,5,395,25.0,127.0,127.0,5,1111,22.0,843.0,843.0
0.005,17,2,148,1,60,0.0,32.0,32.0,1,88,0.0,60.0,60.0
15.094,17,17,9496,9,7416,1883.0,1350.0,796.0,8,2080,2151.0,1350.0,232.0
0.131,6,10,1506,5,395,29.0,127.0,127.0,5,1111,16.0,843.0,843.0
0.011,6,10,1989,5,910,2.0,642.0,642.0,5,1079,2.0,811.0,811.0
369.803,6,22,2313,16,867,24653.0,195.0,195.0,6,1446,4641.0,419.0,398.0
0.007,17,2,179,1,71,0.0,43.0,43.0,1,108,0.0,80.0,80.0
0.003,17,2,148,1,60,0.0,32.0,32.0,1,88,0.0,60.0,60.0
0.003,17,2,148,1,60,0.0,32.0,32.0,1,88,0.0,60.0,60.0
40.069,17,10,676,5,460,10014.0,104.0,64.0,5,216,10016.0,20.0,15.0
0.097,6,10,1506,5,395,20.0,127.0,127.0,5,1111,23.0,843.0,843.0
0.07,6,10,1506,5,395,15.0,127.0,127.0,5,1111,17.0,843.0,843.0
0.089,6,10,1506,5,395,21.0,127.0,127.0,5,1111,19.0,843.0,843.0
0.164,17,2,152,1,76,0.0,48.0,48.0,1,76,0.0,48.0,48.0
10.859,17,28,4421,14,1993,826.0,268.0,114.0,14,2428,826.0,587.0,145.0
0.011,6,12,1926,6,1189,2.0,659.0,434.0,6,737,2.0,417.0,417.0
0.072,6,10,1506,5,395,13.0,127.0,127.0,5,1111,16.0,843.0,843.0
0.013,6,10,1989,5,910,3.0,642.0,642.0,5,1079,3.0,811.0,811.0
308.446,17,20,1124,10,716,34258.0,48.0,43.0,10,408,34257.0,20.0,12.0
361.76,6,21,1792,16,1030,24117.0,190.0,190.0,5,762,60009.0,461.0,247.0
0.005,17,2,304,1,77,0.0,49.0,49.0,1,227,0.0,199.0,199.0
0.013,6,10,1989,5,910,3.0,642.0,642.0,5,1079,3.0,811.0,811.0
0.072,17,4,352,2,130,1.0,37.0,37.0,2,222,32.0,89.0,83.0
11.182,17,28,4420,14,1993,847.0,268.0,114.0,14,2427,847.0,586.0,145.0
11.154,17,28,4393,14,2312,847.0,587.0,137.0,14,2081,849.0,268.0,120.0
0.042,17,2,148,1,60,0.0,32.0,32.0,1,88,0.0,60.0,60.0
0.121,6,10,1506,5,395,26.0,127.0,127.0,5,1111,26.0,843.0,843.0
0.008,6,10,1677,5,827,2.0,559.0,559.0,5,850,2.0,582.0,582.0
0.004,6,10,1989,5,927,1.0,659.0,659.0,5,1062,1.0,794.0,794.0
0.005,6,10,2006,5,927,1.0,659.0,659.0,5,1079,1.0,811.0,811.0
11.401,17,28,4395,14,2312,864.0,587.0,137.0,14,2083,864.0,270.0,120.0
0.033,6,8,832,4,522,10.0,302.0,302.0,4,310,10.0,102.0,102.0
0.155,6,10,1506,5,395,30.0,127.0,127.0,5,1111,34.0,843.0,843.0
0.017,6,10,1989,5,910,4.0,642.0,642.0,5,1079,4.0,811.0,811.0
0.005,6,10,1643,5,860,1.0,592.0,592.0,5,783,1.0,515.0,515.0
0.016,6,10,1990,5,911,4.0,643.0,643.0,5,1079,4.0,811.0,811.0
311.983,17,20,1124,10,716,34658.0,48.0,43.0,10,408,34658.0,20.0,12.0
0.006,17,2,144,1,64,0.0,36.0,36.0,1,80,0.0,52.0,52.0
0.001,17,2,180,1,66,0.0,38.0,38.0,1,114,0.0,86.0,86.0
0.011,6,13,3735,7,497,1.0,125.0,125.0,6,3238,2.0,1470.0,1459.0
0.015,6,10,1972,5,910,3.0,642.0,642.0,5,1062,3.0,794.0,794.0
0.006,6,10,2006,5,927,1.0,659.0,659.0,5,1079,1.0,811.0,811.0
0.005,6,10,2006,5,927,1.0,659.0,659.0,5,1079,1.0,811.0,811.0
0.009,6,10,1972,5,910,2.0,642.0,642.0,5,1062,2.0,794.0,794.0
0.005,6,10,2007,5,928,1.0,660.0,660.0,5,1079,1.0,811.0,811.0
0.004,6,10,2006,5,927,1.0,659.0,659.0,5,1079,1.0,811.0,811.0
0.075,17,2,170,1,65,0.0,37.0,37.0,1,105,0.0,77.0,77.0
0.015,6,13,3735,7,497,2.0,125.0,125.0,6,3238,2.0,1470.0,1459.0
0.007,6,10,1972,5,910,1.0,642.0,642.0,5,1062,1.0,794.0,794.0
0.004,6,10,2007,5,928,1.0,660.0,660.0,5,1079,1.0,811.0,811.0
0.024,6,10,1989,5,910,6.0,642.0,642.0,5,1079,5.0,811.0,811.0
300.03,6,12,1782,7,1348,50005.0,494.0,494.0,5,434,75006.0,83.0,83.0
0.006,6,10,1689,5,839,1.0,571.0,571.0,5,850,1.0,582.0,582.0
0.152,6,10,1506,5,395,35.0,127.0,127.0,5,1111,37.0,843.0,843.0
0.011,6,10,1989,5,910,2.0,642.0,642.0,5,1079,2.0,811.0,811.0
0.006,6,10,1547,5,764,1.0,496.0,496.0,5,783,1.0,515.0,515.0
0.005,6,10,1989,5,927,1.0,659.0,659.0,5,1062,1.0,794.0,794.0
0.005,17,2,214,1,75,0.0,47.0,47.0,1,139,0.0,111.0,111.0
0.009,6,10,1989,5,910,2.0,642.0,642.0,5,1079,2.0,811.0,811.0
0.006,6,10,1854,5,889,1.0,621.0,621.0,5,965,1.0,697.0,697.0
0.041,17,4,580,2,122,1.0,33.0,33.0,2,458,37.0,307.0,201.0
284.133,17,124,17447,62,4126,4657.0,44.0,38.0,62,13321,4657.0,261.0,186.0
176.445,17,70,9969,35,2330,5189.0,44.0,38.0,35,7639,5189.0,239.0,190.0
1792.904,6,556,188548,287,163257,6268.0,2883.0,921.0,269,25291,6689.0,369.0,114.0
353.511,6,20,2210,6,1308,12003.0,494.0,494.0,14,902,27192.0,83.0,83.0
1787.499,6,154,19574,92,13852,19642.0,302.0,302.0,62,5722,29303.0,83.0,83.0
0.014,6,10,1972,5,910,3.0,642.0,642.0,5,1062,3.0,794.0,794.0
0.004,6,10,2007,5,928,1.0,660.0,660.0,5,1079,1.0,811.0,811.0
0.099,6,10,1506,5,395,21.0,127.0,127.0,5,1111,20.0,843.0,843.0
11.051,17,28,4392,14,2311,841.0,586.0,137.0,14,2081,841.0,268.0,120.0
11.035,17,28,4392,14,2311,840.0,586.0,137.0,14,2081,840.0,268.0,120.0
0.018,6,10,1990,5,911,4.0,643.0,643.0,5,1079,4.0,811.0,811.0
0.077,6,10,1506,5,395,15.0,127.0,127.0,5,1111,17.0,843.0,843.0
0.013,6,10,1762,5,911,3.0,643.0,643.0,5,851,3.0,583.0,583.0
0.045,6,10,1605,5,388,11.0,120.0,120.0,5,1217,11.0,949.0,949.0
0.001,17,2,164,1,74,0.0,46.0,46.0,1,90,0.0,62.0,62.0
0.005,6,14,3742,8,504,0.0,80.0,80.0,6,3238,1.0,1470.0,1459.0
368.718,6,22,2313,16,867,24581.0,195.0,195.0,6,1446,4643.0,419.0,398.0
0.006,6,10,1547,5,764,1.0,496.0,496.0,5,783,1.0,515.0,515.0
240.671,6,37,9656,19,2174,13368.0,746.0,235.0,18,7482,14155.0,1402.0,595.0
0.005,6,10,2006,5,927,1.0,659.0,659.0,5,1079,1.0,811.0,811.0
0.004,6,10,1702,5,863,0.0,595.0,595.0,5,839,1.0,571.0,571.0
0.122,6,10,1506,5,395,27.0,127.0,127.0,5,1111,27.0,843.0,843.0
0.005,6,10,2006,5,927,1.0,659.0,659.0,5,1079,1.0,811.0,811.0
0.006,6,10,1547,5,764,1.0,496.0,496.0,5,783,1.0,515.0,515.0
0.003,17,4,284,2,120,0.0,32.0,32.0,2,164,0.0,60.0,54.0
412.547,6,29,4409,12,3102,10914.0,494.0,494.0,17,1307,25784.0,83.0,83.0
0.001,17,2,180,1,66,0.0,38.0,38.0,1,114,0.0,86.0,86.0
1778.228,17,144,45504,72,22752,25045.0,288.0,288.0,72,22752,25045.0,288.0,288.0
0.12,6,10,1506,5,395,24.0,127.0,127.0,5,1111,28.0,843.0,843.0
0.01,6,10,1983,5,910,2.0,642.0,642.0,5,1073,2.0,805.0,805.0
0.077,6,10,1506,5,395,18.0,127.0,127.0,5,1111,14.0,843.0,843.0
308.411,17,20,1124,10,716,34253.0,48.0,43.0,10,408,34253.0,20.0,12.0
0.072,6,10,1506,5,395,15.0,127.0,127.0,5,1111,14.0,843.0,843.0
0.013,6,10,1989,5,910,3.0,642.0,642.0,5,1079,3.0,811.0,811.0
0.053,17,2,152,1,76,0.0,48.0,48.0,1,76,0.0,48.0,48.0
0.008,6,10,1972,5,910,2.0,642.0,642.0,5,1062,2.0,794.0,794.0
0.007,6,10,1854,5,889,1.0,621.0,621.0,5,965,1.0,697.0,697.0
0.009,6,12,1926,6,1189,1.0,659.0,434.0,6,737,1.0,417.0,417.0
354.004,6,21,1795,16,1030,23600.0,190.0,190.0,5,765,60002.0,464.0,248.0
0.012,6,10,1989,5,927,2.0,659.0,659.0,5,1062,2.0,794.0,794.0
0.005,6,10,2006,5,927,1.0,659.0,659.0,5,1079,1.0,811.0,811.0
0.088,6,10,1506,5,395,20.0,127.0,127.0,5,1111,20.0,843.0,843.0
0.004,6,10,2006,5,927,1.0,659.0,659.0,5,1079,1.0,811.0,811.0
0.001,17,2,180,1,66,0.0,38.0,38.0,1,114,0.0,86.0,86.0
0.001,17,2,136,1,60,0.0,32.0,32.0,1,76,0.0,48.0,48.0
0.007,6,10,1547,5,764,1.0,496.0,496.0,5,783,1.0,515.0,515.0
0.006,6,10,1989,5,927,1.0,659.0,659.0,5,1062,1.0,794.0,794.0
0.01,6,10,1631,5,848,2.0,580.0,580.0,5,783,2.0,515.0,515.0
0.005,6,10,1989,5,927,1.0,659.0,659.0,5,1062,1.0,794.0,794.0
15.072,17,15,9238,8,6902,2149.0,1350.0,834.0,7,2336,2507.0,1350.0,305.0
0.088,6,10,1506,5,395,19.0,127.0,127.0,5,1111,20.0,843.0,843.0
0.119,6,10,1506,5,395,27.0,127.0,127.0,5,1111,28.0,843.0,843.0
0.078,6,10,1506,5,395,17.0,127.0,127.0,5,1111,17.0,843.0,843.0
0.006,6,10,1689,5,839,1.0,571.0,571.0,5,850,1.0,582.0,582.0
0.021,6,10,1989,5,910,5.0,642.0,642.0,5,1079,5.0,811.0,811.0
0.015,6,10,1990,5,911,3.0,643.0,643.0,5,1079,3.0,811.0,811.0
0.004,17,2,136,1,60,0.0,32.0,32.0,1,76,0.0,48.0,48.0
0.429,17,63,44307,39,37758,10.0,1350.0,940.0,24,6549,18.0,1350.0,244.0
0.097,6,10,1506,5,395,22.0,127.0,127.0,5,1111,22.0,843.0,843.0
317.531,17,20,1124,10,716,35266.0,48.0,43.0,10,408,35265.0,20.0,12.0
0.007,6,10,2006,5,927,1.0,659.0,659.0,5,1079,1.0,811.0,811.0
0.089,6,10,1506,5,395,19.0,127.0,127.0,5,1111,21.0,843.0,843.0
0.171,6,3,453,2,321,171.0,241.0,241.0,1,132,0.0,92.0,92.0
0.007,6,10,1989,5,910,1.0,642.0,642.0,5,1079,1.0,811.0,811.0
40.059,17,10,676,5,460,10013.0,104.0,64.0,5,216,10014.0,20.0,15.0
0.006,6,10,2007,5,928,1.0,660.0,660.0,5,1079,1.0,811.0,811.0
0.005,6,13,3747,7,509,0.0,137.0,137.0,6,3238,1.0,1470.0,1459.0
0.038,17,2,412,1,61,0.0,33.0,33.0,1,351,0.0,323.0,323.0
0.001,17,2,180,1,66,0.0,38.0,38.0,1,114,0.0,86.0,86.0
1.526,6,35,8390,18,1958,89.0,890.0,402.0,17,6432,87.0,2126.0,478.0
0.006,6,10,1643,5,860,1.0,592.0,592.0,5,783,1.0,515.0,515.0
240.652,6,33,9267,16,1836,16040.0,624.0,199.0,17,7431,15037.0,1402.0,595.0
40.069,17,10,676,5,460,10014.0,104.0,64.0,5,216,10016.0,20.0,15.0
0.01,6,10,1989,5,910,2.0,642.0,642.0,5,1079,2.0,811.0,811.0
0.061,6,10,1506,5,395,13.0,127.0,127.0,5,1111,14.0,843.0,843.0
354.067,6,19,1691,15,978,25290.0,190.0,190.0,4,713,80004.0,497.0,497.0
0.015,6,10,1989,5,910,3.0,642.0,642.0,5,1079,3.0,811.0,811.0
0.01,6,10,1989,5,910,2.0,642.0,642.0,5,1079,2.0,811.0,811.0
0.006,6,10,1547,5,764,1.0,496.0,496.0,5,783,1.0,515.0,515.0
0.006,6,13,3747,7,509,0.0,137.0,137.0,6,3238,1.0,1470.0,1459.0
0.005,6,10,2006,5,927,1.0,659.0,659.0,5,1079,1.0,811.0,811.0
0.017,6,10,1990,5,911,4.0,643.0,643.0,5,1079,4.0,811.0,811.0
0.001,17,2,180,1,66,0.0,38.0,38.0,1,114,0.0,86.0,86.0
1.109,6,22,7922,12,1487,100.0,517.0,287.0,10,6435,18.0,1402.0,843.0
0.005,6,10,1854,5,889,1.0,621.0,621.0,5,965,1.0,697.0,697.0
40.064,17,10,676,5,460,10013.0,104.0,64.0,5,216,10015.0,20.0,15.0
0.005,6,10,1643,5,860,1.0,592.0,592.0,5,783,1.0,515.0,515.0
0.005,17,2,293,1,73,0.0,45.0,45.0,1,220,0.0,192.0,192.0
0.004,6,10,2006,5,927,1.0,659.0,659.0,5,1079,1.0,811.0,811.0
0.116,6,10,1506,5,395,26.0,127.0,127.0,5,1111,23.0,843.0,843.0
40.09,17,10,676,5,460,10018.0,104.0,64.0,5,216,10021.0,20.0,15.0
0.004,17,2,185,1,73,0.0,45.0,45.0,1,112,0.0,84.0,84.0
0.017,6,10,1989,5,910,4.0,642.0,642.0,5,1079,4.0,811.0,811.0
0.008,6,10,1989,5,910,2.0,642.0,642.0,5,1079,2.0,811.0,811.0
40.073,17,10,676,5,460,10017.0,104.0,64.0,5,216,10017.0,20.0,15.0
0.005,17,2,194,1,59,0.0,31.0,31.0,1,135,0.0,107.0,107.0
0.004,17,2,136,1,60,0.0,32.0,32.0,1,76,0.0,48.0,48.0
40.071,17,10,676,5,460,10016.0,104.0,64.0,5,216,10017.0,20.0,15.0
0.008,6,10,1989,5,910,2.0,642.0,642.0,5,1079,2.0,811.0,811.0
0.006,6,10,1854,5,889,1.0,621.0,621.0,5,965,1.0,697.0,697.0
0.071,17,8,3613,4,1874,23.0,1350.0,440.0,4,1739,12.0,1350.0,406.0
10.734,17,28,4419,14,1995,817.0,270.0,114.0,14,2424,817.0,587.0,145.0
40.056,17,10,676,5,460,10013.0,104.0,64.0,5,216,10013.0,20.0,15.0
0.005,6,10,2000,5,927,1.0,659.0,659.0,5,1073,1.0,805.0,805.0
0.007,6,10,1854,5,889,1.0,621.0,621.0,5,965,1.0,697.0,697.0
0.006,17,2,225,1,65,0.0,37.0,37.0,1,160,0.0,132.0,132.0
10.764,17,28,4419,14,1995,820.0,270.0,114.0,14,2424,819.0,587.0,145.0
0.006,6,10,1547,5,764,1.0,496.0,496.0,5,783,1.0,515.0,515.0
0.004,6,10,2006,5,927,1.0,659.0,659.0,5,1079,1.0,811.0,811.0
0.017,6,10,1989,5,910,4.0,642.0,642.0,5,1079,4.0,811.0,811.0
0.004,6,10,1989,5,927,1.0,659.0,659.0,5,1062,1.0,794.0,794.0
0.004,6,10,2007,5,928,1.0,660.0,660.0,5,1079,1.0,811.0,811.0
368.927,6,22,2313,16,867,24595.0,195.0,195.0,6,1446,4659.0,419.0,398.0
310.768,17,20,1124,10,716,34516.0,48.0,43.0,10,408,34518.0,20.0,12.0
0.021,6,10,1989,5,910,5.0,642.0,642.0,5,1079,5.0,811.0,811.0
0.089,6,10,1506,5,395,20.0,127.0,127.0,5,1111,16.0,843.0,843.0
15.071,17,15,9238,8,6902,2149.0,1350.0,834.0,7,2336,2507.0,1350.0,305.0
0.005,6,10,1643,5,860,1.0,592.0,592.0,5,783,1.0,515.0,515.0
1730.356,6,45,2790,30,1725,59667.0,35.0,35.0,15,1065,123591.0,31.0,31.0
0.005,6,10,2007,5,928,1.0,660.0,660.0,5,1079,1.0,811.0,811.0
0.006,6,10,1547,5,764,1.0,496.0,496.0,5,783,1.0,515.0,515.0
0.005,17,2,225,1,65,0.0,37.0,37.0,1,160,0.0,132.0,132.0
0.027,6,10,1989,5,910,6.0,642.0,642.0,5,1079,6.0,811.0,811.0
10.814,17,28,4418,14,1994,823.0,269.0,114.0,14,2424,823.0,587.0,145.0
0.126,17,2,80,1,32,0.0,4.0,4.0,1,48,0.0,20.0,20.0
0.077,6,10,1506,5,395,15.0,127.0,127.0,5,1111,17.0,843.0,843.0
0.004,17,2,164,1,74,0.0,46.0,46.0,1,90,0.0,62.0,62.0
0.005,6,10,2007,5,928,1.0,660.0,660.0,5,1079,1.0,811.0,811.0
0.006,6,10,1547,5,764,1.0,496.0,496.0,5,783,1.0,515.0,515.0
0.005,6,10,1689,5,839,1.0,571.0,571.0,5,850,1.0,582.0,582.0
0.515,6,22,7186,11,1635,51.0,748.0,263.0,11,5551,51.0,2334.0,994.0
0.019,6,10,1972,5,910,4.0,642.0,642.0,5,1062,4.0,794.0,794.0
0.01,6,10,1989,5,910,2.0,642.0,642.0,5,1079,2.0,811.0,811.0
0.093,6,10,1506,5,395,19.0,127.0,127.0,5,1111,20.0,843.0,843.0
10.828,17,28,4423,14,1994,824.0,269.0,114.0,14,2429,824.0,588.0,145.0
0.009,17,2,214,1,75,0.0,47.0,47.0,1,139,0.0,111.0,111.0
11.145,17,28,4418,14,1993,844.0,268.0,114.0,14,2425,844.0,588.0,145.0
0.003,17,2,148,1,60,0.0,32.0,32.0,1,88,0.0,60.0,60.0
0.006,6,10,2006,5,927,1.0,659.0,659.0,5,1079,1.0,811.0,811.0
0.083,6,10,1506,5,395,18.0,127.0,127.0,5,1111,16.0,843.0,843.0
0.014,6,10,1762,5,911,3.0,643.0,643.0,5,851,3.0,583.0,583.0
0.004,17,2,170,1,65,0.0,37.0,37.0,1,105,0.0,77.0,77.0
0.001,17,2,180,1,66,0.0,38.0,38.0,1,114,0.0,86.0,86.0
0.017,6,12,1926,6,1189,3.0,659.0,434.0,6,737,3.0,417.0,417.0
0.006,17,2,170,1,65,0.0,37.0,37.0,1,105,0.0,77.0,77.0
15.078,17,16,9071,8,6788,2149.0,1350.0,820.0,8,2283,2149.0,1350.0,257.0
0.038,17,2,144,1,64,0.0,36.0,36.0,1,80,0.0,52.0,52.0
0.005,6,10,1854,5,889,1.0,621.0,621.0,5,965,1.0,697.0,697.0
0.005,17,2,140,1,62,0.0,34.0,34.0,1,78,0.0,50.0,50.0
0.013,6,10,1631,5,848,3.0,580.0,580.0,5,783,3.0,515.0,515.0
0.003,17,2,136,1,60,0.0,32.0,32.0,1,76,0.0,48.0,48.0
0.006,6,10,2007,5,928,1.0,660.0,660.0,5,1079,1.0,811.0,811.0
0.004,6,10,2000,5,927,1.0,659.0,659.0,5,1073,1.0,805.0,805.0
0.005,17,2,166,1,75,0.0,47.0,47.0,1,91,0.0,63.0,63.0
0.006,6,10,1854,5,889,1.0,621.0,621.0,5,965,1.0,697.0,697.0
1787.76,6,150,19350,90,13740,20087.0,302.0,302.0,60,5610,30300.0,83.0,83.0
0.015,17,2,213,1,69,0.0,41.0,41.0,1,144,0.0,116.0,116.0
0.004,6,10,1774,5,923,1.0,655.0,655.0,5,851,1.0,583.0,583.0
40.055,17,10,676,5,460,10013.0,104.0,64.0,5,216,10013.0,20.0,15.0
0.032,6,10,1989,5,910,7.0,642.0,642.0,5,1079,7.0,811.0,811.0
0.122,6,10,1506,5,395,27.0,127.0,127.0,5,1111,24.0,843.0,843.0
0.079,6,10,1506,5,395,17.0,127.0,127.0,5,1111,18.0,843.0,843.0
1799.998,6,252,40889,96,31241,18947.0,2790.0,334.0,156,9648,11612.0,148.0,48.0
0.009,6,12,1926,6,1189,1.0,659.0,434.0,6,737,1.0,417.0,417.0
0.004,17,4,284,2,120,0.0,32.0,32.0,2,164,0.0,60.0,54.0
309.001,17,20,1124,10,716,34319.0,48.0,43.0,10,408,34319.0,20.0,12.0
0.005,17,2,170,1,65,0.0,37.0,37.0,1,105,0.0,77.0,77.0
0.015,6,10,1989,5,910,3.0,642.0,642.0,5,1079,3.0,811.0,811.0
0.005,6,10,1779,5,928,1.0,660.0,660.0,5,851,1.0,583.0,583.0
0.008,6,10,1983,5,910,2.0,642.0,642.0,5,1073,1.0,805.0,805.0
0.088,6,10,1506,5,395,20.0,127.0,127.0,5,1111,19.0,843.0,843.0
0.078,6,10,1506,5,395,16.0,127.0,127.0,5,1111,14.0,843.0,843.0
0.128,6,10,1506,5,395,29.0,127.0,127.0,5,1111,30.0,843.0,843.0
240.103,6,16,4481,9,963,30012.0,238.0,166.0,7,3518,40015.0,1402.0,786.0
0.007,6,10,1983,5,910,1.0,642.0,642.0,5,1073,1.0,805.0,805.0
0.005,17,2,164,1,74,0.0,46.0,46.0,1,90,0.0,62.0,62.0
0.016,6,10,1677,5,827,4.0,559.0,559.0,5,850,3.0,582.0,582.0
0.039,17,4,420,2,122,0.0,33.0,33.0,2,298,35.0,145.0,121.0
0.005,6,10,2007,5,928,1.0,660.0,660.0,5,1079,1.0,811.0,811.0
0.014,6,10,1989,5,910,3.0,642.0,642.0,5,1079,3.0,811.0,811.0
0.088,6,10,1506,5,395,21.0,127.0,127.0,5,1111,17.0,843.0,843.0
0.011,6,10,1677,5,827,2.0,559.0,559.0,5,850,2.0,582.0,582.0
0.012,6,10,1990,5,911,3.0,643.0,643.0,5,1079,2.0,811.0,811.0
0.013,6,10,1990,5,911,3.0,643.0,643.0,5,1079,3.0,811.0,811.0
0.005,6,10,2007,5,928,1.0,660.0,660.0,5,1079,1.0,811.0,811.0
0.014,6,10,1990,5,911,3.0,643.0,643.0,5,1079,3.0,811.0,811.0
0.005,6,10,2007,5,928,1.0,660.0,660.0,5,1079,1.0,811.0,811.0
1778.24,17,144,41760,72,22752,25045.0,288.0,288.0,72,19008,25045.0,236.0,236.0
0.066,6,10,1506,5,395,14.0,127.0,127.0,5,1111,15.0,843.0,843.0
0.001,17,2,180,1,66,0.0,38.0,38.0,1,114,0.0,86.0,86.0
0.011,6,10,1990,5,911,2.0,643.0,643.0,5,1079,2.0,811.0,811.0
0.005,6,10,1689,5,839,1.0,571.0,571.0,5,850,1.0,582.0,582.0
1775.938,6,558,188706,286,163273,6231.0,2883.0,951.0,272,25433,6553.0,381.0,112.0
0.008,6,10,1972,5,910,2.0,642.0,642.0,5,1062,2.0,794.0,794.0
0.014,6,10,1989,5,910,3.0,642.0,642.0,5,1079,3.0,811.0,811.0
0.006,6,10,1547,5,764,1.0,496.0,496.0,5,783,1.0,515.0,515.0
323.079,17,16,892,8,564,46139.0,48.0,42.0,8,328,46138.0,20.0,13.0
0.005,6,10,1989,5,927,1.0,659.0,659.0,5,1062,1.0,794.0,794.0
0.006,6,13,3747,7,509,0.0,137.0,137.0,6,3238,1.0,1470.0,1459.0
0.118,6,10,1506,5,395,29.0,127.0,127.0,5,1111,24.0,843.0,843.0
0.091,6,10,1506,5,395,19.0,127.0,127.0,5,1111,20.0,843.0,843.0
175.262,17,70,9977,35,2338,5154.0,44.0,38.0,35,7639,5154.0,239.0,190.0
0.014,6,10,1762,5,911,3.0,643.0,643.0,5,851,3.0,583.0,583.0
0.006,17,2,193,1,71,0.0,43.0,43.0,1,122,0.0,94.0,94.0
0.004,6,10,1702,5,863,0.0,595.0,595.0,5,839,1.0,571.0,571.0
0.011,6,10,1990,5,911,2.0,643.0,643.0,5,1079,2.0,811.0,811.0
0.008,6,10,1631,5,848,2.0,580.0,580.0,5,783,2.0,515.0,515.0
0.014,6,10,1989,5,910,3.0,642.0,642.0,5,1079,3.0,811.0,811.0
0.004,17,2,136,1,60,0.0,32.0,32.0,1,76,0.0,48.0,48.0
0.006,6,10,1689,5,839,1.0,571.0,571.0,5,850,1.0,582.0,582.0
0.021,6,10,1972,5,910,5.0,642.0,642.0,5,1062,5.0,794.0,794.0
0.005,17,2,179,1,71,0.0,43.0,43.0,1,108,0.0,80.0,80.0
11.031,17,28,4422,14,1993,840.0,268.0,114.0,14,2429,840.0,588.0,145.0
0.01,6,10,1990,5,911,2.0,643.0,643.0,5,1079,2.0,811.0,811.0
0.061,6,10,1506,5,395,13.0,127.0,127.0,5,1111,14.0,843.0,843.0
0.013,17,2,152,1,56,0.0,28.0,28.0,1,96,0.0,68.0,68.0
0.105,6,10,1506,5,395,23.0,127.0,127.0,5,1111,23.0,843.0,843.0
0.121,6,10,1506,5,395,28.0,127.0,127.0,5,1111,22.0,843.0,843.0
0.011,6,12,1926,6,1189,2.0,659.0,434.0,6,737,2.0,417.0,417.0
0.011,6,10,1762,5,911,2.0,643.0,643.0,5,851,2.0,583.0,583.0
0.004,6,10,2006,5,927,1.0,659.0,659.0,5,1079,1.0,811.0,811.0
0.006,6,10,1643,5,860,1.0,592.0,592.0,5,783,1.0,515.0,515.0
240.532,6,33,8636,17,1838,15031.0,571.0,189.0,16,6798,16033.0,1402.0,597.0
0.001,17,2,166,1,75,0.0,47.0,47.0,1,91,0.0,63.0,63.0
11.036,17,28,4422,14,1994,837.0,269.0,114.0,14,2428,837.0,587.0,145.0
0.005,6,10,2000,5,927,1.0,659.0,659.0,5,1073,1.0,805.0,805.0
0.02,6,10,1990,5,911,5.0,643.0,643.0,5,1079,4.0,811.0,811.0
0.019,6,10,1677,5,827,4.0,559.0,559.0,5,850,4.0,582.0,582.0
0.004,6,10,2007,5,928,1.0,660.0,660.0,5,1079,1.0,811.0,811.0
0.045,17,4,284,2,120,2.0,32.0,32.0,2,164,4.0,60.0,54.0
354.04,6,21,1795,16,1030,23602.0,190.0,190.0,5,765,60001.0,464.0,248.0
0.005,6,10,2007,5,928,1.0,660.0,660.0,5,1079,1.0,811.0,811.0
0.102,6,10,1506,5,395,22.0,127.0,127.0,5,1111,16.0,843.0,843.0
241.305,6,369,347210,187,21248,1297.0,2736.0,885.0,182,325962,1333.0,2915.0,1840.0
0.04,17,2,152,1,76,0.0,48.0,48.0,1,76,0.0,48.0,48.0
0.003,17,2,136,1,60,0.0,32.0,32.0,1,76,0.0,48.0,48.0
40.064,17,10,676,5,460,10013.0,104.0,64.0,5,216,10010.0,20.0,15.0
40.038,17,10,676,5,460,10008.0,104.0,64.0,5,216,10008.0,20.0,15.0
0.007,6,10,1689,5,839,1.0,571.0,571.0,5,850,1.0,582.0,582.0
0.011,6,10,1983,5,910,2.0,642.0,642.0,5,1073,2.0,805.0,805.0
0.084,6,10,1506,5,395,16.0,127.0,127.0,5,1111,17.0,843.0,843.0
15.185,17,18,10135,9,6525,1894.0,1350.0,697.0,9,3610,1894.0,1350.0,373.0
0.008,17,2,238,1,66,0.0,38.0,38.0,1,172,0.0,144.0,144.0
0.018,6,10,1972,5,910,4.0,642.0,642.0,5,1062,4.0,794.0,794.0
0.078,6,10,1506,5,395,17.0,127.0,127.0,5,1111,16.0,843.0,843.0
0.004,6,10,1774,5,923,1.0,655.0,655.0,5,851,1.0,583.0,583.0
0.075,6,10,1506,5,395,16.0,127.0,127.0,5,1111,16.0,843.0,843.0
0.01,6,6,716,3,458,3.0,302.0,302.0,3,258,3.0,102.0,102.0
0.004,6,10,2006,5,927,1.0,659.0,659.0,5,1079,1.0,811.0,811.0
240.457,6,28,4647,14,1928,18493.0,555.0,238.0,14,2719,18493.0,1184.0,249.0
0.052,17,2,152,1,76,0.0,48.0,48.0,1,76,0.0,48.0,48.0
0.04,17,2,412,1,61,0.0,33.0,33.0,1,351,0.0,323.0,323.0
0.006,6,10,1547,5,764,1.0,496.0,496.0,5,783,1.0,515.0,515.0
0.004,17,2,166,1,75,0.0,47.0,47.0,1,91,0.0,63.0,63.0
0.085,6,10,1506,5,395,20.0,127.0,127.0,5,1111,16.0,843.0,843.0
289.649,6,403,349072,197,21804,1477.0,2736.0,888.0,206,327268,1412.0,2848.0,1648.0
0.01,6,10,1989,5,910,2.0,642.0,642.0,5,1079,2.0,811.0,811.0
0.005,6,10,1702,5,863,1.0,595.0,595.0,5,839,1.0,571.0,571.0
0.004,6,10,1702,5,863,1.0,595.0,595.0,5,839,0.0,571.0,571.0
0.005,17,2,230,1,68,0.0,40.0,40.0,1,162,0.0,134.0,134.0
0.009,6,10,1990,5,911,2.0,643.0,643.0,5,1079,2.0,811.0,811.0
0.004,6,10,1989,5,927,1.0,659.0,659.0,5,1062,1.0,794.0,794.0
0.006,6,10,2000,5,927,1.0,659.0,659.0,5,1073,1.0,805.0,805.0
0.016,6,13,3735,7,497,2.0,125.0,125.0,6,3238,3.0,1470.0,1459.0
0.076,6,10,1506,5,395,17.0,127.0,127.0,5,1111,16.0,843.0,843.0
0.014,6,10,1631,5,848,3.0,580.0,580.0,5,783,3.0,515.0,515.0
0.005,6,10,1989,5,927,1.0,659.0,659.0,5,1062,1.0,794.0,794.0
0.004,17,2,152,1,76,0.0,48.0,48.0,1,76,0.0,48.0,48.0
0.005,6,10,2007,5,928,1.0,660.0,660.0,5,1079,1.0,811.0,811.0
0.006,17,2,225,1,62,0.0,34.0,34.0,1,163,0.0,135.0,135.0
0.005,6,10,2006,5,927,1.0,659.0,659.0,5,1079,1.0,811.0,811.0
40.076,17,10,676,5,460,10018.0,104.0,64.0,5,216,10018.0,20.0,15.0
0.004,6,10,2000,5,927,1.0,659.0,659.0,5,1073,1.0,805.0,805.0
0.014,6,10,1989,5,910,3.0,642.0,642.0,5,1079,3.0,811.0,811.0
0.005,17,2,170,1,65,0.0,37.0,37.0,1,105,0.0,77.0,77.0
0.005,6,10,1689,5,839,1.0,571.0,571.0,5,850,1.0,582.0,582.0
0.009,6,10,1989,5,910,2.0,642.0,642.0,5,1079,2.0,811.0,811.0
0.126,6,27,9998,15,8942,9.0,2261.0,906.0,12,1056,11.0,147.0,72.0
0.001,17,2,174,1,72,0.0,44.0,44.0,1,102,0.0,74.0,74.0
1778.057,17,141,44556,72,22752,25042.0,288.0,288.0,69,21804,26146.0,288.0,288.0
0.103,6,10,1506,5,395,22.0,127.0,127.0,5,1111,21.0,843.0,843.0
0.042,17,2,148,1,60,0.0,32.0,32.0,1,88,0.0,60.0,60.0
0.005,6,10,1689,5,839,1.0,571.0,571.0,5,850,1.0,582.0,582.0
0.008,6,12,1926,6,1189,1.0,659.0,434.0,6,737,1.0,417.0,417.0
0.006,17,2,170,1,65,0.0,37.0,37.0,1,105,0.0,77.0,77.0
0.002,17,2,136,1,60,0.0,32.0,32.0,1,76,0.0,48.0,48.0
0.075,6,10,1506,5,395,16.0,127.0,127.0,5,1111,16.0,843.0,843.0
0.005,6,14,3799,7,509,0.0,137.0,137.0,7,3290,0.0,1448.0,972.0
0.01,6,10,1989,5,910,2.0,642.0,642.0,5,1079,2.0,811.0,811.0
0.004,6,10,1774,5,923,1.0,655.0,655.0,5,851,1.0,583.0,583.0
0.004,6,10,1989,5,927,1.0,659.0,659.0,5,1062,1.0,794.0,794.0
0.02,6,10,1989,5,910,4.0,642.0,642.0,5,1079,4.0,811.0,811.0
0.008,6,10,1989,5,910,2.0,642.0,642.0,5,1079,2.0,811.0,811.0
0.015,6,10,1990,5,911,3.0,643.0,643.0,5,1079,3.0,811.0,811.0
0.005,6,10,2007,5,928,1.0,660.0,660.0,5,1079,1.0,811.0,811.0
0.005,6,10,1779,5,928,1.0,660.0,660.0,5,851,1.0,583.0,583.0
0.013,6,10,1989,5,910,3.0,642.0,642.0,5,1079,3.0,811.0,811.0
15.144,17,20,13504,10,8344,1678.0,1350.0,806.0,10,5160,1679.0,1350.0,488.0
0.005,6,13,3747,7,509,0.0,137.0,137.0,6,3238,1.0,1470.0,1459.0
0.068,6,10,1506,5,395,15.0,127.0,127.0,5,1111,14.0,843.0,843.0
0.018,6,10,1972,5,910,4.0,642.0,642.0,5,1062,4.0,794.0,794.0
0.006,6,10,1702,5,863,1.0,595.0,595.0,5,839,1.0,571.0,571.0
0.007,6,10,1972,5,910,1.0,642.0,642.0,5,1062,1.0,794.0,794.0
354.019,6,21,1795,16,1030,23601.0,190.0,190.0,5,765,60002.0,464.0,248.0
0.071,17,4,284,2,120,0.0,32.0,32.0,2,164,68.0,60.0,54.0
0.001,17,2,180,1,66,0.0,38.0,38.0,1,114,0.0,86.0,86.0
0.003,17,2,148,1,60,0.0,32.0,32.0,1,88,0.0,60.0,60.0
0.02,6,10,1989,5,910,5.0,642.0,642.0,5,1079,4.0,811.0,811.0
0.09,6,10,1506,5,395,17.0,127.0,127.0,5,1111,20.0,843.0,843.0
40.088,17,10,676,5,460,10021.0,104.0,64.0,5,216,10021.0,20.0,15.0
0.006,6,10,1854,5,889,1.0,621.0,621.0,5,965,1.0,697.0,697.0
0.015,6,10,1990,5,911,3.0,643.0,643.0,5,1079,3.0,811.0,811.0
0.004,6,10,1702,5,863,0.0,595.0,595.0,5,839,1.0,571.0,571.0
0.009,6,10,1631,5,848,2.0,580.0,580.0,5,783,2.0,515.0,515.0
240.01,6,9,787,5,488,60002.0,232.0,232.0,4,299,80002.0,83.0,83.0
0.013,6,10,1631,5,848,3.0,580.0,580.0,5,783,3.0,515.0,515.0
0.006,6,10,1854,5,889,1.0,621.0,621.0,5,965,1.0,697.0,697.0
0.005,17,2,170,1,65,0.0,37.0,37.0,1,105,0.0,77.0,77.0
0.119,6,10,1506,5,395,26.0,127.0,127.0,5,1111,29.0,843.0,843.0
0.146,6,10,1506,5,395,33.0,127.0,127.0,5,1111,32.0,843.0,843.0
40.061,17,10,676,5,460,10013.0,104.0,64.0,5,216,10014.0,20.0,15.0
0.003,17,2,148,1,60,0.0,32.0,32.0,1,88,0.0,60.0,60.0
0.018,6,13,3735,7,497,3.0,125.0,125.0,6,3238,3.0,1470.0,1459.0
0.186,17,4,596,2,122,147.0,33.0,33.0,2,474,146.0,323.0,209.0
0.004,6,10,2006,5,927,1.0,659.0,659.0,5,1079,1.0,811.0,811.0
0.073,6,10,1506,5,395,14.0,127.0,127.0,5,1111,16.0,843.0,843.0
0.008,6,10,1762,5,911,2.0,643.0,643.0,5,851,2.0,583.0,583.0
0.005,6,10,2006,5,927,1.0,659.0,659.0,5,1079,1.0,811.0,811.0
0.009,6,10,1762,5,911,2.0,643.0,643.0,5,851,2.0,583.0,583.0
0.001,17,2,180,1,66,0.0,38.0,38.0,1,114,0.0,86.0,86.0
0.009,6,10,1983,5,910,2.0,642.0,642.0,5,1073,2.0,805.0,805.0
10.972,17,28,4390,14,2312,835.0,587.0,137.0,14,2078,835.0,269.0,120.0
165.073,17,90,13086,45,3014,3751.0,44.0,38.0,45,10072,3751.0,261.0,195.0
0.105,6,10,1506,5,395,24.0,127.0,127.0,5,1111,22.0,843.0,843.0
0.073,6,10,1506,5,395,16.0,127.0,127.0,5,1111,15.0,843.0,843.0
0.005,6,10,1989,5,927,1.0,659.0,659.0,5,1062,1.0,794.0,794.0
0.005,17,2,144,1,64,0.0,36.0,36.0,1,80,0.0,52.0,52.0
0.109,6,10,1506,5,395,24.0,127.0,127.0,5,1111,21.0,843.0,843.0
0.004,6,10,1702,5,863,1.0,595.0,595.0,5,839,0.0,571.0,571.0
0.012,6,10,1631,5,848,3.0,580.0,580.0,5,783,2.0,515.0,515.0
0.086,6,10,1506,5,395,21.0,127.0,127.0,5,1111,14.0,843.0,843.0
1770.549,6,82,4318,41,2159,44262.0,27.0,27.0,41,2159,44262.0,27.0,27.0
0.004,17,2,148,1,60,0.0,32.0,32.0,1,88,0.0,60.0,60.0
0.011,6,10,1631,5,848,2.0,580.0,580.0,5,783,2.0,515.0,515.0
0.039,17,2,182,1,65,0.0,37.0,37.0,1,117,0.0,89.0,89.0
0.003,6,10,1702,5,863,0.0,595.0,595.0,5,839,0.0,571.0,571.0
0.015,6,10,1631,5,848,3.0,580.0,580.0,5,783,3.0,515.0,515.0
0.009,6,10,1989,5,910,2.0,642.0,642.0,5,1079,2.0,811.0,811.0
0.005,6,10,1779,5,928,1.0,660.0,660.0,5,851,1.0,583.0,583.0
364.361,6,19,1688,15,978,26025.0,190.0,190.0,4,710,80014.0,494.0,494.0
0.001,17,2,180,1,66,0.0,38.0,38.0,1,114,0.0,86.0,86.0
0.006,17,4,284,2,120,3.0,32.0,32.0,2,164,2.0,60.0,54.0
0.005,6,10,1774,5,923,1.0,655.0,655.0,5,851,1.0,583.0,583.0
0.009,6,12,1926,6,1189,1.0,659.0,434.0,6,737,1.0,417.0,417.0
0.113,6,10,1506,5,395,26.0,127.0,127.0,5,1111,26.0,843.0,843.0
0.008,17,2,170,1,65,0.0,37.0,37.0,1,105,0.0,77.0,77.0
0.072,6,10,1506,5,395,17.0,127.0,127.0,5,1111,16.0,843.0,843.0
0.005,6,10,2006,5,927,1.0,659.0,659.0,5,1079,1.0,811.0,811.0
0.004,6,10,2007,5,928,1.0,660.0,660.0,5,1079,1.0,811.0,811.0
0.114,6,10,1506,5,395,24.0,127.0,127.0,5,1111,25.0,843.0,843.0
0.005,6,10,1990,5,928,1.0,660.0,660.0,5,1062,1.0,794.0,794.0
376.342,6,22,2313,16,867,25089.0,195.0,195.0,6,1446,4635.0,419.0,398.0
0.005,6,10,2007,5,928,1.0,660.0,660.0,5,1079,1.0,811.0,811.0
0.018,6,10,1989,5,910,4.0,642.0,642.0,5,1079,4.0,811.0,811.0
0.001,17,2,166,1,75,0.0,47.0,47.0,1,91,0.0,63.0,63.0
0.09,6,10,1506,5,395,17.0,127.0,127.0,5,1111,21.0,843.0,843.0
0.746,6,10,2009,6,1655,149.0,1403.0,1403.0,4,354,170.0,182.0,182.0
0.04,17,2,136,1,60,0.0,32.0,32.0,1,76,0.0,48.0,48.0
0.113,6,10,1506,5,395,23.0,127.0,127.0,5,1111,22.0,843.0,843.0
300.75,6,37,9597,20,4119,15828.0,1543.0,657.0,17,5478,536.0,2667.0,435.0
0.007,6,10,1989,5,910,1.0,642.0,642.0,5,1079,1.0,811.0,811.0
0.105,6,10,1506,5,395,25.0,127.0,127.0,5,1111,14.0,843.0,843.0
0.005,6,10,1989,5,927,1.0,659.0,659.0,5,1062,1.0,794.0,794.0
0.093,6,10,1506,5,395,19.0,127.0,127.0,5,1111,21.0,843.0,843.0
0.037,17,2,136,1,60,0.0,32.0,32.0,1,76,0.0,48.0,48.0
0.005,6,10,2000,5,927,1.0,659.0,659.0,5,1073,1.0,805.0,805.0
0.039,17,2,182,1,65,0.0,37.0,37.0,1,117,0.0,89.0,89.0
0.077,6,10,1506,5,395,16.0,127.0,127.0,5,1111,15.0,843.0,843.0
0.003,17,2,148,1,60,0.0,32.0,32.0,1,88,0.0,60.0,60.0
0.015,6,10,1990,5,911,3.0,643.0,643.0,5,1079,3.0,811.0,811.0
0.069,6,10,1506,5,395,16.0,127.0,127.0,5,1111,15.0,843.0,843.0
309.014,17,20,1124,10,716,34320.0,48.0,43.0,10,408,34320.0,20.0,12.0
155.865,6,37,9916,19,4398,8659.0,1925.0,901.0,18,5518,509.0,1360.0,398.0
243.144,6,307,343977,116,17547,2114.0,2736.0,959.0,191,326430,1279.0,2959.0,1748.0
0.005,17,2,178,1,65,0.0,37.0,37.0,1,113,0.0,85.0,85.0
0.004,6,10,1989,5,927,1.0,659.0,659.0,5,1062,1.0,794.0,794.0
0.008,6,10,1677,5,827,2.0,559.0,559.0,5,850,2.0,582.0,582.0
0.005,6,10,1689,5,839,1.0,571.0,571.0,5,850,1.0,582.0,582.0
174.134,17,76,10931,38,2558,4706.0,44.0,39.0,38,8373,4706.0,260.0,192.0
0.044,17,2,152,1,76,0.0,48.0,48.0,1,76,0.0,48.0,48.0
0.005,17,2,169,1,62,0.0,34.0,34.0,1,107,0.0,79.0,79.0
0.087,6,10,1506,5,395,20.0,127.0,127.0,5,1111,19.0,843.0,843.0
0.142,6,10,1506,5,395,34.0,127.0,127.0,5,1111,33.0,843.0,843.0
296.154,17,112,15924,56,3730,5384.0,44.0,38.0,56,12194,5384.0,261.0,189.0
0.099,6,10,1506,5,395,22.0,127.0,127.0,5,1111,21.0,843.0,843.0
0.078,6,10,1506,5,395,17.0,127.0,127.0,5,1111,18.0,843.0,843.0
0.006,6,10,2006,5,927,1.0,659.0,659.0,5,1079,1.0,811.0,811.0
308.681,17,20,1124,10,716,34283.0,48.0,43.0,10,408,34283.0,20.0,12.0
0.169,17,2,152,1,76,0.0,48.0,48.0,1,76,0.0,48.0,48.0
15.078,17,15,8191,8,5968,2149.0,1350.0,718.0,7,2223,2508.0,1350.0,289.0
0.001,17,2,180,1,66,0.0,38.0,38.0,1,114,0.0,86.0,86.0
0.005,17,2,148,1,60,0.0,32.0,32.0,1,88,0.0,60.0,60.0
0.192,6,10,1506,5,395,44.0,127.0,127.0,5,1111,38.0,843.0,843.0
0.013,6,10,1989,5,910,3.0,642.0,642.0,5,1079,3.0,811.0,811.0
0.005,17,2,170,1,65,0.0,37.0,37.0,1,105,0.0,77.0,77.0
0.006,17,2,170,1,65,0.0,37.0,37.0,1,105,0.0,77.0,77.0
0.004,6,10,2000,5,927,1.0,659.0,659.0,5,1073,1.0,805.0,805.0
0.01,6,10,1983,5,910,2.0,642.0,642.0,5,1073,2.0,805.0,805.0
0.005,6,10,1989,5,927,1.0,659.0,659.0,5,1062,1.0,794.0,794.0
0.11,6,10,1506,5,395,24.0,127.0,127.0,5,1111,24.0,843.0,843.0
0.117,6,10,1506,5,395,24.0,127.0,127.0,5,1111,25.0,843.0,843.0
0.001,17,2,180,1,66,0.0,38.0,38.0,1,114,0.0,86.0,86.0
0.005,17,2,144,1,64,0.0,36.0,36.0,1,80,0.0,52.0,52.0
0.163,17,2,152,1,76,0.0,48.0,48.0,1,76,0.0,48.0,48.0
0.004,17,2,148,1,60,0.0,32.0,32.0,1,88,0.0,60.0,60.0
0.009,6,10,1990,5,911,2.0,643.0,643.0,5,1079,2.0,811.0,811.0
0.005,6,10,1643,5,860,1.0,592.0,592.0,5,783,1.0,515.0,515.0
11.239,17,28,4394,14,2312,856.0,587.0,137.0,14,2082,856.0,269.0,120.0
0.061,17,2,80,1,32,0.0,4.0,4.0,1,48,0.0,20.0,20.0
0.006,17,2,170,1,65,0.0,37.0,37.0,1,105,0.0,77.0,77.0
0.006,17,2,164,1,74,0.0,46.0,46.0,1,90,0.0,62.0,62.0
0.005,17,2,140,1,62,0.0,34.0,34.0,1,78,0.0,50.0,50.0
0.006,6,10,1547,5,764,1.0,496.0,496.0,5,783,1.0,515.0,515.0
0.005,6,10,2006,5,927,1.0,659.0,659.0,5,1079,1.0,811.0,811.0
0.01,6,10,1972,5,910,2.0,642.0,642.0,5,1062,2.0,794.0,794.0
0.004,6,10,1989,5,927,1.0,659.0,659.0,5,1062,1.0,794.0,794.0
0.012,6,10,1631,5,848,3.0,580.0,580.0,5,783,3.0,515.0,515.0
0.005,17,2,144,1,64,0.0,36.0,36.0,1,80,0.0,52.0,52.0
0.005,6,10,2000,5,927,1.0,659.0,659.0,5,1073,1.0,805.0,805.0
0.005,6,10,2006,5,927,1.0,659.0,659.0,5,1079,1.0,811.0,811.0
0.076,6,10,1506,5,395,17.0,127.0,127.0,5,1111,16.0,843.0,843.0
0.091,6,10,1506,5,395,21.0,127.0,127.0,5,1111,16.0,843.0,843.0
0.001,17,2,180,1,66,0.0,38.0,38.0,1,114,0.0,86.0,86.0
0.001,17,2,180,1,66,0.0,38.0,38.0,1,114,0.0,86.0,86.0
0.005,6,10,2006,5,927,1.0,659.0,659.0,5,1079,1.0,811.0,811.0
0.001,17,2,179,1,62,0.0,34.0,34.0,1,117,0.0,89.0,89.0
0.001,17,2,180,1,66,0.0,38.0,38.0,1,114,0.0,86.0,86.0
0.014,6,10,1989,5,910,3.0,642.0,642.0,5,1079,3.0,811.0,811.0
0.102,6,10,1506,5,395,23.0,127.0,127.0,5,1111,22.0,843.0,843.0
0.005,17,2,180,1,66,0.0,38.0,38.0,1,114,0.0,86.0,86.0
240.089,6,16,4481,9,963,30011.0,238.0,166.0,7,3518,40014.0,1402.0,786.0
11.006,17,28,4398,14,2313,837.0,588.0,137.0,14,2085,837.0,268.0,120.0
0.004,6,10,1779,5,928,1.0,660.0,660.0,5,851,1.0,583.0,583.0
0.008,6,10,1989,5,910,1.0,642.0,642.0,5,1079,1.0,811.0,811.0
0.006,6,10,1547,5,764,1.0,496.0,496.0,5,783,1.0,515.0,515.0
0.008,6,10,1972,5,910,2.0,642.0,642.0,5,1062,2.0,794.0,794.0
0.014,6,13,3735,7,497,2.0,125.0,125.0,6,3238,2.0,1470.0,1459.0
0.007,6,10,1547,5,764,1.0,496.0,496.0,5,783,1.0,515.0,515.0
0.07,6,10,1506,5,395,16.0,127.0,127.0,5,1111,14.0,843.0,843.0
0.009,6,10,1677,5,827,2.0,559.0,559.0,5,850,2.0,582.0,582.0
0.01,6,10,1989,5,910,2.0,642.0,642.0,5,1079,2.0,811.0,811.0
0.005,6,10,2000,5,927,1.0,659.0,659.0,5,1073,1.0,805.0,805.0
0.007,17,2,138,1,61,0.0,33.0,33.0,1,77,0.0,49.0,49.0
308.569,17,20,1124,10,716,34274.0,48.0,43.0,10,408,34273.0,20.0,12.0
0.006,6,10,1854,5,889,1.0,621.0,621.0,5,965,1.0,697.0,697.0
40.082,17,10,676,5,460,10017.0,104.0,64.0,5,216,10019.0,20.0,15.0
0.066,6,10,1506,5,395,15.0,127.0,127.0,5,1111,15.0,843.0,843.0
0.005,17,2,184,1,68,0.0,40.0,40.0,1,116,0.0,88.0,88.0
0.008,6,14,3787,7,497,1.0,125.0,125.0,7,3290,1.0,1448.0,972.0
0.04,17,2,156,1,64,0.0,36.0,36.0,1,92,0.0,64.0,64.0
292.367,6,319,343692,125,18059,2357.0,2736.0,889.0,194,325633,1514.0,2804.0,1762.0
0.015,6,10,1762,5,911,3.0,643.0,643.0,5,851,3.0,583.0,583.0
0.008,6,10,1972,5,910,2.0,642.0,642.0,5,1062,2.0,794.0,794.0
0.004,6,10,2000,5,927,1.0,659.0,659.0,5,1073,1.0,805.0,805.0
0.004,6,10,2000,5,927,1.0,659.0,659.0,5,1073,1.0,805.0,805.0
0.003,17,4,284,2,120,0.0,32.0,32.0,2,164,0.0,60.0,54.0
0.005,6,10,1989,5,927,1.0,659.0,659.0,5,1062,1.0,794.0,794.0
0.009,6,10,1990,5,911,2.0,643.0,643.0,5,1079,2.0,811.0,811.0
0.108,6,10,1506,5,395,24.0,127.0,127.0,5,1111,24.0,843.0,843.0
0.02,6,10,1990,5,911,4.0,643.0,643.0,5,1079,4.0,811.0,811.0
0.09,6,10,1506,5,395,20.0,127.0,127.0,5,1111,19.0,843.0,843.0
0.01,6,14,3787,7,497,1.0,125.0,125.0,7,3290,1.0,1448.0,972.0
0.004,17,4,284,2,120,0.0,32.0,32.0,2,164,0.0,60.0,54.0
0.006,6,10,2007,5,928,1.0,660.0,660.0,5,1079,1.0,811.0,811.0
0.129,17,2,80,1,32,0.0,4.0,4.0,1,48,0.0,20.0,20.0
0.077,6,10,1506,5,395,16.0,127.0,127.0,5,1111,17.0,843.0,843.0
0.091,6,10,1506,5,395,18.0,127.0,127.0,5,1111,21.0,843.0,843.0
0.006,6,10,1689,5,839,1.0,571.0,571.0,5,850,1.0,582.0,582.0
240.137,6,32,9584,15,7052,17152.0,2166.0,696.0,17,2532,15008.0,580.0,205.0
0.004,6,10,1989,5,927,1.0,659.0,659.0,5,1062,1.0,794.0,794.0
0.028,6,10,1605,5,388,7.0,120.0,120.0,5,1217,7.0,949.0,949.0
0.003,17,2,148,1,60,0.0,32.0,32.0,1,88,0.0,60.0,60.0
0.005,6,10,2006,5,927,1.0,659.0,659.0,5,1079,1.0,811.0,811.0
0.1,6,10,1506,5,395,17.0,127.0,127.0,5,1111,21.0,843.0,843.0
0.001,17,2,132,1,58,0.0,30.0,30.0,1,74,0.0,46.0,46.0
0.095,6,10,1506,5,395,22.0,127.0,127.0,5,1111,21.0,843.0,843.0
0.005,6,10,1643,5,860,1.0,592.0,592.0,5,783,1.0,515.0,515.0
0.004,6,10,1779,5,928,1.0,660.0,660.0,5,851,1.0,583.0,583.0
0.092,6,10,1506,5,395,20.0,127.0,127.0,5,1111,17.0,843.0,843.0
0.004,17,4,284,2,120,0.0,32.0,32.0,2,164,1.0,60.0,54.0
10.789,17,28,4422,14,1994,821.0,269.0,114.0,14,2428,821.0,587.0,145.0
0.006,6,13,3690,7,452,1.0,80.0,80.0,6,3238,1.0,1470.0,1459.0
40.07,17,10,676,5,460,10015.0,104.0,64.0,5,216,10016.0,20.0,15.0
40.06,17,10,676,5,460,10014.0,104.0,64.0,5,216,10014.0,20.0,15.0
0.004,17,4,284,2,120,0.0,32.0,32.0,2,164,0.0,60.0,54.0
0.003,17,2,148,1,60,0.0,32.0,32.0,1,88,0.0,60.0,60.0
0.005,6,10,2000,5,927,1.0,659.0,659.0,5,1073,1.0,805.0,805.0
0.087,6,10,1506,5,395,19.0,127.0,127.0,5,1111,20.0,843.0,843.0
312.337,17,20,1124,10,716,34689.0,48.0,43.0,10,408,34689.0,20.0,12.0
0.034,6,8,832,4,522,10.0,302.0,302.0,4,310,9.0,102.0,102.0
0.04,17,2,182,1,65,0.0,37.0,37.0,1,117,0.0,89.0,89.0
0.006,6,10,1547,5,764,1.0,496.0,496.0,5,783,1.0,515.0,515.0
0.005,6,10,2006,5,927,1.0,659.0,659.0,5,1079,1.0,811.0,811.0
0.023,6,10,1989,5,910,5.0,642.0,642.0,5,1079,5.0,811.0,811.0
0.01,6,10,1677,5,827,2.0,559.0,559.0,5,850,2.0,582.0,582.0
0.006,6,10,2007,5,928,1.0,660.0,660.0,5,1079,1.0,811.0,811.0
0.081,6,10,1506,5,395,19.0,127.0,127.0,5,1111,16.0,843.0,843.0
0.069,17,8,3613,4,1874,23.0,1350.0,440.0,4,1739,12.0,1350.0,406.0
0.013,6,10,2000,5,927,3.0,659.0,659.0,5,1073,3.0,805.0,805.0
0.01,6,10,1989,5,910,2.0,642.0,642.0,5,1079,2.0,811.0,811.0
0.146,6,10,1506,5,395,36.0,127.0,127.0,5,1111,34.0,843.0,843.0
174.174,17,92,13391,46,3090,3870.0,44.0,39.0,46,10301,3870.0,261.0,195.0
0.006,6,10,1854,5,889,1.0,621.0,621.0,5,965,1.0,697.0,697.0
0.005,17,2,144,1,64,0.0,36.0,36.0,1,80,0.0,52.0,52.0
0.004,6,10,1779,5,928,1.0,660.0,660.0,5,851,0.0,583.0,583.0
0.167,6,10,1506,5,395,23.0,127.0,127.0,5,1111,38.0,843.0,843.0
0.095,6,10,1506,5,395,21.0,127.0,127.0,5,1111,21.0,843.0,843.0
0.006,6,12,1698,6,863,1.0,327.0,271.0,6,835,1.0,515.0,515.0
0.005,17,2,168,1,76,0.0,48.0,48.0,1,92,0.0,64.0,64.0
0.042,17,2,186,1,61,0.0,33.0,33.0,1,125,0.0,97.0,97.0
370.969,6,22,2313,16,867,24731.0,195.0,195.0,6,1446,4644.0,419.0,398.0
0.03,6,13,3735,7,497,5.0,125.0,125.0,6,3238,6.0,1470.0,1459.0
0.005,6,10,2007,5,928,1.0,660.0,660.0,5,1079,1.0,811.0,811.0
0.014,6,10,1762,5,911,3.0,643.0,643.0,5,851,3.0,583.0,583.0
0.005,6,10,2006,5,927,1.0,659.0,659.0,5,1079,1.0,811.0,811.0
0.003,17,2,136,1,60,0.0,32.0,32.0,1,76,0.0,48.0,48.0
0.006,6,10,1547,5,764,1.0,496.0,496.0,5,783,1.0,515.0,515.0
0.206,6,16,2779,8,1397,29.0,533.0,324.0,8,1382,18.0,529.0,239.0
0.072,17,4,284,2,120,0.0,32.0,32.0,2,164,68.0,60.0,54.0
21.26,6,40,13382,20,7739,464.0,4080.0,1723.0,20,5643,1110.0,2667.0,402.0
0.005,6,10,2006,5,927,1.0,659.0,659.0,5,1079,1.0,811.0,811.0
0.039,17,2,148,1,60,0.0,32.0,32.0,1,88,0.0,60.0,60.0
0.013,6,10,1990,5,911,3.0,643.0,643.0,5,1079,3.0,811.0,811.0
0.068,6,10,1506,5,395,14.0,127.0,127.0,5,1111,14.0,843.0,843.0
0.014,6,10,1677,5,827,3.0,559.0,559.0,5,850,3.0,582.0,582.0
0.001,17,2,180,1,66,0.0,38.0,38.0,1,114,0.0,86.0,86.0
0.006,6,10,1689,5,839,1.0,571.0,571.0,5,850,1.0,582.0,582.0
0.09,6,10,1506,5,395,20.0,127.0,127.0,5,1111,19.0,843.0,843.0
0.038,17,2,412,1,61,0.0,33.0,33.0,1,351,0.0,323.0,323.0
73.596,6,1251,1252064,556,1214657,62.0,4080.0,2288.0,695,37407,105.0,1360.0,177.0
0.098,6,10,1506,5,395,21.0,127.0,127.0,5,1111,20.0,843.0,843.0
214.786,6,33,6264,18,1338,12634.0,267.0,195.0,15,4926,613.0,1823.0,392.0
0.005,6,10,2007,5,928,1.0,660.0,660.0,5,1079,1.0,811.0,811.0
40.068,17,10,676,5,460,10013.0,104.0,64.0,5,216,10015.0,20.0,15.0
0.004,17,4,284,2,120,0.0,32.0,32.0,2,164,0.0,60.0,54.0
0.005,17,2,170,1,65,0.0,37.0,37.0,1,105,0.0,77.0,77.0
0.107,6,10,1506,5,395,25.0,127.0,127.0,5,1111,22.0,843.0,843.0
0.006,6,10,2007,5,928,1.0,660.0,660.0,5,1079,1.0,811.0,811.0
0.017,6,10,1972,5,910,4.0,642.0,642.0,5,1062,4.0,794.0,794.0
0.007,6,10,2006,5,927,1.0,659.0,659.0,5,1079,1.0,811.0,811.0
0.005,6,10,1989,5,927,1.0,659.0,659.0,5,1062,1.0,794.0,794.0
0.01,6,10,1677,5,827,2.0,559.0,559.0,5,850,2.0,582.0,582.0
0.004,6,10,2006,5,927,1.0,659.0,659.0,5,1079,1.0,811.0,811.0
0.003,6,10,1702,5,863,0.0,595.0,595.0,5,839,0.0,571.0,571.0
0.009,6,10,1989,5,910,2.0,642.0,642.0,5,1079,2.0,811.0,811.0
0.022,6,10,1762,5,911,5.0,643.0,643.0,5,851,5.0,583.0,583.0
0.014,6,10,1990,5,911,3.0,643.0,643.0,5,1079,3.0,811.0,811.0
178.535,17,80,11398,40,2666,4577.0,44.0,38.0,40,8732,4577.0,239.0,190.0
0.004,6,10,1774,5,923,1.0,655.0,655.0,5,851,1.0,583.0,583.0
0.015,17,2,198,1,91,0.0,63.0,63.0,1,107,0.0,79.0,79.0
0.005,6,10,1989,5,927,1.0,659.0,659.0,5,1062,1.0,794.0,794.0
0.015,6,10,1989,5,910,3.0,642.0,642.0,5,1079,3.0,811.0,811.0
0.108,17,4,284,2,120,105.0,32.0,32.0,2,164,36.0,60.0,54.0
300.422,6,16,2170,9,684,37532.0,146.0,146.0,7,1486,50041.0,419.0,398.0
0.088,6,10,1506,5,395,20.0,127.0,127.0,5,1111,20.0,843.0,843.0
0.001,17,2,180,1,66,0.0,38.0,38.0,1,114,0.0,86.0,86.0
0.005,6,10,2006,5,927,1.0,659.0,659.0,5,1079,1.0,811.0,811.0
0.014,6,10,1989,5,910,3.0,642.0,642.0,5,1079,3.0,811.0,811.0
0.023,6,10,1990,5,911,5.0,643.0,643.0,5,1079,5.0,811.0,811.0
0.007,17,2,144,1,64,0.0,36.0,36.0,1,80,0.0,52.0,52.0
0.005,6,10,2007,5,928,1.0,660.0,660.0,5,1079,1.0,811.0,811.0
240.023,6,9,787,5,488,60005.0,232.0,232.0,4,299,80006.0,83.0,83.0
0.009,6,12,1926,6,1189,1.0,659.0,434.0,6,737,1.0,417.0,417.0
40.069,17,10,676,5,460,10016.0,104.0,64.0,5,216,10016.0,20.0,15.0
0.004,17,2,234,1,61,0.0,33.0,33.0,1,173,0.0,145.0,145.0
0.011,17,2,170,1,65,0.0,37.0,37.0,1,105,0.0,77.0,77.0
0.172,17,2,152,1,76,0.0,48.0,48.0,1,76,0.0,48.0,48.0
10.889,17,28,4419,14,1995,829.0,270.0,114.0,14,2424,829.0,587.0,145.0
0.005,6,10,2006,5,927,1.0,659.0,659.0,5,1079,1.0,811.0,811.0
0.004,17,2,148,1,60,0.0,32.0,32.0,1,88,0.0,60.0,60.0
0.148,6,10,1506,5,395,33.0,127.0,127.0,5,1111,36.0,843.0,843.0
0.214,6,23,6535,12,2065,18.0,746.0,286.0,11,4470,20.0,1324.0,778.0
1799.839,6,139,6670,76,3625,23997.0,39.0,39.0,63,3045,28541.0,35.0,35.0
0.005,6,10,2006,5,927,1.0,659.0,659.0,5,1079,1.0,811.0,811.0
0.005,6,14,3742,7,452,0.0,80.0,80.0,7,3290,0.0,1448.0,972.0
0.01,6,10,1677,5,827,2.0,559.0,559.0,5,850,2.0,582.0,582.0
11.139,17,28,4423,14,1995,844.0,270.0,114.0,14,2428,844.0,587.0,145.0
0.079,6,10,1506,5,395,19.0,127.0,127.0,5,1111,17.0,843.0,843.0
0.177,6,10,1506,5,395,40.0,127.0,127.0,5,1111,42.0,843.0,843.0
0.016,6,10,1972,5,910,3.0,642.0,642.0,5,1062,3.0,794.0,794.0
0.082,6,10,1506,5,395,19.0,127.0,127.0,5,1111,18.0,843.0,843.0
40.057,17,10,676,5,460,10013.0,104.0,64.0,5,216,10012.0,20.0,15.0
0.008,6,10,1631,5,848,2.0,580.0,580.0,5,783,2.0,515.0,515.0
0.006,6,10,1547,5,764,1.0,496.0,496.0,5,783,1.0,515.0,515.0
0.005,6,10,1547,5,764,1.0,496.0,496.0,5,783,1.0,515.0,515.0
0.095,6,10,1506,5,395,19.0,127.0,127.0,5,1111,20.0,843.0,843.0
0.01,6,10,1677,5,827,2.0,559.0,559.0,5,850,2.0,582.0,582.0
0.069,6,10,1506,5,395,15.0,127.0,127.0,5,1111,16.0,843.0,843.0
0.028,6,10,1972,5,910,7.0,642.0,642.0,5,1062,6.0,794.0,794.0
40.055,17,10,676,5,460,10012.0,104.0,64.0,5,216,10013.0,20.0,15.0
0.084,6,10,1506,5,395,20.0,127.0,127.0,5,1111,17.0,843.0,843.0
0.005,17,2,170,1,65,0.0,37.0,37.0,1,105,0.0,77.0,77.0
0.058,17,2,152,1,76,0.0,48.0,48.0,1,76,0.0,48.0,48.0
0.004,6,10,1989,5,927,1.0,659.0,659.0,5,1062,1.0,794.0,794.0
0.109,6,10,1506,5,395,24.0,127.0,127.0,5,1111,25.0,843.0,843.0
242.074,6,409,349535,196,21724,1241.0,2736.0,960.0,213,327811,1141.0,2804.0,1560.0
0.135,6,10,1506,5,395,29.0,127.0,127.0,5,1111,29.0,843.0,843.0
0.006,6,10,1774,5,923,1.0,655.0,655.0,5,851,1.0,583.0,583.0
0.041,17,2,148,1,60,0.0,32.0,32.0,1,88,0.0,60.0,60.0
0.006,17,2,222,1,65,0.0,37.0,37.0,1,157,0.0,129.0,129.0
0.09,6,10,1506,5,395,21.0,127.0,127.0,5,1111,21.0,843.0,843.0
0.009,6,7,695,4,448,3.0,232.0,232.0,3,247,3.0,83.0,83.0
177.23,17,82,11909,41,2755,4430.0,44.0,39.0,41,9154,4430.0,239.0,195.0
0.017,6,10,1990,5,911,4.0,643.0,643.0,5,1079,4.0,811.0,811.0
0.01,6,12,1926,6,1189,1.0,659.0,434.0,6,737,2.0,417.0,417.0
0.004,6,10,1702,5,863,1.0,595.0,595.0,5,839,1.0,571.0,571.0
10.833,17,28,4422,14,1993,824.0,268.0,114.0,14,2429,824.0,588.0,145.0
0.005,6,10,1643,5,860,1.0,592.0,592.0,5,783,1.0,515.0,515.0
0.019,17,2,166,1,75,0.0,47.0,47.0,1,91,0.0,63.0,63.0
40.052,17,10,676,5,460,10012.0,104.0,64.0,5,216,10012.0,20.0,15.0
0.006,17,2,424,1,72,0.0,44.0,44.0,1,352,0.0,324.0,324.0
0.005,6,10,1989,5,927,1.0,659.0,659.0,5,1062,1.0,794.0,794.0
0.001,17,2,180,1,66,0.0,38.0,38.0,1,114,0.0,86.0,86.0
0.004,6,10,2007,5,928,1.0,660.0,660.0,5,1079,1.0,811.0,811.0
0.005,6,10,1643,5,860,1.0,592.0,592.0,5,783,1.0,515.0,515.0
0.012,6,10,1972,5,910,2.0,642.0,642.0,5,1062,2.0,794.0,794.0
0.01,6,10,1983,5,910,2.0,642.0,642.0,5,1073,2.0,805.0,805.0
0.004,6,10,1989,5,927,1.0,659.0,659.0,5,1062,1.0,794.0,794.0
0.004,6,10,2006,5,927,1.0,659.0,659.0,5,1079,1.0,811.0,811.0
0.006,6,10,2000,5,927,1.0,659.0,659.0,5,1073,1.0,805.0,805.0
0.038,17,2,166,1,75,0.0,47.0,47.0,1,91,0.0,63.0,63.0
0.091,17,2,80,1,32,0.0,4.0,4.0,1,48,0.0,20.0,20.0
0.004,17,2,136,1,60,0.0,32.0,32.0,1,76,0.0,48.0,48.0
0.079,6,10,1506,5,395,16.0,127.0,127.0,5,1111,16.0,843.0,843.0
0.015,6,10,1631,5,848,3.0,580.0,580.0,5,783,3.0,515.0,515.0
0.072,6,10,1506,5,395,15.0,127.0,127.0,5,1111,16.0,843.0,843.0
0.013,6,14,3787,7,497,2.0,125.0,125.0,7,3290,2.0,1448.0,972.0
0.016,17,2,198,1,91,0.0,63.0,63.0,1,107,0.0,79.0,79.0
0.001,17,2,180,1,65,0.0,37.0,37.0,1,115,0.0,87.0,87.0
0.005,17,2,184,1,68,0.0,40.0,40.0,1,116,0.0,88.0,88.0
0.007,17,2,194,1,59,0.0,31.0,31.0,1,135,0.0,107.0,107.0
40.068,17,10,676,5,460,10015.0,104.0,64.0,5,216,10016.0,20.0,15.0
0.005,6,13,3747,7,509,0.0,137.0,137.0,6,3238,0.0,1470.0,1459.0
0.024,6,13,3735,7,497,4.0,125.0,125.0,6,3238,4.0,1470.0,1459.0
0.073,17,2,148,1,60,0.0,32.0,32.0,1,88,0.0,60.0,60.0
0.015,6,10,1990,5,911,3.0,643.0,643.0,5,1079,3.0,811.0,811.0
0.004,6,10,2007,5,928,1.0,660.0,660.0,5,1079,1.0,811.0,811.0
0.005,6,10,1547,5,764,1.0,496.0,496.0,5,783,1.0,515.0,515.0
0.005,6,10,1774,5,923,1.0,655.0,655.0,5,851,1.0,583.0,583.0
0.075,17,2,179,1,71,0.0,43.0,43.0,1,108,0.0,80.0,80.0
0.003,17,2,208,1,72,0.0,44.0,44.0,1,136,0.0,108.0,108.0
0.013,17,2,166,1,75,0.0,47.0,47.0,1,91,0.0,63.0,63.0
0.005,6,14,3736,7,446,0.0,74.0,74.0,7,3290,0.0,1448.0,972.0
0.107,6,10,1506,5,395,22.0,127.0,127.0,5,1111,24.0,843.0,843.0
0.043,17,2,144,1,64,0.0,36.0,36.0,1,80,0.0,52.0,52.0
15.077,17,16,8383,8,6106,2149.0,1350.0,735.0,8,2277,2149.0,1350.0,256.0
0.01,6,10,1677,5,827,2.0,559.0,559.0,5,850,2.0,582.0,582.0
0.005,6,10,1989,5,927,1.0,659.0,659.0,5,1062,1.0,794.0,794.0
240.097,6,16,4481,9,963,30012.0,238.0,166.0,7,3518,40015.0,1402.0,786.0
0.019,6,10,1677,5,827,4.0,559.0,559.0,5,850,4.0,582.0,582.0
0.005,17,2,170,1,65,0.0,37.0,37.0,1,105,0.0,77.0,77.0
0.106,6,10,1506,5,395,24.0,127.0,127.0,5,1111,23.0,843.0,843.0
0.015,6,10,1677,5,827,3.0,559.0,559.0,5,850,3.0,582.0,582.0
0.019,17,2,148,1,60,0.0,32.0,32.0,1,88,0.0,60.0,60.0
0.004,6,10,2000,5,927,1.0,659.0,659.0,5,1073,1.0,805.0,805.0
0.013,6,10,1983,5,910,3.0,642.0,642.0,5,1073,3.0,805.0,805.0
0.006,17,2,179,1,71,0.0,43.0,43.0,1,108,0.0,80.0,80.0
0.006,6,10,1643,5,860,1.0,592.0,592.0,5,783,1.0,515.0,515.0
0.012,6,10,1983,5,910,2.0,642.0,642.0,5,1073,3.0,805.0,805.0
0.005,6,14,3799,7,509,0.0,137.0,137.0,7,3290,0.0,1448.0,972.0
0.08,17,2,144,1,64,0.0,36.0,36.0,1,80,0.0,52.0,52.0
0.113,6,10,1506,5,395,26.0,127.0,127.0,5,1111,27.0,843.0,843.0
0.009,6,10,1677,5,827,2.0,559.0,559.0,5,850,2.0,582.0,582.0
0.012,6,10,1989,5,910,3.0,642.0,642.0,5,1079,3.0,811.0,811.0
0.091,6,10,1506,5,395,16.0,127.0,127.0,5,1111,20.0,843.0,843.0
40.08,17,10,676,5,460,10017.0,104.0,64.0,5,216,10019.0,20.0,15.0
0.005,6,10,1547,5,764,1.0,496.0,496.0,5,783,1.0,515.0,515.0
40.097,17,10,676,5,460,10022.0,104.0,64.0,5,216,10023.0,20.0,15.0
0.088,6,10,1506,5,395,19.0,127.0,127.0,5,1111,21.0,843.0,843.0
0.166,17,2,152,1,76,0.0,48.0,48.0,1,76,0.0,48.0,48.0
240.011,6,9,787,5,488,60002.0,232.0,232.0,4,299,80002.0,83.0,83.0
0.018,6,10,1990,5,911,4.0,643.0,643.0,5,1079,4.0,811.0,811.0
0.095,6,10,1506,5,395,21.0,127.0,127.0,5,1111,21.0,843.0,843.0
0.003,17,2,136,1,60,0.0,32.0,32.0,1,76,0.0,48.0,48.0
0.005,6,10,2007,5,928,1.0,660.0,660.0,5,1079,1.0,811.0,811.0
15.089,17,15,8682,8,6534,2151.0,1350.0,788.0,7,2148,2509.0,1350.0,278.0
1799.505,17,2642,202360,1311,106222,1373.0,84.0,53.0,1331,96138,1352.0,227.0,44.0
0.013,6,10,1762,5,911,3.0,643.0,643.0,5,851,3.0,583.0,583.0
0.006,6,10,1779,5,928,1.0,660.0,660.0,5,851,1.0,583.0,583.0
0.005,6,10,2000,5,927,1.0,659.0,659.0,5,1073,1.0,805.0,805.0
0.015,6,10,1972,5,910,3.0,642.0,642.0,5,1062,3.0,794.0,794.0
0.007,6,10,1547,5,764,1.0,496.0,496.0,5,783,1.0,515.0,515.0
0.166,6,10,1506,5,395,39.0,127.0,127.0,5,1111,36.0,843.0,843.0
0.001,17,2,180,1,66,0.0,38.0,38.0,1,114,0.0,86.0,86.0
0.114,6,10,1506,5,395,23.0,127.0,127.0,5,1111,24.0,843.0,843.0
0.01,6,10,1989,5,910,2.0,642.0,642.0,5,1079,2.0,811.0,811.0
0.004,17,2,136,1,60,0.0,32.0,32.0,1,76,0.0,48.0,48.0
174.149,17,76,10946,38,2534,4706.0,44.0,38.0,38,8412,4706.0,252.0,193.0
0.189,6,42,11518,22,3190,8.0,1082.0,203.0,20,8328,9.0,1402.0,606.0
0.04,17,2,412,1,61,0.0,33.0,33.0,1,351,0.0,323.0,323.0
0.01,6,10,1989,5,910,2.0,642.0,642.0,5,1079,2.0,811.0,811.0
0.06,17,2,152,1,76,0.0,48.0,48.0,1,76,0.0,48.0,48.0
44.903,6,36,8190,18,1719,527.0,651.0,322.0,18,6471,2634.0,2126.0,478.0
0.005,17,2,180,1,66,0.0,38.0,38.0,1,114,0.0,86.0,86.0
0.009,6,12,1926,6,1189,1.0,659.0,434.0,6,737,1.0,417.0,417.0
0.022,6,10,1677,5,827,5.0,559.0,559.0,5,850,5.0,582.0,582.0
0.005,6,10,2007,5,928,1.0,660.0,660.0,5,1079,1.0,811.0,811.0
0.011,6,13,3735,7,497,1.0,125.0,125.0,6,3238,2.0,1470.0,1459.0
0.004,17,2,148,1,60,0.0,32.0,32.0,1,88,0.0,60.0,60.0
0.017,6,10,1677,5,827,4.0,559.0,559.0,5,850,4.0,582.0,582.0
0.018,6,10,1989,5,910,4.0,642.0,642.0,5,1079,4.0,811.0,811.0
0.012,6,10,1989,5,910,3.0,642.0,642.0,5,1079,2.0,811.0,811.0
0.006,6,10,1854,5,889,1.0,621.0,621.0,5,965,1.0,697.0,697.0
0.018,6,10,1983,5,910,4.0,642.0,642.0,5,1073,4.0,805.0,805.0
0.039,17,2,170,1,65,0.0,37.0,37.0,1,105,0.0,77.0,77.0
0.043,17,2,152,1,76,0.0,48.0,48.0,1,76,0.0,48.0,48.0
171.444,17,92,12963,46,3067,3809.0,44.0,38.0,46,9896,3809.0,261.0,187.0
0.017,6,10,1631,5,848,4.0,580.0,580.0,5,783,4.0,515.0,515.0
40.056,17,10,676,5,460,10013.0,104.0,64.0,5,216,10013.0,20.0,15.0
0.051,6,10,1990,5,911,12.0,643.0,643.0,5,1079,12.0,811.0,811.0
1.035,6,13,3922,7,2139,129.0,1328.0,923.0,6,1783,155.0,1539.0,1539.0
0.082,17,2,136,1,60,0.0,32.0,32.0,1,76,0.0,48.0,48.0
0.006,6,10,1689,5,839,1.0,571.0,571.0,5,850,1.0,582.0,582.0
0.001,17,2,180,1,66,0.0,38.0,38.0,1,114,0.0,86.0,86.0
0.005,6,10,2000,5,927,1.0,659.0,659.0,5,1073,1.0,805.0,805.0
240.019,6,9,787,5,488,60004.0,232.0,232.0,4,299,80005.0,83.0,83.0
0.005,17,2,170,1,65,0.0,37.0,37.0,1,105,0.0,77.0,77.0
0.006,6,10,1689,5,839,1.0,571.0,571.0,5,850,1.0,582.0,582.0
0.084,6,10,1506,5,395,16.0,127.0,127.0,5,1111,16.0,843.0,843.0
0.003,17,2,148,1,60,0.0,32.0,32.0,1,88,0.0,60.0,60.0
0.06,6,10,1506,5,395,13.0,127.0,127.0,5,1111,14.0,843.0,843.0
0.015,6,13,3735,7,497,2.0,125.0,125.0,6,3238,3.0,1470.0,1459.0
0.015,6,10,1762,5,911,3.0,643.0,643.0,5,851,3.0,583.0,583.0
240.269,6,43,5419,19,2373,13348.0,588.0,196.0,24,3046,10446.0,580.0,219.0
0.007,6,10,1547,5,764,1.0,496.0,496.0,5,783,1.0,515.0,515.0
0.101,6,10,1506,5,395,23.0,127.0,127.0,5,1111,20.0,843.0,843.0
0.011,6,10,1972,5,910,2.0,642.0,642.0,5,1062,2.0,794.0,794.0
40.077,17,10,676,5,460,10016.0,104.0,64.0,5,216,10018.0,20.0,15.0
0.006,6,12,1698,6,863,1.0,327.0,271.0,6,835,1.0,515.0,515.0
0.105,6,10,1506,5,395,23.0,127.0,127.0,5,1111,21.0,843.0,843.0
0.009,6,12,1926,6,1189,1.0,659.0,434.0,6,737,1.0,417.0,417.0
0.003,17,2,148,1,60,0.0,32.0,32.0,1,88,0.0,60.0,60.0
0.101,6,10,1506,5,395,21.0,127.0,127.0,5,1111,24.0,843.0,843.0
0.005,17,2,166,1,75,0.0,47.0,47.0,1,91,0.0,63.0,63.0
0.007,6,10,1547,5,764,1.0,496.0,496.0,5,783,1.0,515.0,515.0
0.004,6,10,1779,5,928,1.0,660.0,660.0,5,851,1.0,583.0,583.0
0.006,6,10,1547,5,764,1.0,496.0,496.0,5,783,1.0,515.0,515.0
240.09,6,16,4481,9,963,30011.0,238.0,166.0,7,3518,40014.0,1402.0,786.0
0.01,6,10,1972,5,910,2.0,642.0,642.0,5,1062,2.0,794.0,794.0
0.101,6,10,1506,5,395,24.0,127.0,127.0,5,1111,23.0,843.0,843.0
0.005,6,10,2000,5,927,1.0,659.0,659.0,5,1073,1.0,805.0,805.0
0.006,6,13,3747,7,509,0.0,137.0,137.0,6,3238,1.0,1470.0,1459.0
335.773,17,20,1124,10,716,37296.0,48.0,43.0,10,408,37295.0,20.0,12.0
0.105,6,10,1506,5,395,20.0,127.0,127.0,5,1111,23.0,843.0,843.0
294.899,6,322,343938,127,18155,2340.0,2736.0,888.0,195,325783,1520.0,2804.0,1743.0
0.005,17,2,136,1,60,0.0,32.0,32.0,1,76,0.0,48.0,48.0
308.237,17,20,1124,10,716,34242.0,48.0,43.0,10,408,34242.0,20.0,12.0
240.086,6,16,4481,9,963,30010.0,238.0,166.0,7,3518,40013.0,1402.0,786.0
0.001,17,2,180,1,66,0.0,38.0,38.0,1,114,0.0,86.0,86.0
0.004,6,10,2000,5,927,1.0,659.0,659.0,5,1073,1.0,805.0,805.0
0.007,6,10,1762,5,911,1.0,643.0,643.0,5,851,1.0,583.0,583.0
0.031,6,10,1631,5,848,7.0,580.0,580.0,5,783,7.0,515.0,515.0
0.156,6,10,1506,5,395,35.0,127.0,127.0,5,1111,37.0,843.0,843.0
0.016,17,2,198,1,91,0.0,63.0,63.0,1,107,0.0,79.0,79.0
0.006,6,14,3736,7,446,1.0,74.0,74.0,7,3290,0.0,1448.0,972.0
0.009,6,10,2006,5,927,2.0,659.0,659.0,5,1079,2.0,811.0,811.0
0.006,6,10,1547,5,764,1.0,496.0,496.0,5,783,1.0,515.0,515.0
0.075,6,10,1506,5,395,15.0,127.0,127.0,5,1111,16.0,843.0,843.0
0.092,6,10,1506,5,395,19.0,127.0,127.0,5,1111,20.0,843.0,843.0
0.103,6,10,1506,5,395,22.0,127.0,127.0,5,1111,22.0,843.0,843.0
0.014,6,10,1989,5,910,3.0,642.0,642.0,5,1079,3.0,811.0,811.0
0.005,17,2,194,1,59,0.0,31.0,31.0,1,135,0.0,107.0,107.0
40.098,17,10,676,5,460,10023.0,104.0,64.0,5,216,10022.0,20.0,15.0
240.055,6,9,787,5,488,60013.0,232.0,232.0,4,299,80011.0,83.0,83.0
0.004,6,10,2006,5,927,1.0,659.0,659.0,5,1079,1.0,811.0,811.0
0.004,6,10,1702,5,863,1.0,595.0,595.0,5,839,1.0,571.0,571.0
0.071,6,10,1506,5,395,16.0,127.0,127.0,5,1111,14.0,843.0,843.0
0.016,6,10,1989,5,910,3.0,642.0,642.0,5,1079,4.0,811.0,811.0
0.005,6,13,3747,7,509,0.0,137.0,137.0,6,3238,1.0,1470.0,1459.0
0.012,17,2,178,1,65,0.0,37.0,37.0,1,113,0.0,85.0,85.0
0.012,6,10,1990,5,911,3.0,643.0,643.0,5,1079,2.0,811.0,811.0
0.005,6,10,1689,5,839,1.0,571.0,571.0,5,850,1.0,582.0,582.0
0.015,6,10,1990,5,911,3.0,643.0,643.0,5,1079,3.0,811.0,811.0
0.016,17,2,198,1,91,0.0,63.0,63.0,1,107,0.0,79.0,79.0
0.067,6,10,1506,5,395,16.0,127.0,127.0,5,1111,12.0,843.0,843.0
0.004,6,10,1702,5,863,1.0,595.0,595.0,5,839,1.0,571.0,571.0
0.118,6,10,1506,5,395,24.0,127.0,127.0,5,1111,26.0,843.0,843.0
0.075,6,10,1506,5,395,17.0,127.0,127.0,5,1111,16.0,843.0,843.0
114.916,6,21,8112,11,1953,91.0,1174.0,493.0,10,6159,12748.0,1791.0,957.0
0.005,17,2,166,1,75,0.0,47.0,47.0,1,91,0.0,63.0,63.0
0.081,6,10,1506,5,395,16.0,127.0,127.0,5,1111,18.0,843.0,843.0
0.007,6,10,2000,5,927,1.0,659.0,659.0,5,1073,1.0,805.0,805.0
0.013,6,10,1677,5,827,3.0,559.0,559.0,5,850,3.0,582.0,582.0
0.009,6,10,1989,5,910,2.0,642.0,642.0,5,1079,2.0,811.0,811.0
40.048,17,10,676,5,460,10011.0,104.0,64.0,5,216,10011.0,20.0,15.0
0.006,6,10,1547,5,764,1.0,496.0,496.0,5,783,1.0,515.0,515.0
10.916,17,28,4423,14,1994,831.0,269.0,114.0,14,2429,831.0,588.0,145.0
0.034,6,10,1989,5,910,8.0,642.0,642.0,5,1079,8.0,811.0,811.0
0.079,6,10,1506,5,395,18.0,127.0,127.0,5,1111,15.0,843.0,843.0
0.118,6,10,1506,5,395,24.0,127.0,127.0,5,1111,26.0,843.0,843.0
0.166,17,2,152,1,76,0.0,48.0,48.0,1,76,0.0,48.0,48.0
0.012,6,10,1983,5,910,3.0,642.0,642.0,5,1073,2.0,805.0,805.0
0.005,6,10,2007,5,928,1.0,660.0,660.0,5,1079,1.0,811.0,811.0
0.096,6,10,1506,5,395,19.0,127.0,127.0,5,1111,22.0,843.0,843.0
0.039,17,2,152,1,76,0.0,48.0,48.0,1,76,0.0,48.0,48.0
0.01,6,10,1990,5,911,2.0,643.0,643.0,5,1079,2.0,811.0,811.0
10.804,17,26,4099,13,1847,891.0,270.0,114.0,13,2252,891.0,587.0,145.0
0.024,6,10,1983,5,910,5.0,642.0,642.0,5,1073,5.0,805.0,805.0
0.012,6,10,1983,5,910,3.0,642.0,642.0,5,1073,3.0,805.0,805.0
0.004,6,10,2000,5,927,1.0,659.0,659.0,5,1073,1.0,805.0,805.0
240.016,6,9,787,5,488,60004.0,232.0,232.0,4,299,80004.0,83.0,83.0
300.39,6,16,2170,9,684,37528.0,146.0,146.0,7,1486,50037.0,419.0,398.0
0.011,6,10,1989,5,910,2.0,642.0,642.0,5,1079,2.0,811.0,811.0
40.061,17,10,676,5,460,10012.0,104.0,64.0,5,216,10014.0,20.0,15.0
65.881,6,22,10152,12,3985,5989.0,1591.0,838.0,10,6167,7301.0,2225.0,939.0
0.004,17,2,136,1,60,0.0,32.0,32.0,1,76,0.0,48.0,48.0
0.005,6,10,2007,5,928,1.0,660.0,660.0,5,1079,1.0,811.0,811.0
0.005,6,10,1643,5,860,1.0,592.0,592.0,5,783,1.0,515.0,515.0
0.123,17,2,170,1,65,0.0,37.0,37.0,1,105,0.0,77.0,77.0
0.007,17,2,213,1,69,0.0,41.0,41.0,1,144,0.0,116.0,116.0
0.011,6,10,1631,5,848,2.0,580.0,580.0,5,783,2.0,515.0,515.0
0.084,6,10,1506,5,395,18.0,127.0,127.0,5,1111,19.0,843.0,843.0
0.076,6,10,1506,5,395,15.0,127.0,127.0,5,1111,17.0,843.0,843.0
0.004,6,10,2006,5,927,1.0,659.0,659.0,5,1079,1.0,811.0,811.0
0.012,6,10,1989,5,910,3.0,642.0,642.0,5,1079,3.0,811.0,811.0
0.001,17,2,180,1,66,0.0,38.0,38.0,1,114,0.0,86.0,86.0
0.001,17,2,180,1,66,0.0,38.0,38.0,1,114,0.0,86.0,86.0
0.004,6,14,3799,7,509,0.0,137.0,137.0,7,3290,0.0,1448.0,972.0
0.005,6,10,1774,5,923,1.0,655.0,655.0,5,851,1.0,583.0,583.0
0.005,6,10,1774,5,923,1.0,655.0,655.0,5,851,1.0,583.0,583.0
0.005,6,10,2006,5,927,1.0,659.0,659.0,5,1079,1.0,811.0,811.0
0.014,6,10,1990,5,911,3.0,643.0,643.0,5,1079,3.0,811.0,811.0
0.005,17,2,164,1,74,0.0,46.0,46.0,1,90,0.0,62.0,62.0
0.013,6,10,1972,5,910,3.0,642.0,642.0,5,1062,3.0,794.0,794.0
0.001,17,2,180,1,66,0.0,38.0,38.0,1,114,0.0,86.0,86.0
0.005,6,10,1989,5,927,1.0,659.0,659.0,5,1062,1.0,794.0,794.0
315.817,17,20,1124,10,716,35076.0,48.0,43.0,10,408,35078.0,20.0,12.0
0.007,6,10,1643,5,860,1.0,592.0,592.0,5,783,1.0,515.0,515.0
40.052,17,10,676,5,460,10012.0,104.0,64.0,5,216,10012.0,20.0,15.0
0.001,17,2,180,1,66,0.0,38.0,38.0,1,114,0.0,86.0,86.0
0.008,6,10,1989,5,910,2.0,642.0,642.0,5,1079,2.0,811.0,811.0
0.005,17,2,182,1,65,0.0,37.0,37.0,1,117,0.0,89.0,89.0
0.111,6,10,1506,5,395,25.0,127.0,127.0,5,1111,25.0,843.0,843.0
1778.939,17,144,45504,72,22752,25055.0,288.0,288.0,72,22752,25055.0,288.0,288.0
0.136,6,10,1506,5,395,26.0,127.0,127.0,5,1111,27.0,843.0,843.0
0.096,6,10,1506,5,395,17.0,127.0,127.0,5,1111,23.0,843.0,843.0
0.075,6,10,1506,5,395,18.0,127.0,127.0,5,1111,16.0,843.0,843.0
0.009,6,14,3787,7,497,1.0,125.0,125.0,7,3290,1.0,1448.0,972.0
0.074,6,10,1506,5,395,17.0,127.0,127.0,5,1111,15.0,843.0,843.0
0.004,6,10,1702,5,863,1.0,595.0,595.0,5,839,1.0,571.0,571.0
0.037,6,10,1677,5,827,9.0,559.0,559.0,5,850,9.0,582.0,582.0
11.182,17,28,4422,14,1994,847.0,269.0,114.0,14,2428,847.0,587.0,145.0
0.082,6,10,1506,5,395,19.0,127.0,127.0,5,1111,17.0,843.0,843.0
0.011,6,10,1972,5,910,2.0,642.0,642.0,5,1062,2.0,794.0,794.0
40.096,17,10,676,5,460,10021.0,104.0,64.0,5,216,10023.0,20.0,15.0
0.007,6,10,1972,5,910,1.0,642.0,642.0,5,1062,1.0,794.0,794.0
0.008,6,10,1989,5,910,2.0,642.0,642.0,5,1079,1.0,811.0,811.0
0.012,6,10,1989,5,910,3.0,642.0,642.0,5,1079,3.0,811.0,811.0
0.098,6,10,1506,5,395,22.0,127.0,127.0,5,1111,19.0,843.0,843.0
0.014,6,10,1983,5,910,3.0,642.0,642.0,5,1073,3.0,805.0,805.0
0.005,17,2,214,1,75,0.0,47.0,47.0,1,139,0.0,111.0,111.0
0.004,6,10,2006,5,927,1.0,659.0,659.0,5,1079,1.0,811.0,811.0
0.016,6,10,1631,5,848,4.0,580.0,580.0,5,783,4.0,515.0,515.0
0.031,6,10,1990,5,911,7.0,643.0,643.0,5,1079,7.0,811.0,811.0
0.121,6,10,1506,5,395,26.0,127.0,127.0,5,1111,25.0,843.0,843.0
0.005,6,10,2000,5,927,1.0,659.0,659.0,5,1073,1.0,805.0,805.0
0.003,17,2,208,1,72,0.0,44.0,44.0,1,136,0.0,108.0,108.0
0.004,6,13,3690,7,452,0.0,80.0,80.0,6,3238,0.0,1470.0,1459.0
0.004,6,10,2000,5,927,1.0,659.0,659.0,5,1073,1.0,805.0,805.0
0.005,17,2,144,1,64,0.0,36.0,36.0,1,80,0.0,52.0,52.0
0.003,17,4,284,2,120,0.0,32.0,32.0,2,164,0.0,60.0,54.0
0.116,6,10,1506,5,395,25.0,127.0,127.0,5,1111,23.0,843.0,843.0
0.091,6,10,1506,5,395,21.0,127.0,127.0,5,1111,18.0,843.0,843.0
0.013,17,2,164,1,74,0.0,46.0,46.0,1,90,0.0,62.0,62.0
0.072,6,10,1506,5,395,15.0,127.0,127.0,5,1111,16.0,843.0,843.0
1770.63,17,120,11460,60,5460,30010.0,63.0,63.0,60,6000,30010.0,72.0,72.0
0.01,6,10,1677,5,827,2.0,559.0,559.0,5,850,2.0,582.0,582.0
0.088,6,10,1506,5,395,19.0,127.0,127.0,5,1111,20.0,843.0,843.0
40.081,17,10,676,5,460,10018.0,104.0,64.0,5,216,10019.0,20.0,15.0
0.005,6,10,1774,5,923,1.0,655.0,655.0,5,851,1.0,583.0,583.0
0.004,6,10,2000,5,927,1.0,659.0,659.0,5,1073,1.0,805.0,805.0
0.005,17,2,140,1,62,0.0,34.0,34.0,1,78,0.0,50.0,50.0
0.001,17,2,180,1,66,0.0,38.0,38.0,1,114,0.0,86.0,86.0
40.048,17,10,676,5,460,10011.0,104.0,64.0,5,216,10011.0,20.0,15.0
0.006,6,10,1547,5,764,1.0,496.0,496.0,5,783,1.0,515.0,515.0
0.04,17,4,284,2,120,0.0,32.0,32.0,2,164,36.0,60.0,54.0
0.005,6,10,2007,5,928,1.0,660.0,660.0,5,1079,1.0,811.0,811.0
0.004,6,10,1989,5,927,1.0,659.0,659.0,5,1062,1.0,794.0,794.0
0.096,6,10,1506,5,395,23.0,127.0,127.0,5,1111,20.0,843.0,843.0
0.004,6,10,1779,5,928,1.0,660.0,660.0,5,851,1.0,583.0,583.0
0.006,17,2,160,1,72,0.0,44.0,44.0,1,88,0.0,60.0,60.0
40.083,17,10,676,5,460,10019.0,104.0,64.0,5,216,10020.0,20.0,15.0
0.006,6,10,1547,5,764,1.0,496.0,496.0,5,783,1.0,515.0,515.0
0.018,6,10,1990,5,911,4.0,643.0,643.0,5,1079,4.0,811.0,811.0
0.006,17,2,144,1,64,0.0,36.0,36.0,1,80,0.0,52.0,52.0
0.004,17,2,148,1,60,0.0,32.0,32.0,1,88,0.0,60.0,60.0
40.057,17,10,676,5,460,10013.0,104.0,64.0,5,216,10013.0,20.0,15.0
0.005,17,2,170,1,65,0.0,37.0,37.0,1,105,0.0,77.0,77.0
0.006,6,10,1779,5,928,1.0,660.0,660.0,5,851,1.0,583.0,583.0
0.014,6,10,1989,5,910,3.0,642.0,642.0,5,1079,3.0,811.0,811.0
0.009,6,12,1926,6,1189,1.0,659.0,434.0,6,737,1.0,417.0,417.0
361.825,6,21,1792,16,1030,24121.0,190.0,190.0,5,762,60009.0,461.0,247.0
0.164,17,2,152,1,76,0.0,48.0,48.0,1,76,0.0,48.0,48.0
0.07,6,10,1506,5,395,16.0,127.0,127.0,5,1111,14.0,843.0,843.0
0.006,6,10,1547,5,764,1.0,496.0,496.0,5,783,1.0,515.0,515.0
0.005,17,2,230,1,68,0.0,40.0,40.0,1,162,0.0,134.0,134.0
1.046,6,12,3134,6,2099,157.0,1328.0,923.0,6,1035,157.0,791.0,791.0
0.151,6,10,1506,5,395,36.0,127.0,127.0,5,1111,36.0,843.0,843.0
0.014,6,10,1989,5,910,3.0,642.0,642.0,5,1079,3.0,811.0,811.0
0.081,6,10,1506,5,395,18.0,127.0,127.0,5,1111,18.0,843.0,843.0
351.99,6,20,2210,6,1308,12003.0,494.0,494.0,14,902,27075.0,83.0,83.0
0.072,17,2,184,1,61,0.0,33.0,33.0,1,123,0.0,95.0,95.0
0.006,6,10,1547,5,764,1.0,496.0,496.0,5,783,1.0,515.0,515.0
0.069,6,10,1506,5,395,15.0,127.0,127.0,5,1111,14.0,843.0,843.0
0.005,6,10,2000,5,927,1.0,659.0,659.0,5,1073,1.0,805.0,805.0
0.008,6,10,1547,5,764,1.0,496.0,496.0,5,783,2.0,515.0,515.0
0.012,6,10,1972,5,910,3.0,642.0,642.0,5,1062,3.0,794.0,794.0
0.087,6,10,1506,5,395,18.0,127.0,127.0,5,1111,19.0,843.0,843.0
240.126,6,44,6777,21,3171,12006.0,588.0,230.0,23,3606,10914.0,580.0,240.0
0.176,6,46,11685,25,3304,7.0,1021.0,182.0,21,8381,8.0,1402.0,606.0
0.009,6,10,1972,5,910,2.0,642.0,642.0,5,1062,2.0,794.0,794.0
0.072,6,10,1506,5,395,15.0,127.0,127.0,5,1111,13.0,843.0,843.0
0.01,6,10,1989,5,910,2.0,642.0,642.0,5,1079,2.0,811.0,811.0
0.1,6,10,1506,5,395,23.0,127.0,127.0,5,1111,23.0,843.0,843.0
0.01,6,10,1990,5,911,2.0,643.0,643.0,5,1079,2.0,811.0,811.0
0.015,6,10,1983,5,910,3.0,642.0,642.0,5,1073,3.0,805.0,805.0
0.101,6,10,1506,5,395,21.0,127.0,127.0,5,1111,23.0,843.0,843.0
0.008,6,10,1972,5,910,1.0,642.0,642.0,5,1062,2.0,794.0,794.0
40.064,17,10,676,5,460,10013.0,104.0,64.0,5,216,10015.0,20.0,15.0
0.006,17,2,170,1,65,0.0,37.0,37.0,1,105,0.0,77.0,77.0
0.094,6,10,1506,5,395,19.0,127.0,127.0,5,1111,18.0,843.0,843.0
0.123,6,10,1506,5,395,28.0,127.0,127.0,5,1111,29.0,843.0,843.0
0.007,6,10,1547,5,764,1.0,496.0,496.0,5,783,1.0,515.0,515.0
0.018,6,10,1989,5,910,4.0,642.0,642.0,5,1079,4.0,811.0,811.0
0.003,17,2,148,1,60,0.0,32.0,32.0,1,88,0.0,60.0,60.0
0.067,6,10,1506,5,395,16.0,127.0,127.0,5,1111,12.0,843.0,843.0
0.088,6,10,1506,5,395,19.0,127.0,127.0,5,1111,17.0,843.0,843.0
0.079,6,10,1506,5,395,16.0,127.0,127.0,5,1111,17.0,843.0,843.0
0.019,6,10,1972,5,910,4.0,642.0,642.0,5,1062,4.0,794.0,794.0
0.007,17,2,299,1,65,0.0,37.0,37.0,1,234,0.0,206.0,206.0
0.017,17,2,170,1,65,0.0,37.0,37.0,1,105,0.0,77.0,77.0
0.01,6,10,1990,5,911,2.0,643.0,643.0,5,1079,2.0,811.0,811.0
0.041,17,2,166,1,75,0.0,47.0,47.0,1,91,0.0,63.0,63.0
0.006,6,10,1547,5,764,1.0,496.0,496.0,5,783,1.0,515.0,515.0
0.01,6,10,1989,5,910,2.0,642.0,642.0,5,1079,2.0,811.0,811.0
0.004,17,4,284,2,120,1.0,32.0,32.0,2,164,1.0,60.0,54.0
0.005,6,10,1689,5,839,1.0,571.0,571.0,5,850,1.0,582.0,582.0
0.006,17,2,213,1,69,0.0,41.0,41.0,1,144,0.0,116.0,116.0
0.088,6,10,1506,5,395,18.0,127.0,127.0,5,1111,20.0,843.0,843.0
0.362,17,52,34461,30,28486,12.0,1350.0,921.0,22,5975,14.0,1350.0,243.0
0.01,17,2,194,1,59,0.0,31.0,31.0,1,135,0.0,107.0,107.0
0.01,6,10,1989,5,910,2.0,642.0,642.0,5,1079,2.0,811.0,811.0
0.005,6,10,1779,5,928,1.0,660.0,660.0,5,851,1.0,583.0,583.0
0.015,6,10,1990,5,911,3.0,643.0,643.0,5,1079,3.0,811.0,811.0
15.071,17,15,9238,8,6902,2149.0,1350.0,834.0,7,2336,2507.0,1350.0,305.0
0.17,6,3,453,2,321,170.0,241.0,241.0,1,132,0.0,92.0,92.0
0.014,6,10,1972,5,910,3.0,642.0,642.0,5,1062,3.0,794.0,794.0
0.097,6,10,1506,5,395,21.0,127.0,127.0,5,1111,16.0,843.0,843.0
1789.217,6,65,7413,43,4537,42600.0,1402.0,104.0,22,2876,85192.0,1112.0,82.0
65.791,6,22,10162,12,3995,5981.0,1601.0,840.0,10,6167,7291.0,2111.0,939.0
0.118,6,10,1506,5,395,26.0,127.0,127.0,5,1111,27.0,843.0,843.0
0.011,6,10,1972,5,910,2.0,642.0,642.0,5,1062,2.0,794.0,794.0
0.006,6,10,1547,5,764,1.0,496.0,496.0,5,783,1.0,515.0,515.0
0.014,17,4,284,2,120,0.0,32.0,32.0,2,164,0.0,60.0,54.0
0.085,6,10,1506,5,395,19.0,127.0,127.0,5,1111,19.0,843.0,843.0
0.015,17,2,198,1,91,0.0,63.0,63.0,1,107,0.0,79.0,79.0
0.089,6,10,1506,5,395,21.0,127.0,127.0,5,1111,21.0,843.0,843.0
0.066,6,10,1506,5,395,15.0,127.0,127.0,5,1111,16.0,843.0,843.0
0.011,6,10,1989,5,910,2.0,642.0,642.0,5,1079,2.0,811.0,811.0
0.04,17,2,170,1,65,0.0,37.0,37.0,1,105,0.0,77.0,77.0
0.004,17,2,136,1,60,0.0,32.0,32.0,1,76,0.0,48.0,48.0
0.011,6,10,1990,5,911,2.0,643.0,643.0,5,1079,2.0,811.0,811.0
0.005,6,10,1689,5,839,1.0,571.0,571.0,5,850,1.0,582.0,582.0
0.004,6,10,1774,5,923,1.0,655.0,655.0,5,851,1.0,583.0,583.0
24.886,6,58,32238,30,26091,324.0,2720.0,1657.0,28,6147,915.0,2667.0,385.0
0.011,6,10,1990,5,911,2.0,643.0,643.0,5,1079,2.0,811.0,811.0
0.013,6,10,1990,5,911,3.0,643.0,643.0,5,1079,3.0,811.0,811.0
0.037,17,2,182,1,65,0.0,37.0,37.0,1,117,0.0,89.0,89.0
0.169,17,2,152,1,76,0.0,48.0,48.0,1,76,0.0,48.0,48.0
0.009,6,10,1972,5,910,2.0,642.0,642.0,5,1062,2.0,794.0,794.0
0.009,6,14,3787,7,497,1.0,125.0,125.0,7,3290,1.0,1448.0,972.0
0.005,6,10,2000,5,927,1.0,659.0,659.0,5,1073,1.0,805.0,805.0
0.005,17,2,144,1,64,0.0,36.0,36.0,1,80,0.0,52.0,52.0
354.03,6,21,1795,16,1030,23602.0,190.0,190.0,5,765,60002.0,464.0,248.0
0.006,6,10,1547,5,764,1.0,496.0,496.0,5,783,1.0,515.0,515.0
0.011,6,10,1972,5,910,2.0,642.0,642.0,5,1062,2.0,794.0,794.0
0.12,6,10,1506,5,395,26.0,127.0,127.0,5,1111,25.0,843.0,843.0
175.429,17,78,10969,39,2600,4616.0,44.0,38.0,39,8369,4616.0,239.0,186.0
0.215,17,4,352,2,130,143.0,37.0,37.0,2,222,176.0,89.0,83.0
0.004,17,2,136,1,60,0.0,32.0,32.0,1,76,0.0,48.0,48.0
0.037,17,2,170,1,65,0.0,37.0,37.0,1,105,0.0,77.0,77.0
0.105,6,10,1506,5,395,21.0,127.0,127.0,5,1111,23.0,843.0,843.0
367.029,6,22,2313,16,867,24468.0,195.0,195.0,6,1446,4635.0,419.0,398.0
0.038,17,2,412,1,61,0.0,33.0,33.0,1,351,0.0,323.0,323.0
281.687,6,26,6286,12,1266,25607.0,267.0,156.0,14,5020,21666.0,1400.0,742.0
0.005,6,10,1689,5,839,1.0,571.0,571.0,5,850,1.0,582.0,582.0
0.074,6,10,1506,5,395,15.0,127.0,127.0,5,1111,16.0,843.0,843.0
0.011,6,10,1990,5,911,2.0,643.0,643.0,5,1079,2.0,811.0,811.0
0.014,6,10,1983,5,910,3.0,642.0,642.0,5,1073,3.0,805.0,805.0
0.014,6,10,1972,5,910,3.0,642.0,642.0,5,1062,3.0,794.0,794.0
0.01,6,13,3735,7,497,1.0,125.0,125.0,6,3238,2.0,1470.0,1459.0
0.001,17,2,136,1,60,0.0,32.0,32.0,1,76,0.0,48.0,48.0
0.01,6,10,1989,5,910,2.0,642.0,642.0,5,1079,2.0,811.0,811.0
0.005,6,10,1643,5,860,1.0,592.0,592.0,5,783,1.0,515.0,515.0
0.013,6,10,1631,5,848,3.0,580.0,580.0,5,783,3.0,515.0,515.0
0.005,6,10,1547,5,764,1.0,496.0,496.0,5,783,1.0,515.0,515.0
0.005,6,10,2006,5,927,1.0,659.0,659.0,5,1079,1.0,811.0,811.0
0.006,17,2,146,1,65,0.0,37.0,37.0,1,81,0.0,53.0,53.0
361.771,6,21,1805,16,1042,24118.0,190.0,190.0,5,763,60009.0,462.0,247.0
0.01,6,10,1972,5,910,2.0,642.0,642.0,5,1062,2.0,794.0,794.0
0.005,6,10,2006,5,927,1.0,659.0,659.0,5,1079,1.0,811.0,811.0
40.061,17,10,676,5,460,10012.0,104.0,64.0,5,216,10014.0,20.0,15.0
0.109,6,10,1506,5,395,24.0,127.0,127.0,5,1111,25.0,843.0,843.0
0.005,6,10,1989,5,927,1.0,659.0,659.0,5,1062,1.0,794.0,794.0
0.021,6,10,1972,5,910,5.0,642.0,642.0,5,1062,5.0,794.0,794.0
0.01,6,10,1989,5,910,2.0,642.0,642.0,5,1079,2.0,811.0,811.0
0.015,6,10,1972,5,910,3.0,642.0,642.0,5,1062,3.0,794.0,794.0
0.013,6,10,1762,5,911,3.0,643.0,643.0,5,851,3.0,583.0,583.0
0.004,17,2,152,1,76,0.0,48.0,48.0,1,76,0.0,48.0,48.0
0.006,17,2,170,1,65,0.0,37.0,37.0,1,105,0.0,77.0,77.0
0.001,17,2,180,1,66,0.0,38.0,38.0,1,114,0.0,86.0,86.0
0.005,17,2,146,1,65,0.0,37.0,37.0,1,81,0.0,53.0,53.0
0.005,6,10,2006,5,927,1.0,659.0,659.0,5,1079,1.0,811.0,811.0
0.085,6,10,1506,5,395,18.0,127.0,127.0,5,1111,17.0,843.0,843.0
0.005,6,10,2007,5,928,1.0,660.0,660.0,5,1079,1.0,811.0,811.0
0.084,6,10,1506,5,395,18.0,127.0,127.0,5,1111,19.0,843.0,843.0
319.673,17,20,1124,10,716,35512.0,48.0,43.0,10,408,35512.0,20.0,12.0
0.008,6,10,1677,5,827,2.0,559.0,559.0,5,850,1.0,582.0,582.0
0.089,6,10,1506,5,395,18.0,127.0,127.0,5,1111,18.0,843.0,843.0
40.044,17,10,676,5,460,10010.0,104.0,64.0,5,216,10010.0,20.0,15.0
0.004,6,10,1702,5,863,1.0,595.0,595.0,5,839,1.0,571.0,571.0
0.006,6,10,1643,5,860,1.0,592.0,592.0,5,783,1.0,515.0,515.0
0.013,6,10,1972,5,910,3.0,642.0,642.0,5,1062,3.0,794.0,794.0
0.089,6,10,1506,5,395,20.0,127.0,127.0,5,1111,17.0,843.0,843.0
0.004,17,2,170,1,65,0.0,37.0,37.0,1,105,0.0,77.0,77.0
0.011,6,10,1762,5,911,2.0,643.0,643.0,5,851,2.0,583.0,583.0
0.28,17,16,9596,8,6969,40.0,1350.0,843.0,8,2627,25.0,1350.0,300.0
0.08,6,10,1506,5,395,16.0,127.0,127.0,5,1111,19.0,843.0,843.0
0.013,6,10,1990,5,911,3.0,643.0,643.0,5,1079,3.0,811.0,811.0
0.013,6,10,1989,5,910,3.0,642.0,642.0,5,1079,3.0,811.0,811.0
0.012,6,10,1983,5,910,3.0,642.0,642.0,5,1073,3.0,805.0,805.0
0.014,6,10,1972,5,910,3.0,642.0,642.0,5,1062,3.0,794.0,794.0
0.084,6,10,1506,5,395,18.0,127.0,127.0,5,1111,18.0,843.0,843.0
0.095,6,10,1506,5,395,20.0,127.0,127.0,5,1111,20.0,843.0,843.0
0.009,6,10,1762,5,911,2.0,643.0,643.0,5,851,2.0,583.0,583.0
0.005,17,2,179,1,71,0.0,43.0,43.0,1,108,0.0,80.0,80.0
0.014,6,10,1631,5,848,3.0,580.0,580.0,5,783,3.0,515.0,515.0
0.005,6,10,1989,5,927,1.0,659.0,659.0,5,1062,1.0,794.0,794.0
0.006,6,10,1547,5,764,1.0,496.0,496.0,5,783,1.0,515.0,515.0
0.005,17,2,170,1,65,0.0,37.0,37.0,1,105,0.0,77.0,77.0
300.368,6,16,2170,9,684,37525.0,146.0,146.0,7,1486,50033.0,419.0,398.0
0.066,6,10,1506,5,395,15.0,127.0,127.0,5,1111,14.0,843.0,843.0
0.05,17,2,184,1,61,0.0,33.0,33.0,1,123,0.0,95.0,95.0
0.003,17,2,136,1,60,0.0,32.0,32.0,1,76,0.0,48.0,48.0
0.024,6,10,1989,5,910,6.0,642.0,642.0,5,1079,6.0,811.0,811.0
0.013,6,13,3735,7,497,2.0,125.0,125.0,6,3238,2.0,1470.0,1459.0
0.009,6,10,1989,5,910,2.0,642.0,642.0,5,1079,2.0,811.0,811.0
15.229,17,18,8598,9,6398,1898.0,1350.0,682.0,9,2200,1900.0,1350.0,216.0
615.848,6,40,13466,19,4091,34213.0,676.0,442.0,21,9375,27791.0,1402.0,636.0
0.105,6,10,1506,5,395,24.0,127.0,127.0,5,1111,23.0,843.0,843.0
40.056,17,10,676,5,460,10013.0,104.0,64.0,5,216,10013.0,20.0,15.0
0.006,6,10,1989,5,927,1.0,659.0,659.0,5,1062,1.0,794.0,794.0
0.006,6,10,2000,5,927,1.0,659.0,659.0,5,1073,1.0,805.0,805.0
308.474,17,20,1124,10,716,34268.0,48.0,43.0,10,408,34266.0,20.0,12.0
0.005,6,10,2006,5,927,1.0,659.0,659.0,5,1079,1.0,811.0,811.0
0.015,6,10,1989,5,910,3.0,642.0,642.0,5,1079,3.0,811.0,811.0
0.204,6,10,1506,5,395,43.0,127.0,127.0,5,1111,36.0,843.0,843.0
0.005,17,2,214,1,75,0.0,47.0,47.0,1,139,0.0,111.0,111.0
0.087,6,10,1506,5,395,17.0,127.0,127.0,5,1111,20.0,843.0,843.0
0.04,17,2,182,1,65,0.0,37.0,37.0,1,117,0.0,89.0,89.0
0.205,6,16,2669,8,1395,29.0,533.0,323.0,8,1274,18.0,529.0,212.0
0.005,6,13,3747,7,509,0.0,137.0,137.0,6,3238,0.0,1470.0,1459.0
10.783,17,24,3781,12,1673,970.0,268.0,111.0,12,2108,970.0,587.0,147.0
0.005,17,2,164,1,74,0.0,46.0,46.0,1,90,0.0,62.0,62.0
0.006,17,2,164,1,74,0.0,46.0,46.0,1,90,0.0,62.0,62.0
0.005,6,10,1547,5,764,1.0,496.0,496.0,5,783,1.0,515.0,515.0
0.109,6,10,1506,5,395,25.0,127.0,127.0,5,1111,25.0,843.0,843.0
0.169,17,2,152,1,76,0.0,48.0,48.0,1,76,0.0,48.0,48.0
0.075,6,10,1506,5,395,16.0,127.0,127.0,5,1111,15.0,843.0,843.0
10.905,17,28,4421,14,1993,830.0,268.0,114.0,14,2428,830.0,587.0,145.0
0.01,6,10,1631,5,848,2.0,580.0,580.0,5,783,2.0,515.0,515.0
0.054,6,10,1506,5,395,11.0,127.0,127.0,5,1111,12.0,843.0,843.0
0.01,6,10,1972,5,910,2.0,642.0,642.0,5,1062,2.0,794.0,794.0
309.064,17,20,1124,10,716,34326.0,48.0,43.0,10,408,34326.0,20.0,12.0
0.015,6,10,1990,5,911,3.0,643.0,643.0,5,1079,3.0,811.0,811.0
0.168,17,2,152,1,76,0.0,48.0,48.0,1,76,0.0,48.0,48.0
0.006,6,10,1547,5,764,1.0,496.0,496.0,5,783,1.0,515.0,515.0
0.072,17,4,284,2,120,0.0,32.0,32.0,2,164,68.0,60.0,54.0
0.006,17,2,170,1,65,0.0,37.0,37.0,1,105,0.0,77.0,77.0
0.003,17,4,284,2,120,0.0,32.0,32.0,2,164,0.0,60.0,54.0
0.003,17,2,136,1,60,0.0,32.0,32.0,1,76,0.0,48.0,48.0
0.002,17,2,136,1,60,0.0,32.0,32.0,1,76,0.0,48.0,48.0
0.005,6,10,1989,5,927,1.0,659.0,659.0,5,1062,1.0,794.0,794.0
0.073,6,10,1506,5,395,15.0,127.0,127.0,5,1111,16.0,843.0,843.0
0.005,6,10,2007,5,928,1.0,660.0,660.0,5,1079,1.0,811.0,811.0
0.001,17,2,180,1,65,0.0,37.0,37.0,1,115,0.0,87.0,87.0
40.064,17,10,676,5,460,10011.0,104.0,64.0,5,216,10014.0,20.0,15.0
0.009,6,10,1972,5,910,2.0,642.0,642.0,5,1062,2.0,794.0,794.0
26.984,6,10,1195,6,586,5396.0,266.0,266.0,4,609,8983.0,393.0,393.0
0.004,6,10,2000,5,927,1.0,659.0,659.0,5,1073,1.0,805.0,805.0
0.091,6,10,1506,5,395,20.0,127.0,127.0,5,1111,20.0,843.0,843.0
0.005,6,10,2007,5,928,1.0,660.0,660.0,5,1079,1.0,811.0,811.0
0.015,6,10,1989,5,910,3.0,642.0,642.0,5,1079,3.0,811.0,811.0
0.09,6,10,1506,5,395,21.0,127.0,127.0,5,1111,18.0,843.0,843.0
0.13,6,10,1506,5,395,28.0,127.0,127.0,5,1111,26.0,843.0,843.0
178.171,17,76,10706,38,2529,4814.0,44.0,38.0,38,8177,4815.0,261.0,187.0
0.011,6,10,1989,5,910,2.0,642.0,642.0,5,1079,2.0,811.0,811.0
0.005,6,10,2006,5,927,1.0,659.0,659.0,5,1079,1.0,811.0,811.0
0.011,6,12,1926,6,1189,2.0,659.0,434.0,6,737,2.0,417.0,417.0
0.008,6,10,1983,5,910,2.0,642.0,642.0,5,1073,1.0,805.0,805.0
0.005,17,2,180,1,66,0.0,38.0,38.0,1,114,0.0,86.0,86.0
0.04,17,2,152,1,76,0.0,48.0,48.0,1,76,0.0,48.0,48.0
0.012,6,10,1983,5,910,3.0,642.0,642.0,5,1073,3.0,805.0,805.0
0.038,17,2,144,1,64,0.0,36.0,36.0,1,80,0.0,52.0,52.0
40.057,17,10,676,5,460,10011.0,104.0,64.0,5,216,10013.0,20.0,15.0
0.069,17,8,3613,4,1874,23.0,1350.0,440.0,4,1739,11.0,1350.0,406.0
0.081,6,10,1506,5,395,17.0,127.0,127.0,5,1111,18.0,843.0,843.0
0.014,6,10,1972,5,910,3.0,642.0,642.0,5,1062,3.0,794.0,794.0
0.005,6,10,1689,5,839,1.0,571.0,571.0,5,850,1.0,582.0,582.0
0.004,17,2,148,1,60,0.0,32.0,32.0,1,88,0.0,60.0,60.0
40.059,17,10,676,5,460,10014.0,104.0,64.0,5,216,10014.0,20.0,15.0
0.001,17,2,180,1,66,0.0,38.0,38.0,1,114,0.0,86.0,86.0
292.258,6,382,348100,189,21396,1554.0,2736.0,889.0,193,326704,1522.0,2804.0,1769.0
0.003,17,2,136,1,60,0.0,32.0,32.0,1,76,0.0,48.0,48.0
0.011,6,10,1990,5,911,2.0,643.0,643.0,5,1079,2.0,811.0,811.0
377.454,17,120,17347,60,4003,6397.0,44.0,38.0,60,13344,6397.0,261.0,194.0
0.007,6,13,3735,7,497,1.0,125.0,125.0,6,3238,1.0,1470.0,1459.0
0.005,6,10,2000,5,927,1.0,659.0,659.0,5,1073,1.0,805.0,805.0
0.005,6,10,2006,5,927,1.0,659.0,659.0,5,1079,1.0,811.0,811.0
0.021,6,10,1972,5,910,5.0,642.0,642.0,5,1062,5.0,794.0,794.0
0.015,6,10,1631,5,848,3.0,580.0,580.0,5,783,3.0,515.0,515.0
0.006,6,10,1547,5,764,1.0,496.0,496.0,5,783,1.0,515.0,515.0
0.004,17,4,284,2,120,0.0,32.0,32.0,2,164,1.0,60.0,54.0
40.088,17,10,676,5,460,10020.0,104.0,64.0,5,216,10019.0,20.0,15.0
0.008,6,10,1989,5,910,2.0,642.0,642.0,5,1079,2.0,811.0,811.0
0.006,6,10,1854,5,889,1.0,621.0,621.0,5,965,1.0,697.0,697.0
0.004,17,4,284,2,120,0.0,32.0,32.0,2,164,1.0,60.0,54.0
0.059,6,10,1506,5,395,13.0,127.0,127.0,5,1111,13.0,843.0,843.0
0.089,6,10,1506,5,395,21.0,127.0,127.0,5,1111,19.0,843.0,843.0
0.013,6,10,1990,5,911,3.0,643.0,643.0,5,1079,3.0,811.0,811.0
0.007,6,10,1983,5,910,1.0,642.0,642.0,5,1073,1.0,805.0,805.0
0.001,17,2,180,1,66,0.0,38.0,38.0,1,114,0.0,86.0,86.0
0.039,6,10,1972,5,910,9.0,642.0,642.0,5,1062,9.0,794.0,794.0
0.015,6,10,1677,5,827,3.0,559.0,559.0,5,850,3.0,582.0,582.0
0.114,6,10,1506,5,395,24.0,127.0,127.0,5,1111,27.0,843.0,843.0
0.005,6,10,2007,5,928,1.0,660.0,660.0,5,1079,1.0,811.0,811.0
0.008,17,2,179,1,71,0.0,43.0,43.0,1,108,0.0,80.0,80.0
240.124,6,32,9383,16,6972,16008.0,2045.0,682.0,16,2411,16007.0,580.0,196.0
0.039,17,2,170,1,65,0.0,37.0,37.0,1,105,0.0,77.0,77.0
0.007,6,10,1983,5,910,1.0,642.0,642.0,5,1073,1.0,805.0,805.0
0.093,6,10,1506,5,395,20.0,127.0,127.0,5,1111,16.0,843.0,843.0
308.41,17,18,1008,9,640,38534.0,48.0,43.0,9,368,38534.0,20.0,12.0
0.009,6,12,1926,6,1189,1.0,659.0,434.0,6,737,1.0,417.0,417.0
0.01,6,10,1631,5,848,2.0,580.0,580.0,5,783,2.0,515.0,515.0
0.015,6,10,1989,5,910,3.0,642.0,642.0,5,1079,3.0,811.0,811.0
0.005,6,10,2007,5,928,1.0,660.0,660.0,5,1079,1.0,811.0,811.0
0.001,17,2,180,1,66,0.0,38.0,38.0,1,114,0.0,86.0,86.0
40.062,17,10,676,5,460,10014.0,104.0,64.0,5,216,10014.0,20.0,15.0
0.079,6,10,1506,5,395,17.0,127.0,127.0,5,1111,18.0,843.0,843.0
0.005,6,10,1989,5,927,1.0,659.0,659.0,5,1062,1.0,794.0,794.0
0.071,17,4,364,2,160,0.0,52.0,52.0,2,204,0.0,80.0,74.0
0.014,6,14,3787,7,497,2.0,125.0,125.0,7,3290,2.0,1448.0,972.0
0.005,6,10,1854,5,889,1.0,621.0,621.0,5,965,1.0,697.0,697.0
240.092,6,16,4481,9,963,30011.0,238.0,166.0,7,3518,40014.0,1402.0,786.0
0.004,6,10,1774,5,923,1.0,655.0,655.0,5,851,1.0,583.0,583.0
0.019,6,10,1983,5,910,4.0,642.0,642.0,5,1073,4.0,805.0,805.0
0.005,6,10,1779,5,928,1.0,660.0,660.0,5,851,1.0,583.0,583.0
0.005,6,10,1989,5,927,1.0,659.0,659.0,5,1062,1.0,794.0,794.0
0.008,6,10,1989,5,910,1.0,642.0,642.0,5,1079,1.0,811.0,811.0
60.154,6,80,77676,37,4718,1670.0,1402.0,696.0,43,72958,1431.0,2804.0,1813.0
167.223,17,82,11999,41,2763,4180.0,44.0,39.0,41,9236,4180.0,239.0,197.0
0.121,6,10,1506,5,395,24.0,127.0,127.0,5,1111,27.0,843.0,843.0
0.006,6,10,1643,5,860,1.0,592.0,592.0,5,783,1.0,515.0,515.0
353.43,6,20,2210,6,1308,12014.0,494.0,494.0,14,902,27186.0,83.0,83.0
0.099,6,10,1506,5,395,23.0,127.0,127.0,5,1111,23.0,843.0,843.0
0.006,6,10,1547,5,764,1.0,496.0,496.0,5,783,1.0,515.0,515.0
0.006,6,10,1547,5,764,1.0,496.0,496.0,5,783,1.0,515.0,515.0
0.005,6,10,2000,5,927,1.0,659.0,659.0,5,1073,1.0,805.0,805.0
0.004,6,10,1702,5,863,1.0,595.0,595.0,5,839,0.0,571.0,571.0
0.005,17,2,194,1,59,0.0,31.0,31.0,1,135,0.0,107.0,107.0
0.001,17,2,194,1,57,0.0,29.0,29.0,1,137,0.0,109.0,109.0
0.1,6,10,1506,5,395,22.0,127.0,127.0,5,1111,23.0,843.0,843.0
0.001,17,2,180,1,66,0.0,38.0,38.0,1,114,0.0,86.0,86.0
0.012,6,10,1989,5,910,3.0,642.0,642.0,5,1079,3.0,811.0,811.0
911.332,6,247,36427,141,19241,6509.0,613.0,194.0,106,17186,8679.0,453.0,149.0
40.059,17,10,676,5,460,10011.0,104.0,64.0,5,216,10013.0,20.0,15.0
0.005,17,4,284,2,120,0.0,32.0,32.0,2,164,1.0,60.0,54.0
40.085,17,10,676,5,460,10019.0,104.0,64.0,5,216,10020.0,20.0,15.0
0.019,6,13,3735,7,497,3.0,125.0,125.0,6,3238,3.0,1470.0,1459.0
0.005,6,10,2007,5,928,1.0,660.0,660.0,5,1079,1.0,811.0,811.0
0.004,6,14,3736,7,446,0.0,74.0,74.0,7,3290,0.0,1448.0,972.0
1787.339,6,150,19350,90,13740,20082.0,302.0,302.0,60,5610,30293.0,83.0,83.0
0.014,6,10,1990,5,911,3.0,643.0,643.0,5,1079,3.0,811.0,811.0
0.004,17,2,148,1,60,0.0,32.0,32.0,1,88,0.0,60.0,60.0
0.012,6,10,1677,5,827,2.0,559.0,559.0,5,850,3.0,582.0,582.0
0.229,6,16,2670,8,1396,32.0,533.0,324.0,8,1274,21.0,529.0,212.0
0.004,17,2,148,1,60,0.0,32.0,32.0,1,88,0.0,60.0,60.0
0.007,17,2,179,1,71,0.0,43.0,43.0,1,108,0.0,80.0,80.0
0.005,6,10,1689,5,839,1.0,571.0,571.0,5,850,1.0,582.0,582.0
0.161,6,10,1506,5,395,36.0,127.0,127.0,5,1111,37.0,843.0,843.0
360.03,6,21,3981,13,3142,30002.0,494.0,494.0,8,839,51432.0,83.0,83.0
240.129,6,36,26711,19,17601,13340.0,2736.0,1661.0,17,9110,15007.0,2728.0,1174.0
0.006,6,10,1547,5,764,1.0,496.0,496.0,5,783,1.0,515.0,515.0
0.001,17,2,180,1,66,0.0,38.0,38.0,1,114,0.0,86.0,86.0
0.009,6,13,3735,7,497,1.0,125.0,125.0,6,3238,1.0,1470.0,1459.0
295.568,6,393,348469,196,21753,1515.0,2736.0,888.0,197,326716,1507.0,2804.0,1729.0
0.006,17,2,307,1,61,0.0,33.0,33.0,1,246,0.0,218.0,218.0
0.057,6,10,1506,5,395,12.0,127.0,127.0,5,1111,13.0,843.0,843.0
0.007,6,13,3747,7,509,1.0,137.0,137.0,6,3238,1.0,1470.0,1459.0
0.01,6,10,1989,5,910,2.0,642.0,642.0,5,1079,2.0,811.0,811.0
40.062,17,10,676,5,460,10013.0,104.0,64.0,5,216,10014.0,20.0,15.0
0.004,17,2,148,1,60,0.0,32.0,32.0,1,88,0.0,60.0,60.0
0.098,6,10,1506,5,395,22.0,127.0,127.0,5,1111,24.0,843.0,843.0
0.014,6,10,1989,5,927,3.0,659.0,659.0,5,1062,3.0,794.0,794.0
0.085,6,10,1506,5,395,18.0,127.0,127.0,5,1111,17.0,843.0,843.0
15.075,17,15,9238,8,6902,2148.0,1350.0,834.0,7,2336,2507.0,1350.0,305.0
285.261,6,30,6574,16,1433,19017.0,517.0,290.0,14,5141,21943.0,2379.0,1104.0
40.063,17,10,676,5,460,10015.0,104.0,64.0,5,216,10015.0,20.0,15.0
0.008,6,10,1989,5,910,2.0,642.0,642.0,5,1079,2.0,811.0,811.0
0.005,17,2,160,1,72,0.0,44.0,44.0,1,88,0.0,60.0,60.0
0.012,6,10,1989,5,910,3.0,642.0,642.0,5,1079,3.0,811.0,811.0
0.004,6,10,1779,5,928,1.0,660.0,660.0,5,851,0.0,583.0,583.0
0.11,6,10,1506,5,395,25.0,127.0,127.0,5,1111,25.0,843.0,843.0
0.054,17,2,152,1,76,0.0,48.0,48.0,1,76,0.0,48.0,48.0
0.006,6,10,2006,5,927,1.0,659.0,659.0,5,1079,1.0,811.0,811.0
0.005,6,10,1547,5,764,1.0,496.0,496.0,5,783,1.0,515.0,515.0
0.013,6,10,1990,5,911,3.0,643.0,643.0,5,1079,3.0,811.0,811.0
0.009,6,10,1989,5,910,2.0,642.0,642.0,5,1079,2.0,811.0,811.0
0.04,17,4,284,2,120,0.0,32.0,32.0,2,164,37.0,60.0,54.0
0.013,6,10,1989,5,910,3.0,642.0,642.0,5,1079,3.0,811.0,811.0
0.007,6,10,1989,5,927,1.0,659.0,659.0,5,1062,1.0,794.0,794.0
0.003,17,2,136,1,60,0.0,32.0,32.0,1,76,0.0,48.0,48.0
0.114,6,10,1506,5,395,25.0,127.0,127.0,5,1111,25.0,843.0,843.0
0.011,6,13,3735,7,497,1.0,125.0,125.0,6,3238,2.0,1470.0,1459.0
0.016,6,10,1989,5,910,3.0,642.0,642.0,5,1079,3.0,811.0,811.0
0.126,6,10,1506,5,395,27.0,127.0,127.0,5,1111,27.0,843.0,843.0
240.096,6,16,4481,9,963,30012.0,238.0,166.0,7,3518,40015.0,1402.0,786.0
0.004,6,10,2006,5,927,1.0,659.0,659.0,5,1079,1.0,811.0,811.0
0.004,6,10,1989,5,927,1.0,659.0,659.0,5,1062,1.0,794.0,794.0
0.006,6,10,1989,5,927,1.0,659.0,659.0,5,1062,1.0,794.0,794.0
0.003,17,2,148,1,60,0.0,32.0,32.0,1,88,0.0,60.0,60.0
0.004,17,2,136,1,60,0.0,32.0,32.0,1,76,0.0,48.0,48.0
0.005,6,10,2007,5,928,1.0,660.0,660.0,5,1079,1.0,811.0,811.0
0.005,6,10,1989,5,927,1.0,659.0,659.0,5,1062,1.0,794.0,794.0
0.087,6,10,1506,5,395,19.0,127.0,127.0,5,1111,18.0,843.0,843.0
0.087,6,10,1506,5,395,19.0,127.0,127.0,5,1111,19.0,843.0,843.0
0.004,6,10,1989,5,927,1.0,659.0,659.0,5,1062,1.0,794.0,794.0
0.009,6,10,1972,5,910,2.0,642.0,642.0,5,1062,2.0,794.0,794.0
0.005,6,10,2006,5,927,1.0,659.0,659.0,5,1079,1.0,811.0,811.0
0.005,6,10,1854,5,889,1.0,621.0,621.0,5,965,1.0,697.0,697.0
0.121,6,10,1506,5,395,25.0,127.0,127.0,5,1111,26.0,843.0,843.0
40.076,17,10,676,5,460,10014.0,104.0,64.0,5,216,10018.0,20.0,15.0
127.646,6,23,8535,12,2236,79.0,1345.0,574.0,11,6299,12747.0,2720.0,974.0
0.005,6,10,2000,5,927,1.0,659.0,659.0,5,1073,1.0,805.0,805.0
0.013,17,2,152,1,56,0.0,28.0,28.0,1,96,0.0,68.0,68.0
0.005,6,10,1989,5,927,1.0,659.0,659.0,5,1062,1.0,794.0,794.0
0.005,6,10,2000,5,927,1.0,659.0,659.0,5,1073,1.0,805.0,805.0
0.001,17,2,180,1,66,0.0,38.0,38.0,1,114,0.0,86.0,86.0
0.003,17,4,420,2,122,0.0,33.0,33.0,2,298,0.0,145.0,121.0
0.005,17,2,136,1,60,0.0,32.0,32.0,1,76,0.0,48.0,48.0
0.005,6,10,1989,5,927,1.0,659.0,659.0,5,1062,1.0,794.0,794.0
0.001,17,2,180,1,66,0.0,38.0,38.0,1,114,0.0,86.0,86.0
0.13,6,10,1506,5,395,29.0,127.0,127.0,5,1111,28.0,843.0,843.0
0.075,6,10,1506,5,395,17.0,127.0,127.0,5,1111,16.0,843.0,843.0
0.009,17,2,169,1,62,0.0,34.0,34.0,1,107,0.0,79.0,79.0
0.011,6,10,1989,5,910,2.0,642.0,642.0,5,1079,2.0,811.0,811.0
0.007,6,10,1854,5,889,1.0,621.0,621.0,5,965,1.0,697.0,697.0
0.009,6,10,1983,5,910,2.0,642.0,642.0,5,1073,2.0,805.0,805.0
0.08,6,10,1506,5,395,17.0,127.0,127.0,5,1111,17.0,843.0,843.0
40.086,17,10,676,5,460,10020.0,104.0,64.0,5,216,10020.0,20.0,15.0
0.212,6,10,1506,5,395,48.0,127.0,127.0,5,1111,51.0,843.0,843.0
0.005,6,14,3736,7,446,0.0,74.0,74.0,7,3290,0.0,1448.0,972.0
0.006,6,10,1689,5,839,1.0,571.0,571.0,5,850,1.0,582.0,582.0
0.082,6,10,1506,5,395,19.0,127.0,127.0,5,1111,19.0,843.0,843.0
0.161,6,10,1506,5,395,38.0,127.0,127.0,5,1111,39.0,843.0,843.0
66.23,6,27,17903,15,9958,4730.0,2804.0,1528.0,12,7945,6005.0,2316.0,1218.0
0.009,6,10,1989,5,910,2.0,642.0,642.0,5,1079,2.0,811.0,811.0
0.006,17,2,179,1,71,0.0,43.0,43.0,1,108,0.0,80.0,80.0
1.154,6,13,3929,7,2138,144.0,1328.0,923.0,6,1791,174.0,1539.0,1539.0
0.004,17,2,136,1,60,0.0,32.0,32.0,1,76,0.0,48.0,48.0
0.005,6,13,3747,7,509,0.0,137.0,137.0,6,3238,1.0,1470.0,1459.0
0.011,6,10,1972,5,910,2.0,642.0,642.0,5,1062,2.0,794.0,794.0
0.011,6,10,1677,5,827,2.0,559.0,559.0,5,850,2.0,582.0,582.0
0.005,6,10,1643,5,860,1.0,592.0,592.0,5,783,1.0,515.0,515.0
0.029,17,4,284,2,120,0.0,32.0,32.0,2,164,1.0,60.0,54.0
368.94,6,22,2313,16,867,24596.0,195.0,195.0,6,1446,4638.0,419.0,398.0
0.016,6,10,1762,5,911,3.0,643.0,643.0,5,851,3.0,583.0,583.0
0.02,6,10,1983,5,910,4.0,642.0,642.0,5,1073,5.0,805.0,805.0
0.005,17,2,169,1,62,0.0,34.0,34.0,1,107,0.0,79.0,79.0
0.089,6,10,1506,5,395,20.0,127.0,127.0,5,1111,20.0,843.0,843.0
0.133,6,10,1506,5,395,31.0,127.0,127.0,5,1111,29.0,843.0,843.0
0.005,6,10,2006,5,927,1.0,659.0,659.0,5,1079,1.0,811.0,811.0
1770.67,6,89,4755,45,2394,40241.0,27.0,27.0,44,2361,41177.0,26.0,24.0
0.181,17,4,352,2,130,144.0,37.0,37.0,2,222,141.0,89.0,83.0
0.038,17,2,136,1,60,0.0,32.0,32.0,1,76,0.0,48.0,48.0
0.009,6,10,1983,5,910,2.0,642.0,642.0,5,1073,2.0,805.0,805.0
0.012,6,10,1989,5,910,2.0,642.0,642.0,5,1079,3.0,811.0,811.0
0.068,17,8,3613,4,1874,22.0,1350.0,440.0,4,1739,11.0,1350.0,406.0
0.003,17,2,185,1,73,0.0,45.0,45.0,1,112,0.0,84.0,84.0
0.006,17,2,175,1,65,0.0,37.0,37.0,1,110,0.0,82.0,82.0
0.006,6,10,1854,5,889,1.0,621.0,621.0,5,965,1.0,697.0,697.0
0.004,6,10,1989,5,927,1.0,659.0,659.0,5,1062,1.0,794.0,794.0
0.004,17,2,136,1,60,0.0,32.0,32.0,1,76,0.0,48.0,48.0
0.015,6,10,1983,5,910,3.0,642.0,642.0,5,1073,3.0,805.0,805.0
0.004,17,2,234,1,61,0.0,33.0,33.0,1,173,0.0,145.0,145.0
0.005,6,14,3799,7,509,0.0,137.0,137.0,7,3290,0.0,1448.0,972.0
369.835,6,22,2313,16,867,24655.0,195.0,195.0,6,1446,4643.0,419.0,398.0
0.001,17,2,180,1,66,0.0,38.0,38.0,1,114,0.0,86.0,86.0
0.023,6,10,1989,5,910,5.0,642.0,642.0,5,1079,5.0,811.0,811.0
0.006,17,2,170,1,65,0.0,37.0,37.0,1,105,0.0,77.0,77.0
0.083,6,10,1506,5,395,18.0,127.0,127.0,5,1111,19.0,843.0,843.0
0.001,17,2,180,1,66,0.0,38.0,38.0,1,114,0.0,86.0,86.0
0.005,6,10,2006,5,927,1.0,659.0,659.0,5,1079,1.0,811.0,811.0
0.005,6,10,1774,5,923,1.0,655.0,655.0,5,851,1.0,583.0,583.0
0.046,6,10,1989,5,910,11.0,642.0,642.0,5,1079,11.0,811.0,811.0
0.006,17,2,214,1,75,0.0,47.0,47.0,1,139,0.0,111.0,111.0
0.005,6,10,2006,5,927,1.0,659.0,659.0,5,1079,1.0,811.0,811.0
10.872,17,28,4422,14,1994,827.0,269.0,114.0,14,2428,827.0,587.0,145.0
0.005,17,2,293,1,73,0.0,45.0,45.0,1,220,0.0,192.0,192.0
0.004,17,2,156,1,64,0.0,36.0,36.0,1,92,0.0,64.0,64.0
0.005,17,2,238,1,66,0.0,38.0,38.0,1,172,0.0,144.0,144.0
0.005,6,10,1547,5,764,1.0,496.0,496.0,5,783,1.0,515.0,515.0
0.009,6,10,1762,5,911,2.0,643.0,643.0,5,851,2.0,583.0,583.0
0.013,6,10,1972,5,910,3.0,642.0,642.0,5,1062,3.0,794.0,794.0
0.006,6,10,1854,5,889,1.0,621.0,621.0,5,965,1.0,697.0,697.0
0.004,6,10,1989,5,927,1.0,659.0,659.0,5,1062,1.0,794.0,794.0
0.001,17,2,154,1,69,0.0,41.0,41.0,1,85,0.0,57.0,57.0
0.013,6,10,1972,5,910,3.0,642.0,642.0,5,1062,3.0,794.0,794.0
294.856,6,308,343876,122,17905,2436.0,2736.0,889.0,186,325971,1593.0,2804.0,1838.0
0.066,17,4,352,2,130,3.0,37.0,37.0,2,222,36.0,89.0,83.0
0.006,17,2,164,1,74,0.0,46.0,46.0,1,90,0.0,62.0,62.0
300.993,6,47,15363,25,9407,12541.0,2720.0,1045.0,22,5956,419.0,2667.0,361.0
0.132,6,10,1506,5,395,30.0,127.0,127.0,5,1111,29.0,843.0,843.0
0.077,6,10,1506,5,395,16.0,127.0,127.0,5,1111,16.0,843.0,843.0
0.004,17,2,148,1,60,0.0,32.0,32.0,1,88,0.0,60.0,60.0
0.006,6,10,1547,5,764,1.0,496.0,496.0,5,783,1.0,515.0,515.0
0.005,17,2,170,1,65,0.0,37.0,37.0,1,105,0.0,77.0,77.0
0.005,6,10,1643,5,860,1.0,592.0,592.0,5,783,1.0,515.0,515.0
0.073,6,10,1506,5,395,15.0,127.0,127.0,5,1111,17.0,843.0,843.0
0.01,6,14,3799,7,509,1.0,137.0,137.0,7,3290,1.0,1448.0,972.0
0.004,6,10,1774,5,923,1.0,655.0,655.0,5,851,1.0,583.0,583.0
0.008,6,12,1926,6,1189,1.0,659.0,434.0,6,737,1.0,417.0,417.0
0.005,6,10,1774,5,923,1.0,655.0,655.0,5,851,1.0,583.0,583.0
0.015,6,10,1989,5,910,3.0,642.0,642.0,5,1079,3.0,811.0,811.0
0.07,6,10,1506,5,395,16.0,127.0,127.0,5,1111,14.0,843.0,843.0
0.09,6,10,1506,5,395,20.0,127.0,127.0,5,1111,19.0,843.0,843.0
0.143,6,10,1506,5,395,32.0,127.0,127.0,5,1111,31.0,843.0,843.0
0.014,6,10,1677,5,827,3.0,559.0,559.0,5,850,3.0,582.0,582.0
0.011,6,12,1926,6,1189,2.0,659.0,434.0,6,737,2.0,417.0,417.0
0.006,6,10,1854,5,889,1.0,621.0,621.0,5,965,1.0,697.0,697.0
0.018,6,10,1990,5,911,4.0,643.0,643.0,5,1079,4.0,811.0,811.0
0.014,6,10,1762,5,911,3.0,643.0,643.0,5,851,3.0,583.0,583.0
0.004,6,10,1779,5,928,1.0,660.0,660.0,5,851,1.0,583.0,583.0
0.004,6,10,2006,5,927,1.0,659.0,659.0,5,1079,1.0,811.0,811.0
0.003,17,2,148,1,60,0.0,32.0,32.0,1,88,0.0,60.0,60.0
0.075,6,10,1506,5,395,15.0,127.0,127.0,5,1111,16.0,843.0,843.0
0.014,6,10,1990,5,911,3.0,643.0,643.0,5,1079,3.0,811.0,811.0
0.074,17,8,3613,4,1874,24.0,1350.0,440.0,4,1739,12.0,1350.0,406.0
0.009,6,10,1989,5,910,2.0,642.0,642.0,5,1079,2.0,811.0,811.0
0.004,17,2,148,1,60,0.0,32.0,32.0,1,88,0.0,60.0,60.0
0.005,6,10,1547,5,764,1.0,496.0,496.0,5,783,1.0,515.0,515.0
0.085,6,10,1506,5,395,17.0,127.0,127.0,5,1111,19.0,843.0,843.0
0.005,6,10,1854,5,889,1.0,621.0,621.0,5,965,1.0,697.0,697.0
0.004,6,10,1702,5,863,1.0,595.0,595.0,5,839,1.0,571.0,571.0
0.012,6,10,1990,5,911,3.0,643.0,643.0,5,1079,2.0,811.0,811.0
0.004,6,10,1989,5,927,1.0,659.0,659.0,5,1062,1.0,794.0,794.0
0.001,17,2,132,1,58,0.0,30.0,30.0,1,74,0.0,46.0,46.0
0.012,6,10,1989,5,910,2.0,642.0,642.0,5,1079,3.0,811.0,811.0
40.059,17,10,676,5,460,10014.0,104.0,64.0,5,216,10013.0,20.0,15.0
1778.902,17,143,41496,72,22752,25054.0,288.0,288.0,71,18744,25412.0,236.0,236.0
0.005,17,2,170,1,65,0.0,37.0,37.0,1,105,0.0,77.0,77.0
0.096,6,10,1506,5,395,21.0,127.0,127.0,5,1111,21.0,843.0,843.0
0.126,17,2,136,1,60,0.0,32.0,32.0,1,76,0.0,48.0,48.0
353.381,6,20,2210,6,1308,12003.0,494.0,494.0,14,902,27182.0,83.0,83.0
0.005,6,10,1989,5,927,1.0,659.0,659.0,5,1062,1.0,794.0,794.0
328.599,17,20,1124,10,716,36497.0,48.0,43.0,10,408,36497.0,20.0,12.0
240.162,6,37,4867,17,2267,15010.0,588.0,196.0,20,2600,12639.0,580.0,194.0
0.015,6,10,1989,5,910,3.0,642.0,642.0,5,1079,3.0,811.0,811.0
0.005,17,2,162,1,73,0.0,45.0,45.0,1,89,0.0,61.0,61.0
0.079,6,10,1506,5,395,18.0,127.0,127.0,5,1111,17.0,843.0,843.0
0.004,17,2,136,1,60,0.0,32.0,32.0,1,76,0.0,48.0,48.0
0.085,6,10,1506,5,395,18.0,127.0,127.0,5,1111,20.0,843.0,843.0
0.005,6,10,2000,5,927,1.0,659.0,659.0,5,1073,1.0,805.0,805.0
0.005,6,10,2006,5,927,1.0,659.0,659.0,5,1079,1.0,811.0,811.0
0.005,17,2,170,1,65,0.0,37.0,37.0,1,105,0.0,77.0,77.0
0.011,6,10,1983,5,910,2.0,642.0,642.0,5,1073,2.0,805.0,805.0
0.008,6,10,1972,5,910,2.0,642.0,642.0,5,1062,2.0,794.0,794.0
0.042,17,4,284,2,120,0.0,32.0,32.0,2,164,39.0,60.0,54.0
0.006,6,10,1547,5,764,1.0,496.0,496.0,5,783,1.0,515.0,515.0
0.082,6,10,1506,5,395,19.0,127.0,127.0,5,1111,18.0,843.0,843.0
0.016,6,10,1989,5,910,4.0,642.0,642.0,5,1079,4.0,811.0,811.0
0.015,6,10,1972,5,910,3.0,642.0,642.0,5,1062,3.0,794.0,794.0
0.215,6,16,2778,8,1396,30.0,533.0,324.0,8,1382,19.0,529.0,239.0
0.09,6,10,1506,5,395,19.0,127.0,127.0,5,1111,17.0,843.0,843.0
0.143,6,14,4390,8,923,20.0,238.0,166.0,6,3467,20.0,1402.0,786.0
0.009,6,10,1972,5,910,2.0,642.0,642.0,5,1062,2.0,794.0,794.0
0.184,17,4,352,2,130,50.0,37.0,37.0,2,222,143.0,89.0,83.0
0.005,17,2,169,1,62,0.0,34.0,34.0,1,107,0.0,79.0,79.0
0.009,6,10,1989,5,910,2.0,642.0,642.0,5,1079,2.0,811.0,811.0
126.006,6,14,2938,8,2504,17967.0,1414.0,1086.0,6,434,25154.0,182.0,182.0
15.216,17,38,19983,21,17030,759.0,1350.0,782.0,17,2953,949.0,1350.0,145.0
0.004,6,10,2000,5,927,1.0,659.0,659.0,5,1073,1.0,805.0,805.0
0.012,6,13,3816,7,578,1.0,206.0,206.0,6,3238,2.0,1470.0,1459.0
40.063,17,10,676,5,460,10012.0,104.0,64.0,5,216,10014.0,20.0,15.0
0.015,6,10,1972,5,910,3.0,642.0,642.0,5,1062,3.0,794.0,794.0
0.002,17,2,180,1,66,0.0,38.0,38.0,1,114,0.0,86.0,86.0
0.004,6,10,1702,5,863,1.0,595.0,595.0,5,839,1.0,571.0,571.0
0.007,6,10,2007,5,928,1.0,660.0,660.0,5,1079,1.0,811.0,811.0
0.042,17,2,148,1,60,0.0,32.0,32.0,1,88,0.0,60.0,60.0
0.01,6,10,1990,5,911,2.0,643.0,643.0,5,1079,2.0,811.0,811.0
0.006,6,13,3747,7,509,1.0,137.0,137.0,6,3238,1.0,1470.0,1459.0
0.003,17,2,148,1,60,0.0,32.0,32.0,1,88,0.0,60.0,60.0
40.064,17,10,676,5,460,10013.0,104.0,64.0,5,216,10015.0,20.0,15.0
0.097,6,10,1506,5,395,19.0,127.0,127.0,5,1111,21.0,843.0,843.0
0.087,6,10,1506,5,395,21.0,127.0,127.0,5,1111,19.0,843.0,843.0
0.005,6,10,2006,5,927,1.0,659.0,659.0,5,1079,1.0,811.0,811.0
0.06,6,10,1506,5,395,14.0,127.0,127.0,5,1111,14.0,843.0,843.0
0.005,17,2,170,1,65,0.0,37.0,37.0,1,105,0.0,77.0,77.0
0.013,6,10,1762,5,911,3.0,643.0,643.0,5,851,3.0,583.0,583.0
0.09,6,10,1506,5,395,20.0,127.0,127.0,5,1111,21.0,843.0,843.0
0.008,6,14,3787,7,497,1.0,125.0,125.0,7,3290,1.0,1448.0,972.0
0.005,17,2,144,1,64,0.0,36.0,36.0,1,80,0.0,52.0,52.0
0.085,6,10,1506,5,395,20.0,127.0,127.0,5,1111,20.0,843.0,843.0
0.092,6,10,1506,5,395,22.0,127.0,127.0,5,1111,22.0,843.0,843.0
0.006,6,10,1547,5,764,1.0,496.0,496.0,5,783,1.0,515.0,515.0
0.005,6,10,2000,5,927,1.0,659.0,659.0,5,1073,1.0,805.0,805.0
0.006,17,2,146,1,65,0.0,37.0,37.0,1,81,0.0,53.0,53.0
0.004,6,10,1702,5,863,1.0,595.0,595.0,5,839,0.0,571.0,571.0
0.005,6,10,1989,5,927,1.0,659.0,659.0,5,1062,1.0,794.0,794.0
0.008,6,10,1990,5,911,2.0,643.0,643.0,5,1079,2.0,811.0,811.0
0.04,17,2,234,1,61,0.0,33.0,33.0,1,173,0.0,145.0,145.0
352.243,6,20,2210,6,1308,12003.0,494.0,494.0,14,902,27095.0,83.0,83.0
0.018,6,10,1972,5,910,4.0,642.0,642.0,5,1062,4.0,794.0,794.0
0.005,6,10,1989,5,927,1.0,659.0,659.0,5,1062,1.0,794.0,794.0
0.017,6,14,3787,7,497,2.0,125.0,125.0,7,3290,2.0,1448.0,972.0
240.14,6,32,9305,16,6847,16009.0,1916.0,668.0,16,2458,16009.0,580.0,202.0
0.105,6,10,1506,5,395,23.0,127.0,127.0,5,1111,22.0,843.0,843.0
0.006,17,2,170,1,65,0.0,37.0,37.0,1,105,0.0,77.0,77.0
40.062,17,10,676,5,460,10014.0,104.0,64.0,5,216,10014.0,20.0,15.0
0.004,17,2,148,1,60,0.0,32.0,32.0,1,88,0.0,60.0,60.0
0.006,6,10,2000,5,927,1.0,659.0,659.0,5,1073,1.0,805.0,805.0
0.002,17,2,136,1,60,0.0,32.0,32.0,1,76,0.0,48.0,48.0
0.115,6,10,1506,5,395,21.0,127.0,127.0,5,1111,26.0,843.0,843.0
0.042,17,2,152,1,76,0.0,48.0,48.0,1,76,0.0,48.0,48.0
0.009,6,10,2007,5,928,2.0,660.0,660.0,5,1079,2.0,811.0,811.0
0.006,6,10,1547,5,764,1.0,496.0,496.0,5,783,1.0,515.0,515.0
0.006,6,10,1547,5,764,1.0,496.0,496.0,5,783,1.0,515.0,515.0
371.126,6,22,2313,16,867,24741.0,195.0,195.0,6,1446,4636.0,419.0,398.0
0.005,6,10,2007,5,928,1.0,660.0,660.0,5,1079,1.0,811.0,811.0
0.002,17,2,148,1,60,0.0,32.0,32.0,1,88,0.0,60.0,60.0
0.009,6,10,1990,5,911,2.0,643.0,643.0,5,1079,2.0,811.0,811.0
0.004,6,10,2006,5,927,1.0,659.0,659.0,5,1079,1.0,811.0,811.0
0.011,6,10,1762,5,911,2.0,643.0,643.0,5,851,2.0,583.0,583.0
0.005,6,10,2006,5,927,1.0,659.0,659.0,5,1079,1.0,811.0,811.0
0.005,6,10,2000,5,927,1.0,659.0,659.0,5,1073,1.0,805.0,805.0
240.095,6,16,4482,9,963,30011.0,238.0,166.0,7,3519,40014.0,1402.0,786.0
0.01,6,10,1990,5,911,2.0,643.0,643.0,5,1079,2.0,811.0,811.0
0.005,6,10,1689,5,839,1.0,571.0,571.0,5,850,1.0,582.0,582.0
0.021,6,10,1990,5,911,5.0,643.0,643.0,5,1079,5.0,811.0,811.0
0.006,6,10,2006,5,927,1.0,659.0,659.0,5,1079,1.0,811.0,811.0
0.006,6,10,1547,5,764,1.0,496.0,496.0,5,783,1.0,515.0,515.0
40.057,17,10,676,5,460,10013.0,104.0,64.0,5,216,10013.0,20.0,15.0
0.004,6,10,1774,5,923,1.0,655.0,655.0,5,851,1.0,583.0,583.0
0.014,6,10,1990,5,911,3.0,643.0,643.0,5,1079,3.0,811.0,811.0
0.005,6,10,2006,5,927,1.0,659.0,659.0,5,1079,1.0,811.0,811.0
0.014,6,10,1989,5,910,3.0,642.0,642.0,5,1079,3.0,811.0,811.0
0.041,17,2,152,1,76,0.0,48.0,48.0,1,76,0.0,48.0,48.0
0.092,6,10,1506,5,395,21.0,127.0,127.0,5,1111,19.0,843.0,843.0
0.01,6,10,1989,5,910,2.0,642.0,642.0,5,1079,2.0,811.0,811.0
0.017,6,10,1677,5,827,4.0,559.0,559.0,5,850,4.0,582.0,582.0
0.001,17,2,180,1,66,0.0,38.0,38.0,1,114,0.0,86.0,86.0
0.011,6,10,1989,5,910,2.0,642.0,642.0,5,1079,2.0,811.0,811.0
0.03,17,2,148,1,60,0.0,32.0,32.0,1,88,0.0,60.0,60.0
0.092,6,10,1506,5,395,19.0,127.0,127.0,5,1111,22.0,843.0,843.0
0.004,6,10,2000,5,927,1.0,659.0,659.0,5,1073,1.0,805.0,805.0
0.005,6,10,2007,5,928,1.0,660.0,660.0,5,1079,1.0,811.0,811.0
240.664,6,33,9248,16,1816,16041.0,604.0,195.0,17,7432,15038.0,1402.0,595.0
0.003,17,2,136,1,60,0.0,32.0,32.0,1,76,0.0,48.0,48.0
0.015,6,10,1990,5,911,3.0,643.0,643.0,5,1079,3.0,811.0,811.0
0.011,6,10,1983,5,910,2.0,642.0,642.0,5,1073,2.0,805.0,805.0
1756.073,6,105,6270,60,3525,29763.0,27.0,27.0,45,2745,39909.0,27.0,27.0
0.004,6,10,2006,5,927,1.0,659.0,659.0,5,1079,1.0,811.0,811.0
0.011,6,10,1989,5,910,2.0,642.0,642.0,5,1079,2.0,811.0,811.0
0.005,6,10,2006,5,927,1.0,659.0,659.0,5,1079,1.0,811.0,811.0
0.04,17,4,352,2,130,1.0,37.0,37.0,2,222,2.0,89.0,83.0
0.015,6,10,1677,5,827,3.0,559.0,559.0,5,850,3.0,582.0,582.0
40.071,17,10,676,5,460,10015.0,104.0,64.0,5,216,10016.0,20.0,15.0
0.09,6,10,1506,5,395,21.0,127.0,127.0,5,1111,21.0,843.0,843.0
175.182,17,92,13326,46,3116,3892.0,44.0,39.0,46,10210,3892.0,239.0,193.0
0.011,6,10,1972,5,910,2.0,642.0,642.0,5,1062,2.0,794.0,794.0
0.07,6,10,1506,5,395,16.0,127.0,127.0,5,1111,16.0,843.0,843.0
0.009,6,10,1972,5,910,2.0,642.0,642.0,5,1062,2.0,794.0,794.0
0.041,17,2,148,1,60,0.0,32.0,32.0,1,88,0.0,60.0,60.0
0.009,6,10,1677,5,827,2.0,559.0,559.0,5,850,2.0,582.0,582.0
0.005,6,10,2007,5,928,1.0,660.0,660.0,5,1079,1.0,811.0,811.0
0.005,6,10,1779,5,928,1.0,660.0,660.0,5,851,1.0,583.0,583.0
0.006,17,2,194,1,59,0.0,31.0,31.0,1,135,0.0,107.0,107.0
0.005,17,2,166,1,75,0.0,47.0,47.0,1,91,0.0,63.0,63.0
0.041,17,2,148,1,60,0.0,32.0,32.0,1,88,0.0,60.0,60.0
0.078,6,10,1506,5,395,18.0,127.0,127.0,5,1111,18.0,843.0,843.0
0.019,6,10,1990,5,911,4.0,643.0,643.0,5,1079,4.0,811.0,811.0
0.005,17,2,193,1,71,0.0,43.0,43.0,1,122,0.0,94.0,94.0
0.091,6,10,1506,5,395,20.0,127.0,127.0,5,1111,20.0,843.0,843.0
241.343,6,398,348820,186,21189,1304.0,2736.0,959.0,212,327631,1143.0,2916.0,1567.0
0.005,6,10,2006,5,927,1.0,659.0,659.0,5,1079,1.0,811.0,811.0
0.002,17,2,152,1,76,0.0,48.0,48.0,1,76,0.0,48.0,48.0
15.213,17,38,20019,21,17031,759.0,1350.0,783.0,17,2988,949.0,1350.0,147.0
0.037,17,2,136,1,60,0.0,32.0,32.0,1,76,0.0,48.0,48.0
0.236,17,39,20234,21,17041,11.0,1350.0,783.0,18,3193,10.0,1350.0,149.0
0.008,6,12,1926,6,1189,1.0,659.0,434.0,6,737,1.0,417.0,417.0
0.005,6,10,1774,5,923,1.0,655.0,655.0,5,851,1.0,583.0,583.0
0.121,6,10,1506,5,395,22.0,127.0,127.0,5,1111,26.0,843.0,843.0
0.013,6,10,1989,5,910,3.0,642.0,642.0,5,1079,3.0,811.0,811.0
10.939,17,28,4394,14,2312,832.0,587.0,137.0,14,2082,832.0,269.0,120.0
0.005,6,10,1854,5,889,1.0,621.0,621.0,5,965,1.0,697.0,697.0
0.013,6,14,3787,7,497,2.0,125.0,125.0,7,3290,2.0,1448.0,972.0
0.005,6,10,2000,5,927,1.0,659.0,659.0,5,1073,1.0,805.0,805.0
0.001,17,2,180,1,66,0.0,38.0,38.0,1,114,0.0,86.0,86.0
0.011,6,10,1989,5,910,2.0,642.0,642.0,5,1079,2.0,811.0,811.0
0.005,6,10,2006,5,927,1.0,659.0,659.0,5,1079,1.0,811.0,811.0
300.037,6,42,10638,22,5040,14279.0,1360.0,589.0,20,5598,15782.0,2667.0,435.0
0.005,6,10,1689,5,839,1.0,571.0,571.0,5,850,1.0,582.0,582.0
0.005,6,10,1989,5,927,1.0,659.0,659.0,5,1062,1.0,794.0,794.0
0.006,6,10,1547,5,764,1.0,496.0,496.0,5,783,1.0,515.0,515.0
0.072,6,10,1506,5,395,15.0,127.0,127.0,5,1111,17.0,843.0,843.0
0.012,6,10,1990,5,911,3.0,643.0,643.0,5,1079,3.0,811.0,811.0
0.005,6,10,2006,5,927,1.0,659.0,659.0,5,1079,1.0,811.0,811.0
0.007,17,2,179,1,71,0.0,43.0,43.0,1,108,0.0,80.0,80.0
0.005,6,10,2000,5,927,1.0,659.0,659.0,5,1073,1.0,805.0,805.0
309.702,17,20,1124,10,716,34397.0,48.0,43.0,10,408,34397.0,20.0,12.0
0.089,6,10,1506,5,395,19.0,127.0,127.0,5,1111,19.0,843.0,843.0
2.746,6,24,7517,13,1385,228.0,530.0,277.0,11,6132,256.0,2720.0,946.0
0.008,6,12,1926,6,1189,1.0,659.0,434.0,6,737,1.0,417.0,417.0
0.003,17,2,185,1,73,0.0,45.0,45.0,1,112,0.0,84.0,84.0
0.015,6,10,1983,5,910,3.0,642.0,642.0,5,1073,3.0,805.0,805.0
0.017,6,10,1990,5,911,4.0,643.0,643.0,5,1079,4.0,811.0,811.0
0.172,6,10,1506,5,395,39.0,127.0,127.0,5,1111,38.0,843.0,843.0
40.079,17,10,676,5,460,10018.0,104.0,64.0,5,216,10018.0,20.0,15.0
0.005,6,10,2007,5,928,1.0,660.0,660.0,5,1079,1.0,811.0,811.0
300.331,6,28,7485,16,1409,20022.0,217.0,142.0,12,6076,21844.0,1402.0,680.0
0.115,17,2,299,1,65,0.0,37.0,37.0,1,234,0.0,206.0,206.0
11.185,17,28,4422,14,1994,847.0,269.0,114.0,14,2428,847.0,587.0,145.0
0.016,6,10,1983,5,910,3.0,642.0,642.0,5,1073,3.0,805.0,805.0
0.004,6,10,1989,5,927,1.0,659.0,659.0,5,1062,1.0,794.0,794.0
0.008,6,10,1972,5,910,1.0,642.0,642.0,5,1062,1.0,794.0,794.0
0.005,6,10,2000,5,927,1.0,659.0,659.0,5,1073,1.0,805.0,805.0
0.01,6,10,1990,5,911,2.0,643.0,643.0,5,1079,2.0,811.0,811.0
178.054,17,102,14431,51,3445,3561.0,44.0,39.0,51,10986,3561.0,239.0,187.0
0.004,17,2,166,1,75,0.0,47.0,47.0,1,91,0.0,63.0,63.0
0.262,17,40,21653,22,18412,12.0,1350.0,808.0,18,3241,11.0,1350.0,152.0
0.011,6,10,1972,5,910,2.0,642.0,642.0,5,1062,2.0,794.0,794.0
0.005,6,10,1643,5,860,1.0,592.0,592.0,5,783,1.0,515.0,515.0
0.005,6,10,1989,5,927,1.0,659.0,659.0,5,1062,1.0,794.0,794.0
0.011,6,12,1926,6,1189,2.0,659.0,434.0,6,737,2.0,417.0,417.0
0.005,6,13,3747,7,509,0.0,137.0,137.0,6,3238,1.0,1470.0,1459.0
0.005,6,10,2006,5,927,1.0,659.0,659.0,5,1079,1.0,811.0,811.0
0.005,6,13,3690,7,452,0.0,80.0,80.0,6,3238,1.0,1470.0,1459.0
0.001,17,2,180,1,66,0.0,38.0,38.0,1,114,0.0,86.0,86.0
0.004,17,4,284,2,120,0.0,32.0,32.0,2,164,1.0,60.0,54.0
0.005,17,2,230,1,68,0.0,40.0,40.0,1,162,0.0,134.0,134.0
0.005,6,10,1989,5,927,1.0,659.0,659.0,5,1062,1.0,794.0,794.0
0.005,6,13,3690,7,452,0.0,80.0,80.0,6,3238,1.0,1470.0,1459.0
0.004,6,10,1702,5,863,1.0,595.0,595.0,5,839,1.0,571.0,571.0
0.005,6,10,2006,5,927,1.0,659.0,659.0,5,1079,1.0,811.0,811.0
1772.314,6,105,6270,60,3525,30038.0,27.0,27.0,45,2745,40279.0,27.0,27.0
0.009,6,10,1983,5,910,2.0,642.0,642.0,5,1073,2.0,805.0,805.0
308.314,17,20,1124,10,716,34250.0,48.0,43.0,10,408,34250.0,20.0,12.0
0.005,6,14,3799,7,509,0.0,137.0,137.0,7,3290,0.0,1448.0,972.0
0.314,17,40,20230,22,17084,14.0,1350.0,748.0,18,3146,14.0,1350.0,146.0
0.12,6,10,1506,5,395,27.0,127.0,127.0,5,1111,27.0,843.0,843.0
0.082,6,10,1506,5,395,18.0,127.0,127.0,5,1111,15.0,843.0,843.0
0.009,6,12,1926,6,1189,1.0,659.0,434.0,6,737,1.0,417.0,417.0
0.005,6,10,1989,5,927,1.0,659.0,659.0,5,1062,1.0,794.0,794.0
0.001,17,2,180,1,66,0.0,38.0,38.0,1,114,0.0,86.0,86.0
40.072,17,10,676,5,460,10017.0,104.0,64.0,5,216,10017.0,20.0,15.0
31.811,6,167,159046,88,148024,364.0,2804.0,1912.0,79,11022,406.0,1402.0,690.0
0.116,6,10,1506,5,395,25.0,127.0,127.0,5,1111,24.0,843.0,843.0
0.006,6,10,1547,5,764,1.0,496.0,496.0,5,783,1.0,515.0,515.0
8.987,6,36,9771,19,4293,499.0,1360.0,700.0,17,5478,549.0,2667.0,435.0
0.005,6,10,2000,5,927,1.0,659.0,659.0,5,1073,1.0,805.0,805.0
0.079,6,10,1506,5,395,17.0,127.0,127.0,5,1111,18.0,843.0,843.0
0.077,6,10,1506,5,395,15.0,127.0,127.0,5,1111,18.0,843.0,843.0
0.005,6,10,1689,5,839,1.0,571.0,571.0,5,850,1.0,582.0,582.0
0.013,6,10,1631,5,848,3.0,580.0,580.0,5,783,3.0,515.0,515.0
0.005,17,2,144,1,64,0.0,36.0,36.0,1,80,0.0,52.0,52.0
0.005,6,10,1689,5,839,1.0,571.0,571.0,5,850,1.0,582.0,582.0
0.006,6,10,1547,5,764,1.0,496.0,496.0,5,783,1.0,515.0,515.0
15.074,17,16,8421,8,6227,2149.0,1350.0,750.0,8,2194,2149.0,1350.0,246.0
0.02,17,2,214,1,75,0.0,47.0,47.0,1,139,0.0,111.0,111.0
0.012,6,10,1989,5,910,3.0,642.0,642.0,5,1079,3.0,811.0,811.0
0.004,6,10,2006,5,927,1.0,659.0,659.0,5,1079,1.0,811.0,811.0
355.627,6,18,2106,6,1308,12003.0,494.0,494.0,12,798,32329.0,83.0,83.0
0.005,6,14,3799,7,509,0.0,137.0,137.0,7,3290,0.0,1448.0,972.0
40.086,17,10,676,5,460,10020.0,104.0,64.0,5,216,10020.0,20.0,15.0
0.016,6,10,1989,5,910,3.0,642.0,642.0,5,1079,3.0,811.0,811.0
0.005,6,10,2007,5,928,1.0,660.0,660.0,5,1079,1.0,811.0,811.0
177.292,17,88,12244,44,2935,4122.0,44.0,38.0,44,9309,4123.0,239.0,183.0
0.003,17,2,185,1,73,0.0,45.0,45.0,1,112,0.0,84.0,84.0
0.008,6,10,1990,5,911,2.0,643.0,643.0,5,1079,2.0,811.0,811.0
0.005,6,10,1643,5,860,1.0,592.0,592.0,5,783,1.0,515.0,515.0
0.008,6,10,1989,5,910,2.0,642.0,642.0,5,1079,2.0,811.0,811.0
0.006,6,10,1547,5,764,1.0,496.0,496.0,5,783,1.0,515.0,515.0
1730.397,6,45,2790,30,1725,59668.0,35.0,35.0,15,1065,123594.0,31.0,31.0
308.87,17,20,1124,10,716,34312.0,48.0,43.0,10,408,34312.0,20.0,12.0
0.102,6,10,1506,5,395,23.0,127.0,127.0,5,1111,22.0,843.0,843.0
0.005,6,10,1945,5,981,1.0,713.0,713.0,5,964,1.0,696.0,696.0
0.005,6,10,2006,5,927,1.0,659.0,659.0,5,1079,1.0,811.0,811.0
0.041,17,2,152,1,76,0.0,48.0,48.0,1,76,0.0,48.0,48.0
0.103,6,10,1506,5,395,22.0,127.0,127.0,5,1111,23.0,843.0,843.0
0.005,6,10,2006,5,927,1.0,659.0,659.0,5,1079,1.0,811.0,811.0
0.091,6,10,1506,5,395,19.0,127.0,127.0,5,1111,21.0,843.0,843.0
0.076,17,2,144,1,64,0.0,36.0,36.0,1,80,0.0,52.0,52.0
0.003,17,4,284,2,120,0.0,32.0,32.0,2,164,0.0,60.0,54.0
0.024,6,10,1989,5,910,6.0,642.0,642.0,5,1079,6.0,811.0,811.0
0.014,6,10,1972,5,910,3.0,642.0,642.0,5,1062,3.0,794.0,794.0
0.001,17,2,174,1,72,0.0,44.0,44.0,1,102,0.0,74.0,74.0
0.005,17,2,140,1,62,0.0,34.0,34.0,1,78,0.0,50.0,50.0
0.008,6,10,1972,5,910,2.0,642.0,642.0,5,1062,2.0,794.0,794.0
0.076,6,10,1506,5,395,16.0,127.0,127.0,5,1111,15.0,843.0,843.0
0.008,6,10,1983,5,910,2.0,642.0,642.0,5,1073,1.0,805.0,805.0
170.092,17,78,11183,39,2609,4476.0,44.0,38.0,39,8574,4476.0,239.0,191.0
0.066,6,10,1506,5,395,15.0,127.0,127.0,5,1111,14.0,843.0,843.0
0.075,6,10,1506,5,395,15.0,127.0,127.0,5,1111,17.0,843.0,843.0
0.004,6,10,2006,5,927,1.0,659.0,659.0,5,1079,1.0,811.0,811.0
0.283,17,44,29198,26,24766,11.0,1350.0,924.0,18,4432,14.0,1350.0,218.0
0.244,6,19,6390,9,1442,30.0,533.0,322.0,10,4948,19.0,1402.0,736.0
0.004,17,2,148,1,60,0.0,32.0,32.0,1,88,0.0,60.0,60.0
0.009,6,12,1926,6,1189,1.0,659.0,434.0,6,737,1.0,417.0,417.0
15.085,17,15,8500,8,6359,2150.0,1350.0,766.0,7,2141,2509.0,1350.0,277.0
0.006,6,10,1547,5,764,1.0,496.0,496.0,5,783,1.0,515.0,515.0
0.787,6,10,2361,5,1374,131.0,1162.0,1162.0,5,987,131.0,775.0,775.0
0.003,17,4,284,2,120,0.0,32.0,32.0,2,164,0.0,60.0,54.0
0.009,17,4,284,2,120,6.0,32.0,32.0,2,164,7.0,60.0,54.0
0.005,6,10,1989,5,927,1.0,659.0,659.0,5,1062,1.0,794.0,794.0
0.011,17,4,284,2,120,0.0,32.0,32.0,2,164,0.0,60.0,54.0
0.004,6,10,1989,5,927,1.0,659.0,659.0,5,1062,1.0,794.0,794.0
0.003,17,2,136,1,60,0.0,32.0,32.0,1,76,0.0,48.0,48.0
0.003,6,10,1702,5,863,0.0,595.0,595.0,5,839,0.0,571.0,571.0
0.015,6,10,1990,5,911,3.0,643.0,643.0,5,1079,3.0,811.0,811.0
0.087,6,10,1506,5,395,20.0,127.0,127.0,5,1111,18.0,843.0,843.0
0.004,17,2,148,1,60,0.0,32.0,32.0,1,88,0.0,60.0,60.0
0.005,6,10,1989,5,927,1.0,659.0,659.0,5,1062,1.0,794.0,794.0
0.081,6,10,1506,5,395,17.0,127.0,127.0,5,1111,18.0,843.0,843.0
0.017,6,10,1990,5,911,4.0,643.0,643.0,5,1079,4.0,811.0,811.0
0.027,6,10,1989,5,910,6.0,642.0,642.0,5,1079,6.0,811.0,811.0
0.01,6,14,3787,7,497,1.0,125.0,125.0,7,3290,1.0,1448.0,972.0
0.005,6,10,2006,5,927,1.0,659.0,659.0,5,1079,1.0,811.0,811.0
10.814,17,28,4423,14,1994,823.0,269.0,114.0,14,2429,823.0,588.0,145.0
0.005,6,10,1689,5,839,1.0,571.0,571.0,5,850,1.0,582.0,582.0
0.022,6,13,3913,7,495,3.0,123.0,123.0,6,3418,4.0,1650.0,1549.0
0.006,6,10,2006,5,927,1.0,659.0,659.0,5,1079,1.0,811.0,811.0
0.082,6,10,1506,5,395,17.0,127.0,127.0,5,1111,18.0,843.0,843.0
0.34,17,44,24362,24,21179,14.0,1350.0,854.0,20,3183,14.0,1350.0,131.0
525.929,6,25,6326,14,2388,40456.0,585.0,330.0,11,3938,46589.0,1402.0,671.0
240.094,6,31,9258,15,6856,17149.0,1981.0,675.0,16,2402,16006.0,580.0,195.0
352.502,6,20,2210,6,1308,12003.0,494.0,494.0,14,902,27115.0,83.0,83.0
0.01,6,10,1972,5,910,2.0,642.0,642.0,5,1062,2.0,794.0,794.0
0.01,6,10,1983,5,910,2.0,642.0,642.0,5,1073,2.0,805.0,805.0
0.015,6,13,3735,7,497,2.0,125.0,125.0,6,3238,2.0,1470.0,1459.0
0.008,6,10,1990,5,911,2.0,643.0,643.0,5,1079,2.0,811.0,811.0
0.006,6,10,1547,5,764,1.0,496.0,496.0,5,783,1.0,515.0,515.0
0.006,17,2,230,1,68,0.0,40.0,40.0,1,162,0.0,134.0,134.0
0.018,6,10,1983,5,910,4.0,642.0,642.0,5,1073,4.0,805.0,805.0
0.106,6,10,1506,5,395,18.0,127.0,127.0,5,1111,23.0,843.0,843.0
0.007,6,10,1854,5,889,1.0,621.0,621.0,5,965,1.0,697.0,697.0
0.014,6,10,1631,5,848,3.0,580.0,580.0,5,783,3.0,515.0,515.0
0.006,6,10,1547,5,764,1.0,496.0,496.0,5,783,1.0,515.0,515.0
0.01,6,10,1762,5,911,2.0,643.0,643.0,5,851,2.0,583.0,583.0
0.013,17,2,152,1,56,0.0,28.0,28.0,1,96,0.0,68.0,68.0
10.817,17,28,4418,14,1993,824.0,268.0,114.0,14,2425,823.0,588.0,145.0
40.071,17,10,676,5,460,10017.0,104.0,64.0,5,216,10017.0,20.0,15.0
0.103,6,10,1506,5,395,23.0,127.0,127.0,5,1111,24.0,843.0,843.0
0.13,6,25,6532,12,2337,10.0,746.0,341.0,13,4195,9.0,1324.0,585.0
0.006,6,10,1989,5,927,1.0,659.0,659.0,5,1062,1.0,794.0,794.0
240.033,6,5,633,3,446,120016.0,302.0,302.0,2,187,240026.0,83.0,83.0
0.006,6,10,1547,5,764,1.0,496.0,496.0,5,783,1.0,515.0,515.0
0.124,6,10,1506,5,395,29.0,127.0,127.0,5,1111,27.0,843.0,843.0
0.132,17,2,182,1,65,0.0,37.0,37.0,1,117,0.0,89.0,89.0
0.007,6,10,1989,5,910,1.0,642.0,642.0,5,1079,1.0,811.0,811.0
0.021,17,2,148,1,60,0.0,32.0,32.0,1,88,0.0,60.0,60.0
0.005,17,2,338,1,74,0.0,46.0,46.0,1,264,0.0,236.0,236.0
0.071,6,10,1506,5,395,17.0,127.0,127.0,5,1111,14.0,843.0,843.0
0.011,17,2,194,1,59,0.0,31.0,31.0,1,135,0.0,107.0,107.0
66.884,6,33,22856,18,12715,3934.0,2804.0,1471.0,15,10141,4766.0,2312.0,1169.0
0.069,17,8,3613,4,1874,23.0,1350.0,440.0,4,1739,11.0,1350.0,406.0
0.001,17,2,180,1,66,0.0,38.0,38.0,1,114,0.0,86.0,86.0
0.329,6,16,2782,8,1400,47.0,533.0,325.0,8,1382,30.0,529.0,239.0
0.005,6,13,3690,7,452,0.0,80.0,80.0,6,3238,0.0,1470.0,1459.0
0.005,6,10,1547,5,764,1.0,496.0,496.0,5,783,1.0,515.0,515.0
0.005,6,10,1689,5,839,1.0,571.0,571.0,5,850,1.0,582.0,582.0
15.072,17,11,4407,5,2354,3761.0,1350.0,442.0,6,2053,3008.0,1350.0,314.0
0.101,6,10,1506,5,395,23.0,127.0,127.0,5,1111,21.0,843.0,843.0
20.31,6,39,13541,20,7983,465.0,2720.0,1191.0,19,5558,1118.0,2667.0,435.0
0.094,6,10,1506,5,395,19.0,127.0,127.0,5,1111,21.0,843.0,843.0
0.004,17,2,164,1,74,0.0,46.0,46.0,1,90,0.0,62.0,62.0
0.012,6,12,1926,6,1189,2.0,659.0,434.0,6,737,2.0,417.0,417.0
0.006,6,10,1547,5,764,1.0,496.0,496.0,5,783,1.0,515.0,515.0
0.033,6,10,1990,5,911,8.0,643.0,643.0,5,1079,8.0,811.0,811.0
0.014,6,10,1677,5,827,3.0,559.0,559.0,5,850,3.0,582.0,582.0
0.099,6,10,1506,5,395,22.0,127.0,127.0,5,1111,17.0,843.0,843.0
0.068,6,10,1506,5,395,16.0,127.0,127.0,5,1111,13.0,843.0,843.0
0.007,6,10,1989,5,927,1.0,659.0,659.0,5,1062,1.0,794.0,794.0
0.005,6,13,3747,7,509,0.0,137.0,137.0,6,3238,0.0,1470.0,1459.0
0.038,17,2,152,1,76,0.0,48.0,48.0,1,76,0.0,48.0,48.0
0.012,17,2,136,1,60,0.0,32.0,32.0,1,76,0.0,48.0,48.0
0.013,6,10,1762,5,911,3.0,643.0,643.0,5,851,3.0,583.0,583.0
0.01,6,12,1926,6,1189,2.0,659.0,434.0,6,737,2.0,417.0,417.0
0.006,6,10,1779,5,928,1.0,660.0,660.0,5,851,1.0,583.0,583.0
0.169,17,2,152,1,76,0.0,48.0,48.0,1,76,0.0,48.0,48.0
0.005,6,10,2007,5,928,1.0,660.0,660.0,5,1079,1.0,811.0,811.0
0.012,6,10,1990,5,911,2.0,643.0,643.0,5,1079,2.0,811.0,811.0
0.073,6,10,1506,5,395,17.0,127.0,127.0,5,1111,15.0,843.0,843.0
0.072,17,2,182,1,65,0.0,37.0,37.0,1,117,0.0,89.0,89.0
300.433,6,19,3081,11,1647,30043.0,517.0,266.0,8,1434,34342.0,821.0,336.0
0.116,6,10,1506,5,395,25.0,127.0,127.0,5,1111,22.0,843.0,843.0
0.003,6,10,1702,5,863,0.0,595.0,595.0,5,839,0.0,571.0,571.0
0.098,6,10,1506,5,395,23.0,127.0,127.0,5,1111,22.0,843.0,843.0
0.004,6,10,2007,5,928,1.0,660.0,660.0,5,1079,1.0,811.0,811.0
0.103,6,10,1506,5,395,23.0,127.0,127.0,5,1111,23.0,843.0,843.0
0.229,6,16,2777,8,1395,32.0,533.0,323.0,8,1382,21.0,529.0,239.0
0.014,6,13,3735,7,497,2.0,125.0,125.0,6,3238,2.0,1470.0,1459.0
0.005,6,10,1779,5,928,1.0,660.0,660.0,5,851,1.0,583.0,583.0
0.084,6,10,1506,5,395,18.0,127.0,127.0,5,1111,18.0,843.0,843.0
0.016,6,10,1990,5,911,4.0,643.0,643.0,5,1079,3.0,811.0,811.0
0.005,6,10,2007,5,928,1.0,660.0,660.0,5,1079,1.0,811.0,811.0
0.005,6,10,1989,5,927,1.0,659.0,659.0,5,1062,1.0,794.0,794.0
0.012,6,10,1972,5,910,3.0,642.0,642.0,5,1062,2.0,794.0,794.0
0.005,6,10,2000,5,927,1.0,659.0,659.0,5,1073,1.0,805.0,805.0
0.016,6,10,1990,5,911,3.0,643.0,643.0,5,1079,3.0,811.0,811.0
0.004,6,10,2000,5,927,1.0,659.0,659.0,5,1073,1.0,805.0,805.0
40.046,17,10,676,5,460,10010.0,104.0,64.0,5,216,10010.0,20.0,15.0
0.094,6,10,1506,5,395,22.0,127.0,127.0,5,1111,16.0,843.0,843.0
309.132,17,20,1124,10,716,34341.0,48.0,43.0,10,408,34341.0,20.0,12.0
1.135,6,32,13391,18,5892,66.0,2720.0,854.0,14,7499,73.0,2720.0,769.0
15.073,17,15,9239,8,6902,2149.0,1350.0,834.0,7,2337,2507.0,1350.0,305.0
150.674,6,21,8146,11,1985,87.0,1174.0,504.0,10,6161,16722.0,2720.0,958.0
300.29,6,19,3084,11,1647,30029.0,517.0,266.0,8,1437,34325.0,824.0,337.0
0.005,6,10,1689,5,839,1.0,571.0,571.0,5,850,1.0,582.0,582.0
0.005,17,2,230,1,68,0.0,40.0,40.0,1,162,0.0,134.0,134.0
0.014,6,10,1989,5,910,3.0,642.0,642.0,5,1079,3.0,811.0,811.0
0.007,6,10,1972,5,910,1.0,642.0,642.0,5,1062,1.0,794.0,794.0
0.005,17,2,212,1,74,0.0,46.0,46.0,1,138,0.0,110.0,110.0
0.005,17,2,170,1,65,0.0,37.0,37.0,1,105,0.0,77.0,77.0
0.094,6,10,1506,5,395,21.0,127.0,127.0,5,1111,18.0,843.0,843.0
177.148,17,78,10935,39,2607,4661.0,44.0,38.0,39,8328,4661.0,239.0,185.0
0.013,6,10,1983,5,910,3.0,642.0,642.0,5,1073,3.0,805.0,805.0
0.012,6,10,1989,5,927,3.0,659.0,659.0,5,1062,2.0,794.0,794.0
0.038,17,2,148,1,60,0.0,32.0,32.0,1,88,0.0,60.0,60.0
0.005,6,10,2000,5,927,1.0,659.0,659.0,5,1073,1.0,805.0,805.0
0.226,6,16,2669,8,1395,32.0,533.0,323.0,8,1274,21.0,529.0,212.0
0.011,6,10,1990,5,911,2.0,643.0,643.0,5,1079,2.0,811.0,811.0
0.001,17,2,136,1,60,0.0,32.0,32.0,1,76,0.0,48.0,48.0
40.991,6,39,14495,19,8897,491.0,4080.0,1621.0,20,5598,2148.0,2667.0,435.0
0.009,6,10,1972,5,910,2.0,642.0,642.0,5,1062,2.0,794.0,794.0
0.01,6,14,3787,7,497,1.0,125.0,125.0,7,3290,1.0,1448.0,972.0
0.005,6,10,1643,5,860,1.0,592.0,592.0,5,783,1.0,515.0,515.0
0.014,6,10,1989,5,910,3.0,642.0,642.0,5,1079,3.0,811.0,811.0
0.014,6,10,1990,5,911,3.0,643.0,643.0,5,1079,3.0,811.0,811.0
0.006,6,10,2006,5,927,1.0,659.0,659.0,5,1079,1.0,811.0,811.0
0.005,6,10,2006,5,927,1.0,659.0,659.0,5,1079,1.0,811.0,811.0
0.22,6,10,1506,5,395,50.0,127.0,127.0,5,1111,51.0,843.0,843.0
15.069,17,15,9239,8,6902,2148.0,1350.0,834.0,7,2337,2506.0,1350.0,305.0
0.01,6,10,1972,5,910,2.0,642.0,642.0,5,1062,2.0,794.0,794.0
0.005,6,10,1779,5,928,1.0,660.0,660.0,5,851,1.0,583.0,583.0
315.613,17,20,1124,10,716,35054.0,48.0,43.0,10,408,35054.0,20.0,12.0
0.012,6,10,1762,5,911,2.0,643.0,643.0,5,851,2.0,583.0,583.0
0.013,6,10,1972,5,910,3.0,642.0,642.0,5,1062,3.0,794.0,794.0
0.004,17,2,186,1,61,0.0,33.0,33.0,1,125,0.0,97.0,97.0
0.008,6,12,1926,6,1189,1.0,659.0,434.0,6,737,1.0,417.0,417.0
40.104,17,10,676,5,460,10015.0,104.0,64.0,5,216,10016.0,20.0,15.0
0.078,6,10,1506,5,395,17.0,127.0,127.0,5,1111,17.0,843.0,843.0
0.009,6,10,1983,5,910,2.0,642.0,642.0,5,1073,2.0,805.0,805.0
0.004,17,2,164,1,74,0.0,46.0,46.0,1,90,0.0,62.0,62.0
0.089,6,10,1506,5,395,16.0,127.0,127.0,5,1111,19.0,843.0,843.0
0.04,17,2,182,1,65,0.0,37.0,37.0,1,117,0.0,89.0,89.0
0.005,6,10,2006,5,927,1.0,659.0,659.0,5,1079,1.0,811.0,811.0
0.005,6,10,1779,5,928,1.0,660.0,660.0,5,851,1.0,583.0,583.0
0.015,6,10,1989,5,910,3.0,642.0,642.0,5,1079,3.0,811.0,811.0
15.075,17,14,9191,8,6902,2149.0,1350.0,834.0,6,2289,3009.0,1350.0,353.0
0.004,17,2,152,1,76,0.0,48.0,48.0,1,76,0.0,48.0,48.0
240.375,6,28,4679,14,1932,18487.0,559.0,239.0,14,2747,18487.0,1214.0,252.0
0.021,6,10,1989,5,910,5.0,642.0,642.0,5,1079,5.0,811.0,811.0
0.004,6,10,1989,5,927,1.0,659.0,659.0,5,1062,1.0,794.0,794.0
0.014,6,10,1990,5,911,3.0,643.0,643.0,5,1079,3.0,811.0,811.0
0.009,6,12,1926,6,1189,1.0,659.0,434.0,6,737,1.0,417.0,417.0
0.006,6,10,1547,5,764,1.0,496.0,496.0,5,783,1.0,515.0,515.0
240.09,6,32,9399,16,6759,16006.0,1830.0,659.0,16,2640,16005.0,580.0,225.0
0.063,6,10,1506,5,395,14.0,127.0,127.0,5,1111,14.0,843.0,843.0
0.01,6,10,1972,5,910,2.0,642.0,642.0,5,1062,2.0,794.0,794.0
0.039,17,4,596,2,122,0.0,33.0,33.0,2,474,1.0,323.0,209.0
0.005,6,10,1547,5,764,1.0,496.0,496.0,5,783,1.0,515.0,515.0
40.093,17,10,676,5,460,10013.0,104.0,64.0,5,216,10009.0,20.0,15.0
0.064,6,10,1506,5,395,14.0,127.0,127.0,5,1111,14.0,843.0,843.0
240.089,6,29,6959,14,4663,18468.0,1368.0,490.0,15,2296,17149.0,580.0,188.0
40.074,17,10,676,5,460,10015.0,104.0,64.0,5,216,10017.0,20.0,15.0
0.074,6,10,1506,5,395,17.0,127.0,127.0,5,1111,15.0,843.0,843.0
0.006,6,10,1547,5,764,1.0,496.0,496.0,5,783,1.0,515.0,515.0
0.02,6,12,1926,6,1189,4.0,659.0,434.0,6,737,3.0,417.0,417.0
0.25,17,39,20276,21,17029,12.0,1350.0,782.0,18,3247,11.0,1350.0,152.0
594.747,6,47,19262,25,3696,24781.0,661.0,398.0,22,15566,25461.0,1402.0,960.0
0.059,17,2,152,1,76,0.0,48.0,48.0,1,76,0.0,48.0,48.0
0.005,6,10,2007,5,928,1.0,660.0,660.0,5,1079,1.0,811.0,811.0
0.02,6,10,1989,5,910,4.0,642.0,642.0,5,1079,4.0,811.0,811.0
0.072,17,2,144,1,64,0.0,36.0,36.0,1,80,0.0,52.0,52.0
309.646,17,20,1124,10,716,34398.0,48.0,43.0,10,408,34396.0,20.0,12.0
0.001,17,2,180,1,66,0.0,38.0,38.0,1,114,0.0,86.0,86.0
0.129,17,2,412,1,61,0.0,33.0,33.0,1,351,0.0,323.0,323.0
0.007,17,2,169,1,62,0.0,34.0,34.0,1,107,0.0,79.0,79.0
0.006,6,10,1547,5,764,1.0,496.0,496.0,5,783,1.0,515.0,515.0
0.098,6,10,1506,5,395,21.0,127.0,127.0,5,1111,20.0,843.0,843.0
0.265,17,45,25721,25,21232,11.0,1350.0,821.0,20,4489,10.0,1350.0,196.0
0.042,17,4,284,2,120,0.0,32.0,32.0,2,164,38.0,60.0,54.0
0.012,6,10,1983,5,910,3.0,642.0,642.0,5,1073,3.0,805.0,805.0
0.004,17,2,166,1,75,0.0,47.0,47.0,1,91,0.0,63.0,63.0
0.041,17,4,596,2,122,1.0,33.0,33.0,2,474,2.0,323.0,209.0
0.089,6,10,1506,5,395,21.0,127.0,127.0,5,1111,21.0,843.0,843.0
0.006,6,10,1547,5,764,1.0,496.0,496.0,5,783,1.0,515.0,515.0
0.007,6,10,1972,5,910,1.0,642.0,642.0,5,1062,1.0,794.0,794.0
0.011,6,10,1983,5,910,2.0,642.0,642.0,5,1073,2.0,805.0,805.0
0.004,6,10,2006,5,927,1.0,659.0,659.0,5,1079,1.0,811.0,811.0
0.005,6,10,2007,5,928,1.0,660.0,660.0,5,1079,1.0,811.0,811.0
0.004,6,10,1702,5,863,1.0,595.0,595.0,5,839,1.0,571.0,571.0
0.006,17,2,230,1,68,0.0,40.0,40.0,1,162,0.0,134.0,134.0
0.005,6,10,1989,5,927,1.0,659.0,659.0,5,1062,1.0,794.0,794.0
0.005,6,10,1989,5,927,1.0,659.0,659.0,5,1062,1.0,794.0,794.0
0.004,6,10,1702,5,863,1.0,595.0,595.0,5,839,0.0,571.0,571.0
0.109,6,10,1506,5,395,22.0,127.0,127.0,5,1111,25.0,843.0,843.0
0.005,17,2,144,1,64,0.0,36.0,36.0,1,80,0.0,52.0,52.0
0.09,6,10,1506,5,395,20.0,127.0,127.0,5,1111,19.0,843.0,843.0
0.015,6,10,1972,5,910,3.0,642.0,642.0,5,1062,3.0,794.0,794.0
0.008,6,10,1990,5,911,2.0,643.0,643.0,5,1079,2.0,811.0,811.0
0.004,6,10,1989,5,927,1.0,659.0,659.0,5,1062,1.0,794.0,794.0
0.014,6,10,1677,5,827,3.0,559.0,559.0,5,850,3.0,582.0,582.0
0.005,6,10,1774,5,923,1.0,655.0,655.0,5,851,1.0,583.0,583.0
0.004,6,10,2006,5,927,1.0,659.0,659.0,5,1079,1.0,811.0,811.0
0.005,6,10,2006,5,927,1.0,659.0,659.0,5,1079,1.0,811.0,811.0
0.014,6,10,1972,5,910,3.0,642.0,642.0,5,1062,3.0,794.0,794.0
0.007,6,10,1990,5,911,1.0,643.0,643.0,5,1079,1.0,811.0,811.0
0.011,6,10,1989,5,910,2.0,642.0,642.0,5,1079,2.0,811.0,811.0
0.074,6,10,1506,5,395,16.0,127.0,127.0,5,1111,16.0,843.0,843.0
0.003,17,2,136,1,60,0.0,32.0,32.0,1,76,0.0,48.0,48.0
0.061,6,10,1506,5,395,15.0,127.0,127.0,5,1111,13.0,843.0,843.0
0.005,6,10,2007,5,928,1.0,660.0,660.0,5,1079,1.0,811.0,811.0
240.017,6,9,787,5,488,60004.0,232.0,232.0,4,299,80004.0,83.0,83.0
0.007,6,10,2006,5,927,1.0,659.0,659.0,5,1079,1.0,811.0,811.0
0.015,6,10,1989,5,910,3.0,642.0,642.0,5,1079,3.0,811.0,811.0
0.006,6,10,1547,5,764,1.0,496.0,496.0,5,783,1.0,515.0,515.0
0.014,6,10,1972,5,910,3.0,642.0,642.0,5,1062,3.0,794.0,794.0
0.115,6,10,1506,5,395,25.0,127.0,127.0,5,1111,25.0,843.0,843.0
0.005,6,10,1854,5,889,1.0,621.0,621.0,5,965,1.0,697.0,697.0
0.007,17,2,214,1,75,0.0,47.0,47.0,1,139,0.0,111.0,111.0
10.73,17,28,4423,14,1994,816.0,269.0,114.0,14,2429,816.0,588.0,145.0
0.063,17,2,152,1,76,0.0,48.0,48.0,1,76,0.0,48.0,48.0
0.004,6,10,1989,5,927,1.0,659.0,659.0,5,1062,1.0,794.0,794.0
0.005,6,10,1689,5,839,1.0,571.0,571.0,5,850,1.0,582.0,582.0
0.041,17,2,184,1,61,0.0,33.0,33.0,1,123,0.0,95.0,95.0
40.096,17,10,676,5,460,10017.0,104.0,64.0,5,216,10023.0,20.0,15.0
0.006,6,10,1547,5,764,1.0,496.0,496.0,5,783,1.0,515.0,515.0
0.09,6,10,1506,5,395,18.0,127.0,127.0,5,1111,20.0,843.0,843.0
40.054,17,10,676,5,460,10012.0,104.0,64.0,5,216,10012.0,20.0,15.0
0.01,6,10,1972,5,910,2.0,642.0,642.0,5,1062,2.0,794.0,794.0
0.006,6,10,1547,5,764,1.0,496.0,496.0,5,783,1.0,515.0,515.0
0.002,17,2,136,1,60,0.0,32.0,32.0,1,76,0.0,48.0,48.0
0.004,6,10,2000,5,927,1.0,659.0,659.0,5,1073,1.0,805.0,805.0
0.004,6,10,2006,5,927,1.0,659.0,659.0,5,1079,1.0,811.0,811.0
0.025,6,10,1762,5,911,6.0,643.0,643.0,5,851,6.0,583.0,583.0
0.081,6,10,1506,5,395,18.0,127.0,127.0,5,1111,18.0,843.0,843.0
0.01,6,10,1989,5,910,2.0,642.0,642.0,5,1079,2.0,811.0,811.0
0.015,6,10,1990,5,911,3.0,643.0,643.0,5,1079,3.0,811.0,811.0
0.006,6,10,1547,5,764,1.0,496.0,496.0,5,783,1.0,515.0,515.0
0.071,6,10,1506,5,395,16.0,127.0,127.0,5,1111,15.0,843.0,843.0
0.04,17,2,152,1,76,0.0,48.0,48.0,1,76,0.0,48.0,48.0
0.008,6,10,1989,5,910,2.0,642.0,642.0,5,1079,2.0,811.0,811.0
0.035,17,2,209,1,64,0.0,36.0,36.0,1,145,0.0,117.0,117.0
0.034,6,13,3913,7,495,5.0,123.0,123.0,6,3418,6.0,1650.0,1549.0
67.175,6,40,10527,20,4929,471.0,1360.0,682.0,20,5598,3526.0,2667.0,435.0
240.081,6,16,4480,9,963,30010.0,238.0,166.0,7,3517,40013.0,1402.0,786.0
0.006,6,10,1547,5,764,1.0,496.0,496.0,5,783,1.0,515.0,515.0
10.819,17,28,5011,14,2120,824.0,270.0,123.0,14,2891,824.0,1145.0,178.0
0.009,6,10,1989,5,910,2.0,642.0,642.0,5,1079,2.0,811.0,811.0
0.07,17,8,3613,4,1874,23.0,1350.0,440.0,4,1739,11.0,1350.0,406.0
0.004,6,10,2007,5,928,1.0,660.0,660.0,5,1079,1.0,811.0,811.0
0.007,17,2,179,1,71,0.0,43.0,43.0,1,108,0.0,80.0,80.0
0.123,17,2,80,1,32,0.0,4.0,4.0,1,48,0.0,20.0,20.0
0.006,17,2,230,1,68,0.0,40.0,40.0,1,162,0.0,134.0,134.0
0.005,6,10,1774,5,923,1.0,655.0,655.0,5,851,1.0,583.0,583.0
0.006,17,2,230,1,68,0.0,40.0,40.0,1,162,0.0,134.0,134.0
0.005,6,10,2000,5,927,1.0,659.0,659.0,5,1073,1.0,805.0,805.0
40.053,17,10,676,5,460,10012.0,104.0,64.0,5,216,10012.0,20.0,15.0
0.012,6,10,1983,5,910,3.0,642.0,642.0,5,1073,2.0,805.0,805.0
40.061,17,10,676,5,460,10014.0,104.0,64.0,5,216,10013.0,20.0,15.0
0.018,6,10,1989,5,910,4.0,642.0,642.0,5,1079,4.0,811.0,811.0
0.012,6,10,1989,5,910,3.0,642.0,642.0,5,1079,2.0,811.0,811.0
47.095,6,39,8493,20,1937,467.0,777.0,364.0,19,6556,2608.0,2126.0,444.0
0.003,17,2,136,1,60,0.0,32.0,32.0,1,76,0.0,48.0,48.0
0.01,6,10,1677,5,827,2.0,559.0,559.0,5,850,2.0,582.0,582.0
0.005,6,10,2007,5,928,1.0,660.0,660.0,5,1079,1.0,811.0,811.0
0.003,17,2,148,1,60,0.0,32.0,32.0,1,88,0.0,60.0,60.0
0.004,6,10,2006,5,927,1.0,659.0,659.0,5,1079,1.0,811.0,811.0
0.014,6,10,1972,5,910,3.0,642.0,642.0,5,1062,3.0,794.0,794.0
0.005,6,10,1989,5,927,1.0,659.0,659.0,5,1062,1.0,794.0,794.0
0.004,6,10,1702,5,863,1.0,595.0,595.0,5,839,0.0,571.0,571.0
0.005,6,10,1643,5,860,1.0,592.0,592.0,5,783,1.0,515.0,515.0
40.066,17,10,676,5,460,10015.0,104.0,64.0,5,216,10015.0,20.0,15.0
0.012,6,10,1989,5,910,3.0,642.0,642.0,5,1079,2.0,811.0,811.0
360.025,6,21,3981,13,3142,30002.0,494.0,494.0,8,839,51431.0,83.0,83.0
0.015,17,2,198,1,91,0.0,63.0,63.0,1,107,0.0,79.0,79.0
0.005,6,10,1689,5,839,1.0,571.0,571.0,5,850,1.0,582.0,582.0
0.005,6,10,1702,5,863,1.0,595.0,595.0,5,839,1.0,571.0,571.0
280.409,6,24,6115,11,1226,28040.0,267.0,156.0,13,4889,23357.0,1400.0,873.0
0.012,6,10,1989,5,910,3.0,642.0,642.0,5,1079,3.0,811.0,811.0
0.077,6,10,1506,5,395,17.0,127.0,127.0,5,1111,18.0,843.0,843.0
0.008,6,10,1983,5,910,2.0,642.0,642.0,5,1073,2.0,805.0,805.0
0.004,6,10,2006,5,927,1.0,659.0,659.0,5,1079,1.0,811.0,811.0
0.072,17,4,596,2,122,4.0,33.0,33.0,2,474,65.0,323.0,209.0
0.001,17,2,142,1,63,0.0,35.0,35.0,1,79,0.0,51.0,51.0
0.005,6,10,2000,5,927,1.0,659.0,659.0,5,1073,1.0,805.0,805.0
0.009,6,12,1926,6,1189,1.0,659.0,434.0,6,737,1.0,417.0,417.0
0.222,6,16,2670,8,1396,31.0,533.0,324.0,8,1274,20.0,529.0,212.0
0.004,6,10,2006,5,927,1.0,659.0,659.0,5,1079,1.0,811.0,811.0
0.004,6,10,2007,5,928,1.0,660.0,660.0,5,1079,1.0,811.0,811.0
0.015,6,10,1990,5,911,3.0,643.0,643.0,5,1079,3.0,811.0,811.0
0.004,6,10,1702,5,863,1.0,595.0,595.0,5,839,0.0,571.0,571.0
0.005,6,10,2000,5,927,1.0,659.0,659.0,5,1073,1.0,805.0,805.0
0.005,6,10,1774,5,923,1.0,655.0,655.0,5,851,1.0,583.0,583.0
11.092,17,28,4422,14,1993,840.0,268.0,114.0,14,2429,840.0,588.0,145.0
0.037,17,4,284,2,120,0.0,32.0,32.0,2,164,34.0,60.0,54.0
334.067,17,20,1124,10,716,37103.0,48.0,43.0,10,408,37103.0,20.0,12.0
0.038,17,2,184,1,61,0.0,33.0,33.0,1,123,0.0,95.0,95.0
0.009,6,10,1989,5,910,2.0,642.0,642.0,5,1079,2.0,811.0,811.0
0.037,17,2,156,1,64,0.0,36.0,36.0,1,92,0.0,64.0,64.0
0.006,17,2,169,1,62,0.0,34.0,34.0,1,107,0.0,79.0,79.0
0.074,6,10,1506,5,395,14.0,127.0,127.0,5,1111,16.0,843.0,843.0
0.005,6,10,2006,5,927,1.0,659.0,659.0,5,1079,1.0,811.0,811.0
0.008,6,10,1990,5,911,1.0,643.0,643.0,5,1079,2.0,811.0,811.0
240.094,6,16,4482,9,963,30011.0,238.0,166.0,7,3519,40015.0,1402.0,786.0
0.071,17,4,284,2,120,0.0,32.0,32.0,2,164,68.0,60.0,54.0
0.005,6,10,1989,5,927,1.0,659.0,659.0,5,1062,1.0,794.0,794.0
0.271,17,40,21591,23,18463,12.0,1350.0,774.0,17,3128,13.0,1350.0,156.0
0.105,6,10,1506,5,395,24.0,127.0,127.0,5,1111,23.0,843.0,843.0
0.017,6,10,1677,5,827,4.0,559.0,559.0,5,850,4.0,582.0,582.0
0.124,17,4,596,2,122,0.0,33.0,33.0,2,474,82.0,323.0,209.0
0.009,6,10,1989,5,910,2.0,642.0,642.0,5,1079,2.0,811.0,811.0
0.016,6,10,1989,5,910,3.0,642.0,642.0,5,1079,3.0,811.0,811.0
0.012,6,10,1972,5,910,2.0,642.0,642.0,5,1062,2.0,794.0,794.0
0.248,17,4,352,2,130,176.0,37.0,37.0,2,222,176.0,89.0,83.0
0.007,6,10,1989,5,910,1.0,642.0,642.0,5,1079,1.0,811.0,811.0
0.004,17,2,194,1,59,0.0,31.0,31.0,1,135,0.0,107.0,107.0
0.055,6,10,1506,5,395,12.0,127.0,127.0,5,1111,12.0,843.0,843.0
0.005,17,2,170,1,65,0.0,37.0,37.0,1,105,0.0,77.0,77.0
0.12,6,10,1506,5,395,27.0,127.0,127.0,5,1111,27.0,843.0,843.0
0.009,6,10,1762,5,911,2.0,643.0,643.0,5,851,2.0,583.0,583.0
0.234,6,16,2777,8,1395,33.0,533.0,323.0,8,1382,21.0,529.0,239.0
0.075,6,10,1506,5,395,14.0,127.0,127.0,5,1111,16.0,843.0,843.0
0.005,6,10,1989,5,927,1.0,659.0,659.0,5,1062,1.0,794.0,794.0
0.053,17,2,152,1,76,0.0,48.0,48.0,1,76,0.0,48.0,48.0
290.443,6,314,344085,115,17533,2547.0,2736.0,889.0,199,326552,1466.0,4101.0,1709.0
0.014,6,10,1990,5,911,3.0,643.0,643.0,5,1079,3.0,811.0,811.0
0.082,6,10,1506,5,395,19.0,127.0,127.0,5,1111,18.0,843.0,843.0
0.026,6,19,9922,11,704,2.0,124.0,124.0,8,9218,3.0,3002.0,2198.0
0.005,17,2,214,1,75,0.0,47.0,47.0,1,139,0.0,111.0,111.0
40.056,17,10,676,5,460,10012.0,104.0,64.0,5,216,10013.0,20.0,15.0
0.005,6,14,3799,7,509,0.0,137.0,137.0,7,3290,0.0,1448.0,972.0
1.886,6,38,6827,21,3555,94.0,1103.0,204.0,17,3272,110.0,1402.0,340.0
2.109,6,30,8768,17,2251,131.0,517.0,273.0,13,6517,174.0,1402.0,648.0
0.022,6,10,1989,5,910,5.0,642.0,642.0,5,1079,5.0,811.0,811.0
0.004,6,10,2000,5,927,1.0,659.0,659.0,5,1073,1.0,805.0,805.0
0.001,17,2,180,1,66,0.0,38.0,38.0,1,114,0.0,86.0,86.0
0.004,6,10,1779,5,928,1.0,660.0,660.0,5,851,1.0,583.0,583.0
0.009,6,10,1972,5,910,2.0,642.0,642.0,5,1062,2.0,794.0,794.0
40.051,17,10,676,5,460,10012.0,104.0,64.0,5,216,10011.0,20.0,15.0
0.016,6,10,1631,5,848,4.0,580.0,580.0,5,783,3.0,515.0,515.0
0.012,6,10,1989,5,910,3.0,642.0,642.0,5,1079,2.0,811.0,811.0
0.082,6,10,1506,5,395,19.0,127.0,127.0,5,1111,16.0,843.0,843.0
325.865,17,20,1124,10,716,36192.0,48.0,43.0,10,408,36192.0,20.0,12.0
1770.377,17,92,8096,46,4048,39341.0,60.0,60.0,46,4048,39341.0,60.0,60.0
0.001,17,2,166,1,75,0.0,47.0,47.0,1,91,0.0,63.0,63.0
0.094,6,10,1506,5,395,19.0,127.0,127.0,5,1111,22.0,843.0,843.0
0.137,17,2,152,1,76,0.0,48.0,48.0,1,76,0.0,48.0,48.0
183.578,6,15,4440,9,975,22947.0,238.0,166.0,6,3465,21.0,1402.0,786.0
0.006,6,10,1989,5,927,1.0,659.0,659.0,5,1062,1.0,794.0,794.0
0.005,17,2,169,1,62,0.0,34.0,34.0,1,107,0.0,79.0,79.0
1770.717,6,135,6510,75,3585,23928.0,39.0,39.0,60,2925,30008.0,35.0,35.0
0.142,6,10,1506,5,395,31.0,127.0,127.0,5,1111,31.0,843.0,843.0
0.005,6,10,1689,5,839,1.0,571.0,571.0,5,850,1.0,582.0,582.0
0.008,6,10,1989,5,910,2.0,642.0,642.0,5,1079,2.0,811.0,811.0
0.007,6,10,1989,5,910,1.0,642.0,642.0,5,1079,1.0,811.0,811.0
0.008,17,2,179,1,71,0.0,43.0,43.0,1,108,0.0,80.0,80.0
0.009,6,10,1972,5,910,2.0,642.0,642.0,5,1062,2.0,794.0,794.0
0.016,6,10,1983,5,910,3.0,642.0,642.0,5,1073,4.0,805.0,805.0
0.012,6,10,1990,5,911,3.0,643.0,643.0,5,1079,2.0,811.0,811.0
0.019,6,10,1631,5,848,4.0,580.0,580.0,5,783,4.0,515.0,515.0
15.085,17,16,8426,8,6305,2150.0,1350.0,760.0,8,2121,2150.0,1350.0,237.0
0.044,17,2,152,1,76,0.0,48.0,48.0,1,76,0.0,48.0,48.0
0.005,6,10,2006,5,927,1.0,659.0,659.0,5,1079,1.0,811.0,811.0
0.015,6,10,1983,5,910,3.0,642.0,642.0,5,1073,3.0,805.0,805.0
0.124,17,2,80,1,32,0.0,4.0,4.0,1,48,0.0,20.0,20.0
0.004,6,10,2000,5,927,1.0,659.0,659.0,5,1073,1.0,805.0,805.0
40.068,17,10,676,5,460,10015.0,104.0,64.0,5,216,10016.0,20.0,15.0
0.007,17,2,179,1,71,0.0,43.0,43.0,1,108,0.0,80.0,80.0
0.005,6,10,1689,5,839,1.0,571.0,571.0,5,850,1.0,582.0,582.0
0.012,6,10,1990,5,911,2.0,643.0,643.0,5,1079,2.0,811.0,811.0
0.011,6,10,1989,5,910,2.0,642.0,642.0,5,1079,2.0,811.0,811.0
0.005,6,10,1989,5,927,1.0,659.0,659.0,5,1062,1.0,794.0,794.0
0.12,6,10,1506,5,395,25.0,127.0,127.0,5,1111,24.0,843.0,843.0
0.006,6,10,1547,5,764,1.0,496.0,496.0,5,783,1.0,515.0,515.0
240.09,6,31,9142,15,6763,17149.0,1887.0,665.0,16,2379,16005.0,580.0,192.0
0.006,6,10,1689,5,839,1.0,571.0,571.0,5,850,1.0,582.0,582.0
0.011,6,10,1990,5,911,2.0,643.0,643.0,5,1079,2.0,811.0,811.0
0.007,6,10,1854,5,889,1.0,621.0,621.0,5,965,1.0,697.0,697.0
0.001,17,2,180,1,66,0.0,38.0,38.0,1,114,0.0,86.0,86.0
0.004,6,10,1779,5,928,1.0,660.0,660.0,5,851,1.0,583.0,583.0
15.08,17,15,8455,8,6249,2150.0,1350.0,753.0,7,2206,2508.0,1350.0,287.0
0.011,6,10,1972,5,910,2.0,642.0,642.0,5,1062,2.0,794.0,794.0
11.02,17,28,4422,14,1994,839.0,269.0,114.0,14,2428,839.0,587.0,145.0
11.019,17,28,4422,14,1995,838.0,270.0,114.0,14,2427,838.0,586.0,145.0
0.026,6,10,1989,5,910,6.0,642.0,642.0,5,1079,6.0,811.0,811.0
0.003,17,4,284,2,120,0.0,32.0,32.0,2,164,0.0,60.0,54.0
300.188,6,24,7555,13,2695,25015.0,1368.0,402.0,11,4860,30018.0,1655.0,1073.0
0.005,6,10,2006,5,927,1.0,659.0,659.0,5,1079,1.0,811.0,811.0
0.01,6,13,3735,7,497,1.0,125.0,125.0,6,3238,1.0,1470.0,1459.0
0.009,6,10,1989,5,910,2.0,642.0,642.0,5,1079,2.0,811.0,811.0
0.005,6,10,1643,5,860,1.0,592.0,592.0,5,783,1.0,515.0,515.0
40.061,17,10,676,5,460,10014.0,104.0,64.0,5,216,10014.0,20.0,15.0
0.122,6,10,1506,5,395,25.0,127.0,127.0,5,1111,24.0,843.0,843.0
0.019,6,10,1972,5,910,4.0,642.0,642.0,5,1062,4.0,794.0,794.0
0.005,17,2,140,1,62,0.0,34.0,34.0,1,78,0.0,50.0,50.0
0.013,6,10,1972,5,910,3.0,642.0,642.0,5,1062,3.0,794.0,794.0
0.067,6,28,10381,15,8942,4.0,2883.0,1166.0,13,1439,4.0,346.0,127.0
0.075,6,10,1506,5,395,14.0,127.0,127.0,5,1111,17.0,843.0,843.0
1728.4,6,48,2957,31,1800,57613.0,35.0,35.0,17,1157,108019.0,31.0,31.0
40.069,17,10,676,5,460,10014.0,104.0,64.0,5,216,10016.0,20.0,15.0
0.005,17,2,170,1,65,0.0,37.0,37.0,1,105,0.0,77.0,77.0
0.005,6,10,2007,5,928,1.0,660.0,660.0,5,1079,1.0,811.0,811.0
40.058,17,10,676,5,460,10013.0,104.0,64.0,5,216,10013.0,20.0,15.0
0.009,6,10,1989,5,910,2.0,642.0,642.0,5,1079,2.0,811.0,811.0
0.006,6,10,1689,5,839,1.0,571.0,571.0,5,850,1.0,582.0,582.0
0.127,17,2,412,1,61,0.0,33.0,33.0,1,351,0.0,323.0,323.0
0.005,6,10,2006,5,927,1.0,659.0,659.0,5,1079,1.0,811.0,811.0
0.089,6,10,1506,5,395,20.0,127.0,127.0,5,1111,18.0,843.0,843.0
0.001,17,2,136,1,60,0.0,32.0,32.0,1,76,0.0,48.0,48.0
0.01,6,10,1990,5,911,2.0,643.0,643.0,5,1079,2.0,811.0,811.0
0.007,17,2,194,1,59,0.0,31.0,31.0,1,135,0.0,107.0,107.0
40.073,17,10,676,5,460,10015.0,104.0,64.0,5,216,10017.0,20.0,15.0
0.001,17,2,174,1,72,0.0,44.0,44.0,1,102,0.0,74.0,74.0
1741.94,6,304,97817,188,86467,9315.0,2001.0,684.0,116,11350,15146.0,452.0,70.0
0.005,6,10,1989,5,927,1.0,659.0,659.0,5,1062,1.0,794.0,794.0
15.081,17,15,9239,8,6902,2149.0,1350.0,834.0,7,2337,2508.0,1350.0,305.0
0.005,6,10,2007,5,928,1.0,660.0,660.0,5,1079,1.0,811.0,811.0
0.001,17,2,180,1,66,0.0,38.0,38.0,1,114,0.0,86.0,86.0
0.089,6,10,1506,5,395,19.0,127.0,127.0,5,1111,18.0,843.0,843.0
0.007,6,10,1989,5,910,1.0,642.0,642.0,5,1079,1.0,811.0,811.0
0.005,6,13,3747,7,509,0.0,137.0,137.0,6,3238,0.0,1470.0,1459.0
0.005,6,10,2007,5,928,1.0,660.0,660.0,5,1079,1.0,811.0,811.0
0.005,6,10,2006,5,927,1.0,659.0,659.0,5,1079,1.0,811.0,811.0
40.085,17,10,676,5,460,10020.0,104.0,64.0,5,216,10020.0,20.0,15.0
0.012,6,10,1989,5,910,3.0,642.0,642.0,5,1079,3.0,811.0,811.0
0.016,6,10,1677,5,827,4.0,559.0,559.0,5,850,3.0,582.0,582.0
240.448,6,36,10200,19,1935,13356.0,555.0,187.0,17,8265,15025.0,1661.0,671.0
0.012,6,10,1677,5,827,2.0,559.0,559.0,5,850,2.0,582.0,582.0
0.075,6,10,1506,5,395,16.0,127.0,127.0,5,1111,15.0,843.0,843.0
0.008,6,10,1990,5,911,2.0,643.0,643.0,5,1079,1.0,811.0,811.0
40.065,17,10,676,5,460,10014.0,104.0,64.0,5,216,10015.0,20.0,15.0
0.005,6,10,2000,5,927,1.0,659.0,659.0,5,1073,1.0,805.0,805.0
0.102,6,10,1506,5,395,21.0,127.0,127.0,5,1111,24.0,843.0,843.0
0.095,6,10,1506,5,395,21.0,127.0,127.0,5,1111,21.0,843.0,843.0
0.013,6,10,1990,5,911,3.0,643.0,643.0,5,1079,3.0,811.0,811.0
0.009,6,10,1989,5,910,2.0,642.0,642.0,5,1079,2.0,811.0,811.0
0.001,17,2,174,1,72,0.0,44.0,44.0,1,102,0.0,74.0,74.0
0.111,6,10,1506,5,395,24.0,127.0,127.0,5,1111,21.0,843.0,843.0
0.016,6,10,1990,5,911,4.0,643.0,643.0,5,1079,4.0,811.0,811.0
0.012,6,10,1990,5,911,2.0,643.0,643.0,5,1079,3.0,811.0,811.0
0.076,6,10,1506,5,395,16.0,127.0,127.0,5,1111,16.0,843.0,843.0
0.019,6,10,1983,5,910,4.0,642.0,642.0,5,1073,4.0,805.0,805.0
0.004,6,10,1702,5,863,1.0,595.0,595.0,5,839,1.0,571.0,571.0
0.999,6,13,3922,7,2139,125.0,1328.0,923.0,6,1783,150.0,1539.0,1539.0
40.055,17,10,676,5,460,10012.0,104.0,64.0,5,216,10013.0,20.0,15.0
0.006,6,10,1643,5,860,1.0,592.0,592.0,5,783,1.0,515.0,515.0
0.011,6,10,1677,5,827,2.0,559.0,559.0,5,850,2.0,582.0,582.0
0.037,17,4,284,2,120,0.0,32.0,32.0,2,164,34.0,60.0,54.0
10.934,17,28,4418,14,1994,832.0,269.0,114.0,14,2424,832.0,587.0,145.0
0.079,6,10,1506,5,395,17.0,127.0,127.0,5,1111,15.0,843.0,843.0
0.079,6,10,1506,5,395,16.0,127.0,127.0,5,1111,17.0,843.0,843.0
0.012,6,10,1989,5,910,2.0,642.0,642.0,5,1079,2.0,811.0,811.0
0.117,6,10,1506,5,395,26.0,127.0,127.0,5,1111,26.0,843.0,843.0
0.006,17,2,214,1,75,0.0,47.0,47.0,1,139,0.0,111.0,111.0
0.005,6,10,2000,5,927,1.0,659.0,659.0,5,1073,1.0,805.0,805.0
0.121,6,10,1506,5,395,27.0,127.0,127.0,5,1111,26.0,843.0,843.0
240.013,6,9,787,5,488,60003.0,232.0,232.0,4,299,80003.0,83.0,83.0
0.01,6,10,1677,5,827,2.0,559.0,559.0,5,850,2.0,582.0,582.0
0.005,6,10,2006,5,927,1.0,659.0,659.0,5,1079,1.0,811.0,811.0
0.172,17,2,152,1,76,0.0,48.0,48.0,1,76,0.0,48.0,48.0
240.105,6,30,7289,15,4716,17150.0,1368.0,491.0,15,2573,17150.0,580.0,223.0
0.022,6,10,1990,5,911,5.0,643.0,643.0,5,1079,5.0,811.0,811.0
0.093,6,10,1506,5,395,19.0,127.0,127.0,5,1111,19.0,843.0,843.0
0.008,6,10,1972,5,910,2.0,642.0,642.0,5,1062,1.0,794.0,794.0
0.004,17,2,136,1,60,0.0,32.0,32.0,1,76,0.0,48.0,48.0
240.085,6,16,4481,9,963,30010.0,238.0,166.0,7,3518,40013.0,1402.0,786.0
0.007,17,2,194,1,59,0.0,31.0,31.0,1,135,0.0,107.0,107.0
0.003,17,2,148,1,60,0.0,32.0,32.0,1,88,0.0,60.0,60.0
0.059,6,10,1506,5,395,13.0,127.0,127.0,5,1111,13.0,843.0,843.0
70.182,6,13,796,6,378,14036.0,46.0,46.0,7,418,11675.0,46.0,46.0
0.081,6,10,1506,5,395,19.0,127.0,127.0,5,1111,17.0,843.0,843.0
0.118,6,10,1506,5,395,26.0,127.0,127.0,5,1111,26.0,843.0,843.0
0.011,6,13,3735,7,497,1.0,125.0,125.0,6,3238,2.0,1470.0,1459.0
0.073,6,10,1506,5,395,16.0,127.0,127.0,5,1111,17.0,843.0,843.0
0.046,17,2,140,1,62,0.0,34.0,34.0,1,78,0.0,50.0,50.0
0.126,6,10,1506,5,395,21.0,127.0,127.0,5,1111,26.0,843.0,843.0
0.006,6,10,1989,5,927,1.0,659.0,659.0,5,1062,1.0,794.0,794.0
0.075,6,10,1506,5,395,17.0,127.0,127.0,5,1111,16.0,843.0,843.0
0.181,6,3,453,2,321,181.0,241.0,241.0,1,132,0.0,92.0,92.0
0.134,6,10,1506,5,395,24.0,127.0,127.0,5,1111,31.0,843.0,843.0
0.355,17,45,21139,23,17141,16.0,1350.0,717.0,22,3998,15.0,1350.0,153.0
15.076,17,15,9239,8,6902,2149.0,1350.0,834.0,7,2337,2507.0,1350.0,305.0
0.007,6,10,1547,5,764,1.0,496.0,496.0,5,783,1.0,515.0,515.0
273.038,17,18,1008,9,640,34114.0,48.0,43.0,9,368,34114.0,20.0,12.0
240.198,6,29,11756,14,5736,18476.0,1756.0,1000.0,15,6020,17156.0,1656.0,747.0
66.246,6,27,17752,15,9810,4731.0,2804.0,1503.0,12,7942,6007.0,2313.0,1218.0
0.084,6,10,1506,5,395,18.0,127.0,127.0,5,1111,20.0,843.0,843.0
240.478,6,39,9797,20,2226,12656.0,746.0,235.0,19,7571,13359.0,1402.0,548.0
0.006,6,10,1547,5,764,1.0,496.0,496.0,5,783,1.0,515.0,515.0
40.061,17,10,676,5,460,10014.0,104.0,64.0,5,216,10014.0,20.0,15.0
0.082,6,10,1506,5,395,16.0,127.0,127.0,5,1111,18.0,843.0,843.0
170.426,17,84,11928,42,2803,4156.0,44.0,38.0,42,9125,4156.0,239.0,189.0
0.095,6,10,1506,5,395,21.0,127.0,127.0,5,1111,19.0,843.0,843.0
240.091,6,16,4482,9,963,30011.0,238.0,166.0,7,3519,40014.0,1402.0,786.0
0.005,6,10,1989,5,927,1.0,659.0,659.0,5,1062,1.0,794.0,794.0
0.008,17,2,307,1,61,0.0,33.0,33.0,1,246,0.0,218.0,218.0
0.075,6,10,1506,5,395,16.0,127.0,127.0,5,1111,15.0,843.0,843.0
0.005,6,10,1989,5,927,1.0,659.0,659.0,5,1062,1.0,794.0,794.0
0.005,17,2,213,1,69,0.0,41.0,41.0,1,144,0.0,116.0,116.0
0.009,6,10,1677,5,827,2.0,559.0,559.0,5,850,2.0,582.0,582.0
0.101,6,10,1506,5,395,22.0,127.0,127.0,5,1111,23.0,843.0,843.0
0.025,6,10,1989,5,910,6.0,642.0,642.0,5,1079,6.0,811.0,811.0
0.006,6,10,1762,5,911,1.0,643.0,643.0,5,851,1.0,583.0,583.0
0.007,6,10,1689,5,839,1.0,571.0,571.0,5,850,1.0,582.0,582.0
0.007,6,10,1854,5,889,1.0,621.0,621.0,5,965,1.0,697.0,697.0
15.07,17,14,9190,8,6902,2148.0,1350.0,834.0,6,2288,3008.0,1350.0,353.0
0.017,6,10,1989,5,910,4.0,642.0,642.0,5,1079,4.0,811.0,811.0
0.103,6,10,1506,5,395,22.0,127.0,127.0,5,1111,24.0,843.0,843.0
0.003,17,2,136,1,60,0.0,32.0,32.0,1,76,0.0,48.0,48.0
0.004,17,2,136,1,60,0.0,32.0,32.0,1,76,0.0,48.0,48.0
0.001,17,2,180,1,66,0.0,38.0,38.0,1,114,0.0,86.0,86.0
0.005,6,10,2006,5,927,1.0,659.0,659.0,5,1079,1.0,811.0,811.0
0.006,6,10,1643,5,860,1.0,592.0,592.0,5,783,1.0,515.0,515.0
0.013,17,2,152,1,56,0.0,28.0,28.0,1,96,0.0,68.0,68.0
0.098,6,10,1506,5,395,23.0,127.0,127.0,5,1111,22.0,843.0,843.0
1778.626,17,144,41760,72,22752,25050.0,288.0,288.0,72,19008,25050.0,236.0,236.0
0.01,6,10,1677,5,827,2.0,559.0,559.0,5,850,2.0,582.0,582.0
0.001,17,2,180,1,66,0.0,38.0,38.0,1,114,0.0,86.0,86.0
0.04,17,2,148,1,60,0.0,32.0,32.0,1,88,0.0,60.0,60.0
0.007,6,10,1989,5,910,1.0,642.0,642.0,5,1079,1.0,811.0,811.0
0.09,6,10,1506,5,395,22.0,127.0,127.0,5,1111,19.0,843.0,843.0
0.004,6,10,1989,5,927,1.0,659.0,659.0,5,1062,1.0,794.0,794.0
40.078,17,10,676,5,460,10018.0,104.0,64.0,5,216,10018.0,20.0,15.0
0.113,6,10,1506,5,395,25.0,127.0,127.0,5,1111,24.0,843.0,843.0
0.012,6,10,1989,5,910,3.0,642.0,642.0,5,1079,3.0,811.0,811.0
0.021,6,10,1762,5,911,5.0,643.0,643.0,5,851,5.0,583.0,583.0
0.005,6,13,3747,7,509,0.0,137.0,137.0,6,3238,0.0,1470.0,1459.0
0.014,6,10,1989,5,910,3.0,642.0,642.0,5,1079,3.0,811.0,811.0
0.005,6,10,2000,5,927,1.0,659.0,659.0,5,1073,1.0,805.0,805.0
0.07,6,10,1506,5,395,15.0,127.0,127.0,5,1111,15.0,843.0,843.0
0.011,6,10,1990,5,911,2.0,643.0,643.0,5,1079,2.0,811.0,811.0
40.069,17,10,676,5,460,10016.0,104.0,64.0,5,216,10016.0,20.0,15.0
0.149,6,10,1506,5,395,33.0,127.0,127.0,5,1111,31.0,843.0,843.0
240.02,6,9,787,5,488,60005.0,232.0,232.0,4,299,80005.0,83.0,83.0
0.097,6,10,1506,5,395,23.0,127.0,127.0,5,1111,22.0,843.0,843.0
0.091,6,10,1506,5,395,22.0,127.0,127.0,5,1111,20.0,843.0,843.0
0.003,17,2,148,1,60,0.0,32.0,32.0,1,88,0.0,60.0,60.0
40.086,17,10,676,5,460,10018.0,104.0,64.0,5,216,10020.0,20.0,15.0
0.005,6,13,3747,7,509,0.0,137.0,137.0,6,3238,1.0,1470.0,1459.0
240.093,6,31,9609,16,7013,16006.0,2086.0,687.0,15,2596,17149.0,580.0,226.0
0.005,6,10,2000,5,927,1.0,659.0,659.0,5,1073,1.0,805.0,805.0
0.117,6,10,1506,5,395,26.0,127.0,127.0,5,1111,22.0,843.0,843.0
0.001,17,2,136,1,60,0.0,32.0,32.0,1,76,0.0,48.0,48.0
0.001,17,2,180,1,65,0.0,37.0,37.0,1,115,0.0,87.0,87.0
0.002,17,2,152,1,76,0.0,48.0,48.0,1,76,0.0,48.0,48.0
0.015,6,10,1972,5,910,3.0,642.0,642.0,5,1062,3.0,794.0,794.0
40.15,17,10,676,5,460,10034.0,104.0,64.0,5,216,10036.0,20.0,15.0
0.005,6,10,2000,5,927,1.0,659.0,659.0,5,1073,1.0,805.0,805.0
328.344,17,20,1124,10,716,36469.0,48.0,43.0,10,408,36468.0,20.0,12.0
0.008,6,10,1990,5,911,2.0,643.0,643.0,5,1079,2.0,811.0,811.0
0.132,6,10,1506,5,395,30.0,127.0,127.0,5,1111,30.0,843.0,843.0
0.01,6,10,1972,5,910,2.0,642.0,642.0,5,1062,2.0,794.0,794.0
0.005,17,2,164,1,74,0.0,46.0,46.0,1,90,0.0,62.0,62.0
0.004,6,10,2006,5,927,1.0,659.0,659.0,5,1079,1.0,811.0,811.0
0.178,17,4,596,2,122,136.0,33.0,33.0,2,474,174.0,323.0,209.0
0.071,17,2,148,1,60,0.0,32.0,32.0,1,88,0.0,60.0,60.0
0.001,17,2,136,1,60,0.0,32.0,32.0,1,76,0.0,48.0,48.0
0.007,6,10,1972,5,910,1.0,642.0,642.0,5,1062,1.0,794.0,794.0
0.009,6,10,1989,5,910,2.0,642.0,642.0,5,1079,2.0,811.0,811.0
0.039,17,2,144,1,64,0.0,36.0,36.0,1,80,0.0,52.0,52.0
0.009,6,10,1990,5,911,2.0,643.0,643.0,5,1079,2.0,811.0,811.0
0.037,17,2,148,1,60,0.0,32.0,32.0,1,88,0.0,60.0,60.0
66.454,6,15,922,7,418,11075.0,46.0,46.0,8,504,9474.0,46.0,46.0
0.059,17,2,80,1,32,0.0,4.0,4.0,1,48,0.0,20.0,20.0
0.012,6,10,1762,5,911,3.0,643.0,643.0,5,851,2.0,583.0,583.0
240.092,6,16,4481,9,963,30011.0,238.0,166.0,7,3518,40014.0,1402.0,786.0
1755.165,6,483,69782,262,35928,6724.0,613.0,192.0,221,33854,7977.0,613.0,153.0
0.01,6,10,1972,5,910,2.0,642.0,642.0,5,1062,2.0,794.0,794.0
0.005,17,2,179,1,71,0.0,43.0,43.0,1,108,0.0,80.0,80.0
0.005,6,10,1774,5,923,1.0,655.0,655.0,5,851,1.0,583.0,583.0
361.804,6,19,1689,15,978,25843.0,190.0,190.0,4,711,80013.0,495.0,495.0
0.005,6,13,3747,7,509,0.0,137.0,137.0,6,3238,1.0,1470.0,1459.0
0.031,6,13,3735,7,497,5.0,125.0,125.0,6,3238,6.0,1470.0,1459.0
0.08,6,10,1506,5,395,16.0,127.0,127.0,5,1111,18.0,843.0,843.0
0.04,17,4,420,2,122,0.0,33.0,33.0,2,298,35.0,145.0,121.0
0.004,17,2,148,1,60,0.0,32.0,32.0,1,88,0.0,60.0,60.0
0.164,6,10,1506,5,395,29.0,127.0,127.0,5,1111,39.0,843.0,843.0
0.016,6,10,1972,5,910,3.0,642.0,642.0,5,1062,4.0,794.0,794.0
0.003,17,2,148,1,60,0.0,32.0,32.0,1,88,0.0,60.0,60.0
0.129,17,2,182,1,65,0.0,37.0,37.0,1,117,0.0,89.0,89.0
0.005,6,10,2006,5,927,1.0,659.0,659.0,5,1079,1.0,811.0,811.0
0.014,6,10,1972,5,910,3.0,642.0,642.0,5,1062,3.0,794.0,794.0
0.004,17,2,148,1,60,0.0,32.0,32.0,1,88,0.0,60.0,60.0
0.005,17,2,170,1,65,0.0,37.0,37.0,1,105,0.0,77.0,77.0
0.005,17,2,164,1,74,0.0,46.0,46.0,1,90,0.0,62.0,62.0
240.117,6,16,4481,9,963,30014.0,238.0,166.0,7,3518,40018.0,1402.0,786.0
0.001,17,2,180,1,65,0.0,37.0,37.0,1,115,0.0,87.0,87.0
0.005,17,2,154,1,69,0.0,41.0,41.0,1,85,0.0,57.0,57.0
0.018,6,10,1990,5,911,4.0,643.0,643.0,5,1079,4.0,811.0,811.0
0.006,6,10,1779,5,928,1.0,660.0,660.0,5,851,1.0,583.0,583.0
0.008,6,10,1989,5,910,2.0,642.0,642.0,5,1079,2.0,811.0,811.0
180.083,17,74,10376,37,2472,5002.0,44.0,38.0,37,7904,5002.0,261.0,185.0
0.099,6,10,1506,5,395,21.0,127.0,127.0,5,1111,23.0,843.0,843.0
0.091,6,10,1506,5,395,20.0,127.0,127.0,5,1111,17.0,843.0,843.0
0.139,6,10,1506,5,395,31.0,127.0,127.0,5,1111,29.0,843.0,843.0
0.038,17,2,170,1,65,0.0,37.0,37.0,1,105,0.0,77.0,77.0
9.035,17,6,376,5,280,2258.0,28.0,28.0,1,96,0.0,68.0,68.0
0.01,6,10,1989,5,910,2.0,642.0,642.0,5,1079,2.0,811.0,811.0
240.5,6,33,8638,17,1837,15029.0,570.0,189.0,16,6801,16031.0,1402.0,597.0
0.011,6,10,1677,5,827,2.0,559.0,559.0,5,850,2.0,582.0,582.0
10.89,17,28,4421,14,1993,829.0,268.0,114.0,14,2428,829.0,587.0,145.0
0.003,17,2,148,1,60,0.0,32.0,32.0,1,88,0.0,60.0,60.0
0.005,6,10,2007,5,928,1.0,660.0,660.0,5,1079,1.0,811.0,811.0
310.771,17,20,1124,10,716,34515.0,48.0,43.0,10,408,34515.0,20.0,12.0
1762.074,6,443,66194,258,35614,6856.0,613.0,194.0,185,30580,9576.0,453.0,145.0
0.146,6,10,1506,5,395,34.0,127.0,127.0,5,1111,27.0,843.0,843.0
0.088,6,10,1506,5,395,20.0,127.0,127.0,5,1111,17.0,843.0,843.0
0.004,6,10,2006,5,927,1.0,659.0,659.0,5,1079,1.0,811.0,811.0
0.005,6,13,3747,7,509,0.0,137.0,137.0,6,3238,1.0,1470.0,1459.0
0.007,17,2,299,1,65,0.0,37.0,37.0,1,234,0.0,206.0,206.0
0.005,6,10,2000,5,927,1.0,659.0,659.0,5,1073,1.0,805.0,805.0
1786.429,6,154,19574,92,13852,19631.0,302.0,302.0,62,5722,29285.0,83.0,83.0
0.01,6,10,1990,5,911,2.0,643.0,643.0,5,1079,2.0,811.0,811.0
308.546,17,20,1124,10,716,34276.0,48.0,43.0,10,408,34276.0,20.0,12.0
0.005,6,10,1989,5,927,1.0,659.0,659.0,5,1062,1.0,794.0,794.0
40.054,17,10,676,5,460,10012.0,104.0,64.0,5,216,10012.0,20.0,15.0
0.013,6,10,1989,5,910,3.0,642.0,642.0,5,1079,3.0,811.0,811.0
0.005,6,10,2000,5,927,1.0,659.0,659.0,5,1073,1.0,805.0,805.0
0.009,6,10,1972,5,910,2.0,642.0,642.0,5,1062,2.0,794.0,794.0
11.281,17,28,4423,14,1994,855.0,269.0,114.0,14,2429,855.0,588.0,145.0
0.004,17,2,148,1,60,0.0,32.0,32.0,1,88,0.0,60.0,60.0
0.053,17,2,152,1,76,0.0,48.0,48.0,1,76,0.0,48.0,48.0
240.017,6,9,787,5,488,60004.0,232.0,232.0,4,299,80004.0,83.0,83.0
0.013,6,10,1677,5,827,3.0,559.0,559.0,5,850,3.0,582.0,582.0
0.011,6,10,1677,5,827,2.0,559.0,559.0,5,850,2.0,582.0,582.0
0.005,6,10,2006,5,927,1.0,659.0,659.0,5,1079,1.0,811.0,811.0
0.005,17,2,180,1,58,0.0,30.0,30.0,1,122,0.0,94.0,94.0
0.001,17,2,166,1,75,0.0,47.0,47.0,1,91,0.0,63.0,63.0
0.072,6,10,1506,5,395,15.0,127.0,127.0,5,1111,15.0,843.0,843.0
0.007,6,10,1547,5,764,1.0,496.0,496.0,5,783,1.0,515.0,515.0
0.079,6,10,1506,5,395,18.0,127.0,127.0,5,1111,17.0,843.0,843.0
0.001,17,2,166,1,75,0.0,47.0,47.0,1,91,0.0,63.0,63.0
0.064,6,10,1506,5,395,13.0,127.0,127.0,5,1111,14.0,843.0,843.0
0.005,6,10,1989,5,927,1.0,659.0,659.0,5,1062,1.0,794.0,794.0
0.012,6,10,1677,5,827,3.0,559.0,559.0,5,850,2.0,582.0,582.0
0.044,17,2,152,1,76,0.0,48.0,48.0,1,76,0.0,48.0,48.0
0.014,6,10,1972,5,910,3.0,642.0,642.0,5,1062,3.0,794.0,794.0
0.043,17,2,412,1,61,0.0,33.0,33.0,1,351,0.0,323.0,323.0
0.131,17,2,412,1,61,0.0,33.0,33.0,1,351,0.0,323.0,323.0
0.005,6,10,1689,5,839,1.0,571.0,571.0,5,850,1.0,582.0,582.0
15.52,17,54,34617,30,28463,534.0,1350.0,920.0,24,6154,673.0,1350.0,228.0
0.069,6,10,1506,5,395,16.0,127.0,127.0,5,1111,17.0,843.0,843.0
0.013,6,10,1990,5,911,3.0,643.0,643.0,5,1079,3.0,811.0,811.0
0.006,17,2,262,1,66,0.0,38.0,38.0,1,196,0.0,168.0,168.0
0.005,6,10,2006,5,927,1.0,659.0,659.0,5,1079,1.0,811.0,811.0
0.095,17,2,152,1,76,0.0,48.0,48.0,1,76,0.0,48.0,48.0
40.057,17,10,676,5,460,10013.0,104.0,64.0,5,216,10013.0,20.0,15.0
0.079,6,10,1506,5,395,18.0,127.0,127.0,5,1111,17.0,843.0,843.0
0.039,17,2,412,1,61,0.0,33.0,33.0,1,351,0.0,323.0,323.0
40.054,17,10,676,5,460,10010.0,104.0,64.0,5,216,10012.0,20.0,15.0
0.004,6,10,1702,5,863,0.0,595.0,595.0,5,839,1.0,571.0,571.0
40.062,17,10,676,5,460,10013.0,104.0,64.0,5,216,10014.0,20.0,15.0
0.085,6,10,1506,5,395,19.0,127.0,127.0,5,1111,20.0,843.0,843.0
0.014,6,10,1990,5,911,3.0,643.0,643.0,5,1079,3.0,811.0,811.0
0.001,17,2,180,1,66,0.0,38.0,38.0,1,114,0.0,86.0,86.0
0.005,6,10,2000,5,927,1.0,659.0,659.0,5,1073,1.0,805.0,805.0
240.091,6,31,9235,15,6929,17149.0,2053.0,683.0,16,2306,16005.0,580.0,183.0
0.005,6,10,1854,5,889,1.0,621.0,621.0,5,965,1.0,697.0,697.0
0.007,6,10,1854,5,889,1.0,621.0,621.0,5,965,1.0,697.0,697.0
0.012,6,10,1989,5,910,3.0,642.0,642.0,5,1079,3.0,811.0,811.0
0.011,6,10,1631,5,848,2.0,580.0,580.0,5,783,2.0,515.0,515.0
0.011,6,10,1762,5,911,2.0,643.0,643.0,5,851,2.0,583.0,583.0
1786.714,6,154,19574,92,13852,19634.0,302.0,302.0,62,5722,29290.0,83.0,83.0
0.005,6,10,1989,5,927,1.0,659.0,659.0,5,1062,1.0,794.0,794.0
0.218,6,16,2669,8,1395,31.0,533.0,323.0,8,1274,20.0,529.0,212.0
0.01,6,10,2006,5,927,2.0,659.0,659.0,5,1079,1.0,811.0,811.0
0.005,6,10,2007,5,928,1.0,660.0,660.0,5,1079,1.0,811.0,811.0
9.039,17,6,376,5,280,2259.0,28.0,28.0,1,96,0.0,68.0,68.0
11.321,17,28,4420,14,1993,858.0,268.0,114.0,14,2427,858.0,586.0,145.0
1786.261,6,154,19574,92,13852,19629.0,302.0,302.0,62,5722,29282.0,83.0,83.0
0.006,6,10,1689,5,839,1.0,571.0,571.0,5,850,1.0,582.0,582.0
0.013,17,2,152,1,56,0.0,28.0,28.0,1,96,0.0,68.0,68.0
0.013,6,10,1972,5,910,3.0,642.0,642.0,5,1062,3.0,794.0,794.0
40.059,17,10,676,5,460,10013.0,104.0,64.0,5,216,10014.0,20.0,15.0
0.005,6,10,2006,5,927,1.0,659.0,659.0,5,1079,1.0,811.0,811.0
0.011,6,10,1990,5,911,2.0,643.0,643.0,5,1079,2.0,811.0,811.0
0.005,6,10,1689,5,839,1.0,571.0,571.0,5,850,1.0,582.0,582.0
15.079,17,16,9039,8,6801,2150.0,1350.0,822.0,8,2238,2149.0,1350.0,251.0
0.005,6,10,2006,5,927,1.0,659.0,659.0,5,1079,1.0,811.0,811.0
0.008,6,10,1983,5,910,2.0,642.0,642.0,5,1073,1.0,805.0,805.0
0.018,6,14,3787,7,497,2.0,125.0,125.0,7,3290,2.0,1448.0,972.0
1799.119,17,2944,225067,1463,118649,1230.0,84.0,53.0,1481,106418,1215.0,225.0,43.0
0.003,17,4,284,2,120,0.0,32.0,32.0,2,164,0.0,60.0,54.0
0.004,17,2,148,1,60,0.0,32.0,32.0,1,88,0.0,60.0,60.0
0.005,6,10,1774,5,923,1.0,655.0,655.0,5,851,1.0,583.0,583.0
0.005,6,10,1989,5,927,1.0,659.0,659.0,5,1062,1.0,794.0,794.0
0.096,6,10,1506,5,395,23.0,127.0,127.0,5,1111,23.0,843.0,843.0
0.041,17,2,148,1,60,0.0,32.0,32.0,1,88,0.0,60.0,60.0
0.011,6,10,1983,5,910,2.0,642.0,642.0,5,1073,2.0,805.0,805.0
0.014,6,10,1983,5,910,3.0,642.0,642.0,5,1073,3.0,805.0,805.0
0.038,17,4,284,2,120,0.0,32.0,32.0,2,164,34.0,60.0,54.0
15.074,17,15,9238,8,6902,2149.0,1350.0,834.0,7,2336,2507.0,1350.0,305.0
0.004,6,10,1989,5,927,1.0,659.0,659.0,5,1062,1.0,794.0,794.0
40.1,17,10,676,5,460,10022.0,104.0,64.0,5,216,10024.0,20.0,15.0
0.006,6,10,2006,5,927,1.0,659.0,659.0,5,1079,1.0,811.0,811.0
412.511,6,23,2943,8,1906,17146.0,494.0,494.0,15,1037,29464.0,83.0,83.0
1741.859,6,313,99602,191,87891,9167.0,2001.0,677.0,122,11711,14395.0,452.0,71.0
0.011,6,10,1972,5,910,2.0,642.0,642.0,5,1062,2.0,794.0,794.0
0.005,17,2,230,1,68,0.0,40.0,40.0,1,162,0.0,134.0,134.0
300.344,6,16,2170,9,684,37521.0,146.0,146.0,7,1486,50029.0,419.0,398.0
0.001,17,2,136,1,60,0.0,32.0,32.0,1,76,0.0,48.0,48.0
0.072,17,4,420,2,122,0.0,33.0,33.0,2,298,69.0,145.0,121.0
0.009,6,10,1990,5,911,2.0,643.0,643.0,5,1079,2.0,811.0,811.0
0.034,17,2,152,1,76,0.0,48.0,48.0,1,76,0.0,48.0,48.0
280.459,6,21,5995,8,1106,40064.0,267.0,156.0,13,4889,23370.0,1400.0,873.0
0.004,17,2,213,1,69,0.0,41.0,41.0,1,144,0.0,116.0,116.0
0.004,6,13,3690,7,452,0.0,80.0,80.0,6,3238,0.0,1470.0,1459.0
0.012,6,10,1989,5,910,3.0,642.0,642.0,5,1079,3.0,811.0,811.0
0.015,6,10,1990,5,911,3.0,643.0,643.0,5,1079,3.0,811.0,811.0
0.005,6,13,3747,7,509,0.0,137.0,137.0,6,3238,0.0,1470.0,1459.0
40.055,17,10,676,5,460,10013.0,104.0,64.0,5,216,10013.0,20.0,15.0
0.012,6,10,1983,5,910,3.0,642.0,642.0,5,1073,3.0,805.0,805.0
280.292,6,23,6075,10,1186,31143.0,267.0,156.0,13,4889,23355.0,1400.0,873.0
0.005,6,10,1779,5,928,1.0,660.0,660.0,5,851,1.0,583.0,583.0
160.459,17,76,10834,38,2530,4336.0,44.0,38.0,38,8304,4336.0,239.0,190.0
0.005,17,2,144,1,64,0.0,36.0,36.0,1,80,0.0,52.0,52.0
1.886,6,23,7757,13,1537,157.0,517.0,287.0,10,6220,23.0,1402.0,813.0
0.015,6,10,1989,5,910,3.0,642.0,642.0,5,1079,3.0,811.0,811.0
0.038,17,2,148,1,60,0.0,32.0,32.0,1,88,0.0,60.0,60.0
0.052,6,10,1677,5,827,13.0,559.0,559.0,5,850,13.0,582.0,582.0
0.004,6,10,2006,5,927,1.0,659.0,659.0,5,1079,1.0,811.0,811.0
0.005,6,10,1547,5,764,1.0,496.0,496.0,5,783,1.0,515.0,515.0
0.001,17,2,180,1,66,0.0,38.0,38.0,1,114,0.0,86.0,86.0
0.013,17,2,152,1,56,0.0,28.0,28.0,1,96,0.0,68.0,68.0
0.005,17,2,158,1,71,0.0,43.0,43.0,1,87,0.0,59.0,59.0
0.008,6,10,1762,5,911,2.0,643.0,643.0,5,851,1.0,583.0,583.0
0.005,6,10,1774,5,923,1.0,655.0,655.0,5,851,1.0,583.0,583.0
9.036,17,6,376,5,280,2259.0,28.0,28.0,1,96,0.0,68.0,68.0
0.001,17,2,136,1,60,0.0,32.0,32.0,1,76,0.0,48.0,48.0
0.005,6,13,3690,7,452,0.0,80.0,80.0,6,3238,0.0,1470.0,1459.0
0.005,6,14,3736,7,446,0.0,74.0,74.0,7,3290,0.0,1448.0,972.0
0.01,6,10,1631,5,848,2.0,580.0,580.0,5,783,2.0,515.0,515.0
0.006,6,10,1547,5,764,1.0,496.0,496.0,5,783,1.0,515.0,515.0
40.061,17,10,676,5,460,10014.0,104.0,64.0,5,216,10013.0,20.0,15.0
0.005,17,2,169,1,62,0.0,34.0,34.0,1,107,0.0,79.0,79.0
0.014,6,14,3787,7,497,2.0,125.0,125.0,7,3290,2.0,1448.0,972.0
0.005,17,2,222,1,65,0.0,37.0,37.0,1,157,0.0,129.0,129.0
0.006,6,10,1547,5,764,1.0,496.0,496.0,5,783,1.0,515.0,515.0
0.01,6,10,1972,5,910,2.0,642.0,642.0,5,1062,2.0,794.0,794.0
0.069,6,10,1506,5,395,13.0,127.0,127.0,5,1111,15.0,843.0,843.0
0.013,6,10,1989,5,910,3.0,642.0,642.0,5,1079,3.0,811.0,811.0
0.001,17,2,180,1,66,0.0,38.0,38.0,1,114,0.0,86.0,86.0
40.051,17,10,676,5,460,10012.0,104.0,64.0,5,216,10011.0,20.0,15.0
0.006,6,13,3684,7,446,0.0,74.0,74.0,6,3238,1.0,1470.0,1459.0
1729.226,6,60,4400,40,2740,44339.0,33.0,33.0,20,1660,91002.0,31.0,31.0
0.004,6,10,2007,5,928,1.0,660.0,660.0,5,1079,1.0,811.0,811.0
0.004,17,2,136,1,60,0.0,32.0,32.0,1,76,0.0,48.0,48.0
314.494,17,20,1124,10,716,34929.0,48.0,43.0,10,408,34929.0,20.0,12.0
0.004,6,10,2007,5,928,1.0,660.0,660.0,5,1079,1.0,811.0,811.0
66.596,6,24,8653,14,2432,5122.0,1002.0,424.0,10,6221,7381.0,2355.0,948.0
0.005,6,13,3747,7,509,0.0,137.0,137.0,6,3238,1.0,1470.0,1459.0
0.006,6,10,1689,5,839,1.0,571.0,571.0,5,850,1.0,582.0,582.0
0.067,6,10,1506,5,395,15.0,127.0,127.0,5,1111,14.0,843.0,843.0
0.005,17,2,164,1,74,0.0,46.0,46.0,1,90,0.0,62.0,62.0
11.454,17,28,4399,14,2313,868.0,588.0,137.0,14,2086,868.0,269.0,121.0
0.014,6,10,1989,5,910,3.0,642.0,642.0,5,1079,3.0,811.0,811.0
0.074,17,8,3613,4,1874,24.0,1350.0,440.0,4,1739,12.0,1350.0,406.0
0.005,17,2,157,1,59,0.0,31.0,31.0,1,98,0.0,70.0,70.0
1764.735,6,302,97529,187,86391,9487.0,1402.0,672.0,115,11138,15480.0,452.0,70.0
0.105,6,10,1506,5,395,23.0,127.0,127.0,5,1111,21.0,843.0,843.0
0.004,6,10,2000,5,927,1.0,659.0,659.0,5,1073,1.0,805.0,805.0
0.006,17,2,170,1,65,0.0,37.0,37.0,1,105,0.0,77.0,77.0
0.072,6,10,1506,5,395,16.0,127.0,127.0,5,1111,16.0,843.0,843.0
0.004,6,10,2007,5,928,1.0,660.0,660.0,5,1079,1.0,811.0,811.0
0.023,17,2,214,1,75,0.0,47.0,47.0,1,139,0.0,111.0,111.0
0.005,6,10,1779,5,928,1.0,660.0,660.0,5,851,1.0,583.0,583.0
0.131,6,10,1506,5,395,28.0,127.0,127.0,5,1111,28.0,843.0,843.0
240.014,6,9,787,5,488,60003.0,232.0,232.0,4,299,80003.0,83.0,83.0
0.001,17,2,180,1,66,0.0,38.0,38.0,1,114,0.0,86.0,86.0
309.839,17,20,1124,10,716,34420.0,48.0,43.0,10,408,34419.0,20.0,12.0
0.067,17,8,3613,4,1874,22.0,1350.0,440.0,4,1739,11.0,1350.0,406.0
0.02,6,10,1989,5,910,5.0,642.0,642.0,5,1079,5.0,811.0,811.0
240.175,6,20,7401,11,2619,24017.0,1368.0,512.0,9,4782,30021.0,1656.0,1076.0
0.005,6,10,1989,5,927,1.0,659.0,659.0,5,1062,1.0,794.0,794.0
0.016,17,2,198,1,91,0.0,63.0,63.0,1,107,0.0,79.0,79.0
0.068,17,8,3613,4,1874,22.0,1350.0,440.0,4,1739,11.0,1350.0,406.0
0.005,17,2,166,1,75,0.0,47.0,47.0,1,91,0.0,63.0,63.0
0.11,6,10,1506,5,395,23.0,127.0,127.0,5,1111,24.0,843.0,843.0
0.004,6,10,1989,6,979,0.0,659.0,659.0,4,1010,1.0,794.0,794.0
0.009,6,10,1989,5,910,2.0,642.0,642.0,5,1079,2.0,811.0,811.0
0.088,6,10,1506,5,395,19.0,127.0,127.0,5,1111,20.0,843.0,843.0
313.135,17,20,1124,10,716,34780.0,48.0,43.0,10,408,34779.0,20.0,12.0
0.107,6,10,1506,5,395,22.0,127.0,127.0,5,1111,22.0,843.0,843.0
300.394,6,16,2170,9,684,37528.0,146.0,146.0,7,1486,50037.0,419.0,398.0
0.073,6,10,1506,5,395,17.0,127.0,127.0,5,1111,17.0,843.0,843.0
0.004,6,10,1989,5,927,1.0,659.0,659.0,5,1062,1.0,794.0,794.0
0.123,17,2,80,1,32,0.0,4.0,4.0,1,48,0.0,20.0,20.0
0.005,6,13,3747,7,509,0.0,137.0,137.0,6,3238,0.0,1470.0,1459.0
0.008,6,10,1972,5,910,2.0,642.0,642.0,5,1062,1.0,794.0,794.0
15.074,17,15,10568,9,8280,1880.0,1350.0,892.0,6,2288,3008.0,1350.0,353.0
240.016,6,9,787,5,488,60004.0,232.0,232.0,4,299,80004.0,83.0,83.0
0.005,6,10,2006,5,927,1.0,659.0,659.0,5,1079,1.0,811.0,811.0
0.052,6,10,1506,5,395,12.0,127.0,127.0,5,1111,11.0,843.0,843.0
0.01,6,10,1989,5,910,2.0,642.0,642.0,5,1079,2.0,811.0,811.0
0.005,17,2,152,1,68,0.0,40.0,40.0,1,84,0.0,56.0,56.0
0.072,6,10,1506,5,395,13.0,127.0,127.0,5,1111,17.0,843.0,843.0
0.012,6,10,1990,5,911,3.0,643.0,643.0,5,1079,2.0,811.0,811.0
0.001,17,2,136,1,60,0.0,32.0,32.0,1,76,0.0,48.0,48.0
0.004,6,10,2007,5,928,1.0,660.0,660.0,5,1079,1.0,811.0,811.0
0.021,6,10,1989,5,910,5.0,642.0,642.0,5,1079,5.0,811.0,811.0
0.011,17,2,222,1,65,0.0,37.0,37.0,1,157,0.0,129.0,129.0
0.02,6,10,1983,5,910,5.0,642.0,642.0,5,1073,5.0,805.0,805.0
0.015,6,13,3735,7,497,2.0,125.0,125.0,6,3238,2.0,1470.0,1459.0
0.004,17,4,284,2,120,0.0,32.0,32.0,2,164,0.0,60.0,54.0
173.273,17,82,11487,41,2723,4331.0,44.0,38.0,41,8764,4331.0,239.0,185.0
0.22,6,16,2778,8,1396,31.0,533.0,324.0,8,1382,20.0,529.0,239.0
354.038,6,21,1795,16,1030,23602.0,190.0,190.0,5,765,60002.0,464.0,248.0
0.007,6,10,1972,5,910,1.0,642.0,642.0,5,1062,1.0,794.0,794.0
40.073,17,10,676,5,460,10017.0,104.0,64.0,5,216,10017.0,20.0,15.0
0.218,6,16,2669,8,1395,31.0,533.0,323.0,8,1274,19.0,529.0,212.0
0.004,6,10,2007,5,928,1.0,660.0,660.0,5,1079,1.0,811.0,811.0
0.063,6,10,1506,5,395,13.0,127.0,127.0,5,1111,14.0,843.0,843.0
0.005,6,10,2007,5,928,1.0,660.0,660.0,5,1079,1.0,811.0,811.0
0.004,17,2,148,1,60,0.0,32.0,32.0,1,88,0.0,60.0,60.0
0.005,6,10,2007,5,928,1.0,660.0,660.0,5,1079,1.0,811.0,811.0
0.01,6,10,1972,5,910,2.0,642.0,642.0,5,1062,2.0,794.0,794.0
0.005,6,10,2007,5,928,1.0,660.0,660.0,5,1079,1.0,811.0,811.0
0.011,6,11,2041,6,962,2.0,642.0,642.0,5,1079,2.0,811.0,811.0
0.01,6,13,3735,7,497,1.0,125.0,125.0,6,3238,2.0,1470.0,1459.0
0.005,17,2,136,1,60,0.0,32.0,32.0,1,76,0.0,48.0,48.0
177.163,17,84,12160,42,2836,4320.0,44.0,39.0,42,9324,4320.0,239.0,194.0
0.003,17,2,148,1,60,0.0,32.0,32.0,1,88,0.0,60.0,60.0
0.001,17,2,136,1,60,0.0,32.0,32.0,1,76,0.0,48.0,48.0
0.012,6,11,2035,6,962,2.0,642.0,642.0,5,1073,2.0,805.0,805.0
1720.188,6,61,7140,40,4347,44107.0,1640.0,113.0,21,2793,86001.0,1112.0,85.0
0.085,6,10,1506,5,395,18.0,127.0,127.0,5,1111,19.0,843.0,843.0
0.005,6,10,2000,5,927,1.0,659.0,659.0,5,1073,1.0,805.0,805.0
0.005,6,10,1774,5,923,1.0,655.0,655.0,5,851,1.0,583.0,583.0
0.007,6,10,1547,5,764,1.0,496.0,496.0,5,783,1.0,515.0,515.0
0.005,6,10,1779,5,928,1.0,660.0,660.0,5,851,1.0,583.0,583.0
0.004,6,10,2007,5,928,1.0,660.0,660.0,5,1079,1.0,811.0,811.0
0.091,6,10,1506,5,395,19.0,127.0,127.0,5,1111,20.0,843.0,843.0
0.004,6,10,1774,5,923,1.0,655.0,655.0,5,851,1.0,583.0,583.0
0.003,17,2,136,1,60,0.0,32.0,32.0,1,76,0.0,48.0,48.0
0.26,17,2,152,1,76,0.0,48.0,48.0,1,76,0.0,48.0,48.0
0.001,17,2,180,1,66,0.0,38.0,38.0,1,114,0.0,86.0,86.0
0.009,6,12,1926,6,1189,1.0,659.0,434.0,6,737,1.0,417.0,417.0
0.006,6,10,1547,5,764,1.0,496.0,496.0,5,783,1.0,515.0,515.0
0.007,6,10,2007,5,928,1.0,660.0,660.0,5,1079,1.0,811.0,811.0
0.017,6,10,1989,5,910,4.0,642.0,642.0,5,1079,4.0,811.0,811.0
300.029,6,12,1782,7,1348,50004.0,494.0,494.0,5,434,75005.0,83.0,83.0
0.01,6,10,1762,5,911,2.0,643.0,643.0,5,851,2.0,583.0,583.0
0.006,6,10,1854,5,889,1.0,621.0,621.0,5,965,1.0,697.0,697.0
1771.871,6,105,6270,60,3525,30031.0,27.0,27.0,45,2745,40268.0,27.0,27.0
1769.177,17,92,8096,46,4048,39314.0,60.0,60.0,46,4048,39314.0,60.0,60.0
40.094,17,10,676,5,460,10020.0,104.0,64.0,5,216,10022.0,20.0,15.0
0.013,17,2,152,1,56,0.0,28.0,28.0,1,96,0.0,68.0,68.0
0.003,17,2,152,1,76,0.0,48.0,48.0,1,76,0.0,48.0,48.0
0.001,17,2,180,1,66,0.0,38.0,38.0,1,114,0.0,86.0,86.0
0.009,6,10,1990,5,911,2.0,643.0,643.0,5,1079,2.0,811.0,811.0
0.268,17,39,20254,21,17038,13.0,1350.0,783.0,18,3216,12.0,1350.0,150.0
0.037,17,2,156,1,64,0.0,36.0,36.0,1,92,0.0,64.0,64.0
0.009,6,10,1989,5,910,2.0,642.0,642.0,5,1079,2.0,811.0,811.0
0.02,6,10,1990,5,911,4.0,643.0,643.0,5,1079,4.0,811.0,811.0
0.006,6,10,1854,5,889,1.0,621.0,621.0,5,965,1.0,697.0,697.0
0.015,6,10,1990,5,911,3.0,643.0,643.0,5,1079,3.0,811.0,811.0
0.013,6,10,1631,5,848,3.0,580.0,580.0,5,783,3.0,515.0,515.0
0.004,6,10,2000,5,927,1.0,659.0,659.0,5,1073,1.0,805.0,805.0
0.006,17,2,140,1,62,0.0,34.0,34.0,1,78,0.0,50.0,50.0
0.116,6,10,1506,5,395,21.0,127.0,127.0,5,1111,27.0,843.0,843.0
308.962,17,20,1124,10,716,34314.0,48.0,43.0,10,408,34314.0,20.0,12.0
240.086,6,16,4481,9,963,30010.0,238.0,166.0,7,3518,40013.0,1402.0,786.0
0.017,6,10,1677,5,827,4.0,559.0,559.0,5,850,4.0,582.0,582.0
0.006,6,10,1547,5,764,1.0,496.0,496.0,5,783,1.0,515.0,515.0
0.177,6,10,1506,5,395,39.0,127.0,127.0,5,1111,40.0,843.0,843.0
10.923,17,28,4421,14,1994,831.0,269.0,114.0,14,2427,830.0,586.0,145.0
10.954,17,28,4418,14,1994,833.0,269.0,114.0,14,2424,833.0,587.0,145.0
0.005,17,2,230,1,68,0.0,40.0,40.0,1,162,0.0,134.0,134.0
0.007,6,14,3736,7,446,1.0,74.0,74.0,7,3290,1.0,1448.0,972.0
0.004,6,10,2000,5,927,1.0,659.0,659.0,5,1073,1.0,805.0,805.0
0.009,6,10,1989,5,910,2.0,642.0,642.0,5,1079,2.0,811.0,811.0
9.037,17,6,376,5,280,2259.0,28.0,28.0,1,96,0.0,68.0,68.0
0.005,6,10,2007,5,928,1.0,660.0,660.0,5,1079,1.0,811.0,811.0
0.071,17,8,3613,4,1874,23.0,1350.0,440.0,4,1739,10.0,1350.0,406.0
0.033,17,4,284,2,120,0.0,32.0,32.0,2,164,1.0,60.0,54.0
10.988,17,28,4397,14,2311,836.0,586.0,137.0,14,2086,836.0,269.0,121.0
0.152,6,10,1506,5,395,33.0,127.0,127.0,5,1111,34.0,843.0,843.0
0.005,17,2,166,1,75,0.0,47.0,47.0,1,91,0.0,63.0,63.0
0.005,6,10,2006,5,927,1.0,659.0,659.0,5,1079,1.0,811.0,811.0
0.039,17,4,596,2,122,1.0,33.0,33.0,2,474,0.0,323.0,209.0
0.022,6,10,1631,5,848,5.0,580.0,580.0,5,783,5.0,515.0,515.0
0.005,6,10,2006,5,927,1.0,659.0,659.0,5,1079,1.0,811.0,811.0
0.004,6,10,1989,5,927,1.0,659.0,659.0,5,1062,1.0,794.0,794.0
0.08,6,10,1506,5,395,18.0,127.0,127.0,5,1111,18.0,843.0,843.0
0.006,6,10,1989,5,927,1.0,659.0,659.0,5,1062,1.0,794.0,794.0
0.004,6,10,2006,5,927,1.0,659.0,659.0,5,1079,1.0,811.0,811.0
0.004,6,10,2006,5,927,1.0,659.0,659.0,5,1079,1.0,811.0,811.0
0.004,17,4,284,2,120,0.0,32.0,32.0,2,164,1.0,60.0,54.0
0.085,6,10,1506,5,395,17.0,127.0,127.0,5,1111,20.0,843.0,843.0
0.001,17,2,178,1,81,0.0,53.0,53.0,1,97,0.0,69.0,69.0
0.003,6,10,1702,5,863,0.0,595.0,595.0,5,839,0.0,571.0,571.0
0.001,17,2,180,1,66,0.0,38.0,38.0,1,114,0.0,86.0,86.0
0.009,6,10,1989,5,910,2.0,642.0,642.0,5,1079,2.0,811.0,811.0
40.07,17,10,676,5,460,10016.0,104.0,64.0,5,216,10016.0,20.0,15.0
0.007,17,2,132,1,58,0.0,30.0,30.0,1,74,0.0,46.0,46.0
0.003,17,2,170,1,65,0.0,37.0,37.0,1,105,0.0,77.0,77.0
0.014,6,10,1989,5,910,3.0,642.0,642.0,5,1079,3.0,811.0,811.0
0.014,6,10,1677,5,827,3.0,559.0,559.0,5,850,3.0,582.0,582.0
365.947,6,22,2313,16,867,24396.0,195.0,195.0,6,1446,4646.0,419.0,398.0
0.012,6,10,1989,5,910,3.0,642.0,642.0,5,1079,2.0,811.0,811.0
0.106,6,10,1506,5,395,21.0,127.0,127.0,5,1111,24.0,843.0,843.0
352.625,6,20,2210,6,1308,12003.0,494.0,494.0,14,902,27124.0,83.0,83.0
0.006,17,2,215,1,68,0.0,40.0,40.0,1,147,0.0,119.0,119.0
0.009,6,12,1926,6,1189,1.0,659.0,434.0,6,737,1.0,417.0,417.0
0.004,17,2,136,1,60,0.0,32.0,32.0,1,76,0.0,48.0,48.0
0.004,6,10,1779,5,928,1.0,660.0,660.0,5,851,1.0,583.0,583.0
0.014,6,10,1990,5,911,3.0,643.0,643.0,5,1079,3.0,811.0,811.0
0.006,6,10,1547,5,764,1.0,496.0,496.0,5,783,1.0,515.0,515.0
0.108,6,10,1506,5,395,24.0,127.0,127.0,5,1111,24.0,843.0,843.0
322.361,17,20,1124,10,716,35811.0,48.0,43.0,10,408,35811.0,20.0,12.0
0.106,6,10,1506,5,395,22.0,127.0,127.0,5,1111,23.0,843.0,843.0
0.13,17,2,80,1,32,0.0,4.0,4.0,1,48,0.0,20.0,20.0
0.013,6,10,1989,5,910,3.0,642.0,642.0,5,1079,3.0,811.0,811.0
0.004,17,4,284,2,120,0.0,32.0,32.0,2,164,1.0,60.0,54.0
0.005,6,10,2000,5,927,1.0,659.0,659.0,5,1073,1.0,805.0,805.0
0.004,17,4,284,2,120,1.0,32.0,32.0,2,164,1.0,60.0,54.0
0.076,6,10,1506,5,395,17.0,127.0,127.0,5,1111,17.0,843.0,843.0
0.113,6,10,1506,5,395,17.0,127.0,127.0,5,1111,25.0,843.0,843.0
0.017,6,10,1990,5,911,4.0,643.0,643.0,5,1079,4.0,811.0,811.0
0.012,6,10,1972,5,910,2.0,642.0,642.0,5,1062,3.0,794.0,794.0
0.103,6,10,1506,5,395,23.0,127.0,127.0,5,1111,21.0,843.0,843.0
0.009,6,10,1989,5,910,2.0,642.0,642.0,5,1079,2.0,811.0,811.0
240.669,6,37,9658,19,2175,13368.0,747.0,235.0,18,7483,14155.0,1402.0,595.0
148.437,6,22,8496,12,2236,71.0,1345.0,574.0,10,6260,16474.0,2720.0,974.0
0.086,6,10,1506,5,395,19.0,127.0,127.0,5,1111,19.0,843.0,843.0
174.864,6,24,9399,11,1575,72.0,794.0,367.0,13,7824,14560.0,1360.0,810.0
0.009,6,10,1972,5,910,2.0,642.0,642.0,5,1062,2.0,794.0,794.0
0.006,6,10,1990,5,928,1.0,660.0,660.0,5,1062,1.0,794.0,794.0
0.001,17,2,180,1,66,0.0,38.0,38.0,1,114,0.0,86.0,86.0
0.005,17,2,180,1,66,0.0,38.0,38.0,1,114,0.0,86.0,86.0
0.005,6,10,2006,5,927,1.0,659.0,659.0,5,1079,1.0,811.0,811.0
0.071,17,2,170,1,65,0.0,37.0,37.0,1,105,0.0,77.0,77.0
0.004,6,10,1989,5,927,1.0,659.0,659.0,5,1062,1.0,794.0,794.0
240.222,6,26,4772,12,1824,21838.0,555.0,238.0,14,2948,18478.0,1413.0,278.0
0.005,6,10,1989,5,927,1.0,659.0,659.0,5,1062,1.0,794.0,794.0
0.005,6,10,1689,5,839,1.0,571.0,571.0,5,850,1.0,582.0,582.0
0.011,17,2,170,1,65,0.0,37.0,37.0,1,105,0.0,77.0,77.0
0.007,17,2,179,1,71,0.0,43.0,43.0,1,108,0.0,80.0,80.0
0.005,6,10,1989,5,927,1.0,659.0,659.0,5,1062,1.0,794.0,794.0
0.007,6,10,1762,5,911,1.0,643.0,643.0,5,851,1.0,583.0,583.0
0.005,6,10,1989,5,927,1.0,659.0,659.0,5,1062,1.0,794.0,794.0
0.016,6,10,1972,5,910,4.0,642.0,642.0,5,1062,3.0,794.0,794.0
0.001,17,2,166,1,75,0.0,47.0,47.0,1,91,0.0,63.0,63.0
0.005,6,10,1774,5,923,1.0,655.0,655.0,5,851,1.0,583.0,583.0
0.005,6,14,3742,7,452,0.0,80.0,80.0,7,3290,0.0,1448.0,972.0
0.004,17,2,148,1,60,0.0,32.0,32.0,1,88,0.0,60.0,60.0
0.011,6,10,1990,5,911,2.0,643.0,643.0,5,1079,2.0,811.0,811.0
0.004,6,10,2007,5,928,1.0,660.0,660.0,5,1079,1.0,811.0,811.0
0.001,17,2,180,1,66,0.0,38.0,38.0,1,114,0.0,86.0,86.0
0.12,6,10,1506,5,395,26.0,127.0,127.0,5,1111,25.0,843.0,843.0
0.01,6,10,2006,5,927,2.0,659.0,659.0,5,1079,2.0,811.0,811.0
0.011,6,10,1989,5,910,2.0,642.0,642.0,5,1079,2.0,811.0,811.0
0.028,6,10,1983,5,910,6.0,642.0,642.0,5,1073,6.0,805.0,805.0
0.101,6,10,1506,5,395,19.0,127.0,127.0,5,1111,23.0,843.0,843.0
0.011,6,10,1972,5,910,2.0,642.0,642.0,5,1062,2.0,794.0,794.0
1771.822,6,275,39504,112,22738,15961.0,2720.0,206.0,163,16766,10936.0,1360.0,129.0
0.012,6,10,1990,5,911,3.0,643.0,643.0,5,1079,3.0,811.0,811.0
0.006,17,2,170,1,65,0.0,37.0,37.0,1,105,0.0,77.0,77.0
0.014,6,10,1989,5,910,3.0,642.0,642.0,5,1079,3.0,811.0,811.0
0.1,6,10,1506,5,395,22.0,127.0,127.0,5,1111,24.0,843.0,843.0
240.091,6,16,4480,9,963,30011.0,238.0,166.0,7,3517,40014.0,1402.0,786.0
0.004,6,10,2006,5,927,1.0,659.0,659.0,5,1079,1.0,811.0,811.0
0.005,6,10,2007,5,928,1.0,660.0,660.0,5,1079,1.0,811.0,811.0
0.13,6,10,1506,5,395,29.0,127.0,127.0,5,1111,27.0,843.0,843.0
352.243,6,20,2210,6,1308,12003.0,494.0,494.0,14,902,27095.0,83.0,83.0
0.005,17,2,164,1,74,0.0,46.0,46.0,1,90,0.0,62.0,62.0
0.139,6,10,1506,5,395,31.0,127.0,127.0,5,1111,31.0,843.0,843.0
0.008,6,10,1972,5,910,2.0,642.0,642.0,5,1062,1.0,794.0,794.0
0.001,17,2,180,1,66,0.0,38.0,38.0,1,114,0.0,86.0,86.0
240.077,6,16,4482,9,963,30009.0,238.0,166.0,7,3519,40012.0,1402.0,786.0
1783.235,6,67,7512,43,4533,42457.0,1625.0,108.0,24,2979,77524.0,1111.0,82.0
0.01,6,10,1989,5,910,2.0,642.0,642.0,5,1079,2.0,811.0,811.0
240.091,6,16,4482,9,963,30011.0,238.0,166.0,7,3519,40014.0,1402.0,786.0
0.006,6,10,1689,5,839,1.0,571.0,571.0,5,850,1.0,582.0,582.0
310.916,17,20,1124,10,716,34539.0,48.0,43.0,10,408,34539.0,20.0,12.0
0.004,17,2,214,1,75,0.0,47.0,47.0,1,139,0.0,111.0,111.0
0.021,6,10,1631,5,848,5.0,580.0,580.0,5,783,5.0,515.0,515.0
0.125,6,10,1506,5,395,27.0,127.0,127.0,5,1111,29.0,843.0,843.0
15.107,17,19,9708,9,7104,1882.0,1350.0,761.0,10,2604,1675.0,1350.0,232.0
0.087,6,10,1506,5,395,21.0,127.0,127.0,5,1111,18.0,843.0,843.0
0.216,17,4,352,2,130,175.0,37.0,37.0,2,222,145.0,89.0,83.0
0.005,6,13,3747,7,509,0.0,137.0,137.0,6,3238,0.0,1470.0,1459.0
0.005,6,10,1854,5,889,1.0,621.0,621.0,5,965,1.0,697.0,697.0
240.895,6,22,6630,12,1935,21899.0,1038.0,434.0,10,4695,26765.0,1592.0,694.0
0.004,6,10,2006,5,927,1.0,659.0,659.0,5,1079,1.0,811.0,811.0
0.012,6,10,1631,5,848,3.0,580.0,580.0,5,783,2.0,515.0,515.0
0.005,6,10,2000,5,927,1.0,659.0,659.0,5,1073,1.0,805.0,805.0
2.032,6,33,9284,18,2509,119.0,517.0,262.0,15,6775,144.0,1402.0,663.0
0.042,17,4,336,2,124,0.0,34.0,34.0,2,212,1.0,84.0,78.0
0.006,17,2,140,1,62,0.0,34.0,34.0,1,78,0.0,50.0,50.0
0.003,17,2,136,1,60,0.0,32.0,32.0,1,76,0.0,48.0,48.0
0.0,17,2,166,1,75,0.0,47.0,47.0,1,91,0.0,63.0,63.0
0.003,6,10,1702,5,863,0.0,595.0,595.0,5,839,0.0,571.0,571.0
0.005,6,10,1643,5,860,1.0,592.0,592.0,5,783,1.0,515.0,515.0
0.015,6,10,1990,5,911,3.0,643.0,643.0,5,1079,3.0,811.0,811.0
0.011,6,10,1983,5,910,2.0,642.0,642.0,5,1073,2.0,805.0,805.0
0.126,17,2,80,1,32,0.0,4.0,4.0,1,48,0.0,20.0,20.0
0.005,6,10,1689,5,839,1.0,571.0,571.0,5,850,1.0,582.0,582.0
0.002,17,2,152,1,76,0.0,48.0,48.0,1,76,0.0,48.0,48.0
0.012,6,10,1990,5,911,3.0,643.0,643.0,5,1079,3.0,811.0,811.0
0.093,6,10,1506,5,395,21.0,127.0,127.0,5,1111,21.0,843.0,843.0
0.004,6,10,2000,5,927,1.0,659.0,659.0,5,1073,1.0,805.0,805.0
0.005,6,10,2006,5,927,1.0,659.0,659.0,5,1079,1.0,811.0,811.0
0.121,6,10,1506,5,395,19.0,127.0,127.0,5,1111,28.0,843.0,843.0
0.001,17,2,140,1,62,0.0,34.0,34.0,1,78,0.0,50.0,50.0
418.568,6,27,4870,15,3740,29897.0,494.0,494.0,12,1130,38051.0,83.0,83.0
0.04,17,2,166,1,75,0.0,47.0,47.0,1,91,0.0,63.0,63.0
294.403,6,30,9673,16,2616,19624.0,655.0,355.0,14,7057,22643.0,1402.0,791.0
0.006,17,2,179,1,71,0.0,43.0,43.0,1,108,0.0,80.0,80.0
0.013,6,10,1989,5,910,3.0,642.0,642.0,5,1079,3.0,811.0,811.0
0.012,6,10,1990,5,911,3.0,643.0,643.0,5,1079,3.0,811.0,811.0
144.098,6,21,8143,11,1985,82.0,1174.0,504.0,10,6158,15992.0,2720.0,957.0
11.458,17,28,4399,14,2313,868.0,588.0,137.0,14,2086,868.0,269.0,121.0
0.005,6,10,2006,5,927,1.0,659.0,659.0,5,1079,1.0,811.0,811.0
0.006,6,10,1689,5,839,1.0,571.0,571.0,5,850,1.0,582.0,582.0
0.006,6,10,1547,5,764,1.0,496.0,496.0,5,783,1.0,515.0,515.0
0.005,6,10,1854,5,889,1.0,621.0,621.0,5,965,1.0,697.0,697.0
0.143,6,10,1506,5,395,32.0,127.0,127.0,5,1111,33.0,843.0,843.0
0.005,6,10,1989,5,927,1.0,659.0,659.0,5,1062,1.0,794.0,794.0
0.014,6,10,1631,5,848,3.0,580.0,580.0,5,783,3.0,515.0,515.0
0.227,6,16,2669,8,1395,32.0,533.0,323.0,8,1274,20.0,529.0,212.0
0.011,6,10,1762,5,911,2.0,643.0,643.0,5,851,2.0,583.0,583.0
0.006,6,10,2007,5,928,1.0,660.0,660.0,5,1079,1.0,811.0,811.0
0.021,6,10,1631,5,848,5.0,580.0,580.0,5,783,5.0,515.0,515.0
0.004,17,2,136,1,60,0.0,32.0,32.0,1,76,0.0,48.0,48.0
0.005,17,2,179,1,71,0.0,43.0,43.0,1,108,0.0,80.0,80.0
0.006,17,2,148,1,60,0.0,32.0,32.0,1,88,0.0,60.0,60.0
0.015,6,10,1989,5,910,3.0,642.0,642.0,5,1079,3.0,811.0,811.0
0.02,6,10,1990,5,911,4.0,643.0,643.0,5,1079,5.0,811.0,811.0
0.014,6,13,3735,7,497,2.0,125.0,125.0,6,3238,2.0,1470.0,1459.0
0.007,17,2,179,1,71,0.0,43.0,43.0,1,108,0.0,80.0,80.0
0.175,17,2,152,1,76,0.0,48.0,48.0,1,76,0.0,48.0,48.0
0.001,17,2,180,1,66,0.0,38.0,38.0,1,114,0.0,86.0,86.0
0.008,6,10,1990,5,911,2.0,643.0,643.0,5,1079,2.0,811.0,811.0
0.012,6,10,1990,5,911,3.0,643.0,643.0,5,1079,3.0,811.0,811.0
0.005,6,10,1689,5,839,1.0,571.0,571.0,5,850,1.0,582.0,582.0
0.004,6,10,1989,5,927,1.0,659.0,659.0,5,1062,1.0,794.0,794.0
0.014,6,10,1990,5,911,3.0,643.0,643.0,5,1079,3.0,811.0,811.0
0.005,6,10,2007,5,928,1.0,660.0,660.0,5,1079,1.0,811.0,811.0
0.005,6,10,1643,5,860,1.0,592.0,592.0,5,783,1.0,515.0,515.0
0.005,6,10,1854,5,889,1.0,621.0,621.0,5,965,1.0,697.0,697.0
0.121,6,10,1506,5,395,28.0,127.0,127.0,5,1111,28.0,843.0,843.0
0.015,6,10,1631,5,848,3.0,580.0,580.0,5,783,3.0,515.0,515.0
0.004,17,2,164,1,74,0.0,46.0,46.0,1,90,0.0,62.0,62.0
0.012,6,10,1983,5,910,2.0,642.0,642.0,5,1073,2.0,805.0,805.0
0.001,17,2,180,1,66,0.0,38.0,38.0,1,114,0.0,86.0,86.0
0.014,6,10,1989,5,910,3.0,642.0,642.0,5,1079,3.0,811.0,811.0
0.007,6,10,1547,5,764,1.0,496.0,496.0,5,783,1.0,515.0,515.0
0.014,6,10,1983,5,910,3.0,642.0,642.0,5,1073,3.0,805.0,805.0
0.006,6,10,1689,5,839,1.0,571.0,571.0,5,850,1.0,582.0,582.0
11.093,17,28,4422,14,1995,841.0,270.0,114.0,14,2427,841.0,586.0,145.0
0.109,6,10,1506,5,395,21.0,127.0,127.0,5,1111,26.0,843.0,843.0
0.004,17,2,144,1,64,0.0,36.0,36.0,1,80,0.0,52.0,52.0
0.005,6,14,3736,7,446,0.0,74.0,74.0,7,3290,0.0,1448.0,972.0
301.48,58,5,360,4,288,100493.0,24.0,24.0,1,72,0.0,24.0,24.0
240.666,6,35,8920,18,2069,14154.0,690.0,225.0,17,6851,15039.0,1402.0,597.0
309.175,17,20,1124,10,716,34338.0,48.0,43.0,10,408,34338.0,20.0,12.0
0.069,6,10,1506,5,395,16.0,127.0,127.0,5,1111,17.0,843.0,843.0
0.008,6,10,1983,5,910,1.0,642.0,642.0,5,1073,2.0,805.0,805.0
0.001,17,2,136,1,60,0.0,32.0,32.0,1,76,0.0,48.0,48.0
0.012,6,10,1677,5,827,3.0,559.0,559.0,5,850,2.0,582.0,582.0
0.006,17,2,144,1,64,0.0,36.0,36.0,1,80,0.0,52.0,52.0
0.013,6,10,1989,5,910,3.0,642.0,642.0,5,1079,3.0,811.0,811.0
15.072,17,14,9190,8,6902,2149.0,1350.0,834.0,6,2288,3008.0,1350.0,353.0
0.011,6,10,1972,5,910,2.0,642.0,642.0,5,1062,2.0,794.0,794.0
0.078,6,10,1506,5,395,15.0,127.0,127.0,5,1111,17.0,843.0,843.0
0.006,6,10,1547,5,764,1.0,496.0,496.0,5,783,1.0,515.0,515.0
0.011,6,10,1990,5,911,2.0,643.0,643.0,5,1079,2.0,811.0,811.0
0.012,6,10,1989,5,910,3.0,642.0,642.0,5,1079,2.0,811.0,811.0
0.075,6,10,1506,5,395,17.0,127.0,127.0,5,1111,16.0,843.0,843.0
0.011,6,10,1983,5,910,2.0,642.0,642.0,5,1073,2.0,805.0,805.0
0.009,6,10,1762,5,911,2.0,643.0,643.0,5,851,2.0,583.0,583.0
240.097,6,16,4481,9,963,30012.0,238.0,166.0,7,3518,40015.0,1402.0,786.0
0.086,6,10,1506,5,395,16.0,127.0,127.0,5,1111,18.0,843.0,843.0
0.017,6,10,1989,5,910,4.0,642.0,642.0,5,1079,4.0,811.0,811.0
0.072,17,2,412,1,61,0.0,33.0,33.0,1,351,0.0,323.0,323.0
0.004,17,2,136,1,60,0.0,32.0,32.0,1,76,0.0,48.0,48.0
0.017,6,10,1989,5,910,4.0,642.0,642.0,5,1079,4.0,811.0,811.0
40.063,17,10,676,5,460,10013.0,104.0,64.0,5,216,10011.0,20.0,15.0
0.005,6,10,2006,5,927,1.0,659.0,659.0,5,1079,1.0,811.0,811.0
0.004,6,10,1989,5,927,1.0,659.0,659.0,5,1062,1.0,794.0,794.0
0.012,6,10,1989,5,910,2.0,642.0,642.0,5,1079,2.0,811.0,811.0
0.004,17,2,152,1,76,0.0,48.0,48.0,1,76,0.0,48.0,48.0
15.09,17,15,9239,8,6902,2150.0,1350.0,834.0,7,2337,2508.0,1350.0,305.0
0.006,6,10,2006,5,927,1.0,659.0,659.0,5,1079,1.0,811.0,811.0
0.116,6,10,1506,5,395,27.0,127.0,127.0,5,1111,25.0,843.0,843.0
0.006,6,10,1643,5,860,1.0,592.0,592.0,5,783,1.0,515.0,515.0
240.717,6,38,9709,20,2228,12667.0,748.0,236.0,18,7481,14157.0,1402.0,595.0
0.008,6,10,1983,5,910,2.0,642.0,642.0,5,1073,2.0,805.0,805.0
5.119,6,38,25524,18,15988,301.0,2804.0,2149.0,20,9536,262.0,1288.0,1212.0
292.954,6,410,348742,203,22113,1450.0,2736.0,888.0,207,326629,1422.0,2804.0,1636.0
0.005,6,10,1643,5,860,1.0,592.0,592.0,5,783,1.0,515.0,515.0
0.004,17,2,136,1,60,0.0,32.0,32.0,1,76,0.0,48.0,48.0
0.02,6,10,1989,5,910,5.0,642.0,642.0,5,1079,5.0,811.0,811.0
0.001,17,2,136,1,60,0.0,32.0,32.0,1,76,0.0,48.0,48.0
0.004,17,2,140,1,62,0.0,34.0,34.0,1,78,0.0,50.0,50.0
0.006,6,13,3747,7,509,0.0,137.0,137.0,6,3238,1.0,1470.0,1459.0
0.095,6,10,1506,5,395,21.0,127.0,127.0,5,1111,20.0,843.0,843.0
0.014,6,10,1972,5,910,3.0,642.0,642.0,5,1062,3.0,794.0,794.0
15.074,17,15,9239,8,6902,2149.0,1350.0,834.0,7,2337,2507.0,1350.0,305.0
0.062,6,10,1506,5,395,14.0,127.0,127.0,5,1111,13.0,843.0,843.0
0.004,17,2,136,1,60,0.0,32.0,32.0,1,76,0.0,48.0,48.0
0.006,6,10,2006,5,927,1.0,659.0,659.0,5,1079,1.0,811.0,811.0
0.005,6,10,1643,5,860,1.0,592.0,592.0,5,783,1.0,515.0,515.0
0.006,6,10,1643,5,860,1.0,592.0,592.0,5,783,1.0,515.0,515.0
0.005,6,10,1643,5,860,1.0,592.0,592.0,5,783,1.0,515.0,515.0
0.004,6,13,3747,7,509,0.0,137.0,137.0,6,3238,0.0,1470.0,1459.0
0.005,6,10,2006,5,927,1.0,659.0,659.0,5,1079,1.0,811.0,811.0
0.004,6,10,2006,5,927,1.0,659.0,659.0,5,1079,1.0,811.0,811.0
0.008,6,12,1926,6,1189,1.0,659.0,434.0,6,737,1.0,417.0,417.0
11.17,17,28,4422,14,1994,846.0,269.0,114.0,14,2428,846.0,587.0,145.0
0.136,6,10,1506,5,395,29.0,127.0,127.0,5,1111,28.0,843.0,843.0
0.004,6,10,1989,5,927,1.0,659.0,659.0,5,1062,1.0,794.0,794.0
170.189,17,84,11922,42,2801,4150.0,44.0,38.0,42,9121,4150.0,249.0,189.0
240.261,6,43,5469,21,2501,12013.0,588.0,196.0,22,2968,11440.0,580.0,201.0
615.412,6,55,20639,28,5233,22793.0,676.0,469.0,27,15406,21361.0,1951.0,777.0
0.013,6,10,1677,5,827,3.0,559.0,559.0,5,850,3.0,582.0,582.0
0.011,6,10,1972,5,910,2.0,642.0,642.0,5,1062,2.0,794.0,794.0
0.009,6,10,1762,5,911,2.0,643.0,643.0,5,851,2.0,583.0,583.0
0.009,6,10,1762,5,911,2.0,643.0,643.0,5,851,2.0,583.0,583.0
10.751,17,28,4419,14,1995,818.0,270.0,114.0,14,2424,818.0,587.0,145.0
0.007,17,2,222,1,65,0.0,37.0,37.0,1,157,0.0,129.0,129.0
0.082,6,10,1506,5,395,16.0,127.0,127.0,5,1111,19.0,843.0,843.0
0.006,6,10,1547,5,764,1.0,496.0,496.0,5,783,1.0,515.0,515.0
15.092,17,16,9302,8,6912,2152.0,1350.0,836.0,8,2390,2150.0,1350.0,270.0
0.076,6,10,1506,5,395,16.0,127.0,127.0,5,1111,18.0,843.0,843.0
10.762,17,28,4423,14,1995,819.0,270.0,114.0,14,2428,819.0,587.0,145.0
0.085,6,10,1506,5,395,19.0,127.0,127.0,5,1111,20.0,843.0,843.0
0.007,6,10,1547,5,764,1.0,496.0,496.0,5,783,1.0,515.0,515.0
0.138,6,10,1506,5,395,31.0,127.0,127.0,5,1111,27.0,843.0,843.0
0.005,6,10,2006,5,927,1.0,659.0,659.0,5,1079,1.0,811.0,811.0
0.015,6,10,1983,5,910,3.0,642.0,642.0,5,1073,3.0,805.0,805.0
0.003,17,2,146,1,65,0.0,37.0,37.0,1,81,0.0,53.0,53.0
0.123,6,10,1506,5,395,28.0,127.0,127.0,5,1111,27.0,843.0,843.0
0.035,6,10,1990,5,911,8.0,643.0,643.0,5,1079,8.0,811.0,811.0
0.009,17,2,180,1,66,0.0,38.0,38.0,1,114,0.0,86.0,86.0
0.006,6,10,2006,5,927,1.0,659.0,659.0,5,1079,1.0,811.0,811.0
0.005,17,2,179,1,71,0.0,43.0,43.0,1,108,0.0,80.0,80.0
0.001,17,2,180,1,66,0.0,38.0,38.0,1,114,0.0,86.0,86.0
0.013,6,10,1631,5,848,3.0,580.0,580.0,5,783,3.0,515.0,515.0
0.007,17,2,179,1,71,0.0,43.0,43.0,1,108,0.0,80.0,80.0
0.085,6,10,1506,5,395,18.0,127.0,127.0,5,1111,16.0,843.0,843.0
0.004,17,2,148,1,60,0.0,32.0,32.0,1,88,0.0,60.0,60.0
0.014,6,10,1989,5,910,3.0,642.0,642.0,5,1079,3.0,811.0,811.0
0.008,6,10,1631,5,848,2.0,580.0,580.0,5,783,1.0,515.0,515.0
0.016,6,10,1989,5,910,4.0,642.0,642.0,5,1079,3.0,811.0,811.0
0.001,17,2,180,1,66,0.0,38.0,38.0,1,114,0.0,86.0,86.0
1778.457,17,144,45504,72,22752,25048.0,288.0,288.0,72,22752,25048.0,288.0,288.0
0.005,6,10,1547,5,764,1.0,496.0,496.0,5,783,1.0,515.0,515.0
0.02,6,10,1972,5,910,5.0,642.0,642.0,5,1062,4.0,794.0,794.0
0.023,6,13,3735,7,497,3.0,125.0,125.0,6,3238,4.0,1470.0,1459.0
0.005,6,10,2007,5,928,1.0,660.0,660.0,5,1079,1.0,811.0,811.0
0.006,6,10,1547,5,764,1.0,496.0,496.0,5,783,1.0,515.0,515.0
0.007,6,10,1547,5,764,1.0,496.0,496.0,5,783,1.0,515.0,515.0
0.009,6,10,1990,5,911,2.0,643.0,643.0,5,1079,2.0,811.0,811.0
361.857,6,21,1793,16,1030,24123.0,190.0,190.0,5,763,60010.0,462.0,247.0
0.001,17,2,180,1,66,0.0,38.0,38.0,1,114,0.0,86.0,86.0
0.006,6,10,1547,5,764,1.0,496.0,496.0,5,783,1.0,515.0,515.0
0.006,6,10,1689,5,839,1.0,571.0,571.0,5,850,1.0,582.0,582.0
0.121,6,10,1506,5,395,25.0,127.0,127.0,5,1111,26.0,843.0,843.0
0.004,6,10,2007,5,928,1.0,660.0,660.0,5,1079,1.0,811.0,811.0
0.005,6,10,2006,5,927,1.0,659.0,659.0,5,1079,1.0,811.0,811.0
0.006,6,10,1547,5,764,1.0,496.0,496.0,5,783,1.0,515.0,515.0
0.004,17,2,179,1,71,0.0,43.0,43.0,1,108,0.0,80.0,80.0
0.01,6,10,1972,5,910,2.0,642.0,642.0,5,1062,2.0,794.0,794.0
0.005,17,2,214,1,75,0.0,47.0,47.0,1,139,0.0,111.0,111.0
0.085,6,10,1506,5,395,18.0,127.0,127.0,5,1111,18.0,843.0,843.0
0.08,6,10,1506,5,395,18.0,127.0,127.0,5,1111,18.0,843.0,843.0
0.006,6,10,1547,5,764,1.0,496.0,496.0,5,783,1.0,515.0,515.0
0.005,6,10,2000,5,927,1.0,659.0,659.0,5,1073,1.0,805.0,805.0
0.009,17,4,284,2,120,6.0,32.0,32.0,2,164,5.0,60.0,54.0
0.088,6,10,1506,5,395,19.0,127.0,127.0,5,1111,17.0,843.0,843.0
353.984,6,19,1691,15,978,25284.0,190.0,190.0,4,713,80003.0,497.0,497.0
240.09,6,16,4481,9,963,30011.0,238.0,166.0,7,3518,40014.0,1402.0,786.0
0.004,17,2,136,1,60,0.0,32.0,32.0,1,76,0.0,48.0,48.0
0.075,6,10,1506,5,395,16.0,127.0,127.0,5,1111,16.0,843.0,843.0
15.076,17,15,9239,8,6902,2149.0,1350.0,834.0,7,2337,2507.0,1350.0,305.0
0.094,6,10,1506,5,395,20.0,127.0,127.0,5,1111,19.0,843.0,843.0
0.066,6,10,1506,5,395,15.0,127.0,127.0,5,1111,13.0,843.0,843.0
0.005,17,2,136,1,60,0.0,32.0,32.0,1,76,0.0,48.0,48.0
0.001,17,2,136,1,60,0.0,32.0,32.0,1,76,0.0,48.0,48.0
0.005,6,10,2007,5,928,1.0,660.0,660.0,5,1079,1.0,811.0,811.0
0.041,17,2,152,1,76,0.0,48.0,48.0,1,76,0.0,48.0,48.0
0.005,6,10,2006,5,927,1.0,659.0,659.0,5,1079,1.0,811.0,811.0
0.006,6,10,1547,5,764,1.0,496.0,496.0,5,783,1.0,515.0,515.0
0.016,6,10,1989,5,910,4.0,642.0,642.0,5,1079,3.0,811.0,811.0
0.003,17,2,132,1,58,0.0,30.0,30.0,1,74,0.0,46.0,46.0
0.004,6,10,2006,5,927,1.0,659.0,659.0,5,1079,1.0,811.0,811.0
0.005,6,10,2006,5,927,1.0,659.0,659.0,5,1079,1.0,811.0,811.0
0.012,6,13,3735,7,497,2.0,125.0,125.0,6,3238,2.0,1470.0,1459.0
0.007,6,10,1547,5,764,1.0,496.0,496.0,5,783,1.0,515.0,515.0
0.006,6,10,1547,5,764,1.0,496.0,496.0,5,783,1.0,515.0,515.0
0.005,6,10,1689,5,839,1.0,571.0,571.0,5,850,1.0,582.0,582.0
40.067,17,10,676,5,460,10015.0,104.0,64.0,5,216,10015.0,20.0,15.0
0.003,17,2,186,1,61,0.0,33.0,33.0,1,125,0.0,97.0,97.0
169.041,17,90,12999,45,3033,3841.0,44.0,39.0,45,9966,3841.0,239.0,193.0
0.109,6,10,1506,5,395,24.0,127.0,127.0,5,1111,25.0,843.0,843.0
0.135,6,10,1506,5,395,32.0,127.0,127.0,5,1111,28.0,843.0,843.0
0.016,17,2,198,1,91,0.0,63.0,63.0,1,107,0.0,79.0,79.0
0.005,6,10,2007,5,928,1.0,660.0,660.0,5,1079,1.0,811.0,811.0
0.019,6,10,1990,5,911,4.0,643.0,643.0,5,1079,4.0,811.0,811.0
0.17,6,10,1506,5,395,32.0,127.0,127.0,5,1111,40.0,843.0,843.0
0.01,6,10,1990,5,911,2.0,643.0,643.0,5,1079,2.0,811.0,811.0
0.005,6,10,1774,5,923,1.0,655.0,655.0,5,851,1.0,583.0,583.0
0.117,6,10,1506,5,395,25.0,127.0,127.0,5,1111,25.0,843.0,843.0
0.004,6,10,2006,5,927,1.0,659.0,659.0,5,1079,1.0,811.0,811.0
0.004,6,10,1702,5,863,1.0,595.0,595.0,5,839,0.0,571.0,571.0
0.004,17,2,132,1,58,0.0,30.0,30.0,1,74,0.0,46.0,46.0
0.006,6,10,1689,5,839,1.0,571.0,571.0,5,850,1.0,582.0,582.0
48.15,58,5,360,4,288,16050.0,24.0,24.0,1,72,0.0,24.0,24.0
0.007,17,2,179,1,71,0.0,43.0,43.0,1,108,0.0,80.0,80.0
0.005,17,2,179,1,71,0.0,43.0,43.0,1,108,0.0,80.0,80.0
0.014,6,10,1989,5,910,3.0,642.0,642.0,5,1079,3.0,811.0,811.0
15.083,17,15,8415,8,6157,2150.0,1350.0,741.0,7,2258,2509.0,1350.0,294.0
0.005,6,10,2006,5,927,1.0,659.0,659.0,5,1079,1.0,811.0,811.0
40.066,17,10,676,5,460,10013.0,104.0,64.0,5,216,10015.0,20.0,15.0
15.218,17,18,9402,9,6963,1898.0,1350.0,745.0,9,2439,1898.0,1350.0,243.0
0.084,6,10,1506,5,395,20.0,127.0,127.0,5,1111,17.0,843.0,843.0
0.009,6,10,1983,5,910,2.0,642.0,642.0,5,1073,2.0,805.0,805.0
0.01,6,10,1762,5,911,2.0,643.0,643.0,5,851,2.0,583.0,583.0
0.011,6,10,1989,5,910,2.0,642.0,642.0,5,1079,2.0,811.0,811.0
0.005,6,10,2007,5,928,1.0,660.0,660.0,5,1079,1.0,811.0,811.0
0.041,17,4,352,2,130,1.0,37.0,37.0,2,222,37.0,89.0,83.0
0.037,17,4,284,2,120,0.0,32.0,32.0,2,164,0.0,60.0,54.0
0.005,6,14,3736,7,446,0.0,74.0,74.0,7,3290,0.0,1448.0,972.0
0.009,6,10,1989,5,927,2.0,659.0,659.0,5,1062,2.0,794.0,794.0
0.004,6,10,1989,5,927,1.0,659.0,659.0,5,1062,1.0,794.0,794.0
0.004,6,10,1989,5,927,1.0,659.0,659.0,5,1062,1.0,794.0,794.0
0.095,6,10,1506,5,395,22.0,127.0,127.0,5,1111,20.0,843.0,843.0
0.038,17,2,144,1,64,0.0,36.0,36.0,1,80,0.0,52.0,52.0
40.075,17,10,676,5,460,10017.0,104.0,64.0,5,216,10014.0,20.0,15.0
40.053,17,10,676,5,460,10012.0,104.0,64.0,5,216,10012.0,20.0,15.0
0.078,6,10,1506,5,395,17.0,127.0,127.0,5,1111,18.0,843.0,843.0
0.005,6,10,1643,5,860,1.0,592.0,592.0,5,783,1.0,515.0,515.0
15.075,17,15,8209,8,6006,2149.0,1350.0,722.0,7,2203,2507.0,1350.0,286.0
15.072,17,15,9239,8,6902,2149.0,1350.0,834.0,7,2337,2507.0,1350.0,305.0
240.096,6,31,9408,15,7010,17149.0,2134.0,692.0,16,2398,16006.0,580.0,194.0
300.033,6,12,1782,7,1348,50005.0,494.0,494.0,5,434,75007.0,83.0,83.0
40.059,17,10,676,5,460,10014.0,104.0,64.0,5,216,10013.0,20.0,15.0
0.129,6,10,1506,5,395,29.0,127.0,127.0,5,1111,28.0,843.0,843.0
0.006,6,10,1689,5,839,1.0,571.0,571.0,5,850,1.0,582.0,582.0
0.009,6,10,1972,5,910,2.0,642.0,642.0,5,1062,2.0,794.0,794.0
0.01,6,10,1972,5,910,2.0,642.0,642.0,5,1062,2.0,794.0,794.0
0.017,6,10,1972,5,910,4.0,642.0,642.0,5,1062,4.0,794.0,794.0
0.006,6,10,1547,5,764,1.0,496.0,496.0,5,783,1.0,515.0,515.0
0.001,17,2,180,1,65,0.0,37.0,37.0,1,115,0.0,87.0,87.0
0.006,6,10,1643,5,860,1.0,592.0,592.0,5,783,1.0,515.0,515.0
5.072,6,21,5923,12,1436,461.0,474.0,201.0,9,4487,633.0,1925.0,804.0
40.076,17,10,676,5,460,10016.0,104.0,64.0,5,216,10018.0,20.0,15.0
0.365,17,54,34587,31,28548,12.0,1350.0,892.0,23,6039,13.0,1350.0,234.0
0.154,6,10,1506,5,395,31.0,127.0,127.0,5,1111,37.0,843.0,843.0
0.004,6,10,2007,5,928,1.0,660.0,660.0,5,1079,1.0,811.0,811.0
0.119,6,11,1558,6,447,22.0,127.0,127.0,5,1111,27.0,843.0,843.0
0.009,6,10,1990,5,911,2.0,643.0,643.0,5,1079,2.0,811.0,811.0
0.066,6,10,1506,5,395,15.0,127.0,127.0,5,1111,14.0,843.0,843.0
0.005,17,2,169,1,62,0.0,34.0,34.0,1,107,0.0,79.0,79.0
0.006,17,2,170,1,65,0.0,37.0,37.0,1,105,0.0,77.0,77.0
0.005,6,14,3736,7,446,0.0,74.0,74.0,7,3290,0.0,1448.0,972.0
0.009,6,12,1926,6,1189,1.0,659.0,434.0,6,737,1.0,417.0,417.0
0.01,6,10,1983,5,910,2.0,642.0,642.0,5,1073,2.0,805.0,805.0
0.003,17,2,234,1,61,0.0,33.0,33.0,1,173,0.0,145.0,145.0
0.008,6,10,1989,5,910,2.0,642.0,642.0,5,1079,1.0,811.0,811.0
15.238,17,18,8360,9,6067,1900.0,1350.0,646.0,9,2293,1901.0,1350.0,226.0
0.004,6,14,3736,7,446,0.0,74.0,74.0,7,3290,0.0,1448.0,972.0
0.101,6,10,1506,5,395,23.0,127.0,127.0,5,1111,23.0,843.0,843.0
0.006,6,14,3799,7,509,1.0,137.0,137.0,7,3290,1.0,1448.0,972.0
0.008,6,12,1698,6,863,1.0,327.0,271.0,6,835,1.0,515.0,515.0
0.005,6,10,2006,5,927,1.0,659.0,659.0,5,1079,1.0,811.0,811.0
0.013,6,13,3735,7,497,2.0,125.0,125.0,6,3238,2.0,1470.0,1459.0
0.009,6,10,1990,5,911,2.0,643.0,643.0,5,1079,2.0,811.0,811.0
0.012,6,10,1990,5,911,3.0,643.0,643.0,5,1079,3.0,811.0,811.0
125.28,58,5,360,4,288,41760.0,24.0,24.0,1,72,0.0,24.0,24.0
0.152,6,10,1506,5,395,25.0,127.0,127.0,5,1111,35.0,843.0,843.0
0.092,6,10,1506,5,395,21.0,127.0,127.0,5,1111,18.0,843.0,843.0
0.005,6,10,2006,5,927,1.0,659.0,659.0,5,1079,1.0,811.0,811.0
241.214,6,382,346740,189,21355,1283.0,2736.0,959.0,193,325385,1256.0,2804.0,1723.0
40.062,17,10,676,5,460,10014.0,104.0,64.0,5,216,10013.0,20.0,15.0
0.09,6,10,1506,5,395,20.0,127.0,127.0,5,1111,20.0,843.0,843.0
0.005,17,2,164,1,74,0.0,46.0,46.0,1,90,0.0,62.0,62.0
0.156,6,10,1506,5,395,37.0,127.0,127.0,5,1111,29.0,843.0,843.0
0.004,6,10,2006,5,927,1.0,659.0,659.0,5,1079,1.0,811.0,811.0
386.838,6,29,4397,13,3142,32236.0,494.0,494.0,16,1255,25788.0,83.0,83.0
0.075,6,10,1983,5,910,18.0,642.0,642.0,5,1073,18.0,805.0,805.0
0.005,6,10,1989,5,927,1.0,659.0,659.0,5,1062,1.0,794.0,794.0
240.543,6,33,9267,16,1836,16034.0,624.0,199.0,17,7431,15031.0,1402.0,595.0
0.088,6,10,1506,5,395,21.0,127.0,127.0,5,1111,20.0,843.0,843.0
0.005,6,10,2000,5,927,1.0,659.0,659.0,5,1073,1.0,805.0,805.0
0.005,6,10,2006,5,927,1.0,659.0,659.0,5,1079,1.0,811.0,811.0
0.004,17,4,284,2,120,0.0,32.0,32.0,2,164,1.0,60.0,54.0
0.005,6,10,1547,5,764,1.0,496.0,496.0,5,783,1.0,515.0,515.0
0.005,6,10,1989,5,927,1.0,659.0,659.0,5,1062,1.0,794.0,794.0
0.039,17,4,352,2,130,0.0,37.0,37.0,2,222,35.0,89.0,83.0
0.001,17,2,180,1,66,0.0,38.0,38.0,1,114,0.0,86.0,86.0
0.023,6,10,1990,5,911,5.0,643.0,643.0,5,1079,5.0,811.0,811.0
0.008,6,10,1677,5,827,2.0,559.0,559.0,5,850,1.0,582.0,582.0
0.017,6,10,1631,5,848,4.0,580.0,580.0,5,783,4.0,515.0,515.0
0.015,6,10,1990,5,911,3.0,643.0,643.0,5,1079,3.0,811.0,811.0
0.078,6,10,1506,5,395,18.0,127.0,127.0,5,1111,16.0,843.0,843.0
0.039,6,10,1983,5,910,9.0,642.0,642.0,5,1073,9.0,805.0,805.0
0.005,17,2,169,1,62,0.0,34.0,34.0,1,107,0.0,79.0,79.0
0.058,6,10,1506,5,395,13.0,127.0,127.0,5,1111,13.0,843.0,843.0
0.089,6,10,1506,5,395,21.0,127.0,127.0,5,1111,14.0,843.0,843.0
240.076,6,16,4482,9,963,30009.0,238.0,166.0,7,3519,40012.0,1402.0,786.0
0.074,6,10,1506,5,395,17.0,127.0,127.0,5,1111,16.0,843.0,843.0
0.005,6,10,2007,5,928,1.0,660.0,660.0,5,1079,1.0,811.0,811.0
0.001,17,2,180,1,66,0.0,38.0,38.0,1,114,0.0,86.0,86.0
0.005,6,10,2007,5,928,1.0,660.0,660.0,5,1079,1.0,811.0,811.0
0.02,6,10,1989,5,910,5.0,642.0,642.0,5,1079,5.0,811.0,811.0
0.1,6,10,1506,5,395,22.0,127.0,127.0,5,1111,19.0,843.0,843.0
0.016,6,10,1990,5,911,4.0,643.0,643.0,5,1079,4.0,811.0,811.0
1786.885,6,225,41558,108,29660,16699.0,3842.0,1144.0,117,11898,15404.0,580.0,63.0
0.005,17,2,170,1,65,0.0,37.0,37.0,1,105,0.0,77.0,77.0
0.029,6,10,1989,5,910,7.0,642.0,642.0,5,1079,7.0,811.0,811.0
308.977,17,20,1124,10,716,34316.0,48.0,43.0,10,408,34315.0,20.0,12.0
0.005,6,10,1989,5,927,1.0,659.0,659.0,5,1062,1.0,794.0,794.0
0.075,6,10,1506,5,395,16.0,127.0,127.0,5,1111,15.0,843.0,843.0
0.005,6,10,2006,5,927,1.0,659.0,659.0,5,1079,1.0,811.0,811.0
10.892,17,28,4421,14,1993,828.0,268.0,114.0,14,2428,828.0,587.0,145.0
0.008,6,13,3735,7,497,1.0,125.0,125.0,6,3238,1.0,1470.0,1459.0
0.005,6,10,2006,5,927,1.0,659.0,659.0,5,1079,1.0,811.0,811.0
0.014,6,10,1972,5,910,3.0,642.0,642.0,5,1062,3.0,794.0,794.0
292.726,6,383,347655,191,21503,1540.0,2736.0,889.0,192,326152,1532.0,2804.0,1776.0
0.001,17,2,136,1,60,0.0,32.0,32.0,1,76,0.0,48.0,48.0
0.01,6,10,1990,5,911,2.0,643.0,643.0,5,1079,2.0,811.0,811.0
240.016,6,16,1830,9,1132,30002.0,517.0,167.0,7,698,40002.0,156.0,81.0
0.005,17,2,136,1,60,0.0,32.0,32.0,1,76,0.0,48.0,48.0
300.397,6,16,2170,9,684,37529.0,146.0,146.0,7,1486,50039.0,419.0,398.0
0.006,6,13,3690,7,452,0.0,80.0,80.0,6,3238,1.0,1470.0,1459.0
0.008,6,10,1972,5,910,2.0,642.0,642.0,5,1062,2.0,794.0,794.0
0.012,6,10,1989,5,910,2.0,642.0,642.0,5,1079,2.0,811.0,811.0
0.068,6,10,1506,5,395,15.0,127.0,127.0,5,1111,12.0,843.0,843.0
0.004,6,10,1702,5,863,1.0,595.0,595.0,5,839,1.0,571.0,571.0
0.072,17,4,352,2,130,0.0,37.0,37.0,2,222,32.0,89.0,83.0
0.005,6,10,1854,5,889,1.0,621.0,621.0,5,965,1.0,697.0,697.0
240.497,6,32,8585,16,1788,16030.0,573.0,189.0,16,6797,16030.0,1402.0,596.0
40.089,17,10,676,5,460,10018.0,104.0,64.0,5,216,10019.0,20.0,15.0
0.079,6,10,1506,5,395,19.0,127.0,127.0,5,1111,16.0,843.0,843.0
316.831,17,20,1124,10,716,35189.0,48.0,43.0,10,408,35189.0,20.0,12.0
40.053,17,10,676,5,460,10012.0,104.0,64.0,5,216,10012.0,20.0,15.0
0.09,6,10,1506,5,395,19.0,127.0,127.0,5,1111,21.0,843.0,843.0
40.055,17,10,676,5,460,10012.0,104.0,64.0,5,216,10012.0,20.0,15.0
0.005,6,10,2000,5,927,1.0,659.0,659.0,5,1073,1.0,805.0,805.0
40.072,17,10,676,5,460,10015.0,104.0,64.0,5,216,10017.0,20.0,15.0
0.029,17,2,136,1,60,0.0,32.0,32.0,1,76,0.0,48.0,48.0
0.006,6,10,2006,5,927,1.0,659.0,659.0,5,1079,1.0,811.0,811.0
0.009,6,10,1989,5,910,2.0,642.0,642.0,5,1079,2.0,811.0,811.0
300.418,6,16,2170,9,684,37531.0,146.0,146.0,7,1486,50041.0,419.0,398.0
331.68,17,20,1124,10,716,36845.0,48.0,43.0,10,408,36844.0,20.0,12.0
0.068,6,10,1506,5,395,15.0,127.0,127.0,5,1111,15.0,843.0,843.0
0.17,17,2,152,1,76,0.0,48.0,48.0,1,76,0.0,48.0,48.0
0.005,6,10,2006,5,927,1.0,659.0,659.0,5,1079,1.0,811.0,811.0
0.005,6,10,1989,5,927,1.0,659.0,659.0,5,1062,1.0,794.0,794.0
0.013,6,14,3787,7,497,2.0,125.0,125.0,7,3290,2.0,1448.0,972.0
0.044,17,4,596,2,122,2.0,33.0,33.0,2,474,6.0,323.0,209.0
0.012,6,10,1989,5,910,3.0,642.0,642.0,5,1079,2.0,811.0,811.0
0.008,6,10,1972,5,910,1.0,642.0,642.0,5,1062,2.0,794.0,794.0
0.008,6,10,1990,5,911,1.0,643.0,643.0,5,1079,2.0,811.0,811.0
0.084,6,10,1506,5,395,17.0,127.0,127.0,5,1111,19.0,843.0,843.0
0.191,17,2,194,1,59,0.0,31.0,31.0,1,135,0.0,107.0,107.0
0.004,6,10,2007,5,928,1.0,660.0,660.0,5,1079,1.0,811.0,811.0
0.005,6,10,1779,5,928,1.0,660.0,660.0,5,851,1.0,583.0,583.0
240.143,6,19,5039,9,2305,30017.0,1102.0,613.0,10,2734,26680.0,1162.0,441.0
0.005,6,10,2007,5,928,1.0,660.0,660.0,5,1079,1.0,811.0,811.0
0.011,6,10,1989,5,910,2.0,642.0,642.0,5,1079,2.0,811.0,811.0
0.039,17,2,182,1,65,0.0,37.0,37.0,1,117,0.0,89.0,89.0
0.01,6,13,3735,7,497,1.0,125.0,125.0,6,3238,1.0,1470.0,1459.0
0.004,6,10,1989,5,927,1.0,659.0,659.0,5,1062,1.0,794.0,794.0
0.114,6,10,1506,5,395,19.0,127.0,127.0,5,1111,26.0,843.0,843.0
0.016,6,10,1990,5,911,4.0,643.0,643.0,5,1079,3.0,811.0,811.0
0.123,6,10,1506,5,395,27.0,127.0,127.0,5,1111,27.0,843.0,843.0
0.004,6,10,2006,5,927,1.0,659.0,659.0,5,1079,1.0,811.0,811.0
0.001,17,2,140,1,62,0.0,34.0,34.0,1,78,0.0,50.0,50.0
40.079,17,10,676,5,460,10014.0,104.0,64.0,5,216,10019.0,20.0,15.0
0.009,6,10,1990,5,911,2.0,643.0,643.0,5,1079,2.0,811.0,811.0
0.006,17,2,170,1,65,0.0,37.0,37.0,1,105,0.0,77.0,77.0
40.062,17,10,676,5,460,10014.0,104.0,64.0,5,216,10013.0,20.0,15.0
0.005,6,10,2000,5,927,1.0,659.0,659.0,5,1073,1.0,805.0,805.0
0.005,6,10,1689,5,839,1.0,571.0,571.0,5,850,1.0,582.0,582.0
0.005,6,10,2007,5,928,1.0,660.0,660.0,5,1079,1.0,811.0,811.0
0.018,6,13,3735,7,497,3.0,125.0,125.0,6,3238,3.0,1470.0,1459.0
0.01,6,10,1983,5,910,2.0,642.0,642.0,5,1073,2.0,805.0,805.0
0.006,6,10,1547,5,764,1.0,496.0,496.0,5,783,1.0,515.0,515.0
0.084,6,10,1506,5,395,17.0,127.0,127.0,5,1111,16.0,843.0,843.0
0.005,6,14,3736,7,446,0.0,74.0,74.0,7,3290,0.0,1448.0,972.0
0.005,6,10,2000,5,927,1.0,659.0,659.0,5,1073,1.0,805.0,805.0
40.062,17,10,676,5,460,10014.0,104.0,64.0,5,216,10014.0,20.0,15.0
0.009,6,10,2006,5,927,2.0,659.0,659.0,5,1079,2.0,811.0,811.0
0.006,17,4,284,2,120,3.0,32.0,32.0,2,164,2.0,60.0,54.0
0.004,6,10,1989,5,927,1.0,659.0,659.0,5,1062,1.0,794.0,794.0
0.004,17,2,148,1,60,0.0,32.0,32.0,1,88,0.0,60.0,60.0
0.01,6,10,1983,5,910,2.0,642.0,642.0,5,1073,2.0,805.0,805.0
0.037,17,2,136,1,60,0.0,32.0,32.0,1,76,0.0,48.0,48.0
0.001,17,2,166,1,75,0.0,47.0,47.0,1,91,0.0,63.0,63.0
40.069,17,10,676,5,460,10016.0,104.0,64.0,5,216,10016.0,20.0,15.0
0.004,6,10,1989,5,927,1.0,659.0,659.0,5,1062,1.0,794.0,794.0
0.071,17,2,170,1,65,0.0,37.0,37.0,1,105,0.0,77.0,77.0
0.009,6,10,1677,5,827,2.0,559.0,559.0,5,850,2.0,582.0,582.0
0.009,6,12,1926,6,1189,1.0,659.0,434.0,6,737,1.0,417.0,417.0
0.006,17,2,180,1,66,0.0,38.0,38.0,1,114,0.0,86.0,86.0
0.009,6,10,1990,5,911,2.0,643.0,643.0,5,1079,2.0,811.0,811.0
177.457,17,88,12497,44,2963,4126.0,44.0,39.0,44,9534,4126.0,252.0,188.0
0.043,17,2,148,1,60,0.0,32.0,32.0,1,88,0.0,60.0,60.0
0.017,6,10,1972,5,910,4.0,642.0,642.0,5,1062,4.0,794.0,794.0
0.011,6,10,1989,5,910,2.0,642.0,642.0,5,1079,2.0,811.0,811.0
0.014,6,10,1989,5,910,3.0,642.0,642.0,5,1079,3.0,811.0,811.0
0.005,6,10,2007,5,928,1.0,660.0,660.0,5,1079,1.0,811.0,811.0
0.115,6,10,1506,5,395,26.0,127.0,127.0,5,1111,27.0,843.0,843.0
0.115,6,10,1506,5,395,26.0,127.0,127.0,5,1111,27.0,843.0,843.0
0.006,17,2,214,1,75,0.0,47.0,47.0,1,139,0.0,111.0,111.0
0.011,6,10,1983,5,910,2.0,642.0,642.0,5,1073,2.0,805.0,805.0
0.011,6,10,1972,5,910,2.0,642.0,642.0,5,1062,2.0,794.0,794.0
0.016,6,10,1631,5,848,4.0,580.0,580.0,5,783,4.0,515.0,515.0
0.072,17,4,284,2,120,0.0,32.0,32.0,2,164,68.0,60.0,54.0
0.005,6,10,2006,5,927,1.0,659.0,659.0,5,1079,1.0,811.0,811.0
366.255,6,22,2313,16,867,24417.0,195.0,195.0,6,1446,4635.0,419.0,398.0
0.005,6,10,2006,5,927,1.0,659.0,659.0,5,1079,1.0,811.0,811.0
0.007,6,10,2007,5,928,1.0,660.0,660.0,5,1079,1.0,811.0,811.0
0.079,6,10,1506,5,395,17.0,127.0,127.0,5,1111,16.0,843.0,843.0
0.008,6,10,1972,5,910,2.0,642.0,642.0,5,1062,2.0,794.0,794.0
0.011,6,10,1989,5,910,2.0,642.0,642.0,5,1079,2.0,811.0,811.0
0.004,17,4,596,2,122,1.0,33.0,33.0,2,474,0.0,323.0,209.0
0.006,6,10,1547,5,764,1.0,496.0,496.0,5,783,1.0,515.0,515.0
0.02,6,10,1983,5,910,4.0,642.0,642.0,5,1073,4.0,805.0,805.0
0.039,17,2,156,1,64,0.0,36.0,36.0,1,92,0.0,64.0,64.0
0.011,6,10,1989,5,910,2.0,642.0,642.0,5,1079,2.0,811.0,811.0
372.118,6,21,1794,16,1030,24807.0,190.0,190.0,5,764,60019.0,463.0,248.0
40.055,17,10,676,5,460,10013.0,104.0,64.0,5,216,10012.0,20.0,15.0
0.004,6,10,1989,5,927,1.0,659.0,659.0,5,1062,1.0,794.0,794.0
0.041,17,4,284,2,120,0.0,32.0,32.0,2,164,4.0,60.0,54.0
0.009,6,12,1926,6,1189,1.0,659.0,434.0,6,737,1.0,417.0,417.0
0.006,17,2,240,1,61,0.0,33.0,33.0,1,179,0.0,151.0,151.0
0.005,6,13,3690,7,452,0.0,80.0,80.0,6,3238,0.0,1470.0,1459.0
0.01,6,10,1989,5,910,2.0,642.0,642.0,5,1079,2.0,811.0,811.0
0.005,6,10,2006,5,927,1.0,659.0,659.0,5,1079,1.0,811.0,811.0
308.827,17,20,1124,10,716,34299.0,48.0,43.0,10,408,34300.0,20.0,12.0
0.006,6,10,1547,5,764,1.0,496.0,496.0,5,783,1.0,515.0,515.0
0.116,6,10,1506,5,395,28.0,127.0,127.0,5,1111,25.0,843.0,843.0
0.039,17,2,166,1,75,0.0,47.0,47.0,1,91,0.0,63.0,63.0
0.078,6,10,1506,5,395,17.0,127.0,127.0,5,1111,17.0,843.0,843.0
0.137,6,10,1506,5,395,32.0,127.0,127.0,5,1111,19.0,843.0,843.0
0.011,6,10,1762,5,911,2.0,643.0,643.0,5,851,2.0,583.0,583.0
0.005,6,10,2006,5,927,1.0,659.0,659.0,5,1079,1.0,811.0,811.0
40.061,17,10,676,5,460,10014.0,104.0,64.0,5,216,10014.0,20.0,15.0
0.101,6,10,1506,5,395,21.0,127.0,127.0,5,1111,17.0,843.0,843.0
0.004,17,2,136,1,60,0.0,32.0,32.0,1,76,0.0,48.0,48.0
0.004,6,10,1989,5,927,1.0,659.0,659.0,5,1062,1.0,794.0,794.0
11.502,17,30,4650,15,2441,809.0,588.0,134.0,15,2209,809.0,268.0,119.0
0.02,6,10,1983,5,910,5.0,642.0,642.0,5,1073,5.0,805.0,805.0
0.068,17,2,144,1,64,0.0,36.0,36.0,1,80,0.0,52.0,52.0
0.011,6,10,1989,5,910,2.0,642.0,642.0,5,1079,2.0,811.0,811.0
0.005,6,10,1774,5,923,1.0,655.0,655.0,5,851,1.0,583.0,583.0
0.008,6,10,1762,5,911,2.0,643.0,643.0,5,851,2.0,583.0,583.0
0.002,17,2,136,1,60,0.0,32.0,32.0,1,76,0.0,48.0,48.0
0.015,6,10,1989,5,910,3.0,642.0,642.0,5,1079,3.0,811.0,811.0
0.005,6,10,2006,5,927,1.0,659.0,659.0,5,1079,1.0,811.0,811.0
0.01,6,10,1989,5,910,2.0,642.0,642.0,5,1079,2.0,811.0,811.0
0.005,17,2,170,1,65,0.0,37.0,37.0,1,105,0.0,77.0,77.0
314.276,17,20,1124,10,716,34909.0,48.0,43.0,10,408,34906.0,20.0,12.0
0.006,6,10,2000,5,927,1.0,659.0,659.0,5,1073,1.0,805.0,805.0
0.009,6,10,1779,5,928,2.0,660.0,660.0,5,851,2.0,583.0,583.0
309.244,17,20,1124,10,716,34346.0,48.0,43.0,10,408,34346.0,20.0,12.0
0.086,6,10,1506,5,395,19.0,127.0,127.0,5,1111,19.0,843.0,843.0
361.769,6,19,1688,15,978,25840.0,190.0,190.0,4,710,80014.0,494.0,494.0
0.122,6,10,1506,5,395,29.0,127.0,127.0,5,1111,27.0,843.0,843.0
0.005,6,10,1989,5,927,1.0,659.0,659.0,5,1062,1.0,794.0,794.0
0.004,17,2,148,1,60,0.0,32.0,32.0,1,88,0.0,60.0,60.0
0.016,6,10,1677,5,827,3.0,559.0,559.0,5,850,3.0,582.0,582.0
0.005,6,10,1779,5,928,1.0,660.0,660.0,5,851,1.0,583.0,583.0
366.083,6,20,2210,6,1308,12003.0,494.0,494.0,14,902,28160.0,83.0,83.0
40.067,17,10,676,5,460,10015.0,104.0,64.0,5,216,10016.0,20.0,15.0
0.017,6,10,1989,5,910,4.0,642.0,642.0,5,1079,4.0,811.0,811.0
0.009,6,12,1926,6,1189,1.0,659.0,434.0,6,737,1.0,417.0,417.0
10.839,17,28,4417,14,1994,825.0,269.0,114.0,14,2423,825.0,586.0,145.0
0.087,6,10,1506,5,395,20.0,127.0,127.0,5,1111,16.0,843.0,843.0
40.064,17,10,676,5,460,10015.0,104.0,64.0,5,216,10015.0,20.0,15.0
280.945,6,24,6440,11,1226,28094.0,267.0,156.0,13,5214,23411.0,1400.0,781.0
0.006,17,2,239,1,63,0.0,35.0,35.0,1,176,0.0,148.0,148.0
0.005,6,13,3747,7,509,0.0,137.0,137.0,6,3238,1.0,1470.0,1459.0
0.072,6,10,1506,5,395,15.0,127.0,127.0,5,1111,17.0,843.0,843.0
0.006,6,10,2006,5,927,1.0,659.0,659.0,5,1079,1.0,811.0,811.0
0.007,6,10,1547,5,764,1.0,496.0,496.0,5,783,1.0,515.0,515.0
0.009,6,12,1926,6,1189,1.0,659.0,434.0,6,737,1.0,417.0,417.0
0.082,6,10,1506,5,395,16.0,127.0,127.0,5,1111,19.0,843.0,843.0
0.016,6,13,3735,7,497,2.0,125.0,125.0,6,3238,3.0,1470.0,1459.0
0.009,6,12,1926,6,1189,1.0,659.0,434.0,6,737,1.0,417.0,417.0
0.043,17,4,284,2,120,1.0,32.0,32.0,2,164,39.0,60.0,54.0
0.005,17,2,164,1,74,0.0,46.0,46.0,1,90,0.0,62.0,62.0
0.009,6,10,1990,5,911,2.0,643.0,643.0,5,1079,2.0,811.0,811.0
0.133,6,10,1506,5,395,30.0,127.0,127.0,5,1111,25.0,843.0,843.0
0.005,6,10,1779,5,928,1.0,660.0,660.0,5,851,1.0,583.0,583.0
0.009,6,10,1972,5,910,2.0,642.0,642.0,5,1062,2.0,794.0,794.0
308.43,17,20,1124,10,716,34255.0,48.0,43.0,10,408,34256.0,20.0,12.0
0.126,6,10,1506,5,395,29.0,127.0,127.0,5,1111,27.0,843.0,843.0
240.385,6,35,10496,17,1898,15023.0,622.0,198.0,18,8598,14140.0,1402.0,638.0
0.004,17,2,170,1,65,0.0,37.0,37.0,1,105,0.0,77.0,77.0
0.013,6,10,1990,5,911,3.0,643.0,643.0,5,1079,3.0,811.0,811.0
0.04,17,4,284,2,120,0.0,32.0,32.0,2,164,36.0,60.0,54.0
0.132,17,4,284,2,120,0.0,32.0,32.0,2,164,129.0,60.0,54.0
0.166,17,2,152,1,76,0.0,48.0,48.0,1,76,0.0,48.0,48.0
40.066,17,10,676,5,460,10015.0,104.0,64.0,5,216,10015.0,20.0,15.0
0.025,6,14,3965,7,495,4.0,123.0,123.0,7,3470,4.0,1448.0,1032.0
0.116,6,10,1506,5,395,25.0,127.0,127.0,5,1111,21.0,843.0,843.0
0.07,17,2,152,1,76,0.0,48.0,48.0,1,76,0.0,48.0,48.0
10.821,17,28,4424,14,1995,823.0,270.0,114.0,14,2429,823.0,588.0,145.0
0.006,6,10,1547,5,764,1.0,496.0,496.0,5,783,1.0,515.0,515.0
0.007,6,12,1698,6,863,1.0,327.0,271.0,6,835,1.0,515.0,515.0
0.085,6,10,1506,5,395,20.0,127.0,127.0,5,1111,18.0,843.0,843.0
241.67,6,298,342447,121,17807,2013.0,2736.0,886.0,177,324640,1373.0,2769.0,1888.0
0.004,17,2,148,1,60,0.0,32.0,32.0,1,88,0.0,60.0,60.0
0.011,6,10,1989,5,910,2.0,642.0,642.0,5,1079,2.0,811.0,811.0
0.008,17,2,194,1,59,0.0,31.0,31.0,1,135,0.0,107.0,107.0
0.112,6,10,1506,5,395,26.0,127.0,127.0,5,1111,20.0,843.0,843.0
0.006,6,10,1689,5,839,1.0,571.0,571.0,5,850,1.0,582.0,582.0
40.075,17,10,676,5,460,10017.0,104.0,64.0,5,216,10017.0,20.0,15.0
0.001,17,2,180,1,66,0.0,38.0,38.0,1,114,0.0,86.0,86.0
0.128,17,2,80,1,32,0.0,4.0,4.0,1,48,0.0,20.0,20.0
0.076,6,10,1506,5,395,16.0,127.0,127.0,5,1111,17.0,843.0,843.0
0.109,6,10,1506,5,395,25.0,127.0,127.0,5,1111,25.0,843.0,843.0
0.006,6,10,1547,5,764,1.0,496.0,496.0,5,783,1.0,515.0,515.0
0.011,6,10,1990,5,911,2.0,643.0,643.0,5,1079,2.0,811.0,811.0
0.005,6,10,2006,5,927,1.0,659.0,659.0,5,1079,1.0,811.0,811.0
240.016,6,9,787,5,488,60004.0,232.0,232.0,4,299,80004.0,83.0,83.0
366.343,6,22,2313,16,867,24422.0,195.0,195.0,6,1446,4658.0,419.0,398.0
0.004,17,2,136,1,60,0.0,32.0,32.0,1,76,0.0,48.0,48.0
0.005,6,10,2007,5,928,1.0,660.0,660.0,5,1079,1.0,811.0,811.0
0.005,6,10,1854,5,889,1.0,621.0,621.0,5,965,1.0,697.0,697.0
0.005,6,10,1547,5,764,1.0,496.0,496.0,5,783,1.0,515.0,515.0
0.005,6,10,2006,5,927,1.0,659.0,659.0,5,1079,1.0,811.0,811.0
0.004,6,10,2007,5,928,1.0,660.0,660.0,5,1079,1.0,811.0,811.0
0.01,6,10,1990,5,911,2.0,643.0,643.0,5,1079,2.0,811.0,811.0
0.061,6,10,1506,5,395,13.0,127.0,127.0,5,1111,13.0,843.0,843.0
0.061,17,2,80,1,32,0.0,4.0,4.0,1,48,0.0,20.0,20.0
0.004,6,10,1989,5,927,1.0,659.0,659.0,5,1062,1.0,794.0,794.0
0.005,6,10,1547,5,764,1.0,496.0,496.0,5,783,1.0,515.0,515.0
178.535,17,84,11748,42,2808,4354.0,44.0,38.0,42,8940,4354.0,239.0,184.0
125.981,6,14,2938,8,2504,17963.0,1414.0,1086.0,6,434,25149.0,182.0,182.0
0.005,6,10,2007,5,928,1.0,660.0,660.0,5,1079,1.0,811.0,811.0
0.006,6,10,1547,5,764,1.0,496.0,496.0,5,783,1.0,515.0,515.0
0.005,6,10,2006,5,927,1.0,659.0,659.0,5,1079,1.0,811.0,811.0
0.107,6,10,1506,5,395,24.0,127.0,127.0,5,1111,24.0,843.0,843.0
0.08,6,10,1506,5,395,18.0,127.0,127.0,5,1111,16.0,843.0,843.0
0.129,17,4,284,2,120,0.0,32.0,32.0,2,164,126.0,60.0,54.0
0.005,17,2,179,1,71,0.0,43.0,43.0,1,108,0.0,80.0,80.0
0.011,6,10,1972,5,910,2.0,642.0,642.0,5,1062,2.0,794.0,794.0
0.005,6,10,1547,5,764,1.0,496.0,496.0,5,783,1.0,515.0,515.0
0.043,17,2,152,1,76,0.0,48.0,48.0,1,76,0.0,48.0,48.0
0.016,6,10,1972,5,910,4.0,642.0,642.0,5,1062,4.0,794.0,794.0
0.169,6,3,453,2,321,169.0,241.0,241.0,1,132,0.0,92.0,92.0
0.087,6,10,1506,5,395,20.0,127.0,127.0,5,1111,19.0,843.0,843.0
0.013,6,10,1989,5,910,3.0,642.0,642.0,5,1079,3.0,811.0,811.0
10.964,17,26,4101,13,1846,904.0,269.0,114.0,13,2255,904.0,586.0,145.0
15.073,17,14,9190,8,6902,2149.0,1350.0,834.0,6,2288,3008.0,1350.0,353.0
0.341,17,46,27187,24,21174,14.0,1350.0,854.0,22,6013,13.0,1350.0,245.0
0.008,6,12,1926,6,1189,1.0,659.0,434.0,6,737,1.0,417.0,417.0
0.009,6,13,3735,7,497,1.0,125.0,125.0,6,3238,1.0,1470.0,1459.0
0.004,6,14,3736,7,446,0.0,74.0,74.0,7,3290,0.0,1448.0,972.0
0.006,6,10,1547,5,764,1.0,496.0,496.0,5,783,1.0,515.0,515.0
0.012,6,10,1983,5,910,3.0,642.0,642.0,5,1073,2.0,805.0,805.0
0.004,6,10,1779,5,928,1.0,660.0,660.0,5,851,1.0,583.0,583.0
0.014,6,10,1631,5,848,3.0,580.0,580.0,5,783,3.0,515.0,515.0
0.01,6,10,1972,5,910,2.0,642.0,642.0,5,1062,2.0,794.0,794.0
0.005,6,14,3799,7,509,0.0,137.0,137.0,7,3290,0.0,1448.0,972.0
0.033,6,10,1972,5,910,8.0,642.0,642.0,5,1062,8.0,794.0,794.0
0.02,6,10,1631,5,848,5.0,580.0,580.0,5,783,4.0,515.0,515.0
0.009,6,10,1972,5,910,2.0,642.0,642.0,5,1062,2.0,794.0,794.0
309.023,17,20,1124,10,716,34329.0,48.0,43.0,10,408,34327.0,20.0,12.0
0.069,6,10,1506,5,395,15.0,127.0,127.0,5,1111,16.0,843.0,843.0
40.052,17,10,676,5,460,10012.0,104.0,64.0,5,216,10012.0,20.0,15.0
0.005,6,10,2007,5,928,1.0,660.0,660.0,5,1079,1.0,811.0,811.0
0.005,17,2,144,1,64,0.0,36.0,36.0,1,80,0.0,52.0,52.0
0.004,6,10,2006,5,927,1.0,659.0,659.0,5,1079,1.0,811.0,811.0
0.008,6,13,3690,7,452,1.0,80.0,80.0,6,3238,1.0,1470.0,1459.0
0.013,6,10,1972,5,910,3.0,642.0,642.0,5,1062,3.0,794.0,794.0
0.001,17,2,180,1,66,0.0,38.0,38.0,1,114,0.0,86.0,86.0
0.145,6,10,1506,5,395,29.0,127.0,127.0,5,1111,34.0,843.0,843.0
0.005,17,2,164,1,74,0.0,46.0,46.0,1,90,0.0,62.0,62.0
265.931,6,40,10165,16,6832,17728.0,1904.0,667.0,24,3333,11562.0,580.0,138.0
0.015,6,10,1989,5,910,3.0,642.0,642.0,5,1079,3.0,811.0,811.0
0.004,17,2,148,1,60,0.0,32.0,32.0,1,88,0.0,60.0,60.0
0.104,6,10,1506,5,395,22.0,127.0,127.0,5,1111,22.0,843.0,843.0
336.048,17,20,1124,10,716,37323.0,48.0,43.0,10,408,37323.0,20.0,12.0
0.004,17,2,148,1,60,0.0,32.0,32.0,1,88,0.0,60.0,60.0
0.005,6,10,2006,5,927,1.0,659.0,659.0,5,1079,1.0,811.0,811.0
10.831,17,28,4422,14,1994,824.0,269.0,114.0,14,2428,824.0,587.0,145.0
0.004,17,2,148,1,60,0.0,32.0,32.0,1,88,0.0,60.0,60.0
0.007,6,14,3787,7,497,1.0,125.0,125.0,7,3290,1.0,1448.0,972.0
10.707,17,28,4421,14,1994,815.0,269.0,114.0,14,2427,815.0,586.0,145.0
0.006,6,14,3736,7,446,1.0,74.0,74.0,7,3290,0.0,1448.0,972.0
0.004,6,10,2000,5,927,1.0,659.0,659.0,5,1073,1.0,805.0,805.0
0.096,6,10,1506,5,395,21.0,127.0,127.0,5,1111,20.0,843.0,843.0
0.013,6,10,1983,5,910,3.0,642.0,642.0,5,1073,3.0,805.0,805.0
0.012,6,10,1677,5,827,3.0,559.0,559.0,5,850,3.0,582.0,582.0
0.009,6,12,1926,6,1189,1.0,659.0,434.0,6,737,1.0,417.0,417.0
0.005,6,10,2006,5,927,1.0,659.0,659.0,5,1079,1.0,811.0,811.0
0.012,6,10,1972,5,910,3.0,642.0,642.0,5,1062,2.0,794.0,794.0
40.06,17,10,676,5,460,10014.0,104.0,64.0,5,216,10014.0,20.0,15.0
0.006,17,2,136,1,60,0.0,32.0,32.0,1,76,0.0,48.0,48.0
0.069,6,10,1506,5,395,14.0,127.0,127.0,5,1111,15.0,843.0,843.0
31.567,6,31,14399,16,2489,2104.0,1004.0,411.0,15,11910,2252.0,1402.0,1112.0
0.014,6,10,1990,5,911,3.0,643.0,643.0,5,1079,3.0,811.0,811.0
0.111,6,10,1506,5,395,26.0,127.0,127.0,5,1111,22.0,843.0,843.0
300.293,6,16,2170,9,684,37515.0,146.0,146.0,7,1486,50021.0,419.0,398.0
0.007,6,10,2006,5,927,1.0,659.0,659.0,5,1079,1.0,811.0,811.0
0.008,6,12,1926,6,1189,1.0,659.0,434.0,6,737,1.0,417.0,417.0
0.006,17,2,146,1,65,0.0,37.0,37.0,1,81,0.0,53.0,53.0
0.005,6,10,2006,5,927,1.0,659.0,659.0,5,1079,1.0,811.0,811.0
0.005,17,2,166,1,75,0.0,47.0,47.0,1,91,0.0,63.0,63.0
0.009,17,2,144,1,64,0.0,36.0,36.0,1,80,0.0,52.0,52.0
1770.725,6,84,4422,42,2211,43187.0,27.0,27.0,42,2211,43187.0,27.0,27.0
0.059,6,10,1506,5,395,12.0,127.0,127.0,5,1111,14.0,843.0,843.0
0.006,6,10,1547,5,764,1.0,496.0,496.0,5,783,1.0,515.0,515.0
0.038,17,2,148,1,60,0.0,32.0,32.0,1,88,0.0,60.0,60.0
0.006,6,10,2000,5,927,1.0,659.0,659.0,5,1073,1.0,805.0,805.0
126.053,6,14,2938,8,2504,17973.0,1414.0,1086.0,6,434,25163.0,182.0,182.0
0.001,17,2,166,1,75,0.0,47.0,47.0,1,91,0.0,63.0,63.0
0.083,6,10,1506,5,395,18.0,127.0,127.0,5,1111,19.0,843.0,843.0
0.016,6,10,1762,5,911,4.0,643.0,643.0,5,851,4.0,583.0,583.0
0.005,17,2,144,1,64,0.0,36.0,36.0,1,80,0.0,52.0,52.0
0.004,6,10,1779,5,928,1.0,660.0,660.0,5,851,0.0,583.0,583.0
0.095,6,10,1506,5,395,19.0,127.0,127.0,5,1111,22.0,843.0,843.0
19.491,6,36,9526,18,4008,518.0,1543.0,814.0,18,5518,1136.0,2667.0,435.0
0.004,6,10,2000,5,927,1.0,659.0,659.0,5,1073,1.0,805.0,805.0
0.006,6,10,1774,5,923,1.0,655.0,655.0,5,851,1.0,583.0,583.0
0.013,6,10,1677,5,827,3.0,559.0,559.0,5,850,3.0,582.0,582.0
0.003,17,2,136,1,60,0.0,32.0,32.0,1,76,0.0,48.0,48.0
0.016,6,10,1677,5,827,4.0,559.0,559.0,5,850,4.0,582.0,582.0
40.058,17,10,676,5,460,10013.0,104.0,64.0,5,216,10013.0,20.0,15.0
0.004,17,2,164,1,74,0.0,46.0,46.0,1,90,0.0,62.0,62.0
0.068,6,10,1506,5,395,13.0,127.0,127.0,5,1111,16.0,843.0,843.0
0.016,6,10,1990,5,911,4.0,643.0,643.0,5,1079,4.0,811.0,811.0
240.099,6,16,4481,9,963,30012.0,238.0,166.0,7,3518,40015.0,1402.0,786.0
0.001,17,2,166,1,75,0.0,47.0,47.0,1,91,0.0,63.0,63.0
0.012,6,10,1983,5,910,2.0,642.0,642.0,5,1073,2.0,805.0,805.0
309.161,17,20,1124,10,716,34337.0,48.0,43.0,10,408,34336.0,20.0,12.0
0.005,6,10,1989,5,927,1.0,659.0,659.0,5,1062,1.0,794.0,794.0
291.942,6,406,349208,200,21949,1467.0,2736.0,888.0,206,327259,1424.0,2848.0,1648.0
0.004,17,2,160,1,72,0.0,44.0,44.0,1,88,0.0,60.0,60.0
0.061,17,2,152,1,76,0.0,48.0,48.0,1,76,0.0,48.0,48.0
0.004,17,2,136,1,60,0.0,32.0,32.0,1,76,0.0,48.0,48.0
0.101,6,10,1506,5,395,24.0,127.0,127.0,5,1111,22.0,843.0,843.0
40.08,17,10,676,5,460,10018.0,104.0,64.0,5,216,10019.0,20.0,15.0
0.023,6,13,3735,7,497,3.0,125.0,125.0,6,3238,4.0,1470.0,1459.0
159.062,17,94,13420,47,3157,3457.0,44.0,39.0,47,10263,3457.0,260.0,190.0
0.016,17,2,198,1,91,0.0,63.0,63.0,1,107,0.0,79.0,79.0
0.004,17,4,284,2,120,0.0,32.0,32.0,2,164,0.0,60.0,54.0
0.038,17,2,136,1,60,0.0,32.0,32.0,1,76,0.0,48.0,48.0
0.006,6,10,1689,5,839,1.0,571.0,571.0,5,850,1.0,582.0,582.0
0.033,6,10,1983,5,910,8.0,642.0,642.0,5,1073,8.0,805.0,805.0
0.006,6,10,1689,5,839,1.0,571.0,571.0,5,850,1.0,582.0,582.0
0.005,6,10,1989,5,927,1.0,659.0,659.0,5,1062,1.0,794.0,794.0
0.003,17,2,170,1,65,0.0,37.0,37.0,1,105,0.0,77.0,77.0
0.004,6,10,2000,5,927,1.0,659.0,659.0,5,1073,1.0,805.0,805.0
0.015,6,13,3735,7,497,2.0,125.0,125.0,6,3238,2.0,1470.0,1459.0
0.053,17,2,152,1,76,0.0,48.0,48.0,1,76,0.0,48.0,48.0
0.012,6,10,1762,5,911,2.0,643.0,643.0,5,851,2.0,583.0,583.0
240.017,6,9,787,5,488,60004.0,232.0,232.0,4,299,80004.0,83.0,83.0
0.103,6,10,1506,5,395,23.0,127.0,127.0,5,1111,22.0,843.0,843.0
0.099,6,10,1506,5,395,22.0,127.0,127.0,5,1111,22.0,843.0,843.0
0.039,17,4,284,2,120,0.0,32.0,32.0,2,164,35.0,60.0,54.0
0.114,6,10,1506,5,395,22.0,127.0,127.0,5,1111,25.0,843.0,843.0
15.072,17,15,9238,8,6902,2149.0,1350.0,834.0,7,2336,2507.0,1350.0,305.0
0.004,17,4,284,2,120,0.0,32.0,32.0,2,164,0.0,60.0,54.0
177.589,17,80,11270,40,2664,4553.0,44.0,38.0,40,8606,4553.0,239.0,187.0
0.016,6,10,1989,5,910,3.0,642.0,642.0,5,1079,4.0,811.0,811.0
20.54,6,36,9704,18,4186,522.0,1753.0,858.0,18,5518,1198.0,2667.0,435.0
0.012,6,14,3787,7,497,2.0,125.0,125.0,7,3290,1.0,1448.0,972.0
312.027,17,20,1124,10,716,34662.0,48.0,43.0,10,408,34662.0,20.0,12.0
0.089,6,10,1506,5,395,21.0,127.0,127.0,5,1111,21.0,843.0,843.0
0.016,6,10,1631,5,848,4.0,580.0,580.0,5,783,3.0,515.0,515.0
10.89,17,28,4420,14,1993,828.0,268.0,114.0,14,2427,828.0,586.0,145.0
0.019,6,10,1990,5,911,4.0,643.0,643.0,5,1079,4.0,811.0,811.0
0.008,6,10,1689,5,839,1.0,571.0,571.0,5,850,1.0,582.0,582.0
310.013,17,20,1124,10,716,34432.0,48.0,43.0,10,408,34432.0,20.0,12.0
0.006,6,10,1547,5,764,1.0,496.0,496.0,5,783,1.0,515.0,515.0
0.005,6,10,2007,5,928,1.0,660.0,660.0,5,1079,1.0,811.0,811.0
0.01,6,10,1972,5,910,2.0,642.0,642.0,5,1062,2.0,794.0,794.0
0.01,6,10,1989,5,910,2.0,642.0,642.0,5,1079,2.0,811.0,811.0
0.005,6,10,2006,5,927,1.0,659.0,659.0,5,1079,1.0,811.0,811.0
0.119,6,10,1506,5,395,27.0,127.0,127.0,5,1111,24.0,843.0,843.0
0.005,17,2,166,1,75,0.0,47.0,47.0,1,91,0.0,63.0,63.0
300.744,6,24,6780,13,2022,25061.0,1038.0,331.0,11,4758,30074.0,1592.0,698.0
40.079,17,10,676,5,460,10017.0,104.0,64.0,5,216,10018.0,20.0,15.0
0.006,6,10,1854,5,889,1.0,621.0,621.0,5,965,1.0,697.0,697.0
0.038,17,2,148,1,60,0.0,32.0,32.0,1,88,0.0,60.0,60.0
0.009,6,10,1762,5,911,2.0,643.0,643.0,5,851,2.0,583.0,583.0
1793.987,6,84,5193,42,2234,43754.0,50.0,50.0,42,2959,43754.0,775.0,775.0
0.005,6,13,3747,7,509,0.0,137.0,137.0,6,3238,1.0,1470.0,1459.0
0.105,6,10,1506,5,395,25.0,127.0,127.0,5,1111,19.0,843.0,843.0
40.066,17,10,676,5,460,10014.0,104.0,64.0,5,216,10015.0,20.0,15.0
0.005,6,10,2006,5,927,1.0,659.0,659.0,5,1079,1.0,811.0,811.0
1777.859,17,144,45504,72,22752,25040.0,288.0,288.0,72,22752,25040.0,288.0,288.0
0.034,17,2,213,1,69,0.0,41.0,41.0,1,144,0.0,116.0,116.0
0.107,6,10,1506,5,395,20.0,127.0,127.0,5,1111,23.0,843.0,843.0
0.004,6,10,2006,5,927,1.0,659.0,659.0,5,1079,1.0,811.0,811.0
0.072,17,2,182,1,65,0.0,37.0,37.0,1,117,0.0,89.0,89.0
0.008,6,12,1926,6,1189,1.0,659.0,434.0,6,737,1.0,417.0,417.0
0.103,6,10,1506,5,395,24.0,127.0,127.0,5,1111,22.0,843.0,843.0
0.005,17,2,148,1,60,0.0,32.0,32.0,1,88,0.0,60.0,60.0
0.014,6,10,1989,5,910,3.0,642.0,642.0,5,1079,3.0,811.0,811.0
0.088,6,10,1506,5,395,20.0,127.0,127.0,5,1111,21.0,843.0,843.0
0.001,17,2,180,1,66,0.0,38.0,38.0,1,114,0.0,86.0,86.0
40.078,17,10,676,5,460,10017.0,104.0,64.0,5,216,10018.0,20.0,15.0
0.016,17,2,198,1,91,0.0,63.0,63.0,1,107,0.0,79.0,79.0
0.109,6,10,1506,5,395,23.0,127.0,127.0,5,1111,24.0,843.0,843.0
0.005,6,10,1854,5,889,1.0,621.0,621.0,5,965,1.0,697.0,697.0
0.164,6,10,1506,5,395,29.0,127.0,127.0,5,1111,38.0,843.0,843.0
0.137,6,10,1506,5,395,31.0,127.0,127.0,5,1111,32.0,843.0,843.0
0.053,17,2,152,1,76,0.0,48.0,48.0,1,76,0.0,48.0,48.0
0.006,17,2,293,1,73,0.0,45.0,45.0,1,220,0.0,192.0,192.0
0.005,6,10,1702,5,863,1.0,595.0,595.0,5,839,1.0,571.0,571.0
178.097,17,78,11165,39,2617,4686.0,44.0,39.0,39,8548,4686.0,249.0,191.0
11.143,17,28,4423,14,1994,844.0,269.0,114.0,14,2429,844.0,588.0,145.0
0.004,6,10,2006,5,927,1.0,659.0,659.0,5,1079,1.0,811.0,811.0
240.089,6,16,4481,9,963,30011.0,238.0,166.0,7,3518,40014.0,1402.0,786.0
0.257,17,38,20227,21,17043,12.0,1350.0,783.0,17,3184,12.0,1350.0,159.0
40.068,17,10,676,5,460,10014.0,104.0,64.0,5,216,10016.0,20.0,15.0
0.069,17,8,3613,4,1874,23.0,1350.0,440.0,4,1739,11.0,1350.0,406.0
0.219,17,4,352,2,130,179.0,37.0,37.0,2,222,146.0,89.0,83.0
0.006,6,10,1689,5,839,1.0,571.0,571.0,5,850,1.0,582.0,582.0
0.018,6,13,3735,7,497,3.0,125.0,125.0,6,3238,3.0,1470.0,1459.0
0.005,6,10,1989,5,927,1.0,659.0,659.0,5,1062,1.0,794.0,794.0
0.083,6,10,1506,5,395,18.0,127.0,127.0,5,1111,17.0,843.0,843.0
0.004,6,10,1702,5,863,1.0,595.0,595.0,5,839,0.0,571.0,571.0
1729.878,6,77,13927,49,5244,36039.0,1402.0,116.0,28,8683,64063.0,1402.0,288.0
0.005,6,14,3799,7,509,0.0,137.0,137.0,7,3290,0.0,1448.0,972.0
0.005,6,10,1989,5,927,1.0,659.0,659.0,5,1062,1.0,794.0,794.0
0.001,17,2,166,1,75,0.0,47.0,47.0,1,91,0.0,63.0,63.0
0.02,6,10,1989,5,910,5.0,642.0,642.0,5,1079,4.0,811.0,811.0
0.163,17,2,152,1,76,0.0,48.0,48.0,1,76,0.0,48.0,48.0
0.018,6,10,1989,5,910,4.0,642.0,642.0,5,1079,4.0,811.0,811.0
0.011,6,10,1972,5,910,2.0,642.0,642.0,5,1062,2.0,794.0,794.0
0.23,6,16,2669,8,1395,32.0,533.0,323.0,8,1274,21.0,529.0,212.0
0.015,6,10,1989,5,910,3.0,642.0,642.0,5,1079,3.0,811.0,811.0
0.001,17,2,180,1,66,0.0,38.0,38.0,1,114,0.0,86.0,86.0
0.017,6,10,1983,5,910,4.0,642.0,642.0,5,1073,4.0,805.0,805.0
10.783,17,28,4418,14,1995,820.0,270.0,114.0,14,2423,820.0,586.0,145.0
0.005,6,10,2006,5,927,1.0,659.0,659.0,5,1079,1.0,811.0,811.0
0.005,6,13,3690,7,452,0.0,80.0,80.0,6,3238,1.0,1470.0,1459.0
0.008,6,10,1983,5,910,2.0,642.0,642.0,5,1073,2.0,805.0,805.0
0.004,17,2,168,1,76,0.0,48.0,48.0,1,92,0.0,64.0,64.0
0.006,6,10,1689,5,839,1.0,571.0,571.0,5,850,1.0,582.0,582.0
0.004,17,4,284,2,120,0.0,32.0,32.0,2,164,0.0,60.0,54.0
0.005,6,14,3742,7,452,0.0,80.0,80.0,7,3290,0.0,1448.0,972.0
0.009,6,10,1989,5,910,2.0,642.0,642.0,5,1079,2.0,811.0,811.0
0.007,6,10,1989,5,910,1.0,642.0,642.0,5,1079,1.0,811.0,811.0
0.001,17,2,180,1,66,0.0,38.0,38.0,1,114,0.0,86.0,86.0
0.099,6,10,1506,5,395,22.0,127.0,127.0,5,1111,20.0,843.0,843.0
0.006,6,10,1547,5,764,1.0,496.0,496.0,5,783,1.0,515.0,515.0
15.071,17,15,9239,8,6902,2149.0,1350.0,834.0,7,2337,2507.0,1350.0,305.0
0.08,6,10,1506,5,395,18.0,127.0,127.0,5,1111,16.0,843.0,843.0
0.116,6,10,1506,5,395,27.0,127.0,127.0,5,1111,25.0,843.0,843.0
300.376,6,27,8925,15,1930,21455.0,517.0,285.0,12,6995,21851.0,1402.0,909.0
0.006,6,10,1547,5,764,1.0,496.0,496.0,5,783,1.0,515.0,515.0
0.005,6,10,2006,5,927,1.0,659.0,659.0,5,1079,1.0,811.0,811.0
0.012,6,10,1983,5,910,3.0,642.0,642.0,5,1073,3.0,805.0,805.0
0.011,6,10,1972,5,910,2.0,642.0,642.0,5,1062,2.0,794.0,794.0
0.005,6,13,3747,7,509,0.0,137.0,137.0,6,3238,1.0,1470.0,1459.0
1780.817,6,339,76208,143,57524,12540.0,2720.0,466.0,196,18684,9131.0,1360.0,125.0
0.013,6,10,1990,5,911,3.0,643.0,643.0,5,1079,3.0,811.0,811.0
0.003,17,4,284,2,120,0.0,32.0,32.0,2,164,0.0,60.0,54.0
0.005,17,2,170,1,65,0.0,37.0,37.0,1,105,0.0,77.0,77.0
0.128,6,10,1506,5,395,30.0,127.0,127.0,5,1111,26.0,843.0,843.0
0.072,6,10,1506,5,395,16.0,127.0,127.0,5,1111,13.0,843.0,843.0
15.086,17,16,8462,8,6176,2151.0,1350.0,744.0,8,2286,2150.0,1350.0,257.0
0.008,6,10,1983,5,910,2.0,642.0,642.0,5,1073,1.0,805.0,805.0
0.013,6,10,1677,5,827,3.0,559.0,559.0,5,850,3.0,582.0,582.0
0.077,6,10,1506,5,395,18.0,127.0,127.0,5,1111,16.0,843.0,843.0
0.005,6,10,1689,5,839,1.0,571.0,571.0,5,850,1.0,582.0,582.0
0.012,6,13,3735,7,497,2.0,125.0,125.0,6,3238,2.0,1470.0,1459.0
0.005,6,10,2007,5,928,1.0,660.0,660.0,5,1079,1.0,811.0,811.0
0.017,6,10,1972,5,910,4.0,642.0,642.0,5,1062,4.0,794.0,794.0
0.116,6,10,1506,5,395,23.0,127.0,127.0,5,1111,24.0,843.0,843.0
0.02,6,10,1990,5,911,4.0,643.0,643.0,5,1079,5.0,811.0,811.0
0.005,6,10,2006,5,927,1.0,659.0,659.0,5,1079,1.0,811.0,811.0
0.001,17,2,294,1,64,0.0,36.0,36.0,1,230,0.0,202.0,202.0
15.329,17,44,26602,26,23431,612.0,1350.0,873.0,18,3171,900.0,1350.0,148.0
240.089,6,16,4481,9,963,30011.0,238.0,166.0,7,3518,40014.0,1402.0,786.0
0.005,17,2,170,1,65,0.0,37.0,37.0,1,105,0.0,77.0,77.0
325.078,17,18,1008,9,640,40627.0,48.0,43.0,9,368,40627.0,20.0,12.0
0.068,6,10,1506,5,395,14.0,127.0,127.0,5,1111,15.0,843.0,843.0
0.019,6,10,1990,5,911,4.0,643.0,643.0,5,1079,4.0,811.0,811.0
0.004,6,10,2006,5,927,1.0,659.0,659.0,5,1079,1.0,811.0,811.0
15.073,17,15,9238,8,6902,2149.0,1350.0,834.0,7,2336,2507.0,1350.0,305.0
0.013,6,10,1631,5,848,3.0,580.0,580.0,5,783,3.0,515.0,515.0
0.011,6,10,1762,5,911,2.0,643.0,643.0,5,851,2.0,583.0,583.0
15.085,17,15,7968,8,5922,2150.0,1350.0,712.0,7,2046,2508.0,1350.0,264.0
353.411,6,20,2210,6,1308,12003.0,494.0,494.0,14,902,27185.0,83.0,83.0
366.059,6,22,2313,16,867,24403.0,195.0,195.0,6,1446,4646.0,419.0,398.0
0.004,6,10,2006,5,927,1.0,659.0,659.0,5,1079,1.0,811.0,811.0
0.008,6,10,2006,5,927,2.0,659.0,659.0,5,1079,2.0,811.0,811.0
0.014,6,10,1989,5,910,3.0,642.0,642.0,5,1079,3.0,811.0,811.0
0.006,6,10,1989,5,927,1.0,659.0,659.0,5,1062,1.0,794.0,794.0
0.005,6,10,2006,5,927,1.0,659.0,659.0,5,1079,1.0,811.0,811.0
0.006,6,10,1547,5,764,1.0,496.0,496.0,5,783,1.0,515.0,515.0
0.085,6,10,1506,5,395,18.0,127.0,127.0,5,1111,20.0,843.0,843.0
0.008,6,10,1631,5,848,2.0,580.0,580.0,5,783,1.0,515.0,515.0
0.008,6,10,1677,5,827,2.0,559.0,559.0,5,850,2.0,582.0,582.0
0.003,17,2,136,1,60,0.0,32.0,32.0,1,76,0.0,48.0,48.0
0.004,17,2,152,1,76,0.0,48.0,48.0,1,76,0.0,48.0,48.0
0.007,6,10,1854,5,889,1.0,621.0,621.0,5,965,1.0,697.0,697.0
0.005,17,2,222,1,65,0.0,37.0,37.0,1,157,0.0,129.0,129.0
0.038,17,2,144,1,64,0.0,36.0,36.0,1,80,0.0,52.0,52.0
0.01,6,10,1972,5,910,2.0,642.0,642.0,5,1062,2.0,794.0,794.0
0.171,6,3,453,2,321,171.0,241.0,241.0,1,132,0.0,92.0,92.0
0.005,6,10,1643,5,860,1.0,592.0,592.0,5,783,1.0,515.0,515.0
0.014,6,10,1972,5,910,3.0,642.0,642.0,5,1062,3.0,794.0,794.0
309.868,17,20,1124,10,716,34415.0,48.0,43.0,10,408,34415.0,20.0,12.0
0.004,17,2,136,1,60,0.0,32.0,32.0,1,76,0.0,48.0,48.0
0.011,6,10,1989,5,910,2.0,642.0,642.0,5,1079,2.0,811.0,811.0
0.013,6,10,1983,5,910,3.0,642.0,642.0,5,1073,3.0,805.0,805.0
361.805,6,21,1793,16,1030,24120.0,190.0,190.0,5,763,60009.0,462.0,247.0
0.038,17,2,152,1,76,0.0,48.0,48.0,1,76,0.0,48.0,48.0
0.004,6,10,1989,5,927,1.0,659.0,659.0,5,1062,1.0,794.0,794.0
40.059,17,10,676,5,460,10013.0,104.0,64.0,5,216,10013.0,20.0,15.0
0.011,6,10,1677,5,827,2.0,559.0,559.0,5,850,2.0,582.0,582.0
15.071,17,15,9238,8,6902,2149.0,1350.0,834.0,7,2336,2506.0,1350.0,305.0
0.151,6,10,1506,5,395,36.0,127.0,127.0,5,1111,24.0,843.0,843.0
0.093,6,10,1506,5,395,20.0,127.0,127.0,5,1111,20.0,843.0,843.0
0.086,6,10,1506,5,395,19.0,127.0,127.0,5,1111,18.0,843.0,843.0
240.101,6,16,4481,9,963,30012.0,238.0,166.0,7,3518,40015.0,1402.0,786.0
0.004,6,10,1989,5,927,1.0,659.0,659.0,5,1062,1.0,794.0,794.0
0.005,6,10,2006,5,927,1.0,659.0,659.0,5,1079,1.0,811.0,811.0
0.137,6,10,1506,5,395,31.0,127.0,127.0,5,1111,32.0,843.0,843.0
0.014,6,10,1983,5,910,3.0,642.0,642.0,5,1073,3.0,805.0,805.0
0.239,17,44,24346,24,21177,10.0,1350.0,854.0,20,3169,9.0,1350.0,130.0
0.083,6,10,1506,5,395,18.0,127.0,127.0,5,1111,18.0,843.0,843.0
0.005,6,10,2000,5,927,1.0,659.0,659.0,5,1073,1.0,805.0,805.0
55.801,6,36,9771,18,4253,525.0,1360.0,700.0,18,5518,3272.0,2667.0,435.0
0.013,6,10,1990,5,911,3.0,643.0,643.0,5,1079,3.0,811.0,811.0
0.013,6,10,1631,5,848,3.0,580.0,580.0,5,783,3.0,515.0,515.0
0.009,6,10,1989,5,910,2.0,642.0,642.0,5,1079,2.0,811.0,811.0
354.041,6,19,1691,15,978,25288.0,190.0,190.0,4,713,80002.0,497.0,497.0
0.001,17,2,180,1,66,0.0,38.0,38.0,1,114,0.0,86.0,86.0
240.048,6,9,787,5,488,60012.0,232.0,232.0,4,299,80013.0,83.0,83.0
0.116,6,10,1506,5,395,23.0,127.0,127.0,5,1111,27.0,843.0,843.0
0.011,6,10,1989,5,910,2.0,642.0,642.0,5,1079,2.0,811.0,811.0
0.004,6,10,2007,5,928,1.0,660.0,660.0,5,1079,1.0,811.0,811.0
0.006,6,10,1547,5,764,1.0,496.0,496.0,5,783,1.0,515.0,515.0
0.134,6,14,4389,8,923,19.0,238.0,166.0,6,3466,18.0,1402.0,786.0
0.114,6,10,1506,5,395,26.0,127.0,127.0,5,1111,25.0,843.0,843.0
271.461,6,34,13714,18,2695,15968.0,585.0,345.0,16,11019,18097.0,1402.0,1019.0
34.521,6,35,8426,17,1954,536.0,886.0,414.0,18,6472,2023.0,2126.0,478.0
0.018,6,10,1972,5,910,4.0,642.0,642.0,5,1062,4.0,794.0,794.0
0.004,17,2,136,1,60,0.0,32.0,32.0,1,76,0.0,48.0,48.0
0.005,6,10,2006,5,927,1.0,659.0,659.0,5,1079,1.0,811.0,811.0
241.98,6,313,343555,122,17846,1999.0,2736.0,958.0,191,325709,1273.0,2804.0,1744.0
0.004,17,2,136,1,60,0.0,32.0,32.0,1,76,0.0,48.0,48.0
0.256,17,45,28073,26,23457,10.0,1350.0,874.0,19,4616,10.0,1350.0,214.0
0.004,6,10,2007,5,928,1.0,660.0,660.0,5,1079,1.0,811.0,811.0
178.209,17,78,11168,39,2614,4689.0,44.0,39.0,39,8554,4689.0,260.0,191.0
0.097,6,10,1506,5,395,21.0,127.0,127.0,5,1111,21.0,843.0,843.0
0.005,6,10,1643,5,860,1.0,592.0,592.0,5,783,1.0,515.0,515.0
0.015,6,10,1983,5,910,3.0,642.0,642.0,5,1073,3.0,805.0,805.0
0.005,6,10,2006,5,927,1.0,659.0,659.0,5,1079,1.0,811.0,811.0
0.006,6,10,2007,5,928,1.0,660.0,660.0,5,1079,1.0,811.0,811.0
0.01,6,10,1631,5,848,2.0,580.0,580.0,5,783,2.0,515.0,515.0
0.099,6,10,1506,5,395,22.0,127.0,127.0,5,1111,21.0,843.0,843.0
0.073,6,10,1506,5,395,15.0,127.0,127.0,5,1111,16.0,843.0,843.0
0.215,17,4,352,2,130,178.0,37.0,37.0,2,222,143.0,89.0,83.0
0.006,6,10,1643,5,860,1.0,592.0,592.0,5,783,1.0,515.0,515.0
0.005,17,2,213,1,69,0.0,41.0,41.0,1,144,0.0,116.0,116.0
0.009,17,2,230,1,68,0.0,40.0,40.0,1,162,0.0,134.0,134.0
0.004,6,10,1702,5,863,1.0,595.0,595.0,5,839,1.0,571.0,571.0
0.0,17,2,132,1,58,0.0,30.0,30.0,1,74,0.0,46.0,46.0
0.083,6,10,1506,5,395,18.0,127.0,127.0,5,1111,18.0,843.0,843.0
0.004,6,10,2007,5,928,1.0,660.0,660.0,5,1079,1.0,811.0,811.0
0.081,6,10,1506,5,395,17.0,127.0,127.0,5,1111,15.0,843.0,843.0
0.005,17,2,144,1,64,0.0,36.0,36.0,1,80,0.0,52.0,52.0
125.969,6,14,2938,8,2504,17961.0,1414.0,1086.0,6,434,25147.0,182.0,182.0
0.004,6,10,2006,5,927,1.0,659.0,659.0,5,1079,1.0,811.0,811.0
0.004,17,2,136,1,60,0.0,32.0,32.0,1,76,0.0,48.0,48.0
0.005,17,2,179,1,71,0.0,43.0,43.0,1,108,0.0,80.0,80.0
0.004,17,4,284,2,120,0.0,32.0,32.0,2,164,0.0,60.0,54.0
0.004,6,10,2007,5,928,1.0,660.0,660.0,5,1079,1.0,811.0,811.0
0.005,17,2,179,1,71,0.0,43.0,43.0,1,108,0.0,80.0,80.0
0.011,6,10,1677,5,827,2.0,559.0,559.0,5,850,2.0,582.0,582.0
0.016,17,2,198,1,91,0.0,63.0,63.0,1,107,0.0,79.0,79.0
15.079,17,15,8052,8,5879,2150.0,1350.0,706.0,7,2173,2508.0,1350.0,282.0
0.005,6,10,2000,5,927,1.0,659.0,659.0,5,1073,1.0,805.0,805.0
0.005,6,14,3736,7,446,0.0,74.0,74.0,7,3290,0.0,1448.0,972.0
40.059,17,10,676,5,460,10013.0,104.0,64.0,5,216,10013.0,20.0,15.0
0.007,6,14,3799,7,509,1.0,137.0,137.0,7,3290,1.0,1448.0,972.0
0.005,6,10,2007,5,928,1.0,660.0,660.0,5,1079,1.0,811.0,811.0
312.234,17,20,1124,10,716,34678.0,48.0,43.0,10,408,34678.0,20.0,12.0
0.065,6,10,1506,5,395,14.0,127.0,127.0,5,1111,15.0,843.0,843.0
171.333,17,80,11270,40,2664,4393.0,44.0,38.0,40,8606,4393.0,239.0,187.0
0.005,6,10,2000,5,927,1.0,659.0,659.0,5,1073,1.0,805.0,805.0
46.602,6,51,24160,26,18133,370.0,2720.0,1551.0,25,6027,1934.0,2667.0,385.0
0.011,6,10,1990,5,911,2.0,643.0,643.0,5,1079,2.0,811.0,811.0
1729.231,6,60,4400,40,2740,44339.0,33.0,33.0,20,1660,91003.0,31.0,31.0
0.014,6,10,1990,5,911,3.0,643.0,643.0,5,1079,3.0,811.0,811.0
0.066,6,10,1506,5,395,14.0,127.0,127.0,5,1111,16.0,843.0,843.0
40.055,17,10,676,5,460,10012.0,104.0,64.0,5,216,10013.0,20.0,15.0
0.044,17,2,152,1,76,0.0,48.0,48.0,1,76,0.0,48.0,48.0
0.13,17,2,80,1,32,0.0,4.0,4.0,1,48,0.0,20.0,20.0
1786.218,6,150,19350,90,13740,20069.0,302.0,302.0,60,5610,30274.0,83.0,83.0
0.006,6,10,1547,5,764,1.0,496.0,496.0,5,783,1.0,515.0,515.0
0.006,6,10,1547,5,764,1.0,496.0,496.0,5,783,1.0,515.0,515.0
0.064,6,10,1506,5,395,14.0,127.0,127.0,5,1111,14.0,843.0,843.0
1772.696,6,106,6322,60,3525,30044.0,27.0,27.0,46,2797,39392.0,27.0,27.0
0.005,17,2,170,1,65,0.0,37.0,37.0,1,105,0.0,77.0,77.0
0.056,6,10,1989,5,910,14.0,642.0,642.0,5,1079,13.0,811.0,811.0
0.004,17,4,284,2,120,0.0,32.0,32.0,2,164,0.0,60.0,54.0
309.647,17,20,1124,10,716,34391.0,48.0,43.0,10,408,34391.0,20.0,12.0
0.005,6,10,1989,5,927,1.0,659.0,659.0,5,1062,1.0,794.0,794.0
0.008,6,12,1926,6,1189,1.0,659.0,434.0,6,737,1.0,417.0,417.0
0.074,6,10,1506,5,395,15.0,127.0,127.0,5,1111,16.0,843.0,843.0
0.007,6,10,1854,5,889,1.0,621.0,621.0,5,965,1.0,697.0,697.0
0.121,6,10,1506,5,395,26.0,127.0,127.0,5,1111,29.0,843.0,843.0
0.088,6,10,1506,5,395,19.0,127.0,127.0,5,1111,19.0,843.0,843.0
0.013,6,10,1972,5,910,3.0,642.0,642.0,5,1062,3.0,794.0,794.0
0.095,6,10,1506,5,395,20.0,127.0,127.0,5,1111,21.0,843.0,843.0
15.074,17,15,10568,9,8280,1880.0,1350.0,892.0,6,2288,3008.0,1350.0,353.0
0.016,6,10,1989,5,910,4.0,642.0,642.0,5,1079,4.0,811.0,811.0
0.069,17,8,3613,4,1874,23.0,1350.0,440.0,4,1739,11.0,1350.0,406.0
0.006,17,2,170,1,65,0.0,37.0,37.0,1,105,0.0,77.0,77.0
0.037,17,2,148,1,60,0.0,32.0,32.0,1,88,0.0,60.0,60.0
0.012,6,10,1989,5,910,3.0,642.0,642.0,5,1079,3.0,811.0,811.0
0.009,6,10,1989,5,910,2.0,642.0,642.0,5,1079,2.0,811.0,811.0
0.11,6,10,1506,5,395,24.0,127.0,127.0,5,1111,22.0,843.0,843.0
457.528,6,27,6242,15,3207,32680.0,676.0,403.0,12,3035,36136.0,824.0,480.0
240.044,6,9,787,5,488,60011.0,232.0,232.0,4,299,80013.0,83.0,83.0
0.01,6,10,1972,5,910,2.0,642.0,642.0,5,1062,2.0,794.0,794.0
0.039,17,2,144,1,64,0.0,36.0,36.0,1,80,0.0,52.0,52.0
312.67,17,20,1124,10,716,34727.0,48.0,43.0,10,408,34726.0,20.0,12.0
0.016,6,10,1989,5,910,4.0,642.0,642.0,5,1079,4.0,811.0,811.0
0.013,6,10,1989,5,910,3.0,642.0,642.0,5,1079,3.0,811.0,811.0
0.121,6,10,1506,5,395,25.0,127.0,127.0,5,1111,22.0,843.0,843.0
0.004,6,10,2007,5,928,1.0,660.0,660.0,5,1079,1.0,811.0,811.0
0.005,6,14,3736,7,446,0.0,74.0,74.0,7,3290,0.0,1448.0,972.0
173.147,17,76,10766,38,2529,4679.0,44.0,38.0,38,8237,4679.0,239.0,188.0
0.017,6,10,1990,5,911,4.0,643.0,643.0,5,1079,4.0,811.0,811.0
0.012,6,10,1989,5,910,3.0,642.0,642.0,5,1079,3.0,811.0,811.0
0.005,6,10,2006,5,927,1.0,659.0,659.0,5,1079,1.0,811.0,811.0
0.004,17,2,136,1,60,0.0,32.0,32.0,1,76,0.0,48.0,48.0
0.001,17,2,166,1,75,0.0,47.0,47.0,1,91,0.0,63.0,63.0
0.092,6,10,1506,5,395,20.0,127.0,127.0,5,1111,21.0,843.0,843.0
0.004,6,10,2006,5,927,1.0,659.0,659.0,5,1079,1.0,811.0,811.0
0.005,6,10,2007,5,928,1.0,660.0,660.0,5,1079,1.0,811.0,811.0
0.014,6,10,1990,5,911,3.0,643.0,643.0,5,1079,3.0,811.0,811.0
0.004,6,10,2000,5,927,1.0,659.0,659.0,5,1073,0.0,805.0,805.0
0.004,6,10,1774,5,923,1.0,655.0,655.0,5,851,1.0,583.0,583.0
0.008,6,10,1677,5,827,2.0,559.0,559.0,5,850,2.0,582.0,582.0
0.004,17,2,148,1,60,0.0,32.0,32.0,1,88,0.0,60.0,60.0
0.007,17,2,214,1,75,0.0,47.0,47.0,1,139,0.0,111.0,111.0
0.005,17,2,154,1,69,0.0,41.0,41.0,1,85,0.0,57.0,57.0
0.013,6,10,1989,5,910,3.0,642.0,642.0,5,1079,3.0,811.0,811.0
0.005,6,10,2007,5,928,1.0,660.0,660.0,5,1079,1.0,811.0,811.0
0.009,6,10,1983,5,910,2.0,642.0,642.0,5,1073,2.0,805.0,805.0
0.066,6,10,1506,5,395,14.0,127.0,127.0,5,1111,15.0,843.0,843.0
0.003,17,2,148,1,60,0.0,32.0,32.0,1,88,0.0,60.0,60.0
0.008,6,10,2007,5,928,1.0,660.0,660.0,5,1079,2.0,811.0,811.0
0.005,6,10,1689,5,839,1.0,571.0,571.0,5,850,1.0,582.0,582.0
0.041,17,4,336,2,124,1.0,34.0,34.0,2,212,1.0,84.0,78.0
0.005,17,2,214,1,75,0.0,47.0,47.0,1,139,0.0,111.0,111.0
0.004,6,10,2007,5,928,1.0,660.0,660.0,5,1079,1.0,811.0,811.0
0.134,17,2,80,1,32,0.0,4.0,4.0,1,48,0.0,20.0,20.0
0.004,6,10,2007,5,928,1.0,660.0,660.0,5,1079,1.0,811.0,811.0
0.112,6,10,1506,5,395,24.0,127.0,127.0,5,1111,23.0,843.0,843.0
353.249,6,20,2210,6,1308,12003.0,494.0,494.0,14,902,27172.0,83.0,83.0
0.137,6,10,1506,5,395,32.0,127.0,127.0,5,1111,32.0,843.0,843.0
0.01,6,10,1989,5,910,2.0,642.0,642.0,5,1079,2.0,811.0,811.0
0.004,6,10,1779,5,928,1.0,660.0,660.0,5,851,1.0,583.0,583.0
0.005,6,10,2006,5,927,1.0,659.0,659.0,5,1079,1.0,811.0,811.0
0.004,17,2,144,1,64,0.0,36.0,36.0,1,80,0.0,52.0,52.0
0.097,6,10,1506,5,395,16.0,127.0,127.0,5,1111,23.0,843.0,843.0
0.005,6,13,3747,7,509,0.0,137.0,137.0,6,3238,1.0,1470.0,1459.0
0.039,17,2,184,1,61,0.0,33.0,33.0,1,123,0.0,95.0,95.0
0.009,6,10,1983,5,910,2.0,642.0,642.0,5,1073,2.0,805.0,805.0
0.01,6,10,1983,5,910,2.0,642.0,642.0,5,1073,2.0,805.0,805.0
0.015,6,10,1972,5,910,3.0,642.0,642.0,5,1062,3.0,794.0,794.0
0.011,6,10,1990,5,911,2.0,643.0,643.0,5,1079,2.0,811.0,811.0
0.005,6,10,2006,5,927,1.0,659.0,659.0,5,1079,1.0,811.0,811.0
40.067,17,10,676,5,460,10013.0,104.0,64.0,5,216,10015.0,20.0,15.0
0.003,17,2,132,1,58,0.0,30.0,30.0,1,74,0.0,46.0,46.0
0.006,6,10,1547,5,764,1.0,496.0,496.0,5,783,1.0,515.0,515.0
0.04,17,4,284,2,120,0.0,32.0,32.0,2,164,36.0,60.0,54.0
0.008,6,10,1989,5,910,2.0,642.0,642.0,5,1079,2.0,811.0,811.0
40.049,17,10,676,5,460,10011.0,104.0,64.0,5,216,10011.0,20.0,15.0
0.041,17,2,152,1,76,0.0,48.0,48.0,1,76,0.0,48.0,48.0
0.129,6,10,1506,5,395,29.0,127.0,127.0,5,1111,23.0,843.0,843.0
0.006,6,10,2006,5,927,1.0,659.0,659.0,5,1079,1.0,811.0,811.0
0.012,6,10,1989,5,910,2.0,642.0,642.0,5,1079,2.0,811.0,811.0
0.128,6,10,1506,5,395,30.0,127.0,127.0,5,1111,28.0,843.0,843.0
0.005,6,10,2007,5,928,1.0,660.0,660.0,5,1079,1.0,811.0,811.0
0.067,6,10,1506,5,395,15.0,127.0,127.0,5,1111,15.0,843.0,843.0
11.015,17,28,4422,14,1994,838.0,269.0,114.0,14,2428,838.0,587.0,145.0
10.821,17,26,4102,13,1845,892.0,268.0,113.0,13,2257,892.0,588.0,145.0
0.004,6,10,2006,5,927,1.0,659.0,659.0,5,1079,1.0,811.0,811.0
0.012,6,10,1989,5,910,2.0,642.0,642.0,5,1079,3.0,811.0,811.0
0.007,6,10,1547,5,764,1.0,496.0,496.0,5,783,1.0,515.0,515.0
15.071,17,15,9238,8,6902,2149.0,1350.0,834.0,7,2336,2507.0,1350.0,305.0
0.038,17,2,184,1,61,0.0,33.0,33.0,1,123,0.0,95.0,95.0
0.003,17,2,136,1,60,0.0,32.0,32.0,1,76,0.0,48.0,48.0
0.005,17,2,146,1,65,0.0,37.0,37.0,1,81,0.0,53.0,53.0
0.02,6,10,1631,5,848,4.0,580.0,580.0,5,783,5.0,515.0,515.0
40.049,17,10,676,5,460,10011.0,104.0,64.0,5,216,10011.0,20.0,15.0
240.147,6,40,5312,20,2436,12639.0,588.0,196.0,20,2876,12639.0,580.0,227.0
0.001,17,2,180,1,65,0.0,37.0,37.0,1,115,0.0,87.0,87.0
0.009,6,10,1990,5,911,2.0,643.0,643.0,5,1079,2.0,811.0,811.0
300.282,6,27,7433,16,1409,20018.0,217.0,142.0,11,6024,24024.0,1679.0,777.0
0.02,6,10,1972,5,910,5.0,642.0,642.0,5,1062,4.0,794.0,794.0
15.217,17,18,8738,9,6455,1898.0,1350.0,689.0,9,2283,1898.0,1350.0,225.0
0.004,17,2,136,1,60,0.0,32.0,32.0,1,76,0.0,48.0,48.0
0.005,6,10,2000,5,927,1.0,659.0,659.0,5,1073,1.0,805.0,805.0
0.006,6,10,1547,5,764,1.0,496.0,496.0,5,783,1.0,515.0,515.0
0.005,17,2,144,1,64,0.0,36.0,36.0,1,80,0.0,52.0,52.0
0.037,17,4,284,2,120,0.0,32.0,32.0,2,164,33.0,60.0,54.0
0.011,6,10,1989,5,910,2.0,642.0,642.0,5,1079,2.0,811.0,811.0
0.01,6,10,1989,5,910,2.0,642.0,642.0,5,1079,2.0,811.0,811.0
63.785,6,35,8321,17,1849,539.0,781.0,379.0,18,6472,3744.0,2720.0,478.0
40.063,17,10,676,5,460,10012.0,104.0,64.0,5,216,10014.0,20.0,15.0
0.015,6,10,1983,5,910,3.0,642.0,642.0,5,1073,3.0,805.0,805.0
0.005,17,2,166,1,75,0.0,47.0,47.0,1,91,0.0,63.0,63.0
0.203,6,193,209488,97,6692,2.0,517.0,327.0,96,202796,1.0,4206.0,2197.0
0.14,6,10,1506,5,395,32.0,127.0,127.0,5,1111,32.0,843.0,843.0
0.006,6,10,1547,5,764,1.0,496.0,496.0,5,783,1.0,515.0,515.0
0.014,6,10,1989,5,910,3.0,642.0,642.0,5,1079,3.0,811.0,811.0
0.019,6,13,3913,7,495,3.0,123.0,123.0,6,3418,3.0,1650.0,1549.0
0.003,17,4,284,2,120,0.0,32.0,32.0,2,164,0.0,60.0,54.0
0.011,6,10,1989,5,910,2.0,642.0,642.0,5,1079,2.0,811.0,811.0
40.061,17,10,676,5,460,10013.0,104.0,64.0,5,216,10014.0,20.0,15.0
0.005,17,2,136,1,60,0.0,32.0,32.0,1,76,0.0,48.0,48.0
0.072,6,10,1506,5,395,14.0,127.0,127.0,5,1111,16.0,843.0,843.0
0.01,6,10,1762,5,911,2.0,643.0,643.0,5,851,2.0,583.0,583.0
0.016,6,10,1990,5,911,4.0,643.0,643.0,5,1079,4.0,811.0,811.0
0.111,6,10,1506,5,395,21.0,127.0,127.0,5,1111,26.0,843.0,843.0
0.04,17,2,166,1,75,0.0,47.0,47.0,1,91,0.0,63.0,63.0
40.081,17,10,676,5,460,10019.0,104.0,64.0,5,216,10018.0,20.0,15.0
0.112,6,10,1506,5,395,23.0,127.0,127.0,5,1111,23.0,843.0,843.0
0.004,17,2,150,1,67,0.0,39.0,39.0,1,83,0.0,55.0,55.0
0.011,6,10,1990,5,911,2.0,643.0,643.0,5,1079,2.0,811.0,811.0
318.559,17,20,1124,10,716,35381.0,48.0,43.0,10,408,35381.0,20.0,12.0
0.004,6,10,2006,5,927,1.0,659.0,659.0,5,1079,1.0,811.0,811.0
0.005,17,2,164,1,74,0.0,46.0,46.0,1,90,0.0,62.0,62.0
0.005,17,2,169,1,62,0.0,34.0,34.0,1,107,0.0,79.0,79.0
0.005,6,10,2007,5,928,1.0,660.0,660.0,5,1079,1.0,811.0,811.0
0.011,6,10,1972,5,910,2.0,642.0,642.0,5,1062,2.0,794.0,794.0
40.055,17,10,676,5,460,10012.0,104.0,64.0,5,216,10012.0,20.0,15.0
308.39,17,20,1124,10,716,34252.0,48.0,43.0,10,408,34251.0,20.0,12.0
0.001,17,2,136,1,60,0.0,32.0,32.0,1,76,0.0,48.0,48.0
0.005,6,10,2007,5,928,1.0,660.0,660.0,5,1079,1.0,811.0,811.0
10.766,17,28,4424,14,1995,819.0,270.0,114.0,14,2429,819.0,588.0,145.0
0.005,6,10,2000,5,927,1.0,659.0,659.0,5,1073,1.0,805.0,805.0
1787.38,6,154,19574,92,13852,19641.0,302.0,302.0,62,5722,29301.0,83.0,83.0
0.099,6,10,1506,5,395,23.0,127.0,127.0,5,1111,20.0,843.0,843.0
0.082,6,10,1506,5,395,18.0,127.0,127.0,5,1111,18.0,843.0,843.0
0.012,6,10,1762,5,911,3.0,643.0,643.0,5,851,3.0,583.0,583.0
0.005,17,2,180,1,66,0.0,38.0,38.0,1,114,0.0,86.0,86.0
0.068,17,8,3613,4,1874,22.0,1350.0,440.0,4,1739,11.0,1350.0,406.0
0.005,6,10,1689,5,839,1.0,571.0,571.0,5,850,1.0,582.0,582.0
0.001,17,2,180,1,66,0.0,38.0,38.0,1,114,0.0,86.0,86.0
0.089,6,10,1506,5,395,20.0,127.0,127.0,5,1111,19.0,843.0,843.0
0.011,6,10,1989,5,910,2.0,642.0,642.0,5,1079,2.0,811.0,811.0
0.021,6,10,1989,5,910,5.0,642.0,642.0,5,1079,5.0,811.0,811.0
0.005,6,10,1989,5,927,1.0,659.0,659.0,5,1062,1.0,794.0,794.0
15.986,6,36,8431,19,2000,888.0,892.0,402.0,17,6431,539.0,2720.0,478.0
0.006,17,2,140,1,62,0.0,34.0,34.0,1,78,0.0,50.0,50.0
0.009,6,10,1989,5,910,2.0,642.0,642.0,5,1079,2.0,811.0,811.0
240.013,6,9,787,5,488,60003.0,232.0,232.0,4,299,80003.0,83.0,83.0
0.005,6,10,1689,5,839,1.0,571.0,571.0,5,850,1.0,582.0,582.0
0.119,6,10,1506,5,395,26.0,127.0,127.0,5,1111,25.0,843.0,843.0
0.006,17,2,230,1,68,0.0,40.0,40.0,1,162,0.0,134.0,134.0
0.01,6,10,1989,5,927,2.0,659.0,659.0,5,1062,2.0,794.0,794.0
0.008,6,10,1972,5,910,2.0,642.0,642.0,5,1062,1.0,794.0,794.0
0.006,6,10,1989,5,927,1.0,659.0,659.0,5,1062,1.0,794.0,794.0
0.219,6,16,2782,8,1400,31.0,533.0,325.0,8,1382,20.0,529.0,239.0
0.017,6,10,1972,5,910,4.0,642.0,642.0,5,1062,4.0,794.0,794.0
0.151,6,10,1506,5,395,34.0,127.0,127.0,5,1111,36.0,843.0,843.0
0.194,6,10,1506,5,395,45.0,127.0,127.0,5,1111,39.0,843.0,843.0
0.009,6,10,1989,5,927,2.0,659.0,659.0,5,1062,2.0,794.0,794.0
0.007,17,2,194,1,59,0.0,31.0,31.0,1,135,0.0,107.0,107.0
0.009,6,10,1983,5,910,2.0,642.0,642.0,5,1073,2.0,805.0,805.0
0.001,17,2,136,1,60,0.0,32.0,32.0,1,76,0.0,48.0,48.0
308.633,17,20,1124,10,716,34278.0,48.0,43.0,10,408,34278.0,20.0,12.0
0.106,6,10,1506,5,395,17.0,127.0,127.0,5,1111,23.0,843.0,843.0
241.429,6,386,348317,187,21247,1298.0,2736.0,959.0,199,327070,1219.0,3053.0,1675.0
0.006,6,10,1547,5,764,1.0,496.0,496.0,5,783,1.0,515.0,515.0
379.682,6,26,3272,18,971,22334.0,195.0,195.0,8,2301,3359.0,775.0,492.0
0.01,6,10,1689,5,839,2.0,571.0,571.0,5,850,2.0,582.0,582.0
0.016,6,10,1989,5,910,4.0,642.0,642.0,5,1079,3.0,811.0,811.0
293.919,6,326,344019,121,17837,2449.0,2736.0,824.0,205,326182,1440.0,2804.0,1651.0
0.079,6,10,1506,5,395,18.0,127.0,127.0,5,1111,16.0,843.0,843.0
40.056,17,10,676,5,460,10011.0,104.0,64.0,5,216,10013.0,20.0,15.0
0.005,6,14,3799,7,509,0.0,137.0,137.0,7,3290,0.0,1448.0,972.0
0.005,6,10,2007,5,928,1.0,660.0,660.0,5,1079,1.0,811.0,811.0
1787.51,6,154,19574,92,13852,19642.0,302.0,302.0,62,5722,29303.0,83.0,83.0
0.004,6,10,2007,5,928,1.0,660.0,660.0,5,1079,1.0,811.0,811.0
0.007,6,10,1547,5,764,1.0,496.0,496.0,5,783,1.0,515.0,515.0
0.005,6,10,2006,5,927,1.0,659.0,659.0,5,1079,1.0,811.0,811.0
308.532,17,20,1124,10,716,34267.0,48.0,43.0,10,408,34267.0,20.0,12.0
40.064,17,10,676,5,460,10015.0,104.0,64.0,5,216,10015.0,20.0,15.0
0.008,6,13,3735,7,497,1.0,125.0,125.0,6,3238,1.0,1470.0,1459.0
0.015,6,10,1762,5,911,3.0,643.0,643.0,5,851,3.0,583.0,583.0
0.077,6,10,1506,5,395,18.0,127.0,127.0,5,1111,16.0,843.0,843.0
0.015,6,10,1989,5,910,3.0,642.0,642.0,5,1079,3.0,811.0,811.0
0.005,6,10,1989,5,927,1.0,659.0,659.0,5,1062,1.0,794.0,794.0
240.095,6,16,4481,9,963,30011.0,238.0,166.0,7,3518,40015.0,1402.0,786.0
0.004,6,10,1989,5,927,1.0,659.0,659.0,5,1062,1.0,794.0,794.0
0.006,6,10,1547,5,764,1.0,496.0,496.0,5,783,1.0,515.0,515.0
0.01,6,10,1972,5,910,2.0,642.0,642.0,5,1062,2.0,794.0,794.0
0.088,6,10,1506,5,395,21.0,127.0,127.0,5,1111,19.0,843.0,843.0
0.092,6,10,1506,5,395,15.0,127.0,127.0,5,1111,21.0,843.0,843.0
0.004,6,10,1774,5,923,1.0,655.0,655.0,5,851,1.0,583.0,583.0
0.058,6,10,1506,5,395,13.0,127.0,127.0,5,1111,12.0,843.0,843.0
0.014,6,10,1990,5,911,3.0,643.0,643.0,5,1079,3.0,811.0,811.0
0.005,6,10,2006,5,927,1.0,659.0,659.0,5,1079,1.0,811.0,811.0
0.005,6,10,2006,5,927,1.0,659.0,659.0,5,1079,1.0,811.0,811.0
46.615,6,28,9605,14,1707,3585.0,794.0,367.0,14,7898,3575.0,1360.0,732.0
0.072,17,2,136,1,60,0.0,32.0,32.0,1,76,0.0,48.0,48.0
353.276,6,20,2210,6,1308,12004.0,494.0,494.0,14,902,27174.0,83.0,83.0
0.003,17,2,136,1,60,0.0,32.0,32.0,1,76,0.0,48.0,48.0
0.127,6,10,1506,5,395,30.0,127.0,127.0,5,1111,30.0,843.0,843.0
0.1,6,10,1506,5,395,22.0,127.0,127.0,5,1111,23.0,843.0,843.0
0.009,6,13,3735,7,497,1.0,125.0,125.0,6,3238,1.0,1470.0,1459.0
0.038,17,2,148,1,60,0.0,32.0,32.0,1,88,0.0,60.0,60.0
0.005,6,10,1774,5,923,1.0,655.0,655.0,5,851,1.0,583.0,583.0
0.015,6,10,1762,5,911,3.0,643.0,643.0,5,851,3.0,583.0,583.0
0.006,17,2,230,1,68,0.0,40.0,40.0,1,162,0.0,134.0,134.0
0.004,6,10,2006,5,927,1.0,659.0,659.0,5,1079,1.0,811.0,811.0
0.006,6,10,1547,5,764,1.0,496.0,496.0,5,783,1.0,515.0,515.0
0.004,6,10,2006,5,927,1.0,659.0,659.0,5,1079,1.0,811.0,811.0
159.486,17,94,13629,47,3162,3466.0,44.0,39.0,47,10467,3466.0,261.0,194.0
0.084,6,10,1506,5,395,17.0,127.0,127.0,5,1111,20.0,843.0,843.0
165.15,17,68,9699,34,2271,5004.0,44.0,38.0,34,7428,5004.0,260.0,190.0
0.005,6,10,2006,5,927,1.0,659.0,659.0,5,1079,1.0,811.0,811.0
0.001,17,2,166,1,75,0.0,47.0,47.0,1,91,0.0,63.0,63.0
0.008,6,13,3735,7,497,1.0,125.0,125.0,6,3238,1.0,1470.0,1459.0
0.009,6,10,1990,5,911,2.0,643.0,643.0,5,1079,2.0,811.0,811.0
0.006,17,2,214,1,75,0.0,47.0,47.0,1,139,0.0,111.0,111.0
0.011,6,10,1989,5,910,2.0,642.0,642.0,5,1079,2.0,811.0,811.0
0.005,6,10,2007,5,928,1.0,660.0,660.0,5,1079,1.0,811.0,811.0
0.011,6,13,3860,7,622,1.0,250.0,250.0,6,3238,2.0,1470.0,1459.0
0.127,6,10,1506,5,395,29.0,127.0,127.0,5,1111,26.0,843.0,843.0
0.008,6,10,2000,5,927,2.0,659.0,659.0,5,1073,1.0,805.0,805.0
0.066,17,8,3613,4,1874,22.0,1350.0,440.0,4,1739,10.0,1350.0,406.0
0.005,17,2,136,1,60,0.0,32.0,32.0,1,76,0.0,48.0,48.0
0.04,17,4,284,2,120,0.0,32.0,32.0,2,164,36.0,60.0,54.0
0.005,6,10,1643,5,860,1.0,592.0,592.0,5,783,1.0,515.0,515.0
0.008,6,10,1972,5,910,2.0,642.0,642.0,5,1062,1.0,794.0,794.0
161.436,17,80,11740,40,2694,4139.0,44.0,39.0,40,9046,4139.0,239.0,198.0
0.004,6,10,1779,5,928,1.0,660.0,660.0,5,851,1.0,583.0,583.0
0.088,6,10,1506,5,395,19.0,127.0,127.0,5,1111,16.0,843.0,843.0
0.014,6,10,1989,5,910,3.0,642.0,642.0,5,1079,3.0,811.0,811.0
0.084,6,10,1506,5,395,19.0,127.0,127.0,5,1111,18.0,843.0,843.0
0.115,6,10,1506,5,395,25.0,127.0,127.0,5,1111,28.0,843.0,843.0
240.074,6,20,4872,10,889,26674.0,180.0,93.0,10,3983,26674.0,1591.0,575.0
0.013,6,10,1989,5,910,3.0,642.0,642.0,5,1079,3.0,811.0,811.0
0.012,6,10,1983,5,910,2.0,642.0,642.0,5,1073,2.0,805.0,805.0
0.06,6,10,1506,5,395,13.0,127.0,127.0,5,1111,14.0,843.0,843.0
40.092,17,10,676,5,460,10020.0,104.0,64.0,5,216,10022.0,20.0,15.0
0.011,6,10,1972,5,910,2.0,642.0,642.0,5,1062,2.0,794.0,794.0
0.005,6,13,3747,7,509,0.0,137.0,137.0,6,3238,1.0,1470.0,1459.0
0.004,6,10,1779,5,928,1.0,660.0,660.0,5,851,1.0,583.0,583.0
0.005,6,10,1989,5,927,1.0,659.0,659.0,5,1062,1.0,794.0,794.0
0.005,6,10,2000,5,927,1.0,659.0,659.0,5,1073,1.0,805.0,805.0
0.015,6,10,1989,5,910,3.0,642.0,642.0,5,1079,3.0,811.0,811.0
0.023,6,13,3735,7,497,3.0,125.0,125.0,6,3238,4.0,1470.0,1459.0
0.0,17,2,166,1,75,0.0,47.0,47.0,1,91,0.0,63.0,63.0
0.005,6,10,1854,5,889,1.0,621.0,621.0,5,965,1.0,697.0,697.0
0.003,6,10,1702,5,863,0.0,595.0,595.0,5,839,0.0,571.0,571.0
0.005,17,2,169,1,62,0.0,34.0,34.0,1,107,0.0,79.0,79.0
177.13,17,94,13511,47,3164,3850.0,44.0,39.0,47,10347,3850.0,239.0,192.0
1770.458,6,83,4368,42,2210,43180.0,26.0,26.0,41,2158,44260.0,26.0,26.0
0.004,6,10,2000,5,927,1.0,659.0,659.0,5,1073,1.0,805.0,805.0
0.004,17,2,179,1,71,0.0,43.0,43.0,1,108,0.0,80.0,80.0
123.832,6,21,8146,11,1985,83.0,1174.0,504.0,10,6161,13739.0,2720.0,958.0
0.006,17,2,180,1,66,0.0,38.0,38.0,1,114,0.0,86.0,86.0
40.078,17,10,676,5,460,10018.0,104.0,64.0,5,216,10018.0,20.0,15.0
0.015,6,10,1990,5,911,3.0,643.0,643.0,5,1079,3.0,811.0,811.0
0.005,6,10,1689,5,839,1.0,571.0,571.0,5,850,1.0,582.0,582.0
0.004,17,2,136,1,60,0.0,32.0,32.0,1,76,0.0,48.0,48.0
0.004,6,10,1702,5,863,1.0,595.0,595.0,5,839,0.0,571.0,571.0
40.071,17,10,676,5,460,10016.0,104.0,64.0,5,216,10017.0,20.0,15.0
0.038,17,2,152,1,76,0.0,48.0,48.0,1,76,0.0,48.0,48.0
240.388,6,44,8823,23,5790,10926.0,1515.0,509.0,21,3033,12019.0,580.0,241.0
0.014,6,10,1631,5,848,3.0,580.0,580.0,5,783,3.0,515.0,515.0
0.006,6,10,1689,5,839,1.0,571.0,571.0,5,850,1.0,582.0,582.0
300.352,6,16,2170,9,684,37523.0,146.0,146.0,7,1486,50031.0,419.0,398.0
0.001,17,2,180,1,65,0.0,37.0,37.0,1,115,0.0,87.0,87.0
0.005,6,10,1547,5,764,1.0,496.0,496.0,5,783,1.0,515.0,515.0
0.011,6,10,1762,5,911,2.0,643.0,643.0,5,851,2.0,583.0,583.0
0.11,6,10,1506,5,395,25.0,127.0,127.0,5,1111,26.0,843.0,843.0
0.157,6,10,1506,5,395,37.0,127.0,127.0,5,1111,33.0,843.0,843.0
10.828,17,28,4421,14,1994,824.0,269.0,114.0,14,2427,824.0,586.0,145.0
125.939,6,14,2938,8,2504,17958.0,1414.0,1086.0,6,434,25142.0,182.0,182.0
40.08,17,10,676,5,460,10018.0,104.0,64.0,5,216,10019.0,20.0,15.0
0.004,6,10,1774,5,923,1.0,655.0,655.0,5,851,1.0,583.0,583.0
0.004,6,10,2006,5,927,1.0,659.0,659.0,5,1079,1.0,811.0,811.0
0.007,6,10,1989,5,910,1.0,642.0,642.0,5,1079,1.0,811.0,811.0
300.18,6,23,7473,13,2693,25014.0,1368.0,401.0,10,4780,33353.0,1656.0,1066.0
0.014,6,10,1983,5,910,3.0,642.0,642.0,5,1073,3.0,805.0,805.0
0.007,6,10,2006,5,927,1.0,659.0,659.0,5,1079,1.0,811.0,811.0
0.001,17,2,180,1,66,0.0,38.0,38.0,1,114,0.0,86.0,86.0
0.004,17,2,148,1,60,0.0,32.0,32.0,1,88,0.0,60.0,60.0
0.006,6,10,1547,5,764,1.0,496.0,496.0,5,783,1.0,515.0,515.0
0.018,6,10,1989,5,910,4.0,642.0,642.0,5,1079,4.0,811.0,811.0
0.003,17,2,136,1,60,0.0,32.0,32.0,1,76,0.0,48.0,48.0
0.08,6,10,1506,5,395,17.0,127.0,127.0,5,1111,17.0,843.0,843.0
0.006,6,10,1547,5,764,1.0,496.0,496.0,5,783,1.0,515.0,515.0
40.062,17,10,676,5,460,10013.0,104.0,64.0,5,216,10014.0,20.0,15.0
0.088,6,10,1506,5,395,20.0,127.0,127.0,5,1111,20.0,843.0,843.0
0.006,6,10,1547,5,764,1.0,496.0,496.0,5,783,1.0,515.0,515.0
40.055,17,10,676,5,460,10012.0,104.0,64.0,5,216,10012.0,20.0,15.0
0.004,17,4,284,2,120,0.0,32.0,32.0,2,164,1.0,60.0,54.0
240.086,6,16,4481,9,963,30010.0,238.0,166.0,7,3518,40013.0,1402.0,786.0
0.005,6,10,2006,5,927,1.0,659.0,659.0,5,1079,1.0,811.0,811.0
0.113,6,10,1506,5,395,20.0,127.0,127.0,5,1111,27.0,843.0,843.0
0.077,17,4,284,2,120,6.0,32.0,32.0,2,164,73.0,60.0,54.0
0.21,6,10,1242,5,751,52.0,495.0,495.0,5,491,50.0,223.0,223.0
0.003,17,4,284,2,120,0.0,32.0,32.0,2,164,0.0,60.0,54.0
0.009,6,10,1990,5,911,2.0,643.0,643.0,5,1079,2.0,811.0,811.0
0.006,17,2,170,1,65,0.0,37.0,37.0,1,105,0.0,77.0,77.0
0.005,6,10,2006,5,927,1.0,659.0,659.0,5,1079,1.0,811.0,811.0
0.005,6,10,1779,5,928,1.0,660.0,660.0,5,851,1.0,583.0,583.0
0.001,17,2,136,1,60,0.0,32.0,32.0,1,76,0.0,48.0,48.0
0.006,6,10,2000,5,927,1.0,659.0,659.0,5,1073,1.0,805.0,805.0
0.004,17,2,148,1,60,0.0,32.0,32.0,1,88,0.0,60.0,60.0
0.004,17,2,132,1,58,0.0,30.0,30.0,1,74,0.0,46.0,46.0
0.004,17,4,284,2,120,0.0,32.0,32.0,2,164,0.0,60.0,54.0
0.005,6,10,2006,5,927,1.0,659.0,659.0,5,1079,1.0,811.0,811.0
0.036,17,2,186,1,61,0.0,33.0,33.0,1,125,0.0,97.0,97.0
15.072,17,15,9239,8,6902,2149.0,1350.0,834.0,7,2337,2506.0,1350.0,305.0
0.003,6,10,1702,5,863,0.0,595.0,595.0,5,839,0.0,571.0,571.0
0.001,17,2,179,1,62,0.0,34.0,34.0,1,117,0.0,89.0,89.0
0.127,6,10,1506,5,395,31.0,127.0,127.0,5,1111,29.0,843.0,843.0
0.004,6,10,1702,5,863,1.0,595.0,595.0,5,839,0.0,571.0,571.0
0.018,6,10,1989,5,910,4.0,642.0,642.0,5,1079,4.0,811.0,811.0
0.011,6,10,1990,5,911,2.0,643.0,643.0,5,1079,2.0,811.0,811.0
0.013,6,10,1989,5,910,3.0,642.0,642.0,5,1079,3.0,811.0,811.0
0.057,6,10,1506,5,395,13.0,127.0,127.0,5,1111,12.0,843.0,843.0
0.13,17,4,596,2,122,0.0,33.0,33.0,2,474,90.0,323.0,209.0
0.015,6,10,1762,5,911,3.0,643.0,643.0,5,851,3.0,583.0,583.0
0.011,6,10,1989,5,910,2.0,642.0,642.0,5,1079,2.0,811.0,811.0
0.093,6,10,1506,5,395,20.0,127.0,127.0,5,1111,21.0,843.0,843.0
0.006,17,2,214,1,75,0.0,47.0,47.0,1,139,0.0,111.0,111.0
0.023,6,10,1990,5,911,5.0,643.0,643.0,5,1079,5.0,811.0,811.0
0.003,17,2,136,1,60,0.0,32.0,32.0,1,76,0.0,48.0,48.0
312.497,17,20,1124,10,716,34707.0,48.0,43.0,10,408,34705.0,20.0,12.0
0.009,6,10,1779,5,928,2.0,660.0,660.0,5,851,2.0,583.0,583.0
0.005,6,10,2006,5,927,1.0,659.0,659.0,5,1079,1.0,811.0,811.0
0.001,17,2,136,1,60,0.0,32.0,32.0,1,76,0.0,48.0,48.0
0.004,17,2,148,1,60,0.0,32.0,32.0,1,88,0.0,60.0,60.0
0.016,6,10,1989,5,910,4.0,642.0,642.0,5,1079,4.0,811.0,811.0
0.078,6,10,1506,5,395,16.0,127.0,127.0,5,1111,18.0,843.0,843.0
1770.725,6,85,4522,43,2288,42159.0,26.0,26.0,42,2234,43187.0,26.0,25.0
0.021,6,10,1983,5,910,5.0,642.0,642.0,5,1073,5.0,805.0,805.0
0.008,6,10,1972,5,910,2.0,642.0,642.0,5,1062,2.0,794.0,794.0
0.005,6,10,2000,5,927,1.0,659.0,659.0,5,1073,1.0,805.0,805.0
0.069,6,10,1506,5,395,14.0,127.0,127.0,5,1111,16.0,843.0,843.0
0.017,6,10,1983,5,910,4.0,642.0,642.0,5,1073,4.0,805.0,805.0
0.004,6,10,1702,5,863,0.0,595.0,595.0,5,839,1.0,571.0,571.0
40.055,17,10,676,5,460,10013.0,104.0,64.0,5,216,10012.0,20.0,15.0
0.005,6,10,2006,5,927,1.0,659.0,659.0,5,1079,1.0,811.0,811.0
371.611,6,22,2313,16,867,24774.0,195.0,195.0,6,1446,4637.0,419.0,398.0
0.003,17,2,136,1,60,0.0,32.0,32.0,1,76,0.0,48.0,48.0
0.005,6,15,3794,8,504,0.0,80.0,80.0,7,3290,0.0,1448.0,972.0
0.014,6,10,1677,5,827,3.0,559.0,559.0,5,850,3.0,582.0,582.0
0.011,6,10,1990,5,911,2.0,643.0,643.0,5,1079,2.0,811.0,811.0
0.013,6,10,1631,5,848,3.0,580.0,580.0,5,783,3.0,515.0,515.0
0.005,6,10,1689,5,839,1.0,571.0,571.0,5,850,1.0,582.0,582.0
0.004,6,10,1702,5,863,1.0,595.0,595.0,5,839,0.0,571.0,571.0
0.006,6,10,1547,5,764,1.0,496.0,496.0,5,783,1.0,515.0,515.0
0.006,17,2,214,1,75,0.0,47.0,47.0,1,139,0.0,111.0,111.0
0.017,6,10,1989,5,910,4.0,642.0,642.0,5,1079,4.0,811.0,811.0
0.008,6,10,1989,5,910,2.0,642.0,642.0,5,1079,1.0,811.0,811.0
263.846,6,18,4584,9,963,32980.0,238.0,166.0,9,3621,32980.0,1402.0,786.0
0.004,6,10,1989,5,927,1.0,659.0,659.0,5,1062,1.0,794.0,794.0
0.001,17,2,166,1,75,0.0,47.0,47.0,1,91,0.0,63.0,63.0
0.187,17,4,580,2,122,142.0,33.0,33.0,2,458,148.0,307.0,201.0
0.004,6,10,2006,5,927,1.0,659.0,659.0,5,1079,1.0,811.0,811.0
9.038,17,6,376,5,280,2259.0,28.0,28.0,1,96,0.0,68.0,68.0
0.008,17,2,194,1,59,0.0,31.0,31.0,1,135,0.0,107.0,107.0
0.006,6,10,1547,5,764,1.0,496.0,496.0,5,783,1.0,515.0,515.0
0.005,17,2,179,1,71,0.0,43.0,43.0,1,108,0.0,80.0,80.0
0.147,6,10,1506,5,395,33.0,127.0,127.0,5,1111,34.0,843.0,843.0
0.041,17,2,136,1,60,0.0,32.0,32.0,1,76,0.0,48.0,48.0
1.046,6,32,13393,18,5893,61.0,2720.0,854.0,14,7500,67.0,2720.0,769.0
0.039,17,2,148,1,60,0.0,32.0,32.0,1,88,0.0,60.0,60.0
0.015,6,10,1983,5,910,3.0,642.0,642.0,5,1073,3.0,805.0,805.0
0.004,6,10,2007,5,928,1.0,660.0,660.0,5,1079,1.0,811.0,811.0
0.01,6,10,1989,5,910,2.0,642.0,642.0,5,1079,2.0,811.0,811.0
0.006,6,10,1689,5,839,1.0,571.0,571.0,5,850,1.0,582.0,582.0
0.005,6,10,2000,5,927,1.0,659.0,659.0,5,1073,1.0,805.0,805.0
0.013,6,10,1989,5,910,3.0,642.0,642.0,5,1079,3.0,811.0,811.0
0.012,6,10,1972,5,910,3.0,642.0,642.0,5,1062,3.0,794.0,794.0
0.013,6,10,1989,5,910,3.0,642.0,642.0,5,1079,3.0,811.0,811.0
0.006,6,10,2006,5,927,1.0,659.0,659.0,5,1079,1.0,811.0,811.0
0.001,17,2,166,1,75,0.0,47.0,47.0,1,91,0.0,63.0,63.0
0.001,17,2,180,1,66,0.0,38.0,38.0,1,114,0.0,86.0,86.0
0.009,6,10,1972,5,910,2.0,642.0,642.0,5,1062,2.0,794.0,794.0
0.078,6,10,1506,5,395,17.0,127.0,127.0,5,1111,17.0,843.0,843.0
0.005,17,2,202,1,69,0.0,41.0,41.0,1,133,0.0,105.0,105.0
0.004,6,10,1989,5,927,1.0,659.0,659.0,5,1062,1.0,794.0,794.0
0.003,17,2,152,1,76,0.0,48.0,48.0,1,76,0.0,48.0,48.0
0.078,6,10,1506,5,395,17.0,127.0,127.0,5,1111,17.0,843.0,843.0
0.01,6,10,1677,5,827,2.0,559.0,559.0,5,850,2.0,582.0,582.0
0.005,17,2,140,1,62,0.0,34.0,34.0,1,78,0.0,50.0,50.0
40.092,17,10,676,5,460,10022.0,104.0,64.0,5,216,10022.0,20.0,15.0
0.287,6,11,2944,6,497,57.0,177.0,177.0,5,2447,45.0,1402.0,1089.0
0.084,6,10,1506,5,395,20.0,127.0,127.0,5,1111,19.0,843.0,843.0
0.005,6,10,1547,5,764,1.0,496.0,496.0,5,783,1.0,515.0,515.0
0.07,17,8,3613,4,1874,23.0,1350.0,440.0,4,1739,12.0,1350.0,406.0
0.004,6,10,1989,5,927,1.0,659.0,659.0,5,1062,1.0,794.0,794.0
0.004,6,10,1774,5,923,1.0,655.0,655.0,5,851,1.0,583.0,583.0
0.066,17,8,3613,4,1874,22.0,1350.0,440.0,4,1739,11.0,1350.0,406.0
0.008,6,10,1989,5,910,2.0,642.0,642.0,5,1079,2.0,811.0,811.0
0.024,6,7,695,4,448,8.0,232.0,232.0,3,247,10.0,83.0,83.0
10.785,17,26,4102,13,1846,889.0,269.0,114.0,13,2256,889.0,587.0,145.0
0.015,6,10,1972,5,910,3.0,642.0,642.0,5,1062,3.0,794.0,794.0
0.005,6,10,1643,5,860,1.0,592.0,592.0,5,783,1.0,515.0,515.0
0.129,17,2,80,1,32,0.0,4.0,4.0,1,48,0.0,20.0,20.0
0.042,17,2,136,1,60,0.0,32.0,32.0,1,76,0.0,48.0,48.0
300.376,6,16,2170,9,684,37525.0,146.0,146.0,7,1486,50034.0,419.0,398.0
0.003,17,2,148,1,60,0.0,32.0,32.0,1,88,0.0,60.0,60.0
0.103,6,10,1506,5,395,21.0,127.0,127.0,5,1111,20.0,843.0,843.0
0.164,6,10,1506,5,395,38.0,127.0,127.0,5,1111,28.0,843.0,843.0
0.01,6,10,1631,5,848,2.0,580.0,580.0,5,783,2.0,515.0,515.0
0.003,17,2,136,1,60,0.0,32.0,32.0,1,76,0.0,48.0,48.0
0.066,6,10,1506,5,395,14.0,127.0,127.0,5,1111,14.0,843.0,843.0
11.109,17,28,4418,14,1993,842.0,268.0,114.0,14,2425,842.0,588.0,145.0
0.016,6,13,3735,7,497,2.0,125.0,125.0,6,3238,3.0,1470.0,1459.0
0.113,6,10,1506,5,395,24.0,127.0,127.0,5,1111,24.0,843.0,843.0
0.077,6,10,1506,5,395,16.0,127.0,127.0,5,1111,15.0,843.0,843.0
0.006,17,2,228,1,82,0.0,54.0,54.0,1,146,0.0,118.0,118.0
161.052,17,92,13263,46,3096,3578.0,44.0,39.0,46,10167,3578.0,260.0,193.0
0.015,6,10,1990,5,911,3.0,643.0,643.0,5,1079,3.0,811.0,811.0
27.211,6,29,8947,15,6746,1943.0,1856.0,662.0,14,2201,8.0,580.0,209.0
0.101,6,10,1506,5,395,20.0,127.0,127.0,5,1111,24.0,843.0,843.0
0.005,6,10,2000,5,927,1.0,659.0,659.0,5,1073,1.0,805.0,805.0
0.008,6,10,1989,5,910,2.0,642.0,642.0,5,1079,2.0,811.0,811.0
0.009,6,10,1779,5,928,2.0,660.0,660.0,5,851,2.0,583.0,583.0
0.102,6,10,1506,5,395,23.0,127.0,127.0,5,1111,23.0,843.0,843.0
40.075,17,10,676,5,460,10016.0,104.0,64.0,5,216,10018.0,20.0,15.0
0.002,17,2,180,1,66,0.0,38.0,38.0,1,114,0.0,86.0,86.0
0.188,6,44,11612,24,3283,8.0,1083.0,203.0,20,8329,9.0,1402.0,606.0
0.003,17,2,148,1,60,0.0,32.0,32.0,1,88,0.0,60.0,60.0
0.181,17,2,152,1,76,0.0,48.0,48.0,1,76,0.0,48.0,48.0
0.004,17,2,146,1,65,0.0,37.0,37.0,1,81,0.0,53.0,53.0
0.02,6,10,1990,5,911,5.0,643.0,643.0,5,1079,5.0,811.0,811.0
0.005,6,10,1774,5,923,1.0,655.0,655.0,5,851,1.0,583.0,583.0
40.077,17,10,676,5,460,10016.0,104.0,64.0,5,216,10018.0,20.0,15.0
0.011,6,13,3735,7,497,1.0,125.0,125.0,6,3238,2.0,1470.0,1459.0
0.005,6,10,2007,5,928,1.0,660.0,660.0,5,1079,1.0,811.0,811.0
0.005,6,10,1689,5,839,1.0,571.0,571.0,5,850,1.0,582.0,582.0
0.123,6,10,1506,5,395,27.0,127.0,127.0,5,1111,29.0,843.0,843.0
0.003,17,4,284,2,120,0.0,32.0,32.0,2,164,0.0,60.0,54.0
0.006,6,10,1547,5,764,1.0,496.0,496.0,5,783,1.0,515.0,515.0
0.06,17,2,80,1,32,0.0,4.0,4.0,1,48,0.0,20.0,20.0
0.128,17,2,80,1,32,0.0,4.0,4.0,1,48,0.0,20.0,20.0
1730.452,6,45,2790,30,1725,59670.0,35.0,35.0,15,1065,123598.0,31.0,31.0
0.005,17,2,164,1,74,0.0,46.0,46.0,1,90,0.0,62.0,62.0
0.108,6,10,1506,5,395,23.0,127.0,127.0,5,1111,24.0,843.0,843.0
0.011,6,10,1972,5,910,2.0,642.0,642.0,5,1062,2.0,794.0,794.0
1799.127,17,3043,233244,1506,122039,1195.0,84.0,53.0,1537,111205,1171.0,227.0,44.0
0.001,17,2,180,1,66,0.0,38.0,38.0,1,114,0.0,86.0,86.0
0.012,6,14,3787,7,497,2.0,125.0,125.0,7,3290,2.0,1448.0,972.0
0.006,6,10,1689,5,839,1.0,571.0,571.0,5,850,1.0,582.0,582.0
0.698,6,23,5165,12,1343,57.0,325.0,122.0,11,3822,58.0,1414.0,563.0
173.046,17,78,11072,39,2593,4553.0,44.0,38.0,39,8479,4553.0,261.0,189.0
0.01,6,10,2006,5,927,2.0,659.0,659.0,5,1079,2.0,811.0,811.0
0.004,17,2,136,1,60,0.0,32.0,32.0,1,76,0.0,48.0,48.0
0.005,6,10,1989,5,927,1.0,659.0,659.0,5,1062,1.0,794.0,794.0
300.32,6,16,2170,9,684,37519.0,146.0,146.0,7,1486,50025.0,419.0,398.0
0.039,17,2,152,1,76,0.0,48.0,48.0,1,76,0.0,48.0,48.0
0.092,6,10,1506,5,395,21.0,127.0,127.0,5,1111,19.0,843.0,843.0
0.008,17,2,194,1,59,0.0,31.0,31.0,1,135,0.0,107.0,107.0
0.224,6,16,2777,8,1395,32.0,533.0,323.0,8,1382,20.0,529.0,239.0
0.016,6,10,1677,5,827,3.0,559.0,559.0,5,850,4.0,582.0,582.0
0.004,17,2,152,1,76,0.0,48.0,48.0,1,76,0.0,48.0,48.0
0.005,6,10,2007,5,928,1.0,660.0,660.0,5,1079,1.0,811.0,811.0
0.106,6,10,1506,5,395,24.0,127.0,127.0,5,1111,24.0,843.0,843.0
0.006,17,2,170,1,65,0.0,37.0,37.0,1,105,0.0,77.0,77.0
0.019,6,10,1990,5,911,4.0,643.0,643.0,5,1079,4.0,811.0,811.0
0.011,6,10,1989,5,910,2.0,642.0,642.0,5,1079,2.0,811.0,811.0
0.277,17,4,352,2,130,150.0,37.0,37.0,2,222,236.0,89.0,83.0
0.108,6,10,1506,5,395,24.0,127.0,127.0,5,1111,22.0,843.0,843.0
0.006,6,10,1689,5,839,1.0,571.0,571.0,5,850,1.0,582.0,582.0
0.008,6,10,1605,5,388,2.0,120.0,120.0,5,1217,1.0,949.0,949.0
0.042,17,2,152,1,76,0.0,48.0,48.0,1,76,0.0,48.0,48.0
0.102,6,10,1506,5,395,24.0,127.0,127.0,5,1111,23.0,843.0,843.0
168.231,17,80,11298,40,2669,4313.0,44.0,38.0,40,8629,4313.0,239.0,187.0
0.001,17,2,180,1,66,0.0,38.0,38.0,1,114,0.0,86.0,86.0
0.069,6,10,1506,5,395,16.0,127.0,127.0,5,1111,14.0,843.0,843.0
0.01,6,10,1989,5,910,2.0,642.0,642.0,5,1079,2.0,811.0,811.0
0.018,6,10,1983,5,910,4.0,642.0,642.0,5,1073,4.0,805.0,805.0
0.021,6,10,1762,5,911,5.0,643.0,643.0,5,851,5.0,583.0,583.0
0.072,17,4,284,2,120,0.0,32.0,32.0,2,164,68.0,60.0,54.0
0.004,6,10,1989,5,927,1.0,659.0,659.0,5,1062,1.0,794.0,794.0
0.004,17,2,154,1,69,0.0,41.0,41.0,1,85,0.0,57.0,57.0
176.382,17,78,11126,39,2597,4641.0,44.0,38.0,39,8529,4641.0,261.0,190.0
0.004,17,2,194,1,59,0.0,31.0,31.0,1,135,0.0,107.0,107.0
0.006,6,10,1643,5,860,1.0,592.0,592.0,5,783,1.0,515.0,515.0
1729.272,6,60,4400,40,2740,44340.0,33.0,33.0,20,1660,91005.0,31.0,31.0
0.02,6,10,1989,5,910,5.0,642.0,642.0,5,1079,4.0,811.0,811.0
40.06,17,10,676,5,460,10012.0,104.0,64.0,5,216,10014.0,20.0,15.0
0.076,6,10,1506,5,395,16.0,127.0,127.0,5,1111,18.0,843.0,843.0
0.005,17,2,214,1,75,0.0,47.0,47.0,1,139,0.0,111.0,111.0
0.012,6,13,3735,7,497,1.0,125.0,125.0,6,3238,2.0,1470.0,1459.0
0.006,17,2,230,1,68,0.0,40.0,40.0,1,162,0.0,134.0,134.0
0.038,17,2,170,1,65,0.0,37.0,37.0,1,105,0.0,77.0,77.0
11.173,17,28,4422,14,1994,846.0,269.0,114.0,14,2428,846.0,587.0,145.0
0.005,6,10,2007,5,928,1.0,660.0,660.0,5,1079,1.0,811.0,811.0
0.012,6,10,1972,5,910,2.0,642.0,642.0,5,1062,3.0,794.0,794.0
0.087,6,10,1506,5,395,20.0,127.0,127.0,5,1111,18.0,843.0,843.0
0.01,6,10,1972,5,910,2.0,642.0,642.0,5,1062,2.0,794.0,794.0
0.003,17,2,136,1,60,0.0,32.0,32.0,1,76,0.0,48.0,48.0
0.084,6,10,1506,5,395,18.0,127.0,127.0,5,1111,17.0,843.0,843.0
0.005,6,13,3690,7,452,0.0,80.0,80.0,6,3238,1.0,1470.0,1459.0
0.015,6,10,1990,5,911,3.0,643.0,643.0,5,1079,3.0,811.0,811.0
0.028,6,14,3787,7,497,4.0,125.0,125.0,7,3290,4.0,1448.0,972.0
0.006,6,10,1989,5,927,1.0,659.0,659.0,5,1062,1.0,794.0,794.0
240.136,6,32,9425,16,7013,16009.0,2086.0,687.0,16,2412,16008.0,580.0,196.0
0.012,6,10,1631,5,848,2.0,580.0,580.0,5,783,3.0,515.0,515.0
0.006,6,10,1547,5,764,1.0,496.0,496.0,5,783,1.0,515.0,515.0
0.005,6,10,1779,5,928,1.0,660.0,660.0,5,851,1.0,583.0,583.0
0.083,6,10,1506,5,395,17.0,127.0,127.0,5,1111,19.0,843.0,843.0
0.101,6,10,1506,5,395,19.0,127.0,127.0,5,1111,23.0,843.0,843.0
0.005,17,2,146,1,65,0.0,37.0,37.0,1,81,0.0,53.0,53.0
0.01,6,10,1989,5,910,2.0,642.0,642.0,5,1079,2.0,811.0,811.0
0.005,6,10,1643,5,860,1.0,592.0,592.0,5,783,1.0,515.0,515.0
0.007,6,10,1702,5,863,1.0,595.0,595.0,5,839,1.0,571.0,571.0
40.059,17,10,676,5,460,10014.0,104.0,64.0,5,216,10013.0,20.0,15.0
0.169,17,2,80,1,32,0.0,4.0,4.0,1,48,0.0,20.0,20.0
0.075,6,10,1506,5,395,16.0,127.0,127.0,5,1111,16.0,843.0,843.0
0.153,6,10,1506,5,395,32.0,127.0,127.0,5,1111,37.0,843.0,843.0
0.005,6,10,2000,5,927,1.0,659.0,659.0,5,1073,1.0,805.0,805.0
0.151,6,10,1506,5,395,37.0,127.0,127.0,5,1111,35.0,843.0,843.0
0.02,6,12,1926,6,1189,4.0,659.0,434.0,6,737,4.0,417.0,417.0
0.032,6,10,1989,5,910,8.0,642.0,642.0,5,1079,7.0,811.0,811.0
0.005,17,2,170,1,65,0.0,37.0,37.0,1,105,0.0,77.0,77.0
0.125,6,10,1506,5,395,30.0,127.0,127.0,5,1111,28.0,843.0,843.0
10.748,17,26,4102,13,1847,886.0,270.0,114.0,13,2255,886.0,586.0,145.0
0.008,6,10,1762,5,911,2.0,643.0,643.0,5,851,2.0,583.0,583.0
10.821,17,28,4422,14,1995,824.0,270.0,114.0,14,2427,823.0,586.0,145.0
0.008,6,10,1989,5,910,2.0,642.0,642.0,5,1079,1.0,811.0,811.0
0.005,6,10,1779,5,928,1.0,660.0,660.0,5,851,1.0,583.0,583.0
0.074,6,10,1506,5,395,15.0,127.0,127.0,5,1111,16.0,843.0,843.0
0.04,17,4,284,2,120,0.0,32.0,32.0,2,164,37.0,60.0,54.0
0.004,6,10,1779,5,928,1.0,660.0,660.0,5,851,1.0,583.0,583.0
0.003,17,2,136,1,60,0.0,32.0,32.0,1,76,0.0,48.0,48.0
0.008,6,10,1631,5,848,2.0,580.0,580.0,5,783,2.0,515.0,515.0
0.086,6,10,1506,5,395,16.0,127.0,127.0,5,1111,18.0,843.0,843.0
0.005,6,10,2006,5,927,1.0,659.0,659.0,5,1079,1.0,811.0,811.0
0.001,17,2,180,1,66,0.0,38.0,38.0,1,114,0.0,86.0,86.0
0.086,6,10,1506,5,395,19.0,127.0,127.0,5,1111,19.0,843.0,843.0
0.084,6,10,1506,5,395,19.0,127.0,127.0,5,1111,13.0,843.0,843.0
0.005,6,14,3742,7,452,0.0,80.0,80.0,7,3290,0.0,1448.0,972.0
40.061,17,10,676,5,460,10014.0,104.0,64.0,5,216,10014.0,20.0,15.0
0.004,6,10,2007,5,928,1.0,660.0,660.0,5,1079,1.0,811.0,811.0
0.006,6,10,1547,5,764,1.0,496.0,496.0,5,783,1.0,515.0,515.0
0.084,6,10,1506,5,395,19.0,127.0,127.0,5,1111,19.0,843.0,843.0
0.04,17,2,148,1,60,0.0,32.0,32.0,1,88,0.0,60.0,60.0
0.009,6,14,3736,7,446,1.0,74.0,74.0,7,3290,1.0,1448.0,972.0
0.005,6,10,2006,5,927,1.0,659.0,659.0,5,1079,1.0,811.0,811.0
0.003,17,2,148,1,60,0.0,32.0,32.0,1,88,0.0,60.0,60.0
0.005,6,10,1989,5,927,1.0,659.0,659.0,5,1062,1.0,794.0,794.0
0.131,17,2,80,1,32,0.0,4.0,4.0,1,48,0.0,20.0,20.0
0.011,6,10,1983,5,910,2.0,642.0,642.0,5,1073,2.0,805.0,805.0
0.009,6,10,1972,5,910,2.0,642.0,642.0,5,1062,2.0,794.0,794.0
300.973,6,45,15824,24,9957,13085.0,2720.0,1120.0,21,5867,440.0,2667.0,385.0
0.014,6,10,1983,5,910,3.0,642.0,642.0,5,1073,3.0,805.0,805.0
0.005,6,10,1643,5,860,1.0,592.0,592.0,5,783,1.0,515.0,515.0
0.101,6,10,1506,5,395,20.0,127.0,127.0,5,1111,24.0,843.0,843.0
0.005,17,2,179,1,71,0.0,43.0,43.0,1,108,0.0,80.0,80.0
0.17,6,3,453,2,321,170.0,241.0,241.0,1,132,0.0,92.0,92.0
0.014,17,2,169,1,62,0.0,34.0,34.0,1,107,0.0,79.0,79.0
0.006,6,10,1779,5,928,1.0,660.0,660.0,5,851,1.0,583.0,583.0
0.005,6,10,2006,5,927,1.0,659.0,659.0,5,1079,1.0,811.0,811.0
0.003,17,2,148,1,60,0.0,32.0,32.0,1,88,0.0,60.0,60.0
40.062,17,10,676,5,460,10014.0,104.0,64.0,5,216,10014.0,20.0,15.0
40.066,17,10,676,5,460,10013.0,104.0,64.0,5,216,10015.0,20.0,15.0
0.038,17,2,148,1,60,0.0,32.0,32.0,1,88,0.0,60.0,60.0
0.004,6,10,2006,5,927,1.0,659.0,659.0,5,1079,1.0,811.0,811.0
0.133,6,10,1506,5,395,30.0,127.0,127.0,5,1111,31.0,843.0,843.0
371.005,6,22,2313,16,867,24733.0,195.0,195.0,6,1446,4661.0,419.0,398.0
1759.317,6,466,68231,263,35996,6714.0,613.0,192.0,203,32235,8709.0,613.0,147.0
0.785,6,10,2009,6,1655,157.0,1403.0,1403.0,4,354,185.0,182.0,182.0
0.004,17,2,148,1,60,0.0,32.0,32.0,1,88,0.0,60.0,60.0
0.012,6,10,1990,5,911,2.0,643.0,643.0,5,1079,3.0,811.0,811.0
0.181,6,10,1506,5,395,40.0,127.0,127.0,5,1111,39.0,843.0,843.0
0.728,6,22,5072,11,1250,61.0,325.0,133.0,11,3822,61.0,1414.0,563.0
0.006,17,2,230,1,68,0.0,40.0,40.0,1,162,0.0,134.0,134.0
0.005,6,10,1989,5,927,1.0,659.0,659.0,5,1062,1.0,794.0,794.0
0.005,17,2,214,1,75,0.0,47.0,47.0,1,139,0.0,111.0,111.0
0.005,17,2,144,1,64,0.0,36.0,36.0,1,80,0.0,52.0,52.0
0.01,6,10,1762,5,911,2.0,643.0,643.0,5,851,2.0,583.0,583.0
0.082,6,10,1506,5,395,18.0,127.0,127.0,5,1111,18.0,843.0,843.0
0.009,6,13,3735,7,497,1.0,125.0,125.0,6,3238,1.0,1470.0,1459.0
0.09,6,10,1506,5,395,19.0,127.0,127.0,5,1111,21.0,843.0,843.0
0.015,6,10,1989,5,910,3.0,642.0,642.0,5,1079,3.0,811.0,811.0
0.006,6,10,1547,5,764,1.0,496.0,496.0,5,783,1.0,515.0,515.0
0.005,6,10,2006,5,927,1.0,659.0,659.0,5,1079,1.0,811.0,811.0
0.005,6,10,1547,5,764,1.0,496.0,496.0,5,783,1.0,515.0,515.0
0.124,6,10,1506,5,395,28.0,127.0,127.0,5,1111,26.0,843.0,843.0
352.951,6,20,2210,6,1308,12003.0,494.0,494.0,14,902,27149.0,83.0,83.0
0.048,6,10,1989,5,910,12.0,642.0,642.0,5,1079,11.0,811.0,811.0
0.006,6,10,1547,5,764,1.0,496.0,496.0,5,783,1.0,515.0,515.0
0.007,6,10,1547,5,764,1.0,496.0,496.0,5,783,1.0,515.0,515.0
0.031,6,10,1983,5,910,7.0,642.0,642.0,5,1073,7.0,805.0,805.0
0.016,17,2,194,1,59,0.0,31.0,31.0,1,135,0.0,107.0,107.0
0.01,6,10,1989,5,910,2.0,642.0,642.0,5,1079,2.0,811.0,811.0
0.001,17,2,142,1,63,0.0,35.0,35.0,1,79,0.0,51.0,51.0
0.08,6,10,1506,5,395,17.0,127.0,127.0,5,1111,15.0,843.0,843.0
40.072,17,10,676,5,460,10017.0,104.0,64.0,5,216,10017.0,20.0,15.0
1729.226,6,61,4464,41,2804,43230.0,33.0,33.0,20,1660,91003.0,31.0,31.0
330.739,17,20,1124,10,716,36735.0,48.0,43.0,10,408,36734.0,20.0,12.0
0.013,6,10,1972,5,910,3.0,642.0,642.0,5,1062,3.0,794.0,794.0
0.006,6,10,1547,5,764,1.0,496.0,496.0,5,783,1.0,515.0,515.0
161.013,17,76,10718,38,2537,4351.0,44.0,38.0,38,8181,4351.0,239.0,187.0
0.005,6,10,2000,5,927,1.0,659.0,659.0,5,1073,1.0,805.0,805.0
0.022,6,10,1762,5,911,5.0,643.0,643.0,5,851,5.0,583.0,583.0
0.001,17,2,180,1,66,0.0,38.0,38.0,1,114,0.0,86.0,86.0
0.005,6,10,1774,5,923,1.0,655.0,655.0,5,851,1.0,583.0,583.0
11.179,17,28,4422,14,1994,847.0,269.0,114.0,14,2428,847.0,587.0,145.0
0.044,17,2,184,1,61,0.0,33.0,33.0,1,123,0.0,95.0,95.0
0.005,17,2,180,1,58,0.0,30.0,30.0,1,122,0.0,94.0,94.0
0.008,6,10,1972,5,910,2.0,642.0,642.0,5,1062,2.0,794.0,794.0
0.009,6,10,1990,5,911,2.0,643.0,643.0,5,1079,2.0,811.0,811.0
0.053,17,2,152,1,76,0.0,48.0,48.0,1,76,0.0,48.0,48.0
0.015,6,10,1983,5,910,3.0,642.0,642.0,5,1073,3.0,805.0,805.0
0.17,17,2,152,1,76,0.0,48.0,48.0,1,76,0.0,48.0,48.0
0.005,6,10,1643,5,860,1.0,592.0,592.0,5,783,1.0,515.0,515.0
280.571,6,24,6115,10,1186,31174.0,267.0,156.0,14,4929,21581.0,1400.0,873.0
0.011,6,10,1972,5,910,2.0,642.0,642.0,5,1062,2.0,794.0,794.0
333.186,17,18,1008,9,640,41640.0,48.0,43.0,9,368,41640.0,20.0,12.0
0.004,6,10,1774,5,923,1.0,655.0,655.0,5,851,1.0,583.0,583.0
11.071,17,28,4422,14,1995,839.0,270.0,114.0,14,2427,839.0,586.0,145.0
40.075,17,10,676,5,460,10016.0,104.0,64.0,5,216,10017.0,20.0,15.0
0.012,6,10,1677,5,827,3.0,559.0,559.0,5,850,3.0,582.0,582.0
0.006,6,10,1689,5,839,1.0,571.0,571.0,5,850,1.0,582.0,582.0
0.004,6,10,1702,5,863,0.0,595.0,595.0,5,839,1.0,571.0,571.0
0.171,17,2,152,1,76,0.0,48.0,48.0,1,76,0.0,48.0,48.0
0.021,6,10,1631,5,848,5.0,580.0,580.0,5,783,5.0,515.0,515.0
0.15,17,4,596,2,122,108.0,33.0,33.0,2,474,146.0,323.0,209.0
0.004,17,2,136,1,60,0.0,32.0,32.0,1,76,0.0,48.0,48.0
0.062,6,10,1506,5,395,14.0,127.0,127.0,5,1111,15.0,843.0,843.0
0.001,17,2,180,1,66,0.0,38.0,38.0,1,114,0.0,86.0,86.0
0.071,17,2,182,1,65,0.0,37.0,37.0,1,117,0.0,89.0,89.0
0.014,6,10,1990,5,911,3.0,643.0,643.0,5,1079,3.0,811.0,811.0
40.054,17,10,676,5,460,10011.0,104.0,64.0,5,216,10012.0,20.0,15.0
0.004,6,10,2006,5,927,1.0,659.0,659.0,5,1079,1.0,811.0,811.0
0.009,6,10,1983,5,910,2.0,642.0,642.0,5,1073,2.0,805.0,805.0
0.007,6,10,1989,5,910,1.0,642.0,642.0,5,1079,1.0,811.0,811.0
0.126,6,10,1506,5,395,26.0,127.0,127.0,5,1111,25.0,843.0,843.0
0.006,6,10,1547,5,764,1.0,496.0,496.0,5,783,1.0,515.0,515.0
0.007,6,10,1547,5,764,1.0,496.0,496.0,5,783,1.0,515.0,515.0
0.094,6,10,1506,5,395,20.0,127.0,127.0,5,1111,19.0,843.0,843.0
0.083,6,10,1506,5,395,18.0,127.0,127.0,5,1111,16.0,843.0,843.0
0.001,17,2,179,1,62,0.0,34.0,34.0,1,117,0.0,89.0,89.0
0.025,6,10,1989,5,910,6.0,642.0,642.0,5,1079,6.0,811.0,811.0
0.014,6,10,1989,5,910,3.0,642.0,642.0,5,1079,3.0,811.0,811.0
0.026,6,10,1990,5,911,6.0,643.0,643.0,5,1079,6.0,811.0,811.0
0.009,6,10,1989,5,910,2.0,642.0,642.0,5,1079,2.0,811.0,811.0
0.008,6,10,1631,5,848,2.0,580.0,580.0,5,783,2.0,515.0,515.0
0.005,6,10,1989,5,927,1.0,659.0,659.0,5,1062,1.0,794.0,794.0
300.394,6,16,2170,9,684,37527.0,146.0,146.0,7,1486,50036.0,419.0,398.0
0.087,6,10,1506,5,395,17.0,127.0,127.0,5,1111,21.0,843.0,843.0
0.004,6,10,2006,5,927,1.0,659.0,659.0,5,1079,1.0,811.0,811.0
0.006,6,10,1854,5,889,1.0,621.0,621.0,5,965,1.0,697.0,697.0
361.809,6,19,1688,15,978,25843.0,190.0,190.0,4,710,80012.0,494.0,494.0
0.018,6,10,1762,5,911,4.0,643.0,643.0,5,851,4.0,583.0,583.0
0.005,6,10,2006,5,927,1.0,659.0,659.0,5,1079,1.0,811.0,811.0
0.106,6,10,1506,5,395,22.0,127.0,127.0,5,1111,24.0,843.0,843.0
0.038,17,2,136,1,60,0.0,32.0,32.0,1,76,0.0,48.0,48.0
11.12,17,28,4423,14,1995,842.0,270.0,114.0,14,2428,842.0,587.0,145.0
0.005,6,10,1989,5,927,1.0,659.0,659.0,5,1062,1.0,794.0,794.0
0.138,6,10,1506,5,395,31.0,127.0,127.0,5,1111,21.0,843.0,843.0
0.022,6,10,1989,5,910,5.0,642.0,642.0,5,1079,5.0,811.0,811.0
0.018,6,10,1990,5,911,4.0,643.0,643.0,5,1079,4.0,811.0,811.0
0.004,6,10,2006,5,927,1.0,659.0,659.0,5,1079,1.0,811.0,811.0
0.006,6,10,2007,5,928,1.0,660.0,660.0,5,1079,1.0,811.0,811.0
0.087,6,10,1506,5,395,18.0,127.0,127.0,5,1111,17.0,843.0,843.0
0.023,6,10,1605,5,388,5.0,120.0,120.0,5,1217,5.0,949.0,949.0
11.049,17,28,4424,14,1995,838.0,270.0,114.0,14,2429,841.0,588.0,145.0
0.006,6,10,1689,5,839,1.0,571.0,571.0,5,850,1.0,582.0,582.0
15.085,17,19,10791,9,8290,1882.0,1350.0,893.0,10,2501,1672.0,1350.0,222.0
308.535,17,20,1124,10,716,34266.0,48.0,43.0,10,408,34266.0,20.0,12.0
0.003,17,2,136,1,60,0.0,32.0,32.0,1,76,0.0,48.0,48.0
0.071,17,2,186,1,61,0.0,33.0,33.0,1,125,0.0,97.0,97.0
0.006,17,2,179,1,71,0.0,43.0,43.0,1,108,0.0,80.0,80.0
0.005,6,10,1689,5,839,1.0,571.0,571.0,5,850,1.0,582.0,582.0
0.015,6,10,1972,5,910,3.0,642.0,642.0,5,1062,3.0,794.0,794.0
0.004,6,10,1702,5,863,1.0,595.0,595.0,5,839,0.0,571.0,571.0
0.008,6,10,1972,5,910,1.0,642.0,642.0,5,1062,2.0,794.0,794.0
0.091,6,10,1506,5,395,20.0,127.0,127.0,5,1111,18.0,843.0,843.0
11.066,17,28,4418,14,1994,842.0,269.0,114.0,14,2424,842.0,587.0,145.0
0.011,6,10,1677,5,827,2.0,559.0,559.0,5,850,2.0,582.0,582.0
0.005,6,10,1643,5,860,1.0,592.0,592.0,5,783,1.0,515.0,515.0
0.006,17,2,170,1,65,0.0,37.0,37.0,1,105,0.0,77.0,77.0
0.007,6,10,1989,5,910,1.0,642.0,642.0,5,1079,1.0,811.0,811.0
373.969,6,22,2313,16,867,24931.0,195.0,195.0,6,1446,4644.0,419.0,398.0
10.919,17,28,4422,14,1993,831.0,268.0,114.0,14,2429,831.0,588.0,145.0
0.011,6,10,1989,5,910,2.0,642.0,642.0,5,1079,2.0,811.0,811.0
0.006,6,10,1643,5,860,1.0,592.0,592.0,5,783,1.0,515.0,515.0
0.008,6,10,1989,5,910,2.0,642.0,642.0,5,1079,2.0,811.0,811.0
0.082,6,10,1506,5,395,20.0,127.0,127.0,5,1111,19.0,843.0,843.0
0.017,6,10,1972,5,910,4.0,642.0,642.0,5,1062,4.0,794.0,794.0
15.073,17,15,9239,8,6902,2149.0,1350.0,834.0,7,2337,2507.0,1350.0,305.0
0.01,6,10,1989,5,910,2.0,642.0,642.0,5,1079,2.0,811.0,811.0
0.009,6,12,1926,6,1189,1.0,659.0,434.0,6,737,1.0,417.0,417.0
11.15,17,30,5331,15,2291,784.0,269.0,124.0,15,3040,784.0,1146.0,174.0
1777.126,17,144,45504,72,22752,25029.0,288.0,288.0,72,22752,25029.0,288.0,288.0
0.006,6,10,1547,5,764,1.0,496.0,496.0,5,783,1.0,515.0,515.0
0.004,6,10,1989,5,927,1.0,659.0,659.0,5,1062,1.0,794.0,794.0
0.001,17,2,180,1,66,0.0,38.0,38.0,1,114,0.0,86.0,86.0
0.004,6,10,1774,5,923,1.0,655.0,655.0,5,851,1.0,583.0,583.0
11.264,17,28,4422,14,1994,854.0,269.0,114.0,14,2428,854.0,587.0,145.0
0.012,6,10,1677,5,827,2.0,559.0,559.0,5,850,2.0,582.0,582.0
0.004,6,10,1774,5,923,1.0,655.0,655.0,5,851,1.0,583.0,583.0
0.005,6,10,2007,5,928,1.0,660.0,660.0,5,1079,1.0,811.0,811.0
0.009,6,10,1972,5,910,2.0,642.0,642.0,5,1062,2.0,794.0,794.0
0.092,6,10,1506,5,395,18.0,127.0,127.0,5,1111,19.0,843.0,843.0
0.006,6,10,1547,5,764,1.0,496.0,496.0,5,783,1.0,515.0,515.0
0.005,17,2,193,1,71,0.0,43.0,43.0,1,122,0.0,94.0,94.0
0.017,6,10,1631,5,848,4.0,580.0,580.0,5,783,4.0,515.0,515.0
0.019,6,10,1983,5,910,4.0,642.0,642.0,5,1073,4.0,805.0,805.0
0.073,6,10,1506,5,395,14.0,127.0,127.0,5,1111,15.0,843.0,843.0
0.077,6,10,1506,5,395,17.0,127.0,127.0,5,1111,17.0,843.0,843.0
0.007,6,10,1779,5,928,1.0,660.0,660.0,5,851,1.0,583.0,583.0
0.006,6,10,1547,5,764,1.0,496.0,496.0,5,783,1.0,515.0,515.0
0.005,17,2,180,1,66,0.0,38.0,38.0,1,114,0.0,86.0,86.0
0.012,6,10,1990,5,911,3.0,643.0,643.0,5,1079,2.0,811.0,811.0
0.081,6,10,1506,5,395,18.0,127.0,127.0,5,1111,17.0,843.0,843.0
0.004,6,10,1774,5,923,1.0,655.0,655.0,5,851,1.0,583.0,583.0
354.067,6,21,1795,16,1030,23604.0,190.0,190.0,5,765,60004.0,464.0,248.0
0.011,6,10,1990,5,911,2.0,643.0,643.0,5,1079,2.0,811.0,811.0
0.041,17,2,148,1,60,0.0,32.0,32.0,1,88,0.0,60.0,60.0
0.003,17,2,148,1,60,0.0,32.0,32.0,1,88,0.0,60.0,60.0
0.115,6,10,1506,5,395,24.0,127.0,127.0,5,1111,27.0,843.0,843.0
0.008,6,10,1973,5,911,2.0,643.0,643.0,5,1062,2.0,794.0,794.0
0.009,6,10,1983,5,910,2.0,642.0,642.0,5,1073,2.0,805.0,805.0
0.006,6,13,3747,7,509,0.0,137.0,137.0,6,3238,1.0,1470.0,1459.0
0.016,6,10,1989,5,910,3.0,642.0,642.0,5,1079,4.0,811.0,811.0
0.014,6,10,1989,5,910,3.0,642.0,642.0,5,1079,3.0,811.0,811.0
0.012,6,10,1631,5,848,3.0,580.0,580.0,5,783,2.0,515.0,515.0
0.253,6,16,2783,8,1401,36.0,533.0,325.0,8,1382,24.0,529.0,239.0
0.013,6,10,1677,5,827,3.0,559.0,559.0,5,850,3.0,582.0,582.0
0.004,17,2,136,1,60,0.0,32.0,32.0,1,76,0.0,48.0,48.0
0.006,6,10,1547,5,764,1.0,496.0,496.0,5,783,1.0,515.0,515.0
240.532,6,35,8924,18,2072,14147.0,693.0,225.0,17,6852,15032.0,1402.0,597.0
1515.184,6,190,24321,74,16919,20755.0,2790.0,228.0,116,7402,13174.0,230.0,51.0
61.145,6,36,9704,18,4186,518.0,1753.0,858.0,18,5518,3587.0,2667.0,435.0
240.218,6,31,9345,15,6911,17158.0,2036.0,681.0,16,2434,16014.0,580.0,199.0
0.008,6,10,1972,5,910,2.0,642.0,642.0,5,1062,1.0,794.0,794.0
241.216,6,33,10734,17,3990,15076.0,1038.0,619.0,16,6744,16080.0,1593.0,590.0
0.005,6,10,2007,5,928,1.0,660.0,660.0,5,1079,1.0,811.0,811.0
0.005,6,10,2006,5,927,1.0,659.0,659.0,5,1079,1.0,811.0,811.0
0.102,6,10,1506,5,395,20.0,127.0,127.0,5,1111,23.0,843.0,843.0
0.264,6,10,1506,5,395,44.0,127.0,127.0,5,1111,63.0,843.0,843.0
290.833,6,317,344321,133,18468,2203.0,2736.0,825.0,184,325853,1589.0,2769.0,1849.0
0.015,6,10,1989,5,910,3.0,642.0,642.0,5,1079,3.0,811.0,811.0
178.271,17,70,9895,35,2332,5243.0,44.0,38.0,35,7563,5243.0,239.0,188.0
40.057,17,10,676,5,460,10012.0,104.0,64.0,5,216,10013.0,20.0,15.0
40.066,17,10,676,5,460,10015.0,104.0,64.0,5,216,10015.0,20.0,15.0
0.006,6,10,1547,5,764,1.0,496.0,496.0,5,783,1.0,515.0,515.0
0.084,6,10,1506,5,395,19.0,127.0,127.0,5,1111,19.0,843.0,843.0
240.094,6,16,4481,9,963,30011.0,238.0,166.0,7,3518,40015.0,1402.0,786.0
0.003,17,4,284,2,120,0.0,32.0,32.0,2,164,0.0,60.0,54.0
0.004,6,10,1702,5,863,0.0,595.0,595.0,5,839,1.0,571.0,571.0
0.004,17,4,284,2,120,0.0,32.0,32.0,2,164,0.0,60.0,54.0
361.831,6,21,1792,16,1030,24122.0,190.0,190.0,5,762,60009.0,461.0,247.0
0.005,6,10,2006,5,927,1.0,659.0,659.0,5,1079,1.0,811.0,811.0
0.005,6,10,2006,5,927,1.0,659.0,659.0,5,1079,1.0,811.0,811.0
0.091,6,10,1506,5,395,19.0,127.0,127.0,5,1111,17.0,843.0,843.0
0.01,6,10,1989,5,910,2.0,642.0,642.0,5,1079,2.0,811.0,811.0
0.004,6,10,2007,5,928,1.0,660.0,660.0,5,1079,1.0,811.0,811.0
0.001,17,2,179,1,62,0.0,34.0,34.0,1,117,0.0,89.0,89.0
0.133,17,2,170,1,65,0.0,37.0,37.0,1,105,0.0,77.0,77.0
0.059,17,2,152,1,76,0.0,48.0,48.0,1,76,0.0,48.0,48.0
0.008,6,10,2000,5,927,1.0,659.0,659.0,5,1073,2.0,805.0,805.0
0.004,6,10,2000,5,927,1.0,659.0,659.0,5,1073,1.0,805.0,805.0
0.145,6,10,1506,5,395,33.0,127.0,127.0,5,1111,34.0,843.0,843.0
0.014,6,10,1990,5,911,3.0,643.0,643.0,5,1079,3.0,811.0,811.0
0.087,6,10,1506,5,395,19.0,127.0,127.0,5,1111,19.0,843.0,843.0
1792.47,6,492,99913,247,88523,7286.0,421.0,365.0,245,11390,7345.0,53.0,53.0
0.005,6,10,2007,5,928,1.0,660.0,660.0,5,1079,1.0,811.0,811.0
0.012,6,10,1983,5,910,3.0,642.0,642.0,5,1073,3.0,805.0,805.0
0.005,6,10,1689,5,839,1.0,571.0,571.0,5,850,1.0,582.0,582.0
240.035,6,9,787,5,488,60008.0,232.0,232.0,4,299,80010.0,83.0,83.0
240.101,6,32,9474,16,6896,16006.0,1969.0,674.0,16,2578,16006.0,580.0,217.0
0.003,17,2,203,1,61,0.0,33.0,33.0,1,142,0.0,114.0,114.0
0.015,6,13,3735,7,497,2.0,125.0,125.0,6,3238,3.0,1470.0,1459.0
0.01,6,10,1989,5,910,2.0,642.0,642.0,5,1079,2.0,811.0,811.0
0.005,6,10,2006,5,927,1.0,659.0,659.0,5,1079,1.0,811.0,811.0
0.027,6,10,1990,5,911,6.0,643.0,643.0,5,1079,6.0,811.0,811.0
0.096,6,10,1506,5,395,21.0,127.0,127.0,5,1111,21.0,843.0,843.0
0.093,6,10,1506,5,395,21.0,127.0,127.0,5,1111,21.0,843.0,843.0
0.009,17,2,338,1,74,0.0,46.0,46.0,1,264,0.0,236.0,236.0
0.009,6,10,1989,5,910,2.0,642.0,642.0,5,1079,2.0,811.0,811.0
0.003,17,2,136,1,60,0.0,32.0,32.0,1,76,0.0,48.0,48.0
300.306,6,16,2170,9,684,37517.0,146.0,146.0,7,1486,50023.0,419.0,398.0
0.011,6,10,1689,5,839,2.0,571.0,571.0,5,850,2.0,582.0,582.0
0.004,17,2,148,1,60,0.0,32.0,32.0,1,88,0.0,60.0,60.0
0.006,17,2,179,1,71,0.0,43.0,43.0,1,108,0.0,80.0,80.0
0.011,6,10,1972,5,910,2.0,642.0,642.0,5,1062,2.0,794.0,794.0
0.004,17,2,148,1,60,0.0,32.0,32.0,1,88,0.0,60.0,60.0
0.009,6,10,1631,5,848,2.0,580.0,580.0,5,783,2.0,515.0,515.0
0.005,6,10,1779,5,928,1.0,660.0,660.0,5,851,1.0,583.0,583.0
0.005,6,10,2006,5,927,1.0,659.0,659.0,5,1079,1.0,811.0,811.0
0.12,6,10,1506,5,395,28.0,127.0,127.0,5,1111,25.0,843.0,843.0
0.003,17,2,148,1,60,0.0,32.0,32.0,1,88,0.0,60.0,60.0
0.004,17,2,148,1,60,0.0,32.0,32.0,1,88,0.0,60.0,60.0
0.058,17,2,179,1,71,0.0,43.0,43.0,1,108,0.0,80.0,80.0
0.009,17,2,166,1,75,0.0,47.0,47.0,1,91,0.0,63.0,63.0
0.008,6,10,1989,5,910,2.0,642.0,642.0,5,1079,1.0,811.0,811.0
0.008,6,10,1989,5,927,1.0,659.0,659.0,5,1062,2.0,794.0,794.0
0.004,6,10,2006,5,927,1.0,659.0,659.0,5,1079,1.0,811.0,811.0
0.014,6,10,1972,5,910,3.0,642.0,642.0,5,1062,3.0,794.0,794.0
0.107,6,10,1506,5,395,23.0,127.0,127.0,5,1111,23.0,843.0,843.0
0.021,6,19,9922,11,704,2.0,124.0,124.0,8,9218,2.0,3002.0,2198.0
0.213,6,16,2669,8,1395,30.0,533.0,323.0,8,1274,19.0,529.0,212.0
0.004,17,4,284,2,120,0.0,32.0,32.0,2,164,0.0,60.0,54.0
0.029,6,10,1972,5,910,7.0,642.0,642.0,5,1062,7.0,794.0,794.0
0.071,17,8,3613,4,1874,23.0,1350.0,440.0,4,1739,12.0,1350.0,406.0
0.001,17,2,164,1,74,0.0,46.0,46.0,1,90,0.0,62.0,62.0
0.005,6,10,1779,5,928,1.0,660.0,660.0,5,851,1.0,583.0,583.0
0.017,6,10,1989,5,910,4.0,642.0,642.0,5,1079,4.0,811.0,811.0
0.171,6,10,1506,5,395,41.0,127.0,127.0,5,1111,37.0,843.0,843.0
0.001,17,2,180,1,66,0.0,38.0,38.0,1,114,0.0,86.0,86.0
0.012,6,10,1972,5,910,2.0,642.0,642.0,5,1062,3.0,794.0,794.0
0.018,6,10,1989,5,910,4.0,642.0,642.0,5,1079,4.0,811.0,811.0
0.376,17,17,10021,8,6917,53.0,1350.0,836.0,9,3104,36.0,1350.0,316.0
0.066,17,8,3613,4,1874,22.0,1350.0,440.0,4,1739,11.0,1350.0,406.0
0.039,17,4,284,2,120,0.0,32.0,32.0,2,164,35.0,60.0,54.0
0.005,6,10,2006,5,927,1.0,659.0,659.0,5,1079,1.0,811.0,811.0
369.017,6,22,2313,16,867,24601.0,195.0,195.0,6,1446,4637.0,419.0,398.0
0.001,17,2,180,1,66,0.0,38.0,38.0,1,114,0.0,86.0,86.0
0.012,6,10,1983,5,910,3.0,642.0,642.0,5,1073,2.0,805.0,805.0
0.008,17,2,179,1,71,0.0,43.0,43.0,1,108,0.0,80.0,80.0
15.083,17,17,10673,9,8280,1881.0,1350.0,892.0,8,2393,2148.0,1350.0,271.0
0.005,6,10,1989,5,927,1.0,659.0,659.0,5,1062,1.0,794.0,794.0
0.009,6,10,1762,5,911,2.0,643.0,643.0,5,851,2.0,583.0,583.0
467.555,6,30,8189,16,3168,31170.0,676.0,388.0,14,5021,31347.0,1402.0,612.0
0.005,17,2,166,1,75,0.0,47.0,47.0,1,91,0.0,63.0,63.0
0.078,6,10,1506,5,395,17.0,127.0,127.0,5,1111,17.0,843.0,843.0
0.095,6,10,1506,5,395,21.0,127.0,127.0,5,1111,21.0,843.0,843.0
0.006,6,11,1741,6,891,1.0,571.0,571.0,5,850,1.0,582.0,582.0
0.022,6,10,1989,5,910,5.0,642.0,642.0,5,1079,5.0,811.0,811.0
0.001,17,2,180,1,66,0.0,38.0,38.0,1,114,0.0,86.0,86.0
0.005,6,10,2007,5,928,1.0,660.0,660.0,5,1079,1.0,811.0,811.0
0.088,6,10,1506,5,395,17.0,127.0,127.0,5,1111,20.0,843.0,843.0
0.084,6,10,1506,5,395,18.0,127.0,127.0,5,1111,19.0,843.0,843.0
0.005,6,10,2006,5,927,1.0,659.0,659.0,5,1079,1.0,811.0,811.0
0.044,17,2,152,1,76,0.0,48.0,48.0,1,76,0.0,48.0,48.0
0.005,17,2,144,1,64,0.0,36.0,36.0,1,80,0.0,52.0,52.0
0.151,6,10,1506,5,395,35.0,127.0,127.0,5,1111,35.0,843.0,843.0
0.005,6,10,2006,5,927,1.0,659.0,659.0,5,1079,1.0,811.0,811.0
15.077,17,16,8204,8,6048,2149.0,1350.0,728.0,8,2156,2149.0,1350.0,241.0
10.89,17,28,4419,14,1994,829.0,269.0,114.0,14,2425,829.0,588.0,145.0
0.091,6,10,1506,5,395,22.0,127.0,127.0,5,1111,22.0,843.0,843.0
0.001,17,2,166,1,75,0.0,47.0,47.0,1,91,0.0,63.0,63.0
0.017,6,14,3787,7,497,2.0,125.0,125.0,7,3290,2.0,1448.0,972.0
0.099,6,10,1506,5,395,21.0,127.0,127.0,5,1111,21.0,843.0,843.0
240.172,6,21,7410,11,2624,24017.0,1368.0,514.0,10,4786,26685.0,1657.0,1064.0
40.063,17,10,676,5,460,10015.0,104.0,64.0,5,216,10014.0,20.0,15.0
0.013,6,10,1762,5,911,3.0,643.0,643.0,5,851,3.0,583.0,583.0
1.053,6,12,3134,6,2099,158.0,1328.0,923.0,6,1035,158.0,791.0,791.0
0.013,6,10,1989,5,910,3.0,642.0,642.0,5,1079,3.0,811.0,811.0
0.088,17,2,152,1,76,0.0,48.0,48.0,1,76,0.0,48.0,48.0
0.004,6,10,1989,5,927,1.0,659.0,659.0,5,1062,1.0,794.0,794.0
0.011,6,10,1677,5,827,2.0,559.0,559.0,5,850,2.0,582.0,582.0
0.005,6,10,1689,5,839,1.0,571.0,571.0,5,850,1.0,582.0,582.0
0.006,17,2,230,1,68,0.0,40.0,40.0,1,162,0.0,134.0,134.0
0.005,6,10,2006,5,927,1.0,659.0,659.0,5,1079,1.0,811.0,811.0
0.005,6,10,1779,5,928,1.0,660.0,660.0,5,851,1.0,583.0,583.0
0.072,17,4,284,2,120,0.0,32.0,32.0,2,164,32.0,60.0,54.0
0.008,17,2,194,1,59,0.0,31.0,31.0,1,135,0.0,107.0,107.0
0.01,6,10,1989,5,910,2.0,642.0,642.0,5,1079,2.0,811.0,811.0
242.89,6,386,348110,183,21037,1334.0,2736.0,885.0,203,327073,1202.0,2804.0,1639.0
0.005,6,10,2007,5,928,1.0,660.0,660.0,5,1079,1.0,811.0,811.0
0.013,6,10,1989,5,910,3.0,642.0,642.0,5,1079,3.0,811.0,811.0
0.072,17,2,184,1,61,0.0,33.0,33.0,1,123,0.0,95.0,95.0
0.005,6,10,2000,5,927,1.0,659.0,659.0,5,1073,1.0,805.0,805.0
0.003,6,10,1702,5,863,0.0,595.0,595.0,5,839,0.0,571.0,571.0
9.041,17,6,376,5,280,2260.0,28.0,28.0,1,96,0.0,68.0,68.0
10.518,6,24,7517,13,1385,876.0,530.0,277.0,11,6132,1035.0,1823.0,946.0
0.006,6,10,1643,5,860,1.0,592.0,592.0,5,783,1.0,515.0,515.0
300.364,6,16,2170,9,684,37525.0,146.0,146.0,7,1486,50033.0,419.0,398.0
0.013,6,10,1990,5,911,3.0,643.0,643.0,5,1079,3.0,811.0,811.0
0.01,6,12,1926,6,1189,2.0,659.0,434.0,6,737,1.0,417.0,417.0
40.091,17,10,676,5,460,10016.0,104.0,64.0,5,216,10021.0,20.0,15.0
0.001,17,2,180,1,66,0.0,38.0,38.0,1,114,0.0,86.0,86.0
0.012,6,10,1989,5,910,3.0,642.0,642.0,5,1079,3.0,811.0,811.0
40.054,17,10,676,5,460,10011.0,104.0,64.0,5,216,10012.0,20.0,15.0
0.012,6,10,1547,5,764,3.0,496.0,496.0,5,783,3.0,515.0,515.0
159.435,17,68,9774,34,2267,4831.0,44.0,38.0,34,7507,4831.0,239.0,192.0
0.011,6,10,1989,5,910,2.0,642.0,642.0,5,1079,2.0,811.0,811.0
0.004,6,10,2006,5,927,1.0,659.0,659.0,5,1079,1.0,811.0,811.0
0.071,17,2,184,1,61,0.0,33.0,33.0,1,123,0.0,95.0,95.0
0.005,6,10,2007,5,928,1.0,660.0,660.0,5,1079,1.0,811.0,811.0
0.006,6,10,1854,5,889,1.0,621.0,621.0,5,965,1.0,697.0,697.0
240.084,6,16,4482,9,963,30010.0,238.0,166.0,7,3519,40013.0,1402.0,786.0
0.009,6,10,1989,5,910,2.0,642.0,642.0,5,1079,2.0,811.0,811.0
40.069,17,10,676,5,460,10012.0,104.0,64.0,5,216,10016.0,20.0,15.0
9.036,17,6,376,5,280,2259.0,28.0,28.0,1,96,0.0,68.0,68.0
0.008,6,10,2000,5,927,2.0,659.0,659.0,5,1073,2.0,805.0,805.0
0.004,6,10,2007,5,928,1.0,660.0,660.0,5,1079,1.0,811.0,811.0
0.043,17,2,182,1,65,0.0,37.0,37.0,1,117,0.0,89.0,89.0
0.013,6,11,1729,6,879,2.0,559.0,559.0,5,850,3.0,582.0,582.0
0.019,6,10,1990,5,911,4.0,643.0,643.0,5,1079,4.0,811.0,811.0
0.009,6,10,1989,5,910,2.0,642.0,642.0,5,1079,2.0,811.0,811.0
0.011,6,10,1989,5,910,2.0,642.0,642.0,5,1079,2.0,811.0,811.0
1778.842,17,141,44556,72,22752,25051.0,288.0,288.0,69,21804,26158.0,288.0,288.0
0.003,17,2,148,1,60,0.0,32.0,32.0,1,88,0.0,60.0,60.0
11.114,17,28,4423,14,1995,842.0,270.0,114.0,14,2428,842.0,587.0,145.0
308.451,17,20,1124,10,716,34258.0,48.0,43.0,10,408,34258.0,20.0,12.0
0.014,6,13,3735,7,497,2.0,125.0,125.0,6,3238,2.0,1470.0,1459.0
0.075,6,10,1506,5,395,16.0,127.0,127.0,5,1111,16.0,843.0,843.0
0.005,6,10,1689,5,839,1.0,571.0,571.0,5,850,1.0,582.0,582.0
1795.38,6,329,78467,153,60755,11811.0,2497.0,995.0,176,17712,10259.0,594.0,72.0
1791.653,6,289,27247,146,10033,12356.0,748.0,270.0,143,17214,12617.0,1624.0,71.0
0.009,6,13,3735,7,497,1.0,125.0,125.0,6,3238,1.0,1470.0,1459.0
19.724,6,36,10005,18,4487,522.0,2022.0,933.0,18,5518,1150.0,2667.0,435.0
310.828,17,20,1124,10,716,34522.0,48.0,43.0,10,408,34522.0,20.0,12.0
0.006,6,10,1854,5,889,1.0,621.0,621.0,5,965,1.0,697.0,697.0
300.767,6,40,12798,22,7280,14322.0,2720.0,909.0,18,5518,505.0,2667.0,435.0
0.007,17,2,170,1,65,0.0,37.0,37.0,1,105,0.0,77.0,77.0
0.057,6,10,1506,5,395,13.0,127.0,127.0,5,1111,12.0,843.0,843.0
0.106,6,10,1506,5,395,25.0,127.0,127.0,5,1111,24.0,843.0,843.0
0.012,6,10,1989,5,910,3.0,642.0,642.0,5,1079,3.0,811.0,811.0
0.001,17,2,180,1,66,0.0,38.0,38.0,1,114,0.0,86.0,86.0
0.007,6,10,2000,5,927,1.0,659.0,659.0,5,1073,1.0,805.0,805.0
294.647,6,413,349349,201,22006,1473.0,2688.0,824.0,212,327343,1396.0,2804.0,1597.0
0.005,6,10,2006,5,927,1.0,659.0,659.0,5,1079,1.0,811.0,811.0
1756.639,6,105,6258,60,3519,29772.0,27.0,26.0,45,2739,39922.0,27.0,26.0
333.042,17,20,1124,10,716,36990.0,48.0,43.0,10,408,36990.0,20.0,12.0
0.003,17,2,185,1,73,0.0,45.0,45.0,1,112,0.0,84.0,84.0
0.067,17,8,3613,4,1874,22.0,1350.0,440.0,4,1739,11.0,1350.0,406.0
240.013,6,9,787,5,488,60003.0,232.0,232.0,4,299,80003.0,83.0,83.0
0.006,6,10,2000,5,927,1.0,659.0,659.0,5,1073,1.0,805.0,805.0
0.003,17,2,136,1,60,0.0,32.0,32.0,1,76,0.0,48.0,48.0
0.072,17,8,3613,4,1874,24.0,1350.0,440.0,4,1739,13.0,1350.0,406.0
0.005,6,13,3747,7,509,0.0,137.0,137.0,6,3238,0.0,1470.0,1459.0
0.006,6,10,2006,5,927,1.0,659.0,659.0,5,1079,1.0,811.0,811.0
163.521,17,84,12164,42,2825,3988.0,44.0,39.0,42,9339,3988.0,239.0,194.0
0.774,6,34,20463,18,13850,45.0,2720.0,1455.0,16,6613,39.0,2720.0,851.0
0.005,6,10,2006,5,927,1.0,659.0,659.0,5,1079,1.0,811.0,811.0
0.086,6,10,1506,5,395,20.0,127.0,127.0,5,1111,17.0,843.0,843.0
0.005,6,10,2006,5,927,1.0,659.0,659.0,5,1079,1.0,811.0,811.0
309.322,17,20,1124,10,716,34346.0,48.0,43.0,10,408,34345.0,20.0,12.0
0.005,17,2,144,1,64,0.0,36.0,36.0,1,80,0.0,52.0,52.0
0.114,6,10,1506,5,395,23.0,127.0,127.0,5,1111,22.0,843.0,843.0
0.008,6,10,1990,5,911,2.0,643.0,643.0,5,1079,1.0,811.0,811.0
0.005,6,10,2006,5,927,1.0,659.0,659.0,5,1079,1.0,811.0,811.0
367.32,6,22,2313,16,867,24488.0,195.0,195.0,6,1446,4637.0,419.0,398.0
0.006,17,2,230,1,68,0.0,40.0,40.0,1,162,0.0,134.0,134.0
0.003,17,2,148,1,60,0.0,32.0,32.0,1,88,0.0,60.0,60.0
0.089,6,10,1506,5,395,20.0,127.0,127.0,5,1111,20.0,843.0,843.0
0.033,6,10,1605,5,388,8.0,120.0,120.0,5,1217,8.0,949.0,949.0
0.079,6,10,1506,5,395,17.0,127.0,127.0,5,1111,17.0,843.0,843.0
309.476,17,20,1124,10,716,34372.0,48.0,43.0,10,408,34372.0,20.0,12.0
0.004,17,4,284,2,120,0.0,32.0,32.0,2,164,0.0,60.0,54.0
40.069,17,10,676,5,460,10015.0,104.0,64.0,5,216,10016.0,20.0,15.0
0.005,6,10,2006,5,927,1.0,659.0,659.0,5,1079,1.0,811.0,811.0
0.08,6,10,1506,5,395,17.0,127.0,127.0,5,1111,18.0,843.0,843.0
15.166,17,21,12473,11,8850,1513.0,1350.0,776.0,10,3623,1681.0,1350.0,334.0
0.006,6,10,1689,5,839,1.0,571.0,571.0,5,850,1.0,582.0,582.0
15.075,17,14,9190,8,6902,2149.0,1350.0,834.0,6,2288,3009.0,1350.0,353.0
15.219,17,44,24419,24,21172,660.0,1350.0,854.0,20,3247,799.0,1350.0,134.0
0.005,6,10,1774,5,923,1.0,655.0,655.0,5,851,1.0,583.0,583.0
0.006,6,10,2006,5,927,1.0,659.0,659.0,5,1079,1.0,811.0,811.0
300.318,6,28,7485,16,1409,20021.0,217.0,142.0,12,6076,21842.0,1402.0,680.0
0.003,17,2,136,1,60,0.0,32.0,32.0,1,76,0.0,48.0,48.0
11.106,17,28,4422,14,1993,841.0,268.0,114.0,14,2429,841.0,588.0,145.0
40.062,17,10,676,5,460,10014.0,104.0,64.0,5,216,10014.0,20.0,15.0
0.013,6,10,1972,5,910,3.0,642.0,642.0,5,1062,3.0,794.0,794.0
0.012,6,14,3787,7,497,2.0,125.0,125.0,7,3290,2.0,1448.0,972.0
0.042,17,4,420,2,122,1.0,33.0,33.0,2,298,36.0,145.0,121.0
0.005,17,2,169,1,62,0.0,34.0,34.0,1,107,0.0,79.0,79.0
0.019,6,13,3735,7,497,3.0,125.0,125.0,6,3238,3.0,1470.0,1459.0
0.005,6,10,2006,5,927,1.0,659.0,659.0,5,1079,1.0,811.0,811.0
300.324,6,16,2170,9,684,37520.0,146.0,146.0,7,1486,50026.0,419.0,398.0
0.004,6,10,1702,5,863,1.0,595.0,595.0,5,839,0.0,571.0,571.0
0.01,6,10,1989,5,910,2.0,642.0,642.0,5,1079,2.0,811.0,811.0
40.055,17,10,676,5,460,10012.0,104.0,64.0,5,216,10012.0,20.0,15.0
0.005,6,10,2006,5,927,1.0,659.0,659.0,5,1079,1.0,811.0,811.0
0.042,6,10,1983,5,910,10.0,642.0,642.0,5,1073,10.0,805.0,805.0
0.071,6,45,14111,25,2555,2.0,517.0,139.0,20,11556,3.0,1402.0,808.0
0.004,6,10,1989,5,927,1.0,659.0,659.0,5,1062,1.0,794.0,794.0
0.004,6,13,3690,7,452,0.0,80.0,80.0,6,3238,0.0,1470.0,1459.0
0.012,6,10,1972,5,910,3.0,642.0,642.0,5,1062,2.0,794.0,794.0
0.005,6,14,3742,7,452,0.0,80.0,80.0,7,3290,0.0,1448.0,972.0
0.001,17,2,180,1,66,0.0,38.0,38.0,1,114,0.0,86.0,86.0
0.005,17,2,179,1,71,0.0,43.0,43.0,1,108,0.0,80.0,80.0
0.069,17,8,3613,4,1874,23.0,1350.0,440.0,4,1739,11.0,1350.0,406.0
0.012,6,10,1989,5,910,3.0,642.0,642.0,5,1079,3.0,811.0,811.0
0.016,6,13,3735,7,497,2.0,125.0,125.0,6,3238,3.0,1470.0,1459.0
0.004,6,10,1774,5,923,1.0,655.0,655.0,5,851,1.0,583.0,583.0
0.006,17,2,424,1,72,0.0,44.0,44.0,1,352,0.0,324.0,324.0
0.006,6,10,1547,5,764,1.0,496.0,496.0,5,783,1.0,515.0,515.0
0.09,6,10,1506,5,395,20.0,127.0,127.0,5,1111,18.0,843.0,843.0
40.069,17,10,676,5,460,10016.0,104.0,64.0,5,216,10016.0,20.0,15.0
0.012,6,10,1631,5,848,3.0,580.0,580.0,5,783,2.0,515.0,515.0
0.065,6,10,1506,5,395,13.0,127.0,127.0,5,1111,14.0,843.0,843.0
0.088,6,10,1506,5,395,18.0,127.0,127.0,5,1111,21.0,843.0,843.0
0.006,6,10,1689,5,839,1.0,571.0,571.0,5,850,1.0,582.0,582.0
177.446,17,92,13130,46,3091,3943.0,44.0,39.0,46,10039,3943.0,239.0,190.0
0.005,6,10,1989,5,927,1.0,659.0,659.0,5,1062,1.0,794.0,794.0
0.006,17,2,144,1,64,0.0,36.0,36.0,1,80,0.0,52.0,52.0
311.872,17,20,1124,10,716,34637.0,48.0,43.0,10,408,34638.0,20.0,12.0
0.044,6,10,1989,5,910,11.0,642.0,642.0,5,1079,10.0,811.0,811.0
0.004,6,10,2006,5,927,1.0,659.0,659.0,5,1079,1.0,811.0,811.0
321.609,17,20,1124,10,716,35719.0,48.0,43.0,10,408,35719.0,20.0,12.0
0.005,6,13,3747,7,509,0.0,137.0,137.0,6,3238,0.0,1470.0,1459.0
0.001,17,2,136,1,60,0.0,32.0,32.0,1,76,0.0,48.0,48.0
173.475,17,80,11363,40,2673,4447.0,44.0,38.0,40,8690,4448.0,260.0,189.0
0.124,6,10,1506,5,395,30.0,127.0,127.0,5,1111,28.0,843.0,843.0
0.005,6,14,3742,8,504,0.0,80.0,80.0,6,3238,0.0,1470.0,1459.0
15.072,17,15,9238,8,6902,2149.0,1350.0,834.0,7,2336,2507.0,1350.0,305.0
0.006,6,10,1547,5,764,1.0,496.0,496.0,5,783,1.0,515.0,515.0
240.103,6,16,4482,9,963,30012.0,238.0,166.0,7,3519,40016.0,1402.0,786.0
0.013,6,10,1631,5,848,3.0,580.0,580.0,5,783,3.0,515.0,515.0
0.015,6,10,1972,5,910,3.0,642.0,642.0,5,1062,3.0,794.0,794.0
0.005,6,14,3736,7,446,0.0,74.0,74.0,7,3290,0.0,1448.0,972.0
0.014,6,10,1762,5,911,3.0,643.0,643.0,5,851,3.0,583.0,583.0
300.02,6,12,1782,7,1348,50003.0,494.0,494.0,5,434,75004.0,83.0,83.0
0.039,17,4,420,2,122,0.0,33.0,33.0,2,298,35.0,145.0,121.0
0.006,6,10,2007,5,928,1.0,660.0,660.0,5,1079,1.0,811.0,811.0
0.01,6,10,1989,5,910,2.0,642.0,642.0,5,1079,2.0,811.0,811.0
0.004,17,2,136,1,60,0.0,32.0,32.0,1,76,0.0,48.0,48.0
0.016,6,13,3735,7,497,2.0,125.0,125.0,6,3238,3.0,1470.0,1459.0
0.007,6,10,2006,5,927,1.0,659.0,659.0,5,1079,1.0,811.0,811.0
1769.262,17,92,8096,46,4048,39316.0,60.0,60.0,46,4048,39316.0,60.0,60.0
0.011,6,10,1989,5,910,2.0,642.0,642.0,5,1079,2.0,811.0,811.0
0.103,6,10,1506,5,395,22.0,127.0,127.0,5,1111,22.0,843.0,843.0
0.005,17,2,140,1,62,0.0,34.0,34.0,1,78,0.0,50.0,50.0
0.107,6,10,1506,5,395,22.0,127.0,127.0,5,1111,23.0,843.0,843.0
0.004,17,2,169,1,62,0.0,34.0,34.0,1,107,0.0,79.0,79.0
0.009,6,10,1989,5,910,2.0,642.0,642.0,5,1079,2.0,811.0,811.0
0.018,6,13,3735,7,497,3.0,125.0,125.0,6,3238,3.0,1470.0,1459.0
0.02,6,10,1983,5,910,5.0,642.0,642.0,5,1073,5.0,805.0,805.0
0.012,6,10,1990,5,911,3.0,643.0,643.0,5,1079,3.0,811.0,811.0
0.086,6,10,1506,5,395,19.0,127.0,127.0,5,1111,20.0,843.0,843.0
322.869,17,20,1124,10,716,35860.0,48.0,43.0,10,408,35860.0,20.0,12.0
0.027,17,2,152,1,76,0.0,48.0,48.0,1,76,0.0,48.0,48.0
0.012,6,10,1762,5,911,2.0,643.0,643.0,5,851,2.0,583.0,583.0
308.325,17,20,1124,10,716,34244.0,48.0,43.0,10,408,34244.0,20.0,12.0
0.003,17,2,148,1,60,0.0,32.0,32.0,1,88,0.0,60.0,60.0
0.005,6,10,2006,5,927,1.0,659.0,659.0,5,1079,1.0,811.0,811.0
0.011,6,10,1989,5,910,2.0,642.0,642.0,5,1079,2.0,811.0,811.0
0.005,17,2,178,1,81,0.0,53.0,53.0,1,97,0.0,69.0,69.0
0.103,6,10,1506,5,395,23.0,127.0,127.0,5,1111,23.0,843.0,843.0
0.006,6,10,1689,5,839,1.0,571.0,571.0,5,850,1.0,582.0,582.0
0.003,17,2,148,1,60,0.0,32.0,32.0,1,88,0.0,60.0,60.0
0.013,6,10,1989,5,910,3.0,642.0,642.0,5,1079,3.0,811.0,811.0
0.059,6,10,1506,5,395,13.0,127.0,127.0,5,1111,13.0,843.0,843.0
326.235,17,20,1124,10,716,36233.0,48.0,43.0,10,408,36233.0,20.0,12.0
0.005,6,10,1989,5,927,1.0,659.0,659.0,5,1062,1.0,794.0,794.0
0.001,17,2,136,1,60,0.0,32.0,32.0,1,76,0.0,48.0,48.0
0.019,6,10,1677,5,827,4.0,559.0,559.0,5,850,4.0,582.0,582.0
0.008,6,10,1989,5,910,2.0,642.0,642.0,5,1079,2.0,811.0,811.0
0.005,6,10,1774,5,923,1.0,655.0,655.0,5,851,1.0,583.0,583.0
10.732,17,28,4424,14,1995,817.0,270.0,114.0,14,2429,816.0,588.0,145.0
0.006,17,2,273,1,66,0.0,38.0,38.0,1,207,0.0,179.0,179.0
0.037,17,2,136,1,60,0.0,32.0,32.0,1,76,0.0,48.0,48.0
0.013,6,10,1990,5,911,3.0,643.0,643.0,5,1079,3.0,811.0,811.0
240.232,6,18,7342,10,2076,26692.0,1368.0,520.0,8,5266,34317.0,2802.0,1210.0
0.021,6,13,3735,7,497,3.0,125.0,125.0,6,3238,4.0,1470.0,1459.0
0.08,6,10,1506,5,395,18.0,127.0,127.0,5,1111,19.0,843.0,843.0
0.263,17,39,20115,21,17046,13.0,1350.0,783.0,18,3069,11.0,1350.0,142.0
0.013,6,10,1989,5,910,3.0,642.0,642.0,5,1079,3.0,811.0,811.0
40.08,17,10,676,5,460,10019.0,104.0,64.0,5,216,10019.0,20.0,15.0
0.095,6,10,1506,5,395,18.0,127.0,127.0,5,1111,21.0,843.0,843.0
0.038,17,4,596,2,122,0.0,33.0,33.0,2,474,1.0,323.0,209.0
0.009,6,10,1631,5,848,2.0,580.0,580.0,5,783,2.0,515.0,515.0
0.012,6,10,1990,5,911,3.0,643.0,643.0,5,1079,2.0,811.0,811.0
0.006,17,2,170,1,65,0.0,37.0,37.0,1,105,0.0,77.0,77.0
0.001,17,2,180,1,66,0.0,38.0,38.0,1,114,0.0,86.0,86.0
0.04,17,2,152,1,76,0.0,48.0,48.0,1,76,0.0,48.0,48.0
371.334,6,22,2313,16,867,24755.0,195.0,195.0,6,1446,4636.0,419.0,398.0
0.004,6,10,2007,5,928,1.0,660.0,660.0,5,1079,1.0,811.0,811.0
10.896,17,28,4420,14,1993,829.0,268.0,114.0,14,2427,829.0,586.0,145.0
0.01,6,10,1990,5,911,2.0,643.0,643.0,5,1079,2.0,811.0,811.0
15.076,17,16,8702,8,6636,2149.0,1350.0,801.0,8,2066,2149.0,1350.0,230.0
300.022,6,12,1782,7,1348,50003.0,494.0,494.0,5,434,75005.0,83.0,83.0
0.001,17,2,140,1,62,0.0,34.0,34.0,1,78,0.0,50.0,50.0
0.034,6,10,1983,5,910,8.0,642.0,642.0,5,1073,8.0,805.0,805.0
0.005,6,15,3794,8,504,0.0,80.0,80.0,7,3290,0.0,1448.0,972.0
0.004,17,2,148,1,60,0.0,32.0,32.0,1,88,0.0,60.0,60.0
0.066,6,10,1506,5,395,14.0,127.0,127.0,5,1111,15.0,843.0,843.0
0.017,17,2,166,1,75,0.0,47.0,47.0,1,91,0.0,63.0,63.0
0.003,17,2,136,1,60,0.0,32.0,32.0,1,76,0.0,48.0,48.0
0.008,6,10,2006,5,927,2.0,659.0,659.0,5,1079,2.0,811.0,811.0
0.113,6,10,1506,5,395,25.0,127.0,127.0,5,1111,20.0,843.0,843.0
0.08,6,10,1506,5,395,18.0,127.0,127.0,5,1111,16.0,843.0,843.0
0.004,6,10,1702,5,863,1.0,595.0,595.0,5,839,0.0,571.0,571.0
0.014,17,2,144,1,64,0.0,36.0,36.0,1,80,0.0,52.0,52.0
0.073,6,10,1506,5,395,13.0,127.0,127.0,5,1111,16.0,843.0,843.0
353.275,6,20,2210,6,1308,12010.0,494.0,494.0,14,902,27174.0,83.0,83.0
0.228,6,16,2674,8,1400,32.0,533.0,325.0,8,1274,21.0,529.0,212.0
0.007,6,10,1989,5,910,1.0,642.0,642.0,5,1079,1.0,811.0,811.0
0.022,6,10,1989,5,910,5.0,642.0,642.0,5,1079,5.0,811.0,811.0
0.009,6,10,1990,5,911,2.0,643.0,643.0,5,1079,2.0,811.0,811.0
0.004,6,10,2000,5,927,1.0,659.0,659.0,5,1073,1.0,805.0,805.0
0.005,6,10,2000,5,927,1.0,659.0,659.0,5,1073,1.0,805.0,805.0
0.009,6,10,1762,5,911,2.0,643.0,643.0,5,851,2.0,583.0,583.0
300.33,6,19,3085,11,1647,30033.0,517.0,266.0,8,1438,34331.0,825.0,338.0
0.033,6,10,1631,5,848,8.0,580.0,580.0,5,783,8.0,515.0,515.0
0.009,6,13,3735,7,497,1.0,125.0,125.0,6,3238,1.0,1470.0,1459.0
0.078,6,10,1506,5,395,19.0,127.0,127.0,5,1111,18.0,843.0,843.0
0.011,6,10,1677,5,827,2.0,559.0,559.0,5,850,2.0,582.0,582.0
0.001,17,2,179,1,62,0.0,34.0,34.0,1,117,0.0,89.0,89.0
0.004,6,10,2006,5,927,1.0,659.0,659.0,5,1079,1.0,811.0,811.0
0.005,6,10,1989,5,927,1.0,659.0,659.0,5,1062,1.0,794.0,794.0
0.005,6,10,2007,5,928,1.0,660.0,660.0,5,1079,1.0,811.0,811.0
0.077,6,10,1506,5,395,16.0,127.0,127.0,5,1111,17.0,843.0,843.0
0.006,6,10,1689,5,839,1.0,571.0,571.0,5,850,1.0,582.0,582.0
0.006,6,10,1547,5,764,1.0,496.0,496.0,5,783,1.0,515.0,515.0
0.007,6,10,1547,5,764,1.0,496.0,496.0,5,783,1.0,515.0,515.0
0.0,17,2,136,1,60,0.0,32.0,32.0,1,76,0.0,48.0,48.0
0.01,6,10,1972,5,910,2.0,642.0,642.0,5,1062,2.0,794.0,794.0
0.278,17,45,27882,27,24821,10.0,1350.0,891.0,18,3061,11.0,1350.0,142.0
0.006,6,10,1547,5,764,1.0,496.0,496.0,5,783,1.0,515.0,515.0
0.005,6,10,1774,5,923,1.0,655.0,655.0,5,851,1.0,583.0,583.0
0.082,6,10,1506,5,395,17.0,127.0,127.0,5,1111,18.0,843.0,843.0
0.005,6,10,2000,5,927,1.0,659.0,659.0,5,1073,1.0,805.0,805.0
0.006,17,2,213,1,69,0.0,41.0,41.0,1,144,0.0,116.0,116.0
0.012,6,10,1972,5,910,2.0,642.0,642.0,5,1062,3.0,794.0,794.0
0.008,6,10,1631,5,848,2.0,580.0,580.0,5,783,2.0,515.0,515.0
0.096,6,10,1506,5,395,20.0,127.0,127.0,5,1111,22.0,843.0,843.0
0.004,17,2,148,1,60,0.0,32.0,32.0,1,88,0.0,60.0,60.0
0.001,17,2,166,1,75,0.0,47.0,47.0,1,91,0.0,63.0,63.0
0.006,6,10,1643,5,860,1.0,592.0,592.0,5,783,1.0,515.0,515.0
40.069,17,10,676,5,460,10016.0,104.0,64.0,5,216,10014.0,20.0,15.0
0.006,6,10,1547,5,764,1.0,496.0,496.0,5,783,1.0,515.0,515.0
0.005,6,14,3736,7,446,0.0,74.0,74.0,7,3290,0.0,1448.0,972.0
0.101,6,10,1506,5,395,23.0,127.0,127.0,5,1111,24.0,843.0,843.0
309.135,17,20,1124,10,716,34334.0,48.0,43.0,10,408,34334.0,20.0,12.0
0.068,6,10,1506,5,395,14.0,127.0,127.0,5,1111,14.0,843.0,843.0
0.011,6,10,1677,5,827,2.0,559.0,559.0,5,850,2.0,582.0,582.0
0.015,6,10,1990,5,911,3.0,643.0,643.0,5,1079,3.0,811.0,811.0
0.126,6,10,1506,5,395,27.0,127.0,127.0,5,1111,28.0,843.0,843.0
240.084,6,16,4481,9,963,30010.0,238.0,166.0,7,3518,40013.0,1402.0,786.0
0.027,6,10,1983,5,910,6.0,642.0,642.0,5,1073,6.0,805.0,805.0
0.005,17,2,169,1,62,0.0,34.0,34.0,1,107,0.0,79.0,79.0
0.012,6,10,1989,5,910,3.0,642.0,642.0,5,1079,2.0,811.0,811.0
0.001,17,2,166,1,75,0.0,47.0,47.0,1,91,0.0,63.0,63.0
0.068,17,8,3613,4,1874,22.0,1350.0,440.0,4,1739,11.0,1350.0,406.0
0.002,17,2,180,1,66,0.0,38.0,38.0,1,114,0.0,86.0,86.0
300.32,6,31,12239,16,6013,20021.0,1368.0,739.0,15,6226,21451.0,1657.0,908.0
160.401,17,80,11364,40,2673,4112.0,44.0,38.0,40,8691,4112.0,239.0,189.0
0.124,6,10,1506,5,395,28.0,127.0,127.0,5,1111,30.0,843.0,843.0
0.006,6,10,1989,5,927,1.0,659.0,659.0,5,1062,1.0,794.0,794.0
0.105,6,10,1506,5,395,23.0,127.0,127.0,5,1111,24.0,843.0,843.0
0.006,6,10,1547,5,764,1.0,496.0,496.0,5,783,1.0,515.0,515.0
0.005,6,10,2006,5,927,1.0,659.0,659.0,5,1079,1.0,811.0,811.0
0.017,17,2,179,1,71,0.0,43.0,43.0,1,108,0.0,80.0,80.0
0.005,6,10,1547,5,764,1.0,496.0,496.0,5,783,1.0,515.0,515.0
0.007,6,10,1774,5,923,1.0,655.0,655.0,5,851,1.0,583.0,583.0
0.007,6,10,1547,5,764,1.0,496.0,496.0,5,783,1.0,515.0,515.0
0.029,6,13,3735,7,497,4.0,125.0,125.0,6,3238,5.0,1470.0,1459.0
0.168,6,3,453,2,321,168.0,241.0,241.0,1,132,0.0,92.0,92.0
0.103,6,10,1506,5,395,23.0,127.0,127.0,5,1111,21.0,843.0,843.0
0.088,6,10,1506,5,395,19.0,127.0,127.0,5,1111,18.0,843.0,843.0
1777.852,17,144,41760,72,22752,25040.0,288.0,288.0,72,19008,25040.0,236.0,236.0
240.378,6,42,8721,21,5686,12018.0,1515.0,509.0,21,3035,12018.0,580.0,241.0
11.13,17,28,4424,14,1995,843.0,270.0,114.0,14,2429,843.0,588.0,145.0
0.009,6,10,1989,5,910,2.0,642.0,642.0,5,1079,2.0,811.0,811.0
0.013,6,10,1631,5,848,3.0,580.0,580.0,5,783,3.0,515.0,515.0
0.083,6,10,1506,5,395,20.0,127.0,127.0,5,1111,17.0,843.0,843.0
1.078,17,6,1008,3,183,503.0,33.0,33.0,3,825,519.0,323.0,247.0
0.042,17,2,152,1,76,0.0,48.0,48.0,1,76,0.0,48.0,48.0
0.006,6,10,1689,5,839,1.0,571.0,571.0,5,850,1.0,582.0,582.0
0.007,6,10,1989,5,910,1.0,642.0,642.0,5,1079,1.0,811.0,811.0
0.001,17,2,180,1,66,0.0,38.0,38.0,1,114,0.0,86.0,86.0
0.02,6,10,1677,5,827,5.0,559.0,559.0,5,850,5.0,582.0,582.0
0.011,6,10,1972,5,910,2.0,642.0,642.0,5,1062,2.0,794.0,794.0
0.006,6,10,1547,5,764,1.0,496.0,496.0,5,783,1.0,515.0,515.0
0.117,6,23,6535,11,2013,10.0,746.0,286.0,12,4522,9.0,1324.0,778.0
0.003,17,2,136,1,60,0.0,32.0,32.0,1,76,0.0,48.0,48.0
0.011,6,10,1677,5,827,2.0,559.0,559.0,5,850,2.0,582.0,582.0
0.057,6,10,1506,5,395,13.0,127.0,127.0,5,1111,13.0,843.0,843.0
0.016,6,10,1677,5,827,3.0,559.0,559.0,5,850,4.0,582.0,582.0
0.005,6,10,2006,5,927,1.0,659.0,659.0,5,1079,1.0,811.0,811.0
10.759,17,28,4421,14,1993,819.0,268.0,114.0,14,2428,819.0,587.0,145.0
0.208,6,16,2778,8,1396,29.0,533.0,324.0,8,1382,18.0,529.0,239.0
300.953,6,46,19814,24,14136,13084.0,2720.0,1460.0,22,5678,418.0,2667.0,435.0
0.01,6,10,1762,5,911,2.0,643.0,643.0,5,851,2.0,583.0,583.0
1777.647,17,144,45504,72,22752,25037.0,288.0,288.0,72,22752,25037.0,288.0,288.0
15.075,17,15,9238,8,6902,2149.0,1350.0,834.0,7,2336,2507.0,1350.0,305.0
0.124,6,10,1506,5,395,24.0,127.0,127.0,5,1111,28.0,843.0,843.0
0.01,6,10,1972,5,910,2.0,642.0,642.0,5,1062,2.0,794.0,794.0
0.001,17,2,179,1,62,0.0,34.0,34.0,1,117,0.0,89.0,89.0
0.031,6,6,716,3,458,9.0,302.0,302.0,3,258,9.0,102.0,102.0
0.005,17,2,179,1,71,0.0,43.0,43.0,1,108,0.0,80.0,80.0
0.012,6,10,1989,5,910,3.0,642.0,642.0,5,1079,2.0,811.0,811.0
0.163,17,2,152,1,76,0.0,48.0,48.0,1,76,0.0,48.0,48.0
0.009,17,4,284,2,120,0.0,32.0,32.0,2,164,0.0,60.0,54.0
0.011,6,10,1990,5,911,2.0,643.0,643.0,5,1079,2.0,811.0,811.0
40.055,17,10,676,5,460,10012.0,104.0,64.0,5,216,10012.0,20.0,15.0
0.004,6,10,1774,5,923,1.0,655.0,655.0,5,851,1.0,583.0,583.0
0.012,6,14,3742,7,452,2.0,80.0,80.0,7,3290,2.0,1448.0,972.0
0.006,6,10,1547,5,764,1.0,496.0,496.0,5,783,1.0,515.0,515.0
0.038,17,2,166,1,75,0.0,47.0,47.0,1,91,0.0,63.0,63.0
0.035,6,13,3816,7,578,5.0,206.0,206.0,6,3238,7.0,1470.0,1459.0
0.008,6,10,1972,5,910,2.0,642.0,642.0,5,1062,2.0,794.0,794.0
0.043,17,2,148,1,60,0.0,32.0,32.0,1,88,0.0,60.0,60.0
0.067,6,10,1506,5,395,13.0,127.0,127.0,5,1111,15.0,843.0,843.0
0.005,6,10,1689,5,839,1.0,571.0,571.0,5,850,1.0,582.0,582.0
0.005,6,10,2000,5,927,1.0,659.0,659.0,5,1073,1.0,805.0,805.0
0.011,6,10,1677,5,827,2.0,559.0,559.0,5,850,2.0,582.0,582.0
0.005,6,10,2007,5,928,1.0,660.0,660.0,5,1079,1.0,811.0,811.0
0.005,6,10,1779,5,928,1.0,660.0,660.0,5,851,1.0,583.0,583.0
0.019,6,10,1983,5,910,4.0,642.0,642.0,5,1073,4.0,805.0,805.0
0.014,6,10,1631,5,848,3.0,580.0,580.0,5,783,3.0,515.0,515.0
0.006,6,10,1547,5,764,1.0,496.0,496.0,5,783,1.0,515.0,515.0
0.005,6,10,1779,5,928,1.0,660.0,660.0,5,851,1.0,583.0,583.0
0.006,6,10,1854,5,889,1.0,621.0,621.0,5,965,1.0,697.0,697.0
0.006,17,2,166,1,75,0.0,47.0,47.0,1,91,0.0,63.0,63.0
0.001,17,2,136,1,60,0.0,32.0,32.0,1,76,0.0,48.0,48.0
0.001,17,2,180,1,66,0.0,38.0,38.0,1,114,0.0,86.0,86.0
0.126,17,4,284,2,120,0.0,32.0,32.0,2,164,88.0,60.0,54.0
0.005,6,10,1854,5,889,1.0,621.0,621.0,5,965,1.0,697.0,697.0
0.009,6,10,1989,5,910,2.0,642.0,642.0,5,1079,2.0,811.0,811.0
0.006,6,10,1547,5,764,1.0,496.0,496.0,5,783,1.0,515.0,515.0
0.04,17,4,284,2,120,0.0,32.0,32.0,2,164,37.0,60.0,54.0
0.012,6,10,1631,5,848,3.0,580.0,580.0,5,783,3.0,515.0,515.0
0.121,6,10,1506,5,395,26.0,127.0,127.0,5,1111,25.0,843.0,843.0
0.003,17,2,142,1,63,0.0,35.0,35.0,1,79,0.0,51.0,51.0
0.005,6,10,1689,5,839,1.0,571.0,571.0,5,850,1.0,582.0,582.0
0.011,6,10,1989,5,910,2.0,642.0,642.0,5,1079,2.0,811.0,811.0
0.083,6,10,1506,5,395,20.0,127.0,127.0,5,1111,15.0,843.0,843.0
0.005,6,10,1989,5,927,1.0,659.0,659.0,5,1062,1.0,794.0,794.0
0.038,17,2,412,1,61,0.0,33.0,33.0,1,351,0.0,323.0,323.0
0.004,6,10,2006,5,927,1.0,659.0,659.0,5,1079,1.0,811.0,811.0
0.005,17,2,169,1,62,0.0,34.0,34.0,1,107,0.0,79.0,79.0
0.003,17,2,148,1,60,0.0,32.0,32.0,1,88,0.0,60.0,60.0
0.003,17,2,136,1,60,0.0,32.0,32.0,1,76,0.0,48.0,48.0
0.018,6,10,1677,5,827,4.0,559.0,559.0,5,850,4.0,582.0,582.0
241.516,6,357,346785,164,20072,1481.0,2736.0,885.0,193,326713,1257.0,2804.0,1730.0
0.007,6,10,2000,5,927,1.0,659.0,659.0,5,1073,1.0,805.0,805.0
0.005,6,10,2006,5,927,1.0,659.0,659.0,5,1079,1.0,811.0,811.0
0.009,6,10,1989,5,910,2.0,642.0,642.0,5,1079,2.0,811.0,811.0
0.005,6,10,1689,5,839,1.0,571.0,571.0,5,850,1.0,582.0,582.0
0.005,6,10,1643,5,860,1.0,592.0,592.0,5,783,1.0,515.0,515.0
40.057,17,10,676,5,460,10012.0,104.0,64.0,5,216,10013.0,20.0,15.0
0.011,6,10,1983,5,910,2.0,642.0,642.0,5,1073,2.0,805.0,805.0
0.009,6,10,1989,5,910,2.0,642.0,642.0,5,1079,2.0,811.0,811.0
0.006,6,10,1547,5,764,1.0,496.0,496.0,5,783,1.0,515.0,515.0
0.01,6,10,2006,5,927,2.0,659.0,659.0,5,1079,2.0,811.0,811.0
40.082,17,10,676,5,460,10019.0,104.0,64.0,5,216,10019.0,20.0,15.0
0.012,17,2,222,1,65,0.0,37.0,37.0,1,157,0.0,129.0,129.0
0.014,6,13,3735,7,497,2.0,125.0,125.0,6,3238,2.0,1470.0,1459.0
0.065,6,10,1506,5,395,15.0,127.0,127.0,5,1111,14.0,843.0,843.0
77.651,6,21,8146,11,1985,89.0,1174.0,504.0,10,6161,8608.0,2720.0,958.0
40.062,17,10,676,5,460,10014.0,104.0,64.0,5,216,10014.0,20.0,15.0
0.005,6,10,1989,5,927,1.0,659.0,659.0,5,1062,1.0,794.0,794.0
0.077,6,10,1506,5,395,17.0,127.0,127.0,5,1111,16.0,843.0,843.0
0.006,17,2,170,1,65,0.0,37.0,37.0,1,105,0.0,77.0,77.0
40.094,17,10,676,5,460,10020.0,104.0,64.0,5,216,10021.0,20.0,15.0
0.01,6,10,1989,5,910,2.0,642.0,642.0,5,1079,2.0,811.0,811.0
0.006,17,2,169,1,62,0.0,34.0,34.0,1,107,0.0,79.0,79.0
0.009,6,13,3913,7,495,1.0,123.0,123.0,6,3418,1.0,1650.0,1549.0
0.008,6,10,1989,5,910,2.0,642.0,642.0,5,1079,2.0,811.0,811.0
0.1,6,10,1506,5,395,23.0,127.0,127.0,5,1111,23.0,843.0,843.0
0.004,17,2,136,1,60,0.0,32.0,32.0,1,76,0.0,48.0,48.0
0.005,17,2,214,1,75,0.0,47.0,47.0,1,139,0.0,111.0,111.0
0.004,6,10,2006,5,927,1.0,659.0,659.0,5,1079,1.0,811.0,811.0
0.005,6,10,1779,5,928,1.0,660.0,660.0,5,851,1.0,583.0,583.0
0.005,17,2,179,1,71,0.0,43.0,43.0,1,108,0.0,80.0,80.0
0.074,6,10,1506,5,395,17.0,127.0,127.0,5,1111,15.0,843.0,843.0
0.006,17,2,144,1,64,0.0,36.0,36.0,1,80,0.0,52.0,52.0
0.015,6,10,1677,5,827,3.0,559.0,559.0,5,850,3.0,582.0,582.0
0.004,6,10,2000,5,927,1.0,659.0,659.0,5,1073,1.0,805.0,805.0
0.009,6,10,1972,5,910,2.0,642.0,642.0,5,1062,2.0,794.0,794.0
0.007,6,10,1854,5,889,1.0,621.0,621.0,5,965,1.0,697.0,697.0
0.005,17,2,186,1,61,0.0,33.0,33.0,1,125,0.0,97.0,97.0
293.491,6,329,345540,120,17795,2466.0,2736.0,889.0,209,327745,1411.0,2914.0,1624.0
0.108,6,10,1506,5,395,25.0,127.0,127.0,5,1111,23.0,843.0,843.0
0.005,17,2,166,1,75,0.0,47.0,47.0,1,91,0.0,63.0,63.0
0.001,17,2,136,1,60,0.0,32.0,32.0,1,76,0.0,48.0,48.0
0.101,6,10,1506,5,395,23.0,127.0,127.0,5,1111,19.0,843.0,843.0
0.097,6,10,1506,5,395,20.0,127.0,127.0,5,1111,19.0,843.0,843.0
40.059,17,10,676,5,460,10013.0,104.0,64.0,5,216,10014.0,20.0,15.0
0.011,6,10,1972,5,910,2.0,642.0,642.0,5,1062,2.0,794.0,794.0
300.788,6,38,9815,21,4337,15039.0,1360.0,577.0,17,5478,537.0,2667.0,435.0
0.001,17,2,136,1,60,0.0,32.0,32.0,1,76,0.0,48.0,48.0
0.004,17,2,136,1,60,0.0,32.0,32.0,1,76,0.0,48.0,48.0
0.092,6,10,1506,5,395,20.0,127.0,127.0,5,1111,18.0,843.0,843.0
0.005,6,14,3742,7,452,0.0,80.0,80.0,7,3290,0.0,1448.0,972.0
40.474,6,44,15114,22,9207,430.0,2720.0,1185.0,22,5907,1919.0,2667.0,385.0
0.072,17,4,352,2,130,0.0,37.0,37.0,2,222,69.0,89.0,83.0
0.01,6,10,1605,5,388,2.0,120.0,120.0,5,1217,2.0,949.0,949.0
0.185,6,43,11497,23,3169,8.0,1021.0,197.0,20,8328,9.0,1402.0,606.0
0.016,6,10,1989,5,910,4.0,642.0,642.0,5,1079,3.0,811.0,811.0
0.004,6,10,1774,5,923,1.0,655.0,655.0,5,851,1.0,583.0,583.0
0.005,6,10,2007,5,928,1.0,660.0,660.0,5,1079,1.0,811.0,811.0
0.085,6,10,1506,5,395,19.0,127.0,127.0,5,1111,18.0,843.0,843.0
0.005,6,10,1854,5,889,1.0,621.0,621.0,5,965,1.0,697.0,697.0
368.986,6,22,2313,16,867,24599.0,195.0,195.0,6,1446,4639.0,419.0,398.0
0.007,17,2,194,1,59,0.0,31.0,31.0,1,135,0.0,107.0,107.0
0.039,17,2,144,1,64,0.0,36.0,36.0,1,80,0.0,52.0,52.0
0.001,17,2,174,1,72,0.0,44.0,44.0,1,102,0.0,74.0,74.0
0.004,6,10,2006,5,927,1.0,659.0,659.0,5,1079,1.0,811.0,811.0
290.585,6,395,348754,200,21969,1460.0,2736.0,825.0,195,326785,1497.0,2804.0,1749.0
240.096,6,16,4481,9,963,30012.0,238.0,166.0,7,3518,40015.0,1402.0,786.0
0.015,6,10,1990,5,911,3.0,643.0,643.0,5,1079,3.0,811.0,811.0
0.005,6,10,2006,5,927,1.0,659.0,659.0,5,1079,1.0,811.0,811.0
0.005,6,10,2000,5,927,1.0,659.0,659.0,5,1073,1.0,805.0,805.0
0.083,6,10,1506,5,395,19.0,127.0,127.0,5,1111,19.0,843.0,843.0
0.009,6,10,1989,5,910,2.0,642.0,642.0,5,1079,2.0,811.0,811.0
241.505,6,323,345026,117,17597,2081.0,2736.0,959.0,206,327429,1177.0,2804.0,1615.0
0.005,17,2,179,1,71,0.0,43.0,43.0,1,108,0.0,80.0,80.0
240.237,6,26,9851,14,1292,18479.0,260.0,189.0,12,8559,21836.0,1436.0,880.0
361.882,6,21,1792,16,1030,24125.0,190.0,190.0,5,762,60010.0,461.0,247.0
0.005,6,14,3799,7,509,0.0,137.0,137.0,7,3290,0.0,1448.0,972.0
0.007,17,2,179,1,71,0.0,43.0,43.0,1,108,0.0,80.0,80.0
40.068,17,10,676,5,460,10016.0,104.0,64.0,5,216,10016.0,20.0,15.0
0.009,6,10,1972,5,910,2.0,642.0,642.0,5,1062,2.0,794.0,794.0
0.005,17,2,144,1,64,0.0,36.0,36.0,1,80,0.0,52.0,52.0
0.005,6,10,1989,5,927,1.0,659.0,659.0,5,1062,1.0,794.0,794.0
0.013,6,10,1989,5,910,3.0,642.0,642.0,5,1079,3.0,811.0,811.0
0.003,17,2,148,1,60,0.0,32.0,32.0,1,88,0.0,60.0,60.0
0.08,6,10,1506,5,395,15.0,127.0,127.0,5,1111,18.0,843.0,843.0
0.07,6,10,1506,5,395,15.0,127.0,127.0,5,1111,16.0,843.0,843.0
0.072,6,10,1506,5,395,17.0,127.0,127.0,5,1111,15.0,843.0,843.0
0.012,6,10,1983,5,910,2.0,642.0,642.0,5,1073,3.0,805.0,805.0
0.005,6,13,3747,7,509,0.0,137.0,137.0,6,3238,0.0,1470.0,1459.0
241.156,6,367,347282,175,20626,1385.0,2736.0,886.0,192,326656,1262.0,2804.0,1739.0
0.005,6,10,2006,5,927,1.0,659.0,659.0,5,1079,1.0,811.0,811.0
0.033,6,13,3735,7,497,5.0,125.0,125.0,6,3238,6.0,1470.0,1459.0
0.132,17,2,186,1,61,0.0,33.0,33.0,1,125,0.0,97.0,97.0
0.007,17,2,180,1,58,0.0,30.0,30.0,1,122,0.0,94.0,94.0
0.009,6,10,1983,5,910,2.0,642.0,642.0,5,1073,2.0,805.0,805.0
0.041,17,2,182,1,65,0.0,37.0,37.0,1,117,0.0,89.0,89.0
0.071,17,4,284,2,120,0.0,32.0,32.0,2,164,68.0,60.0,54.0
0.011,6,10,1677,5,827,2.0,559.0,559.0,5,850,2.0,582.0,582.0
40.058,17,10,676,5,460,10013.0,104.0,64.0,5,216,10012.0,20.0,15.0
0.005,6,10,1989,5,927,1.0,659.0,659.0,5,1062,1.0,794.0,794.0
0.025,6,6,716,3,458,8.0,302.0,302.0,3,258,6.0,102.0,102.0
0.005,6,10,1689,5,839,1.0,571.0,571.0,5,850,1.0,582.0,582.0
0.009,6,13,3735,7,497,1.0,125.0,125.0,6,3238,1.0,1470.0,1459.0
0.005,6,10,1779,5,928,1.0,660.0,660.0,5,851,1.0,583.0,583.0
0.007,6,12,1698,6,863,1.0,327.0,271.0,6,835,1.0,515.0,515.0
0.022,6,10,1990,5,911,5.0,643.0,643.0,5,1079,5.0,811.0,811.0
0.015,6,10,1990,5,911,3.0,643.0,643.0,5,1079,3.0,811.0,811.0
300.986,6,47,19436,25,13529,12541.0,4080.0,1388.0,22,5907,419.0,2667.0,385.0
0.004,6,10,2007,5,928,1.0,660.0,660.0,5,1079,1.0,811.0,811.0
0.079,6,10,1506,5,395,16.0,127.0,127.0,5,1111,16.0,843.0,843.0
0.004,6,10,1989,5,927,1.0,659.0,659.0,5,1062,1.0,794.0,794.0
0.005,6,10,1854,5,889,1.0,621.0,621.0,5,965,1.0,697.0,697.0
0.005,6,10,1689,5,839,1.0,571.0,571.0,5,850,1.0,582.0,582.0
0.008,6,10,1989,5,910,1.0,642.0,642.0,5,1079,2.0,811.0,811.0
0.001,17,2,180,1,66,0.0,38.0,38.0,1,114,0.0,86.0,86.0
0.005,17,2,214,1,75,0.0,47.0,47.0,1,139,0.0,111.0,111.0
0.003,17,2,148,1,60,0.0,32.0,32.0,1,88,0.0,60.0,60.0
11.175,17,28,4422,14,1994,846.0,269.0,114.0,14,2428,846.0,587.0,145.0
0.005,17,2,170,1,65,0.0,37.0,37.0,1,105,0.0,77.0,77.0
0.007,6,10,1972,5,910,1.0,642.0,642.0,5,1062,1.0,794.0,794.0
0.1,6,10,1506,5,395,20.0,127.0,127.0,5,1111,21.0,843.0,843.0
0.004,17,4,284,2,120,0.0,32.0,32.0,2,164,1.0,60.0,54.0
0.004,6,10,2000,5,927,1.0,659.0,659.0,5,1073,1.0,805.0,805.0
0.075,6,10,1506,5,395,14.0,127.0,127.0,5,1111,17.0,843.0,843.0
0.017,6,10,1989,5,910,4.0,642.0,642.0,5,1079,4.0,811.0,811.0
10.968,17,28,4424,14,1995,834.0,270.0,114.0,14,2429,834.0,588.0,145.0
243.091,6,21,6492,12,1402,22099.0,253.0,195.0,9,5090,30385.0,1402.0,769.0
0.005,6,10,1989,5,927,1.0,659.0,659.0,5,1062,1.0,794.0,794.0
0.003,17,2,148,1,60,0.0,32.0,32.0,1,88,0.0,60.0,60.0
0.009,6,12,1926,6,1189,1.0,659.0,434.0,6,737,1.0,417.0,417.0
10.819,17,28,4422,14,1995,823.0,270.0,114.0,14,2427,823.0,586.0,145.0
0.084,6,10,1506,5,395,17.0,127.0,127.0,5,1111,19.0,843.0,843.0
0.091,6,10,1506,5,395,19.0,127.0,127.0,5,1111,18.0,843.0,843.0
300.388,6,16,2170,9,684,37528.0,146.0,146.0,7,1486,50036.0,419.0,398.0
0.004,17,2,136,1,60,0.0,32.0,32.0,1,76,0.0,48.0,48.0
0.005,6,10,1774,5,923,1.0,655.0,655.0,5,851,1.0,583.0,583.0
0.006,6,10,1547,5,764,1.0,496.0,496.0,5,783,1.0,515.0,515.0
0.009,6,10,1989,5,910,2.0,642.0,642.0,5,1079,2.0,811.0,811.0
290.282,6,408,348622,202,22044,1444.0,2736.0,888.0,206,326578,1415.0,2804.0,1645.0
0.005,6,10,1779,5,928,1.0,660.0,660.0,5,851,1.0,583.0,583.0
0.008,6,14,3787,7,497,1.0,125.0,125.0,7,3290,1.0,1448.0,972.0
0.014,6,13,3735,7,497,2.0,125.0,125.0,6,3238,2.0,1470.0,1459.0
1786.507,6,260,34054,102,21925,17688.0,2720.0,217.0,158,12129,11378.0,1062.0,79.0
0.127,6,10,1506,5,395,25.0,127.0,127.0,5,1111,27.0,843.0,843.0
308.485,17,20,1124,10,716,34261.0,48.0,43.0,10,408,34261.0,20.0,12.0
5.081,58,2,128,1,64,0.0,16.0,16.0,1,64,0.0,16.0,16.0
0.004,6,10,2007,5,928,1.0,660.0,660.0,5,1079,1.0,811.0,811.0
0.004,6,10,2006,5,927,1.0,659.0,659.0,5,1079,1.0,811.0,811.0
36.096,6,37,12553,18,6995,524.0,2720.0,1248.0,19,5558,1995.0,2667.0,435.0
0.009,6,10,1989,5,910,2.0,642.0,642.0,5,1079,2.0,811.0,811.0
1447.126,6,176,12054,66,5124,22263.0,46.0,46.0,110,6930,13275.0,46.0,46.0
0.004,6,10,1702,5,863,1.0,595.0,595.0,5,839,0.0,571.0,571.0
0.005,6,10,2006,5,927,1.0,659.0,659.0,5,1079,1.0,811.0,811.0
0.006,17,2,179,1,71,0.0,43.0,43.0,1,108,0.0,80.0,80.0
0.039,6,20,9974,11,704,3.0,124.0,124.0,9,9270,4.0,2896.0,1758.0
0.063,6,10,1506,5,395,14.0,127.0,127.0,5,1111,13.0,843.0,843.0
0.011,6,10,1990,5,911,2.0,643.0,643.0,5,1079,2.0,811.0,811.0
0.018,17,2,152,1,56,0.0,28.0,28.0,1,96,0.0,68.0,68.0
0.005,6,10,1989,5,927,1.0,659.0,659.0,5,1062,1.0,794.0,794.0
0.013,6,10,1631,5,848,3.0,580.0,580.0,5,783,3.0,515.0,515.0
0.009,6,10,1972,5,910,2.0,642.0,642.0,5,1062,2.0,794.0,794.0
292.369,6,393,352397,193,21606,1522.0,2736.0,889.0,200,330791,1469.0,2804.0,1722.0
0.006,6,10,1689,5,839,1.0,571.0,571.0,5,850,1.0,582.0,582.0
0.005,6,10,1989,5,927,1.0,659.0,659.0,5,1062,1.0,794.0,794.0
0.216,6,11,1837,6,1346,43.0,519.0,519.0,5,491,52.0,223.0,223.0
0.004,6,13,3747,7,509,0.0,137.0,137.0,6,3238,0.0,1470.0,1459.0
0.011,6,10,1989,5,910,2.0,642.0,642.0,5,1079,2.0,811.0,811.0
0.014,6,10,1989,5,910,3.0,642.0,642.0,5,1079,3.0,811.0,811.0
0.008,6,10,2006,5,927,2.0,659.0,659.0,5,1079,1.0,811.0,811.0
0.026,6,10,1972,5,910,6.0,642.0,642.0,5,1062,6.0,794.0,794.0
0.059,6,10,1506,5,395,12.0,127.0,127.0,5,1111,14.0,843.0,843.0
0.004,6,10,2006,5,927,1.0,659.0,659.0,5,1079,1.0,811.0,811.0
0.01,6,10,1989,5,910,2.0,642.0,642.0,5,1079,2.0,811.0,811.0
0.012,6,14,3787,7,497,1.0,125.0,125.0,7,3290,2.0,1448.0,972.0
0.013,6,10,1989,5,910,3.0,642.0,642.0,5,1079,3.0,811.0,811.0
0.043,17,2,166,1,75,0.0,47.0,47.0,1,91,0.0,63.0,63.0
40.061,17,10,676,5,460,10014.0,104.0,64.0,5,216,10014.0,20.0,15.0
10.858,17,28,4418,14,1994,826.0,269.0,114.0,14,2424,826.0,587.0,145.0
373.578,6,22,2313,16,867,24905.0,195.0,195.0,6,1446,4634.0,419.0,398.0
0.011,6,10,1972,5,910,2.0,642.0,642.0,5,1062,2.0,794.0,794.0
170.025,17,82,11560,41,2728,4250.0,44.0,38.0,41,8832,4250.0,261.0,187.0
0.006,6,10,1547,5,764,1.0,496.0,496.0,5,783,1.0,515.0,515.0
0.004,17,2,168,1,76,0.0,48.0,48.0,1,92,0.0,64.0,64.0
0.108,6,10,1506,5,395,25.0,127.0,127.0,5,1111,25.0,843.0,843.0
0.01,6,10,1983,5,910,2.0,642.0,642.0,5,1073,2.0,805.0,805.0
0.095,6,10,1506,5,395,23.0,127.0,127.0,5,1111,19.0,843.0,843.0
40.06,17,10,676,5,460,10014.0,104.0,64.0,5,216,10014.0,20.0,15.0
0.127,6,10,1506,5,395,29.0,127.0,127.0,5,1111,25.0,843.0,843.0
0.005,6,10,2006,5,927,1.0,659.0,659.0,5,1079,1.0,811.0,811.0
0.004,6,10,2000,5,927,1.0,659.0,659.0,5,1073,1.0,805.0,805.0
0.009,6,10,1989,5,910,2.0,642.0,642.0,5,1079,2.0,811.0,811.0
0.012,6,10,1972,5,910,3.0,642.0,642.0,5,1062,3.0,794.0,794.0
0.005,6,10,2007,5,928,1.0,660.0,660.0,5,1079,1.0,811.0,811.0
0.015,6,10,1983,5,910,3.0,642.0,642.0,5,1073,3.0,805.0,805.0
0.015,6,10,1990,5,911,3.0,643.0,643.0,5,1079,3.0,811.0,811.0
0.005,6,10,2006,5,927,1.0,659.0,659.0,5,1079,1.0,811.0,811.0
0.005,6,10,2007,5,928,1.0,660.0,660.0,5,1079,1.0,811.0,811.0
0.003,17,4,284,2,120,0.0,32.0,32.0,2,164,0.0,60.0,54.0
0.072,17,2,412,1,61,0.0,33.0,33.0,1,351,0.0,323.0,323.0
0.015,6,10,1983,5,910,3.0,642.0,642.0,5,1073,3.0,805.0,805.0
0.009,6,12,1926,6,1189,1.0,659.0,434.0,6,737,1.0,417.0,417.0
240.161,6,16,4481,9,963,30020.0,238.0,166.0,7,3518,40021.0,1402.0,786.0
0.029,6,13,3913,7,495,4.0,123.0,123.0,6,3418,5.0,1650.0,1549.0
0.005,17,2,180,1,66,0.0,38.0,38.0,1,114,0.0,86.0,86.0
0.005,17,2,144,1,64,0.0,36.0,36.0,1,80,0.0,52.0,52.0
0.003,17,2,136,1,60,0.0,32.0,32.0,1,76,0.0,48.0,48.0
373.774,6,22,2313,16,867,24918.0,195.0,195.0,6,1446,4636.0,419.0,398.0
0.006,6,10,1547,5,764,1.0,496.0,496.0,5,783,1.0,515.0,515.0
0.025,6,10,1762,5,911,6.0,643.0,643.0,5,851,6.0,583.0,583.0
0.09,6,10,1506,5,395,19.0,127.0,127.0,5,1111,16.0,843.0,843.0
0.08,6,10,1506,5,395,16.0,127.0,127.0,5,1111,19.0,843.0,843.0
10.931,17,28,4422,14,1994,832.0,269.0,114.0,14,2428,831.0,587.0,145.0
240.096,6,32,9072,16,6637,16006.0,1515.0,580.0,16,2435,16006.0,580.0,199.0
0.005,17,2,170,1,65,0.0,37.0,37.0,1,105,0.0,77.0,77.0
0.005,6,10,1779,5,928,1.0,660.0,660.0,5,851,1.0,583.0,583.0
0.039,17,2,148,1,60,0.0,32.0,32.0,1,88,0.0,60.0,60.0
0.004,17,2,144,1,64,0.0,36.0,36.0,1,80,0.0,52.0,52.0
0.079,6,10,1506,5,395,18.0,127.0,127.0,5,1111,18.0,843.0,843.0
0.011,6,10,1989,5,910,2.0,642.0,642.0,5,1079,2.0,811.0,811.0
1727.955,6,49,3032,32,1875,55740.0,35.0,35.0,17,1157,107972.0,31.0,31.0
0.001,17,2,180,1,66,0.0,38.0,38.0,1,114,0.0,86.0,86.0
0.091,6,10,1506,5,395,22.0,127.0,127.0,5,1111,21.0,843.0,843.0
0.004,6,10,1702,5,863,1.0,595.0,595.0,5,839,1.0,571.0,571.0
0.081,6,10,1506,5,395,18.0,127.0,127.0,5,1111,17.0,843.0,843.0
0.013,6,10,1989,5,910,3.0,642.0,642.0,5,1079,3.0,811.0,811.0
0.084,6,10,1506,5,395,18.0,127.0,127.0,5,1111,19.0,843.0,843.0
0.093,6,10,1506,5,395,19.0,127.0,127.0,5,1111,21.0,843.0,843.0
1787.015,6,150,19350,90,13740,20078.0,302.0,302.0,60,5610,30288.0,83.0,83.0
0.005,6,10,1689,5,839,1.0,571.0,571.0,5,850,1.0,582.0,582.0
0.013,6,10,1990,5,911,3.0,643.0,643.0,5,1079,3.0,811.0,811.0
0.136,6,10,1506,5,395,33.0,127.0,127.0,5,1111,28.0,843.0,843.0
0.004,6,10,1702,5,863,1.0,595.0,595.0,5,839,1.0,571.0,571.0
11.188,17,28,4422,14,1994,848.0,269.0,114.0,14,2428,848.0,587.0,145.0
0.299,17,36,19894,21,17035,14.0,1350.0,783.0,15,2859,14.0,1350.0,162.0
0.006,6,10,2007,5,928,1.0,660.0,660.0,5,1079,1.0,811.0,811.0
173.035,17,70,10007,35,2330,5089.0,44.0,38.0,35,7677,5089.0,239.0,191.0
0.095,6,10,1506,5,395,18.0,127.0,127.0,5,1111,20.0,843.0,843.0
0.009,6,10,1989,5,910,2.0,642.0,642.0,5,1079,2.0,811.0,811.0
104.251,6,22,7437,11,1305,125.0,530.0,277.0,11,6132,10406.0,2720.0,946.0
0.005,6,10,2006,5,927,1.0,659.0,659.0,5,1079,1.0,811.0,811.0
0.072,6,10,1506,5,395,16.0,127.0,127.0,5,1111,16.0,843.0,843.0
0.093,6,10,1506,5,395,20.0,127.0,127.0,5,1111,21.0,843.0,843.0
0.038,17,2,182,1,65,0.0,37.0,37.0,1,117,0.0,89.0,89.0
300.831,6,39,13064,21,7546,15041.0,2720.0,1112.0,18,5518,507.0,2667.0,435.0
0.111,6,10,1506,5,395,27.0,127.0,127.0,5,1111,26.0,843.0,843.0
0.012,6,10,1972,5,910,3.0,642.0,642.0,5,1062,3.0,794.0,794.0
0.006,6,10,1854,5,889,1.0,621.0,621.0,5,965,1.0,697.0,697.0
0.073,6,10,1506,5,395,15.0,127.0,127.0,5,1111,15.0,843.0,843.0
0.008,6,10,1983,5,910,2.0,642.0,642.0,5,1073,2.0,805.0,805.0
0.005,6,10,2000,5,927,1.0,659.0,659.0,5,1073,1.0,805.0,805.0
240.16,6,33,9369,18,7085,14127.0,2054.0,683.0,15,2284,17154.0,580.0,187.0
0.01,6,10,1983,5,910,2.0,642.0,642.0,5,1073,2.0,805.0,805.0
0.004,6,10,1779,5,928,1.0,660.0,660.0,5,851,1.0,583.0,583.0
10.893,17,28,4417,14,1994,829.0,269.0,114.0,14,2423,829.0,586.0,145.0
15.071,17,15,9238,8,6902,2149.0,1350.0,834.0,7,2336,2507.0,1350.0,305.0
40.085,17,10,676,5,460,10020.0,104.0,64.0,5,216,10020.0,20.0,15.0
0.22,6,16,2670,8,1396,31.0,533.0,324.0,8,1274,20.0,529.0,212.0
0.006,6,10,1854,5,889,1.0,621.0,621.0,5,965,1.0,697.0,697.0
0.005,6,10,1643,5,860,1.0,592.0,592.0,5,783,1.0,515.0,515.0
9.036,17,6,376,5,280,2259.0,28.0,28.0,1,96,0.0,68.0,68.0
1770.831,6,81,4266,41,2159,44269.0,27.0,27.0,40,2107,45404.0,27.0,27.0
0.001,17,2,180,1,66,0.0,38.0,38.0,1,114,0.0,86.0,86.0
0.006,6,10,1547,5,764,1.0,496.0,496.0,5,783,1.0,515.0,515.0
0.012,6,10,1983,5,910,3.0,642.0,642.0,5,1073,2.0,805.0,805.0
0.005,6,10,2006,5,927,1.0,659.0,659.0,5,1079,1.0,811.0,811.0
0.01,6,10,1762,5,911,2.0,643.0,643.0,5,851,2.0,583.0,583.0
40.087,17,10,676,5,460,10019.0,104.0,64.0,5,216,10020.0,20.0,15.0
0.017,6,10,1972,5,910,4.0,642.0,642.0,5,1062,4.0,794.0,794.0
242.194,6,305,343959,122,17858,2001.0,2692.0,959.0,183,326101,1330.0,2804.0,1829.0
0.017,6,10,1677,5,827,4.0,559.0,559.0,5,850,4.0,582.0,582.0
0.004,6,10,1774,5,923,1.0,655.0,655.0,5,851,1.0,583.0,583.0
0.017,6,10,1989,5,910,4.0,642.0,642.0,5,1079,4.0,811.0,811.0
0.004,6,10,2006,5,927,1.0,659.0,659.0,5,1079,1.0,811.0,811.0
0.004,6,10,2006,5,927,1.0,659.0,659.0,5,1079,1.0,811.0,811.0
0.005,6,10,2006,5,927,1.0,659.0,659.0,5,1079,1.0,811.0,811.0
0.008,6,10,2007,5,928,1.0,660.0,660.0,5,1079,1.0,811.0,811.0
0.005,6,10,2007,5,928,1.0,660.0,660.0,5,1079,1.0,811.0,811.0
0.005,17,2,164,1,74,0.0,46.0,46.0,1,90,0.0,62.0,62.0
352.004,6,20,2210,6,1308,12003.0,494.0,494.0,14,902,27077.0,83.0,83.0
0.005,17,2,175,1,65,0.0,37.0,37.0,1,110,0.0,82.0,82.0
0.012,6,10,2006,5,927,3.0,659.0,659.0,5,1079,3.0,811.0,811.0
0.005,6,10,1989,5,927,1.0,659.0,659.0,5,1062,1.0,794.0,794.0
0.015,6,10,1990,5,911,3.0,643.0,643.0,5,1079,3.0,811.0,811.0
0.039,17,2,182,1,65,0.0,37.0,37.0,1,117,0.0,89.0,89.0
0.003,17,2,148,1,60,0.0,32.0,32.0,1,88,0.0,60.0,60.0
0.011,6,10,1989,5,910,2.0,642.0,642.0,5,1079,2.0,811.0,811.0
0.064,6,10,1506,5,395,15.0,127.0,127.0,5,1111,14.0,843.0,843.0
0.0,17,2,180,1,66,0.0,38.0,38.0,1,114,0.0,86.0,86.0
40.058,17,10,676,5,460,10013.0,104.0,64.0,5,216,10013.0,20.0,15.0
0.127,17,2,182,1,65,0.0,37.0,37.0,1,117,0.0,89.0,89.0
303.967,6,43,10954,21,4769,15198.0,967.0,609.0,22,6185,14474.0,1162.0,360.0
0.008,6,12,1926,6,1189,1.0,659.0,434.0,6,737,1.0,417.0,417.0
0.005,6,10,1689,5,839,1.0,571.0,571.0,5,850,1.0,582.0,582.0
0.008,6,10,1989,5,910,2.0,642.0,642.0,5,1079,2.0,811.0,811.0
0.006,6,10,1689,5,839,1.0,571.0,571.0,5,850,1.0,582.0,582.0
0.005,6,10,2000,5,927,1.0,659.0,659.0,5,1073,1.0,805.0,805.0
0.125,6,10,1506,5,395,27.0,127.0,127.0,5,1111,25.0,843.0,843.0
40.065,17,10,676,5,460,10014.0,104.0,64.0,5,216,10015.0,20.0,15.0
0.013,6,10,1972,5,910,3.0,642.0,642.0,5,1062,3.0,794.0,794.0
0.069,6,10,1506,5,395,14.0,127.0,127.0,5,1111,16.0,843.0,843.0
0.004,17,4,284,2,120,0.0,32.0,32.0,2,164,1.0,60.0,54.0
0.006,6,10,2006,5,927,1.0,659.0,659.0,5,1079,1.0,811.0,811.0
0.007,17,2,179,1,71,0.0,43.0,43.0,1,108,0.0,80.0,80.0
0.005,6,10,1989,5,927,1.0,659.0,659.0,5,1062,1.0,794.0,794.0
0.003,17,2,185,1,73,0.0,45.0,45.0,1,112,0.0,84.0,84.0
0.02,17,2,236,1,64,0.0,36.0,36.0,1,172,0.0,144.0,144.0
0.114,6,10,1506,5,395,18.0,127.0,127.0,5,1111,27.0,843.0,843.0
0.005,6,10,2006,5,927,1.0,659.0,659.0,5,1079,1.0,811.0,811.0
0.081,6,10,1506,5,395,18.0,127.0,127.0,5,1111,17.0,843.0,843.0
15.078,17,15,8273,8,6244,2149.0,1350.0,752.0,7,2029,2507.0,1350.0,261.0
0.141,6,10,1506,5,395,33.0,127.0,127.0,5,1111,33.0,843.0,843.0
40.072,17,10,676,5,460,10017.0,104.0,64.0,5,216,10017.0,20.0,15.0
0.005,6,10,2006,5,927,1.0,659.0,659.0,5,1079,1.0,811.0,811.0
0.006,6,10,1547,5,764,1.0,496.0,496.0,5,783,1.0,515.0,515.0
0.013,6,10,1972,5,910,3.0,642.0,642.0,5,1062,3.0,794.0,794.0
0.008,6,10,1989,5,910,2.0,642.0,642.0,5,1079,2.0,811.0,811.0
0.004,17,2,148,1,60,0.0,32.0,32.0,1,88,0.0,60.0,60.0
0.016,6,10,1983,5,910,4.0,642.0,642.0,5,1073,4.0,805.0,805.0
0.01,6,10,1972,5,910,2.0,642.0,642.0,5,1062,2.0,794.0,794.0
40.069,17,10,676,5,460,10015.0,104.0,64.0,5,216,10016.0,20.0,15.0
0.078,6,10,1506,5,395,18.0,127.0,127.0,5,1111,16.0,843.0,843.0
0.025,6,10,1990,5,911,6.0,643.0,643.0,5,1079,6.0,811.0,811.0
0.16,6,10,1506,5,395,38.0,127.0,127.0,5,1111,26.0,843.0,843.0
0.013,6,10,1989,5,910,3.0,642.0,642.0,5,1079,3.0,811.0,811.0
0.072,17,4,284,2,120,1.0,32.0,32.0,2,164,68.0,60.0,54.0
0.087,6,10,1506,5,395,18.0,127.0,127.0,5,1111,19.0,843.0,843.0
0.071,6,10,1506,5,395,17.0,127.0,127.0,5,1111,15.0,843.0,843.0
0.014,6,10,1983,5,910,3.0,642.0,642.0,5,1073,3.0,805.0,805.0
0.085,6,10,1506,5,395,19.0,127.0,127.0,5,1111,19.0,843.0,843.0
0.095,6,10,1506,5,395,21.0,127.0,127.0,5,1111,21.0,843.0,843.0
0.003,17,4,284,2,120,0.0,32.0,32.0,2,164,0.0,60.0,54.0
0.015,6,10,1983,5,910,3.0,642.0,642.0,5,1073,3.0,805.0,805.0
0.01,6,10,1989,5,910,2.0,642.0,642.0,5,1079,2.0,811.0,811.0
0.012,6,10,1972,5,910,2.0,642.0,642.0,5,1062,3.0,794.0,794.0
0.01,6,10,1989,5,910,2.0,642.0,642.0,5,1079,2.0,811.0,811.0
2.101,6,20,3435,12,1604,191.0,590.0,239.0,8,1831,299.0,615.0,351.0
0.044,6,10,1990,5,911,10.0,643.0,643.0,5,1079,11.0,811.0,811.0
0.005,6,10,2006,5,927,1.0,659.0,659.0,5,1079,1.0,811.0,811.0
0.056,17,2,179,1,71,0.0,43.0,43.0,1,108,0.0,80.0,80.0
0.068,17,8,3613,4,1874,22.0,1350.0,440.0,4,1739,11.0,1350.0,406.0
0.005,6,10,1989,5,927,1.0,659.0,659.0,5,1062,1.0,794.0,794.0
0.012,6,10,1631,5,848,2.0,580.0,580.0,5,783,3.0,515.0,515.0
0.021,6,10,1990,5,911,5.0,643.0,643.0,5,1079,5.0,811.0,811.0
0.006,6,10,1643,5,860,1.0,592.0,592.0,5,783,1.0,515.0,515.0
0.004,17,2,148,1,60,0.0,32.0,32.0,1,88,0.0,60.0,60.0
0.014,17,2,138,1,61,0.0,33.0,33.0,1,77,0.0,49.0,49.0
0.005,6,10,1547,5,764,1.0,496.0,496.0,5,783,1.0,515.0,515.0
0.013,6,10,1989,5,910,3.0,642.0,642.0,5,1079,3.0,811.0,811.0
0.012,6,10,1989,5,910,3.0,642.0,642.0,5,1079,3.0,811.0,811.0
0.101,6,10,1506,5,395,21.0,127.0,127.0,5,1111,23.0,843.0,843.0
0.083,6,10,1506,5,395,19.0,127.0,127.0,5,1111,15.0,843.0,843.0
0.005,6,10,2006,5,927,1.0,659.0,659.0,5,1079,1.0,811.0,811.0
0.087,6,10,1506,5,395,18.0,127.0,127.0,5,1111,20.0,843.0,843.0
0.069,6,10,1506,5,395,15.0,127.0,127.0,5,1111,15.0,843.0,843.0
0.061,6,10,1989,5,910,15.0,642.0,642.0,5,1079,15.0,811.0,811.0
0.005,6,10,2007,5,928,1.0,660.0,660.0,5,1079,1.0,811.0,811.0
0.057,6,10,1506,5,395,13.0,127.0,127.0,5,1111,12.0,843.0,843.0
0.088,6,10,1506,5,395,19.0,127.0,127.0,5,1111,20.0,843.0,843.0
0.005,6,10,2006,5,927,1.0,659.0,659.0,5,1079,1.0,811.0,811.0
15.074,17,15,8146,8,6081,2149.0,1350.0,732.0,7,2065,2507.0,1350.0,267.0
0.006,17,2,213,1,69,0.0,41.0,41.0,1,144,0.0,116.0,116.0
0.005,6,10,1689,5,839,1.0,571.0,571.0,5,850,1.0,582.0,582.0
0.093,6,10,1506,5,395,20.0,127.0,127.0,5,1111,20.0,843.0,843.0
0.012,6,10,1972,5,910,3.0,642.0,642.0,5,1062,3.0,794.0,794.0
0.11,6,10,1506,5,395,24.0,127.0,127.0,5,1111,24.0,843.0,843.0
0.011,6,10,1990,5,911,2.0,643.0,643.0,5,1079,2.0,811.0,811.0
0.005,6,10,2006,5,927,1.0,659.0,659.0,5,1079,1.0,811.0,811.0
40.087,17,10,676,5,460,10018.0,104.0,64.0,5,216,10021.0,20.0,15.0
0.073,6,10,1506,5,395,17.0,127.0,127.0,5,1111,13.0,843.0,843.0
0.012,6,10,1972,5,910,2.0,642.0,642.0,5,1062,3.0,794.0,794.0
0.149,6,10,1506,5,395,33.0,127.0,127.0,5,1111,35.0,843.0,843.0
0.005,17,2,178,1,81,0.0,53.0,53.0,1,97,0.0,69.0,69.0
0.006,6,10,1989,5,927,1.0,659.0,659.0,5,1062,1.0,794.0,794.0
60.926,6,25,17423,14,9539,4686.0,2804.0,1469.0,11,7884,6079.0,2307.0,1217.0
0.005,6,10,1989,5,927,1.0,659.0,659.0,5,1062,1.0,794.0,794.0
0.007,6,10,1547,5,764,1.0,496.0,496.0,5,783,1.0,515.0,515.0
40.061,17,10,676,5,460,10013.0,104.0,64.0,5,216,10014.0,20.0,15.0
0.143,6,10,1506,5,395,32.0,127.0,127.0,5,1111,30.0,843.0,843.0
0.016,6,10,1972,5,910,3.0,642.0,642.0,5,1062,4.0,794.0,794.0
0.005,6,13,3747,7,509,0.0,137.0,137.0,6,3238,1.0,1470.0,1459.0
0.057,6,10,1506,5,395,14.0,127.0,127.0,5,1111,13.0,843.0,843.0
0.004,6,10,1702,5,863,1.0,595.0,595.0,5,839,1.0,571.0,571.0
0.018,6,10,1972,5,910,4.0,642.0,642.0,5,1062,4.0,794.0,794.0
0.001,17,2,180,1,65,0.0,37.0,37.0,1,115,0.0,87.0,87.0
0.076,6,10,1506,5,395,16.0,127.0,127.0,5,1111,14.0,843.0,843.0
0.006,6,10,1547,5,764,1.0,496.0,496.0,5,783,1.0,515.0,515.0
0.016,6,10,1989,5,910,4.0,642.0,642.0,5,1079,3.0,811.0,811.0
0.017,6,10,1989,5,910,4.0,642.0,642.0,5,1079,4.0,811.0,811.0
0.001,17,2,180,1,65,0.0,37.0,37.0,1,115,0.0,87.0,87.0
0.004,17,2,148,1,60,0.0,32.0,32.0,1,88,0.0,60.0,60.0
0.004,17,2,136,1,60,0.0,32.0,32.0,1,76,0.0,48.0,48.0
0.113,6,10,1506,5,395,25.0,127.0,127.0,5,1111,19.0,843.0,843.0
0.005,17,2,180,1,58,0.0,30.0,30.0,1,122,0.0,94.0,94.0
0.037,17,2,148,1,60,0.0,32.0,32.0,1,88,0.0,60.0,60.0
353.234,6,20,2210,6,1308,12004.0,494.0,494.0,14,902,27171.0,83.0,83.0
0.011,6,10,1972,5,910,2.0,642.0,642.0,5,1062,2.0,794.0,794.0
0.079,6,10,1506,5,395,16.0,127.0,127.0,5,1111,16.0,843.0,843.0
0.083,6,10,1506,5,395,19.0,127.0,127.0,5,1111,19.0,843.0,843.0
0.018,6,10,1983,5,910,4.0,642.0,642.0,5,1073,4.0,805.0,805.0
0.017,6,10,1990,5,911,4.0,643.0,643.0,5,1079,4.0,811.0,811.0
0.015,6,10,1990,5,911,3.0,643.0,643.0,5,1079,3.0,811.0,811.0
0.015,6,10,1989,5,910,3.0,642.0,642.0,5,1079,3.0,811.0,811.0
0.147,6,10,1506,5,395,34.0,127.0,127.0,5,1111,25.0,843.0,843.0
61.269,6,27,19730,15,11786,4376.0,2804.0,1572.0,12,7944,5557.0,2315.0,1218.0
0.014,6,10,1990,5,911,3.0,643.0,643.0,5,1079,3.0,811.0,811.0
300.83,6,36,9226,19,3748,16712.0,1360.0,591.0,17,5478,539.0,2667.0,435.0
0.02,6,10,1983,5,910,5.0,642.0,642.0,5,1073,5.0,805.0,805.0
0.084,6,10,1506,5,395,17.0,127.0,127.0,5,1111,17.0,843.0,843.0
289.521,6,401,348037,194,21653,1500.0,2736.0,825.0,207,326384,1405.0,2804.0,1635.0
0.037,17,2,148,1,60,0.0,32.0,32.0,1,88,0.0,60.0,60.0
0.005,6,10,2000,5,927,1.0,659.0,659.0,5,1073,1.0,805.0,805.0
0.069,17,8,3613,4,1874,23.0,1350.0,440.0,4,1739,11.0,1350.0,406.0
40.042,17,10,676,5,460,10009.0,104.0,64.0,5,216,10009.0,20.0,15.0
0.004,17,2,148,1,60,0.0,32.0,32.0,1,88,0.0,60.0,60.0
240.024,6,9,787,5,488,60006.0,232.0,232.0,4,299,80007.0,83.0,83.0
15.081,17,16,9190,8,6907,2150.0,1350.0,835.0,8,2283,2150.0,1350.0,257.0
0.005,6,10,1643,5,860,1.0,592.0,592.0,5,783,1.0,515.0,515.0
0.114,6,10,1506,5,395,21.0,127.0,127.0,5,1111,27.0,843.0,843.0
0.005,6,10,1547,5,764,1.0,496.0,496.0,5,783,1.0,515.0,515.0
0.072,17,4,284,2,120,0.0,32.0,32.0,2,164,35.0,60.0,54.0
0.054,6,10,1506,5,395,12.0,127.0,127.0,5,1111,12.0,843.0,843.0
0.003,17,2,136,1,60,0.0,32.0,32.0,1,76,0.0,48.0,48.0
0.005,17,2,152,1,76,0.0,48.0,48.0,1,76,0.0,48.0,48.0
0.014,6,10,1990,5,911,3.0,643.0,643.0,5,1079,3.0,811.0,811.0
0.007,6,10,1702,5,863,1.0,595.0,595.0,5,839,1.0,571.0,571.0
0.02,6,10,1677,5,827,4.0,559.0,559.0,5,850,5.0,582.0,582.0
0.003,17,2,148,1,60,0.0,32.0,32.0,1,88,0.0,60.0,60.0
0.006,6,10,1854,5,889,1.0,621.0,621.0,5,965,1.0,697.0,697.0
0.001,17,2,166,1,75,0.0,47.0,47.0,1,91,0.0,63.0,63.0
0.017,6,7,768,3,458,7.0,302.0,302.0,4,310,3.0,102.0,102.0
0.013,6,10,1990,5,911,3.0,643.0,643.0,5,1079,3.0,811.0,811.0
0.005,6,10,2000,5,927,1.0,659.0,659.0,5,1073,1.0,805.0,805.0
0.019,6,10,1989,5,910,4.0,642.0,642.0,5,1079,4.0,811.0,811.0
0.013,6,10,1972,5,910,3.0,642.0,642.0,5,1062,3.0,794.0,794.0
0.006,6,10,2006,5,927,1.0,659.0,659.0,5,1079,1.0,811.0,811.0
120.693,6,59,19106,33,4807,3771.0,1054.0,221.0,26,14299,4827.0,1402.0,862.0
0.003,17,2,136,1,60,0.0,32.0,32.0,1,76,0.0,48.0,48.0
0.005,6,10,2006,5,927,1.0,659.0,659.0,5,1079,1.0,811.0,811.0
308.879,17,18,1008,9,640,38593.0,48.0,43.0,9,368,38592.0,20.0,12.0
0.004,17,4,284,2,120,0.0,32.0,32.0,2,164,1.0,60.0,54.0
0.013,6,10,1983,5,910,3.0,642.0,642.0,5,1073,3.0,805.0,805.0
0.005,6,10,1774,5,923,1.0,655.0,655.0,5,851,1.0,583.0,583.0
0.005,6,10,2007,5,928,1.0,660.0,660.0,5,1079,1.0,811.0,811.0
0.09,6,10,1506,5,395,18.0,127.0,127.0,5,1111,18.0,843.0,843.0
0.006,6,12,1698,6,863,1.0,327.0,271.0,6,835,1.0,515.0,515.0
0.004,6,10,2007,5,928,1.0,660.0,660.0,5,1079,1.0,811.0,811.0
0.851,6,25,5555,12,1445,65.0,267.0,136.0,13,4110,59.0,1414.0,597.0
0.01,17,4,284,2,120,2.0,32.0,32.0,2,164,1.0,60.0,54.0
10.754,17,28,4423,14,1994,818.0,269.0,114.0,14,2429,818.0,588.0,145.0
0.072,17,4,364,2,160,0.0,52.0,52.0,2,204,32.0,80.0,74.0
0.005,6,10,2000,5,927,1.0,659.0,659.0,5,1073,1.0,805.0,805.0
413.59,6,29,4409,12,3102,10914.0,494.0,494.0,17,1307,25849.0,83.0,83.0
0.019,6,10,1972,5,910,4.0,642.0,642.0,5,1062,4.0,794.0,794.0
15.076,17,16,8690,8,6530,2149.0,1350.0,788.0,8,2160,2149.0,1350.0,242.0
0.005,6,10,2006,5,927,1.0,659.0,659.0,5,1079,1.0,811.0,811.0
0.108,6,10,1506,5,395,21.0,127.0,127.0,5,1111,22.0,843.0,843.0
0.013,6,10,1631,5,848,3.0,580.0,580.0,5,783,3.0,515.0,515.0
0.007,6,10,1547,5,764,1.0,496.0,496.0,5,783,1.0,515.0,515.0
0.004,6,10,1774,5,923,1.0,655.0,655.0,5,851,1.0,583.0,583.0
0.102,6,10,1506,5,395,22.0,127.0,127.0,5,1111,23.0,843.0,843.0
0.005,6,10,2006,5,927,1.0,659.0,659.0,5,1079,1.0,811.0,811.0
0.005,6,10,1854,5,889,1.0,621.0,621.0,5,965,1.0,697.0,697.0
0.005,6,10,2006,5,927,1.0,659.0,659.0,5,1079,1.0,811.0,811.0
0.017,6,10,1983,5,910,4.0,642.0,642.0,5,1073,4.0,805.0,805.0
0.02,6,10,1990,5,911,5.0,643.0,643.0,5,1079,5.0,811.0,811.0
0.006,6,10,1547,5,764,1.0,496.0,496.0,5,783,1.0,515.0,515.0
0.005,6,10,1854,5,889,1.0,621.0,621.0,5,965,1.0,697.0,697.0
0.008,6,10,1972,5,910,2.0,642.0,642.0,5,1062,1.0,794.0,794.0
0.098,6,10,1506,5,395,20.0,127.0,127.0,5,1111,19.0,843.0,843.0
0.082,6,10,1506,5,395,17.0,127.0,127.0,5,1111,19.0,843.0,843.0
334.355,17,20,1124,10,716,37136.0,48.0,43.0,10,408,37136.0,20.0,12.0
0.003,17,2,148,1,60,0.0,32.0,32.0,1,88,0.0,60.0,60.0
0.005,6,10,1774,5,923,1.0,655.0,655.0,5,851,1.0,583.0,583.0
0.004,6,10,2000,5,927,1.0,659.0,659.0,5,1073,1.0,805.0,805.0
0.003,17,2,185,1,73,0.0,45.0,45.0,1,112,0.0,84.0,84.0
309.417,17,20,1124,10,716,34373.0,48.0,43.0,10,408,34372.0,20.0,12.0
354.036,6,21,1795,16,1030,23602.0,190.0,190.0,5,765,60002.0,464.0,248.0
0.005,6,10,1643,5,860,1.0,592.0,592.0,5,783,1.0,515.0,515.0
40.06,17,10,676,5,460,10012.0,104.0,64.0,5,216,10014.0,20.0,15.0
0.015,6,10,1989,5,910,3.0,642.0,642.0,5,1079,3.0,811.0,811.0
0.012,6,10,1972,5,910,3.0,642.0,642.0,5,1062,2.0,794.0,794.0
0.006,6,10,1547,5,764,1.0,496.0,496.0,5,783,1.0,515.0,515.0
40.073,17,10,676,5,460,10017.0,104.0,64.0,5,216,10017.0,20.0,15.0
0.006,6,10,1547,5,764,1.0,496.0,496.0,5,783,1.0,515.0,515.0
40.08,17,10,676,5,460,10016.0,104.0,64.0,5,216,10018.0,20.0,15.0
0.167,17,2,152,1,76,0.0,48.0,48.0,1,76,0.0,48.0,48.0
0.006,17,2,164,1,74,0.0,46.0,46.0,1,90,0.0,62.0,62.0
0.028,6,10,1990,5,911,7.0,643.0,643.0,5,1079,6.0,811.0,811.0
240.389,6,28,7908,13,3589,20032.0,1211.0,726.0,15,4319,17170.0,1162.0,392.0
0.005,6,10,2006,5,927,1.0,659.0,659.0,5,1079,1.0,811.0,811.0
0.002,17,2,180,1,66,0.0,38.0,38.0,1,114,0.0,86.0,86.0
0.004,6,10,2000,5,927,1.0,659.0,659.0,5,1073,1.0,805.0,805.0
0.005,6,10,1547,5,764,1.0,496.0,496.0,5,783,1.0,515.0,515.0
0.001,17,2,180,1,66,0.0,38.0,38.0,1,114,0.0,86.0,86.0
0.004,17,2,148,1,60,0.0,32.0,32.0,1,88,0.0,60.0,60.0
0.019,6,10,1677,5,827,4.0,559.0,559.0,5,850,4.0,582.0,582.0
278.645,6,20,3797,11,2323,27863.0,676.0,348.0,9,1474,34826.0,821.0,336.0
0.016,6,10,1631,5,848,4.0,580.0,580.0,5,783,3.0,515.0,515.0
0.08,6,10,1506,5,395,18.0,127.0,127.0,5,1111,17.0,843.0,843.0
360.033,6,21,3981,13,3142,30002.0,494.0,494.0,8,839,51432.0,83.0,83.0
0.016,6,10,1631,5,848,4.0,580.0,580.0,5,783,4.0,515.0,515.0
0.004,6,10,1774,5,923,1.0,655.0,655.0,5,851,1.0,583.0,583.0
0.095,6,10,1506,5,395,21.0,127.0,127.0,5,1111,19.0,843.0,843.0
0.09,6,10,1506,5,395,20.0,127.0,127.0,5,1111,19.0,843.0,843.0
0.005,6,10,2000,5,927,1.0,659.0,659.0,5,1073,1.0,805.0,805.0
0.011,6,10,1989,5,910,2.0,642.0,642.0,5,1079,2.0,811.0,811.0
0.039,17,4,284,2,120,0.0,32.0,32.0,2,164,36.0,60.0,54.0
0.106,6,10,1506,5,395,23.0,127.0,127.0,5,1111,23.0,843.0,843.0
0.029,17,2,213,1,69,0.0,41.0,41.0,1,144,0.0,116.0,116.0
0.01,6,10,1990,5,911,2.0,643.0,643.0,5,1079,2.0,811.0,811.0
0.083,6,10,1506,5,395,15.0,127.0,127.0,5,1111,19.0,843.0,843.0
0.001,17,2,180,1,66,0.0,38.0,38.0,1,114,0.0,86.0,86.0
0.01,6,10,1983,5,910,2.0,642.0,642.0,5,1073,2.0,805.0,805.0
308.592,17,20,1124,10,716,34273.0,48.0,43.0,10,408,34273.0,20.0,12.0
0.004,6,10,2006,5,927,1.0,659.0,659.0,5,1079,1.0,811.0,811.0
0.006,6,10,1547,5,764,1.0,496.0,496.0,5,783,1.0,515.0,515.0
0.017,17,2,179,1,71,0.0,43.0,43.0,1,108,0.0,80.0,80.0
0.041,17,2,148,1,60,0.0,32.0,32.0,1,88,0.0,60.0,60.0
300.761,6,36,9557,19,4079,16708.0,1543.0,657.0,17,5478,536.0,2667.0,435.0
0.106,6,10,1506,5,395,22.0,127.0,127.0,5,1111,22.0,843.0,843.0
71.62,6,32,17795,15,9591,5115.0,2804.0,1469.0,17,8204,4468.0,2315.0,1218.0
0.116,6,10,1506,5,395,25.0,127.0,127.0,5,1111,23.0,843.0,843.0
40.064,17,10,676,5,460,10015.0,104.0,64.0,5,216,10015.0,20.0,15.0
0.005,6,10,1989,5,927,1.0,659.0,659.0,5,1062,1.0,794.0,794.0
0.001,17,2,180,1,66,0.0,38.0,38.0,1,114,0.0,86.0,86.0
0.012,6,10,1989,5,910,2.0,642.0,642.0,5,1079,2.0,811.0,811.0
0.005,6,10,2007,5,928,1.0,660.0,660.0,5,1079,1.0,811.0,811.0
368.535,6,22,2313,16,867,24569.0,195.0,195.0,6,1446,4645.0,419.0,398.0
0.005,6,10,2007,5,928,1.0,660.0,660.0,5,1079,1.0,811.0,811.0
0.005,17,2,148,1,60,0.0,32.0,32.0,1,88,0.0,60.0,60.0
0.019,6,10,1983,5,910,4.0,642.0,642.0,5,1073,4.0,805.0,805.0
0.06,6,10,1506,5,395,14.0,127.0,127.0,5,1111,13.0,843.0,843.0
0.005,6,10,1689,5,839,1.0,571.0,571.0,5,850,1.0,582.0,582.0
0.006,6,10,1762,5,911,1.0,643.0,643.0,5,851,1.0,583.0,583.0
0.005,6,10,2006,5,927,1.0,659.0,659.0,5,1079,1.0,811.0,811.0
0.007,17,2,299,1,65,0.0,37.0,37.0,1,234,0.0,206.0,206.0
0.005,6,10,2006,5,927,1.0,659.0,659.0,5,1079,1.0,811.0,811.0
0.005,6,10,2007,5,928,1.0,660.0,660.0,5,1079,1.0,811.0,811.0
0.003,17,4,284,2,120,0.0,32.0,32.0,2,164,0.0,60.0,54.0
0.006,6,10,1689,5,839,1.0,571.0,571.0,5,850,1.0,582.0,582.0
0.007,17,2,179,1,71,0.0,43.0,43.0,1,108,0.0,80.0,80.0
0.011,6,10,1989,5,910,2.0,642.0,642.0,5,1079,2.0,811.0,811.0
0.006,17,2,164,1,74,0.0,46.0,46.0,1,90,0.0,62.0,62.0
0.092,6,10,1506,5,395,20.0,127.0,127.0,5,1111,22.0,843.0,843.0
0.005,6,13,3747,7,509,0.0,137.0,137.0,6,3238,1.0,1470.0,1459.0
0.009,6,10,1989,5,910,2.0,642.0,642.0,5,1079,2.0,811.0,811.0
0.005,6,14,3799,7,509,0.0,137.0,137.0,7,3290,0.0,1448.0,972.0
40.061,17,10,676,5,460,10014.0,104.0,64.0,5,216,10014.0,20.0,15.0
0.018,6,10,1972,5,910,4.0,642.0,642.0,5,1062,4.0,794.0,794.0
40.063,17,10,676,5,460,10012.0,104.0,64.0,5,216,10014.0,20.0,15.0
0.006,17,2,214,1,75,0.0,47.0,47.0,1,139,0.0,111.0,111.0
0.006,17,2,168,1,76,0.0,48.0,48.0,1,92,0.0,64.0,64.0
0.013,6,10,1972,5,910,3.0,642.0,642.0,5,1062,3.0,794.0,794.0
0.0,17,2,136,1,60,0.0,32.0,32.0,1,76,0.0,48.0,48.0
0.01,6,10,1774,5,923,2.0,655.0,655.0,5,851,2.0,583.0,583.0
0.005,6,10,2007,5,928,1.0,660.0,660.0,5,1079,1.0,811.0,811.0
0.143,6,10,1506,5,395,32.0,127.0,127.0,5,1111,34.0,843.0,843.0
0.004,6,10,1702,5,863,1.0,595.0,595.0,5,839,1.0,571.0,571.0
240.101,6,16,4481,9,963,30012.0,238.0,166.0,7,3518,40016.0,1402.0,786.0
169.28,17,72,10202,36,2405,4836.0,44.0,38.0,36,7797,4836.0,239.0,188.0
0.077,6,10,1506,5,395,17.0,127.0,127.0,5,1111,17.0,843.0,843.0
0.012,17,2,140,1,62,0.0,34.0,34.0,1,78,0.0,50.0,50.0
0.037,17,2,166,1,75,0.0,47.0,47.0,1,91,0.0,63.0,63.0
0.072,6,44,13976,24,2503,3.0,517.0,139.0,20,11473,3.0,1402.0,744.0
0.015,6,10,1990,5,911,3.0,643.0,643.0,5,1079,3.0,811.0,811.0
0.018,6,10,1631,5,848,4.0,580.0,580.0,5,783,4.0,515.0,515.0
40.063,17,10,676,5,460,10015.0,104.0,64.0,5,216,10015.0,20.0,15.0
0.009,6,10,1972,5,910,2.0,642.0,642.0,5,1062,2.0,794.0,794.0
0.812,6,25,5555,12,1445,62.0,267.0,136.0,13,4110,57.0,1414.0,597.0
0.005,6,10,2006,5,927,1.0,659.0,659.0,5,1079,1.0,811.0,811.0
0.005,6,10,2006,5,927,1.0,659.0,659.0,5,1079,1.0,811.0,811.0
0.006,6,10,1989,5,910,1.0,642.0,642.0,5,1079,1.0,811.0,811.0
0.013,6,10,1972,5,910,3.0,642.0,642.0,5,1062,3.0,794.0,794.0
0.001,17,2,154,1,69,0.0,41.0,41.0,1,85,0.0,57.0,57.0
0.004,6,10,1774,5,923,1.0,655.0,655.0,5,851,0.0,583.0,583.0
0.005,17,2,148,1,60,0.0,32.0,32.0,1,88,0.0,60.0,60.0
0.005,6,10,2007,5,928,1.0,660.0,660.0,5,1079,1.0,811.0,811.0
0.02,6,10,1990,5,911,5.0,643.0,643.0,5,1079,4.0,811.0,811.0
0.097,6,10,1506,5,395,22.0,127.0,127.0,5,1111,21.0,843.0,843.0
0.004,17,2,148,1,60,0.0,32.0,32.0,1,88,0.0,60.0,60.0
0.004,17,2,148,1,60,0.0,32.0,32.0,1,88,0.0,60.0,60.0
0.006,17,2,179,1,71,0.0,43.0,43.0,1,108,0.0,80.0,80.0
0.147,6,10,1506,5,395,28.0,127.0,127.0,5,1111,34.0,843.0,843.0
0.1,6,10,1506,5,395,18.0,127.0,127.0,5,1111,24.0,843.0,843.0
0.005,6,10,1547,5,764,1.0,496.0,496.0,5,783,1.0,515.0,515.0
0.005,6,10,2006,5,927,1.0,659.0,659.0,5,1079,1.0,811.0,811.0
0.013,6,10,1983,5,910,3.0,642.0,642.0,5,1073,3.0,805.0,805.0
0.009,6,10,1990,5,911,2.0,643.0,643.0,5,1079,2.0,811.0,811.0
0.003,17,2,148,1,60,0.0,32.0,32.0,1,88,0.0,60.0,60.0
300.052,6,12,1782,7,1348,50008.0,494.0,494.0,5,434,75012.0,83.0,83.0
0.022,6,10,1972,5,910,5.0,642.0,642.0,5,1062,5.0,794.0,794.0
0.01,6,10,1989,5,910,2.0,642.0,642.0,5,1079,2.0,811.0,811.0
9.037,17,6,376,5,280,2259.0,28.0,28.0,1,96,0.0,68.0,68.0
0.006,6,10,2006,5,927,1.0,659.0,659.0,5,1079,1.0,811.0,811.0
0.013,6,10,1762,5,911,3.0,643.0,643.0,5,851,3.0,583.0,583.0
0.001,17,2,180,1,66,0.0,38.0,38.0,1,114,0.0,86.0,86.0
0.088,6,10,1506,5,395,19.0,127.0,127.0,5,1111,19.0,843.0,843.0
0.016,17,2,169,1,62,0.0,34.0,34.0,1,107,0.0,79.0,79.0
0.01,6,10,1989,5,910,2.0,642.0,642.0,5,1079,2.0,811.0,811.0
0.008,6,10,1989,5,910,2.0,642.0,642.0,5,1079,2.0,811.0,811.0
0.005,6,13,3747,7,509,0.0,137.0,137.0,6,3238,1.0,1470.0,1459.0
0.008,6,10,1668,5,951,2.0,683.0,683.0,5,717,1.0,449.0,449.0
0.047,6,10,1983,5,910,11.0,642.0,642.0,5,1073,11.0,805.0,805.0
0.038,17,4,284,2,120,0.0,32.0,32.0,2,164,34.0,60.0,54.0
0.014,6,10,1762,5,911,3.0,643.0,643.0,5,851,3.0,583.0,583.0
0.011,6,10,1983,5,910,2.0,642.0,642.0,5,1073,2.0,805.0,805.0
0.003,17,2,136,1,60,0.0,32.0,32.0,1,76,0.0,48.0,48.0
0.01,6,10,1989,5,910,2.0,642.0,642.0,5,1079,2.0,811.0,811.0
0.022,6,10,1762,5,911,5.0,643.0,643.0,5,851,5.0,583.0,583.0
0.004,17,4,284,2,120,0.0,32.0,32.0,2,164,0.0,60.0,54.0
0.006,17,2,230,1,68,0.0,40.0,40.0,1,162,0.0,134.0,134.0
0.004,6,10,2007,5,928,1.0,660.0,660.0,5,1079,1.0,811.0,811.0
0.021,6,10,1972,5,910,5.0,642.0,642.0,5,1062,5.0,794.0,794.0
40.061,17,10,676,5,460,10014.0,104.0,64.0,5,216,10014.0,20.0,15.0
0.011,6,10,1990,5,911,2.0,643.0,643.0,5,1079,2.0,811.0,811.0
10.811,17,28,4417,14,1994,823.0,269.0,114.0,14,2423,823.0,586.0,145.0
1792.739,6,487,98813,246,87583,7316.0,421.0,368.0,241,11230,7469.0,53.0,53.0
0.024,6,10,1989,5,910,5.0,642.0,642.0,5,1079,5.0,811.0,811.0
373.985,6,22,2313,16,867,24932.0,195.0,195.0,6,1446,4637.0,419.0,398.0
0.006,17,2,164,1,74,0.0,46.0,46.0,1,90,0.0,62.0,62.0
0.114,6,10,1506,5,395,25.0,127.0,127.0,5,1111,26.0,843.0,843.0
0.005,6,10,1989,5,927,1.0,659.0,659.0,5,1062,1.0,794.0,794.0
0.015,6,10,1989,5,910,3.0,642.0,642.0,5,1079,3.0,811.0,811.0
40.089,17,10,676,5,460,10019.0,104.0,64.0,5,216,10021.0,20.0,15.0
0.004,17,2,152,1,76,0.0,48.0,48.0,1,76,0.0,48.0,48.0
168.142,17,92,13386,46,3100,3736.0,44.0,39.0,46,10286,3736.0,239.0,195.0
0.017,6,10,1677,5,827,4.0,559.0,559.0,5,850,4.0,582.0,582.0
0.011,6,10,1983,5,910,2.0,642.0,642.0,5,1073,2.0,805.0,805.0
0.006,17,2,230,1,68,0.0,40.0,40.0,1,162,0.0,134.0,134.0
0.004,17,2,179,1,71,0.0,43.0,43.0,1,108,0.0,80.0,80.0
0.109,6,10,1506,5,395,19.0,127.0,127.0,5,1111,26.0,843.0,843.0
0.005,6,10,1989,5,927,1.0,659.0,659.0,5,1062,1.0,794.0,794.0
0.006,6,10,1643,5,860,1.0,592.0,592.0,5,783,1.0,515.0,515.0
0.087,6,10,1506,5,395,20.0,127.0,127.0,5,1111,18.0,843.0,843.0
0.012,6,10,1631,5,848,3.0,580.0,580.0,5,783,3.0,515.0,515.0
0.001,17,2,180,1,66,0.0,38.0,38.0,1,114,0.0,86.0,86.0
0.073,6,10,1506,5,395,17.0,127.0,127.0,5,1111,16.0,843.0,843.0
0.004,17,2,148,1,60,0.0,32.0,32.0,1,88,0.0,60.0,60.0
0.012,6,10,1677,5,827,2.0,559.0,559.0,5,850,2.0,582.0,582.0
0.015,6,10,1989,5,910,3.0,642.0,642.0,5,1079,3.0,811.0,811.0
0.006,6,10,1774,5,923,1.0,655.0,655.0,5,851,1.0,583.0,583.0
0.007,6,10,1643,5,860,1.0,592.0,592.0,5,783,1.0,515.0,515.0
10.853,17,26,4102,13,1845,895.0,268.0,113.0,13,2257,895.0,588.0,145.0
0.012,6,10,1972,5,910,3.0,642.0,642.0,5,1062,3.0,794.0,794.0
15.081,17,15,8313,8,6187,2150.0,1350.0,745.0,7,2126,2508.0,1350.0,275.0
0.006,17,2,193,1,71,0.0,43.0,43.0,1,122,0.0,94.0,94.0
0.006,6,10,1989,5,927,1.0,659.0,659.0,5,1062,1.0,794.0,794.0
0.009,6,10,1990,5,911,2.0,643.0,643.0,5,1079,2.0,811.0,811.0
300.345,6,16,2170,9,684,37522.0,146.0,146.0,7,1486,50030.0,419.0,398.0
241.15,6,396,347739,192,21507,1262.0,2736.0,959.0,204,326232,1187.0,2804.0,1626.0
0.005,6,10,2007,5,928,1.0,660.0,660.0,5,1079,1.0,811.0,811.0
0.009,6,10,1990,5,911,2.0,643.0,643.0,5,1079,2.0,811.0,811.0
0.012,17,4,284,2,120,0.0,32.0,32.0,2,164,0.0,60.0,54.0
0.004,17,2,148,1,60,0.0,32.0,32.0,1,88,0.0,60.0,60.0
0.005,6,10,1989,5,927,1.0,659.0,659.0,5,1062,1.0,794.0,794.0
40.072,17,10,676,5,460,10017.0,104.0,64.0,5,216,10017.0,20.0,15.0
0.005,6,10,2007,5,928,1.0,660.0,660.0,5,1079,1.0,811.0,811.0
0.006,6,10,1643,5,860,1.0,592.0,592.0,5,783,1.0,515.0,515.0
0.017,6,10,1989,5,910,4.0,642.0,642.0,5,1079,4.0,811.0,811.0
0.012,6,10,1972,5,910,2.0,642.0,642.0,5,1062,2.0,794.0,794.0
0.005,6,10,1989,5,927,1.0,659.0,659.0,5,1062,1.0,794.0,794.0
0.01,6,10,1989,5,910,2.0,642.0,642.0,5,1079,2.0,811.0,811.0
0.008,6,12,1926,6,1189,1.0,659.0,434.0,6,737,1.0,417.0,417.0
0.039,6,10,1989,5,910,9.0,642.0,642.0,5,1079,9.0,811.0,811.0
0.004,6,10,2006,5,927,1.0,659.0,659.0,5,1079,1.0,811.0,811.0
0.001,17,2,180,1,66,0.0,38.0,38.0,1,114,0.0,86.0,86.0
0.005,6,10,2007,5,928,1.0,660.0,660.0,5,1079,1.0,811.0,811.0
0.009,6,10,1990,5,911,2.0,643.0,643.0,5,1079,2.0,811.0,811.0
0.012,6,10,1990,5,911,2.0,643.0,643.0,5,1079,2.0,811.0,811.0
431.681,6,38,6608,18,4896,8201.0,494.0,494.0,20,1712,22719.0,83.0,83.0
0.001,17,2,136,1,60,0.0,32.0,32.0,1,76,0.0,48.0,48.0
0.065,6,10,1506,5,395,14.0,127.0,127.0,5,1111,14.0,843.0,843.0
0.004,17,4,284,2,120,0.0,32.0,32.0,2,164,0.0,60.0,54.0
0.005,6,10,1989,5,927,1.0,659.0,659.0,5,1062,1.0,794.0,794.0
0.02,6,10,1972,5,910,5.0,642.0,642.0,5,1062,4.0,794.0,794.0
10.912,17,28,4420,14,1995,830.0,270.0,114.0,14,2425,830.0,588.0,145.0
0.012,6,10,1972,5,910,3.0,642.0,642.0,5,1062,2.0,794.0,794.0
0.008,6,12,1926,6,1189,1.0,659.0,434.0,6,737,1.0,417.0,417.0
0.005,6,14,3799,7,509,0.0,137.0,137.0,7,3290,0.0,1448.0,972.0
0.009,6,10,1989,5,910,2.0,642.0,642.0,5,1079,2.0,811.0,811.0
0.116,6,10,1506,5,395,27.0,127.0,127.0,5,1111,23.0,843.0,843.0
0.006,17,2,170,1,65,0.0,37.0,37.0,1,105,0.0,77.0,77.0
0.004,6,10,1702,5,863,0.0,595.0,595.0,5,839,1.0,571.0,571.0
0.103,6,10,1506,5,395,24.0,127.0,127.0,5,1111,23.0,843.0,843.0
1770.226,17,92,8096,46,4048,39338.0,60.0,60.0,46,4048,39338.0,60.0,60.0
0.006,6,10,1547,5,764,1.0,496.0,496.0,5,783,1.0,515.0,515.0
0.014,6,10,1990,5,911,3.0,643.0,643.0,5,1079,3.0,811.0,811.0
0.013,6,10,1631,5,848,3.0,580.0,580.0,5,783,3.0,515.0,515.0
10.821,17,28,4422,14,1994,823.0,269.0,114.0,14,2428,823.0,587.0,145.0
0.073,6,13,3735,7,497,12.0,125.0,125.0,6,3238,14.0,1470.0,1459.0
167.224,17,76,10710,38,2529,4519.0,44.0,38.0,38,8181,4519.0,239.0,187.0
9.035,17,6,376,5,280,2258.0,28.0,28.0,1,96,0.0,68.0,68.0
0.075,6,10,1506,5,395,18.0,127.0,127.0,5,1111,17.0,843.0,843.0
0.006,6,10,1643,5,860,1.0,592.0,592.0,5,783,1.0,515.0,515.0
0.01,6,10,1983,5,910,2.0,642.0,642.0,5,1073,2.0,805.0,805.0
1727.838,6,45,2790,30,1725,59580.0,35.0,35.0,15,1065,123404.0,31.0,31.0
0.012,6,13,3735,7,497,2.0,125.0,125.0,6,3238,2.0,1470.0,1459.0
0.005,6,10,2006,5,927,1.0,659.0,659.0,5,1079,1.0,811.0,811.0
0.081,6,10,1506,5,395,16.0,127.0,127.0,5,1111,19.0,843.0,843.0
49.002,6,49,20496,25,14509,383.0,2720.0,1347.0,24,5987,2123.0,2667.0,385.0
0.01,6,10,1677,5,827,2.0,559.0,559.0,5,850,2.0,582.0,582.0
0.053,17,2,152,1,76,0.0,48.0,48.0,1,76,0.0,48.0,48.0
0.008,6,10,1972,5,910,2.0,642.0,642.0,5,1062,2.0,794.0,794.0
0.008,6,10,1547,5,764,2.0,496.0,496.0,5,783,2.0,515.0,515.0
308.4,58,6,432,5,360,77100.0,24.0,24.0,1,72,0.0,24.0,24.0
40.05,17,10,676,5,460,10011.0,104.0,64.0,5,216,10011.0,20.0,15.0
0.005,17,2,230,1,68,0.0,40.0,40.0,1,162,0.0,134.0,134.0
0.004,6,10,2006,5,927,1.0,659.0,659.0,5,1079,1.0,811.0,811.0
40.067,17,10,676,5,460,10014.0,104.0,64.0,5,216,10016.0,20.0,15.0
0.118,6,10,1506,5,395,27.0,127.0,127.0,5,1111,22.0,843.0,843.0
0.005,6,10,2006,5,927,1.0,659.0,659.0,5,1079,1.0,811.0,811.0
0.005,6,10,1854,5,889,1.0,621.0,621.0,5,965,1.0,697.0,697.0
0.04,17,2,152,1,76,0.0,48.0,48.0,1,76,0.0,48.0,48.0
0.007,6,10,2000,5,927,1.0,659.0,659.0,5,1073,1.0,805.0,805.0
169.26,17,78,11138,39,2593,4454.0,44.0,38.0,39,8545,4454.0,260.0,191.0
0.003,17,2,136,1,60,0.0,32.0,32.0,1,76,0.0,48.0,48.0
0.062,6,10,1506,5,395,13.0,127.0,127.0,5,1111,13.0,843.0,843.0
0.006,6,10,1547,5,764,1.0,496.0,496.0,5,783,1.0,515.0,515.0
0.013,6,10,1762,5,911,3.0,643.0,643.0,5,851,3.0,583.0,583.0
0.005,6,10,1989,5,927,1.0,659.0,659.0,5,1062,1.0,794.0,794.0
0.005,17,2,273,1,66,0.0,38.0,38.0,1,207,0.0,179.0,179.0
15.08,17,16,8694,8,6630,2150.0,1350.0,800.0,8,2064,2150.0,1350.0,230.0
0.11,6,10,1506,5,395,24.0,127.0,127.0,5,1111,24.0,843.0,843.0
0.008,6,10,2007,5,928,2.0,660.0,660.0,5,1079,2.0,811.0,811.0
0.004,6,10,2006,5,927,1.0,659.0,659.0,5,1079,1.0,811.0,811.0
0.005,6,13,3684,7,446,0.0,74.0,74.0,6,3238,1.0,1470.0,1459.0
0.018,6,10,1989,5,910,4.0,642.0,642.0,5,1079,4.0,811.0,811.0
359.219,6,19,1690,15,978,25658.0,190.0,190.0,4,712,80002.0,496.0,496.0
0.012,6,10,1990,5,911,2.0,643.0,643.0,5,1079,2.0,811.0,811.0
30.478,6,30,12061,16,2433,2031.0,517.0,313.0,14,9628,2344.0,2694.0,986.0
0.004,6,10,2006,5,927,1.0,659.0,659.0,5,1079,1.0,811.0,811.0
0.076,6,10,1506,5,395,17.0,127.0,127.0,5,1111,16.0,843.0,843.0
0.012,6,10,1983,5,910,3.0,642.0,642.0,5,1073,3.0,805.0,805.0
240.013,6,9,787,5,488,60003.0,232.0,232.0,4,299,80003.0,83.0,83.0
0.005,17,2,168,1,76,0.0,48.0,48.0,1,92,0.0,64.0,64.0
40.057,17,10,676,5,460,10013.0,104.0,64.0,5,216,10013.0,20.0,15.0
0.309,17,40,21603,22,18422,14.0,1350.0,809.0,18,3181,14.0,1350.0,148.0
0.039,17,4,352,2,130,0.0,37.0,37.0,2,222,35.0,89.0,83.0
0.042,17,2,146,1,65,0.0,37.0,37.0,1,81,0.0,53.0,53.0
0.004,6,10,2006,5,927,1.0,659.0,659.0,5,1079,1.0,811.0,811.0
0.005,17,2,214,1,75,0.0,47.0,47.0,1,139,0.0,111.0,111.0
0.011,6,10,1989,5,910,2.0,642.0,642.0,5,1079,2.0,811.0,811.0
40.05,17,10,676,5,460,10011.0,104.0,64.0,5,216,10011.0,20.0,15.0
0.01,6,10,1989,5,910,2.0,642.0,642.0,5,1079,2.0,811.0,811.0
0.007,6,10,1547,5,764,1.0,496.0,496.0,5,783,1.0,515.0,515.0
0.006,17,2,170,1,65,0.0,37.0,37.0,1,105,0.0,77.0,77.0
0.041,17,2,412,1,61,0.0,33.0,33.0,1,351,0.0,323.0,323.0
0.005,6,10,1989,5,927,1.0,659.0,659.0,5,1062,1.0,794.0,794.0
0.093,6,10,1506,5,395,20.0,127.0,127.0,5,1111,17.0,843.0,843.0
30.638,6,46,23081,20,1110,5.0,290.0,290.0,26,21971,1224.0,1414.0,1230.0
0.01,6,10,1677,5,827,2.0,559.0,559.0,5,850,2.0,582.0,582.0
0.07,6,10,1506,5,395,17.0,127.0,127.0,5,1111,15.0,843.0,843.0
0.077,6,10,1506,5,395,17.0,127.0,127.0,5,1111,17.0,843.0,843.0
0.021,6,10,1762,5,911,5.0,643.0,643.0,5,851,5.0,583.0,583.0
0.006,6,10,1547,5,764,1.0,496.0,496.0,5,783,1.0,515.0,515.0
240.474,6,37,9654,19,2170,13359.0,742.0,234.0,18,7484,14145.0,1402.0,595.0
0.003,17,2,136,1,60,0.0,32.0,32.0,1,76,0.0,48.0,48.0
0.109,6,10,1506,5,395,24.0,127.0,127.0,5,1111,22.0,843.0,843.0
0.082,6,10,1506,5,395,15.0,127.0,127.0,5,1111,18.0,843.0,843.0
0.071,6,10,1506,5,395,16.0,127.0,127.0,5,1111,14.0,843.0,843.0
0.004,17,2,136,1,60,0.0,32.0,32.0,1,76,0.0,48.0,48.0
0.043,17,2,152,1,76,0.0,48.0,48.0,1,76,0.0,48.0,48.0
0.011,6,10,1762,5,911,2.0,643.0,643.0,5,851,2.0,583.0,583.0
0.011,6,10,1989,5,910,2.0,642.0,642.0,5,1079,2.0,811.0,811.0
353.248,6,20,2210,6,1308,12003.0,494.0,494.0,14,902,27172.0,83.0,83.0
240.329,6,36,10302,18,1883,14136.0,555.0,187.0,18,8419,14136.0,1763.0,680.0
0.129,6,10,1506,5,395,30.0,127.0,127.0,5,1111,30.0,843.0,843.0
0.001,17,2,180,1,66,0.0,38.0,38.0,1,114,0.0,86.0,86.0
0.001,17,2,180,1,66,0.0,38.0,38.0,1,114,0.0,86.0,86.0
61.065,6,22,11860,12,5295,5551.0,2804.0,935.0,10,6565,6770.0,2111.0,1006.0
0.012,6,10,1762,5,911,2.0,643.0,643.0,5,851,3.0,583.0,583.0
1770.458,17,92,8096,46,4048,39343.0,60.0,60.0,46,4048,39343.0,60.0,60.0
0.038,17,4,352,2,130,0.0,37.0,37.0,2,222,35.0,89.0,83.0
240.076,6,21,4925,11,941,24007.0,180.0,93.0,10,3984,26674.0,1592.0,576.0
0.005,17,2,144,1,64,0.0,36.0,36.0,1,80,0.0,52.0,52.0
0.005,17,2,164,1,74,0.0,46.0,46.0,1,90,0.0,62.0,62.0
0.003,17,2,185,1,73,0.0,45.0,45.0,1,112,0.0,84.0,84.0
0.011,6,10,1972,5,910,2.0,642.0,642.0,5,1062,2.0,794.0,794.0
0.003,17,2,170,1,65,0.0,37.0,37.0,1,105,0.0,77.0,77.0
0.009,6,10,1990,5,911,2.0,643.0,643.0,5,1079,2.0,811.0,811.0
0.003,17,2,152,1,76,0.0,48.0,48.0,1,76,0.0,48.0,48.0
0.001,17,2,166,1,75,0.0,47.0,47.0,1,91,0.0,63.0,63.0
0.005,6,10,2006,5,927,1.0,659.0,659.0,5,1079,1.0,811.0,811.0
40.062,17,10,676,5,460,10014.0,104.0,64.0,5,216,10014.0,20.0,15.0
0.103,6,10,1506,5,395,22.0,127.0,127.0,5,1111,19.0,843.0,843.0
240.013,6,9,787,5,488,60003.0,232.0,232.0,4,299,80003.0,83.0,83.0
0.005,6,10,2006,5,927,1.0,659.0,659.0,5,1079,1.0,811.0,811.0
0.005,17,2,164,1,74,0.0,46.0,46.0,1,90,0.0,62.0,62.0
0.018,6,10,1631,5,848,4.0,580.0,580.0,5,783,4.0,515.0,515.0
0.005,17,2,179,1,71,0.0,43.0,43.0,1,108,0.0,80.0,80.0
40.065,17,10,676,5,460,10013.0,104.0,64.0,5,216,10015.0,20.0,15.0
0.013,6,10,1983,5,910,3.0,642.0,642.0,5,1073,3.0,805.0,805.0
0.006,6,10,1547,5,764,1.0,496.0,496.0,5,783,1.0,515.0,515.0
0.005,6,10,2000,5,927,1.0,659.0,659.0,5,1073,1.0,805.0,805.0
0.073,6,10,1506,5,395,16.0,127.0,127.0,5,1111,15.0,843.0,843.0
40.077,17,10,676,5,460,10018.0,104.0,64.0,5,216,10018.0,20.0,15.0
9.038,17,6,376,5,280,2259.0,28.0,28.0,1,96,0.0,68.0,68.0
0.122,6,10,1266,5,775,30.0,519.0,519.0,5,491,29.0,223.0,223.0
0.011,6,10,1989,5,910,2.0,642.0,642.0,5,1079,2.0,811.0,811.0
0.005,6,10,1643,5,860,1.0,592.0,592.0,5,783,1.0,515.0,515.0
0.007,6,10,1643,5,860,1.0,592.0,592.0,5,783,1.0,515.0,515.0
40.062,17,10,676,5,460,10014.0,104.0,64.0,5,216,10014.0,20.0,15.0
0.011,6,10,1990,5,911,2.0,643.0,643.0,5,1079,2.0,811.0,811.0
0.008,17,2,194,1,59,0.0,31.0,31.0,1,135,0.0,107.0,107.0
0.004,6,10,2006,5,927,1.0,659.0,659.0,5,1079,1.0,811.0,811.0
0.089,6,10,1506,5,395,20.0,127.0,127.0,5,1111,21.0,843.0,843.0
0.013,6,10,1631,5,848,3.0,580.0,580.0,5,783,3.0,515.0,515.0
0.004,6,10,2007,5,928,1.0,660.0,660.0,5,1079,1.0,811.0,811.0
40.055,17,10,676,5,460,10013.0,104.0,64.0,5,216,10013.0,20.0,15.0
0.111,6,10,1506,5,395,24.0,127.0,127.0,5,1111,25.0,843.0,843.0
11.298,17,28,4421,14,1993,856.0,268.0,114.0,14,2428,856.0,587.0,145.0
40.085,17,10,676,5,460,10019.0,104.0,64.0,5,216,10020.0,20.0,15.0
0.004,17,2,148,1,60,0.0,32.0,32.0,1,88,0.0,60.0,60.0
0.014,6,10,1989,5,910,3.0,642.0,642.0,5,1079,3.0,811.0,811.0
174.566,17,80,11642,40,2690,4475.0,44.0,39.0,40,8952,4475.0,239.0,195.0
0.141,6,24,5979,12,1457,11.0,326.0,165.0,12,4522,11.0,1324.0,778.0
1729.225,6,60,4400,40,2740,44339.0,33.0,33.0,20,1660,91003.0,31.0,31.0
0.01,6,10,1990,5,911,2.0,643.0,643.0,5,1079,2.0,811.0,811.0
0.116,6,10,1506,5,395,24.0,127.0,127.0,5,1111,26.0,843.0,843.0
0.005,6,10,1643,5,860,1.0,592.0,592.0,5,783,1.0,515.0,515.0
0.006,6,14,3799,7,509,1.0,137.0,137.0,7,3290,0.0,1448.0,972.0
0.008,6,10,1972,5,910,2.0,642.0,642.0,5,1062,1.0,794.0,794.0
0.005,17,2,164,1,74,0.0,46.0,46.0,1,90,0.0,62.0,62.0
178.671,17,80,11490,40,2662,4581.0,44.0,38.0,40,8828,4581.0,260.0,192.0
300.781,6,36,8156,19,2678,16710.0,1502.0,471.0,17,5478,538.0,2667.0,435.0
0.121,6,10,1506,5,395,24.0,127.0,127.0,5,1111,27.0,843.0,843.0
0.071,6,10,1506,5,395,15.0,127.0,127.0,5,1111,16.0,843.0,843.0
0.434,17,51,33516,29,28914,15.0,1350.0,969.0,22,4602,17.0,1350.0,181.0
0.187,6,10,1506,5,395,41.0,127.0,127.0,5,1111,42.0,843.0,843.0
0.005,6,10,2007,5,928,1.0,660.0,660.0,5,1079,1.0,811.0,811.0
0.019,6,10,1990,5,911,4.0,643.0,643.0,5,1079,4.0,811.0,811.0
0.005,17,2,144,1,64,0.0,36.0,36.0,1,80,0.0,52.0,52.0
0.005,6,10,1774,5,923,1.0,655.0,655.0,5,851,1.0,583.0,583.0
308.55,17,20,1124,10,716,34269.0,48.0,43.0,10,408,34269.0,20.0,12.0
0.005,6,10,2006,5,927,1.0,659.0,659.0,5,1079,1.0,811.0,811.0
0.005,6,10,2006,5,927,1.0,659.0,659.0,5,1079,1.0,811.0,811.0
0.1,6,10,1506,5,395,19.0,127.0,127.0,5,1111,24.0,843.0,843.0
0.004,17,4,420,2,122,0.0,33.0,33.0,2,298,0.0,145.0,121.0
0.001,17,2,180,1,65,0.0,37.0,37.0,1,115,0.0,87.0,87.0
0.099,6,10,1506,5,395,21.0,127.0,127.0,5,1111,23.0,843.0,843.0
0.015,6,10,1762,5,911,3.0,643.0,643.0,5,851,3.0,583.0,583.0
0.012,6,10,1990,5,911,3.0,643.0,643.0,5,1079,2.0,811.0,811.0
0.019,6,10,1989,5,910,4.0,642.0,642.0,5,1079,4.0,811.0,811.0
0.006,17,2,230,1,68,0.0,40.0,40.0,1,162,0.0,134.0,134.0
0.02,6,10,1972,5,910,4.0,642.0,642.0,5,1062,4.0,794.0,794.0
0.134,6,10,1506,5,395,29.0,127.0,127.0,5,1111,23.0,843.0,843.0
0.006,6,10,1547,5,764,1.0,496.0,496.0,5,783,1.0,515.0,515.0
0.005,17,2,214,1,75,0.0,47.0,47.0,1,139,0.0,111.0,111.0
0.006,6,10,2000,5,927,1.0,659.0,659.0,5,1073,1.0,805.0,805.0
175.455,17,90,13033,45,3014,3987.0,44.0,38.0,45,10019,3987.0,239.0,194.0
0.005,6,10,2006,5,927,1.0,659.0,659.0,5,1079,1.0,811.0,811.0
0.005,6,10,1643,5,860,1.0,592.0,592.0,5,783,1.0,515.0,515.0
240.79,6,35,8923,18,2071,14160.0,692.0,225.0,17,6852,15045.0,1402.0,597.0
0.015,6,10,1972,5,910,3.0,642.0,642.0,5,1062,3.0,794.0,794.0
0.005,17,2,230,1,68,0.0,40.0,40.0,1,162,0.0,134.0,134.0
0.005,6,10,2006,5,927,1.0,659.0,659.0,5,1079,1.0,811.0,811.0
40.067,17,10,676,5,460,10013.0,104.0,64.0,5,216,10015.0,20.0,15.0
0.001,17,2,136,1,60,0.0,32.0,32.0,1,76,0.0,48.0,48.0
0.014,6,10,1972,5,910,3.0,642.0,642.0,5,1062,3.0,794.0,794.0
0.011,6,10,1990,5,911,2.0,643.0,643.0,5,1079,2.0,811.0,811.0
0.004,17,4,284,2,120,0.0,32.0,32.0,2,164,0.0,60.0,54.0
0.103,6,10,1506,5,395,24.0,127.0,127.0,5,1111,24.0,843.0,843.0
0.089,6,10,1506,5,395,21.0,127.0,127.0,5,1111,21.0,843.0,843.0
40.065,17,10,676,5,460,10014.0,104.0,64.0,5,216,10015.0,20.0,15.0
0.008,6,10,1990,5,911,2.0,643.0,643.0,5,1079,1.0,811.0,811.0
0.008,6,10,1631,5,848,2.0,580.0,580.0,5,783,2.0,515.0,515.0
0.005,6,10,1643,5,860,1.0,592.0,592.0,5,783,1.0,515.0,515.0
40.061,17,10,676,5,460,10013.0,104.0,64.0,5,216,10014.0,20.0,15.0
0.016,6,10,1989,5,910,4.0,642.0,642.0,5,1079,3.0,811.0,811.0
0.01,6,10,1990,5,911,2.0,643.0,643.0,5,1079,2.0,811.0,811.0
0.004,17,2,136,1,60,0.0,32.0,32.0,1,76,0.0,48.0,48.0
368.081,6,33,12147,18,2671,21651.0,585.0,345.0,15,9476,22001.0,1402.0,965.0
0.003,17,4,284,2,120,0.0,32.0,32.0,2,164,0.0,60.0,54.0
0.005,6,10,2006,5,927,1.0,659.0,659.0,5,1079,1.0,811.0,811.0
170.067,17,82,11364,41,2736,4251.0,44.0,38.0,41,8628,4251.0,260.0,182.0
0.012,6,13,3735,7,497,1.0,125.0,125.0,6,3238,2.0,1470.0,1459.0
0.006,17,2,148,1,60,0.0,32.0,32.0,1,88,0.0,60.0,60.0
0.067,6,10,1506,5,395,15.0,127.0,127.0,5,1111,13.0,843.0,843.0
0.004,17,2,136,1,60,0.0,32.0,32.0,1,76,0.0,48.0,48.0
0.081,6,10,1506,5,395,18.0,127.0,127.0,5,1111,17.0,843.0,843.0
0.005,6,10,2006,5,927,1.0,659.0,659.0,5,1079,1.0,811.0,811.0
0.012,6,10,1989,5,910,3.0,642.0,642.0,5,1079,2.0,811.0,811.0
0.014,6,10,1990,5,911,3.0,643.0,643.0,5,1079,3.0,811.0,811.0
0.016,6,10,1762,5,911,3.0,643.0,643.0,5,851,3.0,583.0,583.0
240.023,6,9,787,5,488,60005.0,232.0,232.0,4,299,80006.0,83.0,83.0
0.005,6,10,1990,5,928,1.0,660.0,660.0,5,1062,1.0,794.0,794.0
0.066,17,8,3613,4,1874,22.0,1350.0,440.0,4,1739,11.0,1350.0,406.0
0.012,6,10,1990,5,911,3.0,643.0,643.0,5,1079,2.0,811.0,811.0
0.004,6,10,2007,5,928,1.0,660.0,660.0,5,1079,1.0,811.0,811.0
0.088,6,10,1506,5,395,18.0,127.0,127.0,5,1111,20.0,843.0,843.0
40.059,17,10,676,5,460,10012.0,104.0,64.0,5,216,10013.0,20.0,15.0
0.011,6,10,1972,5,910,2.0,642.0,642.0,5,1062,2.0,794.0,794.0
0.015,6,10,1989,5,910,3.0,642.0,642.0,5,1079,3.0,811.0,811.0
0.009,6,10,1990,5,911,2.0,643.0,643.0,5,1079,2.0,811.0,811.0
0.005,17,2,166,1,75,0.0,47.0,47.0,1,91,0.0,63.0,63.0
40.054,17,10,676,5,460,10011.0,104.0,64.0,5,216,10012.0,20.0,15.0
0.009,6,12,1926,6,1189,1.0,659.0,434.0,6,737,1.0,417.0,417.0
0.004,17,2,146,1,65,0.0,37.0,37.0,1,81,0.0,53.0,53.0
0.017,6,10,1762,5,911,4.0,643.0,643.0,5,851,4.0,583.0,583.0
0.215,6,16,2669,8,1395,30.0,533.0,323.0,8,1274,19.0,529.0,212.0
0.266,17,43,26475,26,23429,10.0,1350.0,873.0,17,3046,13.0,1350.0,151.0
0.016,6,10,1990,5,911,4.0,643.0,643.0,5,1079,4.0,811.0,811.0
0.041,17,2,152,1,76,0.0,48.0,48.0,1,76,0.0,48.0,48.0
0.147,6,10,1506,5,395,33.0,127.0,127.0,5,1111,30.0,843.0,843.0
170.246,17,90,13141,45,3025,3869.0,44.0,39.0,45,10116,3869.0,261.0,196.0
0.023,6,10,1989,5,910,5.0,642.0,642.0,5,1079,5.0,811.0,811.0
0.005,6,10,1774,5,923,1.0,655.0,655.0,5,851,1.0,583.0,583.0
0.004,6,10,2006,5,927,1.0,659.0,659.0,5,1079,1.0,811.0,811.0
0.01,6,10,1989,5,910,2.0,642.0,642.0,5,1079,2.0,811.0,811.0
0.008,6,10,1972,5,910,2.0,642.0,642.0,5,1062,2.0,794.0,794.0
0.005,6,10,1989,5,927,1.0,659.0,659.0,5,1062,1.0,794.0,794.0
0.013,17,2,148,1,60,0.0,32.0,32.0,1,88,0.0,60.0,60.0
0.001,17,2,180,1,66,0.0,38.0,38.0,1,114,0.0,86.0,86.0
0.001,17,2,136,1,60,0.0,32.0,32.0,1,76,0.0,48.0,48.0
0.098,6,10,1506,5,395,23.0,127.0,127.0,5,1111,22.0,843.0,843.0
0.006,17,2,225,1,65,0.0,37.0,37.0,1,160,0.0,132.0,132.0
0.007,17,2,194,1,59,0.0,31.0,31.0,1,135,0.0,107.0,107.0
0.005,17,2,179,1,71,0.0,43.0,43.0,1,108,0.0,80.0,80.0
0.001,17,2,180,1,66,0.0,38.0,38.0,1,114,0.0,86.0,86.0
0.007,6,10,1547,5,764,1.0,496.0,496.0,5,783,1.0,515.0,515.0
300.384,6,16,2170,9,684,37527.0,146.0,146.0,7,1486,50036.0,419.0,398.0
0.043,17,2,152,1,76,0.0,48.0,48.0,1,76,0.0,48.0,48.0
0.113,6,10,1506,5,395,25.0,127.0,127.0,5,1111,22.0,843.0,843.0
74.758,6,21,8144,11,1985,91.0,1174.0,504.0,10,6159,8288.0,2720.0,957.0
369.533,6,22,2313,16,867,24635.0,195.0,195.0,6,1446,4638.0,419.0,398.0
0.011,6,10,1972,5,910,2.0,642.0,642.0,5,1062,2.0,794.0,794.0
0.071,17,2,148,1,60,0.0,32.0,32.0,1,88,0.0,60.0,60.0
0.005,6,10,2006,5,927,1.0,659.0,659.0,5,1079,1.0,811.0,811.0
0.101,6,10,1506,5,395,20.0,127.0,127.0,5,1111,24.0,843.0,843.0
356.592,6,21,1795,16,1030,23772.0,190.0,190.0,5,765,60004.0,464.0,248.0
1769.131,17,92,8096,46,4048,39313.0,60.0,60.0,46,4048,39313.0,60.0,60.0
0.087,6,10,1506,5,395,19.0,127.0,127.0,5,1111,19.0,843.0,843.0
240.085,6,16,4481,9,963,30010.0,238.0,166.0,7,3518,40013.0,1402.0,786.0
0.001,17,2,146,1,65,0.0,37.0,37.0,1,81,0.0,53.0,53.0
369.513,6,22,2313,16,867,24634.0,195.0,195.0,6,1446,4642.0,419.0,398.0
0.099,6,10,1506,5,395,22.0,127.0,127.0,5,1111,21.0,843.0,843.0
0.117,6,10,1506,5,395,22.0,127.0,127.0,5,1111,24.0,843.0,843.0
0.126,17,4,352,2,130,0.0,37.0,37.0,2,222,55.0,89.0,83.0
40.061,17,10,676,5,460,10013.0,104.0,64.0,5,216,10014.0,20.0,15.0
240.082,6,16,4482,9,963,30010.0,238.0,166.0,7,3519,40013.0,1402.0,786.0
0.005,6,10,2006,5,927,1.0,659.0,659.0,5,1079,1.0,811.0,811.0
0.005,6,10,1989,5,927,1.0,659.0,659.0,5,1062,1.0,794.0,794.0
0.017,6,10,1990,5,911,4.0,643.0,643.0,5,1079,4.0,811.0,811.0
0.005,6,10,2007,5,928,1.0,660.0,660.0,5,1079,1.0,811.0,811.0
0.005,17,2,140,1,62,0.0,34.0,34.0,1,78,0.0,50.0,50.0
0.014,6,10,1972,5,910,3.0,642.0,642.0,5,1062,3.0,794.0,794.0
0.005,6,10,1702,5,863,1.0,595.0,595.0,5,839,1.0,571.0,571.0
0.01,6,10,1983,5,910,2.0,642.0,642.0,5,1073,2.0,805.0,805.0
0.019,6,10,1972,5,910,4.0,642.0,642.0,5,1062,4.0,794.0,794.0
0.003,17,4,284,2,120,0.0,32.0,32.0,2,164,0.0,60.0,54.0
0.006,6,12,1698,6,863,1.0,327.0,271.0,6,835,1.0,515.0,515.0
0.095,6,10,1506,5,395,18.0,127.0,127.0,5,1111,19.0,843.0,843.0
0.1,6,10,1506,5,395,22.0,127.0,127.0,5,1111,21.0,843.0,843.0
0.005,6,13,3747,7,509,0.0,137.0,137.0,6,3238,1.0,1470.0,1459.0
0.001,17,2,180,1,66,0.0,38.0,38.0,1,114,0.0,86.0,86.0
0.015,6,10,1989,5,910,3.0,642.0,642.0,5,1079,3.0,811.0,811.0
0.005,17,2,144,1,64,0.0,36.0,36.0,1,80,0.0,52.0,52.0
0.127,17,2,136,1,60,0.0,32.0,32.0,1,76,0.0,48.0,48.0
0.015,6,10,1762,5,911,3.0,643.0,643.0,5,851,3.0,583.0,583.0
0.003,17,2,152,1,76,0.0,48.0,48.0,1,76,0.0,48.0,48.0
0.066,6,10,1506,5,395,15.0,127.0,127.0,5,1111,13.0,843.0,843.0
0.005,17,2,144,1,64,0.0,36.0,36.0,1,80,0.0,52.0,52.0
40.064,17,10,676,5,460,10013.0,104.0,64.0,5,216,10013.0,20.0,15.0
0.009,6,12,1926,6,1189,1.0,659.0,434.0,6,737,1.0,417.0,417.0
40.056,17,10,676,5,460,10013.0,104.0,64.0,5,216,10013.0,20.0,15.0
240.234,6,22,11454,13,6877,20019.0,2736.0,1034.0,9,4577,30028.0,1655.0,1367.0
0.013,6,10,1990,5,911,3.0,643.0,643.0,5,1079,3.0,811.0,811.0
0.042,17,2,412,1,61,0.0,33.0,33.0,1,351,0.0,323.0,323.0
0.004,6,10,2007,5,928,1.0,660.0,660.0,5,1079,1.0,811.0,811.0
0.005,6,10,2006,5,927,1.0,659.0,659.0,5,1079,1.0,811.0,811.0
0.005,17,2,255,1,82,0.0,54.0,54.0,1,173,0.0,145.0,145.0
0.005,6,10,2006,5,927,1.0,659.0,659.0,5,1079,1.0,811.0,811.0
0.005,6,13,3690,7,452,0.0,80.0,80.0,6,3238,0.0,1470.0,1459.0
0.009,17,2,194,1,59,0.0,31.0,31.0,1,135,0.0,107.0,107.0
0.017,6,10,1631,5,848,4.0,580.0,580.0,5,783,4.0,515.0,515.0
40.072,17,10,676,5,460,10016.0,104.0,64.0,5,216,10015.0,20.0,15.0
0.005,6,10,2000,5,927,1.0,659.0,659.0,5,1073,1.0,805.0,805.0
0.009,6,10,1774,5,923,2.0,655.0,655.0,5,851,2.0,583.0,583.0
0.003,17,2,185,1,73,0.0,45.0,45.0,1,112,0.0,84.0,84.0
0.004,17,2,148,1,60,0.0,32.0,32.0,1,88,0.0,60.0,60.0
1799.731,6,244,35807,151,25972,11998.0,302.0,302.0,93,9835,19562.0,102.0,83.0
0.011,6,10,1989,5,910,2.0,642.0,642.0,5,1079,2.0,811.0,811.0
0.005,6,10,2006,5,927,1.0,659.0,659.0,5,1079,1.0,811.0,811.0
0.013,6,10,1762,5,911,3.0,643.0,643.0,5,851,3.0,583.0,583.0
0.097,6,10,1506,5,395,22.0,127.0,127.0,5,1111,20.0,843.0,843.0
0.011,6,10,1983,5,910,2.0,642.0,642.0,5,1073,2.0,805.0,805.0
0.001,17,2,136,1,60,0.0,32.0,32.0,1,76,0.0,48.0,48.0
308.858,17,20,1124,10,716,34310.0,48.0,43.0,10,408,34310.0,20.0,12.0
0.039,17,2,182,1,65,0.0,37.0,37.0,1,117,0.0,89.0,89.0
0.005,6,10,2006,5,927,1.0,659.0,659.0,5,1079,1.0,811.0,811.0
0.006,17,2,166,1,75,0.0,47.0,47.0,1,91,0.0,63.0,63.0
0.072,17,4,596,2,122,0.0,33.0,33.0,2,474,34.0,323.0,209.0
300.41,6,16,2170,9,684,37530.0,146.0,146.0,7,1486,50040.0,419.0,398.0
0.001,17,2,166,1,75,0.0,47.0,47.0,1,91,0.0,63.0,63.0
0.014,6,10,1972,5,910,3.0,642.0,642.0,5,1062,3.0,794.0,794.0
0.009,6,10,1989,5,910,2.0,642.0,642.0,5,1079,2.0,811.0,811.0
0.011,6,13,3735,7,497,1.0,125.0,125.0,6,3238,2.0,1470.0,1459.0
0.004,17,4,284,2,120,0.0,32.0,32.0,2,164,1.0,60.0,54.0
0.012,6,10,1989,5,910,3.0,642.0,642.0,5,1079,3.0,811.0,811.0
0.005,6,10,1989,5,927,1.0,659.0,659.0,5,1062,1.0,794.0,794.0
0.006,6,10,1689,5,839,1.0,571.0,571.0,5,850,1.0,582.0,582.0
0.001,17,2,180,1,66,0.0,38.0,38.0,1,114,0.0,86.0,86.0
0.015,6,10,1990,5,911,3.0,643.0,643.0,5,1079,3.0,811.0,811.0
0.009,17,2,169,1,62,0.0,34.0,34.0,1,107,0.0,79.0,79.0
240.152,6,45,6829,21,3171,12007.0,588.0,230.0,24,3658,10441.0,580.0,218.0
0.066,6,10,1506,5,395,14.0,127.0,127.0,5,1111,15.0,843.0,843.0
0.004,6,10,1779,5,928,1.0,660.0,660.0,5,851,1.0,583.0,583.0
0.009,6,10,1972,5,910,2.0,642.0,642.0,5,1062,2.0,794.0,794.0
0.004,6,10,1702,5,863,1.0,595.0,595.0,5,839,1.0,571.0,571.0
294.614,6,383,346904,200,21962,1480.0,2736.0,888.0,183,324942,1618.0,2804.0,1866.0
0.005,6,10,1989,5,927,1.0,659.0,659.0,5,1062,1.0,794.0,794.0
15.077,17,15,9238,8,6902,2149.0,1350.0,834.0,7,2336,2506.0,1350.0,305.0
0.012,6,10,1972,5,910,2.0,642.0,642.0,5,1062,2.0,794.0,794.0
0.01,6,10,1990,5,911,2.0,643.0,643.0,5,1079,2.0,811.0,811.0
0.072,17,2,182,1,65,0.0,37.0,37.0,1,117,0.0,89.0,89.0
0.016,17,2,198,1,91,0.0,63.0,63.0,1,107,0.0,79.0,79.0
40.054,17,10,676,5,460,10012.0,104.0,64.0,5,216,10012.0,20.0,15.0
0.013,6,10,1762,5,911,3.0,643.0,643.0,5,851,3.0,583.0,583.0
0.004,17,2,136,1,60,0.0,32.0,32.0,1,76,0.0,48.0,48.0
0.004,6,10,2006,5,927,1.0,659.0,659.0,5,1079,1.0,811.0,811.0
0.001,17,2,180,1,66,0.0,38.0,38.0,1,114,0.0,86.0,86.0
0.096,6,10,1506,5,395,20.0,127.0,127.0,5,1111,21.0,843.0,843.0
0.003,17,2,166,1,75,0.0,47.0,47.0,1,91,0.0,63.0,63.0
0.006,6,10,1547,5,764,1.0,496.0,496.0,5,783,1.0,515.0,515.0
0.087,6,10,1506,5,395,20.0,127.0,127.0,5,1111,20.0,843.0,843.0
0.089,6,10,1506,5,395,19.0,127.0,127.0,5,1111,21.0,843.0,843.0
0.004,17,2,148,1,60,0.0,32.0,32.0,1,88,0.0,60.0,60.0
0.027,6,14,3787,7,497,4.0,125.0,125.0,7,3290,4.0,1448.0,972.0
0.01,6,10,1972,5,910,2.0,642.0,642.0,5,1062,2.0,794.0,794.0
0.005,17,2,144,1,64,0.0,36.0,36.0,1,80,0.0,52.0,52.0
0.006,6,10,2006,5,927,1.0,659.0,659.0,5,1079,1.0,811.0,811.0
0.016,6,10,1631,5,848,4.0,580.0,580.0,5,783,4.0,515.0,515.0
0.005,6,10,2000,5,927,1.0,659.0,659.0,5,1073,1.0,805.0,805.0
0.073,6,10,1506,5,395,16.0,127.0,127.0,5,1111,15.0,843.0,843.0
0.01,17,2,154,1,69,0.0,41.0,41.0,1,85,0.0,57.0,57.0
0.004,6,10,1774,5,923,1.0,655.0,655.0,5,851,1.0,583.0,583.0
0.01,6,10,1990,5,911,2.0,643.0,643.0,5,1079,2.0,811.0,811.0
0.011,6,10,1989,5,910,2.0,642.0,642.0,5,1079,2.0,811.0,811.0
0.009,6,10,1989,5,910,2.0,642.0,642.0,5,1079,2.0,811.0,811.0
352.714,6,20,2210,6,1308,12003.0,494.0,494.0,14,902,27131.0,83.0,83.0
0.047,17,2,136,1,60,0.0,32.0,32.0,1,76,0.0,48.0,48.0
0.004,6,10,2006,5,927,1.0,659.0,659.0,5,1079,1.0,811.0,811.0
0.006,6,10,1547,5,764,1.0,496.0,496.0,5,783,1.0,515.0,515.0
0.004,17,2,152,1,76,0.0,48.0,48.0,1,76,0.0,48.0,48.0
0.105,6,10,1506,5,395,21.0,127.0,127.0,5,1111,20.0,843.0,843.0
0.011,6,10,1631,5,848,2.0,580.0,580.0,5,783,2.0,515.0,515.0
0.014,6,10,1990,5,911,3.0,643.0,643.0,5,1079,3.0,811.0,811.0
0.007,6,10,1989,5,910,1.0,642.0,642.0,5,1079,1.0,811.0,811.0
0.011,6,10,1762,5,911,2.0,643.0,643.0,5,851,2.0,583.0,583.0
0.123,6,10,1506,5,395,28.0,127.0,127.0,5,1111,25.0,843.0,843.0
0.012,6,14,3787,7,497,2.0,125.0,125.0,7,3290,1.0,1448.0,972.0
0.005,6,10,1854,5,889,1.0,621.0,621.0,5,965,1.0,697.0,697.0
0.013,6,13,3735,7,497,2.0,125.0,125.0,6,3238,2.0,1470.0,1459.0
0.005,6,10,2007,5,928,1.0,660.0,660.0,5,1079,1.0,811.0,811.0
0.005,17,2,214,1,75,0.0,47.0,47.0,1,139,0.0,111.0,111.0
0.08,6,10,1506,5,395,18.0,127.0,127.0,5,1111,18.0,843.0,843.0
0.113,6,10,1506,5,395,25.0,127.0,127.0,5,1111,24.0,843.0,843.0
0.09,6,10,1506,5,395,19.0,127.0,127.0,5,1111,20.0,843.0,843.0
0.005,17,2,230,1,68,0.0,40.0,40.0,1,162,0.0,134.0,134.0
0.004,6,10,1989,5,927,1.0,659.0,659.0,5,1062,1.0,794.0,794.0
0.015,6,10,1983,5,910,3.0,642.0,642.0,5,1073,3.0,805.0,805.0
0.006,6,10,1547,5,764,1.0,496.0,496.0,5,783,1.0,515.0,515.0
0.011,6,10,1990,5,911,2.0,643.0,643.0,5,1079,2.0,811.0,811.0
0.009,6,12,1926,6,1189,1.0,659.0,434.0,6,737,1.0,417.0,417.0
0.007,17,2,209,1,64,0.0,36.0,36.0,1,145,0.0,117.0,117.0
0.005,6,10,1989,5,927,1.0,659.0,659.0,5,1062,1.0,794.0,794.0
308.4,17,20,1124,10,716,34252.0,48.0,43.0,10,408,34255.0,20.0,12.0
0.01,6,10,1631,5,848,2.0,580.0,580.0,5,783,2.0,515.0,515.0
0.007,17,2,307,1,61,0.0,33.0,33.0,1,246,0.0,218.0,218.0
0.005,17,2,164,1,74,0.0,46.0,46.0,1,90,0.0,62.0,62.0
0.003,17,2,148,1,60,0.0,32.0,32.0,1,88,0.0,60.0,60.0
40.072,17,10,676,5,460,10017.0,104.0,64.0,5,216,10017.0,20.0,15.0
0.003,17,2,148,1,60,0.0,32.0,32.0,1,88,0.0,60.0,60.0
300.317,6,16,2170,9,684,37518.0,146.0,146.0,7,1486,50024.0,419.0,398.0
0.068,17,8,3613,4,1874,22.0,1350.0,440.0,4,1739,11.0,1350.0,406.0
10.881,17,28,4423,14,1994,829.0,269.0,114.0,14,2429,828.0,588.0,145.0
0.005,6,10,1643,5,860,1.0,592.0,592.0,5,783,1.0,515.0,515.0
0.005,6,14,3799,7,509,0.0,137.0,137.0,7,3290,0.0,1448.0,972.0
0.003,17,2,148,1,60,0.0,32.0,32.0,1,88,0.0,60.0,60.0
0.018,6,10,1989,5,910,4.0,642.0,642.0,5,1079,4.0,811.0,811.0
0.084,6,10,1506,5,395,18.0,127.0,127.0,5,1111,17.0,843.0,843.0
354.026,6,21,1795,16,1030,23601.0,190.0,190.0,5,765,60002.0,464.0,248.0
329.681,17,20,1124,10,716,36616.0,48.0,43.0,10,408,36616.0,20.0,12.0
60.02,6,10,1690,6,1308,12004.0,494.0,494.0,4,382,20005.0,83.0,83.0
300.35,6,16,2170,9,684,37523.0,146.0,146.0,7,1486,50030.0,419.0,398.0
0.005,6,10,1989,5,927,1.0,659.0,659.0,5,1062,1.0,794.0,794.0
0.0,17,2,154,1,69,0.0,41.0,41.0,1,85,0.0,57.0,57.0
0.004,6,10,1989,5,927,1.0,659.0,659.0,5,1062,1.0,794.0,794.0
0.005,6,13,3684,7,446,0.0,74.0,74.0,6,3238,1.0,1470.0,1459.0
0.012,6,10,1989,5,910,3.0,642.0,642.0,5,1079,3.0,811.0,811.0
240.471,6,35,8929,18,2075,14145.0,696.0,226.0,17,6854,15029.0,1402.0,597.0
0.014,6,10,1983,5,910,3.0,642.0,642.0,5,1073,3.0,805.0,805.0
0.133,6,10,1506,5,395,27.0,127.0,127.0,5,1111,28.0,843.0,843.0
0.005,6,14,3742,7,452,0.0,80.0,80.0,7,3290,0.0,1448.0,972.0
0.081,6,10,1506,5,395,19.0,127.0,127.0,5,1111,17.0,843.0,843.0
0.19,17,2,152,1,76,0.0,48.0,48.0,1,76,0.0,48.0,48.0
0.126,17,4,284,2,120,1.0,32.0,32.0,2,164,122.0,60.0,54.0
0.075,6,10,1506,5,395,18.0,127.0,127.0,5,1111,15.0,843.0,843.0
40.062,17,10,676,5,460,10014.0,104.0,64.0,5,216,10014.0,20.0,15.0
0.005,6,10,2006,5,927,1.0,659.0,659.0,5,1079,1.0,811.0,811.0
0.018,6,10,1983,5,910,4.0,642.0,642.0,5,1073,4.0,805.0,805.0
273.22,17,144,20920,72,4845,3848.0,44.0,39.0,72,16075,3848.0,239.0,195.0
0.053,17,2,152,1,76,0.0,48.0,48.0,1,76,0.0,48.0,48.0
15.075,17,14,9190,8,6902,2149.0,1350.0,834.0,6,2288,3009.0,1350.0,353.0
0.006,6,14,3799,7,509,0.0,137.0,137.0,7,3290,0.0,1448.0,972.0
0.072,6,10,1506,5,395,15.0,127.0,127.0,5,1111,17.0,843.0,843.0
0.015,6,10,1989,5,910,3.0,642.0,642.0,5,1079,3.0,811.0,811.0
0.096,6,10,1506,5,395,21.0,127.0,127.0,5,1111,22.0,843.0,843.0
0.005,6,10,1774,5,923,1.0,655.0,655.0,5,851,1.0,583.0,583.0
0.02,6,10,1983,5,910,5.0,642.0,642.0,5,1073,5.0,805.0,805.0
0.112,6,10,1506,5,395,19.0,127.0,127.0,5,1111,26.0,843.0,843.0
0.006,6,10,1547,5,764,1.0,496.0,496.0,5,783,1.0,515.0,515.0
0.018,17,2,170,1,65,0.0,37.0,37.0,1,105,0.0,77.0,77.0
0.005,17,2,166,1,75,0.0,47.0,47.0,1,91,0.0,63.0,63.0
0.133,6,10,1506,5,395,32.0,127.0,127.0,5,1111,29.0,843.0,843.0
0.004,6,10,2000,5,927,1.0,659.0,659.0,5,1073,1.0,805.0,805.0
283.532,6,24,7264,10,1186,31503.0,267.0,156.0,14,6078,21805.0,1400.0,919.0
0.005,6,10,2006,5,927,1.0,659.0,659.0,5,1079,1.0,811.0,811.0
0.073,6,10,1506,5,395,17.0,127.0,127.0,5,1111,14.0,843.0,843.0
0.006,6,10,1854,5,889,1.0,621.0,621.0,5,965,1.0,697.0,697.0
0.01,6,10,1983,5,910,2.0,642.0,642.0,5,1073,2.0,805.0,805.0
0.009,6,10,1989,5,910,2.0,642.0,642.0,5,1079,2.0,811.0,811.0
0.004,17,4,284,2,120,0.0,32.0,32.0,2,164,1.0,60.0,54.0
0.099,6,10,1506,5,395,18.0,127.0,127.0,5,1111,22.0,843.0,843.0
0.011,17,2,140,1,62,0.0,34.0,34.0,1,78,0.0,50.0,50.0
0.013,6,10,1989,5,910,3.0,642.0,642.0,5,1079,3.0,811.0,811.0
0.005,6,10,2006,5,927,1.0,659.0,659.0,5,1079,1.0,811.0,811.0
0.008,6,10,1989,5,910,2.0,642.0,642.0,5,1079,2.0,811.0,811.0
288.92,6,70,17245,35,10441,8497.0,2267.0,573.0,35,6804,8497.0,1665.0,381.0
0.006,6,10,2006,5,927,1.0,659.0,659.0,5,1079,1.0,811.0,811.0
0.004,17,2,136,1,60,0.0,32.0,32.0,1,76,0.0,48.0,48.0
0.087,6,10,1506,5,395,18.0,127.0,127.0,5,1111,19.0,843.0,843.0
366.794,6,22,2313,16,867,24452.0,195.0,195.0,6,1446,4635.0,419.0,398.0
0.017,6,10,1989,5,910,4.0,642.0,642.0,5,1079,4.0,811.0,811.0
0.003,17,2,160,1,72,0.0,44.0,44.0,1,88,0.0,60.0,60.0
0.005,6,10,1779,5,928,1.0,660.0,660.0,5,851,1.0,583.0,583.0
0.009,6,10,1990,5,911,2.0,643.0,643.0,5,1079,2.0,811.0,811.0
0.005,6,10,2000,5,927,1.0,659.0,659.0,5,1073,1.0,805.0,805.0
0.005,17,2,166,1,75,0.0,47.0,47.0,1,91,0.0,63.0,63.0
0.012,6,10,1983,5,910,3.0,642.0,642.0,5,1073,3.0,805.0,805.0
0.067,17,8,3613,4,1874,22.0,1350.0,440.0,4,1739,11.0,1350.0,406.0
0.122,6,10,1506,5,395,22.0,127.0,127.0,5,1111,29.0,843.0,843.0
0.005,17,2,180,1,58,0.0,30.0,30.0,1,122,0.0,94.0,94.0
0.014,6,10,1983,5,910,3.0,642.0,642.0,5,1073,3.0,805.0,805.0
0.005,6,10,2007,5,928,1.0,660.0,660.0,5,1079,1.0,811.0,811.0
0.179,6,10,1506,5,395,41.0,127.0,127.0,5,1111,36.0,843.0,843.0
300.404,6,16,2170,9,684,37529.0,146.0,146.0,7,1486,50039.0,419.0,398.0
0.96,6,22,5168,11,1138,85.0,267.0,115.0,11,4030,83.0,1414.0,597.0
0.015,17,2,180,1,66,0.0,38.0,38.0,1,114,0.0,86.0,86.0
0.005,17,2,170,1,65,0.0,37.0,37.0,1,105,0.0,77.0,77.0
0.01,6,10,1779,5,928,2.0,660.0,660.0,5,851,2.0,583.0,583.0
300.997,6,45,18736,25,13138,12541.0,2720.0,1210.0,20,5598,464.0,2667.0,435.0
40.061,17,10,676,5,460,10012.0,104.0,64.0,5,216,10014.0,20.0,15.0
0.01,6,10,1990,5,911,2.0,643.0,643.0,5,1079,2.0,811.0,811.0
0.001,17,2,136,1,60,0.0,32.0,32.0,1,76,0.0,48.0,48.0
0.213,6,10,1506,5,395,51.0,127.0,127.0,5,1111,51.0,843.0,843.0
0.096,6,10,1506,5,395,22.0,127.0,127.0,5,1111,22.0,843.0,843.0
0.005,6,10,1989,5,927,1.0,659.0,659.0,5,1062,1.0,794.0,794.0
0.239,17,15,8641,8,4076,34.0,1350.0,481.0,7,4565,30.0,1350.0,624.0
0.004,6,10,2007,5,928,1.0,660.0,660.0,5,1079,1.0,811.0,811.0
0.157,6,10,1506,5,395,34.0,127.0,127.0,5,1111,36.0,843.0,843.0
0.005,6,10,1689,5,839,1.0,571.0,571.0,5,850,1.0,582.0,582.0
0.041,17,2,136,1,60,0.0,32.0,32.0,1,76,0.0,48.0,48.0
0.116,6,10,1506,5,395,28.0,127.0,127.0,5,1111,24.0,843.0,843.0
0.043,17,2,148,1,60,0.0,32.0,32.0,1,88,0.0,60.0,60.0
0.117,6,10,1506,5,395,21.0,127.0,127.0,5,1111,27.0,843.0,843.0
0.007,6,10,1547,5,764,1.0,496.0,496.0,5,783,1.0,515.0,515.0
373.872,6,24,2405,17,919,23367.0,195.0,195.0,7,1486,3904.0,419.0,398.0
0.078,6,10,1506,5,395,17.0,127.0,127.0,5,1111,18.0,843.0,843.0
0.016,6,10,1972,5,910,4.0,642.0,642.0,5,1062,3.0,794.0,794.0
379.046,6,22,2313,16,867,25269.0,195.0,195.0,6,1446,4636.0,419.0,398.0
0.079,6,10,1506,5,395,19.0,127.0,127.0,5,1111,16.0,843.0,843.0
0.005,17,2,144,1,64,0.0,36.0,36.0,1,80,0.0,52.0,52.0
0.005,6,10,2006,5,927,1.0,659.0,659.0,5,1079,1.0,811.0,811.0
40.072,17,10,676,5,460,10014.0,104.0,64.0,5,216,10017.0,20.0,15.0
0.001,17,2,174,1,72,0.0,44.0,44.0,1,102,0.0,74.0,74.0
0.786,6,28,13704,16,7251,52.0,2720.0,939.0,12,6453,56.0,2720.0,851.0
0.003,17,2,136,1,60,0.0,32.0,32.0,1,76,0.0,48.0,48.0
0.075,6,10,1506,5,395,16.0,127.0,127.0,5,1111,15.0,843.0,843.0
0.824,6,22,5168,11,1138,70.0,267.0,115.0,11,4030,70.0,1414.0,597.0
0.018,6,10,1990,5,911,4.0,643.0,643.0,5,1079,4.0,811.0,811.0
0.006,6,10,1547,5,764,1.0,496.0,496.0,5,783,1.0,515.0,515.0
0.005,6,10,1989,5,927,1.0,659.0,659.0,5,1062,1.0,794.0,794.0
0.107,6,10,1506,5,395,23.0,127.0,127.0,5,1111,25.0,843.0,843.0
0.004,6,10,2000,5,927,1.0,659.0,659.0,5,1073,1.0,805.0,805.0
0.383,17,45,22062,24,18525,16.0,1350.0,743.0,21,3537,16.0,1350.0,140.0
0.001,17,2,179,1,62,0.0,34.0,34.0,1,117,0.0,89.0,89.0
0.004,17,2,136,1,60,0.0,32.0,32.0,1,76,0.0,48.0,48.0
40.058,17,10,676,5,460,10013.0,104.0,64.0,5,216,10013.0,20.0,15.0
0.001,17,2,166,1,75,0.0,47.0,47.0,1,91,0.0,63.0,63.0
0.227,6,16,2778,8,1396,32.0,533.0,324.0,8,1382,20.0,529.0,239.0
240.131,6,31,9158,15,6852,17152.0,1976.0,675.0,16,2306,16008.0,580.0,183.0
240.204,6,25,7287,13,1222,20016.0,217.0,179.0,12,6065,21836.0,1679.0,777.0
0.005,6,10,1643,5,860,1.0,592.0,592.0,5,783,1.0,515.0,515.0
0.005,17,2,179,1,71,0.0,43.0,43.0,1,108,0.0,80.0,80.0
11.127,17,28,4418,14,1994,843.0,269.0,114.0,14,2424,843.0,587.0,145.0
0.091,6,10,1506,5,395,20.0,127.0,127.0,5,1111,19.0,843.0,843.0
0.033,6,10,1989,5,910,8.0,642.0,642.0,5,1079,8.0,811.0,811.0
0.014,6,10,1983,5,910,3.0,642.0,642.0,5,1073,3.0,805.0,805.0
0.005,6,14,3742,7,452,0.0,80.0,80.0,7,3290,0.0,1448.0,972.0
0.089,6,10,1506,5,395,19.0,127.0,127.0,5,1111,19.0,843.0,843.0
0.024,6,10,1983,5,910,6.0,642.0,642.0,5,1073,6.0,805.0,805.0
0.092,6,10,1506,5,395,20.0,127.0,127.0,5,1111,19.0,843.0,843.0
0.005,17,2,144,1,64,0.0,36.0,36.0,1,80,0.0,52.0,52.0
0.123,6,10,1506,5,395,29.0,127.0,127.0,5,1111,27.0,843.0,843.0
0.595,6,26,8926,14,1587,37.0,517.0,211.0,12,7339,44.0,1288.0,839.0
0.097,6,10,1506,5,395,21.0,127.0,127.0,5,1111,22.0,843.0,843.0
0.085,6,10,1506,5,395,20.0,127.0,127.0,5,1111,13.0,843.0,843.0
0.003,17,4,284,2,120,0.0,32.0,32.0,2,164,0.0,60.0,54.0
0.275,6,12,2882,6,974,55.0,642.0,642.0,6,1908,55.0,794.0,794.0
0.099,6,10,1506,5,395,21.0,127.0,127.0,5,1111,23.0,843.0,843.0
0.021,6,10,1989,5,910,5.0,642.0,642.0,5,1079,5.0,811.0,811.0
0.063,6,10,1506,5,395,13.0,127.0,127.0,5,1111,13.0,843.0,843.0
0.118,6,10,1506,5,395,25.0,127.0,127.0,5,1111,20.0,843.0,843.0
11.403,17,28,4390,14,2312,864.0,587.0,137.0,14,2078,864.0,269.0,120.0
0.786,6,22,5168,11,1138,65.0,267.0,115.0,11,4030,66.0,1414.0,597.0
0.007,6,10,1547,5,764,1.0,496.0,496.0,5,783,1.0,515.0,515.0
0.043,17,4,420,2,122,0.0,33.0,33.0,2,298,39.0,145.0,121.0
40.084,17,10,676,5,460,10018.0,104.0,64.0,5,216,10020.0,20.0,15.0
0.005,6,10,1779,5,928,1.0,660.0,660.0,5,851,1.0,583.0,583.0
0.017,6,10,1972,5,910,4.0,642.0,642.0,5,1062,4.0,794.0,794.0
0.016,6,10,1990,5,911,4.0,643.0,643.0,5,1079,4.0,811.0,811.0
0.25,17,45,25701,25,21220,10.0,1350.0,820.0,20,4481,10.0,1350.0,196.0
0.006,6,10,1547,5,764,1.0,496.0,496.0,5,783,1.0,515.0,515.0
0.003,17,4,284,2,120,0.0,32.0,32.0,2,164,0.0,60.0,54.0
240.161,6,35,13116,19,7108,13342.0,2024.0,680.0,16,6008,16010.0,2379.0,646.0
0.027,6,10,1983,5,910,6.0,642.0,642.0,5,1073,6.0,805.0,805.0
0.012,6,10,1989,5,910,3.0,642.0,642.0,5,1079,3.0,811.0,811.0
0.01,6,10,1677,5,827,2.0,559.0,559.0,5,850,2.0,582.0,582.0
0.006,17,2,148,1,60,0.0,32.0,32.0,1,88,0.0,60.0,60.0
308.722,17,20,1124,10,716,34295.0,48.0,43.0,10,408,34295.0,20.0,12.0
0.005,6,10,1774,5,923,1.0,655.0,655.0,5,851,1.0,583.0,583.0
0.014,6,10,1990,5,911,3.0,643.0,643.0,5,1079,3.0,811.0,811.0
0.005,17,2,164,1,74,0.0,46.0,46.0,1,90,0.0,62.0,62.0
240.481,6,292,337536,103,9125,2357.0,1578.0,537.0,189,328411,1279.0,2856.0,1810.0
0.024,6,10,1989,5,910,6.0,642.0,642.0,5,1079,6.0,811.0,811.0
0.022,6,10,1989,5,910,5.0,642.0,642.0,5,1079,5.0,811.0,811.0
0.001,17,2,180,1,66,0.0,38.0,38.0,1,114,0.0,86.0,86.0
0.008,6,10,1547,5,764,2.0,496.0,496.0,5,783,1.0,515.0,515.0
0.016,17,2,198,1,91,0.0,63.0,63.0,1,107,0.0,79.0,79.0
0.015,6,10,1762,5,911,3.0,643.0,643.0,5,851,3.0,583.0,583.0
0.005,17,2,164,1,74,0.0,46.0,46.0,1,90,0.0,62.0,62.0
0.008,17,2,194,1,59,0.0,31.0,31.0,1,135,0.0,107.0,107.0
0.006,17,2,140,1,62,0.0,34.0,34.0,1,78,0.0,50.0,50.0
0.029,6,14,3868,7,578,4.0,206.0,206.0,7,3290,4.0,1448.0,972.0
0.118,17,4,352,2,130,77.0,37.0,37.0,2,222,77.0,89.0,83.0
0.006,6,10,1547,5,764,1.0,496.0,496.0,5,783,1.0,515.0,515.0
0.004,6,10,2007,5,928,1.0,660.0,660.0,5,1079,1.0,811.0,811.0
0.006,6,10,1547,5,764,1.0,496.0,496.0,5,783,1.0,515.0,515.0
0.005,17,2,144,1,64,0.0,36.0,36.0,1,80,0.0,52.0,52.0
0.001,17,2,136,1,60,0.0,32.0,32.0,1,76,0.0,48.0,48.0
0.006,6,10,1779,5,928,1.0,660.0,660.0,5,851,1.0,583.0,583.0
0.006,6,10,1547,5,764,1.0,496.0,496.0,5,783,1.0,515.0,515.0
0.016,6,10,1989,5,910,3.0,642.0,642.0,5,1079,3.0,811.0,811.0
0.01,6,10,1989,5,910,2.0,642.0,642.0,5,1079,2.0,811.0,811.0
0.005,6,10,1854,5,889,1.0,621.0,621.0,5,965,1.0,697.0,697.0
0.005,6,10,2006,5,927,1.0,659.0,659.0,5,1079,1.0,811.0,811.0
0.007,17,2,179,1,71,0.0,43.0,43.0,1,108,0.0,80.0,80.0
0.004,6,10,2007,5,928,1.0,660.0,660.0,5,1079,1.0,811.0,811.0
0.022,6,10,1983,5,910,5.0,642.0,642.0,5,1073,5.0,805.0,805.0
0.093,6,10,1506,5,395,20.0,127.0,127.0,5,1111,20.0,843.0,843.0
0.005,6,10,2007,5,928,1.0,660.0,660.0,5,1079,1.0,811.0,811.0
11.011,17,26,4102,13,1846,908.0,269.0,114.0,13,2256,908.0,587.0,145.0
0.042,17,4,288,2,122,0.0,33.0,33.0,2,166,2.0,61.0,55.0
0.022,6,10,1989,5,910,5.0,642.0,642.0,5,1079,5.0,811.0,811.0
0.123,6,10,1506,5,395,26.0,127.0,127.0,5,1111,27.0,843.0,843.0
40.062,17,10,676,5,460,10014.0,104.0,64.0,5,216,10013.0,20.0,15.0
0.005,6,13,3690,7,452,0.0,80.0,80.0,6,3238,1.0,1470.0,1459.0
0.09,6,10,1506,5,395,21.0,127.0,127.0,5,1111,20.0,843.0,843.0
314.331,17,20,1124,10,716,34911.0,48.0,43.0,10,408,34911.0,20.0,12.0
0.011,6,13,3735,7,497,1.0,125.0,125.0,6,3238,2.0,1470.0,1459.0
0.004,6,10,1989,5,927,1.0,659.0,659.0,5,1062,1.0,794.0,794.0
361.749,6,21,1795,16,1030,24116.0,190.0,190.0,5,765,60010.0,464.0,248.0
15.074,17,19,10120,9,6968,1880.0,1350.0,746.0,10,3152,1671.0,1350.0,287.0
352.755,6,20,2210,6,1308,12003.0,494.0,494.0,14,902,27134.0,83.0,83.0
65.763,6,25,10408,11,3909,6576.0,1579.0,835.0,14,6499,5049.0,2111.0,576.0
0.09,6,10,1506,5,395,21.0,127.0,127.0,5,1111,21.0,843.0,843.0
0.005,17,2,170,1,65,0.0,37.0,37.0,1,105,0.0,77.0,77.0
0.015,6,10,1989,5,910,3.0,642.0,642.0,5,1079,3.0,811.0,811.0
0.038,6,10,1677,5,827,9.0,559.0,559.0,5,850,9.0,582.0,582.0
0.006,6,10,1547,5,764,1.0,496.0,496.0,5,783,1.0,515.0,515.0
0.005,6,10,1854,5,889,1.0,621.0,621.0,5,965,1.0,697.0,697.0
0.024,6,10,1972,5,910,6.0,642.0,642.0,5,1062,6.0,794.0,794.0
0.06,6,28,10299,15,8942,4.0,2261.0,1020.0,13,1357,4.0,328.0,113.0
0.178,6,10,1506,5,395,21.0,127.0,127.0,5,1111,41.0,843.0,843.0
1778.784,17,143,41496,72,22752,25052.0,288.0,288.0,71,18744,25411.0,236.0,236.0
0.004,6,10,1774,5,923,1.0,655.0,655.0,5,851,1.0,583.0,583.0
0.082,6,10,1506,5,395,17.0,127.0,127.0,5,1111,17.0,843.0,843.0
0.005,6,10,2006,5,927,1.0,659.0,659.0,5,1079,1.0,811.0,811.0
0.005,17,2,154,1,69,0.0,41.0,41.0,1,85,0.0,57.0,57.0
164.088,17,86,11879,43,2877,3906.0,44.0,38.0,43,9002,3906.0,239.0,181.0
0.014,6,10,1989,5,910,3.0,642.0,642.0,5,1079,3.0,811.0,811.0
240.327,6,35,26745,18,7111,14136.0,2736.0,1029.0,17,19634,15020.0,2804.0,1703.0
0.004,6,10,2006,5,927,1.0,659.0,659.0,5,1079,1.0,811.0,811.0
0.006,6,10,1547,5,764,1.0,496.0,496.0,5,783,1.0,515.0,515.0
0.006,6,10,1643,5,860,1.0,592.0,592.0,5,783,1.0,515.0,515.0
0.014,6,10,1631,5,848,3.0,580.0,580.0,5,783,3.0,515.0,515.0
0.005,6,13,3747,7,509,0.0,137.0,137.0,6,3238,0.0,1470.0,1459.0
0.07,6,10,1506,5,395,12.0,127.0,127.0,5,1111,17.0,843.0,843.0
0.005,17,2,144,1,64,0.0,36.0,36.0,1,80,0.0,52.0,52.0
0.005,6,10,1702,5,863,1.0,595.0,595.0,5,839,1.0,571.0,571.0
0.018,6,10,1972,5,910,4.0,642.0,642.0,5,1062,4.0,794.0,794.0
0.007,17,2,136,1,60,0.0,32.0,32.0,1,76,0.0,48.0,48.0
1772.259,6,103,6166,58,3421,31091.0,27.0,27.0,45,2745,40277.0,27.0,27.0
0.06,6,10,1506,5,395,12.0,127.0,127.0,5,1111,12.0,843.0,843.0
0.073,6,10,1506,5,395,16.0,127.0,127.0,5,1111,16.0,843.0,843.0
299.684,6,40,12493,21,6935,14975.0,2720.0,1010.0,19,5558,16637.0,2667.0,435.0
0.027,6,13,3735,7,497,4.0,125.0,125.0,6,3238,5.0,1470.0,1459.0
100.937,6,22,9233,11,1575,91.0,794.0,367.0,11,7658,10080.0,1360.0,1029.0
0.005,6,10,1643,5,860,1.0,592.0,592.0,5,783,1.0,515.0,515.0
0.017,6,10,1972,5,910,4.0,642.0,642.0,5,1062,4.0,794.0,794.0
40.102,17,10,676,5,460,10024.0,104.0,64.0,5,216,10024.0,20.0,15.0
0.005,6,10,1854,5,889,1.0,621.0,621.0,5,965,1.0,697.0,697.0
0.005,6,10,2006,5,927,1.0,659.0,659.0,5,1079,1.0,811.0,811.0
289.751,6,327,345267,125,18056,2336.0,2736.0,825.0,202,327211,1441.0,2804.0,1675.0
0.005,17,2,170,1,65,0.0,37.0,37.0,1,105,0.0,77.0,77.0
0.018,6,13,3913,7,495,2.0,123.0,123.0,6,3418,3.0,1650.0,1549.0
0.016,6,10,1972,5,910,4.0,642.0,642.0,5,1062,4.0,794.0,794.0
0.011,6,12,1926,6,1189,2.0,659.0,434.0,6,737,2.0,417.0,417.0
0.035,17,2,152,1,76,0.0,48.0,48.0,1,76,0.0,48.0,48.0
241.658,6,315,344652,117,17603,2083.0,2736.0,960.0,198,327049,1226.0,2804.0,1684.0
0.006,6,10,1547,5,764,1.0,496.0,496.0,5,783,1.0,515.0,515.0
310.107,17,20,1124,10,716,34442.0,48.0,43.0,10,408,34442.0,20.0,12.0
0.038,17,2,152,1,76,0.0,48.0,48.0,1,76,0.0,48.0,48.0
0.004,6,10,1702,5,863,1.0,595.0,595.0,5,839,1.0,571.0,571.0
10.768,17,28,4420,14,1993,819.0,268.0,114.0,14,2427,819.0,586.0,145.0
0.011,17,2,164,1,74,0.0,46.0,46.0,1,90,0.0,62.0,62.0
0.098,6,10,1506,5,395,22.0,127.0,127.0,5,1111,21.0,843.0,843.0
0.005,6,10,2000,5,927,1.0,659.0,659.0,5,1073,1.0,805.0,805.0
0.011,6,10,1990,5,911,2.0,643.0,643.0,5,1079,2.0,811.0,811.0
1721.206,6,61,7138,40,4347,44133.0,1640.0,113.0,21,2791,86052.0,1110.0,84.0
0.006,6,10,1547,5,764,1.0,496.0,496.0,5,783,1.0,515.0,515.0
292.21,6,399,348979,189,21401,1554.0,2736.0,889.0,210,327578,1398.0,2968.0,1615.0
40.055,17,10,676,5,460,10013.0,104.0,64.0,5,216,10013.0,20.0,15.0
0.014,6,10,1989,5,910,3.0,642.0,642.0,5,1079,3.0,811.0,811.0
0.072,17,2,148,1,60,0.0,32.0,32.0,1,88,0.0,60.0,60.0
0.004,17,2,136,1,60,0.0,32.0,32.0,1,76,0.0,48.0,48.0
0.005,6,10,2006,5,927,1.0,659.0,659.0,5,1079,1.0,811.0,811.0
0.011,6,10,1983,5,910,2.0,642.0,642.0,5,1073,2.0,805.0,805.0
0.015,6,10,1972,5,910,3.0,642.0,642.0,5,1062,3.0,794.0,794.0
0.008,6,10,1547,5,764,2.0,496.0,496.0,5,783,1.0,515.0,515.0
0.008,6,10,1547,5,764,2.0,496.0,496.0,5,783,1.0,515.0,515.0
0.018,6,10,1677,5,827,4.0,559.0,559.0,5,850,4.0,582.0,582.0
0.107,6,10,1506,5,395,24.0,127.0,127.0,5,1111,24.0,843.0,843.0
0.012,6,10,1983,5,910,2.0,642.0,642.0,5,1073,3.0,805.0,805.0
11.948,17,40,9284,20,4659,620.0,1291.0,204.0,20,4625,620.0,1295.0,203.0
0.014,6,10,1983,5,910,3.0,642.0,642.0,5,1073,3.0,805.0,805.0
0.088,6,10,1506,5,395,17.0,127.0,127.0,5,1111,19.0,843.0,843.0
0.102,6,10,1506,5,395,22.0,127.0,127.0,5,1111,23.0,843.0,843.0
0.013,6,10,1989,5,910,3.0,642.0,642.0,5,1079,3.0,811.0,811.0
0.088,6,10,1506,5,395,19.0,127.0,127.0,5,1111,17.0,843.0,843.0
0.017,6,10,1989,5,910,4.0,642.0,642.0,5,1079,4.0,811.0,811.0
317.058,17,20,1124,10,716,35214.0,48.0,43.0,10,408,35215.0,20.0,12.0
0.004,17,2,148,1,60,0.0,32.0,32.0,1,88,0.0,60.0,60.0
300.333,6,16,2170,9,684,37520.0,146.0,146.0,7,1486,50027.0,419.0,398.0
0.005,6,13,3747,7,509,0.0,137.0,137.0,6,3238,0.0,1470.0,1459.0
0.114,6,10,1506,5,395,26.0,127.0,127.0,5,1111,25.0,843.0,843.0
0.038,17,2,412,1,61,0.0,33.0,33.0,1,351,0.0,323.0,323.0
0.013,17,2,152,1,56,0.0,28.0,28.0,1,96,0.0,68.0,68.0
0.109,6,10,1506,5,395,22.0,127.0,127.0,5,1111,20.0,843.0,843.0
0.003,17,2,148,1,60,0.0,32.0,32.0,1,88,0.0,60.0,60.0
0.105,6,10,1506,5,395,17.0,127.0,127.0,5,1111,23.0,843.0,843.0
0.005,6,10,2006,5,927,1.0,659.0,659.0,5,1079,1.0,811.0,811.0
0.005,6,10,2007,5,928,1.0,660.0,660.0,5,1079,1.0,811.0,811.0
0.005,17,2,180,1,58,0.0,30.0,30.0,1,122,0.0,94.0,94.0
0.003,17,2,148,1,60,0.0,32.0,32.0,1,88,0.0,60.0,60.0
0.021,6,10,1989,5,910,5.0,642.0,642.0,5,1079,5.0,811.0,811.0
0.109,6,10,1506,5,395,22.0,127.0,127.0,5,1111,25.0,843.0,843.0
0.005,17,4,284,2,120,1.0,32.0,32.0,2,164,1.0,60.0,54.0
0.012,6,10,1989,5,910,3.0,642.0,642.0,5,1079,2.0,811.0,811.0
0.001,17,2,180,1,66,0.0,38.0,38.0,1,114,0.0,86.0,86.0
0.022,6,10,1983,5,910,5.0,642.0,642.0,5,1073,5.0,805.0,805.0
0.005,6,13,3690,7,452,0.0,80.0,80.0,6,3238,0.0,1470.0,1459.0
0.039,17,2,148,1,60,0.0,32.0,32.0,1,88,0.0,60.0,60.0
0.005,17,2,144,1,64,0.0,36.0,36.0,1,80,0.0,52.0,52.0
40.061,17,10,676,5,460,10012.0,104.0,64.0,5,216,10014.0,20.0,15.0
40.063,17,10,676,5,460,10015.0,104.0,64.0,5,216,10015.0,20.0,15.0
0.006,6,10,1689,5,839,1.0,571.0,571.0,5,850,1.0,582.0,582.0
0.001,17,2,180,1,66,0.0,38.0,38.0,1,114,0.0,86.0,86.0
10.662,6,32,10365,18,9098,627.0,1515.0,906.0,14,1267,819.0,295.0,89.0
0.139,6,10,1506,5,395,32.0,127.0,127.0,5,1111,32.0,843.0,843.0
0.013,6,10,1989,5,910,3.0,642.0,642.0,5,1079,3.0,811.0,811.0
0.008,6,10,1972,5,910,2.0,642.0,642.0,5,1062,1.0,794.0,794.0
0.442,6,15,2726,8,1396,63.0,533.0,324.0,7,1330,59.0,529.0,239.0
0.006,6,10,1547,5,764,1.0,496.0,496.0,5,783,1.0,515.0,515.0
0.001,17,2,180,1,66,0.0,38.0,38.0,1,114,0.0,86.0,86.0
0.008,6,10,1989,5,910,2.0,642.0,642.0,5,1079,2.0,811.0,811.0
0.011,6,12,1926,6,1189,2.0,659.0,434.0,6,737,2.0,417.0,417.0
0.005,6,10,2006,5,927,1.0,659.0,659.0,5,1079,1.0,811.0,811.0
61.883,6,37,9986,19,4468,488.0,1360.0,735.0,18,5518,3630.0,2667.0,435.0
0.018,6,14,3787,7,497,3.0,125.0,125.0,7,3290,2.0,1448.0,972.0
0.003,17,2,162,1,65,0.0,37.0,37.0,1,97,0.0,69.0,69.0
0.089,6,10,1506,5,395,19.0,127.0,127.0,5,1111,19.0,843.0,843.0
0.008,6,10,1990,5,911,2.0,643.0,643.0,5,1079,1.0,811.0,811.0
40.06,17,10,676,5,460,10012.0,104.0,64.0,5,216,10014.0,20.0,15.0
0.007,6,10,1547,5,764,1.0,496.0,496.0,5,783,1.0,515.0,515.0
0.115,6,10,1506,5,395,24.0,127.0,127.0,5,1111,27.0,843.0,843.0
10.819,17,28,4421,14,1993,823.0,268.0,114.0,14,2428,823.0,587.0,145.0
0.008,6,10,1990,5,911,2.0,643.0,643.0,5,1079,1.0,811.0,811.0
0.145,6,10,1506,5,395,31.0,127.0,127.0,5,1111,35.0,843.0,843.0
240.093,6,31,8871,15,6644,17149.0,1770.0,652.0,16,2227,16006.0,580.0,173.0
0.005,6,13,3747,7,509,0.0,137.0,137.0,6,3238,0.0,1470.0,1459.0
0.079,6,10,1506,5,395,15.0,127.0,127.0,5,1111,17.0,843.0,843.0
240.013,6,9,787,5,488,60003.0,232.0,232.0,4,299,80003.0,83.0,83.0
11.127,17,28,4421,14,1994,843.0,269.0,114.0,14,2427,843.0,586.0,145.0
0.169,17,2,152,1,76,0.0,48.0,48.0,1,76,0.0,48.0,48.0
0.108,6,10,1506,5,395,23.0,127.0,127.0,5,1111,24.0,843.0,843.0
0.005,6,10,1547,5,764,1.0,496.0,496.0,5,783,1.0,515.0,515.0
0.087,6,10,1506,5,395,19.0,127.0,127.0,5,1111,20.0,843.0,843.0
0.004,17,2,148,1,60,0.0,32.0,32.0,1,88,0.0,60.0,60.0
0.008,6,10,1762,5,911,1.0,643.0,643.0,5,851,2.0,583.0,583.0
0.007,17,2,152,1,76,0.0,48.0,48.0,1,76,0.0,48.0,48.0
0.01,6,10,1677,5,827,2.0,559.0,559.0,5,850,2.0,582.0,582.0
0.113,6,10,1506,5,395,27.0,127.0,127.0,5,1111,25.0,843.0,843.0
0.007,6,12,1698,6,863,1.0,327.0,271.0,6,835,1.0,515.0,515.0
0.005,17,2,170,1,65,0.0,37.0,37.0,1,105,0.0,77.0,77.0
0.007,6,10,1989,5,910,1.0,642.0,642.0,5,1079,1.0,811.0,811.0
40.123,17,10,676,5,460,10027.0,104.0,64.0,5,216,10028.0,20.0,15.0
11.528,17,28,4398,14,2312,874.0,587.0,137.0,14,2086,873.0,269.0,121.0
0.269,17,44,27980,26,24781,10.0,1350.0,925.0,18,3199,12.0,1350.0,149.0
240.009,6,9,787,5,488,60002.0,232.0,232.0,4,299,80002.0,83.0,83.0
0.008,6,10,1990,5,911,2.0,643.0,643.0,5,1079,2.0,811.0,811.0
0.006,6,10,1854,5,889,1.0,621.0,621.0,5,965,1.0,697.0,697.0
125.995,6,14,2938,8,2504,17965.0,1414.0,1086.0,6,434,25151.0,182.0,182.0
0.009,6,12,1926,6,1189,1.0,659.0,434.0,6,737,1.0,417.0,417.0
0.221,17,4,596,2,122,180.0,33.0,33.0,2,474,149.0,323.0,209.0
40.059,17,10,676,5,460,10012.0,104.0,64.0,5,216,10013.0,20.0,15.0
0.015,6,10,1972,5,910,3.0,642.0,642.0,5,1062,3.0,794.0,794.0
0.009,6,10,1972,5,910,2.0,642.0,642.0,5,1062,2.0,794.0,794.0
1770.386,6,83,4368,42,2210,43179.0,26.0,26.0,41,2158,44258.0,26.0,26.0
0.01,6,10,1989,5,910,2.0,642.0,642.0,5,1079,2.0,811.0,811.0
0.069,6,10,1506,5,395,15.0,127.0,127.0,5,1111,14.0,843.0,843.0
0.001,17,2,180,1,66,0.0,38.0,38.0,1,114,0.0,86.0,86.0
0.005,6,10,1989,5,927,1.0,659.0,659.0,5,1062,1.0,794.0,794.0
0.129,6,10,1506,5,395,30.0,127.0,127.0,5,1111,26.0,843.0,843.0
0.003,17,2,148,1,60,0.0,32.0,32.0,1,88,0.0,60.0,60.0
0.003,17,2,136,1,60,0.0,32.0,32.0,1,76,0.0,48.0,48.0
0.012,6,10,1989,5,910,3.0,642.0,642.0,5,1079,2.0,811.0,811.0
280.267,6,22,6035,9,1146,35032.0,267.0,156.0,13,4889,23354.0,1400.0,873.0
0.005,6,10,2000,5,927,1.0,659.0,659.0,5,1073,1.0,805.0,805.0
0.005,6,10,2000,5,927,1.0,659.0,659.0,5,1073,1.0,805.0,805.0
156.492,17,72,10184,36,2393,4471.0,44.0,38.0,36,7791,4471.0,239.0,188.0
0.12,6,10,1506,5,395,24.0,127.0,127.0,5,1111,25.0,843.0,843.0
0.017,6,10,1989,5,910,4.0,642.0,642.0,5,1079,4.0,811.0,811.0
0.028,6,10,1983,5,910,7.0,642.0,642.0,5,1073,7.0,805.0,805.0
0.006,17,2,213,1,69,0.0,41.0,41.0,1,144,0.0,116.0,116.0
0.006,6,10,2006,5,927,1.0,659.0,659.0,5,1079,1.0,811.0,811.0
0.002,17,2,180,1,66,0.0,38.0,38.0,1,114,0.0,86.0,86.0
0.004,6,10,1702,5,863,1.0,595.0,595.0,5,839,0.0,571.0,571.0
0.053,17,2,152,1,76,0.0,48.0,48.0,1,76,0.0,48.0,48.0
40.052,17,10,676,5,460,10011.0,104.0,64.0,5,216,10012.0,20.0,15.0
30.166,6,26,5923,15,1928,2154.0,517.0,260.0,11,3995,3016.0,1330.0,590.0
0.092,6,10,1506,5,395,20.0,127.0,127.0,5,1111,21.0,843.0,843.0
40.065,17,10,676,5,460,10014.0,104.0,64.0,5,216,10015.0,20.0,15.0
0.807,6,22,5168,11,1138,68.0,267.0,115.0,11,4030,67.0,1414.0,597.0
0.014,6,10,1972,5,910,3.0,642.0,642.0,5,1062,3.0,794.0,794.0
0.013,6,10,1677,5,827,3.0,559.0,559.0,5,850,3.0,582.0,582.0
26.173,6,36,9704,18,4186,523.0,1753.0,858.0,18,5518,1529.0,2667.0,435.0
0.021,17,2,166,1,75,0.0,47.0,47.0,1,91,0.0,63.0,63.0
0.013,6,10,1762,5,911,3.0,643.0,643.0,5,851,3.0,583.0,583.0
0.015,6,10,1762,5,911,3.0,643.0,643.0,5,851,3.0,583.0,583.0
0.008,6,10,1990,5,911,1.0,643.0,643.0,5,1079,2.0,811.0,811.0
0.006,6,10,1854,5,889,1.0,621.0,621.0,5,965,1.0,697.0,697.0
0.082,6,10,1506,5,395,18.0,127.0,127.0,5,1111,17.0,843.0,843.0
40.058,17,10,676,5,460,10013.0,104.0,64.0,5,216,10013.0,20.0,15.0
0.003,17,2,162,1,65,0.0,37.0,37.0,1,97,0.0,69.0,69.0
0.003,17,4,284,2,120,0.0,32.0,32.0,2,164,0.0,60.0,54.0
0.026,6,10,1983,5,910,6.0,642.0,642.0,5,1073,6.0,805.0,805.0
0.071,17,2,136,1,60,0.0,32.0,32.0,1,76,0.0,48.0,48.0
329.266,17,20,1124,10,716,36571.0,48.0,43.0,10,408,36571.0,20.0,12.0
0.01,6,13,3735,7,497,1.0,125.0,125.0,6,3238,1.0,1470.0,1459.0
0.01,6,10,1990,5,911,2.0,643.0,643.0,5,1079,2.0,811.0,811.0
0.014,6,10,1677,5,827,3.0,559.0,559.0,5,850,3.0,582.0,582.0
40.063,17,10,676,5,460,10013.0,104.0,64.0,5,216,10014.0,20.0,15.0
368.438,6,22,2313,16,867,24562.0,195.0,195.0,6,1446,4643.0,419.0,398.0
0.006,6,10,1547,5,764,1.0,496.0,496.0,5,783,1.0,515.0,515.0
0.004,6,13,3690,7,452,0.0,80.0,80.0,6,3238,0.0,1470.0,1459.0
366.009,6,20,2210,6,1308,12003.0,494.0,494.0,14,902,28154.0,83.0,83.0
0.008,17,2,179,1,71,0.0,43.0,43.0,1,108,0.0,80.0,80.0
0.005,6,14,3742,7,452,0.0,80.0,80.0,7,3290,0.0,1448.0,972.0
0.142,6,10,1506,5,395,30.0,127.0,127.0,5,1111,30.0,843.0,843.0
0.005,17,2,140,1,62,0.0,34.0,34.0,1,78,0.0,50.0,50.0
0.041,17,2,156,1,64,0.0,36.0,36.0,1,92,0.0,64.0,64.0
840.88,17,8,632,4,252,280291.0,35.0,35.0,4,380,280291.0,67.0,67.0
0.013,6,10,1989,5,910,3.0,642.0,642.0,5,1079,3.0,811.0,811.0
0.014,6,10,1989,5,910,3.0,642.0,642.0,5,1079,3.0,811.0,811.0
0.012,6,10,1972,5,910,3.0,642.0,642.0,5,1062,3.0,794.0,794.0
0.215,6,16,2674,8,1400,30.0,533.0,325.0,8,1274,19.0,529.0,212.0
0.01,6,10,1972,5,910,2.0,642.0,642.0,5,1062,2.0,794.0,794.0
0.005,17,2,214,1,75,0.0,47.0,47.0,1,139,0.0,111.0,111.0
240.117,6,31,9500,15,6968,17151.0,2091.0,688.0,16,2532,16007.0,580.0,211.0
0.005,17,2,170,1,65,0.0,37.0,37.0,1,105,0.0,77.0,77.0
0.014,17,2,214,1,75,0.0,47.0,47.0,1,139,0.0,111.0,111.0
0.075,6,10,1506,5,395,17.0,127.0,127.0,5,1111,14.0,843.0,843.0
1777.797,17,144,41760,72,22752,25039.0,288.0,288.0,72,19008,25039.0,236.0,236.0
0.008,6,13,3735,7,497,1.0,125.0,125.0,6,3238,1.0,1470.0,1459.0
319.346,17,20,1124,10,716,35471.0,48.0,43.0,10,408,35471.0,20.0,12.0
351.99,6,20,2210,6,1308,12004.0,494.0,494.0,14,902,27075.0,83.0,83.0
356.59,6,19,1691,15,978,25470.0,190.0,190.0,4,713,80005.0,497.0,497.0
0.008,6,10,1990,5,911,2.0,643.0,643.0,5,1079,2.0,811.0,811.0
0.005,17,2,175,1,65,0.0,37.0,37.0,1,110,0.0,82.0,82.0
0.006,6,10,1547,5,764,1.0,496.0,496.0,5,783,1.0,515.0,515.0
0.004,17,2,136,1,60,0.0,32.0,32.0,1,76,0.0,48.0,48.0
0.08,6,10,1506,5,395,16.0,127.0,127.0,5,1111,15.0,843.0,843.0
0.085,6,10,1506,5,395,17.0,127.0,127.0,5,1111,17.0,843.0,843.0
0.004,17,4,284,2,120,1.0,32.0,32.0,2,164,1.0,60.0,54.0
0.008,6,10,1989,5,910,2.0,642.0,642.0,5,1079,2.0,811.0,811.0
0.121,6,10,1506,5,395,24.0,127.0,127.0,5,1111,25.0,843.0,843.0
0.015,6,10,1983,5,910,3.0,642.0,642.0,5,1073,3.0,805.0,805.0
0.005,6,10,2006,5,927,1.0,659.0,659.0,5,1079,1.0,811.0,811.0
0.013,17,2,179,1,71,0.0,43.0,43.0,1,108,0.0,80.0,80.0
0.079,6,10,1506,5,395,19.0,127.0,127.0,5,1111,17.0,843.0,843.0
0.005,6,10,1643,5,860,1.0,592.0,592.0,5,783,1.0,515.0,515.0
240.015,6,9,787,5,488,60003.0,232.0,232.0,4,299,80003.0,83.0,83.0
0.126,17,2,136,1,60,0.0,32.0,32.0,1,76,0.0,48.0,48.0
0.007,17,2,179,1,71,0.0,43.0,43.0,1,108,0.0,80.0,80.0
0.079,6,10,1506,5,395,18.0,127.0,127.0,5,1111,18.0,843.0,843.0
106.06,6,21,8147,11,1985,90.0,1174.0,504.0,10,6162,11765.0,1791.0,958.0
0.006,6,10,1989,5,927,1.0,659.0,659.0,5,1062,1.0,794.0,794.0
0.134,17,2,80,1,32,0.0,4.0,4.0,1,48,0.0,20.0,20.0
0.012,6,10,1990,5,911,2.0,643.0,643.0,5,1079,3.0,811.0,811.0
0.002,17,2,148,1,60,0.0,32.0,32.0,1,88,0.0,60.0,60.0
40.061,17,10,676,5,460,10012.0,104.0,64.0,5,216,10014.0,20.0,15.0
1770.087,6,84,4422,42,2211,43171.0,27.0,27.0,42,2211,43171.0,27.0,27.0
0.016,6,10,1989,5,910,4.0,642.0,642.0,5,1079,3.0,811.0,811.0
0.241,6,10,1506,5,395,55.0,127.0,127.0,5,1111,58.0,843.0,843.0
40.058,17,10,676,5,460,10013.0,104.0,64.0,5,216,10013.0,20.0,15.0
0.005,6,10,1774,5,923,1.0,655.0,655.0,5,851,1.0,583.0,583.0
0.104,6,10,1506,5,395,24.0,127.0,127.0,5,1111,24.0,843.0,843.0
0.019,6,10,1989,5,910,4.0,642.0,642.0,5,1079,4.0,811.0,811.0
0.005,17,2,179,1,71,0.0,43.0,43.0,1,108,0.0,80.0,80.0
0.006,6,10,1547,5,764,1.0,496.0,496.0,5,783,1.0,515.0,515.0
0.009,6,10,1972,5,910,2.0,642.0,642.0,5,1062,2.0,794.0,794.0
0.051,6,10,1506,5,395,12.0,127.0,127.0,5,1111,12.0,843.0,843.0
290.634,6,324,344000,123,17944,2382.0,2736.0,888.0,201,326056,1453.0,2804.0,1696.0
0.005,17,2,166,1,75,0.0,47.0,47.0,1,91,0.0,63.0,63.0
0.011,6,10,1631,5,848,2.0,580.0,580.0,5,783,2.0,515.0,515.0
0.032,6,10,1972,5,910,8.0,642.0,642.0,5,1062,7.0,794.0,794.0
0.109,6,10,1506,5,395,22.0,127.0,127.0,5,1111,23.0,843.0,843.0
0.018,6,10,1972,5,910,4.0,642.0,642.0,5,1062,4.0,794.0,794.0
0.005,6,10,2007,5,928,1.0,660.0,660.0,5,1079,1.0,811.0,811.0
0.019,6,13,3735,7,497,3.0,125.0,125.0,6,3238,3.0,1470.0,1459.0
0.011,6,10,1990,5,911,2.0,643.0,643.0,5,1079,2.0,811.0,811.0
0.004,17,2,148,1,60,0.0,32.0,32.0,1,88,0.0,60.0,60.0
0.118,6,10,1506,5,395,25.0,127.0,127.0,5,1111,24.0,843.0,843.0
0.001,17,2,180,1,66,0.0,38.0,38.0,1,114,0.0,86.0,86.0
0.149,6,10,1506,5,395,30.0,127.0,127.0,5,1111,36.0,843.0,843.0
0.003,17,2,148,1,60,0.0,32.0,32.0,1,88,0.0,60.0,60.0
0.005,17,2,179,1,71,0.0,43.0,43.0,1,108,0.0,80.0,80.0
0.005,6,13,3747,7,509,0.0,137.0,137.0,6,3238,0.0,1470.0,1459.0
0.243,17,4,596,2,122,205.0,33.0,33.0,2,474,171.0,323.0,209.0
240.016,6,9,787,5,488,60004.0,232.0,232.0,4,299,80004.0,83.0,83.0
0.004,6,10,2000,5,927,1.0,659.0,659.0,5,1073,1.0,805.0,805.0
0.009,6,10,1972,5,910,2.0,642.0,642.0,5,1062,2.0,794.0,794.0
0.013,6,10,1972,5,910,3.0,642.0,642.0,5,1062,3.0,794.0,794.0
0.005,6,10,2006,5,927,1.0,659.0,659.0,5,1079,1.0,811.0,811.0
0.004,6,10,1779,5,928,1.0,660.0,660.0,5,851,1.0,583.0,583.0
15.08,17,18,10740,9,8290,1881.0,1350.0,893.0,9,2450,1880.0,1350.0,244.0
361.781,6,19,1688,15,978,25841.0,190.0,190.0,4,710,80013.0,494.0,494.0
0.006,17,2,230,1,68,0.0,40.0,40.0,1,162,0.0,134.0,134.0
0.005,6,10,2007,5,928,1.0,660.0,660.0,5,1079,1.0,811.0,811.0
0.013,17,2,152,1,76,0.0,48.0,48.0,1,76,0.0,48.0,48.0
0.091,6,10,1506,5,395,21.0,127.0,127.0,5,1111,21.0,843.0,843.0
240.085,6,16,4481,9,963,30010.0,238.0,166.0,7,3518,40013.0,1402.0,786.0
0.116,6,10,1506,5,395,28.0,127.0,127.0,5,1111,27.0,843.0,843.0
0.038,17,4,284,2,120,0.0,32.0,32.0,2,164,35.0,60.0,54.0
0.018,6,10,1677,5,827,4.0,559.0,559.0,5,850,4.0,582.0,582.0
0.004,6,10,1779,5,928,1.0,660.0,660.0,5,851,1.0,583.0,583.0
0.001,17,2,136,1,60,0.0,32.0,32.0,1,76,0.0,48.0,48.0
15.083,17,15,8198,8,6031,2150.0,1350.0,725.0,7,2167,2508.0,1350.0,281.0
0.006,6,10,1854,5,889,1.0,621.0,621.0,5,965,1.0,697.0,697.0
0.001,17,2,180,1,66,0.0,38.0,38.0,1,114,0.0,86.0,86.0
0.086,6,10,1506,5,395,19.0,127.0,127.0,5,1111,19.0,843.0,843.0
0.005,6,10,2000,5,927,1.0,659.0,659.0,5,1073,1.0,805.0,805.0
0.008,6,13,3735,7,497,1.0,125.0,125.0,6,3238,1.0,1470.0,1459.0
15.074,17,15,9239,8,6902,2149.0,1350.0,834.0,7,2337,2506.0,1350.0,305.0
0.024,17,2,412,1,61,0.0,33.0,33.0,1,351,0.0,323.0,323.0
0.012,6,14,3787,7,497,2.0,125.0,125.0,7,3290,1.0,1448.0,972.0
0.005,6,10,2000,5,927,1.0,659.0,659.0,5,1073,1.0,805.0,805.0
0.054,17,2,152,1,76,0.0,48.0,48.0,1,76,0.0,48.0,48.0
0.003,6,10,1702,5,863,0.0,595.0,595.0,5,839,0.0,571.0,571.0
0.127,17,2,80,1,32,0.0,4.0,4.0,1,48,0.0,20.0,20.0
0.038,17,2,136,1,60,0.0,32.0,32.0,1,76,0.0,48.0,48.0
0.005,17,2,170,1,65,0.0,37.0,37.0,1,105,0.0,77.0,77.0
0.084,6,10,1506,5,395,20.0,127.0,127.0,5,1111,17.0,843.0,843.0
0.015,6,10,1989,5,910,3.0,642.0,642.0,5,1079,3.0,811.0,811.0
0.004,17,2,148,1,60,0.0,32.0,32.0,1,88,0.0,60.0,60.0
0.087,6,10,1506,5,395,21.0,127.0,127.0,5,1111,15.0,843.0,843.0
0.005,6,10,2006,5,927,1.0,659.0,659.0,5,1079,1.0,811.0,811.0
300.359,6,16,2170,9,684,37523.0,146.0,146.0,7,1486,50031.0,419.0,398.0
0.116,6,10,1506,5,395,24.0,127.0,127.0,5,1111,26.0,843.0,843.0
0.006,6,10,1547,5,764,1.0,496.0,496.0,5,783,1.0,515.0,515.0
0.042,17,4,284,2,120,0.0,32.0,32.0,2,164,39.0,60.0,54.0
0.009,6,10,1762,5,911,2.0,643.0,643.0,5,851,2.0,583.0,583.0
0.079,6,10,1506,5,395,17.0,127.0,127.0,5,1111,18.0,843.0,843.0
0.004,6,10,1779,5,928,1.0,660.0,660.0,5,851,1.0,583.0,583.0
0.01,6,10,1990,5,911,2.0,643.0,643.0,5,1079,2.0,811.0,811.0
0.328,6,10,2349,5,395,58.0,127.0,127.0,5,1954,78.0,843.0,843.0
0.015,6,10,1677,5,827,3.0,559.0,559.0,5,850,3.0,582.0,582.0
0.08,6,10,1506,5,395,17.0,127.0,127.0,5,1111,16.0,843.0,843.0
0.001,17,2,180,1,66,0.0,38.0,38.0,1,114,0.0,86.0,86.0
0.098,6,10,1506,5,395,22.0,127.0,127.0,5,1111,19.0,843.0,843.0
0.011,6,10,1983,5,910,2.0,642.0,642.0,5,1073,2.0,805.0,805.0
0.011,6,10,1677,5,827,2.0,559.0,559.0,5,850,2.0,582.0,582.0
0.013,6,14,3787,7,497,2.0,125.0,125.0,7,3290,2.0,1448.0,972.0
0.083,6,10,1506,5,395,18.0,127.0,127.0,5,1111,17.0,843.0,843.0
0.26,17,43,26409,25,23412,10.0,1350.0,908.0,18,2997,11.0,1350.0,138.0
0.008,6,10,1989,5,910,1.0,642.0,642.0,5,1079,1.0,811.0,811.0
0.012,6,10,1983,5,910,3.0,642.0,642.0,5,1073,2.0,805.0,805.0
0.004,6,10,1774,5,923,1.0,655.0,655.0,5,851,1.0,583.0,583.0
0.009,6,13,3735,7,497,1.0,125.0,125.0,6,3238,1.0,1470.0,1459.0
0.018,6,13,3735,7,497,3.0,125.0,125.0,6,3238,3.0,1470.0,1459.0
0.005,6,10,1779,5,928,1.0,660.0,660.0,5,851,1.0,583.0,583.0
0.004,6,10,1702,5,863,1.0,595.0,595.0,5,839,0.0,571.0,571.0
0.005,6,10,2000,5,927,1.0,659.0,659.0,5,1073,1.0,805.0,805.0
0.005,6,10,1702,5,863,1.0,595.0,595.0,5,839,1.0,571.0,571.0
0.005,6,10,1643,5,860,1.0,592.0,592.0,5,783,1.0,515.0,515.0
0.011,6,14,3787,7,497,1.0,125.0,125.0,7,3290,1.0,1448.0,972.0
0.016,6,10,1989,5,910,3.0,642.0,642.0,5,1079,3.0,811.0,811.0
0.078,6,10,1506,5,395,17.0,127.0,127.0,5,1111,16.0,843.0,843.0
11.171,17,28,4420,14,1993,847.0,268.0,114.0,14,2427,846.0,586.0,145.0
15.074,17,15,9239,8,6902,2149.0,1350.0,834.0,7,2337,2507.0,1350.0,305.0
40.063,17,10,676,5,460,10014.0,104.0,64.0,5,216,10015.0,20.0,15.0
0.013,6,10,1677,5,827,3.0,559.0,559.0,5,850,3.0,582.0,582.0
0.012,6,10,1972,5,910,3.0,642.0,642.0,5,1062,3.0,794.0,794.0
0.016,6,10,1989,5,910,4.0,642.0,642.0,5,1079,4.0,811.0,811.0
0.012,6,10,1762,5,911,3.0,643.0,643.0,5,851,3.0,583.0,583.0
0.006,6,10,1689,5,839,1.0,571.0,571.0,5,850,1.0,582.0,582.0
0.017,6,10,1989,5,910,4.0,642.0,642.0,5,1079,4.0,811.0,811.0
0.005,17,2,214,1,75,0.0,47.0,47.0,1,139,0.0,111.0,111.0
0.273,17,4,596,2,122,145.0,33.0,33.0,2,474,232.0,323.0,209.0
0.08,6,10,1506,5,395,16.0,127.0,127.0,5,1111,17.0,843.0,843.0
0.104,6,10,1506,5,395,22.0,127.0,127.0,5,1111,22.0,843.0,843.0
0.006,6,10,1689,5,839,1.0,571.0,571.0,5,850,1.0,582.0,582.0
0.013,6,10,1989,5,910,3.0,642.0,642.0,5,1079,3.0,811.0,811.0
0.088,6,10,1506,5,395,21.0,127.0,127.0,5,1111,21.0,843.0,843.0
0.108,6,10,1506,5,395,18.0,127.0,127.0,5,1111,24.0,843.0,843.0
0.008,6,10,1989,5,910,2.0,642.0,642.0,5,1079,2.0,811.0,811.0
0.005,6,10,1774,5,923,1.0,655.0,655.0,5,851,1.0,583.0,583.0
240.181,6,17,7292,9,2024,30022.0,1496.0,780.0,8,5268,34311.0,2804.0,1211.0
0.006,6,10,1547,5,764,1.0,496.0,496.0,5,783,1.0,515.0,515.0
40.061,17,10,676,5,460,10014.0,104.0,64.0,5,216,10014.0,20.0,15.0
0.04,17,2,156,1,64,0.0,36.0,36.0,1,92,0.0,64.0,64.0
0.004,6,15,3794,8,504,0.0,80.0,80.0,7,3290,0.0,1448.0,972.0
0.001,17,2,180,1,66,0.0,38.0,38.0,1,114,0.0,86.0,86.0
0.007,6,10,1983,5,910,1.0,642.0,642.0,5,1073,1.0,805.0,805.0
0.006,6,10,1547,5,764,1.0,496.0,496.0,5,783,1.0,515.0,515.0
0.007,17,2,194,1,59,0.0,31.0,31.0,1,135,0.0,107.0,107.0
0.128,6,10,1506,5,395,29.0,127.0,127.0,5,1111,27.0,843.0,843.0
0.021,6,14,3787,7,497,3.0,125.0,125.0,7,3290,3.0,1448.0,972.0
1773.208,6,105,6270,60,3525,30053.0,27.0,27.0,45,2745,40299.0,27.0,27.0
40.054,17,10,676,5,460,10012.0,104.0,64.0,5,216,10012.0,20.0,15.0
0.005,6,10,2007,5,928,1.0,660.0,660.0,5,1079,1.0,811.0,811.0
0.005,6,10,1689,5,839,1.0,571.0,571.0,5,850,1.0,582.0,582.0
0.1,6,10,1506,5,395,21.0,127.0,127.0,5,1111,24.0,843.0,843.0
0.005,6,10,1774,5,923,1.0,655.0,655.0,5,851,1.0,583.0,583.0
280.411,6,23,6075,10,1186,31156.0,267.0,156.0,13,4889,23366.0,1400.0,873.0
0.02,6,10,1972,5,910,4.0,642.0,642.0,5,1062,4.0,794.0,794.0
0.014,6,10,1990,5,911,3.0,643.0,643.0,5,1079,3.0,811.0,811.0
0.009,6,10,1547,5,764,2.0,496.0,496.0,5,783,2.0,515.0,515.0
0.011,6,10,1989,5,910,2.0,642.0,642.0,5,1079,2.0,811.0,811.0
0.005,6,10,2006,5,927,1.0,659.0,659.0,5,1079,1.0,811.0,811.0
0.013,6,10,1762,5,911,3.0,643.0,643.0,5,851,3.0,583.0,583.0
0.006,6,10,1547,5,764,1.0,496.0,496.0,5,783,1.0,515.0,515.0
0.11,6,10,1506,5,395,22.0,127.0,127.0,5,1111,24.0,843.0,843.0
0.072,6,10,1972,5,910,17.0,642.0,642.0,5,1062,17.0,794.0,794.0
0.091,6,10,1506,5,395,20.0,127.0,127.0,5,1111,20.0,843.0,843.0
0.114,6,10,1506,5,395,21.0,127.0,127.0,5,1111,27.0,843.0,843.0
0.01,6,10,1989,5,910,2.0,642.0,642.0,5,1079,2.0,811.0,811.0
0.108,6,10,1506,5,395,23.0,127.0,127.0,5,1111,25.0,843.0,843.0
0.231,6,16,2782,8,1400,33.0,533.0,325.0,8,1382,20.0,529.0,239.0
0.001,17,2,180,1,65,0.0,37.0,37.0,1,115,0.0,87.0,87.0
0.005,6,10,2006,5,927,1.0,659.0,659.0,5,1079,1.0,811.0,811.0
0.005,17,2,144,1,64,0.0,36.0,36.0,1,80,0.0,52.0,52.0
0.013,6,10,1989,5,910,3.0,642.0,642.0,5,1079,3.0,811.0,811.0
0.008,17,2,194,1,59,0.0,31.0,31.0,1,135,0.0,107.0,107.0
0.006,6,10,1854,5,889,1.0,621.0,621.0,5,965,1.0,697.0,697.0
0.004,6,10,2007,5,928,1.0,660.0,660.0,5,1079,1.0,811.0,811.0
0.009,6,12,1926,6,1189,1.0,659.0,434.0,6,737,1.0,417.0,417.0
0.012,6,10,1762,5,911,3.0,643.0,643.0,5,851,2.0,583.0,583.0
0.014,6,10,1677,5,827,3.0,559.0,559.0,5,850,3.0,582.0,582.0
0.002,17,2,166,1,75,0.0,47.0,47.0,1,91,0.0,63.0,63.0
0.009,6,10,1762,5,911,2.0,643.0,643.0,5,851,2.0,583.0,583.0
0.004,6,10,2006,5,927,1.0,659.0,659.0,5,1079,1.0,811.0,811.0
0.041,6,10,1631,5,848,10.0,580.0,580.0,5,783,10.0,515.0,515.0
0.013,6,10,1762,5,911,3.0,643.0,643.0,5,851,3.0,583.0,583.0
0.009,6,10,1989,5,910,2.0,642.0,642.0,5,1079,2.0,811.0,811.0
0.006,17,2,148,1,60,0.0,32.0,32.0,1,88,0.0,60.0,60.0
0.005,6,14,3742,8,504,0.0,80.0,80.0,6,3238,0.0,1470.0,1459.0
0.003,17,2,234,1,61,0.0,33.0,33.0,1,173,0.0,145.0,145.0
0.015,6,10,1631,5,848,3.0,580.0,580.0,5,783,3.0,515.0,515.0
0.065,17,8,3613,4,1874,21.0,1350.0,440.0,4,1739,10.0,1350.0,406.0
0.031,6,10,1989,5,910,7.0,642.0,642.0,5,1079,7.0,811.0,811.0
0.008,6,13,3735,7,497,1.0,125.0,125.0,6,3238,1.0,1470.0,1459.0
0.005,6,10,1989,5,927,1.0,659.0,659.0,5,1062,1.0,794.0,794.0
0.005,6,10,1689,5,839,1.0,571.0,571.0,5,850,1.0,582.0,582.0
0.005,17,2,214,1,75,0.0,47.0,47.0,1,139,0.0,111.0,111.0
0.069,17,8,3613,4,1874,23.0,1350.0,440.0,4,1739,11.0,1350.0,406.0
15.071,17,15,9238,8,6902,2148.0,1350.0,834.0,7,2336,2507.0,1350.0,305.0
308.507,17,18,1036,10,716,34278.0,48.0,43.0,8,320,37776.0,12.0,12.0
0.006,6,10,1854,5,889,1.0,621.0,621.0,5,965,1.0,697.0,697.0
0.071,6,10,1506,5,395,16.0,127.0,127.0,5,1111,15.0,843.0,843.0
0.018,6,10,1989,5,910,4.0,642.0,642.0,5,1079,4.0,811.0,811.0
0.005,6,10,2007,5,928,1.0,660.0,660.0,5,1079,1.0,811.0,811.0
300.8,6,43,14254,24,8696,13078.0,1360.0,856.0,19,5558,479.0,2667.0,435.0
334.213,17,20,1124,10,716,37121.0,48.0,43.0,10,408,37121.0,20.0,12.0
0.005,6,10,1643,5,860,1.0,592.0,592.0,5,783,1.0,515.0,515.0
0.081,6,10,1506,5,395,16.0,127.0,127.0,5,1111,18.0,843.0,843.0
0.014,6,10,1990,5,911,3.0,643.0,643.0,5,1079,3.0,811.0,811.0
0.005,6,10,1989,5,927,1.0,659.0,659.0,5,1062,1.0,794.0,794.0
0.005,6,10,1689,5,839,1.0,571.0,571.0,5,850,1.0,582.0,582.0
0.005,6,10,2000,5,927,1.0,659.0,659.0,5,1073,1.0,805.0,805.0
0.004,17,2,154,1,69,0.0,41.0,41.0,1,85,0.0,57.0,57.0
0.005,17,2,169,1,62,0.0,34.0,34.0,1,107,0.0,79.0,79.0
0.009,6,10,1983,5,910,2.0,642.0,642.0,5,1073,2.0,805.0,805.0
40.062,17,10,676,5,460,10014.0,104.0,64.0,5,216,10014.0,20.0,15.0
10.836,17,28,4419,14,1995,825.0,270.0,114.0,14,2424,825.0,587.0,145.0
0.004,6,10,1779,5,928,1.0,660.0,660.0,5,851,1.0,583.0,583.0
0.005,6,13,3690,7,452,0.0,80.0,80.0,6,3238,0.0,1470.0,1459.0
0.012,6,10,1989,5,910,3.0,642.0,642.0,5,1079,3.0,811.0,811.0
0.004,17,4,284,2,120,0.0,32.0,32.0,2,164,1.0,60.0,54.0
0.005,6,10,1702,5,863,1.0,595.0,595.0,5,839,1.0,571.0,571.0
40.056,17,10,676,5,460,10012.0,104.0,64.0,5,216,10013.0,20.0,15.0
0.012,6,10,1989,5,910,3.0,642.0,642.0,5,1079,2.0,811.0,811.0
0.006,6,10,1547,5,764,1.0,496.0,496.0,5,783,1.0,515.0,515.0
40.06,17,10,676,5,460,10012.0,104.0,64.0,5,216,10014.0,20.0,15.0
0.011,6,10,1990,5,911,2.0,643.0,643.0,5,1079,2.0,811.0,811.0
0.011,6,10,1983,5,910,2.0,642.0,642.0,5,1073,2.0,805.0,805.0
0.001,17,2,166,1,75,0.0,47.0,47.0,1,91,0.0,63.0,63.0
0.004,6,10,1779,5,928,1.0,660.0,660.0,5,851,1.0,583.0,583.0
0.001,17,2,180,1,66,0.0,38.0,38.0,1,114,0.0,86.0,86.0
0.074,6,10,1506,5,395,16.0,127.0,127.0,5,1111,16.0,843.0,843.0
0.005,6,10,2006,5,927,1.0,659.0,659.0,5,1079,1.0,811.0,811.0
0.018,6,10,1677,5,827,4.0,559.0,559.0,5,850,4.0,582.0,582.0
0.013,6,10,1983,5,910,3.0,642.0,642.0,5,1073,3.0,805.0,805.0
0.09,6,10,1506,5,395,21.0,127.0,127.0,5,1111,22.0,843.0,843.0
0.093,6,10,1506,5,395,22.0,127.0,127.0,5,1111,19.0,843.0,843.0
0.014,6,10,1990,5,911,3.0,643.0,643.0,5,1079,3.0,811.0,811.0
0.015,6,10,1983,5,910,3.0,642.0,642.0,5,1073,3.0,805.0,805.0
0.005,6,10,2006,5,927,1.0,659.0,659.0,5,1079,1.0,811.0,811.0
0.006,6,10,1643,5,860,1.0,592.0,592.0,5,783,1.0,515.0,515.0
0.121,6,10,1506,5,395,29.0,127.0,127.0,5,1111,25.0,843.0,843.0
0.019,6,10,1972,5,910,4.0,642.0,642.0,5,1062,4.0,794.0,794.0
0.015,6,10,1677,5,827,3.0,559.0,559.0,5,850,3.0,582.0,582.0
0.008,6,13,3735,7,497,1.0,125.0,125.0,6,3238,1.0,1470.0,1459.0
0.012,6,10,1990,5,911,2.0,643.0,643.0,5,1079,2.0,811.0,811.0
0.012,6,10,1677,5,827,3.0,559.0,559.0,5,850,3.0,582.0,582.0
0.101,6,10,1506,5,395,20.0,127.0,127.0,5,1111,23.0,843.0,843.0
0.005,6,10,1989,5,927,1.0,659.0,659.0,5,1062,1.0,794.0,794.0
0.085,6,10,1506,5,395,18.0,127.0,127.0,5,1111,19.0,843.0,843.0
0.005,6,10,2007,5,928,1.0,660.0,660.0,5,1079,1.0,811.0,811.0
0.005,17,2,136,1,60,0.0,32.0,32.0,1,76,0.0,48.0,48.0
0.042,17,2,136,1,60,0.0,32.0,32.0,1,76,0.0,48.0,48.0
0.073,6,10,1506,5,395,15.0,127.0,127.0,5,1111,12.0,843.0,843.0
0.006,17,2,230,1,68,0.0,40.0,40.0,1,162,0.0,134.0,134.0
0.116,6,10,1506,5,395,28.0,127.0,127.0,5,1111,25.0,843.0,843.0
0.005,17,2,169,1,62,0.0,34.0,34.0,1,107,0.0,79.0,79.0
0.122,6,10,1506,5,395,27.0,127.0,127.0,5,1111,28.0,843.0,843.0
0.108,6,10,1506,5,395,19.0,127.0,127.0,5,1111,23.0,843.0,843.0
0.007,6,10,2007,5,928,1.0,660.0,660.0,5,1079,1.0,811.0,811.0
0.006,6,10,1854,5,889,1.0,621.0,621.0,5,965,1.0,697.0,697.0
0.012,6,10,1990,5,911,3.0,643.0,643.0,5,1079,2.0,811.0,811.0
0.027,6,12,4064,7,692,4.0,316.0,316.0,5,3372,5.0,1702.0,1552.0
0.148,6,10,1506,5,395,35.0,127.0,127.0,5,1111,34.0,843.0,843.0
0.008,17,2,170,1,65,0.0,37.0,37.0,1,105,0.0,77.0,77.0
0.004,6,10,1989,5,927,1.0,659.0,659.0,5,1062,1.0,794.0,794.0
0.011,6,10,1989,5,910,2.0,642.0,642.0,5,1079,2.0,811.0,811.0
0.012,6,10,1989,5,910,2.0,642.0,642.0,5,1079,2.0,811.0,811.0
0.004,17,2,136,1,60,0.0,32.0,32.0,1,76,0.0,48.0,48.0
0.072,17,2,184,1,61,0.0,33.0,33.0,1,123,0.0,95.0,95.0
0.008,6,10,1983,5,910,2.0,642.0,642.0,5,1073,2.0,805.0,805.0
0.151,6,10,1506,5,395,33.0,127.0,127.0,5,1111,33.0,843.0,843.0
0.014,6,10,1989,5,910,3.0,642.0,642.0,5,1079,3.0,811.0,811.0
0.005,6,10,1689,5,839,1.0,571.0,571.0,5,850,1.0,582.0,582.0
240.018,6,17,2480,9,1177,30002.0,563.0,178.0,8,1303,34287.0,580.0,219.0
0.014,6,10,1989,5,910,3.0,642.0,642.0,5,1079,3.0,811.0,811.0
0.005,6,10,2006,5,927,1.0,659.0,659.0,5,1079,1.0,811.0,811.0
353.993,6,21,1795,16,1030,23599.0,190.0,190.0,5,765,60001.0,464.0,248.0
300.811,6,39,9734,21,4171,15040.0,2903.0,821.0,18,5563,508.0,2667.0,402.0
0.006,6,10,1547,5,764,1.0,496.0,496.0,5,783,1.0,515.0,515.0
371.439,6,22,2313,16,867,24762.0,195.0,195.0,6,1446,4642.0,419.0,398.0
289.347,6,26,8944,12,2362,26300.0,663.0,346.0,14,6582,22254.0,1402.0,732.0
1.018,6,13,3922,7,2139,127.0,1328.0,923.0,6,1783,153.0,1539.0,1539.0
300.02,6,12,1782,7,1348,50003.0,494.0,494.0,5,434,75004.0,83.0,83.0
40.062,17,10,676,5,460,10012.0,104.0,64.0,5,216,10014.0,20.0,15.0
0.005,6,14,3742,7,452,0.0,80.0,80.0,7,3290,0.0,1448.0,972.0
0.004,17,2,136,1,60,0.0,32.0,32.0,1,76,0.0,48.0,48.0
0.023,6,10,1983,5,910,5.0,642.0,642.0,5,1073,5.0,805.0,805.0
301.241,6,57,25433,28,19246,11157.0,3005.0,1507.0,29,6187,323.0,1360.0,358.0
0.001,17,2,146,1,65,0.0,37.0,37.0,1,81,0.0,53.0,53.0
0.004,6,10,1989,5,927,1.0,659.0,659.0,5,1062,1.0,794.0,794.0
0.004,17,4,284,2,120,0.0,32.0,32.0,2,164,0.0,60.0,54.0
0.089,6,10,1506,5,395,20.0,127.0,127.0,5,1111,16.0,843.0,843.0
0.005,6,10,1774,5,923,1.0,655.0,655.0,5,851,1.0,583.0,583.0
0.005,6,10,2006,5,927,1.0,659.0,659.0,5,1079,1.0,811.0,811.0
240.486,6,35,8925,18,2071,14145.0,692.0,225.0,17,6854,15030.0,1402.0,597.0
0.001,17,2,180,1,66,0.0,38.0,38.0,1,114,0.0,86.0,86.0
0.009,6,12,1926,6,1189,1.0,659.0,434.0,6,737,1.0,417.0,417.0
0.011,6,10,1989,5,910,2.0,642.0,642.0,5,1079,2.0,811.0,811.0
361.88,6,21,1795,16,1030,24125.0,190.0,190.0,5,765,60010.0,464.0,248.0
300.403,6,16,2170,9,684,37529.0,146.0,146.0,7,1486,50039.0,419.0,398.0
0.018,6,10,1677,5,827,4.0,559.0,559.0,5,850,4.0,582.0,582.0
0.006,17,2,170,1,65,0.0,37.0,37.0,1,105,0.0,77.0,77.0
0.092,6,10,1506,5,395,22.0,127.0,127.0,5,1111,20.0,843.0,843.0
0.005,17,2,144,1,64,0.0,36.0,36.0,1,80,0.0,52.0,52.0
0.001,17,2,136,1,60,0.0,32.0,32.0,1,76,0.0,48.0,48.0
0.015,6,10,1972,5,910,3.0,642.0,642.0,5,1062,3.0,794.0,794.0
0.014,6,10,1972,5,910,3.0,642.0,642.0,5,1062,3.0,794.0,794.0
0.011,6,10,1631,5,848,2.0,580.0,580.0,5,783,2.0,515.0,515.0
0.005,6,10,1854,5,889,1.0,621.0,621.0,5,965,1.0,697.0,697.0
0.005,17,2,230,1,68,0.0,40.0,40.0,1,162,0.0,134.0,134.0
0.054,17,2,152,1,76,0.0,48.0,48.0,1,76,0.0,48.0,48.0
0.004,6,10,1989,5,927,1.0,659.0,659.0,5,1062,1.0,794.0,794.0
40.066,17,10,676,5,460,10015.0,104.0,64.0,5,216,10015.0,20.0,15.0
0.018,6,10,1989,5,910,4.0,642.0,642.0,5,1079,4.0,811.0,811.0
0.012,6,10,1972,5,910,3.0,642.0,642.0,5,1062,2.0,794.0,794.0
0.01,6,10,1989,5,910,2.0,642.0,642.0,5,1079,2.0,811.0,811.0
0.006,6,10,1854,5,889,1.0,621.0,621.0,5,965,1.0,697.0,697.0
0.101,6,10,1506,5,395,20.0,127.0,127.0,5,1111,21.0,843.0,843.0
0.006,17,2,230,1,68,0.0,40.0,40.0,1,162,0.0,134.0,134.0
0.006,6,10,1547,5,764,1.0,496.0,496.0,5,783,1.0,515.0,515.0
0.01,6,10,1972,5,910,2.0,642.0,642.0,5,1062,2.0,794.0,794.0
312.472,17,20,1124,10,716,34712.0,48.0,43.0,10,408,34712.0,20.0,12.0
0.125,6,10,1506,5,395,28.0,127.0,127.0,5,1111,29.0,843.0,843.0
0.003,17,2,136,1,60,0.0,32.0,32.0,1,76,0.0,48.0,48.0
0.005,6,10,2000,5,927,1.0,659.0,659.0,5,1073,1.0,805.0,805.0
0.011,6,10,1989,5,910,2.0,642.0,642.0,5,1079,2.0,811.0,811.0
240.081,6,16,4481,9,963,30010.0,238.0,166.0,7,3518,40013.0,1402.0,786.0
0.006,17,2,170,1,65,0.0,37.0,37.0,1,105,0.0,77.0,77.0
0.078,6,10,1506,5,395,18.0,127.0,127.0,5,1111,19.0,843.0,843.0
0.155,6,10,1506,5,395,38.0,127.0,127.0,5,1111,35.0,843.0,843.0
0.011,6,10,1990,5,911,2.0,643.0,643.0,5,1079,2.0,811.0,811.0
0.005,6,10,2006,5,927,1.0,659.0,659.0,5,1079,1.0,811.0,811.0
0.009,6,10,1990,5,911,2.0,643.0,643.0,5,1079,2.0,811.0,811.0
0.006,17,2,166,1,75,0.0,47.0,47.0,1,91,0.0,63.0,63.0
0.005,6,10,1774,5,923,1.0,655.0,655.0,5,851,1.0,583.0,583.0
10.822,17,28,4421,14,1994,823.0,269.0,114.0,14,2427,823.0,586.0,145.0
0.089,6,10,1506,5,395,18.0,127.0,127.0,5,1111,20.0,843.0,843.0
0.005,6,10,2007,5,928,1.0,660.0,660.0,5,1079,1.0,811.0,811.0
0.084,6,10,1506,5,395,18.0,127.0,127.0,5,1111,15.0,843.0,843.0
0.005,6,10,1989,5,927,1.0,659.0,659.0,5,1062,1.0,794.0,794.0
300.187,6,37,9597,19,4079,16667.0,2903.0,821.0,18,5518,17647.0,2667.0,435.0
0.04,17,2,412,1,61,0.0,33.0,33.0,1,351,0.0,323.0,323.0
0.01,6,10,1972,5,910,2.0,642.0,642.0,5,1062,2.0,794.0,794.0
0.006,6,10,1547,5,764,1.0,496.0,496.0,5,783,1.0,515.0,515.0
0.005,6,14,3799,7,509,0.0,137.0,137.0,7,3290,0.0,1448.0,972.0
0.004,6,10,2007,5,928,1.0,660.0,660.0,5,1079,1.0,811.0,811.0
0.104,6,10,1506,5,395,24.0,127.0,127.0,5,1111,22.0,843.0,843.0
0.091,6,10,1506,5,395,18.0,127.0,127.0,5,1111,19.0,843.0,843.0
178.47,17,82,11725,41,2744,4461.0,44.0,38.0,41,8981,4461.0,239.0,191.0
0.007,6,10,1983,5,910,1.0,642.0,642.0,5,1073,1.0,805.0,805.0
0.073,6,10,1506,5,395,17.0,127.0,127.0,5,1111,15.0,843.0,843.0
300.316,6,16,2170,9,684,37519.0,146.0,146.0,7,1486,50025.0,419.0,398.0
0.009,6,10,1983,5,910,2.0,642.0,642.0,5,1073,2.0,805.0,805.0
0.021,6,10,1990,5,911,5.0,643.0,643.0,5,1079,5.0,811.0,811.0
0.111,6,10,1506,5,395,26.0,127.0,127.0,5,1111,25.0,843.0,843.0
0.066,6,10,1506,5,395,14.0,127.0,127.0,5,1111,14.0,843.0,843.0
0.017,6,10,1990,5,911,4.0,643.0,643.0,5,1079,4.0,811.0,811.0
0.004,6,10,1774,5,923,1.0,655.0,655.0,5,851,1.0,583.0,583.0
0.005,17,2,225,1,65,0.0,37.0,37.0,1,160,0.0,132.0,132.0
0.001,17,2,136,1,60,0.0,32.0,32.0,1,76,0.0,48.0,48.0
0.114,6,10,1506,5,395,23.0,127.0,127.0,5,1111,26.0,843.0,843.0
0.004,6,10,2007,5,928,1.0,660.0,660.0,5,1079,1.0,811.0,811.0
0.001,17,2,180,1,66,0.0,38.0,38.0,1,114,0.0,86.0,86.0
0.005,6,10,2007,5,928,1.0,660.0,660.0,5,1079,1.0,811.0,811.0
0.071,17,2,170,1,65,0.0,37.0,37.0,1,105,0.0,77.0,77.0
0.005,6,10,1989,5,927,1.0,659.0,659.0,5,1062,1.0,794.0,794.0
0.001,17,2,180,1,66,0.0,38.0,38.0,1,114,0.0,86.0,86.0
0.007,6,10,2006,5,927,1.0,659.0,659.0,5,1079,1.0,811.0,811.0
300.377,6,16,2170,9,684,37526.0,146.0,146.0,7,1486,50032.0,419.0,398.0
0.005,6,10,1854,5,889,1.0,621.0,621.0,5,965,1.0,697.0,697.0
0.006,6,10,1547,5,764,1.0,496.0,496.0,5,783,1.0,515.0,515.0
0.013,6,10,1990,5,911,3.0,643.0,643.0,5,1079,3.0,811.0,811.0
0.006,6,10,1547,5,764,1.0,496.0,496.0,5,783,1.0,515.0,515.0
0.007,17,2,194,1,59,0.0,31.0,31.0,1,135,0.0,107.0,107.0
0.004,17,2,148,1,60,0.0,32.0,32.0,1,88,0.0,60.0,60.0
0.016,6,10,1972,5,910,4.0,642.0,642.0,5,1062,4.0,794.0,794.0
0.003,17,4,284,2,120,0.0,32.0,32.0,2,164,0.0,60.0,54.0
0.069,17,8,3613,4,1874,23.0,1350.0,440.0,4,1739,12.0,1350.0,406.0
0.034,17,2,152,1,76,0.0,48.0,48.0,1,76,0.0,48.0,48.0
0.004,6,10,2006,5,927,1.0,659.0,659.0,5,1079,1.0,811.0,811.0
15.075,17,15,9238,8,6902,2149.0,1350.0,834.0,7,2336,2507.0,1350.0,305.0
0.005,6,10,1689,5,839,1.0,571.0,571.0,5,850,1.0,582.0,582.0
1771.235,6,64,7344,42,4469,43200.0,1625.0,108.0,22,2875,84336.0,1111.0,82.0
0.105,6,10,1506,5,395,24.0,127.0,127.0,5,1111,22.0,843.0,843.0
0.008,6,10,1972,5,910,2.0,642.0,642.0,5,1062,2.0,794.0,794.0
0.035,17,2,152,1,76,0.0,48.0,48.0,1,76,0.0,48.0,48.0
330.952,17,20,1124,10,716,36758.0,48.0,43.0,10,408,36758.0,20.0,12.0
0.005,17,2,166,1,75,0.0,47.0,47.0,1,91,0.0,63.0,63.0
0.005,6,13,3747,7,509,0.0,137.0,137.0,6,3238,0.0,1470.0,1459.0
0.004,6,10,1779,5,928,1.0,660.0,660.0,5,851,1.0,583.0,583.0
9.038,17,6,376,5,280,2259.0,28.0,28.0,1,96,0.0,68.0,68.0
0.006,6,10,1643,5,860,1.0,592.0,592.0,5,783,1.0,515.0,515.0
0.005,6,10,1689,5,839,1.0,571.0,571.0,5,850,1.0,582.0,582.0
0.01,6,12,1926,6,1189,1.0,659.0,434.0,6,737,2.0,417.0,417.0
0.005,17,2,222,1,65,0.0,37.0,37.0,1,157,0.0,129.0,129.0
0.013,6,13,3735,7,497,2.0,125.0,125.0,6,3238,2.0,1470.0,1459.0
0.006,17,2,230,1,68,0.0,40.0,40.0,1,162,0.0,134.0,134.0
0.015,6,10,1972,5,910,3.0,642.0,642.0,5,1062,3.0,794.0,794.0
0.001,17,2,136,1,60,0.0,32.0,32.0,1,76,0.0,48.0,48.0
0.008,6,10,1983,5,910,2.0,642.0,642.0,5,1073,2.0,805.0,805.0
0.004,6,10,2006,5,927,1.0,659.0,659.0,5,1079,1.0,811.0,811.0
0.014,6,10,1972,5,910,3.0,642.0,642.0,5,1062,3.0,794.0,794.0
0.006,6,10,2006,5,927,1.0,659.0,659.0,5,1079,1.0,811.0,811.0
0.02,17,2,194,1,59,0.0,31.0,31.0,1,135,0.0,107.0,107.0
0.003,6,10,1702,5,863,0.0,595.0,595.0,5,839,0.0,571.0,571.0
0.005,6,10,2007,5,928,1.0,660.0,660.0,5,1079,1.0,811.0,811.0
0.106,6,10,1506,5,395,19.0,127.0,127.0,5,1111,22.0,843.0,843.0
0.108,6,10,1506,5,395,23.0,127.0,127.0,5,1111,24.0,843.0,843.0
0.068,17,8,3613,4,1874,22.0,1350.0,440.0,4,1739,11.0,1350.0,406.0
0.04,17,2,170,1,65,0.0,37.0,37.0,1,105,0.0,77.0,77.0
0.006,6,10,1689,5,839,1.0,571.0,571.0,5,850,1.0,582.0,582.0
1777.795,6,303,43187,126,25478,14221.0,1939.0,205.0,177,17709,10100.0,1360.0,131.0
0.069,6,10,1506,5,395,15.0,127.0,127.0,5,1111,14.0,843.0,843.0
0.008,6,10,1990,5,911,1.0,643.0,643.0,5,1079,1.0,811.0,811.0
85.816,6,22,9233,11,1575,94.0,794.0,367.0,11,7658,8565.0,1360.0,1029.0
0.111,6,10,1506,5,395,27.0,127.0,127.0,5,1111,24.0,843.0,843.0
0.02,6,10,1972,5,910,5.0,642.0,642.0,5,1062,5.0,794.0,794.0
11.285,17,28,4423,14,1995,855.0,270.0,114.0,14,2428,855.0,587.0,145.0
0.082,6,10,1506,5,395,17.0,127.0,127.0,5,1111,18.0,843.0,843.0
0.001,17,2,180,1,66,0.0,38.0,38.0,1,114,0.0,86.0,86.0
0.009,6,10,1972,5,910,2.0,642.0,642.0,5,1062,2.0,794.0,794.0
0.012,6,10,1972,5,910,3.0,642.0,642.0,5,1062,2.0,794.0,794.0
0.022,6,10,1677,5,827,5.0,559.0,559.0,5,850,5.0,582.0,582.0
0.074,6,10,1506,5,395,17.0,127.0,127.0,5,1111,15.0,843.0,843.0
0.077,6,10,1506,5,395,17.0,127.0,127.0,5,1111,14.0,843.0,843.0
40.068,17,10,676,5,460,10016.0,104.0,64.0,5,216,10016.0,20.0,15.0
0.014,6,10,1989,5,910,3.0,642.0,642.0,5,1079,3.0,811.0,811.0
329.136,17,20,1124,10,716,36564.0,48.0,43.0,10,408,36564.0,20.0,12.0
0.019,6,10,1989,5,910,4.0,642.0,642.0,5,1079,4.0,811.0,811.0
0.134,17,2,148,1,60,0.0,32.0,32.0,1,88,0.0,60.0,60.0
0.005,17,2,180,1,66,0.0,38.0,38.0,1,114,0.0,86.0,86.0
0.007,6,10,1779,5,928,1.0,660.0,660.0,5,851,1.0,583.0,583.0
0.116,6,10,1506,5,395,25.0,127.0,127.0,5,1111,25.0,843.0,843.0
0.119,6,10,1506,5,395,18.0,127.0,127.0,5,1111,27.0,843.0,843.0
0.01,6,10,1989,5,910,2.0,642.0,642.0,5,1079,2.0,811.0,811.0
0.003,17,2,148,1,60,0.0,32.0,32.0,1,88,0.0,60.0,60.0
0.005,6,10,2006,5,927,1.0,659.0,659.0,5,1079,1.0,811.0,811.0
0.018,6,10,1990,5,911,4.0,643.0,643.0,5,1079,4.0,811.0,811.0
0.003,17,2,136,1,60,0.0,32.0,32.0,1,76,0.0,48.0,48.0
0.015,6,10,1989,5,910,3.0,642.0,642.0,5,1079,3.0,811.0,811.0
0.007,6,10,1972,5,910,1.0,642.0,642.0,5,1062,1.0,794.0,794.0
0.004,6,10,1989,5,927,1.0,659.0,659.0,5,1062,1.0,794.0,794.0
0.006,6,10,1547,5,764,1.0,496.0,496.0,5,783,1.0,515.0,515.0
0.005,6,10,2000,5,927,1.0,659.0,659.0,5,1073,1.0,805.0,805.0
0.06,6,10,1506,5,395,12.0,127.0,127.0,5,1111,14.0,843.0,843.0
240.012,6,9,787,5,488,60003.0,232.0,232.0,4,299,80003.0,83.0,83.0
0.014,6,10,1972,5,910,3.0,642.0,642.0,5,1062,3.0,794.0,794.0
0.013,6,10,1605,5,388,3.0,120.0,120.0,5,1217,3.0,949.0,949.0
11.124,17,28,4423,14,1995,843.0,270.0,114.0,14,2428,843.0,587.0,145.0
101.323,6,26,9525,12,1627,74.0,794.0,367.0,14,7898,7784.0,1360.0,732.0
0.018,6,10,1631,5,848,4.0,580.0,580.0,5,783,4.0,515.0,515.0
0.004,6,10,1774,5,923,1.0,655.0,655.0,5,851,1.0,583.0,583.0
0.094,6,10,1506,5,395,20.0,127.0,127.0,5,1111,19.0,843.0,843.0
1.236,17,2,144,1,64,0.0,36.0,36.0,1,80,0.0,52.0,52.0
0.012,6,10,1983,5,910,2.0,642.0,642.0,5,1073,2.0,805.0,805.0
11.376,17,28,4422,14,1994,862.0,269.0,114.0,14,2428,862.0,587.0,145.0
0.084,6,10,1506,5,395,18.0,127.0,127.0,5,1111,18.0,843.0,843.0
0.765,6,10,2009,6,1655,153.0,1403.0,1403.0,4,354,177.0,182.0,182.0
0.007,6,10,1547,5,764,1.0,496.0,496.0,5,783,1.0,515.0,515.0
40.065,17,10,676,5,460,10014.0,104.0,64.0,5,216,10015.0,20.0,15.0
0.063,6,10,1506,5,395,13.0,127.0,127.0,5,1111,13.0,843.0,843.0
375.866,6,30,6180,19,4936,20881.0,494.0,494.0,11,1244,37586.0,83.0,83.0
0.011,6,10,1990,5,911,2.0,643.0,643.0,5,1079,2.0,811.0,811.0
0.04,17,2,152,1,76,0.0,48.0,48.0,1,76,0.0,48.0,48.0
0.01,6,13,3735,7,497,1.0,125.0,125.0,6,3238,1.0,1470.0,1459.0
40.041,17,10,676,5,460,10007.0,104.0,64.0,5,216,10009.0,20.0,15.0
0.01,6,10,1989,5,910,2.0,642.0,642.0,5,1079,2.0,811.0,811.0
0.088,6,10,1506,5,395,20.0,127.0,127.0,5,1111,18.0,843.0,843.0
369.048,6,22,2313,16,867,24603.0,195.0,195.0,6,1446,4653.0,419.0,398.0
0.004,17,2,234,1,61,0.0,33.0,33.0,1,173,0.0,145.0,145.0
40.069,17,10,676,5,460,10016.0,104.0,64.0,5,216,10016.0,20.0,15.0
0.01,6,10,1989,5,910,2.0,642.0,642.0,5,1079,2.0,811.0,811.0
0.079,6,10,1506,5,395,18.0,127.0,127.0,5,1111,17.0,843.0,843.0
40.064,17,10,676,5,460,10014.0,104.0,64.0,5,216,10015.0,20.0,15.0
0.005,6,10,1779,5,928,1.0,660.0,660.0,5,851,1.0,583.0,583.0
0.006,6,10,1689,5,839,1.0,571.0,571.0,5,850,1.0,582.0,582.0
0.005,6,10,1779,5,928,1.0,660.0,660.0,5,851,1.0,583.0,583.0
40.107,17,10,676,5,460,10025.0,104.0,64.0,5,216,10025.0,20.0,15.0
0.009,6,10,1989,5,910,2.0,642.0,642.0,5,1079,2.0,811.0,811.0
0.008,17,2,214,1,75,0.0,47.0,47.0,1,139,0.0,111.0,111.0
126.024,6,14,2938,8,2504,17970.0,1414.0,1086.0,6,434,25158.0,182.0,182.0
40.063,17,10,676,5,460,10014.0,104.0,64.0,5,216,10014.0,20.0,15.0
0.004,6,10,1989,5,927,1.0,659.0,659.0,5,1062,1.0,794.0,794.0
0.011,6,10,1983,5,910,2.0,642.0,642.0,5,1073,2.0,805.0,805.0
40.051,17,10,676,5,460,10011.0,104.0,64.0,5,216,10012.0,20.0,15.0
0.014,6,10,1990,5,911,3.0,643.0,643.0,5,1079,3.0,811.0,811.0
0.007,6,10,1547,5,764,1.0,496.0,496.0,5,783,1.0,515.0,515.0
0.014,6,10,1990,5,911,3.0,643.0,643.0,5,1079,3.0,811.0,811.0
0.104,6,10,1506,5,395,24.0,127.0,127.0,5,1111,23.0,843.0,843.0
0.004,17,2,136,1,60,0.0,32.0,32.0,1,76,0.0,48.0,48.0
0.006,6,10,1643,5,860,1.0,592.0,592.0,5,783,1.0,515.0,515.0
0.164,6,10,1506,5,395,40.0,127.0,127.0,5,1111,36.0,843.0,843.0
0.005,6,10,2007,5,928,1.0,660.0,660.0,5,1079,1.0,811.0,811.0
0.001,17,2,180,1,66,0.0,38.0,38.0,1,114,0.0,86.0,86.0
0.008,17,2,194,1,59,0.0,31.0,31.0,1,135,0.0,107.0,107.0
0.01,6,10,1983,5,910,2.0,642.0,642.0,5,1073,2.0,805.0,805.0
40.069,17,10,676,5,460,10014.0,104.0,64.0,5,216,10016.0,20.0,15.0
15.075,17,15,9239,8,6902,2149.0,1350.0,834.0,7,2337,2507.0,1350.0,305.0
0.037,17,2,148,1,60,0.0,32.0,32.0,1,88,0.0,60.0,60.0
308.61,17,20,1124,10,716,34275.0,48.0,43.0,10,408,34275.0,20.0,12.0
0.085,6,10,1506,5,395,19.0,127.0,127.0,5,1111,17.0,843.0,843.0
0.001,17,2,174,1,72,0.0,44.0,44.0,1,102,0.0,74.0,74.0
0.152,17,2,152,1,76,0.0,48.0,48.0,1,76,0.0,48.0,48.0
40.06,17,10,676,5,460,10013.0,104.0,64.0,5,216,10014.0,20.0,15.0
0.122,6,10,1506,5,395,28.0,127.0,127.0,5,1111,15.0,843.0,843.0
0.004,6,10,2007,5,928,1.0,660.0,660.0,5,1079,1.0,811.0,811.0
0.017,6,10,1990,5,911,4.0,643.0,643.0,5,1079,4.0,811.0,811.0
0.097,6,10,1506,5,395,19.0,127.0,127.0,5,1111,22.0,843.0,843.0
0.005,6,10,2000,5,927,1.0,659.0,659.0,5,1073,1.0,805.0,805.0
0.005,6,10,2006,5,927,1.0,659.0,659.0,5,1079,1.0,811.0,811.0
0.007,17,2,230,1,68,0.0,40.0,40.0,1,162,0.0,134.0,134.0
0.006,6,10,1547,5,764,1.0,496.0,496.0,5,783,1.0,515.0,515.0
0.004,6,10,2007,5,928,1.0,660.0,660.0,5,1079,1.0,811.0,811.0
0.011,6,10,1983,5,910,2.0,642.0,642.0,5,1073,2.0,805.0,805.0
0.009,6,10,1762,5,911,2.0,643.0,643.0,5,851,2.0,583.0,583.0
0.004,6,10,2007,5,928,1.0,660.0,660.0,5,1079,1.0,811.0,811.0
0.006,6,10,1689,5,839,1.0,571.0,571.0,5,850,1.0,582.0,582.0
0.071,17,2,148,1,60,0.0,32.0,32.0,1,88,0.0,60.0,60.0
0.005,6,10,2006,5,927,1.0,659.0,659.0,5,1079,1.0,811.0,811.0
0.041,17,4,284,2,120,0.0,32.0,32.0,2,164,38.0,60.0,54.0
0.102,6,10,1506,5,395,22.0,127.0,127.0,5,1111,24.0,843.0,843.0
0.005,6,10,1989,5,927,1.0,659.0,659.0,5,1062,1.0,794.0,794.0
0.01,17,2,170,1,65,0.0,37.0,37.0,1,105,0.0,77.0,77.0
0.009,6,10,1972,5,910,2.0,642.0,642.0,5,1062,2.0,794.0,794.0
0.014,6,10,1990,5,911,3.0,643.0,643.0,5,1079,3.0,811.0,811.0
0.005,17,2,170,1,65,0.0,37.0,37.0,1,105,0.0,77.0,77.0
0.004,17,2,148,1,60,0.0,32.0,32.0,1,88,0.0,60.0,60.0
0.004,6,10,2007,5,928,1.0,660.0,660.0,5,1079,1.0,811.0,811.0
0.011,6,10,1762,5,911,2.0,643.0,643.0,5,851,2.0,583.0,583.0
0.005,6,10,1643,5,860,1.0,592.0,592.0,5,783,1.0,515.0,515.0
0.006,6,10,1547,5,764,1.0,496.0,496.0,5,783,1.0,515.0,515.0
240.02,6,9,787,5,488,60005.0,232.0,232.0,4,299,80004.0,83.0,83.0
0.016,6,10,1989,5,910,4.0,642.0,642.0,5,1079,4.0,811.0,811.0
0.011,6,10,1762,5,911,2.0,643.0,643.0,5,851,2.0,583.0,583.0
0.005,6,10,2006,5,927,1.0,659.0,659.0,5,1079,1.0,811.0,811.0
0.171,6,3,453,2,321,171.0,241.0,241.0,1,132,0.0,92.0,92.0
0.005,6,10,2006,5,927,1.0,659.0,659.0,5,1079,1.0,811.0,811.0
0.005,17,2,175,1,65,0.0,37.0,37.0,1,110,0.0,82.0,82.0
0.006,6,10,2006,5,927,1.0,659.0,659.0,5,1079,1.0,811.0,811.0
0.006,6,10,1643,5,860,1.0,592.0,592.0,5,783,1.0,515.0,515.0
0.006,6,10,1689,5,839,1.0,571.0,571.0,5,850,1.0,582.0,582.0
0.004,17,4,284,2,120,0.0,32.0,32.0,2,164,0.0,60.0,54.0
0.111,6,10,1506,5,395,24.0,127.0,127.0,5,1111,25.0,843.0,843.0
0.012,6,10,1990,5,911,3.0,643.0,643.0,5,1079,3.0,811.0,811.0
0.062,6,10,1506,5,395,14.0,127.0,127.0,5,1111,14.0,843.0,843.0
29.402,6,40,10527,20,4929,479.0,1360.0,682.0,20,5598,1538.0,2667.0,435.0
0.004,17,2,136,1,60,0.0,32.0,32.0,1,76,0.0,48.0,48.0
0.004,17,2,148,1,60,0.0,32.0,32.0,1,88,0.0,60.0,60.0
0.006,17,2,166,1,75,0.0,47.0,47.0,1,91,0.0,63.0,63.0
0.012,6,10,1983,5,910,3.0,642.0,642.0,5,1073,3.0,805.0,805.0
0.016,6,10,1972,5,910,4.0,642.0,642.0,5,1062,4.0,794.0,794.0
0.004,6,10,2006,5,927,1.0,659.0,659.0,5,1079,1.0,811.0,811.0
0.001,17,2,136,1,60,0.0,32.0,32.0,1,76,0.0,48.0,48.0
0.144,6,10,1506,5,395,35.0,127.0,127.0,5,1111,34.0,843.0,843.0
40.072,17,10,676,5,460,10014.0,104.0,64.0,5,216,10017.0,20.0,15.0
0.004,6,10,2000,5,927,1.0,659.0,659.0,5,1073,1.0,805.0,805.0
0.005,6,10,2006,5,927,1.0,659.0,659.0,5,1079,1.0,811.0,811.0
0.075,6,10,1506,5,395,15.0,127.0,127.0,5,1111,16.0,843.0,843.0
9.036,17,6,376,5,280,2259.0,28.0,28.0,1,96,0.0,68.0,68.0
0.264,17,41,20622,22,17094,12.0,1350.0,749.0,19,3528,11.0,1350.0,157.0
0.046,6,10,1677,5,827,11.0,559.0,559.0,5,850,11.0,582.0,582.0
11.166,17,28,4422,14,1993,846.0,268.0,114.0,14,2429,846.0,588.0,145.0
0.137,6,10,1506,5,395,27.0,127.0,127.0,5,1111,33.0,843.0,843.0
0.006,6,10,1547,5,764,1.0,496.0,496.0,5,783,1.0,515.0,515.0
0.069,17,8,3613,4,1874,23.0,1350.0,440.0,4,1739,11.0,1350.0,406.0
0.012,6,13,3735,7,497,2.0,125.0,125.0,6,3238,2.0,1470.0,1459.0
40.066,17,10,676,5,460,10015.0,104.0,64.0,5,216,10015.0,20.0,15.0
0.009,6,10,1631,5,848,2.0,580.0,580.0,5,783,2.0,515.0,515.0
10.89,17,28,4422,14,1993,828.0,268.0,114.0,14,2429,828.0,588.0,145.0
0.001,17,2,136,1,60,0.0,32.0,32.0,1,76,0.0,48.0,48.0
162.514,17,74,10541,37,2468,4514.0,44.0,38.0,37,8073,4514.0,239.0,190.0
0.005,6,10,2006,5,927,1.0,659.0,659.0,5,1079,1.0,811.0,811.0
0.005,17,2,170,1,65,0.0,37.0,37.0,1,105,0.0,77.0,77.0
0.004,17,4,284,2,120,0.0,32.0,32.0,2,164,1.0,60.0,54.0
0.005,6,10,2006,5,927,1.0,659.0,659.0,5,1079,1.0,811.0,811.0
0.003,17,2,148,1,60,0.0,32.0,32.0,1,88,0.0,60.0,60.0
0.004,6,10,1989,5,927,1.0,659.0,659.0,5,1062,1.0,794.0,794.0
0.006,17,2,213,1,69,0.0,41.0,41.0,1,144,0.0,116.0,116.0
0.006,17,2,136,1,60,0.0,32.0,32.0,1,76,0.0,48.0,48.0
0.005,6,10,1989,5,927,1.0,659.0,659.0,5,1062,1.0,794.0,794.0
0.108,6,10,1506,5,395,20.0,127.0,127.0,5,1111,24.0,843.0,843.0
0.015,6,10,1990,5,911,3.0,643.0,643.0,5,1079,3.0,811.0,811.0
0.005,6,10,2006,5,927,1.0,659.0,659.0,5,1079,1.0,811.0,811.0
0.013,6,10,1972,5,910,3.0,642.0,642.0,5,1062,3.0,794.0,794.0
0.004,6,10,1774,5,923,1.0,655.0,655.0,5,851,1.0,583.0,583.0
0.005,6,13,3690,7,452,0.0,80.0,80.0,6,3238,0.0,1470.0,1459.0
354.017,6,21,1795,16,1030,23601.0,190.0,190.0,5,765,60002.0,464.0,248.0
0.005,6,10,1989,5,927,1.0,659.0,659.0,5,1062,1.0,794.0,794.0
1799.997,6,137,6590,76,3625,23996.0,39.0,39.0,61,2965,29995.0,35.0,35.0
0.005,6,10,2006,5,927,1.0,659.0,659.0,5,1079,1.0,811.0,811.0
0.005,6,10,2007,5,928,1.0,660.0,660.0,5,1079,1.0,811.0,811.0
15.072,17,15,9238,8,6902,2149.0,1350.0,834.0,7,2336,2507.0,1350.0,305.0
0.012,6,10,1990,5,911,2.0,643.0,643.0,5,1079,3.0,811.0,811.0
0.018,6,10,1762,5,911,4.0,643.0,643.0,5,851,4.0,583.0,583.0
0.048,6,7,768,4,510,12.0,302.0,302.0,3,258,9.0,102.0,102.0
0.006,6,10,1643,5,860,1.0,592.0,592.0,5,783,1.0,515.0,515.0
0.009,6,13,3735,7,497,1.0,125.0,125.0,6,3238,1.0,1470.0,1459.0
0.007,6,10,1547,5,764,1.0,496.0,496.0,5,783,1.0,515.0,515.0
0.007,17,2,179,1,71,0.0,43.0,43.0,1,108,0.0,80.0,80.0
0.118,6,10,1506,5,395,24.0,127.0,127.0,5,1111,25.0,843.0,843.0
0.003,17,2,152,1,76,0.0,48.0,48.0,1,76,0.0,48.0,48.0
0.006,17,2,182,1,67,0.0,39.0,39.0,1,115,0.0,87.0,87.0
1191.034,6,50,6235,31,3700,39695.0,1626.0,139.0,19,2535,66159.0,1113.0,103.0
300.405,6,16,2170,9,684,37530.0,146.0,146.0,7,1486,50040.0,419.0,398.0
0.126,6,10,1506,5,395,25.0,127.0,127.0,5,1111,24.0,843.0,843.0
0.006,17,2,286,1,64,0.0,36.0,36.0,1,222,0.0,194.0,194.0
0.004,6,10,1702,5,863,0.0,595.0,595.0,5,839,1.0,571.0,571.0
0.031,6,10,1990,5,911,7.0,643.0,643.0,5,1079,7.0,811.0,811.0
0.004,6,10,2007,5,928,1.0,660.0,660.0,5,1079,1.0,811.0,811.0
0.005,17,2,179,1,71,0.0,43.0,43.0,1,108,0.0,80.0,80.0
11.1,17,28,4418,14,1994,841.0,269.0,114.0,14,2424,841.0,587.0,145.0
0.009,6,10,1989,5,910,2.0,642.0,642.0,5,1079,2.0,811.0,811.0
0.017,6,10,1677,5,827,4.0,559.0,559.0,5,850,4.0,582.0,582.0
0.105,6,10,1506,5,395,22.0,127.0,127.0,5,1111,24.0,843.0,843.0
0.062,6,10,1506,5,395,13.0,127.0,127.0,5,1111,14.0,843.0,843.0
1756.919,6,456,65740,252,35168,6999.0,613.0,197.0,204,30572,8654.0,453.0,142.0
0.01,6,10,1983,5,910,2.0,642.0,642.0,5,1073,2.0,805.0,805.0
0.014,6,10,1983,5,910,3.0,642.0,642.0,5,1073,3.0,805.0,805.0
1778.569,17,144,41760,72,22752,25050.0,288.0,288.0,72,19008,25050.0,236.0,236.0
240.14,6,31,9157,15,6770,17152.0,1894.0,666.0,16,2387,16009.0,580.0,193.0
0.162,6,10,1506,5,395,36.0,127.0,127.0,5,1111,37.0,843.0,843.0
0.109,6,10,1506,5,395,25.0,127.0,127.0,5,1111,21.0,843.0,843.0
0.005,6,10,2007,5,928,1.0,660.0,660.0,5,1079,1.0,811.0,811.0
0.005,6,10,1689,5,839,1.0,571.0,571.0,5,850,1.0,582.0,582.0
0.095,6,10,1506,5,395,19.0,127.0,127.0,5,1111,22.0,843.0,843.0
0.005,17,2,148,1,60,0.0,32.0,32.0,1,88,0.0,60.0,60.0
354.038,6,21,1795,16,1030,23602.0,190.0,190.0,5,765,60001.0,464.0,248.0
0.004,6,10,1702,5,863,1.0,595.0,595.0,5,839,1.0,571.0,571.0
0.001,17,2,180,1,66,0.0,38.0,38.0,1,114,0.0,86.0,86.0
0.011,6,10,1677,5,827,2.0,559.0,559.0,5,850,2.0,582.0,582.0
0.214,6,16,2669,8,1395,30.0,533.0,323.0,8,1274,19.0,529.0,212.0
0.015,6,10,1983,5,910,3.0,642.0,642.0,5,1073,3.0,805.0,805.0
0.081,6,10,1506,5,395,18.0,127.0,127.0,5,1111,19.0,843.0,843.0
23.12,6,41,22926,21,1150,1156.0,290.0,290.0,20,21776,1214.0,1414.0,1233.0
240.947,6,19,4637,9,963,30118.0,238.0,166.0,10,3674,26771.0,1402.0,786.0
0.005,6,10,1774,5,923,1.0,655.0,655.0,5,851,1.0,583.0,583.0
1778.833,17,144,45504,72,22752,25053.0,288.0,288.0,72,22752,25053.0,288.0,288.0
0.004,6,10,1989,5,927,1.0,659.0,659.0,5,1062,1.0,794.0,794.0
0.005,6,10,2007,5,928,1.0,660.0,660.0,5,1079,1.0,811.0,811.0
0.004,6,10,1779,5,928,1.0,660.0,660.0,5,851,0.0,583.0,583.0
0.011,6,10,1990,5,911,2.0,643.0,643.0,5,1079,2.0,811.0,811.0
0.008,6,12,1926,6,1189,1.0,659.0,434.0,6,737,1.0,417.0,417.0
0.005,17,2,230,1,68,0.0,40.0,40.0,1,162,0.0,134.0,134.0
0.043,17,2,170,1,65,0.0,37.0,37.0,1,105,0.0,77.0,77.0
0.006,6,10,1547,5,764,1.0,496.0,496.0,5,783,1.0,515.0,515.0
0.007,6,10,2000,5,927,1.0,659.0,659.0,5,1073,1.0,805.0,805.0
0.005,17,2,170,1,65,0.0,37.0,37.0,1,105,0.0,77.0,77.0
177.196,17,92,13450,46,3109,3937.0,44.0,39.0,46,10341,3937.0,239.0,196.0
0.001,17,2,136,1,60,0.0,32.0,32.0,1,76,0.0,48.0,48.0
0.005,17,2,179,1,71,0.0,43.0,43.0,1,108,0.0,80.0,80.0
0.014,6,10,1989,5,910,3.0,642.0,642.0,5,1079,3.0,811.0,811.0
0.005,6,10,1547,5,764,1.0,496.0,496.0,5,783,1.0,515.0,515.0
0.005,6,14,3742,7,452,0.0,80.0,80.0,7,3290,0.0,1448.0,972.0
31.375,6,36,8190,18,1719,516.0,651.0,322.0,18,6471,1838.0,2720.0,478.0
300.119,6,30,10104,17,1491,18757.0,260.0,149.0,13,8613,20009.0,1561.0,881.0
0.037,17,4,284,2,120,0.0,32.0,32.0,2,164,33.0,60.0,54.0
0.013,6,10,1989,5,910,3.0,642.0,642.0,5,1079,3.0,811.0,811.0
0.219,17,14,8577,7,4012,36.0,1350.0,545.0,7,4565,27.0,1350.0,624.0
0.005,6,10,2006,5,927,1.0,659.0,659.0,5,1079,1.0,811.0,811.0
0.008,6,10,1989,5,910,2.0,642.0,642.0,5,1079,2.0,811.0,811.0
0.006,6,10,1854,5,889,1.0,621.0,621.0,5,965,1.0,697.0,697.0
0.072,6,10,1506,5,395,13.0,127.0,127.0,5,1111,16.0,843.0,843.0
0.006,6,10,1547,5,764,1.0,496.0,496.0,5,783,1.0,515.0,515.0
15.119,17,15,7295,7,3800,2514.0,1350.0,514.0,8,3495,2155.0,1350.0,408.0
0.005,6,10,1779,5,928,1.0,660.0,660.0,5,851,1.0,583.0,583.0
0.017,6,10,1677,5,827,4.0,559.0,559.0,5,850,4.0,582.0,582.0
0.224,6,16,2778,8,1396,32.0,533.0,324.0,8,1382,20.0,529.0,239.0
0.011,6,10,1989,5,910,2.0,642.0,642.0,5,1079,2.0,811.0,811.0
0.009,6,10,1990,5,911,2.0,643.0,643.0,5,1079,2.0,811.0,811.0
0.017,6,13,3735,7,497,2.0,125.0,125.0,6,3238,3.0,1470.0,1459.0
0.008,6,10,1677,5,827,2.0,559.0,559.0,5,850,1.0,582.0,582.0
0.031,6,10,1989,5,910,7.0,642.0,642.0,5,1079,7.0,811.0,811.0
0.276,17,48,27206,27,23504,10.0,1350.0,842.0,21,3702,10.0,1350.0,148.0
0.005,6,10,1774,5,923,1.0,655.0,655.0,5,851,1.0,583.0,583.0
0.095,6,10,1506,5,395,21.0,127.0,127.0,5,1111,19.0,843.0,843.0
0.007,6,10,1547,5,764,1.0,496.0,496.0,5,783,1.0,515.0,515.0
0.021,6,10,1989,5,910,5.0,642.0,642.0,5,1079,5.0,811.0,811.0
0.005,17,2,170,1,65,0.0,37.0,37.0,1,105,0.0,77.0,77.0
0.005,6,10,2006,5,927,1.0,659.0,659.0,5,1079,1.0,811.0,811.0
0.005,6,10,1989,5,927,1.0,659.0,659.0,5,1062,1.0,794.0,794.0
0.011,6,10,1990,5,911,2.0,643.0,643.0,5,1079,2.0,811.0,811.0
0.005,17,2,164,1,74,0.0,46.0,46.0,1,90,0.0,62.0,62.0
308.971,17,20,1124,10,716,34316.0,48.0,43.0,10,408,34316.0,20.0,12.0
0.005,6,10,1989,5,927,1.0,659.0,659.0,5,1062,1.0,794.0,794.0
240.029,6,9,787,5,488,60007.0,232.0,232.0,4,299,80009.0,83.0,83.0
0.157,6,10,1506,5,395,36.0,127.0,127.0,5,1111,37.0,843.0,843.0
0.001,17,2,174,1,72,0.0,44.0,44.0,1,102,0.0,74.0,74.0
0.004,17,2,136,1,60,0.0,32.0,32.0,1,76,0.0,48.0,48.0
0.005,6,10,1702,5,863,1.0,595.0,595.0,5,839,1.0,571.0,571.0
301.378,6,64,32158,34,25931,9132.0,2720.0,1363.0,30,6227,317.0,2667.0,385.0
0.005,17,2,169,1,62,0.0,34.0,34.0,1,107,0.0,79.0,79.0
0.01,6,10,1989,5,910,2.0,642.0,642.0,5,1079,2.0,811.0,811.0
0.004,6,10,2006,5,927,1.0,659.0,659.0,5,1079,1.0,811.0,811.0
0.077,6,28,10264,15,8942,5.0,2736.0,906.0,13,1322,5.0,307.0,107.0
298.117,6,310,257100,173,243616,1732.0,4080.0,1714.0,137,13484,2190.0,1360.0,199.0
0.006,6,10,1689,5,839,1.0,571.0,571.0,5,850,1.0,582.0,582.0
0.09,6,10,1506,5,395,21.0,127.0,127.0,5,1111,20.0,843.0,843.0
0.004,6,10,1702,5,863,1.0,595.0,595.0,5,839,0.0,571.0,571.0
0.005,6,10,1989,5,927,1.0,659.0,659.0,5,1062,1.0,794.0,794.0
0.006,6,10,1854,5,889,1.0,621.0,621.0,5,965,1.0,697.0,697.0
0.007,17,2,170,1,65,0.0,37.0,37.0,1,105,0.0,77.0,77.0
353.468,6,20,2210,6,1308,12003.0,494.0,494.0,14,902,27189.0,83.0,83.0
0.195,17,2,152,1,76,0.0,48.0,48.0,1,76,0.0,48.0,48.0
0.005,6,10,1779,5,928,1.0,660.0,660.0,5,851,1.0,583.0,583.0
0.006,6,10,1689,5,839,1.0,571.0,571.0,5,850,1.0,582.0,582.0
0.006,17,4,284,2,120,2.0,32.0,32.0,2,164,2.0,60.0,54.0
0.004,6,10,2006,5,927,1.0,659.0,659.0,5,1079,1.0,811.0,811.0
0.001,17,2,180,1,66,0.0,38.0,38.0,1,114,0.0,86.0,86.0
0.022,6,13,3735,7,497,3.0,125.0,125.0,6,3238,4.0,1470.0,1459.0
0.004,6,10,2006,5,927,1.0,659.0,659.0,5,1079,1.0,811.0,811.0
0.005,6,10,1689,5,839,1.0,571.0,571.0,5,850,1.0,582.0,582.0
0.074,6,10,1506,5,395,16.0,127.0,127.0,5,1111,16.0,843.0,843.0
40.062,17,10,676,5,460,10014.0,104.0,64.0,5,216,10014.0,20.0,15.0
0.001,17,2,180,1,66,0.0,38.0,38.0,1,114,0.0,86.0,86.0
0.004,6,10,2007,5,928,1.0,660.0,660.0,5,1079,1.0,811.0,811.0
0.005,6,10,1779,5,928,1.0,660.0,660.0,5,851,1.0,583.0,583.0
0.118,6,10,1506,5,395,27.0,127.0,127.0,5,1111,28.0,843.0,843.0
0.136,6,10,1506,5,395,28.0,127.0,127.0,5,1111,32.0,843.0,843.0
0.067,6,10,1989,5,910,16.0,642.0,642.0,5,1079,16.0,811.0,811.0
0.006,6,10,1689,5,839,1.0,571.0,571.0,5,850,1.0,582.0,582.0
0.023,6,13,3735,7,497,3.0,125.0,125.0,6,3238,4.0,1470.0,1459.0
0.01,6,10,1989,5,910,2.0,642.0,642.0,5,1079,2.0,811.0,811.0
0.037,17,2,184,1,61,0.0,33.0,33.0,1,123,0.0,95.0,95.0
174.209,17,76,10848,38,2541,4708.0,44.0,38.0,38,8307,4708.0,239.0,190.0
0.005,6,13,3747,7,509,0.0,137.0,137.0,6,3238,0.0,1470.0,1459.0
0.003,17,4,284,2,120,0.0,32.0,32.0,2,164,0.0,60.0,54.0
0.065,6,10,1506,5,395,15.0,127.0,127.0,5,1111,12.0,843.0,843.0
300.367,6,16,2170,9,684,37524.0,146.0,146.0,7,1486,50032.0,419.0,398.0
0.107,6,10,1506,5,395,24.0,127.0,127.0,5,1111,23.0,843.0,843.0
0.072,17,2,170,1,65,0.0,37.0,37.0,1,105,0.0,77.0,77.0
0.011,6,13,3735,7,497,1.0,125.0,125.0,6,3238,2.0,1470.0,1459.0
0.006,6,10,2006,5,927,1.0,659.0,659.0,5,1079,1.0,811.0,811.0
0.004,17,4,284,2,120,0.0,32.0,32.0,2,164,0.0,60.0,54.0
15.1,17,16,8560,8,6474,2151.0,1350.0,781.0,8,2086,2152.0,1350.0,232.0
0.07,6,10,1506,5,395,15.0,127.0,127.0,5,1111,16.0,843.0,843.0
0.004,6,10,1779,5,928,1.0,660.0,660.0,5,851,1.0,583.0,583.0
0.005,6,10,1779,5,928,1.0,660.0,660.0,5,851,1.0,583.0,583.0
0.004,6,10,2006,5,927,1.0,659.0,659.0,5,1079,1.0,811.0,811.0
240.59,6,27,7712,12,3525,21871.0,1211.0,726.0,15,4187,17184.0,1162.0,377.0
0.069,17,8,3613,4,1874,23.0,1350.0,440.0,4,1739,12.0,1350.0,406.0
0.001,17,2,180,1,66,0.0,38.0,38.0,1,114,0.0,86.0,86.0
0.04,17,2,136,1,60,0.0,32.0,32.0,1,76,0.0,48.0,48.0
0.092,6,10,1506,5,395,21.0,127.0,127.0,5,1111,21.0,843.0,843.0
0.008,6,10,1677,5,827,2.0,559.0,559.0,5,850,2.0,582.0,582.0
0.039,17,4,284,2,120,1.0,32.0,32.0,2,164,35.0,60.0,54.0
0.121,6,10,1506,5,395,28.0,127.0,127.0,5,1111,27.0,843.0,843.0
0.127,17,2,186,1,61,0.0,33.0,33.0,1,125,0.0,97.0,97.0
161.405,17,76,10705,38,2537,4362.0,44.0,38.0,38,8168,4362.0,261.0,186.0
15.07,17,15,9239,8,6902,2148.0,1350.0,834.0,7,2337,2506.0,1350.0,305.0
177.404,17,90,13064,45,3007,4031.0,44.0,38.0,45,10057,4031.0,261.0,195.0
0.005,6,10,2006,5,927,1.0,659.0,659.0,5,1079,1.0,811.0,811.0
0.004,6,10,1779,5,928,1.0,660.0,660.0,5,851,1.0,583.0,583.0
0.013,6,10,1989,5,910,3.0,642.0,642.0,5,1079,3.0,811.0,811.0
0.006,6,10,1547,5,764,1.0,496.0,496.0,5,783,1.0,515.0,515.0
0.004,17,2,136,1,60,0.0,32.0,32.0,1,76,0.0,48.0,48.0
0.011,6,10,1983,5,910,2.0,642.0,642.0,5,1073,2.0,805.0,805.0
0.005,6,10,1989,5,927,1.0,659.0,659.0,5,1062,1.0,794.0,794.0
0.006,6,10,1643,5,860,1.0,592.0,592.0,5,783,1.0,515.0,515.0
1771.595,17,120,11460,60,5460,30026.0,63.0,63.0,60,6000,30026.0,72.0,72.0
0.01,6,12,1926,6,1189,1.0,659.0,434.0,6,737,1.0,417.0,417.0
0.003,17,2,136,1,60,0.0,32.0,32.0,1,76,0.0,48.0,48.0
0.01,6,10,1989,5,910,2.0,642.0,642.0,5,1079,2.0,811.0,811.0
0.006,6,14,3799,7,509,0.0,137.0,137.0,7,3290,0.0,1448.0,972.0
0.04,17,2,152,1,76,0.0,48.0,48.0,1,76,0.0,48.0,48.0
353.037,6,20,2210,6,1308,12003.0,494.0,494.0,14,902,27156.0,83.0,83.0
0.007,6,10,1989,5,927,1.0,659.0,659.0,5,1062,1.0,794.0,794.0
0.01,6,10,1989,5,910,2.0,642.0,642.0,5,1079,2.0,811.0,811.0
371.241,6,22,2313,16,867,24749.0,195.0,195.0,6,1446,4644.0,419.0,398.0
15.074,17,15,9238,8,6902,2149.0,1350.0,834.0,7,2336,2507.0,1350.0,305.0
8.981,6,37,10002,19,4484,498.0,1360.0,738.0,18,5518,516.0,1360.0,398.0
294.373,6,312,344424,122,17898,2432.0,2736.0,889.0,190,326526,1557.0,2804.0,1799.0
0.078,6,10,1506,5,395,18.0,127.0,127.0,5,1111,15.0,843.0,843.0
0.003,17,2,136,1,60,0.0,32.0,32.0,1,76,0.0,48.0,48.0
0.068,6,10,1506,5,395,14.0,127.0,127.0,5,1111,16.0,843.0,843.0
0.005,6,10,2006,5,927,1.0,659.0,659.0,5,1079,1.0,811.0,811.0
0.014,6,10,1989,5,910,3.0,642.0,642.0,5,1079,3.0,811.0,811.0
0.066,6,10,1506,5,395,14.0,127.0,127.0,5,1111,14.0,843.0,843.0
0.005,6,10,2000,5,927,1.0,659.0,659.0,5,1073,1.0,805.0,805.0
0.001,17,2,136,1,60,0.0,32.0,32.0,1,76,0.0,48.0,48.0
0.013,6,10,1983,5,910,3.0,642.0,642.0,5,1073,3.0,805.0,805.0
0.021,6,10,1677,5,827,5.0,559.0,559.0,5,850,5.0,582.0,582.0
0.014,6,10,1972,5,910,3.0,642.0,642.0,5,1062,3.0,794.0,794.0
0.01,6,10,1983,5,910,2.0,642.0,642.0,5,1073,2.0,805.0,805.0
0.001,17,2,180,1,66,0.0,38.0,38.0,1,114,0.0,86.0,86.0
0.008,6,12,1926,6,1189,1.0,659.0,434.0,6,737,1.0,417.0,417.0
40.06,17,10,676,5,460,10013.0,104.0,64.0,5,216,10014.0,20.0,15.0
0.017,6,10,1989,5,910,4.0,642.0,642.0,5,1079,4.0,811.0,811.0
40.057,17,10,676,5,460,10013.0,104.0,64.0,5,216,10013.0,20.0,15.0
0.005,17,2,170,1,65,0.0,37.0,37.0,1,105,0.0,77.0,77.0
0.005,17,2,170,1,65,0.0,37.0,37.0,1,105,0.0,77.0,77.0
0.005,6,14,3799,7,509,0.0,137.0,137.0,7,3290,0.0,1448.0,972.0
0.019,6,10,1989,5,910,4.0,642.0,642.0,5,1079,4.0,811.0,811.0
0.005,17,2,144,1,64,0.0,36.0,36.0,1,80,0.0,52.0,52.0
0.006,17,2,169,1,62,0.0,34.0,34.0,1,107,0.0,79.0,79.0
0.008,6,10,1990,5,911,2.0,643.0,643.0,5,1079,1.0,811.0,811.0
0.001,17,2,180,1,66,0.0,38.0,38.0,1,114,0.0,86.0,86.0
301.023,6,43,13540,23,7713,13682.0,1924.0,965.0,20,5827,466.0,2667.0,385.0
0.006,6,10,1547,5,764,1.0,496.0,496.0,5,783,1.0,515.0,515.0
0.04,17,2,184,1,61,0.0,33.0,33.0,1,123,0.0,95.0,95.0
0.014,6,10,1972,5,910,3.0,642.0,642.0,5,1062,3.0,794.0,794.0
0.006,17,2,179,1,71,0.0,43.0,43.0,1,108,0.0,80.0,80.0
0.004,17,2,170,1,65,0.0,37.0,37.0,1,105,0.0,77.0,77.0
0.01,6,10,1972,5,910,2.0,642.0,642.0,5,1062,2.0,794.0,794.0
0.008,6,10,1762,5,911,2.0,643.0,643.0,5,851,1.0,583.0,583.0
0.01,6,10,1990,5,911,2.0,643.0,643.0,5,1079,2.0,811.0,811.0
0.11,6,10,1506,5,395,23.0,127.0,127.0,5,1111,22.0,843.0,843.0
11.376,17,28,4421,14,1993,862.0,268.0,114.0,14,2428,861.0,587.0,145.0
0.003,17,2,148,1,60,0.0,32.0,32.0,1,88,0.0,60.0,60.0
15.082,17,17,9579,9,7469,1881.0,1350.0,801.0,8,2110,2150.0,1350.0,235.0
0.005,17,2,148,1,60,0.0,32.0,32.0,1,88,0.0,60.0,60.0
40.057,17,10,676,5,460,10013.0,104.0,64.0,5,216,10013.0,20.0,15.0
0.005,6,10,1989,5,927,1.0,659.0,659.0,5,1062,1.0,794.0,794.0
0.005,6,10,1643,5,860,1.0,592.0,592.0,5,783,1.0,515.0,515.0
0.043,17,2,184,1,61,0.0,33.0,33.0,1,123,0.0,95.0,95.0
0.01,6,10,1990,5,911,2.0,643.0,643.0,5,1079,2.0,811.0,811.0
0.067,6,10,1506,5,395,15.0,127.0,127.0,5,1111,15.0,843.0,843.0
0.005,6,10,2006,5,927,1.0,659.0,659.0,5,1079,1.0,811.0,811.0
0.012,6,10,1983,5,910,3.0,642.0,642.0,5,1073,3.0,805.0,805.0
0.056,17,2,299,1,65,0.0,37.0,37.0,1,234,0.0,206.0,206.0
0.008,17,2,160,1,72,0.0,44.0,44.0,1,88,0.0,60.0,60.0
0.014,6,10,1990,5,911,3.0,643.0,643.0,5,1079,3.0,811.0,811.0
0.005,17,2,136,1,60,0.0,32.0,32.0,1,76,0.0,48.0,48.0
0.003,6,10,1702,5,863,0.0,595.0,595.0,5,839,0.0,571.0,571.0
0.005,6,10,1989,5,927,1.0,659.0,659.0,5,1062,1.0,794.0,794.0
0.132,6,10,1506,5,395,30.0,127.0,127.0,5,1111,29.0,843.0,843.0
0.013,6,10,1989,5,910,3.0,642.0,642.0,5,1079,3.0,811.0,811.0
0.013,6,13,3735,7,497,2.0,125.0,125.0,6,3238,2.0,1470.0,1459.0
0.005,6,10,2000,5,927,1.0,659.0,659.0,5,1073,1.0,805.0,805.0
351.992,6,20,2210,6,1308,12003.0,494.0,494.0,14,902,27076.0,83.0,83.0
354.013,6,21,1794,16,1030,23600.0,190.0,190.0,5,764,60003.0,463.0,248.0
0.1,6,10,1506,5,395,21.0,127.0,127.0,5,1111,22.0,843.0,843.0
40.056,17,10,676,5,460,10013.0,104.0,64.0,5,216,10013.0,20.0,15.0
0.006,6,10,1547,5,764,1.0,496.0,496.0,5,783,1.0,515.0,515.0
0.004,17,2,184,1,61,0.0,33.0,33.0,1,123,0.0,95.0,95.0
40.049,17,10,676,5,460,10011.0,104.0,64.0,5,216,10011.0,20.0,15.0
0.33,17,49,30994,29,27595,11.0,1350.0,923.0,20,3399,14.0,1350.0,141.0
0.005,6,10,1774,5,923,1.0,655.0,655.0,5,851,1.0,583.0,583.0
0.001,17,2,179,1,62,0.0,34.0,34.0,1,117,0.0,89.0,89.0
240.215,6,26,11539,13,5808,20017.0,1820.0,1027.0,13,5731,20017.0,1656.0,841.0
0.014,6,10,1989,5,910,3.0,642.0,642.0,5,1079,3.0,811.0,811.0
0.003,17,2,136,1,60,0.0,32.0,32.0,1,76,0.0,48.0,48.0
0.003,17,2,136,1,60,0.0,32.0,32.0,1,76,0.0,48.0,48.0
0.061,6,10,1506,5,395,13.0,127.0,127.0,5,1111,14.0,843.0,843.0
0.005,6,10,2006,5,927,1.0,659.0,659.0,5,1079,1.0,811.0,811.0
0.084,6,10,1506,5,395,15.0,127.0,127.0,5,1111,20.0,843.0,843.0
0.013,17,2,152,1,56,0.0,28.0,28.0,1,96,0.0,68.0,68.0
0.004,17,4,284,2,120,0.0,32.0,32.0,2,164,1.0,60.0,54.0
0.01,6,10,1990,5,911,2.0,643.0,643.0,5,1079,2.0,811.0,811.0
0.114,6,10,1506,5,395,25.0,127.0,127.0,5,1111,23.0,843.0,843.0
0.001,17,2,180,1,66,0.0,38.0,38.0,1,114,0.0,86.0,86.0
354.064,6,21,1795,16,1030,23604.0,190.0,190.0,5,765,60002.0,464.0,248.0
0.08,6,10,1506,5,395,18.0,127.0,127.0,5,1111,18.0,843.0,843.0
240.166,6,36,7579,19,1992,13342.0,517.0,166.0,17,5587,15010.0,1402.0,670.0
308.601,17,18,1008,9,640,38559.0,48.0,43.0,9,368,38559.0,20.0,12.0
0.101,6,10,1506,5,395,22.0,127.0,127.0,5,1111,24.0,843.0,843.0
0.106,6,10,1506,5,395,21.0,127.0,127.0,5,1111,24.0,843.0,843.0
0.007,6,10,2006,5,927,1.0,659.0,659.0,5,1079,1.0,811.0,811.0
0.004,6,10,2006,5,927,1.0,659.0,659.0,5,1079,1.0,811.0,811.0
0.086,6,10,1506,5,395,19.0,127.0,127.0,5,1111,17.0,843.0,843.0
0.095,6,10,1506,5,395,21.0,127.0,127.0,5,1111,22.0,843.0,843.0
0.017,6,10,1983,5,910,4.0,642.0,642.0,5,1073,4.0,805.0,805.0
0.008,6,10,1990,5,911,2.0,643.0,643.0,5,1079,2.0,811.0,811.0
0.023,6,10,1762,5,911,5.0,643.0,643.0,5,851,5.0,583.0,583.0
40.07,17,10,676,5,460,10014.0,104.0,64.0,5,216,10016.0,20.0,15.0
240.013,6,9,787,5,488,60003.0,232.0,232.0,4,299,80003.0,83.0,83.0
0.013,6,10,1989,5,910,3.0,642.0,642.0,5,1079,3.0,811.0,811.0
0.004,17,4,284,2,120,0.0,32.0,32.0,2,164,1.0,60.0,54.0
0.007,6,14,3799,7,509,1.0,137.0,137.0,7,3290,1.0,1448.0,972.0
1716.231,6,61,7130,40,4333,44005.0,1626.0,112.0,21,2797,85803.0,1116.0,85.0
0.004,6,10,1989,5,927,1.0,659.0,659.0,5,1062,1.0,794.0,794.0
0.006,6,10,1643,5,860,1.0,592.0,592.0,5,783,1.0,515.0,515.0
0.008,6,13,3735,7,497,1.0,125.0,125.0,6,3238,1.0,1470.0,1459.0
0.807,6,10,937,6,427,161.0,107.0,107.0,4,510,179.0,294.0,294.0
30.032,6,12,1314,7,546,5005.0,174.0,174.0,5,768,7499.0,473.0,250.0
0.004,17,2,148,1,60,0.0,32.0,32.0,1,88,0.0,60.0,60.0
0.01,6,10,1989,5,910,2.0,642.0,642.0,5,1079,2.0,811.0,811.0
0.008,6,10,1989,5,910,2.0,642.0,642.0,5,1079,2.0,811.0,811.0
0.075,6,10,1506,5,395,13.0,127.0,127.0,5,1111,17.0,843.0,843.0
0.011,6,13,3735,7,497,1.0,125.0,125.0,6,3238,2.0,1470.0,1459.0
0.06,17,2,80,1,32,0.0,4.0,4.0,1,48,0.0,20.0,20.0
0.252,17,4,352,2,130,180.0,37.0,37.0,2,222,179.0,89.0,83.0
0.006,17,2,193,1,71,0.0,43.0,43.0,1,122,0.0,94.0,94.0
15.089,17,15,8310,8,6129,2150.0,1350.0,738.0,7,2181,2510.0,1350.0,283.0
0.002,17,2,194,1,57,0.0,29.0,29.0,1,137,0.0,109.0,109.0
11.219,17,28,4423,14,1994,850.0,269.0,114.0,14,2429,850.0,588.0,145.0
0.001,17,2,132,1,58,0.0,30.0,30.0,1,74,0.0,46.0,46.0
0.001,17,2,180,1,66,0.0,38.0,38.0,1,114,0.0,86.0,86.0
0.108,6,10,1506,5,395,20.0,127.0,127.0,5,1111,25.0,843.0,843.0
0.006,17,2,144,1,64,0.0,36.0,36.0,1,80,0.0,52.0,52.0
0.014,6,10,1631,5,848,3.0,580.0,580.0,5,783,3.0,515.0,515.0
0.005,6,10,1854,5,889,1.0,621.0,621.0,5,965,1.0,697.0,697.0
0.011,6,14,3787,7,497,1.0,125.0,125.0,7,3290,1.0,1448.0,972.0
0.005,6,10,1989,5,927,1.0,659.0,659.0,5,1062,1.0,794.0,794.0
300.023,6,12,1782,7,1348,50003.0,494.0,494.0,5,434,75005.0,83.0,83.0
0.07,17,2,184,1,61,0.0,33.0,33.0,1,123,0.0,95.0,95.0
0.084,6,10,1506,5,395,18.0,127.0,127.0,5,1111,17.0,843.0,843.0
0.006,6,10,1547,5,764,1.0,496.0,496.0,5,783,1.0,515.0,515.0
0.006,6,10,1547,5,764,1.0,496.0,496.0,5,783,1.0,515.0,515.0
0.008,6,10,1631,5,848,2.0,580.0,580.0,5,783,1.0,515.0,515.0
0.016,6,10,1989,5,910,3.0,642.0,642.0,5,1079,3.0,811.0,811.0
0.005,6,10,1774,5,923,1.0,655.0,655.0,5,851,1.0,583.0,583.0
11.274,17,28,4417,14,1994,854.0,269.0,114.0,14,2423,854.0,586.0,145.0
0.021,6,10,1989,5,910,5.0,642.0,642.0,5,1079,5.0,811.0,811.0
0.119,6,10,1506,5,395,25.0,127.0,127.0,5,1111,27.0,843.0,843.0
0.005,17,2,170,1,65,0.0,37.0,37.0,1,105,0.0,77.0,77.0
0.009,6,10,1990,5,911,2.0,643.0,643.0,5,1079,2.0,811.0,811.0
0.089,6,10,1506,5,395,19.0,127.0,127.0,5,1111,19.0,843.0,843.0
38.376,6,36,9195,18,3677,516.0,1360.0,731.0,18,5518,2247.0,2667.0,435.0
0.108,6,10,1506,5,395,25.0,127.0,127.0,5,1111,25.0,843.0,843.0
0.088,6,10,1506,5,395,20.0,127.0,127.0,5,1111,16.0,843.0,843.0
0.006,17,2,136,1,60,0.0,32.0,32.0,1,76,0.0,48.0,48.0
0.013,6,10,1762,5,911,3.0,643.0,643.0,5,851,3.0,583.0,583.0
15.072,17,15,9238,8,6902,2149.0,1350.0,834.0,7,2336,2507.0,1350.0,305.0
0.003,17,2,148,1,60,0.0,32.0,32.0,1,88,0.0,60.0,60.0
0.004,17,2,142,1,63,0.0,35.0,35.0,1,79,0.0,51.0,51.0
0.01,6,10,1983,5,910,2.0,642.0,642.0,5,1073,2.0,805.0,805.0
0.014,6,10,1990,5,911,3.0,643.0,643.0,5,1079,3.0,811.0,811.0
11.104,17,28,4399,14,2312,845.0,587.0,137.0,14,2087,845.0,270.0,121.0
0.004,6,10,2006,5,927,1.0,659.0,659.0,5,1079,1.0,811.0,811.0
0.007,6,10,1547,5,764,1.0,496.0,496.0,5,783,1.0,515.0,515.0
0.011,6,10,1990,5,911,2.0,643.0,643.0,5,1079,2.0,811.0,811.0
0.004,17,2,136,1,60,0.0,32.0,32.0,1,76,0.0,48.0,48.0
0.079,6,10,1506,5,395,19.0,127.0,127.0,5,1111,16.0,843.0,843.0
0.007,6,10,1990,5,911,1.0,643.0,643.0,5,1079,1.0,811.0,811.0
0.005,6,14,3742,7,452,0.0,80.0,80.0,7,3290,0.0,1448.0,972.0
0.005,6,10,1547,5,764,1.0,496.0,496.0,5,783,1.0,515.0,515.0
0.001,17,2,136,1,60,0.0,32.0,32.0,1,76,0.0,48.0,48.0
0.004,6,10,1774,5,923,1.0,655.0,655.0,5,851,1.0,583.0,583.0
0.005,6,10,2006,5,927,1.0,659.0,659.0,5,1079,1.0,811.0,811.0
40.088,17,10,676,5,460,10019.0,104.0,64.0,5,216,10020.0,20.0,15.0
0.005,6,10,2006,5,927,1.0,659.0,659.0,5,1079,1.0,811.0,811.0
0.017,6,10,1989,5,910,4.0,642.0,642.0,5,1079,4.0,811.0,811.0
0.004,17,2,148,1,60,0.0,32.0,32.0,1,88,0.0,60.0,60.0
0.005,6,10,1989,5,927,1.0,659.0,659.0,5,1062,1.0,794.0,794.0
0.005,6,10,2006,5,927,1.0,659.0,659.0,5,1079,1.0,811.0,811.0
0.015,6,10,1983,5,910,3.0,642.0,642.0,5,1073,3.0,805.0,805.0
0.014,6,10,1983,5,910,3.0,642.0,642.0,5,1073,3.0,805.0,805.0
0.015,6,10,1990,5,911,3.0,643.0,643.0,5,1079,3.0,811.0,811.0
0.165,17,2,152,1,76,0.0,48.0,48.0,1,76,0.0,48.0,48.0
0.088,6,10,1506,5,395,19.0,127.0,127.0,5,1111,20.0,843.0,843.0
0.066,6,10,1506,5,395,14.0,127.0,127.0,5,1111,14.0,843.0,843.0
0.009,6,12,1926,6,1189,1.0,659.0,434.0,6,737,1.0,417.0,417.0
0.041,17,2,152,1,76,0.0,48.0,48.0,1,76,0.0,48.0,48.0
0.006,6,10,1547,5,764,1.0,496.0,496.0,5,783,1.0,515.0,515.0
0.006,6,10,1547,5,764,1.0,496.0,496.0,5,783,1.0,515.0,515.0
0.011,6,10,1989,5,910,2.0,642.0,642.0,5,1079,2.0,811.0,811.0
0.005,17,2,187,1,71,0.0,43.0,43.0,1,116,0.0,88.0,88.0
0.005,17,2,170,1,65,0.0,37.0,37.0,1,105,0.0,77.0,77.0
40.061,17,10,676,5,460,10014.0,104.0,64.0,5,216,10014.0,20.0,15.0
0.005,6,10,1774,5,923,1.0,655.0,655.0,5,851,1.0,583.0,583.0
0.009,6,13,3735,7,497,1.0,125.0,125.0,6,3238,1.0,1470.0,1459.0
0.108,6,10,1506,5,395,23.0,127.0,127.0,5,1111,26.0,843.0,843.0
402.501,6,25,6582,14,2388,30961.0,585.0,330.0,11,4194,34249.0,1402.0,722.0
0.065,6,10,1506,5,395,13.0,127.0,127.0,5,1111,15.0,843.0,843.0
412.309,6,29,4409,12,3102,10916.0,494.0,494.0,17,1307,25769.0,83.0,83.0
0.004,6,10,2006,5,927,1.0,659.0,659.0,5,1079,1.0,811.0,811.0
0.005,6,10,1643,5,860,1.0,592.0,592.0,5,783,1.0,515.0,515.0
0.005,6,10,2007,5,928,1.0,660.0,660.0,5,1079,1.0,811.0,811.0
0.18,17,4,352,2,130,142.0,37.0,37.0,2,222,143.0,89.0,83.0
0.006,6,10,2006,5,927,1.0,659.0,659.0,5,1079,1.0,811.0,811.0
414.344,6,29,4409,12,3102,10915.0,494.0,494.0,17,1307,25896.0,83.0,83.0
0.008,6,10,1989,5,910,2.0,642.0,642.0,5,1079,1.0,811.0,811.0
3.501,6,32,6224,17,1298,218.0,267.0,195.0,15,4926,241.0,1823.0,392.0
0.004,6,15,3794,8,504,0.0,80.0,80.0,7,3290,0.0,1448.0,972.0
240.501,6,39,9804,20,2228,12657.0,748.0,236.0,19,7576,13360.0,1402.0,549.0
243.743,6,33,10943,14,4824,26.0,1368.0,679.0,19,6119,13540.0,1656.0,731.0
0.006,17,2,140,1,62,0.0,34.0,34.0,1,78,0.0,50.0,50.0
0.081,6,10,1506,5,395,17.0,127.0,127.0,5,1111,19.0,843.0,843.0
11.104,17,28,4420,14,1993,841.0,268.0,114.0,14,2427,841.0,586.0,145.0
0.108,6,10,1506,5,395,26.0,127.0,127.0,5,1111,24.0,843.0,843.0
0.293,17,16,8908,8,6319,41.0,1350.0,761.0,8,2589,18.0,1350.0,295.0
0.004,17,2,136,1,60,0.0,32.0,32.0,1,76,0.0,48.0,48.0
0.005,6,10,1989,5,927,1.0,659.0,659.0,5,1062,1.0,794.0,794.0
0.01,6,10,1989,5,910,2.0,642.0,642.0,5,1079,2.0,811.0,811.0
240.091,6,16,4482,9,963,30011.0,238.0,166.0,7,3519,40014.0,1402.0,786.0
0.015,6,10,1972,5,910,3.0,642.0,642.0,5,1062,3.0,794.0,794.0
0.139,6,10,1506,5,395,32.0,127.0,127.0,5,1111,32.0,843.0,843.0
0.004,6,14,3742,7,452,0.0,80.0,80.0,7,3290,0.0,1448.0,972.0
0.083,6,10,1506,5,395,18.0,127.0,127.0,5,1111,19.0,843.0,843.0
0.02,6,10,1989,5,910,5.0,642.0,642.0,5,1079,4.0,811.0,811.0
0.005,17,2,170,1,65,0.0,37.0,37.0,1,105,0.0,77.0,77.0
0.006,6,10,1643,5,860,1.0,592.0,592.0,5,783,1.0,515.0,515.0
0.009,6,14,3787,7,497,1.0,125.0,125.0,7,3290,1.0,1448.0,972.0
0.017,6,10,1762,5,911,4.0,643.0,643.0,5,851,4.0,583.0,583.0
0.009,6,12,1926,6,1189,1.0,659.0,434.0,6,737,1.0,417.0,417.0
0.016,6,10,1989,5,910,4.0,642.0,642.0,5,1079,3.0,811.0,811.0
0.044,17,2,152,1,76,0.0,48.0,48.0,1,76,0.0,48.0,48.0
301.169,6,52,21252,28,15220,11154.0,2720.0,1405.0,24,6032,392.0,2667.0,361.0
0.012,6,10,1972,5,910,3.0,642.0,642.0,5,1062,3.0,794.0,794.0
0.08,6,10,1506,5,395,17.0,127.0,127.0,5,1111,19.0,843.0,843.0
0.004,17,2,148,1,60,0.0,32.0,32.0,1,88,0.0,60.0,60.0
374.806,6,30,6180,19,4936,20822.0,494.0,494.0,11,1244,37476.0,83.0,83.0
353.339,6,20,2210,6,1308,12004.0,494.0,494.0,14,902,27179.0,83.0,83.0
0.072,6,10,1506,5,395,16.0,127.0,127.0,5,1111,14.0,843.0,843.0
0.004,6,10,1989,5,927,1.0,659.0,659.0,5,1062,1.0,794.0,794.0
0.035,6,10,1677,5,827,8.0,559.0,559.0,5,850,8.0,582.0,582.0
0.006,6,10,1689,5,839,1.0,571.0,571.0,5,850,1.0,582.0,582.0
0.037,17,4,284,2,120,0.0,32.0,32.0,2,164,33.0,60.0,54.0
0.005,6,10,2006,5,927,1.0,659.0,659.0,5,1079,1.0,811.0,811.0
0.014,6,10,1762,5,911,3.0,643.0,643.0,5,851,3.0,583.0,583.0
411.998,6,29,4409,12,3102,10911.0,494.0,494.0,17,1307,25749.0,83.0,83.0
0.171,6,3,453,2,321,171.0,241.0,241.0,1,132,0.0,92.0,92.0
240.463,6,36,10632,18,2211,14142.0,555.0,253.0,18,8421,14142.0,1402.0,624.0
0.081,6,10,1506,5,395,18.0,127.0,127.0,5,1111,19.0,843.0,843.0
0.012,6,10,1990,5,911,2.0,643.0,643.0,5,1079,3.0,811.0,811.0
0.005,6,10,2006,5,927,1.0,659.0,659.0,5,1079,1.0,811.0,811.0
0.102,6,10,1506,5,395,22.0,127.0,127.0,5,1111,22.0,843.0,843.0
0.069,6,10,1506,5,395,15.0,127.0,127.0,5,1111,14.0,843.0,843.0
0.004,6,10,2007,5,928,1.0,660.0,660.0,5,1079,1.0,811.0,811.0
0.006,6,10,1547,5,764,1.0,496.0,496.0,5,783,1.0,515.0,515.0
0.005,6,10,2000,5,927,1.0,659.0,659.0,5,1073,1.0,805.0,805.0
0.005,6,13,3747,7,509,0.0,137.0,137.0,6,3238,0.0,1470.0,1459.0
1778.634,17,144,41760,72,22752,25051.0,288.0,288.0,72,19008,25051.0,236.0,236.0
0.06,17,2,152,1,76,0.0,48.0,48.0,1,76,0.0,48.0,48.0
0.007,6,10,1989,5,910,1.0,642.0,642.0,5,1079,1.0,811.0,811.0
11.451,17,28,4399,14,2313,868.0,588.0,137.0,14,2086,868.0,269.0,121.0
0.094,6,10,1506,5,395,21.0,127.0,127.0,5,1111,20.0,843.0,843.0
0.017,6,10,1989,5,910,4.0,642.0,642.0,5,1079,4.0,811.0,811.0
0.006,6,10,1547,5,764,1.0,496.0,496.0,5,783,1.0,515.0,515.0
0.072,6,10,1506,5,395,16.0,127.0,127.0,5,1111,16.0,843.0,843.0
0.006,6,10,1547,5,764,1.0,496.0,496.0,5,783,1.0,515.0,515.0
11.139,17,28,4422,14,1995,844.0,270.0,114.0,14,2427,844.0,586.0,145.0
0.098,6,10,1506,5,395,23.0,127.0,127.0,5,1111,23.0,843.0,843.0
0.01,6,10,1677,5,827,2.0,559.0,559.0,5,850,2.0,582.0,582.0
0.089,6,10,1506,5,395,19.0,127.0,127.0,5,1111,19.0,843.0,843.0
10.972,17,28,4397,14,2312,835.0,587.0,137.0,14,2085,835.0,268.0,120.0
0.015,6,10,1631,5,848,3.0,580.0,580.0,5,783,3.0,515.0,515.0
0.005,6,10,1547,5,764,1.0,496.0,496.0,5,783,1.0,515.0,515.0
0.122,6,10,1762,5,911,30.0,643.0,643.0,5,851,30.0,583.0,583.0
0.133,17,2,80,1,32,0.0,4.0,4.0,1,48,0.0,20.0,20.0
0.004,6,10,1702,5,863,1.0,595.0,595.0,5,839,0.0,571.0,571.0
0.004,6,10,1779,5,928,1.0,660.0,660.0,5,851,1.0,583.0,583.0
0.088,6,10,1506,5,395,21.0,127.0,127.0,5,1111,20.0,843.0,843.0
0.124,17,2,144,1,64,0.0,36.0,36.0,1,80,0.0,52.0,52.0
0.003,17,2,136,1,60,0.0,32.0,32.0,1,76,0.0,48.0,48.0
15.074,17,15,9238,8,6902,2149.0,1350.0,834.0,7,2336,2507.0,1350.0,305.0
0.006,6,13,3690,7,452,0.0,80.0,80.0,6,3238,1.0,1470.0,1459.0
0.005,6,10,1643,5,860,1.0,592.0,592.0,5,783,1.0,515.0,515.0
0.006,6,10,1854,5,889,1.0,621.0,621.0,5,965,1.0,697.0,697.0
0.005,6,10,2006,5,927,1.0,659.0,659.0,5,1079,1.0,811.0,811.0
0.011,6,10,1972,5,910,2.0,642.0,642.0,5,1062,2.0,794.0,794.0
0.006,6,10,1547,5,764,1.0,496.0,496.0,5,783,1.0,515.0,515.0
15.073,17,15,9239,8,6902,2149.0,1350.0,834.0,7,2337,2507.0,1350.0,305.0
0.8,6,22,5072,11,1250,69.0,325.0,133.0,11,3822,69.0,1414.0,563.0
0.026,6,9,1190,5,751,6.0,495.0,495.0,4,439,5.0,223.0,223.0
0.011,6,10,1989,5,910,2.0,642.0,642.0,5,1079,2.0,811.0,811.0
0.021,6,10,1677,5,827,5.0,559.0,559.0,5,850,5.0,582.0,582.0
0.013,6,10,1989,5,910,3.0,642.0,642.0,5,1079,3.0,811.0,811.0
10.735,17,28,4423,14,1995,817.0,270.0,114.0,14,2428,817.0,587.0,145.0
0.005,6,10,2006,5,927,1.0,659.0,659.0,5,1079,1.0,811.0,811.0
0.005,17,2,170,1,65,0.0,37.0,37.0,1,105,0.0,77.0,77.0
0.09,6,10,1506,5,395,18.0,127.0,127.0,5,1111,19.0,843.0,843.0
0.007,6,10,2006,5,927,1.0,659.0,659.0,5,1079,1.0,811.0,811.0
300.947,6,47,19361,25,13683,12539.0,2720.0,1265.0,22,5678,417.0,2667.0,435.0
40.054,17,10,676,5,460,10012.0,104.0,64.0,5,216,10012.0,20.0,15.0
0.01,6,10,1677,5,827,2.0,559.0,559.0,5,850,2.0,582.0,582.0
0.021,6,10,1990,5,911,5.0,643.0,643.0,5,1079,5.0,811.0,811.0
0.005,6,10,1989,5,927,1.0,659.0,659.0,5,1062,1.0,794.0,794.0
0.004,6,10,1774,5,923,1.0,655.0,655.0,5,851,1.0,583.0,583.0
300.385,6,16,2170,9,684,37526.0,146.0,146.0,7,1486,50035.0,419.0,398.0
0.005,17,4,495,2,132,0.0,38.0,38.0,2,363,1.0,176.0,153.0
0.005,17,2,166,1,75,0.0,47.0,47.0,1,91,0.0,63.0,63.0
0.091,6,10,1506,5,395,20.0,127.0,127.0,5,1111,19.0,843.0,843.0
0.005,6,10,1854,5,889,1.0,621.0,621.0,5,965,1.0,697.0,697.0
1754.288,6,472,68544,260,35771,6773.0,613.0,193.0,212,32773,8313.0,613.0,149.0
0.005,6,10,1779,5,928,1.0,660.0,660.0,5,851,1.0,583.0,583.0
0.133,17,2,148,1,60,0.0,32.0,32.0,1,88,0.0,60.0,60.0
289.641,6,317,344617,131,18358,2228.0,2736.0,888.0,186,326259,1565.0,2879.0,1840.0
10.859,17,28,4423,14,1995,826.0,270.0,114.0,14,2428,826.0,587.0,145.0
0.01,6,10,1989,5,910,2.0,642.0,642.0,5,1079,2.0,811.0,811.0
0.017,6,10,1989,5,910,4.0,642.0,642.0,5,1079,4.0,811.0,811.0
291.216,6,400,348636,212,22589,1380.0,2736.0,889.0,188,326047,1557.0,2804.0,1817.0
176.103,17,84,11764,42,2812,4295.0,44.0,38.0,42,8952,4295.0,239.0,185.0
0.005,6,10,1854,5,889,1.0,621.0,621.0,5,965,1.0,697.0,697.0
0.107,6,10,1506,5,395,23.0,127.0,127.0,5,1111,23.0,843.0,843.0
0.01,6,10,1689,5,839,2.0,571.0,571.0,5,850,2.0,582.0,582.0
0.0,17,2,140,1,62,0.0,34.0,34.0,1,78,0.0,50.0,50.0
0.008,6,10,1989,5,910,1.0,642.0,642.0,5,1079,2.0,811.0,811.0
0.004,17,2,148,1,60,0.0,32.0,32.0,1,88,0.0,60.0,60.0
0.07,6,10,1506,5,395,15.0,127.0,127.0,5,1111,14.0,843.0,843.0
1784.455,6,240,46357,117,33986,15383.0,2473.0,1033.0,123,12371,14626.0,580.0,62.0
0.01,6,10,1677,5,827,2.0,559.0,559.0,5,850,2.0,582.0,582.0
0.004,6,10,2007,5,928,1.0,660.0,660.0,5,1079,1.0,811.0,811.0
0.042,17,2,170,1,65,0.0,37.0,37.0,1,105,0.0,77.0,77.0
0.065,6,10,1506,5,395,14.0,127.0,127.0,5,1111,15.0,843.0,843.0
0.004,6,10,2000,5,927,1.0,659.0,659.0,5,1073,1.0,805.0,805.0
0.014,6,10,1983,5,910,3.0,642.0,642.0,5,1073,3.0,805.0,805.0
0.111,6,10,1506,5,395,25.0,127.0,127.0,5,1111,23.0,843.0,843.0
0.005,6,10,2006,5,927,1.0,659.0,659.0,5,1079,1.0,811.0,811.0
0.117,6,10,1506,5,395,28.0,127.0,127.0,5,1111,23.0,843.0,843.0
0.005,6,10,1689,5,839,1.0,571.0,571.0,5,850,1.0,582.0,582.0
0.102,6,10,1506,5,395,24.0,127.0,127.0,5,1111,24.0,843.0,843.0
0.069,17,8,3613,4,1874,23.0,1350.0,440.0,4,1739,11.0,1350.0,406.0
0.004,17,4,284,2,120,0.0,32.0,32.0,2,164,0.0,60.0,54.0
300.222,6,32,13109,17,6876,18763.0,2662.0,997.0,15,6233,21444.0,1656.0,909.0
0.004,6,10,1989,5,927,1.0,659.0,659.0,5,1062,1.0,794.0,794.0
0.004,6,10,2007,5,928,1.0,660.0,660.0,5,1079,1.0,811.0,811.0
0.012,6,10,1990,5,911,3.0,643.0,643.0,5,1079,2.0,811.0,811.0
0.005,6,10,2000,5,927,1.0,659.0,659.0,5,1073,1.0,805.0,805.0
0.004,17,4,284,2,120,0.0,32.0,32.0,2,164,0.0,60.0,54.0
0.064,6,10,1506,5,395,13.0,127.0,127.0,5,1111,15.0,843.0,843.0
0.009,6,10,1989,5,910,2.0,642.0,642.0,5,1079,2.0,811.0,811.0
0.012,6,10,1631,5,848,3.0,580.0,580.0,5,783,3.0,515.0,515.0
1787.194,6,154,19574,92,13852,19639.0,302.0,302.0,62,5722,29298.0,83.0,83.0
0.131,6,10,1506,5,395,32.0,127.0,127.0,5,1111,28.0,843.0,843.0
0.008,6,10,1989,5,910,2.0,642.0,642.0,5,1079,1.0,811.0,811.0
0.004,6,10,1989,5,927,1.0,659.0,659.0,5,1062,1.0,794.0,794.0
0.005,17,2,144,1,64,0.0,36.0,36.0,1,80,0.0,52.0,52.0
0.005,6,10,1779,5,928,1.0,660.0,660.0,5,851,1.0,583.0,583.0
0.16,17,2,142,1,63,0.0,35.0,35.0,1,79,0.0,51.0,51.0
0.013,6,10,1677,5,827,3.0,559.0,559.0,5,850,3.0,582.0,582.0
0.003,17,2,136,1,60,0.0,32.0,32.0,1,76,0.0,48.0,48.0
0.094,6,10,1506,5,395,22.0,127.0,127.0,5,1111,19.0,843.0,843.0
0.005,6,10,1779,5,928,1.0,660.0,660.0,5,851,1.0,583.0,583.0
0.005,6,10,1989,5,927,1.0,659.0,659.0,5,1062,1.0,794.0,794.0
0.004,6,10,1702,5,863,1.0,595.0,595.0,5,839,0.0,571.0,571.0
0.01,6,10,1990,5,911,2.0,643.0,643.0,5,1079,2.0,811.0,811.0
0.096,17,4,596,2,122,57.0,33.0,33.0,2,474,55.0,323.0,209.0
0.005,6,10,2006,5,927,1.0,659.0,659.0,5,1079,1.0,811.0,811.0
0.004,17,4,284,2,120,0.0,32.0,32.0,2,164,1.0,60.0,54.0
0.005,6,10,1547,5,764,1.0,496.0,496.0,5,783,1.0,515.0,515.0
0.117,6,10,1506,5,395,27.0,127.0,127.0,5,1111,28.0,843.0,843.0
0.011,6,10,1677,5,827,2.0,559.0,559.0,5,850,2.0,582.0,582.0
291.724,6,393,348832,208,22366,1409.0,2736.0,888.0,185,326466,1585.0,4171.0,1852.0
0.006,6,10,1989,5,927,1.0,659.0,659.0,5,1062,1.0,794.0,794.0
0.006,17,2,164,1,74,0.0,46.0,46.0,1,90,0.0,62.0,62.0
0.006,6,10,1547,5,764,1.0,496.0,496.0,5,783,1.0,515.0,515.0
0.269,17,39,20048,22,17078,12.0,1350.0,748.0,17,2970,12.0,1350.0,146.0
300.313,6,16,2170,9,684,37518.0,146.0,146.0,7,1486,50024.0,419.0,398.0
0.006,17,2,164,1,74,0.0,46.0,46.0,1,90,0.0,62.0,62.0
0.004,17,4,284,2,120,0.0,32.0,32.0,2,164,1.0,60.0,54.0
300.498,6,27,8922,15,1930,21464.0,517.0,285.0,12,6992,21860.0,1402.0,908.0
0.006,6,10,1547,5,764,1.0,496.0,496.0,5,783,1.0,515.0,515.0
0.005,6,10,1779,5,928,1.0,660.0,660.0,5,851,1.0,583.0,583.0
0.005,17,2,179,1,71,0.0,43.0,43.0,1,108,0.0,80.0,80.0
0.085,6,10,1506,5,395,18.0,127.0,127.0,5,1111,20.0,843.0,843.0
0.006,6,10,1643,5,860,1.0,592.0,592.0,5,783,1.0,515.0,515.0
0.009,17,2,166,1,75,0.0,47.0,47.0,1,91,0.0,63.0,63.0
0.005,6,10,2000,5,927,1.0,659.0,659.0,5,1073,1.0,805.0,805.0
0.005,6,10,2006,5,927,1.0,659.0,659.0,5,1079,1.0,811.0,811.0
0.078,6,10,1506,5,395,16.0,127.0,127.0,5,1111,17.0,843.0,843.0
0.081,6,10,1506,5,395,17.0,127.0,127.0,5,1111,19.0,843.0,843.0
240.013,6,9,787,5,488,60003.0,232.0,232.0,4,299,80003.0,83.0,83.0
0.058,17,2,144,1,64,0.0,36.0,36.0,1,80,0.0,52.0,52.0
40.055,17,10,676,5,460,10013.0,104.0,64.0,5,216,10012.0,20.0,15.0
10.812,17,28,4422,14,1995,823.0,270.0,114.0,14,2427,823.0,586.0,145.0
0.116,6,10,1506,5,395,28.0,127.0,127.0,5,1111,22.0,843.0,843.0
40.067,17,10,676,5,460,10014.0,104.0,64.0,5,216,10015.0,20.0,15.0
0.005,6,10,1989,5,927,1.0,659.0,659.0,5,1062,1.0,794.0,794.0
0.004,6,10,1702,5,863,0.0,595.0,595.0,5,839,1.0,571.0,571.0
0.001,17,2,180,1,66,0.0,38.0,38.0,1,114,0.0,86.0,86.0
0.006,17,2,140,1,62,0.0,34.0,34.0,1,78,0.0,50.0,50.0
0.018,6,10,1989,5,910,4.0,642.0,642.0,5,1079,4.0,811.0,811.0
0.004,17,4,284,2,120,1.0,32.0,32.0,2,164,1.0,60.0,54.0
0.097,6,10,1506,5,395,21.0,127.0,127.0,5,1111,19.0,843.0,843.0
0.011,6,10,1972,5,910,2.0,642.0,642.0,5,1062,2.0,794.0,794.0
0.004,6,10,2006,5,927,1.0,659.0,659.0,5,1079,1.0,811.0,811.0
0.009,6,12,1926,6,1189,1.0,659.0,434.0,6,737,1.0,417.0,417.0
0.005,6,10,2007,5,928,1.0,660.0,660.0,5,1079,1.0,811.0,811.0
0.01,6,10,1989,5,910,2.0,642.0,642.0,5,1079,2.0,811.0,811.0
167.171,17,80,11186,40,2664,4286.0,44.0,38.0,40,8522,4286.0,261.0,185.0
369.524,6,21,1793,16,1030,24634.0,190.0,190.0,5,763,60012.0,462.0,247.0
0.008,6,13,3735,7,497,1.0,125.0,125.0,6,3238,1.0,1470.0,1459.0
0.004,17,2,148,1,60,0.0,32.0,32.0,1,88,0.0,60.0,60.0
0.064,6,10,1506,5,395,15.0,127.0,127.0,5,1111,11.0,843.0,843.0
0.008,6,12,1926,6,1189,1.0,659.0,434.0,6,737,1.0,417.0,417.0
0.019,6,10,1972,5,910,4.0,642.0,642.0,5,1062,4.0,794.0,794.0
0.012,6,10,1989,5,910,3.0,642.0,642.0,5,1079,3.0,811.0,811.0
0.001,17,2,180,1,66,0.0,38.0,38.0,1,114,0.0,86.0,86.0
0.004,17,2,148,1,60,0.0,32.0,32.0,1,88,0.0,60.0,60.0
0.006,17,2,170,1,65,0.0,37.0,37.0,1,105,0.0,77.0,77.0
0.011,6,10,1631,5,848,2.0,580.0,580.0,5,783,2.0,515.0,515.0
0.012,6,10,1972,5,910,3.0,642.0,642.0,5,1062,3.0,794.0,794.0
11.203,17,28,4422,14,1994,849.0,269.0,114.0,14,2428,849.0,587.0,145.0
0.003,17,2,136,1,60,0.0,32.0,32.0,1,76,0.0,48.0,48.0
0.024,6,10,1972,5,910,6.0,642.0,642.0,5,1062,6.0,794.0,794.0
0.008,6,10,2006,5,927,2.0,659.0,659.0,5,1079,2.0,811.0,811.0
0.005,6,13,3747,7,509,0.0,137.0,137.0,6,3238,1.0,1470.0,1459.0
0.117,6,10,1506,5,395,25.0,127.0,127.0,5,1111,25.0,843.0,843.0
0.005,6,10,2006,5,927,1.0,659.0,659.0,5,1079,1.0,811.0,811.0
178.305,17,94,13202,47,3119,3876.0,44.0,38.0,47,10083,3876.0,261.0,186.0
0.023,6,10,1972,5,910,5.0,642.0,642.0,5,1062,5.0,794.0,794.0
174.301,17,76,10889,38,2530,4710.0,44.0,38.0,38,8359,4710.0,260.0,191.0
0.005,6,10,1779,5,928,1.0,660.0,660.0,5,851,1.0,583.0,583.0
40.057,17,10,676,5,460,10012.0,104.0,64.0,5,216,10013.0,20.0,15.0
0.004,17,4,284,2,120,0.0,32.0,32.0,2,164,1.0,60.0,54.0
0.072,17,4,284,2,120,0.0,32.0,32.0,2,164,68.0,60.0,54.0
0.019,6,10,1762,5,911,4.0,643.0,643.0,5,851,4.0,583.0,583.0
49.056,6,49,19937,25,13905,381.0,4080.0,1837.0,24,6032,2125.0,2667.0,361.0
1770.532,17,92,8096,46,4048,39345.0,60.0,60.0,46,4048,39345.0,60.0,60.0
0.008,6,10,1990,5,911,2.0,643.0,643.0,5,1079,1.0,811.0,811.0
0.005,6,10,1989,5,927,1.0,659.0,659.0,5,1062,1.0,794.0,794.0
0.003,17,4,284,2,120,0.0,32.0,32.0,2,164,0.0,60.0,54.0
0.004,17,2,170,1,65,0.0,37.0,37.0,1,105,0.0,77.0,77.0
40.07,17,10,676,5,460,10014.0,104.0,64.0,5,216,10016.0,20.0,15.0
0.011,6,12,1926,6,1189,2.0,659.0,434.0,6,737,2.0,417.0,417.0
0.006,17,2,136,1,60,0.0,32.0,32.0,1,76,0.0,48.0,48.0
0.078,6,10,1506,5,395,16.0,127.0,127.0,5,1111,17.0,843.0,843.0
0.005,17,2,179,1,71,0.0,43.0,43.0,1,108,0.0,80.0,80.0
40.045,17,10,676,5,460,10009.0,104.0,64.0,5,216,10010.0,20.0,15.0
10.819,17,28,4422,14,1994,823.0,269.0,114.0,14,2428,823.0,587.0,145.0
0.005,6,10,2006,5,927,1.0,659.0,659.0,5,1079,1.0,811.0,811.0
0.007,6,10,1689,5,839,1.0,571.0,571.0,5,850,1.0,582.0,582.0
0.013,6,10,1983,5,910,3.0,642.0,642.0,5,1073,3.0,805.0,805.0
308.859,17,20,1124,10,716,34303.0,48.0,43.0,10,408,34303.0,20.0,12.0
0.012,6,10,1989,5,910,3.0,642.0,642.0,5,1079,2.0,811.0,811.0
0.017,6,10,1989,5,910,4.0,642.0,642.0,5,1079,4.0,811.0,811.0
0.169,17,2,152,1,76,0.0,48.0,48.0,1,76,0.0,48.0,48.0
0.025,17,2,299,1,65,0.0,37.0,37.0,1,234,0.0,206.0,206.0
0.006,6,10,1547,5,764,1.0,496.0,496.0,5,783,1.0,515.0,515.0
0.009,6,10,1983,5,910,2.0,642.0,642.0,5,1073,2.0,805.0,805.0
40.082,17,10,676,5,460,10017.0,104.0,64.0,5,216,10019.0,20.0,15.0
0.008,6,10,1689,5,839,2.0,571.0,571.0,5,850,2.0,582.0,582.0
390.607,6,29,7962,16,3168,26040.0,676.0,388.0,13,4794,27546.0,1402.0,685.0
0.005,6,10,2007,5,928,1.0,660.0,660.0,5,1079,1.0,811.0,811.0
300.403,6,16,2170,9,684,37528.0,146.0,146.0,7,1486,50038.0,419.0,398.0
0.011,6,10,1989,5,910,2.0,642.0,642.0,5,1079,2.0,811.0,811.0
40.054,17,10,676,5,460,10013.0,104.0,64.0,5,216,10012.0,20.0,15.0
0.034,6,19,9922,11,704,3.0,124.0,124.0,8,9218,4.0,2896.0,2198.0
0.005,6,10,1689,5,839,1.0,571.0,571.0,5,850,1.0,582.0,582.0
0.005,17,2,148,1,60,0.0,32.0,32.0,1,88,0.0,60.0,60.0
0.004,6,10,2006,5,927,1.0,659.0,659.0,5,1079,1.0,811.0,811.0
0.01,6,10,1677,5,827,2.0,559.0,559.0,5,850,2.0,582.0,582.0
0.001,17,2,194,1,57,0.0,29.0,29.0,1,137,0.0,109.0,109.0
0.006,6,10,1547,5,764,1.0,496.0,496.0,5,783,1.0,515.0,515.0
0.04,17,2,182,1,65,0.0,37.0,37.0,1,117,0.0,89.0,89.0
0.012,6,10,1631,5,848,3.0,580.0,580.0,5,783,3.0,515.0,515.0
0.005,6,13,3747,7,509,0.0,137.0,137.0,6,3238,1.0,1470.0,1459.0
0.108,6,10,1506,5,395,24.0,127.0,127.0,5,1111,19.0,843.0,843.0
0.005,6,10,1689,5,839,1.0,571.0,571.0,5,850,1.0,582.0,582.0
11.194,17,28,4422,14,1995,848.0,270.0,114.0,14,2427,848.0,586.0,145.0
0.005,6,10,1689,5,839,1.0,571.0,571.0,5,850,1.0,582.0,582.0
0.008,6,10,1774,5,923,2.0,655.0,655.0,5,851,2.0,583.0,583.0
0.006,6,10,1547,5,764,1.0,496.0,496.0,5,783,1.0,515.0,515.0
0.061,17,2,80,1,32,0.0,4.0,4.0,1,48,0.0,20.0,20.0
40.079,17,10,676,5,460,10018.0,104.0,64.0,5,216,10018.0,20.0,15.0
0.011,6,10,1989,5,910,2.0,642.0,642.0,5,1079,2.0,811.0,811.0
0.005,17,2,249,1,64,0.0,36.0,36.0,1,185,0.0,157.0,157.0
0.019,6,10,1989,5,910,4.0,642.0,642.0,5,1079,4.0,811.0,811.0
0.01,6,10,1989,5,910,2.0,642.0,642.0,5,1079,2.0,811.0,811.0
0.009,17,2,194,1,59,0.0,31.0,31.0,1,135,0.0,107.0,107.0
280.285,6,23,6075,10,1186,31142.0,267.0,156.0,13,4889,23356.0,1400.0,873.0
0.005,17,2,230,1,68,0.0,40.0,40.0,1,162,0.0,134.0,134.0
1778.776,17,144,41760,72,22752,25053.0,288.0,288.0,72,19008,25053.0,236.0,236.0
0.103,6,10,1506,5,395,21.0,127.0,127.0,5,1111,22.0,843.0,843.0
309.863,17,20,1124,10,716,34415.0,48.0,43.0,10,408,34415.0,20.0,12.0
0.007,6,10,2007,5,928,1.0,660.0,660.0,5,1079,1.0,811.0,811.0
10.908,17,28,4422,14,1994,830.0,269.0,114.0,14,2428,830.0,587.0,145.0
0.005,17,2,166,1,75,0.0,47.0,47.0,1,91,0.0,63.0,63.0
0.009,6,10,1989,5,910,2.0,642.0,642.0,5,1079,2.0,811.0,811.0
0.005,6,10,2006,5,927,1.0,659.0,659.0,5,1079,1.0,811.0,811.0
370.298,6,51,13352,26,10072,14811.0,1515.0,581.0,25,3280,15429.0,580.0,151.0
11.454,17,28,4392,14,2313,868.0,588.0,137.0,14,2079,868.0,270.0,120.0
0.006,6,10,1547,5,764,1.0,496.0,496.0,5,783,1.0,515.0,515.0
0.016,6,10,1677,5,827,4.0,559.0,559.0,5,850,3.0,582.0,582.0
10.812,17,28,4422,14,1993,823.0,268.0,114.0,14,2429,823.0,588.0,145.0
0.104,6,10,1506,5,395,20.0,127.0,127.0,5,1111,21.0,843.0,843.0
11.011,17,28,4398,14,2312,837.0,587.0,137.0,14,2086,838.0,269.0,121.0
0.007,6,10,1643,5,860,1.0,592.0,592.0,5,783,1.0,515.0,515.0
0.017,6,10,1631,5,848,4.0,580.0,580.0,5,783,4.0,515.0,515.0
361.766,6,19,1689,15,978,25840.0,190.0,190.0,4,711,80013.0,495.0,495.0
0.015,6,10,1989,5,910,3.0,642.0,642.0,5,1079,3.0,811.0,811.0
11.186,17,28,4421,14,1994,847.0,269.0,114.0,14,2427,847.0,586.0,145.0
0.142,6,10,1506,5,395,33.0,127.0,127.0,5,1111,33.0,843.0,843.0
0.007,6,10,1689,5,839,1.0,571.0,571.0,5,850,1.0,582.0,582.0
0.005,6,10,1989,5,927,1.0,659.0,659.0,5,1062,1.0,794.0,794.0
0.007,6,10,1547,5,764,1.0,496.0,496.0,5,783,1.0,515.0,515.0
1729.223,6,62,4504,40,2740,44339.0,33.0,33.0,22,1764,82335.0,31.0,31.0
0.006,6,10,1547,5,764,1.0,496.0,496.0,5,783,1.0,515.0,515.0
0.008,6,10,1989,5,910,2.0,642.0,642.0,5,1079,2.0,811.0,811.0
0.012,6,10,1973,5,911,3.0,643.0,643.0,5,1062,3.0,794.0,794.0
0.006,17,2,136,1,60,0.0,32.0,32.0,1,76,0.0,48.0,48.0
312.073,17,20,1124,10,716,34661.0,48.0,43.0,10,408,34661.0,20.0,12.0
0.073,6,10,1506,5,395,15.0,127.0,127.0,5,1111,17.0,843.0,843.0
0.009,6,10,1990,5,911,2.0,643.0,643.0,5,1079,2.0,811.0,811.0
0.008,6,12,1926,6,1189,1.0,659.0,434.0,6,737,1.0,417.0,417.0
0.007,6,10,1643,5,860,1.0,592.0,592.0,5,783,1.0,515.0,515.0
0.06,17,2,152,1,76,0.0,48.0,48.0,1,76,0.0,48.0,48.0
0.013,6,13,3735,7,497,2.0,125.0,125.0,6,3238,2.0,1470.0,1459.0
0.003,17,2,185,1,73,0.0,45.0,45.0,1,112,0.0,84.0,84.0
0.006,6,10,1547,5,764,1.0,496.0,496.0,5,783,1.0,515.0,515.0
0.01,6,14,3787,7,497,1.0,125.0,125.0,7,3290,1.0,1448.0,972.0
0.009,6,10,1989,5,910,2.0,642.0,642.0,5,1079,2.0,811.0,811.0
0.004,6,10,1779,5,928,1.0,660.0,660.0,5,851,1.0,583.0,583.0
0.082,6,10,1506,5,395,17.0,127.0,127.0,5,1111,19.0,843.0,843.0
0.037,6,10,1989,5,910,9.0,642.0,642.0,5,1079,9.0,811.0,811.0
0.123,6,10,1506,5,395,26.0,127.0,127.0,5,1111,30.0,843.0,843.0
0.007,6,10,1547,5,764,1.0,496.0,496.0,5,783,1.0,515.0,515.0
0.016,6,10,1762,5,911,4.0,643.0,643.0,5,851,3.0,583.0,583.0
0.025,6,10,1989,5,910,6.0,642.0,642.0,5,1079,6.0,811.0,811.0
0.087,6,10,1506,5,395,19.0,127.0,127.0,5,1111,18.0,843.0,843.0
0.006,6,10,1547,5,764,1.0,496.0,496.0,5,783,1.0,515.0,515.0
40.074,17,10,676,5,460,10016.0,104.0,64.0,5,216,10017.0,20.0,15.0
0.072,17,2,234,1,61,0.0,33.0,33.0,1,173,0.0,145.0,145.0
309.468,17,20,1124,10,716,34371.0,48.0,43.0,10,408,34370.0,20.0,12.0
0.006,6,10,1989,5,927,1.0,659.0,659.0,5,1062,1.0,794.0,794.0
0.006,6,10,1547,5,764,1.0,496.0,496.0,5,783,1.0,515.0,515.0
0.086,6,10,1506,5,395,19.0,127.0,127.0,5,1111,18.0,843.0,843.0
0.001,17,2,140,1,62,0.0,34.0,34.0,1,78,0.0,50.0,50.0
15.072,17,14,9190,8,6902,2149.0,1350.0,834.0,6,2288,3008.0,1350.0,353.0
412.27,6,29,4409,12,3102,10913.0,494.0,494.0,17,1307,25766.0,83.0,83.0
0.081,6,10,1506,5,395,16.0,127.0,127.0,5,1111,19.0,843.0,843.0
0.015,6,10,1983,5,910,3.0,642.0,642.0,5,1073,3.0,805.0,805.0
0.153,6,10,1506,5,395,20.0,127.0,127.0,5,1111,32.0,843.0,843.0
0.005,17,2,146,1,65,0.0,37.0,37.0,1,81,0.0,53.0,53.0
15.072,17,15,9238,8,6902,2149.0,1350.0,834.0,7,2336,2507.0,1350.0,305.0
0.004,17,2,148,1,60,0.0,32.0,32.0,1,88,0.0,60.0,60.0
0.112,6,10,1506,5,395,26.0,127.0,127.0,5,1111,24.0,843.0,843.0
0.075,6,10,1506,5,395,16.0,127.0,127.0,5,1111,15.0,843.0,843.0
0.039,17,2,182,1,65,0.0,37.0,37.0,1,117,0.0,89.0,89.0
0.015,6,13,3735,7,497,2.0,125.0,125.0,6,3238,2.0,1470.0,1459.0
0.011,6,14,3787,7,497,1.0,125.0,125.0,7,3290,1.0,1448.0,972.0
0.005,6,10,1779,5,928,1.0,660.0,660.0,5,851,1.0,583.0,583.0
0.104,6,10,1506,5,395,19.0,127.0,127.0,5,1111,20.0,843.0,843.0
0.008,6,10,1677,5,827,2.0,559.0,559.0,5,850,2.0,582.0,582.0
0.016,6,10,1989,5,910,4.0,642.0,642.0,5,1079,3.0,811.0,811.0
0.01,6,10,1762,5,911,2.0,643.0,643.0,5,851,2.0,583.0,583.0
0.007,17,2,179,1,71,0.0,43.0,43.0,1,108,0.0,80.0,80.0
0.005,6,10,1989,5,927,1.0,659.0,659.0,5,1062,1.0,794.0,794.0
0.012,6,10,1990,5,911,2.0,643.0,643.0,5,1079,2.0,811.0,811.0
0.005,6,10,2000,5,927,1.0,659.0,659.0,5,1073,1.0,805.0,805.0
0.119,6,10,1506,5,395,27.0,127.0,127.0,5,1111,27.0,843.0,843.0
0.006,6,10,2006,5,927,1.0,659.0,659.0,5,1079,1.0,811.0,811.0
308.534,17,18,1008,9,640,38551.0,48.0,43.0,9,368,38551.0,20.0,12.0
0.008,6,10,2006,5,927,2.0,659.0,659.0,5,1079,1.0,811.0,811.0
300.406,6,16,2170,9,684,37529.0,146.0,146.0,7,1486,50039.0,419.0,398.0
0.012,6,10,1989,5,910,3.0,642.0,642.0,5,1079,3.0,811.0,811.0
15.072,17,15,9238,8,6902,2149.0,1350.0,834.0,7,2336,2507.0,1350.0,305.0
0.005,6,10,2006,5,927,1.0,659.0,659.0,5,1079,1.0,811.0,811.0
0.005,6,13,3684,7,446,0.0,74.0,74.0,6,3238,1.0,1470.0,1459.0
314.446,17,20,1124,10,716,34924.0,48.0,43.0,10,408,34924.0,20.0,12.0
0.071,17,2,136,1,60,0.0,32.0,32.0,1,76,0.0,48.0,48.0
0.013,6,10,1972,5,910,3.0,642.0,642.0,5,1062,3.0,794.0,794.0
0.078,6,10,1506,5,395,17.0,127.0,127.0,5,1111,16.0,843.0,843.0
0.004,6,10,2006,5,927,1.0,659.0,659.0,5,1079,1.0,811.0,811.0
0.006,6,10,1547,5,764,1.0,496.0,496.0,5,783,1.0,515.0,515.0
0.016,17,2,198,1,91,0.0,63.0,63.0,1,107,0.0,79.0,79.0
0.01,6,10,1677,5,827,2.0,559.0,559.0,5,850,2.0,582.0,582.0
0.006,6,10,1547,5,764,1.0,496.0,496.0,5,783,1.0,515.0,515.0
0.005,6,10,2006,5,927,1.0,659.0,659.0,5,1079,1.0,811.0,811.0
368.618,6,22,2313,16,867,24574.0,195.0,195.0,6,1446,4638.0,419.0,398.0
0.005,6,10,2000,5,927,1.0,659.0,659.0,5,1073,1.0,805.0,805.0
0.005,17,4,284,2,120,0.0,32.0,32.0,2,164,0.0,60.0,54.0
0.014,6,10,1983,5,910,3.0,642.0,642.0,5,1073,3.0,805.0,805.0
0.005,6,10,1989,5,927,1.0,659.0,659.0,5,1062,1.0,794.0,794.0
0.041,17,4,284,2,120,1.0,32.0,32.0,2,164,37.0,60.0,54.0
0.072,17,2,148,1,60,0.0,32.0,32.0,1,88,0.0,60.0,60.0
0.018,6,10,1989,5,910,4.0,642.0,642.0,5,1079,4.0,811.0,811.0
0.105,6,10,1506,5,395,21.0,127.0,127.0,5,1111,22.0,843.0,843.0
0.005,6,10,2007,5,928,1.0,660.0,660.0,5,1079,1.0,811.0,811.0
0.005,6,10,1989,5,927,1.0,659.0,659.0,5,1062,1.0,794.0,794.0
0.001,17,2,174,1,72,0.0,44.0,44.0,1,102,0.0,74.0,74.0
0.009,6,13,3735,7,497,1.0,125.0,125.0,6,3238,1.0,1470.0,1459.0
0.004,6,10,1774,5,923,1.0,655.0,655.0,5,851,1.0,583.0,583.0
15.076,17,16,8845,8,6711,2149.0,1350.0,810.0,8,2134,2149.0,1350.0,238.0
0.109,6,10,1506,5,395,21.0,127.0,127.0,5,1111,23.0,843.0,843.0
0.006,6,10,1689,5,839,1.0,571.0,571.0,5,850,1.0,582.0,582.0
40.058,17,10,676,5,460,10013.0,104.0,64.0,5,216,10013.0,20.0,15.0
0.01,6,10,1762,5,911,2.0,643.0,643.0,5,851,2.0,583.0,583.0
0.037,17,2,152,1,76,0.0,48.0,48.0,1,76,0.0,48.0,48.0
0.005,17,2,164,1,74,0.0,46.0,46.0,1,90,0.0,62.0,62.0
0.005,6,10,2006,5,927,1.0,659.0,659.0,5,1079,1.0,811.0,811.0
0.006,6,10,1854,5,889,1.0,621.0,621.0,5,965,1.0,697.0,697.0
0.005,6,10,1689,5,839,1.0,571.0,571.0,5,850,1.0,582.0,582.0
0.088,6,10,1506,5,395,20.0,127.0,127.0,5,1111,17.0,843.0,843.0
0.011,6,10,1989,5,910,2.0,642.0,642.0,5,1079,2.0,811.0,811.0
0.011,6,10,1983,5,910,2.0,642.0,642.0,5,1073,2.0,805.0,805.0
0.005,17,2,170,1,65,0.0,37.0,37.0,1,105,0.0,77.0,77.0
293.304,6,382,347177,199,21914,1481.0,2736.0,889.0,183,325263,1611.0,4171.0,1857.0
0.012,6,10,1972,5,910,2.0,642.0,642.0,5,1062,2.0,794.0,794.0
0.003,17,2,136,1,60,0.0,32.0,32.0,1,76,0.0,48.0,48.0
0.011,6,10,1972,5,910,2.0,642.0,642.0,5,1062,2.0,794.0,794.0
179.124,17,78,11096,39,2600,4713.0,44.0,38.0,39,8496,4713.0,261.0,189.0
0.012,6,10,1972,5,910,3.0,642.0,642.0,5,1062,3.0,794.0,794.0
0.003,17,2,148,1,60,0.0,32.0,32.0,1,88,0.0,60.0,60.0
0.011,6,10,1631,5,848,2.0,580.0,580.0,5,783,2.0,515.0,515.0
0.004,17,4,284,2,120,0.0,32.0,32.0,2,164,0.0,60.0,54.0
0.003,17,4,284,2,120,0.0,32.0,32.0,2,164,0.0,60.0,54.0
0.005,6,10,2006,5,927,1.0,659.0,659.0,5,1079,1.0,811.0,811.0
172.156,17,68,9736,34,2258,5216.0,44.0,38.0,34,7478,5216.0,239.0,191.0
0.007,17,2,180,1,66,0.0,38.0,38.0,1,114,0.0,86.0,86.0
0.01,6,10,1990,5,911,2.0,643.0,643.0,5,1079,2.0,811.0,811.0
0.017,6,10,1631,5,848,4.0,580.0,580.0,5,783,4.0,515.0,515.0
40.053,17,10,676,5,460,10012.0,104.0,64.0,5,216,10012.0,20.0,15.0
285.222,6,30,6574,16,1433,19014.0,517.0,290.0,14,5141,21939.0,2379.0,1104.0
241.755,6,389,347961,190,21407,1279.0,2736.0,959.0,199,326554,1220.0,4127.0,1673.0
0.058,6,10,1506,5,395,12.0,127.0,127.0,5,1111,12.0,843.0,843.0
240.155,6,45,7048,21,3171,12007.0,588.0,230.0,24,3877,10441.0,580.0,238.0
0.014,6,10,1989,5,910,3.0,642.0,642.0,5,1079,3.0,811.0,811.0
0.009,6,10,1983,5,910,2.0,642.0,642.0,5,1073,2.0,805.0,805.0
0.013,6,10,1990,5,911,3.0,643.0,643.0,5,1079,3.0,811.0,811.0
0.006,17,2,164,1,74,0.0,46.0,46.0,1,90,0.0,62.0,62.0
0.005,6,10,1989,5,927,1.0,659.0,659.0,5,1062,1.0,794.0,794.0
0.016,6,10,1762,5,911,3.0,643.0,643.0,5,851,3.0,583.0,583.0
10.858,17,28,4393,14,1993,826.0,268.0,114.0,14,2400,826.0,587.0,143.0
0.008,6,14,3787,7,497,1.0,125.0,125.0,7,3290,1.0,1448.0,972.0
0.005,17,2,168,1,76,0.0,48.0,48.0,1,92,0.0,64.0,64.0
0.073,6,10,1506,5,395,15.0,127.0,127.0,5,1111,15.0,843.0,843.0
0.005,17,2,154,1,69,0.0,41.0,41.0,1,85,0.0,57.0,57.0
0.025,6,10,1983,5,910,6.0,642.0,642.0,5,1073,6.0,805.0,805.0
0.001,17,2,166,1,75,0.0,47.0,47.0,1,91,0.0,63.0,63.0
0.01,6,10,1990,5,911,2.0,643.0,643.0,5,1079,2.0,811.0,811.0
0.005,17,2,148,1,60,0.0,32.0,32.0,1,88,0.0,60.0,60.0
0.006,6,10,1643,5,860,1.0,592.0,592.0,5,783,1.0,515.0,515.0
178.057,17,84,12026,42,2825,4342.0,44.0,39.0,42,9201,4342.0,239.0,191.0
0.006,6,10,1547,5,764,1.0,496.0,496.0,5,783,1.0,515.0,515.0
0.097,6,10,1506,5,395,22.0,127.0,127.0,5,1111,20.0,843.0,843.0
0.012,6,10,1990,5,911,3.0,643.0,643.0,5,1079,2.0,811.0,811.0
0.008,6,10,1989,5,910,2.0,642.0,642.0,5,1079,2.0,811.0,811.0
0.005,6,10,2007,5,928,1.0,660.0,660.0,5,1079,1.0,811.0,811.0
162.063,17,80,11878,40,2694,4155.0,44.0,39.0,40,9184,4155.0,261.0,201.0
0.006,17,2,230,1,68,0.0,40.0,40.0,1,162,0.0,134.0,134.0
0.078,6,10,1506,5,395,14.0,127.0,127.0,5,1111,19.0,843.0,843.0
0.009,6,10,1972,5,910,2.0,642.0,642.0,5,1062,2.0,794.0,794.0
0.003,17,2,148,1,60,0.0,32.0,32.0,1,88,0.0,60.0,60.0
0.012,6,10,1989,5,910,3.0,642.0,642.0,5,1079,3.0,811.0,811.0
40.055,17,10,676,5,460,10012.0,104.0,64.0,5,216,10013.0,20.0,15.0
0.093,6,10,1506,5,395,20.0,127.0,127.0,5,1111,18.0,843.0,843.0
0.079,6,10,1506,5,395,18.0,127.0,127.0,5,1111,17.0,843.0,843.0
0.025,6,10,1989,5,910,6.0,642.0,642.0,5,1079,6.0,811.0,811.0
0.005,6,10,2007,5,928,1.0,660.0,660.0,5,1079,1.0,811.0,811.0
40.074,17,10,676,5,460,10017.0,104.0,64.0,5,216,10017.0,20.0,15.0
0.009,6,10,1972,5,910,2.0,642.0,642.0,5,1062,2.0,794.0,794.0
0.01,6,10,1972,5,910,2.0,642.0,642.0,5,1062,2.0,794.0,794.0
0.129,17,4,352,2,130,0.0,37.0,37.0,2,222,92.0,89.0,83.0
0.148,6,10,1506,5,395,34.0,127.0,127.0,5,1111,36.0,843.0,843.0
0.041,17,2,170,1,65,0.0,37.0,37.0,1,105,0.0,77.0,77.0
40.064,17,10,676,5,460,10013.0,104.0,64.0,5,216,10015.0,20.0,15.0
0.005,6,10,2000,5,927,1.0,659.0,659.0,5,1073,1.0,805.0,805.0
0.842,6,23,14686,11,14012,84.0,2828.0,2260.0,12,674,54.0,182.0,182.0
0.009,6,10,1990,5,911,2.0,643.0,643.0,5,1079,2.0,811.0,811.0
0.005,17,2,179,1,71,0.0,43.0,43.0,1,108,0.0,80.0,80.0
0.004,6,10,1702,5,863,1.0,595.0,595.0,5,839,0.0,571.0,571.0
15.095,17,19,10573,9,6944,1886.0,1350.0,743.0,10,3629,1674.0,1350.0,334.0
0.005,17,2,194,1,59,0.0,31.0,31.0,1,135,0.0,107.0,107.0
0.018,6,10,1677,5,827,4.0,559.0,559.0,5,850,4.0,582.0,582.0
0.004,6,10,1702,5,863,1.0,595.0,595.0,5,839,0.0,571.0,571.0
0.005,17,2,255,1,82,0.0,54.0,54.0,1,173,0.0,145.0,145.0
0.019,6,10,1677,5,827,4.0,559.0,559.0,5,850,4.0,582.0,582.0
0.076,6,10,1506,5,395,16.0,127.0,127.0,5,1111,17.0,843.0,843.0
0.019,6,10,1990,5,911,4.0,643.0,643.0,5,1079,4.0,811.0,811.0
0.009,6,13,3735,7,497,1.0,125.0,125.0,6,3238,1.0,1470.0,1459.0
0.005,6,10,2006,5,927,1.0,659.0,659.0,5,1079,1.0,811.0,811.0
309.391,17,20,1124,10,716,34366.0,48.0,43.0,10,408,34365.0,20.0,12.0
0.004,6,10,1774,5,923,1.0,655.0,655.0,5,851,1.0,583.0,583.0
0.005,6,10,2007,5,928,1.0,660.0,660.0,5,1079,1.0,811.0,811.0
0.115,6,10,1506,5,395,27.0,127.0,127.0,5,1111,27.0,843.0,843.0
0.011,6,10,1990,5,911,2.0,643.0,643.0,5,1079,2.0,811.0,811.0
0.006,6,10,2006,5,927,1.0,659.0,659.0,5,1079,1.0,811.0,811.0
0.01,6,10,2007,5,928,2.0,660.0,660.0,5,1079,2.0,811.0,811.0
0.006,6,10,2007,5,928,1.0,660.0,660.0,5,1079,1.0,811.0,811.0
0.006,6,10,1547,5,764,1.0,496.0,496.0,5,783,1.0,515.0,515.0
301.106,6,49,23720,26,18002,12044.0,2720.0,1539.0,23,5718,406.0,2667.0,435.0
0.005,6,10,2006,5,927,1.0,659.0,659.0,5,1079,1.0,811.0,811.0
0.008,6,10,1990,5,911,2.0,643.0,643.0,5,1079,1.0,811.0,811.0
0.001,17,2,136,1,60,0.0,32.0,32.0,1,76,0.0,48.0,48.0
0.005,6,13,3747,7,509,0.0,137.0,137.0,6,3238,1.0,1470.0,1459.0
0.005,17,2,180,1,66,0.0,38.0,38.0,1,114,0.0,86.0,86.0
0.003,17,2,136,1,60,0.0,32.0,32.0,1,76,0.0,48.0,48.0
0.017,6,10,1983,5,910,4.0,642.0,642.0,5,1073,4.0,805.0,805.0
0.005,17,2,194,1,57,0.0,29.0,29.0,1,137,0.0,109.0,109.0
0.041,17,2,152,1,76,0.0,48.0,48.0,1,76,0.0,48.0,48.0
0.01,6,10,1762,5,911,2.0,643.0,643.0,5,851,2.0,583.0,583.0
0.004,17,2,136,1,60,0.0,32.0,32.0,1,76,0.0,48.0,48.0
0.009,6,10,1972,5,910,2.0,642.0,642.0,5,1062,2.0,794.0,794.0
0.012,6,10,1972,5,910,3.0,642.0,642.0,5,1062,3.0,794.0,794.0
308.367,17,20,1124,10,716,34251.0,48.0,43.0,10,408,34251.0,20.0,12.0
104.035,6,39,10113,21,4595,5193.0,1360.0,620.0,18,5518,6109.0,2667.0,435.0
178.274,17,80,11420,40,2667,4570.0,44.0,38.0,40,8753,4571.0,239.0,190.0
834.406,6,66,14976,43,12112,19866.0,494.0,494.0,23,2864,37927.0,83.0,83.0
40.059,17,10,676,5,460,10013.0,104.0,64.0,5,216,10014.0,20.0,15.0
40.063,17,10,676,5,460,10014.0,104.0,64.0,5,216,10014.0,20.0,15.0
0.006,6,10,1547,5,764,1.0,496.0,496.0,5,783,1.0,515.0,515.0
40.061,17,10,676,5,460,10014.0,104.0,64.0,5,216,10014.0,20.0,15.0
0.005,6,10,1689,5,839,1.0,571.0,571.0,5,850,1.0,582.0,582.0
0.057,17,2,144,1,64,0.0,36.0,36.0,1,80,0.0,52.0,52.0
0.005,6,10,2006,5,927,1.0,659.0,659.0,5,1079,1.0,811.0,811.0
240.091,6,16,4481,9,963,30011.0,238.0,166.0,7,3518,40014.0,1402.0,786.0
0.001,17,2,136,1,60,0.0,32.0,32.0,1,76,0.0,48.0,48.0
0.017,6,10,1989,5,910,4.0,642.0,642.0,5,1079,4.0,811.0,811.0
0.018,6,10,1972,5,910,4.0,642.0,642.0,5,1062,4.0,794.0,794.0
0.005,6,10,1689,5,839,1.0,571.0,571.0,5,850,1.0,582.0,582.0
308.676,17,18,1008,9,640,38568.0,48.0,43.0,9,368,38568.0,20.0,12.0
0.006,6,10,1854,5,889,1.0,621.0,621.0,5,965,1.0,697.0,697.0
0.115,6,10,1506,5,395,26.0,127.0,127.0,5,1111,25.0,843.0,843.0
0.012,6,10,1983,5,910,3.0,642.0,642.0,5,1073,2.0,805.0,805.0
0.001,17,2,180,1,66,0.0,38.0,38.0,1,114,0.0,86.0,86.0
0.014,6,10,1990,5,911,3.0,643.0,643.0,5,1079,3.0,811.0,811.0
0.009,6,13,3735,7,497,1.0,125.0,125.0,6,3238,1.0,1470.0,1459.0
0.005,6,10,1989,5,927,1.0,659.0,659.0,5,1062,1.0,794.0,794.0
40.057,17,10,676,5,460,10013.0,104.0,64.0,5,216,10013.0,20.0,15.0
40.055,17,10,676,5,460,10012.0,104.0,64.0,5,216,10012.0,20.0,15.0
0.203,6,10,1506,5,395,48.0,127.0,127.0,5,1111,49.0,843.0,843.0
0.004,17,2,148,1,60,0.0,32.0,32.0,1,88,0.0,60.0,60.0
0.077,6,10,1506,5,395,17.0,127.0,127.0,5,1111,16.0,843.0,843.0
368.778,6,22,2313,16,867,24585.0,195.0,195.0,6,1446,4641.0,419.0,398.0
0.005,6,10,1989,5,927,1.0,659.0,659.0,5,1062,1.0,794.0,794.0
0.004,17,2,136,1,60,0.0,32.0,32.0,1,76,0.0,48.0,48.0
0.004,6,10,2006,5,927,1.0,659.0,659.0,5,1079,1.0,811.0,811.0
0.015,6,10,1983,5,910,3.0,642.0,642.0,5,1073,3.0,805.0,805.0
352.0,6,20,2210,6,1308,12003.0,494.0,494.0,14,902,27076.0,83.0,83.0
0.004,6,10,1989,5,927,1.0,659.0,659.0,5,1062,1.0,794.0,794.0
0.072,6,10,1506,5,395,15.0,127.0,127.0,5,1111,17.0,843.0,843.0
0.016,6,10,1972,5,910,3.0,642.0,642.0,5,1062,3.0,794.0,794.0
0.008,6,10,1677,5,827,1.0,559.0,559.0,5,850,2.0,582.0,582.0
0.006,6,10,2007,5,928,1.0,660.0,660.0,5,1079,1.0,811.0,811.0
0.167,6,10,1506,5,395,40.0,127.0,127.0,5,1111,38.0,843.0,843.0
0.004,17,2,146,1,65,0.0,37.0,37.0,1,81,0.0,53.0,53.0
0.005,17,2,179,1,71,0.0,43.0,43.0,1,108,0.0,80.0,80.0
352.742,6,20,2210,6,1308,12003.0,494.0,494.0,14,902,27133.0,83.0,83.0
0.009,6,12,1926,6,1189,1.0,659.0,434.0,6,737,1.0,417.0,417.0
300.803,6,37,9740,20,4262,15831.0,1686.0,686.0,17,5478,539.0,2667.0,435.0
0.081,6,10,1506,5,395,18.0,127.0,127.0,5,1111,19.0,843.0,843.0
0.047,17,2,170,1,65,0.0,37.0,37.0,1,105,0.0,77.0,77.0
0.015,6,10,1989,5,910,3.0,642.0,642.0,5,1079,3.0,811.0,811.0
0.056,17,4,284,2,120,0.0,32.0,32.0,2,164,33.0,60.0,54.0
0.008,6,10,1631,5,848,2.0,580.0,580.0,5,783,2.0,515.0,515.0
40.078,17,10,676,5,460,10018.0,104.0,64.0,5,216,10018.0,20.0,15.0
15.082,17,16,9180,8,6936,2150.0,1350.0,839.0,8,2244,2150.0,1350.0,252.0
0.024,6,10,1989,5,910,5.0,642.0,642.0,5,1079,5.0,811.0,811.0
0.006,6,10,1547,5,764,1.0,496.0,496.0,5,783,1.0,515.0,515.0
0.006,6,10,1643,5,860,1.0,592.0,592.0,5,783,1.0,515.0,515.0
0.007,6,10,1989,5,910,1.0,642.0,642.0,5,1079,1.0,811.0,811.0
0.011,6,10,1972,5,910,2.0,642.0,642.0,5,1062,2.0,794.0,794.0
0.085,6,10,1506,5,395,18.0,127.0,127.0,5,1111,20.0,843.0,843.0
351.992,6,20,2210,6,1308,12004.0,494.0,494.0,14,902,27076.0,83.0,83.0
1738.22,6,66,7448,42,4469,42395.0,1625.0,108.0,24,2979,75565.0,1111.0,82.0
0.005,6,10,2006,5,927,1.0,659.0,659.0,5,1079,1.0,811.0,811.0
0.005,6,10,1779,5,928,1.0,660.0,660.0,5,851,1.0,583.0,583.0
0.013,6,10,1983,5,910,3.0,642.0,642.0,5,1073,3.0,805.0,805.0
0.014,6,10,1983,5,910,3.0,642.0,642.0,5,1073,3.0,805.0,805.0
0.154,6,10,1506,5,395,35.0,127.0,127.0,5,1111,35.0,843.0,843.0
0.014,6,10,1972,5,910,3.0,642.0,642.0,5,1062,3.0,794.0,794.0
0.03,6,20,9974,11,704,3.0,124.0,124.0,9,9270,3.0,2896.0,1758.0
240.017,6,9,787,5,488,60004.0,232.0,232.0,4,299,80005.0,83.0,83.0
0.009,6,12,1926,6,1189,1.0,659.0,434.0,6,737,1.0,417.0,417.0
10.937,17,28,4399,14,2312,832.0,587.0,137.0,14,2087,832.0,270.0,121.0
0.014,6,10,1989,5,910,3.0,642.0,642.0,5,1079,3.0,811.0,811.0
1735.291,6,64,7361,42,4485,42324.0,1641.0,109.0,22,2876,82623.0,1112.0,82.0
361.806,6,21,1793,16,1030,24120.0,190.0,190.0,5,763,60009.0,462.0,247.0
0.006,6,10,1689,5,839,1.0,571.0,571.0,5,850,1.0,582.0,582.0
0.005,6,10,2006,5,927,1.0,659.0,659.0,5,1079,1.0,811.0,811.0
0.005,17,2,140,1,62,0.0,34.0,34.0,1,78,0.0,50.0,50.0
0.006,6,10,1689,5,839,1.0,571.0,571.0,5,850,1.0,582.0,582.0
0.008,6,10,1989,5,910,2.0,642.0,642.0,5,1079,1.0,811.0,811.0
178.052,17,90,12931,45,3032,4046.0,44.0,39.0,45,9899,4046.0,239.0,191.0
0.006,6,10,1547,5,764,1.0,496.0,496.0,5,783,1.0,515.0,515.0
0.005,17,2,169,1,62,0.0,34.0,34.0,1,107,0.0,79.0,79.0
0.006,17,2,168,1,76,0.0,48.0,48.0,1,92,0.0,64.0,64.0
0.009,6,10,1972,5,910,2.0,642.0,642.0,5,1062,2.0,794.0,794.0
0.005,6,10,1689,5,839,1.0,571.0,571.0,5,850,1.0,582.0,582.0
0.008,6,10,1983,5,910,2.0,642.0,642.0,5,1073,2.0,805.0,805.0
0.082,6,10,1506,5,395,19.0,127.0,127.0,5,1111,16.0,843.0,843.0
328.123,17,20,1124,10,716,36451.0,48.0,43.0,10,408,36448.0,20.0,12.0
0.012,6,10,1983,5,910,3.0,642.0,642.0,5,1073,3.0,805.0,805.0
0.006,6,10,1547,5,764,1.0,496.0,496.0,5,783,1.0,515.0,515.0
0.004,6,10,1989,5,927,1.0,659.0,659.0,5,1062,1.0,794.0,794.0
0.001,17,2,180,1,66,0.0,38.0,38.0,1,114,0.0,86.0,86.0
0.004,17,2,154,1,69,0.0,41.0,41.0,1,85,0.0,57.0,57.0
40.063,17,10,676,5,460,10014.0,104.0,64.0,5,216,10015.0,20.0,15.0
0.014,6,10,1989,5,910,3.0,642.0,642.0,5,1079,3.0,811.0,811.0
40.059,17,10,676,5,460,10013.0,104.0,64.0,5,216,10013.0,20.0,15.0
0.001,17,2,180,1,66,0.0,38.0,38.0,1,114,0.0,86.0,86.0
0.106,6,10,1506,5,395,21.0,127.0,127.0,5,1111,24.0,843.0,843.0
0.005,6,10,1989,5,927,1.0,659.0,659.0,5,1062,1.0,794.0,794.0
0.005,6,10,1774,5,923,1.0,655.0,655.0,5,851,1.0,583.0,583.0
40.046,17,10,676,5,460,10010.0,104.0,64.0,5,216,10010.0,20.0,15.0
0.005,6,13,3747,7,509,0.0,137.0,137.0,6,3238,0.0,1470.0,1459.0
0.011,6,10,1972,5,910,2.0,642.0,642.0,5,1062,2.0,794.0,794.0
0.012,6,10,1990,5,911,2.0,643.0,643.0,5,1079,3.0,811.0,811.0
0.011,6,12,1926,6,1189,2.0,659.0,434.0,6,737,2.0,417.0,417.0
0.005,6,14,3736,7,446,0.0,74.0,74.0,7,3290,0.0,1448.0,972.0
40.075,17,10,676,5,460,10016.0,104.0,64.0,5,216,10017.0,20.0,15.0
0.005,6,10,2000,5,927,1.0,659.0,659.0,5,1073,1.0,805.0,805.0
0.005,6,5,310,3,175,2.0,31.0,31.0,2,135,0.0,31.0,31.0
0.012,6,10,1983,5,910,2.0,642.0,642.0,5,1073,2.0,805.0,805.0
0.028,6,10,1972,5,910,6.0,642.0,642.0,5,1062,7.0,794.0,794.0
0.079,6,10,1506,5,395,16.0,127.0,127.0,5,1111,17.0,843.0,843.0
1771.647,17,120,11460,60,5460,30027.0,63.0,63.0,60,6000,30027.0,72.0,72.0
0.016,6,10,1972,5,910,4.0,642.0,642.0,5,1062,3.0,794.0,794.0
0.004,6,10,1702,5,863,1.0,595.0,595.0,5,839,0.0,571.0,571.0
6.132,6,26,11863,14,1040,471.0,304.0,304.0,12,10823,557.0,1402.0,1132.0
0.001,17,2,154,1,69,0.0,41.0,41.0,1,85,0.0,57.0,57.0
40.059,17,10,676,5,460,10012.0,104.0,64.0,5,216,10013.0,20.0,15.0
0.013,6,10,1990,5,911,3.0,643.0,643.0,5,1079,3.0,811.0,811.0
0.012,6,10,1989,5,910,3.0,642.0,642.0,5,1079,3.0,811.0,811.0
0.006,17,2,179,1,71,0.0,43.0,43.0,1,108,0.0,80.0,80.0
0.004,6,10,1989,5,927,1.0,659.0,659.0,5,1062,1.0,794.0,794.0
0.005,6,10,1854,5,889,1.0,621.0,621.0,5,965,1.0,697.0,697.0
0.011,6,10,1990,5,911,2.0,643.0,643.0,5,1079,2.0,811.0,811.0
0.015,6,10,1983,5,910,3.0,642.0,642.0,5,1073,3.0,805.0,805.0
178.16,17,82,11589,41,2728,4453.0,44.0,38.0,41,8861,4453.0,239.0,188.0
0.005,17,2,179,1,71,0.0,43.0,43.0,1,108,0.0,80.0,80.0
0.003,17,2,136,1,60,0.0,32.0,32.0,1,76,0.0,48.0,48.0
0.006,6,10,1989,5,927,1.0,659.0,659.0,5,1062,1.0,794.0,794.0
0.066,6,10,1506,5,395,16.0,127.0,127.0,5,1111,15.0,843.0,843.0
0.005,6,10,2006,5,927,1.0,659.0,659.0,5,1079,1.0,811.0,811.0
0.005,6,10,1989,5,927,1.0,659.0,659.0,5,1062,1.0,794.0,794.0
0.003,17,2,148,1,60,0.0,32.0,32.0,1,88,0.0,60.0,60.0
0.01,6,12,1926,6,1189,1.0,659.0,434.0,6,737,1.0,417.0,417.0
0.005,6,10,1989,5,927,1.0,659.0,659.0,5,1062,1.0,794.0,794.0
9.038,17,6,376,5,280,2259.0,28.0,28.0,1,96,0.0,68.0,68.0
0.075,6,10,1506,5,395,16.0,127.0,127.0,5,1111,15.0,843.0,843.0
0.01,6,10,1972,5,910,2.0,642.0,642.0,5,1062,2.0,794.0,794.0
0.719,6,22,5072,11,1250,61.0,325.0,133.0,11,3822,61.0,1414.0,563.0
0.003,17,2,148,1,60,0.0,32.0,32.0,1,88,0.0,60.0,60.0
0.011,17,2,146,1,65,0.0,37.0,37.0,1,81,0.0,53.0,53.0
0.008,6,10,1990,5,911,2.0,643.0,643.0,5,1079,2.0,811.0,811.0
0.111,6,10,1506,5,395,22.0,127.0,127.0,5,1111,23.0,843.0,843.0
0.067,6,10,1506,5,395,15.0,127.0,127.0,5,1111,14.0,843.0,843.0
0.001,17,2,179,1,62,0.0,34.0,34.0,1,117,0.0,89.0,89.0
0.01,6,14,3787,7,497,1.0,125.0,125.0,7,3290,1.0,1448.0,972.0
0.227,6,16,2777,8,1395,32.0,533.0,323.0,8,1382,20.0,529.0,239.0
0.01,6,10,1990,5,911,2.0,643.0,643.0,5,1079,2.0,811.0,811.0
0.083,6,10,1506,5,395,16.0,127.0,127.0,5,1111,18.0,843.0,843.0
0.014,6,10,1677,5,827,3.0,559.0,559.0,5,850,3.0,582.0,582.0
0.006,6,10,1547,5,764,1.0,496.0,496.0,5,783,1.0,515.0,515.0
0.005,17,2,169,1,62,0.0,34.0,34.0,1,107,0.0,79.0,79.0
0.102,6,10,1506,5,395,23.0,127.0,127.0,5,1111,23.0,843.0,843.0
0.028,17,2,152,1,56,0.0,28.0,28.0,1,96,0.0,68.0,68.0
0.006,6,10,1689,5,839,1.0,571.0,571.0,5,850,1.0,582.0,582.0
0.005,6,10,1989,5,927,1.0,659.0,659.0,5,1062,1.0,794.0,794.0
0.005,6,10,1779,5,928,1.0,660.0,660.0,5,851,1.0,583.0,583.0
0.013,6,10,1990,5,911,3.0,643.0,643.0,5,1079,3.0,811.0,811.0
0.006,6,10,1547,5,764,1.0,496.0,496.0,5,783,1.0,515.0,515.0
0.226,6,16,2782,8,1400,32.0,533.0,325.0,8,1382,21.0,529.0,239.0
0.077,6,10,1506,5,395,16.0,127.0,127.0,5,1111,17.0,843.0,843.0
0.116,6,10,1506,5,395,26.0,127.0,127.0,5,1111,27.0,843.0,843.0
0.005,6,13,3747,7,509,0.0,137.0,137.0,6,3238,0.0,1470.0,1459.0
0.007,6,10,1547,5,764,1.0,496.0,496.0,5,783,1.0,515.0,515.0
0.004,6,10,1774,5,923,1.0,655.0,655.0,5,851,1.0,583.0,583.0
0.004,17,2,148,1,60,0.0,32.0,32.0,1,88,0.0,60.0,60.0
171.286,17,84,12150,42,2826,4177.0,44.0,39.0,42,9324,4177.0,239.0,194.0
0.13,17,4,284,2,120,0.0,32.0,32.0,2,164,126.0,60.0,54.0
0.005,6,10,2007,5,928,1.0,660.0,660.0,5,1079,1.0,811.0,811.0
0.015,6,10,1989,5,910,3.0,642.0,642.0,5,1079,3.0,811.0,811.0
0.062,6,10,1506,5,395,13.0,127.0,127.0,5,1111,14.0,843.0,843.0
0.087,6,10,1506,5,395,19.0,127.0,127.0,5,1111,18.0,843.0,843.0
0.005,6,10,2007,5,928,1.0,660.0,660.0,5,1079,1.0,811.0,811.0
0.016,6,10,1972,5,910,4.0,642.0,642.0,5,1062,3.0,794.0,794.0
0.012,6,10,1762,5,911,3.0,643.0,643.0,5,851,2.0,583.0,583.0
0.005,6,10,1854,5,889,1.0,621.0,621.0,5,965,1.0,697.0,697.0
0.005,6,10,2000,5,927,1.0,659.0,659.0,5,1073,1.0,805.0,805.0
0.006,6,10,1547,5,764,1.0,496.0,496.0,5,783,1.0,515.0,515.0
0.008,6,10,1990,5,911,2.0,643.0,643.0,5,1079,1.0,811.0,811.0
40.076,17,10,676,5,460,10018.0,104.0,64.0,5,216,10018.0,20.0,15.0
0.005,6,13,3747,7,509,0.0,137.0,137.0,6,3238,0.0,1470.0,1459.0
0.169,17,2,152,1,76,0.0,48.0,48.0,1,76,0.0,48.0,48.0
0.01,6,10,1989,5,910,2.0,642.0,642.0,5,1079,2.0,811.0,811.0
0.005,6,10,2000,5,927,1.0,659.0,659.0,5,1073,1.0,805.0,805.0
0.007,6,13,3747,7,509,1.0,137.0,137.0,6,3238,1.0,1470.0,1459.0
295.752,6,317,343722,120,17795,2485.0,2693.0,825.0,197,325927,1508.0,4206.0,1725.0
0.001,17,2,180,1,66,0.0,38.0,38.0,1,114,0.0,86.0,86.0
0.015,6,11,2042,6,963,2.0,643.0,643.0,5,1079,3.0,811.0,811.0
40.056,17,10,676,5,460,10013.0,104.0,64.0,5,216,10012.0,20.0,15.0
0.008,17,2,144,1,64,0.0,36.0,36.0,1,80,0.0,52.0,52.0
0.001,17,2,136,1,60,0.0,32.0,32.0,1,76,0.0,48.0,48.0
0.005,6,10,2007,5,928,1.0,660.0,660.0,5,1079,1.0,811.0,811.0
0.005,6,10,1774,5,923,1.0,655.0,655.0,5,851,1.0,583.0,583.0
0.07,6,10,1506,5,395,16.0,127.0,127.0,5,1111,15.0,843.0,843.0
0.115,6,10,1506,5,395,25.0,127.0,127.0,5,1111,24.0,843.0,843.0
0.079,6,10,1506,5,395,16.0,127.0,127.0,5,1111,16.0,843.0,843.0
0.005,6,10,2007,5,928,1.0,660.0,660.0,5,1079,1.0,811.0,811.0
0.009,6,12,1926,6,1189,1.0,659.0,434.0,6,737,1.0,417.0,417.0
1741.694,6,311,98889,192,87347,9118.0,2001.0,672.0,119,11542,14760.0,452.0,71.0
0.004,6,10,2006,5,927,1.0,659.0,659.0,5,1079,1.0,811.0,811.0
0.003,17,4,284,2,120,0.0,32.0,32.0,2,164,0.0,60.0,54.0
0.006,6,10,1547,5,764,1.0,496.0,496.0,5,783,1.0,515.0,515.0
0.005,6,10,2006,5,927,1.0,659.0,659.0,5,1079,1.0,811.0,811.0
0.012,6,10,1989,5,910,3.0,642.0,642.0,5,1079,2.0,811.0,811.0
291.602,6,389,347654,203,22119,1443.0,2689.0,888.0,186,325535,1576.0,2804.0,1836.0
0.081,6,10,1506,5,395,17.0,127.0,127.0,5,1111,17.0,843.0,843.0
0.006,6,10,1547,5,764,1.0,496.0,496.0,5,783,1.0,515.0,515.0
0.074,6,10,1506,5,395,17.0,127.0,127.0,5,1111,16.0,843.0,843.0
0.005,6,13,3747,7,509,0.0,137.0,137.0,6,3238,1.0,1470.0,1459.0
0.011,6,10,1989,5,910,2.0,642.0,642.0,5,1079,2.0,811.0,811.0
0.256,17,39,20252,21,17043,12.0,1350.0,783.0,18,3209,11.0,1350.0,150.0
0.004,6,10,2007,5,928,1.0,660.0,660.0,5,1079,1.0,811.0,811.0
0.004,6,10,1702,5,863,0.0,595.0,595.0,5,839,1.0,571.0,571.0
0.013,17,2,152,1,56,0.0,28.0,28.0,1,96,0.0,68.0,68.0
0.02,6,10,1677,5,827,5.0,559.0,559.0,5,850,4.0,582.0,582.0
0.005,6,10,2000,5,927,1.0,659.0,659.0,5,1073,1.0,805.0,805.0
1770.945,6,299,97373,186,86338,9572.0,2001.0,678.0,113,11035,15811.0,452.0,70.0
300.511,6,29,8007,17,1668,18781.0,217.0,152.0,12,6339,21863.0,2804.0,813.0
40.052,17,10,676,5,460,10012.0,104.0,64.0,5,216,10011.0,20.0,15.0
0.005,6,10,2000,5,927,1.0,659.0,659.0,5,1073,1.0,805.0,805.0
1757.523,6,108,6465,60,3537,29787.0,27.0,27.0,48,2928,37393.0,27.0,27.0
0.002,17,2,136,1,60,0.0,32.0,32.0,1,76,0.0,48.0,48.0
0.008,17,2,179,1,71,0.0,43.0,43.0,1,108,0.0,80.0,80.0
0.016,6,10,1989,5,910,4.0,642.0,642.0,5,1079,4.0,811.0,811.0
0.078,6,10,1506,5,395,17.0,127.0,127.0,5,1111,18.0,843.0,843.0
0.077,6,10,1506,5,395,17.0,127.0,127.0,5,1111,16.0,843.0,843.0
0.008,6,10,1989,5,910,2.0,642.0,642.0,5,1079,2.0,811.0,811.0
0.09,6,10,1506,5,395,21.0,127.0,127.0,5,1111,20.0,843.0,843.0
0.005,6,10,2006,5,927,1.0,659.0,659.0,5,1079,1.0,811.0,811.0
0.006,17,2,214,1,75,0.0,47.0,47.0,1,139,0.0,111.0,111.0
0.006,6,10,1689,5,839,1.0,571.0,571.0,5,850,1.0,582.0,582.0
0.006,6,10,1643,5,860,1.0,592.0,592.0,5,783,1.0,515.0,515.0
0.013,6,10,1990,5,911,3.0,643.0,643.0,5,1079,3.0,811.0,811.0
0.131,6,10,1506,5,395,31.0,127.0,127.0,5,1111,30.0,843.0,843.0
0.005,6,13,3747,7,509,0.0,137.0,137.0,6,3238,1.0,1470.0,1459.0
11.258,17,28,4420,14,1995,853.0,270.0,114.0,14,2425,853.0,588.0,145.0
0.001,17,2,136,1,60,0.0,32.0,32.0,1,76,0.0,48.0,48.0
0.05,6,10,1983,5,910,12.0,642.0,642.0,5,1073,12.0,805.0,805.0
10.763,17,28,4423,14,1995,819.0,270.0,114.0,14,2428,819.0,587.0,145.0
0.004,6,10,1989,5,927,1.0,659.0,659.0,5,1062,1.0,794.0,794.0
0.004,6,10,1779,5,928,1.0,660.0,660.0,5,851,1.0,583.0,583.0
37.595,6,40,9988,21,4385,456.0,1360.0,700.0,19,5603,2078.0,2667.0,402.0
0.006,17,2,170,1,65,0.0,37.0,37.0,1,105,0.0,77.0,77.0
0.006,6,10,1547,5,764,1.0,496.0,496.0,5,783,1.0,515.0,515.0
0.013,6,10,1989,5,910,3.0,642.0,642.0,5,1079,3.0,811.0,811.0
0.004,6,10,2006,5,927,1.0,659.0,659.0,5,1079,1.0,811.0,811.0
0.011,6,10,1989,5,910,2.0,642.0,642.0,5,1079,2.0,811.0,811.0
0.005,6,10,2007,5,928,1.0,660.0,660.0,5,1079,1.0,811.0,811.0
11.124,17,28,4422,14,1995,840.0,270.0,114.0,14,2427,843.0,586.0,145.0
0.005,6,13,3747,7,509,0.0,137.0,137.0,6,3238,1.0,1470.0,1459.0
0.004,17,2,148,1,60,0.0,32.0,32.0,1,88,0.0,60.0,60.0
0.006,6,10,1989,5,927,1.0,659.0,659.0,5,1062,1.0,794.0,794.0
0.004,6,10,1989,5,927,1.0,659.0,659.0,5,1062,1.0,794.0,794.0
0.005,6,10,2006,5,927,1.0,659.0,659.0,5,1079,1.0,811.0,811.0
0.009,6,10,1989,5,910,2.0,642.0,642.0,5,1079,2.0,811.0,811.0
312.172,17,20,1124,10,716,34672.0,48.0,43.0,10,408,34671.0,20.0,12.0
0.016,6,10,1972,5,910,3.0,642.0,642.0,5,1062,3.0,794.0,794.0
0.003,17,2,234,1,61,0.0,33.0,33.0,1,173,0.0,145.0,145.0
0.012,6,6,716,3,458,4.0,302.0,302.0,3,258,4.0,102.0,102.0
0.097,6,10,1506,5,395,21.0,127.0,127.0,5,1111,20.0,843.0,843.0
0.111,6,10,1506,5,395,23.0,127.0,127.0,5,1111,23.0,843.0,843.0
0.02,6,10,1983,5,910,5.0,642.0,642.0,5,1073,5.0,805.0,805.0
0.005,6,10,2006,5,927,1.0,659.0,659.0,5,1079,1.0,811.0,811.0
0.09,6,10,1506,5,395,19.0,127.0,127.0,5,1111,21.0,843.0,843.0
0.007,6,10,1989,5,910,1.0,642.0,642.0,5,1079,1.0,811.0,811.0
0.166,17,2,152,1,76,0.0,48.0,48.0,1,76,0.0,48.0,48.0
40.069,17,10,676,5,460,10014.0,104.0,64.0,5,216,10016.0,20.0,15.0
0.011,6,13,3735,7,497,1.0,125.0,125.0,6,3238,2.0,1470.0,1459.0
0.004,6,10,1702,5,863,0.0,595.0,595.0,5,839,1.0,571.0,571.0
0.005,6,10,1779,5,928,1.0,660.0,660.0,5,851,1.0,583.0,583.0
0.001,17,2,180,1,66,0.0,38.0,38.0,1,114,0.0,86.0,86.0
0.214,6,16,2777,8,1395,30.0,533.0,323.0,8,1382,19.0,529.0,239.0
0.017,6,10,1972,5,910,4.0,642.0,642.0,5,1062,4.0,794.0,794.0
0.008,6,10,1983,5,910,2.0,642.0,642.0,5,1073,2.0,805.0,805.0
0.005,6,10,1689,5,839,1.0,571.0,571.0,5,850,1.0,582.0,582.0
0.012,6,10,1989,5,910,3.0,642.0,642.0,5,1079,3.0,811.0,811.0
0.084,6,10,1506,5,395,20.0,127.0,127.0,5,1111,19.0,843.0,843.0
0.81,6,26,11875,14,2701,62.0,1204.0,392.0,12,9174,63.0,1402.0,1067.0
0.006,6,10,1547,5,764,1.0,496.0,496.0,5,783,1.0,515.0,515.0
0.012,6,10,1983,5,910,3.0,642.0,642.0,5,1073,2.0,805.0,805.0
0.08,17,8,3613,4,1874,26.0,1350.0,440.0,4,1739,10.0,1350.0,406.0
0.021,6,10,1989,5,910,5.0,642.0,642.0,5,1079,5.0,811.0,811.0
0.152,6,10,1506,5,395,34.0,127.0,127.0,5,1111,35.0,843.0,843.0
0.112,6,10,1506,5,395,23.0,127.0,127.0,5,1111,24.0,843.0,843.0
0.093,6,10,1506,5,395,20.0,127.0,127.0,5,1111,19.0,843.0,843.0
0.15,6,10,1506,5,395,35.0,127.0,127.0,5,1111,33.0,843.0,843.0
0.011,6,10,1990,5,911,2.0,643.0,643.0,5,1079,2.0,811.0,811.0
353.987,6,21,1795,16,1030,23599.0,190.0,190.0,5,765,60001.0,464.0,248.0
0.005,17,2,214,1,75,0.0,47.0,47.0,1,139,0.0,111.0,111.0
0.015,6,10,1972,5,910,3.0,642.0,642.0,5,1062,3.0,794.0,794.0
0.012,6,10,1989,5,910,3.0,642.0,642.0,5,1079,2.0,811.0,811.0
0.233,6,16,2670,8,1396,33.0,533.0,324.0,8,1274,21.0,529.0,212.0
0.032,6,10,1631,5,848,7.0,580.0,580.0,5,783,7.0,515.0,515.0
0.073,6,10,1506,5,395,16.0,127.0,127.0,5,1111,15.0,843.0,843.0
0.096,6,10,1506,5,395,20.0,127.0,127.0,5,1111,20.0,843.0,843.0
0.006,6,10,1689,5,839,1.0,571.0,571.0,5,850,1.0,582.0,582.0
240.014,6,9,787,5,488,60003.0,232.0,232.0,4,299,80003.0,83.0,83.0
0.001,17,2,180,1,66,0.0,38.0,38.0,1,114,0.0,86.0,86.0
0.005,6,10,2000,5,927,1.0,659.0,659.0,5,1073,1.0,805.0,805.0
0.005,17,2,136,1,60,0.0,32.0,32.0,1,76,0.0,48.0,48.0
0.005,6,13,3747,7,509,0.0,137.0,137.0,6,3238,1.0,1470.0,1459.0
0.01,6,10,1989,5,910,2.0,642.0,642.0,5,1079,2.0,811.0,811.0
324.665,17,20,1124,10,716,36066.0,48.0,43.0,10,408,36067.0,20.0,12.0
1758.956,6,464,66156,252,35168,7007.0,613.0,197.0,212,30988,8335.0,453.0,142.0
0.099,6,10,1506,5,395,21.0,127.0,127.0,5,1111,22.0,843.0,843.0
0.001,17,2,180,1,66,0.0,38.0,38.0,1,114,0.0,86.0,86.0
0.109,6,10,1506,5,395,26.0,127.0,127.0,5,1111,23.0,843.0,843.0
0.007,6,10,1989,5,910,1.0,642.0,642.0,5,1079,1.0,811.0,811.0
0.005,17,2,170,1,65,0.0,37.0,37.0,1,105,0.0,77.0,77.0
240.149,6,51,7333,26,3442,9605.0,588.0,230.0,25,3891,10006.0,580.0,215.0
0.087,6,10,1506,5,395,18.0,127.0,127.0,5,1111,18.0,843.0,843.0
0.127,6,10,1506,5,395,29.0,127.0,127.0,5,1111,30.0,843.0,843.0
240.042,6,9,787,5,488,60010.0,232.0,232.0,4,299,80006.0,83.0,83.0
177.081,17,84,11920,42,2801,4319.0,44.0,38.0,42,9119,4319.0,239.0,189.0
0.066,6,10,1506,5,395,16.0,127.0,127.0,5,1111,15.0,843.0,843.0
0.004,6,10,2007,5,928,1.0,660.0,660.0,5,1079,1.0,811.0,811.0
0.008,17,2,194,1,59,0.0,31.0,31.0,1,135,0.0,107.0,107.0
1786.283,6,183,25301,112,18206,16092.0,302.0,302.0,71,7095,25518.0,83.0,83.0
0.001,17,2,180,1,66,0.0,38.0,38.0,1,114,0.0,86.0,86.0
0.004,6,10,2007,5,928,1.0,660.0,660.0,5,1079,1.0,811.0,811.0
0.011,6,10,1762,5,911,2.0,643.0,643.0,5,851,2.0,583.0,583.0
327.401,17,20,1124,10,716,36364.0,48.0,43.0,10,408,36364.0,20.0,12.0
0.011,6,10,1990,5,911,2.0,643.0,643.0,5,1079,2.0,811.0,811.0
0.004,6,10,2000,5,927,1.0,659.0,659.0,5,1073,1.0,805.0,805.0
0.015,6,10,1990,5,911,3.0,643.0,643.0,5,1079,3.0,811.0,811.0
0.009,6,10,1989,5,910,2.0,642.0,642.0,5,1079,2.0,811.0,811.0
0.067,6,10,1506,5,395,16.0,127.0,127.0,5,1111,13.0,843.0,843.0
0.005,6,10,2006,5,927,1.0,659.0,659.0,5,1079,1.0,811.0,811.0
0.009,6,13,3735,7,497,1.0,125.0,125.0,6,3238,1.0,1470.0,1459.0
0.012,6,10,1983,5,910,3.0,642.0,642.0,5,1073,3.0,805.0,805.0
0.005,6,10,2006,5,927,1.0,659.0,659.0,5,1079,1.0,811.0,811.0
0.005,6,10,2006,5,927,1.0,659.0,659.0,5,1079,1.0,811.0,811.0
0.006,6,13,3690,7,452,1.0,80.0,80.0,6,3238,1.0,1470.0,1459.0
0.144,6,10,1506,5,395,34.0,127.0,127.0,5,1111,27.0,843.0,843.0
0.104,6,19,9922,11,704,10.0,124.0,124.0,8,9218,14.0,2896.0,2198.0
0.015,6,10,1677,5,827,3.0,559.0,559.0,5,850,3.0,582.0,582.0
0.004,17,4,284,2,120,1.0,32.0,32.0,2,164,0.0,60.0,54.0
0.004,17,4,284,2,120,0.0,32.0,32.0,2,164,1.0,60.0,54.0
240.506,6,33,8637,17,1837,15029.0,570.0,189.0,16,6800,16031.0,1402.0,597.0
0.005,6,10,2007,5,928,1.0,660.0,660.0,5,1079,1.0,811.0,811.0
295.205,6,375,347611,193,21606,1537.0,2736.0,889.0,182,326005,1630.0,2896.0,1884.0
11.13,17,28,4418,14,1993,847.0,268.0,114.0,14,2425,847.0,588.0,145.0
0.086,6,10,1506,5,395,18.0,127.0,127.0,5,1111,20.0,843.0,843.0
0.049,17,2,182,1,65,0.0,37.0,37.0,1,117,0.0,89.0,89.0
0.004,17,2,144,1,64,0.0,36.0,36.0,1,80,0.0,52.0,52.0
40.06,17,10,676,5,460,10013.0,104.0,64.0,5,216,10014.0,20.0,15.0
40.063,17,10,676,5,460,10015.0,104.0,64.0,5,216,10014.0,20.0,15.0
0.012,6,10,1989,5,910,3.0,642.0,642.0,5,1079,3.0,811.0,811.0
0.114,6,10,1506,5,395,25.0,127.0,127.0,5,1111,26.0,843.0,843.0
0.027,6,10,1983,5,910,6.0,642.0,642.0,5,1073,6.0,805.0,805.0
0.075,6,10,1506,5,395,15.0,127.0,127.0,5,1111,15.0,843.0,843.0
300.33,6,16,2170,9,684,37520.0,146.0,146.0,7,1486,50027.0,419.0,398.0
0.269,17,40,20345,21,17043,13.0,1350.0,783.0,19,3302,11.0,1350.0,145.0
40.051,17,10,676,5,460,10012.0,104.0,64.0,5,216,10011.0,20.0,15.0
40.063,17,10,676,5,460,10014.0,104.0,64.0,5,216,10015.0,20.0,15.0
0.005,6,10,1689,5,839,1.0,571.0,571.0,5,850,1.0,582.0,582.0
0.005,17,2,169,1,62,0.0,34.0,34.0,1,107,0.0,79.0,79.0
0.014,6,10,1972,5,910,3.0,642.0,642.0,5,1062,3.0,794.0,794.0
0.048,6,10,1506,5,395,11.0,127.0,127.0,5,1111,10.0,843.0,843.0
0.006,6,10,1689,5,839,1.0,571.0,571.0,5,850,1.0,582.0,582.0
0.004,17,4,284,2,120,0.0,32.0,32.0,2,164,1.0,60.0,54.0
0.045,17,2,186,1,61,0.0,33.0,33.0,1,125,0.0,97.0,97.0
178.234,17,80,11379,40,2664,4569.0,44.0,38.0,40,8715,4570.0,261.0,189.0
0.019,6,10,1989,5,910,4.0,642.0,642.0,5,1079,4.0,811.0,811.0
0.004,6,10,2006,5,927,1.0,659.0,659.0,5,1079,1.0,811.0,811.0
0.004,6,10,2007,5,928,1.0,660.0,660.0,5,1079,1.0,811.0,811.0
0.005,6,10,1989,5,927,1.0,659.0,659.0,5,1062,1.0,794.0,794.0
40.046,17,10,676,5,460,10010.0,104.0,64.0,5,216,10010.0,20.0,15.0
0.005,17,2,180,1,58,0.0,30.0,30.0,1,122,0.0,94.0,94.0
0.005,6,10,2006,5,927,1.0,659.0,659.0,5,1079,1.0,811.0,811.0
0.072,6,10,1506,5,395,14.0,127.0,127.0,5,1111,17.0,843.0,843.0
0.005,6,10,2007,5,928,1.0,660.0,660.0,5,1079,1.0,811.0,811.0
0.037,17,2,182,1,65,0.0,37.0,37.0,1,117,0.0,89.0,89.0
0.006,17,2,166,1,75,0.0,47.0,47.0,1,91,0.0,63.0,63.0
0.094,6,10,1506,5,395,21.0,127.0,127.0,5,1111,20.0,843.0,843.0
0.009,6,10,1990,5,911,2.0,643.0,643.0,5,1079,2.0,811.0,811.0
0.005,17,2,169,1,62,0.0,34.0,34.0,1,107,0.0,79.0,79.0
0.009,17,4,284,2,120,0.0,32.0,32.0,2,164,0.0,60.0,54.0
0.102,6,10,1506,5,395,21.0,127.0,127.0,5,1111,22.0,843.0,843.0
0.006,6,10,1689,5,839,1.0,571.0,571.0,5,850,1.0,582.0,582.0
0.023,6,10,1990,5,911,5.0,643.0,643.0,5,1079,5.0,811.0,811.0
0.005,6,10,2006,5,927,1.0,659.0,659.0,5,1079,1.0,811.0,811.0
0.014,6,10,1762,5,911,3.0,643.0,643.0,5,851,3.0,583.0,583.0
0.009,6,12,1926,6,1189,1.0,659.0,434.0,6,737,1.0,417.0,417.0
0.016,6,10,1631,5,848,3.0,580.0,580.0,5,783,4.0,515.0,515.0
0.015,6,10,1990,5,911,3.0,643.0,643.0,5,1079,3.0,811.0,811.0
0.008,6,10,2006,5,927,2.0,659.0,659.0,5,1079,2.0,811.0,811.0
0.015,6,10,1990,5,911,3.0,643.0,643.0,5,1079,3.0,811.0,811.0
0.006,6,10,1547,5,764,1.0,496.0,496.0,5,783,1.0,515.0,515.0
308.219,17,20,1124,10,716,34231.0,48.0,43.0,10,408,34231.0,20.0,12.0
0.006,6,10,2006,5,927,1.0,659.0,659.0,5,1079,1.0,811.0,811.0
0.003,17,2,186,1,61,0.0,33.0,33.0,1,125,0.0,97.0,97.0
300.031,6,12,1782,7,1348,50005.0,494.0,494.0,5,434,75007.0,83.0,83.0
0.079,6,10,1506,5,395,17.0,127.0,127.0,5,1111,17.0,843.0,843.0
0.003,17,2,148,1,60,0.0,32.0,32.0,1,88,0.0,60.0,60.0
0.005,6,10,1989,5,927,1.0,659.0,659.0,5,1062,1.0,794.0,794.0
0.04,17,2,148,1,60,0.0,32.0,32.0,1,88,0.0,60.0,60.0
0.054,17,2,152,1,76,0.0,48.0,48.0,1,76,0.0,48.0,48.0
40.097,17,10,676,5,460,10023.0,104.0,64.0,5,216,10023.0,20.0,15.0
0.013,6,10,1762,5,911,3.0,643.0,643.0,5,851,3.0,583.0,583.0
0.12,6,10,1506,5,395,25.0,127.0,127.0,5,1111,28.0,843.0,843.0
0.001,17,2,180,1,66,0.0,38.0,38.0,1,114,0.0,86.0,86.0
170.038,17,70,10011,35,2338,5000.0,44.0,38.0,35,7673,5001.0,261.0,191.0
0.039,17,2,136,1,60,0.0,32.0,32.0,1,76,0.0,48.0,48.0
0.004,6,10,1702,5,863,1.0,595.0,595.0,5,839,0.0,571.0,571.0
0.073,6,10,1506,5,395,17.0,127.0,127.0,5,1111,17.0,843.0,843.0
0.039,17,2,146,1,65,0.0,37.0,37.0,1,81,0.0,53.0,53.0
0.254,17,38,20060,21,17037,12.0,1350.0,783.0,17,3023,11.0,1350.0,149.0
0.001,17,2,180,1,66,0.0,38.0,38.0,1,114,0.0,86.0,86.0
0.005,17,2,179,1,71,0.0,43.0,43.0,1,108,0.0,80.0,80.0
300.021,6,12,1782,7,1348,50003.0,494.0,494.0,5,434,75004.0,83.0,83.0
11.208,17,28,4417,14,1993,849.0,268.0,114.0,14,2424,849.0,587.0,145.0
0.006,6,10,1774,5,923,1.0,655.0,655.0,5,851,1.0,583.0,583.0
0.006,6,10,2006,5,927,1.0,659.0,659.0,5,1079,1.0,811.0,811.0
0.005,6,10,1643,5,860,1.0,592.0,592.0,5,783,1.0,515.0,515.0
0.004,17,2,136,1,60,0.0,32.0,32.0,1,76,0.0,48.0,48.0
240.103,6,16,4481,9,963,30012.0,238.0,166.0,7,3518,40016.0,1402.0,786.0
0.004,6,10,1989,5,927,1.0,659.0,659.0,5,1062,1.0,794.0,794.0
40.071,17,10,676,5,460,10017.0,104.0,64.0,5,216,10016.0,20.0,15.0
0.013,6,10,1989,5,910,3.0,642.0,642.0,5,1079,3.0,811.0,811.0
0.003,17,2,136,1,60,0.0,32.0,32.0,1,76,0.0,48.0,48.0
0.091,6,10,1506,5,395,22.0,127.0,127.0,5,1111,19.0,843.0,843.0
0.008,6,10,1989,5,910,1.0,642.0,642.0,5,1079,1.0,811.0,811.0
0.004,6,10,2006,5,927,1.0,659.0,659.0,5,1079,1.0,811.0,811.0
0.005,6,10,2006,5,927,1.0,659.0,659.0,5,1079,1.0,811.0,811.0
0.058,6,10,1506,5,395,12.0,127.0,127.0,5,1111,13.0,843.0,843.0
0.08,6,10,1506,5,395,17.0,127.0,127.0,5,1111,18.0,843.0,843.0
0.006,6,10,1854,5,889,1.0,621.0,621.0,5,965,1.0,697.0,697.0
0.008,6,14,3799,7,509,1.0,137.0,137.0,7,3290,1.0,1448.0,972.0
0.005,6,10,2007,5,928,1.0,660.0,660.0,5,1079,1.0,811.0,811.0
0.006,6,10,1643,5,860,1.0,592.0,592.0,5,783,1.0,515.0,515.0
0.001,17,2,180,1,66,0.0,38.0,38.0,1,114,0.0,86.0,86.0
0.009,6,10,1972,5,910,2.0,642.0,642.0,5,1062,2.0,794.0,794.0
0.042,17,2,166,1,75,0.0,47.0,47.0,1,91,0.0,63.0,63.0
0.014,6,10,1983,5,910,3.0,642.0,642.0,5,1073,3.0,805.0,805.0
0.005,6,10,2007,5,928,1.0,660.0,660.0,5,1079,1.0,811.0,811.0
0.016,6,10,1762,5,911,3.0,643.0,643.0,5,851,3.0,583.0,583.0
0.114,6,10,1506,5,395,25.0,127.0,127.0,5,1111,25.0,843.0,843.0
0.001,17,2,136,1,60,0.0,32.0,32.0,1,76,0.0,48.0,48.0
0.001,17,2,166,1,75,0.0,47.0,47.0,1,91,0.0,63.0,63.0
0.093,6,10,1506,5,395,22.0,127.0,127.0,5,1111,18.0,843.0,843.0
0.097,6,10,1506,5,395,23.0,127.0,127.0,5,1111,22.0,843.0,843.0
0.005,17,2,168,1,76,0.0,48.0,48.0,1,92,0.0,64.0,64.0
40.055,17,10,676,5,460,10013.0,104.0,64.0,5,216,10012.0,20.0,15.0
0.144,6,10,1506,5,395,33.0,127.0,127.0,5,1111,31.0,843.0,843.0
0.167,17,2,152,1,76,0.0,48.0,48.0,1,76,0.0,48.0,48.0
0.008,6,10,1989,5,910,2.0,642.0,642.0,5,1079,2.0,811.0,811.0
0.005,17,2,140,1,62,0.0,34.0,34.0,1,78,0.0,50.0,50.0
0.004,6,10,2006,5,927,1.0,659.0,659.0,5,1079,1.0,811.0,811.0
0.005,6,10,2000,5,927,1.0,659.0,659.0,5,1073,1.0,805.0,805.0
0.011,6,10,1989,5,910,2.0,642.0,642.0,5,1079,2.0,811.0,811.0
9.037,17,6,376,5,280,2259.0,28.0,28.0,1,96,0.0,68.0,68.0
0.005,6,10,1779,5,928,1.0,660.0,660.0,5,851,1.0,583.0,583.0
0.006,6,10,1689,5,839,1.0,571.0,571.0,5,850,1.0,582.0,582.0
0.013,6,10,1989,5,910,3.0,642.0,642.0,5,1079,3.0,811.0,811.0
0.106,6,10,1506,5,395,23.0,127.0,127.0,5,1111,24.0,843.0,843.0
10.839,17,28,4422,14,1994,825.0,269.0,114.0,14,2428,825.0,587.0,145.0
0.169,6,10,1506,5,395,40.0,127.0,127.0,5,1111,38.0,843.0,843.0
0.009,6,13,3735,7,497,1.0,125.0,125.0,6,3238,1.0,1470.0,1459.0
0.004,6,10,1774,5,923,1.0,655.0,655.0,5,851,1.0,583.0,583.0
0.037,17,2,136,1,60,0.0,32.0,32.0,1,76,0.0,48.0,48.0
0.015,6,10,1989,5,910,3.0,642.0,642.0,5,1079,3.0,811.0,811.0
0.005,17,2,136,1,60,0.0,32.0,32.0,1,76,0.0,48.0,48.0
0.074,6,10,1506,5,395,16.0,127.0,127.0,5,1111,18.0,843.0,843.0
0.001,17,2,180,1,66,0.0,38.0,38.0,1,114,0.0,86.0,86.0
0.004,17,2,170,1,65,0.0,37.0,37.0,1,105,0.0,77.0,77.0
0.726,6,22,5072,11,1250,61.0,325.0,133.0,11,3822,61.0,1414.0,563.0
0.011,6,10,1989,5,910,2.0,642.0,642.0,5,1079,2.0,811.0,811.0
10.8,17,28,4422,14,1994,822.0,269.0,114.0,14,2428,822.0,587.0,145.0
0.015,6,10,1989,5,910,3.0,642.0,642.0,5,1079,3.0,811.0,811.0
0.011,6,10,1990,5,911,2.0,643.0,643.0,5,1079,2.0,811.0,811.0
0.112,6,10,1506,5,395,25.0,127.0,127.0,5,1111,24.0,843.0,843.0
0.005,6,10,2006,5,927,1.0,659.0,659.0,5,1079,1.0,811.0,811.0
354.046,6,21,1795,16,1030,23603.0,190.0,190.0,5,765,60003.0,464.0,248.0
0.005,6,10,1689,5,839,1.0,571.0,571.0,5,850,1.0,582.0,582.0
0.011,6,10,1989,5,910,2.0,642.0,642.0,5,1079,2.0,811.0,811.0
0.009,6,10,1983,5,910,2.0,642.0,642.0,5,1073,2.0,805.0,805.0
0.101,6,10,1506,5,395,22.0,127.0,127.0,5,1111,23.0,843.0,843.0
0.006,6,10,1689,5,839,1.0,571.0,571.0,5,850,1.0,582.0,582.0
240.105,6,31,8938,15,6616,17150.0,1740.0,648.0,16,2322,16006.0,580.0,185.0
0.005,6,10,2006,5,927,1.0,659.0,659.0,5,1079,1.0,811.0,811.0
0.002,17,2,180,1,66,0.0,38.0,38.0,1,114,0.0,86.0,86.0
329.18,17,20,1124,10,716,36561.0,48.0,43.0,10,408,36561.0,20.0,12.0
0.004,6,10,1702,5,863,1.0,595.0,595.0,5,839,1.0,571.0,571.0
177.216,17,76,10834,38,2530,4789.0,44.0,38.0,38,8304,4789.0,239.0,190.0
0.013,17,2,208,1,72,0.0,44.0,44.0,1,136,0.0,108.0,108.0
0.01,6,10,1989,5,910,2.0,642.0,642.0,5,1079,2.0,811.0,811.0
0.004,6,10,1774,5,923,1.0,655.0,655.0,5,851,1.0,583.0,583.0
0.023,6,10,1989,5,910,5.0,642.0,642.0,5,1079,5.0,811.0,811.0
40.063,17,10,676,5,460,10012.0,104.0,64.0,5,216,10014.0,20.0,15.0
9.04,17,6,376,5,280,2260.0,28.0,28.0,1,96,0.0,68.0,68.0
0.001,17,2,142,1,63,0.0,35.0,35.0,1,79,0.0,51.0,51.0
0.004,6,10,2006,5,927,1.0,659.0,659.0,5,1079,1.0,811.0,811.0
0.072,6,10,1506,5,395,14.0,127.0,127.0,5,1111,15.0,843.0,843.0
0.037,17,2,186,1,61,0.0,33.0,33.0,1,125,0.0,97.0,97.0
0.005,6,10,1643,5,860,1.0,592.0,592.0,5,783,1.0,515.0,515.0
0.116,6,10,1506,5,395,26.0,127.0,127.0,5,1111,25.0,843.0,843.0
0.005,6,10,2006,5,927,1.0,659.0,659.0,5,1079,1.0,811.0,811.0
0.022,6,10,1990,5,911,5.0,643.0,643.0,5,1079,5.0,811.0,811.0
0.004,6,10,2006,5,927,1.0,659.0,659.0,5,1079,1.0,811.0,811.0
300.703,6,27,8593,15,1932,21478.0,798.0,286.0,12,6661,21878.0,1402.0,861.0
1756.145,6,107,6374,60,3525,29764.0,27.0,27.0,47,2849,38176.0,27.0,27.0
0.005,6,10,1854,5,889,1.0,621.0,621.0,5,965,1.0,697.0,697.0
0.005,6,13,3747,7,509,0.0,137.0,137.0,6,3238,0.0,1470.0,1459.0
308.443,17,20,1124,10,716,34257.0,48.0,43.0,10,408,34257.0,20.0,12.0
0.043,6,10,1972,5,910,10.0,642.0,642.0,5,1062,10.0,794.0,794.0
0.015,6,10,1990,5,911,3.0,643.0,643.0,5,1079,3.0,811.0,811.0
0.057,17,2,160,1,72,0.0,44.0,44.0,1,88,0.0,60.0,60.0
0.006,17,2,148,1,60,0.0,32.0,32.0,1,88,0.0,60.0,60.0
0.01,6,10,1989,5,910,2.0,642.0,642.0,5,1079,2.0,811.0,811.0
0.015,6,10,1989,5,910,3.0,642.0,642.0,5,1079,3.0,811.0,811.0
0.006,6,10,1643,5,860,1.0,592.0,592.0,5,783,1.0,515.0,515.0
0.019,6,10,1972,5,910,4.0,642.0,642.0,5,1062,4.0,794.0,794.0
0.01,6,10,1983,5,910,2.0,642.0,642.0,5,1073,2.0,805.0,805.0
0.004,6,10,1702,5,863,1.0,595.0,595.0,5,839,1.0,571.0,571.0
0.009,6,10,1983,5,910,2.0,642.0,642.0,5,1073,2.0,805.0,805.0
0.038,17,2,156,1,64,0.0,36.0,36.0,1,92,0.0,64.0,64.0
0.007,6,10,1547,5,764,1.0,496.0,496.0,5,783,1.0,515.0,515.0
0.113,6,10,1506,5,395,23.0,127.0,127.0,5,1111,23.0,843.0,843.0
0.016,17,2,198,1,91,0.0,63.0,63.0,1,107,0.0,79.0,79.0
0.007,17,2,144,1,64,0.0,36.0,36.0,1,80,0.0,52.0,52.0
40.067,17,10,676,5,460,10015.0,104.0,64.0,5,216,10016.0,20.0,15.0
0.02,6,13,3735,7,497,3.0,125.0,125.0,6,3238,4.0,1470.0,1459.0
0.005,6,10,1854,5,889,1.0,621.0,621.0,5,965,1.0,697.0,697.0
1770.43,6,84,4422,42,2211,43180.0,27.0,27.0,42,2211,43180.0,27.0,27.0
0.011,6,10,1677,5,827,2.0,559.0,559.0,5,850,2.0,582.0,582.0
0.025,6,13,3735,7,497,4.0,125.0,125.0,6,3238,5.0,1470.0,1459.0
0.008,6,10,1989,5,910,2.0,642.0,642.0,5,1079,1.0,811.0,811.0
0.011,6,10,1983,5,910,2.0,642.0,642.0,5,1073,2.0,805.0,805.0
0.008,6,10,1989,5,910,2.0,642.0,642.0,5,1079,1.0,811.0,811.0
15.315,17,49,29153,29,25843,546.0,1350.0,863.0,20,3310,805.0,1350.0,137.0
0.005,17,2,166,1,75,0.0,47.0,47.0,1,91,0.0,63.0,63.0
0.005,17,2,170,1,65,0.0,37.0,37.0,1,105,0.0,77.0,77.0
1753.091,6,454,66285,257,35550,6848.0,613.0,194.0,197,30735,8943.0,453.0,143.0
40.052,17,10,676,5,460,10012.0,104.0,64.0,5,216,10012.0,20.0,15.0
0.082,6,10,1506,5,395,18.0,127.0,127.0,5,1111,16.0,843.0,843.0
0.004,6,10,2000,5,927,1.0,659.0,659.0,5,1073,1.0,805.0,805.0
15.072,17,14,9190,8,6902,2149.0,1350.0,834.0,6,2288,3008.0,1350.0,353.0
0.004,17,2,148,1,60,0.0,32.0,32.0,1,88,0.0,60.0,60.0
11.445,17,28,4394,14,2312,868.0,587.0,137.0,14,2082,868.0,269.0,120.0
0.116,6,10,1506,5,395,27.0,127.0,127.0,5,1111,27.0,843.0,843.0
0.009,6,10,1972,5,910,2.0,642.0,642.0,5,1062,2.0,794.0,794.0
0.005,6,10,2000,5,927,1.0,659.0,659.0,5,1073,1.0,805.0,805.0
0.005,6,10,2006,5,927,1.0,659.0,659.0,5,1079,1.0,811.0,811.0
40.054,17,10,676,5,460,10012.0,104.0,64.0,5,216,10012.0,20.0,15.0
0.01,6,10,1989,5,910,2.0,642.0,642.0,5,1079,2.0,811.0,811.0
0.008,6,10,1677,5,827,1.0,559.0,559.0,5,850,2.0,582.0,582.0
0.096,6,10,1506,5,395,19.0,127.0,127.0,5,1111,23.0,843.0,843.0
0.124,17,2,80,1,32,0.0,4.0,4.0,1,48,0.0,20.0,20.0
0.005,6,10,2006,5,927,1.0,659.0,659.0,5,1079,1.0,811.0,811.0
0.04,17,4,284,2,120,0.0,32.0,32.0,2,164,37.0,60.0,54.0
0.009,6,10,1990,5,911,2.0,643.0,643.0,5,1079,2.0,811.0,811.0
0.009,6,10,1983,5,910,2.0,642.0,642.0,5,1073,2.0,805.0,805.0
0.012,6,10,1677,5,827,2.0,559.0,559.0,5,850,3.0,582.0,582.0
0.003,17,2,148,1,60,0.0,32.0,32.0,1,88,0.0,60.0,60.0
0.004,6,10,2006,5,927,1.0,659.0,659.0,5,1079,1.0,811.0,811.0
0.011,6,10,1990,5,911,2.0,643.0,643.0,5,1079,2.0,811.0,811.0
0.042,17,4,284,2,120,0.0,32.0,32.0,2,164,39.0,60.0,54.0
0.007,6,10,2006,5,927,1.0,659.0,659.0,5,1079,1.0,811.0,811.0
0.008,6,10,1989,5,910,1.0,642.0,642.0,5,1079,1.0,811.0,811.0
10.905,17,28,4421,14,1993,830.0,268.0,114.0,14,2428,830.0,587.0,145.0
0.131,6,10,1506,5,395,30.0,127.0,127.0,5,1111,30.0,843.0,843.0
0.005,17,2,136,1,60,0.0,32.0,32.0,1,76,0.0,48.0,48.0
0.08,6,10,1506,5,395,18.0,127.0,127.0,5,1111,19.0,843.0,843.0
0.029,17,2,170,1,65,0.0,37.0,37.0,1,105,0.0,77.0,77.0
0.076,6,10,1506,5,395,17.0,127.0,127.0,5,1111,16.0,843.0,843.0
0.002,17,2,179,1,62,0.0,34.0,34.0,1,117,0.0,89.0,89.0
0.005,6,10,2006,5,927,1.0,659.0,659.0,5,1079,1.0,811.0,811.0
0.006,6,10,1547,5,764,1.0,496.0,496.0,5,783,1.0,515.0,515.0
0.039,17,2,170,1,65,0.0,37.0,37.0,1,105,0.0,77.0,77.0
0.114,6,10,1506,5,395,25.0,127.0,127.0,5,1111,24.0,843.0,843.0
0.004,17,2,136,1,60,0.0,32.0,32.0,1,76,0.0,48.0,48.0
1771.664,17,120,11460,60,5460,30027.0,63.0,63.0,60,6000,30027.0,72.0,72.0
0.006,6,10,1689,5,839,1.0,571.0,571.0,5,850,1.0,582.0,582.0
0.014,6,10,1989,5,910,3.0,642.0,642.0,5,1079,3.0,811.0,811.0
240.09,6,16,4481,9,963,30011.0,238.0,166.0,7,3518,40014.0,1402.0,786.0
0.014,6,10,1989,5,910,3.0,642.0,642.0,5,1079,3.0,811.0,811.0
0.008,6,10,1990,5,911,2.0,643.0,643.0,5,1079,1.0,811.0,811.0
0.103,6,10,1506,5,395,24.0,127.0,127.0,5,1111,21.0,843.0,843.0
0.069,6,10,1506,5,395,14.0,127.0,127.0,5,1111,13.0,843.0,843.0
0.005,6,10,1854,5,889,1.0,621.0,621.0,5,965,1.0,697.0,697.0
0.005,17,2,166,1,75,0.0,47.0,47.0,1,91,0.0,63.0,63.0
0.626,6,28,13518,15,3899,44.0,1512.0,780.0,13,9619,51.0,1402.0,992.0
0.015,6,10,1762,5,911,3.0,643.0,643.0,5,851,3.0,583.0,583.0
0.005,6,10,1854,5,889,1.0,621.0,621.0,5,965,1.0,697.0,697.0
0.01,6,10,1631,5,848,2.0,580.0,580.0,5,783,2.0,515.0,515.0
0.014,6,13,3735,7,497,2.0,125.0,125.0,6,3238,2.0,1470.0,1459.0
1756.505,6,106,6322,60,3525,29769.0,27.0,27.0,46,2797,39031.0,27.0,27.0
0.106,6,10,1506,5,395,23.0,127.0,127.0,5,1111,21.0,843.0,843.0
371.267,6,22,2313,16,867,24751.0,195.0,195.0,6,1446,4694.0,419.0,398.0
0.005,17,2,214,1,75,0.0,47.0,47.0,1,139,0.0,111.0,111.0
240.105,6,32,9623,16,7130,16007.0,2203.0,700.0,16,2493,16006.0,580.0,206.0
0.008,6,10,1762,5,911,2.0,643.0,643.0,5,851,1.0,583.0,583.0
0.003,17,4,284,2,120,0.0,32.0,32.0,2,164,0.0,60.0,54.0
440.265,6,29,4409,12,3102,10912.0,494.0,494.0,17,1307,27516.0,83.0,83.0
0.005,6,10,2007,5,928,1.0,660.0,660.0,5,1079,1.0,811.0,811.0
0.098,6,10,1506,5,395,22.0,127.0,127.0,5,1111,22.0,843.0,843.0
0.01,6,10,1972,5,910,2.0,642.0,642.0,5,1062,2.0,794.0,794.0
384.834,6,22,2313,16,867,25655.0,195.0,195.0,6,1446,4647.0,419.0,398.0
0.007,6,10,1989,5,910,1.0,642.0,642.0,5,1079,1.0,811.0,811.0
0.001,17,2,174,1,72,0.0,44.0,44.0,1,102,0.0,74.0,74.0
0.004,17,2,148,1,60,0.0,32.0,32.0,1,88,0.0,60.0,60.0
240.022,6,9,787,5,488,60005.0,232.0,232.0,4,299,80006.0,83.0,83.0
0.072,6,10,1506,5,395,17.0,127.0,127.0,5,1111,17.0,843.0,843.0
0.016,6,10,1762,5,911,4.0,643.0,643.0,5,851,3.0,583.0,583.0
0.012,6,10,1972,5,910,3.0,642.0,642.0,5,1062,3.0,794.0,794.0
0.005,6,10,1989,5,927,1.0,659.0,659.0,5,1062,1.0,794.0,794.0
402.95,6,36,12786,19,4153,22385.0,676.0,451.0,17,8633,25184.0,1402.0,861.0
176.448,17,86,12448,43,2889,4201.0,44.0,39.0,43,9559,4201.0,261.0,194.0
0.004,6,10,1989,5,927,1.0,659.0,659.0,5,1062,1.0,794.0,794.0
1778.394,17,144,45504,72,22752,25047.0,288.0,288.0,72,22752,25047.0,288.0,288.0
0.005,6,10,1779,5,928,1.0,660.0,660.0,5,851,1.0,583.0,583.0
0.038,17,2,136,1,60,0.0,32.0,32.0,1,76,0.0,48.0,48.0
0.004,17,2,170,1,65,0.0,37.0,37.0,1,105,0.0,77.0,77.0
0.005,6,10,2000,5,927,1.0,659.0,659.0,5,1073,1.0,805.0,805.0
240.095,6,33,9309,17,6931,15005.0,1515.0,605.0,16,2378,16006.0,580.0,192.0
10.888,17,28,4422,14,1993,829.0,268.0,114.0,14,2429,829.0,588.0,145.0
258.482,6,34,11408,18,3425,15202.0,676.0,413.0,16,7983,17229.0,1402.0,795.0
0.063,6,10,1506,5,395,15.0,127.0,127.0,5,1111,14.0,843.0,843.0
0.009,6,10,1989,5,910,2.0,642.0,642.0,5,1079,2.0,811.0,811.0
0.004,17,4,284,2,120,0.0,32.0,32.0,2,164,0.0,60.0,54.0
42.325,6,28,9605,14,1707,3255.0,794.0,367.0,14,7898,3245.0,1360.0,732.0
0.066,6,10,1506,5,395,13.0,127.0,127.0,5,1111,15.0,843.0,843.0
40.073,17,10,676,5,460,10015.0,104.0,64.0,5,216,10017.0,20.0,15.0
0.011,6,10,1972,5,910,2.0,642.0,642.0,5,1062,2.0,794.0,794.0
40.078,17,10,676,5,460,10017.0,104.0,64.0,5,216,10018.0,20.0,15.0
40.053,17,10,676,5,460,10012.0,104.0,64.0,5,216,10012.0,20.0,15.0
0.083,6,10,1506,5,395,18.0,127.0,127.0,5,1111,18.0,843.0,843.0
0.008,6,10,1631,5,848,2.0,580.0,580.0,5,783,1.0,515.0,515.0
0.006,6,10,1547,5,764,1.0,496.0,496.0,5,783,1.0,515.0,515.0
0.085,6,10,1506,5,395,18.0,127.0,127.0,5,1111,19.0,843.0,843.0
0.02,6,10,1972,5,910,5.0,642.0,642.0,5,1062,4.0,794.0,794.0
0.005,17,2,164,1,74,0.0,46.0,46.0,1,90,0.0,62.0,62.0
0.01,6,10,1989,5,910,2.0,642.0,642.0,5,1079,2.0,811.0,811.0
0.005,6,10,2006,5,927,1.0,659.0,659.0,5,1079,1.0,811.0,811.0
0.005,6,10,1547,5,764,1.0,496.0,496.0,5,783,1.0,515.0,515.0
0.014,6,10,1631,5,848,3.0,580.0,580.0,5,783,3.0,515.0,515.0
0.01,6,10,1990,5,911,2.0,643.0,643.0,5,1079,2.0,811.0,811.0
0.086,6,10,1506,5,395,20.0,127.0,127.0,5,1111,20.0,843.0,843.0
0.098,6,10,1506,5,395,23.0,127.0,127.0,5,1111,22.0,843.0,843.0
0.005,6,10,2006,5,927,1.0,659.0,659.0,5,1079,1.0,811.0,811.0
0.014,6,13,3735,7,497,2.0,125.0,125.0,6,3238,2.0,1470.0,1459.0
0.005,6,10,2006,5,927,1.0,659.0,659.0,5,1079,1.0,811.0,811.0
0.004,6,10,1702,5,863,1.0,595.0,595.0,5,839,0.0,571.0,571.0
0.003,17,2,664,1,336,0.0,308.0,308.0,1,328,0.0,300.0,300.0
0.059,17,2,152,1,76,0.0,48.0,48.0,1,76,0.0,48.0,48.0
0.004,6,10,2006,5,927,1.0,659.0,659.0,5,1079,1.0,811.0,811.0
0.077,6,10,1506,5,395,17.0,127.0,127.0,5,1111,18.0,843.0,843.0
0.084,6,10,1506,5,395,18.0,127.0,127.0,5,1111,18.0,843.0,843.0
0.147,17,4,352,2,130,108.0,37.0,37.0,2,222,143.0,89.0,83.0
0.001,17,2,136,1,60,0.0,32.0,32.0,1,76,0.0,48.0,48.0
0.014,6,10,1990,5,911,3.0,643.0,643.0,5,1079,3.0,811.0,811.0
0.008,6,10,1677,5,827,2.0,559.0,559.0,5,850,2.0,582.0,582.0
72.932,6,26,9525,12,1627,74.0,794.0,367.0,14,7898,5600.0,1360.0,732.0
0.009,6,10,1989,5,910,2.0,642.0,642.0,5,1079,2.0,811.0,811.0
0.072,17,2,412,1,61,0.0,33.0,33.0,1,351,0.0,323.0,323.0
0.091,6,10,1506,5,395,18.0,127.0,127.0,5,1111,21.0,843.0,843.0
0.011,6,10,1989,5,910,2.0,642.0,642.0,5,1079,2.0,811.0,811.0
0.008,6,10,1972,5,910,2.0,642.0,642.0,5,1062,1.0,794.0,794.0
0.005,6,10,1989,5,927,1.0,659.0,659.0,5,1062,1.0,794.0,794.0
0.005,17,2,166,1,75,0.0,47.0,47.0,1,91,0.0,63.0,63.0
0.108,6,44,14036,24,2565,4.0,517.0,146.0,20,11471,5.0,1402.0,744.0
0.01,6,10,1972,5,910,2.0,642.0,642.0,5,1062,2.0,794.0,794.0
0.006,6,10,1643,5,860,1.0,592.0,592.0,5,783,1.0,515.0,515.0
10.875,17,28,4423,14,1995,828.0,270.0,114.0,14,2428,828.0,587.0,145.0
0.008,6,10,1983,5,910,2.0,642.0,642.0,5,1073,2.0,805.0,805.0
0.005,6,10,1547,5,764,1.0,496.0,496.0,5,783,1.0,515.0,515.0
40.058,17,10,676,5,460,10013.0,104.0,64.0,5,216,10013.0,20.0,15.0
0.128,17,2,170,1,65,0.0,37.0,37.0,1,105,0.0,77.0,77.0
0.013,6,10,1972,5,910,3.0,642.0,642.0,5,1062,3.0,794.0,794.0
169.104,17,84,12112,42,2826,4124.0,44.0,39.0,42,9286,4124.0,239.0,193.0
361.838,6,19,1689,15,978,25845.0,190.0,190.0,4,711,80013.0,495.0,495.0
0.008,6,10,1989,5,927,2.0,659.0,659.0,5,1062,1.0,794.0,794.0
0.005,17,2,156,1,70,0.0,42.0,42.0,1,86,0.0,58.0,58.0
40.068,17,10,676,5,460,10015.0,104.0,64.0,5,216,10016.0,20.0,15.0
0.013,6,10,1989,5,910,3.0,642.0,642.0,5,1079,3.0,811.0,811.0
0.007,6,10,2000,5,927,1.0,659.0,659.0,5,1073,1.0,805.0,805.0
0.003,17,2,148,1,60,0.0,32.0,32.0,1,88,0.0,60.0,60.0
291.828,6,36,11467,19,3399,16210.0,676.0,400.0,17,8068,18237.0,1402.0,718.0
0.332,17,39,20066,22,17084,15.0,1350.0,748.0,17,2982,15.0,1350.0,147.0
0.006,17,2,222,1,65,0.0,37.0,37.0,1,157,0.0,129.0,129.0
0.005,17,2,179,1,71,0.0,43.0,43.0,1,108,0.0,80.0,80.0
0.006,6,10,1547,5,764,1.0,496.0,496.0,5,783,1.0,515.0,515.0
0.005,17,2,136,1,60,0.0,32.0,32.0,1,76,0.0,48.0,48.0
0.017,6,10,1990,5,911,4.0,643.0,643.0,5,1079,4.0,811.0,811.0
0.086,6,10,1506,5,395,19.0,127.0,127.0,5,1111,19.0,843.0,843.0
0.04,17,2,182,1,65,0.0,37.0,37.0,1,117,0.0,89.0,89.0
0.107,6,10,1506,5,395,24.0,127.0,127.0,5,1111,24.0,843.0,843.0
308.412,17,20,1124,10,716,34260.0,48.0,43.0,10,408,34259.0,20.0,12.0
0.005,6,10,1774,5,923,1.0,655.0,655.0,5,851,1.0,583.0,583.0
0.013,17,2,152,1,56,0.0,28.0,28.0,1,96,0.0,68.0,68.0
0.012,6,10,1989,5,910,2.0,642.0,642.0,5,1079,2.0,811.0,811.0
0.142,6,10,1506,5,395,33.0,127.0,127.0,5,1111,32.0,843.0,843.0
0.229,6,16,2669,8,1395,32.0,533.0,323.0,8,1274,20.0,529.0,212.0
1778.37,17,144,45504,72,22752,25047.0,288.0,288.0,72,22752,25047.0,288.0,288.0
0.001,17,2,180,1,65,0.0,37.0,37.0,1,115,0.0,87.0,87.0
0.009,6,10,1972,5,910,2.0,642.0,642.0,5,1062,2.0,794.0,794.0
361.844,6,19,1689,15,978,25846.0,190.0,190.0,4,711,80027.0,495.0,495.0
1799.063,6,273,25436,138,8956,13131.0,747.0,295.0,135,16480,13425.0,1624.0,72.0
171.05,17,86,12349,43,2896,4072.0,44.0,39.0,43,9453,4072.0,239.0,191.0
368.588,6,22,2313,16,867,24572.0,195.0,195.0,6,1446,4637.0,419.0,398.0
0.079,6,10,1506,5,395,17.0,127.0,127.0,5,1111,18.0,843.0,843.0
0.011,6,10,1631,5,848,2.0,580.0,580.0,5,783,2.0,515.0,515.0
0.006,6,10,1547,5,764,1.0,496.0,496.0,5,783,1.0,515.0,515.0
0.009,6,10,1989,5,910,2.0,642.0,642.0,5,1079,2.0,811.0,811.0
0.094,6,10,1506,5,395,19.0,127.0,127.0,5,1111,15.0,843.0,843.0
0.005,17,2,136,1,60,0.0,32.0,32.0,1,76,0.0,48.0,48.0
40.076,17,10,676,5,460,10012.0,104.0,64.0,5,216,10018.0,20.0,15.0
0.222,6,16,2777,8,1395,31.0,533.0,323.0,8,1382,20.0,529.0,239.0
0.011,6,10,1989,5,910,2.0,642.0,642.0,5,1079,2.0,811.0,811.0
0.005,6,10,2007,5,928,1.0,660.0,660.0,5,1079,1.0,811.0,811.0
0.105,6,10,1506,5,395,22.0,127.0,127.0,5,1111,25.0,843.0,843.0
240.105,6,31,9263,15,6806,17150.0,1929.0,670.0,16,2457,16006.0,580.0,202.0
0.005,6,10,2007,5,928,1.0,660.0,660.0,5,1079,1.0,811.0,811.0
0.092,6,10,1506,5,395,19.0,127.0,127.0,5,1111,21.0,843.0,843.0
0.012,6,10,1990,5,911,3.0,643.0,643.0,5,1079,2.0,811.0,811.0
0.04,17,2,184,1,61,0.0,33.0,33.0,1,123,0.0,95.0,95.0
0.041,17,2,152,1,76,0.0,48.0,48.0,1,76,0.0,48.0,48.0
0.013,6,10,1972,5,910,3.0,642.0,642.0,5,1062,3.0,794.0,794.0
0.004,6,10,2007,5,928,1.0,660.0,660.0,5,1079,1.0,811.0,811.0
0.005,17,2,170,1,65,0.0,37.0,37.0,1,105,0.0,77.0,77.0
0.004,17,2,136,1,60,0.0,32.0,32.0,1,76,0.0,48.0,48.0
0.088,6,10,1506,5,395,19.0,127.0,127.0,5,1111,19.0,843.0,843.0
0.009,6,10,1983,5,910,2.0,642.0,642.0,5,1073,2.0,805.0,805.0
0.005,17,2,214,1,75,0.0,47.0,47.0,1,139,0.0,111.0,111.0
0.005,6,10,2000,5,927,1.0,659.0,659.0,5,1073,1.0,805.0,805.0
177.149,17,90,12876,45,3004,4025.0,44.0,38.0,45,9872,4026.0,261.0,191.0
0.012,6,10,1990,5,911,3.0,643.0,643.0,5,1079,3.0,811.0,811.0
309.248,17,18,1008,9,640,38646.0,48.0,43.0,9,368,38648.0,20.0,12.0
0.01,6,10,1762,5,911,2.0,643.0,643.0,5,851,2.0,583.0,583.0
0.004,17,2,148,1,60,0.0,32.0,32.0,1,88,0.0,60.0,60.0
0.005,6,10,1774,5,923,1.0,655.0,655.0,5,851,1.0,583.0,583.0
0.005,6,10,2006,5,927,1.0,659.0,659.0,5,1079,1.0,811.0,811.0
0.006,17,2,164,1,74,0.0,46.0,46.0,1,90,0.0,62.0,62.0
0.015,17,2,198,1,91,0.0,63.0,63.0,1,107,0.0,79.0,79.0
0.005,6,10,1989,5,927,1.0,659.0,659.0,5,1062,1.0,794.0,794.0
0.005,17,2,169,1,62,0.0,34.0,34.0,1,107,0.0,79.0,79.0
0.007,6,10,1983,5,910,1.0,642.0,642.0,5,1073,1.0,805.0,805.0
0.016,6,10,1990,5,911,4.0,643.0,643.0,5,1079,4.0,811.0,811.0
0.006,6,10,1643,5,860,1.0,592.0,592.0,5,783,1.0,515.0,515.0
60.029,6,10,1690,6,1308,12005.0,494.0,494.0,4,382,20007.0,83.0,83.0
0.062,6,10,1506,5,395,14.0,127.0,127.0,5,1111,13.0,843.0,843.0
0.005,6,10,2007,5,928,1.0,660.0,660.0,5,1079,1.0,811.0,811.0
0.005,6,10,2000,5,927,1.0,659.0,659.0,5,1073,1.0,805.0,805.0
0.008,6,10,1972,5,910,2.0,642.0,642.0,5,1062,2.0,794.0,794.0
0.005,6,10,1989,5,927,1.0,659.0,659.0,5,1062,1.0,794.0,794.0
0.005,17,2,169,1,62,0.0,34.0,34.0,1,107,0.0,79.0,79.0
0.204,6,16,2670,8,1396,29.0,533.0,324.0,8,1274,18.0,529.0,212.0
0.005,17,2,136,1,60,0.0,32.0,32.0,1,76,0.0,48.0,48.0
0.039,17,2,148,1,60,0.0,32.0,32.0,1,88,0.0,60.0,60.0
0.013,6,10,1990,5,911,3.0,643.0,643.0,5,1079,3.0,811.0,811.0
0.001,17,2,180,1,66,0.0,38.0,38.0,1,114,0.0,86.0,86.0
0.012,6,10,1983,5,910,3.0,642.0,642.0,5,1073,2.0,805.0,805.0
0.067,6,10,1506,5,395,14.0,127.0,127.0,5,1111,14.0,843.0,843.0
240.018,6,9,787,5,488,60004.0,232.0,232.0,4,299,80005.0,83.0,83.0
0.004,6,10,2006,5,927,1.0,659.0,659.0,5,1079,1.0,811.0,811.0
0.006,6,10,1547,5,764,1.0,496.0,496.0,5,783,1.0,515.0,515.0
40.065,17,10,676,5,460,10013.0,104.0,64.0,5,216,10015.0,20.0,15.0
0.074,6,10,1506,5,395,17.0,127.0,127.0,5,1111,16.0,843.0,843.0
0.005,6,10,1989,5,927,1.0,659.0,659.0,5,1062,1.0,794.0,794.0
0.04,17,2,182,1,65,0.0,37.0,37.0,1,117,0.0,89.0,89.0
0.003,17,4,284,2,120,0.0,32.0,32.0,2,164,0.0,60.0,54.0
0.009,6,10,1762,5,911,2.0,643.0,643.0,5,851,2.0,583.0,583.0
0.098,6,10,1506,5,395,21.0,127.0,127.0,5,1111,18.0,843.0,843.0
0.001,17,2,142,1,63,0.0,35.0,35.0,1,79,0.0,51.0,51.0
0.005,6,14,3736,7,446,0.0,74.0,74.0,7,3290,0.0,1448.0,972.0
40.058,17,10,676,5,460,10013.0,104.0,64.0,5,216,10011.0,20.0,15.0
0.001,17,2,180,1,66,0.0,38.0,38.0,1,114,0.0,86.0,86.0
40.074,17,10,676,5,460,10015.0,104.0,64.0,5,216,10014.0,20.0,15.0
0.007,6,10,2007,5,928,1.0,660.0,660.0,5,1079,1.0,811.0,811.0
0.009,17,2,172,1,132,0.0,104.0,104.0,1,40,0.0,12.0,12.0
408.174,6,37,13748,20,3430,21482.0,676.0,397.0,17,10318,21760.0,1402.0,942.0
0.014,6,10,1677,5,827,3.0,559.0,559.0,5,850,3.0,582.0,582.0
0.153,6,10,1506,5,395,36.0,127.0,127.0,5,1111,33.0,843.0,843.0
0.006,17,2,180,1,66,0.0,38.0,38.0,1,114,0.0,86.0,86.0
0.038,17,2,152,1,76,0.0,48.0,48.0,1,76,0.0,48.0,48.0
0.005,17,2,164,1,74,0.0,46.0,46.0,1,90,0.0,62.0,62.0
0.011,6,10,1972,5,910,2.0,642.0,642.0,5,1062,2.0,794.0,794.0
0.011,6,10,1989,5,910,2.0,642.0,642.0,5,1079,2.0,811.0,811.0
0.13,17,2,136,1,60,0.0,32.0,32.0,1,76,0.0,48.0,48.0
0.094,6,10,1506,5,395,19.0,127.0,127.0,5,1111,22.0,843.0,843.0
0.015,6,10,1677,5,827,3.0,559.0,559.0,5,850,3.0,582.0,582.0
0.015,17,2,179,1,71,0.0,43.0,43.0,1,108,0.0,80.0,80.0
0.117,6,10,1506,5,395,25.0,127.0,127.0,5,1111,24.0,843.0,843.0
0.016,6,10,1989,5,910,4.0,642.0,642.0,5,1079,4.0,811.0,811.0
354.061,6,19,1691,15,978,25290.0,190.0,190.0,4,713,80003.0,497.0,497.0
0.008,6,10,1989,5,910,2.0,642.0,642.0,5,1079,2.0,811.0,811.0
311.64,17,20,1124,10,716,34616.0,48.0,43.0,10,408,34617.0,20.0,12.0
0.209,6,16,2779,8,1397,29.0,533.0,324.0,8,1382,19.0,529.0,239.0
0.004,17,2,148,1,60,0.0,32.0,32.0,1,88,0.0,60.0,60.0
0.005,6,10,1643,5,860,1.0,592.0,592.0,5,783,1.0,515.0,515.0
292.849,6,321,343720,127,18155,2324.0,2736.0,888.0,194,325565,1517.0,2804.0,1752.0
0.024,6,10,1989,5,910,6.0,642.0,642.0,5,1079,5.0,811.0,811.0
0.02,6,10,1990,5,911,5.0,643.0,643.0,5,1079,4.0,811.0,811.0
351.99,6,20,2210,6,1308,12004.0,494.0,494.0,14,902,27075.0,83.0,83.0
0.005,17,4,284,2,120,0.0,32.0,32.0,2,164,0.0,60.0,54.0
0.083,6,10,1506,5,395,18.0,127.0,127.0,5,1111,19.0,843.0,843.0
0.112,6,10,1506,5,395,21.0,127.0,127.0,5,1111,25.0,843.0,843.0
0.004,17,4,284,2,120,0.0,32.0,32.0,2,164,1.0,60.0,54.0
0.083,6,10,1506,5,395,19.0,127.0,127.0,5,1111,16.0,843.0,843.0
40.052,17,10,676,5,460,10011.0,104.0,64.0,5,216,10012.0,20.0,15.0
0.04,17,2,136,1,60,0.0,32.0,32.0,1,76,0.0,48.0,48.0
0.008,6,12,1926,6,1189,1.0,659.0,434.0,6,737,1.0,417.0,417.0
0.016,17,2,170,1,65,0.0,37.0,37.0,1,105,0.0,77.0,77.0
0.006,17,2,148,1,60,0.0,32.0,32.0,1,88,0.0,60.0,60.0
300.311,6,16,2170,9,684,37517.0,146.0,146.0,7,1486,50021.0,419.0,398.0
0.005,17,2,170,1,65,0.0,37.0,37.0,1,105,0.0,77.0,77.0
0.005,6,10,2000,5,927,1.0,659.0,659.0,5,1073,1.0,805.0,805.0
0.208,6,16,2777,8,1395,29.0,533.0,323.0,8,1382,19.0,529.0,239.0
9.032,6,36,9771,19,4293,501.0,1360.0,700.0,17,5478,551.0,2667.0,435.0
0.023,6,10,1972,5,910,5.0,642.0,642.0,5,1062,5.0,794.0,794.0
0.004,17,4,284,2,120,0.0,32.0,32.0,2,164,0.0,60.0,54.0
40.072,17,10,676,5,460,10015.0,104.0,64.0,5,216,10017.0,20.0,15.0
0.004,6,10,1702,5,863,1.0,595.0,595.0,5,839,0.0,571.0,571.0
0.014,6,10,1762,5,911,3.0,643.0,643.0,5,851,3.0,583.0,583.0
0.005,6,10,2007,5,928,1.0,660.0,660.0,5,1079,1.0,811.0,811.0
0.017,6,10,1983,5,910,4.0,642.0,642.0,5,1073,4.0,805.0,805.0
0.005,17,2,170,1,65,0.0,37.0,37.0,1,105,0.0,77.0,77.0
0.004,17,2,136,1,60,0.0,32.0,32.0,1,76,0.0,48.0,48.0
0.005,6,10,2006,5,927,1.0,659.0,659.0,5,1079,1.0,811.0,811.0
0.005,17,4,284,2,120,2.0,32.0,32.0,2,164,2.0,60.0,54.0
0.066,6,10,1506,5,395,14.0,127.0,127.0,5,1111,15.0,843.0,843.0
0.005,6,10,2007,5,928,1.0,660.0,660.0,5,1079,1.0,811.0,811.0
0.004,17,2,170,1,65,0.0,37.0,37.0,1,105,0.0,77.0,77.0
0.021,6,10,1990,5,911,5.0,643.0,643.0,5,1079,5.0,811.0,811.0
0.07,6,10,1506,5,395,13.0,127.0,127.0,5,1111,16.0,843.0,843.0
11.147,17,28,4420,14,1995,845.0,270.0,114.0,14,2425,845.0,588.0,145.0
0.006,6,10,1643,5,860,1.0,592.0,592.0,5,783,1.0,515.0,515.0
0.008,17,2,179,1,71,0.0,43.0,43.0,1,108,0.0,80.0,80.0
0.005,17,2,194,1,59,0.0,31.0,31.0,1,135,0.0,107.0,107.0
0.004,6,10,2000,5,927,1.0,659.0,659.0,5,1073,1.0,805.0,805.0
0.041,17,4,596,2,122,1.0,33.0,33.0,2,474,0.0,323.0,209.0
0.008,17,2,194,1,59,0.0,31.0,31.0,1,135,0.0,107.0,107.0
0.003,17,2,148,1,60,0.0,32.0,32.0,1,88,0.0,60.0,60.0
0.002,17,2,180,1,66,0.0,38.0,38.0,1,114,0.0,86.0,86.0
0.005,6,10,1989,5,927,1.0,659.0,659.0,5,1062,1.0,794.0,794.0
0.092,6,10,1506,5,395,21.0,127.0,127.0,5,1111,19.0,843.0,843.0
0.004,17,2,148,1,60,0.0,32.0,32.0,1,88,0.0,60.0,60.0
0.004,6,10,2007,5,928,1.0,660.0,660.0,5,1079,1.0,811.0,811.0
15.078,17,15,9238,8,6902,2149.0,1350.0,834.0,7,2336,2508.0,1350.0,305.0
0.005,6,10,1774,5,923,1.0,655.0,655.0,5,851,1.0,583.0,583.0
0.075,6,10,1506,5,395,16.0,127.0,127.0,5,1111,16.0,843.0,843.0
0.005,6,10,2006,5,927,1.0,659.0,659.0,5,1079,1.0,811.0,811.0
0.001,17,2,180,1,66,0.0,38.0,38.0,1,114,0.0,86.0,86.0
0.011,17,2,148,1,60,0.0,32.0,32.0,1,88,0.0,60.0,60.0
10.724,17,28,4420,14,1994,816.0,269.0,114.0,14,2426,816.0,585.0,145.0
0.034,17,2,152,1,76,0.0,48.0,48.0,1,76,0.0,48.0,48.0
0.005,17,2,179,1,71,0.0,43.0,43.0,1,108,0.0,80.0,80.0
308.313,17,20,1124,10,716,34247.0,48.0,43.0,10,408,34246.0,20.0,12.0
0.013,6,10,1989,5,910,3.0,642.0,642.0,5,1079,3.0,811.0,811.0
0.108,6,10,1506,5,395,22.0,127.0,127.0,5,1111,24.0,843.0,843.0
0.004,6,10,2007,5,928,1.0,660.0,660.0,5,1079,1.0,811.0,811.0
0.005,6,10,1547,5,764,1.0,496.0,496.0,5,783,1.0,515.0,515.0
0.006,6,10,1547,5,764,1.0,496.0,496.0,5,783,1.0,515.0,515.0
0.09,6,10,1506,5,395,19.0,127.0,127.0,5,1111,22.0,843.0,843.0
0.004,17,2,136,1,60,0.0,32.0,32.0,1,76,0.0,48.0,48.0
0.008,6,6,716,3,458,3.0,302.0,302.0,3,258,2.0,102.0,102.0
0.01,6,10,1972,5,910,2.0,642.0,642.0,5,1062,2.0,794.0,794.0
0.006,6,10,1547,5,764,1.0,496.0,496.0,5,783,1.0,515.0,515.0
0.019,6,10,1631,5,848,4.0,580.0,580.0,5,783,4.0,515.0,515.0
0.009,6,10,1677,5,827,2.0,559.0,559.0,5,850,2.0,582.0,582.0
0.023,6,13,3735,7,497,3.0,125.0,125.0,6,3238,4.0,1470.0,1459.0
0.119,6,10,1506,5,395,27.0,127.0,127.0,5,1111,20.0,843.0,843.0
11.012,17,28,4420,14,1993,838.0,268.0,114.0,14,2427,838.0,586.0,145.0
0.006,17,2,180,1,66,0.0,38.0,38.0,1,114,0.0,86.0,86.0
0.005,6,10,2006,5,927,1.0,659.0,659.0,5,1079,1.0,811.0,811.0
308.62,17,20,1124,10,716,34276.0,48.0,43.0,10,408,34276.0,20.0,12.0
0.017,6,10,1989,5,910,4.0,642.0,642.0,5,1079,4.0,811.0,811.0
0.004,17,2,136,1,60,0.0,32.0,32.0,1,76,0.0,48.0,48.0
0.011,6,10,1990,5,911,2.0,643.0,643.0,5,1079,2.0,811.0,811.0
0.074,6,10,1506,5,395,17.0,127.0,127.0,5,1111,14.0,843.0,843.0
0.089,6,10,1506,5,395,19.0,127.0,127.0,5,1111,21.0,843.0,843.0
11.135,17,28,4423,14,1994,844.0,269.0,114.0,14,2429,844.0,588.0,145.0
0.013,17,2,158,1,63,0.0,35.0,35.0,1,95,0.0,67.0,67.0
0.437,6,14,3108,8,601,62.0,177.0,177.0,6,2507,66.0,1402.0,1089.0
0.091,6,10,1506,5,395,20.0,127.0,127.0,5,1111,21.0,843.0,843.0
0.019,6,10,1762,5,911,4.0,643.0,643.0,5,851,4.0,583.0,583.0
0.005,17,2,170,1,65,0.0,37.0,37.0,1,105,0.0,77.0,77.0
0.005,6,10,2006,5,927,1.0,659.0,659.0,5,1079,1.0,811.0,811.0
0.011,6,10,1983,5,910,2.0,642.0,642.0,5,1073,2.0,805.0,805.0
0.015,6,10,1990,5,911,3.0,643.0,643.0,5,1079,3.0,811.0,811.0
289.865,6,404,348844,201,22012,1449.0,2736.0,888.0,203,326832,1434.0,2914.0,1673.0
240.023,6,9,787,5,488,60005.0,232.0,232.0,4,299,80006.0,83.0,83.0
0.088,6,10,1506,5,395,18.0,127.0,127.0,5,1111,20.0,843.0,843.0
0.006,17,2,179,1,71,0.0,43.0,43.0,1,108,0.0,80.0,80.0
0.005,17,2,187,1,71,0.0,43.0,43.0,1,116,0.0,88.0,88.0
0.006,6,10,1547,5,764,1.0,496.0,496.0,5,783,1.0,515.0,515.0
309.805,17,18,1008,9,640,38709.0,48.0,43.0,9,368,38709.0,20.0,12.0
0.005,17,2,164,1,74,0.0,46.0,46.0,1,90,0.0,62.0,62.0
0.006,6,10,1989,5,927,1.0,659.0,659.0,5,1062,1.0,794.0,794.0
0.004,6,10,1989,5,927,1.0,659.0,659.0,5,1062,1.0,794.0,794.0
0.006,6,10,1547,5,764,1.0,496.0,496.0,5,783,1.0,515.0,515.0
0.001,17,2,140,1,62,0.0,34.0,34.0,1,78,0.0,50.0,50.0
0.015,6,10,1989,5,910,3.0,642.0,642.0,5,1079,3.0,811.0,811.0
0.095,17,2,152,1,76,0.0,48.0,48.0,1,76,0.0,48.0,48.0
0.004,6,10,2000,5,927,1.0,659.0,659.0,5,1073,1.0,805.0,805.0
0.004,6,10,1702,5,863,1.0,595.0,595.0,5,839,0.0,571.0,571.0
15.302,17,17,9564,8,4356,2182.0,1350.0,516.0,9,5208,1909.0,1350.0,550.0
0.005,6,10,2006,5,927,1.0,659.0,659.0,5,1079,1.0,811.0,811.0
0.005,17,2,168,1,76,0.0,48.0,48.0,1,92,0.0,64.0,64.0
0.005,6,10,1989,5,927,1.0,659.0,659.0,5,1062,1.0,794.0,794.0
0.006,6,10,1547,5,764,1.0,496.0,496.0,5,783,1.0,515.0,515.0
0.139,6,10,1506,5,395,29.0,127.0,127.0,5,1111,32.0,843.0,843.0
0.008,6,10,1989,5,910,2.0,642.0,642.0,5,1079,1.0,811.0,811.0
0.004,17,4,284,2,120,0.0,32.0,32.0,2,164,1.0,60.0,54.0
0.101,6,10,1506,5,395,18.0,127.0,127.0,5,1111,22.0,843.0,843.0
0.004,6,10,2006,5,927,1.0,659.0,659.0,5,1079,1.0,811.0,811.0
0.001,17,2,180,1,66,0.0,38.0,38.0,1,114,0.0,86.0,86.0
0.005,6,10,1689,5,839,1.0,571.0,571.0,5,850,1.0,582.0,582.0
1730.422,6,45,2790,30,1725,59669.0,35.0,35.0,15,1065,123596.0,31.0,31.0
0.003,17,2,148,1,60,0.0,32.0,32.0,1,88,0.0,60.0,60.0
0.095,6,10,1506,5,395,22.0,127.0,127.0,5,1111,21.0,843.0,843.0
0.001,17,2,180,1,66,0.0,38.0,38.0,1,114,0.0,86.0,86.0
0.006,6,10,1854,5,889,1.0,621.0,621.0,5,965,1.0,697.0,697.0
0.007,6,10,1547,5,764,1.0,496.0,496.0,5,783,1.0,515.0,515.0
301.071,6,45,14954,23,9047,13685.0,2720.0,1156.0,22,5907,423.0,2667.0,385.0
0.004,6,10,2000,5,927,1.0,659.0,659.0,5,1073,1.0,805.0,805.0
0.012,6,10,1989,5,910,2.0,642.0,642.0,5,1079,3.0,811.0,811.0
0.004,17,2,148,1,60,0.0,32.0,32.0,1,88,0.0,60.0,60.0
0.064,6,10,1506,5,395,14.0,127.0,127.0,5,1111,14.0,843.0,843.0
0.012,6,10,1762,5,911,2.0,643.0,643.0,5,851,2.0,583.0,583.0
0.022,17,2,136,1,60,0.0,32.0,32.0,1,76,0.0,48.0,48.0
0.004,6,10,2006,5,927,1.0,659.0,659.0,5,1079,1.0,811.0,811.0
240.1,6,16,4481,9,963,30012.0,238.0,166.0,7,3518,40016.0,1402.0,786.0
0.26,17,37,20176,21,17042,13.0,1350.0,783.0,16,3134,13.0,1350.0,167.0
412.252,6,29,4409,12,3102,10911.0,494.0,494.0,17,1307,25765.0,83.0,83.0
0.01,17,2,132,1,58,0.0,30.0,30.0,1,74,0.0,46.0,46.0
40.055,17,10,676,5,460,10012.0,104.0,64.0,5,216,10013.0,20.0,15.0
0.005,6,10,2000,5,927,1.0,659.0,659.0,5,1073,1.0,805.0,805.0
0.01,6,14,3787,7,497,1.0,125.0,125.0,7,3290,1.0,1448.0,972.0
0.006,6,10,1547,5,764,1.0,496.0,496.0,5,783,1.0,515.0,515.0
0.063,6,10,1506,5,395,14.0,127.0,127.0,5,1111,14.0,843.0,843.0
361.759,6,19,1688,15,978,25839.0,190.0,190.0,4,710,80012.0,494.0,494.0
0.083,6,10,1506,5,395,18.0,127.0,127.0,5,1111,16.0,843.0,843.0
0.009,6,10,1989,5,910,2.0,642.0,642.0,5,1079,2.0,811.0,811.0
0.001,17,2,180,1,66,0.0,38.0,38.0,1,114,0.0,86.0,86.0
178.134,17,74,10439,37,2465,4947.0,44.0,38.0,37,7974,4947.0,249.0,187.0
0.005,6,10,1854,5,889,1.0,621.0,621.0,5,965,1.0,697.0,697.0
0.015,6,10,1989,5,910,3.0,642.0,642.0,5,1079,3.0,811.0,811.0
40.067,17,10,676,5,460,10015.0,104.0,64.0,5,216,10016.0,20.0,15.0
0.001,17,2,166,1,75,0.0,47.0,47.0,1,91,0.0,63.0,63.0
0.131,6,10,1506,5,395,31.0,127.0,127.0,5,1111,28.0,843.0,843.0
40.076,17,10,676,5,460,10011.0,104.0,64.0,5,216,10018.0,20.0,15.0
0.015,6,10,1972,5,910,3.0,642.0,642.0,5,1062,3.0,794.0,794.0
421.304,6,32,11123,17,3295,26329.0,676.0,400.0,15,7828,30090.0,1402.0,881.0
0.094,6,10,1506,5,395,21.0,127.0,127.0,5,1111,19.0,843.0,843.0
0.043,17,2,152,1,76,0.0,48.0,48.0,1,76,0.0,48.0,48.0
40.061,17,10,676,5,460,10012.0,104.0,64.0,5,216,10014.0,20.0,15.0
0.003,17,2,148,1,60,0.0,32.0,32.0,1,88,0.0,60.0,60.0
0.076,6,10,1506,5,395,15.0,127.0,127.0,5,1111,16.0,843.0,843.0
0.005,6,10,1643,5,860,1.0,592.0,592.0,5,783,1.0,515.0,515.0
0.019,6,10,1972,5,910,4.0,642.0,642.0,5,1062,4.0,794.0,794.0
0.006,17,2,152,1,68,0.0,40.0,40.0,1,84,0.0,56.0,56.0
40.083,17,10,676,5,460,10020.0,104.0,64.0,5,216,10020.0,20.0,15.0
0.005,6,10,1779,5,928,1.0,660.0,660.0,5,851,1.0,583.0,583.0
0.001,17,2,248,1,68,0.0,40.0,40.0,1,180,0.0,152.0,152.0
0.005,6,10,1689,5,839,1.0,571.0,571.0,5,850,1.0,582.0,582.0
0.003,17,2,208,1,72,0.0,44.0,44.0,1,136,0.0,108.0,108.0
0.01,17,2,194,1,59,0.0,31.0,31.0,1,135,0.0,107.0,107.0
0.014,6,10,1631,5,848,3.0,580.0,580.0,5,783,3.0,515.0,515.0
0.399,17,54,35825,32,29916,12.0,1350.0,906.0,22,5909,16.0,1350.0,240.0
0.04,17,2,144,1,64,0.0,36.0,36.0,1,80,0.0,52.0,52.0
0.016,6,10,1983,5,910,3.0,642.0,642.0,5,1073,3.0,805.0,805.0
0.017,17,2,164,1,74,0.0,46.0,46.0,1,90,0.0,62.0,62.0
0.004,6,10,2006,5,927,1.0,659.0,659.0,5,1079,1.0,811.0,811.0
0.004,6,10,2000,5,927,1.0,659.0,659.0,5,1073,1.0,805.0,805.0
0.005,6,10,1689,5,839,1.0,571.0,571.0,5,850,1.0,582.0,582.0
40.067,17,10,676,5,460,10015.0,104.0,64.0,5,216,10015.0,20.0,15.0
0.005,6,10,2000,5,927,1.0,659.0,659.0,5,1073,1.0,805.0,805.0
0.001,17,2,136,1,60,0.0,32.0,32.0,1,76,0.0,48.0,48.0
0.005,6,10,2006,5,927,1.0,659.0,659.0,5,1079,1.0,811.0,811.0
300.14,6,40,12493,21,6935,14998.0,2720.0,1010.0,19,5558,16665.0,2667.0,435.0
0.037,17,2,146,1,65,0.0,37.0,37.0,1,81,0.0,53.0,53.0
0.212,6,16,2779,8,1397,30.0,533.0,324.0,8,1382,19.0,529.0,239.0
0.006,6,10,1774,5,923,1.0,655.0,655.0,5,851,1.0,583.0,583.0
0.006,6,10,1547,5,764,1.0,496.0,496.0,5,783,1.0,515.0,515.0
0.011,6,10,1990,5,911,2.0,643.0,643.0,5,1079,2.0,811.0,811.0
300.384,6,16,2170,9,684,37527.0,146.0,146.0,7,1486,50036.0,419.0,398.0
0.005,6,13,3747,7,509,0.0,137.0,137.0,6,3238,1.0,1470.0,1459.0
40.064,17,10,676,5,460,10015.0,104.0,64.0,5,216,10015.0,20.0,15.0
40.062,17,10,676,5,460,10013.0,104.0,64.0,5,216,10014.0,20.0,15.0
0.039,17,4,284,2,120,0.0,32.0,32.0,2,164,35.0,60.0,54.0
0.17,17,2,152,1,76,0.0,48.0,48.0,1,76,0.0,48.0,48.0
0.004,17,4,284,2,120,0.0,32.0,32.0,2,164,1.0,60.0,54.0
0.112,6,10,1506,5,395,25.0,127.0,127.0,5,1111,22.0,843.0,843.0
0.004,6,10,2006,5,927,1.0,659.0,659.0,5,1079,1.0,811.0,811.0
0.007,17,4,284,2,120,0.0,32.0,32.0,2,164,0.0,60.0,54.0
0.015,6,10,1631,5,848,3.0,580.0,580.0,5,783,3.0,515.0,515.0
0.165,17,2,152,1,76,0.0,48.0,48.0,1,76,0.0,48.0,48.0
0.085,6,10,1506,5,395,18.0,127.0,127.0,5,1111,17.0,843.0,843.0
0.083,6,10,1506,5,395,19.0,127.0,127.0,5,1111,16.0,843.0,843.0
0.004,6,10,1702,5,863,0.0,595.0,595.0,5,839,1.0,571.0,571.0
0.014,6,10,1989,5,910,3.0,642.0,642.0,5,1079,3.0,811.0,811.0
0.015,6,10,1762,5,911,3.0,643.0,643.0,5,851,3.0,583.0,583.0
40.071,17,10,676,5,460,10015.0,104.0,64.0,5,216,10016.0,20.0,15.0
0.006,6,10,2006,5,927,1.0,659.0,659.0,5,1079,1.0,811.0,811.0
0.102,6,10,1506,5,395,21.0,127.0,127.0,5,1111,20.0,843.0,843.0
0.004,17,4,284,2,120,0.0,32.0,32.0,2,164,1.0,60.0,54.0
369.926,6,22,2313,16,867,24661.0,195.0,195.0,6,1446,4635.0,419.0,398.0
0.075,6,10,1506,5,395,16.0,127.0,127.0,5,1111,17.0,843.0,843.0
0.01,6,14,3787,7,497,1.0,125.0,125.0,7,3290,1.0,1448.0,972.0
0.07,6,10,1506,5,395,14.0,127.0,127.0,5,1111,15.0,843.0,843.0
0.005,6,10,1547,5,764,1.0,496.0,496.0,5,783,1.0,515.0,515.0
0.041,17,2,152,1,76,0.0,48.0,48.0,1,76,0.0,48.0,48.0
0.082,17,4,352,2,130,3.0,37.0,37.0,2,222,41.0,89.0,83.0
240.101,6,16,4481,9,963,30012.0,238.0,166.0,7,3518,40015.0,1402.0,786.0
0.009,6,10,1762,5,911,2.0,643.0,643.0,5,851,2.0,583.0,583.0
0.008,6,12,1926,6,1189,1.0,659.0,434.0,6,737,1.0,417.0,417.0
0.015,6,10,1989,5,910,3.0,642.0,642.0,5,1079,3.0,811.0,811.0
0.006,17,2,170,1,65,0.0,37.0,37.0,1,105,0.0,77.0,77.0
0.001,17,2,180,1,66,0.0,38.0,38.0,1,114,0.0,86.0,86.0
0.089,6,10,1506,5,395,20.0,127.0,127.0,5,1111,19.0,843.0,843.0
0.004,6,10,1989,5,927,1.0,659.0,659.0,5,1062,1.0,794.0,794.0
0.004,17,2,136,1,60,0.0,32.0,32.0,1,76,0.0,48.0,48.0
0.005,6,10,1774,5,923,1.0,655.0,655.0,5,851,1.0,583.0,583.0
11.067,17,26,4076,13,2165,913.0,588.0,138.0,13,1911,913.0,270.0,119.0
0.005,17,2,179,1,71,0.0,43.0,43.0,1,108,0.0,80.0,80.0
0.038,17,2,152,1,76,0.0,48.0,48.0,1,76,0.0,48.0,48.0
0.013,6,10,1989,5,910,3.0,642.0,642.0,5,1079,3.0,811.0,811.0
0.053,17,2,152,1,76,0.0,48.0,48.0,1,76,0.0,48.0,48.0
0.104,6,10,1506,5,395,20.0,127.0,127.0,5,1111,23.0,843.0,843.0
0.004,6,10,2000,5,927,1.0,659.0,659.0,5,1073,1.0,805.0,805.0
0.009,6,10,1972,5,910,2.0,642.0,642.0,5,1062,2.0,794.0,794.0
0.039,17,2,412,1,61,0.0,33.0,33.0,1,351,0.0,323.0,323.0
178.081,17,94,13465,47,3159,3871.0,44.0,39.0,47,10306,3871.0,239.0,191.0
312.868,17,20,1124,10,716,34748.0,48.0,43.0,10,408,34748.0,20.0,12.0
0.087,6,10,1506,5,395,19.0,127.0,127.0,5,1111,19.0,843.0,843.0
240.709,6,39,9797,20,2227,12667.0,747.0,235.0,19,7570,13370.0,1402.0,548.0
0.029,6,10,1989,5,910,7.0,642.0,642.0,5,1079,7.0,811.0,811.0
0.099,6,10,1506,5,395,22.0,127.0,127.0,5,1111,21.0,843.0,843.0
0.003,6,10,1702,5,863,0.0,595.0,595.0,5,839,0.0,571.0,571.0
0.02,6,10,1989,5,910,4.0,642.0,642.0,5,1079,5.0,811.0,811.0
11.045,17,28,4396,14,2313,840.0,588.0,137.0,14,2083,840.0,270.0,120.0
0.007,6,10,1989,5,927,1.0,659.0,659.0,5,1062,1.0,794.0,794.0
0.012,6,12,1926,6,1189,2.0,659.0,434.0,6,737,2.0,417.0,417.0
66.352,6,27,17545,15,9603,4739.0,2804.0,1469.0,12,7942,6017.0,2313.0,1218.0
0.04,17,2,136,1,60,0.0,32.0,32.0,1,76,0.0,48.0,48.0
40.058,17,10,676,5,460,10013.0,104.0,64.0,5,216,10013.0,20.0,15.0
0.077,17,4,352,2,130,6.0,37.0,37.0,2,222,73.0,89.0,83.0
0.127,6,10,1506,5,395,29.0,127.0,127.0,5,1111,27.0,843.0,843.0
0.043,6,10,1983,5,910,10.0,642.0,642.0,5,1073,10.0,805.0,805.0
0.009,6,10,1989,5,910,2.0,642.0,642.0,5,1079,2.0,811.0,811.0
0.006,6,10,1547,5,764,1.0,496.0,496.0,5,783,1.0,515.0,515.0
10.754,17,28,4423,14,1994,818.0,269.0,114.0,14,2429,818.0,588.0,145.0
40.063,17,10,676,5,460,10013.0,104.0,64.0,5,216,10014.0,20.0,15.0
0.012,6,10,1989,5,910,2.0,642.0,642.0,5,1079,2.0,811.0,811.0
300.379,6,16,2170,9,684,37527.0,146.0,146.0,7,1486,50035.0,419.0,398.0
0.005,6,13,3690,7,452,0.0,80.0,80.0,6,3238,0.0,1470.0,1459.0
0.081,6,10,1506,5,395,19.0,127.0,127.0,5,1111,18.0,843.0,843.0
0.072,17,2,186,1,61,0.0,33.0,33.0,1,125,0.0,97.0,97.0
0.006,17,2,225,1,65,0.0,37.0,37.0,1,160,0.0,132.0,132.0
0.003,17,2,148,1,60,0.0,32.0,32.0,1,88,0.0,60.0,60.0
0.006,6,10,2006,5,927,1.0,659.0,659.0,5,1079,1.0,811.0,811.0
0.038,17,2,144,1,64,0.0,36.0,36.0,1,80,0.0,52.0,52.0
0.005,6,10,2006,5,927,1.0,659.0,659.0,5,1079,1.0,811.0,811.0
11.063,17,28,4394,14,2312,842.0,587.0,137.0,14,2082,842.0,269.0,120.0
0.007,17,2,162,1,65,0.0,37.0,37.0,1,97,0.0,69.0,69.0
0.012,6,10,1990,5,911,3.0,643.0,643.0,5,1079,3.0,811.0,811.0
0.004,17,4,284,2,120,0.0,32.0,32.0,2,164,0.0,60.0,54.0
0.004,6,10,2007,5,928,1.0,660.0,660.0,5,1079,1.0,811.0,811.0
0.011,6,10,1643,5,860,2.0,592.0,592.0,5,783,2.0,515.0,515.0
0.039,17,2,144,1,64,0.0,36.0,36.0,1,80,0.0,52.0,52.0
0.017,6,10,1990,5,911,4.0,643.0,643.0,5,1079,4.0,811.0,811.0
369.868,6,22,2313,16,867,24657.0,195.0,195.0,6,1446,4639.0,419.0,398.0
0.122,6,14,4389,8,923,17.0,238.0,166.0,6,3466,16.0,1402.0,786.0
0.089,6,10,1506,5,395,22.0,127.0,127.0,5,1111,17.0,843.0,843.0
0.004,6,10,1774,5,923,1.0,655.0,655.0,5,851,1.0,583.0,583.0
30.589,6,36,9195,18,3677,517.0,1360.0,731.0,18,5518,1789.0,2667.0,435.0
0.096,6,10,1506,5,395,20.0,127.0,127.0,5,1111,20.0,843.0,843.0
0.104,6,10,1506,5,395,23.0,127.0,127.0,5,1111,23.0,843.0,843.0
0.016,17,2,198,1,91,0.0,63.0,63.0,1,107,0.0,79.0,79.0
0.412,17,17,11351,9,8295,51.0,1350.0,893.0,8,3056,49.0,1350.0,354.0
0.012,6,10,1972,5,910,3.0,642.0,642.0,5,1062,2.0,794.0,794.0
0.003,17,2,185,1,73,0.0,45.0,45.0,1,112,0.0,84.0,84.0
0.012,6,10,1989,5,910,3.0,642.0,642.0,5,1079,3.0,811.0,811.0
0.006,6,10,1547,5,764,1.0,496.0,496.0,5,783,1.0,515.0,515.0
0.015,6,13,3735,7,497,2.0,125.0,125.0,6,3238,3.0,1470.0,1459.0
295.552,6,385,347333,200,21964,1485.0,2736.0,888.0,185,325369,1606.0,4171.0,1846.0
0.008,6,10,1989,5,910,2.0,642.0,642.0,5,1079,1.0,811.0,811.0
0.005,6,10,1989,5,927,1.0,659.0,659.0,5,1062,1.0,794.0,794.0
0.012,6,10,1990,5,911,3.0,643.0,643.0,5,1079,3.0,811.0,811.0
0.004,6,10,2006,5,927,1.0,659.0,659.0,5,1079,1.0,811.0,811.0
0.042,6,10,1989,5,910,10.0,642.0,642.0,5,1079,10.0,811.0,811.0
0.014,6,10,1972,5,910,3.0,642.0,642.0,5,1062,3.0,794.0,794.0
0.004,6,10,1774,5,923,1.0,655.0,655.0,5,851,1.0,583.0,583.0
0.005,6,10,1689,5,839,1.0,571.0,571.0,5,850,1.0,582.0,582.0
0.038,17,4,596,2,122,2.0,33.0,33.0,2,474,0.0,323.0,209.0
40.067,17,10,676,5,460,10014.0,104.0,64.0,5,216,10015.0,20.0,15.0
0.041,17,2,148,1,60,0.0,32.0,32.0,1,88,0.0,60.0,60.0
0.111,6,10,1506,5,395,21.0,127.0,127.0,5,1111,24.0,843.0,843.0
0.004,6,10,2006,5,927,1.0,659.0,659.0,5,1079,1.0,811.0,811.0
0.074,6,10,1506,5,395,15.0,127.0,127.0,5,1111,16.0,843.0,843.0
0.008,6,10,1990,5,911,2.0,643.0,643.0,5,1079,2.0,811.0,811.0
0.005,6,10,2006,5,927,1.0,659.0,659.0,5,1079,1.0,811.0,811.0
240.029,6,9,787,5,488,60007.0,232.0,232.0,4,299,80008.0,83.0,83.0
40.069,17,10,676,5,460,10015.0,104.0,64.0,5,216,10016.0,20.0,15.0
0.005,6,10,2006,5,927,1.0,659.0,659.0,5,1079,1.0,811.0,811.0
0.001,17,2,180,1,66,0.0,38.0,38.0,1,114,0.0,86.0,86.0
0.005,6,10,2006,5,927,1.0,659.0,659.0,5,1079,1.0,811.0,811.0
0.013,6,10,1989,5,910,3.0,642.0,642.0,5,1079,3.0,811.0,811.0
0.011,6,10,1990,5,911,2.0,643.0,643.0,5,1079,2.0,811.0,811.0
0.005,17,2,169,1,62,0.0,34.0,34.0,1,107,0.0,79.0,79.0
0.041,17,2,152,1,76,0.0,48.0,48.0,1,76,0.0,48.0,48.0
1791.424,6,248,47068,120,34192,15053.0,2472.0,1032.0,128,12876,14105.0,580.0,61.0
40.056,17,10,676,5,460,10012.0,104.0,64.0,5,216,10013.0,20.0,15.0
0.012,6,10,1972,5,910,3.0,642.0,642.0,5,1062,2.0,794.0,794.0
0.008,6,10,1762,5,911,1.0,643.0,643.0,5,851,2.0,583.0,583.0
308.729,17,20,1124,10,716,34289.0,48.0,43.0,10,408,34289.0,20.0,12.0
15.072,17,15,9238,8,6902,2149.0,1350.0,834.0,7,2336,2507.0,1350.0,305.0
0.09,6,10,1506,5,395,21.0,127.0,127.0,5,1111,19.0,843.0,843.0
0.058,6,10,1989,5,910,14.0,642.0,642.0,5,1079,14.0,811.0,811.0
0.005,6,10,1990,5,928,1.0,660.0,660.0,5,1062,1.0,794.0,794.0
0.065,6,10,1506,5,395,14.0,127.0,127.0,5,1111,14.0,843.0,843.0
0.001,17,2,136,1,60,0.0,32.0,32.0,1,76,0.0,48.0,48.0
0.014,6,10,1989,5,910,3.0,642.0,642.0,5,1079,3.0,811.0,811.0
0.004,6,10,1702,5,863,1.0,595.0,595.0,5,839,1.0,571.0,571.0
0.006,17,2,166,1,75,0.0,47.0,47.0,1,91,0.0,63.0,63.0
0.017,6,10,1990,5,911,4.0,643.0,643.0,5,1079,4.0,811.0,811.0
0.205,6,16,2777,8,1395,29.0,533.0,323.0,8,1382,18.0,529.0,239.0
40.065,17,10,676,5,460,10013.0,104.0,64.0,5,216,10015.0,20.0,15.0
0.004,6,10,1702,5,863,1.0,595.0,595.0,5,839,1.0,571.0,571.0
0.001,17,2,180,1,66,0.0,38.0,38.0,1,114,0.0,86.0,86.0
0.005,6,10,2000,5,927,1.0,659.0,659.0,5,1073,1.0,805.0,805.0
240.093,6,32,9637,16,7208,16006.0,2279.0,708.0,16,2429,16006.0,580.0,198.0
0.003,17,2,148,1,60,0.0,32.0,32.0,1,88,0.0,60.0,60.0
0.014,6,10,1972,5,910,3.0,642.0,642.0,5,1062,3.0,794.0,794.0
0.131,6,10,1506,5,395,28.0,127.0,127.0,5,1111,30.0,843.0,843.0
0.073,6,10,1506,5,395,16.0,127.0,127.0,5,1111,16.0,843.0,843.0
0.003,17,2,136,1,60,0.0,32.0,32.0,1,76,0.0,48.0,48.0
0.006,6,10,1689,5,839,1.0,571.0,571.0,5,850,1.0,582.0,582.0
0.058,6,10,1506,5,395,12.0,127.0,127.0,5,1111,14.0,843.0,843.0
0.009,6,10,1989,5,927,2.0,659.0,659.0,5,1062,2.0,794.0,794.0
40.087,17,10,676,5,460,10020.0,104.0,64.0,5,216,10020.0,20.0,15.0
0.004,6,10,1702,5,863,1.0,595.0,595.0,5,839,0.0,571.0,571.0
0.013,6,10,1983,5,910,3.0,642.0,642.0,5,1073,3.0,805.0,805.0
0.17,6,3,453,2,321,170.0,241.0,241.0,1,132,0.0,92.0,92.0
0.124,6,10,1506,5,395,30.0,127.0,127.0,5,1111,25.0,843.0,843.0
0.006,6,10,1547,5,764,1.0,496.0,496.0,5,783,1.0,515.0,515.0
0.004,6,10,1774,5,923,1.0,655.0,655.0,5,851,1.0,583.0,583.0
0.082,6,10,1506,5,395,18.0,127.0,127.0,5,1111,19.0,843.0,843.0
40.063,17,10,676,5,460,10012.0,104.0,64.0,5,216,10015.0,20.0,15.0
0.006,17,2,179,1,71,0.0,43.0,43.0,1,108,0.0,80.0,80.0
0.006,6,10,1547,5,764,1.0,496.0,496.0,5,783,1.0,515.0,515.0
0.211,6,16,2777,8,1395,30.0,533.0,323.0,8,1382,19.0,529.0,239.0
15.093,17,14,9191,8,6902,2152.0,1350.0,834.0,6,2289,3009.0,1350.0,353.0
0.005,6,10,2007,5,928,1.0,660.0,660.0,5,1079,1.0,811.0,811.0
0.004,6,10,1774,5,923,1.0,655.0,655.0,5,851,0.0,583.0,583.0
0.005,17,2,140,1,62,0.0,34.0,34.0,1,78,0.0,50.0,50.0
0.004,6,10,2000,5,927,1.0,659.0,659.0,5,1073,1.0,805.0,805.0
0.072,17,2,412,1,61,0.0,33.0,33.0,1,351,0.0,323.0,323.0
0.167,17,2,152,1,76,0.0,48.0,48.0,1,76,0.0,48.0,48.0
0.015,6,10,1972,5,910,3.0,642.0,642.0,5,1062,3.0,794.0,794.0
10.753,17,28,4421,14,1994,818.0,269.0,114.0,14,2427,818.0,586.0,145.0
0.013,6,10,1983,5,910,3.0,642.0,642.0,5,1073,3.0,805.0,805.0
0.112,6,10,1506,5,395,24.0,127.0,127.0,5,1111,23.0,843.0,843.0
521.356,6,26,4955,14,2479,40104.0,676.0,348.0,12,2476,41940.0,824.0,307.0
0.011,6,10,1989,5,910,2.0,642.0,642.0,5,1079,2.0,811.0,811.0
0.09,6,10,1506,5,395,21.0,127.0,127.0,5,1111,16.0,843.0,843.0
0.007,6,10,1689,5,839,1.0,571.0,571.0,5,850,1.0,582.0,582.0
300.316,6,16,2170,9,684,37518.0,146.0,146.0,7,1486,50024.0,419.0,398.0
0.072,17,4,284,2,120,0.0,32.0,32.0,2,164,69.0,60.0,54.0
0.039,6,10,1972,5,910,9.0,642.0,642.0,5,1062,9.0,794.0,794.0
0.005,6,10,2006,5,927,1.0,659.0,659.0,5,1079,1.0,811.0,811.0
0.816,6,10,937,6,427,163.0,107.0,107.0,4,510,181.0,294.0,294.0
0.016,6,10,1631,5,848,4.0,580.0,580.0,5,783,4.0,515.0,515.0
0.011,6,10,1990,5,911,2.0,643.0,643.0,5,1079,2.0,811.0,811.0
0.01,6,10,1972,5,910,2.0,642.0,642.0,5,1062,2.0,794.0,794.0
0.004,6,10,1989,5,927,1.0,659.0,659.0,5,1062,1.0,794.0,794.0
1795.042,6,311,51046,128,30737,14134.0,2720.0,255.0,183,20309,9862.0,1360.0,149.0
0.005,6,10,2006,5,927,1.0,659.0,659.0,5,1079,1.0,811.0,811.0
0.026,6,10,1972,5,910,6.0,642.0,642.0,5,1062,6.0,794.0,794.0
0.09,6,10,1506,5,395,17.0,127.0,127.0,5,1111,19.0,843.0,843.0
0.005,17,2,144,1,64,0.0,36.0,36.0,1,80,0.0,52.0,52.0
0.005,6,10,1702,5,863,1.0,595.0,595.0,5,839,1.0,571.0,571.0
10.92,17,28,4395,14,2312,832.0,587.0,137.0,14,2083,831.0,270.0,120.0
0.001,17,2,180,1,66,0.0,38.0,38.0,1,114,0.0,86.0,86.0
15.073,17,15,9238,8,6902,2149.0,1350.0,834.0,7,2336,2507.0,1350.0,305.0
10.793,17,28,4417,14,1993,821.0,268.0,114.0,14,2424,821.0,587.0,145.0
0.083,6,10,1506,5,395,17.0,127.0,127.0,5,1111,19.0,843.0,843.0
240.097,6,32,9299,16,6759,16006.0,1831.0,659.0,16,2540,16006.0,580.0,212.0
0.006,6,10,1547,5,764,1.0,496.0,496.0,5,783,1.0,515.0,515.0
0.034,17,2,152,1,76,0.0,48.0,48.0,1,76,0.0,48.0,48.0
0.015,6,10,1989,5,910,3.0,642.0,642.0,5,1079,3.0,811.0,811.0
0.004,6,10,1702,5,863,1.0,595.0,595.0,5,839,0.0,571.0,571.0
0.012,6,13,3735,7,497,2.0,125.0,125.0,6,3238,2.0,1470.0,1459.0
0.005,6,10,2007,5,928,1.0,660.0,660.0,5,1079,1.0,811.0,811.0
308.235,17,20,1124,10,716,34241.0,48.0,43.0,10,408,34241.0,20.0,12.0
0.133,6,10,1506,5,395,31.0,127.0,127.0,5,1111,27.0,843.0,843.0
77.955,6,22,8497,12,2236,70.0,1345.0,574.0,10,6261,8642.0,2720.0,974.0
0.037,17,2,182,1,65,0.0,37.0,37.0,1,117,0.0,89.0,89.0
308.415,17,20,1124,10,716,34252.0,48.0,43.0,10,408,34253.0,20.0,12.0
0.084,6,10,1506,5,395,17.0,127.0,127.0,5,1111,18.0,843.0,843.0
0.066,17,8,3613,4,1874,22.0,1350.0,440.0,4,1739,11.0,1350.0,406.0
0.012,6,10,1983,5,910,3.0,642.0,642.0,5,1073,3.0,805.0,805.0
0.037,17,2,144,1,64,0.0,36.0,36.0,1,80,0.0,52.0,52.0
0.006,6,10,1547,5,764,1.0,496.0,496.0,5,783,1.0,515.0,515.0
0.001,17,2,180,1,66,0.0,38.0,38.0,1,114,0.0,86.0,86.0
0.129,6,10,1506,5,395,18.0,127.0,127.0,5,1111,29.0,843.0,843.0
0.004,6,10,2000,5,927,1.0,659.0,659.0,5,1073,1.0,805.0,805.0
40.083,17,10,676,5,460,10018.0,104.0,64.0,5,216,10019.0,20.0,15.0
0.004,17,2,136,1,60,0.0,32.0,32.0,1,76,0.0,48.0,48.0
0.005,6,10,2007,5,928,1.0,660.0,660.0,5,1079,1.0,811.0,811.0
0.004,6,10,2006,5,927,1.0,659.0,659.0,5,1079,1.0,811.0,811.0
0.009,6,10,1983,5,910,2.0,642.0,642.0,5,1073,2.0,805.0,805.0
0.018,6,10,1989,5,910,4.0,642.0,642.0,5,1079,4.0,811.0,811.0
0.22,6,10,1506,5,395,40.0,127.0,127.0,5,1111,39.0,843.0,843.0
0.01,6,10,1983,5,910,2.0,642.0,642.0,5,1073,2.0,805.0,805.0
0.077,6,10,1506,5,395,17.0,127.0,127.0,5,1111,16.0,843.0,843.0
15.32,17,47,28015,28,24866,567.0,1350.0,860.0,19,3149,849.0,1350.0,137.0
40.045,17,10,676,5,460,10010.0,104.0,64.0,5,216,10010.0,20.0,15.0
0.01,6,10,1989,5,910,2.0,642.0,642.0,5,1079,2.0,811.0,811.0
178.053,17,80,11364,40,2673,4565.0,44.0,38.0,40,8691,4565.0,239.0,189.0
0.017,6,10,1983,5,910,4.0,642.0,642.0,5,1073,4.0,805.0,805.0
0.004,6,10,1989,5,927,1.0,659.0,659.0,5,1062,1.0,794.0,794.0
0.004,6,10,2007,5,928,1.0,660.0,660.0,5,1079,1.0,811.0,811.0
0.069,17,2,136,1,60,0.0,32.0,32.0,1,76,0.0,48.0,48.0
0.01,6,10,1983,5,910,2.0,642.0,642.0,5,1073,2.0,805.0,805.0
309.391,17,20,1124,10,716,34370.0,48.0,43.0,10,408,34370.0,20.0,12.0
0.015,6,10,1990,5,911,3.0,643.0,643.0,5,1079,3.0,811.0,811.0
0.005,6,10,1643,5,860,1.0,592.0,592.0,5,783,1.0,515.0,515.0
0.004,6,10,2006,5,927,1.0,659.0,659.0,5,1079,1.0,811.0,811.0
0.009,6,10,1983,5,910,2.0,642.0,642.0,5,1073,2.0,805.0,805.0
0.175,17,2,152,1,76,0.0,48.0,48.0,1,76,0.0,48.0,48.0
369.821,6,24,2405,17,919,23113.0,195.0,195.0,7,1486,3906.0,419.0,398.0
0.005,17,2,170,1,65,0.0,37.0,37.0,1,105,0.0,77.0,77.0
0.011,17,4,284,2,120,0.0,32.0,32.0,2,164,1.0,60.0,54.0
0.01,6,10,1631,5,848,2.0,580.0,580.0,5,783,2.0,515.0,515.0
0.086,6,10,1506,5,395,19.0,127.0,127.0,5,1111,18.0,843.0,843.0
0.006,6,10,2007,5,928,1.0,660.0,660.0,5,1079,1.0,811.0,811.0
0.076,6,10,1506,5,395,15.0,127.0,127.0,5,1111,17.0,843.0,843.0
0.005,6,10,2006,5,927,1.0,659.0,659.0,5,1079,1.0,811.0,811.0
0.004,6,10,1779,5,928,1.0,660.0,660.0,5,851,1.0,583.0,583.0
0.001,17,2,179,1,62,0.0,34.0,34.0,1,117,0.0,89.0,89.0
171.103,17,76,10804,38,2538,4624.0,44.0,38.0,38,8266,4624.0,239.0,189.0
0.023,6,10,1677,5,827,5.0,559.0,559.0,5,850,5.0,582.0,582.0
0.001,17,2,179,1,62,0.0,34.0,34.0,1,117,0.0,89.0,89.0
0.039,17,4,284,2,120,1.0,32.0,32.0,2,164,35.0,60.0,54.0
0.005,6,10,1854,5,889,1.0,621.0,621.0,5,965,1.0,697.0,697.0
0.099,6,10,1506,5,395,23.0,127.0,127.0,5,1111,20.0,843.0,843.0
0.011,6,10,1631,5,848,2.0,580.0,580.0,5,783,2.0,515.0,515.0
0.005,17,2,213,1,69,0.0,41.0,41.0,1,144,0.0,116.0,116.0
0.012,6,10,1989,5,910,3.0,642.0,642.0,5,1079,2.0,811.0,811.0
1745.919,6,467,67477,261,35976,6715.0,613.0,193.0,206,31501,8516.0,469.0,143.0
0.001,17,2,136,1,60,0.0,32.0,32.0,1,76,0.0,48.0,48.0
0.088,6,10,1506,5,395,20.0,127.0,127.0,5,1111,17.0,843.0,843.0
40.067,17,10,676,5,460,10016.0,104.0,64.0,5,216,10016.0,20.0,15.0
0.001,17,2,136,1,60,0.0,32.0,32.0,1,76,0.0,48.0,48.0
0.011,6,10,1989,5,910,2.0,642.0,642.0,5,1079,2.0,811.0,811.0
0.01,6,10,1989,5,910,2.0,642.0,642.0,5,1079,2.0,811.0,811.0
0.005,6,10,1989,5,927,1.0,659.0,659.0,5,1062,1.0,794.0,794.0
0.07,6,10,1506,5,395,17.0,127.0,127.0,5,1111,15.0,843.0,843.0
9.036,17,6,376,5,280,2259.0,28.0,28.0,1,96,0.0,68.0,68.0
0.234,6,16,2778,8,1396,33.0,533.0,324.0,8,1382,21.0,529.0,239.0
0.008,6,10,1990,5,911,2.0,643.0,643.0,5,1079,2.0,811.0,811.0
0.072,17,2,148,1,60,0.0,32.0,32.0,1,88,0.0,60.0,60.0
0.005,6,10,1643,5,860,1.0,592.0,592.0,5,783,1.0,515.0,515.0
0.089,6,10,1506,5,395,19.0,127.0,127.0,5,1111,18.0,843.0,843.0
0.015,6,10,1990,5,911,3.0,643.0,643.0,5,1079,3.0,811.0,811.0
0.006,17,2,293,1,73,0.0,45.0,45.0,1,220,0.0,192.0,192.0
0.037,17,4,284,2,120,0.0,32.0,32.0,2,164,33.0,60.0,54.0
0.005,6,10,2006,5,927,1.0,659.0,659.0,5,1079,1.0,811.0,811.0
0.009,6,10,1989,5,910,2.0,642.0,642.0,5,1079,2.0,811.0,811.0
40.073,17,10,676,5,460,10015.0,104.0,64.0,5,216,10017.0,20.0,15.0
0.003,17,2,185,1,73,0.0,45.0,45.0,1,112,0.0,84.0,84.0
1795.53,6,280,26015,141,9197,12825.0,748.0,263.0,139,16818,13010.0,1625.0,72.0
11.044,17,28,4395,14,2313,840.0,588.0,137.0,14,2082,840.0,269.0,120.0
40.056,17,10,676,5,460,10010.0,104.0,64.0,5,216,10013.0,20.0,15.0
0.012,6,10,1631,5,848,2.0,580.0,580.0,5,783,3.0,515.0,515.0
0.012,17,2,169,1,62,0.0,34.0,34.0,1,107,0.0,79.0,79.0
0.105,6,10,1506,5,395,24.0,127.0,127.0,5,1111,21.0,843.0,843.0
0.096,6,10,1506,5,395,21.0,127.0,127.0,5,1111,20.0,843.0,843.0
0.004,6,10,2006,5,927,1.0,659.0,659.0,5,1079,1.0,811.0,811.0
0.005,6,10,2007,5,928,1.0,660.0,660.0,5,1079,1.0,811.0,811.0
0.144,6,10,1506,5,395,32.0,127.0,127.0,5,1111,33.0,843.0,843.0
0.008,6,10,1972,5,910,1.0,642.0,642.0,5,1062,1.0,794.0,794.0
0.005,6,10,2006,5,927,1.0,659.0,659.0,5,1079,1.0,811.0,811.0
0.004,6,10,1702,5,863,1.0,595.0,595.0,5,839,1.0,571.0,571.0
1770.318,17,92,8096,46,4048,39340.0,60.0,60.0,46,4048,39340.0,60.0,60.0
0.004,6,15,3794,8,504,0.0,80.0,80.0,7,3290,0.0,1448.0,972.0
0.184,17,16,8400,9,6007,23.0,1350.0,639.0,7,2393,19.0,1350.0,313.0
0.011,6,12,1926,6,1189,2.0,659.0,434.0,6,737,2.0,417.0,417.0
171.388,17,74,10806,37,2465,4760.0,44.0,38.0,37,8341,4760.0,261.0,197.0
0.008,6,10,1990,5,911,2.0,643.0,643.0,5,1079,2.0,811.0,811.0
0.015,6,10,1990,5,911,3.0,643.0,643.0,5,1079,3.0,811.0,811.0
0.003,17,2,148,1,60,0.0,32.0,32.0,1,88,0.0,60.0,60.0
0.122,6,10,1506,5,395,28.0,127.0,127.0,5,1111,27.0,843.0,843.0
0.008,6,12,1926,6,1189,1.0,659.0,434.0,6,737,1.0,417.0,417.0
0.284,17,4,596,2,122,152.0,33.0,33.0,2,474,237.0,323.0,209.0
0.004,6,10,2006,5,927,1.0,659.0,659.0,5,1079,1.0,811.0,811.0
0.386,17,17,10021,8,6917,55.0,1350.0,836.0,9,3104,39.0,1350.0,316.0
0.005,6,14,3799,7,509,0.0,137.0,137.0,7,3290,0.0,1448.0,972.0
0.056,6,10,1506,5,395,12.0,127.0,127.0,5,1111,13.0,843.0,843.0
11.025,17,28,4364,14,2311,839.0,586.0,137.0,14,2053,839.0,268.0,118.0
0.004,6,10,2006,5,927,1.0,659.0,659.0,5,1079,1.0,811.0,811.0
353.667,6,20,2210,6,1308,12005.0,494.0,494.0,14,902,27204.0,83.0,83.0
309.934,17,19,1084,10,716,34423.0,48.0,43.0,9,368,38725.0,20.0,12.0
0.005,17,2,179,1,71,0.0,43.0,43.0,1,108,0.0,80.0,80.0
0.008,6,10,1990,5,911,2.0,643.0,643.0,5,1079,2.0,811.0,811.0
0.011,6,10,1762,5,911,2.0,643.0,643.0,5,851,2.0,583.0,583.0
0.038,17,2,186,1,61,0.0,33.0,33.0,1,125,0.0,97.0,97.0
97.138,6,22,7437,11,1305,104.0,530.0,277.0,11,6132,9696.0,2720.0,946.0
0.028,6,13,3816,7,578,4.0,206.0,206.0,6,3238,5.0,1470.0,1459.0
0.005,17,2,230,1,68,0.0,40.0,40.0,1,162,0.0,134.0,134.0
0.016,6,10,1990,5,911,4.0,643.0,643.0,5,1079,3.0,811.0,811.0
0.01,6,10,1989,5,910,2.0,642.0,642.0,5,1079,2.0,811.0,811.0
0.009,6,10,1677,5,827,2.0,559.0,559.0,5,850,2.0,582.0,582.0
0.004,17,2,136,1,60,0.0,32.0,32.0,1,76,0.0,48.0,48.0
0.012,6,10,1631,5,848,2.0,580.0,580.0,5,783,2.0,515.0,515.0
0.004,6,10,2000,5,927,1.0,659.0,659.0,5,1073,1.0,805.0,805.0
0.215,6,16,2669,8,1395,30.0,533.0,323.0,8,1274,19.0,529.0,212.0
0.012,6,10,1762,5,911,2.0,643.0,643.0,5,851,2.0,583.0,583.0
0.007,6,10,1989,5,910,1.0,642.0,642.0,5,1079,1.0,811.0,811.0
0.259,17,38,20170,21,17041,12.0,1350.0,783.0,17,3129,12.0,1350.0,156.0
0.005,17,2,170,1,65,0.0,37.0,37.0,1,105,0.0,77.0,77.0
0.004,6,10,1989,5,927,1.0,659.0,659.0,5,1062,1.0,794.0,794.0
40.066,17,10,676,5,460,10013.0,104.0,64.0,5,216,10015.0,20.0,15.0
0.005,6,10,2006,5,927,1.0,659.0,659.0,5,1079,1.0,811.0,811.0
0.124,6,10,1506,5,395,25.0,127.0,127.0,5,1111,27.0,843.0,843.0
40.065,17,10,676,5,460,10014.0,104.0,64.0,5,216,10013.0,20.0,15.0
0.003,17,2,208,1,72,0.0,44.0,44.0,1,136,0.0,108.0,108.0
0.054,17,2,152,1,76,0.0,48.0,48.0,1,76,0.0,48.0,48.0
0.001,17,2,136,1,60,0.0,32.0,32.0,1,76,0.0,48.0,48.0
0.009,6,12,1926,6,1189,1.0,659.0,434.0,6,737,1.0,417.0,417.0
40.06,17,10,676,5,460,10014.0,104.0,64.0,5,216,10014.0,20.0,15.0
0.074,6,10,1506,5,395,14.0,127.0,127.0,5,1111,16.0,843.0,843.0
0.108,6,10,1506,5,395,22.0,127.0,127.0,5,1111,25.0,843.0,843.0
0.08,6,10,1506,5,395,17.0,127.0,127.0,5,1111,19.0,843.0,843.0
0.014,6,14,3787,7,497,2.0,125.0,125.0,7,3290,2.0,1448.0,972.0
0.077,6,10,1506,5,395,16.0,127.0,127.0,5,1111,17.0,843.0,843.0
11.165,17,28,4418,14,1994,846.0,269.0,114.0,14,2424,846.0,587.0,145.0
40.068,17,10,676,5,460,10016.0,104.0,64.0,5,216,10016.0,20.0,15.0
0.077,6,10,1506,5,395,18.0,127.0,127.0,5,1111,17.0,843.0,843.0
0.007,6,10,1643,5,860,1.0,592.0,592.0,5,783,1.0,515.0,515.0
0.011,6,10,1989,5,910,2.0,642.0,642.0,5,1079,2.0,811.0,811.0
0.001,17,2,180,1,66,0.0,38.0,38.0,1,114,0.0,86.0,86.0
0.08,6,10,1506,5,395,16.0,127.0,127.0,5,1111,18.0,843.0,843.0
0.013,6,10,1762,5,911,3.0,643.0,643.0,5,851,3.0,583.0,583.0
0.001,17,2,180,1,66,0.0,38.0,38.0,1,114,0.0,86.0,86.0
0.01,6,10,1774,5,923,2.0,655.0,655.0,5,851,2.0,583.0,583.0
240.022,6,9,787,5,488,60005.0,232.0,232.0,4,299,80006.0,83.0,83.0
0.041,17,2,184,1,61,0.0,33.0,33.0,1,123,0.0,95.0,95.0
0.161,6,10,1506,5,395,39.0,127.0,127.0,5,1111,37.0,843.0,843.0
0.004,17,2,136,1,60,0.0,32.0,32.0,1,76,0.0,48.0,48.0
0.011,17,2,262,1,67,0.0,39.0,39.0,1,195,0.0,167.0,167.0
0.007,6,10,1779,5,928,1.0,660.0,660.0,5,851,1.0,583.0,583.0
0.004,6,10,1702,5,863,0.0,595.0,595.0,5,839,1.0,571.0,571.0
176.483,17,84,11594,42,2812,4304.0,44.0,38.0,42,8782,4304.0,261.0,181.0
11.014,17,28,4418,14,1994,838.0,269.0,114.0,14,2424,838.0,587.0,145.0
0.005,17,2,144,1,64,0.0,36.0,36.0,1,80,0.0,52.0,52.0
0.096,6,10,1506,5,395,20.0,127.0,127.0,5,1111,21.0,843.0,843.0
40.056,17,10,676,5,460,10013.0,104.0,64.0,5,216,10013.0,20.0,15.0
0.006,17,2,164,1,74,0.0,46.0,46.0,1,90,0.0,62.0,62.0
0.001,17,2,136,1,60,0.0,32.0,32.0,1,76,0.0,48.0,48.0
40.072,17,10,676,5,460,10015.0,104.0,64.0,5,216,10017.0,20.0,15.0
0.043,17,2,152,1,76,0.0,48.0,48.0,1,76,0.0,48.0,48.0
0.018,6,10,1990,5,911,4.0,643.0,643.0,5,1079,4.0,811.0,811.0
40.067,17,10,676,5,460,10015.0,104.0,64.0,5,216,10016.0,20.0,15.0
0.154,17,4,352,2,130,83.0,37.0,37.0,2,222,82.0,89.0,83.0
0.005,6,10,2006,5,927,1.0,659.0,659.0,5,1079,1.0,811.0,811.0
0.007,6,10,1643,5,860,1.0,592.0,592.0,5,783,1.0,515.0,515.0
241.335,6,384,347701,208,22343,1165.0,2736.0,886.0,176,325358,1379.0,2804.0,1916.0
240.118,6,31,9437,15,7008,17151.0,2133.0,692.0,16,2429,16007.0,580.0,198.0
0.059,17,2,152,1,76,0.0,48.0,48.0,1,76,0.0,48.0,48.0
0.092,6,10,1506,5,395,19.0,127.0,127.0,5,1111,18.0,843.0,843.0
0.005,6,10,1689,5,839,1.0,571.0,571.0,5,850,1.0,582.0,582.0
0.012,6,10,1983,5,910,3.0,642.0,642.0,5,1073,3.0,805.0,805.0
0.004,6,10,2007,5,928,1.0,660.0,660.0,5,1079,1.0,811.0,811.0
412.252,6,29,4409,12,3102,10911.0,494.0,494.0,17,1307,25765.0,83.0,83.0
0.005,6,10,2006,5,927,1.0,659.0,659.0,5,1079,1.0,811.0,811.0
0.005,6,10,1989,5,927,1.0,659.0,659.0,5,1062,1.0,794.0,794.0
0.006,6,10,1547,5,764,1.0,496.0,496.0,5,783,1.0,515.0,515.0
322.729,17,20,1124,10,716,35845.0,48.0,43.0,10,408,35845.0,20.0,12.0
0.04,17,2,184,1,61,0.0,33.0,33.0,1,123,0.0,95.0,95.0
0.012,6,10,1983,5,910,3.0,642.0,642.0,5,1073,3.0,805.0,805.0
0.008,6,10,1989,5,910,2.0,642.0,642.0,5,1079,2.0,811.0,811.0
0.006,6,10,1643,5,860,1.0,592.0,592.0,5,783,1.0,515.0,515.0
0.02,6,10,1972,5,910,5.0,642.0,642.0,5,1062,4.0,794.0,794.0
0.015,6,14,3787,7,497,2.0,125.0,125.0,7,3290,2.0,1448.0,972.0
15.129,17,19,13455,10,8344,1678.0,1350.0,806.0,9,5111,1887.0,1350.0,539.0
0.042,17,2,152,1,76,0.0,48.0,48.0,1,76,0.0,48.0,48.0
40.09,17,10,676,5,460,10019.0,104.0,64.0,5,216,10021.0,20.0,15.0
0.07,17,2,152,1,76,0.0,48.0,48.0,1,76,0.0,48.0,48.0
0.006,17,4,284,2,120,1.0,32.0,32.0,2,164,0.0,60.0,54.0
9.037,17,6,376,5,280,2259.0,28.0,28.0,1,96,0.0,68.0,68.0
0.011,6,10,1990,5,911,2.0,643.0,643.0,5,1079,2.0,811.0,811.0
0.005,6,10,2000,5,927,1.0,659.0,659.0,5,1073,1.0,805.0,805.0
0.127,17,2,136,1,60,0.0,32.0,32.0,1,76,0.0,48.0,48.0
0.009,6,10,1631,5,848,2.0,580.0,580.0,5,783,2.0,515.0,515.0
0.013,6,10,1989,5,910,3.0,642.0,642.0,5,1079,3.0,811.0,811.0
0.004,6,10,1774,5,923,1.0,655.0,655.0,5,851,1.0,583.0,583.0
0.006,6,10,1547,5,764,1.0,496.0,496.0,5,783,1.0,515.0,515.0
0.114,6,10,1506,5,395,27.0,127.0,127.0,5,1111,25.0,843.0,843.0
10.896,17,28,4422,14,1993,829.0,268.0,114.0,14,2429,829.0,588.0,145.0
0.01,6,13,3735,7,497,1.0,125.0,125.0,6,3238,1.0,1470.0,1459.0
0.008,6,10,1989,5,927,2.0,659.0,659.0,5,1062,2.0,794.0,794.0
0.004,6,10,1702,5,863,1.0,595.0,595.0,5,839,1.0,571.0,571.0
0.009,6,14,3787,7,497,1.0,125.0,125.0,7,3290,1.0,1448.0,972.0
0.042,17,2,152,1,76,0.0,48.0,48.0,1,76,0.0,48.0,48.0
0.004,17,2,148,1,60,0.0,32.0,32.0,1,88,0.0,60.0,60.0
0.071,6,10,1506,5,395,15.0,127.0,127.0,5,1111,16.0,843.0,843.0
0.014,6,10,1972,5,910,3.0,642.0,642.0,5,1062,3.0,794.0,794.0
0.005,17,2,293,1,73,0.0,45.0,45.0,1,220,0.0,192.0,192.0
0.076,6,10,1506,5,395,16.0,127.0,127.0,5,1111,14.0,843.0,843.0
0.089,6,10,1506,5,395,20.0,127.0,127.0,5,1111,18.0,843.0,843.0
356.565,6,21,1795,16,1030,23771.0,190.0,190.0,5,765,60003.0,464.0,248.0
366.171,6,22,2313,16,867,24411.0,195.0,195.0,6,1446,4635.0,419.0,398.0
0.003,17,2,136,1,60,0.0,32.0,32.0,1,76,0.0,48.0,48.0
0.005,6,13,3747,7,509,0.0,137.0,137.0,6,3238,1.0,1470.0,1459.0
0.005,17,2,234,1,61,0.0,33.0,33.0,1,173,0.0,145.0,145.0
0.006,6,10,2007,5,928,1.0,660.0,660.0,5,1079,1.0,811.0,811.0
0.003,17,4,284,2,120,0.0,32.0,32.0,2,164,0.0,60.0,54.0
1752.226,6,64,7361,42,4485,42737.0,1641.0,109.0,22,2876,83431.0,1112.0,82.0
0.078,6,10,1506,5,395,18.0,127.0,127.0,5,1111,16.0,843.0,843.0
0.005,6,10,2007,5,928,1.0,660.0,660.0,5,1079,1.0,811.0,811.0
40.055,17,10,676,5,460,10012.0,104.0,64.0,5,216,10012.0,20.0,15.0
0.005,6,10,2006,5,927,1.0,659.0,659.0,5,1079,1.0,811.0,811.0
0.004,6,10,1702,5,863,0.0,595.0,595.0,5,839,1.0,571.0,571.0
0.007,6,10,1989,5,910,1.0,642.0,642.0,5,1079,1.0,811.0,811.0
0.009,6,10,1990,5,911,2.0,643.0,643.0,5,1079,2.0,811.0,811.0
0.005,6,10,1689,5,839,1.0,571.0,571.0,5,850,1.0,582.0,582.0
0.009,6,10,1990,5,911,2.0,643.0,643.0,5,1079,2.0,811.0,811.0
0.005,6,14,3799,7,509,0.0,137.0,137.0,7,3290,0.0,1448.0,972.0
0.016,6,10,1983,5,910,3.0,642.0,642.0,5,1073,4.0,805.0,805.0
0.08,6,10,1506,5,395,18.0,127.0,127.0,5,1111,17.0,843.0,843.0
11.024,17,28,4423,14,1995,839.0,270.0,114.0,14,2428,839.0,587.0,145.0
40.073,17,10,676,5,460,10017.0,104.0,64.0,5,216,10017.0,20.0,15.0
0.006,6,10,1989,5,927,1.0,659.0,659.0,5,1062,1.0,794.0,794.0
0.005,6,10,2006,5,927,1.0,659.0,659.0,5,1079,1.0,811.0,811.0
0.035,6,10,1762,5,911,8.0,643.0,643.0,5,851,8.0,583.0,583.0
0.005,6,10,2006,5,927,1.0,659.0,659.0,5,1079,1.0,811.0,811.0
0.004,6,10,1774,5,923,1.0,655.0,655.0,5,851,1.0,583.0,583.0
0.007,6,10,2006,5,927,1.0,659.0,659.0,5,1079,1.0,811.0,811.0
0.006,6,10,1702,5,863,1.0,595.0,595.0,5,839,1.0,571.0,571.0
0.008,6,10,1989,5,910,2.0,642.0,642.0,5,1079,1.0,811.0,811.0
0.001,17,2,180,1,66,0.0,38.0,38.0,1,114,0.0,86.0,86.0
1770.599,17,120,11460,60,5460,30009.0,63.0,63.0,60,6000,30009.0,72.0,72.0
0.091,6,10,1506,5,395,20.0,127.0,127.0,5,1111,19.0,843.0,843.0
15.134,17,18,9879,9,6331,1888.0,1350.0,675.0,9,3548,1888.0,1350.0,366.0
0.005,6,10,2006,5,927,1.0,659.0,659.0,5,1079,1.0,811.0,811.0
0.005,6,13,3690,7,452,0.0,80.0,80.0,6,3238,1.0,1470.0,1459.0
0.023,6,10,1990,5,911,5.0,643.0,643.0,5,1079,5.0,811.0,811.0
0.006,17,2,164,1,74,0.0,46.0,46.0,1,90,0.0,62.0,62.0
40.07,17,10,676,5,460,10016.0,104.0,64.0,5,216,10016.0,20.0,15.0
0.01,6,13,3735,7,497,1.0,125.0,125.0,6,3238,2.0,1470.0,1459.0
310.943,17,18,1008,9,640,38852.0,48.0,43.0,9,368,38852.0,20.0,12.0
0.079,6,10,1506,5,395,17.0,127.0,127.0,5,1111,17.0,843.0,843.0
0.102,6,10,1506,5,395,22.0,127.0,127.0,5,1111,24.0,843.0,843.0
0.12,6,10,1506,5,395,27.0,127.0,127.0,5,1111,27.0,843.0,843.0
0.013,6,10,1972,5,910,3.0,642.0,642.0,5,1062,3.0,794.0,794.0
0.007,6,10,1547,5,764,1.0,496.0,496.0,5,783,1.0,515.0,515.0
0.003,17,2,136,1,60,0.0,32.0,32.0,1,76,0.0,48.0,48.0
0.08,17,2,144,1,64,0.0,36.0,36.0,1,80,0.0,52.0,52.0
0.006,17,2,136,1,60,0.0,32.0,32.0,1,76,0.0,48.0,48.0
368.639,6,22,2313,16,867,24575.0,195.0,195.0,6,1446,4634.0,419.0,398.0
300.336,6,17,2222,10,736,33351.0,146.0,146.0,7,1486,50020.0,419.0,398.0
11.043,17,28,4394,14,2313,840.0,588.0,137.0,14,2081,840.0,268.0,120.0
0.017,6,10,1631,5,848,4.0,580.0,580.0,5,783,4.0,515.0,515.0
0.004,6,10,1702,5,863,1.0,595.0,595.0,5,839,0.0,571.0,571.0
10.759,17,28,4417,14,1994,819.0,269.0,114.0,14,2423,819.0,586.0,145.0
0.013,6,10,1989,5,910,3.0,642.0,642.0,5,1079,3.0,811.0,811.0
0.007,17,2,273,1,66,0.0,38.0,38.0,1,207,0.0,179.0,179.0
0.059,6,10,1506,5,395,13.0,127.0,127.0,5,1111,13.0,843.0,843.0
0.006,6,10,1643,5,860,1.0,592.0,592.0,5,783,1.0,515.0,515.0
0.011,6,10,1989,5,910,2.0,642.0,642.0,5,1079,2.0,811.0,811.0
0.006,6,10,1854,5,889,1.0,621.0,621.0,5,965,1.0,697.0,697.0
0.005,6,10,1689,5,839,1.0,571.0,571.0,5,850,1.0,582.0,582.0
0.005,17,2,156,1,70,0.0,42.0,42.0,1,86,0.0,58.0,58.0
0.005,6,10,1779,5,928,1.0,660.0,660.0,5,851,1.0,583.0,583.0
0.005,6,10,1689,5,839,1.0,571.0,571.0,5,850,1.0,582.0,582.0
0.01,6,10,1983,5,910,2.0,642.0,642.0,5,1073,2.0,805.0,805.0
15.072,17,15,9239,8,6902,2149.0,1350.0,834.0,7,2337,2507.0,1350.0,305.0
0.217,6,16,2670,8,1396,31.0,533.0,324.0,8,1274,19.0,529.0,212.0
0.005,6,10,1547,5,764,1.0,496.0,496.0,5,783,1.0,515.0,515.0
0.005,17,2,170,1,65,0.0,37.0,37.0,1,105,0.0,77.0,77.0
0.005,6,10,2006,5,927,1.0,659.0,659.0,5,1079,1.0,811.0,811.0
0.005,6,10,1774,5,923,1.0,655.0,655.0,5,851,1.0,583.0,583.0
0.004,17,4,284,2,120,1.0,32.0,32.0,2,164,1.0,60.0,54.0
51.803,58,5,360,4,288,17267.0,24.0,24.0,1,72,0.0,24.0,24.0
0.008,6,10,1989,5,910,2.0,642.0,642.0,5,1079,2.0,811.0,811.0
0.007,6,10,1689,5,839,1.0,571.0,571.0,5,850,1.0,582.0,582.0
0.005,6,10,2007,5,928,1.0,660.0,660.0,5,1079,1.0,811.0,811.0
0.005,6,10,1547,5,764,1.0,496.0,496.0,5,783,1.0,515.0,515.0
300.987,6,47,17128,25,11221,12541.0,2720.0,1132.0,22,5907,420.0,2667.0,385.0
0.005,6,10,2006,5,927,1.0,659.0,659.0,5,1079,1.0,811.0,811.0
0.004,17,4,284,2,120,1.0,32.0,32.0,2,164,0.0,60.0,54.0
0.006,6,10,1983,5,910,1.0,642.0,642.0,5,1073,1.0,805.0,805.0
0.006,6,10,1854,5,889,1.0,621.0,621.0,5,965,1.0,697.0,697.0
0.089,6,10,1506,5,395,20.0,127.0,127.0,5,1111,18.0,843.0,843.0
0.015,6,10,1983,5,910,3.0,642.0,642.0,5,1073,3.0,805.0,805.0
0.006,6,10,1643,5,860,1.0,592.0,592.0,5,783,1.0,515.0,515.0
0.005,6,10,2006,5,927,1.0,659.0,659.0,5,1079,1.0,811.0,811.0
0.005,6,10,1989,5,927,1.0,659.0,659.0,5,1062,1.0,794.0,794.0
0.025,17,2,179,1,71,0.0,43.0,43.0,1,108,0.0,80.0,80.0
240.155,6,46,6943,22,3223,11435.0,588.0,230.0,24,3720,10441.0,580.0,224.0
0.015,6,10,1972,5,910,3.0,642.0,642.0,5,1062,3.0,794.0,794.0
0.01,6,10,1972,5,910,2.0,642.0,642.0,5,1062,2.0,794.0,794.0
0.005,6,10,1989,5,927,1.0,659.0,659.0,5,1062,1.0,794.0,794.0
0.005,6,10,2006,5,927,1.0,659.0,659.0,5,1079,1.0,811.0,811.0
313.041,17,20,1124,10,716,34767.0,48.0,43.0,10,408,34767.0,20.0,12.0
0.02,6,10,1989,5,910,5.0,642.0,642.0,5,1079,5.0,811.0,811.0
40.052,17,10,676,5,460,10012.0,104.0,64.0,5,216,10012.0,20.0,15.0
0.089,6,10,1506,5,395,20.0,127.0,127.0,5,1111,20.0,843.0,843.0
308.818,17,20,1124,10,716,34292.0,48.0,43.0,10,408,34299.0,20.0,12.0
11.163,17,28,4423,14,1995,846.0,270.0,114.0,14,2428,846.0,587.0,145.0
0.013,17,2,152,1,56,0.0,28.0,28.0,1,96,0.0,68.0,68.0
0.009,6,10,1983,5,910,2.0,642.0,642.0,5,1073,2.0,805.0,805.0
40.061,17,10,676,5,460,10014.0,104.0,64.0,5,216,10014.0,20.0,15.0
0.006,17,2,170,1,65,0.0,37.0,37.0,1,105,0.0,77.0,77.0
0.001,17,2,180,1,66,0.0,38.0,38.0,1,114,0.0,86.0,86.0
0.006,6,10,1689,5,839,1.0,571.0,571.0,5,850,1.0,582.0,582.0
0.102,6,10,1506,5,395,23.0,127.0,127.0,5,1111,24.0,843.0,843.0
0.07,6,10,1506,5,395,15.0,127.0,127.0,5,1111,17.0,843.0,843.0
0.005,6,10,1989,5,927,1.0,659.0,659.0,5,1062,1.0,794.0,794.0
0.005,6,10,2006,5,927,1.0,659.0,659.0,5,1079,1.0,811.0,811.0
0.112,6,10,1506,5,395,24.0,127.0,127.0,5,1111,24.0,843.0,843.0
308.634,17,20,1124,10,716,34280.0,48.0,43.0,10,408,34282.0,20.0,12.0
0.014,6,10,1983,5,910,3.0,642.0,642.0,5,1073,3.0,805.0,805.0
0.068,6,10,1506,5,395,14.0,127.0,127.0,5,1111,15.0,843.0,843.0
0.008,6,10,1990,5,911,1.0,643.0,643.0,5,1079,1.0,811.0,811.0
0.006,17,2,273,1,66,0.0,38.0,38.0,1,207,0.0,179.0,179.0
0.053,6,10,1990,5,911,13.0,643.0,643.0,5,1079,13.0,811.0,811.0
0.012,6,10,1762,5,911,3.0,643.0,643.0,5,851,3.0,583.0,583.0
0.005,6,10,2006,5,927,1.0,659.0,659.0,5,1079,1.0,811.0,811.0
0.015,6,10,1989,5,910,3.0,642.0,642.0,5,1079,3.0,811.0,811.0
0.114,6,10,1506,5,395,27.0,127.0,127.0,5,1111,24.0,843.0,843.0
0.018,6,10,1762,5,911,4.0,643.0,643.0,5,851,4.0,583.0,583.0
0.006,6,10,1547,5,764,1.0,496.0,496.0,5,783,1.0,515.0,515.0
0.004,6,10,1774,5,923,1.0,655.0,655.0,5,851,1.0,583.0,583.0
0.107,6,10,1506,5,395,24.0,127.0,127.0,5,1111,23.0,843.0,843.0
172.372,17,72,10188,36,2394,4924.0,44.0,38.0,36,7794,4924.0,239.0,188.0
0.179,17,2,152,1,76,0.0,48.0,48.0,1,76,0.0,48.0,48.0
0.006,6,10,1547,5,764,1.0,496.0,496.0,5,783,1.0,515.0,515.0
40.07,17,10,676,5,460,10015.0,104.0,64.0,5,216,10016.0,20.0,15.0
0.005,6,10,2006,5,927,1.0,659.0,659.0,5,1079,1.0,811.0,811.0
0.012,6,10,1983,5,910,3.0,642.0,642.0,5,1073,3.0,805.0,805.0
0.008,6,10,1989,5,910,1.0,642.0,642.0,5,1079,2.0,811.0,811.0
0.01,6,10,1989,5,910,2.0,642.0,642.0,5,1079,2.0,811.0,811.0
0.005,6,10,1779,5,928,1.0,660.0,660.0,5,851,1.0,583.0,583.0
0.005,6,10,2006,5,927,1.0,659.0,659.0,5,1079,1.0,811.0,811.0
240.128,6,16,4481,9,963,30016.0,238.0,166.0,7,3518,40020.0,1402.0,786.0
40.057,17,10,676,5,460,10013.0,104.0,64.0,5,216,10013.0,20.0,15.0
0.005,6,10,2000,5,927,1.0,659.0,659.0,5,1073,1.0,805.0,805.0
0.006,6,12,1698,6,863,1.0,327.0,271.0,6,835,1.0,515.0,515.0
40.059,17,10,676,5,460,10013.0,104.0,64.0,5,216,10014.0,20.0,15.0
0.004,6,10,1989,5,927,1.0,659.0,659.0,5,1062,1.0,794.0,794.0
0.008,6,10,1989,5,910,2.0,642.0,642.0,5,1079,2.0,811.0,811.0
0.011,6,10,1983,5,910,2.0,642.0,642.0,5,1073,2.0,805.0,805.0
0.081,6,10,1506,5,395,15.0,127.0,127.0,5,1111,16.0,843.0,843.0
0.095,6,10,1506,5,395,18.0,127.0,127.0,5,1111,21.0,843.0,843.0
0.005,6,13,3690,7,452,0.0,80.0,80.0,6,3238,0.0,1470.0,1459.0
0.009,6,12,1926,6,1189,1.0,659.0,434.0,6,737,1.0,417.0,417.0
0.005,6,10,2000,5,927,1.0,659.0,659.0,5,1073,1.0,805.0,805.0
0.003,17,2,136,1,60,0.0,32.0,32.0,1,76,0.0,48.0,48.0
170.074,17,74,10417,37,2456,4723.0,44.0,38.0,37,7961,4724.0,239.0,187.0
40.068,17,10,676,5,460,10016.0,104.0,64.0,5,216,10016.0,20.0,15.0
0.08,6,10,1506,5,395,17.0,127.0,127.0,5,1111,17.0,843.0,843.0
240.089,6,16,4482,9,963,30011.0,238.0,166.0,7,3519,40014.0,1402.0,786.0
0.011,6,10,1972,5,910,2.0,642.0,642.0,5,1062,2.0,794.0,794.0
0.004,17,2,136,1,60,0.0,32.0,32.0,1,76,0.0,48.0,48.0
0.003,17,2,136,1,60,0.0,32.0,32.0,1,76,0.0,48.0,48.0
0.13,6,10,1506,5,395,30.0,127.0,127.0,5,1111,28.0,843.0,843.0
0.001,17,2,132,1,58,0.0,30.0,30.0,1,74,0.0,46.0,46.0
0.008,6,12,1926,6,1189,1.0,659.0,434.0,6,737,1.0,417.0,417.0
0.068,6,10,1506,5,395,15.0,127.0,127.0,5,1111,15.0,843.0,843.0
0.007,6,10,1702,5,863,1.0,595.0,595.0,5,839,1.0,571.0,571.0
240.09,6,16,4480,9,963,30011.0,238.0,166.0,7,3517,40014.0,1402.0,786.0
300.341,6,16,2170,9,684,37522.0,146.0,146.0,7,1486,50029.0,419.0,398.0
0.004,6,10,1779,5,928,1.0,660.0,660.0,5,851,1.0,583.0,583.0
292.771,6,386,346905,200,21965,1471.0,2736.0,889.0,186,324940,1582.0,3632.0,1832.0
240.089,6,16,4481,9,963,30011.0,238.0,166.0,7,3518,40014.0,1402.0,786.0
0.11,6,10,1506,5,395,25.0,127.0,127.0,5,1111,25.0,843.0,843.0
0.019,6,13,3816,7,578,3.0,206.0,206.0,6,3238,3.0,1470.0,1459.0
0.087,6,10,1506,5,395,19.0,127.0,127.0,5,1111,18.0,843.0,843.0
1799.903,17,2521,189876,1254,100387,1436.0,82.0,52.0,1267,89489,1419.0,226.0,42.0
0.077,6,10,1506,5,395,18.0,127.0,127.0,5,1111,17.0,843.0,843.0
0.005,17,2,170,1,65,0.0,37.0,37.0,1,105,0.0,77.0,77.0
0.087,6,10,1506,5,395,19.0,127.0,127.0,5,1111,18.0,843.0,843.0
0.072,17,4,284,2,120,0.0,32.0,32.0,2,164,34.0,60.0,54.0
0.039,17,2,152,1,76,0.0,48.0,48.0,1,76,0.0,48.0,48.0
0.149,6,10,1506,5,395,33.0,127.0,127.0,5,1111,36.0,843.0,843.0
0.01,6,13,3735,7,497,1.0,125.0,125.0,6,3238,2.0,1470.0,1459.0
0.058,6,10,1989,5,910,14.0,642.0,642.0,5,1079,14.0,811.0,811.0
0.102,6,10,1506,5,395,24.0,127.0,127.0,5,1111,21.0,843.0,843.0
40.065,17,10,676,5,460,10012.0,104.0,64.0,5,216,10015.0,20.0,15.0
240.095,6,16,4482,9,963,30011.0,238.0,166.0,7,3519,40014.0,1402.0,786.0
0.004,17,2,166,1,75,0.0,47.0,47.0,1,91,0.0,63.0,63.0
0.004,6,10,1989,5,927,1.0,659.0,659.0,5,1062,1.0,794.0,794.0
0.04,17,2,170,1,65,0.0,37.0,37.0,1,105,0.0,77.0,77.0
0.008,6,10,1990,5,911,2.0,643.0,643.0,5,1079,2.0,811.0,811.0
0.003,17,4,284,2,120,0.0,32.0,32.0,2,164,0.0,60.0,54.0
0.012,6,13,3735,7,497,2.0,125.0,125.0,6,3238,2.0,1470.0,1459.0
0.005,6,10,2006,5,927,1.0,659.0,659.0,5,1079,1.0,811.0,811.0
0.08,6,10,1506,5,395,16.0,127.0,127.0,5,1111,19.0,843.0,843.0
0.005,6,10,2000,5,927,1.0,659.0,659.0,5,1073,1.0,805.0,805.0
0.001,17,2,180,1,66,0.0,38.0,38.0,1,114,0.0,86.0,86.0
0.012,6,10,1983,5,910,2.0,642.0,642.0,5,1073,3.0,805.0,805.0
0.013,6,10,1990,5,911,3.0,643.0,643.0,5,1079,3.0,811.0,811.0
0.004,17,2,136,1,60,0.0,32.0,32.0,1,76,0.0,48.0,48.0
0.132,17,2,152,1,76,0.0,48.0,48.0,1,76,0.0,48.0,48.0
0.012,6,10,1990,5,911,3.0,643.0,643.0,5,1079,2.0,811.0,811.0
0.004,6,10,2006,5,927,1.0,659.0,659.0,5,1079,1.0,811.0,811.0
0.012,6,10,1762,5,911,3.0,643.0,643.0,5,851,3.0,583.0,583.0
0.006,6,10,2007,5,928,1.0,660.0,660.0,5,1079,1.0,811.0,811.0
0.001,17,2,166,1,75,0.0,47.0,47.0,1,91,0.0,63.0,63.0
0.125,6,10,1506,5,395,28.0,127.0,127.0,5,1111,28.0,843.0,843.0
0.017,6,10,1990,5,911,4.0,643.0,643.0,5,1079,4.0,811.0,811.0
0.082,6,10,1506,5,395,17.0,127.0,127.0,5,1111,18.0,843.0,843.0
0.009,6,10,2006,5,927,2.0,659.0,659.0,5,1079,2.0,811.0,811.0
0.015,6,10,1972,5,910,3.0,642.0,642.0,5,1062,3.0,794.0,794.0
0.037,17,2,148,1,60,0.0,32.0,32.0,1,88,0.0,60.0,60.0
10.762,17,28,4422,14,1994,819.0,269.0,114.0,14,2428,819.0,587.0,145.0
0.015,6,10,1989,5,910,3.0,642.0,642.0,5,1079,3.0,811.0,811.0
0.009,6,14,3787,7,497,1.0,125.0,125.0,7,3290,1.0,1448.0,972.0
0.071,6,10,1506,5,395,15.0,127.0,127.0,5,1111,15.0,843.0,843.0
0.005,6,10,1702,5,863,1.0,595.0,595.0,5,839,1.0,571.0,571.0
308.42,17,20,1124,10,716,34254.0,48.0,43.0,10,408,34254.0,20.0,12.0
0.106,6,10,1506,5,395,25.0,127.0,127.0,5,1111,25.0,843.0,843.0
0.006,6,10,1547,5,764,1.0,496.0,496.0,5,783,1.0,515.0,515.0
240.081,6,16,4480,9,963,30010.0,238.0,166.0,7,3517,40013.0,1402.0,786.0
0.102,6,10,1506,5,395,23.0,127.0,127.0,5,1111,24.0,843.0,843.0
40.049,17,10,676,5,460,10011.0,104.0,64.0,5,216,10011.0,20.0,15.0
0.001,17,2,180,1,66,0.0,38.0,38.0,1,114,0.0,86.0,86.0
0.111,6,10,1506,5,395,26.0,127.0,127.0,5,1111,24.0,843.0,843.0
0.016,6,10,1972,5,910,4.0,642.0,642.0,5,1062,3.0,794.0,794.0
0.005,6,10,1989,5,927,1.0,659.0,659.0,5,1062,1.0,794.0,794.0
0.014,6,10,1989,5,910,3.0,642.0,642.0,5,1079,3.0,811.0,811.0
0.013,6,10,1972,5,910,3.0,642.0,642.0,5,1062,3.0,794.0,794.0
0.012,6,10,1990,5,911,3.0,643.0,643.0,5,1079,2.0,811.0,811.0
0.012,6,10,1972,5,910,3.0,642.0,642.0,5,1062,3.0,794.0,794.0
40.064,17,10,676,5,460,10015.0,104.0,64.0,5,216,10015.0,20.0,15.0
9.039,17,6,376,5,280,2259.0,28.0,28.0,1,96,0.0,68.0,68.0
0.005,6,10,1989,5,927,1.0,659.0,659.0,5,1062,1.0,794.0,794.0
0.011,6,10,1989,5,910,2.0,642.0,642.0,5,1079,2.0,811.0,811.0
0.013,6,10,1989,5,910,3.0,642.0,642.0,5,1079,3.0,811.0,811.0
0.005,17,2,136,1,60,0.0,32.0,32.0,1,76,0.0,48.0,48.0
0.005,17,2,225,1,65,0.0,37.0,37.0,1,160,0.0,132.0,132.0
0.07,17,8,3613,4,1874,23.0,1350.0,440.0,4,1739,11.0,1350.0,406.0
0.004,6,10,1702,5,863,0.0,595.0,595.0,5,839,1.0,571.0,571.0
0.121,6,10,1506,5,395,28.0,127.0,127.0,5,1111,25.0,843.0,843.0
0.01,6,10,1631,5,848,2.0,580.0,580.0,5,783,2.0,515.0,515.0
0.069,6,10,1506,5,395,15.0,127.0,127.0,5,1111,15.0,843.0,843.0
300.322,6,31,11486,17,1979,18770.0,506.0,271.0,14,9507,4715.0,2804.0,877.0
15.074,17,15,9238,8,6902,2149.0,1350.0,834.0,7,2336,2507.0,1350.0,305.0
0.006,6,10,1547,5,764,1.0,496.0,496.0,5,783,1.0,515.0,515.0
0.006,6,10,1689,5,839,1.0,571.0,571.0,5,850,1.0,582.0,582.0
1750.637,6,443,65513,253,35232,6946.0,613.0,197.0,190,30281,9262.0,453.0,144.0
0.015,6,10,1983,5,910,3.0,642.0,642.0,5,1073,3.0,805.0,805.0
0.005,6,10,2000,5,927,1.0,659.0,659.0,5,1073,1.0,805.0,805.0
0.006,17,2,170,1,65,0.0,37.0,37.0,1,105,0.0,77.0,77.0
0.008,17,2,194,1,59,0.0,31.0,31.0,1,135,0.0,107.0,107.0
308.464,17,20,1124,10,716,34259.0,48.0,43.0,10,408,34259.0,20.0,12.0
0.009,6,10,1989,5,910,2.0,642.0,642.0,5,1079,2.0,811.0,811.0
240.087,6,16,4482,9,963,30010.0,238.0,166.0,7,3519,40014.0,1402.0,786.0
0.011,6,10,1990,5,911,2.0,643.0,643.0,5,1079,2.0,811.0,811.0
0.071,17,8,3613,4,1874,23.0,1350.0,440.0,4,1739,11.0,1350.0,406.0
0.017,17,2,214,1,75,0.0,47.0,47.0,1,139,0.0,111.0,111.0
0.005,17,2,230,1,68,0.0,40.0,40.0,1,162,0.0,134.0,134.0
0.004,6,10,1779,5,928,1.0,660.0,660.0,5,851,1.0,583.0,583.0
0.007,17,2,179,1,71,0.0,43.0,43.0,1,108,0.0,80.0,80.0
0.095,6,10,1506,5,395,19.0,127.0,127.0,5,1111,22.0,843.0,843.0
0.005,6,10,1854,5,889,1.0,621.0,621.0,5,965,1.0,697.0,697.0
0.016,6,10,1989,5,910,3.0,642.0,642.0,5,1079,3.0,811.0,811.0
40.065,17,10,676,5,460,10015.0,104.0,64.0,5,216,10015.0,20.0,15.0
0.005,6,10,2006,5,927,1.0,659.0,659.0,5,1079,1.0,811.0,811.0
0.015,6,10,1972,5,910,3.0,642.0,642.0,5,1062,3.0,794.0,794.0
0.083,17,2,144,1,64,0.0,36.0,36.0,1,80,0.0,52.0,52.0
0.004,6,10,2006,5,927,1.0,659.0,659.0,5,1079,1.0,811.0,811.0
0.076,6,10,1506,5,395,16.0,127.0,127.0,5,1111,16.0,843.0,843.0
0.004,6,10,2000,5,927,1.0,659.0,659.0,5,1073,1.0,805.0,805.0
0.006,6,10,1547,5,764,1.0,496.0,496.0,5,783,1.0,515.0,515.0
0.025,6,10,1989,5,910,6.0,642.0,642.0,5,1079,6.0,811.0,811.0
0.04,17,4,420,2,122,0.0,33.0,33.0,2,298,37.0,145.0,121.0
0.005,6,10,1702,5,863,1.0,595.0,595.0,5,839,1.0,571.0,571.0
0.006,6,10,1643,5,860,1.0,592.0,592.0,5,783,1.0,515.0,515.0
0.044,17,2,152,1,76,0.0,48.0,48.0,1,76,0.0,48.0,48.0
10.725,17,28,4422,14,1994,816.0,269.0,114.0,14,2428,816.0,587.0,145.0
240.017,6,17,2472,9,1169,30002.0,555.0,176.0,8,1303,34287.0,580.0,219.0
0.08,6,10,1506,5,395,16.0,127.0,127.0,5,1111,18.0,843.0,843.0
0.014,6,10,1989,5,910,3.0,642.0,642.0,5,1079,3.0,811.0,811.0
0.001,17,2,180,1,66,0.0,38.0,38.0,1,114,0.0,86.0,86.0
0.009,6,10,1677,5,827,2.0,559.0,559.0,5,850,2.0,582.0,582.0
0.005,17,2,166,1,75,0.0,47.0,47.0,1,91,0.0,63.0,63.0
0.149,6,10,1506,5,395,35.0,127.0,127.0,5,1111,33.0,843.0,843.0
0.006,17,2,146,1,65,0.0,37.0,37.0,1,81,0.0,53.0,53.0
0.004,6,10,1989,5,927,1.0,659.0,659.0,5,1062,1.0,794.0,794.0
0.007,6,10,1677,5,827,1.0,559.0,559.0,5,850,1.0,582.0,582.0
40.075,17,10,676,5,460,10016.0,104.0,64.0,5,216,10017.0,20.0,15.0
1.023,6,13,3922,7,2139,128.0,1328.0,923.0,6,1783,153.0,1539.0,1539.0
0.004,6,10,2006,5,927,1.0,659.0,659.0,5,1079,1.0,811.0,811.0
0.005,6,10,2006,5,927,1.0,659.0,659.0,5,1079,1.0,811.0,811.0
0.006,6,10,1547,5,764,1.0,496.0,496.0,5,783,1.0,515.0,515.0
0.008,6,11,2041,6,962,1.0,642.0,642.0,5,1079,1.0,811.0,811.0
0.008,6,10,1989,5,910,1.0,642.0,642.0,5,1079,1.0,811.0,811.0
0.076,6,10,1506,5,395,17.0,127.0,127.0,5,1111,15.0,843.0,843.0
0.011,6,10,1677,5,827,2.0,559.0,559.0,5,850,2.0,582.0,582.0
15.087,17,15,9238,8,6902,2149.0,1350.0,834.0,7,2336,2509.0,1350.0,305.0
174.049,17,66,9451,33,2202,5438.0,44.0,38.0,33,7249,5438.0,239.0,191.0
0.006,6,10,1990,5,911,1.0,643.0,643.0,5,1079,1.0,811.0,811.0
0.006,17,2,148,1,60,0.0,32.0,32.0,1,88,0.0,60.0,60.0
1.824,6,36,6723,19,3451,101.0,1103.0,204.0,17,3272,106.0,1796.0,396.0
0.02,6,10,2006,5,927,5.0,659.0,659.0,5,1079,5.0,811.0,811.0
0.008,6,10,1990,5,911,2.0,643.0,643.0,5,1079,2.0,811.0,811.0
0.006,17,2,154,1,69,0.0,41.0,41.0,1,85,0.0,57.0,57.0
0.008,17,2,194,1,59,0.0,31.0,31.0,1,135,0.0,107.0,107.0
0.015,6,13,3735,7,497,2.0,125.0,125.0,6,3238,2.0,1470.0,1459.0
0.001,17,2,180,1,66,0.0,38.0,38.0,1,114,0.0,86.0,86.0
366.253,6,22,2313,16,867,24416.0,195.0,195.0,6,1446,4635.0,419.0,398.0
0.086,6,10,1506,5,395,18.0,127.0,127.0,5,1111,18.0,843.0,843.0
0.006,6,10,1854,5,889,1.0,621.0,621.0,5,965,1.0,697.0,697.0
0.003,17,2,148,1,60,0.0,32.0,32.0,1,88,0.0,60.0,60.0
0.001,17,2,180,1,66,0.0,38.0,38.0,1,114,0.0,86.0,86.0
5.092,6,23,6562,13,1500,424.0,474.0,201.0,10,5062,565.0,1925.0,757.0
0.034,6,10,1989,5,910,8.0,642.0,642.0,5,1079,8.0,811.0,811.0
0.003,17,2,136,1,60,0.0,32.0,32.0,1,76,0.0,48.0,48.0
0.011,6,10,1990,5,911,2.0,643.0,643.0,5,1079,2.0,811.0,811.0
0.094,6,10,1506,5,395,20.0,127.0,127.0,5,1111,21.0,843.0,843.0
0.004,17,2,152,1,76,0.0,48.0,48.0,1,76,0.0,48.0,48.0
0.017,6,10,1972,5,910,4.0,642.0,642.0,5,1062,4.0,794.0,794.0
0.071,6,10,1506,5,395,16.0,127.0,127.0,5,1111,14.0,843.0,843.0
0.075,6,10,1506,5,395,17.0,127.0,127.0,5,1111,15.0,843.0,843.0
0.006,17,2,180,1,66,0.0,38.0,38.0,1,114,0.0,86.0,86.0
0.004,6,10,2007,5,928,1.0,660.0,660.0,5,1079,1.0,811.0,811.0
0.08,6,10,1506,5,395,19.0,127.0,127.0,5,1111,16.0,843.0,843.0
0.005,17,2,148,1,60,0.0,32.0,32.0,1,88,0.0,60.0,60.0
40.071,17,10,676,5,460,10016.0,104.0,64.0,5,216,10017.0,20.0,15.0
15.099,17,16,8391,8,6311,2152.0,1350.0,760.0,8,2080,2152.0,1350.0,232.0
0.084,6,10,1506,5,395,16.0,127.0,127.0,5,1111,18.0,843.0,843.0
40.073,17,10,676,5,460,10016.0,104.0,64.0,5,216,10017.0,20.0,15.0
301.075,6,50,18099,27,12107,11579.0,4080.0,1372.0,23,5992,404.0,2667.0,361.0
0.071,17,4,284,2,120,0.0,32.0,32.0,2,164,68.0,60.0,54.0
0.004,6,10,2000,5,927,1.0,659.0,659.0,5,1073,1.0,805.0,805.0
0.076,6,10,1506,5,395,15.0,127.0,127.0,5,1111,18.0,843.0,843.0
0.112,6,10,1506,5,395,18.0,127.0,127.0,5,1111,23.0,843.0,843.0
1770.722,6,87,4626,44,2340,41178.0,26.0,26.0,43,2286,42159.0,26.0,25.0
0.021,6,10,1990,5,911,5.0,643.0,643.0,5,1079,5.0,811.0,811.0
0.009,6,12,1926,6,1189,1.0,659.0,434.0,6,737,1.0,417.0,417.0
0.01,6,10,1990,5,911,2.0,643.0,643.0,5,1079,2.0,811.0,811.0
1729.263,6,60,4400,40,2740,44340.0,33.0,33.0,20,1660,91005.0,31.0,31.0
0.004,6,10,1702,5,863,1.0,595.0,595.0,5,839,0.0,571.0,571.0
300.346,6,16,2170,9,684,37521.0,146.0,146.0,7,1486,50029.0,419.0,398.0
0.005,6,10,2006,5,927,1.0,659.0,659.0,5,1079,1.0,811.0,811.0
53.413,6,837,884967,421,860278,90.0,4080.0,2237.0,416,24689,128.0,2667.0,200.0
0.006,6,10,2007,5,928,1.0,660.0,660.0,5,1079,1.0,811.0,811.0
0.081,6,10,1506,5,395,18.0,127.0,127.0,5,1111,20.0,843.0,843.0
0.019,6,10,1972,5,910,4.0,642.0,642.0,5,1062,4.0,794.0,794.0
0.005,6,10,2007,5,928,1.0,660.0,660.0,5,1079,1.0,811.0,811.0
66.347,6,22,8894,12,2328,6031.0,1002.0,424.0,10,6566,7354.0,2355.0,1006.0
0.004,17,2,148,1,60,0.0,32.0,32.0,1,88,0.0,60.0,60.0
0.016,6,10,1989,5,910,4.0,642.0,642.0,5,1079,3.0,811.0,811.0
354.001,6,19,1691,15,978,25285.0,190.0,190.0,4,713,80003.0,497.0,497.0
0.006,6,10,1547,5,764,1.0,496.0,496.0,5,783,1.0,515.0,515.0
0.005,6,10,2007,5,928,1.0,660.0,660.0,5,1079,1.0,811.0,811.0
0.005,6,10,2006,5,927,1.0,659.0,659.0,5,1079,1.0,811.0,811.0
0.016,6,10,1972,5,910,4.0,642.0,642.0,5,1062,4.0,794.0,794.0
0.005,17,2,136,1,60,0.0,32.0,32.0,1,76,0.0,48.0,48.0
10.843,17,28,4424,14,1995,826.0,270.0,114.0,14,2429,825.0,588.0,145.0
0.005,6,10,1547,5,764,1.0,496.0,496.0,5,783,1.0,515.0,515.0
0.007,6,10,1547,5,764,1.0,496.0,496.0,5,783,1.0,515.0,515.0
0.005,6,10,2006,5,927,1.0,659.0,659.0,5,1079,1.0,811.0,811.0
0.012,6,6,716,3,458,4.0,302.0,302.0,3,258,3.0,102.0,102.0
0.015,6,10,1990,5,911,3.0,643.0,643.0,5,1079,3.0,811.0,811.0
0.139,6,10,1506,5,395,34.0,127.0,127.0,5,1111,18.0,843.0,843.0
0.015,6,10,1990,5,911,3.0,643.0,643.0,5,1079,3.0,811.0,811.0
15.071,17,14,9190,8,6902,2149.0,1350.0,834.0,6,2288,3008.0,1350.0,353.0
0.103,6,10,1506,5,395,23.0,127.0,127.0,5,1111,25.0,843.0,843.0
40.057,17,10,676,5,460,10013.0,104.0,64.0,5,216,10013.0,20.0,15.0
0.044,17,2,148,1,60,0.0,32.0,32.0,1,88,0.0,60.0,60.0
0.075,6,10,1506,5,395,16.0,127.0,127.0,5,1111,14.0,843.0,843.0
0.009,6,10,1983,5,910,2.0,642.0,642.0,5,1073,2.0,805.0,805.0
1775.763,6,333,69079,141,48657,12683.0,2720.0,390.0,192,20422,9296.0,1360.0,148.0
40.093,17,10,676,5,460,10020.0,104.0,64.0,5,216,10022.0,20.0,15.0
0.032,6,10,1990,5,911,8.0,643.0,643.0,5,1079,8.0,811.0,811.0
0.097,6,10,1506,5,395,21.0,127.0,127.0,5,1111,21.0,843.0,843.0
0.009,6,10,1972,5,910,2.0,642.0,642.0,5,1062,2.0,794.0,794.0
0.04,17,2,182,1,65,0.0,37.0,37.0,1,117,0.0,89.0,89.0
0.001,17,2,180,1,65,0.0,37.0,37.0,1,115,0.0,87.0,87.0
0.085,6,10,1506,5,395,19.0,127.0,127.0,5,1111,15.0,843.0,843.0
15.091,17,15,8221,8,6056,2151.0,1350.0,729.0,7,2165,2510.0,1350.0,281.0
0.032,6,10,1983,5,910,7.0,642.0,642.0,5,1073,7.0,805.0,805.0
0.005,17,2,144,1,64,0.0,36.0,36.0,1,80,0.0,52.0,52.0
0.075,6,10,1506,5,395,16.0,127.0,127.0,5,1111,16.0,843.0,843.0
0.001,17,2,142,1,63,0.0,35.0,35.0,1,79,0.0,51.0,51.0
241.764,6,307,343533,117,17600,2084.0,2736.0,960.0,190,325933,1279.0,2804.0,1755.0
0.007,6,10,1547,5,764,1.0,496.0,496.0,5,783,1.0,515.0,515.0
0.007,6,12,1698,6,863,1.0,327.0,271.0,6,835,1.0,515.0,515.0
0.06,6,10,1506,5,395,13.0,127.0,127.0,5,1111,13.0,843.0,843.0
0.01,6,10,1990,5,911,2.0,643.0,643.0,5,1079,2.0,811.0,811.0
0.004,6,10,1989,5,927,1.0,659.0,659.0,5,1062,1.0,794.0,794.0
0.008,6,10,1989,5,910,2.0,642.0,642.0,5,1079,1.0,811.0,811.0
369.872,6,22,2313,16,867,24658.0,195.0,195.0,6,1446,4635.0,419.0,398.0
0.01,6,10,1990,5,911,2.0,643.0,643.0,5,1079,2.0,811.0,811.0
0.014,6,10,1983,5,910,3.0,642.0,642.0,5,1073,3.0,805.0,805.0
0.039,17,2,412,1,61,0.0,33.0,33.0,1,351,0.0,323.0,323.0
0.013,6,10,1972,5,910,3.0,642.0,642.0,5,1062,3.0,794.0,794.0
0.009,6,10,1989,5,910,2.0,642.0,642.0,5,1079,2.0,811.0,811.0
0.004,6,10,1989,5,927,1.0,659.0,659.0,5,1062,1.0,794.0,794.0
0.098,6,10,1506,5,395,22.0,127.0,127.0,5,1111,21.0,843.0,843.0
0.126,17,2,148,1,60,0.0,32.0,32.0,1,88,0.0,60.0,60.0
334.822,17,20,1124,10,716,37188.0,48.0,43.0,10,408,37188.0,20.0,12.0
0.005,17,2,164,1,74,0.0,46.0,46.0,1,90,0.0,62.0,62.0
0.009,6,10,1972,5,910,2.0,642.0,642.0,5,1062,2.0,794.0,794.0
0.076,6,10,1506,5,395,15.0,127.0,127.0,5,1111,17.0,843.0,843.0
0.014,6,13,3735,7,497,2.0,125.0,125.0,6,3238,2.0,1470.0,1459.0
0.013,6,10,1990,5,911,3.0,643.0,643.0,5,1079,3.0,811.0,811.0
40.059,17,10,676,5,460,10012.0,104.0,64.0,5,216,10014.0,20.0,15.0
0.006,6,10,2007,5,928,1.0,660.0,660.0,5,1079,1.0,811.0,811.0
0.004,6,10,1702,5,863,0.0,595.0,595.0,5,839,1.0,571.0,571.0
40.062,17,10,676,5,460,10014.0,104.0,64.0,5,216,10014.0,20.0,15.0
0.023,6,20,9974,11,704,2.0,124.0,124.0,9,9270,2.0,2896.0,1758.0
0.106,6,10,1506,5,395,26.0,127.0,127.0,5,1111,24.0,843.0,843.0
0.012,6,10,1677,5,827,3.0,559.0,559.0,5,850,3.0,582.0,582.0
0.017,6,10,1972,5,910,4.0,642.0,642.0,5,1062,4.0,794.0,794.0
0.076,6,10,1506,5,395,16.0,127.0,127.0,5,1111,18.0,843.0,843.0
0.005,6,10,2007,5,928,1.0,660.0,660.0,5,1079,1.0,811.0,811.0
159.337,17,74,10604,37,2474,4425.0,44.0,38.0,37,8130,4426.0,261.0,191.0
0.01,6,10,1762,5,911,2.0,643.0,643.0,5,851,2.0,583.0,583.0
0.208,6,16,2674,8,1400,29.0,533.0,325.0,8,1274,19.0,529.0,212.0
0.126,17,4,284,2,120,2.0,32.0,32.0,2,164,123.0,60.0,54.0
40.052,17,10,676,5,460,10012.0,104.0,64.0,5,216,10012.0,20.0,15.0
37.639,6,37,8230,19,1759,514.0,651.0,322.0,18,6471,2206.0,2126.0,478.0
0.006,17,2,293,1,73,0.0,45.0,45.0,1,220,0.0,192.0,192.0
0.076,6,10,1506,5,395,18.0,127.0,127.0,5,1111,16.0,843.0,843.0
0.009,6,10,1972,5,910,2.0,642.0,642.0,5,1062,2.0,794.0,794.0
0.013,6,10,1989,5,910,3.0,642.0,642.0,5,1079,3.0,811.0,811.0
0.015,6,10,1631,5,848,3.0,580.0,580.0,5,783,3.0,515.0,515.0
0.004,17,2,180,1,58,0.0,30.0,30.0,1,122,0.0,94.0,94.0
0.006,17,2,170,1,65,0.0,37.0,37.0,1,105,0.0,77.0,77.0
0.005,6,10,1989,5,927,1.0,659.0,659.0,5,1062,1.0,794.0,794.0
0.007,6,10,1989,5,910,1.0,642.0,642.0,5,1079,1.0,811.0,811.0
0.004,17,4,284,2,120,0.0,32.0,32.0,2,164,1.0,60.0,54.0
0.012,6,10,1972,5,910,3.0,642.0,642.0,5,1062,3.0,794.0,794.0
10.772,17,28,4423,14,1994,819.0,269.0,114.0,14,2429,819.0,588.0,145.0
0.016,6,10,1989,5,910,4.0,642.0,642.0,5,1079,4.0,811.0,811.0
0.006,6,10,1689,5,839,1.0,571.0,571.0,5,850,1.0,582.0,582.0
0.004,17,2,136,1,60,0.0,32.0,32.0,1,76,0.0,48.0,48.0
0.128,6,23,2467,12,1185,11.0,426.0,140.0,11,1282,11.0,281.0,118.0
40.065,17,10,676,5,460,10015.0,104.0,64.0,5,216,10015.0,20.0,15.0
240.16,6,16,4480,9,963,30020.0,238.0,166.0,7,3517,40021.0,1402.0,786.0
0.107,6,10,1506,5,395,25.0,127.0,127.0,5,1111,26.0,843.0,843.0
0.005,6,10,1643,5,860,1.0,592.0,592.0,5,783,1.0,515.0,515.0
0.013,6,10,1990,5,911,3.0,643.0,643.0,5,1079,3.0,811.0,811.0
0.008,6,10,1972,5,910,1.0,642.0,642.0,5,1062,1.0,794.0,794.0
0.057,6,10,1506,5,395,13.0,127.0,127.0,5,1111,12.0,843.0,843.0
1779.047,17,143,45188,72,22752,25055.0,288.0,288.0,71,22436,25413.0,288.0,288.0
0.005,6,10,1774,5,923,1.0,655.0,655.0,5,851,1.0,583.0,583.0
0.005,6,10,2000,5,927,1.0,659.0,659.0,5,1073,1.0,805.0,805.0
40.077,17,10,676,5,460,10017.0,104.0,64.0,5,216,10018.0,20.0,15.0
0.005,6,10,2006,5,927,1.0,659.0,659.0,5,1079,1.0,811.0,811.0
0.018,17,2,170,1,65,0.0,37.0,37.0,1,105,0.0,77.0,77.0
0.113,6,10,1506,5,395,22.0,127.0,127.0,5,1111,23.0,843.0,843.0
0.005,6,10,2000,5,927,1.0,659.0,659.0,5,1073,1.0,805.0,805.0
0.095,6,10,1506,5,395,21.0,127.0,127.0,5,1111,19.0,843.0,843.0
0.014,6,10,1989,5,910,3.0,642.0,642.0,5,1079,3.0,811.0,811.0
0.012,6,10,1989,5,910,3.0,642.0,642.0,5,1079,2.0,811.0,811.0
0.009,6,10,1989,5,910,2.0,642.0,642.0,5,1079,2.0,811.0,811.0
0.005,6,10,1689,5,839,1.0,571.0,571.0,5,850,1.0,582.0,582.0
0.004,6,10,2006,5,927,1.0,659.0,659.0,5,1079,1.0,811.0,811.0
178.163,17,82,11600,41,2728,4453.0,44.0,38.0,41,8872,4454.0,260.0,188.0
0.01,6,10,1983,5,910,2.0,642.0,642.0,5,1073,2.0,805.0,805.0
0.01,6,10,1983,5,910,2.0,642.0,642.0,5,1073,2.0,805.0,805.0
0.012,6,10,1990,5,911,3.0,643.0,643.0,5,1079,2.0,811.0,811.0
15.076,17,15,8239,8,6057,2149.0,1350.0,729.0,7,2182,2507.0,1350.0,283.0
0.086,6,10,1506,5,395,19.0,127.0,127.0,5,1111,19.0,843.0,843.0
0.005,17,2,148,1,60,0.0,32.0,32.0,1,88,0.0,60.0,60.0
0.12,6,10,1506,5,395,27.0,127.0,127.0,5,1111,26.0,843.0,843.0
0.012,6,12,1926,6,1189,2.0,659.0,434.0,6,737,2.0,417.0,417.0
280.522,6,24,6115,11,1226,28052.0,267.0,156.0,13,4889,23376.0,1400.0,873.0
0.004,6,10,1779,5,928,1.0,660.0,660.0,5,851,1.0,583.0,583.0
0.104,6,10,1506,5,395,19.0,127.0,127.0,5,1111,22.0,843.0,843.0
30.733,6,26,8118,15,3040,2187.0,1191.0,449.0,11,5078,3062.0,1402.0,751.0
40.063,17,10,676,5,460,10015.0,104.0,64.0,5,216,10015.0,20.0,15.0
0.087,6,10,1506,5,395,19.0,127.0,127.0,5,1111,18.0,843.0,843.0
0.092,6,10,1506,5,395,21.0,127.0,127.0,5,1111,20.0,843.0,843.0
0.005,6,10,2006,5,927,1.0,659.0,659.0,5,1079,1.0,811.0,811.0
0.008,6,10,1762,5,911,1.0,643.0,643.0,5,851,1.0,583.0,583.0
11.223,17,28,4395,14,1994,850.0,269.0,114.0,14,2401,850.0,588.0,143.0
0.005,17,2,230,1,68,0.0,40.0,40.0,1,162,0.0,134.0,134.0
0.244,6,16,2778,8,1396,34.0,533.0,324.0,8,1382,23.0,529.0,239.0
280.297,6,23,5205,12,2929,25481.0,676.0,459.0,11,2276,28029.0,824.0,427.0
0.019,6,10,1989,5,910,4.0,642.0,642.0,5,1079,4.0,811.0,811.0
11.037,17,28,4396,14,2311,840.0,586.0,137.0,14,2085,840.0,268.0,120.0
0.009,6,12,1926,6,1189,1.0,659.0,434.0,6,737,1.0,417.0,417.0
0.117,6,10,1506,5,395,27.0,127.0,127.0,5,1111,25.0,843.0,843.0
0.012,6,14,3787,7,497,2.0,125.0,125.0,7,3290,1.0,1448.0,972.0
0.005,17,2,166,1,75,0.0,47.0,47.0,1,91,0.0,63.0,63.0
0.042,17,2,146,1,65,0.0,37.0,37.0,1,81,0.0,53.0,53.0
0.011,6,10,1762,5,911,2.0,643.0,643.0,5,851,2.0,583.0,583.0
40.054,17,10,676,5,460,10012.0,104.0,64.0,5,216,10012.0,20.0,15.0
0.006,6,10,1989,5,927,1.0,659.0,659.0,5,1062,1.0,794.0,794.0
0.009,6,12,1926,6,1189,1.0,659.0,434.0,6,737,1.0,417.0,417.0
0.026,6,10,1989,5,910,6.0,642.0,642.0,5,1079,6.0,811.0,811.0
0.01,6,12,1698,6,863,1.0,327.0,271.0,6,835,2.0,515.0,515.0
0.012,6,10,1989,5,910,3.0,642.0,642.0,5,1079,2.0,811.0,811.0
0.003,17,2,152,1,76,0.0,48.0,48.0,1,76,0.0,48.0,48.0
0.004,17,2,148,1,60,0.0,32.0,32.0,1,88,0.0,60.0,60.0
0.01,6,14,3787,7,497,1.0,125.0,125.0,7,3290,1.0,1448.0,972.0
40.063,17,10,676,5,460,10015.0,104.0,64.0,5,216,10015.0,20.0,15.0
320.67,17,20,1124,10,716,35615.0,48.0,43.0,10,408,35616.0,20.0,12.0
0.011,6,10,1972,5,910,2.0,642.0,642.0,5,1062,2.0,794.0,794.0
178.033,17,80,11270,40,2664,4564.0,44.0,38.0,40,8606,4564.0,239.0,187.0
0.013,6,10,1762,5,911,3.0,643.0,643.0,5,851,3.0,583.0,583.0
0.011,6,10,1989,5,910,2.0,642.0,642.0,5,1079,2.0,811.0,811.0
0.005,6,10,1779,5,928,1.0,660.0,660.0,5,851,1.0,583.0,583.0
0.009,6,13,3735,7,497,1.0,125.0,125.0,6,3238,1.0,1470.0,1459.0
0.015,6,10,1989,5,910,3.0,642.0,642.0,5,1079,3.0,811.0,811.0
0.075,6,10,1506,5,395,16.0,127.0,127.0,5,1111,15.0,843.0,843.0
0.096,6,10,1506,5,395,21.0,127.0,127.0,5,1111,19.0,843.0,843.0
0.006,17,2,225,1,65,0.0,37.0,37.0,1,160,0.0,132.0,132.0
0.015,6,10,1983,5,910,3.0,642.0,642.0,5,1073,3.0,805.0,805.0
0.008,17,2,194,1,59,0.0,31.0,31.0,1,135,0.0,107.0,107.0
0.01,6,13,3735,7,497,1.0,125.0,125.0,6,3238,1.0,1470.0,1459.0
0.004,17,2,136,1,60,0.0,32.0,32.0,1,76,0.0,48.0,48.0
0.006,6,10,1547,5,764,1.0,496.0,496.0,5,783,1.0,515.0,515.0
0.005,6,13,3747,7,509,0.0,137.0,137.0,6,3238,0.0,1470.0,1459.0
0.007,6,10,1547,5,764,1.0,496.0,496.0,5,783,1.0,515.0,515.0
10.709,17,28,4423,14,1994,815.0,269.0,114.0,14,2429,815.0,588.0,145.0
1751.852,6,450,65428,252,35168,6979.0,613.0,197.0,198,30260,8892.0,453.0,142.0
354.032,6,19,1691,15,978,25288.0,190.0,190.0,4,713,80008.0,497.0,497.0
0.094,6,10,1506,5,395,20.0,127.0,127.0,5,1111,21.0,843.0,843.0
0.005,6,10,2007,5,928,1.0,660.0,660.0,5,1079,1.0,811.0,811.0
0.128,6,10,1506,5,395,29.0,127.0,127.0,5,1111,27.0,843.0,843.0
0.011,17,2,299,1,65,0.0,37.0,37.0,1,234,0.0,206.0,206.0
0.214,17,4,352,2,130,174.0,37.0,37.0,2,222,143.0,89.0,83.0
0.005,6,10,2000,5,927,1.0,659.0,659.0,5,1073,1.0,805.0,805.0
0.073,6,10,1506,5,395,17.0,127.0,127.0,5,1111,17.0,843.0,843.0
0.013,6,10,1972,5,910,3.0,642.0,642.0,5,1062,3.0,794.0,794.0
0.043,17,2,148,1,60,0.0,32.0,32.0,1,88,0.0,60.0,60.0
0.012,6,13,3735,7,497,2.0,125.0,125.0,6,3238,2.0,1470.0,1459.0
20.453,6,24,7517,13,1385,1704.0,530.0,277.0,11,6132,2026.0,1823.0,946.0
0.014,6,10,1972,5,910,3.0,642.0,642.0,5,1062,3.0,794.0,794.0
0.001,17,2,180,1,65,0.0,37.0,37.0,1,115,0.0,87.0,87.0
0.134,6,10,1506,5,395,31.0,127.0,127.0,5,1111,29.0,843.0,843.0
0.08,6,10,1506,5,395,19.0,127.0,127.0,5,1111,17.0,843.0,843.0
0.013,6,10,1972,5,910,3.0,642.0,642.0,5,1062,3.0,794.0,794.0
0.095,6,10,1506,5,395,21.0,127.0,127.0,5,1111,17.0,843.0,843.0
0.105,6,10,1506,5,395,22.0,127.0,127.0,5,1111,23.0,843.0,843.0
0.014,6,10,1989,5,910,3.0,642.0,642.0,5,1079,3.0,811.0,811.0
40.056,17,10,676,5,460,10012.0,104.0,64.0,5,216,10013.0,20.0,15.0
0.043,6,10,1989,5,910,10.0,642.0,642.0,5,1079,10.0,811.0,811.0
0.004,6,10,2000,5,927,1.0,659.0,659.0,5,1073,1.0,805.0,805.0
0.005,17,2,212,1,74,0.0,46.0,46.0,1,138,0.0,110.0,110.0
0.01,6,14,3787,7,497,1.0,125.0,125.0,7,3290,1.0,1448.0,972.0
0.004,17,2,148,1,60,0.0,32.0,32.0,1,88,0.0,60.0,60.0
0.005,6,10,2006,5,927,1.0,659.0,659.0,5,1079,1.0,811.0,811.0
300.023,6,12,1782,7,1348,50003.0,494.0,494.0,5,434,75005.0,83.0,83.0
0.015,6,10,1983,5,910,3.0,642.0,642.0,5,1073,3.0,805.0,805.0
0.054,17,2,152,1,76,0.0,48.0,48.0,1,76,0.0,48.0,48.0
0.064,6,10,1506,5,395,14.0,127.0,127.0,5,1111,13.0,843.0,843.0
40.062,17,10,676,5,460,10014.0,104.0,64.0,5,216,10014.0,20.0,15.0
0.005,6,10,1779,5,928,1.0,660.0,660.0,5,851,1.0,583.0,583.0
0.004,6,10,2006,5,927,1.0,659.0,659.0,5,1079,1.0,811.0,811.0
0.001,17,2,136,1,60,0.0,32.0,32.0,1,76,0.0,48.0,48.0
0.041,17,4,596,2,122,1.0,33.0,33.0,2,474,0.0,323.0,209.0
0.006,17,2,170,1,65,0.0,37.0,37.0,1,105,0.0,77.0,77.0
43.102,17,26,14948,14,12082,3313.0,1350.0,835.0,12,2866,3915.0,1350.0,210.0
0.059,17,2,80,1,32,0.0,4.0,4.0,1,48,0.0,20.0,20.0
308.358,17,20,1124,10,716,34250.0,48.0,43.0,10,408,34249.0,20.0,12.0
0.011,6,10,1990,5,911,2.0,643.0,643.0,5,1079,2.0,811.0,811.0
0.001,17,2,180,1,66,0.0,38.0,38.0,1,114,0.0,86.0,86.0
0.01,6,10,1774,5,923,2.0,655.0,655.0,5,851,2.0,583.0,583.0
0.005,6,10,2007,5,928,1.0,660.0,660.0,5,1079,1.0,811.0,811.0
0.082,6,10,1506,5,395,17.0,127.0,127.0,5,1111,18.0,843.0,843.0
0.071,17,2,136,1,60,0.0,32.0,32.0,1,76,0.0,48.0,48.0
0.056,6,10,1990,5,911,14.0,643.0,643.0,5,1079,14.0,811.0,811.0
11.119,17,28,4422,14,1994,842.0,269.0,114.0,14,2428,842.0,587.0,145.0
0.005,6,13,3747,7,509,0.0,137.0,137.0,6,3238,0.0,1470.0,1459.0
0.006,6,10,1547,5,764,1.0,496.0,496.0,5,783,1.0,515.0,515.0
0.127,6,10,1506,5,395,31.0,127.0,127.0,5,1111,29.0,843.0,843.0
0.018,6,10,1989,5,910,4.0,642.0,642.0,5,1079,4.0,811.0,811.0
0.012,6,10,1989,5,910,2.0,642.0,642.0,5,1079,3.0,811.0,811.0
0.011,6,10,1762,5,911,2.0,643.0,643.0,5,851,2.0,583.0,583.0
0.001,17,2,180,1,66,0.0,38.0,38.0,1,114,0.0,86.0,86.0
0.011,6,10,1677,5,827,2.0,559.0,559.0,5,850,2.0,582.0,582.0
0.016,6,10,1631,5,848,4.0,580.0,580.0,5,783,3.0,515.0,515.0
0.077,6,10,1506,5,395,16.0,127.0,127.0,5,1111,18.0,843.0,843.0
0.012,6,10,1990,5,911,3.0,643.0,643.0,5,1079,3.0,811.0,811.0
0.018,6,10,1762,5,911,4.0,643.0,643.0,5,851,4.0,583.0,583.0
0.004,17,2,136,1,60,0.0,32.0,32.0,1,76,0.0,48.0,48.0
0.004,6,10,2006,5,927,1.0,659.0,659.0,5,1079,1.0,811.0,811.0
0.012,6,10,1631,5,848,3.0,580.0,580.0,5,783,3.0,515.0,515.0
309.161,17,20,1124,10,716,34344.0,48.0,43.0,10,408,34344.0,20.0,12.0
0.005,6,10,2007,5,928,1.0,660.0,660.0,5,1079,1.0,811.0,811.0
0.006,6,10,1689,5,839,1.0,571.0,571.0,5,850,1.0,582.0,582.0
0.006,6,13,3690,7,452,1.0,80.0,80.0,6,3238,1.0,1470.0,1459.0
0.035,6,10,1989,5,910,8.0,642.0,642.0,5,1079,8.0,811.0,811.0
0.01,6,10,1990,5,911,2.0,643.0,643.0,5,1079,2.0,811.0,811.0
0.097,6,10,1506,5,395,19.0,127.0,127.0,5,1111,22.0,843.0,843.0
0.001,17,2,180,1,66,0.0,38.0,38.0,1,114,0.0,86.0,86.0
0.003,6,10,1702,5,863,0.0,595.0,595.0,5,839,0.0,571.0,571.0
0.003,17,2,186,1,61,0.0,33.0,33.0,1,125,0.0,97.0,97.0
0.016,6,10,1989,5,910,4.0,642.0,642.0,5,1079,4.0,811.0,811.0
10.789,17,28,4422,14,1994,821.0,269.0,114.0,14,2428,821.0,587.0,145.0
0.011,6,10,1972,5,910,2.0,642.0,642.0,5,1062,2.0,794.0,794.0
0.006,17,2,170,1,65,0.0,37.0,37.0,1,105,0.0,77.0,77.0
40.051,17,10,676,5,460,10012.0,104.0,64.0,5,216,10012.0,20.0,15.0
0.012,6,10,1989,5,910,3.0,642.0,642.0,5,1079,2.0,811.0,811.0
15.071,17,16,10617,9,8280,1880.0,1350.0,892.0,7,2337,2508.0,1350.0,305.0
0.001,17,2,180,1,66,0.0,38.0,38.0,1,114,0.0,86.0,86.0
0.001,17,2,180,1,66,0.0,38.0,38.0,1,114,0.0,86.0,86.0
0.009,6,12,1926,6,1189,1.0,659.0,434.0,6,737,1.0,417.0,417.0
0.005,6,10,2007,5,928,1.0,660.0,660.0,5,1079,1.0,811.0,811.0
0.001,17,2,180,1,66,0.0,38.0,38.0,1,114,0.0,86.0,86.0
308.474,17,20,1124,10,716,34260.0,48.0,43.0,10,408,34260.0,20.0,12.0
40.053,17,10,676,5,460,10012.0,104.0,64.0,5,216,10012.0,20.0,15.0
0.042,17,4,420,2,122,0.0,33.0,33.0,2,298,39.0,145.0,121.0
0.237,6,16,2670,8,1396,33.0,533.0,324.0,8,1274,22.0,529.0,212.0
0.039,17,4,420,2,122,0.0,33.0,33.0,2,298,36.0,145.0,121.0
0.01,6,10,1972,5,910,2.0,642.0,642.0,5,1062,2.0,794.0,794.0
0.04,17,2,152,1,76,0.0,48.0,48.0,1,76,0.0,48.0,48.0
0.004,6,10,2006,5,927,1.0,659.0,659.0,5,1079,1.0,811.0,811.0
0.005,17,2,190,1,63,0.0,35.0,35.0,1,127,0.0,99.0,99.0
0.008,6,12,1926,6,1189,1.0,659.0,434.0,6,737,1.0,417.0,417.0
0.009,6,10,1983,5,910,2.0,642.0,642.0,5,1073,2.0,805.0,805.0
0.007,17,2,194,1,59,0.0,31.0,31.0,1,135,0.0,107.0,107.0
0.012,6,10,1762,5,911,3.0,643.0,643.0,5,851,3.0,583.0,583.0
0.039,17,2,152,1,76,0.0,48.0,48.0,1,76,0.0,48.0,48.0
311.032,17,20,1124,10,716,34552.0,48.0,43.0,10,408,34552.0,20.0,12.0
1777.99,17,141,44556,72,22752,25041.0,288.0,288.0,69,21804,26145.0,288.0,288.0
0.008,6,10,1983,5,910,2.0,642.0,642.0,5,1073,2.0,805.0,805.0
0.003,17,2,148,1,60,0.0,32.0,32.0,1,88,0.0,60.0,60.0
0.088,6,10,1506,5,395,20.0,127.0,127.0,5,1111,18.0,843.0,843.0
0.101,6,10,1506,5,395,22.0,127.0,127.0,5,1111,19.0,843.0,843.0
0.005,6,10,2007,5,928,1.0,660.0,660.0,5,1079,1.0,811.0,811.0
309.948,17,20,1124,10,716,34432.0,48.0,43.0,10,408,34432.0,20.0,12.0
0.005,6,10,1989,5,927,1.0,659.0,659.0,5,1062,1.0,794.0,794.0
0.005,17,2,170,1,65,0.0,37.0,37.0,1,105,0.0,77.0,77.0
0.005,6,10,2000,5,927,1.0,659.0,659.0,5,1073,1.0,805.0,805.0
0.006,6,10,1689,5,839,1.0,571.0,571.0,5,850,1.0,582.0,582.0
40.07,17,10,676,5,460,10015.0,104.0,64.0,5,216,10016.0,20.0,15.0
0.003,6,10,1702,5,863,0.0,595.0,595.0,5,839,0.0,571.0,571.0
0.007,6,10,1547,5,764,1.0,496.0,496.0,5,783,1.0,515.0,515.0
0.006,6,14,3799,7,509,0.0,137.0,137.0,7,3290,0.0,1448.0,972.0
0.04,17,2,186,1,61,0.0,33.0,33.0,1,125,0.0,97.0,97.0
0.094,6,10,1506,5,395,18.0,127.0,127.0,5,1111,22.0,843.0,843.0
0.04,17,2,166,1,75,0.0,47.0,47.0,1,91,0.0,63.0,63.0
0.004,17,2,412,1,61,0.0,33.0,33.0,1,351,0.0,323.0,323.0
0.068,6,10,1506,5,395,14.0,127.0,127.0,5,1111,15.0,843.0,843.0
0.012,6,10,1990,5,911,3.0,643.0,643.0,5,1079,2.0,811.0,811.0
0.11,6,22,2168,12,1185,10.0,426.0,140.0,10,983,11.0,212.0,77.0
0.041,17,4,284,2,120,1.0,32.0,32.0,2,164,37.0,60.0,54.0
0.005,6,10,2000,5,927,1.0,659.0,659.0,5,1073,1.0,805.0,805.0
0.004,17,2,136,1,60,0.0,32.0,32.0,1,76,0.0,48.0,48.0
0.071,6,10,1506,5,395,15.0,127.0,127.0,5,1111,14.0,843.0,843.0
9.072,17,6,376,5,280,2268.0,28.0,28.0,1,96,0.0,68.0,68.0
0.085,6,10,1506,5,395,18.0,127.0,127.0,5,1111,18.0,843.0,843.0
0.007,6,10,1989,5,910,1.0,642.0,642.0,5,1079,1.0,811.0,811.0
0.021,6,10,1631,5,848,5.0,580.0,580.0,5,783,5.0,515.0,515.0
0.001,17,2,180,1,65,0.0,37.0,37.0,1,115,0.0,87.0,87.0
0.005,6,13,3690,7,452,0.0,80.0,80.0,6,3238,1.0,1470.0,1459.0
0.006,17,2,164,1,74,0.0,46.0,46.0,1,90,0.0,62.0,62.0
0.008,6,10,1989,5,910,2.0,642.0,642.0,5,1079,2.0,811.0,811.0
0.005,6,10,1702,5,863,1.0,595.0,595.0,5,839,1.0,571.0,571.0
0.01,6,10,1631,5,848,2.0,580.0,580.0,5,783,2.0,515.0,515.0
0.076,6,10,1506,5,395,15.0,127.0,127.0,5,1111,16.0,843.0,843.0
305.265,17,16,928,8,608,43591.0,48.0,48.0,8,320,43591.0,12.0,12.0
0.005,6,10,2000,5,927,1.0,659.0,659.0,5,1073,1.0,805.0,805.0
0.009,6,10,1989,5,910,2.0,642.0,642.0,5,1079,2.0,811.0,811.0
0.088,6,10,1506,5,395,16.0,127.0,127.0,5,1111,21.0,843.0,843.0
40.046,17,10,676,5,460,10010.0,104.0,64.0,5,216,10010.0,20.0,15.0
240.009,6,9,787,5,488,60002.0,232.0,232.0,4,299,80002.0,83.0,83.0
308.756,17,20,1124,10,716,34299.0,48.0,43.0,10,408,34299.0,20.0,12.0
0.083,6,10,1506,5,395,18.0,127.0,127.0,5,1111,17.0,843.0,843.0
0.0,17,2,166,1,75,0.0,47.0,47.0,1,91,0.0,63.0,63.0
0.069,6,10,1506,5,395,15.0,127.0,127.0,5,1111,15.0,843.0,843.0
0.005,6,10,2006,5,927,1.0,659.0,659.0,5,1079,1.0,811.0,811.0
0.001,17,2,180,1,66,0.0,38.0,38.0,1,114,0.0,86.0,86.0
0.115,6,10,1506,5,395,26.0,127.0,127.0,5,1111,27.0,843.0,843.0
0.03,6,10,1631,5,848,7.0,580.0,580.0,5,783,7.0,515.0,515.0
0.017,6,10,1677,5,827,4.0,559.0,559.0,5,850,4.0,582.0,582.0
0.009,6,10,1631,5,848,2.0,580.0,580.0,5,783,2.0,515.0,515.0
0.005,6,10,2006,5,927,1.0,659.0,659.0,5,1079,1.0,811.0,811.0
0.096,6,14,3787,7,497,15.0,125.0,125.0,7,3290,16.0,1448.0,972.0
0.001,17,2,180,1,66,0.0,38.0,38.0,1,114,0.0,86.0,86.0
0.005,6,10,1689,5,839,1.0,571.0,571.0,5,850,1.0,582.0,582.0
0.005,6,10,1774,5,923,1.0,655.0,655.0,5,851,1.0,583.0,583.0
0.005,6,10,2007,5,928,1.0,660.0,660.0,5,1079,1.0,811.0,811.0
0.001,17,2,180,1,66,0.0,38.0,38.0,1,114,0.0,86.0,86.0
0.004,6,10,1702,5,863,1.0,595.0,595.0,5,839,0.0,571.0,571.0
0.005,17,2,170,1,65,0.0,37.0,37.0,1,105,0.0,77.0,77.0
0.012,6,10,1983,5,910,3.0,642.0,642.0,5,1073,3.0,805.0,805.0
0.017,6,10,1983,5,910,4.0,642.0,642.0,5,1073,4.0,805.0,805.0
0.0,17,2,136,1,60,0.0,32.0,32.0,1,76,0.0,48.0,48.0
369.792,6,22,2313,16,867,24652.0,195.0,195.0,6,1446,4641.0,419.0,398.0
0.041,17,2,152,1,76,0.0,48.0,48.0,1,76,0.0,48.0,48.0
0.013,6,13,3735,7,497,2.0,125.0,125.0,6,3238,2.0,1470.0,1459.0
366.116,6,22,2313,16,867,24407.0,195.0,195.0,6,1446,4641.0,419.0,398.0
0.013,6,10,1972,5,910,3.0,642.0,642.0,5,1062,3.0,794.0,794.0
0.004,17,2,148,1,60,0.0,32.0,32.0,1,88,0.0,60.0,60.0
0.004,17,2,148,1,60,0.0,32.0,32.0,1,88,0.0,60.0,60.0
0.017,6,10,1989,5,910,4.0,642.0,642.0,5,1079,4.0,811.0,811.0
0.01,6,10,1989,5,910,2.0,642.0,642.0,5,1079,2.0,811.0,811.0
0.006,17,2,230,1,68,0.0,40.0,40.0,1,162,0.0,134.0,134.0
0.006,6,10,2006,5,927,1.0,659.0,659.0,5,1079,1.0,811.0,811.0
0.005,6,10,1547,5,764,1.0,496.0,496.0,5,783,1.0,515.0,515.0
0.006,6,10,2006,5,927,1.0,659.0,659.0,5,1079,1.0,811.0,811.0
0.005,6,10,1989,5,927,1.0,659.0,659.0,5,1062,1.0,794.0,794.0
0.1,6,10,1506,5,395,22.0,127.0,127.0,5,1111,24.0,843.0,843.0
0.043,17,2,152,1,76,0.0,48.0,48.0,1,76,0.0,48.0,48.0
0.003,17,2,148,1,60,0.0,32.0,32.0,1,88,0.0,60.0,60.0
0.006,17,2,179,1,71,0.0,43.0,43.0,1,108,0.0,80.0,80.0
0.015,6,10,1989,5,910,3.0,642.0,642.0,5,1079,3.0,811.0,811.0
0.039,17,2,148,1,60,0.0,32.0,32.0,1,88,0.0,60.0,60.0
0.005,6,10,1989,5,927,1.0,659.0,659.0,5,1062,1.0,794.0,794.0
0.006,17,2,170,1,65,0.0,37.0,37.0,1,105,0.0,77.0,77.0
0.004,17,2,148,1,60,0.0,32.0,32.0,1,88,0.0,60.0,60.0
0.004,17,2,214,1,75,0.0,47.0,47.0,1,139,0.0,111.0,111.0
0.06,17,2,152,1,76,0.0,48.0,48.0,1,76,0.0,48.0,48.0
0.013,6,10,1989,5,910,3.0,642.0,642.0,5,1079,3.0,811.0,811.0
0.006,6,10,1547,5,764,1.0,496.0,496.0,5,783,1.0,515.0,515.0
354.048,6,21,1795,16,1030,23603.0,190.0,190.0,5,765,60003.0,464.0,248.0
0.006,6,10,1547,5,764,1.0,496.0,496.0,5,783,1.0,515.0,515.0
0.004,6,10,2000,5,927,1.0,659.0,659.0,5,1073,1.0,805.0,805.0
0.03,6,13,3735,7,497,5.0,125.0,125.0,6,3238,5.0,1470.0,1459.0
0.011,6,10,1989,5,910,2.0,642.0,642.0,5,1079,2.0,811.0,811.0
0.005,6,10,2006,5,927,1.0,659.0,659.0,5,1079,1.0,811.0,811.0
240.017,6,9,787,5,488,60004.0,232.0,232.0,4,299,80004.0,83.0,83.0
0.079,6,10,1506,5,395,17.0,127.0,127.0,5,1111,17.0,843.0,843.0
0.016,6,10,1972,5,910,4.0,642.0,642.0,5,1062,4.0,794.0,794.0
177.59,17,86,12397,43,2888,4228.0,44.0,39.0,43,9509,4228.0,239.0,193.0
40.068,17,10,676,5,460,10016.0,104.0,64.0,5,216,10016.0,20.0,15.0
0.005,6,10,1547,5,764,1.0,496.0,496.0,5,783,1.0,515.0,515.0
0.04,17,2,184,1,61,0.0,33.0,33.0,1,123,0.0,95.0,95.0
0.004,6,10,1779,5,928,1.0,660.0,660.0,5,851,1.0,583.0,583.0
0.098,6,10,1506,5,395,21.0,127.0,127.0,5,1111,23.0,843.0,843.0
0.005,6,13,3747,7,509,0.0,137.0,137.0,6,3238,0.0,1470.0,1459.0
0.006,17,2,144,1,64,0.0,36.0,36.0,1,80,0.0,52.0,52.0
0.02,6,10,1990,5,911,5.0,643.0,643.0,5,1079,4.0,811.0,811.0
0.1,6,10,1506,5,395,21.0,127.0,127.0,5,1111,21.0,843.0,843.0
0.005,17,2,164,1,74,0.0,46.0,46.0,1,90,0.0,62.0,62.0
0.013,6,10,1989,5,910,3.0,642.0,642.0,5,1079,3.0,811.0,811.0
0.009,6,13,3735,7,497,1.0,125.0,125.0,6,3238,1.0,1470.0,1459.0
0.062,6,10,1506,5,395,12.0,127.0,127.0,5,1111,15.0,843.0,843.0
0.006,17,2,136,1,60,0.0,32.0,32.0,1,76,0.0,48.0,48.0
0.112,6,10,1506,5,395,27.0,127.0,127.0,5,1111,22.0,843.0,843.0
0.003,17,2,148,1,60,0.0,32.0,32.0,1,88,0.0,60.0,60.0
0.005,17,2,215,1,68,0.0,40.0,40.0,1,147,0.0,119.0,119.0
15.077,17,16,8674,8,6529,2149.0,1350.0,788.0,8,2145,2149.0,1350.0,240.0
0.015,6,10,1983,5,910,3.0,642.0,642.0,5,1073,3.0,805.0,805.0
0.005,6,10,1643,5,860,1.0,592.0,592.0,5,783,1.0,515.0,515.0
0.118,6,10,1506,5,395,25.0,127.0,127.0,5,1111,25.0,843.0,843.0
0.004,6,10,2007,5,928,1.0,660.0,660.0,5,1079,1.0,811.0,811.0
0.006,17,2,164,1,74,0.0,46.0,46.0,1,90,0.0,62.0,62.0
40.076,17,10,676,5,460,10017.0,104.0,64.0,5,216,10018.0,20.0,15.0
0.016,6,13,3735,7,497,2.0,125.0,125.0,6,3238,3.0,1470.0,1459.0
1729.233,6,60,4400,40,2740,44339.0,33.0,33.0,20,1660,91003.0,31.0,31.0
0.009,6,10,1983,5,910,2.0,642.0,642.0,5,1073,2.0,805.0,805.0
0.005,6,10,2006,5,927,1.0,659.0,659.0,5,1079,1.0,811.0,811.0
0.004,17,4,284,2,120,0.0,32.0,32.0,2,164,1.0,60.0,54.0
0.076,6,10,1506,5,395,17.0,127.0,127.0,5,1111,16.0,843.0,843.0
0.006,6,10,1547,5,764,1.0,496.0,496.0,5,783,1.0,515.0,515.0
0.004,6,10,1779,5,928,1.0,660.0,660.0,5,851,1.0,583.0,583.0
0.007,17,2,179,1,71,0.0,43.0,43.0,1,108,0.0,80.0,80.0
0.294,6,16,2669,8,1395,42.0,533.0,323.0,8,1274,28.0,529.0,212.0
0.007,6,10,1983,5,910,1.0,642.0,642.0,5,1073,1.0,805.0,805.0
0.041,17,4,284,2,120,0.0,32.0,32.0,2,164,3.0,60.0,54.0
300.37,6,25,7300,15,1357,21455.0,217.0,142.0,10,5943,26700.0,1679.0,902.0
0.005,6,10,1989,5,927,1.0,659.0,659.0,5,1062,1.0,794.0,794.0
11.174,17,28,4419,14,1995,847.0,270.0,114.0,14,2424,846.0,587.0,145.0
0.128,17,2,80,1,32,0.0,4.0,4.0,1,48,0.0,20.0,20.0
0.068,6,10,1506,5,395,16.0,127.0,127.0,5,1111,16.0,843.0,843.0
0.005,6,10,1689,5,839,1.0,571.0,571.0,5,850,1.0,582.0,582.0
0.171,6,3,453,2,321,171.0,241.0,241.0,1,132,0.0,92.0,92.0
0.037,17,2,184,1,61,0.0,33.0,33.0,1,123,0.0,95.0,95.0
0.006,6,10,1689,5,839,1.0,571.0,571.0,5,850,1.0,582.0,582.0
0.016,6,10,1605,5,388,4.0,120.0,120.0,5,1217,3.0,949.0,949.0
373.938,6,22,2313,16,867,24929.0,195.0,195.0,6,1446,4674.0,419.0,398.0
0.102,6,10,1506,5,395,22.0,127.0,127.0,5,1111,21.0,843.0,843.0
0.076,6,10,1506,5,395,16.0,127.0,127.0,5,1111,16.0,843.0,843.0
0.004,6,10,1702,5,863,1.0,595.0,595.0,5,839,0.0,571.0,571.0
0.016,6,10,1989,5,910,4.0,642.0,642.0,5,1079,3.0,811.0,811.0
0.001,17,2,136,1,60,0.0,32.0,32.0,1,76,0.0,48.0,48.0
0.005,6,10,2007,5,928,1.0,660.0,660.0,5,1079,1.0,811.0,811.0
0.092,6,10,1506,5,395,20.0,127.0,127.0,5,1111,21.0,843.0,843.0
159.435,17,86,12129,43,2881,3795.0,44.0,39.0,43,9248,3796.0,239.0,187.0
0.015,6,10,1983,5,910,3.0,642.0,642.0,5,1073,3.0,805.0,805.0
0.011,6,10,1762,5,911,2.0,643.0,643.0,5,851,2.0,583.0,583.0
15.072,17,16,10617,9,8280,1880.0,1350.0,892.0,7,2337,2508.0,1350.0,305.0
0.005,6,10,2006,5,927,1.0,659.0,659.0,5,1079,1.0,811.0,811.0
0.081,6,10,1506,5,395,16.0,127.0,127.0,5,1111,17.0,843.0,843.0
0.074,6,10,1506,5,395,17.0,127.0,127.0,5,1111,17.0,843.0,843.0
76.224,6,22,8496,12,2236,76.0,1345.0,574.0,10,6260,8450.0,2720.0,974.0
9.009,6,36,9771,19,4293,500.0,1360.0,700.0,17,5478,550.0,2667.0,435.0
0.006,6,10,1689,5,839,1.0,571.0,571.0,5,850,1.0,582.0,582.0
40.051,17,10,676,5,460,10011.0,104.0,64.0,5,216,10011.0,20.0,15.0
10.767,17,28,4423,14,1994,819.0,269.0,114.0,14,2429,819.0,588.0,145.0
308.392,17,20,1124,10,716,34251.0,48.0,43.0,10,408,34251.0,20.0,12.0
0.005,17,2,214,1,75,0.0,47.0,47.0,1,139,0.0,111.0,111.0
0.006,17,2,175,1,65,0.0,37.0,37.0,1,110,0.0,82.0,82.0
1799.84,6,136,6550,76,3625,23997.0,39.0,39.0,60,2925,29991.0,35.0,35.0
40.072,17,10,676,5,460,10017.0,104.0,64.0,5,216,10017.0,20.0,15.0
0.118,6,10,1506,5,395,26.0,127.0,127.0,5,1111,25.0,843.0,843.0
11.458,17,28,4398,14,2311,868.0,586.0,137.0,14,2087,868.0,270.0,121.0
0.009,6,10,1983,5,910,2.0,642.0,642.0,5,1073,2.0,805.0,805.0
0.011,6,10,1972,5,910,2.0,642.0,642.0,5,1062,2.0,794.0,794.0
0.216,17,4,352,2,130,176.0,37.0,37.0,2,222,178.0,89.0,83.0
0.152,6,10,1506,5,395,32.0,127.0,127.0,5,1111,35.0,843.0,843.0
0.005,6,10,1989,5,927,1.0,659.0,659.0,5,1062,1.0,794.0,794.0
0.013,6,10,1990,5,911,3.0,643.0,643.0,5,1079,3.0,811.0,811.0
0.005,6,10,2006,5,927,1.0,659.0,659.0,5,1079,1.0,811.0,811.0
0.015,6,10,1983,5,910,3.0,642.0,642.0,5,1073,3.0,805.0,805.0
0.01,6,10,1990,5,911,2.0,643.0,643.0,5,1079,2.0,811.0,811.0
0.005,17,2,170,1,65,0.0,37.0,37.0,1,105,0.0,77.0,77.0
308.622,17,20,1124,10,716,34277.0,48.0,43.0,10,408,34277.0,20.0,12.0
66.444,6,25,10420,11,3921,6644.0,1591.0,838.0,14,6499,5101.0,2111.0,576.0
0.078,6,10,1506,5,395,18.0,127.0,127.0,5,1111,18.0,843.0,843.0
0.688,6,26,5552,13,1650,54.0,325.0,140.0,13,3902,48.0,1414.0,563.0
0.01,6,10,1762,5,911,2.0,643.0,643.0,5,851,2.0,583.0,583.0
0.104,6,10,1506,5,395,24.0,127.0,127.0,5,1111,23.0,843.0,843.0
0.003,17,2,148,1,60,0.0,32.0,32.0,1,88,0.0,60.0,60.0
0.003,17,2,148,1,60,0.0,32.0,32.0,1,88,0.0,60.0,60.0
0.001,17,2,180,1,66,0.0,38.0,38.0,1,114,0.0,86.0,86.0
0.005,6,10,2006,5,927,1.0,659.0,659.0,5,1079,1.0,811.0,811.0
0.006,17,2,180,1,58,0.0,30.0,30.0,1,122,0.0,94.0,94.0
0.007,17,2,140,1,62,0.0,34.0,34.0,1,78,0.0,50.0,50.0
0.083,6,10,1506,5,395,18.0,127.0,127.0,5,1111,17.0,843.0,843.0
0.021,6,10,1983,5,910,5.0,642.0,642.0,5,1073,5.0,805.0,805.0
0.005,6,14,3799,7,509,0.0,137.0,137.0,7,3290,0.0,1448.0,972.0
0.077,17,2,412,1,61,0.0,33.0,33.0,1,351,0.0,323.0,323.0
0.001,17,2,174,1,72,0.0,44.0,44.0,1,102,0.0,74.0,74.0
0.065,6,10,1506,5,395,14.0,127.0,127.0,5,1111,14.0,843.0,843.0
0.093,6,10,1506,5,395,18.0,127.0,127.0,5,1111,18.0,843.0,843.0
0.084,6,10,1506,5,395,19.0,127.0,127.0,5,1111,18.0,843.0,843.0
0.009,6,10,1990,5,911,2.0,643.0,643.0,5,1079,2.0,811.0,811.0
0.013,6,10,1983,5,910,3.0,642.0,642.0,5,1073,3.0,805.0,805.0
0.006,6,10,1547,5,764,1.0,496.0,496.0,5,783,1.0,515.0,515.0
1790.408,6,274,25530,138,8958,13068.0,748.0,295.0,136,16572,13262.0,1626.0,72.0
0.006,6,10,1643,5,860,1.0,592.0,592.0,5,783,1.0,515.0,515.0
0.072,17,8,3613,4,1874,24.0,1350.0,440.0,4,1739,12.0,1350.0,406.0
280.378,6,23,6075,10,1186,31152.0,267.0,156.0,13,4889,23364.0,1400.0,873.0
0.011,6,10,1643,5,860,2.0,592.0,592.0,5,783,2.0,515.0,515.0
0.005,6,10,1779,5,928,1.0,660.0,660.0,5,851,1.0,583.0,583.0
0.005,6,10,2007,5,928,1.0,660.0,660.0,5,1079,1.0,811.0,811.0
0.016,6,10,1972,5,910,4.0,642.0,642.0,5,1062,3.0,794.0,794.0
0.019,6,10,1989,5,910,4.0,642.0,642.0,5,1079,4.0,811.0,811.0
0.006,17,2,170,1,65,0.0,37.0,37.0,1,105,0.0,77.0,77.0
0.01,6,10,1762,5,911,2.0,643.0,643.0,5,851,2.0,583.0,583.0
364.343,6,21,1793,16,1030,24289.0,190.0,190.0,5,763,60010.0,462.0,247.0
0.01,6,10,1989,5,910,2.0,642.0,642.0,5,1079,2.0,811.0,811.0
0.091,6,10,1506,5,395,18.0,127.0,127.0,5,1111,18.0,843.0,843.0
0.045,6,10,1677,5,827,11.0,559.0,559.0,5,850,11.0,582.0,582.0
0.054,17,2,152,1,76,0.0,48.0,48.0,1,76,0.0,48.0,48.0
0.099,6,10,1506,5,395,21.0,127.0,127.0,5,1111,24.0,843.0,843.0
0.005,6,10,1989,5,927,1.0,659.0,659.0,5,1062,1.0,794.0,794.0
0.01,6,10,1989,5,910,2.0,642.0,642.0,5,1079,2.0,811.0,811.0
0.01,6,10,1972,5,910,2.0,642.0,642.0,5,1062,2.0,794.0,794.0
40.052,17,10,676,5,460,10012.0,104.0,64.0,5,216,10012.0,20.0,15.0
0.004,6,10,1702,5,863,1.0,595.0,595.0,5,839,0.0,571.0,571.0
0.009,6,10,1989,5,910,2.0,642.0,642.0,5,1079,2.0,811.0,811.0
0.014,6,10,1762,5,911,3.0,643.0,643.0,5,851,3.0,583.0,583.0
0.005,6,10,1643,5,860,1.0,592.0,592.0,5,783,1.0,515.0,515.0
40.054,17,10,676,5,460,10012.0,104.0,64.0,5,216,10012.0,20.0,15.0
0.072,17,2,148,1,60,0.0,32.0,32.0,1,88,0.0,60.0,60.0
0.012,6,10,1774,5,923,3.0,655.0,655.0,5,851,2.0,583.0,583.0
0.004,6,10,2006,5,927,1.0,659.0,659.0,5,1079,1.0,811.0,811.0
0.017,6,10,1989,5,910,4.0,642.0,642.0,5,1079,4.0,811.0,811.0
0.006,6,12,1698,6,863,1.0,327.0,271.0,6,835,1.0,515.0,515.0
0.016,6,13,3913,7,495,2.0,123.0,123.0,6,3418,3.0,1650.0,1549.0
300.245,6,28,7500,16,1421,20016.0,217.0,142.0,12,6079,21841.0,1679.0,778.0
0.001,17,2,180,1,66,0.0,38.0,38.0,1,114,0.0,86.0,86.0
0.004,17,2,136,1,60,0.0,32.0,32.0,1,76,0.0,48.0,48.0
0.093,6,10,1506,5,395,22.0,127.0,127.0,5,1111,20.0,843.0,843.0
0.004,6,10,1989,5,927,1.0,659.0,659.0,5,1062,1.0,794.0,794.0
0.006,6,10,1547,5,764,1.0,496.0,496.0,5,783,1.0,515.0,515.0
0.006,6,10,1547,5,764,1.0,496.0,496.0,5,783,1.0,515.0,515.0
0.011,6,10,1990,5,911,2.0,643.0,643.0,5,1079,2.0,811.0,811.0
176.1,17,76,10710,38,2529,4759.0,44.0,38.0,38,8181,4759.0,239.0,187.0
0.066,17,8,3613,4,1874,22.0,1350.0,440.0,4,1739,10.0,1350.0,406.0
0.006,6,10,1547,5,764,1.0,496.0,496.0,5,783,1.0,515.0,515.0
0.017,6,10,1989,5,910,4.0,642.0,642.0,5,1079,4.0,811.0,811.0
0.011,6,10,1989,5,910,2.0,642.0,642.0,5,1079,2.0,811.0,811.0
240.127,6,16,4481,9,963,30015.0,238.0,166.0,7,3518,40020.0,1402.0,786.0
0.087,6,10,1506,5,395,19.0,127.0,127.0,5,1111,19.0,843.0,843.0
0.004,6,10,2007,5,928,1.0,660.0,660.0,5,1079,1.0,811.0,811.0
0.006,6,10,1547,5,764,1.0,496.0,496.0,5,783,1.0,515.0,515.0
8.908,6,36,9771,19,4293,494.0,1360.0,700.0,17,5478,544.0,2667.0,435.0
300.326,6,16,2170,9,684,37520.0,146.0,146.0,7,1486,50027.0,419.0,398.0
0.123,6,10,1506,5,395,28.0,127.0,127.0,5,1111,28.0,843.0,843.0
0.1,6,10,1506,5,395,20.0,127.0,127.0,5,1111,21.0,843.0,843.0
0.006,6,10,1689,5,839,1.0,571.0,571.0,5,850,1.0,582.0,582.0
0.005,6,10,2006,5,927,1.0,659.0,659.0,5,1079,1.0,811.0,811.0
40.067,17,10,676,5,460,10015.0,104.0,64.0,5,216,10015.0,20.0,15.0
0.005,6,10,2007,5,928,1.0,660.0,660.0,5,1079,1.0,811.0,811.0
0.005,6,10,1854,5,889,1.0,621.0,621.0,5,965,1.0,697.0,697.0
0.004,6,10,2000,5,927,1.0,659.0,659.0,5,1073,1.0,805.0,805.0
10.894,17,28,4395,14,1994,829.0,269.0,114.0,14,2401,829.0,588.0,143.0
0.005,6,10,2007,5,928,1.0,660.0,660.0,5,1079,1.0,811.0,811.0
0.124,6,10,1506,5,395,29.0,127.0,127.0,5,1111,24.0,843.0,843.0
178.352,17,82,11531,41,2741,4458.0,44.0,38.0,41,8790,4458.0,261.0,186.0
0.09,6,10,1506,5,395,19.0,127.0,127.0,5,1111,19.0,843.0,843.0
0.069,6,10,1506,5,395,16.0,127.0,127.0,5,1111,15.0,843.0,843.0
0.004,17,2,136,1,60,0.0,32.0,32.0,1,76,0.0,48.0,48.0
0.001,17,2,132,1,58,0.0,30.0,30.0,1,74,0.0,46.0,46.0
0.082,6,10,1506,5,395,19.0,127.0,127.0,5,1111,15.0,843.0,843.0
0.039,17,2,136,1,60,0.0,32.0,32.0,1,76,0.0,48.0,48.0
0.005,6,10,2000,5,927,1.0,659.0,659.0,5,1073,1.0,805.0,805.0
10.826,17,28,4419,14,1995,824.0,270.0,114.0,14,2424,823.0,587.0,145.0
0.088,6,10,1506,5,395,18.0,127.0,127.0,5,1111,20.0,843.0,843.0
0.004,17,2,179,1,71,0.0,43.0,43.0,1,108,0.0,80.0,80.0
0.005,6,10,2006,5,927,1.0,659.0,659.0,5,1079,1.0,811.0,811.0
0.017,6,10,1990,5,911,4.0,643.0,643.0,5,1079,4.0,811.0,811.0
0.011,6,10,1972,5,910,2.0,642.0,642.0,5,1062,2.0,794.0,794.0
0.015,6,10,1972,5,910,3.0,642.0,642.0,5,1062,3.0,794.0,794.0
351.987,6,20,2210,6,1308,12003.0,494.0,494.0,14,902,27075.0,83.0,83.0
0.006,6,10,1547,5,764,1.0,496.0,496.0,5,783,1.0,515.0,515.0
0.005,17,2,230,1,68,0.0,40.0,40.0,1,162,0.0,134.0,134.0
0.006,6,10,2006,5,927,1.0,659.0,659.0,5,1079,1.0,811.0,811.0
0.13,17,4,284,2,120,0.0,32.0,32.0,2,164,92.0,60.0,54.0
0.009,17,4,284,2,120,6.0,32.0,32.0,2,164,6.0,60.0,54.0
0.006,6,10,1547,5,764,1.0,496.0,496.0,5,783,1.0,515.0,515.0
0.003,17,2,148,1,60,0.0,32.0,32.0,1,88,0.0,60.0,60.0
0.014,6,10,1990,5,911,3.0,643.0,643.0,5,1079,3.0,811.0,811.0
0.005,6,10,1989,5,927,1.0,659.0,659.0,5,1062,1.0,794.0,794.0
308.537,17,20,1124,10,716,34267.0,48.0,43.0,10,408,34267.0,20.0,12.0
40.058,17,10,676,5,460,10012.0,104.0,64.0,5,216,10013.0,20.0,15.0
0.005,17,2,179,1,71,0.0,43.0,43.0,1,108,0.0,80.0,80.0
0.012,6,10,1972,5,910,3.0,642.0,642.0,5,1062,3.0,794.0,794.0
40.063,17,10,676,5,460,10013.0,104.0,64.0,5,216,10014.0,20.0,15.0
10.807,17,28,4421,14,1993,822.0,268.0,114.0,14,2428,822.0,587.0,145.0
0.013,6,10,1983,5,910,3.0,642.0,642.0,5,1073,3.0,805.0,805.0
0.004,6,10,2006,5,927,1.0,659.0,659.0,5,1079,1.0,811.0,811.0
0.001,17,2,180,1,66,0.0,38.0,38.0,1,114,0.0,86.0,86.0
0.072,17,2,182,1,65,0.0,37.0,37.0,1,117,0.0,89.0,89.0
0.092,6,10,1506,5,395,16.0,127.0,127.0,5,1111,21.0,843.0,843.0
294.355,17,114,16090,57,3802,5256.0,44.0,38.0,57,12288,5256.0,261.0,187.0
15.086,17,15,8174,8,6092,2151.0,1350.0,733.0,7,2082,2509.0,1350.0,269.0
0.006,6,10,1989,5,927,1.0,659.0,659.0,5,1062,1.0,794.0,794.0
0.073,6,10,1506,5,395,16.0,127.0,127.0,5,1111,16.0,843.0,843.0
0.004,6,10,1702,5,863,1.0,595.0,595.0,5,839,1.0,571.0,571.0
0.012,6,10,1989,5,910,2.0,642.0,642.0,5,1079,3.0,811.0,811.0
0.016,6,10,1983,5,910,3.0,642.0,642.0,5,1073,3.0,805.0,805.0
0.004,6,10,2007,5,928,1.0,660.0,660.0,5,1079,1.0,811.0,811.0
0.004,17,4,284,2,120,0.0,32.0,32.0,2,164,0.0,60.0,54.0
0.008,6,10,1972,5,910,2.0,642.0,642.0,5,1062,2.0,794.0,794.0
240.24,6,39,5244,19,2386,13346.0,588.0,196.0,20,2858,12644.0,580.0,226.0
0.1,6,10,1506,5,395,22.0,127.0,127.0,5,1111,21.0,843.0,843.0
0.092,6,10,1506,5,395,16.0,127.0,127.0,5,1111,19.0,843.0,843.0
0.004,6,10,2006,5,927,1.0,659.0,659.0,5,1079,1.0,811.0,811.0
0.009,6,10,1983,5,910,2.0,642.0,642.0,5,1073,2.0,805.0,805.0
0.005,6,10,1854,5,889,1.0,621.0,621.0,5,965,1.0,697.0,697.0
0.016,6,10,1972,5,910,3.0,642.0,642.0,5,1062,4.0,794.0,794.0
0.014,6,10,1989,5,910,3.0,642.0,642.0,5,1079,3.0,811.0,811.0
0.042,17,2,170,1,65,0.0,37.0,37.0,1,105,0.0,77.0,77.0
0.005,6,10,1689,5,839,1.0,571.0,571.0,5,850,1.0,582.0,582.0
0.013,6,10,1972,5,910,3.0,642.0,642.0,5,1062,3.0,794.0,794.0
40.067,17,10,676,5,460,10013.0,104.0,64.0,5,216,10016.0,20.0,15.0
0.008,6,10,1972,5,910,1.0,642.0,642.0,5,1062,1.0,794.0,794.0
0.004,17,2,136,1,60,0.0,32.0,32.0,1,76,0.0,48.0,48.0
0.08,6,10,1506,5,395,17.0,127.0,127.0,5,1111,18.0,843.0,843.0
0.006,17,2,140,1,62,0.0,34.0,34.0,1,78,0.0,50.0,50.0
0.004,6,10,1702,5,863,1.0,595.0,595.0,5,839,1.0,571.0,571.0
0.008,6,10,1989,5,910,2.0,642.0,642.0,5,1079,1.0,811.0,811.0
0.005,6,10,1989,5,927,1.0,659.0,659.0,5,1062,1.0,794.0,794.0
0.017,6,10,1989,5,910,4.0,642.0,642.0,5,1079,4.0,811.0,811.0
0.005,6,10,1547,5,764,1.0,496.0,496.0,5,783,1.0,515.0,515.0
0.006,6,10,1854,5,889,1.0,621.0,621.0,5,965,1.0,697.0,697.0
0.005,6,10,2006,5,927,1.0,659.0,659.0,5,1079,1.0,811.0,811.0
0.006,6,10,1547,5,764,1.0,496.0,496.0,5,783,1.0,515.0,515.0
0.014,6,10,1983,5,910,3.0,642.0,642.0,5,1073,3.0,805.0,805.0
0.004,17,4,284,2,120,0.0,32.0,32.0,2,164,1.0,60.0,54.0
0.005,17,2,230,1,68,0.0,40.0,40.0,1,162,0.0,134.0,134.0
0.02,6,10,1989,5,910,4.0,642.0,642.0,5,1079,4.0,811.0,811.0
0.006,6,10,1643,5,860,1.0,592.0,592.0,5,783,1.0,515.0,515.0
0.005,6,10,1643,5,860,1.0,592.0,592.0,5,783,1.0,515.0,515.0
0.005,6,10,1689,5,839,1.0,571.0,571.0,5,850,1.0,582.0,582.0
10.855,17,28,4417,14,1993,826.0,268.0,114.0,14,2424,826.0,587.0,145.0
0.102,6,10,1506,5,395,22.0,127.0,127.0,5,1111,25.0,843.0,843.0
40.095,17,10,676,5,460,10014.0,104.0,64.0,5,216,10022.0,20.0,15.0
0.009,6,10,1990,5,911,2.0,643.0,643.0,5,1079,2.0,811.0,811.0
0.004,6,10,1702,5,863,1.0,595.0,595.0,5,839,1.0,571.0,571.0
0.005,17,2,140,1,62,0.0,34.0,34.0,1,78,0.0,50.0,50.0
0.039,17,4,364,2,160,0.0,52.0,52.0,2,204,2.0,80.0,74.0
0.006,6,10,1547,5,764,1.0,496.0,496.0,5,783,1.0,515.0,515.0
0.075,6,10,1506,5,395,16.0,127.0,127.0,5,1111,15.0,843.0,843.0
0.004,17,4,284,2,120,1.0,32.0,32.0,2,164,1.0,60.0,54.0
0.006,6,10,2006,5,927,1.0,659.0,659.0,5,1079,1.0,811.0,811.0
0.005,17,2,180,1,66,0.0,38.0,38.0,1,114,0.0,86.0,86.0
40.055,17,10,676,5,460,10012.0,104.0,64.0,5,216,10012.0,20.0,15.0
240.096,6,16,4481,9,963,30012.0,238.0,166.0,7,3518,40015.0,1402.0,786.0
0.004,17,2,179,1,71,0.0,43.0,43.0,1,108,0.0,80.0,80.0
0.04,17,2,170,1,65,0.0,37.0,37.0,1,105,0.0,77.0,77.0
240.201,6,27,14018,13,8900,20016.0,2736.0,1371.0,14,5118,18476.0,1657.0,1095.0
0.007,6,10,1762,5,911,1.0,643.0,643.0,5,851,1.0,583.0,583.0
0.037,17,4,420,2,122,1.0,33.0,33.0,2,298,33.0,145.0,121.0
0.013,6,10,1990,5,911,3.0,643.0,643.0,5,1079,3.0,811.0,811.0
0.005,17,2,152,1,68,0.0,40.0,40.0,1,84,0.0,56.0,56.0
0.004,6,10,1702,5,863,0.0,595.0,595.0,5,839,1.0,571.0,571.0
0.004,6,10,1989,5,927,1.0,659.0,659.0,5,1062,1.0,794.0,794.0
0.053,17,2,152,1,76,0.0,48.0,48.0,1,76,0.0,48.0,48.0
0.1,6,10,1506,5,395,21.0,127.0,127.0,5,1111,18.0,843.0,843.0
0.001,17,2,180,1,66,0.0,38.0,38.0,1,114,0.0,86.0,86.0
0.005,6,10,2007,5,928,1.0,660.0,660.0,5,1079,1.0,811.0,811.0
0.006,6,10,1547,5,764,1.0,496.0,496.0,5,783,1.0,515.0,515.0
0.004,6,10,1989,5,927,1.0,659.0,659.0,5,1062,1.0,794.0,794.0
0.006,6,14,3799,7,509,1.0,137.0,137.0,7,3290,0.0,1448.0,972.0
0.004,17,2,136,1,60,0.0,32.0,32.0,1,76,0.0,48.0,48.0
0.25,17,16,8545,8,6037,35.0,1350.0,726.0,8,2508,30.0,1350.0,285.0
0.037,17,2,412,1,61,0.0,33.0,33.0,1,351,0.0,323.0,323.0
0.006,6,10,1547,5,764,1.0,496.0,496.0,5,783,1.0,515.0,515.0
0.004,6,10,2007,5,928,1.0,660.0,660.0,5,1079,1.0,811.0,811.0
0.013,6,10,1972,5,910,3.0,642.0,642.0,5,1062,3.0,794.0,794.0
0.012,6,10,1762,5,911,3.0,643.0,643.0,5,851,2.0,583.0,583.0
0.088,6,10,1506,5,395,21.0,127.0,127.0,5,1111,19.0,843.0,843.0
0.006,17,2,214,1,75,0.0,47.0,47.0,1,139,0.0,111.0,111.0
0.007,6,10,1989,5,910,1.0,642.0,642.0,5,1079,1.0,811.0,811.0
0.016,6,10,1983,5,910,4.0,642.0,642.0,5,1073,3.0,805.0,805.0
0.012,6,14,3787,7,497,2.0,125.0,125.0,7,3290,2.0,1448.0,972.0
0.001,17,2,180,1,66,0.0,38.0,38.0,1,114,0.0,86.0,86.0
0.003,17,2,185,1,73,0.0,45.0,45.0,1,112,0.0,84.0,84.0
0.012,6,10,1990,5,911,3.0,643.0,643.0,5,1079,3.0,811.0,811.0
0.005,17,2,166,1,75,0.0,47.0,47.0,1,91,0.0,63.0,63.0
0.006,6,10,1854,5,889,1.0,621.0,621.0,5,965,1.0,697.0,697.0
0.004,17,2,148,1,60,0.0,32.0,32.0,1,88,0.0,60.0,60.0
0.005,6,10,2006,5,927,1.0,659.0,659.0,5,1079,1.0,811.0,811.0
0.003,17,2,148,1,60,0.0,32.0,32.0,1,88,0.0,60.0,60.0
0.015,6,13,3735,7,497,2.0,125.0,125.0,6,3238,3.0,1470.0,1459.0
0.004,17,2,148,1,60,0.0,32.0,32.0,1,88,0.0,60.0,60.0
0.005,6,14,3742,7,452,0.0,80.0,80.0,7,3290,0.0,1448.0,972.0
0.072,6,10,1506,5,395,15.0,127.0,127.0,5,1111,14.0,843.0,843.0
0.014,6,10,1631,5,848,3.0,580.0,580.0,5,783,3.0,515.0,515.0
0.109,6,10,1506,5,395,22.0,127.0,127.0,5,1111,22.0,843.0,843.0
0.006,6,10,1854,5,889,1.0,621.0,621.0,5,965,1.0,697.0,697.0
0.001,17,2,180,1,66,0.0,38.0,38.0,1,114,0.0,86.0,86.0
0.037,17,2,186,1,61,0.0,33.0,33.0,1,125,0.0,97.0,97.0
0.005,17,2,230,1,68,0.0,40.0,40.0,1,162,0.0,134.0,134.0
0.005,6,10,2006,5,927,1.0,659.0,659.0,5,1079,1.0,811.0,811.0
0.01,6,10,1762,5,911,2.0,643.0,643.0,5,851,2.0,583.0,583.0
0.079,6,10,1506,5,395,18.0,127.0,127.0,5,1111,17.0,843.0,843.0
0.009,6,10,1990,5,911,2.0,643.0,643.0,5,1079,2.0,811.0,811.0
0.005,17,2,243,1,68,0.0,40.0,40.0,1,175,0.0,147.0,147.0
0.011,6,10,1989,5,910,2.0,642.0,642.0,5,1079,2.0,811.0,811.0
0.011,6,10,1990,5,911,2.0,643.0,643.0,5,1079,2.0,811.0,811.0
0.006,17,2,214,1,75,0.0,47.0,47.0,1,139,0.0,111.0,111.0
0.005,6,13,3747,7,509,0.0,137.0,137.0,6,3238,1.0,1470.0,1459.0
0.027,17,2,179,1,71,0.0,43.0,43.0,1,108,0.0,80.0,80.0
0.005,6,10,1547,5,764,1.0,496.0,496.0,5,783,1.0,515.0,515.0
40.064,17,10,676,5,460,10014.0,104.0,64.0,5,216,10014.0,20.0,15.0
0.185,17,4,352,2,130,145.0,37.0,37.0,2,222,146.0,89.0,83.0
0.004,6,10,1702,5,863,1.0,595.0,595.0,5,839,1.0,571.0,571.0
0.013,6,10,1989,5,910,3.0,642.0,642.0,5,1079,3.0,811.0,811.0
0.005,6,10,1779,5,928,1.0,660.0,660.0,5,851,1.0,583.0,583.0
0.116,6,10,1506,5,395,26.0,127.0,127.0,5,1111,25.0,843.0,843.0
0.028,6,10,1989,5,910,6.0,642.0,642.0,5,1079,6.0,811.0,811.0
0.016,6,10,1762,5,911,4.0,643.0,643.0,5,851,3.0,583.0,583.0
0.006,17,2,136,1,60,0.0,32.0,32.0,1,76,0.0,48.0,48.0
0.012,6,10,1631,5,848,2.0,580.0,580.0,5,783,2.0,515.0,515.0
0.004,17,2,148,1,60,0.0,32.0,32.0,1,88,0.0,60.0,60.0
0.005,6,10,2000,5,927,1.0,659.0,659.0,5,1073,1.0,805.0,805.0
0.006,6,10,1547,5,764,1.0,496.0,496.0,5,783,1.0,515.0,515.0
0.016,6,10,1762,5,911,4.0,643.0,643.0,5,851,3.0,583.0,583.0
0.005,6,10,2006,5,927,1.0,659.0,659.0,5,1079,1.0,811.0,811.0
0.004,6,10,2007,5,928,1.0,660.0,660.0,5,1079,1.0,811.0,811.0
0.024,6,10,1972,5,910,5.0,642.0,642.0,5,1062,6.0,794.0,794.0
0.097,6,10,1506,5,395,21.0,127.0,127.0,5,1111,20.0,843.0,843.0
0.011,6,10,1989,5,910,2.0,642.0,642.0,5,1079,2.0,811.0,811.0
311.278,17,20,1124,10,716,34572.0,48.0,43.0,10,408,34572.0,20.0,12.0
10.794,17,28,4422,14,1993,821.0,268.0,114.0,14,2429,821.0,588.0,145.0
240.218,6,47,24735,21,2041,12010.0,590.0,238.0,26,22694,9608.0,1402.0,1015.0
0.005,6,10,1643,5,860,1.0,592.0,592.0,5,783,1.0,515.0,515.0
0.07,17,8,3613,4,1874,23.0,1350.0,440.0,4,1739,12.0,1350.0,406.0
0.013,17,2,152,1,56,0.0,28.0,28.0,1,96,0.0,68.0,68.0
0.005,6,10,2006,5,927,1.0,659.0,659.0,5,1079,1.0,811.0,811.0
0.001,17,2,180,1,65,0.0,37.0,37.0,1,115,0.0,87.0,87.0
0.066,17,8,3613,4,1874,22.0,1350.0,440.0,4,1739,10.0,1350.0,406.0
0.016,6,10,1762,5,911,4.0,643.0,643.0,5,851,3.0,583.0,583.0
0.004,6,10,1702,5,863,1.0,595.0,595.0,5,839,0.0,571.0,571.0
0.003,17,2,148,1,60,0.0,32.0,32.0,1,88,0.0,60.0,60.0
0.013,6,10,1990,5,911,3.0,643.0,643.0,5,1079,3.0,811.0,811.0
0.011,6,10,1989,5,910,2.0,642.0,642.0,5,1079,2.0,811.0,811.0
0.009,6,12,1926,6,1189,1.0,659.0,434.0,6,737,1.0,417.0,417.0
40.054,17,10,676,5,460,10012.0,104.0,64.0,5,216,10012.0,20.0,15.0
40.056,17,10,676,5,460,10012.0,104.0,64.0,5,216,10013.0,20.0,15.0
15.074,17,16,10617,9,8280,1880.0,1350.0,892.0,7,2337,2507.0,1350.0,305.0
40.061,17,10,676,5,460,10014.0,104.0,64.0,5,216,10014.0,20.0,15.0
0.068,6,10,1506,5,395,15.0,127.0,127.0,5,1111,14.0,843.0,843.0
0.014,6,10,1989,5,910,3.0,642.0,642.0,5,1079,3.0,811.0,811.0
0.073,6,10,1506,5,395,17.0,127.0,127.0,5,1111,16.0,843.0,843.0
0.005,6,10,2006,5,927,1.0,659.0,659.0,5,1079,1.0,811.0,811.0
0.086,6,10,1506,5,395,19.0,127.0,127.0,5,1111,19.0,843.0,843.0
0.009,6,10,1989,5,910,2.0,642.0,642.0,5,1079,2.0,811.0,811.0
0.008,6,10,1983,5,910,1.0,642.0,642.0,5,1073,1.0,805.0,805.0
0.013,6,10,1990,5,911,3.0,643.0,643.0,5,1079,3.0,811.0,811.0
0.001,17,2,136,1,60,0.0,32.0,32.0,1,76,0.0,48.0,48.0
0.005,17,2,170,1,65,0.0,37.0,37.0,1,105,0.0,77.0,77.0
0.008,6,10,1989,5,910,2.0,642.0,642.0,5,1079,2.0,811.0,811.0
175.463,17,80,11220,40,2673,4498.0,44.0,38.0,40,8547,4498.0,239.0,185.0
0.004,6,10,2000,5,927,1.0,659.0,659.0,5,1073,1.0,805.0,805.0
0.004,6,10,2007,5,928,1.0,660.0,660.0,5,1079,1.0,811.0,811.0
0.279,17,4,352,2,130,147.0,37.0,37.0,2,222,239.0,89.0,83.0
0.074,6,10,1506,5,395,18.0,127.0,127.0,5,1111,16.0,843.0,843.0
0.016,6,13,3735,7,497,2.0,125.0,125.0,6,3238,3.0,1470.0,1459.0
0.005,6,10,1547,5,764,1.0,496.0,496.0,5,783,1.0,515.0,515.0
0.052,17,2,152,1,76,0.0,48.0,48.0,1,76,0.0,48.0,48.0
0.04,17,2,412,1,61,0.0,33.0,33.0,1,351,0.0,323.0,323.0
0.016,6,10,1989,5,910,3.0,642.0,642.0,5,1079,4.0,811.0,811.0
385.258,17,116,16500,58,3857,6758.0,44.0,38.0,58,12643,6758.0,239.0,189.0
0.001,17,2,142,1,63,0.0,35.0,35.0,1,79,0.0,51.0,51.0
0.959,6,22,5168,11,1138,83.0,267.0,115.0,11,4030,83.0,1414.0,597.0
0.005,17,2,180,1,66,0.0,38.0,38.0,1,114,0.0,86.0,86.0
0.041,17,4,352,2,130,1.0,37.0,37.0,2,222,1.0,89.0,83.0
40.065,17,10,676,5,460,10013.0,104.0,64.0,5,216,10013.0,20.0,15.0
0.005,6,10,1989,5,927,1.0,659.0,659.0,5,1062,1.0,794.0,794.0
0.004,6,10,1989,5,927,1.0,659.0,659.0,5,1062,1.0,794.0,794.0
0.004,6,10,1774,5,923,1.0,655.0,655.0,5,851,1.0,583.0,583.0
0.005,6,10,1989,5,927,1.0,659.0,659.0,5,1062,1.0,794.0,794.0
10.73,17,28,4421,14,1993,816.0,268.0,114.0,14,2428,816.0,587.0,145.0
0.005,6,10,1989,5,927,1.0,659.0,659.0,5,1062,1.0,794.0,794.0
0.092,6,10,1506,5,395,19.0,127.0,127.0,5,1111,20.0,843.0,843.0
0.001,17,2,180,1,66,0.0,38.0,38.0,1,114,0.0,86.0,86.0
0.122,6,10,1506,5,395,28.0,127.0,127.0,5,1111,23.0,843.0,843.0
0.011,6,12,1926,6,1189,2.0,659.0,434.0,6,737,2.0,417.0,417.0
0.004,6,10,2006,5,927,1.0,659.0,659.0,5,1079,1.0,811.0,811.0
308.386,17,20,1124,10,716,34251.0,48.0,43.0,10,408,34251.0,20.0,12.0
0.018,6,10,1631,5,848,4.0,580.0,580.0,5,783,4.0,515.0,515.0
0.09,6,10,1506,5,395,20.0,127.0,127.0,5,1111,18.0,843.0,843.0
0.006,6,10,1643,5,860,1.0,592.0,592.0,5,783,1.0,515.0,515.0
0.005,6,10,2007,5,928,1.0,660.0,660.0,5,1079,1.0,811.0,811.0
0.015,6,10,1983,5,910,3.0,642.0,642.0,5,1073,3.0,805.0,805.0
0.088,6,10,1506,5,395,19.0,127.0,127.0,5,1111,18.0,843.0,843.0
40.055,17,10,676,5,460,10012.0,104.0,64.0,5,216,10012.0,20.0,15.0
0.017,6,10,1972,5,910,4.0,642.0,642.0,5,1062,4.0,794.0,794.0
0.004,6,10,1702,5,863,1.0,595.0,595.0,5,839,1.0,571.0,571.0
0.013,17,2,194,1,59,0.0,31.0,31.0,1,135,0.0,107.0,107.0
40.047,17,10,676,5,460,10010.0,104.0,64.0,5,216,10010.0,20.0,15.0
0.013,6,10,1989,5,910,3.0,642.0,642.0,5,1079,3.0,811.0,811.0
0.001,17,2,180,1,66,0.0,38.0,38.0,1,114,0.0,86.0,86.0
0.006,6,10,1547,5,764,1.0,496.0,496.0,5,783,1.0,515.0,515.0
0.011,6,12,1926,6,1189,2.0,659.0,434.0,6,737,2.0,417.0,417.0
0.015,6,10,1990,5,911,3.0,643.0,643.0,5,1079,3.0,811.0,811.0
0.006,6,10,1547,5,764,1.0,496.0,496.0,5,783,1.0,515.0,515.0
40.064,17,10,676,5,460,10014.0,104.0,64.0,5,216,10015.0,20.0,15.0
0.001,17,2,140,1,62,0.0,34.0,34.0,1,78,0.0,50.0,50.0
1796.426,6,246,46791,119,34126,15223.0,1368.0,900.0,127,12665,14257.0,580.0,61.0
0.022,6,10,1983,5,910,5.0,642.0,642.0,5,1073,5.0,805.0,805.0
0.008,6,10,1677,5,827,2.0,559.0,559.0,5,850,1.0,582.0,582.0
0.006,6,10,1547,5,764,1.0,496.0,496.0,5,783,1.0,515.0,515.0
0.006,6,10,1547,5,764,1.0,496.0,496.0,5,783,1.0,515.0,515.0
0.074,6,10,1506,5,395,12.0,127.0,127.0,5,1111,16.0,843.0,843.0
0.008,6,10,1702,5,863,2.0,595.0,595.0,5,839,1.0,571.0,571.0
40.057,17,10,676,5,460,10013.0,104.0,64.0,5,216,10013.0,20.0,15.0
0.009,6,10,1989,5,910,2.0,642.0,642.0,5,1079,2.0,811.0,811.0
240.012,6,9,787,5,488,60003.0,232.0,232.0,4,299,80003.0,83.0,83.0
0.018,6,10,1972,5,910,4.0,642.0,642.0,5,1062,4.0,794.0,794.0
0.004,6,10,1774,5,923,1.0,655.0,655.0,5,851,1.0,583.0,583.0
240.094,6,30,9269,15,6752,17149.0,1877.0,664.0,15,2517,17149.0,580.0,247.0
40.067,17,10,676,5,460,10016.0,104.0,64.0,5,216,10015.0,20.0,15.0
0.005,6,10,1547,5,764,1.0,496.0,496.0,5,783,1.0,515.0,515.0
0.009,6,12,1926,6,1189,1.0,659.0,434.0,6,737,1.0,417.0,417.0
240.649,6,33,8639,17,1837,15037.0,570.0,189.0,16,6802,16039.0,1402.0,597.0
0.004,6,10,1989,5,927,1.0,659.0,659.0,5,1062,1.0,794.0,794.0
0.011,6,10,1990,5,911,2.0,643.0,643.0,5,1079,2.0,811.0,811.0
1778.2,17,144,45504,72,22752,25044.0,288.0,288.0,72,22752,25044.0,288.0,288.0
0.005,17,2,136,1,60,0.0,32.0,32.0,1,76,0.0,48.0,48.0
0.037,17,2,136,1,60,0.0,32.0,32.0,1,76,0.0,48.0,48.0
0.004,17,2,136,1,60,0.0,32.0,32.0,1,76,0.0,48.0,48.0
0.071,6,10,1506,5,395,15.0,127.0,127.0,5,1111,17.0,843.0,843.0
0.072,17,2,184,1,61,0.0,33.0,33.0,1,123,0.0,95.0,95.0
0.004,17,2,148,1,60,0.0,32.0,32.0,1,88,0.0,60.0,60.0
0.028,6,13,3735,7,497,4.0,125.0,125.0,6,3238,5.0,1470.0,1459.0
0.013,6,10,1677,5,827,3.0,559.0,559.0,5,850,3.0,582.0,582.0
0.015,6,10,1972,5,910,3.0,642.0,642.0,5,1062,3.0,794.0,794.0
40.066,17,10,676,5,460,10013.0,104.0,64.0,5,216,10015.0,20.0,15.0
0.092,6,10,1506,5,395,20.0,127.0,127.0,5,1111,19.0,843.0,843.0
0.006,6,10,1702,5,863,1.0,595.0,595.0,5,839,1.0,571.0,571.0
0.005,6,10,1774,5,923,1.0,655.0,655.0,5,851,1.0,583.0,583.0
0.037,6,10,1989,5,910,9.0,642.0,642.0,5,1079,9.0,811.0,811.0
0.006,6,10,1643,5,860,1.0,592.0,592.0,5,783,1.0,515.0,515.0
0.017,6,10,1990,5,911,4.0,643.0,643.0,5,1079,4.0,811.0,811.0
0.009,6,10,1983,5,910,2.0,642.0,642.0,5,1073,2.0,805.0,805.0
1756.066,6,105,6270,60,3525,29763.0,27.0,27.0,45,2745,39909.0,27.0,27.0
15.075,17,15,9239,8,6902,2149.0,1350.0,834.0,7,2337,2507.0,1350.0,305.0
0.01,6,10,1989,5,910,2.0,642.0,642.0,5,1079,2.0,811.0,811.0
40.059,17,10,676,5,460,10012.0,104.0,64.0,5,216,10014.0,20.0,15.0
0.006,6,10,1854,5,889,1.0,621.0,621.0,5,965,1.0,697.0,697.0
0.005,6,13,3690,7,452,0.0,80.0,80.0,6,3238,1.0,1470.0,1459.0
0.004,17,2,136,1,60,0.0,32.0,32.0,1,76,0.0,48.0,48.0
0.005,6,10,1643,5,860,1.0,592.0,592.0,5,783,1.0,515.0,515.0
285.121,6,31,7603,17,1485,17819.0,517.0,290.0,14,6118,21932.0,2379.0,1078.0
0.01,6,10,1972,5,910,2.0,642.0,642.0,5,1062,2.0,794.0,794.0
0.008,6,10,1990,5,911,2.0,643.0,643.0,5,1079,2.0,811.0,811.0
0.005,6,10,2007,5,928,1.0,660.0,660.0,5,1079,1.0,811.0,811.0
0.15,6,10,1506,5,395,34.0,127.0,127.0,5,1111,33.0,843.0,843.0
0.073,6,10,1506,5,395,15.0,127.0,127.0,5,1111,15.0,843.0,843.0
0.01,6,10,1990,5,911,2.0,643.0,643.0,5,1079,2.0,811.0,811.0
352.413,6,33,10205,18,2672,20730.0,661.0,345.0,15,7533,20879.0,1402.0,749.0
40.068,17,10,676,5,460,10013.0,104.0,64.0,5,216,10016.0,20.0,15.0
0.006,6,14,3742,8,504,0.0,80.0,80.0,6,3238,1.0,1470.0,1459.0
0.004,17,4,284,2,120,1.0,32.0,32.0,2,164,1.0,60.0,54.0
0.039,17,2,184,1,61,0.0,33.0,33.0,1,123,0.0,95.0,95.0
0.007,6,10,1854,5,889,1.0,621.0,621.0,5,965,1.0,697.0,697.0
0.013,6,13,3735,7,497,2.0,125.0,125.0,6,3238,2.0,1470.0,1459.0
0.005,6,10,1643,5,860,1.0,592.0,592.0,5,783,1.0,515.0,515.0
0.003,17,2,187,1,74,0.0,46.0,46.0,1,113,0.0,85.0,85.0
0.006,6,10,1547,5,764,1.0,496.0,496.0,5,783,1.0,515.0,515.0
0.008,6,10,1689,5,839,2.0,571.0,571.0,5,850,1.0,582.0,582.0
0.089,6,10,1506,5,395,18.0,127.0,127.0,5,1111,19.0,843.0,843.0
177.073,17,76,10886,38,2529,4785.0,44.0,38.0,38,8357,4785.0,239.0,191.0
0.004,6,10,1779,5,928,1.0,660.0,660.0,5,851,1.0,583.0,583.0
0.011,6,10,1677,5,827,2.0,559.0,559.0,5,850,2.0,582.0,582.0
0.004,6,10,1702,5,863,1.0,595.0,595.0,5,839,0.0,571.0,571.0
0.004,6,10,1774,5,923,1.0,655.0,655.0,5,851,1.0,583.0,583.0
0.123,6,10,1506,5,395,28.0,127.0,127.0,5,1111,25.0,843.0,843.0
0.006,6,10,1547,5,764,1.0,496.0,496.0,5,783,1.0,515.0,515.0
0.013,6,10,1983,5,910,3.0,642.0,642.0,5,1073,3.0,805.0,805.0
0.005,6,10,2007,5,928,1.0,660.0,660.0,5,1079,1.0,811.0,811.0
0.005,6,10,2006,5,927,1.0,659.0,659.0,5,1079,1.0,811.0,811.0
0.02,6,10,1990,5,911,5.0,643.0,643.0,5,1079,4.0,811.0,811.0
0.005,6,10,2006,5,927,1.0,659.0,659.0,5,1079,1.0,811.0,811.0
0.09,6,10,1506,5,395,22.0,127.0,127.0,5,1111,19.0,843.0,843.0
0.006,6,10,1983,5,910,1.0,642.0,642.0,5,1073,1.0,805.0,805.0
0.013,6,10,1762,5,911,3.0,643.0,643.0,5,851,3.0,583.0,583.0
309.941,17,20,1124,10,716,34422.0,48.0,43.0,10,408,34422.0,20.0,12.0
240.681,6,35,8924,18,2073,14155.0,694.0,225.0,17,6851,15040.0,1402.0,597.0
0.162,17,2,152,1,76,0.0,48.0,48.0,1,76,0.0,48.0,48.0
0.006,6,10,1547,5,764,1.0,496.0,496.0,5,783,1.0,515.0,515.0
0.009,6,10,1972,5,910,2.0,642.0,642.0,5,1062,2.0,794.0,794.0
0.014,6,10,1989,5,910,3.0,642.0,642.0,5,1079,3.0,811.0,811.0
0.005,6,13,3747,7,509,0.0,137.0,137.0,6,3238,0.0,1470.0,1459.0
0.016,6,10,1983,5,910,3.0,642.0,642.0,5,1073,3.0,805.0,805.0
0.004,6,10,2006,5,927,1.0,659.0,659.0,5,1079,1.0,811.0,811.0
0.004,6,10,2006,5,927,1.0,659.0,659.0,5,1079,1.0,811.0,811.0
0.005,6,10,2006,5,927,1.0,659.0,659.0,5,1079,1.0,811.0,811.0
0.01,6,10,1983,5,910,2.0,642.0,642.0,5,1073,2.0,805.0,805.0
0.016,6,10,1989,5,910,3.0,642.0,642.0,5,1079,3.0,811.0,811.0
0.054,17,2,152,1,76,0.0,48.0,48.0,1,76,0.0,48.0,48.0
0.016,6,10,1989,5,910,3.0,642.0,642.0,5,1079,4.0,811.0,811.0
66.126,6,35,8460,17,1990,539.0,922.0,426.0,18,6470,3881.0,2720.0,478.0
0.004,17,2,148,1,60,0.0,32.0,32.0,1,88,0.0,60.0,60.0
0.021,17,2,262,1,67,0.0,39.0,39.0,1,195,0.0,167.0,167.0
1767.227,6,548,188295,278,162854,6379.0,2883.0,1016.0,270,25441,6569.0,386.0,114.0
9.036,17,6,376,5,280,2259.0,28.0,28.0,1,96,0.0,68.0,68.0
0.016,6,10,1990,5,911,3.0,643.0,643.0,5,1079,3.0,811.0,811.0
1729.226,6,60,4400,40,2740,44339.0,33.0,33.0,20,1660,91002.0,31.0,31.0
0.004,17,2,148,1,60,0.0,32.0,32.0,1,88,0.0,60.0,60.0
0.006,6,10,1547,5,764,1.0,496.0,496.0,5,783,1.0,515.0,515.0
0.013,17,2,152,1,56,0.0,28.0,28.0,1,96,0.0,68.0,68.0
0.099,6,10,1506,5,395,19.0,127.0,127.0,5,1111,23.0,843.0,843.0
0.005,6,13,3690,7,452,0.0,80.0,80.0,6,3238,0.0,1470.0,1459.0
0.006,6,10,1547,5,764,1.0,496.0,496.0,5,783,1.0,515.0,515.0
0.102,6,10,1506,5,395,24.0,127.0,127.0,5,1111,21.0,843.0,843.0
0.015,6,10,1631,5,848,3.0,580.0,580.0,5,783,3.0,515.0,515.0
0.005,17,2,154,1,69,0.0,41.0,41.0,1,85,0.0,57.0,57.0
0.071,6,10,1506,5,395,16.0,127.0,127.0,5,1111,15.0,843.0,843.0
0.087,6,10,1506,5,395,20.0,127.0,127.0,5,1111,16.0,843.0,843.0
0.007,17,2,194,1,59,0.0,31.0,31.0,1,135,0.0,107.0,107.0
0.005,6,10,2006,5,927,1.0,659.0,659.0,5,1079,1.0,811.0,811.0
0.104,6,10,1506,5,395,23.0,127.0,127.0,5,1111,22.0,843.0,843.0
0.01,6,10,1990,5,911,2.0,643.0,643.0,5,1079,2.0,811.0,811.0
0.005,6,10,1689,5,839,1.0,571.0,571.0,5,850,1.0,582.0,582.0
0.015,6,10,1990,5,911,3.0,643.0,643.0,5,1079,3.0,811.0,811.0
0.02,6,10,1983,5,910,4.0,642.0,642.0,5,1073,4.0,805.0,805.0
0.006,6,10,2007,5,928,1.0,660.0,660.0,5,1079,1.0,811.0,811.0
0.004,17,2,136,1,60,0.0,32.0,32.0,1,76,0.0,48.0,48.0
0.094,6,10,1506,5,395,20.0,127.0,127.0,5,1111,21.0,843.0,843.0
0.123,6,10,1506,5,395,27.0,127.0,127.0,5,1111,27.0,843.0,843.0
0.016,6,10,1989,5,910,3.0,642.0,642.0,5,1079,4.0,811.0,811.0
0.004,17,2,136,1,60,0.0,32.0,32.0,1,76,0.0,48.0,48.0
0.013,6,10,1989,5,910,3.0,642.0,642.0,5,1079,3.0,811.0,811.0
0.005,6,10,2007,5,928,1.0,660.0,660.0,5,1079,1.0,811.0,811.0
0.098,6,10,1506,5,395,23.0,127.0,127.0,5,1111,22.0,843.0,843.0
40.054,17,10,676,5,460,10012.0,104.0,64.0,5,216,10012.0,20.0,15.0
0.005,6,13,3690,7,452,0.0,80.0,80.0,6,3238,1.0,1470.0,1459.0
0.004,17,2,136,1,60,0.0,32.0,32.0,1,76,0.0,48.0,48.0
0.005,6,10,2006,5,927,1.0,659.0,659.0,5,1079,1.0,811.0,811.0
0.079,6,10,1506,5,395,18.0,127.0,127.0,5,1111,17.0,843.0,843.0
0.001,17,2,180,1,66,0.0,38.0,38.0,1,114,0.0,86.0,86.0
1792.631,6,556,188125,287,163335,6267.0,2883.0,916.0,269,24790,6688.0,372.0,106.0
0.017,6,10,1677,5,827,4.0,559.0,559.0,5,850,4.0,582.0,582.0
0.006,6,10,1854,5,889,1.0,621.0,621.0,5,965,1.0,697.0,697.0
0.001,17,2,180,1,66,0.0,38.0,38.0,1,114,0.0,86.0,86.0
0.005,6,13,3747,7,509,0.0,137.0,137.0,6,3238,1.0,1470.0,1459.0
0.006,6,10,2006,5,927,1.0,659.0,659.0,5,1079,1.0,811.0,811.0
0.005,17,2,166,1,75,0.0,47.0,47.0,1,91,0.0,63.0,63.0
0.006,6,10,1689,5,839,1.0,571.0,571.0,5,850,1.0,582.0,582.0
0.009,6,10,1990,5,911,2.0,643.0,643.0,5,1079,2.0,811.0,811.0
0.092,6,10,1506,5,395,19.0,127.0,127.0,5,1111,18.0,843.0,843.0
0.014,6,10,1989,5,910,3.0,642.0,642.0,5,1079,3.0,811.0,811.0
0.004,6,10,1702,5,863,1.0,595.0,595.0,5,839,1.0,571.0,571.0
0.229,6,16,2777,8,1395,32.0,533.0,323.0,8,1382,20.0,529.0,239.0
0.01,17,2,194,1,59,0.0,31.0,31.0,1,135,0.0,107.0,107.0
0.009,6,12,1926,6,1189,1.0,659.0,434.0,6,737,1.0,417.0,417.0
0.001,17,2,166,1,75,0.0,47.0,47.0,1,91,0.0,63.0,63.0
0.014,6,10,1762,5,911,3.0,643.0,643.0,5,851,3.0,583.0,583.0
0.169,6,10,1506,5,395,40.0,127.0,127.0,5,1111,40.0,843.0,843.0
0.092,6,10,1506,5,395,20.0,127.0,127.0,5,1111,17.0,843.0,843.0
0.009,6,10,1762,5,911,2.0,643.0,643.0,5,851,2.0,583.0,583.0
0.124,17,2,170,1,65,0.0,37.0,37.0,1,105,0.0,77.0,77.0
40.059,17,10,676,5,460,10012.0,104.0,64.0,5,216,10014.0,20.0,15.0
15.03,17,47,27338,26,23919,600.0,1350.0,891.0,21,3419,750.0,1350.0,134.0
0.004,6,10,2006,5,927,1.0,659.0,659.0,5,1079,1.0,811.0,811.0
0.101,6,10,1506,5,395,21.0,127.0,127.0,5,1111,21.0,843.0,843.0
0.013,6,10,1990,5,911,3.0,643.0,643.0,5,1079,3.0,811.0,811.0
378.618,6,22,2313,16,867,25241.0,195.0,195.0,6,1446,4635.0,419.0,398.0
40.068,17,10,676,5,460,10015.0,104.0,64.0,5,216,10016.0,20.0,15.0
0.12,6,10,1506,5,395,24.0,127.0,127.0,5,1111,25.0,843.0,843.0
0.116,6,10,1506,5,395,26.0,127.0,127.0,5,1111,24.0,843.0,843.0
0.001,17,2,180,1,66,0.0,38.0,38.0,1,114,0.0,86.0,86.0
116.558,6,22,9233,11,1575,92.0,794.0,367.0,11,7658,11643.0,1360.0,1029.0
0.005,6,10,2006,5,927,1.0,659.0,659.0,5,1079,1.0,811.0,811.0
0.225,6,16,2778,8,1396,32.0,533.0,324.0,8,1382,20.0,529.0,239.0
0.005,6,10,2006,5,927,1.0,659.0,659.0,5,1079,1.0,811.0,811.0
0.088,6,10,1506,5,395,18.0,127.0,127.0,5,1111,19.0,843.0,843.0
0.113,6,10,1506,5,395,27.0,127.0,127.0,5,1111,25.0,843.0,843.0
0.004,6,10,1989,5,927,1.0,659.0,659.0,5,1062,1.0,794.0,794.0
0.012,6,10,1677,5,827,3.0,559.0,559.0,5,850,3.0,582.0,582.0
0.005,17,2,170,1,65,0.0,37.0,37.0,1,105,0.0,77.0,77.0
0.036,6,10,1677,5,827,8.0,559.0,559.0,5,850,8.0,582.0,582.0
11.232,17,28,4422,14,1994,851.0,269.0,114.0,14,2428,851.0,587.0,145.0
0.006,6,10,1547,5,764,1.0,496.0,496.0,5,783,1.0,515.0,515.0
300.309,6,16,2170,9,684,37516.0,146.0,146.0,7,1486,50023.0,419.0,398.0
0.005,6,10,1643,5,860,1.0,592.0,592.0,5,783,1.0,515.0,515.0
0.038,17,2,152,1,76,0.0,48.0,48.0,1,76,0.0,48.0,48.0
0.005,17,2,170,1,65,0.0,37.0,37.0,1,105,0.0,77.0,77.0
0.009,6,10,1972,5,910,2.0,642.0,642.0,5,1062,2.0,794.0,794.0
0.006,6,10,1547,5,764,1.0,496.0,496.0,5,783,1.0,515.0,515.0
0.005,6,14,3742,7,452,0.0,80.0,80.0,7,3290,0.0,1448.0,972.0
0.01,6,10,1972,5,910,2.0,642.0,642.0,5,1062,2.0,794.0,794.0
0.004,6,10,1774,5,923,1.0,655.0,655.0,5,851,1.0,583.0,583.0
0.005,6,10,1989,5,927,1.0,659.0,659.0,5,1062,1.0,794.0,794.0
0.004,6,10,1702,5,863,1.0,595.0,595.0,5,839,0.0,571.0,571.0
0.033,6,13,3735,7,497,5.0,125.0,125.0,6,3238,6.0,1470.0,1459.0
0.103,6,10,1506,5,395,22.0,127.0,127.0,5,1111,22.0,843.0,843.0
0.105,6,10,1506,5,395,24.0,127.0,127.0,5,1111,23.0,843.0,843.0
0.006,17,2,170,1,65,0.0,37.0,37.0,1,105,0.0,77.0,77.0
0.012,6,10,1989,5,910,2.0,642.0,642.0,5,1079,3.0,811.0,811.0
0.005,6,10,1989,5,927,1.0,659.0,659.0,5,1062,1.0,794.0,794.0
0.004,6,10,2007,5,928,1.0,660.0,660.0,5,1079,1.0,811.0,811.0
0.004,6,10,2000,5,927,1.0,659.0,659.0,5,1073,1.0,805.0,805.0
0.104,6,10,1506,5,395,23.0,127.0,127.0,5,1111,23.0,843.0,843.0
0.052,17,2,152,1,76,0.0,48.0,48.0,1,76,0.0,48.0,48.0
0.008,6,12,1926,6,1189,1.0,659.0,434.0,6,737,1.0,417.0,417.0
0.012,6,10,1972,5,910,2.0,642.0,642.0,5,1062,2.0,794.0,794.0
40.075,17,10,676,5,460,10016.0,104.0,64.0,5,216,10017.0,20.0,15.0
0.016,6,10,1972,5,910,4.0,642.0,642.0,5,1062,4.0,794.0,794.0
0.008,6,10,1989,5,910,2.0,642.0,642.0,5,1079,2.0,811.0,811.0
0.004,6,10,2006,5,927,1.0,659.0,659.0,5,1079,1.0,811.0,811.0
0.025,17,2,166,1,75,0.0,47.0,47.0,1,91,0.0,63.0,63.0
0.009,6,10,1990,5,911,2.0,643.0,643.0,5,1079,2.0,811.0,811.0
0.069,6,10,1506,5,395,14.0,127.0,127.0,5,1111,16.0,843.0,843.0
0.004,17,2,169,1,62,0.0,34.0,34.0,1,107,0.0,79.0,79.0
0.006,6,10,1689,5,839,1.0,571.0,571.0,5,850,1.0,582.0,582.0
0.005,17,2,213,1,69,0.0,41.0,41.0,1,144,0.0,116.0,116.0
0.004,17,2,148,1,60,0.0,32.0,32.0,1,88,0.0,60.0,60.0
0.005,6,10,1643,5,860,1.0,592.0,592.0,5,783,1.0,515.0,515.0
0.07,17,2,152,1,76,0.0,48.0,48.0,1,76,0.0,48.0,48.0
0.023,6,13,3735,7,497,3.0,125.0,125.0,6,3238,4.0,1470.0,1459.0
0.01,6,10,1989,5,910,2.0,642.0,642.0,5,1079,2.0,811.0,811.0
0.13,17,4,284,2,120,0.0,32.0,32.0,2,164,88.0,60.0,54.0
176.127,17,72,10388,36,2402,5032.0,44.0,38.0,36,7986,5031.0,252.0,193.0
15.154,17,25,9624,11,5159,1512.0,1350.0,441.0,14,4465,1163.0,1350.0,290.0
0.012,6,10,1677,5,827,2.0,559.0,559.0,5,850,2.0,582.0,582.0
0.006,6,13,3684,7,446,1.0,74.0,74.0,6,3238,1.0,1470.0,1459.0
0.09,6,10,1506,5,395,20.0,127.0,127.0,5,1111,18.0,843.0,843.0
0.01,6,10,1989,5,910,2.0,642.0,642.0,5,1079,2.0,811.0,811.0
0.126,6,10,1506,5,395,22.0,127.0,127.0,5,1111,30.0,843.0,843.0
0.013,6,10,1631,5,848,3.0,580.0,580.0,5,783,3.0,515.0,515.0
0.004,6,10,2006,5,927,1.0,659.0,659.0,5,1079,1.0,811.0,811.0
0.005,6,10,1774,5,923,1.0,655.0,655.0,5,851,1.0,583.0,583.0
0.013,17,2,194,1,59,0.0,31.0,31.0,1,135,0.0,107.0,107.0
1777.951,17,144,45504,72,22752,25041.0,288.0,288.0,72,22752,25041.0,288.0,288.0
0.072,6,10,1506,5,395,15.0,127.0,127.0,5,1111,16.0,843.0,843.0
0.059,6,10,1506,5,395,13.0,127.0,127.0,5,1111,13.0,843.0,843.0
40.087,17,10,676,5,460,10017.0,104.0,64.0,5,216,10020.0,20.0,15.0
300.325,6,17,2222,10,736,33350.0,146.0,146.0,7,1486,50025.0,419.0,398.0
300.781,6,37,9597,20,4119,15830.0,1543.0,657.0,17,5478,538.0,2667.0,435.0
0.127,17,2,182,1,65,0.0,37.0,37.0,1,117,0.0,89.0,89.0
0.014,6,10,1972,5,910,3.0,642.0,642.0,5,1062,3.0,794.0,794.0
0.167,17,2,152,1,76,0.0,48.0,48.0,1,76,0.0,48.0,48.0
163.563,6,26,9525,12,1627,81.0,794.0,367.0,14,7898,12571.0,1360.0,732.0
0.053,17,2,152,1,76,0.0,48.0,48.0,1,76,0.0,48.0,48.0
0.124,6,10,1506,5,395,29.0,127.0,127.0,5,1111,29.0,843.0,843.0
0.076,6,10,1506,5,395,17.0,127.0,127.0,5,1111,17.0,843.0,843.0
0.011,6,10,1983,5,910,2.0,642.0,642.0,5,1073,2.0,805.0,805.0
0.07,6,10,1506,5,395,15.0,127.0,127.0,5,1111,14.0,843.0,843.0
0.007,6,10,1972,5,910,1.0,642.0,642.0,5,1062,1.0,794.0,794.0
11.126,17,26,4102,13,1846,918.0,269.0,114.0,13,2256,918.0,587.0,145.0
0.006,6,10,1774,5,923,1.0,655.0,655.0,5,851,1.0,583.0,583.0
0.016,6,10,1972,5,910,3.0,642.0,642.0,5,1062,3.0,794.0,794.0
0.005,17,2,273,1,66,0.0,38.0,38.0,1,207,0.0,179.0,179.0
0.014,6,10,1990,5,911,3.0,643.0,643.0,5,1079,3.0,811.0,811.0
0.014,6,10,1989,5,910,3.0,642.0,642.0,5,1079,3.0,811.0,811.0
0.005,6,14,3742,7,452,0.0,80.0,80.0,7,3290,0.0,1448.0,972.0
0.003,17,2,136,1,60,0.0,32.0,32.0,1,76,0.0,48.0,48.0
300.837,6,39,8915,21,3352,15041.0,2084.0,617.0,18,5563,510.0,2667.0,402.0
0.021,6,10,1990,5,911,5.0,643.0,643.0,5,1079,5.0,811.0,811.0
0.003,17,4,284,2,120,0.0,32.0,32.0,2,164,1.0,60.0,54.0
0.056,17,2,152,1,76,0.0,48.0,48.0,1,76,0.0,48.0,48.0
0.005,17,2,140,1,62,0.0,34.0,34.0,1,78,0.0,50.0,50.0
0.006,6,10,1989,5,927,1.0,659.0,659.0,5,1062,1.0,794.0,794.0
10.841,17,28,4419,14,1994,825.0,269.0,114.0,14,2425,825.0,588.0,145.0
0.009,6,12,1926,6,1189,1.0,659.0,434.0,6,737,1.0,417.0,417.0
0.085,6,10,1506,5,395,18.0,127.0,127.0,5,1111,19.0,843.0,843.0
40.061,17,10,676,5,460,10014.0,104.0,64.0,5,216,10014.0,20.0,15.0
0.006,6,10,1854,5,889,1.0,621.0,621.0,5,965,1.0,697.0,697.0
0.077,6,10,1506,5,395,17.0,127.0,127.0,5,1111,15.0,843.0,843.0
0.011,6,10,1631,5,848,2.0,580.0,580.0,5,783,2.0,515.0,515.0
40.053,17,10,676,5,460,10012.0,104.0,64.0,5,216,10012.0,20.0,15.0
176.097,17,74,10361,37,2470,4891.0,44.0,38.0,37,7891,4891.0,239.0,185.0
1.039,6,12,3029,6,1986,156.0,1216.0,867.0,6,1043,155.0,791.0,791.0
0.016,6,10,1990,5,911,3.0,643.0,643.0,5,1079,4.0,811.0,811.0
0.012,6,13,3735,7,497,2.0,125.0,125.0,6,3238,2.0,1470.0,1459.0
0.006,6,10,1547,5,764,1.0,496.0,496.0,5,783,1.0,515.0,515.0
0.076,6,10,1506,5,395,14.0,127.0,127.0,5,1111,17.0,843.0,843.0
11.04,17,28,4393,14,2311,840.0,586.0,137.0,14,2082,840.0,269.0,120.0
0.11,6,10,1506,5,395,23.0,127.0,127.0,5,1111,23.0,843.0,843.0
10.781,17,28,4423,14,1994,820.0,269.0,114.0,14,2429,820.0,588.0,145.0
0.009,6,12,1926,6,1189,1.0,659.0,434.0,6,737,1.0,417.0,417.0
0.026,6,10,1762,5,911,6.0,643.0,643.0,5,851,6.0,583.0,583.0
0.005,6,10,1774,5,923,1.0,655.0,655.0,5,851,1.0,583.0,583.0
5.101,6,21,5923,12,1436,463.0,474.0,201.0,9,4487,637.0,1925.0,804.0
1772.505,17,92,8096,46,4048,39388.0,60.0,60.0,46,4048,39388.0,60.0,60.0
0.001,17,2,180,1,66,0.0,38.0,38.0,1,114,0.0,86.0,86.0
0.004,6,10,1779,5,928,1.0,660.0,660.0,5,851,1.0,583.0,583.0
0.005,6,10,1643,5,860,1.0,592.0,592.0,5,783,1.0,515.0,515.0
0.005,6,14,3742,7,452,0.0,80.0,80.0,7,3290,0.0,1448.0,972.0
40.072,17,10,676,5,460,10015.0,104.0,64.0,5,216,10017.0,20.0,15.0
0.158,6,10,1506,5,395,39.0,127.0,127.0,5,1111,38.0,843.0,843.0
0.109,6,10,1506,5,395,24.0,127.0,127.0,5,1111,25.0,843.0,843.0
0.091,6,10,1506,5,395,21.0,127.0,127.0,5,1111,20.0,843.0,843.0
0.005,17,2,136,1,60,0.0,32.0,32.0,1,76,0.0,48.0,48.0
0.007,6,10,1990,5,911,1.0,643.0,643.0,5,1079,1.0,811.0,811.0
0.014,6,10,1989,5,910,3.0,642.0,642.0,5,1079,3.0,811.0,811.0
40.084,17,10,676,5,460,10019.0,104.0,64.0,5,216,10020.0,20.0,15.0
0.076,6,10,1506,5,395,17.0,127.0,127.0,5,1111,14.0,843.0,843.0
0.085,6,10,1506,5,395,17.0,127.0,127.0,5,1111,17.0,843.0,843.0
0.003,17,2,148,1,60,0.0,32.0,32.0,1,88,0.0,60.0,60.0
0.006,17,2,170,1,65,0.0,37.0,37.0,1,105,0.0,77.0,77.0
0.008,6,10,1990,5,911,2.0,643.0,643.0,5,1079,1.0,811.0,811.0
0.02,6,10,1989,5,910,5.0,642.0,642.0,5,1079,5.0,811.0,811.0
0.004,6,10,1702,5,863,1.0,595.0,595.0,5,839,1.0,571.0,571.0
0.008,17,2,132,1,58,0.0,30.0,30.0,1,74,0.0,46.0,46.0
242.129,6,35,8934,19,2132,13445.0,693.0,225.0,16,6802,16068.0,1402.0,597.0
0.009,6,12,1926,6,1189,1.0,659.0,434.0,6,737,1.0,417.0,417.0
0.005,6,10,1689,5,839,1.0,571.0,571.0,5,850,1.0,582.0,582.0
0.006,6,10,2000,5,927,1.0,659.0,659.0,5,1073,1.0,805.0,805.0
0.005,17,2,169,1,62,0.0,34.0,34.0,1,107,0.0,79.0,79.0
0.005,6,10,2007,5,928,1.0,660.0,660.0,5,1079,1.0,811.0,811.0
300.395,6,16,2170,9,684,37528.0,146.0,146.0,7,1486,50039.0,419.0,398.0
178.095,17,70,10038,35,2338,5237.0,44.0,38.0,35,7700,5238.0,261.0,192.0
0.081,6,10,1506,5,395,19.0,127.0,127.0,5,1111,18.0,843.0,843.0
0.004,17,2,142,1,63,0.0,35.0,35.0,1,79,0.0,51.0,51.0
0.005,6,10,1643,5,860,1.0,592.0,592.0,5,783,1.0,515.0,515.0
0.005,6,10,2000,5,927,1.0,659.0,659.0,5,1073,1.0,805.0,805.0
309.494,17,20,1124,10,716,34374.0,48.0,43.0,10,408,34374.0,20.0,12.0
0.081,6,10,1506,5,395,16.0,127.0,127.0,5,1111,17.0,843.0,843.0
0.03,17,4,284,2,120,0.0,32.0,32.0,2,164,1.0,60.0,54.0
173.074,17,76,10908,38,2529,4677.0,44.0,38.0,38,8379,4677.0,261.0,192.0
0.016,6,10,1677,5,827,3.0,559.0,559.0,5,850,3.0,582.0,582.0
0.015,6,13,3735,7,497,2.0,125.0,125.0,6,3238,3.0,1470.0,1459.0
0.012,6,10,1989,5,910,2.0,642.0,642.0,5,1079,3.0,811.0,811.0
0.017,6,10,1990,5,911,4.0,643.0,643.0,5,1079,4.0,811.0,811.0
1730.383,6,48,2957,31,1800,57679.0,35.0,35.0,17,1157,108125.0,31.0,31.0
0.006,6,10,1689,5,839,1.0,571.0,571.0,5,850,1.0,582.0,582.0
0.005,17,2,170,1,65,0.0,37.0,37.0,1,105,0.0,77.0,77.0
0.006,6,10,2007,5,928,1.0,660.0,660.0,5,1079,1.0,811.0,811.0
0.006,6,10,1689,5,839,1.0,571.0,571.0,5,850,1.0,582.0,582.0
0.125,6,10,1506,5,395,23.0,127.0,127.0,5,1111,27.0,843.0,843.0
0.085,6,10,1506,5,395,18.0,127.0,127.0,5,1111,18.0,843.0,843.0
0.004,6,10,1702,5,863,0.0,595.0,595.0,5,839,1.0,571.0,571.0
0.004,6,10,1774,5,923,1.0,655.0,655.0,5,851,1.0,583.0,583.0
0.005,17,2,144,1,64,0.0,36.0,36.0,1,80,0.0,52.0,52.0
0.005,6,10,2000,5,927,1.0,659.0,659.0,5,1073,1.0,805.0,805.0
0.021,6,10,1989,5,910,5.0,642.0,642.0,5,1079,5.0,811.0,811.0
0.01,6,10,1631,5,848,2.0,580.0,580.0,5,783,2.0,515.0,515.0
0.095,6,10,1506,5,395,20.0,127.0,127.0,5,1111,22.0,843.0,843.0
40.058,17,10,676,5,460,10013.0,104.0,64.0,5,216,10013.0,20.0,15.0
240.118,6,32,9596,16,7239,16007.0,2311.0,712.0,16,2357,16007.0,580.0,189.0
0.008,17,2,194,1,59,0.0,31.0,31.0,1,135,0.0,107.0,107.0
0.001,17,2,180,1,66,0.0,38.0,38.0,1,114,0.0,86.0,86.0
368.999,6,22,2313,16,867,24599.0,195.0,195.0,6,1446,4635.0,419.0,398.0
0.007,6,10,1989,5,927,1.0,659.0,659.0,5,1062,1.0,794.0,794.0
0.09,6,10,1506,5,395,21.0,127.0,127.0,5,1111,20.0,843.0,843.0
0.009,6,10,1983,5,910,2.0,642.0,642.0,5,1073,2.0,805.0,805.0
0.087,6,10,1506,5,395,20.0,127.0,127.0,5,1111,20.0,843.0,843.0
300.397,6,16,2170,9,684,37528.0,146.0,146.0,7,1486,50037.0,419.0,398.0
0.006,6,10,1779,5,928,1.0,660.0,660.0,5,851,1.0,583.0,583.0
40.056,17,10,676,5,460,10013.0,104.0,64.0,5,216,10013.0,20.0,15.0
40.065,17,10,676,5,460,10015.0,104.0,64.0,5,216,10015.0,20.0,15.0
40.067,17,10,676,5,460,10016.0,104.0,64.0,5,216,10015.0,20.0,15.0
0.008,17,4,284,2,120,0.0,32.0,32.0,2,164,0.0,60.0,54.0
0.006,17,2,230,1,68,0.0,40.0,40.0,1,162,0.0,134.0,134.0
5.967,58,2,144,1,72,0.0,24.0,24.0,1,72,0.0,24.0,24.0
0.01,6,10,1631,5,848,2.0,580.0,580.0,5,783,2.0,515.0,515.0
0.04,17,4,284,2,120,1.0,32.0,32.0,2,164,37.0,60.0,54.0
173.037,17,70,9939,35,2330,5089.0,44.0,38.0,35,7609,5089.0,261.0,189.0
240.011,6,9,787,5,488,60002.0,232.0,232.0,4,299,80002.0,83.0,83.0
0.006,17,2,179,1,71,0.0,43.0,43.0,1,108,0.0,80.0,80.0
20.444,6,58,29362,31,23255,306.0,2720.0,1373.0,27,6107,780.0,2667.0,385.0
0.012,6,10,1972,5,910,2.0,642.0,642.0,5,1062,3.0,794.0,794.0
0.084,6,10,1506,5,395,15.0,127.0,127.0,5,1111,17.0,843.0,843.0
0.011,6,10,1983,5,910,2.0,642.0,642.0,5,1073,2.0,805.0,805.0
11.397,17,26,4142,13,2184,936.0,587.0,140.0,13,1958,936.0,269.0,122.0
0.041,17,2,152,1,76,0.0,48.0,48.0,1,76,0.0,48.0,48.0
0.01,6,10,1972,5,910,2.0,642.0,642.0,5,1062,2.0,794.0,794.0
15.073,17,14,9191,8,6902,2149.0,1350.0,834.0,6,2289,3008.0,1350.0,353.0
0.004,6,10,1989,5,927,1.0,659.0,659.0,5,1062,1.0,794.0,794.0
0.003,17,2,148,1,60,0.0,32.0,32.0,1,88,0.0,60.0,60.0
0.084,6,10,1506,5,395,17.0,127.0,127.0,5,1111,20.0,843.0,843.0
0.004,6,10,2007,5,928,1.0,660.0,660.0,5,1079,1.0,811.0,811.0
61.243,6,38,13315,19,7757,494.0,2720.0,1393.0,19,5558,3393.0,2667.0,435.0
0.004,6,10,2006,5,927,1.0,659.0,659.0,5,1079,1.0,811.0,811.0
0.105,6,10,1506,5,395,19.0,127.0,127.0,5,1111,20.0,843.0,843.0
0.005,6,10,2000,5,927,1.0,659.0,659.0,5,1073,1.0,805.0,805.0
0.008,6,10,1989,5,910,1.0,642.0,642.0,5,1079,1.0,811.0,811.0
360.442,6,23,4085,13,3142,30036.0,494.0,494.0,10,943,40048.0,83.0,83.0
0.011,6,10,1989,5,910,2.0,642.0,642.0,5,1079,2.0,811.0,811.0
9.036,17,6,376,5,280,2259.0,28.0,28.0,1,96,0.0,68.0,68.0
0.004,6,10,1774,5,923,1.0,655.0,655.0,5,851,1.0,583.0,583.0
0.005,6,14,3742,8,504,0.0,80.0,80.0,6,3238,0.0,1470.0,1459.0
0.004,17,2,136,1,60,0.0,32.0,32.0,1,76,0.0,48.0,48.0
0.011,6,10,1989,5,910,2.0,642.0,642.0,5,1079,2.0,811.0,811.0
300.296,6,18,2262,10,736,33346.0,146.0,146.0,8,1526,42874.0,419.0,398.0
0.006,6,10,1547,5,764,1.0,496.0,496.0,5,783,1.0,515.0,515.0
0.005,6,10,1689,5,839,1.0,571.0,571.0,5,850,1.0,582.0,582.0
0.015,6,10,1990,5,911,3.0,643.0,643.0,5,1079,3.0,811.0,811.0
0.01,17,2,230,1,68,0.0,40.0,40.0,1,162,0.0,134.0,134.0
15.071,17,15,9239,8,6902,2149.0,1350.0,834.0,7,2337,2506.0,1350.0,305.0
312.674,17,20,1124,10,716,34727.0,48.0,43.0,10,408,34727.0,20.0,12.0
11.175,17,28,4422,14,1993,846.0,268.0,114.0,14,2429,846.0,588.0,145.0
0.015,6,10,1990,5,911,3.0,643.0,643.0,5,1079,3.0,811.0,811.0
0.008,6,12,1926,6,1189,1.0,659.0,434.0,6,737,1.0,417.0,417.0
367.01,6,22,2313,16,867,24467.0,195.0,195.0,6,1446,4670.0,419.0,398.0
0.004,17,2,148,1,60,0.0,32.0,32.0,1,88,0.0,60.0,60.0
0.001,17,2,180,1,66,0.0,38.0,38.0,1,114,0.0,86.0,86.0
0.006,6,10,1989,5,927,1.0,659.0,659.0,5,1062,1.0,794.0,794.0
11.152,17,28,4418,14,1994,845.0,269.0,114.0,14,2424,845.0,587.0,145.0
0.003,17,2,148,1,60,0.0,32.0,32.0,1,88,0.0,60.0,60.0
0.093,6,10,1506,5,395,20.0,127.0,127.0,5,1111,20.0,843.0,843.0
0.004,6,10,1774,5,923,1.0,655.0,655.0,5,851,1.0,583.0,583.0
0.008,6,10,1989,5,927,2.0,659.0,659.0,5,1062,2.0,794.0,794.0
0.084,6,10,1506,5,395,17.0,127.0,127.0,5,1111,17.0,843.0,843.0
0.011,6,10,1972,5,910,2.0,642.0,642.0,5,1062,2.0,794.0,794.0
0.01,17,4,284,2,120,6.0,32.0,32.0,2,164,7.0,60.0,54.0
295.896,6,311,344039,123,17944,2425.0,2736.0,888.0,188,326095,1582.0,2804.0,1817.0
0.099,6,10,1506,5,395,23.0,127.0,127.0,5,1111,20.0,843.0,843.0
0.019,6,10,1972,5,910,4.0,642.0,642.0,5,1062,4.0,794.0,794.0
0.001,17,2,180,1,65,0.0,37.0,37.0,1,115,0.0,87.0,87.0
0.009,6,10,1989,5,910,2.0,642.0,642.0,5,1079,2.0,811.0,811.0
0.126,6,10,1506,5,395,26.0,127.0,127.0,5,1111,25.0,843.0,843.0
0.006,6,10,1643,5,860,1.0,592.0,592.0,5,783,1.0,515.0,515.0
0.008,6,10,1989,5,910,2.0,642.0,642.0,5,1079,2.0,811.0,811.0
0.005,17,2,164,1,74,0.0,46.0,46.0,1,90,0.0,62.0,62.0
40.059,17,10,676,5,460,10012.0,104.0,64.0,5,216,10013.0,20.0,15.0
0.011,6,10,1972,5,910,2.0,642.0,642.0,5,1062,2.0,794.0,794.0
0.005,6,10,2006,5,927,1.0,659.0,659.0,5,1079,1.0,811.0,811.0
15.321,17,44,20803,22,17076,728.0,1350.0,748.0,22,3727,728.0,1350.0,141.0
0.006,6,10,1547,5,764,1.0,496.0,496.0,5,783,1.0,515.0,515.0
0.006,6,10,1774,5,923,1.0,655.0,655.0,5,851,1.0,583.0,583.0
0.005,17,2,222,1,65,0.0,37.0,37.0,1,157,0.0,129.0,129.0
0.004,17,2,234,1,61,0.0,33.0,33.0,1,173,0.0,145.0,145.0
0.021,6,20,9974,11,704,2.0,124.0,124.0,9,9270,2.0,2896.0,1758.0
0.008,6,10,1972,5,910,2.0,642.0,642.0,5,1062,2.0,794.0,794.0
0.005,17,2,214,1,75,0.0,47.0,47.0,1,139,0.0,111.0,111.0
0.106,6,10,1506,5,395,24.0,127.0,127.0,5,1111,25.0,843.0,843.0
0.006,6,10,2007,5,928,1.0,660.0,660.0,5,1079,1.0,811.0,811.0
0.001,17,2,154,1,69,0.0,41.0,41.0,1,85,0.0,57.0,57.0
0.082,6,10,1506,5,395,18.0,127.0,127.0,5,1111,18.0,843.0,843.0
0.14,6,10,1506,5,395,31.0,127.0,127.0,5,1111,31.0,843.0,843.0
0.011,17,2,148,1,60,0.0,32.0,32.0,1,88,0.0,60.0,60.0
0.038,17,4,420,2,122,0.0,33.0,33.0,2,298,34.0,145.0,121.0
0.009,6,10,1779,5,928,2.0,660.0,660.0,5,851,2.0,583.0,583.0
15.073,17,15,9238,8,6902,2149.0,1350.0,834.0,7,2336,2507.0,1350.0,305.0
0.015,6,10,1989,5,910,3.0,642.0,642.0,5,1079,3.0,811.0,811.0
0.006,6,10,1547,5,764,1.0,496.0,496.0,5,783,1.0,515.0,515.0
0.014,6,10,1989,5,910,3.0,642.0,642.0,5,1079,3.0,811.0,811.0
0.011,6,10,1990,5,911,2.0,643.0,643.0,5,1079,2.0,811.0,811.0
240.082,6,16,4481,9,963,30010.0,238.0,166.0,7,3518,40013.0,1402.0,786.0
0.12,6,10,1506,5,395,29.0,127.0,127.0,5,1111,29.0,843.0,843.0
0.009,6,10,1989,5,910,2.0,642.0,642.0,5,1079,2.0,811.0,811.0
30.106,6,25,5883,14,1888,2315.0,517.0,260.0,11,3995,3010.0,1330.0,590.0
0.089,6,10,1506,5,395,19.0,127.0,127.0,5,1111,20.0,843.0,843.0
300.327,6,27,7433,16,1409,20021.0,217.0,142.0,11,6024,24028.0,1679.0,777.0
0.089,6,10,1506,5,395,19.0,127.0,127.0,5,1111,19.0,843.0,843.0
0.006,17,2,144,1,64,0.0,36.0,36.0,1,80,0.0,52.0,52.0
0.007,6,10,1989,5,910,1.0,642.0,642.0,5,1079,1.0,811.0,811.0
0.205,6,10,1506,5,395,41.0,127.0,127.0,5,1111,48.0,843.0,843.0
10.815,17,28,4422,14,1994,823.0,269.0,114.0,14,2428,823.0,587.0,145.0
0.019,6,10,1989,5,910,4.0,642.0,642.0,5,1079,4.0,811.0,811.0
0.011,6,10,1762,5,911,2.0,643.0,643.0,5,851,2.0,583.0,583.0
0.004,6,10,2006,5,927,1.0,659.0,659.0,5,1079,1.0,811.0,811.0
0.005,6,10,1643,5,860,1.0,592.0,592.0,5,783,1.0,515.0,515.0
0.088,6,10,1506,5,395,19.0,127.0,127.0,5,1111,17.0,843.0,843.0
0.01,6,10,1762,5,911,2.0,643.0,643.0,5,851,2.0,583.0,583.0
0.012,6,10,1972,5,910,3.0,642.0,642.0,5,1062,2.0,794.0,794.0
11.457,17,28,4395,14,2313,869.0,588.0,137.0,14,2082,869.0,269.0,120.0
40.039,17,10,676,5,460,10007.0,104.0,64.0,5,216,10009.0,20.0,15.0
0.006,6,10,1547,5,764,1.0,496.0,496.0,5,783,1.0,515.0,515.0
0.003,17,2,148,1,60,0.0,32.0,32.0,1,88,0.0,60.0,60.0
0.124,6,10,1506,5,395,28.0,127.0,127.0,5,1111,29.0,843.0,843.0
171.098,17,72,10334,36,2403,4888.0,44.0,38.0,36,7931,4888.0,239.0,192.0
0.068,6,10,1506,5,395,14.0,127.0,127.0,5,1111,14.0,843.0,843.0
0.126,17,2,170,1,65,0.0,37.0,37.0,1,105,0.0,77.0,77.0
240.098,6,16,4480,9,963,30012.0,238.0,166.0,7,3517,40015.0,1402.0,786.0
0.016,6,10,1990,5,911,3.0,643.0,643.0,5,1079,3.0,811.0,811.0
0.194,6,10,1506,5,395,45.0,127.0,127.0,5,1111,44.0,843.0,843.0
0.014,6,10,1990,5,911,3.0,643.0,643.0,5,1079,3.0,811.0,811.0
0.006,6,10,1689,5,839,1.0,571.0,571.0,5,850,1.0,582.0,582.0
0.005,6,13,3747,7,509,0.0,137.0,137.0,6,3238,0.0,1470.0,1459.0
0.006,17,2,166,1,75,0.0,47.0,47.0,1,91,0.0,63.0,63.0
0.116,6,10,1506,5,395,26.0,127.0,127.0,5,1111,24.0,843.0,843.0
0.095,6,10,1506,5,395,18.0,127.0,127.0,5,1111,21.0,843.0,843.0
0.015,6,10,1983,5,910,3.0,642.0,642.0,5,1073,3.0,805.0,805.0
0.038,17,2,148,1,60,0.0,32.0,32.0,1,88,0.0,60.0,60.0
0.004,6,10,2007,5,928,1.0,660.0,660.0,5,1079,1.0,811.0,811.0
0.008,6,12,1926,6,1189,1.0,659.0,434.0,6,737,1.0,417.0,417.0
0.016,6,10,1990,5,911,4.0,643.0,643.0,5,1079,3.0,811.0,811.0
40.06,17,10,676,5,460,10012.0,104.0,64.0,5,216,10013.0,20.0,15.0
65.883,6,22,10162,12,3995,5989.0,1601.0,840.0,10,6167,7301.0,2111.0,939.0
0.145,6,10,1506,5,395,28.0,127.0,127.0,5,1111,31.0,843.0,843.0
0.004,6,10,1779,5,928,1.0,660.0,660.0,5,851,1.0,583.0,583.0
0.001,17,2,180,1,66,0.0,38.0,38.0,1,114,0.0,86.0,86.0
0.005,6,10,1689,5,839,1.0,571.0,571.0,5,850,1.0,582.0,582.0
0.004,6,10,2007,5,928,1.0,660.0,660.0,5,1079,1.0,811.0,811.0
0.098,6,10,1506,5,395,20.0,127.0,127.0,5,1111,20.0,843.0,843.0
0.005,6,10,2006,5,927,1.0,659.0,659.0,5,1079,1.0,811.0,811.0
40.063,17,10,676,5,460,10015.0,104.0,64.0,5,216,10015.0,20.0,15.0
1756.066,6,105,6270,60,3525,29763.0,27.0,27.0,45,2745,39909.0,27.0,27.0
0.004,6,10,2006,5,927,1.0,659.0,659.0,5,1079,1.0,811.0,811.0
0.005,17,2,170,1,65,0.0,37.0,37.0,1,105,0.0,77.0,77.0
40.044,17,10,676,5,460,10010.0,104.0,64.0,5,216,10010.0,20.0,15.0
0.083,6,10,1506,5,395,18.0,127.0,127.0,5,1111,18.0,843.0,843.0
0.009,6,14,3787,7,497,1.0,125.0,125.0,7,3290,1.0,1448.0,972.0
0.016,6,10,1762,5,911,4.0,643.0,643.0,5,851,4.0,583.0,583.0
0.008,6,10,1972,5,910,2.0,642.0,642.0,5,1062,2.0,794.0,794.0
1769.149,17,92,8096,46,4048,39314.0,60.0,60.0,46,4048,39314.0,60.0,60.0
0.012,6,10,1972,5,910,2.0,642.0,642.0,5,1062,3.0,794.0,794.0
0.005,6,10,2006,5,927,1.0,659.0,659.0,5,1079,1.0,811.0,811.0
0.005,17,2,140,1,62,0.0,34.0,34.0,1,78,0.0,50.0,50.0
0.006,6,10,1689,5,839,1.0,571.0,571.0,5,850,1.0,582.0,582.0
40.067,17,10,676,5,460,10013.0,104.0,64.0,5,216,10015.0,20.0,15.0
15.079,17,16,8119,8,6020,2150.0,1350.0,724.0,8,2099,2149.0,1350.0,234.0
240.106,6,31,9119,15,6846,17150.0,1971.0,674.0,16,2273,16006.0,580.0,179.0
40.066,17,10,676,5,460,10014.0,104.0,64.0,5,216,10015.0,20.0,15.0
0.004,6,10,2006,5,927,1.0,659.0,659.0,5,1079,1.0,811.0,811.0
0.005,6,10,2007,5,928,1.0,660.0,660.0,5,1079,1.0,811.0,811.0
0.015,6,10,1990,5,911,3.0,643.0,643.0,5,1079,3.0,811.0,811.0
0.006,6,10,1689,5,839,1.0,571.0,571.0,5,850,1.0,582.0,582.0
0.006,6,13,3747,7,509,0.0,137.0,137.0,6,3238,1.0,1470.0,1459.0
0.004,6,10,2007,5,928,1.0,660.0,660.0,5,1079,1.0,811.0,811.0
0.012,6,10,1972,5,910,2.0,642.0,642.0,5,1062,3.0,794.0,794.0
0.005,17,2,169,1,62,0.0,34.0,34.0,1,107,0.0,79.0,79.0
0.006,6,10,1547,5,764,1.0,496.0,496.0,5,783,1.0,515.0,515.0
0.007,17,4,533,2,138,0.0,41.0,41.0,2,395,1.0,200.0,169.0
0.017,6,10,1983,5,910,4.0,642.0,642.0,5,1073,4.0,805.0,805.0
0.039,6,13,3913,7,495,6.0,123.0,123.0,6,3418,7.0,1650.0,1549.0
0.079,6,10,1506,5,395,16.0,127.0,127.0,5,1111,16.0,843.0,843.0
0.006,6,10,1643,5,860,1.0,592.0,592.0,5,783,1.0,515.0,515.0
0.004,6,10,1989,5,927,1.0,659.0,659.0,5,1062,1.0,794.0,794.0
40.091,17,10,676,5,460,10020.0,104.0,64.0,5,216,10021.0,20.0,15.0
0.003,17,2,136,1,60,0.0,32.0,32.0,1,76,0.0,48.0,48.0
0.016,6,10,1972,5,910,3.0,642.0,642.0,5,1062,4.0,794.0,794.0
0.095,6,10,1506,5,395,22.0,127.0,127.0,5,1111,22.0,843.0,843.0
0.04,17,2,182,1,65,0.0,37.0,37.0,1,117,0.0,89.0,89.0
0.248,6,16,2777,8,1395,35.0,533.0,323.0,8,1382,23.0,529.0,239.0
0.006,17,2,170,1,65,0.0,37.0,37.0,1,105,0.0,77.0,77.0
177.34,17,90,13204,45,3005,4030.0,44.0,38.0,45,10199,4030.0,261.0,198.0
0.006,6,10,1689,5,839,1.0,571.0,571.0,5,850,1.0,582.0,582.0
0.212,6,16,2777,8,1395,30.0,533.0,323.0,8,1382,19.0,529.0,239.0
0.181,6,3,453,2,321,181.0,241.0,241.0,1,132,0.0,92.0,92.0
0.096,6,10,1506,5,395,22.0,127.0,127.0,5,1111,21.0,843.0,843.0
0.01,6,10,1989,5,910,2.0,642.0,642.0,5,1079,2.0,811.0,811.0
0.025,17,2,170,1,65,0.0,37.0,37.0,1,105,0.0,77.0,77.0
163.05,17,76,10722,38,2532,4406.0,44.0,38.0,38,8190,4406.0,239.0,187.0
0.011,6,10,1989,5,910,2.0,642.0,642.0,5,1079,2.0,811.0,811.0
40.063,17,10,676,5,460,10013.0,104.0,64.0,5,216,10015.0,20.0,15.0
0.078,17,8,3613,4,1874,26.0,1350.0,440.0,4,1739,11.0,1350.0,406.0
0.169,17,2,152,1,76,0.0,48.0,48.0,1,76,0.0,48.0,48.0
0.006,6,10,1547,5,764,1.0,496.0,496.0,5,783,1.0,515.0,515.0
0.012,6,10,1989,5,910,3.0,642.0,642.0,5,1079,2.0,811.0,811.0
0.007,6,10,1989,5,910,1.0,642.0,642.0,5,1079,1.0,811.0,811.0
0.015,6,10,1972,5,910,3.0,642.0,642.0,5,1062,3.0,794.0,794.0
165.081,17,68,9500,34,2269,5002.0,44.0,38.0,34,7231,5002.0,239.0,184.0
15.158,6,37,9437,19,1777,842.0,329.0,99.0,18,7660,891.0,1402.0,559.0
0.005,6,10,1689,5,839,1.0,571.0,571.0,5,850,1.0,582.0,582.0
0.016,6,10,1972,5,910,4.0,642.0,642.0,5,1062,4.0,794.0,794.0
0.013,17,2,152,1,56,0.0,28.0,28.0,1,96,0.0,68.0,68.0
0.005,6,10,1689,5,839,1.0,571.0,571.0,5,850,1.0,582.0,582.0
0.072,17,2,136,1,60,0.0,32.0,32.0,1,76,0.0,48.0,48.0
0.005,6,10,1989,5,927,1.0,659.0,659.0,5,1062,1.0,794.0,794.0
0.003,17,2,136,1,60,0.0,32.0,32.0,1,76,0.0,48.0,48.0
0.004,6,10,1774,5,923,1.0,655.0,655.0,5,851,1.0,583.0,583.0
40.055,17,10,676,5,460,10012.0,104.0,64.0,5,216,10013.0,20.0,15.0
0.012,6,10,1677,5,827,3.0,559.0,559.0,5,850,3.0,582.0,582.0
0.076,6,10,1506,5,395,16.0,127.0,127.0,5,1111,17.0,843.0,843.0
160.455,17,70,10015,35,2339,4719.0,44.0,38.0,35,7676,4719.0,239.0,191.0
0.087,6,10,1506,5,395,20.0,127.0,127.0,5,1111,20.0,843.0,843.0
0.008,6,10,1989,5,910,2.0,642.0,642.0,5,1079,1.0,811.0,811.0
0.004,6,10,1779,5,928,1.0,660.0,660.0,5,851,1.0,583.0,583.0
0.013,6,10,1989,5,910,3.0,642.0,642.0,5,1079,3.0,811.0,811.0
0.106,6,10,1506,5,395,25.0,127.0,127.0,5,1111,22.0,843.0,843.0
15.033,17,56,34731,33,28648,468.0,1350.0,840.0,23,6083,682.0,1350.0,236.0
0.004,17,2,136,1,60,0.0,32.0,32.0,1,76,0.0,48.0,48.0
0.005,6,10,2006,5,927,1.0,659.0,659.0,5,1079,1.0,811.0,811.0
300.201,6,16,2170,9,684,37504.0,146.0,146.0,7,1486,50005.0,419.0,398.0
0.005,6,13,3747,7,509,0.0,137.0,137.0,6,3238,0.0,1470.0,1459.0
0.006,6,10,1989,5,927,1.0,659.0,659.0,5,1062,1.0,794.0,794.0
0.006,6,10,2007,5,928,1.0,660.0,660.0,5,1079,1.0,811.0,811.0
0.005,6,10,1779,5,928,1.0,660.0,660.0,5,851,1.0,583.0,583.0
0.005,17,2,230,1,68,0.0,40.0,40.0,1,162,0.0,134.0,134.0
0.006,6,10,1547,5,764,1.0,496.0,496.0,5,783,1.0,515.0,515.0
0.006,6,10,1547,5,764,1.0,496.0,496.0,5,783,1.0,515.0,515.0
0.015,6,10,1972,5,910,3.0,642.0,642.0,5,1062,3.0,794.0,794.0
0.001,17,2,180,1,66,0.0,38.0,38.0,1,114,0.0,86.0,86.0
0.012,6,10,1983,5,910,3.0,642.0,642.0,5,1073,3.0,805.0,805.0
177.096,17,76,10496,38,2520,4786.0,44.0,38.0,38,7976,4786.0,239.0,181.0
0.017,6,10,1990,5,911,4.0,643.0,643.0,5,1079,4.0,811.0,811.0
0.006,17,2,214,1,75,0.0,47.0,47.0,1,139,0.0,111.0,111.0
15.08,17,16,9211,8,6917,2150.0,1350.0,836.0,8,2294,2150.0,1350.0,258.0
0.014,6,10,1631,5,848,3.0,580.0,580.0,5,783,3.0,515.0,515.0
0.006,17,2,424,1,72,0.0,44.0,44.0,1,352,0.0,324.0,324.0
0.07,17,8,3613,4,1874,23.0,1350.0,440.0,4,1739,12.0,1350.0,406.0
0.117,6,10,1506,5,395,27.0,127.0,127.0,5,1111,25.0,843.0,843.0
0.012,6,10,1983,5,910,3.0,642.0,642.0,5,1073,3.0,805.0,805.0
11.155,17,28,4420,14,1993,845.0,268.0,114.0,14,2427,845.0,586.0,145.0
0.01,6,10,2006,5,927,2.0,659.0,659.0,5,1079,2.0,811.0,811.0
0.011,6,10,1989,5,910,2.0,642.0,642.0,5,1079,2.0,811.0,811.0
0.115,6,10,1506,5,395,26.0,127.0,127.0,5,1111,25.0,843.0,843.0
0.01,6,10,1989,5,910,2.0,642.0,642.0,5,1079,2.0,811.0,811.0
0.006,17,2,152,1,68,0.0,40.0,40.0,1,84,0.0,56.0,56.0
0.103,6,10,1506,5,395,24.0,127.0,127.0,5,1111,20.0,843.0,843.0
0.121,6,10,1506,5,395,25.0,127.0,127.0,5,1111,25.0,843.0,843.0
0.013,6,13,3735,7,497,2.0,125.0,125.0,6,3238,2.0,1470.0,1459.0
40.068,17,10,676,5,460,10014.0,104.0,64.0,5,216,10015.0,20.0,15.0
0.006,6,10,1643,5,860,1.0,592.0,592.0,5,783,1.0,515.0,515.0
0.008,6,10,1990,5,911,2.0,643.0,643.0,5,1079,2.0,811.0,811.0
0.003,17,4,336,2,124,0.0,34.0,34.0,2,212,0.0,84.0,78.0
0.081,6,10,1506,5,395,16.0,127.0,127.0,5,1111,17.0,843.0,843.0
0.008,6,10,1677,5,827,2.0,559.0,559.0,5,850,2.0,582.0,582.0
0.014,6,13,3735,7,497,2.0,125.0,125.0,6,3238,2.0,1470.0,1459.0
0.071,6,10,1506,5,395,15.0,127.0,127.0,5,1111,15.0,843.0,843.0
0.005,6,10,2007,5,928,1.0,660.0,660.0,5,1079,1.0,811.0,811.0
0.016,6,10,1631,5,848,3.0,580.0,580.0,5,783,4.0,515.0,515.0
2.977,6,40,6939,22,3615,141.0,1103.0,204.0,18,3324,109.0,1402.0,340.0
0.008,6,10,1989,5,910,2.0,642.0,642.0,5,1079,2.0,811.0,811.0
40.065,17,10,676,5,460,10014.0,104.0,64.0,5,216,10015.0,20.0,15.0
0.006,6,10,1547,5,764,1.0,496.0,496.0,5,783,1.0,515.0,515.0
0.014,6,10,1762,5,911,3.0,643.0,643.0,5,851,3.0,583.0,583.0
0.008,6,10,1762,5,911,2.0,643.0,643.0,5,851,2.0,583.0,583.0
0.077,6,10,1506,5,395,15.0,127.0,127.0,5,1111,17.0,843.0,843.0
0.013,6,10,1990,5,911,3.0,643.0,643.0,5,1079,3.0,811.0,811.0
0.008,6,10,1990,5,911,2.0,643.0,643.0,5,1079,1.0,811.0,811.0
0.101,6,10,1506,5,395,22.0,127.0,127.0,5,1111,23.0,843.0,843.0
0.008,6,10,1972,5,910,2.0,642.0,642.0,5,1062,1.0,794.0,794.0
0.005,17,2,169,1,62,0.0,34.0,34.0,1,107,0.0,79.0,79.0
0.005,17,2,164,1,74,0.0,46.0,46.0,1,90,0.0,62.0,62.0
0.005,6,10,2007,5,928,1.0,660.0,660.0,5,1079,1.0,811.0,811.0
177.378,17,96,13846,48,3236,3773.0,44.0,39.0,48,10610,3773.0,261.0,193.0
0.005,6,10,1689,5,839,1.0,571.0,571.0,5,850,1.0,582.0,582.0
352.258,6,20,2210,6,1308,12003.0,494.0,494.0,14,902,27096.0,83.0,83.0
1785.748,6,253,25719,103,9702,17506.0,758.0,70.0,150,16017,11984.0,1360.0,131.0
0.004,6,10,2007,5,928,1.0,660.0,660.0,5,1079,1.0,811.0,811.0
0.111,6,10,1506,5,395,25.0,127.0,127.0,5,1111,20.0,843.0,843.0
0.011,6,10,1631,5,848,2.0,580.0,580.0,5,783,2.0,515.0,515.0
40.057,17,10,676,5,460,10012.0,104.0,64.0,5,216,10013.0,20.0,15.0
0.008,6,10,1989,5,910,1.0,642.0,642.0,5,1079,1.0,811.0,811.0
0.013,6,10,1972,5,910,3.0,642.0,642.0,5,1062,3.0,794.0,794.0
0.062,6,10,1506,5,395,15.0,127.0,127.0,5,1111,13.0,843.0,843.0
0.007,17,2,136,1,60,0.0,32.0,32.0,1,76,0.0,48.0,48.0
0.004,6,10,2006,5,927,1.0,659.0,659.0,5,1079,1.0,811.0,811.0
0.005,17,2,169,1,62,0.0,34.0,34.0,1,107,0.0,79.0,79.0
0.085,6,10,1506,5,395,19.0,127.0,127.0,5,1111,18.0,843.0,843.0
0.04,17,2,136,1,60,0.0,32.0,32.0,1,76,0.0,48.0,48.0
0.011,6,10,1989,5,910,2.0,642.0,642.0,5,1079,2.0,811.0,811.0
0.01,6,10,1989,5,910,2.0,642.0,642.0,5,1079,2.0,811.0,811.0
0.005,6,10,1774,5,923,1.0,655.0,655.0,5,851,1.0,583.0,583.0
0.073,17,4,284,2,120,0.0,32.0,32.0,2,164,69.0,60.0,54.0
0.01,6,10,1990,5,911,2.0,643.0,643.0,5,1079,2.0,811.0,811.0
0.021,6,10,1631,5,848,5.0,580.0,580.0,5,783,5.0,515.0,515.0
0.096,6,10,1506,5,395,20.0,127.0,127.0,5,1111,19.0,843.0,843.0
0.117,6,10,1506,5,395,28.0,127.0,127.0,5,1111,22.0,843.0,843.0
0.007,17,2,179,1,71,0.0,43.0,43.0,1,108,0.0,80.0,80.0
0.009,6,10,1989,5,910,2.0,642.0,642.0,5,1079,2.0,811.0,811.0
0.031,6,10,1989,5,910,7.0,642.0,642.0,5,1079,7.0,811.0,811.0
0.079,6,10,1506,5,395,16.0,127.0,127.0,5,1111,17.0,843.0,843.0
40.051,17,10,676,5,460,10011.0,104.0,64.0,5,216,10011.0,20.0,15.0
0.017,6,10,1989,5,910,4.0,642.0,642.0,5,1079,4.0,811.0,811.0
0.069,17,8,3613,4,1874,23.0,1350.0,440.0,4,1739,12.0,1350.0,406.0
0.005,17,2,178,1,81,0.0,53.0,53.0,1,97,0.0,69.0,69.0
0.006,6,10,1689,5,839,1.0,571.0,571.0,5,850,1.0,582.0,582.0
0.012,17,2,152,1,56,0.0,28.0,28.0,1,96,0.0,68.0,68.0
0.013,6,10,1677,5,827,3.0,559.0,559.0,5,850,3.0,582.0,582.0
0.001,17,2,180,1,66,0.0,38.0,38.0,1,114,0.0,86.0,86.0
0.004,17,4,284,2,120,0.0,32.0,32.0,2,164,0.0,60.0,54.0
0.008,6,10,1972,5,910,2.0,642.0,642.0,5,1062,2.0,794.0,794.0
0.005,6,10,2006,5,927,1.0,659.0,659.0,5,1079,1.0,811.0,811.0
0.003,17,2,136,1,60,0.0,32.0,32.0,1,76,0.0,48.0,48.0
308.944,17,20,1124,10,716,34312.0,48.0,43.0,10,408,34312.0,20.0,12.0
0.142,6,10,1506,5,395,30.0,127.0,127.0,5,1111,28.0,843.0,843.0
0.012,6,10,1989,5,910,3.0,642.0,642.0,5,1079,3.0,811.0,811.0
0.017,6,10,1983,5,910,4.0,642.0,642.0,5,1073,4.0,805.0,805.0
0.004,6,13,3690,7,452,0.0,80.0,80.0,6,3238,0.0,1470.0,1459.0
0.119,6,29,10189,15,8942,8.0,2883.0,1166.0,14,1247,8.0,176.0,86.0
0.187,17,2,142,1,63,0.0,35.0,35.0,1,79,0.0,51.0,51.0
0.059,6,10,1506,5,395,14.0,127.0,127.0,5,1111,12.0,843.0,843.0
0.014,6,10,1983,5,910,3.0,642.0,642.0,5,1073,3.0,805.0,805.0
0.004,6,10,1989,5,927,1.0,659.0,659.0,5,1062,1.0,794.0,794.0
0.008,17,2,194,1,59,0.0,31.0,31.0,1,135,0.0,107.0,107.0
0.006,6,10,1547,5,764,1.0,496.0,496.0,5,783,1.0,515.0,515.0
0.084,17,2,144,1,64,0.0,36.0,36.0,1,80,0.0,52.0,52.0
0.005,6,10,1643,5,860,1.0,592.0,592.0,5,783,1.0,515.0,515.0
0.007,6,10,1762,5,911,1.0,643.0,643.0,5,851,1.0,583.0,583.0
300.084,6,19,4659,11,1102,30007.0,238.0,130.0,8,3557,42868.0,1402.0,786.0
40.076,17,10,676,5,460,10016.0,104.0,64.0,5,216,10018.0,20.0,15.0
240.072,6,21,4925,11,941,24007.0,180.0,93.0,10,3984,26674.0,1592.0,576.0
0.018,6,10,1989,5,910,4.0,642.0,642.0,5,1079,4.0,811.0,811.0
0.005,6,10,1689,5,839,1.0,571.0,571.0,5,850,1.0,582.0,582.0
0.005,6,10,1689,5,839,1.0,571.0,571.0,5,850,1.0,582.0,582.0
0.004,6,10,2000,5,927,1.0,659.0,659.0,5,1073,1.0,805.0,805.0
0.008,6,10,1983,5,910,2.0,642.0,642.0,5,1073,1.0,805.0,805.0
0.078,6,10,1506,5,395,18.0,127.0,127.0,5,1111,16.0,843.0,843.0
0.189,17,4,284,2,120,186.0,32.0,32.0,2,164,117.0,60.0,54.0
0.012,6,10,1989,5,910,2.0,642.0,642.0,5,1079,3.0,811.0,811.0
0.004,6,10,1774,5,923,1.0,655.0,655.0,5,851,1.0,583.0,583.0
0.004,17,2,136,1,60,0.0,32.0,32.0,1,76,0.0,48.0,48.0
0.006,6,10,1547,5,764,1.0,496.0,496.0,5,783,1.0,515.0,515.0
0.005,6,13,3747,7,509,0.0,137.0,137.0,6,3238,0.0,1470.0,1459.0
0.072,17,8,3613,4,1874,24.0,1350.0,440.0,4,1739,12.0,1350.0,406.0
0.005,6,10,1689,5,839,1.0,571.0,571.0,5,850,1.0,582.0,582.0
0.006,17,2,144,1,64,0.0,36.0,36.0,1,80,0.0,52.0,52.0
0.018,6,10,1990,5,911,4.0,643.0,643.0,5,1079,4.0,811.0,811.0
0.008,6,10,1989,5,910,2.0,642.0,642.0,5,1079,1.0,811.0,811.0
0.004,17,2,144,1,64,0.0,36.0,36.0,1,80,0.0,52.0,52.0
40.074,17,10,676,5,460,10015.0,104.0,64.0,5,216,10016.0,20.0,15.0
0.005,6,10,2006,5,927,1.0,659.0,659.0,5,1079,1.0,811.0,811.0
0.089,6,10,1506,5,395,17.0,127.0,127.0,5,1111,19.0,843.0,843.0
0.076,6,10,1506,5,395,17.0,127.0,127.0,5,1111,17.0,843.0,843.0
75.52,6,75,68419,40,43333,1936.0,2804.0,1793.0,35,25086,2216.0,2824.0,1292.0
0.009,6,12,1926,6,1189,1.0,659.0,434.0,6,737,1.0,417.0,417.0
0.083,6,10,1506,5,395,17.0,127.0,127.0,5,1111,19.0,843.0,843.0
0.008,6,10,1972,5,910,2.0,642.0,642.0,5,1062,2.0,794.0,794.0
0.014,17,2,152,1,56,0.0,28.0,28.0,1,96,0.0,68.0,68.0
0.016,6,10,1972,5,910,4.0,642.0,642.0,5,1062,4.0,794.0,794.0
0.005,6,10,2007,5,928,1.0,660.0,660.0,5,1079,1.0,811.0,811.0
0.154,17,4,352,2,130,115.0,37.0,37.0,2,222,150.0,89.0,83.0
0.008,6,13,3747,7,509,1.0,137.0,137.0,6,3238,1.0,1470.0,1459.0
0.016,6,10,1990,5,911,3.0,643.0,643.0,5,1079,3.0,811.0,811.0
0.012,6,10,1972,5,910,2.0,642.0,642.0,5,1062,2.0,794.0,794.0
0.001,17,2,180,1,66,0.0,38.0,38.0,1,114,0.0,86.0,86.0
0.01,6,10,1990,5,911,2.0,643.0,643.0,5,1079,2.0,811.0,811.0
0.02,6,10,1631,5,848,5.0,580.0,580.0,5,783,5.0,515.0,515.0
10.867,17,28,4421,14,1994,827.0,269.0,114.0,14,2427,827.0,586.0,145.0
0.133,6,10,1506,5,395,31.0,127.0,127.0,5,1111,29.0,843.0,843.0
0.009,6,10,1643,5,860,2.0,592.0,592.0,5,783,2.0,515.0,515.0
0.005,17,2,230,1,68,0.0,40.0,40.0,1,162,0.0,134.0,134.0
0.144,6,10,1506,5,395,31.0,127.0,127.0,5,1111,32.0,843.0,843.0
0.012,6,10,1631,5,848,2.0,580.0,580.0,5,783,3.0,515.0,515.0
0.005,17,2,170,1,65,0.0,37.0,37.0,1,105,0.0,77.0,77.0
0.005,6,10,1689,5,839,1.0,571.0,571.0,5,850,1.0,582.0,582.0
11.186,17,28,4423,14,1994,847.0,269.0,114.0,14,2429,847.0,588.0,145.0
176.171,17,80,11232,40,2687,4516.0,44.0,39.0,40,8545,4517.0,239.0,185.0
0.102,6,10,1506,5,395,23.0,127.0,127.0,5,1111,21.0,843.0,843.0
0.007,6,10,1689,5,839,1.0,571.0,571.0,5,850,1.0,582.0,582.0
0.006,6,10,2006,5,927,1.0,659.0,659.0,5,1079,1.0,811.0,811.0
0.021,6,10,1983,5,910,5.0,642.0,642.0,5,1073,5.0,805.0,805.0
0.074,6,10,1506,5,395,15.0,127.0,127.0,5,1111,17.0,843.0,843.0
0.003,17,2,148,1,60,0.0,32.0,32.0,1,88,0.0,60.0,60.0
0.006,6,10,1547,5,764,1.0,496.0,496.0,5,783,1.0,515.0,515.0
0.008,6,12,1926,6,1189,1.0,659.0,434.0,6,737,1.0,417.0,417.0
0.008,17,2,299,1,65,0.0,37.0,37.0,1,234,0.0,206.0,206.0
0.011,6,10,1677,5,827,2.0,559.0,559.0,5,850,2.0,582.0,582.0
11.136,17,28,4418,14,1994,847.0,269.0,114.0,14,2424,847.0,587.0,145.0
0.119,6,10,1506,5,395,22.0,127.0,127.0,5,1111,24.0,843.0,843.0
0.005,6,10,2006,5,927,1.0,659.0,659.0,5,1079,1.0,811.0,811.0
177.524,17,82,11601,41,2731,4437.0,44.0,38.0,41,8870,4438.0,239.0,188.0
0.006,17,2,170,1,65,0.0,37.0,37.0,1,105,0.0,77.0,77.0
0.043,17,4,284,2,120,0.0,32.0,32.0,2,164,33.0,60.0,54.0
0.006,6,10,1643,5,860,1.0,592.0,592.0,5,783,1.0,515.0,515.0
0.041,17,2,182,1,65,0.0,37.0,37.0,1,117,0.0,89.0,89.0
0.153,6,10,1506,5,395,34.0,127.0,127.0,5,1111,36.0,843.0,843.0
0.005,6,10,2006,5,927,1.0,659.0,659.0,5,1079,1.0,811.0,811.0
0.001,17,2,180,1,66,0.0,38.0,38.0,1,114,0.0,86.0,86.0
10.905,17,28,4422,14,1995,830.0,270.0,114.0,14,2427,830.0,586.0,145.0
0.089,6,10,1506,5,395,19.0,127.0,127.0,5,1111,21.0,843.0,843.0
1787.108,6,154,19574,92,13852,19638.0,302.0,302.0,62,5722,29296.0,83.0,83.0
0.009,6,12,1926,6,1189,1.0,659.0,434.0,6,737,1.0,417.0,417.0
0.012,17,2,152,1,56,0.0,28.0,28.0,1,96,0.0,68.0,68.0
0.109,6,10,1506,5,395,22.0,127.0,127.0,5,1111,24.0,843.0,843.0
0.004,6,10,2006,5,927,1.0,659.0,659.0,5,1079,1.0,811.0,811.0
0.02,6,10,1631,5,848,4.0,580.0,580.0,5,783,4.0,515.0,515.0
0.005,6,10,2006,5,927,1.0,659.0,659.0,5,1079,1.0,811.0,811.0
0.005,6,10,2006,5,927,1.0,659.0,659.0,5,1079,1.0,811.0,811.0
0.009,6,10,1989,5,910,2.0,642.0,642.0,5,1079,2.0,811.0,811.0
0.005,6,10,1989,5,927,1.0,659.0,659.0,5,1062,1.0,794.0,794.0
0.005,6,10,1854,5,889,1.0,621.0,621.0,5,965,1.0,697.0,697.0
0.171,17,2,179,1,71,0.0,43.0,43.0,1,108,0.0,80.0,80.0
0.005,6,10,1989,5,927,1.0,659.0,659.0,5,1062,1.0,794.0,794.0
0.012,6,10,1989,5,910,3.0,642.0,642.0,5,1079,3.0,811.0,811.0
0.006,6,10,1547,5,764,1.0,496.0,496.0,5,783,1.0,515.0,515.0
0.005,6,10,2007,5,928,1.0,660.0,660.0,5,1079,1.0,811.0,811.0
169.074,17,78,11296,39,2619,4449.0,44.0,39.0,39,8677,4449.0,260.0,194.0
66.572,6,27,17545,15,9603,4755.0,2804.0,1469.0,12,7942,6036.0,2313.0,1218.0
0.004,6,10,1779,5,928,1.0,660.0,660.0,5,851,1.0,583.0,583.0
0.014,6,10,1989,5,910,3.0,642.0,642.0,5,1079,3.0,811.0,811.0
0.053,17,2,152,1,76,0.0,48.0,48.0,1,76,0.0,48.0,48.0
0.006,6,10,1689,5,839,1.0,571.0,571.0,5,850,1.0,582.0,582.0
0.004,6,10,1702,5,863,1.0,595.0,595.0,5,839,0.0,571.0,571.0
0.268,17,39,20090,21,17029,13.0,1350.0,782.0,18,3061,12.0,1350.0,142.0
40.064,17,10,676,5,460,10015.0,104.0,64.0,5,216,10015.0,20.0,15.0
0.006,6,10,1854,5,889,1.0,621.0,621.0,5,965,1.0,697.0,697.0
40.071,17,10,676,5,460,10014.0,104.0,64.0,5,216,10016.0,20.0,15.0
294.449,6,384,348876,201,22034,1472.0,2736.0,889.0,183,326842,1617.0,2804.0,1877.0
0.012,6,10,1989,5,910,3.0,642.0,642.0,5,1079,2.0,811.0,811.0
0.234,6,16,2777,8,1395,33.0,533.0,323.0,8,1382,22.0,529.0,239.0
0.007,6,10,1547,5,764,1.0,496.0,496.0,5,783,1.0,515.0,515.0
0.007,6,10,1983,5,910,1.0,642.0,642.0,5,1073,1.0,805.0,805.0
0.001,17,2,180,1,66,0.0,38.0,38.0,1,114,0.0,86.0,86.0
0.017,6,10,1990,5,911,4.0,643.0,643.0,5,1079,4.0,811.0,811.0
0.013,6,10,1990,5,911,3.0,643.0,643.0,5,1079,3.0,811.0,811.0
0.004,17,2,148,1,60,0.0,32.0,32.0,1,88,0.0,60.0,60.0
0.006,17,2,148,1,60,0.0,32.0,32.0,1,88,0.0,60.0,60.0
0.001,17,2,154,1,69,0.0,41.0,41.0,1,85,0.0,57.0,57.0
0.026,6,10,1631,5,848,6.0,580.0,580.0,5,783,6.0,515.0,515.0
0.005,6,10,1643,5,860,1.0,592.0,592.0,5,783,1.0,515.0,515.0
240.009,6,9,787,5,488,60002.0,232.0,232.0,4,299,80002.0,83.0,83.0
0.004,17,2,148,1,60,0.0,32.0,32.0,1,88,0.0,60.0,60.0
10.8,17,28,4421,14,1993,821.0,268.0,114.0,14,2428,821.0,587.0,145.0
40.056,17,10,676,5,460,10013.0,104.0,64.0,5,216,10013.0,20.0,15.0
0.004,6,10,2000,5,927,1.0,659.0,659.0,5,1073,1.0,805.0,805.0
0.003,6,10,1702,5,863,0.0,595.0,595.0,5,839,0.0,571.0,571.0
0.008,6,10,1990,5,911,2.0,643.0,643.0,5,1079,2.0,811.0,811.0
0.004,6,10,1774,5,923,1.0,655.0,655.0,5,851,1.0,583.0,583.0
0.003,17,2,148,1,60,0.0,32.0,32.0,1,88,0.0,60.0,60.0
0.006,6,10,1774,5,923,1.0,655.0,655.0,5,851,1.0,583.0,583.0
300.181,6,39,10113,21,4595,15000.0,1360.0,620.0,18,5518,17647.0,2667.0,435.0
0.006,17,2,140,1,62,0.0,34.0,34.0,1,78,0.0,50.0,50.0
0.09,6,10,1506,5,395,19.0,127.0,127.0,5,1111,21.0,843.0,843.0
0.005,6,10,1989,5,927,1.0,659.0,659.0,5,1062,1.0,794.0,794.0
0.011,6,10,1990,5,911,2.0,643.0,643.0,5,1079,2.0,811.0,811.0
15.071,17,15,9238,8,6902,2149.0,1350.0,834.0,7,2336,2506.0,1350.0,305.0
300.78,6,39,12758,21,7240,15039.0,2720.0,1061.0,18,5518,506.0,2667.0,435.0
1769.315,17,92,8096,46,4048,39317.0,60.0,60.0,46,4048,39317.0,60.0,60.0
0.267,17,44,24412,24,21174,11.0,1350.0,854.0,20,3238,10.0,1350.0,133.0
0.005,6,10,2000,5,927,1.0,659.0,659.0,5,1073,1.0,805.0,805.0
0.117,6,10,1506,5,395,25.0,127.0,127.0,5,1111,23.0,843.0,843.0
0.114,6,10,1506,5,395,23.0,127.0,127.0,5,1111,23.0,843.0,843.0
40.064,17,10,676,5,460,10013.0,104.0,64.0,5,216,10014.0,20.0,15.0
0.01,6,10,1989,5,910,2.0,642.0,642.0,5,1079,2.0,811.0,811.0
0.136,6,10,1506,5,395,31.0,127.0,127.0,5,1111,31.0,843.0,843.0
0.006,17,2,170,1,65,0.0,37.0,37.0,1,105,0.0,77.0,77.0
0.011,6,10,1989,5,910,2.0,642.0,642.0,5,1079,2.0,811.0,811.0
0.127,17,2,80,1,32,0.0,4.0,4.0,1,48,0.0,20.0,20.0
0.01,6,10,1990,5,911,2.0,643.0,643.0,5,1079,2.0,811.0,811.0
0.012,6,10,1677,5,827,3.0,559.0,559.0,5,850,2.0,582.0,582.0
0.012,6,10,1677,5,827,3.0,559.0,559.0,5,850,2.0,582.0,582.0
171.239,17,76,10820,38,2538,4627.0,44.0,38.0,38,8282,4628.0,239.0,189.0
0.006,6,10,1547,5,764,1.0,496.0,496.0,5,783,1.0,515.0,515.0
0.005,6,13,3747,7,509,0.0,137.0,137.0,6,3238,1.0,1470.0,1459.0
0.101,6,10,1506,5,395,21.0,127.0,127.0,5,1111,22.0,843.0,843.0
0.007,6,10,1774,5,923,1.0,655.0,655.0,5,851,1.0,583.0,583.0
0.074,6,10,1506,5,395,13.0,127.0,127.0,5,1111,17.0,843.0,843.0
0.012,6,10,1989,5,910,3.0,642.0,642.0,5,1079,3.0,811.0,811.0
0.123,6,10,1506,5,395,24.0,127.0,127.0,5,1111,24.0,843.0,843.0
0.106,6,10,1506,5,395,24.0,127.0,127.0,5,1111,25.0,843.0,843.0
0.006,6,10,2000,5,927,1.0,659.0,659.0,5,1073,1.0,805.0,805.0
0.011,6,10,1983,5,910,2.0,642.0,642.0,5,1073,2.0,805.0,805.0
0.082,6,10,1506,5,395,19.0,127.0,127.0,5,1111,19.0,843.0,843.0
0.094,6,10,1506,5,395,22.0,127.0,127.0,5,1111,20.0,843.0,843.0
0.006,6,10,1989,5,927,1.0,659.0,659.0,5,1062,1.0,794.0,794.0
0.006,6,10,1547,5,764,1.0,496.0,496.0,5,783,1.0,515.0,515.0
0.005,6,10,2006,5,927,1.0,659.0,659.0,5,1079,1.0,811.0,811.0
0.016,6,10,1972,5,910,4.0,642.0,642.0,5,1062,3.0,794.0,794.0
0.004,17,2,136,1,60,0.0,32.0,32.0,1,76,0.0,48.0,48.0
0.005,6,10,1989,5,927,1.0,659.0,659.0,5,1062,1.0,794.0,794.0
0.004,17,2,136,1,60,0.0,32.0,32.0,1,76,0.0,48.0,48.0
368.881,6,22,2313,16,867,24592.0,195.0,195.0,6,1446,4658.0,419.0,398.0
0.014,6,10,1989,5,910,3.0,642.0,642.0,5,1079,3.0,811.0,811.0
0.006,6,13,3747,7,509,1.0,137.0,137.0,6,3238,1.0,1470.0,1459.0
0.005,6,10,1989,5,927,1.0,659.0,659.0,5,1062,1.0,794.0,794.0
15.072,17,15,9238,8,6902,2149.0,1350.0,834.0,7,2336,2507.0,1350.0,305.0
0.001,17,2,180,1,66,0.0,38.0,38.0,1,114,0.0,86.0,86.0
0.007,17,2,179,1,71,0.0,43.0,43.0,1,108,0.0,80.0,80.0
0.009,6,10,1990,5,911,2.0,643.0,643.0,5,1079,2.0,811.0,811.0
40.064,17,10,676,5,460,10013.0,104.0,64.0,5,216,10015.0,20.0,15.0
0.01,6,10,1972,5,910,2.0,642.0,642.0,5,1062,2.0,794.0,794.0
0.006,17,2,164,1,74,0.0,46.0,46.0,1,90,0.0,62.0,62.0
0.005,6,13,3747,7,509,0.0,137.0,137.0,6,3238,0.0,1470.0,1459.0
0.006,6,10,1547,5,764,1.0,496.0,496.0,5,783,1.0,515.0,515.0
0.006,17,2,169,1,62,0.0,34.0,34.0,1,107,0.0,79.0,79.0
0.013,6,10,1972,5,910,3.0,642.0,642.0,5,1062,3.0,794.0,794.0
0.001,17,2,180,1,66,0.0,38.0,38.0,1,114,0.0,86.0,86.0
0.005,17,2,166,1,75,0.0,47.0,47.0,1,91,0.0,63.0,63.0
0.121,6,10,1506,5,395,28.0,127.0,127.0,5,1111,28.0,843.0,843.0
0.01,6,10,1989,5,910,2.0,642.0,642.0,5,1079,2.0,811.0,811.0
0.109,17,2,160,1,72,0.0,44.0,44.0,1,88,0.0,60.0,60.0
0.008,6,10,1989,5,910,2.0,642.0,642.0,5,1079,1.0,811.0,811.0
0.004,6,10,2007,5,928,1.0,660.0,660.0,5,1079,1.0,811.0,811.0
10.799,17,28,4418,14,1993,820.0,268.0,114.0,14,2425,821.0,588.0,145.0
0.042,17,4,352,2,130,0.0,37.0,37.0,2,222,2.0,89.0,83.0
0.265,17,43,24458,24,21161,11.0,1350.0,853.0,19,3297,11.0,1350.0,145.0
0.005,6,10,1774,5,923,1.0,655.0,655.0,5,851,1.0,583.0,583.0
0.016,6,10,1989,5,910,4.0,642.0,642.0,5,1079,4.0,811.0,811.0
0.043,17,4,352,2,130,4.0,37.0,37.0,2,222,2.0,89.0,83.0
15.075,17,15,9238,8,6902,2149.0,1350.0,834.0,7,2336,2507.0,1350.0,305.0
0.087,6,10,1506,5,395,18.0,127.0,127.0,5,1111,20.0,843.0,843.0
173.442,17,86,12375,43,2881,4129.0,44.0,39.0,43,9494,4129.0,239.0,192.0
0.023,17,2,136,1,60,0.0,32.0,32.0,1,76,0.0,48.0,48.0
1778.69,17,144,45504,72,22752,25051.0,288.0,288.0,72,22752,25051.0,288.0,288.0
11.226,17,28,4423,14,1994,850.0,269.0,114.0,14,2429,850.0,588.0,145.0
0.004,17,2,184,1,61,0.0,33.0,33.0,1,123,0.0,95.0,95.0
0.005,6,10,2006,5,927,1.0,659.0,659.0,5,1079,1.0,811.0,811.0
0.012,6,10,1972,5,910,3.0,642.0,642.0,5,1062,2.0,794.0,794.0
40.057,17,10,676,5,460,10012.0,104.0,64.0,5,216,10013.0,20.0,15.0
0.042,6,10,1990,5,911,10.0,643.0,643.0,5,1079,10.0,811.0,811.0
0.005,6,10,2006,5,927,1.0,659.0,659.0,5,1079,1.0,811.0,811.0
0.006,6,10,1547,5,764,1.0,496.0,496.0,5,783,1.0,515.0,515.0
0.119,6,10,1506,5,395,26.0,127.0,127.0,5,1111,27.0,843.0,843.0
0.13,6,10,1506,5,395,28.0,127.0,127.0,5,1111,29.0,843.0,843.0
0.01,6,10,1983,5,910,2.0,642.0,642.0,5,1073,2.0,805.0,805.0
0.009,17,2,136,1,60,0.0,32.0,32.0,1,76,0.0,48.0,48.0
0.119,6,10,1506,5,395,26.0,127.0,127.0,5,1111,25.0,843.0,843.0
0.038,17,2,136,1,60,0.0,32.0,32.0,1,76,0.0,48.0,48.0
0.012,6,10,1762,5,911,3.0,643.0,643.0,5,851,2.0,583.0,583.0
0.005,6,10,1689,5,839,1.0,571.0,571.0,5,850,1.0,582.0,582.0
240.092,6,16,4482,9,963,30011.0,238.0,166.0,7,3519,40014.0,1402.0,786.0
0.001,17,2,180,1,66,0.0,38.0,38.0,1,114,0.0,86.0,86.0
0.085,6,10,1506,5,395,19.0,127.0,127.0,5,1111,19.0,843.0,843.0
0.007,6,10,1547,5,764,1.0,496.0,496.0,5,783,1.0,515.0,515.0
11.184,17,28,4422,14,1994,847.0,269.0,114.0,14,2428,847.0,587.0,145.0
40.066,17,10,676,5,460,10014.0,104.0,64.0,5,216,10015.0,20.0,15.0
0.077,6,10,1506,5,395,17.0,127.0,127.0,5,1111,17.0,843.0,843.0
0.008,6,10,1989,5,910,1.0,642.0,642.0,5,1079,2.0,811.0,811.0
0.016,6,10,1983,5,910,4.0,642.0,642.0,5,1073,4.0,805.0,805.0
0.228,6,16,2777,8,1395,32.0,533.0,323.0,8,1382,21.0,529.0,239.0
0.008,6,10,1989,5,910,1.0,642.0,642.0,5,1079,2.0,811.0,811.0
0.093,6,10,1506,5,395,20.0,127.0,127.0,5,1111,20.0,843.0,843.0
0.005,6,10,2007,5,928,1.0,660.0,660.0,5,1079,1.0,811.0,811.0
0.005,6,10,2006,5,927,1.0,659.0,659.0,5,1079,1.0,811.0,811.0
0.01,6,10,1972,5,910,2.0,642.0,642.0,5,1062,2.0,794.0,794.0
300.842,6,37,9597,20,4119,15833.0,1543.0,657.0,17,5478,542.0,2667.0,435.0
15.2,17,20,11362,10,7801,1685.0,1350.0,752.0,10,3561,1683.0,1350.0,328.0
1755.833,6,446,65220,252,35168,6995.0,613.0,197.0,194,30052,9097.0,453.0,142.0
0.004,17,2,136,1,60,0.0,32.0,32.0,1,76,0.0,48.0,48.0
240.099,6,16,4481,9,963,30012.0,238.0,166.0,7,3518,40016.0,1402.0,786.0
300.09,6,23,4991,11,2381,30008.0,1026.0,447.0,12,2610,27280.0,1162.0,331.0
0.005,6,10,1689,5,839,1.0,571.0,571.0,5,850,1.0,582.0,582.0
0.005,6,10,2000,5,927,1.0,659.0,659.0,5,1073,1.0,805.0,805.0
0.011,6,10,1989,5,910,2.0,642.0,642.0,5,1079,2.0,811.0,811.0
40.085,17,10,676,5,460,10017.0,104.0,64.0,5,216,10020.0,20.0,15.0
0.088,6,10,1506,5,395,20.0,127.0,127.0,5,1111,18.0,843.0,843.0
0.006,6,10,1989,5,927,1.0,659.0,659.0,5,1062,1.0,794.0,794.0
0.006,6,10,1689,5,839,1.0,571.0,571.0,5,850,1.0,582.0,582.0
0.005,6,10,1779,5,928,1.0,660.0,660.0,5,851,1.0,583.0,583.0
0.005,6,10,2006,5,927,1.0,659.0,659.0,5,1079,1.0,811.0,811.0
0.005,6,10,2000,5,927,1.0,659.0,659.0,5,1073,1.0,805.0,805.0
0.007,17,2,194,1,59,0.0,31.0,31.0,1,135,0.0,107.0,107.0
0.001,17,2,180,1,66,0.0,38.0,38.0,1,114,0.0,86.0,86.0
308.589,17,20,1124,10,716,34273.0,48.0,43.0,10,408,34273.0,20.0,12.0
255.437,6,16,4481,9,963,31929.0,238.0,166.0,7,3518,42572.0,1402.0,786.0
0.005,6,10,1779,5,928,1.0,660.0,660.0,5,851,1.0,583.0,583.0
0.093,6,10,1506,5,395,20.0,127.0,127.0,5,1111,19.0,843.0,843.0
40.045,17,10,676,5,460,10010.0,104.0,64.0,5,216,10010.0,20.0,15.0
240.445,6,33,10016,16,2091,16027.0,539.0,250.0,17,7925,15025.0,1402.0,640.0
241.228,6,301,343129,116,17548,2097.0,2736.0,960.0,185,325581,1311.0,2804.0,1805.0
15.072,17,15,9238,8,6902,2149.0,1350.0,834.0,7,2336,2507.0,1350.0,305.0
0.001,17,2,136,1,60,0.0,32.0,32.0,1,76,0.0,48.0,48.0
0.133,6,10,1506,5,395,30.0,127.0,127.0,5,1111,28.0,843.0,843.0
0.01,6,10,1972,5,910,2.0,642.0,642.0,5,1062,2.0,794.0,794.0
40.057,17,10,676,5,460,10013.0,104.0,64.0,5,216,10013.0,20.0,15.0
40.067,17,10,676,5,460,10013.0,104.0,64.0,5,216,10016.0,20.0,15.0
0.015,6,10,1989,5,910,3.0,642.0,642.0,5,1079,3.0,811.0,811.0
0.012,6,13,3735,7,497,1.0,125.0,125.0,6,3238,2.0,1470.0,1459.0
0.024,6,10,1990,5,911,6.0,643.0,643.0,5,1079,5.0,811.0,811.0
0.127,6,10,1506,5,395,29.0,127.0,127.0,5,1111,29.0,843.0,843.0
0.009,6,13,3735,7,497,1.0,125.0,125.0,6,3238,1.0,1470.0,1459.0
0.088,6,10,1506,5,395,19.0,127.0,127.0,5,1111,21.0,843.0,843.0
0.004,17,2,148,1,60,0.0,32.0,32.0,1,88,0.0,60.0,60.0
0.006,17,2,144,1,64,0.0,36.0,36.0,1,80,0.0,52.0,52.0
0.097,6,10,1506,5,395,21.0,127.0,127.0,5,1111,20.0,843.0,843.0
0.084,6,10,1506,5,395,19.0,127.0,127.0,5,1111,17.0,843.0,843.0
966.154,6,134,14054,52,8932,18944.0,1938.0,159.0,82,5122,11926.0,148.0,48.0
9.036,17,6,376,5,280,2259.0,28.0,28.0,1,96,0.0,68.0,68.0
0.001,17,2,180,1,66,0.0,38.0,38.0,1,114,0.0,86.0,86.0
0.009,6,10,1989,5,910,2.0,642.0,642.0,5,1079,2.0,811.0,811.0
0.01,6,12,1926,6,1189,2.0,659.0,434.0,6,737,2.0,417.0,417.0
0.017,6,14,3787,7,497,2.0,125.0,125.0,7,3290,2.0,1448.0,972.0
0.009,6,10,1631,5,848,2.0,580.0,580.0,5,783,2.0,515.0,515.0
0.033,6,10,1972,5,910,8.0,642.0,642.0,5,1062,8.0,794.0,794.0
0.105,6,10,1506,5,395,21.0,127.0,127.0,5,1111,20.0,843.0,843.0
0.004,17,4,284,2,120,0.0,32.0,32.0,2,164,1.0,60.0,54.0
0.005,17,2,180,1,66,0.0,38.0,38.0,1,114,0.0,86.0,86.0
0.146,6,10,1506,5,395,34.0,127.0,127.0,5,1111,30.0,843.0,843.0
0.008,6,10,1989,5,910,2.0,642.0,642.0,5,1079,1.0,811.0,811.0
0.017,6,10,1631,5,848,4.0,580.0,580.0,5,783,4.0,515.0,515.0
0.121,6,10,1506,5,395,25.0,127.0,127.0,5,1111,29.0,843.0,843.0
0.006,6,10,1689,5,839,1.0,571.0,571.0,5,850,1.0,582.0,582.0
0.005,17,2,152,1,68,0.0,40.0,40.0,1,84,0.0,56.0,56.0
0.002,17,2,180,1,66,0.0,38.0,38.0,1,114,0.0,86.0,86.0
0.019,6,10,1677,5,827,4.0,559.0,559.0,5,850,4.0,582.0,582.0
0.08,17,4,352,2,130,42.0,37.0,37.0,2,222,40.0,89.0,83.0
0.063,17,2,80,1,32,0.0,4.0,4.0,1,48,0.0,20.0,20.0
0.008,6,10,1631,5,848,2.0,580.0,580.0,5,783,2.0,515.0,515.0
0.007,17,2,179,1,71,0.0,43.0,43.0,1,108,0.0,80.0,80.0
0.267,17,38,20012,21,17031,13.0,1350.0,783.0,17,2981,12.0,1350.0,147.0
0.003,17,2,136,1,60,0.0,32.0,32.0,1,76,0.0,48.0,48.0
0.009,6,10,1989,5,910,2.0,642.0,642.0,5,1079,2.0,811.0,811.0
0.004,17,4,284,2,120,0.0,32.0,32.0,2,164,0.0,60.0,54.0
0.003,17,2,136,1,60,0.0,32.0,32.0,1,76,0.0,48.0,48.0
0.007,6,10,1547,5,764,1.0,496.0,496.0,5,783,1.0,515.0,515.0
0.005,6,10,2007,5,928,1.0,660.0,660.0,5,1079,1.0,811.0,811.0
0.006,6,10,1774,5,923,1.0,655.0,655.0,5,851,1.0,583.0,583.0
11.085,17,28,4423,14,1995,840.0,270.0,114.0,14,2428,840.0,587.0,145.0
0.106,6,10,1506,5,395,25.0,127.0,127.0,5,1111,22.0,843.0,843.0
40.072,17,10,676,5,460,10015.0,104.0,64.0,5,216,10017.0,20.0,15.0
0.003,17,2,136,1,60,0.0,32.0,32.0,1,76,0.0,48.0,48.0
0.134,6,10,1506,5,395,28.0,127.0,127.0,5,1111,28.0,843.0,843.0
0.006,6,10,1689,5,839,1.0,571.0,571.0,5,850,1.0,582.0,582.0
240.26,6,38,5230,18,2325,14132.0,581.0,195.0,20,2905,12645.0,566.0,265.0
172.206,17,68,9774,34,2267,5218.0,44.0,38.0,34,7507,5218.0,239.0,192.0
0.125,6,10,1506,5,395,30.0,127.0,127.0,5,1111,26.0,843.0,843.0
0.011,6,10,1983,5,910,2.0,642.0,642.0,5,1073,2.0,805.0,805.0
0.007,6,10,1689,5,839,1.0,571.0,571.0,5,850,1.0,582.0,582.0
240.101,6,28,7167,14,4728,18469.0,1419.0,500.0,14,2439,18469.0,580.0,243.0
0.144,6,10,1506,5,395,34.0,127.0,127.0,5,1111,30.0,843.0,843.0
0.004,6,10,2007,5,928,1.0,660.0,660.0,5,1079,1.0,811.0,811.0
0.008,6,10,1989,5,910,2.0,642.0,642.0,5,1079,1.0,811.0,811.0
0.021,6,14,3787,8,549,3.0,125.0,125.0,6,3238,4.0,1470.0,1459.0
288.956,6,369,346587,189,21394,1537.0,2736.0,889.0,180,325193,1614.0,2914.0,1902.0
0.006,6,10,1643,5,860,1.0,592.0,592.0,5,783,1.0,515.0,515.0
0.01,6,10,1989,5,910,2.0,642.0,642.0,5,1079,2.0,811.0,811.0
369.554,6,21,1793,16,1030,24636.0,190.0,190.0,5,763,60010.0,462.0,247.0
0.005,17,2,146,1,65,0.0,37.0,37.0,1,81,0.0,53.0,53.0
0.209,6,10,1506,5,395,40.0,127.0,127.0,5,1111,46.0,843.0,843.0
0.082,6,10,1506,5,395,17.0,127.0,127.0,5,1111,18.0,843.0,843.0
240.101,6,16,4480,9,963,30012.0,238.0,166.0,7,3517,40016.0,1402.0,786.0
0.151,6,10,1506,5,395,34.0,127.0,127.0,5,1111,24.0,843.0,843.0
0.003,17,2,148,1,60,0.0,32.0,32.0,1,88,0.0,60.0,60.0
0.005,6,10,2007,5,928,1.0,660.0,660.0,5,1079,1.0,811.0,811.0
0.01,6,10,1989,5,910,2.0,642.0,642.0,5,1079,2.0,811.0,811.0
0.009,6,10,1990,5,911,2.0,643.0,643.0,5,1079,2.0,811.0,811.0
0.015,6,10,1983,5,910,3.0,642.0,642.0,5,1073,3.0,805.0,805.0
0.007,6,10,1547,5,764,1.0,496.0,496.0,5,783,1.0,515.0,515.0
0.005,6,10,2000,5,927,1.0,659.0,659.0,5,1073,1.0,805.0,805.0
0.005,17,2,144,1,64,0.0,36.0,36.0,1,80,0.0,52.0,52.0
0.013,6,10,1972,5,910,3.0,642.0,642.0,5,1062,3.0,794.0,794.0
0.008,6,12,1926,6,1189,1.0,659.0,434.0,6,737,1.0,417.0,417.0
0.004,6,10,1989,5,927,1.0,659.0,659.0,5,1062,1.0,794.0,794.0
0.04,17,2,136,1,60,0.0,32.0,32.0,1,76,0.0,48.0,48.0
0.059,6,10,1506,5,395,14.0,127.0,127.0,5,1111,14.0,843.0,843.0
781.336,6,36,10633,18,4385,45960.0,676.0,491.0,18,6248,45960.0,1402.0,590.0
0.083,6,10,1506,5,395,17.0,127.0,127.0,5,1111,20.0,843.0,843.0
0.001,17,2,180,1,66,0.0,38.0,38.0,1,114,0.0,86.0,86.0
333.253,17,18,1008,9,640,41640.0,48.0,43.0,9,368,41640.0,20.0,12.0
0.012,6,10,1989,5,910,3.0,642.0,642.0,5,1079,3.0,811.0,811.0
0.007,6,10,1983,5,910,1.0,642.0,642.0,5,1073,1.0,805.0,805.0
0.104,6,10,1506,5,395,20.0,127.0,127.0,5,1111,24.0,843.0,843.0
0.112,6,10,1506,5,395,26.0,127.0,127.0,5,1111,23.0,843.0,843.0
0.042,17,2,170,1,65,0.0,37.0,37.0,1,105,0.0,77.0,77.0
1729.261,6,61,4464,41,2804,43231.0,33.0,33.0,20,1660,91004.0,31.0,31.0
175.23,17,86,12169,43,2877,4172.0,44.0,38.0,43,9292,4172.0,239.0,188.0
0.009,6,10,2006,5,927,2.0,659.0,659.0,5,1079,2.0,811.0,811.0
0.005,6,10,1689,5,839,1.0,571.0,571.0,5,850,1.0,582.0,582.0
240.327,6,32,8587,16,1787,16021.0,572.0,189.0,16,6800,16021.0,1402.0,597.0
169.384,17,74,10421,37,2457,4704.0,44.0,38.0,37,7964,4705.0,239.0,187.0
0.007,6,10,1989,5,910,1.0,642.0,642.0,5,1079,1.0,811.0,811.0
0.006,17,2,170,1,65,0.0,37.0,37.0,1,105,0.0,77.0,77.0
0.005,17,2,170,1,65,0.0,37.0,37.0,1,105,0.0,77.0,77.0
0.155,6,10,1506,5,395,37.0,127.0,127.0,5,1111,32.0,843.0,843.0
0.005,6,14,3799,7,509,0.0,137.0,137.0,7,3290,0.0,1448.0,972.0
0.013,6,10,1643,5,860,3.0,592.0,592.0,5,783,3.0,515.0,515.0
9.04,17,6,376,5,280,2260.0,28.0,28.0,1,96,0.0,68.0,68.0
0.004,6,10,1774,5,923,1.0,655.0,655.0,5,851,1.0,583.0,583.0
0.008,6,13,3735,7,497,1.0,125.0,125.0,6,3238,1.0,1470.0,1459.0
0.005,6,10,1774,5,923,1.0,655.0,655.0,5,851,1.0,583.0,583.0
240.015,6,9,787,5,488,60003.0,232.0,232.0,4,299,80004.0,83.0,83.0
0.011,6,10,1989,5,910,2.0,642.0,642.0,5,1079,2.0,811.0,811.0
240.102,6,16,4480,9,963,30012.0,238.0,166.0,7,3517,40016.0,1402.0,786.0
353.247,6,20,2210,6,1308,12004.0,494.0,494.0,14,902,27172.0,83.0,83.0
0.007,17,2,132,1,58,0.0,30.0,30.0,1,74,0.0,46.0,46.0
10.79,17,28,4422,14,1995,821.0,270.0,114.0,14,2427,821.0,586.0,145.0
0.005,17,2,166,1,75,0.0,47.0,47.0,1,91,0.0,63.0,63.0
0.004,17,4,284,2,120,0.0,32.0,32.0,2,164,0.0,60.0,54.0
0.005,17,2,179,1,71,0.0,43.0,43.0,1,108,0.0,80.0,80.0
162.586,6,21,8146,11,1985,84.0,1174.0,504.0,10,6161,18045.0,2720.0,958.0
0.004,6,10,2000,5,927,1.0,659.0,659.0,5,1073,1.0,805.0,805.0
0.005,6,10,1689,5,839,1.0,571.0,571.0,5,850,1.0,582.0,582.0
1770.577,17,120,11460,60,5460,30009.0,63.0,63.0,60,6000,30009.0,72.0,72.0
0.009,6,10,1989,5,910,2.0,642.0,642.0,5,1079,2.0,811.0,811.0
0.011,6,10,1677,5,827,2.0,559.0,559.0,5,850,2.0,582.0,582.0
0.003,17,2,136,1,60,0.0,32.0,32.0,1,76,0.0,48.0,48.0
0.005,6,10,2006,5,927,1.0,659.0,659.0,5,1079,1.0,811.0,811.0
0.007,17,2,179,1,71,0.0,43.0,43.0,1,108,0.0,80.0,80.0
40.094,17,10,676,5,460,10021.0,104.0,64.0,5,216,10022.0,20.0,15.0
309.624,17,20,1124,10,716,34396.0,48.0,43.0,10,408,34395.0,20.0,12.0
0.117,6,10,1506,5,395,26.0,127.0,127.0,5,1111,15.0,843.0,843.0
0.066,6,10,1506,5,395,15.0,127.0,127.0,5,1111,15.0,843.0,843.0
0.005,6,10,1989,5,927,1.0,659.0,659.0,5,1062,1.0,794.0,794.0
0.004,17,2,166,1,75,0.0,47.0,47.0,1,91,0.0,63.0,63.0
0.038,17,2,184,1,61,0.0,33.0,33.0,1,123,0.0,95.0,95.0
40.07,17,10,676,5,460,10016.0,104.0,64.0,5,216,10016.0,20.0,15.0
0.005,6,10,1989,5,927,1.0,659.0,659.0,5,1062,1.0,794.0,794.0
0.001,17,2,166,1,75,0.0,47.0,47.0,1,91,0.0,63.0,63.0
0.009,6,12,1926,6,1189,1.0,659.0,434.0,6,737,1.0,417.0,417.0
0.012,6,10,1990,5,911,3.0,643.0,643.0,5,1079,3.0,811.0,811.0
0.066,6,10,1506,5,395,16.0,127.0,127.0,5,1111,12.0,843.0,843.0
0.01,6,13,3735,7,497,1.0,125.0,125.0,6,3238,2.0,1470.0,1459.0
0.006,6,10,1547,5,764,1.0,496.0,496.0,5,783,1.0,515.0,515.0
240.099,6,32,9735,16,7082,16006.0,2156.0,694.0,16,2653,16006.0,580.0,226.0
0.012,6,10,1762,5,911,3.0,643.0,643.0,5,851,2.0,583.0,583.0
40.066,17,10,676,5,460,10014.0,104.0,64.0,5,216,10015.0,20.0,15.0
0.006,6,10,1989,5,927,1.0,659.0,659.0,5,1062,1.0,794.0,794.0
0.005,6,10,1989,5,927,1.0,659.0,659.0,5,1062,1.0,794.0,794.0
0.021,6,10,1989,5,910,5.0,642.0,642.0,5,1079,5.0,811.0,811.0
240.214,6,23,7493,12,2605,21837.0,1368.0,493.0,11,4888,24021.0,1656.0,861.0
37.9,58,5,360,4,288,12633.0,24.0,24.0,1,72,0.0,24.0,24.0
0.006,17,2,170,1,65,0.0,37.0,37.0,1,105,0.0,77.0,77.0
0.004,6,10,2006,5,927,1.0,659.0,659.0,5,1079,1.0,811.0,811.0
300.013,6,11,891,6,552,60002.0,232.0,232.0,5,339,75002.0,83.0,83.0
0.006,6,10,2006,5,927,1.0,659.0,659.0,5,1079,1.0,811.0,811.0
0.063,6,10,1506,5,395,13.0,127.0,127.0,5,1111,14.0,843.0,843.0
0.062,6,10,1506,5,395,13.0,127.0,127.0,5,1111,13.0,843.0,843.0
0.027,6,10,1631,5,848,6.0,580.0,580.0,5,783,6.0,515.0,515.0
0.016,6,10,1972,5,910,4.0,642.0,642.0,5,1062,4.0,794.0,794.0
0.073,6,10,1506,5,395,16.0,127.0,127.0,5,1111,16.0,843.0,843.0
0.004,6,10,1989,5,927,1.0,659.0,659.0,5,1062,1.0,794.0,794.0
0.016,6,13,3735,7,497,2.0,125.0,125.0,6,3238,3.0,1470.0,1459.0
0.006,6,10,1854,5,889,1.0,621.0,621.0,5,965,1.0,697.0,697.0
0.095,6,10,1506,5,395,18.0,127.0,127.0,5,1111,21.0,843.0,843.0
0.008,6,12,1926,6,1189,1.0,659.0,434.0,6,737,1.0,417.0,417.0
0.005,6,10,1779,5,928,1.0,660.0,660.0,5,851,1.0,583.0,583.0
0.008,6,10,1989,5,910,1.0,642.0,642.0,5,1079,1.0,811.0,811.0
0.006,6,10,1547,5,764,1.0,496.0,496.0,5,783,1.0,515.0,515.0
240.774,6,47,13988,22,6293,11465.0,1241.0,858.0,25,7695,10031.0,1162.0,375.0
241.726,6,389,347911,193,21558,1258.0,1867.0,822.0,196,326353,1239.0,2804.0,1699.0
0.006,6,10,2006,5,927,1.0,659.0,659.0,5,1079,1.0,811.0,811.0
0.094,6,10,1506,5,395,19.0,127.0,127.0,5,1111,20.0,843.0,843.0
0.158,6,10,1506,5,395,34.0,127.0,127.0,5,1111,38.0,843.0,843.0
0.004,6,10,1702,5,863,1.0,595.0,595.0,5,839,0.0,571.0,571.0
0.004,6,10,2007,5,928,1.0,660.0,660.0,5,1079,1.0,811.0,811.0
0.005,6,10,1643,5,860,1.0,592.0,592.0,5,783,1.0,515.0,515.0
0.001,17,2,136,1,60,0.0,32.0,32.0,1,76,0.0,48.0,48.0
40.057,17,10,676,5,460,10012.0,104.0,64.0,5,216,10012.0,20.0,15.0
0.005,6,10,1989,5,927,1.0,659.0,659.0,5,1062,1.0,794.0,794.0
0.112,6,10,1506,5,395,24.0,127.0,127.0,5,1111,27.0,843.0,843.0
0.218,6,16,2888,8,1506,31.0,533.0,360.0,8,1382,20.0,529.0,239.0
0.006,6,12,1698,6,863,1.0,327.0,271.0,6,835,1.0,515.0,515.0
0.006,6,10,1547,5,764,1.0,496.0,496.0,5,783,1.0,515.0,515.0
1756.075,6,105,6270,60,3525,29763.0,27.0,27.0,45,2745,39909.0,27.0,27.0
40.066,17,10,676,5,460,10013.0,104.0,64.0,5,216,10015.0,20.0,15.0
0.001,17,2,180,1,66,0.0,38.0,38.0,1,114,0.0,86.0,86.0
40.085,17,10,676,5,460,10014.0,104.0,64.0,5,216,10020.0,20.0,15.0
0.005,17,2,180,1,66,0.0,38.0,38.0,1,114,0.0,86.0,86.0
0.052,17,2,152,1,76,0.0,48.0,48.0,1,76,0.0,48.0,48.0
0.001,17,2,180,1,66,0.0,38.0,38.0,1,114,0.0,86.0,86.0
22.919,6,40,10527,20,4929,473.0,1360.0,682.0,20,5598,1197.0,2667.0,435.0
240.095,6,31,9237,15,6895,17149.0,2019.0,679.0,16,2342,16006.0,580.0,187.0
0.042,17,2,396,1,61,0.0,33.0,33.0,1,335,0.0,307.0,307.0
0.004,6,10,1989,5,927,1.0,659.0,659.0,5,1062,1.0,794.0,794.0
0.009,6,12,1926,6,1189,1.0,659.0,434.0,6,737,1.0,417.0,417.0
241.672,6,317,344622,118,17641,2065.0,2736.0,885.0,199,326981,1220.0,2933.0,1675.0
0.017,6,10,1972,5,910,4.0,642.0,642.0,5,1062,4.0,794.0,794.0
0.006,6,10,1689,5,839,1.0,571.0,571.0,5,850,1.0,582.0,582.0
40.015,17,10,676,5,460,10003.0,104.0,64.0,5,216,10003.0,20.0,15.0
0.005,6,10,2006,5,927,1.0,659.0,659.0,5,1079,1.0,811.0,811.0
0.005,17,2,144,1,64,0.0,36.0,36.0,1,80,0.0,52.0,52.0
0.013,6,10,1990,5,911,3.0,643.0,643.0,5,1079,3.0,811.0,811.0
0.004,17,2,136,1,60,0.0,32.0,32.0,1,76,0.0,48.0,48.0
40.062,17,10,676,5,460,10014.0,104.0,64.0,5,216,10014.0,20.0,15.0
0.087,6,10,1506,5,395,19.0,127.0,127.0,5,1111,17.0,843.0,843.0
361.888,6,21,1792,16,1030,24125.0,190.0,190.0,5,762,60010.0,461.0,247.0
0.019,6,10,1989,5,910,4.0,642.0,642.0,5,1079,4.0,811.0,811.0
0.014,6,10,1990,5,911,3.0,643.0,643.0,5,1079,3.0,811.0,811.0
0.021,6,10,1989,5,910,5.0,642.0,642.0,5,1079,5.0,811.0,811.0
0.003,17,2,136,1,60,0.0,32.0,32.0,1,76,0.0,48.0,48.0
0.02,6,10,1983,5,910,5.0,642.0,642.0,5,1073,4.0,805.0,805.0
0.004,17,4,284,2,120,0.0,32.0,32.0,2,164,0.0,60.0,54.0
11.146,17,28,4421,14,1993,844.0,268.0,114.0,14,2428,844.0,587.0,145.0
0.088,6,10,1506,5,395,19.0,127.0,127.0,5,1111,16.0,843.0,843.0
0.108,6,10,1506,5,395,25.0,127.0,127.0,5,1111,25.0,843.0,843.0
40.07,17,10,676,5,460,10015.0,104.0,64.0,5,216,10016.0,20.0,15.0
0.004,17,4,284,2,120,0.0,32.0,32.0,2,164,1.0,60.0,54.0
0.005,6,10,2006,5,927,1.0,659.0,659.0,5,1079,1.0,811.0,811.0
10.821,17,28,4418,14,1994,824.0,269.0,114.0,14,2424,824.0,587.0,145.0
0.17,6,3,453,2,321,170.0,241.0,241.0,1,132,0.0,92.0,92.0
0.01,6,10,2007,5,928,2.0,660.0,660.0,5,1079,2.0,811.0,811.0
0.004,6,10,2006,5,927,1.0,659.0,659.0,5,1079,1.0,811.0,811.0
308.778,17,20,1124,10,716,34294.0,48.0,43.0,10,408,34294.0,20.0,12.0
0.005,6,10,2000,5,927,1.0,659.0,659.0,5,1073,1.0,805.0,805.0
0.004,6,10,2006,5,927,1.0,659.0,659.0,5,1079,1.0,811.0,811.0
0.019,6,10,1989,5,910,4.0,642.0,642.0,5,1079,4.0,811.0,811.0
0.011,6,10,1631,5,848,2.0,580.0,580.0,5,783,2.0,515.0,515.0
0.08,17,8,3613,4,1874,26.0,1350.0,440.0,4,1739,14.0,1350.0,406.0
40.051,17,10,676,5,460,10012.0,104.0,64.0,5,216,10012.0,20.0,15.0
0.005,17,2,166,1,75,0.0,47.0,47.0,1,91,0.0,63.0,63.0
0.011,17,4,284,2,120,1.0,32.0,32.0,2,164,0.0,60.0,54.0
0.089,6,10,1506,5,395,20.0,127.0,127.0,5,1111,19.0,843.0,843.0
0.007,6,10,1689,5,839,1.0,571.0,571.0,5,850,1.0,582.0,582.0
40.081,17,10,676,5,460,10017.0,104.0,64.0,5,216,10019.0,20.0,15.0
0.015,6,10,1983,5,910,3.0,642.0,642.0,5,1073,3.0,805.0,805.0
1.008,6,12,3141,6,2098,151.0,1328.0,923.0,6,1043,151.0,791.0,791.0
0.004,17,2,148,1,60,0.0,32.0,32.0,1,88,0.0,60.0,60.0
0.008,6,10,1990,5,911,1.0,643.0,643.0,5,1079,2.0,811.0,811.0
0.005,6,10,2006,5,927,1.0,659.0,659.0,5,1079,1.0,811.0,811.0
0.24,17,17,9105,8,6613,34.0,1350.0,798.0,9,2492,19.0,1350.0,248.0
0.005,6,10,2006,5,927,1.0,659.0,659.0,5,1079,1.0,811.0,811.0
0.006,6,10,1689,5,839,1.0,571.0,571.0,5,850,1.0,582.0,582.0
0.006,6,10,1989,5,927,1.0,659.0,659.0,5,1062,1.0,794.0,794.0
0.519,17,2,142,1,63,0.0,35.0,35.0,1,79,0.0,51.0,51.0
0.006,6,10,1547,5,764,1.0,496.0,496.0,5,783,1.0,515.0,515.0
0.257,17,4,596,2,122,162.0,33.0,33.0,2,474,204.0,323.0,209.0
0.005,6,10,1989,5,927,1.0,659.0,659.0,5,1062,1.0,794.0,794.0
0.012,6,10,1989,5,910,2.0,642.0,642.0,5,1079,3.0,811.0,811.0
0.117,6,10,1506,5,395,25.0,127.0,127.0,5,1111,26.0,843.0,843.0
352.245,6,20,2210,6,1308,12005.0,494.0,494.0,14,902,27095.0,83.0,83.0
0.006,6,10,1547,5,764,1.0,496.0,496.0,5,783,1.0,515.0,515.0
0.004,6,10,1779,5,928,1.0,660.0,660.0,5,851,1.0,583.0,583.0
0.005,6,10,1643,5,860,1.0,592.0,592.0,5,783,1.0,515.0,515.0
300.419,6,16,2170,9,684,37531.0,146.0,146.0,7,1486,50042.0,419.0,398.0
0.015,6,10,1762,5,911,3.0,643.0,643.0,5,851,3.0,583.0,583.0
0.061,6,10,1506,5,395,13.0,127.0,127.0,5,1111,14.0,843.0,843.0
0.006,6,10,1547,5,764,1.0,496.0,496.0,5,783,1.0,515.0,515.0
0.004,17,2,148,1,60,0.0,32.0,32.0,1,88,0.0,60.0,60.0
0.004,17,2,136,1,60,0.0,32.0,32.0,1,76,0.0,48.0,48.0
0.005,6,10,1547,5,764,1.0,496.0,496.0,5,783,1.0,515.0,515.0
0.009,6,10,1631,5,848,2.0,580.0,580.0,5,783,2.0,515.0,515.0
0.069,17,8,3613,4,1874,23.0,1350.0,440.0,4,1739,12.0,1350.0,406.0
11.066,17,28,4421,14,1993,838.0,268.0,114.0,14,2428,838.0,587.0,145.0
0.016,6,10,1989,5,910,4.0,642.0,642.0,5,1079,3.0,811.0,811.0
11.189,17,28,4423,14,1994,848.0,269.0,114.0,14,2429,848.0,588.0,145.0
0.016,6,10,1972,5,910,4.0,642.0,642.0,5,1062,3.0,794.0,794.0
0.1,6,10,1506,5,395,21.0,127.0,127.0,5,1111,23.0,843.0,843.0
0.003,6,10,1702,5,863,0.0,595.0,595.0,5,839,0.0,571.0,571.0
0.016,6,10,1762,5,911,4.0,643.0,643.0,5,851,4.0,583.0,583.0
0.008,6,12,1926,6,1189,1.0,659.0,434.0,6,737,1.0,417.0,417.0
0.035,6,10,1989,5,910,8.0,642.0,642.0,5,1079,8.0,811.0,811.0
0.09,6,10,1506,5,395,21.0,127.0,127.0,5,1111,17.0,843.0,843.0
0.01,6,10,1989,5,910,2.0,642.0,642.0,5,1079,2.0,811.0,811.0
0.005,6,10,2006,5,927,1.0,659.0,659.0,5,1079,1.0,811.0,811.0
40.063,17,10,676,5,460,10015.0,104.0,64.0,5,216,10015.0,20.0,15.0
353.706,6,20,2210,6,1308,12004.0,494.0,494.0,14,902,27207.0,83.0,83.0
0.005,6,14,3799,7,509,0.0,137.0,137.0,7,3290,0.0,1448.0,972.0
0.01,6,10,1990,5,911,2.0,643.0,643.0,5,1079,2.0,811.0,811.0
0.128,17,2,80,1,32,0.0,4.0,4.0,1,48,0.0,20.0,20.0
66.014,6,22,10140,12,3973,6001.0,1579.0,835.0,10,6167,7316.0,2111.0,939.0
0.107,6,10,1506,5,395,26.0,127.0,127.0,5,1111,22.0,843.0,843.0
177.451,17,72,10303,36,2387,5069.0,44.0,38.0,36,7916,5069.0,252.0,191.0
0.006,6,10,1547,5,764,1.0,496.0,496.0,5,783,1.0,515.0,515.0
308.711,17,20,1124,10,716,34286.0,48.0,43.0,10,408,34286.0,20.0,12.0
0.078,6,10,1506,5,395,17.0,127.0,127.0,5,1111,17.0,843.0,843.0
308.576,17,20,1124,10,716,34279.0,48.0,43.0,10,408,34279.0,20.0,12.0
0.12,6,10,1506,5,395,24.0,127.0,127.0,5,1111,27.0,843.0,843.0
0.037,17,2,182,1,65,0.0,37.0,37.0,1,117,0.0,89.0,89.0
10.856,17,28,4421,14,1994,826.0,269.0,114.0,14,2427,826.0,586.0,145.0
0.017,6,10,1972,5,910,4.0,642.0,642.0,5,1062,4.0,794.0,794.0
0.004,6,10,2007,5,928,1.0,660.0,660.0,5,1079,1.0,811.0,811.0
1742.519,6,303,97604,189,86446,9268.0,1402.0,677.0,114,11158,15420.0,452.0,70.0
0.006,6,10,1689,5,839,1.0,571.0,571.0,5,850,1.0,582.0,582.0
0.004,17,2,136,1,60,0.0,32.0,32.0,1,76,0.0,48.0,48.0
0.005,6,10,1547,5,764,1.0,496.0,496.0,5,783,1.0,515.0,515.0
0.004,6,10,2007,5,928,1.0,660.0,660.0,5,1079,1.0,811.0,811.0
40.068,17,10,676,5,460,10015.0,104.0,64.0,5,216,10016.0,20.0,15.0
0.091,6,10,1506,5,395,18.0,127.0,127.0,5,1111,20.0,843.0,843.0
0.004,17,2,148,1,60,0.0,32.0,32.0,1,88,0.0,60.0,60.0
0.008,6,10,1990,5,911,2.0,643.0,643.0,5,1079,2.0,811.0,811.0
1.04,6,30,12705,17,3312,65.0,1360.0,517.0,13,9393,72.0,2720.0,984.0
0.013,17,2,152,1,56,0.0,28.0,28.0,1,96,0.0,68.0,68.0
1787.587,6,154,19574,92,13852,19643.0,302.0,302.0,62,5722,29304.0,83.0,83.0
40.09,17,10,676,5,460,10019.0,104.0,64.0,5,216,10021.0,20.0,15.0
0.005,17,2,144,1,64,0.0,36.0,36.0,1,80,0.0,52.0,52.0
0.015,6,10,1990,5,911,3.0,643.0,643.0,5,1079,3.0,811.0,811.0
0.001,17,2,180,1,66,0.0,38.0,38.0,1,114,0.0,86.0,86.0
0.005,6,10,2007,5,928,1.0,660.0,660.0,5,1079,1.0,811.0,811.0
0.005,6,10,1989,5,927,1.0,659.0,659.0,5,1062,1.0,794.0,794.0
0.088,6,10,1506,5,395,19.0,127.0,127.0,5,1111,20.0,843.0,843.0
0.256,17,46,25896,26,22607,10.0,1350.0,841.0,20,3289,10.0,1350.0,136.0
0.009,6,10,1972,5,910,2.0,642.0,642.0,5,1062,2.0,794.0,794.0
0.018,6,10,1972,5,910,4.0,642.0,642.0,5,1062,4.0,794.0,794.0
0.176,17,2,152,1,76,0.0,48.0,48.0,1,76,0.0,48.0,48.0
0.005,6,10,1989,5,927,1.0,659.0,659.0,5,1062,1.0,794.0,794.0
0.133,6,10,1506,5,395,30.0,127.0,127.0,5,1111,31.0,843.0,843.0
0.005,6,10,1989,5,927,1.0,659.0,659.0,5,1062,1.0,794.0,794.0
0.226,6,16,2670,8,1396,32.0,533.0,324.0,8,1274,20.0,529.0,212.0
0.005,6,10,2007,5,928,1.0,660.0,660.0,5,1079,1.0,811.0,811.0
0.004,6,10,2007,5,928,1.0,660.0,660.0,5,1079,1.0,811.0,811.0
10.811,17,28,4420,14,1993,823.0,268.0,114.0,14,2427,823.0,586.0,145.0
0.004,17,2,234,1,61,0.0,33.0,33.0,1,173,0.0,145.0,145.0
0.006,6,10,1643,5,860,1.0,592.0,592.0,5,783,1.0,515.0,515.0
0.005,6,14,3799,7,509,0.0,137.0,137.0,7,3290,0.0,1448.0,972.0
0.012,6,10,1990,5,911,2.0,643.0,643.0,5,1079,2.0,811.0,811.0
0.008,6,10,1990,5,911,2.0,643.0,643.0,5,1079,1.0,811.0,811.0
0.178,17,2,194,1,59,0.0,31.0,31.0,1,135,0.0,107.0,107.0
0.367,17,17,10021,8,6917,52.0,1350.0,836.0,9,3104,34.0,1350.0,316.0
0.006,6,10,1547,5,764,1.0,496.0,496.0,5,783,1.0,515.0,515.0
0.006,6,10,2006,5,927,1.0,659.0,659.0,5,1079,1.0,811.0,811.0
0.003,17,2,136,1,60,0.0,32.0,32.0,1,76,0.0,48.0,48.0
0.004,6,10,1702,5,863,1.0,595.0,595.0,5,839,1.0,571.0,571.0
0.003,17,2,136,1,60,0.0,32.0,32.0,1,76,0.0,48.0,48.0
40.065,17,10,676,5,460,10015.0,104.0,64.0,5,216,10015.0,20.0,15.0
0.038,17,2,136,1,60,0.0,32.0,32.0,1,76,0.0,48.0,48.0
0.101,6,10,1506,5,395,22.0,127.0,127.0,5,1111,23.0,843.0,843.0
0.004,6,10,1989,5,927,1.0,659.0,659.0,5,1062,1.0,794.0,794.0
0.065,6,10,1506,5,395,13.0,127.0,127.0,5,1111,16.0,843.0,843.0
0.001,17,2,180,1,66,0.0,38.0,38.0,1,114,0.0,86.0,86.0
0.091,6,10,1506,5,395,19.0,127.0,127.0,5,1111,15.0,843.0,843.0
0.071,17,8,3613,4,1874,23.0,1350.0,440.0,4,1739,12.0,1350.0,406.0
0.009,6,12,1926,6,1189,1.0,659.0,434.0,6,737,1.0,417.0,417.0
0.214,17,4,352,2,130,142.0,37.0,37.0,2,222,175.0,89.0,83.0
0.005,6,14,3736,7,446,0.0,74.0,74.0,7,3290,0.0,1448.0,972.0
0.005,6,10,1689,5,839,1.0,571.0,571.0,5,850,1.0,582.0,582.0
0.005,6,10,1989,5,927,1.0,659.0,659.0,5,1062,1.0,794.0,794.0
40.07,17,10,676,5,460,10016.0,104.0,64.0,5,216,10016.0,20.0,15.0
0.08,6,10,1506,5,395,16.0,127.0,127.0,5,1111,17.0,843.0,843.0
0.004,6,10,2007,5,928,1.0,660.0,660.0,5,1079,1.0,811.0,811.0
40.058,17,10,676,5,460,10013.0,104.0,64.0,5,216,10013.0,20.0,15.0
15.072,17,15,9239,8,6902,2149.0,1350.0,834.0,7,2337,2507.0,1350.0,305.0
0.004,17,4,284,2,120,1.0,32.0,32.0,2,164,0.0,60.0,54.0
0.004,6,10,2007,5,928,1.0,660.0,660.0,5,1079,1.0,811.0,811.0
10.914,17,28,4422,14,1994,831.0,269.0,114.0,14,2428,831.0,587.0,145.0
0.005,6,10,1989,5,927,1.0,659.0,659.0,5,1062,1.0,794.0,794.0
0.012,6,10,1972,5,910,3.0,642.0,642.0,5,1062,2.0,794.0,794.0
0.089,6,10,1506,5,395,19.0,127.0,127.0,5,1111,20.0,843.0,843.0
240.183,6,49,6820,24,3342,10442.0,588.0,230.0,25,3478,10007.0,580.0,180.0
10.808,17,24,3779,12,1674,973.0,269.0,111.0,12,2105,972.0,588.0,147.0
0.006,6,10,1547,5,764,1.0,496.0,496.0,5,783,1.0,515.0,515.0
0.013,17,2,152,1,56,0.0,28.0,28.0,1,96,0.0,68.0,68.0
11.607,17,28,4393,14,2311,880.0,586.0,137.0,14,2082,880.0,269.0,120.0
0.008,17,2,194,1,59,0.0,31.0,31.0,1,135,0.0,107.0,107.0
0.014,6,10,1989,5,910,3.0,642.0,642.0,5,1079,3.0,811.0,811.0
173.083,17,82,11601,41,2748,4327.0,44.0,39.0,41,8853,4327.0,239.0,187.0
40.067,17,10,676,5,460,10015.0,104.0,64.0,5,216,10015.0,20.0,15.0
0.128,6,10,1506,5,395,30.0,127.0,127.0,5,1111,30.0,843.0,843.0
0.383,6,24,8236,12,1699,34.0,748.0,263.0,12,6537,34.0,2335.0,984.0
0.008,6,10,1989,5,910,2.0,642.0,642.0,5,1079,1.0,811.0,811.0
0.005,6,13,3690,7,452,0.0,80.0,80.0,6,3238,1.0,1470.0,1459.0
0.007,17,2,162,1,65,0.0,37.0,37.0,1,97,0.0,69.0,69.0
0.005,6,10,1989,5,927,1.0,659.0,659.0,5,1062,1.0,794.0,794.0
0.005,6,10,1989,5,927,1.0,659.0,659.0,5,1062,1.0,794.0,794.0
0.006,17,2,230,1,68,0.0,40.0,40.0,1,162,0.0,134.0,134.0
0.013,17,2,152,1,76,0.0,48.0,48.0,1,76,0.0,48.0,48.0
0.013,6,14,3787,7,497,2.0,125.0,125.0,7,3290,2.0,1448.0,972.0
0.018,6,10,1990,5,911,4.0,643.0,643.0,5,1079,4.0,811.0,811.0
0.01,6,10,1990,5,911,2.0,643.0,643.0,5,1079,2.0,811.0,811.0
0.009,6,12,1926,6,1189,1.0,659.0,434.0,6,737,1.0,417.0,417.0
0.003,17,4,284,2,120,0.0,32.0,32.0,2,164,0.0,60.0,54.0
0.07,6,10,1506,5,395,15.0,127.0,127.0,5,1111,16.0,843.0,843.0
0.004,6,10,2006,5,927,1.0,659.0,659.0,5,1079,1.0,811.0,811.0
0.079,17,2,152,1,76,0.0,48.0,48.0,1,76,0.0,48.0,48.0
0.001,17,2,180,1,66,0.0,38.0,38.0,1,114,0.0,86.0,86.0
0.069,6,10,1506,5,395,16.0,127.0,127.0,5,1111,15.0,843.0,843.0
40.062,17,10,676,5,460,10012.0,104.0,64.0,5,216,10014.0,20.0,15.0
0.101,6,10,1506,5,395,22.0,127.0,127.0,5,1111,20.0,843.0,843.0
0.009,6,12,1698,6,863,1.0,327.0,271.0,6,835,1.0,515.0,515.0
0.016,17,2,198,1,91,0.0,63.0,63.0,1,107,0.0,79.0,79.0
40.079,17,10,676,5,460,10017.0,104.0,64.0,5,216,10018.0,20.0,15.0
0.014,6,10,1989,5,910,3.0,642.0,642.0,5,1079,3.0,811.0,811.0
0.005,6,10,2000,5,927,1.0,659.0,659.0,5,1073,1.0,805.0,805.0
0.008,6,13,3735,7,497,1.0,125.0,125.0,6,3238,1.0,1470.0,1459.0
0.1,6,10,1506,5,395,22.0,127.0,127.0,5,1111,20.0,843.0,843.0
240.012,6,9,787,5,488,60003.0,232.0,232.0,4,299,80002.0,83.0,83.0
40.053,17,10,676,5,460,10010.0,104.0,64.0,5,216,10012.0,20.0,15.0
0.016,6,10,1989,5,910,4.0,642.0,642.0,5,1079,3.0,811.0,811.0
0.005,6,10,1989,5,927,1.0,659.0,659.0,5,1062,1.0,794.0,794.0
178.615,17,72,9979,36,2388,5103.0,44.0,38.0,36,7591,5103.0,249.0,182.0
0.005,6,10,1774,5,923,1.0,655.0,655.0,5,851,1.0,583.0,583.0
0.014,6,10,1762,5,911,3.0,643.0,643.0,5,851,3.0,583.0,583.0
0.009,6,10,1972,5,910,2.0,642.0,642.0,5,1062,2.0,794.0,794.0
0.011,6,10,1983,5,910,2.0,642.0,642.0,5,1073,2.0,805.0,805.0
0.004,6,10,2006,5,927,1.0,659.0,659.0,5,1079,1.0,811.0,811.0
0.086,6,10,1506,5,395,15.0,127.0,127.0,5,1111,20.0,843.0,843.0
0.006,6,10,1547,5,764,1.0,496.0,496.0,5,783,1.0,515.0,515.0
10.979,17,28,4418,14,1993,834.0,268.0,114.0,14,2425,835.0,588.0,145.0
0.005,17,2,140,1,62,0.0,34.0,34.0,1,78,0.0,50.0,50.0
310.11,17,20,1124,10,716,34442.0,48.0,43.0,10,408,34442.0,20.0,12.0
0.005,6,10,2007,5,928,1.0,660.0,660.0,5,1079,1.0,811.0,811.0
0.004,17,2,152,1,76,0.0,48.0,48.0,1,76,0.0,48.0,48.0
0.01,6,10,1989,5,910,2.0,642.0,642.0,5,1079,2.0,811.0,811.0
0.005,6,10,1989,5,927,1.0,659.0,659.0,5,1062,1.0,794.0,794.0
0.004,17,2,148,1,60,0.0,32.0,32.0,1,88,0.0,60.0,60.0
0.082,6,10,1506,5,395,17.0,127.0,127.0,5,1111,18.0,843.0,843.0
0.008,6,12,1926,6,1189,1.0,659.0,434.0,6,737,1.0,417.0,417.0
15.224,17,17,8366,9,6281,1899.0,1350.0,669.0,8,2085,2170.0,1350.0,232.0
0.005,6,10,2006,5,927,1.0,659.0,659.0,5,1079,1.0,811.0,811.0
0.001,17,2,180,1,66,0.0,38.0,38.0,1,114,0.0,86.0,86.0
0.003,17,2,136,1,60,0.0,32.0,32.0,1,76,0.0,48.0,48.0
40.071,17,10,676,5,460,10015.0,104.0,64.0,5,216,10016.0,20.0,15.0
0.116,17,2,80,1,32,0.0,4.0,4.0,1,48,0.0,20.0,20.0
0.004,17,2,148,1,60,0.0,32.0,32.0,1,88,0.0,60.0,60.0
0.009,6,10,1989,5,910,2.0,642.0,642.0,5,1079,2.0,811.0,811.0
0.032,6,10,1972,5,910,8.0,642.0,642.0,5,1062,8.0,794.0,794.0
0.005,17,2,170,1,65,0.0,37.0,37.0,1,105,0.0,77.0,77.0
0.006,6,10,1547,5,764,1.0,496.0,496.0,5,783,1.0,515.0,515.0
0.006,6,10,2000,5,927,1.0,659.0,659.0,5,1073,1.0,805.0,805.0
0.01,6,10,1990,5,911,2.0,643.0,643.0,5,1079,2.0,811.0,811.0
0.003,17,4,284,2,120,0.0,32.0,32.0,2,164,0.0,60.0,54.0
0.007,6,10,1547,5,764,1.0,496.0,496.0,5,783,1.0,515.0,515.0
0.005,6,10,2007,5,928,1.0,660.0,660.0,5,1079,1.0,811.0,811.0
0.101,6,10,1506,5,395,19.0,127.0,127.0,5,1111,21.0,843.0,843.0
0.106,6,10,1506,5,395,23.0,127.0,127.0,5,1111,25.0,843.0,843.0
0.005,6,10,2007,5,928,1.0,660.0,660.0,5,1079,1.0,811.0,811.0
40.059,17,10,676,5,460,10012.0,104.0,64.0,5,216,10014.0,20.0,15.0
0.077,6,10,1506,5,395,15.0,127.0,127.0,5,1111,18.0,843.0,843.0
0.013,6,10,1990,5,911,3.0,643.0,643.0,5,1079,3.0,811.0,811.0
0.042,17,2,182,1,65,0.0,37.0,37.0,1,117,0.0,89.0,89.0
40.058,17,10,676,5,460,10011.0,104.0,64.0,5,216,10013.0,20.0,15.0
0.008,6,12,1926,6,1189,1.0,659.0,434.0,6,737,1.0,417.0,417.0
0.082,6,10,1506,5,395,19.0,127.0,127.0,5,1111,15.0,843.0,843.0
11.18,17,28,4421,14,1993,847.0,268.0,114.0,14,2428,847.0,587.0,145.0
40.06,17,10,676,5,460,10014.0,104.0,64.0,5,216,10014.0,20.0,15.0
0.006,6,10,1854,5,889,1.0,621.0,621.0,5,965,1.0,697.0,697.0
0.003,17,2,136,1,60,0.0,32.0,32.0,1,76,0.0,48.0,48.0
0.012,6,13,3735,7,497,2.0,125.0,125.0,6,3238,2.0,1470.0,1459.0
0.042,17,2,148,1,60,0.0,32.0,32.0,1,88,0.0,60.0,60.0
0.005,6,10,2006,5,927,1.0,659.0,659.0,5,1079,1.0,811.0,811.0
0.115,6,10,1506,5,395,24.0,127.0,127.0,5,1111,22.0,843.0,843.0
0.014,6,10,1972,5,910,3.0,642.0,642.0,5,1062,3.0,794.0,794.0
0.003,17,2,148,1,60,0.0,32.0,32.0,1,88,0.0,60.0,60.0
0.069,17,2,152,1,76,0.0,48.0,48.0,1,76,0.0,48.0,48.0
0.001,17,2,180,1,66,0.0,38.0,38.0,1,114,0.0,86.0,86.0
0.005,6,10,2006,5,927,1.0,659.0,659.0,5,1079,1.0,811.0,811.0
0.008,6,10,1989,5,910,2.0,642.0,642.0,5,1079,1.0,811.0,811.0
0.179,17,4,352,2,130,107.0,37.0,37.0,2,222,176.0,89.0,83.0
0.013,6,10,1989,5,910,3.0,642.0,642.0,5,1079,3.0,811.0,811.0
0.013,6,10,1989,5,910,3.0,642.0,642.0,5,1079,3.0,811.0,811.0
0.072,6,10,1506,5,395,16.0,127.0,127.0,5,1111,16.0,843.0,843.0
0.011,6,10,1983,5,910,2.0,642.0,642.0,5,1073,2.0,805.0,805.0
0.037,17,2,136,1,60,0.0,32.0,32.0,1,76,0.0,48.0,48.0
0.084,6,10,1506,5,395,20.0,127.0,127.0,5,1111,18.0,843.0,843.0
0.006,6,10,1689,5,839,1.0,571.0,571.0,5,850,1.0,582.0,582.0
0.006,17,2,194,1,59,0.0,31.0,31.0,1,135,0.0,107.0,107.0
0.011,6,10,1631,5,848,2.0,580.0,580.0,5,783,2.0,515.0,515.0
0.005,17,2,136,1,60,0.0,32.0,32.0,1,76,0.0,48.0,48.0
0.013,6,10,1989,5,910,3.0,642.0,642.0,5,1079,3.0,811.0,811.0
0.115,6,10,1506,5,395,23.0,127.0,127.0,5,1111,24.0,843.0,843.0
0.008,6,13,3747,7,509,1.0,137.0,137.0,6,3238,1.0,1470.0,1459.0
1796.92,6,241,46393,116,33938,15625.0,2473.0,995.0,125,12455,14491.0,580.0,61.0
2.166,6,38,6827,21,3555,108.0,1103.0,204.0,17,3272,123.0,1796.0,396.0
0.087,6,10,1506,5,395,19.0,127.0,127.0,5,1111,17.0,843.0,843.0
0.006,6,10,1689,5,839,1.0,571.0,571.0,5,850,1.0,582.0,582.0
0.016,6,10,1990,5,911,3.0,643.0,643.0,5,1079,4.0,811.0,811.0
0.076,6,10,1506,5,395,15.0,127.0,127.0,5,1111,16.0,843.0,843.0
40.068,17,10,676,5,460,10016.0,104.0,64.0,5,216,10016.0,20.0,15.0
293.284,6,391,347714,194,21641,1519.0,2736.0,888.0,197,326073,1496.0,2769.0,1725.0
0.116,6,10,1506,5,395,24.0,127.0,127.0,5,1111,25.0,843.0,843.0
0.015,6,10,1990,5,911,3.0,643.0,643.0,5,1079,3.0,811.0,811.0
175.167,17,94,13529,47,3163,3807.0,44.0,39.0,47,10366,3807.0,261.0,192.0
0.006,6,10,2006,5,927,1.0,659.0,659.0,5,1079,1.0,811.0,811.0
0.004,17,2,136,1,60,0.0,32.0,32.0,1,76,0.0,48.0,48.0
0.028,6,10,1631,5,848,6.0,580.0,580.0,5,783,7.0,515.0,515.0
127.679,6,22,8494,12,2236,70.0,1345.0,574.0,10,6258,14168.0,2720.0,974.0
0.014,6,13,3735,7,497,2.0,125.0,125.0,6,3238,2.0,1470.0,1459.0
174.126,17,74,10473,37,2456,4836.0,44.0,38.0,37,8017,4836.0,239.0,188.0
0.005,6,10,2006,5,927,1.0,659.0,659.0,5,1079,1.0,811.0,811.0
0.001,17,2,180,1,66,0.0,38.0,38.0,1,114,0.0,86.0,86.0
0.005,6,10,1774,5,923,1.0,655.0,655.0,5,851,1.0,583.0,583.0
0.062,6,10,1506,5,395,15.0,127.0,127.0,5,1111,12.0,843.0,843.0
0.591,6,32,8773,18,2153,34.0,517.0,277.0,14,6620,37.0,1330.0,604.0
0.04,17,4,284,2,120,0.0,32.0,32.0,2,164,36.0,60.0,54.0
0.005,6,13,3747,7,509,0.0,137.0,137.0,6,3238,0.0,1470.0,1459.0
0.001,17,2,180,1,66,0.0,38.0,38.0,1,114,0.0,86.0,86.0
0.006,6,10,1547,5,764,1.0,496.0,496.0,5,783,1.0,515.0,515.0
369.431,6,22,2313,16,867,24628.0,195.0,195.0,6,1446,4644.0,419.0,398.0
174.286,17,76,10938,38,2541,4710.0,44.0,38.0,38,8397,4710.0,261.0,192.0
40.092,17,10,676,5,460,10019.0,104.0,64.0,5,216,10022.0,20.0,15.0
0.107,17,2,152,1,76,0.0,48.0,48.0,1,76,0.0,48.0,48.0
40.063,17,10,676,5,460,10013.0,104.0,64.0,5,216,10014.0,20.0,15.0
0.041,17,2,170,1,65,0.0,37.0,37.0,1,105,0.0,77.0,77.0
0.001,17,2,136,1,60,0.0,32.0,32.0,1,76,0.0,48.0,48.0
0.007,6,10,1990,5,911,1.0,643.0,643.0,5,1079,1.0,811.0,811.0
0.007,6,10,1547,5,764,1.0,496.0,496.0,5,783,1.0,515.0,515.0
0.005,6,10,1547,5,764,1.0,496.0,496.0,5,783,1.0,515.0,515.0
353.016,6,20,2210,6,1308,12003.0,494.0,494.0,14,902,27154.0,83.0,83.0
0.005,17,2,170,1,65,0.0,37.0,37.0,1,105,0.0,77.0,77.0
0.075,6,10,1506,5,395,16.0,127.0,127.0,5,1111,13.0,843.0,843.0
0.039,17,2,152,1,76,0.0,48.0,48.0,1,76,0.0,48.0,48.0
0.005,6,10,2006,5,927,1.0,659.0,659.0,5,1079,1.0,811.0,811.0
0.043,17,2,152,1,76,0.0,48.0,48.0,1,76,0.0,48.0,48.0
1.524,6,38,6827,21,3555,76.0,1103.0,204.0,17,3272,91.0,1796.0,396.0
413.626,6,29,4409,12,3102,10911.0,494.0,494.0,17,1307,25851.0,83.0,83.0
0.004,6,10,1702,5,863,1.0,595.0,595.0,5,839,0.0,571.0,571.0
40.066,17,10,676,5,460,10015.0,104.0,64.0,5,216,10015.0,20.0,15.0
0.013,6,6,716,3,458,5.0,302.0,302.0,3,258,5.0,102.0,102.0
0.066,6,10,1506,5,395,15.0,127.0,127.0,5,1111,15.0,843.0,843.0
40.062,17,10,676,5,460,10014.0,104.0,64.0,5,216,10014.0,20.0,15.0
0.005,17,2,222,1,65,0.0,37.0,37.0,1,157,0.0,129.0,129.0
0.013,6,10,1989,5,910,3.0,642.0,642.0,5,1079,3.0,811.0,811.0
0.04,17,2,182,1,65,0.0,37.0,37.0,1,117,0.0,89.0,89.0
0.002,17,2,136,1,60,0.0,32.0,32.0,1,76,0.0,48.0,48.0
0.018,6,10,1631,5,848,4.0,580.0,580.0,5,783,4.0,515.0,515.0
0.053,17,2,152,1,76,0.0,48.0,48.0,1,76,0.0,48.0,48.0
0.017,6,10,1989,5,910,4.0,642.0,642.0,5,1079,4.0,811.0,811.0
0.094,6,10,1506,5,395,21.0,127.0,127.0,5,1111,21.0,843.0,843.0
0.005,6,10,1779,5,928,1.0,660.0,660.0,5,851,1.0,583.0,583.0
0.069,17,8,3613,4,1874,23.0,1350.0,440.0,4,1739,11.0,1350.0,406.0
0.004,6,10,1989,5,927,1.0,659.0,659.0,5,1062,1.0,794.0,794.0
0.009,6,10,1989,5,910,2.0,642.0,642.0,5,1079,2.0,811.0,811.0
294.297,6,409,349043,203,22122,1456.0,2736.0,825.0,206,326921,1435.0,2804.0,1638.0
0.004,6,10,1779,5,928,1.0,660.0,660.0,5,851,1.0,583.0,583.0
0.005,6,10,1854,5,889,1.0,621.0,621.0,5,965,1.0,697.0,697.0
0.103,6,10,1506,5,395,22.0,127.0,127.0,5,1111,21.0,843.0,843.0
0.011,6,10,1677,5,827,2.0,559.0,559.0,5,850,2.0,582.0,582.0
0.005,6,10,2007,5,928,1.0,660.0,660.0,5,1079,1.0,811.0,811.0
0.059,6,10,1506,5,395,14.0,127.0,127.0,5,1111,13.0,843.0,843.0
308.556,17,20,1124,10,716,34269.0,48.0,43.0,10,408,34269.0,20.0,12.0
0.008,6,10,1989,5,910,2.0,642.0,642.0,5,1079,2.0,811.0,811.0
0.001,17,2,180,1,66,0.0,38.0,38.0,1,114,0.0,86.0,86.0
0.005,6,10,2000,5,927,1.0,659.0,659.0,5,1073,1.0,805.0,805.0
0.012,6,10,1983,5,910,3.0,642.0,642.0,5,1073,2.0,805.0,805.0
0.004,6,10,2006,5,927,1.0,659.0,659.0,5,1079,1.0,811.0,811.0
0.02,6,14,3868,7,578,3.0,206.0,206.0,7,3290,3.0,1448.0,972.0
0.008,6,10,2006,5,927,2.0,659.0,659.0,5,1079,1.0,811.0,811.0
0.009,6,10,1989,5,910,2.0,642.0,642.0,5,1079,2.0,811.0,811.0
0.107,6,10,1506,5,395,21.0,127.0,127.0,5,1111,23.0,843.0,843.0
0.004,17,2,164,1,74,0.0,46.0,46.0,1,90,0.0,62.0,62.0
0.006,6,10,1547,5,764,1.0,496.0,496.0,5,783,1.0,515.0,515.0
0.005,6,10,2006,5,927,1.0,659.0,659.0,5,1079,1.0,811.0,811.0
10.873,17,28,4422,14,1994,827.0,269.0,114.0,14,2428,827.0,587.0,145.0
9.037,17,6,376,5,280,2259.0,28.0,28.0,1,96,0.0,68.0,68.0
0.041,17,2,136,1,60,0.0,32.0,32.0,1,76,0.0,48.0,48.0
0.004,6,10,2006,5,927,1.0,659.0,659.0,5,1079,1.0,811.0,811.0
0.001,17,2,140,1,62,0.0,34.0,34.0,1,78,0.0,50.0,50.0
0.04,17,2,148,1,60,0.0,32.0,32.0,1,88,0.0,60.0,60.0
178.224,17,80,11779,40,2686,4569.0,44.0,39.0,40,9093,4569.0,279.0,199.0
0.001,17,2,136,1,60,0.0,32.0,32.0,1,76,0.0,48.0,48.0
0.005,6,14,3799,7,509,0.0,137.0,137.0,7,3290,0.0,1448.0,972.0
0.001,17,2,179,1,62,0.0,34.0,34.0,1,117,0.0,89.0,89.0
0.005,6,10,1643,5,860,1.0,592.0,592.0,5,783,1.0,515.0,515.0
0.004,17,4,420,2,122,0.0,33.0,33.0,2,298,0.0,145.0,121.0
0.007,6,10,2006,5,927,1.0,659.0,659.0,5,1079,1.0,811.0,811.0
0.005,6,10,1689,5,839,1.0,571.0,571.0,5,850,1.0,582.0,582.0
15.077,17,19,10122,9,6968,1881.0,1350.0,746.0,10,3154,1671.0,1350.0,287.0
0.005,6,10,1989,5,927,1.0,659.0,659.0,5,1062,1.0,794.0,794.0
15.077,17,16,9302,8,6912,2149.0,1350.0,836.0,8,2390,2149.0,1350.0,270.0
0.006,17,2,166,1,75,0.0,47.0,47.0,1,91,0.0,63.0,63.0
0.072,6,10,1506,5,395,17.0,127.0,127.0,5,1111,13.0,843.0,843.0
0.009,6,10,1990,5,911,2.0,643.0,643.0,5,1079,2.0,811.0,811.0
0.017,6,10,1762,5,911,4.0,643.0,643.0,5,851,4.0,583.0,583.0
0.006,17,2,214,1,75,0.0,47.0,47.0,1,139,0.0,111.0,111.0
0.004,6,10,2006,5,927,1.0,659.0,659.0,5,1079,1.0,811.0,811.0
0.004,6,10,2007,5,928,1.0,660.0,660.0,5,1079,1.0,811.0,811.0
0.009,6,10,1990,5,911,2.0,643.0,643.0,5,1079,2.0,811.0,811.0
0.002,17,2,136,1,60,0.0,32.0,32.0,1,76,0.0,48.0,48.0
0.109,6,10,1506,5,395,22.0,127.0,127.0,5,1111,26.0,843.0,843.0
0.005,17,2,170,1,65,0.0,37.0,37.0,1,105,0.0,77.0,77.0
0.008,6,10,1989,5,910,2.0,642.0,642.0,5,1079,1.0,811.0,811.0
0.015,6,10,1677,5,827,3.0,559.0,559.0,5,850,3.0,582.0,582.0
0.006,17,2,166,1,75,0.0,47.0,47.0,1,91,0.0,63.0,63.0
0.004,17,2,136,1,60,0.0,32.0,32.0,1,76,0.0,48.0,48.0
0.099,6,10,1506,5,395,21.0,127.0,127.0,5,1111,22.0,843.0,843.0
0.043,17,2,152,1,76,0.0,48.0,48.0,1,76,0.0,48.0,48.0
0.005,6,10,2000,5,927,1.0,659.0,659.0,5,1073,1.0,805.0,805.0
15.08,17,16,8643,8,6550,2150.0,1350.0,790.0,8,2093,2150.0,1350.0,233.0
0.005,17,2,214,1,75,0.0,47.0,47.0,1,139,0.0,111.0,111.0
0.006,6,13,3684,7,446,0.0,74.0,74.0,6,3238,1.0,1470.0,1459.0
0.124,6,10,1506,5,395,29.0,127.0,127.0,5,1111,28.0,843.0,843.0
0.015,6,10,1631,5,848,3.0,580.0,580.0,5,783,3.0,515.0,515.0
0.091,6,10,1506,5,395,17.0,127.0,127.0,5,1111,22.0,843.0,843.0
0.072,6,10,1506,5,395,15.0,127.0,127.0,5,1111,15.0,843.0,843.0
40.053,17,10,676,5,460,10012.0,104.0,64.0,5,216,10012.0,20.0,15.0
15.072,17,15,8322,8,6244,2149.0,1350.0,752.0,7,2078,2507.0,1350.0,268.0
240.095,6,16,4480,9,963,30011.0,238.0,166.0,7,3517,40015.0,1402.0,786.0
0.006,17,2,230,1,68,0.0,40.0,40.0,1,162,0.0,134.0,134.0
0.016,6,10,1677,5,827,4.0,559.0,559.0,5,850,3.0,582.0,582.0
0.01,6,10,1990,5,911,2.0,643.0,643.0,5,1079,2.0,811.0,811.0
0.017,6,14,3787,7,497,2.0,125.0,125.0,7,3290,2.0,1448.0,972.0
0.006,17,2,184,1,68,0.0,40.0,40.0,1,116,0.0,88.0,88.0
0.006,6,13,3747,7,509,1.0,137.0,137.0,6,3238,1.0,1470.0,1459.0
0.005,6,10,1989,5,927,1.0,659.0,659.0,5,1062,1.0,794.0,794.0
0.015,6,10,1972,5,910,3.0,642.0,642.0,5,1062,3.0,794.0,794.0
0.077,6,10,1506,5,395,16.0,127.0,127.0,5,1111,15.0,843.0,843.0
0.009,6,10,1990,5,911,2.0,643.0,643.0,5,1079,2.0,811.0,811.0
0.003,17,2,148,1,60,0.0,32.0,32.0,1,88,0.0,60.0,60.0
0.085,6,10,1506,5,395,18.0,127.0,127.0,5,1111,17.0,843.0,843.0
0.004,17,2,136,1,60,0.0,32.0,32.0,1,76,0.0,48.0,48.0
0.004,6,10,2007,5,928,1.0,660.0,660.0,5,1079,1.0,811.0,811.0
240.053,6,9,787,5,488,60013.0,232.0,232.0,4,299,80016.0,83.0,83.0
0.004,6,10,1702,5,863,0.0,595.0,595.0,5,839,1.0,571.0,571.0
1770.131,6,81,4266,41,2159,44252.0,27.0,27.0,40,2107,45386.0,27.0,27.0
0.012,6,10,1989,5,910,3.0,642.0,642.0,5,1079,3.0,811.0,811.0
0.009,6,14,3787,7,497,1.0,125.0,125.0,7,3290,1.0,1448.0,972.0
0.147,6,11,1558,6,447,28.0,127.0,127.0,5,1111,34.0,843.0,843.0
40.061,17,10,676,5,460,10014.0,104.0,64.0,5,216,10011.0,20.0,15.0
0.001,17,2,180,1,66,0.0,38.0,38.0,1,114,0.0,86.0,86.0
0.001,17,2,180,1,66,0.0,38.0,38.0,1,114,0.0,86.0,86.0
0.07,6,10,1506,5,395,16.0,127.0,127.0,5,1111,15.0,843.0,843.0
240.132,6,41,5304,20,2432,12638.0,581.0,196.0,21,2872,12006.0,566.0,196.0
0.095,6,10,1506,5,395,22.0,127.0,127.0,5,1111,22.0,843.0,843.0
240.093,6,19,4624,9,2210,30011.0,1007.0,582.0,10,2414,26676.0,1162.0,377.0
0.008,6,10,1990,5,911,2.0,643.0,643.0,5,1079,2.0,811.0,811.0
0.015,6,10,1989,5,910,3.0,642.0,642.0,5,1079,3.0,811.0,811.0
0.005,6,10,1779,5,928,1.0,660.0,660.0,5,851,1.0,583.0,583.0
0.011,6,10,1762,5,911,2.0,643.0,643.0,5,851,2.0,583.0,583.0
0.539,17,43,20272,21,17034,26.0,1350.0,783.0,22,3238,21.0,1350.0,119.0
0.004,6,10,1774,5,923,1.0,655.0,655.0,5,851,1.0,583.0,583.0
0.001,17,2,179,1,62,0.0,34.0,34.0,1,117,0.0,89.0,89.0
0.016,6,10,1990,5,911,4.0,643.0,643.0,5,1079,4.0,811.0,811.0
0.8,6,10,937,6,427,160.0,107.0,107.0,4,510,178.0,294.0,294.0
0.004,17,2,132,1,58,0.0,30.0,30.0,1,74,0.0,46.0,46.0
0.006,6,10,2007,5,928,1.0,660.0,660.0,5,1079,1.0,811.0,811.0
0.012,6,14,3965,7,495,2.0,123.0,123.0,7,3470,1.0,1448.0,1032.0
0.016,6,10,1983,5,910,3.0,642.0,642.0,5,1073,3.0,805.0,805.0
0.005,6,10,2006,5,927,1.0,659.0,659.0,5,1079,1.0,811.0,811.0
0.005,6,10,2006,5,927,1.0,659.0,659.0,5,1079,1.0,811.0,811.0
0.012,6,10,1972,5,910,3.0,642.0,642.0,5,1062,2.0,794.0,794.0
0.009,6,10,1631,5,848,2.0,580.0,580.0,5,783,2.0,515.0,515.0
0.065,6,10,1506,5,395,15.0,127.0,127.0,5,1111,13.0,843.0,843.0
0.006,17,2,230,1,68,0.0,40.0,40.0,1,162,0.0,134.0,134.0
0.091,6,10,1506,5,395,19.0,127.0,127.0,5,1111,18.0,843.0,843.0
1788.116,6,233,28109,88,19087,20551.0,2720.0,207.0,145,9022,12416.0,148.0,47.0
0.009,6,10,2000,5,927,2.0,659.0,659.0,5,1073,2.0,805.0,805.0
0.081,6,10,1506,5,395,19.0,127.0,127.0,5,1111,16.0,843.0,843.0
0.004,6,10,2000,5,927,1.0,659.0,659.0,5,1073,1.0,805.0,805.0
0.005,6,10,1989,5,927,1.0,659.0,659.0,5,1062,1.0,794.0,794.0
0.085,6,10,1506,5,395,19.0,127.0,127.0,5,1111,18.0,843.0,843.0
0.005,6,10,1774,5,923,1.0,655.0,655.0,5,851,1.0,583.0,583.0
0.006,6,10,2007,5,928,1.0,660.0,660.0,5,1079,1.0,811.0,811.0
0.072,17,4,596,2,122,1.0,33.0,33.0,2,474,68.0,323.0,209.0
0.005,6,10,1989,5,927,1.0,659.0,659.0,5,1062,1.0,794.0,794.0
240.015,6,9,787,5,488,60003.0,232.0,232.0,4,299,80004.0,83.0,83.0
0.005,17,2,170,1,65,0.0,37.0,37.0,1,105,0.0,77.0,77.0
0.015,6,10,1990,5,911,3.0,643.0,643.0,5,1079,3.0,811.0,811.0
0.128,17,2,182,1,65,0.0,37.0,37.0,1,117,0.0,89.0,89.0
0.005,6,10,2007,5,928,1.0,660.0,660.0,5,1079,1.0,811.0,811.0
40.055,17,10,676,5,460,10012.0,104.0,64.0,5,216,10012.0,20.0,15.0
0.174,17,2,152,1,76,0.0,48.0,48.0,1,76,0.0,48.0,48.0
0.004,17,2,136,1,60,0.0,32.0,32.0,1,76,0.0,48.0,48.0
0.005,17,2,222,1,65,0.0,37.0,37.0,1,157,0.0,129.0,129.0
0.005,6,10,2006,5,927,1.0,659.0,659.0,5,1079,1.0,811.0,811.0
0.078,6,10,1506,5,395,17.0,127.0,127.0,5,1111,18.0,843.0,843.0
0.04,17,2,136,1,60,0.0,32.0,32.0,1,76,0.0,48.0,48.0
40.884,58,3,216,2,144,40884.0,24.0,24.0,1,72,0.0,24.0,24.0
0.006,17,2,367,1,99,0.0,71.0,71.0,1,268,0.0,240.0,240.0
40.07,17,10,676,5,460,10015.0,104.0,64.0,5,216,10016.0,20.0,15.0
0.217,6,16,2669,8,1395,31.0,533.0,323.0,8,1274,19.0,529.0,212.0
10.888,17,24,3778,12,1674,980.0,269.0,111.0,12,2104,980.0,587.0,147.0
361.833,6,21,1793,16,1030,24122.0,190.0,190.0,5,763,60011.0,462.0,247.0
0.039,17,2,152,1,76,0.0,48.0,48.0,1,76,0.0,48.0,48.0
0.085,6,10,1506,5,395,19.0,127.0,127.0,5,1111,20.0,843.0,843.0
0.123,6,10,1506,5,395,29.0,127.0,127.0,5,1111,28.0,843.0,843.0
0.004,6,10,2006,5,927,1.0,659.0,659.0,5,1079,1.0,811.0,811.0
0.005,6,10,1989,5,927,1.0,659.0,659.0,5,1062,1.0,794.0,794.0
0.017,6,10,1990,5,911,4.0,643.0,643.0,5,1079,4.0,811.0,811.0
0.004,17,2,136,1,60,0.0,32.0,32.0,1,76,0.0,48.0,48.0
240.375,6,33,9266,16,1833,16024.0,621.0,198.0,17,7433,15023.0,1402.0,595.0
0.005,6,10,1989,5,927,1.0,659.0,659.0,5,1062,1.0,794.0,794.0
0.005,6,10,1643,5,860,1.0,592.0,592.0,5,783,1.0,515.0,515.0
0.01,17,2,175,1,65,0.0,37.0,37.0,1,110,0.0,82.0,82.0
0.005,6,10,2000,5,927,1.0,659.0,659.0,5,1073,1.0,805.0,805.0
0.128,6,10,1506,5,395,27.0,127.0,127.0,5,1111,29.0,843.0,843.0
10.765,17,28,4422,14,1994,819.0,269.0,114.0,14,2428,819.0,587.0,145.0
15.075,17,15,9238,8,6902,2149.0,1350.0,834.0,7,2336,2507.0,1350.0,305.0
0.009,6,10,1989,5,910,2.0,642.0,642.0,5,1079,2.0,811.0,811.0
0.04,17,2,144,1,64,0.0,36.0,36.0,1,80,0.0,52.0,52.0
0.006,6,10,1547,5,764,1.0,496.0,496.0,5,783,1.0,515.0,515.0
0.005,6,10,2007,5,928,1.0,660.0,660.0,5,1079,1.0,811.0,811.0
0.005,6,10,1989,5,927,1.0,659.0,659.0,5,1062,1.0,794.0,794.0
0.004,6,10,1779,5,928,1.0,660.0,660.0,5,851,0.0,583.0,583.0
0.015,6,10,1631,5,848,3.0,580.0,580.0,5,783,3.0,515.0,515.0
0.017,6,10,1990,5,911,4.0,643.0,643.0,5,1079,4.0,811.0,811.0
0.167,17,2,152,1,76,0.0,48.0,48.0,1,76,0.0,48.0,48.0
0.01,6,13,3735,7,497,1.0,125.0,125.0,6,3238,2.0,1470.0,1459.0
0.077,6,10,1506,5,395,17.0,127.0,127.0,5,1111,14.0,843.0,843.0
0.073,6,10,1506,5,395,16.0,127.0,127.0,5,1111,17.0,843.0,843.0
0.009,6,10,1972,5,910,2.0,642.0,642.0,5,1062,2.0,794.0,794.0
40.072,17,10,676,5,460,10017.0,104.0,64.0,5,216,10014.0,20.0,15.0
15.07,17,15,9238,8,6902,2148.0,1350.0,834.0,7,2336,2506.0,1350.0,305.0
0.004,17,2,162,1,65,0.0,37.0,37.0,1,97,0.0,69.0,69.0
0.082,6,10,1506,5,395,18.0,127.0,127.0,5,1111,18.0,843.0,843.0
0.092,6,10,1506,5,395,20.0,127.0,127.0,5,1111,18.0,843.0,843.0
0.005,6,10,1989,5,927,1.0,659.0,659.0,5,1062,1.0,794.0,794.0
0.003,17,2,148,1,60,0.0,32.0,32.0,1,88,0.0,60.0,60.0
0.063,6,10,1506,5,395,15.0,127.0,127.0,5,1111,12.0,843.0,843.0
0.007,17,2,136,1,60,0.0,32.0,32.0,1,76,0.0,48.0,48.0
0.066,17,8,3613,4,1874,22.0,1350.0,440.0,4,1739,11.0,1350.0,406.0
0.014,6,10,1990,5,911,3.0,643.0,643.0,5,1079,3.0,811.0,811.0
0.013,6,10,1989,5,910,3.0,642.0,642.0,5,1079,3.0,811.0,811.0
11.043,17,28,4390,14,2312,840.0,587.0,137.0,14,2078,840.0,269.0,120.0
0.005,6,10,2006,5,927,1.0,659.0,659.0,5,1079,1.0,811.0,811.0
0.006,6,10,2006,5,927,1.0,659.0,659.0,5,1079,1.0,811.0,811.0
0.005,6,10,2006,5,927,1.0,659.0,659.0,5,1079,1.0,811.0,811.0
0.013,6,10,1990,5,911,3.0,643.0,643.0,5,1079,3.0,811.0,811.0
0.1,6,10,1506,5,395,23.0,127.0,127.0,5,1111,21.0,843.0,843.0
0.011,6,10,1677,5,827,2.0,559.0,559.0,5,850,2.0,582.0,582.0
0.003,17,2,148,1,60,0.0,32.0,32.0,1,88,0.0,60.0,60.0
0.005,6,10,1689,5,839,1.0,571.0,571.0,5,850,1.0,582.0,582.0
0.052,17,2,152,1,76,0.0,48.0,48.0,1,76,0.0,48.0,48.0
1779.271,17,140,44240,72,22752,25054.0,288.0,288.0,68,21488,26555.0,288.0,288.0
0.006,6,10,1989,5,927,1.0,659.0,659.0,5,1062,1.0,794.0,794.0
0.091,6,10,1506,5,395,18.0,127.0,127.0,5,1111,21.0,843.0,843.0
0.005,17,2,140,1,62,0.0,34.0,34.0,1,78,0.0,50.0,50.0
0.012,6,10,1990,5,911,3.0,643.0,643.0,5,1079,3.0,811.0,811.0
0.009,6,10,1989,5,910,2.0,642.0,642.0,5,1079,2.0,811.0,811.0
0.006,6,10,1643,5,860,1.0,592.0,592.0,5,783,1.0,515.0,515.0
40.057,17,10,676,5,460,10012.0,104.0,64.0,5,216,10013.0,20.0,15.0
10.738,17,28,4421,14,1993,817.0,268.0,114.0,14,2428,817.0,587.0,145.0
0.075,6,10,1506,5,395,17.0,127.0,127.0,5,1111,13.0,843.0,843.0
0.086,6,10,1506,5,395,19.0,127.0,127.0,5,1111,17.0,843.0,843.0
0.011,6,10,1989,5,910,2.0,642.0,642.0,5,1079,2.0,811.0,811.0
0.024,6,10,1972,5,910,6.0,642.0,642.0,5,1062,5.0,794.0,794.0
0.201,6,16,2777,8,1395,28.0,533.0,323.0,8,1382,18.0,529.0,239.0
0.102,6,10,1506,5,395,20.0,127.0,127.0,5,1111,22.0,843.0,843.0
0.006,17,2,214,1,75,0.0,47.0,47.0,1,139,0.0,111.0,111.0
0.018,6,10,1989,5,910,4.0,642.0,642.0,5,1079,4.0,811.0,811.0
0.089,6,10,1506,5,395,19.0,127.0,127.0,5,1111,20.0,843.0,843.0
0.023,6,10,1972,5,910,5.0,642.0,642.0,5,1062,5.0,794.0,794.0
0.014,6,10,1990,5,911,3.0,643.0,643.0,5,1079,3.0,811.0,811.0
0.006,6,10,1547,5,764,1.0,496.0,496.0,5,783,1.0,515.0,515.0
0.005,6,10,1779,5,928,1.0,660.0,660.0,5,851,1.0,583.0,583.0
0.023,6,10,1989,5,910,5.0,642.0,642.0,5,1079,5.0,811.0,811.0
0.016,6,10,1972,5,910,4.0,642.0,642.0,5,1062,3.0,794.0,794.0
0.129,17,2,166,1,75,0.0,47.0,47.0,1,91,0.0,63.0,63.0
9.036,17,6,376,5,280,2259.0,28.0,28.0,1,96,0.0,68.0,68.0
0.13,17,2,146,1,65,0.0,37.0,37.0,1,81,0.0,53.0,53.0
0.01,6,10,1983,5,910,2.0,642.0,642.0,5,1073,2.0,805.0,805.0
0.004,6,10,1774,5,923,1.0,655.0,655.0,5,851,1.0,583.0,583.0
0.004,6,10,1989,5,927,1.0,659.0,659.0,5,1062,1.0,794.0,794.0
0.005,6,10,1989,5,927,1.0,659.0,659.0,5,1062,1.0,794.0,794.0
0.009,17,4,284,2,120,6.0,32.0,32.0,2,164,5.0,60.0,54.0
0.105,6,10,1506,5,395,22.0,127.0,127.0,5,1111,23.0,843.0,843.0
0.001,17,2,136,1,60,0.0,32.0,32.0,1,76,0.0,48.0,48.0
172.047,17,78,11263,39,2617,4527.0,44.0,39.0,39,8646,4527.0,261.0,193.0
0.009,6,10,1989,5,910,2.0,642.0,642.0,5,1079,2.0,811.0,811.0
0.004,17,2,136,1,60,0.0,32.0,32.0,1,76,0.0,48.0,48.0
0.007,6,10,1989,5,910,1.0,642.0,642.0,5,1079,1.0,811.0,811.0
0.019,6,10,1990,5,911,4.0,643.0,643.0,5,1079,4.0,811.0,811.0
0.127,6,10,1506,5,395,28.0,127.0,127.0,5,1111,20.0,843.0,843.0
0.087,6,10,1506,5,395,20.0,127.0,127.0,5,1111,19.0,843.0,843.0
0.227,6,16,2674,8,1400,32.0,533.0,325.0,8,1274,20.0,529.0,212.0
240.137,6,23,9421,12,4575,21830.0,1368.0,791.0,11,4846,24013.0,1656.0,1066.0
0.016,6,10,1990,5,911,4.0,643.0,643.0,5,1079,3.0,811.0,811.0
0.005,17,2,170,1,65,0.0,37.0,37.0,1,105,0.0,77.0,77.0
0.006,17,2,170,1,65,0.0,37.0,37.0,1,105,0.0,77.0,77.0
0.009,6,12,1926,6,1189,1.0,659.0,434.0,6,737,1.0,417.0,417.0
0.006,17,2,164,1,74,0.0,46.0,46.0,1,90,0.0,62.0,62.0
0.01,6,10,1983,5,910,2.0,642.0,642.0,5,1073,2.0,805.0,805.0
1743.237,6,64,7344,42,4469,42517.0,1625.0,108.0,22,2875,83003.0,1111.0,82.0
0.003,17,2,136,1,60,0.0,32.0,32.0,1,76,0.0,48.0,48.0
0.009,6,10,1989,5,910,2.0,642.0,642.0,5,1079,2.0,811.0,811.0
0.013,17,2,152,1,56,0.0,28.0,28.0,1,96,0.0,68.0,68.0
0.114,6,10,1506,5,395,25.0,127.0,127.0,5,1111,24.0,843.0,843.0
0.015,6,10,1989,5,910,3.0,642.0,642.0,5,1079,3.0,811.0,811.0
0.043,17,4,596,2,122,4.0,33.0,33.0,2,474,35.0,323.0,209.0
0.018,6,10,1989,5,910,4.0,642.0,642.0,5,1079,4.0,811.0,811.0
0.08,6,10,1506,5,395,17.0,127.0,127.0,5,1111,17.0,843.0,843.0
0.004,17,2,148,1,60,0.0,32.0,32.0,1,88,0.0,60.0,60.0
0.013,6,13,3735,7,497,2.0,125.0,125.0,6,3238,2.0,1470.0,1459.0
0.001,17,2,180,1,66,0.0,38.0,38.0,1,114,0.0,86.0,86.0
0.035,6,10,1677,5,827,8.0,559.0,559.0,5,850,8.0,582.0,582.0
0.005,6,13,3684,7,446,0.0,74.0,74.0,6,3238,1.0,1470.0,1459.0
0.005,6,10,1547,5,764,1.0,496.0,496.0,5,783,1.0,515.0,515.0
0.004,17,2,148,1,60,0.0,32.0,32.0,1,88,0.0,60.0,60.0
0.01,17,2,164,1,74,0.0,46.0,46.0,1,90,0.0,62.0,62.0
0.002,17,2,166,1,75,0.0,47.0,47.0,1,91,0.0,63.0,63.0
0.016,6,10,1990,5,911,4.0,643.0,643.0,5,1079,4.0,811.0,811.0
0.001,17,2,180,1,66,0.0,38.0,38.0,1,114,0.0,86.0,86.0
0.005,6,10,2006,5,927,1.0,659.0,659.0,5,1079,1.0,811.0,811.0
0.119,6,10,1506,5,395,29.0,127.0,127.0,5,1111,26.0,843.0,843.0
0.006,6,10,1989,5,927,1.0,659.0,659.0,5,1062,1.0,794.0,794.0
0.005,6,10,1547,5,764,1.0,496.0,496.0,5,783,1.0,515.0,515.0
0.001,17,2,178,1,81,0.0,53.0,53.0,1,97,0.0,69.0,69.0
242.844,6,318,343892,119,17695,2058.0,2736.0,885.0,199,326197,1226.0,2804.0,1671.0
0.004,17,4,420,2,122,0.0,33.0,33.0,2,298,0.0,145.0,121.0
351.996,6,20,2210,6,1308,12003.0,494.0,494.0,14,902,27076.0,83.0,83.0
0.001,17,2,180,1,66,0.0,38.0,38.0,1,114,0.0,86.0,86.0
14.235,17,45,10350,23,5458,640.0,1337.0,209.0,22,4892,672.0,863.0,194.0
0.04,17,2,136,1,60,0.0,32.0,32.0,1,76,0.0,48.0,48.0
0.005,17,2,164,1,74,0.0,46.0,46.0,1,90,0.0,62.0,62.0
0.1,6,10,1506,5,395,24.0,127.0,127.0,5,1111,22.0,843.0,843.0
0.017,6,13,3913,7,495,2.0,123.0,123.0,6,3418,3.0,1650.0,1549.0
0.164,17,2,152,1,76,0.0,48.0,48.0,1,76,0.0,48.0,48.0
0.006,6,10,1689,5,839,1.0,571.0,571.0,5,850,1.0,582.0,582.0
0.009,6,10,1631,5,848,2.0,580.0,580.0,5,783,2.0,515.0,515.0
0.015,6,10,1989,5,910,3.0,642.0,642.0,5,1079,3.0,811.0,811.0
0.001,17,2,180,1,66,0.0,38.0,38.0,1,114,0.0,86.0,86.0
361.749,6,19,1689,15,978,25839.0,190.0,190.0,4,711,80013.0,495.0,495.0
0.004,17,4,284,2,120,0.0,32.0,32.0,2,164,0.0,60.0,54.0
0.006,6,12,1698,6,863,1.0,327.0,271.0,6,835,1.0,515.0,515.0
15.079,17,15,8506,8,6285,2150.0,1350.0,757.0,7,2221,2508.0,1350.0,289.0
0.016,6,10,1989,5,910,3.0,642.0,642.0,5,1079,4.0,811.0,811.0
0.004,6,10,1989,5,927,1.0,659.0,659.0,5,1062,1.0,794.0,794.0
0.003,17,2,136,1,60,0.0,32.0,32.0,1,76,0.0,48.0,48.0
0.004,6,10,1989,5,927,1.0,659.0,659.0,5,1062,1.0,794.0,794.0
0.01,6,10,1989,5,910,2.0,642.0,642.0,5,1079,2.0,811.0,811.0
240.014,6,11,1563,6,888,48002.0,290.0,290.0,5,675,60002.0,395.0,395.0
0.014,6,10,1989,5,910,3.0,642.0,642.0,5,1079,3.0,811.0,811.0
0.01,6,10,1972,5,910,2.0,642.0,642.0,5,1062,2.0,794.0,794.0
0.004,17,2,214,1,75,0.0,47.0,47.0,1,139,0.0,111.0,111.0
0.015,6,10,1989,5,910,3.0,642.0,642.0,5,1079,3.0,811.0,811.0
0.014,6,10,1989,5,910,3.0,642.0,642.0,5,1079,3.0,811.0,811.0
10.789,17,28,4422,14,1994,821.0,269.0,114.0,14,2428,821.0,587.0,145.0
0.005,17,2,170,1,65,0.0,37.0,37.0,1,105,0.0,77.0,77.0
0.01,6,10,1972,5,910,2.0,642.0,642.0,5,1062,2.0,794.0,794.0
0.004,6,10,2006,5,927,1.0,659.0,659.0,5,1079,1.0,811.0,811.0
0.001,17,2,180,1,66,0.0,38.0,38.0,1,114,0.0,86.0,86.0
0.006,6,10,1547,5,764,1.0,496.0,496.0,5,783,1.0,515.0,515.0
0.009,6,10,1983,5,910,2.0,642.0,642.0,5,1073,2.0,805.0,805.0
0.005,17,2,170,1,65,0.0,37.0,37.0,1,105,0.0,77.0,77.0
0.005,6,10,2000,5,927,1.0,659.0,659.0,5,1073,1.0,805.0,805.0
0.003,17,2,656,1,328,0.0,300.0,300.0,1,328,0.0,300.0,300.0
0.011,6,10,1983,5,910,2.0,642.0,642.0,5,1073,2.0,805.0,805.0
0.017,17,2,169,1,62,0.0,34.0,34.0,1,107,0.0,79.0,79.0
0.001,17,2,154,1,69,0.0,41.0,41.0,1,85,0.0,57.0,57.0
0.085,6,10,1506,5,395,18.0,127.0,127.0,5,1111,19.0,843.0,843.0
0.004,6,10,1989,5,927,1.0,659.0,659.0,5,1062,1.0,794.0,794.0
300.157,6,25,7303,15,1357,21439.0,217.0,142.0,10,5946,26682.0,1679.0,903.0
0.004,6,10,2000,5,927,1.0,659.0,659.0,5,1073,1.0,805.0,805.0
11.199,17,28,4389,14,2311,852.0,586.0,137.0,14,2078,852.0,269.0,120.0
0.01,17,2,194,1,59,0.0,31.0,31.0,1,135,0.0,107.0,107.0
0.005,6,10,2007,5,928,1.0,660.0,660.0,5,1079,1.0,811.0,811.0
0.006,6,10,1547,5,764,1.0,496.0,496.0,5,783,1.0,515.0,515.0
0.009,6,10,1990,5,911,2.0,643.0,643.0,5,1079,2.0,811.0,811.0
0.006,17,2,164,1,74,0.0,46.0,46.0,1,90,0.0,62.0,62.0
0.007,17,2,194,1,59,0.0,31.0,31.0,1,135,0.0,107.0,107.0
0.006,6,10,1547,5,764,1.0,496.0,496.0,5,783,1.0,515.0,515.0
0.006,6,10,2006,5,927,1.0,659.0,659.0,5,1079,1.0,811.0,811.0
0.006,6,10,1643,5,860,1.0,592.0,592.0,5,783,1.0,515.0,515.0
0.097,6,10,1506,5,395,20.0,127.0,127.0,5,1111,22.0,843.0,843.0
0.005,6,10,1643,5,860,1.0,592.0,592.0,5,783,1.0,515.0,515.0
40.049,17,10,676,5,460,10011.0,104.0,64.0,5,216,10011.0,20.0,15.0
0.014,6,10,1983,5,910,3.0,642.0,642.0,5,1073,3.0,805.0,805.0
0.005,6,10,1854,5,889,1.0,621.0,621.0,5,965,1.0,697.0,697.0
309.589,17,20,1124,10,716,34385.0,48.0,43.0,10,408,34384.0,20.0,12.0
0.003,17,2,136,1,60,0.0,32.0,32.0,1,76,0.0,48.0,48.0
11.174,17,28,4421,14,1993,847.0,268.0,114.0,14,2428,847.0,587.0,145.0
0.005,6,10,2006,5,927,1.0,659.0,659.0,5,1079,1.0,811.0,811.0
241.212,6,306,343633,130,18275,1869.0,2736.0,886.0,176,325358,1378.0,2804.0,1904.0
15.082,17,15,8140,8,5982,2150.0,1350.0,719.0,7,2158,2508.0,1350.0,280.0
0.014,6,10,1990,5,911,3.0,643.0,643.0,5,1079,3.0,811.0,811.0
40.064,17,10,676,5,460,10015.0,104.0,64.0,5,216,10015.0,20.0,15.0
0.109,6,10,1506,5,395,26.0,127.0,127.0,5,1111,24.0,843.0,843.0
0.005,17,2,164,1,74,0.0,46.0,46.0,1,90,0.0,62.0,62.0
0.009,6,10,1972,5,910,2.0,642.0,642.0,5,1062,2.0,794.0,794.0
0.011,6,10,1677,5,827,2.0,559.0,559.0,5,850,2.0,582.0,582.0
0.004,6,10,1702,5,863,1.0,595.0,595.0,5,839,1.0,571.0,571.0
0.083,6,10,1506,5,395,17.0,127.0,127.0,5,1111,16.0,843.0,843.0
0.008,6,12,1926,6,1189,1.0,659.0,434.0,6,737,1.0,417.0,417.0
0.005,17,2,214,1,75,0.0,47.0,47.0,1,139,0.0,111.0,111.0
0.065,6,10,1506,5,395,15.0,127.0,127.0,5,1111,14.0,843.0,843.0
0.004,6,10,2000,5,927,1.0,659.0,659.0,5,1073,1.0,805.0,805.0
0.001,17,2,180,1,66,0.0,38.0,38.0,1,114,0.0,86.0,86.0
0.075,6,10,1506,5,395,16.0,127.0,127.0,5,1111,16.0,843.0,843.0
0.001,17,2,180,1,66,0.0,38.0,38.0,1,114,0.0,86.0,86.0
0.012,6,10,1972,5,910,2.0,642.0,642.0,5,1062,2.0,794.0,794.0
0.004,17,2,148,1,60,0.0,32.0,32.0,1,88,0.0,60.0,60.0
0.136,6,10,1506,5,395,26.0,127.0,127.0,5,1111,30.0,843.0,843.0
0.009,6,10,1972,5,910,2.0,642.0,642.0,5,1062,2.0,794.0,794.0
0.005,6,10,1989,5,927,1.0,659.0,659.0,5,1062,1.0,794.0,794.0
0.101,6,10,1506,5,395,22.0,127.0,127.0,5,1111,21.0,843.0,843.0
0.005,6,10,2007,5,928,1.0,660.0,660.0,5,1079,1.0,811.0,811.0
0.005,6,10,1854,5,889,1.0,621.0,621.0,5,965,1.0,697.0,697.0
0.005,6,10,2006,5,927,1.0,659.0,659.0,5,1079,1.0,811.0,811.0
0.014,6,10,1990,5,911,3.0,643.0,643.0,5,1079,3.0,811.0,811.0
0.003,17,4,284,2,120,0.0,32.0,32.0,2,164,0.0,60.0,54.0
0.146,17,2,144,1,64,0.0,36.0,36.0,1,80,0.0,52.0,52.0
0.015,6,10,1762,5,911,3.0,643.0,643.0,5,851,3.0,583.0,583.0
0.037,6,10,1677,5,827,9.0,559.0,559.0,5,850,9.0,582.0,582.0
0.093,6,10,1506,5,395,19.0,127.0,127.0,5,1111,21.0,843.0,843.0
0.005,6,10,2000,5,927,1.0,659.0,659.0,5,1073,1.0,805.0,805.0
0.069,6,10,1506,5,395,14.0,127.0,127.0,5,1111,14.0,843.0,843.0
361.779,6,21,1793,16,1030,24118.0,190.0,190.0,5,763,60011.0,462.0,247.0
308.621,17,20,1124,10,716,34277.0,48.0,43.0,10,408,34276.0,20.0,12.0
0.1,6,10,1506,5,395,23.0,127.0,127.0,5,1111,22.0,843.0,843.0
0.008,6,10,1972,5,910,2.0,642.0,642.0,5,1062,2.0,794.0,794.0
0.007,17,2,132,1,58,0.0,30.0,30.0,1,74,0.0,46.0,46.0
0.02,6,10,1990,5,911,5.0,643.0,643.0,5,1079,4.0,811.0,811.0
0.013,6,10,1989,5,910,3.0,642.0,642.0,5,1079,3.0,811.0,811.0
0.005,6,10,2006,5,927,1.0,659.0,659.0,5,1079,1.0,811.0,811.0
34.167,6,33,6264,18,1338,2009.0,267.0,195.0,15,4926,606.0,1823.0,392.0
0.018,6,10,1631,5,848,4.0,580.0,580.0,5,783,4.0,515.0,515.0
0.006,6,10,1547,5,764,1.0,496.0,496.0,5,783,1.0,515.0,515.0
0.131,6,10,1506,5,395,31.0,127.0,127.0,5,1111,24.0,843.0,843.0
0.004,6,10,1702,5,863,1.0,595.0,595.0,5,839,1.0,571.0,571.0
0.005,6,10,2006,5,927,1.0,659.0,659.0,5,1079,1.0,811.0,811.0
0.014,6,10,1983,5,910,3.0,642.0,642.0,5,1073,3.0,805.0,805.0
0.001,17,2,140,1,62,0.0,34.0,34.0,1,78,0.0,50.0,50.0
0.017,17,2,198,1,91,0.0,63.0,63.0,1,107,0.0,79.0,79.0
0.011,6,10,1972,5,910,2.0,642.0,642.0,5,1062,2.0,794.0,794.0
0.09,6,10,1506,5,395,20.0,127.0,127.0,5,1111,20.0,843.0,843.0
0.102,6,10,1506,5,395,22.0,127.0,127.0,5,1111,22.0,843.0,843.0
40.066,17,10,676,5,460,10015.0,104.0,64.0,5,216,10015.0,20.0,15.0
0.004,17,2,136,1,60,0.0,32.0,32.0,1,76,0.0,48.0,48.0
0.014,6,10,1972,5,910,3.0,642.0,642.0,5,1062,3.0,794.0,794.0
0.004,17,2,152,1,68,0.0,40.0,40.0,1,84,0.0,56.0,56.0
0.005,6,10,1989,5,927,1.0,659.0,659.0,5,1062,1.0,794.0,794.0
0.013,6,10,1972,5,910,3.0,642.0,642.0,5,1062,3.0,794.0,794.0
0.01,6,10,1631,5,848,2.0,580.0,580.0,5,783,2.0,515.0,515.0
0.004,6,10,1702,5,863,1.0,595.0,595.0,5,839,0.0,571.0,571.0
0.044,6,10,1989,5,910,10.0,642.0,642.0,5,1079,11.0,811.0,811.0
0.013,6,10,1989,5,910,3.0,642.0,642.0,5,1079,3.0,811.0,811.0
0.005,6,10,1989,5,927,1.0,659.0,659.0,5,1062,1.0,794.0,794.0
0.005,17,2,230,1,68,0.0,40.0,40.0,1,162,0.0,134.0,134.0
0.006,6,10,1689,5,839,1.0,571.0,571.0,5,850,1.0,582.0,582.0
300.652,6,34,6335,19,1409,16702.0,267.0,154.0,15,4926,609.0,1823.0,392.0
0.005,17,2,140,1,62,0.0,34.0,34.0,1,78,0.0,50.0,50.0
0.039,17,4,284,2,120,0.0,32.0,32.0,2,164,36.0,60.0,54.0
241.378,6,380,347489,195,21668,1244.0,2736.0,960.0,185,325821,1311.0,3984.0,1806.0
0.004,6,10,2007,5,928,1.0,660.0,660.0,5,1079,1.0,811.0,811.0
0.005,17,2,170,1,65,0.0,37.0,37.0,1,105,0.0,77.0,77.0
0.074,6,10,1506,5,395,17.0,127.0,127.0,5,1111,14.0,843.0,843.0
0.004,6,10,2006,5,927,1.0,659.0,659.0,5,1079,1.0,811.0,811.0
308.746,17,20,1124,10,716,34291.0,48.0,43.0,10,408,34291.0,20.0,12.0
0.014,6,10,1762,5,911,3.0,643.0,643.0,5,851,3.0,583.0,583.0
0.005,6,10,1774,5,923,1.0,655.0,655.0,5,851,1.0,583.0,583.0
0.107,6,10,1506,5,395,25.0,127.0,127.0,5,1111,24.0,843.0,843.0
0.097,6,10,1506,5,395,22.0,127.0,127.0,5,1111,19.0,843.0,843.0
0.052,17,2,152,1,76,0.0,48.0,48.0,1,76,0.0,48.0,48.0
308.631,17,20,1124,10,716,34279.0,48.0,43.0,10,408,34279.0,20.0,12.0
0.012,6,10,1631,5,848,2.0,580.0,580.0,5,783,2.0,515.0,515.0
0.005,6,10,1689,5,839,1.0,571.0,571.0,5,850,1.0,582.0,582.0
0.014,6,10,1989,5,910,3.0,642.0,642.0,5,1079,3.0,811.0,811.0
0.016,17,2,198,1,91,0.0,63.0,63.0,1,107,0.0,79.0,79.0
0.117,6,10,1506,5,395,21.0,127.0,127.0,5,1111,23.0,843.0,843.0
241.918,6,316,343849,122,17852,1999.0,2690.0,959.0,194,325997,1253.0,2804.0,1716.0
0.005,6,10,2000,5,927,1.0,659.0,659.0,5,1073,1.0,805.0,805.0
0.003,17,2,148,1,60,0.0,32.0,32.0,1,88,0.0,60.0,60.0
0.013,6,10,1989,5,910,3.0,642.0,642.0,5,1079,3.0,811.0,811.0
0.114,6,10,1506,5,395,24.0,127.0,127.0,5,1111,25.0,843.0,843.0
0.005,6,10,2006,5,927,1.0,659.0,659.0,5,1079,1.0,811.0,811.0
0.003,17,2,148,1,60,0.0,32.0,32.0,1,88,0.0,60.0,60.0
0.005,6,10,2006,5,927,1.0,659.0,659.0,5,1079,1.0,811.0,811.0
0.013,6,10,1972,5,910,3.0,642.0,642.0,5,1062,3.0,794.0,794.0
0.005,17,2,214,1,75,0.0,47.0,47.0,1,139,0.0,111.0,111.0
0.008,6,10,1990,5,911,2.0,643.0,643.0,5,1079,1.0,811.0,811.0
0.126,6,10,1506,5,395,29.0,127.0,127.0,5,1111,30.0,843.0,843.0
0.009,6,13,3735,7,497,1.0,125.0,125.0,6,3238,1.0,1470.0,1459.0
0.082,6,10,1506,5,395,16.0,127.0,127.0,5,1111,19.0,843.0,843.0
40.058,17,10,676,5,460,10013.0,104.0,64.0,5,216,10013.0,20.0,15.0
0.004,6,10,2006,5,927,1.0,659.0,659.0,5,1079,1.0,811.0,811.0
0.017,17,2,179,1,71,0.0,43.0,43.0,1,108,0.0,80.0,80.0
0.005,6,10,1774,5,923,1.0,655.0,655.0,5,851,1.0,583.0,583.0
0.076,6,10,1506,5,395,15.0,127.0,127.0,5,1111,18.0,843.0,843.0
40.071,17,10,676,5,460,10016.0,104.0,64.0,5,216,10016.0,20.0,15.0
0.005,17,2,166,1,75,0.0,47.0,47.0,1,91,0.0,63.0,63.0
0.012,6,10,1989,5,910,2.0,642.0,642.0,5,1079,3.0,811.0,811.0
0.013,6,10,1989,5,910,3.0,642.0,642.0,5,1079,3.0,811.0,811.0
0.016,6,10,1989,5,910,4.0,642.0,642.0,5,1079,4.0,811.0,811.0
0.017,6,10,1990,5,911,4.0,643.0,643.0,5,1079,4.0,811.0,811.0
0.124,17,2,80,1,32,0.0,4.0,4.0,1,48,0.0,20.0,20.0
61.038,6,25,17627,14,9735,4695.0,2804.0,1501.0,11,7892,6090.0,2315.0,1218.0
0.004,6,10,2006,5,927,1.0,659.0,659.0,5,1079,1.0,811.0,811.0
0.005,6,10,1779,5,928,1.0,660.0,660.0,5,851,1.0,583.0,583.0
0.005,17,2,166,1,75,0.0,47.0,47.0,1,91,0.0,63.0,63.0
0.008,6,10,1989,5,910,2.0,642.0,642.0,5,1079,2.0,811.0,811.0
0.004,17,2,148,1,60,0.0,32.0,32.0,1,88,0.0,60.0,60.0
0.014,6,10,1972,5,910,3.0,642.0,642.0,5,1062,3.0,794.0,794.0
0.001,17,2,194,1,57,0.0,29.0,29.0,1,137,0.0,109.0,109.0
0.067,6,10,1506,5,395,14.0,127.0,127.0,5,1111,14.0,843.0,843.0
0.005,6,10,2007,5,928,1.0,660.0,660.0,5,1079,1.0,811.0,811.0
0.013,6,10,1779,5,928,3.0,660.0,660.0,5,851,3.0,583.0,583.0
0.273,17,39,20092,21,17043,13.0,1350.0,783.0,18,3049,12.0,1350.0,141.0
0.1,6,10,1506,5,395,22.0,127.0,127.0,5,1111,20.0,843.0,843.0
0.013,6,10,1989,5,910,3.0,642.0,642.0,5,1079,3.0,811.0,811.0
0.007,6,10,1547,5,764,1.0,496.0,496.0,5,783,1.0,515.0,515.0
9.037,17,6,376,5,280,2259.0,28.0,28.0,1,96,0.0,68.0,68.0
0.014,17,2,150,1,67,0.0,39.0,39.0,1,83,0.0,55.0,55.0
0.119,6,10,1506,5,395,26.0,127.0,127.0,5,1111,24.0,843.0,843.0
0.097,6,10,1506,5,395,22.0,127.0,127.0,5,1111,20.0,843.0,843.0
0.081,6,10,1506,5,395,17.0,127.0,127.0,5,1111,18.0,843.0,843.0
0.014,6,10,1990,5,911,3.0,643.0,643.0,5,1079,3.0,811.0,811.0
15.081,17,14,7501,7,5463,2508.0,1350.0,752.0,7,2038,2508.0,1350.0,263.0
0.006,6,10,1547,5,764,1.0,496.0,496.0,5,783,1.0,515.0,515.0
0.097,6,10,1506,5,395,23.0,127.0,127.0,5,1111,17.0,843.0,843.0
175.25,17,76,10774,38,2537,4736.0,44.0,38.0,38,8237,4736.0,239.0,188.0
40.061,17,10,676,5,460,10013.0,104.0,64.0,5,216,10011.0,20.0,15.0
0.008,6,10,1989,5,910,2.0,642.0,642.0,5,1079,2.0,811.0,811.0
0.006,17,2,152,1,68,0.0,40.0,40.0,1,84,0.0,56.0,56.0
240.135,6,31,9276,15,6899,17152.0,2024.0,680.0,16,2377,16008.0,580.0,192.0
27.215,6,42,27557,20,17917,1432.0,2804.0,1874.0,22,9640,1290.0,1288.0,1212.0
11.499,17,28,4395,14,2312,871.0,587.0,137.0,14,2083,871.0,270.0,120.0
0.005,6,13,3747,7,509,0.0,137.0,137.0,6,3238,1.0,1470.0,1459.0
15.081,17,14,7486,7,5316,2508.0,1350.0,731.0,7,2170,2508.0,1350.0,282.0
309.794,17,20,1124,10,716,34407.0,48.0,43.0,10,408,34407.0,20.0,12.0
0.004,17,2,148,1,60,0.0,32.0,32.0,1,88,0.0,60.0,60.0
0.005,6,10,1989,5,927,1.0,659.0,659.0,5,1062,1.0,794.0,794.0
0.006,6,10,1854,5,889,1.0,621.0,621.0,5,965,1.0,697.0,697.0
1787.758,6,150,19350,90,13740,20087.0,302.0,302.0,60,5610,30300.0,83.0,83.0
0.006,17,2,202,1,69,0.0,41.0,41.0,1,133,0.0,105.0,105.0
0.068,17,8,3613,4,1874,22.0,1350.0,440.0,4,1739,11.0,1350.0,406.0
0.072,6,10,1506,5,395,15.0,127.0,127.0,5,1111,15.0,843.0,843.0
0.014,6,10,1990,5,911,3.0,643.0,643.0,5,1079,3.0,811.0,811.0
0.005,6,10,2007,5,928,1.0,660.0,660.0,5,1079,1.0,811.0,811.0
0.015,6,10,1990,5,911,3.0,643.0,643.0,5,1079,3.0,811.0,811.0
0.001,17,2,136,1,60,0.0,32.0,32.0,1,76,0.0,48.0,48.0
0.066,17,8,3613,4,1874,22.0,1350.0,440.0,4,1739,11.0,1350.0,406.0
240.176,6,16,4480,9,963,30022.0,238.0,166.0,7,3517,40023.0,1402.0,786.0
0.121,6,10,1506,5,395,28.0,127.0,127.0,5,1111,28.0,843.0,843.0
0.017,6,10,1989,5,910,4.0,642.0,642.0,5,1079,4.0,811.0,811.0
0.004,6,10,2007,5,928,1.0,660.0,660.0,5,1079,1.0,811.0,811.0
369.434,6,22,2313,16,867,24628.0,195.0,195.0,6,1446,4644.0,419.0,398.0
0.006,6,10,2007,5,928,1.0,660.0,660.0,5,1079,1.0,811.0,811.0
0.004,6,10,1702,5,863,0.0,595.0,595.0,5,839,1.0,571.0,571.0
0.097,6,10,1506,5,395,21.0,127.0,127.0,5,1111,21.0,843.0,843.0
0.005,17,2,282,1,69,0.0,41.0,41.0,1,213,0.0,185.0,185.0
0.011,6,10,1989,5,910,2.0,642.0,642.0,5,1079,2.0,811.0,811.0
249.995,6,20,5390,10,2388,27773.0,676.0,372.0,10,3002,27773.0,1402.0,621.0
0.004,6,10,1989,5,927,1.0,659.0,659.0,5,1062,1.0,794.0,794.0
0.124,6,10,1506,5,395,28.0,127.0,127.0,5,1111,28.0,843.0,843.0
0.001,17,2,180,1,66,0.0,38.0,38.0,1,114,0.0,86.0,86.0
0.006,6,10,1547,5,764,1.0,496.0,496.0,5,783,1.0,515.0,515.0
0.005,6,10,1989,5,927,1.0,659.0,659.0,5,1062,1.0,794.0,794.0
0.006,17,2,187,1,71,0.0,43.0,43.0,1,116,0.0,88.0,88.0
0.022,6,10,1631,5,848,5.0,580.0,580.0,5,783,5.0,515.0,515.0
0.004,6,10,1989,5,927,1.0,659.0,659.0,5,1062,1.0,794.0,794.0
0.004,6,10,1774,5,923,1.0,655.0,655.0,5,851,0.0,583.0,583.0
0.005,17,2,140,1,62,0.0,34.0,34.0,1,78,0.0,50.0,50.0
0.005,6,10,1989,5,927,1.0,659.0,659.0,5,1062,1.0,794.0,794.0
0.078,6,10,1506,5,395,18.0,127.0,127.0,5,1111,18.0,843.0,843.0
0.078,6,10,1506,5,395,16.0,127.0,127.0,5,1111,16.0,843.0,843.0
15.076,17,15,9238,8,6902,2149.0,1350.0,834.0,7,2336,2507.0,1350.0,305.0
0.009,17,2,194,1,59,0.0,31.0,31.0,1,135,0.0,107.0,107.0
0.005,6,10,2007,5,928,1.0,660.0,660.0,5,1079,1.0,811.0,811.0
0.015,6,10,1990,5,911,3.0,643.0,643.0,5,1079,3.0,811.0,811.0
0.005,6,14,3742,7,452,0.0,80.0,80.0,7,3290,0.0,1448.0,972.0
0.106,6,10,1506,5,395,25.0,127.0,127.0,5,1111,25.0,843.0,843.0
0.095,6,10,1506,5,395,21.0,127.0,127.0,5,1111,21.0,843.0,843.0
0.006,17,2,166,1,75,0.0,47.0,47.0,1,91,0.0,63.0,63.0
0.04,17,2,186,1,61,0.0,33.0,33.0,1,125,0.0,97.0,97.0
0.004,6,10,2007,5,928,1.0,660.0,660.0,5,1079,1.0,811.0,811.0
0.012,6,10,1972,5,910,2.0,642.0,642.0,5,1062,2.0,794.0,794.0
0.072,17,2,412,1,61,0.0,33.0,33.0,1,351,0.0,323.0,323.0
0.003,17,2,152,1,76,0.0,48.0,48.0,1,76,0.0,48.0,48.0
0.067,6,10,1506,5,395,15.0,127.0,127.0,5,1111,14.0,843.0,843.0
0.088,6,10,1506,5,395,19.0,127.0,127.0,5,1111,18.0,843.0,843.0
0.005,6,10,1643,5,860,1.0,592.0,592.0,5,783,1.0,515.0,515.0
0.005,17,2,214,1,75,0.0,47.0,47.0,1,139,0.0,111.0,111.0
0.005,6,10,1689,5,839,1.0,571.0,571.0,5,850,1.0,582.0,582.0
0.005,6,10,2006,5,927,1.0,659.0,659.0,5,1079,1.0,811.0,811.0
0.008,6,10,1990,5,911,2.0,643.0,643.0,5,1079,2.0,811.0,811.0
0.06,17,2,152,1,76,0.0,48.0,48.0,1,76,0.0,48.0,48.0
0.005,6,10,2006,5,927,1.0,659.0,659.0,5,1079,1.0,811.0,811.0
0.006,17,2,132,1,58,0.0,30.0,30.0,1,74,0.0,46.0,46.0
0.008,6,10,1990,5,911,1.0,643.0,643.0,5,1079,1.0,811.0,811.0
11.118,17,28,4422,14,1994,842.0,269.0,114.0,14,2428,842.0,587.0,145.0
0.004,6,10,1989,5,927,1.0,659.0,659.0,5,1062,1.0,794.0,794.0
0.043,17,2,148,1,60,0.0,32.0,32.0,1,88,0.0,60.0,60.0
0.005,6,10,1779,5,928,1.0,660.0,660.0,5,851,1.0,583.0,583.0
0.011,6,10,1989,5,910,2.0,642.0,642.0,5,1079,2.0,811.0,811.0
0.006,6,10,2006,5,927,1.0,659.0,659.0,5,1079,1.0,811.0,811.0
0.007,17,2,179,1,71,0.0,43.0,43.0,1,108,0.0,80.0,80.0
0.057,6,10,1506,5,395,13.0,127.0,127.0,5,1111,12.0,843.0,843.0
0.066,6,10,1506,5,395,14.0,127.0,127.0,5,1111,15.0,843.0,843.0
144.669,6,58,22711,30,13678,734.0,1360.0,1035.0,28,9033,5351.0,2720.0,438.0
0.006,6,10,1547,5,764,1.0,496.0,496.0,5,783,1.0,515.0,515.0
0.014,6,10,1990,5,911,3.0,643.0,643.0,5,1079,3.0,811.0,811.0
0.006,6,10,1774,5,923,1.0,655.0,655.0,5,851,1.0,583.0,583.0
0.068,6,10,1506,5,395,16.0,127.0,127.0,5,1111,15.0,843.0,843.0
0.011,6,10,1989,5,910,2.0,642.0,642.0,5,1079,2.0,811.0,811.0
0.005,6,10,2007,5,928,1.0,660.0,660.0,5,1079,1.0,811.0,811.0
240.523,6,37,14788,18,8082,14148.0,2185.0,1019.0,19,6706,13362.0,1656.0,634.0
0.021,17,2,152,1,56,0.0,28.0,28.0,1,96,0.0,68.0,68.0
0.077,6,10,1506,5,395,17.0,127.0,127.0,5,1111,14.0,843.0,843.0
0.013,6,10,1989,5,910,3.0,642.0,642.0,5,1079,3.0,811.0,811.0
0.077,6,10,1506,5,395,18.0,127.0,127.0,5,1111,16.0,843.0,843.0
0.027,6,10,1990,5,911,6.0,643.0,643.0,5,1079,6.0,811.0,811.0
0.015,6,10,1677,5,827,3.0,559.0,559.0,5,850,3.0,582.0,582.0
0.006,6,10,1643,5,860,1.0,592.0,592.0,5,783,1.0,515.0,515.0
0.001,17,2,140,1,62,0.0,34.0,34.0,1,78,0.0,50.0,50.0
0.005,6,10,1989,5,927,1.0,659.0,659.0,5,1062,1.0,794.0,794.0
0.121,6,10,1506,5,395,26.0,127.0,127.0,5,1111,26.0,843.0,843.0
10.814,17,28,4423,14,1994,823.0,269.0,114.0,14,2429,823.0,588.0,145.0
0.005,6,10,1689,5,839,1.0,571.0,571.0,5,850,1.0,582.0,582.0
0.001,17,2,174,1,72,0.0,44.0,44.0,1,102,0.0,74.0,74.0
0.008,17,2,194,1,59,0.0,31.0,31.0,1,135,0.0,107.0,107.0
0.005,6,10,1547,5,764,1.0,496.0,496.0,5,783,1.0,515.0,515.0
0.005,17,2,178,1,65,0.0,37.0,37.0,1,113,0.0,85.0,85.0
0.005,6,10,1989,5,927,1.0,659.0,659.0,5,1062,1.0,794.0,794.0
0.005,17,2,170,1,65,0.0,37.0,37.0,1,105,0.0,77.0,77.0
0.006,6,10,1547,5,764,1.0,496.0,496.0,5,783,1.0,515.0,515.0
0.012,6,10,1972,5,910,2.0,642.0,642.0,5,1062,3.0,794.0,794.0
0.005,6,10,1989,5,927,1.0,659.0,659.0,5,1062,1.0,794.0,794.0
0.006,6,13,3690,7,452,1.0,80.0,80.0,6,3238,1.0,1470.0,1459.0
243.235,6,310,344319,124,17952,1977.0,2736.0,959.0,186,326367,1314.0,3053.0,1799.0
0.004,6,13,3747,7,509,0.0,137.0,137.0,6,3238,0.0,1470.0,1459.0
0.006,17,2,170,1,65,0.0,37.0,37.0,1,105,0.0,77.0,77.0
308.432,17,20,1124,10,716,34255.0,48.0,43.0,10,408,34255.0,20.0,12.0
15.213,17,39,20262,21,17038,759.0,1350.0,783.0,18,3224,893.0,1350.0,151.0
0.175,17,2,152,1,76,0.0,48.0,48.0,1,76,0.0,48.0,48.0
0.004,6,10,2007,5,928,1.0,660.0,660.0,5,1079,1.0,811.0,811.0
0.014,6,10,1989,5,910,3.0,642.0,642.0,5,1079,3.0,811.0,811.0
40.064,17,10,676,5,460,10012.0,104.0,64.0,5,216,10015.0,20.0,15.0
0.008,6,10,2006,5,927,2.0,659.0,659.0,5,1079,2.0,811.0,811.0
0.004,6,10,2000,5,927,1.0,659.0,659.0,5,1073,1.0,805.0,805.0
0.213,6,16,2777,8,1395,30.0,533.0,323.0,8,1382,19.0,529.0,239.0
0.005,6,10,2007,5,928,1.0,660.0,660.0,5,1079,1.0,811.0,811.0
0.005,17,2,164,1,74,0.0,46.0,46.0,1,90,0.0,62.0,62.0
0.013,6,10,1972,5,910,3.0,642.0,642.0,5,1062,3.0,794.0,794.0
0.14,6,10,1506,5,395,33.0,127.0,127.0,5,1111,31.0,843.0,843.0
0.079,6,10,1506,5,395,16.0,127.0,127.0,5,1111,18.0,843.0,843.0
0.012,6,10,1989,5,910,2.0,642.0,642.0,5,1079,3.0,811.0,811.0
0.005,6,10,1989,5,927,1.0,659.0,659.0,5,1062,1.0,794.0,794.0
0.094,6,10,1506,5,395,20.0,127.0,127.0,5,1111,21.0,843.0,843.0
240.089,6,19,4912,9,2210,30011.0,1007.0,582.0,10,2702,26676.0,1162.0,434.0
0.011,17,2,148,1,60,0.0,32.0,32.0,1,88,0.0,60.0,60.0
0.009,6,10,1989,5,910,2.0,642.0,642.0,5,1079,2.0,811.0,811.0
0.003,17,4,284,2,120,0.0,32.0,32.0,2,164,0.0,60.0,54.0
0.007,6,10,1989,5,927,1.0,659.0,659.0,5,1062,1.0,794.0,794.0
0.004,6,10,2006,5,927,1.0,659.0,659.0,5,1079,1.0,811.0,811.0
0.005,6,10,2000,5,927,1.0,659.0,659.0,5,1073,1.0,805.0,805.0
0.001,17,2,180,1,66,0.0,38.0,38.0,1,114,0.0,86.0,86.0
0.066,6,10,1506,5,395,13.0,127.0,127.0,5,1111,13.0,843.0,843.0
0.02,6,10,1989,5,910,5.0,642.0,642.0,5,1079,5.0,811.0,811.0
0.04,17,2,136,1,60,0.0,32.0,32.0,1,76,0.0,48.0,48.0
0.014,6,10,1989,5,910,3.0,642.0,642.0,5,1079,3.0,811.0,811.0
0.009,6,10,1972,5,910,2.0,642.0,642.0,5,1062,2.0,794.0,794.0
10.94,17,28,4422,14,1994,833.0,269.0,114.0,14,2428,833.0,587.0,145.0
0.004,6,10,1702,5,863,1.0,595.0,595.0,5,839,1.0,571.0,571.0
0.096,6,10,1506,5,395,21.0,127.0,127.0,5,1111,20.0,843.0,843.0
310.081,17,20,1124,10,716,34438.0,48.0,43.0,10,408,34438.0,20.0,12.0
0.015,6,10,1983,5,910,3.0,642.0,642.0,5,1073,3.0,805.0,805.0
0.005,17,2,154,1,69,0.0,41.0,41.0,1,85,0.0,57.0,57.0
40.061,17,10,676,5,460,10013.0,104.0,64.0,5,216,10014.0,20.0,15.0
0.122,6,10,1506,5,395,24.0,127.0,127.0,5,1111,24.0,843.0,843.0
0.101,6,10,1506,5,395,19.0,127.0,127.0,5,1111,23.0,843.0,843.0
0.003,17,2,136,1,60,0.0,32.0,32.0,1,76,0.0,48.0,48.0
0.005,6,10,2007,5,928,1.0,660.0,660.0,5,1079,1.0,811.0,811.0
0.004,6,10,1774,5,923,1.0,655.0,655.0,5,851,1.0,583.0,583.0
0.009,6,10,1990,5,911,2.0,643.0,643.0,5,1079,2.0,811.0,811.0
240.095,6,32,9687,16,7107,16006.0,2181.0,697.0,16,2580,16006.0,580.0,217.0
0.005,6,10,2007,5,928,1.0,660.0,660.0,5,1079,1.0,811.0,811.0
0.005,6,10,2007,5,928,1.0,660.0,660.0,5,1079,1.0,811.0,811.0
0.005,6,10,2006,5,927,1.0,659.0,659.0,5,1079,1.0,811.0,811.0
0.085,6,10,1506,5,395,20.0,127.0,127.0,5,1111,20.0,843.0,843.0
0.015,6,10,1983,5,910,3.0,642.0,642.0,5,1073,3.0,805.0,805.0
0.086,6,10,1506,5,395,17.0,127.0,127.0,5,1111,19.0,843.0,843.0
0.004,6,10,1989,5,927,1.0,659.0,659.0,5,1062,1.0,794.0,794.0
40.068,17,10,676,5,460,10014.0,104.0,64.0,5,216,10016.0,20.0,15.0
78.717,6,22,9233,11,1575,76.0,794.0,367.0,11,7658,7857.0,1360.0,1029.0
0.087,6,10,1506,5,395,18.0,127.0,127.0,5,1111,21.0,843.0,843.0
0.015,6,10,1989,5,910,3.0,642.0,642.0,5,1079,3.0,811.0,811.0
0.014,6,10,1989,5,910,3.0,642.0,642.0,5,1079,3.0,811.0,811.0
0.02,6,10,1989,5,910,5.0,642.0,642.0,5,1079,5.0,811.0,811.0
0.004,6,10,1989,5,927,1.0,659.0,659.0,5,1062,1.0,794.0,794.0
40.05,17,10,676,5,460,10011.0,104.0,64.0,5,216,10011.0,20.0,15.0
0.003,17,2,185,1,73,0.0,45.0,45.0,1,112,0.0,84.0,84.0
0.005,6,10,2006,5,927,1.0,659.0,659.0,5,1079,1.0,811.0,811.0
0.086,6,10,1506,5,395,19.0,127.0,127.0,5,1111,20.0,843.0,843.0
0.012,6,10,1972,5,910,3.0,642.0,642.0,5,1062,3.0,794.0,794.0
0.006,6,10,1643,5,860,1.0,592.0,592.0,5,783,1.0,515.0,515.0
0.009,17,2,136,1,60,0.0,32.0,32.0,1,76,0.0,48.0,48.0
0.001,17,2,180,1,66,0.0,38.0,38.0,1,114,0.0,86.0,86.0
0.035,17,2,152,1,76,0.0,48.0,48.0,1,76,0.0,48.0,48.0
0.006,6,10,2000,5,927,1.0,659.0,659.0,5,1073,1.0,805.0,805.0
0.006,6,10,2006,5,927,1.0,659.0,659.0,5,1079,1.0,811.0,811.0
0.004,6,10,1702,5,863,1.0,595.0,595.0,5,839,0.0,571.0,571.0
0.027,6,10,1989,5,910,6.0,642.0,642.0,5,1079,6.0,811.0,811.0
0.006,6,10,1689,5,839,1.0,571.0,571.0,5,850,1.0,582.0,582.0
0.01,6,10,1990,5,911,2.0,643.0,643.0,5,1079,2.0,811.0,811.0
10.981,17,29,4565,15,2165,776.0,268.0,116.0,14,2400,836.0,587.0,143.0
0.004,6,10,2007,5,928,1.0,660.0,660.0,5,1079,1.0,811.0,811.0
0.136,6,10,1506,5,395,30.0,127.0,127.0,5,1111,32.0,843.0,843.0
240.094,6,31,9601,15,7174,17149.0,2298.0,710.0,16,2427,16006.0,580.0,198.0
0.093,6,10,1506,5,395,20.0,127.0,127.0,5,1111,22.0,843.0,843.0
0.014,6,10,1989,5,910,3.0,642.0,642.0,5,1079,3.0,811.0,811.0
0.006,6,10,1547,5,764,1.0,496.0,496.0,5,783,1.0,515.0,515.0
0.005,6,10,1989,5,927,1.0,659.0,659.0,5,1062,1.0,794.0,794.0
0.012,6,10,1972,5,910,2.0,642.0,642.0,5,1062,3.0,794.0,794.0
1.086,6,32,13392,18,5893,63.0,2720.0,854.0,14,7499,70.0,2720.0,769.0
0.007,6,10,1989,5,927,1.0,659.0,659.0,5,1062,1.0,794.0,794.0
0.005,6,10,2006,5,927,1.0,659.0,659.0,5,1079,1.0,811.0,811.0
0.012,6,10,1989,5,910,3.0,642.0,642.0,5,1079,2.0,811.0,811.0
15.072,17,14,9190,8,6902,2149.0,1350.0,834.0,6,2288,3008.0,1350.0,353.0
0.012,6,10,1990,5,911,2.0,643.0,643.0,5,1079,2.0,811.0,811.0
0.006,6,10,2006,5,927,1.0,659.0,659.0,5,1079,1.0,811.0,811.0
0.012,6,10,1631,5,848,2.0,580.0,580.0,5,783,3.0,515.0,515.0
314.469,17,20,1124,10,716,34926.0,48.0,43.0,10,408,34926.0,20.0,12.0
0.005,6,10,2006,5,927,1.0,659.0,659.0,5,1079,1.0,811.0,811.0
0.008,6,10,1677,5,827,2.0,559.0,559.0,5,850,2.0,582.0,582.0
0.011,6,10,1972,5,910,2.0,642.0,642.0,5,1062,2.0,794.0,794.0
308.385,17,20,1124,10,716,34255.0,48.0,43.0,10,408,34251.0,20.0,12.0
0.029,6,10,1989,5,910,7.0,642.0,642.0,5,1079,7.0,811.0,811.0
0.095,6,10,1506,5,395,19.0,127.0,127.0,5,1111,21.0,843.0,843.0
0.008,6,7,695,4,448,2.0,232.0,232.0,3,247,2.0,83.0,83.0
0.004,6,10,2007,5,928,1.0,660.0,660.0,5,1079,1.0,811.0,811.0
0.17,6,10,1506,5,395,38.0,127.0,127.0,5,1111,38.0,843.0,843.0
0.011,6,10,1989,5,910,2.0,642.0,642.0,5,1079,2.0,811.0,811.0
0.007,6,10,1989,5,910,1.0,642.0,642.0,5,1079,1.0,811.0,811.0
0.005,6,10,1774,5,923,1.0,655.0,655.0,5,851,1.0,583.0,583.0
0.006,17,2,193,1,71,0.0,43.0,43.0,1,122,0.0,94.0,94.0
0.011,6,13,3735,7,497,1.0,125.0,125.0,6,3238,2.0,1470.0,1459.0
0.006,6,10,1547,5,764,1.0,496.0,496.0,5,783,1.0,515.0,515.0
0.005,6,14,3799,7,509,0.0,137.0,137.0,7,3290,0.0,1448.0,972.0
0.007,17,2,144,1,64,0.0,36.0,36.0,1,80,0.0,52.0,52.0
0.005,6,10,1774,5,923,1.0,655.0,655.0,5,851,1.0,583.0,583.0
0.013,6,13,3735,7,497,2.0,125.0,125.0,6,3238,2.0,1470.0,1459.0
240.078,6,19,4899,9,2229,30009.0,1026.0,588.0,10,2670,26675.0,1162.0,428.0
0.013,6,10,1983,5,910,3.0,642.0,642.0,5,1073,3.0,805.0,805.0
0.082,6,10,1506,5,395,18.0,127.0,127.0,5,1111,17.0,843.0,843.0
15.076,17,11,4686,5,2266,3761.0,1350.0,425.0,6,2420,3008.0,1350.0,375.0
0.007,17,2,144,1,64,0.0,36.0,36.0,1,80,0.0,52.0,52.0
0.003,17,2,136,1,60,0.0,32.0,32.0,1,76,0.0,48.0,48.0
0.07,6,10,1506,5,395,14.0,127.0,127.0,5,1111,15.0,843.0,843.0
0.006,17,2,230,1,68,0.0,40.0,40.0,1,162,0.0,134.0,134.0
0.101,6,10,1506,5,395,22.0,127.0,127.0,5,1111,21.0,843.0,843.0
0.024,6,10,1972,5,910,5.0,642.0,642.0,5,1062,6.0,794.0,794.0
0.008,6,10,1989,5,910,2.0,642.0,642.0,5,1079,2.0,811.0,811.0
0.007,17,2,179,1,71,0.0,43.0,43.0,1,108,0.0,80.0,80.0
0.104,6,10,1506,5,395,22.0,127.0,127.0,5,1111,21.0,843.0,843.0
354.05,6,21,1795,16,1030,23603.0,190.0,190.0,5,765,60004.0,464.0,248.0
0.167,6,10,1506,5,395,38.0,127.0,127.0,5,1111,40.0,843.0,843.0
0.011,6,10,1989,5,910,2.0,642.0,642.0,5,1079,2.0,811.0,811.0
0.012,6,10,1605,5,388,3.0,120.0,120.0,5,1217,2.0,949.0,949.0
40.06,17,10,676,5,460,10014.0,104.0,64.0,5,216,10014.0,20.0,15.0
0.005,6,10,2000,5,927,1.0,659.0,659.0,5,1073,1.0,805.0,805.0
0.001,17,2,180,1,66,0.0,38.0,38.0,1,114,0.0,86.0,86.0
0.108,6,10,1506,5,395,26.0,127.0,127.0,5,1111,26.0,843.0,843.0
0.085,6,10,1506,5,395,16.0,127.0,127.0,5,1111,18.0,843.0,843.0
0.237,6,45,11623,24,3253,10.0,1022.0,182.0,21,8370,11.0,1402.0,659.0
0.019,6,10,1990,5,911,4.0,643.0,643.0,5,1079,4.0,811.0,811.0
0.005,6,10,2007,5,928,1.0,660.0,660.0,5,1079,1.0,811.0,811.0
40.054,17,10,676,5,460,10012.0,104.0,64.0,5,216,10011.0,20.0,15.0
354.078,6,21,1795,16,1030,23605.0,190.0,190.0,5,765,60003.0,464.0,248.0
40.058,17,10,676,5,460,10013.0,104.0,64.0,5,216,10009.0,20.0,15.0
301.407,6,31,10086,17,2837,18837.0,801.0,389.0,14,7249,18566.0,1402.0,814.0
0.024,6,10,1677,5,827,5.0,559.0,559.0,5,850,6.0,582.0,582.0
0.196,17,2,142,1,63,0.0,35.0,35.0,1,79,0.0,51.0,51.0
0.008,6,10,1989,5,910,2.0,642.0,642.0,5,1079,2.0,811.0,811.0
40.056,17,10,676,5,460,10013.0,104.0,64.0,5,216,10013.0,20.0,15.0
0.005,6,10,1989,5,927,1.0,659.0,659.0,5,1062,1.0,794.0,794.0
0.019,17,2,136,1,60,0.0,32.0,32.0,1,76,0.0,48.0,48.0
0.005,6,10,1854,5,889,1.0,621.0,621.0,5,965,1.0,697.0,697.0
40.063,17,10,676,5,460,10013.0,104.0,64.0,5,216,10014.0,20.0,15.0
294.398,6,403,349033,191,21496,1549.0,2736.0,888.0,212,327537,1395.0,2804.0,1606.0
0.009,6,10,1972,5,910,2.0,642.0,642.0,5,1062,2.0,794.0,794.0
0.005,17,2,166,1,75,0.0,47.0,47.0,1,91,0.0,63.0,63.0
0.003,17,2,136,1,60,0.0,32.0,32.0,1,76,0.0,48.0,48.0
0.003,17,2,148,1,60,0.0,32.0,32.0,1,88,0.0,60.0,60.0
0.006,6,10,1547,5,764,1.0,496.0,496.0,5,783,1.0,515.0,515.0
0.12,6,10,1506,5,395,24.0,127.0,127.0,5,1111,28.0,843.0,843.0
0.014,6,10,1631,5,848,3.0,580.0,580.0,5,783,3.0,515.0,515.0
0.006,6,10,1547,5,764,1.0,496.0,496.0,5,783,1.0,515.0,515.0
240.252,6,141,119871,63,4551,3875.0,517.0,207.0,78,115320,3120.0,4206.0,1685.0
0.102,6,10,1506,5,395,22.0,127.0,127.0,5,1111,23.0,843.0,843.0
0.018,6,10,1990,5,911,4.0,643.0,643.0,5,1079,4.0,811.0,811.0
0.023,6,13,3735,7,497,3.0,125.0,125.0,6,3238,4.0,1470.0,1459.0
0.017,6,10,1631,5,848,4.0,580.0,580.0,5,783,4.0,515.0,515.0
0.006,6,10,1689,5,839,1.0,571.0,571.0,5,850,1.0,582.0,582.0
0.005,6,10,1689,5,839,1.0,571.0,571.0,5,850,1.0,582.0,582.0
0.006,6,10,1547,5,764,1.0,496.0,496.0,5,783,1.0,515.0,515.0
0.115,6,10,1506,5,395,23.0,127.0,127.0,5,1111,21.0,843.0,843.0
0.011,6,10,1972,5,910,2.0,642.0,642.0,5,1062,2.0,794.0,794.0
0.014,6,10,1983,5,910,3.0,642.0,642.0,5,1073,3.0,805.0,805.0
0.015,17,2,198,1,91,0.0,63.0,63.0,1,107,0.0,79.0,79.0
0.006,6,10,1854,5,889,1.0,621.0,621.0,5,965,1.0,697.0,697.0
0.075,6,10,1506,5,395,16.0,127.0,127.0,5,1111,17.0,843.0,843.0
0.01,6,10,2006,5,927,2.0,659.0,659.0,5,1079,2.0,811.0,811.0
308.276,17,20,1124,10,716,34240.0,48.0,43.0,10,408,34238.0,20.0,12.0
0.013,6,10,1989,5,910,3.0,642.0,642.0,5,1079,3.0,811.0,811.0
0.004,6,10,1702,5,863,1.0,595.0,595.0,5,839,1.0,571.0,571.0
0.005,6,10,2006,5,927,1.0,659.0,659.0,5,1079,1.0,811.0,811.0
0.005,6,10,2000,5,927,1.0,659.0,659.0,5,1073,1.0,805.0,805.0
0.006,17,2,230,1,68,0.0,40.0,40.0,1,162,0.0,134.0,134.0
240.426,6,43,8771,22,5738,11448.0,2883.0,573.0,21,3033,12020.0,580.0,241.0
0.014,6,12,1698,6,863,2.0,327.0,271.0,6,835,2.0,515.0,515.0
0.008,6,10,1972,5,910,2.0,642.0,642.0,5,1062,2.0,794.0,794.0
0.013,6,10,1983,5,910,3.0,642.0,642.0,5,1073,3.0,805.0,805.0
0.006,17,2,170,1,65,0.0,37.0,37.0,1,105,0.0,77.0,77.0
0.005,17,2,166,1,75,0.0,47.0,47.0,1,91,0.0,63.0,63.0
0.004,17,2,184,1,61,0.0,33.0,33.0,1,123,0.0,95.0,95.0
0.229,6,16,2777,8,1395,32.0,533.0,323.0,8,1382,20.0,529.0,239.0
0.005,6,10,2007,5,928,1.0,660.0,660.0,5,1079,1.0,811.0,811.0
0.008,6,10,2007,5,928,2.0,660.0,660.0,5,1079,1.0,811.0,811.0
0.001,17,2,180,1,66,0.0,38.0,38.0,1,114,0.0,86.0,86.0
0.006,6,10,1547,5,764,1.0,496.0,496.0,5,783,1.0,515.0,515.0
310.994,6,24,6094,13,2336,25916.0,585.0,330.0,11,3758,25098.0,1402.0,635.0
0.005,17,2,152,1,68,0.0,40.0,40.0,1,84,0.0,56.0,56.0
0.115,6,10,1506,5,395,25.0,127.0,127.0,5,1111,26.0,843.0,843.0
0.109,6,10,1506,5,395,24.0,127.0,127.0,5,1111,20.0,843.0,843.0
0.089,6,10,1506,5,395,20.0,127.0,127.0,5,1111,17.0,843.0,843.0
0.005,6,14,3736,7,446,0.0,74.0,74.0,7,3290,0.0,1448.0,972.0
0.009,6,12,1926,6,1189,1.0,659.0,434.0,6,737,1.0,417.0,417.0
0.008,6,10,1983,5,910,2.0,642.0,642.0,5,1073,2.0,805.0,805.0
172.077,17,74,10508,37,2466,4779.0,44.0,38.0,37,8042,4779.0,239.0,189.0
0.011,6,10,1972,5,910,2.0,642.0,642.0,5,1062,2.0,794.0,794.0
0.145,6,10,1506,5,395,32.0,127.0,127.0,5,1111,33.0,843.0,843.0
0.001,17,2,166,1,75,0.0,47.0,47.0,1,91,0.0,63.0,63.0
0.018,6,10,1972,5,910,4.0,642.0,642.0,5,1062,4.0,794.0,794.0
0.018,6,10,1990,5,911,4.0,643.0,643.0,5,1079,4.0,811.0,811.0
0.014,6,10,1631,5,848,3.0,580.0,580.0,5,783,3.0,515.0,515.0
0.006,6,10,1689,5,839,1.0,571.0,571.0,5,850,1.0,582.0,582.0
10.99,17,28,4398,14,2313,836.0,588.0,137.0,14,2085,836.0,268.0,120.0
0.079,6,10,1506,5,395,17.0,127.0,127.0,5,1111,18.0,843.0,843.0
0.017,6,10,1972,5,910,4.0,642.0,642.0,5,1062,4.0,794.0,794.0
0.001,17,2,180,1,66,0.0,38.0,38.0,1,114,0.0,86.0,86.0
0.007,6,10,2006,5,927,1.0,659.0,659.0,5,1079,1.0,811.0,811.0
0.006,6,10,1989,5,927,1.0,659.0,659.0,5,1062,1.0,794.0,794.0
0.005,17,2,144,1,64,0.0,36.0,36.0,1,80,0.0,52.0,52.0
0.115,6,10,1506,5,395,25.0,127.0,127.0,5,1111,27.0,843.0,843.0
0.095,6,10,1506,5,395,21.0,127.0,127.0,5,1111,22.0,843.0,843.0
0.006,6,10,1774,5,923,1.0,655.0,655.0,5,851,1.0,583.0,583.0
0.006,17,2,194,1,59,0.0,31.0,31.0,1,135,0.0,107.0,107.0
240.011,6,9,787,5,488,60002.0,232.0,232.0,4,299,80002.0,83.0,83.0
0.001,17,2,180,1,66,0.0,38.0,38.0,1,114,0.0,86.0,86.0
40.065,17,10,676,5,460,10015.0,104.0,64.0,5,216,10015.0,20.0,15.0
0.005,6,10,1989,5,927,1.0,659.0,659.0,5,1062,1.0,794.0,794.0
0.008,6,10,1990,5,911,2.0,643.0,643.0,5,1079,2.0,811.0,811.0
10.856,17,26,4100,13,1845,895.0,268.0,113.0,13,2255,895.0,586.0,145.0
0.005,17,2,158,1,63,0.0,35.0,35.0,1,95,0.0,67.0,67.0
0.001,17,2,136,1,60,0.0,32.0,32.0,1,76,0.0,48.0,48.0
0.039,17,2,186,1,61,0.0,33.0,33.0,1,125,0.0,97.0,97.0
647.145,6,79,5368,30,2304,22315.0,46.0,46.0,49,3064,13479.0,46.0,46.0
0.005,6,10,1989,5,927,1.0,659.0,659.0,5,1062,1.0,794.0,794.0
0.012,6,10,1989,5,910,3.0,642.0,642.0,5,1079,3.0,811.0,811.0
0.014,6,10,1762,5,911,3.0,643.0,643.0,5,851,3.0,583.0,583.0
300.397,6,16,2170,9,684,37527.0,146.0,146.0,7,1486,50037.0,419.0,398.0
0.009,6,10,1631,5,848,2.0,580.0,580.0,5,783,2.0,515.0,515.0
308.589,17,20,1124,10,716,34281.0,48.0,43.0,10,408,34281.0,20.0,12.0
40.064,17,10,676,5,460,10014.0,104.0,64.0,5,216,10015.0,20.0,15.0
0.01,6,10,1762,5,911,2.0,643.0,643.0,5,851,2.0,583.0,583.0
0.005,6,10,2007,5,928,1.0,660.0,660.0,5,1079,1.0,811.0,811.0
0.003,17,2,148,1,60,0.0,32.0,32.0,1,88,0.0,60.0,60.0
0.006,17,2,170,1,65,0.0,37.0,37.0,1,105,0.0,77.0,77.0
0.004,6,10,1989,5,927,1.0,659.0,659.0,5,1062,1.0,794.0,794.0
0.008,6,10,1989,5,910,2.0,642.0,642.0,5,1079,2.0,811.0,811.0
0.02,6,10,1972,5,910,4.0,642.0,642.0,5,1062,5.0,794.0,794.0
0.003,17,2,148,1,60,0.0,32.0,32.0,1,88,0.0,60.0,60.0
0.001,17,2,180,1,66,0.0,38.0,38.0,1,114,0.0,86.0,86.0
0.082,6,10,1506,5,395,19.0,127.0,127.0,5,1111,19.0,843.0,843.0
0.038,17,2,136,1,60,0.0,32.0,32.0,1,76,0.0,48.0,48.0
0.004,17,2,140,1,62,0.0,34.0,34.0,1,78,0.0,50.0,50.0
0.004,6,10,2006,5,927,1.0,659.0,659.0,5,1079,1.0,811.0,811.0
241.639,6,379,347938,180,20889,1349.0,2736.0,960.0,199,327049,1220.0,2914.0,1675.0
0.023,6,10,1983,5,910,5.0,642.0,642.0,5,1073,5.0,805.0,805.0
0.005,6,10,2007,5,928,1.0,660.0,660.0,5,1079,1.0,811.0,811.0
0.142,6,10,1506,5,395,33.0,127.0,127.0,5,1111,33.0,843.0,843.0
0.004,17,2,136,1,60,0.0,32.0,32.0,1,76,0.0,48.0,48.0
0.005,6,10,2006,5,927,1.0,659.0,659.0,5,1079,1.0,811.0,811.0
1756.066,6,105,6270,60,3525,29763.0,27.0,27.0,45,2745,39909.0,27.0,27.0
0.008,6,10,1972,5,910,2.0,642.0,642.0,5,1062,1.0,794.0,794.0
0.004,6,13,3690,7,452,0.0,80.0,80.0,6,3238,0.0,1470.0,1459.0
0.003,17,2,148,1,60,0.0,32.0,32.0,1,88,0.0,60.0,60.0
0.015,6,10,1989,5,910,3.0,642.0,642.0,5,1079,3.0,811.0,811.0
0.004,6,10,2006,5,927,1.0,659.0,659.0,5,1079,1.0,811.0,811.0
0.089,6,10,1506,5,395,18.0,127.0,127.0,5,1111,20.0,843.0,843.0
0.064,6,10,1506,5,395,15.0,127.0,127.0,5,1111,14.0,843.0,843.0
40.056,17,10,676,5,460,10013.0,104.0,64.0,5,216,10013.0,20.0,15.0
0.04,17,2,148,1,60,0.0,32.0,32.0,1,88,0.0,60.0,60.0
0.004,6,10,2007,5,928,1.0,660.0,660.0,5,1079,1.0,811.0,811.0
0.004,17,2,140,1,62,0.0,34.0,34.0,1,78,0.0,50.0,50.0
0.005,6,10,2000,5,927,1.0,659.0,659.0,5,1073,1.0,805.0,805.0
241.432,6,444,350200,209,22374,1160.0,2736.0,885.0,235,327826,1031.0,2804.0,1402.0
0.008,6,10,1972,5,910,2.0,642.0,642.0,5,1062,2.0,794.0,794.0
0.066,6,10,1506,5,395,16.0,127.0,127.0,5,1111,13.0,843.0,843.0
0.004,17,2,132,1,58,0.0,30.0,30.0,1,74,0.0,46.0,46.0
0.007,17,2,136,1,60,0.0,32.0,32.0,1,76,0.0,48.0,48.0
40.115,17,10,676,5,460,10028.0,104.0,64.0,5,216,10027.0,20.0,15.0
0.004,6,10,1989,5,927,1.0,659.0,659.0,5,1062,1.0,794.0,794.0
0.213,17,2,80,1,32,0.0,4.0,4.0,1,48,0.0,20.0,20.0
0.006,6,10,1547,5,764,1.0,496.0,496.0,5,783,1.0,515.0,515.0
0.009,6,10,1989,5,910,2.0,642.0,642.0,5,1079,2.0,811.0,811.0
0.028,6,10,1762,5,911,6.0,643.0,643.0,5,851,7.0,583.0,583.0
0.129,17,2,80,1,32,0.0,4.0,4.0,1,48,0.0,20.0,20.0
0.008,6,10,1689,5,839,1.0,571.0,571.0,5,850,1.0,582.0,582.0
0.008,6,10,1990,5,911,2.0,643.0,643.0,5,1079,2.0,811.0,811.0
240.277,6,40,5308,19,2371,13348.0,588.0,196.0,21,2937,12013.0,580.0,229.0
0.095,6,10,1506,5,395,20.0,127.0,127.0,5,1111,21.0,843.0,843.0
10.924,17,28,4422,14,1995,831.0,270.0,114.0,14,2427,831.0,586.0,145.0
0.011,6,10,1989,5,910,2.0,642.0,642.0,5,1079,2.0,811.0,811.0
0.013,17,2,152,1,56,0.0,28.0,28.0,1,96,0.0,68.0,68.0
0.005,6,10,2006,5,927,1.0,659.0,659.0,5,1079,1.0,811.0,811.0
0.16,17,2,152,1,76,0.0,48.0,48.0,1,76,0.0,48.0,48.0
0.017,6,10,1983,5,910,4.0,642.0,642.0,5,1073,4.0,805.0,805.0
0.088,6,10,1506,5,395,20.0,127.0,127.0,5,1111,19.0,843.0,843.0
0.076,6,10,1506,5,395,17.0,127.0,127.0,5,1111,16.0,843.0,843.0
0.007,6,10,1972,5,910,1.0,642.0,642.0,5,1062,1.0,794.0,794.0
0.005,6,10,2007,5,928,1.0,660.0,660.0,5,1079,1.0,811.0,811.0
0.31,17,38,20252,21,17035,15.0,1350.0,783.0,17,3217,15.0,1350.0,161.0
0.001,17,2,166,1,75,0.0,47.0,47.0,1,91,0.0,63.0,63.0
0.062,6,10,1506,5,395,13.0,127.0,127.0,5,1111,12.0,843.0,843.0
0.015,6,10,1989,5,910,3.0,642.0,642.0,5,1079,3.0,811.0,811.0
308.79,17,20,1124,10,716,34295.0,48.0,43.0,10,408,34295.0,20.0,12.0
0.006,6,10,1547,5,764,1.0,496.0,496.0,5,783,1.0,515.0,515.0
0.006,17,2,294,1,64,0.0,36.0,36.0,1,230,0.0,202.0,202.0
0.007,6,10,2006,5,927,1.0,659.0,659.0,5,1079,1.0,811.0,811.0
40.061,17,10,676,5,460,10013.0,104.0,64.0,5,216,10014.0,20.0,15.0
0.071,17,8,3613,4,1874,23.0,1350.0,440.0,4,1739,12.0,1350.0,406.0
0.005,6,10,2000,5,927,1.0,659.0,659.0,5,1073,1.0,805.0,805.0
0.004,17,2,170,1,65,0.0,37.0,37.0,1,105,0.0,77.0,77.0
327.308,17,20,1124,10,716,36360.0,48.0,43.0,10,408,36360.0,20.0,12.0
0.004,17,4,284,2,120,0.0,32.0,32.0,2,164,0.0,60.0,54.0
0.004,6,10,2006,5,927,1.0,659.0,659.0,5,1079,1.0,811.0,811.0
0.006,17,2,214,1,75,0.0,47.0,47.0,1,139,0.0,111.0,111.0
0.011,6,10,1990,5,911,2.0,643.0,643.0,5,1079,2.0,811.0,811.0
0.02,6,10,1989,5,910,4.0,642.0,642.0,5,1079,5.0,811.0,811.0
0.099,6,10,1506,5,395,23.0,127.0,127.0,5,1111,20.0,843.0,843.0
0.005,17,2,170,1,65,0.0,37.0,37.0,1,105,0.0,77.0,77.0
241.534,6,404,349244,195,21663,1245.0,2736.0,959.0,209,327581,1161.0,3053.0,1591.0
296.062,6,297,342592,119,17732,2509.0,2736.0,824.0,178,324860,1672.0,2804.0,1912.0
0.013,6,10,1989,5,910,3.0,642.0,642.0,5,1079,3.0,811.0,811.0
0.004,6,10,1702,5,863,1.0,595.0,595.0,5,839,1.0,571.0,571.0
282.6,6,23,6075,10,1186,31400.0,267.0,156.0,13,4889,23549.0,1400.0,873.0
0.005,6,10,2006,5,927,1.0,659.0,659.0,5,1079,1.0,811.0,811.0
0.086,6,10,1506,5,395,20.0,127.0,127.0,5,1111,19.0,843.0,843.0
0.097,6,10,1506,5,395,18.0,127.0,127.0,5,1111,22.0,843.0,843.0
0.127,6,10,1506,5,395,30.0,127.0,127.0,5,1111,19.0,843.0,843.0
0.005,6,10,2007,5,928,1.0,660.0,660.0,5,1079,1.0,811.0,811.0
0.007,6,10,1774,5,923,1.0,655.0,655.0,5,851,1.0,583.0,583.0
0.112,6,10,1506,5,395,19.0,127.0,127.0,5,1111,23.0,843.0,843.0
0.006,6,10,1689,5,839,1.0,571.0,571.0,5,850,1.0,582.0,582.0
0.005,6,10,1547,5,764,1.0,496.0,496.0,5,783,1.0,515.0,515.0
0.005,6,10,1989,5,927,1.0,659.0,659.0,5,1062,1.0,794.0,794.0
0.004,17,2,170,1,65,0.0,37.0,37.0,1,105,0.0,77.0,77.0
0.009,6,10,1983,5,910,2.0,642.0,642.0,5,1073,2.0,805.0,805.0
0.005,6,10,2000,5,927,1.0,659.0,659.0,5,1073,1.0,805.0,805.0
10.723,17,28,4419,14,1995,816.0,270.0,114.0,14,2424,816.0,587.0,145.0
0.005,6,10,2006,5,927,1.0,659.0,659.0,5,1079,1.0,811.0,811.0
0.014,6,10,1989,5,910,3.0,642.0,642.0,5,1079,3.0,811.0,811.0
0.005,6,10,2000,5,927,1.0,659.0,659.0,5,1073,1.0,805.0,805.0
0.008,6,12,1698,6,863,1.0,327.0,271.0,6,835,1.0,515.0,515.0
0.016,6,10,1990,5,911,3.0,643.0,643.0,5,1079,4.0,811.0,811.0
352.249,6,20,2210,6,1308,12003.0,494.0,494.0,14,902,27095.0,83.0,83.0
0.009,6,10,1990,5,911,2.0,643.0,643.0,5,1079,2.0,811.0,811.0
0.006,17,2,212,1,74,0.0,46.0,46.0,1,138,0.0,110.0,110.0
0.037,17,4,284,2,120,0.0,32.0,32.0,2,164,33.0,60.0,54.0
0.011,6,10,1990,5,911,2.0,643.0,643.0,5,1079,2.0,811.0,811.0
0.006,6,10,1854,5,889,1.0,621.0,621.0,5,965,1.0,697.0,697.0
0.005,6,15,3794,8,504,0.0,80.0,80.0,7,3290,0.0,1448.0,972.0
0.006,6,10,2007,5,928,1.0,660.0,660.0,5,1079,1.0,811.0,811.0
0.009,6,12,1926,6,1189,1.0,659.0,434.0,6,737,1.0,417.0,417.0
0.085,17,9,4994,5,3252,20.0,1350.0,622.0,4,1742,13.0,1350.0,407.0
0.005,6,10,1989,5,927,1.0,659.0,659.0,5,1062,1.0,794.0,794.0
0.006,6,10,1547,5,764,1.0,496.0,496.0,5,783,1.0,515.0,515.0
40.028,17,10,676,5,460,10004.0,104.0,64.0,5,216,10006.0,20.0,15.0
0.012,6,10,1989,5,910,3.0,642.0,642.0,5,1079,3.0,811.0,811.0
0.005,17,2,140,1,62,0.0,34.0,34.0,1,78,0.0,50.0,50.0
308.343,17,20,1124,10,716,34248.0,48.0,43.0,10,408,34251.0,20.0,12.0
322.183,17,20,1124,10,716,35791.0,48.0,43.0,10,408,35791.0,20.0,12.0
0.001,17,2,180,1,66,0.0,38.0,38.0,1,114,0.0,86.0,86.0
0.005,17,2,179,1,71,0.0,43.0,43.0,1,108,0.0,80.0,80.0
0.153,6,10,1506,5,395,35.0,127.0,127.0,5,1111,24.0,843.0,843.0
0.005,6,10,1689,5,839,1.0,571.0,571.0,5,850,1.0,582.0,582.0
0.008,6,10,1989,5,910,2.0,642.0,642.0,5,1079,2.0,811.0,811.0
0.013,6,10,1972,5,910,3.0,642.0,642.0,5,1062,3.0,794.0,794.0
0.0,17,2,166,1,75,0.0,47.0,47.0,1,91,0.0,63.0,63.0
0.009,6,10,1972,5,910,2.0,642.0,642.0,5,1062,2.0,794.0,794.0
0.005,17,2,169,1,62,0.0,34.0,34.0,1,107,0.0,79.0,79.0
0.012,6,13,3735,7,497,2.0,125.0,125.0,6,3238,2.0,1470.0,1459.0
0.005,17,2,214,1,75,0.0,47.0,47.0,1,139,0.0,111.0,111.0
0.098,6,10,1506,5,395,20.0,127.0,127.0,5,1111,21.0,843.0,843.0
0.04,17,2,170,1,65,0.0,37.0,37.0,1,105,0.0,77.0,77.0
11.24,17,28,4390,14,2313,856.0,588.0,137.0,14,2077,856.0,268.0,120.0
0.068,6,10,1506,5,395,13.0,127.0,127.0,5,1111,13.0,843.0,843.0
0.004,17,2,148,1,60,0.0,32.0,32.0,1,88,0.0,60.0,60.0
0.1,6,10,1506,5,395,22.0,127.0,127.0,5,1111,24.0,843.0,843.0
0.036,17,4,284,2,120,0.0,32.0,32.0,2,164,33.0,60.0,54.0
0.074,6,10,1506,5,395,16.0,127.0,127.0,5,1111,16.0,843.0,843.0
0.016,6,13,3735,7,497,2.0,125.0,125.0,6,3238,3.0,1470.0,1459.0
0.004,17,2,136,1,60,0.0,32.0,32.0,1,76,0.0,48.0,48.0
0.271,17,4,596,2,122,230.0,33.0,33.0,2,474,146.0,323.0,209.0
0.069,6,10,1506,5,395,17.0,127.0,127.0,5,1111,15.0,843.0,843.0
0.005,6,10,2006,5,927,1.0,659.0,659.0,5,1079,1.0,811.0,811.0
0.013,6,10,1631,5,848,3.0,580.0,580.0,5,783,3.0,515.0,515.0
51.723,6,24,7517,13,1385,4310.0,530.0,277.0,11,6132,5155.0,2720.0,946.0
0.122,6,10,1506,5,395,29.0,127.0,127.0,5,1111,26.0,843.0,843.0
0.005,6,10,2000,5,927,1.0,659.0,659.0,5,1073,1.0,805.0,805.0
40.07,17,10,676,5,460,10016.0,104.0,64.0,5,216,10016.0,20.0,15.0
305.236,17,16,928,8,608,43595.0,48.0,48.0,8,320,43596.0,12.0,12.0
0.0,17,2,166,1,75,0.0,47.0,47.0,1,91,0.0,63.0,63.0
0.009,6,13,3735,7,497,1.0,125.0,125.0,6,3238,1.0,1470.0,1459.0
0.071,6,10,1506,5,395,15.0,127.0,127.0,5,1111,16.0,843.0,843.0
0.01,6,10,1990,5,911,2.0,643.0,643.0,5,1079,2.0,811.0,811.0
40.057,17,10,676,5,460,10013.0,104.0,64.0,5,216,10013.0,20.0,15.0
178.302,17,88,13116,44,2959,4146.0,44.0,39.0,44,10157,4146.0,279.0,202.0
0.005,6,10,1689,5,839,1.0,571.0,571.0,5,850,1.0,582.0,582.0
0.134,17,2,152,1,76,0.0,48.0,48.0,1,76,0.0,48.0,48.0
0.012,6,13,3816,7,578,2.0,206.0,206.0,6,3238,2.0,1470.0,1459.0
40.056,17,10,676,5,460,10012.0,104.0,64.0,5,216,10013.0,20.0,15.0
0.016,6,10,1972,5,910,4.0,642.0,642.0,5,1062,3.0,794.0,794.0
0.094,6,10,1506,5,395,21.0,127.0,127.0,5,1111,20.0,843.0,843.0
0.016,6,10,1990,5,911,3.0,643.0,643.0,5,1079,3.0,811.0,811.0
0.126,6,10,1506,5,395,14.0,127.0,127.0,5,1111,30.0,843.0,843.0
0.076,6,10,1506,5,395,14.0,127.0,127.0,5,1111,16.0,843.0,843.0
0.001,17,2,180,1,66,0.0,38.0,38.0,1,114,0.0,86.0,86.0
0.005,6,10,2006,5,927,1.0,659.0,659.0,5,1079,1.0,811.0,811.0
0.022,6,10,1990,5,911,5.0,643.0,643.0,5,1079,5.0,811.0,811.0
0.005,17,2,187,1,71,0.0,43.0,43.0,1,116,0.0,88.0,88.0
0.005,6,10,2007,5,928,1.0,660.0,660.0,5,1079,1.0,811.0,811.0
0.001,17,2,180,1,66,0.0,38.0,38.0,1,114,0.0,86.0,86.0
0.016,6,10,1972,5,910,4.0,642.0,642.0,5,1062,3.0,794.0,794.0
0.008,6,10,2006,5,927,2.0,659.0,659.0,5,1079,1.0,811.0,811.0
0.114,6,10,1506,5,395,26.0,127.0,127.0,5,1111,25.0,843.0,843.0
0.007,6,10,1547,5,764,1.0,496.0,496.0,5,783,1.0,515.0,515.0
0.01,6,10,1762,5,911,2.0,643.0,643.0,5,851,2.0,583.0,583.0
0.005,6,13,3747,7,509,0.0,137.0,137.0,6,3238,1.0,1470.0,1459.0
0.01,6,10,1972,5,910,2.0,642.0,642.0,5,1062,2.0,794.0,794.0
0.012,6,10,1983,5,910,3.0,642.0,642.0,5,1073,3.0,805.0,805.0
0.001,17,2,180,1,66,0.0,38.0,38.0,1,114,0.0,86.0,86.0
0.011,6,10,1990,5,911,2.0,643.0,643.0,5,1079,2.0,811.0,811.0
0.133,6,10,1506,5,395,30.0,127.0,127.0,5,1111,26.0,843.0,843.0
0.011,6,10,1990,5,911,2.0,643.0,643.0,5,1079,2.0,811.0,811.0
0.005,6,10,2000,5,927,1.0,659.0,659.0,5,1073,1.0,805.0,805.0
0.003,17,4,284,2,120,0.0,32.0,32.0,2,164,0.0,60.0,54.0
0.001,17,2,136,1,60,0.0,32.0,32.0,1,76,0.0,48.0,48.0
0.022,6,10,1990,5,911,5.0,643.0,643.0,5,1079,5.0,811.0,811.0
0.004,6,10,1779,5,928,1.0,660.0,660.0,5,851,0.0,583.0,583.0
165.426,17,78,11152,39,2597,4353.0,44.0,38.0,39,8555,4353.0,261.0,191.0
0.004,17,2,148,1,60,0.0,32.0,32.0,1,88,0.0,60.0,60.0
241.231,6,39,9802,20,2230,12694.0,750.0,236.0,19,7572,13399.0,1402.0,549.0
0.009,6,10,1989,5,910,2.0,642.0,642.0,5,1079,2.0,811.0,811.0
0.082,6,10,1762,5,911,20.0,643.0,643.0,5,851,20.0,583.0,583.0
0.095,6,10,1506,5,395,18.0,127.0,127.0,5,1111,20.0,843.0,843.0
0.04,17,2,152,1,76,0.0,48.0,48.0,1,76,0.0,48.0,48.0
0.117,6,10,1506,5,395,26.0,127.0,127.0,5,1111,25.0,843.0,843.0
0.005,6,10,2000,5,927,1.0,659.0,659.0,5,1073,1.0,805.0,805.0
135.021,6,21,8146,11,1985,82.0,1174.0,504.0,10,6161,14984.0,2720.0,958.0
300.347,6,16,2170,9,684,37523.0,146.0,146.0,7,1486,50030.0,419.0,398.0
0.005,6,10,1989,5,927,1.0,659.0,659.0,5,1062,1.0,794.0,794.0
0.014,6,10,1677,5,827,3.0,559.0,559.0,5,850,3.0,582.0,582.0
240.207,6,33,10420,16,1953,16013.0,606.0,187.0,17,8467,15012.0,2063.0,688.0
240.094,6,16,4480,9,963,30011.0,238.0,166.0,7,3517,40014.0,1402.0,786.0
0.018,6,10,1989,5,910,4.0,642.0,642.0,5,1079,4.0,811.0,811.0
0.017,6,10,1677,5,827,4.0,559.0,559.0,5,850,4.0,582.0,582.0
0.017,6,10,1972,5,910,4.0,642.0,642.0,5,1062,4.0,794.0,794.0
0.005,6,13,3747,7,509,0.0,137.0,137.0,6,3238,1.0,1470.0,1459.0
0.005,6,10,2007,5,928,1.0,660.0,660.0,5,1079,1.0,811.0,811.0
0.006,6,12,1698,6,863,1.0,327.0,271.0,6,835,1.0,515.0,515.0
0.005,6,10,2007,5,928,1.0,660.0,660.0,5,1079,1.0,811.0,811.0
0.009,6,13,3735,7,497,1.0,125.0,125.0,6,3238,1.0,1470.0,1459.0
1711.233,6,61,7130,40,4333,43877.0,1626.0,112.0,21,2797,85553.0,1116.0,85.0
0.011,6,10,1972,5,910,2.0,642.0,642.0,5,1062,2.0,794.0,794.0
308.683,17,20,1124,10,716,34278.0,48.0,43.0,10,408,34277.0,20.0,12.0
0.015,6,10,1990,5,911,3.0,643.0,643.0,5,1079,3.0,811.0,811.0
0.005,6,10,2006,5,927,1.0,659.0,659.0,5,1079,1.0,811.0,811.0
0.001,17,2,180,1,66,0.0,38.0,38.0,1,114,0.0,86.0,86.0
0.017,6,10,1762,5,911,4.0,643.0,643.0,5,851,4.0,583.0,583.0
0.005,6,10,2006,5,927,1.0,659.0,659.0,5,1079,1.0,811.0,811.0
0.005,17,2,166,1,75,0.0,47.0,47.0,1,91,0.0,63.0,63.0
0.005,6,10,2006,5,927,1.0,659.0,659.0,5,1079,1.0,811.0,811.0
11.026,17,28,4421,14,1994,839.0,269.0,114.0,14,2427,839.0,586.0,145.0
0.009,6,10,2006,5,927,2.0,659.0,659.0,5,1079,2.0,811.0,811.0
0.001,17,2,180,1,66,0.0,38.0,38.0,1,114,0.0,86.0,86.0
0.005,6,10,1643,5,860,1.0,592.0,592.0,5,783,1.0,515.0,515.0
40.064,17,10,676,5,460,10014.0,104.0,64.0,5,216,10015.0,20.0,15.0
0.005,6,10,2007,5,928,1.0,660.0,660.0,5,1079,1.0,811.0,811.0
0.09,6,10,1506,5,395,19.0,127.0,127.0,5,1111,20.0,843.0,843.0
0.086,6,10,1506,5,395,19.0,127.0,127.0,5,1111,18.0,843.0,843.0
0.023,6,10,1972,5,910,5.0,642.0,642.0,5,1062,5.0,794.0,794.0
0.005,6,14,3742,8,504,0.0,80.0,80.0,6,3238,1.0,1470.0,1459.0
0.004,6,10,2007,5,928,1.0,660.0,660.0,5,1079,1.0,811.0,811.0
0.07,17,8,3613,4,1874,23.0,1350.0,440.0,4,1739,12.0,1350.0,406.0
0.011,6,10,1983,5,910,2.0,642.0,642.0,5,1073,2.0,805.0,805.0
0.005,17,2,179,1,71,0.0,43.0,43.0,1,108,0.0,80.0,80.0
0.005,6,10,2006,5,927,1.0,659.0,659.0,5,1079,1.0,811.0,811.0
0.128,17,2,80,1,32,0.0,4.0,4.0,1,48,0.0,20.0,20.0
0.001,17,2,180,1,66,0.0,38.0,38.0,1,114,0.0,86.0,86.0
0.08,6,10,1506,5,395,17.0,127.0,127.0,5,1111,18.0,843.0,843.0
0.005,6,10,1689,5,839,1.0,571.0,571.0,5,850,1.0,582.0,582.0
30.601,6,76,40608,34,5554,927.0,944.0,314.0,42,35054,746.0,2804.0,1026.0
0.007,17,2,179,1,71,0.0,43.0,43.0,1,108,0.0,80.0,80.0
0.04,17,2,184,1,61,0.0,33.0,33.0,1,123,0.0,95.0,95.0
0.006,6,10,1689,5,839,1.0,571.0,571.0,5,850,1.0,582.0,582.0
0.078,6,10,1506,5,395,16.0,127.0,127.0,5,1111,18.0,843.0,843.0
0.108,6,10,1506,5,395,25.0,127.0,127.0,5,1111,23.0,843.0,843.0
0.019,17,2,214,1,75,0.0,47.0,47.0,1,139,0.0,111.0,111.0
0.01,6,12,1926,6,1189,2.0,659.0,434.0,6,737,2.0,417.0,417.0
0.077,6,10,1506,5,395,17.0,127.0,127.0,5,1111,16.0,843.0,843.0
15.202,17,43,24348,24,21150,659.0,1350.0,853.0,19,3198,842.0,1350.0,140.0
40.054,17,10,676,5,460,10012.0,104.0,64.0,5,216,10012.0,20.0,15.0
0.011,6,10,1762,5,911,2.0,643.0,643.0,5,851,2.0,583.0,583.0
0.006,6,10,1779,5,928,1.0,660.0,660.0,5,851,1.0,583.0,583.0
0.003,17,4,284,2,120,0.0,32.0,32.0,2,164,0.0,60.0,54.0
130.47,6,24,9399,11,1575,69.0,794.0,367.0,13,7824,10862.0,1360.0,810.0
0.006,6,10,2000,5,927,1.0,659.0,659.0,5,1073,1.0,805.0,805.0
0.011,6,10,1972,5,910,2.0,642.0,642.0,5,1062,2.0,794.0,794.0
40.061,17,10,676,5,460,10012.0,104.0,64.0,5,216,10012.0,20.0,15.0
0.04,17,2,184,1,61,0.0,33.0,33.0,1,123,0.0,95.0,95.0
40.061,17,10,676,5,460,10012.0,104.0,64.0,5,216,10014.0,20.0,15.0
0.005,6,10,2006,5,927,1.0,659.0,659.0,5,1079,1.0,811.0,811.0
0.015,6,10,1990,5,911,3.0,643.0,643.0,5,1079,3.0,811.0,811.0
0.004,6,10,2006,5,927,1.0,659.0,659.0,5,1079,1.0,811.0,811.0
0.064,6,10,1506,5,395,13.0,127.0,127.0,5,1111,14.0,843.0,843.0
0.005,6,10,2006,5,927,1.0,659.0,659.0,5,1079,1.0,811.0,811.0
0.005,17,2,144,1,64,0.0,36.0,36.0,1,80,0.0,52.0,52.0
0.006,6,12,1698,6,863,1.0,327.0,271.0,6,835,1.0,515.0,515.0
0.016,6,10,1983,5,910,3.0,642.0,642.0,5,1073,3.0,805.0,805.0
0.054,17,2,146,1,65,0.0,37.0,37.0,1,81,0.0,53.0,53.0
0.229,6,16,2777,8,1395,32.0,533.0,323.0,8,1382,21.0,529.0,239.0
0.112,6,10,1506,5,395,26.0,127.0,127.0,5,1111,26.0,843.0,843.0
240.016,6,9,787,5,488,60004.0,232.0,232.0,4,299,80004.0,83.0,83.0
0.127,6,10,1506,5,395,28.0,127.0,127.0,5,1111,27.0,843.0,843.0
0.031,6,10,1983,5,910,7.0,642.0,642.0,5,1073,7.0,805.0,805.0
0.082,6,10,1506,5,395,18.0,127.0,127.0,5,1111,16.0,843.0,843.0
40.068,17,10,676,5,460,10016.0,104.0,64.0,5,216,10016.0,20.0,15.0
0.005,17,2,169,1,62,0.0,34.0,34.0,1,107,0.0,79.0,79.0
0.089,6,10,1506,5,395,20.0,127.0,127.0,5,1111,19.0,843.0,843.0
0.006,6,10,1689,5,839,1.0,571.0,571.0,5,850,1.0,582.0,582.0
0.005,6,10,1547,5,764,1.0,496.0,496.0,5,783,1.0,515.0,515.0
0.003,17,4,284,2,120,0.0,32.0,32.0,2,164,0.0,60.0,54.0
0.007,6,10,1990,5,911,1.0,643.0,643.0,5,1079,1.0,811.0,811.0
0.012,6,10,1989,5,910,3.0,642.0,642.0,5,1079,2.0,811.0,811.0
0.009,6,12,1926,6,1189,1.0,659.0,434.0,6,737,1.0,417.0,417.0
0.014,6,10,1990,5,911,3.0,643.0,643.0,5,1079,3.0,811.0,811.0
0.004,6,10,2007,5,928,1.0,660.0,660.0,5,1079,1.0,811.0,811.0
11.203,17,28,4421,14,1994,849.0,269.0,114.0,14,2427,849.0,586.0,145.0
0.005,6,10,1779,5,928,1.0,660.0,660.0,5,851,1.0,583.0,583.0
0.008,6,10,1989,5,910,2.0,642.0,642.0,5,1079,1.0,811.0,811.0
0.005,6,10,2006,5,927,1.0,659.0,659.0,5,1079,1.0,811.0,811.0
0.001,17,2,180,1,66,0.0,38.0,38.0,1,114,0.0,86.0,86.0
0.005,6,10,1689,5,839,1.0,571.0,571.0,5,850,1.0,582.0,582.0
0.005,6,10,2006,5,927,1.0,659.0,659.0,5,1079,1.0,811.0,811.0
0.008,6,10,1989,5,910,2.0,642.0,642.0,5,1079,2.0,811.0,811.0
240.12,6,32,9614,16,7199,16008.0,2273.0,707.0,16,2415,16007.0,580.0,196.0
0.008,6,10,1972,5,910,2.0,642.0,642.0,5,1062,1.0,794.0,794.0
0.008,6,10,1989,5,910,2.0,642.0,642.0,5,1079,1.0,811.0,811.0
0.136,6,10,1506,5,395,28.0,127.0,127.0,5,1111,30.0,843.0,843.0
240.022,6,9,787,5,488,60005.0,232.0,232.0,4,299,80003.0,83.0,83.0
0.142,6,10,1506,5,395,33.0,127.0,127.0,5,1111,33.0,843.0,843.0
0.008,6,10,1972,5,910,2.0,642.0,642.0,5,1062,2.0,794.0,794.0
1778.642,17,144,45504,72,22752,25051.0,288.0,288.0,72,22752,25051.0,288.0,288.0
0.005,6,10,1854,5,889,1.0,621.0,621.0,5,965,1.0,697.0,697.0
0.082,6,10,1506,5,395,18.0,127.0,127.0,5,1111,17.0,843.0,843.0
0.016,6,10,1762,5,911,4.0,643.0,643.0,5,851,3.0,583.0,583.0
10.914,17,28,4418,14,1995,830.0,270.0,114.0,14,2423,830.0,586.0,145.0
0.005,6,10,1989,5,927,1.0,659.0,659.0,5,1062,1.0,794.0,794.0
0.071,17,4,284,2,120,0.0,32.0,32.0,2,164,67.0,60.0,54.0
0.011,6,10,1762,5,911,2.0,643.0,643.0,5,851,2.0,583.0,583.0
0.012,6,10,1677,5,827,3.0,559.0,559.0,5,850,2.0,582.0,582.0
0.108,6,10,1506,5,395,26.0,127.0,127.0,5,1111,23.0,843.0,843.0
0.007,17,2,140,1,62,0.0,34.0,34.0,1,78,0.0,50.0,50.0
0.007,6,10,1989,5,910,1.0,642.0,642.0,5,1079,1.0,811.0,811.0
0.012,17,2,212,1,74,0.0,46.0,46.0,1,138,0.0,110.0,110.0
0.012,6,10,1989,5,910,2.0,642.0,642.0,5,1079,3.0,811.0,811.0
0.015,6,10,1972,5,910,3.0,642.0,642.0,5,1062,3.0,794.0,794.0
240.013,6,9,787,5,488,60003.0,232.0,232.0,4,299,80003.0,83.0,83.0
0.099,6,10,1506,5,395,18.0,127.0,127.0,5,1111,22.0,843.0,843.0
0.069,6,10,1506,5,395,15.0,127.0,127.0,5,1111,16.0,843.0,843.0
0.001,17,2,180,1,66,0.0,38.0,38.0,1,114,0.0,86.0,86.0
0.227,6,16,2669,8,1395,32.0,533.0,323.0,8,1274,20.0,529.0,212.0
0.005,6,10,2006,5,927,1.0,659.0,659.0,5,1079,1.0,811.0,811.0
0.004,6,10,1779,5,928,1.0,660.0,660.0,5,851,1.0,583.0,583.0
0.004,17,4,284,2,120,0.0,32.0,32.0,2,164,1.0,60.0,54.0
0.039,17,2,148,1,60,0.0,32.0,32.0,1,88,0.0,60.0,60.0
0.081,6,10,1506,5,395,18.0,127.0,127.0,5,1111,17.0,843.0,843.0
240.121,6,30,9060,15,6722,17151.0,1845.0,660.0,15,2338,17151.0,580.0,221.0
11.039,17,28,4395,14,2313,840.0,588.0,137.0,14,2082,840.0,269.0,120.0
40.06,17,10,676,5,460,10013.0,104.0,64.0,5,216,10011.0,20.0,15.0
0.036,17,2,136,1,60,0.0,32.0,32.0,1,76,0.0,48.0,48.0
0.006,6,10,1689,5,839,1.0,571.0,571.0,5,850,1.0,582.0,582.0
0.012,6,10,1990,5,911,3.0,643.0,643.0,5,1079,2.0,811.0,811.0
0.018,6,10,1762,5,911,4.0,643.0,643.0,5,851,4.0,583.0,583.0
0.005,6,10,1547,5,764,1.0,496.0,496.0,5,783,1.0,515.0,515.0
0.005,6,10,1689,5,839,1.0,571.0,571.0,5,850,1.0,582.0,582.0
0.006,17,2,214,1,75,0.0,47.0,47.0,1,139,0.0,111.0,111.0
0.007,6,10,1547,5,764,1.0,496.0,496.0,5,783,1.0,515.0,515.0
0.009,6,10,1631,5,848,2.0,580.0,580.0,5,783,2.0,515.0,515.0
0.075,6,8,3114,4,2314,25.0,1124.0,1053.0,4,800,24.0,296.0,296.0
0.042,17,2,152,1,76,0.0,48.0,48.0,1,76,0.0,48.0,48.0
0.006,6,10,1547,5,764,1.0,496.0,496.0,5,783,1.0,515.0,515.0
0.011,6,10,1989,5,910,2.0,642.0,642.0,5,1079,2.0,811.0,811.0
0.006,6,10,1547,5,764,1.0,496.0,496.0,5,783,1.0,515.0,515.0
478.715,6,29,7743,16,4757,31914.0,1402.0,559.0,13,2986,34886.0,821.0,383.0
0.005,6,10,2006,5,927,1.0,659.0,659.0,5,1079,1.0,811.0,811.0
0.006,17,2,179,1,71,0.0,43.0,43.0,1,108,0.0,80.0,80.0
0.111,6,10,1506,5,395,22.0,127.0,127.0,5,1111,23.0,843.0,843.0
0.01,6,10,1983,5,910,2.0,642.0,642.0,5,1073,2.0,805.0,805.0
353.981,6,21,1795,16,1030,23598.0,190.0,190.0,5,765,60002.0,464.0,248.0
0.007,6,10,2007,5,928,1.0,660.0,660.0,5,1079,1.0,811.0,811.0
0.006,6,10,1689,5,839,1.0,571.0,571.0,5,850,1.0,582.0,582.0
0.016,17,2,198,1,91,0.0,63.0,63.0,1,107,0.0,79.0,79.0
0.006,6,10,1547,5,764,1.0,496.0,496.0,5,783,1.0,515.0,515.0
354.031,6,21,1795,16,1030,23602.0,190.0,190.0,5,765,60004.0,464.0,248.0
0.059,6,10,1506,5,395,12.0,127.0,127.0,5,1111,13.0,843.0,843.0
0.005,17,2,160,1,72,0.0,44.0,44.0,1,88,0.0,60.0,60.0
0.001,17,2,180,1,66,0.0,38.0,38.0,1,114,0.0,86.0,86.0
0.109,6,10,1506,5,395,25.0,127.0,127.0,5,1111,25.0,843.0,843.0
0.004,6,10,2006,5,927,1.0,659.0,659.0,5,1079,1.0,811.0,811.0
0.079,6,10,1506,5,395,18.0,127.0,127.0,5,1111,15.0,843.0,843.0
0.075,6,10,1506,5,395,16.0,127.0,127.0,5,1111,17.0,843.0,843.0
0.015,17,2,136,1,60,0.0,32.0,32.0,1,76,0.0,48.0,48.0
0.009,6,10,1990,5,911,2.0,643.0,643.0,5,1079,2.0,811.0,811.0
0.026,6,10,1989,5,910,6.0,642.0,642.0,5,1079,6.0,811.0,811.0
0.005,17,2,230,1,68,0.0,40.0,40.0,1,162,0.0,134.0,134.0
0.001,17,2,180,1,66,0.0,38.0,38.0,1,114,0.0,86.0,86.0
0.154,6,10,1506,5,395,34.0,127.0,127.0,5,1111,36.0,843.0,843.0
0.064,6,10,1506,5,395,14.0,127.0,127.0,5,1111,14.0,843.0,843.0
0.006,6,12,1698,6,863,1.0,327.0,271.0,6,835,1.0,515.0,515.0
0.11,6,10,1506,5,395,24.0,127.0,127.0,5,1111,25.0,843.0,843.0
0.005,6,10,2007,5,928,1.0,660.0,660.0,5,1079,1.0,811.0,811.0
0.006,17,2,136,1,60,0.0,32.0,32.0,1,76,0.0,48.0,48.0
0.005,6,10,2000,5,927,1.0,659.0,659.0,5,1073,1.0,805.0,805.0
0.038,17,4,284,2,120,0.0,32.0,32.0,2,164,34.0,60.0,54.0
0.039,17,2,148,1,60,0.0,32.0,32.0,1,88,0.0,60.0,60.0
0.007,6,10,1990,5,911,1.0,643.0,643.0,5,1079,1.0,811.0,811.0
0.066,6,10,1506,5,395,15.0,127.0,127.0,5,1111,14.0,843.0,843.0
10.715,17,28,4422,14,1994,816.0,269.0,114.0,14,2428,816.0,587.0,145.0
0.015,6,10,1983,5,910,3.0,642.0,642.0,5,1073,3.0,805.0,805.0
0.006,6,10,1547,5,764,1.0,496.0,496.0,5,783,1.0,515.0,515.0
40.096,17,10,676,5,460,10020.0,104.0,64.0,5,216,10023.0,20.0,15.0
0.008,17,2,293,1,73,0.0,45.0,45.0,1,220,0.0,192.0,192.0
40.067,17,10,676,5,460,10014.0,104.0,64.0,5,216,10015.0,20.0,15.0
0.007,17,2,179,1,71,0.0,43.0,43.0,1,108,0.0,80.0,80.0
0.008,6,12,1926,6,1189,1.0,659.0,434.0,6,737,1.0,417.0,417.0
0.005,6,10,1779,5,928,1.0,660.0,660.0,5,851,1.0,583.0,583.0
0.01,6,10,1631,5,848,2.0,580.0,580.0,5,783,2.0,515.0,515.0
240.095,6,16,4480,9,963,30011.0,238.0,166.0,7,3517,40015.0,1402.0,786.0
0.011,6,10,1989,5,910,2.0,642.0,642.0,5,1079,2.0,811.0,811.0
0.002,17,2,136,1,60,0.0,32.0,32.0,1,76,0.0,48.0,48.0
0.003,17,2,148,1,60,0.0,32.0,32.0,1,88,0.0,60.0,60.0
0.088,6,10,1506,5,395,19.0,127.0,127.0,5,1111,15.0,843.0,843.0
0.005,17,2,169,1,62,0.0,34.0,34.0,1,107,0.0,79.0,79.0
0.097,6,10,1506,5,395,21.0,127.0,127.0,5,1111,21.0,843.0,843.0
0.004,6,10,1779,5,928,1.0,660.0,660.0,5,851,1.0,583.0,583.0
10.889,17,28,4421,14,1993,828.0,268.0,114.0,14,2428,828.0,587.0,145.0
1.027,6,13,3929,7,2138,129.0,1328.0,923.0,6,1791,155.0,1539.0,1539.0
0.004,17,2,136,1,60,0.0,32.0,32.0,1,76,0.0,48.0,48.0
0.004,6,10,1702,5,863,1.0,595.0,595.0,5,839,0.0,571.0,571.0
0.018,6,10,1990,5,911,4.0,643.0,643.0,5,1079,4.0,811.0,811.0
15.201,17,39,20094,21,17036,758.0,1350.0,783.0,18,3058,892.0,1350.0,141.0
0.012,6,10,1631,5,848,2.0,580.0,580.0,5,783,3.0,515.0,515.0
0.04,17,2,412,1,61,0.0,33.0,33.0,1,351,0.0,323.0,323.0
0.01,6,12,1698,6,863,2.0,327.0,271.0,6,835,2.0,515.0,515.0
0.013,6,10,1677,5,827,3.0,559.0,559.0,5,850,3.0,582.0,582.0
0.005,6,10,1547,5,764,1.0,496.0,496.0,5,783,1.0,515.0,515.0
269.474,6,11,891,5,488,67368.0,232.0,232.0,6,403,53894.0,83.0,83.0
40.061,17,10,676,5,460,10012.0,104.0,64.0,5,216,10014.0,20.0,15.0
0.005,17,2,144,1,64,0.0,36.0,36.0,1,80,0.0,52.0,52.0
0.099,6,10,1506,5,395,24.0,127.0,127.0,5,1111,21.0,843.0,843.0
0.004,6,10,2006,5,927,1.0,659.0,659.0,5,1079,1.0,811.0,811.0
0.004,6,10,1989,5,927,1.0,659.0,659.0,5,1062,1.0,794.0,794.0
0.011,6,10,1762,5,911,2.0,643.0,643.0,5,851,2.0,583.0,583.0
0.007,17,2,225,1,65,0.0,37.0,37.0,1,160,0.0,132.0,132.0
0.049,6,13,3735,7,497,8.0,125.0,125.0,6,3238,9.0,1470.0,1459.0
0.024,6,10,1989,5,910,6.0,642.0,642.0,5,1079,6.0,811.0,811.0
0.016,6,10,1762,5,911,4.0,643.0,643.0,5,851,3.0,583.0,583.0
0.012,6,10,1989,5,910,3.0,642.0,642.0,5,1079,2.0,811.0,811.0
322.361,17,20,1124,10,716,35803.0,48.0,43.0,10,408,35803.0,20.0,12.0
0.005,6,10,2006,5,927,1.0,659.0,659.0,5,1079,1.0,811.0,811.0
0.005,6,10,2006,5,927,1.0,659.0,659.0,5,1079,1.0,811.0,811.0
0.009,6,12,1926,6,1189,1.0,659.0,434.0,6,737,1.0,417.0,417.0
0.005,6,10,2000,5,927,1.0,659.0,659.0,5,1073,1.0,805.0,805.0
0.011,6,10,1972,5,910,2.0,642.0,642.0,5,1062,2.0,794.0,794.0
0.005,6,13,3690,7,452,0.0,80.0,80.0,6,3238,1.0,1470.0,1459.0
0.015,6,10,1989,5,910,3.0,642.0,642.0,5,1079,3.0,811.0,811.0
0.011,6,10,1989,5,910,2.0,642.0,642.0,5,1079,2.0,811.0,811.0
0.01,6,10,1989,5,910,2.0,642.0,642.0,5,1079,2.0,811.0,811.0
9.04,17,6,376,5,280,2260.0,28.0,28.0,1,96,0.0,68.0,68.0
0.004,17,2,148,1,60,0.0,32.0,32.0,1,88,0.0,60.0,60.0
0.065,6,10,1506,5,395,15.0,127.0,127.0,5,1111,13.0,843.0,843.0
0.013,6,10,1983,5,910,3.0,642.0,642.0,5,1073,3.0,805.0,805.0
15.072,17,15,9238,8,6902,2149.0,1350.0,834.0,7,2336,2507.0,1350.0,305.0
1756.506,6,105,6240,60,3510,29770.0,26.0,26.0,45,2730,39919.0,26.0,26.0
0.075,6,10,1506,5,395,16.0,127.0,127.0,5,1111,17.0,843.0,843.0
0.122,6,10,1506,5,395,24.0,127.0,127.0,5,1111,28.0,843.0,843.0
0.005,6,10,2007,5,928,1.0,660.0,660.0,5,1079,1.0,811.0,811.0
0.02,17,4,284,2,120,0.0,32.0,32.0,2,164,0.0,60.0,54.0
0.331,17,45,25895,24,21175,14.0,1350.0,854.0,21,4720,13.0,1350.0,196.0
0.094,6,10,1506,5,395,22.0,127.0,127.0,5,1111,22.0,843.0,843.0
0.003,17,2,148,1,60,0.0,32.0,32.0,1,88,0.0,60.0,60.0
0.006,6,10,1547,5,764,1.0,496.0,496.0,5,783,1.0,515.0,515.0
240.472,6,40,9848,22,2365,11450.0,745.0,235.0,18,7483,14145.0,1402.0,595.0
0.005,17,2,164,1,74,0.0,46.0,46.0,1,90,0.0,62.0,62.0
0.032,6,10,1677,5,827,8.0,559.0,559.0,5,850,8.0,582.0,582.0
11.164,17,28,4421,14,1994,846.0,269.0,114.0,14,2427,846.0,586.0,145.0
0.001,17,2,180,1,66,0.0,38.0,38.0,1,114,0.0,86.0,86.0
0.005,6,10,2007,5,928,1.0,660.0,660.0,5,1079,1.0,811.0,811.0
0.043,17,2,152,1,76,0.0,48.0,48.0,1,76,0.0,48.0,48.0
0.005,17,2,170,1,65,0.0,37.0,37.0,1,105,0.0,77.0,77.0
0.115,6,10,1506,5,395,26.0,127.0,127.0,5,1111,26.0,843.0,843.0
0.124,6,10,1506,5,395,27.0,127.0,127.0,5,1111,28.0,843.0,843.0
40.072,17,10,676,5,460,10017.0,104.0,64.0,5,216,10017.0,20.0,15.0
0.005,6,10,1989,5,927,1.0,659.0,659.0,5,1062,1.0,794.0,794.0
0.006,17,2,169,1,62,0.0,34.0,34.0,1,107,0.0,79.0,79.0
0.005,6,10,2000,5,927,1.0,659.0,659.0,5,1073,1.0,805.0,805.0
0.008,17,2,169,1,62,0.0,34.0,34.0,1,107,0.0,79.0,79.0
0.006,6,10,1854,5,889,1.0,621.0,621.0,5,965,1.0,697.0,697.0
0.005,6,10,1989,5,927,1.0,659.0,659.0,5,1062,1.0,794.0,794.0
0.006,6,10,1689,5,839,1.0,571.0,571.0,5,850,1.0,582.0,582.0
0.009,6,10,1989,5,910,2.0,642.0,642.0,5,1079,2.0,811.0,811.0
0.017,6,10,1762,5,911,4.0,643.0,643.0,5,851,4.0,583.0,583.0
1781.681,6,236,46136,112,33713,16051.0,2473.0,1072.0,124,12423,14485.0,580.0,62.0
300.082,6,12,1782,7,1348,50013.0,494.0,494.0,5,434,75013.0,83.0,83.0
0.073,6,10,1506,5,395,15.0,127.0,127.0,5,1111,17.0,843.0,843.0
0.009,6,10,1989,5,910,2.0,642.0,642.0,5,1079,2.0,811.0,811.0
0.152,6,10,1506,5,395,37.0,127.0,127.0,5,1111,31.0,843.0,843.0
40.108,17,10,676,5,460,10022.0,104.0,64.0,5,216,10025.0,20.0,15.0
0.083,6,10,1506,5,395,13.0,127.0,127.0,5,1111,19.0,843.0,843.0
0.004,17,4,284,2,120,0.0,32.0,32.0,2,164,1.0,60.0,54.0
0.01,6,10,1989,5,910,2.0,642.0,642.0,5,1079,2.0,811.0,811.0
0.045,17,2,152,1,76,0.0,48.0,48.0,1,76,0.0,48.0,48.0
0.008,6,10,1989,5,910,2.0,642.0,642.0,5,1079,2.0,811.0,811.0
0.005,6,10,1774,5,923,1.0,655.0,655.0,5,851,1.0,583.0,583.0
0.016,17,2,198,1,91,0.0,63.0,63.0,1,107,0.0,79.0,79.0
0.096,6,10,1506,5,395,22.0,127.0,127.0,5,1111,18.0,843.0,843.0
0.173,6,10,1506,5,395,39.0,127.0,127.0,5,1111,38.0,843.0,843.0
0.017,6,10,1983,5,910,4.0,642.0,642.0,5,1073,4.0,805.0,805.0
0.005,6,10,1547,5,764,1.0,496.0,496.0,5,783,1.0,515.0,515.0
0.441,17,2,144,1,64,0.0,36.0,36.0,1,80,0.0,52.0,52.0
0.008,6,10,1989,5,910,2.0,642.0,642.0,5,1079,2.0,811.0,811.0
0.013,6,10,1983,5,910,3.0,642.0,642.0,5,1073,3.0,805.0,805.0
40.06,17,10,676,5,460,10014.0,104.0,64.0,5,216,10014.0,20.0,15.0
0.006,6,10,1547,5,764,1.0,496.0,496.0,5,783,1.0,515.0,515.0
0.005,6,10,2000,5,927,1.0,659.0,659.0,5,1073,1.0,805.0,805.0
178.015,17,84,12085,42,2799,4341.0,44.0,38.0,42,9286,4341.0,261.0,193.0
0.006,6,10,1547,5,764,1.0,496.0,496.0,5,783,1.0,515.0,515.0
0.013,6,10,1989,5,910,3.0,642.0,642.0,5,1079,3.0,811.0,811.0
300.953,6,47,21578,25,15900,12539.0,2720.0,1486.0,22,5678,419.0,2667.0,435.0
0.012,17,2,168,1,76,0.0,48.0,48.0,1,92,0.0,64.0,64.0
0.005,6,10,1989,5,927,1.0,659.0,659.0,5,1062,1.0,794.0,794.0
0.005,17,2,144,1,64,0.0,36.0,36.0,1,80,0.0,52.0,52.0
0.004,6,10,1774,5,923,1.0,655.0,655.0,5,851,1.0,583.0,583.0
0.006,17,2,170,1,65,0.0,37.0,37.0,1,105,0.0,77.0,77.0
0.078,6,10,1506,5,395,16.0,127.0,127.0,5,1111,18.0,843.0,843.0
0.008,6,10,1983,5,910,2.0,642.0,642.0,5,1073,1.0,805.0,805.0
0.039,17,2,412,1,61,0.0,33.0,33.0,1,351,0.0,323.0,323.0
0.001,17,2,294,1,64,0.0,36.0,36.0,1,230,0.0,202.0,202.0
0.004,6,10,1989,5,927,1.0,659.0,659.0,5,1062,1.0,794.0,794.0
0.123,6,10,1506,5,395,29.0,127.0,127.0,5,1111,28.0,843.0,843.0
290.05,6,408,349489,199,21894,1464.0,2736.0,888.0,209,327595,1394.0,2804.0,1624.0
0.006,17,2,291,1,66,0.0,38.0,38.0,1,225,0.0,197.0,197.0
0.007,6,12,1698,6,863,1.0,327.0,271.0,6,835,1.0,515.0,515.0
0.004,6,10,2006,5,927,1.0,659.0,659.0,5,1079,1.0,811.0,811.0
0.008,6,10,1983,5,910,2.0,642.0,642.0,5,1073,1.0,805.0,805.0
0.087,6,10,1506,5,395,21.0,127.0,127.0,5,1111,20.0,843.0,843.0
296.153,6,400,348120,206,22220,1444.0,2736.0,821.0,194,325900,1534.0,2804.0,1754.0
0.164,17,2,152,1,76,0.0,48.0,48.0,1,76,0.0,48.0,48.0
0.004,6,10,1774,5,923,1.0,655.0,655.0,5,851,1.0,583.0,583.0
0.07,6,10,1506,5,395,17.0,127.0,127.0,5,1111,15.0,843.0,843.0
0.005,6,10,2000,5,927,1.0,659.0,659.0,5,1073,1.0,805.0,805.0
0.009,6,10,1989,5,910,2.0,642.0,642.0,5,1079,2.0,811.0,811.0
0.023,6,10,1677,5,827,5.0,559.0,559.0,5,850,5.0,582.0,582.0
0.005,17,2,170,1,65,0.0,37.0,37.0,1,105,0.0,77.0,77.0
0.103,6,10,1506,5,395,22.0,127.0,127.0,5,1111,21.0,843.0,843.0
0.008,6,10,1989,5,910,1.0,642.0,642.0,5,1079,2.0,811.0,811.0
0.012,6,10,1990,5,911,3.0,643.0,643.0,5,1079,3.0,811.0,811.0
40.058,17,10,676,5,460,10013.0,104.0,64.0,5,216,10013.0,20.0,15.0
0.008,6,10,1989,5,910,2.0,642.0,642.0,5,1079,2.0,811.0,811.0
40.068,17,10,676,5,460,10013.0,104.0,64.0,5,216,10015.0,20.0,15.0
0.004,6,10,1779,5,928,1.0,660.0,660.0,5,851,1.0,583.0,583.0
15.222,17,18,8947,9,6702,1899.0,1350.0,716.0,9,2245,1899.0,1350.0,221.0
0.014,6,10,1990,5,911,3.0,643.0,643.0,5,1079,3.0,811.0,811.0
0.087,6,10,1506,5,395,20.0,127.0,127.0,5,1111,20.0,843.0,843.0
0.01,6,10,1677,5,827,2.0,559.0,559.0,5,850,2.0,582.0,582.0
0.031,6,10,1972,5,910,7.0,642.0,642.0,5,1062,7.0,794.0,794.0
0.005,6,10,2000,5,927,1.0,659.0,659.0,5,1073,1.0,805.0,805.0
0.004,6,10,1989,5,927,1.0,659.0,659.0,5,1062,1.0,794.0,794.0
0.009,6,13,3735,7,497,1.0,125.0,125.0,6,3238,1.0,1470.0,1459.0
0.003,17,2,136,1,60,0.0,32.0,32.0,1,76,0.0,48.0,48.0
0.006,6,10,1689,5,839,1.0,571.0,571.0,5,850,1.0,582.0,582.0
0.072,17,2,182,1,65,0.0,37.0,37.0,1,117,0.0,89.0,89.0
0.012,6,10,1983,5,910,2.0,642.0,642.0,5,1073,3.0,805.0,805.0
0.016,6,10,1762,5,911,4.0,643.0,643.0,5,851,3.0,583.0,583.0
0.009,17,2,299,1,65,0.0,37.0,37.0,1,234,0.0,206.0,206.0
0.005,6,10,1689,5,839,1.0,571.0,571.0,5,850,1.0,582.0,582.0
0.005,6,13,3747,7,509,0.0,137.0,137.0,6,3238,1.0,1470.0,1459.0
0.093,6,10,1506,5,395,17.0,127.0,127.0,5,1111,21.0,843.0,843.0
0.007,6,12,1698,6,863,1.0,327.0,271.0,6,835,1.0,515.0,515.0
0.005,6,10,1547,5,764,1.0,496.0,496.0,5,783,1.0,515.0,515.0
0.006,6,10,1854,5,889,1.0,621.0,621.0,5,965,1.0,697.0,697.0
0.005,6,10,2006,5,927,1.0,659.0,659.0,5,1079,1.0,811.0,811.0
0.009,6,12,1926,6,1189,1.0,659.0,434.0,6,737,1.0,417.0,417.0
0.003,6,10,1702,5,863,0.0,595.0,595.0,5,839,0.0,571.0,571.0
40.077,17,10,676,5,460,10017.0,104.0,64.0,5,216,10018.0,20.0,15.0
0.005,6,10,2006,5,927,1.0,659.0,659.0,5,1079,1.0,811.0,811.0
0.041,17,4,284,2,120,0.0,32.0,32.0,2,164,38.0,60.0,54.0
10.957,17,28,4391,14,2313,834.0,588.0,137.0,14,2078,834.0,269.0,120.0
0.07,6,10,1506,5,395,15.0,127.0,127.0,5,1111,14.0,843.0,843.0
0.007,6,10,2006,5,927,1.0,659.0,659.0,5,1079,1.0,811.0,811.0
0.005,6,14,3799,7,509,0.0,137.0,137.0,7,3290,0.0,1448.0,972.0
0.011,6,10,1989,5,910,2.0,642.0,642.0,5,1079,2.0,811.0,811.0
0.005,6,10,2007,5,928,1.0,660.0,660.0,5,1079,1.0,811.0,811.0
0.006,6,10,1547,5,764,1.0,496.0,496.0,5,783,1.0,515.0,515.0
0.006,6,10,2006,5,927,1.0,659.0,659.0,5,1079,1.0,811.0,811.0
0.001,17,2,136,1,60,0.0,32.0,32.0,1,76,0.0,48.0,48.0
0.001,17,2,180,1,66,0.0,38.0,38.0,1,114,0.0,86.0,86.0
0.005,6,10,1689,5,839,1.0,571.0,571.0,5,850,1.0,582.0,582.0
240.169,6,21,7826,10,1606,26685.0,819.0,363.0,11,6220,24016.0,1402.0,805.0
0.008,6,10,2006,5,927,2.0,659.0,659.0,5,1079,2.0,811.0,811.0
1.03,6,12,3142,6,2099,155.0,1328.0,923.0,6,1043,155.0,791.0,791.0
0.01,6,10,1972,5,910,2.0,642.0,642.0,5,1062,2.0,794.0,794.0
308.901,17,20,1124,10,716,34307.0,48.0,43.0,10,408,34307.0,20.0,12.0
0.005,6,10,1989,5,927,1.0,659.0,659.0,5,1062,1.0,794.0,794.0
0.006,6,10,2006,5,927,1.0,659.0,659.0,5,1079,1.0,811.0,811.0
0.074,6,10,1506,5,395,15.0,127.0,127.0,5,1111,15.0,843.0,843.0
0.006,6,10,1547,5,764,1.0,496.0,496.0,5,783,1.0,515.0,515.0
11.14,17,28,4399,14,2313,848.0,588.0,137.0,14,2086,848.0,269.0,121.0
0.005,6,10,1989,5,927,1.0,659.0,659.0,5,1062,1.0,794.0,794.0
15.071,17,15,9238,8,6902,2149.0,1350.0,834.0,7,2336,2507.0,1350.0,305.0
0.005,6,10,2006,5,927,1.0,659.0,659.0,5,1079,1.0,811.0,811.0
0.09,6,10,1506,5,395,19.0,127.0,127.0,5,1111,19.0,843.0,843.0
0.041,17,2,152,1,76,0.0,48.0,48.0,1,76,0.0,48.0,48.0
0.005,6,10,1989,5,927,1.0,659.0,659.0,5,1062,1.0,794.0,794.0
0.215,6,16,2779,8,1397,30.0,533.0,324.0,8,1382,19.0,529.0,239.0
0.004,6,10,2007,5,928,1.0,660.0,660.0,5,1079,1.0,811.0,811.0
308.456,17,20,1124,10,716,34265.0,48.0,43.0,10,408,34262.0,20.0,12.0
0.012,6,10,1983,5,910,3.0,642.0,642.0,5,1073,2.0,805.0,805.0
0.007,6,10,1989,5,910,1.0,642.0,642.0,5,1079,1.0,811.0,811.0
0.004,17,2,136,1,60,0.0,32.0,32.0,1,76,0.0,48.0,48.0
0.037,17,2,148,1,60,0.0,32.0,32.0,1,88,0.0,60.0,60.0
0.037,17,2,148,1,60,0.0,32.0,32.0,1,88,0.0,60.0,60.0
0.017,6,10,1677,5,827,4.0,559.0,559.0,5,850,4.0,582.0,582.0
0.011,6,14,3787,7,497,1.0,125.0,125.0,7,3290,1.0,1448.0,972.0
0.003,17,4,284,2,120,0.0,32.0,32.0,2,164,0.0,60.0,54.0
0.068,6,10,1506,5,395,15.0,127.0,127.0,5,1111,14.0,843.0,843.0
0.005,6,10,2006,5,927,1.0,659.0,659.0,5,1079,1.0,811.0,811.0
0.039,6,10,1990,5,911,9.0,643.0,643.0,5,1079,9.0,811.0,811.0
0.006,17,2,152,1,76,0.0,48.0,48.0,1,76,0.0,48.0,48.0
0.079,6,10,1506,5,395,18.0,127.0,127.0,5,1111,17.0,843.0,843.0
326.008,6,19,2158,6,1308,12004.0,494.0,494.0,13,850,27167.0,83.0,83.0
0.001,17,2,164,1,74,0.0,46.0,46.0,1,90,0.0,62.0,62.0
0.006,6,10,2000,5,927,1.0,659.0,659.0,5,1073,1.0,805.0,805.0
0.005,17,2,140,1,62,0.0,34.0,34.0,1,78,0.0,50.0,50.0
0.013,6,10,1983,5,910,3.0,642.0,642.0,5,1073,3.0,805.0,805.0
0.012,6,10,1762,5,911,3.0,643.0,643.0,5,851,2.0,583.0,583.0
0.006,17,2,144,1,64,0.0,36.0,36.0,1,80,0.0,52.0,52.0
0.107,6,10,1506,5,395,26.0,127.0,127.0,5,1111,24.0,843.0,843.0
0.009,6,10,2006,5,927,2.0,659.0,659.0,5,1079,2.0,811.0,811.0
0.013,6,10,1972,5,910,3.0,642.0,642.0,5,1062,3.0,794.0,794.0
0.04,17,2,148,1,60,0.0,32.0,32.0,1,88,0.0,60.0,60.0
0.023,6,10,1762,5,911,5.0,643.0,643.0,5,851,5.0,583.0,583.0
0.005,17,2,166,1,75,0.0,47.0,47.0,1,91,0.0,63.0,63.0
0.019,6,10,1972,5,910,4.0,642.0,642.0,5,1062,4.0,794.0,794.0
0.085,6,10,1506,5,395,20.0,127.0,127.0,5,1111,19.0,843.0,843.0
0.038,17,2,128,1,56,0.0,28.0,28.0,1,72,0.0,44.0,44.0
0.005,17,2,144,1,64,0.0,36.0,36.0,1,80,0.0,52.0,52.0
0.063,6,10,1506,5,395,14.0,127.0,127.0,5,1111,14.0,843.0,843.0
0.005,6,10,2000,5,927,1.0,659.0,659.0,5,1073,1.0,805.0,805.0
0.093,6,10,1506,5,395,17.0,127.0,127.0,5,1111,20.0,843.0,843.0
0.021,6,10,1983,5,910,5.0,642.0,642.0,5,1073,5.0,805.0,805.0
0.007,6,10,1689,5,839,1.0,571.0,571.0,5,850,1.0,582.0,582.0
0.004,6,10,2007,5,928,1.0,660.0,660.0,5,1079,1.0,811.0,811.0
0.009,6,10,1989,5,910,2.0,642.0,642.0,5,1079,2.0,811.0,811.0
0.077,6,10,1506,5,395,15.0,127.0,127.0,5,1111,17.0,843.0,843.0
0.017,6,10,1631,5,848,4.0,580.0,580.0,5,783,4.0,515.0,515.0
0.012,6,10,1990,5,911,3.0,643.0,643.0,5,1079,3.0,811.0,811.0
0.004,17,2,136,1,60,0.0,32.0,32.0,1,76,0.0,48.0,48.0
0.001,17,2,180,1,66,0.0,38.0,38.0,1,114,0.0,86.0,86.0
0.006,6,10,1547,5,764,1.0,496.0,496.0,5,783,1.0,515.0,515.0
0.181,6,12,2996,7,549,30.0,177.0,177.0,5,2447,43.0,1402.0,1089.0
0.004,6,10,1989,5,927,1.0,659.0,659.0,5,1062,1.0,794.0,794.0
0.01,6,12,1926,6,1189,1.0,659.0,434.0,6,737,1.0,417.0,417.0
113.589,6,25,5159,14,1186,8737.0,180.0,75.0,11,3973,11358.0,1592.0,678.0
0.011,6,10,1989,5,910,2.0,642.0,642.0,5,1079,2.0,811.0,811.0
0.011,6,10,1983,5,910,2.0,642.0,642.0,5,1073,2.0,805.0,805.0
0.006,17,2,230,1,68,0.0,40.0,40.0,1,162,0.0,134.0,134.0
0.011,6,10,1990,5,911,2.0,643.0,643.0,5,1079,2.0,811.0,811.0
0.011,6,10,1972,5,910,2.0,642.0,642.0,5,1062,2.0,794.0,794.0
0.005,6,10,2000,5,927,1.0,659.0,659.0,5,1073,1.0,805.0,805.0
0.007,6,10,1989,5,910,1.0,642.0,642.0,5,1079,1.0,811.0,811.0
0.009,6,10,1989,5,910,2.0,642.0,642.0,5,1079,2.0,811.0,811.0
0.011,6,10,1990,5,911,2.0,643.0,643.0,5,1079,2.0,811.0,811.0
15.072,17,14,9190,8,6902,2149.0,1350.0,834.0,6,2288,3008.0,1350.0,353.0
372.185,6,22,2313,16,867,24812.0,195.0,195.0,6,1446,4819.0,419.0,398.0
1730.418,6,45,2790,30,1725,59669.0,35.0,35.0,15,1065,123596.0,31.0,31.0
0.003,17,2,148,1,60,0.0,32.0,32.0,1,88,0.0,60.0,60.0
0.001,17,2,142,1,63,0.0,35.0,35.0,1,79,0.0,51.0,51.0
0.005,17,2,154,1,69,0.0,41.0,41.0,1,85,0.0,57.0,57.0
0.106,6,10,1506,5,395,24.0,127.0,127.0,5,1111,24.0,843.0,843.0
0.005,6,10,1689,5,839,1.0,571.0,571.0,5,850,1.0,582.0,582.0
0.004,6,10,2000,5,927,1.0,659.0,659.0,5,1073,1.0,805.0,805.0
0.005,6,10,2006,5,927,1.0,659.0,659.0,5,1079,1.0,811.0,811.0
0.006,17,2,166,1,75,0.0,47.0,47.0,1,91,0.0,63.0,63.0
1794.906,6,560,190740,288,164328,6254.0,2883.0,957.0,272,26412,6623.0,580.0,120.0
353.646,6,20,2210,6,1308,12003.0,494.0,494.0,14,902,27203.0,83.0,83.0
0.018,6,10,1990,5,911,4.0,643.0,643.0,5,1079,4.0,811.0,811.0
40.075,17,10,676,5,460,10017.0,104.0,64.0,5,216,10017.0,20.0,15.0
0.005,6,10,2006,5,927,1.0,659.0,659.0,5,1079,1.0,811.0,811.0
0.021,6,10,1972,5,910,5.0,642.0,642.0,5,1062,5.0,794.0,794.0
11.086,17,28,4421,14,1994,840.0,269.0,114.0,14,2427,840.0,586.0,145.0
0.072,6,10,1506,5,395,15.0,127.0,127.0,5,1111,14.0,843.0,843.0
0.005,17,2,166,1,75,0.0,47.0,47.0,1,91,0.0,63.0,63.0
0.004,6,10,1702,5,863,0.0,595.0,595.0,5,839,1.0,571.0,571.0
0.037,17,2,184,1,61,0.0,33.0,33.0,1,123,0.0,95.0,95.0
0.005,6,13,3747,7,509,0.0,137.0,137.0,6,3238,0.0,1470.0,1459.0
0.007,6,10,1547,5,764,1.0,496.0,496.0,5,783,1.0,515.0,515.0
240.842,6,32,10066,16,3352,16056.0,757.0,502.0,16,6714,16055.0,1592.0,587.0
0.009,17,2,214,1,75,0.0,47.0,47.0,1,139,0.0,111.0,111.0
0.013,6,10,1990,5,911,3.0,643.0,643.0,5,1079,3.0,811.0,811.0
0.005,6,10,2006,5,927,1.0,659.0,659.0,5,1079,1.0,811.0,811.0
0.005,6,14,3736,7,446,0.0,74.0,74.0,7,3290,0.0,1448.0,972.0
0.01,6,10,1631,5,848,2.0,580.0,580.0,5,783,2.0,515.0,515.0
0.027,6,10,1990,5,911,6.0,643.0,643.0,5,1079,6.0,811.0,811.0
15.075,17,15,9238,8,6902,2149.0,1350.0,834.0,7,2336,2507.0,1350.0,305.0
0.006,6,10,1547,5,764,1.0,496.0,496.0,5,783,1.0,515.0,515.0
0.014,6,10,1972,5,910,3.0,642.0,642.0,5,1062,3.0,794.0,794.0
0.117,6,10,1506,5,395,27.0,127.0,127.0,5,1111,16.0,843.0,843.0
0.107,6,10,1506,5,395,23.0,127.0,127.0,5,1111,23.0,843.0,843.0
0.005,17,2,179,1,71,0.0,43.0,43.0,1,108,0.0,80.0,80.0
0.006,6,10,1547,5,764,1.0,496.0,496.0,5,783,1.0,515.0,515.0
0.783,6,10,2009,6,1655,156.0,1403.0,1403.0,4,354,184.0,182.0,182.0
0.005,17,2,164,1,74,0.0,46.0,46.0,1,90,0.0,62.0,62.0
0.006,6,10,1547,5,764,1.0,496.0,496.0,5,783,1.0,515.0,515.0
0.008,6,10,1779,5,928,2.0,660.0,660.0,5,851,1.0,583.0,583.0
0.006,6,10,1689,5,839,1.0,571.0,571.0,5,850,1.0,582.0,582.0
0.005,6,10,2006,5,927,1.0,659.0,659.0,5,1079,1.0,811.0,811.0
0.01,6,10,1990,5,911,2.0,643.0,643.0,5,1079,2.0,811.0,811.0
10.964,17,28,4421,14,1993,834.0,268.0,114.0,14,2428,834.0,587.0,145.0
0.005,6,10,2000,5,927,1.0,659.0,659.0,5,1073,1.0,805.0,805.0
0.102,6,10,1506,5,395,23.0,127.0,127.0,5,1111,19.0,843.0,843.0
240.018,6,9,787,5,488,60004.0,232.0,232.0,4,299,80005.0,83.0,83.0
0.004,6,10,1702,5,863,0.0,595.0,595.0,5,839,1.0,571.0,571.0
0.009,6,10,1677,5,827,2.0,559.0,559.0,5,850,2.0,582.0,582.0
0.005,6,10,1547,5,764,1.0,496.0,496.0,5,783,1.0,515.0,515.0
11.143,17,28,4418,14,1994,845.0,269.0,114.0,14,2424,844.0,587.0,145.0
0.092,6,10,1506,5,395,19.0,127.0,127.0,5,1111,22.0,843.0,843.0
314.8,17,20,1124,10,716,34963.0,48.0,43.0,10,408,34963.0,20.0,12.0
0.027,6,10,1990,5,911,6.0,643.0,643.0,5,1079,6.0,811.0,811.0
0.006,6,10,1547,5,764,1.0,496.0,496.0,5,783,1.0,515.0,515.0
0.092,6,10,1506,5,395,20.0,127.0,127.0,5,1111,17.0,843.0,843.0
40.074,17,10,676,5,460,10015.0,104.0,64.0,5,216,10017.0,20.0,15.0
0.04,17,2,412,1,61,0.0,33.0,33.0,1,351,0.0,323.0,323.0
0.118,6,10,1506,5,395,27.0,127.0,127.0,5,1111,26.0,843.0,843.0
0.065,17,8,3613,4,1874,21.0,1350.0,440.0,4,1739,11.0,1350.0,406.0
0.005,6,10,2007,5,928,1.0,660.0,660.0,5,1079,1.0,811.0,811.0
0.079,6,10,1506,5,395,18.0,127.0,127.0,5,1111,14.0,843.0,843.0
0.088,6,10,1506,5,395,19.0,127.0,127.0,5,1111,19.0,843.0,843.0
0.398,17,41,20290,23,17135,18.0,1350.0,717.0,18,3155,19.0,1350.0,147.0
0.078,6,10,1506,5,395,17.0,127.0,127.0,5,1111,15.0,843.0,843.0
0.101,6,10,1506,5,395,23.0,127.0,127.0,5,1111,22.0,843.0,843.0
0.131,6,10,1506,5,395,28.0,127.0,127.0,5,1111,30.0,843.0,843.0
40.079,17,10,676,5,460,10018.0,104.0,64.0,5,216,10018.0,20.0,15.0
0.76,6,23,5165,12,1343,64.0,325.0,122.0,11,3822,64.0,1414.0,563.0
0.003,17,2,185,1,73,0.0,45.0,45.0,1,112,0.0,84.0,84.0
0.026,6,10,1983,5,910,6.0,642.0,642.0,5,1073,6.0,805.0,805.0
10.725,17,28,4423,14,1994,816.0,269.0,114.0,14,2429,816.0,588.0,145.0
0.008,17,2,179,1,71,0.0,43.0,43.0,1,108,0.0,80.0,80.0
0.038,17,2,136,1,60,0.0,32.0,32.0,1,76,0.0,48.0,48.0
0.004,6,10,2006,5,927,1.0,659.0,659.0,5,1079,1.0,811.0,811.0
77.402,6,32,14329,17,6925,106.0,1360.0,776.0,15,7404,5516.0,1791.0,970.0
360.032,6,21,3981,13,3142,30002.0,494.0,494.0,8,839,51432.0,83.0,83.0
0.006,6,10,2007,5,928,1.0,660.0,660.0,5,1079,1.0,811.0,811.0
0.005,17,2,144,1,64,0.0,36.0,36.0,1,80,0.0,52.0,52.0
0.141,17,2,144,1,64,0.0,36.0,36.0,1,80,0.0,52.0,52.0
0.01,6,10,1972,5,910,2.0,642.0,642.0,5,1062,2.0,794.0,794.0
40.059,17,10,676,5,460,10013.0,104.0,64.0,5,216,10013.0,20.0,15.0
0.005,6,10,1702,5,863,1.0,595.0,595.0,5,839,1.0,571.0,571.0
0.006,6,10,1689,5,839,1.0,571.0,571.0,5,850,1.0,582.0,582.0
0.006,6,10,2000,5,927,1.0,659.0,659.0,5,1073,1.0,805.0,805.0
0.013,6,10,1990,5,911,3.0,643.0,643.0,5,1079,3.0,811.0,811.0
0.198,17,4,352,2,130,161.0,37.0,37.0,2,222,160.0,89.0,83.0
1.034,6,12,3134,6,2099,155.0,1328.0,923.0,6,1035,156.0,791.0,791.0
0.008,6,10,1983,5,910,2.0,642.0,642.0,5,1073,2.0,805.0,805.0
40.088,17,10,676,5,460,10016.0,104.0,64.0,5,216,10019.0,20.0,15.0
0.154,6,10,1506,5,395,34.0,127.0,127.0,5,1111,35.0,843.0,843.0
40.064,17,10,676,5,460,10015.0,104.0,64.0,5,216,10015.0,20.0,15.0
0.004,17,2,148,1,60,0.0,32.0,32.0,1,88,0.0,60.0,60.0
0.001,17,2,136,1,60,0.0,32.0,32.0,1,76,0.0,48.0,48.0
40.077,17,10,676,5,460,10017.0,104.0,64.0,5,216,10018.0,20.0,15.0
0.004,6,10,2007,5,928,1.0,660.0,660.0,5,1079,1.0,811.0,811.0
0.002,17,2,187,1,74,0.0,46.0,46.0,1,113,0.0,85.0,85.0
0.005,6,10,1989,5,927,1.0,659.0,659.0,5,1062,1.0,794.0,794.0
0.005,6,10,2006,5,927,1.0,659.0,659.0,5,1079,1.0,811.0,811.0
0.016,17,2,198,1,91,0.0,63.0,63.0,1,107,0.0,79.0,79.0
0.005,6,10,1689,5,839,1.0,571.0,571.0,5,850,1.0,582.0,582.0
0.004,17,4,284,2,120,0.0,32.0,32.0,2,164,0.0,60.0,54.0
0.009,6,10,1983,5,910,2.0,642.0,642.0,5,1073,2.0,805.0,805.0
0.2,6,3,453,2,321,200.0,241.0,241.0,1,132,0.0,92.0,92.0
0.012,6,10,1990,5,911,3.0,643.0,643.0,5,1079,3.0,811.0,811.0
0.173,6,10,1506,5,395,40.0,127.0,127.0,5,1111,37.0,843.0,843.0
0.004,6,10,1779,5,928,1.0,660.0,660.0,5,851,1.0,583.0,583.0
0.012,6,10,1677,5,827,3.0,559.0,559.0,5,850,2.0,582.0,582.0
0.005,6,10,1989,5,927,1.0,659.0,659.0,5,1062,1.0,794.0,794.0
0.088,6,10,1506,5,395,18.0,127.0,127.0,5,1111,19.0,843.0,843.0
0.005,17,2,170,1,65,0.0,37.0,37.0,1,105,0.0,77.0,77.0
0.003,17,2,162,1,65,0.0,37.0,37.0,1,97,0.0,69.0,69.0
0.011,6,10,1989,5,910,2.0,642.0,642.0,5,1079,2.0,811.0,811.0
0.008,6,10,1990,5,911,2.0,643.0,643.0,5,1079,2.0,811.0,811.0
0.141,6,10,1506,5,395,29.0,127.0,127.0,5,1111,31.0,843.0,843.0
0.087,6,10,1506,5,395,18.0,127.0,127.0,5,1111,19.0,843.0,843.0
0.143,6,10,1506,5,395,33.0,127.0,127.0,5,1111,30.0,843.0,843.0
0.006,17,2,214,1,75,0.0,47.0,47.0,1,139,0.0,111.0,111.0
0.004,6,10,1774,5,923,1.0,655.0,655.0,5,851,1.0,583.0,583.0
0.004,6,10,2006,5,927,1.0,659.0,659.0,5,1079,1.0,811.0,811.0
0.187,17,4,352,2,130,145.0,37.0,37.0,2,222,146.0,89.0,83.0
0.094,6,10,1506,5,395,21.0,127.0,127.0,5,1111,22.0,843.0,843.0
0.013,6,13,3735,7,497,2.0,125.0,125.0,6,3238,2.0,1470.0,1459.0
15.077,17,15,9239,8,6902,2149.0,1350.0,834.0,7,2337,2507.0,1350.0,305.0
0.005,17,2,166,1,75,0.0,47.0,47.0,1,91,0.0,63.0,63.0
0.004,6,10,2000,5,927,1.0,659.0,659.0,5,1073,1.0,805.0,805.0
300.021,6,12,1782,7,1348,50003.0,494.0,494.0,5,434,75004.0,83.0,83.0
0.118,6,10,1506,5,395,26.0,127.0,127.0,5,1111,24.0,843.0,843.0
0.022,6,10,1983,5,910,5.0,642.0,642.0,5,1073,5.0,805.0,805.0
0.005,6,10,1689,5,839,1.0,571.0,571.0,5,850,1.0,582.0,582.0
0.01,6,10,1983,5,910,2.0,642.0,642.0,5,1073,2.0,805.0,805.0
240.386,6,30,12354,16,6241,16025.0,1368.0,902.0,14,6113,18490.0,1655.0,896.0
0.005,6,10,2007,5,928,1.0,660.0,660.0,5,1079,1.0,811.0,811.0
0.091,6,10,1506,5,395,20.0,127.0,127.0,5,1111,19.0,843.0,843.0
308.59,17,20,1124,10,716,34281.0,48.0,43.0,10,408,34281.0,20.0,12.0
0.005,6,10,1774,5,923,1.0,655.0,655.0,5,851,1.0,583.0,583.0
0.012,6,10,1972,5,910,2.0,642.0,642.0,5,1062,2.0,794.0,794.0
0.004,6,10,1989,5,927,1.0,659.0,659.0,5,1062,1.0,794.0,794.0
40.052,17,10,676,5,460,10012.0,104.0,64.0,5,216,10009.0,20.0,15.0
0.073,17,2,148,1,60,0.0,32.0,32.0,1,88,0.0,60.0,60.0
0.813,6,10,937,6,427,162.0,107.0,107.0,4,510,181.0,294.0,294.0
240.013,6,9,787,5,488,60003.0,232.0,232.0,4,299,80003.0,83.0,83.0
0.013,6,10,1631,5,848,3.0,580.0,580.0,5,783,3.0,515.0,515.0
0.005,6,10,1989,5,927,1.0,659.0,659.0,5,1062,1.0,794.0,794.0
0.011,6,11,1657,6,440,2.0,120.0,120.0,5,1217,2.0,949.0,949.0
0.014,6,10,1990,5,911,3.0,643.0,643.0,5,1079,3.0,811.0,811.0
0.005,6,10,2000,5,927,1.0,659.0,659.0,5,1073,1.0,805.0,805.0
0.01,6,10,1989,5,910,2.0,642.0,642.0,5,1079,2.0,811.0,811.0
40.052,17,10,676,5,460,10012.0,104.0,64.0,5,216,10012.0,20.0,15.0
0.006,6,10,1547,5,764,1.0,496.0,496.0,5,783,1.0,515.0,515.0
0.006,6,10,1689,5,839,1.0,571.0,571.0,5,850,1.0,582.0,582.0
1786.793,6,272,39065,110,22339,16391.0,2720.0,213.0,162,16726,11097.0,1360.0,129.0
0.005,6,14,3799,7,509,0.0,137.0,137.0,7,3290,0.0,1448.0,972.0
0.005,6,10,1945,5,981,1.0,713.0,713.0,5,964,1.0,696.0,696.0
0.111,6,10,1506,5,395,22.0,127.0,127.0,5,1111,26.0,843.0,843.0
0.005,17,2,170,1,65,0.0,37.0,37.0,1,105,0.0,77.0,77.0
40.69,58,3,216,2,144,40690.0,24.0,24.0,1,72,0.0,24.0,24.0
0.005,6,10,2000,5,927,1.0,659.0,659.0,5,1073,1.0,805.0,805.0
0.005,17,4,284,2,120,0.0,32.0,32.0,2,164,1.0,60.0,54.0
0.067,6,10,1506,5,395,13.0,127.0,127.0,5,1111,15.0,843.0,843.0
0.006,6,10,1854,5,889,1.0,621.0,621.0,5,965,1.0,697.0,697.0
0.014,6,10,1762,5,911,3.0,643.0,643.0,5,851,3.0,583.0,583.0
0.006,6,10,2006,5,927,1.0,659.0,659.0,5,1079,1.0,811.0,811.0
0.076,6,45,14098,25,2617,3.0,517.0,146.0,20,11481,3.0,1402.0,745.0
240.683,6,37,9659,19,2175,13369.0,747.0,235.0,18,7484,14155.0,1402.0,595.0
0.015,6,13,3735,7,497,2.0,125.0,125.0,6,3238,2.0,1470.0,1459.0
0.013,6,10,1990,5,911,3.0,643.0,643.0,5,1079,3.0,811.0,811.0
0.004,6,10,2006,5,927,1.0,659.0,659.0,5,1079,1.0,811.0,811.0
64.38,58,3,216,2,144,64380.0,24.0,24.0,1,72,0.0,24.0,24.0
0.004,6,10,2006,5,927,1.0,659.0,659.0,5,1079,1.0,811.0,811.0
0.013,6,10,1989,5,910,3.0,642.0,642.0,5,1079,3.0,811.0,811.0
0.027,17,2,166,1,75,0.0,47.0,47.0,1,91,0.0,63.0,63.0
0.004,6,10,2000,5,927,1.0,659.0,659.0,5,1073,1.0,805.0,805.0
0.005,17,2,230,1,68,0.0,40.0,40.0,1,162,0.0,134.0,134.0
0.005,6,10,2006,5,927,1.0,659.0,659.0,5,1079,1.0,811.0,811.0
0.003,17,2,148,1,60,0.0,32.0,32.0,1,88,0.0,60.0,60.0
0.005,6,10,2006,5,927,1.0,659.0,659.0,5,1079,1.0,811.0,811.0
0.013,6,10,1677,5,827,3.0,559.0,559.0,5,850,3.0,582.0,582.0
356.84,6,20,2210,6,1308,12010.0,494.0,494.0,14,902,27447.0,83.0,83.0
0.004,6,10,1702,5,863,1.0,595.0,595.0,5,839,1.0,571.0,571.0
0.007,17,2,169,1,62,0.0,34.0,34.0,1,107,0.0,79.0,79.0
0.004,6,10,1779,5,928,1.0,660.0,660.0,5,851,1.0,583.0,583.0
0.076,6,10,1506,5,395,18.0,127.0,127.0,5,1111,16.0,843.0,843.0
28.593,6,36,8190,18,1719,531.0,651.0,322.0,18,6471,1674.0,2126.0,478.0
0.005,6,10,2000,5,927,1.0,659.0,659.0,5,1073,1.0,805.0,805.0
40.071,17,10,676,5,460,10016.0,104.0,64.0,5,216,10016.0,20.0,15.0
0.004,6,10,1774,5,923,1.0,655.0,655.0,5,851,1.0,583.0,583.0
240.025,6,9,787,5,488,60006.0,232.0,232.0,4,299,80004.0,83.0,83.0
0.001,17,2,180,1,66,0.0,38.0,38.0,1,114,0.0,86.0,86.0
0.088,6,10,1506,5,395,16.0,127.0,127.0,5,1111,19.0,843.0,843.0
0.113,6,10,1506,5,395,22.0,127.0,127.0,5,1111,23.0,843.0,843.0
0.134,6,10,1506,5,395,30.0,127.0,127.0,5,1111,29.0,843.0,843.0
0.063,17,2,179,1,71,0.0,43.0,43.0,1,108,0.0,80.0,80.0
280.638,6,26,6520,12,1266,25512.0,267.0,156.0,14,5254,21586.0,1400.0,781.0
0.01,6,6,716,3,458,4.0,302.0,302.0,3,258,4.0,102.0,102.0
1784.257,6,240,46410,116,33933,15515.0,2474.0,996.0,124,12477,14506.0,580.0,62.0
0.005,6,10,1689,5,839,1.0,571.0,571.0,5,850,1.0,582.0,582.0
15.08,17,15,9239,8,6902,2150.0,1350.0,834.0,7,2337,2508.0,1350.0,305.0
11.168,17,28,4418,14,1994,846.0,269.0,114.0,14,2424,846.0,587.0,145.0
0.014,6,10,1989,5,910,3.0,642.0,642.0,5,1079,3.0,811.0,811.0
0.015,6,10,1990,5,911,3.0,643.0,643.0,5,1079,3.0,811.0,811.0
0.005,6,10,2006,5,927,1.0,659.0,659.0,5,1079,1.0,811.0,811.0
0.006,6,10,1989,5,927,1.0,659.0,659.0,5,1062,1.0,794.0,794.0
0.038,17,4,284,2,120,0.0,32.0,32.0,2,164,34.0,60.0,54.0
0.001,17,2,180,1,66,0.0,38.0,38.0,1,114,0.0,86.0,86.0
0.005,6,10,2006,5,927,1.0,659.0,659.0,5,1079,1.0,811.0,811.0
0.094,6,10,1506,5,395,20.0,127.0,127.0,5,1111,21.0,843.0,843.0
0.001,17,2,180,1,66,0.0,38.0,38.0,1,114,0.0,86.0,86.0
40.092,17,10,676,5,460,10020.0,104.0,64.0,5,216,10022.0,20.0,15.0
0.005,6,10,1547,5,764,1.0,496.0,496.0,5,783,1.0,515.0,515.0
0.001,17,2,136,1,60,0.0,32.0,32.0,1,76,0.0,48.0,48.0
0.124,17,4,564,2,122,0.0,33.0,33.0,2,442,87.0,291.0,193.0
0.018,6,10,1990,5,911,4.0,643.0,643.0,5,1079,4.0,811.0,811.0
0.006,6,10,1689,5,839,1.0,571.0,571.0,5,850,1.0,582.0,582.0
0.115,6,10,1506,5,395,22.0,127.0,127.0,5,1111,25.0,843.0,843.0
0.038,17,4,284,2,120,0.0,32.0,32.0,2,164,35.0,60.0,54.0
240.26,6,43,8771,21,5686,12012.0,1515.0,509.0,22,3085,11440.0,580.0,241.0
0.005,6,10,2007,5,928,1.0,660.0,660.0,5,1079,1.0,811.0,811.0
0.01,6,10,2006,5,927,2.0,659.0,659.0,5,1079,2.0,811.0,811.0
0.042,17,2,152,1,76,0.0,48.0,48.0,1,76,0.0,48.0,48.0
0.013,17,2,152,1,56,0.0,28.0,28.0,1,96,0.0,68.0,68.0
308.739,17,20,1124,10,716,34290.0,48.0,43.0,10,408,34289.0,20.0,12.0
0.013,6,10,1989,5,910,3.0,642.0,642.0,5,1079,3.0,811.0,811.0
0.005,17,2,212,1,74,0.0,46.0,46.0,1,138,0.0,110.0,110.0
15.08,17,16,8560,8,6495,2150.0,1350.0,783.0,8,2065,2150.0,1350.0,230.0
84.841,6,24,6491,12,2496,7712.0,517.0,372.0,12,3995,7712.0,1402.0,480.0
0.007,6,10,1547,5,764,1.0,496.0,496.0,5,783,1.0,515.0,515.0
0.001,17,2,180,1,66,0.0,38.0,38.0,1,114,0.0,86.0,86.0
0.101,17,2,152,1,76,0.0,48.0,48.0,1,76,0.0,48.0,48.0
0.025,6,10,1989,5,910,6.0,642.0,642.0,5,1079,6.0,811.0,811.0
0.009,6,10,1972,5,910,2.0,642.0,642.0,5,1062,2.0,794.0,794.0
0.083,6,10,1506,5,395,19.0,127.0,127.0,5,1111,14.0,843.0,843.0
0.004,17,2,136,1,60,0.0,32.0,32.0,1,76,0.0,48.0,48.0
0.025,6,10,1762,5,911,6.0,643.0,643.0,5,851,6.0,583.0,583.0
0.006,6,10,2006,5,927,1.0,659.0,659.0,5,1079,1.0,811.0,811.0
0.016,6,10,1677,5,827,4.0,559.0,559.0,5,850,4.0,582.0,582.0
0.11,6,10,1506,5,395,25.0,127.0,127.0,5,1111,26.0,843.0,843.0
11.115,17,28,4422,14,1993,842.0,268.0,114.0,14,2429,842.0,588.0,145.0
0.106,6,10,1506,5,395,21.0,127.0,127.0,5,1111,24.0,843.0,843.0
0.006,6,10,1547,5,764,1.0,496.0,496.0,5,783,1.0,515.0,515.0
313.984,17,20,1124,10,716,34873.0,48.0,43.0,10,408,34873.0,20.0,12.0
1760.53,6,548,188490,279,162907,6332.0,2883.0,969.0,269,25583,6569.0,385.0,115.0
0.003,17,4,284,2,120,0.0,32.0,32.0,2,164,0.0,60.0,54.0
0.132,17,2,170,1,65,0.0,37.0,37.0,1,105,0.0,77.0,77.0
0.005,6,10,1689,5,839,1.0,571.0,571.0,5,850,1.0,582.0,582.0
40.052,17,10,676,5,460,10011.0,104.0,64.0,5,216,10011.0,20.0,15.0
40.087,17,10,676,5,460,10019.0,104.0,64.0,5,216,10021.0,20.0,15.0
0.069,6,10,1506,5,395,14.0,127.0,127.0,5,1111,16.0,843.0,843.0
0.005,6,10,2000,5,927,1.0,659.0,659.0,5,1073,1.0,805.0,805.0
0.006,6,10,1854,5,889,1.0,621.0,621.0,5,965,1.0,697.0,697.0
40.066,17,10,676,5,460,10015.0,104.0,64.0,5,216,10015.0,20.0,15.0
0.004,6,10,1702,5,863,0.0,595.0,595.0,5,839,1.0,571.0,571.0
0.089,6,10,1506,5,395,17.0,127.0,127.0,5,1111,19.0,843.0,843.0
0.009,6,10,1989,5,910,2.0,642.0,642.0,5,1079,2.0,811.0,811.0
0.004,6,10,1989,5,927,1.0,659.0,659.0,5,1062,1.0,794.0,794.0
0.005,17,2,144,1,64,0.0,36.0,36.0,1,80,0.0,52.0,52.0
0.006,6,10,1547,5,764,1.0,496.0,496.0,5,783,1.0,515.0,515.0
0.006,17,2,178,1,81,0.0,53.0,53.0,1,97,0.0,69.0,69.0
0.006,6,10,1689,5,839,1.0,571.0,571.0,5,850,1.0,582.0,582.0
0.098,6,10,1506,5,395,21.0,127.0,127.0,5,1111,18.0,843.0,843.0
10.727,17,28,4422,14,1994,816.0,269.0,114.0,14,2428,816.0,587.0,145.0
0.038,17,2,148,1,60,0.0,32.0,32.0,1,88,0.0,60.0,60.0
0.097,6,10,1506,5,395,22.0,127.0,127.0,5,1111,20.0,843.0,843.0
0.018,6,10,1972,5,910,4.0,642.0,642.0,5,1062,4.0,794.0,794.0
40.078,17,10,676,5,460,10018.0,104.0,64.0,5,216,10018.0,20.0,15.0
240.284,6,41,8667,20,5634,12646.0,2883.0,573.0,21,3033,12014.0,580.0,241.0
0.01,6,12,1926,6,1189,2.0,659.0,434.0,6,737,2.0,417.0,417.0
0.005,17,2,178,1,81,0.0,53.0,53.0,1,97,0.0,69.0,69.0
0.001,17,2,179,1,62,0.0,34.0,34.0,1,117,0.0,89.0,89.0
0.027,6,10,1989,5,910,6.0,642.0,642.0,5,1079,6.0,811.0,811.0
0.094,6,10,1506,5,395,21.0,127.0,127.0,5,1111,19.0,843.0,843.0
0.006,17,2,148,1,60,0.0,32.0,32.0,1,88,0.0,60.0,60.0
0.119,6,10,1506,5,395,14.0,127.0,127.0,5,1111,28.0,843.0,843.0
290.536,6,323,343798,118,17690,2483.0,2736.0,825.0,205,326108,1424.0,2991.0,1642.0
0.011,17,2,299,1,65,0.0,37.0,37.0,1,234,0.0,206.0,206.0
0.006,6,10,1989,5,927,1.0,659.0,659.0,5,1062,1.0,794.0,794.0
0.005,6,10,2000,5,927,1.0,659.0,659.0,5,1073,1.0,805.0,805.0
0.093,6,10,1506,5,395,19.0,127.0,127.0,5,1111,22.0,843.0,843.0
0.006,6,10,1643,5,860,1.0,592.0,592.0,5,783,1.0,515.0,515.0
0.014,6,10,1972,5,910,3.0,642.0,642.0,5,1062,3.0,794.0,794.0
241.14,6,39,11257,18,2719,14184.0,761.0,295.0,21,8538,12056.0,1402.0,532.0
0.006,6,10,1547,5,764,1.0,496.0,496.0,5,783,1.0,515.0,515.0
0.012,6,10,1972,5,910,2.0,642.0,642.0,5,1062,2.0,794.0,794.0
0.005,6,10,1779,5,928,1.0,660.0,660.0,5,851,1.0,583.0,583.0
0.008,6,10,1990,5,911,2.0,643.0,643.0,5,1079,1.0,811.0,811.0
130.814,6,24,9399,11,1575,78.0,794.0,367.0,13,7824,10889.0,1360.0,810.0
0.011,6,14,3787,7,497,1.0,125.0,125.0,7,3290,1.0,1448.0,972.0
0.004,17,4,284,2,120,0.0,32.0,32.0,2,164,0.0,60.0,54.0
0.005,6,10,1689,5,839,1.0,571.0,571.0,5,850,1.0,582.0,582.0
0.004,17,4,284,2,120,0.0,32.0,32.0,2,164,1.0,60.0,54.0
0.005,6,10,1779,5,928,1.0,660.0,660.0,5,851,1.0,583.0,583.0
0.1,6,10,1506,5,395,20.0,127.0,127.0,5,1111,22.0,843.0,843.0
0.065,17,2,152,1,76,0.0,48.0,48.0,1,76,0.0,48.0,48.0
0.004,6,10,2007,5,928,1.0,660.0,660.0,5,1079,1.0,811.0,811.0
0.006,17,2,144,1,64,0.0,36.0,36.0,1,80,0.0,52.0,52.0
0.009,6,10,1990,5,911,2.0,643.0,643.0,5,1079,2.0,811.0,811.0
40.075,17,10,676,5,460,10016.0,104.0,64.0,5,216,10016.0,20.0,15.0
0.01,6,10,1989,5,910,2.0,642.0,642.0,5,1079,2.0,811.0,811.0
0.014,6,10,1983,5,910,3.0,642.0,642.0,5,1073,3.0,805.0,805.0
0.011,6,10,1631,5,848,2.0,580.0,580.0,5,783,2.0,515.0,515.0
0.067,6,10,1506,5,395,12.0,127.0,127.0,5,1111,15.0,843.0,843.0
0.019,6,10,1990,5,911,4.0,643.0,643.0,5,1079,4.0,811.0,811.0
240.09,6,39,7002,19,3329,13338.0,880.0,333.0,20,3673,12636.0,1306.0,328.0
0.011,6,10,1990,5,911,2.0,643.0,643.0,5,1079,2.0,811.0,811.0
0.117,6,10,1506,5,395,26.0,127.0,127.0,5,1111,27.0,843.0,843.0
308.57,17,20,1124,10,716,34271.0,48.0,43.0,10,408,34271.0,20.0,12.0
0.004,17,2,136,1,60,0.0,32.0,32.0,1,76,0.0,48.0,48.0
240.301,6,22,11453,13,6875,20025.0,2736.0,1033.0,9,4578,30037.0,1656.0,1367.0
40.09,17,10,676,5,460,10021.0,104.0,64.0,5,216,10021.0,20.0,15.0
40.081,17,10,676,5,460,10017.0,104.0,64.0,5,216,10019.0,20.0,15.0
0.259,17,38,20208,21,17044,12.0,1350.0,783.0,17,3164,12.0,1350.0,158.0
0.022,6,10,1972,5,910,5.0,642.0,642.0,5,1062,5.0,794.0,794.0
0.005,17,2,212,1,74,0.0,46.0,46.0,1,138,0.0,110.0,110.0
0.005,6,10,2006,5,927,1.0,659.0,659.0,5,1079,1.0,811.0,811.0
293.846,6,391,347360,202,22068,1461.0,2736.0,888.0,189,325292,1562.0,2804.0,1802.0
0.011,6,10,1972,5,910,2.0,642.0,642.0,5,1062,2.0,794.0,794.0
0.02,6,10,1990,5,911,5.0,643.0,643.0,5,1079,5.0,811.0,811.0
0.009,6,10,1643,5,860,2.0,592.0,592.0,5,783,2.0,515.0,515.0
0.123,17,2,80,1,32,0.0,4.0,4.0,1,48,0.0,20.0,20.0
0.005,6,10,2006,5,927,1.0,659.0,659.0,5,1079,1.0,811.0,811.0
0.001,17,2,180,1,66,0.0,38.0,38.0,1,114,0.0,86.0,86.0
0.011,6,10,1983,5,910,2.0,642.0,642.0,5,1073,2.0,805.0,805.0
0.005,6,10,2006,5,927,1.0,659.0,659.0,5,1079,1.0,811.0,811.0
0.111,6,10,1506,5,395,25.0,127.0,127.0,5,1111,26.0,843.0,843.0
0.012,6,10,1631,5,848,3.0,580.0,580.0,5,783,2.0,515.0,515.0
300.026,6,12,1782,7,1348,50004.0,494.0,494.0,5,434,75005.0,83.0,83.0
0.005,17,2,166,1,75,0.0,47.0,47.0,1,91,0.0,63.0,63.0
0.006,17,2,144,1,64,0.0,36.0,36.0,1,80,0.0,52.0,52.0
0.006,17,2,170,1,65,0.0,37.0,37.0,1,105,0.0,77.0,77.0
300.386,6,16,2170,9,684,37526.0,146.0,146.0,7,1486,50037.0,419.0,398.0
0.013,6,10,1972,5,910,3.0,642.0,642.0,5,1062,3.0,794.0,794.0
0.006,17,2,136,1,60,0.0,32.0,32.0,1,76,0.0,48.0,48.0
0.005,6,10,1689,5,839,1.0,571.0,571.0,5,850,1.0,582.0,582.0
0.03,6,10,1972,5,910,7.0,642.0,642.0,5,1062,7.0,794.0,794.0
0.008,6,10,1990,5,911,1.0,643.0,643.0,5,1079,2.0,811.0,811.0
0.041,17,2,152,1,76,0.0,48.0,48.0,1,76,0.0,48.0,48.0
0.005,6,10,2007,5,928,1.0,660.0,660.0,5,1079,1.0,811.0,811.0
0.004,17,2,146,1,65,0.0,37.0,37.0,1,81,0.0,53.0,53.0
0.007,6,10,1989,5,910,1.0,642.0,642.0,5,1079,1.0,811.0,811.0
0.737,6,25,5459,12,1557,56.0,325.0,152.0,13,3902,51.0,1414.0,563.0
0.108,6,10,1506,5,395,25.0,127.0,127.0,5,1111,25.0,843.0,843.0
0.004,6,10,1702,5,863,1.0,595.0,595.0,5,839,0.0,571.0,571.0
300.253,6,27,7436,16,1409,20016.0,217.0,142.0,11,6027,24023.0,1679.0,778.0
0.006,6,10,1643,5,860,1.0,592.0,592.0,5,783,1.0,515.0,515.0
40.068,17,10,676,5,460,10013.0,104.0,64.0,5,216,10016.0,20.0,15.0
0.01,6,10,1990,5,911,2.0,643.0,643.0,5,1079,2.0,811.0,811.0
0.005,6,13,3747,7,509,0.0,137.0,137.0,6,3238,1.0,1470.0,1459.0
0.004,6,10,2006,5,927,1.0,659.0,659.0,5,1079,1.0,811.0,811.0
0.11,6,10,1506,5,395,24.0,127.0,127.0,5,1111,25.0,843.0,843.0
0.015,6,10,1989,5,910,3.0,642.0,642.0,5,1079,3.0,811.0,811.0
0.005,6,10,1779,5,928,1.0,660.0,660.0,5,851,1.0,583.0,583.0
0.143,6,10,1506,5,395,32.0,127.0,127.0,5,1111,33.0,843.0,843.0
0.005,6,10,1689,5,839,1.0,571.0,571.0,5,850,1.0,582.0,582.0
0.011,6,10,1989,5,910,2.0,642.0,642.0,5,1079,2.0,811.0,811.0
0.012,6,10,1989,5,910,3.0,642.0,642.0,5,1079,3.0,811.0,811.0
0.039,17,2,186,1,61,0.0,33.0,33.0,1,125,0.0,97.0,97.0
240.143,6,18,5748,10,1027,26682.0,238.0,166.0,8,4721,34305.0,1402.0,859.0
0.009,6,10,1972,5,910,2.0,642.0,642.0,5,1062,2.0,794.0,794.0
0.167,6,3,453,2,321,167.0,241.0,241.0,1,132,0.0,92.0,92.0
0.006,6,10,2006,5,927,1.0,659.0,659.0,5,1079,1.0,811.0,811.0
0.005,6,10,1689,5,839,1.0,571.0,571.0,5,850,1.0,582.0,582.0
0.006,6,13,3684,7,446,0.0,74.0,74.0,6,3238,1.0,1470.0,1459.0
0.004,6,10,2006,5,927,1.0,659.0,659.0,5,1079,1.0,811.0,811.0
0.005,6,10,2006,5,927,1.0,659.0,659.0,5,1079,1.0,811.0,811.0
0.008,6,10,1972,5,910,2.0,642.0,642.0,5,1062,2.0,794.0,794.0
10.721,17,26,4101,13,1821,884.0,268.0,112.0,13,2280,884.0,587.0,147.0
0.009,6,10,2006,5,927,2.0,659.0,659.0,5,1079,2.0,811.0,811.0
0.005,6,10,2006,5,927,1.0,659.0,659.0,5,1079,1.0,811.0,811.0
0.029,6,10,1972,5,910,7.0,642.0,642.0,5,1062,7.0,794.0,794.0
0.321,17,44,22103,24,18537,13.0,1350.0,744.0,20,3566,13.0,1350.0,150.0
0.014,6,10,1990,5,911,3.0,643.0,643.0,5,1079,3.0,811.0,811.0
0.004,6,10,1774,5,923,1.0,655.0,655.0,5,851,1.0,583.0,583.0
0.004,17,2,136,1,60,0.0,32.0,32.0,1,76,0.0,48.0,48.0
0.008,6,12,1926,6,1189,1.0,659.0,434.0,6,737,1.0,417.0,417.0
0.003,17,2,136,1,60,0.0,32.0,32.0,1,76,0.0,48.0,48.0
0.005,6,10,1547,5,764,1.0,496.0,496.0,5,783,1.0,515.0,515.0
0.016,6,10,1990,5,911,4.0,643.0,643.0,5,1079,4.0,811.0,811.0
0.005,6,13,3747,7,509,0.0,137.0,137.0,6,3238,1.0,1470.0,1459.0
0.005,6,10,2000,5,927,1.0,659.0,659.0,5,1073,1.0,805.0,805.0
0.021,6,10,1989,5,910,5.0,642.0,642.0,5,1079,5.0,811.0,811.0
0.006,6,10,1643,5,860,1.0,592.0,592.0,5,783,1.0,515.0,515.0
0.012,6,10,1990,5,911,2.0,643.0,643.0,5,1079,3.0,811.0,811.0
0.004,6,10,1702,5,863,0.0,595.0,595.0,5,839,1.0,571.0,571.0
0.005,6,10,1689,5,839,1.0,571.0,571.0,5,850,1.0,582.0,582.0
0.007,6,10,1972,5,910,1.0,642.0,642.0,5,1062,1.0,794.0,794.0
0.007,6,10,2006,5,927,1.0,659.0,659.0,5,1079,1.0,811.0,811.0
240.016,6,9,787,5,488,60004.0,232.0,232.0,4,299,80004.0,83.0,83.0
0.004,6,10,1779,5,928,1.0,660.0,660.0,5,851,1.0,583.0,583.0
0.008,6,10,1990,5,911,2.0,643.0,643.0,5,1079,2.0,811.0,811.0
0.003,17,2,136,1,60,0.0,32.0,32.0,1,76,0.0,48.0,48.0
355.581,6,20,2210,6,1308,12007.0,494.0,494.0,14,902,27351.0,83.0,83.0
0.01,6,10,1989,5,910,2.0,642.0,642.0,5,1079,2.0,811.0,811.0
0.005,6,10,2006,5,927,1.0,659.0,659.0,5,1079,1.0,811.0,811.0
300.493,6,31,8853,15,2539,21463.0,1223.0,347.0,16,6314,20032.0,1592.0,548.0
0.079,6,10,1506,5,395,16.0,127.0,127.0,5,1111,19.0,843.0,843.0
0.013,6,10,1989,5,910,3.0,642.0,642.0,5,1079,3.0,811.0,811.0
0.005,6,10,1774,5,923,1.0,655.0,655.0,5,851,1.0,583.0,583.0
0.004,17,4,284,2,120,1.0,32.0,32.0,2,164,0.0,60.0,54.0
0.018,6,10,1990,5,911,4.0,643.0,643.0,5,1079,4.0,811.0,811.0
0.004,17,4,284,2,120,0.0,32.0,32.0,2,164,1.0,60.0,54.0
0.005,6,10,2007,5,928,1.0,660.0,660.0,5,1079,1.0,811.0,811.0
0.005,6,10,2000,5,927,1.0,659.0,659.0,5,1073,1.0,805.0,805.0
0.062,17,2,152,1,76,0.0,48.0,48.0,1,76,0.0,48.0,48.0
40.074,17,10,676,5,460,10015.0,104.0,64.0,5,216,10017.0,20.0,15.0
0.747,6,22,5072,11,1250,64.0,325.0,133.0,11,3822,64.0,1414.0,563.0
0.127,17,4,596,2,122,1.0,33.0,33.0,2,474,87.0,323.0,209.0
0.009,6,10,1989,5,910,2.0,642.0,642.0,5,1079,2.0,811.0,811.0
0.005,17,2,170,1,65,0.0,37.0,37.0,1,105,0.0,77.0,77.0
0.007,6,10,1972,5,910,1.0,642.0,642.0,5,1062,1.0,794.0,794.0
0.005,17,2,164,1,74,0.0,46.0,46.0,1,90,0.0,62.0,62.0
0.06,6,10,1506,5,395,14.0,127.0,127.0,5,1111,12.0,843.0,843.0
0.005,17,2,170,1,65,0.0,37.0,37.0,1,105,0.0,77.0,77.0
0.042,6,10,1983,5,910,10.0,642.0,642.0,5,1073,10.0,805.0,805.0
353.519,6,20,2210,6,1308,12003.0,494.0,494.0,14,902,27193.0,83.0,83.0
0.07,6,10,1506,5,395,15.0,127.0,127.0,5,1111,14.0,843.0,843.0
0.123,6,10,1506,5,395,22.0,127.0,127.0,5,1111,25.0,843.0,843.0
0.009,6,10,1989,5,910,2.0,642.0,642.0,5,1079,2.0,811.0,811.0
0.006,6,10,1547,5,764,1.0,496.0,496.0,5,783,1.0,515.0,515.0
0.014,6,10,1989,5,910,3.0,642.0,642.0,5,1079,3.0,811.0,811.0
0.006,6,10,1547,5,764,1.0,496.0,496.0,5,783,1.0,515.0,515.0
0.225,6,16,2669,8,1395,32.0,533.0,323.0,8,1274,20.0,529.0,212.0
0.005,6,13,3747,7,509,0.0,137.0,137.0,6,3238,1.0,1470.0,1459.0
0.015,6,10,1677,5,827,3.0,559.0,559.0,5,850,3.0,582.0,582.0
15.071,17,15,9238,8,6902,2148.0,1350.0,834.0,7,2336,2507.0,1350.0,305.0
0.012,6,10,1990,5,911,3.0,643.0,643.0,5,1079,3.0,811.0,811.0
0.012,6,14,3787,7,497,2.0,125.0,125.0,7,3290,2.0,1448.0,972.0
259.382,6,11,891,5,488,64845.0,232.0,232.0,6,403,51872.0,83.0,83.0
0.079,6,10,1506,5,395,16.0,127.0,127.0,5,1111,17.0,843.0,843.0
0.004,6,10,1989,5,927,1.0,659.0,659.0,5,1062,1.0,794.0,794.0
0.116,6,10,1506,5,395,21.0,127.0,127.0,5,1111,26.0,843.0,843.0
240.015,6,9,787,5,488,60003.0,232.0,232.0,4,299,80004.0,83.0,83.0
0.17,17,2,80,1,32,0.0,4.0,4.0,1,48,0.0,20.0,20.0
40.063,17,10,676,5,460,10012.0,104.0,64.0,5,216,10015.0,20.0,15.0
0.009,6,10,1989,5,910,2.0,642.0,642.0,5,1079,2.0,811.0,811.0
0.012,6,10,1762,5,911,3.0,643.0,643.0,5,851,2.0,583.0,583.0
0.002,17,2,136,1,60,0.0,32.0,32.0,1,76,0.0,48.0,48.0
0.006,17,2,179,1,71,0.0,43.0,43.0,1,108,0.0,80.0,80.0
0.004,6,10,2006,5,927,1.0,659.0,659.0,5,1079,1.0,811.0,811.0
0.016,6,10,1989,5,910,4.0,642.0,642.0,5,1079,3.0,811.0,811.0
0.005,6,10,2006,5,927,1.0,659.0,659.0,5,1079,1.0,811.0,811.0
1772.007,6,103,6166,59,3473,30551.0,27.0,27.0,44,2693,41208.0,27.0,27.0
240.333,6,33,8636,17,1836,15020.0,569.0,188.0,16,6800,16021.0,1402.0,597.0
314.371,17,20,1124,10,716,34916.0,48.0,43.0,10,408,34916.0,20.0,12.0
0.126,6,10,1242,5,751,31.0,495.0,495.0,5,491,29.0,223.0,223.0
0.099,6,10,1506,5,395,21.0,127.0,127.0,5,1111,21.0,843.0,843.0
0.057,17,2,179,1,71,0.0,43.0,43.0,1,108,0.0,80.0,80.0
0.007,6,10,1779,5,928,1.0,660.0,660.0,5,851,1.0,583.0,583.0
15.078,17,14,9191,8,6902,2149.0,1350.0,834.0,6,2289,3009.0,1350.0,353.0
0.014,6,10,1677,5,827,3.0,559.0,559.0,5,850,3.0,582.0,582.0
0.014,6,10,1989,5,910,3.0,642.0,642.0,5,1079,3.0,811.0,811.0
0.011,6,10,1972,5,910,2.0,642.0,642.0,5,1062,2.0,794.0,794.0
176.543,17,88,12584,44,2941,4105.0,44.0,38.0,44,9643,4105.0,239.0,191.0
0.013,6,10,1989,5,910,3.0,642.0,642.0,5,1079,3.0,811.0,811.0
0.109,6,10,1506,5,395,26.0,127.0,127.0,5,1111,25.0,843.0,843.0
0.001,17,2,180,1,66,0.0,38.0,38.0,1,114,0.0,86.0,86.0
0.018,6,10,1990,5,911,4.0,643.0,643.0,5,1079,4.0,811.0,811.0
0.098,6,10,1506,5,395,22.0,127.0,127.0,5,1111,20.0,843.0,843.0
0.143,6,10,1506,5,395,34.0,127.0,127.0,5,1111,29.0,843.0,843.0
0.089,6,10,1506,5,395,19.0,127.0,127.0,5,1111,21.0,843.0,843.0
0.004,6,10,2007,5,928,1.0,660.0,660.0,5,1079,1.0,811.0,811.0
40.062,17,10,676,5,460,10014.0,104.0,64.0,5,216,10014.0,20.0,15.0
11.175,17,28,4422,14,1994,847.0,269.0,114.0,14,2428,847.0,587.0,145.0
0.005,6,10,1989,5,927,1.0,659.0,659.0,5,1062,1.0,794.0,794.0
0.011,6,10,1989,5,910,2.0,642.0,642.0,5,1079,2.0,811.0,811.0
0.143,6,10,1506,5,395,34.0,127.0,127.0,5,1111,34.0,843.0,843.0
0.015,6,10,1989,5,910,3.0,642.0,642.0,5,1079,3.0,811.0,811.0
0.004,6,13,3690,7,452,0.0,80.0,80.0,6,3238,0.0,1470.0,1459.0
0.009,6,10,1989,5,910,2.0,642.0,642.0,5,1079,2.0,811.0,811.0
0.054,17,2,144,1,64,0.0,36.0,36.0,1,80,0.0,52.0,52.0
0.006,6,10,1547,5,764,1.0,496.0,496.0,5,783,1.0,515.0,515.0
0.013,6,10,1972,5,910,3.0,642.0,642.0,5,1062,3.0,794.0,794.0
0.02,6,10,1677,5,827,5.0,559.0,559.0,5,850,4.0,582.0,582.0
169.065,17,74,10563,37,2458,4696.0,44.0,38.0,37,8105,4696.0,239.0,191.0
0.012,6,10,1989,5,910,3.0,642.0,642.0,5,1079,3.0,811.0,811.0
0.019,6,10,1631,5,848,4.0,580.0,580.0,5,783,4.0,515.0,515.0
0.006,6,12,1698,6,863,1.0,327.0,271.0,6,835,1.0,515.0,515.0
241.447,6,297,342605,117,17599,2081.0,2736.0,959.0,180,325006,1348.0,2804.0,1856.0
0.069,6,10,1506,5,395,13.0,127.0,127.0,5,1111,15.0,843.0,843.0
0.008,6,10,1762,5,911,2.0,643.0,643.0,5,851,2.0,583.0,583.0
0.006,6,10,1989,5,927,1.0,659.0,659.0,5,1062,1.0,794.0,794.0
0.015,6,10,1990,5,911,3.0,643.0,643.0,5,1079,3.0,811.0,811.0
240.092,6,16,4482,9,963,30011.0,238.0,166.0,7,3519,40014.0,1402.0,786.0
0.067,6,10,1506,5,395,15.0,127.0,127.0,5,1111,14.0,843.0,843.0
0.005,17,2,148,1,60,0.0,32.0,32.0,1,88,0.0,60.0,60.0
0.12,6,10,1506,5,395,25.0,127.0,127.0,5,1111,25.0,843.0,843.0
0.006,6,10,1547,5,764,1.0,496.0,496.0,5,783,1.0,515.0,515.0
0.008,6,10,1990,5,911,2.0,643.0,643.0,5,1079,2.0,811.0,811.0
0.091,6,10,1506,5,395,19.0,127.0,127.0,5,1111,21.0,843.0,843.0
0.004,6,10,1702,5,863,0.0,595.0,595.0,5,839,1.0,571.0,571.0
0.005,6,10,1989,5,927,1.0,659.0,659.0,5,1062,1.0,794.0,794.0
0.038,17,2,156,1,64,0.0,36.0,36.0,1,92,0.0,64.0,64.0
0.057,6,10,1506,5,395,13.0,127.0,127.0,5,1111,13.0,843.0,843.0
0.005,6,10,2007,5,928,1.0,660.0,660.0,5,1079,1.0,811.0,811.0
0.191,6,24,6587,12,2065,16.0,746.0,286.0,12,4522,16.0,1324.0,778.0
0.012,6,10,1990,5,911,3.0,643.0,643.0,5,1079,2.0,811.0,811.0
0.011,6,14,3787,7,497,1.0,125.0,125.0,7,3290,1.0,1448.0,972.0
0.009,6,10,1677,5,827,2.0,559.0,559.0,5,850,2.0,582.0,582.0
0.086,17,4,336,2,124,1.0,34.0,34.0,2,212,33.0,84.0,78.0
0.109,6,10,1506,5,395,23.0,127.0,127.0,5,1111,23.0,843.0,843.0
0.018,6,10,1989,5,910,4.0,642.0,642.0,5,1079,4.0,811.0,811.0
0.116,6,10,1506,5,395,24.0,127.0,127.0,5,1111,23.0,843.0,843.0
0.17,17,2,152,1,76,0.0,48.0,48.0,1,76,0.0,48.0,48.0
0.015,6,10,1972,5,910,3.0,642.0,642.0,5,1062,3.0,794.0,794.0
369.853,6,22,2313,16,867,24656.0,195.0,195.0,6,1446,4635.0,419.0,398.0
0.039,17,2,144,1,64,0.0,36.0,36.0,1,80,0.0,52.0,52.0
0.0,17,2,140,1,62,0.0,34.0,34.0,1,78,0.0,50.0,50.0
0.005,6,10,2007,5,928,1.0,660.0,660.0,5,1079,1.0,811.0,811.0
10.735,17,24,3781,12,1673,966.0,268.0,111.0,12,2108,966.0,587.0,147.0
361.84,6,21,1793,16,1030,24122.0,190.0,190.0,5,763,60010.0,462.0,247.0
0.005,6,10,2000,5,927,1.0,659.0,659.0,5,1073,1.0,805.0,805.0
0.103,6,10,1506,5,395,22.0,127.0,127.0,5,1111,20.0,843.0,843.0
0.004,6,10,2006,5,927,1.0,659.0,659.0,5,1079,1.0,811.0,811.0
0.006,6,10,1989,5,910,1.0,642.0,642.0,5,1079,1.0,811.0,811.0
300.313,6,16,2170,9,684,37517.0,146.0,146.0,7,1486,50023.0,419.0,398.0
0.005,6,10,2000,5,927,1.0,659.0,659.0,5,1073,1.0,805.0,805.0
0.012,6,10,1972,5,910,3.0,642.0,642.0,5,1062,3.0,794.0,794.0
0.005,17,2,164,1,74,0.0,46.0,46.0,1,90,0.0,62.0,62.0
40.058,17,10,676,5,460,10011.0,104.0,64.0,5,216,10013.0,20.0,15.0
0.006,17,2,293,1,73,0.0,45.0,45.0,1,220,0.0,192.0,192.0
0.037,17,2,184,1,61,0.0,33.0,33.0,1,123,0.0,95.0,95.0
0.001,17,2,154,1,69,0.0,41.0,41.0,1,85,0.0,57.0,57.0
0.141,6,10,1506,5,395,31.0,127.0,127.0,5,1111,33.0,843.0,843.0
0.005,6,10,2006,5,927,1.0,659.0,659.0,5,1079,1.0,811.0,811.0
0.07,6,10,1506,5,395,17.0,127.0,127.0,5,1111,13.0,843.0,843.0
0.009,6,10,1972,5,910,2.0,642.0,642.0,5,1062,2.0,794.0,794.0
15.441,17,44,20430,23,17140,700.0,1350.0,717.0,21,3290,770.0,1350.0,128.0
0.003,17,2,148,1,60,0.0,32.0,32.0,1,88,0.0,60.0,60.0
66.316,6,29,19864,16,11872,4421.0,2804.0,1576.0,13,7992,5512.0,2311.0,1218.0
0.267,17,39,20240,21,17038,13.0,1350.0,783.0,18,3202,12.0,1350.0,149.0
0.014,6,13,3735,7,497,2.0,125.0,125.0,6,3238,2.0,1470.0,1459.0
0.006,6,10,1689,5,839,1.0,571.0,571.0,5,850,1.0,582.0,582.0
0.016,6,10,1983,5,910,4.0,642.0,642.0,5,1073,4.0,805.0,805.0
0.01,6,10,1972,5,910,2.0,642.0,642.0,5,1062,2.0,794.0,794.0
0.004,6,10,2000,5,927,1.0,659.0,659.0,5,1073,1.0,805.0,805.0
40.069,17,10,676,5,460,10015.0,104.0,64.0,5,216,10016.0,20.0,15.0
0.01,6,10,1983,5,910,2.0,642.0,642.0,5,1073,2.0,805.0,805.0
0.107,6,10,1506,5,395,22.0,127.0,127.0,5,1111,21.0,843.0,843.0
0.128,6,10,1506,5,395,28.0,127.0,127.0,5,1111,29.0,843.0,843.0
0.013,6,10,1989,5,910,3.0,642.0,642.0,5,1079,3.0,811.0,811.0
0.005,17,2,169,1,62,0.0,34.0,34.0,1,107,0.0,79.0,79.0
0.005,6,13,3690,7,452,0.0,80.0,80.0,6,3238,1.0,1470.0,1459.0
0.006,6,10,1547,5,764,1.0,496.0,496.0,5,783,1.0,515.0,515.0
0.149,6,10,1506,5,395,34.0,127.0,127.0,5,1111,33.0,843.0,843.0
0.011,6,10,1983,5,910,2.0,642.0,642.0,5,1073,2.0,805.0,805.0
0.04,17,4,352,2,130,0.0,37.0,37.0,2,222,36.0,89.0,83.0
0.009,6,10,1547,5,764,2.0,496.0,496.0,5,783,2.0,515.0,515.0
0.011,6,10,1989,5,910,2.0,642.0,642.0,5,1079,2.0,811.0,811.0
0.004,6,10,1774,5,923,1.0,655.0,655.0,5,851,1.0,583.0,583.0
0.006,6,10,1547,5,764,1.0,496.0,496.0,5,783,1.0,515.0,515.0
0.099,6,10,1506,5,395,23.0,127.0,127.0,5,1111,23.0,843.0,843.0
40.066,17,10,676,5,460,10015.0,104.0,64.0,5,216,10015.0,20.0,15.0
0.014,6,10,1983,5,910,3.0,642.0,642.0,5,1073,3.0,805.0,805.0
0.013,6,10,1689,5,839,3.0,571.0,571.0,5,850,3.0,582.0,582.0
0.006,6,10,1854,5,889,1.0,621.0,621.0,5,965,1.0,697.0,697.0
0.001,17,2,154,1,69,0.0,41.0,41.0,1,85,0.0,57.0,57.0
0.004,6,10,1989,5,927,1.0,659.0,659.0,5,1062,1.0,794.0,794.0
0.069,17,8,3613,4,1874,23.0,1350.0,440.0,4,1739,11.0,1350.0,406.0
0.016,6,10,1762,5,911,4.0,643.0,643.0,5,851,3.0,583.0,583.0
0.183,17,4,596,2,122,179.0,33.0,33.0,2,474,111.0,323.0,209.0
0.012,6,10,1990,5,911,2.0,643.0,643.0,5,1079,3.0,811.0,811.0
290.262,6,402,348761,209,22423,1395.0,2736.0,888.0,193,326338,1511.0,2804.0,1767.0
0.005,17,2,144,1,64,0.0,36.0,36.0,1,80,0.0,52.0,52.0
441.614,6,35,13374,17,3205,27600.0,661.0,385.0,18,10169,22447.0,1402.0,838.0
0.003,17,4,284,2,120,0.0,32.0,32.0,2,164,0.0,60.0,54.0
0.006,6,10,1989,5,927,1.0,659.0,659.0,5,1062,1.0,794.0,794.0
15.078,17,15,8168,8,6082,2149.0,1350.0,732.0,7,2086,2508.0,1350.0,270.0
0.013,6,10,1972,5,910,3.0,642.0,642.0,5,1062,3.0,794.0,794.0
1778.352,17,144,41760,72,22752,25047.0,288.0,288.0,72,19008,25047.0,236.0,236.0
0.005,17,2,152,1,76,0.0,48.0,48.0,1,76,0.0,48.0,48.0
0.016,6,10,1972,5,910,4.0,642.0,642.0,5,1062,4.0,794.0,794.0
15.071,17,15,9239,8,6902,2149.0,1350.0,834.0,7,2337,2507.0,1350.0,305.0
0.069,6,10,1506,5,395,14.0,127.0,127.0,5,1111,16.0,843.0,843.0
40.057,17,10,676,5,460,10013.0,104.0,64.0,5,216,10013.0,20.0,15.0
0.041,17,2,152,1,76,0.0,48.0,48.0,1,76,0.0,48.0,48.0
0.006,6,10,1547,5,764,1.0,496.0,496.0,5,783,1.0,515.0,515.0
0.004,6,10,2000,5,927,1.0,659.0,659.0,5,1073,1.0,805.0,805.0
0.002,17,2,180,1,66,0.0,38.0,38.0,1,114,0.0,86.0,86.0
0.001,17,2,180,1,65,0.0,37.0,37.0,1,115,0.0,87.0,87.0
0.004,6,10,1702,5,863,1.0,595.0,595.0,5,839,0.0,571.0,571.0
0.016,6,10,1983,5,910,3.0,642.0,642.0,5,1073,3.0,805.0,805.0
0.006,6,10,1547,5,764,1.0,496.0,496.0,5,783,1.0,515.0,515.0
240.027,6,9,787,5,488,60006.0,232.0,232.0,4,299,80008.0,83.0,83.0
0.004,6,10,2000,5,927,1.0,659.0,659.0,5,1073,1.0,805.0,805.0
0.005,17,2,230,1,68,0.0,40.0,40.0,1,162,0.0,134.0,134.0
0.016,6,10,1989,5,910,4.0,642.0,642.0,5,1079,4.0,811.0,811.0
0.001,17,2,180,1,66,0.0,38.0,38.0,1,114,0.0,86.0,86.0
0.005,6,10,2000,5,927,1.0,659.0,659.0,5,1073,1.0,805.0,805.0
292.906,6,406,349427,195,21711,1509.0,2736.0,889.0,211,327716,1394.0,2804.0,1607.0
23.305,6,43,14496,22,8629,430.0,2720.0,1102.0,21,5867,1157.0,2667.0,385.0
0.061,6,10,1506,5,395,13.0,127.0,127.0,5,1111,12.0,843.0,843.0
0.168,17,2,152,1,76,0.0,48.0,48.0,1,76,0.0,48.0,48.0
0.043,17,2,152,1,76,0.0,48.0,48.0,1,76,0.0,48.0,48.0
15.083,17,17,10673,9,8280,1881.0,1350.0,892.0,8,2393,2148.0,1350.0,271.0
0.008,6,10,1989,5,910,1.0,642.0,642.0,5,1079,1.0,811.0,811.0
0.006,6,10,1547,5,764,1.0,496.0,496.0,5,783,1.0,515.0,515.0
0.002,17,2,185,1,73,0.0,45.0,45.0,1,112,0.0,84.0,84.0
0.018,6,10,1983,5,910,4.0,642.0,642.0,5,1073,4.0,805.0,805.0
0.005,6,13,3690,7,452,0.0,80.0,80.0,6,3238,0.0,1470.0,1459.0
0.003,17,2,148,1,60,0.0,32.0,32.0,1,88,0.0,60.0,60.0
15.072,17,15,9238,8,6902,2149.0,1350.0,834.0,7,2336,2507.0,1350.0,305.0
11.262,17,28,4423,14,1995,853.0,270.0,114.0,14,2428,853.0,587.0,145.0
0.011,6,10,1983,5,910,2.0,642.0,642.0,5,1073,2.0,805.0,805.0
0.014,6,10,1631,5,848,3.0,580.0,580.0,5,783,3.0,515.0,515.0
0.005,6,10,1989,5,927,1.0,659.0,659.0,5,1062,1.0,794.0,794.0
0.041,17,2,152,1,76,0.0,48.0,48.0,1,76,0.0,48.0,48.0
0.043,17,2,136,1,60,0.0,32.0,32.0,1,76,0.0,48.0,48.0
15.076,17,15,8144,8,5984,2149.0,1350.0,720.0,7,2160,2507.0,1350.0,280.0
0.065,6,10,1506,5,395,13.0,127.0,127.0,5,1111,15.0,843.0,843.0
0.004,6,10,2007,5,928,1.0,660.0,660.0,5,1079,1.0,811.0,811.0
0.106,6,10,1506,5,395,24.0,127.0,127.0,5,1111,23.0,843.0,843.0
0.004,17,4,284,2,120,1.0,32.0,32.0,2,164,0.0,60.0,54.0
0.075,6,10,1506,5,395,15.0,127.0,127.0,5,1111,16.0,843.0,843.0
15.171,17,20,11293,10,7761,1682.0,1350.0,748.0,10,3532,1682.0,1350.0,325.0
0.084,6,10,1506,5,395,20.0,127.0,127.0,5,1111,19.0,843.0,843.0
0.082,6,10,1506,5,395,18.0,127.0,127.0,5,1111,18.0,843.0,843.0
0.011,6,10,1983,5,910,2.0,642.0,642.0,5,1073,2.0,805.0,805.0
0.069,6,10,1506,5,395,15.0,127.0,127.0,5,1111,15.0,843.0,843.0
0.014,6,10,1983,5,910,3.0,642.0,642.0,5,1073,3.0,805.0,805.0
0.003,17,2,136,1,60,0.0,32.0,32.0,1,76,0.0,48.0,48.0
0.008,6,12,1926,6,1189,1.0,659.0,434.0,6,737,1.0,417.0,417.0
0.016,6,10,1972,5,910,3.0,642.0,642.0,5,1062,3.0,794.0,794.0
0.007,17,2,164,1,74,0.0,46.0,46.0,1,90,0.0,62.0,62.0
0.006,6,10,1547,5,764,1.0,496.0,496.0,5,783,1.0,515.0,515.0
40.072,17,10,676,5,460,10012.0,104.0,64.0,5,216,10015.0,20.0,15.0
0.132,6,10,1506,5,395,30.0,127.0,127.0,5,1111,29.0,843.0,843.0
0.003,17,4,284,2,120,0.0,32.0,32.0,2,164,0.0,60.0,54.0
0.084,6,10,1506,5,395,17.0,127.0,127.0,5,1111,18.0,843.0,843.0
0.005,6,10,2006,5,927,1.0,659.0,659.0,5,1079,1.0,811.0,811.0
0.002,17,2,174,1,72,0.0,44.0,44.0,1,102,0.0,74.0,74.0
0.006,6,10,1854,5,889,1.0,621.0,621.0,5,965,1.0,697.0,697.0
0.006,6,10,2007,5,928,1.0,660.0,660.0,5,1079,1.0,811.0,811.0
0.175,17,2,152,1,76,0.0,48.0,48.0,1,76,0.0,48.0,48.0
0.006,6,10,1854,5,889,1.0,621.0,621.0,5,965,1.0,697.0,697.0
0.004,6,10,1989,5,927,1.0,659.0,659.0,5,1062,1.0,794.0,794.0
0.004,6,10,2006,5,927,1.0,659.0,659.0,5,1079,1.0,811.0,811.0
0.017,6,10,1677,5,827,4.0,559.0,559.0,5,850,4.0,582.0,582.0
0.016,6,10,1989,5,910,3.0,642.0,642.0,5,1079,3.0,811.0,811.0
0.005,6,10,2006,5,927,1.0,659.0,659.0,5,1079,1.0,811.0,811.0
0.12,6,21,7389,11,2564,12.0,1368.0,493.0,10,4825,13.0,1655.0,859.0
0.005,6,13,3747,7,509,0.0,137.0,137.0,6,3238,1.0,1470.0,1459.0
0.005,6,10,1989,5,927,1.0,659.0,659.0,5,1062,1.0,794.0,794.0
0.01,6,13,3735,7,497,1.0,125.0,125.0,6,3238,1.0,1470.0,1459.0
0.005,17,2,144,1,64,0.0,36.0,36.0,1,80,0.0,52.0,52.0
0.005,6,10,2007,5,928,1.0,660.0,660.0,5,1079,1.0,811.0,811.0
0.04,17,2,152,1,76,0.0,48.0,48.0,1,76,0.0,48.0,48.0
0.005,6,10,1689,5,839,1.0,571.0,571.0,5,850,1.0,582.0,582.0
0.021,6,10,1972,5,910,5.0,642.0,642.0,5,1062,5.0,794.0,794.0
0.005,6,10,2000,5,927,1.0,659.0,659.0,5,1073,1.0,805.0,805.0
0.006,6,10,1854,5,889,1.0,621.0,621.0,5,965,1.0,697.0,697.0
0.015,6,10,1989,5,910,3.0,642.0,642.0,5,1079,3.0,811.0,811.0
0.005,6,10,1989,5,927,1.0,659.0,659.0,5,1062,1.0,794.0,794.0
0.011,6,10,1989,5,910,2.0,642.0,642.0,5,1079,2.0,811.0,811.0
0.005,17,2,214,1,75,0.0,47.0,47.0,1,139,0.0,111.0,111.0
0.02,6,10,1983,5,910,4.0,642.0,642.0,5,1073,4.0,805.0,805.0
0.072,17,2,144,1,64,0.0,36.0,36.0,1,80,0.0,52.0,52.0
0.122,6,10,1506,5,395,27.0,127.0,127.0,5,1111,28.0,843.0,843.0
0.005,6,10,1547,5,764,1.0,496.0,496.0,5,783,1.0,515.0,515.0
0.006,6,10,1547,5,764,1.0,496.0,496.0,5,783,1.0,515.0,515.0
0.029,6,13,3735,7,497,4.0,125.0,125.0,6,3238,5.0,1470.0,1459.0
0.004,6,10,1702,5,863,1.0,595.0,595.0,5,839,0.0,571.0,571.0
0.02,6,10,1972,5,910,5.0,642.0,642.0,5,1062,4.0,794.0,794.0
0.005,6,10,1989,5,927,1.0,659.0,659.0,5,1062,1.0,794.0,794.0
300.341,6,16,2170,9,684,37520.0,146.0,146.0,7,1486,50027.0,419.0,398.0
0.118,6,10,1506,5,395,23.0,127.0,127.0,5,1111,26.0,843.0,843.0
40.061,17,10,676,5,460,10013.0,104.0,64.0,5,216,10014.0,20.0,15.0
0.012,6,10,1762,5,911,3.0,643.0,643.0,5,851,2.0,583.0,583.0
44.34,17,8,428,4,260,14735.0,48.0,37.0,4,168,14735.0,20.0,14.0
0.005,17,2,179,1,71,0.0,43.0,43.0,1,108,0.0,80.0,80.0
0.014,6,10,1990,5,911,3.0,643.0,643.0,5,1079,3.0,811.0,811.0
0.012,6,10,1762,5,911,2.0,643.0,643.0,5,851,3.0,583.0,583.0
240.075,6,21,4924,11,941,24007.0,180.0,93.0,10,3983,26674.0,1591.0,575.0
0.073,6,10,1506,5,395,15.0,127.0,127.0,5,1111,15.0,843.0,843.0
40.063,17,10,676,5,460,10012.0,104.0,64.0,5,216,10014.0,20.0,15.0
0.008,6,10,1990,5,911,2.0,643.0,643.0,5,1079,2.0,811.0,811.0
0.004,6,10,2006,5,927,1.0,659.0,659.0,5,1079,1.0,811.0,811.0
0.011,6,10,1989,5,910,2.0,642.0,642.0,5,1079,2.0,811.0,811.0
1757.231,6,106,6292,60,3510,29782.0,26.0,26.0,46,2782,39048.0,26.0,26.0
0.011,6,10,1989,5,910,2.0,642.0,642.0,5,1079,2.0,811.0,811.0
0.102,6,10,1506,5,395,23.0,127.0,127.0,5,1111,23.0,843.0,843.0
0.007,6,10,1989,5,927,1.0,659.0,659.0,5,1062,1.0,794.0,794.0
0.012,6,10,1972,5,910,3.0,642.0,642.0,5,1062,2.0,794.0,794.0
0.021,6,10,1990,5,911,5.0,643.0,643.0,5,1079,5.0,811.0,811.0
0.11,6,10,1506,5,395,18.0,127.0,127.0,5,1111,25.0,843.0,843.0
0.003,17,2,136,1,60,0.0,32.0,32.0,1,76,0.0,48.0,48.0
0.21,6,16,2778,8,1396,30.0,533.0,324.0,8,1382,19.0,529.0,239.0
0.016,6,10,1972,5,910,4.0,642.0,642.0,5,1062,3.0,794.0,794.0
0.068,6,10,1506,5,395,14.0,127.0,127.0,5,1111,14.0,843.0,843.0
0.005,6,10,1779,5,928,1.0,660.0,660.0,5,851,1.0,583.0,583.0
0.001,17,2,180,1,66,0.0,38.0,38.0,1,114,0.0,86.0,86.0
0.006,6,10,1547,5,764,1.0,496.0,496.0,5,783,1.0,515.0,515.0
0.004,6,10,1774,5,923,1.0,655.0,655.0,5,851,1.0,583.0,583.0
0.006,6,10,1689,5,839,1.0,571.0,571.0,5,850,1.0,582.0,582.0
0.012,6,10,1983,5,910,3.0,642.0,642.0,5,1073,3.0,805.0,805.0
0.005,6,10,2000,5,927,1.0,659.0,659.0,5,1073,1.0,805.0,805.0
0.005,6,10,1989,5,927,1.0,659.0,659.0,5,1062,1.0,794.0,794.0
0.004,17,2,148,1,60,0.0,32.0,32.0,1,88,0.0,60.0,60.0
0.015,6,10,1990,5,911,3.0,643.0,643.0,5,1079,3.0,811.0,811.0
1786.783,6,342,77207,147,58563,12237.0,2790.0,449.0,195,18644,9209.0,1360.0,125.0
0.006,6,10,1547,5,764,1.0,496.0,496.0,5,783,1.0,515.0,515.0
0.797,6,22,5168,11,1138,67.0,267.0,115.0,11,4030,66.0,1414.0,597.0
0.005,6,13,3747,7,509,0.0,137.0,137.0,6,3238,1.0,1470.0,1459.0
0.012,6,13,3735,7,497,2.0,125.0,125.0,6,3238,2.0,1470.0,1459.0
0.006,17,2,156,1,70,0.0,42.0,42.0,1,86,0.0,58.0,58.0
0.012,6,10,1983,5,910,2.0,642.0,642.0,5,1073,3.0,805.0,805.0
0.08,6,10,1506,5,395,19.0,127.0,127.0,5,1111,16.0,843.0,843.0
0.0,17,2,180,1,66,0.0,38.0,38.0,1,114,0.0,86.0,86.0
0.012,6,10,1631,5,848,3.0,580.0,580.0,5,783,3.0,515.0,515.0
0.005,17,2,136,1,60,0.0,32.0,32.0,1,76,0.0,48.0,48.0
0.109,6,10,1506,5,395,24.0,127.0,127.0,5,1111,24.0,843.0,843.0
0.004,17,2,148,1,60,0.0,32.0,32.0,1,88,0.0,60.0,60.0
0.001,17,2,180,1,66,0.0,38.0,38.0,1,114,0.0,86.0,86.0
0.004,6,10,2006,5,927,1.0,659.0,659.0,5,1079,1.0,811.0,811.0
0.12,6,10,1506,5,395,24.0,127.0,127.0,5,1111,27.0,843.0,843.0
0.005,6,10,2007,5,928,1.0,660.0,660.0,5,1079,1.0,811.0,811.0
0.102,6,10,1506,5,395,21.0,127.0,127.0,5,1111,21.0,843.0,843.0
0.011,6,10,1989,5,910,2.0,642.0,642.0,5,1079,2.0,811.0,811.0
0.093,6,10,1506,5,395,20.0,127.0,127.0,5,1111,19.0,843.0,843.0
0.327,17,2,144,1,64,0.0,36.0,36.0,1,80,0.0,52.0,52.0
0.004,6,10,2007,5,928,1.0,660.0,660.0,5,1079,1.0,811.0,811.0
0.016,17,2,198,1,91,0.0,63.0,63.0,1,107,0.0,79.0,79.0
0.004,17,2,140,1,62,0.0,34.0,34.0,1,78,0.0,50.0,50.0
240.009,6,9,787,5,488,60002.0,232.0,232.0,4,299,80002.0,83.0,83.0
0.004,17,2,136,1,60,0.0,32.0,32.0,1,76,0.0,48.0,48.0
0.014,6,10,1990,5,911,3.0,643.0,643.0,5,1079,3.0,811.0,811.0
0.011,6,10,1677,5,827,2.0,559.0,559.0,5,850,2.0,582.0,582.0
178.079,17,74,10473,37,2474,4946.0,44.0,38.0,37,7999,4946.0,261.0,188.0
0.012,6,10,1989,5,910,2.0,642.0,642.0,5,1079,2.0,811.0,811.0
0.018,6,10,1989,5,910,4.0,642.0,642.0,5,1079,4.0,811.0,811.0
0.005,6,10,1989,5,927,1.0,659.0,659.0,5,1062,1.0,794.0,794.0
0.172,17,2,152,1,76,0.0,48.0,48.0,1,76,0.0,48.0,48.0
0.076,6,10,1506,5,395,16.0,127.0,127.0,5,1111,16.0,843.0,843.0
308.331,17,20,1124,10,716,34244.0,48.0,43.0,10,408,34244.0,20.0,12.0
0.006,17,2,239,1,63,0.0,35.0,35.0,1,176,0.0,148.0,148.0
0.005,6,10,2000,5,927,1.0,659.0,659.0,5,1073,1.0,805.0,805.0
0.01,6,10,1762,5,911,2.0,643.0,643.0,5,851,2.0,583.0,583.0
1777.742,17,144,41760,72,22752,25038.0,288.0,288.0,72,19008,25038.0,236.0,236.0
40.06,17,10,676,5,460,10012.0,104.0,64.0,5,216,10014.0,20.0,15.0
0.005,6,10,1547,5,764,1.0,496.0,496.0,5,783,1.0,515.0,515.0
0.011,6,14,3787,7,497,1.0,125.0,125.0,7,3290,1.0,1448.0,972.0
0.005,17,2,166,1,75,0.0,47.0,47.0,1,91,0.0,63.0,63.0
0.001,17,2,180,1,66,0.0,38.0,38.0,1,114,0.0,86.0,86.0
0.005,6,10,1643,5,860,1.0,592.0,592.0,5,783,1.0,515.0,515.0
0.011,6,10,1989,5,910,2.0,642.0,642.0,5,1079,2.0,811.0,811.0
0.074,6,10,1506,5,395,15.0,127.0,127.0,5,1111,16.0,843.0,843.0
0.063,6,10,1506,5,395,14.0,127.0,127.0,5,1111,14.0,843.0,843.0
0.144,6,10,1506,5,395,28.0,127.0,127.0,5,1111,34.0,843.0,843.0
0.042,17,2,412,1,61,0.0,33.0,33.0,1,351,0.0,323.0,323.0
0.005,6,10,1702,5,863,1.0,595.0,595.0,5,839,1.0,571.0,571.0
0.079,6,10,1506,5,395,17.0,127.0,127.0,5,1111,18.0,843.0,843.0
0.004,6,10,2007,5,928,1.0,660.0,660.0,5,1079,1.0,811.0,811.0
0.018,6,10,1990,5,911,4.0,643.0,643.0,5,1079,4.0,811.0,811.0
0.015,17,2,166,1,75,0.0,47.0,47.0,1,91,0.0,63.0,63.0
0.004,6,10,2007,5,928,1.0,660.0,660.0,5,1079,1.0,811.0,811.0
0.012,6,10,1677,5,827,3.0,559.0,559.0,5,850,2.0,582.0,582.0
0.076,6,26,10279,13,8838,6.0,2261.0,906.0,13,1441,6.0,316.0,127.0
0.004,6,10,1774,5,923,1.0,655.0,655.0,5,851,1.0,583.0,583.0
0.006,6,10,1547,5,764,1.0,496.0,496.0,5,783,1.0,515.0,515.0
0.013,6,10,1989,5,910,3.0,642.0,642.0,5,1079,3.0,811.0,811.0
0.084,6,10,1506,5,395,18.0,127.0,127.0,5,1111,17.0,843.0,843.0
173.446,17,80,11458,40,2670,4447.0,44.0,38.0,40,8788,4447.0,239.0,191.0
0.006,6,14,3799,7,509,1.0,137.0,137.0,7,3290,0.0,1448.0,972.0
0.02,17,4,284,2,120,3.0,32.0,32.0,2,164,1.0,60.0,54.0
0.009,6,10,1989,5,910,2.0,642.0,642.0,5,1079,2.0,811.0,811.0
0.01,6,10,1972,5,910,2.0,642.0,642.0,5,1062,2.0,794.0,794.0
0.087,6,10,1506,5,395,21.0,127.0,127.0,5,1111,17.0,843.0,843.0
0.099,6,10,1506,5,395,23.0,127.0,127.0,5,1111,22.0,843.0,843.0
0.013,6,10,1989,5,910,3.0,642.0,642.0,5,1079,3.0,811.0,811.0
0.004,6,10,1702,5,863,1.0,595.0,595.0,5,839,1.0,571.0,571.0
0.005,6,10,2007,5,928,1.0,660.0,660.0,5,1079,1.0,811.0,811.0
0.116,17,2,194,1,59,0.0,31.0,31.0,1,135,0.0,107.0,107.0
0.011,6,10,1989,5,910,2.0,642.0,642.0,5,1079,2.0,811.0,811.0
0.037,6,10,1762,5,911,9.0,643.0,643.0,5,851,9.0,583.0,583.0
0.019,6,10,1983,5,910,4.0,642.0,642.0,5,1073,4.0,805.0,805.0
0.005,6,10,2006,5,927,1.0,659.0,659.0,5,1079,1.0,811.0,811.0
0.05,17,4,284,2,120,0.0,32.0,32.0,2,164,40.0,60.0,54.0
0.014,6,10,1983,5,910,3.0,642.0,642.0,5,1073,3.0,805.0,805.0
0.038,17,4,284,2,120,0.0,32.0,32.0,2,164,35.0,60.0,54.0
0.783,6,25,5555,12,1445,59.0,267.0,136.0,13,4110,54.0,1414.0,597.0
0.086,6,10,1506,5,395,20.0,127.0,127.0,5,1111,17.0,843.0,843.0
0.083,6,10,1506,5,395,18.0,127.0,127.0,5,1111,18.0,843.0,843.0
300.352,6,16,2170,9,684,37522.0,146.0,146.0,7,1486,50030.0,419.0,398.0
0.005,6,10,1989,5,927,1.0,659.0,659.0,5,1062,1.0,794.0,794.0
0.207,6,16,2782,8,1400,29.0,533.0,325.0,8,1382,19.0,529.0,239.0
40.052,17,10,676,5,460,10012.0,104.0,64.0,5,216,10012.0,20.0,15.0
0.012,6,10,1983,5,910,3.0,642.0,642.0,5,1073,3.0,805.0,805.0
0.005,17,2,214,1,75,0.0,47.0,47.0,1,139,0.0,111.0,111.0
0.005,6,14,3799,7,509,0.0,137.0,137.0,7,3290,0.0,1448.0,972.0
0.01,6,10,1989,5,910,2.0,642.0,642.0,5,1079,2.0,811.0,811.0
0.008,6,10,1989,5,910,2.0,642.0,642.0,5,1079,2.0,811.0,811.0
0.005,17,2,203,1,61,0.0,33.0,33.0,1,142,0.0,114.0,114.0
40.068,17,10,676,5,460,10016.0,104.0,64.0,5,216,10016.0,20.0,15.0
0.004,6,10,2000,5,927,1.0,659.0,659.0,5,1073,1.0,805.0,805.0
0.005,6,10,1547,5,764,1.0,496.0,496.0,5,783,1.0,515.0,515.0
1.118,6,32,13392,18,5893,65.0,2720.0,854.0,14,7499,72.0,2720.0,769.0
0.082,6,10,1506,5,395,17.0,127.0,127.0,5,1111,16.0,843.0,843.0
0.001,17,2,166,1,75,0.0,47.0,47.0,1,91,0.0,63.0,63.0
0.01,6,10,1631,5,848,2.0,580.0,580.0,5,783,2.0,515.0,515.0
0.02,6,14,3787,7,497,3.0,125.0,125.0,7,3290,3.0,1448.0,972.0
0.005,6,10,1547,5,764,1.0,496.0,496.0,5,783,1.0,515.0,515.0
0.013,6,10,1989,5,910,3.0,642.0,642.0,5,1079,3.0,811.0,811.0
0.003,6,10,1702,5,863,0.0,595.0,595.0,5,839,0.0,571.0,571.0
0.006,6,10,1547,5,764,1.0,496.0,496.0,5,783,1.0,515.0,515.0
0.017,6,10,1983,5,910,4.0,642.0,642.0,5,1073,4.0,805.0,805.0
2.521,6,28,9605,14,1707,193.0,794.0,367.0,14,7898,184.0,1360.0,732.0
0.215,6,16,2782,8,1400,30.0,533.0,325.0,8,1382,19.0,529.0,239.0
0.005,6,10,1779,5,928,1.0,660.0,660.0,5,851,1.0,583.0,583.0
300.708,6,29,8807,14,2478,23131.0,1226.0,348.0,15,6329,21478.0,1592.0,617.0
0.006,6,10,1547,5,764,1.0,496.0,496.0,5,783,1.0,515.0,515.0
0.015,6,10,1972,5,910,3.0,642.0,642.0,5,1062,3.0,794.0,794.0
0.073,6,10,1506,5,395,17.0,127.0,127.0,5,1111,15.0,843.0,843.0
0.016,6,10,1989,5,910,4.0,642.0,642.0,5,1079,4.0,811.0,811.0
0.085,6,10,1506,5,395,18.0,127.0,127.0,5,1111,17.0,843.0,843.0
0.048,17,2,136,1,60,0.0,32.0,32.0,1,76,0.0,48.0,48.0
0.005,6,14,3799,7,509,0.0,137.0,137.0,7,3290,0.0,1448.0,972.0
0.006,6,10,2006,5,927,1.0,659.0,659.0,5,1079,1.0,811.0,811.0
0.01,6,10,1972,5,910,2.0,642.0,642.0,5,1062,2.0,794.0,794.0
0.003,17,2,148,1,60,0.0,32.0,32.0,1,88,0.0,60.0,60.0
0.011,17,2,194,1,59,0.0,31.0,31.0,1,135,0.0,107.0,107.0
0.008,6,12,1926,6,1189,1.0,659.0,434.0,6,737,1.0,417.0,417.0
0.096,6,10,1506,5,395,21.0,127.0,127.0,5,1111,21.0,843.0,843.0
0.005,6,10,2006,5,927,1.0,659.0,659.0,5,1079,1.0,811.0,811.0
0.014,6,10,1989,5,910,3.0,642.0,642.0,5,1079,3.0,811.0,811.0
0.051,6,20,9974,11,704,5.0,124.0,124.0,9,9270,6.0,2896.0,1758.0
0.006,6,10,2007,5,928,1.0,660.0,660.0,5,1079,1.0,811.0,811.0
310.215,17,20,1124,10,716,34453.0,48.0,43.0,10,408,34454.0,20.0,12.0
167.268,17,80,11386,40,2680,4288.0,44.0,39.0,40,8706,4288.0,239.0,189.0
0.005,6,10,2006,5,927,1.0,659.0,659.0,5,1079,1.0,811.0,811.0
1770.748,17,120,11460,60,5460,30012.0,63.0,63.0,60,6000,30012.0,72.0,72.0
0.013,6,10,1990,5,911,3.0,643.0,643.0,5,1079,3.0,811.0,811.0
0.006,6,10,1689,5,839,1.0,571.0,571.0,5,850,1.0,582.0,582.0
0.004,17,2,170,1,65,0.0,37.0,37.0,1,105,0.0,77.0,77.0
0.011,6,10,1989,5,910,2.0,642.0,642.0,5,1079,2.0,811.0,811.0
0.009,6,12,1926,6,1189,1.0,659.0,434.0,6,737,1.0,417.0,417.0
0.008,6,10,1989,5,910,2.0,642.0,642.0,5,1079,2.0,811.0,811.0
0.007,6,10,2000,5,927,1.0,659.0,659.0,5,1073,1.0,805.0,805.0
0.01,6,10,1689,5,839,2.0,571.0,571.0,5,850,2.0,582.0,582.0
0.013,6,10,1762,5,911,3.0,643.0,643.0,5,851,3.0,583.0,583.0
0.008,6,10,1762,5,911,2.0,643.0,643.0,5,851,2.0,583.0,583.0
0.07,6,10,1506,5,395,15.0,127.0,127.0,5,1111,15.0,843.0,843.0
240.094,6,39,7295,19,2226,13338.0,517.0,205.0,20,5069,12636.0,1402.0,446.0
0.042,17,4,284,2,120,0.0,32.0,32.0,2,164,38.0,60.0,54.0
0.005,6,14,3742,7,452,0.0,80.0,80.0,7,3290,0.0,1448.0,972.0
0.208,6,16,2779,8,1397,29.0,533.0,324.0,8,1382,18.0,529.0,239.0
0.011,6,13,3735,7,497,1.0,125.0,125.0,6,3238,2.0,1470.0,1459.0
0.005,6,10,2006,5,927,1.0,659.0,659.0,5,1079,1.0,811.0,811.0
0.071,17,2,182,1,65,0.0,37.0,37.0,1,117,0.0,89.0,89.0
0.005,6,14,3736,7,446,0.0,74.0,74.0,7,3290,0.0,1448.0,972.0
342.622,6,33,12261,18,2671,20154.0,585.0,345.0,15,9590,20181.0,1402.0,978.0
1798.78,17,3084,235874,1536,124425,1171.0,84.0,53.0,1548,111449,1162.0,227.0,43.0
0.006,6,10,1854,5,889,1.0,621.0,621.0,5,965,1.0,697.0,697.0
0.149,17,4,364,2,160,0.0,52.0,52.0,2,204,3.0,80.0,74.0
0.071,6,10,1506,5,395,17.0,127.0,127.0,5,1111,16.0,843.0,843.0
0.003,17,2,136,1,60,0.0,32.0,32.0,1,76,0.0,48.0,48.0
0.004,6,10,1779,5,928,1.0,660.0,660.0,5,851,1.0,583.0,583.0
0.139,6,10,1506,5,395,33.0,127.0,127.0,5,1111,31.0,843.0,843.0
0.12,17,2,80,1,32,0.0,4.0,4.0,1,48,0.0,20.0,20.0
0.015,6,10,1989,5,910,3.0,642.0,642.0,5,1079,3.0,811.0,811.0
0.005,17,2,247,1,72,0.0,44.0,44.0,1,175,0.0,147.0,147.0
0.008,17,2,299,1,65,0.0,37.0,37.0,1,234,0.0,206.0,206.0
0.094,6,10,1506,5,395,20.0,127.0,127.0,5,1111,20.0,843.0,843.0
0.005,17,2,146,1,65,0.0,37.0,37.0,1,81,0.0,53.0,53.0
0.008,6,10,1989,5,910,2.0,642.0,642.0,5,1079,2.0,811.0,811.0
0.004,6,10,1774,5,923,1.0,655.0,655.0,5,851,1.0,583.0,583.0
40.09,17,10,676,5,460,10020.0,104.0,64.0,5,216,10021.0,20.0,15.0
40.072,17,10,676,5,460,10015.0,104.0,64.0,5,216,10017.0,20.0,15.0
0.037,17,2,144,1,64,0.0,36.0,36.0,1,80,0.0,52.0,52.0
177.338,17,90,13127,45,3005,4030.0,44.0,38.0,45,10122,4030.0,239.0,196.0
0.001,17,2,166,1,75,0.0,47.0,47.0,1,91,0.0,63.0,63.0
0.008,17,2,299,1,65,0.0,37.0,37.0,1,234,0.0,206.0,206.0
0.006,6,10,2006,5,927,1.0,659.0,659.0,5,1079,1.0,811.0,811.0
0.008,6,10,1983,5,910,1.0,642.0,642.0,5,1073,1.0,805.0,805.0
11.038,17,28,4391,14,2312,840.0,587.0,137.0,14,2079,840.0,270.0,120.0
0.004,6,13,3747,7,509,0.0,137.0,137.0,6,3238,0.0,1470.0,1459.0
386.67,6,33,12151,18,2671,22745.0,585.0,345.0,15,9480,23329.0,1402.0,965.0
0.127,17,2,148,1,60,0.0,32.0,32.0,1,88,0.0,60.0,60.0
0.006,17,2,230,1,68,0.0,40.0,40.0,1,162,0.0,134.0,134.0
1786.574,6,152,19454,90,13740,20073.0,302.0,302.0,62,5714,29288.0,83.0,83.0
0.006,6,10,1547,5,764,1.0,496.0,496.0,5,783,1.0,515.0,515.0
0.012,6,13,3735,7,497,2.0,125.0,125.0,6,3238,2.0,1470.0,1459.0
0.053,6,9,1190,5,751,13.0,495.0,495.0,4,439,8.0,223.0,223.0
246.53,6,31,9333,15,6733,17609.0,1857.0,661.0,16,2600,16435.0,580.0,195.0
1721.219,6,61,7140,40,4347,44133.0,1640.0,113.0,21,2793,86052.0,1112.0,85.0
0.005,6,10,2000,5,927,1.0,659.0,659.0,5,1073,1.0,805.0,805.0
0.212,6,16,2669,8,1395,30.0,533.0,323.0,8,1274,19.0,529.0,212.0
11.124,17,28,4423,14,1995,843.0,270.0,114.0,14,2428,843.0,587.0,145.0
0.034,17,2,152,1,76,0.0,48.0,48.0,1,76,0.0,48.0,48.0
0.005,6,10,2007,5,928,1.0,660.0,660.0,5,1079,1.0,811.0,811.0
0.005,6,10,2006,5,927,1.0,659.0,659.0,5,1079,1.0,811.0,811.0
0.016,6,10,1989,5,910,3.0,642.0,642.0,5,1079,4.0,811.0,811.0
0.005,6,14,3742,7,452,0.0,80.0,80.0,7,3290,0.0,1448.0,972.0
0.014,6,10,1989,5,910,3.0,642.0,642.0,5,1079,3.0,811.0,811.0
0.005,6,10,1547,5,764,1.0,496.0,496.0,5,783,1.0,515.0,515.0
0.008,6,10,1989,5,910,2.0,642.0,642.0,5,1079,2.0,811.0,811.0
0.005,6,10,1854,5,889,1.0,621.0,621.0,5,965,1.0,697.0,697.0
0.076,6,10,1506,5,395,16.0,127.0,127.0,5,1111,15.0,843.0,843.0
309.226,17,20,1124,10,716,34344.0,48.0,43.0,10,408,34344.0,20.0,12.0
0.104,6,10,1506,5,395,24.0,127.0,127.0,5,1111,24.0,843.0,843.0
0.005,6,10,2007,5,928,1.0,660.0,660.0,5,1079,1.0,811.0,811.0
15.095,17,16,9665,9,7414,1883.0,1350.0,795.0,7,2251,2510.0,1350.0,293.0
0.006,6,10,1547,5,764,1.0,496.0,496.0,5,783,1.0,515.0,515.0
0.005,17,2,170,1,65,0.0,37.0,37.0,1,105,0.0,77.0,77.0
0.01,6,10,1972,5,910,2.0,642.0,642.0,5,1062,2.0,794.0,794.0
0.012,6,10,1989,5,910,3.0,642.0,642.0,5,1079,2.0,811.0,811.0
0.04,17,4,284,2,120,0.0,32.0,32.0,2,164,36.0,60.0,54.0
0.116,6,10,1506,5,395,26.0,127.0,127.0,5,1111,25.0,843.0,843.0
0.02,6,10,1989,5,910,5.0,642.0,642.0,5,1079,4.0,811.0,811.0
0.005,6,10,2006,5,927,1.0,659.0,659.0,5,1079,1.0,811.0,811.0
0.006,6,10,1547,5,764,1.0,496.0,496.0,5,783,1.0,515.0,515.0
0.02,17,2,166,1,75,0.0,47.0,47.0,1,91,0.0,63.0,63.0
0.001,17,2,180,1,66,0.0,38.0,38.0,1,114,0.0,86.0,86.0
15.073,17,14,9190,8,6902,2148.0,1350.0,834.0,6,2288,3008.0,1350.0,353.0
0.005,6,10,1989,5,927,1.0,659.0,659.0,5,1062,1.0,794.0,794.0
11.018,17,28,4422,14,1994,838.0,269.0,114.0,14,2428,838.0,587.0,145.0
0.021,6,10,1990,5,911,5.0,643.0,643.0,5,1079,5.0,811.0,811.0
0.005,6,10,2000,5,927,1.0,659.0,659.0,5,1073,1.0,805.0,805.0
0.02,6,10,1990,5,911,4.0,643.0,643.0,5,1079,4.0,811.0,811.0
0.015,6,10,1989,5,910,3.0,642.0,642.0,5,1079,3.0,811.0,811.0
240.1,6,16,4482,9,963,30012.0,238.0,166.0,7,3519,40016.0,1402.0,786.0
0.01,6,10,1677,5,827,2.0,559.0,559.0,5,850,2.0,582.0,582.0
165.066,17,78,11037,39,2601,4343.0,44.0,38.0,39,8436,4343.0,239.0,188.0
40.058,17,10,676,5,460,10013.0,104.0,64.0,5,216,10013.0,20.0,15.0
0.005,6,10,1774,5,923,1.0,655.0,655.0,5,851,1.0,583.0,583.0
0.07,17,8,3613,4,1874,23.0,1350.0,440.0,4,1739,12.0,1350.0,406.0
0.005,6,10,2006,5,927,1.0,659.0,659.0,5,1079,1.0,811.0,811.0
0.147,6,10,1506,5,395,35.0,127.0,127.0,5,1111,35.0,843.0,843.0
0.057,6,10,1506,5,395,13.0,127.0,127.0,5,1111,13.0,843.0,843.0
373.933,6,22,2313,16,867,24928.0,195.0,195.0,6,1446,4639.0,419.0,398.0
0.137,17,2,152,1,76,0.0,48.0,48.0,1,76,0.0,48.0,48.0
0.004,6,10,1989,5,927,1.0,659.0,659.0,5,1062,1.0,794.0,794.0
0.049,17,2,160,1,72,0.0,44.0,44.0,1,88,0.0,60.0,60.0
0.128,17,2,80,1,32,0.0,4.0,4.0,1,48,0.0,20.0,20.0
1770.454,17,92,8096,46,4048,39343.0,60.0,60.0,46,4048,39343.0,60.0,60.0
308.528,17,20,1124,10,716,34267.0,48.0,43.0,10,408,34267.0,20.0,12.0
0.007,17,2,194,1,59,0.0,31.0,31.0,1,135,0.0,107.0,107.0
171.034,17,74,10653,37,2466,4750.0,44.0,38.0,37,8187,4750.0,239.0,193.0
240.448,6,35,8924,18,2070,14143.0,691.0,225.0,17,6854,15027.0,1402.0,597.0
0.013,6,10,1972,5,910,3.0,642.0,642.0,5,1062,3.0,794.0,794.0
0.013,6,10,2006,5,927,3.0,659.0,659.0,5,1079,3.0,811.0,811.0
0.126,6,10,1506,5,395,29.0,127.0,127.0,5,1111,29.0,843.0,843.0
240.105,6,16,4482,9,963,30013.0,238.0,166.0,7,3519,40016.0,1402.0,786.0
0.1,6,10,1506,5,395,23.0,127.0,127.0,5,1111,22.0,843.0,843.0
300.382,6,16,2170,9,684,37527.0,146.0,146.0,7,1486,50035.0,419.0,398.0
0.013,6,10,1854,5,889,3.0,621.0,621.0,5,965,3.0,697.0,697.0
0.004,17,4,284,2,120,0.0,32.0,32.0,2,164,0.0,60.0,54.0
0.085,6,10,1506,5,395,19.0,127.0,127.0,5,1111,19.0,843.0,843.0
0.077,6,10,1506,5,395,17.0,127.0,127.0,5,1111,16.0,843.0,843.0
0.005,6,10,2000,5,927,1.0,659.0,659.0,5,1073,1.0,805.0,805.0
0.005,6,10,1854,5,889,1.0,621.0,621.0,5,965,1.0,697.0,697.0
0.006,6,14,3799,7,509,1.0,137.0,137.0,7,3290,0.0,1448.0,972.0
0.018,6,10,1983,5,910,4.0,642.0,642.0,5,1073,4.0,805.0,805.0
353.412,6,20,2210,6,1308,12004.0,494.0,494.0,14,902,27185.0,83.0,83.0
0.129,17,2,80,1,32,0.0,4.0,4.0,1,48,0.0,20.0,20.0
0.005,6,13,3747,7,509,0.0,137.0,137.0,6,3238,0.0,1470.0,1459.0
0.006,17,2,170,1,65,0.0,37.0,37.0,1,105,0.0,77.0,77.0
0.08,6,10,1506,5,395,18.0,127.0,127.0,5,1111,19.0,843.0,843.0
0.093,6,10,1506,5,395,20.0,127.0,127.0,5,1111,22.0,843.0,843.0
0.083,6,10,1506,5,395,15.0,127.0,127.0,5,1111,18.0,843.0,843.0
0.005,6,10,2006,5,927,1.0,659.0,659.0,5,1079,1.0,811.0,811.0
0.115,6,10,1506,5,395,26.0,127.0,127.0,5,1111,22.0,843.0,843.0
0.006,6,10,2007,5,928,1.0,660.0,660.0,5,1079,1.0,811.0,811.0
0.011,6,10,1983,5,910,2.0,642.0,642.0,5,1073,2.0,805.0,805.0
0.011,6,10,1989,5,910,2.0,642.0,642.0,5,1079,2.0,811.0,811.0
0.005,6,13,3747,7,509,0.0,137.0,137.0,6,3238,1.0,1470.0,1459.0
0.013,6,13,3735,7,497,2.0,125.0,125.0,6,3238,2.0,1470.0,1459.0
300.02,6,12,1782,7,1348,50003.0,494.0,494.0,5,434,75004.0,83.0,83.0
42.616,6,37,9986,19,4468,488.0,1360.0,735.0,18,5518,2497.0,2667.0,435.0
40.068,17,10,676,5,460,10015.0,104.0,64.0,5,216,10016.0,20.0,15.0
0.067,6,10,1506,5,395,15.0,127.0,127.0,5,1111,14.0,843.0,843.0
736.799,6,74,25850,38,6271,19912.0,676.0,476.0,36,19579,21050.0,1402.0,681.0
0.123,17,2,148,1,60,0.0,32.0,32.0,1,88,0.0,60.0,60.0
0.004,17,4,284,2,120,0.0,32.0,32.0,2,164,1.0,60.0,54.0
0.014,6,10,1677,5,827,3.0,559.0,559.0,5,850,3.0,582.0,582.0
0.005,6,10,2006,5,927,1.0,659.0,659.0,5,1079,1.0,811.0,811.0
0.004,6,10,2006,5,927,1.0,659.0,659.0,5,1079,1.0,811.0,811.0
0.005,6,10,2007,5,928,1.0,660.0,660.0,5,1079,1.0,811.0,811.0
167.258,17,86,12083,43,2864,3982.0,44.0,38.0,43,9219,3982.0,239.0,186.0
1.145,6,32,13391,18,5892,67.0,2073.0,854.0,14,7499,74.0,2720.0,769.0
174.011,17,80,11270,40,2664,4461.0,44.0,38.0,40,8606,4461.0,239.0,187.0
0.009,6,10,1989,5,910,2.0,642.0,642.0,5,1079,2.0,811.0,811.0
0.038,17,4,284,2,120,0.0,32.0,32.0,2,164,35.0,60.0,54.0
0.006,6,10,1547,5,764,1.0,496.0,496.0,5,783,1.0,515.0,515.0
0.002,17,2,180,1,66,0.0,38.0,38.0,1,114,0.0,86.0,86.0
0.006,17,2,175,1,60,0.0,32.0,32.0,1,115,0.0,87.0,87.0
0.104,17,2,80,1,32,0.0,4.0,4.0,1,48,0.0,20.0,20.0
0.003,6,10,1702,5,863,0.0,595.0,595.0,5,839,0.0,571.0,571.0
0.102,6,10,1506,5,395,21.0,127.0,127.0,5,1111,21.0,843.0,843.0
0.106,6,10,1506,5,395,22.0,127.0,127.0,5,1111,24.0,843.0,843.0
0.005,6,13,3747,7,509,0.0,137.0,137.0,6,3238,0.0,1470.0,1459.0
0.008,6,10,1972,5,910,2.0,642.0,642.0,5,1062,2.0,794.0,794.0
281.889,6,23,6075,10,1186,31320.0,267.0,156.0,13,4889,23490.0,1400.0,873.0
0.007,6,10,1983,5,910,1.0,642.0,642.0,5,1073,1.0,805.0,805.0
0.005,6,10,1774,5,923,1.0,655.0,655.0,5,851,1.0,583.0,583.0
0.008,6,10,1689,5,839,2.0,571.0,571.0,5,850,1.0,582.0,582.0
0.02,6,10,1989,5,910,5.0,642.0,642.0,5,1079,5.0,811.0,811.0
0.089,6,10,1506,5,395,19.0,127.0,127.0,5,1111,16.0,843.0,843.0
0.006,6,14,3799,7,509,0.0,137.0,137.0,7,3290,0.0,1448.0,972.0
0.011,6,10,1983,5,910,2.0,642.0,642.0,5,1073,2.0,805.0,805.0
0.005,6,10,2007,5,928,1.0,660.0,660.0,5,1079,1.0,811.0,811.0
11.092,17,28,4424,14,1995,840.0,270.0,114.0,14,2429,840.0,588.0,145.0
0.022,6,10,1989,5,910,5.0,642.0,642.0,5,1079,5.0,811.0,811.0
0.005,6,10,1643,5,860,1.0,592.0,592.0,5,783,1.0,515.0,515.0
0.006,6,10,1547,5,764,1.0,496.0,496.0,5,783,1.0,515.0,515.0
0.005,17,2,144,1,64,0.0,36.0,36.0,1,80,0.0,52.0,52.0
15.076,17,17,10290,9,7983,1881.0,1350.0,859.0,8,2307,2152.0,1350.0,260.0
0.005,6,10,2007,5,928,1.0,660.0,660.0,5,1079,1.0,811.0,811.0
0.001,17,2,180,1,66,0.0,38.0,38.0,1,114,0.0,86.0,86.0
0.022,6,10,1990,5,911,5.0,643.0,643.0,5,1079,5.0,811.0,811.0
0.001,17,2,180,1,66,0.0,38.0,38.0,1,114,0.0,86.0,86.0
0.012,17,2,144,1,64,0.0,36.0,36.0,1,80,0.0,52.0,52.0
0.004,17,2,136,1,60,0.0,32.0,32.0,1,76,0.0,48.0,48.0
26.56,6,46,23081,21,1150,1328.0,290.0,290.0,25,21931,1106.0,1414.0,1230.0
0.067,17,8,3613,4,1874,22.0,1350.0,440.0,4,1739,11.0,1350.0,406.0
0.006,6,10,1643,5,860,1.0,592.0,592.0,5,783,1.0,515.0,515.0
0.006,6,10,1547,5,764,1.0,496.0,496.0,5,783,1.0,515.0,515.0
0.005,6,10,2006,5,927,1.0,659.0,659.0,5,1079,1.0,811.0,811.0
0.001,17,2,136,1,60,0.0,32.0,32.0,1,76,0.0,48.0,48.0
0.005,17,2,214,1,75,0.0,47.0,47.0,1,139,0.0,111.0,111.0
0.089,6,10,1506,5,395,18.0,127.0,127.0,5,1111,21.0,843.0,843.0
40.058,17,10,676,5,460,10013.0,104.0,64.0,5,216,10013.0,20.0,15.0
0.012,6,10,1990,5,911,2.0,643.0,643.0,5,1079,3.0,811.0,811.0
0.017,6,10,1989,5,910,4.0,642.0,642.0,5,1079,4.0,811.0,811.0
0.024,6,10,1990,5,911,6.0,643.0,643.0,5,1079,5.0,811.0,811.0
0.008,6,10,1677,5,827,2.0,559.0,559.0,5,850,1.0,582.0,582.0
0.041,17,2,148,1,60,0.0,32.0,32.0,1,88,0.0,60.0,60.0
0.004,6,10,1702,5,863,1.0,595.0,595.0,5,839,1.0,571.0,571.0
0.013,6,10,1972,5,910,3.0,642.0,642.0,5,1062,3.0,794.0,794.0
0.005,6,10,1989,5,927,1.0,659.0,659.0,5,1062,1.0,794.0,794.0
10.955,17,28,4390,14,2312,834.0,587.0,137.0,14,2078,834.0,269.0,120.0
0.077,6,10,1506,5,395,17.0,127.0,127.0,5,1111,16.0,843.0,843.0
0.004,17,2,164,1,74,0.0,46.0,46.0,1,90,0.0,62.0,62.0
0.005,17,2,164,1,74,0.0,46.0,46.0,1,90,0.0,62.0,62.0
0.046,6,10,1989,5,910,11.0,642.0,642.0,5,1079,11.0,811.0,811.0
0.005,6,10,1779,5,928,1.0,660.0,660.0,5,851,1.0,583.0,583.0
0.169,17,2,152,1,76,0.0,48.0,48.0,1,76,0.0,48.0,48.0
241.215,6,376,346690,196,21715,1237.0,2736.0,959.0,180,324975,1347.0,2804.0,1856.0
0.087,6,10,1506,5,395,18.0,127.0,127.0,5,1111,15.0,843.0,843.0
0.141,6,10,1506,5,395,32.0,127.0,127.0,5,1111,31.0,843.0,843.0
0.012,6,10,1983,5,910,3.0,642.0,642.0,5,1073,2.0,805.0,805.0
0.004,6,10,1779,5,928,1.0,660.0,660.0,5,851,1.0,583.0,583.0
0.123,17,2,80,1,32,0.0,4.0,4.0,1,48,0.0,20.0,20.0
0.007,17,2,275,1,67,0.0,39.0,39.0,1,208,0.0,180.0,180.0
0.052,17,2,152,1,76,0.0,48.0,48.0,1,76,0.0,48.0,48.0
0.005,6,10,2006,5,927,1.0,659.0,659.0,5,1079,1.0,811.0,811.0
0.004,6,10,2007,5,928,1.0,660.0,660.0,5,1079,1.0,811.0,811.0
0.006,6,10,1854,5,889,1.0,621.0,621.0,5,965,1.0,697.0,697.0
112.013,6,21,8146,11,1985,89.0,1174.0,504.0,10,6161,12426.0,2720.0,958.0
0.005,6,10,2006,5,927,1.0,659.0,659.0,5,1079,1.0,811.0,811.0
0.004,17,2,148,1,60,0.0,32.0,32.0,1,88,0.0,60.0,60.0
0.07,6,10,1506,5,395,14.0,127.0,127.0,5,1111,16.0,843.0,843.0
1770.587,17,92,8096,46,4048,39346.0,60.0,60.0,46,4048,39346.0,60.0,60.0
0.068,6,10,1506,5,395,15.0,127.0,127.0,5,1111,14.0,843.0,843.0
10.94,17,28,4421,14,1993,832.0,268.0,114.0,14,2428,832.0,587.0,145.0
0.107,6,10,1506,5,395,24.0,127.0,127.0,5,1111,22.0,843.0,843.0
0.005,6,10,1774,5,923,1.0,655.0,655.0,5,851,1.0,583.0,583.0
0.004,17,2,166,1,75,0.0,47.0,47.0,1,91,0.0,63.0,63.0
0.066,6,10,1506,5,395,14.0,127.0,127.0,5,1111,14.0,843.0,843.0
0.004,17,2,148,1,60,0.0,32.0,32.0,1,88,0.0,60.0,60.0
0.006,6,10,1547,5,764,1.0,496.0,496.0,5,783,1.0,515.0,515.0
0.005,6,10,1989,5,927,1.0,659.0,659.0,5,1062,1.0,794.0,794.0
0.086,6,10,1506,5,395,17.0,127.0,127.0,5,1111,19.0,843.0,843.0
0.001,17,2,136,1,60,0.0,32.0,32.0,1,76,0.0,48.0,48.0
0.148,6,10,1506,5,395,35.0,127.0,127.0,5,1111,34.0,843.0,843.0
0.005,6,10,1989,5,927,1.0,659.0,659.0,5,1062,1.0,794.0,794.0
0.071,17,2,136,1,60,0.0,32.0,32.0,1,76,0.0,48.0,48.0
0.097,6,10,1506,5,395,19.0,127.0,127.0,5,1111,21.0,843.0,843.0
0.004,6,10,2006,5,927,1.0,659.0,659.0,5,1079,1.0,811.0,811.0
0.004,6,10,1774,5,923,1.0,655.0,655.0,5,851,1.0,583.0,583.0
0.008,6,12,1926,6,1189,1.0,659.0,434.0,6,737,1.0,417.0,417.0
0.008,6,12,1926,6,1189,1.0,659.0,434.0,6,737,1.0,417.0,417.0
0.005,6,13,3747,7,509,0.0,137.0,137.0,6,3238,0.0,1470.0,1459.0
0.17,6,10,1506,5,395,40.0,127.0,127.0,5,1111,39.0,843.0,843.0
573.436,6,39,15431,21,3515,28671.0,676.0,400.0,18,11916,30201.0,1402.0,997.0
0.053,17,2,152,1,76,0.0,48.0,48.0,1,76,0.0,48.0,48.0
40.073,17,10,676,5,460,10017.0,104.0,64.0,5,216,10016.0,20.0,15.0
71.904,6,21,8147,11,1985,84.0,1174.0,504.0,10,6162,7970.0,2720.0,958.0
0.009,6,10,1989,5,910,2.0,642.0,642.0,5,1079,2.0,811.0,811.0
0.006,6,10,1547,5,764,1.0,496.0,496.0,5,783,1.0,515.0,515.0
0.004,6,10,1774,5,923,1.0,655.0,655.0,5,851,1.0,583.0,583.0
0.009,6,10,1989,5,910,2.0,642.0,642.0,5,1079,2.0,811.0,811.0
0.004,6,10,2006,5,927,1.0,659.0,659.0,5,1079,1.0,811.0,811.0
0.082,6,10,1506,5,395,19.0,127.0,127.0,5,1111,18.0,843.0,843.0
0.01,6,10,1762,5,911,2.0,643.0,643.0,5,851,2.0,583.0,583.0
0.098,6,10,1506,5,395,22.0,127.0,127.0,5,1111,22.0,843.0,843.0
0.102,6,10,1506,5,395,21.0,127.0,127.0,5,1111,23.0,843.0,843.0
0.007,6,10,1989,5,927,1.0,659.0,659.0,5,1062,1.0,794.0,794.0
40.058,17,10,676,5,460,10013.0,104.0,64.0,5,216,10013.0,20.0,15.0
0.094,6,10,1506,5,395,23.0,127.0,127.0,5,1111,22.0,843.0,843.0
0.009,6,10,1989,5,910,2.0,642.0,642.0,5,1079,2.0,811.0,811.0
0.068,6,10,1506,5,395,14.0,127.0,127.0,5,1111,16.0,843.0,843.0
0.005,6,10,1989,5,927,1.0,659.0,659.0,5,1062,1.0,794.0,794.0
0.004,6,10,2006,5,927,1.0,659.0,659.0,5,1079,1.0,811.0,811.0
0.013,6,10,1989,5,910,3.0,642.0,642.0,5,1079,3.0,811.0,811.0
0.013,6,10,1983,5,910,3.0,642.0,642.0,5,1073,3.0,805.0,805.0
0.015,6,10,1972,5,910,3.0,642.0,642.0,5,1062,3.0,794.0,794.0
0.013,6,10,1989,5,910,3.0,642.0,642.0,5,1079,3.0,811.0,811.0
0.012,6,10,1990,5,911,2.0,643.0,643.0,5,1079,3.0,811.0,811.0
0.085,6,10,1506,5,395,19.0,127.0,127.0,5,1111,18.0,843.0,843.0
0.005,6,10,2006,5,927,1.0,659.0,659.0,5,1079,1.0,811.0,811.0
0.008,6,10,2006,5,927,1.0,659.0,659.0,5,1079,1.0,811.0,811.0
0.004,6,10,2006,5,927,1.0,659.0,659.0,5,1079,1.0,811.0,811.0
0.008,6,12,1698,6,863,1.0,327.0,271.0,6,835,1.0,515.0,515.0
0.009,6,10,1972,5,910,2.0,642.0,642.0,5,1062,2.0,794.0,794.0
0.005,17,2,166,1,75,0.0,47.0,47.0,1,91,0.0,63.0,63.0
40.064,17,10,676,5,460,10012.0,104.0,64.0,5,216,10015.0,20.0,15.0
0.078,6,10,1506,5,395,17.0,127.0,127.0,5,1111,16.0,843.0,843.0
0.005,6,10,1854,5,889,1.0,621.0,621.0,5,965,1.0,697.0,697.0
0.006,6,10,1547,5,764,1.0,496.0,496.0,5,783,1.0,515.0,515.0
0.001,17,2,136,1,60,0.0,32.0,32.0,1,76,0.0,48.0,48.0
0.005,6,10,1989,5,927,1.0,659.0,659.0,5,1062,1.0,794.0,794.0
0.008,6,10,1972,5,910,2.0,642.0,642.0,5,1062,1.0,794.0,794.0
40.072,17,10,676,5,460,10016.0,104.0,64.0,5,216,10017.0,20.0,15.0
0.085,6,10,1506,5,395,19.0,127.0,127.0,5,1111,17.0,843.0,843.0
40.068,17,10,676,5,460,10016.0,104.0,64.0,5,216,10016.0,20.0,15.0
0.017,17,2,169,1,62,0.0,34.0,34.0,1,107,0.0,79.0,79.0
10.992,17,28,4423,14,1995,837.0,270.0,114.0,14,2428,837.0,587.0,145.0
0.006,6,10,1547,5,764,1.0,496.0,496.0,5,783,1.0,515.0,515.0
40.067,17,10,676,5,460,10015.0,104.0,64.0,5,216,10015.0,20.0,15.0
0.006,6,10,1547,5,764,1.0,496.0,496.0,5,783,1.0,515.0,515.0
0.096,6,10,1506,5,395,21.0,127.0,127.0,5,1111,20.0,843.0,843.0
0.008,6,10,1677,5,827,2.0,559.0,559.0,5,850,1.0,582.0,582.0
0.012,6,10,1677,5,827,3.0,559.0,559.0,5,850,2.0,582.0,582.0
0.005,6,14,3736,7,446,0.0,74.0,74.0,7,3290,0.0,1448.0,972.0
0.006,6,10,1689,5,839,1.0,571.0,571.0,5,850,1.0,582.0,582.0
125.974,6,14,2938,8,2504,17962.0,1414.0,1086.0,6,434,25147.0,182.0,182.0
0.006,6,10,1547,5,764,1.0,496.0,496.0,5,783,1.0,515.0,515.0
0.012,6,10,1762,5,911,2.0,643.0,643.0,5,851,3.0,583.0,583.0
0.005,6,10,2006,5,927,1.0,659.0,659.0,5,1079,1.0,811.0,811.0
0.084,6,10,1506,5,395,20.0,127.0,127.0,5,1111,18.0,843.0,843.0
0.004,6,10,1989,5,927,1.0,659.0,659.0,5,1062,1.0,794.0,794.0
0.001,17,2,180,1,66,0.0,38.0,38.0,1,114,0.0,86.0,86.0
0.017,6,10,1989,5,910,4.0,642.0,642.0,5,1079,4.0,811.0,811.0
240.475,6,43,8771,21,5686,12023.0,1515.0,509.0,22,3085,11451.0,580.0,241.0
0.174,6,10,1506,5,395,40.0,127.0,127.0,5,1111,41.0,843.0,843.0
0.003,17,2,136,1,60,0.0,32.0,32.0,1,76,0.0,48.0,48.0
0.071,6,10,1506,5,395,14.0,127.0,127.0,5,1111,16.0,843.0,843.0
0.011,6,10,1677,5,827,2.0,559.0,559.0,5,850,2.0,582.0,582.0
15.087,17,16,8563,8,6322,2150.0,1350.0,762.0,8,2241,2151.0,1350.0,252.0
240.245,6,40,5428,19,2387,13346.0,588.0,197.0,21,3041,12012.0,580.0,242.0
0.012,6,10,1989,5,910,2.0,642.0,642.0,5,1079,3.0,811.0,811.0
0.021,6,10,1762,5,911,5.0,643.0,643.0,5,851,5.0,583.0,583.0
0.005,6,10,1989,5,927,1.0,659.0,659.0,5,1062,1.0,794.0,794.0
40.065,17,10,676,5,460,10014.0,104.0,64.0,5,216,10015.0,20.0,15.0
0.009,6,10,1989,5,927,2.0,659.0,659.0,5,1062,2.0,794.0,794.0
0.068,17,8,3613,4,1874,22.0,1350.0,440.0,4,1739,11.0,1350.0,406.0
0.003,17,4,284,2,120,0.0,32.0,32.0,2,164,0.0,60.0,54.0
0.093,6,10,1506,5,395,21.0,127.0,127.0,5,1111,19.0,843.0,843.0
0.015,6,10,1989,5,910,3.0,642.0,642.0,5,1079,3.0,811.0,811.0
0.005,6,10,2007,5,928,1.0,660.0,660.0,5,1079,1.0,811.0,811.0
0.137,6,10,1506,5,395,30.0,127.0,127.0,5,1111,32.0,843.0,843.0
0.005,6,10,2006,5,927,1.0,659.0,659.0,5,1079,1.0,811.0,811.0
0.009,6,10,1972,5,910,2.0,642.0,642.0,5,1062,2.0,794.0,794.0
0.007,17,2,157,1,59,0.0,31.0,31.0,1,98,0.0,70.0,70.0
0.006,6,10,1547,5,764,1.0,496.0,496.0,5,783,1.0,515.0,515.0
918.669,6,43,13371,23,6149,41757.0,1402.0,494.0,20,7222,45191.0,1402.0,686.0
0.004,6,10,2006,5,927,1.0,659.0,659.0,5,1079,1.0,811.0,811.0
0.067,6,10,1506,5,395,15.0,127.0,127.0,5,1111,13.0,843.0,843.0
0.008,6,10,2000,5,927,1.0,659.0,659.0,5,1073,2.0,805.0,805.0
40.091,17,10,676,5,460,10016.0,104.0,64.0,5,216,10019.0,20.0,15.0
0.012,6,10,1990,5,911,3.0,643.0,643.0,5,1079,2.0,811.0,811.0
0.013,6,10,1989,5,910,3.0,642.0,642.0,5,1079,3.0,811.0,811.0
0.093,6,10,1506,5,395,23.0,127.0,127.0,5,1111,17.0,843.0,843.0
308.566,17,20,1124,10,716,34271.0,48.0,43.0,10,408,34271.0,20.0,12.0
0.012,6,13,3735,7,497,2.0,125.0,125.0,6,3238,2.0,1470.0,1459.0
40.063,17,10,676,5,460,10013.0,104.0,64.0,5,216,10014.0,20.0,15.0
0.005,6,10,1643,5,860,1.0,592.0,592.0,5,783,1.0,515.0,515.0
240.01,6,9,787,5,488,60002.0,232.0,232.0,4,299,80002.0,83.0,83.0
0.001,17,2,180,1,66,0.0,38.0,38.0,1,114,0.0,86.0,86.0
0.098,6,10,1506,5,395,17.0,127.0,127.0,5,1111,23.0,843.0,843.0
0.008,6,10,1643,5,860,1.0,592.0,592.0,5,783,1.0,515.0,515.0
0.015,6,10,1972,5,910,3.0,642.0,642.0,5,1062,3.0,794.0,794.0
0.001,17,2,136,1,60,0.0,32.0,32.0,1,76,0.0,48.0,48.0
0.014,6,10,1631,5,848,3.0,580.0,580.0,5,783,3.0,515.0,515.0
0.001,17,2,180,1,66,0.0,38.0,38.0,1,114,0.0,86.0,86.0
11.131,17,28,4367,14,2312,848.0,587.0,137.0,14,2055,848.0,270.0,118.0
0.014,6,10,1990,5,911,3.0,643.0,643.0,5,1079,3.0,811.0,811.0
0.074,6,10,1506,5,395,17.0,127.0,127.0,5,1111,17.0,843.0,843.0
0.005,6,10,2007,5,928,1.0,660.0,660.0,5,1079,1.0,811.0,811.0
10.815,17,28,4420,14,1993,823.0,268.0,114.0,14,2427,823.0,586.0,145.0
0.618,6,26,8925,14,1587,38.0,517.0,211.0,12,7338,45.0,1288.0,839.0
0.006,6,10,1547,5,764,1.0,496.0,496.0,5,783,1.0,515.0,515.0
0.112,6,10,1506,5,395,22.0,127.0,127.0,5,1111,22.0,843.0,843.0
0.038,17,2,156,1,64,0.0,36.0,36.0,1,92,0.0,64.0,64.0
0.227,6,16,2670,8,1396,32.0,533.0,324.0,8,1274,21.0,529.0,212.0
0.112,6,10,1506,5,395,26.0,127.0,127.0,5,1111,25.0,843.0,843.0
0.009,6,10,1989,5,910,2.0,642.0,642.0,5,1079,2.0,811.0,811.0
0.013,6,10,2006,5,927,3.0,659.0,659.0,5,1079,3.0,811.0,811.0
0.005,6,10,2006,5,927,1.0,659.0,659.0,5,1079,1.0,811.0,811.0
0.008,6,10,1631,5,848,2.0,580.0,580.0,5,783,2.0,515.0,515.0
11.417,17,28,4393,14,2311,865.0,586.0,137.0,14,2082,865.0,269.0,120.0
0.005,6,10,2007,5,928,1.0,660.0,660.0,5,1079,1.0,811.0,811.0
0.013,6,10,1989,5,910,3.0,642.0,642.0,5,1079,3.0,811.0,811.0
177.547,17,86,12259,43,2888,4227.0,44.0,39.0,43,9371,4227.0,239.0,189.0
0.018,6,10,1972,5,910,4.0,642.0,642.0,5,1062,4.0,794.0,794.0
0.071,17,2,234,1,61,0.0,33.0,33.0,1,173,0.0,145.0,145.0
0.005,6,10,2000,5,927,1.0,659.0,659.0,5,1073,1.0,805.0,805.0
0.008,6,10,1972,5,910,2.0,642.0,642.0,5,1062,1.0,794.0,794.0
1749.973,6,456,66877,256,35469,6862.0,613.0,195.0,200,31408,8793.0,538.0,146.0
0.068,6,10,1506,5,395,16.0,127.0,127.0,5,1111,14.0,843.0,843.0
0.004,6,10,1989,5,927,1.0,659.0,659.0,5,1062,1.0,794.0,794.0
0.123,6,10,1506,5,395,28.0,127.0,127.0,5,1111,25.0,843.0,843.0
0.342,17,53,34121,31,27702,11.0,1350.0,865.0,22,6419,13.0,1350.0,263.0
40.069,17,10,676,5,460,10015.0,104.0,64.0,5,216,10016.0,20.0,15.0
0.005,6,10,2006,5,927,1.0,659.0,659.0,5,1079,1.0,811.0,811.0
33.284,6,38,13557,20,3997,1751.0,1070.0,630.0,18,9560,1949.0,1360.0,630.0
0.011,6,10,1990,5,911,2.0,643.0,643.0,5,1079,2.0,811.0,811.0
0.066,6,10,1506,5,395,15.0,127.0,127.0,5,1111,15.0,843.0,843.0
0.006,17,2,175,1,65,0.0,37.0,37.0,1,110,0.0,82.0,82.0
0.001,17,2,136,1,60,0.0,32.0,32.0,1,76,0.0,48.0,48.0
0.125,6,10,1506,5,395,27.0,127.0,127.0,5,1111,29.0,843.0,843.0
0.004,6,10,2007,5,928,1.0,660.0,660.0,5,1079,1.0,811.0,811.0
0.008,17,2,194,1,59,0.0,31.0,31.0,1,135,0.0,107.0,107.0
0.093,6,10,1506,5,395,21.0,127.0,127.0,5,1111,16.0,843.0,843.0
368.476,6,22,2313,16,867,24565.0,195.0,195.0,6,1446,4639.0,419.0,398.0
0.004,6,10,1774,5,923,1.0,655.0,655.0,5,851,0.0,583.0,583.0
0.01,6,10,1983,5,910,2.0,642.0,642.0,5,1073,2.0,805.0,805.0
0.001,17,2,180,1,66,0.0,38.0,38.0,1,114,0.0,86.0,86.0
0.005,6,10,1689,5,839,1.0,571.0,571.0,5,850,1.0,582.0,582.0
0.167,17,2,152,1,76,0.0,48.0,48.0,1,76,0.0,48.0,48.0
0.008,17,2,194,1,59,0.0,31.0,31.0,1,135,0.0,107.0,107.0
0.015,6,10,1990,5,911,3.0,643.0,643.0,5,1079,3.0,811.0,811.0
0.004,6,10,1779,5,928,1.0,660.0,660.0,5,851,1.0,583.0,583.0
0.018,6,10,1983,5,910,4.0,642.0,642.0,5,1073,4.0,805.0,805.0
0.005,6,10,2007,5,928,1.0,660.0,660.0,5,1079,1.0,811.0,811.0
0.006,6,10,2007,5,928,1.0,660.0,660.0,5,1079,1.0,811.0,811.0
0.007,6,11,1695,6,912,1.0,592.0,592.0,5,783,1.0,515.0,515.0
0.859,6,10,1790,6,1436,171.0,1184.0,1184.0,4,354,202.0,182.0,182.0
0.004,17,4,284,2,120,0.0,32.0,32.0,2,164,0.0,60.0,54.0
0.1,6,10,1506,5,395,24.0,127.0,127.0,5,1111,22.0,843.0,843.0
0.069,6,10,1506,5,395,15.0,127.0,127.0,5,1111,17.0,843.0,843.0
0.01,17,2,194,1,59,0.0,31.0,31.0,1,135,0.0,107.0,107.0
0.004,6,10,2006,5,927,1.0,659.0,659.0,5,1079,1.0,811.0,811.0
0.005,17,2,148,1,60,0.0,32.0,32.0,1,88,0.0,60.0,60.0
0.011,6,10,1983,5,910,2.0,642.0,642.0,5,1073,2.0,805.0,805.0
308.697,17,20,1124,10,716,34285.0,48.0,43.0,10,408,34285.0,20.0,12.0
0.006,17,2,175,1,65,0.0,37.0,37.0,1,110,0.0,82.0,82.0
0.006,17,2,230,1,68,0.0,40.0,40.0,1,162,0.0,134.0,134.0
0.152,6,10,1506,5,395,33.0,127.0,127.0,5,1111,37.0,843.0,843.0
0.001,17,2,136,1,60,0.0,32.0,32.0,1,76,0.0,48.0,48.0
0.027,6,20,9974,11,704,2.0,124.0,124.0,9,9270,3.0,2896.0,1758.0
0.001,17,2,180,1,66,0.0,38.0,38.0,1,114,0.0,86.0,86.0
0.005,6,10,2000,5,927,1.0,659.0,659.0,5,1073,1.0,805.0,805.0
0.099,6,10,1506,5,395,18.0,127.0,127.0,5,1111,23.0,843.0,843.0
0.005,6,10,1547,5,764,1.0,496.0,496.0,5,783,1.0,515.0,515.0
0.006,17,2,172,1,59,0.0,31.0,31.0,1,113,0.0,85.0,85.0
0.113,6,10,1506,5,395,27.0,127.0,127.0,5,1111,22.0,843.0,843.0
0.014,6,10,1990,5,911,3.0,643.0,643.0,5,1079,3.0,811.0,811.0
0.005,6,10,2007,5,928,1.0,660.0,660.0,5,1079,1.0,811.0,811.0
0.005,6,10,1779,5,928,1.0,660.0,660.0,5,851,1.0,583.0,583.0
0.006,6,10,1643,5,860,1.0,592.0,592.0,5,783,1.0,515.0,515.0
175.057,17,84,12314,42,2807,4269.0,44.0,38.0,42,9507,4269.0,261.0,198.0
0.004,6,10,1779,5,928,1.0,660.0,660.0,5,851,1.0,583.0,583.0
0.005,6,10,1547,5,764,1.0,496.0,496.0,5,783,1.0,515.0,515.0
0.005,6,10,2006,5,927,1.0,659.0,659.0,5,1079,1.0,811.0,811.0
10.848,17,28,4424,14,1995,825.0,270.0,114.0,14,2429,825.0,588.0,145.0
0.012,17,2,152,1,56,0.0,28.0,28.0,1,96,0.0,68.0,68.0
0.009,6,10,1990,5,911,2.0,643.0,643.0,5,1079,2.0,811.0,811.0
0.08,6,10,1506,5,395,18.0,127.0,127.0,5,1111,17.0,843.0,843.0
10.76,17,26,4102,13,1822,887.0,269.0,112.0,13,2280,887.0,587.0,147.0
0.004,6,10,2006,5,927,1.0,659.0,659.0,5,1079,1.0,811.0,811.0
40.066,17,10,676,5,460,10013.0,104.0,64.0,5,216,10015.0,20.0,15.0
0.001,17,2,180,1,66,0.0,38.0,38.0,1,114,0.0,86.0,86.0
10.889,17,28,4422,14,1995,829.0,270.0,114.0,14,2427,829.0,586.0,145.0
240.099,6,41,9829,20,2026,12636.0,517.0,163.0,21,7803,12004.0,1402.0,670.0
0.006,6,10,2007,5,928,1.0,660.0,660.0,5,1079,1.0,811.0,811.0
0.006,17,2,144,1,64,0.0,36.0,36.0,1,80,0.0,52.0,52.0
0.006,6,10,1689,5,839,1.0,571.0,571.0,5,850,1.0,582.0,582.0
0.003,17,2,136,1,60,0.0,32.0,32.0,1,76,0.0,48.0,48.0
0.112,6,10,1506,5,395,24.0,127.0,127.0,5,1111,21.0,843.0,843.0
0.005,6,10,1989,5,927,1.0,659.0,659.0,5,1062,1.0,794.0,794.0
0.17,6,10,1506,5,395,40.0,127.0,127.0,5,1111,20.0,843.0,843.0
9.038,17,6,376,5,280,2259.0,28.0,28.0,1,96,0.0,68.0,68.0
0.005,17,2,169,1,62,0.0,34.0,34.0,1,107,0.0,79.0,79.0
0.005,6,10,2006,5,927,1.0,659.0,659.0,5,1079,1.0,811.0,811.0
0.005,6,10,1989,5,927,1.0,659.0,659.0,5,1062,1.0,794.0,794.0
0.101,6,10,1506,5,395,21.0,127.0,127.0,5,1111,20.0,843.0,843.0
0.005,17,2,170,1,65,0.0,37.0,37.0,1,105,0.0,77.0,77.0
0.022,6,10,1677,5,827,5.0,559.0,559.0,5,850,5.0,582.0,582.0
0.003,17,4,284,2,120,0.0,32.0,32.0,2,164,0.0,60.0,54.0
0.011,6,10,1983,5,910,2.0,642.0,642.0,5,1073,2.0,805.0,805.0
0.001,17,2,180,1,66,0.0,38.0,38.0,1,114,0.0,86.0,86.0
0.012,6,10,1983,5,910,2.0,642.0,642.0,5,1073,3.0,805.0,805.0
0.012,6,10,1989,5,910,3.0,642.0,642.0,5,1079,2.0,811.0,811.0
369.404,6,22,2313,16,867,24626.0,195.0,195.0,6,1446,4637.0,419.0,398.0
0.004,6,10,2000,5,927,1.0,659.0,659.0,5,1073,1.0,805.0,805.0
0.085,6,10,1506,5,395,18.0,127.0,127.0,5,1111,18.0,843.0,843.0
0.005,6,14,3742,7,452,0.0,80.0,80.0,7,3290,0.0,1448.0,972.0
0.006,6,10,1689,5,839,1.0,571.0,571.0,5,850,1.0,582.0,582.0
0.012,6,10,1983,5,910,2.0,642.0,642.0,5,1073,3.0,805.0,805.0
0.001,17,2,136,1,60,0.0,32.0,32.0,1,76,0.0,48.0,48.0
0.005,17,2,170,1,65,0.0,37.0,37.0,1,105,0.0,77.0,77.0
0.004,17,2,166,1,75,0.0,47.0,47.0,1,91,0.0,63.0,63.0
0.018,6,10,1990,5,911,4.0,643.0,643.0,5,1079,4.0,811.0,811.0
0.06,17,2,152,1,76,0.0,48.0,48.0,1,76,0.0,48.0,48.0
0.011,6,10,1990,5,911,2.0,643.0,643.0,5,1079,2.0,811.0,811.0
0.175,6,10,1506,5,395,38.0,127.0,127.0,5,1111,40.0,843.0,843.0
40.06,17,10,676,5,460,10014.0,104.0,64.0,5,216,10014.0,20.0,15.0
0.012,6,10,1989,5,910,2.0,642.0,642.0,5,1079,2.0,811.0,811.0
1785.842,6,297,51616,121,34145,14882.0,2720.0,304.0,176,17471,10204.0,1360.0,128.0
0.014,6,10,1972,5,910,3.0,642.0,642.0,5,1062,3.0,794.0,794.0
0.008,17,2,179,1,71,0.0,43.0,43.0,1,108,0.0,80.0,80.0
0.009,6,12,1926,6,1189,1.0,659.0,434.0,6,737,1.0,417.0,417.0
0.006,6,10,1547,5,764,1.0,496.0,496.0,5,783,1.0,515.0,515.0
0.043,17,2,152,1,76,0.0,48.0,48.0,1,76,0.0,48.0,48.0
0.009,6,10,1983,5,910,2.0,642.0,642.0,5,1073,2.0,805.0,805.0
309.563,17,20,1124,10,716,34389.0,48.0,43.0,10,408,34388.0,20.0,12.0
0.005,6,10,1774,5,923,1.0,655.0,655.0,5,851,1.0,583.0,583.0
0.11,6,10,1506,5,395,25.0,127.0,127.0,5,1111,23.0,843.0,843.0
0.004,6,10,1702,5,863,1.0,595.0,595.0,5,839,0.0,571.0,571.0
0.005,17,2,179,1,71,0.0,43.0,43.0,1,108,0.0,80.0,80.0
0.086,6,10,1506,5,395,20.0,127.0,127.0,5,1111,19.0,843.0,843.0
0.004,17,2,148,1,60,0.0,32.0,32.0,1,88,0.0,60.0,60.0
29.069,58,2,144,1,72,0.0,24.0,24.0,1,72,0.0,24.0,24.0
0.012,6,10,1677,5,827,3.0,559.0,559.0,5,850,2.0,582.0,582.0
0.012,6,10,1989,5,910,3.0,642.0,642.0,5,1079,2.0,811.0,811.0
0.005,6,10,1989,5,927,1.0,659.0,659.0,5,1062,1.0,794.0,794.0
0.001,17,2,180,1,66,0.0,38.0,38.0,1,114,0.0,86.0,86.0
0.126,6,10,1506,5,395,31.0,127.0,127.0,5,1111,28.0,843.0,843.0
0.011,6,10,1989,5,910,2.0,642.0,642.0,5,1079,2.0,811.0,811.0
0.001,17,2,180,1,66,0.0,38.0,38.0,1,114,0.0,86.0,86.0
0.094,6,10,1506,5,395,20.0,127.0,127.0,5,1111,22.0,843.0,843.0
0.003,17,4,284,2,120,0.0,32.0,32.0,2,164,0.0,60.0,54.0
0.011,6,10,1972,5,910,2.0,642.0,642.0,5,1062,2.0,794.0,794.0
0.139,6,10,1506,5,395,31.0,127.0,127.0,5,1111,31.0,843.0,843.0
615.354,6,35,11300,19,4609,34186.0,1273.0,514.0,16,6691,37020.0,1402.0,731.0
0.005,6,10,2007,5,928,1.0,660.0,660.0,5,1079,1.0,811.0,811.0
293.04,6,33,6264,18,1338,17237.0,267.0,195.0,15,4926,606.0,1823.0,392.0
352.247,6,20,2210,6,1308,12003.0,494.0,494.0,14,902,27095.0,83.0,83.0
0.004,6,10,1702,5,863,1.0,595.0,595.0,5,839,0.0,571.0,571.0
0.005,6,10,1989,5,927,1.0,659.0,659.0,5,1062,1.0,794.0,794.0
0.005,17,2,170,1,65,0.0,37.0,37.0,1,105,0.0,77.0,77.0
0.004,17,2,136,1,60,0.0,32.0,32.0,1,76,0.0,48.0,48.0
0.014,6,10,1989,5,910,3.0,642.0,642.0,5,1079,3.0,811.0,811.0
352.247,6,20,2210,6,1308,12003.0,494.0,494.0,14,902,27095.0,83.0,83.0
0.004,6,10,2000,5,927,1.0,659.0,659.0,5,1073,1.0,805.0,805.0
0.031,6,10,1972,5,910,7.0,642.0,642.0,5,1062,7.0,794.0,794.0
0.041,17,2,182,1,65,0.0,37.0,37.0,1,117,0.0,89.0,89.0
0.014,6,10,1990,5,911,3.0,643.0,643.0,5,1079,3.0,811.0,811.0
0.135,6,10,1506,5,395,31.0,127.0,127.0,5,1111,33.0,843.0,843.0
0.08,6,10,1506,5,395,18.0,127.0,127.0,5,1111,18.0,843.0,843.0
0.005,6,13,3747,7,509,0.0,137.0,137.0,6,3238,1.0,1470.0,1459.0
0.014,17,2,263,1,60,0.0,32.0,32.0,1,203,0.0,175.0,175.0
0.005,17,2,179,1,71,0.0,43.0,43.0,1,108,0.0,80.0,80.0
0.019,6,10,1990,5,911,4.0,643.0,643.0,5,1079,4.0,811.0,811.0
0.017,6,10,1990,5,911,4.0,643.0,643.0,5,1079,4.0,811.0,811.0
1786.389,6,150,19350,90,13740,20071.0,302.0,302.0,60,5610,30277.0,83.0,83.0
0.003,17,2,136,1,60,0.0,32.0,32.0,1,76,0.0,48.0,48.0
0.006,6,10,1547,5,764,1.0,496.0,496.0,5,783,1.0,515.0,515.0
0.078,6,10,1506,5,395,19.0,127.0,127.0,5,1111,18.0,843.0,843.0
0.013,6,10,1972,5,910,3.0,642.0,642.0,5,1062,3.0,794.0,794.0
0.004,6,10,1989,5,927,1.0,659.0,659.0,5,1062,1.0,794.0,794.0
0.071,17,8,3613,4,1874,23.0,1350.0,440.0,4,1739,12.0,1350.0,406.0
0.003,6,10,1702,5,863,0.0,595.0,595.0,5,839,0.0,571.0,571.0
0.04,17,2,184,1,61,0.0,33.0,33.0,1,123,0.0,95.0,95.0
0.008,6,10,1983,5,910,1.0,642.0,642.0,5,1073,1.0,805.0,805.0
0.005,6,13,3690,7,452,0.0,80.0,80.0,6,3238,1.0,1470.0,1459.0
0.006,6,10,1547,5,764,1.0,496.0,496.0,5,783,1.0,515.0,515.0
0.01,6,12,1926,6,1189,1.0,659.0,434.0,6,737,2.0,417.0,417.0
0.006,6,10,1547,5,764,1.0,496.0,496.0,5,783,1.0,515.0,515.0
0.01,6,10,1983,5,910,2.0,642.0,642.0,5,1073,2.0,805.0,805.0
0.005,6,10,2006,5,927,1.0,659.0,659.0,5,1079,1.0,811.0,811.0
0.005,6,10,1779,5,928,1.0,660.0,660.0,5,851,1.0,583.0,583.0
0.113,6,10,1506,5,395,26.0,127.0,127.0,5,1111,23.0,843.0,843.0
0.01,6,10,1972,5,910,2.0,642.0,642.0,5,1062,2.0,794.0,794.0
0.02,6,10,1677,5,827,4.0,559.0,559.0,5,850,4.0,582.0,582.0
0.015,6,10,1972,5,910,3.0,642.0,642.0,5,1062,3.0,794.0,794.0
0.016,6,10,1983,5,910,4.0,642.0,642.0,5,1073,4.0,805.0,805.0
0.006,6,10,1547,5,764,1.0,496.0,496.0,5,783,1.0,515.0,515.0
0.005,6,10,1774,5,923,1.0,655.0,655.0,5,851,1.0,583.0,583.0
0.001,17,2,180,1,66,0.0,38.0,38.0,1,114,0.0,86.0,86.0
0.106,6,10,1506,5,395,23.0,127.0,127.0,5,1111,25.0,843.0,843.0
0.039,17,2,412,1,61,0.0,33.0,33.0,1,351,0.0,323.0,323.0
0.138,6,10,1506,5,395,32.0,127.0,127.0,5,1111,30.0,843.0,843.0
0.082,6,10,1506,5,395,18.0,127.0,127.0,5,1111,20.0,843.0,843.0
0.011,6,10,1989,5,910,2.0,642.0,642.0,5,1079,2.0,811.0,811.0
0.014,6,10,1990,5,911,3.0,643.0,643.0,5,1079,3.0,811.0,811.0
0.005,6,10,2000,5,927,1.0,659.0,659.0,5,1073,1.0,805.0,805.0
0.008,6,10,1990,5,911,2.0,643.0,643.0,5,1079,1.0,811.0,811.0
0.001,17,2,180,1,66,0.0,38.0,38.0,1,114,0.0,86.0,86.0
0.005,6,10,2006,5,927,1.0,659.0,659.0,5,1079,1.0,811.0,811.0
0.006,6,10,1547,5,764,1.0,496.0,496.0,5,783,1.0,515.0,515.0
0.018,6,10,1990,5,911,4.0,643.0,643.0,5,1079,4.0,811.0,811.0
0.004,6,10,1989,5,927,1.0,659.0,659.0,5,1062,1.0,794.0,794.0
0.006,6,10,1547,5,764,1.0,496.0,496.0,5,783,1.0,515.0,515.0
40.069,17,10,676,5,460,10014.0,104.0,64.0,5,216,10016.0,20.0,15.0
0.005,6,10,1989,5,927,1.0,659.0,659.0,5,1062,1.0,794.0,794.0
0.008,6,10,1989,5,927,1.0,659.0,659.0,5,1062,2.0,794.0,794.0
0.092,6,10,1506,5,395,20.0,127.0,127.0,5,1111,19.0,843.0,843.0
0.012,6,10,1989,5,910,2.0,642.0,642.0,5,1079,2.0,811.0,811.0
0.121,6,10,1506,5,395,25.0,127.0,127.0,5,1111,26.0,843.0,843.0
0.005,6,14,3742,7,452,0.0,80.0,80.0,7,3290,0.0,1448.0,972.0
40.061,17,10,676,5,460,10014.0,104.0,64.0,5,216,10014.0,20.0,15.0
0.006,6,10,1547,5,764,1.0,496.0,496.0,5,783,1.0,515.0,515.0
0.02,6,10,1762,5,911,5.0,643.0,643.0,5,851,5.0,583.0,583.0
0.128,6,10,1506,5,395,23.0,127.0,127.0,5,1111,24.0,843.0,843.0
0.005,6,10,2007,5,928,1.0,660.0,660.0,5,1079,1.0,811.0,811.0
0.004,6,10,1989,5,927,1.0,659.0,659.0,5,1062,1.0,794.0,794.0
0.111,6,10,1506,5,395,19.0,127.0,127.0,5,1111,25.0,843.0,843.0
0.005,17,2,208,1,72,0.0,44.0,44.0,1,136,0.0,108.0,108.0
11.151,17,28,4423,14,1994,845.0,269.0,114.0,14,2429,845.0,588.0,145.0
0.006,6,10,1689,5,839,1.0,571.0,571.0,5,850,1.0,582.0,582.0
0.266,17,38,20297,21,17037,13.0,1350.0,783.0,17,3260,13.0,1350.0,163.0
0.1,6,10,1506,5,395,22.0,127.0,127.0,5,1111,19.0,843.0,843.0
0.007,17,2,136,1,60,0.0,32.0,32.0,1,76,0.0,48.0,48.0
0.005,17,2,148,1,60,0.0,32.0,32.0,1,88,0.0,60.0,60.0
40.054,17,10,676,5,460,10012.0,104.0,64.0,5,216,10012.0,20.0,15.0
300.34,6,16,2170,9,684,37521.0,146.0,146.0,7,1486,50029.0,419.0,398.0
40.056,17,10,676,5,460,10012.0,104.0,64.0,5,216,10011.0,20.0,15.0
309.046,17,20,1124,10,716,34323.0,48.0,43.0,10,408,34323.0,20.0,12.0
0.004,6,10,2006,5,927,1.0,659.0,659.0,5,1079,1.0,811.0,811.0
0.017,6,10,1989,5,910,4.0,642.0,642.0,5,1079,4.0,811.0,811.0
0.016,6,10,1989,5,910,4.0,642.0,642.0,5,1079,4.0,811.0,811.0
0.068,6,10,1506,5,395,16.0,127.0,127.0,5,1111,11.0,843.0,843.0
0.005,6,10,2006,5,927,1.0,659.0,659.0,5,1079,1.0,811.0,811.0
0.009,6,13,3735,7,497,1.0,125.0,125.0,6,3238,1.0,1470.0,1459.0
0.005,6,10,2006,5,927,1.0,659.0,659.0,5,1079,1.0,811.0,811.0
291.454,6,379,348452,181,21612,1619.0,2690.0,870.0,198,326840,1479.0,2865.0,1729.0
0.001,17,2,180,1,66,0.0,38.0,38.0,1,114,0.0,86.0,86.0
0.005,6,10,1547,5,764,1.0,496.0,496.0,5,783,1.0,515.0,515.0
0.005,6,14,3736,7,446,0.0,74.0,74.0,7,3290,0.0,1448.0,972.0
0.084,6,10,1506,5,395,19.0,127.0,127.0,5,1111,19.0,843.0,843.0
0.004,6,10,1702,5,863,1.0,595.0,595.0,5,839,1.0,571.0,571.0
0.081,6,10,1506,5,395,18.0,127.0,127.0,5,1111,17.0,843.0,843.0
1770.501,6,80,4212,40,2106,45396.0,26.0,26.0,40,2106,45396.0,26.0,26.0
0.005,6,10,2000,5,927,1.0,659.0,659.0,5,1073,1.0,805.0,805.0
0.005,6,10,2007,5,928,1.0,660.0,660.0,5,1079,1.0,811.0,811.0
0.003,17,2,148,1,60,0.0,32.0,32.0,1,88,0.0,60.0,60.0
0.004,17,2,136,1,60,0.0,32.0,32.0,1,76,0.0,48.0,48.0
0.078,6,10,1506,5,395,16.0,127.0,127.0,5,1111,17.0,843.0,843.0
0.009,6,13,3747,7,509,1.0,137.0,137.0,6,3238,1.0,1470.0,1459.0
1777.91,17,144,41760,72,22752,25040.0,288.0,288.0,72,19008,25040.0,236.0,236.0
0.071,6,10,1506,5,395,16.0,127.0,127.0,5,1111,15.0,843.0,843.0
240.141,6,20,4874,11,941,24014.0,180.0,93.0,9,3933,30017.0,1593.0,576.0
0.009,6,10,1989,5,910,2.0,642.0,642.0,5,1079,2.0,811.0,811.0
0.006,6,12,1698,6,863,1.0,327.0,271.0,6,835,1.0,515.0,515.0
0.004,6,10,1702,5,863,1.0,595.0,595.0,5,839,1.0,571.0,571.0
0.006,6,10,1547,5,764,1.0,496.0,496.0,5,783,1.0,515.0,515.0
240.069,6,21,4925,11,941,24006.0,180.0,93.0,10,3984,26674.0,1592.0,576.0
0.001,17,2,180,1,66,0.0,38.0,38.0,1,114,0.0,86.0,86.0
0.006,6,10,1547,5,764,1.0,496.0,496.0,5,783,1.0,515.0,515.0
0.009,6,10,1989,5,910,2.0,642.0,642.0,5,1079,2.0,811.0,811.0
0.005,6,10,1989,5,927,1.0,659.0,659.0,5,1062,1.0,794.0,794.0
0.006,6,10,1689,5,839,1.0,571.0,571.0,5,850,1.0,582.0,582.0
0.127,6,10,1506,5,395,29.0,127.0,127.0,5,1111,28.0,843.0,843.0
0.018,6,10,1990,5,911,4.0,643.0,643.0,5,1079,4.0,811.0,811.0
40.068,17,10,676,5,460,10014.0,104.0,64.0,5,216,10016.0,20.0,15.0
0.006,6,10,1774,5,923,1.0,655.0,655.0,5,851,1.0,583.0,583.0
0.094,6,10,1506,5,395,21.0,127.0,127.0,5,1111,19.0,843.0,843.0
292.25,6,375,347502,197,21803,1491.0,2736.0,888.0,178,325699,1651.0,2918.0,1929.0
1770.618,17,120,11460,60,5460,30010.0,63.0,63.0,60,6000,30010.0,72.0,72.0
0.01,6,10,1983,5,910,2.0,642.0,642.0,5,1073,2.0,805.0,805.0
1.072,6,24,7127,13,1703,89.0,517.0,256.0,11,5424,106.0,1402.0,692.0
0.005,6,13,3747,7,509,0.0,137.0,137.0,6,3238,0.0,1470.0,1459.0
0.005,6,10,1643,5,860,1.0,592.0,592.0,5,783,1.0,515.0,515.0
165.28,17,74,10604,37,2467,4590.0,44.0,38.0,37,8137,4591.0,261.0,191.0
0.001,17,2,178,1,81,0.0,53.0,53.0,1,97,0.0,69.0,69.0
0.068,6,10,1506,5,395,16.0,127.0,127.0,5,1111,13.0,843.0,843.0
0.14,6,10,1506,5,395,32.0,127.0,127.0,5,1111,29.0,843.0,843.0
240.088,6,16,4480,9,963,30011.0,238.0,166.0,7,3517,40014.0,1402.0,786.0
0.087,6,10,1506,5,395,21.0,127.0,127.0,5,1111,18.0,843.0,843.0
0.009,6,10,1972,5,910,2.0,642.0,642.0,5,1062,2.0,794.0,794.0
0.005,6,10,1643,5,860,1.0,592.0,592.0,5,783,1.0,515.0,515.0
240.07,6,20,4873,10,889,26674.0,180.0,93.0,10,3984,26674.0,1592.0,576.0
0.092,6,10,1506,5,395,19.0,127.0,127.0,5,1111,17.0,843.0,843.0
0.006,6,10,1547,5,764,1.0,496.0,496.0,5,783,1.0,515.0,515.0
0.005,17,4,495,2,132,0.0,38.0,38.0,2,363,2.0,176.0,153.0
0.1,6,10,1506,5,395,24.0,127.0,127.0,5,1111,18.0,843.0,843.0
0.087,6,10,1506,5,395,19.0,127.0,127.0,5,1111,19.0,843.0,843.0
0.006,6,10,2007,5,928,1.0,660.0,660.0,5,1079,1.0,811.0,811.0
0.08,6,10,1506,5,395,17.0,127.0,127.0,5,1111,16.0,843.0,843.0
0.008,6,10,1989,5,910,2.0,642.0,642.0,5,1079,2.0,811.0,811.0
0.005,6,10,2007,5,928,1.0,660.0,660.0,5,1079,1.0,811.0,811.0
0.006,17,2,230,1,68,0.0,40.0,40.0,1,162,0.0,134.0,134.0
0.018,6,10,1989,5,910,4.0,642.0,642.0,5,1079,4.0,811.0,811.0
0.005,6,10,1689,5,839,1.0,571.0,571.0,5,850,1.0,582.0,582.0
0.081,6,10,1506,5,395,18.0,127.0,127.0,5,1111,18.0,843.0,843.0
0.302,17,17,8690,9,6073,37.0,1350.0,646.0,8,2617,26.0,1350.0,299.0
0.013,6,10,1990,5,911,3.0,643.0,643.0,5,1079,3.0,811.0,811.0
0.011,17,2,144,1,64,0.0,36.0,36.0,1,80,0.0,52.0,52.0
0.005,17,2,140,1,62,0.0,34.0,34.0,1,78,0.0,50.0,50.0
0.009,17,2,179,1,71,0.0,43.0,43.0,1,108,0.0,80.0,80.0
0.009,6,10,1972,5,910,2.0,642.0,642.0,5,1062,2.0,794.0,794.0
0.012,6,10,1983,5,910,2.0,642.0,642.0,5,1073,2.0,805.0,805.0
0.003,17,2,148,1,60,0.0,32.0,32.0,1,88,0.0,60.0,60.0
0.006,17,2,170,1,65,0.0,37.0,37.0,1,105,0.0,77.0,77.0
0.069,6,10,1506,5,395,14.0,127.0,127.0,5,1111,15.0,843.0,843.0
0.07,17,8,3613,4,1874,23.0,1350.0,440.0,4,1739,11.0,1350.0,406.0
0.018,6,10,1631,5,848,4.0,580.0,580.0,5,783,4.0,515.0,515.0
0.037,17,2,170,1,65,0.0,37.0,37.0,1,105,0.0,77.0,77.0
0.006,6,10,1547,5,764,1.0,496.0,496.0,5,783,1.0,515.0,515.0
0.005,17,4,284,2,120,0.0,32.0,32.0,2,164,0.0,60.0,54.0
0.003,6,10,1702,5,863,0.0,595.0,595.0,5,839,0.0,571.0,571.0
0.033,6,10,1989,5,910,8.0,642.0,642.0,5,1079,8.0,811.0,811.0
0.005,17,2,170,1,65,0.0,37.0,37.0,1,105,0.0,77.0,77.0
0.005,6,13,3690,7,452,0.0,80.0,80.0,6,3238,1.0,1470.0,1459.0
0.005,6,10,2000,5,927,1.0,659.0,659.0,5,1073,1.0,805.0,805.0
0.005,6,14,3742,7,452,0.0,80.0,80.0,7,3290,0.0,1448.0,972.0
0.006,6,10,1547,5,764,1.0,496.0,496.0,5,783,1.0,515.0,515.0
52.7,6,37,9811,19,4293,499.0,1360.0,700.0,18,5518,3089.0,2667.0,435.0
0.01,6,10,1677,5,827,2.0,559.0,559.0,5,850,2.0,582.0,582.0
0.091,6,10,1506,5,395,21.0,127.0,127.0,5,1111,20.0,843.0,843.0
0.004,17,2,148,1,60,0.0,32.0,32.0,1,88,0.0,60.0,60.0
0.01,6,12,1926,6,1189,2.0,659.0,434.0,6,737,1.0,417.0,417.0
15.081,17,15,8458,8,6327,2150.0,1350.0,762.0,7,2131,2508.0,1350.0,276.0
0.02,6,10,1972,5,910,4.0,642.0,642.0,5,1062,5.0,794.0,794.0
246.522,6,37,9412,15,6584,17608.0,1707.0,645.0,22,2828,11739.0,580.0,128.0
0.09,6,10,1506,5,395,20.0,127.0,127.0,5,1111,17.0,843.0,843.0
0.02,6,10,1990,5,911,5.0,643.0,643.0,5,1079,5.0,811.0,811.0
0.005,6,13,3747,7,509,0.0,137.0,137.0,6,3238,1.0,1470.0,1459.0
360.034,6,21,3981,13,3142,30002.0,494.0,494.0,8,839,51433.0,83.0,83.0
0.069,6,10,1506,5,395,16.0,127.0,127.0,5,1111,14.0,843.0,843.0
0.073,17,2,148,1,60,0.0,32.0,32.0,1,88,0.0,60.0,60.0
0.089,6,10,1506,5,395,21.0,127.0,127.0,5,1111,20.0,843.0,843.0
11.195,17,28,4422,14,1994,848.0,269.0,114.0,14,2428,848.0,587.0,145.0
0.004,6,10,2006,5,927,1.0,659.0,659.0,5,1079,1.0,811.0,811.0
0.155,6,10,1506,5,395,37.0,127.0,127.0,5,1111,37.0,843.0,843.0
0.22,17,17,8725,8,6112,31.0,1350.0,736.0,9,2613,19.0,1350.0,262.0
0.011,6,10,1989,5,910,2.0,642.0,642.0,5,1079,2.0,811.0,811.0
0.006,6,10,1547,5,764,1.0,496.0,496.0,5,783,1.0,515.0,515.0
0.064,6,10,1506,5,395,14.0,127.0,127.0,5,1111,15.0,843.0,843.0
0.026,6,10,1972,5,910,6.0,642.0,642.0,5,1062,6.0,794.0,794.0
1785.207,6,284,26786,143,9879,12571.0,748.0,270.0,141,16907,12751.0,1466.0,71.0
0.005,6,10,2007,5,928,1.0,660.0,660.0,5,1079,1.0,811.0,811.0
0.006,6,10,1643,5,860,1.0,592.0,592.0,5,783,1.0,515.0,515.0
40.11,17,10,676,5,460,10023.0,104.0,64.0,5,216,10026.0,20.0,15.0
0.003,17,2,136,1,60,0.0,32.0,32.0,1,76,0.0,48.0,48.0
0.004,17,4,284,2,120,0.0,32.0,32.0,2,164,0.0,60.0,54.0
1.151,6,31,13351,17,5852,71.0,2720.0,854.0,14,7499,74.0,2720.0,769.0
0.036,17,2,318,1,72,0.0,44.0,44.0,1,246,0.0,218.0,218.0
0.006,6,10,1547,5,764,1.0,496.0,496.0,5,783,1.0,515.0,515.0
0.108,6,10,1506,5,395,19.0,127.0,127.0,5,1111,22.0,843.0,843.0
0.005,17,2,214,1,75,0.0,47.0,47.0,1,139,0.0,111.0,111.0
0.069,17,8,3613,4,1874,23.0,1350.0,440.0,4,1739,12.0,1350.0,406.0
0.069,17,8,3613,4,1874,23.0,1350.0,440.0,4,1739,11.0,1350.0,406.0
0.012,6,10,1631,5,848,3.0,580.0,580.0,5,783,3.0,515.0,515.0
0.005,6,10,2007,5,928,1.0,660.0,660.0,5,1079,1.0,811.0,811.0
0.073,6,10,1506,5,395,13.0,127.0,127.0,5,1111,17.0,843.0,843.0
0.004,6,10,2006,5,927,1.0,659.0,659.0,5,1079,1.0,811.0,811.0
0.009,6,10,1677,5,827,2.0,559.0,559.0,5,850,2.0,582.0,582.0
0.005,6,10,2006,5,927,1.0,659.0,659.0,5,1079,1.0,811.0,811.0
0.012,6,10,1990,5,911,2.0,643.0,643.0,5,1079,3.0,811.0,811.0
1772.483,6,303,98265,187,87013,9529.0,2001.0,683.0,116,11252,15412.0,452.0,70.0
0.006,6,10,1547,5,764,1.0,496.0,496.0,5,783,1.0,515.0,515.0
40.062,17,10,676,5,460,10014.0,104.0,64.0,5,216,10014.0,20.0,15.0
0.004,6,10,1779,5,928,1.0,660.0,660.0,5,851,1.0,583.0,583.0
0.01,6,10,1983,5,910,2.0,642.0,642.0,5,1073,2.0,805.0,805.0
0.012,6,10,1990,5,911,3.0,643.0,643.0,5,1079,3.0,811.0,811.0
0.066,6,10,1506,5,395,15.0,127.0,127.0,5,1111,13.0,843.0,843.0
0.004,17,2,164,1,74,0.0,46.0,46.0,1,90,0.0,62.0,62.0
0.001,17,2,180,1,66,0.0,38.0,38.0,1,114,0.0,86.0,86.0
0.008,6,10,1631,5,848,2.0,580.0,580.0,5,783,2.0,515.0,515.0
0.007,6,10,2006,5,927,1.0,659.0,659.0,5,1079,1.0,811.0,811.0
0.008,6,10,1989,5,910,2.0,642.0,642.0,5,1079,1.0,811.0,811.0
0.11,6,10,1506,5,395,24.0,127.0,127.0,5,1111,25.0,843.0,843.0
11.121,17,28,4423,14,1995,843.0,270.0,114.0,14,2428,843.0,587.0,145.0
0.054,17,4,352,2,130,13.0,37.0,37.0,2,222,49.0,89.0,83.0
0.066,17,8,3613,4,1874,22.0,1350.0,440.0,4,1739,10.0,1350.0,406.0
0.092,6,10,1506,5,395,21.0,127.0,127.0,5,1111,20.0,843.0,843.0
0.084,6,10,1506,5,395,19.0,127.0,127.0,5,1111,18.0,843.0,843.0
0.003,17,2,136,1,60,0.0,32.0,32.0,1,76,0.0,48.0,48.0
0.01,6,10,1677,5,827,2.0,559.0,559.0,5,850,2.0,582.0,582.0
0.013,6,10,1989,5,910,3.0,642.0,642.0,5,1079,3.0,811.0,811.0
0.005,6,10,2006,5,927,1.0,659.0,659.0,5,1079,1.0,811.0,811.0
58.874,6,38,12382,19,6824,492.0,2720.0,1206.0,19,5558,3261.0,2667.0,435.0
0.135,6,10,1506,5,395,32.0,127.0,127.0,5,1111,32.0,843.0,843.0
0.005,6,10,1689,5,839,1.0,571.0,571.0,5,850,1.0,582.0,582.0
0.006,6,10,2007,5,928,1.0,660.0,660.0,5,1079,1.0,811.0,811.0
0.005,6,10,2006,5,927,1.0,659.0,659.0,5,1079,1.0,811.0,811.0
0.009,6,10,1983,5,910,2.0,642.0,642.0,5,1073,2.0,805.0,805.0
240.016,6,9,787,5,488,60004.0,232.0,232.0,4,299,80004.0,83.0,83.0
0.005,6,10,1689,5,839,1.0,571.0,571.0,5,850,1.0,582.0,582.0
0.11,6,10,1506,5,395,25.0,127.0,127.0,5,1111,25.0,843.0,843.0
0.01,17,2,169,1,62,0.0,34.0,34.0,1,107,0.0,79.0,79.0
0.008,17,2,194,1,59,0.0,31.0,31.0,1,135,0.0,107.0,107.0
0.01,6,10,1989,5,910,2.0,642.0,642.0,5,1079,2.0,811.0,811.0
0.005,6,10,1547,5,764,1.0,496.0,496.0,5,783,1.0,515.0,515.0
0.001,17,2,180,1,66,0.0,38.0,38.0,1,114,0.0,86.0,86.0
0.084,6,10,1506,5,395,17.0,127.0,127.0,5,1111,18.0,843.0,843.0
0.012,6,10,1677,5,827,3.0,559.0,559.0,5,850,3.0,582.0,582.0
0.098,6,10,1506,5,395,23.0,127.0,127.0,5,1111,18.0,843.0,843.0
0.008,6,10,1972,5,910,2.0,642.0,642.0,5,1062,2.0,794.0,794.0
0.016,6,10,1972,5,910,3.0,642.0,642.0,5,1062,3.0,794.0,794.0
0.084,6,10,1506,5,395,19.0,127.0,127.0,5,1111,17.0,843.0,843.0
0.007,6,10,1689,5,839,1.0,571.0,571.0,5,850,1.0,582.0,582.0
0.08,6,10,1506,5,395,16.0,127.0,127.0,5,1111,18.0,843.0,843.0
0.001,17,2,154,1,69,0.0,41.0,41.0,1,85,0.0,57.0,57.0
0.006,6,10,1547,5,764,1.0,496.0,496.0,5,783,1.0,515.0,515.0
10.78,17,28,4418,14,1993,820.0,268.0,114.0,14,2425,820.0,588.0,145.0
0.007,6,10,1989,5,910,1.0,642.0,642.0,5,1079,1.0,811.0,811.0
0.09,6,10,1506,5,395,21.0,127.0,127.0,5,1111,17.0,843.0,843.0
0.004,17,2,136,1,60,0.0,32.0,32.0,1,76,0.0,48.0,48.0
0.013,6,10,1972,5,910,3.0,642.0,642.0,5,1062,3.0,794.0,794.0
0.072,6,10,1506,5,395,16.0,127.0,127.0,5,1111,15.0,843.0,843.0
0.084,6,10,1506,5,395,18.0,127.0,127.0,5,1111,17.0,843.0,843.0
0.004,6,10,1702,5,863,1.0,595.0,595.0,5,839,1.0,571.0,571.0
0.004,6,10,1779,5,928,1.0,660.0,660.0,5,851,1.0,583.0,583.0
1769.395,17,92,8096,46,4048,39319.0,60.0,60.0,46,4048,39319.0,60.0,60.0
0.005,6,10,2006,5,927,1.0,659.0,659.0,5,1079,1.0,811.0,811.0
0.004,6,10,1989,5,927,1.0,659.0,659.0,5,1062,1.0,794.0,794.0
15.315,17,47,28020,28,24880,567.0,1350.0,860.0,19,3140,849.0,1350.0,137.0
0.005,6,10,1547,5,764,1.0,496.0,496.0,5,783,1.0,515.0,515.0
0.005,6,10,2006,5,927,1.0,659.0,659.0,5,1079,1.0,811.0,811.0
0.009,6,10,1972,5,910,2.0,642.0,642.0,5,1062,2.0,794.0,794.0
0.103,6,10,1506,5,395,23.0,127.0,127.0,5,1111,23.0,843.0,843.0
0.061,6,10,1506,5,395,13.0,127.0,127.0,5,1111,14.0,843.0,843.0
0.009,6,10,1989,5,910,2.0,642.0,642.0,5,1079,2.0,811.0,811.0
0.008,6,10,1989,5,910,2.0,642.0,642.0,5,1079,2.0,811.0,811.0
0.01,6,10,1631,5,848,2.0,580.0,580.0,5,783,2.0,515.0,515.0
0.001,17,2,180,1,66,0.0,38.0,38.0,1,114,0.0,86.0,86.0
240.393,6,38,9614,19,2003,13354.0,623.0,199.0,19,7611,13354.0,1402.0,509.0
0.006,6,10,1547,5,764,1.0,496.0,496.0,5,783,1.0,515.0,515.0
0.016,6,10,1989,5,910,4.0,642.0,642.0,5,1079,3.0,811.0,811.0
0.005,6,10,1989,5,927,1.0,659.0,659.0,5,1062,1.0,794.0,794.0
0.014,6,10,1989,5,910,3.0,642.0,642.0,5,1079,3.0,811.0,811.0
0.007,17,2,169,1,62,0.0,34.0,34.0,1,107,0.0,79.0,79.0
0.111,6,10,1506,5,395,22.0,127.0,127.0,5,1111,27.0,843.0,843.0
0.005,17,4,284,2,120,1.0,32.0,32.0,2,164,0.0,60.0,54.0
0.009,6,12,1926,6,1189,1.0,659.0,434.0,6,737,1.0,417.0,417.0
0.005,6,10,2006,5,927,1.0,659.0,659.0,5,1079,1.0,811.0,811.0
174.281,17,78,10891,39,2593,4586.0,44.0,38.0,39,8298,4585.0,239.0,184.0
309.512,17,20,1124,10,716,34377.0,48.0,43.0,10,408,34375.0,20.0,12.0
10.954,17,28,4421,14,1993,832.0,268.0,114.0,14,2428,833.0,587.0,145.0
374.727,6,22,2313,16,867,24981.0,195.0,195.0,6,1446,4636.0,419.0,398.0
0.039,17,4,284,2,120,1.0,32.0,32.0,2,164,35.0,60.0,54.0
0.004,6,14,3799,7,509,0.0,137.0,137.0,7,3290,0.0,1448.0,972.0
0.005,6,13,3747,7,509,0.0,137.0,137.0,6,3238,1.0,1470.0,1459.0
0.046,6,10,1972,5,910,11.0,642.0,642.0,5,1062,11.0,794.0,794.0
0.091,6,10,1506,5,395,19.0,127.0,127.0,5,1111,21.0,843.0,843.0
369.865,6,22,2313,16,867,24657.0,195.0,195.0,6,1446,4639.0,419.0,398.0
0.01,6,10,1989,5,910,2.0,642.0,642.0,5,1079,2.0,811.0,811.0
0.092,6,10,1506,5,395,18.0,127.0,127.0,5,1111,19.0,843.0,843.0
40.047,17,10,676,5,460,10010.0,104.0,64.0,5,216,10011.0,20.0,15.0
0.019,6,10,1972,5,910,4.0,642.0,642.0,5,1062,4.0,794.0,794.0
0.081,6,10,1506,5,395,16.0,127.0,127.0,5,1111,18.0,843.0,843.0
0.01,6,10,1972,5,910,2.0,642.0,642.0,5,1062,2.0,794.0,794.0
0.008,6,10,1989,5,910,2.0,642.0,642.0,5,1079,1.0,811.0,811.0
0.087,6,10,1506,5,395,19.0,127.0,127.0,5,1111,19.0,843.0,843.0
0.004,6,10,2006,5,927,1.0,659.0,659.0,5,1079,1.0,811.0,811.0
0.004,6,10,2000,5,927,1.0,659.0,659.0,5,1073,1.0,805.0,805.0
240.095,6,16,4481,9,963,30011.0,238.0,166.0,7,3518,40014.0,1402.0,786.0
0.01,6,10,1972,5,910,2.0,642.0,642.0,5,1062,2.0,794.0,794.0
0.043,6,10,1631,5,848,10.0,580.0,580.0,5,783,10.0,515.0,515.0
240.018,6,9,787,5,488,60004.0,232.0,232.0,4,299,80005.0,83.0,83.0
0.003,17,2,148,1,60,0.0,32.0,32.0,1,88,0.0,60.0,60.0
0.009,6,10,1972,5,910,2.0,642.0,642.0,5,1062,2.0,794.0,794.0
0.014,6,10,1762,5,911,3.0,643.0,643.0,5,851,3.0,583.0,583.0
0.042,17,2,170,1,65,0.0,37.0,37.0,1,105,0.0,77.0,77.0
0.005,6,10,2007,5,928,1.0,660.0,660.0,5,1079,1.0,811.0,811.0
10.831,17,28,4423,14,1995,824.0,270.0,114.0,14,2428,823.0,587.0,145.0
0.087,6,10,1506,5,395,19.0,127.0,127.0,5,1111,20.0,843.0,843.0
11.21,17,28,4419,14,1994,849.0,269.0,114.0,14,2425,849.0,588.0,145.0
0.005,17,2,170,1,65,0.0,37.0,37.0,1,105,0.0,77.0,77.0
0.006,6,10,1547,5,764,1.0,496.0,496.0,5,783,1.0,515.0,515.0
0.014,6,10,1983,5,910,3.0,642.0,642.0,5,1073,3.0,805.0,805.0
0.089,6,10,1506,5,395,16.0,127.0,127.0,5,1111,17.0,843.0,843.0
0.005,6,10,2006,5,927,1.0,659.0,659.0,5,1079,1.0,811.0,811.0
0.068,17,8,3613,4,1874,22.0,1350.0,440.0,4,1739,11.0,1350.0,406.0
15.269,17,46,25726,25,21218,635.0,1350.0,820.0,21,4508,762.0,1350.0,186.0
240.077,6,16,4481,9,963,30009.0,238.0,166.0,7,3518,40012.0,1402.0,786.0
0.023,17,2,136,1,60,0.0,32.0,32.0,1,76,0.0,48.0,48.0
65.628,6,23,8547,13,2288,67.0,1345.0,574.0,10,6259,7273.0,2720.0,974.0
0.005,6,10,2006,5,927,1.0,659.0,659.0,5,1079,1.0,811.0,811.0
0.012,6,10,1972,5,910,3.0,642.0,642.0,5,1062,3.0,794.0,794.0
0.078,6,10,1506,5,395,16.0,127.0,127.0,5,1111,17.0,843.0,843.0
0.005,6,13,3690,7,452,0.0,80.0,80.0,6,3238,1.0,1470.0,1459.0
0.014,6,10,1972,5,910,3.0,642.0,642.0,5,1062,3.0,794.0,794.0
0.016,6,10,1631,5,848,4.0,580.0,580.0,5,783,4.0,515.0,515.0
0.005,17,2,140,1,62,0.0,34.0,34.0,1,78,0.0,50.0,50.0
0.006,6,10,1762,5,911,1.0,643.0,643.0,5,851,1.0,583.0,583.0
0.004,6,10,2006,5,927,1.0,659.0,659.0,5,1079,1.0,811.0,811.0
300.312,6,16,2170,9,684,37518.0,146.0,146.0,7,1486,50025.0,419.0,398.0
0.016,6,10,1990,5,911,4.0,643.0,643.0,5,1079,3.0,811.0,811.0
0.005,6,10,1689,5,839,1.0,571.0,571.0,5,850,1.0,582.0,582.0
11.023,17,28,4421,14,1993,839.0,268.0,114.0,14,2428,839.0,587.0,145.0
0.07,6,10,1506,5,395,15.0,127.0,127.0,5,1111,16.0,843.0,843.0
0.007,6,10,1547,5,764,1.0,496.0,496.0,5,783,1.0,515.0,515.0
15.132,17,18,13388,9,8280,1887.0,1350.0,892.0,9,5108,1887.0,1350.0,539.0
0.006,6,12,1698,6,863,1.0,327.0,271.0,6,835,1.0,515.0,515.0
0.006,6,10,1854,5,889,1.0,621.0,621.0,5,965,1.0,697.0,697.0
0.076,6,10,1506,5,395,18.0,127.0,127.0,5,1111,15.0,843.0,843.0
0.005,6,10,1547,5,764,1.0,496.0,496.0,5,783,1.0,515.0,515.0
0.005,6,13,3747,7,509,0.0,137.0,137.0,6,3238,1.0,1470.0,1459.0
0.004,6,10,2006,5,927,1.0,659.0,659.0,5,1079,1.0,811.0,811.0
0.009,6,10,1983,5,910,2.0,642.0,642.0,5,1073,2.0,805.0,805.0
0.004,17,2,136,1,60,0.0,32.0,32.0,1,76,0.0,48.0,48.0
0.006,6,10,1547,5,764,1.0,496.0,496.0,5,783,1.0,515.0,515.0
0.01,6,10,1990,5,911,2.0,643.0,643.0,5,1079,2.0,811.0,811.0
0.001,17,2,166,1,75,0.0,47.0,47.0,1,91,0.0,63.0,63.0
0.076,6,10,1506,5,395,18.0,127.0,127.0,5,1111,16.0,843.0,843.0
0.005,17,2,178,1,65,0.0,37.0,37.0,1,113,0.0,85.0,85.0
0.0,17,2,136,1,60,0.0,32.0,32.0,1,76,0.0,48.0,48.0
0.005,6,13,3690,7,452,0.0,80.0,80.0,6,3238,0.0,1470.0,1459.0
0.119,6,10,1506,5,395,23.0,127.0,127.0,5,1111,26.0,843.0,843.0
0.005,6,10,2000,5,927,1.0,659.0,659.0,5,1073,1.0,805.0,805.0
0.003,17,2,148,1,60,0.0,32.0,32.0,1,88,0.0,60.0,60.0
0.005,17,2,166,1,75,0.0,47.0,47.0,1,91,0.0,63.0,63.0
0.014,6,10,1990,5,911,3.0,643.0,643.0,5,1079,3.0,811.0,811.0
0.004,17,2,136,1,60,0.0,32.0,32.0,1,76,0.0,48.0,48.0
0.005,6,10,2006,5,927,1.0,659.0,659.0,5,1079,1.0,811.0,811.0
0.007,6,13,3747,7,509,1.0,137.0,137.0,6,3238,1.0,1470.0,1459.0
0.013,6,10,1677,5,827,3.0,559.0,559.0,5,850,3.0,582.0,582.0
0.006,17,2,146,1,65,0.0,37.0,37.0,1,81,0.0,53.0,53.0
0.003,17,4,284,2,120,0.0,32.0,32.0,2,164,0.0,60.0,54.0
0.001,17,2,180,1,66,0.0,38.0,38.0,1,114,0.0,86.0,86.0
40.058,17,10,676,5,460,10013.0,104.0,64.0,5,216,10013.0,20.0,15.0
0.009,6,10,1972,5,910,2.0,642.0,642.0,5,1062,2.0,794.0,794.0
0.005,17,2,179,1,71,0.0,43.0,43.0,1,108,0.0,80.0,80.0
0.005,6,10,1989,5,927,1.0,659.0,659.0,5,1062,1.0,794.0,794.0
0.006,17,2,230,1,68,0.0,40.0,40.0,1,162,0.0,134.0,134.0
313.913,17,20,1124,10,716,34866.0,48.0,43.0,10,408,34870.0,20.0,12.0
0.055,6,10,1989,5,910,13.0,642.0,642.0,5,1079,13.0,811.0,811.0
0.134,17,2,80,1,32,0.0,4.0,4.0,1,48,0.0,20.0,20.0
0.019,6,10,1989,5,910,4.0,642.0,642.0,5,1079,4.0,811.0,811.0
0.005,6,10,2006,5,927,1.0,659.0,659.0,5,1079,1.0,811.0,811.0
0.01,6,10,1989,5,910,2.0,642.0,642.0,5,1079,2.0,811.0,811.0
0.014,6,14,3787,7,497,2.0,125.0,125.0,7,3290,2.0,1448.0,972.0
0.008,6,10,1990,5,911,2.0,643.0,643.0,5,1079,2.0,811.0,811.0
0.013,6,10,1631,5,848,3.0,580.0,580.0,5,783,3.0,515.0,515.0
0.004,17,2,148,1,60,0.0,32.0,32.0,1,88,0.0,60.0,60.0
0.005,6,14,3736,7,446,0.0,74.0,74.0,7,3290,0.0,1448.0,972.0
40.06,17,10,676,5,460,10013.0,104.0,64.0,5,216,10014.0,20.0,15.0
0.078,6,45,14087,25,2617,3.0,517.0,146.0,20,11470,3.0,1402.0,744.0
0.006,6,10,1854,5,889,1.0,621.0,621.0,5,965,1.0,697.0,697.0
0.011,6,10,1989,5,910,2.0,642.0,642.0,5,1079,2.0,811.0,811.0
40.063,17,10,676,5,460,10013.0,104.0,64.0,5,216,10013.0,20.0,15.0
0.006,6,10,1643,5,860,1.0,592.0,592.0,5,783,1.0,515.0,515.0
0.016,6,10,1972,5,910,4.0,642.0,642.0,5,1062,4.0,794.0,794.0
0.004,6,10,2006,5,927,1.0,659.0,659.0,5,1079,1.0,811.0,811.0
0.1,6,10,1506,5,395,24.0,127.0,127.0,5,1111,23.0,843.0,843.0
0.005,6,10,1643,5,860,1.0,592.0,592.0,5,783,1.0,515.0,515.0
0.009,6,10,1989,5,910,2.0,642.0,642.0,5,1079,2.0,811.0,811.0
0.006,6,10,1989,5,927,1.0,659.0,659.0,5,1062,1.0,794.0,794.0
40.064,17,10,676,5,460,10015.0,104.0,64.0,5,216,10015.0,20.0,15.0
0.039,17,2,152,1,76,0.0,48.0,48.0,1,76,0.0,48.0,48.0
0.01,6,10,1972,5,910,2.0,642.0,642.0,5,1062,2.0,794.0,794.0
0.004,6,10,2000,5,927,1.0,659.0,659.0,5,1073,1.0,805.0,805.0
0.012,6,10,1989,5,910,3.0,642.0,642.0,5,1079,3.0,811.0,811.0
0.005,6,14,3736,7,446,0.0,74.0,74.0,7,3290,0.0,1448.0,972.0
0.004,17,2,148,1,60,0.0,32.0,32.0,1,88,0.0,60.0,60.0
0.103,6,10,1506,5,395,21.0,127.0,127.0,5,1111,20.0,843.0,843.0
0.011,6,10,1677,5,827,2.0,559.0,559.0,5,850,2.0,582.0,582.0
0.095,6,10,1506,5,395,21.0,127.0,127.0,5,1111,16.0,843.0,843.0
0.011,6,10,1990,5,911,2.0,643.0,643.0,5,1079,2.0,811.0,811.0
0.005,6,10,2000,5,927,1.0,659.0,659.0,5,1073,1.0,805.0,805.0
0.006,6,10,1779,5,928,1.0,660.0,660.0,5,851,1.0,583.0,583.0
0.005,6,10,2000,5,927,1.0,659.0,659.0,5,1073,1.0,805.0,805.0
0.001,17,2,180,1,66,0.0,38.0,38.0,1,114,0.0,86.0,86.0
0.013,6,10,1631,5,848,3.0,580.0,580.0,5,783,3.0,515.0,515.0
0.005,17,2,154,1,69,0.0,41.0,41.0,1,85,0.0,57.0,57.0
0.068,6,10,1506,5,395,13.0,127.0,127.0,5,1111,16.0,843.0,843.0
300.323,6,16,2170,9,684,37519.0,146.0,146.0,7,1486,50023.0,419.0,398.0
0.071,17,8,3613,4,1874,23.0,1350.0,440.0,4,1739,12.0,1350.0,406.0
0.084,6,10,1506,5,395,18.0,127.0,127.0,5,1111,17.0,843.0,843.0
351.988,6,20,2210,6,1308,12003.0,494.0,494.0,14,902,27075.0,83.0,83.0
0.087,6,10,1506,5,395,18.0,127.0,127.0,5,1111,18.0,843.0,843.0
0.01,6,13,3735,7,497,1.0,125.0,125.0,6,3238,1.0,1470.0,1459.0
10.757,17,28,4422,14,1994,819.0,269.0,114.0,14,2428,819.0,587.0,145.0
0.004,6,10,1779,5,928,1.0,660.0,660.0,5,851,1.0,583.0,583.0
0.025,6,6,716,3,458,11.0,302.0,302.0,3,258,10.0,102.0,102.0
0.001,17,2,180,1,65,0.0,37.0,37.0,1,115,0.0,87.0,87.0
0.013,6,10,1989,5,910,3.0,642.0,642.0,5,1079,3.0,811.0,811.0
0.069,6,10,1506,5,395,14.0,127.0,127.0,5,1111,16.0,843.0,843.0
0.078,6,10,1506,5,395,17.0,127.0,127.0,5,1111,13.0,843.0,843.0
0.175,6,10,1506,5,395,41.0,127.0,127.0,5,1111,29.0,843.0,843.0
0.093,6,10,1506,5,395,20.0,127.0,127.0,5,1111,17.0,843.0,843.0
0.001,17,2,136,1,60,0.0,32.0,32.0,1,76,0.0,48.0,48.0
32.33,6,41,10348,21,4656,495.0,1360.0,738.0,20,5692,1690.0,1360.0,348.0
0.001,17,2,180,1,66,0.0,38.0,38.0,1,114,0.0,86.0,86.0
0.009,6,10,1972,5,910,2.0,642.0,642.0,5,1062,2.0,794.0,794.0
0.082,6,10,1506,5,395,18.0,127.0,127.0,5,1111,17.0,843.0,843.0
0.098,6,10,1506,5,395,21.0,127.0,127.0,5,1111,21.0,843.0,843.0
0.012,6,10,1990,5,911,2.0,643.0,643.0,5,1079,2.0,811.0,811.0
0.006,6,10,1547,5,764,1.0,496.0,496.0,5,783,1.0,515.0,515.0
0.006,6,10,1547,5,764,1.0,496.0,496.0,5,783,1.0,515.0,515.0
0.004,6,14,3736,7,446,0.0,74.0,74.0,7,3290,0.0,1448.0,972.0
0.005,6,10,1989,5,927,1.0,659.0,659.0,5,1062,1.0,794.0,794.0
0.006,6,10,1547,5,764,1.0,496.0,496.0,5,783,1.0,515.0,515.0
0.105,6,10,1506,5,395,24.0,127.0,127.0,5,1111,25.0,843.0,843.0
0.008,6,10,1989,5,910,2.0,642.0,642.0,5,1079,1.0,811.0,811.0
0.008,6,10,1990,5,911,2.0,643.0,643.0,5,1079,2.0,811.0,811.0
0.005,6,10,2006,5,927,1.0,659.0,659.0,5,1079,1.0,811.0,811.0
0.138,6,10,1506,5,395,33.0,127.0,127.0,5,1111,28.0,843.0,843.0
0.007,17,2,194,1,59,0.0,31.0,31.0,1,135,0.0,107.0,107.0
0.015,6,10,1990,5,911,3.0,643.0,643.0,5,1079,3.0,811.0,811.0
0.005,6,10,2006,5,927,1.0,659.0,659.0,5,1079,1.0,811.0,811.0
30.907,6,26,5923,15,1928,2207.0,517.0,260.0,11,3995,3090.0,1330.0,590.0
0.013,6,10,1631,5,848,3.0,580.0,580.0,5,783,3.0,515.0,515.0
0.005,17,2,170,1,65,0.0,37.0,37.0,1,105,0.0,77.0,77.0
0.008,6,10,1972,5,910,2.0,642.0,642.0,5,1062,2.0,794.0,794.0
0.004,6,10,2006,5,927,1.0,659.0,659.0,5,1079,1.0,811.0,811.0
0.005,6,10,2006,5,927,1.0,659.0,659.0,5,1079,1.0,811.0,811.0
0.006,6,10,1643,5,860,1.0,592.0,592.0,5,783,1.0,515.0,515.0
0.005,6,10,2006,5,927,1.0,659.0,659.0,5,1079,1.0,811.0,811.0
0.138,6,10,1506,5,395,32.0,127.0,127.0,5,1111,31.0,843.0,843.0
0.008,6,10,2006,5,927,2.0,659.0,659.0,5,1079,2.0,811.0,811.0
0.011,6,10,1989,5,927,2.0,659.0,659.0,5,1062,2.0,794.0,794.0
0.009,6,10,1989,5,910,2.0,642.0,642.0,5,1079,2.0,811.0,811.0
0.124,17,2,80,1,32,0.0,4.0,4.0,1,48,0.0,20.0,20.0
0.041,17,4,284,2,120,0.0,32.0,32.0,2,164,1.0,60.0,54.0
0.118,6,10,1506,5,395,25.0,127.0,127.0,5,1111,27.0,843.0,843.0
0.015,6,10,1989,5,910,3.0,642.0,642.0,5,1079,3.0,811.0,811.0
0.005,6,10,1989,5,927,1.0,659.0,659.0,5,1062,1.0,794.0,794.0
0.017,17,2,144,1,64,0.0,36.0,36.0,1,80,0.0,52.0,52.0
331.491,17,19,1084,10,716,36819.0,48.0,43.0,9,368,41421.0,20.0,12.0
0.039,17,4,284,2,120,0.0,32.0,32.0,2,164,36.0,60.0,54.0
0.005,17,2,169,1,62,0.0,34.0,34.0,1,107,0.0,79.0,79.0
0.152,6,10,1506,5,395,35.0,127.0,127.0,5,1111,34.0,843.0,843.0
0.006,17,2,180,1,58,0.0,30.0,30.0,1,122,0.0,94.0,94.0
0.004,17,2,148,1,60,0.0,32.0,32.0,1,88,0.0,60.0,60.0
0.011,6,10,1989,5,910,2.0,642.0,642.0,5,1079,2.0,811.0,811.0
0.003,6,10,1702,5,863,0.0,595.0,595.0,5,839,0.0,571.0,571.0
0.006,6,10,1547,5,764,1.0,496.0,496.0,5,783,1.0,515.0,515.0
0.006,6,14,3799,7,509,0.0,137.0,137.0,7,3290,0.0,1448.0,972.0
0.004,6,10,1779,5,928,1.0,660.0,660.0,5,851,1.0,583.0,583.0
0.006,6,10,1547,5,764,1.0,496.0,496.0,5,783,1.0,515.0,515.0
0.023,6,10,1972,5,910,5.0,642.0,642.0,5,1062,5.0,794.0,794.0
0.011,6,10,1990,5,911,2.0,643.0,643.0,5,1079,2.0,811.0,811.0
40.052,17,10,676,5,460,10012.0,104.0,64.0,5,216,10012.0,20.0,15.0
0.019,6,10,1983,5,910,4.0,642.0,642.0,5,1073,4.0,805.0,805.0
1770.331,17,92,8096,46,4048,39340.0,60.0,60.0,46,4048,39340.0,60.0,60.0
0.006,17,2,179,1,71,0.0,43.0,43.0,1,108,0.0,80.0,80.0
0.006,6,10,2000,5,927,1.0,659.0,659.0,5,1073,1.0,805.0,805.0
0.007,6,12,1698,6,863,1.0,327.0,271.0,6,835,1.0,515.0,515.0
0.003,17,2,136,1,60,0.0,32.0,32.0,1,76,0.0,48.0,48.0
0.104,6,10,1506,5,395,18.0,127.0,127.0,5,1111,24.0,843.0,843.0
0.005,6,10,1689,5,839,1.0,571.0,571.0,5,850,1.0,582.0,582.0
0.109,6,10,1506,5,395,25.0,127.0,127.0,5,1111,25.0,843.0,843.0
0.006,17,2,175,1,65,0.0,37.0,37.0,1,110,0.0,82.0,82.0
40.062,17,10,676,5,460,10014.0,104.0,64.0,5,216,10014.0,20.0,15.0
308.691,17,20,1124,10,716,34284.0,48.0,43.0,10,408,34284.0,20.0,12.0
0.005,6,10,2007,5,928,1.0,660.0,660.0,5,1079,1.0,811.0,811.0
0.005,17,2,179,1,71,0.0,43.0,43.0,1,108,0.0,80.0,80.0
0.169,17,2,152,1,76,0.0,48.0,48.0,1,76,0.0,48.0,48.0
240.096,6,31,9398,15,6945,17149.0,2070.0,685.0,16,2453,16006.0,580.0,201.0
1792.697,6,486,98773,245,87543,7346.0,421.0,368.0,241,11230,7469.0,53.0,53.0
1730.395,6,45,2790,30,1725,59668.0,35.0,35.0,15,1065,123591.0,31.0,31.0
0.799,6,10,2009,6,1655,159.0,1403.0,1403.0,4,354,189.0,182.0,182.0
0.005,6,10,1989,5,927,1.0,659.0,659.0,5,1062,1.0,794.0,794.0
0.006,6,10,1547,5,764,1.0,496.0,496.0,5,783,1.0,515.0,515.0
0.005,6,13,3747,7,509,0.0,137.0,137.0,6,3238,0.0,1470.0,1459.0
0.018,6,10,1983,5,910,4.0,642.0,642.0,5,1073,4.0,805.0,805.0
0.009,6,10,1990,5,911,2.0,643.0,643.0,5,1079,2.0,811.0,811.0
0.006,6,10,1643,5,860,1.0,592.0,592.0,5,783,1.0,515.0,515.0
0.009,6,10,1990,5,911,2.0,643.0,643.0,5,1079,2.0,811.0,811.0
0.001,17,2,154,1,69,0.0,41.0,41.0,1,85,0.0,57.0,57.0
0.088,17,8,3613,4,1874,29.0,1350.0,440.0,4,1739,10.0,1350.0,406.0
0.067,6,10,1506,5,395,14.0,127.0,127.0,5,1111,16.0,843.0,843.0
0.005,6,10,2007,5,928,1.0,660.0,660.0,5,1079,1.0,811.0,811.0
40.065,17,10,676,5,460,10015.0,104.0,64.0,5,216,10015.0,20.0,15.0
0.006,6,13,3747,7,509,1.0,137.0,137.0,6,3238,1.0,1470.0,1459.0
0.09,6,10,1506,5,395,19.0,127.0,127.0,5,1111,19.0,843.0,843.0
0.172,6,10,1506,5,395,33.0,127.0,127.0,5,1111,27.0,843.0,843.0
0.006,6,10,1989,5,927,1.0,659.0,659.0,5,1062,1.0,794.0,794.0
0.125,17,2,148,1,60,0.0,32.0,32.0,1,88,0.0,60.0,60.0
0.027,6,10,1972,5,910,6.0,642.0,642.0,5,1062,6.0,794.0,794.0
240.097,6,16,4481,9,963,30012.0,238.0,166.0,7,3518,40015.0,1402.0,786.0
0.001,17,2,166,1,75,0.0,47.0,47.0,1,91,0.0,63.0,63.0
0.0,17,2,179,1,62,0.0,34.0,34.0,1,117,0.0,89.0,89.0
0.12,6,10,1506,5,395,26.0,127.0,127.0,5,1111,28.0,843.0,843.0
0.07,6,10,1506,5,395,15.0,127.0,127.0,5,1111,16.0,843.0,843.0
0.008,6,10,1989,5,910,2.0,642.0,642.0,5,1079,1.0,811.0,811.0
0.005,6,10,2006,5,927,1.0,659.0,659.0,5,1079,1.0,811.0,811.0
40.061,17,10,676,5,460,10014.0,104.0,64.0,5,216,10014.0,20.0,15.0
0.162,17,2,152,1,76,0.0,48.0,48.0,1,76,0.0,48.0,48.0
0.08,6,10,1506,5,395,17.0,127.0,127.0,5,1111,19.0,843.0,843.0
0.067,6,10,1506,5,395,14.0,127.0,127.0,5,1111,14.0,843.0,843.0
0.013,6,10,1631,5,848,3.0,580.0,580.0,5,783,3.0,515.0,515.0
0.005,6,10,1854,5,889,1.0,621.0,621.0,5,965,1.0,697.0,697.0
0.009,6,10,1990,5,911,2.0,643.0,643.0,5,1079,2.0,811.0,811.0
0.093,6,10,1506,5,395,20.0,127.0,127.0,5,1111,19.0,843.0,843.0
0.005,6,10,2000,5,927,1.0,659.0,659.0,5,1073,1.0,805.0,805.0
169.02,17,94,13717,47,3182,3674.0,44.0,39.0,47,10535,3674.0,239.0,196.0
0.004,17,2,412,1,61,0.0,33.0,33.0,1,351,0.0,323.0,323.0
40.048,17,10,676,5,460,10011.0,104.0,64.0,5,216,10011.0,20.0,15.0
0.068,17,8,3613,4,1874,22.0,1350.0,440.0,4,1739,11.0,1350.0,406.0
300.342,6,16,2170,9,684,37520.0,146.0,146.0,7,1486,50027.0,419.0,398.0
163.263,17,82,11544,41,2747,4081.0,44.0,39.0,41,8797,4081.0,261.0,186.0
40.058,17,10,676,5,460,10013.0,104.0,64.0,5,216,10012.0,20.0,15.0
0.091,6,10,1506,5,395,21.0,127.0,127.0,5,1111,19.0,843.0,843.0
0.014,6,10,1990,5,911,3.0,643.0,643.0,5,1079,3.0,811.0,811.0
15.073,17,14,9190,8,6902,2149.0,1350.0,834.0,6,2288,3008.0,1350.0,353.0
0.014,6,10,1989,5,910,3.0,642.0,642.0,5,1079,3.0,811.0,811.0
300.316,6,16,2170,9,684,37518.0,146.0,146.0,7,1486,50025.0,419.0,398.0
0.005,6,10,1989,5,927,1.0,659.0,659.0,5,1062,1.0,794.0,794.0
0.018,6,10,1762,5,911,4.0,643.0,643.0,5,851,4.0,583.0,583.0
0.101,6,10,1506,5,395,23.0,127.0,127.0,5,1111,22.0,843.0,843.0
0.005,6,10,2007,5,928,1.0,660.0,660.0,5,1079,1.0,811.0,811.0
0.014,6,10,1972,5,910,3.0,642.0,642.0,5,1062,3.0,794.0,794.0
0.004,17,2,136,1,60,0.0,32.0,32.0,1,76,0.0,48.0,48.0
0.007,6,10,1547,5,764,1.0,496.0,496.0,5,783,1.0,515.0,515.0
0.008,6,10,1972,5,910,1.0,642.0,642.0,5,1062,1.0,794.0,794.0
0.005,6,10,1989,5,927,1.0,659.0,659.0,5,1062,1.0,794.0,794.0
0.004,6,10,1779,5,928,0.0,660.0,660.0,5,851,1.0,583.0,583.0
174.128,17,88,12909,44,2969,4049.0,44.0,39.0,44,9940,4049.0,261.0,197.0
0.163,17,2,152,1,76,0.0,48.0,48.0,1,76,0.0,48.0,48.0
0.017,6,10,1989,5,910,4.0,642.0,642.0,5,1079,4.0,811.0,811.0
0.006,6,10,1547,5,764,1.0,496.0,496.0,5,783,1.0,515.0,515.0
0.005,6,10,1854,5,889,1.0,621.0,621.0,5,965,1.0,697.0,697.0
0.004,6,10,1989,5,927,1.0,659.0,659.0,5,1062,1.0,794.0,794.0
0.005,6,10,2007,5,928,1.0,660.0,660.0,5,1079,1.0,811.0,811.0
0.102,6,10,1506,5,395,21.0,127.0,127.0,5,1111,22.0,843.0,843.0
0.02,6,10,1631,5,848,4.0,580.0,580.0,5,783,5.0,515.0,515.0
0.094,6,10,1506,5,395,19.0,127.0,127.0,5,1111,18.0,843.0,843.0
0.02,6,10,1990,5,911,5.0,643.0,643.0,5,1079,4.0,811.0,811.0
0.01,6,10,1990,5,911,2.0,643.0,643.0,5,1079,2.0,811.0,811.0
0.092,6,10,1506,5,395,21.0,127.0,127.0,5,1111,19.0,843.0,843.0
0.028,6,10,1605,5,388,7.0,120.0,120.0,5,1217,6.0,949.0,949.0
0.171,6,3,453,2,321,171.0,241.0,241.0,1,132,0.0,92.0,92.0
0.069,17,8,3613,4,1874,23.0,1350.0,440.0,4,1739,11.0,1350.0,406.0
0.001,17,2,136,1,60,0.0,32.0,32.0,1,76,0.0,48.0,48.0
0.005,17,2,170,1,65,0.0,37.0,37.0,1,105,0.0,77.0,77.0
0.005,6,10,1547,5,764,1.0,496.0,496.0,5,783,1.0,515.0,515.0
0.013,6,13,3735,7,497,2.0,125.0,125.0,6,3238,2.0,1470.0,1459.0
240.088,6,16,4481,9,963,30011.0,238.0,166.0,7,3518,40014.0,1402.0,786.0
289.54,6,395,349321,193,22920,1508.0,2736.0,919.0,202,326401,1440.0,2804.0,1698.0
0.099,6,10,1506,5,395,18.0,127.0,127.0,5,1111,21.0,843.0,843.0
0.017,6,10,1762,5,911,4.0,643.0,643.0,5,851,4.0,583.0,583.0
0.005,6,10,2006,5,927,1.0,659.0,659.0,5,1079,1.0,811.0,811.0
0.004,6,10,1774,5,923,1.0,655.0,655.0,5,851,1.0,583.0,583.0
0.071,6,10,1506,5,395,16.0,127.0,127.0,5,1111,15.0,843.0,843.0
0.073,6,10,1506,5,395,15.0,127.0,127.0,5,1111,16.0,843.0,843.0
0.169,6,10,1506,5,395,40.0,127.0,127.0,5,1111,38.0,843.0,843.0
10.764,17,28,4421,14,1993,819.0,268.0,114.0,14,2428,819.0,587.0,145.0
0.005,17,2,169,1,62,0.0,34.0,34.0,1,107,0.0,79.0,79.0
0.006,6,10,1643,5,860,1.0,592.0,592.0,5,783,1.0,515.0,515.0
0.014,6,10,1989,5,910,3.0,642.0,642.0,5,1079,3.0,811.0,811.0
0.005,6,10,1547,5,764,1.0,496.0,496.0,5,783,1.0,515.0,515.0
0.144,6,10,1506,5,395,33.0,127.0,127.0,5,1111,33.0,843.0,843.0
0.16,6,10,1506,5,395,38.0,127.0,127.0,5,1111,35.0,843.0,843.0
0.012,6,10,1989,5,910,3.0,642.0,642.0,5,1079,3.0,811.0,811.0
1778.345,17,143,45188,72,22752,25047.0,288.0,288.0,71,22436,25046.0,288.0,288.0
0.004,6,10,1779,5,928,1.0,660.0,660.0,5,851,1.0,583.0,583.0
0.006,6,10,1689,5,839,1.0,571.0,571.0,5,850,1.0,582.0,582.0
1685.198,17,14,1106,7,441,280865.0,35.0,35.0,7,665,280865.0,67.0,67.0
0.017,6,10,1989,5,910,4.0,642.0,642.0,5,1079,4.0,811.0,811.0
15.072,17,15,9239,8,6902,2149.0,1350.0,834.0,7,2337,2507.0,1350.0,305.0
0.004,17,4,284,2,120,0.0,32.0,32.0,2,164,0.0,60.0,54.0
0.006,6,10,1854,5,889,1.0,621.0,621.0,5,965,1.0,697.0,697.0
0.01,6,10,1990,5,911,2.0,643.0,643.0,5,1079,2.0,811.0,811.0
0.005,17,2,170,1,65,0.0,37.0,37.0,1,105,0.0,77.0,77.0
0.003,17,2,160,1,72,0.0,44.0,44.0,1,88,0.0,60.0,60.0
0.005,17,2,175,1,65,0.0,37.0,37.0,1,110,0.0,82.0,82.0
0.005,6,10,2000,5,927,1.0,659.0,659.0,5,1073,1.0,805.0,805.0
0.005,17,2,230,1,68,0.0,40.0,40.0,1,162,0.0,134.0,134.0
0.006,6,10,1547,5,764,1.0,496.0,496.0,5,783,1.0,515.0,515.0
0.001,17,2,180,1,66,0.0,38.0,38.0,1,114,0.0,86.0,86.0
0.005,6,10,1989,5,927,1.0,659.0,659.0,5,1062,1.0,794.0,794.0
0.005,17,2,180,1,66,0.0,38.0,38.0,1,114,0.0,86.0,86.0
0.005,6,10,1547,5,764,1.0,496.0,496.0,5,783,1.0,515.0,515.0
0.006,17,2,152,1,68,0.0,40.0,40.0,1,84,0.0,56.0,56.0
0.005,6,10,2006,5,927,1.0,659.0,659.0,5,1079,1.0,811.0,811.0
0.084,6,10,1506,5,395,18.0,127.0,127.0,5,1111,17.0,843.0,843.0
171.339,17,78,11037,39,2601,4508.0,44.0,38.0,39,8436,4508.0,239.0,188.0
0.015,6,10,1990,5,911,3.0,643.0,643.0,5,1079,3.0,811.0,811.0
0.005,6,10,1779,5,928,1.0,660.0,660.0,5,851,1.0,583.0,583.0
0.086,6,10,1506,5,395,21.0,127.0,127.0,5,1111,18.0,843.0,843.0
0.001,17,2,180,1,66,0.0,38.0,38.0,1,114,0.0,86.0,86.0
1777.531,17,144,41760,72,22752,25035.0,288.0,288.0,72,19008,25035.0,236.0,236.0
0.007,17,2,136,1,60,0.0,32.0,32.0,1,76,0.0,48.0,48.0
0.001,17,2,180,1,66,0.0,38.0,38.0,1,114,0.0,86.0,86.0
0.004,6,14,3742,7,452,0.0,80.0,80.0,7,3290,0.0,1448.0,972.0
40.071,17,10,676,5,460,10015.0,104.0,64.0,5,216,10016.0,20.0,15.0
0.004,6,10,1774,5,923,1.0,655.0,655.0,5,851,1.0,583.0,583.0
0.101,6,10,1506,5,395,24.0,127.0,127.0,5,1111,22.0,843.0,843.0
0.077,6,10,1506,5,395,16.0,127.0,127.0,5,1111,18.0,843.0,843.0
0.005,6,10,1643,5,860,1.0,592.0,592.0,5,783,1.0,515.0,515.0
0.005,6,10,2000,5,927,1.0,659.0,659.0,5,1073,1.0,805.0,805.0
308.642,17,20,1124,10,716,34279.0,48.0,43.0,10,408,34279.0,20.0,12.0
0.005,6,10,1547,5,764,1.0,496.0,496.0,5,783,1.0,515.0,515.0
0.013,6,10,1983,5,910,3.0,642.0,642.0,5,1073,3.0,805.0,805.0
66.082,6,37,10002,19,4484,499.0,1360.0,738.0,18,5518,3877.0,2667.0,435.0
0.113,6,10,1506,5,395,24.0,127.0,127.0,5,1111,27.0,843.0,843.0
240.3,6,42,8721,21,5686,12014.0,1515.0,509.0,21,3035,12014.0,580.0,241.0
0.005,6,10,2006,5,927,1.0,659.0,659.0,5,1079,1.0,811.0,811.0
0.072,6,10,1506,5,395,15.0,127.0,127.0,5,1111,14.0,843.0,843.0
0.004,6,10,2006,5,927,1.0,659.0,659.0,5,1079,1.0,811.0,811.0
0.083,6,10,1506,5,395,19.0,127.0,127.0,5,1111,18.0,843.0,843.0
15.078,17,16,9303,8,6912,2150.0,1350.0,836.0,8,2391,2149.0,1350.0,270.0
65.809,6,27,17605,15,9656,4700.0,2900.0,1478.0,12,7949,5967.0,2320.0,1219.0
0.187,17,4,596,2,122,145.0,33.0,33.0,2,474,146.0,323.0,209.0
0.086,6,10,1506,5,395,16.0,127.0,127.0,5,1111,18.0,843.0,843.0
240.108,6,16,4481,9,963,30013.0,238.0,166.0,7,3518,40017.0,1402.0,786.0
0.14,6,14,4517,8,993,20.0,517.0,290.0,6,3524,25.0,1402.0,1068.0
0.008,6,10,1972,5,910,2.0,642.0,642.0,5,1062,1.0,794.0,794.0
0.322,17,47,24913,25,21229,13.0,1350.0,821.0,22,3684,13.0,1350.0,139.0
0.005,6,10,1989,5,927,1.0,659.0,659.0,5,1062,1.0,794.0,794.0
1775.587,6,105,7562,51,2822,35510.0,36.0,34.0,54,4740,33500.0,490.0,193.0
0.018,6,10,1989,5,910,4.0,642.0,642.0,5,1079,4.0,811.0,811.0
0.019,6,10,1972,5,910,4.0,642.0,642.0,5,1062,4.0,794.0,794.0
0.025,6,10,1989,5,910,6.0,642.0,642.0,5,1079,6.0,811.0,811.0
0.005,6,10,1643,5,860,1.0,592.0,592.0,5,783,1.0,515.0,515.0
294.266,6,28,9641,15,2606,21017.0,676.0,363.0,13,7035,24521.0,1402.0,909.0
0.006,6,10,1854,5,889,1.0,621.0,621.0,5,965,1.0,697.0,697.0
0.11,6,10,1506,5,395,26.0,127.0,127.0,5,1111,22.0,843.0,843.0
0.471,17,59,41631,35,35379,13.0,1350.0,982.0,24,6252,16.0,1350.0,232.0
0.108,6,10,1506,5,395,26.0,127.0,127.0,5,1111,21.0,843.0,843.0
0.015,6,10,1989,5,910,3.0,642.0,642.0,5,1079,3.0,811.0,811.0
0.006,17,2,164,1,74,0.0,46.0,46.0,1,90,0.0,62.0,62.0
0.162,17,4,596,2,122,159.0,33.0,33.0,2,474,122.0,323.0,209.0
0.007,6,10,1983,5,910,1.0,642.0,642.0,5,1073,1.0,805.0,805.0
0.008,6,10,2006,5,927,1.0,659.0,659.0,5,1079,2.0,811.0,811.0
0.096,6,10,1506,5,395,20.0,127.0,127.0,5,1111,21.0,843.0,843.0
0.006,17,2,170,1,65,0.0,37.0,37.0,1,105,0.0,77.0,77.0
0.006,6,10,1547,5,764,1.0,496.0,496.0,5,783,1.0,515.0,515.0
0.012,6,10,1989,5,910,2.0,642.0,642.0,5,1079,3.0,811.0,811.0
0.005,6,10,2006,5,927,1.0,659.0,659.0,5,1079,1.0,811.0,811.0
0.005,6,10,1779,5,928,1.0,660.0,660.0,5,851,1.0,583.0,583.0
0.006,6,10,1547,5,764,1.0,496.0,496.0,5,783,1.0,515.0,515.0
0.011,6,14,3868,7,578,1.0,206.0,206.0,7,3290,1.0,1448.0,972.0
0.012,6,10,2000,5,927,3.0,659.0,659.0,5,1073,3.0,805.0,805.0
0.005,17,2,144,1,64,0.0,36.0,36.0,1,80,0.0,52.0,52.0
0.012,6,6,716,3,458,3.0,302.0,302.0,3,258,4.0,102.0,102.0
173.031,17,98,14314,49,3304,3604.0,44.0,39.0,49,11010,3604.0,260.0,196.0
0.004,6,10,2006,5,927,1.0,659.0,659.0,5,1079,1.0,811.0,811.0
0.009,6,10,1677,5,827,2.0,559.0,559.0,5,850,2.0,582.0,582.0
0.022,6,10,1989,5,910,5.0,642.0,642.0,5,1079,5.0,811.0,811.0
0.005,6,14,3742,7,452,0.0,80.0,80.0,7,3290,0.0,1448.0,972.0
0.004,6,10,1774,5,923,1.0,655.0,655.0,5,851,1.0,583.0,583.0
0.019,6,14,3787,7,497,3.0,125.0,125.0,7,3290,3.0,1448.0,972.0
0.009,6,12,1926,6,1189,1.0,659.0,434.0,6,737,1.0,417.0,417.0
0.014,6,10,1677,5,827,3.0,559.0,559.0,5,850,3.0,582.0,582.0
313.763,17,20,1124,10,716,34848.0,48.0,43.0,10,408,34848.0,20.0,12.0
0.089,6,10,1506,5,395,21.0,127.0,127.0,5,1111,21.0,843.0,843.0
40.061,17,10,676,5,460,10014.0,104.0,64.0,5,216,10014.0,20.0,15.0
0.037,17,4,284,2,120,0.0,32.0,32.0,2,164,34.0,60.0,54.0
0.103,6,10,1506,5,395,23.0,127.0,127.0,5,1111,24.0,843.0,843.0
0.011,6,10,1972,5,910,2.0,642.0,642.0,5,1062,2.0,794.0,794.0
0.005,6,10,1779,5,928,1.0,660.0,660.0,5,851,1.0,583.0,583.0
352.243,6,20,2210,6,1308,12003.0,494.0,494.0,14,902,27095.0,83.0,83.0
0.006,17,2,293,1,73,0.0,45.0,45.0,1,220,0.0,192.0,192.0
177.39,17,78,11086,39,2597,4668.0,44.0,38.0,39,8489,4668.0,261.0,189.0
0.008,17,2,179,1,71,0.0,43.0,43.0,1,108,0.0,80.0,80.0
40.052,17,10,676,5,460,10012.0,104.0,64.0,5,216,10012.0,20.0,15.0
0.004,17,2,136,1,60,0.0,32.0,32.0,1,76,0.0,48.0,48.0
0.011,6,10,1972,5,910,2.0,642.0,642.0,5,1062,2.0,794.0,794.0
0.013,6,10,1989,5,910,3.0,642.0,642.0,5,1079,3.0,811.0,811.0
381.742,6,22,2313,16,867,25449.0,195.0,195.0,6,1446,4643.0,419.0,398.0
0.007,6,10,1972,5,910,1.0,642.0,642.0,5,1062,1.0,794.0,794.0
0.003,17,2,136,1,60,0.0,32.0,32.0,1,76,0.0,48.0,48.0
0.006,17,2,214,1,75,0.0,47.0,47.0,1,139,0.0,111.0,111.0
0.01,6,10,1677,5,827,2.0,559.0,559.0,5,850,2.0,582.0,582.0
0.005,6,10,1989,5,927,1.0,659.0,659.0,5,1062,1.0,794.0,794.0
0.006,6,10,2006,5,927,1.0,659.0,659.0,5,1079,1.0,811.0,811.0
240.015,6,9,787,5,488,60003.0,232.0,232.0,4,299,80003.0,83.0,83.0
0.005,6,10,2006,5,927,1.0,659.0,659.0,5,1079,1.0,811.0,811.0
0.015,6,10,1990,5,911,3.0,643.0,643.0,5,1079,3.0,811.0,811.0
0.001,17,2,180,1,66,0.0,38.0,38.0,1,114,0.0,86.0,86.0
0.006,6,10,2000,5,927,1.0,659.0,659.0,5,1073,1.0,805.0,805.0
40.103,17,10,676,5,460,10023.0,104.0,64.0,5,216,10024.0,20.0,15.0
0.088,6,10,1506,5,395,20.0,127.0,127.0,5,1111,19.0,843.0,843.0
0.012,6,10,1989,5,910,3.0,642.0,642.0,5,1079,3.0,811.0,811.0
0.006,6,10,1547,5,764,1.0,496.0,496.0,5,783,1.0,515.0,515.0
0.006,6,10,1689,5,839,1.0,571.0,571.0,5,850,1.0,582.0,582.0
0.092,6,10,1506,5,395,21.0,127.0,127.0,5,1111,20.0,843.0,843.0
0.017,6,10,1990,5,911,4.0,643.0,643.0,5,1079,4.0,811.0,811.0
0.005,6,13,3690,7,452,0.0,80.0,80.0,6,3238,0.0,1470.0,1459.0
0.004,6,10,1774,5,923,1.0,655.0,655.0,5,851,1.0,583.0,583.0
0.02,6,10,1989,5,910,4.0,642.0,642.0,5,1079,4.0,811.0,811.0
40.054,17,10,676,5,460,10012.0,104.0,64.0,5,216,10012.0,20.0,15.0
0.167,17,2,152,1,76,0.0,48.0,48.0,1,76,0.0,48.0,48.0
0.053,17,2,152,1,76,0.0,48.0,48.0,1,76,0.0,48.0,48.0
0.006,6,10,2006,5,927,1.0,659.0,659.0,5,1079,1.0,811.0,811.0
0.007,6,10,1547,5,764,1.0,496.0,496.0,5,783,1.0,515.0,515.0
65.301,6,36,9488,18,3970,518.0,1505.0,804.0,18,5518,3831.0,2667.0,435.0
0.016,17,2,180,1,66,0.0,38.0,38.0,1,114,0.0,86.0,86.0
0.006,6,10,1547,5,764,1.0,496.0,496.0,5,783,1.0,515.0,515.0
0.005,17,2,170,1,65,0.0,37.0,37.0,1,105,0.0,77.0,77.0
0.329,6,79,37953,40,3022,8.0,517.0,104.0,39,34931,8.0,2092.0,1061.0
0.007,6,10,1990,5,911,1.0,643.0,643.0,5,1079,1.0,811.0,811.0
0.001,17,2,180,1,66,0.0,38.0,38.0,1,114,0.0,86.0,86.0
0.013,6,10,1983,5,910,3.0,642.0,642.0,5,1073,3.0,805.0,805.0
0.073,6,10,1506,5,395,15.0,127.0,127.0,5,1111,16.0,843.0,843.0
0.006,6,10,2006,5,927,1.0,659.0,659.0,5,1079,1.0,811.0,811.0
0.001,17,2,140,1,62,0.0,34.0,34.0,1,78,0.0,50.0,50.0
0.016,17,2,198,1,91,0.0,63.0,63.0,1,107,0.0,79.0,79.0
0.095,6,10,1506,5,395,21.0,127.0,127.0,5,1111,22.0,843.0,843.0
11.177,17,28,4422,14,1994,847.0,269.0,114.0,14,2428,847.0,587.0,145.0
0.005,17,2,136,1,60,0.0,32.0,32.0,1,76,0.0,48.0,48.0
0.005,6,10,1989,5,927,1.0,659.0,659.0,5,1062,1.0,794.0,794.0
0.015,17,2,136,1,60,0.0,32.0,32.0,1,76,0.0,48.0,48.0
0.01,6,10,1989,5,910,2.0,642.0,642.0,5,1079,2.0,811.0,811.0
321.662,17,20,1124,10,716,35714.0,48.0,43.0,10,408,35716.0,20.0,12.0
0.005,6,14,3742,7,452,0.0,80.0,80.0,7,3290,0.0,1448.0,972.0
0.005,6,10,1989,5,927,1.0,659.0,659.0,5,1062,1.0,794.0,794.0
0.005,6,10,2007,5,928,1.0,660.0,660.0,5,1079,1.0,811.0,811.0
0.003,17,4,284,2,120,0.0,32.0,32.0,2,164,0.0,60.0,54.0
0.078,6,10,1506,5,395,14.0,127.0,127.0,5,1111,18.0,843.0,843.0
0.093,6,10,1506,5,395,19.0,127.0,127.0,5,1111,20.0,843.0,843.0
0.004,6,10,2006,5,927,1.0,659.0,659.0,5,1079,1.0,811.0,811.0
0.167,6,3,453,2,321,167.0,241.0,241.0,1,132,0.0,92.0,92.0
0.017,6,10,1677,5,827,4.0,559.0,559.0,5,850,4.0,582.0,582.0
0.241,17,45,25710,25,21217,10.0,1350.0,820.0,20,4493,9.0,1350.0,196.0
0.079,6,10,1506,5,395,16.0,127.0,127.0,5,1111,19.0,843.0,843.0
0.008,6,10,1990,5,911,2.0,643.0,643.0,5,1079,2.0,811.0,811.0
0.028,6,13,3735,7,497,4.0,125.0,125.0,6,3238,5.0,1470.0,1459.0
0.007,6,10,1547,5,764,1.0,496.0,496.0,5,783,1.0,515.0,515.0
40.078,17,10,676,5,460,10015.0,104.0,64.0,5,216,10018.0,20.0,15.0
0.006,17,2,144,1,64,0.0,36.0,36.0,1,80,0.0,52.0,52.0
0.142,6,10,1506,5,395,33.0,127.0,127.0,5,1111,29.0,843.0,843.0
0.005,6,10,1643,5,860,1.0,592.0,592.0,5,783,1.0,515.0,515.0
0.02,6,10,1989,5,910,5.0,642.0,642.0,5,1079,5.0,811.0,811.0
0.007,17,2,179,1,71,0.0,43.0,43.0,1,108,0.0,80.0,80.0
0.009,6,10,1677,5,827,2.0,559.0,559.0,5,850,2.0,582.0,582.0
0.005,6,10,2000,5,927,1.0,659.0,659.0,5,1073,1.0,805.0,805.0
0.083,6,10,1506,5,395,20.0,127.0,127.0,5,1111,17.0,843.0,843.0
15.081,17,16,9533,9,7320,1881.0,1350.0,785.0,7,2213,2509.0,1350.0,288.0
0.015,6,10,1762,5,911,3.0,643.0,643.0,5,851,3.0,583.0,583.0
9.038,17,6,376,5,280,2259.0,28.0,28.0,1,96,0.0,68.0,68.0
0.001,17,2,166,1,75,0.0,47.0,47.0,1,91,0.0,63.0,63.0
294.256,6,411,348673,207,22323,1428.0,2736.0,888.0,204,326350,1449.0,2804.0,1661.0
0.003,17,2,136,1,60,0.0,32.0,32.0,1,76,0.0,48.0,48.0
0.305,17,43,24779,24,19846,13.0,1350.0,798.0,19,4933,13.0,1350.0,231.0
0.04,17,2,186,1,61,0.0,33.0,33.0,1,125,0.0,97.0,97.0
0.006,6,10,1643,5,860,1.0,592.0,592.0,5,783,1.0,515.0,515.0
0.004,6,10,2007,5,928,1.0,660.0,660.0,5,1079,1.0,811.0,811.0
0.013,6,10,1990,5,911,3.0,643.0,643.0,5,1079,3.0,811.0,811.0
0.041,17,2,182,1,65,0.0,37.0,37.0,1,117,0.0,89.0,89.0
0.006,17,2,170,1,65,0.0,37.0,37.0,1,105,0.0,77.0,77.0
0.085,6,10,1506,5,395,18.0,127.0,127.0,5,1111,17.0,843.0,843.0
0.006,6,10,1547,5,764,1.0,496.0,496.0,5,783,1.0,515.0,515.0
0.107,6,10,1506,5,395,25.0,127.0,127.0,5,1111,25.0,843.0,843.0
0.01,6,10,1989,5,910,2.0,642.0,642.0,5,1079,2.0,811.0,811.0
359.221,6,21,1795,16,1030,23948.0,190.0,190.0,5,765,60010.0,464.0,248.0
0.005,6,10,2006,5,927,1.0,659.0,659.0,5,1079,1.0,811.0,811.0
0.004,6,10,2006,5,927,1.0,659.0,659.0,5,1079,1.0,811.0,811.0
15.221,17,44,23161,24,18505,660.0,1350.0,743.0,20,4656,799.0,1350.0,204.0
0.005,6,10,1854,5,889,1.0,621.0,621.0,5,965,1.0,697.0,697.0
0.004,17,2,380,1,61,0.0,33.0,33.0,1,319,0.0,291.0,291.0
40.056,17,10,676,5,460,10012.0,104.0,64.0,5,216,10012.0,20.0,15.0
0.011,6,10,1762,5,911,2.0,643.0,643.0,5,851,2.0,583.0,583.0
0.014,6,10,1989,5,910,3.0,642.0,642.0,5,1079,3.0,811.0,811.0
0.004,17,2,136,1,60,0.0,32.0,32.0,1,76,0.0,48.0,48.0
0.005,6,10,1774,5,923,1.0,655.0,655.0,5,851,1.0,583.0,583.0
0.005,17,2,140,1,62,0.0,34.0,34.0,1,78,0.0,50.0,50.0
0.005,6,10,2006,5,927,1.0,659.0,659.0,5,1079,1.0,811.0,811.0
1778.463,17,144,41760,72,22752,25048.0,288.0,288.0,72,19008,25048.0,236.0,236.0
0.008,6,12,1926,6,1189,1.0,659.0,434.0,6,737,1.0,417.0,417.0
0.015,6,10,1972,5,910,3.0,642.0,642.0,5,1062,3.0,794.0,794.0
0.091,6,10,1506,5,395,17.0,127.0,127.0,5,1111,21.0,843.0,843.0
0.018,6,10,1605,5,388,4.0,120.0,120.0,5,1217,4.0,949.0,949.0
1777.807,6,239,46372,115,33910,15594.0,2476.0,1033.0,124,12462,14453.0,580.0,62.0
0.222,6,16,2779,8,1397,31.0,533.0,324.0,8,1382,20.0,529.0,239.0
40.09,17,10,676,5,460,10021.0,104.0,64.0,5,216,10021.0,20.0,15.0
0.014,6,10,1972,5,910,3.0,642.0,642.0,5,1062,3.0,794.0,794.0
0.018,6,10,1989,5,910,4.0,642.0,642.0,5,1079,4.0,811.0,811.0
0.093,6,10,1506,5,395,21.0,127.0,127.0,5,1111,21.0,843.0,843.0
300.347,6,16,2170,9,684,37522.0,146.0,146.0,7,1486,50030.0,419.0,398.0
0.006,6,10,1547,5,764,1.0,496.0,496.0,5,783,1.0,515.0,515.0
0.04,17,2,182,1,65,0.0,37.0,37.0,1,117,0.0,89.0,89.0
0.005,6,10,1547,5,764,1.0,496.0,496.0,5,783,1.0,515.0,515.0
243.109,6,21,6492,12,1402,22100.0,253.0,195.0,9,5090,30388.0,1402.0,769.0
0.011,6,10,1989,5,910,2.0,642.0,642.0,5,1079,2.0,811.0,811.0
40.054,17,10,676,5,460,10012.0,104.0,64.0,5,216,10012.0,20.0,15.0
0.005,6,10,2000,5,927,1.0,659.0,659.0,5,1073,1.0,805.0,805.0
0.005,6,10,2007,5,928,1.0,660.0,660.0,5,1079,1.0,811.0,811.0
0.009,6,10,1972,5,910,2.0,642.0,642.0,5,1062,2.0,794.0,794.0
0.126,17,2,184,1,61,0.0,33.0,33.0,1,123,0.0,95.0,95.0
0.004,6,14,3742,8,504,0.0,80.0,80.0,6,3238,0.0,1470.0,1459.0
0.074,6,10,1506,5,395,16.0,127.0,127.0,5,1111,17.0,843.0,843.0
10.894,17,28,4422,14,1994,829.0,269.0,114.0,14,2428,829.0,587.0,145.0
0.004,6,10,1779,5,928,1.0,660.0,660.0,5,851,1.0,583.0,583.0
0.073,6,10,1506,5,395,15.0,127.0,127.0,5,1111,16.0,843.0,843.0
0.097,6,10,1506,5,395,21.0,127.0,127.0,5,1111,22.0,843.0,843.0
0.099,6,10,1506,5,395,23.0,127.0,127.0,5,1111,21.0,843.0,843.0
0.129,17,2,144,1,64,0.0,36.0,36.0,1,80,0.0,52.0,52.0
40.079,17,10,676,5,460,10016.0,104.0,64.0,5,216,10018.0,20.0,15.0
0.014,6,10,1990,5,911,3.0,643.0,643.0,5,1079,3.0,811.0,811.0
0.005,17,2,170,1,65,0.0,37.0,37.0,1,105,0.0,77.0,77.0
0.012,6,10,1762,5,911,3.0,643.0,643.0,5,851,2.0,583.0,583.0
0.005,6,13,3690,7,452,0.0,80.0,80.0,6,3238,1.0,1470.0,1459.0
0.013,6,14,3787,7,497,2.0,125.0,125.0,7,3290,2.0,1448.0,972.0
0.016,6,10,1990,5,911,4.0,643.0,643.0,5,1079,4.0,811.0,811.0
0.004,17,4,284,2,120,1.0,32.0,32.0,2,164,0.0,60.0,54.0
0.04,17,4,596,2,122,2.0,33.0,33.0,2,474,0.0,323.0,209.0
0.004,6,10,2006,5,927,1.0,659.0,659.0,5,1079,1.0,811.0,811.0
0.005,17,2,230,1,68,0.0,40.0,40.0,1,162,0.0,134.0,134.0
0.073,6,10,1506,5,395,15.0,127.0,127.0,5,1111,15.0,843.0,843.0
0.005,6,10,2007,5,928,1.0,660.0,660.0,5,1079,1.0,811.0,811.0
177.349,17,84,12082,42,2819,4325.0,44.0,39.0,42,9263,4325.0,239.0,192.0
0.01,6,10,1989,5,910,2.0,642.0,642.0,5,1079,2.0,811.0,811.0
0.04,6,10,1972,5,910,10.0,642.0,642.0,5,1062,9.0,794.0,794.0
40.061,17,10,676,5,460,10014.0,104.0,64.0,5,216,10014.0,20.0,15.0
0.013,6,10,1990,5,911,3.0,643.0,643.0,5,1079,3.0,811.0,811.0
178.373,17,80,11574,40,2675,4573.0,44.0,38.0,40,8899,4573.0,239.0,194.0
0.005,6,10,2000,5,927,1.0,659.0,659.0,5,1073,1.0,805.0,805.0
0.003,17,2,148,1,60,0.0,32.0,32.0,1,88,0.0,60.0,60.0
0.001,17,2,180,1,66,0.0,38.0,38.0,1,114,0.0,86.0,86.0
0.004,17,2,148,1,60,0.0,32.0,32.0,1,88,0.0,60.0,60.0
0.001,17,2,136,1,60,0.0,32.0,32.0,1,76,0.0,48.0,48.0
0.006,6,10,2000,5,927,1.0,659.0,659.0,5,1073,1.0,805.0,805.0
0.005,6,10,2007,5,928,1.0,660.0,660.0,5,1079,1.0,811.0,811.0
0.006,6,10,2007,5,928,1.0,660.0,660.0,5,1079,1.0,811.0,811.0
0.017,6,10,1989,5,910,4.0,642.0,642.0,5,1079,4.0,811.0,811.0
0.129,17,4,596,2,122,0.0,33.0,33.0,2,474,91.0,323.0,209.0
0.006,6,10,1547,5,764,1.0,496.0,496.0,5,783,1.0,515.0,515.0
177.199,17,72,10210,36,2401,5062.0,44.0,38.0,36,7809,5062.0,239.0,188.0
0.001,17,2,180,1,66,0.0,38.0,38.0,1,114,0.0,86.0,86.0
0.01,6,10,1989,5,910,2.0,642.0,642.0,5,1079,2.0,811.0,811.0
0.009,6,10,1983,5,910,2.0,642.0,642.0,5,1073,2.0,805.0,805.0
0.01,6,10,1989,5,910,2.0,642.0,642.0,5,1079,2.0,811.0,811.0
0.115,6,10,1506,5,395,26.0,127.0,127.0,5,1111,23.0,843.0,843.0
0.004,6,10,2007,5,928,1.0,660.0,660.0,5,1079,1.0,811.0,811.0
0.004,6,10,1989,5,927,1.0,659.0,659.0,5,1062,1.0,794.0,794.0
15.155,6,32,8952,17,1673,947.0,329.0,99.0,15,7279,1082.0,1402.0,721.0
0.005,17,2,230,1,68,0.0,40.0,40.0,1,162,0.0,134.0,134.0
0.014,6,10,1989,5,910,3.0,642.0,642.0,5,1079,3.0,811.0,811.0
0.006,6,10,1547,5,764,1.0,496.0,496.0,5,783,1.0,515.0,515.0
0.015,6,10,1990,5,911,3.0,643.0,643.0,5,1079,3.0,811.0,811.0
0.169,17,2,152,1,76,0.0,48.0,48.0,1,76,0.0,48.0,48.0
0.011,6,10,1990,5,911,2.0,643.0,643.0,5,1079,2.0,811.0,811.0
0.004,17,2,136,1,60,0.0,32.0,32.0,1,76,0.0,48.0,48.0
40.066,17,10,676,5,460,10015.0,104.0,64.0,5,216,10015.0,20.0,15.0
0.043,6,14,3787,7,497,7.0,125.0,125.0,7,3290,7.0,1448.0,972.0
0.087,6,10,1506,5,395,18.0,127.0,127.0,5,1111,18.0,843.0,843.0
0.018,6,10,1972,5,910,4.0,642.0,642.0,5,1062,4.0,794.0,794.0
0.008,6,10,1989,5,910,2.0,642.0,642.0,5,1079,2.0,811.0,811.0
65.791,6,23,10192,13,4025,5482.0,1402.0,668.0,10,6167,7292.0,2111.0,939.0
0.998,6,13,3922,7,2139,125.0,1328.0,923.0,6,1783,150.0,1539.0,1539.0
0.003,17,2,148,1,60,0.0,32.0,32.0,1,88,0.0,60.0,60.0
0.005,17,2,180,1,66,0.0,38.0,38.0,1,114,0.0,86.0,86.0
40.053,17,10,676,5,460,10012.0,104.0,64.0,5,216,10012.0,20.0,15.0
0.004,6,10,1989,5,927,1.0,659.0,659.0,5,1062,1.0,794.0,794.0
0.074,6,10,1506,5,395,16.0,127.0,127.0,5,1111,16.0,843.0,843.0
0.091,6,10,1506,5,395,18.0,127.0,127.0,5,1111,21.0,843.0,843.0
0.007,17,2,140,1,62,0.0,34.0,34.0,1,78,0.0,50.0,50.0
0.142,6,10,1506,5,395,30.0,127.0,127.0,5,1111,30.0,843.0,843.0
0.016,6,10,1983,5,910,4.0,642.0,642.0,5,1073,3.0,805.0,805.0
0.065,6,10,1506,5,395,15.0,127.0,127.0,5,1111,12.0,843.0,843.0
0.04,17,4,284,2,120,0.0,32.0,32.0,2,164,3.0,60.0,54.0
0.002,17,2,142,1,63,0.0,35.0,35.0,1,79,0.0,51.0,51.0
0.015,6,10,1990,5,911,3.0,643.0,643.0,5,1079,3.0,811.0,811.0
0.008,6,10,1989,5,910,1.0,642.0,642.0,5,1079,2.0,811.0,811.0
0.014,6,10,2000,5,927,3.0,659.0,659.0,5,1073,3.0,805.0,805.0
0.012,6,10,1983,5,910,3.0,642.0,642.0,5,1073,3.0,805.0,805.0
0.012,6,10,1990,5,911,2.0,643.0,643.0,5,1079,2.0,811.0,811.0
0.001,17,2,166,1,75,0.0,47.0,47.0,1,91,0.0,63.0,63.0
0.009,6,12,1926,6,1189,1.0,659.0,434.0,6,737,1.0,417.0,417.0
0.006,6,10,1547,5,764,1.0,496.0,496.0,5,783,1.0,515.0,515.0
0.091,6,10,1506,5,395,18.0,127.0,127.0,5,1111,21.0,843.0,843.0
0.005,17,2,164,1,74,0.0,46.0,46.0,1,90,0.0,62.0,62.0
0.251,6,10,1506,5,395,53.0,127.0,127.0,5,1111,30.0,843.0,843.0
0.005,6,10,2006,5,927,1.0,659.0,659.0,5,1079,1.0,811.0,811.0
0.004,17,4,284,2,120,1.0,32.0,32.0,2,164,0.0,60.0,54.0
0.009,6,10,1989,5,910,2.0,642.0,642.0,5,1079,2.0,811.0,811.0
0.004,6,10,2006,5,927,1.0,659.0,659.0,5,1079,1.0,811.0,811.0
0.018,6,10,1631,5,848,4.0,580.0,580.0,5,783,4.0,515.0,515.0
0.083,6,10,1506,5,395,18.0,127.0,127.0,5,1111,17.0,843.0,843.0
0.013,6,10,1983,5,910,3.0,642.0,642.0,5,1073,3.0,805.0,805.0
0.015,6,10,1983,5,910,3.0,642.0,642.0,5,1073,3.0,805.0,805.0
0.005,17,2,144,1,64,0.0,36.0,36.0,1,80,0.0,52.0,52.0
0.072,17,4,420,2,122,0.0,33.0,33.0,2,298,68.0,145.0,121.0
1771.619,17,120,11460,60,5460,30027.0,63.0,63.0,60,6000,30027.0,72.0,72.0
0.004,6,10,2007,5,928,1.0,660.0,660.0,5,1079,1.0,811.0,811.0
0.005,17,2,273,1,66,0.0,38.0,38.0,1,207,0.0,179.0,179.0
353.306,6,20,2210,6,1308,12004.0,494.0,494.0,14,902,27177.0,83.0,83.0
0.074,6,10,1506,5,395,16.0,127.0,127.0,5,1111,15.0,843.0,843.0
0.014,6,10,1989,5,910,3.0,642.0,642.0,5,1079,3.0,811.0,811.0
0.075,6,10,1506,5,395,15.0,127.0,127.0,5,1111,16.0,843.0,843.0
0.123,6,10,1506,5,395,27.0,127.0,127.0,5,1111,26.0,843.0,843.0
0.001,17,2,136,1,60,0.0,32.0,32.0,1,76,0.0,48.0,48.0
0.005,6,10,2006,5,927,1.0,659.0,659.0,5,1079,1.0,811.0,811.0
0.104,6,10,1506,5,395,24.0,127.0,127.0,5,1111,22.0,843.0,843.0
0.006,17,2,164,1,74,0.0,46.0,46.0,1,90,0.0,62.0,62.0
0.007,6,10,2006,5,927,1.0,659.0,659.0,5,1079,1.0,811.0,811.0
240.01,6,9,787,5,488,60002.0,232.0,232.0,4,299,80002.0,83.0,83.0
0.006,6,10,2006,5,927,1.0,659.0,659.0,5,1079,1.0,811.0,811.0
0.005,6,10,1689,5,839,1.0,571.0,571.0,5,850,1.0,582.0,582.0
0.005,6,10,2006,5,927,1.0,659.0,659.0,5,1079,1.0,811.0,811.0
40.058,17,10,676,5,460,10013.0,104.0,64.0,5,216,10013.0,20.0,15.0
0.106,6,10,1506,5,395,24.0,127.0,127.0,5,1111,23.0,843.0,843.0
0.115,6,10,1506,5,395,25.0,127.0,127.0,5,1111,24.0,843.0,843.0
0.013,17,2,152,1,76,0.0,48.0,48.0,1,76,0.0,48.0,48.0
0.004,6,10,1702,5,863,1.0,595.0,595.0,5,839,1.0,571.0,571.0
0.004,6,10,2006,5,927,1.0,659.0,659.0,5,1079,1.0,811.0,811.0
0.04,17,2,234,1,61,0.0,33.0,33.0,1,173,0.0,145.0,145.0
0.005,6,10,2007,5,928,1.0,660.0,660.0,5,1079,1.0,811.0,811.0
40.082,17,10,676,5,460,10017.0,104.0,64.0,5,216,10019.0,20.0,15.0
0.006,6,13,3747,7,509,0.0,137.0,137.0,6,3238,1.0,1470.0,1459.0
0.011,6,10,1983,5,910,2.0,642.0,642.0,5,1073,2.0,805.0,805.0
0.106,6,10,1506,5,395,19.0,127.0,127.0,5,1111,22.0,843.0,843.0
0.113,6,10,1506,5,395,26.0,127.0,127.0,5,1111,27.0,843.0,843.0
0.009,6,10,1983,5,910,2.0,642.0,642.0,5,1073,2.0,805.0,805.0
300.158,6,42,10638,22,5040,14285.0,1360.0,589.0,20,5598,15788.0,2667.0,435.0
0.072,17,4,364,2,160,0.0,52.0,52.0,2,204,32.0,80.0,74.0
0.016,6,10,1989,5,910,4.0,642.0,642.0,5,1079,3.0,811.0,811.0
0.005,6,10,1547,5,764,1.0,496.0,496.0,5,783,1.0,515.0,515.0
172.058,6,22,9246,11,1575,69.0,794.0,367.0,11,7671,17193.0,1360.0,1031.0
0.005,6,10,2006,5,927,1.0,659.0,659.0,5,1079,1.0,811.0,811.0
0.029,6,11,1729,6,879,5.0,559.0,559.0,5,850,7.0,582.0,582.0
0.007,6,10,1762,5,911,1.0,643.0,643.0,5,851,1.0,583.0,583.0
0.005,6,10,2006,5,927,1.0,659.0,659.0,5,1079,1.0,811.0,811.0
0.001,17,2,140,1,62,0.0,34.0,34.0,1,78,0.0,50.0,50.0
0.193,6,10,1506,5,395,42.0,127.0,127.0,5,1111,44.0,843.0,843.0
0.005,6,10,1989,5,927,1.0,659.0,659.0,5,1062,1.0,794.0,794.0
0.011,6,13,3735,7,497,1.0,125.0,125.0,6,3238,2.0,1470.0,1459.0
0.207,6,16,2669,8,1395,29.0,533.0,323.0,8,1274,18.0,529.0,212.0
0.248,17,2,152,1,76,0.0,48.0,48.0,1,76,0.0,48.0,48.0
0.004,6,15,3794,8,504,0.0,80.0,80.0,7,3290,0.0,1448.0,972.0
0.006,6,10,1547,5,764,1.0,496.0,496.0,5,783,1.0,515.0,515.0
0.006,17,2,169,1,62,0.0,34.0,34.0,1,107,0.0,79.0,79.0
0.093,6,10,1506,5,395,18.0,127.0,127.0,5,1111,21.0,843.0,843.0
0.005,6,13,3747,7,509,0.0,137.0,137.0,6,3238,1.0,1470.0,1459.0
0.005,6,10,1702,5,863,1.0,595.0,595.0,5,839,1.0,571.0,571.0
0.004,17,2,148,1,60,0.0,32.0,32.0,1,88,0.0,60.0,60.0
0.016,6,13,3735,7,497,2.0,125.0,125.0,6,3238,3.0,1470.0,1459.0
0.221,6,16,2778,8,1396,31.0,533.0,324.0,8,1382,20.0,529.0,239.0
0.005,6,10,1989,5,927,1.0,659.0,659.0,5,1062,1.0,794.0,794.0
0.004,17,2,148,1,60,0.0,32.0,32.0,1,88,0.0,60.0,60.0
0.012,6,10,1990,5,911,2.0,643.0,643.0,5,1079,2.0,811.0,811.0
0.008,6,10,1854,5,889,2.0,621.0,621.0,5,965,2.0,697.0,697.0
0.006,17,2,263,1,60,0.0,32.0,32.0,1,203,0.0,175.0,175.0
0.096,6,10,1506,5,395,22.0,127.0,127.0,5,1111,21.0,843.0,843.0
0.014,6,10,1989,5,910,3.0,642.0,642.0,5,1079,3.0,811.0,811.0
0.005,6,10,2007,5,928,1.0,660.0,660.0,5,1079,1.0,811.0,811.0
0.004,6,10,2006,5,927,1.0,659.0,659.0,5,1079,1.0,811.0,811.0
0.005,17,2,424,1,72,0.0,44.0,44.0,1,352,0.0,324.0,324.0
0.014,6,10,1989,5,910,3.0,642.0,642.0,5,1079,3.0,811.0,811.0
0.007,6,10,1547,5,764,1.0,496.0,496.0,5,783,1.0,515.0,515.0
0.354,17,44,20804,23,17141,16.0,1350.0,717.0,21,3663,14.0,1350.0,146.0
0.01,6,10,1990,5,911,2.0,643.0,643.0,5,1079,2.0,811.0,811.0
0.093,6,10,1506,5,395,22.0,127.0,127.0,5,1111,20.0,843.0,843.0
0.005,6,10,1989,5,927,1.0,659.0,659.0,5,1062,1.0,794.0,794.0
0.005,6,10,1547,5,764,1.0,496.0,496.0,5,783,1.0,515.0,515.0
0.128,6,10,1506,5,395,26.0,127.0,127.0,5,1111,29.0,843.0,843.0
0.004,6,10,2006,5,927,1.0,659.0,659.0,5,1079,1.0,811.0,811.0
0.089,6,10,1506,5,395,20.0,127.0,127.0,5,1111,19.0,843.0,843.0
0.103,6,10,1506,5,395,23.0,127.0,127.0,5,1111,21.0,843.0,843.0
0.001,17,2,180,1,66,0.0,38.0,38.0,1,114,0.0,86.0,86.0
240.011,6,9,787,5,488,60002.0,232.0,232.0,4,299,80002.0,83.0,83.0
40.062,17,10,676,5,460,10014.0,104.0,64.0,5,216,10014.0,20.0,15.0
0.039,17,2,148,1,60,0.0,32.0,32.0,1,88,0.0,60.0,60.0
0.011,6,10,1989,5,910,2.0,642.0,642.0,5,1079,2.0,811.0,811.0
0.014,6,10,1631,5,848,3.0,580.0,580.0,5,783,3.0,515.0,515.0
0.005,6,10,2007,5,928,1.0,660.0,660.0,5,1079,1.0,811.0,811.0
300.362,6,16,2170,9,684,37524.0,146.0,146.0,7,1486,50032.0,419.0,398.0
325.149,17,20,1124,10,716,36114.0,48.0,43.0,10,408,36114.0,20.0,12.0
0.005,6,10,2000,5,927,1.0,659.0,659.0,5,1073,1.0,805.0,805.0
0.004,6,10,1774,5,923,1.0,655.0,655.0,5,851,1.0,583.0,583.0
0.122,6,10,1506,5,395,28.0,127.0,127.0,5,1111,29.0,843.0,843.0
0.005,6,10,1854,5,889,1.0,621.0,621.0,5,965,1.0,697.0,697.0
0.023,6,13,3735,7,497,3.0,125.0,125.0,6,3238,4.0,1470.0,1459.0
0.003,17,2,136,1,60,0.0,32.0,32.0,1,76,0.0,48.0,48.0
0.009,6,10,1972,5,910,2.0,642.0,642.0,5,1062,2.0,794.0,794.0
0.009,6,10,1989,5,910,2.0,642.0,642.0,5,1079,2.0,811.0,811.0
0.005,6,10,2007,5,928,1.0,660.0,660.0,5,1079,1.0,811.0,811.0
0.26,17,2,152,1,76,0.0,48.0,48.0,1,76,0.0,48.0,48.0
0.093,6,10,1506,5,395,21.0,127.0,127.0,5,1111,21.0,843.0,843.0
0.005,6,10,2006,5,927,1.0,659.0,659.0,5,1079,1.0,811.0,811.0
0.004,17,2,136,1,60,0.0,32.0,32.0,1,76,0.0,48.0,48.0
300.624,6,34,6335,19,1409,16701.0,267.0,154.0,15,4926,605.0,1823.0,392.0
0.039,6,14,3787,7,497,6.0,125.0,125.0,7,3290,6.0,1448.0,972.0
0.005,6,10,1989,5,927,1.0,659.0,659.0,5,1062,1.0,794.0,794.0
0.17,6,3,453,2,321,170.0,241.0,241.0,1,132,0.0,92.0,92.0
0.008,6,13,3735,7,497,1.0,125.0,125.0,6,3238,1.0,1470.0,1459.0
0.008,6,10,1990,5,911,2.0,643.0,643.0,5,1079,2.0,811.0,811.0
0.015,6,10,1990,5,911,3.0,643.0,643.0,5,1079,3.0,811.0,811.0
240.09,6,16,4481,9,963,30011.0,238.0,166.0,7,3518,40014.0,1402.0,786.0
0.004,6,10,1702,5,863,1.0,595.0,595.0,5,839,1.0,571.0,571.0
0.008,6,10,1990,5,911,2.0,643.0,643.0,5,1079,2.0,811.0,811.0
0.041,17,4,596,2,122,2.0,33.0,33.0,2,474,0.0,323.0,209.0
0.013,6,10,1677,5,827,3.0,559.0,559.0,5,850,3.0,582.0,582.0
15.073,17,16,10616,9,8280,1880.0,1350.0,892.0,7,2336,2508.0,1350.0,305.0
0.01,6,10,1631,5,848,2.0,580.0,580.0,5,783,2.0,515.0,515.0
0.035,6,10,1990,5,911,8.0,643.0,643.0,5,1079,8.0,811.0,811.0
40.056,17,10,676,5,460,10013.0,104.0,64.0,5,216,10013.0,20.0,15.0
0.01,6,10,1989,5,910,2.0,642.0,642.0,5,1079,2.0,811.0,811.0
0.005,6,14,3799,7,509,0.0,137.0,137.0,7,3290,0.0,1448.0,972.0
40.061,17,10,676,5,460,10013.0,104.0,64.0,5,216,10013.0,20.0,15.0
0.004,6,10,1774,5,923,1.0,655.0,655.0,5,851,1.0,583.0,583.0
0.106,17,2,144,1,64,0.0,36.0,36.0,1,80,0.0,52.0,52.0
0.094,6,10,1506,5,395,18.0,127.0,127.0,5,1111,22.0,843.0,843.0
0.124,6,10,1506,5,395,20.0,127.0,127.0,5,1111,28.0,843.0,843.0
0.013,6,10,1983,5,910,3.0,642.0,642.0,5,1073,3.0,805.0,805.0
0.02,6,10,1631,5,848,5.0,580.0,580.0,5,783,5.0,515.0,515.0
0.028,6,10,1972,5,910,6.0,642.0,642.0,5,1062,7.0,794.0,794.0
0.014,17,2,148,1,60,0.0,32.0,32.0,1,88,0.0,60.0,60.0
10.764,17,28,4418,14,1995,819.0,270.0,114.0,14,2423,819.0,586.0,145.0
0.004,6,10,2007,5,928,1.0,660.0,660.0,5,1079,1.0,811.0,811.0
0.005,6,10,2006,5,927,1.0,659.0,659.0,5,1079,1.0,811.0,811.0
0.091,6,10,1506,5,395,21.0,127.0,127.0,5,1111,19.0,843.0,843.0
0.013,6,10,1972,5,910,3.0,642.0,642.0,5,1062,3.0,794.0,794.0
0.129,17,4,284,2,120,0.0,32.0,32.0,2,164,125.0,60.0,54.0
40.086,17,10,676,5,460,10020.0,104.0,64.0,5,216,10020.0,20.0,15.0
0.116,6,10,1506,5,395,28.0,127.0,127.0,5,1111,28.0,843.0,843.0
0.007,6,10,1989,5,910,1.0,642.0,642.0,5,1079,1.0,811.0,811.0
0.015,6,10,1983,5,910,3.0,642.0,642.0,5,1073,3.0,805.0,805.0
40.068,17,10,676,5,460,10016.0,104.0,64.0,5,216,10016.0,20.0,15.0
0.005,6,10,1854,5,889,1.0,621.0,621.0,5,965,1.0,697.0,697.0
0.012,6,10,1989,5,910,3.0,642.0,642.0,5,1079,2.0,811.0,811.0
0.021,6,10,1677,5,827,5.0,559.0,559.0,5,850,5.0,582.0,582.0
0.005,6,13,3690,7,452,0.0,80.0,80.0,6,3238,0.0,1470.0,1459.0
0.007,6,10,1989,5,910,1.0,642.0,642.0,5,1079,1.0,811.0,811.0
0.004,17,2,142,1,63,0.0,35.0,35.0,1,79,0.0,51.0,51.0
0.091,6,10,1506,5,395,19.0,127.0,127.0,5,1111,20.0,843.0,843.0
0.005,6,10,2006,5,927,1.0,659.0,659.0,5,1079,1.0,811.0,811.0
0.012,6,10,1989,5,910,3.0,642.0,642.0,5,1079,3.0,811.0,811.0
15.214,17,38,20101,21,17030,759.0,1350.0,782.0,17,3071,949.0,1350.0,152.0
0.005,6,10,2007,5,928,1.0,660.0,660.0,5,1079,1.0,811.0,811.0
0.006,6,10,1854,5,889,1.0,621.0,621.0,5,965,1.0,697.0,697.0
0.007,6,10,1990,5,911,1.0,643.0,643.0,5,1079,1.0,811.0,811.0
0.004,6,10,2006,5,927,1.0,659.0,659.0,5,1079,1.0,811.0,811.0
0.006,6,10,1547,5,764,1.0,496.0,496.0,5,783,1.0,515.0,515.0
0.006,6,10,1547,5,764,1.0,496.0,496.0,5,783,1.0,515.0,515.0
301.004,6,47,19354,25,13447,12541.0,2720.0,1379.0,22,5907,421.0,2667.0,385.0
1771.719,17,120,11460,60,5460,30028.0,63.0,63.0,60,6000,30028.0,72.0,72.0
40.007,17,10,676,5,460,10000.0,104.0,64.0,5,216,10001.0,20.0,15.0
0.005,6,10,2006,5,927,1.0,659.0,659.0,5,1079,1.0,811.0,811.0
15.071,17,15,9238,8,6902,2149.0,1350.0,834.0,7,2336,2507.0,1350.0,305.0
0.004,6,10,1702,5,863,1.0,595.0,595.0,5,839,1.0,571.0,571.0
0.015,6,10,1972,5,910,3.0,642.0,642.0,5,1062,3.0,794.0,794.0
0.005,17,2,170,1,65,0.0,37.0,37.0,1,105,0.0,77.0,77.0
0.005,6,10,1779,5,928,1.0,660.0,660.0,5,851,1.0,583.0,583.0
0.004,6,10,2006,5,927,1.0,659.0,659.0,5,1079,1.0,811.0,811.0
0.005,6,10,2000,5,927,1.0,659.0,659.0,5,1073,1.0,805.0,805.0
0.015,6,10,1990,5,911,3.0,643.0,643.0,5,1079,3.0,811.0,811.0
308.501,17,20,1124,10,716,34264.0,48.0,43.0,10,408,34264.0,20.0,12.0
0.007,17,2,179,1,71,0.0,43.0,43.0,1,108,0.0,80.0,80.0
0.009,6,10,1989,5,910,2.0,642.0,642.0,5,1079,2.0,811.0,811.0
10.804,17,28,4420,14,1993,822.0,268.0,114.0,14,2427,822.0,586.0,145.0
0.006,17,2,154,1,69,0.0,41.0,41.0,1,85,0.0,57.0,57.0
0.038,17,4,284,2,120,0.0,32.0,32.0,2,164,34.0,60.0,54.0
0.008,6,10,1983,5,910,2.0,642.0,642.0,5,1073,2.0,805.0,805.0
240.017,6,9,787,5,488,60004.0,232.0,232.0,4,299,80004.0,83.0,83.0
0.04,17,2,162,1,73,0.0,45.0,45.0,1,89,0.0,61.0,61.0
0.004,17,2,136,1,60,0.0,32.0,32.0,1,76,0.0,48.0,48.0
0.108,6,10,1506,5,395,23.0,127.0,127.0,5,1111,25.0,843.0,843.0
166.369,17,78,10980,39,2601,4378.0,44.0,38.0,39,8379,4378.0,261.0,186.0
0.005,17,2,152,1,68,0.0,40.0,40.0,1,84,0.0,56.0,56.0
0.333,17,4,352,2,130,179.0,37.0,37.0,2,222,257.0,89.0,83.0
0.084,6,10,1506,5,395,19.0,127.0,127.0,5,1111,18.0,843.0,843.0
0.005,17,2,179,1,71,0.0,43.0,43.0,1,108,0.0,80.0,80.0
0.005,6,10,2007,5,928,1.0,660.0,660.0,5,1079,1.0,811.0,811.0
0.109,6,10,1506,5,395,24.0,127.0,127.0,5,1111,27.0,843.0,843.0
0.003,17,2,136,1,60,0.0,32.0,32.0,1,76,0.0,48.0,48.0
0.013,6,10,1762,5,911,3.0,643.0,643.0,5,851,3.0,583.0,583.0
0.019,6,10,1677,5,827,4.0,559.0,559.0,5,850,4.0,582.0,582.0
366.067,6,20,2210,6,1308,12004.0,494.0,494.0,14,902,28158.0,83.0,83.0
0.008,6,10,1989,5,910,2.0,642.0,642.0,5,1079,1.0,811.0,811.0
240.031,6,9,787,5,488,60007.0,232.0,232.0,4,299,80006.0,83.0,83.0
0.006,6,10,1689,5,839,1.0,571.0,571.0,5,850,1.0,582.0,582.0
1764.618,6,465,68381,261,35864,6786.0,613.0,192.0,204,32517,8692.0,613.0,151.0
0.041,17,2,148,1,60,0.0,32.0,32.0,1,88,0.0,60.0,60.0
0.005,6,10,2006,5,927,1.0,659.0,659.0,5,1079,1.0,811.0,811.0
0.043,17,2,170,1,65,0.0,37.0,37.0,1,105,0.0,77.0,77.0
40.055,17,10,676,5,460,10013.0,104.0,64.0,5,216,10013.0,20.0,15.0
0.006,6,10,1547,5,764,1.0,496.0,496.0,5,783,1.0,515.0,515.0
0.004,17,2,148,1,60,0.0,32.0,32.0,1,88,0.0,60.0,60.0
0.014,6,10,1677,5,827,3.0,559.0,559.0,5,850,3.0,582.0,582.0
0.013,6,10,1990,5,911,3.0,643.0,643.0,5,1079,3.0,811.0,811.0
0.757,6,25,5459,12,1557,58.0,325.0,152.0,13,3902,53.0,1414.0,563.0
1.156,6,22,7922,12,1487,105.0,517.0,287.0,10,6435,17.0,1402.0,843.0
0.135,6,10,1506,5,395,27.0,127.0,127.0,5,1111,30.0,843.0,843.0
0.217,6,10,1506,5,395,51.0,127.0,127.0,5,1111,50.0,843.0,843.0
0.006,6,10,1547,5,764,1.0,496.0,496.0,5,783,1.0,515.0,515.0
0.01,6,10,1983,5,910,2.0,642.0,642.0,5,1073,2.0,805.0,805.0
0.07,6,10,1506,5,395,15.0,127.0,127.0,5,1111,14.0,843.0,843.0
0.122,6,10,1506,5,395,25.0,127.0,127.0,5,1111,26.0,843.0,843.0
0.006,17,2,179,1,71,0.0,43.0,43.0,1,108,0.0,80.0,80.0
0.006,6,10,1547,5,764,1.0,496.0,496.0,5,783,1.0,515.0,515.0
0.005,6,10,2007,5,928,1.0,660.0,660.0,5,1079,1.0,811.0,811.0
0.011,6,10,1972,5,910,2.0,642.0,642.0,5,1062,2.0,794.0,794.0
0.008,6,10,2007,5,928,2.0,660.0,660.0,5,1079,1.0,811.0,811.0
0.006,17,2,179,1,71,0.0,43.0,43.0,1,108,0.0,80.0,80.0
353.314,6,20,2210,6,1308,12003.0,494.0,494.0,14,902,27177.0,83.0,83.0
0.007,6,10,2007,5,928,1.0,660.0,660.0,5,1079,1.0,811.0,811.0
0.004,17,4,284,2,120,0.0,32.0,32.0,2,164,0.0,60.0,54.0
308.854,17,20,1124,10,716,34302.0,48.0,43.0,10,408,34302.0,20.0,12.0
0.001,17,2,179,1,62,0.0,34.0,34.0,1,117,0.0,89.0,89.0
0.081,6,10,1506,5,395,17.0,127.0,127.0,5,1111,17.0,843.0,843.0
0.118,6,10,1506,5,395,27.0,127.0,127.0,5,1111,22.0,843.0,843.0
0.141,6,10,1506,5,395,32.0,127.0,127.0,5,1111,33.0,843.0,843.0
0.005,6,10,2006,5,927,1.0,659.0,659.0,5,1079,1.0,811.0,811.0
240.122,6,30,9144,15,6965,17151.0,2090.0,687.0,15,2179,17151.0,580.0,198.0
0.008,6,10,1762,5,911,1.0,643.0,643.0,5,851,2.0,583.0,583.0
40.103,17,10,676,5,460,10013.0,104.0,64.0,5,216,10019.0,20.0,15.0
0.005,17,2,179,1,71,0.0,43.0,43.0,1,108,0.0,80.0,80.0
0.005,6,13,3747,7,509,0.0,137.0,137.0,6,3238,0.0,1470.0,1459.0
0.009,17,2,273,1,66,0.0,38.0,38.0,1,207,0.0,179.0,179.0
0.003,17,2,148,1,60,0.0,32.0,32.0,1,88,0.0,60.0,60.0
0.012,6,13,3735,7,497,2.0,125.0,125.0,6,3238,2.0,1470.0,1459.0
0.003,17,2,136,1,60,0.0,32.0,32.0,1,76,0.0,48.0,48.0
0.031,6,10,1989,5,910,7.0,642.0,642.0,5,1079,7.0,811.0,811.0
15.1,17,15,10568,9,8280,1882.0,1350.0,892.0,6,2288,3012.0,1350.0,353.0
0.158,6,10,1506,5,395,21.0,127.0,127.0,5,1111,33.0,843.0,843.0
0.01,6,10,1983,5,910,2.0,642.0,642.0,5,1073,2.0,805.0,805.0
0.001,17,2,180,1,66,0.0,38.0,38.0,1,114,0.0,86.0,86.0
0.006,6,10,1547,5,764,1.0,496.0,496.0,5,783,1.0,515.0,515.0
0.005,6,13,3747,7,509,0.0,137.0,137.0,6,3238,1.0,1470.0,1459.0
0.005,6,10,2007,5,928,1.0,660.0,660.0,5,1079,1.0,811.0,811.0
0.005,6,10,1774,5,923,1.0,655.0,655.0,5,851,1.0,583.0,583.0
0.03,6,10,1989,5,910,7.0,642.0,642.0,5,1079,7.0,811.0,811.0
0.011,6,10,1989,5,910,2.0,642.0,642.0,5,1079,2.0,811.0,811.0
0.004,6,13,3747,7,509,0.0,137.0,137.0,6,3238,0.0,1470.0,1459.0
0.014,6,10,1983,5,910,3.0,642.0,642.0,5,1073,3.0,805.0,805.0
0.004,6,10,2007,5,928,1.0,660.0,660.0,5,1079,1.0,811.0,811.0
0.133,17,2,80,1,32,0.0,4.0,4.0,1,48,0.0,20.0,20.0
0.001,17,2,180,1,66,0.0,38.0,38.0,1,114,0.0,86.0,86.0
0.006,6,10,1547,5,764,1.0,496.0,496.0,5,783,1.0,515.0,515.0
0.004,17,2,136,1,60,0.0,32.0,32.0,1,76,0.0,48.0,48.0
0.004,6,10,1989,5,927,1.0,659.0,659.0,5,1062,1.0,794.0,794.0
40.058,17,10,676,5,460,10013.0,104.0,64.0,5,216,10013.0,20.0,15.0
300.388,6,16,2170,9,684,37527.0,146.0,146.0,7,1486,50036.0,419.0,398.0
15.077,17,15,8732,8,6534,2149.0,1350.0,788.0,7,2198,2508.0,1350.0,286.0
0.079,6,10,1506,5,395,17.0,127.0,127.0,5,1111,16.0,843.0,843.0
332.697,17,20,1124,10,716,36951.0,48.0,43.0,10,408,36952.0,20.0,12.0
0.039,17,2,136,1,60,0.0,32.0,32.0,1,76,0.0,48.0,48.0
0.04,17,2,144,1,64,0.0,36.0,36.0,1,80,0.0,52.0,52.0
0.211,6,16,2777,8,1395,30.0,533.0,323.0,8,1382,19.0,529.0,239.0
0.128,17,2,80,1,32,0.0,4.0,4.0,1,48,0.0,20.0,20.0
0.008,6,10,1631,5,848,1.0,580.0,580.0,5,783,2.0,515.0,515.0
0.006,6,10,1547,5,764,1.0,496.0,496.0,5,783,1.0,515.0,515.0
0.004,6,10,1774,5,923,1.0,655.0,655.0,5,851,1.0,583.0,583.0
0.001,17,2,180,1,66,0.0,38.0,38.0,1,114,0.0,86.0,86.0
0.019,6,10,1989,5,910,4.0,642.0,642.0,5,1079,4.0,811.0,811.0
0.121,6,10,1506,5,395,28.0,127.0,127.0,5,1111,27.0,843.0,843.0
0.007,6,10,1854,5,889,1.0,621.0,621.0,5,965,1.0,697.0,697.0
171.146,17,78,11097,39,2596,4503.0,44.0,38.0,39,8501,4503.0,239.0,189.0
0.005,6,10,2007,5,928,1.0,660.0,660.0,5,1079,1.0,811.0,811.0
40.052,17,10,676,5,460,10012.0,104.0,64.0,5,216,10011.0,20.0,15.0
40.063,17,10,676,5,460,10015.0,104.0,64.0,5,216,10014.0,20.0,15.0
1779.098,17,143,45188,72,22752,25054.0,288.0,288.0,71,22436,25413.0,288.0,288.0
0.005,6,10,1774,5,923,1.0,655.0,655.0,5,851,1.0,583.0,583.0
0.011,6,14,3787,7,497,1.0,125.0,125.0,7,3290,1.0,1448.0,972.0
0.071,17,2,144,1,64,0.0,36.0,36.0,1,80,0.0,52.0,52.0
0.006,6,10,1547,5,764,1.0,496.0,496.0,5,783,1.0,515.0,515.0
0.005,17,2,144,1,64,0.0,36.0,36.0,1,80,0.0,52.0,52.0
15.077,17,18,8553,9,6012,1881.0,1350.0,640.0,9,2541,1880.0,1350.0,254.0
0.087,6,10,1506,5,395,16.0,127.0,127.0,5,1111,19.0,843.0,843.0
0.004,6,10,1989,5,927,1.0,659.0,659.0,5,1062,1.0,794.0,794.0
15.07,17,14,9191,8,6902,2148.0,1350.0,834.0,6,2289,3008.0,1350.0,353.0
0.101,6,10,1506,5,395,22.0,127.0,127.0,5,1111,20.0,843.0,843.0
0.123,6,10,1506,5,395,27.0,127.0,127.0,5,1111,27.0,843.0,843.0
2.038,6,36,6723,19,3451,113.0,1103.0,204.0,17,3272,117.0,1796.0,396.0
0.064,6,10,1506,5,395,13.0,127.0,127.0,5,1111,14.0,843.0,843.0
0.096,6,10,1506,5,395,22.0,127.0,127.0,5,1111,19.0,843.0,843.0
0.04,17,4,596,2,122,2.0,33.0,33.0,2,474,0.0,323.0,209.0
0.04,17,2,152,1,76,0.0,48.0,48.0,1,76,0.0,48.0,48.0
15.079,17,15,8504,8,6385,2150.0,1350.0,770.0,7,2119,2508.0,1350.0,274.0
0.004,6,10,2000,5,927,1.0,659.0,659.0,5,1073,1.0,805.0,805.0
0.003,17,2,136,1,60,0.0,32.0,32.0,1,76,0.0,48.0,48.0
0.004,17,2,136,1,60,0.0,32.0,32.0,1,76,0.0,48.0,48.0
0.04,17,4,284,2,120,0.0,32.0,32.0,2,164,36.0,60.0,54.0
309.766,17,20,1124,10,716,34403.0,48.0,43.0,10,408,34404.0,20.0,12.0
240.105,6,31,8912,16,6643,16007.0,1515.0,581.0,15,2269,17150.0,580.0,185.0
0.01,17,2,148,1,60,0.0,32.0,32.0,1,88,0.0,60.0,60.0
0.013,6,10,1989,5,910,3.0,642.0,642.0,5,1079,3.0,811.0,811.0
0.017,6,10,1990,5,911,4.0,643.0,643.0,5,1079,4.0,811.0,811.0
0.001,17,2,180,1,66,0.0,38.0,38.0,1,114,0.0,86.0,86.0
0.009,6,10,1983,5,910,2.0,642.0,642.0,5,1073,2.0,805.0,805.0
0.016,17,2,198,1,91,0.0,63.0,63.0,1,107,0.0,79.0,79.0
308.504,17,20,1124,10,716,34262.0,48.0,43.0,10,408,34264.0,20.0,12.0
0.043,17,2,170,1,65,0.0,37.0,37.0,1,105,0.0,77.0,77.0
0.005,6,10,1779,5,928,1.0,660.0,660.0,5,851,1.0,583.0,583.0
0.01,6,10,1762,5,911,2.0,643.0,643.0,5,851,2.0,583.0,583.0
0.005,6,10,2000,5,927,1.0,659.0,659.0,5,1073,1.0,805.0,805.0
0.017,6,10,1990,5,911,4.0,643.0,643.0,5,1079,4.0,811.0,811.0
10.815,17,28,4420,14,1993,823.0,268.0,114.0,14,2427,823.0,586.0,145.0
0.005,6,10,1854,5,889,1.0,621.0,621.0,5,965,1.0,697.0,697.0
40.052,17,10,676,5,460,10012.0,104.0,64.0,5,216,10012.0,20.0,15.0
0.067,6,10,1506,5,395,14.0,127.0,127.0,5,1111,14.0,843.0,843.0
0.004,6,10,1702,5,863,1.0,595.0,595.0,5,839,0.0,571.0,571.0
0.005,6,10,1989,5,927,1.0,659.0,659.0,5,1062,1.0,794.0,794.0
0.213,6,16,2669,8,1395,30.0,533.0,323.0,8,1274,19.0,529.0,212.0
0.004,17,2,186,1,61,0.0,33.0,33.0,1,125,0.0,97.0,97.0
0.085,6,10,1506,5,395,19.0,127.0,127.0,5,1111,16.0,843.0,843.0
0.004,17,2,136,1,60,0.0,32.0,32.0,1,76,0.0,48.0,48.0
0.005,6,10,2006,5,927,1.0,659.0,659.0,5,1079,1.0,811.0,811.0
0.015,6,10,1677,5,827,3.0,559.0,559.0,5,850,3.0,582.0,582.0
0.002,17,2,136,1,60,0.0,32.0,32.0,1,76,0.0,48.0,48.0
0.018,6,10,1989,5,910,4.0,642.0,642.0,5,1079,4.0,811.0,811.0
0.015,6,10,1631,5,848,3.0,580.0,580.0,5,783,3.0,515.0,515.0
0.005,6,10,1547,5,764,1.0,496.0,496.0,5,783,1.0,515.0,515.0
0.004,17,2,136,1,60,0.0,32.0,32.0,1,76,0.0,48.0,48.0
240.104,6,16,4480,9,963,30013.0,238.0,166.0,7,3517,40016.0,1402.0,786.0
0.014,6,10,1989,5,910,3.0,642.0,642.0,5,1079,3.0,811.0,811.0
0.006,6,10,1547,5,764,1.0,496.0,496.0,5,783,1.0,515.0,515.0
0.019,6,10,1972,5,910,4.0,642.0,642.0,5,1062,4.0,794.0,794.0
0.015,6,10,1972,5,910,3.0,642.0,642.0,5,1062,3.0,794.0,794.0
0.007,6,10,1689,5,839,1.0,571.0,571.0,5,850,1.0,582.0,582.0
178.111,17,82,11619,41,2731,4452.0,44.0,38.0,41,8888,4452.0,239.0,188.0
0.072,6,10,1506,5,395,15.0,127.0,127.0,5,1111,15.0,843.0,843.0
0.004,17,2,136,1,60,0.0,32.0,32.0,1,76,0.0,48.0,48.0
0.007,17,2,299,1,65,0.0,37.0,37.0,1,234,0.0,206.0,206.0
0.005,6,10,1989,5,927,1.0,659.0,659.0,5,1062,1.0,794.0,794.0
0.105,6,10,1506,5,395,23.0,127.0,127.0,5,1111,25.0,843.0,843.0
0.005,6,10,1854,5,889,1.0,621.0,621.0,5,965,1.0,697.0,697.0
0.006,6,10,1689,5,839,1.0,571.0,571.0,5,850,1.0,582.0,582.0
0.006,6,10,1547,5,764,1.0,496.0,496.0,5,783,1.0,515.0,515.0
11.706,17,28,4396,14,2311,887.0,586.0,137.0,14,2085,887.0,268.0,120.0
0.056,17,2,179,1,71,0.0,43.0,43.0,1,108,0.0,80.0,80.0
177.167,17,88,12300,44,2935,4120.0,44.0,38.0,44,9365,4120.0,239.0,184.0
0.005,17,2,148,1,60,0.0,32.0,32.0,1,88,0.0,60.0,60.0
0.006,17,2,230,1,68,0.0,40.0,40.0,1,162,0.0,134.0,134.0
0.011,6,10,1677,5,827,2.0,559.0,559.0,5,850,2.0,582.0,582.0
0.005,6,10,1989,5,927,1.0,659.0,659.0,5,1062,1.0,794.0,794.0
0.04,6,14,3787,7,497,6.0,125.0,125.0,7,3290,6.0,1448.0,972.0
0.098,6,10,1506,5,395,22.0,127.0,127.0,5,1111,24.0,843.0,843.0
0.004,17,2,148,1,60,0.0,32.0,32.0,1,88,0.0,60.0,60.0
0.004,17,2,148,1,60,0.0,32.0,32.0,1,88,0.0,60.0,60.0
0.042,17,4,336,2,124,0.0,34.0,34.0,2,212,5.0,84.0,78.0
0.006,6,11,2059,6,980,1.0,660.0,660.0,5,1079,1.0,811.0,811.0
0.094,6,10,1506,5,395,19.0,127.0,127.0,5,1111,21.0,843.0,843.0
0.005,6,10,2006,5,927,1.0,659.0,659.0,5,1079,1.0,811.0,811.0
0.007,6,10,1547,5,764,1.0,496.0,496.0,5,783,1.0,515.0,515.0
0.013,17,2,152,1,56,0.0,28.0,28.0,1,96,0.0,68.0,68.0
0.003,17,2,184,1,61,0.0,33.0,33.0,1,123,0.0,95.0,95.0
0.011,6,10,1677,5,827,2.0,559.0,559.0,5,850,2.0,582.0,582.0
0.01,6,10,1779,5,928,2.0,660.0,660.0,5,851,2.0,583.0,583.0
0.014,6,10,1983,5,910,3.0,642.0,642.0,5,1073,3.0,805.0,805.0
55.844,6,40,10527,20,4929,470.0,1360.0,682.0,20,5598,2930.0,2667.0,435.0
0.097,6,10,1506,5,395,22.0,127.0,127.0,5,1111,18.0,843.0,843.0
15.078,17,15,7962,8,5911,2149.0,1350.0,710.0,7,2051,2507.0,1350.0,265.0
0.095,6,10,1506,5,395,21.0,127.0,127.0,5,1111,21.0,843.0,843.0
0.005,6,10,1689,5,839,1.0,571.0,571.0,5,850,1.0,582.0,582.0
0.006,6,10,1547,5,764,1.0,496.0,496.0,5,783,1.0,515.0,515.0
40.059,17,10,676,5,460,10011.0,104.0,64.0,5,216,10013.0,20.0,15.0
0.015,6,10,1983,5,910,3.0,642.0,642.0,5,1073,3.0,805.0,805.0
0.003,17,2,148,1,60,0.0,32.0,32.0,1,88,0.0,60.0,60.0
354.023,6,21,1795,16,1030,23601.0,190.0,190.0,5,765,60001.0,464.0,248.0
0.004,6,10,1989,5,927,1.0,659.0,659.0,5,1062,1.0,794.0,794.0
0.011,6,10,2007,5,928,2.0,660.0,660.0,5,1079,2.0,811.0,811.0
0.008,6,10,1983,5,910,1.0,642.0,642.0,5,1073,1.0,805.0,805.0
0.01,6,10,1972,5,910,2.0,642.0,642.0,5,1062,2.0,794.0,794.0
40.067,17,10,676,5,460,10015.0,104.0,64.0,5,216,10015.0,20.0,15.0
0.004,17,2,148,1,60,0.0,32.0,32.0,1,88,0.0,60.0,60.0
0.004,6,10,2006,5,927,1.0,659.0,659.0,5,1079,1.0,811.0,811.0
0.005,6,10,1643,5,860,1.0,592.0,592.0,5,783,1.0,515.0,515.0
0.001,17,2,180,1,66,0.0,38.0,38.0,1,114,0.0,86.0,86.0
0.001,17,2,180,1,66,0.0,38.0,38.0,1,114,0.0,86.0,86.0
0.001,17,2,140,1,62,0.0,34.0,34.0,1,78,0.0,50.0,50.0
0.004,6,10,2007,5,928,1.0,660.0,660.0,5,1079,1.0,811.0,811.0
0.009,6,10,1990,5,911,2.0,643.0,643.0,5,1079,2.0,811.0,811.0
0.005,6,10,2006,5,927,1.0,659.0,659.0,5,1079,1.0,811.0,811.0
0.01,6,10,1972,5,910,2.0,642.0,642.0,5,1062,2.0,794.0,794.0
0.004,6,10,1779,5,928,1.0,660.0,660.0,5,851,1.0,583.0,583.0
0.041,17,2,148,1,60,0.0,32.0,32.0,1,88,0.0,60.0,60.0
0.006,17,2,194,1,59,0.0,31.0,31.0,1,135,0.0,107.0,107.0
10.945,17,28,4417,14,1994,833.0,269.0,114.0,14,2423,833.0,586.0,145.0
0.005,6,13,3747,7,509,0.0,137.0,137.0,6,3238,0.0,1470.0,1459.0
0.071,17,8,3613,4,1874,23.0,1350.0,440.0,4,1739,12.0,1350.0,406.0
0.008,6,10,1990,5,911,2.0,643.0,643.0,5,1079,2.0,811.0,811.0
74.101,6,8,494,4,235,24685.0,27.0,27.0,4,259,24684.0,27.0,25.0
0.005,6,10,2007,5,928,1.0,660.0,660.0,5,1079,1.0,811.0,811.0
0.004,17,2,136,1,60,0.0,32.0,32.0,1,76,0.0,48.0,48.0
0.032,6,10,1972,5,910,7.0,642.0,642.0,5,1062,8.0,794.0,794.0
0.012,6,10,1983,5,910,2.0,642.0,642.0,5,1073,3.0,805.0,805.0
0.006,6,10,2006,5,927,1.0,659.0,659.0,5,1079,1.0,811.0,811.0
0.005,6,10,2000,5,927,1.0,659.0,659.0,5,1073,1.0,805.0,805.0
0.005,17,2,166,1,75,0.0,47.0,47.0,1,91,0.0,63.0,63.0
0.009,6,10,1677,5,827,2.0,559.0,559.0,5,850,2.0,582.0,582.0
0.005,17,2,169,1,62,0.0,34.0,34.0,1,107,0.0,79.0,79.0
0.095,6,10,1506,5,395,23.0,127.0,127.0,5,1111,16.0,843.0,843.0
0.004,17,2,136,1,60,0.0,32.0,32.0,1,76,0.0,48.0,48.0
0.111,6,10,1506,5,395,22.0,127.0,127.0,5,1111,25.0,843.0,843.0
0.006,6,10,1854,5,889,1.0,621.0,621.0,5,965,1.0,697.0,697.0
0.098,6,10,1506,5,395,20.0,127.0,127.0,5,1111,21.0,843.0,843.0
0.001,17,2,180,1,65,0.0,37.0,37.0,1,115,0.0,87.0,87.0
0.006,6,10,1643,5,860,1.0,592.0,592.0,5,783,1.0,515.0,515.0
0.014,6,10,1989,5,910,3.0,642.0,642.0,5,1079,3.0,811.0,811.0
0.008,6,10,1983,5,910,2.0,642.0,642.0,5,1073,2.0,805.0,805.0
0.005,6,13,3690,7,452,0.0,80.0,80.0,6,3238,0.0,1470.0,1459.0
0.111,17,2,179,1,71,0.0,43.0,43.0,1,108,0.0,80.0,80.0
0.012,6,10,1677,5,827,2.0,559.0,559.0,5,850,2.0,582.0,582.0
0.009,6,12,1926,6,1189,1.0,659.0,434.0,6,737,1.0,417.0,417.0
0.003,17,2,136,1,60,0.0,32.0,32.0,1,76,0.0,48.0,48.0
0.012,6,10,1972,5,910,2.0,642.0,642.0,5,1062,2.0,794.0,794.0
0.012,6,10,1983,5,910,3.0,642.0,642.0,5,1073,3.0,805.0,805.0
0.006,6,10,2006,5,927,1.0,659.0,659.0,5,1079,1.0,811.0,811.0
1799.558,6,619,207859,304,174337,5939.0,2883.0,916.0,315,33522,5731.0,1665.0,143.0
0.024,6,13,3735,7,497,3.0,125.0,125.0,6,3238,4.0,1470.0,1459.0
0.009,6,10,1983,5,910,2.0,642.0,642.0,5,1073,2.0,805.0,805.0
0.006,6,10,1989,5,927,1.0,659.0,659.0,5,1062,1.0,794.0,794.0
0.005,17,2,230,1,68,0.0,40.0,40.0,1,162,0.0,134.0,134.0
40.053,17,10,676,5,460,10012.0,104.0,64.0,5,216,10012.0,20.0,15.0
0.004,6,10,2006,5,927,1.0,659.0,659.0,5,1079,1.0,811.0,811.0
0.003,17,2,148,1,60,0.0,32.0,32.0,1,88,0.0,60.0,60.0
240.093,6,16,4481,9,963,30011.0,238.0,166.0,7,3518,40014.0,1402.0,786.0
0.076,6,10,1506,5,395,15.0,127.0,127.0,5,1111,17.0,843.0,843.0
0.11,6,10,1506,5,395,25.0,127.0,127.0,5,1111,22.0,843.0,843.0
0.005,6,10,1854,5,889,1.0,621.0,621.0,5,965,1.0,697.0,697.0
190.17,58,4,288,3,216,95085.0,24.0,24.0,1,72,0.0,24.0,24.0
1729.244,6,61,4464,41,2804,43231.0,33.0,33.0,20,1660,91004.0,31.0,31.0
0.019,17,2,230,1,68,0.0,40.0,40.0,1,162,0.0,134.0,134.0
0.06,17,2,80,1,32,0.0,4.0,4.0,1,48,0.0,20.0,20.0
0.013,6,10,1983,5,910,3.0,642.0,642.0,5,1073,3.0,805.0,805.0
0.005,6,10,1779,5,928,1.0,660.0,660.0,5,851,1.0,583.0,583.0
0.077,6,10,1506,5,395,18.0,127.0,127.0,5,1111,17.0,843.0,843.0
0.003,17,2,136,1,60,0.0,32.0,32.0,1,76,0.0,48.0,48.0
0.114,6,10,1506,5,395,25.0,127.0,127.0,5,1111,24.0,843.0,843.0
0.005,6,10,2006,5,927,1.0,659.0,659.0,5,1079,1.0,811.0,811.0
0.081,6,10,1506,5,395,19.0,127.0,127.0,5,1111,18.0,843.0,843.0
0.005,6,10,1854,5,889,1.0,621.0,621.0,5,965,1.0,697.0,697.0
3.141,6,34,10562,21,3311,157.0,517.0,315.0,13,7251,261.0,1402.0,656.0
0.005,6,10,2000,5,927,1.0,659.0,659.0,5,1073,1.0,805.0,805.0
0.005,17,2,234,1,61,0.0,33.0,33.0,1,173,0.0,145.0,145.0
0.003,17,2,148,1,60,0.0,32.0,32.0,1,88,0.0,60.0,60.0
0.004,6,10,1989,5,927,1.0,659.0,659.0,5,1062,1.0,794.0,794.0
0.068,6,10,1506,5,395,15.0,127.0,127.0,5,1111,15.0,843.0,843.0
0.143,6,10,1506,5,395,22.0,127.0,127.0,5,1111,34.0,843.0,843.0
0.006,6,10,1547,5,764,1.0,496.0,496.0,5,783,1.0,515.0,515.0
0.168,6,10,1506,5,395,35.0,127.0,127.0,5,1111,39.0,843.0,843.0
0.062,17,2,234,1,61,0.0,33.0,33.0,1,173,0.0,145.0,145.0
1778.152,17,143,41496,72,22752,25044.0,288.0,288.0,71,18744,25402.0,236.0,236.0
0.077,6,10,1506,5,395,16.0,127.0,127.0,5,1111,18.0,843.0,843.0
0.119,6,10,1506,5,395,28.0,127.0,127.0,5,1111,19.0,843.0,843.0
0.069,17,8,3613,4,1874,23.0,1350.0,440.0,4,1739,10.0,1350.0,406.0
0.084,6,10,1506,5,395,19.0,127.0,127.0,5,1111,19.0,843.0,843.0
0.006,17,2,136,1,60,0.0,32.0,32.0,1,76,0.0,48.0,48.0
0.01,6,10,1983,5,910,2.0,642.0,642.0,5,1073,2.0,805.0,805.0
0.006,17,2,170,1,65,0.0,37.0,37.0,1,105,0.0,77.0,77.0
0.005,6,10,2000,5,927,1.0,659.0,659.0,5,1073,1.0,805.0,805.0
0.009,6,10,1983,5,910,2.0,642.0,642.0,5,1073,2.0,805.0,805.0
354.036,6,21,1795,16,1030,23602.0,190.0,190.0,5,765,60003.0,464.0,248.0
0.153,6,10,1506,5,395,36.0,127.0,127.0,5,1111,36.0,843.0,843.0
40.073,17,10,676,5,460,10013.0,104.0,64.0,5,216,10016.0,20.0,15.0
0.013,6,10,1972,5,910,3.0,642.0,642.0,5,1062,3.0,794.0,794.0
0.111,6,10,1506,5,395,23.0,127.0,127.0,5,1111,25.0,843.0,843.0
0.006,6,10,1547,5,764,1.0,496.0,496.0,5,783,1.0,515.0,515.0
0.005,6,14,3799,7,509,0.0,137.0,137.0,7,3290,0.0,1448.0,972.0
11.168,17,28,4420,14,1993,846.0,268.0,114.0,14,2427,846.0,586.0,145.0
0.092,6,10,1506,5,395,21.0,127.0,127.0,5,1111,19.0,843.0,843.0
0.012,6,10,1972,5,910,3.0,642.0,642.0,5,1062,3.0,794.0,794.0
0.015,6,10,1990,5,911,3.0,643.0,643.0,5,1079,3.0,811.0,811.0
0.005,17,2,179,1,71,0.0,43.0,43.0,1,108,0.0,80.0,80.0
0.006,6,12,1698,6,863,1.0,327.0,271.0,6,835,1.0,515.0,515.0
0.004,17,2,136,1,60,0.0,32.0,32.0,1,76,0.0,48.0,48.0
0.004,6,10,1702,5,863,1.0,595.0,595.0,5,839,1.0,571.0,571.0
0.062,6,10,1990,5,911,15.0,643.0,643.0,5,1079,15.0,811.0,811.0
177.09,17,78,11067,39,2593,4660.0,44.0,38.0,39,8474,4660.0,239.0,189.0
0.086,6,10,1506,5,395,19.0,127.0,127.0,5,1111,18.0,843.0,843.0
0.005,6,10,2006,5,927,1.0,659.0,659.0,5,1079,1.0,811.0,811.0
40.072,17,10,676,5,460,10017.0,104.0,64.0,5,216,10017.0,20.0,15.0
0.008,17,2,194,1,59,0.0,31.0,31.0,1,135,0.0,107.0,107.0
0.115,6,10,1506,5,395,25.0,127.0,127.0,5,1111,25.0,843.0,843.0
0.004,17,4,284,2,120,0.0,32.0,32.0,2,164,0.0,60.0,54.0
0.012,6,10,1677,5,827,3.0,559.0,559.0,5,850,2.0,582.0,582.0
0.017,6,10,1989,5,910,4.0,642.0,642.0,5,1079,4.0,811.0,811.0
1786.933,6,150,19350,90,13740,20077.0,302.0,302.0,60,5610,30286.0,83.0,83.0
0.005,6,10,2006,5,927,1.0,659.0,659.0,5,1079,1.0,811.0,811.0
40.062,17,10,676,5,460,10013.0,104.0,64.0,5,216,10014.0,20.0,15.0
0.009,6,10,1989,5,910,2.0,642.0,642.0,5,1079,2.0,811.0,811.0
0.004,6,10,1779,5,928,1.0,660.0,660.0,5,851,1.0,583.0,583.0
40.065,17,10,676,5,460,10015.0,104.0,64.0,5,216,10015.0,20.0,15.0
0.018,6,10,1762,5,911,4.0,643.0,643.0,5,851,4.0,583.0,583.0
0.009,6,10,1972,5,910,2.0,642.0,642.0,5,1062,2.0,794.0,794.0
0.399,17,2,142,1,63,0.0,35.0,35.0,1,79,0.0,51.0,51.0
0.017,6,10,1631,5,848,4.0,580.0,580.0,5,783,4.0,515.0,515.0
0.016,6,10,1990,5,911,3.0,643.0,643.0,5,1079,3.0,811.0,811.0
0.093,6,10,1506,5,395,21.0,127.0,127.0,5,1111,19.0,843.0,843.0
0.041,17,2,152,1,76,0.0,48.0,48.0,1,76,0.0,48.0,48.0
1729.21,6,60,4400,40,2740,44338.0,33.0,33.0,20,1660,91002.0,31.0,31.0
0.004,6,10,2000,5,927,1.0,659.0,659.0,5,1073,1.0,805.0,805.0
0.005,17,2,180,1,66,0.0,38.0,38.0,1,114,0.0,86.0,86.0
0.005,17,2,230,1,68,0.0,40.0,40.0,1,162,0.0,134.0,134.0
0.008,6,10,1989,5,910,2.0,642.0,642.0,5,1079,2.0,811.0,811.0
0.004,6,10,2006,5,927,1.0,659.0,659.0,5,1079,1.0,811.0,811.0
0.615,17,62,40180,36,35420,17.0,1350.0,955.0,26,4760,21.0,1350.0,155.0
0.104,6,10,1506,5,395,24.0,127.0,127.0,5,1111,24.0,843.0,843.0
0.01,6,10,1989,5,910,2.0,642.0,642.0,5,1079,2.0,811.0,811.0
40.056,17,10,676,5,460,10013.0,104.0,64.0,5,216,10013.0,20.0,15.0
0.009,6,13,3735,7,497,1.0,125.0,125.0,6,3238,1.0,1470.0,1459.0
0.101,6,10,1506,5,395,17.0,127.0,127.0,5,1111,24.0,843.0,843.0
0.041,17,4,284,2,120,0.0,32.0,32.0,2,164,37.0,60.0,54.0
0.005,6,10,1989,5,927,1.0,659.0,659.0,5,1062,1.0,794.0,794.0
0.005,17,2,170,1,65,0.0,37.0,37.0,1,105,0.0,77.0,77.0
0.015,6,10,1989,5,910,3.0,642.0,642.0,5,1079,3.0,811.0,811.0
0.039,17,2,148,1,60,0.0,32.0,32.0,1,88,0.0,60.0,60.0
0.101,6,10,1506,5,395,23.0,127.0,127.0,5,1111,23.0,843.0,843.0
0.008,6,10,1989,5,910,2.0,642.0,642.0,5,1079,2.0,811.0,811.0
0.224,6,16,2670,8,1396,32.0,533.0,324.0,8,1274,20.0,529.0,212.0
0.041,17,4,284,2,120,0.0,32.0,32.0,2,164,38.0,60.0,54.0
0.056,17,2,160,1,72,0.0,44.0,44.0,1,88,0.0,60.0,60.0
0.032,6,10,1989,5,910,8.0,642.0,642.0,5,1079,8.0,811.0,811.0
0.0,17,2,180,1,66,0.0,38.0,38.0,1,114,0.0,86.0,86.0
0.003,17,2,148,1,60,0.0,32.0,32.0,1,88,0.0,60.0,60.0
0.011,6,10,1989,5,910,2.0,642.0,642.0,5,1079,2.0,811.0,811.0
0.094,6,10,1506,5,395,19.0,127.0,127.0,5,1111,18.0,843.0,843.0
0.053,17,2,152,1,76,0.0,48.0,48.0,1,76,0.0,48.0,48.0
15.079,17,16,8729,8,6564,2150.0,1350.0,792.0,8,2165,2149.0,1350.0,242.0
0.094,6,10,1506,5,395,20.0,127.0,127.0,5,1111,21.0,843.0,843.0
0.026,17,2,148,1,60,0.0,32.0,32.0,1,88,0.0,60.0,60.0
0.012,6,10,1677,5,827,2.0,559.0,559.0,5,850,2.0,582.0,582.0
0.01,6,10,1989,5,910,2.0,642.0,642.0,5,1079,2.0,811.0,811.0
0.005,17,2,170,1,65,0.0,37.0,37.0,1,105,0.0,77.0,77.0
40.075,17,10,676,5,460,10015.0,104.0,64.0,5,216,10015.0,20.0,15.0
0.006,6,10,1547,5,764,1.0,496.0,496.0,5,783,1.0,515.0,515.0
0.27,17,44,25696,24,22507,11.0,1350.0,909.0,20,3189,10.0,1350.0,131.0
0.167,17,2,152,1,76,0.0,48.0,48.0,1,76,0.0,48.0,48.0
0.001,17,2,136,1,60,0.0,32.0,32.0,1,76,0.0,48.0,48.0
0.087,6,10,1506,5,395,18.0,127.0,127.0,5,1111,17.0,843.0,843.0
0.016,6,10,1972,5,910,4.0,642.0,642.0,5,1062,3.0,794.0,794.0
0.013,6,13,3735,7,497,2.0,125.0,125.0,6,3238,2.0,1470.0,1459.0
0.007,17,2,194,1,59,0.0,31.0,31.0,1,135,0.0,107.0,107.0
64.78,6,29,17783,14,9564,4983.0,2804.0,1473.0,15,8219,4617.0,2424.0,743.0
311.73,17,18,1044,9,684,38947.0,48.0,48.0,9,360,38949.0,12.0,12.0
0.003,17,2,656,1,328,0.0,300.0,300.0,1,328,0.0,300.0,300.0
0.02,6,10,1972,5,910,4.0,642.0,642.0,5,1062,4.0,794.0,794.0
0.007,17,2,212,1,74,0.0,46.0,46.0,1,138,0.0,110.0,110.0
0.012,6,10,1990,5,911,2.0,643.0,643.0,5,1079,3.0,811.0,811.0
0.07,17,8,3613,4,1874,23.0,1350.0,440.0,4,1739,11.0,1350.0,406.0
0.001,17,2,174,1,72,0.0,44.0,44.0,1,102,0.0,74.0,74.0
0.079,6,10,1506,5,395,16.0,127.0,127.0,5,1111,18.0,843.0,843.0
0.006,6,10,1547,5,764,1.0,496.0,496.0,5,783,1.0,515.0,515.0
0.008,6,10,1990,5,911,2.0,643.0,643.0,5,1079,1.0,811.0,811.0
0.004,17,2,136,1,60,0.0,32.0,32.0,1,76,0.0,48.0,48.0
144.555,6,26,9525,12,1627,79.0,794.0,367.0,14,7898,11109.0,1360.0,732.0
0.013,17,2,152,1,56,0.0,28.0,28.0,1,96,0.0,68.0,68.0
0.134,6,10,1506,5,395,33.0,127.0,127.0,5,1111,32.0,843.0,843.0
0.009,6,10,1983,5,910,2.0,642.0,642.0,5,1073,2.0,805.0,805.0
0.001,17,2,180,1,66,0.0,38.0,38.0,1,114,0.0,86.0,86.0
0.012,6,10,1972,5,910,3.0,642.0,642.0,5,1062,3.0,794.0,794.0
0.041,17,2,182,1,65,0.0,37.0,37.0,1,117,0.0,89.0,89.0
0.006,6,10,1547,5,764,1.0,496.0,496.0,5,783,1.0,515.0,515.0
0.005,17,2,170,1,65,0.0,37.0,37.0,1,105,0.0,77.0,77.0
0.006,17,2,169,1,62,0.0,34.0,34.0,1,107,0.0,79.0,79.0
0.005,6,10,2006,5,927,1.0,659.0,659.0,5,1079,1.0,811.0,811.0
0.005,6,10,2000,5,927,1.0,659.0,659.0,5,1073,1.0,805.0,805.0
0.014,6,10,1989,5,910,3.0,642.0,642.0,5,1079,3.0,811.0,811.0
0.005,6,10,2007,5,928,1.0,660.0,660.0,5,1079,1.0,811.0,811.0
0.093,6,10,1506,5,395,21.0,127.0,127.0,5,1111,20.0,843.0,843.0
0.006,17,2,170,1,65,0.0,37.0,37.0,1,105,0.0,77.0,77.0
1.062,6,16,2991,10,1543,118.0,593.0,252.0,6,1448,211.0,888.0,564.0
241.234,6,304,343569,125,18012,1945.0,2736.0,959.0,179,325557,1355.0,2804.0,1871.0
0.005,6,10,2007,5,928,1.0,660.0,660.0,5,1079,1.0,811.0,811.0
0.082,6,10,1506,5,395,17.0,127.0,127.0,5,1111,19.0,843.0,843.0
0.015,6,10,1677,5,827,3.0,559.0,559.0,5,850,3.0,582.0,582.0
0.012,6,10,1989,5,910,3.0,642.0,642.0,5,1079,3.0,811.0,811.0
0.073,17,2,182,1,65,0.0,37.0,37.0,1,117,0.0,89.0,89.0
0.004,17,2,148,1,60,0.0,32.0,32.0,1,88,0.0,60.0,60.0
0.017,6,10,1990,5,911,4.0,643.0,643.0,5,1079,4.0,811.0,811.0
0.08,6,10,1506,5,395,18.0,127.0,127.0,5,1111,13.0,843.0,843.0
40.068,17,10,676,5,460,10014.0,104.0,64.0,5,216,10016.0,20.0,15.0
0.006,6,10,1547,5,764,1.0,496.0,496.0,5,783,1.0,515.0,515.0
0.014,6,10,1989,5,910,3.0,642.0,642.0,5,1079,3.0,811.0,811.0
0.006,6,10,1989,5,910,1.0,642.0,642.0,5,1079,1.0,811.0,811.0
0.001,17,2,180,1,66,0.0,38.0,38.0,1,114,0.0,86.0,86.0
0.012,6,10,1983,5,910,2.0,642.0,642.0,5,1073,2.0,805.0,805.0
0.092,6,10,1506,5,395,21.0,127.0,127.0,5,1111,20.0,843.0,843.0
0.005,6,15,3794,8,504,0.0,80.0,80.0,7,3290,0.0,1448.0,972.0
0.004,6,10,1702,5,863,1.0,595.0,595.0,5,839,0.0,571.0,571.0
0.005,17,2,170,1,65,0.0,37.0,37.0,1,105,0.0,77.0,77.0
0.07,6,10,1506,5,395,15.0,127.0,127.0,5,1111,15.0,843.0,843.0
0.005,6,10,2000,5,927,1.0,659.0,659.0,5,1073,1.0,805.0,805.0
0.005,6,10,1989,5,927,1.0,659.0,659.0,5,1062,1.0,794.0,794.0
0.011,6,10,1990,5,911,2.0,643.0,643.0,5,1079,2.0,811.0,811.0
0.004,17,2,132,1,58,0.0,30.0,30.0,1,74,0.0,46.0,46.0
0.004,6,10,2006,5,927,1.0,659.0,659.0,5,1079,1.0,811.0,811.0
0.012,6,10,1989,5,910,3.0,642.0,642.0,5,1079,3.0,811.0,811.0
0.101,6,10,1506,5,395,23.0,127.0,127.0,5,1111,24.0,843.0,843.0
0.02,6,10,1983,5,910,4.0,642.0,642.0,5,1073,5.0,805.0,805.0
0.096,6,10,1506,5,395,15.0,127.0,127.0,5,1111,22.0,843.0,843.0
172.052,17,84,11762,42,2815,4196.0,44.0,39.0,42,8947,4196.0,239.0,185.0
0.007,6,10,1989,5,910,1.0,642.0,642.0,5,1079,1.0,811.0,811.0
40.06,17,10,676,5,460,10014.0,104.0,64.0,5,216,10014.0,20.0,15.0
0.005,6,10,1547,5,764,1.0,496.0,496.0,5,783,1.0,515.0,515.0
0.111,6,10,1506,5,395,26.0,127.0,127.0,5,1111,25.0,843.0,843.0
0.006,6,10,1547,5,764,1.0,496.0,496.0,5,783,1.0,515.0,515.0
0.012,6,10,1983,5,910,2.0,642.0,642.0,5,1073,3.0,805.0,805.0
0.13,17,2,80,1,32,0.0,4.0,4.0,1,48,0.0,20.0,20.0
360.044,6,21,3981,13,3142,30003.0,494.0,494.0,8,839,51434.0,83.0,83.0
0.005,6,10,1854,5,889,1.0,621.0,621.0,5,965,1.0,697.0,697.0
0.005,17,2,214,1,75,0.0,47.0,47.0,1,139,0.0,111.0,111.0
0.01,6,10,1989,5,910,2.0,642.0,642.0,5,1079,2.0,811.0,811.0
361.806,6,21,1792,16,1030,24120.0,190.0,190.0,5,762,60009.0,461.0,247.0
0.104,6,10,1506,5,395,24.0,127.0,127.0,5,1111,24.0,843.0,843.0
0.01,6,10,1972,5,910,2.0,642.0,642.0,5,1062,2.0,794.0,794.0
0.053,17,2,152,1,76,0.0,48.0,48.0,1,76,0.0,48.0,48.0
0.012,6,10,1990,5,911,3.0,643.0,643.0,5,1079,3.0,811.0,811.0
0.005,6,10,1989,5,927,1.0,659.0,659.0,5,1062,1.0,794.0,794.0
0.018,6,10,1677,5,827,4.0,559.0,559.0,5,850,4.0,582.0,582.0
0.006,17,2,214,1,75,0.0,47.0,47.0,1,139,0.0,111.0,111.0
0.011,6,10,1762,5,911,2.0,643.0,643.0,5,851,2.0,583.0,583.0
0.005,6,10,1774,5,923,1.0,655.0,655.0,5,851,1.0,583.0,583.0
0.004,17,2,136,1,60,0.0,32.0,32.0,1,76,0.0,48.0,48.0
0.011,6,10,1989,5,910,2.0,642.0,642.0,5,1079,2.0,811.0,811.0
0.006,6,10,2006,5,927,1.0,659.0,659.0,5,1079,1.0,811.0,811.0
0.012,6,10,1631,5,848,2.0,580.0,580.0,5,783,3.0,515.0,515.0
0.004,6,10,1702,5,863,1.0,595.0,595.0,5,839,0.0,571.0,571.0
0.005,6,10,1989,5,927,1.0,659.0,659.0,5,1062,1.0,794.0,794.0
0.093,6,10,1506,5,395,20.0,127.0,127.0,5,1111,20.0,843.0,843.0
0.004,6,10,1989,5,927,1.0,659.0,659.0,5,1062,1.0,794.0,794.0
0.022,6,10,1605,5,388,5.0,120.0,120.0,5,1217,5.0,949.0,949.0
0.011,6,10,1677,5,827,2.0,559.0,559.0,5,850,2.0,582.0,582.0
1770.306,6,83,4368,42,2210,43177.0,26.0,26.0,41,2158,44256.0,26.0,26.0
0.009,6,10,1972,5,910,2.0,642.0,642.0,5,1062,2.0,794.0,794.0
0.008,17,2,179,1,71,0.0,43.0,43.0,1,108,0.0,80.0,80.0
0.127,17,2,136,1,60,0.0,32.0,32.0,1,76,0.0,48.0,48.0
374.687,6,21,1795,16,1030,24979.0,190.0,190.0,5,765,60020.0,464.0,248.0
0.006,17,2,148,1,60,0.0,32.0,32.0,1,88,0.0,60.0,60.0
0.003,17,4,284,2,120,0.0,32.0,32.0,2,164,0.0,60.0,54.0
0.006,6,10,1547,5,764,1.0,496.0,496.0,5,783,1.0,515.0,515.0
0.082,6,10,1506,5,395,19.0,127.0,127.0,5,1111,19.0,843.0,843.0
0.005,6,10,1774,5,923,1.0,655.0,655.0,5,851,1.0,583.0,583.0
0.004,6,10,2006,5,927,1.0,659.0,659.0,5,1079,1.0,811.0,811.0
0.005,6,10,2007,5,928,1.0,660.0,660.0,5,1079,1.0,811.0,811.0
0.006,6,10,1643,5,860,1.0,592.0,592.0,5,783,1.0,515.0,515.0
0.015,6,10,1990,5,911,3.0,643.0,643.0,5,1079,3.0,811.0,811.0
0.009,6,10,1989,5,910,2.0,642.0,642.0,5,1079,2.0,811.0,811.0
0.009,6,13,3735,7,497,1.0,125.0,125.0,6,3238,1.0,1470.0,1459.0
0.007,6,10,1689,5,839,1.0,571.0,571.0,5,850,1.0,582.0,582.0
0.004,6,10,1989,5,927,1.0,659.0,659.0,5,1062,1.0,794.0,794.0
0.003,17,2,148,1,60,0.0,32.0,32.0,1,88,0.0,60.0,60.0
240.038,6,9,787,5,488,60009.0,232.0,232.0,4,299,80011.0,83.0,83.0
0.066,6,10,1506,5,395,14.0,127.0,127.0,5,1111,14.0,843.0,843.0
0.012,6,10,1989,5,910,3.0,642.0,642.0,5,1079,3.0,811.0,811.0
0.177,17,17,10612,9,8208,22.0,1350.0,884.0,8,2404,16.0,1350.0,272.0
40.066,17,10,676,5,460,10015.0,104.0,64.0,5,216,10015.0,20.0,15.0
0.006,6,10,1547,5,764,1.0,496.0,496.0,5,783,1.0,515.0,515.0
0.007,17,2,162,1,65,0.0,37.0,37.0,1,97,0.0,69.0,69.0
0.01,6,10,1989,5,910,2.0,642.0,642.0,5,1079,2.0,811.0,811.0
0.009,6,10,1989,5,910,2.0,642.0,642.0,5,1079,2.0,811.0,811.0
0.005,6,10,1643,5,860,1.0,592.0,592.0,5,783,1.0,515.0,515.0
10.802,17,28,4418,14,1994,822.0,269.0,114.0,14,2424,822.0,587.0,145.0
0.004,17,2,412,1,61,0.0,33.0,33.0,1,351,0.0,323.0,323.0
226.352,6,773,882279,389,858915,582.0,4080.0,2342.0,384,23364,590.0,2667.0,204.0
0.006,6,10,1689,5,839,1.0,571.0,571.0,5,850,1.0,582.0,582.0
0.006,6,10,1547,5,764,1.0,496.0,496.0,5,783,1.0,515.0,515.0
0.005,6,10,1643,5,860,1.0,592.0,592.0,5,783,1.0,515.0,515.0
0.009,6,10,1990,5,911,2.0,643.0,643.0,5,1079,2.0,811.0,811.0
0.118,6,10,1506,5,395,27.0,127.0,127.0,5,1111,28.0,843.0,843.0
177.327,17,92,13087,46,3052,3940.0,44.0,38.0,46,10035,3940.0,252.0,190.0
40.068,17,10,676,5,460,10014.0,104.0,64.0,5,216,10016.0,20.0,15.0
0.005,6,10,2006,5,927,1.0,659.0,659.0,5,1079,1.0,811.0,811.0
0.072,17,2,136,1,60,0.0,32.0,32.0,1,76,0.0,48.0,48.0
0.01,6,10,1989,5,910,2.0,642.0,642.0,5,1079,2.0,811.0,811.0
0.021,6,10,1989,5,910,5.0,642.0,642.0,5,1079,5.0,811.0,811.0
0.111,6,10,1506,5,395,24.0,127.0,127.0,5,1111,25.0,843.0,843.0
0.053,17,2,152,1,76,0.0,48.0,48.0,1,76,0.0,48.0,48.0
40.058,17,10,676,5,460,10013.0,104.0,64.0,5,216,10013.0,20.0,15.0
0.004,17,2,148,1,60,0.0,32.0,32.0,1,88,0.0,60.0,60.0
0.017,6,10,1990,5,911,4.0,643.0,643.0,5,1079,4.0,811.0,811.0
0.015,6,10,1983,5,910,3.0,642.0,642.0,5,1073,3.0,805.0,805.0
0.043,17,2,136,1,60,0.0,32.0,32.0,1,76,0.0,48.0,48.0
0.003,17,2,148,1,60,0.0,32.0,32.0,1,88,0.0,60.0,60.0
0.095,6,10,1506,5,395,18.0,127.0,127.0,5,1111,21.0,843.0,843.0
0.007,6,10,1547,5,764,1.0,496.0,496.0,5,783,1.0,515.0,515.0
0.004,6,10,2000,5,927,1.0,659.0,659.0,5,1073,1.0,805.0,805.0
0.005,17,2,164,1,74,0.0,46.0,46.0,1,90,0.0,62.0,62.0
0.043,17,4,596,2,122,3.0,33.0,33.0,2,474,3.0,323.0,209.0
11.021,17,28,4398,14,2312,839.0,587.0,137.0,14,2086,838.0,269.0,121.0
0.005,17,2,214,1,75,0.0,47.0,47.0,1,139,0.0,111.0,111.0
0.009,6,10,1972,5,910,2.0,642.0,642.0,5,1062,2.0,794.0,794.0
0.015,6,10,1990,5,911,3.0,643.0,643.0,5,1079,3.0,811.0,811.0
40.068,17,10,676,5,460,10016.0,104.0,64.0,5,216,10016.0,20.0,15.0
0.008,6,12,1926,6,1189,1.0,659.0,434.0,6,737,1.0,417.0,417.0
15.101,17,15,9238,8,6902,2149.0,1350.0,834.0,7,2336,2511.0,1350.0,305.0
0.015,6,10,1972,5,910,3.0,642.0,642.0,5,1062,3.0,794.0,794.0
0.01,6,10,1989,5,910,2.0,642.0,642.0,5,1079,2.0,811.0,811.0
0.1,6,10,1506,5,395,23.0,127.0,127.0,5,1111,21.0,843.0,843.0
0.157,6,10,1506,5,395,37.0,127.0,127.0,5,1111,37.0,843.0,843.0
0.01,6,10,1989,5,910,2.0,642.0,642.0,5,1079,2.0,811.0,811.0
9.038,17,6,376,5,280,2259.0,28.0,28.0,1,96,0.0,68.0,68.0
10.793,17,28,4421,14,1994,822.0,269.0,114.0,14,2427,822.0,586.0,145.0
0.007,6,10,2007,5,928,1.0,660.0,660.0,5,1079,1.0,811.0,811.0
0.005,6,13,3747,7,509,0.0,137.0,137.0,6,3238,0.0,1470.0,1459.0
0.02,6,10,1983,5,910,5.0,642.0,642.0,5,1073,5.0,805.0,805.0
0.018,6,10,1983,5,910,4.0,642.0,642.0,5,1073,4.0,805.0,805.0
0.005,17,2,168,1,76,0.0,48.0,48.0,1,92,0.0,64.0,64.0
0.005,6,10,2006,5,927,1.0,659.0,659.0,5,1079,1.0,811.0,811.0
361.823,6,21,1792,16,1030,24121.0,190.0,190.0,5,762,60010.0,461.0,247.0
0.012,6,10,1989,5,910,3.0,642.0,642.0,5,1079,3.0,811.0,811.0
0.005,6,10,1989,5,927,1.0,659.0,659.0,5,1062,1.0,794.0,794.0
0.006,6,10,2000,5,927,1.0,659.0,659.0,5,1073,1.0,805.0,805.0
0.006,6,13,3747,7,509,1.0,137.0,137.0,6,3238,1.0,1470.0,1459.0
0.003,17,2,136,1,60,0.0,32.0,32.0,1,76,0.0,48.0,48.0
0.005,6,10,2006,5,927,1.0,659.0,659.0,5,1079,1.0,811.0,811.0
0.084,6,10,1506,5,395,18.0,127.0,127.0,5,1111,14.0,843.0,843.0
0.019,6,10,1990,5,911,4.0,643.0,643.0,5,1079,4.0,811.0,811.0
0.006,6,10,2006,5,927,1.0,659.0,659.0,5,1079,1.0,811.0,811.0
0.014,6,10,1990,5,911,3.0,643.0,643.0,5,1079,3.0,811.0,811.0
1775.832,6,235,28280,89,19177,20178.0,2720.0,213.0,146,9103,12246.0,147.0,47.0
0.006,6,10,1972,5,910,1.0,642.0,642.0,5,1062,1.0,794.0,794.0
0.014,6,14,3787,7,497,2.0,125.0,125.0,7,3290,2.0,1448.0,972.0
1798.908,17,3298,253147,1639,132878,1098.0,84.0,53.0,1659,120269,1084.0,227.0,44.0
0.014,6,10,1990,5,911,3.0,643.0,643.0,5,1079,3.0,811.0,811.0
0.081,6,10,1506,5,395,19.0,127.0,127.0,5,1111,18.0,843.0,843.0
0.011,6,10,1972,5,910,2.0,642.0,642.0,5,1062,2.0,794.0,794.0
0.072,17,2,170,1,65,0.0,37.0,37.0,1,105,0.0,77.0,77.0
0.006,6,10,1547,5,764,1.0,496.0,496.0,5,783,1.0,515.0,515.0
0.046,17,4,284,2,120,1.0,32.0,32.0,2,164,42.0,60.0,54.0
0.001,17,2,180,1,66,0.0,38.0,38.0,1,114,0.0,86.0,86.0
0.212,6,16,2669,8,1395,30.0,533.0,323.0,8,1274,19.0,529.0,212.0
0.005,17,2,170,1,65,0.0,37.0,37.0,1,105,0.0,77.0,77.0
0.004,6,10,2006,5,927,1.0,659.0,659.0,5,1079,1.0,811.0,811.0
0.065,6,10,1506,5,395,15.0,127.0,127.0,5,1111,13.0,843.0,843.0
0.011,6,10,1989,5,910,2.0,642.0,642.0,5,1079,2.0,811.0,811.0
0.072,17,2,136,1,60,0.0,32.0,32.0,1,76,0.0,48.0,48.0
0.005,6,10,2006,5,927,1.0,659.0,659.0,5,1079,1.0,811.0,811.0
0.009,6,10,1989,5,910,2.0,642.0,642.0,5,1079,2.0,811.0,811.0
0.004,17,2,148,1,60,0.0,32.0,32.0,1,88,0.0,60.0,60.0
0.003,17,2,136,1,60,0.0,32.0,32.0,1,76,0.0,48.0,48.0
0.084,6,10,1506,5,395,19.0,127.0,127.0,5,1111,18.0,843.0,843.0
0.12,6,10,1506,5,395,28.0,127.0,127.0,5,1111,27.0,843.0,843.0
0.068,6,10,1506,5,395,15.0,127.0,127.0,5,1111,14.0,843.0,843.0
30.361,6,25,8555,14,1788,2335.0,517.0,262.0,11,6767,3035.0,1402.0,773.0
0.088,6,10,1506,5,395,20.0,127.0,127.0,5,1111,16.0,843.0,843.0
0.005,17,2,170,1,65,0.0,37.0,37.0,1,105,0.0,77.0,77.0
0.185,6,3,453,2,321,185.0,241.0,241.0,1,132,0.0,92.0,92.0
0.109,6,10,1506,5,395,20.0,127.0,127.0,5,1111,22.0,843.0,843.0
0.004,17,2,156,1,64,0.0,36.0,36.0,1,92,0.0,64.0,64.0
350.5,58,8,576,6,432,70100.0,24.0,24.0,2,144,310677.0,24.0,24.0
0.008,6,14,3787,7,497,1.0,125.0,125.0,7,3290,1.0,1448.0,972.0
0.015,6,10,2007,5,928,3.0,660.0,660.0,5,1079,3.0,811.0,811.0
0.004,6,10,2006,5,927,1.0,659.0,659.0,5,1079,1.0,811.0,811.0
0.005,6,10,1989,5,927,1.0,659.0,659.0,5,1062,1.0,794.0,794.0
0.051,17,2,144,1,64,0.0,36.0,36.0,1,80,0.0,52.0,52.0
0.001,17,2,180,1,66,0.0,38.0,38.0,1,114,0.0,86.0,86.0
0.001,17,2,180,1,66,0.0,38.0,38.0,1,114,0.0,86.0,86.0
0.083,6,10,1506,5,395,19.0,127.0,127.0,5,1111,18.0,843.0,843.0
294.7,6,413,349661,197,21805,1503.0,2736.0,888.0,216,327856,1370.0,2804.0,1567.0
0.102,6,10,1506,5,395,24.0,127.0,127.0,5,1111,24.0,843.0,843.0
0.252,17,39,20150,21,17046,12.0,1350.0,783.0,18,3104,11.0,1350.0,144.0
0.106,6,10,1506,5,395,24.0,127.0,127.0,5,1111,18.0,843.0,843.0
0.007,6,10,1989,5,910,1.0,642.0,642.0,5,1079,1.0,811.0,811.0
0.042,17,2,152,1,76,0.0,48.0,48.0,1,76,0.0,48.0,48.0
40.058,17,10,676,5,460,10013.0,104.0,64.0,5,216,10013.0,20.0,15.0
0.008,17,2,166,1,75,0.0,47.0,47.0,1,91,0.0,63.0,63.0
0.003,17,2,136,1,60,0.0,32.0,32.0,1,76,0.0,48.0,48.0
0.012,6,10,1990,5,911,3.0,643.0,643.0,5,1079,3.0,811.0,811.0
0.069,6,10,1506,5,395,15.0,127.0,127.0,5,1111,14.0,843.0,843.0
0.01,6,10,1989,5,910,2.0,642.0,642.0,5,1079,2.0,811.0,811.0
0.005,6,10,2006,5,927,1.0,659.0,659.0,5,1079,1.0,811.0,811.0
0.01,6,10,1989,5,910,2.0,642.0,642.0,5,1079,2.0,811.0,811.0
0.006,6,10,1547,5,764,1.0,496.0,496.0,5,783,1.0,515.0,515.0
0.086,6,10,1506,5,395,18.0,127.0,127.0,5,1111,19.0,843.0,843.0
0.003,6,10,1702,5,863,0.0,595.0,595.0,5,839,0.0,571.0,571.0
0.008,6,10,1972,5,910,2.0,642.0,642.0,5,1062,2.0,794.0,794.0
0.135,6,10,1506,5,395,33.0,127.0,127.0,5,1111,30.0,843.0,843.0
300.282,6,16,2170,9,684,37513.0,146.0,146.0,7,1486,50018.0,419.0,398.0
0.005,17,2,144,1,64,0.0,36.0,36.0,1,80,0.0,52.0,52.0
0.015,6,10,1989,5,910,3.0,642.0,642.0,5,1079,3.0,811.0,811.0
0.103,6,10,1506,5,395,23.0,127.0,127.0,5,1111,21.0,843.0,843.0
0.004,6,10,1774,5,923,1.0,655.0,655.0,5,851,1.0,583.0,583.0
40.052,17,10,676,5,460,10010.0,104.0,64.0,5,216,10012.0,20.0,15.0
0.126,17,2,148,1,60,0.0,32.0,32.0,1,88,0.0,60.0,60.0
40.079,17,10,676,5,460,10016.0,104.0,64.0,5,216,10019.0,20.0,15.0
0.125,6,10,1506,5,395,24.0,127.0,127.0,5,1111,27.0,843.0,843.0
0.013,6,10,1989,5,910,3.0,642.0,642.0,5,1079,3.0,811.0,811.0
0.01,6,10,1972,5,910,2.0,642.0,642.0,5,1062,2.0,794.0,794.0
0.033,17,2,198,1,91,0.0,63.0,63.0,1,107,0.0,79.0,79.0
0.063,6,10,1506,5,395,13.0,127.0,127.0,5,1111,15.0,843.0,843.0
0.014,6,10,1762,5,911,3.0,643.0,643.0,5,851,3.0,583.0,583.0
0.004,6,13,3690,7,452,0.0,80.0,80.0,6,3238,0.0,1470.0,1459.0
0.016,17,2,180,1,66,0.0,38.0,38.0,1,114,0.0,86.0,86.0
0.084,6,10,1506,5,395,17.0,127.0,127.0,5,1111,18.0,843.0,843.0
0.006,6,10,2006,5,927,1.0,659.0,659.0,5,1079,1.0,811.0,811.0
0.002,17,2,136,1,60,0.0,32.0,32.0,1,76,0.0,48.0,48.0
0.011,6,10,1990,5,911,2.0,643.0,643.0,5,1079,2.0,811.0,811.0
0.032,6,10,1762,5,911,8.0,643.0,643.0,5,851,7.0,583.0,583.0
0.005,6,10,2006,5,927,1.0,659.0,659.0,5,1079,1.0,811.0,811.0
0.001,17,2,180,1,66,0.0,38.0,38.0,1,114,0.0,86.0,86.0
0.006,6,10,1547,5,764,1.0,496.0,496.0,5,783,1.0,515.0,515.0
0.005,6,10,2007,5,928,1.0,660.0,660.0,5,1079,1.0,811.0,811.0
11.149,17,28,4423,14,1995,844.0,270.0,114.0,14,2428,844.0,587.0,145.0
0.024,6,19,9922,11,704,2.0,124.0,124.0,8,9218,3.0,2896.0,2198.0
0.005,6,10,2006,5,927,1.0,659.0,659.0,5,1079,1.0,811.0,811.0
0.253,17,44,24506,24,21161,11.0,1350.0,853.0,20,3345,9.0,1350.0,139.0
0.02,6,10,1989,5,910,5.0,642.0,642.0,5,1079,4.0,811.0,811.0
300.314,6,16,2170,9,684,37517.0,146.0,146.0,7,1486,50023.0,419.0,398.0
0.008,6,12,1926,6,1189,1.0,659.0,434.0,6,737,1.0,417.0,417.0
260.606,6,38,17818,21,9488,5122.0,1360.0,860.0,17,8330,16277.0,2720.0,848.0
308.446,17,20,1124,10,716,34257.0,48.0,43.0,10,408,34257.0,20.0,12.0
0.005,6,10,2007,5,928,1.0,660.0,660.0,5,1079,1.0,811.0,811.0
0.071,17,2,128,1,56,0.0,28.0,28.0,1,72,0.0,44.0,44.0
0.127,17,2,412,1,61,0.0,33.0,33.0,1,351,0.0,323.0,323.0
0.005,6,13,3747,7,509,0.0,137.0,137.0,6,3238,1.0,1470.0,1459.0
240.021,6,9,787,5,488,60005.0,232.0,232.0,4,299,80006.0,83.0,83.0
0.012,6,10,1972,5,910,2.0,642.0,642.0,5,1062,2.0,794.0,794.0
0.012,6,10,1972,5,910,3.0,642.0,642.0,5,1062,3.0,794.0,794.0
0.003,17,2,136,1,60,0.0,32.0,32.0,1,76,0.0,48.0,48.0
0.113,6,10,1506,5,395,23.0,127.0,127.0,5,1111,22.0,843.0,843.0
0.006,6,10,2007,5,928,1.0,660.0,660.0,5,1079,1.0,811.0,811.0
0.005,6,10,1774,5,923,1.0,655.0,655.0,5,851,1.0,583.0,583.0
0.012,6,10,1989,5,910,3.0,642.0,642.0,5,1079,2.0,811.0,811.0
366.196,6,22,2313,16,867,24413.0,195.0,195.0,6,1446,4637.0,419.0,398.0
0.005,6,10,2006,5,927,1.0,659.0,659.0,5,1079,1.0,811.0,811.0
0.005,17,2,166,1,75,0.0,47.0,47.0,1,91,0.0,63.0,63.0
0.014,17,2,179,1,71,0.0,43.0,43.0,1,108,0.0,80.0,80.0
0.013,6,10,1990,5,911,3.0,643.0,643.0,5,1079,3.0,811.0,811.0
0.021,17,2,170,1,65,0.0,37.0,37.0,1,105,0.0,77.0,77.0
0.004,17,2,148,1,60,0.0,32.0,32.0,1,88,0.0,60.0,60.0
0.118,6,10,1506,5,395,27.0,127.0,127.0,5,1111,27.0,843.0,843.0
123.81,6,26,9525,12,1627,78.0,794.0,367.0,14,7898,9514.0,1360.0,732.0
0.005,6,10,1779,5,928,1.0,660.0,660.0,5,851,1.0,583.0,583.0
0.012,6,10,1989,5,910,2.0,642.0,642.0,5,1079,3.0,811.0,811.0
0.004,6,10,1774,5,923,1.0,655.0,655.0,5,851,1.0,583.0,583.0
0.004,17,2,148,1,60,0.0,32.0,32.0,1,88,0.0,60.0,60.0
0.004,6,10,2006,5,927,1.0,659.0,659.0,5,1079,1.0,811.0,811.0
0.008,6,10,1643,5,860,2.0,592.0,592.0,5,783,1.0,515.0,515.0
0.014,6,10,1989,5,910,3.0,642.0,642.0,5,1079,3.0,811.0,811.0
242.243,6,301,342888,112,17338,2182.0,2736.0,886.0,189,325550,1288.0,2804.0,1773.0
0.014,6,10,1990,5,911,3.0,643.0,643.0,5,1079,3.0,811.0,811.0
0.006,17,2,170,1,65,0.0,37.0,37.0,1,105,0.0,77.0,77.0
0.038,17,4,284,2,120,0.0,32.0,32.0,2,164,35.0,60.0,54.0
1797.818,6,86,5303,43,2286,42804.0,50.0,50.0,43,3017,42804.0,432.0,390.0
0.008,6,10,1990,5,911,2.0,643.0,643.0,5,1079,1.0,811.0,811.0
0.004,6,10,2000,5,927,1.0,659.0,659.0,5,1073,1.0,805.0,805.0
0.169,17,2,152,1,76,0.0,48.0,48.0,1,76,0.0,48.0,48.0
0.004,6,10,2000,5,927,1.0,659.0,659.0,5,1073,1.0,805.0,805.0
0.005,17,2,136,1,60,0.0,32.0,32.0,1,76,0.0,48.0,48.0
0.091,6,10,1506,5,395,18.0,127.0,127.0,5,1111,21.0,843.0,843.0
0.005,6,10,2000,5,927,1.0,659.0,659.0,5,1073,1.0,805.0,805.0
0.001,17,2,180,1,66,0.0,38.0,38.0,1,114,0.0,86.0,86.0
40.052,17,10,676,5,460,10012.0,104.0,64.0,5,216,10011.0,20.0,15.0
0.004,6,10,1774,5,923,1.0,655.0,655.0,5,851,1.0,583.0,583.0
0.001,17,2,136,1,60,0.0,32.0,32.0,1,76,0.0,48.0,48.0
0.09,6,10,1506,5,395,21.0,127.0,127.0,5,1111,16.0,843.0,843.0
40.085,17,10,676,5,460,10020.0,104.0,64.0,5,216,10020.0,20.0,15.0
0.01,6,10,1983,5,910,2.0,642.0,642.0,5,1073,2.0,805.0,805.0
0.006,6,10,1547,5,764,1.0,496.0,496.0,5,783,1.0,515.0,515.0
0.271,17,4,352,2,130,231.0,37.0,37.0,2,222,144.0,89.0,83.0
0.006,17,2,144,1,64,0.0,36.0,36.0,1,80,0.0,52.0,52.0
0.067,6,10,1506,5,395,13.0,127.0,127.0,5,1111,14.0,843.0,843.0
0.006,6,10,1547,5,764,1.0,496.0,496.0,5,783,1.0,515.0,515.0
0.005,6,10,1989,5,927,1.0,659.0,659.0,5,1062,1.0,794.0,794.0
9.041,17,6,376,5,280,2260.0,28.0,28.0,1,96,0.0,68.0,68.0
0.015,6,10,1989,5,910,3.0,642.0,642.0,5,1079,3.0,811.0,811.0
0.073,17,2,148,1,60,0.0,32.0,32.0,1,88,0.0,60.0,60.0
0.005,17,2,144,1,64,0.0,36.0,36.0,1,80,0.0,52.0,52.0
240.496,6,33,16458,17,7077,15031.0,2736.0,1239.0,16,9381,16032.0,1908.0,1220.0
0.009,6,10,1689,5,839,2.0,571.0,571.0,5,850,2.0,582.0,582.0
0.016,6,10,1972,5,910,3.0,642.0,642.0,5,1062,4.0,794.0,794.0
0.167,6,10,1506,5,395,41.0,127.0,127.0,5,1111,37.0,843.0,843.0
0.106,6,10,1506,5,395,25.0,127.0,127.0,5,1111,23.0,843.0,843.0
0.016,6,10,1989,5,910,4.0,642.0,642.0,5,1079,3.0,811.0,811.0
240.087,6,18,4608,9,2210,30010.0,1007.0,582.0,9,2398,30010.0,1162.0,480.0
0.005,6,10,1774,5,923,1.0,655.0,655.0,5,851,1.0,583.0,583.0
0.004,17,2,148,1,60,0.0,32.0,32.0,1,88,0.0,60.0,60.0
0.006,6,10,1547,5,764,1.0,496.0,496.0,5,783,1.0,515.0,515.0
0.001,17,2,166,1,75,0.0,47.0,47.0,1,91,0.0,63.0,63.0
0.006,6,10,1689,5,839,1.0,571.0,571.0,5,850,1.0,582.0,582.0
0.015,6,10,1972,5,910,3.0,642.0,642.0,5,1062,3.0,794.0,794.0
0.003,17,2,148,1,60,0.0,32.0,32.0,1,88,0.0,60.0,60.0
1756.146,6,105,6240,60,3510,29764.0,26.0,26.0,45,2730,39911.0,26.0,26.0
0.063,6,10,1506,5,395,13.0,127.0,127.0,5,1111,14.0,843.0,843.0
0.112,6,10,1506,5,395,23.0,127.0,127.0,5,1111,25.0,843.0,843.0
0.015,17,4,284,2,120,0.0,32.0,32.0,2,164,0.0,60.0,54.0
0.008,6,10,1990,5,911,2.0,643.0,643.0,5,1079,2.0,811.0,811.0
0.01,6,10,1990,5,911,2.0,643.0,643.0,5,1079,2.0,811.0,811.0
0.005,6,10,1854,5,889,1.0,621.0,621.0,5,965,1.0,697.0,697.0
177.093,17,92,12820,46,3073,3935.0,44.0,38.0,46,9747,3935.0,261.0,183.0
0.019,6,10,1983,5,910,4.0,642.0,642.0,5,1073,4.0,805.0,805.0
0.012,6,10,1983,5,910,3.0,642.0,642.0,5,1073,2.0,805.0,805.0
0.015,6,10,1989,5,910,3.0,642.0,642.0,5,1079,3.0,811.0,811.0
0.004,6,10,2000,5,927,1.0,659.0,659.0,5,1073,1.0,805.0,805.0
0.015,6,10,1990,5,911,3.0,643.0,643.0,5,1079,3.0,811.0,811.0
40.06,17,10,676,5,460,10014.0,104.0,64.0,5,216,10014.0,20.0,15.0
40.079,17,10,676,5,460,10018.0,104.0,64.0,5,216,10018.0,20.0,15.0
311.29,17,20,1124,10,716,34573.0,48.0,43.0,10,408,34573.0,20.0,12.0
0.006,6,10,1547,5,764,1.0,496.0,496.0,5,783,1.0,515.0,515.0
0.09,6,10,1506,5,395,18.0,127.0,127.0,5,1111,20.0,843.0,843.0
0.011,6,10,1990,5,911,2.0,643.0,643.0,5,1079,2.0,811.0,811.0
0.001,17,2,166,1,75,0.0,47.0,47.0,1,91,0.0,63.0,63.0
300.362,6,16,2170,9,684,37524.0,146.0,146.0,7,1486,50026.0,419.0,398.0
0.023,6,10,1983,5,910,5.0,642.0,642.0,5,1073,5.0,805.0,805.0
0.001,17,2,136,1,60,0.0,32.0,32.0,1,76,0.0,48.0,48.0
0.006,6,10,1547,5,764,1.0,496.0,496.0,5,783,1.0,515.0,515.0
0.001,17,2,179,1,62,0.0,34.0,34.0,1,117,0.0,89.0,89.0
0.044,17,2,132,1,58,0.0,30.0,30.0,1,74,0.0,46.0,46.0
0.014,6,10,1972,5,910,3.0,642.0,642.0,5,1062,3.0,794.0,794.0
10.722,17,28,4422,14,1994,816.0,269.0,114.0,14,2428,816.0,587.0,145.0
0.013,6,10,1989,5,910,3.0,642.0,642.0,5,1079,3.0,811.0,811.0
300.389,6,16,2170,9,684,37526.0,146.0,146.0,7,1486,50035.0,419.0,398.0
0.004,6,10,2006,5,927,1.0,659.0,659.0,5,1079,1.0,811.0,811.0
0.006,6,10,2006,5,927,1.0,659.0,659.0,5,1079,1.0,811.0,811.0
0.011,6,10,1989,5,910,2.0,642.0,642.0,5,1079,2.0,811.0,811.0
0.005,6,10,1989,5,927,1.0,659.0,659.0,5,1062,1.0,794.0,794.0
0.01,6,10,1989,5,910,2.0,642.0,642.0,5,1079,2.0,811.0,811.0
0.005,6,10,1643,5,860,1.0,592.0,592.0,5,783,1.0,515.0,515.0
0.133,6,10,1506,5,395,31.0,127.0,127.0,5,1111,30.0,843.0,843.0
40.052,17,10,676,5,460,10012.0,104.0,64.0,5,216,10012.0,20.0,15.0
1799.929,6,243,35755,151,25972,11999.0,302.0,302.0,92,9783,19779.0,102.0,83.0
0.003,17,2,148,1,60,0.0,32.0,32.0,1,88,0.0,60.0,60.0
0.113,6,10,1506,5,395,28.0,127.0,127.0,5,1111,26.0,843.0,843.0
0.005,6,10,2000,5,927,1.0,659.0,659.0,5,1073,1.0,805.0,805.0
0.006,17,2,170,1,65,0.0,37.0,37.0,1,105,0.0,77.0,77.0
0.009,6,10,1983,5,910,2.0,642.0,642.0,5,1073,2.0,805.0,805.0
0.014,6,10,1631,5,848,3.0,580.0,580.0,5,783,3.0,515.0,515.0
0.226,6,16,2669,8,1395,32.0,533.0,323.0,8,1274,20.0,529.0,212.0
0.004,17,4,284,2,120,0.0,32.0,32.0,2,164,1.0,60.0,54.0
0.004,6,10,1779,5,928,1.0,660.0,660.0,5,851,1.0,583.0,583.0
0.005,6,10,2006,5,927,1.0,659.0,659.0,5,1079,1.0,811.0,811.0
0.004,6,10,2007,5,928,1.0,660.0,660.0,5,1079,1.0,811.0,811.0
0.001,17,2,142,1,63,0.0,35.0,35.0,1,79,0.0,51.0,51.0
0.005,6,13,3690,7,452,0.0,80.0,80.0,6,3238,1.0,1470.0,1459.0
0.001,17,2,180,1,66,0.0,38.0,38.0,1,114,0.0,86.0,86.0
0.005,6,10,2007,5,928,1.0,660.0,660.0,5,1079,1.0,811.0,811.0
170.232,17,72,10214,36,2408,4863.0,44.0,38.0,36,7806,4863.0,239.0,188.0
0.083,6,10,1506,5,395,19.0,127.0,127.0,5,1111,19.0,843.0,843.0
0.004,6,10,1702,5,863,1.0,595.0,595.0,5,839,0.0,571.0,571.0
0.001,17,2,180,1,66,0.0,38.0,38.0,1,114,0.0,86.0,86.0
240.266,6,44,8825,22,5738,11441.0,1368.0,458.0,22,3087,11441.0,580.0,241.0
0.005,17,2,222,1,65,0.0,37.0,37.0,1,157,0.0,129.0,129.0
0.005,17,4,284,2,120,1.0,32.0,32.0,2,164,0.0,60.0,54.0
0.088,6,10,1506,5,395,18.0,127.0,127.0,5,1111,19.0,843.0,843.0
0.011,6,10,1631,5,848,2.0,580.0,580.0,5,783,2.0,515.0,515.0
0.005,6,10,2007,5,928,1.0,660.0,660.0,5,1079,1.0,811.0,811.0
0.089,6,10,1506,5,395,20.0,127.0,127.0,5,1111,19.0,843.0,843.0
40.021,17,10,676,5,460,10004.0,104.0,64.0,5,216,10004.0,20.0,15.0
0.007,17,2,194,1,59,0.0,31.0,31.0,1,135,0.0,107.0,107.0
0.005,6,10,1989,5,927,1.0,659.0,659.0,5,1062,1.0,794.0,794.0
0.069,6,10,1506,5,395,16.0,127.0,127.0,5,1111,14.0,843.0,843.0
0.112,6,10,1506,5,395,21.0,127.0,127.0,5,1111,24.0,843.0,843.0
0.012,6,10,1989,5,910,3.0,642.0,642.0,5,1079,3.0,811.0,811.0
0.004,6,10,2006,5,927,1.0,659.0,659.0,5,1079,1.0,811.0,811.0
0.007,17,2,299,1,65,0.0,37.0,37.0,1,234,0.0,206.0,206.0
0.005,6,10,2007,5,928,1.0,660.0,660.0,5,1079,1.0,811.0,811.0
0.068,17,8,3613,4,1874,22.0,1350.0,440.0,4,1739,11.0,1350.0,406.0
0.01,6,10,1990,5,911,2.0,643.0,643.0,5,1079,2.0,811.0,811.0
0.116,6,10,1506,5,395,28.0,127.0,127.0,5,1111,25.0,843.0,843.0
0.007,6,10,1972,5,910,1.0,642.0,642.0,5,1062,1.0,794.0,794.0
0.005,17,2,164,1,74,0.0,46.0,46.0,1,90,0.0,62.0,62.0
0.004,6,10,1779,5,928,1.0,660.0,660.0,5,851,1.0,583.0,583.0
0.001,17,2,166,1,75,0.0,47.0,47.0,1,91,0.0,63.0,63.0
0.012,6,10,1989,5,910,3.0,642.0,642.0,5,1079,2.0,811.0,811.0
0.106,6,10,1506,5,395,22.0,127.0,127.0,5,1111,17.0,843.0,843.0
0.126,6,10,1506,5,395,27.0,127.0,127.0,5,1111,27.0,843.0,843.0
0.015,6,10,1983,5,910,3.0,642.0,642.0,5,1073,3.0,805.0,805.0
0.008,17,2,179,1,71,0.0,43.0,43.0,1,108,0.0,80.0,80.0
0.022,6,10,1990,5,911,5.0,643.0,643.0,5,1079,5.0,811.0,811.0
0.005,17,2,179,1,71,0.0,43.0,43.0,1,108,0.0,80.0,80.0
15.181,17,39,20277,21,17033,757.0,1350.0,783.0,18,3244,891.0,1350.0,152.0
0.079,6,10,1506,5,395,17.0,127.0,127.0,5,1111,16.0,843.0,843.0
0.004,17,2,160,1,72,0.0,44.0,44.0,1,88,0.0,60.0,60.0
0.005,6,10,2007,5,928,1.0,660.0,660.0,5,1079,1.0,811.0,811.0
0.178,6,10,1506,5,395,42.0,127.0,127.0,5,1111,42.0,843.0,843.0
0.006,6,10,1547,5,764,1.0,496.0,496.0,5,783,1.0,515.0,515.0
0.009,6,10,1989,5,910,2.0,642.0,642.0,5,1079,2.0,811.0,811.0
26.054,6,36,8372,18,1901,508.0,793.0,383.0,18,6471,1525.0,2126.0,478.0
0.011,6,10,1989,5,910,2.0,642.0,642.0,5,1079,2.0,811.0,811.0
0.02,6,10,1983,5,910,5.0,642.0,642.0,5,1073,4.0,805.0,805.0
0.005,6,13,3747,7,509,0.0,137.0,137.0,6,3238,1.0,1470.0,1459.0
0.004,6,10,1702,5,863,0.0,595.0,595.0,5,839,1.0,571.0,571.0
0.001,17,2,180,1,66,0.0,38.0,38.0,1,114,0.0,86.0,86.0
0.017,6,10,1989,5,910,4.0,642.0,642.0,5,1079,4.0,811.0,811.0
0.006,6,10,1689,5,839,1.0,571.0,571.0,5,850,1.0,582.0,582.0
0.012,6,13,3735,7,497,1.0,125.0,125.0,6,3238,2.0,1470.0,1459.0
0.001,17,2,180,1,66,0.0,38.0,38.0,1,114,0.0,86.0,86.0
0.066,17,8,3613,4,1874,22.0,1350.0,440.0,4,1739,11.0,1350.0,406.0
368.465,6,22,2313,16,867,24564.0,195.0,195.0,6,1446,4639.0,419.0,398.0
0.006,17,2,154,1,69,0.0,41.0,41.0,1,85,0.0,57.0,57.0
0.011,6,10,1990,5,911,2.0,643.0,643.0,5,1079,2.0,811.0,811.0
0.071,17,2,184,1,61,0.0,33.0,33.0,1,123,0.0,95.0,95.0
0.133,6,10,1506,5,395,29.0,127.0,127.0,5,1111,25.0,843.0,843.0
0.005,17,2,140,1,62,0.0,34.0,34.0,1,78,0.0,50.0,50.0
0.07,6,10,1506,5,395,15.0,127.0,127.0,5,1111,16.0,843.0,843.0
0.004,17,4,284,2,120,0.0,32.0,32.0,2,164,0.0,60.0,54.0
0.124,17,2,234,1,61,0.0,33.0,33.0,1,173,0.0,145.0,145.0
0.113,6,10,1506,5,395,27.0,127.0,127.0,5,1111,22.0,843.0,843.0
0.008,6,10,2000,5,927,2.0,659.0,659.0,5,1073,2.0,805.0,805.0
0.006,17,2,222,1,65,0.0,37.0,37.0,1,157,0.0,129.0,129.0
0.176,6,3,453,2,321,176.0,241.0,241.0,1,132,0.0,92.0,92.0
0.013,6,10,1989,5,910,3.0,642.0,642.0,5,1079,3.0,811.0,811.0
0.082,6,10,1506,5,395,18.0,127.0,127.0,5,1111,17.0,843.0,843.0
0.01,6,10,1972,5,910,2.0,642.0,642.0,5,1062,2.0,794.0,794.0
0.028,6,10,1983,5,910,7.0,642.0,642.0,5,1073,6.0,805.0,805.0
0.098,6,10,1506,5,395,22.0,127.0,127.0,5,1111,19.0,843.0,843.0
0.004,17,2,213,1,69,0.0,41.0,41.0,1,144,0.0,116.0,116.0
0.005,6,13,3747,7,509,0.0,137.0,137.0,6,3238,0.0,1470.0,1459.0
0.004,6,10,2006,5,927,1.0,659.0,659.0,5,1079,1.0,811.0,811.0
0.004,17,4,284,2,120,0.0,32.0,32.0,2,164,0.0,60.0,54.0
0.901,6,22,5168,11,1138,77.0,267.0,115.0,11,4030,76.0,1414.0,597.0
0.037,17,2,136,1,60,0.0,32.0,32.0,1,76,0.0,48.0,48.0
0.006,6,10,1547,5,764,1.0,496.0,496.0,5,783,1.0,515.0,515.0
0.048,6,10,1506,5,395,11.0,127.0,127.0,5,1111,11.0,843.0,843.0
0.006,6,10,1643,5,860,1.0,592.0,592.0,5,783,1.0,515.0,515.0
0.005,17,2,152,1,68,0.0,40.0,40.0,1,84,0.0,56.0,56.0
0.004,6,10,1702,5,863,0.0,595.0,595.0,5,839,1.0,571.0,571.0
0.83,6,25,5555,12,1445,63.0,267.0,136.0,13,4110,58.0,1414.0,597.0
0.005,6,13,3690,7,452,0.0,80.0,80.0,6,3238,1.0,1470.0,1459.0
0.005,6,10,2006,5,927,1.0,659.0,659.0,5,1079,1.0,811.0,811.0
0.006,17,2,230,1,68,0.0,40.0,40.0,1,162,0.0,134.0,134.0
0.017,6,10,1972,5,910,4.0,642.0,642.0,5,1062,4.0,794.0,794.0
0.005,6,10,2006,5,927,1.0,659.0,659.0,5,1079,1.0,811.0,811.0
0.013,6,10,1972,5,910,3.0,642.0,642.0,5,1062,3.0,794.0,794.0
0.009,17,2,194,1,59,0.0,31.0,31.0,1,135,0.0,107.0,107.0
0.015,6,14,3787,7,497,2.0,125.0,125.0,7,3290,2.0,1448.0,972.0
0.005,17,2,179,1,71,0.0,43.0,43.0,1,108,0.0,80.0,80.0
0.006,6,10,2007,5,928,1.0,660.0,660.0,5,1079,1.0,811.0,811.0
0.015,6,10,1989,5,910,3.0,642.0,642.0,5,1079,3.0,811.0,811.0
0.004,6,10,2007,5,928,1.0,660.0,660.0,5,1079,1.0,811.0,811.0
0.109,6,10,1506,5,395,23.0,127.0,127.0,5,1111,22.0,843.0,843.0
0.079,6,10,1506,5,395,17.0,127.0,127.0,5,1111,18.0,843.0,843.0
0.122,6,10,1506,5,395,27.0,127.0,127.0,5,1111,22.0,843.0,843.0
0.006,17,2,136,1,60,0.0,32.0,32.0,1,76,0.0,48.0,48.0
0.004,17,2,136,1,60,0.0,32.0,32.0,1,76,0.0,48.0,48.0
0.059,6,10,1506,5,395,13.0,127.0,127.0,5,1111,13.0,843.0,843.0
404.117,6,24,3180,17,919,25257.0,195.0,195.0,7,2261,3864.0,775.0,492.0
40.063,17,10,676,5,460,10012.0,104.0,64.0,5,216,10015.0,20.0,15.0
0.075,6,10,1506,5,395,17.0,127.0,127.0,5,1111,16.0,843.0,843.0
0.016,6,10,1762,5,911,3.0,643.0,643.0,5,851,4.0,583.0,583.0
0.005,6,10,1779,5,928,1.0,660.0,660.0,5,851,1.0,583.0,583.0
0.011,6,10,1989,5,910,2.0,642.0,642.0,5,1079,2.0,811.0,811.0
0.004,6,10,2007,5,928,1.0,660.0,660.0,5,1079,1.0,811.0,811.0
0.005,17,2,136,1,60,0.0,32.0,32.0,1,76,0.0,48.0,48.0
0.17,6,3,453,2,321,170.0,241.0,241.0,1,132,0.0,92.0,92.0
0.06,17,2,179,1,71,0.0,43.0,43.0,1,108,0.0,80.0,80.0
0.077,17,8,3613,4,1874,25.0,1350.0,440.0,4,1739,10.0,1350.0,406.0
0.005,6,10,1689,5,839,1.0,571.0,571.0,5,850,1.0,582.0,582.0
0.004,6,10,1702,5,863,1.0,595.0,595.0,5,839,1.0,571.0,571.0
0.004,6,10,2006,5,927,1.0,659.0,659.0,5,1079,1.0,811.0,811.0
0.069,6,10,1506,5,395,14.0,127.0,127.0,5,1111,13.0,843.0,843.0
40.073,17,10,676,5,460,10017.0,104.0,64.0,5,216,10015.0,20.0,15.0
308.269,17,20,1124,10,716,34237.0,48.0,43.0,10,408,34237.0,20.0,12.0
0.011,6,10,1990,5,911,2.0,643.0,643.0,5,1079,2.0,811.0,811.0
0.111,6,10,1506,5,395,24.0,127.0,127.0,5,1111,23.0,843.0,843.0
0.004,17,2,136,1,60,0.0,32.0,32.0,1,76,0.0,48.0,48.0
0.004,6,10,2007,5,928,1.0,660.0,660.0,5,1079,1.0,811.0,811.0
0.098,6,10,1506,5,395,21.0,127.0,127.0,5,1111,22.0,843.0,843.0
0.069,6,10,1506,5,395,14.0,127.0,127.0,5,1111,15.0,843.0,843.0
0.078,6,10,1506,5,395,17.0,127.0,127.0,5,1111,17.0,843.0,843.0
0.062,6,10,1506,5,395,12.0,127.0,127.0,5,1111,14.0,843.0,843.0
0.006,6,10,1547,5,764,1.0,496.0,496.0,5,783,1.0,515.0,515.0
0.013,6,10,1762,5,911,3.0,643.0,643.0,5,851,3.0,583.0,583.0
0.01,6,10,1990,5,911,2.0,643.0,643.0,5,1079,2.0,811.0,811.0
0.015,6,10,1677,5,827,3.0,559.0,559.0,5,850,3.0,582.0,582.0
0.015,6,10,1972,5,910,3.0,642.0,642.0,5,1062,3.0,794.0,794.0
0.037,6,10,1990,5,911,9.0,643.0,643.0,5,1079,9.0,811.0,811.0
0.005,6,10,1547,5,764,1.0,496.0,496.0,5,783,1.0,515.0,515.0
178.138,17,96,13647,48,3227,3790.0,44.0,39.0,48,10420,3790.0,261.0,189.0
367.037,6,22,2313,16,867,24469.0,195.0,195.0,6,1446,4666.0,419.0,398.0
0.005,6,10,1689,5,839,1.0,571.0,571.0,5,850,1.0,582.0,582.0
40.054,17,10,676,5,460,10011.0,104.0,64.0,5,216,10012.0,20.0,15.0
0.117,6,10,1506,5,395,26.0,127.0,127.0,5,1111,23.0,843.0,843.0
0.01,6,10,1631,5,848,2.0,580.0,580.0,5,783,2.0,515.0,515.0
0.012,6,10,1989,5,910,2.0,642.0,642.0,5,1079,3.0,811.0,811.0
1789.393,6,277,25758,139,9081,12966.0,747.0,263.0,138,16677,13061.0,1625.0,71.0
0.08,17,2,144,1,64,0.0,36.0,36.0,1,80,0.0,52.0,52.0
0.006,6,10,1547,5,764,1.0,496.0,496.0,5,783,1.0,515.0,515.0
0.17,17,2,152,1,76,0.0,48.0,48.0,1,76,0.0,48.0,48.0
0.012,6,10,1972,5,910,3.0,642.0,642.0,5,1062,3.0,794.0,794.0
0.008,6,10,1990,5,911,2.0,643.0,643.0,5,1079,2.0,811.0,811.0
0.005,17,2,166,1,75,0.0,47.0,47.0,1,91,0.0,63.0,63.0
0.003,17,2,148,1,60,0.0,32.0,32.0,1,88,0.0,60.0,60.0
0.004,6,10,1989,5,927,1.0,659.0,659.0,5,1062,1.0,794.0,794.0
0.004,6,10,1702,5,863,1.0,595.0,595.0,5,839,0.0,571.0,571.0
0.005,6,10,1989,5,927,1.0,659.0,659.0,5,1062,1.0,794.0,794.0
0.005,6,10,2006,5,927,1.0,659.0,659.0,5,1079,1.0,811.0,811.0
0.169,6,10,1506,5,395,40.0,127.0,127.0,5,1111,39.0,843.0,843.0
0.031,6,10,1989,5,910,7.0,642.0,642.0,5,1079,7.0,811.0,811.0
0.018,6,10,1774,5,923,4.0,655.0,655.0,5,851,4.0,583.0,583.0
0.01,6,12,1926,6,1189,2.0,659.0,434.0,6,737,1.0,417.0,417.0
0.08,6,10,1506,5,395,19.0,127.0,127.0,5,1111,18.0,843.0,843.0
0.015,6,10,1990,5,911,3.0,643.0,643.0,5,1079,3.0,811.0,811.0
0.005,6,10,1779,5,928,1.0,660.0,660.0,5,851,1.0,583.0,583.0
0.006,17,2,170,1,65,0.0,37.0,37.0,1,105,0.0,77.0,77.0
0.178,17,2,148,1,66,0.0,38.0,38.0,1,82,0.0,54.0,54.0
0.014,6,13,3735,7,497,2.0,125.0,125.0,6,3238,2.0,1470.0,1459.0
0.005,6,13,3747,7,509,0.0,137.0,137.0,6,3238,1.0,1470.0,1459.0
0.045,6,10,1989,5,910,11.0,642.0,642.0,5,1079,11.0,811.0,811.0
0.005,6,10,2006,5,927,1.0,659.0,659.0,5,1079,1.0,811.0,811.0
40.067,17,10,676,5,460,10013.0,104.0,64.0,5,216,10016.0,20.0,15.0
0.004,6,10,1779,5,928,1.0,660.0,660.0,5,851,0.0,583.0,583.0
173.133,17,78,11037,39,2601,4556.0,44.0,38.0,39,8436,4556.0,239.0,188.0
0.168,17,2,152,1,76,0.0,48.0,48.0,1,76,0.0,48.0,48.0
0.005,6,10,1989,5,927,1.0,659.0,659.0,5,1062,1.0,794.0,794.0
1770.651,6,87,4626,43,2288,42156.0,26.0,26.0,44,2338,41176.0,26.0,25.0
0.009,6,10,1990,5,911,2.0,643.0,643.0,5,1079,2.0,811.0,811.0
0.005,6,10,1779,5,928,1.0,660.0,660.0,5,851,1.0,583.0,583.0
174.308,17,74,10573,37,2468,4841.0,44.0,38.0,37,8105,4841.0,261.0,191.0
40.055,17,10,676,5,460,10012.0,104.0,64.0,5,216,10013.0,20.0,15.0
15.122,17,19,13436,9,8280,1886.0,1350.0,892.0,10,5156,1677.0,1350.0,487.0
0.005,6,10,1989,5,927,1.0,659.0,659.0,5,1062,1.0,794.0,794.0
0.005,6,10,2006,5,927,1.0,659.0,659.0,5,1079,1.0,811.0,811.0
40.069,17,10,676,5,460,10014.0,104.0,64.0,5,216,10016.0,20.0,15.0
0.005,6,10,2006,5,927,1.0,659.0,659.0,5,1079,1.0,811.0,811.0
40.062,17,10,676,5,460,10014.0,104.0,64.0,5,216,10013.0,20.0,15.0
0.007,17,2,202,1,69,0.0,41.0,41.0,1,133,0.0,105.0,105.0
0.099,6,10,1506,5,395,20.0,127.0,127.0,5,1111,19.0,843.0,843.0
0.016,6,10,1972,5,910,3.0,642.0,642.0,5,1062,4.0,794.0,794.0
40.057,17,10,676,5,460,10013.0,104.0,64.0,5,216,10013.0,20.0,15.0
0.011,6,10,1677,5,827,2.0,559.0,559.0,5,850,2.0,582.0,582.0
0.036,17,2,148,1,60,0.0,32.0,32.0,1,88,0.0,60.0,60.0
0.005,6,10,2006,5,927,1.0,659.0,659.0,5,1079,1.0,811.0,811.0
0.005,17,2,179,1,71,0.0,43.0,43.0,1,108,0.0,80.0,80.0
0.225,6,16,2777,8,1395,32.0,533.0,323.0,8,1382,21.0,529.0,239.0
55.949,6,38,11028,19,5470,490.0,2720.0,935.0,19,5558,3098.0,2667.0,435.0
300.509,6,27,7436,16,1409,20033.0,217.0,142.0,11,6027,24047.0,1679.0,778.0
0.009,6,12,1926,6,1189,1.0,659.0,434.0,6,737,1.0,417.0,417.0
0.063,17,4,284,2,120,0.0,32.0,32.0,2,164,44.0,60.0,54.0
0.078,6,10,1506,5,395,18.0,127.0,127.0,5,1111,17.0,843.0,843.0
0.123,6,10,1506,5,395,28.0,127.0,127.0,5,1111,29.0,843.0,843.0
0.129,17,2,80,1,32,0.0,4.0,4.0,1,48,0.0,20.0,20.0
0.012,6,10,1972,5,910,3.0,642.0,642.0,5,1062,3.0,794.0,794.0
0.009,6,10,1989,5,910,2.0,642.0,642.0,5,1079,2.0,811.0,811.0
0.124,6,10,1506,5,395,27.0,127.0,127.0,5,1111,25.0,843.0,843.0
0.004,17,2,152,1,76,0.0,48.0,48.0,1,76,0.0,48.0,48.0
0.023,6,10,1990,5,911,5.0,643.0,643.0,5,1079,5.0,811.0,811.0
0.155,6,10,1506,5,395,30.0,127.0,127.0,5,1111,37.0,843.0,843.0
0.006,6,10,1547,5,764,1.0,496.0,496.0,5,783,1.0,515.0,515.0
0.006,6,13,3747,7,509,0.0,137.0,137.0,6,3238,1.0,1470.0,1459.0
0.006,6,10,2000,5,927,1.0,659.0,659.0,5,1073,1.0,805.0,805.0
0.023,6,10,1762,5,911,5.0,643.0,643.0,5,851,5.0,583.0,583.0
0.095,6,10,1506,5,395,20.0,127.0,127.0,5,1111,22.0,843.0,843.0
0.112,6,10,1506,5,395,25.0,127.0,127.0,5,1111,22.0,843.0,843.0
0.13,17,2,80,1,32,0.0,4.0,4.0,1,48,0.0,20.0,20.0
0.009,6,12,1926,6,1189,1.0,659.0,434.0,6,737,1.0,417.0,417.0
0.008,6,10,1989,5,910,2.0,642.0,642.0,5,1079,2.0,811.0,811.0
40.063,17,10,676,5,460,10015.0,104.0,64.0,5,216,10014.0,20.0,15.0
0.005,6,10,2006,5,927,1.0,659.0,659.0,5,1079,1.0,811.0,811.0
0.001,17,2,136,1,60,0.0,32.0,32.0,1,76,0.0,48.0,48.0
15.084,17,16,8226,8,6060,2150.0,1350.0,729.0,8,2166,2150.0,1350.0,242.0
0.074,6,10,1506,5,395,16.0,127.0,127.0,5,1111,15.0,843.0,843.0
0.223,17,14,8577,7,4012,37.0,1350.0,545.0,7,4565,27.0,1350.0,624.0
0.001,17,2,180,1,66,0.0,38.0,38.0,1,114,0.0,86.0,86.0
0.036,6,10,1983,5,910,9.0,642.0,642.0,5,1073,8.0,805.0,805.0
0.001,17,2,136,1,60,0.0,32.0,32.0,1,76,0.0,48.0,48.0
0.073,6,10,1506,5,395,16.0,127.0,127.0,5,1111,14.0,843.0,843.0
0.005,6,13,3684,7,446,0.0,74.0,74.0,6,3238,1.0,1470.0,1459.0
0.004,17,2,136,1,60,0.0,32.0,32.0,1,76,0.0,48.0,48.0
0.005,17,2,225,1,65,0.0,37.0,37.0,1,160,0.0,132.0,132.0
0.085,6,10,1506,5,395,18.0,127.0,127.0,5,1111,18.0,843.0,843.0
0.128,6,10,1506,5,395,28.0,127.0,127.0,5,1111,30.0,843.0,843.0
0.005,6,10,1689,5,839,1.0,571.0,571.0,5,850,1.0,582.0,582.0
0.004,17,2,148,1,60,0.0,32.0,32.0,1,88,0.0,60.0,60.0
0.01,6,10,1990,5,911,2.0,643.0,643.0,5,1079,2.0,811.0,811.0
0.006,6,10,1854,5,889,1.0,621.0,621.0,5,965,1.0,697.0,697.0
0.007,17,2,299,1,65,0.0,37.0,37.0,1,234,0.0,206.0,206.0
0.01,6,10,1990,5,911,2.0,643.0,643.0,5,1079,2.0,811.0,811.0
0.005,17,2,136,1,60,0.0,32.0,32.0,1,76,0.0,48.0,48.0
0.072,17,2,144,1,64,0.0,36.0,36.0,1,80,0.0,52.0,52.0
0.006,6,10,2006,5,927,1.0,659.0,659.0,5,1079,1.0,811.0,811.0
0.116,6,10,1506,5,395,24.0,127.0,127.0,5,1111,25.0,843.0,843.0
0.011,6,10,1972,5,910,2.0,642.0,642.0,5,1062,2.0,794.0,794.0
0.004,17,2,136,1,60,0.0,32.0,32.0,1,76,0.0,48.0,48.0
0.11,6,10,1506,5,395,26.0,127.0,127.0,5,1111,24.0,843.0,843.0
294.405,6,412,349260,203,22121,1457.0,2736.0,825.0,209,327139,1415.0,4206.0,1621.0
0.103,6,10,1506,5,395,24.0,127.0,127.0,5,1111,21.0,843.0,843.0
0.011,6,10,1762,5,911,2.0,643.0,643.0,5,851,2.0,583.0,583.0
40.056,17,10,676,5,460,10013.0,104.0,64.0,5,216,10013.0,20.0,15.0
0.017,6,10,1989,5,910,4.0,642.0,642.0,5,1079,4.0,811.0,811.0
0.08,6,10,1506,5,395,19.0,127.0,127.0,5,1111,16.0,843.0,843.0
0.02,6,10,1989,5,910,5.0,642.0,642.0,5,1079,5.0,811.0,811.0
0.006,17,2,180,1,66,0.0,38.0,38.0,1,114,0.0,86.0,86.0
0.004,6,10,2000,5,927,1.0,659.0,659.0,5,1073,1.0,805.0,805.0
0.004,6,10,1774,5,923,1.0,655.0,655.0,5,851,1.0,583.0,583.0
40.063,17,10,676,5,460,10014.0,104.0,64.0,5,216,10015.0,20.0,15.0
0.001,17,2,180,1,66,0.0,38.0,38.0,1,114,0.0,86.0,86.0
0.007,17,2,164,1,74,0.0,46.0,46.0,1,90,0.0,62.0,62.0
0.007,6,10,2006,5,927,1.0,659.0,659.0,5,1079,1.0,811.0,811.0
0.099,6,10,1506,5,395,21.0,127.0,127.0,5,1111,22.0,843.0,843.0
0.087,6,10,1506,5,395,19.0,127.0,127.0,5,1111,17.0,843.0,843.0
15.07,17,15,9238,8,6902,2148.0,1350.0,834.0,7,2336,2506.0,1350.0,305.0
0.016,6,10,1989,5,910,4.0,642.0,642.0,5,1079,4.0,811.0,811.0
0.006,17,2,144,1,64,0.0,36.0,36.0,1,80,0.0,52.0,52.0
0.011,17,2,169,1,62,0.0,34.0,34.0,1,107,0.0,79.0,79.0
0.038,17,2,182,1,65,0.0,37.0,37.0,1,117,0.0,89.0,89.0
0.103,6,10,1506,5,395,23.0,127.0,127.0,5,1111,23.0,843.0,843.0
0.071,6,10,1506,5,395,14.0,127.0,127.0,5,1111,16.0,843.0,843.0
240.122,6,31,8154,15,5774,17151.0,1515.0,554.0,16,2380,16007.0,580.0,192.0
0.008,6,10,1989,5,910,2.0,642.0,642.0,5,1079,1.0,811.0,811.0
0.004,6,10,1989,5,927,1.0,659.0,659.0,5,1062,1.0,794.0,794.0
0.012,6,10,1990,5,911,2.0,643.0,643.0,5,1079,3.0,811.0,811.0
0.005,17,2,166,1,75,0.0,47.0,47.0,1,91,0.0,63.0,63.0
0.005,6,10,2000,5,927,1.0,659.0,659.0,5,1073,1.0,805.0,805.0
0.221,17,4,352,2,130,182.0,37.0,37.0,2,222,148.0,89.0,83.0
0.009,6,10,1989,5,910,2.0,642.0,642.0,5,1079,2.0,811.0,811.0
0.01,17,2,152,1,76,0.0,48.0,48.0,1,76,0.0,48.0,48.0
0.072,17,4,420,2,122,0.0,33.0,33.0,2,298,62.0,145.0,121.0
240.511,6,47,6478,24,3242,10456.0,588.0,245.0,23,3236,10932.0,580.0,224.0
0.04,17,2,152,1,76,0.0,48.0,48.0,1,76,0.0,48.0,48.0
40.056,17,10,676,5,460,10012.0,104.0,64.0,5,216,10013.0,20.0,15.0
0.072,6,10,1506,5,395,16.0,127.0,127.0,5,1111,14.0,843.0,843.0
0.095,6,10,1506,5,395,19.0,127.0,127.0,5,1111,23.0,843.0,843.0
40.068,17,10,676,5,460,10015.0,104.0,64.0,5,216,10015.0,20.0,15.0
0.044,17,2,412,1,61,0.0,33.0,33.0,1,351,0.0,323.0,323.0
0.011,6,10,1990,5,911,2.0,643.0,643.0,5,1079,2.0,811.0,811.0
0.013,6,13,3735,7,497,2.0,125.0,125.0,6,3238,2.0,1470.0,1459.0
0.012,6,10,1990,5,911,3.0,643.0,643.0,5,1079,3.0,811.0,811.0
0.002,17,2,180,1,66,0.0,38.0,38.0,1,114,0.0,86.0,86.0
0.013,6,10,1972,5,910,3.0,642.0,642.0,5,1062,3.0,794.0,794.0
0.012,6,10,1989,5,910,3.0,642.0,642.0,5,1079,2.0,811.0,811.0
0.005,6,10,1779,5,928,1.0,660.0,660.0,5,851,1.0,583.0,583.0
0.074,6,10,1506,5,395,16.0,127.0,127.0,5,1111,13.0,843.0,843.0
0.002,17,2,180,1,66,0.0,38.0,38.0,1,114,0.0,86.0,86.0
0.01,6,10,1990,5,911,2.0,643.0,643.0,5,1079,2.0,811.0,811.0
0.001,17,2,180,1,66,0.0,38.0,38.0,1,114,0.0,86.0,86.0
40.082,17,10,676,5,460,10019.0,104.0,64.0,5,216,10013.0,20.0,15.0
0.005,17,2,148,1,60,0.0,32.0,32.0,1,88,0.0,60.0,60.0
0.007,6,10,1689,5,839,1.0,571.0,571.0,5,850,1.0,582.0,582.0
0.009,6,10,1990,5,911,2.0,643.0,643.0,5,1079,2.0,811.0,811.0
0.346,17,49,30803,29,27590,12.0,1350.0,923.0,20,3213,14.0,1350.0,132.0
0.079,6,10,1506,5,395,17.0,127.0,127.0,5,1111,15.0,843.0,843.0
0.169,17,2,152,1,76,0.0,48.0,48.0,1,76,0.0,48.0,48.0
0.005,17,2,179,1,71,0.0,43.0,43.0,1,108,0.0,80.0,80.0
0.006,6,10,1854,5,889,1.0,621.0,621.0,5,965,1.0,697.0,697.0
0.004,6,10,1702,5,863,1.0,595.0,595.0,5,839,0.0,571.0,571.0
0.007,17,2,230,1,68,0.0,40.0,40.0,1,162,0.0,134.0,134.0
11.058,17,28,4418,14,1994,842.0,269.0,114.0,14,2424,842.0,587.0,145.0
0.057,17,2,144,1,64,0.0,36.0,36.0,1,80,0.0,52.0,52.0
0.002,17,2,136,1,60,0.0,32.0,32.0,1,76,0.0,48.0,48.0
0.019,6,10,1990,5,911,4.0,643.0,643.0,5,1079,4.0,811.0,811.0
0.01,6,10,1983,5,910,2.0,642.0,642.0,5,1073,2.0,805.0,805.0
0.122,6,10,1506,5,395,29.0,127.0,127.0,5,1111,28.0,843.0,843.0
240.118,6,31,9384,15,6920,17151.0,2043.0,682.0,16,2464,16007.0,580.0,203.0
0.068,6,10,1506,5,395,14.0,127.0,127.0,5,1111,14.0,843.0,843.0
0.005,6,10,1989,5,927,1.0,659.0,659.0,5,1062,1.0,794.0,794.0
0.126,6,10,1506,5,395,28.0,127.0,127.0,5,1111,29.0,843.0,843.0
0.004,6,10,2007,5,928,1.0,660.0,660.0,5,1079,1.0,811.0,811.0
1777.726,17,144,45504,72,22752,25038.0,288.0,288.0,72,22752,25038.0,288.0,288.0
0.004,17,4,284,2,120,0.0,32.0,32.0,2,164,0.0,60.0,54.0
0.005,6,10,2000,5,927,1.0,659.0,659.0,5,1073,1.0,805.0,805.0
0.004,6,10,1779,5,928,1.0,660.0,660.0,5,851,1.0,583.0,583.0
0.072,6,10,1506,5,395,17.0,127.0,127.0,5,1111,16.0,843.0,843.0
0.066,6,10,1506,5,395,14.0,127.0,127.0,5,1111,14.0,843.0,843.0
0.003,17,2,148,1,60,0.0,32.0,32.0,1,88,0.0,60.0,60.0
0.003,17,2,136,1,60,0.0,32.0,32.0,1,76,0.0,48.0,48.0
0.015,6,10,1989,5,910,3.0,642.0,642.0,5,1079,3.0,811.0,811.0
40.074,17,10,676,5,460,10017.0,104.0,64.0,5,216,10017.0,20.0,15.0
178.081,17,84,11820,42,2816,4343.0,44.0,39.0,42,9004,4343.0,261.0,186.0
0.065,6,10,1506,5,395,15.0,127.0,127.0,5,1111,12.0,843.0,843.0
0.094,6,10,1506,5,395,21.0,127.0,127.0,5,1111,22.0,843.0,843.0
0.004,17,2,136,1,60,0.0,32.0,32.0,1,76,0.0,48.0,48.0
354.028,6,21,1795,16,1030,23601.0,190.0,190.0,5,765,60003.0,464.0,248.0
15.073,17,14,9190,8,6902,2149.0,1350.0,834.0,6,2288,3008.0,1350.0,353.0
0.009,6,10,1989,5,910,2.0,642.0,642.0,5,1079,2.0,811.0,811.0
0.005,6,10,1689,5,839,1.0,571.0,571.0,5,850,1.0,582.0,582.0
280.548,6,23,6075,10,1186,31171.0,267.0,156.0,13,4889,23378.0,1400.0,873.0
0.005,6,10,2000,5,927,1.0,659.0,659.0,5,1073,1.0,805.0,805.0
40.072,17,10,676,5,460,10014.0,104.0,64.0,5,216,10017.0,20.0,15.0
61.528,6,27,19856,15,11919,4394.0,2804.0,1591.0,12,7937,5581.0,2308.0,1217.0
40.062,17,10,676,5,460,10014.0,104.0,64.0,5,216,10014.0,20.0,15.0
0.004,17,2,148,1,60,0.0,32.0,32.0,1,88,0.0,60.0,60.0
0.016,6,10,1972,5,910,4.0,642.0,642.0,5,1062,4.0,794.0,794.0
0.013,6,10,1983,5,910,3.0,642.0,642.0,5,1073,3.0,805.0,805.0
0.005,6,13,3747,7,509,0.0,137.0,137.0,6,3238,1.0,1470.0,1459.0
0.001,17,2,180,1,66,0.0,38.0,38.0,1,114,0.0,86.0,86.0
0.005,17,2,170,1,65,0.0,37.0,37.0,1,105,0.0,77.0,77.0
0.169,17,2,152,1,76,0.0,48.0,48.0,1,76,0.0,48.0,48.0
0.014,6,10,1972,5,910,3.0,642.0,642.0,5,1062,3.0,794.0,794.0
0.072,17,4,596,2,122,1.0,33.0,33.0,2,474,33.0,323.0,209.0
0.004,6,10,2007,5,928,1.0,660.0,660.0,5,1079,1.0,811.0,811.0
36.487,6,38,11103,19,5545,490.0,2720.0,950.0,19,5558,2017.0,2667.0,435.0
0.004,6,10,2006,5,927,1.0,659.0,659.0,5,1079,1.0,811.0,811.0
0.095,6,10,1506,5,395,21.0,127.0,127.0,5,1111,19.0,843.0,843.0
0.004,6,10,1779,5,928,1.0,660.0,660.0,5,851,1.0,583.0,583.0
0.004,17,4,284,2,120,0.0,32.0,32.0,2,164,0.0,60.0,54.0
0.004,6,10,2007,5,928,1.0,660.0,660.0,5,1079,1.0,811.0,811.0
0.005,6,10,1779,5,928,1.0,660.0,660.0,5,851,1.0,583.0,583.0
0.02,6,10,1990,5,911,4.0,643.0,643.0,5,1079,5.0,811.0,811.0
0.005,6,10,1989,5,927,1.0,659.0,659.0,5,1062,1.0,794.0,794.0
0.07,6,10,1506,5,395,17.0,127.0,127.0,5,1111,16.0,843.0,843.0
0.001,17,2,180,1,66,0.0,38.0,38.0,1,114,0.0,86.0,86.0
0.005,6,10,1989,5,927,1.0,659.0,659.0,5,1062,1.0,794.0,794.0
0.004,6,10,2006,5,927,1.0,659.0,659.0,5,1079,1.0,811.0,811.0
0.003,17,2,136,1,60,0.0,32.0,32.0,1,76,0.0,48.0,48.0
0.006,6,10,1547,5,764,1.0,496.0,496.0,5,783,1.0,515.0,515.0
0.005,6,10,1689,5,839,1.0,571.0,571.0,5,850,1.0,582.0,582.0
11.495,17,28,4394,14,2312,871.0,587.0,137.0,14,2082,871.0,269.0,120.0
0.007,6,10,2000,5,927,1.0,659.0,659.0,5,1073,1.0,805.0,805.0
40.868,17,26,14947,14,12082,3141.0,1350.0,835.0,12,2865,3712.0,1350.0,210.0
0.001,17,2,180,1,66,0.0,38.0,38.0,1,114,0.0,86.0,86.0
15.072,17,15,9238,8,6902,2149.0,1350.0,834.0,7,2336,2507.0,1350.0,305.0
0.083,6,10,1506,5,395,18.0,127.0,127.0,5,1111,20.0,843.0,843.0
0.127,17,2,234,1,61,0.0,33.0,33.0,1,173,0.0,145.0,145.0
0.044,17,2,152,1,76,0.0,48.0,48.0,1,76,0.0,48.0,48.0
0.005,6,10,1989,5,927,1.0,659.0,659.0,5,1062,1.0,794.0,794.0
178.131,17,92,13406,46,3092,3958.0,44.0,39.0,46,10314,3958.0,261.0,196.0
0.007,6,11,2041,6,962,1.0,642.0,642.0,5,1079,1.0,811.0,811.0
0.005,17,2,225,1,65,0.0,37.0,37.0,1,160,0.0,132.0,132.0
0.013,17,2,152,1,56,0.0,28.0,28.0,1,96,0.0,68.0,68.0
0.01,6,10,1990,5,911,2.0,643.0,643.0,5,1079,2.0,811.0,811.0
0.005,6,10,1547,5,764,1.0,496.0,496.0,5,783,1.0,515.0,515.0
0.007,17,2,293,1,73,0.0,45.0,45.0,1,220,0.0,192.0,192.0
0.009,6,10,1990,5,911,2.0,643.0,643.0,5,1079,2.0,811.0,811.0
0.009,6,12,1926,6,1189,1.0,659.0,434.0,6,737,1.0,417.0,417.0
0.012,6,10,1990,5,911,3.0,643.0,643.0,5,1079,3.0,811.0,811.0
0.004,6,10,2000,5,927,1.0,659.0,659.0,5,1073,1.0,805.0,805.0
0.006,6,10,1547,5,764,1.0,496.0,496.0,5,783,1.0,515.0,515.0
0.005,6,10,1689,5,839,1.0,571.0,571.0,5,850,1.0,582.0,582.0
0.128,6,10,1506,5,395,30.0,127.0,127.0,5,1111,30.0,843.0,843.0
0.005,6,10,2007,5,928,1.0,660.0,660.0,5,1079,1.0,811.0,811.0
0.005,6,10,1643,5,860,1.0,592.0,592.0,5,783,1.0,515.0,515.0
0.009,6,10,1989,5,910,2.0,642.0,642.0,5,1079,2.0,811.0,811.0
0.005,6,10,1689,5,839,1.0,571.0,571.0,5,850,1.0,582.0,582.0
1778.097,17,143,41496,72,22752,25043.0,288.0,288.0,71,18744,25401.0,236.0,236.0
0.009,6,10,1983,5,910,2.0,642.0,642.0,5,1073,2.0,805.0,805.0
0.005,6,10,1989,5,927,1.0,659.0,659.0,5,1062,1.0,794.0,794.0
0.017,6,10,1989,5,910,4.0,642.0,642.0,5,1079,4.0,811.0,811.0
1777.711,17,142,44872,72,22752,25034.0,288.0,288.0,70,22120,25757.0,288.0,288.0
0.04,17,4,336,2,124,0.0,34.0,34.0,2,212,2.0,84.0,78.0
10.926,17,28,4417,14,1994,832.0,269.0,114.0,14,2423,832.0,586.0,145.0
0.012,6,10,1983,5,910,2.0,642.0,642.0,5,1073,2.0,805.0,805.0
0.018,6,10,1990,5,911,4.0,643.0,643.0,5,1079,4.0,811.0,811.0
0.005,6,10,1779,5,928,1.0,660.0,660.0,5,851,1.0,583.0,583.0
0.003,17,2,152,1,76,0.0,48.0,48.0,1,76,0.0,48.0,48.0
0.01,6,10,1989,5,910,2.0,642.0,642.0,5,1079,2.0,811.0,811.0
0.001,17,2,180,1,66,0.0,38.0,38.0,1,114,0.0,86.0,86.0
0.072,6,10,1506,5,395,14.0,127.0,127.0,5,1111,17.0,843.0,843.0
0.006,6,10,1547,5,764,1.0,496.0,496.0,5,783,1.0,515.0,515.0
0.006,17,2,179,1,71,0.0,43.0,43.0,1,108,0.0,80.0,80.0
0.072,17,4,284,2,120,1.0,32.0,32.0,2,164,68.0,60.0,54.0
0.015,6,10,1989,5,910,3.0,642.0,642.0,5,1079,3.0,811.0,811.0
0.006,6,10,1547,5,764,1.0,496.0,496.0,5,783,1.0,515.0,515.0
0.079,6,10,1506,5,395,16.0,127.0,127.0,5,1111,17.0,843.0,843.0
0.012,6,10,1972,5,910,3.0,642.0,642.0,5,1062,3.0,794.0,794.0
0.003,17,2,136,1,60,0.0,32.0,32.0,1,76,0.0,48.0,48.0
0.017,6,10,1989,5,910,4.0,642.0,642.0,5,1079,4.0,811.0,811.0
0.003,17,2,148,1,60,0.0,32.0,32.0,1,88,0.0,60.0,60.0
0.216,6,16,2669,8,1395,30.0,533.0,323.0,8,1274,20.0,529.0,212.0
0.024,6,10,1983,5,910,6.0,642.0,642.0,5,1073,5.0,805.0,805.0
0.015,6,10,1762,5,911,3.0,643.0,643.0,5,851,3.0,583.0,583.0
40.075,17,10,676,5,460,10015.0,104.0,64.0,5,216,10017.0,20.0,15.0
0.011,6,10,1990,5,911,2.0,643.0,643.0,5,1079,2.0,811.0,811.0
0.126,17,4,284,2,120,0.0,32.0,32.0,2,164,123.0,60.0,54.0
0.005,17,2,140,1,62,0.0,34.0,34.0,1,78,0.0,50.0,50.0
0.011,6,10,1631,5,848,2.0,580.0,580.0,5,783,2.0,515.0,515.0
0.017,6,10,1972,5,910,4.0,642.0,642.0,5,1062,4.0,794.0,794.0
0.093,6,10,1506,5,395,19.0,127.0,127.0,5,1111,16.0,843.0,843.0
0.041,17,4,284,2,120,0.0,32.0,32.0,2,164,38.0,60.0,54.0
0.004,17,4,284,2,120,0.0,32.0,32.0,2,164,1.0,60.0,54.0
0.004,6,10,1702,5,863,1.0,595.0,595.0,5,839,0.0,571.0,571.0
0.062,6,10,1506,5,395,14.0,127.0,127.0,5,1111,13.0,843.0,843.0
0.004,6,14,3742,7,452,0.0,80.0,80.0,7,3290,0.0,1448.0,972.0
243.82,6,13,1378,4,506,64.0,290.0,290.0,9,872,30477.0,396.0,396.0
0.007,6,10,1547,5,764,1.0,496.0,496.0,5,783,1.0,515.0,515.0
0.082,6,10,1506,5,395,18.0,127.0,127.0,5,1111,17.0,843.0,843.0
0.004,6,10,2007,5,928,1.0,660.0,660.0,5,1079,1.0,811.0,811.0
0.012,6,10,1990,5,911,3.0,643.0,643.0,5,1079,3.0,811.0,811.0
0.116,6,10,1506,5,395,27.0,127.0,127.0,5,1111,25.0,843.0,843.0
0.079,6,10,1506,5,395,19.0,127.0,127.0,5,1111,18.0,843.0,843.0
0.174,6,10,1506,5,395,38.0,127.0,127.0,5,1111,42.0,843.0,843.0
0.006,6,10,1774,5,923,1.0,655.0,655.0,5,851,1.0,583.0,583.0
0.005,17,2,247,1,72,0.0,44.0,44.0,1,175,0.0,147.0,147.0
0.008,6,10,1990,5,911,2.0,643.0,643.0,5,1079,1.0,811.0,811.0
0.003,17,2,148,1,60,0.0,32.0,32.0,1,88,0.0,60.0,60.0
10.914,17,28,4393,14,1993,831.0,268.0,114.0,14,2400,831.0,587.0,143.0
0.005,6,10,2006,5,927,1.0,659.0,659.0,5,1079,1.0,811.0,811.0
178.072,17,72,10222,36,2409,5087.0,44.0,38.0,36,7813,5087.0,261.0,189.0
0.099,6,10,1506,5,395,19.0,127.0,127.0,5,1111,21.0,843.0,843.0
11.144,17,28,4420,14,1993,844.0,268.0,114.0,14,2427,844.0,586.0,145.0
0.068,6,10,1506,5,395,16.0,127.0,127.0,5,1111,15.0,843.0,843.0
0.006,6,10,1547,5,764,1.0,496.0,496.0,5,783,1.0,515.0,515.0
0.098,6,10,1506,5,395,19.0,127.0,127.0,5,1111,21.0,843.0,843.0
0.122,6,10,1506,5,395,25.0,127.0,127.0,5,1111,25.0,843.0,843.0
0.081,6,10,1506,5,395,17.0,127.0,127.0,5,1111,16.0,843.0,843.0
0.001,17,2,136,1,60,0.0,32.0,32.0,1,76,0.0,48.0,48.0
0.005,6,10,1643,5,860,1.0,592.0,592.0,5,783,1.0,515.0,515.0
308.688,17,20,1124,10,716,34286.0,48.0,43.0,10,408,34285.0,20.0,12.0
0.006,6,10,1547,5,764,1.0,496.0,496.0,5,783,1.0,515.0,515.0
0.013,6,10,1631,5,848,3.0,580.0,580.0,5,783,3.0,515.0,515.0
0.332,17,48,29451,27,24819,12.0,1350.0,891.0,21,4632,13.0,1350.0,192.0
0.005,6,10,2000,5,927,1.0,659.0,659.0,5,1073,1.0,805.0,805.0
0.001,17,2,142,1,63,0.0,35.0,35.0,1,79,0.0,51.0,51.0
0.122,6,10,1506,5,395,18.0,127.0,127.0,5,1111,29.0,843.0,843.0
0.004,17,2,148,1,60,0.0,32.0,32.0,1,88,0.0,60.0,60.0
0.142,17,4,596,2,122,102.0,33.0,33.0,2,474,104.0,323.0,209.0
0.006,6,10,1547,5,764,1.0,496.0,496.0,5,783,1.0,515.0,515.0
0.004,17,2,148,1,60,0.0,32.0,32.0,1,88,0.0,60.0,60.0
15.122,17,19,13437,9,8280,1886.0,1350.0,892.0,10,5157,1676.0,1350.0,487.0
0.001,17,2,180,1,66,0.0,38.0,38.0,1,114,0.0,86.0,86.0
0.011,6,10,1677,5,827,2.0,559.0,559.0,5,850,2.0,582.0,582.0
0.006,17,2,169,1,62,0.0,34.0,34.0,1,107,0.0,79.0,79.0
0.005,17,2,158,1,71,0.0,43.0,43.0,1,87,0.0,59.0,59.0
0.007,6,10,1972,5,910,1.0,642.0,642.0,5,1062,1.0,794.0,794.0
0.004,6,10,1989,5,927,1.0,659.0,659.0,5,1062,1.0,794.0,794.0
0.007,17,2,179,1,71,0.0,43.0,43.0,1,108,0.0,80.0,80.0
0.006,6,10,2006,5,927,1.0,659.0,659.0,5,1079,1.0,811.0,811.0
0.073,6,10,1506,5,395,15.0,127.0,127.0,5,1111,14.0,843.0,843.0
0.202,6,16,2669,8,1395,28.0,533.0,323.0,8,1274,18.0,529.0,212.0
0.012,6,10,1989,5,910,3.0,642.0,642.0,5,1079,2.0,811.0,811.0
0.003,17,2,162,1,65,0.0,37.0,37.0,1,97,0.0,69.0,69.0
0.012,6,10,1989,5,910,3.0,642.0,642.0,5,1079,3.0,811.0,811.0
11.252,17,29,4538,15,2484,795.0,587.0,137.0,14,2054,856.0,269.0,118.0
0.005,17,2,166,1,75,0.0,47.0,47.0,1,91,0.0,63.0,63.0
0.237,17,39,20092,21,17044,11.0,1350.0,783.0,18,3048,10.0,1350.0,141.0
0.004,6,10,1779,5,928,1.0,660.0,660.0,5,851,1.0,583.0,583.0
40.057,17,10,676,5,460,10012.0,104.0,64.0,5,216,10013.0,20.0,15.0
0.01,6,10,1989,5,910,2.0,642.0,642.0,5,1079,2.0,811.0,811.0
0.011,17,2,214,1,75,0.0,47.0,47.0,1,139,0.0,111.0,111.0
0.005,6,10,2006,5,927,1.0,659.0,659.0,5,1079,1.0,811.0,811.0
0.004,17,2,148,1,60,0.0,32.0,32.0,1,88,0.0,60.0,60.0
240.085,6,19,4689,9,2112,30010.0,909.0,549.0,10,2577,26675.0,1162.0,409.0
0.004,17,4,284,2,120,1.0,32.0,32.0,2,164,0.0,60.0,54.0
0.007,6,10,1547,5,764,1.0,496.0,496.0,5,783,1.0,515.0,515.0
0.003,17,2,142,1,63,0.0,35.0,35.0,1,79,0.0,51.0,51.0
0.11,6,10,1506,5,395,25.0,127.0,127.0,5,1111,23.0,843.0,843.0
0.004,6,10,2006,5,927,1.0,659.0,659.0,5,1079,1.0,811.0,811.0
0.005,6,10,2006,5,927,1.0,659.0,659.0,5,1079,1.0,811.0,811.0
0.055,6,10,1989,5,910,13.0,642.0,642.0,5,1079,13.0,811.0,811.0
0.004,17,2,148,1,60,0.0,32.0,32.0,1,88,0.0,60.0,60.0
0.004,17,2,140,1,62,0.0,34.0,34.0,1,78,0.0,50.0,50.0
0.13,17,4,564,2,122,0.0,33.0,33.0,2,442,3.0,291.0,193.0
300.027,6,12,1782,7,1348,50004.0,494.0,494.0,5,434,75005.0,83.0,83.0
240.084,6,16,4482,9,963,30010.0,238.0,166.0,7,3519,40013.0,1402.0,786.0
0.006,17,2,170,1,65,0.0,37.0,37.0,1,105,0.0,77.0,77.0
0.152,6,10,1506,5,395,35.0,127.0,127.0,5,1111,33.0,843.0,843.0
0.005,17,2,170,1,65,0.0,37.0,37.0,1,105,0.0,77.0,77.0
0.1,6,10,1506,5,395,22.0,127.0,127.0,5,1111,20.0,843.0,843.0
0.244,17,4,352,2,130,117.0,37.0,37.0,2,222,240.0,89.0,83.0
1778.647,17,144,41760,72,22752,25051.0,288.0,288.0,72,19008,25051.0,236.0,236.0
0.004,6,10,1989,5,927,1.0,659.0,659.0,5,1062,1.0,794.0,794.0
0.005,6,10,2006,5,927,1.0,659.0,659.0,5,1079,1.0,811.0,811.0
0.013,6,10,1972,5,910,3.0,642.0,642.0,5,1062,3.0,794.0,794.0
0.089,6,10,1506,5,395,19.0,127.0,127.0,5,1111,18.0,843.0,843.0
0.006,6,10,1547,5,764,1.0,496.0,496.0,5,783,1.0,515.0,515.0
40.068,17,10,676,5,460,10016.0,104.0,64.0,5,216,10015.0,20.0,15.0
0.006,6,10,1547,5,764,1.0,496.0,496.0,5,783,1.0,515.0,515.0
0.01,6,10,1989,5,910,2.0,642.0,642.0,5,1079,2.0,811.0,811.0
0.001,17,2,140,1,62,0.0,34.0,34.0,1,78,0.0,50.0,50.0
0.001,17,2,180,1,66,0.0,38.0,38.0,1,114,0.0,86.0,86.0
0.012,6,10,1989,5,910,2.0,642.0,642.0,5,1079,3.0,811.0,811.0
0.037,17,2,148,1,60,0.0,32.0,32.0,1,88,0.0,60.0,60.0
0.005,6,10,1774,5,923,1.0,655.0,655.0,5,851,1.0,583.0,583.0
0.007,6,10,2007,5,928,1.0,660.0,660.0,5,1079,1.0,811.0,811.0
0.01,6,10,1989,5,910,2.0,642.0,642.0,5,1079,2.0,811.0,811.0
0.003,17,2,144,1,64,0.0,36.0,36.0,1,80,0.0,52.0,52.0
40.059,17,10,676,5,460,10014.0,104.0,64.0,5,216,10013.0,20.0,15.0
0.217,6,16,2674,8,1400,31.0,533.0,325.0,8,1274,20.0,529.0,212.0
0.109,6,10,1506,5,395,20.0,127.0,127.0,5,1111,22.0,843.0,843.0
0.076,6,10,1506,5,395,16.0,127.0,127.0,5,1111,17.0,843.0,843.0
0.072,6,10,1506,5,395,15.0,127.0,127.0,5,1111,16.0,843.0,843.0
0.006,6,10,1854,5,889,1.0,621.0,621.0,5,965,1.0,697.0,697.0
0.005,6,10,1689,5,839,1.0,571.0,571.0,5,850,1.0,582.0,582.0
0.004,6,10,2006,5,927,1.0,659.0,659.0,5,1079,1.0,811.0,811.0
0.005,6,10,2006,5,927,1.0,659.0,659.0,5,1079,1.0,811.0,811.0
0.005,6,10,1989,5,927,1.0,659.0,659.0,5,1062,1.0,794.0,794.0
0.013,6,10,1989,5,910,3.0,642.0,642.0,5,1079,3.0,811.0,811.0
0.006,6,10,2006,5,927,1.0,659.0,659.0,5,1079,1.0,811.0,811.0
0.481,17,2,144,1,64,0.0,36.0,36.0,1,80,0.0,52.0,52.0
0.016,6,10,1972,5,910,4.0,642.0,642.0,5,1062,4.0,794.0,794.0
0.006,17,2,169,1,62,0.0,34.0,34.0,1,107,0.0,79.0,79.0
0.098,6,10,1506,5,395,22.0,127.0,127.0,5,1111,21.0,843.0,843.0
0.015,6,13,3735,7,497,2.0,125.0,125.0,6,3238,2.0,1470.0,1459.0
11.139,17,28,4396,14,2311,848.0,586.0,137.0,14,2085,848.0,268.0,120.0
0.006,6,10,1547,5,764,1.0,496.0,496.0,5,783,1.0,515.0,515.0
15.073,17,15,9238,8,6902,2149.0,1350.0,834.0,7,2336,2507.0,1350.0,305.0
0.001,17,2,136,1,60,0.0,32.0,32.0,1,76,0.0,48.0,48.0
300.374,6,16,2170,9,684,37525.0,146.0,146.0,7,1486,50034.0,419.0,398.0
0.011,6,10,1972,5,910,2.0,642.0,642.0,5,1062,2.0,794.0,794.0
300.775,6,39,11171,21,5653,15038.0,2720.0,796.0,18,5518,506.0,2667.0,435.0
0.013,6,10,1989,5,910,3.0,642.0,642.0,5,1079,3.0,811.0,811.0
0.006,6,10,2000,5,927,1.0,659.0,659.0,5,1073,1.0,805.0,805.0
1770.466,6,83,4368,42,2210,43181.0,26.0,26.0,41,2158,44260.0,26.0,26.0
0.001,17,2,180,1,66,0.0,38.0,38.0,1,114,0.0,86.0,86.0
356.552,6,19,1691,15,978,25468.0,190.0,190.0,4,713,80002.0,497.0,497.0
0.015,6,10,1972,5,910,3.0,642.0,642.0,5,1062,3.0,794.0,794.0
0.053,17,2,152,1,76,0.0,48.0,48.0,1,76,0.0,48.0,48.0
0.119,6,10,1506,5,395,21.0,127.0,127.0,5,1111,26.0,843.0,843.0
0.005,6,10,2006,5,927,1.0,659.0,659.0,5,1079,1.0,811.0,811.0
40.069,17,10,676,5,460,10016.0,104.0,64.0,5,216,10016.0,20.0,15.0
0.039,17,4,284,2,120,0.0,32.0,32.0,2,164,36.0,60.0,54.0
0.009,6,10,1972,5,910,2.0,642.0,642.0,5,1062,2.0,794.0,794.0
1770.498,6,89,4755,45,2394,40237.0,27.0,27.0,44,2361,41173.0,26.0,24.0
300.383,6,16,2170,9,684,37526.0,146.0,146.0,7,1486,50035.0,419.0,398.0
0.084,6,10,1506,5,395,19.0,127.0,127.0,5,1111,20.0,843.0,843.0
0.079,6,10,1506,5,395,15.0,127.0,127.0,5,1111,17.0,843.0,843.0
368.905,6,22,2313,16,867,24593.0,195.0,195.0,6,1446,4648.0,419.0,398.0
0.014,6,10,1972,5,910,3.0,642.0,642.0,5,1062,3.0,794.0,794.0
0.087,6,10,1506,5,395,17.0,127.0,127.0,5,1111,21.0,843.0,843.0
0.113,6,10,1506,5,395,25.0,127.0,127.0,5,1111,24.0,843.0,843.0
0.005,17,2,214,1,75,0.0,47.0,47.0,1,139,0.0,111.0,111.0
0.005,6,10,2006,5,927,1.0,659.0,659.0,5,1079,1.0,811.0,811.0
0.001,17,2,180,1,66,0.0,38.0,38.0,1,114,0.0,86.0,86.0
0.005,17,2,170,1,65,0.0,37.0,37.0,1,105,0.0,77.0,77.0
0.065,6,10,1506,5,395,14.0,127.0,127.0,5,1111,14.0,843.0,843.0
0.229,6,16,2675,8,1401,32.0,533.0,325.0,8,1274,21.0,529.0,212.0
0.006,6,10,1547,5,764,1.0,496.0,496.0,5,783,1.0,515.0,515.0
0.014,6,10,1677,5,827,3.0,559.0,559.0,5,850,3.0,582.0,582.0
0.01,6,10,1983,5,910,2.0,642.0,642.0,5,1073,2.0,805.0,805.0
0.006,6,10,1547,5,764,1.0,496.0,496.0,5,783,1.0,515.0,515.0
0.006,6,10,1854,5,889,1.0,621.0,621.0,5,965,1.0,697.0,697.0
61.403,6,26,9525,12,1627,78.0,794.0,367.0,14,7898,4713.0,1360.0,732.0
0.004,6,10,1989,5,927,1.0,659.0,659.0,5,1062,1.0,794.0,794.0
0.009,6,10,1972,5,910,2.0,642.0,642.0,5,1062,2.0,794.0,794.0
0.005,6,10,2006,5,927,1.0,659.0,659.0,5,1079,1.0,811.0,811.0
352.772,6,20,2210,6,1308,12003.0,494.0,494.0,14,902,27136.0,83.0,83.0
0.115,6,10,1506,5,395,23.0,127.0,127.0,5,1111,26.0,843.0,843.0
0.123,17,2,80,1,32,0.0,4.0,4.0,1,48,0.0,20.0,20.0
0.037,17,4,284,2,120,2.0,32.0,32.0,2,164,32.0,60.0,54.0
0.004,6,10,1989,5,927,1.0,659.0,659.0,5,1062,1.0,794.0,794.0
0.009,6,10,1972,5,910,2.0,642.0,642.0,5,1062,2.0,794.0,794.0
0.06,6,10,1983,5,910,15.0,642.0,642.0,5,1073,14.0,805.0,805.0
0.008,6,10,1762,5,911,2.0,643.0,643.0,5,851,1.0,583.0,583.0
0.005,17,2,164,1,74,0.0,46.0,46.0,1,90,0.0,62.0,62.0
0.047,6,10,1983,5,910,11.0,642.0,642.0,5,1073,11.0,805.0,805.0
0.007,6,10,1989,5,910,1.0,642.0,642.0,5,1079,1.0,811.0,811.0
0.006,6,10,1547,5,764,1.0,496.0,496.0,5,783,1.0,515.0,515.0
0.072,6,10,1506,5,395,15.0,127.0,127.0,5,1111,15.0,843.0,843.0
0.023,6,10,1989,5,910,5.0,642.0,642.0,5,1079,5.0,811.0,811.0
0.005,6,10,2007,5,928,1.0,660.0,660.0,5,1079,1.0,811.0,811.0
240.103,6,18,5746,10,1027,26678.0,238.0,166.0,8,4719,34300.0,1402.0,859.0
0.132,17,2,136,1,60,0.0,32.0,32.0,1,76,0.0,48.0,48.0
0.004,6,10,2006,5,927,1.0,659.0,659.0,5,1079,1.0,811.0,811.0
0.01,6,10,1989,5,910,2.0,642.0,642.0,5,1079,2.0,811.0,811.0
0.005,6,10,2000,5,927,1.0,659.0,659.0,5,1073,1.0,805.0,805.0
40.076,17,10,676,5,460,10016.0,104.0,64.0,5,216,10017.0,20.0,15.0
0.009,6,10,1989,5,910,2.0,642.0,642.0,5,1079,2.0,811.0,811.0
0.009,6,10,1989,5,910,2.0,642.0,642.0,5,1079,2.0,811.0,811.0
0.012,6,10,1762,5,911,2.0,643.0,643.0,5,851,3.0,583.0,583.0
0.086,6,10,1506,5,395,20.0,127.0,127.0,5,1111,20.0,843.0,843.0
1786.573,6,290,27426,146,10116,12321.0,747.0,250.0,144,17310,12493.0,1624.0,72.0
0.096,6,10,1506,5,395,21.0,127.0,127.0,5,1111,21.0,843.0,843.0
0.018,6,10,1989,5,910,4.0,642.0,642.0,5,1079,4.0,811.0,811.0
0.005,6,10,2000,5,927,1.0,659.0,659.0,5,1073,1.0,805.0,805.0
0.005,6,10,2006,5,927,1.0,659.0,659.0,5,1079,1.0,811.0,811.0
240.011,6,9,787,5,488,60002.0,232.0,232.0,4,299,80002.0,83.0,83.0
0.005,6,10,2007,5,928,1.0,660.0,660.0,5,1079,1.0,811.0,811.0
0.13,6,10,1506,5,395,30.0,127.0,127.0,5,1111,25.0,843.0,843.0
0.108,6,10,1506,5,395,23.0,127.0,127.0,5,1111,23.0,843.0,843.0
0.015,6,10,1990,5,911,3.0,643.0,643.0,5,1079,3.0,811.0,811.0
0.006,6,10,1689,5,839,1.0,571.0,571.0,5,850,1.0,582.0,582.0
241.187,6,322,344508,121,17819,2009.0,2736.0,886.0,201,326689,1205.0,2804.0,1682.0
0.005,6,10,1689,5,839,1.0,571.0,571.0,5,850,1.0,582.0,582.0
0.116,6,10,1506,5,395,23.0,127.0,127.0,5,1111,23.0,843.0,843.0
0.01,6,10,1983,5,910,2.0,642.0,642.0,5,1073,2.0,805.0,805.0
0.098,6,10,1506,5,395,22.0,127.0,127.0,5,1111,22.0,843.0,843.0
0.005,6,10,2006,5,927,1.0,659.0,659.0,5,1079,1.0,811.0,811.0
0.047,17,2,170,1,65,0.0,37.0,37.0,1,105,0.0,77.0,77.0
40.058,17,10,676,5,460,10013.0,104.0,64.0,5,216,10013.0,20.0,15.0
0.015,6,10,1972,5,910,3.0,642.0,642.0,5,1062,3.0,794.0,794.0
0.006,6,10,1547,5,764,1.0,496.0,496.0,5,783,1.0,515.0,515.0
0.096,6,10,1506,5,395,19.0,127.0,127.0,5,1111,23.0,843.0,843.0
0.07,6,10,1506,5,395,15.0,127.0,127.0,5,1111,15.0,843.0,843.0
0.004,6,10,2000,5,927,1.0,659.0,659.0,5,1073,1.0,805.0,805.0
0.213,6,16,2777,8,1395,30.0,533.0,323.0,8,1382,19.0,529.0,239.0
0.114,6,10,1506,5,395,23.0,127.0,127.0,5,1111,25.0,843.0,843.0
0.033,6,10,1677,5,827,8.0,559.0,559.0,5,850,8.0,582.0,582.0
0.004,6,10,1702,5,863,1.0,595.0,595.0,5,839,0.0,571.0,571.0
0.004,6,10,1989,5,927,1.0,659.0,659.0,5,1062,1.0,794.0,794.0
0.007,6,10,2007,6,980,1.0,660.0,660.0,4,1027,1.0,811.0,811.0
0.006,6,10,1854,5,889,1.0,621.0,621.0,5,965,1.0,697.0,697.0
0.022,6,13,3735,7,497,3.0,125.0,125.0,6,3238,4.0,1470.0,1459.0
0.005,6,10,2006,5,927,1.0,659.0,659.0,5,1079,1.0,811.0,811.0
313.687,17,16,928,8,608,44803.0,48.0,48.0,8,320,44803.0,12.0,12.0
0.004,6,10,2006,5,927,1.0,659.0,659.0,5,1079,1.0,811.0,811.0
0.007,17,2,194,1,59,0.0,31.0,31.0,1,135,0.0,107.0,107.0
0.006,6,10,1689,5,839,1.0,571.0,571.0,5,850,1.0,582.0,582.0
0.04,17,2,152,1,76,0.0,48.0,48.0,1,76,0.0,48.0,48.0
0.026,6,10,1972,5,910,6.0,642.0,642.0,5,1062,6.0,794.0,794.0
0.277,17,4,596,2,122,148.0,33.0,33.0,2,474,235.0,323.0,209.0
0.005,6,10,2006,5,927,1.0,659.0,659.0,5,1079,1.0,811.0,811.0
0.003,17,4,284,2,120,0.0,32.0,32.0,2,164,0.0,60.0,54.0
0.005,17,2,214,1,75,0.0,47.0,47.0,1,139,0.0,111.0,111.0
300.02,6,12,1782,7,1348,50003.0,494.0,494.0,5,434,75004.0,83.0,83.0
0.105,6,10,1506,5,395,25.0,127.0,127.0,5,1111,25.0,843.0,843.0
125.997,6,14,2938,8,2504,17966.0,1414.0,1086.0,6,434,25153.0,182.0,182.0
0.01,6,10,1989,5,910,2.0,642.0,642.0,5,1079,2.0,811.0,811.0
0.016,6,10,1972,5,910,4.0,642.0,642.0,5,1062,4.0,794.0,794.0
0.004,6,10,2006,5,927,1.0,659.0,659.0,5,1079,1.0,811.0,811.0
0.004,17,2,136,1,60,0.0,32.0,32.0,1,76,0.0,48.0,48.0
0.003,17,2,148,1,60,0.0,32.0,32.0,1,88,0.0,60.0,60.0
0.007,17,2,179,1,71,0.0,43.0,43.0,1,108,0.0,80.0,80.0
0.015,6,10,1983,5,910,3.0,642.0,642.0,5,1073,3.0,805.0,805.0
0.113,6,10,1506,5,395,26.0,127.0,127.0,5,1111,26.0,843.0,843.0
0.005,6,10,1854,5,889,1.0,621.0,621.0,5,965,1.0,697.0,697.0
0.083,6,10,1506,5,395,17.0,127.0,127.0,5,1111,16.0,843.0,843.0
0.007,17,2,194,1,59,0.0,31.0,31.0,1,135,0.0,107.0,107.0
0.014,17,2,136,1,60,0.0,32.0,32.0,1,76,0.0,48.0,48.0
0.134,6,10,1506,5,395,31.0,127.0,127.0,5,1111,30.0,843.0,843.0
40.095,17,10,676,5,460,10015.0,104.0,64.0,5,216,10021.0,20.0,15.0
0.004,17,4,284,2,120,0.0,32.0,32.0,2,164,1.0,60.0,54.0
172.151,17,74,10604,37,2474,4781.0,44.0,38.0,37,8130,4781.0,260.0,191.0
0.005,17,2,164,1,74,0.0,46.0,46.0,1,90,0.0,62.0,62.0
0.004,6,10,2006,5,927,1.0,659.0,659.0,5,1079,1.0,811.0,811.0
0.01,6,10,1989,5,910,2.0,642.0,642.0,5,1079,2.0,811.0,811.0
0.005,6,10,1547,5,764,1.0,496.0,496.0,5,783,1.0,515.0,515.0
0.005,6,10,1547,5,764,1.0,496.0,496.0,5,783,1.0,515.0,515.0
0.001,17,2,180,1,66,0.0,38.0,38.0,1,114,0.0,86.0,86.0
0.009,6,12,1926,6,1189,1.0,659.0,434.0,6,737,1.0,417.0,417.0
0.001,17,2,136,1,60,0.0,32.0,32.0,1,76,0.0,48.0,48.0
0.003,17,2,136,1,60,0.0,32.0,32.0,1,76,0.0,48.0,48.0
0.005,17,2,214,1,75,0.0,47.0,47.0,1,139,0.0,111.0,111.0
0.004,6,10,1989,5,927,1.0,659.0,659.0,5,1062,1.0,794.0,794.0
0.005,6,10,2007,5,928,1.0,660.0,660.0,5,1079,1.0,811.0,811.0
0.007,6,13,3690,7,452,1.0,80.0,80.0,6,3238,1.0,1470.0,1459.0
0.003,17,2,148,1,60,0.0,32.0,32.0,1,88,0.0,60.0,60.0
0.006,6,10,1854,5,889,1.0,621.0,621.0,5,965,1.0,697.0,697.0
172.496,17,76,10736,38,2532,4661.0,44.0,38.0,38,8204,4661.0,239.0,187.0
300.431,6,16,2170,9,684,37533.0,146.0,146.0,7,1486,50044.0,419.0,398.0
0.067,17,8,3613,4,1874,22.0,1350.0,440.0,4,1739,10.0,1350.0,406.0
0.005,6,10,2007,5,928,1.0,660.0,660.0,5,1079,1.0,811.0,811.0
0.018,6,10,1989,5,910,4.0,642.0,642.0,5,1079,4.0,811.0,811.0
40.063,17,10,676,5,460,10014.0,104.0,64.0,5,216,10014.0,20.0,15.0
0.004,6,10,2006,5,927,1.0,659.0,659.0,5,1079,1.0,811.0,811.0
0.005,6,10,1547,5,764,1.0,496.0,496.0,5,783,1.0,515.0,515.0
176.094,17,82,11821,41,2743,4402.0,44.0,38.0,41,9078,4402.0,261.0,193.0
0.017,6,10,1990,5,911,4.0,643.0,643.0,5,1079,4.0,811.0,811.0
0.003,17,2,148,1,60,0.0,32.0,32.0,1,88,0.0,60.0,60.0
0.016,6,10,1989,5,910,4.0,642.0,642.0,5,1079,4.0,811.0,811.0
15.328,17,44,26578,26,23443,612.0,1350.0,873.0,18,3135,900.0,1350.0,146.0
0.024,6,13,3735,7,497,3.0,125.0,125.0,6,3238,4.0,1470.0,1459.0
0.122,6,10,1506,5,395,29.0,127.0,127.0,5,1111,28.0,843.0,843.0
0.102,6,10,1506,5,395,20.0,127.0,127.0,5,1111,22.0,843.0,843.0
0.013,6,10,1990,5,911,3.0,643.0,643.0,5,1079,3.0,811.0,811.0
0.004,6,10,2007,5,928,1.0,660.0,660.0,5,1079,1.0,811.0,811.0
0.004,17,2,136,1,60,0.0,32.0,32.0,1,76,0.0,48.0,48.0
0.01,6,10,1762,5,911,2.0,643.0,643.0,5,851,2.0,583.0,583.0
0.009,6,10,1972,5,910,2.0,642.0,642.0,5,1062,2.0,794.0,794.0
0.008,6,10,1989,5,910,2.0,642.0,642.0,5,1079,1.0,811.0,811.0
0.063,6,10,1506,5,395,15.0,127.0,127.0,5,1111,14.0,843.0,843.0
0.004,17,2,166,1,75,0.0,47.0,47.0,1,91,0.0,63.0,63.0
0.17,17,2,152,1,76,0.0,48.0,48.0,1,76,0.0,48.0,48.0
0.005,6,10,1990,5,928,1.0,660.0,660.0,5,1062,1.0,794.0,794.0
0.12,6,10,1506,5,395,27.0,127.0,127.0,5,1111,27.0,843.0,843.0
40.089,17,10,676,5,460,10015.0,104.0,64.0,5,216,10015.0,20.0,15.0
0.005,6,10,2007,5,928,1.0,660.0,660.0,5,1079,1.0,811.0,811.0
0.021,6,10,1989,5,910,5.0,642.0,642.0,5,1079,5.0,811.0,811.0
0.006,6,10,1643,5,860,1.0,592.0,592.0,5,783,1.0,515.0,515.0
0.807,6,22,5168,11,1138,69.0,267.0,115.0,11,4030,68.0,1414.0,597.0
0.004,6,10,2006,5,927,1.0,659.0,659.0,5,1079,1.0,811.0,811.0
0.006,6,13,3747,7,509,1.0,137.0,137.0,6,3238,1.0,1470.0,1459.0
0.021,6,10,1983,5,910,5.0,642.0,642.0,5,1073,5.0,805.0,805.0
0.005,17,2,179,1,71,0.0,43.0,43.0,1,108,0.0,80.0,80.0
0.019,6,10,1631,5,848,4.0,580.0,580.0,5,783,4.0,515.0,515.0
0.078,6,10,1506,5,395,16.0,127.0,127.0,5,1111,16.0,843.0,843.0
0.004,6,10,1989,5,927,1.0,659.0,659.0,5,1062,1.0,794.0,794.0
125.998,6,14,2938,8,2504,17965.0,1414.0,1086.0,6,434,25151.0,182.0,182.0
0.008,6,12,1926,6,1189,1.0,659.0,434.0,6,737,1.0,417.0,417.0
0.004,6,10,1989,5,927,1.0,659.0,659.0,5,1062,1.0,794.0,794.0
0.005,6,10,1643,5,860,1.0,592.0,592.0,5,783,1.0,515.0,515.0
40.058,17,10,676,5,460,10013.0,104.0,64.0,5,216,10013.0,20.0,15.0
0.102,6,10,1506,5,395,19.0,127.0,127.0,5,1111,23.0,843.0,843.0
0.066,6,10,1506,5,395,15.0,127.0,127.0,5,1111,13.0,843.0,843.0
15.079,17,14,9191,8,6902,2149.0,1350.0,834.0,6,2289,3009.0,1350.0,353.0
11.135,17,28,4421,14,1994,843.0,269.0,114.0,14,2427,843.0,586.0,145.0
0.005,6,10,1989,5,927,1.0,659.0,659.0,5,1062,1.0,794.0,794.0
15.072,17,15,9238,8,6902,2149.0,1350.0,834.0,7,2336,2507.0,1350.0,305.0
0.006,6,10,2007,5,928,1.0,660.0,660.0,5,1079,1.0,811.0,811.0
0.005,6,10,2006,5,927,1.0,659.0,659.0,5,1079,1.0,811.0,811.0
0.006,6,10,1854,5,889,1.0,621.0,621.0,5,965,1.0,697.0,697.0
0.087,6,10,1506,5,395,19.0,127.0,127.0,5,1111,20.0,843.0,843.0
1787.519,6,154,19574,92,13852,19643.0,302.0,302.0,62,5722,29303.0,83.0,83.0
0.011,6,10,1631,5,848,2.0,580.0,580.0,5,783,2.0,515.0,515.0
0.005,17,2,179,1,71,0.0,43.0,43.0,1,108,0.0,80.0,80.0
0.085,6,10,1506,5,395,19.0,127.0,127.0,5,1111,19.0,843.0,843.0
0.014,6,10,1972,5,910,3.0,642.0,642.0,5,1062,3.0,794.0,794.0
0.005,6,10,1689,5,839,1.0,571.0,571.0,5,850,1.0,582.0,582.0
0.004,17,4,284,2,120,0.0,32.0,32.0,2,164,0.0,60.0,54.0
0.006,6,12,1698,6,863,1.0,327.0,271.0,6,835,1.0,515.0,515.0
300.028,6,12,1782,7,1348,50004.0,494.0,494.0,5,434,75006.0,83.0,83.0
40.077,17,10,676,5,460,10018.0,104.0,64.0,5,216,10018.0,20.0,15.0
0.006,6,10,1689,5,839,1.0,571.0,571.0,5,850,1.0,582.0,582.0
356.611,6,21,1795,16,1030,23774.0,190.0,190.0,5,765,60011.0,464.0,248.0
0.003,17,2,148,1,60,0.0,32.0,32.0,1,88,0.0,60.0,60.0
0.017,6,10,1972,5,910,4.0,642.0,642.0,5,1062,4.0,794.0,794.0
0.005,6,14,3742,7,452,0.0,80.0,80.0,7,3290,0.0,1448.0,972.0
0.005,6,10,2006,5,927,1.0,659.0,659.0,5,1079,1.0,811.0,811.0
0.008,6,10,1989,5,910,1.0,642.0,642.0,5,1079,1.0,811.0,811.0
0.005,6,10,1689,5,839,1.0,571.0,571.0,5,850,1.0,582.0,582.0
0.004,17,2,136,1,60,0.0,32.0,32.0,1,76,0.0,48.0,48.0
0.068,6,10,1506,5,395,14.0,127.0,127.0,5,1111,13.0,843.0,843.0
0.006,17,2,148,1,60,0.0,32.0,32.0,1,88,0.0,60.0,60.0
0.007,17,2,179,1,71,0.0,43.0,43.0,1,108,0.0,80.0,80.0
0.005,17,2,282,1,69,0.0,41.0,41.0,1,213,0.0,185.0,185.0
0.004,6,10,1989,5,927,1.0,659.0,659.0,5,1062,1.0,794.0,794.0
0.135,6,10,1506,5,395,32.0,127.0,127.0,5,1111,27.0,843.0,843.0
0.016,6,10,1677,5,827,4.0,559.0,559.0,5,850,4.0,582.0,582.0
0.014,6,10,1989,5,910,3.0,642.0,642.0,5,1079,3.0,811.0,811.0
0.037,17,4,284,2,120,0.0,32.0,32.0,2,164,0.0,60.0,54.0
0.005,17,2,144,1,64,0.0,36.0,36.0,1,80,0.0,52.0,52.0
0.004,6,10,1774,5,923,1.0,655.0,655.0,5,851,1.0,583.0,583.0
0.008,6,10,1990,5,911,2.0,643.0,643.0,5,1079,1.0,811.0,811.0
0.005,6,10,1989,5,927,1.0,659.0,659.0,5,1062,1.0,794.0,794.0
0.012,6,10,1989,5,910,2.0,642.0,642.0,5,1079,3.0,811.0,811.0
0.011,17,2,179,1,71,0.0,43.0,43.0,1,108,0.0,80.0,80.0
319.372,17,20,1124,10,716,35472.0,48.0,43.0,10,408,35472.0,20.0,12.0
0.012,6,14,3787,7,497,2.0,125.0,125.0,7,3290,2.0,1448.0,972.0
0.005,6,10,2006,5,927,1.0,659.0,659.0,5,1079,1.0,811.0,811.0
0.012,6,10,1989,5,910,2.0,642.0,642.0,5,1079,3.0,811.0,811.0
0.013,6,10,1983,5,910,3.0,642.0,642.0,5,1073,3.0,805.0,805.0
0.005,17,2,180,1,66,0.0,38.0,38.0,1,114,0.0,86.0,86.0
0.067,17,8,3613,4,1874,22.0,1350.0,440.0,4,1739,11.0,1350.0,406.0
291.622,6,384,347111,199,21910,1472.0,2736.0,888.0,185,325201,1584.0,2804.0,1845.0
40.067,17,10,676,5,460,10014.0,104.0,64.0,5,216,10016.0,20.0,15.0
0.015,6,10,1983,5,910,3.0,642.0,642.0,5,1073,3.0,805.0,805.0
0.016,6,10,1990,5,911,4.0,643.0,643.0,5,1079,4.0,811.0,811.0
0.01,6,11,2041,6,962,1.0,642.0,642.0,5,1079,2.0,811.0,811.0
0.101,6,10,1506,5,395,20.0,127.0,127.0,5,1111,21.0,843.0,843.0
10.943,17,28,4398,14,2312,833.0,587.0,137.0,14,2086,833.0,269.0,121.0
0.006,17,2,214,1,75,0.0,47.0,47.0,1,139,0.0,111.0,111.0
0.014,6,10,1990,5,911,3.0,643.0,643.0,5,1079,3.0,811.0,811.0
294.065,6,408,349025,199,21922,1485.0,2736.0,889.0,209,327103,1413.0,2804.0,1621.0
1770.458,6,82,4318,41,2159,44260.0,27.0,27.0,41,2159,44260.0,27.0,27.0
0.071,17,8,3613,4,1874,23.0,1350.0,440.0,4,1739,12.0,1350.0,406.0
0.798,6,25,5555,12,1445,61.0,267.0,136.0,13,4110,55.0,1414.0,597.0
0.005,6,10,2006,5,927,1.0,659.0,659.0,5,1079,1.0,811.0,811.0
68.801,6,26,9479,13,1655,5733.0,794.0,367.0,13,7824,5720.0,1360.0,810.0
11.116,17,28,4420,14,1992,842.0,267.0,114.0,14,2428,842.0,587.0,145.0
0.075,6,10,1506,5,395,15.0,127.0,127.0,5,1111,16.0,843.0,843.0
40.059,17,10,676,5,460,10013.0,104.0,64.0,5,216,10013.0,20.0,15.0
0.005,17,2,136,1,60,0.0,32.0,32.0,1,76,0.0,48.0,48.0
0.003,17,4,284,2,120,0.0,32.0,32.0,2,164,0.0,60.0,54.0
0.069,17,8,3613,4,1874,23.0,1350.0,440.0,4,1739,11.0,1350.0,406.0
0.005,6,10,2006,5,927,1.0,659.0,659.0,5,1079,1.0,811.0,811.0
0.079,6,10,1506,5,395,18.0,127.0,127.0,5,1111,17.0,843.0,843.0
0.006,6,10,1643,5,860,1.0,592.0,592.0,5,783,1.0,515.0,515.0
0.004,6,10,1702,5,863,1.0,595.0,595.0,5,839,0.0,571.0,571.0
172.361,17,78,10973,39,2593,4535.0,44.0,38.0,39,8380,4535.0,239.0,186.0
0.012,6,10,1972,5,910,3.0,642.0,642.0,5,1062,3.0,794.0,794.0
0.184,17,2,152,1,76,0.0,48.0,48.0,1,76,0.0,48.0,48.0
0.005,6,13,3747,7,509,0.0,137.0,137.0,6,3238,0.0,1470.0,1459.0
0.006,6,10,1689,5,839,1.0,571.0,571.0,5,850,1.0,582.0,582.0
0.004,17,2,166,1,75,0.0,47.0,47.0,1,91,0.0,63.0,63.0
0.007,6,10,1972,5,910,1.0,642.0,642.0,5,1062,1.0,794.0,794.0
0.009,6,10,1990,5,911,2.0,643.0,643.0,5,1079,2.0,811.0,811.0
0.038,17,2,152,1,76,0.0,48.0,48.0,1,76,0.0,48.0,48.0
0.073,6,10,1506,5,395,16.0,127.0,127.0,5,1111,15.0,843.0,843.0
0.003,17,2,136,1,60,0.0,32.0,32.0,1,76,0.0,48.0,48.0
0.005,6,10,1547,5,764,1.0,496.0,496.0,5,783,1.0,515.0,515.0
0.004,17,2,136,1,60,0.0,32.0,32.0,1,76,0.0,48.0,48.0
0.01,6,10,1989,5,910,2.0,642.0,642.0,5,1079,2.0,811.0,811.0
0.006,6,10,1547,5,764,1.0,496.0,496.0,5,783,1.0,515.0,515.0
240.263,6,52,7298,26,3481,9610.0,588.0,210.0,26,3817,9610.0,580.0,189.0
0.014,6,10,1983,5,910,3.0,642.0,642.0,5,1073,3.0,805.0,805.0
0.017,6,10,1972,5,910,4.0,642.0,642.0,5,1062,4.0,794.0,794.0
0.009,6,12,1926,6,1189,1.0,659.0,434.0,6,737,1.0,417.0,417.0
0.004,17,2,136,1,60,0.0,32.0,32.0,1,76,0.0,48.0,48.0
0.048,6,10,1506,5,395,11.0,127.0,127.0,5,1111,11.0,843.0,843.0
0.021,6,10,1990,5,911,5.0,643.0,643.0,5,1079,5.0,811.0,811.0
0.013,6,10,1989,5,910,3.0,642.0,642.0,5,1079,3.0,811.0,811.0
40.066,17,10,676,5,460,10015.0,104.0,64.0,5,216,10015.0,20.0,15.0
0.005,17,2,144,1,64,0.0,36.0,36.0,1,80,0.0,52.0,52.0
0.005,6,10,2006,5,927,1.0,659.0,659.0,5,1079,1.0,811.0,811.0
0.012,6,10,1989,5,910,3.0,642.0,642.0,5,1079,3.0,811.0,811.0
0.036,17,2,182,1,65,0.0,37.0,37.0,1,117,0.0,89.0,89.0
0.015,6,10,1983,5,910,3.0,642.0,642.0,5,1073,3.0,805.0,805.0
351.985,6,20,2210,6,1308,12003.0,494.0,494.0,14,902,27075.0,83.0,83.0
0.02,6,10,1677,5,827,4.0,559.0,559.0,5,850,4.0,582.0,582.0
0.016,17,2,170,1,65,0.0,37.0,37.0,1,105,0.0,77.0,77.0
0.115,6,10,1506,5,395,22.0,127.0,127.0,5,1111,22.0,843.0,843.0
0.004,6,13,3690,7,452,0.0,80.0,80.0,6,3238,0.0,1470.0,1459.0
0.06,17,2,152,1,76,0.0,48.0,48.0,1,76,0.0,48.0,48.0
0.074,6,10,1506,5,395,15.0,127.0,127.0,5,1111,17.0,843.0,843.0
0.004,6,10,2006,5,927,1.0,659.0,659.0,5,1079,1.0,811.0,811.0
0.02,6,10,1989,5,910,5.0,642.0,642.0,5,1079,4.0,811.0,811.0
0.005,6,10,1854,5,889,1.0,621.0,621.0,5,965,1.0,697.0,697.0
0.01,6,10,1989,5,910,2.0,642.0,642.0,5,1079,2.0,811.0,811.0
0.014,6,10,1989,5,910,3.0,642.0,642.0,5,1079,3.0,811.0,811.0
0.006,6,10,1854,5,889,1.0,621.0,621.0,5,965,1.0,697.0,697.0
0.012,6,10,1972,5,910,3.0,642.0,642.0,5,1062,2.0,794.0,794.0
1787.105,6,150,19350,90,13740,20079.0,302.0,302.0,60,5610,30289.0,83.0,83.0
0.014,6,10,1762,5,911,3.0,643.0,643.0,5,851,3.0,583.0,583.0
0.005,6,10,1643,5,860,1.0,592.0,592.0,5,783,1.0,515.0,515.0
0.019,6,13,3735,7,497,3.0,125.0,125.0,6,3238,3.0,1470.0,1459.0
0.006,6,10,1989,5,927,1.0,659.0,659.0,5,1062,1.0,794.0,794.0
0.006,17,2,164,1,74,0.0,46.0,46.0,1,90,0.0,62.0,62.0
0.111,6,10,1506,5,395,25.0,127.0,127.0,5,1111,24.0,843.0,843.0
0.005,6,10,1702,5,863,1.0,595.0,595.0,5,839,1.0,571.0,571.0
0.005,6,10,2006,5,927,1.0,659.0,659.0,5,1079,1.0,811.0,811.0
0.006,6,10,1643,5,860,1.0,592.0,592.0,5,783,1.0,515.0,515.0
1712.216,6,61,7138,40,4347,43902.0,1640.0,113.0,21,2791,85602.0,1110.0,84.0
0.001,17,2,180,1,66,0.0,38.0,38.0,1,114,0.0,86.0,86.0
1729.217,6,60,4400,40,2740,44338.0,33.0,33.0,20,1660,91002.0,31.0,31.0
0.048,17,2,144,1,64,0.0,36.0,36.0,1,80,0.0,52.0,52.0
0.005,17,2,170,1,65,0.0,37.0,37.0,1,105,0.0,77.0,77.0
0.001,17,2,180,1,66,0.0,38.0,38.0,1,114,0.0,86.0,86.0
0.009,17,2,170,1,65,0.0,37.0,37.0,1,105,0.0,77.0,77.0
0.006,6,10,1547,5,764,1.0,496.0,496.0,5,783,1.0,515.0,515.0
0.006,6,10,1547,5,764,1.0,496.0,496.0,5,783,1.0,515.0,515.0
0.082,6,10,1506,5,395,18.0,127.0,127.0,5,1111,19.0,843.0,843.0
0.004,17,2,148,1,60,0.0,32.0,32.0,1,88,0.0,60.0,60.0
0.004,6,10,1702,5,863,1.0,595.0,595.0,5,839,0.0,571.0,571.0
0.099,6,10,1506,5,395,23.0,127.0,127.0,5,1111,19.0,843.0,843.0
364.436,6,21,1793,16,1030,24295.0,190.0,190.0,5,763,60010.0,462.0,247.0
0.104,6,10,1506,5,395,22.0,127.0,127.0,5,1111,25.0,843.0,843.0
0.004,6,10,1779,5,928,1.0,660.0,660.0,5,851,1.0,583.0,583.0
11.17,17,28,4421,14,1993,846.0,268.0,114.0,14,2428,847.0,587.0,145.0
0.082,6,10,1506,5,395,19.0,127.0,127.0,5,1111,16.0,843.0,843.0
0.008,6,10,1989,5,910,2.0,642.0,642.0,5,1079,2.0,811.0,811.0
0.083,17,2,144,1,64,0.0,36.0,36.0,1,80,0.0,52.0,52.0
0.012,6,10,1989,5,910,2.0,642.0,642.0,5,1079,2.0,811.0,811.0
308.25,17,18,1008,9,640,38514.0,48.0,43.0,9,368,38514.0,20.0,12.0
15.074,17,15,9238,8,6902,2149.0,1350.0,834.0,7,2336,2507.0,1350.0,305.0
0.006,6,10,1547,5,764,1.0,496.0,496.0,5,783,1.0,515.0,515.0
0.069,17,8,3613,4,1874,23.0,1350.0,440.0,4,1739,12.0,1350.0,406.0
0.014,6,10,1989,5,910,3.0,642.0,642.0,5,1079,3.0,811.0,811.0
0.086,6,10,1506,5,395,20.0,127.0,127.0,5,1111,15.0,843.0,843.0
0.386,17,49,24992,26,21271,15.0,1350.0,790.0,23,3721,14.0,1350.0,133.0
40.091,17,10,676,5,460,10020.0,104.0,64.0,5,216,10021.0,20.0,15.0
0.005,17,2,194,1,59,0.0,31.0,31.0,1,135,0.0,107.0,107.0
240.012,6,9,787,5,488,60003.0,232.0,232.0,4,299,80003.0,83.0,83.0
0.123,6,10,1506,5,395,28.0,127.0,127.0,5,1111,28.0,843.0,843.0
0.09,6,10,1506,5,395,19.0,127.0,127.0,5,1111,21.0,843.0,843.0
0.005,6,10,1989,5,927,1.0,659.0,659.0,5,1062,1.0,794.0,794.0
0.04,17,2,146,1,65,0.0,37.0,37.0,1,81,0.0,53.0,53.0
0.005,6,10,1989,5,927,1.0,659.0,659.0,5,1062,1.0,794.0,794.0
0.005,6,10,2006,5,927,1.0,659.0,659.0,5,1079,1.0,811.0,811.0
0.013,6,10,1762,5,911,3.0,643.0,643.0,5,851,3.0,583.0,583.0
0.022,6,10,1631,5,848,5.0,580.0,580.0,5,783,5.0,515.0,515.0
0.015,6,10,1990,5,911,3.0,643.0,643.0,5,1079,3.0,811.0,811.0
0.085,17,8,3613,4,1874,28.0,1350.0,440.0,4,1739,14.0,1350.0,406.0
0.005,17,2,179,1,71,0.0,43.0,43.0,1,108,0.0,80.0,80.0
3.053,6,27,8604,16,2211,203.0,517.0,273.0,11,6393,304.0,1402.0,726.0
0.084,6,10,1506,5,395,19.0,127.0,127.0,5,1111,18.0,843.0,843.0
0.005,6,13,3690,7,452,0.0,80.0,80.0,6,3238,0.0,1470.0,1459.0
0.015,6,10,1972,5,910,3.0,642.0,642.0,5,1062,3.0,794.0,794.0
0.009,6,10,2000,5,927,2.0,659.0,659.0,5,1073,2.0,805.0,805.0
0.019,6,10,1989,5,910,4.0,642.0,642.0,5,1079,4.0,811.0,811.0
0.018,17,2,198,1,91,0.0,63.0,63.0,1,107,0.0,79.0,79.0
253.151,6,37,9936,15,6907,18082.0,2031.0,681.0,22,3029,12054.0,580.0,144.0
0.006,6,10,1643,5,860,1.0,592.0,592.0,5,783,1.0,515.0,515.0
0.122,6,10,1506,5,395,19.0,127.0,127.0,5,1111,28.0,843.0,843.0
0.1,6,10,1506,5,395,24.0,127.0,127.0,5,1111,23.0,843.0,843.0
0.005,6,10,1689,5,839,1.0,571.0,571.0,5,850,1.0,582.0,582.0
0.005,6,10,2006,5,927,1.0,659.0,659.0,5,1079,1.0,811.0,811.0
0.005,6,10,2007,5,928,1.0,660.0,660.0,5,1079,1.0,811.0,811.0
0.005,17,2,213,1,69,0.0,41.0,41.0,1,144,0.0,116.0,116.0
0.037,17,2,182,1,65,0.0,37.0,37.0,1,117,0.0,89.0,89.0
0.006,17,2,180,1,66,0.0,38.0,38.0,1,114,0.0,86.0,86.0
0.005,6,10,2006,5,927,1.0,659.0,659.0,5,1079,1.0,811.0,811.0
0.059,17,2,152,1,76,0.0,48.0,48.0,1,76,0.0,48.0,48.0
0.007,17,2,179,1,71,0.0,43.0,43.0,1,108,0.0,80.0,80.0
0.7,6,23,5165,12,1343,55.0,325.0,122.0,11,3822,59.0,1414.0,563.0
280.268,6,22,6035,10,1186,31140.0,267.0,156.0,12,4849,25478.0,1400.0,873.0
0.105,6,10,1506,5,395,21.0,127.0,127.0,5,1111,25.0,843.0,843.0
0.009,6,10,1631,5,848,2.0,580.0,580.0,5,783,2.0,515.0,515.0
0.005,17,2,214,1,75,0.0,47.0,47.0,1,139,0.0,111.0,111.0
0.013,6,10,1989,5,910,3.0,642.0,642.0,5,1079,3.0,811.0,811.0
0.004,6,10,2006,5,927,1.0,659.0,659.0,5,1079,1.0,811.0,811.0
0.005,6,10,2007,5,928,1.0,660.0,660.0,5,1079,1.0,811.0,811.0
0.005,6,10,2006,5,927,1.0,659.0,659.0,5,1079,1.0,811.0,811.0
0.006,6,10,1547,5,764,1.0,496.0,496.0,5,783,1.0,515.0,515.0
0.01,6,10,1677,5,827,2.0,559.0,559.0,5,850,2.0,582.0,582.0
0.01,6,10,1989,5,910,2.0,642.0,642.0,5,1079,2.0,811.0,811.0
0.089,6,10,1506,5,395,20.0,127.0,127.0,5,1111,16.0,843.0,843.0
0.006,6,10,2007,5,928,1.0,660.0,660.0,5,1079,1.0,811.0,811.0
177.066,17,76,10722,38,2532,4785.0,44.0,38.0,38,8190,4785.0,239.0,187.0
0.273,17,43,27910,26,24776,10.0,1350.0,924.0,17,3134,14.0,1350.0,156.0
15.076,17,15,8208,8,6047,2149.0,1350.0,727.0,7,2161,2507.0,1350.0,280.0
0.103,6,10,1506,5,395,21.0,127.0,127.0,5,1111,24.0,843.0,843.0
0.004,17,4,284,2,120,0.0,32.0,32.0,2,164,1.0,60.0,54.0
0.013,6,10,1983,5,910,3.0,642.0,642.0,5,1073,3.0,805.0,805.0
0.039,17,2,144,1,64,0.0,36.0,36.0,1,80,0.0,52.0,52.0
0.006,17,2,144,1,64,0.0,36.0,36.0,1,80,0.0,52.0,52.0
0.005,6,10,1689,5,839,1.0,571.0,571.0,5,850,1.0,582.0,582.0
0.005,6,10,2007,5,928,1.0,660.0,660.0,5,1079,1.0,811.0,811.0
0.005,6,14,3736,7,446,0.0,74.0,74.0,7,3290,0.0,1448.0,972.0
0.079,6,10,1506,5,395,18.0,127.0,127.0,5,1111,17.0,843.0,843.0
0.021,6,10,1989,5,910,5.0,642.0,642.0,5,1079,5.0,811.0,811.0
0.001,17,2,146,1,65,0.0,37.0,37.0,1,81,0.0,53.0,53.0
0.004,6,10,2006,5,927,1.0,659.0,659.0,5,1079,1.0,811.0,811.0
0.016,6,10,1972,5,910,4.0,642.0,642.0,5,1062,3.0,794.0,794.0
0.006,6,10,1689,5,839,1.0,571.0,571.0,5,850,1.0,582.0,582.0
0.005,17,2,166,1,75,0.0,47.0,47.0,1,91,0.0,63.0,63.0
0.006,6,10,2007,5,928,1.0,660.0,660.0,5,1079,1.0,811.0,811.0
0.004,17,2,136,1,60,0.0,32.0,32.0,1,76,0.0,48.0,48.0
240.085,6,16,4480,9,963,30010.0,238.0,166.0,7,3517,40013.0,1402.0,786.0
0.009,6,12,1926,6,1189,1.0,659.0,434.0,6,737,1.0,417.0,417.0
0.005,6,10,2006,5,927,1.0,659.0,659.0,5,1079,1.0,811.0,811.0
0.004,6,10,2006,5,927,1.0,659.0,659.0,5,1079,1.0,811.0,811.0
0.022,6,10,1762,5,911,5.0,643.0,643.0,5,851,5.0,583.0,583.0
0.093,6,10,1506,5,395,20.0,127.0,127.0,5,1111,20.0,843.0,843.0
0.001,17,2,136,1,60,0.0,32.0,32.0,1,76,0.0,48.0,48.0
0.006,17,2,166,1,75,0.0,47.0,47.0,1,91,0.0,63.0,63.0
0.124,17,2,136,1,60,0.0,32.0,32.0,1,76,0.0,48.0,48.0
0.008,6,10,1983,5,910,2.0,642.0,642.0,5,1073,2.0,805.0,805.0
0.001,17,2,136,1,60,0.0,32.0,32.0,1,76,0.0,48.0,48.0
0.042,17,2,136,1,60,0.0,32.0,32.0,1,76,0.0,48.0,48.0
0.005,6,10,1689,5,839,1.0,571.0,571.0,5,850,1.0,582.0,582.0
0.001,17,2,180,1,66,0.0,38.0,38.0,1,114,0.0,86.0,86.0
0.015,6,10,1677,5,827,3.0,559.0,559.0,5,850,3.0,582.0,582.0
0.011,17,2,160,1,72,0.0,44.0,44.0,1,88,0.0,60.0,60.0
0.021,6,10,1631,5,848,5.0,580.0,580.0,5,783,5.0,515.0,515.0
0.013,6,13,3735,7,497,2.0,125.0,125.0,6,3238,2.0,1470.0,1459.0
0.011,6,10,1762,5,911,2.0,643.0,643.0,5,851,2.0,583.0,583.0
0.005,17,2,209,1,64,0.0,36.0,36.0,1,145,0.0,117.0,117.0
0.023,6,10,1989,5,910,5.0,642.0,642.0,5,1079,5.0,811.0,811.0
0.084,6,10,1506,5,395,18.0,127.0,127.0,5,1111,18.0,843.0,843.0
0.012,6,10,1990,5,911,3.0,643.0,643.0,5,1079,2.0,811.0,811.0
0.007,6,10,1972,5,910,1.0,642.0,642.0,5,1062,1.0,794.0,794.0
0.024,6,14,3787,7,497,3.0,125.0,125.0,7,3290,4.0,1448.0,972.0
0.005,6,10,1774,5,923,1.0,655.0,655.0,5,851,1.0,583.0,583.0
0.005,6,13,3690,7,452,0.0,80.0,80.0,6,3238,1.0,1470.0,1459.0
0.003,17,2,148,1,60,0.0,32.0,32.0,1,88,0.0,60.0,60.0
0.006,17,2,180,1,58,0.0,30.0,30.0,1,122,0.0,94.0,94.0
0.15,6,10,1990,5,911,37.0,643.0,643.0,5,1079,37.0,811.0,811.0
0.005,6,10,1989,5,927,1.0,659.0,659.0,5,1062,1.0,794.0,794.0
0.004,6,10,1779,5,928,1.0,660.0,660.0,5,851,1.0,583.0,583.0
0.003,17,2,136,1,60,0.0,32.0,32.0,1,76,0.0,48.0,48.0
0.009,6,10,1972,5,910,2.0,642.0,642.0,5,1062,2.0,794.0,794.0
0.004,6,10,1702,5,863,1.0,595.0,595.0,5,839,0.0,571.0,571.0
0.022,6,14,3787,7,497,3.0,125.0,125.0,7,3290,3.0,1448.0,972.0
0.005,6,10,2006,5,927,1.0,659.0,659.0,5,1079,1.0,811.0,811.0
0.005,6,10,1547,5,764,1.0,496.0,496.0,5,783,1.0,515.0,515.0
0.001,17,2,180,1,66,0.0,38.0,38.0,1,114,0.0,86.0,86.0
0.003,17,4,284,2,120,0.0,32.0,32.0,2,164,0.0,60.0,54.0
0.006,6,10,1854,5,889,1.0,621.0,621.0,5,965,1.0,697.0,697.0
0.009,6,10,1983,5,910,2.0,642.0,642.0,5,1073,2.0,805.0,805.0
0.008,6,12,1926,6,1189,1.0,659.0,434.0,6,737,1.0,417.0,417.0
0.103,6,10,1506,5,395,23.0,127.0,127.0,5,1111,23.0,843.0,843.0
0.07,6,10,1506,5,395,14.0,127.0,127.0,5,1111,16.0,843.0,843.0
0.003,17,2,148,1,60,0.0,32.0,32.0,1,88,0.0,60.0,60.0
0.02,6,10,1990,5,911,4.0,643.0,643.0,5,1079,5.0,811.0,811.0
0.004,6,10,2006,5,927,1.0,659.0,659.0,5,1079,1.0,811.0,811.0
0.005,6,10,2007,5,928,1.0,660.0,660.0,5,1079,1.0,811.0,811.0
0.013,6,10,1972,5,910,3.0,642.0,642.0,5,1062,3.0,794.0,794.0
0.017,6,10,1989,5,910,4.0,642.0,642.0,5,1079,4.0,811.0,811.0
0.008,6,10,1547,5,764,2.0,496.0,496.0,5,783,1.0,515.0,515.0
0.006,6,10,1689,5,839,1.0,571.0,571.0,5,850,1.0,582.0,582.0
0.052,17,2,148,1,60,0.0,32.0,32.0,1,88,0.0,60.0,60.0
0.011,6,10,1989,5,910,2.0,642.0,642.0,5,1079,2.0,811.0,811.0
178.065,17,82,11909,41,2755,4451.0,44.0,39.0,41,9154,4451.0,239.0,195.0
0.001,17,2,180,1,66,0.0,38.0,38.0,1,114,0.0,86.0,86.0
0.007,17,2,194,1,59,0.0,31.0,31.0,1,135,0.0,107.0,107.0
240.501,6,33,8619,17,1821,15029.0,554.0,185.0,16,6798,16031.0,1402.0,597.0
15.077,17,18,8915,8,6563,2149.0,1350.0,792.0,10,2352,1672.0,1350.0,207.0
0.005,17,2,140,1,62,0.0,34.0,34.0,1,78,0.0,50.0,50.0
0.001,17,2,179,1,62,0.0,34.0,34.0,1,117,0.0,89.0,89.0
0.165,17,2,152,1,76,0.0,48.0,48.0,1,76,0.0,48.0,48.0
0.007,6,12,1698,6,863,1.0,327.0,271.0,6,835,1.0,515.0,515.0
0.009,6,10,1990,5,911,2.0,643.0,643.0,5,1079,2.0,811.0,811.0
0.003,17,2,152,1,76,0.0,48.0,48.0,1,76,0.0,48.0,48.0
40.066,17,10,676,5,460,10013.0,104.0,64.0,5,216,10015.0,20.0,15.0
0.004,17,2,184,1,61,0.0,33.0,33.0,1,123,0.0,95.0,95.0
0.004,17,2,148,1,60,0.0,32.0,32.0,1,88,0.0,60.0,60.0
0.015,6,13,3735,7,497,2.0,125.0,125.0,6,3238,3.0,1470.0,1459.0
0.006,6,10,1643,5,860,1.0,592.0,592.0,5,783,1.0,515.0,515.0
0.13,6,29,10268,16,8994,8.0,2261.0,816.0,13,1274,10.0,268.0,99.0
0.089,6,10,1506,5,395,19.0,127.0,127.0,5,1111,20.0,843.0,843.0
0.006,6,10,1643,5,860,1.0,592.0,592.0,5,783,1.0,515.0,515.0
17.493,6,34,6304,18,1338,1029.0,267.0,195.0,16,4966,573.0,1823.0,392.0
0.005,6,10,2007,5,928,1.0,660.0,660.0,5,1079,1.0,811.0,811.0
0.006,6,10,1779,5,928,1.0,660.0,660.0,5,851,1.0,583.0,583.0
0.004,6,10,1989,5,927,1.0,659.0,659.0,5,1062,1.0,794.0,794.0
0.103,6,10,1506,5,395,22.0,127.0,127.0,5,1111,24.0,843.0,843.0
0.01,6,13,3735,7,497,1.0,125.0,125.0,6,3238,1.0,1470.0,1459.0
0.005,6,10,2000,5,927,1.0,659.0,659.0,5,1073,1.0,805.0,805.0
171.58,17,72,10131,36,2401,4901.0,44.0,38.0,36,7730,4902.0,260.0,186.0
0.005,17,2,169,1,62,0.0,34.0,34.0,1,107,0.0,79.0,79.0
0.005,6,10,1989,5,927,1.0,659.0,659.0,5,1062,1.0,794.0,794.0
0.008,6,12,1926,6,1189,1.0,659.0,434.0,6,737,1.0,417.0,417.0
0.113,6,10,1506,5,395,26.0,127.0,127.0,5,1111,22.0,843.0,843.0
0.009,6,12,1926,6,1189,1.0,659.0,434.0,6,737,1.0,417.0,417.0
0.005,6,10,2006,5,927,1.0,659.0,659.0,5,1079,1.0,811.0,811.0
0.004,17,4,284,2,120,0.0,32.0,32.0,2,164,0.0,60.0,54.0
0.005,6,10,2006,5,927,1.0,659.0,659.0,5,1079,1.0,811.0,811.0
0.005,17,2,170,1,65,0.0,37.0,37.0,1,105,0.0,77.0,77.0
0.006,17,2,230,1,68,0.0,40.0,40.0,1,162,0.0,134.0,134.0
0.006,6,10,1547,5,764,1.0,496.0,496.0,5,783,1.0,515.0,515.0
0.074,6,10,1506,5,395,16.0,127.0,127.0,5,1111,15.0,843.0,843.0
0.174,17,2,152,1,76,0.0,48.0,48.0,1,76,0.0,48.0,48.0
0.004,17,2,136,1,60,0.0,32.0,32.0,1,76,0.0,48.0,48.0
0.001,17,2,180,1,66,0.0,38.0,38.0,1,114,0.0,86.0,86.0
0.005,6,10,1989,5,927,1.0,659.0,659.0,5,1062,1.0,794.0,794.0
0.006,6,10,1779,5,928,1.0,660.0,660.0,5,851,1.0,583.0,583.0
308.561,17,20,1124,10,716,34270.0,48.0,43.0,10,408,34270.0,20.0,12.0
0.006,17,2,170,1,65,0.0,37.0,37.0,1,105,0.0,77.0,77.0
308.483,17,20,1124,10,716,34261.0,48.0,43.0,10,408,34260.0,20.0,12.0
0.005,6,10,2006,5,927,1.0,659.0,659.0,5,1079,1.0,811.0,811.0
0.098,6,10,1506,5,395,23.0,127.0,127.0,5,1111,24.0,843.0,843.0
0.071,17,8,3613,4,1874,23.0,1350.0,440.0,4,1739,12.0,1350.0,406.0
0.006,6,12,1698,6,863,1.0,327.0,271.0,6,835,1.0,515.0,515.0
240.011,6,9,787,5,488,60002.0,232.0,232.0,4,299,80002.0,83.0,83.0
0.005,6,10,1689,5,839,1.0,571.0,571.0,5,850,1.0,582.0,582.0
0.015,6,10,1989,5,910,3.0,642.0,642.0,5,1079,3.0,811.0,811.0
40.066,17,10,676,5,460,10014.0,104.0,64.0,5,216,10015.0,20.0,15.0
10.943,17,28,4423,14,1994,832.0,269.0,114.0,14,2429,832.0,588.0,145.0
0.006,6,10,1854,5,889,1.0,621.0,621.0,5,965,1.0,697.0,697.0
0.01,6,10,1989,5,910,2.0,642.0,642.0,5,1079,2.0,811.0,811.0
0.009,6,12,1926,6,1189,1.0,659.0,434.0,6,737,1.0,417.0,417.0
10.823,17,28,4418,14,1994,824.0,269.0,114.0,14,2424,823.0,587.0,145.0
0.089,6,10,1506,5,395,20.0,127.0,127.0,5,1111,21.0,843.0,843.0
0.009,6,10,1989,5,910,2.0,642.0,642.0,5,1079,2.0,811.0,811.0
0.007,17,2,179,1,71,0.0,43.0,43.0,1,108,0.0,80.0,80.0
0.074,17,8,3613,4,1874,24.0,1350.0,440.0,4,1739,11.0,1350.0,406.0
0.075,6,10,1506,5,395,16.0,127.0,127.0,5,1111,17.0,843.0,843.0
0.001,17,2,164,1,74,0.0,46.0,46.0,1,90,0.0,62.0,62.0
0.216,6,16,2777,8,1395,30.0,533.0,323.0,8,1382,19.0,529.0,239.0
0.015,6,10,1983,5,910,3.0,642.0,642.0,5,1073,3.0,805.0,805.0
0.011,6,10,1990,5,911,2.0,643.0,643.0,5,1079,2.0,811.0,811.0
0.068,17,8,3613,4,1874,22.0,1350.0,440.0,4,1739,11.0,1350.0,406.0
0.075,6,18,8134,10,808,8.0,280.0,280.0,8,7326,10.0,1402.0,1380.0
0.005,17,2,179,1,71,0.0,43.0,43.0,1,108,0.0,80.0,80.0
40.083,17,10,676,5,460,10018.0,104.0,64.0,5,216,10019.0,20.0,15.0
0.019,6,10,1972,5,910,4.0,642.0,642.0,5,1062,4.0,794.0,794.0
0.109,6,10,1506,5,395,25.0,127.0,127.0,5,1111,25.0,843.0,843.0
15.115,17,15,9239,8,6902,2151.0,1350.0,834.0,7,2337,2512.0,1350.0,305.0
0.005,6,14,3742,7,452,0.0,80.0,80.0,7,3290,0.0,1448.0,972.0
0.093,6,10,1506,5,395,20.0,127.0,127.0,5,1111,20.0,843.0,843.0
0.005,6,10,1774,5,923,1.0,655.0,655.0,5,851,1.0,583.0,583.0
0.005,17,2,179,1,71,0.0,43.0,43.0,1,108,0.0,80.0,80.0
0.005,17,2,179,1,71,0.0,43.0,43.0,1,108,0.0,80.0,80.0
0.005,6,10,2007,5,928,1.0,660.0,660.0,5,1079,1.0,811.0,811.0
66.109,6,29,8049,18,2232,3888.0,253.0,214.0,11,5817,6610.0,1402.0,654.0
0.068,6,10,1506,5,395,16.0,127.0,127.0,5,1111,15.0,843.0,843.0
0.015,6,10,1762,5,911,3.0,643.0,643.0,5,851,3.0,583.0,583.0
0.009,6,10,1990,5,911,2.0,643.0,643.0,5,1079,2.0,811.0,811.0
0.071,6,10,1506,5,395,17.0,127.0,127.0,5,1111,15.0,843.0,843.0
0.039,17,4,580,2,122,1.0,33.0,33.0,2,458,1.0,307.0,201.0
0.005,6,10,1689,5,839,1.0,571.0,571.0,5,850,1.0,582.0,582.0
0.023,6,10,1983,5,910,5.0,642.0,642.0,5,1073,5.0,805.0,805.0
0.004,6,10,1774,5,923,1.0,655.0,655.0,5,851,1.0,583.0,583.0
0.022,6,10,1990,5,911,5.0,643.0,643.0,5,1079,5.0,811.0,811.0
134.72,6,22,8500,12,2236,75.0,1345.0,574.0,10,6264,14949.0,2720.0,975.0
0.007,6,12,1698,6,863,1.0,327.0,271.0,6,835,1.0,515.0,515.0
0.005,17,2,186,1,60,0.0,32.0,32.0,1,126,0.0,98.0,98.0
0.037,17,4,284,2,120,1.0,32.0,32.0,2,164,33.0,60.0,54.0
0.004,6,10,2007,5,928,1.0,660.0,660.0,5,1079,1.0,811.0,811.0
0.011,6,10,1762,5,911,2.0,643.0,643.0,5,851,2.0,583.0,583.0
40.066,17,10,676,5,460,10013.0,104.0,64.0,5,216,10010.0,20.0,15.0
1778.647,17,144,45504,72,22752,25051.0,288.0,288.0,72,22752,25051.0,288.0,288.0
0.01,6,10,1677,5,827,2.0,559.0,559.0,5,850,2.0,582.0,582.0
0.003,17,2,148,1,60,0.0,32.0,32.0,1,88,0.0,60.0,60.0
0.006,17,2,179,1,71,0.0,43.0,43.0,1,108,0.0,80.0,80.0
0.012,6,10,1989,5,910,3.0,642.0,642.0,5,1079,3.0,811.0,811.0
0.006,6,10,1689,5,839,1.0,571.0,571.0,5,850,1.0,582.0,582.0
1799.994,17,2993,229490,1486,120560,1212.0,84.0,53.0,1507,108930,1195.0,227.0,44.0
1730.399,6,45,2790,30,1725,59668.0,35.0,35.0,15,1065,123593.0,31.0,31.0
0.007,6,10,1989,5,927,1.0,659.0,659.0,5,1062,1.0,794.0,794.0
40.088,17,10,676,5,460,10018.0,104.0,64.0,5,216,10021.0,20.0,15.0
0.006,6,12,1698,6,863,1.0,327.0,271.0,6,835,1.0,515.0,515.0
0.001,17,2,180,1,66,0.0,38.0,38.0,1,114,0.0,86.0,86.0
0.129,6,10,1506,5,395,29.0,127.0,127.0,5,1111,31.0,843.0,843.0
0.115,6,10,1506,5,395,26.0,127.0,127.0,5,1111,26.0,843.0,843.0
0.005,6,10,1689,5,839,1.0,571.0,571.0,5,850,1.0,582.0,582.0
11.552,17,28,4399,14,2312,876.0,587.0,137.0,14,2087,876.0,270.0,121.0
0.114,6,10,1506,5,395,26.0,127.0,127.0,5,1111,23.0,843.0,843.0
0.001,17,2,180,1,66,0.0,38.0,38.0,1,114,0.0,86.0,86.0
0.006,6,10,1689,5,839,1.0,571.0,571.0,5,850,1.0,582.0,582.0
0.04,6,10,1762,5,911,10.0,643.0,643.0,5,851,9.0,583.0,583.0
40.054,17,10,676,5,460,10012.0,104.0,64.0,5,216,10012.0,20.0,15.0
0.071,17,2,156,1,64,0.0,36.0,36.0,1,92,0.0,64.0,64.0
0.008,6,10,1989,5,910,2.0,642.0,642.0,5,1079,1.0,811.0,811.0
11.027,17,28,4416,14,1993,839.0,268.0,114.0,14,2423,839.0,586.0,145.0
0.013,6,13,3735,7,497,2.0,125.0,125.0,6,3238,2.0,1470.0,1459.0
0.005,6,10,2000,5,927,1.0,659.0,659.0,5,1073,1.0,805.0,805.0
0.015,6,10,1983,5,910,3.0,642.0,642.0,5,1073,3.0,805.0,805.0
0.171,6,3,453,2,321,171.0,241.0,241.0,1,132,0.0,92.0,92.0
240.114,6,16,4480,9,963,30014.0,238.0,166.0,7,3517,40018.0,1402.0,786.0
0.089,6,10,1506,5,395,19.0,127.0,127.0,5,1111,17.0,843.0,843.0
352.253,6,20,2210,6,1308,12004.0,494.0,494.0,14,902,27096.0,83.0,83.0
0.037,17,2,182,1,65,0.0,37.0,37.0,1,117,0.0,89.0,89.0
308.677,17,20,1124,10,716,34283.0,48.0,43.0,10,408,34283.0,20.0,12.0
0.005,6,10,2006,5,927,1.0,659.0,659.0,5,1079,1.0,811.0,811.0
0.005,17,2,180,1,66,0.0,38.0,38.0,1,114,0.0,86.0,86.0
0.012,6,10,1989,5,910,2.0,642.0,642.0,5,1079,2.0,811.0,811.0
40.063,17,10,676,5,460,10013.0,104.0,64.0,5,216,10015.0,20.0,15.0
0.005,6,10,2007,5,928,1.0,660.0,660.0,5,1079,1.0,811.0,811.0
0.077,6,10,1506,5,395,17.0,127.0,127.0,5,1111,18.0,843.0,843.0
0.106,6,10,1506,5,395,22.0,127.0,127.0,5,1111,22.0,843.0,843.0
240.666,6,35,8923,18,2071,14154.0,692.0,225.0,17,6852,15039.0,1402.0,597.0
167.156,17,74,10511,37,2453,4642.0,44.0,38.0,37,8058,4643.0,239.0,189.0
0.019,6,10,1989,5,910,4.0,642.0,642.0,5,1079,4.0,811.0,811.0
0.011,6,14,3787,7,497,1.0,125.0,125.0,7,3290,1.0,1448.0,972.0
0.003,17,2,136,1,60,0.0,32.0,32.0,1,76,0.0,48.0,48.0
0.016,6,10,1989,5,910,4.0,642.0,642.0,5,1079,3.0,811.0,811.0
10.963,17,28,4398,14,2312,834.0,587.0,137.0,14,2086,834.0,269.0,121.0
0.005,6,10,2007,5,928,1.0,660.0,660.0,5,1079,1.0,811.0,811.0
0.02,6,10,1972,5,910,4.0,642.0,642.0,5,1062,5.0,794.0,794.0
0.01,6,10,1762,5,911,2.0,643.0,643.0,5,851,2.0,583.0,583.0
40.071,17,10,676,5,460,10017.0,104.0,64.0,5,216,10017.0,20.0,15.0
0.006,17,2,170,1,65,0.0,37.0,37.0,1,105,0.0,77.0,77.0
0.005,17,2,158,1,63,0.0,35.0,35.0,1,95,0.0,67.0,67.0
0.009,6,10,1989,5,910,2.0,642.0,642.0,5,1079,2.0,811.0,811.0
0.015,17,2,180,1,66,0.0,38.0,38.0,1,114,0.0,86.0,86.0
0.024,6,10,1989,5,910,6.0,642.0,642.0,5,1079,6.0,811.0,811.0
0.11,6,10,1506,5,395,24.0,127.0,127.0,5,1111,25.0,843.0,843.0
0.006,6,10,2006,5,927,1.0,659.0,659.0,5,1079,1.0,811.0,811.0
0.005,6,14,3736,7,446,0.0,74.0,74.0,7,3290,0.0,1448.0,972.0
0.013,6,10,1762,5,911,3.0,643.0,643.0,5,851,3.0,583.0,583.0
0.007,6,10,1983,5,910,1.0,642.0,642.0,5,1073,1.0,805.0,805.0
0.005,17,4,284,2,120,1.0,32.0,32.0,2,164,2.0,60.0,54.0
0.009,6,10,1983,5,910,2.0,642.0,642.0,5,1073,2.0,805.0,805.0
0.004,6,10,2006,5,927,1.0,659.0,659.0,5,1079,1.0,811.0,811.0
0.013,6,10,1990,5,911,3.0,643.0,643.0,5,1079,3.0,811.0,811.0
0.005,17,2,164,1,74,0.0,46.0,46.0,1,90,0.0,62.0,62.0
0.003,17,2,148,1,60,0.0,32.0,32.0,1,88,0.0,60.0,60.0
40.055,17,10,676,5,460,10012.0,104.0,64.0,5,216,10013.0,20.0,15.0
0.06,17,2,80,1,32,0.0,4.0,4.0,1,48,0.0,20.0,20.0
0.015,6,10,1983,5,910,3.0,642.0,642.0,5,1073,3.0,805.0,805.0
40.071,17,10,676,5,460,10014.0,104.0,64.0,5,216,10012.0,20.0,15.0
0.171,6,3,453,2,321,171.0,241.0,241.0,1,132,0.0,92.0,92.0
0.09,6,10,1506,5,395,20.0,127.0,127.0,5,1111,19.0,843.0,843.0
0.004,17,2,136,1,60,0.0,32.0,32.0,1,76,0.0,48.0,48.0
0.005,6,10,2006,5,927,1.0,659.0,659.0,5,1079,1.0,811.0,811.0
0.08,6,10,1506,5,395,18.0,127.0,127.0,5,1111,18.0,843.0,843.0
10.825,17,28,4422,14,1993,824.0,268.0,114.0,14,2429,823.0,588.0,145.0
0.09,6,10,1506,5,395,21.0,127.0,127.0,5,1111,18.0,843.0,843.0
0.081,6,10,1506,5,395,18.0,127.0,127.0,5,1111,17.0,843.0,843.0
0.006,17,2,170,1,65,0.0,37.0,37.0,1,105,0.0,77.0,77.0
0.003,17,4,284,2,120,0.0,32.0,32.0,2,164,0.0,60.0,54.0
0.001,17,2,180,1,66,0.0,38.0,38.0,1,114,0.0,86.0,86.0
0.005,6,10,1854,5,889,1.0,621.0,621.0,5,965,1.0,697.0,697.0
0.063,17,2,152,1,76,0.0,48.0,48.0,1,76,0.0,48.0,48.0
0.005,6,10,2006,5,927,1.0,659.0,659.0,5,1079,1.0,811.0,811.0
0.011,6,10,2007,5,928,2.0,660.0,660.0,5,1079,2.0,811.0,811.0
40.063,17,10,676,5,460,10014.0,104.0,64.0,5,216,10015.0,20.0,15.0
1717.238,6,62,7182,41,4385,42930.0,1402.0,107.0,21,2797,85853.0,1116.0,85.0
0.093,6,10,1506,5,395,20.0,127.0,127.0,5,1111,18.0,843.0,843.0
0.067,17,8,3613,4,1874,22.0,1350.0,440.0,4,1739,10.0,1350.0,406.0
0.005,6,10,2007,5,928,1.0,660.0,660.0,5,1079,1.0,811.0,811.0
0.003,17,4,284,2,120,0.0,32.0,32.0,2,164,0.0,60.0,54.0
0.012,6,10,1990,5,911,3.0,643.0,643.0,5,1079,3.0,811.0,811.0
0.006,6,10,1547,5,764,1.0,496.0,496.0,5,783,1.0,515.0,515.0
367.269,6,22,2313,16,867,24484.0,195.0,195.0,6,1446,4639.0,419.0,398.0
0.004,6,10,2007,5,928,1.0,660.0,660.0,5,1079,1.0,811.0,811.0
240.358,6,30,10804,15,4401,17168.0,1756.0,722.0,15,6403,17168.0,1592.0,623.0
352.878,6,20,2210,6,1308,12004.0,494.0,494.0,14,902,27144.0,83.0,83.0
0.079,6,10,1506,5,395,17.0,127.0,127.0,5,1111,16.0,843.0,843.0
291.313,6,401,348780,192,21559,1525.0,2736.0,889.0,209,327221,1400.0,2804.0,1622.0
0.004,6,10,2007,5,928,1.0,660.0,660.0,5,1079,1.0,811.0,811.0
0.348,17,47,20865,23,17153,15.0,1350.0,717.0,24,3712,13.0,1350.0,126.0
0.08,6,10,1506,5,395,16.0,127.0,127.0,5,1111,18.0,843.0,843.0
0.009,6,10,1990,5,911,2.0,643.0,643.0,5,1079,2.0,811.0,811.0
0.016,6,10,1631,5,848,4.0,580.0,580.0,5,783,3.0,515.0,515.0
0.127,6,10,1506,5,395,29.0,127.0,127.0,5,1111,23.0,843.0,843.0
0.006,6,10,1547,5,764,1.0,496.0,496.0,5,783,1.0,515.0,515.0
0.004,6,10,2006,5,927,1.0,659.0,659.0,5,1079,1.0,811.0,811.0
240.019,6,9,787,5,488,60004.0,232.0,232.0,4,299,80005.0,83.0,83.0
0.005,6,10,2007,5,928,1.0,660.0,660.0,5,1079,1.0,811.0,811.0
0.004,17,2,132,1,58,0.0,30.0,30.0,1,74,0.0,46.0,46.0
308.457,17,20,1124,10,716,34258.0,48.0,43.0,10,408,34258.0,20.0,12.0
0.013,17,2,152,1,56,0.0,28.0,28.0,1,96,0.0,68.0,68.0
0.076,6,10,1506,5,395,16.0,127.0,127.0,5,1111,15.0,843.0,843.0
0.023,6,10,1972,5,910,5.0,642.0,642.0,5,1062,5.0,794.0,794.0
0.095,6,10,1506,5,395,20.0,127.0,127.0,5,1111,19.0,843.0,843.0
0.009,6,13,3735,7,497,1.0,125.0,125.0,6,3238,1.0,1470.0,1459.0
0.132,6,10,1506,5,395,26.0,127.0,127.0,5,1111,29.0,843.0,843.0
10.937,17,28,4417,14,1994,832.0,269.0,114.0,14,2423,832.0,586.0,145.0
0.004,6,10,2006,5,927,1.0,659.0,659.0,5,1079,1.0,811.0,811.0
0.006,6,10,1547,5,764,1.0,496.0,496.0,5,783,1.0,515.0,515.0
0.106,6,10,1506,5,395,22.0,127.0,127.0,5,1111,25.0,843.0,843.0
0.015,6,10,1990,5,911,3.0,643.0,643.0,5,1079,3.0,811.0,811.0
0.005,17,2,214,1,75,0.0,47.0,47.0,1,139,0.0,111.0,111.0
0.005,6,10,1779,5,928,1.0,660.0,660.0,5,851,1.0,583.0,583.0
0.114,6,10,1506,5,395,25.0,127.0,127.0,5,1111,28.0,843.0,843.0
0.163,17,2,152,1,76,0.0,48.0,48.0,1,76,0.0,48.0,48.0
40.061,17,10,676,5,460,10014.0,104.0,64.0,5,216,10014.0,20.0,15.0
240.016,6,9,787,5,488,60004.0,232.0,232.0,4,299,80004.0,83.0,83.0
0.004,6,10,1702,5,863,1.0,595.0,595.0,5,839,1.0,571.0,571.0
0.006,6,10,1547,5,764,1.0,496.0,496.0,5,783,1.0,515.0,515.0
0.008,6,10,1762,5,911,2.0,643.0,643.0,5,851,2.0,583.0,583.0
242.299,6,401,349016,196,21723,1242.0,2736.0,886.0,205,327293,1187.0,2804.0,1623.0
0.007,6,10,1547,5,764,1.0,496.0,496.0,5,783,1.0,515.0,515.0
0.117,6,10,1506,5,395,26.0,127.0,127.0,5,1111,25.0,843.0,843.0
0.005,6,10,2006,5,927,1.0,659.0,659.0,5,1079,1.0,811.0,811.0
0.108,6,10,1506,5,395,24.0,127.0,127.0,5,1111,24.0,843.0,843.0
0.005,6,10,2007,5,928,1.0,660.0,660.0,5,1079,1.0,811.0,811.0
0.021,6,10,1983,5,910,5.0,642.0,642.0,5,1073,5.0,805.0,805.0
0.071,6,10,1506,5,395,14.0,127.0,127.0,5,1111,16.0,843.0,843.0
0.008,6,12,1926,6,1189,1.0,659.0,434.0,6,737,1.0,417.0,417.0
0.078,6,10,1506,5,395,15.0,127.0,127.0,5,1111,16.0,843.0,843.0
0.006,6,10,2007,5,928,1.0,660.0,660.0,5,1079,1.0,811.0,811.0
0.001,17,2,180,1,66,0.0,38.0,38.0,1,114,0.0,86.0,86.0
0.005,17,2,169,1,62,0.0,34.0,34.0,1,107,0.0,79.0,79.0
0.005,6,10,2007,5,928,1.0,660.0,660.0,5,1079,1.0,811.0,811.0
0.076,6,10,1506,5,395,15.0,127.0,127.0,5,1111,17.0,843.0,843.0
0.063,6,10,1506,5,395,13.0,127.0,127.0,5,1111,13.0,843.0,843.0
0.007,6,10,1547,5,764,1.0,496.0,496.0,5,783,1.0,515.0,515.0
0.005,6,10,2006,5,927,1.0,659.0,659.0,5,1079,1.0,811.0,811.0
0.011,6,10,1989,5,910,2.0,642.0,642.0,5,1079,2.0,811.0,811.0
0.004,17,2,148,1,60,0.0,32.0,32.0,1,88,0.0,60.0,60.0
0.057,17,2,179,1,71,0.0,43.0,43.0,1,108,0.0,80.0,80.0
0.007,6,10,1547,5,764,1.0,496.0,496.0,5,783,1.0,515.0,515.0
0.105,6,10,1506,5,395,23.0,127.0,127.0,5,1111,23.0,843.0,843.0
0.082,6,10,1506,5,395,17.0,127.0,127.0,5,1111,19.0,843.0,843.0
0.006,6,10,1689,5,839,1.0,571.0,571.0,5,850,1.0,582.0,582.0
0.043,17,2,136,1,60,0.0,32.0,32.0,1,76,0.0,48.0,48.0
0.015,6,14,3787,7,497,2.0,125.0,125.0,7,3290,2.0,1448.0,972.0
0.109,6,10,1506,5,395,26.0,127.0,127.0,5,1111,23.0,843.0,843.0
15.073,17,15,9238,8,6902,2149.0,1350.0,834.0,7,2336,2507.0,1350.0,305.0
0.071,17,2,170,1,65,0.0,37.0,37.0,1,105,0.0,77.0,77.0
0.027,6,10,1989,5,910,6.0,642.0,642.0,5,1079,6.0,811.0,811.0
365.999,6,22,2313,16,867,24399.0,195.0,195.0,6,1446,4636.0,419.0,398.0
9.035,17,6,376,5,280,2258.0,28.0,28.0,1,96,0.0,68.0,68.0
0.103,6,10,1506,5,395,22.0,127.0,127.0,5,1111,23.0,843.0,843.0
0.01,6,10,1989,5,910,2.0,642.0,642.0,5,1079,2.0,811.0,811.0
0.081,6,10,1506,5,395,18.0,127.0,127.0,5,1111,19.0,843.0,843.0
0.005,6,10,2006,5,927,1.0,659.0,659.0,5,1079,1.0,811.0,811.0
0.011,6,10,1677,5,827,2.0,559.0,559.0,5,850,2.0,582.0,582.0
0.004,17,4,284,2,120,0.0,32.0,32.0,2,164,1.0,60.0,54.0
0.016,6,10,1990,5,911,4.0,643.0,643.0,5,1079,4.0,811.0,811.0
0.006,6,10,1689,5,839,1.0,571.0,571.0,5,850,1.0,582.0,582.0
0.016,6,10,1989,5,910,4.0,642.0,642.0,5,1079,3.0,811.0,811.0
0.006,17,4,420,2,122,0.0,33.0,33.0,2,298,0.0,145.0,121.0
0.005,17,2,166,1,75,0.0,47.0,47.0,1,91,0.0,63.0,63.0
0.004,6,10,1702,5,863,1.0,595.0,595.0,5,839,0.0,571.0,571.0
1.452,6,35,8390,18,1958,85.0,890.0,402.0,17,6432,82.0,2126.0,478.0
0.013,6,10,1677,5,827,3.0,559.0,559.0,5,850,3.0,582.0,582.0
0.001,17,2,180,1,66,0.0,38.0,38.0,1,114,0.0,86.0,86.0
0.005,6,10,1989,5,927,1.0,659.0,659.0,5,1062,1.0,794.0,794.0
0.068,6,10,1506,5,395,15.0,127.0,127.0,5,1111,14.0,843.0,843.0
0.016,6,10,1631,5,848,4.0,580.0,580.0,5,783,3.0,515.0,515.0
0.005,6,10,2006,5,927,1.0,659.0,659.0,5,1079,1.0,811.0,811.0
0.013,6,10,1983,5,910,3.0,642.0,642.0,5,1073,3.0,805.0,805.0
0.016,6,10,1677,5,827,4.0,559.0,559.0,5,850,3.0,582.0,582.0
0.005,6,13,3747,7,509,0.0,137.0,137.0,6,3238,1.0,1470.0,1459.0
0.07,17,8,3613,4,1874,23.0,1350.0,440.0,4,1739,11.0,1350.0,406.0
0.005,6,10,1547,5,764,1.0,496.0,496.0,5,783,1.0,515.0,515.0
0.006,6,10,1854,5,889,1.0,621.0,621.0,5,965,1.0,697.0,697.0
0.005,17,2,214,1,75,0.0,47.0,47.0,1,139,0.0,111.0,111.0
0.008,6,10,2000,5,927,2.0,659.0,659.0,5,1073,1.0,805.0,805.0
40.055,17,10,676,5,460,10012.0,104.0,64.0,5,216,10012.0,20.0,15.0
0.12,6,10,1506,5,395,27.0,127.0,127.0,5,1111,27.0,843.0,843.0
0.005,17,2,146,1,65,0.0,37.0,37.0,1,81,0.0,53.0,53.0
0.122,6,10,1506,5,395,26.0,127.0,127.0,5,1111,26.0,843.0,843.0
168.07,17,82,11673,41,2753,4201.0,44.0,39.0,41,8920,4201.0,261.0,189.0
0.01,6,10,1990,5,911,2.0,643.0,643.0,5,1079,2.0,811.0,811.0
0.021,6,10,1989,5,910,5.0,642.0,642.0,5,1079,5.0,811.0,811.0
0.001,17,2,180,1,66,0.0,38.0,38.0,1,114,0.0,86.0,86.0
0.093,6,10,1506,5,395,22.0,127.0,127.0,5,1111,20.0,843.0,843.0
0.004,6,10,2006,5,927,1.0,659.0,659.0,5,1079,1.0,811.0,811.0
0.005,6,10,2000,5,927,1.0,659.0,659.0,5,1073,1.0,805.0,805.0
0.017,6,10,1972,5,910,4.0,642.0,642.0,5,1062,4.0,794.0,794.0
1786.626,6,150,19350,90,13740,20074.0,302.0,302.0,60,5610,30281.0,83.0,83.0
0.001,17,2,136,1,60,0.0,32.0,32.0,1,76,0.0,48.0,48.0
0.127,6,10,1506,5,395,29.0,127.0,127.0,5,1111,29.0,843.0,843.0
0.218,6,16,2778,8,1396,31.0,533.0,324.0,8,1382,19.0,529.0,239.0
10.747,17,28,4421,14,1993,818.0,268.0,114.0,14,2428,817.0,587.0,145.0
0.001,17,2,180,1,66,0.0,38.0,38.0,1,114,0.0,86.0,86.0
0.093,6,10,1506,5,395,22.0,127.0,127.0,5,1111,20.0,843.0,843.0
0.07,17,8,3613,4,1874,23.0,1350.0,440.0,4,1739,11.0,1350.0,406.0
0.014,6,10,1983,5,910,3.0,642.0,642.0,5,1073,3.0,805.0,805.0
0.016,6,13,3735,7,497,2.0,125.0,125.0,6,3238,3.0,1470.0,1459.0
0.005,6,10,2006,5,927,1.0,659.0,659.0,5,1079,1.0,811.0,811.0
0.006,6,10,1689,5,839,1.0,571.0,571.0,5,850,1.0,582.0,582.0
0.075,6,10,1506,5,395,16.0,127.0,127.0,5,1111,16.0,843.0,843.0
0.008,6,12,1926,6,1189,1.0,659.0,434.0,6,737,1.0,417.0,417.0
0.005,6,10,2006,5,927,1.0,659.0,659.0,5,1079,1.0,811.0,811.0
0.006,6,10,1643,5,860,1.0,592.0,592.0,5,783,1.0,515.0,515.0
0.001,17,2,136,1,60,0.0,32.0,32.0,1,76,0.0,48.0,48.0
0.21,6,16,2777,8,1395,30.0,533.0,323.0,8,1382,19.0,529.0,239.0
0.004,6,10,2006,5,927,1.0,659.0,659.0,5,1079,1.0,811.0,811.0
0.005,17,2,230,1,68,0.0,40.0,40.0,1,162,0.0,134.0,134.0
0.032,6,14,3787,7,497,5.0,125.0,125.0,7,3290,5.0,1448.0,972.0
0.005,6,10,1989,5,927,1.0,659.0,659.0,5,1062,1.0,794.0,794.0
0.011,6,12,1926,6,1189,2.0,659.0,434.0,6,737,2.0,417.0,417.0
0.088,6,10,1506,5,395,16.0,127.0,127.0,5,1111,20.0,843.0,843.0
0.006,6,10,1547,5,764,1.0,496.0,496.0,5,783,1.0,515.0,515.0
0.008,6,10,1990,5,911,2.0,643.0,643.0,5,1079,2.0,811.0,811.0
0.005,6,10,1779,5,928,1.0,660.0,660.0,5,851,1.0,583.0,583.0
0.001,17,2,180,1,66,0.0,38.0,38.0,1,114,0.0,86.0,86.0
0.066,6,10,1506,5,395,14.0,127.0,127.0,5,1111,14.0,843.0,843.0
0.121,6,10,1506,5,395,26.0,127.0,127.0,5,1111,28.0,843.0,843.0
0.02,6,10,1762,5,911,5.0,643.0,643.0,5,851,5.0,583.0,583.0
0.053,6,10,1506,5,395,12.0,127.0,127.0,5,1111,12.0,843.0,843.0
0.02,6,10,1631,5,848,4.0,580.0,580.0,5,783,4.0,515.0,515.0
0.076,6,10,1506,5,395,15.0,127.0,127.0,5,1111,16.0,843.0,843.0
0.005,6,10,1689,5,839,1.0,571.0,571.0,5,850,1.0,582.0,582.0
0.004,6,14,3742,8,504,0.0,80.0,80.0,6,3238,0.0,1470.0,1459.0
0.035,6,10,1990,5,911,8.0,643.0,643.0,5,1079,8.0,811.0,811.0
0.013,6,14,3787,7,497,2.0,125.0,125.0,7,3290,2.0,1448.0,972.0
0.006,6,10,1689,5,839,1.0,571.0,571.0,5,850,1.0,582.0,582.0
0.006,6,10,2006,5,927,1.0,659.0,659.0,5,1079,1.0,811.0,811.0
0.005,6,10,1689,5,839,1.0,571.0,571.0,5,850,1.0,582.0,582.0
0.009,17,4,284,2,120,5.0,32.0,32.0,2,164,5.0,60.0,54.0
0.005,6,10,2000,5,927,1.0,659.0,659.0,5,1073,1.0,805.0,805.0
0.005,17,2,169,1,62,0.0,34.0,34.0,1,107,0.0,79.0,79.0
0.005,17,2,144,1,64,0.0,36.0,36.0,1,80,0.0,52.0,52.0
0.004,17,4,420,2,122,0.0,33.0,33.0,2,298,0.0,145.0,121.0
0.006,17,2,194,1,59,0.0,31.0,31.0,1,135,0.0,107.0,107.0
0.005,6,10,2000,5,927,1.0,659.0,659.0,5,1073,1.0,805.0,805.0
0.004,6,10,2007,5,928,1.0,660.0,660.0,5,1079,1.0,811.0,811.0
40.091,17,10,676,5,460,10021.0,104.0,64.0,5,216,10021.0,20.0,15.0
0.001,17,2,180,1,66,0.0,38.0,38.0,1,114,0.0,86.0,86.0
0.012,6,10,1677,5,827,3.0,559.0,559.0,5,850,2.0,582.0,582.0
0.005,17,2,169,1,62,0.0,34.0,34.0,1,107,0.0,79.0,79.0
0.053,17,2,152,1,76,0.0,48.0,48.0,1,76,0.0,48.0,48.0
240.131,6,46,6774,22,3227,11434.0,588.0,230.0,24,3547,10440.0,580.0,208.0
177.327,17,74,10569,37,2473,4925.0,44.0,38.0,37,8096,4925.0,239.0,190.0
0.159,6,10,1506,5,395,37.0,127.0,127.0,5,1111,31.0,843.0,843.0
0.039,17,2,412,1,61,0.0,33.0,33.0,1,351,0.0,323.0,323.0
0.004,6,10,2007,5,928,1.0,660.0,660.0,5,1079,1.0,811.0,811.0
0.206,6,16,2778,8,1396,29.0,533.0,324.0,8,1382,18.0,529.0,239.0
0.235,6,10,1506,5,395,35.0,127.0,127.0,5,1111,45.0,843.0,843.0
165.094,17,66,9281,33,2194,5158.0,44.0,38.0,33,7087,5159.0,239.0,186.0
0.142,6,10,1506,5,395,32.0,127.0,127.0,5,1111,33.0,843.0,843.0
0.04,17,2,182,1,65,0.0,37.0,37.0,1,117,0.0,89.0,89.0
174.285,17,104,14684,52,3490,3417.0,44.0,39.0,52,11194,3417.0,239.0,187.0
0.006,6,10,1547,5,764,1.0,496.0,496.0,5,783,1.0,515.0,515.0
15.075,17,16,8497,8,6230,2149.0,1350.0,750.0,8,2267,2149.0,1350.0,255.0
15.118,17,18,13388,9,8280,1886.0,1350.0,892.0,9,5108,1886.0,1350.0,539.0
0.074,6,10,1506,5,395,16.0,127.0,127.0,5,1111,17.0,843.0,843.0
0.006,6,10,1547,5,764,1.0,496.0,496.0,5,783,1.0,515.0,515.0
0.005,6,10,2007,5,928,1.0,660.0,660.0,5,1079,1.0,811.0,811.0
40.076,17,10,676,5,460,10016.0,104.0,64.0,5,216,10018.0,20.0,15.0
0.083,6,10,1506,5,395,20.0,127.0,127.0,5,1111,17.0,843.0,843.0
0.011,6,10,1677,5,827,2.0,559.0,559.0,5,850,2.0,582.0,582.0
0.016,6,10,1762,5,911,3.0,643.0,643.0,5,851,4.0,583.0,583.0
0.006,6,10,1547,5,764,1.0,496.0,496.0,5,783,1.0,515.0,515.0
353.593,6,20,2210,6,1308,12003.0,494.0,494.0,14,902,27199.0,83.0,83.0
0.005,6,10,1689,5,839,1.0,571.0,571.0,5,850,1.0,582.0,582.0
0.001,17,2,180,1,66,0.0,38.0,38.0,1,114,0.0,86.0,86.0
0.005,6,10,2006,5,927,1.0,659.0,659.0,5,1079,1.0,811.0,811.0
0.005,6,10,2007,5,928,1.0,660.0,660.0,5,1079,1.0,811.0,811.0
0.004,6,10,2007,5,928,1.0,660.0,660.0,5,1079,1.0,811.0,811.0
0.005,6,10,2007,5,928,1.0,660.0,660.0,5,1079,1.0,811.0,811.0
0.008,6,10,1989,5,910,2.0,642.0,642.0,5,1079,2.0,811.0,811.0
0.001,17,2,180,1,66,0.0,38.0,38.0,1,114,0.0,86.0,86.0
0.068,6,10,1506,5,395,15.0,127.0,127.0,5,1111,15.0,843.0,843.0
0.11,6,10,1506,5,395,25.0,127.0,127.0,5,1111,22.0,843.0,843.0
0.009,6,12,1926,6,1189,1.0,659.0,434.0,6,737,1.0,417.0,417.0
0.005,6,10,2007,5,928,1.0,660.0,660.0,5,1079,1.0,811.0,811.0
0.021,17,2,412,1,61,0.0,33.0,33.0,1,351,0.0,323.0,323.0
40.071,17,10,676,5,460,10015.0,104.0,64.0,5,216,10016.0,20.0,15.0
0.005,6,10,2006,5,927,1.0,659.0,659.0,5,1079,1.0,811.0,811.0
0.013,6,10,1989,5,910,3.0,642.0,642.0,5,1079,3.0,811.0,811.0
0.009,6,10,1983,5,910,2.0,642.0,642.0,5,1073,2.0,805.0,805.0
0.172,6,3,453,2,321,172.0,241.0,241.0,1,132,0.0,92.0,92.0
0.237,6,16,2674,8,1400,33.0,533.0,325.0,8,1274,22.0,529.0,212.0
0.005,17,2,144,1,64,0.0,36.0,36.0,1,80,0.0,52.0,52.0
177.114,17,100,14548,50,3360,3614.0,44.0,39.0,50,11188,3614.0,239.0,195.0
0.099,6,10,1506,5,395,21.0,127.0,127.0,5,1111,22.0,843.0,843.0
0.014,6,10,1983,5,910,3.0,642.0,642.0,5,1073,3.0,805.0,805.0
294.109,6,406,348448,208,22379,1420.0,2690.0,888.0,198,326069,1492.0,2804.0,1725.0
0.131,6,10,1506,5,395,29.0,127.0,127.0,5,1111,31.0,843.0,843.0
0.008,6,10,1972,5,910,2.0,642.0,642.0,5,1062,1.0,794.0,794.0
173.067,17,72,10274,36,2398,4944.0,44.0,38.0,36,7876,4944.0,260.0,190.0
0.005,17,2,144,1,64,0.0,36.0,36.0,1,80,0.0,52.0,52.0
0.017,6,10,1989,5,910,4.0,642.0,642.0,5,1079,4.0,811.0,811.0
0.005,17,2,180,1,58,0.0,30.0,30.0,1,122,0.0,94.0,94.0
900.715,6,55,22421,29,5050,32168.0,676.0,441.0,26,17371,33628.0,1402.0,941.0
364.451,6,19,1689,15,978,26032.0,190.0,190.0,4,711,80014.0,495.0,495.0
0.004,6,10,2006,5,927,1.0,659.0,659.0,5,1079,1.0,811.0,811.0
0.001,17,2,180,1,66,0.0,38.0,38.0,1,114,0.0,86.0,86.0
0.005,17,2,214,1,75,0.0,47.0,47.0,1,139,0.0,111.0,111.0
0.073,17,2,136,1,60,0.0,32.0,32.0,1,76,0.0,48.0,48.0
0.011,6,10,1983,5,910,2.0,642.0,642.0,5,1073,2.0,805.0,805.0
0.013,6,10,1989,5,910,3.0,642.0,642.0,5,1079,3.0,811.0,811.0
0.005,6,10,1989,5,927,1.0,659.0,659.0,5,1062,1.0,794.0,794.0
0.006,17,2,230,1,68,0.0,40.0,40.0,1,162,0.0,134.0,134.0
0.068,6,10,1506,5,395,16.0,127.0,127.0,5,1111,14.0,843.0,843.0
0.015,6,10,1983,5,910,3.0,642.0,642.0,5,1073,3.0,805.0,805.0
0.007,6,10,1854,5,889,1.0,621.0,621.0,5,965,1.0,697.0,697.0
0.006,6,10,1547,5,764,1.0,496.0,496.0,5,783,1.0,515.0,515.0
0.005,6,10,2006,5,927,1.0,659.0,659.0,5,1079,1.0,811.0,811.0
0.006,6,10,2000,5,927,1.0,659.0,659.0,5,1073,1.0,805.0,805.0
0.005,6,10,1779,5,928,1.0,660.0,660.0,5,851,1.0,583.0,583.0
0.005,6,10,2006,5,927,1.0,659.0,659.0,5,1079,1.0,811.0,811.0
0.006,6,10,1689,5,839,1.0,571.0,571.0,5,850,1.0,582.0,582.0
0.013,6,10,1989,5,910,3.0,642.0,642.0,5,1079,3.0,811.0,811.0
0.013,6,10,1631,5,848,3.0,580.0,580.0,5,783,3.0,515.0,515.0
0.01,6,10,1972,5,910,2.0,642.0,642.0,5,1062,2.0,794.0,794.0
0.004,6,10,1774,5,923,1.0,655.0,655.0,5,851,1.0,583.0,583.0
0.014,6,10,1989,5,910,3.0,642.0,642.0,5,1079,3.0,811.0,811.0
0.004,17,2,136,1,60,0.0,32.0,32.0,1,76,0.0,48.0,48.0
10.968,17,28,4417,14,1994,834.0,269.0,114.0,14,2423,834.0,586.0,145.0
0.009,6,10,1972,5,910,2.0,642.0,642.0,5,1062,2.0,794.0,794.0
1.374,6,33,13431,19,5932,76.0,2720.0,854.0,14,7499,93.0,2720.0,769.0
351.991,6,20,2210,6,1308,12003.0,494.0,494.0,14,902,27076.0,83.0,83.0
0.004,6,10,2006,5,927,1.0,659.0,659.0,5,1079,1.0,811.0,811.0
0.095,6,10,1506,5,395,23.0,127.0,127.0,5,1111,21.0,843.0,843.0
0.011,6,10,1989,5,910,2.0,642.0,642.0,5,1079,2.0,811.0,811.0
0.012,6,10,1972,5,910,3.0,642.0,642.0,5,1062,3.0,794.0,794.0
40.05,17,10,676,5,460,10011.0,104.0,64.0,5,216,10010.0,20.0,15.0
0.01,6,10,1983,5,910,2.0,642.0,642.0,5,1073,2.0,805.0,805.0
240.292,6,34,14455,16,7697,16019.0,1882.0,981.0,18,6758,14134.0,1657.0,726.0
0.004,6,10,1774,5,923,1.0,655.0,655.0,5,851,1.0,583.0,583.0
0.038,17,4,284,2,120,0.0,32.0,32.0,2,164,34.0,60.0,54.0
0.008,6,10,1990,5,911,2.0,643.0,643.0,5,1079,1.0,811.0,811.0
0.016,6,10,2007,5,928,4.0,660.0,660.0,5,1079,4.0,811.0,811.0
0.023,6,10,1972,5,910,5.0,642.0,642.0,5,1062,5.0,794.0,794.0
0.005,17,2,140,1,62,0.0,34.0,34.0,1,78,0.0,50.0,50.0
0.005,6,10,2007,5,928,1.0,660.0,660.0,5,1079,1.0,811.0,811.0
240.018,6,9,787,5,488,60004.0,232.0,232.0,4,299,80005.0,83.0,83.0
0.004,6,10,1989,5,927,1.0,659.0,659.0,5,1062,1.0,794.0,794.0
0.04,6,10,1677,5,827,9.0,559.0,559.0,5,850,10.0,582.0,582.0
0.005,6,10,2006,5,927,1.0,659.0,659.0,5,1079,1.0,811.0,811.0
0.005,6,10,2006,5,927,1.0,659.0,659.0,5,1079,1.0,811.0,811.0
40.061,17,10,676,5,460,10013.0,104.0,64.0,5,216,10014.0,20.0,15.0
240.153,6,47,6814,21,3171,12007.0,588.0,230.0,26,3643,9606.0,580.0,207.0
0.006,6,10,1643,5,860,1.0,592.0,592.0,5,783,1.0,515.0,515.0
300.393,6,16,2170,9,684,37528.0,146.0,146.0,7,1486,50037.0,419.0,398.0
0.04,17,2,166,1,75,0.0,47.0,47.0,1,91,0.0,63.0,63.0
0.009,6,10,1972,5,910,2.0,642.0,642.0,5,1062,2.0,794.0,794.0
0.012,6,10,1990,5,911,3.0,643.0,643.0,5,1079,3.0,811.0,811.0
0.1,6,10,1506,5,395,21.0,127.0,127.0,5,1111,23.0,843.0,843.0
0.056,6,8,1138,5,751,14.0,495.0,495.0,3,387,18.0,223.0,223.0
40.05,17,10,676,5,460,10011.0,104.0,64.0,5,216,10011.0,20.0,15.0
0.018,6,10,1983,5,910,4.0,642.0,642.0,5,1073,4.0,805.0,805.0
0.006,6,10,1547,5,764,1.0,496.0,496.0,5,783,1.0,515.0,515.0
0.005,6,10,2006,5,927,1.0,659.0,659.0,5,1079,1.0,811.0,811.0
40.071,17,10,676,5,460,10014.0,104.0,64.0,5,216,10016.0,20.0,15.0
0.075,6,10,1506,5,395,18.0,127.0,127.0,5,1111,17.0,843.0,843.0
0.103,6,10,1506,5,395,22.0,127.0,127.0,5,1111,21.0,843.0,843.0
0.02,6,10,1990,5,911,4.0,643.0,643.0,5,1079,4.0,811.0,811.0
0.009,6,12,1926,6,1189,1.0,659.0,434.0,6,737,1.0,417.0,417.0
0.074,6,10,1506,5,395,14.0,127.0,127.0,5,1111,16.0,843.0,843.0
0.003,17,2,185,1,73,0.0,45.0,45.0,1,112,0.0,84.0,84.0
0.019,6,10,1972,5,910,4.0,642.0,642.0,5,1062,4.0,794.0,794.0
0.069,17,8,3613,4,1874,23.0,1350.0,440.0,4,1739,11.0,1350.0,406.0
0.114,6,10,1506,5,395,26.0,127.0,127.0,5,1111,25.0,843.0,843.0
0.128,6,10,1506,5,395,30.0,127.0,127.0,5,1111,29.0,843.0,843.0
0.005,6,10,2006,5,927,1.0,659.0,659.0,5,1079,1.0,811.0,811.0
0.008,6,10,1989,5,910,2.0,642.0,642.0,5,1079,1.0,811.0,811.0
0.005,6,10,1643,5,860,1.0,592.0,592.0,5,783,1.0,515.0,515.0
0.008,17,2,148,1,60,0.0,32.0,32.0,1,88,0.0,60.0,60.0
0.005,6,10,2006,5,927,1.0,659.0,659.0,5,1079,1.0,811.0,811.0
308.444,17,20,1124,10,716,34255.0,48.0,43.0,10,408,34257.0,20.0,12.0
0.004,17,4,284,2,120,0.0,32.0,32.0,2,164,1.0,60.0,54.0
0.022,6,10,1677,5,827,5.0,559.0,559.0,5,850,5.0,582.0,582.0
0.009,6,12,1926,6,1189,1.0,659.0,434.0,6,737,1.0,417.0,417.0
0.009,6,10,2007,5,928,2.0,660.0,660.0,5,1079,2.0,811.0,811.0
0.08,6,10,1506,5,395,18.0,127.0,127.0,5,1111,18.0,843.0,843.0
0.004,17,2,148,1,60,0.0,32.0,32.0,1,88,0.0,60.0,60.0
0.005,6,10,2000,5,927,1.0,659.0,659.0,5,1073,1.0,805.0,805.0
0.016,6,10,1989,5,910,4.0,642.0,642.0,5,1079,4.0,811.0,811.0
0.094,6,10,1506,5,395,22.0,127.0,127.0,5,1111,20.0,843.0,843.0
0.005,17,2,148,1,60,0.0,32.0,32.0,1,88,0.0,60.0,60.0
240.134,6,46,6917,22,3217,11434.0,588.0,229.0,24,3700,10440.0,580.0,222.0
0.103,6,10,1506,5,395,23.0,127.0,127.0,5,1111,23.0,843.0,843.0
0.073,6,10,1506,5,395,17.0,127.0,127.0,5,1111,16.0,843.0,843.0
0.141,6,10,1506,5,395,31.0,127.0,127.0,5,1111,30.0,843.0,843.0
0.071,6,10,1506,5,395,16.0,127.0,127.0,5,1111,16.0,843.0,843.0
0.015,6,10,1631,5,848,3.0,580.0,580.0,5,783,3.0,515.0,515.0
0.009,6,10,1972,5,910,2.0,642.0,642.0,5,1062,2.0,794.0,794.0
0.014,6,10,1990,5,911,3.0,643.0,643.0,5,1079,3.0,811.0,811.0
0.013,6,10,1631,5,848,3.0,580.0,580.0,5,783,3.0,515.0,515.0
0.005,6,10,1989,5,927,1.0,659.0,659.0,5,1062,1.0,794.0,794.0
0.013,17,2,152,1,56,0.0,28.0,28.0,1,96,0.0,68.0,68.0
0.004,6,10,1702,5,863,1.0,595.0,595.0,5,839,0.0,571.0,571.0
0.117,6,10,1506,5,395,24.0,127.0,127.0,5,1111,25.0,843.0,843.0
0.003,17,2,136,1,60,0.0,32.0,32.0,1,76,0.0,48.0,48.0
0.011,6,10,1762,5,911,2.0,643.0,643.0,5,851,2.0,583.0,583.0
0.078,6,10,1506,5,395,18.0,127.0,127.0,5,1111,16.0,843.0,843.0
0.275,17,2,152,1,76,0.0,48.0,48.0,1,76,0.0,48.0,48.0
0.23,6,16,2669,8,1395,32.0,533.0,323.0,8,1274,21.0,529.0,212.0
0.052,17,2,152,1,76,0.0,48.0,48.0,1,76,0.0,48.0,48.0
0.015,6,10,1983,5,910,3.0,642.0,642.0,5,1073,3.0,805.0,805.0
0.015,6,10,1677,5,827,3.0,559.0,559.0,5,850,3.0,582.0,582.0
0.009,6,10,1972,5,910,2.0,642.0,642.0,5,1062,2.0,794.0,794.0
0.009,6,10,1989,5,910,2.0,642.0,642.0,5,1079,2.0,811.0,811.0
0.001,17,2,136,1,60,0.0,32.0,32.0,1,76,0.0,48.0,48.0
0.01,6,10,1983,5,910,2.0,642.0,642.0,5,1073,2.0,805.0,805.0
0.074,6,10,1506,5,395,17.0,127.0,127.0,5,1111,16.0,843.0,843.0
0.116,6,10,1506,5,395,25.0,127.0,127.0,5,1111,25.0,843.0,843.0
0.005,6,10,1854,5,889,1.0,621.0,621.0,5,965,1.0,697.0,697.0
0.004,17,2,148,1,60,0.0,32.0,32.0,1,88,0.0,60.0,60.0
0.004,17,2,136,1,60,0.0,32.0,32.0,1,76,0.0,48.0,48.0
0.016,6,10,1762,5,911,4.0,643.0,643.0,5,851,4.0,583.0,583.0
0.005,17,2,170,1,65,0.0,37.0,37.0,1,105,0.0,77.0,77.0
0.025,6,13,3735,7,497,4.0,125.0,125.0,6,3238,5.0,1470.0,1459.0
0.005,6,10,2000,5,927,1.0,659.0,659.0,5,1073,1.0,805.0,805.0
0.005,6,10,1989,5,927,1.0,659.0,659.0,5,1062,1.0,794.0,794.0
0.066,17,8,3613,4,1874,22.0,1350.0,440.0,4,1739,10.0,1350.0,406.0
0.013,6,10,1989,5,910,3.0,642.0,642.0,5,1079,3.0,811.0,811.0
0.076,6,10,1506,5,395,16.0,127.0,127.0,5,1111,14.0,843.0,843.0
0.01,6,10,1972,5,910,2.0,642.0,642.0,5,1062,2.0,794.0,794.0
0.005,6,13,3747,7,509,0.0,137.0,137.0,6,3238,0.0,1470.0,1459.0
0.013,6,10,1972,5,910,3.0,642.0,642.0,5,1062,3.0,794.0,794.0
0.05,6,14,3868,7,578,8.0,206.0,206.0,7,3290,8.0,1448.0,972.0
0.088,6,10,1506,5,395,17.0,127.0,127.0,5,1111,19.0,843.0,843.0
0.071,6,10,1506,5,395,16.0,127.0,127.0,5,1111,16.0,843.0,843.0
0.001,17,2,136,1,60,0.0,32.0,32.0,1,76,0.0,48.0,48.0
0.012,6,10,1989,5,910,3.0,642.0,642.0,5,1079,3.0,811.0,811.0
0.005,6,10,1547,5,764,1.0,496.0,496.0,5,783,1.0,515.0,515.0
0.005,6,10,1989,5,927,1.0,659.0,659.0,5,1062,1.0,794.0,794.0
0.004,6,10,1989,5,927,1.0,659.0,659.0,5,1062,1.0,794.0,794.0
0.005,6,13,3747,7,509,0.0,137.0,137.0,6,3238,0.0,1470.0,1459.0
0.006,6,10,2000,5,927,1.0,659.0,659.0,5,1073,1.0,805.0,805.0
11.225,17,28,4419,14,1995,850.0,270.0,114.0,14,2424,850.0,587.0,145.0
0.006,6,13,3747,7,509,0.0,137.0,137.0,6,3238,1.0,1470.0,1459.0
0.006,17,2,169,1,62,0.0,34.0,34.0,1,107,0.0,79.0,79.0
0.004,6,14,3742,7,452,0.0,80.0,80.0,7,3290,0.0,1448.0,972.0
0.007,17,4,284,2,120,1.0,32.0,32.0,2,164,0.0,60.0,54.0
0.012,6,10,1983,5,910,3.0,642.0,642.0,5,1073,3.0,805.0,805.0
0.005,6,14,3736,7,446,0.0,74.0,74.0,7,3290,0.0,1448.0,972.0
30.293,6,26,8595,15,1828,2163.0,517.0,262.0,11,6767,3028.0,1402.0,773.0
0.086,6,10,1506,5,395,16.0,127.0,127.0,5,1111,20.0,843.0,843.0
0.015,6,10,1990,5,911,3.0,643.0,643.0,5,1079,3.0,811.0,811.0
1770.804,6,135,6510,75,3585,23926.0,39.0,39.0,60,2925,30009.0,35.0,35.0
0.006,6,10,1547,5,764,1.0,496.0,496.0,5,783,1.0,515.0,515.0
0.005,6,10,2007,5,928,1.0,660.0,660.0,5,1079,1.0,811.0,811.0
0.006,6,10,2000,5,927,1.0,659.0,659.0,5,1073,1.0,805.0,805.0
0.001,17,2,136,1,60,0.0,32.0,32.0,1,76,0.0,48.0,48.0
40.06,17,10,676,5,460,10014.0,104.0,64.0,5,216,10013.0,20.0,15.0
953.911,6,50,9540,26,7288,26418.0,494.0,494.0,24,2252,41474.0,83.0,83.0
0.005,6,10,2000,5,927,1.0,659.0,659.0,5,1073,1.0,805.0,805.0
0.021,6,13,3735,7,497,3.0,125.0,125.0,6,3238,4.0,1470.0,1459.0
0.006,6,10,1547,5,764,1.0,496.0,496.0,5,783,1.0,515.0,515.0
0.009,6,10,1989,5,910,2.0,642.0,642.0,5,1079,2.0,811.0,811.0
0.003,6,10,1702,5,863,0.0,595.0,595.0,5,839,0.0,571.0,571.0
0.005,6,10,1989,5,927,1.0,659.0,659.0,5,1062,1.0,794.0,794.0
0.001,17,2,132,1,58,0.0,30.0,30.0,1,74,0.0,46.0,46.0
353.601,6,20,2210,6,1308,12003.0,494.0,494.0,14,902,27199.0,83.0,83.0
0.003,17,2,148,1,60,0.0,32.0,32.0,1,88,0.0,60.0,60.0
0.005,17,2,212,1,63,0.0,35.0,35.0,1,149,0.0,121.0,121.0
0.003,17,2,234,1,61,0.0,33.0,33.0,1,173,0.0,145.0,145.0
15.073,17,15,9238,8,6902,2149.0,1350.0,834.0,7,2336,2507.0,1350.0,305.0
0.012,6,10,1990,5,911,3.0,643.0,643.0,5,1079,3.0,811.0,811.0
0.005,6,10,2006,5,927,1.0,659.0,659.0,5,1079,1.0,811.0,811.0
0.088,6,10,1506,5,395,17.0,127.0,127.0,5,1111,20.0,843.0,843.0
8.948,6,39,10487,20,4929,470.0,1360.0,682.0,19,5558,485.0,2667.0,435.0
0.01,6,10,1677,5,827,2.0,559.0,559.0,5,850,2.0,582.0,582.0
280.448,6,22,6035,9,1146,35056.0,267.0,156.0,13,4889,23365.0,1400.0,873.0
0.021,6,10,1631,5,848,5.0,580.0,580.0,5,783,5.0,515.0,515.0
0.013,6,10,1989,5,910,3.0,642.0,642.0,5,1079,3.0,811.0,811.0
0.005,6,10,1689,5,839,1.0,571.0,571.0,5,850,1.0,582.0,582.0
0.005,6,10,2006,5,927,1.0,659.0,659.0,5,1079,1.0,811.0,811.0
0.037,17,4,352,2,130,0.0,37.0,37.0,2,222,0.0,89.0,83.0
0.006,6,10,1547,5,764,1.0,496.0,496.0,5,783,1.0,515.0,515.0
0.004,17,2,148,1,60,0.0,32.0,32.0,1,88,0.0,60.0,60.0
0.005,17,2,180,1,58,0.0,30.0,30.0,1,122,0.0,94.0,94.0
0.105,6,10,1506,5,395,23.0,127.0,127.0,5,1111,23.0,843.0,843.0
0.004,17,2,136,1,60,0.0,32.0,32.0,1,76,0.0,48.0,48.0
0.012,6,10,1972,5,910,2.0,642.0,642.0,5,1062,3.0,794.0,794.0
0.003,17,2,148,1,60,0.0,32.0,32.0,1,88,0.0,60.0,60.0
300.03,6,12,1782,7,1348,50005.0,494.0,494.0,5,434,75006.0,83.0,83.0
0.009,6,14,3787,7,497,1.0,125.0,125.0,7,3290,1.0,1448.0,972.0
0.005,6,10,1779,5,928,1.0,660.0,660.0,5,851,1.0,583.0,583.0
0.005,6,10,2007,5,928,1.0,660.0,660.0,5,1079,1.0,811.0,811.0
0.007,6,10,1989,5,910,1.0,642.0,642.0,5,1079,1.0,811.0,811.0
0.006,17,2,212,1,74,0.0,46.0,46.0,1,138,0.0,110.0,110.0
0.012,6,10,1989,5,910,3.0,642.0,642.0,5,1079,2.0,811.0,811.0
0.013,6,10,1972,5,910,3.0,642.0,642.0,5,1062,3.0,794.0,794.0
0.016,6,10,1989,5,910,4.0,642.0,642.0,5,1079,3.0,811.0,811.0
5.338,6,27,6955,15,1777,381.0,474.0,195.0,12,5178,484.0,1925.0,757.0
0.009,6,10,1677,5,827,2.0,559.0,559.0,5,850,2.0,582.0,582.0
0.001,17,2,180,1,66,0.0,38.0,38.0,1,114,0.0,86.0,86.0
0.006,17,2,164,1,74,0.0,46.0,46.0,1,90,0.0,62.0,62.0
0.003,17,2,152,1,76,0.0,48.0,48.0,1,76,0.0,48.0,48.0
0.09,6,10,1506,5,395,20.0,127.0,127.0,5,1111,18.0,843.0,843.0
0.006,6,10,2006,5,927,1.0,659.0,659.0,5,1079,1.0,811.0,811.0
0.01,6,10,1989,5,910,2.0,642.0,642.0,5,1079,2.0,811.0,811.0
0.001,17,2,180,1,66,0.0,38.0,38.0,1,114,0.0,86.0,86.0
0.005,6,10,2007,5,928,1.0,660.0,660.0,5,1079,1.0,811.0,811.0
0.012,6,10,1972,5,910,3.0,642.0,642.0,5,1062,3.0,794.0,794.0
0.002,17,2,166,1,75,0.0,47.0,47.0,1,91,0.0,63.0,63.0
0.005,6,10,2006,5,927,1.0,659.0,659.0,5,1079,1.0,811.0,811.0
0.003,17,2,144,1,64,0.0,36.0,36.0,1,80,0.0,52.0,52.0
0.006,17,2,179,1,71,0.0,43.0,43.0,1,108,0.0,80.0,80.0
0.013,6,10,1989,5,910,3.0,642.0,642.0,5,1079,3.0,811.0,811.0
15.081,17,18,9307,8,6908,2150.0,1350.0,835.0,10,2399,1672.0,1350.0,211.0
40.05,17,10,676,5,460,10011.0,104.0,64.0,5,216,10011.0,20.0,15.0
0.017,6,10,1762,5,911,4.0,643.0,643.0,5,851,4.0,583.0,583.0
0.004,6,10,1702,5,863,1.0,595.0,595.0,5,839,1.0,571.0,571.0
15.168,17,21,11301,10,7725,1682.0,1350.0,744.0,11,3576,1513.0,1350.0,297.0
40.056,17,10,676,5,460,10013.0,104.0,64.0,5,216,10013.0,20.0,15.0
0.001,17,2,180,1,66,0.0,38.0,38.0,1,114,0.0,86.0,86.0
0.018,6,10,1990,5,911,4.0,643.0,643.0,5,1079,4.0,811.0,811.0
0.017,6,10,1989,5,910,4.0,642.0,642.0,5,1079,4.0,811.0,811.0
0.001,17,2,180,1,66,0.0,38.0,38.0,1,114,0.0,86.0,86.0
0.005,6,10,1689,5,839,1.0,571.0,571.0,5,850,1.0,582.0,582.0
9.036,17,6,376,5,280,2259.0,28.0,28.0,1,96,0.0,68.0,68.0
0.006,6,10,1547,5,764,1.0,496.0,496.0,5,783,1.0,515.0,515.0
0.012,6,10,1990,5,911,3.0,643.0,643.0,5,1079,3.0,811.0,811.0
0.006,17,2,179,1,71,0.0,43.0,43.0,1,108,0.0,80.0,80.0
0.004,6,14,3736,7,446,0.0,74.0,74.0,7,3290,0.0,1448.0,972.0
0.006,6,10,2006,5,927,1.0,659.0,659.0,5,1079,1.0,811.0,811.0
0.079,6,10,1506,5,395,18.0,127.0,127.0,5,1111,18.0,843.0,843.0
0.003,17,2,136,1,60,0.0,32.0,32.0,1,76,0.0,48.0,48.0
0.004,17,2,152,1,76,0.0,48.0,48.0,1,76,0.0,48.0,48.0
0.131,6,10,1506,5,395,30.0,127.0,127.0,5,1111,29.0,843.0,843.0
0.071,17,4,352,2,130,0.0,37.0,37.0,2,222,34.0,89.0,83.0
0.001,17,2,180,1,66,0.0,38.0,38.0,1,114,0.0,86.0,86.0
0.005,6,13,3690,7,452,0.0,80.0,80.0,6,3238,1.0,1470.0,1459.0
15.078,17,16,8254,8,5981,2149.0,1350.0,719.0,8,2273,2149.0,1350.0,256.0
0.165,6,10,1506,5,395,22.0,127.0,127.0,5,1111,39.0,843.0,843.0
0.008,6,10,1689,5,839,1.0,571.0,571.0,5,850,2.0,582.0,582.0
0.006,6,10,2006,5,927,1.0,659.0,659.0,5,1079,1.0,811.0,811.0
0.007,6,10,1547,5,764,1.0,496.0,496.0,5,783,1.0,515.0,515.0
40.062,17,10,676,5,460,10014.0,104.0,64.0,5,216,10014.0,20.0,15.0
0.004,6,10,2007,5,928,1.0,660.0,660.0,5,1079,1.0,811.0,811.0
0.012,6,10,1972,5,910,3.0,642.0,642.0,5,1062,2.0,794.0,794.0
0.017,6,10,1677,5,827,4.0,559.0,559.0,5,850,4.0,582.0,582.0
0.082,6,10,1506,5,395,17.0,127.0,127.0,5,1111,19.0,843.0,843.0
0.013,6,10,1989,5,910,3.0,642.0,642.0,5,1079,3.0,811.0,811.0
0.077,6,10,1506,5,395,17.0,127.0,127.0,5,1111,17.0,843.0,843.0
0.011,6,10,1990,5,911,2.0,643.0,643.0,5,1079,2.0,811.0,811.0
240.272,6,40,8615,20,5634,12645.0,2883.0,573.0,20,2981,12645.0,580.0,241.0
0.108,6,10,1506,5,395,24.0,127.0,127.0,5,1111,24.0,843.0,843.0
0.13,17,2,80,1,32,0.0,4.0,4.0,1,48,0.0,20.0,20.0
0.011,6,10,1762,5,911,2.0,643.0,643.0,5,851,2.0,583.0,583.0
0.009,6,10,2006,5,927,2.0,659.0,659.0,5,1079,2.0,811.0,811.0
0.005,6,10,2006,5,927,1.0,659.0,659.0,5,1079,1.0,811.0,811.0
1793.532,6,552,191280,284,164488,6337.0,2883.0,965.0,268,26792,6717.0,580.0,124.0
1772.382,6,103,6166,59,3473,30557.0,27.0,27.0,44,2693,41217.0,27.0,27.0
0.012,6,10,1989,5,910,2.0,642.0,642.0,5,1079,3.0,811.0,811.0
0.011,6,10,1989,5,910,2.0,642.0,642.0,5,1079,2.0,811.0,811.0
0.078,6,10,1506,5,395,16.0,127.0,127.0,5,1111,17.0,843.0,843.0
0.009,6,10,1989,5,910,2.0,642.0,642.0,5,1079,2.0,811.0,811.0
0.005,6,10,2006,5,927,1.0,659.0,659.0,5,1079,1.0,811.0,811.0
0.008,6,10,1989,5,910,2.0,642.0,642.0,5,1079,1.0,811.0,811.0
240.283,6,40,5387,19,2387,13348.0,588.0,197.0,21,3000,12013.0,580.0,237.0
0.1,6,10,1506,5,395,21.0,127.0,127.0,5,1111,24.0,843.0,843.0
0.078,6,10,1506,5,395,16.0,127.0,127.0,5,1111,17.0,843.0,843.0
9.134,6,38,9851,19,4293,507.0,1360.0,700.0,19,5558,496.0,1360.0,398.0
0.005,6,10,2007,5,928,1.0,660.0,660.0,5,1079,1.0,811.0,811.0
0.006,6,10,1547,5,764,1.0,496.0,496.0,5,783,1.0,515.0,515.0
0.009,6,12,1926,6,1189,1.0,659.0,434.0,6,737,1.0,417.0,417.0
0.072,17,4,284,2,120,0.0,32.0,32.0,2,164,65.0,60.0,54.0
0.09,6,10,1506,5,395,21.0,127.0,127.0,5,1111,18.0,843.0,843.0
0.008,6,10,1989,5,910,2.0,642.0,642.0,5,1079,2.0,811.0,811.0
0.074,6,10,1506,5,395,14.0,127.0,127.0,5,1111,17.0,843.0,843.0
372.194,6,22,2313,16,867,24812.0,195.0,195.0,6,1446,4644.0,419.0,398.0
0.002,17,2,180,1,66,0.0,38.0,38.0,1,114,0.0,86.0,86.0
0.005,6,10,2006,5,927,1.0,659.0,659.0,5,1079,1.0,811.0,811.0
0.004,6,14,3742,8,504,0.0,80.0,80.0,6,3238,0.0,1470.0,1459.0
0.008,6,10,1972,5,910,1.0,642.0,642.0,5,1062,2.0,794.0,794.0
0.006,17,2,214,1,75,0.0,47.0,47.0,1,139,0.0,111.0,111.0
0.01,6,10,1972,5,910,2.0,642.0,642.0,5,1062,2.0,794.0,794.0
0.072,6,10,1506,5,395,16.0,127.0,127.0,5,1111,14.0,843.0,843.0
0.081,6,10,1506,5,395,17.0,127.0,127.0,5,1111,19.0,843.0,843.0
0.005,6,10,2006,5,927,1.0,659.0,659.0,5,1079,1.0,811.0,811.0
0.056,17,2,152,1,76,0.0,48.0,48.0,1,76,0.0,48.0,48.0
0.016,6,10,1677,5,827,4.0,559.0,559.0,5,850,3.0,582.0,582.0
0.005,6,10,2000,5,927,1.0,659.0,659.0,5,1073,1.0,805.0,805.0
0.1,6,10,1506,5,395,22.0,127.0,127.0,5,1111,22.0,843.0,843.0
0.01,17,2,198,1,66,0.0,38.0,38.0,1,132,0.0,104.0,104.0
0.09,6,10,1506,5,395,17.0,127.0,127.0,5,1111,22.0,843.0,843.0
0.021,6,10,1990,5,911,5.0,643.0,643.0,5,1079,5.0,811.0,811.0
0.004,6,13,3747,7,509,0.0,137.0,137.0,6,3238,0.0,1470.0,1459.0
0.129,6,10,1506,5,395,28.0,127.0,127.0,5,1111,31.0,843.0,843.0
0.097,6,10,1506,5,395,17.0,127.0,127.0,5,1111,19.0,843.0,843.0
0.006,17,2,136,1,60,0.0,32.0,32.0,1,76,0.0,48.0,48.0
0.096,6,10,1506,5,395,21.0,127.0,127.0,5,1111,23.0,843.0,843.0
0.009,6,10,1972,5,910,2.0,642.0,642.0,5,1062,2.0,794.0,794.0
0.006,6,10,1547,5,764,1.0,496.0,496.0,5,783,1.0,515.0,515.0
0.005,6,10,2007,5,928,1.0,660.0,660.0,5,1079,1.0,811.0,811.0
0.005,6,10,2000,5,927,1.0,659.0,659.0,5,1073,1.0,805.0,805.0
0.012,6,10,1972,5,910,2.0,642.0,642.0,5,1062,2.0,794.0,794.0
0.005,6,10,1689,5,839,1.0,571.0,571.0,5,850,1.0,582.0,582.0
40.061,17,10,676,5,460,10013.0,104.0,64.0,5,216,10014.0,20.0,15.0
0.005,17,2,166,1,75,0.0,47.0,47.0,1,91,0.0,63.0,63.0
0.001,17,2,180,1,66,0.0,38.0,38.0,1,114,0.0,86.0,86.0
0.01,6,10,1972,5,910,2.0,642.0,642.0,5,1062,2.0,794.0,794.0
40.062,17,10,676,5,460,10012.0,104.0,64.0,5,216,10011.0,20.0,15.0
0.008,6,10,1989,5,910,1.0,642.0,642.0,5,1079,2.0,811.0,811.0
0.012,6,10,1972,5,910,3.0,642.0,642.0,5,1062,3.0,794.0,794.0
15.073,17,15,9238,8,6902,2149.0,1350.0,834.0,7,2336,2507.0,1350.0,305.0
0.076,6,10,1506,5,395,17.0,127.0,127.0,5,1111,15.0,843.0,843.0
0.005,6,10,2000,5,927,1.0,659.0,659.0,5,1073,1.0,805.0,805.0
0.006,6,10,1547,5,764,1.0,496.0,496.0,5,783,1.0,515.0,515.0
0.019,6,10,1972,5,910,4.0,642.0,642.0,5,1062,4.0,794.0,794.0
0.016,6,10,1989,5,910,4.0,642.0,642.0,5,1079,4.0,811.0,811.0
0.014,6,10,1631,5,848,3.0,580.0,580.0,5,783,3.0,515.0,515.0
0.009,6,10,1989,5,927,2.0,659.0,659.0,5,1062,2.0,794.0,794.0
0.197,6,44,11610,24,3281,8.0,1081.0,203.0,20,8329,10.0,1402.0,606.0
241.8,6,326,344561,124,17968,1965.0,2736.0,960.0,202,326593,1202.0,2804.0,1646.0
0.015,6,10,1972,5,910,3.0,642.0,642.0,5,1062,3.0,794.0,794.0
0.013,6,10,1989,5,910,3.0,642.0,642.0,5,1079,3.0,811.0,811.0
0.095,6,10,1506,5,395,21.0,127.0,127.0,5,1111,21.0,843.0,843.0
0.001,17,2,180,1,66,0.0,38.0,38.0,1,114,0.0,86.0,86.0
0.052,17,2,152,1,76,0.0,48.0,48.0,1,76,0.0,48.0,48.0
0.005,17,2,169,1,62,0.0,34.0,34.0,1,107,0.0,79.0,79.0
240.012,6,9,787,5,488,60003.0,232.0,232.0,4,299,80002.0,83.0,83.0
0.005,6,10,1779,5,928,1.0,660.0,660.0,5,851,1.0,583.0,583.0
0.004,6,10,1702,5,863,1.0,595.0,595.0,5,839,1.0,571.0,571.0
0.083,6,10,1506,5,395,18.0,127.0,127.0,5,1111,17.0,843.0,843.0
0.005,6,10,2000,5,927,1.0,659.0,659.0,5,1073,1.0,805.0,805.0
0.105,6,10,1506,5,395,25.0,127.0,127.0,5,1111,24.0,843.0,843.0
0.004,6,14,3799,7,509,0.0,137.0,137.0,7,3290,0.0,1448.0,972.0
0.1,6,10,1506,5,395,24.0,127.0,127.0,5,1111,23.0,843.0,843.0
0.005,17,2,144,1,64,0.0,36.0,36.0,1,80,0.0,52.0,52.0
309.077,17,20,1124,10,716,34327.0,48.0,43.0,10,408,34327.0,20.0,12.0
0.004,17,2,148,1,60,0.0,32.0,32.0,1,88,0.0,60.0,60.0
0.008,6,10,1989,5,910,2.0,642.0,642.0,5,1079,1.0,811.0,811.0
0.008,17,2,136,1,60,0.0,32.0,32.0,1,76,0.0,48.0,48.0
0.013,6,10,1972,5,910,3.0,642.0,642.0,5,1062,3.0,794.0,794.0
0.062,6,10,1506,5,395,14.0,127.0,127.0,5,1111,12.0,843.0,843.0
40.06,17,10,676,5,460,10014.0,104.0,64.0,5,216,10014.0,20.0,15.0
0.004,6,10,1774,5,923,1.0,655.0,655.0,5,851,1.0,583.0,583.0
0.004,17,2,148,1,60,0.0,32.0,32.0,1,88,0.0,60.0,60.0
0.014,6,10,1989,5,910,3.0,642.0,642.0,5,1079,3.0,811.0,811.0
0.008,6,10,1989,5,910,2.0,642.0,642.0,5,1079,1.0,811.0,811.0
0.006,6,10,1854,5,889,1.0,621.0,621.0,5,965,1.0,697.0,697.0
0.005,6,10,2006,5,927,1.0,659.0,659.0,5,1079,1.0,811.0,811.0
0.009,6,10,1983,5,910,2.0,642.0,642.0,5,1073,2.0,805.0,805.0
0.006,17,2,170,1,65,0.0,37.0,37.0,1,105,0.0,77.0,77.0
0.004,6,13,3747,7,509,0.0,137.0,137.0,6,3238,0.0,1470.0,1459.0
0.219,6,16,2777,8,1395,31.0,533.0,323.0,8,1382,20.0,529.0,239.0
0.005,6,14,3799,7,509,0.0,137.0,137.0,7,3290,0.0,1448.0,972.0
0.005,6,10,1643,5,860,1.0,592.0,592.0,5,783,1.0,515.0,515.0
240.31,6,35,10733,18,3098,14135.0,1485.0,269.0,17,7635,15019.0,2804.0,747.0
0.004,17,4,284,2,120,0.0,32.0,32.0,2,164,1.0,60.0,54.0
0.005,6,10,1989,5,927,1.0,659.0,659.0,5,1062,1.0,794.0,794.0
176.247,17,70,9887,35,2330,5183.0,44.0,38.0,35,7557,5183.0,239.0,187.0
353.997,6,21,1795,16,1030,23599.0,190.0,190.0,5,765,60002.0,464.0,248.0
1799.774,17,2794,213372,1389,112496,1296.0,84.0,52.0,1405,100876,1281.0,227.0,43.0
0.014,6,10,1989,5,910,3.0,642.0,642.0,5,1079,3.0,811.0,811.0
300.34,6,16,2170,9,684,37521.0,146.0,146.0,7,1486,50028.0,419.0,398.0
0.039,17,2,136,1,60,0.0,32.0,32.0,1,76,0.0,48.0,48.0
0.02,6,10,1990,5,911,5.0,643.0,643.0,5,1079,4.0,811.0,811.0
40.061,17,10,676,5,460,10013.0,104.0,64.0,5,216,10014.0,20.0,15.0
0.078,6,10,1506,5,395,15.0,127.0,127.0,5,1111,18.0,843.0,843.0
0.004,6,10,2006,5,927,1.0,659.0,659.0,5,1079,1.0,811.0,811.0
0.001,17,2,180,1,66,0.0,38.0,38.0,1,114,0.0,86.0,86.0
0.004,6,10,1989,5,927,1.0,659.0,659.0,5,1062,1.0,794.0,794.0
0.014,6,10,1983,5,910,3.0,642.0,642.0,5,1073,3.0,805.0,805.0
0.011,6,10,1983,5,910,2.0,642.0,642.0,5,1073,2.0,805.0,805.0
0.006,6,10,1854,5,889,1.0,621.0,621.0,5,965,1.0,697.0,697.0
0.123,6,10,1506,5,395,26.0,127.0,127.0,5,1111,27.0,843.0,843.0
0.007,6,10,1547,5,764,1.0,496.0,496.0,5,783,1.0,515.0,515.0
0.007,6,6,362,3,175,3.0,31.0,31.0,3,187,0.0,31.0,31.0
0.015,17,2,198,1,91,0.0,63.0,63.0,1,107,0.0,79.0,79.0
0.134,6,10,1506,5,395,23.0,127.0,127.0,5,1111,31.0,843.0,843.0
0.006,6,10,1547,5,764,1.0,496.0,496.0,5,783,1.0,515.0,515.0
0.134,6,10,1506,5,395,31.0,127.0,127.0,5,1111,28.0,843.0,843.0
0.005,6,14,3799,7,509,0.0,137.0,137.0,7,3290,0.0,1448.0,972.0
0.108,6,10,1506,5,395,26.0,127.0,127.0,5,1111,24.0,843.0,843.0
0.006,6,10,1689,5,839,1.0,571.0,571.0,5,850,1.0,582.0,582.0
0.005,6,10,1989,5,927,1.0,659.0,659.0,5,1062,1.0,794.0,794.0
0.042,17,2,152,1,76,0.0,48.0,48.0,1,76,0.0,48.0,48.0
0.004,17,2,148,1,60,0.0,32.0,32.0,1,88,0.0,60.0,60.0
0.005,6,10,1689,5,839,1.0,571.0,571.0,5,850,1.0,582.0,582.0
0.005,6,10,2000,5,927,1.0,659.0,659.0,5,1073,1.0,805.0,805.0
0.019,6,10,1972,5,910,4.0,642.0,642.0,5,1062,4.0,794.0,794.0
0.01,6,14,3787,7,497,1.0,125.0,125.0,7,3290,1.0,1448.0,972.0
0.005,6,10,2006,5,927,1.0,659.0,659.0,5,1079,1.0,811.0,811.0
0.005,6,14,3742,7,452,0.0,80.0,80.0,7,3290,0.0,1448.0,972.0
10.816,17,28,4419,14,1994,823.0,269.0,114.0,14,2425,823.0,588.0,145.0
40.054,17,10,676,5,460,10012.0,104.0,64.0,5,216,10012.0,20.0,15.0
40.071,17,10,676,5,460,10014.0,104.0,64.0,5,216,10016.0,20.0,15.0
0.001,17,2,180,1,66,0.0,38.0,38.0,1,114,0.0,86.0,86.0
0.087,6,10,1506,5,395,20.0,127.0,127.0,5,1111,20.0,843.0,843.0
0.008,6,10,1972,5,910,2.0,642.0,642.0,5,1062,2.0,794.0,794.0
0.754,6,10,2009,6,1655,150.0,1403.0,1403.0,4,354,171.0,182.0,182.0
0.342,6,46,12243,25,3851,14.0,1082.0,231.0,21,8392,16.0,2694.0,661.0
0.003,17,4,284,2,120,0.0,32.0,32.0,2,164,0.0,60.0,54.0
0.009,6,14,3787,7,497,1.0,125.0,125.0,7,3290,1.0,1448.0,972.0
0.006,17,2,230,1,68,0.0,40.0,40.0,1,162,0.0,134.0,134.0
0.102,6,10,1506,5,395,24.0,127.0,127.0,5,1111,24.0,843.0,843.0
0.004,6,10,1702,5,863,0.0,595.0,595.0,5,839,1.0,571.0,571.0
0.01,6,10,1989,5,910,2.0,642.0,642.0,5,1079,2.0,811.0,811.0
0.006,6,10,1547,5,764,1.0,496.0,496.0,5,783,1.0,515.0,515.0
0.004,6,10,2000,5,927,1.0,659.0,659.0,5,1073,1.0,805.0,805.0
0.005,6,10,1643,5,860,1.0,592.0,592.0,5,783,1.0,515.0,515.0
0.011,6,10,1990,5,911,2.0,643.0,643.0,5,1079,2.0,811.0,811.0
0.04,17,2,136,1,60,0.0,32.0,32.0,1,76,0.0,48.0,48.0
0.014,6,10,1989,5,910,3.0,642.0,642.0,5,1079,3.0,811.0,811.0
0.009,6,10,1972,5,910,2.0,642.0,642.0,5,1062,2.0,794.0,794.0
0.171,17,2,152,1,76,0.0,48.0,48.0,1,76,0.0,48.0,48.0
0.098,6,10,1506,5,395,21.0,127.0,127.0,5,1111,21.0,843.0,843.0
0.006,6,10,1689,5,839,1.0,571.0,571.0,5,850,1.0,582.0,582.0
0.099,6,10,1506,5,395,20.0,127.0,127.0,5,1111,21.0,843.0,843.0
0.013,17,2,152,1,56,0.0,28.0,28.0,1,96,0.0,68.0,68.0
0.004,6,14,3736,7,446,0.0,74.0,74.0,7,3290,0.0,1448.0,972.0
361.755,6,21,1793,16,1030,24117.0,190.0,190.0,5,763,60009.0,462.0,247.0
300.194,6,27,7435,16,1409,20012.0,217.0,142.0,11,6026,24018.0,1679.0,778.0
0.003,17,2,185,1,73,0.0,45.0,45.0,1,112,0.0,84.0,84.0
0.004,6,10,2007,5,928,1.0,660.0,660.0,5,1079,1.0,811.0,811.0
0.005,6,10,2007,5,928,1.0,660.0,660.0,5,1079,1.0,811.0,811.0
0.005,6,13,3747,7,509,0.0,137.0,137.0,6,3238,1.0,1470.0,1459.0
0.007,17,2,170,1,65,0.0,37.0,37.0,1,105,0.0,77.0,77.0
0.097,6,10,1506,5,395,21.0,127.0,127.0,5,1111,20.0,843.0,843.0
15.073,17,15,9238,8,6902,2149.0,1350.0,834.0,7,2336,2507.0,1350.0,305.0
0.085,6,10,1506,5,395,19.0,127.0,127.0,5,1111,18.0,843.0,843.0
0.006,17,2,179,1,71,0.0,43.0,43.0,1,108,0.0,80.0,80.0
0.007,17,2,179,1,71,0.0,43.0,43.0,1,108,0.0,80.0,80.0
0.001,17,2,166,1,75,0.0,47.0,47.0,1,91,0.0,63.0,63.0
351.987,6,20,2210,6,1308,12003.0,494.0,494.0,14,902,27075.0,83.0,83.0
0.005,6,10,2000,5,927,1.0,659.0,659.0,5,1073,1.0,805.0,805.0
0.016,6,13,3735,7,497,2.0,125.0,125.0,6,3238,3.0,1470.0,1459.0
0.005,6,10,2006,5,927,1.0,659.0,659.0,5,1079,1.0,811.0,811.0
0.022,6,10,1631,5,848,5.0,580.0,580.0,5,783,5.0,515.0,515.0
1.095,6,31,12749,17,3312,68.0,1360.0,517.0,14,9437,70.0,2720.0,886.0
270.545,6,28,9550,15,2515,19324.0,585.0,345.0,13,7035,22545.0,1402.0,909.0
0.014,6,6,716,3,458,6.0,302.0,302.0,3,258,6.0,102.0,102.0
0.001,17,2,180,1,66,0.0,38.0,38.0,1,114,0.0,86.0,86.0
0.003,17,2,160,1,72,0.0,44.0,44.0,1,88,0.0,60.0,60.0
0.112,6,10,1506,5,395,15.0,127.0,127.0,5,1111,25.0,843.0,843.0
240.097,6,16,4480,9,963,30012.0,238.0,166.0,7,3517,40015.0,1402.0,786.0
0.114,17,2,80,1,32,0.0,4.0,4.0,1,48,0.0,20.0,20.0
0.004,6,10,2007,5,928,1.0,660.0,660.0,5,1079,1.0,811.0,811.0
0.006,6,10,1689,5,839,1.0,571.0,571.0,5,850,1.0,582.0,582.0
0.006,6,10,1854,5,889,1.0,621.0,621.0,5,965,1.0,697.0,697.0
0.01,6,10,1989,5,910,2.0,642.0,642.0,5,1079,2.0,811.0,811.0
0.012,6,10,1762,5,911,2.0,643.0,643.0,5,851,3.0,583.0,583.0
0.082,6,45,14035,25,2555,3.0,517.0,139.0,20,11480,4.0,1402.0,745.0
0.006,6,10,2006,5,927,1.0,659.0,659.0,5,1079,1.0,811.0,811.0
0.005,6,10,2006,5,927,1.0,659.0,659.0,5,1079,1.0,811.0,811.0
0.004,17,2,180,1,58,0.0,30.0,30.0,1,122,0.0,94.0,94.0
0.006,6,10,1689,5,839,1.0,571.0,571.0,5,850,1.0,582.0,582.0
0.01,6,10,1677,5,827,2.0,559.0,559.0,5,850,2.0,582.0,582.0
0.008,6,10,1989,5,910,2.0,642.0,642.0,5,1079,1.0,811.0,811.0
0.14,6,10,1506,5,395,34.0,127.0,127.0,5,1111,30.0,843.0,843.0
0.126,6,10,1506,5,395,29.0,127.0,127.0,5,1111,26.0,843.0,843.0
0.003,17,2,208,1,72,0.0,44.0,44.0,1,136,0.0,108.0,108.0
308.419,17,20,1124,10,716,34253.0,48.0,43.0,10,408,34253.0,20.0,12.0
0.005,6,10,1989,5,927,1.0,659.0,659.0,5,1062,1.0,794.0,794.0
0.005,17,2,140,1,62,0.0,34.0,34.0,1,78,0.0,50.0,50.0
0.004,6,10,1702,5,863,1.0,595.0,595.0,5,839,1.0,571.0,571.0
0.008,6,10,1972,5,910,2.0,642.0,642.0,5,1062,1.0,794.0,794.0
240.081,6,16,4481,9,963,30010.0,238.0,166.0,7,3518,40013.0,1402.0,786.0
300.422,6,16,2170,9,684,37531.0,146.0,146.0,7,1486,50041.0,419.0,398.0
0.014,6,10,1989,5,910,3.0,642.0,642.0,5,1079,3.0,811.0,811.0
0.005,6,10,1989,5,927,1.0,659.0,659.0,5,1062,1.0,794.0,794.0
0.007,17,2,148,1,60,0.0,32.0,32.0,1,88,0.0,60.0,60.0
0.005,6,10,1779,5,928,1.0,660.0,660.0,5,851,1.0,583.0,583.0
0.015,6,10,1631,5,848,3.0,580.0,580.0,5,783,3.0,515.0,515.0
0.011,6,10,1972,5,910,2.0,642.0,642.0,5,1062,2.0,794.0,794.0
0.005,17,2,166,1,75,0.0,47.0,47.0,1,91,0.0,63.0,63.0
0.023,6,10,1972,5,910,5.0,642.0,642.0,5,1062,5.0,794.0,794.0
0.006,17,2,230,1,68,0.0,40.0,40.0,1,162,0.0,134.0,134.0
0.009,6,10,1983,5,910,2.0,642.0,642.0,5,1073,2.0,805.0,805.0
0.172,17,2,152,1,76,0.0,48.0,48.0,1,76,0.0,48.0,48.0
0.015,6,10,1990,5,911,3.0,643.0,643.0,5,1079,3.0,811.0,811.0
0.015,6,13,3735,7,497,2.0,125.0,125.0,6,3238,3.0,1470.0,1459.0
0.008,6,10,1972,5,910,2.0,642.0,642.0,5,1062,2.0,794.0,794.0
0.006,6,10,1547,5,764,1.0,496.0,496.0,5,783,1.0,515.0,515.0
0.007,6,10,1762,5,911,1.0,643.0,643.0,5,851,1.0,583.0,583.0
0.001,17,2,180,1,66,0.0,38.0,38.0,1,114,0.0,86.0,86.0
0.014,6,10,1990,5,911,3.0,643.0,643.0,5,1079,3.0,811.0,811.0
0.005,17,2,225,1,65,0.0,37.0,37.0,1,160,0.0,132.0,132.0
0.088,6,10,1506,5,395,21.0,127.0,127.0,5,1111,19.0,843.0,843.0
0.003,17,2,170,1,65,0.0,37.0,37.0,1,105,0.0,77.0,77.0
300.415,6,16,2170,9,684,37530.0,146.0,146.0,7,1486,50040.0,419.0,398.0
0.009,6,10,1989,5,910,2.0,642.0,642.0,5,1079,2.0,811.0,811.0
0.095,6,10,1506,5,395,20.0,127.0,127.0,5,1111,22.0,843.0,843.0
0.006,17,2,170,1,65,0.0,37.0,37.0,1,105,0.0,77.0,77.0
0.006,17,2,178,1,65,0.0,37.0,37.0,1,113,0.0,85.0,85.0
0.006,6,10,2006,5,927,1.0,659.0,659.0,5,1079,1.0,811.0,811.0
0.017,6,10,1972,5,910,4.0,642.0,642.0,5,1062,4.0,794.0,794.0
0.127,6,10,1506,5,395,28.0,127.0,127.0,5,1111,24.0,843.0,843.0
0.001,17,2,180,1,66,0.0,38.0,38.0,1,114,0.0,86.0,86.0
0.005,6,10,2006,5,927,1.0,659.0,659.0,5,1079,1.0,811.0,811.0
241.569,6,378,347891,191,21462,1271.0,2736.0,959.0,187,326429,1298.0,4171.0,1799.0
0.095,6,10,1506,5,395,21.0,127.0,127.0,5,1111,21.0,843.0,843.0
0.076,6,10,1506,5,395,18.0,127.0,127.0,5,1111,16.0,843.0,843.0
0.005,6,10,2006,5,927,1.0,659.0,659.0,5,1079,1.0,811.0,811.0
0.041,17,2,152,1,76,0.0,48.0,48.0,1,76,0.0,48.0,48.0
467.168,6,31,10504,17,2710,29198.0,676.0,363.0,14,7794,31320.0,1402.0,882.0
0.001,17,2,179,1,62,0.0,34.0,34.0,1,117,0.0,89.0,89.0
0.018,6,10,1990,5,911,4.0,643.0,643.0,5,1079,4.0,811.0,811.0
0.009,6,10,1631,5,848,2.0,580.0,580.0,5,783,2.0,515.0,515.0
0.012,6,10,1972,5,910,3.0,642.0,642.0,5,1062,3.0,794.0,794.0
0.141,6,10,1506,5,395,31.0,127.0,127.0,5,1111,31.0,843.0,843.0
0.036,6,10,1989,5,910,8.0,642.0,642.0,5,1079,9.0,811.0,811.0
0.013,6,10,1631,5,848,3.0,580.0,580.0,5,783,3.0,515.0,515.0
0.078,6,10,1506,5,395,15.0,127.0,127.0,5,1111,17.0,843.0,843.0
0.071,6,10,1506,5,395,16.0,127.0,127.0,5,1111,16.0,843.0,843.0
0.005,6,14,3736,7,446,0.0,74.0,74.0,7,3290,0.0,1448.0,972.0
40.066,17,10,676,5,460,10013.0,104.0,64.0,5,216,10015.0,20.0,15.0
0.005,17,2,179,1,71,0.0,43.0,43.0,1,108,0.0,80.0,80.0
0.011,6,13,3735,7,497,1.0,125.0,125.0,6,3238,2.0,1470.0,1459.0
0.005,17,2,170,1,65,0.0,37.0,37.0,1,105,0.0,77.0,77.0
0.008,6,10,1989,5,910,2.0,642.0,642.0,5,1079,1.0,811.0,811.0
0.008,6,10,1972,5,910,2.0,642.0,642.0,5,1062,2.0,794.0,794.0
0.006,17,2,230,1,68,0.0,40.0,40.0,1,162,0.0,134.0,134.0
0.005,6,10,1774,5,923,1.0,655.0,655.0,5,851,1.0,583.0,583.0
1799.351,17,2915,219583,1452,116266,1240.0,82.0,52.0,1463,103317,1230.0,226.0,42.0
0.007,6,10,2006,5,927,1.0,659.0,659.0,5,1079,1.0,811.0,811.0
240.087,6,16,4482,9,963,30010.0,238.0,166.0,7,3519,40014.0,1402.0,786.0
40.056,17,10,676,5,460,10013.0,104.0,64.0,5,216,10013.0,20.0,15.0
10.916,17,28,4424,14,1995,830.0,270.0,114.0,14,2429,830.0,588.0,145.0
0.004,17,2,148,1,60,0.0,32.0,32.0,1,88,0.0,60.0,60.0
0.005,6,10,2006,5,927,1.0,659.0,659.0,5,1079,1.0,811.0,811.0
0.006,6,10,1547,5,764,1.0,496.0,496.0,5,783,1.0,515.0,515.0
0.042,17,2,170,1,65,0.0,37.0,37.0,1,105,0.0,77.0,77.0
0.005,6,10,1774,5,923,1.0,655.0,655.0,5,851,1.0,583.0,583.0
0.003,17,2,185,1,73,0.0,45.0,45.0,1,112,0.0,84.0,84.0
0.005,17,2,144,1,64,0.0,36.0,36.0,1,80,0.0,52.0,52.0
1770.527,6,83,4367,42,2211,43182.0,27.0,27.0,41,2156,44262.0,24.0,24.0
0.013,6,10,1989,5,910,3.0,642.0,642.0,5,1079,3.0,811.0,811.0
0.004,6,10,2006,5,927,1.0,659.0,659.0,5,1079,1.0,811.0,811.0
0.005,6,10,1854,5,889,1.0,621.0,621.0,5,965,1.0,697.0,697.0
0.04,17,4,420,2,122,1.0,33.0,33.0,2,298,36.0,145.0,121.0
0.006,6,10,1547,5,764,1.0,496.0,496.0,5,783,1.0,515.0,515.0
0.003,17,2,162,1,65,0.0,37.0,37.0,1,97,0.0,69.0,69.0
0.005,17,2,179,1,71,0.0,43.0,43.0,1,108,0.0,80.0,80.0
0.259,17,39,20143,21,17041,12.0,1350.0,783.0,18,3102,11.0,1350.0,144.0
240.009,6,9,787,5,488,60002.0,232.0,232.0,4,299,80002.0,83.0,83.0
0.006,6,10,2000,5,927,1.0,659.0,659.0,5,1073,1.0,805.0,805.0
0.013,6,10,1983,5,910,3.0,642.0,642.0,5,1073,3.0,805.0,805.0
0.005,6,10,2006,5,927,1.0,659.0,659.0,5,1079,1.0,811.0,811.0
0.013,6,10,1989,5,910,3.0,642.0,642.0,5,1079,3.0,811.0,811.0
0.003,17,2,136,1,60,0.0,32.0,32.0,1,76,0.0,48.0,48.0
0.8,6,10,937,6,427,160.0,107.0,107.0,4,510,178.0,294.0,294.0
15.342,17,46,24376,25,21218,638.0,1350.0,820.0,21,3158,765.0,1350.0,122.0
0.005,6,10,2006,5,927,1.0,659.0,659.0,5,1079,1.0,811.0,811.0
0.03,6,10,1983,5,910,7.0,642.0,642.0,5,1073,7.0,805.0,805.0
40.052,17,10,676,5,460,10012.0,104.0,64.0,5,216,10012.0,20.0,15.0
0.011,6,10,1972,5,910,2.0,642.0,642.0,5,1062,2.0,794.0,794.0
0.006,17,2,136,1,60,0.0,32.0,32.0,1,76,0.0,48.0,48.0
0.1,6,10,1506,5,395,22.0,127.0,127.0,5,1111,21.0,843.0,843.0
0.082,6,10,1506,5,395,19.0,127.0,127.0,5,1111,20.0,843.0,843.0
0.005,6,10,2007,5,928,1.0,660.0,660.0,5,1079,1.0,811.0,811.0
0.005,6,10,1689,5,839,1.0,571.0,571.0,5,850,1.0,582.0,582.0
0.167,17,2,152,1,76,0.0,48.0,48.0,1,76,0.0,48.0,48.0
40.071,17,10,676,5,460,10014.0,104.0,64.0,5,216,10017.0,20.0,15.0
11.082,17,24,3751,12,1993,997.0,588.0,138.0,12,1758,997.0,269.0,118.0
30.451,6,46,15021,23,9029,413.0,4080.0,1344.0,23,5992,1376.0,2667.0,361.0
0.014,6,10,1990,5,911,3.0,643.0,643.0,5,1079,3.0,811.0,811.0
0.01,6,10,1631,5,848,2.0,580.0,580.0,5,783,2.0,515.0,515.0
0.005,6,10,2006,5,927,1.0,659.0,659.0,5,1079,1.0,811.0,811.0
300.906,6,31,8252,17,2682,18806.0,745.0,355.0,14,5570,23146.0,1593.0,605.0
0.012,6,10,1990,5,911,3.0,643.0,643.0,5,1079,2.0,811.0,811.0
0.005,17,2,170,1,65,0.0,37.0,37.0,1,105,0.0,77.0,77.0
0.01,6,10,1972,5,910,2.0,642.0,642.0,5,1062,2.0,794.0,794.0
0.006,17,2,164,1,74,0.0,46.0,46.0,1,90,0.0,62.0,62.0
10.863,17,28,4421,14,1994,826.0,269.0,114.0,14,2427,826.0,586.0,145.0
0.016,6,10,1989,5,910,4.0,642.0,642.0,5,1079,4.0,811.0,811.0
321.583,17,20,1124,10,716,35719.0,48.0,43.0,10,408,35724.0,20.0,12.0
0.005,6,10,2006,5,927,1.0,659.0,659.0,5,1079,1.0,811.0,811.0
1798.234,6,64,7350,42,4470,43859.0,1626.0,108.0,22,2880,85622.0,1116.0,82.0
0.001,17,2,180,1,66,0.0,38.0,38.0,1,114,0.0,86.0,86.0
0.013,6,10,1990,5,911,3.0,643.0,643.0,5,1079,3.0,811.0,811.0
0.009,6,10,1972,5,910,2.0,642.0,642.0,5,1062,2.0,794.0,794.0
0.008,6,10,1990,5,911,1.0,643.0,643.0,5,1079,2.0,811.0,811.0
0.004,6,10,1989,5,927,1.0,659.0,659.0,5,1062,0.0,794.0,794.0
0.015,6,10,1989,5,910,3.0,642.0,642.0,5,1079,3.0,811.0,811.0
1730.409,6,45,2790,30,1725,59669.0,35.0,35.0,15,1065,123594.0,31.0,31.0
0.006,6,10,1547,5,764,1.0,496.0,496.0,5,783,1.0,515.0,515.0
0.006,17,2,164,1,74,0.0,46.0,46.0,1,90,0.0,62.0,62.0
0.015,6,13,3735,7,497,2.0,125.0,125.0,6,3238,2.0,1470.0,1459.0
11.02,17,28,4420,14,1993,839.0,268.0,114.0,14,2427,839.0,586.0,145.0
0.005,6,10,1779,5,928,1.0,660.0,660.0,5,851,1.0,583.0,583.0
0.04,17,4,284,2,120,1.0,32.0,32.0,2,164,2.0,60.0,54.0
40.064,17,10,676,5,460,10012.0,104.0,64.0,5,216,10015.0,20.0,15.0
0.004,6,10,1702,5,863,0.0,595.0,595.0,5,839,1.0,571.0,571.0
240.112,6,31,9172,15,6713,17150.0,1835.0,659.0,16,2459,16007.0,580.0,202.0
0.005,6,13,3690,7,452,0.0,80.0,80.0,6,3238,0.0,1470.0,1459.0
0.006,17,2,179,1,71,0.0,43.0,43.0,1,108,0.0,80.0,80.0
0.117,6,10,1506,5,395,24.0,127.0,127.0,5,1111,26.0,843.0,843.0
478.204,6,34,11329,18,3347,28128.0,676.0,400.0,16,7982,31877.0,1402.0,794.0
0.005,6,15,3794,8,504,0.0,80.0,80.0,7,3290,0.0,1448.0,972.0
0.074,6,10,1506,5,395,15.0,127.0,127.0,5,1111,17.0,843.0,843.0
0.005,17,2,168,1,76,0.0,48.0,48.0,1,92,0.0,64.0,64.0
0.006,6,10,1547,5,764,1.0,496.0,496.0,5,783,1.0,515.0,515.0
1778.649,17,144,41760,72,22752,25051.0,288.0,288.0,72,19008,25051.0,236.0,236.0
0.008,6,10,1989,5,910,2.0,642.0,642.0,5,1079,1.0,811.0,811.0
0.006,6,10,1689,5,839,1.0,571.0,571.0,5,850,1.0,582.0,582.0
0.013,6,10,1972,5,910,3.0,642.0,642.0,5,1062,3.0,794.0,794.0
0.004,6,10,1989,5,927,1.0,659.0,659.0,5,1062,1.0,794.0,794.0
0.11,6,10,1506,5,395,21.0,127.0,127.0,5,1111,26.0,843.0,843.0
40.061,17,10,676,5,460,10012.0,104.0,64.0,5,216,10014.0,20.0,15.0
361.829,6,21,1792,16,1030,24121.0,190.0,190.0,5,762,60009.0,461.0,247.0
0.007,6,10,1547,5,764,1.0,496.0,496.0,5,783,1.0,515.0,515.0
0.108,6,10,1506,5,395,23.0,127.0,127.0,5,1111,22.0,843.0,843.0
183.129,17,82,11883,41,2757,4578.0,44.0,39.0,41,9126,4578.0,260.0,194.0
0.004,6,10,1702,5,863,1.0,595.0,595.0,5,839,1.0,571.0,571.0
128.594,6,26,9525,12,1627,92.0,794.0,367.0,14,7898,9882.0,1360.0,732.0
0.008,17,2,179,1,71,0.0,43.0,43.0,1,108,0.0,80.0,80.0
0.1,6,10,1506,5,395,18.0,127.0,127.0,5,1111,22.0,843.0,843.0
0.004,6,10,2006,5,927,1.0,659.0,659.0,5,1079,1.0,811.0,811.0
0.005,6,10,2007,5,928,1.0,660.0,660.0,5,1079,1.0,811.0,811.0
0.069,17,8,3613,4,1874,23.0,1350.0,440.0,4,1739,11.0,1350.0,406.0
0.004,17,2,132,1,58,0.0,30.0,30.0,1,74,0.0,46.0,46.0
0.089,6,10,1506,5,395,19.0,127.0,127.0,5,1111,16.0,843.0,843.0
0.005,17,2,170,1,65,0.0,37.0,37.0,1,105,0.0,77.0,77.0
0.08,6,10,1506,5,395,18.0,127.0,127.0,5,1111,17.0,843.0,843.0
0.005,17,2,170,1,65,0.0,37.0,37.0,1,105,0.0,77.0,77.0
0.018,6,10,1677,5,827,4.0,559.0,559.0,5,850,4.0,582.0,582.0
0.106,6,10,1506,5,395,24.0,127.0,127.0,5,1111,25.0,843.0,843.0
0.007,6,10,1547,5,764,1.0,496.0,496.0,5,783,1.0,515.0,515.0
0.089,6,10,1506,5,395,17.0,127.0,127.0,5,1111,20.0,843.0,843.0
0.005,17,2,148,1,60,0.0,32.0,32.0,1,88,0.0,60.0,60.0
40.064,17,10,676,5,460,10015.0,104.0,64.0,5,216,10015.0,20.0,15.0
0.004,17,4,284,2,120,0.0,32.0,32.0,2,164,1.0,60.0,54.0
0.017,6,10,1972,5,910,4.0,642.0,642.0,5,1062,4.0,794.0,794.0
0.082,6,10,1506,5,395,18.0,127.0,127.0,5,1111,19.0,843.0,843.0
0.077,17,2,148,1,60,0.0,32.0,32.0,1,88,0.0,60.0,60.0
0.015,6,10,1972,5,910,3.0,642.0,642.0,5,1062,3.0,794.0,794.0
0.025,6,12,1698,6,863,5.0,327.0,271.0,6,835,5.0,515.0,515.0
0.005,6,10,1989,5,927,1.0,659.0,659.0,5,1062,1.0,794.0,794.0
0.018,6,10,1983,5,910,4.0,642.0,642.0,5,1073,4.0,805.0,805.0
0.072,6,10,1506,5,395,16.0,127.0,127.0,5,1111,13.0,843.0,843.0
0.005,6,10,1689,5,839,1.0,571.0,571.0,5,850,1.0,582.0,582.0
0.003,17,4,284,2,120,0.0,32.0,32.0,2,164,0.0,60.0,54.0
1.039,6,12,3142,6,2099,156.0,1328.0,923.0,6,1043,156.0,791.0,791.0
0.015,6,10,1983,5,910,3.0,642.0,642.0,5,1073,3.0,805.0,805.0
0.009,6,10,1989,5,910,2.0,642.0,642.0,5,1079,2.0,811.0,811.0
0.014,6,13,3735,7,497,2.0,125.0,125.0,6,3238,2.0,1470.0,1459.0
0.011,6,10,1631,5,848,2.0,580.0,580.0,5,783,2.0,515.0,515.0
0.089,6,10,1506,5,395,20.0,127.0,127.0,5,1111,17.0,843.0,843.0
40.066,17,10,676,5,460,10013.0,104.0,64.0,5,216,10015.0,20.0,15.0
0.005,6,10,1547,5,764,1.0,496.0,496.0,5,783,1.0,515.0,515.0
0.005,17,2,170,1,65,0.0,37.0,37.0,1,105,0.0,77.0,77.0
0.009,6,12,1926,6,1189,1.0,659.0,434.0,6,737,1.0,417.0,417.0
0.154,6,10,1506,5,395,33.0,127.0,127.0,5,1111,33.0,843.0,843.0
40.068,17,10,676,5,460,10014.0,104.0,64.0,5,216,10016.0,20.0,15.0
0.071,17,2,152,1,76,0.0,48.0,48.0,1,76,0.0,48.0,48.0
0.009,6,10,1854,5,889,2.0,621.0,621.0,5,965,2.0,697.0,697.0
0.019,6,10,1989,5,910,4.0,642.0,642.0,5,1079,4.0,811.0,811.0
0.005,17,2,180,1,58,0.0,30.0,30.0,1,122,0.0,94.0,94.0
0.016,6,10,1990,5,911,4.0,643.0,643.0,5,1079,4.0,811.0,811.0
0.075,6,10,1506,5,395,15.0,127.0,127.0,5,1111,15.0,843.0,843.0
0.003,17,2,656,1,328,0.0,300.0,300.0,1,328,0.0,300.0,300.0
0.001,17,2,180,1,66,0.0,38.0,38.0,1,114,0.0,86.0,86.0
0.01,6,10,1983,5,910,2.0,642.0,642.0,5,1073,2.0,805.0,805.0
0.091,6,10,1506,5,395,21.0,127.0,127.0,5,1111,19.0,843.0,843.0
0.004,6,10,1702,5,863,1.0,595.0,595.0,5,839,0.0,571.0,571.0
0.005,6,10,2006,5,927,1.0,659.0,659.0,5,1079,1.0,811.0,811.0
0.302,17,39,20272,21,17044,15.0,1350.0,783.0,18,3228,15.0,1350.0,151.0
0.013,6,10,1989,5,910,3.0,642.0,642.0,5,1079,3.0,811.0,811.0
0.005,6,10,2006,5,927,1.0,659.0,659.0,5,1079,1.0,811.0,811.0
0.017,6,10,1677,5,827,4.0,559.0,559.0,5,850,4.0,582.0,582.0
0.005,6,10,1854,5,889,1.0,621.0,621.0,5,965,1.0,697.0,697.0
0.036,17,2,148,1,60,0.0,32.0,32.0,1,88,0.0,60.0,60.0
0.008,6,10,1989,5,927,2.0,659.0,659.0,5,1062,2.0,794.0,794.0
0.005,6,13,3747,7,509,0.0,137.0,137.0,6,3238,0.0,1470.0,1459.0
0.015,6,10,1989,5,910,3.0,642.0,642.0,5,1079,3.0,811.0,811.0
0.075,6,10,1506,5,395,16.0,127.0,127.0,5,1111,17.0,843.0,843.0
0.005,6,10,1689,5,839,1.0,571.0,571.0,5,850,1.0,582.0,582.0
0.015,6,10,1762,5,911,3.0,643.0,643.0,5,851,3.0,583.0,583.0
0.005,6,10,2006,5,927,1.0,659.0,659.0,5,1079,1.0,811.0,811.0
0.009,6,10,1989,5,910,2.0,642.0,642.0,5,1079,2.0,811.0,811.0
0.005,6,10,2006,5,927,1.0,659.0,659.0,5,1079,1.0,811.0,811.0
240.454,6,35,8924,18,2073,14144.0,694.0,225.0,17,6851,15028.0,1402.0,597.0
0.013,6,10,1972,5,910,3.0,642.0,642.0,5,1062,3.0,794.0,794.0
0.005,6,10,2007,5,928,1.0,660.0,660.0,5,1079,1.0,811.0,811.0
0.041,17,2,152,1,76,0.0,48.0,48.0,1,76,0.0,48.0,48.0
0.008,6,10,1547,5,764,1.0,496.0,496.0,5,783,1.0,515.0,515.0
0.007,6,10,1989,5,910,1.0,642.0,642.0,5,1079,1.0,811.0,811.0
0.015,6,10,1972,5,910,3.0,642.0,642.0,5,1062,3.0,794.0,794.0
0.078,17,4,352,2,130,0.0,37.0,37.0,2,222,38.0,89.0,83.0
0.005,6,10,2000,5,927,1.0,659.0,659.0,5,1073,1.0,805.0,805.0
0.008,6,10,1989,5,910,2.0,642.0,642.0,5,1079,2.0,811.0,811.0
0.039,17,2,234,1,61,0.0,33.0,33.0,1,173,0.0,145.0,145.0
0.003,17,2,136,1,60,0.0,32.0,32.0,1,76,0.0,48.0,48.0
0.107,6,10,1506,5,395,23.0,127.0,127.0,5,1111,24.0,843.0,843.0
0.006,17,2,180,1,66,0.0,38.0,38.0,1,114,0.0,86.0,86.0
0.005,6,10,1989,5,927,1.0,659.0,659.0,5,1062,1.0,794.0,794.0
10.823,17,28,4422,14,1994,824.0,269.0,114.0,14,2428,824.0,587.0,145.0
0.013,6,10,1989,5,910,3.0,642.0,642.0,5,1079,3.0,811.0,811.0
513.815,6,30,9985,15,2516,36701.0,661.0,345.0,15,7469,32412.0,1402.0,742.0
0.009,6,12,1926,6,1189,1.0,659.0,434.0,6,737,1.0,417.0,417.0
0.005,6,10,2006,5,927,1.0,659.0,659.0,5,1079,1.0,811.0,811.0
0.018,6,10,1989,5,910,4.0,642.0,642.0,5,1079,4.0,811.0,811.0
0.004,6,10,2007,5,928,1.0,660.0,660.0,5,1079,1.0,811.0,811.0
1726.215,6,61,7124,40,4332,44261.0,1625.0,112.0,21,2792,86302.0,1111.0,85.0
0.141,6,10,1506,5,395,32.0,127.0,127.0,5,1111,30.0,843.0,843.0
289.004,6,396,348355,192,21548,1513.0,2736.0,888.0,204,326807,1423.0,2804.0,1664.0
0.004,6,10,2007,5,928,1.0,660.0,660.0,5,1079,1.0,811.0,811.0
0.006,6,10,1547,5,764,1.0,496.0,496.0,5,783,1.0,515.0,515.0
0.023,17,2,213,1,69,0.0,41.0,41.0,1,144,0.0,116.0,116.0
0.005,17,2,247,1,72,0.0,44.0,44.0,1,175,0.0,147.0,147.0
360.065,6,21,3981,13,3142,30005.0,494.0,494.0,8,839,51437.0,83.0,83.0
300.963,6,45,15187,24,9320,13085.0,2720.0,1041.0,21,5867,439.0,2667.0,385.0
0.005,17,2,293,1,73,0.0,45.0,45.0,1,220,0.0,192.0,192.0
0.04,17,4,284,2,120,0.0,32.0,32.0,2,164,37.0,60.0,54.0
1778.581,17,145,45820,74,23384,24364.0,288.0,288.0,71,22436,25407.0,288.0,288.0
312.81,17,20,1124,10,716,34743.0,48.0,43.0,10,408,34743.0,20.0,12.0
0.003,17,2,186,1,61,0.0,33.0,33.0,1,125,0.0,97.0,97.0
0.009,6,10,1983,5,910,2.0,642.0,642.0,5,1073,2.0,805.0,805.0
0.076,6,10,1506,5,395,16.0,127.0,127.0,5,1111,17.0,843.0,843.0
0.005,6,10,2006,5,927,1.0,659.0,659.0,5,1079,1.0,811.0,811.0
326.811,17,20,1124,10,716,36305.0,48.0,43.0,10,408,36305.0,20.0,12.0
0.004,17,2,136,1,60,0.0,32.0,32.0,1,76,0.0,48.0,48.0
0.005,6,10,2000,5,927,1.0,659.0,659.0,5,1073,1.0,805.0,805.0
0.038,17,4,284,2,120,0.0,32.0,32.0,2,164,34.0,60.0,54.0
0.012,6,12,1926,6,1189,2.0,659.0,434.0,6,737,2.0,417.0,417.0
0.013,6,10,1983,5,910,3.0,642.0,642.0,5,1073,3.0,805.0,805.0
0.003,17,2,148,1,60,0.0,32.0,32.0,1,88,0.0,60.0,60.0
0.009,6,12,1926,6,1189,1.0,659.0,434.0,6,737,1.0,417.0,417.0
0.005,6,10,2006,5,927,1.0,659.0,659.0,5,1079,1.0,811.0,811.0
0.081,6,10,1506,5,395,17.0,127.0,127.0,5,1111,17.0,843.0,843.0
0.007,6,10,1854,5,889,1.0,621.0,621.0,5,965,1.0,697.0,697.0
0.008,6,10,1983,5,910,1.0,642.0,642.0,5,1073,2.0,805.0,805.0
0.005,6,14,3799,7,509,0.0,137.0,137.0,7,3290,0.0,1448.0,972.0
0.002,17,2,166,1,75,0.0,47.0,47.0,1,91,0.0,63.0,63.0
0.007,6,10,1989,5,910,1.0,642.0,642.0,5,1079,1.0,811.0,811.0
0.021,6,10,1990,5,911,5.0,643.0,643.0,5,1079,5.0,811.0,811.0
176.124,17,74,10653,37,2466,4892.0,44.0,38.0,37,8187,4892.0,239.0,193.0
0.016,6,10,1631,5,848,4.0,580.0,580.0,5,783,4.0,515.0,515.0
0.008,17,2,170,1,65,0.0,37.0,37.0,1,105,0.0,77.0,77.0
1743.427,6,64,7360,42,4484,42522.0,1640.0,109.0,22,2876,83012.0,1112.0,82.0
0.009,6,10,1972,5,910,2.0,642.0,642.0,5,1062,2.0,794.0,794.0
0.037,6,10,1972,5,910,9.0,642.0,642.0,5,1062,9.0,794.0,794.0
0.111,6,10,1506,5,395,23.0,127.0,127.0,5,1111,22.0,843.0,843.0
0.005,17,2,240,1,61,0.0,33.0,33.0,1,179,0.0,151.0,151.0
15.074,17,15,9239,8,6902,2149.0,1350.0,834.0,7,2337,2507.0,1350.0,305.0
0.089,6,10,1506,5,395,21.0,127.0,127.0,5,1111,19.0,843.0,843.0
0.013,6,10,1989,5,910,3.0,642.0,642.0,5,1079,3.0,811.0,811.0
0.005,6,10,1989,5,927,1.0,659.0,659.0,5,1062,1.0,794.0,794.0
0.005,6,10,2006,5,927,1.0,659.0,659.0,5,1079,1.0,811.0,811.0
0.013,6,10,1631,5,848,3.0,580.0,580.0,5,783,3.0,515.0,515.0
0.069,17,8,3613,4,1874,23.0,1350.0,440.0,4,1739,12.0,1350.0,406.0
0.004,6,10,2000,5,927,1.0,659.0,659.0,5,1073,1.0,805.0,805.0
162.098,17,68,9778,34,2274,4911.0,44.0,38.0,34,7504,4911.0,239.0,192.0
0.089,6,10,1506,5,395,19.0,127.0,127.0,5,1111,18.0,843.0,843.0
310.88,17,20,1124,10,716,34527.0,48.0,43.0,10,408,34527.0,20.0,12.0
0.004,17,2,148,1,60,0.0,32.0,32.0,1,88,0.0,60.0,60.0
0.005,6,10,1774,5,923,1.0,655.0,655.0,5,851,1.0,583.0,583.0
0.009,6,10,1989,5,910,2.0,642.0,642.0,5,1079,2.0,811.0,811.0
0.003,17,4,420,2,122,0.0,33.0,33.0,2,298,0.0,145.0,121.0
0.006,6,10,2006,5,927,1.0,659.0,659.0,5,1079,1.0,811.0,811.0
0.006,6,10,1854,5,889,1.0,621.0,621.0,5,965,1.0,697.0,697.0
0.006,6,10,1547,5,764,1.0,496.0,496.0,5,783,1.0,515.0,515.0
0.013,6,10,1983,5,910,3.0,642.0,642.0,5,1073,3.0,805.0,805.0
0.006,6,10,1547,5,764,1.0,496.0,496.0,5,783,1.0,515.0,515.0
0.109,6,10,1506,5,395,24.0,127.0,127.0,5,1111,25.0,843.0,843.0
0.019,6,10,1631,5,848,4.0,580.0,580.0,5,783,4.0,515.0,515.0
0.006,6,12,1698,6,863,1.0,327.0,271.0,6,835,1.0,515.0,515.0
0.004,6,10,1989,5,927,1.0,659.0,659.0,5,1062,1.0,794.0,794.0
0.005,6,10,1643,5,860,1.0,592.0,592.0,5,783,1.0,515.0,515.0
0.17,17,2,152,1,76,0.0,48.0,48.0,1,76,0.0,48.0,48.0
0.008,6,10,1990,5,911,2.0,643.0,643.0,5,1079,1.0,811.0,811.0
0.014,6,10,1989,5,910,3.0,642.0,642.0,5,1079,3.0,811.0,811.0
0.06,17,2,80,1,32,0.0,4.0,4.0,1,48,0.0,20.0,20.0
0.006,6,12,1698,6,863,1.0,327.0,271.0,6,835,1.0,515.0,515.0
0.064,6,10,1506,5,395,15.0,127.0,127.0,5,1111,15.0,843.0,843.0
0.014,6,10,1989,5,910,3.0,642.0,642.0,5,1079,3.0,811.0,811.0
0.009,6,10,1631,5,848,2.0,580.0,580.0,5,783,2.0,515.0,515.0
0.006,6,10,1547,5,764,1.0,496.0,496.0,5,783,1.0,515.0,515.0
0.005,17,2,166,1,75,0.0,47.0,47.0,1,91,0.0,63.0,63.0
0.003,17,2,136,1,60,0.0,32.0,32.0,1,76,0.0,48.0,48.0
369.752,6,22,2313,16,867,24650.0,195.0,195.0,6,1446,4636.0,419.0,398.0
0.068,17,8,3613,4,1874,22.0,1350.0,440.0,4,1739,11.0,1350.0,406.0
0.018,6,12,1723,6,954,3.0,421.0,317.0,6,769,3.0,449.0,449.0
0.006,6,10,1989,5,910,1.0,642.0,642.0,5,1079,1.0,811.0,811.0
15.072,17,15,9238,8,6902,2149.0,1350.0,834.0,7,2336,2507.0,1350.0,305.0
0.005,6,10,1779,5,928,1.0,660.0,660.0,5,851,1.0,583.0,583.0
0.008,6,12,1926,6,1189,1.0,659.0,434.0,6,737,1.0,417.0,417.0
40.062,17,10,676,5,460,10014.0,104.0,64.0,5,216,10014.0,20.0,15.0
0.037,17,2,170,1,65,0.0,37.0,37.0,1,105,0.0,77.0,77.0
10.809,17,28,4423,14,1995,823.0,270.0,114.0,14,2428,822.0,587.0,145.0
0.014,6,10,1989,5,910,3.0,642.0,642.0,5,1079,3.0,811.0,811.0
0.005,6,10,2006,5,927,1.0,659.0,659.0,5,1079,1.0,811.0,811.0
0.014,6,10,1990,5,911,3.0,643.0,643.0,5,1079,3.0,811.0,811.0
0.006,6,10,1854,5,889,1.0,621.0,621.0,5,965,1.0,697.0,697.0
40.062,17,10,676,5,460,10013.0,104.0,64.0,5,216,10014.0,20.0,15.0
0.001,17,2,180,1,66,0.0,38.0,38.0,1,114,0.0,86.0,86.0
353.996,6,21,1794,16,1030,23599.0,190.0,190.0,5,764,60003.0,463.0,248.0
0.011,6,10,1983,5,910,2.0,642.0,642.0,5,1073,2.0,805.0,805.0
0.152,6,10,1506,5,395,32.0,127.0,127.0,5,1111,34.0,843.0,843.0
0.006,6,10,1547,5,764,1.0,496.0,496.0,5,783,1.0,515.0,515.0
0.041,17,2,396,1,61,0.0,33.0,33.0,1,335,0.0,307.0,307.0
0.014,6,10,1989,5,910,3.0,642.0,642.0,5,1079,3.0,811.0,811.0
0.004,17,2,148,1,60,0.0,32.0,32.0,1,88,0.0,60.0,60.0
0.005,6,10,1989,5,927,1.0,659.0,659.0,5,1062,1.0,794.0,794.0
0.005,6,10,1689,5,839,1.0,571.0,571.0,5,850,1.0,582.0,582.0
240.101,6,16,4481,9,963,30012.0,238.0,166.0,7,3518,40016.0,1402.0,786.0
0.008,6,10,1983,5,910,2.0,642.0,642.0,5,1073,2.0,805.0,805.0
0.012,6,10,1983,5,910,3.0,642.0,642.0,5,1073,2.0,805.0,805.0
0.111,6,10,1506,5,395,25.0,127.0,127.0,5,1111,25.0,843.0,843.0
0.004,6,10,2000,5,927,1.0,659.0,659.0,5,1073,1.0,805.0,805.0
0.091,6,10,1506,5,395,19.0,127.0,127.0,5,1111,17.0,843.0,843.0
0.009,6,10,1689,5,839,2.0,571.0,571.0,5,850,2.0,582.0,582.0
0.005,6,10,2007,5,928,1.0,660.0,660.0,5,1079,1.0,811.0,811.0
0.018,6,10,1989,5,910,4.0,642.0,642.0,5,1079,4.0,811.0,811.0
0.003,17,2,148,1,60,0.0,32.0,32.0,1,88,0.0,60.0,60.0
0.005,6,10,2007,5,928,1.0,660.0,660.0,5,1079,1.0,811.0,811.0
0.089,6,10,1506,5,395,20.0,127.0,127.0,5,1111,18.0,843.0,843.0
0.126,17,4,284,2,120,0.0,32.0,32.0,2,164,0.0,60.0,54.0
0.005,6,10,1689,5,839,1.0,571.0,571.0,5,850,1.0,582.0,582.0
0.021,17,2,152,1,56,0.0,28.0,28.0,1,96,0.0,68.0,68.0
0.009,6,10,1983,5,910,2.0,642.0,642.0,5,1073,2.0,805.0,805.0
10.808,17,28,4423,14,1995,823.0,270.0,114.0,14,2428,822.0,587.0,145.0
0.02,6,10,1983,5,910,4.0,642.0,642.0,5,1073,4.0,805.0,805.0
0.004,6,10,2000,5,927,1.0,659.0,659.0,5,1073,1.0,805.0,805.0
0.058,17,2,367,1,99,0.0,71.0,71.0,1,268,0.0,240.0,240.0
0.005,6,10,2006,5,927,1.0,659.0,659.0,5,1079,1.0,811.0,811.0
0.014,6,10,1972,5,910,3.0,642.0,642.0,5,1062,3.0,794.0,794.0
0.011,6,10,1989,5,910,2.0,642.0,642.0,5,1079,2.0,811.0,811.0
0.008,6,10,1989,5,910,2.0,642.0,642.0,5,1079,2.0,811.0,811.0
40.083,17,10,676,5,460,10019.0,104.0,64.0,5,216,10019.0,20.0,15.0
0.0,17,2,136,1,60,0.0,32.0,32.0,1,76,0.0,48.0,48.0
0.005,6,10,2006,5,927,1.0,659.0,659.0,5,1079,1.0,811.0,811.0
0.003,17,2,148,1,60,0.0,32.0,32.0,1,88,0.0,60.0,60.0
0.104,6,10,1506,5,395,24.0,127.0,127.0,5,1111,22.0,843.0,843.0
0.005,6,10,2006,5,927,1.0,659.0,659.0,5,1079,1.0,811.0,811.0
0.075,6,10,1506,5,395,14.0,127.0,127.0,5,1111,18.0,843.0,843.0
143.191,6,22,8498,12,2236,73.0,1345.0,574.0,10,6262,15891.0,2720.0,975.0
0.039,17,4,284,2,120,0.0,32.0,32.0,2,164,36.0,60.0,54.0
0.124,6,10,1506,5,395,28.0,127.0,127.0,5,1111,29.0,843.0,843.0
0.085,6,10,1506,5,395,19.0,127.0,127.0,5,1111,19.0,843.0,843.0
15.073,17,15,9238,8,6902,2149.0,1350.0,834.0,7,2336,2507.0,1350.0,305.0
0.005,6,14,3742,7,452,0.0,80.0,80.0,7,3290,0.0,1448.0,972.0
0.004,6,10,2006,5,927,1.0,659.0,659.0,5,1079,1.0,811.0,811.0
0.094,6,10,1506,5,395,19.0,127.0,127.0,5,1111,22.0,843.0,843.0
0.005,6,10,2007,5,928,1.0,660.0,660.0,5,1079,1.0,811.0,811.0
40.07,17,10,676,5,460,10016.0,104.0,64.0,5,216,10016.0,20.0,15.0
0.007,6,10,1854,5,889,1.0,621.0,621.0,5,965,1.0,697.0,697.0
0.139,6,10,1506,5,395,32.0,127.0,127.0,5,1111,24.0,843.0,843.0
0.008,6,10,1989,5,910,1.0,642.0,642.0,5,1079,1.0,811.0,811.0
0.013,6,10,1989,5,910,3.0,642.0,642.0,5,1079,3.0,811.0,811.0
0.009,6,10,1990,5,911,2.0,643.0,643.0,5,1079,2.0,811.0,811.0
0.005,6,10,1547,5,764,1.0,496.0,496.0,5,783,1.0,515.0,515.0
173.477,17,82,11571,41,2735,4336.0,44.0,38.0,41,8836,4336.0,261.0,187.0
0.004,6,10,1779,5,928,1.0,660.0,660.0,5,851,1.0,583.0,583.0
0.08,6,10,1506,5,395,18.0,127.0,127.0,5,1111,18.0,843.0,843.0
0.005,6,10,1779,5,928,1.0,660.0,660.0,5,851,1.0,583.0,583.0
10.933,17,28,4421,14,1993,832.0,268.0,114.0,14,2428,832.0,587.0,145.0
0.009,6,10,1631,5,848,2.0,580.0,580.0,5,783,2.0,515.0,515.0
0.005,6,10,1774,5,923,1.0,655.0,655.0,5,851,1.0,583.0,583.0
0.009,6,10,1972,5,910,2.0,642.0,642.0,5,1062,2.0,794.0,794.0
0.005,6,10,2000,5,927,1.0,659.0,659.0,5,1073,1.0,805.0,805.0
0.004,6,10,2000,5,927,1.0,659.0,659.0,5,1073,1.0,805.0,805.0
40.056,17,10,676,5,460,10013.0,104.0,64.0,5,216,10013.0,20.0,15.0
0.006,6,10,1547,5,764,1.0,496.0,496.0,5,783,1.0,515.0,515.0
0.053,17,2,152,1,76,0.0,48.0,48.0,1,76,0.0,48.0,48.0
1787.907,6,274,25563,137,8976,13146.0,747.0,263.0,137,16587,13146.0,1626.0,72.0
0.006,17,2,179,1,71,0.0,43.0,43.0,1,108,0.0,80.0,80.0
0.009,6,10,1989,5,910,2.0,642.0,642.0,5,1079,2.0,811.0,811.0
15.08,17,16,8532,8,6319,2149.0,1350.0,761.0,8,2213,2150.0,1350.0,248.0
0.005,6,10,2006,5,927,1.0,659.0,659.0,5,1079,1.0,811.0,811.0
0.096,6,10,1506,5,395,20.0,127.0,127.0,5,1111,19.0,843.0,843.0
0.075,6,10,1506,5,395,17.0,127.0,127.0,5,1111,16.0,843.0,843.0
240.082,6,16,4480,9,963,30010.0,238.0,166.0,7,3517,40013.0,1402.0,786.0
0.004,6,10,1774,5,923,1.0,655.0,655.0,5,851,1.0,583.0,583.0
0.014,6,10,1972,5,910,3.0,642.0,642.0,5,1062,3.0,794.0,794.0
223.333,6,260,201661,132,188486,9.0,3990.0,1761.0,128,13175,1758.0,1330.0,321.0
0.103,6,10,1506,5,395,22.0,127.0,127.0,5,1111,23.0,843.0,843.0
0.016,17,2,198,1,91,0.0,63.0,63.0,1,107,0.0,79.0,79.0
0.005,17,2,170,1,65,0.0,37.0,37.0,1,105,0.0,77.0,77.0
0.006,6,10,2006,5,927,1.0,659.0,659.0,5,1079,1.0,811.0,811.0
0.011,6,10,1972,5,910,2.0,642.0,642.0,5,1062,2.0,794.0,794.0
0.006,6,10,1547,5,764,1.0,496.0,496.0,5,783,1.0,515.0,515.0
0.005,6,14,3736,7,446,0.0,74.0,74.0,7,3290,0.0,1448.0,972.0
0.007,6,10,1547,5,764,1.0,496.0,496.0,5,783,1.0,515.0,515.0
11.13,17,28,4424,14,1995,843.0,270.0,114.0,14,2429,843.0,588.0,145.0
0.001,17,2,180,1,66,0.0,38.0,38.0,1,114,0.0,86.0,86.0
0.005,17,2,136,1,60,0.0,32.0,32.0,1,76,0.0,48.0,48.0
40.057,17,10,676,5,460,10012.0,104.0,64.0,5,216,10013.0,20.0,15.0
0.1,6,10,1506,5,395,21.0,127.0,127.0,5,1111,21.0,843.0,843.0
1777.775,17,144,45504,72,22752,25039.0,288.0,288.0,72,22752,25039.0,288.0,288.0
171.312,17,80,11462,40,2677,4392.0,44.0,38.0,40,8785,4392.0,239.0,191.0
0.038,17,2,182,1,65,0.0,37.0,37.0,1,117,0.0,89.0,89.0
0.004,17,4,284,2,120,0.0,32.0,32.0,2,164,0.0,60.0,54.0
0.001,17,2,136,1,60,0.0,32.0,32.0,1,76,0.0,48.0,48.0
0.004,17,2,136,1,60,0.0,32.0,32.0,1,76,0.0,48.0,48.0
0.005,6,10,1989,5,927,1.0,659.0,659.0,5,1062,1.0,794.0,794.0
0.006,6,10,1689,5,839,1.0,571.0,571.0,5,850,1.0,582.0,582.0
0.007,6,10,1547,5,764,1.0,496.0,496.0,5,783,1.0,515.0,515.0
0.108,6,10,1506,5,395,24.0,127.0,127.0,5,1111,24.0,843.0,843.0
0.001,17,2,180,1,66,0.0,38.0,38.0,1,114,0.0,86.0,86.0
0.073,6,10,1506,5,395,16.0,127.0,127.0,5,1111,15.0,843.0,843.0
0.04,17,2,152,1,76,0.0,48.0,48.0,1,76,0.0,48.0,48.0
0.005,17,2,213,1,69,0.0,41.0,41.0,1,144,0.0,116.0,116.0
0.015,6,13,3735,7,497,2.0,125.0,125.0,6,3238,2.0,1470.0,1459.0
0.01,6,10,1762,5,911,2.0,643.0,643.0,5,851,2.0,583.0,583.0
0.038,17,2,144,1,64,0.0,36.0,36.0,1,80,0.0,52.0,52.0
40.059,17,10,676,5,460,10014.0,104.0,64.0,5,216,10013.0,20.0,15.0
0.01,6,10,1989,5,910,2.0,642.0,642.0,5,1079,2.0,811.0,811.0
0.004,17,4,284,2,120,0.0,32.0,32.0,2,164,0.0,60.0,54.0
361.782,6,21,1793,16,1030,24118.0,190.0,190.0,5,763,60009.0,462.0,247.0
0.005,6,10,1989,5,927,1.0,659.0,659.0,5,1062,1.0,794.0,794.0
0.004,6,10,1779,5,928,1.0,660.0,660.0,5,851,1.0,583.0,583.0
0.005,6,10,1689,5,839,1.0,571.0,571.0,5,850,1.0,582.0,582.0
0.09,6,10,1506,5,395,19.0,127.0,127.0,5,1111,19.0,843.0,843.0
0.005,6,10,2006,5,927,1.0,659.0,659.0,5,1079,1.0,811.0,811.0
0.006,17,2,179,1,71,0.0,43.0,43.0,1,108,0.0,80.0,80.0
0.006,6,10,1547,5,764,1.0,496.0,496.0,5,783,1.0,515.0,515.0
240.02,6,9,787,5,488,60005.0,232.0,232.0,4,299,80005.0,83.0,83.0
0.129,17,2,80,1,32,0.0,4.0,4.0,1,48,0.0,20.0,20.0
0.006,17,2,178,1,81,0.0,53.0,53.0,1,97,0.0,69.0,69.0
0.129,17,2,80,1,32,0.0,4.0,4.0,1,48,0.0,20.0,20.0
0.013,6,10,1989,5,910,3.0,642.0,642.0,5,1079,3.0,811.0,811.0
0.005,17,2,166,1,75,0.0,47.0,47.0,1,91,0.0,63.0,63.0
0.123,6,10,1506,5,395,27.0,127.0,127.0,5,1111,29.0,843.0,843.0
40.062,17,10,676,5,460,10013.0,104.0,64.0,5,216,10014.0,20.0,15.0
0.008,6,12,1926,6,1189,1.0,659.0,434.0,6,737,1.0,417.0,417.0
0.017,6,10,1983,5,910,4.0,642.0,642.0,5,1073,4.0,805.0,805.0
368.861,6,22,2313,16,867,24590.0,195.0,195.0,6,1446,4635.0,419.0,398.0
368.895,6,22,2313,16,867,24593.0,195.0,195.0,6,1446,4636.0,419.0,398.0
0.01,6,10,1547,5,764,2.0,496.0,496.0,5,783,2.0,515.0,515.0
0.077,6,10,1506,5,395,17.0,127.0,127.0,5,1111,15.0,843.0,843.0
0.006,6,10,1547,5,764,1.0,496.0,496.0,5,783,1.0,515.0,515.0
15.072,17,15,9238,8,6902,2149.0,1350.0,834.0,7,2336,2507.0,1350.0,305.0
0.01,6,10,1989,5,910,2.0,642.0,642.0,5,1079,2.0,811.0,811.0
0.018,6,10,1990,5,911,4.0,643.0,643.0,5,1079,4.0,811.0,811.0
0.005,6,10,1989,5,927,1.0,659.0,659.0,5,1062,1.0,794.0,794.0
0.111,6,10,1506,5,395,24.0,127.0,127.0,5,1111,26.0,843.0,843.0
40.068,17,10,676,5,460,10015.0,104.0,64.0,5,216,10016.0,20.0,15.0
0.085,6,10,1506,5,395,19.0,127.0,127.0,5,1111,18.0,843.0,843.0
0.007,17,4,284,2,120,4.0,32.0,32.0,2,164,4.0,60.0,54.0
0.006,6,10,1547,5,764,1.0,496.0,496.0,5,783,1.0,515.0,515.0
40.073,17,10,676,5,460,10015.0,104.0,64.0,5,216,10017.0,20.0,15.0
0.004,17,2,136,1,60,0.0,32.0,32.0,1,76,0.0,48.0,48.0
0.004,17,2,148,1,60,0.0,32.0,32.0,1,88,0.0,60.0,60.0
0.003,17,2,136,1,60,0.0,32.0,32.0,1,76,0.0,48.0,48.0
0.012,6,10,1983,5,910,3.0,642.0,642.0,5,1073,2.0,805.0,805.0
0.006,6,12,1698,6,863,1.0,327.0,271.0,6,835,1.0,515.0,515.0
15.077,17,16,8331,8,6089,2149.0,1350.0,733.0,8,2242,2149.0,1350.0,252.0
0.092,6,10,1506,5,395,21.0,127.0,127.0,5,1111,19.0,843.0,843.0
0.003,17,2,136,1,60,0.0,32.0,32.0,1,76,0.0,48.0,48.0
0.005,6,10,1774,5,923,1.0,655.0,655.0,5,851,1.0,583.0,583.0
0.004,6,15,3794,8,504,0.0,80.0,80.0,7,3290,0.0,1448.0,972.0
0.01,6,10,1762,5,911,2.0,643.0,643.0,5,851,2.0,583.0,583.0
0.001,17,2,179,1,62,0.0,34.0,34.0,1,117,0.0,89.0,89.0
0.004,6,10,2000,5,927,1.0,659.0,659.0,5,1073,1.0,805.0,805.0
0.006,6,14,3742,7,452,0.0,80.0,80.0,7,3290,1.0,1448.0,972.0
0.005,17,2,170,1,65,0.0,37.0,37.0,1,105,0.0,77.0,77.0
0.071,6,10,1506,5,395,15.0,127.0,127.0,5,1111,16.0,843.0,843.0
0.005,6,10,2006,5,927,1.0,659.0,659.0,5,1079,1.0,811.0,811.0
0.019,6,10,1972,5,910,4.0,642.0,642.0,5,1062,4.0,794.0,794.0
0.116,6,10,1506,5,395,25.0,127.0,127.0,5,1111,23.0,843.0,843.0
0.004,6,10,2007,5,928,1.0,660.0,660.0,5,1079,1.0,811.0,811.0
0.086,6,10,1506,5,395,19.0,127.0,127.0,5,1111,19.0,843.0,843.0
89.417,6,27,9565,12,1627,93.0,794.0,367.0,15,7938,6376.0,1360.0,732.0
0.005,6,10,1779,5,928,1.0,660.0,660.0,5,851,1.0,583.0,583.0
0.001,17,2,180,1,66,0.0,38.0,38.0,1,114,0.0,86.0,86.0
240.01,6,9,787,5,488,60002.0,232.0,232.0,4,299,80002.0,83.0,83.0
0.006,6,10,1689,5,839,1.0,571.0,571.0,5,850,1.0,582.0,582.0
0.005,6,10,1547,5,764,1.0,496.0,496.0,5,783,1.0,515.0,515.0
40.078,17,10,676,5,460,10018.0,104.0,64.0,5,216,10018.0,20.0,15.0
0.012,6,10,1990,5,911,2.0,643.0,643.0,5,1079,2.0,811.0,811.0
0.039,17,2,170,1,65,0.0,37.0,37.0,1,105,0.0,77.0,77.0
0.128,6,10,1506,5,395,30.0,127.0,127.0,5,1111,30.0,843.0,843.0
15.095,17,16,10622,9,8280,1883.0,1350.0,892.0,7,2342,2507.0,1350.0,306.0
0.039,17,2,412,1,61,0.0,33.0,33.0,1,351,0.0,323.0,323.0
15.069,17,15,9239,8,6902,2148.0,1350.0,834.0,7,2337,2506.0,1350.0,305.0
40.064,17,10,676,5,460,10014.0,104.0,64.0,5,216,10015.0,20.0,15.0
0.005,6,10,2006,5,927,1.0,659.0,659.0,5,1079,1.0,811.0,811.0
0.005,6,10,2006,5,927,1.0,659.0,659.0,5,1079,1.0,811.0,811.0
0.072,17,8,3613,4,1874,24.0,1350.0,440.0,4,1739,12.0,1350.0,406.0
40.061,17,10,676,5,460,10014.0,104.0,64.0,5,216,10014.0,20.0,15.0
0.083,6,10,1506,5,395,17.0,127.0,127.0,5,1111,16.0,843.0,843.0
0.005,17,2,170,1,65,0.0,37.0,37.0,1,105,0.0,77.0,77.0
0.024,17,2,179,1,71,0.0,43.0,43.0,1,108,0.0,80.0,80.0
0.005,6,10,2000,5,927,1.0,659.0,659.0,5,1073,1.0,805.0,805.0
262.633,6,817,833370,389,808704,676.0,4080.0,2190.0,428,24666,614.0,2667.0,215.0
0.004,17,2,148,1,60,0.0,32.0,32.0,1,88,0.0,60.0,60.0
0.014,6,10,1990,5,911,3.0,643.0,643.0,5,1079,3.0,811.0,811.0
0.005,17,2,186,1,61,0.0,33.0,33.0,1,125,0.0,97.0,97.0
0.052,6,10,1506,5,395,12.0,127.0,127.0,5,1111,12.0,843.0,843.0
0.012,17,2,144,1,64,0.0,36.0,36.0,1,80,0.0,52.0,52.0
311.808,17,20,1124,10,716,34632.0,48.0,43.0,10,408,34633.0,20.0,12.0
0.052,17,2,152,1,76,0.0,48.0,48.0,1,76,0.0,48.0,48.0
0.005,6,10,1779,5,928,1.0,660.0,660.0,5,851,1.0,583.0,583.0
0.012,6,10,1989,5,910,3.0,642.0,642.0,5,1079,2.0,811.0,811.0
0.011,6,10,1990,5,911,2.0,643.0,643.0,5,1079,2.0,811.0,811.0
0.015,6,12,1926,6,1189,3.0,659.0,434.0,6,737,3.0,417.0,417.0
0.125,17,2,184,1,61,0.0,33.0,33.0,1,123,0.0,95.0,95.0
0.012,6,10,1677,5,827,2.0,559.0,559.0,5,850,2.0,582.0,582.0
0.004,6,10,2007,5,928,1.0,660.0,660.0,5,1079,1.0,811.0,811.0
0.005,6,10,1854,5,889,1.0,621.0,621.0,5,965,1.0,697.0,697.0
0.005,6,10,2000,5,927,1.0,659.0,659.0,5,1073,1.0,805.0,805.0
0.004,17,4,284,2,120,0.0,32.0,32.0,2,164,1.0,60.0,54.0
0.014,6,10,1990,5,911,3.0,643.0,643.0,5,1079,3.0,811.0,811.0
0.005,6,10,1989,5,927,1.0,659.0,659.0,5,1062,1.0,794.0,794.0
0.003,17,2,136,1,60,0.0,32.0,32.0,1,76,0.0,48.0,48.0
0.014,6,10,1983,5,910,3.0,642.0,642.0,5,1073,3.0,805.0,805.0
0.003,17,2,136,1,60,0.0,32.0,32.0,1,76,0.0,48.0,48.0
0.009,6,10,1972,5,910,2.0,642.0,642.0,5,1062,2.0,794.0,794.0
0.078,17,2,152,1,76,0.0,48.0,48.0,1,76,0.0,48.0,48.0
0.075,6,10,1506,5,395,17.0,127.0,127.0,5,1111,14.0,843.0,843.0
0.01,6,10,1989,5,910,2.0,642.0,642.0,5,1079,2.0,811.0,811.0
0.005,17,2,194,1,57,0.0,29.0,29.0,1,137,0.0,109.0,109.0
0.011,6,10,1989,5,910,2.0,642.0,642.0,5,1079,2.0,811.0,811.0
0.005,6,10,2006,5,927,1.0,659.0,659.0,5,1079,1.0,811.0,811.0
0.024,6,10,1990,5,911,6.0,643.0,643.0,5,1079,6.0,811.0,811.0
0.007,17,2,179,1,71,0.0,43.0,43.0,1,108,0.0,80.0,80.0
308.26,17,20,1124,10,716,34237.0,48.0,43.0,10,408,34237.0,20.0,12.0
0.004,17,2,148,1,60,0.0,32.0,32.0,1,88,0.0,60.0,60.0
0.005,6,10,1779,5,928,1.0,660.0,660.0,5,851,1.0,583.0,583.0
0.009,6,10,1990,5,911,2.0,643.0,643.0,5,1079,2.0,811.0,811.0
174.062,17,74,10511,37,2465,4834.0,44.0,38.0,37,8046,4834.0,239.0,189.0
0.099,6,10,1506,5,395,22.0,127.0,127.0,5,1111,22.0,843.0,843.0
0.146,6,10,1506,5,395,35.0,127.0,127.0,5,1111,31.0,843.0,843.0
0.017,6,10,1689,5,839,4.0,571.0,571.0,5,850,4.0,582.0,582.0
0.04,17,2,152,1,76,0.0,48.0,48.0,1,76,0.0,48.0,48.0
0.004,6,10,1779,5,928,1.0,660.0,660.0,5,851,1.0,583.0,583.0
0.042,17,4,580,2,122,2.0,33.0,33.0,2,458,1.0,307.0,201.0
0.0,17,2,166,1,75,0.0,47.0,47.0,1,91,0.0,63.0,63.0
0.004,6,10,1989,5,927,1.0,659.0,659.0,5,1062,1.0,794.0,794.0
0.163,17,2,152,1,76,0.0,48.0,48.0,1,76,0.0,48.0,48.0
0.006,17,2,214,1,75,0.0,47.0,47.0,1,139,0.0,111.0,111.0
0.073,17,2,412,1,61,0.0,33.0,33.0,1,351,0.0,323.0,323.0
311.558,17,20,1124,10,716,34603.0,48.0,43.0,10,408,34603.0,20.0,12.0
0.069,6,10,1506,5,395,14.0,127.0,127.0,5,1111,16.0,843.0,843.0
0.166,6,10,1506,5,395,38.0,127.0,127.0,5,1111,38.0,843.0,843.0
0.009,6,10,1989,5,910,2.0,642.0,642.0,5,1079,2.0,811.0,811.0
40.064,17,10,676,5,460,10013.0,104.0,64.0,5,216,10015.0,20.0,15.0
0.005,6,10,2006,5,927,1.0,659.0,659.0,5,1079,1.0,811.0,811.0
0.067,17,8,3613,4,1874,22.0,1350.0,440.0,4,1739,10.0,1350.0,406.0
40.067,17,10,676,5,460,10015.0,104.0,64.0,5,216,10016.0,20.0,15.0
0.004,17,2,162,1,65,0.0,37.0,37.0,1,97,0.0,69.0,69.0
0.008,17,2,179,1,71,0.0,43.0,43.0,1,108,0.0,80.0,80.0
0.009,6,10,1989,5,910,2.0,642.0,642.0,5,1079,2.0,811.0,811.0
0.006,6,10,1689,5,839,1.0,571.0,571.0,5,850,1.0,582.0,582.0
0.006,6,10,1989,5,927,1.0,659.0,659.0,5,1062,1.0,794.0,794.0
0.261,6,16,2888,8,1506,37.0,533.0,360.0,8,1382,25.0,529.0,239.0
352.803,6,20,2210,6,1308,12006.0,494.0,494.0,14,902,27138.0,83.0,83.0
0.009,6,10,1677,5,827,2.0,559.0,559.0,5,850,2.0,582.0,582.0
0.014,6,10,1972,5,910,3.0,642.0,642.0,5,1062,3.0,794.0,794.0
0.007,6,10,1989,5,910,1.0,642.0,642.0,5,1079,1.0,811.0,811.0
1756.748,6,105,6270,60,3525,29774.0,27.0,27.0,45,2745,39925.0,27.0,27.0
0.005,17,2,230,1,68,0.0,40.0,40.0,1,162,0.0,134.0,134.0
0.005,6,10,2006,5,927,1.0,659.0,659.0,5,1079,1.0,811.0,811.0
0.001,17,2,180,1,66,0.0,38.0,38.0,1,114,0.0,86.0,86.0
0.005,6,10,1779,5,928,1.0,660.0,660.0,5,851,1.0,583.0,583.0
0.004,17,4,284,2,120,0.0,32.0,32.0,2,164,1.0,60.0,54.0
0.008,17,2,194,1,59,0.0,31.0,31.0,1,135,0.0,107.0,107.0
68.989,6,28,12892,15,3855,4927.0,1002.0,511.0,13,9037,5734.0,2355.0,1044.0
0.008,6,10,1989,5,927,2.0,659.0,659.0,5,1062,2.0,794.0,794.0
0.007,17,2,179,1,71,0.0,43.0,43.0,1,108,0.0,80.0,80.0
0.005,17,2,170,1,65,0.0,37.0,37.0,1,105,0.0,77.0,77.0
0.115,6,10,1506,5,395,27.0,127.0,127.0,5,1111,25.0,843.0,843.0
1799.983,6,138,6704,77,3704,23683.0,39.0,39.0,61,3000,29995.0,35.0,35.0
0.091,6,10,1506,5,395,19.0,127.0,127.0,5,1111,21.0,843.0,843.0
125.554,6,47,17192,24,11016,5458.0,3113.0,1432.0,23,6176,412.0,2667.0,349.0
0.094,6,10,1506,5,395,21.0,127.0,127.0,5,1111,20.0,843.0,843.0
0.093,6,10,1506,5,395,21.0,127.0,127.0,5,1111,21.0,843.0,843.0
0.081,17,2,148,1,60,0.0,32.0,32.0,1,88,0.0,60.0,60.0
0.004,6,10,1774,5,923,1.0,655.0,655.0,5,851,1.0,583.0,583.0
0.005,6,10,1547,5,764,1.0,496.0,496.0,5,783,1.0,515.0,515.0
11.2,17,28,4417,14,1994,849.0,269.0,114.0,14,2423,849.0,586.0,145.0
0.006,17,2,179,1,71,0.0,43.0,43.0,1,108,0.0,80.0,80.0
0.004,6,10,2006,5,927,1.0,659.0,659.0,5,1079,1.0,811.0,811.0
0.094,6,10,1506,5,395,21.0,127.0,127.0,5,1111,17.0,843.0,843.0
0.005,6,10,2006,5,927,1.0,659.0,659.0,5,1079,1.0,811.0,811.0
0.007,17,2,299,1,65,0.0,37.0,37.0,1,234,0.0,206.0,206.0
0.01,6,10,1972,5,910,2.0,642.0,642.0,5,1062,2.0,794.0,794.0
0.006,6,10,1547,5,764,1.0,496.0,496.0,5,783,1.0,515.0,515.0
0.006,6,10,1547,5,764,1.0,496.0,496.0,5,783,1.0,515.0,515.0
0.104,6,10,1506,5,395,21.0,127.0,127.0,5,1111,23.0,843.0,843.0
9.037,17,6,376,5,280,2259.0,28.0,28.0,1,96,0.0,68.0,68.0
0.08,6,10,1506,5,395,17.0,127.0,127.0,5,1111,15.0,843.0,843.0
1731.212,6,64,7361,42,4485,42224.0,1641.0,109.0,22,2876,82430.0,1112.0,82.0
0.069,6,10,1506,5,395,16.0,127.0,127.0,5,1111,15.0,843.0,843.0
0.007,6,10,1989,5,910,1.0,642.0,642.0,5,1079,1.0,811.0,811.0
0.072,6,10,1506,5,395,13.0,127.0,127.0,5,1111,15.0,843.0,843.0
0.077,6,10,1506,5,395,16.0,127.0,127.0,5,1111,15.0,843.0,843.0
0.018,6,10,1990,5,911,4.0,643.0,643.0,5,1079,4.0,811.0,811.0
0.005,17,4,284,2,120,0.0,32.0,32.0,2,164,1.0,60.0,54.0
0.753,6,25,5459,12,1557,58.0,325.0,152.0,13,3902,53.0,1414.0,563.0
1038.803,6,206,48474,89,32523,11804.0,2790.0,444.0,117,15951,8954.0,1360.0,216.0
0.015,6,10,1972,5,910,3.0,642.0,642.0,5,1062,3.0,794.0,794.0
0.005,6,10,2006,5,927,1.0,659.0,659.0,5,1079,1.0,811.0,811.0
0.002,17,2,142,1,63,0.0,35.0,35.0,1,79,0.0,51.0,51.0
0.103,6,10,1506,5,395,23.0,127.0,127.0,5,1111,22.0,843.0,843.0
1770.7,6,135,6510,75,3585,23928.0,39.0,39.0,60,2925,30007.0,35.0,35.0
0.001,17,2,136,1,60,0.0,32.0,32.0,1,76,0.0,48.0,48.0
0.005,6,10,1989,5,927,1.0,659.0,659.0,5,1062,1.0,794.0,794.0
0.005,6,10,2007,5,928,1.0,660.0,660.0,5,1079,1.0,811.0,811.0
0.005,6,10,1643,5,860,1.0,592.0,592.0,5,783,1.0,515.0,515.0
0.128,6,10,1506,5,395,26.0,127.0,127.0,5,1111,28.0,843.0,843.0
0.004,6,10,2000,5,927,1.0,659.0,659.0,5,1073,1.0,805.0,805.0
0.009,6,10,1990,5,911,2.0,643.0,643.0,5,1079,2.0,811.0,811.0
0.004,6,10,2006,5,927,1.0,659.0,659.0,5,1079,1.0,811.0,811.0
0.005,6,10,2000,5,927,1.0,659.0,659.0,5,1073,1.0,805.0,805.0
0.135,6,10,1506,5,395,28.0,127.0,127.0,5,1111,28.0,843.0,843.0
369.907,6,24,2405,17,919,23119.0,195.0,195.0,7,1486,3922.0,419.0,398.0
11.07,17,28,4424,14,1995,839.0,270.0,114.0,14,2429,838.0,588.0,145.0
0.01,6,10,1989,5,910,2.0,642.0,642.0,5,1079,2.0,811.0,811.0
0.004,6,10,1702,5,863,1.0,595.0,595.0,5,839,0.0,571.0,571.0
0.005,6,10,2007,5,928,1.0,660.0,660.0,5,1079,1.0,811.0,811.0
0.001,17,2,180,1,66,0.0,38.0,38.0,1,114,0.0,86.0,86.0
0.011,6,14,3787,7,497,1.0,125.0,125.0,7,3290,1.0,1448.0,972.0
0.01,6,10,1990,5,911,2.0,643.0,643.0,5,1079,2.0,811.0,811.0
0.005,6,10,2007,5,928,1.0,660.0,660.0,5,1079,1.0,811.0,811.0
0.042,17,2,182,1,65,0.0,37.0,37.0,1,117,0.0,89.0,89.0
0.08,6,10,1506,5,395,18.0,127.0,127.0,5,1111,17.0,843.0,843.0
0.109,6,10,1506,5,395,24.0,127.0,127.0,5,1111,24.0,843.0,843.0
0.006,17,2,179,1,71,0.0,43.0,43.0,1,108,0.0,80.0,80.0
0.086,6,10,1506,5,395,17.0,127.0,127.0,5,1111,18.0,843.0,843.0
0.005,6,10,2006,5,927,1.0,659.0,659.0,5,1079,1.0,811.0,811.0
0.042,17,2,148,1,60,0.0,32.0,32.0,1,88,0.0,60.0,60.0
0.091,6,10,1506,5,395,22.0,127.0,127.0,5,1111,19.0,843.0,843.0
0.005,6,10,2007,5,928,1.0,660.0,660.0,5,1079,1.0,811.0,811.0
0.006,17,2,164,1,74,0.0,46.0,46.0,1,90,0.0,62.0,62.0
0.001,17,2,180,1,66,0.0,38.0,38.0,1,114,0.0,86.0,86.0
0.006,6,10,1547,5,764,1.0,496.0,496.0,5,783,1.0,515.0,515.0
0.084,6,10,1506,5,395,18.0,127.0,127.0,5,1111,19.0,843.0,843.0
0.091,6,10,1506,5,395,18.0,127.0,127.0,5,1111,20.0,843.0,843.0
0.119,6,10,1506,5,395,17.0,127.0,127.0,5,1111,27.0,843.0,843.0
0.155,6,10,1506,5,395,36.0,127.0,127.0,5,1111,35.0,843.0,843.0
40.061,17,10,676,5,460,10014.0,104.0,64.0,5,216,10014.0,20.0,15.0
0.006,17,2,212,1,74,0.0,46.0,46.0,1,138,0.0,110.0,110.0
40.081,17,10,676,5,460,10018.0,104.0,64.0,5,216,10019.0,20.0,15.0
0.009,6,12,1926,6,1189,1.0,659.0,434.0,6,737,1.0,417.0,417.0
0.018,6,10,1990,5,911,4.0,643.0,643.0,5,1079,4.0,811.0,811.0
0.04,17,4,284,2,120,0.0,32.0,32.0,2,164,36.0,60.0,54.0
0.016,6,10,1972,5,910,4.0,642.0,642.0,5,1062,4.0,794.0,794.0
0.011,6,10,1762,5,911,2.0,643.0,643.0,5,851,2.0,583.0,583.0
0.015,6,10,1990,5,911,3.0,643.0,643.0,5,1079,3.0,811.0,811.0
0.004,6,10,2007,5,928,1.0,660.0,660.0,5,1079,1.0,811.0,811.0
0.009,6,10,1989,5,910,2.0,642.0,642.0,5,1079,2.0,811.0,811.0
0.087,6,10,1506,5,395,21.0,127.0,127.0,5,1111,20.0,843.0,843.0
0.111,6,10,1506,5,395,27.0,127.0,127.0,5,1111,25.0,843.0,843.0
0.001,17,2,180,1,66,0.0,38.0,38.0,1,114,0.0,86.0,86.0
0.004,6,10,2007,5,928,1.0,660.0,660.0,5,1079,1.0,811.0,811.0
165.3,17,84,11808,42,2803,4031.0,44.0,38.0,42,9005,4031.0,239.0,186.0
0.102,6,10,1506,5,395,24.0,127.0,127.0,5,1111,23.0,843.0,843.0
308.755,17,20,1124,10,716,34299.0,48.0,43.0,10,408,34299.0,20.0,12.0
169.308,17,78,11255,39,2605,4455.0,44.0,38.0,39,8650,4455.0,239.0,193.0
0.005,6,10,1989,5,927,1.0,659.0,659.0,5,1062,1.0,794.0,794.0
0.007,6,10,1689,5,839,1.0,571.0,571.0,5,850,1.0,582.0,582.0
0.009,6,10,1762,5,911,2.0,643.0,643.0,5,851,2.0,583.0,583.0
0.096,6,10,1506,5,395,20.0,127.0,127.0,5,1111,20.0,843.0,843.0
0.005,6,10,1643,5,860,1.0,592.0,592.0,5,783,1.0,515.0,515.0
0.014,6,10,1990,5,911,3.0,643.0,643.0,5,1079,3.0,811.0,811.0
0.068,6,10,1506,5,395,13.0,127.0,127.0,5,1111,16.0,843.0,843.0
66.043,6,22,10152,12,3985,6003.0,1591.0,838.0,10,6167,7319.0,2111.0,939.0
0.129,6,10,1506,5,395,30.0,127.0,127.0,5,1111,31.0,843.0,843.0
0.008,6,10,1983,5,910,2.0,642.0,642.0,5,1073,1.0,805.0,805.0
0.005,6,10,2006,5,927,1.0,659.0,659.0,5,1079,1.0,811.0,811.0
0.001,17,2,180,1,66,0.0,38.0,38.0,1,114,0.0,86.0,86.0
0.004,6,10,2000,5,927,1.0,659.0,659.0,5,1073,1.0,805.0,805.0
0.005,6,14,3742,7,452,0.0,80.0,80.0,7,3290,0.0,1448.0,972.0
0.005,6,14,3742,7,452,0.0,80.0,80.0,7,3290,0.0,1448.0,972.0
0.004,17,4,284,2,120,0.0,32.0,32.0,2,164,1.0,60.0,54.0
0.011,6,10,1983,5,910,2.0,642.0,642.0,5,1073,2.0,805.0,805.0
0.005,6,10,2007,5,928,1.0,660.0,660.0,5,1079,1.0,811.0,811.0
0.097,6,10,1506,5,395,20.0,127.0,127.0,5,1111,23.0,843.0,843.0
0.005,6,10,1689,5,839,1.0,571.0,571.0,5,850,1.0,582.0,582.0
0.018,6,10,1762,5,911,4.0,643.0,643.0,5,851,4.0,583.0,583.0
0.004,6,10,1989,5,927,1.0,659.0,659.0,5,1062,1.0,794.0,794.0
301.062,6,45,14413,24,8546,13089.0,2562.0,944.0,21,5867,444.0,2667.0,385.0
0.04,17,2,152,1,76,0.0,48.0,48.0,1,76,0.0,48.0,48.0
0.004,17,2,136,1,60,0.0,32.0,32.0,1,76,0.0,48.0,48.0
40.067,17,10,676,5,460,10014.0,104.0,64.0,5,216,10015.0,20.0,15.0
174.648,17,74,10541,37,2468,4850.0,44.0,38.0,37,8073,4851.0,239.0,190.0
0.067,17,8,3613,4,1874,22.0,1350.0,440.0,4,1739,11.0,1350.0,406.0
0.098,6,10,1506,5,395,22.0,127.0,127.0,5,1111,20.0,843.0,843.0
0.005,17,2,148,1,60,0.0,32.0,32.0,1,88,0.0,60.0,60.0
0.005,6,10,2000,5,927,1.0,659.0,659.0,5,1073,1.0,805.0,805.0
0.064,6,10,1506,5,395,15.0,127.0,127.0,5,1111,14.0,843.0,843.0
0.004,6,10,1702,5,863,1.0,595.0,595.0,5,839,1.0,571.0,571.0
15.17,17,21,12413,11,8730,1514.0,1350.0,765.0,10,3683,1682.0,1350.0,340.0
0.019,6,13,3735,7,497,3.0,125.0,125.0,6,3238,3.0,1470.0,1459.0
0.012,6,10,1989,5,910,2.0,642.0,642.0,5,1079,2.0,811.0,811.0
0.075,6,10,1506,5,395,16.0,127.0,127.0,5,1111,15.0,843.0,843.0
0.005,6,10,2006,5,927,1.0,659.0,659.0,5,1079,1.0,811.0,811.0
40.052,17,10,676,5,460,10011.0,104.0,64.0,5,216,10012.0,20.0,15.0
0.103,6,10,1506,5,395,22.0,127.0,127.0,5,1111,20.0,843.0,843.0
0.088,6,10,1506,5,395,17.0,127.0,127.0,5,1111,20.0,843.0,843.0
0.003,17,2,234,1,61,0.0,33.0,33.0,1,173,0.0,145.0,145.0
0.094,6,10,1506,5,395,21.0,127.0,127.0,5,1111,18.0,843.0,843.0
0.001,17,2,180,1,66,0.0,38.0,38.0,1,114,0.0,86.0,86.0
0.025,6,10,1989,5,910,6.0,642.0,642.0,5,1079,6.0,811.0,811.0
0.072,6,10,1506,5,395,17.0,127.0,127.0,5,1111,14.0,843.0,843.0
0.012,6,10,1677,5,827,3.0,559.0,559.0,5,850,3.0,582.0,582.0
0.012,6,10,1989,5,910,3.0,642.0,642.0,5,1079,2.0,811.0,811.0
0.066,6,10,1506,5,395,16.0,127.0,127.0,5,1111,14.0,843.0,843.0
0.006,6,10,1689,5,839,1.0,571.0,571.0,5,850,1.0,582.0,582.0
0.006,6,10,1547,5,764,1.0,496.0,496.0,5,783,1.0,515.0,515.0
0.005,6,10,2006,5,927,1.0,659.0,659.0,5,1079,1.0,811.0,811.0
0.004,6,10,1702,5,863,1.0,595.0,595.0,5,839,0.0,571.0,571.0
0.014,6,10,1631,5,848,3.0,580.0,580.0,5,783,3.0,515.0,515.0
0.082,6,10,1506,5,395,18.0,127.0,127.0,5,1111,19.0,843.0,843.0
0.006,17,2,179,1,71,0.0,43.0,43.0,1,108,0.0,80.0,80.0
0.073,6,10,1506,5,395,16.0,127.0,127.0,5,1111,17.0,843.0,843.0
351.994,6,20,2210,6,1308,12003.0,494.0,494.0,14,902,27076.0,83.0,83.0
0.005,6,10,2007,5,928,1.0,660.0,660.0,5,1079,1.0,811.0,811.0
0.086,6,10,1506,5,395,17.0,127.0,127.0,5,1111,19.0,843.0,843.0
0.014,6,13,3735,7,497,2.0,125.0,125.0,6,3238,2.0,1470.0,1459.0
0.012,6,10,1989,5,910,3.0,642.0,642.0,5,1079,2.0,811.0,811.0
0.009,6,10,1972,5,910,2.0,642.0,642.0,5,1062,2.0,794.0,794.0
0.008,6,10,1972,5,910,2.0,642.0,642.0,5,1062,2.0,794.0,794.0
0.012,6,10,1983,5,910,3.0,642.0,642.0,5,1073,3.0,805.0,805.0
0.004,6,10,1989,5,927,1.0,659.0,659.0,5,1062,1.0,794.0,794.0
0.029,6,13,3816,7,578,4.0,206.0,206.0,6,3238,5.0,1470.0,1459.0
0.126,6,10,1506,5,395,28.0,127.0,127.0,5,1111,25.0,843.0,843.0
0.062,6,10,1506,5,395,14.0,127.0,127.0,5,1111,12.0,843.0,843.0
0.004,6,10,2007,5,928,1.0,660.0,660.0,5,1079,1.0,811.0,811.0
0.079,6,10,1506,5,395,18.0,127.0,127.0,5,1111,17.0,843.0,843.0
37.831,6,28,9605,14,1707,2910.0,794.0,367.0,14,7898,2900.0,1360.0,732.0
0.013,6,10,1983,5,910,3.0,642.0,642.0,5,1073,3.0,805.0,805.0
0.01,6,10,1983,5,910,2.0,642.0,642.0,5,1073,2.0,805.0,805.0
0.007,6,10,1774,5,923,1.0,655.0,655.0,5,851,1.0,583.0,583.0
0.004,6,10,1774,5,923,1.0,655.0,655.0,5,851,1.0,583.0,583.0
0.01,6,10,1989,5,910,2.0,642.0,642.0,5,1079,2.0,811.0,811.0
0.005,6,10,1779,5,928,1.0,660.0,660.0,5,851,1.0,583.0,583.0
0.005,6,10,1779,5,928,1.0,660.0,660.0,5,851,1.0,583.0,583.0
0.014,6,10,1972,5,910,3.0,642.0,642.0,5,1062,3.0,794.0,794.0
0.022,6,10,1631,5,848,5.0,580.0,580.0,5,783,5.0,515.0,515.0
0.013,6,10,1631,5,848,3.0,580.0,580.0,5,783,3.0,515.0,515.0
0.005,6,14,3736,7,446,0.0,74.0,74.0,7,3290,0.0,1448.0,972.0
0.012,6,10,1762,5,911,2.0,643.0,643.0,5,851,3.0,583.0,583.0
0.005,6,10,1989,5,927,1.0,659.0,659.0,5,1062,1.0,794.0,794.0
0.005,6,10,2000,5,927,1.0,659.0,659.0,5,1073,1.0,805.0,805.0
0.005,6,10,1989,5,927,1.0,659.0,659.0,5,1062,1.0,794.0,794.0
0.008,6,10,1989,5,910,2.0,642.0,642.0,5,1079,2.0,811.0,811.0
0.015,6,10,1972,5,910,3.0,642.0,642.0,5,1062,3.0,794.0,794.0
240.203,6,17,7290,9,2024,30025.0,1496.0,780.0,8,5266,34314.0,2802.0,1210.0
0.104,6,10,1506,5,395,19.0,127.0,127.0,5,1111,23.0,843.0,843.0
0.005,6,10,2007,5,928,1.0,660.0,660.0,5,1079,1.0,811.0,811.0
0.042,17,2,170,1,65,0.0,37.0,37.0,1,105,0.0,77.0,77.0
0.016,17,2,198,1,91,0.0,63.0,63.0,1,107,0.0,79.0,79.0
0.005,6,10,2006,5,927,1.0,659.0,659.0,5,1079,1.0,811.0,811.0
0.006,6,10,1689,5,839,1.0,571.0,571.0,5,850,1.0,582.0,582.0
0.073,6,10,1506,5,395,16.0,127.0,127.0,5,1111,17.0,843.0,843.0
0.077,6,10,1506,5,395,15.0,127.0,127.0,5,1111,18.0,843.0,843.0
0.008,6,10,1972,5,910,2.0,642.0,642.0,5,1062,2.0,794.0,794.0
0.015,6,10,1989,5,910,3.0,642.0,642.0,5,1079,3.0,811.0,811.0
0.112,6,10,1506,5,395,25.0,127.0,127.0,5,1111,24.0,843.0,843.0
1772.801,6,298,97206,184,86229,9687.0,2001.0,696.0,114,10977,15688.0,452.0,70.0
0.005,6,10,2000,5,927,1.0,659.0,659.0,5,1073,1.0,805.0,805.0
0.009,6,10,1990,5,911,2.0,643.0,643.0,5,1079,2.0,811.0,811.0
0.007,6,10,1972,5,910,1.0,642.0,642.0,5,1062,1.0,794.0,794.0
0.006,17,2,180,1,66,0.0,38.0,38.0,1,114,0.0,86.0,86.0
0.076,6,10,1506,5,395,17.0,127.0,127.0,5,1111,16.0,843.0,843.0
0.069,17,8,3613,4,1874,23.0,1350.0,440.0,4,1739,11.0,1350.0,406.0
0.009,6,10,1990,5,911,2.0,643.0,643.0,5,1079,2.0,811.0,811.0
0.166,17,2,152,1,76,0.0,48.0,48.0,1,76,0.0,48.0,48.0
40.064,17,10,676,5,460,10015.0,104.0,64.0,5,216,10015.0,20.0,15.0
0.006,6,10,1547,5,764,1.0,496.0,496.0,5,783,1.0,515.0,515.0
0.005,17,2,160,1,72,0.0,44.0,44.0,1,88,0.0,60.0,60.0
0.02,6,12,1698,6,863,3.0,327.0,271.0,6,835,4.0,515.0,515.0
0.003,17,2,148,1,60,0.0,32.0,32.0,1,88,0.0,60.0,60.0
0.017,6,10,1989,5,910,4.0,642.0,642.0,5,1079,4.0,811.0,811.0
161.562,17,74,10653,37,2466,4487.0,44.0,38.0,37,8187,4487.0,239.0,193.0
164.499,17,90,12816,45,3005,3738.0,44.0,38.0,45,9811,3738.0,261.0,190.0
0.006,6,10,1547,5,764,1.0,496.0,496.0,5,783,1.0,515.0,515.0
40.066,17,10,676,5,460,10014.0,104.0,64.0,5,216,10015.0,20.0,15.0
0.113,6,10,1506,5,395,24.0,127.0,127.0,5,1111,24.0,843.0,843.0
0.006,6,10,1547,5,764,1.0,496.0,496.0,5,783,1.0,515.0,515.0
0.013,17,2,152,1,56,0.0,28.0,28.0,1,96,0.0,68.0,68.0
0.005,6,10,2000,5,927,1.0,659.0,659.0,5,1073,1.0,805.0,805.0
0.089,6,10,1506,5,395,17.0,127.0,127.0,5,1111,21.0,843.0,843.0
0.011,6,10,1972,5,910,2.0,642.0,642.0,5,1062,2.0,794.0,794.0
0.009,6,10,1990,5,911,2.0,643.0,643.0,5,1079,2.0,811.0,811.0
0.005,6,10,2007,5,928,1.0,660.0,660.0,5,1079,1.0,811.0,811.0
0.087,6,10,1506,5,395,19.0,127.0,127.0,5,1111,18.0,843.0,843.0
0.006,17,2,199,1,68,0.0,40.0,40.0,1,131,0.0,103.0,103.0
0.103,6,10,1506,5,395,24.0,127.0,127.0,5,1111,24.0,843.0,843.0
0.01,6,12,1926,6,1189,1.0,659.0,434.0,6,737,2.0,417.0,417.0
0.005,6,10,1702,5,863,1.0,595.0,595.0,5,839,1.0,571.0,571.0
0.006,6,10,1689,5,839,1.0,571.0,571.0,5,850,1.0,582.0,582.0
0.005,6,10,1689,5,839,1.0,571.0,571.0,5,850,1.0,582.0,582.0
0.008,17,2,179,1,71,0.0,43.0,43.0,1,108,0.0,80.0,80.0
0.005,6,10,1779,5,928,1.0,660.0,660.0,5,851,1.0,583.0,583.0
0.004,17,2,656,1,328,0.0,300.0,300.0,1,328,0.0,300.0,300.0
0.006,6,10,1547,5,764,1.0,496.0,496.0,5,783,1.0,515.0,515.0
0.003,17,2,148,1,60,0.0,32.0,32.0,1,88,0.0,60.0,60.0
0.01,6,10,1990,5,911,2.0,643.0,643.0,5,1079,2.0,811.0,811.0
11.207,17,28,4420,14,1993,849.0,268.0,114.0,14,2427,849.0,586.0,145.0
0.003,17,2,144,1,64,0.0,36.0,36.0,1,80,0.0,52.0,52.0
40.066,17,10,676,5,460,10014.0,104.0,64.0,5,216,10015.0,20.0,15.0
0.007,17,2,168,1,76,0.0,48.0,48.0,1,92,0.0,64.0,64.0
0.005,17,2,164,1,74,0.0,46.0,46.0,1,90,0.0,62.0,62.0
0.001,17,2,136,1,60,0.0,32.0,32.0,1,76,0.0,48.0,48.0
0.005,6,10,1547,5,764,1.0,496.0,496.0,5,783,1.0,515.0,515.0
0.012,6,10,1990,5,911,3.0,643.0,643.0,5,1079,3.0,811.0,811.0
0.221,6,16,2777,8,1395,31.0,533.0,323.0,8,1382,20.0,529.0,239.0
0.031,6,13,3735,7,497,5.0,125.0,125.0,6,3238,6.0,1470.0,1459.0
15.203,17,42,25606,24,19842,659.0,1350.0,798.0,18,5764,892.0,1350.0,292.0
0.001,17,2,180,1,66,0.0,38.0,38.0,1,114,0.0,86.0,86.0
0.094,6,10,1506,5,395,19.0,127.0,127.0,5,1111,20.0,843.0,843.0
0.052,17,2,152,1,76,0.0,48.0,48.0,1,76,0.0,48.0,48.0
0.006,17,2,193,1,71,0.0,43.0,43.0,1,122,0.0,94.0,94.0
0.079,6,10,1506,5,395,18.0,127.0,127.0,5,1111,17.0,843.0,843.0
0.005,6,10,1689,5,839,1.0,571.0,571.0,5,850,1.0,582.0,582.0
0.04,17,4,284,2,120,0.0,32.0,32.0,2,164,36.0,60.0,54.0
0.005,17,2,179,1,71,0.0,43.0,43.0,1,108,0.0,80.0,80.0
0.168,6,10,1242,5,751,42.0,495.0,495.0,5,491,38.0,223.0,223.0
0.006,6,10,1689,5,839,1.0,571.0,571.0,5,850,1.0,582.0,582.0
0.005,6,10,2006,5,927,1.0,659.0,659.0,5,1079,1.0,811.0,811.0
0.008,6,12,1926,6,1189,1.0,659.0,434.0,6,737,1.0,417.0,417.0
27.329,6,45,21072,23,15394,411.0,2720.0,1604.0,22,5678,1293.0,2667.0,435.0
0.074,6,10,1506,5,395,16.0,127.0,127.0,5,1111,17.0,843.0,843.0
0.004,6,10,2000,5,927,1.0,659.0,659.0,5,1073,1.0,805.0,805.0
0.004,6,10,2007,5,928,1.0,660.0,660.0,5,1079,1.0,811.0,811.0
0.004,6,10,1989,5,927,1.0,659.0,659.0,5,1062,1.0,794.0,794.0
0.004,6,10,2007,5,928,1.0,660.0,660.0,5,1079,1.0,811.0,811.0
0.014,6,10,1983,5,910,3.0,642.0,642.0,5,1073,3.0,805.0,805.0
0.014,6,10,1762,5,911,3.0,643.0,643.0,5,851,3.0,583.0,583.0
0.005,6,10,2000,5,927,1.0,659.0,659.0,5,1073,1.0,805.0,805.0
0.005,6,10,2006,5,927,1.0,659.0,659.0,5,1079,1.0,811.0,811.0
0.054,6,10,1506,5,395,12.0,127.0,127.0,5,1111,12.0,843.0,843.0
0.113,6,10,1506,5,395,26.0,127.0,127.0,5,1111,23.0,843.0,843.0
40.06,17,10,676,5,460,10014.0,104.0,64.0,5,216,10013.0,20.0,15.0
0.01,6,10,1983,5,910,2.0,642.0,642.0,5,1073,2.0,805.0,805.0
0.013,17,2,152,1,56,0.0,28.0,28.0,1,96,0.0,68.0,68.0
0.128,17,2,80,1,32,0.0,4.0,4.0,1,48,0.0,20.0,20.0
0.005,6,10,2006,5,927,1.0,659.0,659.0,5,1079,1.0,811.0,811.0
0.005,6,10,2006,5,927,1.0,659.0,659.0,5,1079,1.0,811.0,811.0
0.005,6,10,1689,5,839,1.0,571.0,571.0,5,850,1.0,582.0,582.0
0.004,6,10,1702,5,863,1.0,595.0,595.0,5,839,1.0,571.0,571.0
0.006,6,10,1547,5,764,1.0,496.0,496.0,5,783,1.0,515.0,515.0
0.095,6,10,1506,5,395,21.0,127.0,127.0,5,1111,18.0,843.0,843.0
0.009,6,10,1972,5,910,2.0,642.0,642.0,5,1062,2.0,794.0,794.0
0.005,17,2,169,1,62,0.0,34.0,34.0,1,107,0.0,79.0,79.0
26.098,6,29,11294,17,1944,1631.0,538.0,350.0,12,9350,2372.0,2804.0,1089.0
0.005,6,10,2006,5,927,1.0,659.0,659.0,5,1079,1.0,811.0,811.0
0.075,6,10,1506,5,395,14.0,127.0,127.0,5,1111,17.0,843.0,843.0
0.005,6,10,1989,5,927,1.0,659.0,659.0,5,1062,1.0,794.0,794.0
0.005,6,10,2007,5,928,1.0,660.0,660.0,5,1079,1.0,811.0,811.0
40.066,17,10,676,5,460,10014.0,104.0,64.0,5,216,10015.0,20.0,15.0
0.006,6,10,1972,5,910,1.0,642.0,642.0,5,1062,1.0,794.0,794.0
0.008,6,10,1989,5,910,2.0,642.0,642.0,5,1079,2.0,811.0,811.0
0.005,6,10,2000,5,927,1.0,659.0,659.0,5,1073,1.0,805.0,805.0
0.014,6,10,1989,5,910,3.0,642.0,642.0,5,1079,3.0,811.0,811.0
300.382,6,16,2170,9,684,37526.0,146.0,146.0,7,1486,50034.0,419.0,398.0
0.005,6,14,3799,7,509,0.0,137.0,137.0,7,3290,0.0,1448.0,972.0
0.0,17,2,166,1,75,0.0,47.0,47.0,1,91,0.0,63.0,63.0
0.012,6,10,1990,5,911,3.0,643.0,643.0,5,1079,2.0,811.0,811.0
0.005,6,10,1547,5,764,1.0,496.0,496.0,5,783,1.0,515.0,515.0
0.126,6,10,1506,5,395,29.0,127.0,127.0,5,1111,28.0,843.0,843.0
0.052,6,10,1972,5,910,13.0,642.0,642.0,5,1062,13.0,794.0,794.0
0.005,6,14,3742,7,452,0.0,80.0,80.0,7,3290,0.0,1448.0,972.0
0.054,17,2,164,1,74,0.0,46.0,46.0,1,90,0.0,62.0,62.0
300.401,6,16,2170,9,684,37528.0,146.0,146.0,7,1486,50038.0,419.0,398.0
0.149,6,10,1506,5,395,35.0,127.0,127.0,5,1111,28.0,843.0,843.0
0.006,17,2,302,1,65,0.0,37.0,37.0,1,237,0.0,209.0,209.0
0.008,17,2,179,1,71,0.0,43.0,43.0,1,108,0.0,80.0,80.0
0.091,6,10,1506,5,395,19.0,127.0,127.0,5,1111,18.0,843.0,843.0
40.066,17,10,676,5,460,10013.0,104.0,64.0,5,216,10015.0,20.0,15.0
0.004,6,10,2007,5,928,1.0,660.0,660.0,5,1079,1.0,811.0,811.0
10.816,17,28,4424,14,1995,823.0,270.0,114.0,14,2429,823.0,588.0,145.0
0.001,17,2,142,1,63,0.0,35.0,35.0,1,79,0.0,51.0,51.0
0.039,17,2,184,1,61,0.0,33.0,33.0,1,123,0.0,95.0,95.0
0.002,17,2,136,1,60,0.0,32.0,32.0,1,76,0.0,48.0,48.0
0.015,6,10,1677,5,827,3.0,559.0,559.0,5,850,3.0,582.0,582.0
0.115,6,10,1506,5,395,26.0,127.0,127.0,5,1111,27.0,843.0,843.0
11.127,17,28,4418,14,1993,843.0,268.0,114.0,14,2425,843.0,588.0,145.0
0.003,17,2,148,1,60,0.0,32.0,32.0,1,88,0.0,60.0,60.0
0.02,6,10,1983,5,910,5.0,642.0,642.0,5,1073,5.0,805.0,805.0
0.085,6,10,1506,5,395,16.0,127.0,127.0,5,1111,20.0,843.0,843.0
177.209,17,80,11299,40,2664,4543.0,44.0,38.0,40,8635,4543.0,261.0,187.0
0.004,6,10,2000,5,927,1.0,659.0,659.0,5,1073,1.0,805.0,805.0
0.246,17,43,24245,24,21176,10.0,1350.0,854.0,19,3069,10.0,1350.0,133.0
0.011,6,10,1990,5,911,2.0,643.0,643.0,5,1079,2.0,811.0,811.0
0.006,6,10,1547,5,764,1.0,496.0,496.0,5,783,1.0,515.0,515.0
0.039,17,4,420,2,122,0.0,33.0,33.0,2,298,35.0,145.0,121.0
0.123,6,10,1506,5,395,29.0,127.0,127.0,5,1111,30.0,843.0,843.0
0.005,6,10,1989,5,927,1.0,659.0,659.0,5,1062,1.0,794.0,794.0
0.004,17,2,136,1,60,0.0,32.0,32.0,1,76,0.0,48.0,48.0
0.005,6,10,1989,5,927,1.0,659.0,659.0,5,1062,1.0,794.0,794.0
0.005,6,10,1989,5,927,1.0,659.0,659.0,5,1062,1.0,794.0,794.0
0.006,6,10,2000,5,927,1.0,659.0,659.0,5,1073,1.0,805.0,805.0
364.435,6,21,1793,16,1030,24295.0,190.0,190.0,5,763,60011.0,462.0,247.0
0.004,6,10,2006,5,927,1.0,659.0,659.0,5,1079,1.0,811.0,811.0
0.083,6,10,1506,5,395,19.0,127.0,127.0,5,1111,18.0,843.0,843.0
0.368,6,16,2669,8,1395,52.0,533.0,323.0,8,1274,34.0,529.0,212.0
0.005,17,2,170,1,65,0.0,37.0,37.0,1,105,0.0,77.0,77.0
40.063,17,10,676,5,460,10014.0,104.0,64.0,5,216,10014.0,20.0,15.0
0.066,6,10,1506,5,395,15.0,127.0,127.0,5,1111,13.0,843.0,843.0
0.097,6,10,1506,5,395,18.0,127.0,127.0,5,1111,19.0,843.0,843.0
0.006,6,10,1854,5,889,1.0,621.0,621.0,5,965,1.0,697.0,697.0
0.13,17,2,234,1,61,0.0,33.0,33.0,1,173,0.0,145.0,145.0
0.084,6,10,1506,5,395,18.0,127.0,127.0,5,1111,19.0,843.0,843.0
0.072,6,10,1506,5,395,15.0,127.0,127.0,5,1111,16.0,843.0,843.0
10.924,17,28,4421,14,1993,831.0,268.0,114.0,14,2428,831.0,587.0,145.0
51.984,6,410,349440,202,22077,258.0,2736.0,888.0,208,327363,251.0,2804.0,1623.0
0.238,17,15,8641,8,4076,34.0,1350.0,481.0,7,4565,30.0,1350.0,624.0
0.006,6,10,1547,5,764,1.0,496.0,496.0,5,783,1.0,515.0,515.0
0.085,6,10,1506,5,395,19.0,127.0,127.0,5,1111,19.0,843.0,843.0
0.041,17,2,144,1,64,0.0,36.0,36.0,1,80,0.0,52.0,52.0
0.019,6,10,1972,5,910,4.0,642.0,642.0,5,1062,4.0,794.0,794.0
0.327,17,42,20737,22,17093,15.0,1350.0,748.0,20,3644,13.0,1350.0,154.0
1786.206,6,154,19574,92,13852,19628.0,302.0,302.0,62,5722,29282.0,83.0,83.0
0.005,6,10,2006,5,927,1.0,659.0,659.0,5,1079,1.0,811.0,811.0
0.118,6,10,1506,5,395,24.0,127.0,127.0,5,1111,25.0,843.0,843.0
0.003,17,2,148,1,60,0.0,32.0,32.0,1,88,0.0,60.0,60.0
0.004,6,10,1774,5,923,1.0,655.0,655.0,5,851,1.0,583.0,583.0
10.791,17,28,4420,14,1993,821.0,268.0,114.0,14,2427,821.0,586.0,145.0
0.008,6,10,1547,5,764,2.0,496.0,496.0,5,783,1.0,515.0,515.0
0.023,17,4,284,2,120,0.0,32.0,32.0,2,164,0.0,60.0,54.0
0.005,6,10,1702,5,863,1.0,595.0,595.0,5,839,1.0,571.0,571.0
0.098,6,10,1506,5,395,23.0,127.0,127.0,5,1111,21.0,843.0,843.0
0.005,6,10,2006,5,927,1.0,659.0,659.0,5,1079,1.0,811.0,811.0
0.005,6,10,1689,5,839,1.0,571.0,571.0,5,850,1.0,582.0,582.0
0.006,6,10,1547,5,764,1.0,496.0,496.0,5,783,1.0,515.0,515.0
0.009,17,2,194,1,59,0.0,31.0,31.0,1,135,0.0,107.0,107.0
0.011,6,10,1989,5,910,2.0,642.0,642.0,5,1079,2.0,811.0,811.0
0.007,6,10,1547,5,764,1.0,496.0,496.0,5,783,1.0,515.0,515.0
0.013,6,10,1990,5,911,3.0,643.0,643.0,5,1079,3.0,811.0,811.0
0.088,6,10,1506,5,395,18.0,127.0,127.0,5,1111,21.0,843.0,843.0
0.006,6,10,1547,5,764,1.0,496.0,496.0,5,783,1.0,515.0,515.0
0.005,6,10,2007,5,928,1.0,660.0,660.0,5,1079,1.0,811.0,811.0
0.211,6,10,1506,5,395,44.0,127.0,127.0,5,1111,49.0,843.0,843.0
0.079,6,10,1506,5,395,17.0,127.0,127.0,5,1111,16.0,843.0,843.0
0.013,6,10,1762,5,911,3.0,643.0,643.0,5,851,3.0,583.0,583.0
0.101,6,10,1506,5,395,22.0,127.0,127.0,5,1111,23.0,843.0,843.0
0.005,17,2,179,1,71,0.0,43.0,43.0,1,108,0.0,80.0,80.0
0.009,6,10,1989,5,910,2.0,642.0,642.0,5,1079,2.0,811.0,811.0
0.013,6,10,1631,5,848,3.0,580.0,580.0,5,783,3.0,515.0,515.0
0.003,17,2,136,1,60,0.0,32.0,32.0,1,76,0.0,48.0,48.0
242.387,6,38,15174,20,3059,12755.0,676.0,402.0,18,12115,14256.0,1402.0,931.0
0.006,6,10,1547,5,764,1.0,496.0,496.0,5,783,1.0,515.0,515.0
0.005,6,10,1774,5,923,1.0,655.0,655.0,5,851,1.0,583.0,583.0
15.072,17,15,9238,8,6902,2149.0,1350.0,834.0,7,2336,2507.0,1350.0,305.0
0.005,6,10,2006,5,927,1.0,659.0,659.0,5,1079,1.0,811.0,811.0
40.061,17,10,676,5,460,10014.0,104.0,64.0,5,216,10014.0,20.0,15.0
0.005,6,10,2006,5,927,1.0,659.0,659.0,5,1079,1.0,811.0,811.0
0.019,6,10,1762,5,911,4.0,643.0,643.0,5,851,4.0,583.0,583.0
0.069,6,10,1506,5,395,14.0,127.0,127.0,5,1111,16.0,843.0,843.0
0.116,6,10,1506,5,395,20.0,127.0,127.0,5,1111,25.0,843.0,843.0
0.006,6,10,1689,5,839,1.0,571.0,571.0,5,850,1.0,582.0,582.0
0.017,6,10,1989,5,910,4.0,642.0,642.0,5,1079,4.0,811.0,811.0
0.104,6,10,1506,5,395,24.0,127.0,127.0,5,1111,25.0,843.0,843.0
0.005,6,10,2007,5,928,1.0,660.0,660.0,5,1079,1.0,811.0,811.0
0.009,6,10,1990,5,911,2.0,643.0,643.0,5,1079,2.0,811.0,811.0
0.012,6,10,1631,5,848,3.0,580.0,580.0,5,783,3.0,515.0,515.0
0.004,6,10,1702,5,863,1.0,595.0,595.0,5,839,1.0,571.0,571.0
0.013,6,10,1762,5,911,3.0,643.0,643.0,5,851,3.0,583.0,583.0
0.076,6,10,1506,5,395,16.0,127.0,127.0,5,1111,16.0,843.0,843.0
240.014,6,9,787,5,488,60003.0,232.0,232.0,4,299,80003.0,83.0,83.0
0.018,6,10,1972,5,910,4.0,642.0,642.0,5,1062,4.0,794.0,794.0
0.015,6,10,1990,5,911,3.0,643.0,643.0,5,1079,3.0,811.0,811.0
0.01,6,10,1677,5,827,2.0,559.0,559.0,5,850,2.0,582.0,582.0
0.078,6,10,1506,5,395,16.0,127.0,127.0,5,1111,17.0,843.0,843.0
0.072,6,10,1506,5,395,17.0,127.0,127.0,5,1111,14.0,843.0,843.0
0.005,6,10,1689,5,839,1.0,571.0,571.0,5,850,1.0,582.0,582.0
0.004,6,10,2000,5,927,1.0,659.0,659.0,5,1073,1.0,805.0,805.0
0.01,6,10,1972,5,910,2.0,642.0,642.0,5,1062,2.0,794.0,794.0
0.039,17,2,148,1,60,0.0,32.0,32.0,1,88,0.0,60.0,60.0
0.006,6,10,1547,5,764,1.0,496.0,496.0,5,783,1.0,515.0,515.0
21.801,6,35,9486,17,3968,550.0,1543.0,814.0,18,5518,1272.0,2667.0,435.0
1729.246,6,60,4400,40,2740,44339.0,33.0,33.0,20,1660,91004.0,31.0,31.0
0.013,6,10,1990,5,911,3.0,643.0,643.0,5,1079,3.0,811.0,811.0
351.993,6,20,2210,6,1308,12003.0,494.0,494.0,14,902,27076.0,83.0,83.0
0.006,6,10,1854,5,889,1.0,621.0,621.0,5,965,1.0,697.0,697.0
1753.199,6,447,66202,254,35296,6929.0,613.0,197.0,193,30906,9130.0,453.0,146.0
0.005,6,10,2000,5,927,1.0,659.0,659.0,5,1073,1.0,805.0,805.0
0.011,6,10,1990,5,911,2.0,643.0,643.0,5,1079,2.0,811.0,811.0
0.043,17,2,152,1,76,0.0,48.0,48.0,1,76,0.0,48.0,48.0
0.005,6,10,2000,5,927,1.0,659.0,659.0,5,1073,1.0,805.0,805.0
0.018,6,10,1972,5,910,4.0,642.0,642.0,5,1062,4.0,794.0,794.0
0.001,17,2,140,1,62,0.0,34.0,34.0,1,78,0.0,50.0,50.0
0.005,17,2,222,1,79,0.0,51.0,51.0,1,143,0.0,115.0,115.0
311.864,17,20,1124,10,716,34636.0,48.0,43.0,10,408,34636.0,20.0,12.0
0.005,17,2,180,1,58,0.0,30.0,30.0,1,122,0.0,94.0,94.0
0.053,17,2,152,1,76,0.0,48.0,48.0,1,76,0.0,48.0,48.0
0.01,6,10,1983,5,910,2.0,642.0,642.0,5,1073,2.0,805.0,805.0
0.038,17,2,148,1,60,0.0,32.0,32.0,1,88,0.0,60.0,60.0
0.013,6,10,1989,5,910,3.0,642.0,642.0,5,1079,3.0,811.0,811.0
0.006,6,10,1854,5,889,1.0,621.0,621.0,5,965,1.0,697.0,697.0
0.008,6,10,1677,5,827,2.0,559.0,559.0,5,850,2.0,582.0,582.0
40.056,17,10,676,5,460,10012.0,104.0,64.0,5,216,10013.0,20.0,15.0
0.005,6,10,2000,5,927,1.0,659.0,659.0,5,1073,1.0,805.0,805.0
1795.45,6,492,99492,248,88142,7269.0,421.0,365.0,244,11350,7387.0,53.0,53.0
10.961,17,28,4422,14,1994,834.0,269.0,114.0,14,2428,834.0,587.0,145.0
0.01,6,10,1990,5,911,2.0,643.0,643.0,5,1079,2.0,811.0,811.0
0.009,6,10,2000,5,927,2.0,659.0,659.0,5,1073,2.0,805.0,805.0
0.012,6,10,1989,5,910,3.0,642.0,642.0,5,1079,3.0,811.0,811.0
0.037,17,2,170,1,65,0.0,37.0,37.0,1,105,0.0,77.0,77.0
0.003,17,2,152,1,76,0.0,48.0,48.0,1,76,0.0,48.0,48.0
0.117,6,10,1506,5,395,27.0,127.0,127.0,5,1111,16.0,843.0,843.0
0.001,17,2,180,1,66,0.0,38.0,38.0,1,114,0.0,86.0,86.0
0.005,6,14,3742,7,452,0.0,80.0,80.0,7,3290,0.0,1448.0,972.0
240.011,6,9,787,5,488,60002.0,232.0,232.0,4,299,80002.0,83.0,83.0
0.155,6,10,1506,5,395,24.0,127.0,127.0,5,1111,37.0,843.0,843.0
0.005,17,2,175,1,65,0.0,37.0,37.0,1,110,0.0,82.0,82.0
11.153,17,28,4418,14,1994,845.0,269.0,114.0,14,2424,845.0,587.0,145.0
0.08,6,10,1506,5,395,18.0,127.0,127.0,5,1111,18.0,843.0,843.0
0.005,6,10,2006,5,927,1.0,659.0,659.0,5,1079,1.0,811.0,811.0
0.005,17,2,230,1,68,0.0,40.0,40.0,1,162,0.0,134.0,134.0
168.068,17,100,14422,50,3379,3429.0,44.0,39.0,50,11043,3429.0,260.0,192.0
0.001,17,2,180,1,66,0.0,38.0,38.0,1,114,0.0,86.0,86.0
0.091,17,4,596,2,122,19.0,33.0,33.0,2,474,51.0,323.0,209.0
0.005,6,10,2006,5,927,1.0,659.0,659.0,5,1079,1.0,811.0,811.0
0.017,17,2,169,1,62,0.0,34.0,34.0,1,107,0.0,79.0,79.0
0.014,6,10,1989,5,910,3.0,642.0,642.0,5,1079,3.0,811.0,811.0
0.099,6,10,1506,5,395,23.0,127.0,127.0,5,1111,22.0,843.0,843.0
0.011,6,10,1990,5,911,2.0,643.0,643.0,5,1079,2.0,811.0,811.0
0.005,6,14,3742,7,452,0.0,80.0,80.0,7,3290,0.0,1448.0,972.0
0.005,6,10,1547,5,764,1.0,496.0,496.0,5,783,1.0,515.0,515.0
0.004,6,10,2006,5,927,1.0,659.0,659.0,5,1079,1.0,811.0,811.0
0.015,6,10,1990,5,911,3.0,643.0,643.0,5,1079,3.0,811.0,811.0
0.015,6,10,1972,5,910,3.0,642.0,642.0,5,1062,3.0,794.0,794.0
0.005,17,2,170,1,65,0.0,37.0,37.0,1,105,0.0,77.0,77.0
0.005,6,10,1689,5,839,1.0,571.0,571.0,5,850,1.0,582.0,582.0
0.005,6,10,1779,5,928,1.0,660.0,660.0,5,851,1.0,583.0,583.0
0.007,6,10,1689,5,839,1.0,571.0,571.0,5,850,1.0,582.0,582.0
0.003,17,2,136,1,60,0.0,32.0,32.0,1,76,0.0,48.0,48.0
369.906,6,22,2313,16,867,24660.0,195.0,195.0,6,1446,4637.0,419.0,398.0
0.004,17,2,144,1,64,0.0,36.0,36.0,1,80,0.0,52.0,52.0
0.106,6,10,1506,5,395,23.0,127.0,127.0,5,1111,20.0,843.0,843.0
0.012,6,10,1990,5,911,3.0,643.0,643.0,5,1079,2.0,811.0,811.0
0.009,6,10,1989,5,910,2.0,642.0,642.0,5,1079,2.0,811.0,811.0
40.077,17,10,676,5,460,10017.0,104.0,64.0,5,216,10018.0,20.0,15.0
0.017,6,10,1989,5,910,4.0,642.0,642.0,5,1079,4.0,811.0,811.0
0.015,6,13,3816,7,578,2.0,206.0,206.0,6,3238,3.0,1470.0,1459.0
0.185,17,4,596,2,122,145.0,33.0,33.0,2,474,145.0,323.0,209.0
1770.806,6,135,6510,75,3585,23926.0,39.0,39.0,60,2925,30009.0,35.0,35.0
0.005,6,10,1989,5,927,1.0,659.0,659.0,5,1062,1.0,794.0,794.0
0.005,6,13,3747,7,509,0.0,137.0,137.0,6,3238,0.0,1470.0,1459.0
40.066,17,10,676,5,460,10015.0,104.0,64.0,5,216,10015.0,20.0,15.0
0.135,6,10,1506,5,395,28.0,127.0,127.0,5,1111,31.0,843.0,843.0
0.009,6,10,2000,5,927,2.0,659.0,659.0,5,1073,2.0,805.0,805.0
0.249,17,42,20372,22,17091,11.0,1350.0,748.0,20,3281,11.0,1350.0,136.0
0.204,6,16,2779,8,1397,29.0,533.0,324.0,8,1382,18.0,529.0,239.0
0.041,17,2,412,1,61,0.0,33.0,33.0,1,351,0.0,323.0,323.0
0.013,17,2,152,1,56,0.0,28.0,28.0,1,96,0.0,68.0,68.0
0.008,6,10,1989,5,910,2.0,642.0,642.0,5,1079,1.0,811.0,811.0
0.026,6,10,1989,5,910,6.0,642.0,642.0,5,1079,6.0,811.0,811.0
0.009,6,12,1926,6,1189,1.0,659.0,434.0,6,737,1.0,417.0,417.0
0.368,17,48,28514,28,23552,13.0,1350.0,813.0,20,4962,14.0,1350.0,220.0
15.073,17,15,9238,8,6902,2149.0,1350.0,834.0,7,2336,2507.0,1350.0,305.0
0.072,17,4,596,2,122,1.0,33.0,33.0,2,474,35.0,323.0,209.0
0.003,17,2,148,1,60,0.0,32.0,32.0,1,88,0.0,60.0,60.0
0.001,17,2,180,1,66,0.0,38.0,38.0,1,114,0.0,86.0,86.0
0.013,6,10,1989,5,910,3.0,642.0,642.0,5,1079,3.0,811.0,811.0
0.076,6,10,1506,5,395,16.0,127.0,127.0,5,1111,18.0,843.0,843.0
40.06,17,10,676,5,460,10014.0,104.0,64.0,5,216,10014.0,20.0,15.0
0.009,6,14,3787,7,497,1.0,125.0,125.0,7,3290,1.0,1448.0,972.0
0.004,17,2,148,1,60,0.0,32.0,32.0,1,88,0.0,60.0,60.0
0.07,17,8,3613,4,1874,23.0,1350.0,440.0,4,1739,12.0,1350.0,406.0
0.005,6,10,1854,5,889,1.0,621.0,621.0,5,965,1.0,697.0,697.0
0.005,6,10,2000,5,927,1.0,659.0,659.0,5,1073,1.0,805.0,805.0
0.092,6,10,1506,5,395,20.0,127.0,127.0,5,1111,19.0,843.0,843.0
241.711,6,370,346162,191,21456,1272.0,2736.0,885.0,179,324706,1357.0,2804.0,1866.0
310.529,17,20,1124,10,716,34489.0,48.0,43.0,10,408,34489.0,20.0,12.0
0.004,6,14,3742,8,504,0.0,80.0,80.0,6,3238,0.0,1470.0,1459.0
40.062,17,10,676,5,460,10013.0,104.0,64.0,5,216,10014.0,20.0,15.0
0.022,6,10,1989,5,910,5.0,642.0,642.0,5,1079,5.0,811.0,811.0
295.009,6,313,344072,118,17687,2521.0,2736.0,888.0,195,326385,1520.0,2804.0,1747.0
0.039,17,2,182,1,65,0.0,37.0,37.0,1,117,0.0,89.0,89.0
40.07,17,10,676,5,460,10016.0,104.0,64.0,5,216,10016.0,20.0,15.0
0.011,6,10,1972,5,910,2.0,642.0,642.0,5,1062,2.0,794.0,794.0
0.011,17,2,164,1,74,0.0,46.0,46.0,1,90,0.0,62.0,62.0
0.004,6,10,2006,5,927,1.0,659.0,659.0,5,1079,1.0,811.0,811.0
0.005,6,10,2006,5,927,1.0,659.0,659.0,5,1079,1.0,811.0,811.0
0.016,6,10,1989,5,910,4.0,642.0,642.0,5,1079,4.0,811.0,811.0
0.005,6,10,1547,5,764,1.0,496.0,496.0,5,783,1.0,515.0,515.0
0.003,17,2,148,1,60,0.0,32.0,32.0,1,88,0.0,60.0,60.0
0.007,17,2,136,1,60,0.0,32.0,32.0,1,76,0.0,48.0,48.0
0.013,6,10,1983,5,910,3.0,642.0,642.0,5,1073,3.0,805.0,805.0
0.007,6,10,1762,5,911,1.0,643.0,643.0,5,851,1.0,583.0,583.0
0.011,6,10,1989,5,910,2.0,642.0,642.0,5,1079,2.0,811.0,811.0
0.012,6,10,1989,5,910,3.0,642.0,642.0,5,1079,3.0,811.0,811.0
0.003,17,2,152,1,76,0.0,48.0,48.0,1,76,0.0,48.0,48.0
0.004,6,14,3742,8,504,0.0,80.0,80.0,6,3238,0.0,1470.0,1459.0
0.013,6,10,1972,5,910,3.0,642.0,642.0,5,1062,3.0,794.0,794.0
0.003,17,2,136,1,60,0.0,32.0,32.0,1,76,0.0,48.0,48.0
0.004,17,2,136,1,60,0.0,32.0,32.0,1,76,0.0,48.0,48.0
0.152,6,10,1506,5,395,34.0,127.0,127.0,5,1111,35.0,843.0,843.0
0.035,6,10,1989,5,910,8.0,642.0,642.0,5,1079,8.0,811.0,811.0
1791.914,6,547,190806,277,164130,6492.0,2883.0,984.0,270,26676,6661.0,580.0,122.0
0.012,6,10,1983,5,910,2.0,642.0,642.0,5,1073,2.0,805.0,805.0
0.123,6,10,1506,5,395,27.0,127.0,127.0,5,1111,25.0,843.0,843.0
40.062,17,10,676,5,460,10012.0,104.0,64.0,5,216,10014.0,20.0,15.0
0.006,6,10,1547,5,764,1.0,496.0,496.0,5,783,1.0,515.0,515.0
0.005,17,2,214,1,75,0.0,47.0,47.0,1,139,0.0,111.0,111.0
0.158,6,10,1506,5,395,37.0,127.0,127.0,5,1111,33.0,843.0,843.0
0.214,6,16,2783,8,1401,30.0,533.0,325.0,8,1382,19.0,529.0,239.0
0.015,6,10,1972,5,910,3.0,642.0,642.0,5,1062,3.0,794.0,794.0
412.01,6,29,4409,12,3102,10912.0,494.0,494.0,17,1307,25750.0,83.0,83.0
0.217,6,16,2670,8,1396,31.0,533.0,324.0,8,1274,19.0,529.0,212.0
40.053,17,10,676,5,460,10012.0,104.0,64.0,5,216,10011.0,20.0,15.0
0.018,6,10,1990,5,911,4.0,643.0,643.0,5,1079,4.0,811.0,811.0
0.013,6,10,1989,5,910,3.0,642.0,642.0,5,1079,3.0,811.0,811.0
0.006,6,10,2007,5,928,1.0,660.0,660.0,5,1079,1.0,811.0,811.0
0.005,6,10,2006,5,927,1.0,659.0,659.0,5,1079,1.0,811.0,811.0
0.005,17,2,170,1,65,0.0,37.0,37.0,1,105,0.0,77.0,77.0
0.009,6,10,1983,5,910,2.0,642.0,642.0,5,1073,2.0,805.0,805.0
0.086,6,10,1506,5,395,16.0,127.0,127.0,5,1111,19.0,843.0,843.0
293.095,6,323,343938,122,17903,2422.0,2736.0,889.0,201,326035,1465.0,2804.0,1687.0
0.008,6,10,1989,5,910,1.0,642.0,642.0,5,1079,2.0,811.0,811.0
0.009,6,10,1990,5,911,2.0,643.0,643.0,5,1079,2.0,811.0,811.0
0.004,17,2,136,1,60,0.0,32.0,32.0,1,76,0.0,48.0,48.0
0.101,6,10,1506,5,395,24.0,127.0,127.0,5,1111,20.0,843.0,843.0
0.016,6,10,1983,5,910,4.0,642.0,642.0,5,1073,4.0,805.0,805.0
0.006,6,13,3747,7,509,1.0,137.0,137.0,6,3238,1.0,1470.0,1459.0
0.013,17,2,152,1,56,0.0,28.0,28.0,1,96,0.0,68.0,68.0
0.006,6,10,1689,5,839,1.0,571.0,571.0,5,850,1.0,582.0,582.0
172.176,17,74,10429,37,2466,4782.0,44.0,38.0,37,7963,4782.0,239.0,187.0
0.004,17,2,136,1,60,0.0,32.0,32.0,1,76,0.0,48.0,48.0
0.011,6,10,1972,5,910,2.0,642.0,642.0,5,1062,2.0,794.0,794.0
0.074,6,10,1506,5,395,17.0,127.0,127.0,5,1111,13.0,843.0,843.0
0.005,6,10,2006,5,927,1.0,659.0,659.0,5,1079,1.0,811.0,811.0
0.01,6,10,1989,5,910,2.0,642.0,642.0,5,1079,2.0,811.0,811.0
0.006,6,10,1774,5,923,1.0,655.0,655.0,5,851,1.0,583.0,583.0
0.006,6,10,1547,5,764,1.0,496.0,496.0,5,783,1.0,515.0,515.0
0.009,6,12,1926,6,1189,1.0,659.0,434.0,6,737,1.0,417.0,417.0
0.097,6,10,1506,5,395,19.0,127.0,127.0,5,1111,20.0,843.0,843.0
0.005,6,10,1989,5,927,1.0,659.0,659.0,5,1062,1.0,794.0,794.0
0.005,6,10,1989,5,927,1.0,659.0,659.0,5,1062,1.0,794.0,794.0
0.013,6,10,1677,5,827,3.0,559.0,559.0,5,850,3.0,582.0,582.0
0.692,6,22,5072,11,1250,58.0,325.0,133.0,11,3822,58.0,1414.0,563.0
0.041,17,2,152,1,76,0.0,48.0,48.0,1,76,0.0,48.0,48.0
0.005,6,10,2007,5,928,1.0,660.0,660.0,5,1079,1.0,811.0,811.0
0.015,6,10,1989,5,910,3.0,642.0,642.0,5,1079,3.0,811.0,811.0
0.008,6,10,1762,5,911,2.0,643.0,643.0,5,851,2.0,583.0,583.0
0.105,6,10,1506,5,395,24.0,127.0,127.0,5,1111,22.0,843.0,843.0
0.004,6,10,2007,5,928,1.0,660.0,660.0,5,1079,1.0,811.0,811.0
0.008,6,10,1972,5,910,2.0,642.0,642.0,5,1062,2.0,794.0,794.0
15.078,17,15,8471,8,6307,2149.0,1350.0,760.0,7,2164,2508.0,1350.0,281.0
0.071,6,10,1506,5,395,14.0,127.0,127.0,5,1111,16.0,843.0,843.0
0.006,17,2,214,1,75,0.0,47.0,47.0,1,139,0.0,111.0,111.0
300.08,6,19,4659,11,1102,30007.0,238.0,130.0,8,3557,42868.0,1402.0,786.0
0.012,6,10,1990,5,911,3.0,643.0,643.0,5,1079,2.0,811.0,811.0
0.001,17,2,144,1,64,0.0,36.0,36.0,1,80,0.0,52.0,52.0
0.016,6,10,1972,5,910,4.0,642.0,642.0,5,1062,3.0,794.0,794.0
0.005,6,10,1989,5,927,1.0,659.0,659.0,5,1062,1.0,794.0,794.0
0.003,17,2,170,1,65,0.0,37.0,37.0,1,105,0.0,77.0,77.0
0.012,6,10,1989,5,910,2.0,642.0,642.0,5,1079,3.0,811.0,811.0
0.008,6,12,1926,6,1189,1.0,659.0,434.0,6,737,1.0,417.0,417.0
0.07,6,10,1506,5,395,15.0,127.0,127.0,5,1111,15.0,843.0,843.0
0.005,6,10,2006,5,927,1.0,659.0,659.0,5,1079,1.0,811.0,811.0
0.131,6,10,1506,5,395,29.0,127.0,127.0,5,1111,30.0,843.0,843.0
0.005,6,10,1547,5,764,1.0,496.0,496.0,5,783,1.0,515.0,515.0
0.001,17,2,136,1,60,0.0,32.0,32.0,1,76,0.0,48.0,48.0
0.007,6,10,1989,5,910,1.0,642.0,642.0,5,1079,1.0,811.0,811.0
0.007,6,10,1779,5,928,1.0,660.0,660.0,5,851,1.0,583.0,583.0
0.088,6,10,1506,5,395,21.0,127.0,127.0,5,1111,20.0,843.0,843.0
292.928,6,40,9867,16,6638,19528.0,1710.0,645.0,24,3229,12735.0,580.0,131.0
15.076,17,16,9302,8,6912,2149.0,1350.0,836.0,8,2390,2149.0,1350.0,270.0
0.005,6,10,1779,5,928,1.0,660.0,660.0,5,851,1.0,583.0,583.0
1778.611,17,144,45504,74,23384,24364.0,288.0,288.0,70,22120,25776.0,288.0,288.0
0.004,6,10,1774,5,923,1.0,655.0,655.0,5,851,1.0,583.0,583.0
15.146,6,35,9137,19,1777,841.0,329.0,99.0,16,7360,1009.0,1402.0,652.0
0.018,6,10,1677,5,827,4.0,559.0,559.0,5,850,4.0,582.0,582.0
0.133,17,2,80,1,32,0.0,4.0,4.0,1,48,0.0,20.0,20.0
0.008,6,10,1983,5,910,2.0,642.0,642.0,5,1073,2.0,805.0,805.0
0.005,6,10,1547,5,764,1.0,496.0,496.0,5,783,1.0,515.0,515.0
0.006,6,10,1547,5,764,1.0,496.0,496.0,5,783,1.0,515.0,515.0
0.074,6,10,1506,5,395,16.0,127.0,127.0,5,1111,17.0,843.0,843.0
0.1,6,10,1506,5,395,23.0,127.0,127.0,5,1111,19.0,843.0,843.0
10.769,17,28,4422,14,1994,819.0,269.0,114.0,14,2428,819.0,587.0,145.0
0.079,6,10,1506,5,395,18.0,127.0,127.0,5,1111,18.0,843.0,843.0
0.005,6,10,1689,5,839,1.0,571.0,571.0,5,850,1.0,582.0,582.0
0.003,17,2,148,1,60,0.0,32.0,32.0,1,88,0.0,60.0,60.0
40.08,17,10,676,5,460,10016.0,104.0,64.0,5,216,10019.0,20.0,15.0
0.123,6,10,1506,5,395,28.0,127.0,127.0,5,1111,27.0,843.0,843.0
0.006,6,12,1698,6,863,1.0,327.0,271.0,6,835,1.0,515.0,515.0
0.006,6,10,1854,5,889,1.0,621.0,621.0,5,965,1.0,697.0,697.0
0.083,6,10,1506,5,395,16.0,127.0,127.0,5,1111,18.0,843.0,843.0
0.079,6,10,1506,5,395,18.0,127.0,127.0,5,1111,15.0,843.0,843.0
0.004,17,2,186,1,61,0.0,33.0,33.0,1,125,0.0,97.0,97.0
0.005,17,2,170,1,65,0.0,37.0,37.0,1,105,0.0,77.0,77.0
240.103,6,28,6572,14,4214,18469.0,1368.0,436.0,14,2358,18469.0,580.0,202.0
0.001,17,2,180,1,66,0.0,38.0,38.0,1,114,0.0,86.0,86.0
0.014,6,10,1990,5,911,3.0,643.0,643.0,5,1079,3.0,811.0,811.0
240.372,6,40,5372,20,2435,12651.0,588.0,196.0,20,2937,12651.0,580.0,269.0
0.006,6,10,1547,5,764,1.0,496.0,496.0,5,783,1.0,515.0,515.0
0.01,6,10,1989,5,910,2.0,642.0,642.0,5,1079,2.0,811.0,811.0
0.003,17,2,136,1,60,0.0,32.0,32.0,1,76,0.0,48.0,48.0
0.006,6,10,1547,5,764,1.0,496.0,496.0,5,783,1.0,515.0,515.0
361.775,6,21,1793,16,1030,24118.0,190.0,190.0,5,763,60009.0,462.0,247.0
40.061,17,10,676,5,460,10012.0,104.0,64.0,5,216,10014.0,20.0,15.0
0.006,6,10,1854,5,889,1.0,621.0,621.0,5,965,1.0,697.0,697.0
0.015,6,14,3787,7,497,2.0,125.0,125.0,7,3290,2.0,1448.0,972.0
314.771,17,20,1124,10,716,34959.0,48.0,43.0,10,408,34959.0,20.0,12.0
0.005,6,10,1854,5,889,1.0,621.0,621.0,5,965,1.0,697.0,697.0
0.042,17,2,136,1,60,0.0,32.0,32.0,1,76,0.0,48.0,48.0
0.04,17,2,170,1,65,0.0,37.0,37.0,1,105,0.0,77.0,77.0
0.118,6,10,1506,5,395,23.0,127.0,127.0,5,1111,25.0,843.0,843.0
0.009,6,10,1989,5,910,2.0,642.0,642.0,5,1079,2.0,811.0,811.0
0.003,17,2,148,1,60,0.0,32.0,32.0,1,88,0.0,60.0,60.0
0.073,17,2,186,1,61,0.0,33.0,33.0,1,125,0.0,97.0,97.0
0.006,6,10,1547,5,764,1.0,496.0,496.0,5,783,1.0,515.0,515.0
0.005,6,10,1989,5,927,1.0,659.0,659.0,5,1062,1.0,794.0,794.0
0.02,6,10,1990,5,911,4.0,643.0,643.0,5,1079,4.0,811.0,811.0
0.004,6,10,2006,5,927,1.0,659.0,659.0,5,1079,1.0,811.0,811.0
0.073,6,10,1506,5,395,17.0,127.0,127.0,5,1111,16.0,843.0,843.0
0.01,6,10,1762,5,911,2.0,643.0,643.0,5,851,2.0,583.0,583.0
0.015,6,10,1989,5,910,3.0,642.0,642.0,5,1079,3.0,811.0,811.0
0.009,6,12,1926,6,1189,1.0,659.0,434.0,6,737,1.0,417.0,417.0
0.003,17,2,148,1,60,0.0,32.0,32.0,1,88,0.0,60.0,60.0
0.005,17,2,214,1,75,0.0,47.0,47.0,1,139,0.0,111.0,111.0
0.021,6,13,3735,7,497,3.0,125.0,125.0,6,3238,4.0,1470.0,1459.0
0.012,6,10,1989,5,910,2.0,642.0,642.0,5,1079,3.0,811.0,811.0
0.012,6,10,1989,5,910,2.0,642.0,642.0,5,1079,2.0,811.0,811.0
10.807,17,28,4423,14,1994,822.0,269.0,114.0,14,2429,822.0,588.0,145.0
0.008,6,12,1926,6,1189,1.0,659.0,434.0,6,737,1.0,417.0,417.0
0.005,6,10,2007,5,928,1.0,660.0,660.0,5,1079,1.0,811.0,811.0
10.819,17,28,4418,14,1994,823.0,269.0,114.0,14,2424,823.0,587.0,145.0
0.017,6,10,1972,5,910,4.0,642.0,642.0,5,1062,4.0,794.0,794.0
0.004,6,14,3736,7,446,0.0,74.0,74.0,7,3290,0.0,1448.0,972.0
40.068,17,10,676,5,460,10016.0,104.0,64.0,5,216,10016.0,20.0,15.0
0.053,6,10,1506,5,395,11.0,127.0,127.0,5,1111,12.0,843.0,843.0
378.899,6,22,2313,16,867,25259.0,195.0,195.0,6,1446,4642.0,419.0,398.0
0.017,6,10,1990,5,911,4.0,643.0,643.0,5,1079,4.0,811.0,811.0
0.009,6,10,1990,5,911,2.0,643.0,643.0,5,1079,2.0,811.0,811.0
0.016,6,10,1983,5,910,4.0,642.0,642.0,5,1073,3.0,805.0,805.0
169.269,17,84,11706,42,2798,4128.0,44.0,38.0,42,8908,4128.0,239.0,184.0
0.084,6,10,1506,5,395,18.0,127.0,127.0,5,1111,19.0,843.0,843.0
0.005,6,10,2006,5,927,1.0,659.0,659.0,5,1079,1.0,811.0,811.0
0.005,6,10,2006,5,927,1.0,659.0,659.0,5,1079,1.0,811.0,811.0
0.001,17,2,180,1,66,0.0,38.0,38.0,1,114,0.0,86.0,86.0
0.018,6,10,1972,5,910,4.0,642.0,642.0,5,1062,4.0,794.0,794.0
0.09,6,10,1506,5,395,18.0,127.0,127.0,5,1111,16.0,843.0,843.0
0.012,6,10,1989,5,910,2.0,642.0,642.0,5,1079,3.0,811.0,811.0
0.013,6,10,1972,5,910,3.0,642.0,642.0,5,1062,3.0,794.0,794.0
0.008,6,10,1547,5,764,2.0,496.0,496.0,5,783,1.0,515.0,515.0
0.006,6,10,1547,5,764,1.0,496.0,496.0,5,783,1.0,515.0,515.0
241.226,6,315,351509,130,24810,1869.0,2736.0,1003.0,185,326699,1310.0,4206.0,1854.0
171.993,6,26,9525,12,1627,75.0,794.0,367.0,14,7898,13220.0,1360.0,732.0
0.011,17,2,230,1,68,0.0,40.0,40.0,1,162,0.0,134.0,134.0
369.42,6,24,2405,17,919,23088.0,195.0,195.0,7,1486,3920.0,419.0,398.0
0.005,6,10,2006,5,927,1.0,659.0,659.0,5,1079,1.0,811.0,811.0
40.066,17,10,676,5,460,10014.0,104.0,64.0,5,216,10015.0,20.0,15.0
40.079,17,10,676,5,460,10017.0,104.0,64.0,5,216,10019.0,20.0,15.0
240.555,6,33,9261,16,1834,16034.0,622.0,198.0,17,7427,15032.0,1402.0,595.0
0.003,17,2,152,1,76,0.0,48.0,48.0,1,76,0.0,48.0,48.0
40.065,17,10,676,5,460,10013.0,104.0,64.0,5,216,10007.0,20.0,15.0
0.011,6,10,1972,5,910,2.0,642.0,642.0,5,1062,2.0,794.0,794.0
0.004,6,10,2006,5,927,1.0,659.0,659.0,5,1079,1.0,811.0,811.0
0.001,17,2,132,1,58,0.0,30.0,30.0,1,74,0.0,46.0,46.0
0.023,6,10,1677,5,827,5.0,559.0,559.0,5,850,5.0,582.0,582.0
0.005,6,10,2006,5,927,1.0,659.0,659.0,5,1079,1.0,811.0,811.0
0.034,6,10,1989,5,910,8.0,642.0,642.0,5,1079,8.0,811.0,811.0
0.151,6,10,1506,5,395,33.0,127.0,127.0,5,1111,32.0,843.0,843.0
0.012,6,10,1972,5,910,3.0,642.0,642.0,5,1062,2.0,794.0,794.0
0.066,17,8,3613,4,1874,22.0,1350.0,440.0,4,1739,10.0,1350.0,406.0
49.576,17,29,19098,15,13460,3539.0,1350.0,869.0,14,5638,3811.0,1350.0,374.0
0.017,17,2,148,1,60,0.0,32.0,32.0,1,88,0.0,60.0,60.0
0.006,6,10,2006,5,927,1.0,659.0,659.0,5,1079,1.0,811.0,811.0
0.005,6,10,1689,5,839,1.0,571.0,571.0,5,850,1.0,582.0,582.0
0.005,6,10,2007,5,928,1.0,660.0,660.0,5,1079,1.0,811.0,811.0
0.037,17,2,234,1,61,0.0,33.0,33.0,1,173,0.0,145.0,145.0
0.012,6,10,1983,5,910,2.0,642.0,642.0,5,1073,3.0,805.0,805.0
0.004,6,10,2006,5,927,1.0,659.0,659.0,5,1079,1.0,811.0,811.0
0.005,6,10,2007,5,928,1.0,660.0,660.0,5,1079,1.0,811.0,811.0
0.004,6,10,2000,5,927,1.0,659.0,659.0,5,1073,1.0,805.0,805.0
40.083,17,10,676,5,460,10019.0,104.0,64.0,5,216,10020.0,20.0,15.0
175.306,17,80,11490,40,2665,4494.0,44.0,38.0,40,8825,4494.0,261.0,192.0
0.005,6,13,3690,7,452,0.0,80.0,80.0,6,3238,1.0,1470.0,1459.0
0.004,6,10,1779,5,928,1.0,660.0,660.0,5,851,1.0,583.0,583.0
0.111,6,10,1506,5,395,25.0,127.0,127.0,5,1111,26.0,843.0,843.0
0.004,17,2,148,1,60,0.0,32.0,32.0,1,88,0.0,60.0,60.0
0.015,6,10,1631,5,848,3.0,580.0,580.0,5,783,3.0,515.0,515.0
0.005,17,2,213,1,69,0.0,41.0,41.0,1,144,0.0,116.0,116.0
0.013,6,10,1990,5,911,3.0,643.0,643.0,5,1079,3.0,811.0,811.0
0.006,6,10,1547,5,764,1.0,496.0,496.0,5,783,1.0,515.0,515.0
40.101,17,10,676,5,460,10022.0,104.0,64.0,5,216,10024.0,20.0,15.0
0.005,6,10,1854,5,889,1.0,621.0,621.0,5,965,1.0,697.0,697.0
0.004,17,4,284,2,120,0.0,32.0,32.0,2,164,1.0,60.0,54.0
0.006,6,10,1547,5,764,1.0,496.0,496.0,5,783,1.0,515.0,515.0
0.004,6,10,2006,5,927,1.0,659.0,659.0,5,1079,1.0,811.0,811.0
241.48,6,381,347462,205,22178,1183.0,2736.0,960.0,176,325284,1379.0,2769.0,1904.0
0.068,17,8,3613,4,1874,22.0,1350.0,440.0,4,1739,11.0,1350.0,406.0
0.005,17,2,302,1,65,0.0,37.0,37.0,1,237,0.0,209.0,209.0
0.005,6,10,2006,5,927,1.0,659.0,659.0,5,1079,1.0,811.0,811.0
72.602,6,33,17843,16,9643,4840.0,2804.0,1259.0,17,8200,4529.0,2311.0,1218.0
0.006,6,10,1779,5,928,1.0,660.0,660.0,5,851,1.0,583.0,583.0
177.453,17,76,11036,38,2526,4795.0,44.0,38.0,38,8510,4795.0,239.0,195.0
0.012,6,10,1972,5,910,3.0,642.0,642.0,5,1062,3.0,794.0,794.0
0.004,17,4,284,2,120,0.0,32.0,32.0,2,164,0.0,60.0,54.0
0.014,6,10,1990,5,911,3.0,643.0,643.0,5,1079,3.0,811.0,811.0
0.004,17,2,213,1,69,0.0,41.0,41.0,1,144,0.0,116.0,116.0
0.009,6,13,3735,7,497,1.0,125.0,125.0,6,3238,1.0,1470.0,1459.0
0.004,17,2,148,1,60,0.0,32.0,32.0,1,88,0.0,60.0,60.0
0.004,17,2,148,1,60,0.0,32.0,32.0,1,88,0.0,60.0,60.0
0.008,6,10,1990,5,911,2.0,643.0,643.0,5,1079,1.0,811.0,811.0
0.005,6,10,1702,5,863,1.0,595.0,595.0,5,839,1.0,571.0,571.0
0.006,6,10,2006,5,927,1.0,659.0,659.0,5,1079,1.0,811.0,811.0
240.179,6,46,6989,22,3223,11436.0,588.0,230.0,24,3766,10442.0,580.0,228.0
0.007,17,2,194,1,59,0.0,31.0,31.0,1,135,0.0,107.0,107.0
0.003,17,2,136,1,60,0.0,32.0,32.0,1,76,0.0,48.0,48.0
0.101,6,43,13971,24,2565,4.0,517.0,146.0,19,11406,4.0,1402.0,867.0
0.009,6,12,1926,6,1189,1.0,659.0,434.0,6,737,1.0,417.0,417.0
0.011,6,10,1631,5,848,2.0,580.0,580.0,5,783,2.0,515.0,515.0
0.174,17,2,152,1,76,0.0,48.0,48.0,1,76,0.0,48.0,48.0
0.041,17,2,184,1,61,0.0,33.0,33.0,1,123,0.0,95.0,95.0
0.005,6,10,1989,5,927,1.0,659.0,659.0,5,1062,1.0,794.0,794.0
0.086,6,10,1506,5,395,19.0,127.0,127.0,5,1111,15.0,843.0,843.0
0.006,6,10,1643,5,860,1.0,592.0,592.0,5,783,1.0,515.0,515.0
0.005,17,4,495,2,132,0.0,38.0,38.0,2,363,2.0,176.0,153.0
0.004,6,10,2006,5,927,1.0,659.0,659.0,5,1079,1.0,811.0,811.0
0.01,6,10,1972,5,910,2.0,642.0,642.0,5,1062,2.0,794.0,794.0
0.009,6,10,1854,5,889,2.0,621.0,621.0,5,965,2.0,697.0,697.0
0.019,6,10,1989,5,910,4.0,642.0,642.0,5,1079,4.0,811.0,811.0
0.065,6,10,1506,5,395,14.0,127.0,127.0,5,1111,13.0,843.0,843.0
0.005,17,2,166,1,75,0.0,47.0,47.0,1,91,0.0,63.0,63.0
0.005,6,10,2006,5,927,1.0,659.0,659.0,5,1079,1.0,811.0,811.0
0.005,6,10,2007,5,928,1.0,660.0,660.0,5,1079,1.0,811.0,811.0
0.005,6,10,2007,5,928,1.0,660.0,660.0,5,1079,1.0,811.0,811.0
0.003,17,2,136,1,60,0.0,32.0,32.0,1,76,0.0,48.0,48.0
0.167,17,2,152,1,76,0.0,48.0,48.0,1,76,0.0,48.0,48.0
0.009,6,10,1989,5,910,2.0,642.0,642.0,5,1079,2.0,811.0,811.0
300.291,6,20,3342,10,1794,33365.0,655.0,313.0,10,1548,26694.0,740.0,255.0
0.006,6,10,2006,5,927,1.0,659.0,659.0,5,1079,1.0,811.0,811.0
0.089,6,10,1506,5,395,20.0,127.0,127.0,5,1111,17.0,843.0,843.0
0.116,6,10,1506,5,395,25.0,127.0,127.0,5,1111,23.0,843.0,843.0
0.1,6,10,1506,5,395,22.0,127.0,127.0,5,1111,21.0,843.0,843.0
0.078,6,10,1506,5,395,18.0,127.0,127.0,5,1111,18.0,843.0,843.0
40.069,17,10,676,5,460,10016.0,104.0,64.0,5,216,10016.0,20.0,15.0
0.012,6,10,1989,5,910,3.0,642.0,642.0,5,1079,2.0,811.0,811.0
0.005,6,10,2000,5,927,1.0,659.0,659.0,5,1073,1.0,805.0,805.0
0.038,17,2,152,1,76,0.0,48.0,48.0,1,76,0.0,48.0,48.0
0.003,17,4,284,2,120,0.0,32.0,32.0,2,164,0.0,60.0,54.0
0.001,17,2,180,1,66,0.0,38.0,38.0,1,114,0.0,86.0,86.0
0.061,6,10,1506,5,395,13.0,127.0,127.0,5,1111,14.0,843.0,843.0
351.99,6,20,2210,6,1308,12003.0,494.0,494.0,14,902,27075.0,83.0,83.0
0.096,6,10,1506,5,395,22.0,127.0,127.0,5,1111,23.0,843.0,843.0
0.007,6,10,1972,5,910,1.0,642.0,642.0,5,1062,1.0,794.0,794.0
0.005,6,13,3747,7,509,0.0,137.0,137.0,6,3238,0.0,1470.0,1459.0
0.081,6,10,1506,5,395,18.0,127.0,127.0,5,1111,17.0,843.0,843.0
0.005,6,10,1689,5,839,1.0,571.0,571.0,5,850,1.0,582.0,582.0
0.005,6,10,2007,5,928,1.0,660.0,660.0,5,1079,1.0,811.0,811.0
0.005,6,10,1854,5,889,1.0,621.0,621.0,5,965,1.0,697.0,697.0
0.096,6,10,1506,5,395,17.0,127.0,127.0,5,1111,21.0,843.0,843.0
294.07,6,374,347559,187,21285,1581.0,4058.0,962.0,187,326274,1581.0,2804.0,1829.0
0.016,6,10,1989,5,910,4.0,642.0,642.0,5,1079,3.0,811.0,811.0
0.006,6,10,1854,5,889,1.0,621.0,621.0,5,965,1.0,697.0,697.0
0.005,6,10,2007,5,928,1.0,660.0,660.0,5,1079,1.0,811.0,811.0
371.23,6,22,2313,16,867,24748.0,195.0,195.0,6,1446,4647.0,419.0,398.0
0.013,6,10,1983,5,910,3.0,642.0,642.0,5,1073,3.0,805.0,805.0
330.473,17,20,1124,10,716,36704.0,48.0,43.0,10,408,36704.0,20.0,12.0
0.004,6,10,1779,5,928,1.0,660.0,660.0,5,851,1.0,583.0,583.0
0.001,17,2,180,1,66,0.0,38.0,38.0,1,114,0.0,86.0,86.0
0.006,6,10,1547,5,764,1.0,496.0,496.0,5,783,1.0,515.0,515.0
0.011,6,10,1989,5,910,2.0,642.0,642.0,5,1079,2.0,811.0,811.0
277.328,6,24,7212,14,1759,21332.0,253.0,207.0,10,5453,30813.0,1402.0,703.0
0.007,6,10,1854,5,889,1.0,621.0,621.0,5,965,1.0,697.0,697.0
0.018,6,10,1983,5,910,4.0,642.0,642.0,5,1073,4.0,805.0,805.0
0.009,6,10,1989,5,910,2.0,642.0,642.0,5,1079,2.0,811.0,811.0
0.055,17,2,152,1,76,0.0,48.0,48.0,1,76,0.0,48.0,48.0
40.065,17,10,676,5,460,10015.0,104.0,64.0,5,216,10015.0,20.0,15.0
0.014,6,10,1983,5,910,3.0,642.0,642.0,5,1073,3.0,805.0,805.0
0.012,6,10,1972,5,910,2.0,642.0,642.0,5,1062,3.0,794.0,794.0
0.009,6,10,1989,5,910,2.0,642.0,642.0,5,1079,2.0,811.0,811.0
0.015,6,10,1972,5,910,3.0,642.0,642.0,5,1062,3.0,794.0,794.0
0.013,17,2,152,1,56,0.0,28.0,28.0,1,96,0.0,68.0,68.0
0.005,6,10,2000,5,927,1.0,659.0,659.0,5,1073,1.0,805.0,805.0
0.037,17,2,412,1,61,0.0,33.0,33.0,1,351,0.0,323.0,323.0
11.164,17,28,4419,14,1994,846.0,269.0,114.0,14,2425,845.0,588.0,145.0
0.005,17,2,170,1,65,0.0,37.0,37.0,1,105,0.0,77.0,77.0
0.005,6,10,2006,5,927,1.0,659.0,659.0,5,1079,1.0,811.0,811.0
0.088,6,10,1506,5,395,19.0,127.0,127.0,5,1111,20.0,843.0,843.0
0.005,6,10,2006,5,927,1.0,659.0,659.0,5,1079,1.0,811.0,811.0
0.013,17,2,152,1,56,0.0,28.0,28.0,1,96,0.0,68.0,68.0
0.008,17,2,132,1,58,0.0,30.0,30.0,1,74,0.0,46.0,46.0
241.212,6,366,346658,189,21356,1283.0,2736.0,886.0,177,325302,1370.0,2804.0,1892.0
0.005,17,2,179,1,71,0.0,43.0,43.0,1,108,0.0,80.0,80.0
0.004,17,2,152,1,76,0.0,48.0,48.0,1,76,0.0,48.0,48.0
0.021,6,10,1989,5,910,5.0,642.0,642.0,5,1079,5.0,811.0,811.0
0.005,17,2,144,1,64,0.0,36.0,36.0,1,80,0.0,52.0,52.0
0.073,6,10,1506,5,395,15.0,127.0,127.0,5,1111,15.0,843.0,843.0
10.803,17,28,4422,14,1995,822.0,270.0,114.0,14,2427,822.0,586.0,145.0
0.013,6,10,1762,5,911,3.0,643.0,643.0,5,851,3.0,583.0,583.0
0.033,6,10,1989,5,910,8.0,642.0,642.0,5,1079,8.0,811.0,811.0
0.005,6,10,2006,5,927,1.0,659.0,659.0,5,1079,1.0,811.0,811.0
11.024,17,28,4418,14,1994,839.0,269.0,114.0,14,2424,839.0,587.0,145.0
0.005,6,10,1774,5,923,1.0,655.0,655.0,5,851,1.0,583.0,583.0
9.047,17,6,376,5,280,2261.0,28.0,28.0,1,96,0.0,68.0,68.0
0.016,6,10,1677,5,827,4.0,559.0,559.0,5,850,3.0,582.0,582.0
240.45,6,35,8926,18,2073,14143.0,694.0,225.0,17,6853,15027.0,1402.0,597.0
0.057,6,10,1990,5,911,14.0,643.0,643.0,5,1079,14.0,811.0,811.0
0.109,6,10,1506,5,395,23.0,127.0,127.0,5,1111,23.0,843.0,843.0
0.096,6,10,1506,5,395,19.0,127.0,127.0,5,1111,23.0,843.0,843.0
0.077,6,10,1506,5,395,18.0,127.0,127.0,5,1111,17.0,843.0,843.0
0.125,6,10,1506,5,395,26.0,127.0,127.0,5,1111,26.0,843.0,843.0
0.04,17,2,136,1,60,0.0,32.0,32.0,1,76,0.0,48.0,48.0
0.054,17,2,186,1,61,0.0,33.0,33.0,1,125,0.0,97.0,97.0
0.009,6,10,1989,5,910,2.0,642.0,642.0,5,1079,2.0,811.0,811.0
0.006,17,2,180,1,66,0.0,38.0,38.0,1,114,0.0,86.0,86.0
15.187,17,21,13547,11,9718,1515.0,1350.0,855.0,10,3829,1684.0,1350.0,354.0
0.004,6,10,2006,5,927,1.0,659.0,659.0,5,1079,1.0,811.0,811.0
10.889,17,28,4395,14,1995,828.0,270.0,114.0,14,2400,828.0,587.0,143.0
0.024,6,10,1990,5,911,5.0,643.0,643.0,5,1079,5.0,811.0,811.0
40.063,17,10,676,5,460,10014.0,104.0,64.0,5,216,10015.0,20.0,15.0
0.082,6,10,1506,5,395,19.0,127.0,127.0,5,1111,16.0,843.0,843.0
0.15,6,11,1558,6,447,27.0,127.0,127.0,5,1111,34.0,843.0,843.0
40.054,17,10,676,5,460,10012.0,104.0,64.0,5,216,10012.0,20.0,15.0
0.005,17,2,164,1,74,0.0,46.0,46.0,1,90,0.0,62.0,62.0
0.014,6,10,1631,5,848,3.0,580.0,580.0,5,783,3.0,515.0,515.0
0.047,6,10,1677,5,827,11.0,559.0,559.0,5,850,11.0,582.0,582.0
0.129,17,2,80,1,32,0.0,4.0,4.0,1,48,0.0,20.0,20.0
0.012,6,10,1990,5,911,3.0,643.0,643.0,5,1079,2.0,811.0,811.0
0.095,6,10,1506,5,395,17.0,127.0,127.0,5,1111,23.0,843.0,843.0
0.02,6,14,3868,7,578,3.0,206.0,206.0,7,3290,3.0,1448.0,972.0
0.004,17,2,136,1,60,0.0,32.0,32.0,1,76,0.0,48.0,48.0
0.005,6,10,1989,5,927,1.0,659.0,659.0,5,1062,1.0,794.0,794.0
0.014,6,10,1677,5,827,3.0,559.0,559.0,5,850,3.0,582.0,582.0
0.001,17,2,180,1,66,0.0,38.0,38.0,1,114,0.0,86.0,86.0
0.008,6,12,1926,6,1189,1.0,659.0,434.0,6,737,1.0,417.0,417.0
300.345,6,16,2170,9,684,37523.0,146.0,146.0,7,1486,50030.0,419.0,398.0
0.005,6,10,1854,5,889,1.0,621.0,621.0,5,965,1.0,697.0,697.0
0.005,17,2,194,1,59,0.0,31.0,31.0,1,135,0.0,107.0,107.0
0.013,6,10,1989,5,927,3.0,659.0,659.0,5,1062,3.0,794.0,794.0
0.01,6,10,1989,5,910,2.0,642.0,642.0,5,1079,2.0,811.0,811.0
0.004,6,10,2000,5,927,1.0,659.0,659.0,5,1073,1.0,805.0,805.0
0.015,6,10,1677,5,827,3.0,559.0,559.0,5,850,3.0,582.0,582.0
0.112,6,10,1506,5,395,25.0,127.0,127.0,5,1111,26.0,843.0,843.0
0.085,6,10,1506,5,395,18.0,127.0,127.0,5,1111,17.0,843.0,843.0
0.003,6,10,1702,5,863,0.0,595.0,595.0,5,839,0.0,571.0,571.0
0.001,17,2,152,1,68,0.0,40.0,40.0,1,84,0.0,56.0,56.0
0.004,6,10,2000,5,927,1.0,659.0,659.0,5,1073,1.0,805.0,805.0
40.065,17,10,676,5,460,10015.0,104.0,64.0,5,216,10015.0,20.0,15.0
0.005,6,10,1774,5,923,1.0,655.0,655.0,5,851,1.0,583.0,583.0
0.003,17,2,148,1,60,0.0,32.0,32.0,1,88,0.0,60.0,60.0
0.006,6,10,1547,5,764,1.0,496.0,496.0,5,783,1.0,515.0,515.0
0.181,17,2,194,1,59,0.0,31.0,31.0,1,135,0.0,107.0,107.0
11.311,17,28,4421,14,1993,856.0,268.0,114.0,14,2428,857.0,587.0,145.0
293.936,6,402,349198,193,21590,1530.0,2736.0,888.0,209,327608,1413.0,2804.0,1624.0
0.016,6,10,1631,5,848,4.0,580.0,580.0,5,783,4.0,515.0,515.0
0.006,17,2,180,1,66,0.0,38.0,38.0,1,114,0.0,86.0,86.0
0.007,6,10,2007,5,928,1.0,660.0,660.0,5,1079,1.0,811.0,811.0
0.065,6,10,1506,5,395,15.0,127.0,127.0,5,1111,13.0,843.0,843.0
40.053,17,10,676,5,460,10012.0,104.0,64.0,5,216,10012.0,20.0,15.0
368.789,6,22,2313,16,867,24585.0,195.0,195.0,6,1446,4636.0,419.0,398.0
0.006,6,10,1547,5,764,1.0,496.0,496.0,5,783,1.0,515.0,515.0
1756.219,6,64,7344,42,4469,42834.0,1625.0,108.0,22,2875,83621.0,1111.0,82.0
0.003,17,2,148,1,60,0.0,32.0,32.0,1,88,0.0,60.0,60.0
0.006,17,2,140,1,62,0.0,34.0,34.0,1,78,0.0,50.0,50.0
0.009,6,10,1989,5,910,2.0,642.0,642.0,5,1079,2.0,811.0,811.0
0.006,6,10,1643,5,860,1.0,592.0,592.0,5,783,1.0,515.0,515.0
0.094,6,10,1506,5,395,21.0,127.0,127.0,5,1111,21.0,843.0,843.0
0.005,6,10,2006,5,927,1.0,659.0,659.0,5,1079,1.0,811.0,811.0
0.009,6,12,1926,6,1189,1.0,659.0,434.0,6,737,1.0,417.0,417.0
0.005,6,10,2006,5,927,1.0,659.0,659.0,5,1079,1.0,811.0,811.0
0.005,6,10,1854,5,889,1.0,621.0,621.0,5,965,1.0,697.0,697.0
0.012,6,10,1989,5,910,3.0,642.0,642.0,5,1079,2.0,811.0,811.0
40.059,17,10,676,5,460,10014.0,104.0,64.0,5,216,10011.0,20.0,15.0
0.005,6,10,1774,5,923,1.0,655.0,655.0,5,851,1.0,583.0,583.0
0.009,6,10,1983,5,910,2.0,642.0,642.0,5,1073,2.0,805.0,805.0
0.014,6,10,1972,5,910,3.0,642.0,642.0,5,1062,3.0,794.0,794.0
300.31,6,16,2170,9,684,37517.0,146.0,146.0,7,1486,50023.0,419.0,398.0
0.005,6,10,2006,5,927,1.0,659.0,659.0,5,1079,1.0,811.0,811.0
0.169,17,2,152,1,76,0.0,48.0,48.0,1,76,0.0,48.0,48.0
0.024,6,10,1990,5,911,6.0,643.0,643.0,5,1079,5.0,811.0,811.0
1798.752,6,269,31795,110,15189,16501.0,2720.0,123.0,159,16606,11383.0,1360.0,129.0
0.009,6,10,1762,5,911,2.0,643.0,643.0,5,851,2.0,583.0,583.0
0.005,6,10,1989,5,927,1.0,659.0,659.0,5,1062,1.0,794.0,794.0
0.006,17,2,179,1,71,0.0,43.0,43.0,1,108,0.0,80.0,80.0
0.005,6,10,1989,5,927,1.0,659.0,659.0,5,1062,1.0,794.0,794.0
302.609,6,34,12671,20,1919,15926.0,260.0,171.0,14,10752,18659.0,2804.0,1001.0
0.011,6,10,1989,5,910,2.0,642.0,642.0,5,1079,2.0,811.0,811.0
0.006,6,13,3690,7,452,1.0,80.0,80.0,6,3238,1.0,1470.0,1459.0
0.013,6,10,1972,5,910,3.0,642.0,642.0,5,1062,3.0,794.0,794.0
0.013,6,10,1990,5,911,3.0,643.0,643.0,5,1079,3.0,811.0,811.0
0.004,6,10,1989,5,927,1.0,659.0,659.0,5,1062,1.0,794.0,794.0
0.044,17,2,152,1,76,0.0,48.0,48.0,1,76,0.0,48.0,48.0
0.003,17,2,132,1,58,0.0,30.0,30.0,1,74,0.0,46.0,46.0
0.004,6,10,1989,5,927,1.0,659.0,659.0,5,1062,1.0,794.0,794.0
291.234,6,405,348880,203,22132,1441.0,2736.0,889.0,202,326748,1448.0,2804.0,1682.0
40.065,17,10,676,5,460,10015.0,104.0,64.0,5,216,10015.0,20.0,15.0
0.127,6,10,1506,5,395,28.0,127.0,127.0,5,1111,29.0,843.0,843.0
0.006,6,10,1547,5,764,1.0,496.0,496.0,5,783,1.0,515.0,515.0
0.02,6,10,1990,5,911,5.0,643.0,643.0,5,1079,4.0,811.0,811.0
0.01,6,10,1762,5,911,2.0,643.0,643.0,5,851,2.0,583.0,583.0
0.018,6,10,1972,5,910,4.0,642.0,642.0,5,1062,4.0,794.0,794.0
0.005,6,10,2006,5,927,1.0,659.0,659.0,5,1079,1.0,811.0,811.0
351.993,6,20,2210,6,1308,12003.0,494.0,494.0,14,902,27076.0,83.0,83.0
0.006,17,2,170,1,65,0.0,37.0,37.0,1,105,0.0,77.0,77.0
0.208,6,16,2670,8,1396,29.0,533.0,324.0,8,1274,19.0,529.0,212.0
0.135,6,10,1506,5,395,31.0,127.0,127.0,5,1111,30.0,843.0,843.0
0.072,17,4,284,2,120,0.0,32.0,32.0,2,164,32.0,60.0,54.0
0.07,6,10,1506,5,395,16.0,127.0,127.0,5,1111,13.0,843.0,843.0
0.012,6,13,3735,7,497,2.0,125.0,125.0,6,3238,2.0,1470.0,1459.0
0.006,17,2,136,1,60,0.0,32.0,32.0,1,76,0.0,48.0,48.0
0.005,6,10,2007,5,928,1.0,660.0,660.0,5,1079,1.0,811.0,811.0
0.009,6,10,1972,5,910,2.0,642.0,642.0,5,1062,2.0,794.0,794.0
40.065,17,10,676,5,460,10014.0,104.0,64.0,5,216,10015.0,20.0,15.0
0.007,17,2,179,1,71,0.0,43.0,43.0,1,108,0.0,80.0,80.0
40.065,17,10,676,5,460,10014.0,104.0,64.0,5,216,10015.0,20.0,15.0
0.005,17,2,144,1,64,0.0,36.0,36.0,1,80,0.0,52.0,52.0
0.009,6,10,1989,5,910,2.0,642.0,642.0,5,1079,2.0,811.0,811.0
0.096,6,10,1506,5,395,22.0,127.0,127.0,5,1111,17.0,843.0,843.0
0.004,6,10,1989,5,927,1.0,659.0,659.0,5,1062,1.0,794.0,794.0
176.482,17,84,11668,42,2812,4304.0,44.0,38.0,42,8856,4304.0,239.0,182.0
0.01,6,10,1854,5,889,2.0,621.0,621.0,5,965,2.0,697.0,697.0
0.014,6,10,1983,5,910,3.0,642.0,642.0,5,1073,3.0,805.0,805.0
0.003,17,2,148,1,60,0.0,32.0,32.0,1,88,0.0,60.0,60.0
0.042,17,2,412,1,61,0.0,33.0,33.0,1,351,0.0,323.0,323.0
0.005,6,10,2006,5,927,1.0,659.0,659.0,5,1079,1.0,811.0,811.0
300.291,6,16,2170,9,684,37515.0,146.0,146.0,7,1486,50021.0,419.0,398.0
0.009,6,10,1990,5,911,2.0,643.0,643.0,5,1079,2.0,811.0,811.0
0.011,6,10,1989,5,910,2.0,642.0,642.0,5,1079,2.0,811.0,811.0
0.076,6,10,1506,5,395,16.0,127.0,127.0,5,1111,17.0,843.0,843.0
0.006,6,10,1547,5,764,1.0,496.0,496.0,5,783,1.0,515.0,515.0
0.005,17,2,169,1,62,0.0,34.0,34.0,1,107,0.0,79.0,79.0
0.008,6,10,1990,5,911,2.0,643.0,643.0,5,1079,2.0,811.0,811.0
0.003,17,2,136,1,60,0.0,32.0,32.0,1,76,0.0,48.0,48.0
176.114,17,86,12495,43,2899,4192.0,44.0,39.0,43,9596,4193.0,260.0,195.0
240.015,6,9,787,5,488,60003.0,232.0,232.0,4,299,80004.0,83.0,83.0
10.806,17,28,4421,14,1993,822.0,268.0,114.0,14,2428,822.0,587.0,145.0
0.016,6,10,1972,5,910,3.0,642.0,642.0,5,1062,3.0,794.0,794.0
0.019,6,13,3816,7,578,3.0,206.0,206.0,6,3238,3.0,1470.0,1459.0
0.006,6,10,1547,5,764,1.0,496.0,496.0,5,783,1.0,515.0,515.0
40.052,17,10,676,5,460,10012.0,104.0,64.0,5,216,10012.0,20.0,15.0
0.004,17,2,148,1,60,0.0,32.0,32.0,1,88,0.0,60.0,60.0
0.008,6,10,1990,5,911,2.0,643.0,643.0,5,1079,2.0,811.0,811.0
15.071,17,15,9238,8,6902,2149.0,1350.0,834.0,7,2336,2507.0,1350.0,305.0
0.004,17,2,148,1,60,0.0,32.0,32.0,1,88,0.0,60.0,60.0
1793.217,6,64,7361,42,4485,43737.0,1641.0,109.0,22,2876,85383.0,1112.0,82.0
0.099,6,10,1506,5,395,20.0,127.0,127.0,5,1111,20.0,843.0,843.0
0.107,6,10,1506,5,395,23.0,127.0,127.0,5,1111,24.0,843.0,843.0
0.128,17,2,136,1,60,0.0,32.0,32.0,1,76,0.0,48.0,48.0
0.016,6,10,1762,5,911,3.0,643.0,643.0,5,851,3.0,583.0,583.0
0.011,6,10,1983,5,910,2.0,642.0,642.0,5,1073,2.0,805.0,805.0
240.098,6,16,4480,9,963,30012.0,238.0,166.0,7,3517,40015.0,1402.0,786.0
0.027,6,10,1990,5,911,6.0,643.0,643.0,5,1079,6.0,811.0,811.0
0.001,17,2,179,1,62,0.0,34.0,34.0,1,117,0.0,89.0,89.0
0.016,6,10,1989,5,910,4.0,642.0,642.0,5,1079,3.0,811.0,811.0
0.004,6,10,1779,5,928,1.0,660.0,660.0,5,851,1.0,583.0,583.0
240.084,6,16,4482,9,963,30010.0,238.0,166.0,7,3519,40013.0,1402.0,786.0
0.006,17,2,193,1,71,0.0,43.0,43.0,1,122,0.0,94.0,94.0
0.005,6,10,1854,5,889,1.0,621.0,621.0,5,965,1.0,697.0,697.0
0.006,17,2,144,1,64,0.0,36.0,36.0,1,80,0.0,52.0,52.0
0.003,17,2,148,1,60,0.0,32.0,32.0,1,88,0.0,60.0,60.0
0.001,17,2,136,1,60,0.0,32.0,32.0,1,76,0.0,48.0,48.0
0.006,6,10,2007,5,928,1.0,660.0,660.0,5,1079,1.0,811.0,811.0
0.003,17,2,185,1,73,0.0,45.0,45.0,1,112,0.0,84.0,84.0
0.082,6,10,1506,5,395,14.0,127.0,127.0,5,1111,18.0,843.0,843.0
0.015,6,10,1990,5,911,3.0,643.0,643.0,5,1079,3.0,811.0,811.0
0.006,6,10,1643,5,860,1.0,592.0,592.0,5,783,1.0,515.0,515.0
0.008,6,12,1926,6,1189,1.0,659.0,434.0,6,737,1.0,417.0,417.0
0.014,6,10,1972,5,910,3.0,642.0,642.0,5,1062,3.0,794.0,794.0
0.004,6,10,1779,5,928,1.0,660.0,660.0,5,851,1.0,583.0,583.0
361.865,6,21,1793,16,1030,24124.0,190.0,190.0,5,763,60009.0,462.0,247.0
0.084,6,10,1506,5,395,20.0,127.0,127.0,5,1111,19.0,843.0,843.0
15.069,17,15,9238,8,6902,2148.0,1350.0,834.0,7,2336,2506.0,1350.0,305.0
0.005,6,10,2007,5,928,1.0,660.0,660.0,5,1079,1.0,811.0,811.0
0.005,6,10,1689,5,839,1.0,571.0,571.0,5,850,1.0,582.0,582.0
0.005,6,10,2007,5,928,1.0,660.0,660.0,5,1079,1.0,811.0,811.0
0.005,6,10,2006,5,927,1.0,659.0,659.0,5,1079,1.0,811.0,811.0
15.084,17,15,8263,8,6021,2150.0,1350.0,724.0,7,2242,2509.0,1350.0,292.0
0.006,17,2,249,1,64,0.0,36.0,36.0,1,185,0.0,157.0,157.0
0.012,6,10,1631,5,848,2.0,580.0,580.0,5,783,2.0,515.0,515.0
0.01,6,10,1990,5,911,2.0,643.0,643.0,5,1079,2.0,811.0,811.0
0.011,6,10,1983,5,910,2.0,642.0,642.0,5,1073,2.0,805.0,805.0
0.005,17,2,170,1,65,0.0,37.0,37.0,1,105,0.0,77.0,77.0
0.006,6,10,1689,5,839,1.0,571.0,571.0,5,850,1.0,582.0,582.0
0.005,17,2,136,1,60,0.0,32.0,32.0,1,76,0.0,48.0,48.0
0.094,6,10,1506,5,395,19.0,127.0,127.0,5,1111,19.0,843.0,843.0
0.003,17,2,148,1,60,0.0,32.0,32.0,1,88,0.0,60.0,60.0
40.064,17,10,676,5,460,10015.0,104.0,64.0,5,216,10015.0,20.0,15.0
0.217,6,16,2671,8,1397,31.0,533.0,324.0,8,1274,19.0,529.0,212.0
0.008,6,12,1926,6,1189,1.0,659.0,434.0,6,737,1.0,417.0,417.0
0.004,6,10,1774,5,923,1.0,655.0,655.0,5,851,1.0,583.0,583.0
0.091,6,10,1506,5,395,19.0,127.0,127.0,5,1111,19.0,843.0,843.0
40.062,17,10,676,5,460,10014.0,104.0,64.0,5,216,10014.0,20.0,15.0
240.281,6,41,8667,20,5634,12646.0,2883.0,573.0,21,3033,12013.0,580.0,241.0
0.01,6,10,1989,5,910,2.0,642.0,642.0,5,1079,2.0,811.0,811.0
0.001,17,2,166,1,75,0.0,47.0,47.0,1,91,0.0,63.0,63.0
0.078,6,10,1506,5,395,17.0,127.0,127.0,5,1111,16.0,843.0,843.0
376.355,6,22,2313,16,867,25090.0,195.0,195.0,6,1446,4636.0,419.0,398.0
0.006,17,2,170,1,65,0.0,37.0,37.0,1,105,0.0,77.0,77.0
0.04,17,2,170,1,65,0.0,37.0,37.0,1,105,0.0,77.0,77.0
0.105,6,10,1506,5,395,24.0,127.0,127.0,5,1111,22.0,843.0,843.0
0.012,6,10,1972,5,910,3.0,642.0,642.0,5,1062,2.0,794.0,794.0
0.009,6,10,1972,5,910,2.0,642.0,642.0,5,1062,2.0,794.0,794.0
0.015,6,10,1990,5,911,3.0,643.0,643.0,5,1079,3.0,811.0,811.0
0.078,6,10,1506,5,395,18.0,127.0,127.0,5,1111,17.0,843.0,843.0
40.07,17,10,676,5,460,10016.0,104.0,64.0,5,216,10015.0,20.0,15.0
0.074,6,10,1506,5,395,15.0,127.0,127.0,5,1111,18.0,843.0,843.0
0.016,6,10,1989,5,910,3.0,642.0,642.0,5,1079,3.0,811.0,811.0
0.004,6,10,1989,5,927,1.0,659.0,659.0,5,1062,1.0,794.0,794.0
40.064,17,10,676,5,460,10014.0,104.0,64.0,5,216,10015.0,20.0,15.0
0.006,6,10,1547,5,764,1.0,496.0,496.0,5,783,1.0,515.0,515.0
0.149,6,10,1506,5,395,35.0,127.0,127.0,5,1111,25.0,843.0,843.0
308.428,17,20,1124,10,716,34256.0,48.0,43.0,10,408,34256.0,20.0,12.0
0.005,6,10,1989,5,927,1.0,659.0,659.0,5,1062,1.0,794.0,794.0
0.006,6,10,1547,5,764,1.0,496.0,496.0,5,783,1.0,515.0,515.0
0.088,6,10,1506,5,395,19.0,127.0,127.0,5,1111,21.0,843.0,843.0
0.004,17,2,186,1,61,0.0,33.0,33.0,1,125,0.0,97.0,97.0
0.012,6,10,1972,5,910,3.0,642.0,642.0,5,1062,3.0,794.0,794.0
0.006,17,2,164,1,74,0.0,46.0,46.0,1,90,0.0,62.0,62.0
0.001,17,2,180,1,66,0.0,38.0,38.0,1,114,0.0,86.0,86.0
0.005,6,10,1689,5,839,1.0,571.0,571.0,5,850,1.0,582.0,582.0
0.005,6,10,2006,5,927,1.0,659.0,659.0,5,1079,1.0,811.0,811.0
0.005,17,2,144,1,64,0.0,36.0,36.0,1,80,0.0,52.0,52.0
0.005,6,14,3799,7,509,0.0,137.0,137.0,7,3290,0.0,1448.0,972.0
0.004,6,10,1989,5,927,1.0,659.0,659.0,5,1062,1.0,794.0,794.0
0.006,6,10,1854,5,889,1.0,621.0,621.0,5,965,1.0,697.0,697.0
1778.56,17,142,44872,72,22752,25049.0,288.0,288.0,70,22120,25767.0,288.0,288.0
0.115,6,10,1506,5,395,18.0,127.0,127.0,5,1111,25.0,843.0,843.0
0.069,6,10,1506,5,395,15.0,127.0,127.0,5,1111,14.0,843.0,843.0
0.005,6,10,1547,5,764,1.0,496.0,496.0,5,783,1.0,515.0,515.0
0.005,6,10,2006,5,927,1.0,659.0,659.0,5,1079,1.0,811.0,811.0
0.005,17,2,213,1,69,0.0,41.0,41.0,1,144,0.0,116.0,116.0
40.059,17,10,676,5,460,10014.0,104.0,64.0,5,216,10013.0,20.0,15.0
0.006,17,2,178,1,81,0.0,53.0,53.0,1,97,0.0,69.0,69.0
0.039,17,2,166,1,75,0.0,47.0,47.0,1,91,0.0,63.0,63.0
240.1,6,32,9495,16,7146,16006.0,2216.0,702.0,16,2349,16006.0,580.0,188.0
0.006,6,10,2006,5,927,1.0,659.0,659.0,5,1079,1.0,811.0,811.0
0.011,6,10,1990,5,911,2.0,643.0,643.0,5,1079,2.0,811.0,811.0
0.005,6,10,2006,5,927,1.0,659.0,659.0,5,1079,1.0,811.0,811.0
0.011,6,10,1983,5,910,2.0,642.0,642.0,5,1073,2.0,805.0,805.0
40.053,17,10,676,5,460,10012.0,104.0,64.0,5,216,10012.0,20.0,15.0
0.016,6,10,1972,5,910,4.0,642.0,642.0,5,1062,4.0,794.0,794.0
0.01,6,10,1972,5,910,2.0,642.0,642.0,5,1062,2.0,794.0,794.0
0.006,6,10,1643,5,860,1.0,592.0,592.0,5,783,1.0,515.0,515.0
0.006,6,10,1547,5,764,1.0,496.0,496.0,5,783,1.0,515.0,515.0
0.085,6,10,1506,5,395,17.0,127.0,127.0,5,1111,19.0,843.0,843.0
0.006,17,2,166,1,75,0.0,47.0,47.0,1,91,0.0,63.0,63.0
0.005,6,10,2007,5,928,1.0,660.0,660.0,5,1079,1.0,811.0,811.0
0.008,6,10,1972,5,910,2.0,642.0,642.0,5,1062,2.0,794.0,794.0
0.06,6,10,1506,5,395,14.0,127.0,127.0,5,1111,13.0,843.0,843.0
0.003,17,2,136,1,60,0.0,32.0,32.0,1,76,0.0,48.0,48.0
0.038,17,2,144,1,64,0.0,36.0,36.0,1,80,0.0,52.0,52.0
0.005,6,13,3747,7,509,0.0,137.0,137.0,6,3238,0.0,1470.0,1459.0
0.018,6,10,1972,5,910,4.0,642.0,642.0,5,1062,4.0,794.0,794.0
1.026,6,13,3930,7,2139,128.0,1328.0,923.0,6,1791,154.0,1539.0,1539.0
0.006,6,10,1547,5,764,1.0,496.0,496.0,5,783,1.0,515.0,515.0
40.056,17,10,676,5,460,10013.0,104.0,64.0,5,216,10013.0,20.0,15.0
0.013,6,10,1990,5,911,3.0,643.0,643.0,5,1079,3.0,811.0,811.0
310.5,17,20,1124,10,716,34485.0,48.0,43.0,10,408,34485.0,20.0,12.0
0.083,6,10,1506,5,395,17.0,127.0,127.0,5,1111,15.0,843.0,843.0
0.004,6,10,2000,5,927,1.0,659.0,659.0,5,1073,1.0,805.0,805.0
366.958,6,22,2313,16,867,24463.0,195.0,195.0,6,1446,4751.0,419.0,398.0
0.072,17,2,234,1,61,0.0,33.0,33.0,1,173,0.0,145.0,145.0
0.006,17,2,193,1,71,0.0,43.0,43.0,1,122,0.0,94.0,94.0
0.003,17,4,284,2,120,0.0,32.0,32.0,2,164,0.0,60.0,54.0
0.024,6,10,1972,5,910,6.0,642.0,642.0,5,1062,5.0,794.0,794.0
0.079,6,10,1506,5,395,17.0,127.0,127.0,5,1111,14.0,843.0,843.0
293.38,6,388,348435,197,21801,1496.0,2736.0,888.0,191,326634,1544.0,2804.0,1789.0
0.005,6,10,2007,5,928,1.0,660.0,660.0,5,1079,1.0,811.0,811.0
0.071,17,2,136,1,60,0.0,32.0,32.0,1,76,0.0,48.0,48.0
0.073,17,4,352,2,130,1.0,37.0,37.0,2,222,34.0,89.0,83.0
0.004,6,14,3799,7,509,0.0,137.0,137.0,7,3290,0.0,1448.0,972.0
0.013,6,10,1989,5,910,3.0,642.0,642.0,5,1079,3.0,811.0,811.0
0.051,6,11,2042,6,963,10.0,643.0,643.0,5,1079,12.0,811.0,811.0
0.004,6,10,2007,5,928,1.0,660.0,660.0,5,1079,1.0,811.0,811.0
300.012,6,11,891,6,552,60001.0,232.0,232.0,5,339,75002.0,83.0,83.0
0.127,17,2,80,1,32,0.0,4.0,4.0,1,48,0.0,20.0,20.0
0.001,17,2,180,1,66,0.0,38.0,38.0,1,114,0.0,86.0,86.0
0.011,6,10,1677,5,827,2.0,559.0,559.0,5,850,2.0,582.0,582.0
0.012,6,10,1989,5,910,3.0,642.0,642.0,5,1079,3.0,811.0,811.0
0.006,6,10,1547,5,764,1.0,496.0,496.0,5,783,1.0,515.0,515.0
40.077,17,10,676,5,460,10015.0,104.0,64.0,5,216,10018.0,20.0,15.0
0.004,6,10,1702,5,863,0.0,595.0,595.0,5,839,1.0,571.0,571.0
0.005,6,10,2006,5,927,1.0,659.0,659.0,5,1079,1.0,811.0,811.0
56.711,6,40,10793,20,5195,470.0,1360.0,727.0,20,5598,2976.0,2667.0,435.0
0.005,6,10,1989,5,927,1.0,659.0,659.0,5,1062,1.0,794.0,794.0
0.118,6,10,1506,5,395,23.0,127.0,127.0,5,1111,23.0,843.0,843.0
0.066,6,10,1506,5,395,14.0,127.0,127.0,5,1111,15.0,843.0,843.0
0.004,17,2,136,1,60,0.0,32.0,32.0,1,76,0.0,48.0,48.0
0.004,17,4,284,2,120,0.0,32.0,32.0,2,164,0.0,60.0,54.0
0.169,6,10,1506,5,395,40.0,127.0,127.0,5,1111,38.0,843.0,843.0
40.055,17,10,676,5,460,10012.0,104.0,64.0,5,216,10012.0,20.0,15.0
0.043,6,10,1990,5,911,10.0,643.0,643.0,5,1079,10.0,811.0,811.0
0.038,17,2,152,1,76,0.0,48.0,48.0,1,76,0.0,48.0,48.0
240.149,6,31,9562,15,7188,17153.0,2314.0,712.0,16,2374,16008.0,580.0,191.0
1797.036,17,3069,234507,1529,123924,1176.0,84.0,53.0,1540,110583,1167.0,227.0,43.0
0.006,6,10,1547,5,764,1.0,496.0,496.0,5,783,1.0,515.0,515.0
240.091,6,31,9468,15,7026,17149.0,2150.0,694.0,16,2442,16005.0,580.0,200.0
15.073,17,16,8530,8,6283,2149.0,1350.0,757.0,8,2247,2149.0,1350.0,252.0
0.006,6,10,2006,5,927,1.0,659.0,659.0,5,1079,1.0,811.0,811.0
0.11,6,10,1506,5,395,26.0,127.0,127.0,5,1111,23.0,843.0,843.0
0.004,17,2,160,1,72,0.0,44.0,44.0,1,88,0.0,60.0,60.0
0.006,6,10,1547,5,764,1.0,496.0,496.0,5,783,1.0,515.0,515.0
0.112,6,10,1506,5,395,25.0,127.0,127.0,5,1111,24.0,843.0,843.0
0.005,6,10,2006,5,927,1.0,659.0,659.0,5,1079,1.0,811.0,811.0
0.006,6,10,1854,5,889,1.0,621.0,621.0,5,965,1.0,697.0,697.0
0.017,6,10,1762,5,911,4.0,643.0,643.0,5,851,4.0,583.0,583.0
0.004,17,2,136,1,60,0.0,32.0,32.0,1,76,0.0,48.0,48.0
0.012,6,10,1989,5,910,3.0,642.0,642.0,5,1079,3.0,811.0,811.0
0.2,17,2,152,1,76,0.0,48.0,48.0,1,76,0.0,48.0,48.0
0.005,6,10,2007,5,928,1.0,660.0,660.0,5,1079,1.0,811.0,811.0
0.001,17,2,180,1,66,0.0,38.0,38.0,1,114,0.0,86.0,86.0
0.076,6,10,1506,5,395,15.0,127.0,127.0,5,1111,18.0,843.0,843.0
0.005,6,10,2006,5,927,1.0,659.0,659.0,5,1079,1.0,811.0,811.0
11.178,17,28,4422,14,1993,847.0,268.0,114.0,14,2429,847.0,588.0,145.0
0.008,6,10,1983,5,910,2.0,642.0,642.0,5,1073,2.0,805.0,805.0
0.074,6,10,1506,5,395,15.0,127.0,127.0,5,1111,14.0,843.0,843.0
0.098,6,10,1506,5,395,23.0,127.0,127.0,5,1111,21.0,843.0,843.0
0.016,6,10,1677,5,827,4.0,559.0,559.0,5,850,3.0,582.0,582.0
240.134,6,39,7007,19,3334,13340.0,880.0,334.0,20,3673,12638.0,1306.0,328.0
0.122,6,10,1506,5,395,25.0,127.0,127.0,5,1111,29.0,843.0,843.0
0.096,6,10,1506,5,395,23.0,127.0,127.0,5,1111,21.0,843.0,843.0
0.005,17,2,136,1,60,0.0,32.0,32.0,1,76,0.0,48.0,48.0
15.08,17,15,8374,8,6328,2150.0,1350.0,763.0,7,2046,2508.0,1350.0,264.0
0.11,6,10,1506,5,395,25.0,127.0,127.0,5,1111,23.0,843.0,843.0
0.006,6,10,1779,5,928,1.0,660.0,660.0,5,851,1.0,583.0,583.0
0.005,6,13,3747,7,509,0.0,137.0,137.0,6,3238,0.0,1470.0,1459.0
0.103,6,10,1506,5,395,20.0,127.0,127.0,5,1111,21.0,843.0,843.0
0.1,6,10,1506,5,395,22.0,127.0,127.0,5,1111,21.0,843.0,843.0
309.236,17,20,1124,10,716,34344.0,48.0,43.0,10,408,34344.0,20.0,12.0
40.076,17,10,676,5,460,10018.0,104.0,64.0,5,216,10018.0,20.0,15.0
0.008,6,10,1989,5,910,2.0,642.0,642.0,5,1079,2.0,811.0,811.0
0.011,6,10,1983,5,910,2.0,642.0,642.0,5,1073,2.0,805.0,805.0
40.073,17,10,676,5,460,10015.0,104.0,64.0,5,216,10017.0,20.0,15.0
300.309,6,16,2170,9,684,37518.0,146.0,146.0,7,1486,50024.0,419.0,398.0
0.081,6,10,1506,5,395,19.0,127.0,127.0,5,1111,19.0,843.0,843.0
9.038,17,6,376,5,280,2259.0,28.0,28.0,1,96,0.0,68.0,68.0
300.029,6,12,1782,7,1348,50004.0,494.0,494.0,5,434,75006.0,83.0,83.0
0.013,6,10,1989,5,910,3.0,642.0,642.0,5,1079,3.0,811.0,811.0
0.016,6,10,1989,5,910,3.0,642.0,642.0,5,1079,4.0,811.0,811.0
0.12,6,10,1506,5,395,24.0,127.0,127.0,5,1111,26.0,843.0,843.0
0.01,6,10,1990,5,911,2.0,643.0,643.0,5,1079,2.0,811.0,811.0
0.006,6,10,1989,5,927,1.0,659.0,659.0,5,1062,1.0,794.0,794.0
0.023,6,10,1989,5,910,5.0,642.0,642.0,5,1079,5.0,811.0,811.0
0.001,17,2,180,1,66,0.0,38.0,38.0,1,114,0.0,86.0,86.0
0.006,6,10,1989,5,927,1.0,659.0,659.0,5,1062,1.0,794.0,794.0
0.007,17,2,132,1,58,0.0,30.0,30.0,1,74,0.0,46.0,46.0
0.436,6,10,1506,5,395,106.0,127.0,127.0,5,1111,21.0,843.0,843.0
0.012,6,10,1631,5,848,3.0,580.0,580.0,5,783,3.0,515.0,515.0
66.001,6,25,10420,11,3921,6600.0,1591.0,838.0,14,6499,5066.0,2111.0,576.0
0.003,17,2,136,1,60,0.0,32.0,32.0,1,76,0.0,48.0,48.0
300.319,6,16,2170,9,684,37518.0,146.0,146.0,7,1486,50025.0,419.0,398.0
176.122,17,80,11038,40,2670,4515.0,44.0,38.0,40,8368,4515.0,239.0,181.0
0.11,6,10,1506,5,395,22.0,127.0,127.0,5,1111,23.0,843.0,843.0
0.146,6,10,1506,5,395,33.0,127.0,127.0,5,1111,34.0,843.0,843.0
1756.146,6,105,6270,60,3525,29764.0,27.0,27.0,45,2745,39911.0,27.0,27.0
0.011,6,10,1762,5,911,2.0,643.0,643.0,5,851,2.0,583.0,583.0
0.01,6,10,1762,5,911,2.0,643.0,643.0,5,851,2.0,583.0,583.0
0.092,6,10,1506,5,395,19.0,127.0,127.0,5,1111,21.0,843.0,843.0
0.019,6,10,1972,5,910,4.0,642.0,642.0,5,1062,4.0,794.0,794.0
0.038,17,4,284,2,120,0.0,32.0,32.0,2,164,35.0,60.0,54.0
0.004,6,10,2006,5,927,1.0,659.0,659.0,5,1079,1.0,811.0,811.0
0.014,6,10,1989,5,910,3.0,642.0,642.0,5,1079,3.0,811.0,811.0
0.006,6,10,1689,5,839,1.0,571.0,571.0,5,850,1.0,582.0,582.0
0.049,6,10,1990,5,911,12.0,643.0,643.0,5,1079,12.0,811.0,811.0
0.005,6,10,1989,5,927,1.0,659.0,659.0,5,1062,1.0,794.0,794.0
0.005,6,13,3747,7,509,0.0,137.0,137.0,6,3238,1.0,1470.0,1459.0
0.011,6,10,1983,5,910,2.0,642.0,642.0,5,1073,2.0,805.0,805.0
40.058,17,10,676,5,460,10013.0,104.0,64.0,5,216,10013.0,20.0,15.0
368.825,6,22,2313,16,867,24588.0,195.0,195.0,6,1446,4635.0,419.0,398.0
0.009,6,10,1990,5,911,2.0,643.0,643.0,5,1079,2.0,811.0,811.0
0.006,6,10,1547,5,764,1.0,496.0,496.0,5,783,1.0,515.0,515.0
0.014,6,10,1989,5,910,3.0,642.0,642.0,5,1079,3.0,811.0,811.0
40.063,17,10,676,5,460,10013.0,104.0,64.0,5,216,10014.0,20.0,15.0
0.006,6,10,1779,5,928,1.0,660.0,660.0,5,851,1.0,583.0,583.0
0.006,6,10,1547,5,764,1.0,496.0,496.0,5,783,1.0,515.0,515.0
0.006,6,12,1698,6,863,1.0,327.0,271.0,6,835,1.0,515.0,515.0
0.144,6,26,6095,14,1573,10.0,326.0,165.0,12,4522,11.0,1324.0,778.0
0.01,6,10,1989,5,910,2.0,642.0,642.0,5,1079,2.0,811.0,811.0
0.021,6,10,1990,5,911,5.0,643.0,643.0,5,1079,5.0,811.0,811.0
0.001,17,2,180,1,66,0.0,38.0,38.0,1,114,0.0,86.0,86.0
0.005,6,10,1689,5,839,1.0,571.0,571.0,5,850,1.0,582.0,582.0
0.001,17,2,136,1,60,0.0,32.0,32.0,1,76,0.0,48.0,48.0
0.008,6,10,1677,5,827,2.0,559.0,559.0,5,850,1.0,582.0,582.0
240.107,6,16,4481,9,963,30013.0,238.0,166.0,7,3518,40017.0,1402.0,786.0
0.175,6,3,453,2,321,175.0,241.0,241.0,1,132,0.0,92.0,92.0
0.017,6,10,1990,5,911,4.0,643.0,643.0,5,1079,4.0,811.0,811.0
0.01,6,10,1989,5,910,2.0,642.0,642.0,5,1079,2.0,811.0,811.0
0.017,17,2,136,1,60,0.0,32.0,32.0,1,76,0.0,48.0,48.0
0.009,6,10,1989,5,910,2.0,642.0,642.0,5,1079,2.0,811.0,811.0
1792.659,6,491,99452,247,88102,7286.0,421.0,365.0,244,11350,7376.0,53.0,53.0
240.882,6,27,8634,12,2404,21898.0,1283.0,443.0,15,6230,17205.0,1592.0,544.0
0.004,6,10,2000,5,927,1.0,659.0,659.0,5,1073,1.0,805.0,805.0
0.009,17,2,179,1,71,0.0,43.0,43.0,1,108,0.0,80.0,80.0
0.01,6,10,1989,5,910,2.0,642.0,642.0,5,1079,2.0,811.0,811.0
40.062,17,10,676,5,460,10014.0,104.0,64.0,5,216,10014.0,20.0,15.0
0.012,6,10,1990,5,911,2.0,643.0,643.0,5,1079,2.0,811.0,811.0
0.005,6,13,3747,7,509,0.0,137.0,137.0,6,3238,1.0,1470.0,1459.0
0.006,6,10,1643,5,860,1.0,592.0,592.0,5,783,1.0,515.0,515.0
0.09,6,10,1506,5,395,19.0,127.0,127.0,5,1111,19.0,843.0,843.0
0.004,17,4,284,2,120,1.0,32.0,32.0,2,164,0.0,60.0,54.0
0.004,6,10,2006,5,927,1.0,659.0,659.0,5,1079,1.0,811.0,811.0
0.007,6,10,1689,5,839,1.0,571.0,571.0,5,850,1.0,582.0,582.0
0.012,6,10,1631,5,848,3.0,580.0,580.0,5,783,3.0,515.0,515.0
0.004,6,10,1989,5,927,1.0,659.0,659.0,5,1062,1.0,794.0,794.0
0.003,17,4,284,2,120,0.0,32.0,32.0,2,164,0.0,60.0,54.0
0.008,6,10,1989,5,910,2.0,642.0,642.0,5,1079,2.0,811.0,811.0
40.058,17,10,676,5,460,10013.0,104.0,64.0,5,216,10013.0,20.0,15.0
0.079,6,10,1506,5,395,17.0,127.0,127.0,5,1111,18.0,843.0,843.0
0.004,17,2,136,1,60,0.0,32.0,32.0,1,76,0.0,48.0,48.0
1786.4,6,150,19350,90,13740,20071.0,302.0,302.0,60,5610,30277.0,83.0,83.0
0.019,6,10,1972,5,910,4.0,642.0,642.0,5,1062,4.0,794.0,794.0
0.006,6,10,1547,5,764,1.0,496.0,496.0,5,783,1.0,515.0,515.0
0.004,6,10,2006,5,927,1.0,659.0,659.0,5,1079,1.0,811.0,811.0
0.007,6,10,1643,5,860,1.0,592.0,592.0,5,783,1.0,515.0,515.0
240.02,6,9,787,5,488,60005.0,232.0,232.0,4,299,80005.0,83.0,83.0
351.985,6,20,2210,6,1308,12003.0,494.0,494.0,14,902,27075.0,83.0,83.0
40.063,17,10,676,5,460,10012.0,104.0,64.0,5,216,10014.0,20.0,15.0
0.123,6,10,1506,5,395,29.0,127.0,127.0,5,1111,27.0,843.0,843.0
0.136,6,10,1506,5,395,30.0,127.0,127.0,5,1111,28.0,843.0,843.0
361.826,6,21,1793,16,1030,24121.0,190.0,190.0,5,763,60009.0,462.0,247.0
290.613,6,373,346583,190,21448,1537.0,2736.0,889.0,183,325135,1596.0,2804.0,1867.0
0.005,6,10,2007,5,928,1.0,660.0,660.0,5,1079,1.0,811.0,811.0
0.01,6,10,1762,5,911,2.0,643.0,643.0,5,851,2.0,583.0,583.0
300.242,6,27,7436,16,1409,20016.0,217.0,142.0,11,6027,24022.0,1679.0,778.0
1799.654,17,122,11651,61,5551,29993.0,63.0,63.0,61,6100,29993.0,72.0,72.0
0.007,17,2,132,1,58,0.0,30.0,30.0,1,74,0.0,46.0,46.0
0.001,17,2,180,1,66,0.0,38.0,38.0,1,114,0.0,86.0,86.0
0.079,6,10,1506,5,395,17.0,127.0,127.0,5,1111,15.0,843.0,843.0
0.01,6,10,1990,5,911,2.0,643.0,643.0,5,1079,2.0,811.0,811.0
40.067,17,10,676,5,460,10013.0,104.0,64.0,5,216,10015.0,20.0,15.0
0.004,6,10,2006,5,927,1.0,659.0,659.0,5,1079,1.0,811.0,811.0
0.189,17,4,352,2,130,149.0,37.0,37.0,2,222,145.0,89.0,83.0
0.005,6,10,2000,5,927,1.0,659.0,659.0,5,1073,1.0,805.0,805.0
0.048,6,10,1990,5,911,11.0,643.0,643.0,5,1079,11.0,811.0,811.0
0.167,17,2,152,1,76,0.0,48.0,48.0,1,76,0.0,48.0,48.0
0.073,6,10,1506,5,395,15.0,127.0,127.0,5,1111,16.0,843.0,843.0
0.006,6,10,1689,5,839,1.0,571.0,571.0,5,850,1.0,582.0,582.0
0.005,6,10,1689,5,839,1.0,571.0,571.0,5,850,1.0,582.0,582.0
240.268,6,27,13748,13,8668,20022.0,2736.0,1332.0,14,5080,18479.0,1656.0,1086.0
0.001,17,2,166,1,75,0.0,47.0,47.0,1,91,0.0,63.0,63.0
0.005,6,10,2006,5,927,1.0,659.0,659.0,5,1079,1.0,811.0,811.0
308.844,17,20,1124,10,716,34303.0,48.0,43.0,10,408,34301.0,20.0,12.0
0.013,6,14,3787,7,497,2.0,125.0,125.0,7,3290,2.0,1448.0,972.0
0.005,6,10,2006,5,927,1.0,659.0,659.0,5,1079,1.0,811.0,811.0
0.063,6,10,1506,5,395,14.0,127.0,127.0,5,1111,13.0,843.0,843.0
0.005,6,10,1779,5,928,1.0,660.0,660.0,5,851,1.0,583.0,583.0
0.005,6,10,2007,5,928,1.0,660.0,660.0,5,1079,1.0,811.0,811.0
0.01,6,10,1972,5,910,2.0,642.0,642.0,5,1062,2.0,794.0,794.0
0.119,6,10,1506,5,395,27.0,127.0,127.0,5,1111,25.0,843.0,843.0
0.038,17,2,182,1,65,0.0,37.0,37.0,1,117,0.0,89.0,89.0
0.128,17,2,80,1,32,0.0,4.0,4.0,1,48,0.0,20.0,20.0
0.005,17,2,164,1,74,0.0,46.0,46.0,1,90,0.0,62.0,62.0
0.072,17,2,184,1,61,0.0,33.0,33.0,1,123,0.0,95.0,95.0
0.17,17,2,152,1,76,0.0,48.0,48.0,1,76,0.0,48.0,48.0
0.001,17,2,179,1,62,0.0,34.0,34.0,1,117,0.0,89.0,89.0
40.052,17,10,676,5,460,10012.0,104.0,64.0,5,216,10012.0,20.0,15.0
0.006,6,10,1547,5,764,1.0,496.0,496.0,5,783,1.0,515.0,515.0
0.004,17,2,148,1,60,0.0,32.0,32.0,1,88,0.0,60.0,60.0
0.093,6,10,1506,5,395,20.0,127.0,127.0,5,1111,21.0,843.0,843.0
0.006,6,10,1547,5,764,1.0,496.0,496.0,5,783,1.0,515.0,515.0
0.006,6,10,1643,5,860,1.0,592.0,592.0,5,783,1.0,515.0,515.0
0.018,6,10,1631,5,848,4.0,580.0,580.0,5,783,4.0,515.0,515.0
0.006,6,10,1689,5,839,1.0,571.0,571.0,5,850,1.0,582.0,582.0
0.005,6,10,2006,5,927,1.0,659.0,659.0,5,1079,1.0,811.0,811.0
0.004,6,10,1702,5,863,0.0,595.0,595.0,5,839,1.0,571.0,571.0
0.073,6,10,1506,5,395,16.0,127.0,127.0,5,1111,16.0,843.0,843.0
0.012,6,10,1989,5,910,2.0,642.0,642.0,5,1079,3.0,811.0,811.0
0.095,6,10,1506,5,395,20.0,127.0,127.0,5,1111,19.0,843.0,843.0
0.078,6,10,1506,5,395,15.0,127.0,127.0,5,1111,18.0,843.0,843.0
361.827,6,19,1689,15,978,25844.0,190.0,190.0,4,711,80012.0,495.0,495.0
0.001,17,2,180,1,66,0.0,38.0,38.0,1,114,0.0,86.0,86.0
0.005,6,10,1989,5,927,1.0,659.0,659.0,5,1062,1.0,794.0,794.0
0.049,6,10,1983,5,910,12.0,642.0,642.0,5,1073,12.0,805.0,805.0
0.004,17,2,148,1,60,0.0,32.0,32.0,1,88,0.0,60.0,60.0
0.021,6,13,3735,7,497,3.0,125.0,125.0,6,3238,4.0,1470.0,1459.0
0.011,6,10,1972,5,910,2.0,642.0,642.0,5,1062,2.0,794.0,794.0
0.071,17,2,166,1,75,0.0,47.0,47.0,1,91,0.0,63.0,63.0
0.13,6,10,1506,5,395,30.0,127.0,127.0,5,1111,28.0,843.0,843.0
40.074,17,10,676,5,460,10015.0,104.0,64.0,5,216,10017.0,20.0,15.0
168.15,17,92,13326,46,3105,3736.0,44.0,39.0,46,10221,3736.0,239.0,194.0
0.013,6,10,1631,5,848,3.0,580.0,580.0,5,783,3.0,515.0,515.0
0.005,6,10,1689,5,839,1.0,571.0,571.0,5,850,1.0,582.0,582.0
0.005,6,10,1989,5,927,1.0,659.0,659.0,5,1062,1.0,794.0,794.0
300.398,6,17,2210,10,724,33358.0,146.0,146.0,7,1486,50037.0,419.0,398.0
0.004,6,14,3799,7,509,0.0,137.0,137.0,7,3290,0.0,1448.0,972.0
0.005,17,2,170,1,65,0.0,37.0,37.0,1,105,0.0,77.0,77.0
0.066,6,10,1506,5,395,15.0,127.0,127.0,5,1111,13.0,843.0,843.0
40.058,17,10,676,5,460,10013.0,104.0,64.0,5,216,10013.0,20.0,15.0
0.007,17,2,166,1,75,0.0,47.0,47.0,1,91,0.0,63.0,63.0
178.008,17,84,12082,42,2799,4341.0,44.0,38.0,42,9283,4341.0,239.0,193.0
15.134,17,18,13389,9,8280,1886.0,1350.0,892.0,9,5109,1888.0,1350.0,539.0
0.107,6,10,1506,5,395,25.0,127.0,127.0,5,1111,22.0,843.0,843.0
1687.909,17,14,1106,7,441,281317.0,35.0,35.0,7,665,281317.0,67.0,67.0
0.007,17,2,170,1,65,0.0,37.0,37.0,1,105,0.0,77.0,77.0
0.012,17,2,152,1,56,0.0,28.0,28.0,1,96,0.0,68.0,68.0
0.005,6,10,2006,5,927,1.0,659.0,659.0,5,1079,1.0,811.0,811.0
44.269,6,36,9771,18,4253,524.0,1498.0,875.0,18,5518,2594.0,2667.0,435.0
0.004,6,10,1702,5,863,1.0,595.0,595.0,5,839,1.0,571.0,571.0
0.006,6,10,1689,5,839,1.0,571.0,571.0,5,850,1.0,582.0,582.0
0.019,6,10,1631,5,848,4.0,580.0,580.0,5,783,4.0,515.0,515.0
0.001,17,2,164,1,74,0.0,46.0,46.0,1,90,0.0,62.0,62.0
0.008,6,10,1983,5,910,2.0,642.0,642.0,5,1073,2.0,805.0,805.0
0.005,6,10,1774,5,923,1.0,655.0,655.0,5,851,1.0,583.0,583.0
0.006,6,10,1547,5,764,1.0,496.0,496.0,5,783,1.0,515.0,515.0
0.009,6,10,1990,5,911,2.0,643.0,643.0,5,1079,2.0,811.0,811.0
0.005,17,2,214,1,75,0.0,47.0,47.0,1,139,0.0,111.0,111.0
0.014,6,10,1990,5,911,3.0,643.0,643.0,5,1079,3.0,811.0,811.0
177.089,17,74,10661,37,2468,4919.0,44.0,38.0,37,8193,4919.0,239.0,193.0
0.211,6,16,2669,8,1395,30.0,533.0,323.0,8,1274,19.0,529.0,212.0
0.02,6,10,1983,5,910,4.0,642.0,642.0,5,1073,4.0,805.0,805.0
0.005,6,10,1689,5,839,1.0,571.0,571.0,5,850,1.0,582.0,582.0
0.013,6,10,1983,5,910,3.0,642.0,642.0,5,1073,3.0,805.0,805.0
1730.388,6,49,2997,31,1800,57679.0,35.0,35.0,18,1197,101783.0,31.0,31.0
0.106,6,10,1506,5,395,24.0,127.0,127.0,5,1111,23.0,843.0,843.0
0.005,6,10,2000,5,927,1.0,659.0,659.0,5,1073,1.0,805.0,805.0
0.129,17,2,144,1,64,0.0,36.0,36.0,1,80,0.0,52.0,52.0
40.078,17,10,676,5,460,10016.0,104.0,64.0,5,216,10018.0,20.0,15.0
0.005,6,10,1702,5,863,1.0,595.0,595.0,5,839,1.0,571.0,571.0
0.037,17,2,412,1,61,0.0,33.0,33.0,1,351,0.0,323.0,323.0
240.011,6,9,787,5,488,60002.0,232.0,232.0,4,299,80002.0,83.0,83.0
0.005,6,14,3736,7,446,0.0,74.0,74.0,7,3290,0.0,1448.0,972.0
0.005,6,10,2007,5,928,1.0,660.0,660.0,5,1079,1.0,811.0,811.0
0.006,6,10,1854,5,889,1.0,621.0,621.0,5,965,1.0,697.0,697.0
0.093,6,10,1506,5,395,19.0,127.0,127.0,5,1111,20.0,843.0,843.0
367.367,6,22,2313,16,867,24491.0,195.0,195.0,6,1446,4635.0,419.0,398.0
0.087,6,10,1506,5,395,20.0,127.0,127.0,5,1111,18.0,843.0,843.0
0.001,17,2,180,1,66,0.0,38.0,38.0,1,114,0.0,86.0,86.0
0.1,6,10,1506,5,395,23.0,127.0,127.0,5,1111,21.0,843.0,843.0
465.119,6,37,8742,20,2779,24479.0,664.0,346.0,17,5963,25316.0,1402.0,461.0
890.153,6,92,39762,47,9169,19351.0,1173.0,558.0,45,30593,20230.0,2176.0,911.0
0.119,6,10,1506,5,395,22.0,127.0,127.0,5,1111,25.0,843.0,843.0
0.02,17,2,198,1,91,0.0,63.0,63.0,1,107,0.0,79.0,79.0
0.013,6,10,1990,5,911,3.0,643.0,643.0,5,1079,3.0,811.0,811.0
0.004,17,2,148,1,60,0.0,32.0,32.0,1,88,0.0,60.0,60.0
40.066,17,10,676,5,460,10015.0,104.0,64.0,5,216,10015.0,20.0,15.0
0.013,6,10,1983,5,910,3.0,642.0,642.0,5,1073,3.0,805.0,805.0
0.076,6,10,1506,5,395,16.0,127.0,127.0,5,1111,15.0,843.0,843.0
0.005,6,14,3799,7,509,0.0,137.0,137.0,7,3290,0.0,1448.0,972.0
0.081,6,10,1506,5,395,18.0,127.0,127.0,5,1111,15.0,843.0,843.0
0.001,17,2,180,1,66,0.0,38.0,38.0,1,114,0.0,86.0,86.0
0.093,6,10,1506,5,395,16.0,127.0,127.0,5,1111,20.0,843.0,843.0
0.006,17,2,136,1,60,0.0,32.0,32.0,1,76,0.0,48.0,48.0
0.017,6,10,1972,5,910,4.0,642.0,642.0,5,1062,4.0,794.0,794.0
0.013,6,10,1972,5,910,3.0,642.0,642.0,5,1062,3.0,794.0,794.0
0.009,6,12,1926,6,1189,1.0,659.0,434.0,6,737,1.0,417.0,417.0
0.005,6,10,1989,5,927,1.0,659.0,659.0,5,1062,1.0,794.0,794.0
0.058,6,10,1762,5,911,14.0,643.0,643.0,5,851,14.0,583.0,583.0
0.081,6,10,1506,5,395,19.0,127.0,127.0,5,1111,16.0,843.0,843.0
0.011,6,13,3735,7,497,1.0,125.0,125.0,6,3238,2.0,1470.0,1459.0
0.087,6,10,1506,5,395,18.0,127.0,127.0,5,1111,18.0,843.0,843.0
0.013,6,10,1989,5,910,3.0,642.0,642.0,5,1079,3.0,811.0,811.0
0.006,6,10,1547,5,764,1.0,496.0,496.0,5,783,1.0,515.0,515.0
0.013,17,2,152,1,56,0.0,28.0,28.0,1,96,0.0,68.0,68.0
40.06,17,10,676,5,460,10014.0,104.0,64.0,5,216,10014.0,20.0,15.0
0.006,6,10,1547,5,764,1.0,496.0,496.0,5,783,1.0,515.0,515.0
0.012,6,10,1762,5,911,3.0,643.0,643.0,5,851,3.0,583.0,583.0
0.007,6,10,1547,5,764,1.0,496.0,496.0,5,783,1.0,515.0,515.0
0.009,6,10,1989,5,910,2.0,642.0,642.0,5,1079,2.0,811.0,811.0
361.844,6,21,1793,16,1030,24122.0,190.0,190.0,5,763,60010.0,462.0,247.0
0.113,6,10,1506,5,395,23.0,127.0,127.0,5,1111,25.0,843.0,843.0
0.004,17,2,175,1,65,0.0,37.0,37.0,1,110,0.0,82.0,82.0
0.004,17,2,164,1,74,0.0,46.0,46.0,1,90,0.0,62.0,62.0
0.006,6,10,1547,5,764,1.0,496.0,496.0,5,783,1.0,515.0,515.0
0.089,6,10,1506,5,395,18.0,127.0,127.0,5,1111,19.0,843.0,843.0
0.008,6,10,1989,5,910,2.0,642.0,642.0,5,1079,2.0,811.0,811.0
0.068,6,10,1506,5,395,14.0,127.0,127.0,5,1111,14.0,843.0,843.0
0.004,6,10,1779,5,928,1.0,660.0,660.0,5,851,1.0,583.0,583.0
0.003,17,2,136,1,60,0.0,32.0,32.0,1,76,0.0,48.0,48.0
0.007,6,10,1547,5,764,1.0,496.0,496.0,5,783,1.0,515.0,515.0
0.015,6,10,1990,5,911,3.0,643.0,643.0,5,1079,3.0,811.0,811.0
0.07,17,8,3613,4,1874,23.0,1350.0,440.0,4,1739,12.0,1350.0,406.0
0.072,6,10,1506,5,395,15.0,127.0,127.0,5,1111,12.0,843.0,843.0
15.079,17,15,8126,8,6015,2150.0,1350.0,723.0,7,2111,2508.0,1350.0,273.0
0.038,17,2,136,1,60,0.0,32.0,32.0,1,76,0.0,48.0,48.0
15.139,17,20,13503,10,8344,1678.0,1350.0,806.0,10,5159,1678.0,1350.0,487.0
0.079,6,10,1506,5,395,17.0,127.0,127.0,5,1111,16.0,843.0,843.0
0.005,6,10,1547,5,764,1.0,496.0,496.0,5,783,1.0,515.0,515.0
0.017,6,10,1990,5,911,4.0,643.0,643.0,5,1079,4.0,811.0,811.0
0.006,6,10,1854,5,889,1.0,621.0,621.0,5,965,1.0,697.0,697.0
0.087,6,10,1506,5,395,17.0,127.0,127.0,5,1111,20.0,843.0,843.0
0.006,6,14,3799,7,509,0.0,137.0,137.0,7,3290,0.0,1448.0,972.0
0.008,6,12,1926,6,1189,1.0,659.0,434.0,6,737,1.0,417.0,417.0
0.173,6,10,1506,5,395,36.0,127.0,127.0,5,1111,34.0,843.0,843.0
0.006,17,2,222,1,65,0.0,37.0,37.0,1,157,0.0,129.0,129.0
0.001,17,2,180,1,66,0.0,38.0,38.0,1,114,0.0,86.0,86.0
0.257,6,10,1506,5,395,61.0,127.0,127.0,5,1111,36.0,843.0,843.0
0.006,6,10,2006,5,927,1.0,659.0,659.0,5,1079,1.0,811.0,811.0
240.024,6,9,787,5,488,60006.0,232.0,232.0,4,299,80007.0,83.0,83.0
0.005,6,10,1854,5,889,1.0,621.0,621.0,5,965,1.0,697.0,697.0
300.238,6,17,2210,10,724,33341.0,146.0,146.0,7,1486,50012.0,419.0,398.0
0.003,17,2,136,1,60,0.0,32.0,32.0,1,76,0.0,48.0,48.0
0.079,6,10,1506,5,395,17.0,127.0,127.0,5,1111,18.0,843.0,843.0
0.006,6,10,1689,5,839,1.0,571.0,571.0,5,850,1.0,582.0,582.0
0.009,6,12,1926,6,1189,1.0,659.0,434.0,6,737,1.0,417.0,417.0
0.002,17,2,136,1,60,0.0,32.0,32.0,1,76,0.0,48.0,48.0
0.006,6,10,2007,5,928,1.0,660.0,660.0,5,1079,1.0,811.0,811.0
0.012,6,10,1983,5,910,3.0,642.0,642.0,5,1073,3.0,805.0,805.0
10.857,17,28,4422,14,1994,826.0,269.0,114.0,14,2428,826.0,587.0,145.0
0.001,17,2,180,1,66,0.0,38.0,38.0,1,114,0.0,86.0,86.0
0.009,6,10,1989,5,910,2.0,642.0,642.0,5,1079,2.0,811.0,811.0
300.391,6,27,8925,15,1930,21456.0,517.0,285.0,12,6995,21852.0,1402.0,909.0
0.006,17,2,169,1,62,0.0,34.0,34.0,1,107,0.0,79.0,79.0
0.006,6,10,1689,5,839,1.0,571.0,571.0,5,850,1.0,582.0,582.0
0.004,6,10,1989,5,927,1.0,659.0,659.0,5,1062,1.0,794.0,794.0
9.037,17,6,376,5,280,2259.0,28.0,28.0,1,96,0.0,68.0,68.0
0.004,17,2,136,1,60,0.0,32.0,32.0,1,76,0.0,48.0,48.0
293.859,6,413,348470,215,22754,1373.0,2736.0,771.0,198,325716,1491.0,4127.0,1714.0
0.004,6,10,2006,5,927,1.0,659.0,659.0,5,1079,1.0,811.0,811.0
0.006,6,10,2007,5,928,1.0,660.0,660.0,5,1079,1.0,811.0,811.0
0.069,6,10,1506,5,395,14.0,127.0,127.0,5,1111,15.0,843.0,843.0
0.007,6,10,1983,5,910,1.0,642.0,642.0,5,1073,1.0,805.0,805.0
0.005,6,10,2006,5,927,1.0,659.0,659.0,5,1079,1.0,811.0,811.0
0.005,17,2,194,1,59,0.0,31.0,31.0,1,135,0.0,107.0,107.0
0.005,6,10,1774,5,923,1.0,655.0,655.0,5,851,1.0,583.0,583.0
0.001,17,2,166,1,75,0.0,47.0,47.0,1,91,0.0,63.0,63.0
0.008,6,10,1989,5,910,2.0,642.0,642.0,5,1079,2.0,811.0,811.0
0.001,17,2,180,1,66,0.0,38.0,38.0,1,114,0.0,86.0,86.0
0.015,6,10,1972,5,910,3.0,642.0,642.0,5,1062,3.0,794.0,794.0
0.008,6,11,2035,6,962,1.0,642.0,642.0,5,1073,2.0,805.0,805.0
0.012,6,10,1972,5,910,2.0,642.0,642.0,5,1062,3.0,794.0,794.0
0.013,6,10,1983,5,910,3.0,642.0,642.0,5,1073,3.0,805.0,805.0
0.004,17,2,136,1,60,0.0,32.0,32.0,1,76,0.0,48.0,48.0
0.007,6,10,2007,5,928,1.0,660.0,660.0,5,1079,1.0,811.0,811.0
300.394,6,16,2170,9,684,37529.0,146.0,146.0,7,1486,50038.0,419.0,398.0
0.006,6,10,1547,5,764,1.0,496.0,496.0,5,783,1.0,515.0,515.0
0.085,6,10,1506,5,395,19.0,127.0,127.0,5,1111,18.0,843.0,843.0
240.039,6,9,787,5,488,60009.0,232.0,232.0,4,299,80012.0,83.0,83.0
0.007,17,2,179,1,71,0.0,43.0,43.0,1,108,0.0,80.0,80.0
0.001,17,2,180,1,66,0.0,38.0,38.0,1,114,0.0,86.0,86.0
0.001,17,2,166,1,75,0.0,47.0,47.0,1,91,0.0,63.0,63.0
0.011,6,10,1989,5,910,2.0,642.0,642.0,5,1079,2.0,811.0,811.0
0.081,6,10,1506,5,395,17.0,127.0,127.0,5,1111,18.0,843.0,843.0
0.001,17,2,180,1,66,0.0,38.0,38.0,1,114,0.0,86.0,86.0
240.155,6,39,5315,19,2369,13341.0,581.0,196.0,20,2946,12639.0,566.0,237.0
0.004,6,10,2007,5,928,1.0,660.0,660.0,5,1079,1.0,811.0,811.0
40.056,17,10,676,5,460,10011.0,104.0,64.0,5,216,10013.0,20.0,15.0
0.012,6,10,1989,5,910,3.0,642.0,642.0,5,1079,2.0,811.0,811.0
0.004,6,10,1702,5,863,1.0,595.0,595.0,5,839,0.0,571.0,571.0
0.099,6,10,1506,5,395,20.0,127.0,127.0,5,1111,24.0,843.0,843.0
0.005,17,2,164,1,74,0.0,46.0,46.0,1,90,0.0,62.0,62.0
0.022,6,10,1989,5,910,5.0,642.0,642.0,5,1079,5.0,811.0,811.0
0.072,6,10,1506,5,395,15.0,127.0,127.0,5,1111,14.0,843.0,843.0
0.005,6,10,1774,5,923,1.0,655.0,655.0,5,851,1.0,583.0,583.0
1727.866,6,45,2790,30,1725,59581.0,35.0,35.0,15,1065,123413.0,31.0,31.0
0.005,6,15,3794,8,504,0.0,80.0,80.0,7,3290,0.0,1448.0,972.0
0.007,6,10,1689,5,839,1.0,571.0,571.0,5,850,1.0,582.0,582.0
0.014,6,10,1989,5,910,3.0,642.0,642.0,5,1079,3.0,811.0,811.0
0.23,6,16,2778,8,1396,32.0,533.0,324.0,8,1382,20.0,529.0,239.0
1777.601,17,144,45504,72,22752,25036.0,288.0,288.0,72,22752,25036.0,288.0,288.0
0.004,17,2,136,1,60,0.0,32.0,32.0,1,76,0.0,48.0,48.0
0.083,6,10,1506,5,395,19.0,127.0,127.0,5,1111,17.0,843.0,843.0
0.004,6,10,1702,5,863,1.0,595.0,595.0,5,839,1.0,571.0,571.0
0.011,6,10,1762,5,911,2.0,643.0,643.0,5,851,2.0,583.0,583.0
301.389,6,63,33187,35,27040,8864.0,2720.0,1347.0,28,6147,341.0,1360.0,358.0
0.14,6,10,1506,5,395,32.0,127.0,127.0,5,1111,31.0,843.0,843.0
300.318,6,16,2170,9,684,37517.0,146.0,146.0,7,1486,50024.0,419.0,398.0
0.004,6,10,1989,5,927,1.0,659.0,659.0,5,1062,1.0,794.0,794.0
0.001,17,2,136,1,60,0.0,32.0,32.0,1,76,0.0,48.0,48.0
0.005,6,10,1547,5,764,1.0,496.0,496.0,5,783,1.0,515.0,515.0
0.009,6,10,1972,5,910,2.0,642.0,642.0,5,1062,2.0,794.0,794.0
66.352,6,22,10140,12,3973,6032.0,1579.0,835.0,10,6167,7354.0,2225.0,939.0
40.05,17,10,676,5,460,10011.0,104.0,64.0,5,216,10011.0,20.0,15.0
40.066,17,10,676,5,460,10013.0,104.0,64.0,5,216,10015.0,20.0,15.0
0.008,6,12,1926,6,1189,1.0,659.0,434.0,6,737,1.0,417.0,417.0
313.588,17,18,1008,9,640,39182.0,48.0,43.0,9,368,39182.0,20.0,12.0
0.001,17,2,180,1,66,0.0,38.0,38.0,1,114,0.0,86.0,86.0
0.018,6,13,3747,7,509,2.0,137.0,137.0,6,3238,3.0,1470.0,1459.0
0.005,17,2,213,1,69,0.0,41.0,41.0,1,144,0.0,116.0,116.0
0.006,17,2,144,1,64,0.0,36.0,36.0,1,80,0.0,52.0,52.0
0.009,6,10,1972,5,910,2.0,642.0,642.0,5,1062,2.0,794.0,794.0
0.005,6,10,2000,5,927,1.0,659.0,659.0,5,1073,1.0,805.0,805.0
0.005,6,13,3747,7,509,0.0,137.0,137.0,6,3238,1.0,1470.0,1459.0
333.949,17,20,1124,10,716,37091.0,48.0,43.0,10,408,37091.0,20.0,12.0
0.104,17,2,144,1,64,0.0,36.0,36.0,1,80,0.0,52.0,52.0
0.004,6,10,2007,5,928,1.0,660.0,660.0,5,1079,1.0,811.0,811.0
0.005,6,10,2006,5,927,1.0,659.0,659.0,5,1079,1.0,811.0,811.0
0.001,17,2,180,1,65,0.0,37.0,37.0,1,115,0.0,87.0,87.0
0.004,17,4,284,2,120,0.0,32.0,32.0,2,164,0.0,60.0,54.0
0.017,6,10,1972,5,910,4.0,642.0,642.0,5,1062,4.0,794.0,794.0
0.003,17,2,148,1,60,0.0,32.0,32.0,1,88,0.0,60.0,60.0
0.005,6,10,2006,5,927,1.0,659.0,659.0,5,1079,1.0,811.0,811.0
0.006,6,10,1547,5,764,1.0,496.0,496.0,5,783,1.0,515.0,515.0
0.016,6,10,1631,5,848,4.0,580.0,580.0,5,783,3.0,515.0,515.0
0.004,6,10,2006,5,927,1.0,659.0,659.0,5,1079,1.0,811.0,811.0
0.005,6,10,2006,5,927,1.0,659.0,659.0,5,1079,1.0,811.0,811.0
40.068,17,10,676,5,460,10014.0,104.0,64.0,5,216,10015.0,20.0,15.0
1771.742,6,303,97470,187,86389,9525.0,2001.0,678.0,116,11081,15406.0,452.0,70.0
0.004,6,10,1989,5,927,1.0,659.0,659.0,5,1062,1.0,794.0,794.0
0.007,17,2,179,1,71,0.0,43.0,43.0,1,108,0.0,80.0,80.0
5.123,6,23,6467,13,1827,426.0,801.0,282.0,10,4640,568.0,1925.0,824.0
0.004,6,10,2006,5,927,1.0,659.0,659.0,5,1079,1.0,811.0,811.0
0.005,6,10,1989,5,927,1.0,659.0,659.0,5,1062,1.0,794.0,794.0
1756.142,6,105,6270,60,3525,29764.0,27.0,27.0,45,2745,39911.0,27.0,27.0
0.007,6,10,2006,5,927,1.0,659.0,659.0,5,1079,1.0,811.0,811.0
0.073,17,2,156,1,64,0.0,36.0,36.0,1,92,0.0,64.0,64.0
0.006,6,10,1989,5,927,1.0,659.0,659.0,5,1062,1.0,794.0,794.0
0.005,6,10,1989,5,927,1.0,659.0,659.0,5,1062,1.0,794.0,794.0
0.07,17,8,3613,4,1874,23.0,1350.0,440.0,4,1739,12.0,1350.0,406.0
0.005,6,10,1643,5,860,1.0,592.0,592.0,5,783,1.0,515.0,515.0
0.012,6,10,1972,5,910,3.0,642.0,642.0,5,1062,2.0,794.0,794.0
0.007,6,10,1762,5,911,1.0,643.0,643.0,5,851,1.0,583.0,583.0
0.006,6,10,1547,5,764,1.0,496.0,496.0,5,783,1.0,515.0,515.0
0.005,6,10,2007,5,928,1.0,660.0,660.0,5,1079,1.0,811.0,811.0
0.004,6,10,1702,5,863,1.0,595.0,595.0,5,839,1.0,571.0,571.0
40.069,17,10,676,5,460,10015.0,104.0,64.0,5,216,10016.0,20.0,15.0
309.99,17,20,1124,10,716,34433.0,48.0,43.0,10,408,34433.0,20.0,12.0
314.229,17,18,1008,9,640,39271.0,48.0,43.0,9,368,39271.0,20.0,12.0
0.003,17,2,148,1,60,0.0,32.0,32.0,1,88,0.0,60.0,60.0
0.004,6,10,2006,5,927,1.0,659.0,659.0,5,1079,1.0,811.0,811.0
0.075,6,10,1506,5,395,17.0,127.0,127.0,5,1111,16.0,843.0,843.0
0.005,17,2,170,1,65,0.0,37.0,37.0,1,105,0.0,77.0,77.0
0.014,6,10,1972,5,910,3.0,642.0,642.0,5,1062,3.0,794.0,794.0
178.406,17,70,10171,35,2334,5243.0,44.0,38.0,35,7837,5247.0,261.0,195.0
0.008,6,12,1926,6,1189,1.0,659.0,434.0,6,737,1.0,417.0,417.0
0.113,6,10,1506,5,395,25.0,127.0,127.0,5,1111,19.0,843.0,843.0
0.004,6,10,2006,5,927,1.0,659.0,659.0,5,1079,1.0,811.0,811.0
0.006,6,14,3799,7,509,1.0,137.0,137.0,7,3290,0.0,1448.0,972.0
0.097,6,10,1506,5,395,23.0,127.0,127.0,5,1111,20.0,843.0,843.0
240.368,6,36,10357,17,7632,15023.0,2051.0,674.0,19,2725,13353.0,580.0,190.0
0.123,6,10,1506,5,395,28.0,127.0,127.0,5,1111,23.0,843.0,843.0
0.01,6,10,1983,5,910,2.0,642.0,642.0,5,1073,2.0,805.0,805.0
0.116,6,10,1506,5,395,24.0,127.0,127.0,5,1111,25.0,843.0,843.0
0.009,6,10,2006,5,927,2.0,659.0,659.0,5,1079,2.0,811.0,811.0
0.095,6,10,1506,5,395,20.0,127.0,127.0,5,1111,19.0,843.0,843.0
10.8,17,28,4423,14,1994,822.0,269.0,114.0,14,2429,822.0,588.0,145.0
240.015,6,9,787,5,488,60003.0,232.0,232.0,4,299,80004.0,83.0,83.0
0.011,6,10,1990,5,911,2.0,643.0,643.0,5,1079,2.0,811.0,811.0
0.023,6,10,1677,5,827,5.0,559.0,559.0,5,850,5.0,582.0,582.0
0.102,6,10,1506,5,395,22.0,127.0,127.0,5,1111,23.0,843.0,843.0
0.005,17,4,284,2,120,2.0,32.0,32.0,2,164,2.0,60.0,54.0
40.088,17,10,676,5,460,10018.0,104.0,64.0,5,216,10021.0,20.0,15.0
0.005,6,10,2007,5,928,1.0,660.0,660.0,5,1079,1.0,811.0,811.0
15.075,17,15,9238,8,6902,2149.0,1350.0,834.0,7,2336,2507.0,1350.0,305.0
0.001,17,2,180,1,66,0.0,38.0,38.0,1,114,0.0,86.0,86.0
0.005,6,10,2006,5,927,1.0,659.0,659.0,5,1079,1.0,811.0,811.0
0.004,6,10,2006,5,927,1.0,659.0,659.0,5,1079,1.0,811.0,811.0
0.027,17,2,230,1,68,0.0,40.0,40.0,1,162,0.0,134.0,134.0
40.059,17,10,676,5,460,10013.0,104.0,64.0,5,216,10014.0,20.0,15.0
0.006,6,10,1854,5,889,1.0,621.0,621.0,5,965,1.0,697.0,697.0
0.067,6,10,1506,5,395,14.0,127.0,127.0,5,1111,15.0,843.0,843.0
0.005,6,10,2006,5,927,1.0,659.0,659.0,5,1079,1.0,811.0,811.0
0.066,6,10,1506,5,395,13.0,127.0,127.0,5,1111,15.0,843.0,843.0
0.088,6,10,1506,5,395,19.0,127.0,127.0,5,1111,17.0,843.0,843.0
0.01,6,10,1989,5,910,2.0,642.0,642.0,5,1079,2.0,811.0,811.0
0.001,17,2,166,1,75,0.0,47.0,47.0,1,91,0.0,63.0,63.0
0.005,6,10,2006,5,927,1.0,659.0,659.0,5,1079,1.0,811.0,811.0
0.005,17,2,225,1,65,0.0,37.0,37.0,1,160,0.0,132.0,132.0
361.819,6,21,1792,16,1030,24121.0,190.0,190.0,5,762,60010.0,461.0,247.0
0.111,6,10,1506,5,395,26.0,127.0,127.0,5,1111,23.0,843.0,843.0
0.009,6,10,1677,5,827,2.0,559.0,559.0,5,850,2.0,582.0,582.0
0.005,17,2,166,1,75,0.0,47.0,47.0,1,91,0.0,63.0,63.0
0.001,17,2,180,1,66,0.0,38.0,38.0,1,114,0.0,86.0,86.0
0.083,6,10,1506,5,395,18.0,127.0,127.0,5,1111,18.0,843.0,843.0
0.009,6,10,1989,5,910,2.0,642.0,642.0,5,1079,2.0,811.0,811.0
40.081,17,10,676,5,460,10019.0,104.0,64.0,5,216,10019.0,20.0,15.0
0.005,17,2,213,1,69,0.0,41.0,41.0,1,144,0.0,116.0,116.0
0.018,6,10,1972,5,910,4.0,642.0,642.0,5,1062,4.0,794.0,794.0
0.005,6,10,1779,5,928,1.0,660.0,660.0,5,851,1.0,583.0,583.0
0.005,17,2,164,1,74,0.0,46.0,46.0,1,90,0.0,62.0,62.0
0.012,6,10,1983,5,910,3.0,642.0,642.0,5,1073,3.0,805.0,805.0
0.004,6,10,2006,5,927,1.0,659.0,659.0,5,1079,1.0,811.0,811.0
0.009,6,10,1989,5,910,2.0,642.0,642.0,5,1079,2.0,811.0,811.0
0.006,6,10,1689,5,839,1.0,571.0,571.0,5,850,1.0,582.0,582.0
0.001,17,2,180,1,66,0.0,38.0,38.0,1,114,0.0,86.0,86.0
240.017,6,9,787,5,488,60004.0,232.0,232.0,4,299,80004.0,83.0,83.0
0.089,6,10,1506,5,395,17.0,127.0,127.0,5,1111,17.0,843.0,843.0
0.01,6,13,3735,7,497,1.0,125.0,125.0,6,3238,1.0,1470.0,1459.0
0.004,17,4,284,2,120,0.0,32.0,32.0,2,164,0.0,60.0,54.0
0.005,6,10,2006,5,927,1.0,659.0,659.0,5,1079,1.0,811.0,811.0
0.013,6,10,1972,5,910,3.0,642.0,642.0,5,1062,3.0,794.0,794.0
0.234,6,16,2669,8,1395,33.0,533.0,323.0,8,1274,22.0,529.0,212.0
0.006,6,10,1854,5,889,1.0,621.0,621.0,5,965,1.0,697.0,697.0
16.296,17,26,17565,11,4348,1626.0,1350.0,367.0,15,13217,1161.0,1350.0,853.0
0.082,6,10,1506,5,395,18.0,127.0,127.0,5,1111,17.0,843.0,843.0
0.001,17,2,180,1,66,0.0,38.0,38.0,1,114,0.0,86.0,86.0
0.006,6,10,1547,5,764,1.0,496.0,496.0,5,783,1.0,515.0,515.0
0.007,6,12,1698,6,863,1.0,327.0,271.0,6,835,1.0,515.0,515.0
0.004,17,2,148,1,60,0.0,32.0,32.0,1,88,0.0,60.0,60.0
0.025,6,14,3868,7,578,4.0,206.0,206.0,7,3290,4.0,1448.0,972.0
0.005,6,10,1989,5,927,1.0,659.0,659.0,5,1062,1.0,794.0,794.0
0.003,17,2,148,1,60,0.0,32.0,32.0,1,88,0.0,60.0,60.0
0.003,17,2,148,1,60,0.0,32.0,32.0,1,88,0.0,60.0,60.0
0.013,17,2,152,1,56,0.0,28.0,28.0,1,96,0.0,68.0,68.0
0.085,6,10,1506,5,395,17.0,127.0,127.0,5,1111,18.0,843.0,843.0
0.005,17,2,213,1,69,0.0,41.0,41.0,1,144,0.0,116.0,116.0
0.004,6,10,2000,5,927,1.0,659.0,659.0,5,1073,1.0,805.0,805.0
0.102,6,10,1506,5,395,21.0,127.0,127.0,5,1111,24.0,843.0,843.0
308.805,17,18,1008,9,640,38584.0,48.0,43.0,9,368,38584.0,20.0,12.0
0.005,6,10,1989,5,927,1.0,659.0,659.0,5,1062,1.0,794.0,794.0
240.092,6,16,4481,9,963,30011.0,238.0,166.0,7,3518,40015.0,1402.0,786.0
30.123,6,175,182745,86,5505,354.0,517.0,252.0,89,177240,342.0,2804.0,2007.0
0.013,6,10,1762,5,911,3.0,643.0,643.0,5,851,3.0,583.0,583.0
0.003,17,2,148,1,60,0.0,32.0,32.0,1,88,0.0,60.0,60.0
0.005,17,2,144,1,64,0.0,36.0,36.0,1,80,0.0,52.0,52.0
40.063,17,10,676,5,460,10014.0,104.0,64.0,5,216,10015.0,20.0,15.0
0.051,6,13,3735,7,497,8.0,125.0,125.0,6,3238,10.0,1470.0,1459.0
0.094,6,10,1506,5,395,20.0,127.0,127.0,5,1111,20.0,843.0,843.0
40.058,17,10,676,5,460,10013.0,104.0,64.0,5,216,10013.0,20.0,15.0
0.013,6,10,1972,5,910,3.0,642.0,642.0,5,1062,3.0,794.0,794.0
0.005,6,10,2006,5,927,1.0,659.0,659.0,5,1079,1.0,811.0,811.0
0.004,17,2,148,1,60,0.0,32.0,32.0,1,88,0.0,60.0,60.0
0.009,6,10,1990,5,911,2.0,643.0,643.0,5,1079,2.0,811.0,811.0
0.005,6,10,1547,5,764,1.0,496.0,496.0,5,783,1.0,515.0,515.0
0.17,6,10,1506,5,395,37.0,127.0,127.0,5,1111,36.0,843.0,843.0
0.009,6,10,1990,5,911,2.0,643.0,643.0,5,1079,2.0,811.0,811.0
0.005,6,10,2007,5,928,1.0,660.0,660.0,5,1079,1.0,811.0,811.0
0.003,17,2,136,1,60,0.0,32.0,32.0,1,76,0.0,48.0,48.0
240.208,6,27,4628,13,1880,20017.0,517.0,239.0,14,2748,18477.0,1214.0,253.0
0.096,6,10,1506,5,395,22.0,127.0,127.0,5,1111,21.0,843.0,843.0
0.01,6,10,1989,5,910,2.0,642.0,642.0,5,1079,2.0,811.0,811.0
0.005,17,2,169,1,62,0.0,34.0,34.0,1,107,0.0,79.0,79.0
0.005,6,10,2007,5,928,1.0,660.0,660.0,5,1079,1.0,811.0,811.0
0.018,6,10,1972,5,910,4.0,642.0,642.0,5,1062,4.0,794.0,794.0
0.009,6,10,1989,5,910,2.0,642.0,642.0,5,1079,2.0,811.0,811.0
0.082,6,10,1506,5,395,20.0,127.0,127.0,5,1111,17.0,843.0,843.0
0.006,17,2,164,1,74,0.0,46.0,46.0,1,90,0.0,62.0,62.0
0.007,6,10,1547,5,764,1.0,496.0,496.0,5,783,1.0,515.0,515.0
0.014,6,10,1972,5,910,3.0,642.0,642.0,5,1062,3.0,794.0,794.0
0.007,6,10,1854,5,889,1.0,621.0,621.0,5,965,1.0,697.0,697.0
0.14,6,10,1506,5,395,29.0,127.0,127.0,5,1111,31.0,843.0,843.0
1.22,6,32,13391,18,5892,71.0,2720.0,854.0,14,7499,78.0,2720.0,769.0
0.01,17,4,284,2,120,0.0,32.0,32.0,2,164,0.0,60.0,54.0
0.005,6,10,1774,5,923,1.0,655.0,655.0,5,851,1.0,583.0,583.0
0.006,6,10,1689,5,839,1.0,571.0,571.0,5,850,1.0,582.0,582.0
0.006,6,10,1689,5,839,1.0,571.0,571.0,5,850,1.0,582.0,582.0
0.005,6,10,1547,5,764,1.0,496.0,496.0,5,783,1.0,515.0,515.0
240.156,6,45,6847,22,3224,11435.0,588.0,230.0,23,3623,10916.0,580.0,241.0
270.372,6,72,32737,31,4773,9012.0,944.0,286.0,41,27964,6759.0,1592.0,890.0
0.097,6,10,1506,5,395,21.0,127.0,127.0,5,1111,21.0,843.0,843.0
40.106,17,10,676,5,460,10016.0,104.0,64.0,5,216,10025.0,20.0,15.0
0.086,6,10,1506,5,395,20.0,127.0,127.0,5,1111,19.0,843.0,843.0
0.001,17,2,180,1,66,0.0,38.0,38.0,1,114,0.0,86.0,86.0
0.005,6,10,2000,5,927,1.0,659.0,659.0,5,1073,1.0,805.0,805.0
0.004,6,10,1779,5,928,1.0,660.0,660.0,5,851,1.0,583.0,583.0
0.094,6,10,1506,5,395,22.0,127.0,127.0,5,1111,18.0,843.0,843.0
0.008,6,10,1989,5,910,2.0,642.0,642.0,5,1079,2.0,811.0,811.0
0.016,6,10,1677,5,827,3.0,559.0,559.0,5,850,4.0,582.0,582.0
0.011,6,10,1972,5,910,2.0,642.0,642.0,5,1062,2.0,794.0,794.0
40.162,17,10,676,5,460,10039.0,104.0,64.0,5,216,10039.0,20.0,15.0
0.104,6,10,1506,5,395,25.0,127.0,127.0,5,1111,24.0,843.0,843.0
0.102,6,10,1506,5,395,22.0,127.0,127.0,5,1111,22.0,843.0,843.0
0.007,6,10,1989,5,910,1.0,642.0,642.0,5,1079,1.0,811.0,811.0
0.02,17,2,222,1,65,0.0,37.0,37.0,1,157,0.0,129.0,129.0
0.082,6,10,1506,5,395,16.0,127.0,127.0,5,1111,18.0,843.0,843.0
0.019,6,10,1972,5,910,4.0,642.0,642.0,5,1062,4.0,794.0,794.0
0.011,6,10,1989,5,910,2.0,642.0,642.0,5,1079,2.0,811.0,811.0
1756.38,6,105,6270,60,3525,29768.0,27.0,27.0,45,2745,39916.0,27.0,27.0
40.046,17,10,676,5,460,10010.0,104.0,64.0,5,216,10010.0,20.0,15.0
0.041,17,4,352,2,130,0.0,37.0,37.0,2,222,0.0,89.0,83.0
0.001,17,2,136,1,60,0.0,32.0,32.0,1,76,0.0,48.0,48.0
0.075,17,4,284,2,120,0.0,32.0,32.0,2,164,36.0,60.0,54.0
0.004,6,10,2007,5,928,1.0,660.0,660.0,5,1079,1.0,811.0,811.0
0.011,6,10,1677,5,827,2.0,559.0,559.0,5,850,2.0,582.0,582.0
0.066,6,10,1506,5,395,15.0,127.0,127.0,5,1111,13.0,843.0,843.0
0.007,6,10,1990,5,911,1.0,643.0,643.0,5,1079,1.0,811.0,811.0
0.014,6,10,1677,5,827,3.0,559.0,559.0,5,850,3.0,582.0,582.0
0.221,6,16,2669,8,1395,31.0,533.0,323.0,8,1274,20.0,529.0,212.0
40.056,17,10,676,5,460,10013.0,104.0,64.0,5,216,10013.0,20.0,15.0
0.001,17,2,166,1,75,0.0,47.0,47.0,1,91,0.0,63.0,63.0
0.091,6,10,1506,5,395,18.0,127.0,127.0,5,1111,20.0,843.0,843.0
0.01,6,10,1762,5,911,2.0,643.0,643.0,5,851,2.0,583.0,583.0
0.008,6,10,1983,5,910,2.0,642.0,642.0,5,1073,1.0,805.0,805.0
0.007,17,2,179,1,71,0.0,43.0,43.0,1,108,0.0,80.0,80.0
0.001,17,2,136,1,60,0.0,32.0,32.0,1,76,0.0,48.0,48.0
0.005,6,10,2006,5,927,1.0,659.0,659.0,5,1079,1.0,811.0,811.0
354.039,6,21,1795,16,1030,23602.0,190.0,190.0,5,765,60001.0,464.0,248.0
0.001,17,2,166,1,75,0.0,47.0,47.0,1,91,0.0,63.0,63.0
0.005,6,10,2006,5,927,1.0,659.0,659.0,5,1079,1.0,811.0,811.0
0.005,6,10,2000,5,927,1.0,659.0,659.0,5,1073,1.0,805.0,805.0
11.156,17,28,4422,14,1994,845.0,269.0,114.0,14,2428,845.0,587.0,145.0
0.075,6,10,1506,5,395,17.0,127.0,127.0,5,1111,15.0,843.0,843.0
240.094,6,32,9097,16,6662,16006.0,1735.0,648.0,16,2435,16006.0,580.0,199.0
0.008,6,10,1990,5,911,2.0,643.0,643.0,5,1079,1.0,811.0,811.0
0.005,6,10,2006,5,927,1.0,659.0,659.0,5,1079,1.0,811.0,811.0
0.013,6,10,1972,5,910,3.0,642.0,642.0,5,1062,3.0,794.0,794.0
0.003,17,2,187,1,74,0.0,46.0,46.0,1,113,0.0,85.0,85.0
0.015,6,10,1762,5,911,3.0,643.0,643.0,5,851,3.0,583.0,583.0
5.163,58,2,144,1,72,0.0,24.0,24.0,1,72,0.0,24.0,24.0
10.88,17,28,4417,14,1993,828.0,268.0,114.0,14,2424,828.0,587.0,145.0
0.005,6,10,1689,5,839,1.0,571.0,571.0,5,850,1.0,582.0,582.0
0.206,6,10,1506,5,395,49.0,127.0,127.0,5,1111,39.0,843.0,843.0
0.005,6,10,2000,5,927,1.0,659.0,659.0,5,1073,1.0,805.0,805.0
0.006,6,10,2007,5,928,1.0,660.0,660.0,5,1079,1.0,811.0,811.0
0.005,6,10,1989,5,927,1.0,659.0,659.0,5,1062,1.0,794.0,794.0
0.016,6,10,1990,5,911,3.0,643.0,643.0,5,1079,4.0,811.0,811.0
0.011,6,14,3787,7,497,1.0,125.0,125.0,7,3290,1.0,1448.0,972.0
0.012,6,10,1983,5,910,3.0,642.0,642.0,5,1073,2.0,805.0,805.0
0.081,6,10,1506,5,395,17.0,127.0,127.0,5,1111,17.0,843.0,843.0
0.076,6,10,1506,5,395,17.0,127.0,127.0,5,1111,14.0,843.0,843.0
0.02,6,10,1990,5,911,4.0,643.0,643.0,5,1079,5.0,811.0,811.0
0.004,6,10,2007,5,928,1.0,660.0,660.0,5,1079,1.0,811.0,811.0
0.004,6,10,2006,5,927,1.0,659.0,659.0,5,1079,1.0,811.0,811.0
1759.463,6,470,70510,266,36213,6639.0,613.0,190.0,204,34297,8666.0,613.0,158.0
0.076,6,10,1506,5,395,17.0,127.0,127.0,5,1111,16.0,843.0,843.0
0.011,6,10,1677,5,827,2.0,559.0,559.0,5,850,2.0,582.0,582.0
0.005,17,2,179,1,71,0.0,43.0,43.0,1,108,0.0,80.0,80.0
0.009,6,10,1631,5,848,2.0,580.0,580.0,5,783,2.0,515.0,515.0
0.013,6,10,1631,5,848,3.0,580.0,580.0,5,783,3.0,515.0,515.0
0.005,6,10,1547,5,764,1.0,496.0,496.0,5,783,1.0,515.0,515.0
10.777,17,28,4422,14,1994,820.0,269.0,114.0,14,2428,820.0,587.0,145.0
0.016,6,10,1989,5,910,4.0,642.0,642.0,5,1079,4.0,811.0,811.0
0.005,6,10,1779,5,928,1.0,660.0,660.0,5,851,1.0,583.0,583.0
0.005,6,10,1989,5,927,1.0,659.0,659.0,5,1062,1.0,794.0,794.0
0.015,6,10,1989,5,910,3.0,642.0,642.0,5,1079,3.0,811.0,811.0
0.037,17,4,352,2,130,0.0,37.0,37.0,2,222,34.0,89.0,83.0
0.012,6,13,3735,7,497,2.0,125.0,125.0,6,3238,2.0,1470.0,1459.0
0.072,17,4,284,2,120,0.0,32.0,32.0,2,164,33.0,60.0,54.0
0.064,17,2,144,1,64,0.0,36.0,36.0,1,80,0.0,52.0,52.0
0.126,6,10,1506,5,395,28.0,127.0,127.0,5,1111,31.0,843.0,843.0
0.006,6,10,1854,5,889,1.0,621.0,621.0,5,965,1.0,697.0,697.0
0.008,6,10,1990,5,911,2.0,643.0,643.0,5,1079,2.0,811.0,811.0
0.005,6,10,1779,5,928,1.0,660.0,660.0,5,851,1.0,583.0,583.0
0.008,6,10,1631,5,848,2.0,580.0,580.0,5,783,2.0,515.0,515.0
0.11,6,10,1506,5,395,26.0,127.0,127.0,5,1111,26.0,843.0,843.0
0.146,6,10,1506,5,395,34.0,127.0,127.0,5,1111,34.0,843.0,843.0
0.134,6,10,1506,5,395,26.0,127.0,127.0,5,1111,28.0,843.0,843.0
40.063,17,10,676,5,460,10012.0,104.0,64.0,5,216,10015.0,20.0,15.0
40.055,17,10,676,5,460,10012.0,104.0,64.0,5,216,10012.0,20.0,15.0
0.262,17,39,20064,20,16972,13.0,1350.0,820.0,19,3092,11.0,1350.0,134.0
0.016,6,10,1983,5,910,3.0,642.0,642.0,5,1073,3.0,805.0,805.0
0.009,6,10,1677,5,827,2.0,559.0,559.0,5,850,2.0,582.0,582.0
0.016,6,20,9974,11,704,1.0,124.0,124.0,9,9270,2.0,2896.0,1758.0
0.087,6,10,1506,5,395,19.0,127.0,127.0,5,1111,21.0,843.0,843.0
0.004,6,10,1774,5,923,1.0,655.0,655.0,5,851,1.0,583.0,583.0
0.008,6,12,1926,6,1189,1.0,659.0,434.0,6,737,1.0,417.0,417.0
0.006,6,10,1989,5,927,1.0,659.0,659.0,5,1062,1.0,794.0,794.0
0.127,6,10,1506,5,395,29.0,127.0,127.0,5,1111,30.0,843.0,843.0
0.081,6,10,1506,5,395,18.0,127.0,127.0,5,1111,20.0,843.0,843.0
0.004,6,10,1989,5,927,1.0,659.0,659.0,5,1062,1.0,794.0,794.0
0.087,6,10,1506,5,395,17.0,127.0,127.0,5,1111,20.0,843.0,843.0
20.771,6,43,13778,22,7911,431.0,2023.0,999.0,21,5867,1029.0,2667.0,385.0
0.005,6,10,2007,5,928,1.0,660.0,660.0,5,1079,1.0,811.0,811.0
0.009,6,10,1989,5,910,2.0,642.0,642.0,5,1079,2.0,811.0,811.0
0.005,6,10,2007,5,928,1.0,660.0,660.0,5,1079,1.0,811.0,811.0
0.12,6,10,1506,5,395,26.0,127.0,127.0,5,1111,27.0,843.0,843.0
0.014,6,10,1990,5,911,3.0,643.0,643.0,5,1079,3.0,811.0,811.0
0.004,6,10,2000,5,927,1.0,659.0,659.0,5,1073,1.0,805.0,805.0
0.008,6,12,1926,6,1189,1.0,659.0,434.0,6,737,1.0,417.0,417.0
0.075,6,10,1506,5,395,16.0,127.0,127.0,5,1111,15.0,843.0,843.0
0.002,17,2,136,1,60,0.0,32.0,32.0,1,76,0.0,48.0,48.0
0.06,17,2,152,1,76,0.0,48.0,48.0,1,76,0.0,48.0,48.0
0.006,6,10,1547,5,764,1.0,496.0,496.0,5,783,1.0,515.0,515.0
0.096,6,10,1506,5,395,22.0,127.0,127.0,5,1111,21.0,843.0,843.0
0.003,17,2,136,1,60,0.0,32.0,32.0,1,76,0.0,48.0,48.0
40.053,17,10,676,5,460,10012.0,104.0,64.0,5,216,10010.0,20.0,15.0
0.012,6,10,1989,5,910,3.0,642.0,642.0,5,1079,3.0,811.0,811.0
0.003,17,2,148,1,60,0.0,32.0,32.0,1,88,0.0,60.0,60.0
0.006,6,10,2006,5,927,1.0,659.0,659.0,5,1079,1.0,811.0,811.0
0.07,6,10,1506,5,395,15.0,127.0,127.0,5,1111,15.0,843.0,843.0
240.136,6,32,9577,16,7071,16009.0,2143.0,693.0,16,2506,16008.0,580.0,208.0
0.005,17,2,166,1,75,0.0,47.0,47.0,1,91,0.0,63.0,63.0
0.004,17,2,148,1,60,0.0,32.0,32.0,1,88,0.0,60.0,60.0
40.078,17,10,676,5,460,10015.0,104.0,64.0,5,216,10018.0,20.0,15.0
175.47,17,78,10865,39,2587,4617.0,44.0,38.0,39,8278,4617.0,239.0,184.0
0.013,6,10,1989,5,910,3.0,642.0,642.0,5,1079,3.0,811.0,811.0
0.119,17,2,156,1,64,0.0,36.0,36.0,1,92,0.0,64.0,64.0
0.081,6,10,1506,5,395,15.0,127.0,127.0,5,1111,19.0,843.0,843.0
0.006,6,10,1547,5,764,1.0,496.0,496.0,5,783,1.0,515.0,515.0
0.005,6,10,2007,5,928,1.0,660.0,660.0,5,1079,1.0,811.0,811.0
0.013,6,10,1990,5,911,3.0,643.0,643.0,5,1079,3.0,811.0,811.0
0.091,6,10,1506,5,395,20.0,127.0,127.0,5,1111,20.0,843.0,843.0
0.013,6,10,1762,5,911,3.0,643.0,643.0,5,851,3.0,583.0,583.0
0.004,17,2,136,1,60,0.0,32.0,32.0,1,76,0.0,48.0,48.0
0.08,6,10,1506,5,395,16.0,127.0,127.0,5,1111,17.0,843.0,843.0
10.931,17,28,4418,14,1995,832.0,270.0,114.0,14,2423,832.0,586.0,145.0
0.006,6,10,1547,5,764,1.0,496.0,496.0,5,783,1.0,515.0,515.0
0.005,17,2,179,1,71,0.0,43.0,43.0,1,108,0.0,80.0,80.0
0.097,6,10,1506,5,395,22.0,127.0,127.0,5,1111,22.0,843.0,843.0
170.275,17,76,10818,38,2528,4601.0,44.0,38.0,38,8290,4601.0,239.0,190.0
0.004,6,10,2006,5,927,1.0,659.0,659.0,5,1079,1.0,811.0,811.0
0.01,6,10,1989,5,910,2.0,642.0,642.0,5,1079,2.0,811.0,811.0
10.999,17,28,4398,14,2312,837.0,587.0,137.0,14,2086,837.0,269.0,121.0
0.127,17,4,364,2,160,0.0,52.0,52.0,2,204,87.0,80.0,74.0
0.009,6,10,2006,5,927,2.0,659.0,659.0,5,1079,2.0,811.0,811.0
0.005,6,10,2006,5,927,1.0,659.0,659.0,5,1079,1.0,811.0,811.0
0.001,17,2,180,1,66,0.0,38.0,38.0,1,114,0.0,86.0,86.0
0.005,17,2,180,1,66,0.0,38.0,38.0,1,114,0.0,86.0,86.0
0.003,17,2,148,1,60,0.0,32.0,32.0,1,88,0.0,60.0,60.0
0.005,17,2,230,1,68,0.0,40.0,40.0,1,162,0.0,134.0,134.0
0.11,6,10,1506,5,395,21.0,127.0,127.0,5,1111,25.0,843.0,843.0
0.005,6,13,3690,7,452,0.0,80.0,80.0,6,3238,0.0,1470.0,1459.0
0.006,6,10,1854,5,889,1.0,621.0,621.0,5,965,1.0,697.0,697.0
0.005,17,2,180,1,66,0.0,38.0,38.0,1,114,0.0,86.0,86.0
0.006,17,2,178,1,65,0.0,37.0,37.0,1,113,0.0,85.0,85.0
0.126,6,10,1506,5,395,29.0,127.0,127.0,5,1111,26.0,843.0,843.0
0.007,17,2,179,1,71,0.0,43.0,43.0,1,108,0.0,80.0,80.0
0.07,6,10,1506,5,395,15.0,127.0,127.0,5,1111,14.0,843.0,843.0
0.004,6,10,1702,5,863,1.0,595.0,595.0,5,839,0.0,571.0,571.0
240.096,6,16,4481,9,963,30012.0,238.0,166.0,7,3518,40015.0,1402.0,786.0
0.068,6,10,1506,5,395,15.0,127.0,127.0,5,1111,15.0,843.0,843.0
0.001,17,2,180,1,66,0.0,38.0,38.0,1,114,0.0,86.0,86.0
0.011,6,10,1983,5,910,2.0,642.0,642.0,5,1073,2.0,805.0,805.0
0.011,6,10,1983,5,910,2.0,642.0,642.0,5,1073,2.0,805.0,805.0
0.099,6,10,1506,5,395,18.0,127.0,127.0,5,1111,21.0,843.0,843.0
0.004,6,10,1989,5,927,1.0,659.0,659.0,5,1062,1.0,794.0,794.0
0.005,6,10,1774,5,923,1.0,655.0,655.0,5,851,1.0,583.0,583.0
0.004,17,2,380,1,61,0.0,33.0,33.0,1,319,0.0,291.0,291.0
0.014,6,10,1762,5,911,3.0,643.0,643.0,5,851,3.0,583.0,583.0
0.005,6,10,1779,5,928,1.0,660.0,660.0,5,851,1.0,583.0,583.0
0.016,6,10,1989,5,910,4.0,642.0,642.0,5,1079,4.0,811.0,811.0
0.006,6,10,1689,5,839,1.0,571.0,571.0,5,850,1.0,582.0,582.0
0.004,6,10,2007,5,928,1.0,660.0,660.0,5,1079,1.0,811.0,811.0
0.011,6,10,1989,5,910,2.0,642.0,642.0,5,1079,2.0,811.0,811.0
292.924,6,388,347459,202,22046,1457.0,2736.0,769.0,186,325413,1583.0,2804.0,1835.0
15.072,17,15,9239,8,6902,2149.0,1350.0,834.0,7,2337,2507.0,1350.0,305.0
0.075,6,10,1506,5,395,17.0,127.0,127.0,5,1111,16.0,843.0,843.0
0.096,6,10,1506,5,395,14.0,127.0,127.0,5,1111,23.0,843.0,843.0
0.101,6,10,1506,5,395,21.0,127.0,127.0,5,1111,23.0,843.0,843.0
0.139,6,10,1506,5,395,32.0,127.0,127.0,5,1111,29.0,843.0,843.0
0.005,6,10,2006,5,927,1.0,659.0,659.0,5,1079,1.0,811.0,811.0
0.062,6,10,1506,5,395,13.0,127.0,127.0,5,1111,13.0,843.0,843.0
0.113,6,10,1506,5,395,25.0,127.0,127.0,5,1111,24.0,843.0,843.0
0.09,6,10,1506,5,395,19.0,127.0,127.0,5,1111,18.0,843.0,843.0
0.003,17,2,136,1,60,0.0,32.0,32.0,1,76,0.0,48.0,48.0
176.164,17,78,11067,39,2593,4635.0,44.0,38.0,39,8474,4635.0,239.0,189.0
40.061,17,10,676,5,460,10012.0,104.0,64.0,5,216,10014.0,20.0,15.0
0.088,6,10,1506,5,395,20.0,127.0,127.0,5,1111,19.0,843.0,843.0
0.005,17,2,164,1,74,0.0,46.0,46.0,1,90,0.0,62.0,62.0
0.004,17,2,136,1,60,0.0,32.0,32.0,1,76,0.0,48.0,48.0
40.054,17,10,676,5,460,10012.0,104.0,64.0,5,216,10012.0,20.0,15.0
0.001,17,2,180,1,66,0.0,38.0,38.0,1,114,0.0,86.0,86.0
0.094,6,10,1506,5,395,23.0,127.0,127.0,5,1111,17.0,843.0,843.0
40.064,17,10,676,5,460,10015.0,104.0,64.0,5,216,10014.0,20.0,15.0
0.07,6,10,1506,5,395,14.0,127.0,127.0,5,1111,16.0,843.0,843.0
0.144,6,10,1506,5,395,34.0,127.0,127.0,5,1111,31.0,843.0,843.0
0.006,6,10,1547,5,764,1.0,496.0,496.0,5,783,1.0,515.0,515.0
0.11,6,10,1506,5,395,16.0,127.0,127.0,5,1111,24.0,843.0,843.0
0.089,6,10,1506,5,395,19.0,127.0,127.0,5,1111,18.0,843.0,843.0
0.04,17,4,364,2,160,0.0,52.0,52.0,2,204,2.0,80.0,74.0
0.004,17,2,136,1,60,0.0,32.0,32.0,1,76,0.0,48.0,48.0
0.006,6,10,1989,5,927,1.0,659.0,659.0,5,1062,1.0,794.0,794.0
0.013,6,10,1989,5,910,3.0,642.0,642.0,5,1079,3.0,811.0,811.0
0.126,6,10,1506,5,395,29.0,127.0,127.0,5,1111,29.0,843.0,843.0
0.09,6,10,1506,5,395,21.0,127.0,127.0,5,1111,19.0,843.0,843.0
0.006,6,10,1547,5,764,1.0,496.0,496.0,5,783,1.0,515.0,515.0
0.005,6,10,1854,5,889,1.0,621.0,621.0,5,965,1.0,697.0,697.0
0.011,6,10,1972,5,910,2.0,642.0,642.0,5,1062,2.0,794.0,794.0
0.006,6,10,1547,5,764,1.0,496.0,496.0,5,783,1.0,515.0,515.0
0.008,6,10,1983,5,910,2.0,642.0,642.0,5,1073,2.0,805.0,805.0
301.215,6,57,26259,31,20147,10040.0,4080.0,1451.0,26,6112,361.0,2667.0,361.0
0.012,6,10,1972,5,910,3.0,642.0,642.0,5,1062,3.0,794.0,794.0
0.005,6,10,2007,5,928,1.0,660.0,660.0,5,1079,1.0,811.0,811.0
0.014,6,10,1990,5,911,3.0,643.0,643.0,5,1079,3.0,811.0,811.0
0.005,17,2,170,1,65,0.0,37.0,37.0,1,105,0.0,77.0,77.0
0.005,6,10,2006,5,927,1.0,659.0,659.0,5,1079,1.0,811.0,811.0
0.005,17,2,180,1,66,0.0,38.0,38.0,1,114,0.0,86.0,86.0
0.005,6,10,1989,5,927,1.0,659.0,659.0,5,1062,1.0,794.0,794.0
0.01,6,10,1983,5,910,2.0,642.0,642.0,5,1073,2.0,805.0,805.0
0.008,6,10,1762,5,911,2.0,643.0,643.0,5,851,2.0,583.0,583.0
0.005,6,10,1989,5,927,1.0,659.0,659.0,5,1062,1.0,794.0,794.0
0.09,6,10,1506,5,395,16.0,127.0,127.0,5,1111,22.0,843.0,843.0
0.041,17,2,184,1,61,0.0,33.0,33.0,1,123,0.0,95.0,95.0
308.626,17,20,1124,10,716,34277.0,48.0,43.0,10,408,34277.0,20.0,12.0
0.074,6,10,1506,5,395,17.0,127.0,127.0,5,1111,15.0,843.0,843.0
240.02,6,9,787,5,488,60005.0,232.0,232.0,4,299,80005.0,83.0,83.0
293.084,6,370,347020,189,21395,1558.0,2736.0,889.0,181,325625,1628.0,2804.0,1893.0
0.005,6,10,2006,5,927,1.0,659.0,659.0,5,1079,1.0,811.0,811.0
0.005,6,10,1989,5,927,1.0,659.0,659.0,5,1062,1.0,794.0,794.0
0.005,17,2,170,1,65,0.0,37.0,37.0,1,105,0.0,77.0,77.0
0.01,6,10,1989,5,910,2.0,642.0,642.0,5,1079,2.0,811.0,811.0
0.014,6,10,1631,5,848,3.0,580.0,580.0,5,783,3.0,515.0,515.0
40.055,17,10,676,5,460,10012.0,104.0,64.0,5,216,10013.0,20.0,15.0
0.021,6,10,1631,5,848,5.0,580.0,580.0,5,783,5.0,515.0,515.0
15.074,17,14,9190,8,6902,2149.0,1350.0,834.0,6,2288,3009.0,1350.0,353.0
0.015,6,10,1989,5,910,3.0,642.0,642.0,5,1079,3.0,811.0,811.0
0.01,6,10,1983,5,910,2.0,642.0,642.0,5,1073,2.0,805.0,805.0
0.014,6,10,1989,5,910,3.0,642.0,642.0,5,1079,3.0,811.0,811.0
0.006,6,10,1547,5,764,1.0,496.0,496.0,5,783,1.0,515.0,515.0
0.015,6,10,1972,5,910,3.0,642.0,642.0,5,1062,3.0,794.0,794.0
240.26,6,43,5328,22,2533,11440.0,581.0,195.0,21,2795,12012.0,566.0,211.0
10.839,17,28,4423,14,1994,825.0,269.0,114.0,14,2429,825.0,588.0,145.0
0.004,6,10,2000,5,927,1.0,659.0,659.0,5,1073,1.0,805.0,805.0
0.004,6,10,2006,5,927,1.0,659.0,659.0,5,1079,1.0,811.0,811.0
0.004,6,10,1774,5,923,1.0,655.0,655.0,5,851,0.0,583.0,583.0
0.008,6,10,1989,5,910,2.0,642.0,642.0,5,1079,2.0,811.0,811.0
333.041,17,20,1124,10,716,36990.0,48.0,43.0,10,408,36990.0,20.0,12.0
0.014,6,10,1989,5,910,3.0,642.0,642.0,5,1079,3.0,811.0,811.0
0.008,17,2,179,1,71,0.0,43.0,43.0,1,108,0.0,80.0,80.0
0.005,17,2,170,1,65,0.0,37.0,37.0,1,105,0.0,77.0,77.0
0.098,17,2,80,1,32,0.0,4.0,4.0,1,48,0.0,20.0,20.0
371.388,6,22,2313,16,867,24759.0,195.0,195.0,6,1446,4647.0,419.0,398.0
0.013,6,10,1989,5,910,3.0,642.0,642.0,5,1079,3.0,811.0,811.0
0.037,17,2,136,1,60,0.0,32.0,32.0,1,76,0.0,48.0,48.0
0.017,6,10,1989,5,910,4.0,642.0,642.0,5,1079,4.0,811.0,811.0
0.081,6,10,1506,5,395,15.0,127.0,127.0,5,1111,19.0,843.0,843.0
0.038,17,2,412,1,61,0.0,33.0,33.0,1,351,0.0,323.0,323.0
0.001,17,2,166,1,75,0.0,47.0,47.0,1,91,0.0,63.0,63.0
0.012,6,10,1972,5,910,3.0,642.0,642.0,5,1062,2.0,794.0,794.0
0.005,17,2,180,1,66,0.0,38.0,38.0,1,114,0.0,86.0,86.0
0.07,6,10,1506,5,395,15.0,127.0,127.0,5,1111,16.0,843.0,843.0
0.001,17,2,166,1,75,0.0,47.0,47.0,1,91,0.0,63.0,63.0
0.001,17,2,180,1,66,0.0,38.0,38.0,1,114,0.0,86.0,86.0
0.004,17,2,148,1,60,0.0,32.0,32.0,1,88,0.0,60.0,60.0
1772.856,17,120,11460,60,5460,30047.0,63.0,63.0,60,6000,30048.0,72.0,72.0
0.01,6,10,1989,5,910,2.0,642.0,642.0,5,1079,2.0,811.0,811.0
0.008,6,10,1989,5,910,2.0,642.0,642.0,5,1079,2.0,811.0,811.0
25.544,6,41,13667,20,7800,476.0,3579.0,1393.0,21,5867,1268.0,2667.0,385.0
0.005,6,10,2007,5,928,1.0,660.0,660.0,5,1079,1.0,811.0,811.0
0.093,6,10,1506,5,395,20.0,127.0,127.0,5,1111,19.0,843.0,843.0
0.009,6,10,1989,5,910,2.0,642.0,642.0,5,1079,2.0,811.0,811.0
0.076,6,10,1506,5,395,16.0,127.0,127.0,5,1111,18.0,843.0,843.0
0.168,17,2,152,1,76,0.0,48.0,48.0,1,76,0.0,48.0,48.0
0.004,6,10,2006,5,927,1.0,659.0,659.0,5,1079,1.0,811.0,811.0
0.075,17,4,352,2,130,3.0,37.0,37.0,2,222,36.0,89.0,83.0
0.014,6,10,1972,5,910,3.0,642.0,642.0,5,1062,3.0,794.0,794.0
65.758,6,27,17572,15,9627,4697.0,2804.0,1473.0,12,7945,5962.0,2316.0,1218.0
0.005,17,2,169,1,62,0.0,34.0,34.0,1,107,0.0,79.0,79.0
0.06,17,2,80,1,32,0.0,4.0,4.0,1,48,0.0,20.0,20.0
0.005,17,2,230,1,68,0.0,40.0,40.0,1,162,0.0,134.0,134.0
0.132,17,4,284,2,120,0.0,32.0,32.0,2,164,128.0,60.0,54.0
0.011,6,10,1990,5,911,2.0,643.0,643.0,5,1079,2.0,811.0,811.0
0.006,6,10,1547,5,764,1.0,496.0,496.0,5,783,1.0,515.0,515.0
0.009,6,10,1643,5,860,2.0,592.0,592.0,5,783,2.0,515.0,515.0
0.008,6,13,3735,7,497,1.0,125.0,125.0,6,3238,1.0,1470.0,1459.0
0.01,6,10,1983,5,910,2.0,642.0,642.0,5,1073,2.0,805.0,805.0
0.007,17,2,194,1,59,0.0,31.0,31.0,1,135,0.0,107.0,107.0
0.017,17,2,222,1,65,0.0,37.0,37.0,1,157,0.0,129.0,129.0
0.096,6,10,1506,5,395,22.0,127.0,127.0,5,1111,20.0,843.0,843.0
0.163,17,2,152,1,76,0.0,48.0,48.0,1,76,0.0,48.0,48.0
0.084,6,10,1506,5,395,18.0,127.0,127.0,5,1111,16.0,843.0,843.0
0.005,17,4,284,2,120,0.0,32.0,32.0,2,164,1.0,60.0,54.0
0.117,6,10,1506,5,395,26.0,127.0,127.0,5,1111,23.0,843.0,843.0
0.02,6,10,1983,5,910,5.0,642.0,642.0,5,1073,4.0,805.0,805.0
0.015,6,13,3735,7,497,2.0,125.0,125.0,6,3238,2.0,1470.0,1459.0
240.246,6,41,5427,19,2390,13346.0,581.0,195.0,22,3037,11440.0,566.0,209.0
0.01,6,10,1989,5,910,2.0,642.0,642.0,5,1079,2.0,811.0,811.0
0.005,6,14,3799,7,509,0.0,137.0,137.0,7,3290,0.0,1448.0,972.0
0.004,6,10,2006,5,927,1.0,659.0,659.0,5,1079,1.0,811.0,811.0
10.795,17,28,4418,14,1994,821.0,269.0,114.0,14,2424,821.0,587.0,145.0
0.004,6,10,1702,5,863,1.0,595.0,595.0,5,839,1.0,571.0,571.0
0.012,6,10,1972,5,910,3.0,642.0,642.0,5,1062,3.0,794.0,794.0
0.017,17,2,198,1,91,0.0,63.0,63.0,1,107,0.0,79.0,79.0
0.006,6,10,2007,5,928,1.0,660.0,660.0,5,1079,1.0,811.0,811.0
0.008,17,2,144,1,64,0.0,36.0,36.0,1,80,0.0,52.0,52.0
0.008,6,10,1989,5,910,2.0,642.0,642.0,5,1079,1.0,811.0,811.0
0.062,6,10,1506,5,395,14.0,127.0,127.0,5,1111,13.0,843.0,843.0
1781.249,6,92,4962,46,2482,39582.0,26.0,26.0,46,2480,39582.0,26.0,25.0
0.005,6,10,2000,5,927,1.0,659.0,659.0,5,1073,1.0,805.0,805.0
0.078,6,10,1506,5,395,19.0,127.0,127.0,5,1111,16.0,843.0,843.0
0.096,6,10,1506,5,395,22.0,127.0,127.0,5,1111,23.0,843.0,843.0
0.013,6,10,1990,5,911,3.0,643.0,643.0,5,1079,3.0,811.0,811.0
0.006,6,10,1547,5,764,1.0,496.0,496.0,5,783,1.0,515.0,515.0
0.077,6,10,1506,5,395,16.0,127.0,127.0,5,1111,16.0,843.0,843.0
0.011,6,10,1631,5,848,2.0,580.0,580.0,5,783,2.0,515.0,515.0
0.01,6,10,1989,5,910,2.0,642.0,642.0,5,1079,2.0,811.0,811.0
0.015,6,10,1677,5,827,3.0,559.0,559.0,5,850,3.0,582.0,582.0
0.084,6,10,1506,5,395,19.0,127.0,127.0,5,1111,15.0,843.0,843.0
0.008,6,10,1972,5,910,2.0,642.0,642.0,5,1062,1.0,794.0,794.0
0.004,6,10,2006,5,927,1.0,659.0,659.0,5,1079,1.0,811.0,811.0
0.023,6,10,1677,5,827,5.0,559.0,559.0,5,850,5.0,582.0,582.0
0.006,6,10,1547,5,764,1.0,496.0,496.0,5,783,1.0,515.0,515.0
0.006,6,10,1547,5,764,1.0,496.0,496.0,5,783,1.0,515.0,515.0
301.276,6,56,27681,29,21574,10759.0,2720.0,1567.0,27,6107,350.0,2667.0,385.0
0.005,17,2,136,1,60,0.0,32.0,32.0,1,76,0.0,48.0,48.0
0.084,6,10,1506,5,395,18.0,127.0,127.0,5,1111,16.0,843.0,843.0
330.233,17,20,1124,10,716,36678.0,48.0,43.0,10,408,36678.0,20.0,12.0
0.004,17,4,284,2,120,1.0,32.0,32.0,2,164,0.0,60.0,54.0
0.012,6,10,1983,5,910,3.0,642.0,642.0,5,1073,2.0,805.0,805.0
0.001,17,2,142,1,63,0.0,35.0,35.0,1,79,0.0,51.0,51.0
0.006,6,10,1854,5,889,1.0,621.0,621.0,5,965,1.0,697.0,697.0
0.005,17,2,144,1,64,0.0,36.0,36.0,1,80,0.0,52.0,52.0
1771.864,6,287,56473,113,43752,15819.0,2720.0,426.0,174,12721,10241.0,1062.0,75.0
0.01,6,10,1689,5,839,2.0,571.0,571.0,5,850,2.0,582.0,582.0
0.004,17,2,136,1,60,0.0,32.0,32.0,1,76,0.0,48.0,48.0
0.088,6,10,1506,5,395,16.0,127.0,127.0,5,1111,21.0,843.0,843.0
240.012,6,9,787,5,488,60003.0,232.0,232.0,4,299,80003.0,83.0,83.0
0.001,17,2,179,1,62,0.0,34.0,34.0,1,117,0.0,89.0,89.0
0.005,6,13,3690,7,452,0.0,80.0,80.0,6,3238,1.0,1470.0,1459.0
10.893,17,28,4422,14,1994,829.0,269.0,114.0,14,2428,829.0,587.0,145.0
0.08,6,10,1506,5,395,17.0,127.0,127.0,5,1111,18.0,843.0,843.0
0.005,6,10,2006,5,927,1.0,659.0,659.0,5,1079,1.0,811.0,811.0
0.07,6,10,1506,5,395,14.0,127.0,127.0,5,1111,14.0,843.0,843.0
0.005,17,2,136,1,60,0.0,32.0,32.0,1,76,0.0,48.0,48.0
40.079,17,10,676,5,460,10017.0,104.0,64.0,5,216,10019.0,20.0,15.0
0.011,6,10,1989,5,910,2.0,642.0,642.0,5,1079,2.0,811.0,811.0
0.014,6,10,1989,5,910,3.0,642.0,642.0,5,1079,3.0,811.0,811.0
0.006,6,10,1547,5,764,1.0,496.0,496.0,5,783,1.0,515.0,515.0
0.136,6,10,1506,5,395,26.0,127.0,127.0,5,1111,32.0,843.0,843.0
0.088,6,10,1506,5,395,19.0,127.0,127.0,5,1111,20.0,843.0,843.0
0.015,6,10,1983,5,910,3.0,642.0,642.0,5,1073,3.0,805.0,805.0
0.005,6,10,1547,5,764,1.0,496.0,496.0,5,783,1.0,515.0,515.0
0.122,6,10,1506,5,395,28.0,127.0,127.0,5,1111,25.0,843.0,843.0
0.073,6,10,1506,5,395,15.0,127.0,127.0,5,1111,16.0,843.0,843.0
0.01,6,10,1631,5,848,2.0,580.0,580.0,5,783,2.0,515.0,515.0
0.015,6,10,1972,5,910,3.0,642.0,642.0,5,1062,3.0,794.0,794.0
0.005,17,4,495,2,132,0.0,38.0,38.0,2,363,2.0,176.0,153.0
0.007,17,2,194,1,59,0.0,31.0,31.0,1,135,0.0,107.0,107.0
0.012,6,10,1989,5,910,2.0,642.0,642.0,5,1079,3.0,811.0,811.0
0.15,6,10,1506,5,395,35.0,127.0,127.0,5,1111,34.0,843.0,843.0
0.005,17,2,169,1,62,0.0,34.0,34.0,1,107,0.0,79.0,79.0
40.058,17,10,676,5,460,10012.0,104.0,64.0,5,216,10013.0,20.0,15.0
0.018,6,10,1631,5,848,4.0,580.0,580.0,5,783,4.0,515.0,515.0
0.017,6,10,1990,5,911,4.0,643.0,643.0,5,1079,4.0,811.0,811.0
0.07,6,10,1506,5,395,15.0,127.0,127.0,5,1111,14.0,843.0,843.0
0.004,6,10,2006,5,927,1.0,659.0,659.0,5,1079,1.0,811.0,811.0
0.017,6,10,1762,5,911,4.0,643.0,643.0,5,851,4.0,583.0,583.0
0.011,6,10,1972,5,910,2.0,642.0,642.0,5,1062,2.0,794.0,794.0
0.005,6,10,1689,5,839,1.0,571.0,571.0,5,850,1.0,582.0,582.0
94.739,6,28,9605,14,1707,7287.0,794.0,367.0,14,7898,7277.0,1360.0,732.0
0.004,6,10,1989,5,927,1.0,659.0,659.0,5,1062,1.0,794.0,794.0
0.004,17,2,148,1,60,0.0,32.0,32.0,1,88,0.0,60.0,60.0
0.013,6,10,1989,5,910,3.0,642.0,642.0,5,1079,3.0,811.0,811.0
0.109,6,10,1506,5,395,23.0,127.0,127.0,5,1111,25.0,843.0,843.0
0.003,17,2,136,1,60,0.0,32.0,32.0,1,76,0.0,48.0,48.0
0.003,17,2,148,1,60,0.0,32.0,32.0,1,88,0.0,60.0,60.0
0.114,6,10,1506,5,395,28.0,127.0,127.0,5,1111,23.0,843.0,843.0
0.009,6,13,3735,7,497,1.0,125.0,125.0,6,3238,1.0,1470.0,1459.0
0.137,6,10,1506,5,395,33.0,127.0,127.0,5,1111,27.0,843.0,843.0
0.004,17,2,138,1,61,0.0,33.0,33.0,1,77,0.0,49.0,49.0
0.005,6,10,2006,5,927,1.0,659.0,659.0,5,1079,1.0,811.0,811.0
0.006,6,10,1689,5,839,1.0,571.0,571.0,5,850,1.0,582.0,582.0
0.133,6,10,1506,5,395,30.0,127.0,127.0,5,1111,25.0,843.0,843.0
0.009,6,10,1989,5,910,2.0,642.0,642.0,5,1079,2.0,811.0,811.0
0.005,6,10,1989,5,927,1.0,659.0,659.0,5,1062,1.0,794.0,794.0
0.005,17,2,144,1,64,0.0,36.0,36.0,1,80,0.0,52.0,52.0
0.001,17,2,180,1,66,0.0,38.0,38.0,1,114,0.0,86.0,86.0
0.014,6,10,1989,5,910,3.0,642.0,642.0,5,1079,3.0,811.0,811.0
0.005,6,10,1689,5,839,1.0,571.0,571.0,5,850,1.0,582.0,582.0
300.027,6,12,1782,7,1348,50004.0,494.0,494.0,5,434,75005.0,83.0,83.0
0.005,6,10,2006,5,927,1.0,659.0,659.0,5,1079,1.0,811.0,811.0
0.004,6,10,2006,5,927,1.0,659.0,659.0,5,1079,1.0,811.0,811.0
0.037,17,2,136,1,60,0.0,32.0,32.0,1,76,0.0,48.0,48.0
0.001,17,2,136,1,60,0.0,32.0,32.0,1,76,0.0,48.0,48.0
0.006,6,10,1547,5,764,1.0,496.0,496.0,5,783,1.0,515.0,515.0
0.003,17,2,148,1,60,0.0,32.0,32.0,1,88,0.0,60.0,60.0
0.011,6,10,1989,5,910,2.0,642.0,642.0,5,1079,2.0,811.0,811.0
0.069,6,10,1989,5,910,17.0,642.0,642.0,5,1079,17.0,811.0,811.0
0.07,17,8,3613,4,1874,23.0,1350.0,440.0,4,1739,11.0,1350.0,406.0
0.005,6,10,2000,5,927,1.0,659.0,659.0,5,1073,1.0,805.0,805.0
0.008,6,12,1926,6,1189,1.0,659.0,434.0,6,737,1.0,417.0,417.0
0.011,6,10,1972,5,910,2.0,642.0,642.0,5,1062,2.0,794.0,794.0
0.001,17,2,180,1,66,0.0,38.0,38.0,1,114,0.0,86.0,86.0
0.002,17,2,180,1,66,0.0,38.0,38.0,1,114,0.0,86.0,86.0
0.039,17,4,284,2,120,0.0,32.0,32.0,2,164,35.0,60.0,54.0
0.004,6,10,1989,5,927,1.0,659.0,659.0,5,1062,1.0,794.0,794.0
0.067,17,8,3613,4,1874,22.0,1350.0,440.0,4,1739,11.0,1350.0,406.0
0.005,6,10,2006,5,927,1.0,659.0,659.0,5,1079,1.0,811.0,811.0
0.004,6,10,1774,5,923,1.0,655.0,655.0,5,851,0.0,583.0,583.0
0.001,17,2,136,1,60,0.0,32.0,32.0,1,76,0.0,48.0,48.0
0.069,6,10,1506,5,395,15.0,127.0,127.0,5,1111,15.0,843.0,843.0
0.006,6,10,1547,5,764,1.0,496.0,496.0,5,783,1.0,515.0,515.0
0.001,17,2,180,1,66,0.0,38.0,38.0,1,114,0.0,86.0,86.0
0.006,17,2,169,1,62,0.0,34.0,34.0,1,107,0.0,79.0,79.0
0.072,17,2,148,1,60,0.0,32.0,32.0,1,88,0.0,60.0,60.0
0.017,6,10,1631,5,848,4.0,580.0,580.0,5,783,4.0,515.0,515.0
0.009,6,10,1762,5,911,2.0,643.0,643.0,5,851,2.0,583.0,583.0
0.008,6,13,3735,7,497,1.0,125.0,125.0,6,3238,1.0,1470.0,1459.0
0.005,17,2,170,1,65,0.0,37.0,37.0,1,105,0.0,77.0,77.0
0.004,6,14,3742,7,452,0.0,80.0,80.0,7,3290,0.0,1448.0,972.0
0.282,17,47,29342,29,26290,10.0,1350.0,878.0,18,3052,13.0,1350.0,141.0
173.321,17,74,10629,37,2465,4814.0,44.0,38.0,37,8164,4814.0,261.0,192.0
0.071,6,10,1506,5,395,14.0,127.0,127.0,5,1111,16.0,843.0,843.0
10.873,17,28,4422,14,1994,827.0,269.0,114.0,14,2428,827.0,587.0,145.0
40.061,17,10,676,5,460,10014.0,104.0,64.0,5,216,10014.0,20.0,15.0
40.082,17,10,676,5,460,10018.0,104.0,64.0,5,216,10019.0,20.0,15.0
0.012,6,10,1990,5,911,3.0,643.0,643.0,5,1079,3.0,811.0,811.0
0.172,6,10,1506,5,395,38.0,127.0,127.0,5,1111,40.0,843.0,843.0
0.107,6,10,1506,5,395,25.0,127.0,127.0,5,1111,23.0,843.0,843.0
0.005,6,10,1689,5,839,1.0,571.0,571.0,5,850,1.0,582.0,582.0
308.355,17,20,1124,10,716,34254.0,48.0,43.0,10,408,34250.0,20.0,12.0
40.058,17,10,676,5,460,10012.0,104.0,64.0,5,216,10013.0,20.0,15.0
0.004,6,10,2006,5,927,1.0,659.0,659.0,5,1079,1.0,811.0,811.0
300.571,6,27,8922,15,1930,21469.0,517.0,285.0,12,6992,21864.0,1402.0,908.0
0.093,6,10,1506,5,395,19.0,127.0,127.0,5,1111,21.0,843.0,843.0
240.088,6,16,4480,9,963,30011.0,238.0,166.0,7,3517,40014.0,1402.0,786.0
0.005,6,13,3747,7,509,0.0,137.0,137.0,6,3238,0.0,1470.0,1459.0
0.012,6,10,1990,5,911,3.0,643.0,643.0,5,1079,2.0,811.0,811.0
0.001,17,2,180,1,66,0.0,38.0,38.0,1,114,0.0,86.0,86.0
0.011,6,10,1989,5,910,2.0,642.0,642.0,5,1079,2.0,811.0,811.0
0.001,17,2,180,1,66,0.0,38.0,38.0,1,114,0.0,86.0,86.0
0.01,6,10,1989,5,910,2.0,642.0,642.0,5,1079,2.0,811.0,811.0
0.011,6,10,1972,5,910,2.0,642.0,642.0,5,1062,2.0,794.0,794.0
0.006,6,10,1689,5,839,1.0,571.0,571.0,5,850,1.0,582.0,582.0
0.01,17,2,169,1,62,0.0,34.0,34.0,1,107,0.0,79.0,79.0
0.003,17,2,148,1,60,0.0,32.0,32.0,1,88,0.0,60.0,60.0
0.038,17,2,184,1,61,0.0,33.0,33.0,1,123,0.0,95.0,95.0
176.92,6,22,8496,12,2236,70.0,1345.0,574.0,10,6260,19639.0,2720.0,974.0
0.007,17,2,179,1,71,0.0,43.0,43.0,1,108,0.0,80.0,80.0
173.096,17,84,11786,42,2817,4221.0,44.0,39.0,42,8969,4221.0,239.0,185.0
0.005,17,2,164,1,74,0.0,46.0,46.0,1,90,0.0,62.0,62.0
0.014,6,10,1989,5,910,3.0,642.0,642.0,5,1079,3.0,811.0,811.0
0.005,6,10,2006,5,927,1.0,659.0,659.0,5,1079,1.0,811.0,811.0
0.006,6,10,1689,5,839,1.0,571.0,571.0,5,850,1.0,582.0,582.0
0.013,6,10,1983,5,910,3.0,642.0,642.0,5,1073,3.0,805.0,805.0
0.118,6,10,1506,5,395,25.0,127.0,127.0,5,1111,25.0,843.0,843.0
40.093,17,10,676,5,460,10022.0,104.0,64.0,5,216,10022.0,20.0,15.0
0.014,6,10,1990,5,911,3.0,643.0,643.0,5,1079,3.0,811.0,811.0
0.006,6,10,1547,5,764,1.0,496.0,496.0,5,783,1.0,515.0,515.0
0.076,6,10,1506,5,395,16.0,127.0,127.0,5,1111,15.0,843.0,843.0
0.005,6,10,2006,5,927,1.0,659.0,659.0,5,1079,1.0,811.0,811.0
0.005,6,10,1989,5,927,1.0,659.0,659.0,5,1062,1.0,794.0,794.0
0.012,6,10,1983,5,910,3.0,642.0,642.0,5,1073,2.0,805.0,805.0
30.177,6,27,5963,15,1928,2155.0,517.0,260.0,12,4035,2742.0,1330.0,590.0
0.011,6,10,1972,5,910,2.0,642.0,642.0,5,1062,2.0,794.0,794.0
0.005,6,10,2006,5,927,1.0,659.0,659.0,5,1079,1.0,811.0,811.0
0.01,6,10,1990,5,911,2.0,643.0,643.0,5,1079,2.0,811.0,811.0
0.066,6,10,1506,5,395,15.0,127.0,127.0,5,1111,14.0,843.0,843.0
0.009,6,12,1926,6,1189,1.0,659.0,434.0,6,737,1.0,417.0,417.0
0.08,6,10,1506,5,395,16.0,127.0,127.0,5,1111,18.0,843.0,843.0
0.13,17,2,80,1,32,0.0,4.0,4.0,1,48,0.0,20.0,20.0
0.001,17,2,179,1,62,0.0,34.0,34.0,1,117,0.0,89.0,89.0
0.006,6,10,1547,5,764,1.0,496.0,496.0,5,783,1.0,515.0,515.0
0.004,6,10,2006,5,927,1.0,659.0,659.0,5,1079,1.0,811.0,811.0
0.072,17,2,166,1,75,0.0,47.0,47.0,1,91,0.0,63.0,63.0
0.009,6,10,1983,5,910,2.0,642.0,642.0,5,1073,2.0,805.0,805.0
0.005,6,10,1779,5,928,1.0,660.0,660.0,5,851,1.0,583.0,583.0
0.001,17,2,180,1,66,0.0,38.0,38.0,1,114,0.0,86.0,86.0
0.122,6,10,1506,5,395,25.0,127.0,127.0,5,1111,23.0,843.0,843.0
353.406,6,20,2210,6,1308,12004.0,494.0,494.0,14,902,27184.0,83.0,83.0
40.078,17,10,676,5,460,10016.0,104.0,64.0,5,216,10018.0,20.0,15.0
0.067,17,8,3613,4,1874,22.0,1350.0,440.0,4,1739,11.0,1350.0,406.0
0.004,6,10,2000,5,927,1.0,659.0,659.0,5,1073,1.0,805.0,805.0
1777.433,17,144,41760,72,22752,25034.0,288.0,288.0,72,19008,25034.0,236.0,236.0
0.062,6,10,1506,5,395,14.0,127.0,127.0,5,1111,13.0,843.0,843.0
0.012,6,10,1972,5,910,2.0,642.0,642.0,5,1062,2.0,794.0,794.0
0.005,6,10,2000,5,927,1.0,659.0,659.0,5,1073,1.0,805.0,805.0
0.095,6,10,1506,5,395,18.0,127.0,127.0,5,1111,19.0,843.0,843.0
0.016,6,10,1677,5,827,3.0,559.0,559.0,5,850,3.0,582.0,582.0
40.067,17,10,676,5,460,10015.0,104.0,64.0,5,216,10015.0,20.0,15.0
0.134,6,10,1506,5,395,31.0,127.0,127.0,5,1111,25.0,843.0,843.0
0.117,6,10,1506,5,395,28.0,127.0,127.0,5,1111,25.0,843.0,843.0
0.092,6,10,1506,5,395,22.0,127.0,127.0,5,1111,19.0,843.0,843.0
9.038,17,6,376,5,280,2259.0,28.0,28.0,1,96,0.0,68.0,68.0
0.005,6,10,2006,5,927,1.0,659.0,659.0,5,1079,1.0,811.0,811.0
0.006,6,10,2007,5,928,1.0,660.0,660.0,5,1079,1.0,811.0,811.0
87.237,6,904,949529,430,922749,98.0,4080.0,2333.0,474,26780,184.0,2667.0,205.0
0.006,6,10,1547,5,764,1.0,496.0,496.0,5,783,1.0,515.0,515.0
0.004,6,10,2006,5,927,1.0,659.0,659.0,5,1079,1.0,811.0,811.0
0.005,6,10,1989,5,927,1.0,659.0,659.0,5,1062,1.0,794.0,794.0
0.012,6,10,1983,5,910,2.0,642.0,642.0,5,1073,3.0,805.0,805.0
240.099,6,16,4481,9,963,30012.0,238.0,166.0,7,3518,40016.0,1402.0,786.0
0.005,6,10,2006,5,927,1.0,659.0,659.0,5,1079,1.0,811.0,811.0
0.069,6,10,1506,5,395,14.0,127.0,127.0,5,1111,15.0,843.0,843.0
0.013,6,10,1983,5,910,3.0,642.0,642.0,5,1073,3.0,805.0,805.0
0.015,6,10,1990,5,911,3.0,643.0,643.0,5,1079,3.0,811.0,811.0
0.004,17,2,148,1,60,0.0,32.0,32.0,1,88,0.0,60.0,60.0
0.01,6,10,1972,5,910,2.0,642.0,642.0,5,1062,2.0,794.0,794.0
0.006,6,10,1547,5,764,1.0,496.0,496.0,5,783,1.0,515.0,515.0
10.801,17,28,4422,14,1995,822.0,270.0,114.0,14,2427,822.0,586.0,145.0
0.006,6,10,1547,5,764,1.0,496.0,496.0,5,783,1.0,515.0,515.0
0.005,6,10,2006,5,927,1.0,659.0,659.0,5,1079,1.0,811.0,811.0
0.005,6,10,2006,5,927,1.0,659.0,659.0,5,1079,1.0,811.0,811.0
0.005,17,2,144,1,64,0.0,36.0,36.0,1,80,0.0,52.0,52.0
0.016,6,10,1762,5,911,4.0,643.0,643.0,5,851,3.0,583.0,583.0
0.014,6,13,3735,7,497,2.0,125.0,125.0,6,3238,2.0,1470.0,1459.0
0.013,6,10,1990,5,911,3.0,643.0,643.0,5,1079,3.0,811.0,811.0
0.04,6,10,1631,5,848,10.0,580.0,580.0,5,783,10.0,515.0,515.0
0.04,17,2,182,1,65,0.0,37.0,37.0,1,117,0.0,89.0,89.0
0.014,6,13,3735,7,497,2.0,125.0,125.0,6,3238,2.0,1470.0,1459.0
0.007,6,10,1547,5,764,1.0,496.0,496.0,5,783,1.0,515.0,515.0
15.074,17,14,9190,8,6902,2149.0,1350.0,834.0,6,2288,3009.0,1350.0,353.0
0.007,6,10,1547,5,764,1.0,496.0,496.0,5,783,1.0,515.0,515.0
0.01,6,10,1990,5,911,2.0,643.0,643.0,5,1079,2.0,811.0,811.0
0.006,6,10,2006,5,927,1.0,659.0,659.0,5,1079,1.0,811.0,811.0
0.01,6,10,1972,5,910,2.0,642.0,642.0,5,1062,2.0,794.0,794.0
0.013,6,10,1677,5,827,3.0,559.0,559.0,5,850,3.0,582.0,582.0
0.004,6,10,1989,5,927,1.0,659.0,659.0,5,1062,1.0,794.0,794.0
10.925,17,28,4422,14,1994,831.0,269.0,114.0,14,2428,830.0,587.0,145.0
0.009,6,10,1990,5,911,2.0,643.0,643.0,5,1079,2.0,811.0,811.0
0.103,6,10,1506,5,395,25.0,127.0,127.0,5,1111,22.0,843.0,843.0
0.007,6,10,1689,5,839,1.0,571.0,571.0,5,850,1.0,582.0,582.0
0.005,6,10,2000,5,927,1.0,659.0,659.0,5,1073,1.0,805.0,805.0
0.011,6,10,1972,5,910,2.0,642.0,642.0,5,1062,2.0,794.0,794.0
0.006,6,10,1547,5,764,1.0,496.0,496.0,5,783,1.0,515.0,515.0
0.077,6,10,1506,5,395,16.0,127.0,127.0,5,1111,18.0,843.0,843.0
0.004,17,4,284,2,120,1.0,32.0,32.0,2,164,1.0,60.0,54.0
0.006,6,10,1547,5,764,1.0,496.0,496.0,5,783,1.0,515.0,515.0
0.107,6,10,1506,5,395,24.0,127.0,127.0,5,1111,19.0,843.0,843.0
0.006,6,14,3736,7,446,0.0,74.0,74.0,7,3290,0.0,1448.0,972.0
0.01,6,10,1990,5,911,2.0,643.0,643.0,5,1079,2.0,811.0,811.0
0.003,17,2,136,1,60,0.0,32.0,32.0,1,76,0.0,48.0,48.0
367.279,6,26,3272,18,971,21604.0,195.0,195.0,8,2301,3349.0,775.0,492.0
0.006,6,10,1989,5,927,1.0,659.0,659.0,5,1062,1.0,794.0,794.0
0.008,6,10,1972,5,910,2.0,642.0,642.0,5,1062,1.0,794.0,794.0
0.006,6,14,3799,7,509,0.0,137.0,137.0,7,3290,0.0,1448.0,972.0
0.007,6,10,2007,5,928,1.0,660.0,660.0,5,1079,1.0,811.0,811.0
71.222,6,1238,1295491,576,1260320,59.0,4080.0,2270.0,662,35171,107.0,1360.0,188.0
0.005,6,10,2006,5,927,1.0,659.0,659.0,5,1079,1.0,811.0,811.0
0.186,6,44,11549,24,3221,8.0,1021.0,197.0,20,8328,9.0,1402.0,606.0
0.006,6,10,1547,5,764,1.0,496.0,496.0,5,783,1.0,515.0,515.0
0.336,17,47,24543,25,21233,14.0,1350.0,821.0,22,3310,12.0,1350.0,122.0
0.012,6,10,1973,5,911,3.0,643.0,643.0,5,1062,2.0,794.0,794.0
0.005,6,10,2000,5,927,1.0,659.0,659.0,5,1073,1.0,805.0,805.0
0.38,17,17,10021,8,6917,54.0,1350.0,836.0,9,3104,36.0,1350.0,316.0
0.005,6,10,1643,5,860,1.0,592.0,592.0,5,783,1.0,515.0,515.0
0.01,6,10,2006,5,927,2.0,659.0,659.0,5,1079,2.0,811.0,811.0
0.118,6,10,1506,5,395,28.0,127.0,127.0,5,1111,28.0,843.0,843.0
319.576,17,20,1124,10,716,35494.0,48.0,43.0,10,408,35494.0,20.0,12.0
0.008,6,10,1762,5,911,2.0,643.0,643.0,5,851,2.0,583.0,583.0
0.006,6,10,1547,5,764,1.0,496.0,496.0,5,783,1.0,515.0,515.0
0.005,17,2,164,1,74,0.0,46.0,46.0,1,90,0.0,62.0,62.0
0.038,17,2,182,1,65,0.0,37.0,37.0,1,117,0.0,89.0,89.0
0.08,6,45,14135,25,2555,3.0,517.0,139.0,20,11580,3.0,1402.0,752.0
0.101,6,10,1506,5,395,23.0,127.0,127.0,5,1111,20.0,843.0,843.0
0.009,6,10,1989,5,910,2.0,642.0,642.0,5,1079,2.0,811.0,811.0
0.005,6,10,2007,5,928,1.0,660.0,660.0,5,1079,1.0,811.0,811.0
1757.108,6,103,6166,59,3473,30294.0,27.0,27.0,44,2693,40862.0,27.0,27.0
0.011,6,10,1983,5,910,2.0,642.0,642.0,5,1073,2.0,805.0,805.0
0.001,17,2,179,1,62,0.0,34.0,34.0,1,117,0.0,89.0,89.0
0.011,6,10,1989,5,910,2.0,642.0,642.0,5,1079,2.0,811.0,811.0
0.01,6,10,1972,5,910,2.0,642.0,642.0,5,1062,2.0,794.0,794.0
0.005,17,2,214,1,75,0.0,47.0,47.0,1,139,0.0,111.0,111.0
0.005,6,10,1689,5,839,1.0,571.0,571.0,5,850,1.0,582.0,582.0
0.004,17,2,136,1,60,0.0,32.0,32.0,1,76,0.0,48.0,48.0
0.014,17,2,214,1,75,0.0,47.0,47.0,1,139,0.0,111.0,111.0
1.136,6,10,1266,5,775,284.0,519.0,519.0,5,491,282.0,223.0,223.0
5.127,58,2,144,1,72,0.0,24.0,24.0,1,72,0.0,24.0,24.0
0.001,17,2,166,1,75,0.0,47.0,47.0,1,91,0.0,63.0,63.0
0.005,6,10,2006,5,927,1.0,659.0,659.0,5,1079,1.0,811.0,811.0
0.133,6,10,1506,5,395,31.0,127.0,127.0,5,1111,32.0,843.0,843.0
0.014,6,10,1983,5,910,3.0,642.0,642.0,5,1073,3.0,805.0,805.0
0.079,6,10,1506,5,395,16.0,127.0,127.0,5,1111,17.0,843.0,843.0
0.107,6,10,1506,5,395,24.0,127.0,127.0,5,1111,25.0,843.0,843.0
0.005,6,10,2006,5,927,1.0,659.0,659.0,5,1079,1.0,811.0,811.0
0.005,6,10,2006,5,927,1.0,659.0,659.0,5,1079,1.0,811.0,811.0
177.207,17,82,11524,41,2749,4429.0,44.0,39.0,41,8775,4430.0,261.0,186.0
0.067,17,8,3613,4,1874,22.0,1350.0,440.0,4,1739,11.0,1350.0,406.0
40.062,17,10,676,5,460,10014.0,104.0,64.0,5,216,10014.0,20.0,15.0
0.218,6,16,2777,8,1395,31.0,533.0,323.0,8,1382,19.0,529.0,239.0
0.08,6,10,1506,5,395,18.0,127.0,127.0,5,1111,17.0,843.0,843.0
0.072,17,2,412,1,61,0.0,33.0,33.0,1,351,0.0,323.0,323.0
0.011,6,10,1989,5,910,2.0,642.0,642.0,5,1079,2.0,811.0,811.0
0.001,17,2,180,1,66,0.0,38.0,38.0,1,114,0.0,86.0,86.0
0.002,17,2,136,1,60,0.0,32.0,32.0,1,76,0.0,48.0,48.0
0.005,17,2,148,1,60,0.0,32.0,32.0,1,88,0.0,60.0,60.0
0.003,17,2,136,1,60,0.0,32.0,32.0,1,76,0.0,48.0,48.0
0.005,6,10,1854,5,889,1.0,621.0,621.0,5,965,1.0,697.0,697.0
0.015,6,10,1990,5,911,3.0,643.0,643.0,5,1079,3.0,811.0,811.0
0.121,6,10,1506,5,395,26.0,127.0,127.0,5,1111,29.0,843.0,843.0
0.004,6,10,2000,5,927,1.0,659.0,659.0,5,1073,1.0,805.0,805.0
0.013,6,10,1631,5,848,3.0,580.0,580.0,5,783,3.0,515.0,515.0
0.005,17,2,214,1,75,0.0,47.0,47.0,1,139,0.0,111.0,111.0
0.004,6,10,2000,5,927,1.0,659.0,659.0,5,1073,1.0,805.0,805.0
40.073,17,10,676,5,460,10017.0,104.0,64.0,5,216,10017.0,20.0,15.0
0.092,6,10,1506,5,395,17.0,127.0,127.0,5,1111,19.0,843.0,843.0
0.011,6,10,1972,5,910,2.0,642.0,642.0,5,1062,2.0,794.0,794.0
0.004,6,10,2006,5,927,1.0,659.0,659.0,5,1079,1.0,811.0,811.0
0.006,6,10,2006,5,927,1.0,659.0,659.0,5,1079,1.0,811.0,811.0
15.076,17,15,8475,8,6333,2149.0,1350.0,763.0,7,2142,2507.0,1350.0,278.0
0.038,17,2,136,1,60,0.0,32.0,32.0,1,76,0.0,48.0,48.0
0.011,6,10,1989,5,910,2.0,642.0,642.0,5,1079,2.0,811.0,811.0
0.073,6,10,1506,5,395,17.0,127.0,127.0,5,1111,14.0,843.0,843.0
0.02,6,20,9974,11,704,2.0,124.0,124.0,9,9270,2.0,2896.0,1758.0
0.003,17,2,148,1,60,0.0,32.0,32.0,1,88,0.0,60.0,60.0
38.992,17,25,14900,14,12082,2997.0,1350.0,835.0,11,2818,3896.0,1350.0,228.0
0.004,6,10,1779,5,928,1.0,660.0,660.0,5,851,1.0,583.0,583.0
0.037,17,4,284,2,120,0.0,32.0,32.0,2,164,33.0,60.0,54.0
0.007,6,10,1972,5,910,1.0,642.0,642.0,5,1062,1.0,794.0,794.0
0.008,6,10,2007,5,928,1.0,660.0,660.0,5,1079,2.0,811.0,811.0
0.11,6,10,1506,5,395,20.0,127.0,127.0,5,1111,23.0,843.0,843.0
0.005,6,10,1689,5,839,1.0,571.0,571.0,5,850,1.0,582.0,582.0
0.017,6,10,1972,5,910,4.0,642.0,642.0,5,1062,4.0,794.0,794.0
0.012,6,13,3735,7,497,2.0,125.0,125.0,6,3238,2.0,1470.0,1459.0
0.009,6,10,1989,5,910,2.0,642.0,642.0,5,1079,2.0,811.0,811.0
0.089,6,10,1506,5,395,18.0,127.0,127.0,5,1111,20.0,843.0,843.0
40.058,17,10,676,5,460,10013.0,104.0,64.0,5,216,10013.0,20.0,15.0
0.01,6,10,1989,5,910,2.0,642.0,642.0,5,1079,2.0,811.0,811.0
0.003,17,2,185,1,73,0.0,45.0,45.0,1,112,0.0,84.0,84.0
0.005,17,2,164,1,74,0.0,46.0,46.0,1,90,0.0,62.0,62.0
0.013,6,10,1989,5,910,3.0,642.0,642.0,5,1079,3.0,811.0,811.0
361.828,6,22,1857,17,1094,22614.0,190.0,190.0,5,763,60009.0,462.0,247.0
0.113,6,10,1506,5,395,25.0,127.0,127.0,5,1111,23.0,843.0,843.0
0.005,6,10,2007,5,928,1.0,660.0,660.0,5,1079,1.0,811.0,811.0
0.005,17,2,164,1,74,0.0,46.0,46.0,1,90,0.0,62.0,62.0
0.001,17,2,142,1,63,0.0,35.0,35.0,1,79,0.0,51.0,51.0
0.006,6,10,1689,5,839,1.0,571.0,571.0,5,850,1.0,582.0,582.0
0.105,6,10,1506,5,395,24.0,127.0,127.0,5,1111,25.0,843.0,843.0
0.004,17,2,148,1,60,0.0,32.0,32.0,1,88,0.0,60.0,60.0
0.004,6,10,2000,5,927,1.0,659.0,659.0,5,1073,1.0,805.0,805.0
0.013,6,10,1972,5,910,3.0,642.0,642.0,5,1062,3.0,794.0,794.0
0.011,6,10,1989,5,910,2.0,642.0,642.0,5,1079,2.0,811.0,811.0
0.095,6,10,1506,5,395,21.0,127.0,127.0,5,1111,20.0,843.0,843.0
0.004,6,10,2006,5,927,1.0,659.0,659.0,5,1079,1.0,811.0,811.0
0.006,6,10,1854,5,889,1.0,621.0,621.0,5,965,1.0,697.0,697.0
0.001,17,2,180,1,66,0.0,38.0,38.0,1,114,0.0,86.0,86.0
40.033,17,10,676,5,460,10007.0,104.0,64.0,5,216,10007.0,20.0,15.0
0.001,17,2,166,1,75,0.0,47.0,47.0,1,91,0.0,63.0,63.0
0.005,17,2,140,1,62,0.0,34.0,34.0,1,78,0.0,50.0,50.0
0.016,6,10,1972,5,910,4.0,642.0,642.0,5,1062,4.0,794.0,794.0
300.339,6,16,2170,9,684,37521.0,146.0,146.0,7,1486,50029.0,419.0,398.0
198.588,17,94,13695,47,3160,4317.0,44.0,39.0,47,10535,4317.0,239.0,196.0
0.087,6,10,1506,5,395,19.0,127.0,127.0,5,1111,20.0,843.0,843.0
0.01,6,10,1631,5,848,2.0,580.0,580.0,5,783,2.0,515.0,515.0
44.214,6,36,8190,18,1719,524.0,651.0,322.0,18,6471,2593.0,2126.0,478.0
0.005,6,10,1989,5,927,1.0,659.0,659.0,5,1062,1.0,794.0,794.0
0.075,6,10,1506,5,395,16.0,127.0,127.0,5,1111,17.0,843.0,843.0
1772.654,6,105,6270,59,3473,30562.0,27.0,27.0,46,2797,39391.0,27.0,27.0
0.002,17,2,180,1,66,0.0,38.0,38.0,1,114,0.0,86.0,86.0
0.005,6,10,2007,5,928,1.0,660.0,660.0,5,1079,1.0,811.0,811.0
0.005,6,13,3747,7,509,0.0,137.0,137.0,6,3238,1.0,1470.0,1459.0
0.0,17,2,136,1,60,0.0,32.0,32.0,1,76,0.0,48.0,48.0
0.04,17,2,166,1,75,0.0,47.0,47.0,1,91,0.0,63.0,63.0
0.005,17,2,136,1,60,0.0,32.0,32.0,1,76,0.0,48.0,48.0
0.094,6,10,1506,5,395,18.0,127.0,127.0,5,1111,20.0,843.0,843.0
0.007,17,2,170,1,65,0.0,37.0,37.0,1,105,0.0,77.0,77.0
0.005,17,2,144,1,64,0.0,36.0,36.0,1,80,0.0,52.0,52.0
0.001,17,2,180,1,66,0.0,38.0,38.0,1,114,0.0,86.0,86.0
0.005,6,10,2000,5,927,1.0,659.0,659.0,5,1073,1.0,805.0,805.0
0.009,6,12,1698,6,863,1.0,327.0,271.0,6,835,1.0,515.0,515.0
0.004,17,2,136,1,60,0.0,32.0,32.0,1,76,0.0,48.0,48.0
0.068,17,8,3613,4,1874,22.0,1350.0,440.0,4,1739,11.0,1350.0,406.0
0.067,6,10,1506,5,395,14.0,127.0,127.0,5,1111,14.0,843.0,843.0
15.069,17,15,9238,8,6902,2148.0,1350.0,834.0,7,2336,2506.0,1350.0,305.0
0.009,6,10,1990,5,911,2.0,643.0,643.0,5,1079,2.0,811.0,811.0
0.041,17,4,420,2,122,0.0,33.0,33.0,2,298,1.0,145.0,121.0
178.247,6,22,8496,12,2236,73.0,1345.0,574.0,10,6260,19786.0,2720.0,974.0
0.005,6,10,2000,5,927,1.0,659.0,659.0,5,1073,1.0,805.0,805.0
0.006,6,10,1547,5,764,1.0,496.0,496.0,5,783,1.0,515.0,515.0
0.009,6,13,3735,7,497,1.0,125.0,125.0,6,3238,1.0,1470.0,1459.0
0.09,6,10,1506,5,395,18.0,127.0,127.0,5,1111,21.0,843.0,843.0
0.132,6,10,1506,5,395,30.0,127.0,127.0,5,1111,26.0,843.0,843.0
0.005,6,10,2000,5,927,1.0,659.0,659.0,5,1073,1.0,805.0,805.0
0.003,17,2,148,1,60,0.0,32.0,32.0,1,88,0.0,60.0,60.0
0.005,6,10,2006,5,927,1.0,659.0,659.0,5,1079,1.0,811.0,811.0
0.007,6,10,1989,5,910,1.0,642.0,642.0,5,1079,1.0,811.0,811.0
0.009,6,10,1990,5,911,2.0,643.0,643.0,5,1079,2.0,811.0,811.0
0.18,17,4,352,2,130,143.0,37.0,37.0,2,222,142.0,89.0,83.0
0.006,17,2,180,1,66,0.0,38.0,38.0,1,114,0.0,86.0,86.0
0.005,6,10,2000,5,927,1.0,659.0,659.0,5,1073,1.0,805.0,805.0
0.013,6,10,1989,5,910,3.0,642.0,642.0,5,1079,3.0,811.0,811.0
0.016,6,10,1989,5,910,4.0,642.0,642.0,5,1079,3.0,811.0,811.0
0.003,17,2,234,1,61,0.0,33.0,33.0,1,173,0.0,145.0,145.0
412.014,6,29,4409,12,3102,10913.0,494.0,494.0,17,1307,25750.0,83.0,83.0
1730.41,6,54,3291,33,1950,54075.0,35.0,35.0,21,1341,86516.0,31.0,31.0
0.012,6,10,1990,5,911,2.0,643.0,643.0,5,1079,2.0,811.0,811.0
0.013,6,10,1972,5,910,3.0,642.0,642.0,5,1062,3.0,794.0,794.0
0.009,6,10,1972,5,910,2.0,642.0,642.0,5,1062,2.0,794.0,794.0
0.018,6,10,1762,5,911,4.0,643.0,643.0,5,851,4.0,583.0,583.0
0.005,6,10,2006,5,927,1.0,659.0,659.0,5,1079,1.0,811.0,811.0
0.074,6,10,1506,5,395,15.0,127.0,127.0,5,1111,18.0,843.0,843.0
0.012,6,10,1989,5,910,2.0,642.0,642.0,5,1079,2.0,811.0,811.0
15.079,17,16,9091,8,6951,2150.0,1350.0,840.0,8,2140,2150.0,1350.0,239.0
40.069,17,10,676,5,460,10014.0,104.0,64.0,5,216,10016.0,20.0,15.0
0.006,17,2,170,1,65,0.0,37.0,37.0,1,105,0.0,77.0,77.0
352.763,6,20,2210,6,1308,12005.0,494.0,494.0,14,902,27135.0,83.0,83.0
0.074,6,10,1506,5,395,16.0,127.0,127.0,5,1111,15.0,843.0,843.0
0.003,17,2,148,1,60,0.0,32.0,32.0,1,88,0.0,60.0,60.0
0.005,6,10,2006,5,927,1.0,659.0,659.0,5,1079,1.0,811.0,811.0
300.36,6,19,3160,11,1855,30036.0,676.0,318.0,8,1305,34331.0,692.0,293.0
40.075,17,10,676,5,460,10015.0,104.0,64.0,5,216,10017.0,20.0,15.0
0.009,6,10,1989,5,910,2.0,642.0,642.0,5,1079,2.0,811.0,811.0
0.019,6,10,1677,5,827,4.0,559.0,559.0,5,850,4.0,582.0,582.0
40.051,17,10,676,5,460,10011.0,104.0,64.0,5,216,10012.0,20.0,15.0
0.107,6,10,1506,5,395,21.0,127.0,127.0,5,1111,21.0,843.0,843.0
0.017,6,10,1990,5,911,4.0,643.0,643.0,5,1079,4.0,811.0,811.0
0.017,6,10,1762,5,911,4.0,643.0,643.0,5,851,4.0,583.0,583.0
0.006,6,10,1689,5,839,1.0,571.0,571.0,5,850,1.0,582.0,582.0
126.22,6,21,8456,11,2196,73.0,1345.0,574.0,10,6260,14006.0,2720.0,974.0
40.055,17,10,676,5,460,10012.0,104.0,64.0,5,216,10012.0,20.0,15.0
301.2,6,52,21025,27,14998,11584.0,2720.0,1262.0,25,6027,378.0,2667.0,385.0
0.018,6,10,1989,5,910,4.0,642.0,642.0,5,1079,4.0,811.0,811.0
0.013,6,10,1677,5,827,3.0,559.0,559.0,5,850,3.0,582.0,582.0
0.104,6,10,1506,5,395,22.0,127.0,127.0,5,1111,25.0,843.0,843.0
40.052,17,10,676,5,460,10012.0,104.0,64.0,5,216,10012.0,20.0,15.0
0.014,6,10,1972,5,910,3.0,642.0,642.0,5,1062,3.0,794.0,794.0
0.015,6,10,1990,5,911,3.0,643.0,643.0,5,1079,3.0,811.0,811.0
0.012,6,10,1990,5,911,3.0,643.0,643.0,5,1079,3.0,811.0,811.0
240.093,6,29,8981,15,6546,17149.0,1671.0,641.0,14,2435,18468.0,580.0,242.0
0.013,6,10,1989,5,910,3.0,642.0,642.0,5,1079,3.0,811.0,811.0
0.009,6,10,1990,5,911,2.0,643.0,643.0,5,1079,2.0,811.0,811.0
0.004,6,10,2006,5,927,1.0,659.0,659.0,5,1079,1.0,811.0,811.0
0.005,6,10,2006,5,927,1.0,659.0,659.0,5,1079,1.0,811.0,811.0
0.006,6,10,1547,5,764,1.0,496.0,496.0,5,783,1.0,515.0,515.0
0.083,6,10,1506,5,395,17.0,127.0,127.0,5,1111,15.0,843.0,843.0
0.012,6,10,1631,5,848,3.0,580.0,580.0,5,783,3.0,515.0,515.0
0.003,17,2,136,1,60,0.0,32.0,32.0,1,76,0.0,48.0,48.0
0.013,6,10,1989,5,910,3.0,642.0,642.0,5,1079,3.0,811.0,811.0
9.036,17,6,376,5,280,2259.0,28.0,28.0,1,96,0.0,68.0,68.0
0.006,6,10,1547,5,764,1.0,496.0,496.0,5,783,1.0,515.0,515.0
0.004,6,10,1702,5,863,0.0,595.0,595.0,5,839,1.0,571.0,571.0
0.042,17,2,146,1,65,0.0,37.0,37.0,1,81,0.0,53.0,53.0
0.149,6,10,1506,5,395,24.0,127.0,127.0,5,1111,34.0,843.0,843.0
0.131,6,10,1506,5,395,31.0,127.0,127.0,5,1111,32.0,843.0,843.0
0.143,6,10,1506,5,395,32.0,127.0,127.0,5,1111,34.0,843.0,843.0
0.094,6,10,1506,5,395,20.0,127.0,127.0,5,1111,20.0,843.0,843.0
0.012,6,10,1989,5,910,3.0,642.0,642.0,5,1079,2.0,811.0,811.0
0.02,17,2,179,1,71,0.0,43.0,43.0,1,108,0.0,80.0,80.0
172.25,17,82,11695,41,2740,4306.0,44.0,38.0,41,8955,4306.0,239.0,190.0
0.116,6,10,1506,5,395,24.0,127.0,127.0,5,1111,27.0,843.0,843.0
0.001,17,2,142,1,63,0.0,35.0,35.0,1,79,0.0,51.0,51.0
0.022,17,2,154,1,69,0.0,41.0,41.0,1,85,0.0,57.0,57.0
0.01,6,10,1689,5,839,2.0,571.0,571.0,5,850,2.0,582.0,582.0
0.016,6,10,1972,5,910,4.0,642.0,642.0,5,1062,4.0,794.0,794.0
0.104,6,10,1506,5,395,25.0,127.0,127.0,5,1111,23.0,843.0,843.0
0.086,6,10,1506,5,395,18.0,127.0,127.0,5,1111,19.0,843.0,843.0
0.011,6,10,1972,5,910,2.0,642.0,642.0,5,1062,2.0,794.0,794.0
0.075,6,10,1506,5,395,13.0,127.0,127.0,5,1111,17.0,843.0,843.0
0.004,6,10,2000,5,927,1.0,659.0,659.0,5,1073,1.0,805.0,805.0
0.005,6,10,1989,5,927,1.0,659.0,659.0,5,1062,1.0,794.0,794.0
0.111,6,10,1506,5,395,23.0,127.0,127.0,5,1111,26.0,843.0,843.0
0.014,6,10,1983,5,910,3.0,642.0,642.0,5,1073,3.0,805.0,805.0
0.205,6,16,2777,8,1395,29.0,533.0,323.0,8,1382,18.0,529.0,239.0
0.011,6,10,2006,5,927,2.0,659.0,659.0,5,1079,2.0,811.0,811.0
0.013,17,2,152,1,56,0.0,28.0,28.0,1,96,0.0,68.0,68.0
0.005,6,10,1989,5,927,1.0,659.0,659.0,5,1062,1.0,794.0,794.0
0.006,17,2,230,1,68,0.0,40.0,40.0,1,162,0.0,134.0,134.0
300.103,6,39,10113,21,4595,14996.0,1360.0,620.0,18,5518,17643.0,2667.0,435.0
0.013,6,10,1990,5,911,3.0,643.0,643.0,5,1079,3.0,811.0,811.0
0.133,6,10,1506,5,395,31.0,127.0,127.0,5,1111,30.0,843.0,843.0
0.099,6,10,1506,5,395,19.0,127.0,127.0,5,1111,23.0,843.0,843.0
0.005,17,2,180,1,58,0.0,30.0,30.0,1,122,0.0,94.0,94.0
169.488,17,78,11315,39,2618,4460.0,44.0,39.0,39,8697,4460.0,239.0,195.0
0.075,6,10,1506,5,395,16.0,127.0,127.0,5,1111,15.0,843.0,843.0
0.007,6,10,1689,5,839,1.0,571.0,571.0,5,850,1.0,582.0,582.0
0.236,6,16,2669,8,1395,33.0,533.0,323.0,8,1274,22.0,529.0,212.0
0.013,6,10,1990,5,911,3.0,643.0,643.0,5,1079,3.0,811.0,811.0
240.172,6,40,5412,19,2386,13342.0,588.0,196.0,21,3026,12008.0,580.0,240.0
0.005,6,10,2000,5,927,1.0,659.0,659.0,5,1073,1.0,805.0,805.0
0.005,6,10,2007,5,928,1.0,660.0,660.0,5,1079,1.0,811.0,811.0
0.013,6,10,1762,5,911,3.0,643.0,643.0,5,851,3.0,583.0,583.0
0.006,6,10,1689,5,839,1.0,571.0,571.0,5,850,1.0,582.0,582.0
0.005,6,10,1643,5,860,1.0,592.0,592.0,5,783,1.0,515.0,515.0
0.003,17,2,152,1,76,0.0,48.0,48.0,1,76,0.0,48.0,48.0
1785.573,6,240,46397,116,33935,15526.0,2472.0,1072.0,124,12462,14516.0,580.0,62.0
0.017,6,10,1990,5,911,4.0,643.0,643.0,5,1079,4.0,811.0,811.0
0.019,6,10,1990,5,911,4.0,643.0,643.0,5,1079,4.0,811.0,811.0
0.102,6,10,1506,5,395,22.0,127.0,127.0,5,1111,24.0,843.0,843.0
0.004,6,10,2007,5,928,1.0,660.0,660.0,5,1079,1.0,811.0,811.0
0.005,6,14,3799,7,509,0.0,137.0,137.0,7,3290,0.0,1448.0,972.0
0.084,6,10,1506,5,395,17.0,127.0,127.0,5,1111,17.0,843.0,843.0
301.209,6,54,24239,28,18172,11155.0,2720.0,1418.0,26,6067,364.0,2667.0,385.0
0.132,17,2,80,1,32,0.0,4.0,4.0,1,48,0.0,20.0,20.0
0.005,6,10,1854,5,889,1.0,621.0,621.0,5,965,1.0,697.0,697.0
0.005,6,10,2007,5,928,1.0,660.0,660.0,5,1079,1.0,811.0,811.0
0.123,17,4,284,2,120,0.0,32.0,32.0,2,164,120.0,60.0,54.0
0.004,6,10,1989,5,927,1.0,659.0,659.0,5,1062,1.0,794.0,794.0
0.171,17,2,152,1,76,0.0,48.0,48.0,1,76,0.0,48.0,48.0
0.004,17,2,136,1,60,0.0,32.0,32.0,1,76,0.0,48.0,48.0
0.011,6,10,1972,5,910,2.0,642.0,642.0,5,1062,2.0,794.0,794.0
0.004,17,2,186,1,61,0.0,33.0,33.0,1,125,0.0,97.0,97.0
0.011,6,10,1989,5,910,2.0,642.0,642.0,5,1079,2.0,811.0,811.0
0.039,17,2,182,1,65,0.0,37.0,37.0,1,117,0.0,89.0,89.0
11.47,17,28,4366,14,2312,869.0,587.0,137.0,14,2054,869.0,269.0,118.0
0.054,6,10,1506,5,395,13.0,127.0,127.0,5,1111,12.0,843.0,843.0
0.039,17,4,284,2,120,0.0,32.0,32.0,2,164,36.0,60.0,54.0
0.012,6,10,1631,5,848,2.0,580.0,580.0,5,783,2.0,515.0,515.0
0.111,6,10,1506,5,395,24.0,127.0,127.0,5,1111,24.0,843.0,843.0
0.005,6,10,2007,5,928,1.0,660.0,660.0,5,1079,1.0,811.0,811.0
1792.031,6,553,191143,282,164379,6377.0,2883.0,935.0,271,26764,6637.0,580.0,124.0
0.005,17,2,170,1,65,0.0,37.0,37.0,1,105,0.0,77.0,77.0
0.007,17,2,179,1,71,0.0,43.0,43.0,1,108,0.0,80.0,80.0
40.058,17,10,676,5,460,10013.0,104.0,64.0,5,216,10013.0,20.0,15.0
0.023,6,10,1972,5,910,5.0,642.0,642.0,5,1062,5.0,794.0,794.0
0.016,6,10,1989,5,910,3.0,642.0,642.0,5,1079,3.0,811.0,811.0
0.019,6,10,1983,5,910,4.0,642.0,642.0,5,1073,4.0,805.0,805.0
0.006,6,10,2000,5,927,1.0,659.0,659.0,5,1073,1.0,805.0,805.0
0.005,17,2,168,1,76,0.0,48.0,48.0,1,92,0.0,64.0,64.0
0.136,6,10,1506,5,395,32.0,127.0,127.0,5,1111,31.0,843.0,843.0
0.087,6,10,1506,5,395,18.0,127.0,127.0,5,1111,18.0,843.0,843.0
0.009,6,10,1989,5,910,2.0,642.0,642.0,5,1079,2.0,811.0,811.0
240.187,6,29,10379,13,4003,20015.0,1474.0,666.0,16,6376,16012.0,1591.0,615.0
0.014,17,2,152,1,56,0.0,28.0,28.0,1,96,0.0,68.0,68.0
0.006,6,10,1854,5,889,1.0,621.0,621.0,5,965,1.0,697.0,697.0
0.006,17,2,179,1,71,0.0,43.0,43.0,1,108,0.0,80.0,80.0
0.012,6,10,1677,5,827,3.0,559.0,559.0,5,850,3.0,582.0,582.0
0.005,6,10,1547,5,764,1.0,496.0,496.0,5,783,1.0,515.0,515.0
0.008,6,10,1631,5,848,1.0,580.0,580.0,5,783,2.0,515.0,515.0
40.069,17,10,676,5,460,10016.0,104.0,64.0,5,216,10016.0,20.0,15.0
0.025,6,10,1990,5,911,6.0,643.0,643.0,5,1079,6.0,811.0,811.0
0.037,6,10,1990,5,911,9.0,643.0,643.0,5,1079,9.0,811.0,811.0
0.001,17,2,180,1,66,0.0,38.0,38.0,1,114,0.0,86.0,86.0
0.113,6,10,1506,5,395,26.0,127.0,127.0,5,1111,23.0,843.0,843.0
0.225,6,19,6390,9,1446,28.0,533.0,323.0,10,4944,19.0,1402.0,736.0
308.581,17,20,1124,10,716,34278.0,48.0,43.0,10,408,34278.0,20.0,12.0
0.01,6,10,1972,5,910,2.0,642.0,642.0,5,1062,2.0,794.0,794.0
240.075,6,16,4481,9,963,30009.0,238.0,166.0,7,3518,40012.0,1402.0,786.0
40.082,17,10,676,5,460,10018.0,104.0,64.0,5,216,10019.0,20.0,15.0
40.061,17,10,676,5,460,10014.0,104.0,64.0,5,216,10014.0,20.0,15.0
15.075,17,15,9238,8,6902,2149.0,1350.0,834.0,7,2336,2507.0,1350.0,305.0
0.015,6,10,1762,5,911,3.0,643.0,643.0,5,851,3.0,583.0,583.0
0.004,6,10,1702,5,863,1.0,595.0,595.0,5,839,1.0,571.0,571.0
0.075,6,10,1506,5,395,17.0,127.0,127.0,5,1111,15.0,843.0,843.0
0.008,17,2,194,1,59,0.0,31.0,31.0,1,135,0.0,107.0,107.0
0.003,17,2,136,1,60,0.0,32.0,32.0,1,76,0.0,48.0,48.0
0.009,17,2,194,1,59,0.0,31.0,31.0,1,135,0.0,107.0,107.0
0.001,17,2,154,1,69,0.0,41.0,41.0,1,85,0.0,57.0,57.0
0.011,6,13,3913,7,495,1.0,123.0,123.0,6,3418,2.0,1650.0,1549.0
0.006,17,2,170,1,65,0.0,37.0,37.0,1,105,0.0,77.0,77.0
0.006,6,10,1547,5,764,1.0,496.0,496.0,5,783,1.0,515.0,515.0
0.029,6,10,690,6,391,5.0,71.0,71.0,4,299,4.0,83.0,83.0
0.018,6,10,1990,5,911,4.0,643.0,643.0,5,1079,4.0,811.0,811.0
0.003,17,2,136,1,60,0.0,32.0,32.0,1,76,0.0,48.0,48.0
0.102,6,10,1506,5,395,23.0,127.0,127.0,5,1111,21.0,843.0,843.0
0.013,6,10,1990,5,911,3.0,643.0,643.0,5,1079,3.0,811.0,811.0
0.069,6,10,1506,5,395,15.0,127.0,127.0,5,1111,16.0,843.0,843.0
1770.266,17,92,8096,46,4048,39339.0,60.0,60.0,46,4048,39339.0,60.0,60.0
0.006,6,10,2006,5,927,1.0,659.0,659.0,5,1079,1.0,811.0,811.0
0.005,6,10,2000,5,927,1.0,659.0,659.0,5,1073,1.0,805.0,805.0
0.014,6,10,1989,5,910,3.0,642.0,642.0,5,1079,3.0,811.0,811.0
0.011,6,10,1631,5,848,2.0,580.0,580.0,5,783,2.0,515.0,515.0
240.117,6,32,9005,16,6543,16007.0,1614.0,635.0,16,2462,16007.0,580.0,202.0
0.005,17,2,140,1,62,0.0,34.0,34.0,1,78,0.0,50.0,50.0
0.009,6,7,695,4,448,3.0,232.0,232.0,3,247,2.0,83.0,83.0
0.005,17,2,212,1,74,0.0,46.0,46.0,1,138,0.0,110.0,110.0
0.115,6,10,1506,5,395,28.0,127.0,127.0,5,1111,27.0,843.0,843.0
0.005,6,10,2006,5,927,1.0,659.0,659.0,5,1079,1.0,811.0,811.0
0.01,6,10,1983,5,910,2.0,642.0,642.0,5,1073,2.0,805.0,805.0
0.001,17,2,136,1,60,0.0,32.0,32.0,1,76,0.0,48.0,48.0
11.177,17,28,4420,14,1995,847.0,270.0,114.0,14,2425,847.0,588.0,145.0
0.017,6,10,1762,5,911,4.0,643.0,643.0,5,851,4.0,583.0,583.0
15.072,17,15,9238,8,6902,2149.0,1350.0,834.0,7,2336,2507.0,1350.0,305.0
0.005,6,10,2007,5,928,1.0,660.0,660.0,5,1079,1.0,811.0,811.0
0.129,17,2,136,1,60,0.0,32.0,32.0,1,76,0.0,48.0,48.0
0.071,6,10,1506,5,395,16.0,127.0,127.0,5,1111,14.0,843.0,843.0
0.013,6,10,1990,5,911,3.0,643.0,643.0,5,1079,3.0,811.0,811.0
0.01,6,10,1631,5,848,2.0,580.0,580.0,5,783,2.0,515.0,515.0
176.094,17,70,9954,35,2330,5179.0,44.0,38.0,35,7624,5179.0,252.0,189.0
0.014,6,10,1677,5,827,3.0,559.0,559.0,5,850,3.0,582.0,582.0
0.079,6,10,1506,5,395,16.0,127.0,127.0,5,1111,17.0,843.0,843.0
0.001,17,2,166,1,75,0.0,47.0,47.0,1,91,0.0,63.0,63.0
0.005,6,10,1989,5,927,1.0,659.0,659.0,5,1062,1.0,794.0,794.0
0.015,6,10,1972,5,910,3.0,642.0,642.0,5,1062,3.0,794.0,794.0
0.001,17,2,180,1,66,0.0,38.0,38.0,1,114,0.0,86.0,86.0
0.004,17,2,148,1,60,0.0,32.0,32.0,1,88,0.0,60.0,60.0
0.005,6,10,1689,5,839,1.0,571.0,571.0,5,850,1.0,582.0,582.0
0.001,17,2,180,1,66,0.0,38.0,38.0,1,114,0.0,86.0,86.0
0.006,6,10,2000,5,927,1.0,659.0,659.0,5,1073,1.0,805.0,805.0
0.005,17,2,179,1,71,0.0,43.0,43.0,1,108,0.0,80.0,80.0
240.029,6,9,787,5,488,60007.0,232.0,232.0,4,299,80009.0,83.0,83.0
0.005,6,10,2006,5,927,1.0,659.0,659.0,5,1079,1.0,811.0,811.0
0.016,6,10,1631,5,848,3.0,580.0,580.0,5,783,3.0,515.0,515.0
0.005,6,10,1989,5,927,1.0,659.0,659.0,5,1062,1.0,794.0,794.0
0.067,6,10,1506,5,395,13.0,127.0,127.0,5,1111,16.0,843.0,843.0
0.004,6,10,2007,5,928,1.0,660.0,660.0,5,1079,1.0,811.0,811.0
0.004,17,2,148,1,60,0.0,32.0,32.0,1,88,0.0,60.0,60.0
0.004,6,10,2007,5,928,1.0,660.0,660.0,5,1079,1.0,811.0,811.0
0.005,6,10,1643,5,860,1.0,592.0,592.0,5,783,1.0,515.0,515.0
368.872,6,22,2313,16,867,24591.0,195.0,195.0,6,1446,4643.0,419.0,398.0
0.008,6,10,1762,5,911,2.0,643.0,643.0,5,851,2.0,583.0,583.0
170.356,17,78,11205,39,2593,4482.0,44.0,38.0,39,8612,4482.0,239.0,192.0
0.009,6,10,1983,5,910,2.0,642.0,642.0,5,1073,2.0,805.0,805.0
0.021,6,10,1972,5,910,5.0,642.0,642.0,5,1062,5.0,794.0,794.0
0.067,17,8,3613,4,1874,22.0,1350.0,440.0,4,1739,10.0,1350.0,406.0
15.072,17,15,9238,8,6902,2149.0,1350.0,834.0,7,2336,2507.0,1350.0,305.0
0.008,17,2,148,1,60,0.0,32.0,32.0,1,88,0.0,60.0,60.0
0.009,6,10,1989,5,910,2.0,642.0,642.0,5,1079,2.0,811.0,811.0
0.005,6,10,2006,5,927,1.0,659.0,659.0,5,1079,1.0,811.0,811.0
0.011,6,10,1990,5,911,2.0,643.0,643.0,5,1079,2.0,811.0,811.0
0.005,6,10,2007,5,928,1.0,660.0,660.0,5,1079,1.0,811.0,811.0
0.005,6,10,2006,5,927,1.0,659.0,659.0,5,1079,1.0,811.0,811.0
0.741,6,10,2009,6,1655,148.0,1403.0,1403.0,4,354,169.0,182.0,182.0
0.072,17,2,234,1,61,0.0,33.0,33.0,1,173,0.0,145.0,145.0
0.124,6,10,1506,5,395,28.0,127.0,127.0,5,1111,25.0,843.0,843.0
0.001,17,2,180,1,66,0.0,38.0,38.0,1,114,0.0,86.0,86.0
0.012,6,13,3735,7,497,2.0,125.0,125.0,6,3238,2.0,1470.0,1459.0
0.005,6,10,1779,5,928,1.0,660.0,660.0,5,851,1.0,583.0,583.0
15.069,17,15,9238,8,6902,2148.0,1350.0,834.0,7,2336,2506.0,1350.0,305.0
0.138,6,10,1506,5,395,30.0,127.0,127.0,5,1111,29.0,843.0,843.0
0.017,6,10,1989,5,910,4.0,642.0,642.0,5,1079,4.0,811.0,811.0
0.008,6,10,1989,5,910,2.0,642.0,642.0,5,1079,2.0,811.0,811.0
0.018,6,10,1631,5,848,4.0,580.0,580.0,5,783,4.0,515.0,515.0
0.082,6,10,1506,5,395,19.0,127.0,127.0,5,1111,17.0,843.0,843.0
0.259,17,40,20255,22,17100,12.0,1350.0,749.0,18,3155,11.0,1350.0,147.0
10.731,17,28,4418,14,1994,817.0,269.0,114.0,14,2424,816.0,587.0,145.0
56.385,6,40,10527,20,4929,470.0,1360.0,682.0,20,5598,2959.0,2667.0,435.0
0.029,6,10,1989,5,910,7.0,642.0,642.0,5,1079,7.0,811.0,811.0
0.133,17,4,364,2,160,0.0,52.0,52.0,2,204,87.0,80.0,74.0
0.001,17,2,180,1,66,0.0,38.0,38.0,1,114,0.0,86.0,86.0
0.01,6,10,2006,5,927,2.0,659.0,659.0,5,1079,2.0,811.0,811.0
5.304,6,24,6614,14,1552,407.0,474.0,201.0,10,5062,589.0,1925.0,757.0
70.748,6,22,8496,12,2236,72.0,1345.0,574.0,10,6260,7841.0,2720.0,974.0
0.009,6,10,2007,5,928,2.0,660.0,660.0,5,1079,2.0,811.0,811.0
0.013,6,10,1989,5,910,3.0,642.0,642.0,5,1079,3.0,811.0,811.0
0.086,6,10,1506,5,395,19.0,127.0,127.0,5,1111,17.0,843.0,843.0
167.301,17,72,10304,36,2410,4779.0,44.0,38.0,36,7894,4779.0,239.0,191.0
290.038,6,413,348685,204,22171,1428.0,2736.0,888.0,209,326514,1394.0,2804.0,1618.0
0.082,6,10,1506,5,395,19.0,127.0,127.0,5,1111,18.0,843.0,843.0
10.975,17,28,4417,14,1993,833.0,268.0,114.0,14,2424,835.0,587.0,145.0
0.044,17,2,152,1,76,0.0,48.0,48.0,1,76,0.0,48.0,48.0
0.001,17,2,357,1,68,0.0,40.0,40.0,1,289,0.0,261.0,261.0
0.072,6,10,1506,5,395,15.0,127.0,127.0,5,1111,17.0,843.0,843.0
0.008,6,12,1698,6,863,1.0,327.0,271.0,6,835,1.0,515.0,515.0
0.126,6,10,1506,5,395,25.0,127.0,127.0,5,1111,26.0,843.0,843.0
174.193,17,94,13818,47,3142,3786.0,44.0,38.0,47,10676,3786.0,261.0,199.0
0.006,6,10,1547,5,764,1.0,496.0,496.0,5,783,1.0,515.0,515.0
0.004,6,10,1774,5,923,1.0,655.0,655.0,5,851,1.0,583.0,583.0
86.877,6,22,9233,11,1575,84.0,794.0,367.0,11,7658,8674.0,1360.0,1029.0
40.031,17,10,676,5,460,10006.0,104.0,64.0,5,216,10006.0,20.0,15.0
0.006,17,2,180,1,66,0.0,38.0,38.0,1,114,0.0,86.0,86.0
0.004,6,10,2000,5,927,1.0,659.0,659.0,5,1073,1.0,805.0,805.0
0.01,6,13,3735,7,497,1.0,125.0,125.0,6,3238,1.0,1470.0,1459.0
0.005,6,10,1689,5,839,1.0,571.0,571.0,5,850,1.0,582.0,582.0
0.006,6,10,1689,5,839,1.0,571.0,571.0,5,850,1.0,582.0,582.0
176.186,17,82,11727,41,2745,4404.0,44.0,38.0,41,8982,4404.0,261.0,191.0
0.003,17,2,136,1,60,0.0,32.0,32.0,1,76,0.0,48.0,48.0
0.004,6,10,2006,5,927,1.0,659.0,659.0,5,1079,1.0,811.0,811.0
0.4,17,55,33437,32,28598,12.0,1350.0,865.0,23,4839,15.0,1350.0,182.0
0.003,17,4,284,2,120,1.0,32.0,32.0,2,164,0.0,60.0,54.0
0.074,17,4,284,2,120,3.0,32.0,32.0,2,164,70.0,60.0,54.0
240.011,6,9,787,5,488,60002.0,232.0,232.0,4,299,80002.0,83.0,83.0
40.056,17,10,676,5,460,10011.0,104.0,64.0,5,216,10012.0,20.0,15.0
0.022,6,10,1972,5,910,5.0,642.0,642.0,5,1062,5.0,794.0,794.0
0.001,17,2,166,1,75,0.0,47.0,47.0,1,91,0.0,63.0,63.0
0.008,6,10,1989,5,910,2.0,642.0,642.0,5,1079,2.0,811.0,811.0
0.006,6,10,1854,5,889,1.0,621.0,621.0,5,965,1.0,697.0,697.0
0.005,6,13,3747,7,509,0.0,137.0,137.0,6,3238,1.0,1470.0,1459.0
0.008,6,10,1983,5,910,2.0,642.0,642.0,5,1073,2.0,805.0,805.0
0.1,6,10,1506,5,395,22.0,127.0,127.0,5,1111,21.0,843.0,843.0
10.909,17,28,4421,14,1994,831.0,269.0,114.0,14,2427,831.0,586.0,145.0
0.005,6,10,2007,5,928,1.0,660.0,660.0,5,1079,1.0,811.0,811.0
0.003,17,2,136,1,60,0.0,32.0,32.0,1,76,0.0,48.0,48.0
0.014,6,10,1972,5,910,3.0,642.0,642.0,5,1062,3.0,794.0,794.0
0.079,6,10,1506,5,395,16.0,127.0,127.0,5,1111,16.0,843.0,843.0
15.073,17,15,8005,8,5874,2149.0,1350.0,706.0,7,2131,2507.0,1350.0,276.0
0.005,17,2,170,1,65,0.0,37.0,37.0,1,105,0.0,77.0,77.0
0.011,6,13,3735,7,497,1.0,125.0,125.0,6,3238,2.0,1470.0,1459.0
40.064,17,10,676,5,460,10014.0,104.0,64.0,5,216,10015.0,20.0,15.0
361.855,6,19,1688,15,978,25846.0,190.0,190.0,4,710,80012.0,494.0,494.0
0.072,6,10,1506,5,395,14.0,127.0,127.0,5,1111,15.0,843.0,843.0
240.282,6,44,8825,22,5738,11441.0,1368.0,458.0,22,3087,11441.0,580.0,241.0
0.007,17,4,284,2,120,0.0,32.0,32.0,2,164,0.0,60.0,54.0
0.007,6,13,3690,7,452,1.0,80.0,80.0,6,3238,1.0,1470.0,1459.0
11.176,17,28,4423,14,1994,847.0,269.0,114.0,14,2429,847.0,588.0,145.0
0.006,6,10,1547,5,764,1.0,496.0,496.0,5,783,1.0,515.0,515.0
0.02,6,10,1983,5,910,5.0,642.0,642.0,5,1073,4.0,805.0,805.0
0.005,17,2,169,1,62,0.0,34.0,34.0,1,107,0.0,79.0,79.0
240.741,6,37,9657,19,2173,13372.0,745.0,235.0,18,7484,14159.0,1402.0,595.0
0.062,6,10,1506,5,395,14.0,127.0,127.0,5,1111,14.0,843.0,843.0
0.018,6,10,1677,5,827,4.0,559.0,559.0,5,850,4.0,582.0,582.0
0.007,17,2,194,1,59,0.0,31.0,31.0,1,135,0.0,107.0,107.0
308.598,17,20,1124,10,716,34274.0,48.0,43.0,10,408,34274.0,20.0,12.0
0.003,6,10,1702,5,863,0.0,595.0,595.0,5,839,0.0,571.0,571.0
0.001,17,2,136,1,60,0.0,32.0,32.0,1,76,0.0,48.0,48.0
0.005,6,10,1854,5,889,1.0,621.0,621.0,5,965,1.0,697.0,697.0
0.004,6,10,2007,5,928,1.0,660.0,660.0,5,1079,1.0,811.0,811.0
0.005,6,13,3690,7,452,0.0,80.0,80.0,6,3238,0.0,1470.0,1459.0
0.04,17,2,170,1,65,0.0,37.0,37.0,1,105,0.0,77.0,77.0
0.006,6,10,1547,5,764,1.0,496.0,496.0,5,783,1.0,515.0,515.0
0.003,17,2,160,1,72,0.0,44.0,44.0,1,88,0.0,60.0,60.0
0.107,6,10,1506,5,395,24.0,127.0,127.0,5,1111,21.0,843.0,843.0
0.069,6,10,1506,5,395,16.0,127.0,127.0,5,1111,13.0,843.0,843.0
0.005,6,10,1689,5,839,1.0,571.0,571.0,5,850,1.0,582.0,582.0
0.005,6,10,1689,5,839,1.0,571.0,571.0,5,850,1.0,582.0,582.0
0.019,6,10,1631,5,848,4.0,580.0,580.0,5,783,4.0,515.0,515.0
0.011,6,10,1989,5,910,2.0,642.0,642.0,5,1079,2.0,811.0,811.0
15.075,17,14,9190,8,6902,2149.0,1350.0,834.0,6,2288,3009.0,1350.0,353.0
0.001,17,2,180,1,66,0.0,38.0,38.0,1,114,0.0,86.0,86.0
0.023,17,2,148,1,60,0.0,32.0,32.0,1,88,0.0,60.0,60.0
0.001,17,2,164,1,74,0.0,46.0,46.0,1,90,0.0,62.0,62.0
0.001,17,2,180,1,66,0.0,38.0,38.0,1,114,0.0,86.0,86.0
0.004,17,2,148,1,60,0.0,32.0,32.0,1,88,0.0,60.0,60.0
0.007,17,2,179,1,71,0.0,43.0,43.0,1,108,0.0,80.0,80.0
0.006,6,10,1547,5,764,1.0,496.0,496.0,5,783,1.0,515.0,515.0
0.018,6,10,1990,5,911,4.0,643.0,643.0,5,1079,4.0,811.0,811.0
0.279,17,16,8660,8,6101,39.0,1350.0,734.0,8,2559,24.0,1350.0,291.0
280.667,6,26,6520,12,1266,25515.0,267.0,156.0,14,5254,21589.0,1400.0,781.0
40.067,17,10,676,5,460,10013.0,104.0,64.0,5,216,10015.0,20.0,15.0
0.009,6,10,1972,5,910,2.0,642.0,642.0,5,1062,2.0,794.0,794.0
0.15,17,4,596,2,122,146.0,33.0,33.0,2,474,107.0,323.0,209.0
0.039,17,2,152,1,76,0.0,48.0,48.0,1,76,0.0,48.0,48.0
0.009,6,10,1989,5,910,2.0,642.0,642.0,5,1079,2.0,811.0,811.0
0.006,6,10,1547,5,764,1.0,496.0,496.0,5,783,1.0,515.0,515.0
0.003,17,2,203,1,61,0.0,33.0,33.0,1,142,0.0,114.0,114.0
0.01,6,10,1983,5,910,2.0,642.0,642.0,5,1073,2.0,805.0,805.0
0.1,6,10,1506,5,395,22.0,127.0,127.0,5,1111,22.0,843.0,843.0
0.146,17,4,420,2,122,0.0,33.0,33.0,2,298,135.0,145.0,121.0
15.073,17,14,9190,8,6902,2149.0,1350.0,834.0,6,2288,3008.0,1350.0,353.0
240.008,6,9,787,5,488,60002.0,232.0,232.0,4,299,80002.0,83.0,83.0
15.076,17,15,8372,8,6150,2149.0,1350.0,740.0,7,2222,2507.0,1350.0,289.0
0.103,6,10,1506,5,395,22.0,127.0,127.0,5,1111,23.0,843.0,843.0
0.006,17,2,367,1,99,0.0,71.0,71.0,1,268,0.0,240.0,240.0
15.353,17,43,20301,21,17037,766.0,1350.0,783.0,22,3264,729.0,1350.0,120.0
40.056,17,10,676,5,460,10012.0,104.0,64.0,5,216,10013.0,20.0,15.0
0.007,17,2,179,1,71,0.0,43.0,43.0,1,108,0.0,80.0,80.0
0.005,6,13,3690,7,452,0.0,80.0,80.0,6,3238,1.0,1470.0,1459.0
0.111,6,10,1506,5,395,26.0,127.0,127.0,5,1111,24.0,843.0,843.0
40.075,17,10,676,5,460,10015.0,104.0,64.0,5,216,10017.0,20.0,15.0
0.005,6,10,1547,5,764,1.0,496.0,496.0,5,783,1.0,515.0,515.0
0.12,6,10,1506,5,395,26.0,127.0,127.0,5,1111,25.0,843.0,843.0
0.012,6,10,1989,5,910,2.0,642.0,642.0,5,1079,2.0,811.0,811.0
0.01,6,10,1631,5,848,2.0,580.0,580.0,5,783,2.0,515.0,515.0
0.006,6,10,2006,5,927,1.0,659.0,659.0,5,1079,1.0,811.0,811.0
0.006,6,10,1547,5,764,1.0,496.0,496.0,5,783,1.0,515.0,515.0
0.005,6,10,2006,5,927,1.0,659.0,659.0,5,1079,1.0,811.0,811.0
300.382,6,16,2170,9,684,37526.0,146.0,146.0,7,1486,50035.0,419.0,398.0
40.047,17,10,676,5,460,10010.0,104.0,64.0,5,216,10010.0,20.0,15.0
0.102,6,10,1506,5,395,22.0,127.0,127.0,5,1111,22.0,843.0,843.0
40.057,17,10,676,5,460,10013.0,104.0,64.0,5,216,10013.0,20.0,15.0
0.005,6,10,1854,5,889,1.0,621.0,621.0,5,965,1.0,697.0,697.0
10.861,17,28,4422,14,1994,826.0,269.0,114.0,14,2428,826.0,587.0,145.0
0.005,6,10,2006,5,927,1.0,659.0,659.0,5,1079,1.0,811.0,811.0
0.141,6,10,1506,5,395,32.0,127.0,127.0,5,1111,33.0,843.0,843.0
0.013,6,10,1990,5,911,3.0,643.0,643.0,5,1079,3.0,811.0,811.0
0.111,17,4,596,2,122,108.0,33.0,33.0,2,474,107.0,323.0,209.0
0.005,17,2,144,1,64,0.0,36.0,36.0,1,80,0.0,52.0,52.0
0.084,6,10,1506,5,395,18.0,127.0,127.0,5,1111,18.0,843.0,843.0
0.005,6,10,1854,5,889,1.0,621.0,621.0,5,965,1.0,697.0,697.0
0.005,6,10,2006,5,927,1.0,659.0,659.0,5,1079,1.0,811.0,811.0
0.006,6,10,1547,5,764,1.0,496.0,496.0,5,783,1.0,515.0,515.0
18.968,6,34,6304,19,1378,1053.0,267.0,195.0,15,4926,614.0,1823.0,392.0
0.11,6,10,1506,5,395,25.0,127.0,127.0,5,1111,24.0,843.0,843.0
0.005,6,10,2006,5,927,1.0,659.0,659.0,5,1079,1.0,811.0,811.0
1771.862,17,120,11460,60,5460,30031.0,63.0,63.0,60,6000,30031.0,72.0,72.0
40.061,17,10,676,5,460,10012.0,104.0,64.0,5,216,10014.0,20.0,15.0
240.088,6,16,4481,9,963,30011.0,238.0,166.0,7,3518,40014.0,1402.0,786.0
0.005,17,2,213,1,69,0.0,41.0,41.0,1,144,0.0,116.0,116.0
0.017,6,10,1990,5,911,4.0,643.0,643.0,5,1079,4.0,811.0,811.0
0.004,6,10,1989,5,927,1.0,659.0,659.0,5,1062,1.0,794.0,794.0
10.816,17,28,4423,14,1995,823.0,270.0,114.0,14,2428,823.0,587.0,145.0
40.066,17,10,676,5,460,10013.0,104.0,64.0,5,216,10015.0,20.0,15.0
0.005,17,2,180,1,66,0.0,38.0,38.0,1,114,0.0,86.0,86.0
0.01,6,10,1989,5,910,2.0,642.0,642.0,5,1079,2.0,811.0,811.0
0.006,6,10,1854,5,889,1.0,621.0,621.0,5,965,1.0,697.0,697.0
0.004,6,10,1702,5,863,1.0,595.0,595.0,5,839,1.0,571.0,571.0
0.01,6,10,1689,5,839,2.0,571.0,571.0,5,850,2.0,582.0,582.0
0.041,17,2,136,1,60,0.0,32.0,32.0,1,76,0.0,48.0,48.0
0.013,6,10,1972,5,910,3.0,642.0,642.0,5,1062,3.0,794.0,794.0
0.018,6,10,1983,5,910,4.0,642.0,642.0,5,1073,4.0,805.0,805.0
361.775,6,21,1793,16,1030,24118.0,190.0,190.0,5,763,60010.0,462.0,247.0
0.003,17,2,148,1,60,0.0,32.0,32.0,1,88,0.0,60.0,60.0
0.001,17,2,268,1,70,0.0,42.0,42.0,1,198,0.0,170.0,170.0
0.005,6,10,1989,5,927,1.0,659.0,659.0,5,1062,1.0,794.0,794.0
0.007,6,10,1774,5,923,1.0,655.0,655.0,5,851,1.0,583.0,583.0
0.004,6,10,2006,5,927,1.0,659.0,659.0,5,1079,1.0,811.0,811.0
15.074,17,15,9238,8,6902,2149.0,1350.0,834.0,7,2336,2507.0,1350.0,305.0
0.009,6,10,1990,5,911,2.0,643.0,643.0,5,1079,2.0,811.0,811.0
0.007,6,10,1689,5,839,1.0,571.0,571.0,5,850,1.0,582.0,582.0
0.011,6,13,3735,7,497,1.0,125.0,125.0,6,3238,2.0,1470.0,1459.0
0.006,6,10,1989,5,927,1.0,659.0,659.0,5,1062,1.0,794.0,794.0
0.113,6,10,1506,5,395,24.0,127.0,127.0,5,1111,23.0,843.0,843.0
0.014,6,10,1983,5,910,3.0,642.0,642.0,5,1073,3.0,805.0,805.0
0.005,17,2,157,1,59,0.0,31.0,31.0,1,98,0.0,70.0,70.0
0.067,17,8,3613,4,1874,22.0,1350.0,440.0,4,1739,10.0,1350.0,406.0
0.005,6,10,2006,5,927,1.0,659.0,659.0,5,1079,1.0,811.0,811.0
0.013,6,13,3735,7,497,2.0,125.0,125.0,6,3238,2.0,1470.0,1459.0
1770.524,17,92,8096,46,4048,39344.0,60.0,60.0,46,4048,39344.0,60.0,60.0
0.004,6,10,2006,5,927,1.0,659.0,659.0,5,1079,1.0,811.0,811.0
0.006,6,10,1547,5,764,1.0,496.0,496.0,5,783,1.0,515.0,515.0
0.011,6,10,1983,5,910,2.0,642.0,642.0,5,1073,2.0,805.0,805.0
0.174,6,10,1506,5,395,40.0,127.0,127.0,5,1111,22.0,843.0,843.0
1792.595,6,494,99993,249,88603,7227.0,421.0,365.0,245,11390,7346.0,53.0,53.0
0.012,6,10,1631,5,848,3.0,580.0,580.0,5,783,2.0,515.0,515.0
0.014,6,13,3735,7,497,2.0,125.0,125.0,6,3238,2.0,1470.0,1459.0
0.005,6,13,3747,7,509,0.0,137.0,137.0,6,3238,0.0,1470.0,1459.0
0.208,6,16,2669,8,1395,29.0,533.0,323.0,8,1274,19.0,529.0,212.0
0.006,6,10,1547,5,764,1.0,496.0,496.0,5,783,1.0,515.0,515.0
0.094,6,10,1506,5,395,19.0,127.0,127.0,5,1111,19.0,843.0,843.0
0.005,6,10,2000,5,927,1.0,659.0,659.0,5,1073,1.0,805.0,805.0
0.005,6,10,1774,5,923,1.0,655.0,655.0,5,851,1.0,583.0,583.0
0.099,6,10,1506,5,395,22.0,127.0,127.0,5,1111,15.0,843.0,843.0
0.006,6,10,1547,5,764,1.0,496.0,496.0,5,783,1.0,515.0,515.0
0.004,6,10,2007,5,928,1.0,660.0,660.0,5,1079,1.0,811.0,811.0
0.01,6,10,1972,5,910,2.0,642.0,642.0,5,1062,2.0,794.0,794.0
40.08,17,10,676,5,460,10017.0,104.0,64.0,5,216,10019.0,20.0,15.0
0.004,17,2,136,1,60,0.0,32.0,32.0,1,76,0.0,48.0,48.0
0.054,17,2,148,1,60,0.0,32.0,32.0,1,88,0.0,60.0,60.0
0.015,6,10,1990,5,911,3.0,643.0,643.0,5,1079,3.0,811.0,811.0
15.315,17,17,9367,8,4366,2183.0,1350.0,517.0,9,5001,1910.0,1350.0,527.0
0.004,17,2,148,1,60,0.0,32.0,32.0,1,88,0.0,60.0,60.0
0.001,17,2,180,1,66,0.0,38.0,38.0,1,114,0.0,86.0,86.0
0.059,6,10,1506,5,395,13.0,127.0,127.0,5,1111,13.0,843.0,843.0
0.003,17,2,136,1,60,0.0,32.0,32.0,1,76,0.0,48.0,48.0
40.069,17,10,676,5,460,10016.0,104.0,64.0,5,216,10016.0,20.0,15.0
0.116,6,10,1506,5,395,24.0,127.0,127.0,5,1111,25.0,843.0,843.0
15.031,17,42,21622,22,18402,714.0,1350.0,808.0,20,3220,789.0,1350.0,133.0
0.009,6,10,1643,5,860,2.0,592.0,592.0,5,783,2.0,515.0,515.0
0.126,6,10,1506,5,395,29.0,127.0,127.0,5,1111,19.0,843.0,843.0
0.005,6,10,1689,5,839,1.0,571.0,571.0,5,850,1.0,582.0,582.0
0.058,6,10,1506,5,395,12.0,127.0,127.0,5,1111,12.0,843.0,843.0
0.068,6,10,1506,5,395,15.0,127.0,127.0,5,1111,13.0,843.0,843.0
0.005,6,10,2006,5,927,1.0,659.0,659.0,5,1079,1.0,811.0,811.0
0.013,6,10,1972,5,910,3.0,642.0,642.0,5,1062,3.0,794.0,794.0
0.088,6,10,1506,5,395,15.0,127.0,127.0,5,1111,21.0,843.0,843.0
1770.376,6,85,4510,42,2222,43179.0,26.0,26.0,43,2288,42150.0,26.0,26.0
0.004,6,10,1774,5,923,1.0,655.0,655.0,5,851,1.0,583.0,583.0
0.015,6,10,1762,5,911,3.0,643.0,643.0,5,851,3.0,583.0,583.0
0.018,6,10,1989,5,910,4.0,642.0,642.0,5,1079,4.0,811.0,811.0
0.001,17,2,180,1,66,0.0,38.0,38.0,1,114,0.0,86.0,86.0
0.004,6,10,1702,5,863,1.0,595.0,595.0,5,839,1.0,571.0,571.0
0.004,6,10,1702,5,863,1.0,595.0,595.0,5,839,1.0,571.0,571.0
40.062,17,10,676,5,460,10013.0,104.0,64.0,5,216,10014.0,20.0,15.0
15.079,17,15,8289,8,6027,2150.0,1350.0,725.0,7,2262,2508.0,1350.0,295.0
0.012,6,10,1972,5,910,3.0,642.0,642.0,5,1062,2.0,794.0,794.0
0.068,17,8,3613,4,1874,22.0,1350.0,440.0,4,1739,11.0,1350.0,406.0
40.08,17,10,676,5,460,10017.0,104.0,64.0,5,216,10019.0,20.0,15.0
0.007,6,10,1547,5,764,1.0,496.0,496.0,5,783,1.0,515.0,515.0
0.001,17,2,180,1,66,0.0,38.0,38.0,1,114,0.0,86.0,86.0
0.022,6,10,1990,5,911,5.0,643.0,643.0,5,1079,5.0,811.0,811.0
0.004,6,10,1989,5,927,1.0,659.0,659.0,5,1062,1.0,794.0,794.0
0.016,6,10,1983,5,910,3.0,642.0,642.0,5,1073,4.0,805.0,805.0
40.058,17,10,676,5,460,10012.0,104.0,64.0,5,216,10013.0,20.0,15.0
0.005,6,10,1854,5,889,1.0,621.0,621.0,5,965,1.0,697.0,697.0
0.014,6,10,1989,5,910,3.0,642.0,642.0,5,1079,3.0,811.0,811.0
240.053,6,11,1275,6,510,48010.0,190.0,190.0,5,765,60002.0,464.0,248.0
0.005,6,10,1643,5,860,1.0,592.0,592.0,5,783,1.0,515.0,515.0
0.072,17,2,144,1,64,0.0,36.0,36.0,1,80,0.0,52.0,52.0
40.056,17,10,676,5,460,10013.0,104.0,64.0,5,216,10013.0,20.0,15.0
0.008,6,10,1762,5,911,2.0,643.0,643.0,5,851,2.0,583.0,583.0
375.937,6,27,6233,15,3207,26852.0,676.0,403.0,12,3026,28717.0,821.0,478.0
0.011,6,10,1983,5,910,2.0,642.0,642.0,5,1073,2.0,805.0,805.0
0.385,6,11,1558,6,447,75.0,127.0,127.0,5,1111,94.0,843.0,843.0
0.004,6,10,2006,5,927,1.0,659.0,659.0,5,1079,1.0,811.0,811.0
0.011,6,10,1983,5,910,2.0,642.0,642.0,5,1073,2.0,805.0,805.0
0.044,17,2,152,1,76,0.0,48.0,48.0,1,76,0.0,48.0,48.0
0.004,6,10,1779,5,928,1.0,660.0,660.0,5,851,1.0,583.0,583.0
0.006,17,2,140,1,62,0.0,34.0,34.0,1,78,0.0,50.0,50.0
0.001,17,2,180,1,66,0.0,38.0,38.0,1,114,0.0,86.0,86.0
0.068,17,8,3613,4,1874,22.0,1350.0,440.0,4,1739,10.0,1350.0,406.0
10.927,17,28,4422,14,1993,831.0,268.0,114.0,14,2429,831.0,588.0,145.0
300.836,6,36,9557,19,4079,16713.0,2903.0,821.0,17,5478,542.0,2667.0,435.0
0.081,6,10,1506,5,395,17.0,127.0,127.0,5,1111,18.0,843.0,843.0
1770.467,6,83,4368,42,2210,43181.0,26.0,26.0,41,2158,44260.0,26.0,26.0
40.068,17,10,676,5,460,10016.0,104.0,64.0,5,216,10015.0,20.0,15.0
0.002,17,2,180,1,66,0.0,38.0,38.0,1,114,0.0,86.0,86.0
0.013,6,10,1983,5,910,3.0,642.0,642.0,5,1073,3.0,805.0,805.0
0.011,6,10,1983,5,910,2.0,642.0,642.0,5,1073,2.0,805.0,805.0
40.059,17,10,676,5,460,10013.0,104.0,64.0,5,216,10014.0,20.0,15.0
0.01,6,10,1990,5,911,2.0,643.0,643.0,5,1079,2.0,811.0,811.0
0.054,17,2,152,1,76,0.0,48.0,48.0,1,76,0.0,48.0,48.0
0.094,6,10,1506,5,395,20.0,127.0,127.0,5,1111,23.0,843.0,843.0
170.345,17,74,10653,37,2466,4731.0,44.0,38.0,37,8187,4731.0,239.0,193.0
0.005,6,10,2006,5,927,1.0,659.0,659.0,5,1079,1.0,811.0,811.0
0.08,6,10,1506,5,395,17.0,127.0,127.0,5,1111,18.0,843.0,843.0
0.007,6,10,1547,5,764,1.0,496.0,496.0,5,783,1.0,515.0,515.0
0.017,6,10,1989,5,910,4.0,642.0,642.0,5,1079,4.0,811.0,811.0
0.005,6,10,1689,5,839,1.0,571.0,571.0,5,850,1.0,582.0,582.0
0.005,17,2,170,1,65,0.0,37.0,37.0,1,105,0.0,77.0,77.0
0.007,17,2,152,1,76,0.0,48.0,48.0,1,76,0.0,48.0,48.0
0.041,17,2,148,1,60,0.0,32.0,32.0,1,88,0.0,60.0,60.0
40.071,17,10,676,5,460,10015.0,104.0,64.0,5,216,10016.0,20.0,15.0
240.117,6,31,8622,15,6381,17151.0,1515.0,622.0,16,2241,16007.0,580.0,175.0
0.012,6,10,1989,5,910,3.0,642.0,642.0,5,1079,2.0,811.0,811.0
0.186,6,44,11548,24,3219,8.0,1019.0,197.0,20,8329,9.0,1402.0,606.0
0.105,6,10,1506,5,395,23.0,127.0,127.0,5,1111,24.0,843.0,843.0
0.01,6,10,1983,5,910,2.0,642.0,642.0,5,1073,2.0,805.0,805.0
0.01,6,10,1989,5,910,2.0,642.0,642.0,5,1079,2.0,811.0,811.0
1778.61,17,143,45188,72,22752,25049.0,288.0,288.0,71,22436,25407.0,288.0,288.0
0.001,17,2,180,1,66,0.0,38.0,38.0,1,114,0.0,86.0,86.0
0.068,6,10,1506,5,395,14.0,127.0,127.0,5,1111,15.0,843.0,843.0
0.287,17,54,28938,30,24983,9.0,1350.0,804.0,24,3955,10.0,1350.0,136.0
2.132,6,26,10414,14,1575,164.0,517.0,211.0,12,8839,192.0,1402.0,911.0
0.01,6,10,1762,5,911,2.0,643.0,643.0,5,851,2.0,583.0,583.0
40.058,17,10,676,5,460,10013.0,104.0,64.0,5,216,10013.0,20.0,15.0
0.039,17,2,148,1,60,0.0,32.0,32.0,1,88,0.0,60.0,60.0
0.01,6,10,1989,5,910,2.0,642.0,642.0,5,1079,2.0,811.0,811.0
0.005,6,10,1989,5,927,1.0,659.0,659.0,5,1062,1.0,794.0,794.0
0.004,6,10,1989,5,927,1.0,659.0,659.0,5,1062,1.0,794.0,794.0
0.011,6,14,3787,7,497,1.0,125.0,125.0,7,3290,1.0,1448.0,972.0
0.1,6,10,1506,5,395,23.0,127.0,127.0,5,1111,20.0,843.0,843.0
0.081,17,8,3613,4,1874,27.0,1350.0,440.0,4,1739,10.0,1350.0,406.0
0.005,6,10,2007,5,928,1.0,660.0,660.0,5,1079,1.0,811.0,811.0
0.075,6,10,1506,5,395,17.0,127.0,127.0,5,1111,15.0,843.0,843.0
0.011,6,10,1972,5,910,2.0,642.0,642.0,5,1062,2.0,794.0,794.0
0.006,6,10,2007,5,928,1.0,660.0,660.0,5,1079,1.0,811.0,811.0
0.005,6,10,2006,5,927,1.0,659.0,659.0,5,1079,1.0,811.0,811.0
0.005,6,10,1774,5,923,1.0,655.0,655.0,5,851,1.0,583.0,583.0
0.003,17,2,136,1,60,0.0,32.0,32.0,1,76,0.0,48.0,48.0
0.001,17,2,179,1,62,0.0,34.0,34.0,1,117,0.0,89.0,89.0
0.007,6,10,1702,5,863,1.0,595.0,595.0,5,839,1.0,571.0,571.0
0.02,6,10,1990,5,911,4.0,643.0,643.0,5,1079,5.0,811.0,811.0
0.01,6,10,1762,5,911,2.0,643.0,643.0,5,851,2.0,583.0,583.0
0.006,6,10,1547,5,764,1.0,496.0,496.0,5,783,1.0,515.0,515.0
0.005,6,10,1689,5,839,1.0,571.0,571.0,5,850,1.0,582.0,582.0
0.006,17,2,179,1,71,0.0,43.0,43.0,1,108,0.0,80.0,80.0
0.016,6,13,3735,7,497,2.0,125.0,125.0,6,3238,3.0,1470.0,1459.0
0.005,6,14,3799,7,509,0.0,137.0,137.0,7,3290,0.0,1448.0,972.0
0.163,17,2,152,1,76,0.0,48.0,48.0,1,76,0.0,48.0,48.0
241.316,6,384,348074,185,21146,1311.0,2736.0,959.0,199,326928,1218.0,2916.0,1674.0
0.006,6,13,3747,7,509,1.0,137.0,137.0,6,3238,1.0,1470.0,1459.0
0.01,6,10,1989,5,910,2.0,642.0,642.0,5,1079,2.0,811.0,811.0
0.005,6,10,2000,5,927,1.0,659.0,659.0,5,1073,1.0,805.0,805.0
0.008,6,10,1643,5,860,2.0,592.0,592.0,5,783,1.0,515.0,515.0
0.01,6,10,1989,5,910,2.0,642.0,642.0,5,1079,2.0,811.0,811.0
0.003,17,4,284,2,120,0.0,32.0,32.0,2,164,0.0,60.0,54.0
308.374,17,20,1124,10,716,34249.0,48.0,43.0,10,408,34248.0,20.0,12.0
0.017,6,10,1989,5,910,4.0,642.0,642.0,5,1079,4.0,811.0,811.0
0.006,6,10,1547,5,764,1.0,496.0,496.0,5,783,1.0,515.0,515.0
0.04,17,4,284,2,120,0.0,32.0,32.0,2,164,37.0,60.0,54.0
0.005,6,10,2000,5,927,1.0,659.0,659.0,5,1073,1.0,805.0,805.0
0.004,6,10,2007,5,928,1.0,660.0,660.0,5,1079,1.0,811.0,811.0
0.142,6,10,1506,5,395,32.0,127.0,127.0,5,1111,33.0,843.0,843.0
120.828,6,61,19206,34,4860,3661.0,1053.0,221.0,27,14346,4646.0,1402.0,862.0
0.103,6,10,1506,5,395,23.0,127.0,127.0,5,1111,20.0,843.0,843.0
0.005,6,13,3690,7,452,0.0,80.0,80.0,6,3238,0.0,1470.0,1459.0
0.003,17,2,148,1,60,0.0,32.0,32.0,1,88,0.0,60.0,60.0
0.005,6,10,2006,5,927,1.0,659.0,659.0,5,1079,1.0,811.0,811.0
0.066,17,8,3613,4,1874,22.0,1350.0,440.0,4,1739,11.0,1350.0,406.0
0.005,6,14,3742,8,504,0.0,80.0,80.0,6,3238,0.0,1470.0,1459.0
0.009,6,10,1677,5,827,2.0,559.0,559.0,5,850,2.0,582.0,582.0
1780.795,6,86,4653,42,2265,43432.0,27.0,27.0,44,2388,41412.0,27.0,25.0
321.892,17,20,1124,10,716,35751.0,48.0,43.0,10,408,35751.0,20.0,12.0
0.005,6,10,1774,5,923,1.0,655.0,655.0,5,851,1.0,583.0,583.0
40.08,17,10,676,5,460,10019.0,104.0,64.0,5,216,10019.0,20.0,15.0
0.003,17,2,148,1,60,0.0,32.0,32.0,1,88,0.0,60.0,60.0
0.011,6,10,1631,5,848,2.0,580.0,580.0,5,783,2.0,515.0,515.0
0.007,17,2,424,1,72,0.0,44.0,44.0,1,352,0.0,324.0,324.0
327.427,17,20,1124,10,716,36366.0,48.0,43.0,10,408,36366.0,20.0,12.0
11.172,17,28,4419,14,1994,847.0,269.0,114.0,14,2425,847.0,588.0,145.0
0.085,6,10,1506,5,395,16.0,127.0,127.0,5,1111,17.0,843.0,843.0
0.012,6,10,1677,5,827,3.0,559.0,559.0,5,850,3.0,582.0,582.0
0.004,6,10,1774,5,923,1.0,655.0,655.0,5,851,1.0,583.0,583.0
0.005,17,2,179,1,71,0.0,43.0,43.0,1,108,0.0,80.0,80.0
0.014,6,13,3735,7,497,2.0,125.0,125.0,6,3238,2.0,1470.0,1459.0
0.007,6,10,1762,5,911,1.0,643.0,643.0,5,851,1.0,583.0,583.0
0.005,17,2,164,1,74,0.0,46.0,46.0,1,90,0.0,62.0,62.0
0.004,6,10,1989,5,927,1.0,659.0,659.0,5,1062,1.0,794.0,794.0
0.004,6,10,2006,5,927,1.0,659.0,659.0,5,1079,1.0,811.0,811.0
0.004,6,10,2006,5,927,1.0,659.0,659.0,5,1079,1.0,811.0,811.0
10.86,17,28,4416,14,1993,826.0,268.0,114.0,14,2423,826.0,586.0,145.0
0.008,6,10,1972,5,910,2.0,642.0,642.0,5,1062,2.0,794.0,794.0
0.116,6,10,1506,5,395,27.0,127.0,127.0,5,1111,26.0,843.0,843.0
0.005,6,10,1989,5,927,1.0,659.0,659.0,5,1062,1.0,794.0,794.0
0.004,6,10,1702,5,863,0.0,595.0,595.0,5,839,1.0,571.0,571.0
40.07,17,10,676,5,460,10015.0,104.0,64.0,5,216,10016.0,20.0,15.0
0.114,6,10,1506,5,395,21.0,127.0,127.0,5,1111,25.0,843.0,843.0
0.099,6,10,1506,5,395,18.0,127.0,127.0,5,1111,22.0,843.0,843.0
0.166,17,2,152,1,76,0.0,48.0,48.0,1,76,0.0,48.0,48.0
0.004,6,10,1989,5,927,1.0,659.0,659.0,5,1062,1.0,794.0,794.0
11.181,17,28,4422,14,1994,847.0,269.0,114.0,14,2428,847.0,587.0,145.0
0.003,17,4,284,2,120,0.0,32.0,32.0,2,164,0.0,60.0,54.0
0.004,6,10,2006,5,927,1.0,659.0,659.0,5,1079,1.0,811.0,811.0
0.002,17,2,152,1,76,0.0,48.0,48.0,1,76,0.0,48.0,48.0
0.015,6,10,1990,5,911,3.0,643.0,643.0,5,1079,3.0,811.0,811.0
0.132,6,10,1506,5,395,31.0,127.0,127.0,5,1111,30.0,843.0,843.0
0.004,6,10,1989,5,927,1.0,659.0,659.0,5,1062,1.0,794.0,794.0
0.01,6,10,1983,5,910,2.0,642.0,642.0,5,1073,2.0,805.0,805.0
0.003,17,2,136,1,60,0.0,32.0,32.0,1,76,0.0,48.0,48.0
10.855,17,28,4422,14,1995,826.0,270.0,114.0,14,2427,825.0,586.0,145.0
10.801,17,28,4421,14,1994,822.0,269.0,114.0,14,2427,822.0,586.0,145.0
0.005,6,10,1854,5,889,1.0,621.0,621.0,5,965,1.0,697.0,697.0
40.059,17,10,676,5,460,10013.0,104.0,64.0,5,216,10014.0,20.0,15.0
0.013,6,10,1972,5,910,3.0,642.0,642.0,5,1062,3.0,794.0,794.0
240.1,6,16,4480,9,963,30012.0,238.0,166.0,7,3517,40016.0,1402.0,786.0
0.005,17,2,179,1,71,0.0,43.0,43.0,1,108,0.0,80.0,80.0
0.027,6,13,3735,7,497,4.0,125.0,125.0,6,3238,5.0,1470.0,1459.0
0.133,17,2,80,1,32,0.0,4.0,4.0,1,48,0.0,20.0,20.0
0.008,6,10,1762,5,911,1.0,643.0,643.0,5,851,1.0,583.0,583.0
40.057,17,10,676,5,460,10012.0,104.0,64.0,5,216,10011.0,20.0,15.0
0.011,6,10,1972,5,910,2.0,642.0,642.0,5,1062,2.0,794.0,794.0
0.088,6,10,1506,5,395,18.0,127.0,127.0,5,1111,20.0,843.0,843.0
0.006,6,10,2006,5,927,1.0,659.0,659.0,5,1079,1.0,811.0,811.0
0.011,6,10,1972,5,910,2.0,642.0,642.0,5,1062,2.0,794.0,794.0
0.005,6,10,2006,5,927,1.0,659.0,659.0,5,1079,1.0,811.0,811.0
0.001,17,2,179,1,62,0.0,34.0,34.0,1,117,0.0,89.0,89.0
0.01,6,10,1989,5,910,2.0,642.0,642.0,5,1079,2.0,811.0,811.0
300.109,6,19,4660,11,1102,30010.0,238.0,130.0,8,3558,42871.0,1402.0,786.0
0.003,17,2,148,1,60,0.0,32.0,32.0,1,88,0.0,60.0,60.0
0.011,6,10,1972,5,910,2.0,642.0,642.0,5,1062,2.0,794.0,794.0
0.006,17,2,214,1,75,0.0,47.0,47.0,1,139,0.0,111.0,111.0
0.02,6,10,1677,5,827,4.0,559.0,559.0,5,850,4.0,582.0,582.0
0.004,17,4,284,2,120,0.0,32.0,32.0,2,164,0.0,60.0,54.0
40.054,17,10,676,5,460,10012.0,104.0,64.0,5,216,10012.0,20.0,15.0
173.406,17,80,11098,40,2663,4446.0,44.0,38.0,40,8435,4446.0,260.0,182.0
0.005,17,2,170,1,65,0.0,37.0,37.0,1,105,0.0,77.0,77.0
0.13,6,10,1506,5,395,27.0,127.0,127.0,5,1111,27.0,843.0,843.0
0.079,6,10,1506,5,395,17.0,127.0,127.0,5,1111,15.0,843.0,843.0
0.095,6,10,1506,5,395,18.0,127.0,127.0,5,1111,20.0,843.0,843.0
0.006,6,13,3690,7,452,0.0,80.0,80.0,6,3238,1.0,1470.0,1459.0
40.066,17,10,676,5,460,10014.0,104.0,64.0,5,216,10015.0,20.0,15.0
0.005,6,10,2006,5,927,1.0,659.0,659.0,5,1079,1.0,811.0,811.0
0.005,6,10,2007,5,928,1.0,660.0,660.0,5,1079,1.0,811.0,811.0
10.792,17,26,4104,13,1823,890.0,270.0,112.0,13,2281,890.0,588.0,147.0
0.001,17,2,166,1,75,0.0,47.0,47.0,1,91,0.0,63.0,63.0
0.01,6,10,1762,5,911,2.0,643.0,643.0,5,851,2.0,583.0,583.0
0.084,6,10,1506,5,395,17.0,127.0,127.0,5,1111,18.0,843.0,843.0
0.122,17,2,80,1,32,0.0,4.0,4.0,1,48,0.0,20.0,20.0
0.008,6,10,1677,5,827,1.0,559.0,559.0,5,850,2.0,582.0,582.0
0.005,6,10,1774,5,923,1.0,655.0,655.0,5,851,1.0,583.0,583.0
0.108,6,10,1506,5,395,25.0,127.0,127.0,5,1111,25.0,843.0,843.0
0.063,6,10,1506,5,395,14.0,127.0,127.0,5,1111,15.0,843.0,843.0
0.005,6,10,2007,5,928,1.0,660.0,660.0,5,1079,1.0,811.0,811.0
0.017,6,10,1631,5,848,4.0,580.0,580.0,5,783,4.0,515.0,515.0
0.006,6,10,1547,5,764,1.0,496.0,496.0,5,783,1.0,515.0,515.0
240.093,6,16,4481,9,963,30011.0,238.0,166.0,7,3518,40014.0,1402.0,786.0
0.006,6,10,1854,5,889,1.0,621.0,621.0,5,965,1.0,697.0,697.0
0.06,6,10,1506,5,395,14.0,127.0,127.0,5,1111,11.0,843.0,843.0
0.008,6,10,1762,5,911,2.0,643.0,643.0,5,851,2.0,583.0,583.0
0.053,17,2,152,1,76,0.0,48.0,48.0,1,76,0.0,48.0,48.0
0.003,17,2,203,1,61,0.0,33.0,33.0,1,142,0.0,114.0,114.0
0.004,6,10,2006,5,927,1.0,659.0,659.0,5,1079,1.0,811.0,811.0
0.004,6,10,2006,5,927,1.0,659.0,659.0,5,1079,1.0,811.0,811.0
0.163,17,2,152,1,76,0.0,48.0,48.0,1,76,0.0,48.0,48.0
0.005,6,10,2006,5,927,1.0,659.0,659.0,5,1079,1.0,811.0,811.0
0.032,6,10,1972,5,910,8.0,642.0,642.0,5,1062,8.0,794.0,794.0
0.114,6,10,1506,5,395,23.0,127.0,127.0,5,1111,26.0,843.0,843.0
0.014,6,10,1989,5,910,3.0,642.0,642.0,5,1079,3.0,811.0,811.0
240.161,6,41,5393,21,2478,12007.0,588.0,196.0,20,2915,12639.0,580.0,233.0
40.061,17,10,676,5,460,10014.0,104.0,64.0,5,216,10014.0,20.0,15.0
0.008,6,10,1983,5,910,2.0,642.0,642.0,5,1073,2.0,805.0,805.0
0.109,6,10,1506,5,395,23.0,127.0,127.0,5,1111,24.0,843.0,843.0
0.074,17,8,3613,4,1874,24.0,1350.0,440.0,4,1739,14.0,1350.0,406.0
0.01,6,14,3787,7,497,1.0,125.0,125.0,7,3290,1.0,1448.0,972.0
0.01,6,10,1631,5,848,2.0,580.0,580.0,5,783,2.0,515.0,515.0
0.012,6,10,1990,5,911,3.0,643.0,643.0,5,1079,3.0,811.0,811.0
0.005,6,10,1547,5,764,1.0,496.0,496.0,5,783,1.0,515.0,515.0
240.088,6,16,4480,9,963,30011.0,238.0,166.0,7,3517,40014.0,1402.0,786.0
0.004,6,14,3799,7,509,0.0,137.0,137.0,7,3290,0.0,1448.0,972.0
0.006,6,10,1547,5,764,1.0,496.0,496.0,5,783,1.0,515.0,515.0
0.007,6,10,1972,5,910,1.0,642.0,642.0,5,1062,1.0,794.0,794.0
0.098,6,10,1506,5,395,23.0,127.0,127.0,5,1111,15.0,843.0,843.0
0.008,6,10,1990,5,911,2.0,643.0,643.0,5,1079,2.0,811.0,811.0
170.206,17,72,10365,36,2394,4862.0,44.0,38.0,36,7971,4862.0,249.0,193.0
0.039,17,4,284,2,120,0.0,32.0,32.0,2,164,35.0,60.0,54.0
0.009,6,10,1972,5,910,2.0,642.0,642.0,5,1062,2.0,794.0,794.0
1770.4,6,82,4318,41,2159,44258.0,27.0,27.0,41,2159,44258.0,27.0,27.0
0.071,17,8,3613,4,1874,23.0,1350.0,440.0,4,1739,12.0,1350.0,406.0
0.006,6,10,2006,5,927,1.0,659.0,659.0,5,1079,1.0,811.0,811.0
0.013,6,10,1983,5,910,3.0,642.0,642.0,5,1073,3.0,805.0,805.0
0.005,17,2,162,1,73,0.0,45.0,45.0,1,89,0.0,61.0,61.0
0.009,6,10,1989,5,910,2.0,642.0,642.0,5,1079,2.0,811.0,811.0
0.017,6,10,1983,5,910,4.0,642.0,642.0,5,1073,4.0,805.0,805.0
0.006,6,10,2006,5,927,1.0,659.0,659.0,5,1079,1.0,811.0,811.0
0.113,6,10,1506,5,395,25.0,127.0,127.0,5,1111,27.0,843.0,843.0
0.006,6,10,1547,5,764,1.0,496.0,496.0,5,783,1.0,515.0,515.0
0.005,17,2,144,1,64,0.0,36.0,36.0,1,80,0.0,52.0,52.0
0.005,6,10,1989,5,927,1.0,659.0,659.0,5,1062,1.0,794.0,794.0
0.109,6,10,1506,5,395,19.0,127.0,127.0,5,1111,24.0,843.0,843.0
10.772,17,28,4423,14,1995,820.0,270.0,114.0,14,2428,820.0,587.0,145.0
0.012,6,14,3787,7,497,1.0,125.0,125.0,7,3290,1.0,1448.0,972.0
0.074,6,10,1506,5,395,17.0,127.0,127.0,5,1111,16.0,843.0,843.0
0.137,6,10,1506,5,395,31.0,127.0,127.0,5,1111,25.0,843.0,843.0
0.001,17,2,179,1,62,0.0,34.0,34.0,1,117,0.0,89.0,89.0
0.072,17,2,412,1,61,0.0,33.0,33.0,1,351,0.0,323.0,323.0
40.077,17,10,676,5,460,10018.0,104.0,64.0,5,216,10018.0,20.0,15.0
0.012,6,13,3735,7,497,1.0,125.0,125.0,6,3238,2.0,1470.0,1459.0
1778.374,17,144,41760,72,22752,25047.0,288.0,288.0,72,19008,25047.0,236.0,236.0
0.08,6,10,1506,5,395,18.0,127.0,127.0,5,1111,17.0,843.0,843.0
0.009,17,2,194,1,59,0.0,31.0,31.0,1,135,0.0,107.0,107.0
0.012,6,10,1990,5,911,2.0,643.0,643.0,5,1079,2.0,811.0,811.0
0.085,6,10,1506,5,395,17.0,127.0,127.0,5,1111,18.0,843.0,843.0
0.013,6,10,1983,5,910,3.0,642.0,642.0,5,1073,3.0,805.0,805.0
0.987,6,13,3922,7,2139,123.0,1328.0,923.0,6,1783,148.0,1539.0,1539.0
40.06,17,10,676,5,460,10013.0,104.0,64.0,5,216,10014.0,20.0,15.0
0.015,6,10,1990,5,911,3.0,643.0,643.0,5,1079,3.0,811.0,811.0
0.072,17,2,148,1,60,0.0,32.0,32.0,1,88,0.0,60.0,60.0
0.005,6,10,1989,5,927,1.0,659.0,659.0,5,1062,1.0,794.0,794.0
0.004,6,10,2007,5,928,1.0,660.0,660.0,5,1079,1.0,811.0,811.0
40.069,17,10,676,5,460,10013.0,104.0,64.0,5,216,10016.0,20.0,15.0
40.067,17,10,676,5,460,10015.0,104.0,64.0,5,216,10015.0,20.0,15.0
0.04,17,2,234,1,61,0.0,33.0,33.0,1,173,0.0,145.0,145.0
0.01,6,10,1989,5,910,2.0,642.0,642.0,5,1079,2.0,811.0,811.0
0.005,17,2,170,1,65,0.0,37.0,37.0,1,105,0.0,77.0,77.0
0.016,6,10,1972,5,910,3.0,642.0,642.0,5,1062,3.0,794.0,794.0
0.113,6,10,1506,5,395,26.0,127.0,127.0,5,1111,25.0,843.0,843.0
0.11,6,10,1506,5,395,26.0,127.0,127.0,5,1111,26.0,843.0,843.0
0.024,6,10,1989,5,910,6.0,642.0,642.0,5,1079,6.0,811.0,811.0
0.078,6,10,1506,5,395,15.0,127.0,127.0,5,1111,17.0,843.0,843.0
10.746,17,28,4417,14,1993,818.0,268.0,114.0,14,2424,818.0,587.0,145.0
0.036,6,10,1631,5,848,9.0,580.0,580.0,5,783,9.0,515.0,515.0
0.001,17,2,180,1,66,0.0,38.0,38.0,1,114,0.0,86.0,86.0
0.007,6,10,1854,5,889,1.0,621.0,621.0,5,965,1.0,697.0,697.0
0.004,6,10,1702,5,863,1.0,595.0,595.0,5,839,1.0,571.0,571.0
0.018,6,10,1983,5,910,4.0,642.0,642.0,5,1073,4.0,805.0,805.0
241.044,6,37,9654,19,2171,13386.0,743.0,235.0,18,7483,14173.0,1402.0,595.0
0.128,17,2,80,1,32,0.0,4.0,4.0,1,48,0.0,20.0,20.0
10.858,17,28,4422,14,1995,827.0,270.0,114.0,14,2427,826.0,586.0,145.0
0.014,6,10,1990,5,911,3.0,643.0,643.0,5,1079,3.0,811.0,811.0
40.064,17,10,676,5,460,10013.0,104.0,64.0,5,216,10015.0,20.0,15.0
0.005,6,10,2006,5,927,1.0,659.0,659.0,5,1079,1.0,811.0,811.0
171.067,17,72,10188,36,2394,4887.0,44.0,38.0,36,7794,4887.0,239.0,188.0
0.004,17,4,284,2,120,0.0,32.0,32.0,2,164,0.0,60.0,54.0
1771.461,6,304,97633,189,86495,9422.0,1402.0,672.0,115,11138,15539.0,452.0,70.0
0.007,17,2,194,1,59,0.0,31.0,31.0,1,135,0.0,107.0,107.0
0.135,6,10,1506,5,395,22.0,127.0,127.0,5,1111,30.0,843.0,843.0
0.018,6,10,1990,5,911,4.0,643.0,643.0,5,1079,4.0,811.0,811.0
178.187,17,84,12213,42,2799,4345.0,44.0,38.0,42,9414,4346.0,279.0,196.0
0.168,17,2,152,1,76,0.0,48.0,48.0,1,76,0.0,48.0,48.0
0.074,6,10,1506,5,395,17.0,127.0,127.0,5,1111,16.0,843.0,843.0
0.004,17,2,136,1,60,0.0,32.0,32.0,1,76,0.0,48.0,48.0
1.035,6,37,21257,19,14593,57.0,2720.0,1533.0,18,6664,50.0,2720.0,988.0
0.006,6,10,1854,5,889,1.0,621.0,621.0,5,965,1.0,697.0,697.0
0.005,17,2,166,1,75,0.0,47.0,47.0,1,91,0.0,63.0,63.0
1787.43,6,154,19574,92,13852,19642.0,302.0,302.0,62,5722,29302.0,83.0,83.0
54.754,6,48,19007,24,13204,394.0,2720.0,1525.0,24,5803,2373.0,2667.0,402.0
0.128,17,4,352,2,130,1.0,37.0,37.0,2,222,87.0,89.0,83.0
0.005,6,10,1774,5,923,1.0,655.0,655.0,5,851,1.0,583.0,583.0
40.057,17,10,676,5,460,10013.0,104.0,64.0,5,216,10013.0,20.0,15.0
0.004,17,2,144,1,64,0.0,36.0,36.0,1,80,0.0,52.0,52.0
0.039,17,4,284,2,120,0.0,32.0,32.0,2,164,36.0,60.0,54.0
0.004,6,10,2006,5,927,1.0,659.0,659.0,5,1079,1.0,811.0,811.0
0.146,6,10,1506,5,395,32.0,127.0,127.0,5,1111,34.0,843.0,843.0
240.117,6,32,9064,15,6660,17151.0,1773.0,652.0,17,2404,15007.0,580.0,189.0
0.079,6,10,1506,5,395,17.0,127.0,127.0,5,1111,19.0,843.0,843.0
0.014,6,10,1972,5,910,3.0,642.0,642.0,5,1062,3.0,794.0,794.0
0.073,6,10,1506,5,395,15.0,127.0,127.0,5,1111,15.0,843.0,843.0
0.014,6,10,1972,5,910,3.0,642.0,642.0,5,1062,3.0,794.0,794.0
0.087,6,10,1506,5,395,18.0,127.0,127.0,5,1111,18.0,843.0,843.0
0.117,6,10,1506,5,395,22.0,127.0,127.0,5,1111,26.0,843.0,843.0
40.068,17,10,676,5,460,10015.0,104.0,64.0,5,216,10016.0,20.0,15.0
0.072,17,2,148,1,60,0.0,32.0,32.0,1,88,0.0,60.0,60.0
0.007,6,10,1643,5,860,1.0,592.0,592.0,5,783,1.0,515.0,515.0
0.127,17,2,80,1,32,0.0,4.0,4.0,1,48,0.0,20.0,20.0
0.005,6,10,1643,5,860,1.0,592.0,592.0,5,783,1.0,515.0,515.0
0.128,6,10,1506,5,395,28.0,127.0,127.0,5,1111,26.0,843.0,843.0
0.035,6,10,1989,5,910,8.0,642.0,642.0,5,1079,8.0,811.0,811.0
10.829,17,28,4422,14,1994,824.0,269.0,114.0,14,2428,824.0,587.0,145.0
0.003,17,2,136,1,60,0.0,32.0,32.0,1,76,0.0,48.0,48.0
0.001,17,2,178,1,81,0.0,53.0,53.0,1,97,0.0,69.0,69.0
0.016,6,10,1989,5,910,3.0,642.0,642.0,5,1079,4.0,811.0,811.0
0.005,17,2,170,1,65,0.0,37.0,37.0,1,105,0.0,77.0,77.0
0.005,6,10,2000,5,927,1.0,659.0,659.0,5,1073,1.0,805.0,805.0
294.216,6,404,349332,193,21599,1532.0,2736.0,888.0,211,327733,1401.0,2804.0,1607.0
0.009,6,13,3690,7,452,1.0,80.0,80.0,6,3238,1.0,1470.0,1459.0
10.998,17,28,4423,14,1995,836.0,270.0,114.0,14,2428,836.0,587.0,145.0
40.061,17,10,676,5,460,10012.0,104.0,64.0,5,216,10014.0,20.0,15.0
0.121,6,10,1506,5,395,26.0,127.0,127.0,5,1111,26.0,843.0,843.0
0.093,6,10,1506,5,395,22.0,127.0,127.0,5,1111,20.0,843.0,843.0
0.006,6,12,1698,6,863,1.0,327.0,271.0,6,835,1.0,515.0,515.0
40.054,17,10,676,5,460,10012.0,104.0,64.0,5,216,10012.0,20.0,15.0
0.005,6,10,2006,5,927,1.0,659.0,659.0,5,1079,1.0,811.0,811.0
0.006,6,10,1989,5,927,1.0,659.0,659.0,5,1062,1.0,794.0,794.0
0.001,17,2,180,1,66,0.0,38.0,38.0,1,114,0.0,86.0,86.0
308.572,17,20,1124,10,716,34272.0,48.0,43.0,10,408,34272.0,20.0,12.0
0.003,17,2,148,1,60,0.0,32.0,32.0,1,88,0.0,60.0,60.0
0.014,6,10,1990,5,911,3.0,643.0,643.0,5,1079,3.0,811.0,811.0
0.008,6,12,1698,6,863,1.0,327.0,271.0,6,835,1.0,515.0,515.0
0.02,6,10,1990,5,911,5.0,643.0,643.0,5,1079,5.0,811.0,811.0
0.131,6,10,1506,5,395,31.0,127.0,127.0,5,1111,20.0,843.0,843.0
0.009,6,10,1989,5,910,2.0,642.0,642.0,5,1079,2.0,811.0,811.0
0.111,6,10,1506,5,395,26.0,127.0,127.0,5,1111,27.0,843.0,843.0
0.07,6,10,1506,5,395,15.0,127.0,127.0,5,1111,13.0,843.0,843.0
0.004,6,10,1989,5,927,1.0,659.0,659.0,5,1062,1.0,794.0,794.0
0.007,6,10,1989,5,910,1.0,642.0,642.0,5,1079,1.0,811.0,811.0
0.012,6,13,3735,7,497,2.0,125.0,125.0,6,3238,2.0,1470.0,1459.0
0.006,17,2,179,1,71,0.0,43.0,43.0,1,108,0.0,80.0,80.0
0.283,17,41,20212,22,17095,13.0,1350.0,749.0,19,3117,12.0,1350.0,136.0
0.068,6,10,1506,5,395,16.0,127.0,127.0,5,1111,16.0,843.0,843.0
0.006,6,12,1698,6,863,1.0,327.0,271.0,6,835,1.0,515.0,515.0
65.977,6,22,10140,12,3973,5997.0,1579.0,835.0,10,6167,7312.0,2111.0,939.0
0.004,6,10,2006,5,927,1.0,659.0,659.0,5,1079,1.0,811.0,811.0
241.452,6,32,9819,16,3352,16096.0,757.0,502.0,16,6467,16096.0,1592.0,562.0
0.021,6,10,1990,5,911,5.0,643.0,643.0,5,1079,5.0,811.0,811.0
0.006,6,10,1689,5,839,1.0,571.0,571.0,5,850,1.0,582.0,582.0
0.142,6,10,1506,5,395,33.0,127.0,127.0,5,1111,31.0,843.0,843.0
0.119,6,10,1506,5,395,28.0,127.0,127.0,5,1111,23.0,843.0,843.0
0.005,6,10,1643,5,860,1.0,592.0,592.0,5,783,1.0,515.0,515.0
0.076,6,10,1506,5,395,16.0,127.0,127.0,5,1111,17.0,843.0,843.0
0.005,17,2,170,1,65,0.0,37.0,37.0,1,105,0.0,77.0,77.0
0.006,6,10,1547,5,764,1.0,496.0,496.0,5,783,1.0,515.0,515.0
0.006,6,10,2006,5,927,1.0,659.0,659.0,5,1079,1.0,811.0,811.0
0.009,6,12,1926,6,1189,1.0,659.0,434.0,6,737,1.0,417.0,417.0
0.008,17,2,230,1,68,0.0,40.0,40.0,1,162,0.0,134.0,134.0
0.005,6,10,1689,5,839,1.0,571.0,571.0,5,850,1.0,582.0,582.0
1.12,6,30,13239,17,5840,70.0,2073.0,854.0,13,7399,79.0,2720.0,858.0
176.17,17,80,11560,40,2687,4517.0,44.0,39.0,40,8873,4517.0,239.0,193.0
1756.055,6,105,6240,60,3510,29762.0,26.0,26.0,45,2730,39909.0,26.0,26.0
0.003,17,2,148,1,60,0.0,32.0,32.0,1,88,0.0,60.0,60.0
0.081,6,10,1506,5,395,16.0,127.0,127.0,5,1111,18.0,843.0,843.0
0.004,6,10,1779,5,928,1.0,660.0,660.0,5,851,1.0,583.0,583.0
0.006,6,10,1547,5,764,1.0,496.0,496.0,5,783,1.0,515.0,515.0
0.005,6,10,2007,5,928,1.0,660.0,660.0,5,1079,1.0,811.0,811.0
0.014,6,10,1972,5,910,3.0,642.0,642.0,5,1062,3.0,794.0,794.0
0.1,6,10,1506,5,395,22.0,127.0,127.0,5,1111,21.0,843.0,843.0
0.006,6,10,1689,5,839,1.0,571.0,571.0,5,850,1.0,582.0,582.0
0.003,17,2,186,1,61,0.0,33.0,33.0,1,125,0.0,97.0,97.0
0.006,6,10,1779,5,928,1.0,660.0,660.0,5,851,1.0,583.0,583.0
0.01,6,10,1989,5,910,2.0,642.0,642.0,5,1079,2.0,811.0,811.0
0.015,6,10,1989,5,910,3.0,642.0,642.0,5,1079,3.0,811.0,811.0
0.005,6,10,2006,5,927,1.0,659.0,659.0,5,1079,1.0,811.0,811.0
0.097,6,10,1506,5,395,21.0,127.0,127.0,5,1111,20.0,843.0,843.0
40.061,17,10,676,5,460,10014.0,104.0,64.0,5,216,10014.0,20.0,15.0
0.006,6,10,1547,5,764,1.0,496.0,496.0,5,783,1.0,515.0,515.0
0.068,6,10,1506,5,395,15.0,127.0,127.0,5,1111,16.0,843.0,843.0
240.163,6,30,9401,15,6996,17154.0,2120.0,691.0,15,2405,17151.0,580.0,231.0
0.106,6,10,1506,5,395,23.0,127.0,127.0,5,1111,25.0,843.0,843.0
0.013,6,10,1989,5,910,3.0,642.0,642.0,5,1079,3.0,811.0,811.0
0.006,6,10,1643,5,860,1.0,592.0,592.0,5,783,1.0,515.0,515.0
0.019,6,10,1989,5,910,4.0,642.0,642.0,5,1079,4.0,811.0,811.0
0.006,6,10,1547,5,764,1.0,496.0,496.0,5,783,1.0,515.0,515.0
0.005,6,10,1854,5,889,1.0,621.0,621.0,5,965,1.0,697.0,697.0
0.015,6,10,1990,5,911,3.0,643.0,643.0,5,1079,3.0,811.0,811.0
0.018,6,10,1631,5,848,4.0,580.0,580.0,5,783,4.0,515.0,515.0
11.169,17,28,4423,14,1994,847.0,269.0,114.0,14,2429,846.0,588.0,145.0
0.086,6,10,1506,5,395,19.0,127.0,127.0,5,1111,17.0,843.0,843.0
0.114,6,10,1506,5,395,25.0,127.0,127.0,5,1111,25.0,843.0,843.0
0.004,6,10,2007,5,928,1.0,660.0,660.0,5,1079,1.0,811.0,811.0
0.084,6,10,1506,5,395,19.0,127.0,127.0,5,1111,18.0,843.0,843.0
0.005,6,10,2006,5,927,1.0,659.0,659.0,5,1079,1.0,811.0,811.0
0.011,6,10,1762,5,911,2.0,643.0,643.0,5,851,2.0,583.0,583.0
0.187,6,46,11697,25,3304,7.0,1021.0,182.0,21,8393,9.0,1402.0,606.0
0.026,6,14,3868,7,578,4.0,206.0,206.0,7,3290,4.0,1448.0,972.0
0.006,6,10,1547,5,764,1.0,496.0,496.0,5,783,1.0,515.0,515.0
300.02,6,12,1782,7,1348,50003.0,494.0,494.0,5,434,75004.0,83.0,83.0
0.008,6,10,1989,5,910,1.0,642.0,642.0,5,1079,2.0,811.0,811.0
0.018,6,10,1631,5,848,4.0,580.0,580.0,5,783,4.0,515.0,515.0
0.128,6,10,1506,5,395,29.0,127.0,127.0,5,1111,27.0,843.0,843.0
0.004,17,2,148,1,60,0.0,32.0,32.0,1,88,0.0,60.0,60.0
0.006,6,10,1689,5,839,1.0,571.0,571.0,5,850,1.0,582.0,582.0
0.006,6,10,1547,5,764,1.0,496.0,496.0,5,783,1.0,515.0,515.0
0.008,6,12,1926,6,1189,1.0,659.0,434.0,6,737,1.0,417.0,417.0
0.042,17,2,136,1,60,0.0,32.0,32.0,1,76,0.0,48.0,48.0
0.088,6,10,1506,5,395,18.0,127.0,127.0,5,1111,19.0,843.0,843.0
0.004,6,10,1989,5,927,1.0,659.0,659.0,5,1062,1.0,794.0,794.0
0.003,17,2,136,1,60,0.0,32.0,32.0,1,76,0.0,48.0,48.0
0.005,6,10,2007,5,928,1.0,660.0,660.0,5,1079,1.0,811.0,811.0
0.011,6,10,1631,5,848,2.0,580.0,580.0,5,783,2.0,515.0,515.0
369.607,6,19,1689,15,978,26400.0,190.0,190.0,4,711,80013.0,495.0,495.0
0.01,6,10,1989,5,910,2.0,642.0,642.0,5,1079,2.0,811.0,811.0
364.368,6,19,1689,15,978,26026.0,190.0,190.0,4,711,80014.0,495.0,495.0
0.007,6,10,1547,5,764,1.0,496.0,496.0,5,783,1.0,515.0,515.0
0.005,6,10,2007,5,928,1.0,660.0,660.0,5,1079,1.0,811.0,811.0
0.005,17,2,169,1,62,0.0,34.0,34.0,1,107,0.0,79.0,79.0
0.012,6,10,1990,5,911,3.0,643.0,643.0,5,1079,2.0,811.0,811.0
0.005,6,10,2007,5,928,1.0,660.0,660.0,5,1079,1.0,811.0,811.0
240.017,6,9,787,5,488,60004.0,232.0,232.0,4,299,80003.0,83.0,83.0
0.004,6,10,1989,5,927,1.0,659.0,659.0,5,1062,1.0,794.0,794.0
40.067,17,10,676,5,460,10015.0,104.0,64.0,5,216,10015.0,20.0,15.0
0.015,6,10,1989,5,910,3.0,642.0,642.0,5,1079,3.0,811.0,811.0
0.011,6,10,1762,5,911,2.0,643.0,643.0,5,851,2.0,583.0,583.0
0.009,6,10,1983,5,910,2.0,642.0,642.0,5,1073,2.0,805.0,805.0
0.028,6,10,1972,5,910,7.0,642.0,642.0,5,1062,7.0,794.0,794.0
0.015,6,10,1989,5,910,3.0,642.0,642.0,5,1079,3.0,811.0,811.0
40.057,17,10,676,5,460,10012.0,104.0,64.0,5,216,10013.0,20.0,15.0
0.011,6,10,1762,5,911,2.0,643.0,643.0,5,851,2.0,583.0,583.0
0.004,6,10,1779,5,928,1.0,660.0,660.0,5,851,0.0,583.0,583.0
308.47,17,20,1124,10,716,34260.0,48.0,43.0,10,408,34260.0,20.0,12.0
0.005,6,10,1774,5,923,1.0,655.0,655.0,5,851,1.0,583.0,583.0
0.11,6,10,1506,5,395,23.0,127.0,127.0,5,1111,25.0,843.0,843.0
0.013,6,10,1677,5,827,3.0,559.0,559.0,5,850,3.0,582.0,582.0
0.004,17,4,284,2,120,0.0,32.0,32.0,2,164,1.0,60.0,54.0
10.764,17,28,4422,14,1994,819.0,269.0,114.0,14,2428,819.0,587.0,145.0
0.006,17,2,168,1,76,0.0,48.0,48.0,1,92,0.0,64.0,64.0
0.005,6,10,1689,5,839,1.0,571.0,571.0,5,850,1.0,582.0,582.0
0.009,6,10,1972,5,910,2.0,642.0,642.0,5,1062,2.0,794.0,794.0
0.012,6,10,1677,5,827,3.0,559.0,559.0,5,850,2.0,582.0,582.0
308.977,17,20,1124,10,716,34316.0,48.0,43.0,10,408,34316.0,20.0,12.0
0.005,6,10,2006,5,927,1.0,659.0,659.0,5,1079,1.0,811.0,811.0
0.014,6,10,1989,5,910,3.0,642.0,642.0,5,1079,3.0,811.0,811.0
0.003,17,2,170,1,65,0.0,37.0,37.0,1,105,0.0,77.0,77.0
0.004,17,2,144,1,64,0.0,36.0,36.0,1,80,0.0,52.0,52.0
0.001,17,2,180,1,66,0.0,38.0,38.0,1,114,0.0,86.0,86.0
11.05,17,28,4398,14,2311,841.0,586.0,137.0,14,2087,841.0,270.0,121.0
0.005,6,10,1854,5,889,1.0,621.0,621.0,5,965,1.0,697.0,697.0
40.045,17,10,676,5,460,10010.0,104.0,64.0,5,216,10010.0,20.0,15.0
0.006,6,10,1547,5,764,1.0,496.0,496.0,5,783,1.0,515.0,515.0
0.005,6,10,2000,5,927,1.0,659.0,659.0,5,1073,1.0,805.0,805.0
0.012,6,10,1990,5,911,3.0,643.0,643.0,5,1079,3.0,811.0,811.0
0.107,6,10,1506,5,395,22.0,127.0,127.0,5,1111,24.0,843.0,843.0
300.323,6,25,7300,15,1357,21451.0,217.0,142.0,10,5943,26695.0,1679.0,902.0
0.092,6,10,1506,5,395,20.0,127.0,127.0,5,1111,17.0,843.0,843.0
0.006,17,2,179,1,71,0.0,43.0,43.0,1,108,0.0,80.0,80.0
0.01,6,10,1762,5,911,2.0,643.0,643.0,5,851,2.0,583.0,583.0
0.006,17,2,179,1,71,0.0,43.0,43.0,1,108,0.0,80.0,80.0
0.003,17,2,136,1,60,0.0,32.0,32.0,1,76,0.0,48.0,48.0
0.011,6,10,1972,5,910,2.0,642.0,642.0,5,1062,2.0,794.0,794.0
178.095,17,90,12301,45,3006,4047.0,44.0,38.0,45,9295,4047.0,239.0,178.0
0.016,6,10,1762,5,911,4.0,643.0,643.0,5,851,4.0,583.0,583.0
0.003,17,4,284,2,120,0.0,32.0,32.0,2,164,0.0,60.0,54.0
0.117,6,10,1506,5,395,28.0,127.0,127.0,5,1111,26.0,843.0,843.0
0.004,17,2,148,1,60,0.0,32.0,32.0,1,88,0.0,60.0,60.0
1741.056,6,134,16982,80,12008,22038.0,302.0,302.0,54,4974,32850.0,83.0,83.0
0.078,6,10,1506,5,395,16.0,127.0,127.0,5,1111,17.0,843.0,843.0
0.014,6,10,1983,5,910,3.0,642.0,642.0,5,1073,3.0,805.0,805.0
0.006,6,10,1547,5,764,1.0,496.0,496.0,5,783,1.0,515.0,515.0
0.005,6,10,2007,5,928,1.0,660.0,660.0,5,1079,1.0,811.0,811.0
0.001,17,2,180,1,66,0.0,38.0,38.0,1,114,0.0,86.0,86.0
0.079,6,10,1506,5,395,17.0,127.0,127.0,5,1111,18.0,843.0,843.0
0.248,6,10,1506,5,395,60.0,127.0,127.0,5,1111,53.0,843.0,843.0
0.008,6,10,1547,5,764,1.0,496.0,496.0,5,783,2.0,515.0,515.0
0.129,6,10,1506,5,395,29.0,127.0,127.0,5,1111,27.0,843.0,843.0
0.006,6,10,1547,5,764,1.0,496.0,496.0,5,783,1.0,515.0,515.0
0.011,6,10,1972,5,910,2.0,642.0,642.0,5,1062,2.0,794.0,794.0
240.013,6,9,787,5,488,60003.0,232.0,232.0,4,299,80003.0,83.0,83.0
0.005,6,10,1989,5,927,1.0,659.0,659.0,5,1062,1.0,794.0,794.0
0.005,6,10,2006,5,927,1.0,659.0,659.0,5,1079,1.0,811.0,811.0
0.213,6,16,2783,8,1401,30.0,533.0,325.0,8,1382,19.0,529.0,239.0
0.005,6,10,1547,5,764,1.0,496.0,496.0,5,783,1.0,515.0,515.0
0.098,6,10,1506,5,395,22.0,127.0,127.0,5,1111,22.0,843.0,843.0
0.019,6,13,3735,7,497,3.0,125.0,125.0,6,3238,3.0,1470.0,1459.0
0.001,17,2,180,1,66,0.0,38.0,38.0,1,114,0.0,86.0,86.0
0.04,17,2,156,1,64,0.0,36.0,36.0,1,92,0.0,64.0,64.0
0.081,6,10,1506,5,395,17.0,127.0,127.0,5,1111,16.0,843.0,843.0
0.011,17,2,170,1,65,0.0,37.0,37.0,1,105,0.0,77.0,77.0
1729.168,6,60,4400,40,2740,44337.0,33.0,33.0,20,1660,91000.0,31.0,31.0
0.01,6,10,2006,5,927,2.0,659.0,659.0,5,1079,2.0,811.0,811.0
0.005,17,2,164,1,74,0.0,46.0,46.0,1,90,0.0,62.0,62.0
0.008,6,12,1926,6,1189,1.0,659.0,434.0,6,737,1.0,417.0,417.0
0.005,6,10,2006,5,927,1.0,659.0,659.0,5,1079,1.0,811.0,811.0
0.004,6,10,1779,5,928,1.0,660.0,660.0,5,851,1.0,583.0,583.0
0.386,17,4,596,2,122,262.0,33.0,33.0,2,474,259.0,323.0,209.0
1787.736,6,154,19574,92,13852,19645.0,302.0,302.0,62,5722,29307.0,83.0,83.0
0.009,6,10,1989,5,910,2.0,642.0,642.0,5,1079,2.0,811.0,811.0
0.249,17,46,26721,26,23448,9.0,1350.0,873.0,20,3273,9.0,1350.0,135.0
0.099,6,10,1506,5,395,21.0,127.0,127.0,5,1111,23.0,843.0,843.0
0.005,6,10,2000,5,927,1.0,659.0,659.0,5,1073,1.0,805.0,805.0
0.005,6,10,2007,5,928,1.0,660.0,660.0,5,1079,1.0,811.0,811.0
0.006,6,10,1547,5,764,1.0,496.0,496.0,5,783,1.0,515.0,515.0
100.8,58,5,360,4,288,33600.0,24.0,24.0,1,72,0.0,24.0,24.0
0.076,6,43,13930,24,2503,3.0,517.0,139.0,19,11427,4.0,1402.0,802.0
0.008,6,12,1926,6,1189,1.0,659.0,434.0,6,737,1.0,417.0,417.0
0.008,17,2,170,1,65,0.0,37.0,37.0,1,105,0.0,77.0,77.0
240.159,6,42,5433,21,2476,12007.0,588.0,196.0,21,2957,12007.0,580.0,232.0
300.019,6,12,1782,7,1348,50003.0,494.0,494.0,5,434,75003.0,83.0,83.0
0.005,6,10,2006,5,927,1.0,659.0,659.0,5,1079,1.0,811.0,811.0
0.005,6,10,1643,5,860,1.0,592.0,592.0,5,783,1.0,515.0,515.0
0.019,6,10,1989,5,910,4.0,642.0,642.0,5,1079,4.0,811.0,811.0
0.038,17,2,148,1,60,0.0,32.0,32.0,1,88,0.0,60.0,60.0
0.149,6,10,1506,5,395,28.0,127.0,127.0,5,1111,31.0,843.0,843.0
298.836,6,324,344042,121,17845,2490.0,2736.0,889.0,203,326197,1479.0,2804.0,1661.0
0.013,6,10,1983,5,910,3.0,642.0,642.0,5,1073,3.0,805.0,805.0
0.038,17,2,182,1,65,0.0,37.0,37.0,1,117,0.0,89.0,89.0
0.012,6,10,1989,5,910,3.0,642.0,642.0,5,1079,3.0,811.0,811.0
0.018,6,10,1983,5,910,4.0,642.0,642.0,5,1073,4.0,805.0,805.0
0.038,17,2,170,1,65,0.0,37.0,37.0,1,105,0.0,77.0,77.0
240.102,6,16,4482,9,963,30012.0,238.0,166.0,7,3519,40016.0,1402.0,786.0
0.006,6,10,1689,5,839,1.0,571.0,571.0,5,850,1.0,582.0,582.0
0.005,6,10,1989,5,927,1.0,659.0,659.0,5,1062,1.0,794.0,794.0
0.004,6,10,2006,5,927,1.0,659.0,659.0,5,1079,1.0,811.0,811.0
0.079,6,10,1506,5,395,18.0,127.0,127.0,5,1111,18.0,843.0,843.0
0.011,6,10,1631,5,848,2.0,580.0,580.0,5,783,2.0,515.0,515.0
0.011,6,10,1972,5,910,2.0,642.0,642.0,5,1062,2.0,794.0,794.0
0.01,6,12,1698,6,863,2.0,327.0,271.0,6,835,1.0,515.0,515.0
0.016,6,10,1989,5,910,4.0,642.0,642.0,5,1079,4.0,811.0,811.0
0.006,6,10,1547,5,764,1.0,496.0,496.0,5,783,1.0,515.0,515.0
0.006,6,10,1547,5,764,1.0,496.0,496.0,5,783,1.0,515.0,515.0
0.005,6,10,2006,5,927,1.0,659.0,659.0,5,1079,1.0,811.0,811.0
0.005,6,10,1689,5,839,1.0,571.0,571.0,5,850,1.0,582.0,582.0
0.07,6,10,1506,5,395,16.0,127.0,127.0,5,1111,16.0,843.0,843.0
0.007,6,10,1983,5,910,1.0,642.0,642.0,5,1073,1.0,805.0,805.0
0.013,6,10,1989,5,910,3.0,642.0,642.0,5,1079,3.0,811.0,811.0
0.015,6,10,1972,5,910,3.0,642.0,642.0,5,1062,3.0,794.0,794.0
0.01,6,10,1990,5,911,2.0,643.0,643.0,5,1079,2.0,811.0,811.0
40.062,17,10,676,5,460,10014.0,104.0,64.0,5,216,10014.0,20.0,15.0
9.035,17,6,376,5,280,2258.0,28.0,28.0,1,96,0.0,68.0,68.0
0.013,6,10,1990,5,911,3.0,643.0,643.0,5,1079,3.0,811.0,811.0
0.228,6,16,2780,8,1506,32.0,533.0,360.0,8,1274,20.0,529.0,212.0
0.213,6,16,2670,8,1396,30.0,533.0,324.0,8,1274,19.0,529.0,212.0
0.006,17,2,184,1,68,0.0,40.0,40.0,1,116,0.0,88.0,88.0
0.091,6,10,1506,5,395,21.0,127.0,127.0,5,1111,21.0,843.0,843.0
0.006,6,10,1547,5,764,1.0,496.0,496.0,5,783,1.0,515.0,515.0
0.005,17,2,144,1,64,0.0,36.0,36.0,1,80,0.0,52.0,52.0
51.921,6,38,9851,19,4293,498.0,1360.0,700.0,19,5558,2875.0,1360.0,398.0
0.098,6,10,1506,5,395,22.0,127.0,127.0,5,1111,19.0,843.0,843.0
0.004,17,2,136,1,60,0.0,32.0,32.0,1,76,0.0,48.0,48.0
0.012,6,10,1762,5,911,2.0,643.0,643.0,5,851,2.0,583.0,583.0
0.114,6,10,1506,5,395,26.0,127.0,127.0,5,1111,23.0,843.0,843.0
0.097,6,10,1506,5,395,21.0,127.0,127.0,5,1111,22.0,843.0,843.0
0.067,6,10,1506,5,395,14.0,127.0,127.0,5,1111,14.0,843.0,843.0
40.055,17,10,676,5,460,10013.0,104.0,64.0,5,216,10011.0,20.0,15.0
0.102,6,10,1506,5,395,23.0,127.0,127.0,5,1111,20.0,843.0,843.0
0.013,6,10,1990,5,911,3.0,643.0,643.0,5,1079,3.0,811.0,811.0
0.065,6,10,1506,5,395,13.0,127.0,127.0,5,1111,15.0,843.0,843.0
0.009,6,10,1989,5,910,2.0,642.0,642.0,5,1079,2.0,811.0,811.0
40.092,17,10,676,5,460,10011.0,104.0,64.0,5,216,10021.0,20.0,15.0
0.005,6,10,1989,5,927,1.0,659.0,659.0,5,1062,1.0,794.0,794.0
0.018,6,10,1989,5,910,4.0,642.0,642.0,5,1079,4.0,811.0,811.0
0.009,6,10,1989,5,910,2.0,642.0,642.0,5,1079,2.0,811.0,811.0
11.069,17,28,4424,14,1995,839.0,270.0,114.0,14,2429,839.0,588.0,145.0
0.013,6,10,1989,5,910,3.0,642.0,642.0,5,1079,3.0,811.0,811.0
240.115,6,30,9505,15,7088,17151.0,2213.0,701.0,15,2417,17150.0,580.0,232.0
0.011,6,10,1989,5,910,2.0,642.0,642.0,5,1079,2.0,811.0,811.0
0.013,6,10,1989,5,910,3.0,642.0,642.0,5,1079,3.0,811.0,811.0
0.004,6,10,2006,5,927,1.0,659.0,659.0,5,1079,1.0,811.0,811.0
0.005,6,10,2006,5,927,1.0,659.0,659.0,5,1079,1.0,811.0,811.0
0.013,6,10,1631,5,848,3.0,580.0,580.0,5,783,3.0,515.0,515.0
0.076,6,10,1506,5,395,18.0,127.0,127.0,5,1111,14.0,843.0,843.0
0.016,6,10,1989,5,910,4.0,642.0,642.0,5,1079,4.0,811.0,811.0
0.012,6,10,1983,5,910,3.0,642.0,642.0,5,1073,2.0,805.0,805.0
0.004,17,2,148,1,60,0.0,32.0,32.0,1,88,0.0,60.0,60.0
0.005,6,10,1989,5,927,1.0,659.0,659.0,5,1062,1.0,794.0,794.0
11.079,17,28,4416,14,1993,840.0,268.0,114.0,14,2423,840.0,586.0,145.0
40.086,17,10,676,5,460,10020.0,104.0,64.0,5,216,10020.0,20.0,15.0
0.005,6,10,1989,5,927,1.0,659.0,659.0,5,1062,1.0,794.0,794.0
0.003,17,2,148,1,60,0.0,32.0,32.0,1,88,0.0,60.0,60.0
0.004,17,2,154,1,69,0.0,41.0,41.0,1,85,0.0,57.0,57.0
0.011,6,10,1990,5,911,2.0,643.0,643.0,5,1079,2.0,811.0,811.0
0.005,6,10,2007,5,928,1.0,660.0,660.0,5,1079,1.0,811.0,811.0
0.001,17,2,136,1,60,0.0,32.0,32.0,1,76,0.0,48.0,48.0
0.005,6,10,1643,5,860,1.0,592.0,592.0,5,783,1.0,515.0,515.0
0.012,6,10,1989,5,910,2.0,642.0,642.0,5,1079,3.0,811.0,811.0
0.006,17,2,170,1,65,0.0,37.0,37.0,1,105,0.0,77.0,77.0
0.009,6,12,1926,6,1189,1.0,659.0,434.0,6,737,1.0,417.0,417.0
0.09,6,10,1506,5,395,19.0,127.0,127.0,5,1111,20.0,843.0,843.0
0.015,6,10,1972,5,910,3.0,642.0,642.0,5,1062,3.0,794.0,794.0
0.083,6,10,1506,5,395,18.0,127.0,127.0,5,1111,17.0,843.0,843.0
0.013,6,10,1989,5,910,3.0,642.0,642.0,5,1079,3.0,811.0,811.0
0.007,6,12,1698,6,863,1.0,327.0,271.0,6,835,1.0,515.0,515.0
0.005,6,10,2006,5,927,1.0,659.0,659.0,5,1079,1.0,811.0,811.0
0.127,17,2,170,1,65,0.0,37.0,37.0,1,105,0.0,77.0,77.0
0.088,6,10,1506,5,395,19.0,127.0,127.0,5,1111,18.0,843.0,843.0
0.001,17,2,180,1,66,0.0,38.0,38.0,1,114,0.0,86.0,86.0
240.272,6,46,8978,23,5802,10921.0,1515.0,509.0,23,3176,10921.0,580.0,219.0
0.091,6,10,1506,5,395,21.0,127.0,127.0,5,1111,21.0,843.0,843.0
0.01,6,10,1989,5,910,2.0,642.0,642.0,5,1079,2.0,811.0,811.0
0.013,6,10,1989,5,910,3.0,642.0,642.0,5,1079,3.0,811.0,811.0
0.085,6,10,1506,5,395,18.0,127.0,127.0,5,1111,19.0,843.0,843.0
0.009,6,10,1762,5,911,2.0,643.0,643.0,5,851,2.0,583.0,583.0
0.095,6,10,1506,5,395,21.0,127.0,127.0,5,1111,21.0,843.0,843.0
0.005,6,10,1779,5,928,1.0,660.0,660.0,5,851,1.0,583.0,583.0
0.006,6,10,1689,5,839,1.0,571.0,571.0,5,850,1.0,582.0,582.0
0.006,6,13,3747,7,509,0.0,137.0,137.0,6,3238,1.0,1470.0,1459.0
0.005,6,10,2006,5,927,1.0,659.0,659.0,5,1079,1.0,811.0,811.0
0.113,6,10,1506,5,395,27.0,127.0,127.0,5,1111,25.0,843.0,843.0
0.005,17,2,170,1,65,0.0,37.0,37.0,1,105,0.0,77.0,77.0
0.105,6,10,1506,5,395,21.0,127.0,127.0,5,1111,23.0,843.0,843.0
0.04,17,2,184,1,61,0.0,33.0,33.0,1,123,0.0,95.0,95.0
40.06,17,10,676,5,460,10013.0,104.0,64.0,5,216,10014.0,20.0,15.0
0.042,17,4,596,2,122,0.0,33.0,33.0,2,474,3.0,323.0,209.0
0.006,6,10,1547,5,764,1.0,496.0,496.0,5,783,1.0,515.0,515.0
0.082,6,10,1506,5,395,18.0,127.0,127.0,5,1111,16.0,843.0,843.0
0.109,6,10,1506,5,395,22.0,127.0,127.0,5,1111,21.0,843.0,843.0
15.074,17,15,9239,8,6902,2149.0,1350.0,834.0,7,2337,2507.0,1350.0,305.0
0.012,6,10,1631,5,848,3.0,580.0,580.0,5,783,2.0,515.0,515.0
0.101,6,10,1506,5,395,24.0,127.0,127.0,5,1111,24.0,843.0,843.0
0.008,6,10,1983,5,910,2.0,642.0,642.0,5,1073,1.0,805.0,805.0
308.233,17,20,1124,10,716,34241.0,48.0,43.0,10,408,34241.0,20.0,12.0
0.018,6,10,1631,5,848,4.0,580.0,580.0,5,783,4.0,515.0,515.0
0.102,6,10,1506,5,395,22.0,127.0,127.0,5,1111,21.0,843.0,843.0
0.067,6,10,1506,5,395,15.0,127.0,127.0,5,1111,15.0,843.0,843.0
0.011,6,10,1983,5,910,2.0,642.0,642.0,5,1073,2.0,805.0,805.0
0.208,6,10,1506,5,395,33.0,127.0,127.0,5,1111,49.0,843.0,843.0
0.007,6,10,1547,5,764,1.0,496.0,496.0,5,783,1.0,515.0,515.0
15.079,17,16,8427,8,6124,2150.0,1350.0,737.0,8,2303,2150.0,1350.0,259.0
0.005,6,10,1547,5,764,1.0,496.0,496.0,5,783,1.0,515.0,515.0
0.136,6,25,7499,15,3081,8.0,1402.0,380.0,10,4418,13.0,1324.0,778.0
0.017,6,10,1989,5,910,4.0,642.0,642.0,5,1079,4.0,811.0,811.0
0.006,6,12,1698,6,863,1.0,327.0,271.0,6,835,1.0,515.0,515.0
0.015,6,10,1762,5,911,3.0,643.0,643.0,5,851,3.0,583.0,583.0
0.008,17,4,284,2,120,0.0,32.0,32.0,2,164,0.0,60.0,54.0
0.009,6,10,1677,5,827,2.0,559.0,559.0,5,850,2.0,582.0,582.0
0.116,6,10,1506,5,395,26.0,127.0,127.0,5,1111,24.0,843.0,843.0
0.004,17,2,186,1,61,0.0,33.0,33.0,1,125,0.0,97.0,97.0
0.018,6,10,1762,5,911,4.0,643.0,643.0,5,851,4.0,583.0,583.0
0.01,6,14,3787,7,497,1.0,125.0,125.0,7,3290,1.0,1448.0,972.0
0.01,6,10,1989,5,910,2.0,642.0,642.0,5,1079,2.0,811.0,811.0
0.012,6,10,1972,5,910,3.0,642.0,642.0,5,1062,2.0,794.0,794.0
0.004,17,2,136,1,60,0.0,32.0,32.0,1,76,0.0,48.0,48.0
351.984,6,20,2210,6,1308,12003.0,494.0,494.0,14,902,27075.0,83.0,83.0
0.008,6,10,1989,5,910,2.0,642.0,642.0,5,1079,2.0,811.0,811.0
40.074,17,10,676,5,460,10017.0,104.0,64.0,5,216,10017.0,20.0,15.0
0.004,17,2,136,1,60,0.0,32.0,32.0,1,76,0.0,48.0,48.0
0.076,6,10,1506,5,395,16.0,127.0,127.0,5,1111,16.0,843.0,843.0
0.01,6,10,1989,5,910,2.0,642.0,642.0,5,1079,2.0,811.0,811.0
1772.57,6,303,93711,185,82851,9633.0,2001.0,684.0,118,10860,15150.0,92.0,62.0
352.499,6,20,2210,6,1308,12006.0,494.0,494.0,14,902,27115.0,83.0,83.0
0.005,6,10,1779,5,928,1.0,660.0,660.0,5,851,1.0,583.0,583.0
0.143,6,10,1506,5,395,34.0,127.0,127.0,5,1111,34.0,843.0,843.0
0.013,17,2,152,1,56,0.0,28.0,28.0,1,96,0.0,68.0,68.0
171.102,17,74,10502,37,2466,4752.0,44.0,38.0,37,8036,4752.0,239.0,189.0
0.079,6,10,1506,5,395,18.0,127.0,127.0,5,1111,18.0,843.0,843.0
0.014,6,10,1972,5,910,3.0,642.0,642.0,5,1062,3.0,794.0,794.0
0.006,6,10,1854,5,889,1.0,621.0,621.0,5,965,1.0,697.0,697.0
0.01,6,10,1989,5,910,2.0,642.0,642.0,5,1079,2.0,811.0,811.0
0.076,6,10,1506,5,395,17.0,127.0,127.0,5,1111,15.0,843.0,843.0
0.005,17,2,166,1,75,0.0,47.0,47.0,1,91,0.0,63.0,63.0
0.001,17,2,180,1,66,0.0,38.0,38.0,1,114,0.0,86.0,86.0
0.006,17,2,180,1,66,0.0,38.0,38.0,1,114,0.0,86.0,86.0
0.009,6,10,1762,5,911,2.0,643.0,643.0,5,851,2.0,583.0,583.0
0.006,6,10,1547,5,764,1.0,496.0,496.0,5,783,1.0,515.0,515.0
0.015,17,2,166,1,75,0.0,47.0,47.0,1,91,0.0,63.0,63.0
0.021,6,10,1972,5,910,5.0,642.0,642.0,5,1062,5.0,794.0,794.0
0.07,17,8,3613,4,1874,23.0,1350.0,440.0,4,1739,12.0,1350.0,406.0
0.039,17,2,136,1,60,0.0,32.0,32.0,1,76,0.0,48.0,48.0
0.111,6,10,1506,5,395,25.0,127.0,127.0,5,1111,25.0,843.0,843.0
0.004,6,10,1779,5,928,1.0,660.0,660.0,5,851,1.0,583.0,583.0
308.843,17,18,1008,9,640,38592.0,48.0,43.0,9,368,38591.0,20.0,12.0
0.105,6,10,1506,5,395,23.0,127.0,127.0,5,1111,22.0,843.0,843.0
0.169,17,2,152,1,76,0.0,48.0,48.0,1,76,0.0,48.0,48.0
0.139,6,10,1506,5,395,32.0,127.0,127.0,5,1111,24.0,843.0,843.0
0.011,6,10,1631,5,848,2.0,580.0,580.0,5,783,2.0,515.0,515.0
0.012,6,10,1983,5,910,2.0,642.0,642.0,5,1073,3.0,805.0,805.0
0.004,17,2,148,1,60,0.0,32.0,32.0,1,88,0.0,60.0,60.0
0.005,6,10,2000,5,927,1.0,659.0,659.0,5,1073,1.0,805.0,805.0
0.069,6,10,1506,5,395,16.0,127.0,127.0,5,1111,15.0,843.0,843.0
0.013,6,10,1990,5,911,3.0,643.0,643.0,5,1079,3.0,811.0,811.0
0.039,17,2,136,1,60,0.0,32.0,32.0,1,76,0.0,48.0,48.0
15.082,17,15,8679,8,6455,2150.0,1350.0,778.0,7,2224,2508.0,1350.0,289.0
241.204,6,394,348723,188,21298,1289.0,2736.0,885.0,206,327425,1176.0,2804.0,1615.0
0.088,6,10,1506,5,395,19.0,127.0,127.0,5,1111,20.0,843.0,843.0
0.126,6,10,1506,5,395,27.0,127.0,127.0,5,1111,26.0,843.0,843.0
0.006,6,10,1643,5,860,1.0,592.0,592.0,5,783,1.0,515.0,515.0
0.005,6,10,2006,5,927,1.0,659.0,659.0,5,1079,1.0,811.0,811.0
0.004,6,10,1774,5,923,1.0,655.0,655.0,5,851,0.0,583.0,583.0
0.004,6,10,2007,5,928,1.0,660.0,660.0,5,1079,1.0,811.0,811.0
0.005,6,10,1689,5,839,1.0,571.0,571.0,5,850,1.0,582.0,582.0
0.004,6,10,2007,5,928,1.0,660.0,660.0,5,1079,1.0,811.0,811.0
0.069,6,10,1506,5,395,16.0,127.0,127.0,5,1111,14.0,843.0,843.0
0.004,6,10,2007,5,928,1.0,660.0,660.0,5,1079,1.0,811.0,811.0
0.421,17,2,142,1,63,0.0,35.0,35.0,1,79,0.0,51.0,51.0
0.005,17,2,193,1,71,0.0,43.0,43.0,1,122,0.0,94.0,94.0
0.005,6,10,2006,5,927,1.0,659.0,659.0,5,1079,1.0,811.0,811.0
0.014,6,10,1983,5,910,3.0,642.0,642.0,5,1073,3.0,805.0,805.0
0.009,6,10,1983,5,910,2.0,642.0,642.0,5,1073,2.0,805.0,805.0
0.004,6,10,1702,5,863,1.0,595.0,595.0,5,839,0.0,571.0,571.0
0.005,6,10,2007,5,928,1.0,660.0,660.0,5,1079,1.0,811.0,811.0
0.019,6,10,1631,5,848,4.0,580.0,580.0,5,783,4.0,515.0,515.0
178.031,17,72,10263,36,2403,5086.0,44.0,38.0,36,7860,5086.0,261.0,190.0
0.055,17,2,179,1,71,0.0,43.0,43.0,1,108,0.0,80.0,80.0
0.078,6,10,1506,5,395,18.0,127.0,127.0,5,1111,19.0,843.0,843.0
0.008,6,10,1972,5,910,2.0,642.0,642.0,5,1062,1.0,794.0,794.0
0.001,17,2,180,1,66,0.0,38.0,38.0,1,114,0.0,86.0,86.0
0.003,17,2,148,1,60,0.0,32.0,32.0,1,88,0.0,60.0,60.0
0.001,17,2,166,1,75,0.0,47.0,47.0,1,91,0.0,63.0,63.0
0.005,6,10,2007,5,928,1.0,660.0,660.0,5,1079,1.0,811.0,811.0
0.009,6,10,1989,5,910,2.0,642.0,642.0,5,1079,2.0,811.0,811.0
0.006,6,10,1547,5,764,1.0,496.0,496.0,5,783,1.0,515.0,515.0
0.006,6,10,1547,5,764,1.0,496.0,496.0,5,783,1.0,515.0,515.0
0.091,6,10,1506,5,395,21.0,127.0,127.0,5,1111,19.0,843.0,843.0
0.004,6,10,1702,5,863,1.0,595.0,595.0,5,839,0.0,571.0,571.0
0.004,17,4,284,2,120,0.0,32.0,32.0,2,164,0.0,60.0,54.0
0.093,6,10,1506,5,395,22.0,127.0,127.0,5,1111,17.0,843.0,843.0
0.005,6,10,1689,5,839,1.0,571.0,571.0,5,850,1.0,582.0,582.0
0.007,6,10,1689,5,839,1.0,571.0,571.0,5,850,1.0,582.0,582.0
309.514,17,20,1124,10,716,34376.0,48.0,43.0,10,408,34376.0,20.0,12.0
0.015,17,2,198,1,91,0.0,63.0,63.0,1,107,0.0,79.0,79.0
0.005,17,2,230,1,68,0.0,40.0,40.0,1,162,0.0,134.0,134.0
0.016,6,10,1989,5,910,4.0,642.0,642.0,5,1079,3.0,811.0,811.0
0.081,17,2,156,1,64,0.0,36.0,36.0,1,92,0.0,64.0,64.0
0.005,6,10,2006,5,927,1.0,659.0,659.0,5,1079,1.0,811.0,811.0
0.039,17,2,184,1,61,0.0,33.0,33.0,1,123,0.0,95.0,95.0
0.011,6,10,1972,5,910,2.0,642.0,642.0,5,1062,2.0,794.0,794.0
0.005,6,10,2006,5,927,1.0,659.0,659.0,5,1079,1.0,811.0,811.0
0.019,6,10,1983,5,910,4.0,642.0,642.0,5,1073,4.0,805.0,805.0
0.005,6,10,1854,5,889,1.0,621.0,621.0,5,965,1.0,697.0,697.0
0.006,6,10,1689,5,839,1.0,571.0,571.0,5,850,1.0,582.0,582.0
0.005,6,14,3742,8,504,0.0,80.0,80.0,6,3238,1.0,1470.0,1459.0
0.089,6,10,1506,5,395,19.0,127.0,127.0,5,1111,18.0,843.0,843.0
281.77,6,22,6035,9,1146,35220.0,267.0,156.0,13,4889,23480.0,1400.0,873.0
0.008,6,10,1983,5,910,2.0,642.0,642.0,5,1073,2.0,805.0,805.0
0.087,6,10,1506,5,395,17.0,127.0,127.0,5,1111,20.0,843.0,843.0
351.989,6,20,2210,6,1308,12003.0,494.0,494.0,14,902,27075.0,83.0,83.0
0.004,6,10,2006,5,927,1.0,659.0,659.0,5,1079,1.0,811.0,811.0
0.882,17,24,17282,10,4282,98.0,1350.0,400.0,14,13000,65.0,1350.0,900.0
0.004,6,10,1779,5,928,1.0,660.0,660.0,5,851,1.0,583.0,583.0
300.496,6,16,2170,9,684,37540.0,146.0,146.0,7,1486,50054.0,419.0,398.0
0.005,6,10,2006,5,927,1.0,659.0,659.0,5,1079,1.0,811.0,811.0
0.064,6,10,1506,5,395,15.0,127.0,127.0,5,1111,15.0,843.0,843.0
0.005,6,10,1689,5,839,1.0,571.0,571.0,5,850,1.0,582.0,582.0
0.013,6,10,1972,5,910,3.0,642.0,642.0,5,1062,3.0,794.0,794.0
0.013,6,10,1989,5,910,3.0,642.0,642.0,5,1079,3.0,811.0,811.0
0.007,6,10,1643,5,860,1.0,592.0,592.0,5,783,1.0,515.0,515.0
0.005,6,10,2007,5,928,1.0,660.0,660.0,5,1079,1.0,811.0,811.0
0.1,6,10,1506,5,395,23.0,127.0,127.0,5,1111,24.0,843.0,843.0
0.079,17,2,152,1,76,0.0,48.0,48.0,1,76,0.0,48.0,48.0
0.071,6,10,1506,5,395,13.0,127.0,127.0,5,1111,15.0,843.0,843.0
40.093,17,10,676,5,460,10017.0,104.0,64.0,5,216,10021.0,20.0,15.0
40.064,17,10,676,5,460,10014.0,104.0,64.0,5,216,10015.0,20.0,15.0
300.338,6,16,2170,9,684,37521.0,146.0,146.0,7,1486,50028.0,419.0,398.0
0.004,6,10,2000,5,927,1.0,659.0,659.0,5,1073,1.0,805.0,805.0
0.006,17,2,248,1,58,0.0,30.0,30.0,1,190,0.0,162.0,162.0
10.797,17,26,4098,13,1846,891.0,269.0,114.0,13,2252,890.0,587.0,145.0
0.127,6,10,1506,5,395,28.0,127.0,127.0,5,1111,28.0,843.0,843.0
0.004,6,10,2006,5,927,1.0,659.0,659.0,5,1079,1.0,811.0,811.0
0.006,6,10,1854,5,889,1.0,621.0,621.0,5,965,1.0,697.0,697.0
40.07,17,10,676,5,460,10014.0,104.0,64.0,5,216,10016.0,20.0,15.0
10.922,17,28,4417,14,1993,832.0,268.0,114.0,14,2424,831.0,587.0,145.0
0.005,6,10,1643,5,860,1.0,592.0,592.0,5,783,1.0,515.0,515.0
1.062,6,31,13351,17,5852,66.0,2073.0,854.0,14,7499,68.0,2720.0,769.0
0.004,17,4,284,2,120,1.0,32.0,32.0,2,164,1.0,60.0,54.0
0.01,6,10,1972,5,910,2.0,642.0,642.0,5,1062,2.0,794.0,794.0
352.987,6,20,2210,6,1308,12004.0,494.0,494.0,14,902,27152.0,83.0,83.0
0.22,6,16,2670,8,1396,31.0,533.0,324.0,8,1274,20.0,529.0,212.0
0.088,6,10,1506,5,395,18.0,127.0,127.0,5,1111,21.0,843.0,843.0
241.962,6,286,342938,116,17545,2104.0,2736.0,885.0,170,325393,1431.0,2916.0,1978.0
0.005,17,2,144,1,64,0.0,36.0,36.0,1,80,0.0,52.0,52.0
0.071,6,10,1506,5,395,16.0,127.0,127.0,5,1111,16.0,843.0,843.0
0.003,17,2,136,1,60,0.0,32.0,32.0,1,76,0.0,48.0,48.0
0.012,6,10,1762,5,911,2.0,643.0,643.0,5,851,3.0,583.0,583.0
0.014,6,10,1677,5,827,3.0,559.0,559.0,5,850,3.0,582.0,582.0
0.014,6,10,1989,5,910,3.0,642.0,642.0,5,1079,3.0,811.0,811.0
0.005,6,10,1689,5,839,1.0,571.0,571.0,5,850,1.0,582.0,582.0
0.008,6,10,1972,5,910,2.0,642.0,642.0,5,1062,2.0,794.0,794.0
240.015,6,9,787,5,488,60003.0,232.0,232.0,4,299,80003.0,83.0,83.0
0.153,6,10,1506,5,395,32.0,127.0,127.0,5,1111,34.0,843.0,843.0
0.014,6,10,1990,5,911,3.0,643.0,643.0,5,1079,3.0,811.0,811.0
0.067,6,10,1506,5,395,14.0,127.0,127.0,5,1111,15.0,843.0,843.0
0.003,17,2,136,1,60,0.0,32.0,32.0,1,76,0.0,48.0,48.0
0.006,6,10,2007,5,928,1.0,660.0,660.0,5,1079,1.0,811.0,811.0
40.057,17,10,676,5,460,10013.0,104.0,64.0,5,216,10013.0,20.0,15.0
0.102,6,10,1506,5,395,22.0,127.0,127.0,5,1111,22.0,843.0,843.0
0.005,6,10,2006,5,927,1.0,659.0,659.0,5,1079,1.0,811.0,811.0
0.005,6,14,3799,7,509,0.0,137.0,137.0,7,3290,0.0,1448.0,972.0
0.005,6,10,2006,5,927,1.0,659.0,659.0,5,1079,1.0,811.0,811.0
241.758,6,371,347326,183,21045,1328.0,2736.0,960.0,188,326281,1292.0,2804.0,1778.0
40.079,17,10,676,5,460,10011.0,104.0,64.0,5,216,10018.0,20.0,15.0
0.009,6,12,1926,6,1189,1.0,659.0,434.0,6,737,1.0,417.0,417.0
0.006,6,10,1547,5,764,1.0,496.0,496.0,5,783,1.0,515.0,515.0
0.009,6,10,1989,5,910,2.0,642.0,642.0,5,1079,2.0,811.0,811.0
0.013,6,10,1631,5,848,3.0,580.0,580.0,5,783,3.0,515.0,515.0
0.078,6,10,1506,5,395,17.0,127.0,127.0,5,1111,17.0,843.0,843.0
15.296,17,26,17436,11,4341,1526.0,1350.0,366.0,15,13095,1090.0,1350.0,845.0
0.005,6,14,3742,7,452,0.0,80.0,80.0,7,3290,0.0,1448.0,972.0
0.005,17,2,144,1,64,0.0,36.0,36.0,1,80,0.0,52.0,52.0
0.09,6,10,1506,5,395,18.0,127.0,127.0,5,1111,20.0,843.0,843.0
11.118,17,28,4422,14,1995,843.0,270.0,114.0,14,2427,842.0,586.0,145.0
0.012,6,13,3735,7,497,1.0,125.0,125.0,6,3238,2.0,1470.0,1459.0
361.843,6,19,1688,15,978,25845.0,190.0,190.0,4,710,80012.0,494.0,494.0
0.01,6,10,1989,5,910,2.0,642.0,642.0,5,1079,2.0,811.0,811.0
0.007,17,2,299,1,65,0.0,37.0,37.0,1,234,0.0,206.0,206.0
15.069,17,14,9190,8,6902,2148.0,1350.0,834.0,6,2288,3008.0,1350.0,353.0
0.006,17,2,180,1,66,0.0,38.0,38.0,1,114,0.0,86.0,86.0
0.013,6,10,1990,5,911,3.0,643.0,643.0,5,1079,3.0,811.0,811.0
0.009,6,10,1762,5,911,2.0,643.0,643.0,5,851,2.0,583.0,583.0
240.463,6,36,10195,18,1887,14142.0,559.0,188.0,18,8308,14142.0,1402.0,614.0
0.004,17,2,148,1,60,0.0,32.0,32.0,1,88,0.0,60.0,60.0
0.106,6,10,1506,5,395,22.0,127.0,127.0,5,1111,20.0,843.0,843.0
0.014,6,10,1989,5,910,3.0,642.0,642.0,5,1079,3.0,811.0,811.0
0.067,6,10,1506,5,395,14.0,127.0,127.0,5,1111,14.0,843.0,843.0
0.099,6,10,1506,5,395,23.0,127.0,127.0,5,1111,22.0,843.0,843.0
900.624,6,53,19239,27,6232,34639.0,1273.0,535.0,26,13007,36024.0,1402.0,777.0
0.004,17,2,148,1,60,0.0,32.0,32.0,1,88,0.0,60.0,60.0
0.105,6,10,1506,5,395,23.0,127.0,127.0,5,1111,23.0,843.0,843.0
10.924,17,28,4419,14,1995,831.0,270.0,114.0,14,2424,831.0,587.0,145.0
0.208,6,16,2778,8,1396,29.0,533.0,324.0,8,1382,19.0,529.0,239.0
280.233,6,24,6360,11,1471,28023.0,267.0,171.0,13,4889,23352.0,1400.0,873.0
0.023,6,14,3787,7,497,3.0,125.0,125.0,7,3290,3.0,1448.0,972.0
0.008,6,10,1972,5,910,2.0,642.0,642.0,5,1062,2.0,794.0,794.0
0.005,6,10,1779,5,928,1.0,660.0,660.0,5,851,1.0,583.0,583.0
11.223,17,28,4422,14,1994,850.0,269.0,114.0,14,2428,850.0,587.0,145.0
1792.559,6,493,100374,247,88944,7286.0,421.0,366.0,246,11430,7316.0,53.0,53.0
0.003,17,2,148,1,60,0.0,32.0,32.0,1,88,0.0,60.0,60.0
1.196,6,29,7768,17,2784,74.0,1477.0,515.0,12,4984,93.0,2745.0,561.0
0.001,17,2,180,1,66,0.0,38.0,38.0,1,114,0.0,86.0,86.0
0.005,6,10,2000,5,927,1.0,659.0,659.0,5,1073,1.0,805.0,805.0
0.004,6,10,2000,5,927,1.0,659.0,659.0,5,1073,1.0,805.0,805.0
0.051,6,10,1506,5,395,10.0,127.0,127.0,5,1111,12.0,843.0,843.0
0.005,6,13,3747,7,509,0.0,137.0,137.0,6,3238,1.0,1470.0,1459.0
0.005,17,2,412,1,61,0.0,33.0,33.0,1,351,0.0,323.0,323.0
0.206,6,16,2669,8,1395,29.0,533.0,323.0,8,1274,18.0,529.0,212.0
0.006,6,10,1547,5,764,1.0,496.0,496.0,5,783,1.0,515.0,515.0
40.072,17,10,676,5,460,10015.0,104.0,64.0,5,216,10017.0,20.0,15.0
0.006,6,14,3736,7,446,0.0,74.0,74.0,7,3290,0.0,1448.0,972.0
0.003,17,2,136,1,60,0.0,32.0,32.0,1,76,0.0,48.0,48.0
0.012,6,10,1983,5,910,2.0,642.0,642.0,5,1073,3.0,805.0,805.0
0.005,6,10,1989,5,927,1.0,659.0,659.0,5,1062,1.0,794.0,794.0
0.069,6,10,1506,5,395,15.0,127.0,127.0,5,1111,13.0,843.0,843.0
240.024,6,9,787,5,488,60006.0,232.0,232.0,4,299,80007.0,83.0,83.0
0.062,6,10,1506,5,395,15.0,127.0,127.0,5,1111,11.0,843.0,843.0
0.015,17,2,140,1,62,0.0,34.0,34.0,1,78,0.0,50.0,50.0
0.011,6,10,1631,5,848,2.0,580.0,580.0,5,783,2.0,515.0,515.0
0.089,6,10,1506,5,395,18.0,127.0,127.0,5,1111,19.0,843.0,843.0
0.01,6,10,1989,5,910,2.0,642.0,642.0,5,1079,2.0,811.0,811.0
0.004,6,10,1779,5,928,1.0,660.0,660.0,5,851,1.0,583.0,583.0
309.178,17,20,1124,10,716,34346.0,48.0,43.0,10,408,34343.0,20.0,12.0
0.05,6,10,1990,5,911,12.0,643.0,643.0,5,1079,12.0,811.0,811.0
0.04,17,2,234,1,61,0.0,33.0,33.0,1,173,0.0,145.0,145.0
0.006,6,10,1547,5,764,1.0,496.0,496.0,5,783,1.0,515.0,515.0
40.063,17,10,676,5,460,10014.0,104.0,64.0,5,216,10014.0,20.0,15.0
0.006,6,10,1643,5,860,1.0,592.0,592.0,5,783,1.0,515.0,515.0
0.003,17,2,136,1,60,0.0,32.0,32.0,1,76,0.0,48.0,48.0
0.006,6,10,1547,5,764,1.0,496.0,496.0,5,783,1.0,515.0,515.0
0.008,17,2,170,1,65,0.0,37.0,37.0,1,105,0.0,77.0,77.0
0.001,17,2,180,1,65,0.0,37.0,37.0,1,115,0.0,87.0,87.0
0.005,6,10,1774,5,923,1.0,655.0,655.0,5,851,1.0,583.0,583.0
0.001,17,2,142,1,63,0.0,35.0,35.0,1,79,0.0,51.0,51.0
0.005,6,10,1774,5,923,1.0,655.0,655.0,5,851,1.0,583.0,583.0
0.004,17,2,148,1,60,0.0,32.0,32.0,1,88,0.0,60.0,60.0
293.724,6,405,348129,194,21649,1521.0,2736.0,888.0,211,326480,1398.0,2804.0,1601.0
0.007,6,10,1643,5,860,1.0,592.0,592.0,5,783,1.0,515.0,515.0
0.012,6,10,1990,5,911,3.0,643.0,643.0,5,1079,2.0,811.0,811.0
0.001,17,2,180,1,66,0.0,38.0,38.0,1,114,0.0,86.0,86.0
0.004,17,2,148,1,60,0.0,32.0,32.0,1,88,0.0,60.0,60.0
0.078,6,10,1506,5,395,16.0,127.0,127.0,5,1111,16.0,843.0,843.0
0.072,6,10,1506,5,395,17.0,127.0,127.0,5,1111,14.0,843.0,843.0
0.014,6,10,1989,5,910,3.0,642.0,642.0,5,1079,3.0,811.0,811.0
0.012,6,10,1972,5,910,3.0,642.0,642.0,5,1062,3.0,794.0,794.0
0.009,6,10,1972,5,910,2.0,642.0,642.0,5,1062,2.0,794.0,794.0
0.071,6,10,1506,5,395,16.0,127.0,127.0,5,1111,15.0,843.0,843.0
0.001,17,2,142,1,63,0.0,35.0,35.0,1,79,0.0,51.0,51.0
261.089,58,5,360,4,288,87029.0,24.0,24.0,1,72,0.0,24.0,24.0
0.04,17,2,170,1,65,0.0,37.0,37.0,1,105,0.0,77.0,77.0
373.669,58,5,360,3,216,186834.0,24.0,24.0,2,144,291530.0,24.0,24.0
0.157,6,10,1506,5,395,37.0,127.0,127.0,5,1111,37.0,843.0,843.0
0.094,17,2,152,1,76,0.0,48.0,48.0,1,76,0.0,48.0,48.0
40.11,17,10,676,5,460,10026.0,104.0,64.0,5,216,10026.0,20.0,15.0
0.059,6,10,1506,5,395,12.0,127.0,127.0,5,1111,11.0,843.0,843.0
0.005,17,2,164,1,74,0.0,46.0,46.0,1,90,0.0,62.0,62.0
40.071,17,10,676,5,460,10015.0,104.0,64.0,5,216,10016.0,20.0,15.0
0.005,6,10,1989,5,927,1.0,659.0,659.0,5,1062,1.0,794.0,794.0
0.006,6,10,1547,5,764,1.0,496.0,496.0,5,783,1.0,515.0,515.0
0.006,6,10,1547,5,764,1.0,496.0,496.0,5,783,1.0,515.0,515.0
0.013,6,10,1989,5,910,3.0,642.0,642.0,5,1079,3.0,811.0,811.0
0.007,17,2,168,1,76,0.0,48.0,48.0,1,92,0.0,64.0,64.0
0.019,6,10,1989,5,910,4.0,642.0,642.0,5,1079,4.0,811.0,811.0
0.005,6,13,3690,7,452,0.0,80.0,80.0,6,3238,1.0,1470.0,1459.0
166.028,17,80,11346,40,2673,4257.0,44.0,38.0,40,8673,4257.0,260.0,188.0
0.005,6,10,1989,5,927,1.0,659.0,659.0,5,1062,1.0,794.0,794.0
15.07,17,15,9238,8,6902,2148.0,1350.0,834.0,7,2336,2506.0,1350.0,305.0
0.008,17,2,230,1,68,0.0,40.0,40.0,1,162,0.0,134.0,134.0
0.011,6,10,1989,5,910,2.0,642.0,642.0,5,1079,2.0,811.0,811.0
0.008,6,12,1926,6,1189,1.0,659.0,434.0,6,737,1.0,417.0,417.0
0.072,17,2,170,1,65,0.0,37.0,37.0,1,105,0.0,77.0,77.0
0.01,6,10,1989,5,910,2.0,642.0,642.0,5,1079,2.0,811.0,811.0
0.01,6,10,1983,5,910,2.0,642.0,642.0,5,1073,2.0,805.0,805.0
0.0,17,2,166,1,75,0.0,47.0,47.0,1,91,0.0,63.0,63.0
0.011,6,10,1972,5,910,2.0,642.0,642.0,5,1062,2.0,794.0,794.0
0.012,6,10,1990,5,911,3.0,643.0,643.0,5,1079,2.0,811.0,811.0
40.059,17,10,676,5,460,10013.0,104.0,64.0,5,216,10013.0,20.0,15.0
0.006,17,2,140,1,62,0.0,34.0,34.0,1,78,0.0,50.0,50.0
0.01,6,10,1972,5,910,2.0,642.0,642.0,5,1062,2.0,794.0,794.0
0.005,6,10,2006,5,927,1.0,659.0,659.0,5,1079,1.0,811.0,811.0
0.131,6,10,1506,5,395,30.0,127.0,127.0,5,1111,29.0,843.0,843.0
0.006,6,10,1547,5,764,1.0,496.0,496.0,5,783,1.0,515.0,515.0
0.006,6,10,1547,5,764,1.0,496.0,496.0,5,783,1.0,515.0,515.0
0.412,17,48,27236,27,23502,15.0,1350.0,842.0,21,3734,14.0,1350.0,149.0
0.005,17,2,180,1,58,0.0,30.0,30.0,1,122,0.0,94.0,94.0
294.697,6,377,347411,197,21821,1503.0,2736.0,889.0,180,325590,1646.0,2804.0,1904.0
0.009,6,10,1989,5,910,2.0,642.0,642.0,5,1079,2.0,811.0,811.0
0.012,6,10,1990,5,911,2.0,643.0,643.0,5,1079,3.0,811.0,811.0
0.008,6,10,1989,5,910,1.0,642.0,642.0,5,1079,1.0,811.0,811.0
40.064,17,10,676,5,460,10015.0,104.0,64.0,5,216,10015.0,20.0,15.0
0.016,6,13,3735,7,497,2.0,125.0,125.0,6,3238,3.0,1470.0,1459.0
0.216,6,16,2777,8,1395,30.0,533.0,323.0,8,1382,19.0,529.0,239.0
0.018,6,9,1214,5,775,4.0,519.0,519.0,4,439,3.0,223.0,223.0
0.011,6,12,1926,6,1189,2.0,659.0,434.0,6,737,2.0,417.0,417.0
0.013,6,10,1631,5,848,3.0,580.0,580.0,5,783,3.0,515.0,515.0
0.005,6,10,1689,5,839,1.0,571.0,571.0,5,850,1.0,582.0,582.0
0.014,6,10,1989,5,910,3.0,642.0,642.0,5,1079,3.0,811.0,811.0
0.025,6,10,1989,5,910,6.0,642.0,642.0,5,1079,6.0,811.0,811.0
0.017,6,10,1990,5,911,4.0,643.0,643.0,5,1079,4.0,811.0,811.0
0.006,6,10,1547,5,764,1.0,496.0,496.0,5,783,1.0,515.0,515.0
0.131,6,10,1506,5,395,29.0,127.0,127.0,5,1111,28.0,843.0,843.0
0.014,6,10,1990,5,911,3.0,643.0,643.0,5,1079,3.0,811.0,811.0
0.001,17,2,180,1,66,0.0,38.0,38.0,1,114,0.0,86.0,86.0
0.008,6,10,1547,5,764,1.0,496.0,496.0,5,783,1.0,515.0,515.0
0.079,6,10,1506,5,395,17.0,127.0,127.0,5,1111,16.0,843.0,843.0
0.071,17,8,3613,4,1874,23.0,1350.0,440.0,4,1739,12.0,1350.0,406.0
8.963,6,39,12946,21,7428,448.0,1360.0,936.0,18,5518,515.0,2667.0,435.0
0.079,6,10,1506,5,395,16.0,127.0,127.0,5,1111,16.0,843.0,843.0
0.006,6,10,2006,5,927,1.0,659.0,659.0,5,1079,1.0,811.0,811.0
40.038,17,10,676,5,460,10008.0,104.0,64.0,5,216,10008.0,20.0,15.0
0.004,6,10,1774,5,923,1.0,655.0,655.0,5,851,1.0,583.0,583.0
0.133,6,10,1506,5,395,28.0,127.0,127.0,5,1111,29.0,843.0,843.0
40.054,17,10,676,5,460,10012.0,104.0,64.0,5,216,10012.0,20.0,15.0
0.016,6,10,1990,5,911,4.0,643.0,643.0,5,1079,3.0,811.0,811.0
0.004,17,2,136,1,60,0.0,32.0,32.0,1,76,0.0,48.0,48.0
0.005,6,10,1689,5,839,1.0,571.0,571.0,5,850,1.0,582.0,582.0
0.006,6,10,1689,5,839,1.0,571.0,571.0,5,850,1.0,582.0,582.0
0.006,6,10,1689,5,839,1.0,571.0,571.0,5,850,1.0,582.0,582.0
0.085,6,10,1506,5,395,19.0,127.0,127.0,5,1111,20.0,843.0,843.0
0.004,17,4,284,2,120,0.0,32.0,32.0,2,164,1.0,60.0,54.0
0.015,6,10,1972,5,910,3.0,642.0,642.0,5,1062,3.0,794.0,794.0
0.005,6,10,1779,5,928,1.0,660.0,660.0,5,851,1.0,583.0,583.0
0.11,6,10,1506,5,395,23.0,127.0,127.0,5,1111,22.0,843.0,843.0
0.005,17,2,169,1,62,0.0,34.0,34.0,1,107,0.0,79.0,79.0
0.069,6,10,1506,5,395,15.0,127.0,127.0,5,1111,14.0,843.0,843.0
253.745,6,27,7010,10,1659,28193.0,562.0,381.0,17,5351,15858.0,1658.0,891.0
174.072,17,72,10150,36,2406,4973.0,44.0,38.0,36,7744,4973.0,239.0,187.0
0.09,6,10,1506,5,395,19.0,127.0,127.0,5,1111,20.0,843.0,843.0
0.003,17,2,136,1,60,0.0,32.0,32.0,1,76,0.0,48.0,48.0
0.008,6,10,1989,5,910,1.0,642.0,642.0,5,1079,2.0,811.0,811.0
0.005,6,10,2006,5,927,1.0,659.0,659.0,5,1079,1.0,811.0,811.0
0.019,6,10,1983,5,910,4.0,642.0,642.0,5,1073,4.0,805.0,805.0
0.006,17,2,164,1,74,0.0,46.0,46.0,1,90,0.0,62.0,62.0
0.015,6,10,1972,5,910,3.0,642.0,642.0,5,1062,3.0,794.0,794.0
0.014,6,10,1990,5,911,3.0,643.0,643.0,5,1079,3.0,811.0,811.0
0.122,6,10,1506,5,395,25.0,127.0,127.0,5,1111,28.0,843.0,843.0
0.015,6,10,1972,5,910,3.0,642.0,642.0,5,1062,3.0,794.0,794.0
0.125,6,10,1506,5,395,30.0,127.0,127.0,5,1111,27.0,843.0,843.0
0.098,6,10,1506,5,395,19.0,127.0,127.0,5,1111,21.0,843.0,843.0
0.065,6,10,1506,5,395,14.0,127.0,127.0,5,1111,14.0,843.0,843.0
0.015,6,10,1762,5,911,3.0,643.0,643.0,5,851,3.0,583.0,583.0
0.013,6,10,1989,5,910,3.0,642.0,642.0,5,1079,3.0,811.0,811.0
0.131,17,2,80,1,32,0.0,4.0,4.0,1,48,0.0,20.0,20.0
0.003,17,2,136,1,60,0.0,32.0,32.0,1,76,0.0,48.0,48.0
0.004,17,2,380,1,61,0.0,33.0,33.0,1,319,0.0,291.0,291.0
0.038,17,2,184,1,61,0.0,33.0,33.0,1,123,0.0,95.0,95.0
40.071,17,10,676,5,460,10016.0,104.0,64.0,5,216,10016.0,20.0,15.0
0.023,17,2,170,1,65,0.0,37.0,37.0,1,105,0.0,77.0,77.0
0.015,6,10,1989,5,910,3.0,642.0,642.0,5,1079,3.0,811.0,811.0
0.07,6,10,1506,5,395,15.0,127.0,127.0,5,1111,15.0,843.0,843.0
40.092,17,10,676,5,460,10021.0,104.0,64.0,5,216,10022.0,20.0,15.0
0.007,6,10,1547,5,764,1.0,496.0,496.0,5,783,1.0,515.0,515.0
308.749,17,20,1124,10,716,34291.0,48.0,43.0,10,408,34291.0,20.0,12.0
0.064,6,10,1506,5,395,15.0,127.0,127.0,5,1111,14.0,843.0,843.0
0.083,6,10,1506,5,395,18.0,127.0,127.0,5,1111,18.0,843.0,843.0
0.068,6,10,1506,5,395,15.0,127.0,127.0,5,1111,11.0,843.0,843.0
0.022,6,10,1989,5,910,5.0,642.0,642.0,5,1079,5.0,811.0,811.0
0.005,6,10,2006,5,927,1.0,659.0,659.0,5,1079,1.0,811.0,811.0
0.015,6,10,1983,5,910,3.0,642.0,642.0,5,1073,3.0,805.0,805.0
0.001,17,2,136,1,60,0.0,32.0,32.0,1,76,0.0,48.0,48.0
0.106,6,10,1506,5,395,26.0,127.0,127.0,5,1111,23.0,843.0,843.0
0.008,6,12,1926,6,1189,1.0,659.0,434.0,6,737,1.0,417.0,417.0
0.006,6,10,1643,5,860,1.0,592.0,592.0,5,783,1.0,515.0,515.0
0.012,6,10,1972,5,910,3.0,642.0,642.0,5,1062,2.0,794.0,794.0
0.068,17,8,3613,4,1874,22.0,1350.0,440.0,4,1739,11.0,1350.0,406.0
0.12,6,10,1506,5,395,25.0,127.0,127.0,5,1111,26.0,843.0,843.0
68.565,6,24,7517,13,1385,5713.0,530.0,277.0,11,6132,6836.0,2720.0,946.0
0.006,17,2,214,1,75,0.0,47.0,47.0,1,139,0.0,111.0,111.0
0.0,17,2,136,1,60,0.0,32.0,32.0,1,76,0.0,48.0,48.0
0.005,6,14,3799,7,509,0.0,137.0,137.0,7,3290,0.0,1448.0,972.0
0.012,6,10,1762,5,911,3.0,643.0,643.0,5,851,3.0,583.0,583.0
0.009,6,12,1926,6,1189,1.0,659.0,434.0,6,737,1.0,417.0,417.0
15.081,17,14,9190,8,6902,2150.0,1350.0,834.0,6,2288,3010.0,1350.0,353.0
0.001,17,2,180,1,65,0.0,37.0,37.0,1,115,0.0,87.0,87.0
1787.213,6,150,19350,90,13740,20081.0,302.0,302.0,60,5610,30291.0,83.0,83.0
0.17,6,10,1506,5,395,37.0,127.0,127.0,5,1111,38.0,843.0,843.0
0.234,6,10,1506,5,395,56.0,127.0,127.0,5,1111,50.0,843.0,843.0
0.006,6,13,3690,7,452,0.0,80.0,80.0,6,3238,1.0,1470.0,1459.0
0.006,6,10,1774,5,923,1.0,655.0,655.0,5,851,1.0,583.0,583.0
265.877,6,39,9641,15,6591,18991.0,1717.0,646.0,24,3050,11559.0,580.0,119.0
0.012,6,10,1972,5,910,3.0,642.0,642.0,5,1062,3.0,794.0,794.0
0.077,17,2,144,1,64,0.0,36.0,36.0,1,80,0.0,52.0,52.0
0.001,17,2,179,1,62,0.0,34.0,34.0,1,117,0.0,89.0,89.0
0.005,6,10,2000,5,927,1.0,659.0,659.0,5,1073,1.0,805.0,805.0
0.066,6,10,1506,5,395,14.0,127.0,127.0,5,1111,15.0,843.0,843.0
0.094,6,10,1506,5,395,22.0,127.0,127.0,5,1111,21.0,843.0,843.0
0.011,6,10,1972,5,910,2.0,642.0,642.0,5,1062,2.0,794.0,794.0
0.103,6,10,1506,5,395,21.0,127.0,127.0,5,1111,20.0,843.0,843.0
0.004,17,2,185,1,73,0.0,45.0,45.0,1,112,0.0,84.0,84.0
0.004,17,2,148,1,60,0.0,32.0,32.0,1,88,0.0,60.0,60.0
0.157,6,10,1506,5,395,37.0,127.0,127.0,5,1111,37.0,843.0,843.0
0.005,6,10,1989,5,927,1.0,659.0,659.0,5,1062,1.0,794.0,794.0
0.003,6,10,1702,5,863,0.0,595.0,595.0,5,839,0.0,571.0,571.0
0.011,6,10,1972,5,910,2.0,642.0,642.0,5,1062,2.0,794.0,794.0
0.005,6,10,1547,5,764,1.0,496.0,496.0,5,783,1.0,515.0,515.0
0.117,6,10,1506,5,395,23.0,127.0,127.0,5,1111,23.0,843.0,843.0
0.074,6,10,1506,5,395,15.0,127.0,127.0,5,1111,15.0,843.0,843.0
0.005,6,10,2006,5,927,1.0,659.0,659.0,5,1079,1.0,811.0,811.0
0.008,6,10,1989,5,910,2.0,642.0,642.0,5,1079,2.0,811.0,811.0
0.011,6,10,1989,5,910,2.0,642.0,642.0,5,1079,2.0,811.0,811.0
0.02,6,10,1762,5,911,5.0,643.0,643.0,5,851,4.0,583.0,583.0
0.157,6,10,1506,5,395,36.0,127.0,127.0,5,1111,28.0,843.0,843.0
0.018,6,10,1990,5,911,4.0,643.0,643.0,5,1079,4.0,811.0,811.0
0.001,17,2,180,1,66,0.0,38.0,38.0,1,114,0.0,86.0,86.0
0.004,6,10,2007,5,928,1.0,660.0,660.0,5,1079,1.0,811.0,811.0
0.001,17,2,180,1,66,0.0,38.0,38.0,1,114,0.0,86.0,86.0
0.005,17,2,144,1,64,0.0,36.0,36.0,1,80,0.0,52.0,52.0
0.011,6,10,1990,5,911,2.0,643.0,643.0,5,1079,2.0,811.0,811.0
0.001,17,2,180,1,66,0.0,38.0,38.0,1,114,0.0,86.0,86.0
0.088,6,10,1506,5,395,20.0,127.0,127.0,5,1111,20.0,843.0,843.0
0.089,6,10,1506,5,395,20.0,127.0,127.0,5,1111,19.0,843.0,843.0
0.091,6,10,1506,5,395,17.0,127.0,127.0,5,1111,22.0,843.0,843.0
0.005,6,10,2007,5,928,1.0,660.0,660.0,5,1079,1.0,811.0,811.0
0.005,6,10,2006,5,927,1.0,659.0,659.0,5,1079,1.0,811.0,811.0
0.013,6,10,1990,5,911,3.0,643.0,643.0,5,1079,3.0,811.0,811.0
40.057,17,10,676,5,460,10012.0,104.0,64.0,5,216,10013.0,20.0,15.0
240.012,6,9,787,5,488,60003.0,232.0,232.0,4,299,80003.0,83.0,83.0
300.132,6,46,18896,25,13258,12498.0,2720.0,1222.0,21,5638,14998.0,2667.0,435.0
0.005,6,10,1989,5,927,1.0,659.0,659.0,5,1062,1.0,794.0,794.0
0.009,6,10,1972,5,910,2.0,642.0,642.0,5,1062,2.0,794.0,794.0
0.013,6,10,1605,5,388,3.0,120.0,120.0,5,1217,3.0,949.0,949.0
0.011,6,10,1989,5,910,2.0,642.0,642.0,5,1079,2.0,811.0,811.0
0.092,6,10,1506,5,395,21.0,127.0,127.0,5,1111,21.0,843.0,843.0
0.099,6,10,1506,5,395,20.0,127.0,127.0,5,1111,23.0,843.0,843.0
0.018,6,10,1677,5,827,4.0,559.0,559.0,5,850,4.0,582.0,582.0
0.012,17,2,144,1,64,0.0,36.0,36.0,1,80,0.0,52.0,52.0
0.004,6,10,1774,5,923,1.0,655.0,655.0,5,851,1.0,583.0,583.0
294.863,6,406,349350,197,21810,1504.0,2736.0,889.0,209,327540,1417.0,2804.0,1623.0
0.107,17,2,80,1,32,0.0,4.0,4.0,1,48,0.0,20.0,20.0
0.008,6,10,1990,5,911,2.0,643.0,643.0,5,1079,2.0,811.0,811.0
0.01,6,10,1972,5,910,2.0,642.0,642.0,5,1062,2.0,794.0,794.0
0.004,6,10,2007,5,928,1.0,660.0,660.0,5,1079,1.0,811.0,811.0
0.003,17,2,162,1,65,0.0,37.0,37.0,1,97,0.0,69.0,69.0
308.632,17,20,1124,10,716,34280.0,48.0,43.0,10,408,34285.0,20.0,12.0
240.01,6,9,787,5,488,60002.0,232.0,232.0,4,299,80002.0,83.0,83.0
40.07,17,10,676,5,460,10015.0,104.0,64.0,5,216,10016.0,20.0,15.0
11.149,17,28,4394,14,2312,848.0,587.0,137.0,14,2082,848.0,269.0,120.0
0.094,6,10,1506,5,395,21.0,127.0,127.0,5,1111,21.0,843.0,843.0
0.016,6,10,1990,5,911,3.0,643.0,643.0,5,1079,4.0,811.0,811.0
0.008,6,10,1972,5,910,2.0,642.0,642.0,5,1062,1.0,794.0,794.0
0.001,17,2,180,1,66,0.0,38.0,38.0,1,114,0.0,86.0,86.0
0.013,6,10,1989,5,910,3.0,642.0,642.0,5,1079,3.0,811.0,811.0
0.012,6,6,716,3,458,4.0,302.0,302.0,3,258,4.0,102.0,102.0
0.089,6,10,1506,5,395,20.0,127.0,127.0,5,1111,16.0,843.0,843.0
0.097,6,10,1506,5,395,21.0,127.0,127.0,5,1111,19.0,843.0,843.0
0.018,6,10,1983,5,910,4.0,642.0,642.0,5,1073,4.0,805.0,805.0
0.014,6,10,1989,5,910,3.0,642.0,642.0,5,1079,3.0,811.0,811.0
0.068,6,10,1506,5,395,14.0,127.0,127.0,5,1111,16.0,843.0,843.0
240.145,6,18,7344,10,2076,26682.0,1368.0,520.0,8,5268,34306.0,2804.0,1211.0
1771.608,17,120,11460,60,5460,30026.0,63.0,63.0,60,6000,30026.0,72.0,72.0
0.004,6,10,1774,5,923,1.0,655.0,655.0,5,851,1.0,583.0,583.0
0.015,6,10,1972,5,910,3.0,642.0,642.0,5,1062,3.0,794.0,794.0
0.004,6,10,1989,5,927,1.0,659.0,659.0,5,1062,1.0,794.0,794.0
11.09,17,28,4422,14,1995,840.0,270.0,114.0,14,2427,840.0,586.0,145.0
40.054,17,10,676,5,460,10012.0,104.0,64.0,5,216,10012.0,20.0,15.0
0.001,17,2,180,1,66,0.0,38.0,38.0,1,114,0.0,86.0,86.0
40.061,17,10,676,5,460,10012.0,104.0,64.0,5,216,10014.0,20.0,15.0
40.064,17,10,676,5,460,10015.0,104.0,64.0,5,216,10015.0,20.0,15.0
0.006,6,10,1689,5,839,1.0,571.0,571.0,5,850,1.0,582.0,582.0
0.017,6,10,1972,5,910,4.0,642.0,642.0,5,1062,4.0,794.0,794.0
40.099,17,10,676,5,460,10016.0,104.0,64.0,5,216,10016.0,20.0,15.0
0.005,6,13,3747,7,509,0.0,137.0,137.0,6,3238,1.0,1470.0,1459.0
0.014,6,10,1631,5,848,3.0,580.0,580.0,5,783,3.0,515.0,515.0
0.006,17,2,170,1,65,0.0,37.0,37.0,1,105,0.0,77.0,77.0
0.006,6,10,1547,5,764,1.0,496.0,496.0,5,783,1.0,515.0,515.0
0.068,6,10,1506,5,395,15.0,127.0,127.0,5,1111,16.0,843.0,843.0
0.001,17,2,166,1,75,0.0,47.0,47.0,1,91,0.0,63.0,63.0
0.025,6,10,1989,5,910,6.0,642.0,642.0,5,1079,6.0,811.0,811.0
0.005,17,4,284,2,120,1.0,32.0,32.0,2,164,1.0,60.0,54.0
0.139,6,10,1506,5,395,31.0,127.0,127.0,5,1111,31.0,843.0,843.0
40.077,17,10,676,5,460,10016.0,104.0,64.0,5,216,10018.0,20.0,15.0
1786.43,6,150,19350,90,13740,20072.0,302.0,302.0,60,5610,30278.0,83.0,83.0
0.005,6,10,2006,5,927,1.0,659.0,659.0,5,1079,1.0,811.0,811.0
0.014,6,10,1990,5,911,3.0,643.0,643.0,5,1079,3.0,811.0,811.0
0.005,17,2,140,1,62,0.0,34.0,34.0,1,78,0.0,50.0,50.0
0.005,6,10,2000,5,927,1.0,659.0,659.0,5,1073,1.0,805.0,805.0
0.012,6,10,1762,5,911,3.0,643.0,643.0,5,851,2.0,583.0,583.0
0.016,6,10,1990,5,911,3.0,643.0,643.0,5,1079,3.0,811.0,811.0
0.006,6,10,1547,5,764,1.0,496.0,496.0,5,783,1.0,515.0,515.0
0.004,6,10,1779,5,928,1.0,660.0,660.0,5,851,1.0,583.0,583.0
0.004,6,10,2006,5,927,1.0,659.0,659.0,5,1079,1.0,811.0,811.0
0.085,6,10,1506,5,395,14.0,127.0,127.0,5,1111,18.0,843.0,843.0
0.005,6,14,3799,7,509,0.0,137.0,137.0,7,3290,0.0,1448.0,972.0
0.015,6,10,1677,5,827,3.0,559.0,559.0,5,850,3.0,582.0,582.0
0.117,6,10,1506,5,395,28.0,127.0,127.0,5,1111,27.0,843.0,843.0
0.016,6,10,1677,5,827,3.0,559.0,559.0,5,850,4.0,582.0,582.0
0.005,6,10,2006,5,927,1.0,659.0,659.0,5,1079,1.0,811.0,811.0
0.012,6,10,1677,5,827,2.0,559.0,559.0,5,850,2.0,582.0,582.0
0.013,6,10,1631,5,848,3.0,580.0,580.0,5,783,3.0,515.0,515.0
0.001,17,2,180,1,66,0.0,38.0,38.0,1,114,0.0,86.0,86.0
0.005,6,10,2007,5,928,1.0,660.0,660.0,5,1079,1.0,811.0,811.0
10.741,17,28,4419,14,1995,817.0,270.0,114.0,14,2424,817.0,587.0,145.0
0.021,6,10,1631,5,848,5.0,580.0,580.0,5,783,5.0,515.0,515.0
164.088,17,74,10369,37,2473,4557.0,44.0,38.0,37,7896,4557.0,239.0,185.0
0.004,6,10,1774,5,923,1.0,655.0,655.0,5,851,1.0,583.0,583.0
0.086,6,10,1506,5,395,19.0,127.0,127.0,5,1111,20.0,843.0,843.0
0.1,6,10,1506,5,395,20.0,127.0,127.0,5,1111,20.0,843.0,843.0
0.006,6,10,2007,5,928,1.0,660.0,660.0,5,1079,1.0,811.0,811.0
0.105,6,10,1506,5,395,24.0,127.0,127.0,5,1111,23.0,843.0,843.0
0.143,6,10,1506,5,395,34.0,127.0,127.0,5,1111,34.0,843.0,843.0
0.084,6,10,1506,5,395,19.0,127.0,127.0,5,1111,19.0,843.0,843.0
0.004,6,10,1774,5,923,1.0,655.0,655.0,5,851,1.0,583.0,583.0
0.011,6,13,3735,7,497,1.0,125.0,125.0,6,3238,2.0,1470.0,1459.0
165.089,17,68,9759,34,2274,5002.0,44.0,38.0,34,7485,5002.0,261.0,192.0
0.005,6,10,2007,5,928,1.0,660.0,660.0,5,1079,1.0,811.0,811.0
40.07,17,10,676,5,460,10014.0,104.0,64.0,5,216,10016.0,20.0,15.0
0.005,6,10,2007,5,928,1.0,660.0,660.0,5,1079,1.0,811.0,811.0
0.004,6,10,2007,5,928,1.0,660.0,660.0,5,1079,1.0,811.0,811.0
0.011,6,10,1990,5,911,2.0,643.0,643.0,5,1079,2.0,811.0,811.0
0.058,6,10,1506,5,395,14.0,127.0,127.0,5,1111,13.0,843.0,843.0
0.136,6,10,1506,5,395,32.0,127.0,127.0,5,1111,32.0,843.0,843.0
40.059,17,10,676,5,460,10014.0,104.0,64.0,5,216,10014.0,20.0,15.0
0.005,6,10,1854,5,889,1.0,621.0,621.0,5,965,1.0,697.0,697.0
0.134,6,10,1506,5,395,32.0,127.0,127.0,5,1111,32.0,843.0,843.0
0.048,17,2,148,1,60,0.0,32.0,32.0,1,88,0.0,60.0,60.0
0.089,6,10,1506,5,395,21.0,127.0,127.0,5,1111,15.0,843.0,843.0
0.015,6,10,1989,5,910,3.0,642.0,642.0,5,1079,3.0,811.0,811.0
0.008,6,10,1990,5,911,2.0,643.0,643.0,5,1079,2.0,811.0,811.0
0.164,17,2,152,1,76,0.0,48.0,48.0,1,76,0.0,48.0,48.0
0.004,6,10,1702,5,863,1.0,595.0,595.0,5,839,1.0,571.0,571.0
0.025,6,10,1972,5,910,6.0,642.0,642.0,5,1062,6.0,794.0,794.0
0.005,6,10,2006,5,927,1.0,659.0,659.0,5,1079,1.0,811.0,811.0
0.103,6,10,1506,5,395,21.0,127.0,127.0,5,1111,23.0,843.0,843.0
0.042,17,2,148,1,60,0.0,32.0,32.0,1,88,0.0,60.0,60.0
0.003,17,2,136,1,60,0.0,32.0,32.0,1,76,0.0,48.0,48.0
40.085,17,10,676,5,460,10020.0,104.0,64.0,5,216,10020.0,20.0,15.0
0.013,17,2,170,1,65,0.0,37.0,37.0,1,105,0.0,77.0,77.0
0.001,17,2,180,1,66,0.0,38.0,38.0,1,114,0.0,86.0,86.0
0.01,6,10,1972,5,910,2.0,642.0,642.0,5,1062,2.0,794.0,794.0
0.004,6,10,2006,5,927,1.0,659.0,659.0,5,1079,1.0,811.0,811.0
36.442,6,39,9703,20,4100,466.0,1543.0,814.0,19,5603,2015.0,2667.0,402.0
301.226,6,56,28688,30,22621,10387.0,2720.0,1527.0,26,6067,362.0,2667.0,385.0
240.485,6,35,10729,17,2159,15028.0,555.0,253.0,18,8570,14144.0,1476.0,636.0
0.013,6,10,1990,5,911,3.0,643.0,643.0,5,1079,3.0,811.0,811.0
0.019,6,10,1983,5,910,4.0,642.0,642.0,5,1073,4.0,805.0,805.0
0.006,17,2,164,1,74,0.0,46.0,46.0,1,90,0.0,62.0,62.0
0.001,17,2,180,1,66,0.0,38.0,38.0,1,114,0.0,86.0,86.0
240.09,6,16,4480,9,963,30011.0,238.0,166.0,7,3517,40014.0,1402.0,786.0
0.084,6,42,13921,24,2565,3.0,517.0,146.0,18,11356,4.0,1402.0,800.0
11.138,17,26,4163,13,1867,915.0,270.0,115.0,13,2296,914.0,587.0,148.0
0.004,17,2,140,1,62,0.0,34.0,34.0,1,78,0.0,50.0,50.0
0.111,6,10,1506,5,395,24.0,127.0,127.0,5,1111,23.0,843.0,843.0
0.007,17,2,427,1,129,0.0,101.0,101.0,1,298,0.0,270.0,270.0
0.005,6,13,3747,7,509,0.0,137.0,137.0,6,3238,1.0,1470.0,1459.0
0.07,6,10,1506,5,395,15.0,127.0,127.0,5,1111,17.0,843.0,843.0
0.009,6,13,3735,7,497,1.0,125.0,125.0,6,3238,1.0,1470.0,1459.0
0.006,6,10,2007,5,928,1.0,660.0,660.0,5,1079,1.0,811.0,811.0
0.012,6,13,3735,7,497,2.0,125.0,125.0,6,3238,2.0,1470.0,1459.0
0.088,6,10,1506,5,395,16.0,127.0,127.0,5,1111,21.0,843.0,843.0
0.107,6,10,1506,5,395,26.0,127.0,127.0,5,1111,25.0,843.0,843.0
0.001,17,2,180,1,66,0.0,38.0,38.0,1,114,0.0,86.0,86.0
0.003,17,2,148,1,60,0.0,32.0,32.0,1,88,0.0,60.0,60.0
0.014,6,10,1989,5,910,3.0,642.0,642.0,5,1079,3.0,811.0,811.0
1636.322,6,80,4212,40,2106,41955.0,26.0,26.0,40,2106,41955.0,26.0,26.0
0.005,6,10,2006,5,927,1.0,659.0,659.0,5,1079,1.0,811.0,811.0
0.005,6,10,2006,5,927,1.0,659.0,659.0,5,1079,1.0,811.0,811.0
0.006,6,10,1854,5,889,1.0,621.0,621.0,5,965,1.0,697.0,697.0
0.011,6,10,1677,5,827,2.0,559.0,559.0,5,850,2.0,582.0,582.0
242.166,6,313,344331,119,17695,2052.0,2736.0,959.0,194,326636,1254.0,2804.0,1720.0
0.089,6,10,1506,5,395,20.0,127.0,127.0,5,1111,17.0,843.0,843.0
40.07,17,10,676,5,460,10016.0,104.0,64.0,5,216,10016.0,20.0,15.0
0.005,6,10,2006,5,927,1.0,659.0,659.0,5,1079,1.0,811.0,811.0
0.017,6,10,1972,5,910,4.0,642.0,642.0,5,1062,4.0,794.0,794.0
0.004,6,10,1774,5,923,1.0,655.0,655.0,5,851,1.0,583.0,583.0
241.599,6,36,9498,16,6563,16106.0,1633.0,637.0,20,2935,12715.0,580.0,171.0
176.231,17,78,11045,39,2609,4637.0,44.0,38.0,39,8436,4637.0,239.0,188.0
0.008,6,10,1983,5,910,2.0,642.0,642.0,5,1073,2.0,805.0,805.0
0.019,6,10,1983,5,910,4.0,642.0,642.0,5,1073,4.0,805.0,805.0
0.009,6,13,3735,7,497,1.0,125.0,125.0,6,3238,1.0,1470.0,1459.0
0.004,17,2,148,1,60,0.0,32.0,32.0,1,88,0.0,60.0,60.0
40.067,17,10,676,5,460,10015.0,104.0,64.0,5,216,10015.0,20.0,15.0
0.004,6,10,1702,5,863,1.0,595.0,595.0,5,839,0.0,571.0,571.0
0.006,6,10,1547,5,764,1.0,496.0,496.0,5,783,1.0,515.0,515.0
397.218,6,25,6328,14,2388,30555.0,585.0,330.0,11,3940,33717.0,1402.0,672.0
0.005,6,10,1854,5,889,1.0,621.0,621.0,5,965,1.0,697.0,697.0
0.072,17,4,284,2,120,0.0,32.0,32.0,2,164,68.0,60.0,54.0
525.777,6,41,13959,22,4607,25037.0,1352.0,493.0,19,9352,25871.0,1402.0,759.0
0.004,6,10,1702,5,863,1.0,595.0,595.0,5,839,1.0,571.0,571.0
0.004,17,4,284,2,120,0.0,32.0,32.0,2,164,0.0,60.0,54.0
40.077,17,10,676,5,460,10015.0,104.0,64.0,5,216,10016.0,20.0,15.0
0.071,17,4,420,2,122,0.0,33.0,33.0,2,298,29.0,145.0,121.0
0.091,6,10,1506,5,395,21.0,127.0,127.0,5,1111,20.0,843.0,843.0
0.159,17,2,80,1,32,0.0,4.0,4.0,1,48,0.0,20.0,20.0
0.005,6,10,1689,5,839,1.0,571.0,571.0,5,850,1.0,582.0,582.0
0.01,6,10,1983,5,910,2.0,642.0,642.0,5,1073,2.0,805.0,805.0
0.088,6,10,1506,5,395,18.0,127.0,127.0,5,1111,19.0,843.0,843.0
0.213,6,16,2670,8,1396,30.0,533.0,324.0,8,1274,19.0,529.0,212.0
0.014,6,13,3735,7,497,2.0,125.0,125.0,6,3238,2.0,1470.0,1459.0
0.067,6,10,1506,5,395,16.0,127.0,127.0,5,1111,14.0,843.0,843.0
0.005,6,10,2006,5,927,1.0,659.0,659.0,5,1079,1.0,811.0,811.0
0.07,17,8,3613,4,1874,23.0,1350.0,440.0,4,1739,11.0,1350.0,406.0
0.001,17,2,166,1,75,0.0,47.0,47.0,1,91,0.0,63.0,63.0
0.015,6,10,1990,5,911,3.0,643.0,643.0,5,1079,3.0,811.0,811.0
0.005,6,10,2000,5,927,1.0,659.0,659.0,5,1073,1.0,805.0,805.0
0.004,6,10,1989,5,927,1.0,659.0,659.0,5,1062,1.0,794.0,794.0
0.092,6,10,1506,5,395,21.0,127.0,127.0,5,1111,20.0,843.0,843.0
0.083,6,10,1506,5,395,18.0,127.0,127.0,5,1111,13.0,843.0,843.0
0.015,6,10,1972,5,910,3.0,642.0,642.0,5,1062,3.0,794.0,794.0
0.09,6,10,1506,5,395,18.0,127.0,127.0,5,1111,21.0,843.0,843.0
0.039,17,2,136,1,60,0.0,32.0,32.0,1,76,0.0,48.0,48.0
240.097,6,16,4480,9,963,30012.0,238.0,166.0,7,3517,40014.0,1402.0,786.0
0.005,6,10,2006,5,927,1.0,659.0,659.0,5,1079,1.0,811.0,811.0
0.01,6,10,1631,5,848,2.0,580.0,580.0,5,783,2.0,515.0,515.0
0.132,6,10,1506,5,395,30.0,127.0,127.0,5,1111,30.0,843.0,843.0
0.076,6,10,1506,5,395,18.0,127.0,127.0,5,1111,16.0,843.0,843.0
0.004,6,10,2007,5,928,1.0,660.0,660.0,5,1079,1.0,811.0,811.0
10.812,17,28,4419,14,1994,823.0,269.0,114.0,14,2425,823.0,588.0,145.0
0.238,6,16,2783,8,1401,34.0,533.0,325.0,8,1382,22.0,529.0,239.0
0.009,6,10,1989,5,910,2.0,642.0,642.0,5,1079,2.0,811.0,811.0
0.005,17,2,154,1,69,0.0,41.0,41.0,1,85,0.0,57.0,57.0
0.006,6,10,1547,5,764,1.0,496.0,496.0,5,783,1.0,515.0,515.0
0.004,17,2,148,1,60,0.0,32.0,32.0,1,88,0.0,60.0,60.0
0.019,6,10,1989,5,910,4.0,642.0,642.0,5,1079,4.0,811.0,811.0
0.13,6,10,1506,5,395,30.0,127.0,127.0,5,1111,29.0,843.0,843.0
300.242,6,27,7435,16,1409,20016.0,217.0,142.0,11,6026,24023.0,1679.0,778.0
0.017,6,10,1989,5,910,4.0,642.0,642.0,5,1079,4.0,811.0,811.0
0.003,17,2,136,1,60,0.0,32.0,32.0,1,76,0.0,48.0,48.0
0.038,17,2,148,1,60,0.0,32.0,32.0,1,88,0.0,60.0,60.0
0.005,17,2,179,1,71,0.0,43.0,43.0,1,108,0.0,80.0,80.0
0.001,17,2,180,1,66,0.0,38.0,38.0,1,114,0.0,86.0,86.0
0.005,6,14,3742,8,504,0.0,80.0,80.0,6,3238,0.0,1470.0,1459.0
40.098,17,10,676,5,460,10021.0,104.0,64.0,5,216,10023.0,20.0,15.0
0.016,6,10,1631,5,848,4.0,580.0,580.0,5,783,3.0,515.0,515.0
11.217,17,28,4422,14,1994,849.0,269.0,114.0,14,2428,849.0,587.0,145.0
0.038,17,2,148,1,60,0.0,32.0,32.0,1,88,0.0,60.0,60.0
0.134,6,10,1506,5,395,31.0,127.0,127.0,5,1111,28.0,843.0,843.0
0.029,6,10,1972,5,910,7.0,642.0,642.0,5,1062,7.0,794.0,794.0
0.006,6,10,1854,5,889,1.0,621.0,621.0,5,965,1.0,697.0,697.0
240.1,6,16,4481,9,963,30012.0,238.0,166.0,7,3518,40016.0,1402.0,786.0
0.066,6,10,1506,5,395,12.0,127.0,127.0,5,1111,16.0,843.0,843.0
0.08,6,10,1506,5,395,18.0,127.0,127.0,5,1111,14.0,843.0,843.0
240.017,6,9,787,5,488,60004.0,232.0,232.0,4,299,80003.0,83.0,83.0
0.003,17,2,186,1,61,0.0,33.0,33.0,1,125,0.0,97.0,97.0
0.105,6,10,1506,5,395,23.0,127.0,127.0,5,1111,23.0,843.0,843.0
0.006,6,10,1547,5,764,1.0,496.0,496.0,5,783,1.0,515.0,515.0
61.649,6,44,38795,24,24007,2680.0,2804.0,1896.0,20,14788,3237.0,2804.0,1374.0
0.005,6,14,3736,7,446,0.0,74.0,74.0,7,3290,0.0,1448.0,972.0
0.021,6,10,1972,5,910,5.0,642.0,642.0,5,1062,5.0,794.0,794.0
9.059,17,6,376,5,280,2264.0,28.0,28.0,1,96,0.0,68.0,68.0
0.01,6,10,1990,5,911,2.0,643.0,643.0,5,1079,2.0,811.0,811.0
0.13,6,10,1506,5,395,28.0,127.0,127.0,5,1111,30.0,843.0,843.0
0.078,6,10,1506,5,395,17.0,127.0,127.0,5,1111,17.0,843.0,843.0
0.014,6,10,1989,5,910,3.0,642.0,642.0,5,1079,3.0,811.0,811.0
40.055,17,10,676,5,460,10011.0,104.0,64.0,5,216,10012.0,20.0,15.0
0.171,17,2,152,1,76,0.0,48.0,48.0,1,76,0.0,48.0,48.0
0.006,17,2,132,1,58,0.0,30.0,30.0,1,74,0.0,46.0,46.0
10.81,17,28,4423,14,1994,823.0,269.0,114.0,14,2429,823.0,588.0,145.0
0.091,6,10,1506,5,395,20.0,127.0,127.0,5,1111,19.0,843.0,843.0
0.006,17,2,144,1,64,0.0,36.0,36.0,1,80,0.0,52.0,52.0
0.01,6,10,1989,5,910,2.0,642.0,642.0,5,1079,2.0,811.0,811.0
0.003,17,2,185,1,73,0.0,45.0,45.0,1,112,0.0,84.0,84.0
60.21,6,77,78592,38,5831,1627.0,1402.0,769.0,39,72761,1583.0,2804.0,2020.0
0.006,6,10,1689,5,839,1.0,571.0,571.0,5,850,1.0,582.0,582.0
0.004,17,2,136,1,60,0.0,32.0,32.0,1,76,0.0,48.0,48.0
0.087,6,10,1506,5,395,18.0,127.0,127.0,5,1111,18.0,843.0,843.0
0.011,6,13,3735,7,497,1.0,125.0,125.0,6,3238,2.0,1470.0,1459.0
0.014,6,10,1983,5,910,3.0,642.0,642.0,5,1073,3.0,805.0,805.0
0.006,6,10,1689,5,839,1.0,571.0,571.0,5,850,1.0,582.0,582.0
0.005,6,10,2006,5,927,1.0,659.0,659.0,5,1079,1.0,811.0,811.0
0.001,17,2,136,1,60,0.0,32.0,32.0,1,76,0.0,48.0,48.0
0.006,6,10,1689,5,839,1.0,571.0,571.0,5,850,1.0,582.0,582.0
0.14,6,10,1506,5,395,33.0,127.0,127.0,5,1111,31.0,843.0,843.0
0.006,6,10,1689,5,839,1.0,571.0,571.0,5,850,1.0,582.0,582.0
0.016,6,10,1631,5,848,4.0,580.0,580.0,5,783,4.0,515.0,515.0
0.02,6,10,1972,5,910,4.0,642.0,642.0,5,1062,5.0,794.0,794.0
0.013,6,13,3735,7,497,2.0,125.0,125.0,6,3238,2.0,1470.0,1459.0
0.006,17,2,164,1,74,0.0,46.0,46.0,1,90,0.0,62.0,62.0
0.026,6,10,1972,5,910,6.0,642.0,642.0,5,1062,6.0,794.0,794.0
240.015,6,9,787,5,488,60003.0,232.0,232.0,4,299,80004.0,83.0,83.0
0.006,6,10,2000,5,927,1.0,659.0,659.0,5,1073,1.0,805.0,805.0
0.004,6,10,1774,5,923,1.0,655.0,655.0,5,851,1.0,583.0,583.0
40.057,17,10,676,5,460,10012.0,104.0,64.0,5,216,10013.0,20.0,15.0
0.016,6,10,1990,5,911,3.0,643.0,643.0,5,1079,3.0,811.0,811.0
0.013,6,10,1989,5,910,3.0,642.0,642.0,5,1079,3.0,811.0,811.0
0.006,6,10,1547,5,764,1.0,496.0,496.0,5,783,1.0,515.0,515.0
0.166,17,2,152,1,76,0.0,48.0,48.0,1,76,0.0,48.0,48.0
0.006,6,10,1547,5,764,1.0,496.0,496.0,5,783,1.0,515.0,515.0
0.005,6,10,2000,5,927,1.0,659.0,659.0,5,1073,1.0,805.0,805.0
0.001,17,2,166,1,75,0.0,47.0,47.0,1,91,0.0,63.0,63.0
309.697,17,20,1124,10,716,34403.0,48.0,43.0,10,408,34400.0,20.0,12.0
0.092,6,10,1506,5,395,20.0,127.0,127.0,5,1111,19.0,843.0,843.0
0.004,17,4,284,2,120,0.0,32.0,32.0,2,164,1.0,60.0,54.0
0.114,6,10,1506,5,395,25.0,127.0,127.0,5,1111,25.0,843.0,843.0
0.108,6,10,1506,5,395,22.0,127.0,127.0,5,1111,24.0,843.0,843.0
0.009,17,2,170,1,65,0.0,37.0,37.0,1,105,0.0,77.0,77.0
0.068,17,8,3613,4,1874,22.0,1350.0,440.0,4,1739,11.0,1350.0,406.0
0.006,17,2,230,1,68,0.0,40.0,40.0,1,162,0.0,134.0,134.0
0.005,17,2,230,1,68,0.0,40.0,40.0,1,162,0.0,134.0,134.0
0.007,17,2,299,1,65,0.0,37.0,37.0,1,234,0.0,206.0,206.0
0.037,17,2,152,1,76,0.0,48.0,48.0,1,76,0.0,48.0,48.0
0.122,6,10,1506,5,395,29.0,127.0,127.0,5,1111,28.0,843.0,843.0
294.326,6,400,348651,193,21599,1532.0,2688.0,825.0,207,327052,1428.0,2804.0,1638.0
0.005,17,2,214,1,75,0.0,47.0,47.0,1,139,0.0,111.0,111.0
0.008,6,10,1989,5,927,1.0,659.0,659.0,5,1062,2.0,794.0,794.0
0.013,6,10,1989,5,910,3.0,642.0,642.0,5,1079,3.0,811.0,811.0
0.001,17,2,180,1,66,0.0,38.0,38.0,1,114,0.0,86.0,86.0
0.005,6,10,2006,5,927,1.0,659.0,659.0,5,1079,1.0,811.0,811.0
0.009,6,10,1990,5,911,2.0,643.0,643.0,5,1079,2.0,811.0,811.0
0.005,6,10,1547,5,764,1.0,496.0,496.0,5,783,1.0,515.0,515.0
0.014,6,10,1983,5,910,3.0,642.0,642.0,5,1073,3.0,805.0,805.0
0.005,6,10,2006,5,927,1.0,659.0,659.0,5,1079,1.0,811.0,811.0
0.008,17,2,194,1,59,0.0,31.0,31.0,1,135,0.0,107.0,107.0
0.065,6,10,1506,5,395,14.0,127.0,127.0,5,1111,15.0,843.0,843.0
0.012,6,10,1989,5,910,2.0,642.0,642.0,5,1079,3.0,811.0,811.0
40.073,17,10,676,5,460,10017.0,104.0,64.0,5,216,10017.0,20.0,15.0
0.004,17,2,144,1,64,0.0,36.0,36.0,1,80,0.0,52.0,52.0
0.01,6,10,1972,5,910,2.0,642.0,642.0,5,1062,2.0,794.0,794.0
308.643,17,20,1124,10,716,34278.0,48.0,43.0,10,408,34279.0,20.0,12.0
0.01,6,10,1989,5,910,2.0,642.0,642.0,5,1079,2.0,811.0,811.0
0.012,6,10,1989,5,910,3.0,642.0,642.0,5,1079,2.0,811.0,811.0
0.012,6,14,3965,7,495,2.0,123.0,123.0,7,3470,1.0,1448.0,1032.0
0.12,6,10,1506,5,395,25.0,127.0,127.0,5,1111,25.0,843.0,843.0
0.006,6,10,2000,5,927,1.0,659.0,659.0,5,1073,1.0,805.0,805.0
0.013,6,10,1990,5,911,3.0,643.0,643.0,5,1079,3.0,811.0,811.0
0.005,17,2,194,1,59,0.0,31.0,31.0,1,135,0.0,107.0,107.0
0.039,17,4,420,2,122,0.0,33.0,33.0,2,298,34.0,145.0,121.0
0.004,17,2,136,1,60,0.0,32.0,32.0,1,76,0.0,48.0,48.0
0.001,17,2,166,1,75,0.0,47.0,47.0,1,91,0.0,63.0,63.0
0.006,6,10,1547,5,764,1.0,496.0,496.0,5,783,1.0,515.0,515.0
0.088,6,10,1506,5,395,18.0,127.0,127.0,5,1111,19.0,843.0,843.0
0.01,6,10,1989,5,910,2.0,642.0,642.0,5,1079,2.0,811.0,811.0
0.017,6,10,1990,5,911,4.0,643.0,643.0,5,1079,4.0,811.0,811.0
15.072,17,16,9302,8,6912,2149.0,1350.0,836.0,8,2390,2148.0,1350.0,270.0
0.006,17,2,166,1,75,0.0,47.0,47.0,1,91,0.0,63.0,63.0
538.784,6,140,45395,67,38148,8163.0,2883.0,845.0,73,7247,7482.0,580.0,122.0
0.168,17,2,152,1,76,0.0,48.0,48.0,1,76,0.0,48.0,48.0
0.097,6,10,1506,5,395,21.0,127.0,127.0,5,1111,20.0,843.0,843.0
0.011,6,10,1990,5,911,2.0,643.0,643.0,5,1079,2.0,811.0,811.0
0.01,6,10,1989,5,910,2.0,642.0,642.0,5,1079,2.0,811.0,811.0
30.118,6,87,74346,41,3192,752.0,517.0,262.0,46,71154,669.0,2804.0,1598.0
0.009,6,10,1989,5,910,2.0,642.0,642.0,5,1079,2.0,811.0,811.0
0.013,6,10,1972,5,910,3.0,642.0,642.0,5,1062,3.0,794.0,794.0
0.005,6,10,1989,5,927,1.0,659.0,659.0,5,1062,1.0,794.0,794.0
40.1,17,10,676,5,460,10018.0,104.0,64.0,5,216,10021.0,20.0,15.0
0.131,6,10,1506,5,395,28.0,127.0,127.0,5,1111,31.0,843.0,843.0
0.006,6,10,1547,5,764,1.0,496.0,496.0,5,783,1.0,515.0,515.0
0.012,6,10,1983,5,910,3.0,642.0,642.0,5,1073,2.0,805.0,805.0
0.004,6,10,2000,5,927,1.0,659.0,659.0,5,1073,1.0,805.0,805.0
0.006,6,10,1689,5,839,1.0,571.0,571.0,5,850,1.0,582.0,582.0
0.004,6,10,2006,5,927,1.0,659.0,659.0,5,1079,1.0,811.0,811.0
0.017,6,13,3735,7,497,2.0,125.0,125.0,6,3238,3.0,1470.0,1459.0
0.075,6,10,1506,5,395,17.0,127.0,127.0,5,1111,16.0,843.0,843.0
0.022,6,10,1989,5,910,5.0,642.0,642.0,5,1079,5.0,811.0,811.0
0.004,6,10,2006,5,927,1.0,659.0,659.0,5,1079,1.0,811.0,811.0
0.012,6,10,1762,5,911,3.0,643.0,643.0,5,851,2.0,583.0,583.0
0.018,6,10,1983,5,910,4.0,642.0,642.0,5,1073,4.0,805.0,805.0
10.929,17,28,4394,14,2312,832.0,587.0,137.0,14,2082,832.0,269.0,120.0
1772.33,6,105,6270,60,3525,30038.0,27.0,27.0,45,2745,40279.0,27.0,27.0
368.785,6,22,2313,16,867,24585.0,195.0,195.0,6,1446,4643.0,419.0,398.0
40.066,17,10,676,5,460,10013.0,104.0,64.0,5,216,10015.0,20.0,15.0
0.005,6,10,2006,5,927,1.0,659.0,659.0,5,1079,1.0,811.0,811.0
0.278,17,40,21470,22,18413,13.0,1350.0,808.0,18,3057,12.0,1350.0,141.0
0.009,6,10,1972,5,910,2.0,642.0,642.0,5,1062,2.0,794.0,794.0
310.364,17,20,1124,10,716,34470.0,48.0,43.0,10,408,34470.0,20.0,12.0
0.003,17,2,136,1,60,0.0,32.0,32.0,1,76,0.0,48.0,48.0
0.003,17,2,148,1,60,0.0,32.0,32.0,1,88,0.0,60.0,60.0
9.039,17,6,376,5,280,2259.0,28.0,28.0,1,96,0.0,68.0,68.0
0.005,6,10,2000,5,927,1.0,659.0,659.0,5,1073,1.0,805.0,805.0
0.096,6,10,1506,5,395,21.0,127.0,127.0,5,1111,20.0,843.0,843.0
40.061,17,10,676,5,460,10014.0,104.0,64.0,5,216,10014.0,20.0,15.0
0.003,17,2,132,1,58,0.0,30.0,30.0,1,74,0.0,46.0,46.0
0.107,6,10,1506,5,395,23.0,127.0,127.0,5,1111,23.0,843.0,843.0
0.084,6,10,1506,5,395,19.0,127.0,127.0,5,1111,18.0,843.0,843.0
0.097,6,10,1506,5,395,20.0,127.0,127.0,5,1111,22.0,843.0,843.0
0.005,6,10,1774,5,923,1.0,655.0,655.0,5,851,1.0,583.0,583.0
0.008,6,10,1989,5,927,2.0,659.0,659.0,5,1062,2.0,794.0,794.0
0.09,6,10,1506,5,395,19.0,127.0,127.0,5,1111,20.0,843.0,843.0
0.004,17,4,284,2,120,0.0,32.0,32.0,2,164,0.0,60.0,54.0
0.082,6,10,1506,5,395,14.0,127.0,127.0,5,1111,17.0,843.0,843.0
0.006,6,10,2007,5,928,1.0,660.0,660.0,5,1079,1.0,811.0,811.0
0.009,6,12,1926,6,1189,1.0,659.0,434.0,6,737,1.0,417.0,417.0
0.073,6,10,1506,5,395,17.0,127.0,127.0,5,1111,14.0,843.0,843.0
0.083,6,10,1506,5,395,17.0,127.0,127.0,5,1111,17.0,843.0,843.0
15.08,17,15,8191,8,6007,2150.0,1350.0,722.0,7,2184,2508.0,1350.0,284.0
0.005,6,10,1547,5,764,1.0,496.0,496.0,5,783,1.0,515.0,515.0
0.005,6,10,1774,5,923,1.0,655.0,655.0,5,851,1.0,583.0,583.0
0.014,6,10,1677,5,827,3.0,559.0,559.0,5,850,3.0,582.0,582.0
0.005,17,2,194,1,59,0.0,31.0,31.0,1,135,0.0,107.0,107.0
0.016,6,10,1989,5,910,4.0,642.0,642.0,5,1079,3.0,811.0,811.0
0.077,6,10,1506,5,395,17.0,127.0,127.0,5,1111,15.0,843.0,843.0
0.004,17,2,148,1,60,0.0,32.0,32.0,1,88,0.0,60.0,60.0
0.013,6,10,1989,5,910,3.0,642.0,642.0,5,1079,3.0,811.0,811.0
0.076,6,10,1506,5,395,18.0,127.0,127.0,5,1111,14.0,843.0,843.0
0.006,17,2,170,1,65,0.0,37.0,37.0,1,105,0.0,77.0,77.0
0.01,6,14,3787,7,497,1.0,125.0,125.0,7,3290,1.0,1448.0,972.0
0.004,17,4,420,2,122,0.0,33.0,33.0,2,298,0.0,145.0,121.0
0.005,6,10,1774,5,923,1.0,655.0,655.0,5,851,1.0,583.0,583.0
11.149,17,28,4423,14,1994,845.0,269.0,114.0,14,2429,845.0,588.0,145.0
0.011,6,10,1989,5,910,2.0,642.0,642.0,5,1079,2.0,811.0,811.0
0.005,17,2,166,1,75,0.0,47.0,47.0,1,91,0.0,63.0,63.0
0.01,6,10,1972,5,910,2.0,642.0,642.0,5,1062,2.0,794.0,794.0
0.006,6,10,1547,5,764,1.0,496.0,496.0,5,783,1.0,515.0,515.0
40.058,17,10,676,5,460,10012.0,104.0,64.0,5,216,10013.0,20.0,15.0
0.122,6,10,1506,5,395,25.0,127.0,127.0,5,1111,28.0,843.0,843.0
0.005,6,10,2006,5,927,1.0,659.0,659.0,5,1079,1.0,811.0,811.0
0.005,6,10,2006,5,927,1.0,659.0,659.0,5,1079,1.0,811.0,811.0
0.073,6,10,1506,5,395,14.0,127.0,127.0,5,1111,17.0,843.0,843.0
0.009,6,10,1762,5,911,2.0,643.0,643.0,5,851,2.0,583.0,583.0
97.922,6,21,8145,11,1985,81.0,1174.0,504.0,10,6160,10862.0,2720.0,958.0
0.08,6,10,1506,5,395,17.0,127.0,127.0,5,1111,15.0,843.0,843.0
0.013,6,10,1972,5,910,3.0,642.0,642.0,5,1062,3.0,794.0,794.0
0.014,6,10,1677,5,827,3.0,559.0,559.0,5,850,3.0,582.0,582.0
0.072,6,10,1506,5,395,16.0,127.0,127.0,5,1111,16.0,843.0,843.0
0.012,6,10,1990,5,911,2.0,643.0,643.0,5,1079,3.0,811.0,811.0
0.003,17,4,284,2,120,0.0,32.0,32.0,2,164,0.0,60.0,54.0
0.257,17,40,20264,22,17090,12.0,1350.0,748.0,18,3174,11.0,1350.0,148.0
0.1,6,10,1506,5,395,21.0,127.0,127.0,5,1111,21.0,843.0,843.0
0.087,6,10,1506,5,395,20.0,127.0,127.0,5,1111,18.0,843.0,843.0
0.004,6,10,1774,5,923,1.0,655.0,655.0,5,851,1.0,583.0,583.0
0.004,17,4,284,2,120,1.0,32.0,32.0,2,164,0.0,60.0,54.0
0.001,17,2,174,1,72,0.0,44.0,44.0,1,102,0.0,74.0,74.0
0.005,6,10,2006,5,927,1.0,659.0,659.0,5,1079,1.0,811.0,811.0
0.001,17,2,180,1,66,0.0,38.0,38.0,1,114,0.0,86.0,86.0
0.011,6,13,3735,7,497,1.0,125.0,125.0,6,3238,2.0,1470.0,1459.0
0.009,6,12,1926,6,1189,1.0,659.0,434.0,6,737,1.0,417.0,417.0
0.078,6,10,1506,5,395,16.0,127.0,127.0,5,1111,18.0,843.0,843.0
0.006,17,2,170,1,65,0.0,37.0,37.0,1,105,0.0,77.0,77.0
0.004,17,4,284,2,120,0.0,32.0,32.0,2,164,1.0,60.0,54.0
0.069,17,8,3613,4,1874,23.0,1350.0,440.0,4,1739,12.0,1350.0,406.0
0.039,6,10,1677,5,827,9.0,559.0,559.0,5,850,9.0,582.0,582.0
300.411,6,16,2170,9,684,37530.0,146.0,146.0,7,1486,50039.0,419.0,398.0
0.005,17,2,214,1,75,0.0,47.0,47.0,1,139,0.0,111.0,111.0
0.014,6,10,1990,5,911,3.0,643.0,643.0,5,1079,3.0,811.0,811.0
0.018,6,10,1631,5,848,4.0,580.0,580.0,5,783,4.0,515.0,515.0
0.014,6,10,1972,5,910,3.0,642.0,642.0,5,1062,3.0,794.0,794.0
0.072,6,10,1506,5,395,15.0,127.0,127.0,5,1111,16.0,843.0,843.0
0.014,6,10,1983,5,910,3.0,642.0,642.0,5,1073,3.0,805.0,805.0
0.121,6,27,10058,14,8890,9.0,2261.0,1020.0,13,1168,9.0,206.0,82.0
0.001,17,2,180,1,66,0.0,38.0,38.0,1,114,0.0,86.0,86.0
300.418,6,16,2170,9,684,37532.0,146.0,146.0,7,1486,50041.0,419.0,398.0
10.792,17,28,4418,14,1995,821.0,270.0,114.0,14,2423,821.0,586.0,145.0
0.013,6,10,1631,5,848,3.0,580.0,580.0,5,783,3.0,515.0,515.0
0.001,17,2,180,1,66,0.0,38.0,38.0,1,114,0.0,86.0,86.0
0.111,6,10,1506,5,395,23.0,127.0,127.0,5,1111,22.0,843.0,843.0
0.109,6,10,1506,5,395,25.0,127.0,127.0,5,1111,23.0,843.0,843.0
1797.125,17,2998,225406,1493,119622,1204.0,82.0,52.0,1505,105784,1194.0,226.0,42.0
0.005,17,2,179,1,71,0.0,43.0,43.0,1,108,0.0,80.0,80.0
0.007,6,10,1547,5,764,1.0,496.0,496.0,5,783,1.0,515.0,515.0
0.014,6,10,1990,5,911,3.0,643.0,643.0,5,1079,3.0,811.0,811.0
0.005,6,10,1989,5,927,1.0,659.0,659.0,5,1062,1.0,794.0,794.0
0.004,6,10,1702,5,863,1.0,595.0,595.0,5,839,0.0,571.0,571.0
0.142,6,10,1506,5,395,33.0,127.0,127.0,5,1111,34.0,843.0,843.0
0.082,6,10,1506,5,395,16.0,127.0,127.0,5,1111,19.0,843.0,843.0
0.005,17,2,140,1,62,0.0,34.0,34.0,1,78,0.0,50.0,50.0
0.065,6,10,1506,5,395,14.0,127.0,127.0,5,1111,13.0,843.0,843.0
0.011,6,10,1972,5,910,2.0,642.0,642.0,5,1062,2.0,794.0,794.0
0.086,6,10,1506,5,395,19.0,127.0,127.0,5,1111,19.0,843.0,843.0
0.182,17,2,194,1,59,0.0,31.0,31.0,1,135,0.0,107.0,107.0
0.084,6,10,1506,5,395,19.0,127.0,127.0,5,1111,19.0,843.0,843.0
0.008,6,10,1972,5,910,1.0,642.0,642.0,5,1062,1.0,794.0,794.0
40.066,17,10,676,5,460,10013.0,104.0,64.0,5,216,10015.0,20.0,15.0
0.019,6,10,1972,5,910,4.0,642.0,642.0,5,1062,4.0,794.0,794.0
0.004,6,10,2006,5,927,1.0,659.0,659.0,5,1079,1.0,811.0,811.0
0.017,6,10,1983,5,910,4.0,642.0,642.0,5,1073,4.0,805.0,805.0
0.004,17,2,148,1,60,0.0,32.0,32.0,1,88,0.0,60.0,60.0
0.009,6,10,1989,5,910,2.0,642.0,642.0,5,1079,2.0,811.0,811.0
0.068,17,8,3613,4,1874,22.0,1350.0,440.0,4,1739,11.0,1350.0,406.0
0.006,6,10,1547,5,764,1.0,496.0,496.0,5,783,1.0,515.0,515.0
0.004,6,10,2006,5,927,1.0,659.0,659.0,5,1079,1.0,811.0,811.0
0.006,6,10,2007,5,928,1.0,660.0,660.0,5,1079,1.0,811.0,811.0
0.845,6,22,5168,11,1138,71.0,267.0,115.0,11,4030,71.0,1414.0,597.0
0.015,6,10,1605,5,388,3.0,120.0,120.0,5,1217,3.0,949.0,949.0
240.014,6,9,787,5,488,60003.0,232.0,232.0,4,299,80003.0,83.0,83.0
0.071,6,10,1506,5,395,14.0,127.0,127.0,5,1111,16.0,843.0,843.0
0.003,17,2,185,1,73,0.0,45.0,45.0,1,112,0.0,84.0,84.0
0.021,17,2,148,1,60,0.0,32.0,32.0,1,88,0.0,60.0,60.0
11.184,17,28,4421,14,1994,847.0,269.0,114.0,14,2427,847.0,586.0,145.0
0.006,6,10,1547,5,764,1.0,496.0,496.0,5,783,1.0,515.0,515.0
0.015,6,10,1972,5,910,3.0,642.0,642.0,5,1062,3.0,794.0,794.0
0.005,6,10,2006,5,927,1.0,659.0,659.0,5,1079,1.0,811.0,811.0
0.01,6,12,1926,6,1189,2.0,659.0,434.0,6,737,2.0,417.0,417.0
51.369,6,62,36934,32,30707,305.0,2720.0,1729.0,30,6227,1765.0,2667.0,385.0
0.093,6,10,1506,5,395,19.0,127.0,127.0,5,1111,20.0,843.0,843.0
0.037,17,2,170,1,65,0.0,37.0,37.0,1,105,0.0,77.0,77.0
0.04,17,2,152,1,76,0.0,48.0,48.0,1,76,0.0,48.0,48.0
0.14,6,10,1506,5,395,33.0,127.0,127.0,5,1111,32.0,843.0,843.0
0.004,17,2,136,1,60,0.0,32.0,32.0,1,76,0.0,48.0,48.0
0.005,6,13,3747,7,509,0.0,137.0,137.0,6,3238,1.0,1470.0,1459.0
0.004,6,10,1989,5,927,1.0,659.0,659.0,5,1062,1.0,794.0,794.0
0.012,6,10,1762,5,911,2.0,643.0,643.0,5,851,2.0,583.0,583.0
0.004,17,2,136,1,60,0.0,32.0,32.0,1,76,0.0,48.0,48.0
0.005,6,10,2006,5,927,1.0,659.0,659.0,5,1079,1.0,811.0,811.0
0.01,6,14,3787,7,497,1.0,125.0,125.0,7,3290,1.0,1448.0,972.0
0.008,6,10,1972,5,910,2.0,642.0,642.0,5,1062,1.0,794.0,794.0
0.006,17,2,140,1,62,0.0,34.0,34.0,1,78,0.0,50.0,50.0
40.091,17,10,676,5,460,10022.0,104.0,64.0,5,216,10022.0,20.0,15.0
0.005,17,2,170,1,65,0.0,37.0,37.0,1,105,0.0,77.0,77.0
0.023,17,2,170,1,65,0.0,37.0,37.0,1,105,0.0,77.0,77.0
0.004,6,10,2006,5,927,1.0,659.0,659.0,5,1079,1.0,811.0,811.0
0.006,17,2,144,1,64,0.0,36.0,36.0,1,80,0.0,52.0,52.0
0.001,17,2,180,1,66,0.0,38.0,38.0,1,114,0.0,86.0,86.0
0.04,17,2,186,1,61,0.0,33.0,33.0,1,125,0.0,97.0,97.0
0.118,6,10,1506,5,395,28.0,127.0,127.0,5,1111,23.0,843.0,843.0
0.098,6,10,1506,5,395,22.0,127.0,127.0,5,1111,23.0,843.0,843.0
0.006,17,2,144,1,64,0.0,36.0,36.0,1,80,0.0,52.0,52.0
0.004,17,2,148,1,60,0.0,32.0,32.0,1,88,0.0,60.0,60.0
0.01,6,10,1972,5,910,2.0,642.0,642.0,5,1062,2.0,794.0,794.0
11.094,17,28,4417,14,1994,841.0,269.0,114.0,14,2423,841.0,586.0,145.0
0.005,17,2,140,1,62,0.0,34.0,34.0,1,78,0.0,50.0,50.0
0.014,6,10,1631,5,848,3.0,580.0,580.0,5,783,3.0,515.0,515.0
0.005,17,2,247,1,68,0.0,40.0,40.0,1,179,0.0,151.0,151.0
308.279,17,20,1124,10,716,34238.0,48.0,43.0,10,408,34238.0,20.0,12.0
0.005,6,10,2007,5,928,1.0,660.0,660.0,5,1079,1.0,811.0,811.0
0.004,6,10,1774,5,923,1.0,655.0,655.0,5,851,1.0,583.0,583.0
240.088,6,16,4480,9,963,30011.0,238.0,166.0,7,3517,40014.0,1402.0,786.0
0.004,6,10,1779,5,928,1.0,660.0,660.0,5,851,0.0,583.0,583.0
1755.237,6,467,69960,266,36241,6623.0,613.0,191.0,201,33719,8775.0,613.0,154.0
0.144,17,2,144,1,64,0.0,36.0,36.0,1,80,0.0,52.0,52.0
0.071,6,10,1506,5,395,16.0,127.0,127.0,5,1111,14.0,843.0,843.0
361.757,6,19,1688,15,978,25839.0,190.0,190.0,4,710,80013.0,494.0,494.0
0.008,17,2,194,1,59,0.0,31.0,31.0,1,135,0.0,107.0,107.0
240.012,6,9,787,5,488,60003.0,232.0,232.0,4,299,80003.0,83.0,83.0
0.006,6,10,2006,5,927,1.0,659.0,659.0,5,1079,1.0,811.0,811.0
0.004,17,2,148,1,60,0.0,32.0,32.0,1,88,0.0,60.0,60.0
0.006,6,10,1689,5,839,1.0,571.0,571.0,5,850,1.0,582.0,582.0
0.005,6,10,2006,5,927,1.0,659.0,659.0,5,1079,1.0,811.0,811.0
0.127,17,2,136,1,60,0.0,32.0,32.0,1,76,0.0,48.0,48.0
361.821,6,19,1689,15,978,25844.0,190.0,190.0,4,711,80014.0,495.0,495.0
0.083,6,10,1506,5,395,18.0,127.0,127.0,5,1111,18.0,843.0,843.0
300.398,6,30,11500,15,5454,21455.0,1368.0,777.0,15,6046,21455.0,1656.0,752.0
0.01,6,10,1972,5,910,2.0,642.0,642.0,5,1062,2.0,794.0,794.0
0.059,6,10,1506,5,395,12.0,127.0,127.0,5,1111,14.0,843.0,843.0
10.749,17,28,4422,14,1993,818.0,268.0,114.0,14,2429,818.0,588.0,145.0
0.006,6,10,1547,5,764,1.0,496.0,496.0,5,783,1.0,515.0,515.0
0.004,6,10,2007,5,928,1.0,660.0,660.0,5,1079,1.0,811.0,811.0
361.884,6,21,1793,16,1030,24125.0,190.0,190.0,5,763,60009.0,462.0,247.0
0.122,6,10,1506,5,395,24.0,127.0,127.0,5,1111,26.0,843.0,843.0
0.005,6,10,1989,5,927,1.0,659.0,659.0,5,1062,1.0,794.0,794.0
0.005,17,2,157,1,59,0.0,31.0,31.0,1,98,0.0,70.0,70.0
10.789,17,28,4420,14,1993,821.0,268.0,114.0,14,2427,821.0,586.0,145.0
0.036,17,2,136,1,60,0.0,32.0,32.0,1,76,0.0,48.0,48.0
180.457,6,22,8153,11,1953,99.0,1174.0,493.0,11,6200,18028.0,2720.0,958.0
0.012,6,10,1972,5,910,2.0,642.0,642.0,5,1062,3.0,794.0,794.0
300.323,6,16,2170,9,684,37519.0,146.0,146.0,7,1486,50026.0,419.0,398.0
0.005,6,10,2007,5,928,1.0,660.0,660.0,5,1079,1.0,811.0,811.0
0.369,17,2,152,1,76,0.0,48.0,48.0,1,76,0.0,48.0,48.0
0.006,6,10,1547,5,764,1.0,496.0,496.0,5,783,1.0,515.0,515.0
0.001,17,2,136,1,60,0.0,32.0,32.0,1,76,0.0,48.0,48.0
0.004,6,10,2000,5,927,1.0,659.0,659.0,5,1073,1.0,805.0,805.0
369.885,6,22,2313,16,867,24659.0,195.0,195.0,6,1446,4677.0,419.0,398.0
313.856,17,20,1124,10,716,34858.0,48.0,43.0,10,408,34858.0,20.0,12.0
0.003,17,2,148,1,60,0.0,32.0,32.0,1,88,0.0,60.0,60.0
300.465,6,19,3081,11,1647,30046.0,517.0,266.0,8,1434,34343.0,821.0,336.0
0.141,6,10,1506,5,395,32.0,127.0,127.0,5,1111,28.0,843.0,843.0
0.006,6,13,3690,7,452,1.0,80.0,80.0,6,3238,1.0,1470.0,1459.0
1723.448,6,63,7228,40,4332,44190.0,1625.0,112.0,23,2896,78331.0,1111.0,85.0
0.056,17,2,412,1,61,0.0,33.0,33.0,1,351,0.0,323.0,323.0
0.06,17,2,152,1,76,0.0,48.0,48.0,1,76,0.0,48.0,48.0
0.008,6,12,1926,6,1189,1.0,659.0,434.0,6,737,1.0,417.0,417.0
0.07,6,10,1506,5,395,16.0,127.0,127.0,5,1111,16.0,843.0,843.0
240.082,6,16,4480,9,963,30010.0,238.0,166.0,7,3517,40013.0,1402.0,786.0
0.085,6,10,1506,5,395,17.0,127.0,127.0,5,1111,17.0,843.0,843.0
10.886,17,28,4422,14,1995,828.0,270.0,114.0,14,2427,828.0,586.0,145.0
0.038,17,2,136,1,60,0.0,32.0,32.0,1,76,0.0,48.0,48.0
0.009,6,10,1989,5,910,2.0,642.0,642.0,5,1079,2.0,811.0,811.0
0.006,6,10,2006,5,927,1.0,659.0,659.0,5,1079,1.0,811.0,811.0
0.005,17,2,180,1,66,0.0,38.0,38.0,1,114,0.0,86.0,86.0
0.009,6,12,1926,6,1189,1.0,659.0,434.0,6,737,1.0,417.0,417.0
240.092,6,16,4481,9,963,30011.0,238.0,166.0,7,3518,40014.0,1402.0,786.0
0.004,6,10,1989,5,927,1.0,659.0,659.0,5,1062,1.0,794.0,794.0
0.014,6,10,1989,5,910,3.0,642.0,642.0,5,1079,3.0,811.0,811.0
0.001,17,2,180,1,66,0.0,38.0,38.0,1,114,0.0,86.0,86.0
0.1,6,10,1506,5,395,23.0,127.0,127.0,5,1111,22.0,843.0,843.0
0.005,6,13,3690,7,452,0.0,80.0,80.0,6,3238,0.0,1470.0,1459.0
1746.437,6,303,97586,187,86326,9389.0,2001.0,683.0,116,11260,15186.0,452.0,69.0
64.428,6,24,5757,12,1415,5857.0,469.0,156.0,12,4342,5856.0,1402.0,618.0
0.003,17,2,170,1,65,0.0,37.0,37.0,1,105,0.0,77.0,77.0
0.022,6,10,1972,5,910,5.0,642.0,642.0,5,1062,5.0,794.0,794.0
0.005,6,10,2006,5,927,1.0,659.0,659.0,5,1079,1.0,811.0,811.0
0.01,6,10,1677,5,827,2.0,559.0,559.0,5,850,2.0,582.0,582.0
0.01,6,10,1677,5,827,2.0,559.0,559.0,5,850,2.0,582.0,582.0
314.762,17,20,1124,10,716,34959.0,48.0,43.0,10,408,34959.0,20.0,12.0
0.08,6,10,1972,5,910,19.0,642.0,642.0,5,1062,19.0,794.0,794.0
0.001,17,2,184,1,68,0.0,40.0,40.0,1,116,0.0,88.0,88.0
0.005,6,10,2000,5,927,1.0,659.0,659.0,5,1073,1.0,805.0,805.0
313.394,17,20,1124,10,716,34807.0,48.0,43.0,10,408,34807.0,20.0,12.0
0.012,6,10,1972,5,910,3.0,642.0,642.0,5,1062,2.0,794.0,794.0
0.016,6,10,2000,5,927,4.0,659.0,659.0,5,1073,4.0,805.0,805.0
0.013,6,10,1972,5,910,3.0,642.0,642.0,5,1062,3.0,794.0,794.0
0.006,6,10,1547,5,764,1.0,496.0,496.0,5,783,1.0,515.0,515.0
0.005,6,10,1779,5,928,1.0,660.0,660.0,5,851,1.0,583.0,583.0
0.005,6,13,3747,7,509,0.0,137.0,137.0,6,3238,1.0,1470.0,1459.0
0.275,17,44,24445,24,21170,11.0,1350.0,854.0,20,3275,11.0,1350.0,135.0
0.004,6,10,2006,5,927,1.0,659.0,659.0,5,1079,1.0,811.0,811.0
0.074,6,10,1506,5,395,18.0,127.0,127.0,5,1111,15.0,843.0,843.0
0.225,6,10,1506,5,395,54.0,127.0,127.0,5,1111,55.0,843.0,843.0
0.092,6,10,1506,5,395,19.0,127.0,127.0,5,1111,21.0,843.0,843.0
0.006,6,13,3690,7,452,1.0,80.0,80.0,6,3238,1.0,1470.0,1459.0
15.091,17,16,9302,8,6912,2151.0,1350.0,836.0,8,2390,2150.0,1350.0,270.0
0.04,17,2,182,1,65,0.0,37.0,37.0,1,117,0.0,89.0,89.0
0.004,17,2,152,1,76,0.0,48.0,48.0,1,76,0.0,48.0,48.0
0.043,17,4,284,2,120,0.0,32.0,32.0,2,164,40.0,60.0,54.0
0.049,6,10,1989,5,910,12.0,642.0,642.0,5,1079,12.0,811.0,811.0
0.115,6,10,1506,5,395,26.0,127.0,127.0,5,1111,25.0,843.0,843.0
400.134,6,29,4397,13,3142,33344.0,494.0,494.0,16,1255,26675.0,83.0,83.0
0.01,6,10,1972,5,910,2.0,642.0,642.0,5,1062,2.0,794.0,794.0
0.005,6,10,2006,5,927,1.0,659.0,659.0,5,1079,1.0,811.0,811.0
0.087,6,10,1506,5,395,19.0,127.0,127.0,5,1111,18.0,843.0,843.0
351.99,6,20,2210,6,1308,12003.0,494.0,494.0,14,902,27075.0,83.0,83.0
11.169,17,28,4422,14,1994,846.0,269.0,114.0,14,2428,846.0,587.0,145.0
10.905,17,28,4417,14,1994,830.0,269.0,114.0,14,2423,830.0,586.0,145.0
0.012,6,10,1631,5,848,2.0,580.0,580.0,5,783,2.0,515.0,515.0
0.014,6,10,1762,5,911,3.0,643.0,643.0,5,851,3.0,583.0,583.0
0.005,6,10,2006,5,927,1.0,659.0,659.0,5,1079,1.0,811.0,811.0
0.008,6,12,1926,6,1189,1.0,659.0,434.0,6,737,1.0,417.0,417.0
0.009,6,10,1989,5,910,2.0,642.0,642.0,5,1079,2.0,811.0,811.0
0.004,6,10,2000,5,927,1.0,659.0,659.0,5,1073,1.0,805.0,805.0
0.107,6,10,1506,5,395,20.0,127.0,127.0,5,1111,26.0,843.0,843.0
0.015,6,10,1972,5,910,3.0,642.0,642.0,5,1062,3.0,794.0,794.0
0.004,6,10,2000,5,927,1.0,659.0,659.0,5,1073,1.0,805.0,805.0
0.008,6,10,1989,5,910,2.0,642.0,642.0,5,1079,2.0,811.0,811.0
0.005,17,2,146,1,65,0.0,37.0,37.0,1,81,0.0,53.0,53.0
0.004,6,10,2000,5,927,1.0,659.0,659.0,5,1073,1.0,805.0,805.0
0.061,17,2,152,1,76,0.0,48.0,48.0,1,76,0.0,48.0,48.0
0.194,17,4,596,2,122,153.0,33.0,33.0,2,474,154.0,323.0,209.0
0.017,6,10,1983,5,910,4.0,642.0,642.0,5,1073,4.0,805.0,805.0
0.125,6,10,1506,5,395,30.0,127.0,127.0,5,1111,14.0,843.0,843.0
0.018,6,10,2006,5,927,4.0,659.0,659.0,5,1079,4.0,811.0,811.0
0.076,6,10,1506,5,395,16.0,127.0,127.0,5,1111,16.0,843.0,843.0
0.007,17,2,166,1,75,0.0,47.0,47.0,1,91,0.0,63.0,63.0
0.004,6,10,2006,5,927,1.0,659.0,659.0,5,1079,1.0,811.0,811.0
0.007,6,10,1762,5,911,1.0,643.0,643.0,5,851,1.0,583.0,583.0
0.005,6,10,1989,5,927,1.0,659.0,659.0,5,1062,1.0,794.0,794.0
0.014,6,10,1989,5,910,3.0,642.0,642.0,5,1079,3.0,811.0,811.0
0.01,6,10,1762,5,911,2.0,643.0,643.0,5,851,2.0,583.0,583.0
0.099,6,10,1506,5,395,23.0,127.0,127.0,5,1111,21.0,843.0,843.0
0.019,6,10,1990,5,911,4.0,643.0,643.0,5,1079,4.0,811.0,811.0
0.025,6,13,3816,7,578,4.0,206.0,206.0,6,3238,4.0,1470.0,1459.0
0.018,6,10,1989,5,910,4.0,642.0,642.0,5,1079,4.0,811.0,811.0
0.089,6,10,1506,5,395,19.0,127.0,127.0,5,1111,17.0,843.0,843.0
0.011,6,10,1762,5,911,2.0,643.0,643.0,5,851,2.0,583.0,583.0
0.007,6,10,1989,5,910,1.0,642.0,642.0,5,1079,1.0,811.0,811.0
1777.777,17,142,44872,72,22752,25038.0,288.0,288.0,70,22120,25763.0,288.0,288.0
0.087,6,10,1506,5,395,19.0,127.0,127.0,5,1111,20.0,843.0,843.0
1778.231,17,144,45504,72,22752,25045.0,288.0,288.0,72,22752,25045.0,288.0,288.0
0.006,6,10,1689,5,839,1.0,571.0,571.0,5,850,1.0,582.0,582.0
0.005,6,14,3736,7,446,0.0,74.0,74.0,7,3290,0.0,1448.0,972.0
0.017,6,10,1990,5,911,4.0,643.0,643.0,5,1079,4.0,811.0,811.0
0.006,6,10,1547,5,764,1.0,496.0,496.0,5,783,1.0,515.0,515.0
0.008,17,2,194,1,59,0.0,31.0,31.0,1,135,0.0,107.0,107.0
300.318,6,16,2170,9,684,37518.0,146.0,146.0,7,1486,50023.0,419.0,398.0
0.004,17,2,136,1,60,0.0,32.0,32.0,1,76,0.0,48.0,48.0
372.119,6,22,2313,16,867,24807.0,195.0,195.0,6,1446,4646.0,419.0,398.0
0.009,6,10,1972,5,910,2.0,642.0,642.0,5,1062,2.0,794.0,794.0
0.082,6,10,1506,5,395,17.0,127.0,127.0,5,1111,19.0,843.0,843.0
0.001,17,2,180,1,66,0.0,38.0,38.0,1,114,0.0,86.0,86.0
0.098,6,10,1506,5,395,20.0,127.0,127.0,5,1111,23.0,843.0,843.0
0.084,6,10,1506,5,395,19.0,127.0,127.0,5,1111,19.0,843.0,843.0
0.006,6,10,2007,5,928,1.0,660.0,660.0,5,1079,1.0,811.0,811.0
0.006,6,10,1547,5,764,1.0,496.0,496.0,5,783,1.0,515.0,515.0
0.012,6,10,1989,5,910,3.0,642.0,642.0,5,1079,3.0,811.0,811.0
0.008,17,2,194,1,59,0.0,31.0,31.0,1,135,0.0,107.0,107.0
0.013,17,2,179,1,71,0.0,43.0,43.0,1,108,0.0,80.0,80.0
0.004,6,10,2007,5,928,1.0,660.0,660.0,5,1079,1.0,811.0,811.0
312.909,17,20,1124,10,716,34752.0,48.0,43.0,10,408,34752.0,20.0,12.0
0.003,17,2,148,1,60,0.0,32.0,32.0,1,88,0.0,60.0,60.0
0.011,6,10,1972,5,910,2.0,642.0,642.0,5,1062,2.0,794.0,794.0
40.053,17,10,676,5,460,10012.0,104.0,64.0,5,216,10012.0,20.0,15.0
0.012,6,10,1989,5,910,3.0,642.0,642.0,5,1079,3.0,811.0,811.0
0.004,17,4,284,2,120,0.0,32.0,32.0,2,164,0.0,60.0,54.0
0.0,17,2,136,1,60,0.0,32.0,32.0,1,76,0.0,48.0,48.0
0.005,6,10,1779,5,928,1.0,660.0,660.0,5,851,1.0,583.0,583.0
0.005,6,10,2000,5,927,1.0,659.0,659.0,5,1073,1.0,805.0,805.0
0.039,17,2,152,1,76,0.0,48.0,48.0,1,76,0.0,48.0,48.0
0.006,6,10,1854,5,889,1.0,621.0,621.0,5,965,1.0,697.0,697.0
0.005,6,10,2000,5,927,1.0,659.0,659.0,5,1073,1.0,805.0,805.0
0.184,6,10,1506,5,395,41.0,127.0,127.0,5,1111,42.0,843.0,843.0
0.123,6,10,1506,5,395,27.0,127.0,127.0,5,1111,25.0,843.0,843.0
273.794,6,26,6041,13,2965,22816.0,967.0,453.0,13,3076,22815.0,1162.0,398.0
0.004,6,10,2006,5,927,1.0,659.0,659.0,5,1079,1.0,811.0,811.0
40.063,17,10,676,5,460,10014.0,104.0,64.0,5,216,10015.0,20.0,15.0
240.109,6,30,9229,15,7000,17150.0,2123.0,691.0,15,2229,17150.0,580.0,205.0
0.125,6,10,1506,5,395,28.0,127.0,127.0,5,1111,26.0,843.0,843.0
0.038,17,4,284,2,120,0.0,32.0,32.0,2,164,35.0,60.0,54.0
0.005,6,10,1689,5,839,1.0,571.0,571.0,5,850,1.0,582.0,582.0
0.005,6,10,2007,5,928,1.0,660.0,660.0,5,1079,1.0,811.0,811.0
0.098,6,10,1506,5,395,21.0,127.0,127.0,5,1111,21.0,843.0,843.0
1799.922,6,137,6590,76,3625,23995.0,39.0,39.0,61,2965,29994.0,35.0,35.0
0.005,6,10,2007,5,928,1.0,660.0,660.0,5,1079,1.0,811.0,811.0
0.005,6,10,1989,5,927,1.0,659.0,659.0,5,1062,1.0,794.0,794.0
0.072,17,2,136,1,60,0.0,32.0,32.0,1,76,0.0,48.0,48.0
0.04,17,4,596,2,122,0.0,33.0,33.0,2,474,1.0,323.0,209.0
0.037,17,2,136,1,60,0.0,32.0,32.0,1,76,0.0,48.0,48.0
40.071,17,10,676,5,460,10016.0,104.0,64.0,5,216,10016.0,20.0,15.0
241.359,6,357,345940,173,20514,1403.0,2736.0,959.0,184,325426,1318.0,2769.0,1825.0
10.931,17,28,4397,14,2312,832.0,587.0,137.0,14,2085,832.0,268.0,120.0
0.005,6,10,1547,5,764,1.0,496.0,496.0,5,783,1.0,515.0,515.0
0.006,6,10,1689,5,839,1.0,571.0,571.0,5,850,1.0,582.0,582.0
0.009,6,10,1989,5,910,2.0,642.0,642.0,5,1079,2.0,811.0,811.0
10.843,17,28,4423,14,1995,825.0,270.0,114.0,14,2428,825.0,587.0,145.0
291.337,6,377,347596,194,21650,1509.0,2736.0,888.0,183,325946,1600.0,2804.0,1872.0
0.001,17,2,152,1,68,0.0,40.0,40.0,1,84,0.0,56.0,56.0
308.548,17,20,1124,10,716,34268.0,48.0,43.0,10,408,34268.0,20.0,12.0
0.001,17,2,142,1,63,0.0,35.0,35.0,1,79,0.0,51.0,51.0
0.017,6,10,1989,5,910,4.0,642.0,642.0,5,1079,4.0,811.0,811.0
0.014,6,10,1762,5,911,3.0,643.0,643.0,5,851,3.0,583.0,583.0
0.092,6,10,1506,5,395,19.0,127.0,127.0,5,1111,20.0,843.0,843.0
0.013,17,2,230,1,68,0.0,40.0,40.0,1,162,0.0,134.0,134.0
0.004,6,10,2000,5,927,1.0,659.0,659.0,5,1073,1.0,805.0,805.0
0.005,6,10,2006,5,927,1.0,659.0,659.0,5,1079,1.0,811.0,811.0
309.074,17,18,1008,9,640,38626.0,48.0,43.0,9,368,38626.0,20.0,12.0
0.117,6,10,1506,5,395,27.0,127.0,127.0,5,1111,27.0,843.0,843.0
40.074,17,10,676,5,460,10015.0,104.0,64.0,5,216,10015.0,20.0,15.0
0.006,17,2,180,1,66,0.0,38.0,38.0,1,114,0.0,86.0,86.0
0.003,17,2,136,1,60,0.0,32.0,32.0,1,76,0.0,48.0,48.0
0.013,6,10,1631,5,848,3.0,580.0,580.0,5,783,3.0,515.0,515.0
240.11,6,16,4480,9,963,30013.0,238.0,166.0,7,3517,40016.0,1402.0,786.0
0.122,17,2,80,1,32,0.0,4.0,4.0,1,48,0.0,20.0,20.0
0.005,6,10,1989,5,927,1.0,659.0,659.0,5,1062,1.0,794.0,794.0
0.008,6,10,1972,5,910,2.0,642.0,642.0,5,1062,2.0,794.0,794.0
0.004,6,10,2000,5,927,1.0,659.0,659.0,5,1073,1.0,805.0,805.0
0.081,6,10,1506,5,395,15.0,127.0,127.0,5,1111,19.0,843.0,843.0
0.007,17,4,284,2,120,3.0,32.0,32.0,2,164,6.0,60.0,54.0
0.005,6,10,1989,5,927,1.0,659.0,659.0,5,1062,1.0,794.0,794.0
0.005,6,10,1689,5,839,1.0,571.0,571.0,5,850,1.0,582.0,582.0
0.005,6,10,1989,5,927,1.0,659.0,659.0,5,1062,1.0,794.0,794.0
40.068,17,10,676,5,460,10016.0,104.0,64.0,5,216,10016.0,20.0,15.0
28.088,6,40,13741,20,8143,465.0,2720.0,1218.0,20,5598,1469.0,2667.0,435.0
0.072,17,4,352,2,130,0.0,37.0,37.0,2,222,69.0,89.0,83.0
0.005,6,10,1547,5,764,1.0,496.0,496.0,5,783,1.0,515.0,515.0
0.005,17,2,230,1,68,0.0,40.0,40.0,1,162,0.0,134.0,134.0
0.022,6,10,1605,5,388,5.0,120.0,120.0,5,1217,5.0,949.0,949.0
11.11,17,28,4424,14,1995,842.0,270.0,114.0,14,2429,842.0,588.0,145.0
0.006,6,10,1547,5,764,1.0,496.0,496.0,5,783,1.0,515.0,515.0
0.054,6,10,1506,5,395,13.0,127.0,127.0,5,1111,12.0,843.0,843.0
0.003,17,2,148,1,60,0.0,32.0,32.0,1,88,0.0,60.0,60.0
0.012,6,13,3735,7,497,2.0,125.0,125.0,6,3238,2.0,1470.0,1459.0
0.005,17,2,154,1,69,0.0,41.0,41.0,1,85,0.0,57.0,57.0
241.443,6,317,344616,115,17495,2117.0,2736.0,959.0,202,327121,1201.0,2804.0,1649.0
0.008,6,10,1989,5,910,2.0,642.0,642.0,5,1079,2.0,811.0,811.0
0.189,6,10,1506,5,395,43.0,127.0,127.0,5,1111,44.0,843.0,843.0
0.01,6,10,1972,5,910,2.0,642.0,642.0,5,1062,2.0,794.0,794.0
10.813,17,28,4423,14,1994,823.0,269.0,114.0,14,2429,823.0,588.0,145.0
0.005,17,2,170,1,65,0.0,37.0,37.0,1,105,0.0,77.0,77.0
0.091,6,10,1506,5,395,20.0,127.0,127.0,5,1111,19.0,843.0,843.0
15.072,17,15,9238,8,6902,2149.0,1350.0,834.0,7,2336,2507.0,1350.0,305.0
0.009,6,12,1926,6,1189,1.0,659.0,434.0,6,737,1.0,417.0,417.0
0.094,6,10,1506,5,395,16.0,127.0,127.0,5,1111,22.0,843.0,843.0
0.007,17,2,179,1,71,0.0,43.0,43.0,1,108,0.0,80.0,80.0
0.005,6,10,2007,5,928,1.0,660.0,660.0,5,1079,1.0,811.0,811.0
0.054,17,2,144,1,64,0.0,36.0,36.0,1,80,0.0,52.0,52.0
0.005,17,2,170,1,65,0.0,37.0,37.0,1,105,0.0,77.0,77.0
0.004,6,10,1774,5,923,1.0,655.0,655.0,5,851,1.0,583.0,583.0
0.005,6,10,2000,5,927,1.0,659.0,659.0,5,1073,1.0,805.0,805.0
0.009,6,10,1990,5,911,2.0,643.0,643.0,5,1079,2.0,811.0,811.0
0.005,6,10,1989,5,927,1.0,659.0,659.0,5,1062,1.0,794.0,794.0
0.015,6,10,1972,5,910,3.0,642.0,642.0,5,1062,3.0,794.0,794.0
0.011,6,10,1983,5,910,2.0,642.0,642.0,5,1073,2.0,805.0,805.0
240.132,6,16,4481,9,963,30016.0,238.0,166.0,7,3518,40018.0,1402.0,786.0
0.001,17,2,180,1,66,0.0,38.0,38.0,1,114,0.0,86.0,86.0
0.001,17,2,180,1,66,0.0,38.0,38.0,1,114,0.0,86.0,86.0
310.285,17,20,1124,10,716,34461.0,48.0,43.0,10,408,34461.0,20.0,12.0
0.039,17,2,152,1,76,0.0,48.0,48.0,1,76,0.0,48.0,48.0
0.005,17,2,179,1,71,0.0,43.0,43.0,1,108,0.0,80.0,80.0
0.005,6,10,2000,5,927,1.0,659.0,659.0,5,1073,1.0,805.0,805.0
0.168,17,2,152,1,76,0.0,48.0,48.0,1,76,0.0,48.0,48.0
1792.676,6,485,98733,244,87503,7376.0,421.0,368.0,241,11230,7469.0,53.0,53.0
0.097,6,10,1506,5,395,21.0,127.0,127.0,5,1111,23.0,843.0,843.0
0.008,6,10,1972,5,910,1.0,642.0,642.0,5,1062,1.0,794.0,794.0
0.006,6,10,1774,5,923,1.0,655.0,655.0,5,851,1.0,583.0,583.0
0.112,6,10,1506,5,395,26.0,127.0,127.0,5,1111,13.0,843.0,843.0
0.006,6,10,1547,5,764,1.0,496.0,496.0,5,783,1.0,515.0,515.0
0.005,17,2,170,1,65,0.0,37.0,37.0,1,105,0.0,77.0,77.0
0.005,6,14,3736,7,446,0.0,74.0,74.0,7,3290,0.0,1448.0,972.0
0.005,6,10,2007,5,928,1.0,660.0,660.0,5,1079,1.0,811.0,811.0
0.005,17,2,180,1,66,0.0,38.0,38.0,1,114,0.0,86.0,86.0
0.001,17,2,180,1,66,0.0,38.0,38.0,1,114,0.0,86.0,86.0
0.011,6,10,1989,5,910,2.0,642.0,642.0,5,1079,2.0,811.0,811.0
0.012,6,13,3735,7,497,1.0,125.0,125.0,6,3238,2.0,1470.0,1459.0
0.009,6,13,3735,7,497,1.0,125.0,125.0,6,3238,1.0,1470.0,1459.0
0.012,6,10,1990,5,911,3.0,643.0,643.0,5,1079,2.0,811.0,811.0
0.004,6,10,1702,5,863,1.0,595.0,595.0,5,839,1.0,571.0,571.0
0.005,6,13,3690,7,452,0.0,80.0,80.0,6,3238,0.0,1470.0,1459.0
0.037,17,4,420,2,122,0.0,33.0,33.0,2,298,0.0,145.0,121.0
0.166,17,2,152,1,76,0.0,48.0,48.0,1,76,0.0,48.0,48.0
0.004,17,4,284,2,120,0.0,32.0,32.0,2,164,0.0,60.0,54.0
0.004,6,10,1702,5,863,1.0,595.0,595.0,5,839,0.0,571.0,571.0
0.01,6,10,1972,5,910,2.0,642.0,642.0,5,1062,2.0,794.0,794.0
0.006,17,2,166,1,75,0.0,47.0,47.0,1,91,0.0,63.0,63.0
0.001,17,2,136,1,60,0.0,32.0,32.0,1,76,0.0,48.0,48.0
294.027,6,28,9912,15,3203,20999.0,1273.0,483.0,13,6709,24499.0,1402.0,862.0
0.039,17,2,184,1,61,0.0,33.0,33.0,1,123,0.0,95.0,95.0
0.186,6,3,453,2,321,186.0,241.0,241.0,1,132,0.0,92.0,92.0
0.006,6,10,1547,5,764,1.0,496.0,496.0,5,783,1.0,515.0,515.0
9.035,17,6,376,5,280,2258.0,28.0,28.0,1,96,0.0,68.0,68.0
0.005,6,13,3690,7,452,0.0,80.0,80.0,6,3238,1.0,1470.0,1459.0
0.004,6,10,2007,5,928,1.0,660.0,660.0,5,1079,1.0,811.0,811.0
0.003,17,4,284,2,120,0.0,32.0,32.0,2,164,0.0,60.0,54.0
0.042,17,2,412,1,61,0.0,33.0,33.0,1,351,0.0,323.0,323.0
0.085,6,10,1506,5,395,18.0,127.0,127.0,5,1111,17.0,843.0,843.0
0.111,6,10,1506,5,395,24.0,127.0,127.0,5,1111,23.0,843.0,843.0
163.459,17,82,11670,41,2737,4086.0,44.0,38.0,41,8933,4086.0,261.0,189.0
40.058,17,10,676,5,460,10012.0,104.0,64.0,5,216,10013.0,20.0,15.0
0.004,17,2,234,1,61,0.0,33.0,33.0,1,173,0.0,145.0,145.0
0.102,6,10,1506,5,395,20.0,127.0,127.0,5,1111,23.0,843.0,843.0
0.018,6,10,1990,5,911,4.0,643.0,643.0,5,1079,4.0,811.0,811.0
1799.857,6,245,35856,152,26032,11919.0,302.0,302.0,93,9824,19563.0,83.0,83.0
0.016,6,10,1989,5,910,4.0,642.0,642.0,5,1079,4.0,811.0,811.0
0.108,6,10,1506,5,395,23.0,127.0,127.0,5,1111,22.0,843.0,843.0
0.085,6,10,1506,5,395,17.0,127.0,127.0,5,1111,19.0,843.0,843.0
15.076,17,14,9190,8,6902,2149.0,1350.0,834.0,6,2288,3009.0,1350.0,353.0
0.004,6,13,3690,7,452,0.0,80.0,80.0,6,3238,0.0,1470.0,1459.0
0.014,17,2,152,1,56,0.0,28.0,28.0,1,96,0.0,68.0,68.0
0.007,6,10,1774,5,923,1.0,655.0,655.0,5,851,1.0,583.0,583.0
240.096,6,30,9016,15,6719,17149.0,1842.0,660.0,15,2297,17149.0,580.0,188.0
0.138,6,14,4389,8,923,19.0,238.0,166.0,6,3466,20.0,1402.0,786.0
0.005,17,2,179,1,71,0.0,43.0,43.0,1,108,0.0,80.0,80.0
0.001,17,2,180,1,66,0.0,38.0,38.0,1,114,0.0,86.0,86.0
308.606,17,20,1124,10,716,34275.0,48.0,43.0,10,408,34275.0,20.0,12.0
0.068,17,8,3613,4,1874,22.0,1350.0,440.0,4,1739,11.0,1350.0,406.0
0.011,6,10,1989,5,910,2.0,642.0,642.0,5,1079,2.0,811.0,811.0
0.013,6,10,1631,5,848,3.0,580.0,580.0,5,783,3.0,515.0,515.0
0.012,6,10,1762,5,911,2.0,643.0,643.0,5,851,3.0,583.0,583.0
0.007,6,10,1547,5,764,1.0,496.0,496.0,5,783,1.0,515.0,515.0
0.005,6,10,1854,5,889,1.0,621.0,621.0,5,965,1.0,697.0,697.0
0.133,17,2,148,1,60,0.0,32.0,32.0,1,88,0.0,60.0,60.0
0.006,6,10,1547,5,764,1.0,496.0,496.0,5,783,1.0,515.0,515.0
0.017,6,10,1989,5,910,4.0,642.0,642.0,5,1079,4.0,811.0,811.0
11.225,17,28,4421,14,1994,851.0,269.0,114.0,14,2427,851.0,586.0,145.0
0.014,6,10,1983,5,910,3.0,642.0,642.0,5,1073,3.0,805.0,805.0
0.013,6,10,1990,5,911,3.0,643.0,643.0,5,1079,3.0,811.0,811.0
0.005,6,10,1547,5,764,1.0,496.0,496.0,5,783,1.0,515.0,515.0
0.126,17,2,148,1,60,0.0,32.0,32.0,1,88,0.0,60.0,60.0
253.134,6,38,9805,15,6705,18081.0,1829.0,658.0,23,3100,11505.0,580.0,135.0
40.058,17,10,676,5,460,10013.0,104.0,64.0,5,216,10013.0,20.0,15.0
0.006,6,10,1689,5,839,1.0,571.0,571.0,5,850,1.0,582.0,582.0
0.091,6,10,1506,5,395,21.0,127.0,127.0,5,1111,21.0,843.0,843.0
0.038,17,2,136,1,60,0.0,32.0,32.0,1,76,0.0,48.0,48.0
0.694,6,22,5072,11,1250,58.0,325.0,133.0,11,3822,58.0,1414.0,563.0
0.005,6,10,2000,5,927,1.0,659.0,659.0,5,1073,1.0,805.0,805.0
0.062,6,10,1506,5,395,15.0,127.0,127.0,5,1111,13.0,843.0,843.0
0.041,17,2,136,1,60,0.0,32.0,32.0,1,76,0.0,48.0,48.0
0.001,17,2,180,1,66,0.0,38.0,38.0,1,114,0.0,86.0,86.0
0.017,6,10,1983,5,910,4.0,642.0,642.0,5,1073,4.0,805.0,805.0
0.005,6,10,2007,5,928,1.0,660.0,660.0,5,1079,1.0,811.0,811.0
0.005,6,10,2006,5,927,1.0,659.0,659.0,5,1079,1.0,811.0,811.0
0.08,6,10,1506,5,395,19.0,127.0,127.0,5,1111,18.0,843.0,843.0
0.008,6,10,1989,5,910,2.0,642.0,642.0,5,1079,2.0,811.0,811.0
0.005,6,10,1689,5,839,1.0,571.0,571.0,5,850,1.0,582.0,582.0
0.006,6,10,1689,5,839,1.0,571.0,571.0,5,850,1.0,582.0,582.0
0.004,6,10,2006,5,927,1.0,659.0,659.0,5,1079,1.0,811.0,811.0
0.006,17,2,144,1,64,0.0,36.0,36.0,1,80,0.0,52.0,52.0
0.108,6,10,1506,5,395,22.0,127.0,127.0,5,1111,22.0,843.0,843.0
0.014,6,10,1989,5,910,3.0,642.0,642.0,5,1079,3.0,811.0,811.0
0.04,17,4,420,2,122,0.0,33.0,33.0,2,298,36.0,145.0,121.0
0.004,6,10,1779,5,928,1.0,660.0,660.0,5,851,1.0,583.0,583.0
0.008,6,14,3787,7,497,1.0,125.0,125.0,7,3290,1.0,1448.0,972.0
0.007,6,10,2006,5,927,1.0,659.0,659.0,5,1079,1.0,811.0,811.0
0.011,6,10,1989,5,910,2.0,642.0,642.0,5,1079,2.0,811.0,811.0
0.022,6,10,1631,5,848,5.0,580.0,580.0,5,783,5.0,515.0,515.0
0.005,6,10,1643,5,860,1.0,592.0,592.0,5,783,1.0,515.0,515.0
0.004,17,4,284,2,120,0.0,32.0,32.0,2,164,0.0,60.0,54.0
0.003,17,2,136,1,60,0.0,32.0,32.0,1,76,0.0,48.0,48.0
0.019,6,13,3735,7,497,3.0,125.0,125.0,6,3238,3.0,1470.0,1459.0
0.001,17,2,180,1,66,0.0,38.0,38.0,1,114,0.0,86.0,86.0
0.005,17,2,170,1,65,0.0,37.0,37.0,1,105,0.0,77.0,77.0
0.095,6,10,1506,5,395,19.0,127.0,127.0,5,1111,19.0,843.0,843.0
0.009,6,10,1972,5,910,2.0,642.0,642.0,5,1062,2.0,794.0,794.0
0.005,17,2,273,1,66,0.0,38.0,38.0,1,207,0.0,179.0,179.0
0.113,6,10,1506,5,395,20.0,127.0,127.0,5,1111,26.0,843.0,843.0
0.005,6,10,1989,5,927,1.0,659.0,659.0,5,1062,1.0,794.0,794.0
0.066,6,10,1506,5,395,16.0,127.0,127.0,5,1111,11.0,843.0,843.0
0.006,6,10,1779,5,928,1.0,660.0,660.0,5,851,1.0,583.0,583.0
0.006,6,10,1774,5,923,1.0,655.0,655.0,5,851,1.0,583.0,583.0
0.004,17,2,152,1,76,0.0,48.0,48.0,1,76,0.0,48.0,48.0
0.005,6,13,3747,7,509,0.0,137.0,137.0,6,3238,0.0,1470.0,1459.0
0.01,6,13,3735,7,497,1.0,125.0,125.0,6,3238,2.0,1470.0,1459.0
40.055,17,10,676,5,460,10012.0,104.0,64.0,5,216,10012.0,20.0,15.0
0.092,6,10,1506,5,395,22.0,127.0,127.0,5,1111,19.0,843.0,843.0
0.004,17,2,144,1,64,0.0,36.0,36.0,1,80,0.0,52.0,52.0
0.01,6,10,1983,5,910,2.0,642.0,642.0,5,1073,2.0,805.0,805.0
0.005,6,10,1854,5,889,1.0,621.0,621.0,5,965,1.0,697.0,697.0
0.015,6,10,1989,5,910,3.0,642.0,642.0,5,1079,3.0,811.0,811.0
0.005,17,2,179,1,71,0.0,43.0,43.0,1,108,0.0,80.0,80.0
0.074,6,10,1506,5,395,15.0,127.0,127.0,5,1111,17.0,843.0,843.0
58.025,6,36,10067,18,4549,521.0,2084.0,949.0,18,5518,3403.0,2667.0,435.0
0.014,6,10,1990,5,911,3.0,643.0,643.0,5,1079,3.0,811.0,811.0
0.005,6,14,3742,7,452,0.0,80.0,80.0,7,3290,0.0,1448.0,972.0
0.005,6,10,1989,5,927,1.0,659.0,659.0,5,1062,1.0,794.0,794.0
0.009,6,13,3735,7,497,1.0,125.0,125.0,6,3238,1.0,1470.0,1459.0
240.015,6,9,787,5,488,60003.0,232.0,232.0,4,299,80003.0,83.0,83.0
0.003,17,2,148,1,60,0.0,32.0,32.0,1,88,0.0,60.0,60.0
0.004,6,10,2007,5,928,1.0,660.0,660.0,5,1079,1.0,811.0,811.0
0.092,6,10,1506,5,395,21.0,127.0,127.0,5,1111,22.0,843.0,843.0
0.003,17,2,136,1,60,0.0,32.0,32.0,1,76,0.0,48.0,48.0
0.14,6,10,1506,5,395,32.0,127.0,127.0,5,1111,34.0,843.0,843.0
0.005,6,10,2007,5,928,1.0,660.0,660.0,5,1079,1.0,811.0,811.0
0.125,6,10,1506,5,395,28.0,127.0,127.0,5,1111,29.0,843.0,843.0
0.005,6,10,1989,5,927,1.0,659.0,659.0,5,1062,1.0,794.0,794.0
240.137,6,36,27299,19,18041,13340.0,2736.0,1705.0,17,9258,15008.0,2782.0,1195.0
0.001,17,2,166,1,75,0.0,47.0,47.0,1,91,0.0,63.0,63.0
0.001,17,2,174,1,72,0.0,44.0,44.0,1,102,0.0,74.0,74.0
0.018,6,10,1983,5,910,4.0,642.0,642.0,5,1073,4.0,805.0,805.0
241.312,6,313,343179,121,17808,2010.0,2736.0,960.0,192,325371,1263.0,2804.0,1732.0
0.078,6,10,1506,5,395,17.0,127.0,127.0,5,1111,16.0,843.0,843.0
0.005,6,10,2000,5,927,1.0,659.0,659.0,5,1073,1.0,805.0,805.0
0.005,17,2,170,1,65,0.0,37.0,37.0,1,105,0.0,77.0,77.0
0.016,6,10,1990,5,911,4.0,643.0,643.0,5,1079,3.0,811.0,811.0
0.058,6,10,1506,5,395,12.0,127.0,127.0,5,1111,14.0,843.0,843.0
0.014,6,10,1972,5,910,3.0,642.0,642.0,5,1062,3.0,794.0,794.0
0.014,6,10,1989,5,910,3.0,642.0,642.0,5,1079,3.0,811.0,811.0
0.003,17,2,148,1,60,0.0,32.0,32.0,1,88,0.0,60.0,60.0
0.012,6,10,1972,5,910,3.0,642.0,642.0,5,1062,2.0,794.0,794.0
40.067,17,10,676,5,460,10013.0,104.0,64.0,5,216,10016.0,20.0,15.0
0.005,6,10,1989,5,927,1.0,659.0,659.0,5,1062,1.0,794.0,794.0
0.011,6,10,1989,5,910,2.0,642.0,642.0,5,1079,2.0,811.0,811.0
0.004,17,2,136,1,60,0.0,32.0,32.0,1,76,0.0,48.0,48.0
0.011,6,10,1983,5,910,2.0,642.0,642.0,5,1073,2.0,805.0,805.0
0.114,17,2,80,1,32,0.0,4.0,4.0,1,48,0.0,20.0,20.0
0.006,6,10,1643,5,860,1.0,592.0,592.0,5,783,1.0,515.0,515.0
0.004,17,2,184,1,61,0.0,33.0,33.0,1,123,0.0,95.0,95.0
0.004,17,2,148,1,60,0.0,32.0,32.0,1,88,0.0,60.0,60.0
0.011,6,10,1983,5,910,2.0,642.0,642.0,5,1073,2.0,805.0,805.0
0.092,6,10,1506,5,395,20.0,127.0,127.0,5,1111,20.0,843.0,843.0
0.002,17,2,136,1,60,0.0,32.0,32.0,1,76,0.0,48.0,48.0
0.124,6,10,1506,5,395,24.0,127.0,127.0,5,1111,24.0,843.0,843.0
300.383,6,16,2170,9,684,37526.0,146.0,146.0,7,1486,50036.0,419.0,398.0
0.015,6,12,1926,6,1189,3.0,659.0,434.0,6,737,3.0,417.0,417.0
0.013,6,10,1989,5,910,3.0,642.0,642.0,5,1079,3.0,811.0,811.0
0.078,6,10,1506,5,395,16.0,127.0,127.0,5,1111,15.0,843.0,843.0
40.054,17,10,676,5,460,10012.0,104.0,64.0,5,216,10012.0,20.0,15.0
0.074,6,10,1506,5,395,17.0,127.0,127.0,5,1111,16.0,843.0,843.0
0.006,6,10,1547,5,764,1.0,496.0,496.0,5,783,1.0,515.0,515.0
0.104,6,10,1506,5,395,23.0,127.0,127.0,5,1111,22.0,843.0,843.0
0.092,6,10,1506,5,395,21.0,127.0,127.0,5,1111,21.0,843.0,843.0
0.014,6,10,1989,5,910,3.0,642.0,642.0,5,1079,3.0,811.0,811.0
177.497,17,92,13202,46,3093,3944.0,44.0,39.0,46,10109,3944.0,239.0,191.0
0.217,6,16,2777,8,1395,31.0,533.0,323.0,8,1382,19.0,529.0,239.0
175.501,17,78,10863,39,2604,4618.0,44.0,38.0,39,8259,4618.0,239.0,183.0
0.01,6,10,1989,5,910,2.0,642.0,642.0,5,1079,2.0,811.0,811.0
0.039,17,2,184,1,61,0.0,33.0,33.0,1,123,0.0,95.0,95.0
0.111,6,10,1506,5,395,25.0,127.0,127.0,5,1111,25.0,843.0,843.0
0.223,6,16,2668,8,1394,31.0,533.0,323.0,8,1274,20.0,529.0,212.0
40.069,17,10,676,5,460,10016.0,104.0,64.0,5,216,10016.0,20.0,15.0
0.002,17,2,148,1,60,0.0,32.0,32.0,1,88,0.0,60.0,60.0
1.092,6,32,13391,18,5892,64.0,2720.0,854.0,14,7499,70.0,2720.0,769.0
0.005,6,10,2006,5,927,1.0,659.0,659.0,5,1079,1.0,811.0,811.0
0.006,6,10,1547,5,764,1.0,496.0,496.0,5,783,1.0,515.0,515.0
0.124,6,10,1506,5,395,30.0,127.0,127.0,5,1111,26.0,843.0,843.0
0.005,6,10,2006,5,927,1.0,659.0,659.0,5,1079,1.0,811.0,811.0
9.037,17,6,376,5,280,2259.0,28.0,28.0,1,96,0.0,68.0,68.0
0.005,6,10,1854,5,889,1.0,621.0,621.0,5,965,1.0,697.0,697.0
0.007,6,10,1762,5,911,1.0,643.0,643.0,5,851,1.0,583.0,583.0
0.005,6,10,1989,5,927,1.0,659.0,659.0,5,1062,1.0,794.0,794.0
0.007,6,10,2000,5,927,1.0,659.0,659.0,5,1073,1.0,805.0,805.0
0.005,6,10,2006,5,927,1.0,659.0,659.0,5,1079,1.0,811.0,811.0
0.072,6,10,1506,5,395,15.0,127.0,127.0,5,1111,17.0,843.0,843.0
0.005,6,10,1989,5,927,1.0,659.0,659.0,5,1062,1.0,794.0,794.0
0.014,6,10,1990,5,911,3.0,643.0,643.0,5,1079,3.0,811.0,811.0
368.804,6,22,2313,16,867,24586.0,195.0,195.0,6,1446,4638.0,419.0,398.0
0.015,6,10,1631,5,848,3.0,580.0,580.0,5,783,3.0,515.0,515.0
201.683,6,299,246276,164,232872,1236.0,2720.0,1676.0,135,13404,1503.0,2667.0,204.0
0.207,6,16,2671,8,1397,29.0,533.0,324.0,8,1274,18.0,529.0,212.0
15.033,17,45,21864,25,18584,625.0,1350.0,715.0,20,3280,789.0,1350.0,136.0
0.004,6,10,2006,5,927,1.0,659.0,659.0,5,1079,1.0,811.0,811.0
0.018,6,10,1983,5,910,4.0,642.0,642.0,5,1073,4.0,805.0,805.0
0.024,6,8,832,4,522,7.0,302.0,302.0,4,310,7.0,102.0,102.0
0.139,6,10,1506,5,395,32.0,127.0,127.0,5,1111,33.0,843.0,843.0
0.004,6,10,2007,5,928,1.0,660.0,660.0,5,1079,1.0,811.0,811.0
0.011,6,14,3787,7,497,1.0,125.0,125.0,7,3290,1.0,1448.0,972.0
0.099,6,10,1506,5,395,23.0,127.0,127.0,5,1111,23.0,843.0,843.0
0.041,17,2,148,1,60,0.0,32.0,32.0,1,88,0.0,60.0,60.0
0.007,6,10,1989,5,910,1.0,642.0,642.0,5,1079,1.0,811.0,811.0
0.003,17,2,136,1,60,0.0,32.0,32.0,1,76,0.0,48.0,48.0
0.005,6,13,3747,7,509,0.0,137.0,137.0,6,3238,0.0,1470.0,1459.0
0.09,6,10,1506,5,395,20.0,127.0,127.0,5,1111,17.0,843.0,843.0
0.006,6,10,1547,5,764,1.0,496.0,496.0,5,783,1.0,515.0,515.0
0.077,6,10,1506,5,395,15.0,127.0,127.0,5,1111,17.0,843.0,843.0
0.003,17,2,136,1,60,0.0,32.0,32.0,1,76,0.0,48.0,48.0
0.005,17,2,179,1,71,0.0,43.0,43.0,1,108,0.0,80.0,80.0
0.008,6,12,1926,6,1189,1.0,659.0,434.0,6,737,1.0,417.0,417.0
0.008,17,2,170,1,65,0.0,37.0,37.0,1,105,0.0,77.0,77.0
0.003,17,2,162,1,65,0.0,37.0,37.0,1,97,0.0,69.0,69.0
312.333,17,20,1124,10,716,34692.0,48.0,43.0,10,408,34691.0,20.0,12.0
0.004,6,10,1702,5,863,1.0,595.0,595.0,5,839,0.0,571.0,571.0
40.088,17,10,676,5,460,10021.0,104.0,64.0,5,216,10021.0,20.0,15.0
0.005,6,10,2007,5,928,1.0,660.0,660.0,5,1079,1.0,811.0,811.0
0.063,6,10,1506,5,395,14.0,127.0,127.0,5,1111,14.0,843.0,843.0
0.043,17,2,148,1,60,0.0,32.0,32.0,1,88,0.0,60.0,60.0
0.015,6,10,1983,5,910,3.0,642.0,642.0,5,1073,3.0,805.0,805.0
0.005,6,10,2006,5,927,1.0,659.0,659.0,5,1079,1.0,811.0,811.0
15.076,17,15,9238,8,6902,2149.0,1350.0,834.0,7,2336,2507.0,1350.0,305.0
178.02,17,94,13700,47,3164,3869.0,44.0,39.0,47,10536,3869.0,261.0,196.0
0.005,17,2,168,1,76,0.0,48.0,48.0,1,92,0.0,64.0,64.0
40.063,17,10,676,5,460,10012.0,104.0,64.0,5,216,10014.0,20.0,15.0
0.005,6,10,2000,5,927,1.0,659.0,659.0,5,1073,1.0,805.0,805.0
243.342,6,310,344076,118,17657,2079.0,2736.0,960.0,192,326419,1274.0,2804.0,1738.0
0.037,17,2,184,1,61,0.0,33.0,33.0,1,123,0.0,95.0,95.0
0.098,6,10,1506,5,395,21.0,127.0,127.0,5,1111,21.0,843.0,843.0
1786.275,6,150,19350,90,13740,20070.0,302.0,302.0,60,5610,30275.0,83.0,83.0
0.006,6,10,1547,5,764,1.0,496.0,496.0,5,783,1.0,515.0,515.0
40.072,17,10,676,5,460,10016.0,104.0,64.0,5,216,10015.0,20.0,15.0
0.006,6,10,1547,5,764,1.0,496.0,496.0,5,783,1.0,515.0,515.0
0.004,17,2,162,1,65,0.0,37.0,37.0,1,97,0.0,69.0,69.0
0.001,17,2,136,1,60,0.0,32.0,32.0,1,76,0.0,48.0,48.0
0.006,6,10,1774,5,923,1.0,655.0,655.0,5,851,1.0,583.0,583.0
40.065,17,10,676,5,460,10015.0,104.0,64.0,5,216,10015.0,20.0,15.0
0.009,6,10,1989,5,910,2.0,642.0,642.0,5,1079,2.0,811.0,811.0
0.011,6,10,1631,5,848,2.0,580.0,580.0,5,783,2.0,515.0,515.0
0.005,6,14,3799,7,509,0.0,137.0,137.0,7,3290,0.0,1448.0,972.0
0.001,17,2,180,1,66,0.0,38.0,38.0,1,114,0.0,86.0,86.0
0.021,6,10,1972,5,910,5.0,642.0,642.0,5,1062,5.0,794.0,794.0
0.077,6,10,1506,5,395,16.0,127.0,127.0,5,1111,16.0,843.0,843.0
0.142,6,10,1506,5,395,34.0,127.0,127.0,5,1111,30.0,843.0,843.0
0.127,6,10,1506,5,395,28.0,127.0,127.0,5,1111,25.0,843.0,843.0
0.005,6,10,2006,5,927,1.0,659.0,659.0,5,1079,1.0,811.0,811.0
0.021,6,10,1989,5,910,5.0,642.0,642.0,5,1079,5.0,811.0,811.0
0.007,6,10,1779,5,928,1.0,660.0,660.0,5,851,1.0,583.0,583.0
0.007,6,10,2007,5,928,1.0,660.0,660.0,5,1079,1.0,811.0,811.0
0.005,17,2,148,1,60,0.0,32.0,32.0,1,88,0.0,60.0,60.0
0.008,17,2,194,1,59,0.0,31.0,31.0,1,135,0.0,107.0,107.0
0.004,17,2,148,1,60,0.0,32.0,32.0,1,88,0.0,60.0,60.0
0.01,6,10,1972,5,910,2.0,642.0,642.0,5,1062,2.0,794.0,794.0
0.012,6,10,1990,5,911,3.0,643.0,643.0,5,1079,2.0,811.0,811.0
0.004,6,10,2007,5,928,1.0,660.0,660.0,5,1079,1.0,811.0,811.0
0.125,6,10,1506,5,395,28.0,127.0,127.0,5,1111,27.0,843.0,843.0
0.104,6,10,1506,5,395,17.0,127.0,127.0,5,1111,25.0,843.0,843.0
0.039,17,2,412,1,61,0.0,33.0,33.0,1,351,0.0,323.0,323.0
0.094,6,10,1506,5,395,20.0,127.0,127.0,5,1111,19.0,843.0,843.0
0.005,6,10,1989,5,927,1.0,659.0,659.0,5,1062,1.0,794.0,794.0
0.091,6,10,1506,5,395,19.0,127.0,127.0,5,1111,19.0,843.0,843.0
15.218,17,17,8479,9,6421,1898.0,1350.0,685.0,8,2058,2170.0,1350.0,229.0
10.737,17,28,4421,14,1994,817.0,269.0,114.0,14,2427,817.0,586.0,145.0
0.013,6,10,1762,5,911,3.0,643.0,643.0,5,851,3.0,583.0,583.0
0.113,6,10,1506,5,395,25.0,127.0,127.0,5,1111,25.0,843.0,843.0
0.006,6,10,2006,5,927,1.0,659.0,659.0,5,1079,1.0,811.0,811.0
0.004,6,10,1774,5,923,1.0,655.0,655.0,5,851,1.0,583.0,583.0
0.005,6,10,2007,5,928,1.0,660.0,660.0,5,1079,1.0,811.0,811.0
0.069,6,10,1506,5,395,15.0,127.0,127.0,5,1111,15.0,843.0,843.0
0.083,6,10,1506,5,395,18.0,127.0,127.0,5,1111,19.0,843.0,843.0
0.005,6,10,2006,5,927,1.0,659.0,659.0,5,1079,1.0,811.0,811.0
0.008,6,10,1990,5,911,2.0,643.0,643.0,5,1079,1.0,811.0,811.0
0.006,17,2,179,1,71,0.0,43.0,43.0,1,108,0.0,80.0,80.0
308.697,17,20,1124,10,716,34285.0,48.0,43.0,10,408,34285.0,20.0,12.0
0.006,6,10,1547,5,764,1.0,496.0,496.0,5,783,1.0,515.0,515.0
0.005,6,10,1989,5,927,1.0,659.0,659.0,5,1062,1.0,794.0,794.0
67.782,6,37,10002,19,4484,498.0,1360.0,738.0,18,5518,3977.0,2667.0,435.0
0.07,6,10,1506,5,395,15.0,127.0,127.0,5,1111,16.0,843.0,843.0
240.159,6,48,7229,23,3309,10916.0,588.0,210.0,25,3920,10006.0,580.0,237.0
0.005,6,10,1643,5,860,1.0,592.0,592.0,5,783,1.0,515.0,515.0
0.004,6,10,2006,5,927,1.0,659.0,659.0,5,1079,1.0,811.0,811.0
0.004,17,2,148,1,60,0.0,32.0,32.0,1,88,0.0,60.0,60.0
0.008,6,13,3735,7,497,1.0,125.0,125.0,6,3238,1.0,1470.0,1459.0
0.006,6,10,1547,5,764,1.0,496.0,496.0,5,783,1.0,515.0,515.0
0.086,6,10,1506,5,395,15.0,127.0,127.0,5,1111,20.0,843.0,843.0
0.006,17,2,170,1,65,0.0,37.0,37.0,1,105,0.0,77.0,77.0
0.006,6,11,2041,6,979,1.0,659.0,659.0,5,1062,1.0,794.0,794.0
0.011,17,2,209,1,64,0.0,36.0,36.0,1,145,0.0,117.0,117.0
0.062,6,10,1506,5,395,15.0,127.0,127.0,5,1111,15.0,843.0,843.0
0.258,17,2,152,1,76,0.0,48.0,48.0,1,76,0.0,48.0,48.0
0.005,6,10,2006,5,927,1.0,659.0,659.0,5,1079,1.0,811.0,811.0
0.001,17,2,166,1,75,0.0,47.0,47.0,1,91,0.0,63.0,63.0
0.001,17,2,136,1,60,0.0,32.0,32.0,1,76,0.0,48.0,48.0
0.008,6,10,1762,5,911,2.0,643.0,643.0,5,851,1.0,583.0,583.0
0.107,6,10,1506,5,395,21.0,127.0,127.0,5,1111,23.0,843.0,843.0
0.019,6,10,1990,5,911,4.0,643.0,643.0,5,1079,4.0,811.0,811.0
0.004,6,10,2007,5,928,1.0,660.0,660.0,5,1079,1.0,811.0,811.0
0.005,6,10,2000,5,927,1.0,659.0,659.0,5,1073,1.0,805.0,805.0
0.118,6,10,1506,5,395,28.0,127.0,127.0,5,1111,23.0,843.0,843.0
0.006,17,2,164,1,74,0.0,46.0,46.0,1,90,0.0,62.0,62.0
0.016,6,10,1631,5,848,4.0,580.0,580.0,5,783,3.0,515.0,515.0
0.077,6,10,1506,5,395,14.0,127.0,127.0,5,1111,16.0,843.0,843.0
0.01,6,10,1989,5,910,2.0,642.0,642.0,5,1079,2.0,811.0,811.0
0.011,6,10,1983,5,910,2.0,642.0,642.0,5,1073,2.0,805.0,805.0
0.015,6,10,1989,5,910,3.0,642.0,642.0,5,1079,3.0,811.0,811.0
0.005,6,10,1989,5,927,1.0,659.0,659.0,5,1062,1.0,794.0,794.0
0.005,6,10,2000,5,927,1.0,659.0,659.0,5,1073,1.0,805.0,805.0
0.106,6,10,1506,5,395,24.0,127.0,127.0,5,1111,23.0,843.0,843.0
0.003,17,2,136,1,60,0.0,32.0,32.0,1,76,0.0,48.0,48.0
0.021,6,10,1631,5,848,5.0,580.0,580.0,5,783,5.0,515.0,515.0
0.093,6,10,1506,5,395,21.0,127.0,127.0,5,1111,20.0,843.0,843.0
0.009,17,2,338,1,74,0.0,46.0,46.0,1,264,0.0,236.0,236.0
40.055,17,10,676,5,460,10012.0,104.0,64.0,5,216,10012.0,20.0,15.0
0.026,6,10,1989,5,910,6.0,642.0,642.0,5,1079,6.0,811.0,811.0
0.005,6,10,2006,5,927,1.0,659.0,659.0,5,1079,1.0,811.0,811.0
0.086,6,10,1506,5,395,19.0,127.0,127.0,5,1111,20.0,843.0,843.0
0.005,17,2,144,1,64,0.0,36.0,36.0,1,80,0.0,52.0,52.0
0.012,6,10,1983,5,910,3.0,642.0,642.0,5,1073,2.0,805.0,805.0
0.005,6,10,1689,5,839,1.0,571.0,571.0,5,850,1.0,582.0,582.0
0.069,17,8,3613,4,1874,23.0,1350.0,440.0,4,1739,12.0,1350.0,406.0
0.01,6,10,1989,5,910,2.0,642.0,642.0,5,1079,2.0,811.0,811.0
0.164,6,10,1506,5,395,38.0,127.0,127.0,5,1111,39.0,843.0,843.0
368.679,6,22,2313,16,867,24578.0,195.0,195.0,6,1446,4641.0,419.0,398.0
0.005,17,2,170,1,65,0.0,37.0,37.0,1,105,0.0,77.0,77.0
0.006,6,10,1854,5,889,1.0,621.0,621.0,5,965,1.0,697.0,697.0
0.002,17,2,136,1,60,0.0,32.0,32.0,1,76,0.0,48.0,48.0
0.004,17,2,148,1,60,0.0,32.0,32.0,1,88,0.0,60.0,60.0
0.111,6,10,1506,5,395,24.0,127.0,127.0,5,1111,25.0,843.0,843.0
0.005,6,10,2006,5,927,1.0,659.0,659.0,5,1079,1.0,811.0,811.0
240.211,6,64,55036,34,3283,7279.0,1226.0,498.0,30,51753,8283.0,2804.0,1930.0
0.004,6,10,1702,5,863,0.0,595.0,595.0,5,839,1.0,571.0,571.0
0.005,6,10,1989,5,927,1.0,659.0,659.0,5,1062,1.0,794.0,794.0
0.069,17,8,3613,4,1874,23.0,1350.0,440.0,4,1739,11.0,1350.0,406.0
0.019,6,10,1989,5,910,4.0,642.0,642.0,5,1079,4.0,811.0,811.0
40.061,17,10,676,5,460,10014.0,104.0,64.0,5,216,10014.0,20.0,15.0
0.041,17,4,284,2,120,0.0,32.0,32.0,2,164,38.0,60.0,54.0
0.006,6,10,1643,5,860,1.0,592.0,592.0,5,783,1.0,515.0,515.0
0.005,6,13,3747,7,509,0.0,137.0,137.0,6,3238,0.0,1470.0,1459.0
0.073,6,10,1506,5,395,16.0,127.0,127.0,5,1111,16.0,843.0,843.0
0.021,6,10,1989,5,910,5.0,642.0,642.0,5,1079,5.0,811.0,811.0
40.066,17,10,676,5,460,10015.0,104.0,64.0,5,216,10015.0,20.0,15.0
0.009,6,10,1990,5,911,2.0,643.0,643.0,5,1079,2.0,811.0,811.0
0.01,6,10,1677,5,827,2.0,559.0,559.0,5,850,2.0,582.0,582.0
0.012,6,10,1983,5,910,3.0,642.0,642.0,5,1073,3.0,805.0,805.0
0.001,17,2,180,1,66,0.0,38.0,38.0,1,114,0.0,86.0,86.0
0.106,6,10,1506,5,395,21.0,127.0,127.0,5,1111,23.0,843.0,843.0
0.006,6,10,1547,5,764,1.0,496.0,496.0,5,783,1.0,515.0,515.0
0.006,6,10,1547,5,764,1.0,496.0,496.0,5,783,1.0,515.0,515.0
0.004,17,2,148,1,60,0.0,32.0,32.0,1,88,0.0,60.0,60.0
0.02,6,10,1983,5,910,5.0,642.0,642.0,5,1073,5.0,805.0,805.0
0.04,17,2,136,1,60,0.0,32.0,32.0,1,76,0.0,48.0,48.0
0.005,6,10,1989,5,927,1.0,659.0,659.0,5,1062,1.0,794.0,794.0
40.072,17,10,676,5,460,10015.0,104.0,64.0,5,216,10017.0,20.0,15.0
0.103,6,10,1506,5,395,20.0,127.0,127.0,5,1111,24.0,843.0,843.0
15.071,17,15,9239,8,6902,2149.0,1350.0,834.0,7,2337,2507.0,1350.0,305.0
0.014,6,10,1972,5,910,3.0,642.0,642.0,5,1062,3.0,794.0,794.0
0.094,6,10,1506,5,395,19.0,127.0,127.0,5,1111,22.0,843.0,843.0
0.005,17,2,144,1,64,0.0,36.0,36.0,1,80,0.0,52.0,52.0
40.056,17,10,676,5,460,10013.0,104.0,64.0,5,216,10013.0,20.0,15.0
0.001,17,2,180,1,66,0.0,38.0,38.0,1,114,0.0,86.0,86.0
0.013,6,10,1989,5,910,3.0,642.0,642.0,5,1079,3.0,811.0,811.0
0.008,6,10,1990,5,911,2.0,643.0,643.0,5,1079,2.0,811.0,811.0
0.009,6,10,1989,5,910,2.0,642.0,642.0,5,1079,2.0,811.0,811.0
0.008,6,14,3787,7,497,1.0,125.0,125.0,7,3290,1.0,1448.0,972.0
0.01,6,10,1677,5,827,2.0,559.0,559.0,5,850,2.0,582.0,582.0
0.003,17,2,132,1,58,0.0,30.0,30.0,1,74,0.0,46.0,46.0
0.001,17,2,180,1,66,0.0,38.0,38.0,1,114,0.0,86.0,86.0
0.005,17,2,212,1,74,0.0,46.0,46.0,1,138,0.0,110.0,110.0
0.014,6,10,1983,5,910,3.0,642.0,642.0,5,1073,3.0,805.0,805.0
0.006,6,13,3747,7,509,0.0,137.0,137.0,6,3238,1.0,1470.0,1459.0
0.005,17,2,169,1,62,0.0,34.0,34.0,1,107,0.0,79.0,79.0
0.011,6,10,1677,5,827,2.0,559.0,559.0,5,850,2.0,582.0,582.0
0.013,6,10,1983,5,910,3.0,642.0,642.0,5,1073,3.0,805.0,805.0
0.004,6,13,3747,7,509,0.0,137.0,137.0,6,3238,0.0,1470.0,1459.0
0.006,6,10,1547,5,764,1.0,496.0,496.0,5,783,1.0,515.0,515.0
361.801,6,19,1689,15,978,25842.0,190.0,190.0,4,711,80014.0,495.0,495.0
0.077,6,10,1506,5,395,16.0,127.0,127.0,5,1111,17.0,843.0,843.0
0.006,6,10,1689,5,839,1.0,571.0,571.0,5,850,1.0,582.0,582.0
0.006,6,10,1547,5,764,1.0,496.0,496.0,5,783,1.0,515.0,515.0
0.061,6,10,1506,5,395,14.0,127.0,127.0,5,1111,14.0,843.0,843.0
0.009,6,10,1990,5,911,2.0,643.0,643.0,5,1079,2.0,811.0,811.0
0.007,6,10,1547,5,764,1.0,496.0,496.0,5,783,1.0,515.0,515.0
0.01,17,2,166,1,75,0.0,47.0,47.0,1,91,0.0,63.0,63.0
0.002,17,2,180,1,66,0.0,38.0,38.0,1,114,0.0,86.0,86.0
241.162,6,394,347914,191,21458,1269.0,2736.0,959.0,203,326456,1193.0,2804.0,1636.0
0.073,17,4,336,2,124,0.0,34.0,34.0,2,212,32.0,84.0,78.0
240.454,6,37,15024,18,7911,14144.0,1717.0,997.0,19,7113,13358.0,1655.0,764.0
0.068,6,10,1506,5,395,15.0,127.0,127.0,5,1111,12.0,843.0,843.0
0.09,6,10,1506,5,395,19.0,127.0,127.0,5,1111,20.0,843.0,843.0
240.015,6,9,787,5,488,60003.0,232.0,232.0,4,299,80004.0,83.0,83.0
0.013,6,10,1762,5,911,3.0,643.0,643.0,5,851,3.0,583.0,583.0
0.074,6,10,1506,5,395,17.0,127.0,127.0,5,1111,18.0,843.0,843.0
240.014,6,9,787,5,488,60003.0,232.0,232.0,4,299,80004.0,83.0,83.0
11.26,17,28,4418,14,1994,853.0,269.0,114.0,14,2424,853.0,587.0,145.0
0.007,17,4,284,2,120,1.0,32.0,32.0,2,164,0.0,60.0,54.0
0.005,17,2,214,1,75,0.0,47.0,47.0,1,139,0.0,111.0,111.0
0.017,6,10,1990,5,911,4.0,643.0,643.0,5,1079,4.0,811.0,811.0
0.076,6,10,1506,5,395,16.0,127.0,127.0,5,1111,18.0,843.0,843.0
0.007,6,10,2000,5,927,1.0,659.0,659.0,5,1073,1.0,805.0,805.0
0.127,6,10,1506,5,395,27.0,127.0,127.0,5,1111,29.0,843.0,843.0
0.013,6,10,1972,5,910,3.0,642.0,642.0,5,1062,3.0,794.0,794.0
0.005,6,10,2006,5,927,1.0,659.0,659.0,5,1079,1.0,811.0,811.0
0.006,6,10,1689,5,839,1.0,571.0,571.0,5,850,1.0,582.0,582.0
0.006,6,10,1547,5,764,1.0,496.0,496.0,5,783,1.0,515.0,515.0
0.011,6,10,1990,5,911,2.0,643.0,643.0,5,1079,2.0,811.0,811.0
0.019,6,10,1989,5,910,4.0,642.0,642.0,5,1079,4.0,811.0,811.0
0.107,6,10,1506,5,395,24.0,127.0,127.0,5,1111,23.0,843.0,843.0
0.021,6,10,1972,5,910,5.0,642.0,642.0,5,1062,5.0,794.0,794.0
0.012,6,10,1983,5,910,2.0,642.0,642.0,5,1073,2.0,805.0,805.0
0.006,6,10,1547,5,764,1.0,496.0,496.0,5,783,1.0,515.0,515.0
0.011,6,10,1990,5,911,2.0,643.0,643.0,5,1079,2.0,811.0,811.0
328.446,17,20,1124,10,716,36487.0,48.0,43.0,10,408,36487.0,20.0,12.0
0.044,17,2,170,1,65,0.0,37.0,37.0,1,105,0.0,77.0,77.0
0.088,6,10,1506,5,395,18.0,127.0,127.0,5,1111,21.0,843.0,843.0
0.005,6,10,1989,5,927,1.0,659.0,659.0,5,1062,1.0,794.0,794.0
0.016,6,10,1989,5,910,3.0,642.0,642.0,5,1079,3.0,811.0,811.0
354.012,6,21,1795,16,1030,23600.0,190.0,190.0,5,765,60005.0,464.0,248.0
40.058,17,10,676,5,460,10013.0,104.0,64.0,5,216,10013.0,20.0,15.0
0.005,6,10,2007,5,928,1.0,660.0,660.0,5,1079,1.0,811.0,811.0
0.066,17,8,3613,4,1874,22.0,1350.0,440.0,4,1739,10.0,1350.0,406.0
0.009,6,10,1989,5,910,2.0,642.0,642.0,5,1079,2.0,811.0,811.0
0.005,6,10,1547,5,764,1.0,496.0,496.0,5,783,1.0,515.0,515.0
0.004,6,10,1989,5,927,1.0,659.0,659.0,5,1062,1.0,794.0,794.0
10.793,17,28,4424,14,1995,821.0,270.0,114.0,14,2429,821.0,588.0,145.0
0.005,6,10,1689,5,839,1.0,571.0,571.0,5,850,1.0,582.0,582.0
0.09,6,10,1506,5,395,20.0,127.0,127.0,5,1111,16.0,843.0,843.0
0.128,6,10,1506,5,395,26.0,127.0,127.0,5,1111,27.0,843.0,843.0
0.006,6,10,1547,5,764,1.0,496.0,496.0,5,783,1.0,515.0,515.0
10.794,17,28,4422,14,1994,821.0,269.0,114.0,14,2428,821.0,587.0,145.0
0.004,17,2,148,1,60,0.0,32.0,32.0,1,88,0.0,60.0,60.0
0.134,17,2,80,1,32,0.0,4.0,4.0,1,48,0.0,20.0,20.0
0.066,6,10,1506,5,395,15.0,127.0,127.0,5,1111,15.0,843.0,843.0
1791.473,6,483,98653,242,87423,7433.0,421.0,368.0,241,11230,7464.0,53.0,53.0
0.007,17,2,136,1,60,0.0,32.0,32.0,1,76,0.0,48.0,48.0
300.371,6,16,2170,9,684,37526.0,146.0,146.0,7,1486,50034.0,419.0,398.0
0.005,17,4,284,2,120,1.0,32.0,32.0,2,164,0.0,60.0,54.0
0.013,6,10,1989,5,910,3.0,642.0,642.0,5,1079,3.0,811.0,811.0
0.009,6,13,3735,7,497,1.0,125.0,125.0,6,3238,1.0,1470.0,1459.0
0.011,6,10,1972,5,910,2.0,642.0,642.0,5,1062,2.0,794.0,794.0
0.005,17,2,170,1,65,0.0,37.0,37.0,1,105,0.0,77.0,77.0
0.01,6,10,1990,5,911,2.0,643.0,643.0,5,1079,2.0,811.0,811.0
0.005,6,10,1779,5,928,1.0,660.0,660.0,5,851,1.0,583.0,583.0
413.669,6,29,4409,12,3102,10912.0,494.0,494.0,17,1307,25854.0,83.0,83.0
0.004,17,2,186,1,61,0.0,33.0,33.0,1,125,0.0,97.0,97.0
0.095,6,10,1506,5,395,21.0,127.0,127.0,5,1111,22.0,843.0,843.0
0.019,6,10,1631,5,848,4.0,580.0,580.0,5,783,4.0,515.0,515.0
0.005,6,10,2006,5,927,1.0,659.0,659.0,5,1079,1.0,811.0,811.0
40.063,17,10,676,5,460,10015.0,104.0,64.0,5,216,10015.0,20.0,15.0
40.083,17,10,676,5,460,10016.0,104.0,64.0,5,216,10017.0,20.0,15.0
0.003,17,2,136,1,60,0.0,32.0,32.0,1,76,0.0,48.0,48.0
0.003,17,4,284,2,120,0.0,32.0,32.0,2,164,0.0,60.0,54.0
0.096,6,10,1506,5,395,22.0,127.0,127.0,5,1111,20.0,843.0,843.0
0.001,17,2,180,1,65,0.0,37.0,37.0,1,115,0.0,87.0,87.0
240.221,6,16,4480,9,963,30027.0,238.0,166.0,7,3517,40030.0,1402.0,786.0
0.004,17,2,148,1,60,0.0,32.0,32.0,1,88,0.0,60.0,60.0
0.071,17,2,148,1,60,0.0,32.0,32.0,1,88,0.0,60.0,60.0
0.008,6,10,1972,5,910,1.0,642.0,642.0,5,1062,2.0,794.0,794.0
0.017,6,10,1989,5,910,4.0,642.0,642.0,5,1079,4.0,811.0,811.0
0.004,6,10,1702,5,863,1.0,595.0,595.0,5,839,1.0,571.0,571.0
0.002,17,2,136,1,60,0.0,32.0,32.0,1,76,0.0,48.0,48.0
40.054,17,10,676,5,460,10012.0,104.0,64.0,5,216,10012.0,20.0,15.0
0.02,6,10,1677,5,827,5.0,559.0,559.0,5,850,5.0,582.0,582.0
35.236,6,37,8230,19,1759,510.0,651.0,322.0,18,6471,2065.0,2720.0,478.0
0.007,6,10,1779,5,928,1.0,660.0,660.0,5,851,1.0,583.0,583.0
0.005,6,10,2006,5,927,1.0,659.0,659.0,5,1079,1.0,811.0,811.0
0.005,6,10,2006,5,927,1.0,659.0,659.0,5,1079,1.0,811.0,811.0
40.074,17,10,676,5,460,10017.0,104.0,64.0,5,216,10017.0,20.0,15.0
0.102,6,10,1506,5,395,22.0,127.0,127.0,5,1111,22.0,843.0,843.0
15.072,17,14,9190,8,6902,2149.0,1350.0,834.0,6,2288,3008.0,1350.0,353.0
0.003,17,2,136,1,60,0.0,32.0,32.0,1,76,0.0,48.0,48.0
0.009,6,10,1989,5,910,2.0,642.0,642.0,5,1079,2.0,811.0,811.0
0.004,17,4,284,2,120,1.0,32.0,32.0,2,164,0.0,60.0,54.0
0.014,6,10,1989,5,910,3.0,642.0,642.0,5,1079,3.0,811.0,811.0
0.11,6,10,1506,5,395,22.0,127.0,127.0,5,1111,25.0,843.0,843.0
0.004,17,2,148,1,60,0.0,32.0,32.0,1,88,0.0,60.0,60.0
0.148,6,10,1506,5,395,35.0,127.0,127.0,5,1111,22.0,843.0,843.0
0.008,6,10,1989,5,910,2.0,642.0,642.0,5,1079,2.0,811.0,811.0
0.005,17,2,164,1,74,0.0,46.0,46.0,1,90,0.0,62.0,62.0
0.018,6,10,1983,5,910,4.0,642.0,642.0,5,1073,4.0,805.0,805.0
40.063,17,10,676,5,460,10014.0,104.0,64.0,5,216,10014.0,20.0,15.0
0.102,6,10,1506,5,395,24.0,127.0,127.0,5,1111,18.0,843.0,843.0
0.096,6,10,1506,5,395,22.0,127.0,127.0,5,1111,21.0,843.0,843.0
0.011,6,10,1762,5,911,2.0,643.0,643.0,5,851,2.0,583.0,583.0
0.087,6,10,1506,5,395,20.0,127.0,127.0,5,1111,16.0,843.0,843.0
0.041,6,19,9922,11,704,4.0,124.0,124.0,8,9218,5.0,2896.0,2198.0
0.017,17,2,198,1,91,0.0,63.0,63.0,1,107,0.0,79.0,79.0
0.008,6,10,1762,5,911,2.0,643.0,643.0,5,851,2.0,583.0,583.0
0.008,6,10,1547,5,764,1.0,496.0,496.0,5,783,1.0,515.0,515.0
10.747,17,28,4420,14,1993,818.0,268.0,114.0,14,2427,818.0,586.0,145.0
0.008,6,10,1989,5,910,1.0,642.0,642.0,5,1079,2.0,811.0,811.0
0.005,6,10,2006,5,927,1.0,659.0,659.0,5,1079,1.0,811.0,811.0
0.02,6,10,1990,5,911,5.0,643.0,643.0,5,1079,4.0,811.0,811.0
0.739,6,22,5072,11,1250,63.0,325.0,133.0,11,3822,63.0,1414.0,563.0
0.011,6,10,1989,5,910,2.0,642.0,642.0,5,1079,2.0,811.0,811.0
0.116,6,10,1506,5,395,23.0,127.0,127.0,5,1111,24.0,843.0,843.0
15.074,17,15,9238,8,6902,2149.0,1350.0,834.0,7,2336,2507.0,1350.0,305.0
0.009,6,10,1989,5,910,2.0,642.0,642.0,5,1079,2.0,811.0,811.0
0.006,6,10,1547,5,764,1.0,496.0,496.0,5,783,1.0,515.0,515.0
0.004,6,14,3742,8,504,0.0,80.0,80.0,6,3238,0.0,1470.0,1459.0
0.004,6,10,2007,5,928,1.0,660.0,660.0,5,1079,1.0,811.0,811.0
0.003,17,2,148,1,60,0.0,32.0,32.0,1,88,0.0,60.0,60.0
0.004,6,10,2007,5,928,1.0,660.0,660.0,5,1079,1.0,811.0,811.0
0.011,6,10,1990,5,911,2.0,643.0,643.0,5,1079,2.0,811.0,811.0
0.018,6,10,1989,5,910,4.0,642.0,642.0,5,1079,4.0,811.0,811.0
0.263,17,13,9140,7,6851,43.0,1350.0,950.0,6,2289,46.0,1350.0,353.0
0.005,6,10,1702,5,863,1.0,595.0,595.0,5,839,1.0,571.0,571.0
0.081,17,2,184,1,61,0.0,33.0,33.0,1,123,0.0,95.0,95.0
0.014,6,10,1972,5,910,3.0,642.0,642.0,5,1062,3.0,794.0,794.0
0.007,17,2,136,1,60,0.0,32.0,32.0,1,76,0.0,48.0,48.0
0.005,6,10,2007,5,928,1.0,660.0,660.0,5,1079,1.0,811.0,811.0
0.079,6,10,1506,5,395,17.0,127.0,127.0,5,1111,18.0,843.0,843.0
0.079,6,10,1506,5,395,17.0,127.0,127.0,5,1111,17.0,843.0,843.0
0.009,6,10,1972,5,910,2.0,642.0,642.0,5,1062,2.0,794.0,794.0
0.01,6,13,3735,7,497,1.0,125.0,125.0,6,3238,2.0,1470.0,1459.0
0.001,17,2,180,1,66,0.0,38.0,38.0,1,114,0.0,86.0,86.0
0.085,6,10,1506,5,395,18.0,127.0,127.0,5,1111,18.0,843.0,843.0
0.068,17,8,3613,4,1874,22.0,1350.0,440.0,4,1739,11.0,1350.0,406.0
0.009,6,10,1983,5,910,2.0,642.0,642.0,5,1073,2.0,805.0,805.0
0.006,6,10,1547,5,764,1.0,496.0,496.0,5,783,1.0,515.0,515.0
0.003,17,2,136,1,60,0.0,32.0,32.0,1,76,0.0,48.0,48.0
0.006,6,10,1854,5,889,1.0,621.0,621.0,5,965,1.0,697.0,697.0
15.075,17,15,9238,8,6902,2149.0,1350.0,834.0,7,2336,2507.0,1350.0,305.0
40.066,17,10,676,5,460,10015.0,104.0,64.0,5,216,10015.0,20.0,15.0
0.004,17,2,136,1,60,0.0,32.0,32.0,1,76,0.0,48.0,48.0
0.119,6,10,1506,5,395,22.0,127.0,127.0,5,1111,24.0,843.0,843.0
0.006,6,10,1547,5,764,1.0,496.0,496.0,5,783,1.0,515.0,515.0
0.075,6,10,1506,5,395,16.0,127.0,127.0,5,1111,15.0,843.0,843.0
1795.733,6,296,42889,123,25340,14718.0,2720.0,214.0,173,17549,10439.0,1360.0,131.0
0.097,6,10,1506,5,395,21.0,127.0,127.0,5,1111,21.0,843.0,843.0
0.005,17,2,178,1,81,0.0,53.0,53.0,1,97,0.0,69.0,69.0
0.008,6,10,1989,5,910,2.0,642.0,642.0,5,1079,2.0,811.0,811.0
300.293,6,27,7434,16,1409,20019.0,217.0,142.0,11,6025,24025.0,1679.0,777.0
0.014,6,10,1989,5,910,3.0,642.0,642.0,5,1079,3.0,811.0,811.0
0.014,6,10,1972,5,910,3.0,642.0,642.0,5,1062,3.0,794.0,794.0
0.008,6,12,1926,6,1189,1.0,659.0,434.0,6,737,1.0,417.0,417.0
0.017,17,2,198,1,91,0.0,63.0,63.0,1,107,0.0,79.0,79.0
40.086,17,10,676,5,460,10019.0,104.0,64.0,5,216,10020.0,20.0,15.0
0.016,6,10,1990,5,911,3.0,643.0,643.0,5,1079,4.0,811.0,811.0
0.006,6,10,1547,5,764,1.0,496.0,496.0,5,783,1.0,515.0,515.0
40.068,17,10,676,5,460,10014.0,104.0,64.0,5,216,10015.0,20.0,15.0
0.013,17,2,152,1,56,0.0,28.0,28.0,1,96,0.0,68.0,68.0
11.083,17,28,4422,14,1994,840.0,269.0,114.0,14,2428,840.0,587.0,145.0
0.005,6,10,2006,5,927,1.0,659.0,659.0,5,1079,1.0,811.0,811.0
178.653,17,70,9853,35,2326,5254.0,44.0,38.0,35,7527,5254.0,239.0,187.0
40.059,17,10,676,5,460,10014.0,104.0,64.0,5,216,10013.0,20.0,15.0
1778.607,17,142,44872,72,22752,25041.0,288.0,288.0,70,22120,25771.0,288.0,288.0
0.014,6,10,1983,5,910,3.0,642.0,642.0,5,1073,3.0,805.0,805.0
0.037,17,2,184,1,61,0.0,33.0,33.0,1,123,0.0,95.0,95.0
0.005,6,14,3736,7,446,0.0,74.0,74.0,7,3290,0.0,1448.0,972.0
0.006,6,10,1547,5,764,1.0,496.0,496.0,5,783,1.0,515.0,515.0
171.249,17,90,12415,45,3050,3891.0,44.0,39.0,45,9365,3891.0,261.0,180.0
0.004,6,10,1989,5,927,1.0,659.0,659.0,5,1062,1.0,794.0,794.0
0.067,6,10,1506,5,395,14.0,127.0,127.0,5,1111,13.0,843.0,843.0
0.006,6,13,3684,7,446,0.0,74.0,74.0,6,3238,1.0,1470.0,1459.0
0.008,6,10,1972,5,910,2.0,642.0,642.0,5,1062,1.0,794.0,794.0
0.005,6,10,1989,5,927,1.0,659.0,659.0,5,1062,1.0,794.0,794.0
0.01,6,10,1989,5,910,2.0,642.0,642.0,5,1079,2.0,811.0,811.0
0.003,17,4,284,2,120,0.0,32.0,32.0,2,164,0.0,60.0,54.0
368.951,6,22,2313,16,867,24596.0,195.0,195.0,6,1446,4636.0,419.0,398.0
0.005,17,2,164,1,74,0.0,46.0,46.0,1,90,0.0,62.0,62.0
0.127,6,10,1506,5,395,30.0,127.0,127.0,5,1111,26.0,843.0,843.0
0.005,6,13,3690,7,452,0.0,80.0,80.0,6,3238,0.0,1470.0,1459.0
0.005,6,10,2006,5,927,1.0,659.0,659.0,5,1079,1.0,811.0,811.0
0.006,6,13,3747,7,509,0.0,137.0,137.0,6,3238,1.0,1470.0,1459.0
0.001,17,2,180,1,66,0.0,38.0,38.0,1,114,0.0,86.0,86.0
366.15,6,22,2313,16,867,24410.0,195.0,195.0,6,1446,4635.0,419.0,398.0
0.06,17,2,152,1,76,0.0,48.0,48.0,1,76,0.0,48.0,48.0
175.164,17,72,10573,36,2409,5004.0,44.0,38.0,36,8164,5004.0,261.0,198.0
0.012,6,10,1989,5,910,3.0,642.0,642.0,5,1079,2.0,811.0,811.0
312.266,17,20,1124,10,716,34683.0,48.0,43.0,10,408,34688.0,20.0,12.0
0.082,6,10,1506,5,395,18.0,127.0,127.0,5,1111,19.0,843.0,843.0
0.011,6,10,1990,5,911,2.0,643.0,643.0,5,1079,2.0,811.0,811.0
240.02,6,9,787,5,488,60005.0,232.0,232.0,4,299,80005.0,83.0,83.0
0.005,6,10,1989,5,927,1.0,659.0,659.0,5,1062,1.0,794.0,794.0
0.011,6,10,1989,5,910,2.0,642.0,642.0,5,1079,2.0,811.0,811.0
0.005,6,10,1854,5,889,1.0,621.0,621.0,5,965,1.0,697.0,697.0
0.118,6,10,1506,5,395,27.0,127.0,127.0,5,1111,27.0,843.0,843.0
0.017,6,13,3735,7,497,2.0,125.0,125.0,6,3238,3.0,1470.0,1459.0
0.001,17,2,140,1,62,0.0,34.0,34.0,1,78,0.0,50.0,50.0
0.005,6,10,2006,5,927,1.0,659.0,659.0,5,1079,1.0,811.0,811.0
0.008,6,10,1689,5,839,2.0,571.0,571.0,5,850,1.0,582.0,582.0
15.075,17,15,8223,8,6021,2149.0,1350.0,724.0,7,2202,2507.0,1350.0,286.0
0.013,6,10,1990,5,911,3.0,643.0,643.0,5,1079,3.0,811.0,811.0
0.009,6,10,1989,5,910,2.0,642.0,642.0,5,1079,2.0,811.0,811.0
0.005,17,2,170,1,65,0.0,37.0,37.0,1,105,0.0,77.0,77.0
40.062,17,10,676,5,460,10014.0,104.0,64.0,5,216,10014.0,20.0,15.0
0.006,6,10,1547,5,764,1.0,496.0,496.0,5,783,1.0,515.0,515.0
0.114,6,10,1506,5,395,26.0,127.0,127.0,5,1111,26.0,843.0,843.0
0.073,6,10,1506,5,395,16.0,127.0,127.0,5,1111,17.0,843.0,843.0
0.094,6,10,1506,5,395,23.0,127.0,127.0,5,1111,20.0,843.0,843.0
1730.422,6,48,2957,31,1800,57680.0,35.0,35.0,17,1157,108145.0,31.0,31.0
0.008,17,2,162,1,65,0.0,37.0,37.0,1,97,0.0,69.0,69.0
0.014,6,10,1983,5,910,3.0,642.0,642.0,5,1073,3.0,805.0,805.0
0.006,6,10,1989,5,927,1.0,659.0,659.0,5,1062,1.0,794.0,794.0
0.005,6,10,1779,5,928,1.0,660.0,660.0,5,851,1.0,583.0,583.0
0.118,6,10,1506,5,395,23.0,127.0,127.0,5,1111,22.0,843.0,843.0
0.081,6,10,1506,5,395,16.0,127.0,127.0,5,1111,18.0,843.0,843.0
0.089,6,10,1506,5,395,20.0,127.0,127.0,5,1111,20.0,843.0,843.0
0.072,6,10,1506,5,395,16.0,127.0,127.0,5,1111,17.0,843.0,843.0
300.177,6,28,8662,14,2477,23090.0,1225.0,348.0,14,6185,23090.0,1591.0,682.0
0.005,17,2,144,1,64,0.0,36.0,36.0,1,80,0.0,52.0,52.0
0.015,6,10,1989,5,910,3.0,642.0,642.0,5,1079,3.0,811.0,811.0
0.013,6,10,1990,5,911,3.0,643.0,643.0,5,1079,3.0,811.0,811.0
0.013,6,10,2007,5,928,3.0,660.0,660.0,5,1079,3.0,811.0,811.0
0.01,6,10,1762,5,911,2.0,643.0,643.0,5,851,2.0,583.0,583.0
0.04,17,2,166,1,75,0.0,47.0,47.0,1,91,0.0,63.0,63.0
0.005,6,10,1989,5,927,1.0,659.0,659.0,5,1062,1.0,794.0,794.0
0.013,6,13,3735,7,497,2.0,125.0,125.0,6,3238,2.0,1470.0,1459.0
0.031,17,2,170,1,65,0.0,37.0,37.0,1,105,0.0,77.0,77.0
40.052,17,10,676,5,460,10012.0,104.0,64.0,5,216,10012.0,20.0,15.0
0.073,6,10,1506,5,395,17.0,127.0,127.0,5,1111,15.0,843.0,843.0
0.007,17,2,179,1,71,0.0,43.0,43.0,1,108,0.0,80.0,80.0
0.005,6,10,2006,5,927,1.0,659.0,659.0,5,1079,1.0,811.0,811.0
1792.77,6,304,43282,129,25580,14005.0,1360.0,207.0,175,17702,10302.0,1360.0,128.0
0.009,6,10,1972,5,910,2.0,642.0,642.0,5,1062,2.0,794.0,794.0
0.012,6,10,1990,5,911,2.0,643.0,643.0,5,1079,2.0,811.0,811.0
0.009,6,10,1972,5,910,2.0,642.0,642.0,5,1062,2.0,794.0,794.0
0.011,6,10,1762,5,911,2.0,643.0,643.0,5,851,2.0,583.0,583.0
11.231,17,28,4417,14,1994,851.0,269.0,114.0,14,2423,851.0,586.0,145.0
0.005,17,2,214,1,75,0.0,47.0,47.0,1,139,0.0,111.0,111.0
0.019,6,10,1972,5,910,4.0,642.0,642.0,5,1062,4.0,794.0,794.0
0.012,6,10,1972,5,910,3.0,642.0,642.0,5,1062,3.0,794.0,794.0
0.007,6,10,1643,5,860,1.0,592.0,592.0,5,783,1.0,515.0,515.0
311.843,17,19,1084,10,716,34624.0,48.0,43.0,9,368,38952.0,20.0,12.0
0.03,6,10,1989,5,910,7.0,642.0,642.0,5,1079,7.0,811.0,811.0
0.071,6,10,1506,5,395,14.0,127.0,127.0,5,1111,16.0,843.0,843.0
0.004,6,10,1774,5,923,1.0,655.0,655.0,5,851,1.0,583.0,583.0
0.013,6,10,1605,5,388,3.0,120.0,120.0,5,1217,3.0,949.0,949.0
0.008,6,10,1972,5,910,2.0,642.0,642.0,5,1062,2.0,794.0,794.0
0.089,6,10,1506,5,395,19.0,127.0,127.0,5,1111,19.0,843.0,843.0
0.095,6,10,1506,5,395,22.0,127.0,127.0,5,1111,18.0,843.0,843.0
0.015,6,10,1983,5,910,3.0,642.0,642.0,5,1073,3.0,805.0,805.0
1.645,6,140,99510,72,96601,19.0,2828.0,1378.0,68,2909,20.0,177.0,177.0
0.006,6,10,1689,5,839,1.0,571.0,571.0,5,850,1.0,582.0,582.0
0.921,6,26,5824,13,1922,67.0,325.0,174.0,13,3902,65.0,1414.0,563.0
0.005,17,2,230,1,68,0.0,40.0,40.0,1,162,0.0,134.0,134.0
0.011,6,10,1677,5,827,2.0,559.0,559.0,5,850,2.0,582.0,582.0
0.004,17,2,148,1,60,0.0,32.0,32.0,1,88,0.0,60.0,60.0
0.006,17,2,214,1,75,0.0,47.0,47.0,1,139,0.0,111.0,111.0
0.096,6,10,1506,5,395,20.0,127.0,127.0,5,1111,19.0,843.0,843.0
163.121,17,76,10860,38,2544,4408.0,44.0,38.0,38,8316,4408.0,239.0,190.0
0.004,17,2,148,1,60,0.0,32.0,32.0,1,88,0.0,60.0,60.0
0.013,6,10,1983,5,910,3.0,642.0,642.0,5,1073,3.0,805.0,805.0
15.073,17,18,10712,9,8280,1880.0,1350.0,892.0,9,2432,1880.0,1350.0,242.0
0.012,6,10,1972,5,910,2.0,642.0,642.0,5,1062,3.0,794.0,794.0
0.167,17,2,152,1,76,0.0,48.0,48.0,1,76,0.0,48.0,48.0
0.004,17,2,148,1,60,0.0,32.0,32.0,1,88,0.0,60.0,60.0
10.779,17,28,4420,14,1995,821.0,270.0,114.0,14,2425,821.0,588.0,145.0
0.006,17,2,166,1,75,0.0,47.0,47.0,1,91,0.0,63.0,63.0
0.085,6,10,1506,5,395,17.0,127.0,127.0,5,1111,19.0,843.0,843.0
0.008,6,10,1990,5,911,2.0,643.0,643.0,5,1079,2.0,811.0,811.0
0.009,6,12,1926,6,1189,1.0,659.0,434.0,6,737,1.0,417.0,417.0
0.029,6,10,1989,5,910,7.0,642.0,642.0,5,1079,7.0,811.0,811.0
0.072,17,4,364,2,160,0.0,52.0,52.0,2,204,32.0,80.0,74.0
0.005,6,10,1643,5,860,1.0,592.0,592.0,5,783,1.0,515.0,515.0
0.057,6,10,1506,5,395,12.0,127.0,127.0,5,1111,13.0,843.0,843.0
0.061,17,2,80,1,32,0.0,4.0,4.0,1,48,0.0,20.0,20.0
0.005,17,2,140,1,62,0.0,34.0,34.0,1,78,0.0,50.0,50.0
0.013,17,2,152,1,56,0.0,28.0,28.0,1,96,0.0,68.0,68.0
0.072,17,2,136,1,60,0.0,32.0,32.0,1,76,0.0,48.0,48.0
40.055,17,10,676,5,460,10013.0,104.0,64.0,5,216,10013.0,20.0,15.0
0.012,6,10,1989,5,910,2.0,642.0,642.0,5,1079,2.0,811.0,811.0
0.001,17,2,180,1,66,0.0,38.0,38.0,1,114,0.0,86.0,86.0
0.001,17,2,180,1,66,0.0,38.0,38.0,1,114,0.0,86.0,86.0
0.005,17,2,146,1,65,0.0,37.0,37.0,1,81,0.0,53.0,53.0
0.006,6,10,1547,5,764,1.0,496.0,496.0,5,783,1.0,515.0,515.0
0.01,6,10,1989,5,910,2.0,642.0,642.0,5,1079,2.0,811.0,811.0
0.004,6,10,2006,5,927,1.0,659.0,659.0,5,1079,1.0,811.0,811.0
0.005,6,10,1989,5,927,1.0,659.0,659.0,5,1062,1.0,794.0,794.0
0.013,6,10,1990,5,911,3.0,643.0,643.0,5,1079,3.0,811.0,811.0
0.085,6,10,1506,5,395,14.0,127.0,127.0,5,1111,19.0,843.0,843.0
0.006,6,13,3690,7,452,0.0,80.0,80.0,6,3238,1.0,1470.0,1459.0
0.001,17,2,136,1,60,0.0,32.0,32.0,1,76,0.0,48.0,48.0
0.005,6,10,2006,5,927,1.0,659.0,659.0,5,1079,1.0,811.0,811.0
0.051,17,2,182,1,65,0.0,37.0,37.0,1,117,0.0,89.0,89.0
0.072,6,10,1506,5,395,17.0,127.0,127.0,5,1111,13.0,843.0,843.0
240.331,6,26,4537,13,1880,20025.0,559.0,239.0,13,2657,20024.0,1611.0,283.0
0.004,6,13,3747,7,509,0.0,137.0,137.0,6,3238,0.0,1470.0,1459.0
0.072,17,2,80,1,32,0.0,4.0,4.0,1,48,0.0,20.0,20.0
0.005,17,2,214,1,75,0.0,47.0,47.0,1,139,0.0,111.0,111.0
0.004,6,10,2000,5,927,1.0,659.0,659.0,5,1073,1.0,805.0,805.0
0.001,17,2,166,1,75,0.0,47.0,47.0,1,91,0.0,63.0,63.0
0.01,6,13,3735,7,497,1.0,125.0,125.0,6,3238,1.0,1470.0,1459.0
0.005,6,10,2006,5,927,1.0,659.0,659.0,5,1079,1.0,811.0,811.0
0.004,6,10,2006,5,927,1.0,659.0,659.0,5,1079,1.0,811.0,811.0
0.005,6,10,1989,5,927,1.0,659.0,659.0,5,1062,1.0,794.0,794.0
0.001,17,2,180,1,66,0.0,38.0,38.0,1,114,0.0,86.0,86.0
0.007,6,10,2006,5,927,1.0,659.0,659.0,5,1079,1.0,811.0,811.0
0.006,6,10,1547,5,764,1.0,496.0,496.0,5,783,1.0,515.0,515.0
0.005,6,10,2007,5,928,1.0,660.0,660.0,5,1079,1.0,811.0,811.0
0.003,17,2,136,1,60,0.0,32.0,32.0,1,76,0.0,48.0,48.0
0.005,6,10,1689,5,839,1.0,571.0,571.0,5,850,1.0,582.0,582.0
0.005,6,10,1989,5,927,1.0,659.0,659.0,5,1062,1.0,794.0,794.0
0.006,6,14,3799,7,509,1.0,137.0,137.0,7,3290,0.0,1448.0,972.0
0.007,6,10,2007,5,928,1.0,660.0,660.0,5,1079,1.0,811.0,811.0
292.093,6,392,348618,202,22058,1453.0,2736.0,888.0,190,326560,1545.0,2804.0,1799.0
1796.155,6,565,188748,291,163376,6193.0,2883.0,932.0,274,25372,6579.0,383.0,109.0
0.006,6,10,1689,5,839,1.0,571.0,571.0,5,850,1.0,582.0,582.0
0.073,17,4,284,2,120,0.0,32.0,32.0,2,164,69.0,60.0,54.0
0.005,6,10,1774,5,923,1.0,655.0,655.0,5,851,1.0,583.0,583.0
0.01,6,10,1972,5,910,2.0,642.0,642.0,5,1062,2.0,794.0,794.0
0.005,6,10,2007,5,928,1.0,660.0,660.0,5,1079,1.0,811.0,811.0
0.004,6,10,1774,5,923,1.0,655.0,655.0,5,851,1.0,583.0,583.0
164.049,17,72,10304,36,2410,4687.0,44.0,38.0,36,7894,4687.0,239.0,191.0
10.815,17,28,4422,14,1995,823.0,270.0,114.0,14,2427,823.0,586.0,145.0
40.091,17,10,676,5,460,10021.0,104.0,64.0,5,216,10021.0,20.0,15.0
0.008,6,10,1972,5,910,2.0,642.0,642.0,5,1062,2.0,794.0,794.0
0.007,6,10,1547,5,764,1.0,496.0,496.0,5,783,1.0,515.0,515.0
240.71,6,21,7285,11,1823,24071.0,990.0,418.0,10,5462,26745.0,1593.0,822.0
0.006,6,10,1547,5,764,1.0,496.0,496.0,5,783,1.0,515.0,515.0
0.018,6,10,1762,5,911,4.0,643.0,643.0,5,851,4.0,583.0,583.0
0.001,17,2,180,1,66,0.0,38.0,38.0,1,114,0.0,86.0,86.0
0.014,6,10,1989,5,910,3.0,642.0,642.0,5,1079,3.0,811.0,811.0
0.012,6,10,1983,5,910,3.0,642.0,642.0,5,1073,3.0,805.0,805.0
0.006,6,10,2000,5,927,1.0,659.0,659.0,5,1073,1.0,805.0,805.0
40.072,17,10,676,5,460,10017.0,104.0,64.0,5,216,10016.0,20.0,15.0
0.007,6,10,1689,5,839,1.0,571.0,571.0,5,850,1.0,582.0,582.0
0.013,17,2,194,1,59,0.0,31.0,31.0,1,135,0.0,107.0,107.0
0.006,6,10,1547,5,764,1.0,496.0,496.0,5,783,1.0,515.0,515.0
254.71,6,11,891,5,488,63677.0,232.0,232.0,6,403,50941.0,83.0,83.0
0.006,6,10,1689,5,839,1.0,571.0,571.0,5,850,1.0,582.0,582.0
0.01,6,10,1983,5,910,2.0,642.0,642.0,5,1073,2.0,805.0,805.0
0.127,17,4,284,2,120,0.0,32.0,32.0,2,164,124.0,60.0,54.0
0.012,6,10,1983,5,910,2.0,642.0,642.0,5,1073,3.0,805.0,805.0
352.047,6,20,2210,6,1308,12014.0,494.0,494.0,14,902,27080.0,83.0,83.0
0.078,6,10,1506,5,395,18.0,127.0,127.0,5,1111,17.0,843.0,843.0
0.005,17,2,140,1,62,0.0,34.0,34.0,1,78,0.0,50.0,50.0
0.005,6,10,2006,5,927,1.0,659.0,659.0,5,1079,1.0,811.0,811.0
0.004,6,10,2006,5,927,1.0,659.0,659.0,5,1079,1.0,811.0,811.0
0.174,6,3,453,2,321,174.0,241.0,241.0,1,132,0.0,92.0,92.0
0.069,6,10,1506,5,395,14.0,127.0,127.0,5,1111,14.0,843.0,843.0
0.004,17,2,136,1,60,0.0,32.0,32.0,1,76,0.0,48.0,48.0
0.014,6,10,1983,5,910,3.0,642.0,642.0,5,1073,3.0,805.0,805.0
40.073,17,10,676,5,460,10016.0,104.0,64.0,5,216,10017.0,20.0,15.0
0.011,6,10,1989,5,910,2.0,642.0,642.0,5,1079,2.0,811.0,811.0
0.071,17,8,3613,4,1874,23.0,1350.0,440.0,4,1739,12.0,1350.0,406.0
0.004,6,10,1774,5,923,1.0,655.0,655.0,5,851,1.0,583.0,583.0
0.12,6,10,1506,5,395,27.0,127.0,127.0,5,1111,26.0,843.0,843.0
0.009,6,10,1989,5,910,2.0,642.0,642.0,5,1079,2.0,811.0,811.0
0.014,6,10,1677,5,827,3.0,559.0,559.0,5,850,3.0,582.0,582.0
0.092,6,10,1506,5,395,19.0,127.0,127.0,5,1111,21.0,843.0,843.0
0.006,6,10,1547,5,764,1.0,496.0,496.0,5,783,1.0,515.0,515.0
0.005,6,14,3736,7,446,0.0,74.0,74.0,7,3290,0.0,1448.0,972.0
0.095,6,10,1506,5,395,21.0,127.0,127.0,5,1111,18.0,843.0,843.0
0.012,6,10,1972,5,910,2.0,642.0,642.0,5,1062,3.0,794.0,794.0
0.004,17,2,148,1,60,0.0,32.0,32.0,1,88,0.0,60.0,60.0
0.006,6,10,1989,5,927,1.0,659.0,659.0,5,1062,1.0,794.0,794.0
11.111,17,28,4418,14,1993,842.0,268.0,114.0,14,2425,842.0,588.0,145.0
0.007,6,10,1989,5,910,1.0,642.0,642.0,5,1079,1.0,811.0,811.0
0.113,17,4,596,2,122,74.0,33.0,33.0,2,474,41.0,323.0,209.0
0.005,6,13,3690,7,452,0.0,80.0,80.0,6,3238,1.0,1470.0,1459.0
0.013,6,10,1989,5,910,3.0,642.0,642.0,5,1079,3.0,811.0,811.0
0.006,17,2,179,1,71,0.0,43.0,43.0,1,108,0.0,80.0,80.0
0.001,17,2,180,1,66,0.0,38.0,38.0,1,114,0.0,86.0,86.0
0.005,17,2,170,1,65,0.0,37.0,37.0,1,105,0.0,77.0,77.0
0.006,17,2,170,1,65,0.0,37.0,37.0,1,105,0.0,77.0,77.0
0.026,6,14,3787,7,497,4.0,125.0,125.0,7,3290,4.0,1448.0,972.0
0.01,6,10,1989,5,910,2.0,642.0,642.0,5,1079,2.0,811.0,811.0
0.007,6,10,1854,5,889,1.0,621.0,621.0,5,965,1.0,697.0,697.0
0.013,6,10,1677,5,827,3.0,559.0,559.0,5,850,3.0,582.0,582.0
0.008,6,10,1643,5,860,1.0,592.0,592.0,5,783,1.0,515.0,515.0
0.098,6,10,1506,5,395,23.0,127.0,127.0,5,1111,23.0,843.0,843.0
0.005,17,2,225,1,65,0.0,37.0,37.0,1,160,0.0,132.0,132.0
0.001,17,2,166,1,75,0.0,47.0,47.0,1,91,0.0,63.0,63.0
0.011,6,10,1989,5,910,2.0,642.0,642.0,5,1079,2.0,811.0,811.0
240.384,6,35,10484,17,1864,15023.0,588.0,192.0,18,8620,14140.0,1402.0,640.0
0.104,6,10,1506,5,395,24.0,127.0,127.0,5,1111,23.0,843.0,843.0
0.023,6,10,1983,5,910,5.0,642.0,642.0,5,1073,5.0,805.0,805.0
0.004,6,10,1779,5,928,1.0,660.0,660.0,5,851,1.0,583.0,583.0
0.009,6,10,1990,5,911,2.0,643.0,643.0,5,1079,2.0,811.0,811.0
0.011,17,2,169,1,62,0.0,34.0,34.0,1,107,0.0,79.0,79.0
308.505,17,15,916,10,716,34262.0,48.0,43.0,5,200,76267.0,12.0,12.0
0.003,6,10,1702,5,863,0.0,595.0,595.0,5,839,0.0,571.0,571.0
40.069,17,10,676,5,460,10015.0,104.0,64.0,5,216,10016.0,20.0,15.0
0.006,6,10,1689,5,839,1.0,571.0,571.0,5,850,1.0,582.0,582.0
0.107,6,10,1506,5,395,16.0,127.0,127.0,5,1111,24.0,843.0,843.0
1787.609,6,150,19350,90,13740,20085.0,302.0,302.0,60,5610,30297.0,83.0,83.0
0.006,6,10,1774,5,923,1.0,655.0,655.0,5,851,1.0,583.0,583.0
0.002,17,2,180,1,66,0.0,38.0,38.0,1,114,0.0,86.0,86.0
0.005,6,10,1774,5,923,1.0,655.0,655.0,5,851,1.0,583.0,583.0
0.091,6,10,1506,5,395,20.0,127.0,127.0,5,1111,19.0,843.0,843.0
40.069,17,10,676,5,460,10015.0,104.0,64.0,5,216,10016.0,20.0,15.0
0.021,6,10,1983,5,910,5.0,642.0,642.0,5,1073,5.0,805.0,805.0
0.004,6,10,2007,5,928,1.0,660.0,660.0,5,1079,1.0,811.0,811.0
40.062,17,10,676,5,460,10013.0,104.0,64.0,5,216,10014.0,20.0,15.0
1779.21,17,141,44556,72,22752,25057.0,288.0,288.0,69,21804,26154.0,288.0,288.0
0.111,6,10,1506,5,395,27.0,127.0,127.0,5,1111,24.0,843.0,843.0
0.1,6,10,1506,5,395,23.0,127.0,127.0,5,1111,21.0,843.0,843.0
0.071,17,2,170,1,65,0.0,37.0,37.0,1,105,0.0,77.0,77.0
0.014,6,10,1972,5,910,3.0,642.0,642.0,5,1062,3.0,794.0,794.0
0.713,6,25,5459,12,1557,56.0,325.0,152.0,13,3902,50.0,1414.0,563.0
264.605,17,18,1008,9,640,33060.0,48.0,43.0,9,368,33060.0,20.0,12.0
40.07,17,10,676,5,460,10015.0,104.0,64.0,5,216,10016.0,20.0,15.0
0.005,6,13,3747,7,509,0.0,137.0,137.0,6,3238,1.0,1470.0,1459.0
0.012,6,10,1972,5,910,3.0,642.0,642.0,5,1062,2.0,794.0,794.0
0.791,6,22,5072,11,1250,70.0,325.0,133.0,11,3822,67.0,1414.0,563.0
0.127,6,10,1506,5,395,27.0,127.0,127.0,5,1111,29.0,843.0,843.0
0.128,17,2,80,1,32,0.0,4.0,4.0,1,48,0.0,20.0,20.0
0.007,17,2,194,1,59,0.0,31.0,31.0,1,135,0.0,107.0,107.0
74.67,58,5,360,4,288,24890.0,24.0,24.0,1,72,0.0,24.0,24.0
0.016,6,10,1972,5,910,3.0,642.0,642.0,5,1062,3.0,794.0,794.0
1770.46,6,83,4368,42,2210,43181.0,26.0,26.0,41,2158,44260.0,26.0,26.0
0.005,6,10,2007,5,928,1.0,660.0,660.0,5,1079,1.0,811.0,811.0
0.063,6,10,1506,5,395,13.0,127.0,127.0,5,1111,14.0,843.0,843.0
0.006,6,10,1643,5,860,1.0,592.0,592.0,5,783,1.0,515.0,515.0
252.571,6,360,345630,183,21044,1387.0,2736.0,886.0,177,324586,1435.0,4206.0,1877.0
0.042,17,2,144,1,64,0.0,36.0,36.0,1,80,0.0,52.0,52.0
0.008,6,12,1926,6,1189,1.0,659.0,434.0,6,737,1.0,417.0,417.0
0.125,6,10,1506,5,395,29.0,127.0,127.0,5,1111,27.0,843.0,843.0
0.04,17,2,156,1,64,0.0,36.0,36.0,1,92,0.0,64.0,64.0
0.004,6,13,3690,7,452,0.0,80.0,80.0,6,3238,0.0,1470.0,1459.0
0.005,6,10,2000,5,927,1.0,659.0,659.0,5,1073,1.0,805.0,805.0
15.075,17,15,10568,9,8280,1880.0,1350.0,892.0,6,2288,3011.0,1350.0,353.0
0.003,17,2,136,1,60,0.0,32.0,32.0,1,76,0.0,48.0,48.0
0.04,17,2,144,1,64,0.0,36.0,36.0,1,80,0.0,52.0,52.0
0.005,6,10,1643,5,860,1.0,592.0,592.0,5,783,1.0,515.0,515.0
0.118,6,10,1506,5,395,26.0,127.0,127.0,5,1111,27.0,843.0,843.0
247.455,6,400,379267,123,21699,2028.0,1368.0,695.0,277,357568,896.0,2804.0,1367.0
2.764,6,25,6087,14,2100,212.0,517.0,303.0,11,3987,259.0,1330.0,589.0
0.005,6,10,1989,5,927,1.0,659.0,659.0,5,1062,1.0,794.0,794.0
0.013,6,10,1989,5,910,3.0,642.0,642.0,5,1079,3.0,811.0,811.0
0.004,6,10,2006,5,927,1.0,659.0,659.0,5,1079,1.0,811.0,811.0
0.012,6,10,1972,5,910,2.0,642.0,642.0,5,1062,3.0,794.0,794.0
0.009,6,10,1972,5,910,2.0,642.0,642.0,5,1062,2.0,794.0,794.0
0.012,6,10,1983,5,910,3.0,642.0,642.0,5,1073,2.0,805.0,805.0
0.005,6,10,1689,5,839,1.0,571.0,571.0,5,850,1.0,582.0,582.0
0.054,17,2,184,1,61,0.0,33.0,33.0,1,123,0.0,95.0,95.0
0.002,17,2,136,1,60,0.0,32.0,32.0,1,76,0.0,48.0,48.0
0.005,6,10,1989,5,927,1.0,659.0,659.0,5,1062,1.0,794.0,794.0
1756.157,6,105,6270,60,3525,29764.0,27.0,27.0,45,2745,39911.0,27.0,27.0
0.006,6,10,1689,5,839,1.0,571.0,571.0,5,850,1.0,582.0,582.0
0.13,6,10,1506,5,395,29.0,127.0,127.0,5,1111,29.0,843.0,843.0
0.001,17,2,180,1,66,0.0,38.0,38.0,1,114,0.0,86.0,86.0
0.05,6,13,3913,7,495,8.0,123.0,123.0,6,3418,9.0,1650.0,1549.0
0.099,6,10,1506,5,395,23.0,127.0,127.0,5,1111,22.0,843.0,843.0
10.81,17,28,4422,14,1994,823.0,269.0,114.0,14,2428,822.0,587.0,145.0
0.004,6,10,1989,5,927,1.0,659.0,659.0,5,1062,1.0,794.0,794.0
0.004,6,10,2007,5,928,1.0,660.0,660.0,5,1079,1.0,811.0,811.0
0.005,17,2,164,1,74,0.0,46.0,46.0,1,90,0.0,62.0,62.0
0.013,6,10,1989,5,910,3.0,642.0,642.0,5,1079,3.0,811.0,811.0
0.005,6,10,2000,5,927,1.0,659.0,659.0,5,1073,1.0,805.0,805.0
0.165,6,10,1506,5,395,38.0,127.0,127.0,5,1111,39.0,843.0,843.0
0.114,6,10,1506,5,395,26.0,127.0,127.0,5,1111,26.0,843.0,843.0
0.009,6,12,1926,6,1189,1.0,659.0,434.0,6,737,1.0,417.0,417.0
0.005,6,10,1989,5,927,1.0,659.0,659.0,5,1062,1.0,794.0,794.0
0.007,17,4,284,2,120,3.0,32.0,32.0,2,164,4.0,60.0,54.0
0.087,6,10,1506,5,395,19.0,127.0,127.0,5,1111,19.0,843.0,843.0
0.006,6,10,1854,5,889,1.0,621.0,621.0,5,965,1.0,697.0,697.0
0.094,6,10,1506,5,395,22.0,127.0,127.0,5,1111,22.0,843.0,843.0
0.012,6,10,1989,5,910,3.0,642.0,642.0,5,1079,3.0,811.0,811.0
0.011,6,10,1989,5,910,2.0,642.0,642.0,5,1079,2.0,811.0,811.0
0.009,6,10,2007,5,928,2.0,660.0,660.0,5,1079,2.0,811.0,811.0
40.069,17,10,676,5,460,10015.0,104.0,64.0,5,216,10016.0,20.0,15.0
0.005,17,2,136,1,60,0.0,32.0,32.0,1,76,0.0,48.0,48.0
353.667,6,20,2210,6,1308,12003.0,494.0,494.0,14,902,27204.0,83.0,83.0
0.017,6,10,1631,5,848,4.0,580.0,580.0,5,783,4.0,515.0,515.0
0.01,6,10,1983,5,910,2.0,642.0,642.0,5,1073,2.0,805.0,805.0
0.005,6,10,2006,5,927,1.0,659.0,659.0,5,1079,1.0,811.0,811.0
0.01,6,10,1983,5,910,2.0,642.0,642.0,5,1073,2.0,805.0,805.0
0.008,6,10,1990,5,911,2.0,643.0,643.0,5,1079,1.0,811.0,811.0
0.004,17,2,166,1,75,0.0,47.0,47.0,1,91,0.0,63.0,63.0
0.008,6,10,1677,5,827,2.0,559.0,559.0,5,850,2.0,582.0,582.0
0.006,6,10,1689,5,839,1.0,571.0,571.0,5,850,1.0,582.0,582.0
0.005,17,2,179,1,71,0.0,43.0,43.0,1,108,0.0,80.0,80.0
0.001,17,2,180,1,66,0.0,38.0,38.0,1,114,0.0,86.0,86.0
308.968,17,20,1124,10,716,34316.0,48.0,43.0,10,408,34316.0,20.0,12.0
0.922,6,24,8450,14,2106,70.0,1139.0,378.0,10,6344,83.0,2749.0,1186.0
0.004,6,10,1702,5,863,1.0,595.0,595.0,5,839,0.0,571.0,571.0
378.746,6,22,2313,16,867,25249.0,195.0,195.0,6,1446,4637.0,419.0,398.0
0.224,6,16,2669,8,1395,32.0,533.0,323.0,8,1274,20.0,529.0,212.0
0.005,6,10,1689,5,839,1.0,571.0,571.0,5,850,1.0,582.0,582.0
0.003,17,2,136,1,60,0.0,32.0,32.0,1,76,0.0,48.0,48.0
0.072,6,10,1506,5,395,15.0,127.0,127.0,5,1111,16.0,843.0,843.0
0.03,6,13,3913,7,495,5.0,123.0,123.0,6,3418,5.0,1650.0,1549.0
300.419,6,16,2170,9,684,37530.0,146.0,146.0,7,1486,50040.0,419.0,398.0
0.006,6,10,1689,5,839,1.0,571.0,571.0,5,850,1.0,582.0,582.0
0.077,6,10,1506,5,395,15.0,127.0,127.0,5,1111,17.0,843.0,843.0
0.014,6,10,1972,5,910,3.0,642.0,642.0,5,1062,3.0,794.0,794.0
310.031,17,20,1124,10,716,34433.0,48.0,43.0,10,408,34433.0,20.0,12.0
0.038,17,4,284,2,120,0.0,32.0,32.0,2,164,35.0,60.0,54.0
40.087,17,10,676,5,460,10018.0,104.0,64.0,5,216,10020.0,20.0,15.0
0.016,6,10,1972,5,910,4.0,642.0,642.0,5,1062,4.0,794.0,794.0
40.049,17,10,676,5,460,10011.0,104.0,64.0,5,216,10011.0,20.0,15.0
0.084,6,10,1506,5,395,20.0,127.0,127.0,5,1111,17.0,843.0,843.0
0.119,6,10,1506,5,395,16.0,127.0,127.0,5,1111,27.0,843.0,843.0
0.006,6,10,1689,5,839,1.0,571.0,571.0,5,850,1.0,582.0,582.0
40.084,17,10,676,5,460,10020.0,104.0,64.0,5,216,10020.0,20.0,15.0
0.005,6,10,1689,5,839,1.0,571.0,571.0,5,850,1.0,582.0,582.0
0.016,6,13,3735,7,497,2.0,125.0,125.0,6,3238,3.0,1470.0,1459.0
0.04,17,2,156,1,64,0.0,36.0,36.0,1,92,0.0,64.0,64.0
354.032,6,21,1795,16,1030,23602.0,190.0,190.0,5,765,60003.0,464.0,248.0
0.018,6,10,1631,5,848,4.0,580.0,580.0,5,783,4.0,515.0,515.0
0.006,6,10,1989,5,927,1.0,659.0,659.0,5,1062,1.0,794.0,794.0
0.745,6,10,2201,5,1214,125.0,1002.0,1002.0,5,987,125.0,775.0,775.0
0.006,17,2,214,1,75,0.0,47.0,47.0,1,139,0.0,111.0,111.0
0.001,17,2,180,1,66,0.0,38.0,38.0,1,114,0.0,86.0,86.0
0.113,6,10,1506,5,395,26.0,127.0,127.0,5,1111,26.0,843.0,843.0
0.014,17,2,266,1,69,0.0,41.0,41.0,1,197,0.0,169.0,169.0
0.009,6,13,3735,7,497,1.0,125.0,125.0,6,3238,1.0,1470.0,1459.0
0.006,17,2,230,1,68,0.0,40.0,40.0,1,162,0.0,134.0,134.0
40.073,17,10,676,5,460,10015.0,104.0,64.0,5,216,10016.0,20.0,15.0
0.001,17,2,180,1,66,0.0,38.0,38.0,1,114,0.0,86.0,86.0
0.106,6,10,1506,5,395,23.0,127.0,127.0,5,1111,24.0,843.0,843.0
0.129,17,2,80,1,32,0.0,4.0,4.0,1,48,0.0,20.0,20.0
326.811,17,20,1124,10,716,36298.0,48.0,43.0,10,408,36298.0,20.0,12.0
0.042,17,2,136,1,60,0.0,32.0,32.0,1,76,0.0,48.0,48.0
0.005,6,10,1689,5,839,1.0,571.0,571.0,5,850,1.0,582.0,582.0
0.004,17,4,284,2,120,0.0,32.0,32.0,2,164,1.0,60.0,54.0
0.134,6,10,1506,5,395,31.0,127.0,127.0,5,1111,28.0,843.0,843.0
0.015,6,10,1990,5,911,3.0,643.0,643.0,5,1079,3.0,811.0,811.0
0.006,6,10,1854,5,889,1.0,621.0,621.0,5,965,1.0,697.0,697.0
0.07,17,8,3613,4,1874,23.0,1350.0,440.0,4,1739,12.0,1350.0,406.0
0.004,17,2,179,1,71,0.0,43.0,43.0,1,108,0.0,80.0,80.0
0.016,6,10,1762,5,911,4.0,643.0,643.0,5,851,3.0,583.0,583.0
0.004,17,4,284,2,120,0.0,32.0,32.0,2,164,0.0,60.0,54.0
0.102,6,10,1506,5,395,23.0,127.0,127.0,5,1111,22.0,843.0,843.0
0.004,17,2,136,1,60,0.0,32.0,32.0,1,76,0.0,48.0,48.0
0.009,6,10,1989,5,910,2.0,642.0,642.0,5,1079,2.0,811.0,811.0
0.005,6,10,2007,5,928,1.0,660.0,660.0,5,1079,1.0,811.0,811.0
0.145,6,10,1506,5,395,32.0,127.0,127.0,5,1111,35.0,843.0,843.0
0.006,6,10,1547,5,764,1.0,496.0,496.0,5,783,1.0,515.0,515.0
0.018,6,10,1989,5,910,4.0,642.0,642.0,5,1079,4.0,811.0,811.0
353.656,6,20,2210,6,1308,12003.0,494.0,494.0,14,902,27204.0,83.0,83.0
0.108,6,10,1506,5,395,24.0,127.0,127.0,5,1111,21.0,843.0,843.0
0.008,6,10,1547,5,764,1.0,496.0,496.0,5,783,1.0,515.0,515.0
0.14,6,10,1506,5,395,34.0,127.0,127.0,5,1111,30.0,843.0,843.0
40.056,17,10,676,5,460,10013.0,104.0,64.0,5,216,10013.0,20.0,15.0
0.075,6,10,1506,5,395,15.0,127.0,127.0,5,1111,15.0,843.0,843.0
11.512,17,28,4398,14,2312,872.0,587.0,137.0,14,2086,872.0,269.0,121.0
0.081,6,10,1506,5,395,19.0,127.0,127.0,5,1111,17.0,843.0,843.0
0.076,6,10,1506,5,395,18.0,127.0,127.0,5,1111,17.0,843.0,843.0
242.161,6,296,343073,107,17082,2284.0,2736.0,960.0,189,325991,1288.0,4171.0,1766.0
1789.82,6,279,41263,112,22253,16122.0,2720.0,201.0,167,19010,10781.0,1360.0,152.0
0.005,6,10,2006,5,927,1.0,659.0,659.0,5,1079,1.0,811.0,811.0
0.004,17,2,136,1,60,0.0,32.0,32.0,1,76,0.0,48.0,48.0
0.005,6,10,1989,5,927,1.0,659.0,659.0,5,1062,1.0,794.0,794.0
0.071,17,2,80,1,32,0.0,4.0,4.0,1,48,0.0,20.0,20.0
0.006,17,2,140,1,62,0.0,34.0,34.0,1,78,0.0,50.0,50.0
0.005,6,10,2006,5,927,1.0,659.0,659.0,5,1079,1.0,811.0,811.0
0.004,6,10,2006,5,927,1.0,659.0,659.0,5,1079,1.0,811.0,811.0
0.064,17,2,152,1,76,0.0,48.0,48.0,1,76,0.0,48.0,48.0
0.106,6,10,1506,5,395,24.0,127.0,127.0,5,1111,17.0,843.0,843.0
0.007,17,2,166,1,75,0.0,47.0,47.0,1,91,0.0,63.0,63.0
0.208,17,15,9063,8,6518,29.0,1350.0,786.0,7,2545,24.0,1350.0,335.0
0.087,6,10,1506,5,395,18.0,127.0,127.0,5,1111,21.0,843.0,843.0
0.054,17,2,152,1,76,0.0,48.0,48.0,1,76,0.0,48.0,48.0
0.019,6,10,1990,5,911,4.0,643.0,643.0,5,1079,4.0,811.0,811.0
0.005,6,10,1989,5,927,1.0,659.0,659.0,5,1062,1.0,794.0,794.0
309.505,17,20,1124,10,716,34371.0,48.0,43.0,10,408,34372.0,20.0,12.0
0.143,6,10,1506,5,395,32.0,127.0,127.0,5,1111,34.0,843.0,843.0
240.079,6,16,4482,9,963,30009.0,238.0,166.0,7,3519,40012.0,1402.0,786.0
0.005,17,2,148,1,60,0.0,32.0,32.0,1,88,0.0,60.0,60.0
0.016,6,13,3735,7,497,2.0,125.0,125.0,6,3238,3.0,1470.0,1459.0
0.005,6,10,1689,5,839,1.0,571.0,571.0,5,850,1.0,582.0,582.0
0.005,17,2,179,1,71,0.0,43.0,43.0,1,108,0.0,80.0,80.0
0.04,17,4,420,2,122,1.0,33.0,33.0,2,298,32.0,145.0,121.0
0.001,17,2,180,1,66,0.0,38.0,38.0,1,114,0.0,86.0,86.0
0.016,6,10,1983,5,910,3.0,642.0,642.0,5,1073,4.0,805.0,805.0
0.004,6,10,2006,5,927,1.0,659.0,659.0,5,1079,1.0,811.0,811.0
0.014,6,10,1990,5,911,3.0,643.0,643.0,5,1079,3.0,811.0,811.0
0.005,17,2,140,1,62,0.0,34.0,34.0,1,78,0.0,50.0,50.0
40.059,17,10,676,5,460,10013.0,104.0,64.0,5,216,10013.0,20.0,15.0
0.179,17,2,152,1,76,0.0,48.0,48.0,1,76,0.0,48.0,48.0
0.103,6,10,1506,5,395,21.0,127.0,127.0,5,1111,24.0,843.0,843.0
0.011,6,10,1990,5,911,2.0,643.0,643.0,5,1079,2.0,811.0,811.0
0.001,17,2,180,1,66,0.0,38.0,38.0,1,114,0.0,86.0,86.0
0.001,17,2,180,1,66,0.0,38.0,38.0,1,114,0.0,86.0,86.0
0.004,17,2,213,1,69,0.0,41.0,41.0,1,144,0.0,116.0,116.0
40.075,17,10,676,5,460,10015.0,104.0,64.0,5,216,10017.0,20.0,15.0
0.006,17,2,170,1,65,0.0,37.0,37.0,1,105,0.0,77.0,77.0
0.081,6,10,1506,5,395,19.0,127.0,127.0,5,1111,19.0,843.0,843.0
0.008,17,2,298,1,65,0.0,37.0,37.0,1,233,0.0,205.0,205.0
0.1,6,10,1506,5,395,19.0,127.0,127.0,5,1111,22.0,843.0,843.0
0.025,6,10,1989,5,910,6.0,642.0,642.0,5,1079,6.0,811.0,811.0
0.041,17,2,186,1,61,0.0,33.0,33.0,1,125,0.0,97.0,97.0
40.065,17,10,676,5,460,10015.0,104.0,64.0,5,216,10015.0,20.0,15.0
0.08,6,10,1506,5,395,18.0,127.0,127.0,5,1111,18.0,843.0,843.0
0.012,6,10,1989,5,910,3.0,642.0,642.0,5,1079,3.0,811.0,811.0
0.005,6,13,3747,7,509,0.0,137.0,137.0,6,3238,0.0,1470.0,1459.0
1.127,6,32,13391,18,5892,66.0,2073.0,854.0,14,7499,73.0,2720.0,769.0
0.004,6,10,1989,5,927,1.0,659.0,659.0,5,1062,1.0,794.0,794.0
0.019,6,10,1972,5,910,4.0,642.0,642.0,5,1062,4.0,794.0,794.0
0.006,17,2,179,1,71,0.0,43.0,43.0,1,108,0.0,80.0,80.0
0.009,6,10,1989,5,910,2.0,642.0,642.0,5,1079,2.0,811.0,811.0
0.23,6,16,2777,8,1395,32.0,533.0,323.0,8,1382,21.0,529.0,239.0
0.006,6,10,1547,5,764,1.0,496.0,496.0,5,783,1.0,515.0,515.0
0.005,17,2,180,1,66,0.0,38.0,38.0,1,114,0.0,86.0,86.0
0.006,6,10,1547,5,764,1.0,496.0,496.0,5,783,1.0,515.0,515.0
0.004,17,2,148,1,60,0.0,32.0,32.0,1,88,0.0,60.0,60.0
0.005,6,10,2007,5,928,1.0,660.0,660.0,5,1079,1.0,811.0,811.0
0.011,17,2,194,1,59,0.0,31.0,31.0,1,135,0.0,107.0,107.0
0.012,6,10,1983,5,910,2.0,642.0,642.0,5,1073,2.0,805.0,805.0
0.012,6,10,1762,5,911,3.0,643.0,643.0,5,851,3.0,583.0,583.0
0.019,6,13,3735,7,497,3.0,125.0,125.0,6,3238,3.0,1470.0,1459.0
10.898,17,28,4392,14,1993,829.0,268.0,114.0,14,2399,829.0,586.0,143.0
0.024,6,10,1989,5,910,6.0,642.0,642.0,5,1079,6.0,811.0,811.0
0.007,6,10,1547,5,764,1.0,496.0,496.0,5,783,1.0,515.0,515.0
0.005,6,10,1989,5,927,1.0,659.0,659.0,5,1062,1.0,794.0,794.0
0.015,6,10,1983,5,910,3.0,642.0,642.0,5,1073,3.0,805.0,805.0
40.057,17,10,676,5,460,10013.0,104.0,64.0,5,216,10013.0,20.0,15.0
0.011,6,10,1983,5,910,2.0,642.0,642.0,5,1073,2.0,805.0,805.0
0.005,6,10,1989,5,927,1.0,659.0,659.0,5,1062,1.0,794.0,794.0
0.006,6,10,1547,5,764,1.0,496.0,496.0,5,783,1.0,515.0,515.0
359.177,6,21,1795,16,1030,23945.0,190.0,190.0,5,765,60013.0,464.0,248.0
0.005,17,2,230,1,68,0.0,40.0,40.0,1,162,0.0,134.0,134.0
0.005,6,10,1779,5,928,1.0,660.0,660.0,5,851,1.0,583.0,583.0
0.013,6,10,1972,5,910,3.0,642.0,642.0,5,1062,3.0,794.0,794.0
0.001,17,2,180,1,66,0.0,38.0,38.0,1,114,0.0,86.0,86.0
300.315,6,16,2170,9,684,37518.0,146.0,146.0,7,1486,50024.0,419.0,398.0
0.082,6,10,1506,5,395,17.0,127.0,127.0,5,1111,19.0,843.0,843.0
0.005,6,10,1774,5,923,1.0,655.0,655.0,5,851,1.0,583.0,583.0
0.014,6,10,1990,5,911,3.0,643.0,643.0,5,1079,3.0,811.0,811.0
0.139,6,10,1506,5,395,31.0,127.0,127.0,5,1111,30.0,843.0,843.0
0.099,6,10,1506,5,395,22.0,127.0,127.0,5,1111,22.0,843.0,843.0
0.006,6,10,2006,5,927,1.0,659.0,659.0,5,1079,1.0,811.0,811.0
0.003,17,2,162,1,65,0.0,37.0,37.0,1,97,0.0,69.0,69.0
0.127,6,10,1506,5,395,24.0,127.0,127.0,5,1111,30.0,843.0,843.0
0.009,6,10,1989,5,910,2.0,642.0,642.0,5,1079,2.0,811.0,811.0
240.354,6,33,9307,16,1836,16023.0,624.0,199.0,17,7471,15021.0,1402.0,599.0
40.063,17,10,676,5,460,10012.0,104.0,64.0,5,216,10014.0,20.0,15.0
0.004,6,10,1989,5,927,1.0,659.0,659.0,5,1062,1.0,794.0,794.0
0.006,6,10,1854,5,889,1.0,621.0,621.0,5,965,1.0,697.0,697.0
0.086,6,10,1506,5,395,18.0,127.0,127.0,5,1111,19.0,843.0,843.0
0.007,6,10,1989,5,910,1.0,642.0,642.0,5,1079,1.0,811.0,811.0
240.011,6,9,787,5,488,60002.0,232.0,232.0,4,299,80002.0,83.0,83.0
0.004,6,10,2007,5,928,1.0,660.0,660.0,5,1079,1.0,811.0,811.0
0.008,6,12,1926,6,1189,1.0,659.0,434.0,6,737,1.0,417.0,417.0
0.006,17,2,214,1,75,0.0,47.0,47.0,1,139,0.0,111.0,111.0
0.005,17,2,222,1,65,0.0,37.0,37.0,1,157,0.0,129.0,129.0
0.005,17,2,144,1,64,0.0,36.0,36.0,1,80,0.0,52.0,52.0
0.1,6,10,1506,5,395,20.0,127.0,127.0,5,1111,24.0,843.0,843.0
0.017,6,13,3735,7,497,2.0,125.0,125.0,6,3238,3.0,1470.0,1459.0
0.017,6,10,1990,5,911,4.0,643.0,643.0,5,1079,4.0,811.0,811.0
0.009,6,10,2007,5,928,2.0,660.0,660.0,5,1079,2.0,811.0,811.0
0.015,6,10,1972,5,910,3.0,642.0,642.0,5,1062,3.0,794.0,794.0
1770.641,6,81,4264,41,2158,44265.0,26.0,26.0,40,2106,45400.0,26.0,26.0
0.005,6,10,2006,5,927,1.0,659.0,659.0,5,1079,1.0,811.0,811.0
15.079,17,16,8777,8,6714,2150.0,1350.0,811.0,8,2063,2150.0,1350.0,229.0
0.009,6,10,1990,5,911,2.0,643.0,643.0,5,1079,2.0,811.0,811.0
0.011,6,10,1989,5,910,2.0,642.0,642.0,5,1079,2.0,811.0,811.0
0.059,6,10,1506,5,395,13.0,127.0,127.0,5,1111,12.0,843.0,843.0
0.071,17,2,136,1,60,0.0,32.0,32.0,1,76,0.0,48.0,48.0
0.072,6,10,1506,5,395,17.0,127.0,127.0,5,1111,16.0,843.0,843.0
0.011,6,10,1983,5,910,2.0,642.0,642.0,5,1073,2.0,805.0,805.0
0.013,6,10,1762,5,911,3.0,643.0,643.0,5,851,3.0,583.0,583.0
9.038,17,6,376,5,280,2259.0,28.0,28.0,1,96,0.0,68.0,68.0
300.422,6,16,2170,9,684,37531.0,146.0,146.0,7,1486,50042.0,419.0,398.0
0.005,6,14,3799,7,509,0.0,137.0,137.0,7,3290,0.0,1448.0,972.0
15.214,17,18,8765,9,6537,1898.0,1350.0,698.0,9,2228,1898.0,1350.0,219.0
0.001,17,2,180,1,66,0.0,38.0,38.0,1,114,0.0,86.0,86.0
40.074,17,10,676,5,460,10017.0,104.0,64.0,5,216,10017.0,20.0,15.0
0.077,6,10,1506,5,395,17.0,127.0,127.0,5,1111,18.0,843.0,843.0
0.004,17,4,284,2,120,0.0,32.0,32.0,2,164,1.0,60.0,54.0
0.067,6,39,8464,23,2310,3.0,517.0,122.0,16,6154,4.0,2694.0,531.0
0.007,17,2,170,1,65,0.0,37.0,37.0,1,105,0.0,77.0,77.0
0.014,6,10,1631,5,848,3.0,580.0,580.0,5,783,3.0,515.0,515.0
0.001,17,2,180,1,66,0.0,38.0,38.0,1,114,0.0,86.0,86.0
0.005,6,10,1989,5,927,1.0,659.0,659.0,5,1062,1.0,794.0,794.0
0.082,6,10,1506,5,395,18.0,127.0,127.0,5,1111,17.0,843.0,843.0
0.015,6,10,1989,5,910,3.0,642.0,642.0,5,1079,3.0,811.0,811.0
0.018,6,10,1972,5,910,4.0,642.0,642.0,5,1062,4.0,794.0,794.0
177.215,17,74,10467,37,2473,4922.0,44.0,38.0,37,7994,4922.0,239.0,188.0
0.078,6,10,1506,5,395,18.0,127.0,127.0,5,1111,18.0,843.0,843.0
171.22,17,84,12233,42,2817,4174.0,44.0,39.0,42,9416,4176.0,261.0,196.0
0.072,17,2,170,1,65,0.0,37.0,37.0,1,105,0.0,77.0,77.0
0.005,6,10,2000,5,927,1.0,659.0,659.0,5,1073,1.0,805.0,805.0
0.111,6,10,1506,5,395,23.0,127.0,127.0,5,1111,25.0,843.0,843.0
0.04,17,2,170,1,65,0.0,37.0,37.0,1,105,0.0,77.0,77.0
0.006,17,2,179,1,71,0.0,43.0,43.0,1,108,0.0,80.0,80.0
0.061,6,10,1506,5,395,13.0,127.0,127.0,5,1111,14.0,843.0,843.0
0.005,6,10,1989,5,927,1.0,659.0,659.0,5,1062,1.0,794.0,794.0
0.076,6,10,1506,5,395,15.0,127.0,127.0,5,1111,18.0,843.0,843.0
300.307,6,16,2170,9,684,37517.0,146.0,146.0,7,1486,50023.0,419.0,398.0
310.301,17,20,1124,10,716,34462.0,48.0,43.0,10,408,34463.0,20.0,12.0
0.006,6,10,1547,5,764,1.0,496.0,496.0,5,783,1.0,515.0,515.0
40.053,17,10,676,5,460,10012.0,104.0,64.0,5,216,10012.0,20.0,15.0
0.005,6,10,1774,5,923,1.0,655.0,655.0,5,851,1.0,583.0,583.0
0.004,17,4,284,2,120,0.0,32.0,32.0,2,164,1.0,60.0,54.0
0.087,6,10,1506,5,395,20.0,127.0,127.0,5,1111,16.0,843.0,843.0
10.977,17,28,4397,14,2312,835.0,587.0,137.0,14,2085,835.0,268.0,120.0
0.005,17,2,164,1,74,0.0,46.0,46.0,1,90,0.0,62.0,62.0
0.005,6,10,2006,5,927,1.0,659.0,659.0,5,1079,1.0,811.0,811.0
40.057,17,10,676,5,460,10013.0,104.0,64.0,5,216,10013.0,20.0,15.0
0.006,6,10,1547,5,764,1.0,496.0,496.0,5,783,1.0,515.0,515.0
0.065,6,10,1506,5,395,13.0,127.0,127.0,5,1111,15.0,843.0,843.0
0.077,17,2,148,1,60,0.0,32.0,32.0,1,88,0.0,60.0,60.0
0.015,6,10,1983,5,910,3.0,642.0,642.0,5,1073,3.0,805.0,805.0
178.074,17,80,11850,40,2679,4565.0,44.0,38.0,40,9171,4565.0,279.0,201.0
0.04,17,4,284,2,120,0.0,32.0,32.0,2,164,36.0,60.0,54.0
0.077,6,10,1506,5,395,16.0,127.0,127.0,5,1111,17.0,843.0,843.0
0.004,17,2,136,1,60,0.0,32.0,32.0,1,76,0.0,48.0,48.0
0.015,6,10,1989,5,910,3.0,642.0,642.0,5,1079,3.0,811.0,811.0
0.004,6,10,2006,5,927,1.0,659.0,659.0,5,1079,1.0,811.0,811.0
0.005,17,2,222,1,65,0.0,37.0,37.0,1,157,0.0,129.0,129.0
0.005,17,2,178,1,81,0.0,53.0,53.0,1,97,0.0,69.0,69.0
0.204,6,10,1506,5,395,48.0,127.0,127.0,5,1111,47.0,843.0,843.0
2.07,6,22,7057,13,1715,172.0,517.0,256.0,9,5342,258.0,1402.0,811.0
0.005,17,4,284,2,120,0.0,32.0,32.0,2,164,0.0,60.0,54.0
0.006,6,13,3747,7,509,1.0,137.0,137.0,6,3238,1.0,1470.0,1459.0
0.015,6,10,1983,5,910,3.0,642.0,642.0,5,1073,3.0,805.0,805.0
0.004,6,10,2000,5,927,1.0,659.0,659.0,5,1073,1.0,805.0,805.0
242.448,6,309,343024,113,17389,2164.0,2736.0,959.0,196,325635,1243.0,4171.0,1695.0
0.001,17,2,136,1,60,0.0,32.0,32.0,1,76,0.0,48.0,48.0
71.977,6,28,10440,12,3961,6543.0,1579.0,835.0,16,6479,4790.0,1288.0,805.0
0.022,6,10,1989,5,910,5.0,642.0,642.0,5,1079,5.0,811.0,811.0
0.012,6,10,1631,5,848,3.0,580.0,580.0,5,783,3.0,515.0,515.0
0.008,6,10,1989,5,910,2.0,642.0,642.0,5,1079,1.0,811.0,811.0
0.011,6,10,1990,5,911,2.0,643.0,643.0,5,1079,2.0,811.0,811.0
0.071,17,2,136,1,60,0.0,32.0,32.0,1,76,0.0,48.0,48.0
0.014,6,10,1989,5,910,3.0,642.0,642.0,5,1079,3.0,811.0,811.0
0.003,17,2,136,1,60,0.0,32.0,32.0,1,76,0.0,48.0,48.0
0.005,6,10,1774,5,923,1.0,655.0,655.0,5,851,1.0,583.0,583.0
62.908,6,21,8145,11,1985,84.0,1174.0,504.0,10,6160,6970.0,2720.0,958.0
0.001,17,2,180,1,66,0.0,38.0,38.0,1,114,0.0,86.0,86.0
167.054,17,68,9566,34,2267,5062.0,44.0,38.0,34,7299,5062.0,239.0,186.0
0.004,6,10,1702,5,863,0.0,595.0,595.0,5,839,1.0,571.0,571.0
0.045,17,2,179,1,71,0.0,43.0,43.0,1,108,0.0,80.0,80.0
0.006,17,2,230,1,68,0.0,40.0,40.0,1,162,0.0,134.0,134.0
0.005,6,10,2007,5,928,1.0,660.0,660.0,5,1079,1.0,811.0,811.0
300.394,6,16,2170,9,684,37528.0,146.0,146.0,7,1486,50038.0,419.0,398.0
0.014,6,10,1677,5,827,3.0,559.0,559.0,5,850,3.0,582.0,582.0
0.012,6,10,1989,5,910,3.0,642.0,642.0,5,1079,2.0,811.0,811.0
40.053,17,10,676,5,460,10012.0,104.0,64.0,5,216,10012.0,20.0,15.0
0.004,6,10,2000,5,927,1.0,659.0,659.0,5,1073,1.0,805.0,805.0
0.226,6,16,2670,8,1396,32.0,533.0,324.0,8,1274,20.0,529.0,212.0
0.004,17,2,136,1,60,0.0,32.0,32.0,1,76,0.0,48.0,48.0
0.025,6,10,1972,5,910,6.0,642.0,642.0,5,1062,6.0,794.0,794.0
240.497,6,33,8638,17,1839,15028.0,572.0,189.0,16,6799,16030.0,1402.0,597.0
0.007,6,10,1972,5,910,1.0,642.0,642.0,5,1062,1.0,794.0,794.0
0.005,6,14,3736,7,446,0.0,74.0,74.0,7,3290,0.0,1448.0,972.0
40.06,17,10,676,5,460,10014.0,104.0,64.0,5,216,10014.0,20.0,15.0
0.004,6,10,2007,5,928,1.0,660.0,660.0,5,1079,1.0,811.0,811.0
0.008,6,10,2006,5,927,1.0,659.0,659.0,5,1079,1.0,811.0,811.0
0.004,17,4,596,2,122,0.0,33.0,33.0,2,474,0.0,323.0,209.0
0.043,17,2,152,1,76,0.0,48.0,48.0,1,76,0.0,48.0,48.0
0.183,17,4,596,2,122,111.0,33.0,33.0,2,474,179.0,323.0,209.0
0.007,6,10,1972,5,910,1.0,642.0,642.0,5,1062,1.0,794.0,794.0
1786.446,6,240,35580,150,25920,11989.0,302.0,302.0,90,9660,20072.0,83.0,83.0
0.089,6,10,1506,5,395,19.0,127.0,127.0,5,1111,19.0,843.0,843.0
0.001,17,2,180,1,66,0.0,38.0,38.0,1,114,0.0,86.0,86.0
240.278,6,43,8771,22,5738,11441.0,1368.0,458.0,21,3033,12013.0,580.0,241.0
40.078,17,10,676,5,460,10016.0,104.0,64.0,5,216,10018.0,20.0,15.0
0.004,6,10,2006,5,927,1.0,659.0,659.0,5,1079,1.0,811.0,811.0
0.011,17,2,179,1,71,0.0,43.0,43.0,1,108,0.0,80.0,80.0
8.991,6,36,9771,19,4293,499.0,1360.0,700.0,17,5478,549.0,2667.0,435.0
0.005,6,10,2007,5,928,1.0,660.0,660.0,5,1079,1.0,811.0,811.0
0.004,6,10,1989,5,927,1.0,659.0,659.0,5,1062,1.0,794.0,794.0
178.18,17,74,10327,37,2472,4949.0,44.0,38.0,37,7855,4949.0,239.0,184.0
0.009,6,12,1926,6,1189,1.0,659.0,434.0,6,737,1.0,417.0,417.0
0.005,6,13,3747,7,509,0.0,137.0,137.0,6,3238,0.0,1470.0,1459.0
0.006,6,10,1547,5,764,1.0,496.0,496.0,5,783,1.0,515.0,515.0
0.009,6,10,1989,5,910,2.0,642.0,642.0,5,1079,2.0,811.0,811.0
0.009,6,10,1972,5,910,2.0,642.0,642.0,5,1062,2.0,794.0,794.0
0.004,17,2,136,1,60,0.0,32.0,32.0,1,76,0.0,48.0,48.0
0.008,6,12,1926,6,1189,1.0,659.0,434.0,6,737,1.0,417.0,417.0
0.003,17,2,148,1,60,0.0,32.0,32.0,1,88,0.0,60.0,60.0
0.104,6,10,1506,5,395,25.0,127.0,127.0,5,1111,25.0,843.0,843.0
240.096,6,32,9977,16,7375,16006.0,2449.0,727.0,16,2602,16006.0,580.0,220.0
9.037,17,6,376,5,280,2259.0,28.0,28.0,1,96,0.0,68.0,68.0
0.004,6,10,1989,5,927,1.0,659.0,659.0,5,1062,1.0,794.0,794.0
0.009,6,10,1762,5,911,2.0,643.0,643.0,5,851,2.0,583.0,583.0
0.241,17,37,20148,21,17025,12.0,1350.0,782.0,16,3123,12.0,1350.0,167.0
0.068,6,10,1506,5,395,14.0,127.0,127.0,5,1111,16.0,843.0,843.0
0.265,17,38,20163,21,17045,13.0,1350.0,783.0,17,3118,12.0,1350.0,155.0
0.004,6,10,2007,5,928,1.0,660.0,660.0,5,1079,1.0,811.0,811.0
0.008,6,10,1702,5,863,2.0,595.0,595.0,5,839,1.0,571.0,571.0
0.004,6,10,2007,5,928,1.0,660.0,660.0,5,1079,1.0,811.0,811.0
40.056,17,10,676,5,460,10010.0,104.0,64.0,5,216,10013.0,20.0,15.0
0.017,6,10,1972,5,910,4.0,642.0,642.0,5,1062,4.0,794.0,794.0
0.001,17,2,180,1,66,0.0,38.0,38.0,1,114,0.0,86.0,86.0
0.006,6,10,1643,5,860,1.0,592.0,592.0,5,783,1.0,515.0,515.0
0.005,6,10,1989,5,927,1.0,659.0,659.0,5,1062,1.0,794.0,794.0
300.393,6,16,2170,9,684,37528.0,146.0,146.0,7,1486,50037.0,419.0,398.0
240.08,6,21,4926,11,941,24008.0,180.0,93.0,10,3985,26675.0,1593.0,576.0
0.012,6,10,1983,5,910,3.0,642.0,642.0,5,1073,3.0,805.0,805.0
11.125,17,28,4421,14,1994,843.0,269.0,114.0,14,2427,843.0,586.0,145.0
0.005,6,13,3747,7,509,0.0,137.0,137.0,6,3238,0.0,1470.0,1459.0
0.006,6,10,1547,5,764,1.0,496.0,496.0,5,783,1.0,515.0,515.0
0.006,17,2,299,1,65,0.0,37.0,37.0,1,234,0.0,206.0,206.0
0.003,17,2,148,1,60,0.0,32.0,32.0,1,88,0.0,60.0,60.0
0.07,17,4,284,2,120,0.0,32.0,32.0,2,164,66.0,60.0,54.0
0.005,17,2,154,1,69,0.0,41.0,41.0,1,85,0.0,57.0,57.0
0.092,6,10,1506,5,395,21.0,127.0,127.0,5,1111,22.0,843.0,843.0
1799.85,6,136,6550,76,3625,23998.0,39.0,39.0,60,2925,29993.0,35.0,35.0
0.01,6,10,1677,5,827,2.0,559.0,559.0,5,850,2.0,582.0,582.0
110.349,6,36,8222,19,1791,6130.0,651.0,333.0,17,6431,536.0,2126.0,478.0
0.015,6,10,1972,5,910,3.0,642.0,642.0,5,1062,3.0,794.0,794.0
0.005,6,10,1547,5,764,1.0,496.0,496.0,5,783,1.0,515.0,515.0
0.124,17,2,128,1,56,0.0,28.0,28.0,1,72,0.0,44.0,44.0
0.061,17,2,152,1,76,0.0,48.0,48.0,1,76,0.0,48.0,48.0
0.007,6,10,1990,5,911,1.0,643.0,643.0,5,1079,1.0,811.0,811.0
0.001,17,2,180,1,66,0.0,38.0,38.0,1,114,0.0,86.0,86.0
1799.998,6,261,32011,104,22056,17475.0,1939.0,205.0,157,9955,11537.0,225.0,51.0
0.037,17,2,148,1,60,0.0,32.0,32.0,1,88,0.0,60.0,60.0
0.145,6,10,1506,5,395,31.0,127.0,127.0,5,1111,31.0,843.0,843.0
293.21,17,116,16578,58,3862,5143.0,44.0,38.0,58,12716,5143.0,239.0,191.0
0.005,6,10,2006,5,927,1.0,659.0,659.0,5,1079,1.0,811.0,811.0
0.042,17,2,152,1,76,0.0,48.0,48.0,1,76,0.0,48.0,48.0
0.005,6,10,2000,5,927,1.0,659.0,659.0,5,1073,1.0,805.0,805.0
0.009,6,10,1990,5,911,2.0,643.0,643.0,5,1079,2.0,811.0,811.0
0.013,6,10,1989,5,910,3.0,642.0,642.0,5,1079,3.0,811.0,811.0
40.076,17,10,676,5,460,10017.0,104.0,64.0,5,216,10017.0,20.0,15.0
0.041,17,4,364,2,160,0.0,52.0,52.0,2,204,1.0,80.0,74.0
11.023,17,28,4422,14,1994,839.0,269.0,114.0,14,2428,839.0,587.0,145.0
0.095,6,10,1506,5,395,22.0,127.0,127.0,5,1111,23.0,843.0,843.0
300.398,6,16,2170,9,684,37528.0,146.0,146.0,7,1486,50038.0,419.0,398.0
0.171,6,10,1506,5,395,32.0,127.0,127.0,5,1111,37.0,843.0,843.0
300.406,6,16,2170,9,684,37530.0,146.0,146.0,7,1486,50040.0,419.0,398.0
178.234,17,78,11242,39,2616,4690.0,44.0,39.0,39,8626,4690.0,279.0,193.0
0.014,6,10,1990,5,911,3.0,643.0,643.0,5,1079,3.0,811.0,811.0
0.004,6,10,2006,5,927,1.0,659.0,659.0,5,1079,1.0,811.0,811.0
0.238,6,16,2778,8,1396,34.0,533.0,324.0,8,1382,21.0,529.0,239.0
0.004,17,4,284,2,120,0.0,32.0,32.0,2,164,0.0,60.0,54.0
0.005,6,10,1689,5,839,1.0,571.0,571.0,5,850,1.0,582.0,582.0
0.005,6,10,2006,5,927,1.0,659.0,659.0,5,1079,1.0,811.0,811.0
0.001,17,2,164,1,74,0.0,46.0,46.0,1,90,0.0,62.0,62.0
0.006,17,2,214,1,75,0.0,47.0,47.0,1,139,0.0,111.0,111.0
240.138,6,45,6716,22,3226,11435.0,588.0,230.0,23,3490,10915.0,580.0,228.0
0.004,6,10,2007,5,928,1.0,660.0,660.0,5,1079,1.0,811.0,811.0
0.025,6,10,1972,5,910,6.0,642.0,642.0,5,1062,6.0,794.0,794.0
0.039,17,2,148,1,60,0.0,32.0,32.0,1,88,0.0,60.0,60.0
0.009,6,13,3735,7,497,1.0,125.0,125.0,6,3238,1.0,1470.0,1459.0
0.008,6,10,1983,5,910,2.0,642.0,642.0,5,1073,2.0,805.0,805.0
0.005,6,10,1854,5,889,1.0,621.0,621.0,5,965,1.0,697.0,697.0
0.017,6,14,3787,7,497,2.0,125.0,125.0,7,3290,2.0,1448.0,972.0
0.014,6,10,1972,5,910,3.0,642.0,642.0,5,1062,3.0,794.0,794.0
0.015,17,2,198,1,91,0.0,63.0,63.0,1,107,0.0,79.0,79.0
0.016,6,10,1983,5,910,3.0,642.0,642.0,5,1073,4.0,805.0,805.0
0.008,6,10,1643,5,860,1.0,592.0,592.0,5,783,1.0,515.0,515.0
0.101,6,10,1506,5,395,22.0,127.0,127.0,5,1111,21.0,843.0,843.0
0.003,17,2,148,1,60,0.0,32.0,32.0,1,88,0.0,60.0,60.0
0.005,6,10,2006,5,927,1.0,659.0,659.0,5,1079,1.0,811.0,811.0
0.035,6,10,1990,5,911,8.0,643.0,643.0,5,1079,8.0,811.0,811.0
0.097,6,10,1506,5,395,15.0,127.0,127.0,5,1111,22.0,843.0,843.0
0.038,17,2,412,1,61,0.0,33.0,33.0,1,351,0.0,323.0,323.0
0.005,6,10,1854,5,889,1.0,621.0,621.0,5,965,1.0,697.0,697.0
300.025,6,12,1782,7,1348,50004.0,494.0,494.0,5,434,75005.0,83.0,83.0
0.038,17,2,148,1,60,0.0,32.0,32.0,1,88,0.0,60.0,60.0
0.014,6,10,1990,5,911,3.0,643.0,643.0,5,1079,3.0,811.0,811.0
0.004,6,10,2000,5,927,1.0,659.0,659.0,5,1073,1.0,805.0,805.0
0.006,6,10,1854,5,889,1.0,621.0,621.0,5,965,1.0,697.0,697.0
0.006,6,10,1547,5,764,1.0,496.0,496.0,5,783,1.0,515.0,515.0
0.005,6,10,1689,5,839,1.0,571.0,571.0,5,850,1.0,582.0,582.0
0.087,6,10,1506,5,395,18.0,127.0,127.0,5,1111,18.0,843.0,843.0
0.003,17,2,132,1,58,0.0,30.0,30.0,1,74,0.0,46.0,46.0
0.009,6,10,1762,5,911,2.0,643.0,643.0,5,851,2.0,583.0,583.0
0.015,6,10,1989,5,910,3.0,642.0,642.0,5,1079,3.0,811.0,811.0
0.006,6,10,1854,5,889,1.0,621.0,621.0,5,965,1.0,697.0,697.0
0.11,6,10,1506,5,395,24.0,127.0,127.0,5,1111,25.0,843.0,843.0
0.004,6,10,2000,5,927,1.0,659.0,659.0,5,1073,1.0,805.0,805.0
300.363,6,27,7433,16,1409,20024.0,217.0,142.0,11,6024,24031.0,1679.0,777.0
0.008,6,10,1989,5,910,2.0,642.0,642.0,5,1079,1.0,811.0,811.0
0.009,6,10,1972,5,910,2.0,642.0,642.0,5,1062,2.0,794.0,794.0
0.014,6,10,1989,5,910,3.0,642.0,642.0,5,1079,3.0,811.0,811.0
0.004,17,2,136,1,60,0.0,32.0,32.0,1,76,0.0,48.0,48.0
0.004,6,10,1702,5,863,0.0,595.0,595.0,5,839,1.0,571.0,571.0
0.022,6,13,3735,7,497,3.0,125.0,125.0,6,3238,4.0,1470.0,1459.0
0.074,6,10,1506,5,395,16.0,127.0,127.0,5,1111,15.0,843.0,843.0
240.086,6,16,4482,9,963,30010.0,238.0,166.0,7,3519,40013.0,1402.0,786.0
0.023,6,10,1677,5,827,5.0,559.0,559.0,5,850,5.0,582.0,582.0
0.006,6,10,1547,5,764,1.0,496.0,496.0,5,783,1.0,515.0,515.0
0.005,6,10,2007,5,928,1.0,660.0,660.0,5,1079,1.0,811.0,811.0
0.009,17,2,194,1,59,0.0,31.0,31.0,1,135,0.0,107.0,107.0
0.127,6,10,1506,5,395,28.0,127.0,127.0,5,1111,26.0,843.0,843.0
0.101,6,10,1506,5,395,22.0,127.0,127.0,5,1111,22.0,843.0,843.0
0.005,6,10,2000,5,927,1.0,659.0,659.0,5,1073,1.0,805.0,805.0
0.079,6,10,1506,5,395,15.0,127.0,127.0,5,1111,19.0,843.0,843.0
0.005,6,10,2006,5,927,1.0,659.0,659.0,5,1079,1.0,811.0,811.0
0.009,6,10,1989,5,910,2.0,642.0,642.0,5,1079,2.0,811.0,811.0
0.006,6,10,1547,5,764,1.0,496.0,496.0,5,783,1.0,515.0,515.0
0.065,6,10,1506,5,395,15.0,127.0,127.0,5,1111,14.0,843.0,843.0
66.563,6,24,11976,13,5359,5546.0,2804.0,935.0,11,6617,6639.0,2111.0,1006.0
0.02,6,10,1972,5,910,4.0,642.0,642.0,5,1062,4.0,794.0,794.0
0.012,6,10,1990,5,911,2.0,643.0,643.0,5,1079,2.0,811.0,811.0
0.015,6,14,3787,7,497,2.0,125.0,125.0,7,3290,2.0,1448.0,972.0
0.005,6,13,3747,7,509,0.0,137.0,137.0,6,3238,1.0,1470.0,1459.0
0.066,6,10,1506,5,395,14.0,127.0,127.0,5,1111,13.0,843.0,843.0
0.005,6,10,2000,5,927,1.0,659.0,659.0,5,1073,1.0,805.0,805.0
0.015,6,10,1983,5,910,3.0,642.0,642.0,5,1073,3.0,805.0,805.0
0.001,17,2,180,1,66,0.0,38.0,38.0,1,114,0.0,86.0,86.0
240.018,6,9,787,5,488,60004.0,232.0,232.0,4,299,80005.0,83.0,83.0
0.005,17,2,157,1,59,0.0,31.0,31.0,1,98,0.0,70.0,70.0
0.097,17,2,144,1,64,0.0,36.0,36.0,1,80,0.0,52.0,52.0
368.667,6,22,2313,16,867,24577.0,195.0,195.0,6,1446,4642.0,419.0,398.0
0.221,17,14,8577,7,4012,36.0,1350.0,545.0,7,4565,27.0,1350.0,624.0
0.005,6,10,1989,5,927,1.0,659.0,659.0,5,1062,1.0,794.0,794.0
0.005,17,2,170,1,65,0.0,37.0,37.0,1,105,0.0,77.0,77.0
0.059,17,2,152,1,76,0.0,48.0,48.0,1,76,0.0,48.0,48.0
0.013,6,10,1972,5,910,3.0,642.0,642.0,5,1062,3.0,794.0,794.0
0.008,6,12,1926,6,1189,1.0,659.0,434.0,6,737,1.0,417.0,417.0
0.001,17,2,180,1,66,0.0,38.0,38.0,1,114,0.0,86.0,86.0
0.013,6,10,1990,5,911,3.0,643.0,643.0,5,1079,3.0,811.0,811.0
0.015,6,10,1989,5,910,3.0,642.0,642.0,5,1079,3.0,811.0,811.0
0.009,6,10,1677,5,827,2.0,559.0,559.0,5,850,2.0,582.0,582.0
0.038,17,2,148,1,60,0.0,32.0,32.0,1,88,0.0,60.0,60.0
0.068,6,10,1506,5,395,15.0,127.0,127.0,5,1111,13.0,843.0,843.0
0.007,17,2,213,1,69,0.0,41.0,41.0,1,144,0.0,116.0,116.0
0.004,6,10,2006,5,927,1.0,659.0,659.0,5,1079,1.0,811.0,811.0
0.079,6,10,1506,5,395,13.0,127.0,127.0,5,1111,19.0,843.0,843.0
0.009,6,10,2007,5,928,2.0,660.0,660.0,5,1079,2.0,811.0,811.0
0.099,6,10,1506,5,395,22.0,127.0,127.0,5,1111,21.0,843.0,843.0
0.005,6,10,1854,5,889,1.0,621.0,621.0,5,965,1.0,697.0,697.0
0.041,17,2,152,1,76,0.0,48.0,48.0,1,76,0.0,48.0,48.0
0.039,17,2,148,1,60,0.0,32.0,32.0,1,88,0.0,60.0,60.0
0.039,17,2,152,1,76,0.0,48.0,48.0,1,76,0.0,48.0,48.0
0.119,6,10,1506,5,395,24.0,127.0,127.0,5,1111,26.0,843.0,843.0
0.104,6,10,1506,5,395,23.0,127.0,127.0,5,1111,24.0,843.0,843.0
0.004,6,10,2007,5,928,1.0,660.0,660.0,5,1079,1.0,811.0,811.0
0.005,6,14,3742,7,452,0.0,80.0,80.0,7,3290,0.0,1448.0,972.0
0.007,6,12,1698,6,863,1.0,327.0,271.0,6,835,1.0,515.0,515.0
240.544,6,33,8635,17,1836,15031.0,569.0,188.0,16,6799,16034.0,1402.0,597.0
10.777,17,28,4423,14,1994,820.0,269.0,114.0,14,2429,820.0,588.0,145.0
1769.882,6,83,4368,42,2210,43166.0,26.0,26.0,41,2158,44246.0,26.0,26.0
177.123,17,76,10718,38,2537,4787.0,44.0,38.0,38,8181,4787.0,239.0,187.0
0.008,6,10,1989,5,910,2.0,642.0,642.0,5,1079,2.0,811.0,811.0
0.005,6,10,2006,5,927,1.0,659.0,659.0,5,1079,1.0,811.0,811.0
351.988,6,20,2210,6,1308,12003.0,494.0,494.0,14,902,27075.0,83.0,83.0
0.01,6,10,1990,5,911,2.0,643.0,643.0,5,1079,2.0,811.0,811.0
0.07,17,8,3613,4,1874,23.0,1350.0,440.0,4,1739,12.0,1350.0,406.0
1727.943,6,45,2790,30,1725,59584.0,35.0,35.0,15,1065,123417.0,31.0,31.0
40.068,17,10,676,5,460,10013.0,104.0,64.0,5,216,10016.0,20.0,15.0
242.54,6,353,362847,162,20465,1506.0,2736.0,958.0,191,342382,1276.0,2804.0,1846.0
0.013,6,10,1677,5,827,3.0,559.0,559.0,5,850,3.0,582.0,582.0
0.038,17,2,136,1,60,0.0,32.0,32.0,1,76,0.0,48.0,48.0
0.013,6,10,1989,5,910,3.0,642.0,642.0,5,1079,3.0,811.0,811.0
0.013,6,13,3735,7,497,2.0,125.0,125.0,6,3238,2.0,1470.0,1459.0
240.085,6,16,4482,9,963,30010.0,238.0,166.0,7,3519,40013.0,1402.0,786.0
0.004,6,10,1702,5,863,1.0,595.0,595.0,5,839,1.0,571.0,571.0
0.116,6,10,1506,5,395,27.0,127.0,127.0,5,1111,27.0,843.0,843.0
1799.76,6,136,6550,76,3625,23996.0,39.0,39.0,60,2925,29990.0,35.0,35.0
321.455,17,20,1124,10,716,35705.0,48.0,43.0,10,408,35705.0,20.0,12.0
0.093,6,10,1506,5,395,20.0,127.0,127.0,5,1111,18.0,843.0,843.0
0.012,6,10,1972,5,910,3.0,642.0,642.0,5,1062,3.0,794.0,794.0
308.704,17,20,1124,10,716,34286.0,48.0,43.0,10,408,34286.0,20.0,12.0
0.004,6,10,2007,5,928,1.0,660.0,660.0,5,1079,1.0,811.0,811.0
0.012,6,10,1983,5,910,3.0,642.0,642.0,5,1073,3.0,805.0,805.0
0.012,6,10,1989,5,910,3.0,642.0,642.0,5,1079,3.0,811.0,811.0
0.014,6,10,1989,5,910,3.0,642.0,642.0,5,1079,3.0,811.0,811.0
10.798,17,28,4423,14,1994,822.0,269.0,114.0,14,2429,822.0,588.0,145.0
0.013,6,10,1989,5,910,3.0,642.0,642.0,5,1079,3.0,811.0,811.0
0.005,6,10,2007,5,928,1.0,660.0,660.0,5,1079,1.0,811.0,811.0
240.093,6,16,4481,9,963,30011.0,238.0,166.0,7,3518,40015.0,1402.0,786.0
0.012,6,10,1677,5,827,3.0,559.0,559.0,5,850,3.0,582.0,582.0
0.22,6,16,2669,8,1395,31.0,533.0,323.0,8,1274,20.0,529.0,212.0
0.004,6,10,1779,5,928,1.0,660.0,660.0,5,851,1.0,583.0,583.0
0.001,17,2,179,1,62,0.0,34.0,34.0,1,117,0.0,89.0,89.0
0.044,17,2,152,1,76,0.0,48.0,48.0,1,76,0.0,48.0,48.0
240.129,6,16,4481,9,963,30016.0,238.0,166.0,7,3518,40019.0,1402.0,786.0
40.069,17,10,676,5,460,10015.0,104.0,64.0,5,216,10016.0,20.0,15.0
361.829,6,19,1688,15,978,25844.0,190.0,190.0,4,710,80013.0,494.0,494.0
0.006,6,10,1643,5,860,1.0,592.0,592.0,5,783,1.0,515.0,515.0
0.01,6,6,716,3,458,3.0,302.0,302.0,3,258,3.0,102.0,102.0
0.004,6,10,2006,5,927,1.0,659.0,659.0,5,1079,1.0,811.0,811.0
0.009,6,10,1972,5,910,2.0,642.0,642.0,5,1062,2.0,794.0,794.0
0.014,6,10,1762,5,911,3.0,643.0,643.0,5,851,3.0,583.0,583.0
0.006,17,2,140,1,62,0.0,34.0,34.0,1,78,0.0,50.0,50.0
0.006,6,10,1547,5,764,1.0,496.0,496.0,5,783,1.0,515.0,515.0
40.05,17,10,676,5,460,10011.0,104.0,64.0,5,216,10011.0,20.0,15.0
0.007,6,10,1547,5,764,1.0,496.0,496.0,5,783,1.0,515.0,515.0
0.011,6,10,1989,5,910,2.0,642.0,642.0,5,1079,2.0,811.0,811.0
0.005,6,10,2006,5,927,1.0,659.0,659.0,5,1079,1.0,811.0,811.0
0.17,6,3,453,2,321,170.0,241.0,241.0,1,132,0.0,92.0,92.0
0.085,6,10,1506,5,395,20.0,127.0,127.0,5,1111,18.0,843.0,843.0
0.016,6,10,1972,5,910,4.0,642.0,642.0,5,1062,4.0,794.0,794.0
0.093,6,10,1506,5,395,20.0,127.0,127.0,5,1111,19.0,843.0,843.0
0.011,6,13,3913,7,495,1.0,123.0,123.0,6,3418,2.0,1650.0,1549.0
0.004,17,2,166,1,75,0.0,47.0,47.0,1,91,0.0,63.0,63.0
0.001,17,2,180,1,66,0.0,38.0,38.0,1,114,0.0,86.0,86.0
0.005,6,10,2006,5,927,1.0,659.0,659.0,5,1079,1.0,811.0,811.0
0.005,6,10,2006,5,927,1.0,659.0,659.0,5,1079,1.0,811.0,811.0
0.071,17,2,184,1,61,0.0,33.0,33.0,1,123,0.0,95.0,95.0
0.004,17,4,284,2,120,1.0,32.0,32.0,2,164,0.0,60.0,54.0
0.005,17,2,166,1,75,0.0,47.0,47.0,1,91,0.0,63.0,63.0
0.011,6,10,1972,5,910,2.0,642.0,642.0,5,1062,2.0,794.0,794.0
40.066,17,10,676,5,460,10014.0,104.0,64.0,5,216,10014.0,20.0,15.0
300.323,6,16,2170,9,684,37520.0,146.0,146.0,7,1486,50025.0,419.0,398.0
0.038,17,2,136,1,60,0.0,32.0,32.0,1,76,0.0,48.0,48.0
0.001,17,2,184,1,68,0.0,40.0,40.0,1,116,0.0,88.0,88.0
0.013,6,10,2007,5,928,3.0,660.0,660.0,5,1079,3.0,811.0,811.0
0.02,17,2,180,1,66,0.0,38.0,38.0,1,114,0.0,86.0,86.0
0.005,6,10,1774,5,923,1.0,655.0,655.0,5,851,1.0,583.0,583.0
0.005,17,2,214,1,75,0.0,47.0,47.0,1,139,0.0,111.0,111.0
0.005,17,2,170,1,65,0.0,37.0,37.0,1,105,0.0,77.0,77.0
0.005,6,10,2006,5,927,1.0,659.0,659.0,5,1079,1.0,811.0,811.0
0.008,17,2,194,1,59,0.0,31.0,31.0,1,135,0.0,107.0,107.0
0.015,6,10,1989,5,910,3.0,642.0,642.0,5,1079,3.0,811.0,811.0
0.016,6,10,1972,5,910,4.0,642.0,642.0,5,1062,3.0,794.0,794.0
0.1,6,10,1506,5,395,20.0,127.0,127.0,5,1111,23.0,843.0,843.0
240.098,6,16,4482,9,963,30012.0,238.0,166.0,7,3519,40015.0,1402.0,786.0
0.008,6,10,1989,5,910,2.0,642.0,642.0,5,1079,2.0,811.0,811.0
0.042,17,2,136,1,60,0.0,32.0,32.0,1,76,0.0,48.0,48.0
0.014,6,10,1990,5,911,3.0,643.0,643.0,5,1079,3.0,811.0,811.0
0.004,6,10,2006,5,927,1.0,659.0,659.0,5,1079,1.0,811.0,811.0
0.015,6,10,1762,5,911,3.0,643.0,643.0,5,851,3.0,583.0,583.0
0.006,6,10,2007,5,928,1.0,660.0,660.0,5,1079,1.0,811.0,811.0
0.011,6,12,1926,6,1189,2.0,659.0,434.0,6,737,2.0,417.0,417.0
0.006,6,10,1547,5,764,1.0,496.0,496.0,5,783,1.0,515.0,515.0
0.053,6,13,3735,7,497,8.0,125.0,125.0,6,3238,10.0,1470.0,1459.0
0.003,17,4,284,2,120,0.0,32.0,32.0,2,164,0.0,60.0,54.0
0.204,6,16,2669,8,1395,29.0,533.0,323.0,8,1274,18.0,529.0,212.0
0.005,6,10,2007,5,928,1.0,660.0,660.0,5,1079,1.0,811.0,811.0
0.076,6,10,1506,5,395,18.0,127.0,127.0,5,1111,14.0,843.0,843.0
1771.599,17,120,11460,60,5460,30026.0,63.0,63.0,60,6000,30026.0,72.0,72.0
0.004,6,10,1702,5,863,1.0,595.0,595.0,5,839,1.0,571.0,571.0
0.005,6,10,1989,5,927,1.0,659.0,659.0,5,1062,1.0,794.0,794.0
0.004,6,10,1702,5,863,1.0,595.0,595.0,5,839,0.0,571.0,571.0
0.005,6,10,2006,5,927,1.0,659.0,659.0,5,1079,1.0,811.0,811.0
0.008,6,10,1689,5,839,1.0,571.0,571.0,5,850,1.0,582.0,582.0
0.019,6,10,1989,5,910,4.0,642.0,642.0,5,1079,4.0,811.0,811.0
0.005,6,10,2007,5,928,1.0,660.0,660.0,5,1079,1.0,811.0,811.0
0.005,6,10,2007,5,928,1.0,660.0,660.0,5,1079,1.0,811.0,811.0
0.072,17,2,412,1,61,0.0,33.0,33.0,1,351,0.0,323.0,323.0
0.019,6,10,1972,5,910,4.0,642.0,642.0,5,1062,4.0,794.0,794.0
1730.409,6,45,2790,30,1725,59669.0,35.0,35.0,15,1065,123595.0,31.0,31.0
10.846,17,28,4423,14,1995,826.0,270.0,114.0,14,2428,825.0,587.0,145.0
0.006,6,10,2000,5,927,1.0,659.0,659.0,5,1073,1.0,805.0,805.0
0.087,6,10,1506,5,395,20.0,127.0,127.0,5,1111,18.0,843.0,843.0
0.005,6,10,2007,5,928,1.0,660.0,660.0,5,1079,1.0,811.0,811.0
0.082,6,10,1506,5,395,19.0,127.0,127.0,5,1111,17.0,843.0,843.0
0.014,6,10,1631,5,848,3.0,580.0,580.0,5,783,3.0,515.0,515.0
0.077,6,10,1506,5,395,17.0,127.0,127.0,5,1111,16.0,843.0,843.0
0.039,17,4,596,2,122,0.0,33.0,33.0,2,474,36.0,323.0,209.0
0.151,6,10,1506,5,395,33.0,127.0,127.0,5,1111,24.0,843.0,843.0
368.012,6,22,2313,16,867,24534.0,195.0,195.0,6,1446,4635.0,419.0,398.0
0.007,6,10,1989,5,910,1.0,642.0,642.0,5,1079,1.0,811.0,811.0
0.005,6,10,1989,5,927,1.0,659.0,659.0,5,1062,1.0,794.0,794.0
0.019,17,2,136,1,60,0.0,32.0,32.0,1,76,0.0,48.0,48.0
0.096,6,10,1506,5,395,19.0,127.0,127.0,5,1111,22.0,843.0,843.0
173.559,17,82,11965,41,2734,4338.0,44.0,38.0,41,9231,4338.0,261.0,197.0
0.005,6,10,2007,5,928,1.0,660.0,660.0,5,1079,1.0,811.0,811.0
0.005,17,2,148,1,60,0.0,32.0,32.0,1,88,0.0,60.0,60.0
0.003,17,2,136,1,60,0.0,32.0,32.0,1,76,0.0,48.0,48.0
567.15,6,46,13525,20,5840,29849.0,1026.0,684.0,26,7685,22685.0,1162.0,372.0
1798.801,6,322,51486,134,30977,13523.0,1939.0,241.0,188,20509,9618.0,1360.0,149.0
361.845,6,21,1793,16,1030,24123.0,190.0,190.0,5,763,60009.0,462.0,247.0
10.92,17,28,4422,14,1995,831.0,270.0,114.0,14,2427,831.0,586.0,145.0
0.005,17,2,136,1,60,0.0,32.0,32.0,1,76,0.0,48.0,48.0
0.004,6,10,1702,5,863,1.0,595.0,595.0,5,839,0.0,571.0,571.0
0.072,17,4,284,2,120,0.0,32.0,32.0,2,164,67.0,60.0,54.0
10.815,17,28,4417,14,1993,823.0,268.0,114.0,14,2424,823.0,587.0,145.0
0.001,17,2,178,1,81,0.0,53.0,53.0,1,97,0.0,69.0,69.0
0.01,6,10,1983,5,910,2.0,642.0,642.0,5,1073,2.0,805.0,805.0
0.001,17,2,180,1,66,0.0,38.0,38.0,1,114,0.0,86.0,86.0
0.074,17,4,420,2,122,0.0,33.0,33.0,2,298,34.0,145.0,121.0
0.012,6,10,1990,5,911,2.0,643.0,643.0,5,1079,3.0,811.0,811.0
0.004,6,10,1990,5,928,1.0,660.0,660.0,5,1062,1.0,794.0,794.0
0.004,6,10,2000,5,927,1.0,659.0,659.0,5,1073,1.0,805.0,805.0
0.001,17,2,136,1,60,0.0,32.0,32.0,1,76,0.0,48.0,48.0
0.052,17,2,152,1,76,0.0,48.0,48.0,1,76,0.0,48.0,48.0
0.011,6,10,1989,5,910,2.0,642.0,642.0,5,1079,2.0,811.0,811.0
0.004,6,14,3742,7,452,0.0,80.0,80.0,7,3290,0.0,1448.0,972.0
0.005,17,2,164,1,74,0.0,46.0,46.0,1,90,0.0,62.0,62.0
0.006,6,10,1643,5,860,1.0,592.0,592.0,5,783,1.0,515.0,515.0
0.07,17,8,3613,4,1874,23.0,1350.0,440.0,4,1739,12.0,1350.0,406.0
0.004,6,10,2007,5,928,1.0,660.0,660.0,5,1079,1.0,811.0,811.0
40.06,17,10,676,5,460,10013.0,104.0,64.0,5,216,10014.0,20.0,15.0
0.014,6,10,1983,5,910,3.0,642.0,642.0,5,1073,3.0,805.0,805.0
40.052,17,10,676,5,460,10012.0,104.0,64.0,5,216,10012.0,20.0,15.0
0.005,6,10,2007,5,928,1.0,660.0,660.0,5,1079,1.0,811.0,811.0
0.131,6,10,1506,5,395,29.0,127.0,127.0,5,1111,31.0,843.0,843.0
0.003,17,2,152,1,76,0.0,48.0,48.0,1,76,0.0,48.0,48.0
65.662,6,22,8550,12,2328,5969.0,1002.0,424.0,10,6222,7277.0,2241.0,949.0
291.457,6,388,347606,195,21690,1502.0,2736.0,887.0,193,325916,1517.0,2804.0,1764.0
0.008,6,10,1631,5,848,2.0,580.0,580.0,5,783,2.0,515.0,515.0
11.073,17,28,4393,14,2311,842.0,586.0,137.0,14,2082,842.0,269.0,120.0
0.005,6,10,2000,5,927,1.0,659.0,659.0,5,1073,1.0,805.0,805.0
0.029,6,10,1989,5,910,7.0,642.0,642.0,5,1079,7.0,811.0,811.0
0.004,6,10,2000,5,927,1.0,659.0,659.0,5,1073,1.0,805.0,805.0
0.101,6,10,1506,5,395,22.0,127.0,127.0,5,1111,20.0,843.0,843.0
0.005,17,2,180,1,58,0.0,30.0,30.0,1,122,0.0,94.0,94.0
0.003,17,2,136,1,60,0.0,32.0,32.0,1,76,0.0,48.0,48.0
0.005,17,2,148,1,60,0.0,32.0,32.0,1,88,0.0,60.0,60.0
40.059,17,10,676,5,460,10014.0,104.0,64.0,5,216,10014.0,20.0,15.0
0.012,6,10,1631,5,848,3.0,580.0,580.0,5,783,3.0,515.0,515.0
0.041,6,10,1989,5,910,10.0,642.0,642.0,5,1079,10.0,811.0,811.0
0.01,6,10,1983,5,910,2.0,642.0,642.0,5,1073,2.0,805.0,805.0
0.012,6,10,1983,5,910,3.0,642.0,642.0,5,1073,2.0,805.0,805.0
0.009,6,10,1990,5,911,2.0,643.0,643.0,5,1079,2.0,811.0,811.0
0.001,17,2,146,1,65,0.0,37.0,37.0,1,81,0.0,53.0,53.0
0.004,17,2,136,1,60,0.0,32.0,32.0,1,76,0.0,48.0,48.0
0.061,17,2,152,1,76,0.0,48.0,48.0,1,76,0.0,48.0,48.0
0.065,6,10,1506,5,395,15.0,127.0,127.0,5,1111,13.0,843.0,843.0
0.061,6,10,1506,5,395,13.0,127.0,127.0,5,1111,13.0,843.0,843.0
242.182,6,308,342968,122,17860,2001.0,2736.0,886.0,186,325108,1309.0,2804.0,1792.0
264.297,6,284,342523,110,17231,2424.0,2736.0,885.0,174,325292,1527.0,2804.0,1916.0
0.006,6,10,1643,5,860,1.0,592.0,592.0,5,783,1.0,515.0,515.0
0.005,17,2,214,1,75,0.0,47.0,47.0,1,139,0.0,111.0,111.0
0.005,6,10,1547,5,764,1.0,496.0,496.0,5,783,1.0,515.0,515.0
126.047,6,15,2978,8,2504,17973.0,1414.0,1086.0,7,474,20968.0,182.0,182.0
0.004,6,10,1989,5,927,1.0,659.0,659.0,5,1062,1.0,794.0,794.0
0.096,6,10,1506,5,395,21.0,127.0,127.0,5,1111,20.0,843.0,843.0
0.207,6,10,1506,5,395,43.0,127.0,127.0,5,1111,48.0,843.0,843.0
296.53,6,403,349845,193,22241,1544.0,2692.0,871.0,210,327604,1418.0,2804.0,1623.0
0.014,6,13,3747,7,509,2.0,137.0,137.0,6,3238,2.0,1470.0,1459.0
0.115,6,10,1506,5,395,27.0,127.0,127.0,5,1111,24.0,843.0,843.0
0.013,6,10,1990,5,911,3.0,643.0,643.0,5,1079,3.0,811.0,811.0
0.005,6,10,1689,5,839,1.0,571.0,571.0,5,850,1.0,582.0,582.0
0.017,6,10,1983,5,910,4.0,642.0,642.0,5,1073,4.0,805.0,805.0
0.005,17,2,170,1,65,0.0,37.0,37.0,1,105,0.0,77.0,77.0
0.031,6,10,1989,5,910,7.0,642.0,642.0,5,1079,7.0,811.0,811.0
0.042,17,2,152,1,76,0.0,48.0,48.0,1,76,0.0,48.0,48.0
0.004,6,10,2006,5,927,1.0,659.0,659.0,5,1079,1.0,811.0,811.0
40.055,17,10,676,5,460,10013.0,104.0,64.0,5,216,10013.0,20.0,15.0
0.013,6,10,1972,5,910,3.0,642.0,642.0,5,1062,3.0,794.0,794.0
0.006,6,10,1689,5,839,1.0,571.0,571.0,5,850,1.0,582.0,582.0
240.01,6,9,787,5,488,60002.0,232.0,232.0,4,299,80002.0,83.0,83.0
240.086,6,16,4481,9,963,30010.0,238.0,166.0,7,3518,40013.0,1402.0,786.0
0.072,6,10,1506,5,395,15.0,127.0,127.0,5,1111,15.0,843.0,843.0
0.083,6,10,1506,5,395,19.0,127.0,127.0,5,1111,18.0,843.0,843.0
11.08,17,28,4422,14,1995,843.0,270.0,114.0,14,2427,843.0,586.0,145.0
0.069,6,10,1506,5,395,12.0,127.0,127.0,5,1111,15.0,843.0,843.0
40.088,17,10,676,5,460,10019.0,104.0,64.0,5,216,10021.0,20.0,15.0
0.003,17,2,148,1,60,0.0,32.0,32.0,1,88,0.0,60.0,60.0
0.015,6,10,1989,5,910,3.0,642.0,642.0,5,1079,3.0,811.0,811.0
0.019,6,10,1990,5,911,4.0,643.0,643.0,5,1079,4.0,811.0,811.0
0.012,6,10,1972,5,910,2.0,642.0,642.0,5,1062,3.0,794.0,794.0
0.006,6,10,1547,5,764,1.0,496.0,496.0,5,783,1.0,515.0,515.0
0.004,6,10,1702,5,863,1.0,595.0,595.0,5,839,0.0,571.0,571.0
0.006,6,10,1643,5,860,1.0,592.0,592.0,5,783,1.0,515.0,515.0
0.006,6,10,1689,5,839,1.0,571.0,571.0,5,850,1.0,582.0,582.0
0.005,6,10,2007,5,928,1.0,660.0,660.0,5,1079,1.0,811.0,811.0
0.127,17,4,352,2,130,0.0,37.0,37.0,2,222,88.0,89.0,83.0
40.052,17,10,676,5,460,10012.0,104.0,64.0,5,216,10012.0,20.0,15.0
0.111,6,10,1506,5,395,24.0,127.0,127.0,5,1111,24.0,843.0,843.0
0.001,17,2,164,1,74,0.0,46.0,46.0,1,90,0.0,62.0,62.0
0.006,6,10,1689,5,839,1.0,571.0,571.0,5,850,1.0,582.0,582.0
240.202,6,32,11802,15,5363,17157.0,1368.0,762.0,17,6439,15012.0,1593.0,553.0
0.005,6,10,1689,5,839,1.0,571.0,571.0,5,850,1.0,582.0,582.0
0.005,17,2,193,1,71,0.0,43.0,43.0,1,122,0.0,94.0,94.0
0.006,6,10,1643,5,860,1.0,592.0,592.0,5,783,1.0,515.0,515.0
0.012,6,10,1989,5,910,3.0,642.0,642.0,5,1079,3.0,811.0,811.0
0.009,6,10,1762,5,911,2.0,643.0,643.0,5,851,2.0,583.0,583.0
0.071,17,2,148,1,60,0.0,32.0,32.0,1,88,0.0,60.0,60.0
0.005,17,2,164,1,74,0.0,46.0,46.0,1,90,0.0,62.0,62.0
0.005,6,10,1989,5,927,1.0,659.0,659.0,5,1062,1.0,794.0,794.0
0.135,17,2,80,1,32,0.0,4.0,4.0,1,48,0.0,20.0,20.0
0.009,6,14,3787,7,497,1.0,125.0,125.0,7,3290,1.0,1448.0,972.0
0.016,17,2,198,1,91,0.0,63.0,63.0,1,107,0.0,79.0,79.0
0.01,6,10,1677,5,827,2.0,559.0,559.0,5,850,2.0,582.0,582.0
0.094,17,8,3613,4,1874,31.0,1350.0,440.0,4,1739,9.0,1350.0,406.0
0.003,17,2,136,1,60,0.0,32.0,32.0,1,76,0.0,48.0,48.0
0.074,6,10,1506,5,395,15.0,127.0,127.0,5,1111,17.0,843.0,843.0
0.075,6,10,1506,5,395,16.0,127.0,127.0,5,1111,14.0,843.0,843.0
1779.141,17,142,44872,72,22752,25056.0,288.0,288.0,70,22120,25783.0,288.0,288.0
0.018,6,10,1677,5,827,4.0,559.0,559.0,5,850,4.0,582.0,582.0
0.009,6,10,1989,5,910,2.0,642.0,642.0,5,1079,2.0,811.0,811.0
0.006,6,10,1547,5,764,1.0,496.0,496.0,5,783,1.0,515.0,515.0
0.006,6,10,1689,5,839,1.0,571.0,571.0,5,850,1.0,582.0,582.0
0.005,6,13,3747,7,509,0.0,137.0,137.0,6,3238,0.0,1470.0,1459.0
0.005,6,10,2000,5,927,1.0,659.0,659.0,5,1073,1.0,805.0,805.0
0.006,17,2,157,1,59,0.0,31.0,31.0,1,98,0.0,70.0,70.0
0.006,6,10,2000,5,927,1.0,659.0,659.0,5,1073,1.0,805.0,805.0
0.013,6,10,1989,5,910,3.0,642.0,642.0,5,1079,3.0,811.0,811.0
0.014,6,10,1990,5,911,3.0,643.0,643.0,5,1079,3.0,811.0,811.0
0.003,17,2,148,1,60,0.0,32.0,32.0,1,88,0.0,60.0,60.0
0.011,6,13,3735,7,497,1.0,125.0,125.0,6,3238,2.0,1470.0,1459.0
0.005,6,10,2007,5,928,1.0,660.0,660.0,5,1079,1.0,811.0,811.0
0.014,6,10,1972,5,910,3.0,642.0,642.0,5,1062,3.0,794.0,794.0
240.34,6,24,3846,11,1756,24030.0,539.0,235.0,13,2090,20025.0,1044.0,202.0
0.009,6,11,2041,6,962,1.0,642.0,642.0,5,1079,2.0,811.0,811.0
0.09,6,10,1506,5,395,19.0,127.0,127.0,5,1111,19.0,843.0,843.0
0.011,6,10,1631,5,848,2.0,580.0,580.0,5,783,2.0,515.0,515.0
0.004,6,10,1989,5,927,1.0,659.0,659.0,5,1062,1.0,794.0,794.0
0.067,6,10,1506,5,395,16.0,127.0,127.0,5,1111,14.0,843.0,843.0
0.005,6,10,2006,5,927,1.0,659.0,659.0,5,1079,1.0,811.0,811.0
300.026,6,12,1782,7,1348,50004.0,494.0,494.0,5,434,75005.0,83.0,83.0
114.638,6,22,7437,11,1305,106.0,530.0,277.0,11,6132,11447.0,2720.0,946.0
40.075,17,10,676,5,460,10015.0,104.0,64.0,5,216,10017.0,20.0,15.0
0.04,17,2,412,1,61,0.0,33.0,33.0,1,351,0.0,323.0,323.0
290.926,6,323,344993,116,17583,2529.0,2736.0,888.0,207,327410,1412.0,2804.0,1640.0
0.019,6,10,1989,5,910,4.0,642.0,642.0,5,1079,4.0,811.0,811.0
0.005,17,2,170,1,65,0.0,37.0,37.0,1,105,0.0,77.0,77.0
292.343,6,318,343548,127,18159,2320.0,2736.0,889.0,191,325389,1538.0,2804.0,1782.0
0.008,6,10,2006,5,927,2.0,659.0,659.0,5,1079,2.0,811.0,811.0
0.011,17,2,170,1,65,0.0,37.0,37.0,1,105,0.0,77.0,77.0
0.08,6,10,1506,5,395,17.0,127.0,127.0,5,1111,18.0,843.0,843.0
0.012,6,10,1762,5,911,3.0,643.0,643.0,5,851,3.0,583.0,583.0
0.103,6,10,1506,5,395,22.0,127.0,127.0,5,1111,24.0,843.0,843.0
0.001,17,2,179,1,62,0.0,34.0,34.0,1,117,0.0,89.0,89.0
0.015,6,10,1972,5,910,3.0,642.0,642.0,5,1062,3.0,794.0,794.0
0.101,6,10,1506,5,395,21.0,127.0,127.0,5,1111,23.0,843.0,843.0
0.005,6,10,2000,5,927,1.0,659.0,659.0,5,1073,1.0,805.0,805.0
0.005,6,10,1643,5,860,1.0,592.0,592.0,5,783,1.0,515.0,515.0
0.009,6,12,1926,6,1189,1.0,659.0,434.0,6,737,1.0,417.0,417.0
0.017,6,10,1972,5,910,4.0,642.0,642.0,5,1062,4.0,794.0,794.0
0.007,6,10,1643,5,860,1.0,592.0,592.0,5,783,1.0,515.0,515.0
0.005,6,10,2006,5,927,1.0,659.0,659.0,5,1079,1.0,811.0,811.0
40.054,17,10,676,5,460,10012.0,104.0,64.0,5,216,10012.0,20.0,15.0
0.011,6,10,1972,5,910,2.0,642.0,642.0,5,1062,2.0,794.0,794.0
40.063,17,10,676,5,460,10014.0,104.0,64.0,5,216,10015.0,20.0,15.0
0.005,6,10,1989,5,927,1.0,659.0,659.0,5,1062,1.0,794.0,794.0
0.004,17,2,148,1,60,0.0,32.0,32.0,1,88,0.0,60.0,60.0
0.073,6,10,1506,5,395,16.0,127.0,127.0,5,1111,15.0,843.0,843.0
0.004,6,10,1779,5,928,1.0,660.0,660.0,5,851,1.0,583.0,583.0
0.109,6,10,1506,5,395,22.0,127.0,127.0,5,1111,25.0,843.0,843.0
0.005,6,11,2058,6,979,1.0,659.0,659.0,5,1079,1.0,811.0,811.0
0.001,17,2,180,1,66,0.0,38.0,38.0,1,114,0.0,86.0,86.0
30.692,6,25,8066,14,2988,2353.0,1191.0,449.0,11,5078,3058.0,1402.0,751.0
0.006,6,10,1547,5,764,1.0,496.0,496.0,5,783,1.0,515.0,515.0
0.009,6,10,1989,5,910,2.0,642.0,642.0,5,1079,2.0,811.0,811.0
0.006,6,10,1547,5,764,1.0,496.0,496.0,5,783,1.0,515.0,515.0
0.016,6,10,1972,5,910,4.0,642.0,642.0,5,1062,3.0,794.0,794.0
0.005,6,10,1989,5,927,1.0,659.0,659.0,5,1062,1.0,794.0,794.0
0.013,6,10,1989,5,910,3.0,642.0,642.0,5,1079,3.0,811.0,811.0
0.004,6,10,2006,5,927,1.0,659.0,659.0,5,1079,1.0,811.0,811.0
0.007,6,10,1547,5,764,1.0,496.0,496.0,5,783,1.0,515.0,515.0
0.006,6,10,1547,5,764,1.0,496.0,496.0,5,783,1.0,515.0,515.0
0.013,17,2,152,1,56,0.0,28.0,28.0,1,96,0.0,68.0,68.0
0.164,17,4,596,2,122,124.0,33.0,33.0,2,474,160.0,323.0,209.0
314.808,17,20,1124,10,716,34971.0,48.0,43.0,10,408,34971.0,20.0,12.0
10.885,17,28,4420,14,1995,828.0,270.0,114.0,14,2425,828.0,588.0,145.0
0.006,6,10,1547,5,764,1.0,496.0,496.0,5,783,1.0,515.0,515.0
0.009,6,10,1702,5,863,2.0,595.0,595.0,5,839,2.0,571.0,571.0
0.006,6,10,1643,5,860,1.0,592.0,592.0,5,783,1.0,515.0,515.0
0.148,6,10,1506,5,395,36.0,127.0,127.0,5,1111,33.0,843.0,843.0
0.006,6,10,1547,5,764,1.0,496.0,496.0,5,783,1.0,515.0,515.0
313.349,17,20,1124,10,716,34801.0,48.0,43.0,10,408,34801.0,20.0,12.0
0.106,6,10,1506,5,395,24.0,127.0,127.0,5,1111,23.0,843.0,843.0
0.008,6,10,1989,5,910,2.0,642.0,642.0,5,1079,2.0,811.0,811.0
0.005,6,10,2007,5,928,1.0,660.0,660.0,5,1079,1.0,811.0,811.0
0.005,6,10,2006,5,927,1.0,659.0,659.0,5,1079,1.0,811.0,811.0
308.359,17,20,1124,10,716,34247.0,48.0,43.0,10,408,34247.0,20.0,12.0
0.097,6,10,1506,5,395,21.0,127.0,127.0,5,1111,22.0,843.0,843.0
0.013,17,2,152,1,56,0.0,28.0,28.0,1,96,0.0,68.0,68.0
0.012,6,10,1972,5,910,3.0,642.0,642.0,5,1062,2.0,794.0,794.0
0.005,6,10,2007,5,928,1.0,660.0,660.0,5,1079,1.0,811.0,811.0
0.005,6,10,2006,5,927,1.0,659.0,659.0,5,1079,1.0,811.0,811.0
0.005,6,10,2006,5,927,1.0,659.0,659.0,5,1079,1.0,811.0,811.0
0.045,17,2,170,1,65,0.0,37.0,37.0,1,105,0.0,77.0,77.0
240.102,6,16,4482,9,963,30012.0,238.0,166.0,7,3519,40016.0,1402.0,786.0
0.004,17,4,284,2,120,1.0,32.0,32.0,2,164,1.0,60.0,54.0
0.013,6,10,1972,5,910,3.0,642.0,642.0,5,1062,3.0,794.0,794.0
0.084,6,10,1506,5,395,19.0,127.0,127.0,5,1111,19.0,843.0,843.0
0.014,6,10,1990,5,911,3.0,643.0,643.0,5,1079,3.0,811.0,811.0
0.011,6,10,1972,5,910,2.0,642.0,642.0,5,1062,2.0,794.0,794.0
240.029,6,9,787,5,488,60007.0,232.0,232.0,4,299,80008.0,83.0,83.0
0.014,6,10,1677,5,827,3.0,559.0,559.0,5,850,3.0,582.0,582.0
0.001,17,2,180,1,66,0.0,38.0,38.0,1,114,0.0,86.0,86.0
0.162,17,2,152,1,76,0.0,48.0,48.0,1,76,0.0,48.0,48.0
0.004,17,2,148,1,60,0.0,32.0,32.0,1,88,0.0,60.0,60.0
240.302,6,30,10910,15,4928,17164.0,1368.0,690.0,15,5982,17164.0,1655.0,742.0
40.054,17,10,676,5,460,10012.0,104.0,64.0,5,216,10012.0,20.0,15.0
0.001,17,2,166,1,75,0.0,47.0,47.0,1,91,0.0,63.0,63.0
0.18,17,4,352,2,130,108.0,37.0,37.0,2,222,176.0,89.0,83.0
0.011,6,10,1972,5,910,2.0,642.0,642.0,5,1062,2.0,794.0,794.0
178.107,17,72,10180,36,2386,5088.0,44.0,38.0,36,7794,5088.0,239.0,188.0
0.014,6,10,1631,5,848,3.0,580.0,580.0,5,783,3.0,515.0,515.0
0.103,6,10,1506,5,395,22.0,127.0,127.0,5,1111,20.0,843.0,843.0
40.064,17,10,676,5,460,10014.0,104.0,64.0,5,216,10015.0,20.0,15.0
0.039,17,4,284,2,120,0.0,32.0,32.0,2,164,36.0,60.0,54.0
40.066,17,10,676,5,460,10014.0,104.0,64.0,5,216,10015.0,20.0,15.0
0.001,17,2,180,1,66,0.0,38.0,38.0,1,114,0.0,86.0,86.0
44.433,6,36,8560,18,2089,506.0,1021.0,445.0,18,6471,2606.0,2126.0,478.0
0.001,17,2,142,1,63,0.0,35.0,35.0,1,79,0.0,51.0,51.0
0.013,6,10,1972,5,910,3.0,642.0,642.0,5,1062,3.0,794.0,794.0
0.006,6,10,1854,5,889,1.0,621.0,621.0,5,965,1.0,697.0,697.0
15.081,17,16,10617,9,8280,1880.0,1350.0,892.0,7,2337,2508.0,1350.0,305.0
0.003,17,4,284,2,120,0.0,32.0,32.0,2,164,0.0,60.0,54.0
0.014,6,10,1972,5,910,3.0,642.0,642.0,5,1062,3.0,794.0,794.0
0.001,17,2,180,1,66,0.0,38.0,38.0,1,114,0.0,86.0,86.0
0.006,6,10,1779,5,928,1.0,660.0,660.0,5,851,1.0,583.0,583.0
0.006,6,10,1643,5,860,1.0,592.0,592.0,5,783,1.0,515.0,515.0
0.004,17,2,136,1,60,0.0,32.0,32.0,1,76,0.0,48.0,48.0
361.89,6,21,1792,16,1030,24126.0,190.0,190.0,5,762,60009.0,461.0,247.0
0.006,6,10,1854,5,889,1.0,621.0,621.0,5,965,1.0,697.0,697.0
300.027,6,12,1782,7,1348,50004.0,494.0,494.0,5,434,75005.0,83.0,83.0
0.015,6,10,1990,5,911,3.0,643.0,643.0,5,1079,3.0,811.0,811.0
40.085,17,10,676,5,460,10014.0,104.0,64.0,5,216,10020.0,20.0,15.0
0.005,6,10,1643,5,860,1.0,592.0,592.0,5,783,1.0,515.0,515.0
0.001,17,2,166,1,75,0.0,47.0,47.0,1,91,0.0,63.0,63.0
0.004,6,10,2000,5,927,1.0,659.0,659.0,5,1073,1.0,805.0,805.0
30.272,6,28,12838,16,2489,2018.0,1004.0,411.0,12,10349,2751.0,2804.0,1388.0
0.014,6,10,1677,5,827,3.0,559.0,559.0,5,850,3.0,582.0,582.0
0.005,17,2,170,1,65,0.0,37.0,37.0,1,105,0.0,77.0,77.0
0.005,6,10,2006,5,927,1.0,659.0,659.0,5,1079,1.0,811.0,811.0
0.033,17,2,136,1,60,0.0,32.0,32.0,1,76,0.0,48.0,48.0
0.005,17,2,169,1,62,0.0,34.0,34.0,1,107,0.0,79.0,79.0
172.17,17,82,11751,41,2734,4304.0,44.0,38.0,41,9017,4304.0,260.0,191.0
0.322,6,17,2834,9,1452,40.0,533.0,325.0,8,1382,39.0,529.0,239.0
0.088,6,10,1506,5,395,20.0,127.0,127.0,5,1111,20.0,843.0,843.0
0.013,6,10,1989,5,910,3.0,642.0,642.0,5,1079,3.0,811.0,811.0
176.217,17,74,10421,37,2457,4894.0,44.0,38.0,37,7964,4894.0,239.0,187.0
0.003,17,2,148,1,60,0.0,32.0,32.0,1,88,0.0,60.0,60.0
0.066,6,10,1506,5,395,14.0,127.0,127.0,5,1111,15.0,843.0,843.0
0.01,6,13,3735,7,497,1.0,125.0,125.0,6,3238,2.0,1470.0,1459.0
0.005,6,10,1774,5,923,1.0,655.0,655.0,5,851,1.0,583.0,583.0
0.052,17,2,152,1,76,0.0,48.0,48.0,1,76,0.0,48.0,48.0
0.029,6,10,1989,5,910,7.0,642.0,642.0,5,1079,7.0,811.0,811.0
0.083,6,10,1506,5,395,18.0,127.0,127.0,5,1111,18.0,843.0,843.0
354.068,6,21,1795,16,1030,23604.0,190.0,190.0,5,765,60001.0,464.0,248.0
0.005,6,10,1989,5,927,1.0,659.0,659.0,5,1062,1.0,794.0,794.0
0.005,6,10,2006,5,927,1.0,659.0,659.0,5,1079,1.0,811.0,811.0
0.007,6,10,1774,5,923,1.0,655.0,655.0,5,851,1.0,583.0,583.0
240.094,6,16,4482,9,963,30011.0,238.0,166.0,7,3519,40015.0,1402.0,786.0
0.133,6,10,1506,5,395,26.0,127.0,127.0,5,1111,26.0,843.0,843.0
0.028,6,10,1983,5,910,7.0,642.0,642.0,5,1073,6.0,805.0,805.0
0.093,6,10,1506,5,395,21.0,127.0,127.0,5,1111,21.0,843.0,843.0
0.091,6,10,1506,5,395,21.0,127.0,127.0,5,1111,19.0,843.0,843.0
0.005,6,10,2000,5,927,1.0,659.0,659.0,5,1073,1.0,805.0,805.0
0.004,6,10,2006,5,927,1.0,659.0,659.0,5,1079,1.0,811.0,811.0
0.005,6,10,2007,5,928,1.0,660.0,660.0,5,1079,1.0,811.0,811.0
0.006,17,2,214,1,75,0.0,47.0,47.0,1,139,0.0,111.0,111.0
0.006,6,10,1547,5,764,1.0,496.0,496.0,5,783,1.0,515.0,515.0
0.053,17,2,152,1,76,0.0,48.0,48.0,1,76,0.0,48.0,48.0
10.757,17,28,4421,14,1993,819.0,268.0,114.0,14,2428,818.0,587.0,145.0
0.006,6,10,1547,5,764,1.0,496.0,496.0,5,783,1.0,515.0,515.0
0.005,6,13,3747,7,509,0.0,137.0,137.0,6,3238,1.0,1470.0,1459.0
240.091,6,9,787,5,488,60022.0,232.0,232.0,4,299,80016.0,83.0,83.0
0.006,6,10,1547,5,764,1.0,496.0,496.0,5,783,1.0,515.0,515.0
0.01,6,10,1983,5,910,2.0,642.0,642.0,5,1073,2.0,805.0,805.0
0.005,6,10,2007,5,928,1.0,660.0,660.0,5,1079,1.0,811.0,811.0
0.086,6,10,1506,5,395,19.0,127.0,127.0,5,1111,16.0,843.0,843.0
0.068,6,14,3787,7,497,11.0,125.0,125.0,7,3290,11.0,1448.0,972.0
0.009,6,10,1989,5,910,2.0,642.0,642.0,5,1079,2.0,811.0,811.0
0.005,6,10,2006,5,927,1.0,659.0,659.0,5,1079,1.0,811.0,811.0
0.096,6,10,1506,5,395,21.0,127.0,127.0,5,1111,22.0,843.0,843.0
0.014,6,10,1762,5,911,3.0,643.0,643.0,5,851,3.0,583.0,583.0
0.026,17,2,136,1,60,0.0,32.0,32.0,1,76,0.0,48.0,48.0
0.096,6,10,1506,5,395,22.0,127.0,127.0,5,1111,22.0,843.0,843.0
0.018,6,10,1989,5,910,4.0,642.0,642.0,5,1079,4.0,811.0,811.0
0.014,6,10,1990,5,911,3.0,643.0,643.0,5,1079,3.0,811.0,811.0
0.005,17,2,148,1,60,0.0,32.0,32.0,1,88,0.0,60.0,60.0
0.009,6,10,1990,5,911,2.0,643.0,643.0,5,1079,2.0,811.0,811.0
0.175,6,3,453,2,321,175.0,241.0,241.0,1,132,0.0,92.0,92.0
300.328,6,16,2170,9,684,37519.0,146.0,146.0,7,1486,50025.0,419.0,398.0
0.005,6,10,2006,5,927,1.0,659.0,659.0,5,1079,1.0,811.0,811.0
0.09,6,10,1506,5,395,20.0,127.0,127.0,5,1111,21.0,843.0,843.0
0.315,17,47,27213,25,21227,13.0,1350.0,821.0,22,5986,12.0,1350.0,244.0
0.014,6,10,1990,5,911,3.0,643.0,643.0,5,1079,3.0,811.0,811.0
0.004,6,10,1779,5,928,1.0,660.0,660.0,5,851,1.0,583.0,583.0
0.005,6,10,1989,5,927,1.0,659.0,659.0,5,1062,1.0,794.0,794.0
0.005,6,10,1989,5,927,1.0,659.0,659.0,5,1062,1.0,794.0,794.0
0.041,17,2,184,1,61,0.0,33.0,33.0,1,123,0.0,95.0,95.0
0.004,6,10,2006,5,927,1.0,659.0,659.0,5,1079,1.0,811.0,811.0
0.005,6,10,1989,5,927,1.0,659.0,659.0,5,1062,1.0,794.0,794.0
0.005,6,14,3742,8,504,0.0,80.0,80.0,6,3238,1.0,1470.0,1459.0
0.165,17,2,152,1,76,0.0,48.0,48.0,1,76,0.0,48.0,48.0
0.1,6,10,1506,5,395,21.0,127.0,127.0,5,1111,21.0,843.0,843.0
0.013,6,10,1972,5,910,3.0,642.0,642.0,5,1062,3.0,794.0,794.0
0.004,6,10,2000,5,927,1.0,659.0,659.0,5,1073,1.0,805.0,805.0
1770.467,6,88,4678,44,2340,41172.0,26.0,26.0,44,2338,41172.0,26.0,25.0
0.006,17,2,249,1,64,0.0,36.0,36.0,1,185,0.0,157.0,157.0
300.774,6,41,14973,22,9415,14322.0,2720.0,1214.0,19,5558,478.0,2667.0,435.0
0.003,17,2,136,1,60,0.0,32.0,32.0,1,76,0.0,48.0,48.0
0.019,6,10,1989,5,910,4.0,642.0,642.0,5,1079,4.0,811.0,811.0
0.043,17,2,170,1,65,0.0,37.0,37.0,1,105,0.0,77.0,77.0
240.097,6,16,4482,9,963,30012.0,238.0,166.0,7,3519,40015.0,1402.0,786.0
1756.746,6,124,12587,69,4792,25833.0,517.0,66.0,55,7795,32531.0,1402.0,234.0
0.004,17,2,136,1,60,0.0,32.0,32.0,1,76,0.0,48.0,48.0
0.126,17,2,80,1,32,0.0,4.0,4.0,1,48,0.0,20.0,20.0
0.016,6,10,1990,5,911,3.0,643.0,643.0,5,1079,4.0,811.0,811.0
0.011,6,13,3735,7,497,1.0,125.0,125.0,6,3238,2.0,1470.0,1459.0
0.005,6,10,2006,5,927,1.0,659.0,659.0,5,1079,1.0,811.0,811.0
40.064,17,10,676,5,460,10013.0,104.0,64.0,5,216,10015.0,20.0,15.0
0.017,6,10,1983,5,910,4.0,642.0,642.0,5,1073,4.0,805.0,805.0
0.013,6,10,1983,5,910,3.0,642.0,642.0,5,1073,3.0,805.0,805.0
0.094,6,10,1506,5,395,20.0,127.0,127.0,5,1111,20.0,843.0,843.0
0.016,6,10,1983,5,910,4.0,642.0,642.0,5,1073,4.0,805.0,805.0
0.006,17,2,170,1,65,0.0,37.0,37.0,1,105,0.0,77.0,77.0
290.854,6,397,348474,188,21340,1555.0,2736.0,825.0,209,327134,1398.0,2804.0,1621.0
0.011,6,10,1972,5,910,2.0,642.0,642.0,5,1062,2.0,794.0,794.0
0.004,6,10,1989,5,927,1.0,659.0,659.0,5,1062,1.0,794.0,794.0
0.006,6,10,1547,5,764,1.0,496.0,496.0,5,783,1.0,515.0,515.0
0.039,17,4,420,2,122,0.0,33.0,33.0,2,298,35.0,145.0,121.0
10.851,17,24,3784,12,1675,976.0,270.0,111.0,12,2109,976.0,588.0,147.0
0.009,17,2,164,1,74,0.0,46.0,46.0,1,90,0.0,62.0,62.0
0.123,6,10,1506,5,395,30.0,127.0,127.0,5,1111,26.0,843.0,843.0
0.168,17,2,152,1,76,0.0,48.0,48.0,1,76,0.0,48.0,48.0
169.287,17,80,11312,40,2656,4340.0,44.0,38.0,40,8656,4340.0,261.0,188.0
0.005,6,10,2000,5,927,1.0,659.0,659.0,5,1073,1.0,805.0,805.0
0.004,17,4,284,2,120,0.0,32.0,32.0,2,164,1.0,60.0,54.0
0.015,6,10,1972,5,910,3.0,642.0,642.0,5,1062,3.0,794.0,794.0
0.102,6,10,1506,5,395,23.0,127.0,127.0,5,1111,18.0,843.0,843.0
0.004,6,10,2007,5,928,1.0,660.0,660.0,5,1079,1.0,811.0,811.0
0.002,17,2,136,1,60,0.0,32.0,32.0,1,76,0.0,48.0,48.0
0.008,6,12,1698,6,863,1.0,327.0,271.0,6,835,1.0,515.0,515.0
0.011,6,10,1990,5,911,2.0,643.0,643.0,5,1079,2.0,811.0,811.0
0.09,6,10,1506,5,395,20.0,127.0,127.0,5,1111,17.0,843.0,843.0
40.058,17,10,676,5,460,10013.0,104.0,64.0,5,216,10013.0,20.0,15.0
0.004,6,10,1774,5,923,1.0,655.0,655.0,5,851,1.0,583.0,583.0
0.006,17,2,180,1,66,0.0,38.0,38.0,1,114,0.0,86.0,86.0
0.007,6,10,1702,5,863,1.0,595.0,595.0,5,839,1.0,571.0,571.0
0.016,17,2,198,1,91,0.0,63.0,63.0,1,107,0.0,79.0,79.0
0.004,6,10,2006,5,927,1.0,659.0,659.0,5,1079,1.0,811.0,811.0
0.009,6,10,1989,5,910,2.0,642.0,642.0,5,1079,2.0,811.0,811.0
0.005,6,13,3690,7,452,0.0,80.0,80.0,6,3238,1.0,1470.0,1459.0
0.014,6,10,1983,5,910,3.0,642.0,642.0,5,1073,3.0,805.0,805.0
0.013,6,10,1983,5,910,3.0,642.0,642.0,5,1073,3.0,805.0,805.0
0.004,6,10,1779,5,928,1.0,660.0,660.0,5,851,1.0,583.0,583.0
0.008,6,10,1972,5,910,1.0,642.0,642.0,5,1062,1.0,794.0,794.0
0.005,6,10,1689,5,839,1.0,571.0,571.0,5,850,1.0,582.0,582.0
0.004,6,10,2006,5,927,1.0,659.0,659.0,5,1079,1.0,811.0,811.0
0.111,6,42,11167,23,2968,5.0,517.0,177.0,19,8199,5.0,2694.0,653.0
0.001,17,2,180,1,66,0.0,38.0,38.0,1,114,0.0,86.0,86.0
0.003,17,4,284,2,120,0.0,32.0,32.0,2,164,0.0,60.0,54.0
0.009,6,10,1989,5,910,2.0,642.0,642.0,5,1079,2.0,811.0,811.0
0.07,6,10,1506,5,395,16.0,127.0,127.0,5,1111,12.0,843.0,843.0
0.127,6,10,1506,5,395,28.0,127.0,127.0,5,1111,25.0,843.0,843.0
0.014,6,10,1989,5,910,3.0,642.0,642.0,5,1079,3.0,811.0,811.0
0.001,17,2,180,1,66,0.0,38.0,38.0,1,114,0.0,86.0,86.0
0.005,6,13,3747,7,509,0.0,137.0,137.0,6,3238,0.0,1470.0,1459.0
0.082,6,10,1506,5,395,19.0,127.0,127.0,5,1111,19.0,843.0,843.0
10.985,17,28,4390,14,2311,836.0,586.0,137.0,14,2079,836.0,270.0,120.0
0.017,6,10,1983,5,910,4.0,642.0,642.0,5,1073,4.0,805.0,805.0
0.1,6,10,1506,5,395,22.0,127.0,127.0,5,1111,24.0,843.0,843.0
0.016,6,10,1989,5,910,4.0,642.0,642.0,5,1079,3.0,811.0,811.0
0.016,17,2,198,1,91,0.0,63.0,63.0,1,107,0.0,79.0,79.0
0.004,6,10,1779,5,928,1.0,660.0,660.0,5,851,1.0,583.0,583.0
0.097,6,10,1506,5,395,20.0,127.0,127.0,5,1111,18.0,843.0,843.0
0.096,6,10,1506,5,395,21.0,127.0,127.0,5,1111,21.0,843.0,843.0
0.006,17,2,214,1,75,0.0,47.0,47.0,1,139,0.0,111.0,111.0
0.011,6,10,1990,5,911,2.0,643.0,643.0,5,1079,2.0,811.0,811.0
0.005,6,10,2000,5,927,1.0,659.0,659.0,5,1073,1.0,805.0,805.0
0.005,6,10,2006,5,927,1.0,659.0,659.0,5,1079,1.0,811.0,811.0
0.103,6,10,1506,5,395,23.0,127.0,127.0,5,1111,23.0,843.0,843.0
0.006,6,10,1547,5,764,1.0,496.0,496.0,5,783,1.0,515.0,515.0
308.599,17,19,1084,10,716,34274.0,48.0,43.0,9,368,38555.0,20.0,12.0
0.013,6,10,1990,5,911,3.0,643.0,643.0,5,1079,3.0,811.0,811.0
0.011,6,10,1972,5,910,2.0,642.0,642.0,5,1062,2.0,794.0,794.0
0.005,6,10,1547,5,764,1.0,496.0,496.0,5,783,1.0,515.0,515.0
15.071,17,15,9238,8,6902,2148.0,1350.0,834.0,7,2336,2507.0,1350.0,305.0
0.004,6,10,2006,5,927,1.0,659.0,659.0,5,1079,1.0,811.0,811.0
0.022,6,10,1990,5,911,5.0,643.0,643.0,5,1079,5.0,811.0,811.0
0.144,6,10,1506,5,395,32.0,127.0,127.0,5,1111,29.0,843.0,843.0
1762.51,6,474,67406,258,35614,6858.0,613.0,194.0,216,31792,8197.0,453.0,142.0
0.135,6,10,1506,5,395,32.0,127.0,127.0,5,1111,27.0,843.0,843.0
0.014,17,2,152,1,56,0.0,28.0,28.0,1,96,0.0,68.0,68.0
0.078,6,10,1506,5,395,19.0,127.0,127.0,5,1111,14.0,843.0,843.0
40.071,17,10,676,5,460,10015.0,104.0,64.0,5,216,10017.0,20.0,15.0
0.003,17,2,136,1,60,0.0,32.0,32.0,1,76,0.0,48.0,48.0
0.007,6,10,1990,5,911,1.0,643.0,643.0,5,1079,1.0,811.0,811.0
0.006,17,2,169,1,62,0.0,34.0,34.0,1,107,0.0,79.0,79.0
15.133,17,19,13456,10,8344,1678.0,1350.0,806.0,9,5112,1888.0,1350.0,540.0
0.006,6,10,1547,5,764,1.0,496.0,496.0,5,783,1.0,515.0,515.0
0.006,6,10,1689,5,839,1.0,571.0,571.0,5,850,1.0,582.0,582.0
354.065,6,21,1795,16,1030,23604.0,190.0,190.0,5,765,60002.0,464.0,248.0
308.506,17,20,1124,10,716,34263.0,48.0,43.0,10,408,34263.0,20.0,12.0
40.062,17,10,676,5,460,10013.0,104.0,64.0,5,216,10014.0,20.0,15.0
0.009,6,10,1972,5,910,2.0,642.0,642.0,5,1062,2.0,794.0,794.0
15.389,17,46,26627,26,23440,614.0,1350.0,873.0,20,3187,808.0,1350.0,131.0
0.014,6,10,1989,5,910,3.0,642.0,642.0,5,1079,3.0,811.0,811.0
0.001,17,2,180,1,66,0.0,38.0,38.0,1,114,0.0,86.0,86.0
0.014,6,10,1990,5,911,3.0,643.0,643.0,5,1079,3.0,811.0,811.0
0.005,6,10,2006,5,927,1.0,659.0,659.0,5,1079,1.0,811.0,811.0
0.097,6,10,1506,5,395,23.0,127.0,127.0,5,1111,20.0,843.0,843.0
0.007,17,2,180,1,66,0.0,38.0,38.0,1,114,0.0,86.0,86.0
0.005,6,10,1989,5,927,1.0,659.0,659.0,5,1062,1.0,794.0,794.0
240.011,6,9,787,5,488,60002.0,232.0,232.0,4,299,80002.0,83.0,83.0
0.011,6,10,1989,5,910,2.0,642.0,642.0,5,1079,2.0,811.0,811.0
0.006,6,10,1547,5,764,1.0,496.0,496.0,5,783,1.0,515.0,515.0
0.042,6,10,1989,5,910,10.0,642.0,642.0,5,1079,10.0,811.0,811.0
300.308,6,27,7433,16,1409,20020.0,217.0,142.0,11,6024,24027.0,1679.0,777.0
0.006,6,12,1698,6,863,1.0,327.0,271.0,6,835,1.0,515.0,515.0
0.07,17,8,3613,4,1874,23.0,1350.0,440.0,4,1739,12.0,1350.0,406.0
172.289,17,96,14002,48,3231,3665.0,44.0,39.0,48,10771,3665.0,252.0,196.0
0.111,6,10,1506,5,395,23.0,127.0,127.0,5,1111,23.0,843.0,843.0
0.009,17,2,136,1,60,0.0,32.0,32.0,1,76,0.0,48.0,48.0
254.799,6,33,9709,16,7187,16986.0,2259.0,706.0,17,2522,15924.0,580.0,163.0
308.638,17,18,1008,9,640,38564.0,48.0,43.0,9,368,38564.0,20.0,12.0
40.054,17,10,676,5,460,10012.0,104.0,64.0,5,216,10012.0,20.0,15.0
0.071,6,10,1506,5,395,17.0,127.0,127.0,5,1111,16.0,843.0,843.0
0.005,6,14,3736,7,446,0.0,74.0,74.0,7,3290,0.0,1448.0,972.0
0.015,6,10,1677,5,827,3.0,559.0,559.0,5,850,3.0,582.0,582.0
40.074,17,10,676,5,460,10017.0,104.0,64.0,5,216,10017.0,20.0,15.0
0.051,6,10,1506,5,395,11.0,127.0,127.0,5,1111,12.0,843.0,843.0
40.065,17,10,676,5,460,10013.0,104.0,64.0,5,216,10015.0,20.0,15.0
0.005,6,13,3747,7,509,0.0,137.0,137.0,6,3238,0.0,1470.0,1459.0
10.699,17,26,4104,13,1823,882.0,270.0,112.0,13,2281,882.0,588.0,147.0
0.006,17,2,166,1,75,0.0,47.0,47.0,1,91,0.0,63.0,63.0
0.085,6,10,1506,5,395,18.0,127.0,127.0,5,1111,17.0,843.0,843.0
0.006,6,10,1547,5,764,1.0,496.0,496.0,5,783,1.0,515.0,515.0
0.007,17,2,179,1,71,0.0,43.0,43.0,1,108,0.0,80.0,80.0
0.072,6,10,1506,5,395,14.0,127.0,127.0,5,1111,16.0,843.0,843.0
0.009,6,10,1983,5,910,2.0,642.0,642.0,5,1073,2.0,805.0,805.0
0.001,17,2,132,1,58,0.0,30.0,30.0,1,74,0.0,46.0,46.0
0.005,6,10,1547,5,764,1.0,496.0,496.0,5,783,1.0,515.0,515.0
0.108,6,10,1506,5,395,24.0,127.0,127.0,5,1111,21.0,843.0,843.0
0.007,17,2,179,1,71,0.0,43.0,43.0,1,108,0.0,80.0,80.0
9.041,17,6,376,5,280,2260.0,28.0,28.0,1,96,0.0,68.0,68.0
0.005,6,13,3690,7,452,0.0,80.0,80.0,6,3238,1.0,1470.0,1459.0
0.005,17,2,164,1,74,0.0,46.0,46.0,1,90,0.0,62.0,62.0
10.866,17,28,4422,14,1995,827.0,270.0,114.0,14,2427,827.0,586.0,145.0
0.005,17,2,166,1,75,0.0,47.0,47.0,1,91,0.0,63.0,63.0
0.005,6,14,3799,7,509,0.0,137.0,137.0,7,3290,0.0,1448.0,972.0
0.005,6,10,2007,5,928,1.0,660.0,660.0,5,1079,1.0,811.0,811.0
0.037,17,2,170,1,65,0.0,37.0,37.0,1,105,0.0,77.0,77.0
0.014,6,10,1989,5,910,3.0,642.0,642.0,5,1079,3.0,811.0,811.0
0.01,6,10,2000,5,927,2.0,659.0,659.0,5,1073,2.0,805.0,805.0
0.043,17,2,152,1,76,0.0,48.0,48.0,1,76,0.0,48.0,48.0
0.072,17,2,182,1,65,0.0,37.0,37.0,1,117,0.0,89.0,89.0
0.076,17,2,182,1,65,0.0,37.0,37.0,1,117,0.0,89.0,89.0
0.005,17,2,144,1,64,0.0,36.0,36.0,1,80,0.0,52.0,52.0
0.004,6,10,2006,5,927,1.0,659.0,659.0,5,1079,1.0,811.0,811.0
0.004,6,10,2006,5,927,1.0,659.0,659.0,5,1079,1.0,811.0,811.0
0.072,6,10,1506,5,395,16.0,127.0,127.0,5,1111,15.0,843.0,843.0
0.005,6,10,2007,5,928,1.0,660.0,660.0,5,1079,1.0,811.0,811.0
0.005,6,10,1547,5,764,1.0,496.0,496.0,5,783,1.0,515.0,515.0
0.005,17,2,214,1,75,0.0,47.0,47.0,1,139,0.0,111.0,111.0
0.084,6,10,1506,5,395,19.0,127.0,127.0,5,1111,17.0,843.0,843.0
0.004,6,10,2006,5,927,1.0,659.0,659.0,5,1079,1.0,811.0,811.0
0.095,6,10,1506,5,395,21.0,127.0,127.0,5,1111,22.0,843.0,843.0
0.017,6,10,1989,5,910,4.0,642.0,642.0,5,1079,4.0,811.0,811.0
240.414,6,35,10431,18,2215,14139.0,559.0,254.0,17,8216,15023.0,1612.0,666.0
0.005,17,2,164,1,74,0.0,46.0,46.0,1,90,0.0,62.0,62.0
0.006,6,10,2006,5,927,1.0,659.0,659.0,5,1079,1.0,811.0,811.0
0.009,6,10,1989,5,910,2.0,642.0,642.0,5,1079,2.0,811.0,811.0
0.008,6,10,1989,5,910,2.0,642.0,642.0,5,1079,1.0,811.0,811.0
40.051,17,10,676,5,460,10012.0,104.0,64.0,5,216,10011.0,20.0,15.0
0.006,6,13,3747,7,509,0.0,137.0,137.0,6,3238,1.0,1470.0,1459.0
0.004,6,10,2007,5,928,1.0,660.0,660.0,5,1079,1.0,811.0,811.0
0.005,6,10,2006,5,927,1.0,659.0,659.0,5,1079,1.0,811.0,811.0
0.113,17,4,596,2,122,42.0,33.0,33.0,2,474,73.0,323.0,209.0
0.011,6,10,1983,5,910,2.0,642.0,642.0,5,1073,2.0,805.0,805.0
0.003,17,2,148,1,60,0.0,32.0,32.0,1,88,0.0,60.0,60.0
0.004,6,10,1779,5,928,1.0,660.0,660.0,5,851,1.0,583.0,583.0
0.011,6,10,1762,5,911,2.0,643.0,643.0,5,851,2.0,583.0,583.0
0.012,6,13,3735,7,497,2.0,125.0,125.0,6,3238,2.0,1470.0,1459.0
0.004,17,4,284,2,120,0.0,32.0,32.0,2,164,1.0,60.0,54.0
0.012,6,13,3735,7,497,2.0,125.0,125.0,6,3238,2.0,1470.0,1459.0
0.004,17,2,186,1,61,0.0,33.0,33.0,1,125,0.0,97.0,97.0
0.041,17,2,136,1,60,0.0,32.0,32.0,1,76,0.0,48.0,48.0
0.001,17,2,180,1,66,0.0,38.0,38.0,1,114,0.0,86.0,86.0
0.009,6,10,1990,5,911,2.0,643.0,643.0,5,1079,2.0,811.0,811.0
0.014,6,10,1972,5,910,3.0,642.0,642.0,5,1062,3.0,794.0,794.0
0.004,17,2,136,1,60,0.0,32.0,32.0,1,76,0.0,48.0,48.0
40.08,17,10,676,5,460,10016.0,104.0,64.0,5,216,10019.0,20.0,15.0
0.016,17,2,198,1,91,0.0,63.0,63.0,1,107,0.0,79.0,79.0
0.018,6,10,1972,5,910,4.0,642.0,642.0,5,1062,4.0,794.0,794.0
0.017,6,10,1989,5,910,4.0,642.0,642.0,5,1079,4.0,811.0,811.0
8.814,6,36,9771,19,4293,489.0,1360.0,700.0,17,5478,538.0,2667.0,435.0
0.091,6,10,1506,5,395,17.0,127.0,127.0,5,1111,21.0,843.0,843.0
0.008,6,12,1926,6,1189,1.0,659.0,434.0,6,737,1.0,417.0,417.0
0.006,17,2,170,1,65,0.0,37.0,37.0,1,105,0.0,77.0,77.0
0.096,6,10,1506,5,395,22.0,127.0,127.0,5,1111,20.0,843.0,843.0
0.004,6,10,1702,5,863,1.0,595.0,595.0,5,839,0.0,571.0,571.0
1794.06,6,489,99372,245,88022,7352.0,421.0,365.0,244,11350,7381.0,53.0,53.0
0.005,17,2,180,1,66,0.0,38.0,38.0,1,114,0.0,86.0,86.0
0.005,6,10,2007,5,928,1.0,660.0,660.0,5,1079,1.0,811.0,811.0
0.006,6,10,1779,5,928,1.0,660.0,660.0,5,851,1.0,583.0,583.0
240.089,6,27,6733,14,4583,18468.0,1368.0,482.0,13,2150,20007.0,580.0,183.0
0.037,17,4,420,2,122,0.0,33.0,33.0,2,298,34.0,145.0,121.0
15.491,17,24,14140,12,9030,1405.0,1350.0,724.0,12,5110,1405.0,1350.0,397.0
0.008,17,2,179,1,71,0.0,43.0,43.0,1,108,0.0,80.0,80.0
0.005,17,4,284,2,120,1.0,32.0,32.0,2,164,1.0,60.0,54.0
0.039,17,2,412,1,61,0.0,33.0,33.0,1,351,0.0,323.0,323.0
0.001,17,2,180,1,66,0.0,38.0,38.0,1,114,0.0,86.0,86.0
0.014,6,10,2006,5,927,3.0,659.0,659.0,5,1079,3.0,811.0,811.0
0.003,17,2,136,1,60,0.0,32.0,32.0,1,76,0.0,48.0,48.0
0.011,6,10,1990,5,911,2.0,643.0,643.0,5,1079,2.0,811.0,811.0
0.005,6,10,2007,5,928,1.0,660.0,660.0,5,1079,1.0,811.0,811.0
0.027,6,10,1983,5,910,6.0,642.0,642.0,5,1073,6.0,805.0,805.0
0.004,6,10,2006,5,927,1.0,659.0,659.0,5,1079,1.0,811.0,811.0
0.004,6,10,1774,5,923,1.0,655.0,655.0,5,851,1.0,583.0,583.0
240.116,6,34,9827,18,7295,14124.0,2263.0,707.0,16,2532,16007.0,580.0,211.0
0.006,17,2,262,1,66,0.0,38.0,38.0,1,196,0.0,168.0,168.0
0.006,6,13,3747,7,509,0.0,137.0,137.0,6,3238,1.0,1470.0,1459.0
0.005,6,10,1989,5,927,1.0,659.0,659.0,5,1062,1.0,794.0,794.0
0.008,6,10,1762,5,911,2.0,643.0,643.0,5,851,1.0,583.0,583.0
0.117,6,10,1506,5,395,25.0,127.0,127.0,5,1111,26.0,843.0,843.0
0.001,17,2,180,1,66,0.0,38.0,38.0,1,114,0.0,86.0,86.0
241.236,6,31,8608,14,4065,18556.0,1031.0,665.0,17,4543,15077.0,1162.0,363.0
0.067,6,10,1506,5,395,15.0,127.0,127.0,5,1111,15.0,843.0,843.0
0.073,17,2,396,1,61,0.0,33.0,33.0,1,335,0.0,307.0,307.0
0.015,6,10,1990,5,911,3.0,643.0,643.0,5,1079,3.0,811.0,811.0
0.005,17,2,136,1,60,0.0,32.0,32.0,1,76,0.0,48.0,48.0
314.432,17,20,1124,10,716,34922.0,48.0,43.0,10,408,34922.0,20.0,12.0
0.004,17,4,284,2,120,0.0,32.0,32.0,2,164,1.0,60.0,54.0
0.167,6,10,1506,5,395,39.0,127.0,127.0,5,1111,27.0,843.0,843.0
0.005,6,10,2006,5,927,1.0,659.0,659.0,5,1079,1.0,811.0,811.0
0.064,6,10,1506,5,395,14.0,127.0,127.0,5,1111,14.0,843.0,843.0
40.06,17,10,676,5,460,10011.0,104.0,64.0,5,216,10014.0,20.0,15.0
0.011,6,10,1989,5,910,2.0,642.0,642.0,5,1079,2.0,811.0,811.0
0.104,6,10,1506,5,395,23.0,127.0,127.0,5,1111,22.0,843.0,843.0
0.005,17,2,146,1,65,0.0,37.0,37.0,1,81,0.0,53.0,53.0
0.005,17,2,164,1,74,0.0,46.0,46.0,1,90,0.0,62.0,62.0
0.005,6,10,1989,5,927,1.0,659.0,659.0,5,1062,1.0,794.0,794.0
0.011,6,10,1989,5,910,2.0,642.0,642.0,5,1079,2.0,811.0,811.0
240.09,6,16,4482,9,963,30011.0,238.0,166.0,7,3519,40014.0,1402.0,786.0
0.006,6,10,1689,5,839,1.0,571.0,571.0,5,850,1.0,582.0,582.0
0.005,6,10,2007,5,928,1.0,660.0,660.0,5,1079,1.0,811.0,811.0
0.012,6,10,1983,5,910,3.0,642.0,642.0,5,1073,2.0,805.0,805.0
0.005,6,10,1989,5,927,1.0,659.0,659.0,5,1062,1.0,794.0,794.0
0.005,17,2,136,1,60,0.0,32.0,32.0,1,76,0.0,48.0,48.0
15.078,17,16,8845,8,6703,2150.0,1350.0,809.0,8,2142,2149.0,1350.0,239.0
0.005,6,10,1702,5,863,1.0,595.0,595.0,5,839,1.0,571.0,571.0
0.008,6,10,1990,5,911,2.0,643.0,643.0,5,1079,2.0,811.0,811.0
1770.47,6,83,4368,42,2210,43181.0,26.0,26.0,41,2158,44260.0,26.0,26.0
0.004,17,2,148,1,60,0.0,32.0,32.0,1,88,0.0,60.0,60.0
0.009,6,13,3735,7,497,1.0,125.0,125.0,6,3238,1.0,1470.0,1459.0
0.017,6,10,1972,5,910,4.0,642.0,642.0,5,1062,4.0,794.0,794.0
0.005,6,10,1989,5,927,1.0,659.0,659.0,5,1062,1.0,794.0,794.0
1770.785,6,135,6510,75,3585,23929.0,39.0,39.0,60,2925,30009.0,35.0,35.0
0.001,17,2,180,1,66,0.0,38.0,38.0,1,114,0.0,86.0,86.0
0.102,6,10,1506,5,395,23.0,127.0,127.0,5,1111,23.0,843.0,843.0
0.005,6,10,1989,5,927,1.0,659.0,659.0,5,1062,1.0,794.0,794.0
0.003,17,2,136,1,60,0.0,32.0,32.0,1,76,0.0,48.0,48.0
0.005,6,10,2006,5,927,1.0,659.0,659.0,5,1079,1.0,811.0,811.0
0.179,6,3,453,2,321,179.0,241.0,241.0,1,132,0.0,92.0,92.0
0.043,6,10,1972,5,910,10.0,642.0,642.0,5,1062,10.0,794.0,794.0
0.013,6,10,1983,5,910,3.0,642.0,642.0,5,1073,3.0,805.0,805.0
0.014,6,10,1990,5,911,3.0,643.0,643.0,5,1079,3.0,811.0,811.0
0.083,6,10,1506,5,395,19.0,127.0,127.0,5,1111,18.0,843.0,843.0
0.001,17,2,180,1,66,0.0,38.0,38.0,1,114,0.0,86.0,86.0
0.005,6,13,3747,7,509,0.0,137.0,137.0,6,3238,0.0,1470.0,1459.0
0.005,17,2,214,1,75,0.0,47.0,47.0,1,139,0.0,111.0,111.0
0.016,6,10,1990,5,911,4.0,643.0,643.0,5,1079,4.0,811.0,811.0
0.005,6,10,2007,5,928,1.0,660.0,660.0,5,1079,1.0,811.0,811.0
0.053,17,2,152,1,76,0.0,48.0,48.0,1,76,0.0,48.0,48.0
0.006,6,10,1643,5,860,1.0,592.0,592.0,5,783,1.0,515.0,515.0
0.008,6,10,1990,5,911,2.0,643.0,643.0,5,1079,2.0,811.0,811.0
0.001,17,2,180,1,66,0.0,38.0,38.0,1,114,0.0,86.0,86.0
0.013,6,10,1990,5,911,3.0,643.0,643.0,5,1079,3.0,811.0,811.0
0.006,6,10,1854,5,889,1.0,621.0,621.0,5,965,1.0,697.0,697.0
0.01,6,13,3747,7,509,1.0,137.0,137.0,6,3238,1.0,1470.0,1459.0
0.072,17,4,596,2,122,1.0,33.0,33.0,2,474,33.0,323.0,209.0
0.062,6,10,1506,5,395,13.0,127.0,127.0,5,1111,13.0,843.0,843.0
0.123,6,10,1506,5,395,25.0,127.0,127.0,5,1111,30.0,843.0,843.0
0.005,17,2,214,1,75,0.0,47.0,47.0,1,139,0.0,111.0,111.0
0.175,6,10,1506,5,395,42.0,127.0,127.0,5,1111,36.0,843.0,843.0
0.001,17,2,180,1,66,0.0,38.0,38.0,1,114,0.0,86.0,86.0
0.008,6,10,1779,5,928,2.0,660.0,660.0,5,851,1.0,583.0,583.0
0.089,6,10,1506,5,395,19.0,127.0,127.0,5,1111,17.0,843.0,843.0
0.004,6,10,1702,5,863,1.0,595.0,595.0,5,839,0.0,571.0,571.0
0.005,6,10,2007,5,928,1.0,660.0,660.0,5,1079,1.0,811.0,811.0
0.005,6,13,3747,7,509,0.0,137.0,137.0,6,3238,1.0,1470.0,1459.0
0.013,6,10,1989,5,910,3.0,642.0,642.0,5,1079,3.0,811.0,811.0
0.107,6,10,1506,5,395,22.0,127.0,127.0,5,1111,24.0,843.0,843.0
0.004,6,10,2000,5,927,1.0,659.0,659.0,5,1073,1.0,805.0,805.0
0.005,6,10,1547,5,764,1.0,496.0,496.0,5,783,1.0,515.0,515.0
0.008,6,10,1989,5,910,2.0,642.0,642.0,5,1079,1.0,811.0,811.0
0.006,6,10,1547,5,764,1.0,496.0,496.0,5,783,1.0,515.0,515.0
0.022,6,10,1989,5,910,5.0,642.0,642.0,5,1079,5.0,811.0,811.0
0.005,6,10,1689,5,839,1.0,571.0,571.0,5,850,1.0,582.0,582.0
0.076,6,10,1506,5,395,16.0,127.0,127.0,5,1111,14.0,843.0,843.0
0.033,6,10,1605,5,388,8.0,120.0,120.0,5,1217,8.0,949.0,949.0
1787.526,6,150,19350,90,13740,20084.0,302.0,302.0,60,5610,30296.0,83.0,83.0
0.13,17,4,364,2,160,0.0,52.0,52.0,2,204,93.0,80.0,74.0
0.013,6,10,1990,5,911,3.0,643.0,643.0,5,1079,3.0,811.0,811.0
0.01,6,10,1689,5,839,2.0,571.0,571.0,5,850,2.0,582.0,582.0
0.003,17,2,170,1,65,0.0,37.0,37.0,1,105,0.0,77.0,77.0
0.078,6,43,13994,24,2565,3.0,517.0,146.0,19,11429,4.0,1402.0,745.0
0.08,6,10,1506,5,395,18.0,127.0,127.0,5,1111,14.0,843.0,843.0
241.768,6,301,342613,116,17541,2102.0,2736.0,885.0,185,325072,1313.0,2804.0,1802.0
240.738,6,24,7709,12,2387,21885.0,757.0,441.0,12,5322,21885.0,1591.0,670.0
0.09,6,10,1506,5,395,21.0,127.0,127.0,5,1111,18.0,843.0,843.0
0.005,6,13,3747,7,509,0.0,137.0,137.0,6,3238,0.0,1470.0,1459.0
0.061,6,10,1506,5,395,13.0,127.0,127.0,5,1111,14.0,843.0,843.0
0.009,6,10,1989,5,910,2.0,642.0,642.0,5,1079,2.0,811.0,811.0
361.826,6,21,1792,16,1030,24121.0,190.0,190.0,5,762,60009.0,461.0,247.0
0.006,6,10,2007,5,928,1.0,660.0,660.0,5,1079,1.0,811.0,811.0
0.012,6,10,1990,5,911,3.0,643.0,643.0,5,1079,3.0,811.0,811.0
0.019,6,10,1989,5,910,4.0,642.0,642.0,5,1079,4.0,811.0,811.0
0.004,6,10,1779,5,928,1.0,660.0,660.0,5,851,1.0,583.0,583.0
0.015,6,10,1972,5,910,3.0,642.0,642.0,5,1062,3.0,794.0,794.0
0.001,17,2,136,1,60,0.0,32.0,32.0,1,76,0.0,48.0,48.0
0.006,17,2,144,1,64,0.0,36.0,36.0,1,80,0.0,52.0,52.0
0.005,6,10,2007,5,928,1.0,660.0,660.0,5,1079,1.0,811.0,811.0
0.019,6,10,1990,5,911,4.0,643.0,643.0,5,1079,4.0,811.0,811.0
0.002,17,2,166,1,75,0.0,47.0,47.0,1,91,0.0,63.0,63.0
0.008,6,10,1972,5,910,2.0,642.0,642.0,5,1062,2.0,794.0,794.0
0.013,6,10,1983,5,910,3.0,642.0,642.0,5,1073,3.0,805.0,805.0
0.023,6,10,1989,5,910,5.0,642.0,642.0,5,1079,5.0,811.0,811.0
0.006,17,2,230,1,68,0.0,40.0,40.0,1,162,0.0,134.0,134.0
10.989,17,28,4417,14,1994,836.0,269.0,114.0,14,2423,835.0,586.0,145.0
0.004,17,2,170,1,65,0.0,37.0,37.0,1,105,0.0,77.0,77.0
0.005,6,10,2006,5,927,1.0,659.0,659.0,5,1079,1.0,811.0,811.0
0.008,17,2,162,1,65,0.0,37.0,37.0,1,97,0.0,69.0,69.0
0.014,6,10,1989,5,910,3.0,642.0,642.0,5,1079,3.0,811.0,811.0
0.014,6,10,1989,5,910,3.0,642.0,642.0,5,1079,3.0,811.0,811.0
0.13,17,2,148,1,60,0.0,32.0,32.0,1,88,0.0,60.0,60.0
0.005,6,10,2006,5,927,1.0,659.0,659.0,5,1079,1.0,811.0,811.0
0.279,17,19,10302,9,7710,34.0,1350.0,828.0,10,2592,20.0,1350.0,231.0
0.005,6,10,1989,5,927,1.0,659.0,659.0,5,1062,1.0,794.0,794.0
0.012,6,10,1972,5,910,3.0,642.0,642.0,5,1062,3.0,794.0,794.0
0.011,6,10,1989,5,910,2.0,642.0,642.0,5,1079,2.0,811.0,811.0
0.005,6,10,1689,5,839,1.0,571.0,571.0,5,850,1.0,582.0,582.0
0.189,17,2,179,1,71,0.0,43.0,43.0,1,108,0.0,80.0,80.0
0.01,6,10,1762,5,911,2.0,643.0,643.0,5,851,2.0,583.0,583.0
0.006,6,10,1547,5,764,1.0,496.0,496.0,5,783,1.0,515.0,515.0
15.075,17,15,9239,8,6902,2149.0,1350.0,834.0,7,2337,2507.0,1350.0,305.0
0.011,6,10,1989,5,910,2.0,642.0,642.0,5,1079,2.0,811.0,811.0
0.089,6,10,1506,5,395,16.0,127.0,127.0,5,1111,20.0,843.0,843.0
1776.719,17,144,41760,72,22752,25023.0,288.0,288.0,72,19008,25023.0,236.0,236.0
0.01,6,10,1677,5,827,2.0,559.0,559.0,5,850,2.0,582.0,582.0
0.01,6,13,3735,7,497,1.0,125.0,125.0,6,3238,1.0,1470.0,1459.0
325.716,17,20,1124,10,716,36176.0,48.0,43.0,10,408,36176.0,20.0,12.0
0.004,17,2,148,1,60,0.0,32.0,32.0,1,88,0.0,60.0,60.0
0.018,6,10,1972,5,910,4.0,642.0,642.0,5,1062,4.0,794.0,794.0
0.006,6,10,1643,5,860,1.0,592.0,592.0,5,783,1.0,515.0,515.0
0.021,6,10,1989,5,910,5.0,642.0,642.0,5,1079,5.0,811.0,811.0
0.005,17,2,214,1,75,0.0,47.0,47.0,1,139,0.0,111.0,111.0
0.016,6,10,1990,5,911,3.0,643.0,643.0,5,1079,4.0,811.0,811.0
10.93,17,28,4423,14,1994,832.0,269.0,114.0,14,2429,832.0,588.0,145.0
0.046,17,2,412,1,61,0.0,33.0,33.0,1,351,0.0,323.0,323.0
0.004,6,10,2007,5,928,1.0,660.0,660.0,5,1079,1.0,811.0,811.0
0.006,6,14,3799,7,509,0.0,137.0,137.0,7,3290,0.0,1448.0,972.0
40.053,17,10,676,5,460,10012.0,104.0,64.0,5,216,10012.0,20.0,15.0
0.003,17,2,148,1,60,0.0,32.0,32.0,1,88,0.0,60.0,60.0
0.004,6,10,2006,5,927,1.0,659.0,659.0,5,1079,1.0,811.0,811.0
0.013,6,10,1990,5,911,3.0,643.0,643.0,5,1079,3.0,811.0,811.0
0.005,6,10,2007,5,928,1.0,660.0,660.0,5,1079,1.0,811.0,811.0
0.018,6,13,3735,7,497,2.0,125.0,125.0,6,3238,3.0,1470.0,1459.0
0.009,6,10,1989,5,910,2.0,642.0,642.0,5,1079,2.0,811.0,811.0
0.013,6,10,1972,5,910,3.0,642.0,642.0,5,1062,3.0,794.0,794.0
0.006,17,2,170,1,65,0.0,37.0,37.0,1,105,0.0,77.0,77.0
0.005,6,10,1779,5,928,1.0,660.0,660.0,5,851,1.0,583.0,583.0
0.003,17,2,152,1,76,0.0,48.0,48.0,1,76,0.0,48.0,48.0
0.001,17,2,180,1,66,0.0,38.0,38.0,1,114,0.0,86.0,86.0
0.001,17,2,180,1,66,0.0,38.0,38.0,1,114,0.0,86.0,86.0
0.011,6,10,1989,5,910,2.0,642.0,642.0,5,1079,2.0,811.0,811.0
0.004,6,10,2006,5,927,1.0,659.0,659.0,5,1079,1.0,811.0,811.0
0.005,6,10,1779,5,928,1.0,660.0,660.0,5,851,1.0,583.0,583.0
0.005,6,10,2006,5,927,1.0,659.0,659.0,5,1079,1.0,811.0,811.0
0.006,6,10,1689,5,839,1.0,571.0,571.0,5,850,1.0,582.0,582.0
0.11,6,10,1506,5,395,25.0,127.0,127.0,5,1111,24.0,843.0,843.0
0.006,6,10,1989,5,927,1.0,659.0,659.0,5,1062,1.0,794.0,794.0
0.006,6,10,2006,5,927,1.0,659.0,659.0,5,1079,1.0,811.0,811.0
0.067,6,10,1506,5,395,16.0,127.0,127.0,5,1111,14.0,843.0,843.0
308.444,17,20,1124,10,716,34262.0,48.0,43.0,10,408,34258.0,20.0,12.0
0.04,17,2,182,1,65,0.0,37.0,37.0,1,117,0.0,89.0,89.0
0.001,17,2,154,1,69,0.0,41.0,41.0,1,85,0.0,57.0,57.0
0.012,6,10,1762,5,911,3.0,643.0,643.0,5,851,2.0,583.0,583.0
0.077,6,10,1506,5,395,17.0,127.0,127.0,5,1111,14.0,843.0,843.0
0.109,6,10,1506,5,395,25.0,127.0,127.0,5,1111,25.0,843.0,843.0
0.012,6,10,1762,5,911,2.0,643.0,643.0,5,851,2.0,583.0,583.0
0.055,6,10,1972,5,910,13.0,642.0,642.0,5,1062,13.0,794.0,794.0
11.14,17,28,4418,14,1995,844.0,270.0,114.0,14,2423,844.0,586.0,145.0
0.006,6,10,1989,5,927,1.0,659.0,659.0,5,1062,1.0,794.0,794.0
0.015,6,10,1990,5,911,3.0,643.0,643.0,5,1079,3.0,811.0,811.0
0.005,6,10,1989,5,927,1.0,659.0,659.0,5,1062,1.0,794.0,794.0
0.071,17,2,136,1,60,0.0,32.0,32.0,1,76,0.0,48.0,48.0
0.007,17,2,179,1,71,0.0,43.0,43.0,1,108,0.0,80.0,80.0
0.025,6,10,1989,5,910,6.0,642.0,642.0,5,1079,6.0,811.0,811.0
0.001,17,2,180,1,66,0.0,38.0,38.0,1,114,0.0,86.0,86.0
0.039,17,2,148,1,60,0.0,32.0,32.0,1,88,0.0,60.0,60.0
0.01,6,10,1989,5,910,2.0,642.0,642.0,5,1079,2.0,811.0,811.0
0.011,6,13,3735,7,497,1.0,125.0,125.0,6,3238,2.0,1470.0,1459.0
0.071,6,10,1506,5,395,14.0,127.0,127.0,5,1111,15.0,843.0,843.0
0.007,17,2,194,1,59,0.0,31.0,31.0,1,135,0.0,107.0,107.0
0.22,6,16,2777,8,1395,31.0,533.0,323.0,8,1382,20.0,529.0,239.0
0.067,6,10,1506,5,395,15.0,127.0,127.0,5,1111,14.0,843.0,843.0
0.187,17,15,8454,7,5923,31.0,1350.0,818.0,8,2531,18.0,1350.0,288.0
366.642,6,27,4293,13,3142,30553.0,494.0,494.0,14,1151,28203.0,83.0,83.0
0.004,17,2,148,1,60,0.0,32.0,32.0,1,88,0.0,60.0,60.0
0.004,6,10,1774,5,923,1.0,655.0,655.0,5,851,1.0,583.0,583.0
300.037,6,12,1782,7,1348,50006.0,494.0,494.0,5,434,75008.0,83.0,83.0
40.09,17,10,676,5,460,10016.0,104.0,64.0,5,216,10021.0,20.0,15.0
0.007,6,10,1547,5,764,1.0,496.0,496.0,5,783,1.0,515.0,515.0
0.009,6,13,3735,7,497,1.0,125.0,125.0,6,3238,1.0,1470.0,1459.0
0.084,6,10,1506,5,395,20.0,127.0,127.0,5,1111,15.0,843.0,843.0
0.008,6,10,1972,5,910,1.0,642.0,642.0,5,1062,1.0,794.0,794.0
0.005,6,10,2007,5,928,1.0,660.0,660.0,5,1079,1.0,811.0,811.0
0.042,17,4,284,2,120,0.0,32.0,32.0,2,164,39.0,60.0,54.0
309.177,17,20,1124,10,716,34346.0,48.0,43.0,10,408,34346.0,20.0,12.0
0.001,17,2,180,1,66,0.0,38.0,38.0,1,114,0.0,86.0,86.0
0.01,6,10,1989,5,910,2.0,642.0,642.0,5,1079,2.0,811.0,811.0
0.122,6,10,1506,5,395,26.0,127.0,127.0,5,1111,27.0,843.0,843.0
0.013,6,10,1989,5,910,3.0,642.0,642.0,5,1079,3.0,811.0,811.0
0.016,6,10,1762,5,911,4.0,643.0,643.0,5,851,4.0,583.0,583.0
0.005,6,10,1989,5,927,1.0,659.0,659.0,5,1062,1.0,794.0,794.0
240.115,6,31,9434,15,7024,17151.0,2147.0,694.0,16,2410,16006.0,580.0,196.0
0.005,17,2,144,1,64,0.0,36.0,36.0,1,80,0.0,52.0,52.0
0.174,6,3,453,2,321,174.0,241.0,241.0,1,132,0.0,92.0,92.0
0.006,6,10,1547,5,764,1.0,496.0,496.0,5,783,1.0,515.0,515.0
1778.647,17,141,44556,72,22752,25051.0,288.0,288.0,69,21804,26156.0,288.0,288.0
0.005,6,10,1689,5,839,1.0,571.0,571.0,5,850,1.0,582.0,582.0
0.011,6,10,1989,5,910,2.0,642.0,642.0,5,1079,2.0,811.0,811.0
240.022,6,9,787,5,488,60005.0,232.0,232.0,4,299,80006.0,83.0,83.0
0.715,6,22,5072,11,1250,61.0,325.0,133.0,11,3822,60.0,1414.0,563.0
0.092,6,10,1506,5,395,19.0,127.0,127.0,5,1111,19.0,843.0,843.0
0.076,6,10,1506,5,395,16.0,127.0,127.0,5,1111,13.0,843.0,843.0
0.005,6,10,2007,5,928,1.0,660.0,660.0,5,1079,1.0,811.0,811.0
300.375,6,16,2170,9,684,37525.0,146.0,146.0,7,1486,50033.0,419.0,398.0
0.021,6,10,1989,5,910,5.0,642.0,642.0,5,1079,5.0,811.0,811.0
354.036,6,19,1691,15,978,25288.0,190.0,190.0,4,713,80003.0,497.0,497.0
0.014,6,10,1989,5,910,3.0,642.0,642.0,5,1079,3.0,811.0,811.0
0.006,6,10,1547,5,764,1.0,496.0,496.0,5,783,1.0,515.0,515.0
0.005,6,10,2006,5,927,1.0,659.0,659.0,5,1079,1.0,811.0,811.0
0.008,6,10,1983,5,910,2.0,642.0,642.0,5,1073,1.0,805.0,805.0
0.006,6,10,1547,5,764,1.0,496.0,496.0,5,783,1.0,515.0,515.0
0.005,6,10,2000,5,927,1.0,659.0,659.0,5,1073,1.0,805.0,805.0
240.092,6,32,9117,16,6627,16006.0,1701.0,644.0,16,2490,16005.0,580.0,206.0
0.022,6,10,1989,5,910,5.0,642.0,642.0,5,1079,5.0,811.0,811.0
0.019,6,10,1990,5,911,4.0,643.0,643.0,5,1079,4.0,811.0,811.0
0.078,6,10,1506,5,395,16.0,127.0,127.0,5,1111,17.0,843.0,843.0
0.005,6,10,2000,5,927,1.0,659.0,659.0,5,1073,1.0,805.0,805.0
0.005,6,10,2006,5,927,1.0,659.0,659.0,5,1079,1.0,811.0,811.0
0.121,6,10,1506,5,395,23.0,127.0,127.0,5,1111,29.0,843.0,843.0
10.772,17,28,4418,14,1993,820.0,268.0,114.0,14,2425,820.0,588.0,145.0
0.023,6,10,1989,5,910,5.0,642.0,642.0,5,1079,5.0,811.0,811.0
0.009,6,10,1989,5,910,2.0,642.0,642.0,5,1079,2.0,811.0,811.0
0.009,6,10,1990,5,911,2.0,643.0,643.0,5,1079,2.0,811.0,811.0
0.041,17,4,420,2,122,0.0,33.0,33.0,2,298,37.0,145.0,121.0
0.013,6,10,1989,5,910,3.0,642.0,642.0,5,1079,3.0,811.0,811.0
0.081,6,10,1506,5,395,19.0,127.0,127.0,5,1111,18.0,843.0,843.0
0.124,6,10,1506,5,395,28.0,127.0,127.0,5,1111,27.0,843.0,843.0
0.005,17,2,214,1,75,0.0,47.0,47.0,1,139,0.0,111.0,111.0
0.013,6,10,1989,5,910,3.0,642.0,642.0,5,1079,3.0,811.0,811.0
176.352,17,78,10943,39,2592,4640.0,44.0,38.0,39,8351,4640.0,239.0,186.0
0.006,6,12,1698,6,863,1.0,327.0,271.0,6,835,1.0,515.0,515.0
0.002,17,2,294,1,64,0.0,36.0,36.0,1,230,0.0,202.0,202.0
0.089,6,10,1506,5,395,18.0,127.0,127.0,5,1111,19.0,843.0,843.0
0.136,17,2,182,1,65,0.0,37.0,37.0,1,117,0.0,89.0,89.0
0.006,17,2,179,1,71,0.0,43.0,43.0,1,108,0.0,80.0,80.0
0.005,6,10,2006,5,927,1.0,659.0,659.0,5,1079,1.0,811.0,811.0
0.01,6,10,1989,5,910,2.0,642.0,642.0,5,1079,2.0,811.0,811.0
0.012,6,10,1989,5,910,2.0,642.0,642.0,5,1079,3.0,811.0,811.0
0.011,6,10,1989,5,910,2.0,642.0,642.0,5,1079,2.0,811.0,811.0
242.37,58,7,504,5,360,60592.0,24.0,24.0,2,144,230198.0,24.0,24.0
0.004,17,2,148,1,60,0.0,32.0,32.0,1,88,0.0,60.0,60.0
0.074,6,10,1506,5,395,16.0,127.0,127.0,5,1111,16.0,843.0,843.0
0.075,6,10,1506,5,395,16.0,127.0,127.0,5,1111,17.0,843.0,843.0
0.01,6,10,1990,5,911,2.0,643.0,643.0,5,1079,2.0,811.0,811.0
0.011,6,10,1677,5,827,2.0,559.0,559.0,5,850,2.0,582.0,582.0
0.007,6,10,1854,5,889,1.0,621.0,621.0,5,965,1.0,697.0,697.0
0.102,6,10,1506,5,395,23.0,127.0,127.0,5,1111,22.0,843.0,843.0
0.041,17,2,148,1,60,0.0,32.0,32.0,1,88,0.0,60.0,60.0
0.102,6,10,1506,5,395,21.0,127.0,127.0,5,1111,23.0,843.0,843.0
0.012,6,10,1990,5,911,3.0,643.0,643.0,5,1079,3.0,811.0,811.0
0.005,6,10,1854,5,889,1.0,621.0,621.0,5,965,1.0,697.0,697.0
0.01,6,12,1926,6,1189,1.0,659.0,434.0,6,737,2.0,417.0,417.0
0.042,17,2,170,1,65,0.0,37.0,37.0,1,105,0.0,77.0,77.0
0.009,6,10,1989,5,910,2.0,642.0,642.0,5,1079,2.0,811.0,811.0
162.491,17,92,13436,46,3103,3610.0,44.0,39.0,46,10333,3610.0,260.0,196.0
0.006,6,10,2006,5,927,1.0,659.0,659.0,5,1079,1.0,811.0,811.0
0.151,6,10,1506,5,395,33.0,127.0,127.0,5,1111,36.0,843.0,843.0
0.006,6,10,1689,5,839,1.0,571.0,571.0,5,850,1.0,582.0,582.0
0.005,6,10,1989,5,927,1.0,659.0,659.0,5,1062,1.0,794.0,794.0
0.004,17,2,170,1,65,0.0,37.0,37.0,1,105,0.0,77.0,77.0
0.005,6,10,1547,5,764,1.0,496.0,496.0,5,783,1.0,515.0,515.0
0.052,17,2,152,1,76,0.0,48.0,48.0,1,76,0.0,48.0,48.0
0.005,17,2,180,1,66,0.0,38.0,38.0,1,114,0.0,86.0,86.0
0.007,6,13,3747,7,509,1.0,137.0,137.0,6,3238,1.0,1470.0,1459.0
0.004,6,10,2007,5,928,1.0,660.0,660.0,5,1079,0.0,811.0,811.0
0.009,6,10,1983,5,910,2.0,642.0,642.0,5,1073,2.0,805.0,805.0
0.005,17,2,144,1,64,0.0,36.0,36.0,1,80,0.0,52.0,52.0
0.011,6,10,1990,5,911,2.0,643.0,643.0,5,1079,2.0,811.0,811.0
0.005,17,2,214,1,75,0.0,47.0,47.0,1,139,0.0,111.0,111.0
0.129,17,2,80,1,32,0.0,4.0,4.0,1,48,0.0,20.0,20.0
0.004,6,10,2000,5,927,1.0,659.0,659.0,5,1073,1.0,805.0,805.0
0.006,6,10,1547,5,764,1.0,496.0,496.0,5,783,1.0,515.0,515.0
0.095,6,10,1506,5,395,20.0,127.0,127.0,5,1111,20.0,843.0,843.0
0.086,6,10,1506,5,395,19.0,127.0,127.0,5,1111,19.0,843.0,843.0
0.004,17,2,148,1,60,0.0,32.0,32.0,1,88,0.0,60.0,60.0
0.009,6,10,1677,5,827,2.0,559.0,559.0,5,850,2.0,582.0,582.0
0.005,6,10,1689,5,839,1.0,571.0,571.0,5,850,1.0,582.0,582.0
0.003,17,2,148,1,60,0.0,32.0,32.0,1,88,0.0,60.0,60.0
0.005,6,10,2000,5,927,1.0,659.0,659.0,5,1073,1.0,805.0,805.0
308.417,17,20,1124,10,716,34256.0,48.0,43.0,10,408,34257.0,20.0,12.0
0.005,6,10,1989,5,927,1.0,659.0,659.0,5,1062,1.0,794.0,794.0
0.005,6,10,1989,5,927,1.0,659.0,659.0,5,1062,1.0,794.0,794.0
0.005,6,10,1989,5,927,1.0,659.0,659.0,5,1062,1.0,794.0,794.0
0.131,17,2,148,1,60,0.0,32.0,32.0,1,88,0.0,60.0,60.0
0.004,6,10,1989,5,927,1.0,659.0,659.0,5,1062,1.0,794.0,794.0
40.058,17,10,676,5,460,10013.0,104.0,64.0,5,216,10013.0,20.0,15.0
0.076,6,10,1506,5,395,17.0,127.0,127.0,5,1111,18.0,843.0,843.0
319.383,17,20,1124,10,716,35472.0,48.0,43.0,10,408,35472.0,20.0,12.0
0.076,6,10,1506,5,395,16.0,127.0,127.0,5,1111,18.0,843.0,843.0
0.006,6,10,1854,5,889,1.0,621.0,621.0,5,965,1.0,697.0,697.0
240.085,6,16,4480,9,963,30010.0,238.0,166.0,7,3517,40013.0,1402.0,786.0
0.012,6,10,1762,5,911,3.0,643.0,643.0,5,851,3.0,583.0,583.0
0.009,6,10,1972,5,910,2.0,642.0,642.0,5,1062,2.0,794.0,794.0
0.005,6,10,2000,5,927,1.0,659.0,659.0,5,1073,1.0,805.0,805.0
0.005,6,14,3799,7,509,0.0,137.0,137.0,7,3290,0.0,1448.0,972.0
0.072,17,2,170,1,65,0.0,37.0,37.0,1,105,0.0,77.0,77.0
40.061,17,10,676,5,460,10012.0,104.0,64.0,5,216,10014.0,20.0,15.0
0.004,6,10,1989,5,927,1.0,659.0,659.0,5,1062,1.0,794.0,794.0
0.016,6,10,1989,5,910,4.0,642.0,642.0,5,1079,3.0,811.0,811.0
0.043,17,2,152,1,76,0.0,48.0,48.0,1,76,0.0,48.0,48.0
0.164,6,10,1506,5,395,39.0,127.0,127.0,5,1111,38.0,843.0,843.0
0.021,6,10,1677,5,827,5.0,559.0,559.0,5,850,5.0,582.0,582.0
0.004,17,4,284,2,120,0.0,32.0,32.0,2,164,1.0,60.0,54.0
0.015,6,10,1631,5,848,3.0,580.0,580.0,5,783,3.0,515.0,515.0
0.007,6,10,1983,5,910,1.0,642.0,642.0,5,1073,1.0,805.0,805.0
0.162,17,2,152,1,76,0.0,48.0,48.0,1,76,0.0,48.0,48.0
0.067,17,8,3613,4,1874,22.0,1350.0,440.0,4,1739,11.0,1350.0,406.0
294.255,6,396,348948,187,21288,1582.0,2736.0,888.0,209,327660,1414.0,4136.0,1624.0
0.011,17,2,214,1,75,0.0,47.0,47.0,1,139,0.0,111.0,111.0
0.005,17,2,154,1,69,0.0,41.0,41.0,1,85,0.0,57.0,57.0
10.937,17,28,4422,14,1995,833.0,270.0,114.0,14,2427,833.0,586.0,145.0
240.252,6,42,5261,21,2475,12012.0,588.0,196.0,21,2786,12012.0,580.0,210.0
0.005,6,10,1779,5,928,1.0,660.0,660.0,5,851,1.0,583.0,583.0
1791.395,6,488,99226,246,88009,7311.0,421.0,366.0,242,11217,7432.0,53.0,53.0
0.115,17,2,299,1,65,0.0,37.0,37.0,1,234,0.0,206.0,206.0
1772.138,6,106,6361,60,3537,30035.0,27.0,27.0,46,2824,39379.0,27.0,27.0
0.006,6,10,1689,5,839,1.0,571.0,571.0,5,850,1.0,582.0,582.0
0.005,6,10,1989,5,927,1.0,659.0,659.0,5,1062,1.0,794.0,794.0
0.018,6,10,1677,5,827,4.0,559.0,559.0,5,850,4.0,582.0,582.0
0.004,6,10,2000,5,927,1.0,659.0,659.0,5,1073,1.0,805.0,805.0
0.02,6,10,1762,5,911,4.0,643.0,643.0,5,851,5.0,583.0,583.0
0.005,6,10,2007,5,928,1.0,660.0,660.0,5,1079,1.0,811.0,811.0
0.003,17,2,136,1,60,0.0,32.0,32.0,1,76,0.0,48.0,48.0
0.095,6,10,1506,5,395,19.0,127.0,127.0,5,1111,22.0,843.0,843.0
0.009,6,10,1990,5,911,2.0,643.0,643.0,5,1079,2.0,811.0,811.0
0.005,6,10,2006,5,927,1.0,659.0,659.0,5,1079,1.0,811.0,811.0
0.015,6,10,1677,5,827,3.0,559.0,559.0,5,850,3.0,582.0,582.0
0.006,6,10,1854,5,889,1.0,621.0,621.0,5,965,1.0,697.0,697.0
0.068,17,8,3613,4,1874,22.0,1350.0,440.0,4,1739,11.0,1350.0,406.0
10.956,17,28,4397,14,2312,834.0,587.0,137.0,14,2085,834.0,268.0,120.0
0.022,6,10,1983,5,910,5.0,642.0,642.0,5,1073,5.0,805.0,805.0
0.004,17,4,284,2,120,1.0,32.0,32.0,2,164,1.0,60.0,54.0
0.095,6,10,1506,5,395,21.0,127.0,127.0,5,1111,22.0,843.0,843.0
0.076,6,10,1506,5,395,18.0,127.0,127.0,5,1111,15.0,843.0,843.0
0.069,6,10,1506,5,395,16.0,127.0,127.0,5,1111,12.0,843.0,843.0
0.012,6,10,1989,5,910,3.0,642.0,642.0,5,1079,2.0,811.0,811.0
0.007,6,10,1972,5,910,1.0,642.0,642.0,5,1062,1.0,794.0,794.0
40.05,17,10,676,5,460,10011.0,104.0,64.0,5,216,10011.0,20.0,15.0
366.145,6,22,2313,16,867,24409.0,195.0,195.0,6,1446,4645.0,419.0,398.0
0.005,6,10,1774,5,923,1.0,655.0,655.0,5,851,1.0,583.0,583.0
0.006,6,10,1547,5,764,1.0,496.0,496.0,5,783,1.0,515.0,515.0
0.004,6,10,1989,5,927,1.0,659.0,659.0,5,1062,1.0,794.0,794.0
0.006,6,10,1547,5,764,1.0,496.0,496.0,5,783,1.0,515.0,515.0
0.023,6,10,1990,5,911,5.0,643.0,643.0,5,1079,5.0,811.0,811.0
0.011,6,10,1983,5,910,2.0,642.0,642.0,5,1073,2.0,805.0,805.0
0.006,6,10,1547,5,764,1.0,496.0,496.0,5,783,1.0,515.0,515.0
0.097,6,10,1506,5,395,23.0,127.0,127.0,5,1111,22.0,843.0,843.0
0.07,17,8,3613,4,1874,23.0,1350.0,440.0,4,1739,12.0,1350.0,406.0
0.006,6,10,1547,5,764,1.0,496.0,496.0,5,783,1.0,515.0,515.0
0.037,17,4,284,2,120,0.0,32.0,32.0,2,164,33.0,60.0,54.0
0.102,6,10,1506,5,395,23.0,127.0,127.0,5,1111,23.0,843.0,843.0
0.006,6,10,1547,5,764,1.0,496.0,496.0,5,783,1.0,515.0,515.0
1755.984,6,106,6322,60,3525,29761.0,27.0,27.0,46,2797,39020.0,27.0,27.0
0.001,17,2,180,1,66,0.0,38.0,38.0,1,114,0.0,86.0,86.0
0.011,6,10,1972,5,910,2.0,642.0,642.0,5,1062,2.0,794.0,794.0
0.001,17,2,136,1,60,0.0,32.0,32.0,1,76,0.0,48.0,48.0
0.059,6,10,1506,5,395,12.0,127.0,127.0,5,1111,14.0,843.0,843.0
0.006,6,10,1854,5,889,1.0,621.0,621.0,5,965,1.0,697.0,697.0
0.006,6,10,1547,5,764,1.0,496.0,496.0,5,783,1.0,515.0,515.0
0.005,6,10,1989,5,927,1.0,659.0,659.0,5,1062,1.0,794.0,794.0
40.045,17,10,676,5,460,10010.0,104.0,64.0,5,216,10010.0,20.0,15.0
308.297,17,20,1124,10,716,34248.0,48.0,43.0,10,408,34243.0,20.0,12.0
0.006,6,10,1547,5,764,1.0,496.0,496.0,5,783,1.0,515.0,515.0
300.948,6,43,18636,23,13038,13679.0,4080.0,1342.0,20,5598,461.0,2667.0,435.0
0.014,6,10,1989,5,910,3.0,642.0,642.0,5,1079,3.0,811.0,811.0
15.078,17,16,8324,8,6104,2150.0,1350.0,735.0,8,2220,2149.0,1350.0,249.0
0.016,6,10,1972,5,910,3.0,642.0,642.0,5,1062,4.0,794.0,794.0
0.069,6,10,1506,5,395,15.0,127.0,127.0,5,1111,16.0,843.0,843.0
0.021,6,10,1677,5,827,5.0,559.0,559.0,5,850,5.0,582.0,582.0
0.013,6,10,1631,5,848,3.0,580.0,580.0,5,783,3.0,515.0,515.0
176.154,17,78,11016,39,2593,4635.0,44.0,38.0,39,8423,4635.0,261.0,187.0
0.014,6,10,1631,5,848,3.0,580.0,580.0,5,783,3.0,515.0,515.0
0.005,6,10,2000,5,927,1.0,659.0,659.0,5,1073,1.0,805.0,805.0
0.005,6,10,2006,5,927,1.0,659.0,659.0,5,1079,1.0,811.0,811.0
168.306,17,78,11247,39,2603,4428.0,44.0,38.0,39,8644,4429.0,239.0,193.0
0.008,6,12,1926,6,1189,1.0,659.0,434.0,6,737,1.0,417.0,417.0
1730.445,6,45,2790,30,1725,59670.0,35.0,35.0,15,1065,123598.0,31.0,31.0
0.005,6,14,3799,7,509,0.0,137.0,137.0,7,3290,0.0,1448.0,972.0
0.016,6,10,1989,5,910,4.0,642.0,642.0,5,1079,3.0,811.0,811.0
0.021,6,11,2035,6,962,4.0,642.0,642.0,5,1073,5.0,805.0,805.0
0.006,6,10,1547,5,764,1.0,496.0,496.0,5,783,1.0,515.0,515.0
0.014,6,10,1677,5,827,3.0,559.0,559.0,5,850,3.0,582.0,582.0
0.009,6,12,1926,6,1189,1.0,659.0,434.0,6,737,1.0,417.0,417.0
0.004,17,4,284,2,120,0.0,32.0,32.0,2,164,1.0,60.0,54.0
0.005,6,13,3690,7,452,0.0,80.0,80.0,6,3238,1.0,1470.0,1459.0
0.005,6,10,1689,5,839,1.0,571.0,571.0,5,850,1.0,582.0,582.0
0.012,6,10,1989,5,910,3.0,642.0,642.0,5,1079,2.0,811.0,811.0
0.042,17,2,170,1,65,0.0,37.0,37.0,1,105,0.0,77.0,77.0
0.094,6,10,1506,5,395,22.0,127.0,127.0,5,1111,22.0,843.0,843.0
0.004,6,10,2007,5,928,1.0,660.0,660.0,5,1079,1.0,811.0,811.0
0.005,6,10,1689,5,839,1.0,571.0,571.0,5,850,1.0,582.0,582.0
0.008,6,10,1989,5,910,2.0,642.0,642.0,5,1079,1.0,811.0,811.0
0.011,6,10,1990,5,911,2.0,643.0,643.0,5,1079,2.0,811.0,811.0
0.024,6,10,1762,5,911,6.0,643.0,643.0,5,851,6.0,583.0,583.0
0.005,6,13,3747,7,509,0.0,137.0,137.0,6,3238,0.0,1470.0,1459.0
1761.299,6,454,66085,253,35232,6989.0,613.0,197.0,201,30853,8805.0,453.0,144.0
15.172,17,20,14815,10,9658,1681.0,1350.0,937.0,10,5157,1680.0,1350.0,487.0
0.012,6,10,1990,5,911,3.0,643.0,643.0,5,1079,3.0,811.0,811.0
0.164,6,10,1506,5,395,39.0,127.0,127.0,5,1111,37.0,843.0,843.0
0.005,6,10,1643,5,860,1.0,592.0,592.0,5,783,1.0,515.0,515.0
0.006,6,10,1547,5,764,1.0,496.0,496.0,5,783,1.0,515.0,515.0
0.006,6,10,1689,5,839,1.0,571.0,571.0,5,850,1.0,582.0,582.0
310.563,17,18,1008,9,640,38806.0,48.0,43.0,9,368,38809.0,20.0,12.0
0.016,6,10,1762,5,911,4.0,643.0,643.0,5,851,4.0,583.0,583.0
0.012,6,10,1972,5,910,3.0,642.0,642.0,5,1062,2.0,794.0,794.0
0.014,6,10,1972,5,910,3.0,642.0,642.0,5,1062,3.0,794.0,794.0
0.084,6,10,1506,5,395,20.0,127.0,127.0,5,1111,16.0,843.0,843.0
0.052,17,2,152,1,76,0.0,48.0,48.0,1,76,0.0,48.0,48.0
0.188,6,10,1506,5,395,44.0,127.0,127.0,5,1111,44.0,843.0,843.0
0.005,6,10,2007,5,928,1.0,660.0,660.0,5,1079,1.0,811.0,811.0
0.717,17,387,337799,131,12902,5.0,1350.0,70.0,256,324897,2.0,1350.0,1241.0
0.006,6,10,1643,5,860,1.0,592.0,592.0,5,783,1.0,515.0,515.0
0.004,6,10,1989,5,927,1.0,659.0,659.0,5,1062,1.0,794.0,794.0
0.12,6,10,1506,5,395,29.0,127.0,127.0,5,1111,26.0,843.0,843.0
0.007,6,10,1547,5,764,1.0,496.0,496.0,5,783,1.0,515.0,515.0
0.005,6,13,3684,7,446,0.0,74.0,74.0,6,3238,1.0,1470.0,1459.0
0.011,6,10,1631,5,848,2.0,580.0,580.0,5,783,2.0,515.0,515.0
0.072,6,10,1506,5,395,14.0,127.0,127.0,5,1111,16.0,843.0,843.0
367.009,6,21,1795,16,1030,24467.0,190.0,190.0,5,765,60015.0,464.0,248.0
369.946,6,22,2313,16,867,24663.0,195.0,195.0,6,1446,4643.0,419.0,398.0
40.062,17,10,676,5,460,10014.0,104.0,64.0,5,216,10014.0,20.0,15.0
240.09,6,16,4480,9,963,30011.0,238.0,166.0,7,3517,40014.0,1402.0,786.0
0.006,6,10,1854,5,889,1.0,621.0,621.0,5,965,1.0,697.0,697.0
0.004,17,2,148,1,60,0.0,32.0,32.0,1,88,0.0,60.0,60.0
0.004,17,2,148,1,60,0.0,32.0,32.0,1,88,0.0,60.0,60.0
0.013,6,10,1989,5,910,3.0,642.0,642.0,5,1079,3.0,811.0,811.0
0.04,17,2,136,1,60,0.0,32.0,32.0,1,76,0.0,48.0,48.0
0.074,6,10,1506,5,395,16.0,127.0,127.0,5,1111,16.0,843.0,843.0
0.005,6,10,1689,5,839,1.0,571.0,571.0,5,850,1.0,582.0,582.0
0.005,6,10,2000,5,927,1.0,659.0,659.0,5,1073,1.0,805.0,805.0
10.94,17,28,4421,14,1993,832.0,268.0,114.0,14,2428,832.0,587.0,145.0
0.013,6,10,1990,5,911,3.0,643.0,643.0,5,1079,3.0,811.0,811.0
0.113,6,10,1506,5,395,27.0,127.0,127.0,5,1111,23.0,843.0,843.0
0.013,6,10,1990,5,911,3.0,643.0,643.0,5,1079,3.0,811.0,811.0
0.224,6,16,2777,8,1395,32.0,533.0,323.0,8,1382,20.0,529.0,239.0
0.01,6,10,1677,5,827,2.0,559.0,559.0,5,850,2.0,582.0,582.0
0.094,6,10,1506,5,395,20.0,127.0,127.0,5,1111,20.0,843.0,843.0
0.009,6,10,1972,5,910,2.0,642.0,642.0,5,1062,2.0,794.0,794.0
0.005,6,10,1854,5,889,1.0,621.0,621.0,5,965,1.0,697.0,697.0
10.74,17,28,4422,14,1994,817.0,269.0,114.0,14,2428,817.0,587.0,145.0
0.007,17,2,132,1,58,0.0,30.0,30.0,1,74,0.0,46.0,46.0
0.006,6,10,1702,5,863,1.0,595.0,595.0,5,839,1.0,571.0,571.0
0.004,17,2,148,1,60,0.0,32.0,32.0,1,88,0.0,60.0,60.0
0.005,6,14,3799,7,509,0.0,137.0,137.0,7,3290,0.0,1448.0,972.0
0.01,6,10,1762,5,911,2.0,643.0,643.0,5,851,2.0,583.0,583.0
0.11,6,10,1506,5,395,26.0,127.0,127.0,5,1111,26.0,843.0,843.0
0.005,6,10,2007,5,928,1.0,660.0,660.0,5,1079,1.0,811.0,811.0
0.012,6,6,716,3,458,4.0,302.0,302.0,3,258,4.0,102.0,102.0
0.015,17,2,198,1,91,0.0,63.0,63.0,1,107,0.0,79.0,79.0
0.039,17,2,136,1,60,0.0,32.0,32.0,1,76,0.0,48.0,48.0
0.025,6,14,3787,7,497,4.0,125.0,125.0,7,3290,4.0,1448.0,972.0
0.097,6,10,1506,5,395,20.0,127.0,127.0,5,1111,22.0,843.0,843.0
0.041,17,4,352,2,130,0.0,37.0,37.0,2,222,32.0,89.0,83.0
0.014,6,10,1983,5,910,3.0,642.0,642.0,5,1073,3.0,805.0,805.0
0.005,6,10,2007,5,928,1.0,660.0,660.0,5,1079,1.0,811.0,811.0
0.077,6,10,1506,5,395,17.0,127.0,127.0,5,1111,16.0,843.0,843.0
40.055,17,10,676,5,460,10012.0,104.0,64.0,5,216,10012.0,20.0,15.0
15.078,17,15,8160,8,5975,2149.0,1350.0,718.0,7,2185,2508.0,1350.0,284.0
0.006,6,10,1547,5,764,1.0,496.0,496.0,5,783,1.0,515.0,515.0
0.006,6,10,1774,5,923,1.0,655.0,655.0,5,851,1.0,583.0,583.0
0.005,6,10,2007,5,928,1.0,660.0,660.0,5,1079,1.0,811.0,811.0
0.01,6,10,1990,5,911,2.0,643.0,643.0,5,1079,2.0,811.0,811.0
0.026,6,10,1990,5,911,6.0,643.0,643.0,5,1079,6.0,811.0,811.0
0.016,6,10,1990,5,911,4.0,643.0,643.0,5,1079,4.0,811.0,811.0
0.006,6,12,1698,6,863,1.0,327.0,271.0,6,835,1.0,515.0,515.0
0.086,6,10,1506,5,395,18.0,127.0,127.0,5,1111,20.0,843.0,843.0
0.003,17,2,148,1,60,0.0,32.0,32.0,1,88,0.0,60.0,60.0
308.737,17,20,1124,10,716,34297.0,48.0,43.0,10,408,34297.0,20.0,12.0
0.007,6,10,1990,5,911,1.0,643.0,643.0,5,1079,1.0,811.0,811.0
0.008,17,4,284,2,120,0.0,32.0,32.0,2,164,0.0,60.0,54.0
0.103,6,10,1506,5,395,23.0,127.0,127.0,5,1111,24.0,843.0,843.0
0.006,6,10,1547,5,764,1.0,496.0,496.0,5,783,1.0,515.0,515.0
0.016,6,10,1972,5,910,3.0,642.0,642.0,5,1062,3.0,794.0,794.0
0.005,6,10,2006,5,927,1.0,659.0,659.0,5,1079,1.0,811.0,811.0
0.107,6,10,1506,5,395,23.0,127.0,127.0,5,1111,24.0,843.0,843.0
0.004,6,10,2006,5,927,1.0,659.0,659.0,5,1079,1.0,811.0,811.0
0.016,6,10,1989,5,910,3.0,642.0,642.0,5,1079,4.0,811.0,811.0
0.246,17,2,152,1,76,0.0,48.0,48.0,1,76,0.0,48.0,48.0
0.014,6,10,1989,5,910,3.0,642.0,642.0,5,1079,3.0,811.0,811.0
0.006,6,10,1547,5,764,1.0,496.0,496.0,5,783,1.0,515.0,515.0
0.007,6,10,1774,5,923,1.0,655.0,655.0,5,851,1.0,583.0,583.0
0.004,6,10,1702,5,863,0.0,595.0,595.0,5,839,1.0,571.0,571.0
0.011,6,10,1989,5,910,2.0,642.0,642.0,5,1079,2.0,811.0,811.0
0.002,17,2,180,1,66,0.0,38.0,38.0,1,114,0.0,86.0,86.0
0.069,17,8,3613,4,1874,23.0,1350.0,440.0,4,1739,11.0,1350.0,406.0
0.006,6,10,1689,5,839,1.0,571.0,571.0,5,850,1.0,582.0,582.0
0.088,6,10,1506,5,395,19.0,127.0,127.0,5,1111,16.0,843.0,843.0
0.089,6,10,1506,5,395,21.0,127.0,127.0,5,1111,15.0,843.0,843.0
60.017,6,10,1690,6,1308,12003.0,494.0,494.0,4,382,20004.0,83.0,83.0
0.005,6,10,1779,5,928,1.0,660.0,660.0,5,851,1.0,583.0,583.0
172.338,17,86,12401,43,2889,4103.0,44.0,39.0,43,9512,4103.0,239.0,193.0
0.012,6,10,1983,5,910,2.0,642.0,642.0,5,1073,3.0,805.0,805.0
0.013,6,10,1762,5,911,3.0,643.0,643.0,5,851,3.0,583.0,583.0
0.015,6,10,1989,5,910,3.0,642.0,642.0,5,1079,3.0,811.0,811.0
0.005,6,10,1774,5,923,1.0,655.0,655.0,5,851,1.0,583.0,583.0
0.005,6,10,1989,5,927,1.0,659.0,659.0,5,1062,1.0,794.0,794.0
0.094,6,10,1506,5,395,21.0,127.0,127.0,5,1111,22.0,843.0,843.0
0.001,17,2,180,1,66,0.0,38.0,38.0,1,114,0.0,86.0,86.0
0.015,6,10,1990,5,911,3.0,643.0,643.0,5,1079,3.0,811.0,811.0
0.111,6,10,1506,5,395,26.0,127.0,127.0,5,1111,25.0,843.0,843.0
40.054,17,10,676,5,460,10012.0,104.0,64.0,5,216,10012.0,20.0,15.0
0.005,6,13,3747,7,509,0.0,137.0,137.0,6,3238,0.0,1470.0,1459.0
0.013,6,12,1926,6,1189,2.0,659.0,434.0,6,737,2.0,417.0,417.0
0.006,17,2,225,1,65,0.0,37.0,37.0,1,160,0.0,132.0,132.0
0.007,6,10,1689,5,839,1.0,571.0,571.0,5,850,1.0,582.0,582.0
0.011,6,10,1972,5,910,2.0,642.0,642.0,5,1062,2.0,794.0,794.0
0.004,17,2,208,1,72,0.0,44.0,44.0,1,136,0.0,108.0,108.0
0.005,6,10,1689,5,839,1.0,571.0,571.0,5,850,1.0,582.0,582.0
0.003,17,2,136,1,60,0.0,32.0,32.0,1,76,0.0,48.0,48.0
0.067,6,10,1506,5,395,15.0,127.0,127.0,5,1111,14.0,843.0,843.0
0.005,6,10,1989,5,927,1.0,659.0,659.0,5,1062,1.0,794.0,794.0
0.006,6,10,1547,5,764,1.0,496.0,496.0,5,783,1.0,515.0,515.0
0.019,6,10,1677,5,827,4.0,559.0,559.0,5,850,4.0,582.0,582.0
0.005,6,10,1689,5,839,1.0,571.0,571.0,5,850,1.0,582.0,582.0
0.077,6,10,1506,5,395,17.0,127.0,127.0,5,1111,16.0,843.0,843.0
0.071,6,10,1506,5,395,17.0,127.0,127.0,5,1111,14.0,843.0,843.0
0.068,6,10,1506,5,395,15.0,127.0,127.0,5,1111,14.0,843.0,843.0
0.018,6,10,1972,5,910,4.0,642.0,642.0,5,1062,4.0,794.0,794.0
308.438,17,20,1124,10,716,34257.0,48.0,43.0,10,408,34264.0,20.0,12.0
0.026,6,10,1990,5,911,6.0,643.0,643.0,5,1079,6.0,811.0,811.0
0.005,17,2,144,1,64,0.0,36.0,36.0,1,80,0.0,52.0,52.0
0.005,17,2,164,1,74,0.0,46.0,46.0,1,90,0.0,62.0,62.0
0.015,6,10,1983,5,910,3.0,642.0,642.0,5,1073,3.0,805.0,805.0
0.01,6,10,1972,5,910,2.0,642.0,642.0,5,1062,2.0,794.0,794.0
0.084,6,10,1506,5,395,19.0,127.0,127.0,5,1111,18.0,843.0,843.0
0.004,17,2,148,1,60,0.0,32.0,32.0,1,88,0.0,60.0,60.0
0.084,6,10,1506,5,395,18.0,127.0,127.0,5,1111,20.0,843.0,843.0
0.041,17,2,152,1,76,0.0,48.0,48.0,1,76,0.0,48.0,48.0
40.057,17,10,676,5,460,10013.0,104.0,64.0,5,216,10013.0,20.0,15.0
240.087,6,16,4481,9,963,30010.0,238.0,166.0,7,3518,40013.0,1402.0,786.0
0.006,6,12,1698,6,863,1.0,327.0,271.0,6,835,1.0,515.0,515.0
0.007,6,10,1854,5,889,1.0,621.0,621.0,5,965,1.0,697.0,697.0
0.011,6,10,1983,5,910,2.0,642.0,642.0,5,1073,2.0,805.0,805.0
481.315,6,36,12790,19,4166,26737.0,676.0,452.0,17,8624,30080.0,1402.0,860.0
0.011,6,10,1989,5,910,2.0,642.0,642.0,5,1079,2.0,811.0,811.0
1.028,6,12,3142,6,2099,154.0,1328.0,923.0,6,1043,154.0,791.0,791.0
0.005,6,10,2006,5,927,1.0,659.0,659.0,5,1079,1.0,811.0,811.0
0.112,6,10,1506,5,395,26.0,127.0,127.0,5,1111,27.0,843.0,843.0
0.011,6,10,1983,5,910,2.0,642.0,642.0,5,1073,2.0,805.0,805.0
0.014,6,10,1972,5,910,3.0,642.0,642.0,5,1062,3.0,794.0,794.0
0.011,6,10,1972,5,910,2.0,642.0,642.0,5,1062,2.0,794.0,794.0
0.004,17,2,148,1,60,0.0,32.0,32.0,1,88,0.0,60.0,60.0
0.007,6,10,1762,5,911,1.0,643.0,643.0,5,851,1.0,583.0,583.0
0.076,17,2,144,1,64,0.0,36.0,36.0,1,80,0.0,52.0,52.0
0.083,6,10,1506,5,395,15.0,127.0,127.0,5,1111,17.0,843.0,843.0
0.002,17,2,136,1,60,0.0,32.0,32.0,1,76,0.0,48.0,48.0
1.142,6,32,13392,18,5893,67.0,2720.0,854.0,14,7499,74.0,2720.0,769.0
0.008,6,10,1990,5,911,2.0,643.0,643.0,5,1079,2.0,811.0,811.0
10.766,17,28,4422,14,1994,819.0,269.0,114.0,14,2428,819.0,587.0,145.0
0.005,6,10,2000,5,927,1.0,659.0,659.0,5,1073,1.0,805.0,805.0
0.001,17,2,166,1,75,0.0,47.0,47.0,1,91,0.0,63.0,63.0
40.077,17,10,676,5,460,10017.0,104.0,64.0,5,216,10018.0,20.0,15.0
66.467,6,111,86885,64,12430,1055.0,2823.0,1135.0,47,74455,1441.0,3122.0,1800.0
0.007,6,10,1689,5,839,1.0,571.0,571.0,5,850,1.0,582.0,582.0
0.005,6,10,2007,5,928,1.0,660.0,660.0,5,1079,1.0,811.0,811.0
0.085,6,10,1506,5,395,19.0,127.0,127.0,5,1111,17.0,843.0,843.0
0.006,6,10,1689,5,839,1.0,571.0,571.0,5,850,1.0,582.0,582.0
0.021,6,10,1762,5,911,5.0,643.0,643.0,5,851,5.0,583.0,583.0
0.004,17,2,169,1,62,0.0,34.0,34.0,1,107,0.0,79.0,79.0
0.006,6,10,1854,5,889,1.0,621.0,621.0,5,965,1.0,697.0,697.0
0.005,6,10,2000,5,927,1.0,659.0,659.0,5,1073,1.0,805.0,805.0
240.015,6,9,787,5,488,60003.0,232.0,232.0,4,299,80004.0,83.0,83.0
0.089,6,10,1506,5,395,20.0,127.0,127.0,5,1111,18.0,843.0,843.0
0.014,6,10,1762,5,911,3.0,643.0,643.0,5,851,3.0,583.0,583.0
0.006,6,10,2006,5,927,1.0,659.0,659.0,5,1079,1.0,811.0,811.0
0.005,6,10,1989,5,927,1.0,659.0,659.0,5,1062,1.0,794.0,794.0
369.593,6,22,2313,16,867,24639.0,195.0,195.0,6,1446,4636.0,419.0,398.0
0.005,6,10,1547,5,764,1.0,496.0,496.0,5,783,1.0,515.0,515.0
40.064,17,10,676,5,460,10014.0,104.0,64.0,5,216,10015.0,20.0,15.0
0.005,17,2,169,1,62,0.0,34.0,34.0,1,107,0.0,79.0,79.0
0.006,17,2,148,1,60,0.0,32.0,32.0,1,88,0.0,60.0,60.0
0.01,6,10,1989,5,910,2.0,642.0,642.0,5,1079,2.0,811.0,811.0
0.012,6,10,1762,5,911,2.0,643.0,643.0,5,851,2.0,583.0,583.0
0.005,17,2,170,1,65,0.0,37.0,37.0,1,105,0.0,77.0,77.0
0.007,6,10,2006,5,927,1.0,659.0,659.0,5,1079,1.0,811.0,811.0
15.073,17,11,4410,5,2357,3761.0,1350.0,443.0,6,2053,3008.0,1350.0,314.0
0.004,6,10,2006,5,927,1.0,659.0,659.0,5,1079,1.0,811.0,811.0
0.005,17,2,164,1,74,0.0,46.0,46.0,1,90,0.0,62.0,62.0
0.038,17,4,284,2,120,0.0,32.0,32.0,2,164,33.0,60.0,54.0
0.006,6,10,1989,5,927,1.0,659.0,659.0,5,1062,1.0,794.0,794.0
0.006,6,10,1547,5,764,1.0,496.0,496.0,5,783,1.0,515.0,515.0
0.011,6,10,1762,5,911,2.0,643.0,643.0,5,851,2.0,583.0,583.0
0.005,6,10,1774,5,923,1.0,655.0,655.0,5,851,1.0,583.0,583.0
0.072,6,10,1506,5,395,15.0,127.0,127.0,5,1111,14.0,843.0,843.0
0.012,6,10,1989,5,910,3.0,642.0,642.0,5,1079,2.0,811.0,811.0
0.108,6,10,1506,5,395,26.0,127.0,127.0,5,1111,26.0,843.0,843.0
0.01,6,10,1983,5,910,2.0,642.0,642.0,5,1073,2.0,805.0,805.0
0.019,6,10,1972,5,910,4.0,642.0,642.0,5,1062,4.0,794.0,794.0
10.971,17,28,4394,14,2312,835.0,587.0,137.0,14,2082,835.0,269.0,120.0
0.104,6,10,1506,5,395,21.0,127.0,127.0,5,1111,22.0,843.0,843.0
0.006,6,10,1547,5,764,1.0,496.0,496.0,5,783,1.0,515.0,515.0
0.009,6,10,1989,5,910,2.0,642.0,642.0,5,1079,2.0,811.0,811.0
0.007,6,12,1698,6,863,1.0,327.0,271.0,6,835,1.0,515.0,515.0
300.015,6,11,891,6,552,60002.0,232.0,232.0,5,339,75003.0,83.0,83.0
0.008,6,10,1989,5,927,2.0,659.0,659.0,5,1062,1.0,794.0,794.0
40.061,17,10,676,5,460,10014.0,104.0,64.0,5,216,10014.0,20.0,15.0
354.063,6,21,1795,16,1030,23604.0,190.0,190.0,5,765,60001.0,464.0,248.0
0.004,6,10,2006,5,927,1.0,659.0,659.0,5,1079,1.0,811.0,811.0
0.004,6,10,2006,5,927,1.0,659.0,659.0,5,1079,1.0,811.0,811.0
0.016,6,10,1762,5,911,4.0,643.0,643.0,5,851,3.0,583.0,583.0
0.004,6,10,1989,5,927,1.0,659.0,659.0,5,1062,1.0,794.0,794.0
0.004,17,2,144,1,64,0.0,36.0,36.0,1,80,0.0,52.0,52.0
0.04,17,2,152,1,76,0.0,48.0,48.0,1,76,0.0,48.0,48.0
0.005,6,10,2006,5,927,1.0,659.0,659.0,5,1079,1.0,811.0,811.0
0.016,6,10,1989,5,910,3.0,642.0,642.0,5,1079,3.0,811.0,811.0
0.001,17,2,180,1,66,0.0,38.0,38.0,1,114,0.0,86.0,86.0
0.008,6,12,1926,6,1189,1.0,659.0,434.0,6,737,1.0,417.0,417.0
0.017,6,10,1990,5,911,4.0,643.0,643.0,5,1079,4.0,811.0,811.0
40.082,17,10,676,5,460,10017.0,104.0,64.0,5,216,10019.0,20.0,15.0
0.014,6,10,1983,5,910,3.0,642.0,642.0,5,1073,3.0,805.0,805.0
0.011,6,10,1762,5,911,2.0,643.0,643.0,5,851,2.0,583.0,583.0
0.006,6,10,2006,5,927,1.0,659.0,659.0,5,1079,1.0,811.0,811.0
10.927,17,28,4398,14,2312,832.0,587.0,137.0,14,2086,832.0,269.0,121.0
0.082,6,10,1506,5,395,17.0,127.0,127.0,5,1111,17.0,843.0,843.0
0.101,6,10,1506,5,395,23.0,127.0,127.0,5,1111,18.0,843.0,843.0
300.399,6,16,2170,9,684,37528.0,146.0,146.0,7,1486,50037.0,419.0,398.0
0.011,6,10,1631,5,848,2.0,580.0,580.0,5,783,2.0,515.0,515.0
11.505,17,28,4394,14,2312,872.0,587.0,137.0,14,2082,872.0,269.0,120.0
0.011,6,10,1762,5,911,2.0,643.0,643.0,5,851,2.0,583.0,583.0
0.006,6,10,1547,5,764,1.0,496.0,496.0,5,783,1.0,515.0,515.0
168.354,17,68,9726,34,2253,5101.0,44.0,38.0,34,7473,5101.0,261.0,191.0
0.153,6,10,1506,5,395,26.0,127.0,127.0,5,1111,35.0,843.0,843.0
0.001,17,2,180,1,66,0.0,38.0,38.0,1,114,0.0,86.0,86.0
0.001,17,2,136,1,60,0.0,32.0,32.0,1,76,0.0,48.0,48.0
40.061,17,10,676,5,460,10013.0,104.0,64.0,5,216,10013.0,20.0,15.0
40.073,17,10,676,5,460,10017.0,104.0,64.0,5,216,10017.0,20.0,15.0
0.011,6,10,1972,5,910,2.0,642.0,642.0,5,1062,2.0,794.0,794.0
0.012,6,10,1983,5,910,3.0,642.0,642.0,5,1073,3.0,805.0,805.0
0.004,6,10,1989,5,927,1.0,659.0,659.0,5,1062,1.0,794.0,794.0
0.006,6,10,1689,5,839,1.0,571.0,571.0,5,850,1.0,582.0,582.0
0.101,6,10,1506,5,395,23.0,127.0,127.0,5,1111,20.0,843.0,843.0
353.371,6,20,2210,6,1308,12003.0,494.0,494.0,14,902,27182.0,83.0,83.0
308.528,17,20,1124,10,716,34267.0,48.0,43.0,10,408,34267.0,20.0,12.0
0.013,17,4,284,2,120,9.0,32.0,32.0,2,164,9.0,60.0,54.0
240.14,6,40,7107,19,3343,13341.0,880.0,333.0,21,3764,12006.0,1306.0,296.0
0.005,6,10,2006,5,927,1.0,659.0,659.0,5,1079,1.0,811.0,811.0
0.234,17,44,27844,27,24840,9.0,1350.0,892.0,17,3004,11.0,1350.0,148.0
40.051,17,10,676,5,460,10010.0,104.0,64.0,5,216,10012.0,20.0,15.0
1.022,6,13,3930,7,2139,128.0,1328.0,923.0,6,1791,153.0,1539.0,1539.0
0.005,17,4,284,2,120,1.0,32.0,32.0,2,164,1.0,60.0,54.0
0.014,6,10,1972,5,910,3.0,642.0,642.0,5,1062,3.0,794.0,794.0
0.178,6,10,1506,5,395,43.0,127.0,127.0,5,1111,36.0,843.0,843.0
0.001,17,2,180,1,66,0.0,38.0,38.0,1,114,0.0,86.0,86.0
0.073,6,10,1506,5,395,14.0,127.0,127.0,5,1111,16.0,843.0,843.0
40.053,17,10,676,5,460,10012.0,104.0,64.0,5,216,10012.0,20.0,15.0
0.005,6,10,2006,5,927,1.0,659.0,659.0,5,1079,1.0,811.0,811.0
240.089,6,31,9398,15,7020,17149.0,2145.0,693.0,16,2378,16005.0,580.0,192.0
1778.809,17,144,45504,72,22752,25053.0,288.0,288.0,72,22752,25053.0,288.0,288.0
1742.903,6,305,98315,187,86938,9370.0,2001.0,689.0,118,11377,14896.0,452.0,70.0
0.004,17,2,136,1,60,0.0,32.0,32.0,1,76,0.0,48.0,48.0
0.006,6,10,1643,5,860,1.0,592.0,592.0,5,783,1.0,515.0,515.0
0.072,17,2,182,1,65,0.0,37.0,37.0,1,117,0.0,89.0,89.0
0.005,17,2,169,1,62,0.0,34.0,34.0,1,107,0.0,79.0,79.0
0.016,6,10,1762,5,911,3.0,643.0,643.0,5,851,3.0,583.0,583.0
0.005,6,10,1547,5,764,1.0,496.0,496.0,5,783,1.0,515.0,515.0
0.006,6,10,1689,5,839,1.0,571.0,571.0,5,850,1.0,582.0,582.0
0.099,6,10,1506,5,395,17.0,127.0,127.0,5,1111,23.0,843.0,843.0
0.102,6,10,1506,5,395,23.0,127.0,127.0,5,1111,23.0,843.0,843.0
0.108,6,10,1506,5,395,26.0,127.0,127.0,5,1111,21.0,843.0,843.0
0.003,17,2,148,1,60,0.0,32.0,32.0,1,88,0.0,60.0,60.0
0.004,6,10,2007,5,928,1.0,660.0,660.0,5,1079,1.0,811.0,811.0
0.005,6,10,2006,5,927,1.0,659.0,659.0,5,1079,1.0,811.0,811.0
0.006,17,2,164,1,74,0.0,46.0,46.0,1,90,0.0,62.0,62.0
317.884,17,20,1124,10,716,35305.0,48.0,43.0,10,408,35305.0,20.0,12.0
33.574,6,46,19066,23,13348,411.0,2720.0,1377.0,23,5718,1518.0,2667.0,435.0
0.005,6,13,3690,7,452,0.0,80.0,80.0,6,3238,0.0,1470.0,1459.0
0.013,6,10,1972,5,910,3.0,642.0,642.0,5,1062,3.0,794.0,794.0
0.015,6,10,1989,5,910,3.0,642.0,642.0,5,1079,3.0,811.0,811.0
0.005,6,10,2000,5,927,1.0,659.0,659.0,5,1073,1.0,805.0,805.0
0.028,6,10,1989,5,910,6.0,642.0,642.0,5,1079,7.0,811.0,811.0
0.143,6,10,1506,5,395,34.0,127.0,127.0,5,1111,34.0,843.0,843.0
368.983,6,24,2405,17,919,23061.0,195.0,195.0,7,1486,3906.0,419.0,398.0
0.163,17,2,152,1,76,0.0,48.0,48.0,1,76,0.0,48.0,48.0
40.085,17,10,676,5,460,10018.0,104.0,64.0,5,216,10020.0,20.0,15.0
0.005,6,10,2000,5,927,1.0,659.0,659.0,5,1073,1.0,805.0,805.0
0.005,6,13,3747,7,509,0.0,137.0,137.0,6,3238,0.0,1470.0,1459.0
0.005,6,10,2007,5,928,1.0,660.0,660.0,5,1079,1.0,811.0,811.0
0.005,6,10,2000,5,927,1.0,659.0,659.0,5,1073,1.0,805.0,805.0
0.005,6,10,2006,5,927,1.0,659.0,659.0,5,1079,1.0,811.0,811.0
40.051,17,10,676,5,460,10009.0,104.0,64.0,5,216,10011.0,20.0,15.0
0.005,6,13,3747,7,509,0.0,137.0,137.0,6,3238,0.0,1470.0,1459.0
174.639,17,78,10833,39,2606,4595.0,44.0,38.0,39,8227,4595.0,239.0,182.0
0.014,6,10,1989,5,910,3.0,642.0,642.0,5,1079,3.0,811.0,811.0
0.005,17,2,230,1,68,0.0,40.0,40.0,1,162,0.0,134.0,134.0
0.121,6,61,61226,28,2279,4.0,504.0,271.0,33,58947,3.0,2804.0,1845.0
0.008,6,10,1972,5,910,2.0,642.0,642.0,5,1062,2.0,794.0,794.0
0.008,6,10,1631,5,848,2.0,580.0,580.0,5,783,2.0,515.0,515.0
40.066,17,10,676,5,460,10015.0,104.0,64.0,5,216,10011.0,20.0,15.0
240.017,6,9,787,5,488,60004.0,232.0,232.0,4,299,80004.0,83.0,83.0
51.86,6,39,11235,20,5677,464.0,1360.0,807.0,19,5558,2872.0,2667.0,435.0
11.4,17,28,4397,14,2312,864.0,587.0,137.0,14,2085,864.0,268.0,120.0
10.921,17,28,4389,14,2312,832.0,587.0,137.0,14,2077,832.0,268.0,120.0
15.228,17,38,20174,21,17043,759.0,1350.0,783.0,17,3131,949.0,1350.0,156.0
0.009,6,10,1990,5,911,2.0,643.0,643.0,5,1079,2.0,811.0,811.0
0.009,6,10,1762,5,911,2.0,643.0,643.0,5,851,2.0,583.0,583.0
0.004,6,10,2007,5,928,1.0,660.0,660.0,5,1079,1.0,811.0,811.0
15.073,17,15,9238,8,6902,2149.0,1350.0,834.0,7,2336,2507.0,1350.0,305.0
0.005,6,13,3747,7,509,0.0,137.0,137.0,6,3238,0.0,1470.0,1459.0
0.008,6,14,3787,7,497,1.0,125.0,125.0,7,3290,1.0,1448.0,972.0
0.021,6,10,1989,5,910,5.0,642.0,642.0,5,1079,5.0,811.0,811.0
0.006,6,10,2006,5,927,1.0,659.0,659.0,5,1079,1.0,811.0,811.0
0.004,6,10,1702,5,863,1.0,595.0,595.0,5,839,1.0,571.0,571.0
40.064,17,10,676,5,460,10015.0,104.0,64.0,5,216,10015.0,20.0,15.0
0.004,6,10,2006,5,927,1.0,659.0,659.0,5,1079,1.0,811.0,811.0
0.013,6,10,1972,5,910,3.0,642.0,642.0,5,1062,3.0,794.0,794.0
40.054,17,10,676,5,460,10012.0,104.0,64.0,5,216,10012.0,20.0,15.0
0.007,17,2,240,1,61,0.0,33.0,33.0,1,179,0.0,151.0,151.0
0.004,17,4,284,2,120,0.0,32.0,32.0,2,164,0.0,60.0,54.0
0.005,6,10,2007,5,928,1.0,660.0,660.0,5,1079,1.0,811.0,811.0
0.038,17,2,148,1,60,0.0,32.0,32.0,1,88,0.0,60.0,60.0
0.005,6,10,1854,5,889,1.0,621.0,621.0,5,965,1.0,697.0,697.0
0.064,6,10,1506,5,395,14.0,127.0,127.0,5,1111,14.0,843.0,843.0
0.008,17,2,179,1,71,0.0,43.0,43.0,1,108,0.0,80.0,80.0
0.007,6,10,2007,5,928,1.0,660.0,660.0,5,1079,1.0,811.0,811.0
0.001,17,2,180,1,66,0.0,38.0,38.0,1,114,0.0,86.0,86.0
0.016,6,10,1990,5,911,4.0,643.0,643.0,5,1079,4.0,811.0,811.0
0.038,17,2,156,1,64,0.0,36.0,36.0,1,92,0.0,64.0,64.0
0.105,6,10,1506,5,395,22.0,127.0,127.0,5,1111,23.0,843.0,843.0
0.008,6,12,1926,6,1189,1.0,659.0,434.0,6,737,1.0,417.0,417.0
0.004,17,2,136,1,60,0.0,32.0,32.0,1,76,0.0,48.0,48.0
0.014,6,10,1989,5,910,3.0,642.0,642.0,5,1079,3.0,811.0,811.0
0.011,6,10,1983,5,910,2.0,642.0,642.0,5,1073,2.0,805.0,805.0
0.016,6,10,1631,5,848,3.0,580.0,580.0,5,783,4.0,515.0,515.0
0.004,6,10,2007,5,928,1.0,660.0,660.0,5,1079,1.0,811.0,811.0
0.101,6,10,1506,5,395,22.0,127.0,127.0,5,1111,22.0,843.0,843.0
0.004,6,10,1989,5,927,1.0,659.0,659.0,5,1062,1.0,794.0,794.0
0.004,6,10,1989,5,927,1.0,659.0,659.0,5,1062,1.0,794.0,794.0
0.005,17,2,140,1,62,0.0,34.0,34.0,1,78,0.0,50.0,50.0
0.151,6,10,1506,5,395,35.0,127.0,127.0,5,1111,35.0,843.0,843.0
0.01,17,2,166,1,75,0.0,47.0,47.0,1,91,0.0,63.0,63.0
0.06,6,10,1506,5,395,13.0,127.0,127.0,5,1111,13.0,843.0,843.0
0.005,6,10,2006,5,927,1.0,659.0,659.0,5,1079,1.0,811.0,811.0
0.011,6,10,1989,5,910,2.0,642.0,642.0,5,1079,2.0,811.0,811.0
0.003,17,4,284,2,120,0.0,32.0,32.0,2,164,0.0,60.0,54.0
0.006,6,10,1547,5,764,1.0,496.0,496.0,5,783,1.0,515.0,515.0
0.154,6,10,1506,5,395,25.0,127.0,127.0,5,1111,32.0,843.0,843.0
0.007,17,2,144,1,64,0.0,36.0,36.0,1,80,0.0,52.0,52.0
0.073,6,10,1506,5,395,16.0,127.0,127.0,5,1111,15.0,843.0,843.0
0.224,6,16,2778,8,1396,32.0,533.0,324.0,8,1382,20.0,529.0,239.0
0.005,6,13,3747,7,509,0.0,137.0,137.0,6,3238,0.0,1470.0,1459.0
0.013,6,10,1677,5,827,3.0,559.0,559.0,5,850,3.0,582.0,582.0
0.005,17,2,178,1,65,0.0,37.0,37.0,1,113,0.0,85.0,85.0
0.094,6,10,1506,5,395,19.0,127.0,127.0,5,1111,19.0,843.0,843.0
0.005,6,10,1989,5,927,1.0,659.0,659.0,5,1062,1.0,794.0,794.0
0.013,6,10,1990,5,911,3.0,643.0,643.0,5,1079,3.0,811.0,811.0
0.003,17,2,148,1,60,0.0,32.0,32.0,1,88,0.0,60.0,60.0
0.001,17,2,136,1,60,0.0,32.0,32.0,1,76,0.0,48.0,48.0
0.005,6,10,2000,5,927,1.0,659.0,659.0,5,1073,1.0,805.0,805.0
15.169,17,19,10116,9,7942,1892.0,1350.0,854.0,10,2174,1682.0,1350.0,189.0
0.105,6,10,1506,5,395,23.0,127.0,127.0,5,1111,25.0,843.0,843.0
0.145,6,10,1506,5,395,34.0,127.0,127.0,5,1111,27.0,843.0,843.0
0.068,6,10,1506,5,395,14.0,127.0,127.0,5,1111,15.0,843.0,843.0
0.007,17,2,194,1,59,0.0,31.0,31.0,1,135,0.0,107.0,107.0
0.083,6,10,1506,5,395,19.0,127.0,127.0,5,1111,20.0,843.0,843.0
0.04,17,4,596,2,122,0.0,33.0,33.0,2,474,1.0,323.0,209.0
0.011,6,10,1990,5,911,2.0,643.0,643.0,5,1079,2.0,811.0,811.0
0.125,6,10,1506,5,395,30.0,127.0,127.0,5,1111,27.0,843.0,843.0
0.001,17,2,136,1,60,0.0,32.0,32.0,1,76,0.0,48.0,48.0
0.011,6,10,1989,5,910,2.0,642.0,642.0,5,1079,2.0,811.0,811.0
0.005,6,10,2000,5,927,1.0,659.0,659.0,5,1073,1.0,805.0,805.0
0.113,6,10,1506,5,395,27.0,127.0,127.0,5,1111,23.0,843.0,843.0
0.035,6,10,1631,5,848,8.0,580.0,580.0,5,783,8.0,515.0,515.0
0.022,6,10,1983,5,910,5.0,642.0,642.0,5,1073,5.0,805.0,805.0
0.093,6,10,1506,5,395,21.0,127.0,127.0,5,1111,20.0,843.0,843.0
0.077,6,10,1506,5,395,18.0,127.0,127.0,5,1111,12.0,843.0,843.0
0.005,6,10,2007,5,928,1.0,660.0,660.0,5,1079,1.0,811.0,811.0
0.006,17,2,225,1,65,0.0,37.0,37.0,1,160,0.0,132.0,132.0
0.004,6,10,2006,5,927,1.0,659.0,659.0,5,1079,1.0,811.0,811.0
0.005,6,10,1989,5,927,1.0,659.0,659.0,5,1062,1.0,794.0,794.0
1772.347,6,305,98746,186,87533,9580.0,2001.0,689.0,119,11213,15019.0,452.0,69.0
0.082,6,10,1506,5,395,18.0,127.0,127.0,5,1111,19.0,843.0,843.0
1782.737,6,296,42883,122,25294,14732.0,2801.0,212.0,174,17589,10304.0,1360.0,131.0
0.165,6,10,1506,5,395,36.0,127.0,127.0,5,1111,33.0,843.0,843.0
10.819,17,28,4418,14,1994,823.0,269.0,114.0,14,2424,824.0,587.0,145.0
0.006,6,10,1547,5,764,1.0,496.0,496.0,5,783,1.0,515.0,515.0
0.004,6,10,1779,5,928,1.0,660.0,660.0,5,851,1.0,583.0,583.0
300.178,6,27,7436,16,1409,20011.0,217.0,142.0,11,6027,24015.0,1679.0,778.0
0.005,6,10,2007,5,928,1.0,660.0,660.0,5,1079,1.0,811.0,811.0
0.005,6,10,1689,5,839,1.0,571.0,571.0,5,850,1.0,582.0,582.0
0.006,6,10,1774,5,923,1.0,655.0,655.0,5,851,1.0,583.0,583.0
0.016,6,10,1983,5,910,4.0,642.0,642.0,5,1073,4.0,805.0,805.0
0.006,6,10,1547,5,764,1.0,496.0,496.0,5,783,1.0,515.0,515.0
0.082,6,10,1983,5,910,20.0,642.0,642.0,5,1073,20.0,805.0,805.0
0.005,6,10,1774,5,923,1.0,655.0,655.0,5,851,1.0,583.0,583.0
65.888,6,22,10140,12,3973,5989.0,1579.0,835.0,10,6167,7301.0,2111.0,939.0
0.003,17,2,136,1,60,0.0,32.0,32.0,1,76,0.0,48.0,48.0
0.01,6,10,1989,5,910,2.0,642.0,642.0,5,1079,2.0,811.0,811.0
0.005,6,10,1774,5,923,1.0,655.0,655.0,5,851,1.0,583.0,583.0
0.006,6,10,1547,5,764,1.0,496.0,496.0,5,783,1.0,515.0,515.0
0.008,17,2,136,1,60,0.0,32.0,32.0,1,76,0.0,48.0,48.0
169.213,17,82,11649,41,2735,4230.0,44.0,38.0,41,8914,4230.0,239.0,189.0
0.005,6,10,2006,5,927,1.0,659.0,659.0,5,1079,1.0,811.0,811.0
0.001,17,2,142,1,63,0.0,35.0,35.0,1,79,0.0,51.0,51.0
308.297,17,20,1124,10,716,34248.0,48.0,43.0,10,408,34248.0,20.0,12.0
0.094,6,10,1506,5,395,21.0,127.0,127.0,5,1111,16.0,843.0,843.0
0.005,6,10,2006,5,927,1.0,659.0,659.0,5,1079,1.0,811.0,811.0
0.088,6,10,1506,5,395,20.0,127.0,127.0,5,1111,17.0,843.0,843.0
0.005,6,10,2006,5,927,1.0,659.0,659.0,5,1079,1.0,811.0,811.0
0.008,6,10,1972,5,910,2.0,642.0,642.0,5,1062,1.0,794.0,794.0
0.006,6,10,1854,5,889,1.0,621.0,621.0,5,965,1.0,697.0,697.0
0.009,6,10,1989,5,910,2.0,642.0,642.0,5,1079,2.0,811.0,811.0
0.007,6,10,1677,5,827,1.0,559.0,559.0,5,850,1.0,582.0,582.0
0.012,6,10,1983,5,910,3.0,642.0,642.0,5,1073,3.0,805.0,805.0
0.004,6,10,2006,5,927,1.0,659.0,659.0,5,1079,1.0,811.0,811.0
40.078,17,10,676,5,460,10018.0,104.0,64.0,5,216,10018.0,20.0,15.0
0.016,6,10,1989,5,910,3.0,642.0,642.0,5,1079,4.0,811.0,811.0
0.005,6,10,2006,5,927,1.0,659.0,659.0,5,1079,1.0,811.0,811.0
0.009,6,13,3735,7,497,1.0,125.0,125.0,6,3238,1.0,1470.0,1459.0
0.01,6,10,1972,5,910,2.0,642.0,642.0,5,1062,2.0,794.0,794.0
0.015,6,10,1989,5,910,3.0,642.0,642.0,5,1079,3.0,811.0,811.0
0.067,6,10,1506,5,395,14.0,127.0,127.0,5,1111,14.0,843.0,843.0
0.011,6,10,1631,5,848,2.0,580.0,580.0,5,783,2.0,515.0,515.0
0.016,6,10,1972,5,910,4.0,642.0,642.0,5,1062,4.0,794.0,794.0
0.009,6,10,1972,5,910,2.0,642.0,642.0,5,1062,2.0,794.0,794.0
11.182,17,28,4417,14,1994,848.0,269.0,114.0,14,2423,848.0,586.0,145.0
0.005,6,10,1989,5,927,1.0,659.0,659.0,5,1062,1.0,794.0,794.0
0.01,6,10,1990,5,911,2.0,643.0,643.0,5,1079,2.0,811.0,811.0
0.008,6,10,1989,5,910,2.0,642.0,642.0,5,1079,2.0,811.0,811.0
0.046,17,4,284,2,120,9.0,32.0,32.0,2,164,43.0,60.0,54.0
0.005,6,10,1989,5,927,1.0,659.0,659.0,5,1062,1.0,794.0,794.0
0.008,6,10,1990,5,911,2.0,643.0,643.0,5,1079,2.0,811.0,811.0
10.935,17,28,4417,14,1994,832.0,269.0,114.0,14,2423,832.0,586.0,145.0
0.005,6,10,2006,5,927,1.0,659.0,659.0,5,1079,1.0,811.0,811.0
353.288,6,20,2210,6,1308,12004.0,494.0,494.0,14,902,27175.0,83.0,83.0
0.079,6,10,1506,5,395,16.0,127.0,127.0,5,1111,15.0,843.0,843.0
240.317,6,30,7968,14,3641,18485.0,1211.0,726.0,16,4327,16020.0,1162.0,348.0
0.019,6,10,1989,5,910,4.0,642.0,642.0,5,1079,4.0,811.0,811.0
0.079,6,10,1506,5,395,15.0,127.0,127.0,5,1111,17.0,843.0,843.0
0.016,6,10,1990,5,911,4.0,643.0,643.0,5,1079,3.0,811.0,811.0
0.004,17,4,284,2,120,0.0,32.0,32.0,2,164,0.0,60.0,54.0
0.005,6,10,2007,5,928,1.0,660.0,660.0,5,1079,1.0,811.0,811.0
0.011,6,10,1989,5,910,2.0,642.0,642.0,5,1079,2.0,811.0,811.0
0.005,17,2,140,1,62,0.0,34.0,34.0,1,78,0.0,50.0,50.0
0.008,6,12,1926,6,1189,1.0,659.0,434.0,6,737,1.0,417.0,417.0
0.041,17,2,170,1,65,0.0,37.0,37.0,1,105,0.0,77.0,77.0
0.004,6,10,1989,5,927,1.0,659.0,659.0,5,1062,1.0,794.0,794.0
0.087,6,10,1506,5,395,20.0,127.0,127.0,5,1111,17.0,843.0,843.0
0.103,6,10,1506,5,395,17.0,127.0,127.0,5,1111,25.0,843.0,843.0
0.014,6,10,1989,5,910,3.0,642.0,642.0,5,1079,3.0,811.0,811.0
0.013,6,10,1989,5,910,3.0,642.0,642.0,5,1079,3.0,811.0,811.0
0.038,17,4,284,2,120,1.0,32.0,32.0,2,164,34.0,60.0,54.0
0.013,17,2,152,1,56,0.0,28.0,28.0,1,96,0.0,68.0,68.0
11.445,17,28,4399,14,2313,868.0,588.0,137.0,14,2086,868.0,269.0,121.0
0.009,6,10,1762,5,911,2.0,643.0,643.0,5,851,2.0,583.0,583.0
0.006,17,2,166,1,75,0.0,47.0,47.0,1,91,0.0,63.0,63.0
0.007,6,10,1547,5,764,1.0,496.0,496.0,5,783,1.0,515.0,515.0
5.089,6,21,5923,12,1436,462.0,474.0,201.0,9,4487,635.0,1925.0,804.0
40.056,17,10,676,5,460,10012.0,104.0,64.0,5,216,10013.0,20.0,15.0
15.074,17,15,9238,8,6902,2149.0,1350.0,834.0,7,2336,2507.0,1350.0,305.0
308.674,17,20,1124,10,716,34286.0,48.0,43.0,10,408,34285.0,20.0,12.0
0.006,17,2,170,1,65,0.0,37.0,37.0,1,105,0.0,77.0,77.0
0.119,6,10,1506,5,395,28.0,127.0,127.0,5,1111,25.0,843.0,843.0
0.089,6,10,1506,5,395,18.0,127.0,127.0,5,1111,19.0,843.0,843.0
0.006,17,4,284,2,120,2.0,32.0,32.0,2,164,2.0,60.0,54.0
0.091,6,10,1506,5,395,21.0,127.0,127.0,5,1111,19.0,843.0,843.0
40.068,17,10,676,5,460,10016.0,104.0,64.0,5,216,10016.0,20.0,15.0
0.005,6,10,2007,5,928,1.0,660.0,660.0,5,1079,1.0,811.0,811.0
0.015,6,10,1990,5,911,3.0,643.0,643.0,5,1079,3.0,811.0,811.0
0.005,6,10,2000,5,927,1.0,659.0,659.0,5,1073,1.0,805.0,805.0
0.006,6,10,1547,5,764,1.0,496.0,496.0,5,783,1.0,515.0,515.0
0.013,6,12,1926,6,1189,2.0,659.0,434.0,6,737,2.0,417.0,417.0
0.006,6,10,1547,5,764,1.0,496.0,496.0,5,783,1.0,515.0,515.0
0.098,6,10,1506,5,395,21.0,127.0,127.0,5,1111,21.0,843.0,843.0
0.095,6,10,1506,5,395,19.0,127.0,127.0,5,1111,22.0,843.0,843.0
0.013,6,10,1989,5,910,3.0,642.0,642.0,5,1079,3.0,811.0,811.0
0.188,6,46,11698,25,3305,7.0,1022.0,182.0,21,8393,9.0,1402.0,606.0
0.008,6,12,1926,6,1189,1.0,659.0,434.0,6,737,1.0,417.0,417.0
0.204,6,16,2777,8,1395,29.0,533.0,323.0,8,1382,18.0,529.0,239.0
240.304,6,19,6742,11,1109,24030.0,253.0,176.0,8,5633,34328.0,2307.0,1041.0
0.015,6,10,1631,5,848,3.0,580.0,580.0,5,783,3.0,515.0,515.0
0.004,6,10,1774,5,923,1.0,655.0,655.0,5,851,1.0,583.0,583.0
15.085,17,15,7936,8,5876,2150.0,1350.0,706.0,7,2060,2509.0,1350.0,266.0
0.019,6,10,1989,5,910,4.0,642.0,642.0,5,1079,4.0,811.0,811.0
15.17,17,20,11527,10,7786,1682.0,1350.0,750.0,10,3741,1682.0,1350.0,346.0
0.005,6,10,1989,5,927,1.0,659.0,659.0,5,1062,1.0,794.0,794.0
0.005,6,10,2006,5,927,1.0,659.0,659.0,5,1079,1.0,811.0,811.0
0.005,6,10,1779,5,928,1.0,660.0,660.0,5,851,1.0,583.0,583.0
0.013,6,10,1990,5,911,3.0,643.0,643.0,5,1079,3.0,811.0,811.0
285.325,6,32,7667,17,1497,17832.0,517.0,290.0,15,6170,20380.0,2379.0,1078.0
0.014,6,10,1989,5,910,3.0,642.0,642.0,5,1079,3.0,811.0,811.0
0.076,6,10,1506,5,395,17.0,127.0,127.0,5,1111,16.0,843.0,843.0
0.017,6,13,3735,7,497,2.0,125.0,125.0,6,3238,3.0,1470.0,1459.0
0.015,17,2,194,1,59,0.0,31.0,31.0,1,135,0.0,107.0,107.0
0.1,6,10,1506,5,395,21.0,127.0,127.0,5,1111,19.0,843.0,843.0
0.094,6,10,1506,5,395,19.0,127.0,127.0,5,1111,19.0,843.0,843.0
0.032,6,10,1631,5,848,8.0,580.0,580.0,5,783,7.0,515.0,515.0
0.005,6,10,2007,5,928,1.0,660.0,660.0,5,1079,1.0,811.0,811.0
0.084,6,10,1506,5,395,18.0,127.0,127.0,5,1111,18.0,843.0,843.0
0.072,17,2,412,1,61,0.0,33.0,33.0,1,351,0.0,323.0,323.0
0.005,6,10,2000,5,927,1.0,659.0,659.0,5,1073,1.0,805.0,805.0
0.005,6,10,1547,5,764,1.0,496.0,496.0,5,783,1.0,515.0,515.0
0.071,6,10,1506,5,395,17.0,127.0,127.0,5,1111,16.0,843.0,843.0
1785.886,6,273,37983,110,21261,16384.0,2720.0,191.0,163,16722,11022.0,1360.0,130.0
0.005,6,10,2007,5,928,1.0,660.0,660.0,5,1079,1.0,811.0,811.0
241.598,6,392,348650,185,21142,1313.0,2736.0,959.0,207,327508,1172.0,2804.0,1607.0
0.013,6,10,1990,5,911,3.0,643.0,643.0,5,1079,3.0,811.0,811.0
240.326,6,33,8638,17,1837,15020.0,570.0,189.0,16,6801,16021.0,1402.0,597.0
102.279,6,32,13271,15,3785,69.0,1070.0,630.0,17,9486,6384.0,1360.0,676.0
0.079,6,10,1506,5,395,16.0,127.0,127.0,5,1111,16.0,843.0,843.0
0.039,17,2,148,1,60,0.0,32.0,32.0,1,88,0.0,60.0,60.0
0.015,6,10,1972,5,910,3.0,642.0,642.0,5,1062,3.0,794.0,794.0
0.007,17,2,178,1,65,0.0,37.0,37.0,1,113,0.0,85.0,85.0
0.256,17,39,20145,21,17034,12.0,1350.0,783.0,18,3111,11.0,1350.0,144.0
0.01,6,10,1972,5,910,2.0,642.0,642.0,5,1062,2.0,794.0,794.0
40.071,17,10,676,5,460,10017.0,104.0,64.0,5,216,10017.0,20.0,15.0
0.004,17,2,136,1,60,0.0,32.0,32.0,1,76,0.0,48.0,48.0
0.118,6,10,1506,5,395,28.0,127.0,127.0,5,1111,27.0,843.0,843.0
0.088,6,10,1506,5,395,17.0,127.0,127.0,5,1111,19.0,843.0,843.0
0.005,6,10,1689,5,839,1.0,571.0,571.0,5,850,1.0,582.0,582.0
0.75,6,25,5459,12,1557,58.0,325.0,152.0,13,3902,53.0,1414.0,563.0
0.107,6,10,1506,5,395,24.0,127.0,127.0,5,1111,21.0,843.0,843.0
0.016,6,10,1972,5,910,4.0,642.0,642.0,5,1062,3.0,794.0,794.0
0.005,17,2,136,1,60,0.0,32.0,32.0,1,76,0.0,48.0,48.0
0.005,6,10,2006,5,927,1.0,659.0,659.0,5,1079,1.0,811.0,811.0
0.013,6,10,1989,5,910,3.0,642.0,642.0,5,1079,3.0,811.0,811.0
439.529,6,29,4409,12,3102,10911.0,494.0,494.0,17,1307,27470.0,83.0,83.0
0.005,6,10,1989,5,927,1.0,659.0,659.0,5,1062,1.0,794.0,794.0
11.456,17,28,4399,14,2313,868.0,588.0,137.0,14,2086,868.0,269.0,121.0
0.029,6,14,3868,7,578,4.0,206.0,206.0,7,3290,4.0,1448.0,972.0
300.357,6,16,2170,9,684,37523.0,146.0,146.0,7,1486,50031.0,419.0,398.0
0.065,6,10,1506,5,395,13.0,127.0,127.0,5,1111,14.0,843.0,843.0
0.05,6,10,1983,5,910,12.0,642.0,642.0,5,1073,12.0,805.0,805.0
0.004,17,4,284,2,120,0.0,32.0,32.0,2,164,0.0,60.0,54.0
0.082,6,10,1506,5,395,19.0,127.0,127.0,5,1111,18.0,843.0,843.0
0.013,6,10,1989,5,910,3.0,642.0,642.0,5,1079,3.0,811.0,811.0
0.325,17,41,22817,22,18425,15.0,1350.0,809.0,19,4392,14.0,1350.0,203.0
0.045,17,2,184,1,61,0.0,33.0,33.0,1,123,0.0,95.0,95.0
241.624,6,380,346936,188,21310,1292.0,2736.0,960.0,192,325626,1265.0,2804.0,1734.0
0.088,6,10,1506,5,395,20.0,127.0,127.0,5,1111,18.0,843.0,843.0
0.005,17,2,180,1,58,0.0,30.0,30.0,1,122,0.0,94.0,94.0
0.004,6,13,3747,7,509,0.0,137.0,137.0,6,3238,0.0,1470.0,1459.0
0.005,6,10,1989,5,927,1.0,659.0,659.0,5,1062,1.0,794.0,794.0
0.004,17,2,136,1,60,0.0,32.0,32.0,1,76,0.0,48.0,48.0
0.005,17,2,170,1,65,0.0,37.0,37.0,1,105,0.0,77.0,77.0
0.012,6,13,3735,7,497,1.0,125.0,125.0,6,3238,2.0,1470.0,1459.0
0.061,6,10,1506,5,395,12.0,127.0,127.0,5,1111,14.0,843.0,843.0
0.018,6,10,1677,5,827,4.0,559.0,559.0,5,850,4.0,582.0,582.0
300.393,6,16,2170,9,684,37525.0,146.0,146.0,7,1486,50030.0,419.0,398.0
0.005,17,2,230,1,68,0.0,40.0,40.0,1,162,0.0,134.0,134.0
0.011,6,10,1989,5,910,2.0,642.0,642.0,5,1079,2.0,811.0,811.0
0.013,6,10,1983,5,910,3.0,642.0,642.0,5,1073,3.0,805.0,805.0
1758.519,6,442,64980,252,35168,7006.0,613.0,197.0,190,29812,9303.0,453.0,142.0
0.012,6,10,1990,5,911,3.0,643.0,643.0,5,1079,2.0,811.0,811.0
0.004,6,10,2000,5,927,1.0,659.0,659.0,5,1073,1.0,805.0,805.0
40.06,17,10,676,5,460,10012.0,104.0,64.0,5,216,10014.0,20.0,15.0
0.006,6,10,1547,5,764,1.0,496.0,496.0,5,783,1.0,515.0,515.0
0.14,6,10,1506,5,395,33.0,127.0,127.0,5,1111,24.0,843.0,843.0
378.741,6,20,2210,6,1308,12004.0,494.0,494.0,14,902,29133.0,83.0,83.0
0.099,6,10,1506,5,395,22.0,127.0,127.0,5,1111,22.0,843.0,843.0
0.122,6,10,1506,5,395,27.0,127.0,127.0,5,1111,26.0,843.0,843.0
302.016,6,32,11454,18,3860,17765.0,1402.0,486.0,14,7594,18611.0,1402.0,857.0
0.005,6,10,1989,5,927,1.0,659.0,659.0,5,1062,1.0,794.0,794.0
0.005,6,10,1779,5,928,1.0,660.0,660.0,5,851,1.0,583.0,583.0
0.005,6,10,1989,5,927,1.0,659.0,659.0,5,1062,1.0,794.0,794.0
0.001,17,2,164,1,74,0.0,46.0,46.0,1,90,0.0,62.0,62.0
0.111,6,10,1506,5,395,26.0,127.0,127.0,5,1111,21.0,843.0,843.0
0.084,6,10,1506,5,395,17.0,127.0,127.0,5,1111,19.0,843.0,843.0
0.073,6,10,1506,5,395,16.0,127.0,127.0,5,1111,16.0,843.0,843.0
170.504,17,74,10559,37,2457,4736.0,44.0,38.0,37,8102,4736.0,239.0,190.0
0.014,6,10,1972,5,910,3.0,642.0,642.0,5,1062,3.0,794.0,794.0
0.003,17,4,284,2,120,0.0,32.0,32.0,2,164,0.0,60.0,54.0
0.005,17,2,178,1,81,0.0,53.0,53.0,1,97,0.0,69.0,69.0
0.003,17,2,136,1,60,0.0,32.0,32.0,1,76,0.0,48.0,48.0
0.024,6,10,1972,5,910,6.0,642.0,642.0,5,1062,6.0,794.0,794.0
240.089,6,31,9641,15,7070,17149.0,2194.0,699.0,16,2571,16005.0,580.0,216.0
0.004,6,10,2000,5,927,1.0,659.0,659.0,5,1073,1.0,805.0,805.0
0.11,6,10,1506,5,395,26.0,127.0,127.0,5,1111,25.0,843.0,843.0
1799.916,6,137,6590,76,3625,23995.0,39.0,39.0,61,2965,29994.0,35.0,35.0
40.05,17,10,676,5,460,10011.0,104.0,64.0,5,216,10011.0,20.0,15.0
117.405,6,26,9525,12,1627,82.0,794.0,367.0,14,7898,9019.0,1360.0,732.0
0.006,6,10,2006,5,927,1.0,659.0,659.0,5,1079,1.0,811.0,811.0
0.139,6,10,1506,5,395,32.0,127.0,127.0,5,1111,33.0,843.0,843.0
0.005,6,15,3794,8,504,0.0,80.0,80.0,7,3290,0.0,1448.0,972.0
0.071,6,10,1506,5,395,15.0,127.0,127.0,5,1111,13.0,843.0,843.0
0.005,17,2,212,1,74,0.0,46.0,46.0,1,138,0.0,110.0,110.0
0.001,17,2,180,1,66,0.0,38.0,38.0,1,114,0.0,86.0,86.0
0.005,6,10,1779,5,928,1.0,660.0,660.0,5,851,1.0,583.0,583.0
0.011,6,10,1989,5,910,2.0,642.0,642.0,5,1079,2.0,811.0,811.0
0.092,6,10,1506,5,395,21.0,127.0,127.0,5,1111,20.0,843.0,843.0
0.004,6,10,2006,5,927,1.0,659.0,659.0,5,1079,1.0,811.0,811.0
158.577,17,74,10031,37,2459,4404.0,44.0,38.0,37,7572,4404.0,239.0,176.0
0.012,6,10,1989,5,910,3.0,642.0,642.0,5,1079,2.0,811.0,811.0
0.005,6,10,2007,5,928,1.0,660.0,660.0,5,1079,1.0,811.0,811.0
0.013,6,10,1989,5,910,3.0,642.0,642.0,5,1079,3.0,811.0,811.0
0.014,6,10,1631,5,848,3.0,580.0,580.0,5,783,3.0,515.0,515.0
0.005,6,10,1989,5,927,1.0,659.0,659.0,5,1062,1.0,794.0,794.0
0.242,17,15,8641,8,4076,34.0,1350.0,481.0,7,4565,31.0,1350.0,624.0
1769.148,17,92,8096,46,4048,39314.0,60.0,60.0,46,4048,39314.0,60.0,60.0
0.018,6,10,1990,5,911,4.0,643.0,643.0,5,1079,4.0,811.0,811.0
0.069,6,10,1506,5,395,15.0,127.0,127.0,5,1111,15.0,843.0,843.0
240.091,6,32,9859,16,7279,16006.0,2351.0,716.0,16,2580,16005.0,580.0,217.0
240.701,6,33,8639,17,1839,15041.0,572.0,189.0,16,6800,16042.0,1402.0,597.0
0.019,6,10,1972,5,910,4.0,642.0,642.0,5,1062,4.0,794.0,794.0
0.004,17,2,136,1,60,0.0,32.0,32.0,1,76,0.0,48.0,48.0
0.079,6,10,1506,5,395,18.0,127.0,127.0,5,1111,17.0,843.0,843.0
0.008,6,12,1926,6,1189,1.0,659.0,434.0,6,737,1.0,417.0,417.0
0.005,6,10,2006,5,927,1.0,659.0,659.0,5,1079,1.0,811.0,811.0
0.007,6,10,1854,5,889,1.0,621.0,621.0,5,965,1.0,697.0,697.0
0.006,6,10,1547,5,764,1.0,496.0,496.0,5,783,1.0,515.0,515.0
0.096,6,10,1506,5,395,21.0,127.0,127.0,5,1111,22.0,843.0,843.0
0.007,17,2,194,1,59,0.0,31.0,31.0,1,135,0.0,107.0,107.0
0.127,6,10,1506,5,395,24.0,127.0,127.0,5,1111,26.0,843.0,843.0
0.004,6,10,1774,5,923,1.0,655.0,655.0,5,851,1.0,583.0,583.0
0.012,6,10,1972,5,910,3.0,642.0,642.0,5,1062,2.0,794.0,794.0
0.093,6,10,1506,5,395,19.0,127.0,127.0,5,1111,22.0,843.0,843.0
0.005,17,2,168,1,76,0.0,48.0,48.0,1,92,0.0,64.0,64.0
0.005,6,13,3747,7,509,0.0,137.0,137.0,6,3238,1.0,1470.0,1459.0
0.005,6,14,3736,7,446,0.0,74.0,74.0,7,3290,0.0,1448.0,972.0
0.006,6,10,1547,5,764,1.0,496.0,496.0,5,783,1.0,515.0,515.0
0.086,6,10,1506,5,395,17.0,127.0,127.0,5,1111,19.0,843.0,843.0
0.011,6,10,1990,5,911,2.0,643.0,643.0,5,1079,2.0,811.0,811.0
0.005,6,10,1989,5,927,1.0,659.0,659.0,5,1062,1.0,794.0,794.0
0.005,6,10,2006,5,927,1.0,659.0,659.0,5,1079,1.0,811.0,811.0
0.004,6,10,2007,5,928,1.0,660.0,660.0,5,1079,1.0,811.0,811.0
0.008,6,10,1983,5,910,2.0,642.0,642.0,5,1073,2.0,805.0,805.0
290.723,6,375,347243,190,21441,1538.0,2689.0,888.0,185,325802,1580.0,2804.0,1848.0
0.084,6,10,1506,5,395,18.0,127.0,127.0,5,1111,17.0,843.0,843.0
0.013,17,2,152,1,56,0.0,28.0,28.0,1,96,0.0,68.0,68.0
0.12,6,10,1506,5,395,26.0,127.0,127.0,5,1111,25.0,843.0,843.0
0.005,6,10,2006,5,927,1.0,659.0,659.0,5,1079,1.0,811.0,811.0
0.22,6,16,2777,8,1395,31.0,533.0,323.0,8,1382,20.0,529.0,239.0
0.009,6,10,1677,5,827,2.0,559.0,559.0,5,850,2.0,582.0,582.0
0.005,17,2,179,1,71,0.0,43.0,43.0,1,108,0.0,80.0,80.0
0.01,6,10,1689,5,839,2.0,571.0,571.0,5,850,2.0,582.0,582.0
0.009,6,13,3735,7,497,1.0,125.0,125.0,6,3238,1.0,1470.0,1459.0
0.003,17,2,136,1,60,0.0,32.0,32.0,1,76,0.0,48.0,48.0
0.111,6,10,1506,5,395,23.0,127.0,127.0,5,1111,24.0,843.0,843.0
0.001,17,2,194,1,57,0.0,29.0,29.0,1,137,0.0,109.0,109.0
0.006,6,10,1762,5,911,1.0,643.0,643.0,5,851,1.0,583.0,583.0
0.064,6,10,1506,5,395,12.0,127.0,127.0,5,1111,14.0,843.0,843.0
300.02,6,12,1782,7,1348,50003.0,494.0,494.0,5,434,75004.0,83.0,83.0
0.006,6,10,2006,5,927,1.0,659.0,659.0,5,1079,1.0,811.0,811.0
0.006,17,2,154,1,69,0.0,41.0,41.0,1,85,0.0,57.0,57.0
0.018,17,2,213,1,69,0.0,41.0,41.0,1,144,0.0,116.0,116.0
0.004,6,13,3690,7,452,0.0,80.0,80.0,6,3238,0.0,1470.0,1459.0
15.316,17,20,11199,10,7640,1700.0,1350.0,736.0,10,3559,1690.0,1350.0,327.0
0.013,6,10,1989,5,910,3.0,642.0,642.0,5,1079,3.0,811.0,811.0
0.005,6,10,1989,5,927,1.0,659.0,659.0,5,1062,1.0,794.0,794.0
0.001,17,2,180,1,66,0.0,38.0,38.0,1,114,0.0,86.0,86.0
0.005,6,10,1547,5,764,1.0,496.0,496.0,5,783,1.0,515.0,515.0
0.009,6,10,1989,5,910,2.0,642.0,642.0,5,1079,2.0,811.0,811.0
0.014,6,10,1983,5,910,3.0,642.0,642.0,5,1073,3.0,805.0,805.0
50.373,6,36,8190,18,1719,525.0,651.0,322.0,18,6471,2955.0,2126.0,478.0
0.008,6,10,1972,5,910,1.0,642.0,642.0,5,1062,1.0,794.0,794.0
0.08,6,10,1506,5,395,16.0,127.0,127.0,5,1111,16.0,843.0,843.0
0.007,17,2,194,1,59,0.0,31.0,31.0,1,135,0.0,107.0,107.0
9.036,17,6,376,5,280,2259.0,28.0,28.0,1,96,0.0,68.0,68.0
0.087,6,10,1506,5,395,19.0,127.0,127.0,5,1111,19.0,843.0,843.0
0.005,6,10,2006,5,927,1.0,659.0,659.0,5,1079,1.0,811.0,811.0
0.004,6,10,2006,5,927,1.0,659.0,659.0,5,1079,1.0,811.0,811.0
0.004,17,2,136,1,60,0.0,32.0,32.0,1,76,0.0,48.0,48.0
0.041,17,2,182,1,65,0.0,37.0,37.0,1,117,0.0,89.0,89.0
0.06,17,2,152,1,76,0.0,48.0,48.0,1,76,0.0,48.0,48.0
0.09,6,10,1506,5,395,21.0,127.0,127.0,5,1111,20.0,843.0,843.0
0.248,17,44,24628,24,21176,10.0,1350.0,854.0,20,3452,11.0,1350.0,144.0
0.011,6,13,3735,7,497,1.0,125.0,125.0,6,3238,2.0,1470.0,1459.0
0.085,17,2,234,1,61,0.0,33.0,33.0,1,173,0.0,145.0,145.0
0.025,6,12,1926,6,1189,5.0,659.0,434.0,6,737,5.0,417.0,417.0
0.059,6,10,1506,5,395,13.0,127.0,127.0,5,1111,12.0,843.0,843.0
0.014,6,10,1990,5,911,3.0,643.0,643.0,5,1079,3.0,811.0,811.0
0.039,17,2,148,1,60,0.0,32.0,32.0,1,88,0.0,60.0,60.0
240.162,6,46,6925,21,3170,12007.0,588.0,230.0,25,3755,10006.0,580.0,244.0
40.058,17,10,676,5,460,10013.0,104.0,64.0,5,216,10013.0,20.0,15.0
0.005,6,10,1689,5,839,1.0,571.0,571.0,5,850,1.0,582.0,582.0
0.008,17,2,179,1,71,0.0,43.0,43.0,1,108,0.0,80.0,80.0
0.006,6,10,1547,5,764,1.0,496.0,496.0,5,783,1.0,515.0,515.0
0.015,6,10,1983,5,910,3.0,642.0,642.0,5,1073,3.0,805.0,805.0
0.009,6,10,1983,5,910,2.0,642.0,642.0,5,1073,2.0,805.0,805.0
0.128,17,2,80,1,32,0.0,4.0,4.0,1,48,0.0,20.0,20.0
0.111,17,2,164,1,74,0.0,46.0,46.0,1,90,0.0,62.0,62.0
0.004,6,10,2007,5,928,1.0,660.0,660.0,5,1079,1.0,811.0,811.0
0.016,6,10,1989,5,910,4.0,642.0,642.0,5,1079,3.0,811.0,811.0
0.005,6,10,2006,5,927,1.0,659.0,659.0,5,1079,1.0,811.0,811.0
0.012,6,10,1762,5,911,3.0,643.0,643.0,5,851,2.0,583.0,583.0
0.008,6,10,2006,5,927,1.0,659.0,659.0,5,1079,2.0,811.0,811.0
177.273,17,84,12142,42,2818,4323.0,44.0,39.0,42,9324,4323.0,239.0,194.0
0.005,6,10,2006,5,927,1.0,659.0,659.0,5,1079,1.0,811.0,811.0
0.005,6,10,2006,5,927,1.0,659.0,659.0,5,1079,1.0,811.0,811.0
15.122,17,18,13388,9,8280,1886.0,1350.0,892.0,9,5108,1886.0,1350.0,539.0
0.04,17,4,596,2,122,0.0,33.0,33.0,2,474,1.0,323.0,209.0
0.092,6,10,1506,5,395,22.0,127.0,127.0,5,1111,21.0,843.0,843.0
0.008,6,10,1972,5,910,2.0,642.0,642.0,5,1062,2.0,794.0,794.0
0.011,6,10,1989,5,910,2.0,642.0,642.0,5,1079,2.0,811.0,811.0
0.004,17,2,148,1,60,0.0,32.0,32.0,1,88,0.0,60.0,60.0
0.006,6,10,1643,5,860,1.0,592.0,592.0,5,783,1.0,515.0,515.0
0.016,6,10,1983,5,910,3.0,642.0,642.0,5,1073,3.0,805.0,805.0
0.014,6,10,1989,5,910,3.0,642.0,642.0,5,1079,3.0,811.0,811.0
240.097,6,32,9466,16,7034,16006.0,2106.0,689.0,16,2432,16006.0,580.0,199.0
300.373,6,32,10802,17,4881,18773.0,1368.0,662.0,15,5921,21454.0,1656.0,735.0
0.004,6,10,2006,5,927,1.0,659.0,659.0,5,1079,1.0,811.0,811.0
0.005,6,14,3736,7,446,0.0,74.0,74.0,7,3290,0.0,1448.0,972.0
0.194,17,4,596,2,122,147.0,33.0,33.0,2,474,153.0,323.0,209.0
0.08,6,10,1506,5,395,17.0,127.0,127.0,5,1111,17.0,843.0,843.0
0.073,6,10,1506,5,395,15.0,127.0,127.0,5,1111,14.0,843.0,843.0
0.091,6,10,1506,5,395,20.0,127.0,127.0,5,1111,21.0,843.0,843.0
0.004,6,10,2006,5,927,1.0,659.0,659.0,5,1079,1.0,811.0,811.0
0.02,6,10,1990,5,911,5.0,643.0,643.0,5,1079,5.0,811.0,811.0
0.006,6,10,1854,5,889,1.0,621.0,621.0,5,965,1.0,697.0,697.0
289.352,6,409,350241,205,22805,1418.0,2736.0,866.0,204,327436,1425.0,2968.0,1685.0
0.005,6,10,2006,5,927,1.0,659.0,659.0,5,1079,1.0,811.0,811.0
0.006,6,10,1689,5,839,1.0,571.0,571.0,5,850,1.0,582.0,582.0
15.082,17,15,8281,8,6070,2150.0,1350.0,730.0,7,2211,2508.0,1350.0,287.0
40.057,17,10,676,5,460,10013.0,104.0,64.0,5,216,10013.0,20.0,15.0
0.003,17,2,136,1,60,0.0,32.0,32.0,1,76,0.0,48.0,48.0
0.019,6,10,1972,5,910,4.0,642.0,642.0,5,1062,4.0,794.0,794.0
0.005,6,10,1702,5,863,1.0,595.0,595.0,5,839,1.0,571.0,571.0
0.131,17,4,596,2,122,1.0,33.0,33.0,2,474,92.0,323.0,209.0
293.075,6,415,350655,200,21981,1472.0,2736.0,889.0,215,328674,1369.0,2804.0,1579.0
1.101,6,33,12829,18,3352,64.0,1360.0,517.0,15,9477,66.0,2720.0,886.0
0.007,6,10,1983,5,910,1.0,642.0,642.0,5,1073,1.0,805.0,805.0
0.005,17,2,230,1,68,0.0,40.0,40.0,1,162,0.0,134.0,134.0
0.131,6,10,1506,5,395,30.0,127.0,127.0,5,1111,26.0,843.0,843.0
371.071,6,22,2313,16,867,24738.0,195.0,195.0,6,1446,4637.0,419.0,398.0
0.012,6,10,1972,5,910,2.0,642.0,642.0,5,1062,2.0,794.0,794.0
0.014,6,10,1631,5,848,3.0,580.0,580.0,5,783,3.0,515.0,515.0
0.078,6,10,1506,5,395,17.0,127.0,127.0,5,1111,17.0,843.0,843.0
0.01,17,4,284,2,120,0.0,32.0,32.0,2,164,0.0,60.0,54.0
10.847,17,28,4422,14,1993,825.0,268.0,114.0,14,2429,825.0,588.0,145.0
0.129,6,10,1506,5,395,27.0,127.0,127.0,5,1111,30.0,843.0,843.0
0.005,6,10,2006,5,927,1.0,659.0,659.0,5,1079,1.0,811.0,811.0
0.005,17,4,284,2,120,0.0,32.0,32.0,2,164,1.0,60.0,54.0
0.005,6,10,2006,5,927,1.0,659.0,659.0,5,1079,1.0,811.0,811.0
0.008,6,12,1926,6,1189,1.0,659.0,434.0,6,737,1.0,417.0,417.0
0.04,17,2,182,1,65,0.0,37.0,37.0,1,117,0.0,89.0,89.0
10.942,17,28,4421,14,1994,832.0,269.0,114.0,14,2427,832.0,586.0,145.0
0.091,6,10,1506,5,395,21.0,127.0,127.0,5,1111,20.0,843.0,843.0
0.087,6,10,1506,5,395,19.0,127.0,127.0,5,1111,18.0,843.0,843.0
0.005,6,10,2000,5,927,1.0,659.0,659.0,5,1073,1.0,805.0,805.0
378.482,6,19,1679,15,1070,27034.0,282.0,282.0,4,609,80023.0,393.0,393.0
10.748,17,26,4103,13,1847,886.0,270.0,114.0,13,2256,886.0,587.0,145.0
0.005,6,10,1774,5,923,1.0,655.0,655.0,5,851,1.0,583.0,583.0
386.162,6,29,4397,13,3142,32180.0,494.0,494.0,16,1255,25743.0,83.0,83.0
361.783,6,21,1792,16,1030,24118.0,190.0,190.0,5,762,60009.0,461.0,247.0
0.005,6,10,2006,5,927,1.0,659.0,659.0,5,1079,1.0,811.0,811.0
0.005,17,2,140,1,62,0.0,34.0,34.0,1,78,0.0,50.0,50.0
0.016,6,10,1972,5,910,3.0,642.0,642.0,5,1062,3.0,794.0,794.0
0.006,6,10,1547,5,764,1.0,496.0,496.0,5,783,1.0,515.0,515.0
169.508,17,74,10421,37,2457,4708.0,44.0,38.0,37,7964,4708.0,239.0,187.0
0.017,6,10,1983,5,910,4.0,642.0,642.0,5,1073,4.0,805.0,805.0
0.008,6,10,1972,5,910,2.0,642.0,642.0,5,1062,2.0,794.0,794.0
0.013,6,10,1983,5,910,3.0,642.0,642.0,5,1073,3.0,805.0,805.0
0.006,6,10,1854,5,889,1.0,621.0,621.0,5,965,1.0,697.0,697.0
0.001,17,2,136,1,60,0.0,32.0,32.0,1,76,0.0,48.0,48.0
0.01,6,10,1990,5,911,2.0,643.0,643.0,5,1079,2.0,811.0,811.0
60.025,6,10,1690,6,1308,12005.0,494.0,494.0,4,382,20006.0,83.0,83.0
40.058,17,10,676,5,460,10013.0,104.0,64.0,5,216,10013.0,20.0,15.0
40.07,17,10,676,5,460,10016.0,104.0,64.0,5,216,10016.0,20.0,15.0
0.014,6,10,1677,5,827,3.0,559.0,559.0,5,850,3.0,582.0,582.0
11.157,17,28,4420,14,1995,846.0,270.0,114.0,14,2425,845.0,588.0,145.0
0.005,6,10,1774,5,923,1.0,655.0,655.0,5,851,1.0,583.0,583.0
0.088,17,2,144,1,64,0.0,36.0,36.0,1,80,0.0,52.0,52.0
0.005,6,10,1989,5,927,1.0,659.0,659.0,5,1062,1.0,794.0,794.0
0.053,17,2,152,1,76,0.0,48.0,48.0,1,76,0.0,48.0,48.0
0.009,6,10,1990,5,911,2.0,643.0,643.0,5,1079,2.0,811.0,811.0
0.013,6,10,1972,5,910,3.0,642.0,642.0,5,1062,3.0,794.0,794.0
0.022,6,10,1677,5,827,5.0,559.0,559.0,5,850,5.0,582.0,582.0
0.001,17,2,180,1,66,0.0,38.0,38.0,1,114,0.0,86.0,86.0
266.713,6,39,9822,15,6799,19050.0,1924.0,669.0,24,3023,11596.0,580.0,117.0
0.118,6,10,1506,5,395,25.0,127.0,127.0,5,1111,28.0,843.0,843.0
15.075,17,15,9238,8,6902,2149.0,1350.0,834.0,7,2336,2507.0,1350.0,305.0
0.001,17,2,248,1,68,0.0,40.0,40.0,1,180,0.0,152.0,152.0
310.879,17,20,1124,10,716,34532.0,48.0,43.0,10,408,34535.0,20.0,12.0
0.005,6,10,1989,5,927,1.0,659.0,659.0,5,1062,1.0,794.0,794.0
172.051,17,78,11080,39,2610,4527.0,44.0,38.0,39,8470,4527.0,261.0,189.0
0.004,6,10,1702,5,863,1.0,595.0,595.0,5,839,1.0,571.0,571.0
0.005,17,2,213,1,69,0.0,41.0,41.0,1,144,0.0,116.0,116.0
0.028,6,13,3735,7,497,4.0,125.0,125.0,6,3238,5.0,1470.0,1459.0
0.013,6,13,3735,7,497,2.0,125.0,125.0,6,3238,2.0,1470.0,1459.0
0.021,6,10,1989,5,910,5.0,642.0,642.0,5,1079,5.0,811.0,811.0
0.006,6,10,1547,5,764,1.0,496.0,496.0,5,783,1.0,515.0,515.0
0.006,6,10,1643,5,860,1.0,592.0,592.0,5,783,1.0,515.0,515.0
0.006,6,10,1643,5,860,1.0,592.0,592.0,5,783,1.0,515.0,515.0
0.006,6,10,1643,5,860,1.0,592.0,592.0,5,783,1.0,515.0,515.0
0.006,17,2,154,1,69,0.0,41.0,41.0,1,85,0.0,57.0,57.0
0.012,6,10,1990,5,911,3.0,643.0,643.0,5,1079,2.0,811.0,811.0
0.214,6,16,2777,8,1395,30.0,533.0,323.0,8,1382,19.0,529.0,239.0
0.005,6,10,2007,5,928,1.0,660.0,660.0,5,1079,1.0,811.0,811.0
0.076,6,10,1506,5,395,15.0,127.0,127.0,5,1111,16.0,843.0,843.0
0.011,6,10,1972,5,910,2.0,642.0,642.0,5,1062,2.0,794.0,794.0
0.001,17,2,180,1,66,0.0,38.0,38.0,1,114,0.0,86.0,86.0
0.006,6,10,1547,5,764,1.0,496.0,496.0,5,783,1.0,515.0,515.0
0.121,6,10,1506,5,395,28.0,127.0,127.0,5,1111,26.0,843.0,843.0
0.005,6,10,2006,5,927,1.0,659.0,659.0,5,1079,1.0,811.0,811.0
0.036,6,10,1983,5,910,8.0,642.0,642.0,5,1073,9.0,805.0,805.0
0.004,6,13,3747,7,509,0.0,137.0,137.0,6,3238,0.0,1470.0,1459.0
0.001,17,2,180,1,66,0.0,38.0,38.0,1,114,0.0,86.0,86.0
0.105,6,10,1506,5,395,23.0,127.0,127.0,5,1111,23.0,843.0,843.0
0.005,6,10,2000,5,927,1.0,659.0,659.0,5,1073,1.0,805.0,805.0
15.123,17,19,13436,9,8280,1886.0,1350.0,892.0,10,5156,1677.0,1350.0,487.0
0.011,6,10,1989,5,910,2.0,642.0,642.0,5,1079,2.0,811.0,811.0
15.077,17,16,8545,8,6362,2149.0,1350.0,767.0,8,2183,2149.0,1350.0,244.0
0.001,17,2,180,1,66,0.0,38.0,38.0,1,114,0.0,86.0,86.0
0.013,6,10,1972,5,910,3.0,642.0,642.0,5,1062,3.0,794.0,794.0
0.013,6,10,1972,5,910,3.0,642.0,642.0,5,1062,3.0,794.0,794.0
0.105,6,10,1506,5,395,23.0,127.0,127.0,5,1111,25.0,843.0,843.0
0.076,17,2,152,1,76,0.0,48.0,48.0,1,76,0.0,48.0,48.0
0.005,6,14,3742,7,452,0.0,80.0,80.0,7,3290,0.0,1448.0,972.0
0.069,17,8,3613,4,1874,23.0,1350.0,440.0,4,1739,11.0,1350.0,406.0
0.009,6,12,1926,6,1189,1.0,659.0,434.0,6,737,1.0,417.0,417.0
0.074,6,10,1506,5,395,16.0,127.0,127.0,5,1111,17.0,843.0,843.0
240.369,6,33,9267,16,1834,16024.0,622.0,198.0,17,7433,15022.0,1402.0,595.0
0.001,17,2,179,1,62,0.0,34.0,34.0,1,117,0.0,89.0,89.0
0.012,6,10,1990,5,911,3.0,643.0,643.0,5,1079,3.0,811.0,811.0
0.124,17,4,352,2,130,0.0,37.0,37.0,2,222,84.0,89.0,83.0
0.102,6,10,1506,5,395,23.0,127.0,127.0,5,1111,23.0,843.0,843.0
0.069,6,10,1506,5,395,13.0,127.0,127.0,5,1111,15.0,843.0,843.0
0.016,6,10,1631,5,848,4.0,580.0,580.0,5,783,3.0,515.0,515.0
10.928,17,28,4416,14,1993,832.0,268.0,114.0,14,2423,832.0,586.0,145.0
0.083,6,10,1506,5,395,17.0,127.0,127.0,5,1111,18.0,843.0,843.0
0.004,6,10,1702,5,863,1.0,595.0,595.0,5,839,0.0,571.0,571.0
0.009,17,2,179,1,71,0.0,43.0,43.0,1,108,0.0,80.0,80.0
300.392,6,16,2170,9,684,37528.0,146.0,146.0,7,1486,50037.0,419.0,398.0
0.085,6,10,1506,5,395,19.0,127.0,127.0,5,1111,18.0,843.0,843.0
0.021,6,10,1972,5,910,5.0,642.0,642.0,5,1062,5.0,794.0,794.0
0.182,6,10,1506,5,395,33.0,127.0,127.0,5,1111,45.0,843.0,843.0
23.389,6,36,8190,19,1759,1299.0,651.0,322.0,17,6431,537.0,2720.0,478.0
0.005,6,10,1689,5,839,1.0,571.0,571.0,5,850,1.0,582.0,582.0
0.005,6,10,2000,5,927,1.0,659.0,659.0,5,1073,1.0,805.0,805.0
0.005,6,14,3742,7,452,0.0,80.0,80.0,7,3290,0.0,1448.0,972.0
0.131,6,10,1506,5,395,32.0,127.0,127.0,5,1111,31.0,843.0,843.0
0.004,17,4,284,2,120,1.0,32.0,32.0,2,164,0.0,60.0,54.0
0.006,6,14,3799,7,509,0.0,137.0,137.0,7,3290,0.0,1448.0,972.0
0.018,6,10,1989,5,910,4.0,642.0,642.0,5,1079,4.0,811.0,811.0
0.123,6,10,1506,5,395,24.0,127.0,127.0,5,1111,26.0,843.0,843.0
40.053,17,10,676,5,460,10012.0,104.0,64.0,5,216,10010.0,20.0,15.0
0.025,6,10,1990,5,911,6.0,643.0,643.0,5,1079,6.0,811.0,811.0
0.005,17,2,144,1,64,0.0,36.0,36.0,1,80,0.0,52.0,52.0
0.008,6,10,1762,5,911,2.0,643.0,643.0,5,851,1.0,583.0,583.0
354.063,6,19,1691,15,978,25290.0,190.0,190.0,4,713,80003.0,497.0,497.0
10.812,17,28,4420,14,1993,822.0,268.0,114.0,14,2427,822.0,586.0,145.0
0.009,6,14,3799,7,509,1.0,137.0,137.0,7,3290,1.0,1448.0,972.0
0.005,6,10,2000,5,927,1.0,659.0,659.0,5,1073,1.0,805.0,805.0
0.016,6,10,1989,5,910,3.0,642.0,642.0,5,1079,4.0,811.0,811.0
0.004,6,10,2000,5,927,1.0,659.0,659.0,5,1073,1.0,805.0,805.0
0.057,6,10,1506,5,395,12.0,127.0,127.0,5,1111,12.0,843.0,843.0
0.011,6,10,1972,5,910,2.0,642.0,642.0,5,1062,2.0,794.0,794.0
0.011,6,10,1989,5,910,2.0,642.0,642.0,5,1079,2.0,811.0,811.0
0.075,17,2,144,1,64,0.0,36.0,36.0,1,80,0.0,52.0,52.0
353.996,6,21,1795,16,1030,23599.0,190.0,190.0,5,765,60002.0,464.0,248.0
0.005,6,10,1989,5,927,1.0,659.0,659.0,5,1062,1.0,794.0,794.0
0.003,17,4,284,2,120,0.0,32.0,32.0,2,164,0.0,60.0,54.0
0.037,17,2,170,1,65,0.0,37.0,37.0,1,105,0.0,77.0,77.0
0.004,6,10,2000,5,927,1.0,659.0,659.0,5,1073,1.0,805.0,805.0
0.004,6,10,1779,5,928,1.0,660.0,660.0,5,851,1.0,583.0,583.0
0.088,6,10,1506,5,395,17.0,127.0,127.0,5,1111,19.0,843.0,843.0
0.082,6,17,4824,8,2265,11.0,1102.0,613.0,9,2559,9.0,1162.0,416.0
0.224,17,4,352,2,130,150.0,37.0,37.0,2,222,187.0,89.0,83.0
0.012,6,10,1972,5,910,3.0,642.0,642.0,5,1062,2.0,794.0,794.0
40.064,17,10,676,5,460,10015.0,104.0,64.0,5,216,10015.0,20.0,15.0
0.004,6,10,2000,5,927,1.0,659.0,659.0,5,1073,1.0,805.0,805.0
0.089,6,10,1506,5,395,21.0,127.0,127.0,5,1111,17.0,843.0,843.0
0.011,6,10,1762,5,911,2.0,643.0,643.0,5,851,2.0,583.0,583.0
0.009,6,12,1926,6,1189,1.0,659.0,434.0,6,737,1.0,417.0,417.0
0.005,6,10,2000,5,927,1.0,659.0,659.0,5,1073,1.0,805.0,805.0
0.096,6,10,1506,5,395,21.0,127.0,127.0,5,1111,21.0,843.0,843.0
0.006,6,10,1547,5,764,1.0,496.0,496.0,5,783,1.0,515.0,515.0
0.083,6,10,1506,5,395,19.0,127.0,127.0,5,1111,19.0,843.0,843.0
0.006,6,10,1547,5,764,1.0,496.0,496.0,5,783,1.0,515.0,515.0
0.006,6,10,1547,5,764,1.0,496.0,496.0,5,783,1.0,515.0,515.0
0.006,6,10,1689,5,839,1.0,571.0,571.0,5,850,1.0,582.0,582.0
0.123,6,10,1506,5,395,26.0,127.0,127.0,5,1111,24.0,843.0,843.0
0.005,6,10,1854,5,889,1.0,621.0,621.0,5,965,1.0,697.0,697.0
40.089,17,10,676,5,460,10019.0,104.0,64.0,5,216,10021.0,20.0,15.0
0.041,17,2,152,1,76,0.0,48.0,48.0,1,76,0.0,48.0,48.0
0.004,6,10,2007,5,928,1.0,660.0,660.0,5,1079,1.0,811.0,811.0
0.004,17,2,148,1,60,0.0,32.0,32.0,1,88,0.0,60.0,60.0
0.115,6,10,1506,5,395,26.0,127.0,127.0,5,1111,24.0,843.0,843.0
0.01,6,10,1983,5,910,2.0,642.0,642.0,5,1073,2.0,805.0,805.0
0.003,17,2,170,1,65,0.0,37.0,37.0,1,105,0.0,77.0,77.0
40.056,17,10,676,5,460,10013.0,104.0,64.0,5,216,10013.0,20.0,15.0
0.02,6,10,1762,5,911,5.0,643.0,643.0,5,851,4.0,583.0,583.0
0.006,6,10,1779,5,928,1.0,660.0,660.0,5,851,1.0,583.0,583.0
0.007,6,10,1547,5,764,1.0,496.0,496.0,5,783,1.0,515.0,515.0
0.015,6,10,1972,5,910,3.0,642.0,642.0,5,1062,3.0,794.0,794.0
0.073,6,10,1506,5,395,16.0,127.0,127.0,5,1111,15.0,843.0,843.0
0.039,17,2,136,1,60,0.0,32.0,32.0,1,76,0.0,48.0,48.0
0.004,6,10,2007,5,928,1.0,660.0,660.0,5,1079,1.0,811.0,811.0
0.004,6,10,2000,5,927,1.0,659.0,659.0,5,1073,1.0,805.0,805.0
0.005,6,10,2006,5,927,1.0,659.0,659.0,5,1079,1.0,811.0,811.0
0.087,6,10,1506,5,395,20.0,127.0,127.0,5,1111,20.0,843.0,843.0
0.006,6,10,1689,5,839,1.0,571.0,571.0,5,850,1.0,582.0,582.0
0.004,6,10,2007,5,928,1.0,660.0,660.0,5,1079,1.0,811.0,811.0
0.013,17,2,152,1,56,0.0,28.0,28.0,1,96,0.0,68.0,68.0
0.106,6,10,1506,5,395,25.0,127.0,127.0,5,1111,25.0,843.0,843.0
0.001,17,2,180,1,66,0.0,38.0,38.0,1,114,0.0,86.0,86.0
0.084,6,10,1506,5,395,20.0,127.0,127.0,5,1111,15.0,843.0,843.0
0.005,6,10,1989,5,927,1.0,659.0,659.0,5,1062,1.0,794.0,794.0
0.005,6,10,2000,5,927,1.0,659.0,659.0,5,1073,1.0,805.0,805.0
356.591,6,21,1795,16,1030,23772.0,190.0,190.0,5,765,60003.0,464.0,248.0
0.004,6,10,2000,5,927,1.0,659.0,659.0,5,1073,1.0,805.0,805.0
0.014,6,10,1989,5,910,3.0,642.0,642.0,5,1079,3.0,811.0,811.0
0.009,6,10,1989,5,910,2.0,642.0,642.0,5,1079,2.0,811.0,811.0
0.008,6,10,1677,5,827,2.0,559.0,559.0,5,850,1.0,582.0,582.0
0.005,6,10,1779,5,928,1.0,660.0,660.0,5,851,1.0,583.0,583.0
0.004,17,2,170,1,65,0.0,37.0,37.0,1,105,0.0,77.0,77.0
0.09,6,10,1506,5,395,19.0,127.0,127.0,5,1111,18.0,843.0,843.0
0.005,6,10,1643,5,860,1.0,592.0,592.0,5,783,1.0,515.0,515.0
0.009,6,10,1990,5,911,2.0,643.0,643.0,5,1079,2.0,811.0,811.0
0.012,6,10,1990,5,911,2.0,643.0,643.0,5,1079,3.0,811.0,811.0
0.004,6,10,2006,5,927,1.0,659.0,659.0,5,1079,1.0,811.0,811.0
40.066,17,10,676,5,460,10013.0,104.0,64.0,5,216,10015.0,20.0,15.0
0.005,6,10,2006,5,927,1.0,659.0,659.0,5,1079,1.0,811.0,811.0
0.011,6,10,1989,5,910,2.0,642.0,642.0,5,1079,2.0,811.0,811.0
30.977,6,25,8066,14,2988,2370.0,1191.0,449.0,11,5078,3081.0,1402.0,751.0
0.001,17,2,180,1,66,0.0,38.0,38.0,1,114,0.0,86.0,86.0
0.105,6,10,1506,5,395,21.0,127.0,127.0,5,1111,24.0,843.0,843.0
0.012,6,10,1989,5,910,3.0,642.0,642.0,5,1079,2.0,811.0,811.0
0.006,17,2,178,1,81,0.0,53.0,53.0,1,97,0.0,69.0,69.0
0.078,6,10,1506,5,395,16.0,127.0,127.0,5,1111,18.0,843.0,843.0
0.013,17,2,179,1,71,0.0,43.0,43.0,1,108,0.0,80.0,80.0
0.067,6,10,1506,5,395,15.0,127.0,127.0,5,1111,13.0,843.0,843.0
0.005,6,10,1547,5,764,1.0,496.0,496.0,5,783,1.0,515.0,515.0
0.011,6,10,1989,5,910,2.0,642.0,642.0,5,1079,2.0,811.0,811.0
0.038,6,13,3735,7,497,6.0,125.0,125.0,6,3238,7.0,1470.0,1459.0
0.044,17,2,234,1,61,0.0,33.0,33.0,1,173,0.0,145.0,145.0
55.158,6,10,584,5,292,13789.0,46.0,46.0,5,292,13740.0,46.0,46.0
0.001,17,2,136,1,60,0.0,32.0,32.0,1,76,0.0,48.0,48.0
0.017,6,10,1990,5,911,4.0,643.0,643.0,5,1079,4.0,811.0,811.0
361.83,6,21,1792,16,1030,24122.0,190.0,190.0,5,762,60009.0,461.0,247.0
40.094,17,10,676,5,460,10017.0,104.0,64.0,5,216,10021.0,20.0,15.0
0.013,6,10,1762,5,911,3.0,643.0,643.0,5,851,3.0,583.0,583.0
0.009,6,10,1972,5,910,2.0,642.0,642.0,5,1062,2.0,794.0,794.0
0.005,6,10,2007,5,928,1.0,660.0,660.0,5,1079,1.0,811.0,811.0
0.022,6,10,1990,5,911,5.0,643.0,643.0,5,1079,5.0,811.0,811.0
0.017,6,10,1989,5,910,4.0,642.0,642.0,5,1079,4.0,811.0,811.0
0.067,6,10,1506,5,395,14.0,127.0,127.0,5,1111,14.0,843.0,843.0
0.005,17,2,194,1,59,0.0,31.0,31.0,1,135,0.0,107.0,107.0
0.006,17,2,170,1,65,0.0,37.0,37.0,1,105,0.0,77.0,77.0
0.011,6,10,1989,5,910,2.0,642.0,642.0,5,1079,2.0,811.0,811.0
0.012,6,10,1631,5,848,3.0,580.0,580.0,5,783,3.0,515.0,515.0
0.009,6,10,1989,5,927,2.0,659.0,659.0,5,1062,2.0,794.0,794.0
0.003,17,2,136,1,60,0.0,32.0,32.0,1,76,0.0,48.0,48.0
0.012,6,14,3787,7,497,1.0,125.0,125.0,7,3290,2.0,1448.0,972.0
15.084,17,15,8566,8,6376,2150.0,1350.0,769.0,7,2190,2509.0,1350.0,284.0
0.011,6,10,1972,5,910,2.0,642.0,642.0,5,1062,2.0,794.0,794.0
0.005,6,10,2006,5,927,1.0,659.0,659.0,5,1079,1.0,811.0,811.0
0.005,17,2,193,1,71,0.0,43.0,43.0,1,122,0.0,94.0,94.0
178.045,17,72,10158,36,2402,5086.0,44.0,38.0,36,7756,5086.0,239.0,187.0
240.19,6,27,13594,13,8642,20015.0,2736.0,1328.0,14,4952,18475.0,1656.0,1054.0
11.079,17,28,4395,14,1994,843.0,269.0,114.0,14,2401,843.0,588.0,143.0
0.009,6,10,1989,5,910,2.0,642.0,642.0,5,1079,2.0,811.0,811.0
0.006,6,10,1547,5,764,1.0,496.0,496.0,5,783,1.0,515.0,515.0
0.006,6,10,1547,5,764,1.0,496.0,496.0,5,783,1.0,515.0,515.0
0.066,6,10,1506,5,395,14.0,127.0,127.0,5,1111,14.0,843.0,843.0
240.022,6,9,787,5,488,60005.0,232.0,232.0,4,299,80006.0,83.0,83.0
0.005,6,10,1989,5,927,1.0,659.0,659.0,5,1062,1.0,794.0,794.0
0.006,6,10,1547,5,764,1.0,496.0,496.0,5,783,1.0,515.0,515.0
0.005,6,10,1989,5,927,1.0,659.0,659.0,5,1062,1.0,794.0,794.0
0.016,6,10,1989,5,910,3.0,642.0,642.0,5,1079,3.0,811.0,811.0
0.125,6,10,1506,5,395,29.0,127.0,127.0,5,1111,25.0,843.0,843.0
0.006,17,2,144,1,64,0.0,36.0,36.0,1,80,0.0,52.0,52.0
0.095,6,10,1506,5,395,20.0,127.0,127.0,5,1111,20.0,843.0,843.0
0.037,17,2,182,1,65,0.0,37.0,37.0,1,117,0.0,89.0,89.0
0.001,17,2,180,1,66,0.0,38.0,38.0,1,114,0.0,86.0,86.0
0.009,6,10,1983,5,910,2.0,642.0,642.0,5,1073,2.0,805.0,805.0
0.004,6,10,2007,5,928,1.0,660.0,660.0,5,1079,1.0,811.0,811.0
0.003,17,2,160,1,72,0.0,44.0,44.0,1,88,0.0,60.0,60.0
0.04,17,2,412,1,61,0.0,33.0,33.0,1,351,0.0,323.0,323.0
0.005,6,10,1989,5,927,1.0,659.0,659.0,5,1062,1.0,794.0,794.0
40.148,6,43,10355,25,3168,1672.0,1041.0,206.0,18,7187,2361.0,1402.0,568.0
0.001,17,2,180,1,66,0.0,38.0,38.0,1,114,0.0,86.0,86.0
0.037,17,2,152,1,76,0.0,48.0,48.0,1,76,0.0,48.0,48.0
0.003,17,2,148,1,60,0.0,32.0,32.0,1,88,0.0,60.0,60.0
0.001,17,2,136,1,60,0.0,32.0,32.0,1,76,0.0,48.0,48.0
0.011,6,10,1762,5,911,2.0,643.0,643.0,5,851,2.0,583.0,583.0
0.001,17,2,136,1,60,0.0,32.0,32.0,1,76,0.0,48.0,48.0
361.796,6,19,1689,15,978,25842.0,190.0,190.0,4,711,80014.0,495.0,495.0
0.013,6,10,1983,5,910,3.0,642.0,642.0,5,1073,3.0,805.0,805.0
0.003,17,2,148,1,60,0.0,32.0,32.0,1,88,0.0,60.0,60.0
0.004,6,10,2006,5,927,1.0,659.0,659.0,5,1079,1.0,811.0,811.0
0.012,6,13,3735,7,497,1.0,125.0,125.0,6,3238,2.0,1470.0,1459.0
0.006,6,10,1547,5,764,1.0,496.0,496.0,5,783,1.0,515.0,515.0
0.011,6,10,1990,5,911,2.0,643.0,643.0,5,1079,2.0,811.0,811.0
0.006,6,10,1854,5,889,1.0,621.0,621.0,5,965,1.0,697.0,697.0
0.005,6,10,2007,5,928,1.0,660.0,660.0,5,1079,1.0,811.0,811.0
0.009,6,10,1779,5,928,2.0,660.0,660.0,5,851,2.0,583.0,583.0
0.137,6,12,2996,7,549,22.0,177.0,177.0,5,2447,33.0,1402.0,1089.0
177.168,17,78,11263,39,2619,4662.0,44.0,39.0,39,8644,4662.0,239.0,193.0
300.323,6,16,2170,9,684,37520.0,146.0,146.0,7,1486,50026.0,419.0,398.0
0.078,6,10,1506,5,395,19.0,127.0,127.0,5,1111,17.0,843.0,843.0
0.007,17,2,222,1,65,0.0,37.0,37.0,1,157,0.0,129.0,129.0
0.017,6,10,1972,5,910,4.0,642.0,642.0,5,1062,4.0,794.0,794.0
0.004,6,10,2000,5,927,1.0,659.0,659.0,5,1073,1.0,805.0,805.0
715.408,6,51,15875,26,5497,28616.0,676.0,459.0,25,10378,29808.0,1402.0,605.0
0.007,6,10,1547,5,764,1.0,496.0,496.0,5,783,1.0,515.0,515.0
0.005,6,10,2000,5,927,1.0,659.0,659.0,5,1073,1.0,805.0,805.0
11.15,17,28,4418,14,1995,845.0,270.0,114.0,14,2423,845.0,586.0,145.0
0.006,6,10,1547,5,764,1.0,496.0,496.0,5,783,1.0,515.0,515.0
40.057,17,10,676,5,460,10012.0,104.0,64.0,5,216,10013.0,20.0,15.0
240.471,6,36,8976,19,2124,13359.0,693.0,225.0,17,6852,15029.0,1402.0,597.0
0.011,6,10,1989,5,910,2.0,642.0,642.0,5,1079,2.0,811.0,811.0
240.718,6,37,9950,18,3036,14159.0,577.0,258.0,19,6914,13373.0,1666.0,590.0
0.012,6,10,1989,5,910,2.0,642.0,642.0,5,1079,3.0,811.0,811.0
110.146,6,32,6224,17,1298,6884.0,267.0,195.0,15,4926,603.0,1823.0,392.0
0.106,6,10,1506,5,395,21.0,127.0,127.0,5,1111,24.0,843.0,843.0
0.013,6,10,1631,5,848,3.0,580.0,580.0,5,783,3.0,515.0,515.0
0.004,17,2,148,1,60,0.0,32.0,32.0,1,88,0.0,60.0,60.0
0.103,6,10,1506,5,395,23.0,127.0,127.0,5,1111,24.0,843.0,843.0
0.005,6,10,1989,5,927,1.0,659.0,659.0,5,1062,1.0,794.0,794.0
0.009,6,12,1926,6,1189,1.0,659.0,434.0,6,737,1.0,417.0,417.0
0.012,6,10,1631,5,848,3.0,580.0,580.0,5,783,3.0,515.0,515.0
0.015,6,10,1972,5,910,3.0,642.0,642.0,5,1062,3.0,794.0,794.0
0.006,17,2,169,1,62,0.0,34.0,34.0,1,107,0.0,79.0,79.0
0.004,6,10,2000,5,927,1.0,659.0,659.0,5,1073,1.0,805.0,805.0
0.114,6,10,1506,5,395,25.0,127.0,127.0,5,1111,23.0,843.0,843.0
0.022,6,10,1989,5,910,5.0,642.0,642.0,5,1079,5.0,811.0,811.0
172.367,17,74,10421,37,2457,4787.0,44.0,38.0,37,7964,4787.0,239.0,187.0
0.01,6,14,3787,7,497,1.0,125.0,125.0,7,3290,1.0,1448.0,972.0
0.097,6,10,1506,5,395,22.0,127.0,127.0,5,1111,19.0,843.0,843.0
0.005,6,10,2007,5,928,1.0,660.0,660.0,5,1079,1.0,811.0,811.0
0.014,6,10,1989,5,910,3.0,642.0,642.0,5,1079,3.0,811.0,811.0
0.04,17,4,352,2,130,1.0,37.0,37.0,2,222,35.0,89.0,83.0
10.988,17,28,4390,14,2312,836.0,587.0,137.0,14,2078,836.0,269.0,120.0
0.071,17,4,284,2,120,0.0,32.0,32.0,2,164,0.0,60.0,54.0
0.008,6,12,1926,6,1189,1.0,659.0,434.0,6,737,1.0,417.0,417.0
0.011,6,13,3735,7,497,1.0,125.0,125.0,6,3238,2.0,1470.0,1459.0
0.016,6,10,1989,5,910,3.0,642.0,642.0,5,1079,4.0,811.0,811.0
40.055,17,10,676,5,460,10013.0,104.0,64.0,5,216,10012.0,20.0,15.0
0.111,6,10,1506,5,395,25.0,127.0,127.0,5,1111,21.0,843.0,843.0
0.008,6,10,1762,5,911,2.0,643.0,643.0,5,851,2.0,583.0,583.0
0.077,6,10,1506,5,395,17.0,127.0,127.0,5,1111,16.0,843.0,843.0
0.004,6,10,2006,5,927,1.0,659.0,659.0,5,1079,1.0,811.0,811.0
0.12,6,10,1506,5,395,28.0,127.0,127.0,5,1111,25.0,843.0,843.0
0.006,17,2,180,1,66,0.0,38.0,38.0,1,114,0.0,86.0,86.0
0.004,17,4,284,2,120,0.0,32.0,32.0,2,164,1.0,60.0,54.0
0.017,6,10,1762,5,911,4.0,643.0,643.0,5,851,4.0,583.0,583.0
241.514,6,402,347847,214,22637,1133.0,2736.0,885.0,188,325210,1291.0,2804.0,1772.0
0.009,6,10,1972,5,910,2.0,642.0,642.0,5,1062,2.0,794.0,794.0
15.293,17,17,9545,8,4359,2180.0,1350.0,516.0,9,5186,1908.0,1350.0,548.0
0.096,6,10,1506,5,395,21.0,127.0,127.0,5,1111,23.0,843.0,843.0
40.073,17,10,676,5,460,10015.0,104.0,64.0,5,216,10017.0,20.0,15.0
0.016,6,10,1677,5,827,4.0,559.0,559.0,5,850,4.0,582.0,582.0
0.001,17,2,179,1,62,0.0,34.0,34.0,1,117,0.0,89.0,89.0
0.098,6,10,1506,5,395,22.0,127.0,127.0,5,1111,23.0,843.0,843.0
0.019,6,10,1990,5,911,4.0,643.0,643.0,5,1079,4.0,811.0,811.0
0.005,6,10,2000,5,927,1.0,659.0,659.0,5,1073,1.0,805.0,805.0
0.177,17,2,194,1,59,0.0,31.0,31.0,1,135,0.0,107.0,107.0
0.005,6,10,1779,5,928,1.0,660.0,660.0,5,851,1.0,583.0,583.0
0.005,6,10,2007,5,928,1.0,660.0,660.0,5,1079,1.0,811.0,811.0
0.008,6,10,1989,5,910,1.0,642.0,642.0,5,1079,2.0,811.0,811.0
0.023,6,10,1631,5,848,5.0,580.0,580.0,5,783,5.0,515.0,515.0
0.012,6,10,1677,5,827,2.0,559.0,559.0,5,850,3.0,582.0,582.0
55.384,6,65,32403,34,26042,285.0,4080.0,1759.0,31,6361,1840.0,2667.0,340.0
0.005,6,10,1774,5,923,1.0,655.0,655.0,5,851,1.0,583.0,583.0
0.04,17,2,148,1,60,0.0,32.0,32.0,1,88,0.0,60.0,60.0
0.013,17,2,152,1,56,0.0,28.0,28.0,1,96,0.0,68.0,68.0
0.041,17,2,148,1,60,0.0,32.0,32.0,1,88,0.0,60.0,60.0
0.07,6,10,1506,5,395,15.0,127.0,127.0,5,1111,14.0,843.0,843.0
0.006,6,10,1547,5,764,1.0,496.0,496.0,5,783,1.0,515.0,515.0
0.013,6,10,1990,5,911,3.0,643.0,643.0,5,1079,3.0,811.0,811.0
0.005,6,10,2000,5,927,1.0,659.0,659.0,5,1073,1.0,805.0,805.0
0.004,6,10,1989,5,927,1.0,659.0,659.0,5,1062,1.0,794.0,794.0
0.005,6,10,1774,5,923,1.0,655.0,655.0,5,851,1.0,583.0,583.0
0.035,17,2,152,1,76,0.0,48.0,48.0,1,76,0.0,48.0,48.0
11.161,17,28,4422,14,1994,846.0,269.0,114.0,14,2428,846.0,587.0,145.0
0.005,6,10,1779,5,928,1.0,660.0,660.0,5,851,1.0,583.0,583.0
0.013,17,2,152,1,56,0.0,28.0,28.0,1,96,0.0,68.0,68.0
0.135,6,10,1506,5,395,31.0,127.0,127.0,5,1111,31.0,843.0,843.0
172.07,17,78,10905,39,2615,4528.0,44.0,39.0,39,8290,4528.0,239.0,184.0
0.067,17,2,80,1,32,0.0,4.0,4.0,1,48,0.0,20.0,20.0
0.005,6,10,1643,5,860,1.0,592.0,592.0,5,783,1.0,515.0,515.0
0.014,6,10,1989,5,910,3.0,642.0,642.0,5,1079,3.0,811.0,811.0
0.009,6,10,1990,5,911,2.0,643.0,643.0,5,1079,2.0,811.0,811.0
0.017,6,10,1631,5,848,4.0,580.0,580.0,5,783,4.0,515.0,515.0
0.005,6,10,2006,5,927,1.0,659.0,659.0,5,1079,1.0,811.0,811.0
0.022,6,10,1983,5,910,5.0,642.0,642.0,5,1073,5.0,805.0,805.0
0.237,6,10,1506,5,395,27.0,127.0,127.0,5,1111,49.0,843.0,843.0
0.001,17,2,132,1,58,0.0,30.0,30.0,1,74,0.0,46.0,46.0
0.009,6,10,1972,5,910,2.0,642.0,642.0,5,1062,2.0,794.0,794.0
300.337,6,16,2170,9,684,37521.0,146.0,146.0,7,1486,50028.0,419.0,398.0
0.001,17,2,180,1,66,0.0,38.0,38.0,1,114,0.0,86.0,86.0
309.212,17,20,1124,10,716,34343.0,48.0,43.0,10,408,34345.0,20.0,12.0
0.089,6,10,1506,5,395,18.0,127.0,127.0,5,1111,18.0,843.0,843.0
308.561,17,20,1124,10,716,34270.0,48.0,43.0,10,408,34270.0,20.0,12.0
0.004,6,10,1989,5,927,1.0,659.0,659.0,5,1062,1.0,794.0,794.0
0.007,17,2,179,1,71,0.0,43.0,43.0,1,108,0.0,80.0,80.0
0.005,6,10,2000,5,927,1.0,659.0,659.0,5,1073,1.0,805.0,805.0
0.013,6,10,2000,5,927,3.0,659.0,659.0,5,1073,3.0,805.0,805.0
0.124,17,2,148,1,60,0.0,32.0,32.0,1,88,0.0,60.0,60.0
0.005,17,2,154,1,69,0.0,41.0,41.0,1,85,0.0,57.0,57.0
40.064,17,10,676,5,460,10014.0,104.0,64.0,5,216,10015.0,20.0,15.0
0.004,17,2,186,1,61,0.0,33.0,33.0,1,125,0.0,97.0,97.0
0.02,6,10,1972,5,910,4.0,642.0,642.0,5,1062,5.0,794.0,794.0
0.005,6,10,1689,5,839,1.0,571.0,571.0,5,850,1.0,582.0,582.0
0.011,6,10,1643,5,860,2.0,592.0,592.0,5,783,2.0,515.0,515.0
168.154,17,74,10381,37,2465,4670.0,44.0,38.0,37,7916,4670.0,261.0,185.0
240.08,6,21,4926,11,941,24008.0,180.0,93.0,10,3985,26675.0,1593.0,576.0
0.085,6,10,1506,5,395,18.0,127.0,127.0,5,1111,18.0,843.0,843.0
0.039,17,4,284,2,120,0.0,32.0,32.0,2,164,36.0,60.0,54.0
40.053,17,10,676,5,460,10012.0,104.0,64.0,5,216,10012.0,20.0,15.0
0.005,17,2,179,1,71,0.0,43.0,43.0,1,108,0.0,80.0,80.0
0.005,6,10,1989,5,927,1.0,659.0,659.0,5,1062,1.0,794.0,794.0
0.016,6,10,1990,5,911,4.0,643.0,643.0,5,1079,3.0,811.0,811.0
0.005,17,2,164,1,74,0.0,46.0,46.0,1,90,0.0,62.0,62.0
0.004,6,10,2006,5,927,1.0,659.0,659.0,5,1079,1.0,811.0,811.0
0.004,6,10,1702,5,863,1.0,595.0,595.0,5,839,1.0,571.0,571.0
0.006,6,10,1689,5,839,1.0,571.0,571.0,5,850,1.0,582.0,582.0
0.008,6,10,1989,5,910,1.0,642.0,642.0,5,1079,2.0,811.0,811.0
360.031,6,21,3981,13,3142,30002.0,494.0,494.0,8,839,51432.0,83.0,83.0
0.001,17,2,180,1,66,0.0,38.0,38.0,1,114,0.0,86.0,86.0
0.003,17,2,160,1,72,0.0,44.0,44.0,1,88,0.0,60.0,60.0
0.085,6,10,1506,5,395,20.0,127.0,127.0,5,1111,15.0,843.0,843.0
0.124,17,2,412,1,61,0.0,33.0,33.0,1,351,0.0,323.0,323.0
0.04,17,2,152,1,76,0.0,48.0,48.0,1,76,0.0,48.0,48.0
0.021,6,14,3787,7,497,3.0,125.0,125.0,7,3290,3.0,1448.0,972.0
0.042,6,10,1972,5,910,10.0,642.0,642.0,5,1062,10.0,794.0,794.0
0.009,6,10,1990,5,911,2.0,643.0,643.0,5,1079,2.0,811.0,811.0
0.018,6,10,1990,5,911,4.0,643.0,643.0,5,1079,4.0,811.0,811.0
0.008,6,10,1762,5,911,2.0,643.0,643.0,5,851,2.0,583.0,583.0
0.16,6,10,1506,5,395,35.0,127.0,127.0,5,1111,36.0,843.0,843.0
240.333,6,33,8638,17,1837,15020.0,570.0,189.0,16,6801,16021.0,1402.0,597.0
0.17,6,3,453,2,321,170.0,241.0,241.0,1,132,0.0,92.0,92.0
0.005,17,2,166,1,75,0.0,47.0,47.0,1,91,0.0,63.0,63.0
0.011,6,13,3735,7,497,1.0,125.0,125.0,6,3238,2.0,1470.0,1459.0
0.005,6,10,2007,5,928,1.0,660.0,660.0,5,1079,1.0,811.0,811.0
300.572,6,19,3081,11,1647,30057.0,517.0,266.0,8,1434,34358.0,821.0,336.0
0.005,6,10,1643,5,860,1.0,592.0,592.0,5,783,1.0,515.0,515.0
0.005,6,10,1854,5,889,1.0,621.0,621.0,5,965,1.0,697.0,697.0
0.012,6,10,1983,5,910,3.0,642.0,642.0,5,1073,3.0,805.0,805.0
0.005,6,10,1989,5,927,1.0,659.0,659.0,5,1062,1.0,794.0,794.0
0.006,6,10,1547,5,764,1.0,496.0,496.0,5,783,1.0,515.0,515.0
0.005,17,2,140,1,62,0.0,34.0,34.0,1,78,0.0,50.0,50.0
0.005,6,10,1774,5,923,1.0,655.0,655.0,5,851,1.0,583.0,583.0
0.006,6,10,2007,5,928,1.0,660.0,660.0,5,1079,1.0,811.0,811.0
0.258,6,16,2777,8,1395,36.0,533.0,323.0,8,1382,24.0,529.0,239.0
0.091,6,10,1506,5,395,17.0,127.0,127.0,5,1111,21.0,843.0,843.0
0.005,6,10,2000,5,927,1.0,659.0,659.0,5,1073,1.0,805.0,805.0
322.413,17,20,1124,10,716,35808.0,48.0,43.0,10,408,35808.0,20.0,12.0
0.008,6,10,1989,5,910,2.0,642.0,642.0,5,1079,2.0,811.0,811.0
0.129,17,4,284,2,120,0.0,32.0,32.0,2,164,126.0,60.0,54.0
352.246,6,20,2210,6,1308,12004.0,494.0,494.0,14,902,27095.0,83.0,83.0
0.102,6,10,1506,5,395,23.0,127.0,127.0,5,1111,24.0,843.0,843.0
0.01,6,12,1926,6,1189,2.0,659.0,434.0,6,737,2.0,417.0,417.0
308.423,17,20,1124,10,716,34254.0,48.0,43.0,10,408,34254.0,20.0,12.0
0.005,17,4,284,2,120,0.0,32.0,32.0,2,164,1.0,60.0,54.0
0.012,6,10,1983,5,910,3.0,642.0,642.0,5,1073,2.0,805.0,805.0
366.113,6,22,2313,16,867,24407.0,195.0,195.0,6,1446,4641.0,419.0,398.0
0.005,6,14,3799,7,509,0.0,137.0,137.0,7,3290,0.0,1448.0,972.0
0.005,17,2,166,1,75,0.0,47.0,47.0,1,91,0.0,63.0,63.0
0.005,6,10,2006,5,927,1.0,659.0,659.0,5,1079,1.0,811.0,811.0
0.01,6,14,3965,7,495,1.0,123.0,123.0,7,3470,1.0,1448.0,1032.0
0.01,6,10,1983,5,910,2.0,642.0,642.0,5,1073,2.0,805.0,805.0
40.078,17,10,676,5,460,10018.0,104.0,64.0,5,216,10018.0,20.0,15.0
0.109,6,10,1506,5,395,24.0,127.0,127.0,5,1111,22.0,843.0,843.0
0.037,17,2,170,1,65,0.0,37.0,37.0,1,105,0.0,77.0,77.0
0.007,6,10,1547,5,764,1.0,496.0,496.0,5,783,1.0,515.0,515.0
0.017,6,10,1972,5,910,4.0,642.0,642.0,5,1062,4.0,794.0,794.0
0.007,17,2,179,1,71,0.0,43.0,43.0,1,108,0.0,80.0,80.0
9.037,17,6,376,5,280,2259.0,28.0,28.0,1,96,0.0,68.0,68.0
0.01,6,13,3735,7,497,1.0,125.0,125.0,6,3238,1.0,1470.0,1459.0
0.004,6,10,2006,5,927,1.0,659.0,659.0,5,1079,1.0,811.0,811.0
0.005,6,10,2007,5,928,1.0,660.0,660.0,5,1079,1.0,811.0,811.0
0.005,6,10,2000,5,927,1.0,659.0,659.0,5,1073,1.0,805.0,805.0
0.014,6,10,1990,5,911,3.0,643.0,643.0,5,1079,3.0,811.0,811.0
40.061,17,10,676,5,460,10014.0,104.0,64.0,5,216,10014.0,20.0,15.0
0.075,6,10,1506,5,395,16.0,127.0,127.0,5,1111,16.0,843.0,843.0
1777.663,17,138,43608,72,22752,25036.0,288.0,288.0,66,20856,26957.0,288.0,288.0
0.005,6,13,3747,7,509,0.0,137.0,137.0,6,3238,0.0,1470.0,1459.0
0.012,6,10,1990,5,911,2.0,643.0,643.0,5,1079,3.0,811.0,811.0
0.005,17,2,136,1,60,0.0,32.0,32.0,1,76,0.0,48.0,48.0
0.083,6,10,1506,5,395,19.0,127.0,127.0,5,1111,19.0,843.0,843.0
0.017,6,10,1677,5,827,4.0,559.0,559.0,5,850,4.0,582.0,582.0
0.066,6,10,1506,5,395,14.0,127.0,127.0,5,1111,15.0,843.0,843.0
0.134,6,10,1506,5,395,33.0,127.0,127.0,5,1111,30.0,843.0,843.0
0.011,6,10,1972,5,910,2.0,642.0,642.0,5,1062,2.0,794.0,794.0
0.003,17,2,136,1,60,0.0,32.0,32.0,1,76,0.0,48.0,48.0
0.004,17,4,284,2,120,0.0,32.0,32.0,2,164,1.0,60.0,54.0
262.028,6,32,9542,16,7040,17468.0,2111.0,690.0,16,2502,17468.0,580.0,184.0
0.04,17,2,184,1,61,0.0,33.0,33.0,1,123,0.0,95.0,95.0
0.121,6,10,1506,5,395,27.0,127.0,127.0,5,1111,28.0,843.0,843.0
0.012,6,10,1990,5,911,3.0,643.0,643.0,5,1079,2.0,811.0,811.0
0.015,6,10,1989,5,910,3.0,642.0,642.0,5,1079,3.0,811.0,811.0
0.003,17,2,148,1,60,0.0,32.0,32.0,1,88,0.0,60.0,60.0
0.044,17,4,352,2,130,6.0,37.0,37.0,2,222,40.0,89.0,83.0
0.005,6,12,1698,6,863,1.0,327.0,271.0,6,835,1.0,515.0,515.0
0.004,6,14,3742,8,504,0.0,80.0,80.0,6,3238,0.0,1470.0,1459.0
0.014,6,10,1989,5,910,3.0,642.0,642.0,5,1079,3.0,811.0,811.0
0.008,6,10,1972,5,910,2.0,642.0,642.0,5,1062,2.0,794.0,794.0
0.086,6,10,1506,5,395,19.0,127.0,127.0,5,1111,16.0,843.0,843.0
240.269,6,42,8721,21,5686,12013.0,2883.0,573.0,21,3035,12013.0,580.0,241.0
0.005,6,10,2007,5,928,1.0,660.0,660.0,5,1079,1.0,811.0,811.0
0.005,6,10,2007,5,928,1.0,660.0,660.0,5,1079,1.0,811.0,811.0
0.113,6,10,1506,5,395,26.0,127.0,127.0,5,1111,25.0,843.0,843.0
0.005,6,10,2007,5,928,1.0,660.0,660.0,5,1079,1.0,811.0,811.0
0.007,17,2,179,1,71,0.0,43.0,43.0,1,108,0.0,80.0,80.0
0.015,17,2,194,1,59,0.0,31.0,31.0,1,135,0.0,107.0,107.0
40.068,17,10,676,5,460,10014.0,104.0,64.0,5,216,10016.0,20.0,15.0
0.005,6,10,2006,5,927,1.0,659.0,659.0,5,1079,1.0,811.0,811.0
0.069,6,10,1506,5,395,16.0,127.0,127.0,5,1111,14.0,843.0,843.0
240.131,6,44,6643,21,3173,12006.0,588.0,230.0,23,3470,10914.0,580.0,226.0
0.005,6,10,2006,5,927,1.0,659.0,659.0,5,1079,1.0,811.0,811.0
0.005,6,10,1689,5,839,1.0,571.0,571.0,5,850,1.0,582.0,582.0
0.005,6,10,2007,5,928,1.0,660.0,660.0,5,1079,1.0,811.0,811.0
300.84,6,46,11993,24,6270,13080.0,2720.0,877.0,22,5723,412.0,1360.0,371.0
0.037,17,2,148,1,60,0.0,32.0,32.0,1,88,0.0,60.0,60.0
0.012,6,10,1989,5,910,3.0,642.0,642.0,5,1079,2.0,811.0,811.0
0.001,17,2,180,1,66,0.0,38.0,38.0,1,114,0.0,86.0,86.0
0.017,6,10,1989,5,910,4.0,642.0,642.0,5,1079,4.0,811.0,811.0
169.08,17,82,11639,41,2734,4226.0,44.0,38.0,41,8905,4226.0,239.0,189.0
0.005,6,10,1643,5,860,1.0,592.0,592.0,5,783,1.0,515.0,515.0
0.004,6,10,2000,5,927,1.0,659.0,659.0,5,1073,1.0,805.0,805.0
0.014,6,10,1972,5,910,3.0,642.0,642.0,5,1062,3.0,794.0,794.0
40.067,17,10,676,5,460,10015.0,104.0,64.0,5,216,10015.0,20.0,15.0
10.87,17,28,4422,14,1994,827.0,269.0,114.0,14,2428,827.0,587.0,145.0
1.995,6,32,6224,17,1298,124.0,267.0,195.0,15,4926,132.0,1823.0,392.0
0.008,6,10,1677,5,827,2.0,559.0,559.0,5,850,2.0,582.0,582.0
40.077,17,10,676,5,460,10016.0,104.0,64.0,5,216,10018.0,20.0,15.0
0.096,6,10,1506,5,395,21.0,127.0,127.0,5,1111,23.0,843.0,843.0
0.005,6,10,2006,5,927,1.0,659.0,659.0,5,1079,1.0,811.0,811.0
0.005,6,10,2007,5,928,1.0,660.0,660.0,5,1079,1.0,811.0,811.0
0.004,17,2,148,1,60,0.0,32.0,32.0,1,88,0.0,60.0,60.0
0.127,6,10,1506,5,395,29.0,127.0,127.0,5,1111,29.0,843.0,843.0
40.068,17,10,676,5,460,10014.0,104.0,64.0,5,216,10016.0,20.0,15.0
0.003,17,2,152,1,76,0.0,48.0,48.0,1,76,0.0,48.0,48.0
0.012,6,10,1972,5,910,2.0,642.0,642.0,5,1062,3.0,794.0,794.0
300.101,6,46,18340,24,12662,13040.0,4080.0,1296.0,22,5678,14282.0,1360.0,398.0
0.175,6,3,453,2,321,175.0,241.0,241.0,1,132,0.0,92.0,92.0
0.041,17,4,596,2,122,1.0,33.0,33.0,2,474,1.0,323.0,209.0
0.006,6,10,1779,5,928,1.0,660.0,660.0,5,851,1.0,583.0,583.0
0.004,6,10,1702,5,863,1.0,595.0,595.0,5,839,0.0,571.0,571.0
0.773,6,10,2009,6,1655,154.0,1403.0,1403.0,4,354,179.0,182.0,182.0
0.014,6,10,1989,5,910,3.0,642.0,642.0,5,1079,3.0,811.0,811.0
0.009,6,12,1926,6,1189,1.0,659.0,434.0,6,737,1.0,417.0,417.0
1791.75,6,273,25476,138,8958,13078.0,748.0,295.0,135,16518,13371.0,1624.0,73.0
0.006,6,10,1547,5,764,1.0,496.0,496.0,5,783,1.0,515.0,515.0
0.005,6,10,1774,5,923,1.0,655.0,655.0,5,851,1.0,583.0,583.0
0.004,17,4,284,2,120,0.0,32.0,32.0,2,164,1.0,60.0,54.0
0.005,6,10,1779,5,928,1.0,660.0,660.0,5,851,1.0,583.0,583.0
0.01,6,10,1989,5,910,2.0,642.0,642.0,5,1079,2.0,811.0,811.0
0.072,17,2,144,1,64,0.0,36.0,36.0,1,80,0.0,52.0,52.0
0.005,6,10,2007,5,928,1.0,660.0,660.0,5,1079,1.0,811.0,811.0
0.038,17,2,148,1,60,0.0,32.0,32.0,1,88,0.0,60.0,60.0
0.041,17,2,148,1,60,0.0,32.0,32.0,1,88,0.0,60.0,60.0
40.06,17,10,676,5,460,10014.0,104.0,64.0,5,216,10014.0,20.0,15.0
0.005,6,10,2007,5,928,1.0,660.0,660.0,5,1079,1.0,811.0,811.0
0.005,6,13,3747,7,509,0.0,137.0,137.0,6,3238,0.0,1470.0,1459.0
0.004,17,2,166,1,75,0.0,47.0,47.0,1,91,0.0,63.0,63.0
0.029,17,2,214,1,75,0.0,47.0,47.0,1,139,0.0,111.0,111.0
15.083,17,16,8314,8,6097,2150.0,1350.0,734.0,8,2217,2150.0,1350.0,249.0
0.004,6,10,2006,5,927,1.0,659.0,659.0,5,1079,1.0,811.0,811.0
308.499,17,20,1124,10,716,34271.0,48.0,43.0,10,408,34271.0,20.0,12.0
0.005,6,10,2006,5,927,1.0,659.0,659.0,5,1079,1.0,811.0,811.0
0.005,17,2,214,1,75,0.0,47.0,47.0,1,139,0.0,111.0,111.0
351.986,6,20,2210,6,1308,12003.0,494.0,494.0,14,902,27075.0,83.0,83.0
0.004,6,10,1989,5,927,1.0,659.0,659.0,5,1062,1.0,794.0,794.0
0.093,6,10,1506,5,395,20.0,127.0,127.0,5,1111,20.0,843.0,843.0
0.014,6,10,1983,5,910,3.0,642.0,642.0,5,1073,3.0,805.0,805.0
0.007,6,10,1547,5,764,1.0,496.0,496.0,5,783,1.0,515.0,515.0
0.005,6,10,2000,5,927,1.0,659.0,659.0,5,1073,1.0,805.0,805.0
0.006,6,10,1547,5,764,1.0,496.0,496.0,5,783,1.0,515.0,515.0
0.008,6,10,1774,5,923,1.0,655.0,655.0,5,851,2.0,583.0,583.0
0.003,17,2,136,1,60,0.0,32.0,32.0,1,76,0.0,48.0,48.0
0.114,6,10,1506,5,395,27.0,127.0,127.0,5,1111,23.0,843.0,843.0
0.105,6,10,1506,5,395,21.0,127.0,127.0,5,1111,22.0,843.0,843.0
0.014,6,10,1972,5,910,3.0,642.0,642.0,5,1062,3.0,794.0,794.0
40.057,17,10,676,5,460,10013.0,104.0,64.0,5,216,10013.0,20.0,15.0
0.006,6,10,1547,5,764,1.0,496.0,496.0,5,783,1.0,515.0,515.0
0.098,6,10,1506,5,395,18.0,127.0,127.0,5,1111,23.0,843.0,843.0
0.08,6,10,1506,5,395,16.0,127.0,127.0,5,1111,18.0,843.0,843.0
0.014,6,10,1989,5,910,3.0,642.0,642.0,5,1079,3.0,811.0,811.0
0.006,6,14,3742,7,452,1.0,80.0,80.0,7,3290,0.0,1448.0,972.0
0.012,6,10,1989,5,910,3.0,642.0,642.0,5,1079,2.0,811.0,811.0
0.006,6,10,2006,5,927,1.0,659.0,659.0,5,1079,1.0,811.0,811.0
0.013,6,13,3735,7,497,2.0,125.0,125.0,6,3238,2.0,1470.0,1459.0
40.071,17,10,676,5,460,10017.0,104.0,64.0,5,216,10017.0,20.0,15.0
0.005,6,10,2006,5,927,1.0,659.0,659.0,5,1079,1.0,811.0,811.0
0.001,17,2,179,1,62,0.0,34.0,34.0,1,117,0.0,89.0,89.0
0.013,6,10,1631,5,848,3.0,580.0,580.0,5,783,3.0,515.0,515.0
0.005,6,10,1774,5,923,1.0,655.0,655.0,5,851,1.0,583.0,583.0
0.129,6,10,1506,5,395,28.0,127.0,127.0,5,1111,30.0,843.0,843.0
0.013,6,10,1990,5,911,3.0,643.0,643.0,5,1079,3.0,811.0,811.0
0.072,6,10,1506,5,395,17.0,127.0,127.0,5,1111,16.0,843.0,843.0
0.033,6,14,3868,7,578,5.0,206.0,206.0,7,3290,5.0,1448.0,972.0
0.087,6,10,1506,5,395,19.0,127.0,127.0,5,1111,16.0,843.0,843.0
0.006,6,10,1547,5,764,1.0,496.0,496.0,5,783,1.0,515.0,515.0
0.01,6,12,1926,6,1189,2.0,659.0,434.0,6,737,1.0,417.0,417.0
0.157,6,10,1506,5,395,38.0,127.0,127.0,5,1111,38.0,843.0,843.0
0.001,17,2,140,1,62,0.0,34.0,34.0,1,78,0.0,50.0,50.0
0.233,6,16,2669,8,1395,33.0,533.0,323.0,8,1274,21.0,529.0,212.0
0.005,6,10,2007,5,928,1.0,660.0,660.0,5,1079,1.0,811.0,811.0
0.005,17,2,214,1,75,0.0,47.0,47.0,1,139,0.0,111.0,111.0
0.839,6,10,1716,6,1362,167.0,1110.0,1110.0,4,354,198.0,182.0,182.0
0.006,6,10,1547,5,764,1.0,496.0,496.0,5,783,1.0,515.0,515.0
437.953,6,31,8457,15,2520,31282.0,665.0,346.0,16,5937,25194.0,1449.0,509.0
0.307,17,44,24404,24,21180,13.0,1350.0,854.0,20,3224,11.0,1350.0,133.0
0.005,6,10,2000,5,927,1.0,659.0,659.0,5,1073,1.0,805.0,805.0
0.008,6,10,1989,5,910,1.0,642.0,642.0,5,1079,2.0,811.0,811.0
0.01,6,10,1972,5,910,2.0,642.0,642.0,5,1062,2.0,794.0,794.0
0.075,17,2,144,1,64,0.0,36.0,36.0,1,80,0.0,52.0,52.0
0.01,6,10,1990,5,911,2.0,643.0,643.0,5,1079,2.0,811.0,811.0
0.01,6,14,3787,7,497,1.0,125.0,125.0,7,3290,1.0,1448.0,972.0
240.182,6,21,6344,11,1758,24018.0,924.0,396.0,10,4586,26686.0,1593.0,676.0
0.005,6,13,3747,7,509,0.0,137.0,137.0,6,3238,0.0,1470.0,1459.0
0.005,6,10,1989,5,927,1.0,659.0,659.0,5,1062,1.0,794.0,794.0
1755.963,6,105,6270,60,3525,29761.0,27.0,27.0,45,2745,39907.0,27.0,27.0
0.138,6,10,1506,5,395,30.0,127.0,127.0,5,1111,31.0,843.0,843.0
0.01,6,10,1677,5,827,2.0,559.0,559.0,5,850,2.0,582.0,582.0
0.073,17,8,3613,4,1874,24.0,1350.0,440.0,4,1739,13.0,1350.0,406.0
1778.493,17,144,41760,72,22752,25049.0,288.0,288.0,72,19008,25049.0,236.0,236.0
0.065,6,10,1506,5,395,14.0,127.0,127.0,5,1111,15.0,843.0,843.0
0.017,6,10,1972,5,910,4.0,642.0,642.0,5,1062,4.0,794.0,794.0
0.129,6,10,1506,5,395,31.0,127.0,127.0,5,1111,28.0,843.0,843.0
0.11,6,10,1506,5,395,24.0,127.0,127.0,5,1111,22.0,843.0,843.0
0.008,6,10,1990,5,911,2.0,643.0,643.0,5,1079,1.0,811.0,811.0
40.079,17,10,676,5,460,10016.0,104.0,64.0,5,216,10018.0,20.0,15.0
0.004,17,2,136,1,60,0.0,32.0,32.0,1,76,0.0,48.0,48.0
0.126,6,10,1506,5,395,25.0,127.0,127.0,5,1111,27.0,843.0,843.0
0.016,6,10,1989,5,910,4.0,642.0,642.0,5,1079,4.0,811.0,811.0
0.02,6,10,1983,5,910,4.0,642.0,642.0,5,1073,5.0,805.0,805.0
0.005,6,10,1689,5,839,1.0,571.0,571.0,5,850,1.0,582.0,582.0
0.117,6,10,1506,5,395,27.0,127.0,127.0,5,1111,27.0,843.0,843.0
0.004,17,2,146,1,65,0.0,37.0,37.0,1,81,0.0,53.0,53.0
0.105,6,10,1506,5,395,25.0,127.0,127.0,5,1111,22.0,843.0,843.0
0.07,6,10,1506,5,395,16.0,127.0,127.0,5,1111,16.0,843.0,843.0
0.045,17,4,352,2,130,5.0,37.0,37.0,2,222,41.0,89.0,83.0
0.325,17,43,21761,23,18465,14.0,1350.0,774.0,20,3296,13.0,1350.0,136.0
11.001,17,28,4389,14,2312,837.0,587.0,137.0,14,2077,837.0,268.0,120.0
0.001,17,2,180,1,66,0.0,38.0,38.0,1,114,0.0,86.0,86.0
40.058,17,10,676,5,460,10012.0,104.0,64.0,5,216,10013.0,20.0,15.0
0.005,6,10,1547,5,764,1.0,496.0,496.0,5,783,1.0,515.0,515.0
0.01,6,10,1990,5,911,2.0,643.0,643.0,5,1079,2.0,811.0,811.0
0.072,17,4,596,2,122,1.0,33.0,33.0,2,474,29.0,323.0,209.0
0.234,6,16,2670,8,1396,33.0,533.0,324.0,8,1274,21.0,529.0,212.0
167.259,17,86,12599,43,2894,3982.0,44.0,39.0,43,9705,3982.0,239.0,197.0
0.006,17,2,179,1,71,0.0,43.0,43.0,1,108,0.0,80.0,80.0
0.001,17,2,180,1,66,0.0,38.0,38.0,1,114,0.0,86.0,86.0
0.005,6,10,1989,5,927,1.0,659.0,659.0,5,1062,1.0,794.0,794.0
0.006,17,2,140,1,62,0.0,34.0,34.0,1,78,0.0,50.0,50.0
0.005,6,10,2007,5,928,1.0,660.0,660.0,5,1079,1.0,811.0,811.0
1768.416,17,92,8096,46,4048,39297.0,60.0,60.0,46,4048,39298.0,60.0,60.0
0.041,17,2,152,1,76,0.0,48.0,48.0,1,76,0.0,48.0,48.0
0.108,6,10,1506,5,395,24.0,127.0,127.0,5,1111,25.0,843.0,843.0
0.004,17,2,136,1,60,0.0,32.0,32.0,1,76,0.0,48.0,48.0
0.004,6,10,1702,5,863,1.0,595.0,595.0,5,839,0.0,571.0,571.0
0.005,6,10,2000,5,927,1.0,659.0,659.0,5,1073,1.0,805.0,805.0
0.104,6,10,1506,5,395,22.0,127.0,127.0,5,1111,24.0,843.0,843.0
0.013,6,10,1972,5,910,3.0,642.0,642.0,5,1062,3.0,794.0,794.0
335.14,17,20,1124,10,716,37225.0,48.0,43.0,10,408,37227.0,20.0,12.0
0.011,6,10,1983,5,910,2.0,642.0,642.0,5,1073,2.0,805.0,805.0
0.113,6,10,1506,5,395,25.0,127.0,127.0,5,1111,23.0,843.0,843.0
354.036,6,21,1795,16,1030,23602.0,190.0,190.0,5,765,60002.0,464.0,248.0
0.012,6,10,1631,5,848,3.0,580.0,580.0,5,783,3.0,515.0,515.0
315.297,17,20,1124,10,716,35018.0,48.0,43.0,10,408,35018.0,20.0,12.0
0.007,6,10,1643,5,860,1.0,592.0,592.0,5,783,1.0,515.0,515.0
0.014,6,10,1989,5,910,3.0,642.0,642.0,5,1079,3.0,811.0,811.0
0.191,17,17,9436,8,6769,27.0,1350.0,818.0,9,2667,19.0,1350.0,268.0
0.001,17,2,136,1,60,0.0,32.0,32.0,1,76,0.0,48.0,48.0
0.005,6,14,3736,7,446,0.0,74.0,74.0,7,3290,0.0,1448.0,972.0
0.014,6,10,1989,5,910,3.0,642.0,642.0,5,1079,3.0,811.0,811.0
0.011,6,10,1989,5,910,2.0,642.0,642.0,5,1079,2.0,811.0,811.0
0.004,6,10,2006,5,927,1.0,659.0,659.0,5,1079,1.0,811.0,811.0
0.01,6,10,1631,5,848,2.0,580.0,580.0,5,783,2.0,515.0,515.0
1793.558,6,286,27080,144,9942,12542.0,747.0,270.0,142,17138,12720.0,1626.0,72.0
1751.889,6,447,65737,253,35232,6951.0,613.0,197.0,194,30505,9076.0,453.0,144.0
0.007,6,10,1677,5,827,1.0,559.0,559.0,5,850,1.0,582.0,582.0
0.01,6,10,1972,5,910,2.0,642.0,642.0,5,1062,2.0,794.0,794.0
0.017,6,10,1631,5,848,4.0,580.0,580.0,5,783,4.0,515.0,515.0
0.012,6,10,1989,5,910,3.0,642.0,642.0,5,1079,2.0,811.0,811.0
0.038,17,2,148,1,60,0.0,32.0,32.0,1,88,0.0,60.0,60.0
0.007,6,10,1702,5,863,1.0,595.0,595.0,5,839,1.0,571.0,571.0
40.069,17,10,676,5,460,10015.0,104.0,64.0,5,216,10016.0,20.0,15.0
0.098,6,10,1506,5,395,21.0,127.0,127.0,5,1111,21.0,843.0,843.0
0.086,6,10,1506,5,395,19.0,127.0,127.0,5,1111,20.0,843.0,843.0
0.006,6,10,1547,5,764,1.0,496.0,496.0,5,783,1.0,515.0,515.0
0.129,17,2,80,1,32,0.0,4.0,4.0,1,48,0.0,20.0,20.0
0.006,6,10,1547,5,764,1.0,496.0,496.0,5,783,1.0,515.0,515.0
0.104,6,10,1506,5,395,23.0,127.0,127.0,5,1111,21.0,843.0,843.0
0.005,6,10,1989,5,927,1.0,659.0,659.0,5,1062,1.0,794.0,794.0
0.006,6,13,3684,7,446,0.0,74.0,74.0,6,3238,1.0,1470.0,1459.0
0.008,6,10,1983,5,910,1.0,642.0,642.0,5,1073,1.0,805.0,805.0
0.006,6,10,1547,5,764,1.0,496.0,496.0,5,783,1.0,515.0,515.0
290.199,6,418,350058,204,22164,1429.0,2736.0,889.0,214,327894,1362.0,3036.0,1583.0
0.001,17,2,180,1,66,0.0,38.0,38.0,1,114,0.0,86.0,86.0
0.012,6,10,1631,5,848,2.0,580.0,580.0,5,783,3.0,515.0,515.0
58.863,6,44,13625,22,7718,433.0,2720.0,972.0,22,5907,2795.0,2667.0,385.0
0.038,17,4,284,2,120,0.0,32.0,32.0,2,164,34.0,60.0,54.0
0.04,17,2,182,1,65,0.0,37.0,37.0,1,117,0.0,89.0,89.0
0.005,6,10,2000,5,927,1.0,659.0,659.0,5,1073,1.0,805.0,805.0
81.958,6,522,677778,195,15874,422.0,1498.0,944.0,327,661904,251.0,4206.0,2002.0
40.075,17,10,676,5,460,10013.0,104.0,64.0,5,216,10016.0,20.0,15.0
0.068,17,2,152,1,76,0.0,48.0,48.0,1,76,0.0,48.0,48.0
0.069,17,8,3613,4,1874,23.0,1350.0,440.0,4,1739,11.0,1350.0,406.0
0.01,6,10,1989,5,910,2.0,642.0,642.0,5,1079,2.0,811.0,811.0
0.017,6,10,1989,5,910,4.0,642.0,642.0,5,1079,4.0,811.0,811.0
0.177,17,2,194,1,59,0.0,31.0,31.0,1,135,0.0,107.0,107.0
0.004,6,10,2006,5,927,1.0,659.0,659.0,5,1079,1.0,811.0,811.0
0.015,6,10,1972,5,910,3.0,642.0,642.0,5,1062,3.0,794.0,794.0
0.011,6,10,1989,5,910,2.0,642.0,642.0,5,1079,2.0,811.0,811.0
0.048,6,10,1631,5,848,12.0,580.0,580.0,5,783,12.0,515.0,515.0
0.004,6,10,2007,5,928,1.0,660.0,660.0,5,1079,1.0,811.0,811.0
0.005,6,10,2000,5,927,1.0,659.0,659.0,5,1073,1.0,805.0,805.0
0.004,6,10,1702,5,863,1.0,595.0,595.0,5,839,0.0,571.0,571.0
325.687,17,20,1124,10,716,36180.0,48.0,43.0,10,408,36180.0,20.0,12.0
0.005,6,10,2007,5,928,1.0,660.0,660.0,5,1079,1.0,811.0,811.0
0.001,17,2,180,1,66,0.0,38.0,38.0,1,114,0.0,86.0,86.0
0.008,6,10,1989,5,910,2.0,642.0,642.0,5,1079,2.0,811.0,811.0
0.005,17,2,164,1,74,0.0,46.0,46.0,1,90,0.0,62.0,62.0
0.005,6,13,3747,7,509,0.0,137.0,137.0,6,3238,0.0,1470.0,1459.0
0.007,6,10,1689,5,839,1.0,571.0,571.0,5,850,1.0,582.0,582.0
0.005,6,10,2007,5,928,1.0,660.0,660.0,5,1079,1.0,811.0,811.0
15.077,17,15,8411,8,6330,2149.0,1350.0,763.0,7,2081,2507.0,1350.0,269.0
0.016,6,13,3735,7,497,2.0,125.0,125.0,6,3238,3.0,1470.0,1459.0
0.02,6,10,1990,5,911,4.0,643.0,643.0,5,1079,4.0,811.0,811.0
0.009,6,13,3735,7,497,1.0,125.0,125.0,6,3238,1.0,1470.0,1459.0
240.1,6,16,4481,9,963,30012.0,238.0,166.0,7,3518,40016.0,1402.0,786.0
0.022,6,10,1972,5,910,5.0,642.0,642.0,5,1062,5.0,794.0,794.0
0.107,6,10,1506,5,395,24.0,127.0,127.0,5,1111,22.0,843.0,843.0
0.008,6,12,1926,6,1189,1.0,659.0,434.0,6,737,1.0,417.0,417.0
0.005,6,13,3690,7,452,0.0,80.0,80.0,6,3238,0.0,1470.0,1459.0
0.005,6,10,2006,5,927,1.0,659.0,659.0,5,1079,1.0,811.0,811.0
0.008,17,2,179,1,71,0.0,43.0,43.0,1,108,0.0,80.0,80.0
0.004,6,10,2006,5,927,1.0,659.0,659.0,5,1079,1.0,811.0,811.0
539.56,6,45,17671,24,5608,23459.0,1273.0,544.0,21,12063,23977.0,1402.0,913.0
0.009,17,2,148,1,60,0.0,32.0,32.0,1,88,0.0,60.0,60.0
0.005,6,10,1689,5,839,1.0,571.0,571.0,5,850,1.0,582.0,582.0
0.105,6,10,1506,5,395,19.0,127.0,127.0,5,1111,24.0,843.0,843.0
0.067,6,10,1506,5,395,14.0,127.0,127.0,5,1111,14.0,843.0,843.0
0.005,6,10,2000,5,927,1.0,659.0,659.0,5,1073,1.0,805.0,805.0
0.005,6,10,1547,5,764,1.0,496.0,496.0,5,783,1.0,515.0,515.0
0.098,6,10,1506,5,395,19.0,127.0,127.0,5,1111,22.0,843.0,843.0
0.001,17,2,180,1,66,0.0,38.0,38.0,1,114,0.0,86.0,86.0
0.075,6,10,1506,5,395,15.0,127.0,127.0,5,1111,16.0,843.0,843.0
0.015,6,10,1631,5,848,3.0,580.0,580.0,5,783,3.0,515.0,515.0
40.079,17,10,676,5,460,10019.0,104.0,64.0,5,216,10018.0,20.0,15.0
0.021,6,10,1989,5,910,5.0,642.0,642.0,5,1079,5.0,811.0,811.0
0.001,17,2,136,1,60,0.0,32.0,32.0,1,76,0.0,48.0,48.0
0.04,17,2,152,1,76,0.0,48.0,48.0,1,76,0.0,48.0,48.0
11.179,17,28,4422,14,1995,847.0,270.0,114.0,14,2427,847.0,586.0,145.0
0.042,17,2,156,1,64,0.0,36.0,36.0,1,92,0.0,64.0,64.0
0.043,17,2,152,1,76,0.0,48.0,48.0,1,76,0.0,48.0,48.0
0.001,17,2,180,1,66,0.0,38.0,38.0,1,114,0.0,86.0,86.0
40.064,17,10,676,5,460,10013.0,104.0,64.0,5,216,10015.0,20.0,15.0
0.082,6,10,1506,5,395,19.0,127.0,127.0,5,1111,18.0,843.0,843.0
0.001,17,2,140,1,62,0.0,34.0,34.0,1,78,0.0,50.0,50.0
0.007,17,2,179,1,71,0.0,43.0,43.0,1,108,0.0,80.0,80.0
0.129,6,10,1506,5,395,29.0,127.0,127.0,5,1111,29.0,843.0,843.0
0.001,17,2,180,1,66,0.0,38.0,38.0,1,114,0.0,86.0,86.0
0.016,6,10,1972,5,910,4.0,642.0,642.0,5,1062,4.0,794.0,794.0
0.005,6,14,3742,8,504,0.0,80.0,80.0,6,3238,0.0,1470.0,1459.0
0.018,6,10,1631,5,848,4.0,580.0,580.0,5,783,4.0,515.0,515.0
0.005,17,2,144,1,64,0.0,36.0,36.0,1,80,0.0,52.0,52.0
0.001,17,2,142,1,63,0.0,35.0,35.0,1,79,0.0,51.0,51.0
0.005,6,10,1547,5,764,1.0,496.0,496.0,5,783,1.0,515.0,515.0
0.366,17,63,46447,40,40449,9.0,1350.0,983.0,23,5998,13.0,1350.0,232.0
0.131,6,10,1506,5,395,23.0,127.0,127.0,5,1111,30.0,843.0,843.0
1772.611,17,120,11460,60,5460,30043.0,63.0,63.0,60,6000,30043.0,72.0,72.0
0.005,6,13,3747,7,509,0.0,137.0,137.0,6,3238,0.0,1470.0,1459.0
40.068,17,10,676,5,460,10016.0,104.0,64.0,5,216,10016.0,20.0,15.0
0.01,6,10,1972,5,910,2.0,642.0,642.0,5,1062,2.0,794.0,794.0
0.013,6,10,1983,5,910,3.0,642.0,642.0,5,1073,3.0,805.0,805.0
240.094,6,31,9427,15,6911,17149.0,2035.0,681.0,16,2516,16006.0,580.0,209.0
0.001,17,2,268,1,70,0.0,42.0,42.0,1,198,0.0,170.0,170.0
0.07,17,8,3613,4,1874,23.0,1350.0,440.0,4,1739,12.0,1350.0,406.0
0.081,6,10,1506,5,395,18.0,127.0,127.0,5,1111,17.0,843.0,843.0
353.279,6,20,2210,6,1308,12003.0,494.0,494.0,14,902,27175.0,83.0,83.0
0.067,6,10,1506,5,395,16.0,127.0,127.0,5,1111,14.0,843.0,843.0
0.212,6,10,1506,5,395,51.0,127.0,127.0,5,1111,50.0,843.0,843.0
0.003,17,2,136,1,60,0.0,32.0,32.0,1,76,0.0,48.0,48.0
0.108,6,10,1506,5,395,21.0,127.0,127.0,5,1111,23.0,843.0,843.0
0.006,6,10,1689,5,839,1.0,571.0,571.0,5,850,1.0,582.0,582.0
0.004,6,10,1989,5,927,1.0,659.0,659.0,5,1062,1.0,794.0,794.0
0.657,6,22,5852,10,1796,71.0,821.0,317.0,12,4056,58.0,1402.0,570.0
10.77,17,28,4422,14,1994,819.0,269.0,114.0,14,2428,819.0,587.0,145.0
178.313,17,84,11746,42,2804,4348.0,44.0,38.0,42,8942,4349.0,261.0,184.0
0.006,17,2,179,1,71,0.0,43.0,43.0,1,108,0.0,80.0,80.0
0.004,17,2,148,1,60,0.0,32.0,32.0,1,88,0.0,60.0,60.0
0.127,6,10,1506,5,395,29.0,127.0,127.0,5,1111,29.0,843.0,843.0
0.114,6,10,1506,5,395,28.0,127.0,127.0,5,1111,26.0,843.0,843.0
0.209,6,16,2776,8,1394,29.0,533.0,323.0,8,1382,19.0,529.0,239.0
0.014,6,10,1989,5,910,3.0,642.0,642.0,5,1079,3.0,811.0,811.0
0.024,6,10,1677,5,827,5.0,559.0,559.0,5,850,5.0,582.0,582.0
0.102,6,10,1506,5,395,20.0,127.0,127.0,5,1111,21.0,843.0,843.0
0.249,17,4,596,2,122,177.0,33.0,33.0,2,474,176.0,323.0,209.0
0.011,6,10,1972,5,910,2.0,642.0,642.0,5,1062,2.0,794.0,794.0
0.007,6,10,1989,5,910,1.0,642.0,642.0,5,1079,1.0,811.0,811.0
0.006,6,10,2007,5,928,1.0,660.0,660.0,5,1079,1.0,811.0,811.0
0.001,17,2,180,1,66,0.0,38.0,38.0,1,114,0.0,86.0,86.0
0.012,6,10,1983,5,910,2.0,642.0,642.0,5,1073,3.0,805.0,805.0
0.005,17,2,170,1,65,0.0,37.0,37.0,1,105,0.0,77.0,77.0
0.069,6,10,1506,5,395,15.0,127.0,127.0,5,1111,15.0,843.0,843.0
0.005,6,10,1989,5,927,1.0,659.0,659.0,5,1062,1.0,794.0,794.0
0.038,17,2,136,1,60,0.0,32.0,32.0,1,76,0.0,48.0,48.0
0.007,6,10,1547,5,764,1.0,496.0,496.0,5,783,1.0,515.0,515.0
0.007,6,10,1989,5,927,1.0,659.0,659.0,5,1062,1.0,794.0,794.0
11.175,17,28,4416,14,1993,847.0,268.0,114.0,14,2423,847.0,586.0,145.0
0.078,6,10,1506,5,395,16.0,127.0,127.0,5,1111,18.0,843.0,843.0
1762.292,6,552,190332,281,164323,6293.0,2883.0,941.0,271,26009,6526.0,580.0,116.0
11.488,17,28,4397,14,2312,871.0,587.0,137.0,14,2085,871.0,268.0,120.0
178.069,17,72,10138,36,2401,5087.0,44.0,38.0,36,7737,5087.0,239.0,186.0
0.001,17,2,179,1,62,0.0,34.0,34.0,1,117,0.0,89.0,89.0
24.94,58,3,216,2,144,24940.0,24.0,24.0,1,72,0.0,24.0,24.0
40.072,17,10,676,5,460,10011.0,104.0,64.0,5,216,10011.0,20.0,15.0
0.067,17,8,3613,4,1874,22.0,1350.0,440.0,4,1739,10.0,1350.0,406.0
0.006,6,10,2007,5,928,1.0,660.0,660.0,5,1079,1.0,811.0,811.0
240.082,6,16,4481,9,963,30010.0,238.0,166.0,7,3518,40013.0,1402.0,786.0
0.004,17,2,140,1,62,0.0,34.0,34.0,1,78,0.0,50.0,50.0
0.077,6,10,1506,5,395,15.0,127.0,127.0,5,1111,16.0,843.0,843.0
0.005,6,10,2000,5,927,1.0,659.0,659.0,5,1073,1.0,805.0,805.0
0.063,6,10,1506,5,395,13.0,127.0,127.0,5,1111,13.0,843.0,843.0
0.005,6,14,3742,7,452,0.0,80.0,80.0,7,3290,0.0,1448.0,972.0
0.239,6,10,1506,5,395,58.0,127.0,127.0,5,1111,40.0,843.0,843.0
0.012,6,10,1677,5,827,3.0,559.0,559.0,5,850,3.0,582.0,582.0
0.013,6,10,1989,5,910,3.0,642.0,642.0,5,1079,3.0,811.0,811.0
301.202,6,49,20840,26,14893,12048.0,2720.0,1256.0,23,5947,409.0,2667.0,385.0
0.001,17,2,180,1,66,0.0,38.0,38.0,1,114,0.0,86.0,86.0
0.075,6,10,1506,5,395,16.0,127.0,127.0,5,1111,17.0,843.0,843.0
0.039,17,2,396,1,61,0.0,33.0,33.0,1,335,0.0,307.0,307.0
0.005,17,2,140,1,62,0.0,34.0,34.0,1,78,0.0,50.0,50.0
10.862,17,28,4421,14,1994,825.0,269.0,114.0,14,2427,826.0,586.0,145.0
0.018,6,13,3735,7,497,3.0,125.0,125.0,6,3238,3.0,1470.0,1459.0
0.007,17,2,194,1,59,0.0,31.0,31.0,1,135,0.0,107.0,107.0
0.005,6,10,1547,5,764,1.0,496.0,496.0,5,783,1.0,515.0,515.0
0.088,6,10,1506,5,395,21.0,127.0,127.0,5,1111,18.0,843.0,843.0
0.007,6,13,3684,7,446,1.0,74.0,74.0,6,3238,1.0,1470.0,1459.0
0.004,6,10,2007,5,928,1.0,660.0,660.0,5,1079,1.0,811.0,811.0
0.12,6,10,1506,5,395,29.0,127.0,127.0,5,1111,25.0,843.0,843.0
0.005,6,10,2006,5,927,1.0,659.0,659.0,5,1079,1.0,811.0,811.0
308.491,17,20,1124,10,716,34262.0,48.0,43.0,10,408,34261.0,20.0,12.0
0.014,6,10,1983,5,910,3.0,642.0,642.0,5,1073,3.0,805.0,805.0
0.005,6,10,2006,5,927,1.0,659.0,659.0,5,1079,1.0,811.0,811.0
0.015,17,2,136,1,60,0.0,32.0,32.0,1,76,0.0,48.0,48.0
0.004,17,2,148,1,60,0.0,32.0,32.0,1,88,0.0,60.0,60.0
0.005,6,10,2006,5,927,1.0,659.0,659.0,5,1079,1.0,811.0,811.0
0.017,6,10,1631,5,848,4.0,580.0,580.0,5,783,4.0,515.0,515.0
289.751,6,330,345370,124,18003,2355.0,2736.0,889.0,206,327367,1413.0,2914.0,1649.0
0.005,6,10,1643,5,860,1.0,592.0,592.0,5,783,1.0,515.0,515.0
0.001,17,2,136,1,60,0.0,32.0,32.0,1,76,0.0,48.0,48.0
0.145,6,10,1506,5,395,34.0,127.0,127.0,5,1111,34.0,843.0,843.0
0.017,6,10,1989,5,910,4.0,642.0,642.0,5,1079,4.0,811.0,811.0
0.005,6,10,1774,5,923,1.0,655.0,655.0,5,851,1.0,583.0,583.0
0.009,6,10,1677,5,827,2.0,559.0,559.0,5,850,2.0,582.0,582.0
0.013,17,2,140,1,62,0.0,34.0,34.0,1,78,0.0,50.0,50.0
0.014,6,10,1990,5,911,3.0,643.0,643.0,5,1079,3.0,811.0,811.0
240.093,6,16,4481,9,963,30011.0,238.0,166.0,7,3518,40015.0,1402.0,786.0
0.013,6,14,3787,7,497,2.0,125.0,125.0,7,3290,2.0,1448.0,972.0
0.008,6,10,1989,5,910,1.0,642.0,642.0,5,1079,2.0,811.0,811.0
0.04,17,2,136,1,60,0.0,32.0,32.0,1,76,0.0,48.0,48.0
0.001,17,2,180,1,65,0.0,37.0,37.0,1,115,0.0,87.0,87.0
0.006,6,10,1689,5,839,1.0,571.0,571.0,5,850,1.0,582.0,582.0
0.014,6,10,1983,5,910,3.0,642.0,642.0,5,1073,3.0,805.0,805.0
0.005,17,2,144,1,64,0.0,36.0,36.0,1,80,0.0,52.0,52.0
0.085,6,10,1506,5,395,19.0,127.0,127.0,5,1111,17.0,843.0,843.0
0.016,6,10,1972,5,910,4.0,642.0,642.0,5,1062,4.0,794.0,794.0
0.009,6,10,1762,5,911,2.0,643.0,643.0,5,851,2.0,583.0,583.0
0.065,6,10,1506,5,395,14.0,127.0,127.0,5,1111,15.0,843.0,843.0
0.107,6,10,1506,5,395,22.0,127.0,127.0,5,1111,21.0,843.0,843.0
0.06,6,10,1506,5,395,14.0,127.0,127.0,5,1111,13.0,843.0,843.0
0.009,6,12,1926,6,1189,1.0,659.0,434.0,6,737,1.0,417.0,417.0
0.005,6,10,1547,5,764,1.0,496.0,496.0,5,783,1.0,515.0,515.0
40.06,17,10,676,5,460,10013.0,104.0,64.0,5,216,10014.0,20.0,15.0
0.001,17,2,180,1,66,0.0,38.0,38.0,1,114,0.0,86.0,86.0
0.074,6,10,1506,5,395,15.0,127.0,127.0,5,1111,15.0,843.0,843.0
0.121,6,10,1506,5,395,26.0,127.0,127.0,5,1111,26.0,843.0,843.0
0.005,6,10,1989,5,927,1.0,659.0,659.0,5,1062,1.0,794.0,794.0
0.017,6,10,1677,5,827,4.0,559.0,559.0,5,850,4.0,582.0,582.0
0.005,6,10,2000,5,927,1.0,659.0,659.0,5,1073,1.0,805.0,805.0
60.856,6,22,11817,12,5263,5532.0,2804.0,928.0,10,6554,6747.0,2111.0,1004.0
0.004,6,10,1774,5,923,1.0,655.0,655.0,5,851,1.0,583.0,583.0
0.003,17,2,234,1,61,0.0,33.0,33.0,1,173,0.0,145.0,145.0
11.202,17,28,4399,14,2312,852.0,587.0,137.0,14,2087,852.0,270.0,121.0
0.017,6,10,1990,5,911,4.0,643.0,643.0,5,1079,4.0,811.0,811.0
0.019,6,10,1990,5,911,4.0,643.0,643.0,5,1079,4.0,811.0,811.0
0.086,6,10,1506,5,395,18.0,127.0,127.0,5,1111,18.0,843.0,843.0
0.003,17,4,284,2,120,0.0,32.0,32.0,2,164,0.0,60.0,54.0
0.005,6,10,2007,5,928,1.0,660.0,660.0,5,1079,1.0,811.0,811.0
0.016,6,10,1983,5,910,3.0,642.0,642.0,5,1073,3.0,805.0,805.0
0.01,6,10,1762,5,911,2.0,643.0,643.0,5,851,2.0,583.0,583.0
0.084,6,10,1506,5,395,19.0,127.0,127.0,5,1111,17.0,843.0,843.0
0.006,17,2,180,1,66,0.0,38.0,38.0,1,114,0.0,86.0,86.0
130.931,6,22,7437,11,1305,130.0,530.0,277.0,11,6132,13075.0,2720.0,946.0
1790.381,6,607,199242,311,166716,5775.0,2883.0,870.0,296,32526,6069.0,1666.0,148.0
0.008,6,10,1989,5,910,1.0,642.0,642.0,5,1079,2.0,811.0,811.0
0.012,6,10,1990,5,911,3.0,643.0,643.0,5,1079,2.0,811.0,811.0
0.005,17,2,154,1,69,0.0,41.0,41.0,1,85,0.0,57.0,57.0
0.005,17,2,164,1,74,0.0,46.0,46.0,1,90,0.0,62.0,62.0
0.083,6,10,1506,5,395,20.0,127.0,127.0,5,1111,20.0,843.0,843.0
0.107,6,10,1506,5,395,26.0,127.0,127.0,5,1111,25.0,843.0,843.0
0.008,6,10,1972,5,910,1.0,642.0,642.0,5,1062,1.0,794.0,794.0
0.096,6,10,1506,5,395,22.0,127.0,127.0,5,1111,20.0,843.0,843.0
0.005,6,10,1989,5,927,1.0,659.0,659.0,5,1062,1.0,794.0,794.0
11.122,17,28,4422,14,1994,842.0,269.0,114.0,14,2428,843.0,587.0,145.0
0.006,6,10,1547,5,764,1.0,496.0,496.0,5,783,1.0,515.0,515.0
10.811,17,28,4421,14,1994,823.0,269.0,114.0,14,2427,823.0,586.0,145.0
0.013,6,10,1990,5,911,3.0,643.0,643.0,5,1079,3.0,811.0,811.0
0.006,6,10,1547,5,764,1.0,496.0,496.0,5,783,1.0,515.0,515.0
0.005,6,10,2007,5,928,1.0,660.0,660.0,5,1079,1.0,811.0,811.0
40.057,17,10,676,5,460,10013.0,104.0,64.0,5,216,10013.0,20.0,15.0
0.005,6,10,2006,5,927,1.0,659.0,659.0,5,1079,1.0,811.0,811.0
0.005,6,10,2006,5,927,1.0,659.0,659.0,5,1079,1.0,811.0,811.0
0.005,6,10,2006,5,927,1.0,659.0,659.0,5,1079,1.0,811.0,811.0
0.01,6,10,1990,5,911,2.0,643.0,643.0,5,1079,2.0,811.0,811.0
0.016,6,10,1989,5,910,3.0,642.0,642.0,5,1079,4.0,811.0,811.0
0.092,6,10,1506,5,395,20.0,127.0,127.0,5,1111,20.0,843.0,843.0
0.106,6,10,1506,5,395,22.0,127.0,127.0,5,1111,24.0,843.0,843.0
0.138,6,10,1506,5,395,31.0,127.0,127.0,5,1111,30.0,843.0,843.0
353.56,6,20,2210,6,1308,12004.0,494.0,494.0,14,902,27196.0,83.0,83.0
0.012,6,10,1990,5,911,2.0,643.0,643.0,5,1079,3.0,811.0,811.0
0.12,6,10,1506,5,395,24.0,127.0,127.0,5,1111,24.0,843.0,843.0
0.004,6,10,1989,5,927,1.0,659.0,659.0,5,1062,1.0,794.0,794.0
0.018,6,10,1972,5,910,4.0,642.0,642.0,5,1062,4.0,794.0,794.0
0.012,6,10,1972,5,910,3.0,642.0,642.0,5,1062,3.0,794.0,794.0
0.005,17,2,166,1,75,0.0,47.0,47.0,1,91,0.0,63.0,63.0
10.717,17,26,4101,13,1845,884.0,268.0,113.0,13,2256,884.0,587.0,145.0
0.137,6,10,1506,5,395,32.0,127.0,127.0,5,1111,32.0,843.0,843.0
0.027,6,10,1989,5,910,6.0,642.0,642.0,5,1079,6.0,811.0,811.0
240.087,6,28,6960,14,4640,18468.0,1368.0,489.0,14,2320,18468.0,580.0,198.0
0.084,6,10,1506,5,395,16.0,127.0,127.0,5,1111,17.0,843.0,843.0
0.011,6,10,1989,5,910,2.0,642.0,642.0,5,1079,2.0,811.0,811.0
0.005,6,10,1989,5,927,1.0,659.0,659.0,5,1062,1.0,794.0,794.0
0.011,6,10,1631,5,848,2.0,580.0,580.0,5,783,2.0,515.0,515.0
0.12,6,10,1506,5,395,28.0,127.0,127.0,5,1111,28.0,843.0,843.0
0.004,17,2,152,1,76,0.0,48.0,48.0,1,76,0.0,48.0,48.0
0.006,6,10,1643,5,860,1.0,592.0,592.0,5,783,1.0,515.0,515.0
0.06,6,10,1506,5,395,12.0,127.0,127.0,5,1111,14.0,843.0,843.0
0.005,6,10,1989,5,927,1.0,659.0,659.0,5,1062,1.0,794.0,794.0
40.074,17,10,676,5,460,10016.0,104.0,64.0,5,216,10017.0,20.0,15.0
40.057,17,10,676,5,460,10011.0,104.0,64.0,5,216,10013.0,20.0,15.0
0.097,6,10,1506,5,395,19.0,127.0,127.0,5,1111,21.0,843.0,843.0
0.012,6,10,1631,5,848,3.0,580.0,580.0,5,783,3.0,515.0,515.0
0.009,6,10,1983,5,910,2.0,642.0,642.0,5,1073,2.0,805.0,805.0
0.005,6,10,2007,5,928,1.0,660.0,660.0,5,1079,1.0,811.0,811.0
0.039,17,4,284,2,120,0.0,32.0,32.0,2,164,36.0,60.0,54.0
0.001,17,2,180,1,66,0.0,38.0,38.0,1,114,0.0,86.0,86.0
0.059,17,2,80,1,32,0.0,4.0,4.0,1,48,0.0,20.0,20.0
0.005,6,10,2006,5,927,1.0,659.0,659.0,5,1079,1.0,811.0,811.0
0.01,6,10,1990,5,911,2.0,643.0,643.0,5,1079,2.0,811.0,811.0
0.016,6,10,1972,5,910,4.0,642.0,642.0,5,1062,4.0,794.0,794.0
0.058,6,10,1506,5,395,12.0,127.0,127.0,5,1111,12.0,843.0,843.0
0.005,6,10,2007,5,928,1.0,660.0,660.0,5,1079,1.0,811.0,811.0
0.005,6,10,1989,5,927,1.0,659.0,659.0,5,1062,1.0,794.0,794.0
0.005,6,10,2007,5,928,1.0,660.0,660.0,5,1079,1.0,811.0,811.0
0.008,6,10,1990,5,911,1.0,643.0,643.0,5,1079,2.0,811.0,811.0
0.006,6,10,1547,5,764,1.0,496.0,496.0,5,783,1.0,515.0,515.0
0.006,6,10,1854,5,889,1.0,621.0,621.0,5,965,1.0,697.0,697.0
308.244,17,18,1008,9,640,38514.0,48.0,43.0,9,368,38514.0,20.0,12.0
10.844,17,28,4423,14,1994,825.0,269.0,114.0,14,2429,825.0,588.0,145.0
1769.124,17,92,8096,46,4048,39313.0,60.0,60.0,46,4048,39313.0,60.0,60.0
0.013,6,10,1762,5,911,3.0,643.0,643.0,5,851,3.0,583.0,583.0
0.004,6,10,2006,5,927,1.0,659.0,659.0,5,1079,1.0,811.0,811.0
0.013,6,10,1972,5,910,3.0,642.0,642.0,5,1062,3.0,794.0,794.0
0.013,6,10,1762,5,911,3.0,643.0,643.0,5,851,3.0,583.0,583.0
0.006,6,10,1547,5,764,1.0,496.0,496.0,5,783,1.0,515.0,515.0
0.01,6,10,1983,5,910,2.0,642.0,642.0,5,1073,2.0,805.0,805.0
40.056,17,10,676,5,460,10013.0,104.0,64.0,5,216,10013.0,20.0,15.0
0.013,17,2,152,1,56,0.0,28.0,28.0,1,96,0.0,68.0,68.0
11.232,17,28,4422,14,1993,850.0,268.0,114.0,14,2429,851.0,588.0,145.0
0.005,6,13,3747,7,509,0.0,137.0,137.0,6,3238,0.0,1470.0,1459.0
0.005,6,14,3799,7,509,0.0,137.0,137.0,7,3290,0.0,1448.0,972.0
0.001,17,2,180,1,66,0.0,38.0,38.0,1,114,0.0,86.0,86.0
0.109,6,10,1506,5,395,25.0,127.0,127.0,5,1111,24.0,843.0,843.0
0.19,17,2,194,1,59,0.0,31.0,31.0,1,135,0.0,107.0,107.0
0.005,6,10,1689,5,839,1.0,571.0,571.0,5,850,1.0,582.0,582.0
0.006,6,10,1547,5,764,1.0,496.0,496.0,5,783,1.0,515.0,515.0
300.328,6,16,2170,9,684,37519.0,146.0,146.0,7,1486,50026.0,419.0,398.0
0.007,6,10,1989,5,927,1.0,659.0,659.0,5,1062,1.0,794.0,794.0
0.006,6,10,2006,5,927,1.0,659.0,659.0,5,1079,1.0,811.0,811.0
0.007,17,2,194,1,59,0.0,31.0,31.0,1,135,0.0,107.0,107.0
0.006,6,10,2006,5,927,1.0,659.0,659.0,5,1079,1.0,811.0,811.0
0.003,17,2,136,1,60,0.0,32.0,32.0,1,76,0.0,48.0,48.0
0.132,6,10,1506,5,395,24.0,127.0,127.0,5,1111,19.0,843.0,843.0
0.004,6,10,1989,5,927,1.0,659.0,659.0,5,1062,1.0,794.0,794.0
0.004,6,10,1779,5,928,1.0,660.0,660.0,5,851,1.0,583.0,583.0
0.025,6,10,1983,5,910,6.0,642.0,642.0,5,1073,6.0,805.0,805.0
0.039,17,2,170,1,65,0.0,37.0,37.0,1,105,0.0,77.0,77.0
0.202,17,15,8612,8,6025,28.0,1350.0,725.0,7,2587,20.0,1350.0,341.0
377.556,6,24,2405,17,919,23597.0,195.0,195.0,7,1486,3905.0,419.0,398.0
0.098,6,10,1506,5,395,23.0,127.0,127.0,5,1111,23.0,843.0,843.0
0.24,17,2,152,1,76,0.0,48.0,48.0,1,76,0.0,48.0,48.0
0.008,17,2,194,1,59,0.0,31.0,31.0,1,135,0.0,107.0,107.0
0.107,6,10,1506,5,395,25.0,127.0,127.0,5,1111,24.0,843.0,843.0
0.038,17,2,148,1,60,0.0,32.0,32.0,1,88,0.0,60.0,60.0
0.012,6,10,1631,5,848,3.0,580.0,580.0,5,783,2.0,515.0,515.0
0.01,6,10,1990,5,911,2.0,643.0,643.0,5,1079,2.0,811.0,811.0
0.004,6,10,2000,5,927,1.0,659.0,659.0,5,1073,1.0,805.0,805.0
0.017,17,2,294,1,64,0.0,36.0,36.0,1,230,0.0,202.0,202.0
0.005,6,14,3799,7,509,0.0,137.0,137.0,7,3290,0.0,1448.0,972.0
300.209,6,40,12493,21,6935,15002.0,2720.0,1010.0,19,5558,16669.0,2667.0,435.0
0.003,17,2,152,1,76,0.0,48.0,48.0,1,76,0.0,48.0,48.0
0.103,6,10,1506,5,395,23.0,127.0,127.0,5,1111,23.0,843.0,843.0
1.822,6,38,6839,21,3555,91.0,1103.0,204.0,17,3284,106.0,1402.0,340.0
0.017,6,10,1677,5,827,4.0,559.0,559.0,5,850,4.0,582.0,582.0
0.092,6,10,1506,5,395,20.0,127.0,127.0,5,1111,21.0,843.0,843.0
0.005,6,10,2006,5,927,1.0,659.0,659.0,5,1079,1.0,811.0,811.0
0.01,6,10,1990,5,911,2.0,643.0,643.0,5,1079,2.0,811.0,811.0
0.004,6,10,2006,5,927,1.0,659.0,659.0,5,1079,1.0,811.0,811.0
0.005,6,10,2000,5,927,1.0,659.0,659.0,5,1073,1.0,805.0,805.0
0.003,17,2,136,1,60,0.0,32.0,32.0,1,76,0.0,48.0,48.0
0.067,6,10,1506,5,395,14.0,127.0,127.0,5,1111,15.0,843.0,843.0
0.104,6,10,1506,5,395,25.0,127.0,127.0,5,1111,25.0,843.0,843.0
11.199,17,28,4422,14,1995,848.0,270.0,114.0,14,2427,848.0,586.0,145.0
173.064,17,76,10624,38,2528,4677.0,44.0,38.0,38,8096,4677.0,239.0,185.0
0.005,17,2,164,1,74,0.0,46.0,46.0,1,90,0.0,62.0,62.0
0.013,6,10,1989,5,910,3.0,642.0,642.0,5,1079,3.0,811.0,811.0
0.117,6,10,1506,5,395,24.0,127.0,127.0,5,1111,23.0,843.0,843.0
0.096,6,10,1506,5,395,21.0,127.0,127.0,5,1111,23.0,843.0,843.0
0.019,6,10,1677,5,827,4.0,559.0,559.0,5,850,4.0,582.0,582.0
0.04,17,2,156,1,64,0.0,36.0,36.0,1,92,0.0,64.0,64.0
0.006,17,2,212,1,74,0.0,46.0,46.0,1,138,0.0,110.0,110.0
1770.306,6,83,4368,42,2210,43177.0,26.0,26.0,41,2158,44256.0,26.0,26.0
0.005,6,10,1547,5,764,1.0,496.0,496.0,5,783,1.0,515.0,515.0
0.003,17,2,148,1,60,0.0,32.0,32.0,1,88,0.0,60.0,60.0
0.011,6,10,1972,5,910,2.0,642.0,642.0,5,1062,2.0,794.0,794.0
0.005,6,10,2006,5,927,1.0,659.0,659.0,5,1079,1.0,811.0,811.0
0.008,6,13,3735,7,497,1.0,125.0,125.0,6,3238,1.0,1470.0,1459.0
0.08,6,10,1506,5,395,17.0,127.0,127.0,5,1111,17.0,843.0,843.0
0.014,6,10,1989,5,910,3.0,642.0,642.0,5,1079,3.0,811.0,811.0
368.707,6,22,2313,16,867,24580.0,195.0,195.0,6,1446,4635.0,419.0,398.0
0.1,6,10,1506,5,395,22.0,127.0,127.0,5,1111,20.0,843.0,843.0
0.094,6,10,1506,5,395,22.0,127.0,127.0,5,1111,20.0,843.0,843.0
0.003,17,2,148,1,60,0.0,32.0,32.0,1,88,0.0,60.0,60.0
0.014,6,10,1990,5,911,3.0,643.0,643.0,5,1079,3.0,811.0,811.0
333.672,17,20,1124,10,716,37067.0,48.0,43.0,10,408,37067.0,20.0,12.0
0.01,6,10,1989,5,910,2.0,642.0,642.0,5,1079,2.0,811.0,811.0
0.007,6,10,1989,5,910,1.0,642.0,642.0,5,1079,1.0,811.0,811.0
0.008,6,10,1631,5,848,2.0,580.0,580.0,5,783,2.0,515.0,515.0
0.006,6,10,1547,5,764,1.0,496.0,496.0,5,783,1.0,515.0,515.0
0.077,6,10,1506,5,395,17.0,127.0,127.0,5,1111,15.0,843.0,843.0
5.243,6,24,7042,14,1879,403.0,801.0,282.0,10,5163,582.0,1925.0,774.0
0.041,17,2,156,1,64,0.0,36.0,36.0,1,92,0.0,64.0,64.0
0.005,6,10,1643,5,860,1.0,592.0,592.0,5,783,1.0,515.0,515.0
0.006,17,2,212,1,74,0.0,46.0,46.0,1,138,0.0,110.0,110.0
0.108,6,10,1506,5,395,24.0,127.0,127.0,5,1111,26.0,843.0,843.0
0.005,17,2,146,1,65,0.0,37.0,37.0,1,81,0.0,53.0,53.0
0.009,6,10,1989,5,910,2.0,642.0,642.0,5,1079,2.0,811.0,811.0
0.005,6,10,2006,5,927,1.0,659.0,659.0,5,1079,1.0,811.0,811.0
0.098,6,10,1506,5,395,17.0,127.0,127.0,5,1111,22.0,843.0,843.0
0.01,6,10,1989,5,910,2.0,642.0,642.0,5,1079,2.0,811.0,811.0
0.004,17,2,148,1,60,0.0,32.0,32.0,1,88,0.0,60.0,60.0
0.005,6,10,2006,5,927,1.0,659.0,659.0,5,1079,1.0,811.0,811.0
0.01,6,10,1990,5,911,2.0,643.0,643.0,5,1079,2.0,811.0,811.0
0.037,17,2,136,1,60,0.0,32.0,32.0,1,76,0.0,48.0,48.0
0.518,17,58,38816,34,31336,15.0,1350.0,893.0,24,7480,19.0,1350.0,283.0
0.021,6,10,1989,5,910,5.0,642.0,642.0,5,1079,5.0,811.0,811.0
0.04,17,2,412,1,61,0.0,33.0,33.0,1,351,0.0,323.0,323.0
0.005,6,10,2007,5,928,1.0,660.0,660.0,5,1079,1.0,811.0,811.0
125.97,6,14,2938,8,2504,17962.0,1414.0,1086.0,6,434,25146.0,182.0,182.0
11.175,17,28,4421,14,1994,847.0,269.0,114.0,14,2427,847.0,586.0,145.0
0.005,6,10,2007,5,928,1.0,660.0,660.0,5,1079,1.0,811.0,811.0
0.013,6,10,1990,5,911,3.0,643.0,643.0,5,1079,3.0,811.0,811.0
0.006,6,10,1689,5,839,1.0,571.0,571.0,5,850,1.0,582.0,582.0
0.096,6,10,1506,5,395,22.0,127.0,127.0,5,1111,20.0,843.0,843.0
0.004,6,10,1779,5,928,1.0,660.0,660.0,5,851,1.0,583.0,583.0
0.053,17,2,152,1,76,0.0,48.0,48.0,1,76,0.0,48.0,48.0
0.005,6,10,2006,5,927,1.0,659.0,659.0,5,1079,1.0,811.0,811.0
10.821,17,28,4423,14,1995,823.0,270.0,114.0,14,2428,823.0,587.0,145.0
0.012,6,10,1990,5,911,3.0,643.0,643.0,5,1079,3.0,811.0,811.0
0.01,6,10,1989,5,910,2.0,642.0,642.0,5,1079,2.0,811.0,811.0
0.005,6,10,1854,5,889,1.0,621.0,621.0,5,965,1.0,697.0,697.0
11.082,17,28,4420,14,1993,839.0,268.0,114.0,14,2427,839.0,586.0,145.0
15.07,17,15,9239,8,6902,2148.0,1350.0,834.0,7,2337,2506.0,1350.0,305.0
0.005,6,10,1702,5,863,1.0,595.0,595.0,5,839,1.0,571.0,571.0
1778.351,17,144,45504,72,22752,25035.0,288.0,288.0,72,22752,25036.0,288.0,288.0
0.013,6,10,1989,5,910,3.0,642.0,642.0,5,1079,3.0,811.0,811.0
0.009,6,10,1972,5,910,2.0,642.0,642.0,5,1062,2.0,794.0,794.0
0.011,6,10,1989,5,910,2.0,642.0,642.0,5,1079,2.0,811.0,811.0
9.035,17,6,376,5,280,2258.0,28.0,28.0,1,96,0.0,68.0,68.0
0.004,17,2,148,1,60,0.0,32.0,32.0,1,88,0.0,60.0,60.0
0.026,6,10,1989,5,910,6.0,642.0,642.0,5,1079,6.0,811.0,811.0
0.011,6,10,1989,5,910,2.0,642.0,642.0,5,1079,2.0,811.0,811.0
0.005,6,10,1989,5,927,1.0,659.0,659.0,5,1062,1.0,794.0,794.0
0.005,6,10,2000,5,927,1.0,659.0,659.0,5,1073,1.0,805.0,805.0
360.052,6,22,4033,13,3142,30004.0,494.0,494.0,9,891,45006.0,83.0,83.0
0.001,17,2,180,1,66,0.0,38.0,38.0,1,114,0.0,86.0,86.0
176.398,17,84,12171,42,2804,4302.0,44.0,38.0,42,9367,4302.0,261.0,195.0
1778.646,17,143,45188,72,22752,25050.0,288.0,288.0,71,22436,25409.0,288.0,288.0
0.005,6,10,1689,5,839,1.0,571.0,571.0,5,850,1.0,582.0,582.0
0.005,6,10,1854,5,889,1.0,621.0,621.0,5,965,1.0,697.0,697.0
40.063,17,10,676,5,460,10015.0,104.0,64.0,5,216,10014.0,20.0,15.0
0.038,17,2,412,1,61,0.0,33.0,33.0,1,351,0.0,323.0,323.0
0.005,17,2,193,1,71,0.0,43.0,43.0,1,122,0.0,94.0,94.0
10.823,17,28,4423,14,1994,824.0,269.0,114.0,14,2429,824.0,588.0,145.0
0.005,6,10,2006,5,927,1.0,659.0,659.0,5,1079,1.0,811.0,811.0
0.004,6,10,2007,5,928,1.0,660.0,660.0,5,1079,1.0,811.0,811.0
0.005,17,2,170,1,65,0.0,37.0,37.0,1,105,0.0,77.0,77.0
0.073,6,10,1506,5,395,16.0,127.0,127.0,5,1111,17.0,843.0,843.0
0.004,6,10,2007,5,928,1.0,660.0,660.0,5,1079,1.0,811.0,811.0
0.005,17,2,170,1,65,0.0,37.0,37.0,1,105,0.0,77.0,77.0
0.094,6,10,1506,5,395,20.0,127.0,127.0,5,1111,20.0,843.0,843.0
0.007,6,14,3736,7,446,1.0,74.0,74.0,7,3290,1.0,1448.0,972.0
1778.207,17,142,41232,72,22752,25045.0,288.0,288.0,70,18480,25771.0,236.0,236.0
0.01,6,10,1972,5,910,2.0,642.0,642.0,5,1062,2.0,794.0,794.0
40.08,17,10,676,5,460,10019.0,104.0,64.0,5,216,10016.0,20.0,15.0
40.068,17,10,676,5,460,10014.0,104.0,64.0,5,216,10016.0,20.0,15.0
0.002,17,2,180,1,66,0.0,38.0,38.0,1,114,0.0,86.0,86.0
0.007,6,10,2006,5,927,1.0,659.0,659.0,5,1079,1.0,811.0,811.0
11.122,17,28,4422,14,1994,843.0,269.0,114.0,14,2428,843.0,587.0,145.0
0.005,17,2,132,1,58,0.0,30.0,30.0,1,74,0.0,46.0,46.0
0.018,6,10,1677,5,827,4.0,559.0,559.0,5,850,4.0,582.0,582.0
0.005,6,10,1689,5,839,1.0,571.0,571.0,5,850,1.0,582.0,582.0
0.01,6,10,1989,5,910,2.0,642.0,642.0,5,1079,2.0,811.0,811.0
0.015,6,10,1990,5,911,3.0,643.0,643.0,5,1079,3.0,811.0,811.0
0.044,17,2,148,1,60,0.0,32.0,32.0,1,88,0.0,60.0,60.0
0.008,6,10,1983,5,910,2.0,642.0,642.0,5,1073,2.0,805.0,805.0
0.014,6,10,1983,5,910,3.0,642.0,642.0,5,1073,3.0,805.0,805.0
0.127,6,10,1506,5,395,30.0,127.0,127.0,5,1111,26.0,843.0,843.0
40.062,17,10,676,5,460,10014.0,104.0,64.0,5,216,10014.0,20.0,15.0
40.082,17,10,676,5,460,10019.0,104.0,64.0,5,216,10019.0,20.0,15.0
0.079,6,10,1506,5,395,17.0,127.0,127.0,5,1111,15.0,843.0,843.0
1779.644,17,143,45188,72,22752,25064.0,288.0,288.0,71,22436,25422.0,288.0,288.0
0.005,6,10,1989,5,927,1.0,659.0,659.0,5,1062,1.0,794.0,794.0
40.069,17,10,676,5,460,10014.0,104.0,64.0,5,216,10016.0,20.0,15.0
0.005,6,10,1779,5,928,1.0,660.0,660.0,5,851,1.0,583.0,583.0
0.005,17,2,170,1,65,0.0,37.0,37.0,1,105,0.0,77.0,77.0
0.004,6,10,2007,5,928,1.0,660.0,660.0,5,1079,1.0,811.0,811.0
0.004,6,10,2007,5,928,1.0,660.0,660.0,5,1079,1.0,811.0,811.0
0.006,17,2,170,1,65,0.0,37.0,37.0,1,105,0.0,77.0,77.0
0.006,17,2,140,1,62,0.0,34.0,34.0,1,78,0.0,50.0,50.0
0.09,6,10,1506,5,395,20.0,127.0,127.0,5,1111,21.0,843.0,843.0
0.086,6,10,1506,5,395,20.0,127.0,127.0,5,1111,17.0,843.0,843.0
0.013,17,2,152,1,56,0.0,28.0,28.0,1,96,0.0,68.0,68.0
0.006,6,10,2006,5,927,1.0,659.0,659.0,5,1079,1.0,811.0,811.0
40.082,17,10,676,5,460,10019.0,104.0,64.0,5,216,10019.0,20.0,15.0
0.011,6,13,3735,7,497,1.0,125.0,125.0,6,3238,2.0,1470.0,1459.0
0.01,6,10,1990,5,911,2.0,643.0,643.0,5,1079,2.0,811.0,811.0
0.007,6,10,1547,5,764,1.0,496.0,496.0,5,783,1.0,515.0,515.0
0.016,6,10,1972,5,910,4.0,642.0,642.0,5,1062,4.0,794.0,794.0
40.069,17,10,676,5,460,10015.0,104.0,64.0,5,216,10016.0,20.0,15.0
0.085,6,10,1506,5,395,19.0,127.0,127.0,5,1111,19.0,843.0,843.0
0.005,6,14,3742,7,452,0.0,80.0,80.0,7,3290,0.0,1448.0,972.0
0.004,6,10,2006,5,927,1.0,659.0,659.0,5,1079,1.0,811.0,811.0
240.1,6,31,9423,15,7016,17150.0,2142.0,693.0,16,2407,16006.0,580.0,195.0
0.006,6,10,2006,5,927,1.0,659.0,659.0,5,1079,1.0,811.0,811.0
0.006,17,2,154,1,69,0.0,41.0,41.0,1,85,0.0,57.0,57.0
309.785,17,20,1124,10,716,34406.0,48.0,43.0,10,408,34406.0,20.0,12.0
301.009,6,49,19814,26,13855,12040.0,2720.0,1278.0,23,5959,401.0,2667.0,385.0
0.001,17,2,166,1,75,0.0,47.0,47.0,1,91,0.0,63.0,63.0
0.08,6,10,1506,5,395,17.0,127.0,127.0,5,1111,18.0,843.0,843.0
0.09,6,10,1506,5,395,18.0,127.0,127.0,5,1111,20.0,843.0,843.0
0.087,6,10,1506,5,395,19.0,127.0,127.0,5,1111,20.0,843.0,843.0
0.009,6,10,1989,5,910,2.0,642.0,642.0,5,1079,2.0,811.0,811.0
1777.956,17,142,44872,72,22752,25040.0,288.0,288.0,70,22120,25758.0,288.0,288.0
0.019,6,14,3787,7,497,3.0,125.0,125.0,7,3290,3.0,1448.0,972.0
0.005,17,2,169,1,62,0.0,34.0,34.0,1,107,0.0,79.0,79.0
0.004,6,10,2006,5,927,1.0,659.0,659.0,5,1079,1.0,811.0,811.0
0.005,6,10,1779,5,928,1.0,660.0,660.0,5,851,1.0,583.0,583.0
0.075,6,10,1506,5,395,14.0,127.0,127.0,5,1111,17.0,843.0,843.0
0.008,17,2,140,1,62,0.0,34.0,34.0,1,78,0.0,50.0,50.0
0.004,6,10,2006,5,927,1.0,659.0,659.0,5,1079,1.0,811.0,811.0
0.007,6,10,2007,5,928,1.0,660.0,660.0,5,1079,1.0,811.0,811.0
0.009,6,10,1989,5,910,2.0,642.0,642.0,5,1079,2.0,811.0,811.0
0.124,6,10,1506,5,395,24.0,127.0,127.0,5,1111,28.0,843.0,843.0
0.005,6,13,3747,7,509,0.0,137.0,137.0,6,3238,0.0,1470.0,1459.0
0.092,6,10,1506,5,395,19.0,127.0,127.0,5,1111,22.0,843.0,843.0
0.004,17,2,136,1,60,0.0,32.0,32.0,1,76,0.0,48.0,48.0
0.001,17,2,180,1,66,0.0,38.0,38.0,1,114,0.0,86.0,86.0
0.005,6,10,2006,5,927,1.0,659.0,659.0,5,1079,1.0,811.0,811.0
0.115,6,10,1506,5,395,26.0,127.0,127.0,5,1111,24.0,843.0,843.0
0.004,6,10,2006,5,927,1.0,659.0,659.0,5,1079,1.0,811.0,811.0
0.01,6,10,1762,5,911,2.0,643.0,643.0,5,851,2.0,583.0,583.0
0.017,6,10,1631,5,848,4.0,580.0,580.0,5,783,4.0,515.0,515.0
0.005,6,10,1779,5,928,1.0,660.0,660.0,5,851,1.0,583.0,583.0
0.116,6,10,1506,5,395,27.0,127.0,127.0,5,1111,20.0,843.0,843.0
0.006,6,12,1698,6,863,1.0,327.0,271.0,6,835,1.0,515.0,515.0
0.005,6,10,2006,5,927,1.0,659.0,659.0,5,1079,1.0,811.0,811.0
0.011,6,10,1677,5,827,2.0,559.0,559.0,5,850,2.0,582.0,582.0
0.004,17,2,136,1,60,0.0,32.0,32.0,1,76,0.0,48.0,48.0
0.002,17,2,180,1,66,0.0,38.0,38.0,1,114,0.0,86.0,86.0
0.005,17,2,212,1,74,0.0,46.0,46.0,1,138,0.0,110.0,110.0
0.13,6,10,1506,5,395,30.0,127.0,127.0,5,1111,29.0,843.0,843.0
0.005,6,10,1547,5,764,1.0,496.0,496.0,5,783,1.0,515.0,515.0
0.122,6,10,1506,5,395,29.0,127.0,127.0,5,1111,26.0,843.0,843.0
0.009,6,10,1989,5,910,2.0,642.0,642.0,5,1079,2.0,811.0,811.0
0.005,6,10,2000,5,927,1.0,659.0,659.0,5,1073,1.0,805.0,805.0
0.038,17,2,152,1,76,0.0,48.0,48.0,1,76,0.0,48.0,48.0
0.153,6,10,1506,5,395,33.0,127.0,127.0,5,1111,33.0,843.0,843.0
0.088,6,10,1506,5,395,21.0,127.0,127.0,5,1111,20.0,843.0,843.0
0.001,17,2,142,1,63,0.0,35.0,35.0,1,79,0.0,51.0,51.0
0.005,6,10,1989,5,927,1.0,659.0,659.0,5,1062,1.0,794.0,794.0
0.025,6,10,1983,5,910,6.0,642.0,642.0,5,1073,6.0,805.0,805.0
0.008,6,13,3735,7,497,1.0,125.0,125.0,6,3238,1.0,1470.0,1459.0
0.003,17,4,284,2,120,0.0,32.0,32.0,2,164,0.0,60.0,54.0
0.107,6,10,1506,5,395,22.0,127.0,127.0,5,1111,22.0,843.0,843.0
0.058,17,2,182,1,65,0.0,37.0,37.0,1,117,0.0,89.0,89.0
280.716,6,23,6075,10,1186,31190.0,267.0,156.0,13,4889,23382.0,1400.0,873.0
0.011,6,10,1983,5,910,2.0,642.0,642.0,5,1073,2.0,805.0,805.0
0.004,6,10,2006,5,927,1.0,659.0,659.0,5,1079,1.0,811.0,811.0
0.043,17,2,152,1,76,0.0,48.0,48.0,1,76,0.0,48.0,48.0
0.005,17,2,136,1,60,0.0,32.0,32.0,1,76,0.0,48.0,48.0
0.102,6,10,1506,5,395,21.0,127.0,127.0,5,1111,22.0,843.0,843.0
0.021,6,10,1972,5,910,5.0,642.0,642.0,5,1062,5.0,794.0,794.0
0.07,17,8,3613,4,1874,23.0,1350.0,440.0,4,1739,11.0,1350.0,406.0
0.016,6,10,1990,5,911,4.0,643.0,643.0,5,1079,3.0,811.0,811.0
0.004,6,10,2000,5,927,1.0,659.0,659.0,5,1073,1.0,805.0,805.0
0.012,6,10,1989,5,910,2.0,642.0,642.0,5,1079,3.0,811.0,811.0
40.082,17,10,676,5,460,10016.0,104.0,64.0,5,216,10018.0,20.0,15.0
0.007,6,10,1643,5,860,1.0,592.0,592.0,5,783,1.0,515.0,515.0
0.013,6,10,1983,5,910,3.0,642.0,642.0,5,1073,3.0,805.0,805.0
0.006,6,10,1989,5,927,1.0,659.0,659.0,5,1062,1.0,794.0,794.0
0.001,17,2,180,1,66,0.0,38.0,38.0,1,114,0.0,86.0,86.0
0.005,6,10,1774,5,923,1.0,655.0,655.0,5,851,1.0,583.0,583.0
0.001,17,2,180,1,66,0.0,38.0,38.0,1,114,0.0,86.0,86.0
0.004,6,10,1989,5,927,1.0,659.0,659.0,5,1062,1.0,794.0,794.0
0.013,6,10,1972,5,910,3.0,642.0,642.0,5,1062,3.0,794.0,794.0
0.04,17,2,170,1,65,0.0,37.0,37.0,1,105,0.0,77.0,77.0
0.01,6,10,1989,5,910,2.0,642.0,642.0,5,1079,2.0,811.0,811.0
0.008,6,10,1972,5,910,2.0,642.0,642.0,5,1062,1.0,794.0,794.0
11.025,17,26,4102,13,1823,909.0,270.0,112.0,13,2279,909.0,586.0,147.0
0.005,6,10,2006,5,927,1.0,659.0,659.0,5,1079,1.0,811.0,811.0
0.024,17,2,230,1,68,0.0,40.0,40.0,1,162,0.0,134.0,134.0
0.012,6,10,1983,5,910,3.0,642.0,642.0,5,1073,3.0,805.0,805.0
0.005,17,2,164,1,74,0.0,46.0,46.0,1,90,0.0,62.0,62.0
0.03,6,13,3816,7,578,5.0,206.0,206.0,6,3238,6.0,1470.0,1459.0
846.966,6,43,8022,22,6092,25733.0,494.0,494.0,21,1930,42348.0,83.0,83.0
0.001,17,2,180,1,66,0.0,38.0,38.0,1,114,0.0,86.0,86.0
0.008,6,10,1983,5,910,1.0,642.0,642.0,5,1073,1.0,805.0,805.0
0.01,6,10,1989,5,910,2.0,642.0,642.0,5,1079,2.0,811.0,811.0
11.134,17,28,4423,14,1995,843.0,270.0,114.0,14,2428,843.0,587.0,145.0
0.008,6,10,1989,5,910,2.0,642.0,642.0,5,1079,2.0,811.0,811.0
289.724,6,404,349324,197,21808,1478.0,2736.0,888.0,207,327516,1406.0,3053.0,1641.0
0.004,17,2,148,1,60,0.0,32.0,32.0,1,88,0.0,60.0,60.0
0.016,6,10,1762,5,911,4.0,643.0,643.0,5,851,3.0,583.0,583.0
0.007,17,2,293,1,73,0.0,45.0,45.0,1,220,0.0,192.0,192.0
40.083,17,10,676,5,460,10012.0,104.0,64.0,5,216,10019.0,20.0,15.0
0.072,6,10,1506,5,395,16.0,127.0,127.0,5,1111,14.0,843.0,843.0
240.072,6,22,4977,12,993,21824.0,180.0,93.0,10,3984,26674.0,1592.0,576.0
1770.374,17,92,8096,46,4048,39341.0,60.0,60.0,46,4048,39341.0,60.0,60.0
0.009,6,10,1989,5,910,2.0,642.0,642.0,5,1079,2.0,811.0,811.0
40.039,17,10,676,5,460,10007.0,104.0,64.0,5,216,10008.0,20.0,15.0
1792.624,6,492,99913,247,88523,7286.0,421.0,365.0,245,11390,7346.0,53.0,53.0
0.007,6,12,1698,6,863,1.0,327.0,271.0,6,835,1.0,515.0,515.0
333.253,17,18,1008,9,640,41640.0,48.0,43.0,9,368,41640.0,20.0,12.0
0.005,6,10,2006,5,927,1.0,659.0,659.0,5,1079,1.0,811.0,811.0
40.082,17,10,676,5,460,10017.0,104.0,64.0,5,216,10014.0,20.0,15.0
0.126,6,10,1506,5,395,30.0,127.0,127.0,5,1111,27.0,843.0,843.0
0.009,6,10,1989,5,910,2.0,642.0,642.0,5,1079,2.0,811.0,811.0
0.013,6,10,1990,5,911,3.0,643.0,643.0,5,1079,3.0,811.0,811.0
0.005,6,10,1989,5,927,1.0,659.0,659.0,5,1062,1.0,794.0,794.0
0.011,6,10,1972,5,910,2.0,642.0,642.0,5,1062,2.0,794.0,794.0
0.015,6,14,3787,7,497,2.0,125.0,125.0,7,3290,2.0,1448.0,972.0
0.011,6,10,1989,5,910,2.0,642.0,642.0,5,1079,2.0,811.0,811.0
313.713,17,20,1124,10,716,34843.0,48.0,43.0,10,408,34843.0,20.0,12.0
0.004,6,10,2007,5,928,1.0,660.0,660.0,5,1079,1.0,811.0,811.0
0.011,6,10,1989,5,910,2.0,642.0,642.0,5,1079,2.0,811.0,811.0
0.009,6,10,1989,5,910,2.0,642.0,642.0,5,1079,2.0,811.0,811.0
0.014,6,10,1989,5,910,3.0,642.0,642.0,5,1079,3.0,811.0,811.0
0.001,17,2,180,1,66,0.0,38.0,38.0,1,114,0.0,86.0,86.0
0.006,6,10,1547,5,764,1.0,496.0,496.0,5,783,1.0,515.0,515.0
0.0,17,2,136,1,60,0.0,32.0,32.0,1,76,0.0,48.0,48.0
0.012,6,10,1983,5,910,3.0,642.0,642.0,5,1073,2.0,805.0,805.0
0.014,6,10,1990,5,911,3.0,643.0,643.0,5,1079,3.0,811.0,811.0
0.005,6,10,1689,5,839,1.0,571.0,571.0,5,850,1.0,582.0,582.0
0.008,6,10,1990,5,911,2.0,643.0,643.0,5,1079,2.0,811.0,811.0
0.005,6,10,1774,5,923,1.0,655.0,655.0,5,851,1.0,583.0,583.0
0.015,6,13,3913,7,495,2.0,123.0,123.0,6,3418,2.0,1650.0,1549.0
0.016,6,10,1983,5,910,3.0,642.0,642.0,5,1073,4.0,805.0,805.0
1792.067,6,486,98773,245,87543,7344.0,421.0,368.0,241,11230,7466.0,53.0,53.0
0.008,6,12,1926,6,1189,1.0,659.0,434.0,6,737,1.0,417.0,417.0
0.144,6,10,1506,5,395,22.0,127.0,127.0,5,1111,32.0,843.0,843.0
0.011,6,10,1989,5,910,2.0,642.0,642.0,5,1079,2.0,811.0,811.0
0.042,17,2,156,1,64,0.0,36.0,36.0,1,92,0.0,64.0,64.0
0.013,6,10,1972,5,910,3.0,642.0,642.0,5,1062,3.0,794.0,794.0
0.005,6,10,2000,5,927,1.0,659.0,659.0,5,1073,1.0,805.0,805.0
0.005,6,10,2000,5,927,1.0,659.0,659.0,5,1073,1.0,805.0,805.0
0.001,17,2,180,1,66,0.0,38.0,38.0,1,114,0.0,86.0,86.0
0.098,6,10,1506,5,395,22.0,127.0,127.0,5,1111,22.0,843.0,843.0
0.006,6,10,1689,5,839,1.0,571.0,571.0,5,850,1.0,582.0,582.0
0.099,6,10,1506,5,395,19.0,127.0,127.0,5,1111,23.0,843.0,843.0
0.152,6,10,1506,5,395,35.0,127.0,127.0,5,1111,37.0,843.0,843.0
0.009,6,10,1989,5,910,2.0,642.0,642.0,5,1079,2.0,811.0,811.0
0.006,6,10,1989,5,927,1.0,659.0,659.0,5,1062,1.0,794.0,794.0
0.005,6,10,1854,5,889,1.0,621.0,621.0,5,965,1.0,697.0,697.0
330.474,17,20,1124,10,716,36704.0,48.0,43.0,10,408,36709.0,20.0,12.0
0.004,6,10,1989,5,927,1.0,659.0,659.0,5,1062,1.0,794.0,794.0
0.013,6,10,1989,5,910,3.0,642.0,642.0,5,1079,3.0,811.0,811.0
0.03,6,10,1989,5,910,7.0,642.0,642.0,5,1079,7.0,811.0,811.0
0.005,6,10,1989,5,927,1.0,659.0,659.0,5,1062,1.0,794.0,794.0
0.005,6,13,3747,7,509,0.0,137.0,137.0,6,3238,1.0,1470.0,1459.0
0.005,6,10,2006,5,927,1.0,659.0,659.0,5,1079,1.0,811.0,811.0
0.064,17,2,144,1,64,0.0,36.0,36.0,1,80,0.0,52.0,52.0
0.001,17,2,180,1,66,0.0,38.0,38.0,1,114,0.0,86.0,86.0
292.283,6,410,349160,192,21557,1530.0,2736.0,889.0,218,327603,1346.0,4127.0,1550.0
0.072,6,10,1506,5,395,15.0,127.0,127.0,5,1111,14.0,843.0,843.0
0.005,6,13,3690,7,452,0.0,80.0,80.0,6,3238,0.0,1470.0,1459.0
0.005,6,10,1774,5,923,1.0,655.0,655.0,5,851,1.0,583.0,583.0
0.069,6,10,1506,5,395,15.0,127.0,127.0,5,1111,15.0,843.0,843.0
240.147,6,49,6892,23,3314,10915.0,588.0,211.0,26,3578,9605.0,580.0,184.0
0.072,17,2,170,1,65,0.0,37.0,37.0,1,105,0.0,77.0,77.0
0.008,6,10,1972,5,910,2.0,642.0,642.0,5,1062,2.0,794.0,794.0
0.002,17,2,166,1,75,0.0,47.0,47.0,1,91,0.0,63.0,63.0
0.008,6,10,1989,5,910,1.0,642.0,642.0,5,1079,2.0,811.0,811.0
0.004,6,10,2006,5,927,1.0,659.0,659.0,5,1079,1.0,811.0,811.0
0.004,17,4,284,2,120,0.0,32.0,32.0,2,164,0.0,60.0,54.0
0.006,6,10,1547,5,764,1.0,496.0,496.0,5,783,1.0,515.0,515.0
0.003,17,4,284,2,120,0.0,32.0,32.0,2,164,0.0,60.0,54.0
0.013,6,10,1989,5,910,3.0,642.0,642.0,5,1079,3.0,811.0,811.0
0.124,6,10,1506,5,395,28.0,127.0,127.0,5,1111,27.0,843.0,843.0
10.892,17,28,4421,14,1993,829.0,268.0,114.0,14,2428,829.0,587.0,145.0
0.088,6,10,1506,5,395,19.0,127.0,127.0,5,1111,19.0,843.0,843.0
0.006,6,10,1689,5,839,1.0,571.0,571.0,5,850,1.0,582.0,582.0
0.008,6,10,1631,5,848,2.0,580.0,580.0,5,783,2.0,515.0,515.0
0.004,6,10,2000,5,927,1.0,659.0,659.0,5,1073,1.0,805.0,805.0
0.004,17,2,170,1,65,0.0,37.0,37.0,1,105,0.0,77.0,77.0
1770.585,6,89,4755,44,2342,41175.0,27.0,27.0,45,2413,40239.0,26.0,24.0
0.096,6,10,1506,5,395,22.0,127.0,127.0,5,1111,21.0,843.0,843.0
0.003,6,10,1702,5,863,0.0,595.0,595.0,5,839,0.0,571.0,571.0
0.008,6,12,1926,6,1189,1.0,659.0,434.0,6,737,1.0,417.0,417.0
0.122,6,10,1506,5,395,27.0,127.0,127.0,5,1111,24.0,843.0,843.0
0.01,6,10,1989,5,910,2.0,642.0,642.0,5,1079,2.0,811.0,811.0
0.028,6,10,1983,5,910,7.0,642.0,642.0,5,1073,7.0,805.0,805.0
0.017,6,10,1762,5,911,4.0,643.0,643.0,5,851,4.0,583.0,583.0
0.003,17,4,284,2,120,0.0,32.0,32.0,2,164,0.0,60.0,54.0
0.003,17,4,284,2,120,0.0,32.0,32.0,2,164,0.0,60.0,54.0
55.796,6,40,10527,20,4929,471.0,1360.0,682.0,20,5598,2928.0,2667.0,435.0
1797.61,17,3119,239049,1547,125338,1162.0,84.0,53.0,1572,113711,1144.0,227.0,44.0
40.053,17,10,676,5,460,10012.0,104.0,64.0,5,216,10012.0,20.0,15.0
0.014,17,2,169,1,62,0.0,34.0,34.0,1,107,0.0,79.0,79.0
0.014,6,10,1972,5,910,3.0,642.0,642.0,5,1062,3.0,794.0,794.0
0.004,17,2,148,1,60,0.0,32.0,32.0,1,88,0.0,60.0,60.0
369.908,6,22,2313,16,867,24660.0,195.0,195.0,6,1446,4650.0,419.0,398.0
0.015,6,10,1702,5,863,3.0,595.0,595.0,5,839,3.0,571.0,571.0
0.006,6,10,1689,5,839,1.0,571.0,571.0,5,850,1.0,582.0,582.0
0.005,6,10,2000,5,927,1.0,659.0,659.0,5,1073,1.0,805.0,805.0
0.005,17,2,166,1,75,0.0,47.0,47.0,1,91,0.0,63.0,63.0
0.003,17,2,136,1,60,0.0,32.0,32.0,1,76,0.0,48.0,48.0
0.085,6,10,1506,5,395,19.0,127.0,127.0,5,1111,17.0,843.0,843.0
0.007,17,2,179,1,71,0.0,43.0,43.0,1,108,0.0,80.0,80.0
0.003,17,2,136,1,60,0.0,32.0,32.0,1,76,0.0,48.0,48.0
40.062,17,10,676,5,460,10014.0,104.0,64.0,5,216,10014.0,20.0,15.0
0.018,6,10,1990,5,911,4.0,643.0,643.0,5,1079,4.0,811.0,811.0
0.004,6,10,1779,5,928,1.0,660.0,660.0,5,851,1.0,583.0,583.0
0.163,6,10,1506,5,395,40.0,127.0,127.0,5,1111,38.0,843.0,843.0
0.085,6,10,1506,5,395,19.0,127.0,127.0,5,1111,19.0,843.0,843.0
0.004,6,10,2006,5,927,1.0,659.0,659.0,5,1079,1.0,811.0,811.0
0.005,17,2,140,1,62,0.0,34.0,34.0,1,78,0.0,50.0,50.0
0.078,17,2,152,1,76,0.0,48.0,48.0,1,76,0.0,48.0,48.0
0.013,6,10,1972,5,910,3.0,642.0,642.0,5,1062,3.0,794.0,794.0
0.004,6,10,2006,5,927,1.0,659.0,659.0,5,1079,1.0,811.0,811.0
0.006,6,10,1547,5,764,1.0,496.0,496.0,5,783,1.0,515.0,515.0
10.899,17,28,4424,14,1995,830.0,270.0,114.0,14,2429,829.0,588.0,145.0
0.013,6,10,1762,5,911,3.0,643.0,643.0,5,851,3.0,583.0,583.0
0.004,6,10,2006,5,927,1.0,659.0,659.0,5,1079,1.0,811.0,811.0
0.008,6,12,1926,6,1189,1.0,659.0,434.0,6,737,1.0,417.0,417.0
0.001,17,2,136,1,60,0.0,32.0,32.0,1,76,0.0,48.0,48.0
0.005,6,10,2006,5,927,1.0,659.0,659.0,5,1079,1.0,811.0,811.0
0.005,6,10,2007,5,928,1.0,660.0,660.0,5,1079,1.0,811.0,811.0
0.144,6,10,1506,5,395,33.0,127.0,127.0,5,1111,34.0,843.0,843.0
0.006,6,10,1689,5,839,1.0,571.0,571.0,5,850,1.0,582.0,582.0
0.016,17,2,198,1,91,0.0,63.0,63.0,1,107,0.0,79.0,79.0
0.033,6,10,1990,5,911,8.0,643.0,643.0,5,1079,8.0,811.0,811.0
0.012,6,10,1989,5,910,3.0,642.0,642.0,5,1079,3.0,811.0,811.0
0.005,17,2,140,1,62,0.0,34.0,34.0,1,78,0.0,50.0,50.0
40.084,17,10,676,5,460,10018.0,104.0,64.0,5,216,10020.0,20.0,15.0
0.113,6,10,1506,5,395,23.0,127.0,127.0,5,1111,21.0,843.0,843.0
0.021,6,10,1989,5,910,5.0,642.0,642.0,5,1079,5.0,811.0,811.0
0.004,6,10,1989,5,927,1.0,659.0,659.0,5,1062,1.0,794.0,794.0
0.132,6,10,1506,5,395,28.0,127.0,127.0,5,1111,30.0,843.0,843.0
0.238,6,10,1506,5,395,42.0,127.0,127.0,5,1111,56.0,843.0,843.0
0.027,6,13,3735,7,497,4.0,125.0,125.0,6,3238,5.0,1470.0,1459.0
375.951,6,72,10060,34,2960,11392.0,747.0,296.0,38,7100,10160.0,1626.0,146.0
0.011,6,10,1983,5,910,2.0,642.0,642.0,5,1073,2.0,805.0,805.0
40.073,17,10,676,5,460,10015.0,104.0,64.0,5,216,10017.0,20.0,15.0
0.006,6,13,3747,7,509,0.0,137.0,137.0,6,3238,1.0,1470.0,1459.0
0.068,6,10,1506,5,395,15.0,127.0,127.0,5,1111,15.0,843.0,843.0
266.641,6,39,9816,15,6594,19045.0,1718.0,646.0,24,3222,11592.0,580.0,131.0
0.006,6,10,1689,5,839,1.0,571.0,571.0,5,850,1.0,582.0,582.0
0.156,6,10,1506,5,395,36.0,127.0,127.0,5,1111,36.0,843.0,843.0
0.014,6,10,1989,5,910,3.0,642.0,642.0,5,1079,3.0,811.0,811.0
0.103,6,10,1506,5,395,18.0,127.0,127.0,5,1111,23.0,843.0,843.0
0.005,6,10,1689,5,839,1.0,571.0,571.0,5,850,1.0,582.0,582.0
0.012,6,10,1972,5,910,3.0,642.0,642.0,5,1062,2.0,794.0,794.0
0.006,17,2,294,1,64,0.0,36.0,36.0,1,230,0.0,202.0,202.0
0.012,6,10,1989,5,910,3.0,642.0,642.0,5,1079,3.0,811.0,811.0
326.102,17,20,1124,10,716,36219.0,48.0,43.0,10,408,36219.0,20.0,12.0
11.192,17,28,4421,14,1993,848.0,268.0,114.0,14,2428,848.0,587.0,145.0
0.01,6,10,1972,5,910,2.0,642.0,642.0,5,1062,2.0,794.0,794.0
15.072,17,15,9238,8,6902,2149.0,1350.0,834.0,7,2336,2507.0,1350.0,305.0
0.116,6,10,1506,5,395,27.0,127.0,127.0,5,1111,21.0,843.0,843.0
0.005,6,10,1689,5,839,1.0,571.0,571.0,5,850,1.0,582.0,582.0
0.217,6,16,2669,8,1395,31.0,533.0,323.0,8,1274,19.0,529.0,212.0
0.116,6,10,1506,5,395,28.0,127.0,127.0,5,1111,25.0,843.0,843.0
0.01,6,10,1677,5,827,2.0,559.0,559.0,5,850,2.0,582.0,582.0
0.009,6,10,1989,5,910,2.0,642.0,642.0,5,1079,2.0,811.0,811.0
0.011,6,10,1631,5,848,2.0,580.0,580.0,5,783,2.0,515.0,515.0
0.088,6,10,1506,5,395,19.0,127.0,127.0,5,1111,18.0,843.0,843.0
0.012,6,10,1990,5,911,3.0,643.0,643.0,5,1079,3.0,811.0,811.0
0.015,6,10,1990,5,911,3.0,643.0,643.0,5,1079,3.0,811.0,811.0
0.09,6,10,1506,5,395,21.0,127.0,127.0,5,1111,17.0,843.0,843.0
0.016,6,10,1983,5,910,4.0,642.0,642.0,5,1073,4.0,805.0,805.0
0.038,17,2,412,1,61,0.0,33.0,33.0,1,351,0.0,323.0,323.0
0.141,6,10,1506,5,395,34.0,127.0,127.0,5,1111,29.0,843.0,843.0
0.011,6,10,1990,5,911,2.0,643.0,643.0,5,1079,2.0,811.0,811.0
0.005,6,10,1989,5,927,1.0,659.0,659.0,5,1062,1.0,794.0,794.0
0.001,17,2,180,1,66,0.0,38.0,38.0,1,114,0.0,86.0,86.0
177.11,17,94,13534,47,3163,3850.0,44.0,39.0,47,10371,3850.0,261.0,192.0
40.064,17,10,676,5,460,10015.0,104.0,64.0,5,216,10014.0,20.0,15.0
0.008,6,10,1989,5,910,2.0,642.0,642.0,5,1079,2.0,811.0,811.0
0.001,17,2,180,1,65,0.0,37.0,37.0,1,115,0.0,87.0,87.0
0.01,6,10,1972,5,910,2.0,642.0,642.0,5,1062,2.0,794.0,794.0
0.003,17,2,136,1,60,0.0,32.0,32.0,1,76,0.0,48.0,48.0
0.038,17,2,166,1,75,0.0,47.0,47.0,1,91,0.0,63.0,63.0
15.079,17,15,8162,8,6088,2150.0,1350.0,733.0,7,2074,2508.0,1350.0,268.0
0.021,6,10,1983,5,910,5.0,642.0,642.0,5,1073,5.0,805.0,805.0
314.459,17,20,1124,10,716,34933.0,48.0,43.0,10,408,34933.0,20.0,12.0
300.341,6,16,2170,9,684,37521.0,146.0,146.0,7,1486,50029.0,419.0,398.0
300.444,6,21,2406,13,880,25019.0,146.0,146.0,8,1526,42893.0,419.0,398.0
0.004,6,10,2007,5,928,1.0,660.0,660.0,5,1079,1.0,811.0,811.0
0.004,6,10,2007,5,928,1.0,660.0,660.0,5,1079,1.0,811.0,811.0
40.062,17,10,676,5,460,10014.0,104.0,64.0,5,216,10012.0,20.0,15.0
11.064,17,28,4423,14,1995,838.0,270.0,114.0,14,2428,838.0,587.0,145.0
40.074,17,10,676,5,460,10017.0,104.0,64.0,5,216,10017.0,20.0,15.0
0.004,17,4,420,2,122,0.0,33.0,33.0,2,298,0.0,145.0,121.0
0.077,6,10,1506,5,395,17.0,127.0,127.0,5,1111,14.0,843.0,843.0
0.006,6,10,1547,5,764,1.0,496.0,496.0,5,783,1.0,515.0,515.0
0.011,6,10,1989,5,910,2.0,642.0,642.0,5,1079,2.0,811.0,811.0
0.005,6,13,3747,7,509,0.0,137.0,137.0,6,3238,0.0,1470.0,1459.0
0.045,17,4,284,2,120,3.0,32.0,32.0,2,164,42.0,60.0,54.0
40.066,17,10,676,5,460,10013.0,104.0,64.0,5,216,10015.0,20.0,15.0
0.006,17,2,166,1,75,0.0,47.0,47.0,1,91,0.0,63.0,63.0
241.833,6,390,347454,184,21087,1321.0,2736.0,959.0,206,326367,1179.0,2804.0,1610.0
0.008,6,10,1989,5,910,2.0,642.0,642.0,5,1079,2.0,811.0,811.0
0.04,17,2,182,1,65,0.0,37.0,37.0,1,117,0.0,89.0,89.0
0.006,17,2,225,1,65,0.0,37.0,37.0,1,160,0.0,132.0,132.0
0.04,17,4,364,2,160,0.0,52.0,52.0,2,204,1.0,80.0,74.0
0.005,6,10,1689,5,839,1.0,571.0,571.0,5,850,1.0,582.0,582.0
0.212,17,4,596,2,122,141.0,33.0,33.0,2,474,174.0,323.0,209.0
40.072,17,10,676,5,460,10017.0,104.0,64.0,5,216,10016.0,20.0,15.0
0.012,17,4,284,2,120,0.0,32.0,32.0,2,164,0.0,60.0,54.0
285.23,6,30,6574,16,1433,19015.0,517.0,290.0,14,5141,21940.0,2379.0,1104.0
0.078,6,10,1506,5,395,18.0,127.0,127.0,5,1111,14.0,843.0,843.0
312.769,17,20,1124,10,716,34738.0,48.0,43.0,10,408,34738.0,20.0,12.0
0.006,17,2,144,1,64,0.0,36.0,36.0,1,80,0.0,52.0,52.0
0.003,17,2,136,1,60,0.0,32.0,32.0,1,76,0.0,48.0,48.0
0.01,6,10,1990,5,911,2.0,643.0,643.0,5,1079,2.0,811.0,811.0
300.399,6,16,2170,9,684,37529.0,146.0,146.0,7,1486,50039.0,419.0,398.0
435.718,6,39,15159,21,3515,21785.0,676.0,400.0,18,11644,22098.0,1402.0,972.0
0.005,6,10,1989,5,927,1.0,659.0,659.0,5,1062,1.0,794.0,794.0
0.083,6,10,1506,5,395,18.0,127.0,127.0,5,1111,16.0,843.0,843.0
0.083,6,10,1506,5,395,18.0,127.0,127.0,5,1111,17.0,843.0,843.0
0.07,6,30,10323,17,9046,4.0,2261.0,906.0,13,1277,5.0,279.0,100.0
0.007,6,10,2007,5,928,1.0,660.0,660.0,5,1079,1.0,811.0,811.0
0.006,6,10,1854,5,889,1.0,621.0,621.0,5,965,1.0,697.0,697.0
0.089,6,10,1506,5,395,20.0,127.0,127.0,5,1111,15.0,843.0,843.0
0.071,6,10,1506,5,395,16.0,127.0,127.0,5,1111,15.0,843.0,843.0
0.008,6,10,1989,5,927,2.0,659.0,659.0,5,1062,2.0,794.0,794.0
0.005,6,10,1989,5,927,1.0,659.0,659.0,5,1062,1.0,794.0,794.0
0.01,6,10,1643,5,860,2.0,592.0,592.0,5,783,2.0,515.0,515.0
0.087,6,10,1506,5,395,20.0,127.0,127.0,5,1111,21.0,843.0,843.0
40.051,17,10,676,5,460,10011.0,104.0,64.0,5,216,10012.0,20.0,15.0
0.01,6,6,716,3,458,4.0,302.0,302.0,3,258,3.0,102.0,102.0
0.014,6,10,1989,5,910,3.0,642.0,642.0,5,1079,3.0,811.0,811.0
0.006,6,10,1854,5,889,1.0,621.0,621.0,5,965,1.0,697.0,697.0
0.135,17,2,148,1,60,0.0,32.0,32.0,1,88,0.0,60.0,60.0
0.001,17,2,180,1,66,0.0,38.0,38.0,1,114,0.0,86.0,86.0
0.006,6,10,1547,5,764,1.0,496.0,496.0,5,783,1.0,515.0,515.0
0.007,17,2,299,1,65,0.0,37.0,37.0,1,234,0.0,206.0,206.0
0.011,6,13,3735,7,497,1.0,125.0,125.0,6,3238,2.0,1470.0,1459.0
0.001,17,2,180,1,66,0.0,38.0,38.0,1,114,0.0,86.0,86.0
11.135,17,28,4423,14,1995,844.0,270.0,114.0,14,2428,844.0,587.0,145.0
0.07,6,10,1506,5,395,15.0,127.0,127.0,5,1111,15.0,843.0,843.0
0.001,17,2,180,1,66,0.0,38.0,38.0,1,114,0.0,86.0,86.0
0.005,6,10,2000,5,927,1.0,659.0,659.0,5,1073,1.0,805.0,805.0
0.004,17,2,166,1,75,0.0,47.0,47.0,1,91,0.0,63.0,63.0
0.005,6,13,3747,7,509,0.0,137.0,137.0,6,3238,0.0,1470.0,1459.0
0.003,17,4,284,2,120,0.0,32.0,32.0,2,164,0.0,60.0,54.0
0.081,6,10,1506,5,395,17.0,127.0,127.0,5,1111,18.0,843.0,843.0
0.008,17,2,136,1,60,0.0,32.0,32.0,1,76,0.0,48.0,48.0
0.003,17,4,284,2,120,0.0,32.0,32.0,2,164,0.0,60.0,54.0
0.005,6,10,2007,5,928,1.0,660.0,660.0,5,1079,1.0,811.0,811.0
0.001,17,2,180,1,66,0.0,38.0,38.0,1,114,0.0,86.0,86.0
0.004,6,10,2000,5,927,1.0,659.0,659.0,5,1073,1.0,805.0,805.0
240.091,6,16,4481,9,963,30011.0,238.0,166.0,7,3518,40014.0,1402.0,786.0
300.332,6,16,2170,9,684,37520.0,146.0,146.0,7,1486,50027.0,419.0,398.0
0.005,17,2,248,1,68,0.0,40.0,40.0,1,180,0.0,152.0,152.0
0.061,6,10,1506,5,395,12.0,127.0,127.0,5,1111,13.0,843.0,843.0
0.14,6,10,1506,5,395,30.0,127.0,127.0,5,1111,32.0,843.0,843.0
0.01,6,10,1972,5,910,2.0,642.0,642.0,5,1062,2.0,794.0,794.0
0.004,17,2,136,1,60,0.0,32.0,32.0,1,76,0.0,48.0,48.0
0.005,6,10,2007,5,928,1.0,660.0,660.0,5,1079,1.0,811.0,811.0
0.07,6,10,1506,5,395,17.0,127.0,127.0,5,1111,14.0,843.0,843.0
0.019,6,10,1631,5,848,4.0,580.0,580.0,5,783,4.0,515.0,515.0
0.004,6,10,1774,5,923,1.0,655.0,655.0,5,851,1.0,583.0,583.0
0.09,6,10,1506,5,395,21.0,127.0,127.0,5,1111,21.0,843.0,843.0
0.008,17,2,194,1,59,0.0,31.0,31.0,1,135,0.0,107.0,107.0
0.005,6,10,2006,5,927,1.0,659.0,659.0,5,1079,1.0,811.0,811.0
0.04,17,2,412,1,61,0.0,33.0,33.0,1,351,0.0,323.0,323.0
20.68,6,37,10002,19,4484,496.0,1360.0,738.0,18,5518,1206.0,2667.0,435.0
240.275,6,45,5888,23,2887,10921.0,588.0,207.0,22,3001,11441.0,580.0,202.0
0.013,6,10,1972,5,910,3.0,642.0,642.0,5,1062,3.0,794.0,794.0
0.005,17,2,164,1,74,0.0,46.0,46.0,1,90,0.0,62.0,62.0
0.006,17,2,170,1,65,0.0,37.0,37.0,1,105,0.0,77.0,77.0
0.011,6,10,1989,5,910,2.0,642.0,642.0,5,1079,2.0,811.0,811.0
0.003,17,2,148,1,60,0.0,32.0,32.0,1,88,0.0,60.0,60.0
0.006,6,10,1547,5,764,1.0,496.0,496.0,5,783,1.0,515.0,515.0
0.009,6,10,1990,5,911,2.0,643.0,643.0,5,1079,2.0,811.0,811.0
0.016,6,10,1972,5,910,4.0,642.0,642.0,5,1062,3.0,794.0,794.0
0.003,17,2,148,1,60,0.0,32.0,32.0,1,88,0.0,60.0,60.0
0.01,17,2,144,1,64,0.0,36.0,36.0,1,80,0.0,52.0,52.0
0.005,6,10,2006,5,927,1.0,659.0,659.0,5,1079,1.0,811.0,811.0
0.003,17,2,136,1,60,0.0,32.0,32.0,1,76,0.0,48.0,48.0
0.014,6,10,1631,5,848,3.0,580.0,580.0,5,783,3.0,515.0,515.0
0.005,6,13,3747,7,509,0.0,137.0,137.0,6,3238,1.0,1470.0,1459.0
0.001,17,2,180,1,66,0.0,38.0,38.0,1,114,0.0,86.0,86.0
0.123,6,10,1506,5,395,29.0,127.0,127.0,5,1111,28.0,843.0,843.0
0.01,6,10,1990,5,911,2.0,643.0,643.0,5,1079,2.0,811.0,811.0
40.06,17,10,676,5,460,10014.0,104.0,64.0,5,216,10014.0,20.0,15.0
1787.693,6,150,19350,90,13740,20086.0,302.0,302.0,60,5610,30299.0,83.0,83.0
9.039,17,6,376,5,280,2259.0,28.0,28.0,1,96,0.0,68.0,68.0
0.006,6,10,1689,5,839,1.0,571.0,571.0,5,850,1.0,582.0,582.0
0.011,6,10,1972,5,910,2.0,642.0,642.0,5,1062,2.0,794.0,794.0
0.012,6,10,1989,5,910,2.0,642.0,642.0,5,1079,2.0,811.0,811.0
0.006,6,10,1547,5,764,1.0,496.0,496.0,5,783,1.0,515.0,515.0
0.114,6,10,1506,5,395,25.0,127.0,127.0,5,1111,24.0,843.0,843.0
0.009,6,14,3787,7,497,1.0,125.0,125.0,7,3290,1.0,1448.0,972.0
0.011,6,10,1989,5,910,2.0,642.0,642.0,5,1079,2.0,811.0,811.0
0.09,6,10,1506,5,395,19.0,127.0,127.0,5,1111,19.0,843.0,843.0
0.148,6,10,1506,5,395,35.0,127.0,127.0,5,1111,31.0,843.0,843.0
0.006,6,10,1547,5,764,1.0,496.0,496.0,5,783,1.0,515.0,515.0
0.006,17,2,255,1,82,0.0,54.0,54.0,1,173,0.0,145.0,145.0
0.011,6,10,1972,5,910,2.0,642.0,642.0,5,1062,2.0,794.0,794.0
0.005,6,10,1643,5,860,1.0,592.0,592.0,5,783,1.0,515.0,515.0
0.041,17,2,152,1,76,0.0,48.0,48.0,1,76,0.0,48.0,48.0
0.015,6,10,1989,5,910,3.0,642.0,642.0,5,1079,3.0,811.0,811.0
0.001,17,2,180,1,66,0.0,38.0,38.0,1,114,0.0,86.0,86.0
0.005,6,10,2006,5,927,1.0,659.0,659.0,5,1079,1.0,811.0,811.0
0.005,6,10,2006,5,927,1.0,659.0,659.0,5,1079,1.0,811.0,811.0
0.006,17,2,169,1,62,0.0,34.0,34.0,1,107,0.0,79.0,79.0
335.631,17,18,1008,9,640,41946.0,48.0,43.0,9,368,41946.0,20.0,12.0
0.001,17,2,180,1,66,0.0,38.0,38.0,1,114,0.0,86.0,86.0
0.014,6,10,1989,5,910,3.0,642.0,642.0,5,1079,3.0,811.0,811.0
0.004,6,10,1702,5,863,1.0,595.0,595.0,5,839,1.0,571.0,571.0
15.072,17,15,9238,8,6902,2148.0,1350.0,834.0,7,2336,2507.0,1350.0,305.0
0.091,6,10,1506,5,395,18.0,127.0,127.0,5,1111,20.0,843.0,843.0
0.083,6,10,1506,5,395,18.0,127.0,127.0,5,1111,18.0,843.0,843.0
0.015,6,10,1989,5,910,3.0,642.0,642.0,5,1079,3.0,811.0,811.0
0.004,6,10,2007,5,928,1.0,660.0,660.0,5,1079,1.0,811.0,811.0
0.001,17,2,180,1,66,0.0,38.0,38.0,1,114,0.0,86.0,86.0
0.005,6,10,2007,5,928,1.0,660.0,660.0,5,1079,1.0,811.0,811.0
0.008,6,12,1926,6,1189,1.0,659.0,434.0,6,737,1.0,417.0,417.0
0.005,6,14,3742,8,504,0.0,80.0,80.0,6,3238,0.0,1470.0,1459.0
0.094,6,10,1506,5,395,21.0,127.0,127.0,5,1111,19.0,843.0,843.0
11.145,17,28,4417,14,1993,844.0,268.0,114.0,14,2424,844.0,587.0,145.0
0.014,6,10,1989,5,910,3.0,642.0,642.0,5,1079,3.0,811.0,811.0
0.021,6,10,1989,5,910,5.0,642.0,642.0,5,1079,5.0,811.0,811.0
0.009,6,10,1983,5,910,2.0,642.0,642.0,5,1073,2.0,805.0,805.0
334.632,6,23,4657,13,2427,27886.0,676.0,348.0,10,2230,30509.0,821.0,425.0
0.004,6,10,1774,5,923,1.0,655.0,655.0,5,851,1.0,583.0,583.0
0.014,6,10,1989,5,910,3.0,642.0,642.0,5,1079,3.0,811.0,811.0
0.005,17,2,180,1,58,0.0,30.0,30.0,1,122,0.0,94.0,94.0
0.099,6,10,1506,5,395,19.0,127.0,127.0,5,1111,21.0,843.0,843.0
0.011,6,10,1972,5,910,2.0,642.0,642.0,5,1062,2.0,794.0,794.0
0.006,17,4,495,2,132,1.0,38.0,38.0,2,363,2.0,176.0,153.0
0.005,6,10,2000,5,927,1.0,659.0,659.0,5,1073,1.0,805.0,805.0
15.095,17,15,8457,8,6429,2151.0,1350.0,775.0,7,2028,2509.0,1350.0,261.0
0.067,6,10,1506,5,395,15.0,127.0,127.0,5,1111,14.0,843.0,843.0
300.384,6,16,2170,9,684,37527.0,146.0,146.0,7,1486,50035.0,419.0,398.0
0.698,6,22,5072,11,1250,59.0,325.0,133.0,11,3822,58.0,1414.0,563.0
0.219,6,16,2674,8,1400,31.0,533.0,325.0,8,1274,19.0,529.0,212.0
308.7,17,20,1124,10,716,34286.0,48.0,43.0,10,408,34291.0,20.0,12.0
0.148,6,10,1506,5,395,33.0,127.0,127.0,5,1111,30.0,843.0,843.0
0.014,6,10,1989,5,910,3.0,642.0,642.0,5,1079,3.0,811.0,811.0
40.059,17,10,676,5,460,10012.0,104.0,64.0,5,216,10013.0,20.0,15.0
40.064,17,10,676,5,460,10014.0,104.0,64.0,5,216,10015.0,20.0,15.0
0.074,6,10,1506,5,395,16.0,127.0,127.0,5,1111,17.0,843.0,843.0
0.009,6,10,1983,5,910,2.0,642.0,642.0,5,1073,2.0,805.0,805.0
240.107,6,16,4481,9,963,30013.0,238.0,166.0,7,3518,40017.0,1402.0,786.0
0.171,6,3,453,2,321,171.0,241.0,241.0,1,132,0.0,92.0,92.0
0.006,17,2,170,1,65,0.0,37.0,37.0,1,105,0.0,77.0,77.0
0.006,6,10,1854,5,889,1.0,621.0,621.0,5,965,1.0,697.0,697.0
0.016,6,10,1989,5,910,4.0,642.0,642.0,5,1079,4.0,811.0,811.0
0.009,6,12,1926,6,1189,1.0,659.0,434.0,6,737,1.0,417.0,417.0
0.005,6,14,3742,8,504,0.0,80.0,80.0,6,3238,1.0,1470.0,1459.0
0.006,6,10,1989,5,927,1.0,659.0,659.0,5,1062,1.0,794.0,794.0
0.006,17,2,144,1,64,0.0,36.0,36.0,1,80,0.0,52.0,52.0
0.005,17,2,214,1,75,0.0,47.0,47.0,1,139,0.0,111.0,111.0
0.013,6,10,1989,5,910,3.0,642.0,642.0,5,1079,3.0,811.0,811.0
0.011,6,10,1972,5,910,2.0,642.0,642.0,5,1062,2.0,794.0,794.0
0.005,6,10,2000,5,927,1.0,659.0,659.0,5,1073,1.0,805.0,805.0
0.089,6,10,1506,5,395,18.0,127.0,127.0,5,1111,19.0,843.0,843.0
0.013,6,10,1631,5,848,3.0,580.0,580.0,5,783,3.0,515.0,515.0
0.004,6,10,1989,5,927,1.0,659.0,659.0,5,1062,1.0,794.0,794.0
0.084,6,10,1506,5,395,19.0,127.0,127.0,5,1111,17.0,843.0,843.0
0.005,6,10,2007,5,928,1.0,660.0,660.0,5,1079,1.0,811.0,811.0
0.114,6,10,1506,5,395,19.0,127.0,127.0,5,1111,25.0,843.0,843.0
0.091,6,10,1506,5,395,21.0,127.0,127.0,5,1111,18.0,843.0,843.0
0.013,6,10,1972,5,910,3.0,642.0,642.0,5,1062,3.0,794.0,794.0
0.005,17,2,193,1,71,0.0,43.0,43.0,1,122,0.0,94.0,94.0
0.01,6,10,1972,5,910,2.0,642.0,642.0,5,1062,2.0,794.0,794.0
0.005,6,10,2006,5,927,1.0,659.0,659.0,5,1079,1.0,811.0,811.0
0.005,6,10,1989,5,927,1.0,659.0,659.0,5,1062,1.0,794.0,794.0
0.006,6,10,1689,5,839,1.0,571.0,571.0,5,850,1.0,582.0,582.0
0.005,17,2,140,1,62,0.0,34.0,34.0,1,78,0.0,50.0,50.0
0.004,17,2,136,1,60,0.0,32.0,32.0,1,76,0.0,48.0,48.0
0.008,6,10,1762,5,911,1.0,643.0,643.0,5,851,2.0,583.0,583.0
0.005,17,2,179,1,71,0.0,43.0,43.0,1,108,0.0,80.0,80.0
0.081,6,10,1506,5,395,19.0,127.0,127.0,5,1111,17.0,843.0,843.0
0.041,6,10,1989,5,910,10.0,642.0,642.0,5,1079,10.0,811.0,811.0
0.005,6,10,1547,5,764,1.0,496.0,496.0,5,783,1.0,515.0,515.0
0.016,6,10,1989,5,910,4.0,642.0,642.0,5,1079,3.0,811.0,811.0
0.126,17,2,182,1,65,0.0,37.0,37.0,1,117,0.0,89.0,89.0
0.085,6,10,1506,5,395,20.0,127.0,127.0,5,1111,16.0,843.0,843.0
0.004,6,10,2000,5,927,1.0,659.0,659.0,5,1073,1.0,805.0,805.0
0.005,6,10,1779,5,928,1.0,660.0,660.0,5,851,1.0,583.0,583.0
15.182,17,18,9773,9,6335,1894.0,1350.0,675.0,9,3438,1894.0,1350.0,354.0
0.004,17,4,284,2,120,1.0,32.0,32.0,2,164,0.0,60.0,54.0
0.066,6,10,1506,5,395,13.0,127.0,127.0,5,1111,15.0,843.0,843.0
0.005,6,10,1779,5,928,1.0,660.0,660.0,5,851,1.0,583.0,583.0
10.817,17,28,4424,14,1995,823.0,270.0,114.0,14,2429,823.0,588.0,145.0
300.416,6,16,2170,9,684,37530.0,146.0,146.0,7,1486,50040.0,419.0,398.0
0.72,6,23,5165,12,1343,57.0,325.0,122.0,11,3822,60.0,1414.0,563.0
0.067,17,8,3613,4,1874,22.0,1350.0,440.0,4,1739,11.0,1350.0,406.0
0.015,6,10,1990,5,911,3.0,643.0,643.0,5,1079,3.0,811.0,811.0
10.909,17,28,4423,14,1995,830.0,270.0,114.0,14,2428,830.0,587.0,145.0
0.018,6,10,1972,5,910,4.0,642.0,642.0,5,1062,4.0,794.0,794.0
0.005,6,13,3690,7,452,0.0,80.0,80.0,6,3238,0.0,1470.0,1459.0
0.016,6,10,1990,5,911,4.0,643.0,643.0,5,1079,3.0,811.0,811.0
0.003,17,2,208,1,72,0.0,44.0,44.0,1,136,0.0,108.0,108.0
0.102,6,130,121215,63,4395,1.0,517.0,279.0,67,116820,1.0,2804.0,1857.0
0.005,6,10,1989,5,927,1.0,659.0,659.0,5,1062,1.0,794.0,794.0
0.102,17,2,144,1,64,0.0,36.0,36.0,1,80,0.0,52.0,52.0
0.011,6,10,1972,5,910,2.0,642.0,642.0,5,1062,2.0,794.0,794.0
0.001,17,2,180,1,66,0.0,38.0,38.0,1,114,0.0,86.0,86.0
0.003,6,10,1702,5,863,0.0,595.0,595.0,5,839,0.0,571.0,571.0
0.006,6,10,1854,5,889,1.0,621.0,621.0,5,965,1.0,697.0,697.0
0.005,6,10,1989,5,927,1.0,659.0,659.0,5,1062,1.0,794.0,794.0
0.006,6,10,2007,5,928,1.0,660.0,660.0,5,1079,1.0,811.0,811.0
0.099,6,10,1506,5,395,21.0,127.0,127.0,5,1111,22.0,843.0,843.0
40.097,17,10,676,5,460,10021.0,104.0,64.0,5,216,10023.0,20.0,15.0
0.011,6,10,1990,5,911,2.0,643.0,643.0,5,1079,2.0,811.0,811.0
0.005,6,10,2007,5,928,1.0,660.0,660.0,5,1079,1.0,811.0,811.0
0.004,17,2,136,1,60,0.0,32.0,32.0,1,76,0.0,48.0,48.0
0.01,6,10,1989,5,910,2.0,642.0,642.0,5,1079,2.0,811.0,811.0
40.072,17,10,676,5,460,10015.0,104.0,64.0,5,216,10017.0,20.0,15.0
0.004,6,10,1779,5,928,1.0,660.0,660.0,5,851,1.0,583.0,583.0
0.004,6,10,1989,5,927,1.0,659.0,659.0,5,1062,1.0,794.0,794.0
308.506,17,20,1124,10,716,34271.0,48.0,43.0,10,408,34271.0,20.0,12.0
0.016,6,10,1972,5,910,4.0,642.0,642.0,5,1062,3.0,794.0,794.0
0.014,6,10,1989,5,910,3.0,642.0,642.0,5,1079,3.0,811.0,811.0
0.005,6,10,1643,5,860,1.0,592.0,592.0,5,783,1.0,515.0,515.0
10.87,17,28,4424,14,1995,827.0,270.0,114.0,14,2429,827.0,588.0,145.0
0.023,17,2,198,1,91,0.0,63.0,63.0,1,107,0.0,79.0,79.0
40.054,17,10,676,5,460,10012.0,104.0,64.0,5,216,10012.0,20.0,15.0
0.011,17,4,284,2,120,8.0,32.0,32.0,2,164,7.0,60.0,54.0
0.006,6,10,1547,5,764,1.0,496.0,496.0,5,783,1.0,515.0,515.0
0.005,6,10,2000,5,927,1.0,659.0,659.0,5,1073,1.0,805.0,805.0
0.005,6,10,2006,5,927,1.0,659.0,659.0,5,1079,1.0,811.0,811.0
0.073,17,4,420,2,122,1.0,33.0,33.0,2,298,30.0,145.0,121.0
0.011,6,10,1762,5,911,2.0,643.0,643.0,5,851,2.0,583.0,583.0
15.07,17,15,9238,8,6902,2148.0,1350.0,834.0,7,2336,2506.0,1350.0,305.0
0.009,6,12,1926,6,1189,1.0,659.0,434.0,6,737,1.0,417.0,417.0
0.005,6,10,2007,5,928,1.0,660.0,660.0,5,1079,1.0,811.0,811.0
0.004,6,11,2041,6,979,0.0,659.0,659.0,5,1062,1.0,794.0,794.0
11.061,17,29,4567,15,2166,782.0,269.0,116.0,14,2401,842.0,588.0,143.0
0.005,6,10,2000,5,927,1.0,659.0,659.0,5,1073,1.0,805.0,805.0
0.005,6,14,3736,7,446,0.0,74.0,74.0,7,3290,0.0,1448.0,972.0
0.009,6,10,1983,5,910,2.0,642.0,642.0,5,1073,2.0,805.0,805.0
0.107,6,10,1506,5,395,22.0,127.0,127.0,5,1111,25.0,843.0,843.0
0.122,6,10,1506,5,395,27.0,127.0,127.0,5,1111,25.0,843.0,843.0
361.89,6,21,1793,16,1030,24126.0,190.0,190.0,5,763,60011.0,462.0,247.0
0.014,6,10,1990,5,911,3.0,643.0,643.0,5,1079,3.0,811.0,811.0
0.015,6,10,1983,5,910,3.0,642.0,642.0,5,1073,3.0,805.0,805.0
0.095,6,10,1506,5,395,21.0,127.0,127.0,5,1111,22.0,843.0,843.0
0.008,17,2,194,1,59,0.0,31.0,31.0,1,135,0.0,107.0,107.0
0.005,6,10,2006,5,927,1.0,659.0,659.0,5,1079,1.0,811.0,811.0
0.01,6,10,1989,5,910,2.0,642.0,642.0,5,1079,2.0,811.0,811.0
0.025,6,10,1989,5,910,6.0,642.0,642.0,5,1079,6.0,811.0,811.0
0.006,6,10,1547,5,764,1.0,496.0,496.0,5,783,1.0,515.0,515.0
0.001,17,2,136,1,60,0.0,32.0,32.0,1,76,0.0,48.0,48.0
314.251,17,20,1124,10,716,34903.0,48.0,43.0,10,408,34902.0,20.0,12.0
0.006,6,10,1547,5,764,1.0,496.0,496.0,5,783,1.0,515.0,515.0
0.013,6,10,1989,5,910,3.0,642.0,642.0,5,1079,3.0,811.0,811.0
0.006,6,10,1547,5,764,1.0,496.0,496.0,5,783,1.0,515.0,515.0
0.005,6,14,3799,7,509,0.0,137.0,137.0,7,3290,0.0,1448.0,972.0
240.037,6,9,787,5,488,60009.0,232.0,232.0,4,299,80011.0,83.0,83.0
0.121,6,10,1506,5,395,28.0,127.0,127.0,5,1111,29.0,843.0,843.0
0.005,6,13,3747,7,509,0.0,137.0,137.0,6,3238,1.0,1470.0,1459.0
0.008,17,2,194,1,59,0.0,31.0,31.0,1,135,0.0,107.0,107.0
0.006,6,10,1547,5,764,1.0,496.0,496.0,5,783,1.0,515.0,515.0
0.094,6,10,1506,5,395,19.0,127.0,127.0,5,1111,21.0,843.0,843.0
0.011,6,10,1677,5,827,2.0,559.0,559.0,5,850,2.0,582.0,582.0
0.004,6,10,2006,5,927,1.0,659.0,659.0,5,1079,1.0,811.0,811.0
0.096,6,10,1506,5,395,21.0,127.0,127.0,5,1111,18.0,843.0,843.0
0.044,6,10,1989,5,910,10.0,642.0,642.0,5,1079,10.0,811.0,811.0
0.006,6,10,1547,5,764,1.0,496.0,496.0,5,783,1.0,515.0,515.0
240.172,6,32,9637,16,7107,16011.0,2178.0,697.0,16,2530,16011.0,580.0,211.0
0.009,6,14,3965,7,495,1.0,123.0,123.0,7,3470,1.0,1448.0,1032.0
300.364,6,16,2170,9,684,37524.0,146.0,146.0,7,1486,50031.0,419.0,398.0
0.096,6,10,1506,5,395,20.0,127.0,127.0,5,1111,22.0,843.0,843.0
0.009,6,10,1989,5,910,2.0,642.0,642.0,5,1079,2.0,811.0,811.0
0.012,17,2,140,1,62,0.0,34.0,34.0,1,78,0.0,50.0,50.0
0.004,6,10,1989,5,927,1.0,659.0,659.0,5,1062,1.0,794.0,794.0
0.005,6,13,3690,7,452,0.0,80.0,80.0,6,3238,0.0,1470.0,1459.0
0.006,6,10,1689,5,839,1.0,571.0,571.0,5,850,1.0,582.0,582.0
0.248,17,38,20051,21,17020,12.0,1350.0,782.0,17,3031,11.0,1350.0,150.0
40.06,17,10,676,5,460,10013.0,104.0,64.0,5,216,10014.0,20.0,15.0
0.131,6,10,1506,5,395,29.0,127.0,127.0,5,1111,29.0,843.0,843.0
0.128,17,2,136,1,60,0.0,32.0,32.0,1,76,0.0,48.0,48.0
0.042,17,2,184,1,61,0.0,33.0,33.0,1,123,0.0,95.0,95.0
0.006,6,13,3747,7,509,1.0,137.0,137.0,6,3238,1.0,1470.0,1459.0
0.005,6,14,3742,7,452,0.0,80.0,80.0,7,3290,0.0,1448.0,972.0
0.005,17,2,136,1,60,0.0,32.0,32.0,1,76,0.0,48.0,48.0
0.067,6,10,1506,5,395,13.0,127.0,127.0,5,1111,13.0,843.0,843.0
0.003,17,2,166,1,75,0.0,47.0,47.0,1,91,0.0,63.0,63.0
0.006,6,10,2006,5,927,1.0,659.0,659.0,5,1079,1.0,811.0,811.0
0.003,17,2,148,1,60,0.0,32.0,32.0,1,88,0.0,60.0,60.0
0.005,6,10,2007,5,928,1.0,660.0,660.0,5,1079,1.0,811.0,811.0
0.07,6,10,1506,5,395,17.0,127.0,127.0,5,1111,13.0,843.0,843.0
0.103,6,10,1506,5,395,22.0,127.0,127.0,5,1111,24.0,843.0,843.0
0.005,6,10,2006,5,927,1.0,659.0,659.0,5,1079,1.0,811.0,811.0
0.004,17,4,284,2,120,0.0,32.0,32.0,2,164,1.0,60.0,54.0
125.998,6,14,2938,8,2504,17965.0,1414.0,1086.0,6,434,25151.0,182.0,182.0
0.012,6,10,1989,5,910,3.0,642.0,642.0,5,1079,2.0,811.0,811.0
0.066,6,10,1506,5,395,15.0,127.0,127.0,5,1111,14.0,843.0,843.0
15.07,17,15,9238,8,6902,2148.0,1350.0,834.0,7,2336,2506.0,1350.0,305.0
0.087,6,10,1506,5,395,19.0,127.0,127.0,5,1111,18.0,843.0,843.0
0.007,6,10,1990,5,911,1.0,643.0,643.0,5,1079,1.0,811.0,811.0
0.012,6,10,1631,5,848,3.0,580.0,580.0,5,783,3.0,515.0,515.0
0.007,6,10,1989,5,910,1.0,642.0,642.0,5,1079,1.0,811.0,811.0
160.07,17,66,9451,33,2202,5002.0,44.0,38.0,33,7249,5002.0,239.0,191.0
0.009,6,10,1972,5,910,2.0,642.0,642.0,5,1062,2.0,794.0,794.0
0.163,17,2,152,1,76,0.0,48.0,48.0,1,76,0.0,48.0,48.0
0.004,6,10,2006,5,927,1.0,659.0,659.0,5,1079,1.0,811.0,811.0
0.005,6,10,2006,5,927,1.0,659.0,659.0,5,1079,1.0,811.0,811.0
0.008,6,10,1972,5,910,2.0,642.0,642.0,5,1062,1.0,794.0,794.0
0.934,6,25,8461,14,2077,71.0,1142.0,371.0,11,6384,76.0,2720.0,988.0
0.005,17,2,230,1,68,0.0,40.0,40.0,1,162,0.0,134.0,134.0
15.08,17,16,8580,8,6346,2150.0,1350.0,765.0,8,2234,2150.0,1350.0,251.0
0.021,6,10,1972,5,910,5.0,642.0,642.0,5,1062,5.0,794.0,794.0
173.404,17,80,11184,40,2663,4446.0,44.0,38.0,40,8521,4446.0,239.0,185.0
0.004,6,10,2006,5,927,1.0,659.0,659.0,5,1079,1.0,811.0,811.0
0.012,6,10,1990,5,911,3.0,643.0,643.0,5,1079,3.0,811.0,811.0
40.062,17,10,676,5,460,10013.0,104.0,64.0,5,216,10014.0,20.0,15.0
0.005,6,10,2000,5,927,1.0,659.0,659.0,5,1073,1.0,805.0,805.0
0.005,6,10,2006,5,927,1.0,659.0,659.0,5,1079,1.0,811.0,811.0
40.071,17,10,676,5,460,10014.0,104.0,64.0,5,216,10016.0,20.0,15.0
0.066,6,10,1506,5,395,13.0,127.0,127.0,5,1111,15.0,843.0,843.0
0.106,6,10,1506,5,395,24.0,127.0,127.0,5,1111,24.0,843.0,843.0
0.108,6,10,1506,5,395,24.0,127.0,127.0,5,1111,20.0,843.0,843.0
0.011,17,2,144,1,64,0.0,36.0,36.0,1,80,0.0,52.0,52.0
0.04,17,4,352,2,130,1.0,37.0,37.0,2,222,36.0,89.0,83.0
0.004,17,2,152,1,76,0.0,48.0,48.0,1,76,0.0,48.0,48.0
0.019,6,10,1990,5,911,4.0,643.0,643.0,5,1079,4.0,811.0,811.0
0.007,6,10,1989,5,927,1.0,659.0,659.0,5,1062,1.0,794.0,794.0
0.004,17,2,136,1,60,0.0,32.0,32.0,1,76,0.0,48.0,48.0
0.006,17,2,166,1,75,0.0,47.0,47.0,1,91,0.0,63.0,63.0
0.019,6,10,1990,5,911,4.0,643.0,643.0,5,1079,4.0,811.0,811.0
0.037,17,2,144,1,64,0.0,36.0,36.0,1,80,0.0,52.0,52.0
0.005,6,10,1989,5,927,1.0,659.0,659.0,5,1062,1.0,794.0,794.0
0.016,6,10,1972,5,910,4.0,642.0,642.0,5,1062,3.0,794.0,794.0
0.013,6,10,1989,5,910,3.0,642.0,642.0,5,1079,3.0,811.0,811.0
0.004,6,10,2006,5,927,1.0,659.0,659.0,5,1079,1.0,811.0,811.0
40.061,17,10,676,5,460,10014.0,104.0,64.0,5,216,10013.0,20.0,15.0
0.072,17,4,352,2,130,1.0,37.0,37.0,2,222,32.0,89.0,83.0
0.09,6,10,1506,5,395,20.0,127.0,127.0,5,1111,18.0,843.0,843.0
0.005,6,10,1989,5,927,1.0,659.0,659.0,5,1062,1.0,794.0,794.0
11.186,17,28,4419,14,1995,848.0,270.0,114.0,14,2424,848.0,587.0,145.0
40.069,17,10,676,5,460,10016.0,104.0,64.0,5,216,10016.0,20.0,15.0
0.124,17,2,144,1,64,0.0,36.0,36.0,1,80,0.0,52.0,52.0
0.012,6,10,1990,5,911,2.0,643.0,643.0,5,1079,2.0,811.0,811.0
0.007,6,10,1774,5,923,1.0,655.0,655.0,5,851,1.0,583.0,583.0
0.012,17,2,179,1,71,0.0,43.0,43.0,1,108,0.0,80.0,80.0
0.068,17,8,3613,4,1874,22.0,1350.0,440.0,4,1739,11.0,1350.0,406.0
0.008,6,10,1677,5,827,2.0,559.0,559.0,5,850,2.0,582.0,582.0
0.172,6,3,453,2,321,172.0,241.0,241.0,1,132,0.0,92.0,92.0
0.005,6,10,1547,5,764,1.0,496.0,496.0,5,783,1.0,515.0,515.0
0.001,17,2,180,1,66,0.0,38.0,38.0,1,114,0.0,86.0,86.0
0.01,6,13,3735,7,497,1.0,125.0,125.0,6,3238,1.0,1470.0,1459.0
0.01,6,10,1989,5,910,2.0,642.0,642.0,5,1079,2.0,811.0,811.0
0.018,6,10,1989,5,910,4.0,642.0,642.0,5,1079,4.0,811.0,811.0
240.107,6,16,4482,9,963,30013.0,238.0,166.0,7,3519,40016.0,1402.0,786.0
0.094,6,10,1506,5,395,20.0,127.0,127.0,5,1111,22.0,843.0,843.0
0.009,6,10,1989,5,910,2.0,642.0,642.0,5,1079,2.0,811.0,811.0
40.055,17,10,676,5,460,10013.0,104.0,64.0,5,216,10013.0,20.0,15.0
0.096,6,10,1506,5,395,23.0,127.0,127.0,5,1111,22.0,843.0,843.0
0.131,6,10,1506,5,395,32.0,127.0,127.0,5,1111,28.0,843.0,843.0
0.02,6,10,1990,5,911,5.0,643.0,643.0,5,1079,4.0,811.0,811.0
0.017,17,2,198,1,91,0.0,63.0,63.0,1,107,0.0,79.0,79.0
0.004,6,10,2006,5,927,1.0,659.0,659.0,5,1079,1.0,811.0,811.0
0.008,6,10,1990,5,911,1.0,643.0,643.0,5,1079,2.0,811.0,811.0
0.02,6,10,1677,5,827,5.0,559.0,559.0,5,850,4.0,582.0,582.0
0.098,6,10,1506,5,395,23.0,127.0,127.0,5,1111,21.0,843.0,843.0
0.006,6,10,2007,5,928,1.0,660.0,660.0,5,1079,1.0,811.0,811.0
0.005,6,10,2007,5,928,1.0,660.0,660.0,5,1079,1.0,811.0,811.0
0.037,17,2,152,1,76,0.0,48.0,48.0,1,76,0.0,48.0,48.0
0.005,17,2,175,1,65,0.0,37.0,37.0,1,110,0.0,82.0,82.0
0.005,6,10,2000,5,927,1.0,659.0,659.0,5,1073,1.0,805.0,805.0
0.098,6,10,1506,5,395,21.0,127.0,127.0,5,1111,20.0,843.0,843.0
361.785,6,21,1805,16,1042,24119.0,190.0,190.0,5,763,60010.0,462.0,247.0
0.006,6,10,1547,5,764,1.0,496.0,496.0,5,783,1.0,515.0,515.0
15.073,17,15,9238,8,6902,2148.0,1350.0,834.0,7,2336,2507.0,1350.0,305.0
0.045,17,2,396,1,61,0.0,33.0,33.0,1,335,0.0,307.0,307.0
0.091,6,10,1506,5,395,19.0,127.0,127.0,5,1111,20.0,843.0,843.0
0.005,6,10,2000,5,927,1.0,659.0,659.0,5,1073,1.0,805.0,805.0
0.072,17,4,596,2,122,1.0,33.0,33.0,2,474,34.0,323.0,209.0
0.001,17,2,180,1,66,0.0,38.0,38.0,1,114,0.0,86.0,86.0
0.004,6,10,2006,5,927,1.0,659.0,659.0,5,1079,1.0,811.0,811.0
0.004,17,2,136,1,60,0.0,32.0,32.0,1,76,0.0,48.0,48.0
0.005,6,10,1989,5,927,1.0,659.0,659.0,5,1062,1.0,794.0,794.0
0.008,6,10,1972,5,910,2.0,642.0,642.0,5,1062,1.0,794.0,794.0
0.006,6,10,1689,5,839,1.0,571.0,571.0,5,850,1.0,582.0,582.0
0.016,6,10,1762,5,911,4.0,643.0,643.0,5,851,3.0,583.0,583.0
367.22,6,24,2405,17,919,22951.0,195.0,195.0,7,1486,3912.0,419.0,398.0
0.004,6,10,1702,5,863,1.0,595.0,595.0,5,839,0.0,571.0,571.0
0.011,6,10,1989,5,910,2.0,642.0,642.0,5,1079,2.0,811.0,811.0
0.111,6,10,1506,5,395,27.0,127.0,127.0,5,1111,26.0,843.0,843.0
0.005,6,10,2000,5,927,1.0,659.0,659.0,5,1073,1.0,805.0,805.0
0.005,17,2,180,1,66,0.0,38.0,38.0,1,114,0.0,86.0,86.0
0.105,6,10,1506,5,395,23.0,127.0,127.0,5,1111,22.0,843.0,843.0
0.099,6,10,1506,5,395,19.0,127.0,127.0,5,1111,22.0,843.0,843.0
15.08,17,15,9238,8,6902,2149.0,1350.0,834.0,7,2336,2508.0,1350.0,305.0
180.485,6,61,19322,34,4828,5469.0,1054.0,236.0,27,14494,6941.0,2804.0,770.0
0.01,6,10,1972,5,910,2.0,642.0,642.0,5,1062,2.0,794.0,794.0
354.096,6,19,1691,15,978,25292.0,190.0,190.0,4,713,80003.0,497.0,497.0
0.006,6,10,1547,5,764,1.0,496.0,496.0,5,783,1.0,515.0,515.0
0.097,6,10,1506,5,395,15.0,127.0,127.0,5,1111,23.0,843.0,843.0
40.058,17,10,676,5,460,10013.0,104.0,64.0,5,216,10013.0,20.0,15.0
0.005,17,2,166,1,75,0.0,47.0,47.0,1,91,0.0,63.0,63.0
0.003,17,2,148,1,60,0.0,32.0,32.0,1,88,0.0,60.0,60.0
0.005,6,10,2006,5,927,1.0,659.0,659.0,5,1079,1.0,811.0,811.0
0.074,6,10,1506,5,395,18.0,127.0,127.0,5,1111,12.0,843.0,843.0
0.005,6,10,2007,5,928,1.0,660.0,660.0,5,1079,1.0,811.0,811.0
0.084,6,10,1506,5,395,18.0,127.0,127.0,5,1111,19.0,843.0,843.0
0.004,6,10,1702,5,863,1.0,595.0,595.0,5,839,1.0,571.0,571.0
0.005,6,10,2006,5,927,1.0,659.0,659.0,5,1079,1.0,811.0,811.0
0.015,6,10,1990,5,911,3.0,643.0,643.0,5,1079,3.0,811.0,811.0
0.011,6,10,1989,5,910,2.0,642.0,642.0,5,1079,2.0,811.0,811.0
0.089,6,10,1506,5,395,19.0,127.0,127.0,5,1111,20.0,843.0,843.0
0.006,6,10,1547,5,764,1.0,496.0,496.0,5,783,1.0,515.0,515.0
10.809,17,28,4422,14,1993,822.0,268.0,114.0,14,2429,822.0,588.0,145.0
15.07,17,14,9190,8,6902,2148.0,1350.0,834.0,6,2288,3008.0,1350.0,353.0
0.004,6,10,1989,5,927,1.0,659.0,659.0,5,1062,1.0,794.0,794.0
0.01,6,10,1989,5,910,2.0,642.0,642.0,5,1079,2.0,811.0,811.0
0.008,17,2,170,1,65,0.0,37.0,37.0,1,105,0.0,77.0,77.0
15.072,17,15,9238,8,6902,2149.0,1350.0,834.0,7,2336,2507.0,1350.0,305.0
0.068,17,8,3613,4,1874,22.0,1350.0,440.0,4,1739,11.0,1350.0,406.0
0.001,17,2,136,1,60,0.0,32.0,32.0,1,76,0.0,48.0,48.0
0.006,6,10,1643,5,860,1.0,592.0,592.0,5,783,1.0,515.0,515.0
0.07,6,10,1506,5,395,17.0,127.0,127.0,5,1111,13.0,843.0,843.0
0.01,6,10,1983,5,910,2.0,642.0,642.0,5,1073,2.0,805.0,805.0
0.006,6,10,1779,5,928,1.0,660.0,660.0,5,851,1.0,583.0,583.0
0.129,17,2,80,1,32,0.0,4.0,4.0,1,48,0.0,20.0,20.0
0.013,6,10,1677,5,827,3.0,559.0,559.0,5,850,3.0,582.0,582.0
0.006,6,10,1689,5,839,1.0,571.0,571.0,5,850,1.0,582.0,582.0
368.472,6,22,2313,16,867,24564.0,195.0,195.0,6,1446,4635.0,419.0,398.0
1777.558,17,144,45504,72,22752,25035.0,288.0,288.0,72,22752,25035.0,288.0,288.0
0.005,17,2,136,1,60,0.0,32.0,32.0,1,76,0.0,48.0,48.0
0.119,6,10,1506,5,395,26.0,127.0,127.0,5,1111,26.0,843.0,843.0
0.011,6,13,3735,7,497,1.0,125.0,125.0,6,3238,2.0,1470.0,1459.0
169.265,17,76,10696,38,2530,4574.0,44.0,38.0,38,8166,4574.0,239.0,186.0
0.003,17,2,208,1,72,0.0,44.0,44.0,1,136,0.0,108.0,108.0
0.02,6,10,1983,5,910,5.0,642.0,642.0,5,1073,4.0,805.0,805.0
0.037,17,2,148,1,60,0.0,32.0,32.0,1,88,0.0,60.0,60.0
0.004,6,10,2006,5,927,1.0,659.0,659.0,5,1079,1.0,811.0,811.0
0.005,17,2,214,1,75,0.0,47.0,47.0,1,139,0.0,111.0,111.0
0.003,17,2,184,1,61,0.0,33.0,33.0,1,123,0.0,95.0,95.0
327.546,17,20,1124,10,716,36379.0,48.0,43.0,10,408,36379.0,20.0,12.0
0.017,6,10,1983,5,910,4.0,642.0,642.0,5,1073,4.0,805.0,805.0
0.086,6,10,1506,5,395,19.0,127.0,127.0,5,1111,16.0,843.0,843.0
0.006,6,10,1547,5,764,1.0,496.0,496.0,5,783,1.0,515.0,515.0
0.04,17,4,532,2,122,0.0,33.0,33.0,2,410,0.0,259.0,177.0
0.006,6,10,2000,5,927,1.0,659.0,659.0,5,1073,1.0,805.0,805.0
0.004,6,10,2000,5,927,1.0,659.0,659.0,5,1073,1.0,805.0,805.0
15.285,17,17,9360,8,4348,2179.0,1350.0,515.0,9,5012,1906.0,1350.0,528.0
0.013,6,10,1631,5,848,3.0,580.0,580.0,5,783,3.0,515.0,515.0
0.065,6,10,1506,5,395,13.0,127.0,127.0,5,1111,14.0,843.0,843.0
40.062,17,10,676,5,460,10014.0,104.0,64.0,5,216,10014.0,20.0,15.0
0.001,17,2,136,1,60,0.0,32.0,32.0,1,76,0.0,48.0,48.0
0.006,6,10,1689,5,839,1.0,571.0,571.0,5,850,1.0,582.0,582.0
0.013,6,13,3735,7,497,2.0,125.0,125.0,6,3238,2.0,1470.0,1459.0
159.525,17,82,11740,41,2734,3988.0,44.0,38.0,41,9006,3988.0,261.0,191.0
0.114,6,10,1506,5,395,23.0,127.0,127.0,5,1111,23.0,843.0,843.0
240.345,6,33,9267,16,1834,16022.0,622.0,198.0,17,7433,15021.0,1402.0,595.0
0.02,6,10,1989,5,910,5.0,642.0,642.0,5,1079,4.0,811.0,811.0
0.004,6,10,2000,5,927,1.0,659.0,659.0,5,1073,1.0,805.0,805.0
0.013,6,10,1677,5,827,3.0,559.0,559.0,5,850,3.0,582.0,582.0
10.885,17,28,4416,14,1993,828.0,268.0,114.0,14,2423,828.0,586.0,145.0
0.005,17,2,214,1,75,0.0,47.0,47.0,1,139,0.0,111.0,111.0
0.018,6,10,1989,5,910,4.0,642.0,642.0,5,1079,4.0,811.0,811.0
0.112,6,10,1506,5,395,23.0,127.0,127.0,5,1111,23.0,843.0,843.0
0.005,6,13,3747,7,509,0.0,137.0,137.0,6,3238,0.0,1470.0,1459.0
0.005,6,10,1779,5,928,1.0,660.0,660.0,5,851,1.0,583.0,583.0
0.089,6,10,1506,5,395,18.0,127.0,127.0,5,1111,18.0,843.0,843.0
0.005,6,10,1779,5,928,1.0,660.0,660.0,5,851,1.0,583.0,583.0
0.004,17,4,596,2,122,0.0,33.0,33.0,2,474,0.0,323.0,209.0
0.005,6,10,1779,5,928,1.0,660.0,660.0,5,851,1.0,583.0,583.0
40.054,17,10,676,5,460,10012.0,104.0,64.0,5,216,10012.0,20.0,15.0
0.003,17,4,284,2,120,0.0,32.0,32.0,2,164,0.0,60.0,54.0
0.004,6,10,2007,5,928,1.0,660.0,660.0,5,1079,1.0,811.0,811.0
0.005,6,10,2007,5,928,1.0,660.0,660.0,5,1079,1.0,811.0,811.0
0.004,6,10,2006,5,927,1.0,659.0,659.0,5,1079,1.0,811.0,811.0
0.004,6,10,2006,5,927,1.0,659.0,659.0,5,1079,1.0,811.0,811.0
0.005,6,10,2000,5,927,1.0,659.0,659.0,5,1073,1.0,805.0,805.0
1786.405,6,150,19350,90,13740,20071.0,302.0,302.0,60,5610,30277.0,83.0,83.0
0.005,17,2,170,1,65,0.0,37.0,37.0,1,105,0.0,77.0,77.0
0.004,17,2,180,1,58,0.0,30.0,30.0,1,122,0.0,94.0,94.0
0.005,6,13,3747,7,509,0.0,137.0,137.0,6,3238,1.0,1470.0,1459.0
0.018,6,10,1989,5,910,4.0,642.0,642.0,5,1079,4.0,811.0,811.0
240.091,6,16,4480,9,963,30011.0,238.0,166.0,7,3517,40014.0,1402.0,786.0
0.004,17,2,148,1,60,0.0,32.0,32.0,1,88,0.0,60.0,60.0
0.005,6,10,2007,5,928,1.0,660.0,660.0,5,1079,1.0,811.0,811.0
0.137,6,10,1506,5,395,33.0,127.0,127.0,5,1111,29.0,843.0,843.0
0.006,6,10,1547,5,764,1.0,496.0,496.0,5,783,1.0,515.0,515.0
0.005,6,10,2006,5,927,1.0,659.0,659.0,5,1079,1.0,811.0,811.0
0.005,6,10,2007,5,928,1.0,660.0,660.0,5,1079,1.0,811.0,811.0
0.007,6,10,1990,5,911,1.0,643.0,643.0,5,1079,1.0,811.0,811.0
300.422,6,16,2170,9,684,37532.0,146.0,146.0,7,1486,50043.0,419.0,398.0
308.246,17,18,1008,9,640,38523.0,48.0,43.0,9,368,38523.0,20.0,12.0
0.004,6,10,1779,5,928,1.0,660.0,660.0,5,851,1.0,583.0,583.0
0.013,6,10,1972,5,910,3.0,642.0,642.0,5,1062,3.0,794.0,794.0
0.004,6,10,1702,5,863,1.0,595.0,595.0,5,839,1.0,571.0,571.0
0.014,6,10,1972,5,910,3.0,642.0,642.0,5,1062,3.0,794.0,794.0
0.016,6,10,1989,5,910,4.0,642.0,642.0,5,1079,3.0,811.0,811.0
0.009,6,12,1926,6,1189,1.0,659.0,434.0,6,737,1.0,417.0,417.0
0.012,6,14,3787,7,497,1.0,125.0,125.0,7,3290,1.0,1448.0,972.0
0.007,17,2,179,1,71,0.0,43.0,43.0,1,108,0.0,80.0,80.0
0.005,6,10,1854,5,889,1.0,621.0,621.0,5,965,1.0,697.0,697.0
0.006,6,10,2006,5,927,1.0,659.0,659.0,5,1079,1.0,811.0,811.0
240.13,6,16,4481,9,963,30016.0,238.0,166.0,7,3518,40019.0,1402.0,786.0
0.004,17,4,284,2,120,0.0,32.0,32.0,2,164,1.0,60.0,54.0
0.004,17,2,136,1,60,0.0,32.0,32.0,1,76,0.0,48.0,48.0
0.006,6,10,1689,5,839,1.0,571.0,571.0,5,850,1.0,582.0,582.0
0.006,17,2,168,1,76,0.0,48.0,48.0,1,92,0.0,64.0,64.0
0.006,6,10,2006,5,927,1.0,659.0,659.0,5,1079,1.0,811.0,811.0
280.707,6,25,6480,11,1226,28070.0,267.0,156.0,14,5254,21590.0,1400.0,781.0
308.604,17,20,1124,10,716,34275.0,48.0,43.0,10,408,34275.0,20.0,12.0
0.004,17,2,136,1,60,0.0,32.0,32.0,1,76,0.0,48.0,48.0
0.005,17,2,179,1,71,0.0,43.0,43.0,1,108,0.0,80.0,80.0
0.014,6,10,1972,5,910,3.0,642.0,642.0,5,1062,3.0,794.0,794.0
40.064,17,10,676,5,460,10013.0,104.0,64.0,5,216,10015.0,20.0,15.0
0.012,17,2,152,1,68,0.0,40.0,40.0,1,84,0.0,56.0,56.0
0.01,6,10,1983,5,910,2.0,642.0,642.0,5,1073,2.0,805.0,805.0
0.005,6,10,2007,5,928,1.0,660.0,660.0,5,1079,1.0,811.0,811.0
0.004,17,2,136,1,60,0.0,32.0,32.0,1,76,0.0,48.0,48.0
0.08,6,10,1506,5,395,17.0,127.0,127.0,5,1111,16.0,843.0,843.0
0.013,6,10,1989,5,910,3.0,642.0,642.0,5,1079,3.0,811.0,811.0
0.134,6,10,1506,5,395,29.0,127.0,127.0,5,1111,30.0,843.0,843.0
0.009,6,10,1983,5,910,2.0,642.0,642.0,5,1073,2.0,805.0,805.0
0.005,6,10,2007,5,928,1.0,660.0,660.0,5,1079,1.0,811.0,811.0
0.185,6,10,1506,5,395,43.0,127.0,127.0,5,1111,40.0,843.0,843.0
0.004,6,10,1989,5,927,1.0,659.0,659.0,5,1062,1.0,794.0,794.0
0.005,6,10,2006,5,927,1.0,659.0,659.0,5,1079,1.0,811.0,811.0
40.06,17,10,676,5,460,10012.0,104.0,64.0,5,216,10014.0,20.0,15.0
176.067,17,80,11642,40,2690,4514.0,44.0,39.0,40,8952,4514.0,239.0,195.0
0.012,17,2,144,1,64,0.0,36.0,36.0,1,80,0.0,52.0,52.0
0.006,17,2,214,1,75,0.0,47.0,47.0,1,139,0.0,111.0,111.0
0.005,6,10,2007,5,928,1.0,660.0,660.0,5,1079,1.0,811.0,811.0
0.117,6,10,1506,5,395,27.0,127.0,127.0,5,1111,25.0,843.0,843.0
0.006,17,2,193,1,71,0.0,43.0,43.0,1,122,0.0,94.0,94.0
11.075,17,28,4418,14,1994,839.0,269.0,114.0,14,2424,839.0,587.0,145.0
361.875,6,21,1793,16,1030,24125.0,190.0,190.0,5,763,60009.0,462.0,247.0
1799.397,6,506,78984,274,41211,6590.0,1877.0,222.0,232,37773,7789.0,1402.0,166.0
0.01,6,13,3735,7,497,1.0,125.0,125.0,6,3238,2.0,1470.0,1459.0
0.009,6,12,1926,6,1189,1.0,659.0,434.0,6,737,1.0,417.0,417.0
0.005,6,14,3736,7,446,0.0,74.0,74.0,7,3290,0.0,1448.0,972.0
0.004,6,10,1702,5,863,1.0,595.0,595.0,5,839,0.0,571.0,571.0
0.005,6,10,1643,5,860,1.0,592.0,592.0,5,783,1.0,515.0,515.0
0.02,6,10,1989,5,910,4.0,642.0,642.0,5,1079,4.0,811.0,811.0
0.005,17,2,144,1,64,0.0,36.0,36.0,1,80,0.0,52.0,52.0
0.005,6,10,2000,5,927,1.0,659.0,659.0,5,1073,1.0,805.0,805.0
0.013,6,10,1972,5,910,3.0,642.0,642.0,5,1062,3.0,794.0,794.0
0.004,6,10,1779,5,928,1.0,660.0,660.0,5,851,1.0,583.0,583.0
40.05,17,10,676,5,460,10011.0,104.0,64.0,5,216,10011.0,20.0,15.0
0.005,6,10,1547,5,764,1.0,496.0,496.0,5,783,1.0,515.0,515.0
0.081,6,10,1506,5,395,17.0,127.0,127.0,5,1111,17.0,843.0,843.0
0.004,17,2,148,1,60,0.0,32.0,32.0,1,88,0.0,60.0,60.0
0.005,17,2,180,1,66,0.0,38.0,38.0,1,114,0.0,86.0,86.0
0.071,17,2,136,1,60,0.0,32.0,32.0,1,76,0.0,48.0,48.0
0.278,17,39,20254,21,17037,13.0,1350.0,783.0,18,3217,12.0,1350.0,150.0
0.005,6,10,2007,5,928,1.0,660.0,660.0,5,1079,1.0,811.0,811.0
336.219,17,20,1124,10,716,37343.0,48.0,43.0,10,408,37344.0,20.0,12.0
0.006,6,10,1779,5,928,1.0,660.0,660.0,5,851,1.0,583.0,583.0
0.005,6,10,1989,5,927,1.0,659.0,659.0,5,1062,1.0,794.0,794.0
0.009,6,10,1972,5,910,2.0,642.0,642.0,5,1062,2.0,794.0,794.0
0.005,6,10,1989,5,927,1.0,659.0,659.0,5,1062,1.0,794.0,794.0
1745.165,6,300,97290,185,86215,9484.0,1402.0,677.0,115,11075,15308.0,452.0,70.0
240.092,6,16,4481,9,963,30011.0,238.0,166.0,7,3518,40014.0,1402.0,786.0
0.085,6,10,1506,5,395,17.0,127.0,127.0,5,1111,18.0,843.0,843.0
367.141,6,22,2313,16,867,24476.0,195.0,195.0,6,1446,4651.0,419.0,398.0
0.119,6,10,1506,5,395,27.0,127.0,127.0,5,1111,27.0,843.0,843.0
0.011,6,10,1989,5,910,2.0,642.0,642.0,5,1079,2.0,811.0,811.0
120.765,6,60,19250,33,4819,3773.0,1054.0,221.0,27,14431,4644.0,2804.0,867.0
0.005,6,10,1989,5,927,1.0,659.0,659.0,5,1062,1.0,794.0,794.0
0.004,17,2,148,1,60,0.0,32.0,32.0,1,88,0.0,60.0,60.0
0.037,17,2,412,1,61,0.0,33.0,33.0,1,351,0.0,323.0,323.0
0.005,6,10,2007,5,928,1.0,660.0,660.0,5,1079,1.0,811.0,811.0
0.087,6,10,1506,5,395,18.0,127.0,127.0,5,1111,20.0,843.0,843.0
0.009,6,12,1926,6,1189,1.0,659.0,434.0,6,737,1.0,417.0,417.0
0.013,6,10,1989,5,910,3.0,642.0,642.0,5,1079,3.0,811.0,811.0
0.016,6,13,3735,7,497,2.0,125.0,125.0,6,3238,3.0,1470.0,1459.0
0.005,6,10,1774,5,923,1.0,655.0,655.0,5,851,1.0,583.0,583.0
10.909,17,26,4100,13,1821,899.0,268.0,112.0,13,2279,899.0,586.0,147.0
0.074,6,10,1506,5,395,16.0,127.0,127.0,5,1111,16.0,843.0,843.0
0.086,6,10,1506,5,395,19.0,127.0,127.0,5,1111,17.0,843.0,843.0
0.005,17,2,213,1,69,0.0,41.0,41.0,1,144,0.0,116.0,116.0
40.067,17,10,676,5,460,10015.0,104.0,64.0,5,216,10013.0,20.0,15.0
0.006,6,10,1547,5,764,1.0,496.0,496.0,5,783,1.0,515.0,515.0
0.074,6,10,1506,5,395,17.0,127.0,127.0,5,1111,15.0,843.0,843.0
0.006,6,10,1547,5,764,1.0,496.0,496.0,5,783,1.0,515.0,515.0
0.005,6,10,1689,5,839,1.0,571.0,571.0,5,850,1.0,582.0,582.0
0.009,6,12,1926,6,1189,1.0,659.0,434.0,6,737,1.0,417.0,417.0
0.083,6,10,1506,5,395,19.0,127.0,127.0,5,1111,17.0,843.0,843.0
177.035,17,76,10987,38,2541,4784.0,44.0,38.0,38,8446,4784.0,260.0,194.0
0.005,6,10,1989,5,927,1.0,659.0,659.0,5,1062,1.0,794.0,794.0
0.011,6,10,1990,5,911,2.0,643.0,643.0,5,1079,2.0,811.0,811.0
0.059,6,10,1506,5,395,13.0,127.0,127.0,5,1111,13.0,843.0,843.0
0.001,17,2,180,1,66,0.0,38.0,38.0,1,114,0.0,86.0,86.0
0.124,17,4,284,2,120,0.0,32.0,32.0,2,164,120.0,60.0,54.0
0.009,6,10,1989,5,910,2.0,642.0,642.0,5,1079,2.0,811.0,811.0
0.007,6,10,1547,5,764,1.0,496.0,496.0,5,783,1.0,515.0,515.0
0.001,17,2,136,1,60,0.0,32.0,32.0,1,76,0.0,48.0,48.0
0.017,6,10,2006,5,927,4.0,659.0,659.0,5,1079,4.0,811.0,811.0
0.007,6,13,3684,7,446,1.0,74.0,74.0,6,3238,1.0,1470.0,1459.0
0.021,17,4,284,2,120,1.0,32.0,32.0,2,164,0.0,60.0,54.0
0.02,6,10,1989,5,910,5.0,642.0,642.0,5,1079,4.0,811.0,811.0
240.109,6,31,9047,15,6676,17150.0,1799.0,655.0,16,2371,16007.0,580.0,191.0
0.062,6,10,1506,5,395,13.0,127.0,127.0,5,1111,13.0,843.0,843.0
0.074,6,10,1506,5,395,16.0,127.0,127.0,5,1111,14.0,843.0,843.0
0.011,6,10,1677,5,827,2.0,559.0,559.0,5,850,2.0,582.0,582.0
0.115,6,10,1506,5,395,24.0,127.0,127.0,5,1111,24.0,843.0,843.0
10.828,17,28,4420,14,1993,824.0,268.0,114.0,14,2427,824.0,586.0,145.0
352.241,6,20,2210,6,1308,12003.0,494.0,494.0,14,902,27095.0,83.0,83.0
0.004,6,10,1989,5,927,1.0,659.0,659.0,5,1062,1.0,794.0,794.0
0.005,6,10,2006,5,927,1.0,659.0,659.0,5,1079,1.0,811.0,811.0
318.095,17,20,1124,10,716,35329.0,48.0,43.0,10,408,35329.0,20.0,12.0
0.008,6,10,1631,5,848,2.0,580.0,580.0,5,783,2.0,515.0,515.0
0.004,17,2,148,1,60,0.0,32.0,32.0,1,88,0.0,60.0,60.0
10.79,17,28,4418,14,1994,821.0,269.0,114.0,14,2424,821.0,587.0,145.0
0.04,17,4,352,2,130,1.0,37.0,37.0,2,222,1.0,89.0,83.0
0.003,17,2,142,1,63,0.0,35.0,35.0,1,79,0.0,51.0,51.0
0.071,17,2,136,1,60,0.0,32.0,32.0,1,76,0.0,48.0,48.0
0.008,6,10,1989,5,910,2.0,642.0,642.0,5,1079,2.0,811.0,811.0
0.071,6,10,1506,5,395,16.0,127.0,127.0,5,1111,16.0,843.0,843.0
0.015,6,10,1983,5,910,3.0,642.0,642.0,5,1073,3.0,805.0,805.0
0.008,6,10,1972,5,910,2.0,642.0,642.0,5,1062,1.0,794.0,794.0
0.004,6,10,1989,5,927,1.0,659.0,659.0,5,1062,1.0,794.0,794.0
0.005,6,10,1689,5,839,1.0,571.0,571.0,5,850,1.0,582.0,582.0
0.097,6,10,1506,5,395,19.0,127.0,127.0,5,1111,21.0,843.0,843.0
0.096,6,10,1506,5,395,23.0,127.0,127.0,5,1111,22.0,843.0,843.0
0.006,6,10,1643,5,860,1.0,592.0,592.0,5,783,1.0,515.0,515.0
0.014,6,10,1983,5,910,3.0,642.0,642.0,5,1073,3.0,805.0,805.0
0.004,6,10,2007,5,928,1.0,660.0,660.0,5,1079,1.0,811.0,811.0
0.097,6,10,1506,5,395,21.0,127.0,127.0,5,1111,23.0,843.0,843.0
0.02,6,10,1989,5,910,5.0,642.0,642.0,5,1079,5.0,811.0,811.0
0.005,6,10,1989,5,927,1.0,659.0,659.0,5,1062,1.0,794.0,794.0
0.006,6,10,1547,5,764,1.0,496.0,496.0,5,783,1.0,515.0,515.0
0.001,17,2,179,1,62,0.0,34.0,34.0,1,117,0.0,89.0,89.0
0.005,6,14,3736,7,446,0.0,74.0,74.0,7,3290,0.0,1448.0,972.0
0.076,6,10,1506,5,395,14.0,127.0,127.0,5,1111,18.0,843.0,843.0
0.379,17,16,9973,8,6917,54.0,1350.0,836.0,8,3056,41.0,1350.0,354.0
0.082,6,10,1506,5,395,17.0,127.0,127.0,5,1111,17.0,843.0,843.0
0.012,6,10,1983,5,910,3.0,642.0,642.0,5,1073,3.0,805.0,805.0
0.08,6,10,1506,5,395,17.0,127.0,127.0,5,1111,17.0,843.0,843.0
0.206,6,16,2669,8,1395,29.0,533.0,323.0,8,1274,18.0,529.0,212.0
0.004,6,10,2000,5,927,1.0,659.0,659.0,5,1073,1.0,805.0,805.0
0.005,6,13,3747,7,509,0.0,137.0,137.0,6,3238,0.0,1470.0,1459.0
0.021,6,10,1989,5,910,5.0,642.0,642.0,5,1079,5.0,811.0,811.0
0.005,6,10,1779,5,928,1.0,660.0,660.0,5,851,1.0,583.0,583.0
0.005,6,10,2006,5,927,1.0,659.0,659.0,5,1079,1.0,811.0,811.0
0.012,6,10,1990,5,911,3.0,643.0,643.0,5,1079,2.0,811.0,811.0
0.145,17,4,352,2,130,107.0,37.0,37.0,2,222,141.0,89.0,83.0
0.072,6,10,1506,5,395,16.0,127.0,127.0,5,1111,16.0,843.0,843.0
0.008,6,10,1983,5,910,2.0,642.0,642.0,5,1073,2.0,805.0,805.0
0.014,6,10,1989,5,910,3.0,642.0,642.0,5,1079,3.0,811.0,811.0
0.039,17,2,148,1,60,0.0,32.0,32.0,1,88,0.0,60.0,60.0
40.061,17,10,676,5,460,10014.0,104.0,64.0,5,216,10014.0,20.0,15.0
0.004,17,2,148,1,60,0.0,32.0,32.0,1,88,0.0,60.0,60.0
0.135,6,10,1506,5,395,28.0,127.0,127.0,5,1111,32.0,843.0,843.0
40.065,17,10,676,5,460,10015.0,104.0,64.0,5,216,10015.0,20.0,15.0
240.083,6,19,4664,9,2169,30010.0,966.0,568.0,10,2495,26675.0,1162.0,393.0
0.095,6,10,1506,5,395,20.0,127.0,127.0,5,1111,22.0,843.0,843.0
269.497,6,52,20130,25,12495,11229.0,2736.0,1244.0,27,7635,10365.0,1162.0,366.0
0.039,17,2,148,1,60,0.0,32.0,32.0,1,88,0.0,60.0,60.0
0.005,6,14,3799,7,509,0.0,137.0,137.0,7,3290,0.0,1448.0,972.0
0.008,6,10,1677,5,827,2.0,559.0,559.0,5,850,2.0,582.0,582.0
0.011,6,10,1972,5,910,2.0,642.0,642.0,5,1062,2.0,794.0,794.0
0.005,6,10,2007,5,928,1.0,660.0,660.0,5,1079,1.0,811.0,811.0
0.063,6,10,1506,5,395,14.0,127.0,127.0,5,1111,12.0,843.0,843.0
0.001,17,2,180,1,66,0.0,38.0,38.0,1,114,0.0,86.0,86.0
300.41,6,27,7433,16,1409,20027.0,217.0,142.0,11,6024,24036.0,1679.0,777.0
0.004,17,2,136,1,60,0.0,32.0,32.0,1,76,0.0,48.0,48.0
11.392,17,27,4245,13,1846,935.0,269.0,114.0,14,2399,863.0,586.0,143.0
0.003,17,2,136,1,60,0.0,32.0,32.0,1,76,0.0,48.0,48.0
0.004,6,10,1779,5,928,1.0,660.0,660.0,5,851,1.0,583.0,583.0
0.072,17,4,420,2,122,0.0,33.0,33.0,2,298,35.0,145.0,121.0
0.021,6,10,1989,5,910,5.0,642.0,642.0,5,1079,5.0,811.0,811.0
0.075,6,10,1506,5,395,17.0,127.0,127.0,5,1111,16.0,843.0,843.0
0.004,6,10,1702,5,863,1.0,595.0,595.0,5,839,1.0,571.0,571.0
0.006,6,10,1547,5,764,1.0,496.0,496.0,5,783,1.0,515.0,515.0
40.066,17,10,676,5,460,10015.0,104.0,64.0,5,216,10015.0,20.0,15.0
0.056,17,2,179,1,71,0.0,43.0,43.0,1,108,0.0,80.0,80.0
0.006,17,2,179,1,71,0.0,43.0,43.0,1,108,0.0,80.0,80.0
0.015,6,10,1990,5,911,3.0,643.0,643.0,5,1079,3.0,811.0,811.0
0.157,6,10,1506,5,395,19.0,127.0,127.0,5,1111,37.0,843.0,843.0
0.115,6,10,1506,5,395,26.0,127.0,127.0,5,1111,17.0,843.0,843.0
0.005,6,10,1643,5,860,1.0,592.0,592.0,5,783,1.0,515.0,515.0
0.073,6,10,1506,5,395,15.0,127.0,127.0,5,1111,17.0,843.0,843.0
0.013,6,10,1989,5,910,3.0,642.0,642.0,5,1079,3.0,811.0,811.0
0.009,6,12,1926,6,1189,1.0,659.0,434.0,6,737,1.0,417.0,417.0
0.007,6,10,2000,5,927,1.0,659.0,659.0,5,1073,1.0,805.0,805.0
0.004,6,10,2006,5,927,1.0,659.0,659.0,5,1079,1.0,811.0,811.0
0.017,6,10,1990,5,911,4.0,643.0,643.0,5,1079,4.0,811.0,811.0
0.014,6,10,1989,5,910,3.0,642.0,642.0,5,1079,3.0,811.0,811.0
0.09,6,10,1506,5,395,18.0,127.0,127.0,5,1111,19.0,843.0,843.0
0.073,6,10,1506,5,395,16.0,127.0,127.0,5,1111,16.0,843.0,843.0
0.005,17,2,140,1,62,0.0,34.0,34.0,1,78,0.0,50.0,50.0
0.091,6,10,1506,5,395,20.0,127.0,127.0,5,1111,20.0,843.0,843.0
0.072,6,10,1506,5,395,15.0,127.0,127.0,5,1111,13.0,843.0,843.0
0.005,6,10,1689,5,839,1.0,571.0,571.0,5,850,1.0,582.0,582.0
0.078,6,10,1506,5,395,15.0,127.0,127.0,5,1111,18.0,843.0,843.0
15.083,17,15,8397,8,6187,2150.0,1350.0,745.0,7,2210,2508.0,1350.0,287.0
0.005,6,10,1643,5,860,1.0,592.0,592.0,5,783,1.0,515.0,515.0
0.006,17,2,275,1,67,0.0,39.0,39.0,1,208,0.0,180.0,180.0
0.006,17,2,136,1,60,0.0,32.0,32.0,1,76,0.0,48.0,48.0
40.067,17,10,676,5,460,10014.0,104.0,64.0,5,216,10016.0,20.0,15.0
0.005,17,2,170,1,65,0.0,37.0,37.0,1,105,0.0,77.0,77.0
6.127,6,26,12118,14,1040,471.0,304.0,304.0,12,11078,556.0,1402.0,1160.0
0.004,17,2,136,1,60,0.0,32.0,32.0,1,76,0.0,48.0,48.0
0.004,6,10,2007,5,928,1.0,660.0,660.0,5,1079,1.0,811.0,811.0
0.041,17,2,148,1,60,0.0,32.0,32.0,1,88,0.0,60.0,60.0
0.002,17,2,180,1,66,0.0,38.0,38.0,1,114,0.0,86.0,86.0
0.007,17,2,179,1,71,0.0,43.0,43.0,1,108,0.0,80.0,80.0
0.004,6,10,2000,5,927,1.0,659.0,659.0,5,1073,1.0,805.0,805.0
0.006,6,10,1547,5,764,1.0,496.0,496.0,5,783,1.0,515.0,515.0
0.005,6,10,1774,5,923,1.0,655.0,655.0,5,851,1.0,583.0,583.0
0.005,6,13,3690,7,452,0.0,80.0,80.0,6,3238,0.0,1470.0,1459.0
0.012,6,10,1989,5,910,3.0,642.0,642.0,5,1079,3.0,811.0,811.0
40.059,17,10,676,5,460,10013.0,104.0,64.0,5,216,10013.0,20.0,15.0
0.529,6,43,11499,24,3222,23.0,1022.0,197.0,19,8277,29.0,1402.0,606.0
0.005,6,10,2007,5,928,1.0,660.0,660.0,5,1079,1.0,811.0,811.0
0.017,6,10,1989,5,910,4.0,642.0,642.0,5,1079,4.0,811.0,811.0
426.769,6,28,4357,12,3102,10912.0,494.0,494.0,16,1255,28451.0,83.0,83.0
0.015,6,10,1972,5,910,3.0,642.0,642.0,5,1062,3.0,794.0,794.0
40.111,17,10,676,5,460,10023.0,104.0,64.0,5,216,10021.0,20.0,15.0
0.004,17,4,284,2,120,0.0,32.0,32.0,2,164,0.0,60.0,54.0
0.014,6,10,1972,5,910,3.0,642.0,642.0,5,1062,3.0,794.0,794.0
300.361,6,16,2170,9,684,37522.0,146.0,146.0,7,1486,50032.0,419.0,398.0
0.004,6,10,2007,5,928,1.0,660.0,660.0,5,1079,1.0,811.0,811.0
0.008,6,10,1643,5,860,2.0,592.0,592.0,5,783,1.0,515.0,515.0
0.008,6,10,1989,5,910,1.0,642.0,642.0,5,1079,2.0,811.0,811.0
0.004,17,4,284,2,120,0.0,32.0,32.0,2,164,0.0,60.0,54.0
0.085,6,10,1506,5,395,17.0,127.0,127.0,5,1111,16.0,843.0,843.0
0.108,6,10,1506,5,395,23.0,127.0,127.0,5,1111,24.0,843.0,843.0
0.012,6,10,1989,5,910,3.0,642.0,642.0,5,1079,2.0,811.0,811.0
0.067,17,8,3613,4,1874,22.0,1350.0,440.0,4,1739,11.0,1350.0,406.0
0.006,6,10,2000,5,927,1.0,659.0,659.0,5,1073,1.0,805.0,805.0
0.014,6,10,1972,5,910,3.0,642.0,642.0,5,1062,3.0,794.0,794.0
0.018,6,10,1989,5,910,4.0,642.0,642.0,5,1079,4.0,811.0,811.0
0.005,6,10,1779,5,928,1.0,660.0,660.0,5,851,1.0,583.0,583.0
0.005,17,2,140,1,62,0.0,34.0,34.0,1,78,0.0,50.0,50.0
0.019,6,10,1983,5,910,4.0,642.0,642.0,5,1073,4.0,805.0,805.0
0.005,6,10,2006,5,927,1.0,659.0,659.0,5,1079,1.0,811.0,811.0
0.005,17,2,160,1,72,0.0,44.0,44.0,1,88,0.0,60.0,60.0
0.001,17,2,180,1,66,0.0,38.0,38.0,1,114,0.0,86.0,86.0
177.341,17,78,11063,39,2599,4666.0,44.0,38.0,39,8464,4666.0,261.0,189.0
0.105,6,10,1506,5,395,23.0,127.0,127.0,5,1111,22.0,843.0,843.0
0.004,6,10,1702,5,863,1.0,595.0,595.0,5,839,0.0,571.0,571.0
0.012,6,10,1990,5,911,2.0,643.0,643.0,5,1079,2.0,811.0,811.0
0.005,6,10,1989,5,927,1.0,659.0,659.0,5,1062,1.0,794.0,794.0
0.004,17,2,136,1,60,0.0,32.0,32.0,1,76,0.0,48.0,48.0
0.005,6,10,1989,5,927,1.0,659.0,659.0,5,1062,1.0,794.0,794.0
0.004,17,2,148,1,60,0.0,32.0,32.0,1,88,0.0,60.0,60.0
240.105,6,16,4482,9,963,30013.0,238.0,166.0,7,3519,40017.0,1402.0,786.0
0.053,17,2,152,1,76,0.0,48.0,48.0,1,76,0.0,48.0,48.0
0.006,6,10,2007,5,928,1.0,660.0,660.0,5,1079,1.0,811.0,811.0
0.006,6,10,1547,5,764,1.0,496.0,496.0,5,783,1.0,515.0,515.0
0.074,17,2,182,1,65,0.0,37.0,37.0,1,117,0.0,89.0,89.0
0.005,6,10,2006,5,927,1.0,659.0,659.0,5,1079,1.0,811.0,811.0
0.019,17,2,132,1,58,0.0,30.0,30.0,1,74,0.0,46.0,46.0
0.007,6,10,1547,5,764,1.0,496.0,496.0,5,783,1.0,515.0,515.0
159.302,6,26,9525,12,1627,81.0,794.0,367.0,14,7898,12244.0,1360.0,732.0
0.006,6,10,2007,5,928,1.0,660.0,660.0,5,1079,1.0,811.0,811.0
0.074,6,10,1506,5,395,16.0,127.0,127.0,5,1111,15.0,843.0,843.0
0.009,6,10,1990,5,911,2.0,643.0,643.0,5,1079,2.0,811.0,811.0
0.008,6,10,1989,5,910,2.0,642.0,642.0,5,1079,1.0,811.0,811.0
0.003,17,2,234,1,61,0.0,33.0,33.0,1,173,0.0,145.0,145.0
0.018,6,10,1972,5,910,4.0,642.0,642.0,5,1062,4.0,794.0,794.0
0.005,6,10,1989,5,927,1.0,659.0,659.0,5,1062,1.0,794.0,794.0
0.008,6,10,1972,5,910,2.0,642.0,642.0,5,1062,2.0,794.0,794.0
0.04,17,2,184,1,61,0.0,33.0,33.0,1,123,0.0,95.0,95.0
0.004,6,10,1702,5,863,1.0,595.0,595.0,5,839,1.0,571.0,571.0
0.001,17,2,180,1,66,0.0,38.0,38.0,1,114,0.0,86.0,86.0
0.004,17,2,136,1,60,0.0,32.0,32.0,1,76,0.0,48.0,48.0
0.126,6,10,1506,5,395,26.0,127.0,127.0,5,1111,29.0,843.0,843.0
0.013,6,10,1990,5,911,3.0,643.0,643.0,5,1079,3.0,811.0,811.0
40.053,17,10,676,5,460,10012.0,104.0,64.0,5,216,10012.0,20.0,15.0
0.008,6,10,1990,5,911,2.0,643.0,643.0,5,1079,2.0,811.0,811.0
0.001,17,2,180,1,66,0.0,38.0,38.0,1,114,0.0,86.0,86.0
0.072,17,2,412,1,61,0.0,33.0,33.0,1,351,0.0,323.0,323.0
0.063,6,10,1506,5,395,14.0,127.0,127.0,5,1111,14.0,843.0,843.0
0.008,6,10,1989,5,910,2.0,642.0,642.0,5,1079,1.0,811.0,811.0
0.006,6,10,1547,5,764,1.0,496.0,496.0,5,783,1.0,515.0,515.0
0.003,6,10,1702,5,863,0.0,595.0,595.0,5,839,0.0,571.0,571.0
0.012,6,10,1677,5,827,3.0,559.0,559.0,5,850,2.0,582.0,582.0
0.148,6,10,1506,5,395,35.0,127.0,127.0,5,1111,25.0,843.0,843.0
0.102,6,10,1506,5,395,24.0,127.0,127.0,5,1111,22.0,843.0,843.0
0.009,6,12,1926,6,1189,1.0,659.0,434.0,6,737,1.0,417.0,417.0
0.005,17,4,284,2,120,0.0,32.0,32.0,2,164,0.0,60.0,54.0
0.005,6,10,2007,5,928,1.0,660.0,660.0,5,1079,1.0,811.0,811.0
0.108,6,10,1506,5,395,26.0,127.0,127.0,5,1111,25.0,843.0,843.0
0.004,6,10,1989,5,927,1.0,659.0,659.0,5,1062,1.0,794.0,794.0
40.061,17,10,676,5,460,10014.0,104.0,64.0,5,216,10014.0,20.0,15.0
0.016,6,10,1631,5,848,3.0,580.0,580.0,5,783,4.0,515.0,515.0
0.078,6,10,1506,5,395,17.0,127.0,127.0,5,1111,17.0,843.0,843.0
0.011,6,13,3747,7,509,1.0,137.0,137.0,6,3238,2.0,1470.0,1459.0
240.011,6,9,787,5,488,60002.0,232.0,232.0,4,299,80003.0,83.0,83.0
0.016,6,13,3735,7,497,2.0,125.0,125.0,6,3238,3.0,1470.0,1459.0
0.005,6,10,2000,5,927,1.0,659.0,659.0,5,1073,1.0,805.0,805.0
0.005,6,10,1989,5,927,1.0,659.0,659.0,5,1062,1.0,794.0,794.0
0.004,6,10,2006,5,927,1.0,659.0,659.0,5,1079,1.0,811.0,811.0
0.02,6,10,1631,5,848,4.0,580.0,580.0,5,783,4.0,515.0,515.0
32.45,6,36,10090,18,4572,521.0,2107.0,955.0,18,5518,1898.0,2667.0,435.0
0.005,17,2,136,1,60,0.0,32.0,32.0,1,76,0.0,48.0,48.0
0.013,6,10,1972,5,910,3.0,642.0,642.0,5,1062,3.0,794.0,794.0
0.005,17,2,179,1,71,0.0,43.0,43.0,1,108,0.0,80.0,80.0
0.007,6,10,1990,5,911,1.0,643.0,643.0,5,1079,1.0,811.0,811.0
0.124,6,10,1506,5,395,28.0,127.0,127.0,5,1111,26.0,843.0,843.0
0.004,17,2,136,1,60,0.0,32.0,32.0,1,76,0.0,48.0,48.0
0.014,6,13,3913,7,495,2.0,123.0,123.0,6,3418,2.0,1650.0,1549.0
0.006,6,10,1547,5,764,1.0,496.0,496.0,5,783,1.0,515.0,515.0
0.009,6,10,1972,5,910,2.0,642.0,642.0,5,1062,2.0,794.0,794.0
0.005,6,10,2000,5,927,1.0,659.0,659.0,5,1073,1.0,805.0,805.0
0.012,6,10,2006,5,927,3.0,659.0,659.0,5,1079,2.0,811.0,811.0
0.105,6,10,1506,5,395,23.0,127.0,127.0,5,1111,20.0,843.0,843.0
0.07,6,10,1506,5,395,15.0,127.0,127.0,5,1111,14.0,843.0,843.0
0.001,17,2,166,1,75,0.0,47.0,47.0,1,91,0.0,63.0,63.0
0.026,6,10,1972,5,910,6.0,642.0,642.0,5,1062,6.0,794.0,794.0
0.005,6,10,1547,5,764,1.0,496.0,496.0,5,783,1.0,515.0,515.0
0.005,6,10,2007,5,928,1.0,660.0,660.0,5,1079,1.0,811.0,811.0
0.01,6,10,1677,5,827,2.0,559.0,559.0,5,850,2.0,582.0,582.0
0.013,6,10,1762,5,911,3.0,643.0,643.0,5,851,3.0,583.0,583.0
40.072,17,10,676,5,460,10016.0,104.0,64.0,5,216,10016.0,20.0,15.0
0.003,17,2,136,1,60,0.0,32.0,32.0,1,76,0.0,48.0,48.0
0.085,6,10,1506,5,395,17.0,127.0,127.0,5,1111,18.0,843.0,843.0
0.008,6,10,1983,5,910,2.0,642.0,642.0,5,1073,2.0,805.0,805.0
240.1,6,16,4481,9,963,30012.0,238.0,166.0,7,3518,40016.0,1402.0,786.0
0.006,6,10,1547,5,764,1.0,496.0,496.0,5,783,1.0,515.0,515.0
40.054,17,10,676,5,460,10012.0,104.0,64.0,5,216,10012.0,20.0,15.0
0.006,17,2,170,1,65,0.0,37.0,37.0,1,105,0.0,77.0,77.0
240.098,6,32,9157,16,6834,16006.0,1905.0,667.0,16,2323,16006.0,580.0,185.0
0.004,6,10,2007,5,928,1.0,660.0,660.0,5,1079,1.0,811.0,811.0
1.098,6,32,13391,18,5892,64.0,2073.0,854.0,14,7499,71.0,2720.0,769.0
1758.38,6,454,69028,264,36056,6685.0,613.0,192.0,190,32972,9303.0,613.0,156.0
0.008,6,10,1631,5,848,2.0,580.0,580.0,5,783,2.0,515.0,515.0
0.128,6,10,1506,5,395,16.0,127.0,127.0,5,1111,30.0,843.0,843.0
0.012,6,10,1990,5,911,3.0,643.0,643.0,5,1079,3.0,811.0,811.0
0.015,6,10,1990,5,911,3.0,643.0,643.0,5,1079,3.0,811.0,811.0
0.09,6,10,1506,5,395,20.0,127.0,127.0,5,1111,19.0,843.0,843.0
0.004,6,10,1989,5,927,1.0,659.0,659.0,5,1062,1.0,794.0,794.0
6.492,6,26,12158,14,1040,499.0,304.0,304.0,12,11118,589.0,1402.0,1165.0
0.216,6,10,1506,5,395,41.0,127.0,127.0,5,1111,49.0,843.0,843.0
40.063,17,10,676,5,460,10012.0,104.0,64.0,5,216,10015.0,20.0,15.0
0.005,6,14,3742,8,504,0.0,80.0,80.0,6,3238,0.0,1470.0,1459.0
0.09,6,10,1506,5,395,19.0,127.0,127.0,5,1111,18.0,843.0,843.0
240.108,6,31,9176,15,6807,17150.0,1931.0,670.0,16,2369,16007.0,580.0,191.0
0.005,6,10,2000,5,927,1.0,659.0,659.0,5,1073,1.0,805.0,805.0
0.005,6,14,3742,8,504,0.0,80.0,80.0,6,3238,1.0,1470.0,1459.0
0.005,6,10,1643,5,860,1.0,592.0,592.0,5,783,1.0,515.0,515.0
0.04,17,4,284,2,120,0.0,32.0,32.0,2,164,36.0,60.0,54.0
40.063,17,10,676,5,460,10013.0,104.0,64.0,5,216,10013.0,20.0,15.0
0.005,6,10,1689,5,839,1.0,571.0,571.0,5,850,1.0,582.0,582.0
0.006,6,10,1989,5,927,1.0,659.0,659.0,5,1062,1.0,794.0,794.0
0.004,6,10,1779,5,928,1.0,660.0,660.0,5,851,1.0,583.0,583.0
40.06,17,10,676,5,460,10014.0,104.0,64.0,5,216,10013.0,20.0,15.0
0.006,6,10,1547,5,764,1.0,496.0,496.0,5,783,1.0,515.0,515.0
308.5,17,20,1124,10,716,34263.0,48.0,43.0,10,408,34262.0,20.0,12.0
0.005,6,10,1689,5,839,1.0,571.0,571.0,5,850,1.0,582.0,582.0
15.073,17,15,9239,8,6902,2149.0,1350.0,834.0,7,2337,2507.0,1350.0,305.0
0.13,17,2,146,1,65,0.0,37.0,37.0,1,81,0.0,53.0,53.0
0.017,6,10,1989,5,910,4.0,642.0,642.0,5,1079,4.0,811.0,811.0
367.316,6,22,2313,16,867,24487.0,195.0,195.0,6,1446,4638.0,419.0,398.0
0.04,17,2,152,1,76,0.0,48.0,48.0,1,76,0.0,48.0,48.0
0.119,6,10,1506,5,395,25.0,127.0,127.0,5,1111,28.0,843.0,843.0
0.074,6,10,1506,5,395,15.0,127.0,127.0,5,1111,15.0,843.0,843.0
0.005,6,10,1774,5,923,1.0,655.0,655.0,5,851,1.0,583.0,583.0
0.021,6,10,1983,5,910,5.0,642.0,642.0,5,1073,5.0,805.0,805.0
0.199,6,10,1506,5,395,44.0,127.0,127.0,5,1111,48.0,843.0,843.0
40.059,17,10,676,5,460,10011.0,104.0,64.0,5,216,10013.0,20.0,15.0
0.098,6,10,1506,5,395,18.0,127.0,127.0,5,1111,21.0,843.0,843.0
40.058,17,10,676,5,460,10013.0,104.0,64.0,5,216,10012.0,20.0,15.0
0.012,6,10,1983,5,910,2.0,642.0,642.0,5,1073,3.0,805.0,805.0
0.005,6,10,1989,5,927,1.0,659.0,659.0,5,1062,1.0,794.0,794.0
352.781,6,20,2210,6,1308,12003.0,494.0,494.0,14,902,27136.0,83.0,83.0
15.468,17,44,24679,24,19844,672.0,1350.0,798.0,20,4835,812.0,1350.0,213.0
10.969,17,34,6373,17,2658,678.0,270.0,128.0,17,3715,678.0,1145.0,190.0
0.172,6,3,453,2,321,172.0,241.0,241.0,1,132,0.0,92.0,92.0
0.005,17,2,164,1,74,0.0,46.0,46.0,1,90,0.0,62.0,62.0
0.005,6,10,1989,5,927,1.0,659.0,659.0,5,1062,1.0,794.0,794.0
0.004,6,10,2006,5,927,1.0,659.0,659.0,5,1079,0.0,811.0,811.0
0.005,6,13,3690,7,452,0.0,80.0,80.0,6,3238,0.0,1470.0,1459.0
0.012,6,10,1631,5,848,3.0,580.0,580.0,5,783,2.0,515.0,515.0
0.004,6,10,1774,5,923,1.0,655.0,655.0,5,851,1.0,583.0,583.0
0.039,17,2,148,1,60,0.0,32.0,32.0,1,88,0.0,60.0,60.0
0.005,6,10,1779,5,928,1.0,660.0,660.0,5,851,1.0,583.0,583.0
0.007,6,10,1989,5,910,1.0,642.0,642.0,5,1079,1.0,811.0,811.0
2.315,6,39,7419,21,3395,115.0,1103.0,211.0,18,4024,123.0,1414.0,470.0
0.068,17,8,3613,4,1874,22.0,1350.0,440.0,4,1739,11.0,1350.0,406.0
0.004,6,13,3690,7,452,0.0,80.0,80.0,6,3238,0.0,1470.0,1459.0
0.067,6,10,1506,5,395,16.0,127.0,127.0,5,1111,14.0,843.0,843.0
0.085,6,10,1506,5,395,20.0,127.0,127.0,5,1111,17.0,843.0,843.0
300.342,6,27,8913,14,1878,23102.0,517.0,285.0,13,7035,25028.0,1402.0,909.0
0.026,6,10,1972,5,910,6.0,642.0,642.0,5,1062,6.0,794.0,794.0
0.015,6,10,1989,5,910,3.0,642.0,642.0,5,1079,3.0,811.0,811.0
0.001,17,2,166,1,75,0.0,47.0,47.0,1,91,0.0,63.0,63.0
0.007,6,10,1972,5,910,1.0,642.0,642.0,5,1062,1.0,794.0,794.0
0.108,6,10,1506,5,395,24.0,127.0,127.0,5,1111,25.0,843.0,843.0
0.005,17,2,214,1,75,0.0,47.0,47.0,1,139,0.0,111.0,111.0
0.71,6,22,5072,11,1250,60.0,325.0,133.0,11,3822,59.0,1414.0,563.0
15.079,17,16,8711,8,6514,2150.0,1350.0,786.0,8,2197,2150.0,1350.0,246.0
0.083,6,10,1506,5,395,19.0,127.0,127.0,5,1111,18.0,843.0,843.0
15.087,17,15,8329,8,6238,2151.0,1350.0,751.0,7,2091,2509.0,1350.0,270.0
0.005,17,2,166,1,75,0.0,47.0,47.0,1,91,0.0,63.0,63.0
0.005,6,10,1689,5,839,1.0,571.0,571.0,5,850,1.0,582.0,582.0
0.12,6,10,1506,5,395,23.0,127.0,127.0,5,1111,27.0,843.0,843.0
0.017,6,10,1990,5,911,4.0,643.0,643.0,5,1079,4.0,811.0,811.0
0.006,6,10,1989,5,927,1.0,659.0,659.0,5,1062,1.0,794.0,794.0
1.147,6,33,13432,19,5933,63.0,1360.0,732.0,14,7499,75.0,2720.0,769.0
0.01,17,2,170,1,65,0.0,37.0,37.0,1,105,0.0,77.0,77.0
0.003,17,2,136,1,60,0.0,32.0,32.0,1,76,0.0,48.0,48.0
0.005,6,10,1643,5,860,1.0,592.0,592.0,5,783,1.0,515.0,515.0
1778.257,17,140,44240,72,22752,25045.0,288.0,288.0,68,21488,26538.0,288.0,288.0
0.04,17,4,284,2,120,1.0,32.0,32.0,2,164,36.0,60.0,54.0
0.005,6,14,3736,7,446,0.0,74.0,74.0,7,3290,0.0,1448.0,972.0
240.074,6,19,4985,9,2305,30009.0,1102.0,613.0,10,2680,26674.0,1162.0,430.0
11.275,17,28,4422,14,1993,855.0,268.0,114.0,14,2429,855.0,588.0,145.0
0.064,6,10,1506,5,395,15.0,127.0,127.0,5,1111,13.0,843.0,843.0
0.039,17,2,412,1,61,0.0,33.0,33.0,1,351,0.0,323.0,323.0
0.005,17,2,193,1,71,0.0,43.0,43.0,1,122,0.0,94.0,94.0
0.006,17,2,202,1,69,0.0,41.0,41.0,1,133,0.0,105.0,105.0
0.005,6,10,2007,5,928,1.0,660.0,660.0,5,1079,1.0,811.0,811.0
0.029,17,2,136,1,60,0.0,32.0,32.0,1,76,0.0,48.0,48.0
273.862,6,63,18381,25,14041,11410.0,2720.0,686.0,38,4340,7398.0,1062.0,176.0
11.117,17,28,4421,14,1994,842.0,269.0,114.0,14,2427,842.0,586.0,145.0
0.004,6,10,1779,5,928,1.0,660.0,660.0,5,851,1.0,583.0,583.0
0.004,6,10,2007,5,928,1.0,660.0,660.0,5,1079,1.0,811.0,811.0
295.099,6,393,348607,190,21436,1561.0,2736.0,888.0,203,327171,1460.0,2916.0,1675.0
0.132,6,10,1506,5,395,26.0,127.0,127.0,5,1111,29.0,843.0,843.0
0.13,6,10,1506,5,395,31.0,127.0,127.0,5,1111,30.0,843.0,843.0
0.004,6,10,1702,5,863,1.0,595.0,595.0,5,839,1.0,571.0,571.0
40.064,17,10,676,5,460,10014.0,104.0,64.0,5,216,10015.0,20.0,15.0
0.004,17,2,170,1,65,0.0,37.0,37.0,1,105,0.0,77.0,77.0
0.005,6,10,2007,5,928,1.0,660.0,660.0,5,1079,1.0,811.0,811.0
0.005,6,10,2006,5,927,1.0,659.0,659.0,5,1079,1.0,811.0,811.0
0.011,6,10,1989,5,910,2.0,642.0,642.0,5,1079,2.0,811.0,811.0
0.143,17,2,412,1,61,0.0,33.0,33.0,1,351,0.0,323.0,323.0
0.13,17,2,148,1,60,0.0,32.0,32.0,1,88,0.0,60.0,60.0
0.038,17,2,380,1,61,0.0,33.0,33.0,1,319,0.0,291.0,291.0
0.012,6,12,1926,6,1189,2.0,659.0,434.0,6,737,2.0,417.0,417.0
240.09,6,16,4481,9,963,30011.0,238.0,166.0,7,3518,40014.0,1402.0,786.0
0.006,17,2,179,1,71,0.0,43.0,43.0,1,108,0.0,80.0,80.0
0.005,17,2,140,1,62,0.0,34.0,34.0,1,78,0.0,50.0,50.0
323.395,17,20,1124,10,716,35917.0,48.0,43.0,10,408,35918.0,20.0,12.0
0.006,6,10,1547,5,764,1.0,496.0,496.0,5,783,1.0,515.0,515.0
0.095,6,10,1506,5,395,19.0,127.0,127.0,5,1111,20.0,843.0,843.0
0.001,17,2,136,1,60,0.0,32.0,32.0,1,76,0.0,48.0,48.0
0.005,6,10,1779,5,928,1.0,660.0,660.0,5,851,1.0,583.0,583.0
0.125,6,10,1506,5,395,30.0,127.0,127.0,5,1111,28.0,843.0,843.0
40.064,17,10,676,5,460,10015.0,104.0,64.0,5,216,10015.0,20.0,15.0
0.01,6,10,1989,5,910,2.0,642.0,642.0,5,1079,2.0,811.0,811.0
0.006,6,10,1547,5,764,1.0,496.0,496.0,5,783,1.0,515.0,515.0
0.005,6,10,2007,5,928,1.0,660.0,660.0,5,1079,1.0,811.0,811.0
40.054,17,10,676,5,460,10012.0,104.0,64.0,5,216,10012.0,20.0,15.0
0.016,6,10,1983,5,910,4.0,642.0,642.0,5,1073,3.0,805.0,805.0
0.075,6,10,1506,5,395,14.0,127.0,127.0,5,1111,16.0,843.0,843.0
11.312,17,28,4423,14,1994,857.0,269.0,114.0,14,2429,857.0,588.0,145.0
0.075,6,10,1506,5,395,17.0,127.0,127.0,5,1111,17.0,843.0,843.0
0.072,6,10,1506,5,395,17.0,127.0,127.0,5,1111,16.0,843.0,843.0
40.069,17,10,676,5,460,10012.0,104.0,64.0,5,216,10016.0,20.0,15.0
0.006,6,10,1689,5,839,1.0,571.0,571.0,5,850,1.0,582.0,582.0
0.106,6,10,1506,5,395,24.0,127.0,127.0,5,1111,25.0,843.0,843.0
0.013,6,10,1677,5,827,3.0,559.0,559.0,5,850,3.0,582.0,582.0
0.069,17,8,3613,4,1874,23.0,1350.0,440.0,4,1739,11.0,1350.0,406.0
360.098,6,15,2515,9,1946,45012.0,494.0,494.0,6,569,72018.0,83.0,83.0
0.037,17,2,234,1,61,0.0,33.0,33.0,1,173,0.0,145.0,145.0
0.001,17,2,180,1,66,0.0,38.0,38.0,1,114,0.0,86.0,86.0
0.006,17,2,164,1,74,0.0,46.0,46.0,1,90,0.0,62.0,62.0
0.006,6,10,1547,5,764,1.0,496.0,496.0,5,783,1.0,515.0,515.0
0.03,6,10,1972,5,910,7.0,642.0,642.0,5,1062,7.0,794.0,794.0
0.015,6,10,1990,5,911,3.0,643.0,643.0,5,1079,3.0,811.0,811.0
40.072,17,10,676,5,460,10017.0,104.0,64.0,5,216,10017.0,20.0,15.0
0.001,17,2,180,1,66,0.0,38.0,38.0,1,114,0.0,86.0,86.0
0.081,6,10,1506,5,395,17.0,127.0,127.0,5,1111,16.0,843.0,843.0
0.005,17,4,284,2,120,1.0,32.0,32.0,2,164,2.0,60.0,54.0
1.255,6,32,13392,18,5893,73.0,2720.0,854.0,14,7499,82.0,2720.0,769.0
308.211,17,20,1124,10,716,34237.0,48.0,43.0,10,408,34235.0,20.0,12.0
0.015,6,13,3735,7,497,2.0,125.0,125.0,6,3238,2.0,1470.0,1459.0
0.005,6,10,1689,5,839,1.0,571.0,571.0,5,850,1.0,582.0,582.0
0.005,6,10,2007,5,928,1.0,660.0,660.0,5,1079,1.0,811.0,811.0
0.01,17,2,136,1,60,0.0,32.0,32.0,1,76,0.0,48.0,48.0
0.011,6,10,1989,5,910,2.0,642.0,642.0,5,1079,2.0,811.0,811.0
0.019,17,2,140,1,62,0.0,34.0,34.0,1,78,0.0,50.0,50.0
0.005,17,2,193,1,71,0.0,43.0,43.0,1,122,0.0,94.0,94.0
0.01,6,10,1762,5,911,2.0,643.0,643.0,5,851,2.0,583.0,583.0
0.006,6,10,1854,5,889,1.0,621.0,621.0,5,965,1.0,697.0,697.0
0.013,6,10,1677,5,827,3.0,559.0,559.0,5,850,3.0,582.0,582.0
0.004,6,10,2007,5,928,1.0,660.0,660.0,5,1079,1.0,811.0,811.0
0.005,6,13,3747,7,509,0.0,137.0,137.0,6,3238,1.0,1470.0,1459.0
0.015,6,10,1989,5,910,3.0,642.0,642.0,5,1079,3.0,811.0,811.0
0.005,17,2,169,1,62,0.0,34.0,34.0,1,107,0.0,79.0,79.0
0.072,17,4,364,2,160,1.0,52.0,52.0,2,204,32.0,80.0,74.0
0.009,6,10,1762,5,911,2.0,643.0,643.0,5,851,2.0,583.0,583.0
0.06,17,2,152,1,76,0.0,48.0,48.0,1,76,0.0,48.0,48.0
11.174,17,28,4418,14,1993,846.0,268.0,114.0,14,2425,846.0,588.0,145.0
0.178,6,10,1506,5,395,38.0,127.0,127.0,5,1111,25.0,843.0,843.0
0.004,6,10,1989,5,927,1.0,659.0,659.0,5,1062,1.0,794.0,794.0
0.102,6,10,1506,5,395,18.0,127.0,127.0,5,1111,22.0,843.0,843.0
0.025,6,13,3735,7,497,4.0,125.0,125.0,6,3238,5.0,1470.0,1459.0
0.739,6,25,5459,12,1557,56.0,325.0,152.0,13,3902,52.0,1414.0,563.0
0.007,6,10,1989,5,910,1.0,642.0,642.0,5,1079,1.0,811.0,811.0
0.043,17,2,152,1,76,0.0,48.0,48.0,1,76,0.0,48.0,48.0
0.008,6,10,1990,5,911,2.0,643.0,643.0,5,1079,2.0,811.0,811.0
40.055,17,10,676,5,460,10012.0,104.0,64.0,5,216,10012.0,20.0,15.0
0.072,6,10,1506,5,395,16.0,127.0,127.0,5,1111,17.0,843.0,843.0
0.006,6,10,1547,5,764,1.0,496.0,496.0,5,783,1.0,515.0,515.0
0.085,6,10,1506,5,395,19.0,127.0,127.0,5,1111,20.0,843.0,843.0
0.054,17,2,152,1,76,0.0,48.0,48.0,1,76,0.0,48.0,48.0
15.073,17,14,9191,8,6902,2149.0,1350.0,834.0,6,2289,3008.0,1350.0,353.0
0.017,6,10,1677,5,827,4.0,559.0,559.0,5,850,4.0,582.0,582.0
0.005,6,10,1989,5,927,1.0,659.0,659.0,5,1062,1.0,794.0,794.0
0.024,6,10,1989,5,910,6.0,642.0,642.0,5,1079,5.0,811.0,811.0
0.012,6,10,1989,5,910,3.0,642.0,642.0,5,1079,2.0,811.0,811.0
0.006,6,14,3799,7,509,0.0,137.0,137.0,7,3290,0.0,1448.0,972.0
0.005,17,2,166,1,75,0.0,47.0,47.0,1,91,0.0,63.0,63.0
0.005,6,14,3799,7,509,0.0,137.0,137.0,7,3290,0.0,1448.0,972.0
10.753,17,28,4418,14,1994,819.0,269.0,114.0,14,2424,819.0,587.0,145.0
0.012,6,10,1631,5,848,2.0,580.0,580.0,5,783,2.0,515.0,515.0
0.019,6,10,1677,5,827,4.0,559.0,559.0,5,850,4.0,582.0,582.0
40.085,17,10,676,5,460,10016.0,104.0,64.0,5,216,10020.0,20.0,15.0
0.005,6,10,1779,5,928,1.0,660.0,660.0,5,851,1.0,583.0,583.0
240.124,6,30,9349,15,6965,17151.0,2088.0,687.0,15,2384,17151.0,580.0,199.0
0.005,6,10,1989,5,927,1.0,659.0,659.0,5,1062,1.0,794.0,794.0
0.013,17,2,152,1,56,0.0,28.0,28.0,1,96,0.0,68.0,68.0
9.038,17,6,376,5,280,2259.0,28.0,28.0,1,96,0.0,68.0,68.0
15.086,17,15,8456,8,6225,2151.0,1350.0,750.0,7,2231,2508.0,1350.0,290.0
0.005,6,10,2006,5,927,1.0,659.0,659.0,5,1079,1.0,811.0,811.0
0.01,6,10,1762,5,911,2.0,643.0,643.0,5,851,2.0,583.0,583.0
0.072,17,4,352,2,130,1.0,37.0,37.0,2,222,33.0,89.0,83.0
361.824,6,19,1689,15,978,25844.0,190.0,190.0,4,711,80013.0,495.0,495.0
0.004,6,10,2006,5,927,1.0,659.0,659.0,5,1079,1.0,811.0,811.0
0.005,17,2,214,1,75,0.0,47.0,47.0,1,139,0.0,111.0,111.0
1.116,6,30,13240,17,5841,69.0,2074.0,854.0,13,7399,78.0,2720.0,858.0
0.006,17,2,166,1,75,0.0,47.0,47.0,1,91,0.0,63.0,63.0
0.101,6,10,1506,5,395,23.0,127.0,127.0,5,1111,23.0,843.0,843.0
0.019,6,10,1983,5,910,4.0,642.0,642.0,5,1073,4.0,805.0,805.0
0.004,6,10,1774,5,923,1.0,655.0,655.0,5,851,1.0,583.0,583.0
290.278,6,386,347791,196,21761,1488.0,2736.0,825.0,190,326030,1535.0,2804.0,1796.0
0.012,6,10,1972,5,910,3.0,642.0,642.0,5,1062,2.0,794.0,794.0
0.043,17,4,548,2,122,1.0,33.0,33.0,2,426,38.0,275.0,185.0
0.014,6,10,1989,5,910,3.0,642.0,642.0,5,1079,3.0,811.0,811.0
0.01,6,10,1989,5,910,2.0,642.0,642.0,5,1079,2.0,811.0,811.0
0.167,17,2,152,1,76,0.0,48.0,48.0,1,76,0.0,48.0,48.0
0.039,17,2,166,1,75,0.0,47.0,47.0,1,91,0.0,63.0,63.0
0.018,6,10,1990,5,911,4.0,643.0,643.0,5,1079,4.0,811.0,811.0
319.748,17,20,1124,10,716,35520.0,48.0,43.0,10,408,35520.0,20.0,12.0
0.09,17,2,144,1,64,0.0,36.0,36.0,1,80,0.0,52.0,52.0
0.082,6,10,1506,5,395,15.0,127.0,127.0,5,1111,18.0,843.0,843.0
0.057,17,2,299,1,65,0.0,37.0,37.0,1,234,0.0,206.0,206.0
0.006,6,10,1547,5,764,1.0,496.0,496.0,5,783,1.0,515.0,515.0
0.003,17,2,152,1,76,0.0,48.0,48.0,1,76,0.0,48.0,48.0
40.082,17,10,676,5,460,10019.0,104.0,64.0,5,216,10019.0,20.0,15.0
0.111,6,10,1506,5,395,25.0,127.0,127.0,5,1111,24.0,843.0,843.0
0.003,17,2,148,1,60,0.0,32.0,32.0,1,88,0.0,60.0,60.0
0.016,6,10,1983,5,910,3.0,642.0,642.0,5,1073,4.0,805.0,805.0
0.004,6,10,2000,5,927,1.0,659.0,659.0,5,1073,1.0,805.0,805.0
0.082,6,10,1506,5,395,18.0,127.0,127.0,5,1111,16.0,843.0,843.0
0.103,6,10,1506,5,395,23.0,127.0,127.0,5,1111,22.0,843.0,843.0
300.352,6,16,2170,9,684,37522.0,146.0,146.0,7,1486,50030.0,419.0,398.0
0.006,6,10,2006,5,927,1.0,659.0,659.0,5,1079,1.0,811.0,811.0
0.003,17,2,148,1,60,0.0,32.0,32.0,1,88,0.0,60.0,60.0
0.134,17,2,80,1,32,0.0,4.0,4.0,1,48,0.0,20.0,20.0
10.749,17,28,4422,14,1995,817.0,270.0,114.0,14,2427,818.0,586.0,145.0
0.001,17,2,180,1,66,0.0,38.0,38.0,1,114,0.0,86.0,86.0
141.02,6,26,5212,15,1238,10072.0,180.0,75.0,11,3974,14101.0,1593.0,678.0
0.011,6,10,1983,5,910,2.0,642.0,642.0,5,1073,2.0,805.0,805.0
0.006,6,10,1547,5,764,1.0,496.0,496.0,5,783,1.0,515.0,515.0
0.013,6,10,1983,5,910,3.0,642.0,642.0,5,1073,3.0,805.0,805.0
0.004,6,10,1774,5,923,1.0,655.0,655.0,5,851,1.0,583.0,583.0
0.005,6,10,2000,5,927,1.0,659.0,659.0,5,1073,1.0,805.0,805.0
0.08,6,10,1506,5,395,19.0,127.0,127.0,5,1111,19.0,843.0,843.0
0.006,17,2,170,1,65,0.0,37.0,37.0,1,105,0.0,77.0,77.0
0.075,6,10,1506,5,395,15.0,127.0,127.0,5,1111,17.0,843.0,843.0
0.013,6,10,1990,5,911,3.0,643.0,643.0,5,1079,3.0,811.0,811.0
0.006,6,10,1547,5,764,1.0,496.0,496.0,5,783,1.0,515.0,515.0
9.036,17,6,376,5,280,2259.0,28.0,28.0,1,96,0.0,68.0,68.0
326.686,17,20,1124,10,716,36291.0,48.0,43.0,10,408,36291.0,20.0,12.0
0.005,6,10,1643,5,860,1.0,592.0,592.0,5,783,1.0,515.0,515.0
0.008,6,10,2007,5,928,1.0,660.0,660.0,5,1079,1.0,811.0,811.0
0.094,6,10,1506,5,395,19.0,127.0,127.0,5,1111,21.0,843.0,843.0
0.094,6,10,1506,5,395,20.0,127.0,127.0,5,1111,22.0,843.0,843.0
0.007,6,10,1989,5,910,1.0,642.0,642.0,5,1079,1.0,811.0,811.0
0.005,17,2,214,1,75,0.0,47.0,47.0,1,139,0.0,111.0,111.0
0.045,6,10,1990,5,911,11.0,643.0,643.0,5,1079,11.0,811.0,811.0
0.005,6,10,2006,5,927,1.0,659.0,659.0,5,1079,1.0,811.0,811.0
240.088,6,31,9529,15,7037,17149.0,2161.0,695.0,16,2492,16005.0,580.0,206.0
0.013,6,10,1990,5,911,3.0,643.0,643.0,5,1079,3.0,811.0,811.0
0.005,6,10,2006,5,927,1.0,659.0,659.0,5,1079,1.0,811.0,811.0
0.005,6,10,1989,5,927,1.0,659.0,659.0,5,1062,1.0,794.0,794.0
0.111,6,10,1506,5,395,23.0,127.0,127.0,5,1111,25.0,843.0,843.0
0.005,6,10,1643,5,860,1.0,592.0,592.0,5,783,1.0,515.0,515.0
0.011,6,10,1989,5,910,2.0,642.0,642.0,5,1079,2.0,811.0,811.0
0.008,6,10,1972,5,910,2.0,642.0,642.0,5,1062,1.0,794.0,794.0
0.007,6,10,1983,5,910,1.0,642.0,642.0,5,1073,1.0,805.0,805.0
40.062,17,10,676,5,460,10014.0,104.0,64.0,5,216,10014.0,20.0,15.0
0.072,6,10,1506,5,395,15.0,127.0,127.0,5,1111,15.0,843.0,843.0
0.004,6,10,1989,5,927,1.0,659.0,659.0,5,1062,1.0,794.0,794.0
0.001,17,2,180,1,66,0.0,38.0,38.0,1,114,0.0,86.0,86.0
0.005,17,2,170,1,65,0.0,37.0,37.0,1,105,0.0,77.0,77.0
0.04,17,4,596,2,122,0.0,33.0,33.0,2,474,1.0,323.0,209.0
1730.388,6,50,3080,32,1852,55818.0,35.0,35.0,18,1228,101783.0,31.0,31.0
0.124,17,2,170,1,65,0.0,37.0,37.0,1,105,0.0,77.0,77.0
0.012,6,10,1989,5,910,2.0,642.0,642.0,5,1079,3.0,811.0,811.0
0.089,6,10,1506,5,395,19.0,127.0,127.0,5,1111,19.0,843.0,843.0
0.005,6,10,2006,5,927,1.0,659.0,659.0,5,1079,1.0,811.0,811.0
0.005,6,10,2007,5,928,1.0,660.0,660.0,5,1079,1.0,811.0,811.0
40.064,17,10,676,5,460,10014.0,104.0,64.0,5,216,10015.0,20.0,15.0
1778.706,17,142,44872,72,22752,25050.0,288.0,288.0,70,22120,25773.0,288.0,288.0
0.025,6,10,1762,5,911,6.0,643.0,643.0,5,851,6.0,583.0,583.0
0.025,17,2,214,1,75,0.0,47.0,47.0,1,139,0.0,111.0,111.0
0.005,6,10,2000,5,927,1.0,659.0,659.0,5,1073,1.0,805.0,805.0
11.109,17,28,4423,14,1995,841.0,270.0,114.0,14,2428,842.0,587.0,145.0
0.006,6,10,1547,5,764,1.0,496.0,496.0,5,783,1.0,515.0,515.0
0.072,17,2,136,1,60,0.0,32.0,32.0,1,76,0.0,48.0,48.0
0.006,6,10,1547,5,764,1.0,496.0,496.0,5,783,1.0,515.0,515.0
0.0,17,2,136,1,60,0.0,32.0,32.0,1,76,0.0,48.0,48.0
0.068,6,10,1506,5,395,16.0,127.0,127.0,5,1111,13.0,843.0,843.0
0.005,6,10,1643,5,860,1.0,592.0,592.0,5,783,1.0,515.0,515.0
0.106,6,10,1506,5,395,25.0,127.0,127.0,5,1111,22.0,843.0,843.0
0.005,6,10,1989,5,927,1.0,659.0,659.0,5,1062,1.0,794.0,794.0
0.172,17,2,152,1,76,0.0,48.0,48.0,1,76,0.0,48.0,48.0
0.001,17,2,180,1,66,0.0,38.0,38.0,1,114,0.0,86.0,86.0
0.099,6,10,1506,5,395,22.0,127.0,127.0,5,1111,21.0,843.0,843.0
0.005,6,10,2006,5,927,1.0,659.0,659.0,5,1079,1.0,811.0,811.0
0.007,6,10,2007,5,928,1.0,660.0,660.0,5,1079,1.0,811.0,811.0
0.112,6,10,1506,5,395,22.0,127.0,127.0,5,1111,25.0,843.0,843.0
168.08,17,76,10834,38,2530,4542.0,44.0,38.0,38,8304,4542.0,239.0,190.0
0.008,6,10,1972,5,910,2.0,642.0,642.0,5,1062,1.0,794.0,794.0
0.005,6,10,1547,5,764,1.0,496.0,496.0,5,783,1.0,515.0,515.0
0.011,6,10,1677,5,827,2.0,559.0,559.0,5,850,2.0,582.0,582.0
0.013,6,10,1989,5,910,3.0,642.0,642.0,5,1079,3.0,811.0,811.0
0.005,6,10,1779,5,928,1.0,660.0,660.0,5,851,1.0,583.0,583.0
0.098,6,10,1506,5,395,21.0,127.0,127.0,5,1111,22.0,843.0,843.0
0.008,6,10,1972,5,910,2.0,642.0,642.0,5,1062,1.0,794.0,794.0
0.005,6,10,2006,5,927,1.0,659.0,659.0,5,1079,1.0,811.0,811.0
0.013,6,10,1631,5,848,3.0,580.0,580.0,5,783,3.0,515.0,515.0
11.018,17,28,4423,14,1994,839.0,269.0,114.0,14,2429,839.0,588.0,145.0
0.005,6,10,1774,5,923,1.0,655.0,655.0,5,851,1.0,583.0,583.0
0.017,6,10,1983,5,910,4.0,642.0,642.0,5,1073,4.0,805.0,805.0
0.13,6,10,1506,5,395,31.0,127.0,127.0,5,1111,28.0,843.0,843.0
0.019,17,2,148,1,60,0.0,32.0,32.0,1,88,0.0,60.0,60.0
0.057,17,2,235,1,64,0.0,36.0,36.0,1,171,0.0,143.0,143.0
0.004,17,2,136,1,60,0.0,32.0,32.0,1,76,0.0,48.0,48.0
0.005,6,10,2007,5,928,1.0,660.0,660.0,5,1079,1.0,811.0,811.0
0.086,6,10,1506,5,395,16.0,127.0,127.0,5,1111,20.0,843.0,843.0
0.011,6,10,1989,5,910,2.0,642.0,642.0,5,1079,2.0,811.0,811.0
0.006,6,10,1643,5,860,1.0,592.0,592.0,5,783,1.0,515.0,515.0
0.013,6,10,1631,5,848,3.0,580.0,580.0,5,783,3.0,515.0,515.0
0.015,6,10,1990,5,911,3.0,643.0,643.0,5,1079,3.0,811.0,811.0
309.978,17,20,1124,10,716,34429.0,48.0,43.0,10,408,34432.0,20.0,12.0
0.011,6,10,1989,5,910,2.0,642.0,642.0,5,1079,2.0,811.0,811.0
0.004,6,10,1702,5,863,1.0,595.0,595.0,5,839,1.0,571.0,571.0
0.004,6,10,1989,5,927,1.0,659.0,659.0,5,1062,1.0,794.0,794.0
40.069,17,10,676,5,460,10015.0,104.0,64.0,5,216,10016.0,20.0,15.0
177.155,17,72,10004,36,2392,5061.0,44.0,38.0,36,7612,5061.0,249.0,183.0
0.003,6,10,1702,5,863,0.0,595.0,595.0,5,839,0.0,571.0,571.0
0.082,6,10,1506,5,395,19.0,127.0,127.0,5,1111,19.0,843.0,843.0
0.008,6,10,1989,5,910,2.0,642.0,642.0,5,1079,2.0,811.0,811.0
0.008,6,10,1989,5,910,2.0,642.0,642.0,5,1079,2.0,811.0,811.0
0.004,6,10,1774,5,923,1.0,655.0,655.0,5,851,0.0,583.0,583.0
0.004,6,10,1989,5,927,1.0,659.0,659.0,5,1062,1.0,794.0,794.0
0.003,17,2,152,1,76,0.0,48.0,48.0,1,76,0.0,48.0,48.0
0.001,17,2,180,1,66,0.0,38.0,38.0,1,114,0.0,86.0,86.0
0.006,6,10,2007,5,928,1.0,660.0,660.0,5,1079,1.0,811.0,811.0
240.149,6,36,5016,18,2315,14126.0,581.0,195.0,18,2701,14126.0,566.0,251.0
0.098,6,10,1506,5,395,21.0,127.0,127.0,5,1111,19.0,843.0,843.0
0.014,6,10,1631,5,848,3.0,580.0,580.0,5,783,3.0,515.0,515.0
40.065,17,10,676,5,460,10014.0,104.0,64.0,5,216,10015.0,20.0,15.0
1757.237,6,64,7350,42,4470,42859.0,1626.0,108.0,22,2880,83669.0,1116.0,82.0
0.009,6,10,1677,5,827,2.0,559.0,559.0,5,850,2.0,582.0,582.0
0.004,6,10,2006,5,927,1.0,659.0,659.0,5,1079,1.0,811.0,811.0
1781.279,6,548,190592,276,164080,6477.0,2883.0,912.0,272,26512,6572.0,580.0,120.0
0.067,17,8,3613,4,1874,22.0,1350.0,440.0,4,1739,11.0,1350.0,406.0
240.167,6,35,9753,18,7164,14127.0,2120.0,691.0,17,2589,15010.0,580.0,212.0
0.015,6,10,1972,5,910,3.0,642.0,642.0,5,1062,3.0,794.0,794.0
0.015,6,10,1677,5,827,3.0,559.0,559.0,5,850,3.0,582.0,582.0
0.01,6,10,1677,5,827,2.0,559.0,559.0,5,850,2.0,582.0,582.0
0.006,6,10,1547,5,764,1.0,496.0,496.0,5,783,1.0,515.0,515.0
300.331,6,16,2170,9,684,37520.0,146.0,146.0,7,1486,50027.0,419.0,398.0
0.005,6,10,2007,5,928,1.0,660.0,660.0,5,1079,1.0,811.0,811.0
0.006,6,10,1643,5,860,1.0,592.0,592.0,5,783,1.0,515.0,515.0
0.005,6,13,3747,7,509,0.0,137.0,137.0,6,3238,0.0,1470.0,1459.0
1144.85,6,176,25511,77,12455,15063.0,2720.0,166.0,99,13056,11680.0,1360.0,189.0
0.003,17,2,203,1,61,0.0,33.0,33.0,1,142,0.0,114.0,114.0
0.005,6,10,1989,5,927,1.0,659.0,659.0,5,1062,1.0,794.0,794.0
0.126,6,10,1506,5,395,28.0,127.0,127.0,5,1111,28.0,843.0,843.0
0.004,17,2,148,1,60,0.0,32.0,32.0,1,88,0.0,60.0,60.0
0.005,6,10,2000,5,927,1.0,659.0,659.0,5,1073,1.0,805.0,805.0
0.005,6,14,3742,8,504,0.0,80.0,80.0,6,3238,0.0,1470.0,1459.0
0.005,6,10,2006,5,927,1.0,659.0,659.0,5,1079,1.0,811.0,811.0
0.018,6,10,1990,5,911,4.0,643.0,643.0,5,1079,4.0,811.0,811.0
0.005,6,10,1689,5,839,1.0,571.0,571.0,5,850,1.0,582.0,582.0
0.111,6,10,1506,5,395,27.0,127.0,127.0,5,1111,24.0,843.0,843.0
0.162,17,2,152,1,76,0.0,48.0,48.0,1,76,0.0,48.0,48.0
0.013,6,12,1926,6,1189,2.0,659.0,434.0,6,737,2.0,417.0,417.0
0.031,6,13,3735,7,497,5.0,125.0,125.0,6,3238,6.0,1470.0,1459.0
0.086,6,10,1506,5,395,20.0,127.0,127.0,5,1111,20.0,843.0,843.0
0.013,6,10,1972,5,910,3.0,642.0,642.0,5,1062,3.0,794.0,794.0
0.005,17,2,164,1,74,0.0,46.0,46.0,1,90,0.0,62.0,62.0
0.006,6,10,1547,5,764,1.0,496.0,496.0,5,783,1.0,515.0,515.0
1787.542,6,154,19574,92,13852,19643.0,302.0,302.0,62,5722,29303.0,83.0,83.0
0.003,17,4,284,2,120,0.0,32.0,32.0,2,164,0.0,60.0,54.0
0.013,6,10,1989,5,910,3.0,642.0,642.0,5,1079,3.0,811.0,811.0
352.511,6,20,2210,6,1308,12004.0,494.0,494.0,14,902,27115.0,83.0,83.0
0.022,6,10,1989,5,910,5.0,642.0,642.0,5,1079,5.0,811.0,811.0
0.129,6,10,1506,5,395,31.0,127.0,127.0,5,1111,27.0,843.0,843.0
0.005,6,10,1689,5,839,1.0,571.0,571.0,5,850,1.0,582.0,582.0
0.009,6,12,1926,6,1189,1.0,659.0,434.0,6,737,1.0,417.0,417.0
0.17,6,3,453,2,321,170.0,241.0,241.0,1,132,0.0,92.0,92.0
0.009,6,10,1989,5,910,2.0,642.0,642.0,5,1079,2.0,811.0,811.0
0.008,6,10,1677,5,827,2.0,559.0,559.0,5,850,2.0,582.0,582.0
0.01,6,13,3735,7,497,1.0,125.0,125.0,6,3238,2.0,1470.0,1459.0
0.009,6,10,1990,5,911,2.0,643.0,643.0,5,1079,2.0,811.0,811.0
0.016,6,10,1972,5,910,3.0,642.0,642.0,5,1062,3.0,794.0,794.0
0.005,6,14,3736,7,446,0.0,74.0,74.0,7,3290,0.0,1448.0,972.0
0.014,6,10,1983,5,910,3.0,642.0,642.0,5,1073,3.0,805.0,805.0
366.781,6,22,2313,16,867,24452.0,195.0,195.0,6,1446,4634.0,419.0,398.0
0.005,6,10,1989,5,927,1.0,659.0,659.0,5,1062,1.0,794.0,794.0
0.038,17,2,136,1,60,0.0,32.0,32.0,1,76,0.0,48.0,48.0
0.095,6,10,1506,5,395,21.0,127.0,127.0,5,1111,23.0,843.0,843.0
10.903,17,28,4422,14,1994,830.0,269.0,114.0,14,2428,830.0,587.0,145.0
0.005,6,10,2006,5,927,1.0,659.0,659.0,5,1079,1.0,811.0,811.0
15.073,17,15,9239,8,6902,2149.0,1350.0,834.0,7,2337,2507.0,1350.0,305.0
0.005,6,10,1989,5,927,1.0,659.0,659.0,5,1062,1.0,794.0,794.0
0.123,17,2,136,1,60,0.0,32.0,32.0,1,76,0.0,48.0,48.0
0.019,6,10,1762,5,911,4.0,643.0,643.0,5,851,4.0,583.0,583.0
0.01,6,10,1989,5,910,2.0,642.0,642.0,5,1079,2.0,811.0,811.0
0.107,6,10,1506,5,395,23.0,127.0,127.0,5,1111,25.0,843.0,843.0
0.113,6,10,1506,5,395,22.0,127.0,127.0,5,1111,26.0,843.0,843.0
10.874,17,28,4423,14,1994,827.0,269.0,114.0,14,2429,827.0,588.0,145.0
0.005,6,10,2007,5,928,1.0,660.0,660.0,5,1079,1.0,811.0,811.0
0.005,6,10,2006,5,927,1.0,659.0,659.0,5,1079,1.0,811.0,811.0
0.005,17,2,164,1,74,0.0,46.0,46.0,1,90,0.0,62.0,62.0
0.003,6,10,1702,5,863,0.0,595.0,595.0,5,839,0.0,571.0,571.0
309.938,17,20,1124,10,716,34423.0,48.0,43.0,10,408,34423.0,20.0,12.0
0.129,6,10,1506,5,395,28.0,127.0,127.0,5,1111,29.0,843.0,843.0
0.006,6,10,1547,5,764,1.0,496.0,496.0,5,783,1.0,515.0,515.0
11.17,17,28,4418,14,1994,846.0,269.0,114.0,14,2424,846.0,587.0,145.0
5.071,58,2,144,1,72,0.0,24.0,24.0,1,72,0.0,24.0,24.0
0.047,17,2,170,1,65,0.0,37.0,37.0,1,105,0.0,77.0,77.0
0.012,6,10,1990,5,911,3.0,643.0,643.0,5,1079,2.0,811.0,811.0
9.038,17,6,376,5,280,2259.0,28.0,28.0,1,96,0.0,68.0,68.0
0.005,6,10,1643,5,860,1.0,592.0,592.0,5,783,1.0,515.0,515.0
0.07,6,20,9974,11,704,7.0,124.0,124.0,9,9270,8.0,2896.0,1758.0
0.106,6,10,1506,5,395,25.0,127.0,127.0,5,1111,22.0,843.0,843.0
40.053,17,10,676,5,460,10010.0,104.0,64.0,5,216,10012.0,20.0,15.0
0.004,6,10,1779,5,928,1.0,660.0,660.0,5,851,1.0,583.0,583.0
0.071,6,10,1506,5,395,17.0,127.0,127.0,5,1111,17.0,843.0,843.0
0.004,17,4,284,2,120,0.0,32.0,32.0,2,164,1.0,60.0,54.0
0.004,6,10,1702,5,863,1.0,595.0,595.0,5,839,1.0,571.0,571.0
0.087,6,10,1506,5,395,19.0,127.0,127.0,5,1111,19.0,843.0,843.0
0.011,6,10,1972,5,910,2.0,642.0,642.0,5,1062,2.0,794.0,794.0
0.015,6,10,1989,5,910,3.0,642.0,642.0,5,1079,3.0,811.0,811.0
0.004,6,10,2007,5,928,1.0,660.0,660.0,5,1079,1.0,811.0,811.0
241.3,6,313,343922,124,17965,1961.0,2736.0,960.0,189,325957,1283.0,2769.0,1766.0
0.006,6,10,1547,5,764,1.0,496.0,496.0,5,783,1.0,515.0,515.0
178.192,17,76,10866,38,2521,4815.0,44.0,38.0,38,8345,4815.0,261.0,191.0
0.114,6,10,1506,5,395,23.0,127.0,127.0,5,1111,27.0,843.0,843.0
0.012,6,14,3787,7,497,1.0,125.0,125.0,7,3290,2.0,1448.0,972.0
0.17,17,2,152,1,76,0.0,48.0,48.0,1,76,0.0,48.0,48.0
0.068,6,10,1506,5,395,15.0,127.0,127.0,5,1111,14.0,843.0,843.0
0.005,6,13,3747,7,509,0.0,137.0,137.0,6,3238,1.0,1470.0,1459.0
0.039,17,2,152,1,76,0.0,48.0,48.0,1,76,0.0,48.0,48.0
0.001,17,2,180,1,66,0.0,38.0,38.0,1,114,0.0,86.0,86.0
0.112,6,10,1506,5,395,24.0,127.0,127.0,5,1111,18.0,843.0,843.0
0.209,6,10,1506,5,395,49.0,127.0,127.0,5,1111,47.0,843.0,843.0
0.016,6,10,1983,5,910,3.0,642.0,642.0,5,1073,3.0,805.0,805.0
0.039,17,2,136,1,60,0.0,32.0,32.0,1,76,0.0,48.0,48.0
120.039,6,19,3889,12,3102,10912.0,494.0,494.0,7,787,20006.0,83.0,83.0
0.006,6,10,1547,5,764,1.0,496.0,496.0,5,783,1.0,515.0,515.0
0.006,6,10,1689,5,839,1.0,571.0,571.0,5,850,1.0,582.0,582.0
1777.823,17,143,41496,72,22752,25039.0,288.0,288.0,71,18744,25397.0,236.0,236.0
0.088,6,10,1506,5,395,20.0,127.0,127.0,5,1111,17.0,843.0,843.0
0.169,17,2,152,1,76,0.0,48.0,48.0,1,76,0.0,48.0,48.0
0.005,6,10,1689,5,839,1.0,571.0,571.0,5,850,1.0,582.0,582.0
10.723,17,28,4418,14,1994,816.0,269.0,114.0,14,2424,816.0,587.0,145.0
0.018,6,13,3735,7,497,3.0,125.0,125.0,6,3238,3.0,1470.0,1459.0
0.005,6,10,2006,5,927,1.0,659.0,659.0,5,1079,1.0,811.0,811.0
0.014,6,10,1989,5,910,3.0,642.0,642.0,5,1079,3.0,811.0,811.0
0.006,6,10,1689,5,839,1.0,571.0,571.0,5,850,1.0,582.0,582.0
0.007,6,10,1689,5,839,1.0,571.0,571.0,5,850,1.0,582.0,582.0
311.362,17,20,1124,10,716,34581.0,48.0,43.0,10,408,34581.0,20.0,12.0
0.001,17,2,180,1,66,0.0,38.0,38.0,1,114,0.0,86.0,86.0
0.019,6,10,1972,5,910,4.0,642.0,642.0,5,1062,4.0,794.0,794.0
0.006,17,2,166,1,75,0.0,47.0,47.0,1,91,0.0,63.0,63.0
0.008,6,10,1983,5,910,2.0,642.0,642.0,5,1073,1.0,805.0,805.0
0.068,6,10,1506,5,395,15.0,127.0,127.0,5,1111,12.0,843.0,843.0
0.214,17,4,352,2,130,142.0,37.0,37.0,2,222,176.0,89.0,83.0
1730.403,6,48,2957,31,1800,57680.0,35.0,35.0,17,1157,108145.0,31.0,31.0
10.88,17,28,4421,14,1994,828.0,269.0,114.0,14,2427,828.0,586.0,145.0
10.879,17,28,4395,14,1995,828.0,270.0,114.0,14,2400,828.0,587.0,143.0
0.006,6,10,1762,5,911,1.0,643.0,643.0,5,851,1.0,583.0,583.0
0.01,6,10,1972,5,910,2.0,642.0,642.0,5,1062,2.0,794.0,794.0
0.012,6,10,1631,5,848,3.0,580.0,580.0,5,783,3.0,515.0,515.0
0.006,6,10,1547,5,764,1.0,496.0,496.0,5,783,1.0,515.0,515.0
0.075,6,10,1506,5,395,15.0,127.0,127.0,5,1111,17.0,843.0,843.0
0.004,6,10,2006,5,927,1.0,659.0,659.0,5,1079,1.0,811.0,811.0
0.008,6,10,1990,5,911,2.0,643.0,643.0,5,1079,2.0,811.0,811.0
0.005,6,10,2007,5,928,1.0,660.0,660.0,5,1079,1.0,811.0,811.0
0.007,17,2,424,1,72,0.0,44.0,44.0,1,352,0.0,324.0,324.0
308.694,17,20,1124,10,716,34285.0,48.0,43.0,10,408,34285.0,20.0,12.0
0.099,6,10,1506,5,395,21.0,127.0,127.0,5,1111,17.0,843.0,843.0
314.526,17,20,1124,10,716,34933.0,48.0,43.0,10,408,34933.0,20.0,12.0
0.087,6,10,1506,5,395,16.0,127.0,127.0,5,1111,20.0,843.0,843.0
0.005,6,10,2006,5,927,1.0,659.0,659.0,5,1079,1.0,811.0,811.0
0.017,6,10,1762,5,911,4.0,643.0,643.0,5,851,4.0,583.0,583.0
0.015,6,10,1631,5,848,3.0,580.0,580.0,5,783,3.0,515.0,515.0
0.071,17,8,3613,4,1874,23.0,1350.0,440.0,4,1739,13.0,1350.0,406.0
0.006,17,2,230,1,68,0.0,40.0,40.0,1,162,0.0,134.0,134.0
40.055,17,10,676,5,460,10013.0,104.0,64.0,5,216,10013.0,20.0,15.0
0.009,6,10,1631,5,848,2.0,580.0,580.0,5,783,2.0,515.0,515.0
0.006,6,10,1547,5,764,1.0,496.0,496.0,5,783,1.0,515.0,515.0
0.017,6,10,1983,5,910,4.0,642.0,642.0,5,1073,4.0,805.0,805.0
0.006,6,10,1547,5,764,1.0,496.0,496.0,5,783,1.0,515.0,515.0
0.012,6,10,1983,5,910,3.0,642.0,642.0,5,1073,2.0,805.0,805.0
0.166,17,2,152,1,76,0.0,48.0,48.0,1,76,0.0,48.0,48.0
0.005,6,10,1689,5,839,1.0,571.0,571.0,5,850,1.0,582.0,582.0
0.004,17,2,179,1,71,0.0,43.0,43.0,1,108,0.0,80.0,80.0
0.039,17,2,184,1,61,0.0,33.0,33.0,1,123,0.0,95.0,95.0
0.005,6,10,1774,5,923,1.0,655.0,655.0,5,851,1.0,583.0,583.0
0.038,17,2,136,1,60,0.0,32.0,32.0,1,76,0.0,48.0,48.0
0.221,6,16,2669,8,1395,31.0,533.0,323.0,8,1274,20.0,529.0,212.0
0.005,6,10,2006,5,927,1.0,659.0,659.0,5,1079,1.0,811.0,811.0
0.006,6,13,3747,7,509,1.0,137.0,137.0,6,3238,1.0,1470.0,1459.0
0.104,6,10,1506,5,395,20.0,127.0,127.0,5,1111,24.0,843.0,843.0
0.042,17,2,412,1,61,0.0,33.0,33.0,1,351,0.0,323.0,323.0
0.005,17,2,194,1,59,0.0,31.0,31.0,1,135,0.0,107.0,107.0
0.011,6,10,1989,5,910,2.0,642.0,642.0,5,1079,2.0,811.0,811.0
40.053,17,10,676,5,460,10012.0,104.0,64.0,5,216,10012.0,20.0,15.0
0.081,6,10,1506,5,395,17.0,127.0,127.0,5,1111,18.0,843.0,843.0
0.005,6,10,1774,5,923,1.0,655.0,655.0,5,851,1.0,583.0,583.0
1792.558,6,488,99332,244,87982,7376.0,421.0,365.0,244,11350,7376.0,53.0,53.0
0.016,6,10,1972,5,910,4.0,642.0,642.0,5,1062,4.0,794.0,794.0
0.012,6,10,1990,5,911,2.0,643.0,643.0,5,1079,3.0,811.0,811.0
0.005,6,10,1854,5,889,1.0,621.0,621.0,5,965,1.0,697.0,697.0
0.004,6,10,2006,5,927,1.0,659.0,659.0,5,1079,1.0,811.0,811.0
0.001,17,2,180,1,66,0.0,38.0,38.0,1,114,0.0,86.0,86.0
0.005,6,10,2006,5,927,1.0,659.0,659.0,5,1079,1.0,811.0,811.0
0.131,17,2,170,1,65,0.0,37.0,37.0,1,105,0.0,77.0,77.0
0.005,6,10,1774,5,923,1.0,655.0,655.0,5,851,1.0,583.0,583.0
0.111,6,10,1506,5,395,25.0,127.0,127.0,5,1111,23.0,843.0,843.0
0.004,6,10,2006,5,927,1.0,659.0,659.0,5,1079,1.0,811.0,811.0
0.009,6,10,1677,5,827,2.0,559.0,559.0,5,850,2.0,582.0,582.0
0.107,6,10,1506,5,395,24.0,127.0,127.0,5,1111,24.0,843.0,843.0
0.005,6,13,3747,7,509,0.0,137.0,137.0,6,3238,0.0,1470.0,1459.0
0.005,6,10,2006,5,927,1.0,659.0,659.0,5,1079,1.0,811.0,811.0
0.126,6,10,1506,5,395,27.0,127.0,127.0,5,1111,25.0,843.0,843.0
0.005,6,10,2007,5,928,1.0,660.0,660.0,5,1079,1.0,811.0,811.0
0.123,6,10,1506,5,395,29.0,127.0,127.0,5,1111,22.0,843.0,843.0
300.028,6,12,1782,7,1348,50004.0,494.0,494.0,5,434,75006.0,83.0,83.0
0.04,17,2,136,1,60,0.0,32.0,32.0,1,76,0.0,48.0,48.0
0.006,6,10,1547,5,764,1.0,496.0,496.0,5,783,1.0,515.0,515.0
0.005,6,10,2000,5,927,1.0,659.0,659.0,5,1073,1.0,805.0,805.0
40.053,17,10,676,5,460,10012.0,104.0,64.0,5,216,10012.0,20.0,15.0
0.004,6,10,2000,5,927,1.0,659.0,659.0,5,1073,1.0,805.0,805.0
0.015,6,10,1983,5,910,3.0,642.0,642.0,5,1073,3.0,805.0,805.0
0.095,6,10,1506,5,395,19.0,127.0,127.0,5,1111,19.0,843.0,843.0
0.008,17,2,194,1,59,0.0,31.0,31.0,1,135,0.0,107.0,107.0
0.007,6,10,2007,5,928,1.0,660.0,660.0,5,1079,1.0,811.0,811.0
0.003,17,2,136,1,60,0.0,32.0,32.0,1,76,0.0,48.0,48.0
0.103,6,10,1506,5,395,20.0,127.0,127.0,5,1111,23.0,843.0,843.0
0.008,6,13,3735,7,497,1.0,125.0,125.0,6,3238,1.0,1470.0,1459.0
0.089,6,10,1506,5,395,19.0,127.0,127.0,5,1111,20.0,843.0,843.0
301.758,6,258,223786,140,212207,2169.0,4080.0,1765.0,118,11579,2577.0,2667.0,236.0
0.005,6,10,2006,5,927,1.0,659.0,659.0,5,1079,1.0,811.0,811.0
0.111,6,10,1506,5,395,22.0,127.0,127.0,5,1111,24.0,843.0,843.0
0.006,6,10,1989,5,927,1.0,659.0,659.0,5,1062,1.0,794.0,794.0
0.006,6,10,1643,5,860,1.0,592.0,592.0,5,783,1.0,515.0,515.0
300.404,6,16,2170,9,684,37530.0,146.0,146.0,7,1486,50040.0,419.0,398.0
0.105,6,10,1506,5,395,24.0,127.0,127.0,5,1111,23.0,843.0,843.0
0.073,6,10,1506,5,395,14.0,127.0,127.0,5,1111,16.0,843.0,843.0
0.012,6,10,1990,5,911,2.0,643.0,643.0,5,1079,3.0,811.0,811.0
0.072,17,2,182,1,65,0.0,37.0,37.0,1,117,0.0,89.0,89.0
0.006,17,2,170,1,65,0.0,37.0,37.0,1,105,0.0,77.0,77.0
0.082,6,10,1506,5,395,18.0,127.0,127.0,5,1111,18.0,843.0,843.0
0.009,6,10,1983,5,910,2.0,642.0,642.0,5,1073,2.0,805.0,805.0
0.01,6,10,1989,5,910,2.0,642.0,642.0,5,1079,2.0,811.0,811.0
0.076,6,10,1506,5,395,17.0,127.0,127.0,5,1111,16.0,843.0,843.0
5.074,6,21,5923,12,1436,461.0,474.0,201.0,9,4487,634.0,1925.0,804.0
0.009,6,10,1990,5,911,2.0,643.0,643.0,5,1079,2.0,811.0,811.0
0.034,6,10,1989,5,910,8.0,642.0,642.0,5,1079,8.0,811.0,811.0
0.227,6,16,2777,8,1395,32.0,533.0,323.0,8,1382,21.0,529.0,239.0
0.073,17,4,596,2,122,1.0,33.0,33.0,2,474,1.0,323.0,209.0
0.005,17,2,144,1,64,0.0,36.0,36.0,1,80,0.0,52.0,52.0
0.007,17,2,222,1,65,0.0,37.0,37.0,1,157,0.0,129.0,129.0
0.001,17,2,142,1,63,0.0,35.0,35.0,1,79,0.0,51.0,51.0
0.005,6,10,2007,5,928,1.0,660.0,660.0,5,1079,1.0,811.0,811.0
0.005,6,10,1689,5,839,1.0,571.0,571.0,5,850,1.0,582.0,582.0
0.005,6,10,1689,5,839,1.0,571.0,571.0,5,850,1.0,582.0,582.0
0.004,17,2,170,1,65,0.0,37.0,37.0,1,105,0.0,77.0,77.0
0.04,17,2,186,1,61,0.0,33.0,33.0,1,125,0.0,97.0,97.0
0.008,6,12,1926,6,1189,1.0,659.0,434.0,6,737,1.0,417.0,417.0
240.101,6,16,4480,9,963,30012.0,238.0,166.0,7,3517,40016.0,1402.0,786.0
0.006,6,10,1547,5,764,1.0,496.0,496.0,5,783,1.0,515.0,515.0
0.006,17,2,194,1,59,0.0,31.0,31.0,1,135,0.0,107.0,107.0
0.005,17,2,180,1,66,0.0,38.0,38.0,1,114,0.0,86.0,86.0
0.006,17,2,179,1,71,0.0,43.0,43.0,1,108,0.0,80.0,80.0
0.004,17,2,136,1,60,0.0,32.0,32.0,1,76,0.0,48.0,48.0
0.003,17,4,284,2,120,0.0,32.0,32.0,2,164,0.0,60.0,54.0
0.013,6,10,1983,5,910,3.0,642.0,642.0,5,1073,3.0,805.0,805.0
0.012,6,10,1989,5,910,3.0,642.0,642.0,5,1079,2.0,811.0,811.0
0.004,6,10,2007,5,928,1.0,660.0,660.0,5,1079,1.0,811.0,811.0
0.006,17,2,157,1,59,0.0,31.0,31.0,1,98,0.0,70.0,70.0
0.12,6,10,1506,5,395,27.0,127.0,127.0,5,1111,21.0,843.0,843.0
0.004,6,10,2000,5,927,1.0,659.0,659.0,5,1073,1.0,805.0,805.0
0.012,6,10,1631,5,848,3.0,580.0,580.0,5,783,3.0,515.0,515.0
0.005,6,10,2007,5,928,1.0,660.0,660.0,5,1079,1.0,811.0,811.0
0.15,6,10,1506,5,395,35.0,127.0,127.0,5,1111,35.0,843.0,843.0
0.005,6,10,1989,5,927,1.0,659.0,659.0,5,1062,1.0,794.0,794.0
40.071,17,10,676,5,460,10014.0,104.0,64.0,5,216,10017.0,20.0,15.0
0.012,6,10,1972,5,910,2.0,642.0,642.0,5,1062,2.0,794.0,794.0
15.077,17,15,9238,8,6902,2149.0,1350.0,834.0,7,2336,2507.0,1350.0,305.0
178.192,17,70,9923,35,2326,5240.0,44.0,38.0,35,7597,5240.0,252.0,189.0
0.004,6,10,2000,5,927,1.0,659.0,659.0,5,1073,1.0,805.0,805.0
0.096,6,10,1506,5,395,23.0,127.0,127.0,5,1111,20.0,843.0,843.0
0.016,6,6,716,3,458,6.0,302.0,302.0,3,258,6.0,102.0,102.0
0.016,6,13,3735,7,497,2.0,125.0,125.0,6,3238,3.0,1470.0,1459.0
0.005,6,10,1547,5,764,1.0,496.0,496.0,5,783,1.0,515.0,515.0
0.07,6,10,1506,5,395,16.0,127.0,127.0,5,1111,14.0,843.0,843.0
0.004,6,10,1989,5,927,1.0,659.0,659.0,5,1062,1.0,794.0,794.0
0.005,17,2,180,1,66,0.0,38.0,38.0,1,114,0.0,86.0,86.0
40.064,17,10,676,5,460,10014.0,104.0,64.0,5,216,10015.0,20.0,15.0
0.004,6,10,1989,5,927,1.0,659.0,659.0,5,1062,1.0,794.0,794.0
0.007,6,10,1547,5,764,1.0,496.0,496.0,5,783,1.0,515.0,515.0
0.153,6,10,1506,5,395,36.0,127.0,127.0,5,1111,35.0,843.0,843.0
0.064,6,10,1506,5,395,15.0,127.0,127.0,5,1111,13.0,843.0,843.0
0.02,6,10,1989,5,910,4.0,642.0,642.0,5,1079,5.0,811.0,811.0
0.079,6,10,1506,5,395,18.0,127.0,127.0,5,1111,17.0,843.0,843.0
0.106,6,10,1506,5,395,21.0,127.0,127.0,5,1111,24.0,843.0,843.0
0.009,6,10,1990,5,911,2.0,643.0,643.0,5,1079,2.0,811.0,811.0
40.043,17,10,676,5,460,10010.0,104.0,64.0,5,216,10010.0,20.0,15.0
10.97,17,28,4394,14,2312,835.0,587.0,137.0,14,2082,835.0,269.0,120.0
0.086,6,10,1506,5,395,18.0,127.0,127.0,5,1111,16.0,843.0,843.0
0.003,17,2,170,1,65,0.0,37.0,37.0,1,105,0.0,77.0,77.0
0.013,6,10,1983,5,910,3.0,642.0,642.0,5,1073,3.0,805.0,805.0
0.084,6,10,1506,5,395,18.0,127.0,127.0,5,1111,17.0,843.0,843.0
0.037,6,10,1972,5,910,9.0,642.0,642.0,5,1062,9.0,794.0,794.0
40.066,17,10,676,5,460,10013.0,104.0,64.0,5,216,10015.0,20.0,15.0
0.006,6,10,1854,5,889,1.0,621.0,621.0,5,965,1.0,697.0,697.0
0.006,6,10,1689,5,839,1.0,571.0,571.0,5,850,1.0,582.0,582.0
0.011,6,10,1631,5,848,2.0,580.0,580.0,5,783,2.0,515.0,515.0
0.021,6,10,1972,5,910,5.0,642.0,642.0,5,1062,5.0,794.0,794.0
310.378,17,20,1124,10,716,34471.0,48.0,43.0,10,408,34471.0,20.0,12.0
0.004,6,10,2007,5,928,1.0,660.0,660.0,5,1079,1.0,811.0,811.0
0.005,6,13,3747,7,509,0.0,137.0,137.0,6,3238,0.0,1470.0,1459.0
0.087,6,10,1506,5,395,18.0,127.0,127.0,5,1111,19.0,843.0,843.0
0.006,6,10,1689,5,839,1.0,571.0,571.0,5,850,1.0,582.0,582.0
240.109,6,31,9511,15,6910,17150.0,2034.0,681.0,16,2601,16007.0,580.0,220.0
0.009,6,12,1926,6,1189,1.0,659.0,434.0,6,737,1.0,417.0,417.0
0.005,6,10,1989,5,927,1.0,659.0,659.0,5,1062,1.0,794.0,794.0
0.004,6,10,1989,5,927,1.0,659.0,659.0,5,1062,1.0,794.0,794.0
0.005,6,10,1689,5,839,1.0,571.0,571.0,5,850,1.0,582.0,582.0
40.046,17,10,676,5,460,10010.0,104.0,64.0,5,216,10010.0,20.0,15.0
0.08,6,10,1506,5,395,19.0,127.0,127.0,5,1111,15.0,843.0,843.0
0.005,6,13,3747,7,509,0.0,137.0,137.0,6,3238,1.0,1470.0,1459.0
309.043,17,20,1124,10,716,34324.0,48.0,43.0,10,408,34323.0,20.0,12.0
0.097,6,10,1506,5,395,20.0,127.0,127.0,5,1111,21.0,843.0,843.0
0.113,6,10,1506,5,395,24.0,127.0,127.0,5,1111,25.0,843.0,843.0
0.003,17,4,284,2,120,0.0,32.0,32.0,2,164,0.0,60.0,54.0
0.011,6,14,3787,7,497,1.0,125.0,125.0,7,3290,1.0,1448.0,972.0
300.907,6,31,10086,17,2837,18806.0,801.0,389.0,14,7249,18525.0,1402.0,814.0
0.193,17,4,352,2,130,150.0,37.0,37.0,2,222,152.0,89.0,83.0
0.068,6,14,3965,7,495,11.0,123.0,123.0,7,3470,11.0,1448.0,1032.0
309.028,17,20,1124,10,716,34322.0,48.0,43.0,10,408,34322.0,20.0,12.0
0.004,6,10,2006,5,927,1.0,659.0,659.0,5,1079,1.0,811.0,811.0
0.004,6,10,1779,5,928,1.0,660.0,660.0,5,851,1.0,583.0,583.0
0.004,17,2,136,1,60,0.0,32.0,32.0,1,76,0.0,48.0,48.0
300.327,6,16,2170,9,684,37519.0,146.0,146.0,7,1486,50026.0,419.0,398.0
0.007,17,2,214,1,75,0.0,47.0,47.0,1,139,0.0,111.0,111.0
0.008,17,2,144,1,64,0.0,36.0,36.0,1,80,0.0,52.0,52.0
0.113,6,10,1506,5,395,24.0,127.0,127.0,5,1111,24.0,843.0,843.0
0.006,6,10,1547,5,764,1.0,496.0,496.0,5,783,1.0,515.0,515.0
0.067,6,10,1506,5,395,15.0,127.0,127.0,5,1111,14.0,843.0,843.0
0.011,6,10,1989,5,910,2.0,642.0,642.0,5,1079,2.0,811.0,811.0
0.01,6,10,1972,5,910,2.0,642.0,642.0,5,1062,2.0,794.0,794.0
0.001,17,2,166,1,75,0.0,47.0,47.0,1,91,0.0,63.0,63.0
0.005,6,10,2000,5,927,1.0,659.0,659.0,5,1073,1.0,805.0,805.0
0.001,17,2,180,1,66,0.0,38.0,38.0,1,114,0.0,86.0,86.0
40.049,17,10,676,5,460,10011.0,104.0,64.0,5,216,10011.0,20.0,15.0
40.058,17,10,676,5,460,10012.0,104.0,64.0,5,216,10013.0,20.0,15.0
0.004,6,10,2006,5,927,1.0,659.0,659.0,5,1079,1.0,811.0,811.0
0.072,17,2,412,1,61,0.0,33.0,33.0,1,351,0.0,323.0,323.0
0.004,6,10,1774,5,923,1.0,655.0,655.0,5,851,1.0,583.0,583.0
11.118,17,28,4420,14,1993,842.0,268.0,114.0,14,2427,842.0,586.0,145.0
40.065,17,10,676,5,460,10015.0,104.0,64.0,5,216,10013.0,20.0,15.0
0.067,6,10,1506,5,395,14.0,127.0,127.0,5,1111,16.0,843.0,843.0
0.005,6,10,1689,5,839,1.0,571.0,571.0,5,850,1.0,582.0,582.0
0.006,6,10,1547,5,764,1.0,496.0,496.0,5,783,1.0,515.0,515.0
0.005,17,2,214,1,75,0.0,47.0,47.0,1,139,0.0,111.0,111.0
0.005,6,10,1643,5,860,1.0,592.0,592.0,5,783,1.0,515.0,515.0
0.006,6,10,2006,5,927,1.0,659.0,659.0,5,1079,1.0,811.0,811.0
66.32,6,22,10162,12,3995,6029.0,1601.0,840.0,10,6167,7349.0,2111.0,939.0
242.215,6,300,343261,110,17238,2222.0,2736.0,960.0,190,326023,1281.0,4206.0,1756.0
0.005,17,2,170,1,65,0.0,37.0,37.0,1,105,0.0,77.0,77.0
0.004,6,10,1702,5,863,1.0,595.0,595.0,5,839,0.0,571.0,571.0
0.134,6,10,1506,5,395,30.0,127.0,127.0,5,1111,30.0,843.0,843.0
0.006,17,2,214,1,75,0.0,47.0,47.0,1,139,0.0,111.0,111.0
15.079,17,15,8203,8,6090,2149.0,1350.0,733.0,7,2113,2508.0,1350.0,273.0
0.068,17,8,3613,4,1874,22.0,1350.0,440.0,4,1739,11.0,1350.0,406.0
0.063,6,10,1506,5,395,13.0,127.0,127.0,5,1111,15.0,843.0,843.0
0.004,17,2,136,1,60,0.0,32.0,32.0,1,76,0.0,48.0,48.0
0.081,6,10,1506,5,395,19.0,127.0,127.0,5,1111,19.0,843.0,843.0
0.17,6,3,453,2,321,170.0,241.0,241.0,1,132,0.0,92.0,92.0
0.005,17,2,170,1,65,0.0,37.0,37.0,1,105,0.0,77.0,77.0
0.003,17,2,136,1,60,0.0,32.0,32.0,1,76,0.0,48.0,48.0
0.007,6,10,1547,5,764,1.0,496.0,496.0,5,783,1.0,515.0,515.0
0.02,6,10,1762,5,911,5.0,643.0,643.0,5,851,4.0,583.0,583.0
0.005,6,14,3799,7,509,0.0,137.0,137.0,7,3290,0.0,1448.0,972.0
0.007,6,10,1854,5,889,1.0,621.0,621.0,5,965,1.0,697.0,697.0
0.071,17,4,284,2,120,0.0,32.0,32.0,2,164,68.0,60.0,54.0
0.046,17,2,182,1,65,0.0,37.0,37.0,1,117,0.0,89.0,89.0
0.099,6,10,1506,5,395,21.0,127.0,127.0,5,1111,23.0,843.0,843.0
0.001,17,2,180,1,66,0.0,38.0,38.0,1,114,0.0,86.0,86.0
0.005,17,2,169,1,62,0.0,34.0,34.0,1,107,0.0,79.0,79.0
40.057,17,10,676,5,460,10013.0,104.0,64.0,5,216,10013.0,20.0,15.0
0.005,6,10,1989,5,927,1.0,659.0,659.0,5,1062,1.0,794.0,794.0
0.005,6,10,2000,5,927,1.0,659.0,659.0,5,1073,1.0,805.0,805.0
0.003,17,2,148,1,60,0.0,32.0,32.0,1,88,0.0,60.0,60.0
0.006,6,10,1547,5,764,1.0,496.0,496.0,5,783,1.0,515.0,515.0
0.005,17,2,230,1,68,0.0,40.0,40.0,1,162,0.0,134.0,134.0
0.164,17,2,152,1,76,0.0,48.0,48.0,1,76,0.0,48.0,48.0
0.001,17,2,166,1,75,0.0,47.0,47.0,1,91,0.0,63.0,63.0
0.04,17,2,148,1,60,0.0,32.0,32.0,1,88,0.0,60.0,60.0
0.014,6,13,3735,7,497,2.0,125.0,125.0,6,3238,2.0,1470.0,1459.0
0.004,6,14,3742,8,504,0.0,80.0,80.0,6,3238,0.0,1470.0,1459.0
0.004,6,10,2006,5,927,1.0,659.0,659.0,5,1079,1.0,811.0,811.0
0.004,17,2,136,1,60,0.0,32.0,32.0,1,76,0.0,48.0,48.0
0.012,6,10,1990,5,911,3.0,643.0,643.0,5,1079,2.0,811.0,811.0
0.009,6,10,1989,5,910,2.0,642.0,642.0,5,1079,2.0,811.0,811.0
0.092,6,10,1506,5,395,20.0,127.0,127.0,5,1111,20.0,843.0,843.0
0.005,6,10,1779,5,928,1.0,660.0,660.0,5,851,1.0,583.0,583.0
0.005,6,10,1774,5,923,1.0,655.0,655.0,5,851,1.0,583.0,583.0
0.012,6,10,1972,5,910,3.0,642.0,642.0,5,1062,2.0,794.0,794.0
0.008,6,10,1689,5,839,1.0,571.0,571.0,5,850,1.0,582.0,582.0
313.824,17,20,1124,10,716,34858.0,48.0,43.0,10,408,34857.0,20.0,12.0
0.001,17,2,180,1,66,0.0,38.0,38.0,1,114,0.0,86.0,86.0
175.141,17,88,11672,44,2944,4072.0,44.0,38.0,44,8728,4073.0,252.0,170.0
0.008,6,10,1989,5,910,2.0,642.0,642.0,5,1079,1.0,811.0,811.0
0.04,17,4,284,2,120,0.0,32.0,32.0,2,164,37.0,60.0,54.0
0.085,6,10,1506,5,395,20.0,127.0,127.0,5,1111,18.0,843.0,843.0
0.012,6,10,1972,5,910,2.0,642.0,642.0,5,1062,3.0,794.0,794.0
0.003,17,2,136,1,60,0.0,32.0,32.0,1,76,0.0,48.0,48.0
40.068,17,10,676,5,460,10015.0,104.0,64.0,5,216,10015.0,20.0,15.0
352.763,6,20,2210,6,1308,12003.0,494.0,494.0,14,902,27135.0,83.0,83.0
0.016,6,10,1990,5,911,3.0,643.0,643.0,5,1079,4.0,811.0,811.0
0.176,6,10,1506,5,395,42.0,127.0,127.0,5,1111,36.0,843.0,843.0
0.004,17,2,148,1,60,0.0,32.0,32.0,1,88,0.0,60.0,60.0
308.452,17,20,1124,10,716,34257.0,48.0,43.0,10,408,34257.0,20.0,12.0
0.005,6,10,1643,5,860,1.0,592.0,592.0,5,783,1.0,515.0,515.0
0.004,6,10,2007,5,928,1.0,660.0,660.0,5,1079,1.0,811.0,811.0
315.179,17,20,1124,10,716,35007.0,48.0,43.0,10,408,35007.0,20.0,12.0
0.024,6,10,1972,5,910,6.0,642.0,642.0,5,1062,6.0,794.0,794.0
0.006,6,10,2006,5,927,1.0,659.0,659.0,5,1079,1.0,811.0,811.0
0.012,6,10,1990,5,911,2.0,643.0,643.0,5,1079,2.0,811.0,811.0
0.083,6,10,1506,5,395,18.0,127.0,127.0,5,1111,18.0,843.0,843.0
0.01,6,10,1989,5,910,2.0,642.0,642.0,5,1079,2.0,811.0,811.0
0.006,6,10,1547,5,764,1.0,496.0,496.0,5,783,1.0,515.0,515.0
0.004,17,2,136,1,60,0.0,32.0,32.0,1,76,0.0,48.0,48.0
0.005,6,10,2006,5,927,1.0,659.0,659.0,5,1079,1.0,811.0,811.0
300.405,6,16,2170,9,684,37530.0,146.0,146.0,7,1486,50040.0,419.0,398.0
0.021,6,10,1990,5,911,5.0,643.0,643.0,5,1079,5.0,811.0,811.0
10.757,17,28,4423,14,1995,819.0,270.0,114.0,14,2428,819.0,587.0,145.0
0.005,6,10,2006,5,927,1.0,659.0,659.0,5,1079,1.0,811.0,811.0
0.005,6,10,1989,5,927,1.0,659.0,659.0,5,1062,1.0,794.0,794.0
0.006,6,10,1547,5,764,1.0,496.0,496.0,5,783,1.0,515.0,515.0
0.001,17,2,180,1,66,0.0,38.0,38.0,1,114,0.0,86.0,86.0
0.005,6,10,1774,5,923,1.0,655.0,655.0,5,851,1.0,583.0,583.0
0.01,6,10,1983,5,910,2.0,642.0,642.0,5,1073,2.0,805.0,805.0
0.004,6,10,2006,5,927,1.0,659.0,659.0,5,1079,1.0,811.0,811.0
0.005,6,10,2006,5,927,1.0,659.0,659.0,5,1079,1.0,811.0,811.0
0.006,6,10,1547,5,764,1.0,496.0,496.0,5,783,1.0,515.0,515.0
0.016,6,10,1990,5,911,3.0,643.0,643.0,5,1079,3.0,811.0,811.0
0.011,6,10,1972,5,910,2.0,642.0,642.0,5,1062,2.0,794.0,794.0
300.371,6,16,2170,9,684,37526.0,146.0,146.0,7,1486,50033.0,419.0,398.0
0.017,6,10,1989,5,910,4.0,642.0,642.0,5,1079,4.0,811.0,811.0
39.976,6,37,9811,19,4293,496.0,1360.0,700.0,18,5518,2342.0,2667.0,435.0
0.005,6,10,1989,5,927,1.0,659.0,659.0,5,1062,1.0,794.0,794.0
0.005,6,10,2006,5,927,1.0,659.0,659.0,5,1079,1.0,811.0,811.0
0.054,17,2,152,1,76,0.0,48.0,48.0,1,76,0.0,48.0,48.0
0.009,6,10,1989,5,927,2.0,659.0,659.0,5,1062,2.0,794.0,794.0
352.95,6,20,2210,6,1308,12003.0,494.0,494.0,14,902,27149.0,83.0,83.0
0.149,6,10,1506,5,395,34.0,127.0,127.0,5,1111,33.0,843.0,843.0
0.005,17,2,179,1,71,0.0,43.0,43.0,1,108,0.0,80.0,80.0
0.005,6,14,3799,7,509,0.0,137.0,137.0,7,3290,0.0,1448.0,972.0
289.905,6,375,347250,199,21916,1464.0,2736.0,889.0,176,325334,1656.0,4171.0,1951.0
0.005,6,10,2006,5,927,1.0,659.0,659.0,5,1079,1.0,811.0,811.0
1786.298,6,150,19350,90,13740,20070.0,302.0,302.0,60,5610,30275.0,83.0,83.0
0.018,6,10,1989,5,910,4.0,642.0,642.0,5,1079,4.0,811.0,811.0
0.004,6,10,1989,5,927,1.0,659.0,659.0,5,1062,1.0,794.0,794.0
0.005,17,2,136,1,60,0.0,32.0,32.0,1,76,0.0,48.0,48.0
0.005,6,10,2000,5,927,1.0,659.0,659.0,5,1073,1.0,805.0,805.0
269.641,17,18,1008,9,640,33689.0,48.0,43.0,9,368,33689.0,20.0,12.0
0.004,6,10,1774,5,923,1.0,655.0,655.0,5,851,1.0,583.0,583.0
0.04,17,2,182,1,65,0.0,37.0,37.0,1,117,0.0,89.0,89.0
0.135,6,10,1506,5,395,32.0,127.0,127.0,5,1111,30.0,843.0,843.0
0.071,6,10,1506,5,395,15.0,127.0,127.0,5,1111,15.0,843.0,843.0
0.011,6,10,1989,5,910,2.0,642.0,642.0,5,1079,2.0,811.0,811.0
0.001,17,2,180,1,66,0.0,38.0,38.0,1,114,0.0,86.0,86.0
0.004,6,10,2006,5,927,1.0,659.0,659.0,5,1079,1.0,811.0,811.0
0.138,6,10,1506,5,395,34.0,127.0,127.0,5,1111,29.0,843.0,843.0
0.005,6,10,2006,5,927,1.0,659.0,659.0,5,1079,1.0,811.0,811.0
0.004,6,10,2007,5,928,1.0,660.0,660.0,5,1079,1.0,811.0,811.0
0.005,6,10,2006,5,927,1.0,659.0,659.0,5,1079,1.0,811.0,811.0
0.017,6,10,1989,5,910,4.0,642.0,642.0,5,1079,4.0,811.0,811.0
10.883,17,28,4422,14,1994,828.0,269.0,114.0,14,2428,828.0,587.0,145.0
0.037,17,2,148,1,60,0.0,32.0,32.0,1,88,0.0,60.0,60.0
0.005,17,2,170,1,65,0.0,37.0,37.0,1,105,0.0,77.0,77.0
0.013,6,10,1762,5,911,3.0,643.0,643.0,5,851,3.0,583.0,583.0
0.009,6,10,1990,5,911,2.0,643.0,643.0,5,1079,2.0,811.0,811.0
0.067,6,10,1506,5,395,15.0,127.0,127.0,5,1111,13.0,843.0,843.0
0.005,17,2,170,1,65,0.0,37.0,37.0,1,105,0.0,77.0,77.0
0.006,6,10,1643,5,860,1.0,592.0,592.0,5,783,1.0,515.0,515.0
0.006,6,10,1643,5,860,1.0,592.0,592.0,5,783,1.0,515.0,515.0
0.005,6,10,1547,5,764,1.0,496.0,496.0,5,783,1.0,515.0,515.0
0.005,6,10,2007,5,928,1.0,660.0,660.0,5,1079,1.0,811.0,811.0
0.004,6,10,2006,5,927,1.0,659.0,659.0,5,1079,1.0,811.0,811.0
0.008,6,10,1972,5,910,1.0,642.0,642.0,5,1062,2.0,794.0,794.0
0.004,6,10,1702,5,863,1.0,595.0,595.0,5,839,0.0,571.0,571.0
0.026,6,10,1990,5,911,6.0,643.0,643.0,5,1079,6.0,811.0,811.0
0.015,6,10,1989,5,910,3.0,642.0,642.0,5,1079,3.0,811.0,811.0
0.014,6,10,1983,5,910,3.0,642.0,642.0,5,1073,3.0,805.0,805.0
0.007,17,2,194,1,59,0.0,31.0,31.0,1,135,0.0,107.0,107.0
0.139,6,10,1506,5,395,31.0,127.0,127.0,5,1111,33.0,843.0,843.0
0.005,6,10,1989,5,927,1.0,659.0,659.0,5,1062,1.0,794.0,794.0
0.004,17,2,158,1,63,0.0,35.0,35.0,1,95,0.0,67.0,67.0
240.097,6,33,9364,16,6689,16006.0,1750.0,649.0,17,2675,15005.0,580.0,222.0
0.004,6,10,2006,5,927,1.0,659.0,659.0,5,1079,1.0,811.0,811.0
0.09,6,10,1506,5,395,19.0,127.0,127.0,5,1111,20.0,843.0,843.0
0.011,6,10,1972,5,910,2.0,642.0,642.0,5,1062,2.0,794.0,794.0
0.083,6,10,1506,5,395,19.0,127.0,127.0,5,1111,17.0,843.0,843.0
1.092,6,28,12271,16,3260,72.0,1360.0,517.0,12,9011,83.0,2720.0,1064.0
0.005,6,10,2006,5,927,1.0,659.0,659.0,5,1079,1.0,811.0,811.0
0.005,6,10,1774,5,923,1.0,655.0,655.0,5,851,1.0,583.0,583.0
0.014,6,10,1989,5,910,3.0,642.0,642.0,5,1079,3.0,811.0,811.0
0.012,6,10,1990,5,911,3.0,643.0,643.0,5,1079,3.0,811.0,811.0
0.005,6,10,2006,5,927,1.0,659.0,659.0,5,1079,1.0,811.0,811.0
40.053,17,10,676,5,460,10012.0,104.0,64.0,5,216,10012.0,20.0,15.0
0.005,6,10,1643,5,860,1.0,592.0,592.0,5,783,1.0,515.0,515.0
0.005,6,13,3747,7,509,0.0,137.0,137.0,6,3238,0.0,1470.0,1459.0
0.092,6,10,1506,5,395,19.0,127.0,127.0,5,1111,21.0,843.0,843.0
0.005,6,10,2006,5,927,1.0,659.0,659.0,5,1079,1.0,811.0,811.0
0.005,17,2,136,1,60,0.0,32.0,32.0,1,76,0.0,48.0,48.0
0.011,6,10,1990,5,911,2.0,643.0,643.0,5,1079,2.0,811.0,811.0
0.132,6,10,1506,5,395,25.0,127.0,127.0,5,1111,22.0,843.0,843.0
0.005,17,2,166,1,75,0.0,47.0,47.0,1,91,0.0,63.0,63.0
0.012,6,10,1983,5,910,3.0,642.0,642.0,5,1073,3.0,805.0,805.0
0.009,6,10,1989,5,927,2.0,659.0,659.0,5,1062,2.0,794.0,794.0
0.005,6,14,3736,7,446,0.0,74.0,74.0,7,3290,0.0,1448.0,972.0
292.447,6,382,346867,194,21645,1515.0,2736.0,888.0,188,325222,1563.0,2804.0,1812.0
0.006,6,10,1689,5,839,1.0,571.0,571.0,5,850,1.0,582.0,582.0
0.006,6,10,1547,5,764,1.0,496.0,496.0,5,783,1.0,515.0,515.0
0.067,6,10,1506,5,395,12.0,127.0,127.0,5,1111,16.0,843.0,843.0
0.005,6,10,1989,5,927,1.0,659.0,659.0,5,1062,1.0,794.0,794.0
0.1,6,10,1506,5,395,23.0,127.0,127.0,5,1111,21.0,843.0,843.0
0.005,17,2,170,1,65,0.0,37.0,37.0,1,105,0.0,77.0,77.0
0.096,6,10,1506,5,395,18.0,127.0,127.0,5,1111,22.0,843.0,843.0
40.055,17,10,676,5,460,10012.0,104.0,64.0,5,216,10012.0,20.0,15.0
0.006,6,10,1547,5,764,1.0,496.0,496.0,5,783,1.0,515.0,515.0
0.005,17,2,140,1,62,0.0,34.0,34.0,1,78,0.0,50.0,50.0
0.005,17,2,179,1,71,0.0,43.0,43.0,1,108,0.0,80.0,80.0
280.424,6,24,6115,11,1226,28042.0,267.0,156.0,13,4889,23367.0,1400.0,873.0
40.072,17,10,676,5,460,10016.0,104.0,64.0,5,216,10017.0,20.0,15.0
0.006,6,10,1547,5,764,1.0,496.0,496.0,5,783,1.0,515.0,515.0
40.076,17,10,676,5,460,10017.0,104.0,64.0,5,216,10018.0,20.0,15.0
0.01,6,10,1989,5,910,2.0,642.0,642.0,5,1079,2.0,811.0,811.0
0.004,6,10,2007,5,928,1.0,660.0,660.0,5,1079,1.0,811.0,811.0
300.322,6,16,2170,9,684,37519.0,146.0,146.0,7,1486,50025.0,419.0,398.0
0.006,6,10,1547,5,764,1.0,496.0,496.0,5,783,1.0,515.0,515.0
11.12,17,28,4421,14,1993,842.0,268.0,114.0,14,2428,842.0,587.0,145.0
0.018,6,10,1983,5,910,4.0,642.0,642.0,5,1073,4.0,805.0,805.0
0.004,6,10,2006,5,927,1.0,659.0,659.0,5,1079,1.0,811.0,811.0
0.143,17,2,152,1,76,0.0,48.0,48.0,1,76,0.0,48.0,48.0
0.003,17,2,148,1,60,0.0,32.0,32.0,1,88,0.0,60.0,60.0
0.001,17,2,166,1,75,0.0,47.0,47.0,1,91,0.0,63.0,63.0
0.012,6,13,3735,7,497,2.0,125.0,125.0,6,3238,2.0,1470.0,1459.0
0.018,6,10,1972,5,910,4.0,642.0,642.0,5,1062,4.0,794.0,794.0
0.039,17,4,284,2,120,0.0,32.0,32.0,2,164,35.0,60.0,54.0
0.006,17,2,169,1,62,0.0,34.0,34.0,1,107,0.0,79.0,79.0
0.014,6,13,3735,7,497,2.0,125.0,125.0,6,3238,2.0,1470.0,1459.0
0.001,17,2,180,1,66,0.0,38.0,38.0,1,114,0.0,86.0,86.0
0.006,6,10,1643,5,860,1.0,592.0,592.0,5,783,1.0,515.0,515.0
0.004,17,2,136,1,60,0.0,32.0,32.0,1,76,0.0,48.0,48.0
0.1,6,10,1506,5,395,24.0,127.0,127.0,5,1111,23.0,843.0,843.0
0.009,6,12,1926,6,1189,1.0,659.0,434.0,6,737,1.0,417.0,417.0
0.004,17,2,136,1,60,0.0,32.0,32.0,1,76,0.0,48.0,48.0
0.013,6,10,1989,5,910,3.0,642.0,642.0,5,1079,3.0,811.0,811.0
0.124,6,10,1506,5,395,25.0,127.0,127.0,5,1111,25.0,843.0,843.0
0.127,6,10,1506,5,395,28.0,127.0,127.0,5,1111,30.0,843.0,843.0
0.005,17,2,179,1,71,0.0,43.0,43.0,1,108,0.0,80.0,80.0
0.016,17,2,198,1,91,0.0,63.0,63.0,1,107,0.0,79.0,79.0
0.011,6,10,1989,5,910,2.0,642.0,642.0,5,1079,2.0,811.0,811.0
40.058,17,10,676,5,460,10013.0,104.0,64.0,5,216,10013.0,20.0,15.0
0.007,6,10,1990,5,911,1.0,643.0,643.0,5,1079,1.0,811.0,811.0
0.004,6,10,1702,5,863,0.0,595.0,595.0,5,839,1.0,571.0,571.0
0.081,6,10,1506,5,395,18.0,127.0,127.0,5,1111,18.0,843.0,843.0
40.062,17,10,676,5,460,10014.0,104.0,64.0,5,216,10014.0,20.0,15.0
0.035,17,2,152,1,76,0.0,48.0,48.0,1,76,0.0,48.0,48.0
0.081,6,10,1506,5,395,18.0,127.0,127.0,5,1111,17.0,843.0,843.0
0.098,6,10,1506,5,395,20.0,127.0,127.0,5,1111,20.0,843.0,843.0
0.005,6,10,1547,5,764,1.0,496.0,496.0,5,783,1.0,515.0,515.0
0.071,17,4,284,2,120,0.0,32.0,32.0,2,164,68.0,60.0,54.0
0.042,17,2,148,1,60,0.0,32.0,32.0,1,88,0.0,60.0,60.0
0.009,17,2,179,1,71,0.0,43.0,43.0,1,108,0.0,80.0,80.0
0.041,17,2,148,1,60,0.0,32.0,32.0,1,88,0.0,60.0,60.0
0.005,6,14,3742,7,452,0.0,80.0,80.0,7,3290,0.0,1448.0,972.0
0.041,17,2,152,1,76,0.0,48.0,48.0,1,76,0.0,48.0,48.0
0.082,6,10,1506,5,395,18.0,127.0,127.0,5,1111,19.0,843.0,843.0
0.012,6,10,1990,5,911,2.0,643.0,643.0,5,1079,3.0,811.0,811.0
125.997,6,15,2978,8,2504,17966.0,1414.0,1086.0,7,474,20961.0,182.0,182.0
0.015,6,10,1990,5,911,3.0,643.0,643.0,5,1079,3.0,811.0,811.0
0.014,6,10,1990,5,911,3.0,643.0,643.0,5,1079,3.0,811.0,811.0
0.004,17,2,136,1,60,0.0,32.0,32.0,1,76,0.0,48.0,48.0
162.349,17,84,12394,42,2833,3959.0,44.0,39.0,42,9561,3959.0,261.0,199.0
0.006,6,10,1689,5,839,1.0,571.0,571.0,5,850,1.0,582.0,582.0
0.005,6,10,1989,5,927,1.0,659.0,659.0,5,1062,1.0,794.0,794.0
0.169,17,2,152,1,76,0.0,48.0,48.0,1,76,0.0,48.0,48.0
0.004,6,10,1774,5,923,1.0,655.0,655.0,5,851,1.0,583.0,583.0
0.001,17,2,136,1,60,0.0,32.0,32.0,1,76,0.0,48.0,48.0
0.005,6,10,1989,5,927,1.0,659.0,659.0,5,1062,1.0,794.0,794.0
0.006,6,10,2006,5,927,1.0,659.0,659.0,5,1079,1.0,811.0,811.0
309.053,17,20,1124,10,716,34325.0,48.0,43.0,10,408,34325.0,20.0,12.0
0.006,6,10,1547,5,764,1.0,496.0,496.0,5,783,1.0,515.0,515.0
1735.208,6,64,7361,42,4485,42322.0,1641.0,109.0,22,2876,82620.0,1112.0,82.0
0.005,17,2,179,1,71,0.0,43.0,43.0,1,108,0.0,80.0,80.0
0.012,6,10,1989,5,910,3.0,642.0,642.0,5,1079,2.0,811.0,811.0
0.087,6,10,1506,5,395,20.0,127.0,127.0,5,1111,17.0,843.0,843.0
0.005,17,2,136,1,60,0.0,32.0,32.0,1,76,0.0,48.0,48.0
40.092,17,10,676,5,460,10018.0,104.0,64.0,5,216,10022.0,20.0,15.0
0.776,6,10,1905,6,1551,155.0,1299.0,1299.0,4,354,178.0,182.0,182.0
0.006,6,10,2007,5,928,1.0,660.0,660.0,5,1079,1.0,811.0,811.0
0.016,6,10,1983,5,910,4.0,642.0,642.0,5,1073,4.0,805.0,805.0
0.09,6,10,1506,5,395,20.0,127.0,127.0,5,1111,19.0,843.0,843.0
0.005,6,10,2007,5,928,1.0,660.0,660.0,5,1079,1.0,811.0,811.0
0.005,6,10,2006,5,927,1.0,659.0,659.0,5,1079,1.0,811.0,811.0
0.004,6,10,1989,5,927,1.0,659.0,659.0,5,1062,1.0,794.0,794.0
0.014,6,10,1990,5,911,3.0,643.0,643.0,5,1079,3.0,811.0,811.0
900.964,6,75,25770,40,8214,23101.0,676.0,510.0,35,17556,24732.0,1402.0,655.0
0.135,6,10,1506,5,395,31.0,127.0,127.0,5,1111,24.0,843.0,843.0
40.073,17,10,676,5,460,10017.0,104.0,64.0,5,216,10017.0,20.0,15.0
0.093,6,10,1506,5,395,21.0,127.0,127.0,5,1111,20.0,843.0,843.0
0.07,6,10,1506,5,395,15.0,127.0,127.0,5,1111,16.0,843.0,843.0
0.001,17,2,132,1,58,0.0,30.0,30.0,1,74,0.0,46.0,46.0
0.013,6,10,1983,5,910,3.0,642.0,642.0,5,1073,3.0,805.0,805.0
0.01,6,12,1926,6,1189,2.0,659.0,434.0,6,737,1.0,417.0,417.0
0.012,6,10,1990,5,911,3.0,643.0,643.0,5,1079,3.0,811.0,811.0
0.073,6,10,1506,5,395,16.0,127.0,127.0,5,1111,13.0,843.0,843.0
293.889,6,327,344213,118,17682,2511.0,2688.0,888.0,209,326531,1412.0,2804.0,1627.0
0.005,17,2,144,1,64,0.0,36.0,36.0,1,80,0.0,52.0,52.0
0.006,6,10,1547,5,764,1.0,496.0,496.0,5,783,1.0,515.0,515.0
0.09,6,10,1506,5,395,20.0,127.0,127.0,5,1111,18.0,843.0,843.0
15.075,17,15,9238,8,6902,2149.0,1350.0,834.0,7,2336,2507.0,1350.0,305.0
40.058,17,10,676,5,460,10013.0,104.0,64.0,5,216,10013.0,20.0,15.0
0.0,17,2,136,1,60,0.0,32.0,32.0,1,76,0.0,48.0,48.0
0.005,6,10,1547,5,764,1.0,496.0,496.0,5,783,1.0,515.0,515.0
240.544,6,33,9158,16,1787,16034.0,572.0,189.0,17,7371,15031.0,1402.0,590.0
301.547,6,189,129918,107,20435,2844.0,2736.0,1236.0,82,109483,3722.0,2937.0,1594.0
0.004,17,2,186,1,61,0.0,33.0,33.0,1,125,0.0,97.0,97.0
0.005,6,10,1989,5,927,1.0,659.0,659.0,5,1062,1.0,794.0,794.0
11.173,17,28,4423,14,1995,847.0,270.0,114.0,14,2428,847.0,587.0,145.0
0.011,6,10,1972,5,910,2.0,642.0,642.0,5,1062,2.0,794.0,794.0
0.017,6,10,1989,5,910,4.0,642.0,642.0,5,1079,4.0,811.0,811.0
240.123,6,31,9138,15,6693,17151.0,1817.0,657.0,16,2445,16008.0,580.0,200.0
0.009,6,10,1983,5,910,2.0,642.0,642.0,5,1073,2.0,805.0,805.0
0.072,17,4,336,2,124,0.0,34.0,34.0,2,212,32.0,84.0,78.0
40.061,17,10,676,5,460,10014.0,104.0,64.0,5,216,10014.0,20.0,15.0
0.025,6,10,1677,5,827,6.0,559.0,559.0,5,850,6.0,582.0,582.0
0.005,6,10,1989,5,927,1.0,659.0,659.0,5,1062,1.0,794.0,794.0
40.052,17,10,676,5,460,10012.0,104.0,64.0,5,216,10012.0,20.0,15.0
1755.981,6,105,6270,60,3525,29761.0,27.0,27.0,45,2745,39907.0,27.0,27.0
0.005,6,10,1547,5,764,1.0,496.0,496.0,5,783,1.0,515.0,515.0
240.018,6,9,787,5,488,60004.0,232.0,232.0,4,299,80005.0,83.0,83.0
308.553,17,20,1124,10,716,34268.0,48.0,43.0,10,408,34269.0,20.0,12.0
0.004,6,10,1779,5,928,1.0,660.0,660.0,5,851,1.0,583.0,583.0
177.529,17,88,12801,44,2968,4128.0,44.0,39.0,44,9833,4128.0,261.0,195.0
0.006,6,10,1689,5,839,1.0,571.0,571.0,5,850,1.0,582.0,582.0
0.005,6,14,3742,8,504,0.0,80.0,80.0,6,3238,0.0,1470.0,1459.0
0.252,17,39,20147,21,17036,12.0,1350.0,783.0,18,3111,11.0,1350.0,144.0
0.004,6,10,1702,5,863,1.0,595.0,595.0,5,839,1.0,571.0,571.0
0.041,17,4,336,2,124,0.0,34.0,34.0,2,212,0.0,84.0,78.0
0.065,6,10,1506,5,395,13.0,127.0,127.0,5,1111,13.0,843.0,843.0
10.832,17,28,4421,14,1993,824.0,268.0,114.0,14,2428,824.0,587.0,145.0
0.003,17,2,136,1,60,0.0,32.0,32.0,1,76,0.0,48.0,48.0
0.004,6,10,2006,5,927,1.0,659.0,659.0,5,1079,1.0,811.0,811.0
0.005,6,10,2000,5,927,1.0,659.0,659.0,5,1073,1.0,805.0,805.0
0.001,17,2,180,1,66,0.0,38.0,38.0,1,114,0.0,86.0,86.0
0.003,17,4,284,2,120,0.0,32.0,32.0,2,164,0.0,60.0,54.0
0.021,6,10,1989,5,910,5.0,642.0,642.0,5,1079,5.0,811.0,811.0
0.005,6,10,2006,5,927,1.0,659.0,659.0,5,1079,1.0,811.0,811.0
0.006,6,10,1689,5,839,1.0,571.0,571.0,5,850,1.0,582.0,582.0
0.01,6,10,1983,5,910,2.0,642.0,642.0,5,1073,2.0,805.0,805.0
9.038,17,6,376,5,280,2259.0,28.0,28.0,1,96,0.0,68.0,68.0
178.186,17,88,12672,44,2961,4143.0,44.0,39.0,44,9711,4143.0,239.0,192.0
0.047,17,4,352,2,130,0.0,37.0,37.0,2,222,0.0,89.0,83.0
0.005,6,10,1854,5,889,1.0,621.0,621.0,5,965,1.0,697.0,697.0
0.005,6,10,2006,5,927,1.0,659.0,659.0,5,1079,1.0,811.0,811.0
0.018,6,10,1972,5,910,4.0,642.0,642.0,5,1062,4.0,794.0,794.0
0.006,6,10,1547,5,764,1.0,496.0,496.0,5,783,1.0,515.0,515.0
0.04,17,2,148,1,60,0.0,32.0,32.0,1,88,0.0,60.0,60.0
310.749,17,20,1124,10,716,34521.0,48.0,43.0,10,408,34521.0,20.0,12.0
0.004,6,10,1774,5,923,1.0,655.0,655.0,5,851,1.0,583.0,583.0
0.014,6,10,1677,5,827,3.0,559.0,559.0,5,850,3.0,582.0,582.0
0.001,17,2,166,1,75,0.0,47.0,47.0,1,91,0.0,63.0,63.0
0.005,6,10,2006,5,927,1.0,659.0,659.0,5,1079,1.0,811.0,811.0
0.023,6,10,1972,5,910,5.0,642.0,642.0,5,1062,5.0,794.0,794.0
0.083,6,10,1506,5,395,19.0,127.0,127.0,5,1111,17.0,843.0,843.0
0.116,6,10,1506,5,395,26.0,127.0,127.0,5,1111,25.0,843.0,843.0
171.494,17,80,11072,40,2665,4397.0,44.0,38.0,40,8407,4397.0,239.0,182.0
0.003,17,2,185,1,73,0.0,45.0,45.0,1,112,0.0,84.0,84.0
0.083,6,10,1506,5,395,19.0,127.0,127.0,5,1111,17.0,843.0,843.0
0.084,6,10,1506,5,395,16.0,127.0,127.0,5,1111,18.0,843.0,843.0
0.075,6,10,1506,5,395,17.0,127.0,127.0,5,1111,14.0,843.0,843.0
0.005,6,10,1989,5,927,1.0,659.0,659.0,5,1062,1.0,794.0,794.0
0.006,6,10,1643,5,860,1.0,592.0,592.0,5,783,1.0,515.0,515.0
0.011,6,13,3735,7,497,1.0,125.0,125.0,6,3238,2.0,1470.0,1459.0
0.016,6,10,1983,5,910,3.0,642.0,642.0,5,1073,3.0,805.0,805.0
0.008,6,10,1677,5,827,2.0,559.0,559.0,5,850,1.0,582.0,582.0
0.004,17,2,136,1,60,0.0,32.0,32.0,1,76,0.0,48.0,48.0
0.004,6,10,1989,5,927,1.0,659.0,659.0,5,1062,1.0,794.0,794.0
0.006,17,2,170,1,65,0.0,37.0,37.0,1,105,0.0,77.0,77.0
0.04,17,4,420,2,122,0.0,33.0,33.0,2,298,36.0,145.0,121.0
0.004,17,2,170,1,65,0.0,37.0,37.0,1,105,0.0,77.0,77.0
0.005,6,10,2006,5,927,1.0,659.0,659.0,5,1079,1.0,811.0,811.0
308.502,17,20,1124,10,716,34264.0,48.0,43.0,10,408,34264.0,20.0,12.0
0.004,6,10,1989,5,927,1.0,659.0,659.0,5,1062,1.0,794.0,794.0
0.001,17,2,179,1,62,0.0,34.0,34.0,1,117,0.0,89.0,89.0
0.007,6,10,1689,5,839,1.0,571.0,571.0,5,850,1.0,582.0,582.0
0.004,6,10,1702,5,863,1.0,595.0,595.0,5,839,1.0,571.0,571.0
0.012,6,10,1990,5,911,2.0,643.0,643.0,5,1079,3.0,811.0,811.0
0.052,17,2,152,1,76,0.0,48.0,48.0,1,76,0.0,48.0,48.0
0.03,6,10,1989,5,910,7.0,642.0,642.0,5,1079,7.0,811.0,811.0
0.083,6,10,1506,5,395,17.0,127.0,127.0,5,1111,15.0,843.0,843.0
10.906,17,28,4422,14,1994,830.0,269.0,114.0,14,2428,830.0,587.0,145.0
0.005,6,13,3690,7,452,0.0,80.0,80.0,6,3238,1.0,1470.0,1459.0
0.019,6,10,1989,5,910,4.0,642.0,642.0,5,1079,4.0,811.0,811.0
0.006,6,10,1689,5,839,1.0,571.0,571.0,5,850,1.0,582.0,582.0
0.004,17,2,136,1,60,0.0,32.0,32.0,1,76,0.0,48.0,48.0
0.09,6,10,1506,5,395,21.0,127.0,127.0,5,1111,19.0,843.0,843.0
0.013,6,10,1989,5,910,3.0,642.0,642.0,5,1079,3.0,811.0,811.0
285.731,6,28,6469,15,1381,20409.0,517.0,290.0,13,5088,23810.0,2378.0,1104.0
168.393,17,86,12341,43,2870,4009.0,44.0,38.0,43,9471,4009.0,239.0,192.0
1741.884,6,307,98576,188,87125,9314.0,2001.0,678.0,119,11451,14761.0,452.0,70.0
294.59,6,36,14871,19,2814,16364.0,676.0,363.0,17,12057,18409.0,1402.0,1016.0
0.006,6,10,1547,5,764,1.0,496.0,496.0,5,783,1.0,515.0,515.0
0.005,6,10,1989,5,927,1.0,659.0,659.0,5,1062,1.0,794.0,794.0
176.3,17,74,10653,37,2466,4897.0,44.0,38.0,37,8187,4897.0,239.0,193.0
176.059,17,76,10774,38,2528,4758.0,44.0,38.0,38,8246,4758.0,279.0,189.0
0.001,17,2,180,1,65,0.0,37.0,37.0,1,115,0.0,87.0,87.0
0.007,6,10,1547,5,764,1.0,496.0,496.0,5,783,1.0,515.0,515.0
0.016,6,10,1631,5,848,4.0,580.0,580.0,5,783,4.0,515.0,515.0
0.138,6,10,1506,5,395,31.0,127.0,127.0,5,1111,33.0,843.0,843.0
0.005,6,10,1854,5,889,1.0,621.0,621.0,5,965,1.0,697.0,697.0
0.096,6,10,1506,5,395,22.0,127.0,127.0,5,1111,16.0,843.0,843.0
0.07,17,8,3613,4,1874,23.0,1350.0,440.0,4,1739,12.0,1350.0,406.0
0.004,17,2,148,1,60,0.0,32.0,32.0,1,88,0.0,60.0,60.0
0.04,6,10,1989,5,910,9.0,642.0,642.0,5,1079,10.0,811.0,811.0
0.004,6,10,2006,5,927,1.0,659.0,659.0,5,1079,1.0,811.0,811.0
0.004,17,2,148,1,60,0.0,32.0,32.0,1,88,0.0,60.0,60.0
0.005,6,10,1854,5,889,1.0,621.0,621.0,5,965,1.0,697.0,697.0
0.004,6,10,2006,5,927,1.0,659.0,659.0,5,1079,1.0,811.0,811.0
0.015,6,10,1972,5,910,3.0,642.0,642.0,5,1062,3.0,794.0,794.0
0.119,6,10,1506,5,395,26.0,127.0,127.0,5,1111,26.0,843.0,843.0
0.005,6,10,1689,5,839,1.0,571.0,571.0,5,850,1.0,582.0,582.0
0.04,17,2,148,1,60,0.0,32.0,32.0,1,88,0.0,60.0,60.0
0.001,17,2,180,1,66,0.0,38.0,38.0,1,114,0.0,86.0,86.0
0.005,6,10,2006,5,927,1.0,659.0,659.0,5,1079,1.0,811.0,811.0
0.009,6,10,1989,5,910,2.0,642.0,642.0,5,1079,2.0,811.0,811.0
0.005,6,10,1774,5,923,1.0,655.0,655.0,5,851,1.0,583.0,583.0
0.005,6,14,3799,7,509,0.0,137.0,137.0,7,3290,0.0,1448.0,972.0
0.004,17,2,148,1,60,0.0,32.0,32.0,1,88,0.0,60.0,60.0
0.105,6,10,1506,5,395,11.0,127.0,127.0,5,1111,25.0,843.0,843.0
0.024,6,13,3735,7,497,4.0,125.0,125.0,6,3238,4.0,1470.0,1459.0
0.016,6,10,1989,5,910,4.0,642.0,642.0,5,1079,4.0,811.0,811.0
246.801,6,21,4753,8,923,18.0,238.0,166.0,13,3830,20566.0,1402.0,786.0
1769.015,17,92,8096,46,4048,39311.0,60.0,60.0,46,4048,39311.0,60.0,60.0
0.109,6,10,1506,5,395,25.0,127.0,127.0,5,1111,26.0,843.0,843.0
0.006,6,10,1547,5,764,1.0,496.0,496.0,5,783,1.0,515.0,515.0
40.055,17,10,676,5,460,10012.0,104.0,64.0,5,216,10013.0,20.0,15.0
0.085,6,10,1506,5,395,18.0,127.0,127.0,5,1111,16.0,843.0,843.0
0.001,17,2,180,1,66,0.0,38.0,38.0,1,114,0.0,86.0,86.0
240.094,6,31,9001,15,6531,17149.0,1655.0,639.0,16,2470,16006.0,580.0,203.0
0.005,6,14,3736,7,446,0.0,74.0,74.0,7,3290,0.0,1448.0,972.0
0.066,6,10,1506,5,395,14.0,127.0,127.0,5,1111,15.0,843.0,843.0
0.005,17,2,140,1,62,0.0,34.0,34.0,1,78,0.0,50.0,50.0
0.014,6,10,1972,5,910,3.0,642.0,642.0,5,1062,3.0,794.0,794.0
0.006,6,10,1547,5,764,1.0,496.0,496.0,5,783,1.0,515.0,515.0
0.001,17,2,136,1,60,0.0,32.0,32.0,1,76,0.0,48.0,48.0
0.012,6,10,1989,5,910,3.0,642.0,642.0,5,1079,2.0,811.0,811.0
0.005,17,2,170,1,65,0.0,37.0,37.0,1,105,0.0,77.0,77.0
15.125,17,19,13436,9,8280,1887.0,1350.0,892.0,10,5156,1677.0,1350.0,487.0
0.009,6,12,1926,6,1189,1.0,659.0,434.0,6,737,1.0,417.0,417.0
0.004,6,10,2007,5,928,1.0,660.0,660.0,5,1079,1.0,811.0,811.0
1772.146,6,271,39875,105,27271,17038.0,2720.0,265.0,166,12604,10739.0,1062.0,78.0
0.314,17,45,24527,24,21170,13.0,1350.0,854.0,21,3357,12.0,1350.0,131.0
0.1,6,10,1506,5,395,22.0,127.0,127.0,5,1111,20.0,843.0,843.0
0.042,17,2,170,1,65,0.0,37.0,37.0,1,105,0.0,77.0,77.0
0.098,6,10,1506,5,395,22.0,127.0,127.0,5,1111,17.0,843.0,843.0
0.005,6,10,2007,5,928,1.0,660.0,660.0,5,1079,1.0,811.0,811.0
0.005,6,14,3742,7,452,0.0,80.0,80.0,7,3290,0.0,1448.0,972.0
0.039,17,2,136,1,60,0.0,32.0,32.0,1,76,0.0,48.0,48.0
0.02,6,10,1990,5,911,5.0,643.0,643.0,5,1079,4.0,811.0,811.0
0.005,6,10,2006,5,927,1.0,659.0,659.0,5,1079,1.0,811.0,811.0
0.001,17,2,180,1,66,0.0,38.0,38.0,1,114,0.0,86.0,86.0
40.061,17,10,676,5,460,10014.0,104.0,64.0,5,216,10010.0,20.0,15.0
0.009,6,10,1989,5,910,2.0,642.0,642.0,5,1079,2.0,811.0,811.0
240.014,6,9,787,5,488,60003.0,232.0,232.0,4,299,80003.0,83.0,83.0
300.311,6,16,2170,9,684,37518.0,146.0,146.0,7,1486,50024.0,419.0,398.0
0.142,6,10,1506,5,395,22.0,127.0,127.0,5,1111,31.0,843.0,843.0
0.004,6,10,1989,5,927,1.0,659.0,659.0,5,1062,1.0,794.0,794.0
0.001,17,2,180,1,66,0.0,38.0,38.0,1,114,0.0,86.0,86.0
40.073,17,10,676,5,460,10016.0,104.0,64.0,5,216,10017.0,20.0,15.0
300.395,6,16,2170,9,684,37529.0,146.0,146.0,7,1486,50038.0,419.0,398.0
0.014,6,10,1990,5,911,3.0,643.0,643.0,5,1079,3.0,811.0,811.0
0.001,17,2,166,1,75,0.0,47.0,47.0,1,91,0.0,63.0,63.0
1774.229,6,64,7350,42,4470,43273.0,1626.0,108.0,22,2880,84479.0,1116.0,82.0
40.065,17,10,676,5,460,10012.0,104.0,64.0,5,216,10015.0,20.0,15.0
0.063,6,10,1506,5,395,14.0,127.0,127.0,5,1111,14.0,843.0,843.0
0.005,6,13,3747,7,509,0.0,137.0,137.0,6,3238,0.0,1470.0,1459.0
0.005,17,2,144,1,64,0.0,36.0,36.0,1,80,0.0,52.0,52.0
0.005,6,10,1854,5,889,1.0,621.0,621.0,5,965,1.0,697.0,697.0
0.009,6,10,1762,5,911,2.0,643.0,643.0,5,851,2.0,583.0,583.0
380.149,6,22,2313,16,867,25343.0,195.0,195.0,6,1446,4639.0,419.0,398.0
0.004,6,10,2006,5,927,1.0,659.0,659.0,5,1079,1.0,811.0,811.0
0.145,6,10,1506,5,395,35.0,127.0,127.0,5,1111,34.0,843.0,843.0
0.005,17,2,164,1,74,0.0,46.0,46.0,1,90,0.0,62.0,62.0
0.073,6,10,1506,5,395,16.0,127.0,127.0,5,1111,17.0,843.0,843.0
0.083,6,10,1506,5,395,19.0,127.0,127.0,5,1111,17.0,843.0,843.0
352.244,6,20,2210,6,1308,12003.0,494.0,494.0,14,902,27095.0,83.0,83.0
0.04,17,4,352,2,130,0.0,37.0,37.0,2,222,37.0,89.0,83.0
0.006,6,13,3690,7,452,1.0,80.0,80.0,6,3238,1.0,1470.0,1459.0
0.005,6,14,3799,7,509,0.0,137.0,137.0,7,3290,0.0,1448.0,972.0
0.004,17,4,284,2,120,0.0,32.0,32.0,2,164,0.0,60.0,54.0
0.009,6,10,1990,5,911,2.0,643.0,643.0,5,1079,2.0,811.0,811.0
292.228,6,402,347932,200,21963,1468.0,2736.0,888.0,202,325969,1453.0,2804.0,1677.0
0.133,6,10,1506,5,395,30.0,127.0,127.0,5,1111,30.0,843.0,843.0
0.029,17,2,136,1,60,0.0,32.0,32.0,1,76,0.0,48.0,48.0
0.004,6,10,1702,5,863,1.0,595.0,595.0,5,839,1.0,571.0,571.0
0.005,6,10,2006,5,927,1.0,659.0,659.0,5,1079,1.0,811.0,811.0
0.005,6,10,2007,5,928,1.0,660.0,660.0,5,1079,1.0,811.0,811.0
0.071,6,10,1506,5,395,16.0,127.0,127.0,5,1111,15.0,843.0,843.0
0.005,6,10,1779,5,928,1.0,660.0,660.0,5,851,1.0,583.0,583.0
0.011,6,10,1972,5,910,2.0,642.0,642.0,5,1062,2.0,794.0,794.0
0.14,6,10,1506,5,395,32.0,127.0,127.0,5,1111,34.0,843.0,843.0
0.038,17,2,148,1,60,0.0,32.0,32.0,1,88,0.0,60.0,60.0
0.005,17,2,136,1,60,0.0,32.0,32.0,1,76,0.0,48.0,48.0
313.521,17,20,1124,10,716,34820.0,48.0,43.0,10,408,34822.0,20.0,12.0
0.012,6,10,1989,5,910,3.0,642.0,642.0,5,1079,2.0,811.0,811.0
0.016,6,10,1990,5,911,4.0,643.0,643.0,5,1079,4.0,811.0,811.0
0.004,6,10,1989,5,927,1.0,659.0,659.0,5,1062,1.0,794.0,794.0
0.009,6,12,1926,6,1189,1.0,659.0,434.0,6,737,1.0,417.0,417.0
0.01,6,10,1972,5,910,2.0,642.0,642.0,5,1062,2.0,794.0,794.0
15.073,17,15,9238,8,6902,2149.0,1350.0,834.0,7,2336,2507.0,1350.0,305.0
10.956,17,28,4419,14,1994,834.0,269.0,114.0,14,2425,834.0,588.0,145.0
40.049,17,10,676,5,460,10011.0,104.0,64.0,5,216,10011.0,20.0,15.0
0.014,6,10,1990,5,911,3.0,643.0,643.0,5,1079,3.0,811.0,811.0
0.009,6,10,1989,5,910,2.0,642.0,642.0,5,1079,2.0,811.0,811.0
499.614,6,29,8148,16,3168,33307.0,676.0,388.0,13,4980,36633.0,1402.0,716.0
0.005,17,2,214,1,75,0.0,47.0,47.0,1,139,0.0,111.0,111.0
0.006,6,10,1689,5,839,1.0,571.0,571.0,5,850,1.0,582.0,582.0
40.066,17,10,676,5,460,10014.0,104.0,64.0,5,216,10015.0,20.0,15.0
0.012,6,10,1989,5,910,3.0,642.0,642.0,5,1079,3.0,811.0,811.0
0.005,6,10,1854,5,889,1.0,621.0,621.0,5,965,1.0,697.0,697.0
0.006,6,10,1689,5,839,1.0,571.0,571.0,5,850,1.0,582.0,582.0
0.005,6,10,2006,5,927,1.0,659.0,659.0,5,1079,1.0,811.0,811.0
0.102,6,10,1506,5,395,21.0,127.0,127.0,5,1111,23.0,843.0,843.0
0.001,17,2,180,1,66,0.0,38.0,38.0,1,114,0.0,86.0,86.0
0.006,6,10,1547,5,764,1.0,496.0,496.0,5,783,1.0,515.0,515.0
0.005,17,2,140,1,62,0.0,34.0,34.0,1,78,0.0,50.0,50.0
40.06,17,10,676,5,460,10012.0,104.0,64.0,5,216,10014.0,20.0,15.0
0.013,6,10,1972,5,910,3.0,642.0,642.0,5,1062,3.0,794.0,794.0
176.504,17,72,10188,36,2394,5042.0,44.0,38.0,36,7794,5042.0,239.0,188.0
0.109,6,10,1506,5,395,26.0,127.0,127.0,5,1111,23.0,843.0,843.0
0.063,17,2,152,1,76,0.0,48.0,48.0,1,76,0.0,48.0,48.0
0.099,6,10,1506,5,395,22.0,127.0,127.0,5,1111,20.0,843.0,843.0
0.005,6,10,2006,5,927,1.0,659.0,659.0,5,1079,1.0,811.0,811.0
0.017,6,10,1972,5,910,4.0,642.0,642.0,5,1062,4.0,794.0,794.0
0.003,17,2,136,1,60,0.0,32.0,32.0,1,76,0.0,48.0,48.0
0.02,6,10,1677,5,827,4.0,559.0,559.0,5,850,5.0,582.0,582.0
40.077,17,10,676,5,460,10016.0,104.0,64.0,5,216,10018.0,20.0,15.0
0.004,6,10,1989,5,927,1.0,659.0,659.0,5,1062,1.0,794.0,794.0
0.006,6,10,1854,5,889,1.0,621.0,621.0,5,965,1.0,697.0,697.0
0.012,6,10,1983,5,910,3.0,642.0,642.0,5,1073,2.0,805.0,805.0
0.019,6,13,3735,7,497,3.0,125.0,125.0,6,3238,3.0,1470.0,1459.0
0.004,6,10,1779,5,928,1.0,660.0,660.0,5,851,1.0,583.0,583.0
0.081,6,10,1506,5,395,15.0,127.0,127.0,5,1111,17.0,843.0,843.0
0.006,17,2,166,1,75,0.0,47.0,47.0,1,91,0.0,63.0,63.0
0.0,17,2,180,1,66,0.0,38.0,38.0,1,114,0.0,86.0,86.0
0.014,6,10,1989,5,910,3.0,642.0,642.0,5,1079,3.0,811.0,811.0
0.082,6,10,1506,5,395,19.0,127.0,127.0,5,1111,19.0,843.0,843.0
0.017,6,10,1972,5,910,4.0,642.0,642.0,5,1062,4.0,794.0,794.0
0.005,6,10,1854,5,889,1.0,621.0,621.0,5,965,1.0,697.0,697.0
0.003,17,4,284,2,120,0.0,32.0,32.0,2,164,0.0,60.0,54.0
0.006,17,2,180,1,66,0.0,38.0,38.0,1,114,0.0,86.0,86.0
0.132,17,2,80,1,32,0.0,4.0,4.0,1,48,0.0,20.0,20.0
0.126,6,10,1506,5,395,29.0,127.0,127.0,5,1111,27.0,843.0,843.0
0.047,17,2,170,1,65,0.0,37.0,37.0,1,105,0.0,77.0,77.0
0.202,6,16,2670,8,1396,28.0,533.0,324.0,8,1274,18.0,529.0,212.0
0.089,6,10,1506,5,395,18.0,127.0,127.0,5,1111,20.0,843.0,843.0
0.087,6,10,1506,5,395,19.0,127.0,127.0,5,1111,17.0,843.0,843.0
0.082,6,10,1506,5,395,18.0,127.0,127.0,5,1111,19.0,843.0,843.0
0.005,6,10,2006,5,927,1.0,659.0,659.0,5,1079,1.0,811.0,811.0
40.063,17,10,676,5,460,10013.0,104.0,64.0,5,216,10014.0,20.0,15.0
0.006,6,10,1854,5,889,1.0,621.0,621.0,5,965,1.0,697.0,697.0
0.006,6,10,1547,5,764,1.0,496.0,496.0,5,783,1.0,515.0,515.0
15.085,17,19,9063,9,6445,1882.0,1350.0,688.0,10,2618,1672.0,1350.0,233.0
0.004,6,10,1774,5,923,1.0,655.0,655.0,5,851,0.0,583.0,583.0
0.01,6,10,1990,5,911,2.0,643.0,643.0,5,1079,2.0,811.0,811.0
0.005,6,10,2006,5,927,1.0,659.0,659.0,5,1079,1.0,811.0,811.0
0.142,6,10,1506,5,395,29.0,127.0,127.0,5,1111,32.0,843.0,843.0
0.036,6,10,1983,5,910,9.0,642.0,642.0,5,1073,9.0,805.0,805.0
0.006,6,10,1989,5,927,1.0,659.0,659.0,5,1062,1.0,794.0,794.0
1792.214,6,571,192260,290,164251,6201.0,2883.0,956.0,281,28009,6400.0,385.0,125.0
0.193,17,2,144,1,64,0.0,36.0,36.0,1,80,0.0,52.0,52.0
0.168,17,4,596,2,122,44.0,33.0,33.0,2,474,129.0,323.0,209.0
0.005,6,10,1989,5,927,1.0,659.0,659.0,5,1062,1.0,794.0,794.0
0.006,6,10,2000,5,927,1.0,659.0,659.0,5,1073,1.0,805.0,805.0
0.012,6,10,1677,5,827,3.0,559.0,559.0,5,850,3.0,582.0,582.0
0.004,6,10,1774,5,923,1.0,655.0,655.0,5,851,1.0,583.0,583.0
0.001,17,2,180,1,66,0.0,38.0,38.0,1,114,0.0,86.0,86.0
0.135,6,25,10144,14,8890,10.0,2883.0,1166.0,11,1254,13.0,268.0,113.0
0.005,6,10,1702,5,863,1.0,595.0,595.0,5,839,1.0,571.0,571.0
0.007,17,2,179,1,71,0.0,43.0,43.0,1,108,0.0,80.0,80.0
0.012,6,10,1989,5,910,3.0,642.0,642.0,5,1079,3.0,811.0,811.0
176.304,17,88,12646,44,2929,4099.0,44.0,38.0,44,9717,4100.0,239.0,192.0
360.032,6,21,3981,13,3142,30002.0,494.0,494.0,8,839,51432.0,83.0,83.0
0.009,6,14,3799,7,509,1.0,137.0,137.0,7,3290,1.0,1448.0,972.0
0.013,6,10,1631,5,848,3.0,580.0,580.0,5,783,3.0,515.0,515.0
240.29,6,36,10524,18,2215,14133.0,559.0,254.0,18,8309,14134.0,1402.0,614.0
240.084,6,16,4482,9,963,30010.0,238.0,166.0,7,3519,40013.0,1402.0,786.0
0.005,6,10,2006,5,927,1.0,659.0,659.0,5,1079,1.0,811.0,811.0
0.005,6,14,3799,7,509,0.0,137.0,137.0,7,3290,0.0,1448.0,972.0
0.022,6,10,1990,5,911,5.0,643.0,643.0,5,1079,5.0,811.0,811.0
0.004,17,4,284,2,120,0.0,32.0,32.0,2,164,1.0,60.0,54.0
0.004,6,10,2006,5,927,1.0,659.0,659.0,5,1079,1.0,811.0,811.0
0.001,17,2,166,1,75,0.0,47.0,47.0,1,91,0.0,63.0,63.0
0.004,6,10,1989,5,927,1.0,659.0,659.0,5,1062,1.0,794.0,794.0
0.02,6,10,1631,5,848,5.0,580.0,580.0,5,783,4.0,515.0,515.0
0.006,6,10,1547,5,764,1.0,496.0,496.0,5,783,1.0,515.0,515.0
0.096,6,10,1506,5,395,21.0,127.0,127.0,5,1111,23.0,843.0,843.0
719.414,6,53,21047,28,4528,26644.0,676.0,437.0,25,16519,27473.0,1402.0,894.0
0.039,17,2,186,1,61,0.0,33.0,33.0,1,125,0.0,97.0,97.0
0.006,6,10,1547,5,764,1.0,496.0,496.0,5,783,1.0,515.0,515.0
0.007,17,2,179,1,71,0.0,43.0,43.0,1,108,0.0,80.0,80.0
0.004,6,10,1702,5,863,1.0,595.0,595.0,5,839,0.0,571.0,571.0
0.008,6,13,3735,7,497,1.0,125.0,125.0,6,3238,1.0,1470.0,1459.0
0.005,6,10,1989,5,927,1.0,659.0,659.0,5,1062,1.0,794.0,794.0
0.017,6,10,1762,5,911,4.0,643.0,643.0,5,851,4.0,583.0,583.0
0.006,6,10,1547,5,764,1.0,496.0,496.0,5,783,1.0,515.0,515.0
0.014,6,10,1677,5,827,3.0,559.0,559.0,5,850,3.0,582.0,582.0
0.012,6,10,1990,5,911,3.0,643.0,643.0,5,1079,3.0,811.0,811.0
0.001,17,2,136,1,60,0.0,32.0,32.0,1,76,0.0,48.0,48.0
0.001,17,2,180,1,66,0.0,38.0,38.0,1,114,0.0,86.0,86.0
0.008,6,10,1989,5,910,2.0,642.0,642.0,5,1079,1.0,811.0,811.0
11.148,17,28,4420,14,1993,845.0,268.0,114.0,14,2427,845.0,586.0,145.0
0.004,17,2,234,1,61,0.0,33.0,33.0,1,173,0.0,145.0,145.0
0.012,6,10,1972,5,910,2.0,642.0,642.0,5,1062,2.0,794.0,794.0
353.456,6,20,2210,6,1308,12003.0,494.0,494.0,14,902,27188.0,83.0,83.0
320.601,17,20,1124,10,716,35608.0,48.0,43.0,10,408,35608.0,20.0,12.0
0.006,6,10,1643,5,860,1.0,592.0,592.0,5,783,1.0,515.0,515.0
0.005,6,10,2006,5,927,1.0,659.0,659.0,5,1079,1.0,811.0,811.0
0.0,17,2,136,1,60,0.0,32.0,32.0,1,76,0.0,48.0,48.0
312.105,17,20,1124,10,716,34663.0,48.0,43.0,10,408,34664.0,20.0,12.0
0.015,6,10,1989,5,910,3.0,642.0,642.0,5,1079,3.0,811.0,811.0
0.013,6,10,1989,5,910,3.0,642.0,642.0,5,1079,3.0,811.0,811.0
240.117,6,34,26457,18,17482,14124.0,2736.0,1655.0,16,8975,16007.0,2655.0,1355.0
15.073,17,15,9238,8,6902,2149.0,1350.0,834.0,7,2336,2507.0,1350.0,305.0
0.005,6,10,2006,5,927,1.0,659.0,659.0,5,1079,1.0,811.0,811.0
0.003,17,2,136,1,60,0.0,32.0,32.0,1,76,0.0,48.0,48.0
1791.526,6,485,98733,244,87503,7372.0,421.0,368.0,241,11230,7464.0,53.0,53.0
0.004,17,2,136,1,60,0.0,32.0,32.0,1,76,0.0,48.0,48.0
0.039,17,2,136,1,60,0.0,32.0,32.0,1,76,0.0,48.0,48.0
0.018,17,2,170,1,65,0.0,37.0,37.0,1,105,0.0,77.0,77.0
0.005,17,2,164,1,74,0.0,46.0,46.0,1,90,0.0,62.0,62.0
0.014,6,10,1989,5,910,3.0,642.0,642.0,5,1079,3.0,811.0,811.0
0.013,6,10,1677,5,827,3.0,559.0,559.0,5,850,3.0,582.0,582.0
0.013,6,10,1972,5,910,3.0,642.0,642.0,5,1062,3.0,794.0,794.0
0.005,17,2,140,1,62,0.0,34.0,34.0,1,78,0.0,50.0,50.0
0.004,6,10,1989,5,927,1.0,659.0,659.0,5,1062,1.0,794.0,794.0
152.119,6,29,17676,17,9737,9507.0,2804.0,1263.0,12,7939,6036.0,2310.0,1217.0
0.13,17,4,420,2,122,0.0,33.0,33.0,2,298,91.0,145.0,121.0
0.005,6,10,1689,5,839,1.0,571.0,571.0,5,850,1.0,582.0,582.0
0.006,6,10,1547,5,764,1.0,496.0,496.0,5,783,1.0,515.0,515.0
0.014,6,10,1972,5,910,3.0,642.0,642.0,5,1062,3.0,794.0,794.0
0.006,6,10,1689,5,839,1.0,571.0,571.0,5,850,1.0,582.0,582.0
0.005,6,10,1689,5,839,1.0,571.0,571.0,5,850,1.0,582.0,582.0
0.091,6,10,1506,5,395,19.0,127.0,127.0,5,1111,18.0,843.0,843.0
0.115,6,10,1506,5,395,23.0,127.0,127.0,5,1111,24.0,843.0,843.0
0.008,6,10,1989,5,910,1.0,642.0,642.0,5,1079,2.0,811.0,811.0
0.011,6,10,1983,5,910,2.0,642.0,642.0,5,1073,2.0,805.0,805.0
0.01,6,10,1989,5,910,2.0,642.0,642.0,5,1079,2.0,811.0,811.0
0.074,6,10,1506,5,395,16.0,127.0,127.0,5,1111,17.0,843.0,843.0
0.032,6,10,1990,5,911,7.0,643.0,643.0,5,1079,7.0,811.0,811.0
0.005,6,10,1989,5,927,1.0,659.0,659.0,5,1062,1.0,794.0,794.0
0.011,6,10,1989,5,910,2.0,642.0,642.0,5,1079,2.0,811.0,811.0
0.007,6,10,1990,5,911,1.0,643.0,643.0,5,1079,1.0,811.0,811.0
0.004,17,2,186,1,61,0.0,33.0,33.0,1,125,0.0,97.0,97.0
308.956,17,20,1124,10,716,34314.0,48.0,43.0,10,408,34314.0,20.0,12.0
40.076,17,10,676,5,460,10016.0,104.0,64.0,5,216,10018.0,20.0,15.0
0.007,17,2,179,1,71,0.0,43.0,43.0,1,108,0.0,80.0,80.0
40.058,17,10,676,5,460,10013.0,104.0,64.0,5,216,10013.0,20.0,15.0
240.108,6,16,4481,9,963,30013.0,238.0,166.0,7,3518,40015.0,1402.0,786.0
0.004,17,2,230,1,68,0.0,40.0,40.0,1,162,0.0,134.0,134.0
0.005,6,10,1854,5,889,1.0,621.0,621.0,5,965,1.0,697.0,697.0
0.004,6,10,1779,5,928,1.0,660.0,660.0,5,851,1.0,583.0,583.0
40.065,17,10,676,5,460,10015.0,104.0,64.0,5,216,10015.0,20.0,15.0
0.004,17,4,284,2,120,0.0,32.0,32.0,2,164,0.0,60.0,54.0
0.011,6,10,1989,5,910,2.0,642.0,642.0,5,1079,2.0,811.0,811.0
0.005,6,10,1989,5,927,1.0,659.0,659.0,5,1062,1.0,794.0,794.0
0.017,6,10,1989,5,910,4.0,642.0,642.0,5,1079,4.0,811.0,811.0
0.006,17,2,179,1,71,0.0,43.0,43.0,1,108,0.0,80.0,80.0
174.567,17,80,11661,40,2690,4475.0,44.0,39.0,40,8971,4476.0,261.0,196.0
1773.778,6,252,25450,102,9433,17560.0,586.0,66.0,150,16017,11903.0,1360.0,131.0
0.004,6,10,2000,5,927,1.0,659.0,659.0,5,1073,1.0,805.0,805.0
15.091,17,16,9303,8,6912,2151.0,1350.0,836.0,8,2391,2150.0,1350.0,270.0
0.006,6,10,2000,5,927,1.0,659.0,659.0,5,1073,1.0,805.0,805.0
0.008,17,2,194,1,59,0.0,31.0,31.0,1,135,0.0,107.0,107.0
0.008,6,10,1972,5,910,2.0,642.0,642.0,5,1062,2.0,794.0,794.0
0.004,17,2,148,1,60,0.0,32.0,32.0,1,88,0.0,60.0,60.0
0.004,17,2,208,1,72,0.0,44.0,44.0,1,136,0.0,108.0,108.0
0.272,6,10,1506,5,395,65.0,127.0,127.0,5,1111,62.0,843.0,843.0
0.109,6,10,1506,5,395,24.0,127.0,127.0,5,1111,24.0,843.0,843.0
0.008,6,10,1762,5,911,2.0,643.0,643.0,5,851,2.0,583.0,583.0
0.011,6,10,1983,5,910,2.0,642.0,642.0,5,1073,2.0,805.0,805.0
0.097,6,10,1506,5,395,19.0,127.0,127.0,5,1111,20.0,843.0,843.0
0.092,6,10,1506,5,395,20.0,127.0,127.0,5,1111,19.0,843.0,843.0
0.013,6,10,1983,5,910,3.0,642.0,642.0,5,1073,3.0,805.0,805.0
0.01,6,10,1762,5,911,2.0,643.0,643.0,5,851,2.0,583.0,583.0
0.08,6,10,1506,5,395,18.0,127.0,127.0,5,1111,17.0,843.0,843.0
0.004,6,10,1989,5,927,1.0,659.0,659.0,5,1062,1.0,794.0,794.0
40.058,17,10,676,5,460,10012.0,104.0,64.0,5,216,10013.0,20.0,15.0
0.012,6,14,3787,7,497,2.0,125.0,125.0,7,3290,1.0,1448.0,972.0
0.008,6,10,1989,5,910,2.0,642.0,642.0,5,1079,1.0,811.0,811.0
0.086,6,10,1506,5,395,19.0,127.0,127.0,5,1111,20.0,843.0,843.0
0.02,6,10,1989,5,910,4.0,642.0,642.0,5,1079,4.0,811.0,811.0
0.068,6,10,1506,5,395,14.0,127.0,127.0,5,1111,15.0,843.0,843.0
0.005,6,10,1989,5,927,1.0,659.0,659.0,5,1062,1.0,794.0,794.0
0.013,17,2,152,1,56,0.0,28.0,28.0,1,96,0.0,68.0,68.0
0.098,6,10,1506,5,395,21.0,127.0,127.0,5,1111,19.0,843.0,843.0
1770.676,6,87,4626,44,2340,41177.0,26.0,26.0,43,2286,42158.0,26.0,25.0
0.006,17,2,214,1,75,0.0,47.0,47.0,1,139,0.0,111.0,111.0
0.008,6,10,2006,5,927,1.0,659.0,659.0,5,1079,1.0,811.0,811.0
0.004,6,10,1702,5,863,0.0,595.0,595.0,5,839,1.0,571.0,571.0
0.005,17,2,230,1,68,0.0,40.0,40.0,1,162,0.0,134.0,134.0
40.065,17,10,676,5,460,10015.0,104.0,64.0,5,216,10015.0,20.0,15.0
0.007,6,10,1990,5,911,1.0,643.0,643.0,5,1079,1.0,811.0,811.0
0.005,6,13,3747,7,509,0.0,137.0,137.0,6,3238,0.0,1470.0,1459.0
0.032,6,10,1990,5,911,8.0,643.0,643.0,5,1079,7.0,811.0,811.0
15.069,17,15,9238,8,6902,2148.0,1350.0,834.0,7,2336,2506.0,1350.0,305.0
0.01,6,10,1990,5,911,2.0,643.0,643.0,5,1079,2.0,811.0,811.0
369.426,6,22,2313,16,867,24628.0,195.0,195.0,6,1446,4638.0,419.0,398.0
0.005,6,10,1689,5,839,1.0,571.0,571.0,5,850,1.0,582.0,582.0
1793.507,6,85,5319,43,2310,42701.0,37.0,37.0,42,3009,43743.0,280.0,206.0
0.015,6,10,1989,5,910,3.0,642.0,642.0,5,1079,3.0,811.0,811.0
0.008,6,10,2000,5,927,1.0,659.0,659.0,5,1073,2.0,805.0,805.0
0.005,6,10,1689,5,839,1.0,571.0,571.0,5,850,1.0,582.0,582.0
0.04,17,2,182,1,65,0.0,37.0,37.0,1,117,0.0,89.0,89.0
0.004,6,10,2006,5,927,1.0,659.0,659.0,5,1079,1.0,811.0,811.0
0.115,6,10,1506,5,395,26.0,127.0,127.0,5,1111,17.0,843.0,843.0
0.004,17,2,148,1,60,0.0,32.0,32.0,1,88,0.0,60.0,60.0
5.075,6,21,5923,12,1436,461.0,474.0,201.0,9,4487,634.0,1925.0,804.0
40.068,17,10,676,5,460,10014.0,104.0,64.0,5,216,10016.0,20.0,15.0
0.008,17,2,152,1,76,0.0,48.0,48.0,1,76,0.0,48.0,48.0
0.066,17,8,3613,4,1874,22.0,1350.0,440.0,4,1739,10.0,1350.0,406.0
0.012,6,10,1989,5,910,3.0,642.0,642.0,5,1079,2.0,811.0,811.0
0.005,17,4,284,2,120,1.0,32.0,32.0,2,164,2.0,60.0,54.0
0.017,6,10,1990,5,911,4.0,643.0,643.0,5,1079,4.0,811.0,811.0
0.016,6,10,1972,5,910,4.0,642.0,642.0,5,1062,3.0,794.0,794.0
0.013,6,10,1990,5,911,3.0,643.0,643.0,5,1079,3.0,811.0,811.0
0.011,6,10,1990,5,911,2.0,643.0,643.0,5,1079,2.0,811.0,811.0
0.003,17,2,136,1,60,0.0,32.0,32.0,1,76,0.0,48.0,48.0
0.005,17,2,144,1,64,0.0,36.0,36.0,1,80,0.0,52.0,52.0
0.072,6,10,1506,5,395,13.0,127.0,127.0,5,1111,15.0,843.0,843.0
0.01,6,10,1989,5,910,2.0,642.0,642.0,5,1079,2.0,811.0,811.0
368.636,6,22,2313,16,867,24575.0,195.0,195.0,6,1446,4645.0,419.0,398.0
0.224,17,14,8577,7,4012,37.0,1350.0,545.0,7,4565,28.0,1350.0,624.0
0.01,6,10,1972,5,910,2.0,642.0,642.0,5,1062,2.0,794.0,794.0
0.006,6,10,1854,5,889,1.0,621.0,621.0,5,965,1.0,697.0,697.0
0.02,6,10,1990,5,911,5.0,643.0,643.0,5,1079,5.0,811.0,811.0
0.025,17,2,214,1,75,0.0,47.0,47.0,1,139,0.0,111.0,111.0
0.006,17,2,168,1,76,0.0,48.0,48.0,1,92,0.0,64.0,64.0
0.01,6,10,1983,5,910,2.0,642.0,642.0,5,1073,2.0,805.0,805.0
0.005,17,2,213,1,69,0.0,41.0,41.0,1,144,0.0,116.0,116.0
0.079,6,10,1506,5,395,16.0,127.0,127.0,5,1111,15.0,843.0,843.0
0.012,6,10,1631,5,848,2.0,580.0,580.0,5,783,2.0,515.0,515.0
1770.595,6,83,4370,42,2211,43184.0,27.0,27.0,41,2159,44263.0,27.0,27.0
0.004,6,10,2007,5,928,1.0,660.0,660.0,5,1079,1.0,811.0,811.0
0.006,6,10,1689,5,839,1.0,571.0,571.0,5,850,1.0,582.0,582.0
0.016,6,10,1990,5,911,3.0,643.0,643.0,5,1079,3.0,811.0,811.0
0.013,6,10,1972,5,910,3.0,642.0,642.0,5,1062,3.0,794.0,794.0
0.015,6,10,1631,5,848,3.0,580.0,580.0,5,783,3.0,515.0,515.0
0.012,6,10,1677,5,827,2.0,559.0,559.0,5,850,3.0,582.0,582.0
0.005,6,10,1989,5,927,1.0,659.0,659.0,5,1062,1.0,794.0,794.0
0.06,17,2,80,1,32,0.0,4.0,4.0,1,48,0.0,20.0,20.0
0.006,6,10,2006,5,927,1.0,659.0,659.0,5,1079,1.0,811.0,811.0
0.069,6,10,1506,5,395,15.0,127.0,127.0,5,1111,15.0,843.0,843.0
0.011,6,10,1972,5,910,2.0,642.0,642.0,5,1062,2.0,794.0,794.0
0.004,6,10,2006,5,927,1.0,659.0,659.0,5,1079,1.0,811.0,811.0
0.017,6,10,1989,5,910,4.0,642.0,642.0,5,1079,4.0,811.0,811.0
0.005,6,10,2006,5,927,1.0,659.0,659.0,5,1079,1.0,811.0,811.0
0.002,17,2,136,1,60,0.0,32.0,32.0,1,76,0.0,48.0,48.0
0.005,6,10,1989,5,927,1.0,659.0,659.0,5,1062,1.0,794.0,794.0
0.016,6,10,1983,5,910,3.0,642.0,642.0,5,1073,4.0,805.0,805.0
0.005,6,10,1689,5,839,1.0,571.0,571.0,5,850,1.0,582.0,582.0
40.075,17,10,676,5,460,10017.0,104.0,64.0,5,216,10017.0,20.0,15.0
0.005,6,10,2006,5,927,1.0,659.0,659.0,5,1079,1.0,811.0,811.0
0.005,6,10,2007,5,928,1.0,660.0,660.0,5,1079,1.0,811.0,811.0
11.042,17,28,4422,14,1994,838.0,269.0,114.0,14,2428,837.0,587.0,145.0
0.005,17,2,144,1,64,0.0,36.0,36.0,1,80,0.0,52.0,52.0
1744.733,6,294,93056,182,82662,9639.0,2001.0,671.0,112,10394,15718.0,93.0,65.0
0.008,6,12,1926,6,1189,1.0,659.0,434.0,6,737,1.0,417.0,417.0
0.006,17,2,214,1,75,0.0,47.0,47.0,1,139,0.0,111.0,111.0
0.009,6,12,1926,6,1189,1.0,659.0,434.0,6,737,1.0,417.0,417.0
0.126,6,10,1506,5,395,29.0,127.0,127.0,5,1111,29.0,843.0,843.0
0.011,6,10,2006,5,927,2.0,659.0,659.0,5,1079,2.0,811.0,811.0
240.02,6,9,787,5,488,60005.0,232.0,232.0,4,299,80005.0,83.0,83.0
0.01,6,10,1972,5,910,2.0,642.0,642.0,5,1062,2.0,794.0,794.0
0.005,6,10,1989,5,927,1.0,659.0,659.0,5,1062,1.0,794.0,794.0
0.008,6,10,1677,5,827,2.0,559.0,559.0,5,850,1.0,582.0,582.0
0.078,6,10,1506,5,395,17.0,127.0,127.0,5,1111,16.0,843.0,843.0
0.004,17,2,136,1,60,0.0,32.0,32.0,1,76,0.0,48.0,48.0
0.001,17,2,166,1,75,0.0,47.0,47.0,1,91,0.0,63.0,63.0
0.017,6,10,1989,5,910,4.0,642.0,642.0,5,1079,4.0,811.0,811.0
0.006,17,2,179,1,71,0.0,43.0,43.0,1,108,0.0,80.0,80.0
0.004,6,10,1779,5,928,1.0,660.0,660.0,5,851,1.0,583.0,583.0
0.091,6,10,1506,5,395,20.0,127.0,127.0,5,1111,22.0,843.0,843.0
0.001,17,2,166,1,75,0.0,47.0,47.0,1,91,0.0,63.0,63.0
0.005,6,10,2006,5,927,1.0,659.0,659.0,5,1079,1.0,811.0,811.0
0.014,6,10,1762,5,911,3.0,643.0,643.0,5,851,3.0,583.0,583.0
40.071,17,10,676,5,460,10016.0,104.0,64.0,5,216,10016.0,20.0,15.0
0.009,6,10,1762,5,911,2.0,643.0,643.0,5,851,2.0,583.0,583.0
0.008,6,10,1631,5,848,1.0,580.0,580.0,5,783,2.0,515.0,515.0
0.011,6,10,1983,5,910,2.0,642.0,642.0,5,1073,2.0,805.0,805.0
0.074,17,4,352,2,130,1.0,37.0,37.0,2,222,69.0,89.0,83.0
0.007,6,10,1989,5,910,1.0,642.0,642.0,5,1079,1.0,811.0,811.0
10.834,17,24,3782,12,1674,975.0,269.0,111.0,12,2108,975.0,587.0,147.0
0.112,6,10,1506,5,395,23.0,127.0,127.0,5,1111,24.0,843.0,843.0
0.012,6,10,1989,5,910,2.0,642.0,642.0,5,1079,3.0,811.0,811.0
0.011,6,13,3735,7,497,1.0,125.0,125.0,6,3238,2.0,1470.0,1459.0
0.006,6,10,1547,5,764,1.0,496.0,496.0,5,783,1.0,515.0,515.0
0.006,17,2,222,1,65,0.0,37.0,37.0,1,157,0.0,129.0,129.0
0.07,6,10,1506,5,395,15.0,127.0,127.0,5,1111,14.0,843.0,843.0
0.007,6,10,1854,5,889,1.0,621.0,621.0,5,965,1.0,697.0,697.0
0.005,6,10,2006,5,927,1.0,659.0,659.0,5,1079,1.0,811.0,811.0
0.086,6,10,1506,5,395,19.0,127.0,127.0,5,1111,19.0,843.0,843.0
0.006,17,2,164,1,74,0.0,46.0,46.0,1,90,0.0,62.0,62.0
0.003,17,2,148,1,60,0.0,32.0,32.0,1,88,0.0,60.0,60.0
0.004,6,10,1989,5,927,1.0,659.0,659.0,5,1062,1.0,794.0,794.0
0.005,6,10,2007,5,928,1.0,660.0,660.0,5,1079,1.0,811.0,811.0
40.063,17,10,676,5,460,10014.0,104.0,64.0,5,216,10015.0,20.0,15.0
0.008,6,10,1972,5,910,2.0,642.0,642.0,5,1062,1.0,794.0,794.0
0.004,17,2,136,1,60,0.0,32.0,32.0,1,76,0.0,48.0,48.0
0.079,6,10,1506,5,395,18.0,127.0,127.0,5,1111,15.0,843.0,843.0
0.005,6,10,1989,5,927,1.0,659.0,659.0,5,1062,1.0,794.0,794.0
354.066,6,21,1795,16,1030,23604.0,190.0,190.0,5,765,60005.0,464.0,248.0
0.004,17,2,179,1,71,0.0,43.0,43.0,1,108,0.0,80.0,80.0
0.012,6,10,1990,5,911,3.0,643.0,643.0,5,1079,2.0,811.0,811.0
0.124,17,2,170,1,65,0.0,37.0,37.0,1,105,0.0,77.0,77.0
0.106,6,10,1506,5,395,24.0,127.0,127.0,5,1111,22.0,843.0,843.0
0.006,6,10,2007,5,928,1.0,660.0,660.0,5,1079,1.0,811.0,811.0
0.081,6,10,1506,5,395,17.0,127.0,127.0,5,1111,18.0,843.0,843.0
0.01,6,10,1989,5,910,2.0,642.0,642.0,5,1079,2.0,811.0,811.0
0.098,6,10,1506,5,395,22.0,127.0,127.0,5,1111,22.0,843.0,843.0
0.006,6,10,1547,5,764,1.0,496.0,496.0,5,783,1.0,515.0,515.0
0.004,6,10,1702,5,863,1.0,595.0,595.0,5,839,1.0,571.0,571.0
171.343,17,82,11347,41,2735,4283.0,44.0,38.0,41,8612,4283.0,261.0,182.0
0.008,17,2,194,1,59,0.0,31.0,31.0,1,135,0.0,107.0,107.0
0.077,6,10,1506,5,395,16.0,127.0,127.0,5,1111,15.0,843.0,843.0
0.122,6,10,1506,5,395,24.0,127.0,127.0,5,1111,25.0,843.0,843.0
0.014,6,10,1631,5,848,3.0,580.0,580.0,5,783,3.0,515.0,515.0
0.01,6,10,1983,5,910,2.0,642.0,642.0,5,1073,2.0,805.0,805.0
0.016,6,10,1989,5,910,4.0,642.0,642.0,5,1079,3.0,811.0,811.0
0.013,6,13,3735,7,497,2.0,125.0,125.0,6,3238,2.0,1470.0,1459.0
0.133,6,10,1506,5,395,31.0,127.0,127.0,5,1111,29.0,843.0,843.0
0.005,6,10,1774,5,923,1.0,655.0,655.0,5,851,1.0,583.0,583.0
0.019,6,10,1989,5,910,4.0,642.0,642.0,5,1079,4.0,811.0,811.0
0.005,6,10,1774,5,923,1.0,655.0,655.0,5,851,1.0,583.0,583.0
61.095,6,25,17427,14,9539,4699.0,2804.0,1469.0,11,7888,6096.0,2311.0,1218.0
0.014,6,10,1972,5,910,3.0,642.0,642.0,5,1062,3.0,794.0,794.0
0.113,6,10,1506,5,395,24.0,127.0,127.0,5,1111,25.0,843.0,843.0
0.004,17,2,170,1,65,0.0,37.0,37.0,1,105,0.0,77.0,77.0
0.005,6,10,2006,5,927,1.0,659.0,659.0,5,1079,1.0,811.0,811.0
0.005,6,10,1989,5,927,1.0,659.0,659.0,5,1062,1.0,794.0,794.0
0.012,6,10,1972,5,910,3.0,642.0,642.0,5,1062,3.0,794.0,794.0
1.049,6,13,3922,7,2139,131.0,1328.0,923.0,6,1783,157.0,1539.0,1539.0
0.006,6,10,1547,5,764,1.0,496.0,496.0,5,783,1.0,515.0,515.0
0.006,6,10,1643,5,860,1.0,592.0,592.0,5,783,1.0,515.0,515.0
0.013,17,2,152,1,56,0.0,28.0,28.0,1,96,0.0,68.0,68.0
0.008,6,12,1926,6,1189,1.0,659.0,434.0,6,737,1.0,417.0,417.0
0.127,6,10,1506,5,395,27.0,127.0,127.0,5,1111,25.0,843.0,843.0
0.005,17,2,213,1,69,0.0,41.0,41.0,1,144,0.0,116.0,116.0
0.004,17,2,148,1,60,0.0,32.0,32.0,1,88,0.0,60.0,60.0
0.003,17,2,136,1,60,0.0,32.0,32.0,1,76,0.0,48.0,48.0
171.359,17,68,9477,34,2258,5192.0,44.0,38.0,34,7219,5192.0,261.0,184.0
0.003,17,2,148,1,60,0.0,32.0,32.0,1,88,0.0,60.0,60.0
0.008,6,10,1983,5,910,2.0,642.0,642.0,5,1073,1.0,805.0,805.0
0.261,17,39,20261,21,17042,13.0,1350.0,783.0,18,3219,12.0,1350.0,150.0
242.367,6,376,347115,196,21722,1242.0,2736.0,960.0,180,325393,1353.0,2804.0,1858.0
0.106,6,10,1506,5,395,25.0,127.0,127.0,5,1111,23.0,843.0,843.0
0.005,6,10,1989,5,927,1.0,659.0,659.0,5,1062,1.0,794.0,794.0
0.004,6,10,2007,5,928,1.0,660.0,660.0,5,1079,1.0,811.0,811.0
0.004,6,10,1774,5,923,1.0,655.0,655.0,5,851,1.0,583.0,583.0
0.006,17,2,179,1,71,0.0,43.0,43.0,1,108,0.0,80.0,80.0
0.006,6,10,1689,5,839,1.0,571.0,571.0,5,850,1.0,582.0,582.0
0.006,17,2,164,1,74,0.0,46.0,46.0,1,90,0.0,62.0,62.0
0.013,6,10,1983,5,910,3.0,642.0,642.0,5,1073,3.0,805.0,805.0
0.009,6,10,1989,5,910,2.0,642.0,642.0,5,1079,2.0,811.0,811.0
240.013,6,9,787,5,488,60003.0,232.0,232.0,4,299,80002.0,83.0,83.0
0.007,6,10,1689,5,839,1.0,571.0,571.0,5,850,1.0,582.0,582.0
0.013,6,10,1983,5,910,3.0,642.0,642.0,5,1073,3.0,805.0,805.0
0.001,17,2,180,1,66,0.0,38.0,38.0,1,114,0.0,86.0,86.0
0.006,6,10,1547,5,764,1.0,496.0,496.0,5,783,1.0,515.0,515.0
0.0,17,2,180,1,65,0.0,37.0,37.0,1,115,0.0,87.0,87.0
0.015,6,10,1983,5,910,3.0,642.0,642.0,5,1073,3.0,805.0,805.0
0.087,6,10,1506,5,395,21.0,127.0,127.0,5,1111,21.0,843.0,843.0
0.006,17,2,166,1,75,0.0,47.0,47.0,1,91,0.0,63.0,63.0
15.076,17,15,9238,8,6902,2149.0,1350.0,834.0,7,2336,2507.0,1350.0,305.0
0.012,6,10,1972,5,910,3.0,642.0,642.0,5,1062,2.0,794.0,794.0
0.007,6,10,2000,5,927,1.0,659.0,659.0,5,1073,1.0,805.0,805.0
0.005,6,10,2000,5,927,1.0,659.0,659.0,5,1073,1.0,805.0,805.0
0.014,6,10,1972,5,910,3.0,642.0,642.0,5,1062,3.0,794.0,794.0
0.068,6,10,1506,5,395,14.0,127.0,127.0,5,1111,15.0,843.0,843.0
10.801,17,28,4423,14,1995,822.0,270.0,114.0,14,2428,822.0,587.0,145.0
0.105,6,10,1506,5,395,24.0,127.0,127.0,5,1111,25.0,843.0,843.0
0.013,6,10,1762,5,911,3.0,643.0,643.0,5,851,3.0,583.0,583.0
0.011,6,10,1983,5,910,2.0,642.0,642.0,5,1073,2.0,805.0,805.0
0.005,6,10,1989,5,927,1.0,659.0,659.0,5,1062,1.0,794.0,794.0
0.083,6,10,1506,5,395,18.0,127.0,127.0,5,1111,18.0,843.0,843.0
0.026,6,10,1972,5,910,6.0,642.0,642.0,5,1062,6.0,794.0,794.0
240.113,6,19,8108,10,2075,26679.0,1495.0,779.0,9,6033,30013.0,2115.0,1111.0
11.427,17,29,4561,14,2312,866.0,587.0,137.0,15,2249,804.0,268.0,121.0
0.006,6,10,1547,5,764,1.0,496.0,496.0,5,783,1.0,515.0,515.0
300.376,6,16,2170,9,684,37526.0,146.0,146.0,7,1486,50035.0,419.0,398.0
0.013,6,10,1972,5,910,3.0,642.0,642.0,5,1062,3.0,794.0,794.0
0.005,17,2,144,1,64,0.0,36.0,36.0,1,80,0.0,52.0,52.0
0.012,6,13,3735,7,497,1.0,125.0,125.0,6,3238,2.0,1470.0,1459.0
424.997,6,29,4409,12,3102,10912.0,494.0,494.0,17,1307,26562.0,83.0,83.0
0.112,6,10,1506,5,395,26.0,127.0,127.0,5,1111,26.0,843.0,843.0
0.047,17,4,284,2,120,1.0,32.0,32.0,2,164,41.0,60.0,54.0
40.054,17,10,676,5,460,10012.0,104.0,64.0,5,216,10012.0,20.0,15.0
0.006,6,10,2006,5,927,1.0,659.0,659.0,5,1079,1.0,811.0,811.0
0.061,6,10,1506,5,395,12.0,127.0,127.0,5,1111,12.0,843.0,843.0
0.005,6,10,1689,5,839,1.0,571.0,571.0,5,850,1.0,582.0,582.0
0.088,6,10,1506,5,395,21.0,127.0,127.0,5,1111,16.0,843.0,843.0
0.064,6,10,1506,5,395,15.0,127.0,127.0,5,1111,14.0,843.0,843.0
10.802,17,28,4423,14,1995,822.0,270.0,114.0,14,2428,822.0,587.0,145.0
0.006,6,10,1547,5,764,1.0,496.0,496.0,5,783,1.0,515.0,515.0
0.004,17,2,136,1,60,0.0,32.0,32.0,1,76,0.0,48.0,48.0
0.005,6,10,1547,5,764,1.0,496.0,496.0,5,783,1.0,515.0,515.0
40.058,17,10,676,5,460,10013.0,104.0,64.0,5,216,10013.0,20.0,15.0
0.06,17,2,152,1,76,0.0,48.0,48.0,1,76,0.0,48.0,48.0
0.001,17,2,166,1,75,0.0,47.0,47.0,1,91,0.0,63.0,63.0
0.006,6,12,1698,6,863,1.0,327.0,271.0,6,835,1.0,515.0,515.0
0.014,6,10,1762,5,911,3.0,643.0,643.0,5,851,3.0,583.0,583.0
0.006,17,2,230,1,68,0.0,40.0,40.0,1,162,0.0,134.0,134.0
0.005,17,2,175,1,65,0.0,37.0,37.0,1,110,0.0,82.0,82.0
11.506,17,28,4389,14,2312,872.0,587.0,137.0,14,2077,872.0,268.0,120.0
0.003,17,2,136,1,60,0.0,32.0,32.0,1,76,0.0,48.0,48.0
0.005,6,10,2000,5,927,1.0,659.0,659.0,5,1073,1.0,805.0,805.0
0.016,6,10,1990,5,911,3.0,643.0,643.0,5,1079,3.0,811.0,811.0
15.071,17,15,9238,8,6902,2149.0,1350.0,834.0,7,2336,2506.0,1350.0,305.0
0.006,6,10,1854,5,889,1.0,621.0,621.0,5,965,1.0,697.0,697.0
40.081,17,10,676,5,460,10017.0,104.0,64.0,5,216,10019.0,20.0,15.0
0.01,6,10,1989,5,910,2.0,642.0,642.0,5,1079,2.0,811.0,811.0
0.005,6,10,1989,5,927,1.0,659.0,659.0,5,1062,1.0,794.0,794.0
0.073,17,2,166,1,75,0.0,47.0,47.0,1,91,0.0,63.0,63.0
0.005,17,2,214,1,75,0.0,47.0,47.0,1,139,0.0,111.0,111.0
0.008,17,2,136,1,60,0.0,32.0,32.0,1,76,0.0,48.0,48.0
0.007,6,10,2000,5,927,1.0,659.0,659.0,5,1073,1.0,805.0,805.0
10.98,17,28,4391,14,2312,836.0,587.0,137.0,14,2079,836.0,270.0,120.0
0.005,17,2,170,1,65,0.0,37.0,37.0,1,105,0.0,77.0,77.0
0.129,6,10,1506,5,395,29.0,127.0,127.0,5,1111,28.0,843.0,843.0
0.001,17,2,136,1,60,0.0,32.0,32.0,1,76,0.0,48.0,48.0
10.729,17,28,4423,14,1995,817.0,270.0,114.0,14,2428,817.0,587.0,145.0
0.041,17,2,170,1,65,0.0,37.0,37.0,1,105,0.0,77.0,77.0
0.014,6,10,1990,5,911,3.0,643.0,643.0,5,1079,3.0,811.0,811.0
0.108,6,10,1506,5,395,24.0,127.0,127.0,5,1111,22.0,843.0,843.0
0.013,6,13,3735,7,497,2.0,125.0,125.0,6,3238,2.0,1470.0,1459.0
0.004,6,10,2000,5,927,1.0,659.0,659.0,5,1073,1.0,805.0,805.0
0.014,6,13,3735,7,497,2.0,125.0,125.0,6,3238,2.0,1470.0,1459.0
0.042,17,4,352,2,130,1.0,37.0,37.0,2,222,38.0,89.0,83.0
1770.129,6,300,94113,185,83368,9620.0,2001.0,670.0,115,10745,15527.0,93.0,66.0
0.001,17,2,180,1,66,0.0,38.0,38.0,1,114,0.0,86.0,86.0
0.005,6,10,2006,5,927,1.0,659.0,659.0,5,1079,1.0,811.0,811.0
0.005,6,10,2006,5,927,1.0,659.0,659.0,5,1079,1.0,811.0,811.0
0.004,6,10,2000,5,927,1.0,659.0,659.0,5,1073,1.0,805.0,805.0
1730.353,6,45,2790,30,1725,59667.0,35.0,35.0,15,1065,123591.0,31.0,31.0
0.012,6,10,1990,5,911,2.0,643.0,643.0,5,1079,3.0,811.0,811.0
40.054,17,10,676,5,460,10012.0,104.0,64.0,5,216,10012.0,20.0,15.0
0.017,6,10,1677,5,827,4.0,559.0,559.0,5,850,4.0,582.0,582.0
0.006,17,2,214,1,75,0.0,47.0,47.0,1,139,0.0,111.0,111.0
40.065,17,10,676,5,460,10015.0,104.0,64.0,5,216,10015.0,20.0,15.0
0.017,6,10,1989,5,910,4.0,642.0,642.0,5,1079,4.0,811.0,811.0
0.001,17,2,180,1,66,0.0,38.0,38.0,1,114,0.0,86.0,86.0
0.005,6,10,1689,5,839,1.0,571.0,571.0,5,850,1.0,582.0,582.0
0.012,6,10,1990,5,911,3.0,643.0,643.0,5,1079,3.0,811.0,811.0
0.009,6,10,1677,5,827,2.0,559.0,559.0,5,850,2.0,582.0,582.0
0.008,6,10,1990,5,911,2.0,643.0,643.0,5,1079,2.0,811.0,811.0
0.107,6,10,1506,5,395,22.0,127.0,127.0,5,1111,22.0,843.0,843.0
0.114,6,10,1506,5,395,23.0,127.0,127.0,5,1111,26.0,843.0,843.0
0.042,17,2,148,1,60,0.0,32.0,32.0,1,88,0.0,60.0,60.0
421.557,6,39,12418,21,3594,21077.0,676.0,415.0,18,8824,21265.0,1402.0,716.0
316.399,17,20,1124,10,716,35141.0,48.0,43.0,10,408,35141.0,20.0,12.0
102.34,6,39,10125,21,4607,5108.0,1360.0,620.0,18,5518,6009.0,2667.0,435.0
15.077,17,15,9238,8,6902,2149.0,1350.0,834.0,7,2336,2507.0,1350.0,305.0
0.017,6,10,1990,5,911,4.0,643.0,643.0,5,1079,4.0,811.0,811.0
15.219,17,43,27821,26,24772,607.0,1350.0,924.0,17,3049,950.0,1350.0,151.0
0.079,6,10,1506,5,395,17.0,127.0,127.0,5,1111,18.0,843.0,843.0
0.005,6,10,2006,5,927,1.0,659.0,659.0,5,1079,1.0,811.0,811.0
0.12,6,10,1506,5,395,26.0,127.0,127.0,5,1111,29.0,843.0,843.0
0.002,17,2,180,1,66,0.0,38.0,38.0,1,114,0.0,86.0,86.0
351.991,6,20,2210,6,1308,12004.0,494.0,494.0,14,902,27076.0,83.0,83.0
0.006,17,2,255,1,82,0.0,54.0,54.0,1,173,0.0,145.0,145.0
411.999,6,29,4409,12,3102,10911.0,494.0,494.0,17,1307,25749.0,83.0,83.0
0.011,6,10,1631,5,848,2.0,580.0,580.0,5,783,2.0,515.0,515.0
0.014,6,10,1631,5,848,3.0,580.0,580.0,5,783,3.0,515.0,515.0
0.013,6,10,1631,5,848,3.0,580.0,580.0,5,783,3.0,515.0,515.0
0.018,6,10,1989,5,910,4.0,642.0,642.0,5,1079,4.0,811.0,811.0
0.005,6,10,2007,5,928,1.0,660.0,660.0,5,1079,1.0,811.0,811.0
0.005,6,10,2006,5,927,1.0,659.0,659.0,5,1079,1.0,811.0,811.0
0.008,6,10,1989,5,910,2.0,642.0,642.0,5,1079,2.0,811.0,811.0
0.006,17,2,169,1,62,0.0,34.0,34.0,1,107,0.0,79.0,79.0
0.005,17,2,179,1,71,0.0,43.0,43.0,1,108,0.0,80.0,80.0
168.337,17,92,12913,46,3074,3740.0,44.0,38.0,46,9839,3740.0,261.0,185.0
0.001,17,2,136,1,60,0.0,32.0,32.0,1,76,0.0,48.0,48.0
0.004,17,4,284,2,120,1.0,32.0,32.0,2,164,1.0,60.0,54.0
0.707,6,26,5499,13,1597,51.0,325.0,152.0,13,3902,49.0,1414.0,563.0
0.092,17,2,152,1,76,0.0,48.0,48.0,1,76,0.0,48.0,48.0
0.005,6,10,1689,5,839,1.0,571.0,571.0,5,850,1.0,582.0,582.0
0.001,17,2,180,1,66,0.0,38.0,38.0,1,114,0.0,86.0,86.0
0.088,6,10,1506,5,395,20.0,127.0,127.0,5,1111,19.0,843.0,843.0
0.007,17,2,179,1,71,0.0,43.0,43.0,1,108,0.0,80.0,80.0
111.061,6,22,9233,11,1575,83.0,794.0,367.0,11,7658,11093.0,1360.0,1029.0
0.005,6,10,1547,5,764,1.0,496.0,496.0,5,783,1.0,515.0,515.0
0.005,6,10,1774,5,923,1.0,655.0,655.0,5,851,1.0,583.0,583.0
0.003,17,2,148,1,60,0.0,32.0,32.0,1,88,0.0,60.0,60.0
0.09,6,10,1506,5,395,20.0,127.0,127.0,5,1111,20.0,843.0,843.0
0.01,6,10,1990,5,911,2.0,643.0,643.0,5,1079,2.0,811.0,811.0
0.007,6,10,1643,5,860,1.0,592.0,592.0,5,783,1.0,515.0,515.0
0.005,6,10,1989,5,927,1.0,659.0,659.0,5,1062,1.0,794.0,794.0
0.008,6,10,1983,5,910,2.0,642.0,642.0,5,1073,2.0,805.0,805.0
0.005,17,2,214,1,75,0.0,47.0,47.0,1,139,0.0,111.0,111.0
11.04,17,28,4389,14,2311,840.0,586.0,137.0,14,2078,840.0,269.0,120.0
0.102,6,10,1506,5,395,22.0,127.0,127.0,5,1111,15.0,843.0,843.0
0.005,6,10,2006,5,927,1.0,659.0,659.0,5,1079,1.0,811.0,811.0
0.012,6,10,1631,5,848,3.0,580.0,580.0,5,783,3.0,515.0,515.0
0.005,6,10,1989,5,927,1.0,659.0,659.0,5,1062,1.0,794.0,794.0
15.077,17,16,8417,8,6304,2149.0,1350.0,760.0,8,2113,2149.0,1350.0,236.0
0.713,6,26,5499,13,1597,50.0,325.0,152.0,13,3902,50.0,1414.0,563.0
0.004,6,10,1989,5,927,1.0,659.0,659.0,5,1062,1.0,794.0,794.0
0.01,6,10,1990,5,911,2.0,643.0,643.0,5,1079,2.0,811.0,811.0
40.054,17,10,676,5,460,10012.0,104.0,64.0,5,216,10012.0,20.0,15.0
40.069,17,10,676,5,460,10014.0,104.0,64.0,5,216,10016.0,20.0,15.0
0.001,17,2,180,1,66,0.0,38.0,38.0,1,114,0.0,86.0,86.0
0.005,6,10,1854,5,889,1.0,621.0,621.0,5,965,1.0,697.0,697.0
0.006,6,10,1547,5,764,1.0,496.0,496.0,5,783,1.0,515.0,515.0
0.017,6,10,1631,5,848,4.0,580.0,580.0,5,783,4.0,515.0,515.0
0.169,6,3,453,2,321,169.0,241.0,241.0,1,132,0.0,92.0,92.0
0.256,17,40,20215,22,17093,12.0,1350.0,748.0,18,3122,11.0,1350.0,145.0
0.013,6,10,1762,5,911,3.0,643.0,643.0,5,851,3.0,583.0,583.0
0.005,6,10,1989,5,927,1.0,659.0,659.0,5,1062,1.0,794.0,794.0
0.006,6,10,1547,5,764,1.0,496.0,496.0,5,783,1.0,515.0,515.0
15.07,17,15,9238,8,6902,2148.0,1350.0,834.0,7,2336,2506.0,1350.0,305.0
0.005,17,2,144,1,64,0.0,36.0,36.0,1,80,0.0,52.0,52.0
0.001,17,2,152,1,68,0.0,40.0,40.0,1,84,0.0,56.0,56.0
0.031,6,13,3735,7,497,5.0,125.0,125.0,6,3238,6.0,1470.0,1459.0
0.109,6,10,1506,5,395,25.0,127.0,127.0,5,1111,21.0,843.0,843.0
0.005,17,2,213,1,69,0.0,41.0,41.0,1,144,0.0,116.0,116.0
0.007,6,10,1989,5,927,1.0,659.0,659.0,5,1062,1.0,794.0,794.0
0.003,17,2,136,1,60,0.0,32.0,32.0,1,76,0.0,48.0,48.0
0.008,6,10,1990,5,911,2.0,643.0,643.0,5,1079,2.0,811.0,811.0
240.024,6,9,787,5,488,60006.0,232.0,232.0,4,299,80007.0,83.0,83.0
15.18,17,45,27129,26,21266,606.0,1350.0,789.0,19,5863,841.0,1350.0,280.0
0.001,17,2,194,1,57,0.0,29.0,29.0,1,137,0.0,109.0,109.0
0.006,6,10,1689,5,839,1.0,571.0,571.0,5,850,1.0,582.0,582.0
0.014,6,10,1989,5,910,3.0,642.0,642.0,5,1079,3.0,811.0,811.0
0.091,6,10,1506,5,395,20.0,127.0,127.0,5,1111,20.0,843.0,843.0
0.005,6,10,2007,5,928,1.0,660.0,660.0,5,1079,1.0,811.0,811.0
9.039,17,6,376,5,280,2259.0,28.0,28.0,1,96,0.0,68.0,68.0
0.106,6,10,1506,5,395,22.0,127.0,127.0,5,1111,24.0,843.0,843.0
361.847,6,19,1689,15,978,25846.0,190.0,190.0,4,711,80012.0,495.0,495.0
0.011,6,10,1989,5,910,2.0,642.0,642.0,5,1079,2.0,811.0,811.0
0.002,17,2,268,1,70,0.0,42.0,42.0,1,198,0.0,170.0,170.0
0.014,6,10,1762,5,911,3.0,643.0,643.0,5,851,3.0,583.0,583.0
0.001,17,2,166,1,75,0.0,47.0,47.0,1,91,0.0,63.0,63.0
0.005,6,10,1989,5,927,1.0,659.0,659.0,5,1062,1.0,794.0,794.0
0.005,6,10,1702,5,863,1.0,595.0,595.0,5,839,1.0,571.0,571.0
0.005,17,2,170,1,65,0.0,37.0,37.0,1,105,0.0,77.0,77.0
0.01,6,10,1972,5,910,2.0,642.0,642.0,5,1062,2.0,794.0,794.0
23.065,6,36,9704,19,4226,1281.0,1753.0,858.0,17,5478,540.0,2667.0,435.0
0.004,6,10,2000,5,927,1.0,659.0,659.0,5,1073,1.0,805.0,805.0
0.01,6,10,1989,5,910,2.0,642.0,642.0,5,1079,2.0,811.0,811.0
0.019,6,10,1983,5,910,4.0,642.0,642.0,5,1073,4.0,805.0,805.0
0.012,6,10,1989,5,910,3.0,642.0,642.0,5,1079,2.0,811.0,811.0
40.068,17,10,676,5,460,10016.0,104.0,64.0,5,216,10016.0,20.0,15.0
0.075,6,10,1506,5,395,17.0,127.0,127.0,5,1111,14.0,843.0,843.0
0.186,17,2,144,1,64,0.0,36.0,36.0,1,80,0.0,52.0,52.0
11.505,17,28,4393,14,2312,872.0,587.0,137.0,14,2081,872.0,268.0,120.0
0.004,17,2,148,1,60,0.0,32.0,32.0,1,88,0.0,60.0,60.0
0.017,6,10,1677,5,827,4.0,559.0,559.0,5,850,4.0,582.0,582.0
0.005,6,10,1643,5,860,1.0,592.0,592.0,5,783,1.0,515.0,515.0
0.004,6,10,1702,5,863,0.0,595.0,595.0,5,839,1.0,571.0,571.0
11.175,17,28,4423,14,1995,847.0,270.0,114.0,14,2428,846.0,587.0,145.0
0.004,17,4,284,2,120,1.0,32.0,32.0,2,164,1.0,60.0,54.0
0.003,17,2,148,1,60,0.0,32.0,32.0,1,88,0.0,60.0,60.0
0.04,17,2,412,1,61,0.0,33.0,33.0,1,351,0.0,323.0,323.0
0.006,6,10,1547,5,764,1.0,496.0,496.0,5,783,1.0,515.0,515.0
0.005,6,10,2006,5,927,1.0,659.0,659.0,5,1079,1.0,811.0,811.0
0.039,17,2,412,1,61,0.0,33.0,33.0,1,351,0.0,323.0,323.0
0.005,6,10,2007,5,928,1.0,660.0,660.0,5,1079,1.0,811.0,811.0
0.004,6,10,2000,5,927,1.0,659.0,659.0,5,1073,1.0,805.0,805.0
0.133,6,10,1506,5,395,29.0,127.0,127.0,5,1111,30.0,843.0,843.0
10.753,17,28,4422,14,1994,819.0,269.0,114.0,14,2428,818.0,587.0,145.0
0.004,6,10,2000,5,927,1.0,659.0,659.0,5,1073,1.0,805.0,805.0
0.109,6,10,1506,5,395,24.0,127.0,127.0,5,1111,24.0,843.0,843.0
0.005,17,2,140,1,62,0.0,34.0,34.0,1,78,0.0,50.0,50.0
0.005,17,2,148,1,60,0.0,32.0,32.0,1,88,0.0,60.0,60.0
361.852,6,21,1793,16,1030,24123.0,190.0,190.0,5,763,60010.0,462.0,247.0
0.005,6,10,2007,5,928,1.0,660.0,660.0,5,1079,1.0,811.0,811.0
11.196,17,34,6344,17,2655,692.0,269.0,128.0,17,3689,692.0,1146.0,189.0
1744.952,6,299,94031,184,83376,9535.0,2001.0,670.0,115,10655,15306.0,93.0,65.0
0.005,6,10,1547,5,764,1.0,496.0,496.0,5,783,1.0,515.0,515.0
0.014,6,10,1762,5,911,3.0,643.0,643.0,5,851,3.0,583.0,583.0
0.005,17,2,146,1,65,0.0,37.0,37.0,1,81,0.0,53.0,53.0
0.006,6,10,2007,5,928,1.0,660.0,660.0,5,1079,1.0,811.0,811.0
0.005,6,10,2007,5,928,1.0,660.0,660.0,5,1079,1.0,811.0,811.0
0.006,6,10,1547,5,764,1.0,496.0,496.0,5,783,1.0,515.0,515.0
0.004,17,2,136,1,60,0.0,32.0,32.0,1,76,0.0,48.0,48.0
0.008,6,10,1989,5,910,2.0,642.0,642.0,5,1079,1.0,811.0,811.0
0.48,6,27,12315,15,2541,34.0,1272.0,441.0,12,9774,43.0,1402.0,1015.0
0.014,6,10,1989,5,910,3.0,642.0,642.0,5,1079,3.0,811.0,811.0
0.097,6,10,1506,5,395,22.0,127.0,127.0,5,1111,20.0,843.0,843.0
0.009,6,10,1989,5,910,2.0,642.0,642.0,5,1079,2.0,811.0,811.0
0.012,6,10,1762,5,911,3.0,643.0,643.0,5,851,2.0,583.0,583.0
300.986,6,43,11800,23,5973,13681.0,1376.0,717.0,20,5827,463.0,2667.0,385.0
0.004,6,10,2000,5,927,1.0,659.0,659.0,5,1073,1.0,805.0,805.0
0.09,6,10,1506,5,395,20.0,127.0,127.0,5,1111,20.0,843.0,843.0
0.072,17,4,284,2,120,0.0,32.0,32.0,2,164,31.0,60.0,54.0
0.003,17,2,148,1,60,0.0,32.0,32.0,1,88,0.0,60.0,60.0
0.004,17,2,136,1,60,0.0,32.0,32.0,1,76,0.0,48.0,48.0
0.011,6,10,1983,5,910,2.0,642.0,642.0,5,1073,2.0,805.0,805.0
0.006,6,10,1547,5,764,1.0,496.0,496.0,5,783,1.0,515.0,515.0
294.737,6,378,347767,192,21542,1543.0,2736.0,825.0,186,326225,1593.0,2917.0,1840.0
0.011,6,10,1989,5,910,2.0,642.0,642.0,5,1079,2.0,811.0,811.0
0.085,6,10,1506,5,395,19.0,127.0,127.0,5,1111,17.0,843.0,843.0
0.007,6,10,1689,5,839,1.0,571.0,571.0,5,850,1.0,582.0,582.0
0.005,17,2,166,1,75,0.0,47.0,47.0,1,91,0.0,63.0,63.0
0.012,6,10,1972,5,910,3.0,642.0,642.0,5,1062,2.0,794.0,794.0
10.813,17,28,4422,14,1994,823.0,269.0,114.0,14,2428,823.0,587.0,145.0
0.005,6,10,2006,5,927,1.0,659.0,659.0,5,1079,1.0,811.0,811.0
0.007,17,2,179,1,71,0.0,43.0,43.0,1,108,0.0,80.0,80.0
0.004,6,10,2006,5,927,1.0,659.0,659.0,5,1079,1.0,811.0,811.0
0.006,17,2,179,1,71,0.0,43.0,43.0,1,108,0.0,80.0,80.0
0.013,17,2,152,1,56,0.0,28.0,28.0,1,96,0.0,68.0,68.0
0.005,6,10,2006,5,927,1.0,659.0,659.0,5,1079,1.0,811.0,811.0
0.005,6,10,2007,5,928,1.0,660.0,660.0,5,1079,1.0,811.0,811.0
0.005,6,10,2006,5,927,1.0,659.0,659.0,5,1079,1.0,811.0,811.0
0.124,6,10,1506,5,395,27.0,127.0,127.0,5,1111,26.0,843.0,843.0
0.006,6,10,1989,5,927,1.0,659.0,659.0,5,1062,1.0,794.0,794.0
0.079,6,10,1506,5,395,18.0,127.0,127.0,5,1111,13.0,843.0,843.0
0.004,17,2,148,1,60,0.0,32.0,32.0,1,88,0.0,60.0,60.0
39.24,17,26,14947,14,12082,3016.0,1350.0,835.0,12,2865,3564.0,1350.0,210.0
0.006,17,2,293,1,73,0.0,45.0,45.0,1,220,0.0,192.0,192.0
0.005,17,2,164,1,74,0.0,46.0,46.0,1,90,0.0,62.0,62.0
290.546,6,375,347709,191,21500,1529.0,2736.0,889.0,184,326209,1587.0,2804.0,1862.0
0.005,6,10,2006,5,927,1.0,659.0,659.0,5,1079,1.0,811.0,811.0
0.017,17,2,180,1,66,0.0,38.0,38.0,1,114,0.0,86.0,86.0
0.004,6,10,1774,5,923,1.0,655.0,655.0,5,851,1.0,583.0,583.0
0.041,17,2,152,1,76,0.0,48.0,48.0,1,76,0.0,48.0,48.0
0.07,6,10,1506,5,395,15.0,127.0,127.0,5,1111,15.0,843.0,843.0
0.04,17,2,156,1,64,0.0,36.0,36.0,1,92,0.0,64.0,64.0
0.094,6,10,1506,5,395,19.0,127.0,127.0,5,1111,20.0,843.0,843.0
0.005,6,10,2006,5,927,1.0,659.0,659.0,5,1079,1.0,811.0,811.0
0.016,6,10,2006,5,927,4.0,659.0,659.0,5,1079,4.0,811.0,811.0
0.001,17,2,180,1,66,0.0,38.0,38.0,1,114,0.0,86.0,86.0
0.008,6,10,1989,5,910,2.0,642.0,642.0,5,1079,2.0,811.0,811.0
0.012,6,10,1989,5,910,2.0,642.0,642.0,5,1079,3.0,811.0,811.0
0.038,17,2,184,1,61,0.0,33.0,33.0,1,123,0.0,95.0,95.0
0.005,6,10,1643,5,860,1.0,592.0,592.0,5,783,1.0,515.0,515.0
169.242,17,80,11350,40,2660,4339.0,44.0,38.0,40,8690,4339.0,261.0,189.0
0.008,6,10,1989,5,910,1.0,642.0,642.0,5,1079,2.0,811.0,811.0
0.005,17,2,169,1,62,0.0,34.0,34.0,1,107,0.0,79.0,79.0
0.006,6,10,1547,5,764,1.0,496.0,496.0,5,783,1.0,515.0,515.0
0.005,6,10,2006,5,927,1.0,659.0,659.0,5,1079,1.0,811.0,811.0
0.005,6,10,2007,5,928,1.0,660.0,660.0,5,1079,1.0,811.0,811.0
0.022,6,10,1983,5,910,5.0,642.0,642.0,5,1073,5.0,805.0,805.0
0.004,6,10,2006,5,927,1.0,659.0,659.0,5,1079,1.0,811.0,811.0
0.015,6,10,1990,5,911,3.0,643.0,643.0,5,1079,3.0,811.0,811.0
40.064,17,10,676,5,460,10013.0,104.0,64.0,5,216,10013.0,20.0,15.0
0.104,6,10,1506,5,395,19.0,127.0,127.0,5,1111,23.0,843.0,843.0
0.004,6,10,2006,5,927,1.0,659.0,659.0,5,1079,1.0,811.0,811.0
0.005,6,14,3736,7,446,0.0,74.0,74.0,7,3290,0.0,1448.0,972.0
0.284,6,14,3108,8,601,40.0,177.0,177.0,6,2507,55.0,1402.0,1089.0
0.005,6,10,2006,5,927,1.0,659.0,659.0,5,1079,1.0,811.0,811.0
15.071,17,15,9238,8,6902,2148.0,1350.0,834.0,7,2336,2507.0,1350.0,305.0
0.014,6,10,1989,5,910,3.0,642.0,642.0,5,1079,3.0,811.0,811.0
352.891,6,20,2210,6,1308,12003.0,494.0,494.0,14,902,27145.0,83.0,83.0
0.005,6,10,2006,5,927,1.0,659.0,659.0,5,1079,1.0,811.0,811.0
0.109,6,10,1506,5,395,24.0,127.0,127.0,5,1111,23.0,843.0,843.0
0.004,6,10,1774,5,923,1.0,655.0,655.0,5,851,1.0,583.0,583.0
376.307,6,22,2313,16,867,25087.0,195.0,195.0,6,1446,4645.0,419.0,398.0
0.005,6,10,2006,5,927,1.0,659.0,659.0,5,1079,1.0,811.0,811.0
0.004,17,4,284,2,120,0.0,32.0,32.0,2,164,1.0,60.0,54.0
0.003,17,2,136,1,60,0.0,32.0,32.0,1,76,0.0,48.0,48.0
0.005,6,10,2006,5,927,1.0,659.0,659.0,5,1079,1.0,811.0,811.0
10.739,17,28,4422,14,1995,817.0,270.0,114.0,14,2427,817.0,586.0,145.0
0.013,6,10,1989,5,910,3.0,642.0,642.0,5,1079,3.0,811.0,811.0
0.066,6,10,1506,5,395,14.0,127.0,127.0,5,1111,15.0,843.0,843.0
15.073,17,15,9238,8,6902,2149.0,1350.0,834.0,7,2336,2507.0,1350.0,305.0
0.105,6,10,1506,5,395,22.0,127.0,127.0,5,1111,24.0,843.0,843.0
0.02,6,10,1990,5,911,4.0,643.0,643.0,5,1079,5.0,811.0,811.0
0.001,17,2,180,1,66,0.0,38.0,38.0,1,114,0.0,86.0,86.0
0.133,17,4,284,2,120,1.0,32.0,32.0,2,164,129.0,60.0,54.0
300.358,6,16,2170,9,684,37524.0,146.0,146.0,7,1486,50032.0,419.0,398.0
0.004,17,2,148,1,60,0.0,32.0,32.0,1,88,0.0,60.0,60.0
0.001,17,2,180,1,66,0.0,38.0,38.0,1,114,0.0,86.0,86.0
0.005,6,14,3736,7,446,0.0,74.0,74.0,7,3290,0.0,1448.0,972.0
0.013,6,10,1989,5,910,3.0,642.0,642.0,5,1079,3.0,811.0,811.0
0.009,6,10,1677,5,827,2.0,559.0,559.0,5,850,2.0,582.0,582.0
0.013,6,10,1677,5,827,3.0,559.0,559.0,5,850,3.0,582.0,582.0
1778.427,17,144,45504,72,22752,25048.0,288.0,288.0,72,22752,25048.0,288.0,288.0
0.004,6,10,1702,5,863,1.0,595.0,595.0,5,839,1.0,571.0,571.0
0.003,17,2,148,1,60,0.0,32.0,32.0,1,88,0.0,60.0,60.0
240.794,6,36,10753,17,2159,15043.0,555.0,253.0,19,8594,13372.0,1402.0,585.0
0.395,17,47,27189,25,23400,16.0,1350.0,908.0,22,3789,15.0,1350.0,144.0
15.075,17,19,8561,9,6079,1880.0,1350.0,647.0,10,2482,1671.0,1350.0,220.0
240.009,6,9,787,5,488,60002.0,232.0,232.0,4,299,80002.0,83.0,83.0
0.008,6,10,1989,5,910,1.0,642.0,642.0,5,1079,2.0,811.0,811.0
0.004,17,4,284,2,120,1.0,32.0,32.0,2,164,0.0,60.0,54.0
0.072,17,2,184,1,61,0.0,33.0,33.0,1,123,0.0,95.0,95.0
0.009,6,10,1677,5,827,2.0,559.0,559.0,5,850,2.0,582.0,582.0
0.005,6,10,1854,5,889,1.0,621.0,621.0,5,965,1.0,697.0,697.0
0.001,17,2,136,1,60,0.0,32.0,32.0,1,76,0.0,48.0,48.0
0.013,17,2,152,1,56,0.0,28.0,28.0,1,96,0.0,68.0,68.0
15.077,17,14,9190,8,6902,2149.0,1350.0,834.0,6,2288,3009.0,1350.0,353.0
0.082,6,10,1506,5,395,19.0,127.0,127.0,5,1111,18.0,843.0,843.0
0.004,17,4,284,2,120,1.0,32.0,32.0,2,164,0.0,60.0,54.0
0.018,6,10,1990,5,911,4.0,643.0,643.0,5,1079,4.0,811.0,811.0
0.009,6,10,1762,5,911,2.0,643.0,643.0,5,851,2.0,583.0,583.0
308.437,17,20,1124,10,716,34255.0,48.0,43.0,10,408,34255.0,20.0,12.0
0.01,6,10,1983,5,910,2.0,642.0,642.0,5,1073,2.0,805.0,805.0
0.004,6,10,1702,5,863,1.0,595.0,595.0,5,839,1.0,571.0,571.0
0.014,6,10,1677,5,827,3.0,559.0,559.0,5,850,3.0,582.0,582.0
0.004,17,2,148,1,60,0.0,32.0,32.0,1,88,0.0,60.0,60.0
0.044,17,4,284,2,120,1.0,32.0,32.0,2,164,37.0,60.0,54.0
0.043,17,2,148,1,60,0.0,32.0,32.0,1,88,0.0,60.0,60.0
0.001,17,2,180,1,66,0.0,38.0,38.0,1,114,0.0,86.0,86.0
0.005,6,10,1643,5,860,1.0,592.0,592.0,5,783,1.0,515.0,515.0
0.038,17,2,184,1,61,0.0,33.0,33.0,1,123,0.0,95.0,95.0
0.042,17,2,152,1,76,0.0,48.0,48.0,1,76,0.0,48.0,48.0
40.064,17,10,676,5,460,10015.0,104.0,64.0,5,216,10015.0,20.0,15.0
0.001,17,2,180,1,66,0.0,38.0,38.0,1,114,0.0,86.0,86.0
313.742,17,20,1124,10,716,34846.0,48.0,43.0,10,408,34845.0,20.0,12.0
0.005,6,10,2000,5,927,1.0,659.0,659.0,5,1073,1.0,805.0,805.0
0.005,6,10,1779,5,928,1.0,660.0,660.0,5,851,1.0,583.0,583.0
0.001,17,2,180,1,66,0.0,38.0,38.0,1,114,0.0,86.0,86.0
0.001,17,2,179,1,62,0.0,34.0,34.0,1,117,0.0,89.0,89.0
0.182,6,10,1506,5,395,44.0,127.0,127.0,5,1111,40.0,843.0,843.0
40.069,17,10,676,5,460,10014.0,104.0,64.0,5,216,10016.0,20.0,15.0
0.004,6,10,2006,5,927,1.0,659.0,659.0,5,1079,1.0,811.0,811.0
0.006,6,10,1689,5,839,1.0,571.0,571.0,5,850,1.0,582.0,582.0
0.013,6,10,1989,5,910,3.0,642.0,642.0,5,1079,3.0,811.0,811.0
0.003,17,2,148,1,60,0.0,32.0,32.0,1,88,0.0,60.0,60.0
0.007,6,10,1547,5,764,1.0,496.0,496.0,5,783,1.0,515.0,515.0
0.011,6,10,1605,5,388,2.0,120.0,120.0,5,1217,2.0,949.0,949.0
0.313,6,19,3543,9,1594,33.0,533.0,279.0,10,1949,30.0,529.0,284.0
30.074,6,26,5923,14,1888,2313.0,517.0,260.0,12,4035,2733.0,1330.0,590.0
0.083,6,10,1506,5,395,18.0,127.0,127.0,5,1111,19.0,843.0,843.0
0.005,6,13,3690,7,452,0.0,80.0,80.0,6,3238,1.0,1470.0,1459.0
0.07,6,10,1506,5,395,15.0,127.0,127.0,5,1111,16.0,843.0,843.0
0.015,6,13,3913,7,495,2.0,123.0,123.0,6,3418,3.0,1650.0,1549.0
1.218,6,32,13392,18,5893,71.0,2074.0,854.0,14,7499,79.0,2720.0,769.0
0.001,17,2,136,1,60,0.0,32.0,32.0,1,76,0.0,48.0,48.0
0.013,6,10,1990,5,911,3.0,643.0,643.0,5,1079,3.0,811.0,811.0
40.057,17,10,676,5,460,10013.0,104.0,64.0,5,216,10013.0,20.0,15.0
0.103,6,10,1506,5,395,18.0,127.0,127.0,5,1111,24.0,843.0,843.0
40.081,17,10,676,5,460,10018.0,104.0,64.0,5,216,10018.0,20.0,15.0
0.08,6,10,1506,5,395,18.0,127.0,127.0,5,1111,17.0,843.0,843.0
40.062,17,10,676,5,460,10013.0,104.0,64.0,5,216,10014.0,20.0,15.0
0.128,17,2,80,1,32,0.0,4.0,4.0,1,48,0.0,20.0,20.0
11.081,17,28,4416,14,1993,840.0,268.0,114.0,14,2423,840.0,586.0,145.0
0.006,6,10,1547,5,764,1.0,496.0,496.0,5,783,1.0,515.0,515.0
0.006,6,10,1547,5,764,1.0,496.0,496.0,5,783,1.0,515.0,515.0
40.077,17,10,676,5,460,10018.0,104.0,64.0,5,216,10018.0,20.0,15.0
0.003,17,2,148,1,60,0.0,32.0,32.0,1,88,0.0,60.0,60.0
0.005,6,10,1774,5,923,1.0,655.0,655.0,5,851,1.0,583.0,583.0
0.007,6,10,1702,5,863,1.0,595.0,595.0,5,839,1.0,571.0,571.0
0.109,6,10,1506,5,395,23.0,127.0,127.0,5,1111,24.0,843.0,843.0
40.061,17,10,676,5,460,10014.0,104.0,64.0,5,216,10014.0,20.0,15.0
0.006,6,10,1547,5,764,1.0,496.0,496.0,5,783,1.0,515.0,515.0
0.003,6,10,1702,5,863,0.0,595.0,595.0,5,839,0.0,571.0,571.0
0.004,6,10,2000,5,927,1.0,659.0,659.0,5,1073,1.0,805.0,805.0
0.069,6,10,1506,5,395,15.0,127.0,127.0,5,1111,14.0,843.0,843.0
0.005,6,10,1547,5,764,1.0,496.0,496.0,5,783,1.0,515.0,515.0
0.016,6,10,1972,5,910,4.0,642.0,642.0,5,1062,4.0,794.0,794.0
0.085,6,10,1506,5,395,19.0,127.0,127.0,5,1111,18.0,843.0,843.0
0.006,6,10,1547,5,764,1.0,496.0,496.0,5,783,1.0,515.0,515.0
0.122,6,10,1506,5,395,28.0,127.0,127.0,5,1111,26.0,843.0,843.0
0.004,6,10,1774,5,923,1.0,655.0,655.0,5,851,1.0,583.0,583.0
0.075,6,10,1506,5,395,15.0,127.0,127.0,5,1111,16.0,843.0,843.0
0.015,6,10,1989,5,910,3.0,642.0,642.0,5,1079,3.0,811.0,811.0
0.006,6,10,1689,5,839,1.0,571.0,571.0,5,850,1.0,582.0,582.0
0.013,6,10,1972,5,910,3.0,642.0,642.0,5,1062,3.0,794.0,794.0
0.009,6,10,1972,5,910,2.0,642.0,642.0,5,1062,2.0,794.0,794.0
0.02,6,10,1989,5,910,4.0,642.0,642.0,5,1079,4.0,811.0,811.0
0.073,6,10,1506,5,395,15.0,127.0,127.0,5,1111,16.0,843.0,843.0
0.009,6,10,1989,5,910,2.0,642.0,642.0,5,1079,2.0,811.0,811.0
0.005,6,10,2006,5,927,1.0,659.0,659.0,5,1079,1.0,811.0,811.0
15.072,17,15,9238,8,6902,2149.0,1350.0,834.0,7,2336,2507.0,1350.0,305.0
0.005,17,2,166,1,75,0.0,47.0,47.0,1,91,0.0,63.0,63.0
40.052,17,10,676,5,460,10012.0,104.0,64.0,5,216,10012.0,20.0,15.0
0.001,17,2,179,1,62,0.0,34.0,34.0,1,117,0.0,89.0,89.0
0.005,6,10,2006,5,927,1.0,659.0,659.0,5,1079,1.0,811.0,811.0
240.131,6,46,7031,23,3279,10914.0,588.0,230.0,23,3752,10914.0,580.0,254.0
0.005,17,2,170,1,65,0.0,37.0,37.0,1,105,0.0,77.0,77.0
0.004,17,2,160,1,72,0.0,44.0,44.0,1,88,0.0,60.0,60.0
0.691,6,24,5956,12,1900,61.0,821.0,317.0,12,4056,61.0,1402.0,570.0
0.008,6,10,1989,5,910,2.0,642.0,642.0,5,1079,1.0,811.0,811.0
0.005,6,10,2006,5,927,1.0,659.0,659.0,5,1079,1.0,811.0,811.0
9.037,17,6,376,5,280,2259.0,28.0,28.0,1,96,0.0,68.0,68.0
0.005,6,10,2006,5,927,1.0,659.0,659.0,5,1079,1.0,811.0,811.0
0.021,6,10,1989,5,910,5.0,642.0,642.0,5,1079,5.0,811.0,811.0
0.071,17,4,284,2,120,0.0,32.0,32.0,2,164,67.0,60.0,54.0
0.005,6,14,3736,7,446,0.0,74.0,74.0,7,3290,0.0,1448.0,972.0
0.015,6,10,1989,5,910,3.0,642.0,642.0,5,1079,3.0,811.0,811.0
310.628,17,20,1124,10,716,34500.0,48.0,43.0,10,408,34499.0,20.0,12.0
10.82,17,28,4421,14,1993,823.0,268.0,114.0,14,2428,823.0,587.0,145.0
40.06,17,10,676,5,460,10014.0,104.0,64.0,5,216,10014.0,20.0,15.0
0.137,6,10,1506,5,395,24.0,127.0,127.0,5,1111,31.0,843.0,843.0
0.005,6,10,1643,5,860,1.0,592.0,592.0,5,783,1.0,515.0,515.0
0.09,6,10,1506,5,395,19.0,127.0,127.0,5,1111,19.0,843.0,843.0
240.083,6,16,4480,9,963,30010.0,238.0,166.0,7,3517,40013.0,1402.0,786.0
0.005,17,2,194,1,59,0.0,31.0,31.0,1,135,0.0,107.0,107.0
0.005,6,10,1989,5,927,1.0,659.0,659.0,5,1062,1.0,794.0,794.0
1729.217,6,60,4400,40,2740,44338.0,33.0,33.0,20,1660,91002.0,31.0,31.0
0.004,6,10,2000,5,927,1.0,659.0,659.0,5,1073,1.0,805.0,805.0
0.002,17,2,174,1,72,0.0,44.0,44.0,1,102,0.0,74.0,74.0
0.126,17,4,284,2,120,0.0,32.0,32.0,2,164,86.0,60.0,54.0
0.077,6,10,1506,5,395,17.0,127.0,127.0,5,1111,17.0,843.0,843.0
0.037,17,4,364,2,160,0.0,52.0,52.0,2,204,0.0,80.0,74.0
0.006,17,2,230,1,68,0.0,40.0,40.0,1,162,0.0,134.0,134.0
0.005,6,10,2006,5,927,1.0,659.0,659.0,5,1079,1.0,811.0,811.0
0.078,6,10,1506,5,395,16.0,127.0,127.0,5,1111,17.0,843.0,843.0
0.011,6,10,1972,5,910,2.0,642.0,642.0,5,1062,2.0,794.0,794.0
0.004,17,2,148,1,60,0.0,32.0,32.0,1,88,0.0,60.0,60.0
40.064,17,10,676,5,460,10012.0,104.0,64.0,5,216,10014.0,20.0,15.0
0.006,6,10,1643,5,860,1.0,592.0,592.0,5,783,1.0,515.0,515.0
0.004,17,4,284,2,120,1.0,32.0,32.0,2,164,0.0,60.0,54.0
353.288,6,20,2210,6,1308,12003.0,494.0,494.0,14,902,27175.0,83.0,83.0
0.009,17,2,148,1,60,0.0,32.0,32.0,1,88,0.0,60.0,60.0
0.008,17,2,194,1,59,0.0,31.0,31.0,1,135,0.0,107.0,107.0
0.118,6,10,1506,5,395,28.0,127.0,127.0,5,1111,27.0,843.0,843.0
0.005,17,2,170,1,65,0.0,37.0,37.0,1,105,0.0,77.0,77.0
40.057,17,10,676,5,460,10013.0,104.0,64.0,5,216,10013.0,20.0,15.0
0.007,17,2,412,1,61,0.0,33.0,33.0,1,351,0.0,323.0,323.0
0.005,6,14,3742,7,452,0.0,80.0,80.0,7,3290,0.0,1448.0,972.0
0.01,6,10,1989,5,910,2.0,642.0,642.0,5,1079,2.0,811.0,811.0
0.008,6,10,1972,5,910,1.0,642.0,642.0,5,1062,1.0,794.0,794.0
0.108,6,10,1506,5,395,25.0,127.0,127.0,5,1111,23.0,843.0,843.0
0.013,6,10,1762,5,911,3.0,643.0,643.0,5,851,3.0,583.0,583.0
0.124,6,10,1506,5,395,30.0,127.0,127.0,5,1111,29.0,843.0,843.0
0.116,17,2,182,1,72,0.0,44.0,44.0,1,110,0.0,82.0,82.0
0.224,6,10,1506,5,395,40.0,127.0,127.0,5,1111,46.0,843.0,843.0
0.005,6,10,2006,5,927,1.0,659.0,659.0,5,1079,1.0,811.0,811.0
0.005,17,4,284,2,120,0.0,32.0,32.0,2,164,1.0,60.0,54.0
0.007,17,2,179,1,71,0.0,43.0,43.0,1,108,0.0,80.0,80.0
0.012,6,10,1989,5,910,2.0,642.0,642.0,5,1079,3.0,811.0,811.0
0.11,6,10,1506,5,395,24.0,127.0,127.0,5,1111,24.0,843.0,843.0
0.089,6,10,1506,5,395,19.0,127.0,127.0,5,1111,21.0,843.0,843.0
0.011,6,10,1972,5,910,2.0,642.0,642.0,5,1062,2.0,794.0,794.0
0.115,6,10,1506,5,395,25.0,127.0,127.0,5,1111,25.0,843.0,843.0
0.004,17,2,136,1,60,0.0,32.0,32.0,1,76,0.0,48.0,48.0
0.005,17,2,178,1,81,0.0,53.0,53.0,1,97,0.0,69.0,69.0
0.005,6,10,1702,5,863,1.0,595.0,595.0,5,839,1.0,571.0,571.0
0.3,17,19,11797,9,7800,37.0,1350.0,838.0,10,3997,27.0,1350.0,371.0
310.392,17,20,1124,10,716,34473.0,48.0,43.0,10,408,34473.0,20.0,12.0
0.005,6,10,1689,5,839,1.0,571.0,571.0,5,850,1.0,582.0,582.0
0.135,6,10,1506,5,395,33.0,127.0,127.0,5,1111,32.0,843.0,843.0
0.223,6,16,2669,8,1395,31.0,533.0,323.0,8,1274,20.0,529.0,212.0
0.004,6,10,2007,5,928,1.0,660.0,660.0,5,1079,1.0,811.0,811.0
0.09,6,10,1506,5,395,20.0,127.0,127.0,5,1111,17.0,843.0,843.0
0.012,6,10,1972,5,910,3.0,642.0,642.0,5,1062,3.0,794.0,794.0
0.013,6,10,1990,5,911,3.0,643.0,643.0,5,1079,3.0,811.0,811.0
0.014,6,10,1677,5,827,3.0,559.0,559.0,5,850,3.0,582.0,582.0
0.004,6,10,2006,5,927,1.0,659.0,659.0,5,1079,1.0,811.0,811.0
2.523,6,25,6041,14,2100,194.0,517.0,303.0,11,3941,241.0,1360.0,697.0
40.068,17,10,676,5,460,10015.0,104.0,64.0,5,216,10016.0,20.0,15.0
0.004,17,4,284,2,120,1.0,32.0,32.0,2,164,0.0,60.0,54.0
0.108,6,10,1506,5,395,23.0,127.0,127.0,5,1111,25.0,843.0,843.0
0.224,6,16,2669,8,1395,32.0,533.0,323.0,8,1274,20.0,529.0,212.0
0.003,17,2,148,1,60,0.0,32.0,32.0,1,88,0.0,60.0,60.0
0.004,6,10,2000,5,927,1.0,659.0,659.0,5,1073,1.0,805.0,805.0
40.077,17,10,676,5,460,10018.0,104.0,64.0,5,216,10018.0,20.0,15.0
0.045,17,2,255,1,82,0.0,54.0,54.0,1,173,0.0,145.0,145.0
0.094,6,10,1506,5,395,21.0,127.0,127.0,5,1111,19.0,843.0,843.0
65.777,6,44,14885,22,8978,428.0,1834.0,1152.0,22,5907,3124.0,2667.0,385.0
0.005,6,10,2007,5,928,1.0,660.0,660.0,5,1079,1.0,811.0,811.0
0.005,6,10,2006,5,927,1.0,659.0,659.0,5,1079,1.0,811.0,811.0
35.639,6,41,15313,21,9715,451.0,2720.0,1263.0,20,5598,1866.0,2667.0,435.0
0.013,17,2,152,1,56,0.0,28.0,28.0,1,96,0.0,68.0,68.0
8.257,6,36,9557,19,4079,458.0,2903.0,821.0,17,5478,504.0,2667.0,435.0
0.108,6,10,1506,5,395,26.0,127.0,127.0,5,1111,26.0,843.0,843.0
0.003,17,2,136,1,60,0.0,32.0,32.0,1,76,0.0,48.0,48.0
0.107,6,10,1506,5,395,24.0,127.0,127.0,5,1111,25.0,843.0,843.0
0.009,6,10,1989,5,910,2.0,642.0,642.0,5,1079,2.0,811.0,811.0
0.004,6,10,2000,5,927,1.0,659.0,659.0,5,1073,1.0,805.0,805.0
0.019,6,10,1989,5,910,4.0,642.0,642.0,5,1079,4.0,811.0,811.0
0.005,6,10,2007,5,928,1.0,660.0,660.0,5,1079,1.0,811.0,811.0
0.004,6,10,1774,5,923,1.0,655.0,655.0,5,851,1.0,583.0,583.0
0.04,17,2,152,1,76,0.0,48.0,48.0,1,76,0.0,48.0,48.0
0.201,6,19,6396,9,1452,25.0,533.0,325.0,10,4944,16.0,1402.0,736.0
15.1,17,15,8414,8,6345,2153.0,1350.0,765.0,7,2069,2511.0,1350.0,267.0
312.124,17,20,1124,10,716,34666.0,48.0,43.0,10,408,34666.0,20.0,12.0
0.006,6,10,1689,5,839,1.0,571.0,571.0,5,850,1.0,582.0,582.0
1.381,6,32,13392,18,5893,81.0,2720.0,854.0,14,7499,92.0,2720.0,769.0
0.021,6,10,1989,5,910,5.0,642.0,642.0,5,1079,5.0,811.0,811.0
11.185,17,28,4418,14,1993,847.0,268.0,114.0,14,2425,847.0,588.0,145.0
0.176,17,16,8897,7,6371,29.0,1350.0,882.0,9,2526,17.0,1350.0,252.0
0.012,6,10,1983,5,910,2.0,642.0,642.0,5,1073,2.0,805.0,805.0
0.004,6,10,2000,5,927,1.0,659.0,659.0,5,1073,1.0,805.0,805.0
0.006,17,2,214,1,75,0.0,47.0,47.0,1,139,0.0,111.0,111.0
0.015,6,10,1989,5,910,3.0,642.0,642.0,5,1079,3.0,811.0,811.0
0.013,6,10,1983,5,910,3.0,642.0,642.0,5,1073,3.0,805.0,805.0
301.22,6,50,19474,26,13487,12048.0,3098.0,1241.0,24,5987,392.0,2667.0,385.0
0.005,6,10,2000,5,927,1.0,659.0,659.0,5,1073,1.0,805.0,805.0
0.016,6,10,1989,5,910,4.0,642.0,642.0,5,1079,4.0,811.0,811.0
0.005,6,10,2000,5,927,1.0,659.0,659.0,5,1073,1.0,805.0,805.0
0.004,6,10,2007,5,928,1.0,660.0,660.0,5,1079,1.0,811.0,811.0
15.089,17,15,9239,8,6902,2149.0,1350.0,834.0,7,2337,2510.0,1350.0,305.0
0.006,6,10,1689,5,839,1.0,571.0,571.0,5,850,1.0,582.0,582.0
0.015,6,14,3787,7,497,2.0,125.0,125.0,7,3290,2.0,1448.0,972.0
0.001,17,2,136,1,60,0.0,32.0,32.0,1,76,0.0,48.0,48.0
0.014,6,10,1989,5,910,3.0,642.0,642.0,5,1079,3.0,811.0,811.0
0.005,17,2,152,1,68,0.0,40.0,40.0,1,84,0.0,56.0,56.0
300.337,6,16,2170,9,684,37521.0,146.0,146.0,7,1486,50028.0,419.0,398.0
295.119,6,417,349075,200,21962,1483.0,2736.0,888.0,217,327113,1366.0,2804.0,1555.0
0.005,6,10,1854,5,889,1.0,621.0,621.0,5,965,1.0,697.0,697.0
40.065,17,10,676,5,460,10013.0,104.0,64.0,5,216,10015.0,20.0,15.0
240.133,6,48,7030,24,3336,10440.0,588.0,229.0,24,3694,10440.0,580.0,221.0
0.01,6,10,1990,5,911,2.0,643.0,643.0,5,1079,2.0,811.0,811.0
0.005,6,10,1689,5,839,1.0,571.0,571.0,5,850,1.0,582.0,582.0
0.006,6,10,2007,5,928,1.0,660.0,660.0,5,1079,1.0,811.0,811.0
0.077,17,8,3613,4,1874,25.0,1350.0,440.0,4,1739,11.0,1350.0,406.0
40.062,17,10,676,5,460,10013.0,104.0,64.0,5,216,10014.0,20.0,15.0
0.001,17,2,180,1,66,0.0,38.0,38.0,1,114,0.0,86.0,86.0
0.071,17,4,352,2,130,3.0,37.0,37.0,2,222,28.0,89.0,83.0
1772.871,6,296,97056,182,86057,9794.0,2001.0,702.0,114,10999,15689.0,452.0,70.0
40.052,17,10,676,5,460,10012.0,104.0,64.0,5,216,10012.0,20.0,15.0
0.005,17,2,179,1,71,0.0,43.0,43.0,1,108,0.0,80.0,80.0
0.001,17,2,180,1,66,0.0,38.0,38.0,1,114,0.0,86.0,86.0
0.04,17,2,136,1,60,0.0,32.0,32.0,1,76,0.0,48.0,48.0
0.011,6,10,1972,5,910,2.0,642.0,642.0,5,1062,2.0,794.0,794.0
0.005,17,2,144,1,64,0.0,36.0,36.0,1,80,0.0,52.0,52.0
280.648,6,26,6520,12,1266,25513.0,267.0,156.0,14,5254,21587.0,1400.0,781.0
0.006,17,2,166,1,75,0.0,47.0,47.0,1,91,0.0,63.0,63.0
0.004,6,10,1702,5,863,1.0,595.0,595.0,5,839,0.0,571.0,571.0
0.004,6,10,1702,5,863,1.0,595.0,595.0,5,839,1.0,571.0,571.0
0.012,6,10,1983,5,910,2.0,642.0,642.0,5,1073,2.0,805.0,805.0
0.005,6,10,1989,5,927,1.0,659.0,659.0,5,1062,1.0,794.0,794.0
0.005,6,10,1854,5,889,1.0,621.0,621.0,5,965,1.0,697.0,697.0
0.005,6,10,2006,5,927,1.0,659.0,659.0,5,1079,1.0,811.0,811.0
0.009,6,10,1762,5,911,2.0,643.0,643.0,5,851,2.0,583.0,583.0
0.005,6,10,1854,5,889,1.0,621.0,621.0,5,965,1.0,697.0,697.0
0.114,6,10,1506,5,395,23.0,127.0,127.0,5,1111,25.0,843.0,843.0
0.005,6,10,2006,5,927,1.0,659.0,659.0,5,1079,1.0,811.0,811.0
0.005,6,10,2006,5,927,1.0,659.0,659.0,5,1079,1.0,811.0,811.0
0.005,6,10,2006,5,927,1.0,659.0,659.0,5,1079,1.0,811.0,811.0
0.009,6,10,1972,5,910,2.0,642.0,642.0,5,1062,2.0,794.0,794.0
1791.866,6,86,5325,43,2308,42662.0,36.0,36.0,43,3017,42662.0,432.0,390.0
0.006,17,2,178,1,65,0.0,37.0,37.0,1,113,0.0,85.0,85.0
0.075,6,10,1506,5,395,16.0,127.0,127.0,5,1111,15.0,843.0,843.0
0.037,17,2,136,1,60,0.0,32.0,32.0,1,76,0.0,48.0,48.0
0.005,17,2,180,1,58,0.0,30.0,30.0,1,122,0.0,94.0,94.0
0.334,17,44,25641,24,19859,14.0,1350.0,799.0,20,5782,14.0,1350.0,261.0
0.037,17,2,148,1,60,0.0,32.0,32.0,1,88,0.0,60.0,60.0
0.005,6,10,2007,5,928,1.0,660.0,660.0,5,1079,1.0,811.0,811.0
0.006,17,2,179,1,71,0.0,43.0,43.0,1,108,0.0,80.0,80.0
0.006,6,10,1547,5,764,1.0,496.0,496.0,5,783,1.0,515.0,515.0
0.005,6,10,2006,5,927,1.0,659.0,659.0,5,1079,1.0,811.0,811.0
0.005,6,10,2007,5,928,1.0,660.0,660.0,5,1079,1.0,811.0,811.0
0.005,6,10,1989,5,927,1.0,659.0,659.0,5,1062,1.0,794.0,794.0
0.229,6,16,2669,8,1395,32.0,533.0,323.0,8,1274,21.0,529.0,212.0
240.012,6,9,787,5,488,60003.0,232.0,232.0,4,299,80003.0,83.0,83.0
240.106,6,16,4481,9,963,30013.0,238.0,166.0,7,3518,40017.0,1402.0,786.0
0.011,6,10,1990,5,911,2.0,643.0,643.0,5,1079,2.0,811.0,811.0
0.004,6,10,1774,5,923,1.0,655.0,655.0,5,851,1.0,583.0,583.0
40.067,17,10,676,5,460,10014.0,104.0,64.0,5,216,10016.0,20.0,15.0
361.768,6,21,1792,16,1030,24117.0,190.0,190.0,5,762,60009.0,461.0,247.0
0.011,6,10,1762,5,911,2.0,643.0,643.0,5,851,2.0,583.0,583.0
242.248,6,395,348297,197,21769,1235.0,2736.0,959.0,198,326528,1229.0,2804.0,1682.0
0.022,6,10,1989,5,910,5.0,642.0,642.0,5,1079,5.0,811.0,811.0
0.007,6,10,1702,5,863,1.0,595.0,595.0,5,839,1.0,571.0,571.0
11.149,17,28,4398,14,2312,848.0,587.0,137.0,14,2086,848.0,269.0,121.0
0.005,17,2,230,1,68,0.0,40.0,40.0,1,162,0.0,134.0,134.0
40.054,17,10,676,5,460,10012.0,104.0,64.0,5,216,10012.0,20.0,15.0
0.013,17,2,152,1,76,0.0,48.0,48.0,1,76,0.0,48.0,48.0
0.016,6,10,1990,5,911,4.0,643.0,643.0,5,1079,3.0,811.0,811.0
0.116,6,10,1506,5,395,23.0,127.0,127.0,5,1111,27.0,843.0,843.0
0.064,6,10,1506,5,395,13.0,127.0,127.0,5,1111,14.0,843.0,843.0
0.005,17,2,214,1,75,0.0,47.0,47.0,1,139,0.0,111.0,111.0
0.009,17,2,170,1,65,0.0,37.0,37.0,1,105,0.0,77.0,77.0
40.07,17,10,676,5,460,10016.0,104.0,64.0,5,216,10015.0,20.0,15.0
0.001,17,2,166,1,75,0.0,47.0,47.0,1,91,0.0,63.0,63.0
0.004,6,10,1779,5,928,1.0,660.0,660.0,5,851,1.0,583.0,583.0
0.232,6,16,2777,8,1395,33.0,533.0,323.0,8,1382,21.0,529.0,239.0
0.043,6,10,1983,5,910,10.0,642.0,642.0,5,1073,10.0,805.0,805.0
0.004,17,4,284,2,120,0.0,32.0,32.0,2,164,0.0,60.0,54.0
172.294,17,80,10985,40,2667,4417.0,44.0,38.0,40,8318,4417.0,252.0,179.0
0.005,6,10,2007,5,928,1.0,660.0,660.0,5,1079,1.0,811.0,811.0
168.333,17,82,11605,41,2732,4208.0,44.0,38.0,41,8873,4208.0,239.0,188.0
0.008,6,10,1972,5,910,2.0,642.0,642.0,5,1062,2.0,794.0,794.0
0.006,6,10,1547,5,764,1.0,496.0,496.0,5,783,1.0,515.0,515.0
0.037,17,2,156,1,64,0.0,36.0,36.0,1,92,0.0,64.0,64.0
0.122,6,10,1506,5,395,25.0,127.0,127.0,5,1111,26.0,843.0,843.0
0.005,6,10,2006,5,927,1.0,659.0,659.0,5,1079,1.0,811.0,811.0
0.01,6,10,1972,5,910,2.0,642.0,642.0,5,1062,2.0,794.0,794.0
0.138,6,10,1506,5,395,32.0,127.0,127.0,5,1111,29.0,843.0,843.0
0.127,6,10,1506,5,395,29.0,127.0,127.0,5,1111,24.0,843.0,843.0
0.001,17,2,180,1,66,0.0,38.0,38.0,1,114,0.0,86.0,86.0
0.071,17,2,182,1,65,0.0,37.0,37.0,1,117,0.0,89.0,89.0
0.004,17,2,148,1,60,0.0,32.0,32.0,1,88,0.0,60.0,60.0
0.005,6,10,1643,5,860,1.0,592.0,592.0,5,783,1.0,515.0,515.0
0.005,6,10,2007,5,928,1.0,660.0,660.0,5,1079,1.0,811.0,811.0
0.005,6,10,1643,5,860,1.0,592.0,592.0,5,783,1.0,515.0,515.0
15.101,17,15,9239,8,6902,2151.0,1350.0,834.0,7,2337,2510.0,1350.0,305.0
0.005,6,10,1989,5,927,1.0,659.0,659.0,5,1062,1.0,794.0,794.0
15.078,17,16,8486,8,6414,2150.0,1350.0,773.0,8,2072,2149.0,1350.0,231.0
0.125,6,10,1506,5,395,29.0,127.0,127.0,5,1111,29.0,843.0,843.0
0.003,17,2,152,1,76,0.0,48.0,48.0,1,76,0.0,48.0,48.0
0.07,6,10,1506,5,395,15.0,127.0,127.0,5,1111,16.0,843.0,843.0
0.101,6,10,1506,5,395,23.0,127.0,127.0,5,1111,22.0,843.0,843.0
0.014,6,10,1989,5,910,3.0,642.0,642.0,5,1079,3.0,811.0,811.0
0.037,17,2,148,1,60,0.0,32.0,32.0,1,88,0.0,60.0,60.0
0.005,6,10,2000,5,927,1.0,659.0,659.0,5,1073,1.0,805.0,805.0
0.101,6,10,1506,5,395,22.0,127.0,127.0,5,1111,25.0,843.0,843.0
0.006,17,2,230,1,68,0.0,40.0,40.0,1,162,0.0,134.0,134.0
240.24,6,30,12451,15,6434,17160.0,1980.0,941.0,15,6017,17159.0,1655.0,747.0
0.17,6,3,453,2,321,170.0,241.0,241.0,1,132,0.0,92.0,92.0
178.483,17,88,12724,44,2960,4150.0,44.0,39.0,44,9764,4150.0,239.0,193.0
0.104,6,10,1506,5,395,24.0,127.0,127.0,5,1111,23.0,843.0,843.0
40.07,17,10,676,5,460,10015.0,104.0,64.0,5,216,10016.0,20.0,15.0
0.005,6,10,1689,5,839,1.0,571.0,571.0,5,850,1.0,582.0,582.0
0.008,6,10,1990,5,911,2.0,643.0,643.0,5,1079,2.0,811.0,811.0
0.015,6,10,1983,5,910,3.0,642.0,642.0,5,1073,3.0,805.0,805.0
0.018,6,10,1983,5,910,4.0,642.0,642.0,5,1073,4.0,805.0,805.0
0.075,6,10,1506,5,395,17.0,127.0,127.0,5,1111,17.0,843.0,843.0
1770.417,17,92,8096,46,4048,39342.0,60.0,60.0,46,4048,39342.0,60.0,60.0
0.005,6,10,2007,5,928,1.0,660.0,660.0,5,1079,1.0,811.0,811.0
0.003,17,2,136,1,60,0.0,32.0,32.0,1,76,0.0,48.0,48.0
0.147,17,4,352,2,130,108.0,37.0,37.0,2,222,144.0,89.0,83.0
0.013,6,10,1631,5,848,3.0,580.0,580.0,5,783,3.0,515.0,515.0
0.012,6,10,1972,5,910,3.0,642.0,642.0,5,1062,2.0,794.0,794.0
0.025,6,10,1631,5,848,6.0,580.0,580.0,5,783,6.0,515.0,515.0
0.075,6,10,1506,5,395,16.0,127.0,127.0,5,1111,15.0,843.0,843.0
0.073,6,10,1506,5,395,17.0,127.0,127.0,5,1111,15.0,843.0,843.0
0.04,17,2,234,1,61,0.0,33.0,33.0,1,173,0.0,145.0,145.0
0.049,17,4,596,2,122,8.0,33.0,33.0,2,474,44.0,323.0,209.0
0.797,6,10,2009,6,1655,159.0,1403.0,1403.0,4,354,187.0,182.0,182.0
0.001,17,2,180,1,66,0.0,38.0,38.0,1,114,0.0,86.0,86.0
0.004,6,10,2007,5,928,1.0,660.0,660.0,5,1079,1.0,811.0,811.0
0.039,17,2,166,1,75,0.0,47.0,47.0,1,91,0.0,63.0,63.0
0.012,6,10,1989,5,910,2.0,642.0,642.0,5,1079,2.0,811.0,811.0
0.005,6,10,1989,5,927,1.0,659.0,659.0,5,1062,1.0,794.0,794.0
0.011,6,10,1983,5,910,2.0,642.0,642.0,5,1073,2.0,805.0,805.0
0.01,6,10,1989,5,910,2.0,642.0,642.0,5,1079,2.0,811.0,811.0
0.065,6,10,1506,5,395,14.0,127.0,127.0,5,1111,14.0,843.0,843.0
1760.834,6,440,65030,254,35341,6959.0,613.0,195.0,186,29689,9517.0,453.0,141.0
0.008,17,2,194,1,59,0.0,31.0,31.0,1,135,0.0,107.0,107.0
0.006,17,2,214,1,75,0.0,47.0,47.0,1,139,0.0,111.0,111.0
0.009,6,10,1972,5,910,2.0,642.0,642.0,5,1062,2.0,794.0,794.0
40.067,17,10,676,5,460,10012.0,104.0,64.0,5,216,10016.0,20.0,15.0
0.007,17,2,179,1,71,0.0,43.0,43.0,1,108,0.0,80.0,80.0
0.038,17,2,152,1,76,0.0,48.0,48.0,1,76,0.0,48.0,48.0
0.006,17,2,214,1,75,0.0,47.0,47.0,1,139,0.0,111.0,111.0
1768.94,17,92,8096,46,4048,39309.0,60.0,60.0,46,4048,39309.0,60.0,60.0
0.168,17,2,152,1,76,0.0,48.0,48.0,1,76,0.0,48.0,48.0
0.005,6,10,1689,5,839,1.0,571.0,571.0,5,850,1.0,582.0,582.0
0.202,6,10,1506,5,395,47.0,127.0,127.0,5,1111,40.0,843.0,843.0
0.007,6,10,1547,5,764,1.0,496.0,496.0,5,783,1.0,515.0,515.0
0.139,6,10,1506,5,395,31.0,127.0,127.0,5,1111,31.0,843.0,843.0
0.005,6,10,1689,5,839,1.0,571.0,571.0,5,850,1.0,582.0,582.0
0.042,17,2,412,1,61,0.0,33.0,33.0,1,351,0.0,323.0,323.0
0.137,6,10,1506,5,395,24.0,127.0,127.0,5,1111,27.0,843.0,843.0
0.044,17,2,213,1,69,0.0,41.0,41.0,1,144,0.0,116.0,116.0
240.685,6,34,9358,16,1836,16042.0,624.0,199.0,18,7522,14155.0,1402.0,549.0
0.008,6,10,1989,5,910,2.0,642.0,642.0,5,1079,2.0,811.0,811.0
0.008,6,12,1926,6,1189,1.0,659.0,434.0,6,737,1.0,417.0,417.0
0.003,17,2,185,1,73,0.0,45.0,45.0,1,112,0.0,84.0,84.0
0.006,17,2,148,1,60,0.0,32.0,32.0,1,88,0.0,60.0,60.0
0.092,6,10,1506,5,395,19.0,127.0,127.0,5,1111,18.0,843.0,843.0
0.007,6,10,2006,5,927,1.0,659.0,659.0,5,1079,1.0,811.0,811.0
0.005,17,2,170,1,65,0.0,37.0,37.0,1,105,0.0,77.0,77.0
0.008,6,10,1989,5,910,2.0,642.0,642.0,5,1079,1.0,811.0,811.0
0.005,6,10,2006,5,927,1.0,659.0,659.0,5,1079,1.0,811.0,811.0
40.077,17,10,676,5,460,10018.0,104.0,64.0,5,216,10018.0,20.0,15.0
0.097,6,10,1506,5,395,20.0,127.0,127.0,5,1111,20.0,843.0,843.0
0.005,6,10,2006,5,927,1.0,659.0,659.0,5,1079,1.0,811.0,811.0
0.006,6,10,1547,5,764,1.0,496.0,496.0,5,783,1.0,515.0,515.0
0.012,6,10,1989,5,910,3.0,642.0,642.0,5,1079,3.0,811.0,811.0
0.009,6,10,1972,5,910,2.0,642.0,642.0,5,1062,2.0,794.0,794.0
0.096,6,10,1506,5,395,21.0,127.0,127.0,5,1111,23.0,843.0,843.0
0.006,6,13,3684,7,446,0.0,74.0,74.0,6,3238,1.0,1470.0,1459.0
0.009,6,10,1631,5,848,2.0,580.0,580.0,5,783,2.0,515.0,515.0
0.004,6,10,2000,5,927,1.0,659.0,659.0,5,1073,1.0,805.0,805.0
0.079,6,10,1506,5,395,16.0,127.0,127.0,5,1111,18.0,843.0,843.0
0.005,6,10,2000,5,927,1.0,659.0,659.0,5,1073,1.0,805.0,805.0
0.006,6,10,1547,5,764,1.0,496.0,496.0,5,783,1.0,515.0,515.0
0.005,6,10,1689,5,839,1.0,571.0,571.0,5,850,1.0,582.0,582.0
0.143,6,10,1506,5,395,31.0,127.0,127.0,5,1111,30.0,843.0,843.0
0.015,6,10,1983,5,910,3.0,642.0,642.0,5,1073,3.0,805.0,805.0
40.084,17,10,676,5,460,10018.0,104.0,64.0,5,216,10020.0,20.0,15.0
0.004,17,2,148,1,60,0.0,32.0,32.0,1,88,0.0,60.0,60.0
0.004,6,10,1989,5,927,1.0,659.0,659.0,5,1062,1.0,794.0,794.0
0.006,17,2,170,1,65,0.0,37.0,37.0,1,105,0.0,77.0,77.0
0.003,17,2,148,1,60,0.0,32.0,32.0,1,88,0.0,60.0,60.0
0.025,6,10,1983,5,910,6.0,642.0,642.0,5,1073,6.0,805.0,805.0
40.067,17,10,676,5,460,10016.0,104.0,64.0,5,216,10016.0,20.0,15.0
0.001,17,2,136,1,60,0.0,32.0,32.0,1,76,0.0,48.0,48.0
0.085,6,10,1506,5,395,17.0,127.0,127.0,5,1111,17.0,843.0,843.0
0.005,6,10,1989,5,927,1.0,659.0,659.0,5,1062,1.0,794.0,794.0
0.014,6,10,1989,5,910,3.0,642.0,642.0,5,1079,3.0,811.0,811.0
0.005,6,13,3690,7,452,0.0,80.0,80.0,6,3238,0.0,1470.0,1459.0
0.011,6,10,1631,5,848,2.0,580.0,580.0,5,783,2.0,515.0,515.0
0.006,6,10,2006,5,927,1.0,659.0,659.0,5,1079,1.0,811.0,811.0
40.073,17,10,676,5,460,10015.0,104.0,64.0,5,216,10017.0,20.0,15.0
0.013,6,10,1989,5,910,3.0,642.0,642.0,5,1079,3.0,811.0,811.0
0.127,17,4,420,2,122,0.0,33.0,33.0,2,298,3.0,145.0,121.0
0.009,17,2,154,1,69,0.0,41.0,41.0,1,85,0.0,57.0,57.0
0.008,6,10,1989,5,910,2.0,642.0,642.0,5,1079,2.0,811.0,811.0
0.004,6,10,2007,5,928,1.0,660.0,660.0,5,1079,1.0,811.0,811.0
0.1,6,10,1506,5,395,23.0,127.0,127.0,5,1111,23.0,843.0,843.0
0.001,17,2,180,1,66,0.0,38.0,38.0,1,114,0.0,86.0,86.0
0.007,17,4,284,2,120,0.0,32.0,32.0,2,164,1.0,60.0,54.0
0.006,6,10,1547,5,764,1.0,496.0,496.0,5,783,1.0,515.0,515.0
0.006,6,10,1547,5,764,1.0,496.0,496.0,5,783,1.0,515.0,515.0
0.004,17,4,284,2,120,0.0,32.0,32.0,2,164,1.0,60.0,54.0
0.175,17,2,179,1,71,0.0,43.0,43.0,1,108,0.0,80.0,80.0
10.836,17,28,4421,14,1993,825.0,268.0,114.0,14,2428,825.0,587.0,145.0
0.005,6,10,1989,5,927,1.0,659.0,659.0,5,1062,1.0,794.0,794.0
0.012,6,10,1989,5,910,2.0,642.0,642.0,5,1079,2.0,811.0,811.0
0.012,6,10,1677,5,827,3.0,559.0,559.0,5,850,3.0,582.0,582.0
0.005,6,10,2006,5,927,1.0,659.0,659.0,5,1079,1.0,811.0,811.0
0.014,6,10,1990,5,911,3.0,643.0,643.0,5,1079,3.0,811.0,811.0
0.12,6,10,1506,5,395,24.0,127.0,127.0,5,1111,24.0,843.0,843.0
0.01,6,10,1677,5,827,2.0,559.0,559.0,5,850,2.0,582.0,582.0
0.015,6,10,1990,5,911,3.0,643.0,643.0,5,1079,3.0,811.0,811.0
0.013,6,10,1631,5,848,3.0,580.0,580.0,5,783,3.0,515.0,515.0
0.005,6,10,1779,5,928,1.0,660.0,660.0,5,851,1.0,583.0,583.0
15.069,17,15,9238,8,6902,2148.0,1350.0,834.0,7,2336,2506.0,1350.0,305.0
0.004,17,2,136,1,60,0.0,32.0,32.0,1,76,0.0,48.0,48.0
0.001,17,2,180,1,66,0.0,38.0,38.0,1,114,0.0,86.0,86.0
0.005,6,10,1989,5,927,1.0,659.0,659.0,5,1062,1.0,794.0,794.0
0.005,17,2,170,1,65,0.0,37.0,37.0,1,105,0.0,77.0,77.0
0.085,6,10,1506,5,395,18.0,127.0,127.0,5,1111,19.0,843.0,843.0
0.005,17,2,154,1,69,0.0,41.0,41.0,1,85,0.0,57.0,57.0
0.027,6,10,1989,5,910,6.0,642.0,642.0,5,1079,6.0,811.0,811.0
0.009,17,2,140,1,62,0.0,34.0,34.0,1,78,0.0,50.0,50.0
0.005,17,2,180,1,66,0.0,38.0,38.0,1,114,0.0,86.0,86.0
0.005,6,10,1989,5,927,1.0,659.0,659.0,5,1062,1.0,794.0,794.0
0.011,6,10,1972,5,910,2.0,642.0,642.0,5,1062,2.0,794.0,794.0
0.003,17,2,136,1,60,0.0,32.0,32.0,1,76,0.0,48.0,48.0
0.111,6,10,1506,5,395,17.0,127.0,127.0,5,1111,26.0,843.0,843.0
0.003,17,4,284,2,120,0.0,32.0,32.0,2,164,0.0,60.0,54.0
0.006,6,10,1689,5,839,1.0,571.0,571.0,5,850,1.0,582.0,582.0
0.124,6,10,1506,5,395,30.0,127.0,127.0,5,1111,25.0,843.0,843.0
0.005,6,13,3747,7,509,0.0,137.0,137.0,6,3238,0.0,1470.0,1459.0
0.013,6,10,1983,5,910,3.0,642.0,642.0,5,1073,3.0,805.0,805.0
0.006,17,4,284,2,120,0.0,32.0,32.0,2,164,1.0,60.0,54.0
0.009,6,10,1972,5,910,2.0,642.0,642.0,5,1062,2.0,794.0,794.0
0.007,6,10,1547,5,764,1.0,496.0,496.0,5,783,1.0,515.0,515.0
40.055,17,10,676,5,460,10012.0,104.0,64.0,5,216,10012.0,20.0,15.0
0.001,17,2,180,1,66,0.0,38.0,38.0,1,114,0.0,86.0,86.0
0.018,6,10,1972,5,910,4.0,642.0,642.0,5,1062,4.0,794.0,794.0
0.004,6,10,2006,5,927,1.0,659.0,659.0,5,1079,1.0,811.0,811.0
0.018,6,10,1990,5,911,4.0,643.0,643.0,5,1079,4.0,811.0,811.0
240.146,6,46,6794,22,3225,11435.0,588.0,230.0,24,3569,10440.0,580.0,210.0
40.062,17,10,676,5,460,10013.0,104.0,64.0,5,216,10014.0,20.0,15.0
0.005,6,10,2000,5,927,1.0,659.0,659.0,5,1073,1.0,805.0,805.0
314.867,17,20,1124,10,716,34978.0,48.0,43.0,10,408,34978.0,20.0,12.0
0.024,6,10,1989,5,910,6.0,642.0,642.0,5,1079,5.0,811.0,811.0
353.399,6,20,2210,6,1308,12003.0,494.0,494.0,14,902,27184.0,83.0,83.0
0.005,6,10,2007,5,928,1.0,660.0,660.0,5,1079,1.0,811.0,811.0
0.09,6,14,6933,7,6268,15.0,2736.0,1474.0,7,665,14.0,293.0,293.0
0.006,6,10,1689,5,839,1.0,571.0,571.0,5,850,1.0,582.0,582.0
40.065,17,10,676,5,460,10013.0,104.0,64.0,5,216,10013.0,20.0,15.0
0.096,6,10,1506,5,395,21.0,127.0,127.0,5,1111,21.0,843.0,843.0
0.112,6,10,1506,5,395,20.0,127.0,127.0,5,1111,27.0,843.0,843.0
0.082,6,10,1506,5,395,18.0,127.0,127.0,5,1111,16.0,843.0,843.0
308.631,17,20,1124,10,716,34280.0,48.0,43.0,10,408,34279.0,20.0,12.0
0.006,6,10,1689,5,839,1.0,571.0,571.0,5,850,1.0,582.0,582.0
0.106,6,10,1506,5,395,22.0,127.0,127.0,5,1111,20.0,843.0,843.0
0.039,17,2,148,1,60,0.0,32.0,32.0,1,88,0.0,60.0,60.0
10.866,17,26,4103,13,1847,896.0,270.0,114.0,13,2256,896.0,587.0,145.0
0.013,6,10,1677,5,827,3.0,559.0,559.0,5,850,3.0,582.0,582.0
0.012,6,10,1989,5,910,2.0,642.0,642.0,5,1079,2.0,811.0,811.0
0.086,6,10,1506,5,395,18.0,127.0,127.0,5,1111,16.0,843.0,843.0
0.105,6,10,1506,5,395,24.0,127.0,127.0,5,1111,23.0,843.0,843.0
0.072,17,4,284,2,120,0.0,32.0,32.0,2,164,69.0,60.0,54.0
40.083,17,10,676,5,460,10018.0,104.0,64.0,5,216,10019.0,20.0,15.0
177.165,17,82,11574,41,2735,4428.0,44.0,38.0,41,8839,4429.0,249.0,187.0
0.004,6,10,2007,5,928,1.0,660.0,660.0,5,1079,1.0,811.0,811.0
0.07,17,2,152,1,76,0.0,48.0,48.0,1,76,0.0,48.0,48.0
0.006,6,10,1547,5,764,1.0,496.0,496.0,5,783,1.0,515.0,515.0
308.441,17,20,1124,10,716,34256.0,48.0,43.0,10,408,34256.0,20.0,12.0
0.17,17,2,152,1,76,0.0,48.0,48.0,1,76,0.0,48.0,48.0
0.04,17,2,412,1,61,0.0,33.0,33.0,1,351,0.0,323.0,323.0
0.103,6,10,1506,5,395,22.0,127.0,127.0,5,1111,24.0,843.0,843.0
368.561,6,22,2313,16,867,24570.0,195.0,195.0,6,1446,4636.0,419.0,398.0
0.004,17,4,284,2,120,0.0,32.0,32.0,2,164,1.0,60.0,54.0
0.004,17,2,148,1,60,0.0,32.0,32.0,1,88,0.0,60.0,60.0
171.112,17,88,12194,44,2932,3979.0,44.0,38.0,44,9262,3979.0,261.0,182.0
177.137,17,78,10951,39,2600,4661.0,44.0,38.0,39,8351,4661.0,239.0,186.0
0.067,6,10,1506,5,395,13.0,127.0,127.0,5,1111,15.0,843.0,843.0
0.006,6,10,1547,5,764,1.0,496.0,496.0,5,783,1.0,515.0,515.0
0.017,6,10,1989,5,910,4.0,642.0,642.0,5,1079,4.0,811.0,811.0
15.17,17,20,10979,10,7422,1682.0,1350.0,714.0,10,3557,1682.0,1350.0,327.0
0.005,17,2,214,1,75,0.0,47.0,47.0,1,139,0.0,111.0,111.0
0.005,6,10,1854,5,889,1.0,621.0,621.0,5,965,1.0,697.0,697.0
0.006,6,10,2006,5,927,1.0,659.0,659.0,5,1079,1.0,811.0,811.0
0.095,6,10,1506,5,395,22.0,127.0,127.0,5,1111,19.0,843.0,843.0
40.064,17,10,676,5,460,10013.0,104.0,64.0,5,216,10015.0,20.0,15.0
0.038,17,4,284,2,120,0.0,32.0,32.0,2,164,34.0,60.0,54.0
0.005,6,10,2000,5,927,1.0,659.0,659.0,5,1073,1.0,805.0,805.0
310.187,17,20,1124,10,716,34451.0,48.0,43.0,10,408,34451.0,20.0,12.0
0.005,6,13,3690,7,452,0.0,80.0,80.0,6,3238,0.0,1470.0,1459.0
0.01,6,10,1990,5,911,2.0,643.0,643.0,5,1079,2.0,811.0,811.0
0.016,6,10,1989,5,910,4.0,642.0,642.0,5,1079,4.0,811.0,811.0
0.025,6,10,1631,5,848,6.0,580.0,580.0,5,783,6.0,515.0,515.0
0.0,17,2,166,1,75,0.0,47.0,47.0,1,91,0.0,63.0,63.0
0.005,17,2,170,1,65,0.0,37.0,37.0,1,105,0.0,77.0,77.0
0.006,6,10,1547,5,764,1.0,496.0,496.0,5,783,1.0,515.0,515.0
0.011,17,2,166,1,75,0.0,47.0,47.0,1,91,0.0,63.0,63.0
0.005,17,2,169,1,62,0.0,34.0,34.0,1,107,0.0,79.0,79.0
0.013,6,10,1762,5,911,3.0,643.0,643.0,5,851,3.0,583.0,583.0
0.02,6,10,1631,5,848,5.0,580.0,580.0,5,783,5.0,515.0,515.0
0.017,6,10,1983,5,910,4.0,642.0,642.0,5,1073,4.0,805.0,805.0
0.004,17,4,284,2,120,1.0,32.0,32.0,2,164,1.0,60.0,54.0
0.005,6,10,1989,5,927,1.0,659.0,659.0,5,1062,1.0,794.0,794.0
0.023,6,10,1990,5,911,5.0,643.0,643.0,5,1079,5.0,811.0,811.0
0.012,6,10,1989,5,910,3.0,642.0,642.0,5,1079,3.0,811.0,811.0
0.004,17,4,284,2,120,0.0,32.0,32.0,2,164,0.0,60.0,54.0
0.012,6,10,1972,5,910,3.0,642.0,642.0,5,1062,3.0,794.0,794.0
0.072,6,10,1506,5,395,17.0,127.0,127.0,5,1111,15.0,843.0,843.0
0.012,6,10,1983,5,910,3.0,642.0,642.0,5,1073,2.0,805.0,805.0
0.006,17,2,179,1,71,0.0,43.0,43.0,1,108,0.0,80.0,80.0
0.005,6,10,1779,5,928,1.0,660.0,660.0,5,851,1.0,583.0,583.0
11.525,17,28,4398,14,2312,873.0,587.0,137.0,14,2086,873.0,269.0,121.0
0.006,6,10,1547,5,764,1.0,496.0,496.0,5,783,1.0,515.0,515.0
0.041,6,10,1989,5,910,10.0,642.0,642.0,5,1079,10.0,811.0,811.0
253.742,6,18,4585,9,963,31717.0,238.0,166.0,9,3622,31717.0,1402.0,786.0
0.004,17,2,136,1,60,0.0,32.0,32.0,1,76,0.0,48.0,48.0
0.006,17,2,214,1,75,0.0,47.0,47.0,1,139,0.0,111.0,111.0
0.093,6,10,1506,5,395,20.0,127.0,127.0,5,1111,19.0,843.0,843.0
0.017,6,10,1989,5,910,4.0,642.0,642.0,5,1079,4.0,811.0,811.0
0.008,6,10,1631,5,848,2.0,580.0,580.0,5,783,1.0,515.0,515.0
0.004,17,2,208,1,72,0.0,44.0,44.0,1,136,0.0,108.0,108.0
0.117,17,2,179,1,71,0.0,43.0,43.0,1,108,0.0,80.0,80.0
24.845,6,38,12687,19,7129,491.0,4080.0,1267.0,19,5558,1371.0,2667.0,435.0
0.005,6,10,2007,5,928,1.0,660.0,660.0,5,1079,1.0,811.0,811.0
0.009,6,10,1990,5,911,2.0,643.0,643.0,5,1079,2.0,811.0,811.0
0.009,6,10,1990,5,911,2.0,643.0,643.0,5,1079,2.0,811.0,811.0
0.059,17,2,152,1,76,0.0,48.0,48.0,1,76,0.0,48.0,48.0
0.006,6,10,1547,5,764,1.0,496.0,496.0,5,783,1.0,515.0,515.0
0.005,6,10,2007,5,928,1.0,660.0,660.0,5,1079,1.0,811.0,811.0
0.004,17,2,170,1,65,0.0,37.0,37.0,1,105,0.0,77.0,77.0
0.023,6,10,1972,5,910,5.0,642.0,642.0,5,1062,5.0,794.0,794.0
0.006,6,10,1547,5,764,1.0,496.0,496.0,5,783,1.0,515.0,515.0
15.08,17,15,8494,8,6359,2150.0,1350.0,766.0,7,2135,2508.0,1350.0,277.0
0.004,6,10,2007,5,928,1.0,660.0,660.0,5,1079,1.0,811.0,811.0
0.004,17,2,136,1,60,0.0,32.0,32.0,1,76,0.0,48.0,48.0
0.005,6,10,2006,5,927,1.0,659.0,659.0,5,1079,1.0,811.0,811.0
0.005,6,10,2006,5,927,1.0,659.0,659.0,5,1079,1.0,811.0,811.0
66.183,6,22,8895,12,2328,6016.0,1002.0,424.0,10,6567,7335.0,2355.0,1006.0
0.018,6,10,1990,5,911,4.0,643.0,643.0,5,1079,4.0,811.0,811.0
1.049,6,13,3922,7,2139,131.0,1328.0,923.0,6,1783,157.0,1539.0,1539.0
0.051,17,2,144,1,64,0.0,36.0,36.0,1,80,0.0,52.0,52.0
0.011,6,10,1972,5,910,2.0,642.0,642.0,5,1062,2.0,794.0,794.0
0.005,6,10,2007,5,928,1.0,660.0,660.0,5,1079,1.0,811.0,811.0
0.071,6,10,1506,5,395,14.0,127.0,127.0,5,1111,14.0,843.0,843.0
0.005,6,10,1779,5,928,1.0,660.0,660.0,5,851,1.0,583.0,583.0
40.059,17,10,676,5,460,10013.0,104.0,64.0,5,216,10014.0,20.0,15.0
5.156,6,23,6990,13,1827,429.0,801.0,282.0,10,5163,572.0,1925.0,774.0
0.008,6,10,1989,5,910,1.0,642.0,642.0,5,1079,2.0,811.0,811.0
0.247,6,16,2669,8,1395,35.0,533.0,323.0,8,1274,23.0,529.0,212.0
0.008,6,10,2007,5,928,1.0,660.0,660.0,5,1079,2.0,811.0,811.0
900.811,6,55,18499,29,5650,32171.0,676.0,459.0,26,12849,33631.0,1402.0,718.0
0.004,6,10,2006,5,927,1.0,659.0,659.0,5,1079,1.0,811.0,811.0
0.001,17,2,180,1,66,0.0,38.0,38.0,1,114,0.0,86.0,86.0
0.141,6,10,1506,5,395,33.0,127.0,127.0,5,1111,33.0,843.0,843.0
0.006,6,10,1689,5,839,1.0,571.0,571.0,5,850,1.0,582.0,582.0
0.006,6,10,1547,5,764,1.0,496.0,496.0,5,783,1.0,515.0,515.0
0.008,6,10,1989,5,910,2.0,642.0,642.0,5,1079,2.0,811.0,811.0
0.113,6,10,1506,5,395,27.0,127.0,127.0,5,1111,18.0,843.0,843.0
0.004,17,4,284,2,120,1.0,32.0,32.0,2,164,0.0,60.0,54.0
0.112,6,10,1506,5,395,25.0,127.0,127.0,5,1111,20.0,843.0,843.0
37.353,6,36,9669,18,4151,519.0,1686.0,849.0,18,5518,2186.0,2667.0,435.0
240.095,6,32,9451,16,6949,16006.0,2021.0,680.0,16,2502,16006.0,580.0,207.0
0.006,6,10,1547,5,764,1.0,496.0,496.0,5,783,1.0,515.0,515.0
0.014,6,10,1762,5,911,3.0,643.0,643.0,5,851,3.0,583.0,583.0
0.131,6,10,1506,5,395,26.0,127.0,127.0,5,1111,18.0,843.0,843.0
0.004,6,10,2007,5,928,1.0,660.0,660.0,5,1079,1.0,811.0,811.0
0.005,6,10,2007,5,928,1.0,660.0,660.0,5,1079,1.0,811.0,811.0
0.005,6,10,2000,5,927,1.0,659.0,659.0,5,1073,1.0,805.0,805.0
0.005,6,10,1854,5,889,1.0,621.0,621.0,5,965,1.0,697.0,697.0
0.01,6,10,1989,5,910,2.0,642.0,642.0,5,1079,2.0,811.0,811.0
0.005,17,2,166,1,75,0.0,47.0,47.0,1,91,0.0,63.0,63.0
0.013,6,10,1989,5,910,3.0,642.0,642.0,5,1079,3.0,811.0,811.0
9.037,17,6,376,5,280,2259.0,28.0,28.0,1,96,0.0,68.0,68.0
0.215,6,16,2670,8,1396,30.0,533.0,324.0,8,1274,19.0,529.0,212.0
0.061,6,10,1506,5,395,12.0,127.0,127.0,5,1111,14.0,843.0,843.0
0.005,17,2,170,1,65,0.0,37.0,37.0,1,105,0.0,77.0,77.0
0.083,6,10,1506,5,395,17.0,127.0,127.0,5,1111,18.0,843.0,843.0
0.011,6,10,1983,5,910,2.0,642.0,642.0,5,1073,2.0,805.0,805.0
0.163,17,2,152,1,76,0.0,48.0,48.0,1,76,0.0,48.0,48.0
0.077,6,10,1506,5,395,16.0,127.0,127.0,5,1111,18.0,843.0,843.0
0.011,6,14,3787,7,497,1.0,125.0,125.0,7,3290,1.0,1448.0,972.0
40.064,17,10,676,5,460,10014.0,104.0,64.0,5,216,10015.0,20.0,15.0
0.004,6,10,2007,5,928,1.0,660.0,660.0,5,1079,1.0,811.0,811.0
0.086,6,10,1506,5,395,20.0,127.0,127.0,5,1111,18.0,843.0,843.0
0.005,6,10,2007,5,928,1.0,660.0,660.0,5,1079,1.0,811.0,811.0
0.106,6,10,1506,5,395,21.0,127.0,127.0,5,1111,24.0,843.0,843.0
0.083,6,10,1506,5,395,17.0,127.0,127.0,5,1111,20.0,843.0,843.0
0.003,6,10,1702,5,863,0.0,595.0,595.0,5,839,0.0,571.0,571.0
0.005,6,10,1989,5,927,1.0,659.0,659.0,5,1062,1.0,794.0,794.0
0.005,17,2,144,1,64,0.0,36.0,36.0,1,80,0.0,52.0,52.0
0.104,6,10,1506,5,395,22.0,127.0,127.0,5,1111,23.0,843.0,843.0
176.537,17,82,11948,41,2751,4413.0,44.0,39.0,41,9197,4413.0,261.0,196.0
308.665,17,20,1124,10,716,34280.0,48.0,43.0,10,408,34281.0,20.0,12.0
0.221,6,16,2777,8,1395,31.0,533.0,323.0,8,1382,20.0,529.0,239.0
0.014,6,10,1762,5,911,3.0,643.0,643.0,5,851,3.0,583.0,583.0
0.008,6,10,1989,5,910,2.0,642.0,642.0,5,1079,1.0,811.0,811.0
0.004,6,10,1989,5,927,1.0,659.0,659.0,5,1062,0.0,794.0,794.0
0.004,6,10,1702,5,863,0.0,595.0,595.0,5,839,1.0,571.0,571.0
0.008,6,10,2006,5,927,1.0,659.0,659.0,5,1079,1.0,811.0,811.0
0.005,6,10,2000,5,927,1.0,659.0,659.0,5,1073,1.0,805.0,805.0
0.011,6,10,1677,5,827,2.0,559.0,559.0,5,850,2.0,582.0,582.0
318.153,17,20,1124,10,716,35335.0,48.0,43.0,10,408,35335.0,20.0,12.0
0.13,6,10,1506,5,395,30.0,127.0,127.0,5,1111,30.0,843.0,843.0
0.013,6,10,1989,5,910,3.0,642.0,642.0,5,1079,3.0,811.0,811.0
15.072,17,15,9238,8,6902,2149.0,1350.0,834.0,7,2336,2507.0,1350.0,305.0
0.003,17,2,152,1,76,0.0,48.0,48.0,1,76,0.0,48.0,48.0
10.731,17,28,4421,14,1993,817.0,268.0,114.0,14,2428,816.0,587.0,145.0
0.11,6,10,1506,5,395,24.0,127.0,127.0,5,1111,24.0,843.0,843.0
0.008,6,10,1689,5,839,1.0,571.0,571.0,5,850,1.0,582.0,582.0
280.486,6,24,6115,11,1226,28048.0,267.0,156.0,13,4889,23373.0,1400.0,873.0
0.072,6,10,1506,5,395,16.0,127.0,127.0,5,1111,14.0,843.0,843.0
0.094,6,10,1506,5,395,21.0,127.0,127.0,5,1111,20.0,843.0,843.0
0.01,6,10,1983,5,910,2.0,642.0,642.0,5,1073,2.0,805.0,805.0
0.098,6,10,1506,5,395,22.0,127.0,127.0,5,1111,20.0,843.0,843.0
0.005,6,10,1774,5,923,1.0,655.0,655.0,5,851,1.0,583.0,583.0
0.006,6,10,1643,5,860,1.0,592.0,592.0,5,783,1.0,515.0,515.0
240.093,6,31,9236,15,6892,17149.0,2018.0,679.0,16,2344,16006.0,580.0,188.0
0.038,17,2,136,1,60,0.0,32.0,32.0,1,76,0.0,48.0,48.0
0.007,6,10,1643,5,860,1.0,592.0,592.0,5,783,1.0,515.0,515.0
0.005,17,2,169,1,62,0.0,34.0,34.0,1,107,0.0,79.0,79.0
0.128,17,2,80,1,32,0.0,4.0,4.0,1,48,0.0,20.0,20.0
0.005,6,10,1854,5,889,1.0,621.0,621.0,5,965,1.0,697.0,697.0
0.006,6,10,2006,5,927,1.0,659.0,659.0,5,1079,1.0,811.0,811.0
0.086,6,10,1506,5,395,19.0,127.0,127.0,5,1111,19.0,843.0,843.0
0.001,17,2,180,1,66,0.0,38.0,38.0,1,114,0.0,86.0,86.0
0.087,6,10,1506,5,395,17.0,127.0,127.0,5,1111,20.0,843.0,843.0
0.006,6,10,1689,5,839,1.0,571.0,571.0,5,850,1.0,582.0,582.0
0.009,6,12,1926,6,1189,1.0,659.0,434.0,6,737,1.0,417.0,417.0
0.093,6,10,1506,5,395,21.0,127.0,127.0,5,1111,21.0,843.0,843.0
0.006,6,10,1547,5,764,1.0,496.0,496.0,5,783,1.0,515.0,515.0
0.005,6,14,3736,7,446,0.0,74.0,74.0,7,3290,0.0,1448.0,972.0
1792.414,6,560,189181,283,163034,6356.0,2883.0,926.0,277,26147,6494.0,378.0,119.0
0.004,17,2,148,1,60,0.0,32.0,32.0,1,88,0.0,60.0,60.0
0.005,17,2,164,1,74,0.0,46.0,46.0,1,90,0.0,62.0,62.0
0.005,17,2,140,1,62,0.0,34.0,34.0,1,78,0.0,50.0,50.0
10.796,17,28,4421,14,1994,822.0,269.0,114.0,14,2427,822.0,586.0,145.0
0.006,6,10,1547,5,764,1.0,496.0,496.0,5,783,1.0,515.0,515.0
0.101,6,10,1506,5,395,23.0,127.0,127.0,5,1111,23.0,843.0,843.0
0.084,6,10,1506,5,395,19.0,127.0,127.0,5,1111,17.0,843.0,843.0
0.006,17,2,179,1,71,0.0,43.0,43.0,1,108,0.0,80.0,80.0
0.005,6,10,2006,5,927,1.0,659.0,659.0,5,1079,1.0,811.0,811.0
29.313,17,24,14848,13,12031,2440.0,1350.0,897.0,11,2817,2928.0,1350.0,228.0
0.008,6,10,1972,5,910,2.0,642.0,642.0,5,1062,2.0,794.0,794.0
0.003,17,2,148,1,60,0.0,32.0,32.0,1,88,0.0,60.0,60.0
0.014,6,13,3735,7,497,2.0,125.0,125.0,6,3238,2.0,1470.0,1459.0
0.012,6,10,1990,5,911,3.0,643.0,643.0,5,1079,2.0,811.0,811.0
0.015,6,10,1972,5,910,3.0,642.0,642.0,5,1062,3.0,794.0,794.0
0.015,6,10,1972,5,910,3.0,642.0,642.0,5,1062,3.0,794.0,794.0
0.096,6,10,1506,5,395,21.0,127.0,127.0,5,1111,19.0,843.0,843.0
0.004,6,10,1702,5,863,1.0,595.0,595.0,5,839,1.0,571.0,571.0
0.019,6,10,1983,5,910,4.0,642.0,642.0,5,1073,4.0,805.0,805.0
0.012,6,10,1983,5,910,3.0,642.0,642.0,5,1073,2.0,805.0,805.0
0.003,17,4,284,2,120,0.0,32.0,32.0,2,164,0.0,60.0,54.0
0.216,6,16,2671,8,1397,30.0,533.0,324.0,8,1274,19.0,529.0,212.0
0.003,17,2,148,1,60,0.0,32.0,32.0,1,88,0.0,60.0,60.0
0.006,6,10,1854,5,889,1.0,621.0,621.0,5,965,1.0,697.0,697.0
0.006,6,10,1547,5,764,1.0,496.0,496.0,5,783,1.0,515.0,515.0
0.004,17,2,148,1,60,0.0,32.0,32.0,1,88,0.0,60.0,60.0
0.004,6,10,1702,5,863,1.0,595.0,595.0,5,839,0.0,571.0,571.0
0.014,6,14,3787,7,497,2.0,125.0,125.0,7,3290,2.0,1448.0,972.0
0.078,6,10,1506,5,395,17.0,127.0,127.0,5,1111,16.0,843.0,843.0
9.039,17,6,376,5,280,2259.0,28.0,28.0,1,96,0.0,68.0,68.0
0.011,6,10,1989,5,910,2.0,642.0,642.0,5,1079,2.0,811.0,811.0
0.004,17,2,136,1,60,0.0,32.0,32.0,1,76,0.0,48.0,48.0
0.089,6,10,1506,5,395,19.0,127.0,127.0,5,1111,20.0,843.0,843.0
0.01,17,2,132,1,58,0.0,30.0,30.0,1,74,0.0,46.0,46.0
40.064,17,10,676,5,460,10014.0,104.0,64.0,5,216,10015.0,20.0,15.0
0.01,6,10,1983,5,910,2.0,642.0,642.0,5,1073,2.0,805.0,805.0
0.015,6,10,1990,5,911,3.0,643.0,643.0,5,1079,3.0,811.0,811.0
0.013,17,4,284,2,120,10.0,32.0,32.0,2,164,9.0,60.0,54.0
40.059,17,10,676,5,460,10014.0,104.0,64.0,5,216,10013.0,20.0,15.0
0.004,6,10,1702,5,863,1.0,595.0,595.0,5,839,0.0,571.0,571.0
0.011,6,10,1972,5,910,2.0,642.0,642.0,5,1062,2.0,794.0,794.0
0.015,6,13,3735,7,497,2.0,125.0,125.0,6,3238,3.0,1470.0,1459.0
15.234,17,18,9625,9,6032,1899.0,1350.0,642.0,9,3593,1898.0,1350.0,371.0
0.088,6,10,1506,5,395,21.0,127.0,127.0,5,1111,19.0,843.0,843.0
0.012,6,10,1677,5,827,3.0,559.0,559.0,5,850,3.0,582.0,582.0
0.001,17,2,180,1,66,0.0,38.0,38.0,1,114,0.0,86.0,86.0
0.007,6,10,1854,5,889,1.0,621.0,621.0,5,965,1.0,697.0,697.0
0.017,6,10,1972,5,910,4.0,642.0,642.0,5,1062,4.0,794.0,794.0
0.006,6,10,1643,5,860,1.0,592.0,592.0,5,783,1.0,515.0,515.0
0.007,6,10,2007,5,928,1.0,660.0,660.0,5,1079,1.0,811.0,811.0
0.003,6,10,1702,5,863,0.0,595.0,595.0,5,839,0.0,571.0,571.0
0.072,17,2,380,1,61,0.0,33.0,33.0,1,319,0.0,291.0,291.0
0.013,6,10,1972,5,910,3.0,642.0,642.0,5,1062,3.0,794.0,794.0
0.01,6,10,1989,5,910,2.0,642.0,642.0,5,1079,2.0,811.0,811.0
0.001,17,2,180,1,66,0.0,38.0,38.0,1,114,0.0,86.0,86.0
0.331,17,43,20818,22,17091,15.0,1350.0,748.0,21,3727,13.0,1350.0,149.0
0.017,17,2,180,1,66,0.0,38.0,38.0,1,114,0.0,86.0,86.0
0.004,6,10,2006,5,927,1.0,659.0,659.0,5,1079,1.0,811.0,811.0
0.009,6,10,1990,5,911,2.0,643.0,643.0,5,1079,2.0,811.0,811.0
0.005,17,2,144,1,64,0.0,36.0,36.0,1,80,0.0,52.0,52.0
0.014,6,10,1762,5,911,3.0,643.0,643.0,5,851,3.0,583.0,583.0
0.072,17,2,144,1,64,0.0,36.0,36.0,1,80,0.0,52.0,52.0
15.076,17,15,8357,8,6268,2149.0,1350.0,755.0,7,2089,2507.0,1350.0,270.0
0.007,17,2,162,1,65,0.0,37.0,37.0,1,97,0.0,69.0,69.0
0.0,17,2,136,1,60,0.0,32.0,32.0,1,76,0.0,48.0,48.0
0.01,6,10,1677,5,827,2.0,559.0,559.0,5,850,2.0,582.0,582.0
354.022,6,21,1795,16,1030,23601.0,190.0,190.0,5,765,60001.0,464.0,248.0
0.056,17,2,299,1,65,0.0,37.0,37.0,1,234,0.0,206.0,206.0
0.004,17,2,179,1,71,0.0,43.0,43.0,1,108,0.0,80.0,80.0
0.005,6,10,1774,5,923,1.0,655.0,655.0,5,851,1.0,583.0,583.0
0.003,17,2,152,1,76,0.0,48.0,48.0,1,76,0.0,48.0,48.0
0.005,6,10,1643,5,860,1.0,592.0,592.0,5,783,1.0,515.0,515.0
0.082,6,10,1506,5,395,18.0,127.0,127.0,5,1111,18.0,843.0,843.0
0.008,6,10,1989,5,910,2.0,642.0,642.0,5,1079,1.0,811.0,811.0
1778.37,17,144,41760,72,22752,25047.0,288.0,288.0,72,19008,25047.0,236.0,236.0
0.095,6,10,1506,5,395,21.0,127.0,127.0,5,1111,20.0,843.0,843.0
240.088,6,16,4481,9,963,30011.0,238.0,166.0,7,3518,40014.0,1402.0,786.0
0.006,6,10,2006,5,927,1.0,659.0,659.0,5,1079,1.0,811.0,811.0
0.014,6,10,1972,5,910,3.0,642.0,642.0,5,1062,3.0,794.0,794.0
0.012,6,10,1983,5,910,3.0,642.0,642.0,5,1073,3.0,805.0,805.0
40.056,17,10,676,5,460,10013.0,104.0,64.0,5,216,10013.0,20.0,15.0
0.076,6,10,1506,5,395,18.0,127.0,127.0,5,1111,16.0,843.0,843.0
0.004,6,10,2007,5,928,1.0,660.0,660.0,5,1079,1.0,811.0,811.0
0.009,6,10,1972,5,910,2.0,642.0,642.0,5,1062,2.0,794.0,794.0
0.007,6,10,1547,5,764,1.0,496.0,496.0,5,783,1.0,515.0,515.0
0.008,6,10,1990,5,911,1.0,643.0,643.0,5,1079,2.0,811.0,811.0
0.008,6,10,2007,5,928,2.0,660.0,660.0,5,1079,1.0,811.0,811.0
0.017,6,10,1972,5,910,4.0,642.0,642.0,5,1062,4.0,794.0,794.0
309.689,17,18,1008,9,640,38694.0,48.0,43.0,9,368,38694.0,20.0,12.0
0.114,6,10,1506,5,395,24.0,127.0,127.0,5,1111,24.0,843.0,843.0
0.001,17,2,166,1,75,0.0,47.0,47.0,1,91,0.0,63.0,63.0
0.012,6,10,1631,5,848,3.0,580.0,580.0,5,783,3.0,515.0,515.0
40.064,17,10,676,5,460,10015.0,104.0,64.0,5,216,10015.0,20.0,15.0
40.066,17,10,676,5,460,10015.0,104.0,64.0,5,216,10015.0,20.0,15.0
0.008,6,10,1989,5,910,2.0,642.0,642.0,5,1079,2.0,811.0,811.0
0.005,6,10,1989,5,927,1.0,659.0,659.0,5,1062,1.0,794.0,794.0
308.652,17,20,1124,10,716,34288.0,48.0,43.0,10,408,34288.0,20.0,12.0
0.156,6,10,1506,5,395,34.0,127.0,127.0,5,1111,35.0,843.0,843.0
0.009,6,12,1926,6,1189,1.0,659.0,434.0,6,737,1.0,417.0,417.0
0.004,6,10,2006,5,927,1.0,659.0,659.0,5,1079,1.0,811.0,811.0
0.123,6,10,1506,5,395,25.0,127.0,127.0,5,1111,27.0,843.0,843.0
0.005,17,2,140,1,62,0.0,34.0,34.0,1,78,0.0,50.0,50.0
0.005,6,10,2006,5,927,1.0,659.0,659.0,5,1079,1.0,811.0,811.0
0.006,6,10,1547,5,764,1.0,496.0,496.0,5,783,1.0,515.0,515.0
0.003,17,2,136,1,60,0.0,32.0,32.0,1,76,0.0,48.0,48.0
0.011,6,10,1989,5,910,2.0,642.0,642.0,5,1079,2.0,811.0,811.0
0.005,6,10,2006,5,927,1.0,659.0,659.0,5,1079,1.0,811.0,811.0
0.167,17,2,152,1,76,0.0,48.0,48.0,1,76,0.0,48.0,48.0
0.005,6,10,2006,5,927,1.0,659.0,659.0,5,1079,1.0,811.0,811.0
0.014,6,10,1989,5,910,3.0,642.0,642.0,5,1079,3.0,811.0,811.0
0.001,17,2,180,1,66,0.0,38.0,38.0,1,114,0.0,86.0,86.0
0.056,6,10,1506,5,395,12.0,127.0,127.0,5,1111,13.0,843.0,843.0
0.005,17,2,140,1,62,0.0,34.0,34.0,1,78,0.0,50.0,50.0
0.02,6,10,1631,5,848,5.0,580.0,580.0,5,783,4.0,515.0,515.0
0.167,17,2,152,1,76,0.0,48.0,48.0,1,76,0.0,48.0,48.0
40.072,17,10,676,5,460,10013.0,104.0,64.0,5,216,10017.0,20.0,15.0
0.004,6,10,1702,5,863,1.0,595.0,595.0,5,839,0.0,571.0,571.0
0.006,6,10,1547,5,764,1.0,496.0,496.0,5,783,1.0,515.0,515.0
0.024,6,10,1972,5,910,6.0,642.0,642.0,5,1062,5.0,794.0,794.0
0.005,17,2,136,1,60,0.0,32.0,32.0,1,76,0.0,48.0,48.0
0.009,6,12,1926,6,1189,1.0,659.0,434.0,6,737,1.0,417.0,417.0
0.005,17,2,148,1,60,0.0,32.0,32.0,1,88,0.0,60.0,60.0
0.001,17,2,180,1,66,0.0,38.0,38.0,1,114,0.0,86.0,86.0
5.098,6,21,5923,12,1436,463.0,474.0,201.0,9,4487,636.0,1925.0,804.0
40.061,17,10,676,5,460,10013.0,104.0,64.0,5,216,10014.0,20.0,15.0
0.014,6,13,3735,7,497,2.0,125.0,125.0,6,3238,2.0,1470.0,1459.0
0.005,17,2,169,1,62,0.0,34.0,34.0,1,107,0.0,79.0,79.0
0.005,6,13,3690,7,452,0.0,80.0,80.0,6,3238,1.0,1470.0,1459.0
310.368,17,18,1008,9,640,38780.0,48.0,43.0,9,368,38780.0,20.0,12.0
0.013,17,2,152,1,56,0.0,28.0,28.0,1,96,0.0,68.0,68.0
0.007,6,10,1972,5,910,1.0,642.0,642.0,5,1062,1.0,794.0,794.0
0.005,6,10,2006,5,927,1.0,659.0,659.0,5,1079,1.0,811.0,811.0
0.015,6,10,1990,5,911,3.0,643.0,643.0,5,1079,3.0,811.0,811.0
0.006,6,10,1989,5,927,1.0,659.0,659.0,5,1062,1.0,794.0,794.0
0.006,6,10,1689,5,839,1.0,571.0,571.0,5,850,1.0,582.0,582.0
0.219,6,16,2777,8,1395,31.0,533.0,323.0,8,1382,19.0,529.0,239.0
0.085,6,10,1506,5,395,20.0,127.0,127.0,5,1111,20.0,843.0,843.0
0.001,17,2,164,1,74,0.0,46.0,46.0,1,90,0.0,62.0,62.0
0.003,17,2,148,1,60,0.0,32.0,32.0,1,88,0.0,60.0,60.0
0.072,17,2,234,1,61,0.0,33.0,33.0,1,173,0.0,145.0,145.0
11.175,17,28,4418,14,1994,847.0,269.0,114.0,14,2424,847.0,587.0,145.0
240.016,6,17,2472,9,1169,30002.0,555.0,176.0,8,1303,34287.0,580.0,219.0
0.005,6,14,3742,7,452,0.0,80.0,80.0,7,3290,0.0,1448.0,972.0
40.073,17,10,676,5,460,10013.0,104.0,64.0,5,216,10017.0,20.0,15.0
0.004,6,10,2006,5,927,1.0,659.0,659.0,5,1079,1.0,811.0,811.0
0.016,17,2,198,1,91,0.0,63.0,63.0,1,107,0.0,79.0,79.0
0.021,6,10,1989,5,910,5.0,642.0,642.0,5,1079,5.0,811.0,811.0
0.146,6,10,1506,5,395,23.0,127.0,127.0,5,1111,35.0,843.0,843.0
0.089,6,10,1506,5,395,19.0,127.0,127.0,5,1111,20.0,843.0,843.0
0.007,6,10,1547,5,764,1.0,496.0,496.0,5,783,1.0,515.0,515.0
0.009,6,10,1989,5,910,2.0,642.0,642.0,5,1079,2.0,811.0,811.0
0.003,17,2,136,1,60,0.0,32.0,32.0,1,76,0.0,48.0,48.0
15.07,17,15,9238,8,6902,2148.0,1350.0,834.0,7,2336,2506.0,1350.0,305.0
0.004,6,10,1702,5,863,0.0,595.0,595.0,5,839,1.0,571.0,571.0
0.003,17,2,132,1,58,0.0,30.0,30.0,1,74,0.0,46.0,46.0
0.025,6,13,3735,7,497,4.0,125.0,125.0,6,3238,5.0,1470.0,1459.0
0.04,17,2,136,1,60,0.0,32.0,32.0,1,76,0.0,48.0,48.0
0.015,6,10,1983,5,910,3.0,642.0,642.0,5,1073,3.0,805.0,805.0
0.979,6,13,3922,7,2139,122.0,1328.0,923.0,6,1783,147.0,1539.0,1539.0
0.103,6,10,1506,5,395,24.0,127.0,127.0,5,1111,22.0,843.0,843.0
0.069,6,10,1506,5,395,15.0,127.0,127.0,5,1111,15.0,843.0,843.0
0.009,17,2,179,1,71,0.0,43.0,43.0,1,108,0.0,80.0,80.0
0.064,6,10,1506,5,395,14.0,127.0,127.0,5,1111,12.0,843.0,843.0
0.014,6,10,1854,5,889,3.0,621.0,621.0,5,965,3.0,697.0,697.0
240.084,6,16,4482,9,963,30010.0,238.0,166.0,7,3519,40013.0,1402.0,786.0
0.013,6,10,1631,5,848,3.0,580.0,580.0,5,783,3.0,515.0,515.0
0.037,17,2,170,1,65,0.0,37.0,37.0,1,105,0.0,77.0,77.0
0.004,6,10,2007,5,928,1.0,660.0,660.0,5,1079,1.0,811.0,811.0
252.921,6,39,9874,16,6758,16861.0,1829.0,658.0,23,3116,11496.0,580.0,136.0
1778.882,17,142,44872,72,22752,25053.0,288.0,288.0,70,22120,25779.0,288.0,288.0
0.011,6,10,1983,5,910,2.0,642.0,642.0,5,1073,2.0,805.0,805.0
0.01,6,10,1677,5,827,2.0,559.0,559.0,5,850,2.0,582.0,582.0
0.11,6,10,1506,5,395,23.0,127.0,127.0,5,1111,23.0,843.0,843.0
300.861,6,39,12924,21,7406,15043.0,2720.0,1089.0,18,5518,510.0,2667.0,435.0
0.005,6,13,3747,7,509,0.0,137.0,137.0,6,3238,1.0,1470.0,1459.0
0.005,6,10,2007,5,928,1.0,660.0,660.0,5,1079,1.0,811.0,811.0
0.014,6,10,1983,5,910,3.0,642.0,642.0,5,1073,3.0,805.0,805.0
0.005,17,2,164,1,74,0.0,46.0,46.0,1,90,0.0,62.0,62.0
0.008,6,10,1989,5,910,2.0,642.0,642.0,5,1079,1.0,811.0,811.0
0.097,6,10,1506,5,395,21.0,127.0,127.0,5,1111,20.0,843.0,843.0
0.114,6,10,1506,5,395,21.0,127.0,127.0,5,1111,23.0,843.0,843.0
0.087,6,10,1506,5,395,18.0,127.0,127.0,5,1111,16.0,843.0,843.0
0.016,6,10,1972,5,910,3.0,642.0,642.0,5,1062,4.0,794.0,794.0
40.058,17,10,676,5,460,10013.0,104.0,64.0,5,216,10013.0,20.0,15.0
0.083,6,10,1506,5,395,17.0,127.0,127.0,5,1111,17.0,843.0,843.0
0.071,17,8,3613,4,1874,23.0,1350.0,440.0,4,1739,12.0,1350.0,406.0
187.033,17,94,13789,47,3139,4065.0,44.0,38.0,47,10650,4065.0,261.0,198.0
0.005,17,2,170,1,65,0.0,37.0,37.0,1,105,0.0,77.0,77.0
0.006,6,10,1689,5,839,1.0,571.0,571.0,5,850,1.0,582.0,582.0
0.01,6,10,1990,5,911,2.0,643.0,643.0,5,1079,2.0,811.0,811.0
0.005,6,10,2006,5,927,1.0,659.0,659.0,5,1079,1.0,811.0,811.0
0.004,6,10,1779,5,928,1.0,660.0,660.0,5,851,1.0,583.0,583.0
0.003,17,2,148,1,60,0.0,32.0,32.0,1,88,0.0,60.0,60.0
0.04,17,4,420,2,122,1.0,33.0,33.0,2,298,35.0,145.0,121.0
0.013,6,10,1972,5,910,3.0,642.0,642.0,5,1062,3.0,794.0,794.0
0.009,6,12,1926,6,1189,1.0,659.0,434.0,6,737,1.0,417.0,417.0
300.609,6,34,6335,19,1409,16700.0,267.0,154.0,15,4926,605.0,1823.0,392.0
0.005,6,14,3742,7,452,0.0,80.0,80.0,7,3290,0.0,1448.0,972.0
0.005,6,10,2000,5,927,1.0,659.0,659.0,5,1073,1.0,805.0,805.0
0.034,6,10,1631,5,848,8.0,580.0,580.0,5,783,8.0,515.0,515.0
0.074,17,4,420,2,122,0.0,33.0,33.0,2,298,70.0,145.0,121.0
0.116,6,10,1506,5,395,25.0,127.0,127.0,5,1111,25.0,843.0,843.0
0.008,6,10,1990,5,911,2.0,643.0,643.0,5,1079,1.0,811.0,811.0
0.097,6,10,1506,5,395,20.0,127.0,127.0,5,1111,22.0,843.0,843.0
0.005,6,10,2007,5,928,1.0,660.0,660.0,5,1079,1.0,811.0,811.0
0.007,17,2,180,1,66,0.0,38.0,38.0,1,114,0.0,86.0,86.0
409.36,6,23,4663,13,2427,34113.0,676.0,348.0,10,2236,38816.0,824.0,427.0
0.003,17,2,148,1,60,0.0,32.0,32.0,1,88,0.0,60.0,60.0
0.009,6,10,1989,5,910,2.0,642.0,642.0,5,1079,2.0,811.0,811.0
0.005,6,10,1989,5,927,1.0,659.0,659.0,5,1062,1.0,794.0,794.0
0.01,6,10,1631,5,848,2.0,580.0,580.0,5,783,2.0,515.0,515.0
1742.571,6,304,97517,187,86386,9368.0,2001.0,684.0,117,11131,15022.0,452.0,70.0
176.098,17,74,10645,37,2458,4891.0,44.0,38.0,37,8187,4891.0,239.0,193.0
0.113,6,10,1506,5,395,22.0,127.0,127.0,5,1111,25.0,843.0,843.0
0.012,6,10,1989,5,910,2.0,642.0,642.0,5,1079,2.0,811.0,811.0
65.799,6,46,18213,23,12266,413.0,3311.0,1414.0,23,5947,2983.0,2667.0,385.0
0.005,17,2,179,1,71,0.0,43.0,43.0,1,108,0.0,80.0,80.0
0.007,6,12,1698,6,863,1.0,327.0,271.0,6,835,1.0,515.0,515.0
240.009,6,9,787,5,488,60002.0,232.0,232.0,4,299,80001.0,83.0,83.0
0.003,17,2,148,1,60,0.0,32.0,32.0,1,88,0.0,60.0,60.0
0.104,6,10,1506,5,395,20.0,127.0,127.0,5,1111,22.0,843.0,843.0
0.011,6,10,1631,5,848,2.0,580.0,580.0,5,783,2.0,515.0,515.0
0.005,6,10,2000,5,927,1.0,659.0,659.0,5,1073,1.0,805.0,805.0
0.004,17,2,148,1,60,0.0,32.0,32.0,1,88,0.0,60.0,60.0
0.014,6,14,3799,7,509,2.0,137.0,137.0,7,3290,2.0,1448.0,972.0
0.007,17,2,164,1,74,0.0,46.0,46.0,1,90,0.0,62.0,62.0
0.007,17,2,194,1,59,0.0,31.0,31.0,1,135,0.0,107.0,107.0
311.739,17,19,1084,10,716,34637.0,48.0,43.0,9,368,33384.0,20.0,12.0
0.01,6,10,1989,5,910,2.0,642.0,642.0,5,1079,2.0,811.0,811.0
0.019,6,10,1990,5,911,4.0,643.0,643.0,5,1079,4.0,811.0,811.0
300.404,6,16,2170,9,684,37529.0,146.0,146.0,7,1486,50039.0,419.0,398.0
0.006,6,10,1547,5,764,1.0,496.0,496.0,5,783,1.0,515.0,515.0
0.008,6,10,2006,5,927,2.0,659.0,659.0,5,1079,2.0,811.0,811.0
0.036,6,10,1989,5,910,9.0,642.0,642.0,5,1079,9.0,811.0,811.0
0.01,6,14,3787,7,497,1.0,125.0,125.0,7,3290,1.0,1448.0,972.0
0.006,17,2,170,1,65,0.0,37.0,37.0,1,105,0.0,77.0,77.0
0.119,6,10,1506,5,395,29.0,127.0,127.0,5,1111,25.0,843.0,843.0
0.001,17,2,180,1,66,0.0,38.0,38.0,1,114,0.0,86.0,86.0
40.06,17,10,676,5,460,10013.0,104.0,64.0,5,216,10014.0,20.0,15.0
0.018,6,10,1983,5,910,4.0,642.0,642.0,5,1073,4.0,805.0,805.0
0.008,6,10,1989,5,910,2.0,642.0,642.0,5,1079,2.0,811.0,811.0
0.006,17,2,140,1,62,0.0,34.0,34.0,1,78,0.0,50.0,50.0
0.005,6,10,2000,5,927,1.0,659.0,659.0,5,1073,1.0,805.0,805.0
0.008,6,12,1926,6,1189,1.0,659.0,434.0,6,737,1.0,417.0,417.0
0.006,6,10,1643,5,860,1.0,592.0,592.0,5,783,1.0,515.0,515.0
0.04,17,2,166,1,75,0.0,47.0,47.0,1,91,0.0,63.0,63.0
0.015,6,10,1983,5,910,3.0,642.0,642.0,5,1073,3.0,805.0,805.0
0.006,6,10,1547,5,764,1.0,496.0,496.0,5,783,1.0,515.0,515.0
0.006,6,10,1547,5,764,1.0,496.0,496.0,5,783,1.0,515.0,515.0
0.001,17,2,234,1,61,0.0,33.0,33.0,1,173,0.0,145.0,145.0
10.829,17,28,4424,14,1995,824.0,270.0,114.0,14,2429,824.0,588.0,145.0
0.001,17,2,136,1,60,0.0,32.0,32.0,1,76,0.0,48.0,48.0
0.005,17,2,166,1,75,0.0,47.0,47.0,1,91,0.0,63.0,63.0
0.005,17,2,170,1,65,0.0,37.0,37.0,1,105,0.0,77.0,77.0
0.006,6,10,2000,5,927,1.0,659.0,659.0,5,1073,1.0,805.0,805.0
40.063,17,10,676,5,460,10015.0,104.0,64.0,5,216,10015.0,20.0,15.0
0.16,6,10,1506,5,395,37.0,127.0,127.0,5,1111,36.0,843.0,843.0
0.005,17,2,154,1,69,0.0,41.0,41.0,1,85,0.0,57.0,57.0
0.038,17,2,166,1,75,0.0,47.0,47.0,1,91,0.0,63.0,63.0
40.071,17,10,676,5,460,10015.0,104.0,64.0,5,216,10013.0,20.0,15.0
0.006,17,2,136,1,60,0.0,32.0,32.0,1,76,0.0,48.0,48.0
0.004,17,2,152,1,76,0.0,48.0,48.0,1,76,0.0,48.0,48.0
0.005,6,10,1989,5,927,1.0,659.0,659.0,5,1062,1.0,794.0,794.0
0.001,17,2,180,1,66,0.0,38.0,38.0,1,114,0.0,86.0,86.0
15.119,17,18,12074,10,8344,1676.0,1350.0,806.0,8,3730,2155.0,1350.0,438.0
300.282,6,27,7433,16,1409,20018.0,217.0,142.0,11,6024,24024.0,1679.0,777.0
0.004,17,2,208,1,72,0.0,44.0,44.0,1,136,0.0,108.0,108.0
0.005,6,13,3690,7,452,0.0,80.0,80.0,6,3238,1.0,1470.0,1459.0
0.003,17,4,284,2,120,0.0,32.0,32.0,2,164,0.0,60.0,54.0
0.103,6,10,1506,5,395,22.0,127.0,127.0,5,1111,23.0,843.0,843.0
0.008,6,10,1631,5,848,2.0,580.0,580.0,5,783,1.0,515.0,515.0
366.188,6,22,2313,16,867,24412.0,195.0,195.0,6,1446,4667.0,419.0,398.0
40.06,17,10,676,5,460,10013.0,104.0,64.0,5,216,10014.0,20.0,15.0
40.054,17,10,676,5,460,10012.0,104.0,64.0,5,216,10012.0,20.0,15.0
0.009,6,10,1989,5,910,2.0,642.0,642.0,5,1079,2.0,811.0,811.0
0.004,6,10,2000,5,927,1.0,659.0,659.0,5,1073,1.0,805.0,805.0
290.814,6,414,349848,211,22531,1384.0,2736.0,889.0,203,327317,1439.0,2769.0,1675.0
0.009,6,14,3787,7,497,1.0,125.0,125.0,7,3290,1.0,1448.0,972.0
0.005,6,10,1779,5,928,1.0,660.0,660.0,5,851,1.0,583.0,583.0
0.001,17,2,136,1,60,0.0,32.0,32.0,1,76,0.0,48.0,48.0
0.148,6,10,1506,5,395,31.0,127.0,127.0,5,1111,35.0,843.0,843.0
0.01,6,12,1926,6,1189,2.0,659.0,434.0,6,737,1.0,417.0,417.0
0.01,6,10,1972,5,910,2.0,642.0,642.0,5,1062,2.0,794.0,794.0
0.004,6,10,2006,5,927,1.0,659.0,659.0,5,1079,1.0,811.0,811.0
0.008,6,10,1989,5,910,2.0,642.0,642.0,5,1079,2.0,811.0,811.0
0.167,17,2,152,1,76,0.0,48.0,48.0,1,76,0.0,48.0,48.0
0.005,6,10,2000,5,927,1.0,659.0,659.0,5,1073,1.0,805.0,805.0
0.006,17,2,170,1,65,0.0,37.0,37.0,1,105,0.0,77.0,77.0
0.006,17,2,170,1,65,0.0,37.0,37.0,1,105,0.0,77.0,77.0
0.01,6,10,1990,5,911,2.0,643.0,643.0,5,1079,2.0,811.0,811.0
1797.558,17,2958,226543,1474,119403,1220.0,84.0,53.0,1484,107140,1212.0,225.0,44.0
0.08,6,10,1506,5,395,19.0,127.0,127.0,5,1111,15.0,843.0,843.0
0.019,6,10,1677,5,827,4.0,559.0,559.0,5,850,4.0,582.0,582.0
0.013,6,10,1989,5,910,3.0,642.0,642.0,5,1079,3.0,811.0,811.0
0.01,17,2,168,1,76,0.0,48.0,48.0,1,92,0.0,64.0,64.0
0.005,17,2,179,1,71,0.0,43.0,43.0,1,108,0.0,80.0,80.0
0.093,6,10,1506,5,395,21.0,127.0,127.0,5,1111,20.0,843.0,843.0
0.005,17,2,273,1,66,0.0,38.0,38.0,1,207,0.0,179.0,179.0
0.089,6,10,1506,5,395,20.0,127.0,127.0,5,1111,18.0,843.0,843.0
0.079,6,10,1506,5,395,16.0,127.0,127.0,5,1111,16.0,843.0,843.0
0.084,6,10,1506,5,395,18.0,127.0,127.0,5,1111,16.0,843.0,843.0
0.005,6,10,1689,5,839,1.0,571.0,571.0,5,850,1.0,582.0,582.0
240.104,6,16,4481,9,963,30013.0,238.0,166.0,7,3518,40016.0,1402.0,786.0
0.09,6,10,1506,5,395,18.0,127.0,127.0,5,1111,18.0,843.0,843.0
0.003,17,2,186,1,61,0.0,33.0,33.0,1,125,0.0,97.0,97.0
0.003,17,2,136,1,60,0.0,32.0,32.0,1,76,0.0,48.0,48.0
0.008,6,10,1854,5,889,2.0,621.0,621.0,5,965,1.0,697.0,697.0
240.071,6,21,4926,11,941,24007.0,180.0,93.0,10,3985,26674.0,1593.0,576.0
0.006,6,10,1689,5,839,1.0,571.0,571.0,5,850,1.0,582.0,582.0
0.008,6,10,1972,5,910,2.0,642.0,642.0,5,1062,2.0,794.0,794.0
0.013,6,13,3735,7,497,2.0,125.0,125.0,6,3238,2.0,1470.0,1459.0
0.003,17,2,136,1,60,0.0,32.0,32.0,1,76,0.0,48.0,48.0
0.013,6,10,1989,5,910,3.0,642.0,642.0,5,1079,3.0,811.0,811.0
0.004,6,10,1774,5,923,1.0,655.0,655.0,5,851,1.0,583.0,583.0
280.269,6,22,6035,9,1146,35033.0,267.0,156.0,13,4889,23355.0,1400.0,873.0
0.02,6,10,1989,5,910,5.0,642.0,642.0,5,1079,5.0,811.0,811.0
0.005,6,10,2000,5,927,1.0,659.0,659.0,5,1073,1.0,805.0,805.0
0.004,17,2,136,1,60,0.0,32.0,32.0,1,76,0.0,48.0,48.0
0.005,6,10,2007,5,928,1.0,660.0,660.0,5,1079,1.0,811.0,811.0
0.005,6,10,2006,5,927,1.0,659.0,659.0,5,1079,1.0,811.0,811.0
0.139,6,10,1506,5,395,20.0,127.0,127.0,5,1111,32.0,843.0,843.0
0.009,6,10,1643,5,860,2.0,592.0,592.0,5,783,2.0,515.0,515.0
0.005,6,10,2006,5,927,1.0,659.0,659.0,5,1079,1.0,811.0,811.0
0.011,6,10,1989,5,910,2.0,642.0,642.0,5,1079,2.0,811.0,811.0
0.007,6,10,1547,5,764,1.0,496.0,496.0,5,783,1.0,515.0,515.0
0.016,17,2,198,1,91,0.0,63.0,63.0,1,107,0.0,79.0,79.0
40.064,17,10,676,5,460,10015.0,104.0,64.0,5,216,10015.0,20.0,15.0
0.007,17,2,234,1,61,0.0,33.0,33.0,1,173,0.0,145.0,145.0
0.005,6,10,2006,5,927,1.0,659.0,659.0,5,1079,1.0,811.0,811.0
0.042,17,2,170,1,65,0.0,37.0,37.0,1,105,0.0,77.0,77.0
0.098,6,10,1506,5,395,17.0,127.0,127.0,5,1111,21.0,843.0,843.0
0.006,6,10,1547,5,764,1.0,496.0,496.0,5,783,1.0,515.0,515.0
0.009,6,13,3735,7,497,1.0,125.0,125.0,6,3238,1.0,1470.0,1459.0
0.004,6,13,3690,7,452,0.0,80.0,80.0,6,3238,0.0,1470.0,1459.0
0.113,6,10,1506,5,395,26.0,127.0,127.0,5,1111,25.0,843.0,843.0
0.009,6,10,2006,5,927,2.0,659.0,659.0,5,1079,2.0,811.0,811.0
0.006,6,10,1689,5,839,1.0,571.0,571.0,5,850,1.0,582.0,582.0
0.01,6,10,1631,5,848,2.0,580.0,580.0,5,783,2.0,515.0,515.0
0.003,17,2,148,1,60,0.0,32.0,32.0,1,88,0.0,60.0,60.0
15.154,17,19,8747,9,6195,1888.0,1350.0,660.0,10,2552,1679.0,1350.0,227.0
0.005,6,10,1547,5,764,1.0,496.0,496.0,5,783,1.0,515.0,515.0
0.004,17,2,136,1,60,0.0,32.0,32.0,1,76,0.0,48.0,48.0
0.035,6,10,1631,5,848,8.0,580.0,580.0,5,783,8.0,515.0,515.0
10.845,17,28,4422,14,1994,825.0,269.0,114.0,14,2428,825.0,587.0,145.0
0.006,6,10,2007,5,928,1.0,660.0,660.0,5,1079,1.0,811.0,811.0
0.011,6,10,1989,5,910,2.0,642.0,642.0,5,1079,2.0,811.0,811.0
0.005,17,2,136,1,60,0.0,32.0,32.0,1,76,0.0,48.0,48.0
0.01,6,12,1926,6,1189,1.0,659.0,434.0,6,737,1.0,417.0,417.0
0.004,6,10,1989,5,927,1.0,659.0,659.0,5,1062,1.0,794.0,794.0
1757.278,6,64,7347,42,4470,42860.0,1626.0,108.0,22,2877,83670.0,1113.0,82.0
0.233,6,16,2777,8,1395,33.0,533.0,323.0,8,1382,21.0,529.0,239.0
0.009,6,10,1989,5,910,2.0,642.0,642.0,5,1079,2.0,811.0,811.0
0.074,6,10,1506,5,395,16.0,127.0,127.0,5,1111,17.0,843.0,843.0
0.111,6,10,1506,5,395,25.0,127.0,127.0,5,1111,24.0,843.0,843.0
0.005,17,2,175,1,65,0.0,37.0,37.0,1,110,0.0,82.0,82.0
0.005,17,2,164,1,74,0.0,46.0,46.0,1,90,0.0,62.0,62.0
0.004,17,4,420,2,122,1.0,33.0,33.0,2,298,0.0,145.0,121.0
0.022,6,10,1990,5,911,5.0,643.0,643.0,5,1079,5.0,811.0,811.0
0.009,6,10,1989,5,910,2.0,642.0,642.0,5,1079,2.0,811.0,811.0
10.932,17,28,4422,14,1995,832.0,270.0,114.0,14,2427,832.0,586.0,145.0
0.006,6,12,1698,6,863,1.0,327.0,271.0,6,835,1.0,515.0,515.0
0.004,6,10,1702,5,863,1.0,595.0,595.0,5,839,0.0,571.0,571.0
0.016,6,10,1677,5,827,4.0,559.0,559.0,5,850,4.0,582.0,582.0
15.094,17,15,8855,8,6589,2152.0,1350.0,795.0,7,2266,2510.0,1350.0,295.0
0.005,6,10,1989,5,927,1.0,659.0,659.0,5,1062,1.0,794.0,794.0
163.522,17,72,10304,36,2410,4671.0,44.0,38.0,36,7894,4671.0,239.0,191.0
1789.242,6,68,7552,42,4469,43640.0,1625.0,108.0,26,3083,71563.0,1111.0,82.0
0.006,17,2,170,1,65,0.0,37.0,37.0,1,105,0.0,77.0,77.0
0.008,6,10,2006,5,927,2.0,659.0,659.0,5,1079,1.0,811.0,811.0
15.073,17,15,9238,8,6902,2149.0,1350.0,834.0,7,2336,2507.0,1350.0,305.0
0.001,17,2,179,1,62,0.0,34.0,34.0,1,117,0.0,89.0,89.0
0.265,17,40,21636,22,18422,12.0,1350.0,809.0,18,3214,12.0,1350.0,150.0
290.358,6,382,347033,188,21350,1552.0,2696.0,889.0,194,325683,1504.0,2804.0,1753.0
0.005,6,10,2007,5,928,1.0,660.0,660.0,5,1079,1.0,811.0,811.0
0.006,6,10,2007,5,928,1.0,660.0,660.0,5,1079,1.0,811.0,811.0
0.009,6,10,1972,5,910,2.0,642.0,642.0,5,1062,2.0,794.0,794.0
0.005,6,10,1989,5,927,1.0,659.0,659.0,5,1062,1.0,794.0,794.0
0.006,6,10,1547,5,764,1.0,496.0,496.0,5,783,1.0,515.0,515.0
1796.864,17,2613,200058,1301,105412,1382.0,84.0,53.0,1312,94646,1370.0,227.0,44.0
0.016,6,10,1990,5,911,3.0,643.0,643.0,5,1079,4.0,811.0,811.0
0.071,6,10,1506,5,395,14.0,127.0,127.0,5,1111,14.0,843.0,843.0
0.018,6,10,1631,5,848,4.0,580.0,580.0,5,783,4.0,515.0,515.0
0.041,17,2,182,1,65,0.0,37.0,37.0,1,117,0.0,89.0,89.0
0.016,6,10,1762,5,911,4.0,643.0,643.0,5,851,3.0,583.0,583.0
0.014,6,10,1972,5,910,3.0,642.0,642.0,5,1062,3.0,794.0,794.0
15.075,17,15,8821,8,6804,2149.0,1350.0,822.0,7,2017,2507.0,1350.0,260.0
0.004,6,10,1779,5,928,1.0,660.0,660.0,5,851,1.0,583.0,583.0
0.073,6,10,1506,5,395,13.0,127.0,127.0,5,1111,16.0,843.0,843.0
0.285,17,43,21788,23,18487,11.0,1350.0,775.0,20,3301,13.0,1350.0,137.0
0.006,6,10,2007,5,928,1.0,660.0,660.0,5,1079,1.0,811.0,811.0
0.106,6,10,1506,5,395,23.0,127.0,127.0,5,1111,23.0,843.0,843.0
0.079,6,10,1506,5,395,19.0,127.0,127.0,5,1111,17.0,843.0,843.0
0.005,6,10,2006,5,927,1.0,659.0,659.0,5,1079,1.0,811.0,811.0
0.013,6,10,1983,5,910,3.0,642.0,642.0,5,1073,3.0,805.0,805.0
0.011,6,10,1989,5,910,2.0,642.0,642.0,5,1079,2.0,811.0,811.0
0.015,6,13,3735,7,497,2.0,125.0,125.0,6,3238,2.0,1470.0,1459.0
0.006,17,2,179,1,71,0.0,43.0,43.0,1,108,0.0,80.0,80.0
0.125,6,10,1506,5,395,28.0,127.0,127.0,5,1111,27.0,843.0,843.0
0.006,6,10,1989,5,927,1.0,659.0,659.0,5,1062,1.0,794.0,794.0
0.041,17,2,148,1,60,0.0,32.0,32.0,1,88,0.0,60.0,60.0
40.056,17,10,676,5,460,10013.0,104.0,64.0,5,216,10012.0,20.0,15.0
0.005,6,10,2006,5,927,1.0,659.0,659.0,5,1079,1.0,811.0,811.0
0.014,6,10,1990,5,911,3.0,643.0,643.0,5,1079,3.0,811.0,811.0
0.005,6,10,2006,5,927,1.0,659.0,659.0,5,1079,1.0,811.0,811.0
0.078,6,10,1506,5,395,18.0,127.0,127.0,5,1111,15.0,843.0,843.0
170.127,17,74,10588,37,2471,4725.0,44.0,38.0,37,8117,4725.0,261.0,191.0
0.004,17,4,284,2,120,0.0,32.0,32.0,2,164,0.0,60.0,54.0
0.001,17,2,166,1,75,0.0,47.0,47.0,1,91,0.0,63.0,63.0
0.001,17,2,180,1,66,0.0,38.0,38.0,1,114,0.0,86.0,86.0
0.012,6,10,1990,5,911,2.0,643.0,643.0,5,1079,3.0,811.0,811.0
40.074,17,10,676,5,460,10015.0,104.0,64.0,5,216,10015.0,20.0,15.0
0.003,17,2,148,1,60,0.0,32.0,32.0,1,88,0.0,60.0,60.0
0.125,6,10,1506,5,395,28.0,127.0,127.0,5,1111,27.0,843.0,843.0
0.003,17,2,136,1,60,0.0,32.0,32.0,1,76,0.0,48.0,48.0
351.99,6,20,2210,6,1308,12003.0,494.0,494.0,14,902,27075.0,83.0,83.0
0.017,6,10,1989,5,910,4.0,642.0,642.0,5,1079,4.0,811.0,811.0
0.005,17,2,214,1,75,0.0,47.0,47.0,1,139,0.0,111.0,111.0
0.001,17,2,136,1,60,0.0,32.0,32.0,1,76,0.0,48.0,48.0
0.011,6,10,1989,5,910,2.0,642.0,642.0,5,1079,2.0,811.0,811.0
0.003,17,2,148,1,60,0.0,32.0,32.0,1,88,0.0,60.0,60.0
0.004,6,10,1702,5,863,1.0,595.0,595.0,5,839,1.0,571.0,571.0
0.006,17,2,230,1,68,0.0,40.0,40.0,1,162,0.0,134.0,134.0
0.001,17,2,164,1,74,0.0,46.0,46.0,1,90,0.0,62.0,62.0
0.081,6,10,1506,5,395,16.0,127.0,127.0,5,1111,19.0,843.0,843.0
0.041,17,2,148,1,60,0.0,32.0,32.0,1,88,0.0,60.0,60.0
0.013,6,10,1972,5,910,3.0,642.0,642.0,5,1062,3.0,794.0,794.0
177.382,17,74,10381,37,2464,4926.0,44.0,38.0,37,7917,4927.0,239.0,185.0
0.004,17,4,284,2,120,1.0,32.0,32.0,2,164,0.0,60.0,54.0
0.068,6,10,1506,5,395,15.0,127.0,127.0,5,1111,16.0,843.0,843.0
0.004,6,10,1989,5,927,1.0,659.0,659.0,5,1062,1.0,794.0,794.0
0.005,6,10,2000,5,927,1.0,659.0,659.0,5,1073,1.0,805.0,805.0
0.005,6,10,1689,5,839,1.0,571.0,571.0,5,850,1.0,582.0,582.0
0.001,17,2,180,1,66,0.0,38.0,38.0,1,114,0.0,86.0,86.0
15.07,17,15,9238,8,6902,2148.0,1350.0,834.0,7,2336,2506.0,1350.0,305.0
15.073,17,15,9238,8,6902,2149.0,1350.0,834.0,7,2336,2507.0,1350.0,305.0
314.579,17,20,1124,10,716,34938.0,48.0,43.0,10,408,34939.0,20.0,12.0
0.003,17,2,152,1,76,0.0,48.0,48.0,1,76,0.0,48.0,48.0
0.012,6,10,1972,5,910,3.0,642.0,642.0,5,1062,3.0,794.0,794.0
0.014,6,10,1990,5,911,3.0,643.0,643.0,5,1079,3.0,811.0,811.0
0.008,6,13,3735,7,497,1.0,125.0,125.0,6,3238,1.0,1470.0,1459.0
0.001,17,2,180,1,66,0.0,38.0,38.0,1,114,0.0,86.0,86.0
0.012,6,10,1983,5,910,2.0,642.0,642.0,5,1073,2.0,805.0,805.0
0.006,17,2,168,1,76,0.0,48.0,48.0,1,92,0.0,64.0,64.0
0.001,17,2,166,1,75,0.0,47.0,47.0,1,91,0.0,63.0,63.0
176.033,17,80,11360,40,2666,4513.0,44.0,38.0,40,8694,4513.0,239.0,189.0
0.112,6,10,1506,5,395,24.0,127.0,127.0,5,1111,27.0,843.0,843.0
311.211,17,20,1124,10,716,34564.0,48.0,43.0,10,408,34565.0,20.0,12.0
0.11,6,10,1506,5,395,26.0,127.0,127.0,5,1111,23.0,843.0,843.0
600.461,6,46,16401,24,4803,26106.0,676.0,443.0,22,11598,28592.0,1402.0,804.0
0.012,6,10,1989,5,910,3.0,642.0,642.0,5,1079,3.0,811.0,811.0
0.005,6,10,2000,5,927,1.0,659.0,659.0,5,1073,1.0,805.0,805.0
0.006,6,10,1689,5,839,1.0,571.0,571.0,5,850,1.0,582.0,582.0
0.038,17,2,148,1,60,0.0,32.0,32.0,1,88,0.0,60.0,60.0
174.124,17,88,12762,44,2969,4049.0,44.0,39.0,44,9793,4049.0,239.0,194.0
40.069,17,10,676,5,460,10016.0,104.0,64.0,5,216,10016.0,20.0,15.0
40.071,17,10,676,5,460,10016.0,104.0,64.0,5,216,10007.0,20.0,15.0
0.125,6,10,1506,5,395,28.0,127.0,127.0,5,1111,27.0,843.0,843.0
0.005,6,10,1989,5,927,1.0,659.0,659.0,5,1062,1.0,794.0,794.0
0.009,6,10,1989,5,910,2.0,642.0,642.0,5,1079,2.0,811.0,811.0
0.193,6,46,11684,25,3303,8.0,1020.0,182.0,21,8381,9.0,1402.0,606.0
0.005,6,10,2006,5,927,1.0,659.0,659.0,5,1079,1.0,811.0,811.0
0.005,6,10,2007,5,928,1.0,660.0,660.0,5,1079,1.0,811.0,811.0
0.075,6,10,1506,5,395,16.0,127.0,127.0,5,1111,17.0,843.0,843.0
0.168,17,2,152,1,76,0.0,48.0,48.0,1,76,0.0,48.0,48.0
0.005,6,10,1989,5,927,1.0,659.0,659.0,5,1062,1.0,794.0,794.0
0.011,6,10,1762,5,911,2.0,643.0,643.0,5,851,2.0,583.0,583.0
0.007,6,10,1989,5,910,1.0,642.0,642.0,5,1079,1.0,811.0,811.0
0.005,6,13,3860,7,622,0.0,250.0,250.0,6,3238,1.0,1470.0,1459.0
0.016,6,10,1989,5,910,4.0,642.0,642.0,5,1079,3.0,811.0,811.0
40.06,17,10,676,5,460,10014.0,104.0,64.0,5,216,10014.0,20.0,15.0
0.01,6,10,1983,5,910,2.0,642.0,642.0,5,1073,2.0,805.0,805.0
0.014,6,10,1989,5,910,3.0,642.0,642.0,5,1079,3.0,811.0,811.0
0.087,6,10,1506,5,395,20.0,127.0,127.0,5,1111,20.0,843.0,843.0
0.01,6,10,1972,5,910,2.0,642.0,642.0,5,1062,2.0,794.0,794.0
40.067,17,10,676,5,460,10015.0,104.0,64.0,5,216,10014.0,20.0,15.0
167.158,17,74,10605,37,2486,4643.0,44.0,39.0,37,8119,4642.0,239.0,191.0
0.042,17,2,152,1,76,0.0,48.0,48.0,1,76,0.0,48.0,48.0
40.064,17,10,676,5,460,10015.0,104.0,64.0,5,216,10015.0,20.0,15.0
0.006,6,10,1547,5,764,1.0,496.0,496.0,5,783,1.0,515.0,515.0
0.012,6,10,1989,5,910,3.0,642.0,642.0,5,1079,2.0,811.0,811.0
0.017,17,2,198,1,91,0.0,63.0,63.0,1,107,0.0,79.0,79.0
1777.255,17,144,45504,72,22752,25024.0,288.0,288.0,72,22752,25021.0,288.0,288.0
240.086,6,16,4481,9,963,30010.0,238.0,166.0,7,3518,40013.0,1402.0,786.0
0.005,6,10,1643,5,860,1.0,592.0,592.0,5,783,1.0,515.0,515.0
0.004,6,10,2000,5,927,1.0,659.0,659.0,5,1073,1.0,805.0,805.0
0.005,6,10,1547,5,764,1.0,496.0,496.0,5,783,1.0,515.0,515.0
0.227,6,16,2777,8,1395,32.0,533.0,323.0,8,1382,20.0,529.0,239.0
0.118,6,10,1506,5,395,28.0,127.0,127.0,5,1111,25.0,843.0,843.0
0.005,6,10,1643,5,860,1.0,592.0,592.0,5,783,1.0,515.0,515.0
0.013,6,14,3787,7,497,2.0,125.0,125.0,7,3290,2.0,1448.0,972.0
0.1,6,10,1506,5,395,21.0,127.0,127.0,5,1111,23.0,843.0,843.0
0.011,6,10,1983,5,910,2.0,642.0,642.0,5,1073,2.0,805.0,805.0
309.224,17,20,1124,10,716,34343.0,48.0,43.0,10,408,34343.0,20.0,12.0
0.091,6,10,1506,5,395,18.0,127.0,127.0,5,1111,19.0,843.0,843.0
0.014,6,10,1983,5,910,3.0,642.0,642.0,5,1073,3.0,805.0,805.0
0.012,6,10,1983,5,910,3.0,642.0,642.0,5,1073,3.0,805.0,805.0
0.109,6,10,1506,5,395,23.0,127.0,127.0,5,1111,23.0,843.0,843.0
0.005,6,10,1689,5,839,1.0,571.0,571.0,5,850,1.0,582.0,582.0
0.163,6,10,1506,5,395,35.0,127.0,127.0,5,1111,38.0,843.0,843.0
0.13,6,10,1506,5,395,29.0,127.0,127.0,5,1111,30.0,843.0,843.0
0.017,6,10,1990,5,911,4.0,643.0,643.0,5,1079,4.0,811.0,811.0
0.086,6,10,1506,5,395,19.0,127.0,127.0,5,1111,19.0,843.0,843.0
0.012,17,2,179,1,71,0.0,43.0,43.0,1,108,0.0,80.0,80.0
0.17,6,3,453,2,321,170.0,241.0,241.0,1,132,0.0,92.0,92.0
10.868,17,28,4421,14,1994,827.0,269.0,114.0,14,2427,827.0,586.0,145.0
329.204,17,20,1124,10,716,36564.0,48.0,43.0,10,408,36563.0,20.0,12.0
0.097,6,10,1506,5,395,21.0,127.0,127.0,5,1111,19.0,843.0,843.0
10.955,17,27,4366,13,1937,901.0,269.0,121.0,14,2429,832.0,588.0,145.0
0.015,6,10,1631,5,848,3.0,580.0,580.0,5,783,3.0,515.0,515.0
0.007,6,10,1989,5,910,1.0,642.0,642.0,5,1079,1.0,811.0,811.0
0.083,6,10,1506,5,395,19.0,127.0,127.0,5,1111,16.0,843.0,843.0
65.966,6,22,8896,12,2328,5996.0,1002.0,424.0,10,6568,7311.0,2241.0,1006.0
0.068,6,10,1506,5,395,16.0,127.0,127.0,5,1111,14.0,843.0,843.0
1762.227,6,64,7344,42,4469,42981.0,1625.0,108.0,22,2875,83907.0,1111.0,82.0
0.008,6,10,1989,5,910,1.0,642.0,642.0,5,1079,2.0,811.0,811.0
0.014,6,10,1989,5,910,3.0,642.0,642.0,5,1079,3.0,811.0,811.0
0.094,6,10,1506,5,395,20.0,127.0,127.0,5,1111,21.0,843.0,843.0
0.012,6,10,1989,5,910,3.0,642.0,642.0,5,1079,3.0,811.0,811.0
361.811,6,21,1792,16,1030,24120.0,190.0,190.0,5,762,60011.0,461.0,247.0
0.015,6,10,1989,5,910,3.0,642.0,642.0,5,1079,3.0,811.0,811.0
0.012,6,10,1677,5,827,3.0,559.0,559.0,5,850,3.0,582.0,582.0
0.018,6,10,1989,5,910,4.0,642.0,642.0,5,1079,4.0,811.0,811.0
0.009,6,10,1990,5,911,2.0,643.0,643.0,5,1079,2.0,811.0,811.0
0.003,17,2,136,1,60,0.0,32.0,32.0,1,76,0.0,48.0,48.0
0.006,6,10,1854,5,889,1.0,621.0,621.0,5,965,1.0,697.0,697.0
0.006,6,10,1689,5,839,1.0,571.0,571.0,5,850,1.0,582.0,582.0
0.004,6,10,2006,5,927,1.0,659.0,659.0,5,1079,1.0,811.0,811.0
0.037,17,2,182,1,65,0.0,37.0,37.0,1,117,0.0,89.0,89.0
40.093,17,10,676,5,460,10018.0,104.0,64.0,5,216,10022.0,20.0,15.0
0.012,6,10,1972,5,910,3.0,642.0,642.0,5,1062,3.0,794.0,794.0
0.005,6,10,1989,5,927,1.0,659.0,659.0,5,1062,1.0,794.0,794.0
40.072,17,10,676,5,460,10016.0,104.0,64.0,5,216,10017.0,20.0,15.0
0.009,6,10,1983,5,910,2.0,642.0,642.0,5,1073,2.0,805.0,805.0
0.006,6,10,2007,5,928,1.0,660.0,660.0,5,1079,1.0,811.0,811.0
0.011,6,10,1989,5,910,2.0,642.0,642.0,5,1079,2.0,811.0,811.0
0.017,6,10,1762,5,911,4.0,643.0,643.0,5,851,4.0,583.0,583.0
0.006,6,10,1689,5,839,1.0,571.0,571.0,5,850,1.0,582.0,582.0
0.008,6,10,1989,5,910,2.0,642.0,642.0,5,1079,1.0,811.0,811.0
0.012,6,10,1983,5,910,2.0,642.0,642.0,5,1073,2.0,805.0,805.0
30.041,6,12,1310,7,557,5006.0,185.0,185.0,5,753,7501.0,473.0,242.0
0.081,6,10,1506,5,395,17.0,127.0,127.0,5,1111,17.0,843.0,843.0
0.005,6,14,3736,7,446,0.0,74.0,74.0,7,3290,0.0,1448.0,972.0
0.004,6,10,1774,5,923,1.0,655.0,655.0,5,851,1.0,583.0,583.0
0.015,6,10,1983,5,910,3.0,642.0,642.0,5,1073,3.0,805.0,805.0
9.038,17,6,376,5,280,2259.0,28.0,28.0,1,96,0.0,68.0,68.0
0.004,6,10,2000,5,927,1.0,659.0,659.0,5,1073,1.0,805.0,805.0
0.101,6,10,1506,5,395,23.0,127.0,127.0,5,1111,20.0,843.0,843.0
0.005,6,10,1689,5,839,1.0,571.0,571.0,5,850,1.0,582.0,582.0
0.018,6,10,1990,5,911,4.0,643.0,643.0,5,1079,4.0,811.0,811.0
0.219,17,19,9826,10,7360,24.0,1350.0,708.0,9,2466,19.0,1350.0,246.0
0.006,6,10,1547,5,764,1.0,496.0,496.0,5,783,1.0,515.0,515.0
0.026,6,10,1762,5,911,6.0,643.0,643.0,5,851,6.0,583.0,583.0
0.01,6,10,1972,5,910,2.0,642.0,642.0,5,1062,2.0,794.0,794.0
0.006,6,10,2006,5,927,1.0,659.0,659.0,5,1079,1.0,811.0,811.0
0.074,6,10,1506,5,395,15.0,127.0,127.0,5,1111,17.0,843.0,843.0
0.005,6,10,2007,5,928,1.0,660.0,660.0,5,1079,1.0,811.0,811.0
0.107,6,10,1506,5,395,20.0,127.0,127.0,5,1111,23.0,843.0,843.0
0.005,17,2,154,1,69,0.0,41.0,41.0,1,85,0.0,57.0,57.0
0.016,6,10,1972,5,910,3.0,642.0,642.0,5,1062,3.0,794.0,794.0
0.003,17,2,136,1,60,0.0,32.0,32.0,1,76,0.0,48.0,48.0
240.242,6,44,5604,23,2595,10919.0,588.0,197.0,21,3009,12012.0,580.0,238.0
0.005,17,2,230,1,68,0.0,40.0,40.0,1,162,0.0,134.0,134.0
0.006,6,10,1989,5,927,1.0,659.0,659.0,5,1062,1.0,794.0,794.0
54.831,6,48,19371,24,13613,396.0,2720.0,1262.0,24,5758,2376.0,2667.0,435.0
0.004,6,10,2006,5,927,1.0,659.0,659.0,5,1079,1.0,811.0,811.0
0.004,6,10,2007,5,928,1.0,660.0,660.0,5,1079,1.0,811.0,811.0
0.005,6,13,3690,7,452,0.0,80.0,80.0,6,3238,0.0,1470.0,1459.0
0.004,17,4,284,2,120,1.0,32.0,32.0,2,164,0.0,60.0,54.0
0.093,6,10,1506,5,395,20.0,127.0,127.0,5,1111,18.0,843.0,843.0
0.012,6,10,1677,5,827,3.0,559.0,559.0,5,850,3.0,582.0,582.0
0.02,6,10,1990,5,911,4.0,643.0,643.0,5,1079,5.0,811.0,811.0
0.103,6,10,1506,5,395,21.0,127.0,127.0,5,1111,23.0,843.0,843.0
174.085,17,76,10937,38,2530,4704.0,44.0,38.0,38,8407,4704.0,261.0,193.0
0.012,6,10,1990,5,911,3.0,643.0,643.0,5,1079,2.0,811.0,811.0
0.006,6,10,1989,5,927,1.0,659.0,659.0,5,1062,1.0,794.0,794.0
0.006,6,12,1698,6,863,1.0,327.0,271.0,6,835,1.0,515.0,515.0
0.004,6,10,1779,5,928,1.0,660.0,660.0,5,851,1.0,583.0,583.0
0.039,17,2,152,1,76,0.0,48.0,48.0,1,76,0.0,48.0,48.0
0.005,6,13,3747,7,509,0.0,137.0,137.0,6,3238,0.0,1470.0,1459.0
0.005,6,13,3747,7,509,0.0,137.0,137.0,6,3238,0.0,1470.0,1459.0
0.04,17,4,284,2,120,1.0,32.0,32.0,2,164,36.0,60.0,54.0
0.04,17,2,136,1,60,0.0,32.0,32.0,1,76,0.0,48.0,48.0
0.011,6,10,1972,5,910,2.0,642.0,642.0,5,1062,2.0,794.0,794.0
300.196,6,27,7436,16,1409,20013.0,217.0,142.0,11,6027,24018.0,1679.0,778.0
0.006,6,10,1854,5,889,1.0,621.0,621.0,5,965,1.0,697.0,697.0
0.015,6,10,1989,5,910,3.0,642.0,642.0,5,1079,3.0,811.0,811.0
0.005,6,10,1689,5,839,1.0,571.0,571.0,5,850,1.0,582.0,582.0
0.006,17,2,209,1,64,0.0,36.0,36.0,1,145,0.0,117.0,117.0
0.005,17,2,170,1,65,0.0,37.0,37.0,1,105,0.0,77.0,77.0
15.073,17,14,9190,8,6902,2149.0,1350.0,834.0,6,2288,3008.0,1350.0,353.0
0.005,17,2,144,1,64,0.0,36.0,36.0,1,80,0.0,52.0,52.0
0.123,6,10,1506,5,395,28.0,127.0,127.0,5,1111,29.0,843.0,843.0
0.009,6,10,1989,5,910,2.0,642.0,642.0,5,1079,2.0,811.0,811.0
0.042,17,2,186,1,61,0.0,33.0,33.0,1,125,0.0,97.0,97.0
0.043,17,2,152,1,76,0.0,48.0,48.0,1,76,0.0,48.0,48.0
0.008,17,2,136,1,60,0.0,32.0,32.0,1,76,0.0,48.0,48.0
0.005,6,10,2007,5,928,1.0,660.0,660.0,5,1079,1.0,811.0,811.0
0.005,6,10,1989,5,927,1.0,659.0,659.0,5,1062,1.0,794.0,794.0
0.005,6,10,2006,5,927,1.0,659.0,659.0,5,1079,1.0,811.0,811.0
0.004,6,10,2006,5,927,1.0,659.0,659.0,5,1079,1.0,811.0,811.0
0.102,6,10,1506,5,395,24.0,127.0,127.0,5,1111,23.0,843.0,843.0
353.49,6,20,2210,6,1308,12003.0,494.0,494.0,14,902,27191.0,83.0,83.0
40.057,17,10,676,5,460,10013.0,104.0,64.0,5,216,10013.0,20.0,15.0
0.005,6,10,2006,5,927,1.0,659.0,659.0,5,1079,1.0,811.0,811.0
0.013,6,10,1972,5,910,3.0,642.0,642.0,5,1062,3.0,794.0,794.0
27.242,6,37,12342,18,6784,523.0,4080.0,1508.0,19,5558,1504.0,2667.0,435.0
0.006,6,10,1854,5,889,1.0,621.0,621.0,5,965,1.0,697.0,697.0
322.295,17,20,1124,10,716,35796.0,48.0,43.0,10,408,35796.0,20.0,12.0
240.022,6,9,787,5,488,60005.0,232.0,232.0,4,299,80006.0,83.0,83.0
0.09,6,10,1506,5,395,18.0,127.0,127.0,5,1111,21.0,843.0,843.0
0.094,6,10,1506,5,395,21.0,127.0,127.0,5,1111,18.0,843.0,843.0
0.014,6,10,1989,5,910,3.0,642.0,642.0,5,1079,3.0,811.0,811.0
0.009,6,10,1990,5,911,2.0,643.0,643.0,5,1079,2.0,811.0,811.0
93.969,6,33,18696,19,12679,54.0,2720.0,1319.0,14,6017,7215.0,2720.0,907.0
0.03,6,10,1989,5,910,7.0,642.0,642.0,5,1079,7.0,811.0,811.0
0.004,6,10,2006,5,927,1.0,659.0,659.0,5,1079,1.0,811.0,811.0
0.005,6,10,2007,5,928,1.0,660.0,660.0,5,1079,1.0,811.0,811.0
240.091,6,31,9470,15,7013,17149.0,2137.0,693.0,16,2457,16005.0,580.0,202.0
0.003,17,2,148,1,60,0.0,32.0,32.0,1,88,0.0,60.0,60.0
0.11,6,10,1506,5,395,25.0,127.0,127.0,5,1111,25.0,843.0,843.0
0.102,6,10,1506,5,395,19.0,127.0,127.0,5,1111,20.0,843.0,843.0
0.006,6,10,2007,5,928,1.0,660.0,660.0,5,1079,1.0,811.0,811.0
40.062,17,10,676,5,460,10014.0,104.0,64.0,5,216,10014.0,20.0,15.0
0.066,6,10,1506,5,395,12.0,127.0,127.0,5,1111,14.0,843.0,843.0
0.005,6,10,1643,5,860,1.0,592.0,592.0,5,783,1.0,515.0,515.0
305.296,17,16,928,8,608,43595.0,48.0,48.0,8,320,43596.0,12.0,12.0
0.003,17,2,136,1,60,0.0,32.0,32.0,1,76,0.0,48.0,48.0
0.005,6,10,1989,5,927,1.0,659.0,659.0,5,1062,1.0,794.0,794.0
0.016,6,10,1990,5,911,4.0,643.0,643.0,5,1079,3.0,811.0,811.0
0.004,6,10,2006,5,927,1.0,659.0,659.0,5,1079,1.0,811.0,811.0
0.005,6,13,3747,7,509,0.0,137.0,137.0,6,3238,0.0,1470.0,1459.0
0.005,6,10,2007,5,928,1.0,660.0,660.0,5,1079,1.0,811.0,811.0
0.005,6,10,1689,5,839,1.0,571.0,571.0,5,850,1.0,582.0,582.0
240.225,6,41,5499,20,2430,12643.0,580.0,195.0,21,3069,12011.0,564.0,246.0
240.193,6,34,13202,17,7042,15012.0,2061.0,684.0,17,6160,15011.0,2379.0,585.0
0.005,6,13,3690,7,452,0.0,80.0,80.0,6,3238,0.0,1470.0,1459.0
0.133,6,10,1506,5,395,30.0,127.0,127.0,5,1111,31.0,843.0,843.0
0.19,17,4,596,2,122,147.0,33.0,33.0,2,474,151.0,323.0,209.0
9.037,17,6,376,5,280,2259.0,28.0,28.0,1,96,0.0,68.0,68.0
0.75,6,22,5072,11,1250,64.0,325.0,133.0,11,3822,64.0,1414.0,563.0
0.005,6,10,1854,5,889,1.0,621.0,621.0,5,965,1.0,697.0,697.0
0.005,6,10,1774,5,923,1.0,655.0,655.0,5,851,1.0,583.0,583.0
0.014,6,10,1972,5,910,3.0,642.0,642.0,5,1062,3.0,794.0,794.0
15.074,17,15,9239,8,6902,2149.0,1350.0,834.0,7,2337,2507.0,1350.0,305.0
0.006,6,10,2006,5,927,1.0,659.0,659.0,5,1079,1.0,811.0,811.0
0.007,17,2,160,1,72,0.0,44.0,44.0,1,88,0.0,60.0,60.0
0.017,6,10,1677,5,827,4.0,559.0,559.0,5,850,4.0,582.0,582.0
0.012,6,10,1983,5,910,2.0,642.0,642.0,5,1073,2.0,805.0,805.0
0.004,6,10,1989,5,927,1.0,659.0,659.0,5,1062,1.0,794.0,794.0
0.012,6,10,1989,5,910,3.0,642.0,642.0,5,1079,2.0,811.0,811.0
0.005,6,10,1854,5,889,1.0,621.0,621.0,5,965,1.0,697.0,697.0
0.004,6,10,2006,5,927,1.0,659.0,659.0,5,1079,1.0,811.0,811.0
0.004,6,10,1702,5,863,1.0,595.0,595.0,5,839,1.0,571.0,571.0
0.01,6,10,1631,5,848,2.0,580.0,580.0,5,783,2.0,515.0,515.0
0.07,17,8,3613,4,1874,23.0,1350.0,440.0,4,1739,12.0,1350.0,406.0
300.396,6,16,2170,9,684,37528.0,146.0,146.0,7,1486,50037.0,419.0,398.0
0.005,17,2,222,1,65,0.0,37.0,37.0,1,157,0.0,129.0,129.0
0.004,17,2,136,1,60,0.0,32.0,32.0,1,76,0.0,48.0,48.0
0.004,17,2,136,1,60,0.0,32.0,32.0,1,76,0.0,48.0,48.0
0.005,17,4,284,2,120,2.0,32.0,32.0,2,164,1.0,60.0,54.0
36.045,6,36,9704,18,4186,521.0,1753.0,858.0,18,5518,2110.0,2667.0,435.0
0.005,6,10,1989,5,927,1.0,659.0,659.0,5,1062,1.0,794.0,794.0
0.005,6,10,2006,5,927,1.0,659.0,659.0,5,1079,1.0,811.0,811.0
0.07,17,8,3613,4,1874,23.0,1350.0,440.0,4,1739,12.0,1350.0,406.0
0.005,6,10,2007,5,928,1.0,660.0,660.0,5,1079,1.0,811.0,811.0
240.016,6,9,787,5,488,60004.0,232.0,232.0,4,299,80004.0,83.0,83.0
0.004,17,2,136,1,60,0.0,32.0,32.0,1,76,0.0,48.0,48.0
0.09,6,10,1506,5,395,19.0,127.0,127.0,5,1111,19.0,843.0,843.0
300.022,6,12,1782,7,1348,50003.0,494.0,494.0,5,434,75004.0,83.0,83.0
0.118,6,10,1506,5,395,25.0,127.0,127.0,5,1111,24.0,843.0,843.0
0.005,6,10,1854,5,889,1.0,621.0,621.0,5,965,1.0,697.0,697.0
0.005,17,2,166,1,75,0.0,47.0,47.0,1,91,0.0,63.0,63.0
0.012,6,10,1983,5,910,3.0,642.0,642.0,5,1073,3.0,805.0,805.0
40.062,17,10,676,5,460,10013.0,104.0,64.0,5,216,10014.0,20.0,15.0
0.012,6,10,1990,5,911,2.0,643.0,643.0,5,1079,3.0,811.0,811.0
64.362,6,58,47037,29,26671,2298.0,2804.0,1677.0,29,20366,2294.0,2822.0,1178.0
0.005,6,10,2007,5,928,1.0,660.0,660.0,5,1079,1.0,811.0,811.0
0.011,6,10,1990,5,911,2.0,643.0,643.0,5,1079,2.0,811.0,811.0
10.878,17,26,4098,13,1822,897.0,269.0,112.0,13,2276,897.0,587.0,147.0
0.001,17,2,140,1,62,0.0,34.0,34.0,1,78,0.0,50.0,50.0
0.011,6,10,1990,5,911,2.0,643.0,643.0,5,1079,2.0,811.0,811.0
0.009,6,14,3787,7,497,1.0,125.0,125.0,7,3290,1.0,1448.0,972.0
0.005,6,10,2007,5,928,1.0,660.0,660.0,5,1079,1.0,811.0,811.0
0.17,6,10,1506,5,395,39.0,127.0,127.0,5,1111,38.0,843.0,843.0
240.096,6,16,4481,9,963,30012.0,238.0,166.0,7,3518,40015.0,1402.0,786.0
40.058,17,10,676,5,460,10013.0,104.0,64.0,5,216,10013.0,20.0,15.0
0.013,6,10,1990,5,911,3.0,643.0,643.0,5,1079,3.0,811.0,811.0
0.006,17,2,193,1,71,0.0,43.0,43.0,1,122,0.0,94.0,94.0
0.007,17,2,194,1,59,0.0,31.0,31.0,1,135,0.0,107.0,107.0
300.381,6,16,2170,9,684,37528.0,146.0,146.0,7,1486,50036.0,419.0,398.0
0.042,17,2,146,1,65,0.0,37.0,37.0,1,81,0.0,53.0,53.0
0.004,6,10,2007,5,928,1.0,660.0,660.0,5,1079,1.0,811.0,811.0
0.003,17,4,284,2,120,0.0,32.0,32.0,2,164,0.0,60.0,54.0
0.005,6,10,1689,5,839,1.0,571.0,571.0,5,850,1.0,582.0,582.0
0.006,6,10,1547,5,764,1.0,496.0,496.0,5,783,1.0,515.0,515.0
0.018,6,10,1989,5,927,4.0,659.0,659.0,5,1062,4.0,794.0,794.0
0.013,6,14,3787,7,497,2.0,125.0,125.0,7,3290,2.0,1448.0,972.0
0.006,6,10,2007,5,928,1.0,660.0,660.0,5,1079,1.0,811.0,811.0
0.009,6,10,1983,5,910,2.0,642.0,642.0,5,1073,2.0,805.0,805.0
0.005,6,10,2006,5,927,1.0,659.0,659.0,5,1079,1.0,811.0,811.0
0.004,6,10,1702,5,863,1.0,595.0,595.0,5,839,0.0,571.0,571.0
0.011,6,10,1972,5,910,2.0,642.0,642.0,5,1062,2.0,794.0,794.0
11.186,17,28,4422,14,1994,848.0,269.0,114.0,14,2428,848.0,587.0,145.0
0.005,17,2,148,1,60,0.0,32.0,32.0,1,88,0.0,60.0,60.0
40.072,17,10,676,5,460,10016.0,104.0,64.0,5,216,10017.0,20.0,15.0
0.008,6,10,1762,5,911,2.0,643.0,643.0,5,851,1.0,583.0,583.0
366.148,6,22,2313,16,867,24409.0,195.0,195.0,6,1446,4633.0,419.0,398.0
178.055,17,82,11747,41,2739,4451.0,44.0,38.0,41,9008,4451.0,239.0,191.0
0.013,6,10,1989,5,910,3.0,642.0,642.0,5,1079,3.0,811.0,811.0
0.005,6,10,2000,5,927,1.0,659.0,659.0,5,1073,1.0,805.0,805.0
0.01,6,10,1990,5,911,2.0,643.0,643.0,5,1079,2.0,811.0,811.0
0.127,17,4,352,2,130,0.0,37.0,37.0,2,222,86.0,89.0,83.0
0.008,17,2,194,1,59,0.0,31.0,31.0,1,135,0.0,107.0,107.0
0.005,6,10,2006,5,927,1.0,659.0,659.0,5,1079,1.0,811.0,811.0
0.005,17,2,154,1,69,0.0,41.0,41.0,1,85,0.0,57.0,57.0
66.282,6,109,86842,62,12327,1086.0,2823.0,1297.0,47,74515,1437.0,2804.0,1801.0
0.011,6,10,1677,5,827,2.0,559.0,559.0,5,850,2.0,582.0,582.0
0.008,17,2,170,1,65,0.0,37.0,37.0,1,105,0.0,77.0,77.0
0.017,6,10,1990,5,911,4.0,643.0,643.0,5,1079,4.0,811.0,811.0
0.001,17,2,180,1,66,0.0,38.0,38.0,1,114,0.0,86.0,86.0
0.081,17,2,144,1,64,0.0,36.0,36.0,1,80,0.0,52.0,52.0
0.005,6,10,1774,5,923,1.0,655.0,655.0,5,851,1.0,583.0,583.0
0.124,6,10,1506,5,395,29.0,127.0,127.0,5,1111,28.0,843.0,843.0
0.009,6,10,1972,5,910,2.0,642.0,642.0,5,1062,2.0,794.0,794.0
0.015,6,10,1989,5,910,3.0,642.0,642.0,5,1079,3.0,811.0,811.0
0.004,6,10,2006,5,927,1.0,659.0,659.0,5,1079,1.0,811.0,811.0
0.008,6,13,3735,7,497,1.0,125.0,125.0,6,3238,1.0,1470.0,1459.0
0.013,17,2,152,1,56,0.0,28.0,28.0,1,96,0.0,68.0,68.0
0.068,6,10,1506,5,395,14.0,127.0,127.0,5,1111,14.0,843.0,843.0
0.005,6,10,1854,5,889,1.0,621.0,621.0,5,965,1.0,697.0,697.0
0.008,17,4,284,2,120,4.0,32.0,32.0,2,164,5.0,60.0,54.0
0.003,17,2,136,1,60,0.0,32.0,32.0,1,76,0.0,48.0,48.0
0.005,6,10,2006,5,927,1.0,659.0,659.0,5,1079,1.0,811.0,811.0
0.117,6,10,1506,5,395,28.0,127.0,127.0,5,1111,25.0,843.0,843.0
0.069,17,8,3613,4,1874,23.0,1350.0,440.0,4,1739,10.0,1350.0,406.0
10.843,17,28,4422,14,1995,825.0,270.0,114.0,14,2427,825.0,586.0,145.0
0.005,6,10,2007,5,928,1.0,660.0,660.0,5,1079,1.0,811.0,811.0
0.082,6,10,1506,5,395,17.0,127.0,127.0,5,1111,18.0,843.0,843.0
40.078,17,10,676,5,460,10018.0,104.0,64.0,5,216,10018.0,20.0,15.0
0.008,6,12,1926,6,1189,1.0,659.0,434.0,6,737,1.0,417.0,417.0
0.161,6,10,1506,5,395,37.0,127.0,127.0,5,1111,27.0,843.0,843.0
0.132,6,10,1506,5,395,27.0,127.0,127.0,5,1111,27.0,843.0,843.0
120.798,6,55,18825,30,4625,4165.0,1054.0,235.0,25,14200,5033.0,2804.0,1074.0
0.005,6,10,2006,5,927,1.0,659.0,659.0,5,1079,1.0,811.0,811.0
0.005,6,10,2006,5,927,1.0,659.0,659.0,5,1079,1.0,811.0,811.0
0.015,6,10,1677,5,827,3.0,559.0,559.0,5,850,3.0,582.0,582.0
0.006,6,10,1689,5,839,1.0,571.0,571.0,5,850,1.0,582.0,582.0
0.004,6,10,2006,5,927,1.0,659.0,659.0,5,1079,1.0,811.0,811.0
178.182,17,80,11289,40,2668,4568.0,44.0,38.0,40,8621,4568.0,261.0,187.0
0.004,17,2,234,1,61,0.0,33.0,33.0,1,173,0.0,145.0,145.0
0.005,6,10,1989,5,927,1.0,659.0,659.0,5,1062,1.0,794.0,794.0
0.099,6,10,1506,5,395,24.0,127.0,127.0,5,1111,23.0,843.0,843.0
0.005,17,2,170,1,65,0.0,37.0,37.0,1,105,0.0,77.0,77.0
0.015,6,10,1990,5,911,3.0,643.0,643.0,5,1079,3.0,811.0,811.0
0.006,6,10,1854,5,889,1.0,621.0,621.0,5,965,1.0,697.0,697.0
0.005,6,10,1547,5,764,1.0,496.0,496.0,5,783,1.0,515.0,515.0
0.124,17,4,352,2,130,0.0,37.0,37.0,2,222,121.0,89.0,83.0
171.156,17,106,15567,53,3571,3291.0,44.0,39.0,53,11996,3291.0,260.0,198.0
29.786,6,24,7517,13,1385,2482.0,530.0,277.0,11,6132,2961.0,2720.0,946.0
92.559,6,25,8609,14,2308,68.0,1345.0,564.0,11,6301,9239.0,2720.0,974.0
308.32,17,20,1124,10,716,34243.0,48.0,43.0,10,408,34243.0,20.0,12.0
240.105,6,16,4480,9,963,30013.0,238.0,166.0,7,3517,40017.0,1402.0,786.0
176.399,17,80,11262,40,2668,4522.0,44.0,38.0,40,8594,4522.0,239.0,186.0
0.039,17,2,214,1,75,0.0,47.0,47.0,1,139,0.0,111.0,111.0
0.17,6,3,453,2,321,170.0,241.0,241.0,1,132,0.0,92.0,92.0
273.225,17,144,20814,72,4845,3848.0,44.0,39.0,72,15969,3848.0,261.0,193.0
0.007,17,2,179,1,71,0.0,43.0,43.0,1,108,0.0,80.0,80.0
11.125,17,28,4419,14,1994,843.0,269.0,114.0,14,2425,843.0,588.0,145.0
0.006,6,10,1547,5,764,1.0,496.0,496.0,5,783,1.0,515.0,515.0
0.016,17,2,198,1,91,0.0,63.0,63.0,1,107,0.0,79.0,79.0
0.111,6,10,1506,5,395,26.0,127.0,127.0,5,1111,26.0,843.0,843.0
0.032,6,10,1762,5,911,7.0,643.0,643.0,5,851,8.0,583.0,583.0
0.011,6,10,1983,5,910,2.0,642.0,642.0,5,1073,2.0,805.0,805.0
0.012,6,10,1989,5,910,2.0,642.0,642.0,5,1079,3.0,811.0,811.0
0.04,17,2,136,1,60,0.0,32.0,32.0,1,76,0.0,48.0,48.0
0.008,6,12,1926,6,1189,1.0,659.0,434.0,6,737,1.0,417.0,417.0
28.096,6,27,11188,16,1890,1873.0,506.0,350.0,11,9298,2808.0,2804.0,1245.0
267.5,6,33,9624,12,1781,24318.0,568.0,383.0,21,7843,13374.0,2370.0,842.0
0.005,6,14,3742,8,504,0.0,80.0,80.0,6,3238,0.0,1470.0,1459.0
0.068,17,8,3613,4,1874,22.0,1350.0,440.0,4,1739,11.0,1350.0,406.0
0.013,17,2,152,1,56,0.0,28.0,28.0,1,96,0.0,68.0,68.0
0.005,6,10,2006,5,927,1.0,659.0,659.0,5,1079,1.0,811.0,811.0
1777.809,17,144,41760,72,22752,25039.0,288.0,288.0,72,19008,25039.0,236.0,236.0
0.026,6,10,1989,5,910,6.0,642.0,642.0,5,1079,6.0,811.0,811.0
0.025,6,10,1983,5,910,6.0,642.0,642.0,5,1073,6.0,805.0,805.0
0.111,6,10,1506,5,395,24.0,127.0,127.0,5,1111,22.0,843.0,843.0
0.073,6,10,1506,5,395,15.0,127.0,127.0,5,1111,13.0,843.0,843.0
308.528,17,20,1124,10,716,34266.0,48.0,43.0,10,408,34262.0,20.0,12.0
0.127,17,2,412,1,61,0.0,33.0,33.0,1,351,0.0,323.0,323.0
0.155,6,10,1506,5,395,36.0,127.0,127.0,5,1111,35.0,843.0,843.0
0.005,6,10,2006,5,927,1.0,659.0,659.0,5,1079,1.0,811.0,811.0
0.009,6,10,1989,5,910,2.0,642.0,642.0,5,1079,2.0,811.0,811.0
0.005,17,2,169,1,62,0.0,34.0,34.0,1,107,0.0,79.0,79.0
40.056,17,10,676,5,460,10011.0,104.0,64.0,5,216,10012.0,20.0,15.0
0.005,17,2,230,1,68,0.0,40.0,40.0,1,162,0.0,134.0,134.0
0.008,17,2,179,1,71,0.0,43.0,43.0,1,108,0.0,80.0,80.0
0.005,6,13,3747,7,509,0.0,137.0,137.0,6,3238,0.0,1470.0,1459.0
0.003,17,2,148,1,60,0.0,32.0,32.0,1,88,0.0,60.0,60.0
0.029,6,10,1990,5,911,7.0,643.0,643.0,5,1079,7.0,811.0,811.0
0.004,17,2,152,1,76,0.0,48.0,48.0,1,76,0.0,48.0,48.0
0.01,6,10,1972,5,910,2.0,642.0,642.0,5,1062,2.0,794.0,794.0
0.106,6,10,1506,5,395,23.0,127.0,127.0,5,1111,25.0,843.0,843.0
0.006,6,10,1689,5,839,1.0,571.0,571.0,5,850,1.0,582.0,582.0
0.083,6,43,14070,24,2565,3.0,517.0,146.0,19,11505,4.0,1402.0,808.0
0.014,6,10,1990,5,911,3.0,643.0,643.0,5,1079,3.0,811.0,811.0
0.015,6,10,1983,5,910,3.0,642.0,642.0,5,1073,3.0,805.0,805.0
0.004,17,2,148,1,60,0.0,32.0,32.0,1,88,0.0,60.0,60.0
0.008,6,10,1989,5,910,1.0,642.0,642.0,5,1079,1.0,811.0,811.0
0.107,6,10,1506,5,395,26.0,127.0,127.0,5,1111,23.0,843.0,843.0
0.006,17,2,194,1,59,0.0,31.0,31.0,1,135,0.0,107.0,107.0
0.005,6,10,1989,5,927,1.0,659.0,659.0,5,1062,1.0,794.0,794.0
0.017,17,2,180,1,66,0.0,38.0,38.0,1,114,0.0,86.0,86.0
0.005,6,10,1643,5,860,1.0,592.0,592.0,5,783,1.0,515.0,515.0
15.071,17,15,9238,8,6902,2148.0,1350.0,834.0,7,2336,2506.0,1350.0,305.0
0.005,6,10,1547,5,764,1.0,496.0,496.0,5,783,1.0,515.0,515.0
40.055,17,10,676,5,460,10012.0,104.0,64.0,5,216,10013.0,20.0,15.0
0.004,6,10,2007,5,928,1.0,660.0,660.0,5,1079,1.0,811.0,811.0
0.088,6,10,1506,5,395,18.0,127.0,127.0,5,1111,18.0,843.0,843.0
300.789,6,36,9700,19,4222,16710.0,3046.0,857.0,17,5478,538.0,2667.0,435.0
15.218,17,17,8239,9,6175,1898.0,1350.0,658.0,8,2064,2169.0,1350.0,230.0
300.994,6,44,17715,24,12117,13086.0,2720.0,1236.0,20,5598,463.0,2667.0,435.0
0.003,17,2,136,1,60,0.0,32.0,32.0,1,76,0.0,48.0,48.0
0.123,6,10,1506,5,395,28.0,127.0,127.0,5,1111,25.0,843.0,843.0
0.005,6,10,2007,5,928,1.0,660.0,660.0,5,1079,1.0,811.0,811.0
0.016,6,7,1067,4,406,5.0,190.0,190.0,3,661,4.0,497.0,497.0
0.011,6,10,1989,5,910,2.0,642.0,642.0,5,1079,2.0,811.0,811.0
0.005,17,2,144,1,64,0.0,36.0,36.0,1,80,0.0,52.0,52.0
0.004,6,10,1989,5,927,1.0,659.0,659.0,5,1062,1.0,794.0,794.0
0.103,6,10,1506,5,395,20.0,127.0,127.0,5,1111,24.0,843.0,843.0
0.018,6,10,1990,5,911,4.0,643.0,643.0,5,1079,4.0,811.0,811.0
0.005,6,10,2000,5,927,1.0,659.0,659.0,5,1073,1.0,805.0,805.0
9.038,17,6,376,5,280,2259.0,28.0,28.0,1,96,0.0,68.0,68.0
0.004,17,2,136,1,60,0.0,32.0,32.0,1,76,0.0,48.0,48.0
0.004,17,2,136,1,60,0.0,32.0,32.0,1,76,0.0,48.0,48.0
0.012,6,10,1989,5,910,3.0,642.0,642.0,5,1079,3.0,811.0,811.0
0.005,6,10,2007,5,928,1.0,660.0,660.0,5,1079,1.0,811.0,811.0
0.106,6,10,1506,5,395,21.0,127.0,127.0,5,1111,25.0,843.0,843.0
354.068,6,21,1795,16,1030,23604.0,190.0,190.0,5,765,60001.0,464.0,248.0
0.001,17,2,142,1,63,0.0,35.0,35.0,1,79,0.0,51.0,51.0
0.14,6,10,1506,5,395,30.0,127.0,127.0,5,1111,30.0,843.0,843.0
0.005,6,10,2006,5,927,1.0,659.0,659.0,5,1079,1.0,811.0,811.0
0.097,6,10,1506,5,395,22.0,127.0,127.0,5,1111,22.0,843.0,843.0
0.005,6,10,1547,5,764,1.0,496.0,496.0,5,783,1.0,515.0,515.0
0.005,6,10,1989,5,927,1.0,659.0,659.0,5,1062,1.0,794.0,794.0
0.006,6,10,1643,5,860,1.0,592.0,592.0,5,783,1.0,515.0,515.0
0.163,17,2,152,1,76,0.0,48.0,48.0,1,76,0.0,48.0,48.0
0.061,6,10,1506,5,395,14.0,127.0,127.0,5,1111,12.0,843.0,843.0
0.012,6,10,1972,5,910,2.0,642.0,642.0,5,1062,2.0,794.0,794.0
0.005,6,10,2000,5,927,1.0,659.0,659.0,5,1073,1.0,805.0,805.0
0.006,6,10,1547,5,764,1.0,496.0,496.0,5,783,1.0,515.0,515.0
0.015,6,10,1989,5,910,3.0,642.0,642.0,5,1079,3.0,811.0,811.0
0.003,17,2,148,1,60,0.0,32.0,32.0,1,88,0.0,60.0,60.0
0.059,6,10,1506,5,395,13.0,127.0,127.0,5,1111,14.0,843.0,843.0
240.018,6,9,787,5,488,60004.0,232.0,232.0,4,299,80004.0,83.0,83.0
1799.624,17,3187,243568,1580,128042,1139.0,84.0,53.0,1607,115526,1120.0,227.0,43.0
0.005,6,10,1547,5,764,1.0,496.0,496.0,5,783,1.0,515.0,515.0
0.261,6,10,1506,5,395,62.0,127.0,127.0,5,1111,45.0,843.0,843.0
0.011,6,12,1926,6,1189,2.0,659.0,434.0,6,737,2.0,417.0,417.0
174.11,17,88,12518,44,2933,4049.0,44.0,38.0,44,9585,4049.0,239.0,189.0
0.009,6,10,1972,5,910,2.0,642.0,642.0,5,1062,2.0,794.0,794.0
0.015,17,2,198,1,91,0.0,63.0,63.0,1,107,0.0,79.0,79.0
0.006,6,10,1643,5,860,1.0,592.0,592.0,5,783,1.0,515.0,515.0
0.103,6,10,1506,5,395,21.0,127.0,127.0,5,1111,21.0,843.0,843.0
0.001,17,2,166,1,75,0.0,47.0,47.0,1,91,0.0,63.0,63.0
0.139,6,10,1506,5,395,31.0,127.0,127.0,5,1111,32.0,843.0,843.0
40.082,17,10,676,5,460,10019.0,104.0,64.0,5,216,10019.0,20.0,15.0
0.01,6,10,1989,5,910,2.0,642.0,642.0,5,1079,2.0,811.0,811.0
0.004,6,10,1702,5,863,1.0,595.0,595.0,5,839,1.0,571.0,571.0
0.119,6,10,1506,5,395,28.0,127.0,127.0,5,1111,27.0,843.0,843.0
40.06,17,10,676,5,460,10014.0,104.0,64.0,5,216,10014.0,20.0,15.0
0.091,6,10,1506,5,395,20.0,127.0,127.0,5,1111,20.0,843.0,843.0
0.037,17,2,136,1,60,0.0,32.0,32.0,1,76,0.0,48.0,48.0
0.103,6,10,1506,5,395,23.0,127.0,127.0,5,1111,21.0,843.0,843.0
0.006,6,10,1547,5,764,1.0,496.0,496.0,5,783,1.0,515.0,515.0
0.004,6,10,2007,5,928,1.0,660.0,660.0,5,1079,1.0,811.0,811.0
40.118,17,10,676,5,460,10028.0,104.0,64.0,5,216,10028.0,20.0,15.0
0.008,17,2,179,1,71,0.0,43.0,43.0,1,108,0.0,80.0,80.0
0.004,17,2,136,1,60,0.0,32.0,32.0,1,76,0.0,48.0,48.0
266.695,6,40,9892,16,6770,17779.0,1842.0,660.0,24,3122,11595.0,580.0,124.0
0.004,6,10,1774,5,923,1.0,655.0,655.0,5,851,1.0,583.0,583.0
10.812,17,28,4417,14,1993,823.0,268.0,114.0,14,2424,823.0,587.0,145.0
0.014,6,10,1989,5,910,3.0,642.0,642.0,5,1079,3.0,811.0,811.0
0.012,6,10,1990,5,911,3.0,643.0,643.0,5,1079,3.0,811.0,811.0
0.082,6,10,1506,5,395,17.0,127.0,127.0,5,1111,19.0,843.0,843.0
0.006,6,10,1547,5,764,1.0,496.0,496.0,5,783,1.0,515.0,515.0
0.008,6,10,1854,5,889,2.0,621.0,621.0,5,965,1.0,697.0,697.0
0.072,17,2,136,1,60,0.0,32.0,32.0,1,76,0.0,48.0,48.0
0.009,6,10,1989,5,910,2.0,642.0,642.0,5,1079,2.0,811.0,811.0
0.076,6,10,1506,5,395,16.0,127.0,127.0,5,1111,17.0,843.0,843.0
15.09,17,16,8486,8,6255,2151.0,1350.0,753.0,8,2231,2151.0,1350.0,250.0
0.005,6,10,1643,5,860,1.0,592.0,592.0,5,783,1.0,515.0,515.0
0.012,6,10,1990,5,911,3.0,643.0,643.0,5,1079,2.0,811.0,811.0
0.012,6,10,1983,5,910,3.0,642.0,642.0,5,1073,2.0,805.0,805.0
10.887,17,28,4421,14,1993,829.0,268.0,114.0,14,2428,828.0,587.0,145.0
0.094,6,10,1506,5,395,20.0,127.0,127.0,5,1111,22.0,843.0,843.0
0.129,6,10,1506,5,395,28.0,127.0,127.0,5,1111,29.0,843.0,843.0
0.01,6,10,1989,5,910,2.0,642.0,642.0,5,1079,2.0,811.0,811.0
0.013,6,10,1989,5,910,3.0,642.0,642.0,5,1079,3.0,811.0,811.0
0.001,17,2,146,1,65,0.0,37.0,37.0,1,81,0.0,53.0,53.0
288.965,6,412,349549,211,22531,1376.0,2736.0,888.0,201,327018,1444.0,4127.0,1692.0
24.139,58,2,144,1,72,0.0,24.0,24.0,1,72,0.0,24.0,24.0
0.168,17,2,152,1,76,0.0,48.0,48.0,1,76,0.0,48.0,48.0
0.005,6,10,1989,5,927,1.0,659.0,659.0,5,1062,1.0,794.0,794.0
412.026,6,29,4409,12,3102,10914.0,494.0,494.0,17,1307,25751.0,83.0,83.0
40.07,17,10,676,5,460,10015.0,104.0,64.0,5,216,10015.0,20.0,15.0
0.019,6,10,1631,5,848,4.0,580.0,580.0,5,783,4.0,515.0,515.0
0.005,6,10,2006,5,927,1.0,659.0,659.0,5,1079,1.0,811.0,811.0
0.015,6,10,1983,5,910,3.0,642.0,642.0,5,1073,3.0,805.0,805.0
0.001,17,2,180,1,66,0.0,38.0,38.0,1,114,0.0,86.0,86.0
0.101,6,10,1506,5,395,23.0,127.0,127.0,5,1111,20.0,843.0,843.0
0.058,6,10,1506,5,395,11.0,127.0,127.0,5,1111,14.0,843.0,843.0
0.006,6,13,3747,7,509,0.0,137.0,137.0,6,3238,1.0,1470.0,1459.0
0.005,6,10,1989,5,927,1.0,659.0,659.0,5,1062,1.0,794.0,794.0
0.023,6,10,1989,5,910,5.0,642.0,642.0,5,1079,5.0,811.0,811.0
0.005,6,10,1643,5,860,1.0,592.0,592.0,5,783,1.0,515.0,515.0
0.001,17,2,180,1,66,0.0,38.0,38.0,1,114,0.0,86.0,86.0
40.065,17,10,676,5,460,10015.0,104.0,64.0,5,216,10015.0,20.0,15.0
0.003,17,2,136,1,60,0.0,32.0,32.0,1,76,0.0,48.0,48.0
40.054,17,10,676,5,460,10012.0,104.0,64.0,5,216,10012.0,20.0,15.0
0.077,6,10,1506,5,395,16.0,127.0,127.0,5,1111,17.0,843.0,843.0
0.001,17,2,174,1,72,0.0,44.0,44.0,1,102,0.0,74.0,74.0
0.009,17,4,284,2,120,0.0,32.0,32.0,2,164,1.0,60.0,54.0
1799.212,6,64,7360,42,4484,43883.0,1640.0,109.0,22,2876,85668.0,1112.0,82.0
0.015,6,13,3735,7,497,2.0,125.0,125.0,6,3238,3.0,1470.0,1459.0
369.81,6,22,2313,16,867,24654.0,195.0,195.0,6,1446,4638.0,419.0,398.0
0.004,6,10,2000,5,927,1.0,659.0,659.0,5,1073,1.0,805.0,805.0
0.006,6,10,1547,5,764,1.0,496.0,496.0,5,783,1.0,515.0,515.0
0.005,6,10,1689,5,839,1.0,571.0,571.0,5,850,1.0,582.0,582.0
0.005,6,10,2006,5,927,1.0,659.0,659.0,5,1079,1.0,811.0,811.0
0.004,6,10,2007,5,928,1.0,660.0,660.0,5,1079,1.0,811.0,811.0
0.005,6,10,2006,5,927,1.0,659.0,659.0,5,1079,1.0,811.0,811.0
0.006,6,10,1854,5,889,1.0,621.0,621.0,5,965,1.0,697.0,697.0
361.843,6,21,1792,16,1030,24122.0,190.0,190.0,5,762,60011.0,461.0,247.0
0.001,17,2,180,1,66,0.0,38.0,38.0,1,114,0.0,86.0,86.0
0.005,6,10,1643,5,860,1.0,592.0,592.0,5,783,1.0,515.0,515.0
0.004,6,10,1702,5,863,0.0,595.0,595.0,5,839,1.0,571.0,571.0
0.013,6,10,1972,5,910,3.0,642.0,642.0,5,1062,3.0,794.0,794.0
0.001,17,2,132,1,58,0.0,30.0,30.0,1,74,0.0,46.0,46.0
0.068,17,8,3613,4,1874,22.0,1350.0,440.0,4,1739,12.0,1350.0,406.0
0.005,6,10,2007,5,928,1.0,660.0,660.0,5,1079,1.0,811.0,811.0
277.38,6,25,7263,15,1811,19812.0,253.0,207.0,10,5452,30819.0,1402.0,703.0
0.005,6,10,2007,5,928,1.0,660.0,660.0,5,1079,1.0,811.0,811.0
0.015,6,10,1677,5,827,3.0,559.0,559.0,5,850,3.0,582.0,582.0
0.005,6,10,2007,5,928,1.0,660.0,660.0,5,1079,1.0,811.0,811.0
0.041,17,2,152,1,76,0.0,48.0,48.0,1,76,0.0,48.0,48.0
0.128,6,10,1506,5,395,29.0,127.0,127.0,5,1111,30.0,843.0,843.0
0.005,6,10,1989,5,927,1.0,659.0,659.0,5,1062,1.0,794.0,794.0
0.005,17,2,144,1,64,0.0,36.0,36.0,1,80,0.0,52.0,52.0
356.568,6,21,1795,16,1030,23771.0,190.0,190.0,5,765,60007.0,464.0,248.0
0.006,17,2,136,1,60,0.0,32.0,32.0,1,76,0.0,48.0,48.0
0.175,17,2,152,1,76,0.0,48.0,48.0,1,76,0.0,48.0,48.0
0.004,6,10,1989,5,927,1.0,659.0,659.0,5,1062,1.0,794.0,794.0
0.016,6,10,1972,5,910,4.0,642.0,642.0,5,1062,4.0,794.0,794.0
0.005,6,10,2007,5,928,1.0,660.0,660.0,5,1079,1.0,811.0,811.0
0.005,6,10,2000,5,927,1.0,659.0,659.0,5,1073,1.0,805.0,805.0
0.006,6,10,2006,5,927,1.0,659.0,659.0,5,1079,1.0,811.0,811.0
10.934,17,28,4424,14,1995,832.0,270.0,114.0,14,2429,832.0,588.0,145.0
0.085,6,10,1506,5,395,18.0,127.0,127.0,5,1111,17.0,843.0,843.0
353.44,6,20,2210,6,1308,12004.0,494.0,494.0,14,902,27187.0,83.0,83.0
0.013,6,10,1983,5,910,3.0,642.0,642.0,5,1073,3.0,805.0,805.0
0.005,6,10,1774,5,923,1.0,655.0,655.0,5,851,1.0,583.0,583.0
0.004,6,10,1702,5,863,1.0,595.0,595.0,5,839,0.0,571.0,571.0
0.004,6,10,2007,5,928,1.0,660.0,660.0,5,1079,1.0,811.0,811.0
40.056,17,10,676,5,460,10012.0,104.0,64.0,5,216,10013.0,20.0,15.0
0.016,6,10,1983,5,910,4.0,642.0,642.0,5,1073,3.0,805.0,805.0
0.04,17,2,136,1,60,0.0,32.0,32.0,1,76,0.0,48.0,48.0
310.537,17,20,1124,10,716,34492.0,48.0,43.0,10,408,34492.0,20.0,12.0
0.004,6,10,1779,5,928,1.0,660.0,660.0,5,851,1.0,583.0,583.0
15.074,17,15,10569,9,8280,1880.0,1350.0,892.0,6,2289,3010.0,1350.0,353.0
0.091,6,10,1506,5,395,20.0,127.0,127.0,5,1111,18.0,843.0,843.0
0.006,6,10,1689,5,839,1.0,571.0,571.0,5,850,1.0,582.0,582.0
0.008,17,2,194,1,59,0.0,31.0,31.0,1,135,0.0,107.0,107.0
0.302,6,27,12046,13,6264,25.0,1938.0,930.0,14,5782,22.0,1657.0,841.0
0.008,6,10,1990,5,911,2.0,643.0,643.0,5,1079,2.0,811.0,811.0
0.014,6,10,1990,5,911,3.0,643.0,643.0,5,1079,3.0,811.0,811.0
0.005,6,13,3747,7,509,0.0,137.0,137.0,6,3238,0.0,1470.0,1459.0
0.015,6,10,1972,5,910,3.0,642.0,642.0,5,1062,3.0,794.0,794.0
0.119,17,2,80,1,32,0.0,4.0,4.0,1,48,0.0,20.0,20.0
0.047,6,10,1989,5,910,11.0,642.0,642.0,5,1079,11.0,811.0,811.0
0.004,6,10,1702,5,863,1.0,595.0,595.0,5,839,0.0,571.0,571.0
0.006,6,10,1547,5,764,1.0,496.0,496.0,5,783,1.0,515.0,515.0
0.013,6,13,3735,7,497,2.0,125.0,125.0,6,3238,2.0,1470.0,1459.0
0.041,17,2,412,1,61,0.0,33.0,33.0,1,351,0.0,323.0,323.0
0.006,17,2,179,1,71,0.0,43.0,43.0,1,108,0.0,80.0,80.0
0.004,6,10,2006,5,927,1.0,659.0,659.0,5,1079,1.0,811.0,811.0
0.102,6,10,1506,5,395,23.0,127.0,127.0,5,1111,20.0,843.0,843.0
0.005,6,10,1643,5,860,1.0,592.0,592.0,5,783,1.0,515.0,515.0
0.005,6,10,1779,5,928,1.0,660.0,660.0,5,851,1.0,583.0,583.0
379.77,6,20,2210,6,1308,12003.0,494.0,494.0,14,902,29212.0,83.0,83.0
309.7,17,20,1124,10,716,34397.0,48.0,43.0,10,408,34397.0,20.0,12.0
0.092,6,10,1506,5,395,21.0,127.0,127.0,5,1111,19.0,843.0,843.0
0.009,6,10,1677,5,827,2.0,559.0,559.0,5,850,2.0,582.0,582.0
0.005,6,10,1779,5,928,1.0,660.0,660.0,5,851,1.0,583.0,583.0
0.013,6,10,1990,5,911,3.0,643.0,643.0,5,1079,3.0,811.0,811.0
327.099,17,20,1124,10,716,36330.0,48.0,43.0,10,408,36330.0,20.0,12.0
0.071,17,8,3613,4,1874,23.0,1350.0,440.0,4,1739,12.0,1350.0,406.0
0.005,17,2,230,1,68,0.0,40.0,40.0,1,162,0.0,134.0,134.0
0.066,17,2,152,1,76,0.0,48.0,48.0,1,76,0.0,48.0,48.0
0.015,6,10,1989,5,910,3.0,642.0,642.0,5,1079,3.0,811.0,811.0
0.069,17,8,3613,4,1874,23.0,1350.0,440.0,4,1739,12.0,1350.0,406.0
240.129,6,36,26656,19,17567,13340.0,2736.0,1658.0,17,9089,15007.0,2752.0,1171.0
0.007,6,10,1989,5,910,1.0,642.0,642.0,5,1079,1.0,811.0,811.0
0.019,6,10,1631,5,848,4.0,580.0,580.0,5,783,4.0,515.0,515.0
0.005,6,10,1989,5,927,1.0,659.0,659.0,5,1062,1.0,794.0,794.0
0.026,6,13,3735,7,497,4.0,125.0,125.0,6,3238,5.0,1470.0,1459.0
0.005,6,10,1779,5,928,1.0,660.0,660.0,5,851,1.0,583.0,583.0
0.016,17,2,180,1,66,0.0,38.0,38.0,1,114,0.0,86.0,86.0
0.009,6,10,1983,5,910,2.0,642.0,642.0,5,1073,2.0,805.0,805.0
0.014,6,10,1972,5,910,3.0,642.0,642.0,5,1062,3.0,794.0,794.0
40.071,17,10,676,5,460,10014.0,104.0,64.0,5,216,10016.0,20.0,15.0
0.119,6,10,1506,5,395,28.0,127.0,127.0,5,1111,26.0,843.0,843.0
0.001,17,2,180,1,66,0.0,38.0,38.0,1,114,0.0,86.0,86.0
173.245,17,90,12713,45,3008,3937.0,44.0,38.0,45,9705,3937.0,239.0,187.0
0.005,17,2,180,1,66,0.0,38.0,38.0,1,114,0.0,86.0,86.0
300.026,6,12,1782,7,1348,50004.0,494.0,494.0,5,434,75005.0,83.0,83.0
0.119,6,10,1506,5,395,24.0,127.0,127.0,5,1111,20.0,843.0,843.0
0.069,6,10,1506,5,395,15.0,127.0,127.0,5,1111,14.0,843.0,843.0
0.039,17,2,144,1,64,0.0,36.0,36.0,1,80,0.0,52.0,52.0
0.005,6,10,2007,5,928,1.0,660.0,660.0,5,1079,1.0,811.0,811.0
309.662,17,20,1124,10,716,34392.0,48.0,43.0,10,408,34392.0,20.0,12.0
412.016,6,29,4409,12,3102,10913.0,494.0,494.0,17,1307,25750.0,83.0,83.0
0.004,6,10,2006,5,927,1.0,659.0,659.0,5,1079,1.0,811.0,811.0
0.1,6,10,1506,5,395,22.0,127.0,127.0,5,1111,23.0,843.0,843.0
0.005,6,10,1547,5,764,1.0,496.0,496.0,5,783,1.0,515.0,515.0
1773.197,6,64,7358,42,4484,43248.0,1640.0,109.0,22,2874,84429.0,1110.0,82.0
1778.801,17,144,41760,72,22752,25053.0,288.0,288.0,72,19008,25053.0,236.0,236.0
0.015,6,12,1926,6,1189,2.0,659.0,434.0,6,737,2.0,417.0,417.0
0.042,17,2,184,1,61,0.0,33.0,33.0,1,123,0.0,95.0,95.0
0.009,6,10,1972,5,910,2.0,642.0,642.0,5,1062,2.0,794.0,794.0
0.006,17,2,424,1,72,0.0,44.0,44.0,1,352,0.0,324.0,324.0
0.084,6,10,1506,5,395,19.0,127.0,127.0,5,1111,18.0,843.0,843.0
0.005,6,10,1774,5,923,1.0,655.0,655.0,5,851,1.0,583.0,583.0
0.096,6,10,1506,5,395,20.0,127.0,127.0,5,1111,22.0,843.0,843.0
0.246,17,15,8641,8,4076,35.0,1350.0,481.0,7,4565,31.0,1350.0,624.0
0.078,6,10,1506,5,395,17.0,127.0,127.0,5,1111,18.0,843.0,843.0
0.008,6,13,3735,7,497,1.0,125.0,125.0,6,3238,1.0,1470.0,1459.0
0.006,17,2,179,1,71,0.0,43.0,43.0,1,108,0.0,80.0,80.0
0.003,17,2,185,1,73,0.0,45.0,45.0,1,112,0.0,84.0,84.0
0.012,6,10,1631,5,848,3.0,580.0,580.0,5,783,3.0,515.0,515.0
0.006,17,2,230,1,68,0.0,40.0,40.0,1,162,0.0,134.0,134.0
0.005,17,2,170,1,65,0.0,37.0,37.0,1,105,0.0,77.0,77.0
0.132,17,2,80,1,32,0.0,4.0,4.0,1,48,0.0,20.0,20.0
0.005,6,10,1854,5,889,1.0,621.0,621.0,5,965,1.0,697.0,697.0
0.078,6,10,1506,5,395,17.0,127.0,127.0,5,1111,16.0,843.0,843.0
0.008,6,10,1989,5,910,2.0,642.0,642.0,5,1079,1.0,811.0,811.0
11.396,17,28,4394,14,2313,864.0,588.0,137.0,14,2081,864.0,268.0,120.0
0.008,17,2,179,1,71,0.0,43.0,43.0,1,108,0.0,80.0,80.0
0.004,17,2,170,1,65,0.0,37.0,37.0,1,105,0.0,77.0,77.0
0.113,6,10,1506,5,395,24.0,127.0,127.0,5,1111,22.0,843.0,843.0
0.075,6,10,1506,5,395,17.0,127.0,127.0,5,1111,15.0,843.0,843.0
0.038,17,4,284,2,120,0.0,32.0,32.0,2,164,35.0,60.0,54.0
0.072,6,10,1506,5,395,16.0,127.0,127.0,5,1111,16.0,843.0,843.0
0.005,6,10,1774,5,923,1.0,655.0,655.0,5,851,1.0,583.0,583.0
0.014,6,10,1989,5,910,3.0,642.0,642.0,5,1079,3.0,811.0,811.0
301.279,6,27,9040,15,1961,21519.0,568.0,293.0,12,7079,27388.0,2370.0,1076.0
0.119,6,10,1506,5,395,25.0,127.0,127.0,5,1111,21.0,843.0,843.0
0.005,6,10,1779,5,928,1.0,660.0,660.0,5,851,1.0,583.0,583.0
0.006,6,10,1547,5,764,1.0,496.0,496.0,5,783,1.0,515.0,515.0
0.08,6,10,1506,5,395,15.0,127.0,127.0,5,1111,17.0,843.0,843.0
0.007,17,2,179,1,71,0.0,43.0,43.0,1,108,0.0,80.0,80.0
0.037,17,2,152,1,76,0.0,48.0,48.0,1,76,0.0,48.0,48.0
0.005,17,2,179,1,71,0.0,43.0,43.0,1,108,0.0,80.0,80.0
0.005,6,10,2007,5,928,1.0,660.0,660.0,5,1079,1.0,811.0,811.0
0.119,6,10,1506,5,395,24.0,127.0,127.0,5,1111,27.0,843.0,843.0
0.006,6,10,2006,5,927,1.0,659.0,659.0,5,1079,1.0,811.0,811.0
371.011,6,22,2313,16,867,24734.0,195.0,195.0,6,1446,4645.0,419.0,398.0
0.005,6,10,1643,5,860,1.0,592.0,592.0,5,783,1.0,515.0,515.0
0.006,17,2,179,1,71,0.0,43.0,43.0,1,108,0.0,80.0,80.0
0.093,6,10,1506,5,395,15.0,127.0,127.0,5,1111,20.0,843.0,843.0
0.01,6,10,1972,5,910,2.0,642.0,642.0,5,1062,2.0,794.0,794.0
0.004,6,10,2006,5,927,1.0,659.0,659.0,5,1079,1.0,811.0,811.0
1761.329,6,468,68442,262,35944,6748.0,613.0,192.0,206,32498,8591.0,613.0,149.0
0.005,17,2,169,1,62,0.0,34.0,34.0,1,107,0.0,79.0,79.0
1778.849,17,146,46136,74,23384,24364.0,288.0,288.0,72,22752,25053.0,288.0,288.0
0.004,17,4,284,2,120,1.0,32.0,32.0,2,164,0.0,60.0,54.0
308.635,17,20,1124,10,716,34277.0,48.0,43.0,10,408,34278.0,20.0,12.0
0.114,6,10,1506,5,395,20.0,127.0,127.0,5,1111,27.0,843.0,843.0
0.01,6,10,1631,5,848,2.0,580.0,580.0,5,783,2.0,515.0,515.0
0.021,6,10,1762,5,911,5.0,643.0,643.0,5,851,5.0,583.0,583.0
0.003,17,2,136,1,60,0.0,32.0,32.0,1,76,0.0,48.0,48.0
0.118,6,10,1506,5,395,25.0,127.0,127.0,5,1111,25.0,843.0,843.0
0.005,17,4,284,2,120,0.0,32.0,32.0,2,164,1.0,60.0,54.0
0.005,6,10,1854,5,889,1.0,621.0,621.0,5,965,1.0,697.0,697.0
0.026,6,10,1989,5,910,6.0,642.0,642.0,5,1079,6.0,811.0,811.0
0.013,6,10,1631,5,848,3.0,580.0,580.0,5,783,3.0,515.0,515.0
0.006,17,2,299,1,65,0.0,37.0,37.0,1,234,0.0,206.0,206.0
0.08,6,10,1506,5,395,19.0,127.0,127.0,5,1111,17.0,843.0,843.0
0.073,17,2,412,1,61,0.0,33.0,33.0,1,351,0.0,323.0,323.0
301.016,6,44,13582,24,7755,13087.0,1566.0,845.0,20,5827,466.0,2667.0,385.0
40.06,17,10,676,5,460,10012.0,104.0,64.0,5,216,10014.0,20.0,15.0
0.04,17,2,148,1,60,0.0,32.0,32.0,1,88,0.0,60.0,60.0
0.004,6,10,1779,5,928,1.0,660.0,660.0,5,851,1.0,583.0,583.0
0.111,6,10,1506,5,395,25.0,127.0,127.0,5,1111,23.0,843.0,843.0
0.075,6,10,1506,5,395,16.0,127.0,127.0,5,1111,16.0,843.0,843.0
0.001,17,2,166,1,75,0.0,47.0,47.0,1,91,0.0,63.0,63.0
0.013,6,10,1972,5,910,3.0,642.0,642.0,5,1062,3.0,794.0,794.0
0.041,17,2,152,1,76,0.0,48.0,48.0,1,76,0.0,48.0,48.0
242.476,6,369,346864,190,21396,1282.0,2736.0,885.0,179,325468,1362.0,4206.0,1870.0
0.14,6,10,1506,5,395,21.0,127.0,127.0,5,1111,33.0,843.0,843.0
0.006,6,10,1547,5,764,1.0,496.0,496.0,5,783,1.0,515.0,515.0
0.018,6,14,3787,7,497,3.0,125.0,125.0,7,3290,2.0,1448.0,972.0
0.004,17,2,184,1,61,0.0,33.0,33.0,1,123,0.0,95.0,95.0
0.01,6,10,1989,5,910,2.0,642.0,642.0,5,1079,2.0,811.0,811.0
0.004,6,10,1702,5,863,1.0,595.0,595.0,5,839,1.0,571.0,571.0
0.007,17,2,194,1,59,0.0,31.0,31.0,1,135,0.0,107.0,107.0
0.014,6,10,1990,5,911,3.0,643.0,643.0,5,1079,3.0,811.0,811.0
0.01,6,10,1990,5,911,2.0,643.0,643.0,5,1079,2.0,811.0,811.0
0.042,17,4,364,2,160,0.0,52.0,52.0,2,204,38.0,80.0,74.0
0.01,6,10,1989,5,910,2.0,642.0,642.0,5,1079,2.0,811.0,811.0
0.003,17,2,148,1,60,0.0,32.0,32.0,1,88,0.0,60.0,60.0
0.201,6,16,2668,8,1394,28.0,533.0,323.0,8,1274,18.0,529.0,212.0
15.216,17,38,20174,21,17029,759.0,1350.0,782.0,17,3145,949.0,1350.0,157.0
1799.994,6,137,6590,76,3625,23996.0,39.0,39.0,61,2965,29996.0,35.0,35.0
0.001,17,2,180,1,66,0.0,38.0,38.0,1,114,0.0,86.0,86.0
0.014,6,10,1677,5,827,3.0,559.0,559.0,5,850,3.0,582.0,582.0
240.103,6,16,4481,9,963,30012.0,238.0,166.0,7,3518,40016.0,1402.0,786.0
368.992,6,22,2313,16,867,24599.0,195.0,195.0,6,1446,4639.0,419.0,398.0
0.011,6,10,1989,5,910,2.0,642.0,642.0,5,1079,2.0,811.0,811.0
172.13,17,84,12183,42,2805,4198.0,44.0,38.0,42,9378,4198.0,261.0,195.0
10.979,17,26,4070,13,2164,905.0,587.0,138.0,13,1906,906.0,269.0,118.0
0.091,6,10,1506,5,395,22.0,127.0,127.0,5,1111,19.0,843.0,843.0
0.006,6,10,1689,5,839,1.0,571.0,571.0,5,850,1.0,582.0,582.0
40.069,17,10,676,5,460,10014.0,104.0,64.0,5,216,10016.0,20.0,15.0
0.005,6,10,2006,5,927,1.0,659.0,659.0,5,1079,1.0,811.0,811.0
0.077,6,10,1506,5,395,16.0,127.0,127.0,5,1111,18.0,843.0,843.0
11.188,17,28,4423,14,1994,848.0,269.0,114.0,14,2429,847.0,588.0,145.0
0.071,6,10,1506,5,395,14.0,127.0,127.0,5,1111,14.0,843.0,843.0
0.006,6,10,1547,5,764,1.0,496.0,496.0,5,783,1.0,515.0,515.0
0.125,17,2,80,1,32,0.0,4.0,4.0,1,48,0.0,20.0,20.0
40.063,17,10,676,5,460,10014.0,104.0,64.0,5,216,10014.0,20.0,15.0
0.005,6,10,2006,5,927,1.0,659.0,659.0,5,1079,1.0,811.0,811.0
240.147,6,50,7343,25,3393,10006.0,588.0,230.0,25,3950,10006.0,580.0,220.0
0.004,17,2,136,1,60,0.0,32.0,32.0,1,76,0.0,48.0,48.0
0.005,6,10,1689,5,839,1.0,571.0,571.0,5,850,1.0,582.0,582.0
0.068,17,8,3613,4,1874,22.0,1350.0,440.0,4,1739,11.0,1350.0,406.0
294.328,6,402,348754,194,21650,1525.0,2736.0,888.0,208,327104,1421.0,2804.0,1630.0
0.014,6,10,1990,5,911,3.0,643.0,643.0,5,1079,3.0,811.0,811.0
0.006,17,2,164,1,74,0.0,46.0,46.0,1,90,0.0,62.0,62.0
0.006,6,10,1547,5,764,1.0,496.0,496.0,5,783,1.0,515.0,515.0
0.005,6,10,2007,5,928,1.0,660.0,660.0,5,1079,1.0,811.0,811.0
0.04,17,2,148,1,60,0.0,32.0,32.0,1,88,0.0,60.0,60.0
0.004,6,10,1989,5,927,1.0,659.0,659.0,5,1062,1.0,794.0,794.0
0.091,6,10,1506,5,395,20.0,127.0,127.0,5,1111,19.0,843.0,843.0
0.088,6,10,1506,5,395,19.0,127.0,127.0,5,1111,16.0,843.0,843.0
0.006,6,10,1547,5,764,1.0,496.0,496.0,5,783,1.0,515.0,515.0
0.014,6,10,1990,5,911,3.0,643.0,643.0,5,1079,3.0,811.0,811.0
0.11,6,10,1506,5,395,25.0,127.0,127.0,5,1111,23.0,843.0,843.0
0.002,17,2,180,1,66,0.0,38.0,38.0,1,114,0.0,86.0,86.0
0.012,6,10,1989,5,910,3.0,642.0,642.0,5,1079,3.0,811.0,811.0
0.005,6,10,1779,5,928,1.0,660.0,660.0,5,851,1.0,583.0,583.0
0.0,17,2,136,1,60,0.0,32.0,32.0,1,76,0.0,48.0,48.0
0.005,6,10,2000,5,927,1.0,659.0,659.0,5,1073,1.0,805.0,805.0
15.031,17,39,20036,22,17079,714.0,1350.0,748.0,17,2957,937.0,1350.0,145.0
0.012,6,10,1989,5,910,2.0,642.0,642.0,5,1079,2.0,811.0,811.0
0.011,6,10,1972,5,910,2.0,642.0,642.0,5,1062,2.0,794.0,794.0
0.009,6,13,3735,7,497,1.0,125.0,125.0,6,3238,1.0,1470.0,1459.0
0.009,6,10,1983,5,910,2.0,642.0,642.0,5,1073,2.0,805.0,805.0
0.004,17,2,148,1,60,0.0,32.0,32.0,1,88,0.0,60.0,60.0
0.012,6,12,1926,6,1189,2.0,659.0,434.0,6,737,2.0,417.0,417.0
0.108,6,10,1506,5,395,26.0,127.0,127.0,5,1111,24.0,843.0,843.0
0.089,17,2,152,1,76,0.0,48.0,48.0,1,76,0.0,48.0,48.0
0.017,6,10,1990,5,911,4.0,643.0,643.0,5,1079,4.0,811.0,811.0
0.017,6,10,1990,5,911,4.0,643.0,643.0,5,1079,4.0,811.0,811.0
0.008,6,10,1983,5,910,2.0,642.0,642.0,5,1073,2.0,805.0,805.0
0.077,6,10,1506,5,395,18.0,127.0,127.0,5,1111,18.0,843.0,843.0
0.079,6,10,1506,5,395,18.0,127.0,127.0,5,1111,16.0,843.0,843.0
0.105,6,10,1506,5,395,22.0,127.0,127.0,5,1111,24.0,843.0,843.0
0.071,17,8,3613,4,1874,23.0,1350.0,440.0,4,1739,12.0,1350.0,406.0
0.01,6,10,1972,5,910,2.0,642.0,642.0,5,1062,2.0,794.0,794.0
0.01,6,10,1989,5,910,2.0,642.0,642.0,5,1079,2.0,811.0,811.0
0.273,17,4,352,2,130,142.0,37.0,37.0,2,222,236.0,89.0,83.0
0.005,6,10,2007,5,928,1.0,660.0,660.0,5,1079,1.0,811.0,811.0
0.005,6,13,3747,7,509,0.0,137.0,137.0,6,3238,1.0,1470.0,1459.0
352.041,6,20,2210,6,1308,12003.0,494.0,494.0,14,902,27079.0,83.0,83.0
0.013,6,13,3735,7,497,2.0,125.0,125.0,6,3238,2.0,1470.0,1459.0
0.041,17,2,412,1,61,0.0,33.0,33.0,1,351,0.0,323.0,323.0
0.082,6,10,1506,5,395,19.0,127.0,127.0,5,1111,18.0,843.0,843.0
0.117,6,10,1506,5,395,23.0,127.0,127.0,5,1111,25.0,843.0,843.0
40.076,17,10,676,5,460,10016.0,104.0,64.0,5,216,10018.0,20.0,15.0
244.081,6,38,9727,21,2294,12200.0,746.0,235.0,17,7433,15062.0,2804.0,655.0
0.004,6,10,1989,5,927,1.0,659.0,659.0,5,1062,1.0,794.0,794.0
0.019,6,10,1631,5,848,4.0,580.0,580.0,5,783,4.0,515.0,515.0
40.072,17,10,676,5,460,10016.0,104.0,64.0,5,216,10017.0,20.0,15.0
0.125,6,10,1506,5,395,30.0,127.0,127.0,5,1111,30.0,843.0,843.0
0.004,6,10,1779,5,928,1.0,660.0,660.0,5,851,1.0,583.0,583.0
0.012,6,10,1972,5,910,3.0,642.0,642.0,5,1062,2.0,794.0,794.0
0.006,6,10,1854,5,889,1.0,621.0,621.0,5,965,1.0,697.0,697.0
240.079,6,19,4675,9,2153,30009.0,950.0,563.0,10,2522,26675.0,1162.0,398.0
0.005,6,10,2007,5,928,1.0,660.0,660.0,5,1079,1.0,811.0,811.0
1756.65,6,469,68279,263,36165,6704.0,613.0,192.0,206,32114,8568.0,613.0,146.0
240.093,6,16,4481,9,963,30011.0,238.0,166.0,7,3518,40015.0,1402.0,786.0
0.088,6,10,1506,5,395,17.0,127.0,127.0,5,1111,20.0,843.0,843.0
40.094,17,10,676,5,460,10013.0,104.0,64.0,5,216,10022.0,20.0,15.0
0.107,6,10,1506,5,395,21.0,127.0,127.0,5,1111,24.0,843.0,843.0
15.071,17,15,9239,8,6902,2149.0,1350.0,834.0,7,2337,2507.0,1350.0,305.0
0.003,17,2,136,1,60,0.0,32.0,32.0,1,76,0.0,48.0,48.0
0.005,6,10,1989,5,927,1.0,659.0,659.0,5,1062,1.0,794.0,794.0
0.006,6,10,1547,5,764,1.0,496.0,496.0,5,783,1.0,515.0,515.0
0.005,17,2,293,1,73,0.0,45.0,45.0,1,220,0.0,192.0,192.0
0.005,6,14,3742,8,504,0.0,80.0,80.0,6,3238,0.0,1470.0,1459.0
0.005,6,10,2006,5,927,1.0,659.0,659.0,5,1079,1.0,811.0,811.0
0.012,6,10,1972,5,910,3.0,642.0,642.0,5,1062,2.0,794.0,794.0
0.001,17,2,180,1,66,0.0,38.0,38.0,1,114,0.0,86.0,86.0
0.005,6,10,1989,5,927,1.0,659.0,659.0,5,1062,1.0,794.0,794.0
0.004,6,10,1702,5,863,1.0,595.0,595.0,5,839,1.0,571.0,571.0
0.013,6,10,1989,5,910,3.0,642.0,642.0,5,1079,3.0,811.0,811.0
0.01,6,10,1989,5,910,2.0,642.0,642.0,5,1079,2.0,811.0,811.0
0.005,17,2,170,1,65,0.0,37.0,37.0,1,105,0.0,77.0,77.0
284.853,6,20,3800,11,2323,28485.0,676.0,348.0,9,1477,35606.0,824.0,337.0
0.003,17,2,136,1,60,0.0,32.0,32.0,1,76,0.0,48.0,48.0
0.07,17,8,3613,4,1874,23.0,1350.0,440.0,4,1739,12.0,1350.0,406.0
0.089,6,10,1506,5,395,19.0,127.0,127.0,5,1111,19.0,843.0,843.0
10.765,17,28,4422,14,1995,819.0,270.0,114.0,14,2427,819.0,586.0,145.0
0.003,17,2,136,1,60,0.0,32.0,32.0,1,76,0.0,48.0,48.0
560.281,58,6,432,4,288,186760.0,24.0,24.0,2,144,536643.0,24.0,24.0
0.005,6,10,2007,5,928,1.0,660.0,660.0,5,1079,1.0,811.0,811.0
10.771,17,28,4423,14,1995,820.0,270.0,114.0,14,2428,820.0,587.0,145.0
240.017,6,9,787,5,488,60004.0,232.0,232.0,4,299,80004.0,83.0,83.0
15.177,17,20,11377,10,7812,1683.0,1350.0,753.0,10,3565,1682.0,1350.0,328.0
0.009,6,10,1762,5,911,2.0,643.0,643.0,5,851,2.0,583.0,583.0
0.006,6,10,1854,5,889,1.0,621.0,621.0,5,965,1.0,697.0,697.0
168.089,17,98,13865,49,3280,3501.0,44.0,38.0,49,10585,3501.0,261.0,188.0
0.001,17,2,180,1,66,0.0,38.0,38.0,1,114,0.0,86.0,86.0
241.478,6,385,347764,202,22039,1201.0,2736.0,960.0,183,325725,1326.0,2804.0,1827.0
174.215,17,88,12724,44,2955,4051.0,44.0,39.0,44,9769,4051.0,261.0,194.0
0.019,6,10,1989,5,910,4.0,642.0,642.0,5,1079,4.0,811.0,811.0
0.013,6,10,1990,5,911,3.0,643.0,643.0,5,1079,3.0,811.0,811.0
0.019,6,12,1926,6,1189,3.0,659.0,434.0,6,737,3.0,417.0,417.0
0.097,6,10,1506,5,395,21.0,127.0,127.0,5,1111,21.0,843.0,843.0
0.038,17,4,352,2,130,0.0,37.0,37.0,2,222,34.0,89.0,83.0
0.111,6,10,1506,5,395,25.0,127.0,127.0,5,1111,22.0,843.0,843.0
0.037,17,4,284,2,120,0.0,32.0,32.0,2,164,34.0,60.0,54.0
0.009,6,10,1990,5,911,2.0,643.0,643.0,5,1079,2.0,811.0,811.0
0.134,17,2,80,1,32,0.0,4.0,4.0,1,48,0.0,20.0,20.0
0.006,6,10,1989,5,927,1.0,659.0,659.0,5,1062,1.0,794.0,794.0
0.005,6,10,1989,5,927,1.0,659.0,659.0,5,1062,1.0,794.0,794.0
0.015,6,10,1990,5,911,3.0,643.0,643.0,5,1079,3.0,811.0,811.0
0.003,17,2,170,1,65,0.0,37.0,37.0,1,105,0.0,77.0,77.0
0.006,6,10,1547,5,764,1.0,496.0,496.0,5,783,1.0,515.0,515.0
0.006,6,10,1547,5,764,1.0,496.0,496.0,5,783,1.0,515.0,515.0
0.006,6,10,1689,5,839,1.0,571.0,571.0,5,850,1.0,582.0,582.0
0.116,6,10,1506,5,395,27.0,127.0,127.0,5,1111,25.0,843.0,843.0
0.012,6,10,1989,5,910,3.0,642.0,642.0,5,1079,2.0,811.0,811.0
0.103,6,10,1506,5,395,24.0,127.0,127.0,5,1111,21.0,843.0,843.0
0.014,6,10,1983,5,910,3.0,642.0,642.0,5,1073,3.0,805.0,805.0
0.011,6,10,1972,5,910,2.0,642.0,642.0,5,1062,2.0,794.0,794.0
40.052,17,10,676,5,460,10012.0,104.0,64.0,5,216,10009.0,20.0,15.0
0.073,6,10,1506,5,395,17.0,127.0,127.0,5,1111,16.0,843.0,843.0
0.011,6,10,1989,5,910,2.0,642.0,642.0,5,1079,2.0,811.0,811.0
0.006,6,10,1547,5,764,1.0,496.0,496.0,5,783,1.0,515.0,515.0
0.005,6,10,2006,5,927,1.0,659.0,659.0,5,1079,1.0,811.0,811.0
240.212,6,16,4481,9,963,30026.0,238.0,166.0,7,3518,40027.0,1402.0,786.0
0.005,6,14,3799,7,509,0.0,137.0,137.0,7,3290,0.0,1448.0,972.0
0.012,6,10,1762,5,911,3.0,643.0,643.0,5,851,2.0,583.0,583.0
40.067,17,10,676,5,460,10015.0,104.0,64.0,5,216,10015.0,20.0,15.0
300.308,6,16,2170,9,684,37518.0,146.0,146.0,7,1486,50024.0,419.0,398.0
0.004,17,4,284,2,120,0.0,32.0,32.0,2,164,0.0,60.0,54.0
0.004,6,10,2007,5,928,1.0,660.0,660.0,5,1079,1.0,811.0,811.0
0.016,6,10,1989,5,910,4.0,642.0,642.0,5,1079,3.0,811.0,811.0
0.009,6,10,1989,5,910,2.0,642.0,642.0,5,1079,2.0,811.0,811.0
0.005,6,10,1989,5,927,1.0,659.0,659.0,5,1062,1.0,794.0,794.0
0.017,6,10,2000,5,927,4.0,659.0,659.0,5,1073,4.0,805.0,805.0
0.039,17,4,284,2,120,0.0,32.0,32.0,2,164,35.0,60.0,54.0
0.006,6,10,1547,5,764,1.0,496.0,496.0,5,783,1.0,515.0,515.0
0.003,17,4,284,2,120,0.0,32.0,32.0,2,164,0.0,60.0,54.0
0.125,6,10,1506,5,395,28.0,127.0,127.0,5,1111,29.0,843.0,843.0
0.016,6,10,1972,5,910,4.0,642.0,642.0,5,1062,3.0,794.0,794.0
163.469,17,80,11325,40,2669,4191.0,44.0,38.0,40,8656,4191.0,261.0,188.0
0.01,6,14,3787,7,497,1.0,125.0,125.0,7,3290,1.0,1448.0,972.0
376.548,6,22,2313,16,867,25103.0,195.0,195.0,6,1446,4634.0,419.0,398.0
0.005,6,10,2000,5,927,1.0,659.0,659.0,5,1073,1.0,805.0,805.0
0.009,6,10,1762,5,911,2.0,643.0,643.0,5,851,2.0,583.0,583.0
0.005,6,10,2007,5,928,1.0,660.0,660.0,5,1079,1.0,811.0,811.0
0.005,6,10,2000,5,927,1.0,659.0,659.0,5,1073,1.0,805.0,805.0
0.012,6,10,1972,5,910,3.0,642.0,642.0,5,1062,3.0,794.0,794.0
10.958,17,28,4420,14,1993,834.0,268.0,114.0,14,2427,834.0,586.0,145.0
0.005,6,10,1989,5,927,1.0,659.0,659.0,5,1062,1.0,794.0,794.0
0.006,6,10,1547,5,764,1.0,496.0,496.0,5,783,1.0,515.0,515.0
10.794,17,28,4422,14,1994,822.0,269.0,114.0,14,2428,822.0,587.0,145.0
0.04,17,4,352,2,130,0.0,37.0,37.0,2,222,0.0,89.0,83.0
0.013,17,2,152,1,56,0.0,28.0,28.0,1,96,0.0,68.0,68.0
0.019,6,10,1631,5,848,4.0,580.0,580.0,5,783,4.0,515.0,515.0
0.088,6,10,1506,5,395,18.0,127.0,127.0,5,1111,20.0,843.0,843.0
0.011,6,10,1989,5,910,2.0,642.0,642.0,5,1079,2.0,811.0,811.0
1770.758,6,84,4419,42,2211,43188.0,27.0,27.0,42,2208,43188.0,24.0,24.0
0.004,6,10,2000,5,927,1.0,659.0,659.0,5,1073,1.0,805.0,805.0
0.01,6,10,1983,5,910,2.0,642.0,642.0,5,1073,2.0,805.0,805.0
240.094,6,31,9311,15,6822,17149.0,1946.0,671.0,16,2489,16006.0,580.0,206.0
0.008,6,10,1972,5,910,2.0,642.0,642.0,5,1062,2.0,794.0,794.0
0.005,17,2,179,1,71,0.0,43.0,43.0,1,108,0.0,80.0,80.0
40.075,17,10,676,5,460,10015.0,104.0,64.0,5,216,10017.0,20.0,15.0
0.013,6,10,1989,5,910,3.0,642.0,642.0,5,1079,3.0,811.0,811.0
0.005,6,10,1779,5,928,1.0,660.0,660.0,5,851,1.0,583.0,583.0
0.013,6,13,3735,7,497,2.0,125.0,125.0,6,3238,2.0,1470.0,1459.0
0.108,6,10,1506,5,395,24.0,127.0,127.0,5,1111,24.0,843.0,843.0
0.04,17,4,336,2,124,1.0,34.0,34.0,2,212,2.0,84.0,78.0
0.005,6,10,2006,5,927,1.0,659.0,659.0,5,1079,1.0,811.0,811.0
0.006,6,10,1547,5,764,1.0,496.0,496.0,5,783,1.0,515.0,515.0
0.006,6,10,1547,5,764,1.0,496.0,496.0,5,783,1.0,515.0,515.0
0.001,17,2,180,1,66,0.0,38.0,38.0,1,114,0.0,86.0,86.0
0.032,6,10,1972,5,910,7.0,642.0,642.0,5,1062,7.0,794.0,794.0
0.006,6,10,1689,5,839,1.0,571.0,571.0,5,850,1.0,582.0,582.0
0.016,6,10,1990,5,911,4.0,643.0,643.0,5,1079,4.0,811.0,811.0
0.065,6,10,1506,5,395,14.0,127.0,127.0,5,1111,13.0,843.0,843.0
11.172,17,28,4423,14,1994,847.0,269.0,114.0,14,2429,846.0,588.0,145.0
0.006,17,2,179,1,71,0.0,43.0,43.0,1,108,0.0,80.0,80.0
0.015,6,10,1989,5,910,3.0,642.0,642.0,5,1079,3.0,811.0,811.0
0.092,6,10,1506,5,395,21.0,127.0,127.0,5,1111,20.0,843.0,843.0
0.011,6,10,1972,5,910,2.0,642.0,642.0,5,1062,2.0,794.0,794.0
0.005,6,10,1989,5,927,1.0,659.0,659.0,5,1062,1.0,794.0,794.0
0.006,6,10,2000,5,927,1.0,659.0,659.0,5,1073,1.0,805.0,805.0
0.01,6,10,1631,5,848,2.0,580.0,580.0,5,783,2.0,515.0,515.0
0.093,17,2,152,1,76,0.0,48.0,48.0,1,76,0.0,48.0,48.0
0.338,17,15,9899,8,6907,48.0,1350.0,835.0,7,2992,47.0,1350.0,399.0
0.003,17,2,136,1,60,0.0,32.0,32.0,1,76,0.0,48.0,48.0
0.096,6,10,1506,5,395,22.0,127.0,127.0,5,1111,22.0,843.0,843.0
0.014,6,10,1677,5,827,3.0,559.0,559.0,5,850,3.0,582.0,582.0
0.005,6,10,2006,5,927,1.0,659.0,659.0,5,1079,1.0,811.0,811.0
0.101,6,10,1506,5,395,22.0,127.0,127.0,5,1111,22.0,843.0,843.0
0.018,6,10,1989,5,910,4.0,642.0,642.0,5,1079,4.0,811.0,811.0
40.081,17,10,676,5,460,10018.0,104.0,64.0,5,216,10019.0,20.0,15.0
0.041,17,2,152,1,76,0.0,48.0,48.0,1,76,0.0,48.0,48.0
0.08,6,10,1506,5,395,17.0,127.0,127.0,5,1111,16.0,843.0,843.0
0.04,17,2,136,1,60,0.0,32.0,32.0,1,76,0.0,48.0,48.0
0.146,6,10,1506,5,395,33.0,127.0,127.0,5,1111,30.0,843.0,843.0
0.005,17,2,214,1,75,0.0,47.0,47.0,1,139,0.0,111.0,111.0
0.005,6,10,2000,5,927,1.0,659.0,659.0,5,1073,1.0,805.0,805.0
0.076,6,10,1506,5,395,17.0,127.0,127.0,5,1111,17.0,843.0,843.0
15.074,17,15,9238,8,6902,2149.0,1350.0,834.0,7,2336,2507.0,1350.0,305.0
0.006,6,10,1689,5,839,1.0,571.0,571.0,5,850,1.0,582.0,582.0
309.087,17,20,1124,10,716,34329.0,48.0,43.0,10,408,34329.0,20.0,12.0
0.004,6,10,1989,5,927,1.0,659.0,659.0,5,1062,1.0,794.0,794.0
0.005,6,10,1547,5,764,1.0,496.0,496.0,5,783,1.0,515.0,515.0
65.908,6,22,10152,12,3985,5991.0,1591.0,838.0,10,6167,7304.0,2111.0,939.0
0.005,17,2,166,1,75,0.0,47.0,47.0,1,91,0.0,63.0,63.0
0.006,6,10,1854,5,889,1.0,621.0,621.0,5,965,1.0,697.0,697.0
0.015,6,10,1990,5,911,3.0,643.0,643.0,5,1079,3.0,811.0,811.0
0.005,17,2,178,1,65,0.0,37.0,37.0,1,113,0.0,85.0,85.0
11.175,17,28,4424,14,1995,847.0,270.0,114.0,14,2429,847.0,588.0,145.0
0.039,17,2,136,1,60,0.0,32.0,32.0,1,76,0.0,48.0,48.0
0.109,6,10,1506,5,395,23.0,127.0,127.0,5,1111,21.0,843.0,843.0
0.026,6,10,1631,5,848,6.0,580.0,580.0,5,783,6.0,515.0,515.0
0.011,6,10,1983,5,910,2.0,642.0,642.0,5,1073,2.0,805.0,805.0
0.012,6,10,1631,5,848,3.0,580.0,580.0,5,783,3.0,515.0,515.0
0.013,6,10,1989,5,910,3.0,642.0,642.0,5,1079,3.0,811.0,811.0
15.079,17,15,8057,8,5996,2150.0,1350.0,721.0,7,2061,2508.0,1350.0,266.0
0.004,17,2,146,1,65,0.0,37.0,37.0,1,81,0.0,53.0,53.0
0.005,6,10,2006,5,927,1.0,659.0,659.0,5,1079,1.0,811.0,811.0
0.009,6,12,1926,6,1189,1.0,659.0,434.0,6,737,1.0,417.0,417.0
15.204,17,46,25978,25,21226,632.0,1350.0,821.0,21,4752,758.0,1350.0,198.0
0.028,6,10,1983,5,910,6.0,642.0,642.0,5,1073,7.0,805.0,805.0
0.013,6,10,1989,5,910,3.0,642.0,642.0,5,1079,3.0,811.0,811.0
0.003,17,2,148,1,60,0.0,32.0,32.0,1,88,0.0,60.0,60.0
3.178,6,24,7517,13,1385,264.0,530.0,277.0,11,6132,300.0,2720.0,946.0
0.038,17,2,148,1,60,0.0,32.0,32.0,1,88,0.0,60.0,60.0
0.006,17,2,293,1,73,0.0,45.0,45.0,1,220,0.0,192.0,192.0
0.005,6,10,1779,5,928,1.0,660.0,660.0,5,851,1.0,583.0,583.0
0.006,6,10,1547,5,764,1.0,496.0,496.0,5,783,1.0,515.0,515.0
0.01,6,10,1989,5,910,2.0,642.0,642.0,5,1079,2.0,811.0,811.0
0.081,6,10,1506,5,395,19.0,127.0,127.0,5,1111,17.0,843.0,843.0
240.09,6,30,8865,15,6646,17149.0,1769.0,652.0,15,2219,17149.0,580.0,178.0
0.056,17,2,179,1,71,0.0,43.0,43.0,1,108,0.0,80.0,80.0
0.078,6,10,1506,5,395,16.0,127.0,127.0,5,1111,17.0,843.0,843.0
176.393,17,80,11285,40,2670,4522.0,44.0,38.0,40,8615,4522.0,261.0,187.0
0.009,6,10,1972,5,910,2.0,642.0,642.0,5,1062,2.0,794.0,794.0
0.07,6,10,1506,5,395,15.0,127.0,127.0,5,1111,16.0,843.0,843.0
0.001,17,2,180,1,66,0.0,38.0,38.0,1,114,0.0,86.0,86.0
0.004,6,10,1779,5,928,1.0,660.0,660.0,5,851,1.0,583.0,583.0
368.711,6,22,2313,16,867,24580.0,195.0,195.0,6,1446,4646.0,419.0,398.0
40.059,17,10,676,5,460,10011.0,104.0,64.0,5,216,10013.0,20.0,15.0
40.063,17,10,676,5,460,10013.0,104.0,64.0,5,216,10014.0,20.0,15.0
0.005,6,10,1774,5,923,1.0,655.0,655.0,5,851,1.0,583.0,583.0
240.015,6,9,787,5,488,60003.0,232.0,232.0,4,299,80004.0,83.0,83.0
0.005,6,10,2006,5,927,1.0,659.0,659.0,5,1079,1.0,811.0,811.0
0.005,6,10,2007,5,928,1.0,660.0,660.0,5,1079,1.0,811.0,811.0
0.257,17,42,26481,25,23400,10.0,1350.0,908.0,17,3081,12.0,1350.0,153.0
0.005,6,14,3736,7,446,0.0,74.0,74.0,7,3290,0.0,1448.0,972.0
0.04,17,2,148,1,60,0.0,32.0,32.0,1,88,0.0,60.0,60.0
0.005,6,10,2006,5,927,1.0,659.0,659.0,5,1079,1.0,811.0,811.0
0.005,6,10,2006,5,927,1.0,659.0,659.0,5,1079,1.0,811.0,811.0
0.005,6,10,1547,5,764,1.0,496.0,496.0,5,783,1.0,515.0,515.0
0.093,6,10,1506,5,395,21.0,127.0,127.0,5,1111,20.0,843.0,843.0
0.111,6,10,1506,5,395,23.0,127.0,127.0,5,1111,22.0,843.0,843.0
0.15,6,10,1506,5,395,32.0,127.0,127.0,5,1111,32.0,843.0,843.0
0.008,6,10,1762,5,911,1.0,643.0,643.0,5,851,2.0,583.0,583.0
0.006,6,10,1547,5,764,1.0,496.0,496.0,5,783,1.0,515.0,515.0
0.004,17,2,148,1,60,0.0,32.0,32.0,1,88,0.0,60.0,60.0
0.099,6,10,1506,5,395,20.0,127.0,127.0,5,1111,22.0,843.0,843.0
0.005,6,10,1989,5,927,1.0,659.0,659.0,5,1062,1.0,794.0,794.0
0.133,17,2,80,1,32,0.0,4.0,4.0,1,48,0.0,20.0,20.0
0.127,6,10,1506,5,395,29.0,127.0,127.0,5,1111,23.0,843.0,843.0
40.053,17,10,676,5,460,10012.0,104.0,64.0,5,216,10012.0,20.0,15.0
0.119,6,10,1506,5,395,27.0,127.0,127.0,5,1111,27.0,843.0,843.0
0.005,6,10,2006,5,927,1.0,659.0,659.0,5,1079,1.0,811.0,811.0
0.011,17,2,136,1,60,0.0,32.0,32.0,1,76,0.0,48.0,48.0
0.004,17,4,284,2,120,0.0,32.0,32.0,2,164,0.0,60.0,54.0
0.119,6,10,1506,5,395,26.0,127.0,127.0,5,1111,27.0,843.0,843.0
0.015,6,10,1989,5,910,3.0,642.0,642.0,5,1079,3.0,811.0,811.0
0.013,6,10,1677,5,827,3.0,559.0,559.0,5,850,3.0,582.0,582.0
0.116,6,10,1506,5,395,26.0,127.0,127.0,5,1111,25.0,843.0,843.0
0.009,6,10,1990,5,911,2.0,643.0,643.0,5,1079,2.0,811.0,811.0
0.521,6,27,12315,15,2541,37.0,1272.0,441.0,12,9774,47.0,1402.0,1015.0
0.004,6,10,2006,5,927,1.0,659.0,659.0,5,1079,1.0,811.0,811.0
0.136,6,10,1506,5,395,26.0,127.0,127.0,5,1111,29.0,843.0,843.0
0.105,6,10,1506,5,395,23.0,127.0,127.0,5,1111,23.0,843.0,843.0
0.005,6,10,2006,5,927,1.0,659.0,659.0,5,1079,1.0,811.0,811.0
0.012,6,10,1983,5,910,3.0,642.0,642.0,5,1073,2.0,805.0,805.0
0.074,17,2,186,1,61,0.0,33.0,33.0,1,125,0.0,97.0,97.0
0.011,6,10,1990,5,911,2.0,643.0,643.0,5,1079,2.0,811.0,811.0
0.065,6,10,1506,5,395,15.0,127.0,127.0,5,1111,14.0,843.0,843.0
0.011,6,10,1989,5,910,2.0,642.0,642.0,5,1079,2.0,811.0,811.0
0.004,17,4,284,2,120,0.0,32.0,32.0,2,164,0.0,60.0,54.0
0.145,6,10,1506,5,395,28.0,127.0,127.0,5,1111,31.0,843.0,843.0
0.013,6,10,1631,5,848,3.0,580.0,580.0,5,783,3.0,515.0,515.0
0.063,6,10,1506,5,395,15.0,127.0,127.0,5,1111,13.0,843.0,843.0
0.013,6,10,1972,5,910,3.0,642.0,642.0,5,1062,3.0,794.0,794.0
0.015,6,10,1972,5,910,3.0,642.0,642.0,5,1062,3.0,794.0,794.0
11.136,17,28,4419,14,1995,844.0,270.0,114.0,14,2424,844.0,587.0,145.0
0.006,6,12,1698,6,863,1.0,327.0,271.0,6,835,1.0,515.0,515.0
0.162,17,2,152,1,76,0.0,48.0,48.0,1,76,0.0,48.0,48.0
0.097,6,10,1506,5,395,22.0,127.0,127.0,5,1111,18.0,843.0,843.0
280.626,6,24,7515,10,1186,31179.0,267.0,156.0,14,6329,21586.0,1400.0,960.0
308.356,17,20,1124,10,716,34251.0,48.0,43.0,10,408,34248.0,20.0,12.0
0.016,6,19,9922,11,704,1.0,124.0,124.0,8,9218,2.0,2896.0,2198.0
0.124,6,10,1506,5,395,27.0,127.0,127.0,5,1111,29.0,843.0,843.0
0.088,6,10,1506,5,395,20.0,127.0,127.0,5,1111,19.0,843.0,843.0
1750.24,6,64,7344,42,4469,42688.0,1625.0,108.0,22,2875,83336.0,1111.0,82.0
0.072,17,2,136,1,60,0.0,32.0,32.0,1,76,0.0,48.0,48.0
0.005,6,10,2007,5,928,1.0,660.0,660.0,5,1079,1.0,811.0,811.0
40.061,17,10,676,5,460,10014.0,104.0,64.0,5,216,10014.0,20.0,15.0
0.006,6,10,1854,5,889,1.0,621.0,621.0,5,965,1.0,697.0,697.0
0.004,6,10,1779,5,928,1.0,660.0,660.0,5,851,1.0,583.0,583.0
0.004,17,2,136,1,60,0.0,32.0,32.0,1,76,0.0,48.0,48.0
0.132,6,10,1506,5,395,32.0,127.0,127.0,5,1111,25.0,843.0,843.0
0.003,17,2,148,1,60,0.0,32.0,32.0,1,88,0.0,60.0,60.0
15.071,17,15,9238,8,6902,2149.0,1350.0,834.0,7,2336,2507.0,1350.0,305.0
0.083,6,10,1506,5,395,19.0,127.0,127.0,5,1111,18.0,843.0,843.0
0.008,17,2,194,1,59,0.0,31.0,31.0,1,135,0.0,107.0,107.0
0.086,6,10,1506,5,395,18.0,127.0,127.0,5,1111,19.0,843.0,843.0
0.09,6,10,1506,5,395,20.0,127.0,127.0,5,1111,20.0,843.0,843.0
0.006,6,10,1989,5,927,1.0,659.0,659.0,5,1062,1.0,794.0,794.0
0.01,6,10,1972,5,910,2.0,642.0,642.0,5,1062,2.0,794.0,794.0
0.008,6,10,1631,5,848,2.0,580.0,580.0,5,783,2.0,515.0,515.0
0.005,6,10,2007,5,928,1.0,660.0,660.0,5,1079,1.0,811.0,811.0
10.939,17,28,4419,14,1995,832.0,270.0,114.0,14,2424,833.0,587.0,145.0
0.014,6,10,1677,5,827,3.0,559.0,559.0,5,850,3.0,582.0,582.0
0.04,17,2,170,1,65,0.0,37.0,37.0,1,105,0.0,77.0,77.0
0.042,17,2,152,1,76,0.0,48.0,48.0,1,76,0.0,48.0,48.0
0.003,17,2,136,1,60,0.0,32.0,32.0,1,76,0.0,48.0,48.0
354.015,6,21,1795,16,1030,23601.0,190.0,190.0,5,765,60001.0,464.0,248.0
0.229,6,16,2674,8,1400,32.0,533.0,325.0,8,1274,21.0,529.0,212.0
0.015,6,10,1990,5,911,3.0,643.0,643.0,5,1079,3.0,811.0,811.0
359.236,6,19,1691,15,978,25659.0,190.0,190.0,4,713,80003.0,497.0,497.0
30.022,6,12,1313,7,557,5003.0,185.0,185.0,5,756,7503.0,476.0,244.0
0.004,17,2,136,1,60,0.0,32.0,32.0,1,76,0.0,48.0,48.0
0.005,6,10,2006,5,927,1.0,659.0,659.0,5,1079,1.0,811.0,811.0
0.005,6,10,1989,5,927,1.0,659.0,659.0,5,1062,1.0,794.0,794.0
0.006,17,2,179,1,71,0.0,43.0,43.0,1,108,0.0,80.0,80.0
0.006,6,10,1547,5,764,1.0,496.0,496.0,5,783,1.0,515.0,515.0
0.004,17,4,284,2,120,1.0,32.0,32.0,2,164,0.0,60.0,54.0
0.013,17,2,152,1,56,0.0,28.0,28.0,1,96,0.0,68.0,68.0
0.005,6,10,2007,5,928,1.0,660.0,660.0,5,1079,1.0,811.0,811.0
0.094,6,10,1506,5,395,20.0,127.0,127.0,5,1111,22.0,843.0,843.0
0.072,6,10,1506,5,395,15.0,127.0,127.0,5,1111,15.0,843.0,843.0
0.014,6,10,1990,5,911,3.0,643.0,643.0,5,1079,3.0,811.0,811.0
0.005,6,10,2006,5,927,1.0,659.0,659.0,5,1079,1.0,811.0,811.0
0.006,6,10,1547,5,764,1.0,496.0,496.0,5,783,1.0,515.0,515.0
0.009,6,10,1762,5,911,2.0,643.0,643.0,5,851,2.0,583.0,583.0
0.004,17,2,148,1,60,0.0,32.0,32.0,1,88,0.0,60.0,60.0
0.016,6,10,1983,5,910,3.0,642.0,642.0,5,1073,4.0,805.0,805.0
0.008,6,10,1990,5,911,2.0,643.0,643.0,5,1079,2.0,811.0,811.0
0.006,6,10,1547,5,764,1.0,496.0,496.0,5,783,1.0,515.0,515.0
0.018,17,2,136,1,60,0.0,32.0,32.0,1,76,0.0,48.0,48.0
11.244,17,28,4394,14,2312,856.0,587.0,137.0,14,2082,856.0,269.0,120.0
0.005,6,10,1989,5,927,1.0,659.0,659.0,5,1062,1.0,794.0,794.0
0.008,6,10,1547,5,764,2.0,496.0,496.0,5,783,1.0,515.0,515.0
0.004,17,4,284,2,120,0.0,32.0,32.0,2,164,1.0,60.0,54.0
0.072,6,10,1506,5,395,15.0,127.0,127.0,5,1111,17.0,843.0,843.0
0.01,6,10,1972,5,910,2.0,642.0,642.0,5,1062,2.0,794.0,794.0
0.006,6,10,2007,5,928,1.0,660.0,660.0,5,1079,1.0,811.0,811.0
0.005,6,10,1689,5,839,1.0,571.0,571.0,5,850,1.0,582.0,582.0
180.255,17,92,13110,46,3077,4005.0,44.0,38.0,46,10033,4005.0,261.0,190.0
0.009,6,10,1972,5,910,2.0,642.0,642.0,5,1062,2.0,794.0,794.0
40.061,17,10,676,5,460,10013.0,104.0,64.0,5,216,10014.0,20.0,15.0
0.013,6,10,1631,5,848,3.0,580.0,580.0,5,783,3.0,515.0,515.0
0.005,6,10,2006,5,927,1.0,659.0,659.0,5,1079,1.0,811.0,811.0
0.008,6,10,1983,5,910,2.0,642.0,642.0,5,1073,1.0,805.0,805.0
0.008,6,10,1989,5,910,1.0,642.0,642.0,5,1079,2.0,811.0,811.0
0.125,6,10,1506,5,395,28.0,127.0,127.0,5,1111,27.0,843.0,843.0
0.016,6,10,1631,5,848,4.0,580.0,580.0,5,783,3.0,515.0,515.0
0.013,6,10,1677,5,827,3.0,559.0,559.0,5,850,3.0,582.0,582.0
0.005,6,14,3799,7,509,0.0,137.0,137.0,7,3290,0.0,1448.0,972.0
0.006,6,10,1547,5,764,1.0,496.0,496.0,5,783,1.0,515.0,515.0
0.013,6,10,1973,5,911,3.0,643.0,643.0,5,1062,3.0,794.0,794.0
0.008,6,10,1989,5,910,2.0,642.0,642.0,5,1079,1.0,811.0,811.0
240.499,6,33,8638,17,1838,15029.0,571.0,189.0,16,6800,16031.0,1402.0,597.0
0.003,17,4,284,2,120,0.0,32.0,32.0,2,164,0.0,60.0,54.0
0.06,17,2,80,1,32,0.0,4.0,4.0,1,48,0.0,20.0,20.0
0.122,6,10,1506,5,395,26.0,127.0,127.0,5,1111,24.0,843.0,843.0
0.005,6,10,2007,5,928,1.0,660.0,660.0,5,1079,1.0,811.0,811.0
0.078,6,10,1506,5,395,17.0,127.0,127.0,5,1111,15.0,843.0,843.0
0.014,6,13,3735,7,497,2.0,125.0,125.0,6,3238,2.0,1470.0,1459.0
0.022,6,10,1677,5,827,5.0,559.0,559.0,5,850,5.0,582.0,582.0
0.018,6,10,1990,5,911,4.0,643.0,643.0,5,1079,4.0,811.0,811.0
0.005,17,2,136,1,60,0.0,32.0,32.0,1,76,0.0,48.0,48.0
0.015,6,10,1762,5,911,3.0,643.0,643.0,5,851,3.0,583.0,583.0
0.003,17,2,152,1,76,0.0,48.0,48.0,1,76,0.0,48.0,48.0
0.004,17,2,180,1,66,0.0,38.0,38.0,1,114,0.0,86.0,86.0
0.005,6,10,2007,5,928,1.0,660.0,660.0,5,1079,1.0,811.0,811.0
0.005,17,2,136,1,60,0.0,32.0,32.0,1,76,0.0,48.0,48.0
240.011,6,9,787,5,488,60002.0,232.0,232.0,4,299,80002.0,83.0,83.0
0.004,6,10,2000,5,927,1.0,659.0,659.0,5,1073,1.0,805.0,805.0
360.03,6,21,3981,13,3142,30002.0,494.0,494.0,8,839,51432.0,83.0,83.0
0.001,17,2,180,1,66,0.0,38.0,38.0,1,114,0.0,86.0,86.0
0.023,6,10,1983,5,910,5.0,642.0,642.0,5,1073,5.0,805.0,805.0
0.085,6,10,1506,5,395,20.0,127.0,127.0,5,1111,19.0,843.0,843.0
0.011,6,10,1631,5,848,2.0,580.0,580.0,5,783,2.0,515.0,515.0
0.037,17,2,152,1,76,0.0,48.0,48.0,1,76,0.0,48.0,48.0
40.053,17,10,676,5,460,10012.0,104.0,64.0,5,216,10012.0,20.0,15.0
9.038,17,6,376,5,280,2259.0,28.0,28.0,1,96,0.0,68.0,68.0
0.011,6,10,1631,5,848,2.0,580.0,580.0,5,783,2.0,515.0,515.0
0.014,6,10,1989,5,910,3.0,642.0,642.0,5,1079,3.0,811.0,811.0
0.012,6,14,3965,7,495,2.0,123.0,123.0,7,3470,1.0,1448.0,1032.0
0.003,17,2,148,1,60,0.0,32.0,32.0,1,88,0.0,60.0,60.0
0.009,6,10,1983,5,910,2.0,642.0,642.0,5,1073,2.0,805.0,805.0
0.01,6,10,1990,5,911,2.0,643.0,643.0,5,1079,2.0,811.0,811.0
0.005,17,2,412,1,61,0.0,33.0,33.0,1,351,0.0,323.0,323.0
291.655,6,385,347077,192,21550,1526.0,2736.0,889.0,193,325527,1519.0,2804.0,1762.0
0.006,6,10,1547,5,764,1.0,496.0,496.0,5,783,1.0,515.0,515.0
0.005,6,10,2006,5,927,1.0,659.0,659.0,5,1079,1.0,811.0,811.0
0.082,6,10,1506,5,395,18.0,127.0,127.0,5,1111,19.0,843.0,843.0
0.003,17,2,136,1,60,0.0,32.0,32.0,1,76,0.0,48.0,48.0
0.008,6,10,1989,5,910,1.0,642.0,642.0,5,1079,1.0,811.0,811.0
0.005,6,10,2006,5,927,1.0,659.0,659.0,5,1079,1.0,811.0,811.0
0.005,6,10,2000,5,927,1.0,659.0,659.0,5,1073,1.0,805.0,805.0
0.013,6,10,1990,5,911,3.0,643.0,643.0,5,1079,3.0,811.0,811.0
0.006,17,2,184,1,68,0.0,40.0,40.0,1,116,0.0,88.0,88.0
0.009,6,10,1989,5,910,2.0,642.0,642.0,5,1079,2.0,811.0,811.0
0.013,6,10,1989,5,910,3.0,642.0,642.0,5,1079,3.0,811.0,811.0
0.001,17,2,180,1,66,0.0,38.0,38.0,1,114,0.0,86.0,86.0
0.091,6,10,1506,5,395,19.0,127.0,127.0,5,1111,21.0,843.0,843.0
0.01,6,10,1677,5,827,2.0,559.0,559.0,5,850,2.0,582.0,582.0
0.004,17,2,148,1,60,0.0,32.0,32.0,1,88,0.0,60.0,60.0
0.005,6,13,3747,7,509,0.0,137.0,137.0,6,3238,0.0,1470.0,1459.0
0.11,6,10,1506,5,395,26.0,127.0,127.0,5,1111,26.0,843.0,843.0
0.005,6,10,1774,5,923,1.0,655.0,655.0,5,851,1.0,583.0,583.0
158.475,17,76,11082,38,2555,4282.0,44.0,39.0,38,8527,4283.0,239.0,196.0
0.019,6,10,1631,5,848,4.0,580.0,580.0,5,783,4.0,515.0,515.0
0.024,17,2,166,1,75,0.0,47.0,47.0,1,91,0.0,63.0,63.0
0.038,17,2,148,1,60,0.0,32.0,32.0,1,88,0.0,60.0,60.0
27.156,17,24,14848,13,12031,2260.0,1350.0,897.0,11,2817,2712.0,1350.0,228.0
15.182,17,22,13600,11,9724,1515.0,1350.0,856.0,11,3876,1515.0,1350.0,324.0
1778.495,17,144,41760,72,22752,25049.0,288.0,288.0,72,19008,25049.0,236.0,236.0
0.103,6,10,1506,5,395,24.0,127.0,127.0,5,1111,22.0,843.0,843.0
0.041,17,2,136,1,60,0.0,32.0,32.0,1,76,0.0,48.0,48.0
0.108,6,10,1506,5,395,26.0,127.0,127.0,5,1111,24.0,843.0,843.0
0.006,17,2,164,1,74,0.0,46.0,46.0,1,90,0.0,62.0,62.0
0.004,17,2,136,1,60,0.0,32.0,32.0,1,76,0.0,48.0,48.0
0.151,6,10,1506,5,395,29.0,127.0,127.0,5,1111,32.0,843.0,843.0
178.208,17,72,10304,36,2410,5091.0,44.0,38.0,36,7894,5091.0,239.0,191.0
0.04,17,2,152,1,76,0.0,48.0,48.0,1,76,0.0,48.0,48.0
1756.887,6,125,12605,69,4760,25835.0,517.0,64.0,56,7845,31942.0,1402.0,234.0
172.362,17,86,12449,43,2885,4103.0,44.0,39.0,43,9564,4103.0,239.0,194.0
0.005,6,10,2006,5,927,1.0,659.0,659.0,5,1079,1.0,811.0,811.0
0.018,6,10,1983,5,910,4.0,642.0,642.0,5,1073,4.0,805.0,805.0
0.105,6,10,1506,5,395,24.0,127.0,127.0,5,1111,22.0,843.0,843.0
308.541,17,20,1124,10,716,34268.0,48.0,43.0,10,408,34268.0,20.0,12.0
0.074,6,10,1506,5,395,16.0,127.0,127.0,5,1111,18.0,843.0,843.0
0.004,6,10,2006,5,927,1.0,659.0,659.0,5,1079,1.0,811.0,811.0
0.011,6,10,1990,5,911,2.0,643.0,643.0,5,1079,2.0,811.0,811.0
40.055,17,10,676,5,460,10012.0,104.0,64.0,5,216,10013.0,20.0,15.0
0.004,17,2,136,1,60,0.0,32.0,32.0,1,76,0.0,48.0,48.0
0.005,6,10,2007,5,928,1.0,660.0,660.0,5,1079,1.0,811.0,811.0
0.078,6,10,1506,5,395,16.0,127.0,127.0,5,1111,17.0,843.0,843.0
0.007,6,10,2006,5,927,1.0,659.0,659.0,5,1079,1.0,811.0,811.0
0.072,6,10,1506,5,395,15.0,127.0,127.0,5,1111,15.0,843.0,843.0
240.084,6,16,4480,9,963,30010.0,238.0,166.0,7,3517,40013.0,1402.0,786.0
0.17,17,2,152,1,76,0.0,48.0,48.0,1,76,0.0,48.0,48.0
0.005,17,2,180,1,66,0.0,38.0,38.0,1,114,0.0,86.0,86.0
0.005,6,10,2006,5,927,1.0,659.0,659.0,5,1079,1.0,811.0,811.0
1798.696,6,243,35755,151,25972,11991.0,302.0,302.0,92,9783,19765.0,102.0,83.0
9.037,17,6,376,5,280,2259.0,28.0,28.0,1,96,0.0,68.0,68.0
1777.971,17,140,44240,72,22752,25040.0,288.0,288.0,68,21488,26535.0,288.0,288.0
0.005,6,10,1989,5,927,1.0,659.0,659.0,5,1062,1.0,794.0,794.0
0.012,6,10,1983,5,910,3.0,642.0,642.0,5,1073,2.0,805.0,805.0
0.008,6,10,1990,5,911,2.0,643.0,643.0,5,1079,2.0,811.0,811.0
0.004,6,10,1702,5,863,1.0,595.0,595.0,5,839,1.0,571.0,571.0
11.153,17,28,4398,14,2312,848.0,587.0,137.0,14,2086,849.0,269.0,121.0
40.056,17,10,676,5,460,10013.0,104.0,64.0,5,216,10013.0,20.0,15.0
0.038,17,2,170,1,65,0.0,37.0,37.0,1,105,0.0,77.0,77.0
0.148,6,10,1506,5,395,24.0,127.0,127.0,5,1111,35.0,843.0,843.0
240.094,6,30,9316,15,7048,17149.0,2172.0,696.0,15,2268,17149.0,580.0,211.0
0.024,6,10,1762,5,911,6.0,643.0,643.0,5,851,5.0,583.0,583.0
0.014,6,10,1990,5,911,3.0,643.0,643.0,5,1079,3.0,811.0,811.0
0.006,17,2,169,1,62,0.0,34.0,34.0,1,107,0.0,79.0,79.0
0.071,6,10,1506,5,395,15.0,127.0,127.0,5,1111,16.0,843.0,843.0
0.114,6,10,1506,5,395,25.0,127.0,127.0,5,1111,25.0,843.0,843.0
0.014,6,10,1989,5,910,3.0,642.0,642.0,5,1079,3.0,811.0,811.0
0.005,6,10,2006,5,927,1.0,659.0,659.0,5,1079,1.0,811.0,811.0
0.006,6,10,2006,5,927,1.0,659.0,659.0,5,1079,1.0,811.0,811.0
0.052,17,4,420,2,122,0.0,33.0,33.0,2,298,33.0,145.0,121.0
0.001,17,2,136,1,60,0.0,32.0,32.0,1,76,0.0,48.0,48.0
0.041,17,2,152,1,76,0.0,48.0,48.0,1,76,0.0,48.0,48.0
0.005,6,13,3747,7,509,0.0,137.0,137.0,6,3238,0.0,1470.0,1459.0
0.005,6,10,1989,5,927,1.0,659.0,659.0,5,1062,1.0,794.0,794.0
0.001,17,2,179,1,62,0.0,34.0,34.0,1,117,0.0,89.0,89.0
0.076,6,10,1506,5,395,16.0,127.0,127.0,5,1111,16.0,843.0,843.0
0.005,17,2,164,1,74,0.0,46.0,46.0,1,90,0.0,62.0,62.0
40.061,17,10,676,5,460,10014.0,104.0,64.0,5,216,10014.0,20.0,15.0
0.007,6,10,2000,5,927,1.0,659.0,659.0,5,1073,1.0,805.0,805.0
0.005,6,10,2006,5,927,1.0,659.0,659.0,5,1079,1.0,811.0,811.0
0.133,17,2,152,1,76,0.0,48.0,48.0,1,76,0.0,48.0,48.0
0.039,17,2,148,1,60,0.0,32.0,32.0,1,88,0.0,60.0,60.0
0.154,6,10,1506,5,395,33.0,127.0,127.0,5,1111,32.0,843.0,843.0
309.224,17,20,1124,10,716,34343.0,48.0,43.0,10,408,34343.0,20.0,12.0
0.013,17,2,152,1,56,0.0,28.0,28.0,1,96,0.0,68.0,68.0
1770.931,17,92,8096,46,4048,39353.0,60.0,60.0,46,4048,39353.0,60.0,60.0
0.07,6,10,1989,5,910,17.0,642.0,642.0,5,1079,17.0,811.0,811.0
1786.114,6,151,19402,90,13740,20068.0,302.0,302.0,61,5662,29768.0,83.0,83.0
0.014,6,10,1972,5,910,3.0,642.0,642.0,5,1062,3.0,794.0,794.0
0.029,6,10,1983,5,910,7.0,642.0,642.0,5,1073,7.0,805.0,805.0
300.311,6,16,2170,9,684,37518.0,146.0,146.0,7,1486,50024.0,419.0,398.0
0.003,17,2,148,1,60,0.0,32.0,32.0,1,88,0.0,60.0,60.0
0.075,6,10,1506,5,395,17.0,127.0,127.0,5,1111,16.0,843.0,843.0
0.005,6,10,1689,5,839,1.0,571.0,571.0,5,850,1.0,582.0,582.0
0.006,6,10,1547,5,764,1.0,496.0,496.0,5,783,1.0,515.0,515.0
40.053,17,10,676,5,460,10011.0,104.0,64.0,5,216,10012.0,20.0,15.0
0.013,6,10,1631,5,848,3.0,580.0,580.0,5,783,3.0,515.0,515.0
0.003,17,2,136,1,60,0.0,32.0,32.0,1,76,0.0,48.0,48.0
0.004,6,10,2006,5,927,1.0,659.0,659.0,5,1079,1.0,811.0,811.0
240.075,6,16,4481,9,963,30009.0,238.0,166.0,7,3518,40012.0,1402.0,786.0
0.005,17,2,225,1,65,0.0,37.0,37.0,1,160,0.0,132.0,132.0
0.006,6,10,1547,5,764,1.0,496.0,496.0,5,783,1.0,515.0,515.0
300.498,6,16,2170,9,684,37541.0,146.0,146.0,7,1486,50054.0,419.0,398.0
40.075,17,10,676,5,460,10018.0,104.0,64.0,5,216,10018.0,20.0,15.0
0.005,6,10,2006,5,927,1.0,659.0,659.0,5,1079,1.0,811.0,811.0
0.001,17,2,180,1,66,0.0,38.0,38.0,1,114,0.0,86.0,86.0
0.003,17,2,142,1,63,0.0,35.0,35.0,1,79,0.0,51.0,51.0
0.003,17,2,132,1,58,0.0,30.0,30.0,1,74,0.0,46.0,46.0
0.133,6,10,1506,5,395,29.0,127.0,127.0,5,1111,28.0,843.0,843.0
15.167,17,18,9534,9,7299,1892.0,1350.0,783.0,9,2235,1892.0,1350.0,220.0
0.003,17,2,148,1,60,0.0,32.0,32.0,1,88,0.0,60.0,60.0
0.008,6,10,1631,5,848,2.0,580.0,580.0,5,783,2.0,515.0,515.0
0.024,17,2,164,1,74,0.0,46.0,46.0,1,90,0.0,62.0,62.0
0.018,6,10,1972,5,910,4.0,642.0,642.0,5,1062,4.0,794.0,794.0
0.006,6,10,1643,5,860,1.0,592.0,592.0,5,783,1.0,515.0,515.0
0.098,6,10,1506,5,395,20.0,127.0,127.0,5,1111,22.0,843.0,843.0
0.004,17,2,169,1,62,0.0,34.0,34.0,1,107,0.0,79.0,79.0
0.014,6,10,1990,5,911,3.0,643.0,643.0,5,1079,3.0,811.0,811.0
1778.359,17,144,41760,72,22752,25047.0,288.0,288.0,72,19008,25047.0,236.0,236.0
0.005,6,10,2006,5,927,1.0,659.0,659.0,5,1079,1.0,811.0,811.0
0.005,6,14,3742,8,504,0.0,80.0,80.0,6,3238,1.0,1470.0,1459.0
0.011,6,10,1983,5,910,2.0,642.0,642.0,5,1073,2.0,805.0,805.0
15.269,17,20,12169,10,8340,1693.0,1350.0,806.0,10,3829,1693.0,1350.0,354.0
0.082,6,10,1506,5,395,19.0,127.0,127.0,5,1111,19.0,843.0,843.0
0.015,6,10,1989,5,910,3.0,642.0,642.0,5,1079,3.0,811.0,811.0
0.007,6,12,1698,6,863,1.0,327.0,271.0,6,835,1.0,515.0,515.0
0.016,6,10,1677,5,827,4.0,559.0,559.0,5,850,3.0,582.0,582.0
354.082,6,21,1795,16,1030,23605.0,190.0,190.0,5,765,60003.0,464.0,248.0
0.039,17,4,284,2,120,0.0,32.0,32.0,2,164,32.0,60.0,54.0
0.005,6,10,2006,5,927,1.0,659.0,659.0,5,1079,1.0,811.0,811.0
0.112,6,10,1506,5,395,27.0,127.0,127.0,5,1111,24.0,843.0,843.0
11.466,17,28,4398,14,2313,869.0,588.0,137.0,14,2085,869.0,268.0,120.0
0.011,6,10,1983,5,910,2.0,642.0,642.0,5,1073,2.0,805.0,805.0
0.042,17,4,596,2,122,1.0,33.0,33.0,2,474,38.0,323.0,209.0
0.003,17,2,136,1,60,0.0,32.0,32.0,1,76,0.0,48.0,48.0
0.001,17,2,180,1,66,0.0,38.0,38.0,1,114,0.0,86.0,86.0
0.006,6,10,1547,5,764,1.0,496.0,496.0,5,783,1.0,515.0,515.0
40.064,17,10,676,5,460,10015.0,104.0,64.0,5,216,10015.0,20.0,15.0
308.532,17,20,1124,10,716,34266.0,48.0,43.0,10,408,34266.0,20.0,12.0
0.014,6,10,1989,5,910,3.0,642.0,642.0,5,1079,3.0,811.0,811.0
0.013,6,10,1762,5,911,3.0,643.0,643.0,5,851,3.0,583.0,583.0
40.066,17,10,676,5,460,10015.0,104.0,64.0,5,216,10015.0,20.0,15.0
0.004,6,10,1774,5,923,1.0,655.0,655.0,5,851,1.0,583.0,583.0
0.004,17,2,136,1,60,0.0,32.0,32.0,1,76,0.0,48.0,48.0
0.005,6,10,1854,5,889,1.0,621.0,621.0,5,965,1.0,697.0,697.0
0.124,6,10,1506,5,395,27.0,127.0,127.0,5,1111,28.0,843.0,843.0
0.072,17,2,144,1,64,0.0,36.0,36.0,1,80,0.0,52.0,52.0
0.015,6,10,1762,5,911,3.0,643.0,643.0,5,851,3.0,583.0,583.0
0.039,17,2,144,1,64,0.0,36.0,36.0,1,80,0.0,52.0,52.0
0.004,17,2,148,1,60,0.0,32.0,32.0,1,88,0.0,60.0,60.0
0.008,17,2,299,1,65,0.0,37.0,37.0,1,234,0.0,206.0,206.0
0.015,6,10,1983,5,910,3.0,642.0,642.0,5,1073,3.0,805.0,805.0
240.098,6,31,9438,15,6944,17149.0,2067.0,685.0,16,2494,16006.0,580.0,206.0
0.005,6,13,3747,7,509,0.0,137.0,137.0,6,3238,1.0,1470.0,1459.0
0.1,6,10,1506,5,395,22.0,127.0,127.0,5,1111,23.0,843.0,843.0
240.191,6,47,6914,22,3239,11437.0,588.0,230.0,25,3675,10007.0,580.0,215.0
240.092,6,16,4481,9,963,30011.0,238.0,166.0,7,3518,40014.0,1402.0,786.0
0.005,17,2,230,1,68,0.0,40.0,40.0,1,162,0.0,134.0,134.0
0.005,17,2,158,1,71,0.0,43.0,43.0,1,87,0.0,59.0,59.0
0.013,17,2,152,1,56,0.0,28.0,28.0,1,96,0.0,68.0,68.0
0.004,6,10,2006,5,927,1.0,659.0,659.0,5,1079,1.0,811.0,811.0
0.012,6,10,1989,5,910,2.0,642.0,642.0,5,1079,2.0,811.0,811.0
0.017,6,10,1762,5,911,4.0,643.0,643.0,5,851,4.0,583.0,583.0
0.009,6,10,1983,5,910,2.0,642.0,642.0,5,1073,2.0,805.0,805.0
0.006,6,10,2006,5,927,1.0,659.0,659.0,5,1079,1.0,811.0,811.0
0.005,6,10,2000,5,927,1.0,659.0,659.0,5,1073,1.0,805.0,805.0
0.009,6,10,1774,5,923,2.0,655.0,655.0,5,851,2.0,583.0,583.0
0.008,6,10,1972,5,910,1.0,642.0,642.0,5,1062,2.0,794.0,794.0
0.003,17,2,148,1,60,0.0,32.0,32.0,1,88,0.0,60.0,60.0
0.006,6,10,1989,5,927,1.0,659.0,659.0,5,1062,1.0,794.0,794.0
0.006,6,10,1689,5,839,1.0,571.0,571.0,5,850,1.0,582.0,582.0
0.001,17,2,180,1,66,0.0,38.0,38.0,1,114,0.0,86.0,86.0
0.009,6,12,1926,6,1189,1.0,659.0,434.0,6,737,1.0,417.0,417.0
0.006,6,10,1972,5,910,1.0,642.0,642.0,5,1062,1.0,794.0,794.0
0.054,6,10,1972,5,910,13.0,642.0,642.0,5,1062,13.0,794.0,794.0
0.004,17,2,132,1,58,0.0,30.0,30.0,1,74,0.0,46.0,46.0
0.009,6,10,1989,5,910,2.0,642.0,642.0,5,1079,2.0,811.0,811.0
0.001,17,2,142,1,63,0.0,35.0,35.0,1,79,0.0,51.0,51.0
0.081,6,10,1506,5,395,18.0,127.0,127.0,5,1111,18.0,843.0,843.0
0.131,6,10,1506,5,395,30.0,127.0,127.0,5,1111,26.0,843.0,843.0
0.005,6,10,1989,5,927,1.0,659.0,659.0,5,1062,1.0,794.0,794.0
0.021,6,10,1631,5,848,5.0,580.0,580.0,5,783,5.0,515.0,515.0
0.011,6,10,1989,5,910,2.0,642.0,642.0,5,1079,2.0,811.0,811.0
0.012,6,10,1989,5,910,3.0,642.0,642.0,5,1079,3.0,811.0,811.0
0.013,6,10,1989,5,910,3.0,642.0,642.0,5,1079,3.0,811.0,811.0
0.008,6,12,1926,6,1189,1.0,659.0,434.0,6,737,1.0,417.0,417.0
308.257,17,20,1124,10,716,34244.0,48.0,43.0,10,408,34242.0,20.0,12.0
0.004,6,10,2007,5,928,1.0,660.0,660.0,5,1079,1.0,811.0,811.0
0.005,17,2,180,1,66,0.0,38.0,38.0,1,114,0.0,86.0,86.0
0.015,6,10,1972,5,910,3.0,642.0,642.0,5,1062,3.0,794.0,794.0
361.82,6,21,1792,16,1030,24121.0,190.0,190.0,5,762,60009.0,461.0,247.0
0.07,17,8,3613,4,1874,23.0,1350.0,440.0,4,1739,11.0,1350.0,406.0
178.085,17,70,9895,35,2344,5237.0,44.0,38.0,35,7551,5237.0,239.0,187.0
0.035,6,10,1972,5,910,8.0,642.0,642.0,5,1062,8.0,794.0,794.0
0.037,17,2,152,1,76,0.0,48.0,48.0,1,76,0.0,48.0,48.0
0.006,17,2,214,1,75,0.0,47.0,47.0,1,139,0.0,111.0,111.0
0.006,6,10,1547,5,764,1.0,496.0,496.0,5,783,1.0,515.0,515.0
0.06,6,10,1506,5,395,14.0,127.0,127.0,5,1111,13.0,843.0,843.0
0.009,6,10,1989,5,927,2.0,659.0,659.0,5,1062,2.0,794.0,794.0
0.004,6,10,2006,5,927,1.0,659.0,659.0,5,1079,1.0,811.0,811.0
0.103,6,10,1506,5,395,20.0,127.0,127.0,5,1111,23.0,843.0,843.0
0.013,6,10,1972,5,910,3.0,642.0,642.0,5,1062,3.0,794.0,794.0
0.004,6,10,1774,5,923,1.0,655.0,655.0,5,851,1.0,583.0,583.0
0.083,6,10,1506,5,395,17.0,127.0,127.0,5,1111,19.0,843.0,843.0
182.168,6,56,13886,32,4972,5876.0,1029.0,237.0,24,8914,7920.0,2694.0,590.0
0.004,6,10,2006,5,927,1.0,659.0,659.0,5,1079,1.0,811.0,811.0
0.014,6,10,1989,5,910,3.0,642.0,642.0,5,1079,3.0,811.0,811.0
0.09,6,10,1506,5,395,20.0,127.0,127.0,5,1111,19.0,843.0,843.0
352.245,6,20,2210,6,1308,12003.0,494.0,494.0,14,902,27095.0,83.0,83.0
0.005,6,10,2006,5,927,1.0,659.0,659.0,5,1079,1.0,811.0,811.0
0.071,17,8,3613,4,1874,23.0,1350.0,440.0,4,1739,12.0,1350.0,406.0
0.001,17,2,164,1,74,0.0,46.0,46.0,1,90,0.0,62.0,62.0
0.005,6,10,2007,5,928,1.0,660.0,660.0,5,1079,1.0,811.0,811.0
0.005,6,13,3747,7,509,0.0,137.0,137.0,6,3238,1.0,1470.0,1459.0
9.037,17,6,376,5,280,2259.0,28.0,28.0,1,96,0.0,68.0,68.0
0.24,6,10,1506,5,395,57.0,127.0,127.0,5,1111,22.0,843.0,843.0
0.007,6,10,1983,5,910,1.0,642.0,642.0,5,1073,1.0,805.0,805.0
0.021,6,14,3787,7,497,3.0,125.0,125.0,7,3290,3.0,1448.0,972.0
0.081,17,2,152,1,76,0.0,48.0,48.0,1,76,0.0,48.0,48.0
0.002,17,2,180,1,66,0.0,38.0,38.0,1,114,0.0,86.0,86.0
0.049,6,10,1506,5,395,11.0,127.0,127.0,5,1111,10.0,843.0,843.0
0.005,6,10,2006,5,927,1.0,659.0,659.0,5,1079,1.0,811.0,811.0
1799.765,17,2590,198511,1290,104595,1396.0,84.0,53.0,1300,93916,1385.0,227.0,44.0
0.048,17,2,144,1,64,0.0,36.0,36.0,1,80,0.0,52.0,52.0
0.004,17,4,284,2,120,0.0,32.0,32.0,2,164,1.0,60.0,54.0
0.017,6,10,1989,5,910,4.0,642.0,642.0,5,1079,4.0,811.0,811.0
0.103,6,10,1506,5,395,22.0,127.0,127.0,5,1111,24.0,843.0,843.0
0.081,6,10,1506,5,395,16.0,127.0,127.0,5,1111,19.0,843.0,843.0
0.004,6,10,1779,5,928,1.0,660.0,660.0,5,851,1.0,583.0,583.0
0.001,17,2,136,1,60,0.0,32.0,32.0,1,76,0.0,48.0,48.0
0.004,6,10,1989,5,927,1.0,659.0,659.0,5,1062,1.0,794.0,794.0
0.071,6,10,1506,5,395,15.0,127.0,127.0,5,1111,15.0,843.0,843.0
0.083,6,10,1506,5,395,18.0,127.0,127.0,5,1111,17.0,843.0,843.0
0.014,6,10,1989,5,910,3.0,642.0,642.0,5,1079,3.0,811.0,811.0
0.005,6,10,2006,5,927,1.0,659.0,659.0,5,1079,1.0,811.0,811.0
0.004,6,10,1989,5,927,1.0,659.0,659.0,5,1062,1.0,794.0,794.0
0.006,6,10,1689,5,839,1.0,571.0,571.0,5,850,1.0,582.0,582.0
1770.435,6,84,4422,42,2211,43180.0,27.0,27.0,42,2211,43180.0,27.0,27.0
0.005,6,10,1689,5,839,1.0,571.0,571.0,5,850,1.0,582.0,582.0
0.038,17,2,182,1,65,0.0,37.0,37.0,1,117,0.0,89.0,89.0
0.125,6,10,1506,5,395,30.0,127.0,127.0,5,1111,29.0,843.0,843.0
0.004,6,10,1774,5,923,1.0,655.0,655.0,5,851,1.0,583.0,583.0
240.088,6,19,4625,9,2153,30011.0,950.0,563.0,10,2472,26676.0,1162.0,388.0
0.006,6,10,1547,5,764,1.0,496.0,496.0,5,783,1.0,515.0,515.0
0.006,6,10,1547,5,764,1.0,496.0,496.0,5,783,1.0,515.0,515.0
0.883,6,26,5776,13,1666,68.0,267.0,142.0,13,4110,62.0,1414.0,597.0
0.022,6,10,1989,5,910,5.0,642.0,642.0,5,1079,5.0,811.0,811.0
0.013,6,10,1972,5,910,3.0,642.0,642.0,5,1062,3.0,794.0,794.0
178.55,17,90,12751,45,2996,4057.0,44.0,38.0,45,9755,4057.0,239.0,188.0
0.007,6,10,2000,5,927,1.0,659.0,659.0,5,1073,1.0,805.0,805.0
40.063,17,10,676,5,460,10014.0,104.0,64.0,5,216,10015.0,20.0,15.0
0.004,6,10,2006,5,927,1.0,659.0,659.0,5,1079,1.0,811.0,811.0
0.016,6,10,1989,5,910,4.0,642.0,642.0,5,1079,3.0,811.0,811.0
0.004,17,2,170,1,65,0.0,37.0,37.0,1,105,0.0,77.0,77.0
240.026,6,9,787,5,488,60006.0,232.0,232.0,4,299,80006.0,83.0,83.0
0.001,17,2,180,1,66,0.0,38.0,38.0,1,114,0.0,86.0,86.0
0.175,6,10,1506,5,395,42.0,127.0,127.0,5,1111,39.0,843.0,843.0
0.066,17,8,3613,4,1874,22.0,1350.0,440.0,4,1739,11.0,1350.0,406.0
7.404,6,31,6184,17,1298,462.0,267.0,195.0,14,4886,503.0,1823.0,392.0
0.071,6,10,1506,5,395,15.0,127.0,127.0,5,1111,16.0,843.0,843.0
0.011,6,10,1972,5,910,2.0,642.0,642.0,5,1062,2.0,794.0,794.0
0.005,17,2,170,1,65,0.0,37.0,37.0,1,105,0.0,77.0,77.0
0.003,17,2,136,1,60,0.0,32.0,32.0,1,76,0.0,48.0,48.0
0.008,6,10,1989,5,910,2.0,642.0,642.0,5,1079,1.0,811.0,811.0
300.296,6,16,2170,9,684,37516.0,146.0,146.0,7,1486,50021.0,419.0,398.0
0.087,6,10,1506,5,395,21.0,127.0,127.0,5,1111,18.0,843.0,843.0
0.006,6,10,1547,5,764,1.0,496.0,496.0,5,783,1.0,515.0,515.0
0.004,6,10,1989,5,927,1.0,659.0,659.0,5,1062,1.0,794.0,794.0
0.005,6,10,2000,5,927,1.0,659.0,659.0,5,1073,1.0,805.0,805.0
0.005,6,10,2000,5,927,1.0,659.0,659.0,5,1073,1.0,805.0,805.0
0.006,6,10,1854,5,889,1.0,621.0,621.0,5,965,1.0,697.0,697.0
11.255,17,28,4417,14,1994,853.0,269.0,114.0,14,2423,853.0,586.0,145.0
0.012,17,2,230,1,68,0.0,40.0,40.0,1,162,0.0,134.0,134.0
0.208,6,21,6602,11,1550,20.0,533.0,323.0,10,5052,18.0,1402.0,754.0
0.008,6,10,1989,5,910,1.0,642.0,642.0,5,1079,2.0,811.0,811.0
240.101,6,16,4481,9,963,30012.0,238.0,166.0,7,3518,40016.0,1402.0,786.0
300.416,6,19,3081,11,1647,30041.0,517.0,266.0,8,1434,34339.0,821.0,336.0
40.072,17,10,676,5,460,10015.0,104.0,64.0,5,216,10017.0,20.0,15.0
0.008,6,10,1989,5,910,2.0,642.0,642.0,5,1079,2.0,811.0,811.0
0.005,17,2,225,1,65,0.0,37.0,37.0,1,160,0.0,132.0,132.0
0.005,6,10,1989,5,927,1.0,659.0,659.0,5,1062,1.0,794.0,794.0
0.005,17,2,164,1,74,0.0,46.0,46.0,1,90,0.0,62.0,62.0
0.001,17,2,136,1,60,0.0,32.0,32.0,1,76,0.0,48.0,48.0
2.586,6,27,6166,15,2139,184.0,517.0,303.0,12,4027,224.0,1330.0,589.0
0.005,6,10,2000,5,927,1.0,659.0,659.0,5,1073,1.0,805.0,805.0
0.016,6,10,1972,5,910,4.0,642.0,642.0,5,1062,3.0,794.0,794.0
0.092,6,10,1506,5,395,18.0,127.0,127.0,5,1111,22.0,843.0,843.0
0.008,6,10,1972,5,910,2.0,642.0,642.0,5,1062,2.0,794.0,794.0
0.006,6,10,1547,5,764,1.0,496.0,496.0,5,783,1.0,515.0,515.0
0.082,6,10,1506,5,395,17.0,127.0,127.0,5,1111,15.0,843.0,843.0
0.109,6,10,1506,5,395,24.0,127.0,127.0,5,1111,22.0,843.0,843.0
0.005,6,10,2000,5,927,1.0,659.0,659.0,5,1073,1.0,805.0,805.0
0.077,6,10,1506,5,395,17.0,127.0,127.0,5,1111,16.0,843.0,843.0
0.005,6,10,1689,5,839,1.0,571.0,571.0,5,850,1.0,582.0,582.0
0.006,6,10,1689,5,839,1.0,571.0,571.0,5,850,1.0,582.0,582.0
0.106,6,10,1506,5,395,23.0,127.0,127.0,5,1111,21.0,843.0,843.0
0.006,6,10,1689,5,839,1.0,571.0,571.0,5,850,1.0,582.0,582.0
0.09,6,10,1506,5,395,20.0,127.0,127.0,5,1111,16.0,843.0,843.0
0.01,6,10,1989,5,910,2.0,642.0,642.0,5,1079,2.0,811.0,811.0
0.079,6,10,1506,5,395,16.0,127.0,127.0,5,1111,17.0,843.0,843.0
0.006,6,10,1989,5,927,1.0,659.0,659.0,5,1062,1.0,794.0,794.0
0.005,6,10,1779,5,928,1.0,660.0,660.0,5,851,1.0,583.0,583.0
0.009,17,2,136,1,60,0.0,32.0,32.0,1,76,0.0,48.0,48.0
0.041,17,2,136,1,60,0.0,32.0,32.0,1,76,0.0,48.0,48.0
0.004,17,2,136,1,60,0.0,32.0,32.0,1,76,0.0,48.0,48.0
0.008,17,2,162,1,65,0.0,37.0,37.0,1,97,0.0,69.0,69.0
0.143,6,10,1506,5,395,31.0,127.0,127.0,5,1111,32.0,843.0,843.0
0.005,17,2,170,1,65,0.0,37.0,37.0,1,105,0.0,77.0,77.0
240.108,6,16,4482,9,963,30013.0,238.0,166.0,7,3519,40017.0,1402.0,786.0
0.003,17,2,148,1,60,0.0,32.0,32.0,1,88,0.0,60.0,60.0
0.321,17,39,20206,22,17089,15.0,1350.0,748.0,17,3117,13.0,1350.0,155.0
0.005,6,13,3747,7,509,0.0,137.0,137.0,6,3238,0.0,1470.0,1459.0
241.337,6,307,343950,106,17026,2298.0,2736.0,959.0,201,326924,1206.0,2804.0,1656.0
0.005,6,10,2006,5,927,1.0,659.0,659.0,5,1079,1.0,811.0,811.0
0.005,6,10,2006,5,927,1.0,659.0,659.0,5,1079,1.0,811.0,811.0
0.005,17,2,170,1,65,0.0,37.0,37.0,1,105,0.0,77.0,77.0
0.005,17,2,144,1,64,0.0,36.0,36.0,1,80,0.0,52.0,52.0
0.006,6,10,1547,5,764,1.0,496.0,496.0,5,783,1.0,515.0,515.0
0.014,6,10,1677,5,827,3.0,559.0,559.0,5,850,3.0,582.0,582.0
0.011,6,10,1990,5,911,2.0,643.0,643.0,5,1079,2.0,811.0,811.0
15.09,17,16,9302,8,6912,2151.0,1350.0,836.0,8,2390,2151.0,1350.0,270.0
0.088,6,10,1506,5,395,19.0,127.0,127.0,5,1111,21.0,843.0,843.0
40.071,17,10,676,5,460,10016.0,104.0,64.0,5,216,10010.0,20.0,15.0
0.011,6,10,1989,5,927,2.0,659.0,659.0,5,1062,2.0,794.0,794.0
0.008,6,10,1762,5,911,2.0,643.0,643.0,5,851,2.0,583.0,583.0
0.005,6,10,2000,5,927,1.0,659.0,659.0,5,1073,1.0,805.0,805.0
0.014,6,13,3735,7,497,2.0,125.0,125.0,6,3238,2.0,1470.0,1459.0
0.005,17,2,180,1,66,0.0,38.0,38.0,1,114,0.0,86.0,86.0
0.038,17,2,152,1,76,0.0,48.0,48.0,1,76,0.0,48.0,48.0
15.075,17,15,9239,8,6902,2149.0,1350.0,834.0,7,2337,2507.0,1350.0,305.0
0.015,6,10,1972,5,910,3.0,642.0,642.0,5,1062,3.0,794.0,794.0
0.011,6,10,1677,5,827,2.0,559.0,559.0,5,850,2.0,582.0,582.0
40.074,17,10,676,5,460,10017.0,104.0,64.0,5,216,10017.0,20.0,15.0
40.07,17,10,676,5,460,10015.0,104.0,64.0,5,216,10016.0,20.0,15.0
126.005,6,14,2938,8,2504,17967.0,1414.0,1086.0,6,434,25154.0,182.0,182.0
0.001,17,2,180,1,65,0.0,37.0,37.0,1,115,0.0,87.0,87.0
240.016,6,9,787,5,488,60004.0,232.0,232.0,4,299,80004.0,83.0,83.0
0.001,17,2,180,1,66,0.0,38.0,38.0,1,114,0.0,86.0,86.0
0.017,6,10,1990,5,911,4.0,643.0,643.0,5,1079,4.0,811.0,811.0
0.005,17,2,170,1,65,0.0,37.0,37.0,1,105,0.0,77.0,77.0
0.071,17,8,3613,4,1874,23.0,1350.0,440.0,4,1739,13.0,1350.0,406.0
0.012,6,10,1972,5,910,3.0,642.0,642.0,5,1062,3.0,794.0,794.0
0.188,17,4,352,2,130,145.0,37.0,37.0,2,222,148.0,89.0,83.0
0.005,6,10,1989,5,927,1.0,659.0,659.0,5,1062,1.0,794.0,794.0
11.176,17,28,4421,14,1993,847.0,268.0,114.0,14,2428,847.0,587.0,145.0
240.025,6,15,2376,8,1125,34289.0,563.0,178.0,7,1251,40003.0,580.0,219.0
0.043,17,2,152,1,76,0.0,48.0,48.0,1,76,0.0,48.0,48.0
0.01,6,10,1989,5,910,2.0,642.0,642.0,5,1079,2.0,811.0,811.0
0.003,17,2,136,1,60,0.0,32.0,32.0,1,76,0.0,48.0,48.0
40.067,17,10,676,5,460,10015.0,104.0,64.0,5,216,10015.0,20.0,15.0
0.155,6,10,1506,5,395,35.0,127.0,127.0,5,1111,37.0,843.0,843.0
0.005,6,10,2006,5,927,1.0,659.0,659.0,5,1079,1.0,811.0,811.0
0.004,6,10,1774,5,923,1.0,655.0,655.0,5,851,1.0,583.0,583.0
0.043,17,4,596,2,122,1.0,33.0,33.0,2,474,5.0,323.0,209.0
0.004,6,10,1702,5,863,1.0,595.0,595.0,5,839,0.0,571.0,571.0
0.005,6,10,1854,5,889,1.0,621.0,621.0,5,965,1.0,697.0,697.0
0.09,6,10,1506,5,395,19.0,127.0,127.0,5,1111,19.0,843.0,843.0
354.019,6,21,1795,16,1030,23601.0,190.0,190.0,5,765,60002.0,464.0,248.0
241.988,6,397,348843,191,21462,1273.0,2736.0,886.0,206,327381,1180.0,4206.0,1615.0
0.003,17,2,156,1,64,0.0,36.0,36.0,1,92,0.0,64.0,64.0
0.004,17,2,148,1,60,0.0,32.0,32.0,1,88,0.0,60.0,60.0
1744.752,6,309,98387,190,86655,9231.0,2001.0,691.0,119,11732,14785.0,452.0,71.0
0.714,6,22,5072,11,1250,60.0,325.0,133.0,11,3822,60.0,1414.0,563.0
359.201,6,21,1795,16,1030,23946.0,190.0,190.0,5,765,60005.0,464.0,248.0
0.004,6,10,1774,5,923,1.0,655.0,655.0,5,851,1.0,583.0,583.0
0.005,6,10,2000,5,927,1.0,659.0,659.0,5,1073,1.0,805.0,805.0
0.018,6,10,1677,5,827,4.0,559.0,559.0,5,850,4.0,582.0,582.0
11.113,17,28,4422,14,1994,842.0,269.0,114.0,14,2428,842.0,587.0,145.0
0.006,6,10,1547,5,764,1.0,496.0,496.0,5,783,1.0,515.0,515.0
0.112,6,10,1506,5,395,25.0,127.0,127.0,5,1111,23.0,843.0,843.0
0.085,6,10,1506,5,395,19.0,127.0,127.0,5,1111,19.0,843.0,843.0
0.005,6,10,1779,5,928,1.0,660.0,660.0,5,851,1.0,583.0,583.0
10.718,17,26,4103,13,1823,884.0,270.0,112.0,13,2280,884.0,587.0,147.0
40.069,17,10,676,5,460,10014.0,104.0,64.0,5,216,10016.0,20.0,15.0
0.032,6,10,1972,5,910,8.0,642.0,642.0,5,1062,7.0,794.0,794.0
0.16,6,10,1506,5,395,38.0,127.0,127.0,5,1111,37.0,843.0,843.0
0.013,17,2,262,1,66,0.0,38.0,38.0,1,196,0.0,168.0,168.0
240.375,6,21,7263,11,1823,24037.0,990.0,418.0,10,5440,26708.0,1591.0,818.0
0.003,17,2,148,1,60,0.0,32.0,32.0,1,88,0.0,60.0,60.0
0.006,17,2,169,1,62,0.0,34.0,34.0,1,107,0.0,79.0,79.0
0.009,6,10,1990,5,911,2.0,643.0,643.0,5,1079,2.0,811.0,811.0
0.04,17,2,136,1,60,0.0,32.0,32.0,1,76,0.0,48.0,48.0
0.006,6,10,1547,5,764,1.0,496.0,496.0,5,783,1.0,515.0,515.0
0.005,17,2,144,1,64,0.0,36.0,36.0,1,80,0.0,52.0,52.0
19.973,6,36,9330,18,3812,523.0,1360.0,765.0,18,5518,1164.0,2667.0,435.0
0.005,6,10,2006,5,927,1.0,659.0,659.0,5,1079,1.0,811.0,811.0
0.039,17,2,148,1,60,0.0,32.0,32.0,1,88,0.0,60.0,60.0
40.06,17,10,676,5,460,10013.0,104.0,64.0,5,216,10012.0,20.0,15.0
0.005,17,2,169,1,62,0.0,34.0,34.0,1,107,0.0,79.0,79.0
0.004,6,10,1774,5,923,1.0,655.0,655.0,5,851,1.0,583.0,583.0
0.138,6,10,1506,5,395,34.0,127.0,127.0,5,1111,31.0,843.0,843.0
0.018,6,10,1972,5,910,4.0,642.0,642.0,5,1062,4.0,794.0,794.0
0.004,6,10,2000,5,927,1.0,659.0,659.0,5,1073,1.0,805.0,805.0
40.064,17,10,676,5,460,10014.0,104.0,64.0,5,216,10014.0,20.0,15.0
0.041,17,2,182,1,65,0.0,37.0,37.0,1,117,0.0,89.0,89.0
0.014,6,10,1762,5,911,3.0,643.0,643.0,5,851,3.0,583.0,583.0
0.005,6,10,2006,5,927,1.0,659.0,659.0,5,1079,1.0,811.0,811.0
0.04,17,2,152,1,76,0.0,48.0,48.0,1,76,0.0,48.0,48.0
0.008,6,10,1990,5,911,2.0,643.0,643.0,5,1079,2.0,811.0,811.0
0.005,6,10,2006,5,927,1.0,659.0,659.0,5,1079,1.0,811.0,811.0
0.011,6,10,1990,5,911,2.0,643.0,643.0,5,1079,2.0,811.0,811.0
0.005,6,10,1774,5,923,1.0,655.0,655.0,5,851,1.0,583.0,583.0
0.006,6,10,2007,5,928,1.0,660.0,660.0,5,1079,1.0,811.0,811.0
176.354,17,82,11744,41,2736,4408.0,44.0,38.0,41,9008,4408.0,261.0,191.0
0.164,6,10,1506,5,395,35.0,127.0,127.0,5,1111,37.0,843.0,843.0
0.045,6,9,1190,5,751,11.0,495.0,495.0,4,439,9.0,223.0,223.0
0.013,6,10,1990,5,911,3.0,643.0,643.0,5,1079,3.0,811.0,811.0
0.007,6,12,1698,6,863,1.0,327.0,271.0,6,835,1.0,515.0,515.0
0.012,6,14,3787,7,497,2.0,125.0,125.0,7,3290,1.0,1448.0,972.0
0.013,6,10,1762,5,911,3.0,643.0,643.0,5,851,3.0,583.0,583.0
0.12,6,10,1506,5,395,27.0,127.0,127.0,5,1111,25.0,843.0,843.0
0.026,6,10,1677,5,827,6.0,559.0,559.0,5,850,6.0,582.0,582.0
0.128,17,2,80,1,32,0.0,4.0,4.0,1,48,0.0,20.0,20.0
1742.528,6,307,98249,186,86874,9419.0,2001.0,695.0,121,11375,14521.0,452.0,69.0
0.005,17,2,146,1,65,0.0,37.0,37.0,1,81,0.0,53.0,53.0
0.005,17,2,175,1,65,0.0,37.0,37.0,1,110,0.0,82.0,82.0
0.006,6,10,1547,5,764,1.0,496.0,496.0,5,783,1.0,515.0,515.0
0.069,6,10,1506,5,395,14.0,127.0,127.0,5,1111,16.0,843.0,843.0
0.018,6,10,1972,5,910,4.0,642.0,642.0,5,1062,4.0,794.0,794.0
0.005,6,10,1547,5,764,1.0,496.0,496.0,5,783,1.0,515.0,515.0
0.005,6,10,2006,5,927,1.0,659.0,659.0,5,1079,1.0,811.0,811.0
0.096,6,10,1506,5,395,22.0,127.0,127.0,5,1111,21.0,843.0,843.0
0.006,6,10,2000,5,927,1.0,659.0,659.0,5,1073,1.0,805.0,805.0
40.054,17,10,676,5,460,10012.0,104.0,64.0,5,216,10012.0,20.0,15.0
0.004,17,2,136,1,60,0.0,32.0,32.0,1,76,0.0,48.0,48.0
0.004,6,10,2000,5,927,1.0,659.0,659.0,5,1073,1.0,805.0,805.0
11.182,17,28,4423,14,1994,847.0,269.0,114.0,14,2429,847.0,588.0,145.0
0.01,6,12,1926,6,1189,1.0,659.0,434.0,6,737,2.0,417.0,417.0
0.01,6,10,1972,5,910,2.0,642.0,642.0,5,1062,2.0,794.0,794.0
0.004,6,10,1989,5,927,1.0,659.0,659.0,5,1062,1.0,794.0,794.0
0.005,17,2,164,1,74,0.0,46.0,46.0,1,90,0.0,62.0,62.0
240.1,6,16,4481,9,963,30012.0,238.0,166.0,7,3518,40016.0,1402.0,786.0
15.125,17,16,8288,8,6187,2156.0,1350.0,745.0,8,2101,2156.0,1350.0,234.0
0.006,17,2,180,1,66,0.0,38.0,38.0,1,114,0.0,86.0,86.0
284.434,6,25,6155,11,1226,28443.0,267.0,156.0,14,4929,21879.0,1400.0,873.0
0.015,6,10,1989,5,910,3.0,642.0,642.0,5,1079,3.0,811.0,811.0
0.004,6,10,2006,5,927,1.0,659.0,659.0,5,1079,1.0,811.0,811.0
0.001,17,2,154,1,69,0.0,41.0,41.0,1,85,0.0,57.0,57.0
0.007,6,10,1643,5,860,1.0,592.0,592.0,5,783,1.0,515.0,515.0
0.005,17,2,214,1,75,0.0,47.0,47.0,1,139,0.0,111.0,111.0
0.005,6,10,2006,5,927,1.0,659.0,659.0,5,1079,1.0,811.0,811.0
0.039,6,10,1989,5,910,9.0,642.0,642.0,5,1079,9.0,811.0,811.0
0.006,6,12,1698,6,863,1.0,327.0,271.0,6,835,1.0,515.0,515.0
0.214,6,10,1506,5,395,46.0,127.0,127.0,5,1111,27.0,843.0,843.0
0.005,6,14,3736,7,446,0.0,74.0,74.0,7,3290,0.0,1448.0,972.0
0.079,6,10,1506,5,395,17.0,127.0,127.0,5,1111,18.0,843.0,843.0
177.02,17,106,15566,53,3579,3404.0,44.0,39.0,53,11987,3404.0,260.0,198.0
1799.901,17,2923,223561,1452,117745,1240.0,84.0,53.0,1471,105816,1224.0,227.0,43.0
0.092,6,10,1506,5,395,20.0,127.0,127.0,5,1111,19.0,843.0,843.0
0.008,6,10,1990,5,911,2.0,643.0,643.0,5,1079,1.0,811.0,811.0
0.01,6,10,1972,5,910,2.0,642.0,642.0,5,1062,2.0,794.0,794.0
0.167,6,3,453,2,321,167.0,241.0,241.0,1,132,0.0,92.0,92.0
0.098,6,10,1506,5,395,21.0,127.0,127.0,5,1111,18.0,843.0,843.0
0.013,6,10,1989,5,910,3.0,642.0,642.0,5,1079,3.0,811.0,811.0
52.599,6,371,347522,190,21455,278.0,2736.0,888.0,181,326067,292.0,2804.0,1884.0
15.081,17,17,8247,8,6036,2150.0,1350.0,726.0,9,2211,1881.0,1350.0,217.0
0.013,6,10,1990,5,911,3.0,643.0,643.0,5,1079,3.0,811.0,811.0
0.06,6,10,1990,5,911,14.0,643.0,643.0,5,1079,15.0,811.0,811.0
242.965,6,318,343560,125,18005,1959.0,2736.0,959.0,193,325555,1265.0,2769.0,1724.0
0.006,6,10,1547,5,764,1.0,496.0,496.0,5,783,1.0,515.0,515.0
0.006,6,10,2006,5,927,1.0,659.0,659.0,5,1079,1.0,811.0,811.0
40.061,17,10,676,5,460,10014.0,104.0,64.0,5,216,10014.0,20.0,15.0
40.09,17,10,676,5,460,10021.0,104.0,64.0,5,216,10021.0,20.0,15.0
0.004,6,10,2006,5,927,1.0,659.0,659.0,5,1079,1.0,811.0,811.0
0.005,6,14,3799,7,509,0.0,137.0,137.0,7,3290,0.0,1448.0,972.0
0.122,6,10,1506,5,395,27.0,127.0,127.0,5,1111,24.0,843.0,843.0
0.003,17,2,136,1,60,0.0,32.0,32.0,1,76,0.0,48.0,48.0
0.005,6,10,2000,5,927,1.0,659.0,659.0,5,1073,1.0,805.0,805.0
0.054,17,2,152,1,76,0.0,48.0,48.0,1,76,0.0,48.0,48.0
0.006,17,2,230,1,68,0.0,40.0,40.0,1,162,0.0,134.0,134.0
15.071,17,15,9238,8,6902,2149.0,1350.0,834.0,7,2336,2506.0,1350.0,305.0
240.02,6,9,787,5,488,60005.0,232.0,232.0,4,299,80005.0,83.0,83.0
0.078,6,10,1506,5,395,17.0,127.0,127.0,5,1111,17.0,843.0,843.0
0.011,6,10,1983,5,910,2.0,642.0,642.0,5,1073,2.0,805.0,805.0
11.394,17,29,4567,15,2166,802.0,269.0,116.0,14,2401,863.0,588.0,143.0
0.006,6,10,1689,5,839,1.0,571.0,571.0,5,850,1.0,582.0,582.0
0.004,6,10,1702,5,863,0.0,595.0,595.0,5,839,1.0,571.0,571.0
0.039,17,2,148,1,60,0.0,32.0,32.0,1,88,0.0,60.0,60.0
0.1,6,10,1506,5,395,22.0,127.0,127.0,5,1111,21.0,843.0,843.0
0.006,6,10,1643,5,860,1.0,592.0,592.0,5,783,1.0,515.0,515.0
0.006,6,10,1547,5,764,1.0,496.0,496.0,5,783,1.0,515.0,515.0
10.831,17,28,4418,14,1994,824.0,269.0,114.0,14,2424,824.0,587.0,145.0
0.006,6,10,1854,5,889,1.0,621.0,621.0,5,965,1.0,697.0,697.0
0.063,6,10,1506,5,395,12.0,127.0,127.0,5,1111,14.0,843.0,843.0
300.035,6,12,1782,7,1348,50005.0,494.0,494.0,5,434,75007.0,83.0,83.0
0.146,6,36,15150,18,11190,8.0,1267.0,1099.0,18,3960,8.0,296.0,296.0
0.013,6,10,1989,5,910,3.0,642.0,642.0,5,1079,3.0,811.0,811.0
0.007,6,13,3690,7,452,1.0,80.0,80.0,6,3238,1.0,1470.0,1459.0
0.005,6,10,2006,5,927,1.0,659.0,659.0,5,1079,1.0,811.0,811.0
311.574,17,20,1124,10,716,34605.0,48.0,43.0,10,408,34605.0,20.0,12.0
308.381,17,20,1124,10,716,34257.0,48.0,43.0,10,408,34248.0,20.0,12.0
0.003,17,2,148,1,60,0.0,32.0,32.0,1,88,0.0,60.0,60.0
0.011,6,10,1983,5,910,2.0,642.0,642.0,5,1073,2.0,805.0,805.0
0.012,6,10,1677,5,827,3.0,559.0,559.0,5,850,2.0,582.0,582.0
0.04,17,2,136,1,60,0.0,32.0,32.0,1,76,0.0,48.0,48.0
0.045,6,10,1605,5,388,11.0,120.0,120.0,5,1217,11.0,949.0,949.0
0.01,6,10,1990,5,911,2.0,643.0,643.0,5,1079,2.0,811.0,811.0
0.013,6,10,1972,5,910,3.0,642.0,642.0,5,1062,3.0,794.0,794.0
0.006,6,10,1547,5,764,1.0,496.0,496.0,5,783,1.0,515.0,515.0
0.008,6,12,1926,6,1189,1.0,659.0,434.0,6,737,1.0,417.0,417.0
0.004,17,2,136,1,60,0.0,32.0,32.0,1,76,0.0,48.0,48.0
0.008,6,10,1972,5,910,1.0,642.0,642.0,5,1062,2.0,794.0,794.0
0.136,6,10,1506,5,395,21.0,127.0,127.0,5,1111,25.0,843.0,843.0
0.005,17,2,179,1,71,0.0,43.0,43.0,1,108,0.0,80.0,80.0
0.006,6,10,1774,5,923,1.0,655.0,655.0,5,851,1.0,583.0,583.0
0.004,6,10,1779,5,928,1.0,660.0,660.0,5,851,1.0,583.0,583.0
300.033,6,12,1782,7,1348,50005.0,494.0,494.0,5,434,75007.0,83.0,83.0
0.004,6,10,2007,5,928,1.0,660.0,660.0,5,1079,1.0,811.0,811.0
0.104,6,10,1506,5,395,23.0,127.0,127.0,5,1111,21.0,843.0,843.0
0.004,6,10,1702,5,863,1.0,595.0,595.0,5,839,1.0,571.0,571.0
0.091,6,10,1506,5,395,19.0,127.0,127.0,5,1111,17.0,843.0,843.0
0.094,6,10,1506,5,395,20.0,127.0,127.0,5,1111,19.0,843.0,843.0
900.674,6,45,14152,24,4499,39159.0,1273.0,461.0,21,9653,42032.0,1402.0,657.0
0.006,6,13,3747,7,509,1.0,137.0,137.0,6,3238,1.0,1470.0,1459.0
0.004,6,10,1702,5,863,1.0,595.0,595.0,5,839,0.0,571.0,571.0
0.016,6,10,1677,5,827,3.0,559.0,559.0,5,850,3.0,582.0,582.0
2.125,6,28,8188,16,2255,141.0,517.0,284.0,12,5933,192.0,1402.0,662.0
0.005,6,10,2006,5,927,1.0,659.0,659.0,5,1079,1.0,811.0,811.0
0.005,17,2,164,1,74,0.0,46.0,46.0,1,90,0.0,62.0,62.0
15.176,17,22,12655,11,9109,1514.0,1350.0,800.0,11,3546,1514.0,1350.0,294.0
0.01,6,10,1983,5,910,2.0,642.0,642.0,5,1073,2.0,805.0,805.0
0.006,6,10,1547,5,764,1.0,496.0,496.0,5,783,1.0,515.0,515.0
0.013,6,10,1677,5,827,3.0,559.0,559.0,5,850,3.0,582.0,582.0
0.069,6,10,1631,5,848,17.0,580.0,580.0,5,783,17.0,515.0,515.0
0.137,17,2,144,1,64,0.0,36.0,36.0,1,80,0.0,52.0,52.0
0.006,6,10,1989,5,927,1.0,659.0,659.0,5,1062,1.0,794.0,794.0
0.006,6,10,1547,5,764,1.0,496.0,496.0,5,783,1.0,515.0,515.0
0.005,6,10,1989,5,927,1.0,659.0,659.0,5,1062,1.0,794.0,794.0
0.006,6,10,1547,5,764,1.0,496.0,496.0,5,783,1.0,515.0,515.0
0.004,6,10,2006,5,927,1.0,659.0,659.0,5,1079,1.0,811.0,811.0
240.252,6,41,5259,20,2438,12644.0,588.0,196.0,21,2821,12012.0,580.0,215.0
0.005,6,10,2006,5,927,1.0,659.0,659.0,5,1079,1.0,811.0,811.0
0.012,6,10,1972,5,910,2.0,642.0,642.0,5,1062,3.0,794.0,794.0
0.006,17,2,169,1,62,0.0,34.0,34.0,1,107,0.0,79.0,79.0
0.005,6,13,3690,7,452,0.0,80.0,80.0,6,3238,0.0,1470.0,1459.0
0.076,6,10,1506,5,395,16.0,127.0,127.0,5,1111,18.0,843.0,843.0
0.003,17,2,136,1,60,0.0,32.0,32.0,1,76,0.0,48.0,48.0
0.004,6,10,1779,5,928,1.0,660.0,660.0,5,851,1.0,583.0,583.0
0.011,6,10,1989,5,910,2.0,642.0,642.0,5,1079,2.0,811.0,811.0
0.005,6,10,2007,5,928,1.0,660.0,660.0,5,1079,1.0,811.0,811.0
0.005,6,10,2000,5,927,1.0,659.0,659.0,5,1073,1.0,805.0,805.0
0.004,6,10,1989,5,927,1.0,659.0,659.0,5,1062,1.0,794.0,794.0
0.01,6,10,1989,5,910,2.0,642.0,642.0,5,1079,2.0,811.0,811.0
0.005,6,10,2006,5,927,1.0,659.0,659.0,5,1079,1.0,811.0,811.0
0.01,6,10,1989,5,910,2.0,642.0,642.0,5,1079,2.0,811.0,811.0
0.005,17,2,166,1,75,0.0,47.0,47.0,1,91,0.0,63.0,63.0
0.02,6,10,1989,5,910,4.0,642.0,642.0,5,1079,4.0,811.0,811.0
0.004,6,10,1779,5,928,1.0,660.0,660.0,5,851,1.0,583.0,583.0
0.005,6,10,2006,5,927,1.0,659.0,659.0,5,1079,1.0,811.0,811.0
0.005,6,10,1689,5,839,1.0,571.0,571.0,5,850,1.0,582.0,582.0
0.015,6,10,1762,5,911,3.0,643.0,643.0,5,851,3.0,583.0,583.0
0.011,6,10,1989,5,910,2.0,642.0,642.0,5,1079,2.0,811.0,811.0
0.076,6,10,1506,5,395,15.0,127.0,127.0,5,1111,17.0,843.0,843.0
145.318,6,36,13477,18,3917,60.0,1070.0,630.0,18,9560,8540.0,1360.0,630.0
240.018,6,9,787,5,488,60004.0,232.0,232.0,4,299,80005.0,83.0,83.0
0.009,6,10,1972,5,910,2.0,642.0,642.0,5,1062,2.0,794.0,794.0
0.04,17,2,170,1,65,0.0,37.0,37.0,1,105,0.0,77.0,77.0
0.005,6,10,1689,5,839,1.0,571.0,571.0,5,850,1.0,582.0,582.0
241.449,6,300,342930,122,17850,1995.0,2736.0,959.0,178,325080,1364.0,2804.0,1879.0
0.005,6,10,2007,5,928,1.0,660.0,660.0,5,1079,1.0,811.0,811.0
0.015,6,10,1631,5,848,3.0,580.0,580.0,5,783,3.0,515.0,515.0
0.007,17,2,144,1,64,0.0,36.0,36.0,1,80,0.0,52.0,52.0
15.294,17,42,22919,23,18458,693.0,1350.0,774.0,19,4461,847.0,1350.0,206.0
0.079,6,10,1506,5,395,16.0,127.0,127.0,5,1111,18.0,843.0,843.0
0.04,17,2,182,1,65,0.0,37.0,37.0,1,117,0.0,89.0,89.0
11.397,17,28,4398,14,2312,864.0,587.0,137.0,14,2086,864.0,269.0,121.0
0.176,6,10,1506,5,395,42.0,127.0,127.0,5,1111,39.0,843.0,843.0
0.353,6,17,2723,9,1449,44.0,533.0,324.0,8,1274,44.0,529.0,212.0
0.042,17,2,144,1,64,0.0,36.0,36.0,1,80,0.0,52.0,52.0
0.014,6,10,1990,5,911,3.0,643.0,643.0,5,1079,3.0,811.0,811.0
0.133,17,4,352,2,130,0.0,37.0,37.0,2,222,0.0,89.0,83.0
0.006,6,10,1547,5,764,1.0,496.0,496.0,5,783,1.0,515.0,515.0
161.561,17,70,9867,35,2336,4751.0,44.0,38.0,35,7531,4751.0,261.0,187.0
0.011,6,10,1972,5,910,2.0,642.0,642.0,5,1062,2.0,794.0,794.0
0.009,6,10,1989,5,910,2.0,642.0,642.0,5,1079,2.0,811.0,811.0
0.005,17,2,230,1,68,0.0,40.0,40.0,1,162,0.0,134.0,134.0
0.082,6,10,1506,5,395,19.0,127.0,127.0,5,1111,16.0,843.0,843.0
240.444,6,35,8926,18,2072,14143.0,693.0,225.0,17,6854,15027.0,1402.0,597.0
0.009,6,12,1926,6,1189,1.0,659.0,434.0,6,737,1.0,417.0,417.0
0.004,6,10,1779,5,928,1.0,660.0,660.0,5,851,1.0,583.0,583.0
0.037,17,2,136,1,60,0.0,32.0,32.0,1,76,0.0,48.0,48.0
0.005,6,10,1989,5,927,1.0,659.0,659.0,5,1062,1.0,794.0,794.0
0.001,17,2,180,1,66,0.0,38.0,38.0,1,114,0.0,86.0,86.0
1777.794,17,143,45188,72,22752,25037.0,288.0,288.0,71,22436,25392.0,288.0,288.0
0.005,6,10,1779,5,928,1.0,660.0,660.0,5,851,1.0,583.0,583.0
240.187,6,16,940,9,522,30018.0,27.0,27.0,7,418,40024.0,27.0,27.0
15.217,17,17,8374,9,6102,1898.0,1350.0,650.0,8,2272,2169.0,1350.0,256.0
0.01,6,10,1677,5,827,2.0,559.0,559.0,5,850,2.0,582.0,582.0
0.014,6,10,1990,5,911,3.0,643.0,643.0,5,1079,3.0,811.0,811.0
0.005,6,10,2007,5,928,1.0,660.0,660.0,5,1079,1.0,811.0,811.0
0.102,6,10,1506,5,395,22.0,127.0,127.0,5,1111,22.0,843.0,843.0
0.012,6,10,1972,5,910,2.0,642.0,642.0,5,1062,3.0,794.0,794.0
0.001,17,2,180,1,66,0.0,38.0,38.0,1,114,0.0,86.0,86.0
0.015,6,10,1990,5,911,3.0,643.0,643.0,5,1079,3.0,811.0,811.0
0.012,6,10,1990,5,911,2.0,643.0,643.0,5,1079,2.0,811.0,811.0
240.094,6,16,4481,9,963,30011.0,238.0,166.0,7,3518,40015.0,1402.0,786.0
0.009,6,10,1631,5,848,2.0,580.0,580.0,5,783,2.0,515.0,515.0
148.836,6,22,8499,12,2236,71.0,1345.0,574.0,10,6263,16518.0,2720.0,975.0
0.001,17,2,180,1,66,0.0,38.0,38.0,1,114,0.0,86.0,86.0
0.005,17,2,214,1,75,0.0,47.0,47.0,1,139,0.0,111.0,111.0
0.014,6,10,1677,5,827,3.0,559.0,559.0,5,850,3.0,582.0,582.0
0.001,17,2,179,1,62,0.0,34.0,34.0,1,117,0.0,89.0,89.0
0.101,6,10,1506,5,395,23.0,127.0,127.0,5,1111,24.0,843.0,843.0
240.024,6,9,787,5,488,60006.0,232.0,232.0,4,299,80006.0,83.0,83.0
0.006,6,10,1689,5,839,1.0,571.0,571.0,5,850,1.0,582.0,582.0
0.084,6,10,1506,5,395,19.0,127.0,127.0,5,1111,19.0,843.0,843.0
0.124,6,10,1506,5,395,27.0,127.0,127.0,5,1111,26.0,843.0,843.0
0.019,6,10,1972,5,910,4.0,642.0,642.0,5,1062,4.0,794.0,794.0
0.004,17,4,284,2,120,0.0,32.0,32.0,2,164,1.0,60.0,54.0
0.006,17,2,166,1,75,0.0,47.0,47.0,1,91,0.0,63.0,63.0
0.001,17,2,180,1,66,0.0,38.0,38.0,1,114,0.0,86.0,86.0
0.205,17,19,10188,9,7475,25.0,1350.0,802.0,10,2713,18.0,1350.0,243.0
40.068,17,10,676,5,460,10016.0,104.0,64.0,5,216,10016.0,20.0,15.0
148.02,58,4,288,3,216,74010.0,24.0,24.0,1,72,0.0,24.0,24.0
0.019,6,13,3735,7,497,3.0,125.0,125.0,6,3238,3.0,1470.0,1459.0
0.001,17,2,180,1,66,0.0,38.0,38.0,1,114,0.0,86.0,86.0
40.056,17,10,676,5,460,10013.0,104.0,64.0,5,216,10013.0,20.0,15.0
0.016,6,10,1989,5,910,3.0,642.0,642.0,5,1079,3.0,811.0,811.0
0.005,6,10,2007,5,928,1.0,660.0,660.0,5,1079,1.0,811.0,811.0
0.009,6,10,1990,5,911,2.0,643.0,643.0,5,1079,2.0,811.0,811.0
0.006,6,10,1989,5,927,1.0,659.0,659.0,5,1062,1.0,794.0,794.0
0.005,17,2,154,1,69,0.0,41.0,41.0,1,85,0.0,57.0,57.0
0.038,17,2,184,1,61,0.0,33.0,33.0,1,123,0.0,95.0,95.0
0.004,6,10,1779,5,928,1.0,660.0,660.0,5,851,1.0,583.0,583.0
0.113,6,10,1506,5,395,27.0,127.0,127.0,5,1111,24.0,843.0,843.0
0.014,6,10,1972,5,910,3.0,642.0,642.0,5,1062,3.0,794.0,794.0
0.018,6,10,1990,5,911,4.0,643.0,643.0,5,1079,4.0,811.0,811.0
0.015,6,10,1983,5,910,3.0,642.0,642.0,5,1073,3.0,805.0,805.0
0.011,6,10,1989,5,910,2.0,642.0,642.0,5,1079,2.0,811.0,811.0
0.012,6,10,1762,5,911,2.0,643.0,643.0,5,851,3.0,583.0,583.0
0.013,6,10,1990,5,911,3.0,643.0,643.0,5,1079,3.0,811.0,811.0
0.098,6,10,1506,5,395,21.0,127.0,127.0,5,1111,18.0,843.0,843.0
0.016,6,10,1990,5,911,4.0,643.0,643.0,5,1079,4.0,811.0,811.0
0.012,6,10,1990,5,911,2.0,643.0,643.0,5,1079,2.0,811.0,811.0
0.006,6,10,1547,5,764,1.0,496.0,496.0,5,783,1.0,515.0,515.0
0.013,6,10,1990,5,911,3.0,643.0,643.0,5,1079,3.0,811.0,811.0
0.014,6,10,1677,5,827,3.0,559.0,559.0,5,850,3.0,582.0,582.0
0.01,6,10,1631,5,848,2.0,580.0,580.0,5,783,2.0,515.0,515.0
0.013,17,2,194,1,59,0.0,31.0,31.0,1,135,0.0,107.0,107.0
0.075,6,10,1506,5,395,18.0,127.0,127.0,5,1111,15.0,843.0,843.0
0.007,6,10,1547,5,764,1.0,496.0,496.0,5,783,1.0,515.0,515.0
0.009,6,10,1631,5,848,2.0,580.0,580.0,5,783,2.0,515.0,515.0
240.094,6,16,4480,9,963,30011.0,238.0,166.0,7,3517,40015.0,1402.0,786.0
0.07,6,10,1506,5,395,14.0,127.0,127.0,5,1111,17.0,843.0,843.0
0.004,6,10,1989,5,927,1.0,659.0,659.0,5,1062,1.0,794.0,794.0
11.564,17,34,6370,17,2655,712.0,269.0,128.0,17,3715,712.0,1145.0,190.0
0.006,17,2,180,1,58,0.0,30.0,30.0,1,122,0.0,94.0,94.0
0.004,6,10,1989,5,927,1.0,659.0,659.0,5,1062,1.0,794.0,794.0
0.086,6,10,1506,5,395,19.0,127.0,127.0,5,1111,18.0,843.0,843.0
0.008,6,10,1989,5,910,1.0,642.0,642.0,5,1079,2.0,811.0,811.0
0.025,6,10,1677,5,827,6.0,559.0,559.0,5,850,6.0,582.0,582.0
0.01,6,10,1677,5,827,2.0,559.0,559.0,5,850,2.0,582.0,582.0
0.003,17,2,148,1,60,0.0,32.0,32.0,1,88,0.0,60.0,60.0
0.004,6,10,2006,5,927,1.0,659.0,659.0,5,1079,1.0,811.0,811.0
0.006,6,10,1547,5,764,1.0,496.0,496.0,5,783,1.0,515.0,515.0
0.005,6,10,2006,5,927,1.0,659.0,659.0,5,1079,1.0,811.0,811.0
0.005,6,10,2000,5,927,1.0,659.0,659.0,5,1073,1.0,805.0,805.0
0.004,17,2,136,1,60,0.0,32.0,32.0,1,76,0.0,48.0,48.0
0.151,6,10,1506,5,395,32.0,127.0,127.0,5,1111,33.0,843.0,843.0
240.073,6,21,4924,11,941,24007.0,180.0,93.0,10,3983,26674.0,1591.0,575.0
0.005,6,10,1779,5,928,1.0,660.0,660.0,5,851,1.0,583.0,583.0
0.007,6,10,1779,5,928,1.0,660.0,660.0,5,851,1.0,583.0,583.0
0.003,6,10,1702,5,863,0.0,595.0,595.0,5,839,0.0,571.0,571.0
0.001,17,2,136,1,60,0.0,32.0,32.0,1,76,0.0,48.0,48.0
0.004,6,10,1779,5,928,1.0,660.0,660.0,5,851,1.0,583.0,583.0
0.016,6,10,1983,5,910,4.0,642.0,642.0,5,1073,4.0,805.0,805.0
0.006,6,13,3747,7,509,0.0,137.0,137.0,6,3238,1.0,1470.0,1459.0
0.112,6,10,1506,5,395,26.0,127.0,127.0,5,1111,26.0,843.0,843.0
0.005,17,2,212,1,74,0.0,46.0,46.0,1,138,0.0,110.0,110.0
0.013,6,10,1677,5,827,3.0,559.0,559.0,5,850,3.0,582.0,582.0
0.011,6,10,1989,5,910,2.0,642.0,642.0,5,1079,2.0,811.0,811.0
0.005,6,10,2007,5,928,1.0,660.0,660.0,5,1079,1.0,811.0,811.0
0.01,6,10,1631,5,848,2.0,580.0,580.0,5,783,2.0,515.0,515.0
326.009,6,19,2158,6,1308,12003.0,494.0,494.0,13,850,27167.0,83.0,83.0
0.005,6,10,2006,5,927,1.0,659.0,659.0,5,1079,1.0,811.0,811.0
0.012,6,10,1631,5,848,3.0,580.0,580.0,5,783,3.0,515.0,515.0
0.012,6,10,1983,5,910,2.0,642.0,642.0,5,1073,2.0,805.0,805.0
150.576,6,22,7437,11,1305,109.0,530.0,277.0,11,6132,15040.0,2720.0,946.0
396.65,58,6,432,5,360,99162.0,24.0,24.0,1,72,0.0,24.0,24.0
0.005,6,10,2006,5,927,1.0,659.0,659.0,5,1079,1.0,811.0,811.0
0.004,17,2,136,1,60,0.0,32.0,32.0,1,76,0.0,48.0,48.0
0.17,17,2,152,1,76,0.0,48.0,48.0,1,76,0.0,48.0,48.0
0.005,6,10,1989,5,927,1.0,659.0,659.0,5,1062,1.0,794.0,794.0
0.005,6,10,1779,5,928,1.0,660.0,660.0,5,851,1.0,583.0,583.0
11.172,17,28,4422,14,1994,846.0,269.0,114.0,14,2428,846.0,587.0,145.0
0.005,6,10,1989,5,927,1.0,659.0,659.0,5,1062,1.0,794.0,794.0
0.005,17,2,164,1,74,0.0,46.0,46.0,1,90,0.0,62.0,62.0
0.005,6,10,2006,5,927,1.0,659.0,659.0,5,1079,1.0,811.0,811.0
0.081,6,10,1506,5,395,17.0,127.0,127.0,5,1111,18.0,843.0,843.0
0.005,6,10,2006,5,927,1.0,659.0,659.0,5,1079,1.0,811.0,811.0
0.071,17,8,3613,4,1874,23.0,1350.0,440.0,4,1739,12.0,1350.0,406.0
0.04,17,2,136,1,60,0.0,32.0,32.0,1,76,0.0,48.0,48.0
0.074,6,10,1506,5,395,16.0,127.0,127.0,5,1111,14.0,843.0,843.0
0.006,6,10,2006,5,927,1.0,659.0,659.0,5,1079,1.0,811.0,811.0
0.006,17,2,169,1,62,0.0,34.0,34.0,1,107,0.0,79.0,79.0
0.0,17,2,154,1,69,0.0,41.0,41.0,1,85,0.0,57.0,57.0
0.007,17,2,179,1,71,0.0,43.0,43.0,1,108,0.0,80.0,80.0
0.024,6,10,1989,5,910,6.0,642.0,642.0,5,1079,6.0,811.0,811.0
0.009,6,10,1989,5,910,2.0,642.0,642.0,5,1079,2.0,811.0,811.0
0.069,6,10,1506,5,395,15.0,127.0,127.0,5,1111,16.0,843.0,843.0
0.025,6,10,1983,5,910,6.0,642.0,642.0,5,1073,6.0,805.0,805.0
40.059,17,10,676,5,460,10013.0,104.0,64.0,5,216,10013.0,20.0,15.0
10.785,17,28,4422,14,1994,821.0,269.0,114.0,14,2428,821.0,587.0,145.0
0.005,6,10,2000,5,927,1.0,659.0,659.0,5,1073,1.0,805.0,805.0
11.509,17,28,4399,14,2313,873.0,588.0,137.0,14,2086,873.0,269.0,121.0
0.005,17,2,170,1,65,0.0,37.0,37.0,1,105,0.0,77.0,77.0
0.005,6,10,1854,5,889,1.0,621.0,621.0,5,965,1.0,697.0,697.0
240.089,6,16,4482,9,963,30011.0,238.0,166.0,7,3519,40014.0,1402.0,786.0
0.009,6,10,1990,5,911,2.0,643.0,643.0,5,1079,2.0,811.0,811.0
0.004,17,2,148,1,60,0.0,32.0,32.0,1,88,0.0,60.0,60.0
0.006,6,10,1547,5,764,1.0,496.0,496.0,5,783,1.0,515.0,515.0
361.755,6,21,1793,16,1030,24117.0,190.0,190.0,5,763,60009.0,462.0,247.0
0.124,6,10,1506,5,395,28.0,127.0,127.0,5,1111,28.0,843.0,843.0
0.007,17,2,247,1,68,0.0,40.0,40.0,1,179,0.0,151.0,151.0
0.016,6,10,1983,5,910,4.0,642.0,642.0,5,1073,4.0,805.0,805.0
0.012,6,10,2006,5,927,2.0,659.0,659.0,5,1079,2.0,811.0,811.0
0.009,6,10,1643,5,860,2.0,592.0,592.0,5,783,2.0,515.0,515.0
0.004,6,10,1989,5,927,1.0,659.0,659.0,5,1062,1.0,794.0,794.0
0.006,6,10,1547,5,764,1.0,496.0,496.0,5,783,1.0,515.0,515.0
40.06,17,10,676,5,460,10014.0,104.0,64.0,5,216,10014.0,20.0,15.0
0.005,6,10,2007,5,928,1.0,660.0,660.0,5,1079,1.0,811.0,811.0
0.005,17,2,144,1,64,0.0,36.0,36.0,1,80,0.0,52.0,52.0
0.003,17,2,136,1,60,0.0,32.0,32.0,1,76,0.0,48.0,48.0
37.447,6,36,8352,18,1881,511.0,773.0,376.0,18,6471,2195.0,2126.0,478.0
0.005,6,10,2006,5,927,1.0,659.0,659.0,5,1079,1.0,811.0,811.0
0.011,6,10,1989,5,910,2.0,642.0,642.0,5,1079,2.0,811.0,811.0
0.006,6,10,1547,5,764,1.0,496.0,496.0,5,783,1.0,515.0,515.0
0.015,6,10,1631,5,848,3.0,580.0,580.0,5,783,3.0,515.0,515.0
0.119,6,10,1506,5,395,25.0,127.0,127.0,5,1111,23.0,843.0,843.0
0.005,6,10,2007,5,928,1.0,660.0,660.0,5,1079,1.0,811.0,811.0
0.005,17,2,144,1,64,0.0,36.0,36.0,1,80,0.0,52.0,52.0
0.014,6,10,1972,5,910,3.0,642.0,642.0,5,1062,3.0,794.0,794.0
0.075,6,10,1506,5,395,17.0,127.0,127.0,5,1111,14.0,843.0,843.0
0.008,6,10,1989,5,910,2.0,642.0,642.0,5,1079,2.0,811.0,811.0
0.015,6,10,1762,5,911,3.0,643.0,643.0,5,851,3.0,583.0,583.0
0.006,6,10,1547,5,764,1.0,496.0,496.0,5,783,1.0,515.0,515.0
0.001,17,2,180,1,66,0.0,38.0,38.0,1,114,0.0,86.0,86.0
0.082,6,10,1506,5,395,18.0,127.0,127.0,5,1111,17.0,843.0,843.0
0.102,6,10,1506,5,395,23.0,127.0,127.0,5,1111,23.0,843.0,843.0
0.017,6,10,1989,5,910,4.0,642.0,642.0,5,1079,4.0,811.0,811.0
0.004,17,2,148,1,60,0.0,32.0,32.0,1,88,0.0,60.0,60.0
1778.71,17,144,41760,72,22752,25052.0,288.0,288.0,72,19008,25052.0,236.0,236.0
0.004,6,10,2006,5,927,1.0,659.0,659.0,5,1079,1.0,811.0,811.0
0.005,6,10,1779,5,928,1.0,660.0,660.0,5,851,1.0,583.0,583.0
0.268,17,38,20186,21,17036,13.0,1350.0,783.0,17,3150,12.0,1350.0,157.0
240.087,6,16,4482,9,963,30010.0,238.0,166.0,7,3519,40012.0,1402.0,786.0
0.004,6,10,1774,5,923,1.0,655.0,655.0,5,851,1.0,583.0,583.0
0.238,6,10,1506,5,395,55.0,127.0,127.0,5,1111,56.0,843.0,843.0
240.089,6,31,9308,15,6988,17149.0,2111.0,690.0,16,2320,16005.0,580.0,185.0
0.006,6,10,1547,5,764,1.0,496.0,496.0,5,783,1.0,515.0,515.0
0.004,6,10,2006,5,927,1.0,659.0,659.0,5,1079,1.0,811.0,811.0
0.005,6,10,1989,5,927,1.0,659.0,659.0,5,1062,1.0,794.0,794.0
0.004,6,10,1989,5,927,1.0,659.0,659.0,5,1062,1.0,794.0,794.0
240.131,6,16,4482,9,963,30016.0,238.0,166.0,7,3519,40021.0,1402.0,786.0
0.02,6,10,1989,5,910,5.0,642.0,642.0,5,1079,4.0,811.0,811.0
0.003,17,2,148,1,60,0.0,32.0,32.0,1,88,0.0,60.0,60.0
40.063,17,10,676,5,460,10013.0,104.0,64.0,5,216,10015.0,20.0,15.0
0.016,6,10,1989,5,910,4.0,642.0,642.0,5,1079,4.0,811.0,811.0
175.041,17,78,11259,39,2621,4606.0,44.0,39.0,39,8638,4606.0,252.0,193.0
0.014,6,10,1605,5,388,3.0,120.0,120.0,5,1217,3.0,949.0,949.0
175.423,17,80,11249,40,2656,4497.0,44.0,38.0,40,8593,4498.0,261.0,186.0
0.086,6,10,1506,5,395,19.0,127.0,127.0,5,1111,16.0,843.0,843.0
0.038,17,2,152,1,76,0.0,48.0,48.0,1,76,0.0,48.0,48.0
0.004,17,4,284,2,120,1.0,32.0,32.0,2,164,1.0,60.0,54.0
0.004,17,2,136,1,60,0.0,32.0,32.0,1,76,0.0,48.0,48.0
0.005,6,13,3690,7,452,0.0,80.0,80.0,6,3238,0.0,1470.0,1459.0
0.005,17,2,169,1,62,0.0,34.0,34.0,1,107,0.0,79.0,79.0
0.008,6,10,1972,5,910,2.0,642.0,642.0,5,1062,2.0,794.0,794.0
0.004,6,10,1779,5,928,1.0,660.0,660.0,5,851,1.0,583.0,583.0
0.004,6,10,1774,5,923,1.0,655.0,655.0,5,851,1.0,583.0,583.0
0.004,6,10,2006,5,927,1.0,659.0,659.0,5,1079,1.0,811.0,811.0
0.04,17,2,182,1,65,0.0,37.0,37.0,1,117,0.0,89.0,89.0
1769.282,17,92,8096,46,4048,39317.0,60.0,60.0,46,4048,39317.0,60.0,60.0
0.005,6,14,3799,7,509,0.0,137.0,137.0,7,3290,0.0,1448.0,972.0
0.005,6,10,1774,5,923,1.0,655.0,655.0,5,851,1.0,583.0,583.0
0.071,17,2,136,1,60,0.0,32.0,32.0,1,76,0.0,48.0,48.0
40.067,17,10,676,5,460,10014.0,104.0,64.0,5,216,10016.0,20.0,15.0
0.079,6,10,1506,5,395,17.0,127.0,127.0,5,1111,17.0,843.0,843.0
0.041,17,4,352,2,130,1.0,37.0,37.0,2,222,2.0,89.0,83.0
0.003,17,2,148,1,60,0.0,32.0,32.0,1,88,0.0,60.0,60.0
0.005,6,10,1702,5,863,1.0,595.0,595.0,5,839,1.0,571.0,571.0
0.003,17,2,136,1,60,0.0,32.0,32.0,1,76,0.0,48.0,48.0
0.102,6,10,1506,5,395,20.0,127.0,127.0,5,1111,24.0,843.0,843.0
0.015,6,10,1989,5,910,3.0,642.0,642.0,5,1079,3.0,811.0,811.0
40.063,17,10,676,5,460,10015.0,104.0,64.0,5,216,10014.0,20.0,15.0
0.015,6,10,1989,5,910,3.0,642.0,642.0,5,1079,3.0,811.0,811.0
15.07,17,15,9238,8,6902,2148.0,1350.0,834.0,7,2336,2506.0,1350.0,305.0
0.007,6,10,1689,5,839,1.0,571.0,571.0,5,850,1.0,582.0,582.0
0.005,17,2,230,1,68,0.0,40.0,40.0,1,162,0.0,134.0,134.0
0.027,6,10,1989,5,910,6.0,642.0,642.0,5,1079,6.0,811.0,811.0
240.091,6,31,9544,15,6980,17149.0,2102.0,689.0,16,2564,16005.0,580.0,215.0
366.308,6,22,2313,16,867,24420.0,195.0,195.0,6,1446,4647.0,419.0,398.0
0.079,6,10,1506,5,395,16.0,127.0,127.0,5,1111,17.0,843.0,843.0
40.05,17,10,676,5,460,10011.0,104.0,64.0,5,216,10011.0,20.0,15.0
0.007,17,2,140,1,62,0.0,34.0,34.0,1,78,0.0,50.0,50.0
0.005,6,10,1989,5,927,1.0,659.0,659.0,5,1062,1.0,794.0,794.0
10.801,17,24,3780,12,1673,972.0,268.0,111.0,12,2107,972.0,586.0,147.0
312.406,17,20,1124,10,716,34697.0,48.0,43.0,10,408,34697.0,20.0,12.0
0.004,6,10,2006,5,927,1.0,659.0,659.0,5,1079,1.0,811.0,811.0
0.011,6,10,1762,5,911,2.0,643.0,643.0,5,851,2.0,583.0,583.0
0.097,6,10,1506,5,395,22.0,127.0,127.0,5,1111,22.0,843.0,843.0
0.005,6,10,2007,5,928,1.0,660.0,660.0,5,1079,1.0,811.0,811.0
0.019,17,2,169,1,62,0.0,34.0,34.0,1,107,0.0,79.0,79.0
0.01,6,14,3787,7,497,1.0,125.0,125.0,7,3290,1.0,1448.0,972.0
240.092,6,32,9365,16,6973,16006.0,2045.0,682.0,16,2392,16005.0,580.0,194.0
0.014,6,10,1762,5,911,3.0,643.0,643.0,5,851,3.0,583.0,583.0
0.014,6,10,1972,5,910,3.0,642.0,642.0,5,1062,3.0,794.0,794.0
15.082,17,16,9061,8,6916,2150.0,1350.0,836.0,8,2145,2150.0,1350.0,240.0
0.013,6,10,1631,5,848,3.0,580.0,580.0,5,783,3.0,515.0,515.0
0.001,17,2,166,1,75,0.0,47.0,47.0,1,91,0.0,63.0,63.0
0.004,17,2,148,1,60,0.0,32.0,32.0,1,88,0.0,60.0,60.0
0.079,6,10,1506,5,395,18.0,127.0,127.0,5,1111,18.0,843.0,843.0
0.006,6,12,1698,6,863,1.0,327.0,271.0,6,835,1.0,515.0,515.0
1787.438,6,150,19350,90,13740,20083.0,302.0,302.0,60,5610,30294.0,83.0,83.0
176.244,17,76,10767,38,2524,4762.0,44.0,38.0,38,8243,4763.0,261.0,188.0
0.006,6,10,1547,5,764,1.0,496.0,496.0,5,783,1.0,515.0,515.0
0.096,6,10,1506,5,395,19.0,127.0,127.0,5,1111,18.0,843.0,843.0
329.609,17,20,1124,10,716,36616.0,48.0,43.0,10,408,36616.0,20.0,12.0
0.005,6,10,2000,5,927,1.0,659.0,659.0,5,1073,1.0,805.0,805.0
0.005,6,10,2006,5,927,1.0,659.0,659.0,5,1079,1.0,811.0,811.0
0.018,6,10,1972,5,910,4.0,642.0,642.0,5,1062,4.0,794.0,794.0
0.005,6,10,2007,5,928,1.0,660.0,660.0,5,1079,1.0,811.0,811.0
0.011,6,10,1972,5,910,2.0,642.0,642.0,5,1062,2.0,794.0,794.0
0.086,6,10,1506,5,395,19.0,127.0,127.0,5,1111,16.0,843.0,843.0
1786.544,6,154,19574,92,13852,19632.0,302.0,302.0,62,5722,29287.0,83.0,83.0
0.016,6,6,716,3,458,7.0,302.0,302.0,3,258,6.0,102.0,102.0
0.005,6,10,2006,5,927,1.0,659.0,659.0,5,1079,1.0,811.0,811.0
0.005,6,10,2006,5,927,1.0,659.0,659.0,5,1079,1.0,811.0,811.0
0.072,17,4,596,2,122,0.0,33.0,33.0,2,474,35.0,323.0,209.0
300.325,6,29,9335,17,1586,18770.0,336.0,170.0,12,7749,21844.0,2804.0,889.0
0.005,6,10,1989,5,927,1.0,659.0,659.0,5,1062,1.0,794.0,794.0
0.002,17,2,180,1,66,0.0,38.0,38.0,1,114,0.0,86.0,86.0
0.013,6,10,1972,5,910,3.0,642.0,642.0,5,1062,3.0,794.0,794.0
0.084,6,10,1506,5,395,20.0,127.0,127.0,5,1111,17.0,843.0,843.0
0.001,17,2,180,1,66,0.0,38.0,38.0,1,114,0.0,86.0,86.0
0.111,6,10,1506,5,395,25.0,127.0,127.0,5,1111,25.0,843.0,843.0
0.007,6,10,1547,5,764,1.0,496.0,496.0,5,783,1.0,515.0,515.0
240.217,6,28,4606,13,1888,20017.0,555.0,238.0,15,2718,17158.0,1094.0,215.0
0.005,6,10,1989,5,927,1.0,659.0,659.0,5,1062,1.0,794.0,794.0
308.63,17,19,1084,10,716,34279.0,48.0,43.0,9,368,38568.0,20.0,12.0
0.088,6,10,1506,5,395,19.0,127.0,127.0,5,1111,20.0,843.0,843.0
0.01,6,10,1990,5,911,2.0,643.0,643.0,5,1079,2.0,811.0,811.0
0.007,6,10,1989,5,910,1.0,642.0,642.0,5,1079,1.0,811.0,811.0
0.006,6,10,1854,5,889,1.0,621.0,621.0,5,965,1.0,697.0,697.0
0.006,17,2,144,1,64,0.0,36.0,36.0,1,80,0.0,52.0,52.0
40.065,17,10,676,5,460,10013.0,104.0,64.0,5,216,10012.0,20.0,15.0
240.777,6,24,9218,12,1769,21888.0,568.0,383.0,12,7449,21888.0,2370.0,973.0
0.015,6,10,1989,5,910,3.0,642.0,642.0,5,1079,3.0,811.0,811.0
0.004,17,2,136,1,60,0.0,32.0,32.0,1,76,0.0,48.0,48.0
0.053,17,2,152,1,76,0.0,48.0,48.0,1,76,0.0,48.0,48.0
0.228,6,16,2778,8,1396,32.0,533.0,324.0,8,1382,21.0,529.0,239.0
11.172,17,28,4422,14,1994,847.0,269.0,114.0,14,2428,847.0,587.0,145.0
0.005,6,13,3747,7,509,0.0,137.0,137.0,6,3238,0.0,1470.0,1459.0
0.003,17,2,148,1,60,0.0,32.0,32.0,1,88,0.0,60.0,60.0
1785.09,6,244,46667,119,34099,15127.0,2474.0,961.0,125,12568,14395.0,580.0,62.0
308.612,17,20,1124,10,716,34275.0,48.0,43.0,10,408,34275.0,20.0,12.0
0.008,6,10,1762,5,911,1.0,643.0,643.0,5,851,1.0,583.0,583.0
0.003,17,2,136,1,60,0.0,32.0,32.0,1,76,0.0,48.0,48.0
240.313,6,41,8669,20,5634,12647.0,2883.0,573.0,21,3035,12015.0,580.0,241.0
0.001,17,2,180,1,65,0.0,37.0,37.0,1,115,0.0,87.0,87.0
0.02,6,10,1631,5,848,5.0,580.0,580.0,5,783,5.0,515.0,515.0
0.005,6,10,2006,5,927,1.0,659.0,659.0,5,1079,1.0,811.0,811.0
0.004,17,4,284,2,120,0.0,32.0,32.0,2,164,0.0,60.0,54.0
314.015,6,34,12972,18,3347,18469.0,676.0,400.0,16,9625,20932.0,1402.0,977.0
0.005,6,10,1854,5,889,1.0,621.0,621.0,5,965,1.0,697.0,697.0
0.01,6,10,1990,5,911,2.0,643.0,643.0,5,1079,2.0,811.0,811.0
0.097,6,10,1506,5,395,21.0,127.0,127.0,5,1111,20.0,843.0,843.0
175.376,17,86,12251,43,2903,4175.0,44.0,39.0,43,9348,4175.0,239.0,189.0
0.025,6,10,1972,5,910,6.0,642.0,642.0,5,1062,6.0,794.0,794.0
0.015,6,10,1989,5,910,3.0,642.0,642.0,5,1079,3.0,811.0,811.0
0.013,6,10,1677,5,827,3.0,559.0,559.0,5,850,3.0,582.0,582.0
0.006,6,10,1643,5,860,1.0,592.0,592.0,5,783,1.0,515.0,515.0
0.004,17,2,412,1,61,0.0,33.0,33.0,1,351,0.0,323.0,323.0
0.098,6,10,1506,5,395,15.0,127.0,127.0,5,1111,22.0,843.0,843.0
240.117,6,31,9542,16,6996,16007.0,2069.0,685.0,15,2546,17151.0,580.0,219.0
0.004,6,10,2007,5,928,1.0,660.0,660.0,5,1079,1.0,811.0,811.0
0.012,6,10,1631,5,848,2.0,580.0,580.0,5,783,2.0,515.0,515.0
0.015,6,10,1972,5,910,3.0,642.0,642.0,5,1062,3.0,794.0,794.0
0.008,6,10,1990,5,911,2.0,643.0,643.0,5,1079,1.0,811.0,811.0
0.004,6,10,2000,5,927,1.0,659.0,659.0,5,1073,1.0,805.0,805.0
0.005,6,10,1774,5,923,1.0,655.0,655.0,5,851,1.0,583.0,583.0
11.273,17,28,4422,14,1993,854.0,268.0,114.0,14,2429,854.0,588.0,145.0
0.037,17,2,396,1,61,0.0,33.0,33.0,1,335,0.0,307.0,307.0
0.014,6,10,1762,5,911,3.0,643.0,643.0,5,851,3.0,583.0,583.0
0.007,6,10,2006,5,927,1.0,659.0,659.0,5,1079,1.0,811.0,811.0
0.005,17,2,184,1,68,0.0,40.0,40.0,1,116,0.0,88.0,88.0
0.005,17,2,144,1,64,0.0,36.0,36.0,1,80,0.0,52.0,52.0
0.014,6,10,1983,5,910,3.0,642.0,642.0,5,1073,3.0,805.0,805.0
0.101,6,10,1506,5,395,23.0,127.0,127.0,5,1111,19.0,843.0,843.0
0.059,17,2,152,1,76,0.0,48.0,48.0,1,76,0.0,48.0,48.0
0.016,6,10,1990,5,911,3.0,643.0,643.0,5,1079,4.0,811.0,811.0
0.013,6,10,1989,5,910,3.0,642.0,642.0,5,1079,3.0,811.0,811.0
0.009,6,10,1990,5,911,2.0,643.0,643.0,5,1079,2.0,811.0,811.0
505.44,17,126,18151,63,4197,8152.0,44.0,38.0,63,13954,8152.0,239.0,193.0
0.008,6,14,3787,7,497,1.0,125.0,125.0,7,3290,1.0,1448.0,972.0
0.006,6,13,3747,7,509,1.0,137.0,137.0,6,3238,1.0,1470.0,1459.0
0.126,6,10,1506,5,395,30.0,127.0,127.0,5,1111,30.0,843.0,843.0
0.001,17,2,180,1,66,0.0,38.0,38.0,1,114,0.0,86.0,86.0
0.006,6,10,1854,5,889,1.0,621.0,621.0,5,965,1.0,697.0,697.0
0.012,17,2,136,1,60,0.0,32.0,32.0,1,76,0.0,48.0,48.0
0.012,6,10,1989,5,910,3.0,642.0,642.0,5,1079,3.0,811.0,811.0
10.823,17,28,4418,14,1994,823.0,269.0,114.0,14,2424,823.0,587.0,145.0
0.129,17,2,80,1,32,0.0,4.0,4.0,1,48,0.0,20.0,20.0
0.071,6,10,1506,5,395,16.0,127.0,127.0,5,1111,15.0,843.0,843.0
0.005,17,2,164,1,74,0.0,46.0,46.0,1,90,0.0,62.0,62.0
0.006,17,2,170,1,65,0.0,37.0,37.0,1,105,0.0,77.0,77.0
0.013,6,10,1972,5,910,3.0,642.0,642.0,5,1062,3.0,794.0,794.0
0.082,6,10,1506,5,395,19.0,127.0,127.0,5,1111,14.0,843.0,843.0
0.008,6,10,1762,5,911,1.0,643.0,643.0,5,851,1.0,583.0,583.0
1770.622,17,120,11460,60,5460,30010.0,63.0,63.0,60,6000,30010.0,72.0,72.0
0.373,17,54,32451,31,28629,12.0,1350.0,895.0,23,3822,14.0,1350.0,138.0
40.061,17,10,676,5,460,10013.0,104.0,64.0,5,216,10014.0,20.0,15.0
1772.26,6,103,6166,59,3473,30555.0,27.0,27.0,44,2693,41214.0,27.0,27.0
0.115,6,10,1506,5,395,18.0,127.0,127.0,5,1111,26.0,843.0,843.0
0.004,6,10,1702,5,863,1.0,595.0,595.0,5,839,1.0,571.0,571.0
0.022,6,10,1990,5,911,5.0,643.0,643.0,5,1079,5.0,811.0,811.0
0.084,6,10,1506,5,395,15.0,127.0,127.0,5,1111,18.0,843.0,843.0
0.013,17,2,152,1,56,0.0,28.0,28.0,1,96,0.0,68.0,68.0
0.015,6,13,3735,7,497,2.0,125.0,125.0,6,3238,3.0,1470.0,1459.0
0.005,6,10,1989,5,927,1.0,659.0,659.0,5,1062,1.0,794.0,794.0
0.01,6,10,1989,5,910,2.0,642.0,642.0,5,1079,2.0,811.0,811.0
0.029,17,2,198,1,91,0.0,63.0,63.0,1,107,0.0,79.0,79.0
0.005,6,10,2006,5,927,1.0,659.0,659.0,5,1079,1.0,811.0,811.0
0.052,6,10,1506,5,395,12.0,127.0,127.0,5,1111,12.0,843.0,843.0
0.008,6,10,1547,5,764,1.0,496.0,496.0,5,783,1.0,515.0,515.0
0.011,6,10,1854,5,889,2.0,621.0,621.0,5,965,2.0,697.0,697.0
0.009,6,10,1990,5,911,2.0,643.0,643.0,5,1079,2.0,811.0,811.0
0.008,6,10,1989,5,910,2.0,642.0,642.0,5,1079,1.0,811.0,811.0
0.112,6,10,1506,5,395,25.0,127.0,127.0,5,1111,22.0,843.0,843.0
0.005,6,14,3742,7,452,0.0,80.0,80.0,7,3290,0.0,1448.0,972.0
11.072,17,28,4422,14,1994,839.0,269.0,114.0,14,2428,839.0,587.0,145.0
15.081,17,15,9239,8,6902,2149.0,1350.0,834.0,7,2337,2508.0,1350.0,305.0
0.006,6,10,1989,5,927,1.0,659.0,659.0,5,1062,1.0,794.0,794.0
0.004,17,2,136,1,60,0.0,32.0,32.0,1,76,0.0,48.0,48.0
0.012,6,10,1989,5,910,2.0,642.0,642.0,5,1079,3.0,811.0,811.0
0.088,6,10,1506,5,395,18.0,127.0,127.0,5,1111,15.0,843.0,843.0
0.009,6,10,1762,5,911,2.0,643.0,643.0,5,851,2.0,583.0,583.0
0.004,6,10,1989,5,927,1.0,659.0,659.0,5,1062,1.0,794.0,794.0
240.091,6,16,4482,9,963,30011.0,238.0,166.0,7,3519,40014.0,1402.0,786.0
0.006,6,10,1779,5,928,1.0,660.0,660.0,5,851,1.0,583.0,583.0
0.001,17,2,180,1,66,0.0,38.0,38.0,1,114,0.0,86.0,86.0
0.001,17,2,180,1,66,0.0,38.0,38.0,1,114,0.0,86.0,86.0
0.01,6,10,1989,5,910,2.0,642.0,642.0,5,1079,2.0,811.0,811.0
0.079,6,10,1506,5,395,17.0,127.0,127.0,5,1111,17.0,843.0,843.0
0.105,6,10,1506,5,395,24.0,127.0,127.0,5,1111,23.0,843.0,843.0
0.007,6,10,1547,5,764,1.0,496.0,496.0,5,783,1.0,515.0,515.0
0.11,6,10,1506,5,395,26.0,127.0,127.0,5,1111,26.0,843.0,843.0
0.004,6,10,1989,5,927,1.0,659.0,659.0,5,1062,1.0,794.0,794.0
0.005,17,2,170,1,65,0.0,37.0,37.0,1,105,0.0,77.0,77.0
0.001,17,2,180,1,66,0.0,38.0,38.0,1,114,0.0,86.0,86.0
0.011,6,6,716,3,458,4.0,302.0,302.0,3,258,4.0,102.0,102.0
0.001,17,2,174,1,72,0.0,44.0,44.0,1,102,0.0,74.0,74.0
0.02,6,10,1989,5,910,4.0,642.0,642.0,5,1079,5.0,811.0,811.0
0.004,17,4,284,2,120,0.0,32.0,32.0,2,164,1.0,60.0,54.0
0.184,17,2,194,1,59,0.0,31.0,31.0,1,135,0.0,107.0,107.0
0.005,6,13,3747,7,509,0.0,137.0,137.0,6,3238,1.0,1470.0,1459.0
0.005,6,10,1989,5,927,1.0,659.0,659.0,5,1062,1.0,794.0,794.0
0.006,6,10,1547,5,764,1.0,496.0,496.0,5,783,1.0,515.0,515.0
0.005,6,10,2006,5,927,1.0,659.0,659.0,5,1079,1.0,811.0,811.0
0.016,6,10,1989,5,910,4.0,642.0,642.0,5,1079,3.0,811.0,811.0
0.076,6,10,1506,5,395,18.0,127.0,127.0,5,1111,14.0,843.0,843.0
0.011,6,10,1989,5,910,2.0,642.0,642.0,5,1079,2.0,811.0,811.0
0.172,17,2,154,1,69,0.0,41.0,41.0,1,85,0.0,57.0,57.0
0.091,6,10,1506,5,395,20.0,127.0,127.0,5,1111,18.0,843.0,843.0
0.013,6,10,1990,5,911,3.0,643.0,643.0,5,1079,3.0,811.0,811.0
0.008,6,10,1983,5,910,1.0,642.0,642.0,5,1073,1.0,805.0,805.0
10.855,17,28,4423,14,1994,826.0,269.0,114.0,14,2429,826.0,588.0,145.0
0.002,17,2,166,1,75,0.0,47.0,47.0,1,91,0.0,63.0,63.0
0.005,6,13,3747,7,509,0.0,137.0,137.0,6,3238,1.0,1470.0,1459.0
0.009,6,10,1762,5,911,2.0,643.0,643.0,5,851,2.0,583.0,583.0
0.005,6,10,2000,5,927,1.0,659.0,659.0,5,1073,1.0,805.0,805.0
0.011,6,10,1990,5,911,2.0,643.0,643.0,5,1079,2.0,811.0,811.0
0.127,6,10,1506,5,395,29.0,127.0,127.0,5,1111,27.0,843.0,843.0
40.053,17,10,676,5,460,10012.0,104.0,64.0,5,216,10012.0,20.0,15.0
0.023,6,10,1990,5,911,5.0,643.0,643.0,5,1079,5.0,811.0,811.0
0.005,6,10,1774,5,923,1.0,655.0,655.0,5,851,1.0,583.0,583.0
0.001,17,2,166,1,75,0.0,47.0,47.0,1,91,0.0,63.0,63.0
0.004,6,10,2007,5,928,1.0,660.0,660.0,5,1079,1.0,811.0,811.0
0.004,6,10,1989,5,927,1.0,659.0,659.0,5,1062,1.0,794.0,794.0
0.016,6,10,1990,5,911,4.0,643.0,643.0,5,1079,4.0,811.0,811.0
0.14,17,2,180,1,58,0.0,30.0,30.0,1,122,0.0,94.0,94.0
0.005,6,10,2007,5,928,1.0,660.0,660.0,5,1079,1.0,811.0,811.0
40.07,17,10,676,5,460,10014.0,104.0,64.0,5,216,10016.0,20.0,15.0
0.005,6,10,2000,5,927,1.0,659.0,659.0,5,1073,1.0,805.0,805.0
40.081,17,10,676,5,460,10018.0,104.0,64.0,5,216,10019.0,20.0,15.0
0.007,6,10,1989,5,910,1.0,642.0,642.0,5,1079,1.0,811.0,811.0
240.14,6,43,6762,21,3174,12006.0,588.0,230.0,22,3588,11435.0,580.0,243.0
0.003,17,2,136,1,60,0.0,32.0,32.0,1,76,0.0,48.0,48.0
0.011,6,10,1990,5,911,2.0,643.0,643.0,5,1079,2.0,811.0,811.0
0.005,6,14,3742,7,452,0.0,80.0,80.0,7,3290,0.0,1448.0,972.0
0.016,6,10,1762,5,911,4.0,643.0,643.0,5,851,4.0,583.0,583.0
40.055,17,10,676,5,460,10011.0,104.0,64.0,5,216,10011.0,20.0,15.0
309.231,17,20,1124,10,716,34344.0,48.0,43.0,10,408,34343.0,20.0,12.0
0.013,6,10,1989,5,910,3.0,642.0,642.0,5,1079,3.0,811.0,811.0
0.003,17,2,185,1,73,0.0,45.0,45.0,1,112,0.0,84.0,84.0
0.004,17,2,148,1,60,0.0,32.0,32.0,1,88,0.0,60.0,60.0
0.003,17,2,185,1,73,0.0,45.0,45.0,1,112,0.0,84.0,84.0
0.005,6,10,2000,5,927,1.0,659.0,659.0,5,1073,1.0,805.0,805.0
0.006,6,10,1689,5,839,1.0,571.0,571.0,5,850,1.0,582.0,582.0
0.005,6,10,1989,5,927,1.0,659.0,659.0,5,1062,1.0,794.0,794.0
0.006,6,10,2007,5,928,1.0,660.0,660.0,5,1079,1.0,811.0,811.0
0.014,6,10,1990,5,911,3.0,643.0,643.0,5,1079,3.0,811.0,811.0
300.313,6,16,2170,9,684,37518.0,146.0,146.0,7,1486,50024.0,419.0,398.0
0.08,6,10,1506,5,395,18.0,127.0,127.0,5,1111,16.0,843.0,843.0
0.001,17,2,180,1,66,0.0,38.0,38.0,1,114,0.0,86.0,86.0
0.018,6,10,1989,5,910,4.0,642.0,642.0,5,1079,4.0,811.0,811.0
0.004,17,2,148,1,60,0.0,32.0,32.0,1,88,0.0,60.0,60.0
0.004,6,10,2007,5,928,1.0,660.0,660.0,5,1079,1.0,811.0,811.0
0.015,6,10,1989,5,910,3.0,642.0,642.0,5,1079,3.0,811.0,811.0
0.104,6,10,1506,5,395,21.0,127.0,127.0,5,1111,22.0,843.0,843.0
10.956,17,28,4423,14,1994,833.0,269.0,114.0,14,2429,833.0,588.0,145.0
0.005,6,10,1779,5,928,1.0,660.0,660.0,5,851,1.0,583.0,583.0
0.006,17,2,170,1,65,0.0,37.0,37.0,1,105,0.0,77.0,77.0
0.005,6,10,2000,5,927,1.0,659.0,659.0,5,1073,1.0,805.0,805.0
0.005,6,10,2007,5,928,1.0,660.0,660.0,5,1079,1.0,811.0,811.0
0.005,6,10,1547,5,764,1.0,496.0,496.0,5,783,1.0,515.0,515.0
0.014,6,10,1989,5,910,3.0,642.0,642.0,5,1079,3.0,811.0,811.0
0.074,6,10,1506,5,395,16.0,127.0,127.0,5,1111,17.0,843.0,843.0
0.005,6,10,2007,5,928,1.0,660.0,660.0,5,1079,1.0,811.0,811.0
0.148,6,10,1506,5,395,33.0,127.0,127.0,5,1111,32.0,843.0,843.0
0.005,6,10,2007,5,928,1.0,660.0,660.0,5,1079,1.0,811.0,811.0
0.001,17,2,180,1,66,0.0,38.0,38.0,1,114,0.0,86.0,86.0
0.005,17,2,230,1,68,0.0,40.0,40.0,1,162,0.0,134.0,134.0
0.492,17,2,144,1,64,0.0,36.0,36.0,1,80,0.0,52.0,52.0
0.006,6,10,1990,5,911,1.0,643.0,643.0,5,1079,1.0,811.0,811.0
0.041,17,4,596,2,122,1.0,33.0,33.0,2,474,2.0,323.0,209.0
0.006,6,10,1643,5,860,1.0,592.0,592.0,5,783,1.0,515.0,515.0
0.004,6,10,1989,5,927,1.0,659.0,659.0,5,1062,1.0,794.0,794.0
0.01,6,10,1677,5,827,2.0,559.0,559.0,5,850,2.0,582.0,582.0
0.015,6,10,1990,5,911,3.0,643.0,643.0,5,1079,3.0,811.0,811.0
40.069,17,10,676,5,460,10016.0,104.0,64.0,5,216,10016.0,20.0,15.0
0.005,17,2,169,1,62,0.0,34.0,34.0,1,107,0.0,79.0,79.0
0.004,6,10,1779,5,928,1.0,660.0,660.0,5,851,1.0,583.0,583.0
10.777,17,26,4101,13,1846,889.0,269.0,114.0,13,2255,889.0,586.0,145.0
0.004,17,2,136,1,60,0.0,32.0,32.0,1,76,0.0,48.0,48.0
0.131,17,4,284,2,120,0.0,32.0,32.0,2,164,127.0,60.0,54.0
0.005,6,10,2006,5,927,1.0,659.0,659.0,5,1079,1.0,811.0,811.0
0.001,17,2,174,1,72,0.0,44.0,44.0,1,102,0.0,74.0,74.0
0.012,6,10,1631,5,848,2.0,580.0,580.0,5,783,2.0,515.0,515.0
79.973,6,24,9037,12,3129,104.0,1360.0,654.0,12,5908,7255.0,2720.0,902.0
0.005,6,10,1854,5,889,1.0,621.0,621.0,5,965,1.0,697.0,697.0
308.527,17,20,1124,10,716,34266.0,48.0,43.0,10,408,34266.0,20.0,12.0
0.073,6,10,1506,5,395,16.0,127.0,127.0,5,1111,17.0,843.0,843.0
0.005,17,2,212,1,74,0.0,46.0,46.0,1,138,0.0,110.0,110.0
0.006,6,10,2007,5,928,1.0,660.0,660.0,5,1079,1.0,811.0,811.0
0.086,6,10,1506,5,395,20.0,127.0,127.0,5,1111,20.0,843.0,843.0
0.001,17,2,136,1,60,0.0,32.0,32.0,1,76,0.0,48.0,48.0
0.107,6,10,1506,5,395,25.0,127.0,127.0,5,1111,24.0,843.0,843.0
11.171,17,28,4423,14,1994,847.0,269.0,114.0,14,2429,847.0,588.0,145.0
0.015,6,10,1972,5,910,3.0,642.0,642.0,5,1062,3.0,794.0,794.0
0.005,6,10,2006,5,927,1.0,659.0,659.0,5,1079,1.0,811.0,811.0
293.892,6,374,346443,189,21385,1563.0,2690.0,769.0,185,325058,1597.0,2804.0,1844.0
0.006,6,10,1854,5,889,1.0,621.0,621.0,5,965,1.0,697.0,697.0
0.074,6,10,1506,5,395,16.0,127.0,127.0,5,1111,17.0,843.0,843.0
0.004,17,2,148,1,60,0.0,32.0,32.0,1,88,0.0,60.0,60.0
0.006,6,10,2006,5,927,1.0,659.0,659.0,5,1079,1.0,811.0,811.0
0.075,6,10,1506,5,395,18.0,127.0,127.0,5,1111,15.0,843.0,843.0
0.005,6,10,1547,5,764,1.0,496.0,496.0,5,783,1.0,515.0,515.0
0.04,17,4,420,2,122,0.0,33.0,33.0,2,298,37.0,145.0,121.0
0.01,17,2,166,1,75,0.0,47.0,47.0,1,91,0.0,63.0,63.0
0.005,6,10,2006,5,927,1.0,659.0,659.0,5,1079,1.0,811.0,811.0
0.016,6,10,1989,5,910,3.0,642.0,642.0,5,1079,4.0,811.0,811.0
0.106,6,10,1506,5,395,25.0,127.0,127.0,5,1111,22.0,843.0,843.0
0.005,6,10,2000,5,927,1.0,659.0,659.0,5,1073,1.0,805.0,805.0
0.006,6,10,1547,5,764,1.0,496.0,496.0,5,783,1.0,515.0,515.0
0.005,6,10,2006,5,927,1.0,659.0,659.0,5,1079,1.0,811.0,811.0
0.004,17,2,148,1,60,0.0,32.0,32.0,1,88,0.0,60.0,60.0
0.129,17,2,80,1,32,0.0,4.0,4.0,1,48,0.0,20.0,20.0
0.005,6,10,1702,5,863,1.0,595.0,595.0,5,839,1.0,571.0,571.0
0.085,6,10,1506,5,395,19.0,127.0,127.0,5,1111,16.0,843.0,843.0
0.011,6,10,1762,5,911,2.0,643.0,643.0,5,851,2.0,583.0,583.0
0.097,6,10,1506,5,395,20.0,127.0,127.0,5,1111,22.0,843.0,843.0
0.006,17,2,180,1,66,0.0,38.0,38.0,1,114,0.0,86.0,86.0
0.008,6,10,1989,5,910,1.0,642.0,642.0,5,1079,1.0,811.0,811.0
0.013,6,10,1989,5,910,3.0,642.0,642.0,5,1079,3.0,811.0,811.0
240.089,6,31,9123,15,6845,17149.0,1967.0,674.0,16,2278,16005.0,580.0,179.0
0.077,6,10,1506,5,395,18.0,127.0,127.0,5,1111,17.0,843.0,843.0
0.02,6,10,1989,5,910,5.0,642.0,642.0,5,1079,5.0,811.0,811.0
0.004,6,10,2006,5,927,1.0,659.0,659.0,5,1079,1.0,811.0,811.0
0.012,6,10,1989,5,910,3.0,642.0,642.0,5,1079,3.0,811.0,811.0
0.001,17,2,180,1,66,0.0,38.0,38.0,1,114,0.0,86.0,86.0
11.356,17,28,4398,14,2312,861.0,587.0,137.0,14,2086,861.0,269.0,121.0
0.012,6,10,1762,5,911,2.0,643.0,643.0,5,851,2.0,583.0,583.0
40.093,17,10,676,5,460,10016.0,104.0,64.0,5,216,10013.0,20.0,15.0
11.127,17,28,4423,14,1994,843.0,269.0,114.0,14,2429,843.0,588.0,145.0
0.012,6,10,1989,5,910,3.0,642.0,642.0,5,1079,3.0,811.0,811.0
145.331,6,22,7437,11,1305,115.0,530.0,277.0,11,6132,14514.0,2720.0,946.0
0.169,17,2,152,1,76,0.0,48.0,48.0,1,76,0.0,48.0,48.0
40.057,17,10,676,5,460,10013.0,104.0,64.0,5,216,10013.0,20.0,15.0
0.005,6,10,1989,5,927,1.0,659.0,659.0,5,1062,1.0,794.0,794.0
0.004,6,10,2007,5,928,1.0,660.0,660.0,5,1079,1.0,811.0,811.0
0.004,17,2,144,1,64,0.0,36.0,36.0,1,80,0.0,52.0,52.0
170.07,17,76,10751,38,2530,4596.0,44.0,38.0,38,8221,4596.0,261.0,188.0
240.088,6,16,4481,9,963,30011.0,238.0,166.0,7,3518,40014.0,1402.0,786.0
0.003,17,2,136,1,60,0.0,32.0,32.0,1,76,0.0,48.0,48.0
0.103,6,10,1506,5,395,22.0,127.0,127.0,5,1111,24.0,843.0,843.0
0.065,6,10,1506,5,395,15.0,127.0,127.0,5,1111,14.0,843.0,843.0
240.175,6,39,5079,19,2374,13342.0,588.0,196.0,20,2705,12640.0,580.0,207.0
0.004,17,4,284,2,120,1.0,32.0,32.0,2,164,1.0,60.0,54.0
0.01,6,10,1989,5,910,2.0,642.0,642.0,5,1079,2.0,811.0,811.0
0.005,17,2,179,1,71,0.0,43.0,43.0,1,108,0.0,80.0,80.0
0.072,6,10,1506,5,395,17.0,127.0,127.0,5,1111,14.0,843.0,843.0
11.507,17,28,4399,14,2312,872.0,587.0,137.0,14,2087,872.0,270.0,121.0
0.003,17,2,136,1,60,0.0,32.0,32.0,1,76,0.0,48.0,48.0
0.005,6,10,1854,5,889,1.0,621.0,621.0,5,965,1.0,697.0,697.0
0.018,6,10,1972,5,910,4.0,642.0,642.0,5,1062,4.0,794.0,794.0
0.006,6,10,1689,5,839,1.0,571.0,571.0,5,850,1.0,582.0,582.0
0.005,6,10,1689,5,839,1.0,571.0,571.0,5,850,1.0,582.0,582.0
0.009,6,10,1989,5,910,2.0,642.0,642.0,5,1079,2.0,811.0,811.0
368.612,6,22,2313,16,867,24574.0,195.0,195.0,6,1446,4636.0,419.0,398.0
0.004,6,10,2006,5,927,1.0,659.0,659.0,5,1079,1.0,811.0,811.0
176.381,17,78,11029,39,2605,4641.0,44.0,38.0,39,8424,4641.0,239.0,188.0
0.09,6,10,1506,5,395,21.0,127.0,127.0,5,1111,17.0,843.0,843.0
0.006,6,10,1689,5,839,1.0,571.0,571.0,5,850,1.0,582.0,582.0
0.005,6,10,1689,5,839,1.0,571.0,571.0,5,850,1.0,582.0,582.0
0.005,6,10,2006,5,927,1.0,659.0,659.0,5,1079,1.0,811.0,811.0
354.049,6,21,1795,16,1030,23603.0,190.0,190.0,5,765,60002.0,464.0,248.0
0.007,17,2,179,1,71,0.0,43.0,43.0,1,108,0.0,80.0,80.0
0.006,6,10,1547,5,764,1.0,496.0,496.0,5,783,1.0,515.0,515.0
0.052,17,2,152,1,76,0.0,48.0,48.0,1,76,0.0,48.0,48.0
0.004,6,10,2007,5,928,1.0,660.0,660.0,5,1079,1.0,811.0,811.0
352.243,6,20,2210,6,1308,12003.0,494.0,494.0,14,902,27095.0,83.0,83.0
240.105,6,32,9491,16,6896,16007.0,1968.0,674.0,16,2595,16006.0,580.0,219.0
0.001,17,2,180,1,66,0.0,38.0,38.0,1,114,0.0,86.0,86.0
0.004,6,10,2006,5,927,1.0,659.0,659.0,5,1079,1.0,811.0,811.0
0.005,6,10,2000,5,927,1.0,659.0,659.0,5,1073,1.0,805.0,805.0
0.006,6,10,1547,5,764,1.0,496.0,496.0,5,783,1.0,515.0,515.0
0.004,6,10,1989,5,927,1.0,659.0,659.0,5,1062,1.0,794.0,794.0
0.007,6,10,1689,5,839,1.0,571.0,571.0,5,850,1.0,582.0,582.0
0.092,6,10,1506,5,395,19.0,127.0,127.0,5,1111,19.0,843.0,843.0
0.003,17,4,284,2,120,0.0,32.0,32.0,2,164,0.0,60.0,54.0
0.005,6,14,3742,7,452,0.0,80.0,80.0,7,3290,0.0,1448.0,972.0
0.004,17,2,148,1,60,0.0,32.0,32.0,1,88,0.0,60.0,60.0
0.011,6,10,1990,5,911,2.0,643.0,643.0,5,1079,2.0,811.0,811.0
0.001,17,2,174,1,72,0.0,44.0,44.0,1,102,0.0,74.0,74.0
360.024,6,21,3981,13,3142,30002.0,494.0,494.0,8,839,51431.0,83.0,83.0
0.005,6,10,2007,5,928,1.0,660.0,660.0,5,1079,1.0,811.0,811.0
0.086,6,10,1506,5,395,19.0,127.0,127.0,5,1111,19.0,843.0,843.0
0.017,6,13,3735,7,497,2.0,125.0,125.0,6,3238,3.0,1470.0,1459.0
0.129,17,2,80,1,32,0.0,4.0,4.0,1,48,0.0,20.0,20.0
0.005,17,2,184,1,61,0.0,33.0,33.0,1,123,0.0,95.0,95.0
0.094,6,10,1506,5,395,19.0,127.0,127.0,5,1111,20.0,843.0,843.0
0.015,17,2,148,1,60,0.0,32.0,32.0,1,88,0.0,60.0,60.0
0.122,6,10,1506,5,395,28.0,127.0,127.0,5,1111,28.0,843.0,843.0
0.177,6,10,1506,5,395,42.0,127.0,127.0,5,1111,18.0,843.0,843.0
0.005,6,10,2006,5,927,1.0,659.0,659.0,5,1079,1.0,811.0,811.0
0.011,6,10,1762,5,911,2.0,643.0,643.0,5,851,2.0,583.0,583.0
0.006,17,2,170,1,65,0.0,37.0,37.0,1,105,0.0,77.0,77.0
40.066,17,10,676,5,460,10013.0,104.0,64.0,5,216,10012.0,20.0,15.0
0.013,17,2,152,1,76,0.0,48.0,48.0,1,76,0.0,48.0,48.0
0.007,6,10,1547,5,764,1.0,496.0,496.0,5,783,1.0,515.0,515.0
0.005,6,10,2000,5,927,1.0,659.0,659.0,5,1073,1.0,805.0,805.0
0.009,17,2,148,1,60,0.0,32.0,32.0,1,88,0.0,60.0,60.0
0.006,6,10,1854,5,889,1.0,621.0,621.0,5,965,1.0,697.0,697.0
0.115,6,10,1506,5,395,22.0,127.0,127.0,5,1111,27.0,843.0,843.0
0.013,6,10,1762,5,911,3.0,643.0,643.0,5,851,3.0,583.0,583.0
0.246,17,16,8559,8,6082,35.0,1350.0,732.0,8,2477,20.0,1350.0,281.0
0.001,17,2,180,1,65,0.0,37.0,37.0,1,115,0.0,87.0,87.0
10.712,17,28,4423,14,1994,815.0,269.0,114.0,14,2429,815.0,588.0,145.0
0.012,6,13,3735,7,497,1.0,125.0,125.0,6,3238,2.0,1470.0,1459.0
66.365,6,27,17583,15,9638,4740.0,2804.0,1475.0,12,7945,6017.0,2316.0,1218.0
0.005,6,10,2006,5,927,1.0,659.0,659.0,5,1079,1.0,811.0,811.0
0.005,6,10,1854,5,889,1.0,621.0,621.0,5,965,1.0,697.0,697.0
0.014,6,10,1972,5,910,3.0,642.0,642.0,5,1062,3.0,794.0,794.0
0.015,6,10,1989,5,910,3.0,642.0,642.0,5,1079,3.0,811.0,811.0
0.093,6,10,1506,5,395,20.0,127.0,127.0,5,1111,19.0,843.0,843.0
0.145,6,10,1506,5,395,35.0,127.0,127.0,5,1111,35.0,843.0,843.0
0.005,17,2,166,1,75,0.0,47.0,47.0,1,91,0.0,63.0,63.0
0.006,6,10,1547,5,764,1.0,496.0,496.0,5,783,1.0,515.0,515.0
0.215,6,16,2674,8,1400,30.0,533.0,325.0,8,1274,19.0,529.0,212.0
0.006,6,10,1854,5,889,1.0,621.0,621.0,5,965,1.0,697.0,697.0
0.007,6,10,1989,5,910,1.0,642.0,642.0,5,1079,1.0,811.0,811.0
0.001,17,2,180,1,66,0.0,38.0,38.0,1,114,0.0,86.0,86.0
0.014,17,2,136,1,60,0.0,32.0,32.0,1,76,0.0,48.0,48.0
0.008,6,10,2006,5,927,2.0,659.0,659.0,5,1079,1.0,811.0,811.0
0.088,6,10,1506,5,395,20.0,127.0,127.0,5,1111,17.0,843.0,843.0
40.071,17,10,676,5,460,10016.0,104.0,64.0,5,216,10016.0,20.0,15.0
322.895,6,33,10744,18,2762,18993.0,676.0,363.0,15,7982,18776.0,1402.0,799.0
0.006,6,10,2006,5,927,1.0,659.0,659.0,5,1079,1.0,811.0,811.0
40.059,17,10,676,5,460,10014.0,104.0,64.0,5,216,10013.0,20.0,15.0
274.287,6,28,9509,15,2606,19589.0,676.0,363.0,13,6903,22854.0,1402.0,890.0
0.01,6,10,1990,5,911,2.0,643.0,643.0,5,1079,2.0,811.0,811.0
0.037,17,2,182,1,65,0.0,37.0,37.0,1,117,0.0,89.0,89.0
1769.067,17,92,8096,46,4048,39312.0,60.0,60.0,46,4048,39312.0,60.0,60.0
0.005,6,10,2006,5,927,1.0,659.0,659.0,5,1079,1.0,811.0,811.0
0.006,6,10,1643,5,860,1.0,592.0,592.0,5,783,1.0,515.0,515.0
291.779,6,317,345908,127,19487,2315.0,2736.0,859.0,190,326421,1543.0,2804.0,1819.0
0.005,6,13,3747,7,509,0.0,137.0,137.0,6,3238,1.0,1470.0,1459.0
0.019,6,10,1989,5,910,4.0,642.0,642.0,5,1079,4.0,811.0,811.0
0.042,17,2,152,1,76,0.0,48.0,48.0,1,76,0.0,48.0,48.0
0.007,6,10,1989,5,910,1.0,642.0,642.0,5,1079,1.0,811.0,811.0
0.011,6,10,1989,5,910,2.0,642.0,642.0,5,1079,2.0,811.0,811.0
0.08,6,10,1506,5,395,16.0,127.0,127.0,5,1111,18.0,843.0,843.0
0.006,6,10,1547,5,764,1.0,496.0,496.0,5,783,1.0,515.0,515.0
0.009,6,10,1989,5,910,2.0,642.0,642.0,5,1079,2.0,811.0,811.0
0.066,6,10,1506,5,395,14.0,127.0,127.0,5,1111,14.0,843.0,843.0
0.005,6,10,1643,5,860,1.0,592.0,592.0,5,783,1.0,515.0,515.0
5.088,6,23,6562,13,1500,423.0,474.0,201.0,10,5062,564.0,1925.0,757.0
0.107,6,10,1506,5,395,25.0,127.0,127.0,5,1111,24.0,843.0,843.0
0.001,17,2,136,1,60,0.0,32.0,32.0,1,76,0.0,48.0,48.0
0.005,17,2,136,1,60,0.0,32.0,32.0,1,76,0.0,48.0,48.0
0.015,17,2,198,1,91,0.0,63.0,63.0,1,107,0.0,79.0,79.0
11.145,17,28,4390,14,2312,848.0,587.0,137.0,14,2078,848.0,269.0,120.0
0.004,6,10,2006,5,927,1.0,659.0,659.0,5,1079,1.0,811.0,811.0
432.35,17,124,17812,62,4134,7087.0,44.0,38.0,62,13678,7087.0,239.0,192.0
0.008,6,10,1989,5,910,2.0,642.0,642.0,5,1079,1.0,811.0,811.0
0.004,6,10,2006,5,927,1.0,659.0,659.0,5,1079,1.0,811.0,811.0
1757.826,6,88,5473,44,2360,40878.0,36.0,36.0,44,3113,40878.0,398.0,206.0
0.005,17,2,427,1,129,0.0,101.0,101.0,1,298,0.0,270.0,270.0
0.004,17,2,136,1,60,0.0,32.0,32.0,1,76,0.0,48.0,48.0
40.066,17,10,676,5,460,10013.0,104.0,64.0,5,216,10015.0,20.0,15.0
240.306,6,33,8636,17,1836,15018.0,569.0,188.0,16,6800,16020.0,1402.0,597.0
240.091,6,16,4481,9,963,30011.0,238.0,166.0,7,3518,40014.0,1402.0,786.0
0.003,17,4,284,2,120,0.0,32.0,32.0,2,164,0.0,60.0,54.0
0.004,6,10,1774,5,923,1.0,655.0,655.0,5,851,1.0,583.0,583.0
0.013,6,10,1990,5,911,3.0,643.0,643.0,5,1079,3.0,811.0,811.0
0.004,17,2,148,1,60,0.0,32.0,32.0,1,88,0.0,60.0,60.0
0.113,6,10,1506,5,395,24.0,127.0,127.0,5,1111,26.0,843.0,843.0
308.58,17,20,1124,10,716,34272.0,48.0,43.0,10,408,34272.0,20.0,12.0
0.08,6,10,1506,5,395,16.0,127.0,127.0,5,1111,18.0,843.0,843.0
0.09,6,10,1506,5,395,21.0,127.0,127.0,5,1111,17.0,843.0,843.0
0.012,6,10,1989,5,910,3.0,642.0,642.0,5,1079,2.0,811.0,811.0
0.005,6,10,1643,5,860,1.0,592.0,592.0,5,783,1.0,515.0,515.0
0.006,17,2,169,1,62,0.0,34.0,34.0,1,107,0.0,79.0,79.0
0.018,6,10,1990,5,911,4.0,643.0,643.0,5,1079,4.0,811.0,811.0
0.005,17,2,214,1,75,0.0,47.0,47.0,1,139,0.0,111.0,111.0
0.004,6,10,2000,5,927,1.0,659.0,659.0,5,1073,1.0,805.0,805.0
0.014,6,10,1989,5,910,3.0,642.0,642.0,5,1079,3.0,811.0,811.0
0.116,6,10,1506,5,395,26.0,127.0,127.0,5,1111,26.0,843.0,843.0
0.083,6,10,1506,5,395,19.0,127.0,127.0,5,1111,16.0,843.0,843.0
0.004,6,10,1779,5,928,1.0,660.0,660.0,5,851,1.0,583.0,583.0
0.155,6,10,1506,5,395,35.0,127.0,127.0,5,1111,34.0,843.0,843.0
0.012,6,10,1983,5,910,2.0,642.0,642.0,5,1073,3.0,805.0,805.0
0.012,6,10,1972,5,910,3.0,642.0,642.0,5,1062,3.0,794.0,794.0
0.001,17,2,132,1,58,0.0,30.0,30.0,1,74,0.0,46.0,46.0
0.082,6,10,1506,5,395,15.0,127.0,127.0,5,1111,19.0,843.0,843.0
0.003,17,2,148,1,60,0.0,32.0,32.0,1,88,0.0,60.0,60.0
0.115,6,10,1506,5,395,25.0,127.0,127.0,5,1111,26.0,843.0,843.0
0.011,6,10,1989,5,910,2.0,642.0,642.0,5,1079,2.0,811.0,811.0
0.014,6,10,1989,5,910,3.0,642.0,642.0,5,1079,3.0,811.0,811.0
0.005,17,2,169,1,62,0.0,34.0,34.0,1,107,0.0,79.0,79.0
40.052,17,10,676,5,460,10011.0,104.0,64.0,5,216,10012.0,20.0,15.0
177.188,17,90,13264,45,3036,4026.0,44.0,39.0,45,10228,4026.0,261.0,199.0
0.013,17,2,152,1,56,0.0,28.0,28.0,1,96,0.0,68.0,68.0
0.008,6,10,1983,5,910,2.0,642.0,642.0,5,1073,1.0,805.0,805.0
0.004,17,2,148,1,60,0.0,32.0,32.0,1,88,0.0,60.0,60.0
1794.869,6,562,188229,283,162676,6364.0,2883.0,936.0,279,25553,6456.0,378.0,112.0
0.079,6,10,1506,5,395,15.0,127.0,127.0,5,1111,17.0,843.0,843.0
0.004,6,10,1702,5,863,0.0,595.0,595.0,5,839,1.0,571.0,571.0
0.012,6,10,1989,5,910,2.0,642.0,642.0,5,1079,3.0,811.0,811.0
0.004,6,10,2007,5,928,1.0,660.0,660.0,5,1079,1.0,811.0,811.0
0.111,6,10,1506,5,395,27.0,127.0,127.0,5,1111,25.0,843.0,843.0
0.038,17,2,152,1,76,0.0,48.0,48.0,1,76,0.0,48.0,48.0
0.024,17,2,179,1,71,0.0,43.0,43.0,1,108,0.0,80.0,80.0
0.019,6,10,1989,5,910,4.0,642.0,642.0,5,1079,4.0,811.0,811.0
0.006,6,10,1689,5,839,1.0,571.0,571.0,5,850,1.0,582.0,582.0
0.017,6,10,1989,5,910,4.0,642.0,642.0,5,1079,4.0,811.0,811.0
0.001,17,2,142,1,63,0.0,35.0,35.0,1,79,0.0,51.0,51.0
0.103,6,10,1506,5,395,24.0,127.0,127.0,5,1111,23.0,843.0,843.0
0.005,17,2,144,1,64,0.0,36.0,36.0,1,80,0.0,52.0,52.0
0.006,6,10,2006,5,927,1.0,659.0,659.0,5,1079,1.0,811.0,811.0
0.005,6,10,1854,5,889,1.0,621.0,621.0,5,965,1.0,697.0,697.0
0.006,6,10,1547,5,764,1.0,496.0,496.0,5,783,1.0,515.0,515.0
172.146,17,78,11101,39,2601,4530.0,44.0,38.0,39,8500,4530.0,239.0,189.0
0.015,6,13,3735,7,497,2.0,125.0,125.0,6,3238,2.0,1470.0,1459.0
0.083,6,10,1506,5,395,19.0,127.0,127.0,5,1111,18.0,843.0,843.0
11.166,17,28,4423,14,1994,846.0,269.0,114.0,14,2429,846.0,588.0,145.0
0.005,6,10,2006,5,927,1.0,659.0,659.0,5,1079,1.0,811.0,811.0
0.038,17,2,186,1,61,0.0,33.0,33.0,1,125,0.0,97.0,97.0
0.009,6,13,3735,7,497,1.0,125.0,125.0,6,3238,1.0,1470.0,1459.0
354.008,6,21,1795,16,1030,23600.0,190.0,190.0,5,765,60002.0,464.0,248.0
0.096,6,10,1506,5,395,17.0,127.0,127.0,5,1111,23.0,843.0,843.0
0.009,6,10,1989,5,927,2.0,659.0,659.0,5,1062,2.0,794.0,794.0
0.004,17,2,144,1,64,0.0,36.0,36.0,1,80,0.0,52.0,52.0
0.006,6,10,1702,5,863,1.0,595.0,595.0,5,839,1.0,571.0,571.0
0.01,6,10,1631,5,848,2.0,580.0,580.0,5,783,2.0,515.0,515.0
10.981,17,28,4395,14,2312,836.0,587.0,137.0,14,2083,836.0,270.0,120.0
0.004,17,2,136,1,60,0.0,32.0,32.0,1,76,0.0,48.0,48.0
0.008,17,2,214,1,75,0.0,47.0,47.0,1,139,0.0,111.0,111.0
240.097,6,30,9295,15,6854,17149.0,1979.0,675.0,15,2441,17149.0,580.0,236.0
0.004,6,10,2007,5,928,1.0,660.0,660.0,5,1079,1.0,811.0,811.0
0.004,6,10,2006,5,927,1.0,659.0,659.0,5,1079,1.0,811.0,811.0
0.008,6,10,1677,5,827,2.0,559.0,559.0,5,850,1.0,582.0,582.0
0.005,6,10,2006,5,927,1.0,659.0,659.0,5,1079,1.0,811.0,811.0
0.02,6,10,1972,5,910,4.0,642.0,642.0,5,1062,5.0,794.0,794.0
0.211,6,16,2669,8,1395,30.0,533.0,323.0,8,1274,19.0,529.0,212.0
40.069,17,10,676,5,460,10016.0,104.0,64.0,5,216,10016.0,20.0,15.0
0.006,17,2,170,1,65,0.0,37.0,37.0,1,105,0.0,77.0,77.0
0.114,6,10,1506,5,395,23.0,127.0,127.0,5,1111,26.0,843.0,843.0
0.01,6,10,1989,5,910,2.0,642.0,642.0,5,1079,2.0,811.0,811.0
40.069,17,10,676,5,460,10015.0,104.0,64.0,5,216,10016.0,20.0,15.0
0.016,6,10,1983,5,910,4.0,642.0,642.0,5,1073,3.0,805.0,805.0
0.321,17,40,20686,21,17042,16.0,1350.0,783.0,19,3644,12.0,1350.0,163.0
0.038,17,2,148,1,60,0.0,32.0,32.0,1,88,0.0,60.0,60.0
0.008,6,10,1983,5,910,2.0,642.0,642.0,5,1073,2.0,805.0,805.0
0.006,6,10,1643,5,860,1.0,592.0,592.0,5,783,1.0,515.0,515.0
0.004,6,10,2007,5,928,1.0,660.0,660.0,5,1079,1.0,811.0,811.0
0.01,6,10,1989,5,910,2.0,642.0,642.0,5,1079,2.0,811.0,811.0
0.004,6,10,2006,5,927,1.0,659.0,659.0,5,1079,1.0,811.0,811.0
0.005,6,10,2006,5,927,1.0,659.0,659.0,5,1079,1.0,811.0,811.0
1772.332,6,105,6270,60,3525,30038.0,27.0,27.0,45,2745,40279.0,27.0,27.0
0.051,17,2,152,1,76,0.0,48.0,48.0,1,76,0.0,48.0,48.0
0.004,6,10,1779,5,928,1.0,660.0,660.0,5,851,1.0,583.0,583.0
0.07,6,10,1506,5,395,16.0,127.0,127.0,5,1111,13.0,843.0,843.0
0.004,17,4,284,2,120,0.0,32.0,32.0,2,164,0.0,60.0,54.0
0.004,6,10,2007,5,928,1.0,660.0,660.0,5,1079,1.0,811.0,811.0
5.331,58,2,144,1,72,0.0,24.0,24.0,1,72,0.0,24.0,24.0
0.012,6,10,1989,5,910,3.0,642.0,642.0,5,1079,2.0,811.0,811.0
0.001,17,2,166,1,75,0.0,47.0,47.0,1,91,0.0,63.0,63.0
0.004,6,10,2000,5,927,1.0,659.0,659.0,5,1073,1.0,805.0,805.0
0.005,6,10,2007,5,928,1.0,660.0,660.0,5,1079,1.0,811.0,811.0
0.005,6,10,1779,5,928,1.0,660.0,660.0,5,851,1.0,583.0,583.0
0.005,6,10,2006,5,927,1.0,659.0,659.0,5,1079,1.0,811.0,811.0
0.011,6,10,1990,5,911,2.0,643.0,643.0,5,1079,2.0,811.0,811.0
0.011,6,10,1983,5,910,2.0,642.0,642.0,5,1073,2.0,805.0,805.0
0.207,6,16,2669,8,1395,29.0,533.0,323.0,8,1274,18.0,529.0,212.0
0.006,6,10,1547,5,764,1.0,496.0,496.0,5,783,1.0,515.0,515.0
0.009,17,2,299,1,65,0.0,37.0,37.0,1,234,0.0,206.0,206.0
0.015,6,10,1989,5,910,3.0,642.0,642.0,5,1079,3.0,811.0,811.0
0.034,6,10,1989,5,910,8.0,642.0,642.0,5,1079,8.0,811.0,811.0
0.006,6,10,1689,5,839,1.0,571.0,571.0,5,850,1.0,582.0,582.0
0.006,6,10,1854,5,889,1.0,621.0,621.0,5,965,1.0,697.0,697.0
0.006,17,2,299,1,65,0.0,37.0,37.0,1,234,0.0,206.0,206.0
0.094,6,10,1506,5,395,21.0,127.0,127.0,5,1111,20.0,843.0,843.0
40.056,17,10,676,5,460,10013.0,104.0,64.0,5,216,10013.0,20.0,15.0
0.006,17,2,164,1,74,0.0,46.0,46.0,1,90,0.0,62.0,62.0
0.016,6,10,1631,5,848,4.0,580.0,580.0,5,783,4.0,515.0,515.0
0.152,6,10,1506,5,395,33.0,127.0,127.0,5,1111,29.0,843.0,843.0
0.013,6,12,1926,6,1189,2.0,659.0,434.0,6,737,2.0,417.0,417.0
0.069,6,10,1506,5,395,15.0,127.0,127.0,5,1111,16.0,843.0,843.0
0.008,6,10,1989,5,910,1.0,642.0,642.0,5,1079,2.0,811.0,811.0
0.007,6,10,1547,5,764,1.0,496.0,496.0,5,783,1.0,515.0,515.0
40.053,17,10,676,5,460,10012.0,104.0,64.0,5,216,10012.0,20.0,15.0
0.015,6,10,1990,5,911,3.0,643.0,643.0,5,1079,3.0,811.0,811.0
0.008,6,14,3787,7,497,1.0,125.0,125.0,7,3290,1.0,1448.0,972.0
0.001,17,2,180,1,66,0.0,38.0,38.0,1,114,0.0,86.0,86.0
0.006,17,2,208,1,72,0.0,44.0,44.0,1,136,0.0,108.0,108.0
0.087,6,10,1506,5,395,18.0,127.0,127.0,5,1111,20.0,843.0,843.0
0.083,6,10,1506,5,395,19.0,127.0,127.0,5,1111,15.0,843.0,843.0
0.088,6,10,1506,5,395,20.0,127.0,127.0,5,1111,21.0,843.0,843.0
0.009,6,10,1990,5,911,2.0,643.0,643.0,5,1079,2.0,811.0,811.0
0.006,6,14,3742,7,452,0.0,80.0,80.0,7,3290,0.0,1448.0,972.0
240.083,6,16,4481,9,963,30010.0,238.0,166.0,7,3518,40013.0,1402.0,786.0
0.005,6,10,2006,5,927,1.0,659.0,659.0,5,1079,1.0,811.0,811.0
0.072,6,10,1506,5,395,13.0,127.0,127.0,5,1111,15.0,843.0,843.0
0.013,6,10,1983,5,910,3.0,642.0,642.0,5,1073,3.0,805.0,805.0
0.007,17,2,179,1,71,0.0,43.0,43.0,1,108,0.0,80.0,80.0
0.087,6,10,1506,5,395,17.0,127.0,127.0,5,1111,20.0,843.0,843.0
40.085,17,10,676,5,460,10017.0,104.0,64.0,5,216,10020.0,20.0,15.0
0.008,6,12,1926,6,1189,1.0,659.0,434.0,6,737,1.0,417.0,417.0
0.013,6,10,1762,5,911,3.0,643.0,643.0,5,851,3.0,583.0,583.0
0.019,6,10,1972,5,910,4.0,642.0,642.0,5,1062,4.0,794.0,794.0
0.01,6,10,1972,5,910,2.0,642.0,642.0,5,1062,2.0,794.0,794.0
0.009,6,10,1989,5,910,2.0,642.0,642.0,5,1079,2.0,811.0,811.0
0.004,17,2,148,1,60,0.0,32.0,32.0,1,88,0.0,60.0,60.0
0.004,17,2,136,1,60,0.0,32.0,32.0,1,76,0.0,48.0,48.0
0.015,6,10,1631,5,848,3.0,580.0,580.0,5,783,3.0,515.0,515.0
0.072,17,2,182,1,65,0.0,37.0,37.0,1,117,0.0,89.0,89.0
40.09,17,10,676,5,460,10015.0,104.0,64.0,5,216,10021.0,20.0,15.0
0.086,17,4,352,2,130,44.0,37.0,37.0,2,222,44.0,89.0,83.0
0.118,6,10,1506,5,395,25.0,127.0,127.0,5,1111,24.0,843.0,843.0
0.011,6,10,1990,5,911,2.0,643.0,643.0,5,1079,2.0,811.0,811.0
0.09,6,10,1506,5,395,20.0,127.0,127.0,5,1111,20.0,843.0,843.0
0.005,6,10,1989,5,927,1.0,659.0,659.0,5,1062,1.0,794.0,794.0
0.016,6,10,1989,5,910,3.0,642.0,642.0,5,1079,3.0,811.0,811.0
0.004,17,2,136,1,60,0.0,32.0,32.0,1,76,0.0,48.0,48.0
0.128,6,10,1506,5,395,25.0,127.0,127.0,5,1111,30.0,843.0,843.0
0.02,6,10,1990,5,911,5.0,643.0,643.0,5,1079,4.0,811.0,811.0
0.006,6,10,2007,5,928,1.0,660.0,660.0,5,1079,1.0,811.0,811.0
0.011,6,10,1631,5,848,2.0,580.0,580.0,5,783,2.0,515.0,515.0
0.005,6,10,1689,5,839,1.0,571.0,571.0,5,850,1.0,582.0,582.0
0.004,17,2,148,1,60,0.0,32.0,32.0,1,88,0.0,60.0,60.0
0.005,6,10,1854,5,889,1.0,621.0,621.0,5,965,1.0,697.0,697.0
0.006,17,2,213,1,69,0.0,41.0,41.0,1,144,0.0,116.0,116.0
0.014,6,10,1631,5,848,3.0,580.0,580.0,5,783,3.0,515.0,515.0
0.013,6,10,1989,5,910,3.0,642.0,642.0,5,1079,3.0,811.0,811.0
0.006,17,2,166,1,75,0.0,47.0,47.0,1,91,0.0,63.0,63.0
0.007,6,10,1989,5,927,1.0,659.0,659.0,5,1062,1.0,794.0,794.0
10.882,17,28,4424,14,1995,828.0,270.0,114.0,14,2429,826.0,588.0,145.0
0.117,6,10,1506,5,395,24.0,127.0,127.0,5,1111,27.0,843.0,843.0
0.006,6,12,1698,6,863,1.0,327.0,271.0,6,835,1.0,515.0,515.0
0.006,6,10,1547,5,764,1.0,496.0,496.0,5,783,1.0,515.0,515.0
0.014,6,10,1989,5,910,3.0,642.0,642.0,5,1079,3.0,811.0,811.0
0.005,6,10,2007,5,928,1.0,660.0,660.0,5,1079,1.0,811.0,811.0
0.004,6,10,1989,5,927,1.0,659.0,659.0,5,1062,1.0,794.0,794.0
11.069,17,28,4399,14,2312,843.0,587.0,137.0,14,2087,843.0,270.0,121.0
0.004,17,2,148,1,60,0.0,32.0,32.0,1,88,0.0,60.0,60.0
0.005,6,10,1547,5,764,1.0,496.0,496.0,5,783,1.0,515.0,515.0
0.005,6,10,2007,5,928,1.0,660.0,660.0,5,1079,1.0,811.0,811.0
0.005,6,10,2000,5,927,1.0,659.0,659.0,5,1073,1.0,805.0,805.0
0.004,6,10,1779,5,928,1.0,660.0,660.0,5,851,1.0,583.0,583.0
0.011,6,10,1989,5,910,2.0,642.0,642.0,5,1079,2.0,811.0,811.0
0.097,6,10,1506,5,395,20.0,127.0,127.0,5,1111,22.0,843.0,843.0
0.005,17,2,170,1,65,0.0,37.0,37.0,1,105,0.0,77.0,77.0
0.099,6,10,1506,5,395,22.0,127.0,127.0,5,1111,20.0,843.0,843.0
0.005,17,2,213,1,69,0.0,41.0,41.0,1,144,0.0,116.0,116.0
0.08,6,10,1506,5,395,17.0,127.0,127.0,5,1111,16.0,843.0,843.0
0.076,6,10,1506,5,395,13.0,127.0,127.0,5,1111,18.0,843.0,843.0
351.994,6,20,2210,6,1308,12003.0,494.0,494.0,14,902,27076.0,83.0,83.0
0.005,6,10,2006,5,927,1.0,659.0,659.0,5,1079,1.0,811.0,811.0
0.012,6,10,1990,5,911,2.0,643.0,643.0,5,1079,2.0,811.0,811.0
0.005,6,10,1779,5,928,1.0,660.0,660.0,5,851,1.0,583.0,583.0
0.008,6,10,1989,5,910,2.0,642.0,642.0,5,1079,2.0,811.0,811.0
0.011,6,10,1972,5,910,2.0,642.0,642.0,5,1062,2.0,794.0,794.0
0.008,6,10,1989,5,910,1.0,642.0,642.0,5,1079,2.0,811.0,811.0
0.072,17,2,148,1,60,0.0,32.0,32.0,1,88,0.0,60.0,60.0
0.005,17,2,166,1,75,0.0,47.0,47.0,1,91,0.0,63.0,63.0
240.015,6,9,787,5,488,60003.0,232.0,232.0,4,299,80003.0,83.0,83.0
0.019,6,10,1989,5,910,4.0,642.0,642.0,5,1079,4.0,811.0,811.0
0.01,6,10,1990,5,911,2.0,643.0,643.0,5,1079,2.0,811.0,811.0
0.076,6,10,1506,5,395,18.0,127.0,127.0,5,1111,15.0,843.0,843.0
372.037,6,24,2405,17,919,23252.0,195.0,195.0,7,1486,3974.0,419.0,398.0
40.062,17,10,676,5,460,10014.0,104.0,64.0,5,216,10014.0,20.0,15.0
0.012,6,10,1972,5,910,3.0,642.0,642.0,5,1062,2.0,794.0,794.0
0.016,6,10,1989,5,910,3.0,642.0,642.0,5,1079,4.0,811.0,811.0
0.119,6,10,1506,5,395,27.0,127.0,127.0,5,1111,28.0,843.0,843.0
0.004,6,10,2007,5,928,1.0,660.0,660.0,5,1079,1.0,811.0,811.0
0.005,6,10,2006,5,927,1.0,659.0,659.0,5,1079,1.0,811.0,811.0
293.322,17,138,20111,69,4640,4313.0,44.0,39.0,69,15471,4313.0,239.0,196.0
0.131,17,4,284,2,120,0.0,32.0,32.0,2,164,127.0,60.0,54.0
0.004,17,2,136,1,60,0.0,32.0,32.0,1,76,0.0,48.0,48.0
0.012,6,10,1631,5,848,2.0,580.0,580.0,5,783,2.0,515.0,515.0
240.259,6,43,5375,22,2542,11440.0,588.0,196.0,21,2833,12012.0,580.0,216.0
0.005,6,10,1989,5,927,1.0,659.0,659.0,5,1062,1.0,794.0,794.0
0.001,17,2,166,1,75,0.0,47.0,47.0,1,91,0.0,63.0,63.0
0.014,6,10,1677,5,827,3.0,559.0,559.0,5,850,3.0,582.0,582.0
0.013,6,10,1983,5,910,3.0,642.0,642.0,5,1073,3.0,805.0,805.0
0.01,17,2,166,1,75,0.0,47.0,47.0,1,91,0.0,63.0,63.0
0.011,6,10,1677,5,827,2.0,559.0,559.0,5,850,2.0,582.0,582.0
40.055,17,10,676,5,460,10012.0,104.0,64.0,5,216,10013.0,20.0,15.0
0.003,17,2,136,1,60,0.0,32.0,32.0,1,76,0.0,48.0,48.0
0.004,6,10,2006,5,927,1.0,659.0,659.0,5,1079,1.0,811.0,811.0
0.013,6,10,1762,5,911,3.0,643.0,643.0,5,851,3.0,583.0,583.0
293.927,6,321,344864,121,17839,2449.0,2736.0,888.0,200,327025,1477.0,4136.0,1702.0
0.013,17,2,152,1,56,0.0,28.0,28.0,1,96,0.0,68.0,68.0
10.768,17,28,4422,14,1993,820.0,268.0,114.0,14,2429,820.0,588.0,145.0
300.34,6,16,2170,9,684,37521.0,146.0,146.0,7,1486,50027.0,419.0,398.0
0.015,6,10,1972,5,910,3.0,642.0,642.0,5,1062,3.0,794.0,794.0
0.051,6,10,1506,5,395,12.0,127.0,127.0,5,1111,11.0,843.0,843.0
169.041,17,78,11231,39,2602,4448.0,44.0,38.0,39,8629,4448.0,261.0,193.0
0.008,6,10,1762,5,911,2.0,643.0,643.0,5,851,2.0,583.0,583.0
0.006,6,10,1547,5,764,1.0,496.0,496.0,5,783,1.0,515.0,515.0
0.007,6,10,1762,5,911,1.0,643.0,643.0,5,851,1.0,583.0,583.0
0.081,6,10,1506,5,395,18.0,127.0,127.0,5,1111,18.0,843.0,843.0
0.013,6,10,1762,5,911,3.0,643.0,643.0,5,851,3.0,583.0,583.0
0.005,6,10,2000,5,927,1.0,659.0,659.0,5,1073,1.0,805.0,805.0
0.071,17,2,152,1,76,0.0,48.0,48.0,1,76,0.0,48.0,48.0
0.013,6,10,1989,5,910,3.0,642.0,642.0,5,1079,3.0,811.0,811.0
0.072,6,10,1506,5,395,14.0,127.0,127.0,5,1111,17.0,843.0,843.0
0.008,17,2,194,1,59,0.0,31.0,31.0,1,135,0.0,107.0,107.0
0.003,17,4,284,2,120,0.0,32.0,32.0,2,164,0.0,60.0,54.0
0.04,17,2,136,1,60,0.0,32.0,32.0,1,76,0.0,48.0,48.0
0.01,6,10,1972,5,910,2.0,642.0,642.0,5,1062,2.0,794.0,794.0
0.104,6,10,1506,5,395,24.0,127.0,127.0,5,1111,24.0,843.0,843.0
0.02,6,13,3735,7,497,3.0,125.0,125.0,6,3238,3.0,1470.0,1459.0
0.11,6,10,1506,5,395,26.0,127.0,127.0,5,1111,22.0,843.0,843.0
0.004,6,10,2007,5,928,1.0,660.0,660.0,5,1079,1.0,811.0,811.0
0.001,17,2,166,1,75,0.0,47.0,47.0,1,91,0.0,63.0,63.0
0.009,6,12,1926,6,1189,1.0,659.0,434.0,6,737,1.0,417.0,417.0
0.021,6,10,1990,5,911,5.0,643.0,643.0,5,1079,5.0,811.0,811.0
0.005,6,14,3799,7,509,0.0,137.0,137.0,7,3290,0.0,1448.0,972.0
0.069,6,10,1506,5,395,16.0,127.0,127.0,5,1111,14.0,843.0,843.0
0.011,6,10,1762,5,911,2.0,643.0,643.0,5,851,2.0,583.0,583.0
0.005,6,10,2007,5,928,1.0,660.0,660.0,5,1079,1.0,811.0,811.0
0.001,17,2,180,1,66,0.0,38.0,38.0,1,114,0.0,86.0,86.0
0.077,6,10,1506,5,395,17.0,127.0,127.0,5,1111,17.0,843.0,843.0
0.001,17,2,180,1,66,0.0,38.0,38.0,1,114,0.0,86.0,86.0
0.005,6,10,1989,5,927,1.0,659.0,659.0,5,1062,1.0,794.0,794.0
0.217,17,4,596,2,122,146.0,33.0,33.0,2,474,176.0,323.0,209.0
308.509,17,20,1124,10,716,34264.0,48.0,43.0,10,408,34264.0,20.0,12.0
0.067,6,10,1506,5,395,15.0,127.0,127.0,5,1111,13.0,843.0,843.0
0.064,6,10,1506,5,395,13.0,127.0,127.0,5,1111,15.0,843.0,843.0
0.089,6,10,1506,5,395,20.0,127.0,127.0,5,1111,17.0,843.0,843.0
0.014,6,10,1983,5,910,3.0,642.0,642.0,5,1073,3.0,805.0,805.0
0.054,17,2,152,1,76,0.0,48.0,48.0,1,76,0.0,48.0,48.0
0.071,17,2,182,1,65,0.0,37.0,37.0,1,117,0.0,89.0,89.0
0.063,6,10,1506,5,395,14.0,127.0,127.0,5,1111,14.0,843.0,843.0
0.039,17,2,148,1,60,0.0,32.0,32.0,1,88,0.0,60.0,60.0
0.137,17,2,80,1,32,0.0,4.0,4.0,1,48,0.0,20.0,20.0
11.298,17,28,4417,14,1994,856.0,269.0,114.0,14,2423,854.0,586.0,145.0
0.005,6,10,1989,5,927,1.0,659.0,659.0,5,1062,1.0,794.0,794.0
0.009,6,10,1972,5,910,2.0,642.0,642.0,5,1062,2.0,794.0,794.0
0.005,6,10,2006,5,927,1.0,659.0,659.0,5,1079,1.0,811.0,811.0
0.004,17,4,284,2,120,1.0,32.0,32.0,2,164,0.0,60.0,54.0
40.073,17,10,676,5,460,10017.0,104.0,64.0,5,216,10017.0,20.0,15.0
40.061,17,10,676,5,460,10013.0,104.0,64.0,5,216,10014.0,20.0,15.0
0.006,6,10,1689,5,839,1.0,571.0,571.0,5,850,1.0,582.0,582.0
294.574,6,320,344784,117,17638,2539.0,2736.0,825.0,203,327146,1458.0,2882.0,1675.0
0.017,6,10,1631,5,848,4.0,580.0,580.0,5,783,4.0,515.0,515.0
0.007,6,10,2006,5,927,1.0,659.0,659.0,5,1079,1.0,811.0,811.0
0.004,17,4,284,2,120,0.0,32.0,32.0,2,164,0.0,60.0,54.0
0.071,6,10,1506,5,395,16.0,127.0,127.0,5,1111,16.0,843.0,843.0
0.006,6,10,1643,5,860,1.0,592.0,592.0,5,783,1.0,515.0,515.0
0.079,6,10,1506,5,395,17.0,127.0,127.0,5,1111,17.0,843.0,843.0
40.079,17,10,676,5,460,10016.0,104.0,64.0,5,216,10019.0,20.0,15.0
0.012,6,10,1983,5,910,3.0,642.0,642.0,5,1073,3.0,805.0,805.0
0.014,6,10,1989,5,910,3.0,642.0,642.0,5,1079,3.0,811.0,811.0
0.012,6,13,3735,7,497,2.0,125.0,125.0,6,3238,2.0,1470.0,1459.0
0.005,6,10,2006,5,927,1.0,659.0,659.0,5,1079,1.0,811.0,811.0
0.012,6,10,1972,5,910,3.0,642.0,642.0,5,1062,3.0,794.0,794.0
0.011,6,10,1990,5,911,2.0,643.0,643.0,5,1079,2.0,811.0,811.0
0.12,6,10,1506,5,395,28.0,127.0,127.0,5,1111,26.0,843.0,843.0
0.082,6,10,1506,5,395,17.0,127.0,127.0,5,1111,19.0,843.0,843.0
0.005,6,10,2000,5,927,1.0,659.0,659.0,5,1073,1.0,805.0,805.0
0.004,6,10,2006,5,927,1.0,659.0,659.0,5,1079,1.0,811.0,811.0
0.01,6,10,1990,5,911,2.0,643.0,643.0,5,1079,2.0,811.0,811.0
361.794,6,21,1792,16,1030,24119.0,190.0,190.0,5,762,60011.0,461.0,247.0
66.339,6,36,8318,18,1847,510.0,739.0,365.0,18,6471,3894.0,2720.0,478.0
0.004,6,10,2000,5,927,1.0,659.0,659.0,5,1073,1.0,805.0,805.0
0.005,6,10,2006,5,927,1.0,659.0,659.0,5,1079,1.0,811.0,811.0
0.006,6,10,1547,5,764,1.0,496.0,496.0,5,783,1.0,515.0,515.0
0.085,6,10,1506,5,395,15.0,127.0,127.0,5,1111,18.0,843.0,843.0
0.005,6,10,1989,5,927,1.0,659.0,659.0,5,1062,1.0,794.0,794.0
0.007,6,10,2006,5,927,1.0,659.0,659.0,5,1079,1.0,811.0,811.0
0.006,6,10,1989,5,927,1.0,659.0,659.0,5,1062,1.0,794.0,794.0
0.014,6,10,1972,5,910,3.0,642.0,642.0,5,1062,3.0,794.0,794.0
0.006,6,10,1854,5,889,1.0,621.0,621.0,5,965,1.0,697.0,697.0
0.132,6,10,1506,5,395,28.0,127.0,127.0,5,1111,29.0,843.0,843.0
0.006,17,2,214,1,75,0.0,47.0,47.0,1,139,0.0,111.0,111.0
0.007,6,10,1989,5,927,1.0,659.0,659.0,5,1062,1.0,794.0,794.0
240.093,6,16,4481,9,963,30011.0,238.0,166.0,7,3518,40015.0,1402.0,786.0
0.008,6,10,1689,5,839,1.0,571.0,571.0,5,850,2.0,582.0,582.0
0.004,6,10,1989,5,927,1.0,659.0,659.0,5,1062,1.0,794.0,794.0
0.009,6,13,3735,7,497,1.0,125.0,125.0,6,3238,1.0,1470.0,1459.0
0.008,17,2,162,1,65,0.0,37.0,37.0,1,97,0.0,69.0,69.0
0.001,17,2,180,1,66,0.0,38.0,38.0,1,114,0.0,86.0,86.0
0.006,6,10,1643,5,860,1.0,592.0,592.0,5,783,1.0,515.0,515.0
0.017,6,10,1972,5,910,4.0,642.0,642.0,5,1062,4.0,794.0,794.0
0.015,6,10,1677,5,827,3.0,559.0,559.0,5,850,3.0,582.0,582.0
0.005,17,2,230,1,68,0.0,40.0,40.0,1,162,0.0,134.0,134.0
0.01,6,10,1983,5,910,2.0,642.0,642.0,5,1073,2.0,805.0,805.0
0.174,17,2,152,1,76,0.0,48.0,48.0,1,76,0.0,48.0,48.0
0.005,6,10,1989,5,927,1.0,659.0,659.0,5,1062,1.0,794.0,794.0
0.004,6,10,2007,5,928,1.0,660.0,660.0,5,1079,1.0,811.0,811.0
0.005,17,2,180,1,66,0.0,38.0,38.0,1,114,0.0,86.0,86.0
0.004,17,2,132,1,58,0.0,30.0,30.0,1,74,0.0,46.0,46.0
0.094,6,10,1506,5,395,20.0,127.0,127.0,5,1111,21.0,843.0,843.0
0.014,6,10,1677,5,827,3.0,559.0,559.0,5,850,3.0,582.0,582.0
0.009,6,10,1990,5,911,2.0,643.0,643.0,5,1079,2.0,811.0,811.0
0.008,6,12,1926,6,1189,1.0,659.0,434.0,6,737,1.0,417.0,417.0
0.009,6,10,1989,5,910,2.0,642.0,642.0,5,1079,2.0,811.0,811.0
0.015,6,10,1990,5,911,3.0,643.0,643.0,5,1079,3.0,811.0,811.0
0.004,17,2,154,1,69,0.0,41.0,41.0,1,85,0.0,57.0,57.0
0.01,6,10,1677,5,827,2.0,559.0,559.0,5,850,2.0,582.0,582.0
0.001,17,2,180,1,66,0.0,38.0,38.0,1,114,0.0,86.0,86.0
0.084,6,10,1506,5,395,18.0,127.0,127.0,5,1111,16.0,843.0,843.0
0.014,6,10,1989,5,910,3.0,642.0,642.0,5,1079,3.0,811.0,811.0
0.015,6,10,1989,5,910,3.0,642.0,642.0,5,1079,3.0,811.0,811.0
0.014,6,10,1677,5,827,3.0,559.0,559.0,5,850,3.0,582.0,582.0
0.005,6,10,2006,5,927,1.0,659.0,659.0,5,1079,1.0,811.0,811.0
11.067,17,28,4397,14,2311,842.0,586.0,137.0,14,2086,842.0,269.0,121.0
0.006,6,10,1547,5,764,1.0,496.0,496.0,5,783,1.0,515.0,515.0
0.009,6,10,1989,5,910,2.0,642.0,642.0,5,1079,2.0,811.0,811.0
0.102,6,10,1506,5,395,21.0,127.0,127.0,5,1111,23.0,843.0,843.0
0.121,6,10,1506,5,395,27.0,127.0,127.0,5,1111,28.0,843.0,843.0
0.101,6,10,1506,5,395,23.0,127.0,127.0,5,1111,24.0,843.0,843.0
242.038,6,374,351320,177,20729,1375.0,2690.0,959.0,197,330591,1234.0,3320.0,1713.0
0.004,6,10,2007,5,928,1.0,660.0,660.0,5,1079,1.0,811.0,811.0
0.016,17,2,198,1,91,0.0,63.0,63.0,1,107,0.0,79.0,79.0
0.001,17,2,180,1,66,0.0,38.0,38.0,1,114,0.0,86.0,86.0
0.007,17,2,179,1,71,0.0,43.0,43.0,1,108,0.0,80.0,80.0
0.006,6,10,1547,5,764,1.0,496.0,496.0,5,783,1.0,515.0,515.0
0.097,6,10,1506,5,395,21.0,127.0,127.0,5,1111,20.0,843.0,843.0
27.036,6,47,18629,24,12682,399.0,2720.0,1298.0,23,5947,1221.0,2667.0,385.0
0.008,17,2,194,1,59,0.0,31.0,31.0,1,135,0.0,107.0,107.0
0.061,6,10,1506,5,395,13.0,127.0,127.0,5,1111,13.0,843.0,843.0
0.004,6,10,1989,5,927,1.0,659.0,659.0,5,1062,1.0,794.0,794.0
9.036,17,6,376,5,280,2259.0,28.0,28.0,1,96,0.0,68.0,68.0
0.121,6,10,1506,5,395,28.0,127.0,127.0,5,1111,27.0,843.0,843.0
0.04,17,2,152,1,76,0.0,48.0,48.0,1,76,0.0,48.0,48.0
5.089,6,21,5923,12,1436,462.0,474.0,201.0,9,4487,635.0,1925.0,804.0
0.004,17,2,136,1,60,0.0,32.0,32.0,1,76,0.0,48.0,48.0
0.02,6,10,1972,5,910,5.0,642.0,642.0,5,1062,4.0,794.0,794.0
0.001,17,2,166,1,75,0.0,47.0,47.0,1,91,0.0,63.0,63.0
0.001,17,2,180,1,66,0.0,38.0,38.0,1,114,0.0,86.0,86.0
0.007,6,10,1990,5,911,1.0,643.0,643.0,5,1079,1.0,811.0,811.0
1756.741,6,462,67712,260,35742,6782.0,613.0,194.0,202,31970,8739.0,453.0,147.0
0.016,6,10,1972,5,910,4.0,642.0,642.0,5,1062,3.0,794.0,794.0
10.779,17,28,4420,14,1995,821.0,270.0,114.0,14,2425,821.0,588.0,145.0
0.005,6,14,3742,7,452,0.0,80.0,80.0,7,3290,0.0,1448.0,972.0
0.006,6,10,1854,5,889,1.0,621.0,621.0,5,965,1.0,697.0,697.0
0.004,6,10,1779,5,928,1.0,660.0,660.0,5,851,1.0,583.0,583.0
0.019,6,10,1677,5,827,4.0,559.0,559.0,5,850,4.0,582.0,582.0
0.006,17,2,230,1,68,0.0,40.0,40.0,1,162,0.0,134.0,134.0
0.001,17,2,136,1,60,0.0,32.0,32.0,1,76,0.0,48.0,48.0
0.168,17,2,152,1,76,0.0,48.0,48.0,1,76,0.0,48.0,48.0
0.01,6,10,1989,5,910,2.0,642.0,642.0,5,1079,2.0,811.0,811.0
0.037,17,2,170,1,65,0.0,37.0,37.0,1,105,0.0,77.0,77.0
0.005,6,10,1689,5,839,1.0,571.0,571.0,5,850,1.0,582.0,582.0
0.091,6,10,1506,5,395,19.0,127.0,127.0,5,1111,20.0,843.0,843.0
0.073,6,10,1506,5,395,16.0,127.0,127.0,5,1111,15.0,843.0,843.0
0.021,6,10,1989,5,910,5.0,642.0,642.0,5,1079,5.0,811.0,811.0
0.004,6,10,2006,5,927,1.0,659.0,659.0,5,1079,1.0,811.0,811.0
54.425,6,38,9863,19,4305,497.0,1360.0,700.0,19,5558,3014.0,2720.0,435.0
0.011,6,10,1989,5,910,2.0,642.0,642.0,5,1079,2.0,811.0,811.0
0.006,6,10,1547,5,764,1.0,496.0,496.0,5,783,1.0,515.0,515.0
0.08,6,10,1506,5,395,19.0,127.0,127.0,5,1111,16.0,843.0,843.0
0.015,6,10,1972,5,910,3.0,642.0,642.0,5,1062,3.0,794.0,794.0
0.008,6,10,1547,5,764,2.0,496.0,496.0,5,783,1.0,515.0,515.0
0.005,17,2,180,1,66,0.0,38.0,38.0,1,114,0.0,86.0,86.0
0.012,6,10,1983,5,910,2.0,642.0,642.0,5,1073,3.0,805.0,805.0
0.005,6,10,2007,5,928,1.0,660.0,660.0,5,1079,1.0,811.0,811.0
0.009,6,10,1990,5,911,2.0,643.0,643.0,5,1079,2.0,811.0,811.0
0.079,6,10,1506,5,395,17.0,127.0,127.0,5,1111,17.0,843.0,843.0
0.005,6,10,1989,5,927,1.0,659.0,659.0,5,1062,1.0,794.0,794.0
0.023,6,10,1989,5,910,5.0,642.0,642.0,5,1079,5.0,811.0,811.0
0.02,6,10,1677,5,827,5.0,559.0,559.0,5,850,4.0,582.0,582.0
0.004,6,10,2006,5,927,1.0,659.0,659.0,5,1079,1.0,811.0,811.0
0.095,6,10,1506,5,395,19.0,127.0,127.0,5,1111,20.0,843.0,843.0
0.006,17,2,293,1,73,0.0,45.0,45.0,1,220,0.0,192.0,192.0
0.039,17,2,148,1,60,0.0,32.0,32.0,1,88,0.0,60.0,60.0
0.004,17,2,136,1,60,0.0,32.0,32.0,1,76,0.0,48.0,48.0
0.006,6,10,1547,5,764,1.0,496.0,496.0,5,783,1.0,515.0,515.0
40.069,17,10,676,5,460,10016.0,104.0,64.0,5,216,10016.0,20.0,15.0
242.582,6,394,347761,208,22329,1171.0,2736.0,885.0,186,325432,1311.0,2769.0,1794.0
0.015,6,10,1631,5,848,3.0,580.0,580.0,5,783,3.0,515.0,515.0
0.041,17,2,152,1,76,0.0,48.0,48.0,1,76,0.0,48.0,48.0
0.006,6,10,1547,5,764,1.0,496.0,496.0,5,783,1.0,515.0,515.0
0.005,6,13,3747,7,509,0.0,137.0,137.0,6,3238,1.0,1470.0,1459.0
0.005,6,10,1689,5,839,1.0,571.0,571.0,5,850,1.0,582.0,582.0
0.39,17,17,10023,8,6917,55.0,1350.0,836.0,9,3106,37.0,1350.0,317.0
10.909,17,28,4419,14,1995,830.0,270.0,114.0,14,2424,830.0,587.0,145.0
0.001,17,2,140,1,62,0.0,34.0,34.0,1,78,0.0,50.0,50.0
0.133,6,10,1506,5,395,31.0,127.0,127.0,5,1111,27.0,843.0,843.0
0.007,6,10,1989,5,910,1.0,642.0,642.0,5,1079,1.0,811.0,811.0
0.004,6,10,2006,5,927,1.0,659.0,659.0,5,1079,1.0,811.0,811.0
0.009,6,10,1989,5,910,2.0,642.0,642.0,5,1079,2.0,811.0,811.0
0.004,6,10,1702,5,863,1.0,595.0,595.0,5,839,1.0,571.0,571.0
0.003,17,4,284,2,120,0.0,32.0,32.0,2,164,0.0,60.0,54.0
0.106,6,10,1506,5,395,21.0,127.0,127.0,5,1111,19.0,843.0,843.0
0.131,6,10,1506,5,395,28.0,127.0,127.0,5,1111,23.0,843.0,843.0
1756.227,6,105,6240,60,3510,29765.0,26.0,26.0,45,2730,39913.0,26.0,26.0
0.008,6,12,1926,6,1189,1.0,659.0,434.0,6,737,1.0,417.0,417.0
40.057,17,10,676,5,460,10013.0,104.0,64.0,5,216,10013.0,20.0,15.0
0.005,17,2,214,1,75,0.0,47.0,47.0,1,139,0.0,111.0,111.0
0.005,17,2,164,1,74,0.0,46.0,46.0,1,90,0.0,62.0,62.0
0.097,6,10,1506,5,395,21.0,127.0,127.0,5,1111,23.0,843.0,843.0
0.004,6,10,2000,5,927,1.0,659.0,659.0,5,1073,1.0,805.0,805.0
0.1,6,10,1506,5,395,24.0,127.0,127.0,5,1111,22.0,843.0,843.0
83.799,6,24,9399,11,1575,70.0,794.0,367.0,13,7824,6972.0,1360.0,810.0
0.132,6,10,1506,5,395,31.0,127.0,127.0,5,1111,27.0,843.0,843.0
0.007,6,10,2000,5,927,1.0,659.0,659.0,5,1073,1.0,805.0,805.0
0.011,6,13,3735,7,497,1.0,125.0,125.0,6,3238,2.0,1470.0,1459.0
0.005,17,2,166,1,75,0.0,47.0,47.0,1,91,0.0,63.0,63.0
0.008,6,10,1983,5,910,2.0,642.0,642.0,5,1073,1.0,805.0,805.0
0.009,6,10,1972,5,910,2.0,642.0,642.0,5,1062,2.0,794.0,794.0
308.467,17,20,1124,10,716,34259.0,48.0,43.0,10,408,34259.0,20.0,12.0
175.293,17,76,10733,38,2536,4737.0,44.0,38.0,38,8197,4737.0,252.0,187.0
0.086,6,10,1506,5,395,16.0,127.0,127.0,5,1111,18.0,843.0,843.0
0.001,17,2,180,1,66,0.0,38.0,38.0,1,114,0.0,86.0,86.0
0.004,6,10,1702,5,863,1.0,595.0,595.0,5,839,1.0,571.0,571.0
0.014,6,10,1990,5,911,3.0,643.0,643.0,5,1079,3.0,811.0,811.0
0.013,6,10,1990,5,911,3.0,643.0,643.0,5,1079,3.0,811.0,811.0
0.005,6,10,2000,5,927,1.0,659.0,659.0,5,1073,1.0,805.0,805.0
0.005,6,10,1547,5,764,1.0,496.0,496.0,5,783,1.0,515.0,515.0
300.357,6,27,7434,16,1409,20023.0,217.0,142.0,11,6025,24031.0,1679.0,777.0
0.156,6,10,1506,5,395,35.0,127.0,127.0,5,1111,28.0,843.0,843.0
0.004,17,4,284,2,120,1.0,32.0,32.0,2,164,0.0,60.0,54.0
9.036,17,6,376,5,280,2259.0,28.0,28.0,1,96,0.0,68.0,68.0
0.009,6,10,1762,5,911,2.0,643.0,643.0,5,851,2.0,583.0,583.0
0.008,6,12,1926,6,1189,1.0,659.0,434.0,6,737,1.0,417.0,417.0
0.009,6,10,1990,5,911,2.0,643.0,643.0,5,1079,2.0,811.0,811.0
0.007,6,10,1854,5,889,1.0,621.0,621.0,5,965,1.0,697.0,697.0
0.113,6,10,1506,5,395,22.0,127.0,127.0,5,1111,24.0,843.0,843.0
0.001,17,2,180,1,66,0.0,38.0,38.0,1,114,0.0,86.0,86.0
0.005,6,10,1989,5,927,1.0,659.0,659.0,5,1062,1.0,794.0,794.0
0.006,6,10,2006,5,927,1.0,659.0,659.0,5,1079,1.0,811.0,811.0
0.006,6,14,3799,7,509,1.0,137.0,137.0,7,3290,0.0,1448.0,972.0
0.04,17,4,352,2,130,1.0,37.0,37.0,2,222,1.0,89.0,83.0
0.005,17,2,166,1,75,0.0,47.0,47.0,1,91,0.0,63.0,63.0
0.008,6,10,1972,5,910,1.0,642.0,642.0,5,1062,1.0,794.0,794.0
0.018,6,10,1989,5,910,4.0,642.0,642.0,5,1079,4.0,811.0,811.0
0.001,17,2,180,1,66,0.0,38.0,38.0,1,114,0.0,86.0,86.0
0.005,6,10,2000,5,927,1.0,659.0,659.0,5,1073,1.0,805.0,805.0
0.069,6,10,1506,5,395,14.0,127.0,127.0,5,1111,15.0,843.0,843.0
0.015,6,10,1989,5,910,3.0,642.0,642.0,5,1079,3.0,811.0,811.0
0.011,6,10,1972,5,910,2.0,642.0,642.0,5,1062,2.0,794.0,794.0
0.164,17,2,152,1,76,0.0,48.0,48.0,1,76,0.0,48.0,48.0
0.009,6,10,1983,5,910,2.0,642.0,642.0,5,1073,2.0,805.0,805.0
0.001,17,2,180,1,66,0.0,38.0,38.0,1,114,0.0,86.0,86.0
0.009,6,10,1631,5,848,2.0,580.0,580.0,5,783,2.0,515.0,515.0
0.016,6,11,2041,6,962,3.0,642.0,642.0,5,1079,3.0,811.0,811.0
0.133,6,10,1506,5,395,30.0,127.0,127.0,5,1111,30.0,843.0,843.0
40.075,17,10,676,5,460,10018.0,104.0,64.0,5,216,10018.0,20.0,15.0
0.087,6,10,1506,5,395,16.0,127.0,127.0,5,1111,18.0,843.0,843.0
40.079,17,10,676,5,460,10019.0,104.0,64.0,5,216,10018.0,20.0,15.0
15.092,17,17,9307,9,7197,1882.0,1350.0,771.0,8,2110,2151.0,1350.0,235.0
240.269,6,43,8771,21,5686,12013.0,1515.0,509.0,22,3085,11441.0,580.0,241.0
0.029,17,2,179,1,71,0.0,43.0,43.0,1,108,0.0,80.0,80.0
40.066,17,10,676,5,460,10013.0,104.0,64.0,5,216,10015.0,20.0,15.0
0.004,6,10,1702,5,863,1.0,595.0,595.0,5,839,1.0,571.0,571.0
0.094,6,10,1506,5,395,20.0,127.0,127.0,5,1111,19.0,843.0,843.0
0.017,6,13,3735,7,497,2.0,125.0,125.0,6,3238,3.0,1470.0,1459.0
10.922,17,28,4422,14,1994,831.0,269.0,114.0,14,2428,831.0,587.0,145.0
0.083,6,10,1506,5,395,17.0,127.0,127.0,5,1111,18.0,843.0,843.0
0.013,6,10,1989,5,910,3.0,642.0,642.0,5,1079,3.0,811.0,811.0
167.16,17,78,11037,39,2601,4398.0,44.0,38.0,39,8436,4398.0,239.0,188.0
0.005,6,10,2007,5,928,1.0,660.0,660.0,5,1079,1.0,811.0,811.0
0.005,6,10,1702,5,863,1.0,595.0,595.0,5,839,1.0,571.0,571.0
0.091,6,10,1506,5,395,17.0,127.0,127.0,5,1111,21.0,843.0,843.0
0.065,6,10,1506,5,395,13.0,127.0,127.0,5,1111,15.0,843.0,843.0
354.056,6,21,1795,16,1030,23603.0,190.0,190.0,5,765,60001.0,464.0,248.0
0.006,6,10,1547,5,764,1.0,496.0,496.0,5,783,1.0,515.0,515.0
0.012,6,10,1972,5,910,2.0,642.0,642.0,5,1062,2.0,794.0,794.0
0.06,17,2,152,1,76,0.0,48.0,48.0,1,76,0.0,48.0,48.0
1778.42,17,144,41760,72,22752,25048.0,288.0,288.0,72,19008,25048.0,236.0,236.0
0.005,6,10,1779,5,928,1.0,660.0,660.0,5,851,1.0,583.0,583.0
0.09,6,10,1506,5,395,19.0,127.0,127.0,5,1111,21.0,843.0,843.0
0.114,6,10,1506,5,395,26.0,127.0,127.0,5,1111,24.0,843.0,843.0
0.015,6,10,1990,5,911,3.0,643.0,643.0,5,1079,3.0,811.0,811.0
0.006,6,10,1547,5,764,1.0,496.0,496.0,5,783,1.0,515.0,515.0
0.095,6,10,1506,5,395,20.0,127.0,127.0,5,1111,20.0,843.0,843.0
40.072,17,10,676,5,460,10015.0,104.0,64.0,5,216,10011.0,20.0,15.0
0.004,6,10,1779,5,928,1.0,660.0,660.0,5,851,0.0,583.0,583.0
0.005,6,10,1547,5,764,1.0,496.0,496.0,5,783,1.0,515.0,515.0
378.756,6,22,2313,16,867,25250.0,195.0,195.0,6,1446,4650.0,419.0,398.0
0.007,17,2,299,1,65,0.0,37.0,37.0,1,234,0.0,206.0,206.0
0.025,6,10,1631,5,848,6.0,580.0,580.0,5,783,6.0,515.0,515.0
0.009,6,10,1983,5,910,2.0,642.0,642.0,5,1073,2.0,805.0,805.0
0.006,17,2,166,1,75,0.0,47.0,47.0,1,91,0.0,63.0,63.0
11.089,17,28,4389,14,2311,844.0,586.0,137.0,14,2078,844.0,269.0,120.0
0.006,17,2,136,1,60,0.0,32.0,32.0,1,76,0.0,48.0,48.0
0.012,6,12,1926,6,1189,2.0,659.0,434.0,6,737,2.0,417.0,417.0
0.004,17,4,284,2,120,0.0,32.0,32.0,2,164,1.0,60.0,54.0
0.05,17,2,184,1,61,0.0,33.0,33.0,1,123,0.0,95.0,95.0
0.175,6,10,1990,5,911,43.0,643.0,643.0,5,1079,43.0,811.0,811.0
0.016,6,14,3787,7,497,2.0,125.0,125.0,7,3290,2.0,1448.0,972.0
40.063,17,10,676,5,460,10013.0,104.0,64.0,5,216,10011.0,20.0,15.0
0.039,17,2,148,1,60,0.0,32.0,32.0,1,88,0.0,60.0,60.0
0.007,6,10,1990,5,911,1.0,643.0,643.0,5,1079,1.0,811.0,811.0
40.067,17,10,676,5,460,10015.0,104.0,64.0,5,216,10016.0,20.0,15.0
0.005,6,10,1779,5,928,1.0,660.0,660.0,5,851,1.0,583.0,583.0
0.006,17,2,144,1,64,0.0,36.0,36.0,1,80,0.0,52.0,52.0
0.008,6,12,1926,6,1189,1.0,659.0,434.0,6,737,1.0,417.0,417.0
354.019,6,21,1795,16,1030,23601.0,190.0,190.0,5,765,60001.0,464.0,248.0
0.001,17,2,180,1,66,0.0,38.0,38.0,1,114,0.0,86.0,86.0
0.059,6,10,1506,5,395,14.0,127.0,127.0,5,1111,12.0,843.0,843.0
0.076,6,10,1506,5,395,16.0,127.0,127.0,5,1111,17.0,843.0,843.0
0.017,6,13,3747,7,509,2.0,137.0,137.0,6,3238,3.0,1470.0,1459.0
0.005,6,10,1689,5,839,1.0,571.0,571.0,5,850,1.0,582.0,582.0
0.016,6,10,1983,5,910,3.0,642.0,642.0,5,1073,4.0,805.0,805.0
0.015,6,10,1983,5,910,3.0,642.0,642.0,5,1073,3.0,805.0,805.0
1730.781,6,50,3084,32,1875,55830.0,35.0,35.0,18,1209,101806.0,31.0,31.0
0.006,17,2,179,1,71,0.0,43.0,43.0,1,108,0.0,80.0,80.0
0.01,6,10,1983,5,910,2.0,642.0,642.0,5,1073,2.0,805.0,805.0
0.006,6,10,1547,5,764,1.0,496.0,496.0,5,783,1.0,515.0,515.0
0.007,6,10,2006,5,927,1.0,659.0,659.0,5,1079,1.0,811.0,811.0
0.013,6,13,3735,7,497,2.0,125.0,125.0,6,3238,2.0,1470.0,1459.0
369.985,6,22,2313,16,867,24665.0,195.0,195.0,6,1446,4635.0,419.0,398.0
0.012,6,14,3787,7,497,1.0,125.0,125.0,7,3290,1.0,1448.0,972.0
0.093,6,10,1506,5,395,19.0,127.0,127.0,5,1111,21.0,843.0,843.0
0.005,6,10,1689,5,839,1.0,571.0,571.0,5,850,1.0,582.0,582.0
0.01,6,10,1631,5,848,2.0,580.0,580.0,5,783,2.0,515.0,515.0
0.005,6,10,1989,5,927,1.0,659.0,659.0,5,1062,1.0,794.0,794.0
0.066,17,8,3613,4,1874,22.0,1350.0,440.0,4,1739,11.0,1350.0,406.0
0.014,6,10,1983,5,910,3.0,642.0,642.0,5,1073,3.0,805.0,805.0
0.099,6,10,1506,5,395,20.0,127.0,127.0,5,1111,22.0,843.0,843.0
0.005,6,10,1774,5,923,1.0,655.0,655.0,5,851,1.0,583.0,583.0
0.014,6,10,1989,5,910,3.0,642.0,642.0,5,1079,3.0,811.0,811.0
0.004,6,10,2006,5,927,1.0,659.0,659.0,5,1079,1.0,811.0,811.0
0.004,6,10,1779,5,928,1.0,660.0,660.0,5,851,1.0,583.0,583.0
0.004,6,10,1702,5,863,1.0,595.0,595.0,5,839,1.0,571.0,571.0
0.011,6,10,1989,5,910,2.0,642.0,642.0,5,1079,2.0,811.0,811.0
1770.665,17,120,11460,60,5460,30010.0,63.0,63.0,60,6000,30010.0,72.0,72.0
0.01,6,10,1762,5,911,2.0,643.0,643.0,5,851,2.0,583.0,583.0
0.003,17,2,136,1,60,0.0,32.0,32.0,1,76,0.0,48.0,48.0
0.005,6,10,1989,5,927,1.0,659.0,659.0,5,1062,1.0,794.0,794.0
0.009,6,10,1990,5,911,2.0,643.0,643.0,5,1079,2.0,811.0,811.0
0.01,6,13,3735,7,497,1.0,125.0,125.0,6,3238,1.0,1470.0,1459.0
0.012,6,10,1972,5,910,3.0,642.0,642.0,5,1062,3.0,794.0,794.0
240.088,6,16,4481,9,963,30011.0,238.0,166.0,7,3518,40014.0,1402.0,786.0
0.008,6,10,1990,5,911,1.0,643.0,643.0,5,1079,1.0,811.0,811.0
11.528,17,30,4739,15,2166,811.0,269.0,116.0,15,2573,811.0,588.0,143.0
0.101,6,10,1506,5,395,22.0,127.0,127.0,5,1111,22.0,843.0,843.0
0.009,6,10,1631,5,848,2.0,580.0,580.0,5,783,2.0,515.0,515.0
0.005,6,10,1547,5,764,1.0,496.0,496.0,5,783,1.0,515.0,515.0
1778.524,17,144,41760,72,22752,25049.0,288.0,288.0,72,19008,25049.0,236.0,236.0
175.131,17,80,11489,40,2673,4490.0,44.0,38.0,40,8816,4490.0,260.0,192.0
0.005,6,10,2006,5,927,1.0,659.0,659.0,5,1079,1.0,811.0,811.0
0.01,6,10,1983,5,910,2.0,642.0,642.0,5,1073,2.0,805.0,805.0
0.02,6,10,1990,5,911,5.0,643.0,643.0,5,1079,4.0,811.0,811.0
0.126,6,10,1506,5,395,29.0,127.0,127.0,5,1111,28.0,843.0,843.0
0.008,6,10,2006,5,927,2.0,659.0,659.0,5,1079,2.0,811.0,811.0
1799.84,6,136,6550,76,3625,23997.0,39.0,39.0,60,2925,29991.0,35.0,35.0
0.005,17,2,144,1,64,0.0,36.0,36.0,1,80,0.0,52.0,52.0
0.027,17,2,213,1,69,0.0,41.0,41.0,1,144,0.0,116.0,116.0
0.115,6,10,1506,5,395,26.0,127.0,127.0,5,1111,20.0,843.0,843.0
0.013,6,13,3735,7,497,2.0,125.0,125.0,6,3238,2.0,1470.0,1459.0
1770.89,6,83,4370,42,2211,43191.0,27.0,27.0,41,2159,44271.0,27.0,27.0
0.007,6,10,1762,5,911,1.0,643.0,643.0,5,851,1.0,583.0,583.0
0.004,6,10,2006,5,927,1.0,659.0,659.0,5,1079,1.0,811.0,811.0
0.079,6,10,1506,5,395,14.0,127.0,127.0,5,1111,18.0,843.0,843.0
0.004,6,10,1989,5,927,1.0,659.0,659.0,5,1062,1.0,794.0,794.0
0.008,6,10,1990,5,911,2.0,643.0,643.0,5,1079,1.0,811.0,811.0
0.005,6,10,2000,5,927,1.0,659.0,659.0,5,1073,1.0,805.0,805.0
0.082,6,10,1506,5,395,17.0,127.0,127.0,5,1111,19.0,843.0,843.0
0.012,6,10,1983,5,910,2.0,642.0,642.0,5,1073,3.0,805.0,805.0
0.009,6,10,1989,5,910,2.0,642.0,642.0,5,1079,2.0,811.0,811.0
0.004,6,10,2006,5,927,1.0,659.0,659.0,5,1079,1.0,811.0,811.0
0.004,6,10,2006,5,927,1.0,659.0,659.0,5,1079,1.0,811.0,811.0
0.016,6,10,1972,5,910,4.0,642.0,642.0,5,1062,3.0,794.0,794.0
0.01,6,10,1972,5,910,2.0,642.0,642.0,5,1062,2.0,794.0,794.0
0.139,6,10,1506,5,395,34.0,127.0,127.0,5,1111,31.0,843.0,843.0
1770.551,17,92,8096,46,4048,39345.0,60.0,60.0,46,4048,39345.0,60.0,60.0
0.085,6,10,1506,5,395,19.0,127.0,127.0,5,1111,19.0,843.0,843.0
300.946,6,46,19130,24,13452,13084.0,2720.0,1384.0,22,5678,417.0,2667.0,435.0
0.003,17,2,148,1,60,0.0,32.0,32.0,1,88,0.0,60.0,60.0
0.005,6,10,1989,5,927,1.0,659.0,659.0,5,1062,1.0,794.0,794.0
0.129,6,10,1506,5,395,32.0,127.0,127.0,5,1111,30.0,843.0,843.0
0.008,6,10,1774,5,923,1.0,655.0,655.0,5,851,2.0,583.0,583.0
361.862,6,19,1689,15,978,25847.0,190.0,190.0,4,711,80012.0,495.0,495.0
0.005,6,10,1689,5,839,1.0,571.0,571.0,5,850,1.0,582.0,582.0
0.009,6,10,1677,5,827,2.0,559.0,559.0,5,850,2.0,582.0,582.0
0.005,17,2,169,1,62,0.0,34.0,34.0,1,107,0.0,79.0,79.0
10.876,17,28,4419,14,1995,828.0,270.0,114.0,14,2424,828.0,587.0,145.0
0.095,6,10,1506,5,395,22.0,127.0,127.0,5,1111,20.0,843.0,843.0
0.01,6,10,1989,5,910,2.0,642.0,642.0,5,1079,2.0,811.0,811.0
0.005,6,10,2006,5,927,1.0,659.0,659.0,5,1079,1.0,811.0,811.0
0.006,6,10,1643,5,860,1.0,592.0,592.0,5,783,1.0,515.0,515.0
0.005,6,10,2006,5,927,1.0,659.0,659.0,5,1079,1.0,811.0,811.0
0.037,17,2,148,1,60,0.0,32.0,32.0,1,88,0.0,60.0,60.0
0.014,6,10,1983,5,910,3.0,642.0,642.0,5,1073,3.0,805.0,805.0
0.004,6,10,2006,5,927,1.0,659.0,659.0,5,1079,1.0,811.0,811.0
173.079,17,88,13020,44,2963,4024.0,44.0,39.0,44,10057,4025.0,279.0,200.0
0.011,6,10,1990,5,911,2.0,643.0,643.0,5,1079,2.0,811.0,811.0
40.069,17,10,676,5,460,10015.0,104.0,64.0,5,216,10016.0,20.0,15.0
0.079,6,10,1506,5,395,14.0,127.0,127.0,5,1111,17.0,843.0,843.0
0.008,17,2,194,1,59,0.0,31.0,31.0,1,135,0.0,107.0,107.0
0.011,6,10,1762,5,911,2.0,643.0,643.0,5,851,2.0,583.0,583.0
0.018,6,10,1990,5,911,4.0,643.0,643.0,5,1079,4.0,811.0,811.0
0.099,6,10,1506,5,395,18.0,127.0,127.0,5,1111,24.0,843.0,843.0
300.352,6,16,2170,9,684,37523.0,146.0,146.0,7,1486,50030.0,419.0,398.0
0.126,17,2,80,1,32,0.0,4.0,4.0,1,48,0.0,20.0,20.0
0.093,6,10,1506,5,395,18.0,127.0,127.0,5,1111,18.0,843.0,843.0
0.013,6,10,1972,5,910,3.0,642.0,642.0,5,1062,3.0,794.0,794.0
0.005,6,10,2007,5,928,1.0,660.0,660.0,5,1079,1.0,811.0,811.0
0.012,6,10,1762,5,911,3.0,643.0,643.0,5,851,2.0,583.0,583.0
0.01,6,10,1983,5,910,2.0,642.0,642.0,5,1073,2.0,805.0,805.0
0.005,6,10,2007,5,928,1.0,660.0,660.0,5,1079,1.0,811.0,811.0
0.292,17,39,20235,21,17035,14.0,1350.0,783.0,18,3200,12.0,1350.0,149.0
0.005,17,2,170,1,65,0.0,37.0,37.0,1,105,0.0,77.0,77.0
178.482,17,78,11287,39,2594,4696.0,44.0,38.0,39,8693,4696.0,261.0,194.0
0.008,6,10,1854,5,889,2.0,621.0,621.0,5,965,1.0,697.0,697.0
0.005,17,2,194,1,57,0.0,29.0,29.0,1,137,0.0,109.0,109.0
0.005,6,10,2000,5,927,1.0,659.0,659.0,5,1073,1.0,805.0,805.0
0.005,17,2,180,1,66,0.0,38.0,38.0,1,114,0.0,86.0,86.0
0.003,17,2,695,1,367,0.0,339.0,339.0,1,328,0.0,300.0,300.0
0.01,6,10,1989,5,910,2.0,642.0,642.0,5,1079,2.0,811.0,811.0
0.004,17,2,136,1,60,0.0,32.0,32.0,1,76,0.0,48.0,48.0
0.018,6,10,1762,5,911,4.0,643.0,643.0,5,851,4.0,583.0,583.0
0.094,6,10,1506,5,395,21.0,127.0,127.0,5,1111,21.0,843.0,843.0
369.734,6,22,2313,16,867,24648.0,195.0,195.0,6,1446,4645.0,419.0,398.0
0.007,6,10,1643,5,860,1.0,592.0,592.0,5,783,1.0,515.0,515.0
0.003,17,2,136,1,60,0.0,32.0,32.0,1,76,0.0,48.0,48.0
0.008,6,12,1926,6,1189,1.0,659.0,434.0,6,737,1.0,417.0,417.0
0.017,6,10,1990,5,911,4.0,643.0,643.0,5,1079,4.0,811.0,811.0
0.006,6,10,1643,5,860,1.0,592.0,592.0,5,783,1.0,515.0,515.0
0.006,6,10,1854,5,889,1.0,621.0,621.0,5,965,1.0,697.0,697.0
0.003,6,10,1702,5,863,0.0,595.0,595.0,5,839,0.0,571.0,571.0
0.096,6,10,1506,5,395,19.0,127.0,127.0,5,1111,21.0,843.0,843.0
0.005,6,10,2006,5,927,1.0,659.0,659.0,5,1079,1.0,811.0,811.0
361.861,6,21,1793,16,1030,24124.0,190.0,190.0,5,763,60009.0,462.0,247.0
0.011,6,10,1990,5,911,2.0,643.0,643.0,5,1079,2.0,811.0,811.0
40.062,17,10,676,5,460,10012.0,104.0,64.0,5,216,10014.0,20.0,15.0
0.013,6,10,1972,5,910,3.0,642.0,642.0,5,1062,3.0,794.0,794.0
0.016,6,10,1677,5,827,3.0,559.0,559.0,5,850,3.0,582.0,582.0
25.788,6,28,5326,15,1238,1841.0,180.0,75.0,13,4088,2148.0,1591.0,678.0
0.093,6,10,1506,5,395,20.0,127.0,127.0,5,1111,19.0,843.0,843.0
0.004,17,4,284,2,120,0.0,32.0,32.0,2,164,0.0,60.0,54.0
241.313,6,381,346775,202,22024,1200.0,2736.0,959.0,179,324751,1355.0,2804.0,1866.0
0.091,6,10,1506,5,395,19.0,127.0,127.0,5,1111,19.0,843.0,843.0
0.005,17,2,140,1,62,0.0,34.0,34.0,1,78,0.0,50.0,50.0
0.004,17,2,234,1,61,0.0,33.0,33.0,1,173,0.0,145.0,145.0
0.004,6,10,1989,5,927,1.0,659.0,659.0,5,1062,1.0,794.0,794.0
0.123,6,10,1506,5,395,25.0,127.0,127.0,5,1111,26.0,843.0,843.0
0.016,17,2,170,1,65,0.0,37.0,37.0,1,105,0.0,77.0,77.0
0.004,6,10,1702,5,863,1.0,595.0,595.0,5,839,0.0,571.0,571.0
0.009,17,2,294,1,64,0.0,36.0,36.0,1,230,0.0,202.0,202.0
0.098,6,10,1506,5,395,22.0,127.0,127.0,5,1111,20.0,843.0,843.0
0.006,6,10,1854,5,889,1.0,621.0,621.0,5,965,1.0,697.0,697.0
0.023,17,2,198,1,91,0.0,63.0,63.0,1,107,0.0,79.0,79.0
0.01,6,10,1989,5,927,2.0,659.0,659.0,5,1062,2.0,794.0,794.0
0.007,6,10,2006,5,927,1.0,659.0,659.0,5,1079,1.0,811.0,811.0
0.129,17,2,80,1,32,0.0,4.0,4.0,1,48,0.0,20.0,20.0
0.008,6,10,1990,5,911,1.0,643.0,643.0,5,1079,1.0,811.0,811.0
0.004,6,14,3742,7,452,0.0,80.0,80.0,7,3290,0.0,1448.0,972.0
0.004,6,10,1989,5,927,1.0,659.0,659.0,5,1062,1.0,794.0,794.0
0.004,17,2,136,1,60,0.0,32.0,32.0,1,76,0.0,48.0,48.0
11.023,17,26,4100,13,1823,909.0,270.0,112.0,13,2277,909.0,588.0,147.0
0.005,6,10,2007,5,928,1.0,660.0,660.0,5,1079,1.0,811.0,811.0
0.114,6,10,1506,5,395,24.0,127.0,127.0,5,1111,24.0,843.0,843.0
0.08,6,10,1506,5,395,19.0,127.0,127.0,5,1111,15.0,843.0,843.0
0.041,17,2,152,1,76,0.0,48.0,48.0,1,76,0.0,48.0,48.0
0.026,6,10,1989,5,910,6.0,642.0,642.0,5,1079,6.0,811.0,811.0
0.009,6,10,1990,5,911,2.0,643.0,643.0,5,1079,2.0,811.0,811.0
0.003,17,2,160,1,72,0.0,44.0,44.0,1,88,0.0,60.0,60.0
0.006,17,2,170,1,65,0.0,37.0,37.0,1,105,0.0,77.0,77.0
0.071,17,2,234,1,61,0.0,33.0,33.0,1,173,0.0,145.0,145.0
0.005,17,2,166,1,75,0.0,47.0,47.0,1,91,0.0,63.0,63.0
0.005,6,10,2006,5,927,1.0,659.0,659.0,5,1079,1.0,811.0,811.0
0.014,6,10,1990,5,911,3.0,643.0,643.0,5,1079,3.0,811.0,811.0
0.001,17,2,180,1,66,0.0,38.0,38.0,1,114,0.0,86.0,86.0
0.004,6,10,2006,5,927,1.0,659.0,659.0,5,1079,1.0,811.0,811.0
0.105,6,10,1506,5,395,23.0,127.0,127.0,5,1111,22.0,843.0,843.0
0.144,6,10,1506,5,395,34.0,127.0,127.0,5,1111,31.0,843.0,843.0
0.005,6,10,1547,5,764,1.0,496.0,496.0,5,783,1.0,515.0,515.0
0.005,6,10,1774,5,923,1.0,655.0,655.0,5,851,1.0,583.0,583.0
93.978,6,25,9452,12,1627,74.0,794.0,367.0,13,7825,7820.0,1360.0,810.0
0.004,6,10,1702,5,863,1.0,595.0,595.0,5,839,1.0,571.0,571.0
0.005,17,2,214,1,75,0.0,47.0,47.0,1,139,0.0,111.0,111.0
0.008,6,10,1989,5,927,1.0,659.0,659.0,5,1062,1.0,794.0,794.0
0.005,6,13,3747,7,509,0.0,137.0,137.0,6,3238,0.0,1470.0,1459.0
0.091,6,10,1506,5,395,21.0,127.0,127.0,5,1111,17.0,843.0,843.0
0.078,6,10,1506,5,395,17.0,127.0,127.0,5,1111,17.0,843.0,843.0
0.012,6,10,1762,5,911,3.0,643.0,643.0,5,851,3.0,583.0,583.0
0.011,6,10,1989,5,910,2.0,642.0,642.0,5,1079,2.0,811.0,811.0
0.011,6,10,1989,5,910,2.0,642.0,642.0,5,1079,2.0,811.0,811.0
0.009,6,10,1989,5,910,2.0,642.0,642.0,5,1079,2.0,811.0,811.0
372.187,6,22,2313,16,867,24812.0,195.0,195.0,6,1446,4706.0,419.0,398.0
0.001,17,2,180,1,66,0.0,38.0,38.0,1,114,0.0,86.0,86.0
0.005,6,10,1779,5,928,1.0,660.0,660.0,5,851,1.0,583.0,583.0
0.012,6,10,1983,5,910,2.0,642.0,642.0,5,1073,2.0,805.0,805.0
0.087,6,10,1506,5,395,17.0,127.0,127.0,5,1111,20.0,843.0,843.0
0.005,6,10,1779,5,928,1.0,660.0,660.0,5,851,1.0,583.0,583.0
0.076,17,2,152,1,76,0.0,48.0,48.0,1,76,0.0,48.0,48.0
0.005,6,10,2006,5,927,1.0,659.0,659.0,5,1079,1.0,811.0,811.0
0.005,6,10,2006,5,927,1.0,659.0,659.0,5,1079,1.0,811.0,811.0
0.004,6,10,1779,5,928,1.0,660.0,660.0,5,851,1.0,583.0,583.0
0.011,6,10,1972,5,910,2.0,642.0,642.0,5,1062,2.0,794.0,794.0
0.004,6,10,1774,5,923,1.0,655.0,655.0,5,851,1.0,583.0,583.0
0.011,6,10,1677,5,827,2.0,559.0,559.0,5,850,2.0,582.0,582.0
0.016,17,2,198,1,91,0.0,63.0,63.0,1,107,0.0,79.0,79.0
0.016,6,10,1972,5,910,3.0,642.0,642.0,5,1062,3.0,794.0,794.0
0.004,6,10,2000,5,927,1.0,659.0,659.0,5,1073,1.0,805.0,805.0
0.061,6,10,1506,5,395,12.0,127.0,127.0,5,1111,13.0,843.0,843.0
0.005,6,10,2000,5,927,1.0,659.0,659.0,5,1073,1.0,805.0,805.0
0.119,6,10,1506,5,395,25.0,127.0,127.0,5,1111,26.0,843.0,843.0
0.005,17,2,140,1,62,0.0,34.0,34.0,1,78,0.0,50.0,50.0
0.262,6,16,2670,8,1396,37.0,533.0,324.0,8,1274,24.0,529.0,212.0
1797.964,17,3029,231680,1508,122210,1193.0,84.0,53.0,1521,109470,1181.0,227.0,43.0
0.009,6,13,3735,7,497,1.0,125.0,125.0,6,3238,1.0,1470.0,1459.0
0.01,6,10,1990,5,911,2.0,643.0,643.0,5,1079,2.0,811.0,811.0
0.006,6,10,1689,5,839,1.0,571.0,571.0,5,850,1.0,582.0,582.0
0.001,17,2,136,1,60,0.0,32.0,32.0,1,76,0.0,48.0,48.0
0.04,17,2,148,1,60,0.0,32.0,32.0,1,88,0.0,60.0,60.0
37.109,17,4,670,2,136,37105.0,40.0,40.0,2,534,37105.0,239.0,239.0
300.379,6,28,7488,16,1409,20025.0,217.0,142.0,12,6079,21848.0,1402.0,680.0
5.082,6,21,5923,12,1436,461.0,474.0,201.0,9,4487,634.0,1925.0,804.0
0.008,6,12,1926,6,1189,1.0,659.0,434.0,6,737,1.0,417.0,417.0
0.102,6,10,1506,5,395,24.0,127.0,127.0,5,1111,24.0,843.0,843.0
0.004,6,10,2007,5,928,1.0,660.0,660.0,5,1079,1.0,811.0,811.0
40.077,17,10,676,5,460,10018.0,104.0,64.0,5,216,10018.0,20.0,15.0
0.078,6,13,3816,7,578,13.0,206.0,206.0,6,3238,15.0,1470.0,1459.0
0.112,6,10,1506,5,395,25.0,127.0,127.0,5,1111,27.0,843.0,843.0
0.005,6,10,2007,5,928,1.0,660.0,660.0,5,1079,1.0,811.0,811.0
0.001,17,2,164,1,74,0.0,46.0,46.0,1,90,0.0,62.0,62.0
0.013,6,10,1983,5,910,3.0,642.0,642.0,5,1073,3.0,805.0,805.0
0.005,17,2,179,1,71,0.0,43.0,43.0,1,108,0.0,80.0,80.0
0.005,6,13,3747,7,509,0.0,137.0,137.0,6,3238,0.0,1470.0,1459.0
0.006,6,10,1689,5,839,1.0,571.0,571.0,5,850,1.0,582.0,582.0
0.005,17,2,146,1,65,0.0,37.0,37.0,1,81,0.0,53.0,53.0
0.009,6,10,1990,5,911,2.0,643.0,643.0,5,1079,2.0,811.0,811.0
0.007,6,10,2006,5,927,1.0,659.0,659.0,5,1079,1.0,811.0,811.0
0.064,17,2,152,1,76,0.0,48.0,48.0,1,76,0.0,48.0,48.0
0.009,6,10,1990,5,911,2.0,643.0,643.0,5,1079,2.0,811.0,811.0
0.004,6,10,2007,5,928,1.0,660.0,660.0,5,1079,1.0,811.0,811.0
0.104,6,10,1506,5,395,21.0,127.0,127.0,5,1111,24.0,843.0,843.0
15.073,17,14,9190,8,6902,2149.0,1350.0,834.0,6,2288,3008.0,1350.0,353.0
0.005,6,10,1989,5,927,1.0,659.0,659.0,5,1062,1.0,794.0,794.0
0.005,17,2,168,1,76,0.0,48.0,48.0,1,92,0.0,64.0,64.0
0.014,6,13,3735,7,497,2.0,125.0,125.0,6,3238,2.0,1470.0,1459.0
0.004,6,14,3742,7,452,0.0,80.0,80.0,7,3290,0.0,1448.0,972.0
0.004,17,2,136,1,60,0.0,32.0,32.0,1,76,0.0,48.0,48.0
240.088,6,16,4481,9,963,30011.0,238.0,166.0,7,3518,40014.0,1402.0,786.0
0.004,6,10,2007,5,928,1.0,660.0,660.0,5,1079,1.0,811.0,811.0
0.102,6,10,1506,5,395,20.0,127.0,127.0,5,1111,20.0,843.0,843.0
0.006,6,10,1547,5,764,1.0,496.0,496.0,5,783,1.0,515.0,515.0
0.019,6,10,1983,5,910,4.0,642.0,642.0,5,1073,4.0,805.0,805.0
0.098,6,10,1506,5,395,20.0,127.0,127.0,5,1111,24.0,843.0,843.0
0.005,6,10,2006,5,927,1.0,659.0,659.0,5,1079,1.0,811.0,811.0
0.006,6,10,1854,5,889,1.0,621.0,621.0,5,965,1.0,697.0,697.0
0.005,6,10,2007,5,928,1.0,660.0,660.0,5,1079,1.0,811.0,811.0
154.368,6,28,9605,14,1707,11874.0,794.0,367.0,14,7898,11864.0,1360.0,732.0
0.076,6,10,1506,5,395,16.0,127.0,127.0,5,1111,17.0,843.0,843.0
0.116,6,10,1506,5,395,27.0,127.0,127.0,5,1111,26.0,843.0,843.0
0.064,6,10,1506,5,395,14.0,127.0,127.0,5,1111,14.0,843.0,843.0
0.123,6,10,1506,5,395,26.0,127.0,127.0,5,1111,29.0,843.0,843.0
366.975,6,24,2405,17,919,22935.0,195.0,195.0,7,1486,3902.0,419.0,398.0
0.004,6,10,1989,5,927,1.0,659.0,659.0,5,1062,1.0,794.0,794.0
0.006,6,10,1689,5,839,1.0,571.0,571.0,5,850,1.0,582.0,582.0
0.005,6,13,3747,7,509,0.0,137.0,137.0,6,3238,0.0,1470.0,1459.0
0.008,17,2,268,1,70,0.0,42.0,42.0,1,198,0.0,170.0,170.0
0.005,17,2,140,1,62,0.0,34.0,34.0,1,78,0.0,50.0,50.0
0.015,6,10,1972,5,910,3.0,642.0,642.0,5,1062,3.0,794.0,794.0
0.004,17,2,136,1,60,0.0,32.0,32.0,1,76,0.0,48.0,48.0
0.028,17,2,214,1,75,0.0,47.0,47.0,1,139,0.0,111.0,111.0
0.001,17,2,136,1,60,0.0,32.0,32.0,1,76,0.0,48.0,48.0
0.017,6,10,1990,5,911,4.0,643.0,643.0,5,1079,4.0,811.0,811.0
0.095,6,10,1506,5,395,21.0,127.0,127.0,5,1111,21.0,843.0,843.0
0.039,17,4,284,2,120,0.0,32.0,32.0,2,164,35.0,60.0,54.0
0.005,6,14,3742,8,504,0.0,80.0,80.0,6,3238,0.0,1470.0,1459.0
0.004,6,10,1774,5,923,1.0,655.0,655.0,5,851,1.0,583.0,583.0
0.019,6,10,1989,5,910,4.0,642.0,642.0,5,1079,4.0,811.0,811.0
0.011,6,10,1990,5,911,2.0,643.0,643.0,5,1079,2.0,811.0,811.0
0.121,6,10,1506,5,395,27.0,127.0,127.0,5,1111,28.0,843.0,843.0
0.005,6,10,2006,5,927,1.0,659.0,659.0,5,1079,1.0,811.0,811.0
0.004,17,2,136,1,60,0.0,32.0,32.0,1,76,0.0,48.0,48.0
0.192,6,10,1506,5,395,46.0,127.0,127.0,5,1111,31.0,843.0,843.0
0.006,6,10,2000,5,927,1.0,659.0,659.0,5,1073,1.0,805.0,805.0
0.012,6,10,1989,5,910,3.0,642.0,642.0,5,1079,2.0,811.0,811.0
0.005,17,2,164,1,74,0.0,46.0,46.0,1,90,0.0,62.0,62.0
0.092,6,10,1506,5,395,18.0,127.0,127.0,5,1111,21.0,843.0,843.0
0.017,6,10,1972,5,910,4.0,642.0,642.0,5,1062,4.0,794.0,794.0
0.005,6,10,1643,5,860,1.0,592.0,592.0,5,783,1.0,515.0,515.0
0.054,17,2,152,1,76,0.0,48.0,48.0,1,76,0.0,48.0,48.0
0.004,6,10,1702,5,863,1.0,595.0,595.0,5,839,0.0,571.0,571.0
0.004,17,4,284,2,120,0.0,32.0,32.0,2,164,0.0,60.0,54.0
0.003,17,2,136,1,60,0.0,32.0,32.0,1,76,0.0,48.0,48.0
0.01,6,10,1972,5,910,2.0,642.0,642.0,5,1062,2.0,794.0,794.0
0.005,6,10,2007,5,928,1.0,660.0,660.0,5,1079,1.0,811.0,811.0
0.018,6,10,1990,5,911,4.0,643.0,643.0,5,1079,4.0,811.0,811.0
368.423,6,24,2405,17,919,23026.0,195.0,195.0,7,1486,3914.0,419.0,398.0
0.114,6,10,1506,5,395,27.0,127.0,127.0,5,1111,23.0,843.0,843.0
0.08,6,10,1506,5,395,18.0,127.0,127.0,5,1111,19.0,843.0,843.0
0.209,6,10,1506,5,395,45.0,127.0,127.0,5,1111,49.0,843.0,843.0
0.005,6,10,2007,5,928,1.0,660.0,660.0,5,1079,1.0,811.0,811.0
40.061,17,10,676,5,460,10012.0,104.0,64.0,5,216,10014.0,20.0,15.0
40.054,17,10,676,5,460,10012.0,104.0,64.0,5,216,10012.0,20.0,15.0
0.009,6,10,1972,5,910,2.0,642.0,642.0,5,1062,2.0,794.0,794.0
0.017,6,10,1972,5,910,4.0,642.0,642.0,5,1062,4.0,794.0,794.0
0.004,17,4,284,2,120,0.0,32.0,32.0,2,164,0.0,60.0,54.0
0.004,6,10,1989,5,927,1.0,659.0,659.0,5,1062,1.0,794.0,794.0
0.006,6,10,2000,5,927,1.0,659.0,659.0,5,1073,1.0,805.0,805.0
0.085,6,10,1506,5,395,16.0,127.0,127.0,5,1111,18.0,843.0,843.0
0.003,17,2,132,1,58,0.0,30.0,30.0,1,74,0.0,46.0,46.0
176.119,17,72,10296,36,2402,5031.0,44.0,38.0,36,7894,5031.0,239.0,191.0
0.005,6,10,2006,5,927,1.0,659.0,659.0,5,1079,1.0,811.0,811.0
266.018,6,39,9904,15,6711,19001.0,1835.0,659.0,24,3193,11565.0,580.0,129.0
0.012,6,10,1989,5,910,3.0,642.0,642.0,5,1079,3.0,811.0,811.0
40.051,17,10,676,5,460,10012.0,104.0,64.0,5,216,10012.0,20.0,15.0
0.005,6,10,1689,5,839,1.0,571.0,571.0,5,850,1.0,582.0,582.0
40.111,17,10,676,5,460,10027.0,104.0,64.0,5,216,10027.0,20.0,15.0
0.023,6,10,1989,5,910,5.0,642.0,642.0,5,1079,5.0,811.0,811.0
0.076,6,10,1506,5,395,16.0,127.0,127.0,5,1111,14.0,843.0,843.0
173.142,17,74,10944,37,2471,4808.0,44.0,38.0,37,8473,4809.0,279.0,201.0
0.017,6,6,716,3,458,7.0,302.0,302.0,3,258,7.0,102.0,102.0
0.009,6,10,1989,5,910,2.0,642.0,642.0,5,1079,2.0,811.0,811.0
0.005,6,12,1698,6,863,1.0,327.0,271.0,6,835,1.0,515.0,515.0
0.004,6,10,2007,5,928,1.0,660.0,660.0,5,1079,1.0,811.0,811.0
0.005,6,10,1689,5,839,1.0,571.0,571.0,5,850,1.0,582.0,582.0
0.119,6,10,1506,5,395,27.0,127.0,127.0,5,1111,25.0,843.0,843.0
0.016,6,10,1972,5,910,4.0,642.0,642.0,5,1062,3.0,794.0,794.0
0.01,6,10,1631,5,848,2.0,580.0,580.0,5,783,2.0,515.0,515.0
0.009,6,10,1989,5,910,2.0,642.0,642.0,5,1079,2.0,811.0,811.0
0.013,17,2,152,1,56,0.0,28.0,28.0,1,96,0.0,68.0,68.0
15.073,17,15,9239,8,6902,2149.0,1350.0,834.0,7,2337,2507.0,1350.0,305.0
0.004,17,2,148,1,60,0.0,32.0,32.0,1,88,0.0,60.0,60.0
0.005,6,10,2000,5,927,1.0,659.0,659.0,5,1073,1.0,805.0,805.0
0.005,17,2,164,1,74,0.0,46.0,46.0,1,90,0.0,62.0,62.0
0.007,6,12,1698,6,863,1.0,327.0,271.0,6,835,1.0,515.0,515.0
0.005,6,10,1989,5,927,1.0,659.0,659.0,5,1062,1.0,794.0,794.0
0.014,6,10,1989,5,910,3.0,642.0,642.0,5,1079,3.0,811.0,811.0
0.134,17,2,80,1,32,0.0,4.0,4.0,1,48,0.0,20.0,20.0
0.008,6,10,1972,5,910,2.0,642.0,642.0,5,1062,1.0,794.0,794.0
0.02,6,10,1983,5,910,4.0,642.0,642.0,5,1073,4.0,805.0,805.0
0.006,6,10,1547,5,764,1.0,496.0,496.0,5,783,1.0,515.0,515.0
40.056,17,10,676,5,460,10013.0,104.0,64.0,5,216,10013.0,20.0,15.0
0.004,6,10,2006,5,927,1.0,659.0,659.0,5,1079,1.0,811.0,811.0
0.088,6,10,1506,5,395,19.0,127.0,127.0,5,1111,20.0,843.0,843.0
0.105,6,10,1506,5,395,21.0,127.0,127.0,5,1111,23.0,843.0,843.0
0.093,17,2,152,1,76,0.0,48.0,48.0,1,76,0.0,48.0,48.0
0.011,17,2,169,1,62,0.0,34.0,34.0,1,107,0.0,79.0,79.0
1797.086,6,871,732955,312,90586,5778.0,2540.0,1061.0,559,642369,3220.0,2804.0,1283.0
0.06,17,2,152,1,76,0.0,48.0,48.0,1,76,0.0,48.0,48.0
0.004,6,10,2006,5,927,1.0,659.0,659.0,5,1079,1.0,811.0,811.0
0.061,6,10,1506,5,395,13.0,127.0,127.0,5,1111,12.0,843.0,843.0
0.005,6,10,2006,5,927,1.0,659.0,659.0,5,1079,1.0,811.0,811.0
0.006,6,10,1643,5,860,1.0,592.0,592.0,5,783,1.0,515.0,515.0
15.072,17,15,9239,8,6902,2149.0,1350.0,834.0,7,2337,2507.0,1350.0,305.0
0.005,6,10,1989,5,927,1.0,659.0,659.0,5,1062,1.0,794.0,794.0
0.004,6,10,2007,5,928,1.0,660.0,660.0,5,1079,1.0,811.0,811.0
240.02,6,9,787,5,488,60005.0,232.0,232.0,4,299,80005.0,83.0,83.0
0.005,6,10,2000,5,927,1.0,659.0,659.0,5,1073,1.0,805.0,805.0
0.001,17,2,180,1,66,0.0,38.0,38.0,1,114,0.0,86.0,86.0
0.005,6,10,1689,5,839,1.0,571.0,571.0,5,850,1.0,582.0,582.0
325.649,17,20,1124,10,716,36169.0,48.0,43.0,10,408,36169.0,20.0,12.0
0.123,6,10,1506,5,395,29.0,127.0,127.0,5,1111,29.0,843.0,843.0
0.005,6,10,2007,5,928,1.0,660.0,660.0,5,1079,1.0,811.0,811.0
0.005,17,2,164,1,74,0.0,46.0,46.0,1,90,0.0,62.0,62.0
0.005,6,10,1643,5,860,1.0,592.0,592.0,5,783,1.0,515.0,515.0
0.005,6,10,2006,5,927,1.0,659.0,659.0,5,1079,1.0,811.0,811.0
0.01,6,10,1989,5,910,2.0,642.0,642.0,5,1079,2.0,811.0,811.0
0.081,6,10,1506,5,395,18.0,127.0,127.0,5,1111,18.0,843.0,843.0
0.072,6,10,1506,5,395,15.0,127.0,127.0,5,1111,17.0,843.0,843.0
0.017,6,10,1972,5,910,4.0,642.0,642.0,5,1062,4.0,794.0,794.0
240.02,6,9,787,5,488,60005.0,232.0,232.0,4,299,80005.0,83.0,83.0
0.003,17,2,132,1,58,0.0,30.0,30.0,1,74,0.0,46.0,46.0
0.019,6,10,1972,5,910,4.0,642.0,642.0,5,1062,4.0,794.0,794.0
0.005,6,10,2007,5,928,1.0,660.0,660.0,5,1079,1.0,811.0,811.0
11.224,17,28,4422,14,1994,851.0,269.0,114.0,14,2428,851.0,587.0,145.0
0.071,17,2,148,1,60,0.0,32.0,32.0,1,88,0.0,60.0,60.0
0.127,17,2,412,1,61,0.0,33.0,33.0,1,351,0.0,323.0,323.0
0.006,6,10,2000,5,927,1.0,659.0,659.0,5,1073,1.0,805.0,805.0
0.006,6,10,1774,5,923,1.0,655.0,655.0,5,851,1.0,583.0,583.0
0.006,6,10,1547,5,764,1.0,496.0,496.0,5,783,1.0,515.0,515.0
0.012,6,10,1983,5,910,3.0,642.0,642.0,5,1073,2.0,805.0,805.0
0.004,6,10,1779,5,928,1.0,660.0,660.0,5,851,1.0,583.0,583.0
352.251,6,20,2210,6,1308,12004.0,494.0,494.0,14,902,27096.0,83.0,83.0
0.013,6,10,1990,5,911,3.0,643.0,643.0,5,1079,3.0,811.0,811.0
0.005,6,10,2006,5,927,1.0,659.0,659.0,5,1079,1.0,811.0,811.0
0.005,6,10,2007,5,928,1.0,660.0,660.0,5,1079,1.0,811.0,811.0
0.005,17,2,180,1,66,0.0,38.0,38.0,1,114,0.0,86.0,86.0
1768.932,17,92,8096,46,4048,39308.0,60.0,60.0,46,4048,39309.0,60.0,60.0
40.071,17,10,676,5,460,10017.0,104.0,64.0,5,216,10016.0,20.0,15.0
40.077,17,10,676,5,460,10017.0,104.0,64.0,5,216,10018.0,20.0,15.0
0.006,17,2,179,1,71,0.0,43.0,43.0,1,108,0.0,80.0,80.0
0.005,6,14,3742,7,452,0.0,80.0,80.0,7,3290,0.0,1448.0,972.0
0.116,6,10,1506,5,395,27.0,127.0,127.0,5,1111,24.0,843.0,843.0
0.005,6,10,2000,5,927,1.0,659.0,659.0,5,1073,1.0,805.0,805.0
0.006,6,10,1547,5,764,1.0,496.0,496.0,5,783,1.0,515.0,515.0
0.006,6,10,2007,5,928,1.0,660.0,660.0,5,1079,1.0,811.0,811.0
0.004,6,10,1989,5,927,1.0,659.0,659.0,5,1062,1.0,794.0,794.0
0.018,6,10,1983,5,910,4.0,642.0,642.0,5,1073,4.0,805.0,805.0
0.005,6,10,2007,5,928,1.0,660.0,660.0,5,1079,1.0,811.0,811.0
0.004,6,10,1774,5,923,1.0,655.0,655.0,5,851,1.0,583.0,583.0
0.008,6,10,1972,5,910,1.0,642.0,642.0,5,1062,2.0,794.0,794.0
0.049,17,2,152,1,76,0.0,48.0,48.0,1,76,0.0,48.0,48.0
0.005,6,10,1774,5,923,1.0,655.0,655.0,5,851,1.0,583.0,583.0
0.017,6,10,1990,5,911,4.0,643.0,643.0,5,1079,4.0,811.0,811.0
0.009,6,10,1990,5,911,2.0,643.0,643.0,5,1079,2.0,811.0,811.0
0.018,6,14,3787,7,497,3.0,125.0,125.0,7,3290,2.0,1448.0,972.0
0.208,6,16,2675,8,1401,29.0,533.0,325.0,8,1274,19.0,529.0,212.0
0.008,6,12,1926,6,1189,1.0,659.0,434.0,6,737,1.0,417.0,417.0
0.021,6,10,1990,5,911,5.0,643.0,643.0,5,1079,5.0,811.0,811.0
0.014,6,10,1972,5,910,3.0,642.0,642.0,5,1062,3.0,794.0,794.0
0.005,6,10,1989,5,927,1.0,659.0,659.0,5,1062,1.0,794.0,794.0
1770.976,6,85,4547,42,2238,43193.0,27.0,27.0,43,2309,42163.0,26.0,24.0
15.172,17,21,11309,10,7667,1682.0,1350.0,738.0,11,3642,1514.0,1350.0,303.0
292.51,6,392,348398,203,22108,1448.0,2736.0,888.0,189,326290,1555.0,2804.0,1808.0
0.072,6,10,1506,5,395,15.0,127.0,127.0,5,1111,15.0,843.0,843.0
0.006,17,2,209,1,64,0.0,36.0,36.0,1,145,0.0,117.0,117.0
0.005,6,10,2006,5,927,1.0,659.0,659.0,5,1079,1.0,811.0,811.0
0.005,6,10,2006,5,927,1.0,659.0,659.0,5,1079,1.0,811.0,811.0
0.008,17,2,299,1,65,0.0,37.0,37.0,1,234,0.0,206.0,206.0
308.748,17,20,1124,10,716,34298.0,48.0,43.0,10,408,34298.0,20.0,12.0
0.102,6,10,1506,5,395,23.0,127.0,127.0,5,1111,22.0,843.0,843.0
0.003,17,2,136,1,60,0.0,32.0,32.0,1,76,0.0,48.0,48.0
1.087,17,2,144,1,64,0.0,36.0,36.0,1,80,0.0,52.0,52.0
293.691,6,408,348925,207,22336,1425.0,2736.0,889.0,201,326589,1468.0,2804.0,1690.0
0.005,6,10,1779,5,928,1.0,660.0,660.0,5,851,1.0,583.0,583.0
0.005,17,2,273,1,66,0.0,38.0,38.0,1,207,0.0,179.0,179.0
264.684,17,18,1008,9,640,33075.0,48.0,43.0,9,368,33075.0,20.0,12.0
0.011,6,10,1989,5,910,2.0,642.0,642.0,5,1079,2.0,811.0,811.0
0.167,6,10,1506,5,395,39.0,127.0,127.0,5,1111,38.0,843.0,843.0
0.013,6,10,1972,5,910,3.0,642.0,642.0,5,1062,3.0,794.0,794.0
0.006,6,10,1547,5,764,1.0,496.0,496.0,5,783,1.0,515.0,515.0
0.005,17,2,140,1,62,0.0,34.0,34.0,1,78,0.0,50.0,50.0
354.054,6,20,2210,6,1308,12007.0,494.0,494.0,14,902,27234.0,83.0,83.0
0.006,6,10,1547,5,764,1.0,496.0,496.0,5,783,1.0,515.0,515.0
0.013,6,10,1989,5,910,3.0,642.0,642.0,5,1079,3.0,811.0,811.0
0.087,6,10,1506,5,395,19.0,127.0,127.0,5,1111,21.0,843.0,843.0
0.04,17,2,234,1,61,0.0,33.0,33.0,1,173,0.0,145.0,145.0
0.104,6,10,1506,5,395,21.0,127.0,127.0,5,1111,20.0,843.0,843.0
0.009,6,10,1989,5,910,2.0,642.0,642.0,5,1079,2.0,811.0,811.0
0.057,17,2,179,1,71,0.0,43.0,43.0,1,108,0.0,80.0,80.0
0.004,6,10,2006,5,927,1.0,659.0,659.0,5,1079,1.0,811.0,811.0
240.009,6,9,787,5,488,60002.0,232.0,232.0,4,299,80002.0,83.0,83.0
321.795,17,20,1124,10,716,35740.0,48.0,43.0,10,408,35740.0,20.0,12.0
326.658,17,20,1124,10,716,36280.0,48.0,43.0,10,408,36280.0,20.0,12.0
0.005,6,10,2006,5,927,1.0,659.0,659.0,5,1079,1.0,811.0,811.0
0.006,6,10,1854,5,889,1.0,621.0,621.0,5,965,1.0,697.0,697.0
0.005,17,2,170,1,65,0.0,37.0,37.0,1,105,0.0,77.0,77.0
0.006,6,12,1698,6,863,1.0,327.0,271.0,6,835,1.0,515.0,515.0
0.01,6,10,1631,5,848,2.0,580.0,580.0,5,783,2.0,515.0,515.0
0.011,6,10,1677,5,827,2.0,559.0,559.0,5,850,2.0,582.0,582.0
0.014,6,10,1990,5,911,3.0,643.0,643.0,5,1079,3.0,811.0,811.0
0.061,6,10,1506,5,395,14.0,127.0,127.0,5,1111,13.0,843.0,843.0
361.763,6,21,1792,16,1030,24117.0,190.0,190.0,5,762,60010.0,461.0,247.0
240.094,6,17,4534,9,963,30011.0,238.0,166.0,8,3571,34298.0,1402.0,786.0
0.005,6,10,2006,5,927,1.0,659.0,659.0,5,1079,1.0,811.0,811.0
0.007,17,2,170,1,65,0.0,37.0,37.0,1,105,0.0,77.0,77.0
0.003,17,2,396,1,61,0.0,33.0,33.0,1,335,0.0,307.0,307.0
0.005,6,10,1689,5,839,1.0,571.0,571.0,5,850,1.0,582.0,582.0
0.039,17,2,148,1,60,0.0,32.0,32.0,1,88,0.0,60.0,60.0
0.078,6,10,1506,5,395,16.0,127.0,127.0,5,1111,17.0,843.0,843.0
8.932,6,39,10487,20,4929,470.0,1360.0,682.0,19,5558,485.0,2667.0,435.0
0.004,6,10,2006,5,927,1.0,659.0,659.0,5,1079,1.0,811.0,811.0
0.084,6,10,1506,5,395,18.0,127.0,127.0,5,1111,15.0,843.0,843.0
0.005,17,2,170,1,65,0.0,37.0,37.0,1,105,0.0,77.0,77.0
0.129,17,4,420,2,122,0.0,33.0,33.0,2,298,92.0,145.0,121.0
0.005,6,10,1989,5,927,1.0,659.0,659.0,5,1062,1.0,794.0,794.0
0.005,17,2,179,1,71,0.0,43.0,43.0,1,108,0.0,80.0,80.0
0.091,6,10,1506,5,395,19.0,127.0,127.0,5,1111,21.0,843.0,843.0
40.053,17,10,676,5,460,10012.0,104.0,64.0,5,216,10012.0,20.0,15.0
0.005,6,10,1689,5,839,1.0,571.0,571.0,5,850,1.0,582.0,582.0
0.005,6,10,2006,5,927,1.0,659.0,659.0,5,1079,1.0,811.0,811.0
0.02,6,10,1990,5,911,5.0,643.0,643.0,5,1079,5.0,811.0,811.0
0.744,6,22,5072,11,1250,63.0,325.0,133.0,11,3822,62.0,1414.0,563.0
0.001,17,2,136,1,60,0.0,32.0,32.0,1,76,0.0,48.0,48.0
1777.858,6,302,97700,186,86424,9610.0,2001.0,691.0,116,11276,15459.0,452.0,70.0
0.008,6,12,1926,6,1189,1.0,659.0,434.0,6,737,1.0,417.0,417.0
40.076,17,10,676,5,460,10016.0,104.0,64.0,5,216,10018.0,20.0,15.0
0.018,6,11,1683,6,900,3.0,580.0,580.0,5,783,4.0,515.0,515.0
0.005,6,14,3736,7,446,0.0,74.0,74.0,7,3290,0.0,1448.0,972.0
0.005,6,10,2000,5,927,1.0,659.0,659.0,5,1073,1.0,805.0,805.0
0.006,17,2,179,1,71,0.0,43.0,43.0,1,108,0.0,80.0,80.0
240.204,6,32,9282,16,6795,16013.0,1867.0,663.0,16,2487,16010.0,580.0,205.0
0.005,6,10,2007,5,928,1.0,660.0,660.0,5,1079,1.0,811.0,811.0
0.41,17,41,22167,23,18469,18.0,1350.0,775.0,18,3698,20.0,1350.0,177.0
0.001,17,2,180,1,66,0.0,38.0,38.0,1,114,0.0,86.0,86.0
40.08,17,10,676,5,460,10018.0,104.0,64.0,5,216,10018.0,20.0,15.0
0.005,17,2,154,1,69,0.0,41.0,41.0,1,85,0.0,57.0,57.0
0.007,17,2,179,1,71,0.0,43.0,43.0,1,108,0.0,80.0,80.0
240.088,6,16,4480,9,963,30011.0,238.0,166.0,7,3517,40014.0,1402.0,786.0
0.003,17,2,148,1,60,0.0,32.0,32.0,1,88,0.0,60.0,60.0
40.072,17,10,676,5,460,10017.0,104.0,64.0,5,216,10017.0,20.0,15.0
0.066,6,10,1506,5,395,14.0,127.0,127.0,5,1111,15.0,843.0,843.0
0.008,6,10,1989,5,910,2.0,642.0,642.0,5,1079,2.0,811.0,811.0
40.06,17,10,676,5,460,10014.0,104.0,64.0,5,216,10014.0,20.0,15.0
0.097,6,10,1506,5,395,21.0,127.0,127.0,5,1111,22.0,843.0,843.0
0.041,17,4,284,2,120,0.0,32.0,32.0,2,164,37.0,60.0,54.0
0.016,6,10,1990,5,911,4.0,643.0,643.0,5,1079,3.0,811.0,811.0
0.07,6,10,1506,5,395,14.0,127.0,127.0,5,1111,17.0,843.0,843.0
0.019,6,10,1972,5,910,4.0,642.0,642.0,5,1062,4.0,794.0,794.0
0.006,6,10,1689,5,839,1.0,571.0,571.0,5,850,1.0,582.0,582.0
0.005,6,10,1643,5,860,1.0,592.0,592.0,5,783,1.0,515.0,515.0
0.004,6,10,1989,5,927,1.0,659.0,659.0,5,1062,1.0,794.0,794.0
0.008,6,13,3735,7,497,1.0,125.0,125.0,6,3238,1.0,1470.0,1459.0
0.007,17,2,179,1,71,0.0,43.0,43.0,1,108,0.0,80.0,80.0
1776.589,6,306,98011,188,86540,9500.0,2001.0,685.0,118,11471,15184.0,452.0,69.0
0.129,17,2,80,1,32,0.0,4.0,4.0,1,48,0.0,20.0,20.0
0.005,17,2,146,1,65,0.0,37.0,37.0,1,81,0.0,53.0,53.0
0.013,6,14,3787,7,497,2.0,125.0,125.0,7,3290,2.0,1448.0,972.0
0.007,6,10,1547,5,764,1.0,496.0,496.0,5,783,1.0,515.0,515.0
0.083,6,10,1506,5,395,18.0,127.0,127.0,5,1111,18.0,843.0,843.0
0.004,17,2,148,1,60,0.0,32.0,32.0,1,88,0.0,60.0,60.0
280.44,6,23,6075,10,1186,31159.0,267.0,156.0,13,4889,23369.0,1400.0,873.0
0.044,17,2,152,1,76,0.0,48.0,48.0,1,76,0.0,48.0,48.0
0.004,6,10,1779,5,928,1.0,660.0,660.0,5,851,1.0,583.0,583.0
0.166,17,2,152,1,76,0.0,48.0,48.0,1,76,0.0,48.0,48.0
353.154,6,13,1834,7,1348,58859.0,494.0,494.0,6,486,70630.0,83.0,83.0
0.005,17,2,179,1,71,0.0,43.0,43.0,1,108,0.0,80.0,80.0
0.04,17,2,182,1,65,0.0,37.0,37.0,1,117,0.0,89.0,89.0
0.102,6,10,1506,5,395,20.0,127.0,127.0,5,1111,23.0,843.0,843.0
0.041,17,4,284,2,120,0.0,32.0,32.0,2,164,38.0,60.0,54.0
1798.608,6,277,25801,140,9132,12939.0,747.0,263.0,137,16669,13225.0,1624.0,72.0
0.01,6,10,1989,5,910,2.0,642.0,642.0,5,1079,2.0,811.0,811.0
0.011,6,10,1983,5,910,2.0,642.0,642.0,5,1073,2.0,805.0,805.0
40.096,17,10,676,5,460,10023.0,104.0,64.0,5,216,10023.0,20.0,15.0
0.081,6,10,1506,5,395,18.0,127.0,127.0,5,1111,15.0,843.0,843.0
0.081,6,10,1506,5,395,18.0,127.0,127.0,5,1111,18.0,843.0,843.0
0.009,6,10,1631,5,848,2.0,580.0,580.0,5,783,2.0,515.0,515.0
0.005,6,10,1779,5,928,1.0,660.0,660.0,5,851,1.0,583.0,583.0
0.014,6,10,1989,5,910,3.0,642.0,642.0,5,1079,3.0,811.0,811.0
240.093,6,16,4480,9,963,30011.0,238.0,166.0,7,3517,40014.0,1402.0,786.0
0.004,6,10,1989,5,927,1.0,659.0,659.0,5,1062,1.0,794.0,794.0
0.085,6,10,1506,5,395,20.0,127.0,127.0,5,1111,18.0,843.0,843.0
0.009,6,10,1990,5,911,2.0,643.0,643.0,5,1079,2.0,811.0,811.0
0.001,17,2,180,1,66,0.0,38.0,38.0,1,114,0.0,86.0,86.0
0.022,6,10,1989,5,910,5.0,642.0,642.0,5,1079,5.0,811.0,811.0
40.075,17,10,676,5,460,10016.0,104.0,64.0,5,216,10017.0,20.0,15.0
0.004,6,10,2006,5,927,1.0,659.0,659.0,5,1079,1.0,811.0,811.0
0.006,6,10,1547,5,764,1.0,496.0,496.0,5,783,1.0,515.0,515.0
0.004,17,2,234,1,61,0.0,33.0,33.0,1,173,0.0,145.0,145.0
0.004,17,4,284,2,120,0.0,32.0,32.0,2,164,0.0,60.0,54.0
15.075,17,15,9238,8,6902,2149.0,1350.0,834.0,7,2336,2507.0,1350.0,305.0
0.017,6,10,1989,5,910,4.0,642.0,642.0,5,1079,4.0,811.0,811.0
240.085,6,16,4481,9,963,30010.0,238.0,166.0,7,3518,40013.0,1402.0,786.0
0.005,6,10,1854,5,889,1.0,621.0,621.0,5,965,1.0,697.0,697.0
0.06,6,10,1506,5,395,13.0,127.0,127.0,5,1111,13.0,843.0,843.0
0.017,6,10,1762,5,911,4.0,643.0,643.0,5,851,4.0,583.0,583.0
0.005,17,2,144,1,64,0.0,36.0,36.0,1,80,0.0,52.0,52.0
163.035,17,68,9774,34,2267,4940.0,44.0,38.0,34,7507,4940.0,239.0,192.0
0.092,6,10,1506,5,395,21.0,127.0,127.0,5,1111,20.0,843.0,843.0
0.005,6,10,1779,5,928,1.0,660.0,660.0,5,851,1.0,583.0,583.0
139.294,6,33,6264,18,1338,8193.0,267.0,195.0,15,4926,606.0,1823.0,392.0
0.004,6,10,2000,5,927,1.0,659.0,659.0,5,1073,1.0,805.0,805.0
0.005,6,10,2006,5,927,1.0,659.0,659.0,5,1079,1.0,811.0,811.0
0.097,6,10,1506,5,395,22.0,127.0,127.0,5,1111,19.0,843.0,843.0
0.008,6,12,1926,6,1189,1.0,659.0,434.0,6,737,1.0,417.0,417.0
0.005,6,10,1989,5,927,1.0,659.0,659.0,5,1062,1.0,794.0,794.0
0.007,6,12,1698,6,863,1.0,327.0,271.0,6,835,1.0,515.0,515.0
0.213,6,16,2777,8,1395,30.0,533.0,323.0,8,1382,18.0,529.0,239.0
40.087,17,10,676,5,460,10017.0,104.0,64.0,5,216,10018.0,20.0,15.0
0.005,6,10,1989,5,927,1.0,659.0,659.0,5,1062,1.0,794.0,794.0
0.007,6,10,1547,5,764,1.0,496.0,496.0,5,783,1.0,515.0,515.0
40.071,17,10,676,5,460,10016.0,104.0,64.0,5,216,10017.0,20.0,15.0
0.081,6,10,1506,5,395,18.0,127.0,127.0,5,1111,16.0,843.0,843.0
0.014,6,10,1989,5,910,3.0,642.0,642.0,5,1079,3.0,811.0,811.0
240.089,6,32,9382,16,6971,16005.0,2043.0,682.0,16,2411,16005.0,580.0,196.0
240.61,6,33,9263,16,1835,16038.0,623.0,199.0,17,7428,15036.0,1402.0,595.0
0.001,17,2,136,1,60,0.0,32.0,32.0,1,76,0.0,48.0,48.0
0.012,6,10,1631,5,848,3.0,580.0,580.0,5,783,3.0,515.0,515.0
0.014,6,10,1762,5,911,3.0,643.0,643.0,5,851,3.0,583.0,583.0
0.001,17,2,132,1,58,0.0,30.0,30.0,1,74,0.0,46.0,46.0
5.096,6,21,5923,12,1436,463.0,474.0,201.0,9,4487,636.0,1925.0,804.0
0.042,17,4,284,2,120,0.0,32.0,32.0,2,164,38.0,60.0,54.0
0.039,17,2,412,1,61,0.0,33.0,33.0,1,351,0.0,323.0,323.0
361.814,6,21,1792,16,1030,24120.0,190.0,190.0,5,762,60010.0,461.0,247.0
0.001,17,2,180,1,66,0.0,38.0,38.0,1,114,0.0,86.0,86.0
0.02,6,10,1989,5,910,5.0,642.0,642.0,5,1079,4.0,811.0,811.0
0.072,17,2,148,1,60,0.0,32.0,32.0,1,88,0.0,60.0,60.0
0.013,6,10,1547,5,764,3.0,496.0,496.0,5,783,3.0,515.0,515.0
0.071,6,44,13977,24,2503,3.0,517.0,139.0,20,11474,3.0,1402.0,744.0
0.135,17,2,136,1,60,0.0,32.0,32.0,1,76,0.0,48.0,48.0
0.006,6,10,1547,5,764,1.0,496.0,496.0,5,783,1.0,515.0,515.0
0.005,6,10,1989,5,927,1.0,659.0,659.0,5,1062,1.0,794.0,794.0
0.005,17,4,284,2,120,2.0,32.0,32.0,2,164,2.0,60.0,54.0
0.015,6,10,1677,5,827,3.0,559.0,559.0,5,850,3.0,582.0,582.0
300.916,6,37,8933,20,3455,15837.0,1360.0,524.0,17,5478,542.0,2667.0,435.0
40.057,17,10,676,5,460,10013.0,104.0,64.0,5,216,10013.0,20.0,15.0
0.004,17,2,136,1,60,0.0,32.0,32.0,1,76,0.0,48.0,48.0
0.001,17,2,180,1,66,0.0,38.0,38.0,1,114,0.0,86.0,86.0
0.001,17,2,180,1,66,0.0,38.0,38.0,1,114,0.0,86.0,86.0
0.005,17,2,168,1,76,0.0,48.0,48.0,1,92,0.0,64.0,64.0
0.005,6,10,2006,5,927,1.0,659.0,659.0,5,1079,1.0,811.0,811.0
0.014,6,10,1677,5,827,3.0,559.0,559.0,5,850,3.0,582.0,582.0
240.15,6,46,6991,22,3224,11435.0,588.0,230.0,24,3767,10441.0,580.0,228.0
0.005,6,14,3742,7,452,0.0,80.0,80.0,7,3290,0.0,1448.0,972.0
0.055,6,10,1506,5,395,13.0,127.0,127.0,5,1111,12.0,843.0,843.0
0.084,6,10,1506,5,395,20.0,127.0,127.0,5,1111,17.0,843.0,843.0
0.005,6,10,2006,5,927,1.0,659.0,659.0,5,1079,1.0,811.0,811.0
0.013,6,10,1990,5,911,3.0,643.0,643.0,5,1079,3.0,811.0,811.0
300.336,6,16,2170,9,684,37521.0,146.0,146.0,7,1486,50028.0,419.0,398.0
0.004,17,4,284,2,120,0.0,32.0,32.0,2,164,0.0,60.0,54.0
0.114,6,10,1506,5,395,26.0,127.0,127.0,5,1111,23.0,843.0,843.0
0.005,6,10,2006,5,927,1.0,659.0,659.0,5,1079,1.0,811.0,811.0
9.036,17,6,376,5,280,2259.0,28.0,28.0,1,96,0.0,68.0,68.0
0.007,17,2,230,1,68,0.0,40.0,40.0,1,162,0.0,134.0,134.0
0.013,6,10,1989,5,910,3.0,642.0,642.0,5,1079,3.0,811.0,811.0
0.012,6,13,3735,7,497,2.0,125.0,125.0,6,3238,2.0,1470.0,1459.0
0.006,6,10,1547,5,764,1.0,496.0,496.0,5,783,1.0,515.0,515.0
0.017,6,10,1677,5,827,4.0,559.0,559.0,5,850,4.0,582.0,582.0
0.004,6,10,2000,5,927,1.0,659.0,659.0,5,1073,1.0,805.0,805.0
0.008,6,10,1989,5,910,2.0,642.0,642.0,5,1079,1.0,811.0,811.0
0.081,6,10,1506,5,395,17.0,127.0,127.0,5,1111,16.0,843.0,843.0
0.113,6,10,1506,5,395,24.0,127.0,127.0,5,1111,25.0,843.0,843.0
0.005,17,2,170,1,65,0.0,37.0,37.0,1,105,0.0,77.0,77.0
0.07,6,10,1506,5,395,12.0,127.0,127.0,5,1111,16.0,843.0,843.0
0.101,6,10,1506,5,395,23.0,127.0,127.0,5,1111,22.0,843.0,843.0
0.009,6,10,1677,5,827,2.0,559.0,559.0,5,850,2.0,582.0,582.0
172.24,17,76,10834,38,2530,4655.0,44.0,38.0,38,8304,4655.0,239.0,190.0
0.004,6,10,2007,5,928,1.0,660.0,660.0,5,1079,1.0,811.0,811.0
0.013,6,10,1990,5,911,3.0,643.0,643.0,5,1079,3.0,811.0,811.0
0.005,6,10,2007,5,928,1.0,660.0,660.0,5,1079,1.0,811.0,811.0
0.005,6,10,1989,5,927,1.0,659.0,659.0,5,1062,1.0,794.0,794.0
0.009,6,10,1972,5,910,2.0,642.0,642.0,5,1062,2.0,794.0,794.0
0.103,6,10,1506,5,395,21.0,127.0,127.0,5,1111,25.0,843.0,843.0
0.085,6,10,1506,5,395,17.0,127.0,127.0,5,1111,19.0,843.0,843.0
0.027,17,2,198,1,91,0.0,63.0,63.0,1,107,0.0,79.0,79.0
0.005,6,10,2006,5,927,1.0,659.0,659.0,5,1079,1.0,811.0,811.0
0.211,6,16,2669,8,1395,30.0,533.0,323.0,8,1274,19.0,529.0,212.0
0.008,6,10,1990,5,911,2.0,643.0,643.0,5,1079,2.0,811.0,811.0
0.006,6,10,1547,5,764,1.0,496.0,496.0,5,783,1.0,515.0,515.0
0.008,6,10,1989,5,910,2.0,642.0,642.0,5,1079,1.0,811.0,811.0
0.009,6,10,1972,5,910,2.0,642.0,642.0,5,1062,2.0,794.0,794.0
0.004,6,10,1702,5,863,1.0,595.0,595.0,5,839,0.0,571.0,571.0
0.015,6,10,1762,5,911,3.0,643.0,643.0,5,851,3.0,583.0,583.0
0.017,6,10,1990,5,911,4.0,643.0,643.0,5,1079,4.0,811.0,811.0
308.421,17,20,1124,10,716,34255.0,48.0,43.0,10,408,34255.0,20.0,12.0
0.005,6,10,2006,5,927,1.0,659.0,659.0,5,1079,1.0,811.0,811.0
0.017,6,10,1677,5,827,4.0,559.0,559.0,5,850,4.0,582.0,582.0
0.004,6,10,2007,5,928,1.0,660.0,660.0,5,1079,1.0,811.0,811.0
0.125,6,10,1506,5,395,29.0,127.0,127.0,5,1111,27.0,843.0,843.0
0.004,17,4,284,2,120,0.0,32.0,32.0,2,164,0.0,60.0,54.0
0.075,6,10,1506,5,395,17.0,127.0,127.0,5,1111,16.0,843.0,843.0
0.007,6,10,1990,5,911,1.0,643.0,643.0,5,1079,1.0,811.0,811.0
40.054,17,10,676,5,460,10012.0,104.0,64.0,5,216,10012.0,20.0,15.0
0.042,17,2,182,1,65,0.0,37.0,37.0,1,117,0.0,89.0,89.0
11.132,17,28,4422,14,1995,843.0,270.0,114.0,14,2427,843.0,586.0,145.0
0.005,6,10,2000,5,927,1.0,659.0,659.0,5,1073,1.0,805.0,805.0
0.005,6,10,2006,5,927,1.0,659.0,659.0,5,1079,1.0,811.0,811.0
0.004,6,10,1702,5,863,1.0,595.0,595.0,5,839,1.0,571.0,571.0
0.103,6,10,1506,5,395,21.0,127.0,127.0,5,1111,24.0,843.0,843.0
40.063,17,10,676,5,460,10014.0,104.0,64.0,5,216,10014.0,20.0,15.0
0.005,6,10,1779,5,928,1.0,660.0,660.0,5,851,1.0,583.0,583.0
40.069,17,10,676,5,460,10014.0,104.0,64.0,5,216,10016.0,20.0,15.0
0.005,17,2,179,1,71,0.0,43.0,43.0,1,108,0.0,80.0,80.0
0.004,6,10,2006,5,927,1.0,659.0,659.0,5,1079,1.0,811.0,811.0
0.067,17,8,3613,4,1874,22.0,1350.0,440.0,4,1739,10.0,1350.0,406.0
0.085,6,10,1506,5,395,20.0,127.0,127.0,5,1111,19.0,843.0,843.0
0.005,6,10,2006,5,927,1.0,659.0,659.0,5,1079,1.0,811.0,811.0
0.011,6,10,1972,5,910,2.0,642.0,642.0,5,1062,2.0,794.0,794.0
0.058,17,2,179,1,71,0.0,43.0,43.0,1,108,0.0,80.0,80.0
0.142,6,10,1506,5,395,31.0,127.0,127.0,5,1111,34.0,843.0,843.0
0.007,6,10,1689,5,839,1.0,571.0,571.0,5,850,1.0,582.0,582.0
0.013,6,10,1631,5,848,3.0,580.0,580.0,5,783,3.0,515.0,515.0
0.096,6,10,1506,5,395,21.0,127.0,127.0,5,1111,19.0,843.0,843.0
240.013,6,9,787,5,488,60003.0,232.0,232.0,4,299,80002.0,83.0,83.0
0.012,6,13,3735,7,497,1.0,125.0,125.0,6,3238,2.0,1470.0,1459.0
0.08,6,10,1506,5,395,19.0,127.0,127.0,5,1111,18.0,843.0,843.0
0.011,6,10,1983,5,910,2.0,642.0,642.0,5,1073,2.0,805.0,805.0
0.107,6,10,1506,5,395,24.0,127.0,127.0,5,1111,22.0,843.0,843.0
0.011,6,10,1989,5,910,2.0,642.0,642.0,5,1079,2.0,811.0,811.0
0.003,17,2,136,1,60,0.0,32.0,32.0,1,76,0.0,48.0,48.0
0.017,6,10,1989,5,910,4.0,642.0,642.0,5,1079,4.0,811.0,811.0
240.5,6,33,8636,17,1839,15029.0,572.0,189.0,16,6797,16031.0,1402.0,596.0
0.004,17,2,140,1,62,0.0,34.0,34.0,1,78,0.0,50.0,50.0
0.004,6,10,2007,5,928,1.0,660.0,660.0,5,1079,1.0,811.0,811.0
0.005,6,13,3690,7,452,0.0,80.0,80.0,6,3238,0.0,1470.0,1459.0
0.07,6,10,1506,5,395,13.0,127.0,127.0,5,1111,17.0,843.0,843.0
240.093,6,31,9183,15,6948,17149.0,2072.0,685.0,16,2235,16006.0,580.0,174.0
0.005,17,2,140,1,62,0.0,34.0,34.0,1,78,0.0,50.0,50.0
0.061,6,10,1506,5,395,13.0,127.0,127.0,5,1111,12.0,843.0,843.0
0.005,17,2,180,1,66,0.0,38.0,38.0,1,114,0.0,86.0,86.0
0.005,17,2,164,1,74,0.0,46.0,46.0,1,90,0.0,62.0,62.0
0.006,6,10,1547,5,764,1.0,496.0,496.0,5,783,1.0,515.0,515.0
0.107,6,10,1506,5,395,19.0,127.0,127.0,5,1111,23.0,843.0,843.0
0.009,17,2,154,1,69,0.0,41.0,41.0,1,85,0.0,57.0,57.0
240.012,6,9,787,5,488,60003.0,232.0,232.0,4,299,80002.0,83.0,83.0
0.01,6,10,1972,5,910,2.0,642.0,642.0,5,1062,2.0,794.0,794.0
0.005,6,10,2006,5,927,1.0,659.0,659.0,5,1079,1.0,811.0,811.0
0.009,6,10,1990,5,911,2.0,643.0,643.0,5,1079,2.0,811.0,811.0
527.613,17,138,20267,69,4639,7758.0,44.0,39.0,69,15628,7758.0,239.0,198.0
0.068,17,8,3613,4,1874,22.0,1350.0,440.0,4,1739,12.0,1350.0,406.0
0.155,6,10,1506,5,395,36.0,127.0,127.0,5,1111,36.0,843.0,843.0
0.219,6,16,2777,8,1395,31.0,533.0,323.0,8,1382,19.0,529.0,239.0
0.004,17,2,136,1,60,0.0,32.0,32.0,1,76,0.0,48.0,48.0
0.072,6,10,1506,5,395,16.0,127.0,127.0,5,1111,16.0,843.0,843.0
0.006,6,10,1547,5,764,1.0,496.0,496.0,5,783,1.0,515.0,515.0
0.007,6,10,1972,5,910,1.0,642.0,642.0,5,1062,1.0,794.0,794.0
0.006,6,10,1547,5,764,1.0,496.0,496.0,5,783,1.0,515.0,515.0
0.008,6,12,1926,6,1189,1.0,659.0,434.0,6,737,1.0,417.0,417.0
0.006,17,2,230,1,68,0.0,40.0,40.0,1,162,0.0,134.0,134.0
0.006,6,10,1547,5,764,1.0,496.0,496.0,5,783,1.0,515.0,515.0
240.095,6,18,3993,9,2239,30011.0,1215.0,591.0,9,1754,30011.0,967.0,319.0
0.009,17,2,162,1,65,0.0,37.0,37.0,1,97,0.0,69.0,69.0
0.068,6,10,1506,5,395,14.0,127.0,127.0,5,1111,14.0,843.0,843.0
0.04,17,2,148,1,60,0.0,32.0,32.0,1,88,0.0,60.0,60.0
0.006,6,10,1547,5,764,1.0,496.0,496.0,5,783,1.0,515.0,515.0
0.019,6,14,3787,7,497,3.0,125.0,125.0,7,3290,3.0,1448.0,972.0
0.006,17,2,136,1,60,0.0,32.0,32.0,1,76,0.0,48.0,48.0
21.206,17,24,14848,13,12031,1764.0,1350.0,897.0,11,2817,2117.0,1350.0,228.0
0.012,6,10,1989,5,910,3.0,642.0,642.0,5,1079,3.0,811.0,811.0
0.005,6,10,2006,5,927,1.0,659.0,659.0,5,1079,1.0,811.0,811.0
0.089,6,10,1506,5,395,19.0,127.0,127.0,5,1111,18.0,843.0,843.0
0.043,17,4,284,2,120,0.0,32.0,32.0,2,164,39.0,60.0,54.0
0.069,6,10,1506,5,395,16.0,127.0,127.0,5,1111,13.0,843.0,843.0
0.112,6,10,1506,5,395,25.0,127.0,127.0,5,1111,23.0,843.0,843.0
40.065,17,10,676,5,460,10015.0,104.0,64.0,5,216,10015.0,20.0,15.0
240.157,6,31,9700,15,7143,17154.0,2266.0,707.0,16,2557,16010.0,580.0,214.0
0.01,6,10,1677,5,827,2.0,559.0,559.0,5,850,2.0,582.0,582.0
0.096,6,10,1506,5,395,22.0,127.0,127.0,5,1111,20.0,843.0,843.0
0.005,6,10,1689,5,839,1.0,571.0,571.0,5,850,1.0,582.0,582.0
0.027,6,10,1972,5,910,6.0,642.0,642.0,5,1062,6.0,794.0,794.0
0.003,17,2,148,1,60,0.0,32.0,32.0,1,88,0.0,60.0,60.0
40.072,17,10,676,5,460,10016.0,104.0,64.0,5,216,10017.0,20.0,15.0
0.018,6,10,1972,5,910,4.0,642.0,642.0,5,1062,4.0,794.0,794.0
300.386,6,16,2170,9,684,37527.0,146.0,146.0,7,1486,50036.0,419.0,398.0
0.005,6,10,2007,5,928,1.0,660.0,660.0,5,1079,1.0,811.0,811.0
0.006,6,10,1547,5,764,1.0,496.0,496.0,5,783,1.0,515.0,515.0
0.008,6,10,1989,5,910,1.0,642.0,642.0,5,1079,1.0,811.0,811.0
40.07,17,10,676,5,460,10016.0,104.0,64.0,5,216,10016.0,20.0,15.0
156.495,17,72,10119,36,2393,4471.0,44.0,38.0,36,7726,4471.0,261.0,186.0
167.192,17,82,11897,41,2752,4179.0,44.0,39.0,41,9145,4179.0,239.0,195.0
0.01,6,10,1762,5,911,2.0,643.0,643.0,5,851,2.0,583.0,583.0
0.08,6,10,1506,5,395,16.0,127.0,127.0,5,1111,18.0,843.0,843.0
0.082,6,10,1506,5,395,17.0,127.0,127.0,5,1111,16.0,843.0,843.0
0.007,6,10,1762,5,911,1.0,643.0,643.0,5,851,1.0,583.0,583.0
0.006,6,12,1698,6,863,1.0,327.0,271.0,6,835,1.0,515.0,515.0
0.007,6,10,1689,5,839,1.0,571.0,571.0,5,850,1.0,582.0,582.0
0.133,6,10,1506,5,395,25.0,127.0,127.0,5,1111,27.0,843.0,843.0
0.754,6,22,5168,11,1138,63.0,267.0,115.0,11,4030,63.0,1414.0,597.0
0.004,6,10,2006,5,927,1.0,659.0,659.0,5,1079,1.0,811.0,811.0
0.004,6,10,2006,5,927,1.0,659.0,659.0,5,1079,1.0,811.0,811.0
0.005,17,2,144,1,64,0.0,36.0,36.0,1,80,0.0,52.0,52.0
0.004,6,10,1702,5,863,1.0,595.0,595.0,5,839,1.0,571.0,571.0
0.009,6,13,3735,7,497,1.0,125.0,125.0,6,3238,1.0,1470.0,1459.0
0.138,6,10,1506,5,395,29.0,127.0,127.0,5,1111,17.0,843.0,843.0
0.007,6,10,2000,5,927,1.0,659.0,659.0,5,1073,1.0,805.0,805.0
0.08,6,10,1506,5,395,16.0,127.0,127.0,5,1111,18.0,843.0,843.0
0.005,6,10,2006,5,927,1.0,659.0,659.0,5,1079,1.0,811.0,811.0
0.783,6,10,1905,6,1551,156.0,1299.0,1299.0,4,354,180.0,182.0,182.0
0.013,6,10,1989,5,910,3.0,642.0,642.0,5,1079,3.0,811.0,811.0
40.094,17,10,676,5,460,10022.0,104.0,64.0,5,216,10022.0,20.0,15.0
0.212,6,16,2670,8,1396,30.0,533.0,324.0,8,1274,19.0,529.0,212.0
40.072,17,10,676,5,460,10015.0,104.0,64.0,5,216,10017.0,20.0,15.0
0.005,17,2,214,1,75,0.0,47.0,47.0,1,139,0.0,111.0,111.0
0.076,6,10,1506,5,395,15.0,127.0,127.0,5,1111,16.0,843.0,843.0
0.005,6,10,2000,5,927,1.0,659.0,659.0,5,1073,1.0,805.0,805.0
0.01,6,12,1926,6,1189,2.0,659.0,434.0,6,737,1.0,417.0,417.0
0.005,6,10,2007,5,928,1.0,660.0,660.0,5,1079,1.0,811.0,811.0
0.005,6,10,2006,5,927,1.0,659.0,659.0,5,1079,1.0,811.0,811.0
0.029,6,10,1972,5,910,7.0,642.0,642.0,5,1062,7.0,794.0,794.0
0.004,6,10,1774,5,923,1.0,655.0,655.0,5,851,1.0,583.0,583.0
0.008,17,2,144,1,64,0.0,36.0,36.0,1,80,0.0,52.0,52.0
40.069,17,10,676,5,460,10016.0,104.0,64.0,5,216,10016.0,20.0,15.0
0.015,6,10,1989,5,910,3.0,642.0,642.0,5,1079,3.0,811.0,811.0
0.005,17,4,284,2,120,0.0,32.0,32.0,2,164,0.0,60.0,54.0
40.065,17,10,676,5,460,10015.0,104.0,64.0,5,216,10015.0,20.0,15.0
0.009,6,10,1989,5,910,2.0,642.0,642.0,5,1079,2.0,811.0,811.0
0.144,6,10,1506,5,395,33.0,127.0,127.0,5,1111,31.0,843.0,843.0
0.004,6,10,2006,5,927,1.0,659.0,659.0,5,1079,1.0,811.0,811.0
0.007,6,10,1983,5,910,1.0,642.0,642.0,5,1073,1.0,805.0,805.0
0.011,6,10,1983,5,910,2.0,642.0,642.0,5,1073,2.0,805.0,805.0
309.09,17,20,1124,10,716,34328.0,48.0,43.0,10,408,34329.0,20.0,12.0
0.004,6,10,2007,5,928,1.0,660.0,660.0,5,1079,1.0,811.0,811.0
0.005,6,10,2000,5,927,1.0,659.0,659.0,5,1073,1.0,805.0,805.0
0.006,6,10,1774,5,923,1.0,655.0,655.0,5,851,1.0,583.0,583.0
0.014,6,10,1631,5,848,3.0,580.0,580.0,5,783,3.0,515.0,515.0
0.006,6,10,1547,5,764,1.0,496.0,496.0,5,783,1.0,515.0,515.0
0.005,6,13,3747,7,509,0.0,137.0,137.0,6,3238,1.0,1470.0,1459.0
0.018,6,10,1990,5,911,4.0,643.0,643.0,5,1079,4.0,811.0,811.0
0.005,6,10,2007,5,928,1.0,660.0,660.0,5,1079,1.0,811.0,811.0
0.006,6,10,2007,5,928,1.0,660.0,660.0,5,1079,1.0,811.0,811.0
0.005,6,14,3799,7,509,0.0,137.0,137.0,7,3290,0.0,1448.0,972.0
0.087,6,10,1506,5,395,20.0,127.0,127.0,5,1111,19.0,843.0,843.0
0.12,6,10,1506,5,395,22.0,127.0,127.0,5,1111,25.0,843.0,843.0
0.013,6,10,1989,5,910,3.0,642.0,642.0,5,1079,3.0,811.0,811.0
0.001,17,2,180,1,66,0.0,38.0,38.0,1,114,0.0,86.0,86.0
0.003,17,2,136,1,60,0.0,32.0,32.0,1,76,0.0,48.0,48.0
0.004,6,10,2006,5,927,1.0,659.0,659.0,5,1079,1.0,811.0,811.0
0.004,6,10,2006,5,927,1.0,659.0,659.0,5,1079,1.0,811.0,811.0
0.004,17,2,144,1,64,0.0,36.0,36.0,1,80,0.0,52.0,52.0
300.344,6,16,2170,9,684,37522.0,146.0,146.0,7,1486,50030.0,419.0,398.0
0.01,6,10,1990,5,911,2.0,643.0,643.0,5,1079,2.0,811.0,811.0
0.084,6,10,1506,5,395,18.0,127.0,127.0,5,1111,17.0,843.0,843.0
0.006,6,10,1643,5,860,1.0,592.0,592.0,5,783,1.0,515.0,515.0
0.004,17,2,148,1,60,0.0,32.0,32.0,1,88,0.0,60.0,60.0
0.005,17,2,194,1,59,0.0,31.0,31.0,1,135,0.0,107.0,107.0
0.003,17,2,136,1,60,0.0,32.0,32.0,1,76,0.0,48.0,48.0
0.006,6,10,1547,5,764,1.0,496.0,496.0,5,783,1.0,515.0,515.0
0.009,6,10,1990,5,911,2.0,643.0,643.0,5,1079,2.0,811.0,811.0
308.538,17,20,1124,10,716,34267.0,48.0,43.0,10,408,34267.0,20.0,12.0
0.016,6,10,1631,5,848,3.0,580.0,580.0,5,783,3.0,515.0,515.0
0.098,6,10,1506,5,395,22.0,127.0,127.0,5,1111,17.0,843.0,843.0
15.074,17,14,9190,8,6902,2149.0,1350.0,834.0,6,2288,3009.0,1350.0,353.0
0.005,6,10,1689,5,839,1.0,571.0,571.0,5,850,1.0,582.0,582.0
0.007,17,2,179,1,71,0.0,43.0,43.0,1,108,0.0,80.0,80.0
0.105,6,10,1506,5,395,24.0,127.0,127.0,5,1111,23.0,843.0,843.0
0.007,6,10,1689,5,839,1.0,571.0,571.0,5,850,1.0,582.0,582.0
0.08,6,10,1506,5,395,19.0,127.0,127.0,5,1111,19.0,843.0,843.0
0.04,17,2,136,1,60,0.0,32.0,32.0,1,76,0.0,48.0,48.0
40.069,17,10,676,5,460,10015.0,104.0,64.0,5,216,10016.0,20.0,15.0
0.101,6,10,1506,5,395,24.0,127.0,127.0,5,1111,20.0,843.0,843.0
0.005,6,10,2006,5,927,1.0,659.0,659.0,5,1079,1.0,811.0,811.0
0.008,6,10,1972,5,910,1.0,642.0,642.0,5,1062,2.0,794.0,794.0
0.004,6,10,2007,5,928,1.0,660.0,660.0,5,1079,1.0,811.0,811.0
0.04,17,2,182,1,65,0.0,37.0,37.0,1,117,0.0,89.0,89.0
11.168,17,28,4420,14,1995,846.0,270.0,114.0,14,2425,846.0,588.0,145.0
0.039,17,2,170,1,65,0.0,37.0,37.0,1,105,0.0,77.0,77.0
0.006,6,10,1643,5,860,1.0,592.0,592.0,5,783,1.0,515.0,515.0
0.001,17,2,136,1,60,0.0,32.0,32.0,1,76,0.0,48.0,48.0
0.004,6,10,1702,5,863,1.0,595.0,595.0,5,839,1.0,571.0,571.0
0.012,6,10,1983,5,910,3.0,642.0,642.0,5,1073,3.0,805.0,805.0
0.013,17,2,293,1,73,0.0,45.0,45.0,1,220,0.0,192.0,192.0
167.27,17,78,11033,39,2600,4401.0,44.0,38.0,39,8433,4401.0,239.0,188.0
40.056,17,10,676,5,460,10013.0,104.0,64.0,5,216,10013.0,20.0,15.0
0.013,6,10,1989,5,910,3.0,642.0,642.0,5,1079,3.0,811.0,811.0
0.004,6,10,1989,5,927,1.0,659.0,659.0,5,1062,1.0,794.0,794.0
0.005,6,10,2000,5,927,1.0,659.0,659.0,5,1073,1.0,805.0,805.0
0.007,6,10,1972,5,910,1.0,642.0,642.0,5,1062,1.0,794.0,794.0
0.001,17,2,166,1,75,0.0,47.0,47.0,1,91,0.0,63.0,63.0
8.844,6,35,8460,18,2030,520.0,922.0,426.0,17,6430,542.0,2720.0,478.0
0.074,6,10,1506,5,395,17.0,127.0,127.0,5,1111,16.0,843.0,843.0
0.07,6,10,1506,5,395,14.0,127.0,127.0,5,1111,16.0,843.0,843.0
40.06,17,10,676,5,460,10012.0,104.0,64.0,5,216,10014.0,20.0,15.0
0.011,6,10,1989,5,910,2.0,642.0,642.0,5,1079,2.0,811.0,811.0
0.008,6,10,1990,5,911,2.0,643.0,643.0,5,1079,2.0,811.0,811.0
11.094,17,28,4398,14,2312,844.0,587.0,137.0,14,2086,844.0,269.0,121.0
300.259,6,25,7303,15,1357,21447.0,217.0,142.0,10,5946,26693.0,1679.0,903.0
0.222,6,16,2777,8,1395,31.0,533.0,323.0,8,1382,20.0,529.0,239.0
240.144,6,50,7023,24,3367,10440.0,588.0,211.0,26,3656,9605.0,580.0,191.0
240.35,6,25,4157,12,1808,21846.0,539.0,235.0,13,2349,20026.0,1303.0,239.0
0.006,6,10,1689,5,839,1.0,571.0,571.0,5,850,1.0,582.0,582.0
0.23,6,16,2777,8,1395,32.0,533.0,323.0,8,1382,21.0,529.0,239.0
0.011,6,10,1989,5,910,2.0,642.0,642.0,5,1079,2.0,811.0,811.0
0.011,6,10,1989,5,910,2.0,642.0,642.0,5,1079,2.0,811.0,811.0
0.037,17,2,152,1,76,0.0,48.0,48.0,1,76,0.0,48.0,48.0
40.065,17,10,676,5,460,10015.0,104.0,64.0,5,216,10015.0,20.0,15.0
0.017,6,10,1983,5,910,4.0,642.0,642.0,5,1073,4.0,805.0,805.0
0.116,6,10,1506,5,395,24.0,127.0,127.0,5,1111,23.0,843.0,843.0
0.012,6,10,1990,5,911,3.0,643.0,643.0,5,1079,3.0,811.0,811.0
0.006,6,10,2006,5,927,1.0,659.0,659.0,5,1079,1.0,811.0,811.0
300.404,6,27,8925,15,1930,21457.0,517.0,285.0,12,6995,21853.0,1402.0,909.0
0.024,6,13,3735,7,497,4.0,125.0,125.0,6,3238,4.0,1470.0,1459.0
177.356,17,80,11210,40,2667,4547.0,44.0,38.0,40,8543,4547.0,239.0,185.0
11.037,17,28,4397,14,2311,840.0,586.0,137.0,14,2086,840.0,269.0,121.0
1730.37,6,45,2790,30,1725,59667.0,35.0,35.0,15,1065,123592.0,31.0,31.0
0.004,6,10,2007,5,928,1.0,660.0,660.0,5,1079,1.0,811.0,811.0
0.003,17,2,136,1,60,0.0,32.0,32.0,1,76,0.0,48.0,48.0
0.007,6,10,1547,5,764,1.0,496.0,496.0,5,783,1.0,515.0,515.0
0.017,6,10,1983,5,910,4.0,642.0,642.0,5,1073,4.0,805.0,805.0
40.069,17,10,676,5,460,10014.0,104.0,64.0,5,216,10016.0,20.0,15.0
134.225,6,24,10275,14,4108,10325.0,1579.0,674.0,10,6167,7347.0,2111.0,939.0
0.106,6,10,1506,5,395,25.0,127.0,127.0,5,1111,24.0,843.0,843.0
0.004,6,10,2007,5,928,1.0,660.0,660.0,5,1079,1.0,811.0,811.0
0.092,6,10,1506,5,395,20.0,127.0,127.0,5,1111,21.0,843.0,843.0
0.004,17,2,148,1,60,0.0,32.0,32.0,1,88,0.0,60.0,60.0
0.14,6,10,1506,5,395,30.0,127.0,127.0,5,1111,31.0,843.0,843.0
0.004,6,10,1702,5,863,1.0,595.0,595.0,5,839,0.0,571.0,571.0
0.062,17,2,152,1,76,0.0,48.0,48.0,1,76,0.0,48.0,48.0
0.088,6,10,1506,5,395,19.0,127.0,127.0,5,1111,18.0,843.0,843.0
0.102,6,10,1506,5,395,24.0,127.0,127.0,5,1111,22.0,843.0,843.0
0.011,6,10,1990,5,911,2.0,643.0,643.0,5,1079,2.0,811.0,811.0
0.004,6,10,1774,5,923,1.0,655.0,655.0,5,851,1.0,583.0,583.0
0.041,17,2,225,1,65,0.0,37.0,37.0,1,160,0.0,132.0,132.0
0.122,6,10,1506,5,395,28.0,127.0,127.0,5,1111,28.0,843.0,843.0
354.036,6,19,1691,15,978,25288.0,190.0,190.0,4,713,80002.0,497.0,497.0
0.001,17,2,179,1,62,0.0,34.0,34.0,1,117,0.0,89.0,89.0
40.053,17,10,676,5,460,10012.0,104.0,64.0,5,216,10012.0,20.0,15.0
300.355,6,16,2170,9,684,37523.0,146.0,146.0,7,1486,50031.0,419.0,398.0
0.004,6,10,1779,5,928,1.0,660.0,660.0,5,851,1.0,583.0,583.0
0.014,6,10,1972,5,910,3.0,642.0,642.0,5,1062,3.0,794.0,794.0
308.919,17,18,1044,10,716,34309.0,48.0,43.0,8,328,44108.0,20.0,13.0
10.909,17,28,4422,14,1993,830.0,268.0,114.0,14,2429,830.0,588.0,145.0
0.178,6,3,453,2,321,178.0,241.0,241.0,1,132,0.0,92.0,92.0
0.003,17,2,148,1,60,0.0,32.0,32.0,1,88,0.0,60.0,60.0
0.11,6,10,1506,5,395,23.0,127.0,127.0,5,1111,27.0,843.0,843.0
0.013,6,10,1989,5,910,3.0,642.0,642.0,5,1079,3.0,811.0,811.0
0.204,6,3,453,2,321,204.0,241.0,241.0,1,132,0.0,92.0,92.0
0.005,6,10,2006,5,927,1.0,659.0,659.0,5,1079,1.0,811.0,811.0
0.006,6,13,3747,7,509,0.0,137.0,137.0,6,3238,1.0,1470.0,1459.0
0.041,17,4,284,2,120,0.0,32.0,32.0,2,164,37.0,60.0,54.0
0.004,17,2,136,1,60,0.0,32.0,32.0,1,76,0.0,48.0,48.0
0.013,6,10,1990,5,911,3.0,643.0,643.0,5,1079,3.0,811.0,811.0
0.005,6,10,2000,5,927,1.0,659.0,659.0,5,1073,1.0,805.0,805.0
0.005,6,10,1689,5,839,1.0,571.0,571.0,5,850,1.0,582.0,582.0
0.005,6,10,2006,5,927,1.0,659.0,659.0,5,1079,1.0,811.0,811.0
0.003,17,2,148,1,60,0.0,32.0,32.0,1,88,0.0,60.0,60.0
0.109,6,10,1506,5,395,24.0,127.0,127.0,5,1111,25.0,843.0,843.0
0.017,6,10,1972,5,910,4.0,642.0,642.0,5,1062,4.0,794.0,794.0
0.005,6,10,1689,5,839,1.0,571.0,571.0,5,850,1.0,582.0,582.0
0.001,17,2,180,1,66,0.0,38.0,38.0,1,114,0.0,86.0,86.0
0.007,17,2,179,1,71,0.0,43.0,43.0,1,108,0.0,80.0,80.0
0.124,6,10,1506,5,395,27.0,127.0,127.0,5,1111,26.0,843.0,843.0
0.06,6,13,3735,7,497,10.0,125.0,125.0,6,3238,12.0,1470.0,1459.0
0.015,6,10,1989,5,910,3.0,642.0,642.0,5,1079,3.0,811.0,811.0
0.014,6,10,1972,5,910,3.0,642.0,642.0,5,1062,3.0,794.0,794.0
0.005,6,10,2007,5,928,1.0,660.0,660.0,5,1079,1.0,811.0,811.0
0.009,6,10,1989,5,910,2.0,642.0,642.0,5,1079,2.0,811.0,811.0
0.009,6,10,1990,5,911,2.0,643.0,643.0,5,1079,2.0,811.0,811.0
0.014,6,10,1989,5,910,3.0,642.0,642.0,5,1079,3.0,811.0,811.0
0.124,6,10,1506,5,395,29.0,127.0,127.0,5,1111,26.0,843.0,843.0
1770.469,6,83,4368,42,2210,43181.0,26.0,26.0,41,2158,44260.0,26.0,26.0
0.001,17,2,132,1,58,0.0,30.0,30.0,1,74,0.0,46.0,46.0
0.012,6,10,1972,5,910,3.0,642.0,642.0,5,1062,3.0,794.0,794.0
0.082,6,10,1506,5,395,18.0,127.0,127.0,5,1111,18.0,843.0,843.0
172.557,17,80,11357,40,2660,4424.0,44.0,38.0,40,8697,4424.0,261.0,189.0
0.041,17,4,284,2,120,0.0,32.0,32.0,2,164,37.0,60.0,54.0
0.005,6,10,1774,5,923,1.0,655.0,655.0,5,851,1.0,583.0,583.0
0.011,6,13,3735,7,497,1.0,125.0,125.0,6,3238,2.0,1470.0,1459.0
40.069,17,10,676,5,460,10014.0,104.0,64.0,5,216,10016.0,20.0,15.0
0.005,6,10,1774,5,923,1.0,655.0,655.0,5,851,1.0,583.0,583.0
0.006,6,10,2007,5,928,1.0,660.0,660.0,5,1079,1.0,811.0,811.0
0.013,6,10,1972,5,910,3.0,642.0,642.0,5,1062,3.0,794.0,794.0
0.005,6,10,1989,5,927,1.0,659.0,659.0,5,1062,1.0,794.0,794.0
354.015,6,21,1795,16,1030,23601.0,190.0,190.0,5,765,60002.0,464.0,248.0
0.111,6,10,1506,5,395,27.0,127.0,127.0,5,1111,24.0,843.0,843.0
0.004,17,4,284,2,120,0.0,32.0,32.0,2,164,0.0,60.0,54.0
0.107,6,10,1506,5,395,24.0,127.0,127.0,5,1111,20.0,843.0,843.0
0.01,6,10,1762,5,911,2.0,643.0,643.0,5,851,2.0,583.0,583.0
0.005,17,2,214,1,75,0.0,47.0,47.0,1,139,0.0,111.0,111.0
0.009,6,14,3787,7,497,1.0,125.0,125.0,7,3290,1.0,1448.0,972.0
0.105,6,10,1506,5,395,23.0,127.0,127.0,5,1111,24.0,843.0,843.0
0.017,17,2,198,1,91,0.0,63.0,63.0,1,107,0.0,79.0,79.0
0.008,6,10,1677,5,827,1.0,559.0,559.0,5,850,1.0,582.0,582.0
0.01,6,10,1677,5,827,2.0,559.0,559.0,5,850,2.0,582.0,582.0
40.058,17,10,676,5,460,10012.0,104.0,64.0,5,216,10013.0,20.0,15.0
0.004,6,10,1702,5,863,1.0,595.0,595.0,5,839,0.0,571.0,571.0
0.083,6,10,1506,5,395,18.0,127.0,127.0,5,1111,19.0,843.0,843.0
0.039,17,2,186,1,61,0.0,33.0,33.0,1,125,0.0,97.0,97.0
240.011,6,9,787,5,488,60002.0,232.0,232.0,4,299,80003.0,83.0,83.0
70.15,58,5,360,4,288,23383.0,24.0,24.0,1,72,0.0,24.0,24.0
0.013,17,2,152,1,56,0.0,28.0,28.0,1,96,0.0,68.0,68.0
354.031,6,21,1795,16,1030,23602.0,190.0,190.0,5,765,60005.0,464.0,248.0
0.039,17,2,152,1,76,0.0,48.0,48.0,1,76,0.0,48.0,48.0
40.067,17,10,676,5,460,10013.0,104.0,64.0,5,216,10015.0,20.0,15.0
0.058,6,10,1506,5,395,13.0,127.0,127.0,5,1111,13.0,843.0,843.0
0.127,17,4,284,2,120,0.0,32.0,32.0,2,164,90.0,60.0,54.0
0.005,6,10,2006,5,927,1.0,659.0,659.0,5,1079,1.0,811.0,811.0
0.005,6,10,2006,5,927,1.0,659.0,659.0,5,1079,1.0,811.0,811.0
0.008,6,10,1989,5,910,2.0,642.0,642.0,5,1079,2.0,811.0,811.0
0.016,6,10,1631,5,848,4.0,580.0,580.0,5,783,3.0,515.0,515.0
0.004,6,10,2007,5,928,1.0,660.0,660.0,5,1079,1.0,811.0,811.0
0.005,6,10,2006,5,927,1.0,659.0,659.0,5,1079,1.0,811.0,811.0
0.242,6,16,2777,8,1395,34.0,533.0,323.0,8,1382,23.0,529.0,239.0
0.116,6,10,1506,5,395,25.0,127.0,127.0,5,1111,22.0,843.0,843.0
240.026,6,9,787,5,488,60006.0,232.0,232.0,4,299,80007.0,83.0,83.0
0.085,6,10,1506,5,395,18.0,127.0,127.0,5,1111,19.0,843.0,843.0
0.005,17,2,170,1,65,0.0,37.0,37.0,1,105,0.0,77.0,77.0
0.032,6,10,1989,5,910,7.0,642.0,642.0,5,1079,7.0,811.0,811.0
329.098,17,20,1124,10,716,36552.0,48.0,43.0,10,408,36552.0,20.0,12.0
0.001,17,2,180,1,66,0.0,38.0,38.0,1,114,0.0,86.0,86.0
0.001,17,2,174,1,72,0.0,44.0,44.0,1,102,0.0,74.0,74.0
40.095,17,10,676,5,460,10021.0,104.0,64.0,5,216,10023.0,20.0,15.0
0.039,17,4,352,2,130,1.0,37.0,37.0,2,222,35.0,89.0,83.0
1756.23,6,105,6270,60,3525,29765.0,27.0,27.0,45,2745,39913.0,27.0,27.0
0.005,6,10,2006,5,927,1.0,659.0,659.0,5,1079,1.0,811.0,811.0
0.114,6,10,1506,5,395,25.0,127.0,127.0,5,1111,25.0,843.0,843.0
0.004,6,10,2007,5,928,1.0,660.0,660.0,5,1079,1.0,811.0,811.0
0.088,6,10,1506,5,395,12.0,127.0,127.0,5,1111,21.0,843.0,843.0
0.015,6,10,1972,5,910,3.0,642.0,642.0,5,1062,3.0,794.0,794.0
0.111,6,10,1506,5,395,24.0,127.0,127.0,5,1111,25.0,843.0,843.0
11.121,17,28,4422,14,1994,842.0,269.0,114.0,14,2428,842.0,587.0,145.0
280.78,6,24,6440,10,1186,31197.0,267.0,156.0,14,5254,21598.0,1400.0,781.0
0.008,17,2,162,1,65,0.0,37.0,37.0,1,97,0.0,69.0,69.0
300.349,6,16,2170,9,684,37521.0,146.0,146.0,7,1486,50029.0,419.0,398.0
0.016,6,10,1989,5,910,3.0,642.0,642.0,5,1079,3.0,811.0,811.0
0.014,6,10,1972,5,910,3.0,642.0,642.0,5,1062,3.0,794.0,794.0
0.016,6,10,1989,5,910,4.0,642.0,642.0,5,1079,3.0,811.0,811.0
0.015,6,10,1972,5,910,3.0,642.0,642.0,5,1062,3.0,794.0,794.0
177.373,17,86,12197,43,2871,4223.0,44.0,38.0,43,9326,4222.0,239.0,188.0
240.093,6,31,9232,15,6829,17149.0,1955.0,672.0,16,2403,16006.0,580.0,195.0
0.102,6,10,1506,5,395,21.0,127.0,127.0,5,1111,23.0,843.0,843.0
0.006,6,10,1547,5,764,1.0,496.0,496.0,5,783,1.0,515.0,515.0
0.012,6,10,1989,5,910,2.0,642.0,642.0,5,1079,2.0,811.0,811.0
0.018,6,10,1972,5,910,4.0,642.0,642.0,5,1062,4.0,794.0,794.0
0.107,6,10,1506,5,395,20.0,127.0,127.0,5,1111,23.0,843.0,843.0
0.005,17,2,144,1,64,0.0,36.0,36.0,1,80,0.0,52.0,52.0
240.022,6,9,787,5,488,60005.0,232.0,232.0,4,299,80006.0,83.0,83.0
0.701,6,22,5072,11,1250,59.0,325.0,133.0,11,3822,59.0,1414.0,563.0
0.221,17,2,80,1,32,0.0,4.0,4.0,1,48,0.0,20.0,20.0
0.039,17,2,184,1,61,0.0,33.0,33.0,1,123,0.0,95.0,95.0
0.005,17,2,169,1,62,0.0,34.0,34.0,1,107,0.0,79.0,79.0
15.077,17,15,8176,8,6047,2149.0,1350.0,727.0,7,2129,2507.0,1350.0,276.0
0.152,6,10,1506,5,395,29.0,127.0,127.0,5,1111,35.0,843.0,843.0
0.101,6,10,1506,5,395,20.0,127.0,127.0,5,1111,20.0,843.0,843.0
0.012,6,10,1990,5,911,2.0,643.0,643.0,5,1079,3.0,811.0,811.0
0.114,6,10,1506,5,395,24.0,127.0,127.0,5,1111,26.0,843.0,843.0
40.066,17,10,676,5,460,10015.0,104.0,64.0,5,216,10015.0,20.0,15.0
0.006,6,10,1689,5,839,1.0,571.0,571.0,5,850,1.0,582.0,582.0
0.005,17,2,178,1,65,0.0,37.0,37.0,1,113,0.0,85.0,85.0
0.004,6,10,2007,5,928,1.0,660.0,660.0,5,1079,1.0,811.0,811.0
0.075,6,10,1506,5,395,17.0,127.0,127.0,5,1111,16.0,843.0,843.0
242.077,6,385,347785,192,21500,1267.0,2736.0,959.0,193,326285,1260.0,2914.0,1728.0
0.013,6,10,1989,5,910,3.0,642.0,642.0,5,1079,3.0,811.0,811.0
0.006,6,10,2006,5,927,1.0,659.0,659.0,5,1079,1.0,811.0,811.0
0.006,6,10,1547,5,764,1.0,496.0,496.0,5,783,1.0,515.0,515.0
240.093,6,16,4481,9,963,30011.0,238.0,166.0,7,3518,40015.0,1402.0,786.0
0.007,6,10,1547,5,764,1.0,496.0,496.0,5,783,1.0,515.0,515.0
0.011,6,10,1989,5,910,2.0,642.0,642.0,5,1079,2.0,811.0,811.0
0.004,6,10,2006,5,927,1.0,659.0,659.0,5,1079,1.0,811.0,811.0
0.797,6,25,5555,12,1445,61.0,267.0,136.0,13,4110,56.0,1414.0,597.0
0.005,6,10,2007,5,928,1.0,660.0,660.0,5,1079,1.0,811.0,811.0
0.008,6,10,1989,5,910,2.0,642.0,642.0,5,1079,2.0,811.0,811.0
0.004,17,2,136,1,60,0.0,32.0,32.0,1,76,0.0,48.0,48.0
0.012,6,10,1990,5,911,2.0,643.0,643.0,5,1079,3.0,811.0,811.0
0.005,6,10,2006,5,927,1.0,659.0,659.0,5,1079,1.0,811.0,811.0
361.815,6,21,1793,16,1030,24121.0,190.0,190.0,5,763,60010.0,462.0,247.0
0.079,6,10,1506,5,395,17.0,127.0,127.0,5,1111,15.0,843.0,843.0
0.036,17,4,284,2,120,0.0,32.0,32.0,2,164,33.0,60.0,54.0
0.011,6,10,1631,5,848,2.0,580.0,580.0,5,783,2.0,515.0,515.0
0.003,17,4,284,2,120,0.0,32.0,32.0,2,164,0.0,60.0,54.0
0.005,6,10,1779,5,928,1.0,660.0,660.0,5,851,1.0,583.0,583.0
0.005,6,10,2006,5,927,1.0,659.0,659.0,5,1079,1.0,811.0,811.0
0.003,6,10,1702,5,863,0.0,595.0,595.0,5,839,0.0,571.0,571.0
0.021,6,10,1989,5,910,5.0,642.0,642.0,5,1079,5.0,811.0,811.0
0.005,6,10,1989,5,927,1.0,659.0,659.0,5,1062,1.0,794.0,794.0
0.072,6,10,1506,5,395,17.0,127.0,127.0,5,1111,16.0,843.0,843.0
0.004,6,10,1779,5,928,1.0,660.0,660.0,5,851,1.0,583.0,583.0
10.81,17,28,4421,14,1993,823.0,268.0,114.0,14,2428,823.0,587.0,145.0
0.01,6,10,1989,5,910,2.0,642.0,642.0,5,1079,2.0,811.0,811.0
0.006,6,10,1547,5,764,1.0,496.0,496.0,5,783,1.0,515.0,515.0
0.005,17,2,170,1,65,0.0,37.0,37.0,1,105,0.0,77.0,77.0
0.01,6,10,1989,5,910,2.0,642.0,642.0,5,1079,2.0,811.0,811.0
240.085,6,16,4481,9,963,30010.0,238.0,166.0,7,3518,40013.0,1402.0,786.0
0.018,6,10,1972,5,910,4.0,642.0,642.0,5,1062,4.0,794.0,794.0
0.042,17,4,596,2,122,1.0,33.0,33.0,2,474,38.0,323.0,209.0
240.028,6,9,787,5,488,60007.0,232.0,232.0,4,299,80008.0,83.0,83.0
0.009,6,10,1762,5,911,2.0,643.0,643.0,5,851,2.0,583.0,583.0
0.004,6,10,2000,5,927,1.0,659.0,659.0,5,1073,1.0,805.0,805.0
0.005,6,10,1989,5,927,1.0,659.0,659.0,5,1062,1.0,794.0,794.0
0.009,17,2,152,1,76,0.0,48.0,48.0,1,76,0.0,48.0,48.0
40.063,17,10,676,5,460,10014.0,104.0,64.0,5,216,10014.0,20.0,15.0
0.004,17,2,170,1,65,0.0,37.0,37.0,1,105,0.0,77.0,77.0
0.113,17,4,532,2,122,75.0,33.0,33.0,2,410,73.0,259.0,177.0
0.006,6,10,1689,5,839,1.0,571.0,571.0,5,850,1.0,582.0,582.0
0.099,6,10,1506,5,395,22.0,127.0,127.0,5,1111,20.0,843.0,843.0
0.108,6,10,1506,5,395,25.0,127.0,127.0,5,1111,22.0,843.0,843.0
0.005,6,10,1989,5,927,1.0,659.0,659.0,5,1062,1.0,794.0,794.0
0.165,6,10,1506,5,395,38.0,127.0,127.0,5,1111,39.0,843.0,843.0
0.005,6,10,1989,5,927,1.0,659.0,659.0,5,1062,1.0,794.0,794.0
353.253,6,20,2210,6,1308,12004.0,494.0,494.0,14,902,27173.0,83.0,83.0
0.005,17,2,136,1,60,0.0,32.0,32.0,1,76,0.0,48.0,48.0
0.004,17,2,186,1,61,0.0,33.0,33.0,1,125,0.0,97.0,97.0
0.005,6,13,3747,7,509,0.0,137.0,137.0,6,3238,1.0,1470.0,1459.0
0.071,17,2,136,1,60,0.0,32.0,32.0,1,76,0.0,48.0,48.0
10.805,17,28,4422,14,1993,822.0,268.0,114.0,14,2429,822.0,588.0,145.0
15.083,17,15,8264,8,6049,2149.0,1350.0,728.0,7,2215,2508.0,1350.0,288.0
0.005,6,10,1854,5,889,1.0,621.0,621.0,5,965,1.0,697.0,697.0
10.794,17,28,4421,14,1994,822.0,269.0,114.0,14,2427,822.0,586.0,145.0
10.919,17,28,4416,14,1993,831.0,268.0,114.0,14,2423,831.0,586.0,145.0
354.046,6,21,1795,16,1030,23603.0,190.0,190.0,5,765,60003.0,464.0,248.0
0.004,6,10,1702,5,863,1.0,595.0,595.0,5,839,1.0,571.0,571.0
0.005,6,10,2006,5,927,1.0,659.0,659.0,5,1079,1.0,811.0,811.0
0.078,6,10,1506,5,395,16.0,127.0,127.0,5,1111,17.0,843.0,843.0
0.005,6,10,1989,5,927,1.0,659.0,659.0,5,1062,1.0,794.0,794.0
0.016,6,10,1989,5,910,3.0,642.0,642.0,5,1079,3.0,811.0,811.0
0.012,6,13,3816,7,578,1.0,206.0,206.0,6,3238,2.0,1470.0,1459.0
240.06,6,26,7169,14,1842,18466.0,517.0,159.0,12,5327,21823.0,1402.0,670.0
0.001,17,2,180,1,66,0.0,38.0,38.0,1,114,0.0,86.0,86.0
15.081,17,15,9239,8,6902,2149.0,1350.0,834.0,7,2337,2508.0,1350.0,305.0
0.006,6,10,2000,5,927,1.0,659.0,659.0,5,1073,1.0,805.0,805.0
0.005,6,10,1989,5,927,1.0,659.0,659.0,5,1062,1.0,794.0,794.0
40.054,17,10,676,5,460,10012.0,104.0,64.0,5,216,10012.0,20.0,15.0
0.04,17,2,170,1,65,0.0,37.0,37.0,1,105,0.0,77.0,77.0
0.004,6,10,1702,5,863,1.0,595.0,595.0,5,839,0.0,571.0,571.0
0.005,17,2,178,1,81,0.0,53.0,53.0,1,97,0.0,69.0,69.0
125.968,6,14,2938,8,2504,17962.0,1414.0,1086.0,6,434,25147.0,182.0,182.0
0.129,17,2,80,1,32,0.0,4.0,4.0,1,48,0.0,20.0,20.0
0.107,6,10,1506,5,395,24.0,127.0,127.0,5,1111,26.0,843.0,843.0
0.006,6,10,1547,5,764,1.0,496.0,496.0,5,783,1.0,515.0,515.0
0.008,6,10,1547,5,764,2.0,496.0,496.0,5,783,2.0,515.0,515.0
0.014,6,10,1972,5,910,3.0,642.0,642.0,5,1062,3.0,794.0,794.0
0.011,6,10,1983,5,910,2.0,642.0,642.0,5,1073,2.0,805.0,805.0
0.073,6,10,1506,5,395,17.0,127.0,127.0,5,1111,17.0,843.0,843.0
0.005,6,10,2006,5,927,1.0,659.0,659.0,5,1079,1.0,811.0,811.0
0.018,6,10,1989,5,910,4.0,642.0,642.0,5,1079,4.0,811.0,811.0
0.09,6,10,1506,5,395,19.0,127.0,127.0,5,1111,20.0,843.0,843.0
40.073,17,10,676,5,460,10017.0,104.0,64.0,5,216,10017.0,20.0,15.0
0.005,6,10,1989,5,927,1.0,659.0,659.0,5,1062,1.0,794.0,794.0
0.008,6,13,3735,7,497,1.0,125.0,125.0,6,3238,1.0,1470.0,1459.0
0.006,6,10,1989,5,927,1.0,659.0,659.0,5,1062,1.0,794.0,794.0
0.144,6,10,1506,5,395,35.0,127.0,127.0,5,1111,30.0,843.0,843.0
0.004,6,10,2006,5,927,1.0,659.0,659.0,5,1079,1.0,811.0,811.0
0.006,6,10,1547,5,764,1.0,496.0,496.0,5,783,1.0,515.0,515.0
0.092,6,10,1506,5,395,19.0,127.0,127.0,5,1111,20.0,843.0,843.0
0.008,6,10,1677,5,827,2.0,559.0,559.0,5,850,2.0,582.0,582.0
0.015,6,10,1989,5,910,3.0,642.0,642.0,5,1079,3.0,811.0,811.0
0.009,6,10,1989,5,910,2.0,642.0,642.0,5,1079,2.0,811.0,811.0
40.088,17,10,676,5,460,10019.0,104.0,64.0,5,216,10021.0,20.0,15.0
1798.344,17,2974,227581,1476,119724,1219.0,84.0,53.0,1498,107857,1201.0,227.0,44.0
0.128,6,10,1506,5,395,30.0,127.0,127.0,5,1111,29.0,843.0,843.0
0.006,6,10,1547,5,764,1.0,496.0,496.0,5,783,1.0,515.0,515.0
300.382,6,16,2170,9,684,37526.0,146.0,146.0,7,1486,50035.0,419.0,398.0
0.086,6,10,1506,5,395,20.0,127.0,127.0,5,1111,19.0,843.0,843.0
0.018,6,10,1989,5,910,4.0,642.0,642.0,5,1079,4.0,811.0,811.0
1771.662,17,120,11460,60,5460,30027.0,63.0,63.0,60,6000,30027.0,72.0,72.0
240.015,6,9,787,5,488,60003.0,232.0,232.0,4,299,80004.0,83.0,83.0
0.009,17,2,179,1,71,0.0,43.0,43.0,1,108,0.0,80.0,80.0
0.089,6,10,1506,5,395,20.0,127.0,127.0,5,1111,18.0,843.0,843.0
0.008,6,10,1989,5,910,2.0,642.0,642.0,5,1079,2.0,811.0,811.0
352.675,6,20,2210,6,1308,12003.0,494.0,494.0,14,902,27128.0,83.0,83.0
0.004,6,10,2006,5,927,1.0,659.0,659.0,5,1079,1.0,811.0,811.0
0.018,6,13,3735,7,497,3.0,125.0,125.0,6,3238,3.0,1470.0,1459.0
0.006,17,2,170,1,65,0.0,37.0,37.0,1,105,0.0,77.0,77.0
0.046,17,2,152,1,76,0.0,48.0,48.0,1,76,0.0,48.0,48.0
0.004,6,10,2006,5,927,1.0,659.0,659.0,5,1079,1.0,811.0,811.0
0.015,6,10,1989,5,910,3.0,642.0,642.0,5,1079,3.0,811.0,811.0
1778.549,17,142,44872,72,22752,25048.0,288.0,288.0,70,22120,25774.0,288.0,288.0
0.0,17,2,136,1,60,0.0,32.0,32.0,1,76,0.0,48.0,48.0
0.008,6,10,1990,5,911,2.0,643.0,643.0,5,1079,2.0,811.0,811.0
0.014,6,10,1990,5,911,3.0,643.0,643.0,5,1079,3.0,811.0,811.0
0.007,17,2,230,1,68,0.0,40.0,40.0,1,162,0.0,134.0,134.0
0.01,6,10,1762,5,911,2.0,643.0,643.0,5,851,2.0,583.0,583.0
0.007,6,10,1547,5,764,1.0,496.0,496.0,5,783,1.0,515.0,515.0
0.006,17,2,180,1,66,0.0,38.0,38.0,1,114,0.0,86.0,86.0
0.088,6,10,1506,5,395,21.0,127.0,127.0,5,1111,20.0,843.0,843.0
0.015,6,10,1989,5,910,3.0,642.0,642.0,5,1079,3.0,811.0,811.0
0.744,6,25,5459,12,1557,59.0,325.0,152.0,13,3902,53.0,1414.0,563.0
0.001,17,2,166,1,75,0.0,47.0,47.0,1,91,0.0,63.0,63.0
0.005,17,2,170,1,65,0.0,37.0,37.0,1,105,0.0,77.0,77.0
0.004,6,10,2006,5,927,1.0,659.0,659.0,5,1079,1.0,811.0,811.0
0.006,6,10,1547,5,764,1.0,496.0,496.0,5,783,1.0,515.0,515.0
0.006,6,10,1854,5,889,1.0,621.0,621.0,5,965,1.0,697.0,697.0
0.004,6,10,1774,5,923,1.0,655.0,655.0,5,851,1.0,583.0,583.0
0.013,17,2,152,1,56,0.0,28.0,28.0,1,96,0.0,68.0,68.0
0.08,6,10,1506,5,395,16.0,127.0,127.0,5,1111,18.0,843.0,843.0
0.005,6,10,1989,5,927,1.0,659.0,659.0,5,1062,1.0,794.0,794.0
0.006,17,2,214,1,75,0.0,47.0,47.0,1,139,0.0,111.0,111.0
0.008,17,2,194,1,59,0.0,31.0,31.0,1,135,0.0,107.0,107.0
0.018,6,10,1972,5,910,4.0,642.0,642.0,5,1062,4.0,794.0,794.0
0.013,6,10,1989,5,910,3.0,642.0,642.0,5,1079,3.0,811.0,811.0
0.031,6,10,1631,5,848,7.0,580.0,580.0,5,783,7.0,515.0,515.0
0.009,6,10,1990,5,911,2.0,643.0,643.0,5,1079,2.0,811.0,811.0
0.113,6,10,1506,5,395,23.0,127.0,127.0,5,1111,25.0,843.0,843.0
0.005,6,10,2000,5,927,1.0,659.0,659.0,5,1073,1.0,805.0,805.0
0.118,6,10,1506,5,395,26.0,127.0,127.0,5,1111,22.0,843.0,843.0
10.834,17,28,4417,14,1994,824.0,269.0,114.0,14,2423,824.0,586.0,145.0
0.004,6,10,1774,5,923,1.0,655.0,655.0,5,851,1.0,583.0,583.0
0.005,6,10,1989,5,927,1.0,659.0,659.0,5,1062,1.0,794.0,794.0
0.016,17,2,180,1,66,0.0,38.0,38.0,1,114,0.0,86.0,86.0
0.011,6,10,1989,5,910,2.0,642.0,642.0,5,1079,2.0,811.0,811.0
0.005,6,10,2006,5,927,1.0,659.0,659.0,5,1079,1.0,811.0,811.0
0.012,6,10,1762,5,911,2.0,643.0,643.0,5,851,3.0,583.0,583.0
0.012,6,10,1989,5,910,2.0,642.0,642.0,5,1079,3.0,811.0,811.0
0.011,6,13,3735,7,497,1.0,125.0,125.0,6,3238,2.0,1470.0,1459.0
0.01,6,10,1989,5,910,2.0,642.0,642.0,5,1079,2.0,811.0,811.0
0.014,6,10,1983,5,910,3.0,642.0,642.0,5,1073,3.0,805.0,805.0
0.012,6,10,1972,5,910,3.0,642.0,642.0,5,1062,2.0,794.0,794.0
0.005,17,2,230,1,68,0.0,40.0,40.0,1,162,0.0,134.0,134.0
0.013,6,10,1972,5,910,3.0,642.0,642.0,5,1062,3.0,794.0,794.0
0.004,17,2,136,1,60,0.0,32.0,32.0,1,76,0.0,48.0,48.0
0.019,6,10,1990,5,911,4.0,643.0,643.0,5,1079,4.0,811.0,811.0
0.008,6,10,1989,5,910,2.0,642.0,642.0,5,1079,1.0,811.0,811.0
0.088,6,10,1506,5,395,18.0,127.0,127.0,5,1111,19.0,843.0,843.0
0.005,17,2,156,1,70,0.0,42.0,42.0,1,86,0.0,58.0,58.0
0.011,6,10,1989,5,910,2.0,642.0,642.0,5,1079,2.0,811.0,811.0
240.097,6,16,4481,9,963,30012.0,238.0,166.0,7,3518,40015.0,1402.0,786.0
0.112,6,10,1506,5,395,25.0,127.0,127.0,5,1111,23.0,843.0,843.0
10.791,17,28,4422,14,1994,821.0,269.0,114.0,14,2428,821.0,587.0,145.0
0.005,6,14,3799,7,509,0.0,137.0,137.0,7,3290,0.0,1448.0,972.0
0.077,6,10,1506,5,395,15.0,127.0,127.0,5,1111,15.0,843.0,843.0
0.01,6,10,1989,5,910,2.0,642.0,642.0,5,1079,2.0,811.0,811.0
0.095,6,10,1506,5,395,22.0,127.0,127.0,5,1111,22.0,843.0,843.0
40.068,17,10,676,5,460,10016.0,104.0,64.0,5,216,10016.0,20.0,15.0
1729.224,6,60,4400,40,2740,44339.0,33.0,33.0,20,1660,91002.0,31.0,31.0
0.006,6,10,1689,5,839,1.0,571.0,571.0,5,850,1.0,582.0,582.0
0.004,6,10,2007,5,928,1.0,660.0,660.0,5,1079,1.0,811.0,811.0
0.01,6,10,1990,5,911,2.0,643.0,643.0,5,1079,2.0,811.0,811.0
0.008,6,10,1972,5,910,2.0,642.0,642.0,5,1062,2.0,794.0,794.0
15.069,17,15,9238,8,6902,2148.0,1350.0,834.0,7,2336,2506.0,1350.0,305.0
0.117,6,10,1506,5,395,25.0,127.0,127.0,5,1111,27.0,843.0,843.0
0.006,6,10,2006,5,927,1.0,659.0,659.0,5,1079,1.0,811.0,811.0
0.003,17,2,148,1,60,0.0,32.0,32.0,1,88,0.0,60.0,60.0
0.005,17,2,213,1,69,0.0,41.0,41.0,1,144,0.0,116.0,116.0
0.001,17,2,180,1,66,0.0,38.0,38.0,1,114,0.0,86.0,86.0
0.003,17,4,284,2,120,0.0,32.0,32.0,2,164,0.0,60.0,54.0
0.005,6,10,2006,5,927,1.0,659.0,659.0,5,1079,1.0,811.0,811.0
0.075,6,10,1506,5,395,17.0,127.0,127.0,5,1111,15.0,843.0,843.0
0.007,6,10,1689,5,839,1.0,571.0,571.0,5,850,1.0,582.0,582.0
0.1,6,10,1506,5,395,20.0,127.0,127.0,5,1111,22.0,843.0,843.0
0.068,6,10,1506,5,395,15.0,127.0,127.0,5,1111,15.0,843.0,843.0
0.105,6,10,1506,5,395,25.0,127.0,127.0,5,1111,25.0,843.0,843.0
0.013,17,2,152,1,56,0.0,28.0,28.0,1,96,0.0,68.0,68.0
0.072,17,8,3613,4,1874,24.0,1350.0,440.0,4,1739,11.0,1350.0,406.0
10.719,17,28,4419,14,1994,816.0,269.0,114.0,14,2425,816.0,588.0,145.0
0.005,6,10,1854,5,889,1.0,621.0,621.0,5,965,1.0,697.0,697.0
10.86,17,28,4424,14,1995,826.0,270.0,114.0,14,2429,826.0,588.0,145.0
0.124,6,10,1506,5,395,28.0,127.0,127.0,5,1111,25.0,843.0,843.0
0.071,17,8,3613,4,1874,23.0,1350.0,440.0,4,1739,12.0,1350.0,406.0
0.006,6,10,1547,5,764,1.0,496.0,496.0,5,783,1.0,515.0,515.0
0.061,17,2,152,1,76,0.0,48.0,48.0,1,76,0.0,48.0,48.0
0.001,17,2,178,1,81,0.0,53.0,53.0,1,97,0.0,69.0,69.0
0.024,6,10,1631,5,848,6.0,580.0,580.0,5,783,6.0,515.0,515.0
0.076,6,10,1506,5,395,14.0,127.0,127.0,5,1111,17.0,843.0,843.0
0.005,6,10,1547,5,764,1.0,496.0,496.0,5,783,1.0,515.0,515.0
0.079,6,10,1506,5,395,17.0,127.0,127.0,5,1111,18.0,843.0,843.0
0.044,17,2,148,1,60,0.0,32.0,32.0,1,88,0.0,60.0,60.0
0.006,6,10,1689,5,839,1.0,571.0,571.0,5,850,1.0,582.0,582.0
1730.409,6,45,2790,30,1725,59669.0,35.0,35.0,15,1065,123595.0,31.0,31.0
0.15,6,10,1506,5,395,33.0,127.0,127.0,5,1111,34.0,843.0,843.0
0.098,6,10,1506,5,395,23.0,127.0,127.0,5,1111,19.0,843.0,843.0
0.039,17,2,412,1,61,0.0,33.0,33.0,1,351,0.0,323.0,323.0
11.263,17,28,4416,14,1993,852.0,268.0,114.0,14,2423,853.0,586.0,145.0
0.004,6,10,2007,5,928,1.0,660.0,660.0,5,1079,1.0,811.0,811.0
0.004,6,10,2006,5,927,1.0,659.0,659.0,5,1079,1.0,811.0,811.0
0.159,6,10,1506,5,395,38.0,127.0,127.0,5,1111,34.0,843.0,843.0
0.001,17,2,180,1,66,0.0,38.0,38.0,1,114,0.0,86.0,86.0
0.04,17,2,148,1,60,0.0,32.0,32.0,1,88,0.0,60.0,60.0
0.019,6,10,1990,5,911,4.0,643.0,643.0,5,1079,4.0,811.0,811.0
0.004,6,10,1989,5,927,1.0,659.0,659.0,5,1062,1.0,794.0,794.0
0.022,6,10,1762,5,911,5.0,643.0,643.0,5,851,5.0,583.0,583.0
0.022,6,10,1972,5,910,5.0,642.0,642.0,5,1062,5.0,794.0,794.0
0.013,6,10,1990,5,911,3.0,643.0,643.0,5,1079,3.0,811.0,811.0
0.105,6,10,1506,5,395,23.0,127.0,127.0,5,1111,25.0,843.0,843.0
0.01,6,13,3735,7,497,1.0,125.0,125.0,6,3238,1.0,1470.0,1459.0
0.013,6,10,1972,5,910,3.0,642.0,642.0,5,1062,3.0,794.0,794.0
0.009,6,10,1989,5,910,2.0,642.0,642.0,5,1079,2.0,811.0,811.0
0.006,17,2,140,1,62,0.0,34.0,34.0,1,78,0.0,50.0,50.0
0.017,17,2,136,1,60,0.0,32.0,32.0,1,76,0.0,48.0,48.0
40.078,17,10,676,5,460,10018.0,104.0,64.0,5,216,10018.0,20.0,15.0
0.011,6,10,2007,5,928,2.0,660.0,660.0,5,1079,2.0,811.0,811.0
0.006,6,10,1643,5,860,1.0,592.0,592.0,5,783,1.0,515.0,515.0
0.013,17,2,152,1,56,0.0,28.0,28.0,1,96,0.0,68.0,68.0
0.066,17,8,3613,4,1874,22.0,1350.0,440.0,4,1739,12.0,1350.0,406.0
0.005,6,10,2006,5,927,1.0,659.0,659.0,5,1079,1.0,811.0,811.0
15.08,17,15,7909,8,5801,2150.0,1350.0,697.0,7,2108,2508.0,1350.0,273.0
40.075,17,10,676,5,460,10017.0,104.0,64.0,5,216,10017.0,20.0,15.0
0.011,6,10,1972,5,910,2.0,642.0,642.0,5,1062,2.0,794.0,794.0
0.085,6,10,1506,5,395,19.0,127.0,127.0,5,1111,17.0,843.0,843.0
0.006,6,10,1547,5,764,1.0,496.0,496.0,5,783,1.0,515.0,515.0
0.001,17,2,248,1,68,0.0,40.0,40.0,1,180,0.0,152.0,152.0
0.019,6,10,1989,5,910,4.0,642.0,642.0,5,1079,4.0,811.0,811.0
0.006,6,10,1547,5,764,1.0,496.0,496.0,5,783,1.0,515.0,515.0
0.005,17,2,170,1,65,0.0,37.0,37.0,1,105,0.0,77.0,77.0
0.134,6,10,1506,5,395,31.0,127.0,127.0,5,1111,30.0,843.0,843.0
11.208,17,28,4420,14,1995,849.0,270.0,114.0,14,2425,849.0,588.0,145.0
0.007,6,10,1689,5,839,1.0,571.0,571.0,5,850,1.0,582.0,582.0
0.006,6,10,1689,5,839,1.0,571.0,571.0,5,850,1.0,582.0,582.0
0.065,6,10,1506,5,395,14.0,127.0,127.0,5,1111,13.0,843.0,843.0
0.006,6,10,1547,5,764,1.0,496.0,496.0,5,783,1.0,515.0,515.0
0.015,6,10,1983,5,910,3.0,642.0,642.0,5,1073,3.0,805.0,805.0
240.273,6,42,5393,22,2528,11441.0,588.0,196.0,20,2865,12645.0,580.0,227.0
0.006,6,10,1547,5,764,1.0,496.0,496.0,5,783,1.0,515.0,515.0
0.001,17,2,180,1,66,0.0,38.0,38.0,1,114,0.0,86.0,86.0
332.375,17,20,1124,10,716,36915.0,48.0,43.0,10,408,36915.0,20.0,12.0
0.011,6,12,1698,6,863,2.0,327.0,271.0,6,835,2.0,515.0,515.0
0.005,17,2,170,1,65,0.0,37.0,37.0,1,105,0.0,77.0,77.0
0.075,6,10,1506,5,395,16.0,127.0,127.0,5,1111,18.0,843.0,843.0
0.046,17,2,152,1,76,0.0,48.0,48.0,1,76,0.0,48.0,48.0
0.036,6,10,1989,5,910,8.0,642.0,642.0,5,1079,8.0,811.0,811.0
0.245,17,17,8769,8,6307,35.0,1350.0,760.0,9,2462,18.0,1350.0,245.0
0.01,6,10,1677,5,827,2.0,559.0,559.0,5,850,2.0,582.0,582.0
0.006,6,10,1547,5,764,1.0,496.0,496.0,5,783,1.0,515.0,515.0
11.173,17,28,4423,14,1995,847.0,270.0,114.0,14,2428,847.0,587.0,145.0
0.005,6,14,3799,7,509,0.0,137.0,137.0,7,3290,0.0,1448.0,972.0
0.001,17,2,179,1,62,0.0,34.0,34.0,1,117,0.0,89.0,89.0
0.089,6,10,1506,5,395,20.0,127.0,127.0,5,1111,19.0,843.0,843.0
0.005,6,10,1989,5,927,1.0,659.0,659.0,5,1062,1.0,794.0,794.0
0.319,17,47,28183,28,24473,11.0,1350.0,846.0,19,3710,14.0,1350.0,167.0
40.058,17,10,676,5,460,10013.0,104.0,64.0,5,216,10013.0,20.0,15.0
40.051,17,10,676,5,460,10011.0,104.0,64.0,5,216,10012.0,20.0,15.0
0.04,17,2,152,1,76,0.0,48.0,48.0,1,76,0.0,48.0,48.0
0.065,17,8,3613,4,1874,21.0,1350.0,440.0,4,1739,11.0,1350.0,406.0
0.014,6,10,1990,5,911,3.0,643.0,643.0,5,1079,3.0,811.0,811.0
0.018,6,9,1214,5,775,4.0,519.0,519.0,4,439,4.0,223.0,223.0
0.009,6,10,2000,5,927,2.0,659.0,659.0,5,1073,2.0,805.0,805.0
0.004,6,10,2007,5,928,1.0,660.0,660.0,5,1079,1.0,811.0,811.0
0.038,17,2,170,1,65,0.0,37.0,37.0,1,105,0.0,77.0,77.0
0.039,17,2,148,1,60,0.0,32.0,32.0,1,88,0.0,60.0,60.0
41.57,6,46,17369,23,11422,409.0,2720.0,1308.0,23,5947,1882.0,2667.0,385.0
0.303,17,4,352,2,130,179.0,37.0,37.0,2,222,231.0,89.0,83.0
0.458,6,23,7306,12,1736,40.0,797.0,276.0,11,5570,45.0,2334.0,998.0
0.005,6,13,3690,7,452,0.0,80.0,80.0,6,3238,0.0,1470.0,1459.0
0.013,6,14,3787,7,497,2.0,125.0,125.0,7,3290,2.0,1448.0,972.0
0.005,17,2,164,1,74,0.0,46.0,46.0,1,90,0.0,62.0,62.0
40.069,17,10,676,5,460,10016.0,104.0,64.0,5,216,10016.0,20.0,15.0
0.005,17,2,184,1,68,0.0,40.0,40.0,1,116,0.0,88.0,88.0
40.056,17,10,676,5,460,10013.0,104.0,64.0,5,216,10013.0,20.0,15.0
0.095,6,10,1506,5,395,21.0,127.0,127.0,5,1111,20.0,843.0,843.0
0.004,6,10,2000,5,927,1.0,659.0,659.0,5,1073,1.0,805.0,805.0
1799.818,17,3120,234892,1553,124316,1159.0,82.0,52.0,1567,110576,1149.0,226.0,42.0
40.065,17,10,676,5,460,10015.0,104.0,64.0,5,216,10013.0,20.0,15.0
0.007,17,2,194,1,59,0.0,31.0,31.0,1,135,0.0,107.0,107.0
300.345,6,16,2170,9,684,37521.0,146.0,146.0,7,1486,50028.0,419.0,398.0
40.055,17,10,676,5,460,10012.0,104.0,64.0,5,216,10012.0,20.0,15.0
0.237,17,15,8641,8,4076,33.0,1350.0,481.0,7,4565,30.0,1350.0,624.0
0.012,6,10,1989,5,910,3.0,642.0,642.0,5,1079,2.0,811.0,811.0
0.005,17,2,154,1,69,0.0,41.0,41.0,1,85,0.0,57.0,57.0
0.011,6,10,1990,5,911,2.0,643.0,643.0,5,1079,2.0,811.0,811.0
0.006,6,10,1547,5,764,1.0,496.0,496.0,5,783,1.0,515.0,515.0
308.701,17,20,1124,10,716,34285.0,48.0,43.0,10,408,34285.0,20.0,12.0
0.005,6,10,2006,5,927,1.0,659.0,659.0,5,1079,1.0,811.0,811.0
11.257,17,28,4417,14,1994,851.0,269.0,114.0,14,2423,852.0,586.0,145.0
0.076,6,10,1506,5,395,16.0,127.0,127.0,5,1111,15.0,843.0,843.0
0.005,6,10,1689,5,839,1.0,571.0,571.0,5,850,1.0,582.0,582.0
0.082,6,10,1506,5,395,17.0,127.0,127.0,5,1111,18.0,843.0,843.0
0.014,6,10,1989,5,910,3.0,642.0,642.0,5,1079,3.0,811.0,811.0
15.072,17,14,9190,8,6902,2149.0,1350.0,834.0,6,2288,3008.0,1350.0,353.0
0.005,17,2,225,1,65,0.0,37.0,37.0,1,160,0.0,132.0,132.0
0.005,6,10,1779,5,928,1.0,660.0,660.0,5,851,1.0,583.0,583.0
0.006,6,10,1547,5,764,1.0,496.0,496.0,5,783,1.0,515.0,515.0
0.006,17,2,179,1,71,0.0,43.0,43.0,1,108,0.0,80.0,80.0
0.001,17,2,136,1,60,0.0,32.0,32.0,1,76,0.0,48.0,48.0
0.006,17,2,169,1,62,0.0,34.0,34.0,1,107,0.0,79.0,79.0
0.005,6,13,3747,7,509,0.0,137.0,137.0,6,3238,0.0,1470.0,1459.0
0.093,6,10,1506,5,395,20.0,127.0,127.0,5,1111,22.0,843.0,843.0
96.792,6,24,9037,12,3129,93.0,1360.0,654.0,12,5908,8784.0,2720.0,902.0
0.013,6,10,1972,5,910,3.0,642.0,642.0,5,1062,3.0,794.0,794.0
0.006,17,2,152,1,68,0.0,40.0,40.0,1,84,0.0,56.0,56.0
0.101,6,10,1506,5,395,21.0,127.0,127.0,5,1111,23.0,843.0,843.0
0.004,17,2,148,1,60,0.0,32.0,32.0,1,88,0.0,60.0,60.0
0.111,6,10,1506,5,395,26.0,127.0,127.0,5,1111,25.0,843.0,843.0
0.004,6,10,1779,5,928,1.0,660.0,660.0,5,851,1.0,583.0,583.0
240.079,6,16,4481,9,963,30009.0,238.0,166.0,7,3518,40012.0,1402.0,786.0
0.007,17,2,194,1,59,0.0,31.0,31.0,1,135,0.0,107.0,107.0
0.013,6,10,1972,5,910,3.0,642.0,642.0,5,1062,3.0,794.0,794.0
0.0,17,2,180,1,66,0.0,38.0,38.0,1,114,0.0,86.0,86.0
0.009,6,10,1983,5,910,2.0,642.0,642.0,5,1073,2.0,805.0,805.0
10.562,6,35,10668,16,8994,704.0,2261.0,1020.0,19,1674,584.0,281.0,114.0
0.082,6,10,1506,5,395,18.0,127.0,127.0,5,1111,15.0,843.0,843.0
0.005,6,10,2000,5,927,1.0,659.0,659.0,5,1073,1.0,805.0,805.0
0.089,17,8,3613,4,1874,29.0,1350.0,440.0,4,1739,12.0,1350.0,406.0
0.004,6,10,2007,5,928,1.0,660.0,660.0,5,1079,1.0,811.0,811.0
0.004,6,10,2007,5,928,1.0,660.0,660.0,5,1079,1.0,811.0,811.0
0.035,6,10,1972,5,910,8.0,642.0,642.0,5,1062,8.0,794.0,794.0
0.038,17,2,182,1,65,0.0,37.0,37.0,1,117,0.0,89.0,89.0
0.004,6,10,1702,5,863,1.0,595.0,595.0,5,839,0.0,571.0,571.0
0.037,17,2,136,1,60,0.0,32.0,32.0,1,76,0.0,48.0,48.0
0.03,17,2,164,1,74,0.0,46.0,46.0,1,90,0.0,62.0,62.0
0.013,6,10,1983,5,910,3.0,642.0,642.0,5,1073,3.0,805.0,805.0
0.005,6,13,3747,7,509,0.0,137.0,137.0,6,3238,1.0,1470.0,1459.0
0.019,6,10,1989,5,910,4.0,642.0,642.0,5,1079,4.0,811.0,811.0
0.005,6,10,1854,5,889,1.0,621.0,621.0,5,965,1.0,697.0,697.0
0.006,6,10,1689,5,839,1.0,571.0,571.0,5,850,1.0,582.0,582.0
332.967,17,20,1124,10,716,36989.0,48.0,43.0,10,408,36989.0,20.0,12.0
0.004,6,10,1702,5,863,1.0,595.0,595.0,5,839,1.0,571.0,571.0
0.001,17,2,142,1,63,0.0,35.0,35.0,1,79,0.0,51.0,51.0
113.095,6,26,9525,12,1627,76.0,794.0,367.0,14,7898,8690.0,1360.0,732.0
0.005,17,2,230,1,68,0.0,40.0,40.0,1,162,0.0,134.0,134.0
0.014,6,10,1990,5,911,3.0,643.0,643.0,5,1079,3.0,811.0,811.0
0.076,6,10,1506,5,395,16.0,127.0,127.0,5,1111,17.0,843.0,843.0
1.07,6,32,12795,18,3352,62.0,1360.0,517.0,14,9443,69.0,2720.0,985.0
0.001,17,2,180,1,66,0.0,38.0,38.0,1,114,0.0,86.0,86.0
0.006,6,10,1547,5,764,1.0,496.0,496.0,5,783,1.0,515.0,515.0
0.004,6,10,1779,5,928,1.0,660.0,660.0,5,851,1.0,583.0,583.0
1770.299,6,83,4368,42,2210,43177.0,26.0,26.0,41,2158,44256.0,26.0,26.0
0.009,6,10,1972,5,910,2.0,642.0,642.0,5,1062,2.0,794.0,794.0
0.003,17,2,234,1,61,0.0,33.0,33.0,1,173,0.0,145.0,145.0
300.964,6,41,10983,22,5196,14331.0,1360.0,714.0,19,5787,488.0,2667.0,385.0
0.008,17,2,194,1,59,0.0,31.0,31.0,1,135,0.0,107.0,107.0
40.058,17,10,676,5,460,10012.0,104.0,64.0,5,216,10012.0,20.0,15.0
0.071,6,10,1506,5,395,15.0,127.0,127.0,5,1111,15.0,843.0,843.0
0.005,17,2,170,1,65,0.0,37.0,37.0,1,105,0.0,77.0,77.0
0.013,6,13,3735,7,497,2.0,125.0,125.0,6,3238,2.0,1470.0,1459.0
0.008,6,10,1643,5,860,2.0,592.0,592.0,5,783,1.0,515.0,515.0
0.106,6,10,1506,5,395,24.0,127.0,127.0,5,1111,19.0,843.0,843.0
0.006,6,13,3690,7,452,0.0,80.0,80.0,6,3238,1.0,1470.0,1459.0
0.004,17,2,170,1,65,0.0,37.0,37.0,1,105,0.0,77.0,77.0
0.005,6,10,1779,5,928,1.0,660.0,660.0,5,851,1.0,583.0,583.0
0.012,6,10,1677,5,827,3.0,559.0,559.0,5,850,3.0,582.0,582.0
40.053,17,10,676,5,460,10012.0,104.0,64.0,5,216,10011.0,20.0,15.0
15.281,17,45,25687,25,21231,635.0,1350.0,821.0,20,4456,802.0,1350.0,194.0
40.051,17,10,676,5,460,10012.0,104.0,64.0,5,216,10011.0,20.0,15.0
0.005,17,2,230,1,68,0.0,40.0,40.0,1,162,0.0,134.0,134.0
0.008,6,12,1926,6,1189,1.0,659.0,434.0,6,737,1.0,417.0,417.0
0.005,6,10,2000,5,927,1.0,659.0,659.0,5,1073,1.0,805.0,805.0
0.001,17,2,180,1,66,0.0,38.0,38.0,1,114,0.0,86.0,86.0
0.014,6,10,1983,5,910,3.0,642.0,642.0,5,1073,3.0,805.0,805.0
0.005,6,10,2006,5,927,1.0,659.0,659.0,5,1079,1.0,811.0,811.0
0.018,6,13,3735,7,497,2.0,125.0,125.0,6,3238,3.0,1470.0,1459.0
0.001,17,2,180,1,66,0.0,38.0,38.0,1,114,0.0,86.0,86.0
0.073,17,2,184,1,61,0.0,33.0,33.0,1,123,0.0,95.0,95.0
0.008,6,10,1983,5,910,2.0,642.0,642.0,5,1073,2.0,805.0,805.0
0.005,6,10,2006,5,927,1.0,659.0,659.0,5,1079,1.0,811.0,811.0
0.001,17,2,180,1,66,0.0,38.0,38.0,1,114,0.0,86.0,86.0
0.004,6,10,1774,5,923,1.0,655.0,655.0,5,851,1.0,583.0,583.0
0.004,6,10,2000,5,927,1.0,659.0,659.0,5,1073,1.0,805.0,805.0
0.005,6,10,1689,5,839,1.0,571.0,571.0,5,850,1.0,582.0,582.0
0.005,6,10,2006,5,927,1.0,659.0,659.0,5,1079,1.0,811.0,811.0
0.078,6,10,1506,5,395,18.0,127.0,127.0,5,1111,16.0,843.0,843.0
0.008,17,2,164,1,74,0.0,46.0,46.0,1,90,0.0,62.0,62.0
0.005,6,10,2006,5,927,1.0,659.0,659.0,5,1079,1.0,811.0,811.0
0.087,6,10,1506,5,395,20.0,127.0,127.0,5,1111,16.0,843.0,843.0
0.005,6,10,1989,5,927,1.0,659.0,659.0,5,1062,1.0,794.0,794.0
0.005,6,10,2006,5,927,1.0,659.0,659.0,5,1079,1.0,811.0,811.0
0.005,6,10,2007,5,928,1.0,660.0,660.0,5,1079,1.0,811.0,811.0
0.005,6,10,1989,5,927,1.0,659.0,659.0,5,1062,1.0,794.0,794.0
11.5,17,28,4398,14,2312,872.0,587.0,137.0,14,2086,871.0,269.0,121.0
0.109,6,10,1506,5,395,23.0,127.0,127.0,5,1111,25.0,843.0,843.0
0.014,6,10,1972,5,910,3.0,642.0,642.0,5,1062,3.0,794.0,794.0
0.005,6,10,1547,5,764,1.0,496.0,496.0,5,783,1.0,515.0,515.0
0.01,6,10,1983,5,910,2.0,642.0,642.0,5,1073,2.0,805.0,805.0
0.005,6,10,2000,5,927,1.0,659.0,659.0,5,1073,1.0,805.0,805.0
0.005,6,10,1774,5,923,1.0,655.0,655.0,5,851,1.0,583.0,583.0
0.004,6,10,2007,5,928,1.0,660.0,660.0,5,1079,1.0,811.0,811.0
0.005,6,10,1689,5,839,1.0,571.0,571.0,5,850,1.0,582.0,582.0
0.071,6,10,1506,5,395,14.0,127.0,127.0,5,1111,16.0,843.0,843.0
0.126,17,2,156,1,64,0.0,36.0,36.0,1,92,0.0,64.0,64.0
0.005,6,10,1774,5,923,1.0,655.0,655.0,5,851,1.0,583.0,583.0
0.098,6,10,1506,5,395,22.0,127.0,127.0,5,1111,21.0,843.0,843.0
0.005,6,10,2007,5,928,1.0,660.0,660.0,5,1079,1.0,811.0,811.0
11.18,17,28,4423,14,1994,847.0,269.0,114.0,14,2429,847.0,588.0,145.0
0.005,6,10,1989,5,927,1.0,659.0,659.0,5,1062,1.0,794.0,794.0
0.001,17,2,180,1,66,0.0,38.0,38.0,1,114,0.0,86.0,86.0
10.886,17,28,4423,14,1994,828.0,269.0,114.0,14,2429,828.0,588.0,145.0
0.114,6,10,1506,5,395,28.0,127.0,127.0,5,1111,25.0,843.0,843.0
0.005,17,2,170,1,65,0.0,37.0,37.0,1,105,0.0,77.0,77.0
0.029,6,10,1972,5,910,7.0,642.0,642.0,5,1062,7.0,794.0,794.0
0.104,6,10,1506,5,395,23.0,127.0,127.0,5,1111,23.0,843.0,843.0
40.084,17,10,676,5,460,10018.0,104.0,64.0,5,216,10020.0,20.0,15.0
1729.898,6,58,3533,35,2100,50879.0,35.0,35.0,23,1433,78627.0,31.0,31.0
0.085,6,10,1506,5,395,19.0,127.0,127.0,5,1111,19.0,843.0,843.0
0.013,17,2,179,1,71,0.0,43.0,43.0,1,108,0.0,80.0,80.0
178.041,17,78,11037,39,2601,4685.0,44.0,38.0,39,8436,4685.0,239.0,188.0
0.018,6,10,1631,5,848,4.0,580.0,580.0,5,783,4.0,515.0,515.0
0.006,6,10,1547,5,764,1.0,496.0,496.0,5,783,1.0,515.0,515.0
0.016,6,10,1989,5,910,4.0,642.0,642.0,5,1079,3.0,811.0,811.0
240.332,6,25,4174,12,1808,21845.0,539.0,235.0,13,2366,20025.0,1320.0,242.0
0.006,6,10,1547,5,764,1.0,496.0,496.0,5,783,1.0,515.0,515.0
0.005,17,2,225,1,65,0.0,37.0,37.0,1,160,0.0,132.0,132.0
0.122,17,2,80,1,32,0.0,4.0,4.0,1,48,0.0,20.0,20.0
0.004,6,10,2000,5,927,1.0,659.0,659.0,5,1073,1.0,805.0,805.0
0.005,6,10,1854,5,889,1.0,621.0,621.0,5,965,1.0,697.0,697.0
0.009,6,14,3787,7,497,1.0,125.0,125.0,7,3290,1.0,1448.0,972.0
0.007,6,10,1547,5,764,1.0,496.0,496.0,5,783,1.0,515.0,515.0
0.105,6,10,1506,5,395,22.0,127.0,127.0,5,1111,23.0,843.0,843.0
0.004,17,2,148,1,60,0.0,32.0,32.0,1,88,0.0,60.0,60.0
0.004,6,10,1989,5,927,1.0,659.0,659.0,5,1062,1.0,794.0,794.0
0.005,6,10,2006,5,927,1.0,659.0,659.0,5,1079,1.0,811.0,811.0
40.063,17,10,676,5,460,10014.0,104.0,64.0,5,216,10014.0,20.0,15.0
55.754,6,1199,1311848,586,1277721,63.0,4080.0,2276.0,613,34127,90.0,2667.0,181.0
366.859,6,22,2313,16,867,24457.0,195.0,195.0,6,1446,4638.0,419.0,398.0
0.006,6,10,1547,5,764,1.0,496.0,496.0,5,783,1.0,515.0,515.0
0.004,17,2,136,1,60,0.0,32.0,32.0,1,76,0.0,48.0,48.0
0.006,6,10,1854,5,889,1.0,621.0,621.0,5,965,1.0,697.0,697.0
10.795,17,26,4104,13,1823,890.0,270.0,112.0,13,2281,890.0,588.0,147.0
40.057,17,10,676,5,460,10012.0,104.0,64.0,5,216,10013.0,20.0,15.0
0.011,6,10,1989,5,910,2.0,642.0,642.0,5,1079,2.0,811.0,811.0
0.005,6,13,3747,7,509,0.0,137.0,137.0,6,3238,0.0,1470.0,1459.0
40.072,17,10,676,5,460,10015.0,104.0,64.0,5,216,10017.0,20.0,15.0
11.454,17,28,4398,14,2313,868.0,588.0,137.0,14,2085,868.0,268.0,120.0
0.09,6,10,1506,5,395,20.0,127.0,127.0,5,1111,19.0,843.0,843.0
0.015,6,10,1972,5,910,3.0,642.0,642.0,5,1062,3.0,794.0,794.0
0.016,6,13,3735,7,497,2.0,125.0,125.0,6,3238,3.0,1470.0,1459.0
0.026,6,10,1989,5,910,6.0,642.0,642.0,5,1079,6.0,811.0,811.0
0.003,17,2,148,1,60,0.0,32.0,32.0,1,88,0.0,60.0,60.0
0.006,17,2,213,1,69,0.0,41.0,41.0,1,144,0.0,116.0,116.0
0.023,6,10,1990,5,911,5.0,643.0,643.0,5,1079,5.0,811.0,811.0
0.005,6,10,1643,5,860,1.0,592.0,592.0,5,783,1.0,515.0,515.0
0.001,17,2,136,1,60,0.0,32.0,32.0,1,76,0.0,48.0,48.0
0.008,6,12,1926,6,1189,1.0,659.0,434.0,6,737,1.0,417.0,417.0
0.015,6,10,1677,5,827,3.0,559.0,559.0,5,850,3.0,582.0,582.0
178.19,17,86,12007,43,2871,4242.0,44.0,38.0,43,9136,4242.0,239.0,184.0
0.004,17,2,136,1,60,0.0,32.0,32.0,1,76,0.0,48.0,48.0
40.064,17,10,676,5,460,10011.0,104.0,64.0,5,216,10014.0,20.0,15.0
0.079,6,10,1506,5,395,18.0,127.0,127.0,5,1111,15.0,843.0,843.0
0.014,6,10,1983,5,910,3.0,642.0,642.0,5,1073,3.0,805.0,805.0
0.005,6,10,1689,5,839,1.0,571.0,571.0,5,850,1.0,582.0,582.0
0.006,6,10,1547,5,764,1.0,496.0,496.0,5,783,1.0,515.0,515.0
0.005,6,10,2000,5,927,1.0,659.0,659.0,5,1073,1.0,805.0,805.0
0.006,6,10,1547,5,764,1.0,496.0,496.0,5,783,1.0,515.0,515.0
0.005,6,10,2006,5,927,1.0,659.0,659.0,5,1079,1.0,811.0,811.0
368.631,6,22,2313,16,867,24575.0,195.0,195.0,6,1446,4636.0,419.0,398.0
361.764,6,21,1793,16,1030,24117.0,190.0,190.0,5,763,60009.0,462.0,247.0
15.074,17,15,9239,8,6902,2149.0,1350.0,834.0,7,2337,2507.0,1350.0,305.0
0.087,6,10,1506,5,395,18.0,127.0,127.0,5,1111,21.0,843.0,843.0
0.032,6,10,1972,5,910,8.0,642.0,642.0,5,1062,7.0,794.0,794.0
0.125,17,2,80,1,32,0.0,4.0,4.0,1,48,0.0,20.0,20.0
0.014,6,10,1989,5,910,3.0,642.0,642.0,5,1079,3.0,811.0,811.0
0.116,6,10,1506,5,395,24.0,127.0,127.0,5,1111,27.0,843.0,843.0
0.006,6,10,1689,5,839,1.0,571.0,571.0,5,850,1.0,582.0,582.0
0.005,17,2,144,1,64,0.0,36.0,36.0,1,80,0.0,52.0,52.0
0.08,6,10,1506,5,395,17.0,127.0,127.0,5,1111,15.0,843.0,843.0
0.004,6,10,2000,5,927,1.0,659.0,659.0,5,1073,1.0,805.0,805.0
0.133,6,10,1506,5,395,30.0,127.0,127.0,5,1111,30.0,843.0,843.0
0.005,6,10,1989,5,927,1.0,659.0,659.0,5,1062,1.0,794.0,794.0
0.095,6,10,1506,5,395,20.0,127.0,127.0,5,1111,19.0,843.0,843.0
0.004,17,2,136,1,60,0.0,32.0,32.0,1,76,0.0,48.0,48.0
0.062,6,10,1506,5,395,14.0,127.0,127.0,5,1111,11.0,843.0,843.0
0.004,6,10,2006,5,927,1.0,659.0,659.0,5,1079,1.0,811.0,811.0
40.078,17,10,676,5,460,10014.0,104.0,64.0,5,216,10018.0,20.0,15.0
0.008,6,10,1762,5,911,2.0,643.0,643.0,5,851,2.0,583.0,583.0
0.014,6,10,1677,5,827,3.0,559.0,559.0,5,850,3.0,582.0,582.0
0.009,6,10,1854,5,889,2.0,621.0,621.0,5,965,2.0,697.0,697.0
0.13,6,10,1506,5,395,28.0,127.0,127.0,5,1111,27.0,843.0,843.0
0.0,17,2,180,1,65,0.0,37.0,37.0,1,115,0.0,87.0,87.0
0.017,17,2,198,1,91,0.0,63.0,63.0,1,107,0.0,79.0,79.0
0.013,6,10,1990,5,911,3.0,643.0,643.0,5,1079,3.0,811.0,811.0
0.11,6,10,1506,5,395,24.0,127.0,127.0,5,1111,25.0,843.0,843.0
0.006,6,10,1547,5,764,1.0,496.0,496.0,5,783,1.0,515.0,515.0
0.014,6,10,2006,5,927,3.0,659.0,659.0,5,1079,3.0,811.0,811.0
0.134,6,10,1506,5,395,33.0,127.0,127.0,5,1111,31.0,843.0,843.0
0.005,6,10,2007,5,928,1.0,660.0,660.0,5,1079,1.0,811.0,811.0
0.256,17,38,20173,21,17040,12.0,1350.0,783.0,17,3133,12.0,1350.0,156.0
0.003,17,2,148,1,60,0.0,32.0,32.0,1,88,0.0,60.0,60.0
0.003,17,2,136,1,60,0.0,32.0,32.0,1,76,0.0,48.0,48.0
0.007,6,10,1547,5,764,1.0,496.0,496.0,5,783,1.0,515.0,515.0
0.006,17,18,2523,9,606,0.0,44.0,39.0,9,1917,0.0,239.0,185.0
0.008,6,10,1989,5,910,2.0,642.0,642.0,5,1079,1.0,811.0,811.0
1774.769,6,301,51805,125,34334,14311.0,2720.0,292.0,176,17471,10140.0,1360.0,128.0
0.017,6,10,1989,5,910,4.0,642.0,642.0,5,1079,4.0,811.0,811.0
0.005,6,10,2007,5,928,1.0,660.0,660.0,5,1079,1.0,811.0,811.0
0.001,17,2,180,1,66,0.0,38.0,38.0,1,114,0.0,86.0,86.0
24.729,6,39,13909,19,8311,494.0,3086.0,1503.0,20,5598,1292.0,2667.0,435.0
40.063,17,10,676,5,460,10014.0,104.0,64.0,5,216,10014.0,20.0,15.0
0.005,6,10,1989,5,927,1.0,659.0,659.0,5,1062,1.0,794.0,794.0
240.023,6,9,787,5,488,60005.0,232.0,232.0,4,299,80006.0,83.0,83.0
0.083,6,10,1506,5,395,19.0,127.0,127.0,5,1111,18.0,843.0,843.0
0.005,6,13,3747,7,509,0.0,137.0,137.0,6,3238,1.0,1470.0,1459.0
0.004,17,2,193,1,71,0.0,43.0,43.0,1,122,0.0,94.0,94.0
0.015,6,10,1989,5,910,3.0,642.0,642.0,5,1079,3.0,811.0,811.0
0.003,6,10,1702,5,863,0.0,595.0,595.0,5,839,0.0,571.0,571.0
9.036,17,6,376,5,280,2259.0,28.0,28.0,1,96,0.0,68.0,68.0
0.001,17,2,166,1,75,0.0,47.0,47.0,1,91,0.0,63.0,63.0
0.009,6,10,2000,5,927,2.0,659.0,659.0,5,1073,2.0,805.0,805.0
0.004,17,2,136,1,60,0.0,32.0,32.0,1,76,0.0,48.0,48.0
0.012,6,10,1972,5,910,3.0,642.0,642.0,5,1062,2.0,794.0,794.0
240.262,6,45,8875,24,5842,10446.0,1368.0,458.0,21,3033,12012.0,580.0,241.0
0.006,17,2,178,1,65,0.0,37.0,37.0,1,113,0.0,85.0,85.0
0.003,17,2,136,1,60,0.0,32.0,32.0,1,76,0.0,48.0,48.0
0.004,17,2,144,1,64,0.0,36.0,36.0,1,80,0.0,52.0,52.0
0.004,17,2,170,1,65,0.0,37.0,37.0,1,105,0.0,77.0,77.0
0.004,6,10,2007,5,928,1.0,660.0,660.0,5,1079,1.0,811.0,811.0
0.005,6,10,2007,5,928,1.0,660.0,660.0,5,1079,1.0,811.0,811.0
40.064,17,10,676,5,460,10013.0,104.0,64.0,5,216,10015.0,20.0,15.0
0.005,17,2,170,1,65,0.0,37.0,37.0,1,105,0.0,77.0,77.0
0.014,6,10,1989,5,910,3.0,642.0,642.0,5,1079,3.0,811.0,811.0
0.088,6,10,1506,5,395,19.0,127.0,127.0,5,1111,19.0,843.0,843.0
0.081,6,10,1506,5,395,18.0,127.0,127.0,5,1111,18.0,843.0,843.0
0.012,6,13,3735,7,497,2.0,125.0,125.0,6,3238,2.0,1470.0,1459.0
0.011,6,10,1989,5,910,2.0,642.0,642.0,5,1079,2.0,811.0,811.0
0.005,17,2,179,1,71,0.0,43.0,43.0,1,108,0.0,80.0,80.0
0.005,6,10,1989,5,927,1.0,659.0,659.0,5,1062,1.0,794.0,794.0
0.075,6,10,1506,5,395,16.0,127.0,127.0,5,1111,18.0,843.0,843.0
40.051,17,10,676,5,460,10011.0,104.0,64.0,5,216,10011.0,20.0,15.0
0.001,17,2,140,1,62,0.0,34.0,34.0,1,78,0.0,50.0,50.0
15.202,17,38,20149,21,17036,758.0,1350.0,783.0,17,3113,948.0,1350.0,155.0
0.037,17,4,284,2,120,0.0,32.0,32.0,2,164,33.0,60.0,54.0
0.014,6,10,1990,5,911,3.0,643.0,643.0,5,1079,3.0,811.0,811.0
0.01,6,13,3735,7,497,1.0,125.0,125.0,6,3238,2.0,1470.0,1459.0
0.005,6,10,2007,5,928,1.0,660.0,660.0,5,1079,1.0,811.0,811.0
0.006,6,10,1854,5,889,1.0,621.0,621.0,5,965,1.0,697.0,697.0
0.017,6,10,1983,5,910,4.0,642.0,642.0,5,1073,4.0,805.0,805.0
0.006,17,2,170,1,65,0.0,37.0,37.0,1,105,0.0,77.0,77.0
0.008,6,10,1989,5,910,2.0,642.0,642.0,5,1079,1.0,811.0,811.0
0.117,6,10,1506,5,395,25.0,127.0,127.0,5,1111,23.0,843.0,843.0
0.005,17,2,164,1,74,0.0,46.0,46.0,1,90,0.0,62.0,62.0
0.006,6,10,2006,5,927,1.0,659.0,659.0,5,1079,1.0,811.0,811.0
0.004,6,10,2007,5,928,1.0,660.0,660.0,5,1079,1.0,811.0,811.0
240.169,6,32,9315,16,6983,16011.0,1515.0,615.0,16,2332,16010.0,580.0,186.0
0.006,6,10,1643,5,860,1.0,592.0,592.0,5,783,1.0,515.0,515.0
0.006,17,2,166,1,75,0.0,47.0,47.0,1,91,0.0,63.0,63.0
0.004,6,14,3742,8,504,0.0,80.0,80.0,6,3238,0.0,1470.0,1459.0
1721.254,6,61,7141,40,4348,44134.0,1641.0,113.0,21,2793,86054.0,1112.0,85.0
1778.447,17,144,45504,72,22752,25048.0,288.0,288.0,72,22752,25048.0,288.0,288.0
0.005,6,10,1643,5,860,1.0,592.0,592.0,5,783,1.0,515.0,515.0
0.094,6,10,1506,5,395,22.0,127.0,127.0,5,1111,23.0,843.0,843.0
0.062,6,10,1506,5,395,14.0,127.0,127.0,5,1111,13.0,843.0,843.0
0.075,6,10,1506,5,395,17.0,127.0,127.0,5,1111,17.0,843.0,843.0
240.266,6,43,5529,22,2540,11441.0,588.0,196.0,21,2989,12013.0,580.0,236.0
0.005,6,10,2007,5,928,1.0,660.0,660.0,5,1079,1.0,811.0,811.0
0.107,6,10,1506,5,395,24.0,127.0,127.0,5,1111,21.0,843.0,843.0
0.005,6,10,2006,5,927,1.0,659.0,659.0,5,1079,1.0,811.0,811.0
0.005,6,10,1854,5,889,1.0,621.0,621.0,5,965,1.0,697.0,697.0
0.166,6,10,1506,5,395,39.0,127.0,127.0,5,1111,38.0,843.0,843.0
40.055,17,10,676,5,460,10012.0,104.0,64.0,5,216,10012.0,20.0,15.0
0.202,6,16,2768,8,1386,28.0,533.0,320.0,8,1382,18.0,529.0,239.0
0.005,6,10,2006,5,927,1.0,659.0,659.0,5,1079,1.0,811.0,811.0
40.062,17,10,676,5,460,10013.0,104.0,64.0,5,216,10013.0,20.0,15.0
0.005,6,10,2007,5,928,1.0,660.0,660.0,5,1079,1.0,811.0,811.0
0.076,6,10,1506,5,395,16.0,127.0,127.0,5,1111,17.0,843.0,843.0
0.004,17,2,136,1,60,0.0,32.0,32.0,1,76,0.0,48.0,48.0
0.008,6,10,1983,5,910,2.0,642.0,642.0,5,1073,1.0,805.0,805.0
0.007,17,2,194,1,59,0.0,31.0,31.0,1,135,0.0,107.0,107.0
0.007,6,10,2006,5,927,1.0,659.0,659.0,5,1079,1.0,811.0,811.0
0.011,6,10,1989,5,910,2.0,642.0,642.0,5,1079,2.0,811.0,811.0
0.008,6,10,1989,5,910,2.0,642.0,642.0,5,1079,2.0,811.0,811.0
0.008,17,2,144,1,64,0.0,36.0,36.0,1,80,0.0,52.0,52.0
0.004,6,10,2007,5,928,1.0,660.0,660.0,5,1079,1.0,811.0,811.0
0.005,6,10,1989,5,927,1.0,659.0,659.0,5,1062,1.0,794.0,794.0
0.003,17,4,284,2,120,0.0,32.0,32.0,2,164,0.0,60.0,54.0
0.012,6,10,1983,5,910,3.0,642.0,642.0,5,1073,3.0,805.0,805.0
0.013,6,10,1990,5,911,3.0,643.0,643.0,5,1079,3.0,811.0,811.0
0.097,6,10,1506,5,395,20.0,127.0,127.0,5,1111,20.0,843.0,843.0
40.06,17,10,676,5,460,10012.0,104.0,64.0,5,216,10014.0,20.0,15.0
0.001,17,2,136,1,60,0.0,32.0,32.0,1,76,0.0,48.0,48.0
40.069,17,10,676,5,460,10016.0,104.0,64.0,5,216,10016.0,20.0,15.0
1799.413,17,2999,229703,1489,120649,1209.0,84.0,53.0,1510,109054,1192.0,227.0,44.0
0.001,17,2,180,1,66,0.0,38.0,38.0,1,114,0.0,86.0,86.0
0.012,6,10,1972,5,910,2.0,642.0,642.0,5,1062,2.0,794.0,794.0
0.006,6,10,1547,5,764,1.0,496.0,496.0,5,783,1.0,515.0,515.0
0.001,17,2,180,1,66,0.0,38.0,38.0,1,114,0.0,86.0,86.0
0.006,6,10,1989,5,927,1.0,659.0,659.0,5,1062,1.0,794.0,794.0
0.151,6,10,1506,5,395,36.0,127.0,127.0,5,1111,35.0,843.0,843.0
0.005,6,10,1989,5,927,1.0,659.0,659.0,5,1062,1.0,794.0,794.0
0.01,6,10,1762,5,911,2.0,643.0,643.0,5,851,2.0,583.0,583.0
0.088,6,10,1506,5,395,20.0,127.0,127.0,5,1111,19.0,843.0,843.0
0.073,6,13,3735,7,497,12.0,125.0,125.0,6,3238,14.0,1470.0,1459.0
0.006,17,2,214,1,75,0.0,47.0,47.0,1,139,0.0,111.0,111.0
0.01,6,10,1990,5,911,2.0,643.0,643.0,5,1079,2.0,811.0,811.0
0.096,6,10,1506,5,395,21.0,127.0,127.0,5,1111,19.0,843.0,843.0
0.007,6,10,1547,5,764,1.0,496.0,496.0,5,783,1.0,515.0,515.0
0.004,6,14,3742,7,452,0.0,80.0,80.0,7,3290,0.0,1448.0,972.0
0.014,6,10,1983,5,910,3.0,642.0,642.0,5,1073,3.0,805.0,805.0
300.309,6,16,2170,9,684,37517.0,146.0,146.0,7,1486,50023.0,419.0,398.0
0.015,6,10,1972,5,910,3.0,642.0,642.0,5,1062,3.0,794.0,794.0
0.018,6,13,3735,7,497,3.0,125.0,125.0,6,3238,3.0,1470.0,1459.0
10.816,17,28,4419,14,1995,823.0,270.0,114.0,14,2424,823.0,587.0,145.0
0.099,6,10,1506,5,395,22.0,127.0,127.0,5,1111,21.0,843.0,843.0
0.005,6,10,1989,5,927,1.0,659.0,659.0,5,1062,1.0,794.0,794.0
0.004,6,10,1702,5,863,0.0,595.0,595.0,5,839,1.0,571.0,571.0
0.022,6,10,1983,5,910,5.0,642.0,642.0,5,1073,5.0,805.0,805.0
0.005,6,11,1831,6,980,1.0,660.0,660.0,5,851,1.0,583.0,583.0
0.004,17,2,148,1,60,0.0,32.0,32.0,1,88,0.0,60.0,60.0
0.161,6,10,1506,5,395,38.0,127.0,127.0,5,1111,38.0,843.0,843.0
0.003,17,2,136,1,60,0.0,32.0,32.0,1,76,0.0,48.0,48.0
0.042,17,2,136,1,60,0.0,32.0,32.0,1,76,0.0,48.0,48.0
0.005,6,10,1689,5,839,1.0,571.0,571.0,5,850,1.0,582.0,582.0
0.014,6,10,1990,5,911,3.0,643.0,643.0,5,1079,3.0,811.0,811.0
300.346,6,16,2170,9,684,37522.0,146.0,146.0,7,1486,50029.0,419.0,398.0
0.001,17,2,180,1,66,0.0,38.0,38.0,1,114,0.0,86.0,86.0
0.003,17,2,162,1,65,0.0,37.0,37.0,1,97,0.0,69.0,69.0
0.01,6,10,1990,5,911,2.0,643.0,643.0,5,1079,2.0,811.0,811.0
0.007,6,10,1774,5,923,1.0,655.0,655.0,5,851,1.0,583.0,583.0
0.09,6,10,1506,5,395,21.0,127.0,127.0,5,1111,19.0,843.0,843.0
0.005,6,10,1989,5,927,1.0,659.0,659.0,5,1062,1.0,794.0,794.0
0.004,6,10,1989,5,927,1.0,659.0,659.0,5,1062,1.0,794.0,794.0
300.278,6,16,2170,9,684,37513.0,146.0,146.0,7,1486,50018.0,419.0,398.0
0.006,6,10,1547,5,764,1.0,496.0,496.0,5,783,1.0,515.0,515.0
0.013,6,10,1990,5,911,3.0,643.0,643.0,5,1079,3.0,811.0,811.0
0.003,17,4,284,2,120,0.0,32.0,32.0,2,164,0.0,60.0,54.0
0.006,6,10,1547,5,764,1.0,496.0,496.0,5,783,1.0,515.0,515.0
10.974,17,28,4390,14,2312,835.0,587.0,137.0,14,2078,835.0,269.0,120.0
0.008,17,2,299,1,65,0.0,37.0,37.0,1,234,0.0,206.0,206.0
0.003,17,2,136,1,60,0.0,32.0,32.0,1,76,0.0,48.0,48.0
0.005,6,10,1547,5,764,1.0,496.0,496.0,5,783,1.0,515.0,515.0
0.016,6,10,1989,5,910,4.0,642.0,642.0,5,1079,4.0,811.0,811.0
0.009,6,10,1972,5,910,2.0,642.0,642.0,5,1062,2.0,794.0,794.0
308.604,17,20,1124,10,716,34282.0,48.0,43.0,10,408,34280.0,20.0,12.0
0.016,6,10,1990,5,911,4.0,643.0,643.0,5,1079,4.0,811.0,811.0
15.078,17,17,8408,8,6273,2150.0,1350.0,756.0,9,2135,1881.0,1350.0,209.0
0.038,17,4,284,2,120,0.0,32.0,32.0,2,164,34.0,60.0,54.0
11.668,17,28,4393,14,2311,884.0,586.0,137.0,14,2082,884.0,269.0,120.0
0.072,6,10,1506,5,395,15.0,127.0,127.0,5,1111,15.0,843.0,843.0
0.127,17,4,364,2,160,1.0,52.0,52.0,2,204,89.0,80.0,74.0
1050.603,6,73,31475,38,7465,28394.0,1273.0,548.0,35,24010,29133.0,1402.0,924.0
40.062,17,10,676,5,460,10012.0,104.0,64.0,5,216,10014.0,20.0,15.0
0.101,6,10,1506,5,395,21.0,127.0,127.0,5,1111,19.0,843.0,843.0
0.014,6,10,1990,5,911,3.0,643.0,643.0,5,1079,3.0,811.0,811.0
0.005,6,10,1643,5,860,1.0,592.0,592.0,5,783,1.0,515.0,515.0
0.004,6,10,1702,5,863,1.0,595.0,595.0,5,839,0.0,571.0,571.0
0.006,17,2,179,1,71,0.0,43.0,43.0,1,108,0.0,80.0,80.0
0.006,6,10,1547,5,764,1.0,496.0,496.0,5,783,1.0,515.0,515.0
40.067,17,10,676,5,460,10015.0,104.0,64.0,5,216,10016.0,20.0,15.0
0.005,6,14,3799,7,509,0.0,137.0,137.0,7,3290,0.0,1448.0,972.0
15.197,17,19,9748,10,7450,1685.0,1350.0,717.0,9,2298,1896.0,1350.0,227.0
0.011,6,10,1989,5,910,2.0,642.0,642.0,5,1079,2.0,811.0,811.0
0.008,6,10,1689,5,839,2.0,571.0,571.0,5,850,1.0,582.0,582.0
40.081,17,10,676,5,460,10015.0,104.0,64.0,5,216,10018.0,20.0,15.0
0.004,6,10,2006,5,927,1.0,659.0,659.0,5,1079,1.0,811.0,811.0
0.092,6,10,1506,5,395,20.0,127.0,127.0,5,1111,20.0,843.0,843.0
0.004,17,4,284,2,120,0.0,32.0,32.0,2,164,0.0,60.0,54.0
0.008,17,2,136,1,60,0.0,32.0,32.0,1,76,0.0,48.0,48.0
0.016,6,10,1983,5,910,3.0,642.0,642.0,5,1073,4.0,805.0,805.0
368.627,6,22,2313,16,867,24575.0,195.0,195.0,6,1446,4639.0,419.0,398.0
0.101,6,10,1506,5,395,23.0,127.0,127.0,5,1111,24.0,843.0,843.0
0.039,17,2,182,1,65,0.0,37.0,37.0,1,117,0.0,89.0,89.0
0.124,17,2,364,1,61,0.0,33.0,33.0,1,303,0.0,275.0,275.0
0.004,17,4,284,2,120,1.0,32.0,32.0,2,164,1.0,60.0,54.0
312.96,17,20,1124,10,716,34759.0,48.0,43.0,10,408,34759.0,20.0,12.0
0.079,6,10,1506,5,395,19.0,127.0,127.0,5,1111,16.0,843.0,843.0
0.085,6,10,1506,5,395,18.0,127.0,127.0,5,1111,20.0,843.0,843.0
0.008,17,4,284,2,120,4.0,32.0,32.0,2,164,4.0,60.0,54.0
323.856,17,20,1124,10,716,35969.0,48.0,43.0,10,408,35969.0,20.0,12.0
0.008,6,10,1762,5,911,1.0,643.0,643.0,5,851,2.0,583.0,583.0
0.014,6,10,1989,5,910,3.0,642.0,642.0,5,1079,3.0,811.0,811.0
0.005,6,10,2000,5,927,1.0,659.0,659.0,5,1073,1.0,805.0,805.0
65.602,6,27,17716,15,9776,4685.0,2804.0,1498.0,12,7940,5948.0,2311.0,1218.0
0.091,6,10,1506,5,395,20.0,127.0,127.0,5,1111,15.0,843.0,843.0
0.005,6,10,1547,5,764,1.0,496.0,496.0,5,783,1.0,515.0,515.0
0.016,6,14,3787,7,497,2.0,125.0,125.0,7,3290,2.0,1448.0,972.0
40.053,17,10,676,5,460,10012.0,104.0,64.0,5,216,10012.0,20.0,15.0
0.004,6,10,1774,5,923,1.0,655.0,655.0,5,851,1.0,583.0,583.0
0.007,6,10,1990,5,911,1.0,643.0,643.0,5,1079,1.0,811.0,811.0
0.113,6,10,1506,5,395,26.0,127.0,127.0,5,1111,26.0,843.0,843.0
0.012,6,10,1983,5,910,3.0,642.0,642.0,5,1073,3.0,805.0,805.0
0.135,6,10,1506,5,395,32.0,127.0,127.0,5,1111,32.0,843.0,843.0
0.005,6,10,2000,5,927,1.0,659.0,659.0,5,1073,1.0,805.0,805.0
0.022,6,14,3868,7,578,3.0,206.0,206.0,7,3290,3.0,1448.0,972.0
172.208,17,68,9755,34,2267,5218.0,44.0,38.0,34,7488,5218.0,261.0,192.0
0.098,6,10,1506,5,395,22.0,127.0,127.0,5,1111,21.0,843.0,843.0
0.005,6,10,2007,5,928,1.0,660.0,660.0,5,1079,1.0,811.0,811.0
0.013,6,10,1972,5,910,3.0,642.0,642.0,5,1062,3.0,794.0,794.0
0.003,17,2,136,1,60,0.0,32.0,32.0,1,76,0.0,48.0,48.0
0.004,6,10,2006,5,927,1.0,659.0,659.0,5,1079,1.0,811.0,811.0
0.008,6,10,2006,6,979,1.0,659.0,659.0,4,1027,2.0,811.0,811.0
0.005,6,13,3747,7,509,0.0,137.0,137.0,6,3238,0.0,1470.0,1459.0
0.038,17,2,148,1,60,0.0,32.0,32.0,1,88,0.0,60.0,60.0
0.128,17,2,80,1,32,0.0,4.0,4.0,1,48,0.0,20.0,20.0
0.1,6,10,1506,5,395,22.0,127.0,127.0,5,1111,24.0,843.0,843.0
0.008,6,10,1990,5,911,2.0,643.0,643.0,5,1079,2.0,811.0,811.0
0.167,17,2,152,1,76,0.0,48.0,48.0,1,76,0.0,48.0,48.0
0.073,6,10,1506,5,395,16.0,127.0,127.0,5,1111,16.0,843.0,843.0
0.073,6,10,1506,5,395,16.0,127.0,127.0,5,1111,16.0,843.0,843.0
0.006,6,10,1854,5,889,1.0,621.0,621.0,5,965,1.0,697.0,697.0
0.041,17,2,152,1,76,0.0,48.0,48.0,1,76,0.0,48.0,48.0
0.037,17,4,284,2,120,1.0,32.0,32.0,2,164,33.0,60.0,54.0
0.014,6,10,1972,5,910,3.0,642.0,642.0,5,1062,3.0,794.0,794.0
15.079,17,15,8102,8,5959,2150.0,1350.0,716.0,7,2143,2508.0,1350.0,278.0
0.023,6,10,1677,5,827,5.0,559.0,559.0,5,850,5.0,582.0,582.0
0.012,6,10,1989,5,910,3.0,642.0,642.0,5,1079,2.0,811.0,811.0
0.005,6,10,2006,5,927,1.0,659.0,659.0,5,1079,1.0,811.0,811.0
0.009,6,10,1989,5,910,2.0,642.0,642.0,5,1079,2.0,811.0,811.0
0.006,6,10,1989,5,927,1.0,659.0,659.0,5,1062,1.0,794.0,794.0
40.146,17,10,676,5,460,10033.0,104.0,64.0,5,216,10035.0,20.0,15.0
0.022,6,10,1989,5,910,5.0,642.0,642.0,5,1079,5.0,811.0,811.0
0.006,6,10,1854,5,889,1.0,621.0,621.0,5,965,1.0,697.0,697.0
0.015,6,10,1972,5,910,3.0,642.0,642.0,5,1062,3.0,794.0,794.0
1770.632,6,83,4368,42,2210,43185.0,26.0,26.0,41,2158,44264.0,26.0,26.0
0.005,17,2,170,1,65,0.0,37.0,37.0,1,105,0.0,77.0,77.0
0.285,17,48,26427,27,21332,10.0,1350.0,762.0,21,5095,10.0,1350.0,214.0
0.17,6,10,1506,5,395,39.0,127.0,127.0,5,1111,38.0,843.0,843.0
0.004,6,10,1779,5,928,1.0,660.0,660.0,5,851,1.0,583.0,583.0
40.062,17,10,676,5,460,10013.0,104.0,64.0,5,216,10014.0,20.0,15.0
0.004,17,2,136,1,60,0.0,32.0,32.0,1,76,0.0,48.0,48.0
0.004,6,10,1989,5,927,1.0,659.0,659.0,5,1062,1.0,794.0,794.0
0.004,6,10,1779,5,928,1.0,660.0,660.0,5,851,1.0,583.0,583.0
0.006,17,2,179,1,71,0.0,43.0,43.0,1,108,0.0,80.0,80.0
9.037,17,6,376,5,280,2259.0,28.0,28.0,1,96,0.0,68.0,68.0
0.013,6,10,1989,5,910,3.0,642.0,642.0,5,1079,3.0,811.0,811.0
0.001,17,2,180,1,66,0.0,38.0,38.0,1,114,0.0,86.0,86.0
0.005,6,10,2006,5,927,1.0,659.0,659.0,5,1079,1.0,811.0,811.0
0.005,17,2,214,1,75,0.0,47.0,47.0,1,139,0.0,111.0,111.0
0.006,6,10,1547,5,764,1.0,496.0,496.0,5,783,1.0,515.0,515.0
0.038,17,2,184,1,61,0.0,33.0,33.0,1,123,0.0,95.0,95.0
0.073,6,10,1506,5,395,16.0,127.0,127.0,5,1111,15.0,843.0,843.0
0.08,6,10,1506,5,395,16.0,127.0,127.0,5,1111,17.0,843.0,843.0
0.005,17,2,170,1,65,0.0,37.0,37.0,1,105,0.0,77.0,77.0
0.005,6,10,1547,5,764,1.0,496.0,496.0,5,783,1.0,515.0,515.0
0.022,6,10,1990,5,911,5.0,643.0,643.0,5,1079,5.0,811.0,811.0
15.069,17,15,9238,8,6902,2148.0,1350.0,834.0,7,2336,2506.0,1350.0,305.0
0.107,6,10,1506,5,395,24.0,127.0,127.0,5,1111,17.0,843.0,843.0
0.01,6,10,1677,5,827,2.0,559.0,559.0,5,850,2.0,582.0,582.0
0.006,6,10,1689,5,839,1.0,571.0,571.0,5,850,1.0,582.0,582.0
240.091,6,16,4482,9,963,30011.0,238.0,166.0,7,3519,40014.0,1402.0,786.0
0.005,6,10,2006,5,927,1.0,659.0,659.0,5,1079,1.0,811.0,811.0
0.005,6,10,1643,5,860,1.0,592.0,592.0,5,783,1.0,515.0,515.0
0.005,17,2,144,1,64,0.0,36.0,36.0,1,80,0.0,52.0,52.0
0.148,6,10,1506,5,395,34.0,127.0,127.0,5,1111,35.0,843.0,843.0
0.044,6,13,3735,7,497,7.0,125.0,125.0,6,3238,8.0,1470.0,1459.0
0.005,6,10,2006,5,927,1.0,659.0,659.0,5,1079,1.0,811.0,811.0
0.006,6,10,1547,5,764,1.0,496.0,496.0,5,783,1.0,515.0,515.0
0.011,6,13,3735,7,497,1.0,125.0,125.0,6,3238,2.0,1470.0,1459.0
0.008,6,10,1989,5,910,2.0,642.0,642.0,5,1079,1.0,811.0,811.0
40.056,17,10,676,5,460,10013.0,104.0,64.0,5,216,10011.0,20.0,15.0
0.04,17,2,152,1,76,0.0,48.0,48.0,1,76,0.0,48.0,48.0
0.005,6,10,1989,5,927,1.0,659.0,659.0,5,1062,1.0,794.0,794.0
40.055,17,10,676,5,460,10012.0,104.0,64.0,5,216,10012.0,20.0,15.0
0.009,6,10,1990,5,911,2.0,643.0,643.0,5,1079,2.0,811.0,811.0
0.001,17,2,180,1,66,0.0,38.0,38.0,1,114,0.0,86.0,86.0
0.02,6,10,1983,5,910,5.0,642.0,642.0,5,1073,4.0,805.0,805.0
0.004,17,2,412,1,61,0.0,33.0,33.0,1,351,0.0,323.0,323.0
0.011,6,10,1677,5,827,2.0,559.0,559.0,5,850,2.0,582.0,582.0
10.778,17,28,4422,14,1995,821.0,270.0,114.0,14,2427,820.0,586.0,145.0
40.086,17,10,676,5,460,10020.0,104.0,64.0,5,216,10020.0,20.0,15.0
0.041,17,4,596,2,122,2.0,33.0,33.0,2,474,2.0,323.0,209.0
300.495,6,27,8922,15,1930,21463.0,517.0,285.0,12,6992,21859.0,1402.0,908.0
0.004,6,10,1702,5,863,1.0,595.0,595.0,5,839,0.0,571.0,571.0
0.005,17,2,169,1,62,0.0,34.0,34.0,1,107,0.0,79.0,79.0
0.064,6,10,1506,5,395,14.0,127.0,127.0,5,1111,14.0,843.0,843.0
0.021,6,13,3735,7,497,3.0,125.0,125.0,6,3238,4.0,1470.0,1459.0
0.004,6,10,2007,5,928,1.0,660.0,660.0,5,1079,1.0,811.0,811.0
0.005,6,10,2000,5,927,1.0,659.0,659.0,5,1073,1.0,805.0,805.0
1778.051,17,144,45504,72,22752,25042.0,288.0,288.0,72,22752,25042.0,288.0,288.0
0.005,6,10,2000,5,927,1.0,659.0,659.0,5,1073,1.0,805.0,805.0
0.004,17,2,136,1,60,0.0,32.0,32.0,1,76,0.0,48.0,48.0
0.012,6,10,1989,5,910,2.0,642.0,642.0,5,1079,2.0,811.0,811.0
0.001,17,2,180,1,66,0.0,38.0,38.0,1,114,0.0,86.0,86.0
0.005,6,10,1547,5,764,1.0,496.0,496.0,5,783,1.0,515.0,515.0
165.416,17,78,11255,39,2607,4352.0,44.0,38.0,39,8648,4352.0,279.0,193.0
0.071,6,10,1506,5,395,16.0,127.0,127.0,5,1111,16.0,843.0,843.0
0.065,6,10,1506,5,395,13.0,127.0,127.0,5,1111,14.0,843.0,843.0
0.005,6,10,1643,5,860,1.0,592.0,592.0,5,783,1.0,515.0,515.0
0.015,6,10,1983,5,910,3.0,642.0,642.0,5,1073,3.0,805.0,805.0
0.005,6,10,1989,5,927,1.0,659.0,659.0,5,1062,1.0,794.0,794.0
0.079,17,2,80,1,32,0.0,4.0,4.0,1,48,0.0,20.0,20.0
0.011,6,10,1990,5,911,2.0,643.0,643.0,5,1079,2.0,811.0,811.0
0.014,6,10,1677,5,827,3.0,559.0,559.0,5,850,3.0,582.0,582.0
0.084,6,10,1506,5,395,19.0,127.0,127.0,5,1111,18.0,843.0,843.0
0.014,6,10,1989,5,910,3.0,642.0,642.0,5,1079,3.0,811.0,811.0
0.128,6,10,1506,5,395,18.0,127.0,127.0,5,1111,30.0,843.0,843.0
0.005,6,10,1989,5,927,1.0,659.0,659.0,5,1062,1.0,794.0,794.0
0.095,6,10,1506,5,395,18.0,127.0,127.0,5,1111,20.0,843.0,843.0
244.6,6,39,8268,18,4959,14388.0,1368.0,366.0,21,3309,12229.0,580.0,184.0
0.004,6,10,2006,5,927,1.0,659.0,659.0,5,1079,1.0,811.0,811.0
0.005,6,10,1643,5,860,1.0,592.0,592.0,5,783,1.0,515.0,515.0
0.006,6,10,2006,5,927,1.0,659.0,659.0,5,1079,1.0,811.0,811.0
0.027,6,10,1677,5,827,6.0,559.0,559.0,5,850,6.0,582.0,582.0
311.359,17,20,1124,10,716,34581.0,48.0,43.0,10,408,34581.0,20.0,12.0
0.005,17,2,180,1,58,0.0,30.0,30.0,1,122,0.0,94.0,94.0
0.004,17,2,148,1,60,0.0,32.0,32.0,1,88,0.0,60.0,60.0
0.01,6,10,1972,5,910,2.0,642.0,642.0,5,1062,2.0,794.0,794.0
8.986,6,37,9811,19,4293,499.0,1360.0,700.0,18,5518,516.0,1360.0,398.0
0.021,6,10,1990,5,911,5.0,643.0,643.0,5,1079,5.0,811.0,811.0
0.016,6,10,1989,5,910,3.0,642.0,642.0,5,1079,3.0,811.0,811.0
0.067,6,10,1506,5,395,14.0,127.0,127.0,5,1111,14.0,843.0,843.0
0.005,17,2,140,1,62,0.0,34.0,34.0,1,78,0.0,50.0,50.0
0.004,6,10,2000,5,927,1.0,659.0,659.0,5,1073,1.0,805.0,805.0
174.409,17,102,14832,51,3448,3488.0,44.0,39.0,51,11384,3488.0,261.0,195.0
0.016,17,2,198,1,91,0.0,63.0,63.0,1,107,0.0,79.0,79.0
0.009,6,12,1926,6,1189,1.0,659.0,434.0,6,737,1.0,417.0,417.0
0.124,6,10,1506,5,395,28.0,127.0,127.0,5,1111,28.0,843.0,843.0
0.006,6,10,2007,5,928,1.0,660.0,660.0,5,1079,1.0,811.0,811.0
0.014,6,10,1990,5,911,3.0,643.0,643.0,5,1079,3.0,811.0,811.0
0.004,6,10,1702,5,863,1.0,595.0,595.0,5,839,1.0,571.0,571.0
40.052,17,10,676,5,460,10011.0,104.0,64.0,5,216,10012.0,20.0,15.0
0.012,6,10,1989,5,910,3.0,642.0,642.0,5,1079,2.0,811.0,811.0
0.004,6,10,2006,5,927,1.0,659.0,659.0,5,1079,1.0,811.0,811.0
0.01,6,10,1983,5,910,2.0,642.0,642.0,5,1073,2.0,805.0,805.0
11.091,17,28,4422,14,1995,840.0,270.0,114.0,14,2427,840.0,586.0,145.0
0.005,6,10,1989,5,927,1.0,659.0,659.0,5,1062,1.0,794.0,794.0
0.005,6,10,2006,5,927,1.0,659.0,659.0,5,1079,1.0,811.0,811.0
0.004,6,10,2006,5,927,1.0,659.0,659.0,5,1079,1.0,811.0,811.0
0.004,6,10,2006,5,927,1.0,659.0,659.0,5,1079,1.0,811.0,811.0
0.034,6,10,1983,5,910,8.0,642.0,642.0,5,1073,8.0,805.0,805.0
0.005,6,10,2006,5,927,1.0,659.0,659.0,5,1079,1.0,811.0,811.0
0.006,6,10,1547,5,764,1.0,496.0,496.0,5,783,1.0,515.0,515.0
0.014,6,10,1989,5,910,3.0,642.0,642.0,5,1079,3.0,811.0,811.0
0.041,17,2,152,1,76,0.0,48.0,48.0,1,76,0.0,48.0,48.0
0.148,6,10,1506,5,395,35.0,127.0,127.0,5,1111,34.0,843.0,843.0
0.009,6,10,1631,5,848,2.0,580.0,580.0,5,783,2.0,515.0,515.0
0.007,6,12,1698,6,863,1.0,327.0,271.0,6,835,1.0,515.0,515.0
0.111,6,10,1506,5,395,25.0,127.0,127.0,5,1111,24.0,843.0,843.0
0.01,6,10,1972,5,910,2.0,642.0,642.0,5,1062,2.0,794.0,794.0
0.008,6,10,1989,5,910,2.0,642.0,642.0,5,1079,2.0,811.0,811.0
0.007,6,10,1990,5,911,1.0,643.0,643.0,5,1079,1.0,811.0,811.0
0.018,6,13,3735,7,497,3.0,125.0,125.0,6,3238,3.0,1470.0,1459.0
0.006,6,10,1854,5,889,1.0,621.0,621.0,5,965,1.0,697.0,697.0
0.041,17,2,152,1,76,0.0,48.0,48.0,1,76,0.0,48.0,48.0
354.05,6,21,1795,16,1030,23603.0,190.0,190.0,5,765,60002.0,464.0,248.0
0.115,6,10,1506,5,395,27.0,127.0,127.0,5,1111,21.0,843.0,843.0
0.005,6,10,2006,5,927,1.0,659.0,659.0,5,1079,1.0,811.0,811.0
0.006,6,10,1547,5,764,1.0,496.0,496.0,5,783,1.0,515.0,515.0
0.008,6,10,1983,5,910,2.0,642.0,642.0,5,1073,1.0,805.0,805.0
0.014,6,10,1983,5,910,3.0,642.0,642.0,5,1073,3.0,805.0,805.0
0.083,6,10,1506,5,395,19.0,127.0,127.0,5,1111,17.0,843.0,843.0
40.054,17,10,676,5,460,10010.0,104.0,64.0,5,216,10012.0,20.0,15.0
0.01,6,10,1631,5,848,2.0,580.0,580.0,5,783,2.0,515.0,515.0
0.053,17,2,152,1,76,0.0,48.0,48.0,1,76,0.0,48.0,48.0
0.005,17,2,170,1,65,0.0,37.0,37.0,1,105,0.0,77.0,77.0
0.005,6,10,1547,5,764,1.0,496.0,496.0,5,783,1.0,515.0,515.0
0.006,6,10,2007,5,928,1.0,660.0,660.0,5,1079,1.0,811.0,811.0
0.005,6,10,1689,5,839,1.0,571.0,571.0,5,850,1.0,582.0,582.0
0.006,6,10,1989,5,927,1.0,659.0,659.0,5,1062,1.0,794.0,794.0
0.116,6,10,1506,5,395,27.0,127.0,127.0,5,1111,27.0,843.0,843.0
0.004,6,10,1779,5,928,1.0,660.0,660.0,5,851,0.0,583.0,583.0
241.386,6,394,348764,187,21247,1297.0,2736.0,959.0,207,327517,1171.0,3053.0,1607.0
0.005,6,10,2006,5,927,1.0,659.0,659.0,5,1079,1.0,811.0,811.0
0.124,17,4,364,2,160,0.0,52.0,52.0,2,204,83.0,80.0,74.0
0.006,6,10,1547,5,764,1.0,496.0,496.0,5,783,1.0,515.0,515.0
0.016,6,10,1989,5,910,4.0,642.0,642.0,5,1079,4.0,811.0,811.0
0.006,6,10,1643,5,860,1.0,592.0,592.0,5,783,1.0,515.0,515.0
0.038,17,2,170,1,65,0.0,37.0,37.0,1,105,0.0,77.0,77.0
269.987,6,75,40607,34,5542,8181.0,944.0,314.0,41,35065,6749.0,2804.0,1097.0
170.229,17,76,10586,38,2551,4600.0,44.0,39.0,38,8035,4600.0,239.0,183.0
40.101,17,10,676,5,460,10013.0,104.0,64.0,5,216,10017.0,20.0,15.0
0.027,6,10,1990,5,911,6.0,643.0,643.0,5,1079,6.0,811.0,811.0
0.006,6,10,1547,5,764,1.0,496.0,496.0,5,783,1.0,515.0,515.0
246.776,6,21,4753,8,923,17.0,238.0,166.0,13,3830,20564.0,1402.0,786.0
0.005,6,10,2000,5,927,1.0,659.0,659.0,5,1073,1.0,805.0,805.0
1787.498,6,150,19350,90,13740,20084.0,302.0,302.0,60,5610,30296.0,83.0,83.0
0.004,6,10,1779,5,928,1.0,660.0,660.0,5,851,1.0,583.0,583.0
0.011,6,10,1972,5,910,2.0,642.0,642.0,5,1062,2.0,794.0,794.0
0.027,6,10,1989,5,910,6.0,642.0,642.0,5,1079,6.0,811.0,811.0
0.053,17,2,152,1,76,0.0,48.0,48.0,1,76,0.0,48.0,48.0
40.073,17,10,676,5,460,10017.0,104.0,64.0,5,216,10017.0,20.0,15.0
0.003,17,2,136,1,60,0.0,32.0,32.0,1,76,0.0,48.0,48.0
0.005,6,10,1779,5,928,1.0,660.0,660.0,5,851,1.0,583.0,583.0
0.012,6,10,1990,5,911,2.0,643.0,643.0,5,1079,3.0,811.0,811.0
0.001,17,2,179,1,62,0.0,34.0,34.0,1,117,0.0,89.0,89.0
0.041,17,2,412,1,61,0.0,33.0,33.0,1,351,0.0,323.0,323.0
40.058,17,10,676,5,460,10013.0,104.0,64.0,5,216,10013.0,20.0,15.0
11.607,17,28,4399,14,2312,880.0,587.0,137.0,14,2087,879.0,270.0,121.0
240.094,6,16,4481,9,963,30011.0,238.0,166.0,7,3518,40015.0,1402.0,786.0
0.109,6,10,1506,5,395,25.0,127.0,127.0,5,1111,22.0,843.0,843.0
0.006,6,10,2007,5,928,1.0,660.0,660.0,5,1079,1.0,811.0,811.0
0.001,17,2,180,1,66,0.0,38.0,38.0,1,114,0.0,86.0,86.0
0.006,6,10,1689,5,839,1.0,571.0,571.0,5,850,1.0,582.0,582.0
1786.237,6,155,19626,92,13852,19628.0,302.0,302.0,63,5774,28810.0,83.0,83.0
0.006,6,10,1547,5,764,1.0,496.0,496.0,5,783,1.0,515.0,515.0
0.009,6,10,1972,5,910,2.0,642.0,642.0,5,1062,2.0,794.0,794.0
0.009,6,10,1990,5,911,2.0,643.0,643.0,5,1079,2.0,811.0,811.0
0.008,6,10,1972,5,910,1.0,642.0,642.0,5,1062,2.0,794.0,794.0
0.017,6,10,1972,5,910,4.0,642.0,642.0,5,1062,4.0,794.0,794.0
0.173,17,2,152,1,76,0.0,48.0,48.0,1,76,0.0,48.0,48.0
240.089,6,16,4482,9,963,30011.0,238.0,166.0,7,3519,40014.0,1402.0,786.0
0.007,6,10,1547,5,764,1.0,496.0,496.0,5,783,1.0,515.0,515.0
15.083,17,16,8695,8,6600,2150.0,1350.0,797.0,8,2095,2150.0,1350.0,233.0
0.004,6,10,1779,5,928,1.0,660.0,660.0,5,851,1.0,583.0,583.0
0.015,6,10,1631,5,848,3.0,580.0,580.0,5,783,3.0,515.0,515.0
0.001,17,2,180,1,66,0.0,38.0,38.0,1,114,0.0,86.0,86.0
0.005,6,10,2006,5,927,1.0,659.0,659.0,5,1079,1.0,811.0,811.0
0.11,6,10,1506,5,395,26.0,127.0,127.0,5,1111,18.0,843.0,843.0
0.01,6,10,1989,5,910,2.0,642.0,642.0,5,1079,2.0,811.0,811.0
0.005,6,10,1643,5,860,1.0,592.0,592.0,5,783,1.0,515.0,515.0
0.006,6,10,1643,5,860,1.0,592.0,592.0,5,783,1.0,515.0,515.0
0.135,17,2,80,1,32,0.0,4.0,4.0,1,48,0.0,20.0,20.0
15.091,17,16,8590,8,6469,2149.0,1350.0,780.0,8,2121,2151.0,1350.0,237.0
311.296,17,20,1124,10,716,34581.0,48.0,43.0,10,408,34580.0,20.0,12.0
0.004,6,10,1702,5,863,1.0,595.0,595.0,5,839,0.0,571.0,571.0
0.004,17,2,234,1,61,0.0,33.0,33.0,1,173,0.0,145.0,145.0
529.714,6,37,13880,20,3451,27879.0,676.0,400.0,17,10429,29353.0,1402.0,953.0
0.006,6,10,1547,5,764,1.0,496.0,496.0,5,783,1.0,515.0,515.0
0.005,6,10,2006,5,927,1.0,659.0,659.0,5,1079,1.0,811.0,811.0
0.008,6,10,1983,5,910,2.0,642.0,642.0,5,1073,2.0,805.0,805.0
0.053,17,2,152,1,76,0.0,48.0,48.0,1,76,0.0,48.0,48.0
0.005,6,10,2006,5,927,1.0,659.0,659.0,5,1079,1.0,811.0,811.0
0.263,17,49,31687,29,28448,9.0,1350.0,952.0,20,3239,11.0,1350.0,133.0
0.007,6,10,2007,5,928,1.0,660.0,660.0,5,1079,1.0,811.0,811.0
0.001,17,2,180,1,65,0.0,37.0,37.0,1,115,0.0,87.0,87.0
0.02,6,10,1989,5,910,5.0,642.0,642.0,5,1079,4.0,811.0,811.0
0.077,6,10,1506,5,395,17.0,127.0,127.0,5,1111,17.0,843.0,843.0
289.355,6,391,347342,201,22002,1446.0,2736.0,888.0,190,325340,1530.0,3034.0,1802.0
0.01,6,10,1631,5,848,2.0,580.0,580.0,5,783,2.0,515.0,515.0
0.214,17,4,596,2,122,176.0,33.0,33.0,2,474,142.0,323.0,209.0
0.015,17,2,180,1,66,0.0,38.0,38.0,1,114,0.0,86.0,86.0
0.007,17,2,179,1,71,0.0,43.0,43.0,1,108,0.0,80.0,80.0
0.01,17,2,148,1,60,0.0,32.0,32.0,1,88,0.0,60.0,60.0
0.005,6,10,2006,5,927,1.0,659.0,659.0,5,1079,1.0,811.0,811.0
0.075,6,10,1506,5,395,16.0,127.0,127.0,5,1111,15.0,843.0,843.0
0.01,6,10,1989,5,910,2.0,642.0,642.0,5,1079,2.0,811.0,811.0
1756.146,6,107,6374,60,3525,29764.0,27.0,27.0,47,2849,38176.0,27.0,27.0
0.016,6,10,1983,5,910,4.0,642.0,642.0,5,1073,4.0,805.0,805.0
0.005,6,10,1989,5,927,1.0,659.0,659.0,5,1062,1.0,794.0,794.0
0.059,17,2,152,1,76,0.0,48.0,48.0,1,76,0.0,48.0,48.0
0.012,6,10,1631,5,848,3.0,580.0,580.0,5,783,3.0,515.0,515.0
0.001,17,2,152,1,62,0.0,34.0,34.0,1,90,0.0,62.0,62.0
0.083,6,10,1506,5,395,17.0,127.0,127.0,5,1111,17.0,843.0,843.0
0.006,6,13,3747,7,509,0.0,137.0,137.0,6,3238,1.0,1470.0,1459.0
11.211,17,28,4418,14,1995,850.0,270.0,114.0,14,2423,850.0,586.0,145.0
0.087,6,10,1506,5,395,19.0,127.0,127.0,5,1111,18.0,843.0,843.0
0.004,6,10,1989,5,927,1.0,659.0,659.0,5,1062,1.0,794.0,794.0
0.013,6,10,1972,5,910,3.0,642.0,642.0,5,1062,3.0,794.0,794.0
0.004,6,10,2007,5,928,1.0,660.0,660.0,5,1079,1.0,811.0,811.0
0.004,17,4,284,2,120,1.0,32.0,32.0,2,164,0.0,60.0,54.0
0.005,6,10,2006,5,927,1.0,659.0,659.0,5,1079,1.0,811.0,811.0
240.098,6,31,9331,15,6911,17149.0,2036.0,681.0,16,2420,16006.0,580.0,197.0
0.004,17,2,152,1,76,0.0,48.0,48.0,1,76,0.0,48.0,48.0
0.01,6,10,1990,5,911,2.0,643.0,643.0,5,1079,2.0,811.0,811.0
0.013,6,10,1989,5,910,3.0,642.0,642.0,5,1079,3.0,811.0,811.0
0.001,17,2,136,1,60,0.0,32.0,32.0,1,76,0.0,48.0,48.0
240.095,6,31,9223,15,6772,17149.0,1896.0,666.0,16,2451,16006.0,580.0,201.0
0.005,17,2,179,1,71,0.0,43.0,43.0,1,108,0.0,80.0,80.0
0.037,17,2,170,1,65,0.0,37.0,37.0,1,105,0.0,77.0,77.0
0.005,6,10,1989,5,927,1.0,659.0,659.0,5,1062,1.0,794.0,794.0
0.001,17,2,180,1,66,0.0,38.0,38.0,1,114,0.0,86.0,86.0
0.011,6,10,1631,5,848,2.0,580.0,580.0,5,783,2.0,515.0,515.0
0.017,6,10,1989,5,910,4.0,642.0,642.0,5,1079,4.0,811.0,811.0
0.005,6,10,2007,5,928,1.0,660.0,660.0,5,1079,1.0,811.0,811.0
0.005,17,2,412,1,61,0.0,33.0,33.0,1,351,0.0,323.0,323.0
0.006,17,2,169,1,62,0.0,34.0,34.0,1,107,0.0,79.0,79.0
0.003,17,2,148,1,60,0.0,32.0,32.0,1,88,0.0,60.0,60.0
0.005,17,2,164,1,74,0.0,46.0,46.0,1,90,0.0,62.0,62.0
0.381,17,43,23367,24,18522,16.0,1350.0,743.0,19,4845,17.0,1350.0,227.0
369.877,6,22,2313,16,867,24658.0,195.0,195.0,6,1446,4646.0,419.0,398.0
0.086,6,10,1506,5,395,18.0,127.0,127.0,5,1111,18.0,843.0,843.0
0.101,6,10,1506,5,395,22.0,127.0,127.0,5,1111,23.0,843.0,843.0
0.005,6,10,1989,5,927,1.0,659.0,659.0,5,1062,1.0,794.0,794.0
240.013,6,9,787,5,488,60003.0,232.0,232.0,4,299,80003.0,83.0,83.0
0.012,6,10,1631,5,848,2.0,580.0,580.0,5,783,3.0,515.0,515.0
40.064,17,10,676,5,460,10015.0,104.0,64.0,5,216,10015.0,20.0,15.0
308.924,17,20,1124,10,716,34310.0,48.0,43.0,10,408,34310.0,20.0,12.0
0.014,6,10,1631,5,848,3.0,580.0,580.0,5,783,3.0,515.0,515.0
0.041,17,2,152,1,76,0.0,48.0,48.0,1,76,0.0,48.0,48.0
0.071,17,2,148,1,60,0.0,32.0,32.0,1,88,0.0,60.0,60.0
0.001,17,2,180,1,66,0.0,38.0,38.0,1,114,0.0,86.0,86.0
0.04,17,4,284,2,120,0.0,32.0,32.0,2,164,36.0,60.0,54.0
0.01,6,10,1989,5,910,2.0,642.0,642.0,5,1079,2.0,811.0,811.0
0.081,6,10,1506,5,395,16.0,127.0,127.0,5,1111,18.0,843.0,843.0
0.015,6,10,1983,5,910,3.0,642.0,642.0,5,1073,3.0,805.0,805.0
0.004,6,10,2007,5,928,1.0,660.0,660.0,5,1079,1.0,811.0,811.0
0.012,6,10,1631,5,848,2.0,580.0,580.0,5,783,2.0,515.0,515.0
0.081,6,10,1506,5,395,17.0,127.0,127.0,5,1111,16.0,843.0,843.0
0.006,17,2,194,1,59,0.0,31.0,31.0,1,135,0.0,107.0,107.0
0.004,6,10,2006,5,927,1.0,659.0,659.0,5,1079,1.0,811.0,811.0
0.006,6,10,2006,5,927,1.0,659.0,659.0,5,1079,1.0,811.0,811.0
0.102,6,10,1506,5,395,21.0,127.0,127.0,5,1111,21.0,843.0,843.0
0.011,6,10,1972,5,910,2.0,642.0,642.0,5,1062,2.0,794.0,794.0
0.099,6,10,1506,5,395,20.0,127.0,127.0,5,1111,23.0,843.0,843.0
0.04,17,2,136,1,60,0.0,32.0,32.0,1,76,0.0,48.0,48.0
637.345,6,41,14544,22,3555,30349.0,676.0,400.0,19,10989,32067.0,1402.0,832.0
0.005,6,10,1774,5,923,1.0,655.0,655.0,5,851,1.0,583.0,583.0
40.067,17,10,676,5,460,10016.0,104.0,64.0,5,216,10015.0,20.0,15.0
0.083,6,10,1506,5,395,20.0,127.0,127.0,5,1111,15.0,843.0,843.0
0.005,6,10,1689,5,839,1.0,571.0,571.0,5,850,1.0,582.0,582.0
0.072,6,10,1506,5,395,16.0,127.0,127.0,5,1111,16.0,843.0,843.0
0.078,6,10,1506,5,395,16.0,127.0,127.0,5,1111,15.0,843.0,843.0
0.014,6,10,1990,5,911,3.0,643.0,643.0,5,1079,3.0,811.0,811.0
0.138,6,10,1506,5,395,30.0,127.0,127.0,5,1111,32.0,843.0,843.0
0.005,6,10,1779,5,928,1.0,660.0,660.0,5,851,1.0,583.0,583.0
0.007,6,10,1547,5,764,1.0,496.0,496.0,5,783,1.0,515.0,515.0
0.072,17,2,170,1,65,0.0,37.0,37.0,1,105,0.0,77.0,77.0
0.007,17,2,299,1,65,0.0,37.0,37.0,1,234,0.0,206.0,206.0
0.102,6,10,1506,5,395,22.0,127.0,127.0,5,1111,24.0,843.0,843.0
0.009,6,10,1677,5,827,2.0,559.0,559.0,5,850,2.0,582.0,582.0
0.005,6,13,3747,7,509,0.0,137.0,137.0,6,3238,0.0,1470.0,1459.0
0.006,17,2,180,1,66,0.0,38.0,38.0,1,114,0.0,86.0,86.0
0.005,6,10,1689,5,839,1.0,571.0,571.0,5,850,1.0,582.0,582.0
0.005,17,2,170,1,65,0.0,37.0,37.0,1,105,0.0,77.0,77.0
0.005,17,2,213,1,69,0.0,41.0,41.0,1,144,0.0,116.0,116.0
0.005,6,10,1774,5,923,1.0,655.0,655.0,5,851,1.0,583.0,583.0
0.001,17,2,180,1,66,0.0,38.0,38.0,1,114,0.0,86.0,86.0
0.081,6,10,1506,5,395,18.0,127.0,127.0,5,1111,19.0,843.0,843.0
0.075,6,10,1506,5,395,15.0,127.0,127.0,5,1111,14.0,843.0,843.0
0.006,6,10,1643,5,860,1.0,592.0,592.0,5,783,1.0,515.0,515.0
0.022,6,10,1972,5,910,5.0,642.0,642.0,5,1062,5.0,794.0,794.0
0.016,6,10,1677,5,827,4.0,559.0,559.0,5,850,3.0,582.0,582.0
0.001,17,2,166,1,75,0.0,47.0,47.0,1,91,0.0,63.0,63.0
0.008,6,10,1989,5,910,1.0,642.0,642.0,5,1079,1.0,811.0,811.0
0.006,6,10,1643,5,860,1.0,592.0,592.0,5,783,1.0,515.0,515.0
1786.346,6,150,19350,90,13740,20071.0,302.0,302.0,60,5610,30276.0,83.0,83.0
0.099,6,10,1506,5,395,21.0,127.0,127.0,5,1111,21.0,843.0,843.0
0.006,17,2,170,1,65,0.0,37.0,37.0,1,105,0.0,77.0,77.0
0.016,6,10,1631,5,848,3.0,580.0,580.0,5,783,3.0,515.0,515.0
0.007,17,2,293,1,73,0.0,45.0,45.0,1,220,0.0,192.0,192.0
0.006,6,10,1643,5,860,1.0,592.0,592.0,5,783,1.0,515.0,515.0
0.008,6,10,1972,5,910,2.0,642.0,642.0,5,1062,1.0,794.0,794.0
0.09,6,10,1506,5,395,21.0,127.0,127.0,5,1111,20.0,843.0,843.0
310.237,17,20,1124,10,716,34455.0,48.0,43.0,10,408,34455.0,20.0,12.0
0.257,17,44,27844,26,24770,10.0,1350.0,924.0,18,3074,11.0,1350.0,142.0
1770.612,17,120,11460,60,5460,30010.0,63.0,63.0,60,6000,30010.0,72.0,72.0
0.009,6,14,3787,7,497,1.0,125.0,125.0,7,3290,1.0,1448.0,972.0
0.037,17,2,136,1,60,0.0,32.0,32.0,1,76,0.0,48.0,48.0
0.024,6,10,1990,5,911,5.0,643.0,643.0,5,1079,6.0,811.0,811.0
0.004,6,10,1702,5,863,1.0,595.0,595.0,5,839,1.0,571.0,571.0
0.012,6,10,1989,5,910,3.0,642.0,642.0,5,1079,2.0,811.0,811.0
15.071,17,15,9238,8,6902,2149.0,1350.0,834.0,7,2336,2507.0,1350.0,305.0
0.015,17,2,180,1,66,0.0,38.0,38.0,1,114,0.0,86.0,86.0
0.004,17,4,284,2,120,0.0,32.0,32.0,2,164,1.0,60.0,54.0
0.004,6,10,1779,5,928,1.0,660.0,660.0,5,851,1.0,583.0,583.0
0.005,17,2,140,1,62,0.0,34.0,34.0,1,78,0.0,50.0,50.0
0.04,17,2,182,1,65,0.0,37.0,37.0,1,117,0.0,89.0,89.0
0.061,6,10,1506,5,395,12.0,127.0,127.0,5,1111,13.0,843.0,843.0
0.076,6,10,1506,5,395,15.0,127.0,127.0,5,1111,17.0,843.0,843.0
0.004,6,10,2006,5,927,1.0,659.0,659.0,5,1079,1.0,811.0,811.0
0.006,17,2,166,1,75,0.0,47.0,47.0,1,91,0.0,63.0,63.0
0.012,6,10,1983,5,910,2.0,642.0,642.0,5,1073,3.0,805.0,805.0
352.797,6,20,2210,6,1308,12003.0,494.0,494.0,14,902,27138.0,83.0,83.0
0.142,6,10,1506,5,395,30.0,127.0,127.0,5,1111,34.0,843.0,843.0
0.006,17,2,170,1,65,0.0,37.0,37.0,1,105,0.0,77.0,77.0
0.006,17,2,230,1,68,0.0,40.0,40.0,1,162,0.0,134.0,134.0
240.022,6,9,787,5,488,60005.0,232.0,232.0,4,299,80006.0,83.0,83.0
0.005,6,10,2007,5,928,1.0,660.0,660.0,5,1079,1.0,811.0,811.0
0.004,6,10,2006,5,927,1.0,659.0,659.0,5,1079,1.0,811.0,811.0
0.001,17,2,166,1,75,0.0,47.0,47.0,1,91,0.0,63.0,63.0
0.082,6,10,1506,5,395,16.0,127.0,127.0,5,1111,18.0,843.0,843.0
40.071,17,10,676,5,460,10015.0,104.0,64.0,5,216,10017.0,20.0,15.0
0.081,6,10,1506,5,395,18.0,127.0,127.0,5,1111,18.0,843.0,843.0
0.01,6,13,3735,7,497,1.0,125.0,125.0,6,3238,2.0,1470.0,1459.0
0.123,6,10,1506,5,395,27.0,127.0,127.0,5,1111,25.0,843.0,843.0
0.08,6,10,1506,5,395,19.0,127.0,127.0,5,1111,18.0,843.0,843.0
0.005,6,10,1989,5,927,1.0,659.0,659.0,5,1062,1.0,794.0,794.0
0.045,6,10,1972,5,910,11.0,642.0,642.0,5,1062,11.0,794.0,794.0
0.02,6,10,1989,5,910,5.0,642.0,642.0,5,1079,4.0,811.0,811.0
0.004,6,10,1774,5,923,1.0,655.0,655.0,5,851,1.0,583.0,583.0
0.01,6,10,1989,5,910,2.0,642.0,642.0,5,1079,2.0,811.0,811.0
0.013,6,10,1989,5,910,3.0,642.0,642.0,5,1079,3.0,811.0,811.0
40.061,17,10,676,5,460,10014.0,104.0,64.0,5,216,10014.0,20.0,15.0
0.015,6,10,1990,5,911,3.0,643.0,643.0,5,1079,3.0,811.0,811.0
15.08,17,16,9302,8,6912,2150.0,1350.0,836.0,8,2390,2150.0,1350.0,270.0
0.005,6,10,1989,5,927,1.0,659.0,659.0,5,1062,1.0,794.0,794.0
0.005,6,10,2006,5,927,1.0,659.0,659.0,5,1079,1.0,811.0,811.0
40.053,17,10,676,5,460,10012.0,104.0,64.0,5,216,10012.0,20.0,15.0
0.036,6,10,1762,5,911,8.0,643.0,643.0,5,851,8.0,583.0,583.0
0.006,17,2,230,1,68,0.0,40.0,40.0,1,162,0.0,134.0,134.0
30.838,6,19,9444,10,772,3426.0,240.0,240.0,9,8672,3853.0,1402.0,1366.0
0.006,6,10,1547,5,764,1.0,496.0,496.0,5,783,1.0,515.0,515.0
0.004,6,10,2006,5,927,1.0,659.0,659.0,5,1079,1.0,811.0,811.0
0.005,6,10,2007,5,928,1.0,660.0,660.0,5,1079,1.0,811.0,811.0
1797.102,6,243,35755,151,25972,11980.0,302.0,302.0,92,9783,19748.0,102.0,83.0
0.015,6,10,1990,5,911,3.0,643.0,643.0,5,1079,3.0,811.0,811.0
0.001,17,2,180,1,66,0.0,38.0,38.0,1,114,0.0,86.0,86.0
15.223,17,21,9167,10,6403,1687.0,1350.0,612.0,11,2764,1519.0,1350.0,223.0
0.009,6,10,1990,5,911,2.0,643.0,643.0,5,1079,2.0,811.0,811.0
0.012,6,10,1631,5,848,3.0,580.0,580.0,5,783,3.0,515.0,515.0
0.015,6,13,3735,7,497,2.0,125.0,125.0,6,3238,3.0,1470.0,1459.0
0.006,6,10,1689,5,839,1.0,571.0,571.0,5,850,1.0,582.0,582.0
0.02,6,10,1989,5,910,4.0,642.0,642.0,5,1079,4.0,811.0,811.0
0.096,17,2,80,1,32,0.0,4.0,4.0,1,48,0.0,20.0,20.0
0.012,6,10,1990,5,911,2.0,643.0,643.0,5,1079,2.0,811.0,811.0
0.005,6,10,2007,5,928,1.0,660.0,660.0,5,1079,1.0,811.0,811.0
0.097,6,10,1506,5,395,20.0,127.0,127.0,5,1111,23.0,843.0,843.0
0.154,6,10,1506,5,395,27.0,127.0,127.0,5,1111,35.0,843.0,843.0
177.163,17,74,10653,37,2466,4921.0,44.0,38.0,37,8187,4921.0,239.0,193.0
0.071,17,8,3613,4,1874,23.0,1350.0,440.0,4,1739,12.0,1350.0,406.0
0.006,6,10,1547,5,764,1.0,496.0,496.0,5,783,1.0,515.0,515.0
0.006,6,10,1547,5,764,1.0,496.0,496.0,5,783,1.0,515.0,515.0
0.008,6,10,1972,5,910,2.0,642.0,642.0,5,1062,2.0,794.0,794.0
0.016,6,10,1972,5,910,3.0,642.0,642.0,5,1062,4.0,794.0,794.0
0.01,6,10,1989,5,910,2.0,642.0,642.0,5,1079,2.0,811.0,811.0
300.812,6,38,9666,21,4188,15040.0,1360.0,552.0,17,5478,540.0,2667.0,435.0
0.011,6,14,3787,7,497,1.0,125.0,125.0,7,3290,1.0,1448.0,972.0
0.001,17,2,180,1,66,0.0,38.0,38.0,1,114,0.0,86.0,86.0
0.018,6,10,1989,5,910,4.0,642.0,642.0,5,1079,4.0,811.0,811.0
0.009,6,10,1972,5,910,2.0,642.0,642.0,5,1062,2.0,794.0,794.0
0.005,6,10,1989,5,927,1.0,659.0,659.0,5,1062,1.0,794.0,794.0
0.006,6,10,1547,5,764,1.0,496.0,496.0,5,783,1.0,515.0,515.0
0.016,6,10,1989,5,910,3.0,642.0,642.0,5,1079,3.0,811.0,811.0
0.071,17,4,420,2,122,0.0,33.0,33.0,2,298,32.0,145.0,121.0
0.005,6,10,1989,5,927,1.0,659.0,659.0,5,1062,1.0,794.0,794.0
289.441,6,290,343108,119,17738,2452.0,2736.0,888.0,171,325370,1702.0,2804.0,2015.0
0.009,6,10,1990,5,911,2.0,643.0,643.0,5,1079,2.0,811.0,811.0
0.006,17,2,170,1,65,0.0,37.0,37.0,1,105,0.0,77.0,77.0
0.005,6,10,2007,5,928,1.0,660.0,660.0,5,1079,1.0,811.0,811.0
361.802,6,19,1688,15,978,25843.0,190.0,190.0,4,710,80014.0,494.0,494.0
15.072,17,15,9238,8,6902,2149.0,1350.0,834.0,7,2336,2507.0,1350.0,305.0
0.075,6,10,1506,5,395,17.0,127.0,127.0,5,1111,15.0,843.0,843.0
0.008,6,10,1547,5,764,1.0,496.0,496.0,5,783,2.0,515.0,515.0
0.009,6,10,1677,5,827,2.0,559.0,559.0,5,850,2.0,582.0,582.0
0.005,6,10,1989,5,927,1.0,659.0,659.0,5,1062,1.0,794.0,794.0
0.141,6,10,1506,5,395,33.0,127.0,127.0,5,1111,32.0,843.0,843.0
0.069,17,8,3613,4,1874,23.0,1350.0,440.0,4,1739,12.0,1350.0,406.0
0.092,6,10,1506,5,395,21.0,127.0,127.0,5,1111,19.0,843.0,843.0
0.123,6,10,1506,5,395,29.0,127.0,127.0,5,1111,29.0,843.0,843.0
0.077,6,10,1506,5,395,18.0,127.0,127.0,5,1111,17.0,843.0,843.0
0.014,6,10,1762,5,911,3.0,643.0,643.0,5,851,3.0,583.0,583.0
0.157,6,10,1506,5,395,31.0,127.0,127.0,5,1111,36.0,843.0,843.0
0.015,6,10,1631,5,848,3.0,580.0,580.0,5,783,3.0,515.0,515.0
0.09,6,10,1506,5,395,18.0,127.0,127.0,5,1111,19.0,843.0,843.0
0.006,6,10,1643,5,860,1.0,592.0,592.0,5,783,1.0,515.0,515.0
0.015,6,10,1989,5,910,3.0,642.0,642.0,5,1079,3.0,811.0,811.0
0.003,17,2,136,1,60,0.0,32.0,32.0,1,76,0.0,48.0,48.0
0.013,6,12,1926,6,1189,2.0,659.0,434.0,6,737,2.0,417.0,417.0
0.081,6,10,1506,5,395,17.0,127.0,127.0,5,1111,16.0,843.0,843.0
1771.824,17,120,11460,60,5460,30030.0,63.0,63.0,60,6000,30030.0,72.0,72.0
1752.245,6,462,66052,250,35064,7037.0,613.0,197.0,212,30988,8304.0,453.0,142.0
40.18,6,43,11503,25,3351,1674.0,1224.0,226.0,18,8152,2363.0,2694.0,656.0
0.013,6,10,1989,5,910,3.0,642.0,642.0,5,1079,3.0,811.0,811.0
0.016,6,10,1983,5,910,4.0,642.0,642.0,5,1073,4.0,805.0,805.0
0.004,17,2,136,1,60,0.0,32.0,32.0,1,76,0.0,48.0,48.0
0.003,17,2,152,1,76,0.0,48.0,48.0,1,76,0.0,48.0,48.0
0.037,6,10,1989,5,910,9.0,642.0,642.0,5,1079,9.0,811.0,811.0
0.005,6,10,2007,5,928,1.0,660.0,660.0,5,1079,1.0,811.0,811.0
0.09,6,10,1506,5,395,21.0,127.0,127.0,5,1111,21.0,843.0,843.0
0.003,17,4,284,2,120,0.0,32.0,32.0,2,164,0.0,60.0,54.0
0.005,6,10,1702,5,863,1.0,595.0,595.0,5,839,1.0,571.0,571.0
0.116,6,10,1506,5,395,23.0,127.0,127.0,5,1111,24.0,843.0,843.0
0.043,17,2,184,1,61,0.0,33.0,33.0,1,123,0.0,95.0,95.0
0.004,6,10,2007,5,928,1.0,660.0,660.0,5,1079,1.0,811.0,811.0
40.056,17,10,676,5,460,10012.0,104.0,64.0,5,216,10013.0,20.0,15.0
0.003,17,2,148,1,60,0.0,32.0,32.0,1,88,0.0,60.0,60.0
0.079,6,10,1506,5,395,15.0,127.0,127.0,5,1111,16.0,843.0,843.0
0.005,6,10,1643,5,860,1.0,592.0,592.0,5,783,1.0,515.0,515.0
0.069,6,10,1506,5,395,15.0,127.0,127.0,5,1111,14.0,843.0,843.0
0.084,6,10,1506,5,395,19.0,127.0,127.0,5,1111,15.0,843.0,843.0
0.074,6,10,1506,5,395,14.0,127.0,127.0,5,1111,16.0,843.0,843.0
0.087,6,10,1506,5,395,20.0,127.0,127.0,5,1111,20.0,843.0,843.0
0.015,6,10,1989,5,910,3.0,642.0,642.0,5,1079,3.0,811.0,811.0
0.007,17,2,194,1,59,0.0,31.0,31.0,1,135,0.0,107.0,107.0
40.086,17,10,676,5,460,10019.0,104.0,64.0,5,216,10020.0,20.0,15.0
0.138,6,11,1558,6,447,26.0,127.0,127.0,5,1111,33.0,843.0,843.0
0.072,17,4,284,2,120,0.0,32.0,32.0,2,164,68.0,60.0,54.0
0.01,6,10,1989,5,910,2.0,642.0,642.0,5,1079,2.0,811.0,811.0
0.097,6,10,1506,5,395,23.0,127.0,127.0,5,1111,18.0,843.0,843.0
0.095,6,10,1506,5,395,21.0,127.0,127.0,5,1111,18.0,843.0,843.0
0.13,17,2,186,1,61,0.0,33.0,33.0,1,125,0.0,97.0,97.0
308.401,17,20,1124,10,716,34260.0,48.0,43.0,10,408,34260.0,20.0,12.0
0.005,6,10,2007,5,928,1.0,660.0,660.0,5,1079,1.0,811.0,811.0
40.056,17,10,676,5,460,10013.0,104.0,64.0,5,216,10013.0,20.0,15.0
0.012,6,10,1990,5,911,3.0,643.0,643.0,5,1079,2.0,811.0,811.0
0.005,6,10,1774,5,923,1.0,655.0,655.0,5,851,1.0,583.0,583.0
0.013,6,10,1989,5,910,3.0,642.0,642.0,5,1079,3.0,811.0,811.0
0.012,6,10,1677,5,827,2.0,559.0,559.0,5,850,3.0,582.0,582.0
0.01,6,10,1990,5,911,2.0,643.0,643.0,5,1079,2.0,811.0,811.0
0.062,17,2,152,1,76,0.0,48.0,48.0,1,76,0.0,48.0,48.0
0.009,6,10,1990,5,911,2.0,643.0,643.0,5,1079,2.0,811.0,811.0
0.09,6,10,1506,5,395,20.0,127.0,127.0,5,1111,19.0,843.0,843.0
0.007,17,2,179,1,71,0.0,43.0,43.0,1,108,0.0,80.0,80.0
0.013,6,10,1983,5,910,3.0,642.0,642.0,5,1073,3.0,805.0,805.0
308.275,17,20,1124,10,716,34237.0,48.0,43.0,10,408,34237.0,20.0,12.0
0.097,6,10,1506,5,395,22.0,127.0,127.0,5,1111,21.0,843.0,843.0
0.016,6,10,1972,5,910,4.0,642.0,642.0,5,1062,4.0,794.0,794.0
0.012,6,10,1762,5,911,3.0,643.0,643.0,5,851,2.0,583.0,583.0
0.004,6,10,2007,5,928,1.0,660.0,660.0,5,1079,1.0,811.0,811.0
0.008,6,10,1972,5,910,2.0,642.0,642.0,5,1062,2.0,794.0,794.0
0.095,6,10,1506,5,395,22.0,127.0,127.0,5,1111,22.0,843.0,843.0
334.43,58,4,288,3,216,167215.0,24.0,24.0,1,72,0.0,24.0,24.0
0.004,6,10,1779,5,928,1.0,660.0,660.0,5,851,1.0,583.0,583.0
0.083,6,10,1506,5,395,20.0,127.0,127.0,5,1111,13.0,843.0,843.0
0.004,6,10,2000,5,927,1.0,659.0,659.0,5,1073,1.0,805.0,805.0
0.09,6,10,1506,5,395,20.0,127.0,127.0,5,1111,20.0,843.0,843.0
0.008,6,10,1972,5,910,2.0,642.0,642.0,5,1062,1.0,794.0,794.0
240.012,6,9,787,5,488,60003.0,232.0,232.0,4,299,80003.0,83.0,83.0
0.011,6,10,1972,5,910,2.0,642.0,642.0,5,1062,2.0,794.0,794.0
0.005,6,10,2006,5,927,1.0,659.0,659.0,5,1079,1.0,811.0,811.0
0.006,6,10,2007,5,928,1.0,660.0,660.0,5,1079,1.0,811.0,811.0
240.324,6,33,8636,17,1837,15020.0,570.0,189.0,16,6799,16021.0,1402.0,597.0
0.004,6,10,1702,5,863,1.0,595.0,595.0,5,839,1.0,571.0,571.0
0.001,17,2,180,1,66,0.0,38.0,38.0,1,114,0.0,86.0,86.0
0.024,6,10,1989,5,910,6.0,642.0,642.0,5,1079,6.0,811.0,811.0
0.056,17,2,179,1,71,0.0,43.0,43.0,1,108,0.0,80.0,80.0
0.079,6,10,1506,5,395,18.0,127.0,127.0,5,1111,15.0,843.0,843.0
0.006,6,12,1698,6,863,1.0,327.0,271.0,6,835,1.0,515.0,515.0
0.023,6,10,1990,5,911,5.0,643.0,643.0,5,1079,5.0,811.0,811.0
0.005,6,10,1643,5,860,1.0,592.0,592.0,5,783,1.0,515.0,515.0
0.091,6,10,1506,5,395,22.0,127.0,127.0,5,1111,19.0,843.0,843.0
0.004,6,10,2006,5,927,1.0,659.0,659.0,5,1079,1.0,811.0,811.0
0.004,17,2,144,1,64,0.0,36.0,36.0,1,80,0.0,52.0,52.0
0.005,6,10,1689,5,839,1.0,571.0,571.0,5,850,1.0,582.0,582.0
0.112,6,10,1506,5,395,22.0,127.0,127.0,5,1111,25.0,843.0,843.0
0.091,6,10,1506,5,395,19.0,127.0,127.0,5,1111,21.0,843.0,843.0
0.016,17,2,144,1,64,0.0,36.0,36.0,1,80,0.0,52.0,52.0
0.01,6,10,1989,5,910,2.0,642.0,642.0,5,1079,2.0,811.0,811.0
0.093,6,10,1506,5,395,21.0,127.0,127.0,5,1111,20.0,843.0,843.0
1756.23,6,64,7360,42,4484,42834.0,1640.0,109.0,22,2876,83621.0,1112.0,82.0
0.011,6,10,2006,5,927,2.0,659.0,659.0,5,1079,2.0,811.0,811.0
0.005,6,10,2006,5,927,1.0,659.0,659.0,5,1079,1.0,811.0,811.0
13.598,6,25,5159,14,1186,1046.0,180.0,75.0,11,3973,1359.0,1592.0,678.0
0.265,17,38,20046,21,17038,13.0,1350.0,783.0,17,3008,12.0,1350.0,148.0
11.242,17,28,4423,14,1995,852.0,270.0,114.0,14,2428,852.0,587.0,145.0
0.001,17,2,180,1,66,0.0,38.0,38.0,1,114,0.0,86.0,86.0
0.004,6,10,2007,5,928,1.0,660.0,660.0,5,1079,1.0,811.0,811.0
0.005,17,4,284,2,120,2.0,32.0,32.0,2,164,2.0,60.0,54.0
0.004,6,10,2007,5,928,1.0,660.0,660.0,5,1079,1.0,811.0,811.0
0.274,6,21,7085,10,1557,30.0,746.0,257.0,11,5528,27.0,2335.0,989.0
0.004,6,10,1774,5,923,1.0,655.0,655.0,5,851,1.0,583.0,583.0
0.005,6,10,1643,5,860,1.0,592.0,592.0,5,783,1.0,515.0,515.0
0.084,6,10,1506,5,395,20.0,127.0,127.0,5,1111,19.0,843.0,843.0
0.005,6,10,1989,5,927,1.0,659.0,659.0,5,1062,1.0,794.0,794.0
0.018,6,10,1989,5,910,4.0,642.0,642.0,5,1079,4.0,811.0,811.0
0.088,6,10,1506,5,395,19.0,127.0,127.0,5,1111,21.0,843.0,843.0
0.017,6,10,1972,5,910,4.0,642.0,642.0,5,1062,4.0,794.0,794.0
0.106,6,10,1506,5,395,24.0,127.0,127.0,5,1111,25.0,843.0,843.0
40.071,17,10,676,5,460,10015.0,104.0,64.0,5,216,10016.0,20.0,15.0
0.005,6,14,3799,7,509,0.0,137.0,137.0,7,3290,0.0,1448.0,972.0
0.006,6,10,2007,5,928,1.0,660.0,660.0,5,1079,1.0,811.0,811.0
170.101,17,78,11037,39,2601,4476.0,44.0,38.0,39,8436,4476.0,239.0,188.0
0.013,6,10,1972,5,910,3.0,642.0,642.0,5,1062,3.0,794.0,794.0
0.093,6,10,1506,5,395,19.0,127.0,127.0,5,1111,17.0,843.0,843.0
0.016,6,10,1989,5,910,3.0,642.0,642.0,5,1079,3.0,811.0,811.0
308.488,17,20,1124,10,716,34269.0,48.0,43.0,10,408,34269.0,20.0,12.0
0.006,17,2,179,1,71,0.0,43.0,43.0,1,108,0.0,80.0,80.0
0.011,6,10,1990,5,911,2.0,643.0,643.0,5,1079,2.0,811.0,811.0
0.001,17,2,136,1,60,0.0,32.0,32.0,1,76,0.0,48.0,48.0
0.006,6,10,1547,5,764,1.0,496.0,496.0,5,783,1.0,515.0,515.0
0.12,6,10,1506,5,395,26.0,127.0,127.0,5,1111,28.0,843.0,843.0
100.397,17,10,3160,5,1580,25098.0,288.0,288.0,5,1580,25097.0,288.0,288.0
40.052,17,10,676,5,460,10012.0,104.0,64.0,5,216,10012.0,20.0,15.0
0.005,6,10,2006,5,927,1.0,659.0,659.0,5,1079,1.0,811.0,811.0
0.013,6,10,1990,5,911,3.0,643.0,643.0,5,1079,3.0,811.0,811.0
0.006,6,10,2000,5,927,1.0,659.0,659.0,5,1073,1.0,805.0,805.0
0.001,17,2,180,1,66,0.0,38.0,38.0,1,114,0.0,86.0,86.0
0.014,6,10,1990,5,911,3.0,643.0,643.0,5,1079,3.0,811.0,811.0
173.212,17,78,11085,39,2593,4558.0,44.0,38.0,39,8492,4558.0,239.0,189.0
0.085,6,10,1506,5,395,19.0,127.0,127.0,5,1111,20.0,843.0,843.0
0.004,6,10,2000,5,927,1.0,659.0,659.0,5,1073,1.0,805.0,805.0
0.007,6,10,1643,5,860,1.0,592.0,592.0,5,783,1.0,515.0,515.0
0.035,17,2,152,1,76,0.0,48.0,48.0,1,76,0.0,48.0,48.0
0.071,6,10,1506,5,395,15.0,127.0,127.0,5,1111,16.0,843.0,843.0
0.005,17,2,136,1,60,0.0,32.0,32.0,1,76,0.0,48.0,48.0
0.005,6,13,3747,7,509,0.0,137.0,137.0,6,3238,0.0,1470.0,1459.0
0.011,6,10,1989,5,910,2.0,642.0,642.0,5,1079,2.0,811.0,811.0
0.01,6,10,1677,5,827,2.0,559.0,559.0,5,850,2.0,582.0,582.0
0.01,6,10,1989,5,910,2.0,642.0,642.0,5,1079,2.0,811.0,811.0
0.093,6,10,1506,5,395,19.0,127.0,127.0,5,1111,19.0,843.0,843.0
40.06,17,10,676,5,460,10012.0,104.0,64.0,5,216,10014.0,20.0,15.0
0.004,17,2,136,1,60,0.0,32.0,32.0,1,76,0.0,48.0,48.0
240.106,6,16,4482,9,963,30013.0,238.0,166.0,7,3519,40017.0,1402.0,786.0
0.043,17,4,420,2,122,0.0,33.0,33.0,2,298,2.0,145.0,121.0
0.006,17,2,179,1,71,0.0,43.0,43.0,1,108,0.0,80.0,80.0
0.09,6,10,1506,5,395,22.0,127.0,127.0,5,1111,17.0,843.0,843.0
0.004,6,10,2006,5,927,1.0,659.0,659.0,5,1079,1.0,811.0,811.0
280.226,6,24,6115,11,1226,28022.0,267.0,156.0,13,4889,23351.0,1400.0,873.0
0.005,6,10,2006,5,927,1.0,659.0,659.0,5,1079,1.0,811.0,811.0
0.005,6,10,1854,5,889,1.0,621.0,621.0,5,965,1.0,697.0,697.0
0.004,6,10,1779,5,928,1.0,660.0,660.0,5,851,1.0,583.0,583.0
0.067,17,8,3613,4,1874,22.0,1350.0,440.0,4,1739,10.0,1350.0,406.0
0.005,6,10,1774,5,923,1.0,655.0,655.0,5,851,1.0,583.0,583.0
40.061,17,10,676,5,460,10013.0,104.0,64.0,5,216,10014.0,20.0,15.0
0.004,6,10,1702,5,863,0.0,595.0,595.0,5,839,1.0,571.0,571.0
0.004,6,10,2000,5,927,1.0,659.0,659.0,5,1073,1.0,805.0,805.0
0.022,6,10,1989,5,910,5.0,642.0,642.0,5,1079,5.0,811.0,811.0
0.039,17,2,136,1,60,0.0,32.0,32.0,1,76,0.0,48.0,48.0
40.068,17,10,676,5,460,10016.0,104.0,64.0,5,216,10016.0,20.0,15.0
361.779,6,21,1793,16,1030,24118.0,190.0,190.0,5,763,60009.0,462.0,247.0
0.104,6,10,1506,5,395,22.0,127.0,127.0,5,1111,20.0,843.0,843.0
0.116,6,10,1506,5,395,25.0,127.0,127.0,5,1111,26.0,843.0,843.0
0.081,6,10,1506,5,395,18.0,127.0,127.0,5,1111,17.0,843.0,843.0
0.005,6,10,2000,5,927,1.0,659.0,659.0,5,1073,1.0,805.0,805.0
0.231,6,10,1972,5,910,57.0,642.0,642.0,5,1062,57.0,794.0,794.0
0.005,6,10,1779,5,928,1.0,660.0,660.0,5,851,1.0,583.0,583.0
11.104,17,28,4391,14,2313,845.0,588.0,137.0,14,2078,845.0,269.0,120.0
188.457,58,4,288,2,144,183299.0,24.0,24.0,2,144,175673.0,24.0,24.0
240.086,6,16,4482,9,963,30010.0,238.0,166.0,7,3519,40013.0,1402.0,786.0
240.023,6,9,787,5,488,60005.0,232.0,232.0,4,299,80004.0,83.0,83.0
0.061,17,2,152,1,76,0.0,48.0,48.0,1,76,0.0,48.0,48.0
0.005,6,10,2007,5,928,1.0,660.0,660.0,5,1079,1.0,811.0,811.0
0.013,6,10,1677,5,827,3.0,559.0,559.0,5,850,3.0,582.0,582.0
0.013,17,2,152,1,56,0.0,28.0,28.0,1,96,0.0,68.0,68.0
0.04,17,2,182,1,65,0.0,37.0,37.0,1,117,0.0,89.0,89.0
351.996,6,20,2210,6,1308,12003.0,494.0,494.0,14,902,27076.0,83.0,83.0
15.08,17,15,9238,8,6902,2149.0,1350.0,834.0,7,2336,2507.0,1350.0,305.0
0.006,17,2,170,1,65,0.0,37.0,37.0,1,105,0.0,77.0,77.0
0.005,6,14,3742,7,452,0.0,80.0,80.0,7,3290,0.0,1448.0,972.0
0.04,17,2,186,1,61,0.0,33.0,33.0,1,125,0.0,97.0,97.0
0.08,6,10,1506,5,395,19.0,127.0,127.0,5,1111,18.0,843.0,843.0
0.006,6,10,2000,5,927,1.0,659.0,659.0,5,1073,1.0,805.0,805.0
40.058,17,10,676,5,460,10012.0,104.0,64.0,5,216,10013.0,20.0,15.0
0.009,6,10,1989,5,910,2.0,642.0,642.0,5,1079,2.0,811.0,811.0
0.006,6,10,1547,5,764,1.0,496.0,496.0,5,783,1.0,515.0,515.0
0.019,6,10,1989,5,910,4.0,642.0,642.0,5,1079,4.0,811.0,811.0
0.011,6,10,1677,5,827,2.0,559.0,559.0,5,850,2.0,582.0,582.0
0.018,6,10,1990,5,911,4.0,643.0,643.0,5,1079,4.0,811.0,811.0
0.077,6,10,1506,5,395,18.0,127.0,127.0,5,1111,15.0,843.0,843.0
0.012,6,10,1990,5,911,3.0,643.0,643.0,5,1079,2.0,811.0,811.0
352.244,6,20,2210,6,1308,12004.0,494.0,494.0,14,902,27095.0,83.0,83.0
0.005,6,10,1779,5,928,1.0,660.0,660.0,5,851,1.0,583.0,583.0
0.014,6,13,3735,7,497,2.0,125.0,125.0,6,3238,2.0,1470.0,1459.0
0.004,17,2,148,1,60,0.0,32.0,32.0,1,88,0.0,60.0,60.0
240.092,6,29,9255,15,6915,17149.0,2039.0,682.0,14,2340,18468.0,580.0,229.0
0.008,6,10,2007,5,928,2.0,660.0,660.0,5,1079,2.0,811.0,811.0
0.004,6,10,1989,5,927,1.0,659.0,659.0,5,1062,1.0,794.0,794.0
0.107,6,10,1506,5,395,25.0,127.0,127.0,5,1111,25.0,843.0,843.0
1770.306,6,84,4420,42,2210,43177.0,26.0,26.0,42,2210,43177.0,26.0,26.0
0.098,6,10,1506,5,395,23.0,127.0,127.0,5,1111,20.0,843.0,843.0
0.009,6,12,1926,6,1189,1.0,659.0,434.0,6,737,1.0,417.0,417.0
0.132,6,10,1506,5,395,32.0,127.0,127.0,5,1111,30.0,843.0,843.0
0.006,6,10,1547,5,764,1.0,496.0,496.0,5,783,1.0,515.0,515.0
11.191,17,28,4423,14,1994,848.0,269.0,114.0,14,2429,848.0,588.0,145.0
92.026,6,26,9525,12,1627,76.0,794.0,367.0,14,7898,7068.0,1360.0,732.0
0.021,6,10,1990,5,911,5.0,643.0,643.0,5,1079,5.0,811.0,811.0
0.005,17,2,212,1,74,0.0,46.0,46.0,1,138,0.0,110.0,110.0
376.257,6,22,2313,16,867,25083.0,195.0,195.0,6,1446,4648.0,419.0,398.0
165.095,17,100,14623,50,3369,3369.0,44.0,39.0,50,11254,3369.0,261.0,197.0
0.004,17,2,132,1,58,0.0,30.0,30.0,1,74,0.0,46.0,46.0
0.011,6,10,1972,5,910,2.0,642.0,642.0,5,1062,2.0,794.0,794.0
0.006,6,10,1762,5,911,1.0,643.0,643.0,5,851,1.0,583.0,583.0
0.011,6,10,1677,5,827,2.0,559.0,559.0,5,850,2.0,582.0,582.0
0.005,6,14,3736,7,446,0.0,74.0,74.0,7,3290,0.0,1448.0,972.0
0.062,6,10,1506,5,395,13.0,127.0,127.0,5,1111,13.0,843.0,843.0
0.04,17,2,136,1,60,0.0,32.0,32.0,1,76,0.0,48.0,48.0
301.211,6,53,22381,29,16394,10757.0,2720.0,1169.0,24,5987,391.0,2667.0,385.0
367.257,6,24,2405,17,919,22953.0,195.0,195.0,7,1486,3911.0,419.0,398.0
0.006,17,2,166,1,75,0.0,47.0,47.0,1,91,0.0,63.0,63.0
11.125,17,28,4423,14,1994,846.0,269.0,114.0,14,2429,845.0,588.0,145.0
0.099,6,10,1506,5,395,23.0,127.0,127.0,5,1111,22.0,843.0,843.0
40.069,17,10,676,5,460,10016.0,104.0,64.0,5,216,10016.0,20.0,15.0
0.008,6,10,1762,5,911,1.0,643.0,643.0,5,851,1.0,583.0,583.0
40.065,17,10,676,5,460,10015.0,104.0,64.0,5,216,10015.0,20.0,15.0
0.005,6,10,1689,5,839,1.0,571.0,571.0,5,850,1.0,582.0,582.0
0.014,6,10,1989,5,910,3.0,642.0,642.0,5,1079,3.0,811.0,811.0
0.001,17,2,166,1,75,0.0,47.0,47.0,1,91,0.0,63.0,63.0
0.011,6,10,1990,5,911,2.0,643.0,643.0,5,1079,2.0,811.0,811.0
0.005,6,10,2006,5,927,1.0,659.0,659.0,5,1079,1.0,811.0,811.0
0.04,17,2,182,1,65,0.0,37.0,37.0,1,117,0.0,89.0,89.0
0.117,6,10,1506,5,395,26.0,127.0,127.0,5,1111,18.0,843.0,843.0
0.007,17,2,193,1,71,0.0,43.0,43.0,1,122,0.0,94.0,94.0
0.013,6,14,3787,7,497,2.0,125.0,125.0,7,3290,2.0,1448.0,972.0
0.006,17,4,284,2,120,0.0,32.0,32.0,2,164,0.0,60.0,54.0
369.656,6,22,2313,16,867,24643.0,195.0,195.0,6,1446,4655.0,419.0,398.0
310.651,17,20,1124,10,716,34508.0,48.0,43.0,10,408,34505.0,20.0,12.0
0.015,6,10,1972,5,910,3.0,642.0,642.0,5,1062,3.0,794.0,794.0
0.006,6,10,1547,5,764,1.0,496.0,496.0,5,783,1.0,515.0,515.0
0.004,6,10,1702,5,863,1.0,595.0,595.0,5,839,1.0,571.0,571.0
0.009,17,2,179,1,71,0.0,43.0,43.0,1,108,0.0,80.0,80.0
0.126,17,2,179,1,71,0.0,43.0,43.0,1,108,0.0,80.0,80.0
0.005,6,14,3736,7,446,0.0,74.0,74.0,7,3290,0.0,1448.0,972.0
40.054,17,10,676,5,460,10012.0,104.0,64.0,5,216,10012.0,20.0,15.0
373.576,6,22,2313,16,867,24905.0,195.0,195.0,6,1446,4635.0,419.0,398.0
0.003,17,2,148,1,60,0.0,32.0,32.0,1,88,0.0,60.0,60.0
0.091,6,10,1506,5,395,20.0,127.0,127.0,5,1111,19.0,843.0,843.0
10.854,17,28,4422,14,1993,826.0,268.0,114.0,14,2429,826.0,588.0,145.0
0.35,17,45,20872,22,17093,16.0,1350.0,748.0,23,3779,14.0,1350.0,136.0
0.011,6,10,1990,5,911,2.0,643.0,643.0,5,1079,2.0,811.0,811.0
40.057,17,10,676,5,460,10013.0,104.0,64.0,5,216,10013.0,20.0,15.0
0.001,17,2,180,1,66,0.0,38.0,38.0,1,114,0.0,86.0,86.0
0.006,17,2,180,1,66,0.0,38.0,38.0,1,114,0.0,86.0,86.0
0.005,6,10,2000,5,927,1.0,659.0,659.0,5,1073,1.0,805.0,805.0
0.006,6,10,1547,5,764,1.0,496.0,496.0,5,783,1.0,515.0,515.0
0.005,6,10,1989,5,927,1.0,659.0,659.0,5,1062,1.0,794.0,794.0
15.075,17,15,9238,8,6902,2149.0,1350.0,834.0,7,2336,2507.0,1350.0,305.0
0.109,6,10,1506,5,395,26.0,127.0,127.0,5,1111,25.0,843.0,843.0
354.064,6,21,1795,16,1030,23604.0,190.0,190.0,5,765,60001.0,464.0,248.0
0.018,6,10,1989,5,910,4.0,642.0,642.0,5,1079,4.0,811.0,811.0
0.003,17,2,170,1,65,0.0,37.0,37.0,1,105,0.0,77.0,77.0
0.039,17,4,284,2,120,0.0,32.0,32.0,2,164,36.0,60.0,54.0
0.103,6,10,1506,5,395,23.0,127.0,127.0,5,1111,22.0,843.0,843.0
0.004,6,10,1702,5,863,0.0,595.0,595.0,5,839,1.0,571.0,571.0
0.005,6,10,2006,5,927,1.0,659.0,659.0,5,1079,1.0,811.0,811.0
0.005,6,10,1689,5,839,1.0,571.0,571.0,5,850,1.0,582.0,582.0
300.872,6,43,12975,24,7372,13081.0,2720.0,909.0,19,5603,482.0,2667.0,402.0
0.006,6,10,1547,5,764,1.0,496.0,496.0,5,783,1.0,515.0,515.0
0.123,6,10,1506,5,395,29.0,127.0,127.0,5,1111,25.0,843.0,843.0
240.011,6,9,787,5,488,60002.0,232.0,232.0,4,299,80002.0,83.0,83.0
0.008,6,12,1926,6,1189,1.0,659.0,434.0,6,737,1.0,417.0,417.0
0.006,6,10,1854,5,889,1.0,621.0,621.0,5,965,1.0,697.0,697.0
173.095,17,78,11275,39,2610,4555.0,44.0,38.0,39,8665,4555.0,239.0,194.0
0.012,6,10,1989,5,910,2.0,642.0,642.0,5,1079,2.0,811.0,811.0
240.104,6,16,4481,9,963,30013.0,238.0,166.0,7,3518,40016.0,1402.0,786.0
0.11,6,10,1506,5,395,25.0,127.0,127.0,5,1111,22.0,843.0,843.0
1800.0,6,281,40325,113,27614,16071.0,2801.0,251.0,168,12711,10777.0,1062.0,77.0
0.006,6,10,2006,5,927,1.0,659.0,659.0,5,1079,1.0,811.0,811.0
0.071,17,2,170,1,65,0.0,37.0,37.0,1,105,0.0,77.0,77.0
120.806,6,56,19009,32,4770,3896.0,1054.0,221.0,24,14239,5252.0,2804.0,927.0
0.005,6,10,1989,5,927,1.0,659.0,659.0,5,1062,1.0,794.0,794.0
0.086,6,10,1506,5,395,19.0,127.0,127.0,5,1111,18.0,843.0,843.0
0.114,6,10,1506,5,395,27.0,127.0,127.0,5,1111,25.0,843.0,843.0
15.116,17,18,9417,9,6979,1886.0,1350.0,747.0,9,2438,1883.0,1350.0,242.0
0.127,6,10,1506,5,395,28.0,127.0,127.0,5,1111,28.0,843.0,843.0
0.004,6,10,1702,5,863,1.0,595.0,595.0,5,839,0.0,571.0,571.0
0.004,6,10,2007,5,928,1.0,660.0,660.0,5,1079,1.0,811.0,811.0
0.005,6,10,2000,5,927,1.0,659.0,659.0,5,1073,1.0,805.0,805.0
0.006,6,10,1547,5,764,1.0,496.0,496.0,5,783,1.0,515.0,515.0
40.025,17,10,676,5,460,10005.0,104.0,64.0,5,216,10005.0,20.0,15.0
0.005,6,10,2006,5,927,1.0,659.0,659.0,5,1079,1.0,811.0,811.0
300.369,6,16,2170,9,684,37524.0,146.0,146.0,7,1486,50032.0,419.0,398.0
368.582,6,22,2313,16,867,24572.0,195.0,195.0,6,1446,4645.0,419.0,398.0
308.47,17,20,1124,10,716,34259.0,48.0,43.0,10,408,34259.0,20.0,12.0
0.126,17,2,80,1,32,0.0,4.0,4.0,1,48,0.0,20.0,20.0
0.004,6,10,2000,5,927,1.0,659.0,659.0,5,1073,1.0,805.0,805.0
309.25,17,20,1124,10,716,34354.0,48.0,43.0,10,408,34354.0,20.0,12.0
0.124,6,10,1506,5,395,29.0,127.0,127.0,5,1111,28.0,843.0,843.0
0.078,6,10,1506,5,395,16.0,127.0,127.0,5,1111,18.0,843.0,843.0
40.062,17,10,676,5,460,10013.0,104.0,64.0,5,216,10014.0,20.0,15.0
240.091,6,16,4480,9,963,30011.0,238.0,166.0,7,3517,40014.0,1402.0,786.0
0.005,6,10,1689,5,839,1.0,571.0,571.0,5,850,1.0,582.0,582.0
0.011,6,10,1990,5,911,2.0,643.0,643.0,5,1079,2.0,811.0,811.0
0.006,6,10,1547,5,764,1.0,496.0,496.0,5,783,1.0,515.0,515.0
0.013,6,10,1972,5,910,3.0,642.0,642.0,5,1062,3.0,794.0,794.0
40.055,17,10,676,5,460,10012.0,104.0,64.0,5,216,10013.0,20.0,15.0
0.012,6,10,1631,5,848,2.0,580.0,580.0,5,783,2.0,515.0,515.0
0.041,17,2,148,1,60,0.0,32.0,32.0,1,88,0.0,60.0,60.0
0.007,6,10,2007,5,928,1.0,660.0,660.0,5,1079,1.0,811.0,811.0
0.04,17,2,364,1,61,0.0,33.0,33.0,1,303,0.0,275.0,275.0
0.086,6,10,1506,5,395,19.0,127.0,127.0,5,1111,19.0,843.0,843.0
0.004,6,10,2006,5,927,1.0,659.0,659.0,5,1079,1.0,811.0,811.0
15.071,17,15,9239,8,6902,2149.0,1350.0,834.0,7,2337,2507.0,1350.0,305.0
0.008,6,10,2007,5,928,2.0,660.0,660.0,5,1079,2.0,811.0,811.0
0.008,6,10,2006,5,927,1.0,659.0,659.0,5,1079,2.0,811.0,811.0
0.121,6,10,1506,5,395,27.0,127.0,127.0,5,1111,14.0,843.0,843.0
0.011,6,10,1762,5,911,2.0,643.0,643.0,5,851,2.0,583.0,583.0
376.388,6,16,2002,6,1308,12003.0,494.0,494.0,10,694,41820.0,83.0,83.0
0.014,6,10,1983,5,910,3.0,642.0,642.0,5,1073,3.0,805.0,805.0
0.011,6,10,1631,5,848,2.0,580.0,580.0,5,783,2.0,515.0,515.0
0.081,6,10,1506,5,395,18.0,127.0,127.0,5,1111,17.0,843.0,843.0
0.005,6,10,1854,5,889,1.0,621.0,621.0,5,965,1.0,697.0,697.0
0.014,6,10,1631,5,848,3.0,580.0,580.0,5,783,3.0,515.0,515.0
0.003,6,10,1702,5,863,0.0,595.0,595.0,5,839,0.0,571.0,571.0
0.012,6,13,3735,7,497,1.0,125.0,125.0,6,3238,2.0,1470.0,1459.0
0.059,6,10,1506,5,395,13.0,127.0,127.0,5,1111,14.0,843.0,843.0
0.016,6,10,1989,5,910,4.0,642.0,642.0,5,1079,3.0,811.0,811.0
0.037,17,2,184,1,61,0.0,33.0,33.0,1,123,0.0,95.0,95.0
0.003,17,4,284,2,120,0.0,32.0,32.0,2,164,0.0,60.0,54.0
0.018,6,10,1989,5,910,4.0,642.0,642.0,5,1079,4.0,811.0,811.0
308.919,17,20,1124,10,716,34310.0,48.0,43.0,10,408,34310.0,20.0,12.0
0.014,6,10,1677,5,827,3.0,559.0,559.0,5,850,3.0,582.0,582.0
308.269,17,20,1124,10,716,34235.0,48.0,43.0,10,408,34237.0,20.0,12.0
0.006,6,10,1547,5,764,1.0,496.0,496.0,5,783,1.0,515.0,515.0
0.006,6,10,1689,5,839,1.0,571.0,571.0,5,850,1.0,582.0,582.0
0.08,6,10,1506,5,395,17.0,127.0,127.0,5,1111,19.0,843.0,843.0
0.087,6,10,1506,5,395,18.0,127.0,127.0,5,1111,18.0,843.0,843.0
0.006,6,10,1547,5,764,1.0,496.0,496.0,5,783,1.0,515.0,515.0
0.007,6,10,1989,5,910,1.0,642.0,642.0,5,1079,1.0,811.0,811.0
0.006,6,10,1547,5,764,1.0,496.0,496.0,5,783,1.0,515.0,515.0
0.014,6,10,1762,5,911,3.0,643.0,643.0,5,851,3.0,583.0,583.0
0.005,17,2,180,1,66,0.0,38.0,38.0,1,114,0.0,86.0,86.0
0.004,6,10,1989,5,927,1.0,659.0,659.0,5,1062,1.0,794.0,794.0
0.008,6,10,1989,5,910,2.0,642.0,642.0,5,1079,2.0,811.0,811.0
0.013,6,10,1989,5,910,3.0,642.0,642.0,5,1079,3.0,811.0,811.0
0.008,6,10,1762,5,911,1.0,643.0,643.0,5,851,2.0,583.0,583.0
1798.061,17,2861,219767,1420,115082,1267.0,84.0,53.0,1441,104685,1248.0,225.0,44.0
0.012,6,10,1972,5,910,2.0,642.0,642.0,5,1062,2.0,794.0,794.0
0.009,6,10,1990,5,911,2.0,643.0,643.0,5,1079,2.0,811.0,811.0
0.005,6,10,2000,5,927,1.0,659.0,659.0,5,1073,1.0,805.0,805.0
0.004,6,10,1779,5,928,1.0,660.0,660.0,5,851,1.0,583.0,583.0
0.079,6,10,1506,5,395,17.0,127.0,127.0,5,1111,16.0,843.0,843.0
0.005,6,10,1779,5,928,1.0,660.0,660.0,5,851,1.0,583.0,583.0
0.013,6,13,3735,7,497,2.0,125.0,125.0,6,3238,2.0,1470.0,1459.0
0.011,6,10,1983,5,910,2.0,642.0,642.0,5,1073,2.0,805.0,805.0
0.005,6,14,3742,7,452,0.0,80.0,80.0,7,3290,0.0,1448.0,972.0
0.087,6,10,1506,5,395,15.0,127.0,127.0,5,1111,19.0,843.0,843.0
0.134,6,10,1506,5,395,31.0,127.0,127.0,5,1111,32.0,843.0,843.0
0.07,6,10,1506,5,395,16.0,127.0,127.0,5,1111,15.0,843.0,843.0
552.887,6,61,26474,32,4722,17835.0,662.0,435.0,29,21752,17602.0,1402.0,963.0
1755.349,6,307,97965,190,86633,9287.0,2001.0,673.0,117,11332,15132.0,452.0,70.0
0.087,6,10,1506,5,395,17.0,127.0,127.0,5,1111,19.0,843.0,843.0
300.799,6,37,9740,20,4262,15831.0,1686.0,686.0,17,5478,541.0,2667.0,435.0
0.104,6,10,1506,5,395,23.0,127.0,127.0,5,1111,24.0,843.0,843.0
0.012,6,10,1989,5,910,3.0,642.0,642.0,5,1079,3.0,811.0,811.0
0.005,6,10,2006,5,927,1.0,659.0,659.0,5,1079,1.0,811.0,811.0
0.037,17,2,136,1,60,0.0,32.0,32.0,1,76,0.0,48.0,48.0
0.017,6,10,1689,5,839,4.0,571.0,571.0,5,850,4.0,582.0,582.0
0.005,6,10,2007,5,928,1.0,660.0,660.0,5,1079,1.0,811.0,811.0
0.006,17,2,148,1,60,0.0,32.0,32.0,1,88,0.0,60.0,60.0
0.04,17,2,152,1,76,0.0,48.0,48.0,1,76,0.0,48.0,48.0
0.008,17,2,179,1,71,0.0,43.0,43.0,1,108,0.0,80.0,80.0
1730.366,6,48,2957,31,1800,57678.0,35.0,35.0,17,1157,108143.0,31.0,31.0
0.078,6,10,1506,5,395,17.0,127.0,127.0,5,1111,17.0,843.0,843.0
0.005,6,10,2000,5,927,1.0,659.0,659.0,5,1073,1.0,805.0,805.0
0.01,6,10,1989,5,910,2.0,642.0,642.0,5,1079,2.0,811.0,811.0
0.012,6,10,1990,5,911,3.0,643.0,643.0,5,1079,2.0,811.0,811.0
0.005,17,2,179,1,71,0.0,43.0,43.0,1,108,0.0,80.0,80.0
0.006,6,10,1643,5,860,1.0,592.0,592.0,5,783,1.0,515.0,515.0
0.039,17,4,284,2,120,0.0,32.0,32.0,2,164,35.0,60.0,54.0
0.014,6,10,1762,5,911,3.0,643.0,643.0,5,851,3.0,583.0,583.0
1770.385,6,78,4110,39,2055,46586.0,27.0,27.0,39,2055,46588.0,27.0,27.0
0.01,6,10,1989,5,910,2.0,642.0,642.0,5,1079,2.0,811.0,811.0
0.004,6,10,1989,5,927,1.0,659.0,659.0,5,1062,1.0,794.0,794.0
0.008,6,12,1926,6,1189,1.0,659.0,434.0,6,737,1.0,417.0,417.0
0.103,6,10,1506,5,395,21.0,127.0,127.0,5,1111,23.0,843.0,843.0
0.005,17,2,140,1,62,0.0,34.0,34.0,1,78,0.0,50.0,50.0
0.005,6,10,1989,5,927,1.0,659.0,659.0,5,1062,1.0,794.0,794.0
0.037,6,14,3787,7,497,6.0,125.0,125.0,7,3290,6.0,1448.0,972.0
51.493,6,53,25381,26,19274,373.0,4080.0,1654.0,27,6107,1973.0,2667.0,385.0
0.005,17,2,140,1,62,0.0,34.0,34.0,1,78,0.0,50.0,50.0
0.005,6,13,3747,7,509,0.0,137.0,137.0,6,3238,0.0,1470.0,1459.0
0.387,17,53,34633,30,28479,13.0,1350.0,921.0,23,6154,13.0,1350.0,239.0
0.039,17,4,284,2,120,0.0,32.0,32.0,2,164,2.0,60.0,54.0
0.003,17,2,136,1,60,0.0,32.0,32.0,1,76,0.0,48.0,48.0
0.013,6,10,1972,5,910,3.0,642.0,642.0,5,1062,3.0,794.0,794.0
0.009,6,10,1972,5,910,2.0,642.0,642.0,5,1062,2.0,794.0,794.0
0.041,17,4,596,2,122,5.0,33.0,33.0,2,474,1.0,323.0,209.0
0.072,6,10,1506,5,395,15.0,127.0,127.0,5,1111,13.0,843.0,843.0
10.862,17,28,4423,14,1994,827.0,269.0,114.0,14,2429,826.0,588.0,145.0
240.09,6,16,4480,9,963,30011.0,238.0,166.0,7,3517,40014.0,1402.0,786.0
0.006,17,2,179,1,71,0.0,43.0,43.0,1,108,0.0,80.0,80.0
0.022,6,10,1631,5,848,5.0,580.0,580.0,5,783,5.0,515.0,515.0
40.056,17,10,676,5,460,10013.0,104.0,64.0,5,216,10012.0,20.0,15.0
0.006,6,10,1689,5,839,1.0,571.0,571.0,5,850,1.0,582.0,582.0
0.079,6,10,1506,5,395,19.0,127.0,127.0,5,1111,17.0,843.0,843.0
1730.406,6,45,2790,30,1725,59669.0,35.0,35.0,15,1065,123594.0,31.0,31.0
0.009,6,10,1989,5,910,2.0,642.0,642.0,5,1079,2.0,811.0,811.0
0.01,6,10,1989,5,910,2.0,642.0,642.0,5,1079,2.0,811.0,811.0
0.005,6,10,2006,5,927,1.0,659.0,659.0,5,1079,1.0,811.0,811.0
0.095,6,10,1506,5,395,20.0,127.0,127.0,5,1111,21.0,843.0,843.0
0.117,6,10,1506,5,395,26.0,127.0,127.0,5,1111,28.0,843.0,843.0
0.009,6,10,1983,5,910,2.0,642.0,642.0,5,1073,2.0,805.0,805.0
0.08,6,10,1506,5,395,18.0,127.0,127.0,5,1111,15.0,843.0,843.0
0.001,17,2,180,1,66,0.0,38.0,38.0,1,114,0.0,86.0,86.0
0.003,17,4,284,2,120,0.0,32.0,32.0,2,164,0.0,60.0,54.0
0.086,6,10,1506,5,395,19.0,127.0,127.0,5,1111,20.0,843.0,843.0
0.123,6,10,1506,5,395,26.0,127.0,127.0,5,1111,21.0,843.0,843.0
0.026,6,10,1989,5,910,6.0,642.0,642.0,5,1079,6.0,811.0,811.0
0.015,6,10,1989,5,910,3.0,642.0,642.0,5,1079,3.0,811.0,811.0
0.005,6,10,1989,5,927,1.0,659.0,659.0,5,1062,1.0,794.0,794.0
0.004,17,2,164,1,74,0.0,46.0,46.0,1,90,0.0,62.0,62.0
0.006,6,10,1854,5,889,1.0,621.0,621.0,5,965,1.0,697.0,697.0
0.008,6,10,1990,5,911,2.0,643.0,643.0,5,1079,1.0,811.0,811.0
0.019,6,10,1983,5,910,4.0,642.0,642.0,5,1073,4.0,805.0,805.0
0.004,17,2,148,1,60,0.0,32.0,32.0,1,88,0.0,60.0,60.0
0.013,17,2,152,1,56,0.0,28.0,28.0,1,96,0.0,68.0,68.0
0.016,6,10,1631,5,848,4.0,580.0,580.0,5,783,4.0,515.0,515.0
176.153,17,74,10435,37,2472,4892.0,44.0,38.0,37,7963,4893.0,252.0,187.0
308.826,17,20,1124,10,716,34302.0,48.0,43.0,10,408,34302.0,20.0,12.0
40.051,17,10,676,5,460,10011.0,104.0,64.0,5,216,10011.0,20.0,15.0
0.018,6,10,1989,5,910,4.0,642.0,642.0,5,1079,4.0,811.0,811.0
0.011,6,10,1990,5,911,2.0,643.0,643.0,5,1079,2.0,811.0,811.0
0.006,6,10,1547,5,764,1.0,496.0,496.0,5,783,1.0,515.0,515.0
0.015,6,10,1972,5,910,3.0,642.0,642.0,5,1062,3.0,794.0,794.0
0.019,6,10,1983,5,910,4.0,642.0,642.0,5,1073,4.0,805.0,805.0
0.099,6,10,1506,5,395,21.0,127.0,127.0,5,1111,22.0,843.0,843.0
300.386,6,16,2170,9,684,37527.0,146.0,146.0,7,1486,50036.0,419.0,398.0
0.001,17,2,179,1,62,0.0,34.0,34.0,1,117,0.0,89.0,89.0
0.009,6,10,1990,5,911,2.0,643.0,643.0,5,1079,2.0,811.0,811.0
0.004,6,10,1989,5,927,1.0,659.0,659.0,5,1062,1.0,794.0,794.0
0.003,17,2,162,1,65,0.0,37.0,37.0,1,97,0.0,69.0,69.0
0.006,6,10,1643,5,860,1.0,592.0,592.0,5,783,1.0,515.0,515.0
40.068,17,10,676,5,460,10014.0,104.0,64.0,5,216,10015.0,20.0,15.0
0.004,6,10,2007,5,928,1.0,660.0,660.0,5,1079,1.0,811.0,811.0
0.1,6,10,1506,5,395,17.0,127.0,127.0,5,1111,23.0,843.0,843.0
0.005,17,2,214,1,75,0.0,47.0,47.0,1,139,0.0,111.0,111.0
0.039,17,4,352,2,130,1.0,37.0,37.0,2,222,35.0,89.0,83.0
0.005,17,2,214,1,75,0.0,47.0,47.0,1,139,0.0,111.0,111.0
0.004,6,10,1774,5,923,1.0,655.0,655.0,5,851,1.0,583.0,583.0
0.073,6,10,1506,5,395,14.0,127.0,127.0,5,1111,17.0,843.0,843.0
0.009,6,10,1983,5,910,2.0,642.0,642.0,5,1073,2.0,805.0,805.0
366.236,6,22,2313,16,867,24415.0,195.0,195.0,6,1446,4665.0,419.0,398.0
0.005,6,10,1689,5,839,1.0,571.0,571.0,5,850,1.0,582.0,582.0
0.004,17,2,136,1,60,0.0,32.0,32.0,1,76,0.0,48.0,48.0
0.009,6,10,1631,5,848,2.0,580.0,580.0,5,783,2.0,515.0,515.0
0.009,6,10,1989,5,910,2.0,642.0,642.0,5,1079,2.0,811.0,811.0
40.059,17,10,676,5,460,10013.0,104.0,64.0,5,216,10013.0,20.0,15.0
0.007,17,4,420,2,122,4.0,33.0,33.0,2,298,3.0,145.0,121.0
40.058,17,10,676,5,460,10013.0,104.0,64.0,5,216,10013.0,20.0,15.0
0.039,17,2,136,1,60,0.0,32.0,32.0,1,76,0.0,48.0,48.0
300.419,6,16,2170,9,684,37530.0,146.0,146.0,7,1486,50041.0,419.0,398.0
10.999,17,28,4389,14,2311,837.0,586.0,137.0,14,2078,837.0,269.0,120.0
0.01,6,10,1983,5,910,2.0,642.0,642.0,5,1073,2.0,805.0,805.0
0.079,6,10,1506,5,395,17.0,127.0,127.0,5,1111,16.0,843.0,843.0
0.015,6,10,1983,5,910,3.0,642.0,642.0,5,1073,3.0,805.0,805.0
0.012,6,10,1972,5,910,3.0,642.0,642.0,5,1062,3.0,794.0,794.0
0.079,17,4,352,2,130,39.0,37.0,37.0,2,222,41.0,89.0,83.0
0.005,6,10,2007,5,928,1.0,660.0,660.0,5,1079,1.0,811.0,811.0
0.005,6,10,2000,5,927,1.0,659.0,659.0,5,1073,1.0,805.0,805.0
40.077,17,10,676,5,460,10015.0,104.0,64.0,5,216,10018.0,20.0,15.0
0.001,17,2,136,1,60,0.0,32.0,32.0,1,76,0.0,48.0,48.0
0.005,17,2,179,1,71,0.0,43.0,43.0,1,108,0.0,80.0,80.0
0.015,6,10,1989,5,910,3.0,642.0,642.0,5,1079,3.0,811.0,811.0
301.026,6,37,9900,19,4221,16723.0,3075.0,857.0,18,5679,521.0,1360.0,412.0
11.205,17,28,4420,14,1993,849.0,268.0,114.0,14,2427,849.0,586.0,145.0
0.112,6,18,8163,10,808,12.0,280.0,280.0,8,7355,15.0,1402.0,1386.0
0.006,6,10,1689,5,839,1.0,571.0,571.0,5,850,1.0,582.0,582.0
0.147,6,10,1242,5,751,36.0,495.0,495.0,5,491,32.0,223.0,223.0
0.095,6,10,1506,5,395,21.0,127.0,127.0,5,1111,22.0,843.0,843.0
0.012,6,10,1990,5,911,2.0,643.0,643.0,5,1079,3.0,811.0,811.0
0.005,6,10,1547,5,764,1.0,496.0,496.0,5,783,1.0,515.0,515.0
0.003,17,2,136,1,60,0.0,32.0,32.0,1,76,0.0,48.0,48.0
0.006,6,10,1547,5,764,1.0,496.0,496.0,5,783,1.0,515.0,515.0
0.01,6,10,1989,5,910,2.0,642.0,642.0,5,1079,2.0,811.0,811.0
240.021,6,9,787,5,488,60005.0,232.0,232.0,4,299,80006.0,83.0,83.0
0.177,6,10,1506,5,395,40.0,127.0,127.0,5,1111,42.0,843.0,843.0
0.006,6,10,1854,5,889,1.0,621.0,621.0,5,965,1.0,697.0,697.0
0.086,6,10,1506,5,395,17.0,127.0,127.0,5,1111,20.0,843.0,843.0
0.003,17,2,148,1,60,0.0,32.0,32.0,1,88,0.0,60.0,60.0
0.004,6,10,2000,5,927,1.0,659.0,659.0,5,1073,1.0,805.0,805.0
0.017,17,2,148,1,60,0.0,32.0,32.0,1,88,0.0,60.0,60.0
1799.055,17,3191,244160,1588,128690,1133.0,84.0,53.0,1603,115470,1122.0,227.0,44.0
0.009,6,12,1926,6,1189,1.0,659.0,434.0,6,737,1.0,417.0,417.0
0.005,6,10,2006,5,927,1.0,659.0,659.0,5,1079,1.0,811.0,811.0
11.445,17,31,4909,17,2510,708.0,269.0,119.0,14,2399,871.0,586.0,143.0
0.096,17,2,144,1,64,0.0,36.0,36.0,1,80,0.0,52.0,52.0
0.014,6,10,1990,5,911,3.0,643.0,643.0,5,1079,3.0,811.0,811.0
0.042,17,2,182,1,65,0.0,37.0,37.0,1,117,0.0,89.0,89.0
0.006,17,2,294,1,64,0.0,36.0,36.0,1,230,0.0,202.0,202.0
0.08,6,10,1506,5,395,16.0,127.0,127.0,5,1111,16.0,843.0,843.0
0.004,6,10,2006,5,927,1.0,659.0,659.0,5,1079,1.0,811.0,811.0
240.095,6,16,4481,9,963,30011.0,238.0,166.0,7,3518,40015.0,1402.0,786.0
0.004,6,10,1702,5,863,0.0,595.0,595.0,5,839,1.0,571.0,571.0
300.02,6,12,1782,7,1348,50003.0,494.0,494.0,5,434,75004.0,83.0,83.0
0.015,6,10,1972,5,910,3.0,642.0,642.0,5,1062,3.0,794.0,794.0
0.018,6,10,1990,5,911,4.0,643.0,643.0,5,1079,4.0,811.0,811.0
0.095,6,10,1506,5,395,18.0,127.0,127.0,5,1111,20.0,843.0,843.0
40.092,17,10,676,5,460,10012.0,104.0,64.0,5,216,10013.0,20.0,15.0
40.057,17,10,676,5,460,10013.0,104.0,64.0,5,216,10013.0,20.0,15.0
240.09,6,16,4481,9,963,30011.0,238.0,166.0,7,3518,40014.0,1402.0,786.0
0.156,6,10,1506,5,395,25.0,127.0,127.0,5,1111,36.0,843.0,843.0
0.009,6,10,1989,5,910,2.0,642.0,642.0,5,1079,2.0,811.0,811.0
0.006,6,10,1547,5,764,1.0,496.0,496.0,5,783,1.0,515.0,515.0
0.004,6,10,1989,5,927,1.0,659.0,659.0,5,1062,1.0,794.0,794.0
0.069,6,10,1506,5,395,13.0,127.0,127.0,5,1111,15.0,843.0,843.0
0.005,17,2,170,1,65,0.0,37.0,37.0,1,105,0.0,77.0,77.0
0.005,6,10,1689,5,839,1.0,571.0,571.0,5,850,1.0,582.0,582.0
308.541,17,18,1008,9,640,38555.0,48.0,43.0,9,368,38555.0,20.0,12.0
240.085,6,16,4479,9,963,30010.0,238.0,166.0,7,3516,40013.0,1402.0,786.0
0.025,6,10,1989,5,910,6.0,642.0,642.0,5,1079,6.0,811.0,811.0
0.006,17,2,230,1,68,0.0,40.0,40.0,1,162,0.0,134.0,134.0
0.128,6,10,1506,5,395,31.0,127.0,127.0,5,1111,29.0,843.0,843.0
0.732,6,22,5072,11,1250,64.0,325.0,133.0,11,3822,62.0,1414.0,563.0
0.009,6,12,1926,6,1189,1.0,659.0,434.0,6,737,1.0,417.0,417.0
0.038,17,2,412,1,61,0.0,33.0,33.0,1,351,0.0,323.0,323.0
0.006,6,10,1854,5,889,1.0,621.0,621.0,5,965,1.0,697.0,697.0
0.125,17,2,80,1,32,0.0,4.0,4.0,1,48,0.0,20.0,20.0
0.071,6,10,1506,5,395,16.0,127.0,127.0,5,1111,16.0,843.0,843.0
0.017,6,10,1989,5,910,4.0,642.0,642.0,5,1079,4.0,811.0,811.0
40.103,17,10,676,5,460,10014.0,104.0,64.0,5,216,10017.0,20.0,15.0
40.072,17,10,676,5,460,10016.0,104.0,64.0,5,216,10017.0,20.0,15.0
0.118,6,10,1506,5,395,27.0,127.0,127.0,5,1111,25.0,843.0,843.0
0.017,6,10,1677,5,827,4.0,559.0,559.0,5,850,4.0,582.0,582.0
40.063,17,10,676,5,460,10012.0,104.0,64.0,5,216,10015.0,20.0,15.0
0.004,17,2,160,1,72,0.0,44.0,44.0,1,88,0.0,60.0,60.0
0.005,6,10,2007,5,928,1.0,660.0,660.0,5,1079,1.0,811.0,811.0
0.004,6,10,1702,5,863,1.0,595.0,595.0,5,839,0.0,571.0,571.0
0.102,6,10,1506,5,395,22.0,127.0,127.0,5,1111,23.0,843.0,843.0
0.167,17,2,152,1,76,0.0,48.0,48.0,1,76,0.0,48.0,48.0
0.075,6,10,1506,5,395,17.0,127.0,127.0,5,1111,18.0,843.0,843.0
0.017,6,10,1631,5,848,4.0,580.0,580.0,5,783,4.0,515.0,515.0
0.006,6,10,1547,5,764,1.0,496.0,496.0,5,783,1.0,515.0,515.0
0.013,6,13,3735,7,497,2.0,125.0,125.0,6,3238,2.0,1470.0,1459.0
0.072,6,10,1506,5,395,16.0,127.0,127.0,5,1111,17.0,843.0,843.0
0.006,6,10,1547,5,764,1.0,496.0,496.0,5,783,1.0,515.0,515.0
0.003,17,2,136,1,60,0.0,32.0,32.0,1,76,0.0,48.0,48.0
0.005,6,10,1989,5,927,1.0,659.0,659.0,5,1062,1.0,794.0,794.0
309.85,17,20,1124,10,716,34413.0,48.0,43.0,10,408,34413.0,20.0,12.0
293.125,6,370,346354,186,21175,1584.0,2736.0,821.0,184,325179,1601.0,2999.0,1878.0
0.019,6,10,1762,5,911,4.0,643.0,643.0,5,851,4.0,583.0,583.0
0.016,6,10,1990,5,911,3.0,643.0,643.0,5,1079,3.0,811.0,811.0
0.076,6,10,1506,5,395,16.0,127.0,127.0,5,1111,16.0,843.0,843.0
0.11,6,10,1506,5,395,22.0,127.0,127.0,5,1111,21.0,843.0,843.0
0.005,6,10,1702,5,863,1.0,595.0,595.0,5,839,1.0,571.0,571.0
40.072,17,10,676,5,460,10015.0,104.0,64.0,5,216,10017.0,20.0,15.0
0.006,6,10,2000,5,927,1.0,659.0,659.0,5,1073,1.0,805.0,805.0
0.009,6,10,2000,5,927,2.0,659.0,659.0,5,1073,2.0,805.0,805.0
0.073,6,10,1506,5,395,16.0,127.0,127.0,5,1111,15.0,843.0,843.0
0.005,6,10,1779,5,928,1.0,660.0,660.0,5,851,1.0,583.0,583.0
0.001,17,2,152,1,68,0.0,40.0,40.0,1,84,0.0,56.0,56.0
0.004,6,10,1702,5,863,0.0,595.0,595.0,5,839,1.0,571.0,571.0
0.104,6,10,1506,5,395,21.0,127.0,127.0,5,1111,24.0,843.0,843.0
0.009,6,10,1990,5,911,2.0,643.0,643.0,5,1079,2.0,811.0,811.0
0.005,6,10,2000,5,927,1.0,659.0,659.0,5,1073,1.0,805.0,805.0
0.082,6,10,1506,5,395,18.0,127.0,127.0,5,1111,15.0,843.0,843.0
0.003,17,2,136,1,60,0.0,32.0,32.0,1,76,0.0,48.0,48.0
0.009,6,12,1926,6,1189,1.0,659.0,434.0,6,737,1.0,417.0,417.0
0.003,17,4,284,2,120,0.0,32.0,32.0,2,164,0.0,60.0,54.0
40.069,17,10,676,5,460,10016.0,104.0,64.0,5,216,10016.0,20.0,15.0
0.005,6,10,2006,5,927,1.0,659.0,659.0,5,1079,1.0,811.0,811.0
0.134,6,10,1506,5,395,30.0,127.0,127.0,5,1111,27.0,843.0,843.0
0.017,6,10,1989,5,910,4.0,642.0,642.0,5,1079,4.0,811.0,811.0
0.02,6,13,3735,7,497,3.0,125.0,125.0,6,3238,3.0,1470.0,1459.0
0.016,6,10,1989,5,910,3.0,642.0,642.0,5,1079,3.0,811.0,811.0
290.093,6,395,348866,200,21965,1457.0,2736.0,889.0,195,326901,1495.0,2804.0,1759.0
0.264,6,16,2674,8,1400,37.0,533.0,325.0,8,1274,23.0,529.0,212.0
259.678,6,39,9703,16,6729,17311.0,1515.0,590.0,23,2974,11803.0,580.0,126.0
0.104,6,10,1506,5,395,23.0,127.0,127.0,5,1111,24.0,843.0,843.0
0.007,6,10,1547,5,764,1.0,496.0,496.0,5,783,1.0,515.0,515.0
0.006,6,10,1854,5,889,1.0,621.0,621.0,5,965,1.0,697.0,697.0
0.006,6,13,3684,7,446,0.0,74.0,74.0,6,3238,1.0,1470.0,1459.0
0.005,6,13,3690,7,452,0.0,80.0,80.0,6,3238,1.0,1470.0,1459.0
0.005,6,10,2006,5,927,1.0,659.0,659.0,5,1079,1.0,811.0,811.0
0.005,6,10,1989,5,927,1.0,659.0,659.0,5,1062,1.0,794.0,794.0
0.079,6,10,1506,5,395,16.0,127.0,127.0,5,1111,16.0,843.0,843.0
0.079,6,10,1506,5,395,17.0,127.0,127.0,5,1111,18.0,843.0,843.0
0.064,6,10,1506,5,395,13.0,127.0,127.0,5,1111,14.0,843.0,843.0
0.011,6,10,1989,5,910,2.0,642.0,642.0,5,1079,2.0,811.0,811.0
0.004,6,10,1779,5,928,1.0,660.0,660.0,5,851,1.0,583.0,583.0
0.15,6,10,1506,5,395,33.0,127.0,127.0,5,1111,34.0,843.0,843.0
0.01,6,10,1989,5,910,2.0,642.0,642.0,5,1079,2.0,811.0,811.0
0.015,6,10,1972,5,910,3.0,642.0,642.0,5,1062,3.0,794.0,794.0
0.004,6,10,2006,5,927,1.0,659.0,659.0,5,1079,1.0,811.0,811.0
0.011,6,10,1972,5,910,2.0,642.0,642.0,5,1062,2.0,794.0,794.0
0.216,6,16,2782,8,1400,30.0,533.0,325.0,8,1382,19.0,529.0,239.0
0.001,17,2,136,1,60,0.0,32.0,32.0,1,76,0.0,48.0,48.0
0.004,6,10,2006,5,927,1.0,659.0,659.0,5,1079,1.0,811.0,811.0
0.005,6,10,1989,5,927,1.0,659.0,659.0,5,1062,1.0,794.0,794.0
40.063,17,10,676,5,460,10015.0,104.0,64.0,5,216,10015.0,20.0,15.0
0.006,6,10,1547,5,764,1.0,496.0,496.0,5,783,1.0,515.0,515.0
0.14,6,10,1506,5,395,33.0,127.0,127.0,5,1111,32.0,843.0,843.0
0.112,6,10,1506,5,395,22.0,127.0,127.0,5,1111,25.0,843.0,843.0
0.012,6,10,1631,5,848,3.0,580.0,580.0,5,783,3.0,515.0,515.0
0.011,6,10,1762,5,911,2.0,643.0,643.0,5,851,2.0,583.0,583.0
0.018,6,10,1972,5,910,4.0,642.0,642.0,5,1062,4.0,794.0,794.0
0.066,17,8,3613,4,1874,22.0,1350.0,440.0,4,1739,11.0,1350.0,406.0
0.096,6,10,1506,5,395,21.0,127.0,127.0,5,1111,18.0,843.0,843.0
361.895,6,21,1792,16,1030,24126.0,190.0,190.0,5,762,60009.0,461.0,247.0
40.056,17,10,676,5,460,10013.0,104.0,64.0,5,216,10013.0,20.0,15.0
0.098,6,10,1506,5,395,21.0,127.0,127.0,5,1111,20.0,843.0,843.0
177.101,17,94,13493,47,3169,3849.0,44.0,39.0,47,10324,3849.0,239.0,191.0
40.068,17,10,676,5,460,10014.0,104.0,64.0,5,216,10016.0,20.0,15.0
0.006,6,10,1689,5,839,1.0,571.0,571.0,5,850,1.0,582.0,582.0
0.072,6,10,1506,5,395,15.0,127.0,127.0,5,1111,14.0,843.0,843.0
0.01,6,10,1989,5,910,2.0,642.0,642.0,5,1079,2.0,811.0,811.0
40.059,17,10,676,5,460,10013.0,104.0,64.0,5,216,10013.0,20.0,15.0
0.005,6,10,2007,5,928,1.0,660.0,660.0,5,1079,1.0,811.0,811.0
0.175,6,3,453,2,321,175.0,241.0,241.0,1,132,0.0,92.0,92.0
0.021,6,10,1989,5,910,5.0,642.0,642.0,5,1079,5.0,811.0,811.0
0.08,6,10,1506,5,395,18.0,127.0,127.0,5,1111,16.0,843.0,843.0
0.011,6,10,1983,5,910,2.0,642.0,642.0,5,1073,2.0,805.0,805.0
369.445,6,22,2313,16,867,24629.0,195.0,195.0,6,1446,4637.0,419.0,398.0
10.783,17,28,4422,14,1994,821.0,269.0,114.0,14,2428,820.0,587.0,145.0
49.344,6,44,17148,31,5174,1644.0,1004.0,196.0,13,11974,37.0,2804.0,1408.0
0.006,6,10,1689,5,839,1.0,571.0,571.0,5,850,1.0,582.0,582.0
0.005,6,10,1689,5,839,1.0,571.0,571.0,5,850,1.0,582.0,582.0
0.07,6,10,1506,5,395,16.0,127.0,127.0,5,1111,15.0,843.0,843.0
0.005,6,10,1779,5,928,1.0,660.0,660.0,5,851,1.0,583.0,583.0
0.085,6,10,1506,5,395,20.0,127.0,127.0,5,1111,19.0,843.0,843.0
0.012,6,10,1972,5,910,2.0,642.0,642.0,5,1062,2.0,794.0,794.0
0.006,17,2,170,1,65,0.0,37.0,37.0,1,105,0.0,77.0,77.0
0.006,6,10,1547,5,764,1.0,496.0,496.0,5,783,1.0,515.0,515.0
0.076,6,10,1506,5,395,16.0,127.0,127.0,5,1111,15.0,843.0,843.0
0.005,6,10,1774,5,923,1.0,655.0,655.0,5,851,1.0,583.0,583.0
0.012,6,10,1972,5,910,2.0,642.0,642.0,5,1062,3.0,794.0,794.0
0.005,17,2,144,1,64,0.0,36.0,36.0,1,80,0.0,52.0,52.0
0.17,6,10,1506,5,395,41.0,127.0,127.0,5,1111,41.0,843.0,843.0
0.089,6,10,1506,5,395,21.0,127.0,127.0,5,1111,20.0,843.0,843.0
0.166,17,2,152,1,76,0.0,48.0,48.0,1,76,0.0,48.0,48.0
0.013,6,10,1983,5,910,3.0,642.0,642.0,5,1073,3.0,805.0,805.0
0.039,17,2,152,1,76,0.0,48.0,48.0,1,76,0.0,48.0,48.0
0.107,6,10,1506,5,395,22.0,127.0,127.0,5,1111,23.0,843.0,843.0
0.038,17,2,136,1,60,0.0,32.0,32.0,1,76,0.0,48.0,48.0
0.018,6,10,1972,5,910,4.0,642.0,642.0,5,1062,4.0,794.0,794.0
0.089,6,10,1506,5,395,19.0,127.0,127.0,5,1111,20.0,843.0,843.0
15.173,17,20,12719,11,9166,1514.0,1350.0,805.0,9,3553,1892.0,1350.0,366.0
0.093,6,10,1506,5,395,22.0,127.0,127.0,5,1111,19.0,843.0,843.0
0.081,6,10,1506,5,395,18.0,127.0,127.0,5,1111,16.0,843.0,843.0
0.008,6,10,1702,5,863,1.0,595.0,595.0,5,839,2.0,571.0,571.0
240.22,6,36,10195,18,1887,14130.0,559.0,188.0,18,8308,14130.0,1402.0,614.0
5.513,6,38,25440,18,15932,324.0,2804.0,2141.0,20,9508,283.0,1288.0,1208.0
0.081,6,10,1506,5,395,17.0,127.0,127.0,5,1111,18.0,843.0,843.0
0.016,6,10,1972,5,910,4.0,642.0,642.0,5,1062,3.0,794.0,794.0
0.005,6,13,3747,7,509,0.0,137.0,137.0,6,3238,0.0,1470.0,1459.0
0.011,6,10,1989,5,910,2.0,642.0,642.0,5,1079,2.0,811.0,811.0
0.004,6,10,2007,5,928,1.0,660.0,660.0,5,1079,1.0,811.0,811.0
0.011,6,14,3787,7,497,1.0,125.0,125.0,7,3290,1.0,1448.0,972.0
0.005,6,10,1989,5,927,1.0,659.0,659.0,5,1062,1.0,794.0,794.0
0.009,6,10,1972,5,910,2.0,642.0,642.0,5,1062,2.0,794.0,794.0
0.029,6,13,3735,7,497,4.0,125.0,125.0,6,3238,5.0,1470.0,1459.0
0.017,6,10,1983,5,910,4.0,642.0,642.0,5,1073,4.0,805.0,805.0
0.013,6,10,1983,5,910,3.0,642.0,642.0,5,1073,3.0,805.0,805.0
0.016,6,10,1990,5,911,3.0,643.0,643.0,5,1079,3.0,811.0,811.0
0.004,6,10,1779,5,928,1.0,660.0,660.0,5,851,1.0,583.0,583.0
0.009,6,10,1972,5,910,2.0,642.0,642.0,5,1062,2.0,794.0,794.0
0.003,17,2,185,1,73,0.0,45.0,45.0,1,112,0.0,84.0,84.0
0.005,17,2,144,1,64,0.0,36.0,36.0,1,80,0.0,52.0,52.0
0.008,6,13,3747,7,509,1.0,137.0,137.0,6,3238,1.0,1470.0,1459.0
0.006,6,10,1689,5,839,1.0,571.0,571.0,5,850,1.0,582.0,582.0
0.021,6,10,1990,5,911,5.0,643.0,643.0,5,1079,5.0,811.0,811.0
0.005,6,10,2007,5,928,1.0,660.0,660.0,5,1079,1.0,811.0,811.0
11.547,17,28,4398,14,2313,875.0,588.0,137.0,14,2085,876.0,268.0,120.0
0.003,17,2,148,1,60,0.0,32.0,32.0,1,88,0.0,60.0,60.0
0.097,6,10,1506,5,395,22.0,127.0,127.0,5,1111,20.0,843.0,843.0
0.006,17,2,214,1,75,0.0,47.0,47.0,1,139,0.0,111.0,111.0
0.006,6,10,2006,5,927,1.0,659.0,659.0,5,1079,1.0,811.0,811.0
0.01,6,12,1926,6,1189,1.0,659.0,434.0,6,737,2.0,417.0,417.0
0.004,6,10,2007,5,928,1.0,660.0,660.0,5,1079,1.0,811.0,811.0
40.741,6,36,9526,18,4008,519.0,1543.0,814.0,18,5518,2386.0,2667.0,435.0
1771.864,17,119,11360,60,5460,30031.0,63.0,63.0,59,5900,30548.0,72.0,72.0
0.005,6,10,2006,5,927,1.0,659.0,659.0,5,1079,1.0,811.0,811.0
0.122,6,10,1506,5,395,29.0,127.0,127.0,5,1111,24.0,843.0,843.0
0.006,6,10,2006,5,927,1.0,659.0,659.0,5,1079,1.0,811.0,811.0
0.004,6,10,1989,5,927,1.0,659.0,659.0,5,1062,1.0,794.0,794.0
0.008,6,10,1983,5,910,2.0,642.0,642.0,5,1073,1.0,805.0,805.0
0.01,6,10,1990,5,911,2.0,643.0,643.0,5,1079,2.0,811.0,811.0
0.017,6,10,1990,5,911,4.0,643.0,643.0,5,1079,4.0,811.0,811.0
0.005,6,10,1779,5,928,1.0,660.0,660.0,5,851,1.0,583.0,583.0
0.093,6,10,1506,5,395,20.0,127.0,127.0,5,1111,21.0,843.0,843.0
0.015,17,2,194,1,59,0.0,31.0,31.0,1,135,0.0,107.0,107.0
0.007,17,2,179,1,71,0.0,43.0,43.0,1,108,0.0,80.0,80.0
0.057,17,2,179,1,71,0.0,43.0,43.0,1,108,0.0,80.0,80.0
0.001,17,2,136,1,60,0.0,32.0,32.0,1,76,0.0,48.0,48.0
40.066,17,10,676,5,460,10014.0,104.0,64.0,5,216,10015.0,20.0,15.0
0.02,6,10,1972,5,910,5.0,642.0,642.0,5,1062,5.0,794.0,794.0
0.115,6,10,1506,5,395,25.0,127.0,127.0,5,1111,24.0,843.0,843.0
0.016,6,10,1989,5,910,3.0,642.0,642.0,5,1079,3.0,811.0,811.0
0.08,6,10,1506,5,395,18.0,127.0,127.0,5,1111,19.0,843.0,843.0
0.124,6,10,1506,5,395,23.0,127.0,127.0,5,1111,25.0,843.0,843.0
0.042,17,2,136,1,60,0.0,32.0,32.0,1,76,0.0,48.0,48.0
0.089,6,10,1506,5,395,18.0,127.0,127.0,5,1111,19.0,843.0,843.0
0.005,17,2,286,1,64,0.0,36.0,36.0,1,222,0.0,194.0,194.0
0.008,6,10,1989,5,910,2.0,642.0,642.0,5,1079,1.0,811.0,811.0
300.759,6,36,8021,19,2543,16708.0,1367.0,437.0,17,5478,537.0,2667.0,435.0
0.001,17,2,180,1,66,0.0,38.0,38.0,1,114,0.0,86.0,86.0
0.013,6,10,1972,5,910,3.0,642.0,642.0,5,1062,3.0,794.0,794.0
0.013,6,10,1972,5,910,3.0,642.0,642.0,5,1062,3.0,794.0,794.0
10.829,17,28,4422,14,1995,824.0,270.0,114.0,14,2427,824.0,586.0,145.0
0.009,6,10,1972,5,910,2.0,642.0,642.0,5,1062,2.0,794.0,794.0
354.024,6,19,1691,15,978,25287.0,190.0,190.0,4,713,80003.0,497.0,497.0
0.005,6,10,2006,5,927,1.0,659.0,659.0,5,1079,1.0,811.0,811.0
175.522,17,74,10595,37,2462,4875.0,44.0,38.0,37,8133,4875.0,261.0,191.0
0.004,17,2,136,1,60,0.0,32.0,32.0,1,76,0.0,48.0,48.0
0.0,17,2,180,1,66,0.0,38.0,38.0,1,114,0.0,86.0,86.0
0.009,6,12,1926,6,1189,1.0,659.0,434.0,6,737,1.0,417.0,417.0
0.069,6,10,1506,5,395,16.0,127.0,127.0,5,1111,14.0,843.0,843.0
0.038,17,2,152,1,76,0.0,48.0,48.0,1,76,0.0,48.0,48.0
40.058,17,10,676,5,460,10013.0,104.0,64.0,5,216,10013.0,20.0,15.0
0.006,6,10,2006,5,927,1.0,659.0,659.0,5,1079,1.0,811.0,811.0
0.004,6,10,2007,5,928,1.0,660.0,660.0,5,1079,1.0,811.0,811.0
0.076,6,10,1506,5,395,17.0,127.0,127.0,5,1111,16.0,843.0,843.0
0.013,6,10,1989,5,910,3.0,642.0,642.0,5,1079,3.0,811.0,811.0
0.08,6,10,1506,5,395,18.0,127.0,127.0,5,1111,16.0,843.0,843.0
0.007,6,10,1972,5,910,1.0,642.0,642.0,5,1062,1.0,794.0,794.0
0.005,6,10,1547,5,764,1.0,496.0,496.0,5,783,1.0,515.0,515.0
0.005,6,10,1689,5,839,1.0,571.0,571.0,5,850,1.0,582.0,582.0
0.008,6,12,1698,6,863,1.0,327.0,271.0,6,835,1.0,515.0,515.0
0.004,6,10,2007,5,928,1.0,660.0,660.0,5,1079,1.0,811.0,811.0
0.005,6,10,1989,5,927,1.0,659.0,659.0,5,1062,1.0,794.0,794.0
0.008,6,10,2006,5,927,2.0,659.0,659.0,5,1079,2.0,811.0,811.0
0.005,6,10,1989,5,927,1.0,659.0,659.0,5,1062,1.0,794.0,794.0
40.067,17,10,676,5,460,10014.0,104.0,64.0,5,216,10014.0,20.0,15.0
354.644,6,20,2210,6,1308,12009.0,494.0,494.0,14,902,27279.0,83.0,83.0
0.216,6,16,2777,8,1395,30.0,533.0,323.0,8,1382,20.0,529.0,239.0
0.067,6,10,1506,5,395,15.0,127.0,127.0,5,1111,14.0,843.0,843.0
352.501,6,20,2210,6,1308,12004.0,494.0,494.0,14,902,27115.0,83.0,83.0
0.009,6,10,1989,5,910,2.0,642.0,642.0,5,1079,2.0,811.0,811.0
0.004,6,10,1779,5,928,1.0,660.0,660.0,5,851,1.0,583.0,583.0
0.098,6,10,1506,5,395,22.0,127.0,127.0,5,1111,21.0,843.0,843.0
0.017,6,13,3735,7,497,2.0,125.0,125.0,6,3238,3.0,1470.0,1459.0
0.016,6,10,1990,5,911,4.0,643.0,643.0,5,1079,4.0,811.0,811.0
0.022,6,10,1989,5,910,5.0,642.0,642.0,5,1079,5.0,811.0,811.0
0.283,17,46,27953,27,24818,10.0,1350.0,891.0,19,3135,12.0,1350.0,137.0
120.072,6,19,3889,12,3102,10915.0,494.0,494.0,7,787,20011.0,83.0,83.0
0.005,6,10,1689,5,839,1.0,571.0,571.0,5,850,1.0,582.0,582.0
0.006,6,10,1643,5,860,1.0,592.0,592.0,5,783,1.0,515.0,515.0
0.007,6,10,1689,5,839,1.0,571.0,571.0,5,850,1.0,582.0,582.0
0.09,6,10,1506,5,395,19.0,127.0,127.0,5,1111,21.0,843.0,843.0
0.005,17,2,140,1,62,0.0,34.0,34.0,1,78,0.0,50.0,50.0
0.229,6,16,2669,8,1395,32.0,533.0,323.0,8,1274,21.0,529.0,212.0
0.005,17,2,230,1,68,0.0,40.0,40.0,1,162,0.0,134.0,134.0
0.005,6,10,2006,5,927,1.0,659.0,659.0,5,1079,1.0,811.0,811.0
0.006,6,14,3799,7,509,1.0,137.0,137.0,7,3290,0.0,1448.0,972.0
0.015,17,2,198,1,91,0.0,63.0,63.0,1,107,0.0,79.0,79.0
0.004,17,2,186,1,61,0.0,33.0,33.0,1,125,0.0,97.0,97.0
0.001,17,2,180,1,66,0.0,38.0,38.0,1,114,0.0,86.0,86.0
0.006,6,10,1547,5,764,1.0,496.0,496.0,5,783,1.0,515.0,515.0
0.005,6,10,1779,5,928,1.0,660.0,660.0,5,851,1.0,583.0,583.0
0.007,17,2,166,1,75,0.0,47.0,47.0,1,91,0.0,63.0,63.0
0.005,6,10,2006,5,927,1.0,659.0,659.0,5,1079,1.0,811.0,811.0
0.003,17,2,148,1,60,0.0,32.0,32.0,1,88,0.0,60.0,60.0
0.008,6,10,1989,5,910,2.0,642.0,642.0,5,1079,1.0,811.0,811.0
0.072,6,10,1506,5,395,17.0,127.0,127.0,5,1111,16.0,843.0,843.0
0.005,6,10,2006,5,927,1.0,659.0,659.0,5,1079,1.0,811.0,811.0
0.004,6,10,1774,5,923,1.0,655.0,655.0,5,851,1.0,583.0,583.0
40.052,17,10,676,5,460,10009.0,104.0,64.0,5,216,10012.0,20.0,15.0
0.005,6,10,2006,5,927,1.0,659.0,659.0,5,1079,1.0,811.0,811.0
0.089,6,10,1506,5,395,19.0,127.0,127.0,5,1111,21.0,843.0,843.0
0.004,6,10,2007,5,928,1.0,660.0,660.0,5,1079,1.0,811.0,811.0
308.595,17,18,1008,9,640,38566.0,48.0,43.0,9,368,38566.0,20.0,12.0
0.113,6,10,1506,5,395,27.0,127.0,127.0,5,1111,25.0,843.0,843.0
0.01,6,10,1990,5,911,2.0,643.0,643.0,5,1079,2.0,811.0,811.0
0.076,6,10,1506,5,395,16.0,127.0,127.0,5,1111,14.0,843.0,843.0
0.005,6,10,2007,5,928,1.0,660.0,660.0,5,1079,1.0,811.0,811.0
0.08,6,10,1506,5,395,17.0,127.0,127.0,5,1111,17.0,843.0,843.0
0.004,17,2,234,1,61,0.0,33.0,33.0,1,173,0.0,145.0,145.0
0.006,6,10,1547,5,764,1.0,496.0,496.0,5,783,1.0,515.0,515.0
310.605,17,20,1124,10,716,34505.0,48.0,43.0,10,408,34505.0,20.0,12.0
0.005,6,10,2000,5,927,1.0,659.0,659.0,5,1073,1.0,805.0,805.0
0.141,6,10,1506,5,395,31.0,127.0,127.0,5,1111,31.0,843.0,843.0
0.005,6,10,2007,5,928,1.0,660.0,660.0,5,1079,1.0,811.0,811.0
0.019,6,10,1972,5,910,4.0,642.0,642.0,5,1062,4.0,794.0,794.0
0.001,17,2,180,1,66,0.0,38.0,38.0,1,114,0.0,86.0,86.0
0.005,6,10,2006,5,927,1.0,659.0,659.0,5,1079,1.0,811.0,811.0
0.013,6,10,1989,5,910,3.0,642.0,642.0,5,1079,3.0,811.0,811.0
0.005,6,10,2006,5,927,1.0,659.0,659.0,5,1079,1.0,811.0,811.0
0.012,6,10,1990,5,911,3.0,643.0,643.0,5,1079,2.0,811.0,811.0
48.83,58,5,360,4,288,16276.0,24.0,24.0,1,72,0.0,24.0,24.0
0.004,17,2,136,1,60,0.0,32.0,32.0,1,76,0.0,48.0,48.0
0.073,6,10,1506,5,395,15.0,127.0,127.0,5,1111,16.0,843.0,843.0
0.13,6,10,1506,5,395,31.0,127.0,127.0,5,1111,31.0,843.0,843.0
0.014,6,10,1972,5,910,3.0,642.0,642.0,5,1062,3.0,794.0,794.0
0.09,6,10,1506,5,395,17.0,127.0,127.0,5,1111,20.0,843.0,843.0
0.005,6,10,2007,5,928,1.0,660.0,660.0,5,1079,1.0,811.0,811.0
0.005,17,2,170,1,65,0.0,37.0,37.0,1,105,0.0,77.0,77.0
0.029,6,10,1989,5,910,7.0,642.0,642.0,5,1079,7.0,811.0,811.0
0.009,6,12,1926,6,1189,1.0,659.0,434.0,6,737,1.0,417.0,417.0
0.006,6,10,1854,5,889,1.0,621.0,621.0,5,965,1.0,697.0,697.0
0.005,6,10,2006,5,927,1.0,659.0,659.0,5,1079,1.0,811.0,811.0
0.007,6,10,1990,5,911,1.0,643.0,643.0,5,1079,1.0,811.0,811.0
40.063,17,10,676,5,460,10014.0,104.0,64.0,5,216,10015.0,20.0,15.0
0.005,6,10,1989,5,927,1.0,659.0,659.0,5,1062,1.0,794.0,794.0
0.006,6,10,1547,5,764,1.0,496.0,496.0,5,783,1.0,515.0,515.0
0.113,6,10,1506,5,395,25.0,127.0,127.0,5,1111,24.0,843.0,843.0
1.208,17,6,976,3,183,585.0,33.0,33.0,3,793,568.0,323.0,236.0
0.005,17,2,214,1,75,0.0,47.0,47.0,1,139,0.0,111.0,111.0
0.007,6,10,1643,5,860,1.0,592.0,592.0,5,783,1.0,515.0,515.0
0.008,6,10,1779,5,928,1.0,660.0,660.0,5,851,2.0,583.0,583.0
0.006,6,10,1547,5,764,1.0,496.0,496.0,5,783,1.0,515.0,515.0
0.014,6,10,1983,5,910,3.0,642.0,642.0,5,1073,3.0,805.0,805.0
0.138,6,10,1506,5,395,32.0,127.0,127.0,5,1111,32.0,843.0,843.0
0.008,6,10,1989,5,910,2.0,642.0,642.0,5,1079,1.0,811.0,811.0
300.024,6,12,1782,7,1348,50004.0,494.0,494.0,5,434,75005.0,83.0,83.0
0.006,6,10,1547,5,764,1.0,496.0,496.0,5,783,1.0,515.0,515.0
0.099,6,10,1506,5,395,17.0,127.0,127.0,5,1111,23.0,843.0,843.0
0.004,17,2,136,1,60,0.0,32.0,32.0,1,76,0.0,48.0,48.0
0.005,6,10,1774,5,923,1.0,655.0,655.0,5,851,1.0,583.0,583.0
0.014,6,10,1990,5,911,3.0,643.0,643.0,5,1079,3.0,811.0,811.0
11.137,17,29,4526,14,2312,848.0,587.0,137.0,15,2214,787.0,269.0,119.0
0.113,6,10,1506,5,395,22.0,127.0,127.0,5,1111,23.0,843.0,843.0
0.071,17,4,284,2,120,0.0,32.0,32.0,2,164,68.0,60.0,54.0
0.04,17,2,136,1,60,0.0,32.0,32.0,1,76,0.0,48.0,48.0
0.026,6,13,3735,7,497,4.0,125.0,125.0,6,3238,5.0,1470.0,1459.0
0.004,6,10,1774,5,923,1.0,655.0,655.0,5,851,1.0,583.0,583.0
15.075,17,14,9191,8,6902,2149.0,1350.0,834.0,6,2289,3009.0,1350.0,353.0
0.013,6,10,1989,5,910,3.0,642.0,642.0,5,1079,3.0,811.0,811.0
0.218,6,16,2669,8,1395,31.0,533.0,323.0,8,1274,20.0,529.0,212.0
0.019,17,2,136,1,60,0.0,32.0,32.0,1,76,0.0,48.0,48.0
0.005,6,13,3690,7,452,0.0,80.0,80.0,6,3238,0.0,1470.0,1459.0
0.004,6,10,1989,5,927,1.0,659.0,659.0,5,1062,1.0,794.0,794.0
0.011,6,10,1972,5,910,2.0,642.0,642.0,5,1062,2.0,794.0,794.0
0.011,6,10,1972,5,910,2.0,642.0,642.0,5,1062,2.0,794.0,794.0
0.113,6,10,1506,5,395,24.0,127.0,127.0,5,1111,23.0,843.0,843.0
0.004,6,10,2006,5,927,1.0,659.0,659.0,5,1079,1.0,811.0,811.0
0.008,17,2,230,1,68,0.0,40.0,40.0,1,162,0.0,134.0,134.0
31.805,6,38,9806,19,4203,494.0,3046.0,1133.0,19,5603,1757.0,2667.0,402.0
40.092,17,10,676,5,460,10016.0,104.0,64.0,5,216,10022.0,20.0,15.0
0.046,6,10,1989,5,910,11.0,642.0,642.0,5,1079,11.0,811.0,811.0
0.004,6,10,1989,5,927,1.0,659.0,659.0,5,1062,1.0,794.0,794.0
0.005,6,10,1989,5,927,1.0,659.0,659.0,5,1062,1.0,794.0,794.0
0.111,6,10,1506,5,395,23.0,127.0,127.0,5,1111,20.0,843.0,843.0
0.069,6,10,1506,5,395,17.0,127.0,127.0,5,1111,14.0,843.0,843.0
0.064,6,10,1506,5,395,15.0,127.0,127.0,5,1111,15.0,843.0,843.0
354.077,6,21,1794,16,1030,23605.0,190.0,190.0,5,764,60003.0,463.0,248.0
0.004,6,10,2000,5,927,1.0,659.0,659.0,5,1073,1.0,805.0,805.0
0.061,6,10,1506,5,395,12.0,127.0,127.0,5,1111,13.0,843.0,843.0
0.427,17,47,22392,25,18572,17.0,1350.0,714.0,22,3820,17.0,1350.0,145.0
240.085,6,16,4481,9,963,30010.0,238.0,166.0,7,3518,40013.0,1402.0,786.0
0.001,17,2,180,1,66,0.0,38.0,38.0,1,114,0.0,86.0,86.0
0.005,17,2,170,1,65,0.0,37.0,37.0,1,105,0.0,77.0,77.0
0.029,6,10,1983,5,910,7.0,642.0,642.0,5,1073,7.0,805.0,805.0
0.007,6,10,1702,5,863,1.0,595.0,595.0,5,839,1.0,571.0,571.0
0.078,6,10,1506,5,395,18.0,127.0,127.0,5,1111,19.0,843.0,843.0
0.013,6,10,1989,5,910,3.0,642.0,642.0,5,1079,3.0,811.0,811.0
0.003,17,2,136,1,60,0.0,32.0,32.0,1,76,0.0,48.0,48.0
0.011,6,10,1989,5,910,2.0,642.0,642.0,5,1079,2.0,811.0,811.0
0.005,6,10,2000,5,927,1.0,659.0,659.0,5,1073,1.0,805.0,805.0
0.005,17,2,299,1,65,0.0,37.0,37.0,1,234,0.0,206.0,206.0
0.142,6,10,1506,5,395,35.0,127.0,127.0,5,1111,31.0,843.0,843.0
240.441,6,36,10521,18,2215,14141.0,559.0,254.0,18,8306,14141.0,1402.0,614.0
0.001,17,2,180,1,66,0.0,38.0,38.0,1,114,0.0,86.0,86.0
0.01,17,2,194,1,59,0.0,31.0,31.0,1,135,0.0,107.0,107.0
0.081,6,10,1506,5,395,19.0,127.0,127.0,5,1111,19.0,843.0,843.0
0.003,17,2,132,1,58,0.0,30.0,30.0,1,74,0.0,46.0,46.0
11.204,17,28,4421,14,1994,848.0,269.0,114.0,14,2427,849.0,586.0,145.0
0.135,6,10,1506,5,395,31.0,127.0,127.0,5,1111,31.0,843.0,843.0
0.006,6,10,1643,5,860,1.0,592.0,592.0,5,783,1.0,515.0,515.0
0.003,17,2,148,1,60,0.0,32.0,32.0,1,88,0.0,60.0,60.0
1770.467,6,83,4368,42,2210,43181.0,26.0,26.0,41,2158,44260.0,26.0,26.0
0.005,6,10,2006,5,927,1.0,659.0,659.0,5,1079,1.0,811.0,811.0
0.113,6,10,1506,5,395,26.0,127.0,127.0,5,1111,25.0,843.0,843.0
40.061,17,10,676,5,460,10014.0,104.0,64.0,5,216,10014.0,20.0,15.0
0.005,17,2,164,1,74,0.0,46.0,46.0,1,90,0.0,62.0,62.0
0.011,6,10,1989,5,910,2.0,642.0,642.0,5,1079,2.0,811.0,811.0
308.658,17,20,1124,10,716,34281.0,48.0,43.0,10,408,34282.0,20.0,12.0
0.011,6,10,1631,5,848,2.0,580.0,580.0,5,783,2.0,515.0,515.0
0.005,6,10,1989,5,927,1.0,659.0,659.0,5,1062,1.0,794.0,794.0
0.004,6,10,2000,5,927,1.0,659.0,659.0,5,1073,1.0,805.0,805.0
0.001,17,2,180,1,66,0.0,38.0,38.0,1,114,0.0,86.0,86.0
0.005,6,10,2006,5,927,1.0,659.0,659.0,5,1079,1.0,811.0,811.0
0.014,6,10,1990,5,911,3.0,643.0,643.0,5,1079,3.0,811.0,811.0
0.014,6,10,1989,5,910,3.0,642.0,642.0,5,1079,3.0,811.0,811.0
0.101,6,10,1506,5,395,22.0,127.0,127.0,5,1111,24.0,843.0,843.0
0.015,6,13,3735,7,497,2.0,125.0,125.0,6,3238,2.0,1470.0,1459.0
0.016,17,2,198,1,91,0.0,63.0,63.0,1,107,0.0,79.0,79.0
0.006,6,10,1643,5,860,1.0,592.0,592.0,5,783,1.0,515.0,515.0
0.005,6,10,1989,5,927,1.0,659.0,659.0,5,1062,1.0,794.0,794.0
0.001,17,2,180,1,66,0.0,38.0,38.0,1,114,0.0,86.0,86.0
0.125,6,10,1506,5,395,25.0,127.0,127.0,5,1111,24.0,843.0,843.0
0.14,6,10,1506,5,395,29.0,127.0,127.0,5,1111,32.0,843.0,843.0
0.014,6,10,1989,5,910,3.0,642.0,642.0,5,1079,3.0,811.0,811.0
0.012,17,2,152,1,76,0.0,48.0,48.0,1,76,0.0,48.0,48.0
0.204,6,16,2668,8,1394,29.0,533.0,323.0,8,1274,18.0,529.0,212.0
0.012,6,10,1677,5,827,3.0,559.0,559.0,5,850,2.0,582.0,582.0
0.012,6,10,1972,5,910,2.0,642.0,642.0,5,1062,2.0,794.0,794.0
0.08,6,10,1506,5,395,17.0,127.0,127.0,5,1111,16.0,843.0,843.0
0.019,6,10,1972,5,910,4.0,642.0,642.0,5,1062,4.0,794.0,794.0
0.012,6,10,1989,5,910,3.0,642.0,642.0,5,1079,3.0,811.0,811.0
0.004,17,2,148,1,60,0.0,32.0,32.0,1,88,0.0,60.0,60.0
0.005,6,10,1779,5,928,1.0,660.0,660.0,5,851,1.0,583.0,583.0
0.006,6,10,2006,5,927,1.0,659.0,659.0,5,1079,1.0,811.0,811.0
0.001,17,2,180,1,66,0.0,38.0,38.0,1,114,0.0,86.0,86.0
0.016,6,10,1677,5,827,4.0,559.0,559.0,5,850,3.0,582.0,582.0
0.085,6,10,1506,5,395,16.0,127.0,127.0,5,1111,20.0,843.0,843.0
40.087,17,10,676,5,460,10019.0,104.0,64.0,5,216,10020.0,20.0,15.0
0.039,17,2,136,1,60,0.0,32.0,32.0,1,76,0.0,48.0,48.0
0.003,17,2,186,1,61,0.0,33.0,33.0,1,125,0.0,97.0,97.0
0.04,17,2,152,1,76,0.0,48.0,48.0,1,76,0.0,48.0,48.0
0.013,6,10,1631,5,848,3.0,580.0,580.0,5,783,3.0,515.0,515.0
11.184,17,28,4419,14,1994,847.0,269.0,114.0,14,2425,847.0,588.0,145.0
0.115,17,2,144,1,64,0.0,36.0,36.0,1,80,0.0,52.0,52.0
0.006,6,10,2006,5,927,1.0,659.0,659.0,5,1079,1.0,811.0,811.0
240.195,6,23,9378,12,4569,21835.0,1368.0,789.0,11,4809,24018.0,1656.0,1057.0
0.004,6,10,1989,5,927,1.0,659.0,659.0,5,1062,1.0,794.0,794.0
0.004,17,2,148,1,60,0.0,32.0,32.0,1,88,0.0,60.0,60.0
0.004,17,2,148,1,60,0.0,32.0,32.0,1,88,0.0,60.0,60.0
0.011,6,10,1631,5,848,2.0,580.0,580.0,5,783,2.0,515.0,515.0
0.005,6,10,1547,5,764,1.0,496.0,496.0,5,783,1.0,515.0,515.0
0.001,17,2,179,1,62,0.0,34.0,34.0,1,117,0.0,89.0,89.0
0.005,17,2,156,1,70,0.0,42.0,42.0,1,86,0.0,58.0,58.0
0.004,6,10,1779,5,928,1.0,660.0,660.0,5,851,1.0,583.0,583.0
11.112,17,28,4423,14,1995,842.0,270.0,114.0,14,2428,842.0,587.0,145.0
0.005,6,10,1643,5,860,1.0,592.0,592.0,5,783,1.0,515.0,515.0
0.014,6,10,1989,5,910,3.0,642.0,642.0,5,1079,3.0,811.0,811.0
0.005,17,2,144,1,64,0.0,36.0,36.0,1,80,0.0,52.0,52.0
40.068,17,10,676,5,460,10016.0,104.0,64.0,5,216,10016.0,20.0,15.0
300.135,6,40,9974,22,4456,14284.0,1360.0,588.0,18,5518,17645.0,2667.0,435.0
10.827,17,26,4102,13,1846,893.0,269.0,114.0,13,2256,893.0,587.0,145.0
15.084,17,16,8059,8,5968,2150.0,1350.0,718.0,8,2091,2150.0,1350.0,233.0
0.009,6,10,1989,5,910,2.0,642.0,642.0,5,1079,2.0,811.0,811.0
0.02,6,10,1989,5,910,4.0,642.0,642.0,5,1079,5.0,811.0,811.0
0.014,6,10,1972,5,910,3.0,642.0,642.0,5,1062,3.0,794.0,794.0
0.005,6,14,3799,7,509,0.0,137.0,137.0,7,3290,0.0,1448.0,972.0
0.004,6,10,2006,5,927,1.0,659.0,659.0,5,1079,1.0,811.0,811.0
0.099,6,10,1506,5,395,23.0,127.0,127.0,5,1111,22.0,843.0,843.0
0.005,6,10,1643,5,860,1.0,592.0,592.0,5,783,1.0,515.0,515.0
0.005,6,10,1989,5,927,1.0,659.0,659.0,5,1062,1.0,794.0,794.0
0.016,6,10,1983,5,910,4.0,642.0,642.0,5,1073,3.0,805.0,805.0
0.125,6,10,1506,5,395,29.0,127.0,127.0,5,1111,25.0,843.0,843.0
40.066,17,10,676,5,460,10013.0,104.0,64.0,5,216,10015.0,20.0,15.0
10.929,17,28,4421,14,1993,832.0,268.0,114.0,14,2428,832.0,587.0,145.0
40.054,17,10,676,5,460,10012.0,104.0,64.0,5,216,10012.0,20.0,15.0
240.092,6,16,4481,9,963,30011.0,238.0,166.0,7,3518,40014.0,1402.0,786.0
0.017,6,10,1972,5,910,4.0,642.0,642.0,5,1062,4.0,794.0,794.0
11.047,17,28,4390,14,2312,840.0,587.0,137.0,14,2078,840.0,269.0,120.0
0.005,17,2,140,1,62,0.0,34.0,34.0,1,78,0.0,50.0,50.0
0.005,6,14,3799,7,509,0.0,137.0,137.0,7,3290,0.0,1448.0,972.0
0.013,6,10,1989,5,910,3.0,642.0,642.0,5,1079,3.0,811.0,811.0
300.066,6,43,12670,23,7027,13631.0,2720.0,1010.0,20,5643,15782.0,2667.0,402.0
240.07,6,20,4872,11,941,24007.0,180.0,93.0,9,3931,30008.0,1591.0,575.0
0.006,6,10,1547,5,764,1.0,496.0,496.0,5,783,1.0,515.0,515.0
0.117,6,10,1506,5,395,26.0,127.0,127.0,5,1111,23.0,843.0,843.0
0.01,6,10,1989,5,910,2.0,642.0,642.0,5,1079,2.0,811.0,811.0
0.011,6,10,1989,5,910,2.0,642.0,642.0,5,1079,2.0,811.0,811.0
0.111,6,10,1506,5,395,25.0,127.0,127.0,5,1111,25.0,843.0,843.0
0.044,6,10,1989,5,910,10.0,642.0,642.0,5,1079,11.0,811.0,811.0
0.005,6,10,2006,5,927,1.0,659.0,659.0,5,1079,1.0,811.0,811.0
240.092,6,16,4480,9,963,30011.0,238.0,166.0,7,3517,40014.0,1402.0,786.0
0.066,6,10,1506,5,395,14.0,127.0,127.0,5,1111,15.0,843.0,843.0
0.228,6,10,1506,5,395,55.0,127.0,127.0,5,1111,46.0,843.0,843.0
0.079,6,36,9584,21,2194,3.0,517.0,122.0,15,7390,5.0,2694.0,733.0
0.068,17,8,3613,4,1874,22.0,1350.0,440.0,4,1739,11.0,1350.0,406.0
1756.064,6,105,6270,60,3525,29763.0,27.0,27.0,45,2745,39909.0,27.0,27.0
0.001,17,2,180,1,66,0.0,38.0,38.0,1,114,0.0,86.0,86.0
125.983,6,14,2938,8,2504,17964.0,1414.0,1086.0,6,434,25150.0,182.0,182.0
308.796,17,20,1124,10,716,34303.0,48.0,43.0,10,408,34303.0,20.0,12.0
0.001,17,2,180,1,66,0.0,38.0,38.0,1,114,0.0,86.0,86.0
0.005,17,2,179,1,71,0.0,43.0,43.0,1,108,0.0,80.0,80.0
0.014,6,10,1989,5,910,3.0,642.0,642.0,5,1079,3.0,811.0,811.0
0.005,6,13,3747,7,509,0.0,137.0,137.0,6,3238,0.0,1470.0,1459.0
0.005,17,2,230,1,68,0.0,40.0,40.0,1,162,0.0,134.0,134.0
0.015,6,14,3787,7,497,2.0,125.0,125.0,7,3290,2.0,1448.0,972.0
0.012,6,10,1972,5,910,3.0,642.0,642.0,5,1062,2.0,794.0,794.0
0.016,6,10,1972,5,910,4.0,642.0,642.0,5,1062,4.0,794.0,794.0
0.137,6,10,1506,5,395,32.0,127.0,127.0,5,1111,30.0,843.0,843.0
0.006,6,10,1854,5,889,1.0,621.0,621.0,5,965,1.0,697.0,697.0
353.327,6,20,2210,6,1308,12004.0,494.0,494.0,14,902,27178.0,83.0,83.0
0.01,6,10,1990,5,911,2.0,643.0,643.0,5,1079,2.0,811.0,811.0
11.106,17,28,4424,14,1995,842.0,270.0,114.0,14,2429,842.0,588.0,145.0
0.092,6,10,1506,5,395,20.0,127.0,127.0,5,1111,19.0,843.0,843.0
0.039,6,10,1990,5,911,9.0,643.0,643.0,5,1079,9.0,811.0,811.0
11.449,17,28,4389,14,2311,868.0,586.0,137.0,14,2078,868.0,269.0,120.0
0.106,6,10,1506,5,395,24.0,127.0,127.0,5,1111,26.0,843.0,843.0
240.454,6,32,13733,15,7062,17175.0,1690.0,1047.0,17,6671,15028.0,1657.0,722.0
0.123,6,10,1506,5,395,28.0,127.0,127.0,5,1111,29.0,843.0,843.0
1769.134,17,92,8096,46,4048,39313.0,60.0,60.0,46,4048,39313.0,60.0,60.0
0.007,6,10,2007,5,928,1.0,660.0,660.0,5,1079,1.0,811.0,811.0
0.013,6,10,1631,5,848,3.0,580.0,580.0,5,783,3.0,515.0,515.0
0.007,6,10,1989,5,910,1.0,642.0,642.0,5,1079,1.0,811.0,811.0
0.009,6,10,1990,5,911,2.0,643.0,643.0,5,1079,2.0,811.0,811.0
0.009,6,10,1983,5,910,2.0,642.0,642.0,5,1073,2.0,805.0,805.0
0.131,6,10,1506,5,395,29.0,127.0,127.0,5,1111,21.0,843.0,843.0
0.003,17,2,136,1,60,0.0,32.0,32.0,1,76,0.0,48.0,48.0
0.006,6,10,1989,5,927,1.0,659.0,659.0,5,1062,1.0,794.0,794.0
0.006,6,10,1547,5,764,1.0,496.0,496.0,5,783,1.0,515.0,515.0
0.009,6,10,1972,5,910,2.0,642.0,642.0,5,1062,2.0,794.0,794.0
0.005,6,10,1989,5,927,1.0,659.0,659.0,5,1062,1.0,794.0,794.0
0.04,17,2,148,1,60,0.0,32.0,32.0,1,88,0.0,60.0,60.0
0.013,17,2,225,1,65,0.0,37.0,37.0,1,160,0.0,132.0,132.0
40.06,17,10,676,5,460,10014.0,104.0,64.0,5,216,10014.0,20.0,15.0
0.009,6,10,1989,5,910,2.0,642.0,642.0,5,1079,2.0,811.0,811.0
0.007,6,10,1547,5,764,1.0,496.0,496.0,5,783,1.0,515.0,515.0
0.006,6,10,1547,5,764,1.0,496.0,496.0,5,783,1.0,515.0,515.0
0.001,17,2,180,1,66,0.0,38.0,38.0,1,114,0.0,86.0,86.0
0.005,6,10,1989,5,927,1.0,659.0,659.0,5,1062,1.0,794.0,794.0
0.006,17,2,148,1,60,0.0,32.0,32.0,1,88,0.0,60.0,60.0
0.005,17,4,284,2,120,0.0,32.0,32.0,2,164,1.0,60.0,54.0
0.007,6,10,1547,5,764,1.0,496.0,496.0,5,783,1.0,515.0,515.0
0.005,6,10,2006,5,927,1.0,659.0,659.0,5,1079,1.0,811.0,811.0
291.629,6,413,349268,206,22277,1422.0,2736.0,825.0,207,326991,1415.0,4127.0,1629.0
308.363,17,20,1124,10,716,34249.0,48.0,43.0,10,408,34249.0,20.0,12.0
0.004,6,10,1989,5,927,1.0,659.0,659.0,5,1062,1.0,794.0,794.0
0.008,6,10,1631,5,848,2.0,580.0,580.0,5,783,2.0,515.0,515.0
0.02,6,10,1990,5,911,5.0,643.0,643.0,5,1079,4.0,811.0,811.0
0.012,6,10,1990,5,911,3.0,643.0,643.0,5,1079,2.0,811.0,811.0
0.072,6,10,1506,5,395,17.0,127.0,127.0,5,1111,15.0,843.0,843.0
167.16,17,74,10574,37,2471,4643.0,44.0,38.0,37,8103,4643.0,260.0,191.0
0.005,6,10,1779,5,928,1.0,660.0,660.0,5,851,1.0,583.0,583.0
0.041,17,2,184,1,61,0.0,33.0,33.0,1,123,0.0,95.0,95.0
0.06,17,2,80,1,32,0.0,4.0,4.0,1,48,0.0,20.0,20.0
0.001,17,2,180,1,66,0.0,38.0,38.0,1,114,0.0,86.0,86.0
361.891,6,21,1793,16,1030,24126.0,190.0,190.0,5,763,60010.0,462.0,247.0
0.213,6,16,2777,8,1395,30.0,533.0,323.0,8,1382,19.0,529.0,239.0
0.01,6,10,1989,5,910,2.0,642.0,642.0,5,1079,2.0,811.0,811.0
0.092,6,10,1506,5,395,18.0,127.0,127.0,5,1111,21.0,843.0,843.0
165.388,17,74,10597,37,2460,4593.0,44.0,38.0,37,8137,4594.0,239.0,191.0
0.156,6,10,1506,5,395,36.0,127.0,127.0,5,1111,29.0,843.0,843.0
0.009,6,12,1926,6,1189,1.0,659.0,434.0,6,737,1.0,417.0,417.0
0.001,17,2,140,1,62,0.0,34.0,34.0,1,78,0.0,50.0,50.0
0.004,6,10,1989,5,927,1.0,659.0,659.0,5,1062,1.0,794.0,794.0
0.075,6,10,1506,5,395,16.0,127.0,127.0,5,1111,17.0,843.0,843.0
0.085,6,10,1506,5,395,18.0,127.0,127.0,5,1111,16.0,843.0,843.0
0.004,6,10,2006,5,927,1.0,659.0,659.0,5,1079,1.0,811.0,811.0
0.006,17,2,170,1,65,0.0,37.0,37.0,1,105,0.0,77.0,77.0
0.005,6,10,2006,5,927,1.0,659.0,659.0,5,1079,1.0,811.0,811.0
0.004,6,10,2000,5,927,1.0,659.0,659.0,5,1073,1.0,805.0,805.0
0.077,6,10,1506,5,395,16.0,127.0,127.0,5,1111,17.0,843.0,843.0
0.011,6,10,1990,5,911,2.0,643.0,643.0,5,1079,2.0,811.0,811.0
0.004,17,2,136,1,60,0.0,32.0,32.0,1,76,0.0,48.0,48.0
0.083,6,10,1506,5,395,18.0,127.0,127.0,5,1111,18.0,843.0,843.0
0.006,6,10,1547,5,764,1.0,496.0,496.0,5,783,1.0,515.0,515.0
0.091,6,10,1506,5,395,20.0,127.0,127.0,5,1111,19.0,843.0,843.0
0.012,6,10,1990,5,911,3.0,643.0,643.0,5,1079,2.0,811.0,811.0
0.005,6,10,2007,5,928,1.0,660.0,660.0,5,1079,1.0,811.0,811.0
0.013,6,10,1972,5,910,3.0,642.0,642.0,5,1062,3.0,794.0,794.0
0.084,6,10,1506,5,395,18.0,127.0,127.0,5,1111,19.0,843.0,843.0
353.295,6,20,2210,6,1308,12004.0,494.0,494.0,14,902,27176.0,83.0,83.0
0.005,6,14,3742,8,504,0.0,80.0,80.0,6,3238,1.0,1470.0,1459.0
0.004,17,2,148,1,60,0.0,32.0,32.0,1,88,0.0,60.0,60.0
0.068,6,10,1506,5,395,16.0,127.0,127.0,5,1111,12.0,843.0,843.0
0.004,17,4,284,2,120,0.0,32.0,32.0,2,164,1.0,60.0,54.0
0.005,6,10,2006,5,927,1.0,659.0,659.0,5,1079,1.0,811.0,811.0
0.025,6,10,1677,5,827,6.0,559.0,559.0,5,850,6.0,582.0,582.0
0.005,6,10,1989,5,927,1.0,659.0,659.0,5,1062,1.0,794.0,794.0
0.004,17,4,284,2,120,1.0,32.0,32.0,2,164,0.0,60.0,54.0
0.009,6,10,1990,5,911,2.0,643.0,643.0,5,1079,2.0,811.0,811.0
0.012,6,10,1762,5,911,2.0,643.0,643.0,5,851,3.0,583.0,583.0
0.013,6,10,1989,5,910,3.0,642.0,642.0,5,1079,3.0,811.0,811.0
351.986,6,20,2210,6,1308,12003.0,494.0,494.0,14,902,27075.0,83.0,83.0
0.005,6,10,1989,5,927,1.0,659.0,659.0,5,1062,1.0,794.0,794.0
0.005,17,2,230,1,68,0.0,40.0,40.0,1,162,0.0,134.0,134.0
0.016,6,10,1972,5,910,4.0,642.0,642.0,5,1062,3.0,794.0,794.0
0.006,17,2,214,1,75,0.0,47.0,47.0,1,139,0.0,111.0,111.0
0.006,6,10,1547,5,764,1.0,496.0,496.0,5,783,1.0,515.0,515.0
0.119,6,10,1506,5,395,27.0,127.0,127.0,5,1111,25.0,843.0,843.0
0.005,6,10,1774,5,923,1.0,655.0,655.0,5,851,1.0,583.0,583.0
0.012,17,2,136,1,60,0.0,32.0,32.0,1,76,0.0,48.0,48.0
15.07,17,15,9238,8,6902,2148.0,1350.0,834.0,7,2336,2506.0,1350.0,305.0
0.004,6,10,2006,5,927,1.0,659.0,659.0,5,1079,1.0,811.0,811.0
0.002,17,2,136,1,60,0.0,32.0,32.0,1,76,0.0,48.0,48.0
15.07,17,15,9238,8,6902,2148.0,1350.0,834.0,7,2336,2506.0,1350.0,305.0
0.008,6,10,1547,5,764,1.0,496.0,496.0,5,783,1.0,515.0,515.0
0.015,6,10,1631,5,848,3.0,580.0,580.0,5,783,3.0,515.0,515.0
0.009,6,10,1677,5,827,2.0,559.0,559.0,5,850,2.0,582.0,582.0
0.17,6,3,453,2,321,170.0,241.0,241.0,1,132,0.0,92.0,92.0
0.004,17,2,148,1,60,0.0,32.0,32.0,1,88,0.0,60.0,60.0
0.007,6,12,1698,6,863,1.0,327.0,271.0,6,835,1.0,515.0,515.0
0.006,6,10,1854,5,889,1.0,621.0,621.0,5,965,1.0,697.0,697.0
0.057,6,10,1506,5,395,12.0,127.0,127.0,5,1111,13.0,843.0,843.0
0.267,17,44,26485,26,23452,10.0,1350.0,874.0,18,3033,12.0,1350.0,140.0
0.015,6,10,1677,5,827,3.0,559.0,559.0,5,850,3.0,582.0,582.0
0.013,6,20,9974,11,704,1.0,124.0,124.0,9,9270,1.0,2896.0,1758.0
309.459,17,20,1124,10,716,34375.0,48.0,43.0,10,408,34371.0,20.0,12.0
0.006,6,13,3747,7,509,1.0,137.0,137.0,6,3238,1.0,1470.0,1459.0
0.004,6,10,1989,5,927,1.0,659.0,659.0,5,1062,1.0,794.0,794.0
0.001,17,2,180,1,66,0.0,38.0,38.0,1,114,0.0,86.0,86.0
0.053,17,2,152,1,76,0.0,48.0,48.0,1,76,0.0,48.0,48.0
240.101,6,30,9265,15,6897,17150.0,2021.0,680.0,15,2368,17149.0,580.0,197.0
0.041,6,10,1631,5,848,10.0,580.0,580.0,5,783,10.0,515.0,515.0
10.747,17,28,4423,14,1995,818.0,270.0,114.0,14,2428,818.0,587.0,145.0
0.006,6,10,1643,5,860,1.0,592.0,592.0,5,783,1.0,515.0,515.0
0.004,6,10,1989,5,927,1.0,659.0,659.0,5,1062,1.0,794.0,794.0
0.008,6,10,2006,5,927,1.0,659.0,659.0,5,1079,2.0,811.0,811.0
0.042,17,2,144,1,64,0.0,36.0,36.0,1,80,0.0,52.0,52.0
0.009,6,10,1989,5,910,2.0,642.0,642.0,5,1079,2.0,811.0,811.0
0.005,6,10,2006,5,927,1.0,659.0,659.0,5,1079,1.0,811.0,811.0
0.008,6,10,1989,5,910,1.0,642.0,642.0,5,1079,2.0,811.0,811.0
40.078,17,10,676,5,460,10016.0,104.0,64.0,5,216,10018.0,20.0,15.0
0.009,6,10,1972,5,910,2.0,642.0,642.0,5,1062,2.0,794.0,794.0
0.096,6,10,1506,5,395,20.0,127.0,127.0,5,1111,19.0,843.0,843.0
0.004,17,4,284,2,120,0.0,32.0,32.0,2,164,0.0,60.0,54.0
0.013,6,10,1631,5,848,3.0,580.0,580.0,5,783,3.0,515.0,515.0
354.031,6,21,1795,16,1030,23602.0,190.0,190.0,5,765,60003.0,464.0,248.0
15.072,17,14,9191,8,6902,2149.0,1350.0,834.0,6,2289,3008.0,1350.0,353.0
0.005,6,10,2000,5,927,1.0,659.0,659.0,5,1073,1.0,805.0,805.0
0.041,17,4,284,2,120,0.0,32.0,32.0,2,164,37.0,60.0,54.0
0.006,6,10,2006,5,927,1.0,659.0,659.0,5,1079,1.0,811.0,811.0
40.053,17,10,676,5,460,10012.0,104.0,64.0,5,216,10012.0,20.0,15.0
0.001,17,2,180,1,66,0.0,38.0,38.0,1,114,0.0,86.0,86.0
0.0,17,2,142,1,63,0.0,35.0,35.0,1,79,0.0,51.0,51.0
0.073,6,10,1506,5,395,15.0,127.0,127.0,5,1111,16.0,843.0,843.0
308.602,17,18,1036,10,716,34276.0,48.0,43.0,8,320,43599.0,12.0,12.0
0.006,6,10,1547,5,764,1.0,496.0,496.0,5,783,1.0,515.0,515.0
0.017,6,10,1989,5,910,4.0,642.0,642.0,5,1079,4.0,811.0,811.0
0.137,6,10,1506,5,395,19.0,127.0,127.0,5,1111,32.0,843.0,843.0
0.086,6,10,1506,5,395,16.0,127.0,127.0,5,1111,18.0,843.0,843.0
300.019,6,12,1782,7,1348,50003.0,494.0,494.0,5,434,75004.0,83.0,83.0
0.005,6,10,2006,5,927,1.0,659.0,659.0,5,1079,1.0,811.0,811.0
0.004,6,10,2007,5,928,1.0,660.0,660.0,5,1079,1.0,811.0,811.0
0.007,17,2,179,1,71,0.0,43.0,43.0,1,108,0.0,80.0,80.0
0.182,17,2,152,1,76,0.0,48.0,48.0,1,76,0.0,48.0,48.0
0.025,6,10,1972,5,910,6.0,642.0,642.0,5,1062,6.0,794.0,794.0
0.066,6,10,1506,5,395,15.0,127.0,127.0,5,1111,14.0,843.0,843.0
0.014,6,10,1990,5,911,3.0,643.0,643.0,5,1079,3.0,811.0,811.0
0.003,17,2,148,1,60,0.0,32.0,32.0,1,88,0.0,60.0,60.0
0.007,6,10,1989,5,927,1.0,659.0,659.0,5,1062,1.0,794.0,794.0
0.013,6,10,1990,5,911,3.0,643.0,643.0,5,1079,3.0,811.0,811.0
0.226,6,16,2669,8,1395,32.0,533.0,323.0,8,1274,20.0,529.0,212.0
0.108,6,10,1506,5,395,26.0,127.0,127.0,5,1111,26.0,843.0,843.0
0.004,6,10,2006,5,927,1.0,659.0,659.0,5,1079,1.0,811.0,811.0
0.005,6,13,3747,7,509,0.0,137.0,137.0,6,3238,0.0,1470.0,1459.0
0.009,6,10,1972,5,910,2.0,642.0,642.0,5,1062,2.0,794.0,794.0
308.621,17,20,1124,10,716,34276.0,48.0,43.0,10,408,34276.0,20.0,12.0
0.015,6,10,1677,5,827,3.0,559.0,559.0,5,850,3.0,582.0,582.0
0.145,6,10,1506,5,395,33.0,127.0,127.0,5,1111,33.0,843.0,843.0
0.132,6,10,1506,5,395,31.0,127.0,127.0,5,1111,27.0,843.0,843.0
179.031,17,68,9774,34,2267,5425.0,44.0,38.0,34,7507,5425.0,239.0,192.0
0.005,6,10,2000,5,927,1.0,659.0,659.0,5,1073,1.0,805.0,805.0
0.01,6,10,1989,5,910,2.0,642.0,642.0,5,1079,2.0,811.0,811.0
0.075,6,10,1506,5,395,17.0,127.0,127.0,5,1111,16.0,843.0,843.0
40.066,17,10,676,5,460,10015.0,104.0,64.0,5,216,10015.0,20.0,15.0
0.011,6,10,1989,5,910,2.0,642.0,642.0,5,1079,2.0,811.0,811.0
0.007,17,2,194,1,59,0.0,31.0,31.0,1,135,0.0,107.0,107.0
0.04,6,10,1990,5,911,9.0,643.0,643.0,5,1079,9.0,811.0,811.0
0.091,6,10,1506,5,395,20.0,127.0,127.0,5,1111,19.0,843.0,843.0
0.121,6,10,1506,5,395,27.0,127.0,127.0,5,1111,28.0,843.0,843.0
0.007,6,10,1989,5,927,1.0,659.0,659.0,5,1062,1.0,794.0,794.0
40.055,17,10,676,5,460,10012.0,104.0,64.0,5,216,10012.0,20.0,15.0
10.91,17,28,4419,14,1994,830.0,269.0,114.0,14,2425,830.0,588.0,145.0
0.068,17,8,3613,4,1874,22.0,1350.0,440.0,4,1739,12.0,1350.0,406.0
0.044,17,2,152,1,76,0.0,48.0,48.0,1,76,0.0,48.0,48.0
0.017,6,10,1989,5,910,4.0,642.0,642.0,5,1079,4.0,811.0,811.0
0.008,6,10,1643,5,860,2.0,592.0,592.0,5,783,1.0,515.0,515.0
0.008,6,10,1990,5,911,2.0,643.0,643.0,5,1079,2.0,811.0,811.0
0.078,6,10,1506,5,395,17.0,127.0,127.0,5,1111,17.0,843.0,843.0
0.001,17,2,154,1,69,0.0,41.0,41.0,1,85,0.0,57.0,57.0
0.019,6,10,1989,5,910,4.0,642.0,642.0,5,1079,4.0,811.0,811.0
0.016,6,10,1989,5,910,3.0,642.0,642.0,5,1079,3.0,811.0,811.0
0.005,6,10,1643,5,860,1.0,592.0,592.0,5,783,1.0,515.0,515.0
246.438,6,38,9696,16,6544,16429.0,1618.0,635.0,22,3152,11735.0,580.0,153.0
0.005,6,10,2006,5,927,1.0,659.0,659.0,5,1079,1.0,811.0,811.0
30.055,6,10,1210,6,494,6011.0,174.0,174.0,4,716,10005.0,500.0,500.0
40.079,17,10,676,5,460,10016.0,104.0,64.0,5,216,10018.0,20.0,15.0
0.001,17,2,180,1,66,0.0,38.0,38.0,1,114,0.0,86.0,86.0
0.005,6,10,1547,5,764,1.0,496.0,496.0,5,783,1.0,515.0,515.0
0.006,6,10,1547,5,764,1.0,496.0,496.0,5,783,1.0,515.0,515.0
0.005,6,10,2006,5,927,1.0,659.0,659.0,5,1079,1.0,811.0,811.0
0.066,17,8,3613,4,1874,22.0,1350.0,440.0,4,1739,11.0,1350.0,406.0
10.929,17,28,4422,14,1993,831.0,268.0,114.0,14,2429,831.0,588.0,145.0
10.944,17,28,4395,14,2313,833.0,588.0,137.0,14,2082,833.0,269.0,120.0
0.168,17,2,152,1,76,0.0,48.0,48.0,1,76,0.0,48.0,48.0
0.004,6,10,1989,5,927,1.0,659.0,659.0,5,1062,1.0,794.0,794.0
0.006,6,10,1547,5,764,1.0,496.0,496.0,5,783,1.0,515.0,515.0
0.004,6,10,1702,5,863,1.0,595.0,595.0,5,839,0.0,571.0,571.0
0.069,6,10,1506,5,395,16.0,127.0,127.0,5,1111,15.0,843.0,843.0
0.012,6,10,1631,5,848,3.0,580.0,580.0,5,783,2.0,515.0,515.0
0.007,17,2,179,1,71,0.0,43.0,43.0,1,108,0.0,80.0,80.0
0.01,6,10,1989,5,910,2.0,642.0,642.0,5,1079,2.0,811.0,811.0
0.005,6,10,2006,5,927,1.0,659.0,659.0,5,1079,1.0,811.0,811.0
0.221,6,16,2777,8,1395,31.0,533.0,323.0,8,1382,21.0,529.0,239.0
0.006,17,2,170,1,65,0.0,37.0,37.0,1,105,0.0,77.0,77.0
0.044,17,2,152,1,76,0.0,48.0,48.0,1,76,0.0,48.0,48.0
0.006,6,10,2007,5,928,1.0,660.0,660.0,5,1079,1.0,811.0,811.0
0.007,6,10,1547,5,764,1.0,496.0,496.0,5,783,1.0,515.0,515.0
0.075,6,10,1506,5,395,15.0,127.0,127.0,5,1111,17.0,843.0,843.0
15.32,17,18,9610,8,4368,2184.0,1350.0,518.0,10,5242,1698.0,1350.0,496.0
0.005,6,10,1989,5,927,1.0,659.0,659.0,5,1062,1.0,794.0,794.0
300.854,6,38,10193,21,4715,15042.0,1360.0,640.0,17,5478,542.0,2667.0,435.0
9.038,17,6,376,5,280,2259.0,28.0,28.0,1,96,0.0,68.0,68.0
0.006,6,10,1689,5,839,1.0,571.0,571.0,5,850,1.0,582.0,582.0
0.012,6,10,1990,5,911,3.0,643.0,643.0,5,1079,2.0,811.0,811.0
0.089,6,10,1506,5,395,19.0,127.0,127.0,5,1111,21.0,843.0,843.0
0.001,17,2,136,1,60,0.0,32.0,32.0,1,76,0.0,48.0,48.0
0.005,6,10,1854,5,889,1.0,621.0,621.0,5,965,1.0,697.0,697.0
0.012,6,10,1972,5,910,2.0,642.0,642.0,5,1062,2.0,794.0,794.0
0.004,6,10,2006,5,927,1.0,659.0,659.0,5,1079,1.0,811.0,811.0
0.005,6,10,2006,5,927,1.0,659.0,659.0,5,1079,1.0,811.0,811.0
301.181,6,53,21502,28,15475,11154.0,4080.0,1193.0,25,6027,376.0,2667.0,385.0
0.003,17,2,136,1,60,0.0,32.0,32.0,1,76,0.0,48.0,48.0
0.01,6,14,3787,7,497,1.0,125.0,125.0,7,3290,1.0,1448.0,972.0
0.006,6,10,2006,5,927,1.0,659.0,659.0,5,1079,1.0,811.0,811.0
0.004,6,10,2007,5,928,1.0,660.0,660.0,5,1079,1.0,811.0,811.0
0.004,17,4,284,2,120,0.0,32.0,32.0,2,164,0.0,60.0,54.0
0.007,17,2,225,1,65,0.0,37.0,37.0,1,160,0.0,132.0,132.0
0.005,6,10,1854,5,889,1.0,621.0,621.0,5,965,1.0,697.0,697.0
0.011,6,10,1972,5,910,2.0,642.0,642.0,5,1062,2.0,794.0,794.0
0.016,17,2,198,1,91,0.0,63.0,63.0,1,107,0.0,79.0,79.0
40.07,17,10,676,5,460,10016.0,104.0,64.0,5,216,10016.0,20.0,15.0
0.005,6,10,2007,5,928,1.0,660.0,660.0,5,1079,1.0,811.0,811.0
0.005,17,2,180,1,58,0.0,30.0,30.0,1,122,0.0,94.0,94.0
11.174,17,28,4419,14,1994,846.0,269.0,114.0,14,2425,846.0,588.0,145.0
0.005,6,10,1854,5,889,1.0,621.0,621.0,5,965,1.0,697.0,697.0
0.01,6,10,1990,5,911,2.0,643.0,643.0,5,1079,2.0,811.0,811.0
0.011,6,10,1989,5,910,2.0,642.0,642.0,5,1079,2.0,811.0,811.0
0.014,6,12,1926,6,1189,2.0,659.0,434.0,6,737,2.0,417.0,417.0
0.005,6,10,1689,5,839,1.0,571.0,571.0,5,850,1.0,582.0,582.0
0.016,6,10,1990,5,911,3.0,643.0,643.0,5,1079,4.0,811.0,811.0
0.001,17,2,142,1,63,0.0,35.0,35.0,1,79,0.0,51.0,51.0
0.004,6,10,2006,5,927,1.0,659.0,659.0,5,1079,1.0,811.0,811.0
308.74,17,20,1124,10,716,34289.0,48.0,43.0,10,408,34289.0,20.0,12.0
0.014,6,10,1972,5,910,3.0,642.0,642.0,5,1062,3.0,794.0,794.0
0.005,6,10,1989,5,927,1.0,659.0,659.0,5,1062,1.0,794.0,794.0
351.987,6,20,2210,6,1308,12003.0,494.0,494.0,14,902,27075.0,83.0,83.0
0.012,6,10,1989,5,910,2.0,642.0,642.0,5,1079,2.0,811.0,811.0
0.011,6,10,1983,5,910,2.0,642.0,642.0,5,1073,2.0,805.0,805.0
467.868,6,28,6858,15,3792,33416.0,676.0,429.0,13,3066,38985.0,821.0,478.0
1792.585,6,288,27194,144,9928,12535.0,747.0,270.0,144,17266,12535.0,1625.0,71.0
0.004,6,10,1989,5,927,1.0,659.0,659.0,5,1062,1.0,794.0,794.0
0.016,6,10,1631,5,848,4.0,580.0,580.0,5,783,4.0,515.0,515.0
0.085,6,10,1506,5,395,20.0,127.0,127.0,5,1111,18.0,843.0,843.0
0.004,17,2,136,1,60,0.0,32.0,32.0,1,76,0.0,48.0,48.0
300.764,6,37,9597,20,4119,15829.0,1543.0,657.0,17,5478,537.0,2667.0,435.0
0.003,17,4,284,2,120,0.0,32.0,32.0,2,164,0.0,60.0,54.0
0.113,6,10,1506,5,395,27.0,127.0,127.0,5,1111,23.0,843.0,843.0
0.011,6,10,1989,5,910,2.0,642.0,642.0,5,1079,2.0,811.0,811.0
0.003,17,2,148,1,60,0.0,32.0,32.0,1,88,0.0,60.0,60.0
259.482,6,38,9644,15,6728,18534.0,1853.0,661.0,23,2916,11794.0,580.0,122.0
0.003,17,2,136,1,60,0.0,32.0,32.0,1,76,0.0,48.0,48.0
0.036,17,4,420,2,122,0.0,33.0,33.0,2,298,33.0,145.0,121.0
0.003,17,2,148,1,60,0.0,32.0,32.0,1,88,0.0,60.0,60.0
177.591,17,68,9689,34,2257,5381.0,44.0,38.0,34,7432,5381.0,261.0,190.0
0.005,17,2,230,1,68,0.0,40.0,40.0,1,162,0.0,134.0,134.0
0.009,6,13,3735,7,497,1.0,125.0,125.0,6,3238,1.0,1470.0,1459.0
0.15,6,10,1506,5,395,33.0,127.0,127.0,5,1111,28.0,843.0,843.0
0.097,6,10,1506,5,395,15.0,127.0,127.0,5,1111,22.0,843.0,843.0
0.083,6,10,1506,5,395,20.0,127.0,127.0,5,1111,17.0,843.0,843.0
0.256,17,44,27818,26,24778,10.0,1350.0,925.0,18,3040,11.0,1350.0,140.0
9.038,17,6,376,5,280,2259.0,28.0,28.0,1,96,0.0,68.0,68.0
0.01,6,10,1990,5,911,2.0,643.0,643.0,5,1079,2.0,811.0,811.0
240.097,6,32,9534,16,6937,16006.0,2009.0,678.0,16,2597,16006.0,580.0,219.0
0.106,6,10,1506,5,395,23.0,127.0,127.0,5,1111,20.0,843.0,843.0
0.015,6,10,1972,5,910,3.0,642.0,642.0,5,1062,3.0,794.0,794.0
0.012,6,10,1972,5,910,2.0,642.0,642.0,5,1062,2.0,794.0,794.0
300.341,6,16,2170,9,684,37522.0,146.0,146.0,7,1486,50029.0,419.0,398.0
240.036,6,9,787,5,488,60009.0,232.0,232.0,4,299,80007.0,83.0,83.0
0.001,17,2,180,1,66,0.0,38.0,38.0,1,114,0.0,86.0,86.0
0.017,6,10,1677,5,827,4.0,559.0,559.0,5,850,4.0,582.0,582.0
0.004,6,10,2007,5,928,1.0,660.0,660.0,5,1079,1.0,811.0,811.0
40.052,17,10,676,5,460,10012.0,104.0,64.0,5,216,10012.0,20.0,15.0
0.012,6,10,1983,5,910,3.0,642.0,642.0,5,1073,3.0,805.0,805.0
0.005,6,10,1547,5,764,1.0,496.0,496.0,5,783,1.0,515.0,515.0
0.1,6,10,1506,5,395,16.0,127.0,127.0,5,1111,22.0,843.0,843.0
0.039,17,2,234,1,61,0.0,33.0,33.0,1,173,0.0,145.0,145.0
0.15,17,4,284,2,120,0.0,32.0,32.0,2,164,116.0,60.0,54.0
0.011,6,10,1990,5,911,2.0,643.0,643.0,5,1079,2.0,811.0,811.0
0.005,6,10,1989,5,927,1.0,659.0,659.0,5,1062,1.0,794.0,794.0
0.006,6,10,1643,5,860,1.0,592.0,592.0,5,783,1.0,515.0,515.0
0.081,6,10,1506,5,395,16.0,127.0,127.0,5,1111,16.0,843.0,843.0
0.106,6,10,1506,5,395,26.0,127.0,127.0,5,1111,24.0,843.0,843.0
0.093,6,10,1506,5,395,21.0,127.0,127.0,5,1111,21.0,843.0,843.0
0.005,17,2,140,1,62,0.0,34.0,34.0,1,78,0.0,50.0,50.0
0.13,17,4,364,2,160,0.0,52.0,52.0,2,204,88.0,80.0,74.0
0.091,6,10,1506,5,395,20.0,127.0,127.0,5,1111,20.0,843.0,843.0
0.084,6,10,1506,5,395,17.0,127.0,127.0,5,1111,19.0,843.0,843.0
0.016,6,10,1677,5,827,4.0,559.0,559.0,5,850,3.0,582.0,582.0
0.014,6,10,1972,5,910,3.0,642.0,642.0,5,1062,3.0,794.0,794.0
0.01,6,10,1854,5,889,2.0,621.0,621.0,5,965,2.0,697.0,697.0
0.001,17,2,180,1,66,0.0,38.0,38.0,1,114,0.0,86.0,86.0
309.178,17,20,1124,10,716,34338.0,48.0,43.0,10,408,34338.0,20.0,12.0
0.009,6,10,1983,5,910,2.0,642.0,642.0,5,1073,2.0,805.0,805.0
178.243,17,76,10910,38,2550,4817.0,44.0,39.0,38,8360,4817.0,239.0,192.0
0.005,6,10,1702,5,863,1.0,595.0,595.0,5,839,1.0,571.0,571.0
0.019,6,13,3735,7,497,3.0,125.0,125.0,6,3238,3.0,1470.0,1459.0
0.005,17,2,170,1,65,0.0,37.0,37.0,1,105,0.0,77.0,77.0
0.005,17,2,230,1,68,0.0,40.0,40.0,1,162,0.0,134.0,134.0
0.017,6,10,1972,5,910,4.0,642.0,642.0,5,1062,4.0,794.0,794.0
0.005,6,10,2006,5,927,1.0,659.0,659.0,5,1079,1.0,811.0,811.0
0.005,6,10,1547,5,764,1.0,496.0,496.0,5,783,1.0,515.0,515.0
0.006,6,10,1854,5,889,1.0,621.0,621.0,5,965,1.0,697.0,697.0
0.004,6,10,1989,5,927,1.0,659.0,659.0,5,1062,1.0,794.0,794.0
0.014,6,10,1990,5,911,3.0,643.0,643.0,5,1079,3.0,811.0,811.0
0.005,6,10,2007,5,928,1.0,660.0,660.0,5,1079,1.0,811.0,811.0
240.146,6,50,7518,24,3366,10441.0,588.0,211.0,26,4152,9605.0,580.0,232.0
166.118,17,76,10771,38,2531,4489.0,44.0,38.0,38,8240,4489.0,260.0,188.0
0.001,17,2,180,1,66,0.0,38.0,38.0,1,114,0.0,86.0,86.0
173.061,17,106,15075,53,3613,3328.0,44.0,40.0,53,11462,3328.0,239.0,188.0
0.012,6,10,1989,5,910,3.0,642.0,642.0,5,1079,2.0,811.0,811.0
0.004,17,2,136,1,60,0.0,32.0,32.0,1,76,0.0,48.0,48.0
0.005,6,10,2007,5,928,1.0,660.0,660.0,5,1079,1.0,811.0,811.0
0.093,6,10,1506,5,395,18.0,127.0,127.0,5,1111,22.0,843.0,843.0
0.013,6,10,1990,5,911,3.0,643.0,643.0,5,1079,3.0,811.0,811.0
0.006,6,10,1547,5,764,1.0,496.0,496.0,5,783,1.0,515.0,515.0
0.034,6,10,1989,5,910,8.0,642.0,642.0,5,1079,8.0,811.0,811.0
0.004,6,10,2006,5,927,1.0,659.0,659.0,5,1079,1.0,811.0,811.0
0.039,17,2,148,1,60,0.0,32.0,32.0,1,88,0.0,60.0,60.0
0.005,6,10,2007,5,928,1.0,660.0,660.0,5,1079,1.0,811.0,811.0
0.005,6,10,2000,5,927,1.0,659.0,659.0,5,1073,1.0,805.0,805.0
10.808,17,28,4422,14,1993,822.0,268.0,114.0,14,2429,822.0,588.0,145.0
0.004,17,2,214,1,75,0.0,47.0,47.0,1,139,0.0,111.0,111.0
0.006,6,10,1854,5,889,1.0,621.0,621.0,5,965,1.0,697.0,697.0
0.001,17,2,180,1,66,0.0,38.0,38.0,1,114,0.0,86.0,86.0
40.051,17,10,676,5,460,10012.0,104.0,64.0,5,216,10012.0,20.0,15.0
0.005,6,10,2006,5,927,1.0,659.0,659.0,5,1079,1.0,811.0,811.0
0.005,6,10,2000,5,927,1.0,659.0,659.0,5,1073,1.0,805.0,805.0
0.005,6,10,2006,5,927,1.0,659.0,659.0,5,1079,1.0,811.0,811.0
0.005,6,13,3747,7,509,0.0,137.0,137.0,6,3238,1.0,1470.0,1459.0
0.004,6,10,2000,5,927,1.0,659.0,659.0,5,1073,1.0,805.0,805.0
0.012,6,10,1983,5,910,3.0,642.0,642.0,5,1073,3.0,805.0,805.0
240.202,6,26,11477,13,5247,20016.0,1368.0,915.0,13,6230,20016.0,1657.0,924.0
0.014,6,10,1972,5,910,3.0,642.0,642.0,5,1062,3.0,794.0,794.0
246.461,6,37,9978,15,6772,17604.0,1895.0,666.0,22,3206,11736.0,580.0,158.0
0.01,6,10,1631,5,848,2.0,580.0,580.0,5,783,2.0,515.0,515.0
0.127,6,10,1506,5,395,30.0,127.0,127.0,5,1111,25.0,843.0,843.0
0.14,6,10,1506,5,395,33.0,127.0,127.0,5,1111,16.0,843.0,843.0
0.111,6,10,1506,5,395,23.0,127.0,127.0,5,1111,24.0,843.0,843.0
289.156,6,311,343859,130,18313,2241.0,2736.0,889.0,181,325546,1606.0,2804.0,1892.0
0.087,6,10,1506,5,395,19.0,127.0,127.0,5,1111,18.0,843.0,843.0
0.004,6,10,2006,5,927,1.0,659.0,659.0,5,1079,1.0,811.0,811.0
369.913,6,22,2313,16,867,24660.0,195.0,195.0,6,1446,4639.0,419.0,398.0
1799.945,6,138,6704,77,3704,23683.0,39.0,39.0,61,3000,29995.0,35.0,35.0
0.095,6,10,1506,5,395,20.0,127.0,127.0,5,1111,21.0,843.0,843.0
0.021,6,10,1990,5,911,5.0,643.0,643.0,5,1079,5.0,811.0,811.0
0.005,17,2,148,1,60,0.0,32.0,32.0,1,88,0.0,60.0,60.0
0.014,6,10,1972,5,910,3.0,642.0,642.0,5,1062,3.0,794.0,794.0
0.007,6,10,1547,5,764,1.0,496.0,496.0,5,783,1.0,515.0,515.0
40.056,17,10,676,5,460,10013.0,104.0,64.0,5,216,10013.0,20.0,15.0
300.35,6,16,2170,9,684,37522.0,146.0,146.0,7,1486,50030.0,419.0,398.0
0.166,17,2,152,1,76,0.0,48.0,48.0,1,76,0.0,48.0,48.0
0.008,6,10,1972,5,910,2.0,642.0,642.0,5,1062,1.0,794.0,794.0
40.067,17,10,676,5,460,10013.0,104.0,64.0,5,216,10014.0,20.0,15.0
0.004,6,10,2000,5,927,1.0,659.0,659.0,5,1073,1.0,805.0,805.0
0.01,6,10,1990,5,911,2.0,643.0,643.0,5,1079,2.0,811.0,811.0
30.04,6,12,1317,7,546,5006.0,174.0,174.0,5,771,7508.0,476.0,251.0
0.013,6,10,1989,5,910,3.0,642.0,642.0,5,1079,3.0,811.0,811.0
0.004,17,4,284,2,120,0.0,32.0,32.0,2,164,1.0,60.0,54.0
0.008,17,2,170,1,65,0.0,37.0,37.0,1,105,0.0,77.0,77.0
0.006,6,10,2000,5,927,1.0,659.0,659.0,5,1073,1.0,805.0,805.0
0.007,6,10,1989,5,910,1.0,642.0,642.0,5,1079,1.0,811.0,811.0
0.008,6,10,1631,5,848,2.0,580.0,580.0,5,783,2.0,515.0,515.0
1797.224,6,64,7344,42,4469,43834.0,1625.0,108.0,22,2875,85574.0,1111.0,82.0
1795.805,6,244,35804,152,26032,11892.0,302.0,302.0,92,9772,19734.0,83.0,83.0
10.809,17,28,4420,14,1995,822.0,270.0,114.0,14,2425,822.0,588.0,145.0
40.073,17,10,676,5,460,10017.0,104.0,64.0,5,216,10017.0,20.0,15.0
0.084,6,10,1506,5,395,18.0,127.0,127.0,5,1111,18.0,843.0,843.0
0.016,6,10,1990,5,911,4.0,643.0,643.0,5,1079,4.0,811.0,811.0
0.101,6,10,1506,5,395,22.0,127.0,127.0,5,1111,22.0,843.0,843.0
0.169,17,2,152,1,76,0.0,48.0,48.0,1,76,0.0,48.0,48.0
0.011,6,10,1631,5,848,2.0,580.0,580.0,5,783,2.0,515.0,515.0
0.008,6,10,1774,5,923,2.0,655.0,655.0,5,851,1.0,583.0,583.0
0.793,6,23,8521,13,2148,66.0,1253.0,399.0,10,6373,69.0,2720.0,851.0
11.122,17,30,5338,15,2293,783.0,270.0,124.0,15,3045,783.0,1147.0,175.0
0.037,17,2,136,1,60,0.0,32.0,32.0,1,76,0.0,48.0,48.0
0.005,6,13,3747,7,509,0.0,137.0,137.0,6,3238,1.0,1470.0,1459.0
0.11,6,10,1506,5,395,26.0,127.0,127.0,5,1111,25.0,843.0,843.0
0.005,17,2,170,1,65,0.0,37.0,37.0,1,105,0.0,77.0,77.0
310.098,17,18,1008,9,640,38746.0,48.0,43.0,9,368,38746.0,20.0,12.0
0.104,6,10,1506,5,395,20.0,127.0,127.0,5,1111,22.0,843.0,843.0
0.006,6,13,3690,7,452,0.0,80.0,80.0,6,3238,1.0,1470.0,1459.0
0.005,6,10,2000,5,927,1.0,659.0,659.0,5,1073,1.0,805.0,805.0
169.446,17,82,11767,41,2734,4236.0,44.0,38.0,41,9033,4236.0,261.0,192.0
1777.763,6,301,53800,127,34325,14108.0,2720.0,295.0,174,19475,10275.0,1360.0,150.0
0.006,6,10,1854,5,889,1.0,621.0,621.0,5,965,1.0,697.0,697.0
0.013,6,10,1631,5,848,3.0,580.0,580.0,5,783,3.0,515.0,515.0
0.005,6,10,1643,5,860,1.0,592.0,592.0,5,783,1.0,515.0,515.0
0.005,6,10,2000,5,927,1.0,659.0,659.0,5,1073,1.0,805.0,805.0
0.006,17,2,230,1,68,0.0,40.0,40.0,1,162,0.0,134.0,134.0
0.102,6,10,1506,5,395,23.0,127.0,127.0,5,1111,21.0,843.0,843.0
0.02,17,2,299,1,65,0.0,37.0,37.0,1,234,0.0,206.0,206.0
0.017,6,10,2000,5,927,4.0,659.0,659.0,5,1073,4.0,805.0,805.0
0.017,6,10,1989,5,910,4.0,642.0,642.0,5,1079,4.0,811.0,811.0
40.06,17,10,676,5,460,10013.0,104.0,64.0,5,216,10014.0,20.0,15.0
10.767,17,28,4422,14,1994,819.0,269.0,114.0,14,2428,819.0,587.0,145.0
240.029,6,9,787,5,488,60007.0,232.0,232.0,4,299,80008.0,83.0,83.0
0.119,6,10,1506,5,395,27.0,127.0,127.0,5,1111,26.0,843.0,843.0
0.013,6,10,1989,5,910,3.0,642.0,642.0,5,1079,3.0,811.0,811.0
0.005,17,2,169,1,62,0.0,34.0,34.0,1,107,0.0,79.0,79.0
15.077,17,16,8601,8,6476,2149.0,1350.0,781.0,8,2125,2149.0,1350.0,237.0
0.005,6,10,1774,5,923,1.0,655.0,655.0,5,851,1.0,583.0,583.0
0.009,6,10,1989,5,910,2.0,642.0,642.0,5,1079,2.0,811.0,811.0
0.005,6,10,2006,5,927,1.0,659.0,659.0,5,1079,1.0,811.0,811.0
0.013,6,10,1631,5,848,3.0,580.0,580.0,5,783,3.0,515.0,515.0
0.009,6,10,1989,5,910,2.0,642.0,642.0,5,1079,2.0,811.0,811.0
240.068,6,21,4924,11,941,24006.0,180.0,93.0,10,3983,26673.0,1591.0,575.0
0.005,17,2,179,1,71,0.0,43.0,43.0,1,108,0.0,80.0,80.0
0.144,6,10,1506,5,395,34.0,127.0,127.0,5,1111,33.0,843.0,843.0
0.064,6,10,1506,5,395,15.0,127.0,127.0,5,1111,13.0,843.0,843.0
0.009,6,13,3747,7,509,1.0,137.0,137.0,6,3238,1.0,1470.0,1459.0
0.005,17,2,212,1,74,0.0,46.0,46.0,1,138,0.0,110.0,110.0
0.037,17,4,284,2,120,1.0,32.0,32.0,2,164,33.0,60.0,54.0
0.006,6,10,1547,5,764,1.0,496.0,496.0,5,783,1.0,515.0,515.0
0.005,6,10,2006,5,927,1.0,659.0,659.0,5,1079,1.0,811.0,811.0
0.09,6,10,1506,5,395,19.0,127.0,127.0,5,1111,21.0,843.0,843.0
0.012,6,10,1983,5,910,3.0,642.0,642.0,5,1073,3.0,805.0,805.0
0.083,6,10,1506,5,395,18.0,127.0,127.0,5,1111,18.0,843.0,843.0
0.153,6,10,1506,5,395,35.0,127.0,127.0,5,1111,36.0,843.0,843.0
0.005,6,10,2006,5,927,1.0,659.0,659.0,5,1079,1.0,811.0,811.0
0.004,6,10,2006,5,927,1.0,659.0,659.0,5,1079,1.0,811.0,811.0
0.013,6,10,1990,5,911,3.0,643.0,643.0,5,1079,3.0,811.0,811.0
0.006,6,10,2006,5,927,1.0,659.0,659.0,5,1079,1.0,811.0,811.0
0.013,6,10,1989,5,910,3.0,642.0,642.0,5,1079,3.0,811.0,811.0
240.021,6,9,787,5,488,60005.0,232.0,232.0,4,299,80006.0,83.0,83.0
0.167,6,3,453,2,321,167.0,241.0,241.0,1,132,0.0,92.0,92.0
0.004,6,10,2000,5,927,1.0,659.0,659.0,5,1073,1.0,805.0,805.0
0.006,6,10,1854,5,889,1.0,621.0,621.0,5,965,1.0,697.0,697.0
0.017,6,10,1677,5,827,4.0,559.0,559.0,5,850,4.0,582.0,582.0
1794.107,6,543,187582,269,162400,6694.0,2883.0,982.0,274,25182,6571.0,386.0,108.0
0.138,6,10,1506,5,395,33.0,127.0,127.0,5,1111,33.0,843.0,843.0
0.006,6,10,2000,5,927,1.0,659.0,659.0,5,1073,1.0,805.0,805.0
0.123,6,10,1506,5,395,26.0,127.0,127.0,5,1111,27.0,843.0,843.0
0.01,6,10,1990,5,911,2.0,643.0,643.0,5,1079,2.0,811.0,811.0
0.005,6,10,2006,5,927,1.0,659.0,659.0,5,1079,1.0,811.0,811.0
0.009,6,10,1989,5,910,2.0,642.0,642.0,5,1079,2.0,811.0,811.0
0.134,6,10,1506,5,395,28.0,127.0,127.0,5,1111,31.0,843.0,843.0
15.096,17,16,9034,8,6899,2152.0,1350.0,834.0,8,2135,2149.0,1350.0,238.0
0.016,6,10,1983,5,910,4.0,642.0,642.0,5,1073,4.0,805.0,805.0
0.005,17,2,170,1,65,0.0,37.0,37.0,1,105,0.0,77.0,77.0
0.009,6,10,1631,5,848,2.0,580.0,580.0,5,783,2.0,515.0,515.0
0.01,6,12,1926,6,1189,1.0,659.0,434.0,6,737,1.0,417.0,417.0
0.001,17,2,166,1,75,0.0,47.0,47.0,1,91,0.0,63.0,63.0
0.005,6,10,1689,5,839,1.0,571.0,571.0,5,850,1.0,582.0,582.0
0.032,17,2,214,1,75,0.0,47.0,47.0,1,139,0.0,111.0,111.0
0.043,6,10,1972,5,910,10.0,642.0,642.0,5,1062,10.0,794.0,794.0
0.069,17,8,3613,4,1874,23.0,1350.0,440.0,4,1739,10.0,1350.0,406.0
368.738,6,22,2313,16,867,24582.0,195.0,195.0,6,1446,4651.0,419.0,398.0
0.017,6,10,1989,5,910,4.0,642.0,642.0,5,1079,4.0,811.0,811.0
0.003,17,2,148,1,60,0.0,32.0,32.0,1,88,0.0,60.0,60.0
0.004,17,2,166,1,75,0.0,47.0,47.0,1,91,0.0,63.0,63.0
0.006,6,10,1547,5,764,1.0,496.0,496.0,5,783,1.0,515.0,515.0
0.006,6,10,1547,5,764,1.0,496.0,496.0,5,783,1.0,515.0,515.0
178.087,17,72,10021,36,2389,5088.0,44.0,38.0,36,7632,5088.0,252.0,184.0
0.005,17,2,160,1,72,0.0,44.0,44.0,1,88,0.0,60.0,60.0
240.012,6,9,787,5,488,60003.0,232.0,232.0,4,299,80003.0,83.0,83.0
0.08,6,10,1506,5,395,19.0,127.0,127.0,5,1111,15.0,843.0,843.0
0.008,6,10,2000,5,927,2.0,659.0,659.0,5,1073,1.0,805.0,805.0
0.021,6,10,1972,5,910,5.0,642.0,642.0,5,1062,5.0,794.0,794.0
0.017,6,10,1989,5,910,4.0,642.0,642.0,5,1079,4.0,811.0,811.0
0.005,6,10,2007,5,928,1.0,660.0,660.0,5,1079,1.0,811.0,811.0
0.004,17,2,148,1,60,0.0,32.0,32.0,1,88,0.0,60.0,60.0
0.004,17,4,284,2,120,0.0,32.0,32.0,2,164,1.0,60.0,54.0
1756.063,6,105,6270,60,3525,29763.0,27.0,27.0,45,2745,39909.0,27.0,27.0
0.018,6,10,1677,5,827,4.0,559.0,559.0,5,850,4.0,582.0,582.0
0.005,6,10,1643,5,860,1.0,592.0,592.0,5,783,1.0,515.0,515.0
300.318,6,16,2170,9,684,37517.0,146.0,146.0,7,1486,50023.0,419.0,398.0
0.005,6,10,2006,5,927,1.0,659.0,659.0,5,1079,1.0,811.0,811.0
0.024,17,2,179,1,71,0.0,43.0,43.0,1,108,0.0,80.0,80.0
0.01,6,10,1983,5,910,2.0,642.0,642.0,5,1073,2.0,805.0,805.0
0.004,6,10,2007,5,928,1.0,660.0,660.0,5,1079,1.0,811.0,811.0
285.221,6,30,6574,16,1433,19014.0,517.0,290.0,14,5141,21939.0,2379.0,1104.0
0.068,6,10,1506,5,395,14.0,127.0,127.0,5,1111,15.0,843.0,843.0
0.087,6,10,1506,5,395,19.0,127.0,127.0,5,1111,18.0,843.0,843.0
0.114,6,10,1506,5,395,24.0,127.0,127.0,5,1111,22.0,843.0,843.0
0.743,6,22,5072,11,1250,63.0,325.0,133.0,11,3822,63.0,1414.0,563.0
0.005,6,10,1689,5,839,1.0,571.0,571.0,5,850,1.0,582.0,582.0
0.079,6,10,1506,5,395,17.0,127.0,127.0,5,1111,18.0,843.0,843.0
0.014,6,10,1989,5,910,3.0,642.0,642.0,5,1079,3.0,811.0,811.0
0.004,17,2,148,1,60,0.0,32.0,32.0,1,88,0.0,60.0,60.0
0.105,6,10,1506,5,395,23.0,127.0,127.0,5,1111,25.0,843.0,843.0
40.083,17,10,676,5,460,10019.0,104.0,64.0,5,216,10020.0,20.0,15.0
0.006,17,2,170,1,65,0.0,37.0,37.0,1,105,0.0,77.0,77.0
0.012,6,10,1989,5,910,3.0,642.0,642.0,5,1079,3.0,811.0,811.0
0.006,6,10,1854,5,889,1.0,621.0,621.0,5,965,1.0,697.0,697.0
0.005,6,10,1989,5,927,1.0,659.0,659.0,5,1062,1.0,794.0,794.0
0.005,17,2,140,1,62,0.0,34.0,34.0,1,78,0.0,50.0,50.0
0.005,6,10,1854,5,889,1.0,621.0,621.0,5,965,1.0,697.0,697.0
0.124,17,2,148,1,60,0.0,32.0,32.0,1,88,0.0,60.0,60.0
0.098,6,10,1506,5,395,21.0,127.0,127.0,5,1111,22.0,843.0,843.0
0.005,6,10,2006,5,927,1.0,659.0,659.0,5,1079,1.0,811.0,811.0
0.102,6,10,1506,5,395,22.0,127.0,127.0,5,1111,24.0,843.0,843.0
0.005,6,14,3799,7,509,0.0,137.0,137.0,7,3290,0.0,1448.0,972.0
0.019,17,2,164,1,74,0.0,46.0,46.0,1,90,0.0,62.0,62.0
174.095,17,88,12136,44,2938,4048.0,44.0,38.0,44,9198,4048.0,239.0,181.0
0.132,6,26,7379,13,3253,10.0,1402.0,428.0,13,4126,9.0,1324.0,688.0
0.01,6,10,1983,5,910,2.0,642.0,642.0,5,1073,2.0,805.0,805.0
240.012,6,9,787,5,488,60003.0,232.0,232.0,4,299,80003.0,83.0,83.0
1778.489,17,143,41496,72,22752,25049.0,288.0,288.0,71,18744,25406.0,236.0,236.0
0.074,6,10,1506,5,395,14.0,127.0,127.0,5,1111,17.0,843.0,843.0
0.004,6,10,2000,5,927,1.0,659.0,659.0,5,1073,1.0,805.0,805.0
0.08,6,10,1506,5,395,17.0,127.0,127.0,5,1111,16.0,843.0,843.0
0.005,6,10,2006,5,927,1.0,659.0,659.0,5,1079,1.0,811.0,811.0
0.012,6,10,1990,5,911,2.0,643.0,643.0,5,1079,2.0,811.0,811.0
0.006,6,13,3747,7,509,1.0,137.0,137.0,6,3238,1.0,1470.0,1459.0
353.971,6,19,1691,15,978,25283.0,190.0,190.0,4,713,80002.0,497.0,497.0
0.121,6,10,1506,5,395,27.0,127.0,127.0,5,1111,26.0,843.0,843.0
0.007,6,10,2007,5,928,1.0,660.0,660.0,5,1079,1.0,811.0,811.0
0.008,6,10,1989,5,910,1.0,642.0,642.0,5,1079,2.0,811.0,811.0
0.009,6,10,1631,5,848,2.0,580.0,580.0,5,783,2.0,515.0,515.0
40.069,17,10,676,5,460,10016.0,104.0,64.0,5,216,10016.0,20.0,15.0
0.005,6,10,2007,5,928,1.0,660.0,660.0,5,1079,1.0,811.0,811.0
0.072,17,2,412,1,61,0.0,33.0,33.0,1,351,0.0,323.0,323.0
0.119,6,10,1506,5,395,28.0,127.0,127.0,5,1111,24.0,843.0,843.0
0.012,6,10,1983,5,910,3.0,642.0,642.0,5,1073,3.0,805.0,805.0
0.018,6,10,1972,5,910,4.0,642.0,642.0,5,1062,4.0,794.0,794.0
0.006,6,10,2000,5,927,1.0,659.0,659.0,5,1073,1.0,805.0,805.0
0.005,17,2,194,1,59,0.0,31.0,31.0,1,135,0.0,107.0,107.0
9.036,17,6,376,5,280,2259.0,28.0,28.0,1,96,0.0,68.0,68.0
0.005,6,10,1774,5,923,1.0,655.0,655.0,5,851,1.0,583.0,583.0
300.804,6,38,9637,21,4159,15040.0,1360.0,547.0,17,5478,543.0,2667.0,435.0
0.271,17,47,27042,26,23452,10.0,1350.0,874.0,21,3590,10.0,1350.0,142.0
15.08,17,15,9239,8,6902,2149.0,1350.0,834.0,7,2337,2508.0,1350.0,305.0
0.01,6,10,1972,5,910,2.0,642.0,642.0,5,1062,2.0,794.0,794.0
0.087,6,10,1506,5,395,19.0,127.0,127.0,5,1111,19.0,843.0,843.0
40.067,17,10,676,5,460,10015.0,104.0,64.0,5,216,10015.0,20.0,15.0
0.18,17,4,352,2,130,142.0,37.0,37.0,2,222,141.0,89.0,83.0
1757.532,6,552,189350,281,164097,6276.0,2883.0,983.0,271,25253,6509.0,388.0,111.0
0.015,6,10,1983,5,910,3.0,642.0,642.0,5,1073,3.0,805.0,805.0
0.018,6,10,1631,5,848,4.0,580.0,580.0,5,783,4.0,515.0,515.0
0.007,6,12,1698,6,863,1.0,327.0,271.0,6,835,1.0,515.0,515.0
0.001,17,2,140,1,62,0.0,34.0,34.0,1,78,0.0,50.0,50.0
11.154,17,28,4390,14,2313,849.0,588.0,137.0,14,2077,849.0,268.0,120.0
0.037,17,2,182,1,65,0.0,37.0,37.0,1,117,0.0,89.0,89.0
0.004,6,10,2006,5,927,1.0,659.0,659.0,5,1079,1.0,811.0,811.0
0.006,6,10,2007,5,928,1.0,660.0,660.0,5,1079,1.0,811.0,811.0
0.001,17,2,140,1,62,0.0,34.0,34.0,1,78,0.0,50.0,50.0
0.04,17,2,144,1,64,0.0,36.0,36.0,1,80,0.0,52.0,52.0
0.009,6,10,1631,5,848,2.0,580.0,580.0,5,783,2.0,515.0,515.0
0.005,6,13,3747,7,509,0.0,137.0,137.0,6,3238,1.0,1470.0,1459.0
0.009,6,12,1926,6,1189,1.0,659.0,434.0,6,737,1.0,417.0,417.0
40.091,17,10,676,5,460,10019.0,104.0,64.0,5,216,10022.0,20.0,15.0
0.005,6,10,1989,5,927,1.0,659.0,659.0,5,1062,1.0,794.0,794.0
0.005,6,10,2000,5,927,1.0,659.0,659.0,5,1073,1.0,805.0,805.0
178.656,17,92,13056,46,3061,3970.0,44.0,38.0,46,9995,3970.0,239.0,189.0
0.117,6,10,1506,5,395,24.0,127.0,127.0,5,1111,24.0,843.0,843.0
0.006,6,10,1547,5,764,1.0,496.0,496.0,5,783,1.0,515.0,515.0
40.072,17,10,676,5,460,10017.0,104.0,64.0,5,216,10017.0,20.0,15.0
0.006,6,10,1547,5,764,1.0,496.0,496.0,5,783,1.0,515.0,515.0
0.005,17,2,144,1,64,0.0,36.0,36.0,1,80,0.0,52.0,52.0
0.005,6,10,2006,5,927,1.0,659.0,659.0,5,1079,1.0,811.0,811.0
0.005,6,10,2006,5,927,1.0,659.0,659.0,5,1079,1.0,811.0,811.0
0.01,6,10,1983,5,910,2.0,642.0,642.0,5,1073,2.0,805.0,805.0
0.115,6,10,1506,5,395,27.0,127.0,127.0,5,1111,23.0,843.0,843.0
0.169,17,2,152,1,76,0.0,48.0,48.0,1,76,0.0,48.0,48.0
0.005,6,10,2000,5,927,1.0,659.0,659.0,5,1073,1.0,805.0,805.0
0.042,17,4,284,2,120,38.0,32.0,32.0,2,164,5.0,60.0,54.0
0.011,6,10,1990,5,911,2.0,643.0,643.0,5,1079,2.0,811.0,811.0
0.005,6,10,2000,5,927,1.0,659.0,659.0,5,1073,1.0,805.0,805.0
0.017,6,10,1990,5,911,4.0,643.0,643.0,5,1079,4.0,811.0,811.0
0.039,17,2,182,1,65,0.0,37.0,37.0,1,117,0.0,89.0,89.0
0.012,6,10,1983,5,910,2.0,642.0,642.0,5,1073,3.0,805.0,805.0
9.038,17,6,376,5,280,2259.0,28.0,28.0,1,96,0.0,68.0,68.0
40.06,17,10,676,5,460,10014.0,104.0,64.0,5,216,10014.0,20.0,15.0
0.072,17,2,170,1,65,0.0,37.0,37.0,1,105,0.0,77.0,77.0
0.005,6,10,2007,5,928,1.0,660.0,660.0,5,1079,1.0,811.0,811.0
0.006,6,10,1547,5,764,1.0,496.0,496.0,5,783,1.0,515.0,515.0
1787.247,6,150,19350,90,13740,20081.0,302.0,302.0,60,5610,30292.0,83.0,83.0
0.007,6,10,1547,5,764,1.0,496.0,496.0,5,783,1.0,515.0,515.0
40.063,17,10,676,5,460,10012.0,104.0,64.0,5,216,10014.0,20.0,15.0
0.008,6,10,1990,5,911,2.0,643.0,643.0,5,1079,2.0,811.0,811.0
0.005,6,10,1643,5,860,1.0,592.0,592.0,5,783,1.0,515.0,515.0
0.006,6,10,1547,5,764,1.0,496.0,496.0,5,783,1.0,515.0,515.0
0.003,17,2,136,1,60,0.0,32.0,32.0,1,76,0.0,48.0,48.0
0.084,6,10,1506,5,395,17.0,127.0,127.0,5,1111,20.0,843.0,843.0
0.006,6,10,1854,5,889,1.0,621.0,621.0,5,965,1.0,697.0,697.0
0.001,17,2,180,1,66,0.0,38.0,38.0,1,114,0.0,86.0,86.0
0.031,6,10,1972,5,910,7.0,642.0,642.0,5,1062,7.0,794.0,794.0
0.001,17,2,180,1,65,0.0,37.0,37.0,1,115,0.0,87.0,87.0
0.081,6,10,1506,5,395,17.0,127.0,127.0,5,1111,17.0,843.0,843.0
0.013,6,10,1990,5,911,3.0,643.0,643.0,5,1079,3.0,811.0,811.0
0.009,6,10,1983,5,910,2.0,642.0,642.0,5,1073,2.0,805.0,805.0
0.004,17,2,140,1,62,0.0,34.0,34.0,1,78,0.0,50.0,50.0
0.006,17,2,180,1,58,0.0,30.0,30.0,1,122,0.0,94.0,94.0
0.005,6,10,1989,5,927,1.0,659.0,659.0,5,1062,1.0,794.0,794.0
0.001,17,2,136,1,60,0.0,32.0,32.0,1,76,0.0,48.0,48.0
0.015,6,10,1989,5,910,3.0,642.0,642.0,5,1079,3.0,811.0,811.0
0.004,6,10,1989,5,927,1.0,659.0,659.0,5,1062,1.0,794.0,794.0
0.029,17,2,162,1,65,0.0,37.0,37.0,1,97,0.0,69.0,69.0
0.02,6,10,1972,5,910,5.0,642.0,642.0,5,1062,5.0,794.0,794.0
0.012,6,10,1983,5,910,2.0,642.0,642.0,5,1073,2.0,805.0,805.0
0.02,6,10,1983,5,910,4.0,642.0,642.0,5,1073,4.0,805.0,805.0
0.006,6,10,1689,5,839,1.0,571.0,571.0,5,850,1.0,582.0,582.0
60.251,6,36,10047,18,4529,521.0,2096.0,944.0,18,5518,3533.0,2667.0,435.0
0.016,17,2,198,1,91,0.0,63.0,63.0,1,107,0.0,79.0,79.0
0.004,17,2,166,1,75,0.0,47.0,47.0,1,91,0.0,63.0,63.0
0.011,6,10,1972,5,910,2.0,642.0,642.0,5,1062,2.0,794.0,794.0
0.012,6,14,3787,7,497,1.0,125.0,125.0,7,3290,2.0,1448.0,972.0
0.005,6,14,3799,7,509,0.0,137.0,137.0,7,3290,0.0,1448.0,972.0
0.019,6,10,1983,5,910,4.0,642.0,642.0,5,1073,4.0,805.0,805.0
0.005,6,10,1689,5,839,1.0,571.0,571.0,5,850,1.0,582.0,582.0
0.011,6,10,1983,5,910,2.0,642.0,642.0,5,1073,2.0,805.0,805.0
11.207,17,28,4423,14,1994,848.0,269.0,114.0,14,2429,849.0,588.0,145.0
1761.215,6,65,7412,43,4536,41933.0,1402.0,104.0,22,2876,83859.0,1112.0,82.0
0.005,6,10,1989,5,927,1.0,659.0,659.0,5,1062,1.0,794.0,794.0
126.277,6,21,8144,11,1985,81.0,1174.0,504.0,10,6159,14012.0,2720.0,957.0
0.113,6,10,1506,5,395,23.0,127.0,127.0,5,1111,25.0,843.0,843.0
0.006,6,10,1547,5,764,1.0,496.0,496.0,5,783,1.0,515.0,515.0
0.005,6,10,1854,5,889,1.0,621.0,621.0,5,965,1.0,697.0,697.0
0.008,6,10,1989,5,910,2.0,642.0,642.0,5,1079,1.0,811.0,811.0
0.074,6,10,1506,5,395,16.0,127.0,127.0,5,1111,16.0,843.0,843.0
0.007,6,10,1983,5,910,1.0,642.0,642.0,5,1073,1.0,805.0,805.0
0.106,6,10,1506,5,395,24.0,127.0,127.0,5,1111,23.0,843.0,843.0
0.006,6,10,2007,5,928,1.0,660.0,660.0,5,1079,1.0,811.0,811.0
0.013,6,10,1972,5,910,3.0,642.0,642.0,5,1062,3.0,794.0,794.0
0.011,6,10,1989,5,910,2.0,642.0,642.0,5,1079,2.0,811.0,811.0
0.011,6,10,1990,5,911,2.0,643.0,643.0,5,1079,2.0,811.0,811.0
0.008,6,10,1643,5,860,1.0,592.0,592.0,5,783,2.0,515.0,515.0
0.006,6,10,1774,5,923,1.0,655.0,655.0,5,851,1.0,583.0,583.0
0.008,6,10,1989,5,910,2.0,642.0,642.0,5,1079,2.0,811.0,811.0
0.012,17,2,194,1,59,0.0,31.0,31.0,1,135,0.0,107.0,107.0
0.006,6,10,2006,5,927,1.0,659.0,659.0,5,1079,1.0,811.0,811.0
0.006,17,2,170,1,65,0.0,37.0,37.0,1,105,0.0,77.0,77.0
0.013,6,10,1972,5,910,3.0,642.0,642.0,5,1062,3.0,794.0,794.0
0.073,17,2,412,1,61,0.0,33.0,33.0,1,351,0.0,323.0,323.0
354.065,6,21,1795,16,1030,23604.0,190.0,190.0,5,765,60003.0,464.0,248.0
0.004,6,10,2006,5,927,1.0,659.0,659.0,5,1079,1.0,811.0,811.0
0.004,6,10,1774,5,923,1.0,655.0,655.0,5,851,1.0,583.0,583.0
40.072,17,10,676,5,460,10015.0,104.0,64.0,5,216,10017.0,20.0,15.0
0.001,17,2,166,1,75,0.0,47.0,47.0,1,91,0.0,63.0,63.0
0.007,6,10,1547,5,764,1.0,496.0,496.0,5,783,1.0,515.0,515.0
300.799,6,45,18716,24,13078,13078.0,2720.0,1342.0,21,5638,430.0,1360.0,398.0
0.006,17,2,179,1,71,0.0,43.0,43.0,1,108,0.0,80.0,80.0
0.008,6,10,1983,5,910,2.0,642.0,642.0,5,1073,2.0,805.0,805.0
300.019,6,12,1782,7,1348,50003.0,494.0,494.0,5,434,75003.0,83.0,83.0
0.019,6,13,3735,7,497,3.0,125.0,125.0,6,3238,3.0,1470.0,1459.0
0.005,6,10,1989,5,927,1.0,659.0,659.0,5,1062,1.0,794.0,794.0
0.134,17,2,80,1,32,0.0,4.0,4.0,1,48,0.0,20.0,20.0
0.006,17,2,180,1,58,0.0,30.0,30.0,1,122,0.0,94.0,94.0
0.005,6,10,2006,5,927,1.0,659.0,659.0,5,1079,1.0,811.0,811.0
40.058,17,10,676,5,460,10013.0,104.0,64.0,5,216,10013.0,20.0,15.0
0.005,6,10,1989,5,927,1.0,659.0,659.0,5,1062,1.0,794.0,794.0
0.004,6,10,2006,5,927,1.0,659.0,659.0,5,1079,1.0,811.0,811.0
1730.399,6,45,2790,30,1725,59668.0,35.0,35.0,15,1065,123594.0,31.0,31.0
0.004,17,2,136,1,60,0.0,32.0,32.0,1,76,0.0,48.0,48.0
0.005,6,10,2007,5,928,1.0,660.0,660.0,5,1079,1.0,811.0,811.0
0.037,17,2,148,1,60,0.0,32.0,32.0,1,88,0.0,60.0,60.0
369.617,6,24,2405,17,919,23101.0,195.0,195.0,7,1486,3901.0,419.0,398.0
0.078,6,10,1506,5,395,17.0,127.0,127.0,5,1111,16.0,843.0,843.0
0.022,6,10,1972,5,910,5.0,642.0,642.0,5,1062,5.0,794.0,794.0
40.062,17,10,676,5,460,10014.0,104.0,64.0,5,216,10014.0,20.0,15.0
0.005,17,2,212,1,74,0.0,46.0,46.0,1,138,0.0,110.0,110.0
0.014,6,10,1972,5,910,3.0,642.0,642.0,5,1062,3.0,794.0,794.0
0.016,6,10,1990,5,911,4.0,643.0,643.0,5,1079,4.0,811.0,811.0
0.01,6,10,1631,5,848,2.0,580.0,580.0,5,783,2.0,515.0,515.0
40.059,17,10,676,5,460,10012.0,104.0,64.0,5,216,10013.0,20.0,15.0
1004.337,6,71,29483,37,6154,27898.0,676.0,467.0,34,23329,28616.0,1402.0,898.0
0.004,17,4,284,2,120,0.0,32.0,32.0,2,164,0.0,60.0,54.0
169.374,17,76,10835,38,2529,4577.0,44.0,38.0,38,8306,4577.0,261.0,190.0
0.012,6,10,1762,5,911,2.0,643.0,643.0,5,851,2.0,583.0,583.0
0.098,6,10,1506,5,395,16.0,127.0,127.0,5,1111,21.0,843.0,843.0
0.118,6,10,1506,5,395,23.0,127.0,127.0,5,1111,24.0,843.0,843.0
0.007,6,10,2006,5,927,1.0,659.0,659.0,5,1079,1.0,811.0,811.0
0.01,6,10,1972,5,910,2.0,642.0,642.0,5,1062,2.0,794.0,794.0
0.006,6,10,1547,5,764,1.0,496.0,496.0,5,783,1.0,515.0,515.0
0.017,6,13,3735,7,497,2.0,125.0,125.0,6,3238,3.0,1470.0,1459.0
0.01,6,10,1972,5,910,2.0,642.0,642.0,5,1062,2.0,794.0,794.0
0.005,6,10,2007,5,928,1.0,660.0,660.0,5,1079,1.0,811.0,811.0
0.09,6,10,1506,5,395,20.0,127.0,127.0,5,1111,22.0,843.0,843.0
353.599,6,20,2210,6,1308,12004.0,494.0,494.0,14,902,27199.0,83.0,83.0
10.794,17,28,4423,14,1995,821.0,270.0,114.0,14,2428,821.0,587.0,145.0
0.004,6,10,2000,5,927,1.0,659.0,659.0,5,1073,1.0,805.0,805.0
0.006,6,10,1643,5,860,1.0,592.0,592.0,5,783,1.0,515.0,515.0
0.005,6,10,1989,5,927,1.0,659.0,659.0,5,1062,1.0,794.0,794.0
0.013,6,10,1990,5,911,3.0,643.0,643.0,5,1079,3.0,811.0,811.0
0.02,6,10,1677,5,827,4.0,559.0,559.0,5,850,4.0,582.0,582.0
0.017,6,10,1762,5,911,4.0,643.0,643.0,5,851,4.0,583.0,583.0
1.114,6,31,13351,18,5892,65.0,2073.0,854.0,13,7459,77.0,2720.0,769.0
0.005,17,2,142,1,63,0.0,35.0,35.0,1,79,0.0,51.0,51.0
0.005,6,10,2006,5,927,1.0,659.0,659.0,5,1079,1.0,811.0,811.0
0.097,6,10,1506,5,395,22.0,127.0,127.0,5,1111,21.0,843.0,843.0
0.005,6,10,1547,5,764,1.0,496.0,496.0,5,783,1.0,515.0,515.0
0.005,6,10,2006,5,927,1.0,659.0,659.0,5,1079,1.0,811.0,811.0
0.082,6,10,1506,5,395,18.0,127.0,127.0,5,1111,15.0,843.0,843.0
0.014,17,2,144,1,64,0.0,36.0,36.0,1,80,0.0,52.0,52.0
0.131,6,10,1506,5,395,27.0,127.0,127.0,5,1111,29.0,843.0,843.0
361.816,6,21,1793,16,1030,24121.0,190.0,190.0,5,763,60009.0,462.0,247.0
0.105,6,10,1506,5,395,19.0,127.0,127.0,5,1111,23.0,843.0,843.0
0.015,6,10,1989,5,910,3.0,642.0,642.0,5,1079,3.0,811.0,811.0
0.005,17,2,170,1,65,0.0,37.0,37.0,1,105,0.0,77.0,77.0
0.009,6,10,1677,5,827,2.0,559.0,559.0,5,850,2.0,582.0,582.0
0.001,17,2,180,1,66,0.0,38.0,38.0,1,114,0.0,86.0,86.0
0.005,17,2,214,1,75,0.0,47.0,47.0,1,139,0.0,111.0,111.0
0.003,17,2,152,1,76,0.0,48.0,48.0,1,76,0.0,48.0,48.0
0.012,6,10,1983,5,910,2.0,642.0,642.0,5,1073,3.0,805.0,805.0
10.759,17,26,4101,13,1846,887.0,269.0,114.0,13,2255,887.0,586.0,145.0
0.109,6,10,1506,5,395,24.0,127.0,127.0,5,1111,25.0,843.0,843.0
0.061,17,2,152,1,76,0.0,48.0,48.0,1,76,0.0,48.0,48.0
0.004,17,4,284,2,120,0.0,32.0,32.0,2,164,1.0,60.0,54.0
0.015,6,13,3735,7,497,2.0,125.0,125.0,6,3238,3.0,1470.0,1459.0
0.006,6,10,1643,5,860,1.0,592.0,592.0,5,783,1.0,515.0,515.0
0.005,6,10,1779,5,928,1.0,660.0,660.0,5,851,1.0,583.0,583.0
0.006,6,10,1854,5,889,1.0,621.0,621.0,5,965,1.0,697.0,697.0
0.095,6,10,1506,5,395,19.0,127.0,127.0,5,1111,20.0,843.0,843.0
0.003,17,2,152,1,76,0.0,48.0,48.0,1,76,0.0,48.0,48.0
0.17,6,3,453,2,321,170.0,241.0,241.0,1,132,0.0,92.0,92.0
8.98,6,35,9731,18,4253,528.0,1360.0,700.0,17,5478,548.0,2667.0,435.0
175.345,17,78,10983,39,2593,4613.0,44.0,38.0,39,8390,4614.0,261.0,187.0
0.009,6,10,1989,5,910,2.0,642.0,642.0,5,1079,2.0,811.0,811.0
0.013,6,10,1983,5,910,3.0,642.0,642.0,5,1073,3.0,805.0,805.0
0.1,17,2,152,1,76,0.0,48.0,48.0,1,76,0.0,48.0,48.0
0.063,6,10,1506,5,395,14.0,127.0,127.0,5,1111,15.0,843.0,843.0
0.01,6,10,1631,5,848,2.0,580.0,580.0,5,783,2.0,515.0,515.0
0.003,17,2,148,1,60,0.0,32.0,32.0,1,88,0.0,60.0,60.0
0.013,6,10,1972,5,910,3.0,642.0,642.0,5,1062,3.0,794.0,794.0
0.038,17,2,152,1,76,0.0,48.0,48.0,1,76,0.0,48.0,48.0
0.016,6,10,1989,5,910,4.0,642.0,642.0,5,1079,4.0,811.0,811.0
40.054,17,10,676,5,460,10012.0,104.0,64.0,5,216,10012.0,20.0,15.0
0.004,17,2,148,1,60,0.0,32.0,32.0,1,88,0.0,60.0,60.0
0.012,6,10,2007,5,928,3.0,660.0,660.0,5,1079,3.0,811.0,811.0
0.079,6,10,1506,5,395,17.0,127.0,127.0,5,1111,15.0,843.0,843.0
0.004,6,10,1989,5,927,1.0,659.0,659.0,5,1062,1.0,794.0,794.0
0.006,17,2,144,1,64,0.0,36.0,36.0,1,80,0.0,52.0,52.0
240.124,6,32,9403,15,7055,17151.0,2168.0,696.0,17,2348,15007.0,580.0,182.0
0.069,6,10,1506,5,395,16.0,127.0,127.0,5,1111,14.0,843.0,843.0
0.005,6,10,2006,5,927,1.0,659.0,659.0,5,1079,1.0,811.0,811.0
0.079,6,10,1506,5,395,17.0,127.0,127.0,5,1111,19.0,843.0,843.0
0.008,17,2,166,1,75,0.0,47.0,47.0,1,91,0.0,63.0,63.0
240.107,6,30,9447,14,6909,18469.0,2084.0,687.0,16,2538,16006.0,580.0,212.0
40.052,17,10,676,5,460,10012.0,104.0,64.0,5,216,10011.0,20.0,15.0
0.006,6,10,1989,5,927,1.0,659.0,659.0,5,1062,1.0,794.0,794.0
0.005,6,10,1689,5,839,1.0,571.0,571.0,5,850,1.0,582.0,582.0
266.008,6,40,10301,16,6863,17733.0,1934.0,670.0,24,3438,11565.0,580.0,145.0
0.009,6,10,1762,5,911,2.0,643.0,643.0,5,851,2.0,583.0,583.0
10.825,17,28,4423,14,1995,823.0,270.0,114.0,14,2428,823.0,587.0,145.0
0.005,6,10,2007,5,928,1.0,660.0,660.0,5,1079,1.0,811.0,811.0
0.042,17,4,420,2,122,0.0,33.0,33.0,2,298,0.0,145.0,121.0
240.071,6,21,4924,11,941,24007.0,180.0,93.0,10,3983,26674.0,1591.0,575.0
0.015,6,10,1990,5,911,3.0,643.0,643.0,5,1079,3.0,811.0,811.0
0.095,6,10,1506,5,395,21.0,127.0,127.0,5,1111,20.0,843.0,843.0
0.013,6,10,1983,5,910,3.0,642.0,642.0,5,1073,3.0,805.0,805.0
0.005,17,2,170,1,65,0.0,37.0,37.0,1,105,0.0,77.0,77.0
0.001,17,2,136,1,60,0.0,32.0,32.0,1,76,0.0,48.0,48.0
0.084,6,10,1506,5,395,19.0,127.0,127.0,5,1111,18.0,843.0,843.0
0.08,6,10,1506,5,395,15.0,127.0,127.0,5,1111,17.0,843.0,843.0
0.005,6,10,1989,5,927,1.0,659.0,659.0,5,1062,1.0,794.0,794.0
0.011,6,10,1989,5,910,2.0,642.0,642.0,5,1079,2.0,811.0,811.0
0.009,6,10,1972,5,910,2.0,642.0,642.0,5,1062,2.0,794.0,794.0
0.016,6,10,1989,5,910,3.0,642.0,642.0,5,1079,4.0,811.0,811.0
0.058,6,10,1506,5,395,12.0,127.0,127.0,5,1111,12.0,843.0,843.0
0.005,17,2,166,1,75,0.0,47.0,47.0,1,91,0.0,63.0,63.0
0.005,6,10,1854,5,889,1.0,621.0,621.0,5,965,1.0,697.0,697.0
0.005,17,2,179,1,71,0.0,43.0,43.0,1,108,0.0,80.0,80.0
0.069,17,8,3613,4,1874,23.0,1350.0,440.0,4,1739,12.0,1350.0,406.0
367.387,6,22,2313,16,867,24492.0,195.0,195.0,6,1446,4638.0,419.0,398.0
177.322,17,82,11451,41,2751,4432.0,44.0,39.0,41,8700,4432.0,239.0,184.0
0.011,6,10,1983,5,910,2.0,642.0,642.0,5,1073,2.0,805.0,805.0
0.005,6,10,1854,5,889,1.0,621.0,621.0,5,965,1.0,697.0,697.0
0.089,6,10,1506,5,395,18.0,127.0,127.0,5,1111,19.0,843.0,843.0
0.026,6,10,1762,5,911,6.0,643.0,643.0,5,851,6.0,583.0,583.0
240.478,6,273,335254,89,8399,2732.0,1580.0,537.0,184,326855,1314.0,2804.0,1855.0
40.064,17,10,676,5,460,10013.0,104.0,64.0,5,216,10014.0,20.0,15.0
0.093,6,10,1506,5,395,19.0,127.0,127.0,5,1111,21.0,843.0,843.0
0.04,17,2,152,1,76,0.0,48.0,48.0,1,76,0.0,48.0,48.0
0.004,17,2,136,1,60,0.0,32.0,32.0,1,76,0.0,48.0,48.0
0.006,6,10,1547,5,764,1.0,496.0,496.0,5,783,1.0,515.0,515.0
0.016,6,10,1983,5,910,3.0,642.0,642.0,5,1073,4.0,805.0,805.0
0.005,6,10,2007,5,928,1.0,660.0,660.0,5,1079,1.0,811.0,811.0
0.098,6,10,1506,5,395,21.0,127.0,127.0,5,1111,19.0,843.0,843.0
0.014,6,10,1677,5,827,3.0,559.0,559.0,5,850,3.0,582.0,582.0
0.013,17,2,140,1,62,0.0,34.0,34.0,1,78,0.0,50.0,50.0
0.106,6,10,1506,5,395,24.0,127.0,127.0,5,1111,24.0,843.0,843.0
0.007,6,10,1854,5,889,1.0,621.0,621.0,5,965,1.0,697.0,697.0
0.001,17,2,180,1,66,0.0,38.0,38.0,1,114,0.0,86.0,86.0
0.008,6,10,2007,5,928,2.0,660.0,660.0,5,1079,2.0,811.0,811.0
0.012,6,10,1983,5,910,3.0,642.0,642.0,5,1073,2.0,805.0,805.0
0.005,17,2,164,1,74,0.0,46.0,46.0,1,90,0.0,62.0,62.0
0.004,6,10,1989,5,927,1.0,659.0,659.0,5,1062,1.0,794.0,794.0
25.857,6,46,18502,23,12784,411.0,2720.0,1314.0,23,5718,1167.0,2667.0,435.0
174.16,17,96,13420,48,3251,3705.0,44.0,39.0,48,10169,3705.0,239.0,183.0
0.013,6,10,1989,5,910,3.0,642.0,642.0,5,1079,3.0,811.0,811.0
0.013,6,10,1972,5,910,3.0,642.0,642.0,5,1062,3.0,794.0,794.0
0.008,6,12,1926,6,1189,1.0,659.0,434.0,6,737,1.0,417.0,417.0
0.008,6,12,1926,6,1189,1.0,659.0,434.0,6,737,1.0,417.0,417.0
0.001,17,2,180,1,66,0.0,38.0,38.0,1,114,0.0,86.0,86.0
0.072,17,4,420,2,122,0.0,33.0,33.0,2,298,31.0,145.0,121.0
40.054,17,10,676,5,460,10012.0,104.0,64.0,5,216,10012.0,20.0,15.0
300.368,6,16,2170,9,684,37525.0,146.0,146.0,7,1486,50033.0,419.0,398.0
0.004,6,10,2006,5,927,1.0,659.0,659.0,5,1079,1.0,811.0,811.0
0.005,6,10,2007,5,928,1.0,660.0,660.0,5,1079,1.0,811.0,811.0
0.117,6,10,1506,5,395,26.0,127.0,127.0,5,1111,21.0,843.0,843.0
303.971,6,24,5390,13,3437,25330.0,1052.0,458.0,11,1953,30396.0,695.0,346.0
40.064,17,10,676,5,460,10015.0,104.0,64.0,5,216,10015.0,20.0,15.0
240.037,6,9,787,5,488,60009.0,232.0,232.0,4,299,80011.0,83.0,83.0
40.064,17,10,676,5,460,10012.0,104.0,64.0,5,216,10015.0,20.0,15.0
0.005,6,10,2006,5,927,1.0,659.0,659.0,5,1079,1.0,811.0,811.0
0.003,17,2,136,1,60,0.0,32.0,32.0,1,76,0.0,48.0,48.0
0.004,6,10,2006,5,927,1.0,659.0,659.0,5,1079,1.0,811.0,811.0
0.004,17,2,136,1,60,0.0,32.0,32.0,1,76,0.0,48.0,48.0
0.004,17,2,136,1,60,0.0,32.0,32.0,1,76,0.0,48.0,48.0
0.005,17,2,144,1,64,0.0,36.0,36.0,1,80,0.0,52.0,52.0
0.005,6,10,1854,5,889,1.0,621.0,621.0,5,965,1.0,697.0,697.0
0.017,6,10,1972,5,910,4.0,642.0,642.0,5,1062,4.0,794.0,794.0
0.058,6,10,1506,5,395,13.0,127.0,127.0,5,1111,13.0,843.0,843.0
0.085,6,10,1506,5,395,20.0,127.0,127.0,5,1111,20.0,843.0,843.0
0.115,6,10,1506,5,395,26.0,127.0,127.0,5,1111,25.0,843.0,843.0
40.064,17,10,676,5,460,10014.0,104.0,64.0,5,216,10015.0,20.0,15.0
0.005,6,13,3747,7,509,0.0,137.0,137.0,6,3238,0.0,1470.0,1459.0
0.008,6,10,1989,5,910,2.0,642.0,642.0,5,1079,2.0,811.0,811.0
0.086,6,10,1506,5,395,19.0,127.0,127.0,5,1111,16.0,843.0,843.0
0.005,17,2,152,1,68,0.0,40.0,40.0,1,84,0.0,56.0,56.0
0.113,6,10,1506,5,395,24.0,127.0,127.0,5,1111,25.0,843.0,843.0
0.004,6,10,1989,5,927,1.0,659.0,659.0,5,1062,1.0,794.0,794.0
0.082,6,10,1506,5,395,19.0,127.0,127.0,5,1111,19.0,843.0,843.0
0.009,6,10,1990,5,911,2.0,643.0,643.0,5,1079,2.0,811.0,811.0
0.127,6,10,1506,5,395,29.0,127.0,127.0,5,1111,29.0,843.0,843.0
0.112,6,10,1506,5,395,25.0,127.0,127.0,5,1111,22.0,843.0,843.0
0.006,6,10,1547,5,764,1.0,496.0,496.0,5,783,1.0,515.0,515.0
1792.667,6,493,99532,249,88182,7228.0,421.0,365.0,244,11350,7376.0,53.0,53.0
0.085,6,10,1506,5,395,17.0,127.0,127.0,5,1111,17.0,843.0,843.0
0.074,6,10,1506,5,395,16.0,127.0,127.0,5,1111,18.0,843.0,843.0
0.014,6,14,3787,7,497,2.0,125.0,125.0,7,3290,2.0,1448.0,972.0
0.004,6,10,2006,5,927,1.0,659.0,659.0,5,1079,1.0,811.0,811.0
0.063,6,10,1506,5,395,13.0,127.0,127.0,5,1111,13.0,843.0,843.0
0.016,6,10,1983,5,910,3.0,642.0,642.0,5,1073,3.0,805.0,805.0
0.001,17,2,180,1,65,0.0,37.0,37.0,1,115,0.0,87.0,87.0
0.009,6,10,1631,5,848,2.0,580.0,580.0,5,783,2.0,515.0,515.0
0.005,6,10,1989,5,927,1.0,659.0,659.0,5,1062,1.0,794.0,794.0
40.07,17,10,676,5,460,10016.0,104.0,64.0,5,216,10016.0,20.0,15.0
0.008,6,10,1990,5,911,2.0,643.0,643.0,5,1079,1.0,811.0,811.0
0.006,6,10,1547,5,764,1.0,496.0,496.0,5,783,1.0,515.0,515.0
1772.03,6,106,6361,60,3537,30033.0,27.0,27.0,46,2824,39377.0,27.0,27.0
0.004,17,2,136,1,60,0.0,32.0,32.0,1,76,0.0,48.0,48.0
0.008,6,12,1926,6,1189,1.0,659.0,434.0,6,737,1.0,417.0,417.0
0.133,17,2,412,1,61,0.0,33.0,33.0,1,351,0.0,323.0,323.0
0.013,6,10,1990,5,911,3.0,643.0,643.0,5,1079,3.0,811.0,811.0
0.07,6,10,1506,5,395,14.0,127.0,127.0,5,1111,14.0,843.0,843.0
0.016,6,10,1989,5,910,4.0,642.0,642.0,5,1079,3.0,811.0,811.0
0.137,6,10,1506,5,395,33.0,127.0,127.0,5,1111,32.0,843.0,843.0
0.014,6,10,1989,5,910,3.0,642.0,642.0,5,1079,3.0,811.0,811.0
240.012,6,9,787,5,488,60003.0,232.0,232.0,4,299,80002.0,83.0,83.0
0.005,17,2,202,1,69,0.0,41.0,41.0,1,133,0.0,105.0,105.0
10.801,17,28,4421,14,1994,821.0,269.0,114.0,14,2427,821.0,586.0,145.0
0.005,6,10,2000,5,927,1.0,659.0,659.0,5,1073,1.0,805.0,805.0
40.068,17,10,676,5,460,10016.0,104.0,64.0,5,216,10015.0,20.0,15.0
0.001,17,2,180,1,66,0.0,38.0,38.0,1,114,0.0,86.0,86.0
40.055,17,10,676,5,460,10011.0,104.0,64.0,5,216,10012.0,20.0,15.0
0.009,6,10,1989,5,910,2.0,642.0,642.0,5,1079,2.0,811.0,811.0
0.072,17,4,352,2,130,1.0,37.0,37.0,2,222,32.0,89.0,83.0
11.496,17,28,4399,14,2313,872.0,588.0,137.0,14,2086,872.0,269.0,121.0
0.016,6,10,1677,5,827,3.0,559.0,559.0,5,850,3.0,582.0,582.0
0.016,6,10,1972,5,910,3.0,642.0,642.0,5,1062,3.0,794.0,794.0
0.005,6,10,1689,5,839,1.0,571.0,571.0,5,850,1.0,582.0,582.0
0.077,6,10,1506,5,395,17.0,127.0,127.0,5,1111,14.0,843.0,843.0
40.058,17,10,676,5,460,10013.0,104.0,64.0,5,216,10013.0,20.0,15.0
0.101,6,10,1506,5,395,21.0,127.0,127.0,5,1111,22.0,843.0,843.0
0.008,6,12,1926,6,1189,1.0,659.0,434.0,6,737,1.0,417.0,417.0
0.012,6,13,3735,7,497,2.0,125.0,125.0,6,3238,2.0,1470.0,1459.0
0.009,6,10,1972,5,910,2.0,642.0,642.0,5,1062,2.0,794.0,794.0
240.12,6,33,9478,17,6892,15007.0,1515.0,601.0,16,2586,16007.0,580.0,218.0
0.005,6,10,2000,5,927,1.0,659.0,659.0,5,1073,1.0,805.0,805.0
0.002,17,2,180,1,66,0.0,38.0,38.0,1,114,0.0,86.0,86.0
0.005,17,2,180,1,66,0.0,38.0,38.0,1,114,0.0,86.0,86.0
0.152,17,2,182,1,65,0.0,37.0,37.0,1,117,0.0,89.0,89.0
0.092,6,10,1506,5,395,21.0,127.0,127.0,5,1111,20.0,843.0,843.0
0.011,6,10,1972,5,910,2.0,642.0,642.0,5,1062,2.0,794.0,794.0
0.008,6,10,1983,5,910,2.0,642.0,642.0,5,1073,2.0,805.0,805.0
0.015,6,10,1989,5,910,3.0,642.0,642.0,5,1079,3.0,811.0,811.0
22.922,6,36,8190,19,1759,1273.0,651.0,322.0,17,6431,590.0,2720.0,478.0
0.007,6,10,1972,5,910,1.0,642.0,642.0,5,1062,1.0,794.0,794.0
0.011,6,10,1983,5,910,2.0,642.0,642.0,5,1073,2.0,805.0,805.0
0.007,6,10,1762,5,911,1.0,643.0,643.0,5,851,1.0,583.0,583.0
0.01,6,10,1677,5,827,2.0,559.0,559.0,5,850,2.0,582.0,582.0
0.08,6,10,1506,5,395,19.0,127.0,127.0,5,1111,17.0,843.0,843.0
0.004,6,10,2006,5,927,1.0,659.0,659.0,5,1079,1.0,811.0,811.0
0.005,17,2,214,1,75,0.0,47.0,47.0,1,139,0.0,111.0,111.0
0.106,6,10,1506,5,395,23.0,127.0,127.0,5,1111,24.0,843.0,843.0
243.108,6,21,6493,12,1402,22100.0,253.0,195.0,9,5091,30388.0,1402.0,769.0
0.078,6,10,1506,5,395,17.0,127.0,127.0,5,1111,17.0,843.0,843.0
0.097,6,10,1506,5,395,21.0,127.0,127.0,5,1111,19.0,843.0,843.0
0.015,6,10,1990,5,911,3.0,643.0,643.0,5,1079,3.0,811.0,811.0
0.007,6,10,1983,5,910,1.0,642.0,642.0,5,1073,1.0,805.0,805.0
0.005,6,10,2007,5,928,1.0,660.0,660.0,5,1079,1.0,811.0,811.0
0.012,6,10,1990,5,911,2.0,643.0,643.0,5,1079,3.0,811.0,811.0
0.188,17,4,352,2,130,147.0,37.0,37.0,2,222,150.0,89.0,83.0
0.006,6,10,1547,5,764,1.0,496.0,496.0,5,783,1.0,515.0,515.0
0.013,6,10,1989,5,910,3.0,642.0,642.0,5,1079,3.0,811.0,811.0
0.036,6,10,1990,5,911,8.0,643.0,643.0,5,1079,8.0,811.0,811.0
0.129,6,10,1506,5,395,30.0,127.0,127.0,5,1111,29.0,843.0,843.0
0.07,6,10,1506,5,395,16.0,127.0,127.0,5,1111,15.0,843.0,843.0
170.351,17,92,13232,46,3096,3785.0,44.0,39.0,46,10136,3785.0,239.0,192.0
40.061,17,10,676,5,460,10012.0,104.0,64.0,5,216,10013.0,20.0,15.0
40.068,17,10,676,5,460,10014.0,104.0,64.0,5,216,10016.0,20.0,15.0
0.006,17,2,179,1,71,0.0,43.0,43.0,1,108,0.0,80.0,80.0
0.107,6,10,1506,5,395,24.0,127.0,127.0,5,1111,25.0,843.0,843.0
0.04,17,4,336,2,124,0.0,34.0,34.0,2,212,0.0,84.0,78.0
0.095,6,10,1506,5,395,22.0,127.0,127.0,5,1111,20.0,843.0,843.0
0.003,17,2,136,1,60,0.0,32.0,32.0,1,76,0.0,48.0,48.0
0.004,6,10,1702,5,863,1.0,595.0,595.0,5,839,0.0,571.0,571.0
0.008,6,12,1926,6,1189,1.0,659.0,434.0,6,737,1.0,417.0,417.0
0.106,6,10,1989,5,910,26.0,642.0,642.0,5,1079,26.0,811.0,811.0
0.012,6,10,1990,5,911,3.0,643.0,643.0,5,1079,2.0,811.0,811.0
0.006,6,10,1547,5,764,1.0,496.0,496.0,5,783,1.0,515.0,515.0
0.005,17,2,164,1,74,0.0,46.0,46.0,1,90,0.0,62.0,62.0
0.003,17,2,186,1,61,0.0,33.0,33.0,1,125,0.0,97.0,97.0
0.096,6,10,1506,5,395,20.0,127.0,127.0,5,1111,21.0,843.0,843.0
0.006,6,10,1547,5,764,1.0,496.0,496.0,5,783,1.0,515.0,515.0
0.001,17,2,180,1,66,0.0,38.0,38.0,1,114,0.0,86.0,86.0
0.083,6,10,1506,5,395,15.0,127.0,127.0,5,1111,19.0,843.0,843.0
264.71,6,237,209116,137,12416,1946.0,924.0,528.0,100,196700,2673.0,3371.0,2176.0
0.004,6,10,2006,5,927,1.0,659.0,659.0,5,1079,1.0,811.0,811.0
0.003,17,4,284,2,120,0.0,32.0,32.0,2,164,0.0,60.0,54.0
0.012,6,10,1989,5,910,2.0,642.0,642.0,5,1079,2.0,811.0,811.0
0.076,6,10,1506,5,395,18.0,127.0,127.0,5,1111,17.0,843.0,843.0
0.004,6,10,2006,5,927,1.0,659.0,659.0,5,1079,1.0,811.0,811.0
0.037,17,2,148,1,60,0.0,32.0,32.0,1,88,0.0,60.0,60.0
0.006,6,10,2006,5,927,1.0,659.0,659.0,5,1079,1.0,811.0,811.0
0.005,6,10,2000,5,927,1.0,659.0,659.0,5,1073,1.0,805.0,805.0
0.025,6,10,1989,5,910,6.0,642.0,642.0,5,1079,6.0,811.0,811.0
0.133,6,10,1506,5,395,30.0,127.0,127.0,5,1111,32.0,843.0,843.0
0.002,17,2,152,1,76,0.0,48.0,48.0,1,76,0.0,48.0,48.0
0.092,6,10,1506,5,395,22.0,127.0,127.0,5,1111,20.0,843.0,843.0
0.004,6,10,1774,5,923,1.0,655.0,655.0,5,851,1.0,583.0,583.0
40.083,17,10,676,5,460,10018.0,104.0,64.0,5,216,10019.0,20.0,15.0
40.075,17,10,676,5,460,10018.0,104.0,64.0,5,216,10017.0,20.0,15.0
0.012,6,10,1990,5,911,3.0,643.0,643.0,5,1079,2.0,811.0,811.0
0.124,6,10,1506,5,395,26.0,127.0,127.0,5,1111,25.0,843.0,843.0
0.123,6,10,1506,5,395,26.0,127.0,127.0,5,1111,27.0,843.0,843.0
0.093,6,10,1506,5,395,20.0,127.0,127.0,5,1111,21.0,843.0,843.0
0.004,6,10,1989,5,927,1.0,659.0,659.0,5,1062,1.0,794.0,794.0
0.167,6,10,1506,5,395,38.0,127.0,127.0,5,1111,38.0,843.0,843.0
0.013,6,10,1989,5,910,3.0,642.0,642.0,5,1079,3.0,811.0,811.0
0.006,17,2,169,1,62,0.0,34.0,34.0,1,107,0.0,79.0,79.0
0.018,6,10,1983,5,910,4.0,642.0,642.0,5,1073,4.0,805.0,805.0
0.006,17,2,164,1,74,0.0,46.0,46.0,1,90,0.0,62.0,62.0
30.565,6,19,9441,10,772,3396.0,240.0,240.0,9,8669,3819.0,1402.0,1365.0
0.115,6,10,1506,5,395,26.0,127.0,127.0,5,1111,27.0,843.0,843.0
0.005,17,2,214,1,75,0.0,47.0,47.0,1,139,0.0,111.0,111.0
240.082,6,16,4480,9,963,30010.0,238.0,166.0,7,3517,40013.0,1402.0,786.0
0.017,6,10,1631,5,848,4.0,580.0,580.0,5,783,4.0,515.0,515.0
240.11,6,30,9258,15,6819,17150.0,1942.0,671.0,15,2439,17150.0,580.0,235.0
40.095,17,10,676,5,460,10020.0,104.0,64.0,5,216,10021.0,20.0,15.0
40.087,17,10,676,5,460,10020.0,104.0,64.0,5,216,10020.0,20.0,15.0
15.081,17,16,8220,8,5914,2150.0,1350.0,711.0,8,2306,2150.0,1350.0,260.0
0.135,17,2,80,1,32,0.0,4.0,4.0,1,48,0.0,20.0,20.0
0.017,6,10,1990,5,911,4.0,643.0,643.0,5,1079,4.0,811.0,811.0
40.07,17,10,676,5,460,10014.0,104.0,64.0,5,216,10016.0,20.0,15.0
0.005,6,10,1689,5,839,1.0,571.0,571.0,5,850,1.0,582.0,582.0
169.385,17,74,10392,37,2457,4705.0,44.0,38.0,37,7935,4705.0,261.0,186.0
308.493,17,20,1124,10,716,34263.0,48.0,43.0,10,408,34263.0,20.0,12.0
0.039,17,2,148,1,60,0.0,32.0,32.0,1,88,0.0,60.0,60.0
0.012,6,10,1989,5,910,3.0,642.0,642.0,5,1079,2.0,811.0,811.0
0.007,6,10,1643,5,860,1.0,592.0,592.0,5,783,1.0,515.0,515.0
0.02,6,10,1972,5,910,5.0,642.0,642.0,5,1062,5.0,794.0,794.0
0.071,6,10,1506,5,395,16.0,127.0,127.0,5,1111,15.0,843.0,843.0
0.012,6,10,1677,5,827,3.0,559.0,559.0,5,850,2.0,582.0,582.0
0.128,17,4,596,2,122,0.0,33.0,33.0,2,474,90.0,323.0,209.0
176.105,17,84,12133,42,2806,4294.0,44.0,38.0,42,9327,4295.0,279.0,194.0
0.018,6,10,1989,5,910,4.0,642.0,642.0,5,1079,4.0,811.0,811.0
0.041,17,4,364,2,160,0.0,52.0,52.0,2,204,4.0,80.0,74.0
0.001,17,2,180,1,66,0.0,38.0,38.0,1,114,0.0,86.0,86.0
0.104,6,10,1506,5,395,24.0,127.0,127.0,5,1111,25.0,843.0,843.0
0.004,17,2,160,1,72,0.0,44.0,44.0,1,88,0.0,60.0,60.0
0.069,17,8,3613,4,1874,23.0,1350.0,440.0,4,1739,11.0,1350.0,406.0
354.033,6,19,1691,15,978,25288.0,190.0,190.0,4,713,80003.0,497.0,497.0
0.012,6,10,1989,5,910,3.0,642.0,642.0,5,1079,2.0,811.0,811.0
0.0,17,2,142,1,63,0.0,35.0,35.0,1,79,0.0,51.0,51.0
0.097,6,10,1506,5,395,20.0,127.0,127.0,5,1111,22.0,843.0,843.0
0.015,6,10,1762,5,911,3.0,643.0,643.0,5,851,3.0,583.0,583.0
0.013,6,10,1989,5,910,3.0,642.0,642.0,5,1079,3.0,811.0,811.0
0.004,6,10,2000,5,927,1.0,659.0,659.0,5,1073,1.0,805.0,805.0
40.065,17,10,676,5,460,10015.0,104.0,64.0,5,216,10015.0,20.0,15.0
0.006,6,10,1547,5,764,1.0,496.0,496.0,5,783,1.0,515.0,515.0
0.01,6,10,1762,5,911,2.0,643.0,643.0,5,851,2.0,583.0,583.0
0.008,17,2,194,1,59,0.0,31.0,31.0,1,135,0.0,107.0,107.0
0.117,6,10,1506,5,395,25.0,127.0,127.0,5,1111,24.0,843.0,843.0
0.006,17,2,166,1,75,0.0,47.0,47.0,1,91,0.0,63.0,63.0
0.005,6,14,3799,7,509,0.0,137.0,137.0,7,3290,0.0,1448.0,972.0
0.015,6,10,1972,5,910,3.0,642.0,642.0,5,1062,3.0,794.0,794.0
0.006,6,10,1547,5,764,1.0,496.0,496.0,5,783,1.0,515.0,515.0
0.072,17,4,352,2,130,0.0,37.0,37.0,2,222,34.0,89.0,83.0
11.159,17,28,4419,14,1994,845.0,269.0,114.0,14,2425,845.0,588.0,145.0
0.001,17,2,136,1,60,0.0,32.0,32.0,1,76,0.0,48.0,48.0
0.008,17,2,194,1,59,0.0,31.0,31.0,1,135,0.0,107.0,107.0
0.005,17,2,170,1,65,0.0,37.0,37.0,1,105,0.0,77.0,77.0
0.001,17,2,174,1,72,0.0,44.0,44.0,1,102,0.0,74.0,74.0
0.928,6,29,7768,17,2784,58.0,1477.0,515.0,12,4984,68.0,2745.0,561.0
300.389,6,16,2170,9,684,37527.0,146.0,146.0,7,1486,50037.0,419.0,398.0
0.005,6,10,2007,5,928,1.0,660.0,660.0,5,1079,1.0,811.0,811.0
40.065,17,10,676,5,460,10015.0,104.0,64.0,5,216,10015.0,20.0,15.0
0.136,6,10,1506,5,395,31.0,127.0,127.0,5,1111,33.0,843.0,843.0
0.005,17,2,230,1,68,0.0,40.0,40.0,1,162,0.0,134.0,134.0
0.005,6,10,2006,5,927,1.0,659.0,659.0,5,1079,1.0,811.0,811.0
0.004,6,10,2006,5,927,1.0,659.0,659.0,5,1079,1.0,811.0,811.0
0.019,6,10,1989,5,910,4.0,642.0,642.0,5,1079,4.0,811.0,811.0
0.19,17,2,152,1,76,0.0,48.0,48.0,1,76,0.0,48.0,48.0
0.006,6,10,2006,5,927,1.0,659.0,659.0,5,1079,1.0,811.0,811.0
0.004,6,10,2006,5,927,1.0,659.0,659.0,5,1079,1.0,811.0,811.0
0.075,6,10,1506,5,395,15.0,127.0,127.0,5,1111,17.0,843.0,843.0
59.384,6,36,9330,18,3812,522.0,1360.0,765.0,18,5518,3483.0,2667.0,435.0
0.089,6,10,1506,5,395,19.0,127.0,127.0,5,1111,19.0,843.0,843.0
11.28,17,28,4420,14,1995,855.0,270.0,114.0,14,2425,854.0,588.0,145.0
0.004,6,10,2007,5,928,1.0,660.0,660.0,5,1079,1.0,811.0,811.0
0.005,17,2,140,1,62,0.0,34.0,34.0,1,78,0.0,50.0,50.0
312.688,17,20,1124,10,716,34728.0,48.0,43.0,10,408,34728.0,20.0,12.0
361.807,6,21,1793,16,1030,24120.0,190.0,190.0,5,763,60010.0,462.0,247.0
0.005,6,10,1547,5,764,1.0,496.0,496.0,5,783,1.0,515.0,515.0
0.018,6,10,1972,5,910,4.0,642.0,642.0,5,1062,4.0,794.0,794.0
0.008,6,12,1926,6,1189,1.0,659.0,434.0,6,737,1.0,417.0,417.0
0.001,17,2,136,1,60,0.0,32.0,32.0,1,76,0.0,48.0,48.0
0.003,17,2,148,1,60,0.0,32.0,32.0,1,88,0.0,60.0,60.0
0.005,17,2,164,1,74,0.0,46.0,46.0,1,90,0.0,62.0,62.0
0.018,6,13,3735,7,497,2.0,125.0,125.0,6,3238,3.0,1470.0,1459.0
0.006,6,10,1774,5,923,1.0,655.0,655.0,5,851,1.0,583.0,583.0
0.026,6,10,1972,5,910,6.0,642.0,642.0,5,1062,6.0,794.0,794.0
0.004,6,10,1779,5,928,1.0,660.0,660.0,5,851,1.0,583.0,583.0
0.005,17,2,144,1,64,0.0,36.0,36.0,1,80,0.0,52.0,52.0
0.014,6,10,1990,5,911,3.0,643.0,643.0,5,1079,3.0,811.0,811.0
0.001,17,2,140,1,62,0.0,34.0,34.0,1,78,0.0,50.0,50.0
0.005,6,10,2007,5,928,1.0,660.0,660.0,5,1079,1.0,811.0,811.0
0.005,17,2,140,1,62,0.0,34.0,34.0,1,78,0.0,50.0,50.0
300.043,6,12,1782,7,1348,50007.0,494.0,494.0,5,434,75008.0,83.0,83.0
0.009,6,10,1972,5,910,2.0,642.0,642.0,5,1062,2.0,794.0,794.0
143.434,6,26,9525,12,1627,74.0,794.0,367.0,14,7898,11023.0,1360.0,732.0
0.102,6,10,1506,5,395,22.0,127.0,127.0,5,1111,24.0,843.0,843.0
0.068,17,8,3613,4,1874,22.0,1350.0,440.0,4,1739,11.0,1350.0,406.0
0.069,6,10,1506,5,395,16.0,127.0,127.0,5,1111,12.0,843.0,843.0
0.013,6,10,1972,5,910,3.0,642.0,642.0,5,1062,3.0,794.0,794.0
0.009,6,10,1689,5,839,2.0,571.0,571.0,5,850,2.0,582.0,582.0
0.005,17,2,166,1,75,0.0,47.0,47.0,1,91,0.0,63.0,63.0
240.008,6,9,787,5,488,60002.0,232.0,232.0,4,299,80002.0,83.0,83.0
178.49,17,88,12304,44,2936,4150.0,44.0,38.0,44,9368,4150.0,239.0,184.0
15.081,17,15,8438,8,6255,2150.0,1350.0,753.0,7,2183,2508.0,1350.0,283.0
0.011,6,10,1983,5,910,2.0,642.0,642.0,5,1073,2.0,805.0,805.0
0.005,6,10,1989,5,927,1.0,659.0,659.0,5,1062,1.0,794.0,794.0
0.006,6,10,1547,5,764,1.0,496.0,496.0,5,783,1.0,515.0,515.0
0.088,6,10,1506,5,395,19.0,127.0,127.0,5,1111,19.0,843.0,843.0
0.099,6,10,1506,5,395,22.0,127.0,127.0,5,1111,24.0,843.0,843.0
0.011,6,10,1989,5,910,2.0,642.0,642.0,5,1079,2.0,811.0,811.0
0.079,6,10,1506,5,395,17.0,127.0,127.0,5,1111,16.0,843.0,843.0
0.006,17,2,179,1,71,0.0,43.0,43.0,1,108,0.0,80.0,80.0
240.011,6,9,787,5,488,60002.0,232.0,232.0,4,299,80002.0,83.0,83.0
0.004,6,10,2006,5,927,1.0,659.0,659.0,5,1079,1.0,811.0,811.0
0.005,6,10,2007,5,928,1.0,660.0,660.0,5,1079,1.0,811.0,811.0
0.006,6,10,1547,5,764,1.0,496.0,496.0,5,783,1.0,515.0,515.0
0.004,6,14,3742,8,504,0.0,80.0,80.0,6,3238,0.0,1470.0,1459.0
0.012,6,10,1989,5,910,3.0,642.0,642.0,5,1079,2.0,811.0,811.0
0.05,6,10,1631,5,848,12.0,580.0,580.0,5,783,12.0,515.0,515.0
0.037,17,4,284,2,120,0.0,32.0,32.0,2,164,33.0,60.0,54.0
0.006,17,4,284,2,120,0.0,32.0,32.0,2,164,0.0,60.0,54.0
0.113,6,10,1506,5,395,26.0,127.0,127.0,5,1111,26.0,843.0,843.0
0.006,6,10,1547,5,764,1.0,496.0,496.0,5,783,1.0,515.0,515.0
146.334,6,25,9095,13,3217,100.0,1360.0,533.0,12,5878,13288.0,2720.0,897.0
0.133,17,4,284,2,120,0.0,32.0,32.0,2,164,121.0,60.0,54.0
0.02,6,10,1989,5,910,5.0,642.0,642.0,5,1079,4.0,811.0,811.0
0.093,6,10,1506,5,395,21.0,127.0,127.0,5,1111,22.0,843.0,843.0
0.006,17,2,136,1,60,0.0,32.0,32.0,1,76,0.0,48.0,48.0
10.931,17,28,4423,14,1994,831.0,269.0,114.0,14,2429,831.0,588.0,145.0
40.065,17,10,676,5,460,10015.0,104.0,64.0,5,216,10015.0,20.0,15.0
0.011,6,10,1972,5,910,2.0,642.0,642.0,5,1062,2.0,794.0,794.0
0.069,6,10,1506,5,395,14.0,127.0,127.0,5,1111,15.0,843.0,843.0
309.54,17,20,1124,10,716,34378.0,48.0,43.0,10,408,34378.0,20.0,12.0
240.297,6,43,8771,21,5686,12014.0,1515.0,509.0,22,3085,11442.0,580.0,241.0
0.009,6,10,1989,5,910,2.0,642.0,642.0,5,1079,2.0,811.0,811.0
0.005,17,2,148,1,60,0.0,32.0,32.0,1,88,0.0,60.0,60.0
0.019,6,10,1989,5,910,4.0,642.0,642.0,5,1079,4.0,811.0,811.0
0.027,6,10,1990,5,911,6.0,643.0,643.0,5,1079,6.0,811.0,811.0
0.053,17,2,152,1,76,0.0,48.0,48.0,1,76,0.0,48.0,48.0
0.005,6,10,2007,5,928,1.0,660.0,660.0,5,1079,1.0,811.0,811.0
0.011,6,10,1972,5,910,2.0,642.0,642.0,5,1062,2.0,794.0,794.0
0.01,6,10,1989,5,910,2.0,642.0,642.0,5,1079,2.0,811.0,811.0
0.093,6,10,1506,5,395,21.0,127.0,127.0,5,1111,21.0,843.0,843.0
0.108,6,10,1506,5,395,25.0,127.0,127.0,5,1111,23.0,843.0,843.0
0.006,6,10,1547,5,764,1.0,496.0,496.0,5,783,1.0,515.0,515.0
0.062,6,37,7913,22,2246,2.0,517.0,122.0,15,5667,4.0,2694.0,542.0
0.088,6,10,1506,5,395,20.0,127.0,127.0,5,1111,20.0,843.0,843.0
0.005,17,2,144,1,64,0.0,36.0,36.0,1,80,0.0,52.0,52.0
0.009,6,10,1990,5,911,2.0,643.0,643.0,5,1079,2.0,811.0,811.0
0.012,6,10,1972,5,910,2.0,642.0,642.0,5,1062,2.0,794.0,794.0
0.004,17,2,136,1,60,0.0,32.0,32.0,1,76,0.0,48.0,48.0
0.006,6,10,1547,5,764,1.0,496.0,496.0,5,783,1.0,515.0,515.0
0.028,6,10,1990,5,911,7.0,643.0,643.0,5,1079,7.0,811.0,811.0
0.005,17,2,166,1,75,0.0,47.0,47.0,1,91,0.0,63.0,63.0
0.004,17,2,136,1,60,0.0,32.0,32.0,1,76,0.0,48.0,48.0
0.088,6,10,1506,5,395,20.0,127.0,127.0,5,1111,20.0,843.0,843.0
0.005,6,13,3747,7,509,0.0,137.0,137.0,6,3238,1.0,1470.0,1459.0
0.02,6,10,1972,5,910,5.0,642.0,642.0,5,1062,5.0,794.0,794.0
0.007,17,2,179,1,71,0.0,43.0,43.0,1,108,0.0,80.0,80.0
0.017,6,10,1989,5,910,4.0,642.0,642.0,5,1079,4.0,811.0,811.0
0.005,6,10,2006,5,927,1.0,659.0,659.0,5,1079,1.0,811.0,811.0
15.071,17,15,9238,8,6902,2149.0,1350.0,834.0,7,2336,2507.0,1350.0,305.0
40.066,17,10,676,5,460,10013.0,104.0,64.0,5,216,10015.0,20.0,15.0
0.013,6,10,1983,5,910,3.0,642.0,642.0,5,1073,3.0,805.0,805.0
0.038,17,2,148,1,60,0.0,32.0,32.0,1,88,0.0,60.0,60.0
0.008,6,14,3799,7,509,1.0,137.0,137.0,7,3290,1.0,1448.0,972.0
0.112,6,10,1506,5,395,22.0,127.0,127.0,5,1111,24.0,843.0,843.0
0.005,6,10,2000,5,927,1.0,659.0,659.0,5,1073,1.0,805.0,805.0
0.015,6,10,1989,5,910,3.0,642.0,642.0,5,1079,3.0,811.0,811.0
0.005,6,10,2007,5,928,1.0,660.0,660.0,5,1079,1.0,811.0,811.0
0.084,6,10,1506,5,395,20.0,127.0,127.0,5,1111,18.0,843.0,843.0
0.107,6,10,1506,5,395,26.0,127.0,127.0,5,1111,26.0,843.0,843.0
240.077,6,22,4977,12,993,21825.0,180.0,93.0,10,3984,26674.0,1592.0,576.0
0.004,17,2,148,1,60,0.0,32.0,32.0,1,88,0.0,60.0,60.0
309.264,17,20,1124,10,716,34356.0,48.0,43.0,10,408,34355.0,20.0,12.0
0.01,6,10,1989,5,910,2.0,642.0,642.0,5,1079,2.0,811.0,811.0
0.096,6,10,1506,5,395,21.0,127.0,127.0,5,1111,22.0,843.0,843.0
0.004,17,2,136,1,60,0.0,32.0,32.0,1,76,0.0,48.0,48.0
0.014,6,10,1677,5,827,3.0,559.0,559.0,5,850,3.0,582.0,582.0
280.526,6,24,6115,10,1186,31169.0,267.0,156.0,14,4929,21578.0,1400.0,873.0
0.005,6,13,3747,7,509,0.0,137.0,137.0,6,3238,1.0,1470.0,1459.0
0.01,6,10,1990,5,911,2.0,643.0,643.0,5,1079,2.0,811.0,811.0
240.023,6,9,787,5,488,60005.0,232.0,232.0,4,299,80006.0,83.0,83.0
0.059,6,10,1506,5,395,12.0,127.0,127.0,5,1111,13.0,843.0,843.0
294.127,6,321,345004,121,17843,2451.0,2736.0,888.0,200,327161,1477.0,2804.0,1712.0
0.006,17,2,164,1,74,0.0,46.0,46.0,1,90,0.0,62.0,62.0
0.013,6,10,1989,5,910,3.0,642.0,642.0,5,1079,3.0,811.0,811.0
9.038,17,6,376,5,280,2259.0,28.0,28.0,1,96,0.0,68.0,68.0
0.005,6,10,1989,5,927,1.0,659.0,659.0,5,1062,1.0,794.0,794.0
0.007,17,2,179,1,71,0.0,43.0,43.0,1,108,0.0,80.0,80.0
0.095,6,10,1506,5,395,21.0,127.0,127.0,5,1111,22.0,843.0,843.0
0.01,6,10,1989,5,927,2.0,659.0,659.0,5,1062,2.0,794.0,794.0
0.04,17,2,170,1,65,0.0,37.0,37.0,1,105,0.0,77.0,77.0
300.384,6,16,2170,9,684,37527.0,146.0,146.0,7,1486,50036.0,419.0,398.0
0.005,6,10,1547,5,764,1.0,496.0,496.0,5,783,1.0,515.0,515.0
0.004,6,10,2007,5,928,1.0,660.0,660.0,5,1079,1.0,811.0,811.0
0.023,6,10,1983,5,910,5.0,642.0,642.0,5,1073,5.0,805.0,805.0
0.008,17,2,194,1,59,0.0,31.0,31.0,1,135,0.0,107.0,107.0
40.069,17,10,676,5,460,10014.0,104.0,64.0,5,216,10016.0,20.0,15.0
0.001,17,2,136,1,60,0.0,32.0,32.0,1,76,0.0,48.0,48.0
361.788,6,21,1792,16,1030,24119.0,190.0,190.0,5,762,60009.0,461.0,247.0
0.01,6,14,3787,7,497,1.0,125.0,125.0,7,3290,1.0,1448.0,972.0
0.001,17,2,166,1,75,0.0,47.0,47.0,1,91,0.0,63.0,63.0
0.011,6,10,1990,5,911,2.0,643.0,643.0,5,1079,2.0,811.0,811.0
0.096,6,10,1506,5,395,20.0,127.0,127.0,5,1111,20.0,843.0,843.0
0.022,6,10,1983,5,910,5.0,642.0,642.0,5,1073,5.0,805.0,805.0
308.83,17,20,1124,10,716,34300.0,48.0,43.0,10,408,34300.0,20.0,12.0
0.02,6,10,1990,5,911,5.0,643.0,643.0,5,1079,4.0,811.0,811.0
40.059,17,10,676,5,460,10013.0,104.0,64.0,5,216,10013.0,20.0,15.0
0.006,6,10,1689,5,839,1.0,571.0,571.0,5,850,1.0,582.0,582.0
0.001,17,2,154,1,69,0.0,41.0,41.0,1,85,0.0,57.0,57.0
0.069,17,8,3613,4,1874,23.0,1350.0,440.0,4,1739,11.0,1350.0,406.0
15.078,17,15,8273,8,6044,2150.0,1350.0,727.0,7,2229,2508.0,1350.0,290.0
0.001,17,2,179,1,62,0.0,34.0,34.0,1,117,0.0,89.0,89.0
0.006,6,13,3690,7,452,0.0,80.0,80.0,6,3238,1.0,1470.0,1459.0
0.011,6,10,1989,5,910,2.0,642.0,642.0,5,1079,2.0,811.0,811.0
0.012,6,10,1762,5,911,3.0,643.0,643.0,5,851,2.0,583.0,583.0
0.067,17,8,3613,4,1874,22.0,1350.0,440.0,4,1739,10.0,1350.0,406.0
0.004,17,2,148,1,60,0.0,32.0,32.0,1,88,0.0,60.0,60.0
0.005,6,10,2006,5,927,1.0,659.0,659.0,5,1079,1.0,811.0,811.0
0.005,6,10,2006,5,927,1.0,659.0,659.0,5,1079,1.0,811.0,811.0
309.795,17,20,1124,10,716,34407.0,48.0,43.0,10,408,34407.0,20.0,12.0
0.015,6,10,1983,5,910,3.0,642.0,642.0,5,1073,3.0,805.0,805.0
0.005,6,10,1989,5,927,1.0,659.0,659.0,5,1062,1.0,794.0,794.0
0.023,6,10,1983,5,910,5.0,642.0,642.0,5,1073,5.0,805.0,805.0
65.891,6,23,8947,12,2328,5990.0,1002.0,424.0,11,6619,6572.0,1288.0,862.0
0.005,17,2,170,1,65,0.0,37.0,37.0,1,105,0.0,77.0,77.0
0.004,6,10,1989,5,927,1.0,659.0,659.0,5,1062,1.0,794.0,794.0
0.005,17,2,187,1,71,0.0,43.0,43.0,1,116,0.0,88.0,88.0
0.121,6,10,1506,5,395,20.0,127.0,127.0,5,1111,24.0,843.0,843.0
240.086,6,16,4480,9,963,30010.0,238.0,166.0,7,3517,40013.0,1402.0,786.0
0.006,6,10,2007,5,928,1.0,660.0,660.0,5,1079,1.0,811.0,811.0
0.01,6,10,1972,5,910,2.0,642.0,642.0,5,1062,2.0,794.0,794.0
0.054,17,2,152,1,76,0.0,48.0,48.0,1,76,0.0,48.0,48.0
291.26,6,313,344472,121,17833,2427.0,2736.0,888.0,192,326639,1524.0,2804.0,1778.0
40.051,17,10,676,5,460,10012.0,104.0,64.0,5,216,10011.0,20.0,15.0
0.072,6,10,1506,5,395,16.0,127.0,127.0,5,1111,16.0,843.0,843.0
0.037,6,10,1631,5,848,9.0,580.0,580.0,5,783,9.0,515.0,515.0
0.115,6,10,1506,5,395,20.0,127.0,127.0,5,1111,28.0,843.0,843.0
0.04,17,2,182,1,65,0.0,37.0,37.0,1,117,0.0,89.0,89.0
0.006,6,10,1689,5,839,1.0,571.0,571.0,5,850,1.0,582.0,582.0
0.006,6,10,1689,5,839,1.0,571.0,571.0,5,850,1.0,582.0,582.0
0.094,6,10,1506,5,395,22.0,127.0,127.0,5,1111,20.0,843.0,843.0
0.039,17,4,284,2,120,0.0,32.0,32.0,2,164,35.0,60.0,54.0
311.477,17,20,1124,10,716,34594.0,48.0,43.0,10,408,34594.0,20.0,12.0
0.005,6,10,2000,5,927,1.0,659.0,659.0,5,1073,1.0,805.0,805.0
0.005,6,10,1989,5,927,1.0,659.0,659.0,5,1062,1.0,794.0,794.0
0.001,17,2,179,1,62,0.0,34.0,34.0,1,117,0.0,89.0,89.0
0.009,6,10,1972,5,910,2.0,642.0,642.0,5,1062,2.0,794.0,794.0
240.093,6,16,4480,9,963,30011.0,238.0,166.0,7,3517,40015.0,1402.0,786.0
0.004,6,10,1702,5,863,1.0,595.0,595.0,5,839,0.0,571.0,571.0
0.005,6,10,2000,5,927,1.0,659.0,659.0,5,1073,1.0,805.0,805.0
0.08,6,10,1506,5,395,19.0,127.0,127.0,5,1111,16.0,843.0,843.0
0.009,6,10,1989,5,910,2.0,642.0,642.0,5,1079,2.0,811.0,811.0
0.012,6,14,3787,7,497,2.0,125.0,125.0,7,3290,2.0,1448.0,972.0
0.04,17,4,352,2,130,1.0,37.0,37.0,2,222,2.0,89.0,83.0
0.005,6,10,2006,5,927,1.0,659.0,659.0,5,1079,1.0,811.0,811.0
0.082,6,10,1506,5,395,16.0,127.0,127.0,5,1111,18.0,843.0,843.0
0.005,6,10,2000,5,927,1.0,659.0,659.0,5,1073,1.0,805.0,805.0
0.119,6,10,1506,5,395,25.0,127.0,127.0,5,1111,26.0,843.0,843.0
0.001,17,2,180,1,66,0.0,38.0,38.0,1,114,0.0,86.0,86.0
40.063,17,10,676,5,460,10012.0,104.0,64.0,5,216,10015.0,20.0,15.0
0.072,17,2,148,1,60,0.0,32.0,32.0,1,88,0.0,60.0,60.0
368.559,6,22,2313,16,867,24570.0,195.0,195.0,6,1446,4637.0,419.0,398.0
40.072,17,10,676,5,460,10016.0,104.0,64.0,5,216,10017.0,20.0,15.0
0.004,17,4,284,2,120,0.0,32.0,32.0,2,164,1.0,60.0,54.0
15.034,17,41,21625,23,18467,682.0,1350.0,774.0,18,3158,882.0,1350.0,147.0
0.045,17,4,284,2,120,4.0,32.0,32.0,2,164,41.0,60.0,54.0
0.014,6,10,1990,5,911,3.0,643.0,643.0,5,1079,3.0,811.0,811.0
0.017,6,10,1989,5,910,4.0,642.0,642.0,5,1079,4.0,811.0,811.0
0.069,6,10,1506,5,395,16.0,127.0,127.0,5,1111,15.0,843.0,843.0
0.01,6,10,1972,5,910,2.0,642.0,642.0,5,1062,2.0,794.0,794.0
0.038,17,2,412,1,61,0.0,33.0,33.0,1,351,0.0,323.0,323.0
0.008,6,10,1989,5,910,2.0,642.0,642.0,5,1079,2.0,811.0,811.0
0.009,6,10,1990,5,911,2.0,643.0,643.0,5,1079,2.0,811.0,811.0
0.019,6,10,1631,5,848,4.0,580.0,580.0,5,783,4.0,515.0,515.0
0.084,6,10,1506,5,395,18.0,127.0,127.0,5,1111,18.0,843.0,843.0
0.018,6,10,1972,5,910,4.0,642.0,642.0,5,1062,4.0,794.0,794.0
0.008,6,10,1990,5,911,2.0,643.0,643.0,5,1079,2.0,811.0,811.0
0.004,17,4,284,2,120,0.0,32.0,32.0,2,164,1.0,60.0,54.0
0.07,17,8,3613,4,1874,23.0,1350.0,440.0,4,1739,12.0,1350.0,406.0
0.005,6,10,1774,5,923,1.0,655.0,655.0,5,851,1.0,583.0,583.0
0.005,6,10,1774,5,923,1.0,655.0,655.0,5,851,1.0,583.0,583.0
0.005,6,10,1779,5,928,1.0,660.0,660.0,5,851,1.0,583.0,583.0
0.004,17,2,148,1,60,0.0,32.0,32.0,1,88,0.0,60.0,60.0
0.023,6,10,1990,5,911,5.0,643.0,643.0,5,1079,5.0,811.0,811.0
0.006,6,10,1643,5,860,1.0,592.0,592.0,5,783,1.0,515.0,515.0
0.004,6,10,2006,5,927,1.0,659.0,659.0,5,1079,1.0,811.0,811.0
0.004,6,10,1989,5,927,1.0,659.0,659.0,5,1062,1.0,794.0,794.0
0.005,6,10,2006,5,927,1.0,659.0,659.0,5,1079,1.0,811.0,811.0
0.004,17,4,284,2,120,0.0,32.0,32.0,2,164,0.0,60.0,54.0
40.059,17,10,676,5,460,10012.0,104.0,64.0,5,216,10013.0,20.0,15.0
40.068,17,10,676,5,460,10014.0,104.0,64.0,5,216,10016.0,20.0,15.0
0.073,6,10,1506,5,395,16.0,127.0,127.0,5,1111,16.0,843.0,843.0
0.118,6,10,1506,5,395,23.0,127.0,127.0,5,1111,25.0,843.0,843.0
0.005,17,2,164,1,74,0.0,46.0,46.0,1,90,0.0,62.0,62.0
40.052,17,10,676,5,460,10012.0,104.0,64.0,5,216,10012.0,20.0,15.0
0.012,6,10,1990,5,911,2.0,643.0,643.0,5,1079,3.0,811.0,811.0
0.005,6,10,2006,5,927,1.0,659.0,659.0,5,1079,1.0,811.0,811.0
0.126,6,10,1506,5,395,30.0,127.0,127.0,5,1111,20.0,843.0,843.0
0.005,6,10,1989,5,927,1.0,659.0,659.0,5,1062,1.0,794.0,794.0
0.006,6,10,2000,5,927,1.0,659.0,659.0,5,1073,1.0,805.0,805.0
0.106,6,10,1506,5,395,20.0,127.0,127.0,5,1111,24.0,843.0,843.0
0.003,17,2,148,1,60,0.0,32.0,32.0,1,88,0.0,60.0,60.0
0.011,6,10,1972,5,910,2.0,642.0,642.0,5,1062,2.0,794.0,794.0
0.086,6,10,1506,5,395,19.0,127.0,127.0,5,1111,20.0,843.0,843.0
0.011,6,10,1972,5,910,2.0,642.0,642.0,5,1062,2.0,794.0,794.0
0.004,6,10,2000,5,927,1.0,659.0,659.0,5,1073,1.0,805.0,805.0
0.033,6,20,9974,11,704,3.0,124.0,124.0,9,9270,4.0,2896.0,1758.0
0.005,17,2,169,1,62,0.0,34.0,34.0,1,107,0.0,79.0,79.0
0.005,17,2,166,1,75,0.0,47.0,47.0,1,91,0.0,63.0,63.0
0.008,6,10,1989,5,910,1.0,642.0,642.0,5,1079,1.0,811.0,811.0
169.275,17,78,11160,39,2597,4454.0,44.0,38.0,39,8563,4454.0,261.0,191.0
0.004,6,10,2007,5,928,1.0,660.0,660.0,5,1079,1.0,811.0,811.0
40.061,17,10,676,5,460,10012.0,104.0,64.0,5,216,10014.0,20.0,15.0
0.076,6,10,1506,5,395,16.0,127.0,127.0,5,1111,13.0,843.0,843.0
0.006,6,10,1689,5,839,1.0,571.0,571.0,5,850,1.0,582.0,582.0
0.005,6,10,2006,5,927,1.0,659.0,659.0,5,1079,1.0,811.0,811.0
0.003,17,2,136,1,60,0.0,32.0,32.0,1,76,0.0,48.0,48.0
0.004,17,4,284,2,120,0.0,32.0,32.0,2,164,0.0,60.0,54.0
40.058,17,10,676,5,460,10013.0,104.0,64.0,5,216,10013.0,20.0,15.0
40.066,17,10,676,5,460,10014.0,104.0,64.0,5,216,10015.0,20.0,15.0
0.075,6,10,1506,5,395,16.0,127.0,127.0,5,1111,16.0,843.0,843.0
368.909,6,22,2313,16,867,24593.0,195.0,195.0,6,1446,4638.0,419.0,398.0
0.004,17,2,136,1,60,0.0,32.0,32.0,1,76,0.0,48.0,48.0
0.011,6,10,1677,5,827,2.0,559.0,559.0,5,850,2.0,582.0,582.0
0.005,6,10,1854,5,889,1.0,621.0,621.0,5,965,1.0,697.0,697.0
40.062,17,10,676,5,460,10014.0,104.0,64.0,5,216,10014.0,20.0,15.0
0.005,6,10,1689,5,839,1.0,571.0,571.0,5,850,1.0,582.0,582.0
40.059,17,10,676,5,460,10013.0,104.0,64.0,5,216,10014.0,20.0,15.0
240.075,6,21,4924,11,941,24007.0,180.0,93.0,10,3983,26674.0,1591.0,575.0
300.386,6,16,2170,9,684,37527.0,146.0,146.0,7,1486,50036.0,419.0,398.0
0.006,6,10,1547,5,764,1.0,496.0,496.0,5,783,1.0,515.0,515.0
240.019,6,9,787,5,488,60004.0,232.0,232.0,4,299,80003.0,83.0,83.0
0.009,6,10,2000,5,927,2.0,659.0,659.0,5,1073,2.0,805.0,805.0
0.009,6,10,1989,5,910,2.0,642.0,642.0,5,1079,2.0,811.0,811.0
0.006,6,10,1854,5,889,1.0,621.0,621.0,5,965,1.0,697.0,697.0
0.006,6,10,1643,5,860,1.0,592.0,592.0,5,783,1.0,515.0,515.0
0.006,6,10,2006,5,927,1.0,659.0,659.0,5,1079,1.0,811.0,811.0
312.57,17,18,1008,9,640,39063.0,48.0,43.0,9,368,39063.0,20.0,12.0
0.104,6,10,1506,5,395,24.0,127.0,127.0,5,1111,20.0,843.0,843.0
0.001,17,2,179,1,62,0.0,34.0,34.0,1,117,0.0,89.0,89.0
0.006,17,2,169,1,62,0.0,34.0,34.0,1,107,0.0,79.0,79.0
15.214,17,18,9401,9,6963,1898.0,1350.0,745.0,9,2438,1898.0,1350.0,242.0
0.005,17,2,214,1,75,0.0,47.0,47.0,1,139,0.0,111.0,111.0
0.006,17,2,170,1,65,0.0,37.0,37.0,1,105,0.0,77.0,77.0
0.09,6,10,1506,5,395,19.0,127.0,127.0,5,1111,18.0,843.0,843.0
0.0,17,2,142,1,63,0.0,35.0,35.0,1,79,0.0,51.0,51.0
40.121,17,10,676,5,460,10029.0,104.0,64.0,5,216,10029.0,20.0,15.0
0.01,6,10,1989,5,910,2.0,642.0,642.0,5,1079,2.0,811.0,811.0
0.073,6,10,1506,5,395,14.0,127.0,127.0,5,1111,17.0,843.0,843.0
0.146,6,10,1506,5,395,34.0,127.0,127.0,5,1111,32.0,843.0,843.0
0.003,17,2,186,1,61,0.0,33.0,33.0,1,125,0.0,97.0,97.0
0.014,6,10,1990,5,911,3.0,643.0,643.0,5,1079,3.0,811.0,811.0
0.001,17,2,180,1,66,0.0,38.0,38.0,1,114,0.0,86.0,86.0
0.321,17,39,20123,21,17042,16.0,1350.0,783.0,18,3081,15.0,1350.0,143.0
0.003,17,2,136,1,60,0.0,32.0,32.0,1,76,0.0,48.0,48.0
0.005,6,10,2006,5,927,1.0,659.0,659.0,5,1079,1.0,811.0,811.0
0.09,6,10,1506,5,395,20.0,127.0,127.0,5,1111,21.0,843.0,843.0
0.007,17,2,179,1,71,0.0,43.0,43.0,1,108,0.0,80.0,80.0
0.097,6,10,1506,5,395,20.0,127.0,127.0,5,1111,23.0,843.0,843.0
0.003,17,2,136,1,60,0.0,32.0,32.0,1,76,0.0,48.0,48.0
0.005,6,10,2000,5,927,1.0,659.0,659.0,5,1073,1.0,805.0,805.0
0.075,6,10,1506,5,395,16.0,127.0,127.0,5,1111,16.0,843.0,843.0
0.005,6,10,1689,5,839,1.0,571.0,571.0,5,850,1.0,582.0,582.0
0.005,6,10,2006,5,927,1.0,659.0,659.0,5,1079,1.0,811.0,811.0
0.016,6,10,1989,5,910,4.0,642.0,642.0,5,1079,4.0,811.0,811.0
0.011,6,10,1631,5,848,2.0,580.0,580.0,5,783,2.0,515.0,515.0
0.006,6,10,1547,5,764,1.0,496.0,496.0,5,783,1.0,515.0,515.0
0.006,6,10,1547,5,764,1.0,496.0,496.0,5,783,1.0,515.0,515.0
40.058,17,10,676,5,460,10013.0,104.0,64.0,5,216,10013.0,20.0,15.0
240.161,6,48,6951,23,3288,10916.0,588.0,230.0,25,3663,10006.0,580.0,214.0
0.001,17,2,180,1,66,0.0,38.0,38.0,1,114,0.0,86.0,86.0
0.014,6,13,3735,7,497,2.0,125.0,125.0,6,3238,2.0,1470.0,1459.0
354.067,6,21,1795,16,1030,23604.0,190.0,190.0,5,765,60002.0,464.0,248.0
0.009,6,13,3735,7,497,1.0,125.0,125.0,6,3238,1.0,1470.0,1459.0
0.004,17,2,152,1,76,0.0,48.0,48.0,1,76,0.0,48.0,48.0
0.005,6,10,1989,5,927,1.0,659.0,659.0,5,1062,1.0,794.0,794.0
0.072,17,4,284,2,120,0.0,32.0,32.0,2,164,69.0,60.0,54.0
0.004,17,2,178,1,81,0.0,53.0,53.0,1,97,0.0,69.0,69.0
0.126,17,2,80,1,32,0.0,4.0,4.0,1,48,0.0,20.0,20.0
0.001,17,2,180,1,66,0.0,38.0,38.0,1,114,0.0,86.0,86.0
0.098,6,10,1506,5,395,23.0,127.0,127.0,5,1111,20.0,843.0,843.0
0.127,17,2,182,1,65,0.0,37.0,37.0,1,117,0.0,89.0,89.0
0.083,6,10,1506,5,395,17.0,127.0,127.0,5,1111,19.0,843.0,843.0
0.012,6,10,1631,5,848,3.0,580.0,580.0,5,783,2.0,515.0,515.0
0.006,6,10,2006,5,927,1.0,659.0,659.0,5,1079,1.0,811.0,811.0
0.003,17,4,420,2,122,0.0,33.0,33.0,2,298,0.0,145.0,121.0
0.012,6,10,1972,5,910,3.0,642.0,642.0,5,1062,3.0,794.0,794.0
0.004,6,10,2007,5,928,1.0,660.0,660.0,5,1079,1.0,811.0,811.0
0.005,6,10,1689,5,839,1.0,571.0,571.0,5,850,1.0,582.0,582.0
0.042,17,2,136,1,60,0.0,32.0,32.0,1,76,0.0,48.0,48.0
0.006,6,10,1547,5,764,1.0,496.0,496.0,5,783,1.0,515.0,515.0
1.129,6,26,10410,14,1575,86.0,517.0,211.0,12,8835,102.0,1402.0,911.0
0.004,6,10,1779,5,928,1.0,660.0,660.0,5,851,1.0,583.0,583.0
0.073,6,10,1506,5,395,17.0,127.0,127.0,5,1111,15.0,843.0,843.0
0.018,17,2,230,1,68,0.0,40.0,40.0,1,162,0.0,134.0,134.0
0.012,6,14,3787,7,497,2.0,125.0,125.0,7,3290,1.0,1448.0,972.0
0.005,6,10,2000,5,927,1.0,659.0,659.0,5,1073,1.0,805.0,805.0
240.01,6,9,787,5,488,60002.0,232.0,232.0,4,299,80002.0,83.0,83.0
0.005,17,2,214,1,75,0.0,47.0,47.0,1,139,0.0,111.0,111.0
0.005,6,10,1779,5,928,1.0,660.0,660.0,5,851,1.0,583.0,583.0
0.005,17,2,144,1,64,0.0,36.0,36.0,1,80,0.0,52.0,52.0
0.006,6,10,1779,5,928,1.0,660.0,660.0,5,851,1.0,583.0,583.0
0.01,6,10,1990,5,911,2.0,643.0,643.0,5,1079,2.0,811.0,811.0
0.006,6,10,1779,5,928,1.0,660.0,660.0,5,851,1.0,583.0,583.0
0.007,17,2,148,1,60,0.0,32.0,32.0,1,88,0.0,60.0,60.0
0.005,17,2,179,1,71,0.0,43.0,43.0,1,108,0.0,80.0,80.0
0.082,6,10,1506,5,395,18.0,127.0,127.0,5,1111,19.0,843.0,843.0
0.004,17,2,148,1,60,0.0,32.0,32.0,1,88,0.0,60.0,60.0
0.004,6,10,2006,5,927,1.0,659.0,659.0,5,1079,1.0,811.0,811.0
40.078,17,10,676,5,460,10016.0,104.0,64.0,5,216,10018.0,20.0,15.0
0.009,6,10,1989,5,910,2.0,642.0,642.0,5,1079,2.0,811.0,811.0
0.004,6,10,1774,5,923,1.0,655.0,655.0,5,851,0.0,583.0,583.0
0.012,6,10,1990,5,911,3.0,643.0,643.0,5,1079,3.0,811.0,811.0
0.005,6,10,1689,5,839,1.0,571.0,571.0,5,850,1.0,582.0,582.0
0.001,17,2,132,1,58,0.0,30.0,30.0,1,74,0.0,46.0,46.0
0.096,6,10,1506,5,395,21.0,127.0,127.0,5,1111,22.0,843.0,843.0
1769.037,17,92,8096,46,4048,39311.0,60.0,60.0,46,4048,39311.0,60.0,60.0
0.008,6,12,1926,6,1189,1.0,659.0,434.0,6,737,1.0,417.0,417.0
0.005,6,10,2006,5,927,1.0,659.0,659.0,5,1079,1.0,811.0,811.0
0.04,17,2,412,1,61,0.0,33.0,33.0,1,351,0.0,323.0,323.0
0.005,6,10,2006,5,927,1.0,659.0,659.0,5,1079,1.0,811.0,811.0
0.073,6,10,1506,5,395,15.0,127.0,127.0,5,1111,17.0,843.0,843.0
54.43,6,36,9526,18,4008,522.0,1543.0,814.0,18,5518,3191.0,2667.0,435.0
0.012,17,2,136,1,60,0.0,32.0,32.0,1,76,0.0,48.0,48.0
0.009,6,10,1762,5,911,2.0,643.0,643.0,5,851,2.0,583.0,583.0
0.003,6,10,1702,5,863,0.0,595.0,595.0,5,839,0.0,571.0,571.0
0.012,6,10,1990,5,911,3.0,643.0,643.0,5,1079,2.0,811.0,811.0
11.18,17,28,4420,14,1993,847.0,268.0,114.0,14,2427,847.0,586.0,145.0
0.207,6,12,1086,6,397,37.0,65.0,65.0,6,689,37.0,369.0,369.0
0.004,17,2,230,1,68,0.0,40.0,40.0,1,162,0.0,134.0,134.0
0.008,17,2,194,1,59,0.0,31.0,31.0,1,135,0.0,107.0,107.0
0.023,6,14,3787,7,497,3.0,125.0,125.0,7,3290,3.0,1448.0,972.0
0.118,6,10,1506,5,395,26.0,127.0,127.0,5,1111,24.0,843.0,843.0
0.159,6,10,1506,5,395,38.0,127.0,127.0,5,1111,23.0,843.0,843.0
0.005,6,10,1989,5,927,1.0,659.0,659.0,5,1062,1.0,794.0,794.0
0.096,6,10,1506,5,395,19.0,127.0,127.0,5,1111,23.0,843.0,843.0
324.161,17,18,1008,9,640,40504.0,48.0,43.0,9,368,40504.0,20.0,12.0
0.064,6,10,1506,5,395,15.0,127.0,127.0,5,1111,13.0,843.0,843.0
0.018,6,10,1972,5,910,4.0,642.0,642.0,5,1062,4.0,794.0,794.0
0.072,17,4,284,2,120,1.0,32.0,32.0,2,164,68.0,60.0,54.0
0.004,6,10,2006,5,927,1.0,659.0,659.0,5,1079,1.0,811.0,811.0
0.004,17,2,148,1,60,0.0,32.0,32.0,1,88,0.0,60.0,60.0
0.006,6,10,1854,5,889,1.0,621.0,621.0,5,965,1.0,697.0,697.0
353.991,6,21,1795,16,1030,23599.0,190.0,190.0,5,765,60002.0,464.0,248.0
308.434,17,20,1124,10,716,34256.0,48.0,43.0,10,408,34256.0,20.0,12.0
0.004,6,10,1774,5,923,1.0,655.0,655.0,5,851,1.0,583.0,583.0
0.004,17,2,136,1,60,0.0,32.0,32.0,1,76,0.0,48.0,48.0
240.091,6,16,4481,9,963,30011.0,238.0,166.0,7,3518,40014.0,1402.0,786.0
0.009,6,10,1972,5,910,2.0,642.0,642.0,5,1062,2.0,794.0,794.0
0.072,6,10,1506,5,395,16.0,127.0,127.0,5,1111,15.0,843.0,843.0
0.095,6,10,1506,5,395,20.0,127.0,127.0,5,1111,21.0,843.0,843.0
0.006,17,2,169,1,62,0.0,34.0,34.0,1,107,0.0,79.0,79.0
0.125,6,10,1506,5,395,18.0,127.0,127.0,5,1111,29.0,843.0,843.0
0.004,6,10,1702,5,863,1.0,595.0,595.0,5,839,0.0,571.0,571.0
0.004,6,10,1702,5,863,1.0,595.0,595.0,5,839,0.0,571.0,571.0
0.008,6,10,1677,5,827,2.0,559.0,559.0,5,850,2.0,582.0,582.0
0.004,6,10,2007,5,928,1.0,660.0,660.0,5,1079,1.0,811.0,811.0
0.054,17,2,152,1,76,0.0,48.0,48.0,1,76,0.0,48.0,48.0
247.062,6,14,1487,9,912,30882.0,212.0,212.0,5,575,60011.0,295.0,295.0
0.008,6,13,3735,7,497,1.0,125.0,125.0,6,3238,1.0,1470.0,1459.0
0.008,6,10,1774,5,923,2.0,655.0,655.0,5,851,1.0,583.0,583.0
0.005,17,2,144,1,64,0.0,36.0,36.0,1,80,0.0,52.0,52.0
0.001,17,2,180,1,66,0.0,38.0,38.0,1,114,0.0,86.0,86.0
40.061,17,10,676,5,460,10014.0,104.0,64.0,5,216,10014.0,20.0,15.0
0.004,17,2,148,1,60,0.0,32.0,32.0,1,88,0.0,60.0,60.0
0.003,17,2,148,1,60,0.0,32.0,32.0,1,88,0.0,60.0,60.0
0.005,6,10,2007,5,928,1.0,660.0,660.0,5,1079,1.0,811.0,811.0
0.004,6,10,1779,5,928,1.0,660.0,660.0,5,851,1.0,583.0,583.0
0.005,6,13,3690,7,452,0.0,80.0,80.0,6,3238,1.0,1470.0,1459.0
0.109,6,10,1506,5,395,24.0,127.0,127.0,5,1111,24.0,843.0,843.0
0.125,17,2,170,1,65,0.0,37.0,37.0,1,105,0.0,77.0,77.0
0.006,17,2,164,1,74,0.0,46.0,46.0,1,90,0.0,62.0,62.0
0.091,6,10,1506,5,395,20.0,127.0,127.0,5,1111,16.0,843.0,843.0
0.104,6,10,1506,5,395,21.0,127.0,127.0,5,1111,24.0,843.0,843.0
0.004,6,10,1702,5,863,1.0,595.0,595.0,5,839,0.0,571.0,571.0
240.093,6,16,4481,9,963,30011.0,238.0,166.0,7,3518,40014.0,1402.0,786.0
0.003,17,2,136,1,60,0.0,32.0,32.0,1,76,0.0,48.0,48.0
0.005,17,2,214,1,75,0.0,47.0,47.0,1,139,0.0,111.0,111.0
0.011,6,10,1990,5,911,2.0,643.0,643.0,5,1079,2.0,811.0,811.0
0.146,6,10,1506,5,395,35.0,127.0,127.0,5,1111,33.0,843.0,843.0
0.004,17,2,148,1,60,0.0,32.0,32.0,1,88,0.0,60.0,60.0
0.15,6,10,1506,5,395,33.0,127.0,127.0,5,1111,32.0,843.0,843.0
0.011,17,4,284,2,120,0.0,32.0,32.0,2,164,0.0,60.0,54.0
0.01,6,10,1990,5,911,2.0,643.0,643.0,5,1079,2.0,811.0,811.0
0.079,6,10,1506,5,395,18.0,127.0,127.0,5,1111,19.0,843.0,843.0
0.071,6,10,1506,5,395,16.0,127.0,127.0,5,1111,13.0,843.0,843.0
40.064,17,10,676,5,460,10015.0,104.0,64.0,5,216,10015.0,20.0,15.0
0.024,6,10,1990,5,911,6.0,643.0,643.0,5,1079,5.0,811.0,811.0
0.005,6,13,3747,7,509,0.0,137.0,137.0,6,3238,1.0,1470.0,1459.0
40.086,17,10,676,5,460,10019.0,104.0,64.0,5,216,10020.0,20.0,15.0
0.001,17,2,180,1,66,0.0,38.0,38.0,1,114,0.0,86.0,86.0
0.012,6,10,1972,5,910,3.0,642.0,642.0,5,1062,3.0,794.0,794.0
0.007,6,10,1774,5,923,1.0,655.0,655.0,5,851,1.0,583.0,583.0
0.006,6,12,1698,6,863,1.0,327.0,271.0,6,835,1.0,515.0,515.0
0.016,6,10,1989,5,910,4.0,642.0,642.0,5,1079,3.0,811.0,811.0
0.084,6,10,1506,5,395,19.0,127.0,127.0,5,1111,19.0,843.0,843.0
20.969,6,35,9629,17,4111,550.0,1686.0,849.0,18,5518,1223.0,2667.0,435.0
40.059,17,10,676,5,460,10011.0,104.0,64.0,5,216,10013.0,20.0,15.0
0.005,17,2,169,1,62,0.0,34.0,34.0,1,107,0.0,79.0,79.0
0.004,6,10,1779,5,928,1.0,660.0,660.0,5,851,1.0,583.0,583.0
40.06,17,10,676,5,460,10014.0,104.0,64.0,5,216,10012.0,20.0,15.0
0.014,6,10,1972,5,910,3.0,642.0,642.0,5,1062,3.0,794.0,794.0
0.117,6,10,1506,5,395,27.0,127.0,127.0,5,1111,25.0,843.0,843.0
0.088,6,10,1506,5,395,21.0,127.0,127.0,5,1111,18.0,843.0,843.0
0.005,6,10,1547,5,764,1.0,496.0,496.0,5,783,1.0,515.0,515.0
0.005,17,2,214,1,75,0.0,47.0,47.0,1,139,0.0,111.0,111.0
0.005,6,10,1989,5,927,1.0,659.0,659.0,5,1062,1.0,794.0,794.0
0.005,17,2,170,1,65,0.0,37.0,37.0,1,105,0.0,77.0,77.0
0.089,6,10,1506,5,395,20.0,127.0,127.0,5,1111,19.0,843.0,843.0
0.006,6,10,1547,5,764,1.0,496.0,496.0,5,783,1.0,515.0,515.0
1768.859,17,92,8096,46,4048,39307.0,60.0,60.0,46,4048,39307.0,60.0,60.0
0.006,6,10,1689,5,839,1.0,571.0,571.0,5,850,1.0,582.0,582.0
0.02,6,10,1989,5,910,5.0,642.0,642.0,5,1079,4.0,811.0,811.0
0.008,6,10,1990,5,911,2.0,643.0,643.0,5,1079,2.0,811.0,811.0
0.005,6,10,2007,5,928,1.0,660.0,660.0,5,1079,1.0,811.0,811.0
0.002,17,2,152,1,76,0.0,48.0,48.0,1,76,0.0,48.0,48.0
0.005,6,10,2007,5,928,1.0,660.0,660.0,5,1079,1.0,811.0,811.0
0.005,6,10,2007,5,928,1.0,660.0,660.0,5,1079,1.0,811.0,811.0
0.187,6,43,11475,23,3169,8.0,1021.0,197.0,20,8306,9.0,1402.0,659.0
0.103,6,10,1506,5,395,21.0,127.0,127.0,5,1111,23.0,843.0,843.0
0.039,17,2,136,1,60,0.0,32.0,32.0,1,76,0.0,48.0,48.0
0.015,6,10,1972,5,910,3.0,642.0,642.0,5,1062,3.0,794.0,794.0
0.008,6,10,1983,5,910,2.0,642.0,642.0,5,1073,2.0,805.0,805.0
0.005,6,10,1547,5,764,1.0,496.0,496.0,5,783,1.0,515.0,515.0
0.005,6,10,1689,5,839,1.0,571.0,571.0,5,850,1.0,582.0,582.0
0.012,6,10,1990,5,911,2.0,643.0,643.0,5,1079,3.0,811.0,811.0
0.004,17,2,148,1,60,0.0,32.0,32.0,1,88,0.0,60.0,60.0
0.006,6,10,1547,5,764,1.0,496.0,496.0,5,783,1.0,515.0,515.0
0.005,17,2,168,1,76,0.0,48.0,48.0,1,92,0.0,64.0,64.0
0.07,6,10,1506,5,395,15.0,127.0,127.0,5,1111,14.0,843.0,843.0
0.005,6,10,2006,5,927,1.0,659.0,659.0,5,1079,1.0,811.0,811.0
0.001,17,2,180,1,66,0.0,38.0,38.0,1,114,0.0,86.0,86.0
0.12,6,10,1506,5,395,24.0,127.0,127.0,5,1111,25.0,843.0,843.0
0.111,6,10,1506,5,395,22.0,127.0,127.0,5,1111,26.0,843.0,843.0
0.128,17,2,80,1,32,0.0,4.0,4.0,1,48,0.0,20.0,20.0
0.005,6,10,1643,5,860,1.0,592.0,592.0,5,783,1.0,515.0,515.0
0.004,17,4,284,2,120,0.0,32.0,32.0,2,164,0.0,60.0,54.0
241.359,6,38,11158,18,2719,14195.0,761.0,295.0,20,8439,12701.0,1402.0,569.0
0.005,6,10,1989,5,927,1.0,659.0,659.0,5,1062,1.0,794.0,794.0
0.094,6,10,1506,5,395,21.0,127.0,127.0,5,1111,19.0,843.0,843.0
0.004,6,10,2006,5,927,1.0,659.0,659.0,5,1079,1.0,811.0,811.0
0.012,6,10,1677,5,827,3.0,559.0,559.0,5,850,2.0,582.0,582.0
378.703,6,22,2313,16,867,25246.0,195.0,195.0,6,1446,4643.0,419.0,398.0
0.006,6,10,1689,5,839,1.0,571.0,571.0,5,850,1.0,582.0,582.0
40.063,17,10,676,5,460,10013.0,104.0,64.0,5,216,10015.0,20.0,15.0
0.011,6,10,1972,5,910,2.0,642.0,642.0,5,1062,2.0,794.0,794.0
0.005,17,2,184,1,68,0.0,40.0,40.0,1,116,0.0,88.0,88.0
0.005,6,14,3742,7,452,0.0,80.0,80.0,7,3290,0.0,1448.0,972.0
0.098,6,10,1506,5,395,22.0,127.0,127.0,5,1111,21.0,843.0,843.0
0.044,17,2,148,1,60,0.0,32.0,32.0,1,88,0.0,60.0,60.0
0.006,6,10,1989,5,927,1.0,659.0,659.0,5,1062,1.0,794.0,794.0
241.351,6,39,11254,18,2719,14195.0,761.0,295.0,21,8535,12065.0,1402.0,531.0
10.773,17,28,4423,14,1995,820.0,270.0,114.0,14,2428,820.0,587.0,145.0
0.015,6,10,1972,5,910,3.0,642.0,642.0,5,1062,3.0,794.0,794.0
0.01,6,10,1989,5,910,2.0,642.0,642.0,5,1079,2.0,811.0,811.0
0.003,17,2,187,1,74,0.0,46.0,46.0,1,113,0.0,85.0,85.0
0.005,6,14,3799,7,509,0.0,137.0,137.0,7,3290,0.0,1448.0,972.0
0.001,17,2,180,1,66,0.0,38.0,38.0,1,114,0.0,86.0,86.0
0.005,6,14,3742,8,504,0.0,80.0,80.0,6,3238,0.0,1470.0,1459.0
0.004,6,10,1779,5,928,1.0,660.0,660.0,5,851,1.0,583.0,583.0
165.083,17,68,9778,34,2274,5002.0,44.0,38.0,34,7504,5002.0,239.0,192.0
0.097,6,10,1506,5,395,20.0,127.0,127.0,5,1111,22.0,843.0,843.0
0.016,6,10,1677,5,827,4.0,559.0,559.0,5,850,3.0,582.0,582.0
0.174,17,2,152,1,76,0.0,48.0,48.0,1,76,0.0,48.0,48.0
240.01,6,9,787,5,488,60002.0,232.0,232.0,4,299,80002.0,83.0,83.0
0.006,6,10,1643,5,860,1.0,592.0,592.0,5,783,1.0,515.0,515.0
0.111,6,10,1506,5,395,23.0,127.0,127.0,5,1111,25.0,843.0,843.0
0.011,6,10,1989,5,910,2.0,642.0,642.0,5,1079,2.0,811.0,811.0
0.006,6,10,1689,5,839,1.0,571.0,571.0,5,850,1.0,582.0,582.0
0.003,17,4,284,2,120,0.0,32.0,32.0,2,164,0.0,60.0,54.0
0.169,17,2,152,1,76,0.0,48.0,48.0,1,76,0.0,48.0,48.0
0.03,6,10,1989,5,910,7.0,642.0,642.0,5,1079,7.0,811.0,811.0
0.008,6,10,1990,5,911,1.0,643.0,643.0,5,1079,2.0,811.0,811.0
0.006,6,10,1547,5,764,1.0,496.0,496.0,5,783,1.0,515.0,515.0
0.011,6,10,1989,5,910,2.0,642.0,642.0,5,1079,2.0,811.0,811.0
0.01,6,10,1631,5,848,2.0,580.0,580.0,5,783,2.0,515.0,515.0
0.011,6,10,1989,5,910,2.0,642.0,642.0,5,1079,2.0,811.0,811.0
0.001,17,2,180,1,66,0.0,38.0,38.0,1,114,0.0,86.0,86.0
40.055,17,10,676,5,460,10012.0,104.0,64.0,5,216,10013.0,20.0,15.0
0.005,6,10,1774,5,923,1.0,655.0,655.0,5,851,1.0,583.0,583.0
0.122,6,10,1506,5,395,27.0,127.0,127.0,5,1111,26.0,843.0,843.0
0.088,6,10,1506,5,395,20.0,127.0,127.0,5,1111,19.0,843.0,843.0
317.944,17,20,1124,10,716,35313.0,48.0,43.0,10,408,35313.0,20.0,12.0
240.164,6,42,5409,22,2530,11436.0,588.0,196.0,20,2879,12640.0,580.0,228.0
0.005,6,10,1989,5,927,1.0,659.0,659.0,5,1062,1.0,794.0,794.0
0.105,6,10,1506,5,395,25.0,127.0,127.0,5,1111,22.0,843.0,843.0
0.073,6,10,1506,5,395,16.0,127.0,127.0,5,1111,16.0,843.0,843.0
10.735,17,28,4422,14,1994,817.0,269.0,114.0,14,2428,817.0,587.0,145.0
0.008,17,2,194,1,59,0.0,31.0,31.0,1,135,0.0,107.0,107.0
0.008,6,10,1989,5,910,1.0,642.0,642.0,5,1079,2.0,811.0,811.0
351.99,6,20,2210,6,1308,12003.0,494.0,494.0,14,902,27075.0,83.0,83.0
315.363,17,20,1124,10,716,35026.0,48.0,43.0,10,408,35026.0,20.0,12.0
0.067,6,10,1506,5,395,15.0,127.0,127.0,5,1111,15.0,843.0,843.0
0.149,6,10,1506,5,395,33.0,127.0,127.0,5,1111,34.0,843.0,843.0
0.216,6,16,2669,8,1395,30.0,533.0,323.0,8,1274,19.0,529.0,212.0
0.018,6,10,1972,5,910,4.0,642.0,642.0,5,1062,4.0,794.0,794.0
15.072,17,14,9191,8,6902,2148.0,1350.0,834.0,6,2289,3008.0,1350.0,353.0
0.005,6,10,1547,5,764,1.0,496.0,496.0,5,783,1.0,515.0,515.0
368.968,6,24,2405,17,919,23060.0,195.0,195.0,7,1486,3902.0,419.0,398.0
0.039,17,2,148,1,60,0.0,32.0,32.0,1,88,0.0,60.0,60.0
0.022,6,13,3735,7,497,3.0,125.0,125.0,6,3238,4.0,1470.0,1459.0
0.0,17,2,164,1,74,0.0,46.0,46.0,1,90,0.0,62.0,62.0
0.008,6,10,1702,5,863,1.0,595.0,595.0,5,839,2.0,571.0,571.0
352.251,6,20,2210,6,1308,12004.0,494.0,494.0,14,902,27096.0,83.0,83.0
0.005,17,2,166,1,75,0.0,47.0,47.0,1,91,0.0,63.0,63.0
0.012,6,10,1972,5,910,3.0,642.0,642.0,5,1062,2.0,794.0,794.0
0.011,6,10,1677,5,827,2.0,559.0,559.0,5,850,2.0,582.0,582.0
0.012,6,10,1990,5,911,3.0,643.0,643.0,5,1079,2.0,811.0,811.0
0.003,17,2,136,1,60,0.0,32.0,32.0,1,76,0.0,48.0,48.0
0.005,6,10,2007,5,928,1.0,660.0,660.0,5,1079,1.0,811.0,811.0
0.005,6,10,2006,5,927,1.0,659.0,659.0,5,1079,1.0,811.0,811.0
0.041,17,2,156,1,64,0.0,36.0,36.0,1,92,0.0,64.0,64.0
0.009,17,2,194,1,59,0.0,31.0,31.0,1,135,0.0,107.0,107.0
0.077,6,10,1506,5,395,17.0,127.0,127.0,5,1111,17.0,843.0,843.0
0.006,6,10,1547,5,764,1.0,496.0,496.0,5,783,1.0,515.0,515.0
0.005,6,10,2006,5,927,1.0,659.0,659.0,5,1079,1.0,811.0,811.0
0.072,6,10,1506,5,395,13.0,127.0,127.0,5,1111,17.0,843.0,843.0
40.065,17,10,676,5,460,10014.0,104.0,64.0,5,216,10015.0,20.0,15.0
0.004,17,2,136,1,60,0.0,32.0,32.0,1,76,0.0,48.0,48.0
0.15,6,10,1506,5,395,30.0,127.0,127.0,5,1111,34.0,843.0,843.0
0.01,6,12,1926,6,1189,2.0,659.0,434.0,6,737,1.0,417.0,417.0
0.003,17,2,136,1,60,0.0,32.0,32.0,1,76,0.0,48.0,48.0
264.472,17,18,1008,9,640,33047.0,48.0,43.0,9,368,33047.0,20.0,12.0
0.012,6,10,1972,5,910,3.0,642.0,642.0,5,1062,3.0,794.0,794.0
0.014,6,10,1989,5,910,3.0,642.0,642.0,5,1079,3.0,811.0,811.0
0.005,6,10,2006,5,927,1.0,659.0,659.0,5,1079,1.0,811.0,811.0
0.005,6,10,2006,5,927,1.0,659.0,659.0,5,1079,1.0,811.0,811.0
0.011,6,10,1990,5,911,2.0,643.0,643.0,5,1079,2.0,811.0,811.0
0.011,6,10,1989,5,910,2.0,642.0,642.0,5,1079,2.0,811.0,811.0
0.036,6,10,1605,5,388,9.0,120.0,120.0,5,1217,8.0,949.0,949.0
0.009,6,10,1972,5,910,2.0,642.0,642.0,5,1062,2.0,794.0,794.0
0.004,17,2,148,1,60,0.0,32.0,32.0,1,88,0.0,60.0,60.0
0.006,6,10,1643,5,860,1.0,592.0,592.0,5,783,1.0,515.0,515.0
0.005,17,2,170,1,65,0.0,37.0,37.0,1,105,0.0,77.0,77.0
0.172,17,2,152,1,76,0.0,48.0,48.0,1,76,0.0,48.0,48.0
0.005,6,14,3742,8,504,0.0,80.0,80.0,6,3238,1.0,1470.0,1459.0
0.005,17,2,180,1,58,0.0,30.0,30.0,1,122,0.0,94.0,94.0
40.064,17,10,676,5,460,10015.0,104.0,64.0,5,216,10015.0,20.0,15.0
0.076,6,10,1506,5,395,17.0,127.0,127.0,5,1111,15.0,843.0,843.0
0.004,6,10,2007,5,928,1.0,660.0,660.0,5,1079,1.0,811.0,811.0
1770.629,17,120,11460,60,5460,30010.0,63.0,63.0,60,6000,30010.0,72.0,72.0
0.103,6,10,1506,5,395,21.0,127.0,127.0,5,1111,20.0,843.0,843.0
0.004,6,10,2006,5,927,1.0,659.0,659.0,5,1079,1.0,811.0,811.0
0.01,6,10,1989,5,910,2.0,642.0,642.0,5,1079,2.0,811.0,811.0
0.005,6,10,1989,5,927,1.0,659.0,659.0,5,1062,1.0,794.0,794.0
0.004,6,10,2007,5,928,1.0,660.0,660.0,5,1079,1.0,811.0,811.0
0.009,6,10,1972,5,910,2.0,642.0,642.0,5,1062,2.0,794.0,794.0
0.005,17,2,144,1,64,0.0,36.0,36.0,1,80,0.0,52.0,52.0
0.126,17,2,166,1,75,0.0,47.0,47.0,1,91,0.0,63.0,63.0
0.007,17,2,214,1,75,0.0,47.0,47.0,1,139,0.0,111.0,111.0
0.027,6,10,1677,5,827,6.0,559.0,559.0,5,850,6.0,582.0,582.0
0.005,6,14,3799,7,509,0.0,137.0,137.0,7,3290,0.0,1448.0,972.0
0.005,6,10,1689,5,839,1.0,571.0,571.0,5,850,1.0,582.0,582.0
111.996,6,26,9525,12,1627,91.0,794.0,367.0,14,7898,8605.0,1360.0,732.0
0.004,6,10,2006,5,927,1.0,659.0,659.0,5,1079,1.0,811.0,811.0
240.155,6,17,7291,9,2024,30019.0,1496.0,780.0,8,5267,34307.0,2803.0,1210.0
0.026,17,2,136,1,60,0.0,32.0,32.0,1,76,0.0,48.0,48.0
0.077,6,45,14098,25,2617,3.0,517.0,146.0,20,11481,3.0,1402.0,745.0
290.383,6,390,348034,198,21882,1474.0,2736.0,826.0,192,326152,1520.0,2804.0,1786.0
0.001,17,2,136,1,60,0.0,32.0,32.0,1,76,0.0,48.0,48.0
0.007,6,10,1547,5,764,1.0,496.0,496.0,5,783,1.0,515.0,515.0
0.072,6,10,1506,5,395,16.0,127.0,127.0,5,1111,16.0,843.0,843.0
0.011,6,10,1972,5,910,2.0,642.0,642.0,5,1062,2.0,794.0,794.0
0.009,6,14,3787,7,497,1.0,125.0,125.0,7,3290,1.0,1448.0,972.0
11.001,17,28,4393,14,2312,837.0,587.0,137.0,14,2081,837.0,268.0,120.0
0.01,6,10,1990,5,911,2.0,643.0,643.0,5,1079,2.0,811.0,811.0
0.095,6,10,1506,5,395,21.0,127.0,127.0,5,1111,21.0,843.0,843.0
0.006,6,10,1547,5,764,1.0,496.0,496.0,5,783,1.0,515.0,515.0
0.101,6,10,1506,5,395,22.0,127.0,127.0,5,1111,20.0,843.0,843.0
0.015,6,10,1631,5,848,3.0,580.0,580.0,5,783,3.0,515.0,515.0
0.001,17,2,180,1,66,0.0,38.0,38.0,1,114,0.0,86.0,86.0
0.005,17,2,170,1,65,0.0,37.0,37.0,1,105,0.0,77.0,77.0
0.006,6,10,1547,5,764,1.0,496.0,496.0,5,783,1.0,515.0,515.0
0.005,6,10,1854,5,889,1.0,621.0,621.0,5,965,1.0,697.0,697.0
0.02,6,10,1989,5,910,5.0,642.0,642.0,5,1079,4.0,811.0,811.0
0.093,6,10,1506,5,395,21.0,127.0,127.0,5,1111,20.0,843.0,843.0
0.005,6,10,2007,5,928,1.0,660.0,660.0,5,1079,1.0,811.0,811.0
0.005,17,2,164,1,74,0.0,46.0,46.0,1,90,0.0,62.0,62.0
0.003,17,2,187,1,74,0.0,46.0,46.0,1,113,0.0,85.0,85.0
0.005,17,2,166,1,75,0.0,47.0,47.0,1,91,0.0,63.0,63.0
0.005,6,10,1854,5,889,1.0,621.0,621.0,5,965,1.0,697.0,697.0
0.041,17,2,152,1,76,0.0,48.0,48.0,1,76,0.0,48.0,48.0
0.006,6,10,1547,5,764,1.0,496.0,496.0,5,783,1.0,515.0,515.0
182.27,6,48,13308,27,4632,7010.0,1025.0,270.0,21,8676,9113.0,2694.0,689.0
0.005,17,2,214,1,75,0.0,47.0,47.0,1,139,0.0,111.0,111.0
0.006,17,2,170,1,65,0.0,37.0,37.0,1,105,0.0,77.0,77.0
0.012,6,10,1990,5,911,3.0,643.0,643.0,5,1079,3.0,811.0,811.0
0.005,17,2,222,1,65,0.0,37.0,37.0,1,157,0.0,129.0,129.0
0.006,17,2,164,1,74,0.0,46.0,46.0,1,90,0.0,62.0,62.0
0.014,6,14,3787,7,497,2.0,125.0,125.0,7,3290,2.0,1448.0,972.0
9.036,17,6,376,5,280,2259.0,28.0,28.0,1,96,0.0,68.0,68.0
0.114,6,10,1506,5,395,25.0,127.0,127.0,5,1111,24.0,843.0,843.0
0.005,6,10,2000,5,927,1.0,659.0,659.0,5,1073,1.0,805.0,805.0
0.008,6,10,1677,5,827,2.0,559.0,559.0,5,850,2.0,582.0,582.0
0.012,6,10,1983,5,910,2.0,642.0,642.0,5,1073,3.0,805.0,805.0
0.011,6,10,1989,5,910,2.0,642.0,642.0,5,1079,2.0,811.0,811.0
0.002,17,2,166,1,75,0.0,47.0,47.0,1,91,0.0,63.0,63.0
0.005,6,10,2007,5,928,1.0,660.0,660.0,5,1079,1.0,811.0,811.0
1792.647,6,601,196658,303,166894,5935.0,2883.0,873.0,298,29764,6035.0,580.0,121.0
0.037,17,2,146,1,65,0.0,37.0,37.0,1,81,0.0,53.0,53.0
0.012,6,10,1972,5,910,2.0,642.0,642.0,5,1062,3.0,794.0,794.0
0.001,17,2,179,1,62,0.0,34.0,34.0,1,117,0.0,89.0,89.0
0.028,6,10,1972,5,910,7.0,642.0,642.0,5,1062,6.0,794.0,794.0
0.013,6,10,1990,5,911,3.0,643.0,643.0,5,1079,3.0,811.0,811.0
0.005,6,10,2006,5,927,1.0,659.0,659.0,5,1079,1.0,811.0,811.0
0.001,17,2,180,1,66,0.0,38.0,38.0,1,114,0.0,86.0,86.0
310.819,17,18,1008,9,640,38835.0,48.0,43.0,9,368,38835.0,20.0,12.0
0.005,17,2,169,1,62,0.0,34.0,34.0,1,107,0.0,79.0,79.0
0.086,6,10,1506,5,395,19.0,127.0,127.0,5,1111,17.0,843.0,843.0
0.039,17,4,284,2,120,0.0,32.0,32.0,2,164,36.0,60.0,54.0
0.112,6,10,1506,5,395,26.0,127.0,127.0,5,1111,22.0,843.0,843.0
176.476,17,78,11259,39,2606,4643.0,44.0,38.0,39,8653,4644.0,239.0,193.0
0.003,17,2,136,1,60,0.0,32.0,32.0,1,76,0.0,48.0,48.0
0.005,17,2,164,1,74,0.0,46.0,46.0,1,90,0.0,62.0,62.0
0.138,17,2,80,1,32,0.0,4.0,4.0,1,48,0.0,20.0,20.0
0.009,6,10,1990,5,911,2.0,643.0,643.0,5,1079,2.0,811.0,811.0
0.001,17,2,180,1,66,0.0,38.0,38.0,1,114,0.0,86.0,86.0
0.006,6,10,1643,5,860,1.0,592.0,592.0,5,783,1.0,515.0,515.0
0.106,6,10,1506,5,395,24.0,127.0,127.0,5,1111,25.0,843.0,843.0
0.005,6,10,2000,5,927,1.0,659.0,659.0,5,1073,1.0,805.0,805.0
163.324,6,31,18604,17,12587,59.0,2720.0,1484.0,14,6017,12550.0,2720.0,907.0
240.014,6,9,787,5,488,60003.0,232.0,232.0,4,299,80003.0,83.0,83.0
0.004,6,10,2006,5,927,1.0,659.0,659.0,5,1079,1.0,811.0,811.0
0.006,17,2,164,1,74,0.0,46.0,46.0,1,90,0.0,62.0,62.0
0.006,6,10,1547,5,764,1.0,496.0,496.0,5,783,1.0,515.0,515.0
0.004,6,10,1702,5,863,1.0,595.0,595.0,5,839,1.0,571.0,571.0
0.017,6,10,1989,5,910,4.0,642.0,642.0,5,1079,4.0,811.0,811.0
1770.476,17,92,8096,46,4048,39343.0,60.0,60.0,46,4048,39343.0,60.0,60.0
1070.941,6,44,13986,23,6325,48678.0,973.0,512.0,21,7661,53546.0,1402.0,657.0
0.143,6,10,1506,5,395,33.0,127.0,127.0,5,1111,30.0,843.0,843.0
0.005,6,10,1989,5,927,1.0,659.0,659.0,5,1062,1.0,794.0,794.0
0.006,6,10,1989,5,927,1.0,659.0,659.0,5,1062,1.0,794.0,794.0
0.005,6,10,1989,5,927,1.0,659.0,659.0,5,1062,1.0,794.0,794.0
15.033,17,44,20693,24,17202,652.0,1350.0,688.0,20,3491,789.0,1350.0,146.0
308.418,17,18,1008,9,640,38544.0,48.0,43.0,9,368,38544.0,20.0,12.0
170.176,17,94,13345,47,3150,3699.0,44.0,39.0,47,10195,3699.0,239.0,188.0
0.012,6,10,1989,5,910,2.0,642.0,642.0,5,1079,3.0,811.0,811.0
40.057,17,9,628,5,460,10012.0,104.0,64.0,4,168,13349.0,20.0,14.0
0.012,6,10,1989,5,910,3.0,642.0,642.0,5,1079,2.0,811.0,811.0
0.104,6,10,1506,5,395,23.0,127.0,127.0,5,1111,23.0,843.0,843.0
0.005,6,13,3747,7,509,0.0,137.0,137.0,6,3238,0.0,1470.0,1459.0
0.015,6,10,1972,5,910,3.0,642.0,642.0,5,1062,3.0,794.0,794.0
0.08,6,10,1506,5,395,16.0,127.0,127.0,5,1111,17.0,843.0,843.0
40.06,17,10,676,5,460,10012.0,104.0,64.0,5,216,10014.0,20.0,15.0
0.011,6,10,1990,5,911,2.0,643.0,643.0,5,1079,2.0,811.0,811.0
0.008,17,2,164,1,74,0.0,46.0,46.0,1,90,0.0,62.0,62.0
0.006,17,2,214,1,75,0.0,47.0,47.0,1,139,0.0,111.0,111.0
0.003,17,2,136,1,60,0.0,32.0,32.0,1,76,0.0,48.0,48.0
0.013,6,10,1677,5,827,3.0,559.0,559.0,5,850,3.0,582.0,582.0
240.108,6,16,4481,9,963,30013.0,238.0,166.0,7,3518,40017.0,1402.0,786.0
1778.896,17,141,44556,72,22752,25052.0,288.0,288.0,69,21804,26150.0,288.0,288.0
0.01,6,10,1990,5,911,2.0,643.0,643.0,5,1079,2.0,811.0,811.0
0.115,6,10,1506,5,395,25.0,127.0,127.0,5,1111,27.0,843.0,843.0
0.014,6,10,1989,5,910,3.0,642.0,642.0,5,1079,3.0,811.0,811.0
0.005,6,10,1989,5,927,1.0,659.0,659.0,5,1062,1.0,794.0,794.0
0.006,6,10,1989,5,927,1.0,659.0,659.0,5,1062,1.0,794.0,794.0
0.006,6,10,2007,5,928,1.0,660.0,660.0,5,1079,1.0,811.0,811.0
0.009,6,10,1677,5,827,2.0,559.0,559.0,5,850,2.0,582.0,582.0
312.2,17,20,1124,10,716,34674.0,48.0,43.0,10,408,34673.0,20.0,12.0
0.004,6,10,1779,5,928,1.0,660.0,660.0,5,851,1.0,583.0,583.0
0.004,17,2,148,1,60,0.0,32.0,32.0,1,88,0.0,60.0,60.0
0.005,6,10,1643,5,860,1.0,592.0,592.0,5,783,1.0,515.0,515.0
0.013,6,10,1989,5,910,3.0,642.0,642.0,5,1079,3.0,811.0,811.0
0.059,17,2,152,1,76,0.0,48.0,48.0,1,76,0.0,48.0,48.0
0.004,17,4,284,2,120,0.0,32.0,32.0,2,164,1.0,60.0,54.0
414.774,6,29,4409,12,3102,10914.0,494.0,494.0,17,1307,25922.0,83.0,83.0
0.006,6,10,1547,5,764,1.0,496.0,496.0,5,783,1.0,515.0,515.0
0.004,6,10,2006,5,927,1.0,659.0,659.0,5,1079,1.0,811.0,811.0
0.007,6,10,1547,5,764,1.0,496.0,496.0,5,783,1.0,515.0,515.0
0.099,6,10,1506,5,395,23.0,127.0,127.0,5,1111,23.0,843.0,843.0
0.02,6,10,1631,5,848,4.0,580.0,580.0,5,783,4.0,515.0,515.0
0.013,6,10,1972,5,910,3.0,642.0,642.0,5,1062,3.0,794.0,794.0
0.078,6,10,1506,5,395,17.0,127.0,127.0,5,1111,18.0,843.0,843.0
0.016,6,10,1990,5,911,3.0,643.0,643.0,5,1079,4.0,811.0,811.0
11.079,17,28,4422,14,1994,839.0,269.0,114.0,14,2428,839.0,587.0,145.0
0.004,6,10,2006,5,927,1.0,659.0,659.0,5,1079,1.0,811.0,811.0
0.13,6,10,1506,5,395,29.0,127.0,127.0,5,1111,29.0,843.0,843.0
352.593,6,20,2210,6,1308,12003.0,494.0,494.0,14,902,27122.0,83.0,83.0
0.005,17,4,284,2,120,0.0,32.0,32.0,2,164,0.0,60.0,54.0
0.004,17,4,284,2,120,0.0,32.0,32.0,2,164,0.0,60.0,54.0
0.042,17,2,166,1,75,0.0,47.0,47.0,1,91,0.0,63.0,63.0
0.011,6,10,1972,5,910,2.0,642.0,642.0,5,1062,2.0,794.0,794.0
0.113,6,10,1506,5,395,26.0,127.0,127.0,5,1111,24.0,843.0,843.0
0.012,6,10,1972,5,910,2.0,642.0,642.0,5,1062,2.0,794.0,794.0
0.057,17,2,179,1,71,0.0,43.0,43.0,1,108,0.0,80.0,80.0
0.021,6,10,1989,5,910,5.0,642.0,642.0,5,1079,5.0,811.0,811.0
0.062,6,10,1506,5,395,14.0,127.0,127.0,5,1111,14.0,843.0,843.0
0.004,6,10,2006,5,927,1.0,659.0,659.0,5,1079,1.0,811.0,811.0
0.004,6,10,2007,5,928,1.0,660.0,660.0,5,1079,1.0,811.0,811.0
338.087,6,30,8110,18,2255,19887.0,253.0,187.0,12,5855,30734.0,1402.0,654.0
21.271,6,40,10527,20,4929,472.0,1360.0,682.0,20,5598,1110.0,2667.0,435.0
0.004,17,2,186,1,61,0.0,33.0,33.0,1,125,0.0,97.0,97.0
309.521,17,20,1124,10,716,34384.0,48.0,43.0,10,408,34384.0,20.0,12.0
0.01,6,10,1990,5,911,2.0,643.0,643.0,5,1079,2.0,811.0,811.0
0.022,6,6,716,3,458,9.0,302.0,302.0,3,258,8.0,102.0,102.0
0.225,6,16,2778,8,1396,32.0,533.0,324.0,8,1382,21.0,529.0,239.0
0.007,6,10,1989,5,910,1.0,642.0,642.0,5,1079,1.0,811.0,811.0
0.007,6,10,1989,5,910,1.0,642.0,642.0,5,1079,1.0,811.0,811.0
0.011,6,10,1631,5,848,2.0,580.0,580.0,5,783,2.0,515.0,515.0
0.001,17,2,136,1,60,0.0,32.0,32.0,1,76,0.0,48.0,48.0
0.11,6,10,1506,5,395,21.0,127.0,127.0,5,1111,25.0,843.0,843.0
0.009,6,14,3787,7,497,1.0,125.0,125.0,7,3290,1.0,1448.0,972.0
4.904,58,2,144,1,72,0.0,24.0,24.0,1,72,0.0,24.0,24.0
0.004,17,4,284,2,120,0.0,32.0,32.0,2,164,1.0,60.0,54.0
0.011,6,10,1989,5,910,2.0,642.0,642.0,5,1079,2.0,811.0,811.0
0.005,6,10,1779,5,928,1.0,660.0,660.0,5,851,1.0,583.0,583.0
0.014,6,13,3735,7,497,2.0,125.0,125.0,6,3238,2.0,1470.0,1459.0
0.017,6,10,1677,5,827,4.0,559.0,559.0,5,850,4.0,582.0,582.0
40.056,17,10,676,5,460,10013.0,104.0,64.0,5,216,10013.0,20.0,15.0
0.004,6,10,1702,5,863,1.0,595.0,595.0,5,839,0.0,571.0,571.0
0.005,6,10,2000,5,927,1.0,659.0,659.0,5,1073,1.0,805.0,805.0
0.006,6,10,1689,5,839,1.0,571.0,571.0,5,850,1.0,582.0,582.0
0.007,6,10,1854,5,889,1.0,621.0,621.0,5,965,1.0,697.0,697.0
0.008,6,12,1926,6,1189,1.0,659.0,434.0,6,737,1.0,417.0,417.0
0.005,6,10,1989,5,927,1.0,659.0,659.0,5,1062,1.0,794.0,794.0
0.029,6,10,1972,5,910,7.0,642.0,642.0,5,1062,7.0,794.0,794.0
0.077,6,10,1506,5,395,17.0,127.0,127.0,5,1111,14.0,843.0,843.0
0.006,6,10,1689,5,839,1.0,571.0,571.0,5,850,1.0,582.0,582.0
0.121,6,10,1506,5,395,25.0,127.0,127.0,5,1111,26.0,843.0,843.0
0.004,6,10,1779,5,928,1.0,660.0,660.0,5,851,1.0,583.0,583.0
0.005,17,2,136,1,60,0.0,32.0,32.0,1,76,0.0,48.0,48.0
0.001,17,2,180,1,66,0.0,38.0,38.0,1,114,0.0,86.0,86.0
0.003,17,2,152,1,76,0.0,48.0,48.0,1,76,0.0,48.0,48.0
0.01,6,10,1983,5,910,2.0,642.0,642.0,5,1073,2.0,805.0,805.0
0.006,6,10,2000,5,927,1.0,659.0,659.0,5,1073,1.0,805.0,805.0
0.004,17,2,148,1,60,0.0,32.0,32.0,1,88,0.0,60.0,60.0
0.005,6,13,3747,7,509,0.0,137.0,137.0,6,3238,0.0,1470.0,1459.0
0.003,17,2,148,1,60,0.0,32.0,32.0,1,88,0.0,60.0,60.0
0.713,6,28,5579,13,1597,50.0,325.0,152.0,15,3982,43.0,1414.0,563.0
0.004,17,2,136,1,60,0.0,32.0,32.0,1,76,0.0,48.0,48.0
240.11,6,16,4481,9,963,30013.0,238.0,166.0,7,3518,40016.0,1402.0,786.0
0.005,6,10,1689,5,839,1.0,571.0,571.0,5,850,1.0,582.0,582.0
0.247,17,38,20173,21,17025,12.0,1350.0,782.0,17,3148,11.0,1350.0,157.0
0.119,6,10,1506,5,395,27.0,127.0,127.0,5,1111,26.0,843.0,843.0
0.089,6,10,1506,5,395,20.0,127.0,127.0,5,1111,17.0,843.0,843.0
0.001,17,2,180,1,65,0.0,37.0,37.0,1,115,0.0,87.0,87.0
0.013,6,10,1989,5,910,3.0,642.0,642.0,5,1079,3.0,811.0,811.0
0.006,17,2,179,1,71,0.0,43.0,43.0,1,108,0.0,80.0,80.0
0.12,6,10,1506,5,395,26.0,127.0,127.0,5,1111,27.0,843.0,843.0
0.004,17,2,132,1,58,0.0,30.0,30.0,1,74,0.0,46.0,46.0
40.065,17,10,676,5,460,10013.0,104.0,64.0,5,216,10015.0,20.0,15.0
0.014,6,6,716,3,458,6.0,302.0,302.0,3,258,5.0,102.0,102.0
40.081,17,10,676,5,460,10019.0,104.0,64.0,5,216,10019.0,20.0,15.0
0.013,6,10,1990,5,911,3.0,643.0,643.0,5,1079,3.0,811.0,811.0
369.72,6,22,2313,16,867,24648.0,195.0,195.0,6,1446,4684.0,419.0,398.0
0.005,6,10,1989,5,927,1.0,659.0,659.0,5,1062,1.0,794.0,794.0
40.063,17,10,676,5,460,10015.0,104.0,64.0,5,216,10013.0,20.0,15.0
0.005,6,10,2000,5,927,1.0,659.0,659.0,5,1073,1.0,805.0,805.0
0.011,6,10,1989,5,910,2.0,642.0,642.0,5,1079,2.0,811.0,811.0
0.005,17,2,164,1,74,0.0,46.0,46.0,1,90,0.0,62.0,62.0
10.995,17,28,4422,14,1995,837.0,270.0,114.0,14,2427,837.0,586.0,145.0
0.04,17,2,136,1,60,0.0,32.0,32.0,1,76,0.0,48.0,48.0
10.734,17,28,4421,14,1994,817.0,269.0,114.0,14,2427,817.0,586.0,145.0
0.088,6,10,1506,5,395,19.0,127.0,127.0,5,1111,16.0,843.0,843.0
0.08,6,10,1506,5,395,18.0,127.0,127.0,5,1111,17.0,843.0,843.0
0.004,6,10,1702,5,863,0.0,595.0,595.0,5,839,1.0,571.0,571.0
0.006,6,10,1689,5,839,1.0,571.0,571.0,5,850,1.0,582.0,582.0
0.005,6,10,2007,5,928,1.0,660.0,660.0,5,1079,1.0,811.0,811.0
0.263,17,2,152,1,76,0.0,48.0,48.0,1,76,0.0,48.0,48.0
0.009,6,10,1983,5,910,2.0,642.0,642.0,5,1073,2.0,805.0,805.0
0.073,17,4,284,2,120,0.0,32.0,32.0,2,164,68.0,60.0,54.0
0.004,6,10,2006,5,927,1.0,659.0,659.0,5,1079,1.0,811.0,811.0
0.074,6,10,1506,5,395,14.0,127.0,127.0,5,1111,17.0,843.0,843.0
0.075,6,10,1506,5,395,16.0,127.0,127.0,5,1111,17.0,843.0,843.0
0.018,6,10,1989,5,910,4.0,642.0,642.0,5,1079,4.0,811.0,811.0
0.102,6,10,1506,5,395,23.0,127.0,127.0,5,1111,21.0,843.0,843.0
0.008,6,10,1989,5,910,2.0,642.0,642.0,5,1079,1.0,811.0,811.0
0.076,6,10,1506,5,395,17.0,127.0,127.0,5,1111,14.0,843.0,843.0
0.006,6,10,1547,5,764,1.0,496.0,496.0,5,783,1.0,515.0,515.0
40.073,17,10,676,5,460,10017.0,104.0,64.0,5,216,10017.0,20.0,15.0
0.014,6,10,1677,5,827,3.0,559.0,559.0,5,850,3.0,582.0,582.0
0.006,17,2,170,1,65,0.0,37.0,37.0,1,105,0.0,77.0,77.0
0.017,6,10,1989,5,910,4.0,642.0,642.0,5,1079,4.0,811.0,811.0
0.365,17,4,596,2,122,267.0,33.0,33.0,2,474,203.0,323.0,209.0
0.12,6,10,1506,5,395,29.0,127.0,127.0,5,1111,27.0,843.0,843.0
0.112,6,10,1506,5,395,24.0,127.0,127.0,5,1111,25.0,843.0,843.0
323.541,17,20,1124,10,716,35935.0,48.0,43.0,10,408,35935.0,20.0,12.0
11.064,17,28,4389,14,2311,842.0,586.0,137.0,14,2078,842.0,269.0,120.0
0.043,17,2,152,1,76,0.0,48.0,48.0,1,76,0.0,48.0,48.0
240.079,6,16,4481,9,963,30009.0,238.0,166.0,7,3518,40012.0,1402.0,786.0
0.006,6,10,1547,5,764,1.0,496.0,496.0,5,783,1.0,515.0,515.0
0.071,17,4,284,2,120,1.0,32.0,32.0,2,164,67.0,60.0,54.0
0.013,6,10,1989,5,910,3.0,642.0,642.0,5,1079,3.0,811.0,811.0
0.006,6,10,1774,5,923,1.0,655.0,655.0,5,851,1.0,583.0,583.0
0.005,6,10,2000,5,927,1.0,659.0,659.0,5,1073,1.0,805.0,805.0
0.01,6,10,1983,5,910,2.0,642.0,642.0,5,1073,2.0,805.0,805.0
0.01,6,10,1677,5,827,2.0,559.0,559.0,5,850,2.0,582.0,582.0
40.056,17,10,676,5,460,10013.0,104.0,64.0,5,216,10013.0,20.0,15.0
0.011,6,10,1989,5,910,2.0,642.0,642.0,5,1079,2.0,811.0,811.0
0.188,6,10,1506,5,395,46.0,127.0,127.0,5,1111,43.0,843.0,843.0
0.004,6,10,1702,5,863,1.0,595.0,595.0,5,839,1.0,571.0,571.0
0.005,6,10,2007,5,928,1.0,660.0,660.0,5,1079,1.0,811.0,811.0
0.006,6,10,1547,5,764,1.0,496.0,496.0,5,783,1.0,515.0,515.0
0.004,6,10,2006,5,927,1.0,659.0,659.0,5,1079,1.0,811.0,811.0
0.041,17,4,284,2,120,0.0,32.0,32.0,2,164,37.0,60.0,54.0
40.071,17,10,676,5,460,10015.0,104.0,64.0,5,216,10016.0,20.0,15.0
0.072,17,2,136,1,60,0.0,32.0,32.0,1,76,0.0,48.0,48.0
0.022,6,10,1989,5,910,5.0,642.0,642.0,5,1079,5.0,811.0,811.0
0.264,17,45,27998,27,24837,10.0,1350.0,891.0,18,3161,12.0,1350.0,147.0
0.147,6,10,1506,5,395,31.0,127.0,127.0,5,1111,33.0,843.0,843.0
0.011,6,10,1990,5,911,2.0,643.0,643.0,5,1079,2.0,811.0,811.0
300.366,6,16,2170,9,684,37525.0,146.0,146.0,7,1486,50033.0,419.0,398.0
0.0,17,2,166,1,75,0.0,47.0,47.0,1,91,0.0,63.0,63.0
0.084,6,10,1506,5,395,15.0,127.0,127.0,5,1111,18.0,843.0,843.0
0.006,17,2,179,1,71,0.0,43.0,43.0,1,108,0.0,80.0,80.0
0.144,6,10,1506,5,395,33.0,127.0,127.0,5,1111,31.0,843.0,843.0
0.04,17,4,284,2,120,0.0,32.0,32.0,2,164,35.0,60.0,54.0
0.014,6,10,1677,5,827,3.0,559.0,559.0,5,850,3.0,582.0,582.0
0.054,17,2,144,1,64,0.0,36.0,36.0,1,80,0.0,52.0,52.0
175.261,17,82,11597,41,2736,4381.0,44.0,38.0,41,8861,4381.0,239.0,188.0
0.09,6,10,1506,5,395,18.0,127.0,127.0,5,1111,21.0,843.0,843.0
0.012,6,10,1989,5,910,2.0,642.0,642.0,5,1079,2.0,811.0,811.0
0.003,17,2,136,1,60,0.0,32.0,32.0,1,76,0.0,48.0,48.0
0.126,6,10,1506,5,395,25.0,127.0,127.0,5,1111,28.0,843.0,843.0
0.006,6,10,1547,5,764,1.0,496.0,496.0,5,783,1.0,515.0,515.0
0.015,6,13,3735,7,497,2.0,125.0,125.0,6,3238,3.0,1470.0,1459.0
40.05,17,10,676,5,460,10011.0,104.0,64.0,5,216,10011.0,20.0,15.0
9.045,17,6,376,5,280,2261.0,28.0,28.0,1,96,0.0,68.0,68.0
40.051,17,10,676,5,460,10011.0,104.0,64.0,5,216,10012.0,20.0,15.0
0.005,6,10,1702,5,863,1.0,595.0,595.0,5,839,1.0,571.0,571.0
0.071,17,2,170,1,65,0.0,37.0,37.0,1,105,0.0,77.0,77.0
0.086,6,10,1506,5,395,19.0,127.0,127.0,5,1111,20.0,843.0,843.0
0.073,6,10,1506,5,395,17.0,127.0,127.0,5,1111,17.0,843.0,843.0
0.11,6,10,1506,5,395,24.0,127.0,127.0,5,1111,22.0,843.0,843.0
40.06,17,10,676,5,460,10012.0,104.0,64.0,5,216,10014.0,20.0,15.0
0.013,6,10,1983,5,910,3.0,642.0,642.0,5,1073,3.0,805.0,805.0
0.001,17,2,136,1,60,0.0,32.0,32.0,1,76,0.0,48.0,48.0
0.005,6,10,2007,5,928,1.0,660.0,660.0,5,1079,1.0,811.0,811.0
0.004,17,2,148,1,60,0.0,32.0,32.0,1,88,0.0,60.0,60.0
0.006,6,10,1547,5,764,1.0,496.0,496.0,5,783,1.0,515.0,515.0
0.005,6,10,2000,5,927,1.0,659.0,659.0,5,1073,1.0,805.0,805.0
0.006,6,10,1689,5,839,1.0,571.0,571.0,5,850,1.0,582.0,582.0
0.062,6,10,1506,5,395,13.0,127.0,127.0,5,1111,15.0,843.0,843.0
0.005,6,10,2007,5,928,1.0,660.0,660.0,5,1079,1.0,811.0,811.0
0.005,17,2,166,1,75,0.0,47.0,47.0,1,91,0.0,63.0,63.0
0.005,6,10,1779,5,928,1.0,660.0,660.0,5,851,1.0,583.0,583.0
0.081,6,10,1506,5,395,18.0,127.0,127.0,5,1111,18.0,843.0,843.0
0.096,6,10,1506,5,395,22.0,127.0,127.0,5,1111,20.0,843.0,843.0
291.218,6,420,350126,212,22585,1380.0,2736.0,889.0,208,327541,1406.0,2804.0,1632.0
0.08,6,10,1506,5,395,18.0,127.0,127.0,5,1111,16.0,843.0,843.0
0.099,6,10,1506,5,395,17.0,127.0,127.0,5,1111,23.0,843.0,843.0
0.012,6,10,1990,5,911,3.0,643.0,643.0,5,1079,2.0,811.0,811.0
10.801,17,28,4423,14,1994,822.0,269.0,114.0,14,2429,822.0,588.0,145.0
40.087,17,10,676,5,460,10019.0,104.0,64.0,5,216,10021.0,20.0,15.0
0.011,6,10,1990,5,911,2.0,643.0,643.0,5,1079,2.0,811.0,811.0
311.275,17,20,1124,10,716,34574.0,48.0,43.0,10,408,34572.0,20.0,12.0
0.01,6,13,3735,7,497,1.0,125.0,125.0,6,3238,1.0,1470.0,1459.0
0.005,6,10,1547,5,764,1.0,496.0,496.0,5,783,1.0,515.0,515.0
0.079,6,10,1506,5,395,15.0,127.0,127.0,5,1111,17.0,843.0,843.0
351.99,6,20,2210,6,1308,12003.0,494.0,494.0,14,902,27075.0,83.0,83.0
0.012,6,10,1989,5,910,3.0,642.0,642.0,5,1079,2.0,811.0,811.0
0.015,6,10,1990,5,911,3.0,643.0,643.0,5,1079,3.0,811.0,811.0
0.014,6,10,1983,5,910,3.0,642.0,642.0,5,1073,3.0,805.0,805.0
0.006,6,10,2000,5,927,1.0,659.0,659.0,5,1073,1.0,805.0,805.0
66.008,6,27,17570,15,9628,4714.0,2804.0,1473.0,12,7942,5985.0,2313.0,1218.0
0.08,6,10,1506,5,395,18.0,127.0,127.0,5,1111,18.0,843.0,843.0
0.005,6,10,2006,5,927,1.0,659.0,659.0,5,1079,1.0,811.0,811.0
0.02,6,10,1983,5,910,5.0,642.0,642.0,5,1073,4.0,805.0,805.0
0.008,6,10,1972,5,910,1.0,642.0,642.0,5,1062,2.0,794.0,794.0
40.044,17,10,676,5,460,10010.0,104.0,64.0,5,216,10010.0,20.0,15.0
240.093,6,33,9467,16,6803,16006.0,1863.0,662.0,17,2664,15005.0,580.0,221.0
0.009,6,12,1926,6,1189,1.0,659.0,434.0,6,737,1.0,417.0,417.0
0.005,6,14,3736,7,446,0.0,74.0,74.0,7,3290,0.0,1448.0,972.0
0.005,17,2,180,1,66,0.0,38.0,38.0,1,114,0.0,86.0,86.0
0.076,6,10,1506,5,395,16.0,127.0,127.0,5,1111,14.0,843.0,843.0
0.013,17,2,148,1,60,0.0,32.0,32.0,1,88,0.0,60.0,60.0
40.081,17,10,676,5,460,10018.0,104.0,64.0,5,216,10019.0,20.0,15.0
0.134,6,10,1506,5,395,31.0,127.0,127.0,5,1111,31.0,843.0,843.0
0.039,17,4,284,2,120,0.0,32.0,32.0,2,164,35.0,60.0,54.0
0.008,6,10,1762,5,911,2.0,643.0,643.0,5,851,2.0,583.0,583.0
0.214,6,16,2778,8,1396,30.0,533.0,324.0,8,1382,19.0,529.0,239.0
0.011,6,13,3735,7,497,1.0,125.0,125.0,6,3238,2.0,1470.0,1459.0
0.004,17,2,136,1,60,0.0,32.0,32.0,1,76,0.0,48.0,48.0
40.061,17,10,676,5,460,10014.0,104.0,64.0,5,216,10014.0,20.0,15.0
0.006,17,2,164,1,74,0.0,46.0,46.0,1,90,0.0,62.0,62.0
0.006,6,10,1689,5,839,1.0,571.0,571.0,5,850,1.0,582.0,582.0
0.011,6,10,1989,5,910,2.0,642.0,642.0,5,1079,2.0,811.0,811.0
0.093,6,10,1506,5,395,22.0,127.0,127.0,5,1111,18.0,843.0,843.0
0.001,17,2,180,1,66,0.0,38.0,38.0,1,114,0.0,86.0,86.0
0.006,6,10,1854,5,889,1.0,621.0,621.0,5,965,1.0,697.0,697.0
0.005,6,10,2007,5,928,1.0,660.0,660.0,5,1079,1.0,811.0,811.0
0.008,6,10,1989,5,910,2.0,642.0,642.0,5,1079,2.0,811.0,811.0
0.005,6,10,1774,5,923,1.0,655.0,655.0,5,851,1.0,583.0,583.0
0.092,6,10,1506,5,395,20.0,127.0,127.0,5,1111,19.0,843.0,843.0
0.011,6,10,1989,5,910,2.0,642.0,642.0,5,1079,2.0,811.0,811.0
40.054,17,10,676,5,460,10012.0,104.0,64.0,5,216,10012.0,20.0,15.0
0.009,6,10,1990,5,911,2.0,643.0,643.0,5,1079,2.0,811.0,811.0
0.006,6,10,1689,5,839,1.0,571.0,571.0,5,850,1.0,582.0,582.0
40.062,17,10,676,5,460,10014.0,104.0,64.0,5,216,10014.0,20.0,15.0
0.005,6,10,2006,5,927,1.0,659.0,659.0,5,1079,1.0,811.0,811.0
0.006,6,13,3684,7,446,1.0,74.0,74.0,6,3238,1.0,1470.0,1459.0
0.003,17,2,148,1,60,0.0,32.0,32.0,1,88,0.0,60.0,60.0
0.014,6,10,1989,5,910,3.0,642.0,642.0,5,1079,3.0,811.0,811.0
0.004,17,2,136,1,60,0.0,32.0,32.0,1,76,0.0,48.0,48.0
40.059,17,10,676,5,460,10013.0,104.0,64.0,5,216,10014.0,20.0,15.0
0.015,6,10,1989,5,910,3.0,642.0,642.0,5,1079,3.0,811.0,811.0
0.008,6,10,1989,5,910,2.0,642.0,642.0,5,1079,2.0,811.0,811.0
352.004,6,20,2210,6,1308,12004.0,494.0,494.0,14,902,27077.0,83.0,83.0
0.007,17,2,179,1,71,0.0,43.0,43.0,1,108,0.0,80.0,80.0
377.105,6,22,2313,16,867,25140.0,195.0,195.0,6,1446,4692.0,419.0,398.0
0.095,6,10,1506,5,395,22.0,127.0,127.0,5,1111,19.0,843.0,843.0
0.004,6,10,2006,5,927,1.0,659.0,659.0,5,1079,1.0,811.0,811.0
0.097,6,10,1506,5,395,20.0,127.0,127.0,5,1111,21.0,843.0,843.0
0.006,6,13,3747,7,509,0.0,137.0,137.0,6,3238,1.0,1470.0,1459.0
0.041,17,2,136,1,60,0.0,32.0,32.0,1,76,0.0,48.0,48.0
0.005,6,10,2007,5,928,1.0,660.0,660.0,5,1079,1.0,811.0,811.0
0.068,6,10,1506,5,395,14.0,127.0,127.0,5,1111,15.0,843.0,843.0
0.107,6,10,1506,5,395,23.0,127.0,127.0,5,1111,24.0,843.0,843.0
240.463,6,35,8919,18,2067,14144.0,688.0,224.0,17,6852,15028.0,1402.0,597.0
0.008,6,10,1989,5,910,2.0,642.0,642.0,5,1079,2.0,811.0,811.0
0.004,6,10,2006,5,927,1.0,659.0,659.0,5,1079,1.0,811.0,811.0
0.098,6,10,1506,5,395,21.0,127.0,127.0,5,1111,21.0,843.0,843.0
0.005,6,13,3747,7,509,0.0,137.0,137.0,6,3238,1.0,1470.0,1459.0
0.009,6,10,1689,5,839,2.0,571.0,571.0,5,850,2.0,582.0,582.0
241.257,6,309,343406,114,17442,2135.0,2691.0,886.0,195,325964,1243.0,2804.0,1707.0
0.079,6,10,1506,5,395,17.0,127.0,127.0,5,1111,18.0,843.0,843.0
0.001,17,2,136,1,60,0.0,32.0,32.0,1,76,0.0,48.0,48.0
0.001,17,2,142,1,63,0.0,35.0,35.0,1,79,0.0,51.0,51.0
0.08,6,10,1506,5,395,18.0,127.0,127.0,5,1111,19.0,843.0,843.0
0.015,6,10,1989,5,910,3.0,642.0,642.0,5,1079,3.0,811.0,811.0
0.005,6,10,2007,5,928,1.0,660.0,660.0,5,1079,1.0,811.0,811.0
240.093,6,31,8880,15,6677,17149.0,1801.0,655.0,16,2203,16005.0,580.0,170.0
0.013,17,2,152,1,56,0.0,28.0,28.0,1,96,0.0,68.0,68.0
0.038,17,4,284,2,120,0.0,32.0,32.0,2,164,34.0,60.0,54.0
0.009,6,13,3735,7,497,1.0,125.0,125.0,6,3238,1.0,1470.0,1459.0
0.012,6,10,1989,5,910,2.0,642.0,642.0,5,1079,3.0,811.0,811.0
0.012,6,13,3735,7,497,2.0,125.0,125.0,6,3238,2.0,1470.0,1459.0
0.005,6,10,2007,5,928,1.0,660.0,660.0,5,1079,1.0,811.0,811.0
0.014,6,10,1989,5,910,3.0,642.0,642.0,5,1079,3.0,811.0,811.0
280.478,6,24,6115,10,1186,31164.0,267.0,156.0,14,4929,21574.0,1400.0,873.0
167.249,17,76,10755,38,2529,4520.0,44.0,38.0,38,8226,4520.0,260.0,188.0
0.012,6,10,1989,5,910,2.0,642.0,642.0,5,1079,3.0,811.0,811.0
0.011,6,10,1990,5,911,2.0,643.0,643.0,5,1079,2.0,811.0,811.0
0.018,6,10,1990,5,911,4.0,643.0,643.0,5,1079,4.0,811.0,811.0
0.009,6,13,3735,7,497,1.0,125.0,125.0,6,3238,1.0,1470.0,1459.0
0.005,6,10,1854,5,889,1.0,621.0,621.0,5,965,1.0,697.0,697.0
40.059,17,10,676,5,460,10013.0,104.0,64.0,5,216,10013.0,20.0,15.0
0.014,6,10,1762,5,911,3.0,643.0,643.0,5,851,3.0,583.0,583.0
0.004,6,10,2007,5,928,1.0,660.0,660.0,5,1079,1.0,811.0,811.0
0.012,6,10,1989,5,910,3.0,642.0,642.0,5,1079,3.0,811.0,811.0
0.005,6,13,3747,7,509,0.0,137.0,137.0,6,3238,0.0,1470.0,1459.0
0.24,6,10,1506,5,395,54.0,127.0,127.0,5,1111,40.0,843.0,843.0
0.003,17,4,284,2,120,0.0,32.0,32.0,2,164,0.0,60.0,54.0
0.165,17,2,152,1,76,0.0,48.0,48.0,1,76,0.0,48.0,48.0
0.005,6,10,1989,5,927,1.0,659.0,659.0,5,1062,1.0,794.0,794.0
0.067,6,10,1506,5,395,15.0,127.0,127.0,5,1111,14.0,843.0,843.0
0.005,6,10,1779,5,928,1.0,660.0,660.0,5,851,1.0,583.0,583.0
0.039,17,2,152,1,76,0.0,48.0,48.0,1,76,0.0,48.0,48.0
0.007,6,14,3799,7,509,1.0,137.0,137.0,7,3290,1.0,1448.0,972.0
0.017,6,10,1762,5,911,4.0,643.0,643.0,5,851,4.0,583.0,583.0
0.094,6,10,1506,5,395,21.0,127.0,127.0,5,1111,22.0,843.0,843.0
0.007,6,10,1689,5,839,1.0,571.0,571.0,5,850,1.0,582.0,582.0
0.008,6,10,1989,5,910,1.0,642.0,642.0,5,1079,2.0,811.0,811.0
0.009,6,10,1972,5,910,2.0,642.0,642.0,5,1062,2.0,794.0,794.0
0.019,6,10,1972,5,910,4.0,642.0,642.0,5,1062,4.0,794.0,794.0
0.092,6,10,1506,5,395,20.0,127.0,127.0,5,1111,20.0,843.0,843.0
0.014,6,10,1972,5,910,3.0,642.0,642.0,5,1062,3.0,794.0,794.0
40.112,17,10,676,5,460,10019.0,104.0,64.0,5,216,10027.0,20.0,15.0
0.011,6,10,1989,5,910,2.0,642.0,642.0,5,1079,2.0,811.0,811.0
0.055,17,2,179,1,71,0.0,43.0,43.0,1,108,0.0,80.0,80.0
0.005,6,10,1989,5,927,1.0,659.0,659.0,5,1062,1.0,794.0,794.0
0.005,6,10,1774,5,923,1.0,655.0,655.0,5,851,1.0,583.0,583.0
0.004,6,10,2006,5,927,1.0,659.0,659.0,5,1079,1.0,811.0,811.0
40.067,17,10,676,5,460,10014.0,104.0,64.0,5,216,10012.0,20.0,15.0
0.006,6,13,3747,7,509,0.0,137.0,137.0,6,3238,1.0,1470.0,1459.0
0.005,6,10,2006,5,927,1.0,659.0,659.0,5,1079,1.0,811.0,811.0
0.004,17,2,136,1,60,0.0,32.0,32.0,1,76,0.0,48.0,48.0
0.005,6,10,1989,5,927,1.0,659.0,659.0,5,1062,1.0,794.0,794.0
1787.21,6,150,19350,90,13740,20080.0,302.0,302.0,60,5610,30291.0,83.0,83.0
0.012,6,10,1983,5,910,3.0,642.0,642.0,5,1073,3.0,805.0,805.0
0.004,17,4,284,2,120,1.0,32.0,32.0,2,164,0.0,60.0,54.0
0.006,6,10,1643,5,860,1.0,592.0,592.0,5,783,1.0,515.0,515.0
0.114,6,10,1506,5,395,22.0,127.0,127.0,5,1111,25.0,843.0,843.0
0.005,6,10,2006,5,927,1.0,659.0,659.0,5,1079,1.0,811.0,811.0
0.04,17,2,166,1,75,0.0,47.0,47.0,1,91,0.0,63.0,63.0
308.534,17,20,1124,10,716,34268.0,48.0,43.0,10,408,34267.0,20.0,12.0
40.059,17,10,676,5,460,10013.0,104.0,64.0,5,216,10014.0,20.0,15.0
0.003,17,4,284,2,120,0.0,32.0,32.0,2,164,0.0,60.0,54.0
0.01,6,10,1989,5,910,2.0,642.0,642.0,5,1079,2.0,811.0,811.0
0.035,6,10,1983,5,910,8.0,642.0,642.0,5,1073,8.0,805.0,805.0
1798.433,6,236,46152,112,33749,16202.0,2476.0,996.0,124,12403,14621.0,580.0,61.0
0.02,6,13,3735,7,497,3.0,125.0,125.0,6,3238,3.0,1470.0,1459.0
40.094,17,10,676,5,460,10021.0,104.0,64.0,5,216,10022.0,20.0,15.0
0.103,6,10,1506,5,395,25.0,127.0,127.0,5,1111,18.0,843.0,843.0
1756.907,6,107,6413,60,3537,29777.0,27.0,27.0,47,2876,38192.0,27.0,27.0
0.105,6,10,1506,5,395,23.0,127.0,127.0,5,1111,23.0,843.0,843.0
0.004,17,2,164,1,74,0.0,46.0,46.0,1,90,0.0,62.0,62.0
0.007,6,10,1983,5,910,1.0,642.0,642.0,5,1073,1.0,805.0,805.0
0.01,6,10,1989,5,910,2.0,642.0,642.0,5,1079,2.0,811.0,811.0
308.479,17,20,1124,10,716,34261.0,48.0,43.0,10,408,34261.0,20.0,12.0
0.007,17,2,194,1,59,0.0,31.0,31.0,1,135,0.0,107.0,107.0
0.008,6,10,1989,5,910,2.0,642.0,642.0,5,1079,2.0,811.0,811.0
240.099,6,31,8811,15,6364,17149.0,1515.0,620.0,16,2447,16006.0,580.0,200.0
294.281,6,406,349928,198,22504,1493.0,2736.0,871.0,208,327424,1421.0,2804.0,1640.0
0.046,17,2,152,1,76,0.0,48.0,48.0,1,76,0.0,48.0,48.0
0.198,6,10,1506,5,395,47.0,127.0,127.0,5,1111,44.0,843.0,843.0
0.015,6,10,1762,5,911,3.0,643.0,643.0,5,851,3.0,583.0,583.0
0.008,6,10,1989,5,910,1.0,642.0,642.0,5,1079,2.0,811.0,811.0
0.005,6,10,1989,5,927,1.0,659.0,659.0,5,1062,1.0,794.0,794.0
0.006,6,10,2006,5,927,1.0,659.0,659.0,5,1079,1.0,811.0,811.0
0.04,17,4,284,2,120,0.0,32.0,32.0,2,164,36.0,60.0,54.0
0.004,6,10,2007,5,928,1.0,660.0,660.0,5,1079,1.0,811.0,811.0
0.006,6,10,1689,5,839,1.0,571.0,571.0,5,850,1.0,582.0,582.0
0.005,6,10,1989,5,927,1.0,659.0,659.0,5,1062,1.0,794.0,794.0
40.066,17,10,676,5,460,10014.0,104.0,64.0,5,216,10015.0,20.0,15.0
0.095,6,10,1506,5,395,23.0,127.0,127.0,5,1111,20.0,843.0,843.0
0.004,6,10,1989,5,927,1.0,659.0,659.0,5,1062,1.0,794.0,794.0
0.005,6,10,2000,5,927,1.0,659.0,659.0,5,1073,1.0,805.0,805.0
240.117,6,31,9186,15,6869,17151.0,1993.0,677.0,16,2317,16007.0,580.0,184.0
0.006,6,10,1547,5,764,1.0,496.0,496.0,5,783,1.0,515.0,515.0
0.004,17,2,412,1,61,0.0,33.0,33.0,1,351,0.0,323.0,323.0
0.118,6,10,1506,5,395,26.0,127.0,127.0,5,1111,27.0,843.0,843.0
0.093,6,10,1506,5,395,17.0,127.0,127.0,5,1111,22.0,843.0,843.0
0.005,6,10,1689,5,839,1.0,571.0,571.0,5,850,1.0,582.0,582.0
40.06,17,10,676,5,460,10013.0,104.0,64.0,5,216,10014.0,20.0,15.0
0.084,6,10,1506,5,395,16.0,127.0,127.0,5,1111,18.0,843.0,843.0
0.084,6,10,1506,5,395,17.0,127.0,127.0,5,1111,18.0,843.0,843.0
0.001,17,2,180,1,66,0.0,38.0,38.0,1,114,0.0,86.0,86.0
0.019,6,10,1989,5,910,4.0,642.0,642.0,5,1079,4.0,811.0,811.0
0.081,6,10,1506,5,395,19.0,127.0,127.0,5,1111,18.0,843.0,843.0
0.1,6,10,1506,5,395,21.0,127.0,127.0,5,1111,20.0,843.0,843.0
0.01,6,10,1990,5,911,2.0,643.0,643.0,5,1079,2.0,811.0,811.0
0.013,6,10,1990,5,911,3.0,643.0,643.0,5,1079,3.0,811.0,811.0
0.091,6,10,1506,5,395,20.0,127.0,127.0,5,1111,19.0,843.0,843.0
0.003,6,10,1702,5,863,0.0,595.0,595.0,5,839,0.0,571.0,571.0
0.082,6,10,1506,5,395,17.0,127.0,127.0,5,1111,20.0,843.0,843.0
335.408,17,20,1124,10,716,37252.0,48.0,43.0,10,408,37252.0,20.0,12.0
15.142,17,16,10017,7,4575,2519.0,1350.0,625.0,9,5442,1888.0,1350.0,576.0
0.005,6,10,2007,5,928,1.0,660.0,660.0,5,1079,1.0,811.0,811.0
0.0,17,2,180,1,66,0.0,38.0,38.0,1,114,0.0,86.0,86.0
0.026,6,10,1990,5,911,6.0,643.0,643.0,5,1079,6.0,811.0,811.0
0.006,17,2,140,1,62,0.0,34.0,34.0,1,78,0.0,50.0,50.0
0.037,6,8,832,4,522,11.0,302.0,302.0,4,310,11.0,102.0,102.0
0.005,17,2,193,1,71,0.0,43.0,43.0,1,122,0.0,94.0,94.0
0.015,6,10,1989,5,910,3.0,642.0,642.0,5,1079,3.0,811.0,811.0
0.006,17,2,170,1,65,0.0,37.0,37.0,1,105,0.0,77.0,77.0
0.079,6,10,1506,5,395,17.0,127.0,127.0,5,1111,18.0,843.0,843.0
0.004,6,10,2000,5,927,1.0,659.0,659.0,5,1073,1.0,805.0,805.0
0.007,17,2,148,1,60,0.0,32.0,32.0,1,88,0.0,60.0,60.0
0.009,6,12,1926,6,1189,1.0,659.0,434.0,6,737,1.0,417.0,417.0
368.925,6,22,2313,16,867,24595.0,195.0,195.0,6,1446,4638.0,419.0,398.0
10.882,17,28,4423,14,1995,828.0,270.0,114.0,14,2428,828.0,587.0,145.0
0.102,6,10,1506,5,395,24.0,127.0,127.0,5,1111,22.0,843.0,843.0
0.005,6,10,2000,5,927,1.0,659.0,659.0,5,1073,1.0,805.0,805.0
0.009,17,2,170,1,65,0.0,37.0,37.0,1,105,0.0,77.0,77.0
0.009,6,10,1972,5,910,2.0,642.0,642.0,5,1062,2.0,794.0,794.0
11.378,17,28,4421,14,1993,862.0,268.0,114.0,14,2428,862.0,587.0,145.0
40.073,17,10,676,5,460,10013.0,104.0,64.0,5,216,10017.0,20.0,15.0
0.006,17,2,230,1,68,0.0,40.0,40.0,1,162,0.0,134.0,134.0
0.004,6,10,2007,5,928,1.0,660.0,660.0,5,1079,1.0,811.0,811.0
0.072,6,10,1506,5,395,15.0,127.0,127.0,5,1111,14.0,843.0,843.0
0.17,6,10,1506,5,395,39.0,127.0,127.0,5,1111,39.0,843.0,843.0
0.139,17,4,284,2,120,0.0,32.0,32.0,2,164,130.0,60.0,54.0
0.005,6,10,1989,5,927,1.0,659.0,659.0,5,1062,1.0,794.0,794.0
0.008,6,13,3913,7,495,1.0,123.0,123.0,6,3418,1.0,1650.0,1549.0
0.001,17,2,180,1,66,0.0,38.0,38.0,1,114,0.0,86.0,86.0
0.059,17,2,152,1,76,0.0,48.0,48.0,1,76,0.0,48.0,48.0
300.367,6,16,2170,9,684,37524.0,146.0,146.0,7,1486,50032.0,419.0,398.0
1.065,6,29,12312,16,3260,71.0,1360.0,517.0,13,9052,74.0,2720.0,1065.0
0.021,6,10,1972,5,910,5.0,642.0,642.0,5,1062,5.0,794.0,794.0
0.005,6,10,2006,5,927,1.0,659.0,659.0,5,1079,1.0,811.0,811.0
0.001,17,2,180,1,65,0.0,37.0,37.0,1,115,0.0,87.0,87.0
40.065,17,10,676,5,460,10013.0,104.0,64.0,5,216,10015.0,20.0,15.0
0.005,6,14,3736,7,446,0.0,74.0,74.0,7,3290,0.0,1448.0,972.0
0.005,6,10,1989,5,927,1.0,659.0,659.0,5,1062,1.0,794.0,794.0
0.006,6,10,1547,5,764,1.0,496.0,496.0,5,783,1.0,515.0,515.0
0.005,6,10,2000,5,927,1.0,659.0,659.0,5,1073,1.0,805.0,805.0
0.029,6,10,1605,5,388,7.0,120.0,120.0,5,1217,7.0,949.0,949.0
0.005,6,13,3747,7,509,0.0,137.0,137.0,6,3238,0.0,1470.0,1459.0
0.013,6,10,1972,5,910,3.0,642.0,642.0,5,1062,3.0,794.0,794.0
0.005,6,14,3742,7,452,0.0,80.0,80.0,7,3290,0.0,1448.0,972.0
0.004,6,10,2007,5,928,1.0,660.0,660.0,5,1079,1.0,811.0,811.0
0.016,17,2,148,1,60,0.0,32.0,32.0,1,88,0.0,60.0,60.0
308.471,17,20,1124,10,716,34260.0,48.0,43.0,10,408,34257.0,20.0,12.0
0.005,6,10,2006,5,927,1.0,659.0,659.0,5,1079,1.0,811.0,811.0
0.012,6,10,1990,5,911,2.0,643.0,643.0,5,1079,3.0,811.0,811.0
0.071,6,10,1506,5,395,15.0,127.0,127.0,5,1111,16.0,843.0,843.0
0.005,6,10,2006,5,927,1.0,659.0,659.0,5,1079,1.0,811.0,811.0
0.075,6,10,1506,5,395,16.0,127.0,127.0,5,1111,15.0,843.0,843.0
0.035,6,10,1989,5,910,8.0,642.0,642.0,5,1079,8.0,811.0,811.0
40.056,17,10,676,5,460,10013.0,104.0,64.0,5,216,10013.0,20.0,15.0
0.014,6,10,1989,5,910,3.0,642.0,642.0,5,1079,3.0,811.0,811.0
0.088,6,86,76827,42,3305,2.0,517.0,280.0,44,73522,1.0,4206.0,1780.0
0.007,17,2,154,1,69,0.0,41.0,41.0,1,85,0.0,57.0,57.0
1755.902,6,105,6270,60,3525,29760.0,27.0,27.0,45,2745,39905.0,27.0,27.0
0.001,17,2,180,1,66,0.0,38.0,38.0,1,114,0.0,86.0,86.0
0.01,6,10,1631,5,848,2.0,580.0,580.0,5,783,2.0,515.0,515.0
0.004,6,10,2006,5,927,1.0,659.0,659.0,5,1079,1.0,811.0,811.0
0.005,6,10,2007,5,928,1.0,660.0,660.0,5,1079,1.0,811.0,811.0
241.146,6,313,344490,118,17640,2061.0,2736.0,885.0,195,326850,1243.0,3019.0,1711.0
0.134,6,10,1506,5,395,26.0,127.0,127.0,5,1111,23.0,843.0,843.0
0.085,6,10,1506,5,395,19.0,127.0,127.0,5,1111,18.0,843.0,843.0
0.004,6,10,1779,5,928,1.0,660.0,660.0,5,851,1.0,583.0,583.0
0.006,17,2,230,1,68,0.0,40.0,40.0,1,162,0.0,134.0,134.0
0.009,6,10,1983,5,910,2.0,642.0,642.0,5,1073,2.0,805.0,805.0
0.072,17,2,170,1,65,0.0,37.0,37.0,1,105,0.0,77.0,77.0
0.006,6,10,1547,5,764,1.0,496.0,496.0,5,783,1.0,515.0,515.0
0.01,6,13,3735,7,497,1.0,125.0,125.0,6,3238,2.0,1470.0,1459.0
0.017,6,10,1677,5,827,4.0,559.0,559.0,5,850,4.0,582.0,582.0
0.014,6,10,1972,5,910,3.0,642.0,642.0,5,1062,3.0,794.0,794.0
0.008,6,10,1989,5,910,2.0,642.0,642.0,5,1079,1.0,811.0,811.0
0.003,17,2,136,1,60,0.0,32.0,32.0,1,76,0.0,48.0,48.0
0.136,6,10,1506,5,395,31.0,127.0,127.0,5,1111,32.0,843.0,843.0
0.013,6,10,1990,5,911,3.0,643.0,643.0,5,1079,3.0,811.0,811.0
0.005,6,10,1702,5,863,1.0,595.0,595.0,5,839,1.0,571.0,571.0
171.279,17,98,14139,49,3285,3568.0,44.0,39.0,49,10854,3567.0,239.0,193.0
0.014,6,10,1989,5,910,3.0,642.0,642.0,5,1079,3.0,811.0,811.0
0.003,17,2,136,1,60,0.0,32.0,32.0,1,76,0.0,48.0,48.0
0.043,17,2,148,1,60,0.0,32.0,32.0,1,88,0.0,60.0,60.0
0.005,6,10,1854,5,889,1.0,621.0,621.0,5,965,1.0,697.0,697.0
0.006,17,2,178,1,65,0.0,37.0,37.0,1,113,0.0,85.0,85.0
0.063,6,10,1506,5,395,13.0,127.0,127.0,5,1111,12.0,843.0,843.0
0.109,6,10,1506,5,395,23.0,127.0,127.0,5,1111,25.0,843.0,843.0
0.104,6,10,1506,5,395,19.0,127.0,127.0,5,1111,23.0,843.0,843.0
10.904,17,28,4417,14,1994,829.0,269.0,114.0,14,2423,829.0,586.0,145.0
0.005,6,10,1779,5,928,1.0,660.0,660.0,5,851,1.0,583.0,583.0
0.001,17,2,179,1,62,0.0,34.0,34.0,1,117,0.0,89.0,89.0
0.088,6,10,1506,5,395,20.0,127.0,127.0,5,1111,20.0,843.0,843.0
0.004,6,10,1774,5,923,1.0,655.0,655.0,5,851,1.0,583.0,583.0
0.005,6,10,1774,5,923,1.0,655.0,655.0,5,851,1.0,583.0,583.0
1786.645,6,153,19820,91,14094,19851.0,302.0,302.0,62,5726,29289.0,83.0,83.0
0.061,17,2,152,1,76,0.0,48.0,48.0,1,76,0.0,48.0,48.0
0.014,6,10,1972,5,910,3.0,642.0,642.0,5,1062,3.0,794.0,794.0
0.006,6,10,1779,5,928,1.0,660.0,660.0,5,851,1.0,583.0,583.0
368.548,6,22,2313,16,867,24569.0,195.0,195.0,6,1446,4644.0,419.0,398.0
0.078,6,10,1506,5,395,14.0,127.0,127.0,5,1111,17.0,843.0,843.0
0.131,6,10,1506,5,395,30.0,127.0,127.0,5,1111,31.0,843.0,843.0
0.004,6,10,2007,5,928,1.0,660.0,660.0,5,1079,1.0,811.0,811.0
0.012,6,10,1983,5,910,3.0,642.0,642.0,5,1073,2.0,805.0,805.0
0.112,6,10,1506,5,395,23.0,127.0,127.0,5,1111,23.0,843.0,843.0
40.057,17,10,676,5,460,10013.0,104.0,64.0,5,216,10013.0,20.0,15.0
366.018,6,22,2313,16,867,24401.0,195.0,195.0,6,1446,4640.0,419.0,398.0
0.005,17,4,284,2,120,0.0,32.0,32.0,2,164,0.0,60.0,54.0
0.003,17,4,284,2,120,0.0,32.0,32.0,2,164,0.0,60.0,54.0
0.009,6,10,1989,5,910,2.0,642.0,642.0,5,1079,2.0,811.0,811.0
0.005,6,10,1689,5,839,1.0,571.0,571.0,5,850,1.0,582.0,582.0
0.072,6,10,1506,5,395,15.0,127.0,127.0,5,1111,16.0,843.0,843.0
0.006,6,13,3690,7,452,1.0,80.0,80.0,6,3238,1.0,1470.0,1459.0
0.006,6,10,1547,5,764,1.0,496.0,496.0,5,783,1.0,515.0,515.0
0.007,6,10,1689,5,839,1.0,571.0,571.0,5,850,1.0,582.0,582.0
0.006,6,10,1643,5,860,1.0,592.0,592.0,5,783,1.0,515.0,515.0
40.058,17,10,676,5,460,10013.0,104.0,64.0,5,216,10012.0,20.0,15.0
0.068,6,42,13942,23,2513,3.0,517.0,146.0,19,11429,3.0,1402.0,802.0
0.02,6,10,1989,5,910,5.0,642.0,642.0,5,1079,5.0,811.0,811.0
0.004,17,4,284,2,120,1.0,32.0,32.0,2,164,0.0,60.0,54.0
0.067,6,10,1506,5,395,14.0,127.0,127.0,5,1111,14.0,843.0,843.0
412.249,6,29,4409,12,3102,10911.0,494.0,494.0,17,1307,25765.0,83.0,83.0
0.015,6,10,1972,5,910,3.0,642.0,642.0,5,1062,3.0,794.0,794.0
0.009,6,12,1926,6,1189,1.0,659.0,434.0,6,737,1.0,417.0,417.0
0.004,17,4,284,2,120,0.0,32.0,32.0,2,164,0.0,60.0,54.0
0.064,6,10,1506,5,395,13.0,127.0,127.0,5,1111,14.0,843.0,843.0
0.092,6,10,1506,5,395,20.0,127.0,127.0,5,1111,21.0,843.0,843.0
0.117,6,10,1506,5,395,23.0,127.0,127.0,5,1111,25.0,843.0,843.0
0.008,6,10,1643,5,860,2.0,592.0,592.0,5,783,1.0,515.0,515.0
0.061,17,2,152,1,76,0.0,48.0,48.0,1,76,0.0,48.0,48.0
0.003,17,4,284,2,120,0.0,32.0,32.0,2,164,0.0,60.0,54.0
0.005,17,2,214,1,75,0.0,47.0,47.0,1,139,0.0,111.0,111.0
0.075,6,10,1506,5,395,16.0,127.0,127.0,5,1111,15.0,843.0,843.0
0.004,6,10,1702,5,863,0.0,595.0,595.0,5,839,1.0,571.0,571.0
0.117,6,10,1506,5,395,25.0,127.0,127.0,5,1111,25.0,843.0,843.0
0.014,6,10,1989,5,910,3.0,642.0,642.0,5,1079,3.0,811.0,811.0
0.082,6,10,1506,5,395,18.0,127.0,127.0,5,1111,18.0,843.0,843.0
15.071,17,15,9238,8,6902,2149.0,1350.0,834.0,7,2336,2506.0,1350.0,305.0
0.005,17,2,170,1,65,0.0,37.0,37.0,1,105,0.0,77.0,77.0
0.027,6,10,1989,5,910,6.0,642.0,642.0,5,1079,6.0,811.0,811.0
0.005,6,10,2006,5,927,1.0,659.0,659.0,5,1079,1.0,811.0,811.0
0.007,6,10,1547,5,764,1.0,496.0,496.0,5,783,1.0,515.0,515.0
0.0,17,2,192,1,71,0.0,43.0,43.0,1,121,0.0,93.0,93.0
0.009,6,10,1983,5,910,2.0,642.0,642.0,5,1073,2.0,805.0,805.0
0.089,6,10,1506,5,395,21.0,127.0,127.0,5,1111,21.0,843.0,843.0
0.006,6,10,1689,5,839,1.0,571.0,571.0,5,850,1.0,582.0,582.0
0.011,6,10,1989,5,910,2.0,642.0,642.0,5,1079,2.0,811.0,811.0
270.894,6,61,31772,28,4425,10033.0,944.0,297.0,33,27347,8465.0,2804.0,1114.0
0.005,6,14,3736,7,446,0.0,74.0,74.0,7,3290,0.0,1448.0,972.0
0.004,17,2,160,1,72,0.0,44.0,44.0,1,88,0.0,60.0,60.0
0.004,6,10,1989,5,927,1.0,659.0,659.0,5,1062,1.0,794.0,794.0
0.011,6,10,1762,5,911,2.0,643.0,643.0,5,851,2.0,583.0,583.0
1730.388,6,48,2957,31,1800,57679.0,35.0,35.0,17,1157,108144.0,31.0,31.0
0.076,6,10,1506,5,395,17.0,127.0,127.0,5,1111,17.0,843.0,843.0
0.008,6,13,3735,7,497,1.0,125.0,125.0,6,3238,1.0,1470.0,1459.0
0.113,6,10,1506,5,395,25.0,127.0,127.0,5,1111,23.0,843.0,843.0
40.064,17,10,676,5,460,10015.0,104.0,64.0,5,216,10015.0,20.0,15.0
0.11,6,10,1506,5,395,26.0,127.0,127.0,5,1111,21.0,843.0,843.0
0.005,17,2,140,1,62,0.0,34.0,34.0,1,78,0.0,50.0,50.0
0.012,6,10,1972,5,910,3.0,642.0,642.0,5,1062,3.0,794.0,794.0
0.168,17,2,152,1,76,0.0,48.0,48.0,1,76,0.0,48.0,48.0
172.382,17,80,11321,40,2672,4419.0,44.0,38.0,40,8649,4420.0,261.0,188.0
0.005,6,10,2007,5,928,1.0,660.0,660.0,5,1079,1.0,811.0,811.0
0.012,6,14,3787,7,497,1.0,125.0,125.0,7,3290,1.0,1448.0,972.0
9.037,17,6,376,5,280,2259.0,28.0,28.0,1,96,0.0,68.0,68.0
40.057,17,10,676,5,460,10013.0,104.0,64.0,5,216,10013.0,20.0,15.0
0.013,6,10,1983,5,910,3.0,642.0,642.0,5,1073,3.0,805.0,805.0
0.01,6,10,1631,5,848,2.0,580.0,580.0,5,783,2.0,515.0,515.0
0.005,6,10,2000,5,927,1.0,659.0,659.0,5,1073,1.0,805.0,805.0
0.039,17,4,596,2,122,0.0,33.0,33.0,2,474,35.0,323.0,209.0
0.01,6,10,1983,5,910,2.0,642.0,642.0,5,1073,2.0,805.0,805.0
240.027,6,9,787,5,488,60006.0,232.0,232.0,4,299,80007.0,83.0,83.0
0.006,6,10,1547,5,764,1.0,496.0,496.0,5,783,1.0,515.0,515.0
0.007,6,10,1547,5,764,1.0,496.0,496.0,5,783,1.0,515.0,515.0
1756.149,6,105,6270,60,3525,29764.0,27.0,27.0,45,2745,39911.0,27.0,27.0
0.011,6,10,1989,5,910,2.0,642.0,642.0,5,1079,2.0,811.0,811.0
0.005,17,2,170,1,65,0.0,37.0,37.0,1,105,0.0,77.0,77.0
0.005,6,10,2006,5,927,1.0,659.0,659.0,5,1079,1.0,811.0,811.0
0.014,6,10,1990,5,911,3.0,643.0,643.0,5,1079,3.0,811.0,811.0
0.04,17,2,136,1,60,0.0,32.0,32.0,1,76,0.0,48.0,48.0
0.008,6,10,1989,5,910,2.0,642.0,642.0,5,1079,1.0,811.0,811.0
40.048,17,10,676,5,460,10009.0,104.0,64.0,5,216,10006.0,20.0,15.0
0.07,6,10,1506,5,395,15.0,127.0,127.0,5,1111,15.0,843.0,843.0
0.005,17,2,166,1,75,0.0,47.0,47.0,1,91,0.0,63.0,63.0
0.018,6,10,1983,5,910,4.0,642.0,642.0,5,1073,4.0,805.0,805.0
0.09,6,10,1506,5,395,20.0,127.0,127.0,5,1111,19.0,843.0,843.0
0.004,6,10,1989,5,927,1.0,659.0,659.0,5,1062,1.0,794.0,794.0
40.063,17,10,676,5,460,10014.0,104.0,64.0,5,216,10014.0,20.0,15.0
0.007,6,10,1762,5,911,1.0,643.0,643.0,5,851,1.0,583.0,583.0
328.241,17,20,1124,10,716,36457.0,48.0,43.0,10,408,36457.0,20.0,12.0
0.009,6,10,1989,5,910,2.0,642.0,642.0,5,1079,2.0,811.0,811.0
0.006,6,10,1547,5,764,1.0,496.0,496.0,5,783,1.0,515.0,515.0
300.332,6,16,2170,9,684,37521.0,146.0,146.0,7,1486,50028.0,419.0,398.0
0.06,17,2,80,1,32,0.0,4.0,4.0,1,48,0.0,20.0,20.0
0.171,6,3,453,2,321,171.0,241.0,241.0,1,132,0.0,92.0,92.0
0.008,6,12,1926,6,1189,1.0,659.0,434.0,6,737,1.0,417.0,417.0
0.005,6,10,1989,5,927,1.0,659.0,659.0,5,1062,1.0,794.0,794.0
0.059,17,2,152,1,76,0.0,48.0,48.0,1,76,0.0,48.0,48.0
0.005,17,2,144,1,64,0.0,36.0,36.0,1,80,0.0,52.0,52.0
372.393,6,41,16031,22,2957,17733.0,663.0,361.0,19,13074,17351.0,1402.0,929.0
0.111,6,10,1506,5,395,24.0,127.0,127.0,5,1111,22.0,843.0,843.0
240.088,6,16,4481,9,963,30011.0,238.0,166.0,7,3518,40014.0,1402.0,786.0
0.08,6,10,1506,5,395,17.0,127.0,127.0,5,1111,18.0,843.0,843.0
0.008,6,10,1989,5,910,2.0,642.0,642.0,5,1079,2.0,811.0,811.0
0.004,17,2,148,1,60,0.0,32.0,32.0,1,88,0.0,60.0,60.0
0.004,6,10,1702,5,863,1.0,595.0,595.0,5,839,1.0,571.0,571.0
0.012,6,10,1631,5,848,3.0,580.0,580.0,5,783,3.0,515.0,515.0
0.175,17,2,194,1,59,0.0,31.0,31.0,1,135,0.0,107.0,107.0
0.008,6,10,1547,5,764,2.0,496.0,496.0,5,783,1.0,515.0,515.0
360.04,6,21,3981,13,3142,30003.0,494.0,494.0,8,839,51433.0,83.0,83.0
0.006,6,10,1989,5,927,1.0,659.0,659.0,5,1062,1.0,794.0,794.0
0.101,6,10,1506,5,395,21.0,127.0,127.0,5,1111,23.0,843.0,843.0
0.004,17,4,284,2,120,0.0,32.0,32.0,2,164,0.0,60.0,54.0
0.072,17,2,170,1,65,0.0,37.0,37.0,1,105,0.0,77.0,77.0
0.005,6,10,2000,5,927,1.0,659.0,659.0,5,1073,1.0,805.0,805.0
1795.966,17,2828,216197,1408,114172,1276.0,84.0,53.0,1420,102025,1265.0,227.0,43.0
0.004,17,2,136,1,60,0.0,32.0,32.0,1,76,0.0,48.0,48.0
40.06,17,10,676,5,460,10012.0,104.0,64.0,5,216,10014.0,20.0,15.0
0.016,6,10,1631,5,848,4.0,580.0,580.0,5,783,3.0,515.0,515.0
0.017,6,10,1989,5,910,4.0,642.0,642.0,5,1079,4.0,811.0,811.0
0.102,6,10,1506,5,395,22.0,127.0,127.0,5,1111,21.0,843.0,843.0
0.113,6,10,1506,5,395,21.0,127.0,127.0,5,1111,22.0,843.0,843.0
0.018,6,10,1983,5,910,4.0,642.0,642.0,5,1073,4.0,805.0,805.0
0.011,6,10,1972,5,910,2.0,642.0,642.0,5,1062,2.0,794.0,794.0
0.175,17,2,152,1,76,0.0,48.0,48.0,1,76,0.0,48.0,48.0
0.007,6,10,1689,5,839,1.0,571.0,571.0,5,850,1.0,582.0,582.0
0.103,6,10,1506,5,395,23.0,127.0,127.0,5,1111,23.0,843.0,843.0
0.004,17,2,170,1,65,0.0,37.0,37.0,1,105,0.0,77.0,77.0
0.136,6,10,1506,5,395,18.0,127.0,127.0,5,1111,31.0,843.0,843.0
0.042,17,2,136,1,60,0.0,32.0,32.0,1,76,0.0,48.0,48.0
0.007,6,10,1689,5,839,1.0,571.0,571.0,5,850,1.0,582.0,582.0
0.012,6,10,1983,5,910,2.0,642.0,642.0,5,1073,3.0,805.0,805.0
0.003,6,10,1702,5,863,0.0,595.0,595.0,5,839,0.0,571.0,571.0
0.022,6,10,1989,5,910,5.0,642.0,642.0,5,1079,5.0,811.0,811.0
240.08,6,16,4481,9,963,30010.0,238.0,166.0,7,3518,40012.0,1402.0,786.0
0.016,17,2,198,1,91,0.0,63.0,63.0,1,107,0.0,79.0,79.0
0.008,6,12,1926,6,1189,1.0,659.0,434.0,6,737,1.0,417.0,417.0
11.171,17,28,4422,14,1994,846.0,269.0,114.0,14,2428,846.0,587.0,145.0
176.333,17,68,9747,34,2266,5343.0,44.0,38.0,34,7481,5343.0,252.0,192.0
0.039,17,4,284,2,120,0.0,32.0,32.0,2,164,36.0,60.0,54.0
0.046,6,10,1983,5,910,11.0,642.0,642.0,5,1073,11.0,805.0,805.0
0.008,6,10,1547,5,764,1.0,496.0,496.0,5,783,1.0,515.0,515.0
0.089,17,2,184,1,61,0.0,33.0,33.0,1,123,0.0,95.0,95.0
0.004,6,10,1989,5,927,1.0,659.0,659.0,5,1062,1.0,794.0,794.0
0.005,6,10,2006,5,927,1.0,659.0,659.0,5,1079,1.0,811.0,811.0
0.009,6,10,1774,5,923,2.0,655.0,655.0,5,851,2.0,583.0,583.0
240.09,6,31,9123,15,6697,17149.0,1821.0,657.0,16,2426,16005.0,580.0,198.0
0.006,6,10,1643,5,860,1.0,592.0,592.0,5,783,1.0,515.0,515.0
15.074,17,15,9238,8,6902,2149.0,1350.0,834.0,7,2336,2507.0,1350.0,305.0
0.107,6,10,1506,5,395,24.0,127.0,127.0,5,1111,25.0,843.0,843.0
0.008,6,10,1989,5,910,2.0,642.0,642.0,5,1079,2.0,811.0,811.0
0.014,6,10,1989,5,910,3.0,642.0,642.0,5,1079,3.0,811.0,811.0
0.004,6,10,2007,5,928,1.0,660.0,660.0,5,1079,1.0,811.0,811.0
0.006,6,10,1547,5,764,1.0,496.0,496.0,5,783,1.0,515.0,515.0
0.005,6,10,2007,5,928,1.0,660.0,660.0,5,1079,1.0,811.0,811.0
0.018,6,10,1983,5,910,4.0,642.0,642.0,5,1073,4.0,805.0,805.0
0.019,6,10,1990,5,911,4.0,643.0,643.0,5,1079,4.0,811.0,811.0
0.009,6,13,3735,7,497,1.0,125.0,125.0,6,3238,1.0,1470.0,1459.0
9.039,17,6,376,5,280,2259.0,28.0,28.0,1,96,0.0,68.0,68.0
0.011,6,10,1762,5,911,2.0,643.0,643.0,5,851,2.0,583.0,583.0
0.005,6,10,2007,5,928,1.0,660.0,660.0,5,1079,1.0,811.0,811.0
0.017,6,13,3735,7,497,2.0,125.0,125.0,6,3238,3.0,1470.0,1459.0
0.174,17,2,213,1,69,0.0,41.0,41.0,1,144,0.0,116.0,116.0
0.01,6,10,1677,5,827,2.0,559.0,559.0,5,850,2.0,582.0,582.0
0.111,6,10,1506,5,395,19.0,127.0,127.0,5,1111,25.0,843.0,843.0
0.008,6,12,1926,6,1189,1.0,659.0,434.0,6,737,1.0,417.0,417.0
0.073,6,10,1506,5,395,15.0,127.0,127.0,5,1111,15.0,843.0,843.0
40.041,17,10,676,5,460,10009.0,104.0,64.0,5,216,10009.0,20.0,15.0
0.003,17,2,136,1,60,0.0,32.0,32.0,1,76,0.0,48.0,48.0
0.018,6,10,1631,5,848,4.0,580.0,580.0,5,783,4.0,515.0,515.0
0.019,6,10,1990,5,911,4.0,643.0,643.0,5,1079,4.0,811.0,811.0
0.107,6,10,1506,5,395,22.0,127.0,127.0,5,1111,22.0,843.0,843.0
309.45,17,20,1124,10,716,34368.0,48.0,43.0,10,408,34369.0,20.0,12.0
15.01,17,471,345141,159,14504,94.0,1350.0,63.0,312,330637,48.0,1350.0,1031.0
0.005,6,10,1774,5,923,1.0,655.0,655.0,5,851,1.0,583.0,583.0
0.005,6,10,1689,5,839,1.0,571.0,571.0,5,850,1.0,582.0,582.0
0.015,6,10,1677,5,827,3.0,559.0,559.0,5,850,3.0,582.0,582.0
0.072,17,4,284,2,120,0.0,32.0,32.0,2,164,31.0,60.0,54.0
294.15,6,396,347613,195,21701,1516.0,2736.0,888.0,201,325912,1470.0,2804.0,1695.0
0.009,6,10,1989,5,910,2.0,642.0,642.0,5,1079,2.0,811.0,811.0
0.001,17,2,180,1,66,0.0,38.0,38.0,1,114,0.0,86.0,86.0
0.014,17,2,170,1,65,0.0,37.0,37.0,1,105,0.0,77.0,77.0
0.092,6,10,1506,5,395,21.0,127.0,127.0,5,1111,19.0,843.0,843.0
0.043,17,4,352,2,130,0.0,37.0,37.0,2,222,6.0,89.0,83.0
0.005,6,10,2000,5,927,1.0,659.0,659.0,5,1073,1.0,805.0,805.0
0.013,6,10,1972,5,910,3.0,642.0,642.0,5,1062,3.0,794.0,794.0
0.005,6,10,2007,5,928,1.0,660.0,660.0,5,1079,1.0,811.0,811.0
0.007,6,10,2006,5,927,1.0,659.0,659.0,5,1079,1.0,811.0,811.0
0.012,6,10,1989,5,910,3.0,642.0,642.0,5,1079,2.0,811.0,811.0
0.09,6,10,1506,5,395,19.0,127.0,127.0,5,1111,18.0,843.0,843.0
0.005,6,10,2006,5,927,1.0,659.0,659.0,5,1079,1.0,811.0,811.0
0.005,6,10,2007,5,928,1.0,660.0,660.0,5,1079,1.0,811.0,811.0
0.003,17,2,186,1,61,0.0,33.0,33.0,1,125,0.0,97.0,97.0
0.076,6,10,1506,5,395,17.0,127.0,127.0,5,1111,14.0,843.0,843.0
40.064,17,10,676,5,460,10015.0,104.0,64.0,5,216,10015.0,20.0,15.0
450.414,6,40,13111,21,4179,22518.0,676.0,439.0,19,8932,25021.0,1402.0,722.0
0.08,6,10,1506,5,395,17.0,127.0,127.0,5,1111,19.0,843.0,843.0
0.011,6,10,1677,5,827,2.0,559.0,559.0,5,850,2.0,582.0,582.0
0.087,6,10,1506,5,395,21.0,127.0,127.0,5,1111,18.0,843.0,843.0
0.004,17,2,136,1,60,0.0,32.0,32.0,1,76,0.0,48.0,48.0
0.02,6,10,1762,5,911,4.0,643.0,643.0,5,851,5.0,583.0,583.0
0.005,6,10,1774,5,923,1.0,655.0,655.0,5,851,1.0,583.0,583.0
0.008,6,10,1989,5,910,2.0,642.0,642.0,5,1079,1.0,811.0,811.0
0.013,6,10,1989,5,910,3.0,642.0,642.0,5,1079,3.0,811.0,811.0
0.27,17,40,21644,22,18421,12.0,1350.0,809.0,18,3223,12.0,1350.0,151.0
0.004,17,2,136,1,60,0.0,32.0,32.0,1,76,0.0,48.0,48.0
0.089,6,10,1506,5,395,20.0,127.0,127.0,5,1111,18.0,843.0,843.0
0.005,6,10,1779,5,928,1.0,660.0,660.0,5,851,1.0,583.0,583.0
40.066,17,10,676,5,460,10014.0,104.0,64.0,5,216,10015.0,20.0,15.0
0.013,6,10,1989,5,910,3.0,642.0,642.0,5,1079,3.0,811.0,811.0
0.018,6,13,3735,7,497,3.0,125.0,125.0,6,3238,3.0,1470.0,1459.0
15.071,17,15,9238,8,6902,2149.0,1350.0,834.0,7,2336,2507.0,1350.0,305.0
0.038,17,2,152,1,76,0.0,48.0,48.0,1,76,0.0,48.0,48.0
0.003,17,2,148,1,60,0.0,32.0,32.0,1,88,0.0,60.0,60.0
0.01,6,10,1677,5,827,2.0,559.0,559.0,5,850,2.0,582.0,582.0
40.069,17,10,676,5,460,10013.0,104.0,64.0,5,216,10014.0,20.0,15.0
0.006,6,13,3747,7,509,0.0,137.0,137.0,6,3238,1.0,1470.0,1459.0
0.005,6,14,3742,7,452,0.0,80.0,80.0,7,3290,0.0,1448.0,972.0
0.019,6,10,1631,5,848,4.0,580.0,580.0,5,783,4.0,515.0,515.0
0.009,6,10,1983,5,910,2.0,642.0,642.0,5,1073,2.0,805.0,805.0
40.064,17,10,676,5,460,10012.0,104.0,64.0,5,216,10015.0,20.0,15.0
0.015,6,10,1989,5,910,3.0,642.0,642.0,5,1079,3.0,811.0,811.0
0.005,6,10,2006,5,927,1.0,659.0,659.0,5,1079,1.0,811.0,811.0
0.005,17,2,169,1,62,0.0,34.0,34.0,1,107,0.0,79.0,79.0
240.015,6,9,787,5,488,60003.0,232.0,232.0,4,299,80003.0,83.0,83.0
240.101,6,16,4481,9,963,30012.0,238.0,166.0,7,3518,40016.0,1402.0,786.0
0.006,6,10,2007,5,928,1.0,660.0,660.0,5,1079,1.0,811.0,811.0
0.012,6,10,1631,5,848,2.0,580.0,580.0,5,783,2.0,515.0,515.0
0.005,17,2,140,1,62,0.0,34.0,34.0,1,78,0.0,50.0,50.0
0.013,6,10,1989,5,910,3.0,642.0,642.0,5,1079,3.0,811.0,811.0
0.011,6,10,1547,5,764,2.0,496.0,496.0,5,783,2.0,515.0,515.0
0.079,6,10,1506,5,395,18.0,127.0,127.0,5,1111,18.0,843.0,843.0
0.004,6,10,2006,5,927,1.0,659.0,659.0,5,1079,1.0,811.0,811.0
0.013,6,10,1990,5,911,3.0,643.0,643.0,5,1079,3.0,811.0,811.0
1787.08,6,154,19574,92,13852,19638.0,302.0,302.0,62,5722,29296.0,83.0,83.0
292.374,6,316,344171,122,17893,2416.0,2736.0,888.0,194,326278,1514.0,2914.0,1756.0
0.005,6,10,1689,5,839,1.0,571.0,571.0,5,850,1.0,582.0,582.0
0.003,17,2,148,1,60,0.0,32.0,32.0,1,88,0.0,60.0,60.0
0.07,17,8,3613,4,1874,23.0,1350.0,440.0,4,1739,12.0,1350.0,406.0
0.171,6,3,453,2,321,171.0,241.0,241.0,1,132,0.0,92.0,92.0
0.014,6,10,1972,5,910,3.0,642.0,642.0,5,1062,3.0,794.0,794.0
0.004,6,10,1989,5,927,1.0,659.0,659.0,5,1062,1.0,794.0,794.0
240.091,6,16,4482,9,963,30011.0,238.0,166.0,7,3519,40014.0,1402.0,786.0
0.013,6,10,1972,5,910,3.0,642.0,642.0,5,1062,3.0,794.0,794.0
0.004,17,2,136,1,60,0.0,32.0,32.0,1,76,0.0,48.0,48.0
0.082,6,10,1506,5,395,16.0,127.0,127.0,5,1111,17.0,843.0,843.0
0.105,6,10,1506,5,395,24.0,127.0,127.0,5,1111,25.0,843.0,843.0
0.0,17,2,140,1,62,0.0,34.0,34.0,1,78,0.0,50.0,50.0
318.446,17,20,1124,10,716,35376.0,48.0,43.0,10,408,35376.0,20.0,12.0
0.04,17,2,152,1,76,0.0,48.0,48.0,1,76,0.0,48.0,48.0
0.02,6,10,1989,5,910,5.0,642.0,642.0,5,1079,5.0,811.0,811.0
0.003,17,2,136,1,60,0.0,32.0,32.0,1,76,0.0,48.0,48.0
8.841,6,36,10367,19,4889,491.0,1360.0,819.0,17,5478,539.0,2667.0,435.0
0.001,17,2,166,1,75,0.0,47.0,47.0,1,91,0.0,63.0,63.0
300.726,6,36,9586,19,4108,16707.0,1572.0,663.0,17,5478,535.0,2667.0,435.0
0.005,6,10,2006,5,927,1.0,659.0,659.0,5,1079,1.0,811.0,811.0
40.059,17,10,676,5,460,10013.0,104.0,64.0,5,216,10013.0,20.0,15.0
0.012,6,10,1989,5,910,3.0,642.0,642.0,5,1079,3.0,811.0,811.0
308.491,17,20,1124,10,716,34262.0,48.0,43.0,10,408,34262.0,20.0,12.0
0.008,6,10,1547,5,764,2.0,496.0,496.0,5,783,2.0,515.0,515.0
0.04,17,2,170,1,65,0.0,37.0,37.0,1,105,0.0,77.0,77.0
0.011,6,10,1631,5,848,2.0,580.0,580.0,5,783,2.0,515.0,515.0
0.004,6,10,2007,5,928,1.0,660.0,660.0,5,1079,1.0,811.0,811.0
1792.131,6,586,194406,296,165737,6075.0,2883.0,894.0,290,28669,6201.0,580.0,123.0
0.001,17,2,180,1,66,0.0,38.0,38.0,1,114,0.0,86.0,86.0
0.013,17,2,148,1,60,0.0,32.0,32.0,1,88,0.0,60.0,60.0
240.09,6,32,9281,16,6803,16006.0,1877.0,663.0,16,2478,16005.0,580.0,204.0
0.292,17,45,24692,24,21168,12.0,1350.0,854.0,21,3524,12.0,1350.0,139.0
0.001,17,2,180,1,66,0.0,38.0,38.0,1,114,0.0,86.0,86.0
0.006,6,10,1547,5,764,1.0,496.0,496.0,5,783,1.0,515.0,515.0
374.881,6,22,2313,16,867,24992.0,195.0,195.0,6,1446,4647.0,419.0,398.0
0.13,6,10,1506,5,395,30.0,127.0,127.0,5,1111,27.0,843.0,843.0
40.051,17,10,676,5,460,10011.0,104.0,64.0,5,216,10010.0,20.0,15.0
0.013,6,14,3787,7,497,2.0,125.0,125.0,7,3290,2.0,1448.0,972.0
0.006,6,10,1547,5,764,1.0,496.0,496.0,5,783,1.0,515.0,515.0
0.005,6,10,2006,5,927,1.0,659.0,659.0,5,1079,1.0,811.0,811.0
0.037,17,2,234,1,61,0.0,33.0,33.0,1,173,0.0,145.0,145.0
0.008,6,10,1989,5,910,2.0,642.0,642.0,5,1079,2.0,811.0,811.0
0.132,6,10,1506,5,395,32.0,127.0,127.0,5,1111,31.0,843.0,843.0
40.067,17,10,676,5,460,10014.0,104.0,64.0,5,216,10015.0,20.0,15.0
0.002,17,2,136,1,60,0.0,32.0,32.0,1,76,0.0,48.0,48.0
0.004,17,2,140,1,62,0.0,34.0,34.0,1,78,0.0,50.0,50.0
0.018,6,10,1990,5,911,4.0,643.0,643.0,5,1079,4.0,811.0,811.0
0.001,17,2,180,1,66,0.0,38.0,38.0,1,114,0.0,86.0,86.0
0.005,6,10,1643,5,860,1.0,592.0,592.0,5,783,1.0,515.0,515.0
308.927,17,18,1008,9,640,38599.0,48.0,43.0,9,368,38599.0,20.0,12.0
0.054,17,2,152,1,76,0.0,48.0,48.0,1,76,0.0,48.0,48.0
240.086,6,16,4481,9,963,30010.0,238.0,166.0,7,3518,40013.0,1402.0,786.0
0.008,6,12,1926,6,1189,1.0,659.0,434.0,6,737,1.0,417.0,417.0
290.774,6,321,343707,135,18578,2169.0,2736.0,889.0,186,325129,1571.0,2769.0,1834.0
0.006,6,10,1547,5,764,1.0,496.0,496.0,5,783,1.0,515.0,515.0
0.011,6,10,1972,5,910,2.0,642.0,642.0,5,1062,2.0,794.0,794.0
0.009,6,10,1989,5,910,2.0,642.0,642.0,5,1079,2.0,811.0,811.0
0.005,6,15,3794,8,504,0.0,80.0,80.0,7,3290,0.0,1448.0,972.0
0.005,6,10,1547,5,764,1.0,496.0,496.0,5,783,1.0,515.0,515.0
0.089,6,10,1506,5,395,17.0,127.0,127.0,5,1111,21.0,843.0,843.0
0.004,6,10,1774,5,923,1.0,655.0,655.0,5,851,1.0,583.0,583.0
0.038,17,4,284,2,120,0.0,32.0,32.0,2,164,35.0,60.0,54.0
0.009,6,10,1762,5,911,2.0,643.0,643.0,5,851,2.0,583.0,583.0
0.005,6,10,1774,5,923,1.0,655.0,655.0,5,851,1.0,583.0,583.0
0.041,17,4,420,2,122,1.0,33.0,33.0,2,298,37.0,145.0,121.0
0.167,6,10,1506,5,395,33.0,127.0,127.0,5,1111,38.0,843.0,843.0
0.096,6,10,1506,5,395,20.0,127.0,127.0,5,1111,22.0,843.0,843.0
40.087,17,10,676,5,460,10020.0,104.0,64.0,5,216,10021.0,20.0,15.0
0.148,6,10,1506,5,395,34.0,127.0,127.0,5,1111,32.0,843.0,843.0
0.005,6,10,1854,5,889,1.0,621.0,621.0,5,965,1.0,697.0,697.0
0.012,6,10,1983,5,910,3.0,642.0,642.0,5,1073,3.0,805.0,805.0
0.006,17,2,144,1,64,0.0,36.0,36.0,1,80,0.0,52.0,52.0
0.004,6,10,1989,5,927,1.0,659.0,659.0,5,1062,1.0,794.0,794.0
0.006,6,10,1547,5,764,1.0,496.0,496.0,5,783,1.0,515.0,515.0
240.087,6,31,9587,15,7033,17149.0,2159.0,695.0,16,2554,16005.0,580.0,214.0
0.005,6,10,2007,5,928,1.0,660.0,660.0,5,1079,1.0,811.0,811.0
0.012,6,10,1983,5,910,2.0,642.0,642.0,5,1073,3.0,805.0,805.0
1770.352,6,83,4368,42,2210,43178.0,26.0,26.0,41,2158,44257.0,26.0,26.0
0.016,17,2,170,1,65,0.0,37.0,37.0,1,105,0.0,77.0,77.0
0.006,17,2,144,1,64,0.0,36.0,36.0,1,80,0.0,52.0,52.0
0.006,6,10,2006,5,927,1.0,659.0,659.0,5,1079,1.0,811.0,811.0
0.009,6,10,1762,5,911,2.0,643.0,643.0,5,851,2.0,583.0,583.0
0.006,17,2,170,1,65,0.0,37.0,37.0,1,105,0.0,77.0,77.0
0.104,6,10,1506,5,395,24.0,127.0,127.0,5,1111,21.0,843.0,843.0
241.53,6,38,9760,20,2236,12703.0,744.0,235.0,18,7524,14197.0,1402.0,599.0
0.004,6,10,1702,5,863,0.0,595.0,595.0,5,839,1.0,571.0,571.0
0.111,6,10,1506,5,395,26.0,127.0,127.0,5,1111,24.0,843.0,843.0
0.066,6,10,1506,5,395,15.0,127.0,127.0,5,1111,14.0,843.0,843.0
0.005,17,2,136,1,60,0.0,32.0,32.0,1,76,0.0,48.0,48.0
0.008,6,10,1972,5,910,2.0,642.0,642.0,5,1062,2.0,794.0,794.0
300.542,6,27,8922,15,1930,21467.0,517.0,285.0,12,6992,21861.0,1402.0,908.0
0.077,6,10,1506,5,395,18.0,127.0,127.0,5,1111,16.0,843.0,843.0
0.011,6,10,1989,5,910,2.0,642.0,642.0,5,1079,2.0,811.0,811.0
0.004,17,2,136,1,60,0.0,32.0,32.0,1,76,0.0,48.0,48.0
0.013,6,10,1989,5,910,3.0,642.0,642.0,5,1079,3.0,811.0,811.0
296.042,17,124,17766,62,4138,4853.0,44.0,38.0,62,13628,4853.0,239.0,191.0
0.018,6,10,1677,5,827,4.0,559.0,559.0,5,850,4.0,582.0,582.0
0.01,6,10,1990,5,911,2.0,643.0,643.0,5,1079,2.0,811.0,811.0
0.09,6,10,1506,5,395,20.0,127.0,127.0,5,1111,19.0,843.0,843.0
0.006,6,13,3690,7,452,0.0,80.0,80.0,6,3238,1.0,1470.0,1459.0
40.063,17,10,676,5,460,10014.0,104.0,64.0,5,216,10013.0,20.0,15.0
0.005,6,10,1774,5,923,1.0,655.0,655.0,5,851,1.0,583.0,583.0
0.077,6,10,1506,5,395,18.0,127.0,127.0,5,1111,16.0,843.0,843.0
67.772,6,37,10569,19,5051,489.0,1360.0,851.0,18,5518,3976.0,2667.0,435.0
0.019,6,12,1926,6,1189,3.0,659.0,434.0,6,737,3.0,417.0,417.0
0.097,17,2,80,1,32,0.0,4.0,4.0,1,48,0.0,20.0,20.0
0.009,17,2,175,1,65,0.0,37.0,37.0,1,110,0.0,82.0,82.0
0.017,17,2,148,1,60,0.0,32.0,32.0,1,88,0.0,60.0,60.0
0.025,6,10,1990,5,911,6.0,643.0,643.0,5,1079,6.0,811.0,811.0
0.082,6,10,1506,5,395,18.0,127.0,127.0,5,1111,18.0,843.0,843.0
0.01,6,10,1990,5,911,2.0,643.0,643.0,5,1079,2.0,811.0,811.0
0.009,6,10,1983,5,910,2.0,642.0,642.0,5,1073,2.0,805.0,805.0
0.006,6,10,1547,5,764,1.0,496.0,496.0,5,783,1.0,515.0,515.0
0.006,6,10,1643,5,860,1.0,592.0,592.0,5,783,1.0,515.0,515.0
15.08,17,15,8365,8,6283,2150.0,1350.0,757.0,7,2082,2508.0,1350.0,269.0
0.006,6,10,1854,5,889,1.0,621.0,621.0,5,965,1.0,697.0,697.0
0.004,6,10,1702,5,863,0.0,595.0,595.0,5,839,1.0,571.0,571.0
0.01,6,10,1762,5,911,2.0,643.0,643.0,5,851,2.0,583.0,583.0
11.39,17,28,4392,14,2313,864.0,588.0,137.0,14,2079,863.0,270.0,120.0
0.006,17,2,169,1,62,0.0,34.0,34.0,1,107,0.0,79.0,79.0
40.063,17,10,676,5,460,10015.0,104.0,64.0,5,216,10015.0,20.0,15.0
0.167,17,2,152,1,76,0.0,48.0,48.0,1,76,0.0,48.0,48.0
0.001,17,2,179,1,62,0.0,34.0,34.0,1,117,0.0,89.0,89.0
0.235,6,16,2777,8,1395,33.0,533.0,323.0,8,1382,21.0,529.0,239.0
0.094,6,10,1506,5,395,20.0,127.0,127.0,5,1111,18.0,843.0,843.0
164.305,17,84,12333,42,2826,4007.0,44.0,39.0,42,9507,4007.0,261.0,198.0
0.183,6,10,1506,5,395,42.0,127.0,127.0,5,1111,45.0,843.0,843.0
0.004,6,10,1702,5,863,1.0,595.0,595.0,5,839,0.0,571.0,571.0
300.329,6,27,7436,16,1409,20021.0,217.0,142.0,11,6027,24031.0,1679.0,778.0
0.074,6,10,1506,5,395,17.0,127.0,127.0,5,1111,14.0,843.0,843.0
0.005,17,2,169,1,62,0.0,34.0,34.0,1,107,0.0,79.0,79.0
40.06,17,10,676,5,460,10014.0,104.0,64.0,5,216,10014.0,20.0,15.0
0.004,17,2,136,1,60,0.0,32.0,32.0,1,76,0.0,48.0,48.0
0.006,17,2,169,1,62,0.0,34.0,34.0,1,107,0.0,79.0,79.0
0.034,6,10,1990,5,911,8.0,643.0,643.0,5,1079,8.0,811.0,811.0
0.001,17,2,140,1,62,0.0,34.0,34.0,1,78,0.0,50.0,50.0
0.008,6,10,1989,5,910,1.0,642.0,642.0,5,1079,1.0,811.0,811.0
0.004,6,10,2007,5,928,1.0,660.0,660.0,5,1079,1.0,811.0,811.0
0.018,6,10,1990,5,911,4.0,643.0,643.0,5,1079,4.0,811.0,811.0
0.005,6,10,1779,5,928,1.0,660.0,660.0,5,851,1.0,583.0,583.0
10.882,17,28,4422,14,1994,828.0,269.0,114.0,14,2428,828.0,587.0,145.0
0.082,6,10,1506,5,395,18.0,127.0,127.0,5,1111,16.0,843.0,843.0
0.076,6,10,1506,5,395,16.0,127.0,127.0,5,1111,17.0,843.0,843.0
0.13,17,2,80,1,32,0.0,4.0,4.0,1,48,0.0,20.0,20.0
0.003,17,4,284,2,120,0.0,32.0,32.0,2,164,0.0,60.0,54.0
0.004,17,4,284,2,120,1.0,32.0,32.0,2,164,0.0,60.0,54.0
0.007,6,10,1983,5,910,1.0,642.0,642.0,5,1073,1.0,805.0,805.0
0.038,17,4,284,2,120,0.0,32.0,32.0,2,164,35.0,60.0,54.0
0.06,17,2,152,1,76,0.0,48.0,48.0,1,76,0.0,48.0,48.0
0.04,17,2,186,1,61,0.0,33.0,33.0,1,125,0.0,97.0,97.0
0.011,6,10,1677,5,827,2.0,559.0,559.0,5,850,2.0,582.0,582.0
0.141,6,10,1506,5,395,33.0,127.0,127.0,5,1111,31.0,843.0,843.0
0.005,6,10,2007,5,928,1.0,660.0,660.0,5,1079,1.0,811.0,811.0
0.005,17,2,186,1,61,0.0,33.0,33.0,1,125,0.0,97.0,97.0
0.013,6,10,1972,5,910,3.0,642.0,642.0,5,1062,3.0,794.0,794.0
0.069,6,10,1506,5,395,16.0,127.0,127.0,5,1111,15.0,843.0,843.0
178.508,17,72,10210,36,2401,5099.0,44.0,38.0,36,7809,5099.0,239.0,188.0
0.006,6,10,1547,5,764,1.0,496.0,496.0,5,783,1.0,515.0,515.0
0.056,17,4,284,2,120,1.0,32.0,32.0,2,164,0.0,60.0,54.0
0.007,6,10,1689,5,839,1.0,571.0,571.0,5,850,1.0,582.0,582.0
0.011,6,10,1983,5,910,2.0,642.0,642.0,5,1073,2.0,805.0,805.0
0.004,6,10,2000,5,927,1.0,659.0,659.0,5,1073,1.0,805.0,805.0
0.018,6,10,1989,5,910,4.0,642.0,642.0,5,1079,4.0,811.0,811.0
11.018,17,29,4566,15,2167,779.0,270.0,116.0,14,2399,839.0,586.0,143.0
0.024,6,13,3913,7,495,3.0,123.0,123.0,6,3418,4.0,1650.0,1549.0
0.01,6,10,1989,5,910,2.0,642.0,642.0,5,1079,2.0,811.0,811.0
0.005,6,10,1643,5,860,1.0,592.0,592.0,5,783,1.0,515.0,515.0
40.063,17,10,676,5,460,10014.0,104.0,64.0,5,216,10013.0,20.0,15.0
240.087,6,16,4480,9,963,30010.0,238.0,166.0,7,3517,40014.0,1402.0,786.0
369.006,6,22,2313,16,867,24600.0,195.0,195.0,6,1446,4643.0,419.0,398.0
0.005,6,10,1779,5,928,1.0,660.0,660.0,5,851,1.0,583.0,583.0
173.335,17,78,11089,39,2600,4561.0,44.0,38.0,39,8489,4561.0,239.0,189.0
0.01,6,10,1989,5,910,2.0,642.0,642.0,5,1079,2.0,811.0,811.0
0.005,6,10,2007,5,928,1.0,660.0,660.0,5,1079,1.0,811.0,811.0
313.861,17,20,1124,10,716,34858.0,48.0,43.0,10,408,34858.0,20.0,12.0
0.043,17,2,136,1,60,0.0,32.0,32.0,1,76,0.0,48.0,48.0
0.004,6,10,2006,5,927,1.0,659.0,659.0,5,1079,1.0,811.0,811.0
0.004,6,10,2006,5,927,1.0,659.0,659.0,5,1079,1.0,811.0,811.0
0.005,6,14,3742,8,504,0.0,80.0,80.0,6,3238,0.0,1470.0,1459.0
0.005,6,10,2006,5,927,1.0,659.0,659.0,5,1079,1.0,811.0,811.0
0.011,6,10,1983,5,910,2.0,642.0,642.0,5,1073,2.0,805.0,805.0
240.102,6,31,9432,15,6897,17150.0,2021.0,680.0,16,2535,16006.0,580.0,211.0
0.012,6,10,1677,5,827,3.0,559.0,559.0,5,850,3.0,582.0,582.0
0.068,17,8,3613,4,1874,22.0,1350.0,440.0,4,1739,11.0,1350.0,406.0
0.011,6,10,1989,5,910,2.0,642.0,642.0,5,1079,2.0,811.0,811.0
0.003,17,4,284,2,120,0.0,32.0,32.0,2,164,1.0,60.0,54.0
0.038,17,2,136,1,60,0.0,32.0,32.0,1,76,0.0,48.0,48.0
0.012,17,2,179,1,71,0.0,43.0,43.0,1,108,0.0,80.0,80.0
0.194,6,10,1506,5,395,45.0,127.0,127.0,5,1111,43.0,843.0,843.0
0.087,6,10,1506,5,395,19.0,127.0,127.0,5,1111,19.0,843.0,843.0
0.006,6,10,1547,5,764,1.0,496.0,496.0,5,783,1.0,515.0,515.0
240.14,6,32,9538,16,6878,16009.0,1948.0,672.0,16,2660,16009.0,580.0,227.0
0.009,6,10,1972,5,910,2.0,642.0,642.0,5,1062,2.0,794.0,794.0
0.015,6,10,1990,5,911,3.0,643.0,643.0,5,1079,3.0,811.0,811.0
0.008,17,2,180,1,66,0.0,38.0,38.0,1,114,0.0,86.0,86.0
0.005,6,10,1689,5,839,1.0,571.0,571.0,5,850,1.0,582.0,582.0
0.008,6,10,1972,5,910,2.0,642.0,642.0,5,1062,2.0,794.0,794.0
0.008,6,10,1989,5,910,2.0,642.0,642.0,5,1079,1.0,811.0,811.0
0.023,17,4,420,2,122,0.0,33.0,33.0,2,298,0.0,145.0,121.0
40.058,17,10,676,5,460,10013.0,104.0,64.0,5,216,10013.0,20.0,15.0
0.004,6,10,2006,5,927,1.0,659.0,659.0,5,1079,1.0,811.0,811.0
0.124,6,10,1506,5,395,29.0,127.0,127.0,5,1111,29.0,843.0,843.0
0.181,6,10,1506,5,395,41.0,127.0,127.0,5,1111,40.0,843.0,843.0
0.016,6,10,1989,5,910,3.0,642.0,642.0,5,1079,3.0,811.0,811.0
40.063,17,10,676,5,460,10013.0,104.0,64.0,5,216,10014.0,20.0,15.0
0.004,6,10,1702,5,863,0.0,595.0,595.0,5,839,1.0,571.0,571.0
0.012,6,10,1990,5,911,3.0,643.0,643.0,5,1079,3.0,811.0,811.0
0.11,6,10,1506,5,395,27.0,127.0,127.0,5,1111,21.0,843.0,843.0
0.004,17,2,136,1,60,0.0,32.0,32.0,1,76,0.0,48.0,48.0
0.005,6,10,1989,5,927,1.0,659.0,659.0,5,1062,1.0,794.0,794.0
0.199,6,10,1506,5,395,31.0,127.0,127.0,5,1111,47.0,843.0,843.0
40.069,17,10,676,5,460,10015.0,104.0,64.0,5,216,10016.0,20.0,15.0
15.305,17,42,20344,22,17101,727.0,1350.0,749.0,20,3243,804.0,1350.0,134.0
0.001,17,2,180,1,66,0.0,38.0,38.0,1,114,0.0,86.0,86.0
0.004,17,2,136,1,60,0.0,32.0,32.0,1,76,0.0,48.0,48.0
0.012,6,10,1677,5,827,3.0,559.0,559.0,5,850,3.0,582.0,582.0
15.075,17,11,4410,5,2356,3761.0,1350.0,443.0,6,2054,3009.0,1350.0,314.0
40.059,17,10,676,5,460,10014.0,104.0,64.0,5,216,10013.0,20.0,15.0
0.005,17,2,170,1,65,0.0,37.0,37.0,1,105,0.0,77.0,77.0
0.115,6,10,1506,5,395,24.0,127.0,127.0,5,1111,23.0,843.0,843.0
40.091,17,10,676,5,460,10020.0,104.0,64.0,5,216,10021.0,20.0,15.0
0.129,6,10,1506,5,395,30.0,127.0,127.0,5,1111,29.0,843.0,843.0
0.089,6,10,1506,5,395,21.0,127.0,127.0,5,1111,20.0,843.0,843.0
0.006,6,10,1989,5,927,1.0,659.0,659.0,5,1062,1.0,794.0,794.0
1746.068,6,305,97616,189,86494,9287.0,1402.0,672.0,116,11122,15183.0,452.0,70.0
0.003,6,10,1702,5,863,0.0,595.0,595.0,5,839,0.0,571.0,571.0
0.005,17,4,284,2,120,1.0,32.0,32.0,2,164,2.0,60.0,54.0
0.005,6,10,1702,5,863,1.0,595.0,595.0,5,839,1.0,571.0,571.0
0.005,6,10,2006,5,927,1.0,659.0,659.0,5,1079,1.0,811.0,811.0
0.01,6,10,1989,5,910,2.0,642.0,642.0,5,1079,2.0,811.0,811.0
240.08,6,19,4994,9,2305,30010.0,1102.0,613.0,10,2689,26675.0,1162.0,432.0
0.001,17,2,180,1,66,0.0,38.0,38.0,1,114,0.0,86.0,86.0
0.011,6,10,1989,5,910,2.0,642.0,642.0,5,1079,2.0,811.0,811.0
0.018,6,10,1990,5,911,4.0,643.0,643.0,5,1079,4.0,811.0,811.0
178.133,17,88,12680,44,2969,4142.0,44.0,39.0,44,9711,4142.0,239.0,192.0
0.006,17,2,230,1,68,0.0,40.0,40.0,1,162,0.0,134.0,134.0
0.365,17,4,352,2,130,235.0,37.0,37.0,2,222,233.0,89.0,83.0
0.004,17,4,284,2,120,0.0,32.0,32.0,2,164,0.0,60.0,54.0
0.133,17,2,170,1,65,0.0,37.0,37.0,1,105,0.0,77.0,77.0
0.005,17,2,200,1,68,0.0,40.0,40.0,1,132,0.0,104.0,104.0
0.014,6,10,1989,5,910,3.0,642.0,642.0,5,1079,3.0,811.0,811.0
0.006,6,10,1983,5,910,1.0,642.0,642.0,5,1073,1.0,805.0,805.0
241.215,6,148,134674,88,7450,2772.0,923.0,475.0,60,127224,4087.0,2804.0,2256.0
0.006,6,10,1689,5,839,1.0,571.0,571.0,5,850,1.0,582.0,582.0
316.742,17,20,1124,10,716,35178.0,48.0,43.0,10,408,35179.0,20.0,12.0
300.019,6,12,1782,7,1348,50003.0,494.0,494.0,5,434,75004.0,83.0,83.0
0.094,6,10,1506,5,395,21.0,127.0,127.0,5,1111,20.0,843.0,843.0
240.094,6,33,9649,17,7074,15005.0,1515.0,619.0,16,2575,16006.0,580.0,216.0
0.003,17,2,148,1,60,0.0,32.0,32.0,1,88,0.0,60.0,60.0
0.009,6,10,1990,5,911,2.0,643.0,643.0,5,1079,2.0,811.0,811.0
0.008,6,10,1677,5,827,2.0,559.0,559.0,5,850,2.0,582.0,582.0
0.082,6,10,1506,5,395,18.0,127.0,127.0,5,1111,18.0,843.0,843.0
0.012,6,10,1989,5,910,3.0,642.0,642.0,5,1079,2.0,811.0,811.0
0.098,6,10,1506,5,395,21.0,127.0,127.0,5,1111,19.0,843.0,843.0
0.006,17,2,166,1,75,0.0,47.0,47.0,1,91,0.0,63.0,63.0
1770.789,6,138,6681,76,3664,23607.0,39.0,39.0,62,3017,29025.0,35.0,35.0
0.042,17,2,170,1,65,0.0,37.0,37.0,1,105,0.0,77.0,77.0
0.009,6,10,1972,5,910,2.0,642.0,642.0,5,1062,2.0,794.0,794.0
0.005,17,2,169,1,62,0.0,34.0,34.0,1,107,0.0,79.0,79.0
0.204,6,16,2777,8,1395,29.0,533.0,323.0,8,1382,18.0,529.0,239.0
300.993,6,37,8261,20,1830,15841.0,651.0,249.0,17,6431,553.0,2126.0,478.0
0.086,6,10,1506,5,395,20.0,127.0,127.0,5,1111,18.0,843.0,843.0
0.005,6,10,2006,5,927,1.0,659.0,659.0,5,1079,1.0,811.0,811.0
11.162,17,28,4423,14,1994,846.0,269.0,114.0,14,2429,846.0,588.0,145.0
0.071,17,8,3613,4,1874,23.0,1350.0,440.0,4,1739,12.0,1350.0,406.0
0.005,6,10,1989,5,927,1.0,659.0,659.0,5,1062,1.0,794.0,794.0
0.005,6,10,1774,5,923,1.0,655.0,655.0,5,851,1.0,583.0,583.0
0.009,6,10,1989,5,910,2.0,642.0,642.0,5,1079,2.0,811.0,811.0
308.65,17,20,1124,10,716,34276.0,48.0,43.0,10,408,34276.0,20.0,12.0
0.075,6,10,1506,5,395,17.0,127.0,127.0,5,1111,18.0,843.0,843.0
0.016,6,10,1983,5,910,3.0,642.0,642.0,5,1073,4.0,805.0,805.0
0.013,6,10,1983,5,910,3.0,642.0,642.0,5,1073,3.0,805.0,805.0
0.006,6,10,1547,5,764,1.0,496.0,496.0,5,783,1.0,515.0,515.0
0.006,6,10,1989,5,927,1.0,659.0,659.0,5,1062,1.0,794.0,794.0
0.001,17,2,180,1,66,0.0,38.0,38.0,1,114,0.0,86.0,86.0
0.172,6,10,1506,5,395,41.0,127.0,127.0,5,1111,38.0,843.0,843.0
0.004,6,10,2007,5,928,1.0,660.0,660.0,5,1079,1.0,811.0,811.0
0.004,17,4,284,2,120,0.0,32.0,32.0,2,164,1.0,60.0,54.0
1796.231,6,549,186992,288,162453,6258.0,2883.0,916.0,261,24539,6908.0,380.0,115.0
0.008,6,10,1990,5,911,2.0,643.0,643.0,5,1079,1.0,811.0,811.0
0.111,6,10,1506,5,395,23.0,127.0,127.0,5,1111,24.0,843.0,843.0
0.092,6,10,1506,5,395,22.0,127.0,127.0,5,1111,20.0,843.0,843.0
0.005,6,10,2000,5,927,1.0,659.0,659.0,5,1073,1.0,805.0,805.0
0.015,6,10,1990,5,911,3.0,643.0,643.0,5,1079,3.0,811.0,811.0
0.009,6,10,1972,5,910,2.0,642.0,642.0,5,1062,2.0,794.0,794.0
0.01,6,10,1689,5,839,2.0,571.0,571.0,5,850,2.0,582.0,582.0
0.011,6,10,1989,5,910,2.0,642.0,642.0,5,1079,2.0,811.0,811.0
0.003,17,2,185,1,73,0.0,45.0,45.0,1,112,0.0,84.0,84.0
0.015,6,10,1990,5,911,3.0,643.0,643.0,5,1079,3.0,811.0,811.0
15.081,17,15,8125,8,5952,2150.0,1350.0,716.0,7,2173,2507.0,1350.0,282.0
0.005,6,10,2000,5,927,1.0,659.0,659.0,5,1073,1.0,805.0,805.0
0.021,6,10,1989,5,910,5.0,642.0,642.0,5,1079,5.0,811.0,811.0
40.049,17,10,676,5,460,10011.0,104.0,64.0,5,216,10011.0,20.0,15.0
0.005,6,10,2000,5,927,1.0,659.0,659.0,5,1073,1.0,805.0,805.0
0.1,6,10,1506,5,395,23.0,127.0,127.0,5,1111,24.0,843.0,843.0
0.016,6,10,1989,5,910,4.0,642.0,642.0,5,1079,4.0,811.0,811.0
0.111,6,10,1506,5,395,21.0,127.0,127.0,5,1111,23.0,843.0,843.0
0.019,6,10,1989,5,910,4.0,642.0,642.0,5,1079,4.0,811.0,811.0
0.006,6,10,1547,5,764,1.0,496.0,496.0,5,783,1.0,515.0,515.0
252.953,6,38,9755,15,6609,18068.0,1735.0,648.0,23,3146,11497.0,580.0,138.0
40.052,17,10,676,5,460,10012.0,104.0,64.0,5,216,10012.0,20.0,15.0
0.08,6,10,1506,5,395,18.0,127.0,127.0,5,1111,17.0,843.0,843.0
0.004,6,10,1702,5,863,1.0,595.0,595.0,5,839,0.0,571.0,571.0
0.001,17,2,180,1,66,0.0,38.0,38.0,1,114,0.0,86.0,86.0
0.008,6,10,1689,5,839,1.0,571.0,571.0,5,850,1.0,582.0,582.0
30.564,6,17,6879,9,689,3820.0,209.0,209.0,8,6190,4365.0,1402.0,1153.0
0.005,6,10,2007,5,928,1.0,660.0,660.0,5,1079,1.0,811.0,811.0
0.005,6,10,2006,5,927,1.0,659.0,659.0,5,1079,1.0,811.0,811.0
0.099,6,10,1506,5,395,20.0,127.0,127.0,5,1111,22.0,843.0,843.0
0.004,17,2,136,1,60,0.0,32.0,32.0,1,76,0.0,48.0,48.0
10.748,17,28,4418,14,1995,818.0,270.0,114.0,14,2423,818.0,586.0,145.0
0.072,6,10,1506,5,395,16.0,127.0,127.0,5,1111,14.0,843.0,843.0
0.005,6,10,2006,5,927,1.0,659.0,659.0,5,1079,1.0,811.0,811.0
0.126,6,10,1506,5,395,26.0,127.0,127.0,5,1111,29.0,843.0,843.0
0.005,6,10,2006,5,927,1.0,659.0,659.0,5,1079,1.0,811.0,811.0
0.041,6,10,1631,5,848,10.0,580.0,580.0,5,783,10.0,515.0,515.0
240.02,6,9,787,5,488,60005.0,232.0,232.0,4,299,80005.0,83.0,83.0
0.003,17,2,132,1,58,0.0,30.0,30.0,1,74,0.0,46.0,46.0
0.003,17,2,148,1,60,0.0,32.0,32.0,1,88,0.0,60.0,60.0
0.006,6,10,1547,5,764,1.0,496.0,496.0,5,783,1.0,515.0,515.0
0.01,6,10,1989,5,910,2.0,642.0,642.0,5,1079,2.0,811.0,811.0
0.075,6,10,1506,5,395,15.0,127.0,127.0,5,1111,16.0,843.0,843.0
40.075,17,10,676,5,460,10015.0,104.0,64.0,5,216,10017.0,20.0,15.0
0.088,6,10,1506,5,395,20.0,127.0,127.0,5,1111,17.0,843.0,843.0
0.016,17,2,157,1,59,0.0,31.0,31.0,1,98,0.0,70.0,70.0
0.005,6,10,2000,5,927,1.0,659.0,659.0,5,1073,1.0,805.0,805.0
0.021,6,10,1983,5,910,5.0,642.0,642.0,5,1073,5.0,805.0,805.0
0.003,17,2,136,1,60,0.0,32.0,32.0,1,76,0.0,48.0,48.0
0.004,17,2,148,1,60,0.0,32.0,32.0,1,88,0.0,60.0,60.0
0.004,6,10,1989,5,927,1.0,659.0,659.0,5,1062,1.0,794.0,794.0
0.005,6,10,2006,5,927,1.0,659.0,659.0,5,1079,1.0,811.0,811.0
0.009,6,10,1989,5,910,2.0,642.0,642.0,5,1079,2.0,811.0,811.0
0.084,6,10,1506,5,395,18.0,127.0,127.0,5,1111,16.0,843.0,843.0
0.005,6,10,2007,5,928,1.0,660.0,660.0,5,1079,1.0,811.0,811.0
0.112,6,10,1506,5,395,24.0,127.0,127.0,5,1111,23.0,843.0,843.0
40.063,17,10,676,5,460,10015.0,104.0,64.0,5,216,10015.0,20.0,15.0
0.005,6,10,2006,5,927,1.0,659.0,659.0,5,1079,1.0,811.0,811.0
0.091,6,10,1506,5,395,21.0,127.0,127.0,5,1111,22.0,843.0,843.0
0.009,6,13,3735,7,497,1.0,125.0,125.0,6,3238,1.0,1470.0,1459.0
0.005,6,10,2007,5,928,1.0,660.0,660.0,5,1079,1.0,811.0,811.0
177.464,17,76,10800,38,2528,4796.0,44.0,38.0,38,8272,4796.0,239.0,189.0
0.005,6,10,1547,5,764,1.0,496.0,496.0,5,783,1.0,515.0,515.0
0.092,6,10,1506,5,395,20.0,127.0,127.0,5,1111,21.0,843.0,843.0
0.005,6,10,1547,5,764,1.0,496.0,496.0,5,783,1.0,515.0,515.0
0.222,6,10,1506,5,395,39.0,127.0,127.0,5,1111,51.0,843.0,843.0
0.04,17,2,182,1,65,0.0,37.0,37.0,1,117,0.0,89.0,89.0
0.009,6,10,1989,5,910,2.0,642.0,642.0,5,1079,2.0,811.0,811.0
0.111,6,10,1506,5,395,21.0,127.0,127.0,5,1111,24.0,843.0,843.0
0.004,6,10,2006,5,927,1.0,659.0,659.0,5,1079,1.0,811.0,811.0
177.214,17,90,12905,45,3024,4027.0,44.0,39.0,45,9881,4027.0,239.0,191.0
0.005,6,10,1689,5,839,1.0,571.0,571.0,5,850,1.0,582.0,582.0
0.005,6,10,1643,5,860,1.0,592.0,592.0,5,783,1.0,515.0,515.0
0.005,6,10,2000,5,927,1.0,659.0,659.0,5,1073,1.0,805.0,805.0
0.006,17,2,214,1,75,0.0,47.0,47.0,1,139,0.0,111.0,111.0
0.003,17,2,185,1,73,0.0,45.0,45.0,1,112,0.0,84.0,84.0
0.005,6,10,2006,5,927,1.0,659.0,659.0,5,1079,1.0,811.0,811.0
0.006,17,2,213,1,69,0.0,41.0,41.0,1,144,0.0,116.0,116.0
0.008,6,10,1983,5,910,2.0,642.0,642.0,5,1073,1.0,805.0,805.0
40.068,17,10,676,5,460,10016.0,104.0,64.0,5,216,10016.0,20.0,15.0
10.877,17,28,4420,14,1993,828.0,268.0,114.0,14,2427,828.0,586.0,145.0
0.005,6,10,2000,5,927,1.0,659.0,659.0,5,1073,1.0,805.0,805.0
0.005,6,10,1689,5,839,1.0,571.0,571.0,5,850,1.0,582.0,582.0
240.012,6,9,787,5,488,60003.0,232.0,232.0,4,299,80002.0,83.0,83.0
0.014,6,10,1972,5,910,3.0,642.0,642.0,5,1062,3.0,794.0,794.0
0.107,6,10,1506,5,395,23.0,127.0,127.0,5,1111,25.0,843.0,843.0
308.461,17,20,1124,10,716,34259.0,48.0,43.0,10,408,34259.0,20.0,12.0
0.005,6,10,2006,5,927,1.0,659.0,659.0,5,1079,1.0,811.0,811.0
0.004,6,10,1774,5,923,1.0,655.0,655.0,5,851,1.0,583.0,583.0
0.039,17,2,184,1,61,0.0,33.0,33.0,1,123,0.0,95.0,95.0
0.005,6,10,1643,5,860,1.0,592.0,592.0,5,783,1.0,515.0,515.0
0.229,6,16,2777,8,1395,32.0,533.0,323.0,8,1382,22.0,529.0,239.0
0.129,6,10,1506,5,395,28.0,127.0,127.0,5,1111,29.0,843.0,843.0
0.005,6,10,1643,5,860,1.0,592.0,592.0,5,783,1.0,515.0,515.0
0.009,6,13,3735,7,497,1.0,125.0,125.0,6,3238,1.0,1470.0,1459.0
0.005,6,10,2006,5,927,1.0,659.0,659.0,5,1079,1.0,811.0,811.0
0.009,6,10,1989,5,910,2.0,642.0,642.0,5,1079,2.0,811.0,811.0
0.005,6,10,2006,5,927,1.0,659.0,659.0,5,1079,1.0,811.0,811.0
0.005,6,10,1689,5,839,1.0,571.0,571.0,5,850,1.0,582.0,582.0
0.006,17,2,170,1,65,0.0,37.0,37.0,1,105,0.0,77.0,77.0
0.004,6,10,1774,5,923,1.0,655.0,655.0,5,851,1.0,583.0,583.0
0.093,6,10,1506,5,395,19.0,127.0,127.0,5,1111,16.0,843.0,843.0
0.016,6,10,1989,5,910,4.0,642.0,642.0,5,1079,3.0,811.0,811.0
0.006,6,10,2006,5,927,1.0,659.0,659.0,5,1079,1.0,811.0,811.0
10.984,17,28,4397,14,2311,836.0,586.0,137.0,14,2086,836.0,269.0,121.0
0.004,17,2,136,1,60,0.0,32.0,32.0,1,76,0.0,48.0,48.0
15.073,17,15,9238,8,6902,2149.0,1350.0,834.0,7,2336,2507.0,1350.0,305.0
40.073,17,10,676,5,460,10017.0,104.0,64.0,5,216,10017.0,20.0,15.0
0.006,17,2,140,1,62,0.0,34.0,34.0,1,78,0.0,50.0,50.0
0.011,6,10,1983,5,910,2.0,642.0,642.0,5,1073,2.0,805.0,805.0
0.001,17,2,146,1,65,0.0,37.0,37.0,1,81,0.0,53.0,53.0
0.03,6,10,1677,5,827,7.0,559.0,559.0,5,850,7.0,582.0,582.0
0.006,6,10,1689,5,839,1.0,571.0,571.0,5,850,1.0,582.0,582.0
15.073,17,15,9238,8,6902,2149.0,1350.0,834.0,7,2336,2507.0,1350.0,305.0
0.007,6,10,1854,5,889,1.0,621.0,621.0,5,965,1.0,697.0,697.0
0.004,17,2,148,1,60,0.0,32.0,32.0,1,88,0.0,60.0,60.0
0.004,17,4,284,2,120,0.0,32.0,32.0,2,164,1.0,60.0,54.0
0.004,17,2,142,1,63,0.0,35.0,35.0,1,79,0.0,51.0,51.0
0.005,6,10,1989,5,927,1.0,659.0,659.0,5,1062,1.0,794.0,794.0
0.001,17,2,166,1,75,0.0,47.0,47.0,1,91,0.0,63.0,63.0
0.008,6,10,1990,5,911,2.0,643.0,643.0,5,1079,1.0,811.0,811.0
0.014,6,14,3787,7,497,2.0,125.0,125.0,7,3290,2.0,1448.0,972.0
0.04,17,4,284,2,120,0.0,32.0,32.0,2,164,36.0,60.0,54.0
40.066,17,10,676,5,460,10013.0,104.0,64.0,5,216,10015.0,20.0,15.0
0.006,6,10,1547,5,764,1.0,496.0,496.0,5,783,1.0,515.0,515.0
0.005,6,10,1854,5,889,1.0,621.0,621.0,5,965,1.0,697.0,697.0
40.076,17,10,676,5,460,10018.0,104.0,64.0,5,216,10018.0,20.0,15.0
0.086,6,10,1506,5,395,17.0,127.0,127.0,5,1111,18.0,843.0,843.0
0.004,6,10,1989,5,927,1.0,659.0,659.0,5,1062,1.0,794.0,794.0
0.011,6,10,1631,5,848,2.0,580.0,580.0,5,783,2.0,515.0,515.0
0.006,6,13,3747,7,509,1.0,137.0,137.0,6,3238,1.0,1470.0,1459.0
0.005,6,10,2000,5,927,1.0,659.0,659.0,5,1073,1.0,805.0,805.0
0.015,6,10,1972,5,910,3.0,642.0,642.0,5,1062,3.0,794.0,794.0
0.013,6,10,1989,5,910,3.0,642.0,642.0,5,1079,3.0,811.0,811.0
0.083,6,10,1506,5,395,18.0,127.0,127.0,5,1111,19.0,843.0,843.0
0.107,6,10,1506,5,395,22.0,127.0,127.0,5,1111,23.0,843.0,843.0
0.012,6,10,1989,5,910,3.0,642.0,642.0,5,1079,2.0,811.0,811.0
0.01,17,2,136,1,60,0.0,32.0,32.0,1,76,0.0,48.0,48.0
0.09,6,10,1506,5,395,22.0,127.0,127.0,5,1111,19.0,843.0,843.0
0.012,6,10,1989,5,910,2.0,642.0,642.0,5,1079,3.0,811.0,811.0
0.088,6,10,1506,5,395,20.0,127.0,127.0,5,1111,19.0,843.0,843.0
0.008,17,2,194,1,59,0.0,31.0,31.0,1,135,0.0,107.0,107.0
0.112,6,10,1506,5,395,24.0,127.0,127.0,5,1111,23.0,843.0,843.0
0.005,6,10,1547,5,764,1.0,496.0,496.0,5,783,1.0,515.0,515.0
0.006,6,10,2006,5,927,1.0,659.0,659.0,5,1079,1.0,811.0,811.0
0.037,17,2,136,1,60,0.0,32.0,32.0,1,76,0.0,48.0,48.0
0.011,6,10,1972,5,910,2.0,642.0,642.0,5,1062,2.0,794.0,794.0
40.062,17,10,676,5,460,10014.0,104.0,64.0,5,216,10014.0,20.0,15.0
0.005,6,10,2007,5,928,1.0,660.0,660.0,5,1079,1.0,811.0,811.0
0.016,6,10,1989,5,910,4.0,642.0,642.0,5,1079,3.0,811.0,811.0
0.017,6,10,1989,5,910,4.0,642.0,642.0,5,1079,4.0,811.0,811.0
0.003,17,2,148,1,60,0.0,32.0,32.0,1,88,0.0,60.0,60.0
0.126,6,10,1506,5,395,27.0,127.0,127.0,5,1111,21.0,843.0,843.0
0.039,17,2,148,1,60,0.0,32.0,32.0,1,88,0.0,60.0,60.0
0.006,17,2,140,1,62,0.0,34.0,34.0,1,78,0.0,50.0,50.0
8.805,6,35,9731,18,4253,517.0,1498.0,875.0,17,5478,537.0,2667.0,435.0
0.102,6,10,1506,5,395,23.0,127.0,127.0,5,1111,24.0,843.0,843.0
0.006,6,12,1698,6,863,1.0,327.0,271.0,6,835,1.0,515.0,515.0
0.017,6,10,1989,5,910,4.0,642.0,642.0,5,1079,4.0,811.0,811.0
0.006,6,10,1547,5,764,1.0,496.0,496.0,5,783,1.0,515.0,515.0
0.016,6,10,1631,5,848,3.0,580.0,580.0,5,783,4.0,515.0,515.0
0.004,6,10,1989,5,927,1.0,659.0,659.0,5,1062,1.0,794.0,794.0
0.006,17,2,230,1,68,0.0,40.0,40.0,1,162,0.0,134.0,134.0
0.08,6,10,1506,5,395,16.0,127.0,127.0,5,1111,19.0,843.0,843.0
240.104,6,16,4480,9,963,30013.0,238.0,166.0,7,3517,40016.0,1402.0,786.0
0.01,6,10,1990,5,911,2.0,643.0,643.0,5,1079,2.0,811.0,811.0
0.008,6,10,1972,5,910,2.0,642.0,642.0,5,1062,1.0,794.0,794.0
0.01,6,10,1990,5,911,2.0,643.0,643.0,5,1079,2.0,811.0,811.0
10.702,17,28,4417,14,1993,815.0,268.0,114.0,14,2424,815.0,587.0,145.0
0.005,6,10,2006,5,927,1.0,659.0,659.0,5,1079,1.0,811.0,811.0
168.31,17,74,10515,37,2466,4675.0,44.0,38.0,37,8049,4675.0,239.0,189.0
0.005,6,10,2006,5,927,1.0,659.0,659.0,5,1079,1.0,811.0,811.0
0.077,6,10,1506,5,395,17.0,127.0,127.0,5,1111,18.0,843.0,843.0
0.125,6,10,1506,5,395,29.0,127.0,127.0,5,1111,29.0,843.0,843.0
0.112,6,10,1506,5,395,25.0,127.0,127.0,5,1111,24.0,843.0,843.0
1770.646,6,135,6510,75,3585,23924.0,39.0,39.0,60,2925,30006.0,35.0,35.0
0.005,6,10,1779,5,928,1.0,660.0,660.0,5,851,1.0,583.0,583.0
0.004,17,2,136,1,60,0.0,32.0,32.0,1,76,0.0,48.0,48.0
0.006,6,12,1698,6,863,1.0,327.0,271.0,6,835,1.0,515.0,515.0
0.005,6,10,2006,5,927,1.0,659.0,659.0,5,1079,1.0,811.0,811.0
0.006,6,10,1689,5,839,1.0,571.0,571.0,5,850,1.0,582.0,582.0
0.006,6,10,1689,5,839,1.0,571.0,571.0,5,850,1.0,582.0,582.0
0.004,6,10,2007,5,928,1.0,660.0,660.0,5,1079,1.0,811.0,811.0
0.098,6,10,1506,5,395,21.0,127.0,127.0,5,1111,21.0,843.0,843.0
0.009,17,2,194,1,59,0.0,31.0,31.0,1,135,0.0,107.0,107.0
0.004,17,2,136,1,60,0.0,32.0,32.0,1,76,0.0,48.0,48.0
1799.91,17,2778,213285,1383,112098,1302.0,84.0,53.0,1395,101187,1291.0,225.0,44.0
0.007,6,10,1990,5,911,1.0,643.0,643.0,5,1079,1.0,811.0,811.0
51.483,6,40,10527,20,4929,473.0,1360.0,682.0,20,5598,2700.0,2667.0,435.0
174.474,17,84,11492,42,2799,4255.0,44.0,38.0,42,8693,4255.0,252.0,178.0
0.025,6,10,1631,5,848,6.0,580.0,580.0,5,783,6.0,515.0,515.0
0.012,6,14,3787,7,497,1.0,125.0,125.0,7,3290,1.0,1448.0,972.0
0.006,17,2,140,1,62,0.0,34.0,34.0,1,78,0.0,50.0,50.0
0.037,6,13,3913,7,495,6.0,123.0,123.0,6,3418,7.0,1650.0,1549.0
0.091,6,10,1506,5,395,22.0,127.0,127.0,5,1111,20.0,843.0,843.0
0.005,6,10,1989,5,927,1.0,659.0,659.0,5,1062,1.0,794.0,794.0
0.21,17,15,8564,8,6103,30.0,1350.0,734.0,7,2461,25.0,1350.0,323.0
0.038,17,2,170,1,65,0.0,37.0,37.0,1,105,0.0,77.0,77.0
0.006,17,2,212,1,74,0.0,46.0,46.0,1,138,0.0,110.0,110.0
0.006,17,2,146,1,65,0.0,37.0,37.0,1,81,0.0,53.0,53.0
0.015,6,10,1677,5,827,3.0,559.0,559.0,5,850,3.0,582.0,582.0
0.005,6,10,2007,5,928,1.0,660.0,660.0,5,1079,1.0,811.0,811.0
0.081,6,10,1506,5,395,19.0,127.0,127.0,5,1111,17.0,843.0,843.0
0.005,6,10,2006,5,927,1.0,659.0,659.0,5,1079,1.0,811.0,811.0
0.017,6,10,1989,5,910,4.0,642.0,642.0,5,1079,4.0,811.0,811.0
0.171,6,3,453,2,321,171.0,241.0,241.0,1,132,0.0,92.0,92.0
172.11,17,78,11166,39,2600,4529.0,44.0,38.0,39,8566,4529.0,261.0,191.0
0.005,6,10,2006,5,927,1.0,659.0,659.0,5,1079,1.0,811.0,811.0
0.004,17,2,136,1,60,0.0,32.0,32.0,1,76,0.0,48.0,48.0
0.014,6,10,1983,5,910,3.0,642.0,642.0,5,1073,3.0,805.0,805.0
0.001,17,2,180,1,66,0.0,38.0,38.0,1,114,0.0,86.0,86.0
0.009,6,10,1989,5,910,2.0,642.0,642.0,5,1079,2.0,811.0,811.0
0.009,6,12,1926,6,1189,1.0,659.0,434.0,6,737,1.0,417.0,417.0
0.016,6,10,1677,5,827,3.0,559.0,559.0,5,850,4.0,582.0,582.0
0.005,6,10,1989,5,927,1.0,659.0,659.0,5,1062,1.0,794.0,794.0
0.005,6,14,3742,8,504,0.0,80.0,80.0,6,3238,1.0,1470.0,1459.0
0.003,17,2,148,1,60,0.0,32.0,32.0,1,88,0.0,60.0,60.0
0.007,6,10,1547,5,764,1.0,496.0,496.0,5,783,1.0,515.0,515.0
0.004,6,10,2006,5,927,1.0,659.0,659.0,5,1079,1.0,811.0,811.0
0.009,6,10,1972,5,910,2.0,642.0,642.0,5,1062,2.0,794.0,794.0
0.008,17,2,148,1,60,0.0,32.0,32.0,1,88,0.0,60.0,60.0
0.01,6,10,1983,5,910,2.0,642.0,642.0,5,1073,2.0,805.0,805.0
0.011,6,13,3735,7,497,1.0,125.0,125.0,6,3238,2.0,1470.0,1459.0
0.213,6,16,2670,8,1396,30.0,533.0,324.0,8,1274,19.0,529.0,212.0
1741.896,6,305,97785,188,86453,9314.0,2001.0,684.0,117,11332,15016.0,452.0,70.0
0.006,6,10,1689,5,839,1.0,571.0,571.0,5,850,1.0,582.0,582.0
0.017,6,14,3787,7,497,2.0,125.0,125.0,7,3290,2.0,1448.0,972.0
0.069,6,10,1506,5,395,15.0,127.0,127.0,5,1111,13.0,843.0,843.0
0.013,6,10,1989,5,910,3.0,642.0,642.0,5,1079,3.0,811.0,811.0
0.104,6,10,1506,5,395,21.0,127.0,127.0,5,1111,23.0,843.0,843.0
0.012,6,10,1762,5,911,2.0,643.0,643.0,5,851,2.0,583.0,583.0
0.015,6,10,1983,5,910,3.0,642.0,642.0,5,1073,3.0,805.0,805.0
0.006,17,2,179,1,71,0.0,43.0,43.0,1,108,0.0,80.0,80.0
40.06,17,10,676,5,460,10013.0,104.0,64.0,5,216,10014.0,20.0,15.0
0.008,6,12,1926,6,1189,1.0,659.0,434.0,6,737,1.0,417.0,417.0
1777.567,17,144,41760,72,22752,25036.0,288.0,288.0,72,19008,25035.0,236.0,236.0
0.005,6,10,1989,5,927,1.0,659.0,659.0,5,1062,1.0,794.0,794.0
0.007,17,2,194,1,59,0.0,31.0,31.0,1,135,0.0,107.0,107.0
0.092,6,10,1506,5,395,19.0,127.0,127.0,5,1111,17.0,843.0,843.0
0.023,6,10,1972,5,910,5.0,642.0,642.0,5,1062,5.0,794.0,794.0
0.003,17,2,136,1,60,0.0,32.0,32.0,1,76,0.0,48.0,48.0
0.008,6,10,1990,5,911,2.0,643.0,643.0,5,1079,1.0,811.0,811.0
0.01,6,13,3735,7,497,1.0,125.0,125.0,6,3238,1.0,1470.0,1459.0
0.011,6,10,1972,5,910,2.0,642.0,642.0,5,1062,2.0,794.0,794.0
0.004,6,10,1779,5,928,1.0,660.0,660.0,5,851,1.0,583.0,583.0
0.086,6,10,1506,5,395,18.0,127.0,127.0,5,1111,20.0,843.0,843.0
0.208,6,16,2777,8,1395,29.0,533.0,323.0,8,1382,19.0,529.0,239.0
164.344,17,88,12694,44,2960,3821.0,44.0,39.0,44,9734,3821.0,239.0,193.0
0.008,6,14,3787,7,497,1.0,125.0,125.0,7,3290,1.0,1448.0,972.0
0.053,17,2,152,1,76,0.0,48.0,48.0,1,76,0.0,48.0,48.0
0.009,6,10,1989,5,910,2.0,642.0,642.0,5,1079,2.0,811.0,811.0
0.005,6,10,2000,5,927,1.0,659.0,659.0,5,1073,1.0,805.0,805.0
0.083,6,10,1506,5,395,20.0,127.0,127.0,5,1111,16.0,843.0,843.0
15.073,17,14,9190,8,6902,2149.0,1350.0,834.0,6,2288,3008.0,1350.0,353.0
0.014,6,10,1631,5,848,3.0,580.0,580.0,5,783,3.0,515.0,515.0
1771.629,17,120,11460,60,5460,30027.0,63.0,63.0,60,6000,30027.0,72.0,72.0
40.069,17,10,676,5,460,10015.0,104.0,64.0,5,216,10016.0,20.0,15.0
0.072,6,10,1506,5,395,17.0,127.0,127.0,5,1111,16.0,843.0,843.0
0.093,6,10,1506,5,395,21.0,127.0,127.0,5,1111,19.0,843.0,843.0
0.008,6,10,1989,5,910,1.0,642.0,642.0,5,1079,1.0,811.0,811.0
15.072,17,15,9238,8,6902,2149.0,1350.0,834.0,7,2336,2507.0,1350.0,305.0
0.016,17,2,180,1,66,0.0,38.0,38.0,1,114,0.0,86.0,86.0
0.005,17,2,169,1,62,0.0,34.0,34.0,1,107,0.0,79.0,79.0
0.012,6,10,1990,5,911,2.0,643.0,643.0,5,1079,2.0,811.0,811.0
0.1,6,10,1506,5,395,23.0,127.0,127.0,5,1111,23.0,843.0,843.0
0.085,6,10,1506,5,395,19.0,127.0,127.0,5,1111,16.0,843.0,843.0
0.007,17,2,179,1,71,0.0,43.0,43.0,1,108,0.0,80.0,80.0
240.021,6,9,787,5,488,60005.0,232.0,232.0,4,299,80005.0,83.0,83.0
0.005,6,13,3690,7,452,0.0,80.0,80.0,6,3238,1.0,1470.0,1459.0
0.013,6,10,1990,5,911,3.0,643.0,643.0,5,1079,3.0,811.0,811.0
0.012,6,10,1983,5,910,3.0,642.0,642.0,5,1073,2.0,805.0,805.0
0.041,17,2,136,1,60,0.0,32.0,32.0,1,76,0.0,48.0,48.0
162.375,17,78,11037,39,2601,4272.0,44.0,38.0,39,8436,4272.0,239.0,188.0
0.112,6,10,1506,5,395,26.0,127.0,127.0,5,1111,25.0,843.0,843.0
15.081,17,15,9239,8,6902,2149.0,1350.0,834.0,7,2337,2508.0,1350.0,305.0
0.083,6,10,1506,5,395,19.0,127.0,127.0,5,1111,15.0,843.0,843.0
308.423,17,20,1124,10,716,34262.0,48.0,43.0,10,408,34262.0,20.0,12.0
0.099,6,10,1506,5,395,22.0,127.0,127.0,5,1111,21.0,843.0,843.0
0.006,6,10,1854,5,889,1.0,621.0,621.0,5,965,1.0,697.0,697.0
0.104,6,10,1506,5,395,22.0,127.0,127.0,5,1111,23.0,843.0,843.0
0.009,6,10,1990,5,911,2.0,643.0,643.0,5,1079,2.0,811.0,811.0
0.065,6,10,1506,5,395,13.0,127.0,127.0,5,1111,15.0,843.0,843.0
0.014,6,10,1990,5,911,3.0,643.0,643.0,5,1079,3.0,811.0,811.0
240.035,6,9,787,5,488,60008.0,232.0,232.0,4,299,80010.0,83.0,83.0
0.011,6,10,1990,5,911,2.0,643.0,643.0,5,1079,2.0,811.0,811.0
0.102,6,10,1506,5,395,24.0,127.0,127.0,5,1111,24.0,843.0,843.0
0.005,6,10,2007,5,928,1.0,660.0,660.0,5,1079,1.0,811.0,811.0
0.012,6,10,1983,5,910,3.0,642.0,642.0,5,1073,2.0,805.0,805.0
0.008,17,2,180,1,66,0.0,38.0,38.0,1,114,0.0,86.0,86.0
0.084,6,10,1506,5,395,19.0,127.0,127.0,5,1111,17.0,843.0,843.0
0.021,17,2,198,1,91,0.0,63.0,63.0,1,107,0.0,79.0,79.0
0.114,6,10,1506,5,395,27.0,127.0,127.0,5,1111,22.0,843.0,843.0
0.174,17,2,152,1,76,0.0,48.0,48.0,1,76,0.0,48.0,48.0
0.069,6,10,1506,5,395,16.0,127.0,127.0,5,1111,16.0,843.0,843.0
0.004,6,10,1989,5,927,1.0,659.0,659.0,5,1062,1.0,794.0,794.0
0.014,6,13,3690,7,452,2.0,80.0,80.0,6,3238,2.0,1470.0,1459.0
300.328,6,16,2170,9,684,37520.0,146.0,146.0,7,1486,50026.0,419.0,398.0
0.04,17,2,148,1,60,0.0,32.0,32.0,1,88,0.0,60.0,60.0
1755.985,6,105,6270,60,3525,29761.0,27.0,27.0,45,2745,39907.0,27.0,27.0
0.004,17,2,148,1,60,0.0,32.0,32.0,1,88,0.0,60.0,60.0
0.142,6,10,1506,5,395,31.0,127.0,127.0,5,1111,34.0,843.0,843.0
0.006,17,2,179,1,71,0.0,43.0,43.0,1,108,0.0,80.0,80.0
0.076,6,10,1506,5,395,16.0,127.0,127.0,5,1111,18.0,843.0,843.0
0.006,6,10,1547,5,764,1.0,496.0,496.0,5,783,1.0,515.0,515.0
40.087,17,10,676,5,460,10018.0,104.0,64.0,5,216,10021.0,20.0,15.0
0.012,6,13,3735,7,497,2.0,125.0,125.0,6,3238,2.0,1470.0,1459.0
0.005,6,10,2006,5,927,1.0,659.0,659.0,5,1079,1.0,811.0,811.0
0.015,6,13,3735,7,497,2.0,125.0,125.0,6,3238,3.0,1470.0,1459.0
0.078,6,10,1506,5,395,14.0,127.0,127.0,5,1111,17.0,843.0,843.0
240.01,6,9,787,5,488,60002.0,232.0,232.0,4,299,80002.0,83.0,83.0
0.006,17,2,230,1,68,0.0,40.0,40.0,1,162,0.0,134.0,134.0
0.019,6,10,1989,5,910,4.0,642.0,642.0,5,1079,4.0,811.0,811.0
0.006,6,10,1689,5,839,1.0,571.0,571.0,5,850,1.0,582.0,582.0
0.005,6,13,3690,7,452,0.0,80.0,80.0,6,3238,0.0,1470.0,1459.0
0.005,6,10,2006,5,927,1.0,659.0,659.0,5,1079,1.0,811.0,811.0
0.004,17,2,148,1,60,0.0,32.0,32.0,1,88,0.0,60.0,60.0
0.005,17,2,136,1,60,0.0,32.0,32.0,1,76,0.0,48.0,48.0
11.14,17,28,4392,14,2313,848.0,588.0,137.0,14,2079,847.0,270.0,120.0
0.074,17,4,284,2,120,0.0,32.0,32.0,2,164,70.0,60.0,54.0
0.005,17,2,180,1,66,0.0,38.0,38.0,1,114,0.0,86.0,86.0
0.013,6,10,1990,5,911,3.0,643.0,643.0,5,1079,3.0,811.0,811.0
0.004,6,10,1774,5,923,1.0,655.0,655.0,5,851,1.0,583.0,583.0
0.086,6,10,1506,5,395,19.0,127.0,127.0,5,1111,17.0,843.0,843.0
0.088,6,10,1506,5,395,18.0,127.0,127.0,5,1111,18.0,843.0,843.0
0.009,6,10,1983,5,910,2.0,642.0,642.0,5,1073,2.0,805.0,805.0
0.01,6,13,3735,7,497,1.0,125.0,125.0,6,3238,1.0,1470.0,1459.0
0.004,6,10,2006,5,927,1.0,659.0,659.0,5,1079,1.0,811.0,811.0
0.012,6,10,1990,5,911,3.0,643.0,643.0,5,1079,2.0,811.0,811.0
0.005,6,10,2007,5,928,1.0,660.0,660.0,5,1079,1.0,811.0,811.0
0.016,6,10,1989,5,910,4.0,642.0,642.0,5,1079,4.0,811.0,811.0
0.005,17,2,225,1,65,0.0,37.0,37.0,1,160,0.0,132.0,132.0
240.095,6,16,4481,9,963,30011.0,238.0,166.0,7,3518,40015.0,1402.0,786.0
0.013,6,10,1989,5,910,3.0,642.0,642.0,5,1079,3.0,811.0,811.0
0.076,6,10,1506,5,395,17.0,127.0,127.0,5,1111,16.0,843.0,843.0
0.103,6,10,1506,5,395,23.0,127.0,127.0,5,1111,22.0,843.0,843.0
15.07,17,15,9238,8,6902,2148.0,1350.0,834.0,7,2336,2506.0,1350.0,305.0
0.035,17,2,152,1,76,0.0,48.0,48.0,1,76,0.0,48.0,48.0
0.082,6,10,1506,5,395,17.0,127.0,127.0,5,1111,19.0,843.0,843.0
0.101,6,10,1506,5,395,23.0,127.0,127.0,5,1111,21.0,843.0,843.0
0.009,6,10,1983,5,910,2.0,642.0,642.0,5,1073,2.0,805.0,805.0
0.001,17,2,180,1,66,0.0,38.0,38.0,1,114,0.0,86.0,86.0
0.014,6,10,1631,5,848,3.0,580.0,580.0,5,783,3.0,515.0,515.0
0.084,6,10,1506,5,395,16.0,127.0,127.0,5,1111,20.0,843.0,843.0
15.123,17,15,7292,7,3797,2515.0,1350.0,514.0,8,3495,2156.0,1350.0,408.0
9.038,17,6,376,5,280,2259.0,28.0,28.0,1,96,0.0,68.0,68.0
0.096,6,10,1506,5,395,20.0,127.0,127.0,5,1111,21.0,843.0,843.0
0.105,6,10,1506,5,395,21.0,127.0,127.0,5,1111,25.0,843.0,843.0
0.005,6,13,3690,7,452,0.0,80.0,80.0,6,3238,1.0,1470.0,1459.0
0.004,6,10,1779,5,928,1.0,660.0,660.0,5,851,1.0,583.0,583.0
0.004,6,10,1779,5,928,1.0,660.0,660.0,5,851,1.0,583.0,583.0
40.055,17,10,676,5,460,10011.0,104.0,64.0,5,216,10010.0,20.0,15.0
0.067,6,10,1506,5,395,14.0,127.0,127.0,5,1111,16.0,843.0,843.0
0.175,17,2,213,1,69,0.0,41.0,41.0,1,144,0.0,116.0,116.0
0.005,6,10,1779,5,928,1.0,660.0,660.0,5,851,1.0,583.0,583.0
240.098,6,16,4481,9,963,30012.0,238.0,166.0,7,3518,40015.0,1402.0,786.0
0.005,6,10,2000,5,927,1.0,659.0,659.0,5,1073,1.0,805.0,805.0
0.005,6,10,2007,5,928,1.0,660.0,660.0,5,1079,1.0,811.0,811.0
40.078,17,10,676,5,460,10018.0,104.0,64.0,5,216,10018.0,20.0,15.0
0.019,6,10,1983,5,910,4.0,642.0,642.0,5,1073,4.0,805.0,805.0
240.011,6,9,787,5,488,60002.0,232.0,232.0,4,299,80002.0,83.0,83.0
0.003,17,4,284,2,120,0.0,32.0,32.0,2,164,0.0,60.0,54.0
40.068,17,10,676,5,460,10013.0,104.0,64.0,5,216,10016.0,20.0,15.0
0.004,6,10,2006,5,927,1.0,659.0,659.0,5,1079,1.0,811.0,811.0
0.067,6,10,1506,5,395,14.0,127.0,127.0,5,1111,15.0,843.0,843.0
178.443,17,108,14823,59,3983,3076.0,44.0,39.0,49,10840,3696.0,239.0,193.0
0.009,6,10,1983,5,910,2.0,642.0,642.0,5,1073,2.0,805.0,805.0
0.113,6,10,1506,5,395,27.0,127.0,127.0,5,1111,24.0,843.0,843.0
0.009,6,10,1989,5,910,2.0,642.0,642.0,5,1079,2.0,811.0,811.0
0.005,6,10,2006,5,927,1.0,659.0,659.0,5,1079,1.0,811.0,811.0
240.089,6,16,4480,9,963,30011.0,238.0,166.0,7,3517,40014.0,1402.0,786.0
1777.687,17,144,41760,72,22752,25037.0,288.0,288.0,72,19008,25037.0,236.0,236.0
0.01,6,10,1990,5,911,2.0,643.0,643.0,5,1079,2.0,811.0,811.0
40.083,17,10,676,5,460,10016.0,104.0,64.0,5,216,10020.0,20.0,15.0
66.346,6,27,17551,15,9603,4739.0,2804.0,1469.0,12,7948,6016.0,2319.0,1219.0
0.114,6,10,1506,5,395,26.0,127.0,127.0,5,1111,25.0,843.0,843.0
0.09,6,10,1506,5,395,19.0,127.0,127.0,5,1111,19.0,843.0,843.0
0.025,6,10,1972,5,910,6.0,642.0,642.0,5,1062,6.0,794.0,794.0
0.181,6,3,453,2,321,181.0,241.0,241.0,1,132,0.0,92.0,92.0
0.138,6,10,1506,5,395,25.0,127.0,127.0,5,1111,31.0,843.0,843.0
0.003,17,2,148,1,60,0.0,32.0,32.0,1,88,0.0,60.0,60.0
0.169,17,2,152,1,76,0.0,48.0,48.0,1,76,0.0,48.0,48.0
0.005,6,10,1989,5,927,1.0,659.0,659.0,5,1062,1.0,794.0,794.0
0.005,6,10,2000,5,927,1.0,659.0,659.0,5,1073,1.0,805.0,805.0
0.122,6,10,1506,5,395,28.0,127.0,127.0,5,1111,23.0,843.0,843.0
0.006,17,2,170,1,65,0.0,37.0,37.0,1,105,0.0,77.0,77.0
0.004,17,2,170,1,65,0.0,37.0,37.0,1,105,0.0,77.0,77.0
0.1,6,10,1506,5,395,23.0,127.0,127.0,5,1111,22.0,843.0,843.0
0.004,17,2,146,1,65,0.0,37.0,37.0,1,81,0.0,53.0,53.0
0.016,6,10,1989,5,910,3.0,642.0,642.0,5,1079,4.0,811.0,811.0
0.125,6,10,1506,5,395,25.0,127.0,127.0,5,1111,26.0,843.0,843.0
0.008,17,2,148,1,60,0.0,32.0,32.0,1,88,0.0,60.0,60.0
0.006,6,10,1854,5,889,1.0,621.0,621.0,5,965,1.0,697.0,697.0
0.09,6,10,1506,5,395,21.0,127.0,127.0,5,1111,18.0,843.0,843.0
0.047,6,10,1983,5,910,11.0,642.0,642.0,5,1073,11.0,805.0,805.0
0.079,6,10,1506,5,395,17.0,127.0,127.0,5,1111,16.0,843.0,843.0
0.01,6,10,1983,5,910,2.0,642.0,642.0,5,1073,2.0,805.0,805.0
0.013,6,10,1762,5,911,3.0,643.0,643.0,5,851,3.0,583.0,583.0
0.067,17,8,3613,4,1874,22.0,1350.0,440.0,4,1739,10.0,1350.0,406.0
0.014,6,12,1698,6,863,2.0,327.0,271.0,6,835,2.0,515.0,515.0
0.006,6,10,1547,5,764,1.0,496.0,496.0,5,783,1.0,515.0,515.0
15.079,17,15,8763,8,6558,2150.0,1350.0,791.0,7,2205,2508.0,1350.0,287.0
0.0,17,2,142,1,63,0.0,35.0,35.0,1,79,0.0,51.0,51.0
1792.688,6,485,99154,243,87884,7407.0,421.0,368.0,242,11270,7438.0,53.0,53.0
0.01,6,10,1972,5,910,2.0,642.0,642.0,5,1062,2.0,794.0,794.0
40.059,17,10,676,5,460,10013.0,104.0,64.0,5,216,10013.0,20.0,15.0
0.006,6,10,1547,5,764,1.0,496.0,496.0,5,783,1.0,515.0,515.0
0.013,6,10,1631,5,848,3.0,580.0,580.0,5,783,3.0,515.0,515.0
0.18,6,10,1506,5,395,42.0,127.0,127.0,5,1111,34.0,843.0,843.0
61.524,6,26,17507,14,9567,4732.0,2804.0,1473.0,12,7940,5581.0,2111.0,1044.0
0.04,17,4,284,2,120,0.0,32.0,32.0,2,164,37.0,60.0,54.0
0.011,6,10,1689,5,839,2.0,571.0,571.0,5,850,2.0,582.0,582.0
0.129,6,10,1506,5,395,27.0,127.0,127.0,5,1111,30.0,843.0,843.0
0.011,6,10,1990,5,911,2.0,643.0,643.0,5,1079,2.0,811.0,811.0
0.005,6,10,1689,5,839,1.0,571.0,571.0,5,850,1.0,582.0,582.0
0.005,17,2,166,1,75,0.0,47.0,47.0,1,91,0.0,63.0,63.0
0.005,17,2,212,1,74,0.0,46.0,46.0,1,138,0.0,110.0,110.0
0.011,6,10,1990,5,911,2.0,643.0,643.0,5,1079,2.0,811.0,811.0
0.006,6,10,1547,5,764,1.0,496.0,496.0,5,783,1.0,515.0,515.0
0.009,6,10,1677,5,827,2.0,559.0,559.0,5,850,2.0,582.0,582.0
0.009,6,12,1926,6,1189,1.0,659.0,434.0,6,737,1.0,417.0,417.0
0.005,6,10,2006,5,927,1.0,659.0,659.0,5,1079,1.0,811.0,811.0
0.121,6,10,1506,5,395,28.0,127.0,127.0,5,1111,24.0,843.0,843.0
0.007,6,12,1698,6,863,1.0,327.0,271.0,6,835,1.0,515.0,515.0
10.755,17,28,4423,14,1994,818.0,269.0,114.0,14,2429,818.0,588.0,145.0
0.013,6,10,1989,5,910,3.0,642.0,642.0,5,1079,3.0,811.0,811.0
0.006,6,10,1547,5,764,1.0,496.0,496.0,5,783,1.0,515.0,515.0
0.021,6,10,1990,5,911,5.0,643.0,643.0,5,1079,5.0,811.0,811.0
0.009,6,10,1677,5,827,2.0,559.0,559.0,5,850,2.0,582.0,582.0
240.34,6,43,8771,21,5686,12016.0,1515.0,509.0,22,3085,11444.0,580.0,241.0
0.005,17,4,284,2,120,0.0,32.0,32.0,2,164,1.0,60.0,54.0
0.011,6,10,1677,5,827,2.0,559.0,559.0,5,850,2.0,582.0,582.0
0.004,17,2,148,1,60,0.0,32.0,32.0,1,88,0.0,60.0,60.0
0.073,6,10,1506,5,395,15.0,127.0,127.0,5,1111,16.0,843.0,843.0
0.006,6,10,2000,5,927,1.0,659.0,659.0,5,1073,1.0,805.0,805.0
0.001,17,2,180,1,66,0.0,38.0,38.0,1,114,0.0,86.0,86.0
0.003,17,2,136,1,60,0.0,32.0,32.0,1,76,0.0,48.0,48.0
0.001,17,2,166,1,75,0.0,47.0,47.0,1,91,0.0,63.0,63.0
0.005,6,10,1989,5,927,1.0,659.0,659.0,5,1062,1.0,794.0,794.0
1799.992,6,137,6590,76,3625,23996.0,39.0,39.0,61,2965,29995.0,35.0,35.0
40.086,17,10,676,5,460,10020.0,104.0,64.0,5,216,10020.0,20.0,15.0
0.004,6,10,2000,5,927,1.0,659.0,659.0,5,1073,1.0,805.0,805.0
0.004,6,10,1989,5,927,1.0,659.0,659.0,5,1062,1.0,794.0,794.0
0.057,6,10,1506,5,395,12.0,127.0,127.0,5,1111,13.0,843.0,843.0
0.0,17,2,192,1,65,0.0,37.0,37.0,1,127,0.0,99.0,99.0
0.004,17,4,420,2,122,0.0,33.0,33.0,2,298,0.0,145.0,121.0
0.085,6,10,1506,5,395,20.0,127.0,127.0,5,1111,17.0,843.0,843.0
0.048,6,10,1990,5,911,12.0,643.0,643.0,5,1079,11.0,811.0,811.0
0.005,6,14,3736,7,446,0.0,74.0,74.0,7,3290,0.0,1448.0,972.0
0.006,6,10,2006,5,927,1.0,659.0,659.0,5,1079,1.0,811.0,811.0
0.008,6,10,1972,5,910,2.0,642.0,642.0,5,1062,2.0,794.0,794.0
40.084,17,10,676,5,460,10018.0,104.0,64.0,5,216,10019.0,20.0,15.0
0.005,17,2,164,1,74,0.0,46.0,46.0,1,90,0.0,62.0,62.0
0.017,6,10,1631,5,848,4.0,580.0,580.0,5,783,4.0,515.0,515.0
0.001,17,2,180,1,66,0.0,38.0,38.0,1,114,0.0,86.0,86.0
0.013,6,10,1972,5,910,3.0,642.0,642.0,5,1062,3.0,794.0,794.0
0.065,6,10,1506,5,395,13.0,127.0,127.0,5,1111,15.0,843.0,843.0
0.004,17,2,136,1,60,0.0,32.0,32.0,1,76,0.0,48.0,48.0
0.014,6,10,1972,5,910,3.0,642.0,642.0,5,1062,3.0,794.0,794.0
0.006,6,10,1547,5,764,1.0,496.0,496.0,5,783,1.0,515.0,515.0
0.006,17,2,273,1,66,0.0,38.0,38.0,1,207,0.0,179.0,179.0
0.005,6,10,1779,5,928,1.0,660.0,660.0,5,851,1.0,583.0,583.0
0.02,6,10,1677,5,827,4.0,559.0,559.0,5,850,4.0,582.0,582.0
0.006,6,10,1989,5,927,1.0,659.0,659.0,5,1062,1.0,794.0,794.0
0.003,17,2,148,1,60,0.0,32.0,32.0,1,88,0.0,60.0,60.0
0.006,6,10,1689,5,839,1.0,571.0,571.0,5,850,1.0,582.0,582.0
0.004,17,2,132,1,58,0.0,30.0,30.0,1,74,0.0,46.0,46.0
300.99,6,44,13143,24,7316,13086.0,1360.0,790.0,20,5827,464.0,2667.0,385.0
0.11,6,10,1506,5,395,25.0,127.0,127.0,5,1111,27.0,843.0,843.0
0.006,6,10,1643,5,860,1.0,592.0,592.0,5,783,1.0,515.0,515.0
169.068,17,76,10710,38,2552,4569.0,44.0,39.0,38,8158,4569.0,239.0,186.0
0.006,6,10,2007,5,928,1.0,660.0,660.0,5,1079,1.0,811.0,811.0
0.014,6,10,1972,5,910,3.0,642.0,642.0,5,1062,3.0,794.0,794.0
1799.998,6,212,14610,80,6294,22784.0,46.0,46.0,132,8316,13739.0,46.0,46.0
0.001,17,2,180,1,66,0.0,38.0,38.0,1,114,0.0,86.0,86.0
0.005,6,15,3794,8,504,0.0,80.0,80.0,7,3290,0.0,1448.0,972.0
0.12,6,10,1506,5,395,24.0,127.0,127.0,5,1111,23.0,843.0,843.0
0.114,6,10,1506,5,395,27.0,127.0,127.0,5,1111,27.0,843.0,843.0
40.058,17,10,676,5,460,10013.0,104.0,64.0,5,216,10013.0,20.0,15.0
0.007,17,2,179,1,71,0.0,43.0,43.0,1,108,0.0,80.0,80.0
0.158,17,4,352,2,130,119.0,37.0,37.0,2,222,115.0,89.0,83.0
0.005,17,2,148,1,60,0.0,32.0,32.0,1,88,0.0,60.0,60.0
0.014,6,10,1989,5,910,3.0,642.0,642.0,5,1079,3.0,811.0,811.0
0.004,6,10,2006,5,927,1.0,659.0,659.0,5,1079,1.0,811.0,811.0
0.001,17,2,136,1,60,0.0,32.0,32.0,1,76,0.0,48.0,48.0
0.101,6,10,1506,5,395,21.0,127.0,127.0,5,1111,22.0,843.0,843.0
0.008,6,10,1689,5,839,2.0,571.0,571.0,5,850,1.0,582.0,582.0
0.007,6,10,2007,5,928,1.0,660.0,660.0,5,1079,1.0,811.0,811.0
0.002,17,2,136,1,60,0.0,32.0,32.0,1,76,0.0,48.0,48.0
0.01,6,10,1983,5,910,2.0,642.0,642.0,5,1073,2.0,805.0,805.0
0.088,6,10,1506,5,395,19.0,127.0,127.0,5,1111,20.0,843.0,843.0
300.376,6,16,2170,9,684,37526.0,146.0,146.0,7,1486,50034.0,419.0,398.0
0.068,6,10,1506,5,395,15.0,127.0,127.0,5,1111,13.0,843.0,843.0
0.005,6,10,1547,5,764,1.0,496.0,496.0,5,783,1.0,515.0,515.0
0.004,6,10,1989,5,927,1.0,659.0,659.0,5,1062,1.0,794.0,794.0
0.041,17,2,234,1,61,0.0,33.0,33.0,1,173,0.0,145.0,145.0
0.004,6,10,2000,5,927,1.0,659.0,659.0,5,1073,1.0,805.0,805.0
0.006,6,10,1547,5,764,1.0,496.0,496.0,5,783,1.0,515.0,515.0
0.013,6,10,1983,5,910,3.0,642.0,642.0,5,1073,3.0,805.0,805.0
0.004,6,10,1702,5,863,1.0,595.0,595.0,5,839,0.0,571.0,571.0
335.116,17,156,21428,78,5280,4352.0,44.0,39.0,78,16148,4352.0,239.0,179.0
0.008,17,2,194,1,59,0.0,31.0,31.0,1,135,0.0,107.0,107.0
177.031,17,72,10158,36,2402,5057.0,44.0,38.0,36,7756,5057.0,239.0,187.0
0.04,17,2,152,1,76,0.0,48.0,48.0,1,76,0.0,48.0,48.0
0.004,6,10,1702,5,863,1.0,595.0,595.0,5,839,0.0,571.0,571.0
0.005,17,2,140,1,62,0.0,34.0,34.0,1,78,0.0,50.0,50.0
0.021,6,10,1983,5,910,5.0,642.0,642.0,5,1073,5.0,805.0,805.0
308.462,17,20,1124,10,716,34258.0,48.0,43.0,10,408,34259.0,20.0,12.0
0.005,17,2,213,1,69,0.0,41.0,41.0,1,144,0.0,116.0,116.0
0.009,6,10,1989,5,927,2.0,659.0,659.0,5,1062,2.0,794.0,794.0
0.009,6,10,1774,5,923,2.0,655.0,655.0,5,851,2.0,583.0,583.0
0.004,6,10,2006,5,927,1.0,659.0,659.0,5,1079,1.0,811.0,811.0
1.017,6,13,3922,7,2139,127.0,1328.0,923.0,6,1783,152.0,1539.0,1539.0
0.011,6,10,1990,5,911,2.0,643.0,643.0,5,1079,2.0,811.0,811.0
0.001,17,2,180,1,66,0.0,38.0,38.0,1,114,0.0,86.0,86.0
0.004,17,2,136,1,60,0.0,32.0,32.0,1,76,0.0,48.0,48.0
0.013,6,10,1990,5,911,3.0,643.0,643.0,5,1079,3.0,811.0,811.0
0.014,6,10,1990,5,911,3.0,643.0,643.0,5,1079,3.0,811.0,811.0
0.041,17,4,420,2,122,0.0,33.0,33.0,2,298,37.0,145.0,121.0
0.059,17,2,307,1,61,0.0,33.0,33.0,1,246,0.0,218.0,218.0
0.004,6,10,2007,5,928,1.0,660.0,660.0,5,1079,1.0,811.0,811.0
0.002,17,2,180,1,66,0.0,38.0,38.0,1,114,0.0,86.0,86.0
0.012,6,10,1983,5,910,2.0,642.0,642.0,5,1073,2.0,805.0,805.0
0.005,6,10,2000,5,927,1.0,659.0,659.0,5,1073,1.0,805.0,805.0
0.005,6,10,1989,5,927,1.0,659.0,659.0,5,1062,1.0,794.0,794.0
0.129,6,10,1506,5,395,30.0,127.0,127.0,5,1111,29.0,843.0,843.0
0.02,6,10,1989,5,910,5.0,642.0,642.0,5,1079,4.0,811.0,811.0
0.009,6,10,1989,5,910,2.0,642.0,642.0,5,1079,2.0,811.0,811.0
240.039,6,9,787,5,488,60009.0,232.0,232.0,4,299,80012.0,83.0,83.0
0.059,6,10,1506,5,395,13.0,127.0,127.0,5,1111,14.0,843.0,843.0
40.084,17,10,676,5,460,10017.0,104.0,64.0,5,216,10020.0,20.0,15.0
0.013,6,10,1972,5,910,3.0,642.0,642.0,5,1062,3.0,794.0,794.0
0.114,6,10,1506,5,395,16.0,127.0,127.0,5,1111,26.0,843.0,843.0
0.073,6,10,1506,5,395,16.0,127.0,127.0,5,1111,17.0,843.0,843.0
0.093,6,10,1506,5,395,19.0,127.0,127.0,5,1111,18.0,843.0,843.0
0.001,17,2,180,1,58,0.0,30.0,30.0,1,122,0.0,94.0,94.0
0.01,6,10,1983,5,910,2.0,642.0,642.0,5,1073,2.0,805.0,805.0
0.005,6,10,1779,5,928,1.0,660.0,660.0,5,851,1.0,583.0,583.0
240.309,6,26,11287,13,5061,20025.0,1368.0,877.0,13,6226,20025.0,1713.0,923.0
0.003,17,4,284,2,120,0.0,32.0,32.0,2,164,0.0,60.0,54.0
0.005,6,10,2007,5,928,1.0,660.0,660.0,5,1079,1.0,811.0,811.0
0.015,6,10,1989,5,910,3.0,642.0,642.0,5,1079,3.0,811.0,811.0
0.061,6,10,1506,5,395,12.0,127.0,127.0,5,1111,13.0,843.0,843.0
0.005,6,10,2007,5,928,1.0,660.0,660.0,5,1079,1.0,811.0,811.0
1.102,6,37,20642,20,14018,58.0,2720.0,1318.0,17,6624,56.0,2749.0,988.0
0.005,6,10,2006,5,927,1.0,659.0,659.0,5,1079,1.0,811.0,811.0
0.005,17,2,144,1,64,0.0,36.0,36.0,1,80,0.0,52.0,52.0
0.005,6,10,2006,5,927,1.0,659.0,659.0,5,1079,1.0,811.0,811.0
40.071,17,10,676,5,460,10017.0,104.0,64.0,5,216,10016.0,20.0,15.0
0.005,6,10,1547,5,764,1.0,496.0,496.0,5,783,1.0,515.0,515.0
0.077,6,10,1506,5,395,16.0,127.0,127.0,5,1111,18.0,843.0,843.0
0.007,6,10,1854,5,889,1.0,621.0,621.0,5,965,1.0,697.0,697.0
0.117,6,10,1506,5,395,24.0,127.0,127.0,5,1111,26.0,843.0,843.0
11.155,17,28,4422,14,1994,845.0,269.0,114.0,14,2428,845.0,587.0,145.0
0.01,6,10,1989,5,910,2.0,642.0,642.0,5,1079,2.0,811.0,811.0
0.01,6,10,1983,5,910,2.0,642.0,642.0,5,1073,2.0,805.0,805.0
0.005,6,10,2006,5,927,1.0,659.0,659.0,5,1079,1.0,811.0,811.0
0.005,6,10,1779,5,928,1.0,660.0,660.0,5,851,1.0,583.0,583.0
240.094,6,31,9426,15,6968,17149.0,2092.0,688.0,16,2458,16006.0,580.0,202.0
240.328,6,32,10825,15,4365,17166.0,1720.0,715.0,17,6460,15020.0,1433.0,556.0
40.067,17,10,676,5,460,10015.0,104.0,64.0,5,216,10016.0,20.0,15.0
0.01,6,10,2007,5,928,2.0,660.0,660.0,5,1079,2.0,811.0,811.0
0.01,6,10,1989,5,910,2.0,642.0,642.0,5,1079,2.0,811.0,811.0
40.071,17,10,676,5,460,10015.0,104.0,64.0,5,216,10016.0,20.0,15.0
0.015,6,10,1989,5,910,3.0,642.0,642.0,5,1079,3.0,811.0,811.0
0.103,6,10,1506,5,395,25.0,127.0,127.0,5,1111,24.0,843.0,843.0
0.098,6,10,1506,5,395,22.0,127.0,127.0,5,1111,19.0,843.0,843.0
0.133,6,10,1506,5,395,29.0,127.0,127.0,5,1111,32.0,843.0,843.0
0.063,6,10,1506,5,395,13.0,127.0,127.0,5,1111,15.0,843.0,843.0
0.004,17,4,284,2,120,0.0,32.0,32.0,2,164,0.0,60.0,54.0
0.004,17,2,148,1,60,0.0,32.0,32.0,1,88,0.0,60.0,60.0
0.011,6,10,1547,5,764,2.0,496.0,496.0,5,783,2.0,515.0,515.0
0.014,6,13,3735,7,497,2.0,125.0,125.0,6,3238,2.0,1470.0,1459.0
0.099,6,10,1506,5,395,19.0,127.0,127.0,5,1111,21.0,843.0,843.0
0.013,6,10,1631,5,848,3.0,580.0,580.0,5,783,3.0,515.0,515.0
0.007,6,10,1643,5,860,1.0,592.0,592.0,5,783,1.0,515.0,515.0
0.001,17,2,180,1,66,0.0,38.0,38.0,1,114,0.0,86.0,86.0
0.006,6,10,1779,5,928,1.0,660.0,660.0,5,851,1.0,583.0,583.0
0.011,6,10,1990,5,911,2.0,643.0,643.0,5,1079,2.0,811.0,811.0
0.071,6,10,1506,5,395,15.0,127.0,127.0,5,1111,14.0,843.0,843.0
0.005,6,10,1989,5,927,1.0,659.0,659.0,5,1062,1.0,794.0,794.0
0.005,6,10,1989,5,927,1.0,659.0,659.0,5,1062,1.0,794.0,794.0
0.007,6,10,1689,5,839,1.0,571.0,571.0,5,850,1.0,582.0,582.0
0.008,6,10,1677,5,827,2.0,559.0,559.0,5,850,1.0,582.0,582.0
0.01,6,10,1990,5,911,2.0,643.0,643.0,5,1079,2.0,811.0,811.0
0.017,6,10,1972,5,910,4.0,642.0,642.0,5,1062,4.0,794.0,794.0
0.003,17,2,136,1,60,0.0,32.0,32.0,1,76,0.0,48.0,48.0
0.012,6,10,1990,5,911,3.0,643.0,643.0,5,1079,3.0,811.0,811.0
0.014,6,10,1762,5,911,3.0,643.0,643.0,5,851,3.0,583.0,583.0
0.006,6,10,1547,5,764,1.0,496.0,496.0,5,783,1.0,515.0,515.0
0.111,6,10,1506,5,395,25.0,127.0,127.0,5,1111,25.0,843.0,843.0
0.005,6,10,2007,5,928,1.0,660.0,660.0,5,1079,1.0,811.0,811.0
0.044,17,2,182,1,65,0.0,37.0,37.0,1,117,0.0,89.0,89.0
0.066,6,10,1506,5,395,14.0,127.0,127.0,5,1111,14.0,843.0,843.0
0.01,6,10,1677,5,827,2.0,559.0,559.0,5,850,2.0,582.0,582.0
0.077,6,10,1506,5,395,18.0,127.0,127.0,5,1111,18.0,843.0,843.0
0.003,17,2,148,1,60,0.0,32.0,32.0,1,88,0.0,60.0,60.0
0.001,17,2,180,1,66,0.0,38.0,38.0,1,114,0.0,86.0,86.0
0.005,6,10,2006,5,927,1.0,659.0,659.0,5,1079,1.0,811.0,811.0
0.127,6,10,1506,5,395,30.0,127.0,127.0,5,1111,27.0,843.0,843.0
0.112,6,10,1506,5,395,26.0,127.0,127.0,5,1111,25.0,843.0,843.0
15.383,17,20,11022,10,7354,1708.0,1350.0,707.0,10,3668,1705.0,1350.0,338.0
240.087,6,16,4481,9,963,30010.0,238.0,166.0,7,3518,40014.0,1402.0,786.0
0.006,6,10,1547,5,764,1.0,496.0,496.0,5,783,1.0,515.0,515.0
0.119,6,10,1506,5,395,27.0,127.0,127.0,5,1111,24.0,843.0,843.0
0.005,6,10,2007,5,928,1.0,660.0,660.0,5,1079,1.0,811.0,811.0
0.001,17,2,136,1,60,0.0,32.0,32.0,1,76,0.0,48.0,48.0
0.084,6,10,1506,5,395,18.0,127.0,127.0,5,1111,20.0,843.0,843.0
0.005,6,10,1774,5,923,1.0,655.0,655.0,5,851,1.0,583.0,583.0
0.078,6,10,1506,5,395,16.0,127.0,127.0,5,1111,16.0,843.0,843.0
0.004,6,10,1989,5,927,1.0,659.0,659.0,5,1062,1.0,794.0,794.0
309.778,17,20,1124,10,716,34407.0,48.0,43.0,10,408,34408.0,20.0,12.0
0.001,17,2,164,1,74,0.0,46.0,46.0,1,90,0.0,62.0,62.0
0.005,6,13,3690,7,452,0.0,80.0,80.0,6,3238,1.0,1470.0,1459.0
11.192,17,32,5451,16,2668,738.0,588.0,138.0,16,2783,738.0,588.0,145.0
0.005,17,2,170,1,65,0.0,37.0,37.0,1,105,0.0,77.0,77.0
0.003,17,4,284,2,120,0.0,32.0,32.0,2,164,0.0,60.0,54.0
366.178,6,22,2313,16,867,24411.0,195.0,195.0,6,1446,4673.0,419.0,398.0
15.076,17,15,8108,8,5999,2149.0,1350.0,721.0,7,2109,2507.0,1350.0,273.0
0.006,6,10,1854,5,889,1.0,621.0,621.0,5,965,1.0,697.0,697.0
0.012,6,10,1989,5,910,3.0,642.0,642.0,5,1079,2.0,811.0,811.0
0.077,6,10,1506,5,395,18.0,127.0,127.0,5,1111,15.0,843.0,843.0
0.161,17,2,152,1,76,0.0,48.0,48.0,1,76,0.0,48.0,48.0
1786.954,6,151,19402,90,13740,20078.0,302.0,302.0,61,5662,29782.0,83.0,83.0
40.072,17,10,676,5,460,10016.0,104.0,64.0,5,216,10017.0,20.0,15.0
0.045,6,10,1989,5,910,11.0,642.0,642.0,5,1079,11.0,811.0,811.0
0.996,17,23,16850,10,4290,110.0,1350.0,401.0,13,12560,78.0,1350.0,938.0
0.01,6,10,1990,5,911,2.0,643.0,643.0,5,1079,2.0,811.0,811.0
0.006,6,10,1854,5,889,1.0,621.0,621.0,5,965,1.0,697.0,697.0
0.121,6,10,1506,5,395,28.0,127.0,127.0,5,1111,20.0,843.0,843.0
0.005,6,10,1689,5,839,1.0,571.0,571.0,5,850,1.0,582.0,582.0
15.075,17,14,9190,8,6902,2149.0,1350.0,834.0,6,2288,3009.0,1350.0,353.0
0.004,17,2,148,1,60,0.0,32.0,32.0,1,88,0.0,60.0,60.0
0.057,17,2,152,1,76,0.0,48.0,48.0,1,76,0.0,48.0,48.0
0.066,6,10,1506,5,395,14.0,127.0,127.0,5,1111,12.0,843.0,843.0
0.025,17,2,198,1,91,0.0,63.0,63.0,1,107,0.0,79.0,79.0
300.018,6,12,1782,7,1348,50003.0,494.0,494.0,5,434,75004.0,83.0,83.0
0.091,6,10,1506,5,395,21.0,127.0,127.0,5,1111,21.0,843.0,843.0
0.012,6,10,1990,5,911,3.0,643.0,643.0,5,1079,3.0,811.0,811.0
0.006,6,10,1547,5,764,1.0,496.0,496.0,5,783,1.0,515.0,515.0
0.01,6,10,1983,5,910,2.0,642.0,642.0,5,1073,2.0,805.0,805.0
60.02,6,10,1690,6,1308,12004.0,494.0,494.0,4,382,20005.0,83.0,83.0
0.014,6,10,1989,5,910,3.0,642.0,642.0,5,1079,3.0,811.0,811.0
0.004,6,10,2007,5,928,1.0,660.0,660.0,5,1079,1.0,811.0,811.0
0.005,6,10,1643,5,860,1.0,592.0,592.0,5,783,1.0,515.0,515.0
0.015,17,2,214,1,75,0.0,47.0,47.0,1,139,0.0,111.0,111.0
0.019,6,13,3735,7,497,3.0,125.0,125.0,6,3238,3.0,1470.0,1459.0
0.005,17,2,164,1,74,0.0,46.0,46.0,1,90,0.0,62.0,62.0
0.007,6,10,1854,5,889,1.0,621.0,621.0,5,965,1.0,697.0,697.0
0.005,17,2,140,1,62,0.0,34.0,34.0,1,78,0.0,50.0,50.0
0.006,6,10,1547,5,764,1.0,496.0,496.0,5,783,1.0,515.0,515.0
0.07,6,10,1506,5,395,12.0,127.0,127.0,5,1111,16.0,843.0,843.0
0.011,6,10,1990,5,911,2.0,643.0,643.0,5,1079,2.0,811.0,811.0
0.006,6,10,1547,5,764,1.0,496.0,496.0,5,783,1.0,515.0,515.0
0.004,6,10,1779,5,928,1.0,660.0,660.0,5,851,1.0,583.0,583.0
0.001,17,2,180,1,66,0.0,38.0,38.0,1,114,0.0,86.0,86.0
0.006,6,10,1547,5,764,1.0,496.0,496.0,5,783,1.0,515.0,515.0
0.005,17,2,170,1,65,0.0,37.0,37.0,1,105,0.0,77.0,77.0
0.004,6,10,2000,5,927,1.0,659.0,659.0,5,1073,1.0,805.0,805.0
0.015,6,10,1989,5,910,3.0,642.0,642.0,5,1079,3.0,811.0,811.0
0.075,6,10,1506,5,395,16.0,127.0,127.0,5,1111,18.0,843.0,843.0
0.004,17,2,136,1,60,0.0,32.0,32.0,1,76,0.0,48.0,48.0
0.006,6,10,1854,5,889,1.0,621.0,621.0,5,965,1.0,697.0,697.0
0.012,6,10,1989,5,910,3.0,642.0,642.0,5,1079,3.0,811.0,811.0
0.004,6,10,2006,5,927,1.0,659.0,659.0,5,1079,1.0,811.0,811.0
11.069,17,34,6372,17,2656,684.0,269.0,128.0,17,3716,684.0,1145.0,190.0
0.093,6,10,1506,5,395,18.0,127.0,127.0,5,1111,19.0,843.0,843.0
0.261,17,44,26698,26,23458,10.0,1350.0,874.0,18,3240,12.0,1350.0,152.0
0.006,17,2,179,1,71,0.0,43.0,43.0,1,108,0.0,80.0,80.0
0.005,6,15,3794,8,504,0.0,80.0,80.0,7,3290,0.0,1448.0,972.0
0.004,6,10,2000,5,927,1.0,659.0,659.0,5,1073,1.0,805.0,805.0
0.001,17,2,136,1,60,0.0,32.0,32.0,1,76,0.0,48.0,48.0
0.005,6,10,2007,5,928,1.0,660.0,660.0,5,1079,1.0,811.0,811.0
0.006,17,2,213,1,69,0.0,41.0,41.0,1,144,0.0,116.0,116.0
0.004,17,2,136,1,60,0.0,32.0,32.0,1,76,0.0,48.0,48.0
240.574,6,43,11112,22,5493,11455.0,1368.0,482.0,21,5619,12028.0,1665.0,564.0
0.006,6,10,1547,5,764,1.0,496.0,496.0,5,783,1.0,515.0,515.0
0.005,6,10,2007,5,928,1.0,660.0,660.0,5,1079,1.0,811.0,811.0
0.112,6,10,1506,5,395,25.0,127.0,127.0,5,1111,25.0,843.0,843.0
0.005,6,10,1989,5,927,1.0,659.0,659.0,5,1062,1.0,794.0,794.0
0.011,6,10,1989,5,910,2.0,642.0,642.0,5,1079,2.0,811.0,811.0
0.067,6,10,1506,5,395,13.0,127.0,127.0,5,1111,15.0,843.0,843.0
0.104,6,10,1506,5,395,25.0,127.0,127.0,5,1111,24.0,843.0,843.0
1.005,6,12,3134,6,2099,151.0,1328.0,923.0,6,1035,151.0,791.0,791.0
0.066,17,8,3613,4,1874,22.0,1350.0,440.0,4,1739,11.0,1350.0,406.0
0.011,6,10,1989,5,910,2.0,642.0,642.0,5,1079,2.0,811.0,811.0
0.182,17,2,194,1,59,0.0,31.0,31.0,1,135,0.0,107.0,107.0
0.01,6,10,1990,5,911,2.0,643.0,643.0,5,1079,2.0,811.0,811.0
0.005,6,10,1989,5,927,1.0,659.0,659.0,5,1062,1.0,794.0,794.0
0.124,17,2,80,1,32,0.0,4.0,4.0,1,48,0.0,20.0,20.0
0.005,6,10,1989,5,927,1.0,659.0,659.0,5,1062,1.0,794.0,794.0
0.039,17,4,284,2,120,0.0,32.0,32.0,2,164,1.0,60.0,54.0
0.158,6,10,1506,5,395,35.0,127.0,127.0,5,1111,34.0,843.0,843.0
0.085,6,10,1506,5,395,19.0,127.0,127.0,5,1111,19.0,843.0,843.0
0.04,17,2,182,1,65,0.0,37.0,37.0,1,117,0.0,89.0,89.0
0.016,6,10,1990,5,911,3.0,643.0,643.0,5,1079,3.0,811.0,811.0
0.004,6,10,2006,5,927,1.0,659.0,659.0,5,1079,1.0,811.0,811.0
240.231,6,31,11820,16,6035,16015.0,1487.0,865.0,15,5785,17159.0,1655.0,713.0
0.002,17,2,180,1,66,0.0,38.0,38.0,1,114,0.0,86.0,86.0
289.294,6,400,348417,197,21804,1475.0,2736.0,888.0,203,326613,1432.0,2804.0,1672.0
240.093,6,31,9617,15,7382,17149.0,2505.0,734.0,16,2235,16006.0,580.0,174.0
0.079,6,10,1506,5,395,19.0,127.0,127.0,5,1111,18.0,843.0,843.0
0.005,6,10,2006,5,927,1.0,659.0,659.0,5,1079,1.0,811.0,811.0
40.063,17,10,676,5,460,10014.0,104.0,64.0,5,216,10015.0,20.0,15.0
0.08,6,10,1506,5,395,16.0,127.0,127.0,5,1111,16.0,843.0,843.0
0.026,6,10,1972,5,910,6.0,642.0,642.0,5,1062,6.0,794.0,794.0
0.005,6,10,2006,5,927,1.0,659.0,659.0,5,1079,1.0,811.0,811.0
40.057,17,10,676,5,460,10013.0,104.0,64.0,5,216,10013.0,20.0,15.0
0.375,17,42,20402,22,17085,17.0,1350.0,748.0,20,3317,16.0,1350.0,137.0
0.217,6,16,2669,8,1395,31.0,533.0,323.0,8,1274,19.0,529.0,212.0
0.015,6,10,1972,5,910,3.0,642.0,642.0,5,1062,3.0,794.0,794.0
0.006,6,10,2006,5,927,1.0,659.0,659.0,5,1079,1.0,811.0,811.0
240.09,6,16,4480,9,963,30011.0,238.0,166.0,7,3517,40014.0,1402.0,786.0
0.092,6,10,1506,5,395,21.0,127.0,127.0,5,1111,19.0,843.0,843.0
0.005,17,2,144,1,64,0.0,36.0,36.0,1,80,0.0,52.0,52.0
0.016,6,10,1990,5,911,4.0,643.0,643.0,5,1079,3.0,811.0,811.0
0.004,6,10,2007,5,928,1.0,660.0,660.0,5,1079,1.0,811.0,811.0
0.144,6,10,1506,5,395,27.0,127.0,127.0,5,1111,31.0,843.0,843.0
0.008,6,10,1972,5,910,2.0,642.0,642.0,5,1062,2.0,794.0,794.0
0.037,17,4,284,2,120,0.0,32.0,32.0,2,164,34.0,60.0,54.0
0.012,6,13,3735,7,497,2.0,125.0,125.0,6,3238,2.0,1470.0,1459.0
0.005,6,10,2006,5,927,1.0,659.0,659.0,5,1079,1.0,811.0,811.0
11.487,17,28,4395,14,1994,871.0,269.0,114.0,14,2401,871.0,588.0,143.0
0.011,6,10,1643,5,860,2.0,592.0,592.0,5,783,2.0,515.0,515.0
0.007,6,12,1698,6,863,1.0,327.0,271.0,6,835,1.0,515.0,515.0
0.005,6,10,2006,5,927,1.0,659.0,659.0,5,1079,1.0,811.0,811.0
0.01,6,10,1989,5,910,2.0,642.0,642.0,5,1079,2.0,811.0,811.0
0.005,6,10,1854,5,889,1.0,621.0,621.0,5,965,1.0,697.0,697.0
0.005,17,4,284,2,120,0.0,32.0,32.0,2,164,1.0,60.0,54.0
0.011,6,10,1989,5,910,2.0,642.0,642.0,5,1079,2.0,811.0,811.0
240.259,6,39,5224,20,2435,12645.0,588.0,196.0,19,2789,13347.0,580.0,256.0
81.696,6,22,7437,11,1305,124.0,530.0,277.0,11,6132,8152.0,2720.0,946.0
0.115,6,10,1506,5,395,26.0,127.0,127.0,5,1111,24.0,843.0,843.0
0.001,17,2,180,1,66,0.0,38.0,38.0,1,114,0.0,86.0,86.0
0.015,6,10,1983,5,910,3.0,642.0,642.0,5,1073,3.0,805.0,805.0
0.082,6,10,1506,5,395,18.0,127.0,127.0,5,1111,19.0,843.0,843.0
0.006,6,10,1547,5,764,1.0,496.0,496.0,5,783,1.0,515.0,515.0
0.084,6,10,1506,5,395,17.0,127.0,127.0,5,1111,18.0,843.0,843.0
0.141,6,10,1506,5,395,33.0,127.0,127.0,5,1111,32.0,843.0,843.0
0.014,6,10,1989,5,910,3.0,642.0,642.0,5,1079,3.0,811.0,811.0
0.159,6,10,1506,5,395,33.0,127.0,127.0,5,1111,35.0,843.0,843.0
0.079,6,10,1506,5,395,18.0,127.0,127.0,5,1111,17.0,843.0,843.0
0.004,17,2,136,1,60,0.0,32.0,32.0,1,76,0.0,48.0,48.0
0.006,6,10,1547,5,764,1.0,496.0,496.0,5,783,1.0,515.0,515.0
0.009,6,10,1990,5,911,2.0,643.0,643.0,5,1079,2.0,811.0,811.0
0.103,6,10,1506,5,395,22.0,127.0,127.0,5,1111,23.0,843.0,843.0
40.057,17,10,676,5,460,10013.0,104.0,64.0,5,216,10013.0,20.0,15.0
0.011,17,2,273,1,66,0.0,38.0,38.0,1,207,0.0,179.0,179.0
0.007,6,10,1547,5,764,1.0,496.0,496.0,5,783,1.0,515.0,515.0
0.003,17,2,152,1,76,0.0,48.0,48.0,1,76,0.0,48.0,48.0
0.01,6,10,1989,5,910,2.0,642.0,642.0,5,1079,2.0,811.0,811.0
5.107,58,2,144,1,72,0.0,24.0,24.0,1,72,0.0,24.0,24.0
0.082,6,10,1506,5,395,18.0,127.0,127.0,5,1111,16.0,843.0,843.0
0.04,17,2,184,1,61,0.0,33.0,33.0,1,123,0.0,95.0,95.0
0.004,6,10,1702,5,863,1.0,595.0,595.0,5,839,1.0,571.0,571.0
0.001,17,2,136,1,60,0.0,32.0,32.0,1,76,0.0,48.0,48.0
0.01,6,10,1972,5,910,2.0,642.0,642.0,5,1062,2.0,794.0,794.0
0.012,6,10,1989,5,910,2.0,642.0,642.0,5,1079,3.0,811.0,811.0
0.005,17,2,144,1,64,0.0,36.0,36.0,1,80,0.0,52.0,52.0
0.004,17,2,148,1,60,0.0,32.0,32.0,1,88,0.0,60.0,60.0
0.005,17,2,136,1,60,0.0,32.0,32.0,1,76,0.0,48.0,48.0
0.04,17,2,148,1,60,0.0,32.0,32.0,1,88,0.0,60.0,60.0
0.033,17,2,136,1,60,0.0,32.0,32.0,1,76,0.0,48.0,48.0
0.006,17,2,230,1,68,0.0,40.0,40.0,1,162,0.0,134.0,134.0
0.013,6,10,1989,5,910,3.0,642.0,642.0,5,1079,3.0,811.0,811.0
0.075,6,10,1506,5,395,13.0,127.0,127.0,5,1111,16.0,843.0,843.0
0.064,6,10,1506,5,395,13.0,127.0,127.0,5,1111,14.0,843.0,843.0
0.005,6,10,2006,5,927,1.0,659.0,659.0,5,1079,1.0,811.0,811.0
0.023,6,10,1983,5,910,5.0,642.0,642.0,5,1073,5.0,805.0,805.0
0.014,6,10,1989,5,910,3.0,642.0,642.0,5,1079,3.0,811.0,811.0
0.004,17,2,136,1,60,0.0,32.0,32.0,1,76,0.0,48.0,48.0
0.004,6,10,2006,5,927,1.0,659.0,659.0,5,1079,1.0,811.0,811.0
0.011,6,10,1989,5,910,2.0,642.0,642.0,5,1079,2.0,811.0,811.0
0.122,6,10,1506,5,395,27.0,127.0,127.0,5,1111,28.0,843.0,843.0
0.013,6,10,1972,5,910,3.0,642.0,642.0,5,1062,3.0,794.0,794.0
0.004,6,10,2007,5,928,1.0,660.0,660.0,5,1079,1.0,811.0,811.0
0.006,6,10,2007,5,928,1.0,660.0,660.0,5,1079,1.0,811.0,811.0
0.005,17,2,144,1,64,0.0,36.0,36.0,1,80,0.0,52.0,52.0
0.005,6,10,2006,5,927,1.0,659.0,659.0,5,1079,1.0,811.0,811.0
0.002,17,2,180,1,66,0.0,38.0,38.0,1,114,0.0,86.0,86.0
0.022,6,10,1762,5,911,5.0,643.0,643.0,5,851,5.0,583.0,583.0
0.124,6,10,1506,5,395,29.0,127.0,127.0,5,1111,26.0,843.0,843.0
0.005,6,10,1689,5,839,1.0,571.0,571.0,5,850,1.0,582.0,582.0
0.006,6,13,3690,7,452,1.0,80.0,80.0,6,3238,1.0,1470.0,1459.0
0.009,6,13,3735,7,497,1.0,125.0,125.0,6,3238,1.0,1470.0,1459.0
0.07,6,10,1506,5,395,14.0,127.0,127.0,5,1111,17.0,843.0,843.0
0.005,6,10,1989,5,927,1.0,659.0,659.0,5,1062,1.0,794.0,794.0
240.096,6,16,4482,9,963,30012.0,238.0,166.0,7,3519,40015.0,1402.0,786.0
15.294,17,47,28526,26,22606,610.0,1350.0,841.0,21,5920,763.0,1350.0,253.0
0.12,6,10,1506,5,395,25.0,127.0,127.0,5,1111,26.0,843.0,843.0
0.005,6,10,2007,5,928,1.0,660.0,660.0,5,1079,1.0,811.0,811.0
0.004,6,10,2000,5,927,1.0,659.0,659.0,5,1073,1.0,805.0,805.0
0.009,6,10,1989,5,910,2.0,642.0,642.0,5,1079,2.0,811.0,811.0
0.006,6,10,1779,5,928,1.0,660.0,660.0,5,851,1.0,583.0,583.0
186.509,17,80,11264,40,2676,4782.0,44.0,38.0,40,8588,4782.0,261.0,186.0
0.015,6,10,1631,5,848,3.0,580.0,580.0,5,783,3.0,515.0,515.0
0.013,6,10,1990,5,911,3.0,643.0,643.0,5,1079,3.0,811.0,811.0
0.006,6,10,1689,5,839,1.0,571.0,571.0,5,850,1.0,582.0,582.0
0.008,6,10,1972,5,910,2.0,642.0,642.0,5,1062,2.0,794.0,794.0
0.005,6,10,1779,5,928,1.0,660.0,660.0,5,851,1.0,583.0,583.0
0.17,6,10,1506,5,395,40.0,127.0,127.0,5,1111,40.0,843.0,843.0
0.132,6,10,1506,5,395,30.0,127.0,127.0,5,1111,29.0,843.0,843.0
0.133,17,2,80,1,32,0.0,4.0,4.0,1,48,0.0,20.0,20.0
0.078,6,10,1506,5,395,17.0,127.0,127.0,5,1111,17.0,843.0,843.0
0.006,17,2,170,1,65,0.0,37.0,37.0,1,105,0.0,77.0,77.0
0.135,6,10,1506,5,395,32.0,127.0,127.0,5,1111,30.0,843.0,843.0
0.001,17,2,180,1,66,0.0,38.0,38.0,1,114,0.0,86.0,86.0
0.115,6,10,1506,5,395,25.0,127.0,127.0,5,1111,25.0,843.0,843.0
0.008,6,10,1972,5,910,1.0,642.0,642.0,5,1062,1.0,794.0,794.0
0.09,6,10,1506,5,395,20.0,127.0,127.0,5,1111,19.0,843.0,843.0
0.006,6,10,1547,5,764,1.0,496.0,496.0,5,783,1.0,515.0,515.0
0.003,17,4,284,2,120,0.0,32.0,32.0,2,164,0.0,60.0,54.0
0.109,6,10,1506,5,395,24.0,127.0,127.0,5,1111,25.0,843.0,843.0
0.038,17,2,182,1,65,0.0,37.0,37.0,1,117,0.0,89.0,89.0
40.08,17,10,676,5,460,10018.0,104.0,64.0,5,216,10019.0,20.0,15.0
15.07,17,15,9238,8,6902,2148.0,1350.0,834.0,7,2336,2506.0,1350.0,305.0
0.015,6,10,1989,5,910,3.0,642.0,642.0,5,1079,3.0,811.0,811.0
158.329,17,90,12621,45,3019,3598.0,44.0,39.0,45,9602,3598.0,239.0,185.0
0.005,6,10,2006,5,927,1.0,659.0,659.0,5,1079,1.0,811.0,811.0
0.009,6,10,1989,5,910,2.0,642.0,642.0,5,1079,2.0,811.0,811.0
0.016,6,10,1989,5,910,3.0,642.0,642.0,5,1079,3.0,811.0,811.0
0.005,6,14,3799,7,509,0.0,137.0,137.0,7,3290,0.0,1448.0,972.0
0.009,6,10,1989,5,910,2.0,642.0,642.0,5,1079,2.0,811.0,811.0
354.051,6,21,1795,16,1030,23603.0,190.0,190.0,5,765,60002.0,464.0,248.0
0.046,6,10,1990,5,911,11.0,643.0,643.0,5,1079,11.0,811.0,811.0
240.263,6,44,8823,22,5738,11440.0,1368.0,458.0,22,3085,11440.0,580.0,241.0
116.849,6,39,10113,21,4595,5833.0,1360.0,620.0,18,5518,6863.0,2667.0,435.0
40.067,17,10,676,5,460,10013.0,104.0,64.0,5,216,10015.0,20.0,15.0
0.116,6,10,1506,5,395,17.0,127.0,127.0,5,1111,25.0,843.0,843.0
0.004,6,10,2006,5,927,1.0,659.0,659.0,5,1079,1.0,811.0,811.0
0.117,6,10,1506,5,395,26.0,127.0,127.0,5,1111,24.0,843.0,843.0
0.114,6,10,1506,5,395,25.0,127.0,127.0,5,1111,24.0,843.0,843.0
0.001,17,2,136,1,60,0.0,32.0,32.0,1,76,0.0,48.0,48.0
0.016,6,10,1972,5,910,3.0,642.0,642.0,5,1062,4.0,794.0,794.0
0.011,6,10,1990,5,911,2.0,643.0,643.0,5,1079,2.0,811.0,811.0
0.003,17,2,136,1,60,0.0,32.0,32.0,1,76,0.0,48.0,48.0
11.132,17,28,4423,14,1994,843.0,269.0,114.0,14,2429,843.0,588.0,145.0
0.001,17,2,180,1,66,0.0,38.0,38.0,1,114,0.0,86.0,86.0
0.066,6,10,1506,5,395,15.0,127.0,127.0,5,1111,15.0,843.0,843.0
0.005,17,2,154,1,69,0.0,41.0,41.0,1,85,0.0,57.0,57.0
0.018,6,14,3787,7,497,2.0,125.0,125.0,7,3290,2.0,1448.0,972.0
0.138,6,10,1506,5,395,33.0,127.0,127.0,5,1111,20.0,843.0,843.0
0.005,6,10,2007,5,928,1.0,660.0,660.0,5,1079,1.0,811.0,811.0
40.09,17,10,676,5,460,10019.0,104.0,64.0,5,216,10021.0,20.0,15.0
0.016,6,10,1990,5,911,4.0,643.0,643.0,5,1079,4.0,811.0,811.0
0.012,6,10,1631,5,848,2.0,580.0,580.0,5,783,3.0,515.0,515.0
0.016,6,10,1677,5,827,3.0,559.0,559.0,5,850,3.0,582.0,582.0
0.005,6,10,2006,5,927,1.0,659.0,659.0,5,1079,1.0,811.0,811.0
0.015,6,10,1972,5,910,3.0,642.0,642.0,5,1062,3.0,794.0,794.0
0.042,17,4,284,2,120,1.0,32.0,32.0,2,164,39.0,60.0,54.0
0.005,6,10,2007,5,928,1.0,660.0,660.0,5,1079,1.0,811.0,811.0
0.117,6,10,1506,5,395,25.0,127.0,127.0,5,1111,17.0,843.0,843.0
0.012,6,10,1990,5,911,3.0,643.0,643.0,5,1079,3.0,811.0,811.0
0.005,6,10,2006,5,927,1.0,659.0,659.0,5,1079,1.0,811.0,811.0
0.287,17,38,20083,21,17029,14.0,1350.0,782.0,17,3054,13.0,1350.0,151.0
0.083,6,10,1506,5,395,18.0,127.0,127.0,5,1111,19.0,843.0,843.0
0.121,6,10,1506,5,395,28.0,127.0,127.0,5,1111,25.0,843.0,843.0
351.995,6,20,2210,6,1308,12003.0,494.0,494.0,14,902,27076.0,83.0,83.0
0.004,6,10,1774,5,923,1.0,655.0,655.0,5,851,1.0,583.0,583.0
0.038,17,2,156,1,64,0.0,36.0,36.0,1,92,0.0,64.0,64.0
0.007,6,10,1677,5,827,1.0,559.0,559.0,5,850,1.0,582.0,582.0
0.005,6,15,3794,8,504,0.0,80.0,80.0,7,3290,0.0,1448.0,972.0
0.005,17,2,164,1,74,0.0,46.0,46.0,1,90,0.0,62.0,62.0
0.099,6,10,1506,5,395,21.0,127.0,127.0,5,1111,23.0,843.0,843.0
40.067,17,10,676,5,460,10014.0,104.0,64.0,5,216,10013.0,20.0,15.0
0.008,6,10,1990,5,911,1.0,643.0,643.0,5,1079,1.0,811.0,811.0
0.009,6,10,1989,5,910,2.0,642.0,642.0,5,1079,2.0,811.0,811.0
0.009,6,10,1631,5,848,2.0,580.0,580.0,5,783,2.0,515.0,515.0
0.007,17,2,194,1,59,0.0,31.0,31.0,1,135,0.0,107.0,107.0
0.024,6,10,1990,5,911,6.0,643.0,643.0,5,1079,6.0,811.0,811.0
0.005,17,2,140,1,62,0.0,34.0,34.0,1,78,0.0,50.0,50.0
0.005,6,10,1779,5,928,1.0,660.0,660.0,5,851,1.0,583.0,583.0
0.023,17,2,178,1,81,0.0,53.0,53.0,1,97,0.0,69.0,69.0
0.001,17,2,166,1,75,0.0,47.0,47.0,1,91,0.0,63.0,63.0
11.02,17,28,4419,14,1995,838.0,270.0,114.0,14,2424,838.0,587.0,145.0
40.062,17,10,676,5,460,10014.0,104.0,64.0,5,216,10014.0,20.0,15.0
0.008,6,10,1989,5,910,2.0,642.0,642.0,5,1079,2.0,811.0,811.0
0.006,6,10,1547,5,764,1.0,496.0,496.0,5,783,1.0,515.0,515.0
0.01,6,10,1990,5,911,2.0,643.0,643.0,5,1079,2.0,811.0,811.0
300.339,6,16,2170,9,684,37522.0,146.0,146.0,7,1486,50029.0,419.0,398.0
0.004,6,10,1989,5,927,1.0,659.0,659.0,5,1062,1.0,794.0,794.0
0.098,6,10,1506,5,395,22.0,127.0,127.0,5,1111,21.0,843.0,843.0
0.001,17,2,180,1,66,0.0,38.0,38.0,1,114,0.0,86.0,86.0
0.006,6,10,2006,5,927,1.0,659.0,659.0,5,1079,1.0,811.0,811.0
0.005,6,10,1989,5,927,1.0,659.0,659.0,5,1062,1.0,794.0,794.0
0.003,17,2,148,1,60,0.0,32.0,32.0,1,88,0.0,60.0,60.0
0.006,6,10,1854,5,889,1.0,621.0,621.0,5,965,1.0,697.0,697.0
0.006,6,10,1689,5,839,1.0,571.0,571.0,5,850,1.0,582.0,582.0
0.038,17,2,170,1,65,0.0,37.0,37.0,1,105,0.0,77.0,77.0
0.005,6,10,1774,5,923,1.0,655.0,655.0,5,851,1.0,583.0,583.0
0.005,6,10,2006,5,927,1.0,659.0,659.0,5,1079,1.0,811.0,811.0
0.003,17,4,284,2,120,0.0,32.0,32.0,2,164,0.0,60.0,54.0
0.078,17,8,3613,4,1874,26.0,1350.0,440.0,4,1739,11.0,1350.0,406.0
0.005,17,2,179,1,71,0.0,43.0,43.0,1,108,0.0,80.0,80.0
240.011,6,9,787,5,488,60002.0,232.0,232.0,4,299,80002.0,83.0,83.0
15.083,17,15,8520,8,6317,2150.0,1350.0,761.0,7,2203,2508.0,1350.0,286.0
10.99,17,28,4390,14,2312,837.0,587.0,137.0,14,2078,837.0,269.0,120.0
0.005,17,2,140,1,62,0.0,34.0,34.0,1,78,0.0,50.0,50.0
0.008,6,10,1989,5,910,2.0,642.0,642.0,5,1079,2.0,811.0,811.0
0.008,6,10,1983,5,910,2.0,642.0,642.0,5,1073,1.0,805.0,805.0
0.012,6,10,1972,5,910,3.0,642.0,642.0,5,1062,2.0,794.0,794.0
0.12,6,14,4388,8,923,17.0,238.0,166.0,6,3465,15.0,1402.0,786.0
0.006,6,10,1547,5,764,1.0,496.0,496.0,5,783,1.0,515.0,515.0
0.13,17,2,80,1,32,0.0,4.0,4.0,1,48,0.0,20.0,20.0
0.07,17,8,3613,4,1874,23.0,1350.0,440.0,4,1739,12.0,1350.0,406.0
0.01,6,13,3735,7,497,1.0,125.0,125.0,6,3238,1.0,1470.0,1459.0
0.151,17,2,80,1,32,0.0,4.0,4.0,1,48,0.0,20.0,20.0
1786.118,6,154,19574,92,13852,19627.0,302.0,302.0,62,5722,29280.0,83.0,83.0
0.095,6,10,1506,5,395,22.0,127.0,127.0,5,1111,19.0,843.0,843.0
0.004,6,10,2006,5,927,1.0,659.0,659.0,5,1079,1.0,811.0,811.0
240.16,6,38,5137,18,2324,14126.0,588.0,197.0,20,2813,12639.0,580.0,220.0
0.115,6,10,1506,5,395,27.0,127.0,127.0,5,1111,25.0,843.0,843.0
11.072,17,28,4422,14,1994,839.0,269.0,114.0,14,2428,839.0,587.0,145.0
0.015,6,10,1631,5,848,3.0,580.0,580.0,5,783,3.0,515.0,515.0
40.06,17,10,676,5,460,10012.0,104.0,64.0,5,216,10014.0,20.0,15.0
0.004,17,2,148,1,60,0.0,32.0,32.0,1,88,0.0,60.0,60.0
0.038,17,4,284,2,120,0.0,32.0,32.0,2,164,35.0,60.0,54.0
0.183,6,10,1506,5,395,43.0,127.0,127.0,5,1111,34.0,843.0,843.0
0.005,17,2,180,1,66,0.0,38.0,38.0,1,114,0.0,86.0,86.0
0.004,17,2,148,1,60,0.0,32.0,32.0,1,88,0.0,60.0,60.0
0.203,6,10,1506,5,395,43.0,127.0,127.0,5,1111,48.0,843.0,843.0
0.006,6,10,1547,5,764,1.0,496.0,496.0,5,783,1.0,515.0,515.0
0.006,6,10,1689,5,839,1.0,571.0,571.0,5,850,1.0,582.0,582.0
0.009,6,10,1983,5,910,2.0,642.0,642.0,5,1073,2.0,805.0,805.0
0.106,6,10,1506,5,395,25.0,127.0,127.0,5,1111,23.0,843.0,843.0
0.008,6,10,1989,5,910,1.0,642.0,642.0,5,1079,1.0,811.0,811.0
0.071,6,10,1506,5,395,16.0,127.0,127.0,5,1111,15.0,843.0,843.0
0.005,6,10,2000,5,927,1.0,659.0,659.0,5,1073,1.0,805.0,805.0
0.072,17,8,3613,4,1874,24.0,1350.0,440.0,4,1739,12.0,1350.0,406.0
0.009,6,10,1990,5,911,2.0,643.0,643.0,5,1079,2.0,811.0,811.0
0.128,6,10,1506,5,395,30.0,127.0,127.0,5,1111,30.0,843.0,843.0
0.1,6,10,1506,5,395,22.0,127.0,127.0,5,1111,22.0,843.0,843.0
0.005,6,10,2000,5,927,1.0,659.0,659.0,5,1073,1.0,805.0,805.0
315.22,17,20,1124,10,716,35010.0,48.0,43.0,10,408,35010.0,20.0,12.0
0.019,6,10,1990,5,911,4.0,643.0,643.0,5,1079,4.0,811.0,811.0
0.001,17,2,180,1,66,0.0,38.0,38.0,1,114,0.0,86.0,86.0
0.006,6,10,1547,5,764,1.0,496.0,496.0,5,783,1.0,515.0,515.0
240.082,6,16,4482,9,963,30010.0,238.0,166.0,7,3519,40013.0,1402.0,786.0
300.178,6,27,11292,14,1837,23090.0,538.0,272.0,13,9455,5099.0,2624.0,1096.0
0.017,6,10,1972,5,910,4.0,642.0,642.0,5,1062,4.0,794.0,794.0
0.006,17,2,144,1,64,0.0,36.0,36.0,1,80,0.0,52.0,52.0
0.005,6,10,1989,5,927,1.0,659.0,659.0,5,1062,1.0,794.0,794.0
0.003,17,2,148,1,60,0.0,32.0,32.0,1,88,0.0,60.0,60.0
0.006,6,10,1643,5,860,1.0,592.0,592.0,5,783,1.0,515.0,515.0
0.006,6,12,1698,6,863,1.0,327.0,271.0,6,835,1.0,515.0,515.0
0.005,6,10,1689,5,839,1.0,571.0,571.0,5,850,1.0,582.0,582.0
418.517,6,29,4409,12,3102,10913.0,494.0,494.0,17,1307,26157.0,83.0,83.0
0.004,6,10,1989,5,927,1.0,659.0,659.0,5,1062,1.0,794.0,794.0
0.102,6,10,1506,5,395,21.0,127.0,127.0,5,1111,24.0,843.0,843.0
0.006,6,10,1854,5,889,1.0,621.0,621.0,5,965,1.0,697.0,697.0
0.003,17,2,136,1,60,0.0,32.0,32.0,1,76,0.0,48.0,48.0
0.088,6,10,1506,5,395,20.0,127.0,127.0,5,1111,20.0,843.0,843.0
0.116,6,10,1506,5,395,23.0,127.0,127.0,5,1111,23.0,843.0,843.0
0.111,17,2,80,1,32,0.0,4.0,4.0,1,48,0.0,20.0,20.0
0.109,6,10,1506,5,395,26.0,127.0,127.0,5,1111,20.0,843.0,843.0
0.019,6,10,1989,5,910,4.0,642.0,642.0,5,1079,4.0,811.0,811.0
66.036,6,27,17550,15,9603,4716.0,2804.0,1469.0,12,7947,5988.0,2318.0,1219.0
0.006,6,10,1547,5,764,1.0,496.0,496.0,5,783,1.0,515.0,515.0
0.086,6,10,1506,5,395,19.0,127.0,127.0,5,1111,18.0,843.0,843.0
308.615,17,20,1124,10,716,34275.0,48.0,43.0,10,408,34275.0,20.0,12.0
0.001,17,2,136,1,60,0.0,32.0,32.0,1,76,0.0,48.0,48.0
0.013,6,10,1972,5,910,3.0,642.0,642.0,5,1062,3.0,794.0,794.0
0.143,6,10,1506,5,395,33.0,127.0,127.0,5,1111,30.0,843.0,843.0
0.094,6,10,1506,5,395,20.0,127.0,127.0,5,1111,18.0,843.0,843.0
0.009,6,10,1989,5,910,2.0,642.0,642.0,5,1079,2.0,811.0,811.0
0.013,6,10,1972,5,910,3.0,642.0,642.0,5,1062,3.0,794.0,794.0
0.009,6,10,1990,5,911,2.0,643.0,643.0,5,1079,2.0,811.0,811.0
0.121,6,10,1506,5,395,28.0,127.0,127.0,5,1111,25.0,843.0,843.0
0.013,6,10,1972,5,910,3.0,642.0,642.0,5,1062,3.0,794.0,794.0
266.001,6,38,10007,15,6815,19000.0,1939.0,671.0,23,3192,12090.0,580.0,142.0
0.008,6,10,1677,5,827,2.0,559.0,559.0,5,850,2.0,582.0,582.0
0.005,6,10,1643,5,860,1.0,592.0,592.0,5,783,1.0,515.0,515.0
0.005,6,13,3690,7,452,0.0,80.0,80.0,6,3238,0.0,1470.0,1459.0
0.016,6,10,1989,5,910,4.0,642.0,642.0,5,1079,3.0,811.0,811.0
0.108,6,10,1506,5,395,18.0,127.0,127.0,5,1111,24.0,843.0,843.0
0.013,6,10,1990,5,911,3.0,643.0,643.0,5,1079,3.0,811.0,811.0
335.624,17,20,1124,10,716,37277.0,48.0,43.0,10,408,37277.0,20.0,12.0
0.009,6,10,1990,5,911,2.0,643.0,643.0,5,1079,2.0,811.0,811.0
0.261,17,2,142,1,63,0.0,35.0,35.0,1,79,0.0,51.0,51.0
0.016,6,10,1983,5,910,3.0,642.0,642.0,5,1073,3.0,805.0,805.0
0.003,17,4,284,2,120,0.0,32.0,32.0,2,164,0.0,60.0,54.0
0.004,6,10,1702,5,863,1.0,595.0,595.0,5,839,1.0,571.0,571.0
0.006,6,10,1547,5,764,1.0,496.0,496.0,5,783,1.0,515.0,515.0
0.16,6,10,1506,5,395,37.0,127.0,127.0,5,1111,37.0,843.0,843.0
0.005,6,10,1689,5,839,1.0,571.0,571.0,5,850,1.0,582.0,582.0
175.038,17,76,10721,38,2544,4730.0,44.0,38.0,38,8177,4730.0,239.0,187.0
0.003,17,2,136,1,60,0.0,32.0,32.0,1,76,0.0,48.0,48.0
0.017,6,10,1677,5,827,4.0,559.0,559.0,5,850,4.0,582.0,582.0
0.04,17,4,284,2,120,0.0,32.0,32.0,2,164,36.0,60.0,54.0
0.005,6,10,2006,5,927,1.0,659.0,659.0,5,1079,1.0,811.0,811.0
0.012,6,10,1972,5,910,3.0,642.0,642.0,5,1062,2.0,794.0,794.0
0.123,6,10,1506,5,395,25.0,127.0,127.0,5,1111,25.0,843.0,843.0
0.097,6,10,1506,5,395,20.0,127.0,127.0,5,1111,22.0,843.0,843.0
0.283,17,43,26628,25,23408,11.0,1350.0,908.0,18,3220,13.0,1350.0,150.0
0.005,6,10,1643,5,860,1.0,592.0,592.0,5,783,1.0,515.0,515.0
11.114,17,28,4390,14,2312,846.0,587.0,137.0,14,2078,846.0,269.0,120.0
0.008,6,10,1983,5,910,2.0,642.0,642.0,5,1073,2.0,805.0,805.0
0.005,6,10,1547,5,764,1.0,496.0,496.0,5,783,1.0,515.0,515.0
0.005,6,10,1689,5,839,1.0,571.0,571.0,5,850,1.0,582.0,582.0
0.187,17,2,194,1,59,0.0,31.0,31.0,1,135,0.0,107.0,107.0
0.011,6,10,1677,5,827,2.0,559.0,559.0,5,850,2.0,582.0,582.0
0.014,6,14,3787,7,497,2.0,125.0,125.0,7,3290,2.0,1448.0,972.0
0.074,6,10,1506,5,395,17.0,127.0,127.0,5,1111,17.0,843.0,843.0
15.075,17,14,9190,8,6902,2148.0,1350.0,834.0,6,2288,3009.0,1350.0,353.0
240.106,6,30,8809,15,6560,17150.0,1684.0,642.0,15,2249,17150.0,580.0,182.0
0.006,6,10,1689,5,839,1.0,571.0,571.0,5,850,1.0,582.0,582.0
0.089,6,10,1506,5,395,20.0,127.0,127.0,5,1111,17.0,843.0,843.0
0.005,6,14,3736,7,446,0.0,74.0,74.0,7,3290,0.0,1448.0,972.0
0.009,6,10,1762,5,911,2.0,643.0,643.0,5,851,2.0,583.0,583.0
0.001,17,2,180,1,66,0.0,38.0,38.0,1,114,0.0,86.0,86.0
0.106,6,10,1506,5,395,22.0,127.0,127.0,5,1111,25.0,843.0,843.0
0.006,17,2,140,1,62,0.0,34.0,34.0,1,78,0.0,50.0,50.0
0.005,6,10,2006,5,927,1.0,659.0,659.0,5,1079,1.0,811.0,811.0
0.012,6,10,1972,5,910,3.0,642.0,642.0,5,1062,3.0,794.0,794.0
0.001,17,2,180,1,66,0.0,38.0,38.0,1,114,0.0,86.0,86.0
0.005,6,10,2006,5,927,1.0,659.0,659.0,5,1079,1.0,811.0,811.0
0.134,17,2,80,1,32,0.0,4.0,4.0,1,48,0.0,20.0,20.0
0.005,17,2,225,1,65,0.0,37.0,37.0,1,160,0.0,132.0,132.0
30.065,6,12,1317,7,546,5010.0,174.0,174.0,5,771,7515.0,476.0,251.0
0.006,6,10,1547,5,764,1.0,496.0,496.0,5,783,1.0,515.0,515.0
40.066,17,10,676,5,460,10015.0,104.0,64.0,5,216,10015.0,20.0,15.0
0.009,6,10,1972,5,910,2.0,642.0,642.0,5,1062,2.0,794.0,794.0
0.005,6,10,2006,5,927,1.0,659.0,659.0,5,1079,1.0,811.0,811.0
0.119,6,10,1506,5,395,26.0,127.0,127.0,5,1111,27.0,843.0,843.0
0.21,17,2,80,1,32,0.0,4.0,4.0,1,48,0.0,20.0,20.0
0.011,6,10,1972,5,910,2.0,642.0,642.0,5,1062,2.0,794.0,794.0
0.007,6,10,1547,5,764,1.0,496.0,496.0,5,783,1.0,515.0,515.0
0.127,17,2,80,1,32,0.0,4.0,4.0,1,48,0.0,20.0,20.0
0.04,17,2,184,1,61,0.0,33.0,33.0,1,123,0.0,95.0,95.0
0.004,17,2,148,1,60,0.0,32.0,32.0,1,88,0.0,60.0,60.0
0.006,6,10,2006,5,927,1.0,659.0,659.0,5,1079,1.0,811.0,811.0
0.009,6,11,2024,6,962,1.0,642.0,642.0,5,1062,2.0,794.0,794.0
0.001,17,2,180,1,66,0.0,38.0,38.0,1,114,0.0,86.0,86.0
0.003,17,2,148,1,60,0.0,32.0,32.0,1,88,0.0,60.0,60.0
0.369,17,4,352,2,130,239.0,37.0,37.0,2,222,239.0,89.0,83.0
40.056,17,10,676,5,460,10012.0,104.0,64.0,5,216,10013.0,20.0,15.0
0.097,6,10,1506,5,395,22.0,127.0,127.0,5,1111,15.0,843.0,843.0
9.04,17,6,376,5,280,2260.0,28.0,28.0,1,96,0.0,68.0,68.0
0.005,6,10,1774,5,923,1.0,655.0,655.0,5,851,1.0,583.0,583.0
0.01,6,10,1990,5,911,2.0,643.0,643.0,5,1079,2.0,811.0,811.0
0.015,17,2,213,1,69,0.0,41.0,41.0,1,144,0.0,116.0,116.0
0.007,6,10,1689,5,839,1.0,571.0,571.0,5,850,1.0,582.0,582.0
0.008,6,13,3735,7,497,1.0,125.0,125.0,6,3238,1.0,1470.0,1459.0
0.085,6,10,1506,5,395,19.0,127.0,127.0,5,1111,19.0,843.0,843.0
1.033,6,13,3922,7,2139,129.0,1328.0,923.0,6,1783,155.0,1539.0,1539.0
0.19,6,10,1506,5,395,39.0,127.0,127.0,5,1111,46.0,843.0,843.0
0.007,6,10,1990,5,911,1.0,643.0,643.0,5,1079,1.0,811.0,811.0
11.116,17,28,4422,14,1995,846.0,270.0,114.0,14,2427,846.0,586.0,145.0
0.014,6,10,1989,5,910,3.0,642.0,642.0,5,1079,3.0,811.0,811.0
0.03,6,10,1972,5,910,7.0,642.0,642.0,5,1062,7.0,794.0,794.0
0.006,6,10,1547,5,764,1.0,496.0,496.0,5,783,1.0,515.0,515.0
0.089,6,10,1506,5,395,21.0,127.0,127.0,5,1111,13.0,843.0,843.0
0.004,17,2,136,1,60,0.0,32.0,32.0,1,76,0.0,48.0,48.0
0.005,6,10,2006,5,927,1.0,659.0,659.0,5,1079,1.0,811.0,811.0
40.064,17,10,676,5,460,10013.0,104.0,64.0,5,216,10015.0,20.0,15.0
0.005,17,2,154,1,69,0.0,41.0,41.0,1,85,0.0,57.0,57.0
0.062,6,10,1506,5,395,13.0,127.0,127.0,5,1111,14.0,843.0,843.0
0.01,6,10,1989,5,910,2.0,642.0,642.0,5,1079,2.0,811.0,811.0
240.015,6,9,787,5,488,60003.0,232.0,232.0,4,299,80004.0,83.0,83.0
0.005,6,10,2006,5,927,1.0,659.0,659.0,5,1079,1.0,811.0,811.0
0.081,6,10,1506,5,395,16.0,127.0,127.0,5,1111,19.0,843.0,843.0
0.089,6,10,1506,5,395,18.0,127.0,127.0,5,1111,19.0,843.0,843.0
0.007,17,2,164,1,74,0.0,46.0,46.0,1,90,0.0,62.0,62.0
0.008,17,2,194,1,59,0.0,31.0,31.0,1,135,0.0,107.0,107.0
0.014,6,10,1762,5,911,3.0,643.0,643.0,5,851,3.0,583.0,583.0
0.006,17,2,164,1,74,0.0,46.0,46.0,1,90,0.0,62.0,62.0
0.082,6,10,1506,5,395,18.0,127.0,127.0,5,1111,19.0,843.0,843.0
300.349,6,17,2222,10,736,33353.0,146.0,146.0,7,1486,50030.0,419.0,398.0
0.006,6,10,1547,5,764,1.0,496.0,496.0,5,783,1.0,515.0,515.0
0.014,6,10,1989,5,910,3.0,642.0,642.0,5,1079,3.0,811.0,811.0
0.023,6,10,1631,5,848,5.0,580.0,580.0,5,783,5.0,515.0,515.0
0.004,6,10,1730,5,513,1.0,245.0,245.0,5,1217,1.0,949.0,949.0
0.004,6,10,1779,5,928,1.0,660.0,660.0,5,851,1.0,583.0,583.0
0.081,6,10,1506,5,395,16.0,127.0,127.0,5,1111,16.0,843.0,843.0
0.011,6,10,1972,5,910,2.0,642.0,642.0,5,1062,2.0,794.0,794.0
0.005,6,10,2006,5,927,1.0,659.0,659.0,5,1079,1.0,811.0,811.0
0.008,6,10,1547,5,764,1.0,496.0,496.0,5,783,1.0,515.0,515.0
0.005,6,14,3799,7,509,0.0,137.0,137.0,7,3290,0.0,1448.0,972.0
0.006,6,10,1689,5,839,1.0,571.0,571.0,5,850,1.0,582.0,582.0
0.01,6,10,1983,5,910,2.0,642.0,642.0,5,1073,2.0,805.0,805.0
0.015,6,10,1989,5,910,3.0,642.0,642.0,5,1079,3.0,811.0,811.0
0.129,6,10,1506,5,395,30.0,127.0,127.0,5,1111,23.0,843.0,843.0
0.094,6,10,1506,5,395,21.0,127.0,127.0,5,1111,19.0,843.0,843.0
0.015,6,10,1990,5,911,3.0,643.0,643.0,5,1079,3.0,811.0,811.0
0.004,17,2,148,1,60,0.0,32.0,32.0,1,88,0.0,60.0,60.0
0.077,6,10,1506,5,395,16.0,127.0,127.0,5,1111,17.0,843.0,843.0
0.001,17,2,180,1,65,0.0,37.0,37.0,1,115,0.0,87.0,87.0
0.019,17,2,214,1,75,0.0,47.0,47.0,1,139,0.0,111.0,111.0
0.004,6,10,2006,5,927,1.0,659.0,659.0,5,1079,1.0,811.0,811.0
0.006,17,2,304,1,77,0.0,49.0,49.0,1,227,0.0,199.0,199.0
0.017,6,10,1990,5,911,4.0,643.0,643.0,5,1079,4.0,811.0,811.0
0.081,6,10,1506,5,395,18.0,127.0,127.0,5,1111,17.0,843.0,843.0
240.082,6,16,4481,9,963,30010.0,238.0,166.0,7,3518,40013.0,1402.0,786.0
0.006,6,10,1547,5,764,1.0,496.0,496.0,5,783,1.0,515.0,515.0
0.008,6,10,1972,5,910,2.0,642.0,642.0,5,1062,2.0,794.0,794.0
0.016,6,10,1989,5,910,4.0,642.0,642.0,5,1079,3.0,811.0,811.0
0.005,6,10,2006,5,927,1.0,659.0,659.0,5,1079,1.0,811.0,811.0
0.008,17,2,179,1,71,0.0,43.0,43.0,1,108,0.0,80.0,80.0
0.004,17,2,148,1,60,0.0,32.0,32.0,1,88,0.0,60.0,60.0
37.697,17,26,14947,14,12082,2897.0,1350.0,835.0,12,2865,3424.0,1350.0,210.0
0.005,6,10,2007,5,928,1.0,660.0,660.0,5,1079,1.0,811.0,811.0
0.112,6,10,1506,5,395,22.0,127.0,127.0,5,1111,22.0,843.0,843.0
0.003,17,2,136,1,60,0.0,32.0,32.0,1,76,0.0,48.0,48.0
0.005,17,2,144,1,64,0.0,36.0,36.0,1,80,0.0,52.0,52.0
0.006,17,2,144,1,64,0.0,36.0,36.0,1,80,0.0,52.0,52.0
0.083,6,10,1506,5,395,17.0,127.0,127.0,5,1111,18.0,843.0,843.0
0.12,6,10,1506,5,395,27.0,127.0,127.0,5,1111,21.0,843.0,843.0
0.237,17,40,20139,22,17094,11.0,1350.0,749.0,18,3045,10.0,1350.0,141.0
0.009,6,10,1989,5,910,2.0,642.0,642.0,5,1079,2.0,811.0,811.0
0.005,6,10,2006,5,927,1.0,659.0,659.0,5,1079,1.0,811.0,811.0
0.008,6,12,1926,6,1189,1.0,659.0,434.0,6,737,1.0,417.0,417.0
0.165,6,10,1506,5,395,39.0,127.0,127.0,5,1111,34.0,843.0,843.0
294.699,6,331,344426,122,17890,2435.0,2736.0,825.0,209,326536,1416.0,2804.0,1618.0
10.718,17,26,4102,13,1846,884.0,269.0,114.0,13,2256,884.0,587.0,145.0
0.005,6,13,3747,7,509,0.0,137.0,137.0,6,3238,0.0,1470.0,1459.0
0.083,6,10,1506,5,395,18.0,127.0,127.0,5,1111,17.0,843.0,843.0
0.011,6,10,1989,5,910,2.0,642.0,642.0,5,1079,2.0,811.0,811.0
0.005,6,10,1779,5,928,1.0,660.0,660.0,5,851,1.0,583.0,583.0
0.004,6,10,2007,5,928,1.0,660.0,660.0,5,1079,1.0,811.0,811.0
0.09,6,10,1506,5,395,18.0,127.0,127.0,5,1111,20.0,843.0,843.0
66.209,6,40,10527,20,4929,476.0,1360.0,682.0,20,5598,3475.0,2667.0,435.0
0.095,6,10,1506,5,395,22.0,127.0,127.0,5,1111,20.0,843.0,843.0
0.018,17,2,136,1,60,0.0,32.0,32.0,1,76,0.0,48.0,48.0
0.014,6,10,1677,5,827,3.0,559.0,559.0,5,850,3.0,582.0,582.0
0.008,17,2,148,1,60,0.0,32.0,32.0,1,88,0.0,60.0,60.0
0.008,6,10,1989,5,910,2.0,642.0,642.0,5,1079,1.0,811.0,811.0
0.098,6,10,1506,5,395,22.0,127.0,127.0,5,1111,21.0,843.0,843.0
0.001,17,2,179,1,62,0.0,34.0,34.0,1,117,0.0,89.0,89.0
0.011,6,10,1631,5,848,2.0,580.0,580.0,5,783,2.0,515.0,515.0
0.004,6,10,2006,5,927,1.0,659.0,659.0,5,1079,1.0,811.0,811.0
0.185,17,4,596,2,122,145.0,33.0,33.0,2,474,144.0,323.0,209.0
0.005,17,2,170,1,65,0.0,37.0,37.0,1,105,0.0,77.0,77.0
1756.063,6,105,6240,60,3510,29763.0,26.0,26.0,45,2730,39909.0,26.0,26.0
15.232,17,18,8473,9,6213,1899.0,1350.0,662.0,9,2260,1900.0,1350.0,223.0
0.01,6,13,3735,7,497,1.0,125.0,125.0,6,3238,2.0,1470.0,1459.0
10.811,17,28,4422,14,1994,823.0,269.0,114.0,14,2428,823.0,587.0,145.0
40.066,17,10,676,5,460,10015.0,104.0,64.0,5,216,10015.0,20.0,15.0
0.111,6,10,1506,5,395,25.0,127.0,127.0,5,1111,23.0,843.0,843.0
0.107,6,10,1506,5,395,19.0,127.0,127.0,5,1111,24.0,843.0,843.0
441.738,6,38,6608,18,4896,7258.0,494.0,494.0,20,1712,23249.0,83.0,83.0
0.151,6,10,1506,5,395,36.0,127.0,127.0,5,1111,36.0,843.0,843.0
0.109,6,10,1506,5,395,25.0,127.0,127.0,5,1111,26.0,843.0,843.0
300.351,6,16,2170,9,684,37524.0,146.0,146.0,7,1486,50030.0,419.0,398.0
0.065,6,10,1506,5,395,14.0,127.0,127.0,5,1111,14.0,843.0,843.0
0.134,6,10,1506,5,395,31.0,127.0,127.0,5,1111,29.0,843.0,843.0
0.009,6,10,1972,5,910,2.0,642.0,642.0,5,1062,2.0,794.0,794.0
0.005,17,2,273,1,66,0.0,38.0,38.0,1,207,0.0,179.0,179.0
0.04,17,2,170,1,65,0.0,37.0,37.0,1,105,0.0,77.0,77.0
300.027,6,12,1782,7,1348,50004.0,494.0,494.0,5,434,75005.0,83.0,83.0
0.01,6,10,1762,5,911,2.0,643.0,643.0,5,851,2.0,583.0,583.0
0.006,6,10,2006,5,927,1.0,659.0,659.0,5,1079,1.0,811.0,811.0
0.005,6,10,2006,5,927,1.0,659.0,659.0,5,1079,1.0,811.0,811.0
0.005,17,2,170,1,65,0.0,37.0,37.0,1,105,0.0,77.0,77.0
0.07,6,10,1506,5,395,15.0,127.0,127.0,5,1111,16.0,843.0,843.0
0.004,6,10,2006,5,927,1.0,659.0,659.0,5,1079,1.0,811.0,811.0
0.004,6,10,2000,5,927,1.0,659.0,659.0,5,1073,1.0,805.0,805.0
0.021,6,10,1989,5,910,5.0,642.0,642.0,5,1079,5.0,811.0,811.0
0.018,6,10,1762,5,911,4.0,643.0,643.0,5,851,4.0,583.0,583.0
0.004,17,4,284,2,120,0.0,32.0,32.0,2,164,0.0,60.0,54.0
0.003,17,4,284,2,120,0.0,32.0,32.0,2,164,0.0,60.0,54.0
0.28,17,46,29229,28,26211,10.0,1350.0,908.0,18,3018,13.0,1350.0,139.0
1799.105,17,2931,220575,1461,116910,1232.0,82.0,52.0,1470,103665,1224.0,226.0,42.0
9.036,17,6,376,5,280,2259.0,28.0,28.0,1,96,0.0,68.0,68.0
0.005,17,2,214,1,75,0.0,47.0,47.0,1,139,0.0,111.0,111.0
0.005,6,10,1989,5,927,1.0,659.0,659.0,5,1062,1.0,794.0,794.0
40.078,17,10,676,5,460,10016.0,104.0,64.0,5,216,10018.0,20.0,15.0
0.006,17,2,214,1,75,0.0,47.0,47.0,1,139,0.0,111.0,111.0
0.041,17,2,152,1,76,0.0,48.0,48.0,1,76,0.0,48.0,48.0
0.173,17,2,152,1,76,0.0,48.0,48.0,1,76,0.0,48.0,48.0
1796.346,17,3169,242703,1577,127821,1139.0,84.0,53.0,1592,114882,1128.0,227.0,44.0
0.107,6,10,1506,5,395,24.0,127.0,127.0,5,1111,23.0,843.0,843.0
0.077,6,10,1506,5,395,18.0,127.0,127.0,5,1111,16.0,843.0,843.0
0.006,6,10,1689,5,839,1.0,571.0,571.0,5,850,1.0,582.0,582.0
0.01,17,2,148,1,60,0.0,32.0,32.0,1,88,0.0,60.0,60.0
0.004,17,2,136,1,60,0.0,32.0,32.0,1,76,0.0,48.0,48.0
0.134,6,10,1506,5,395,24.0,127.0,127.0,5,1111,27.0,843.0,843.0
0.088,6,10,1506,5,395,20.0,127.0,127.0,5,1111,20.0,843.0,843.0
0.008,6,12,1926,6,1189,1.0,659.0,434.0,6,737,1.0,417.0,417.0
0.006,6,10,1547,5,764,1.0,496.0,496.0,5,783,1.0,515.0,515.0
291.217,6,332,345078,128,18199,2293.0,2686.0,888.0,204,326879,1434.0,2914.0,1664.0
0.008,6,12,1926,6,1189,1.0,659.0,434.0,6,737,1.0,417.0,417.0
0.013,6,10,1631,5,848,3.0,580.0,580.0,5,783,3.0,515.0,515.0
0.01,6,10,1762,5,911,2.0,643.0,643.0,5,851,2.0,583.0,583.0
0.005,6,10,2006,5,927,1.0,659.0,659.0,5,1079,1.0,811.0,811.0
0.005,17,2,169,1,62,0.0,34.0,34.0,1,107,0.0,79.0,79.0
0.012,6,13,3735,7,497,1.0,125.0,125.0,6,3238,2.0,1470.0,1459.0
40.059,17,10,676,5,460,10013.0,104.0,64.0,5,216,10014.0,20.0,15.0
0.008,6,12,1926,6,1189,1.0,659.0,434.0,6,737,1.0,417.0,417.0
0.115,6,10,1506,5,395,26.0,127.0,127.0,5,1111,17.0,843.0,843.0
0.006,6,10,1689,5,839,1.0,571.0,571.0,5,850,1.0,582.0,582.0
0.006,6,10,1854,5,889,1.0,621.0,621.0,5,965,1.0,697.0,697.0
0.01,6,10,1990,5,911,2.0,643.0,643.0,5,1079,2.0,811.0,811.0
0.125,6,10,1506,5,395,26.0,127.0,127.0,5,1111,29.0,843.0,843.0
0.005,6,10,1989,5,927,1.0,659.0,659.0,5,1062,1.0,794.0,794.0
0.006,17,2,193,1,71,0.0,43.0,43.0,1,122,0.0,94.0,94.0
0.127,6,10,1506,5,395,30.0,127.0,127.0,5,1111,28.0,843.0,843.0
0.131,6,10,1506,5,395,29.0,127.0,127.0,5,1111,27.0,843.0,843.0
0.08,6,10,1506,5,395,17.0,127.0,127.0,5,1111,17.0,843.0,843.0
0.106,6,10,1506,5,395,24.0,127.0,127.0,5,1111,22.0,843.0,843.0
10.995,17,28,4398,14,2311,836.0,586.0,137.0,14,2087,836.0,270.0,121.0
0.118,6,10,1506,5,395,26.0,127.0,127.0,5,1111,24.0,843.0,843.0
0.02,6,10,1762,5,911,4.0,643.0,643.0,5,851,4.0,583.0,583.0
0.066,6,10,1506,5,395,13.0,127.0,127.0,5,1111,13.0,843.0,843.0
0.013,6,13,3735,7,497,2.0,125.0,125.0,6,3238,2.0,1470.0,1459.0
11.182,17,28,4422,14,1994,847.0,269.0,114.0,14,2428,847.0,587.0,145.0
0.011,6,13,3735,7,497,1.0,125.0,125.0,6,3238,2.0,1470.0,1459.0
0.011,6,10,1989,5,910,2.0,642.0,642.0,5,1079,2.0,811.0,811.0
0.015,6,10,1990,5,911,3.0,643.0,643.0,5,1079,3.0,811.0,811.0
10.783,17,28,4422,14,1994,820.0,269.0,114.0,14,2428,820.0,587.0,145.0
0.099,6,10,1506,5,395,20.0,127.0,127.0,5,1111,21.0,843.0,843.0
0.005,6,10,2006,5,927,1.0,659.0,659.0,5,1079,1.0,811.0,811.0
40.064,17,10,676,5,460,10012.0,104.0,64.0,5,216,10015.0,20.0,15.0
0.01,6,10,1989,5,910,2.0,642.0,642.0,5,1079,2.0,811.0,811.0
0.101,6,10,1506,5,395,20.0,127.0,127.0,5,1111,22.0,843.0,843.0
0.037,17,2,182,1,65,0.0,37.0,37.0,1,117,0.0,89.0,89.0
0.005,6,10,2007,5,928,1.0,660.0,660.0,5,1079,1.0,811.0,811.0
0.082,6,10,1506,5,395,19.0,127.0,127.0,5,1111,18.0,843.0,843.0
0.17,17,4,596,2,122,98.0,33.0,33.0,2,474,131.0,323.0,209.0
0.005,6,10,2006,5,927,1.0,659.0,659.0,5,1079,1.0,811.0,811.0
0.005,6,10,2000,5,927,1.0,659.0,659.0,5,1073,1.0,805.0,805.0
0.003,17,2,152,1,76,0.0,48.0,48.0,1,76,0.0,48.0,48.0
10.744,17,28,4421,14,1993,818.0,268.0,114.0,14,2428,817.0,587.0,145.0
0.066,6,10,1506,5,395,15.0,127.0,127.0,5,1111,16.0,843.0,843.0
0.091,6,10,1506,5,395,19.0,127.0,127.0,5,1111,21.0,843.0,843.0
0.133,17,2,80,1,32,0.0,4.0,4.0,1,48,0.0,20.0,20.0
0.007,6,10,1689,5,839,1.0,571.0,571.0,5,850,1.0,582.0,582.0
0.072,17,2,136,1,60,0.0,32.0,32.0,1,76,0.0,48.0,48.0
312.176,17,18,1008,9,640,39006.0,48.0,43.0,9,368,39004.0,20.0,12.0
309.772,17,20,1124,10,716,34404.0,48.0,43.0,10,408,34404.0,20.0,12.0
0.01,6,10,1989,5,910,2.0,642.0,642.0,5,1079,2.0,811.0,811.0
40.062,17,10,676,5,460,10014.0,104.0,64.0,5,216,10014.0,20.0,15.0
0.015,6,10,1989,5,910,3.0,642.0,642.0,5,1079,3.0,811.0,811.0
0.013,6,10,1605,5,388,3.0,120.0,120.0,5,1217,3.0,949.0,949.0
0.006,17,2,169,1,62,0.0,34.0,34.0,1,107,0.0,79.0,79.0
1734.225,6,64,7344,42,4469,42298.0,1625.0,108.0,22,2875,82574.0,1111.0,82.0
0.001,17,2,180,1,66,0.0,38.0,38.0,1,114,0.0,86.0,86.0
0.009,6,12,1926,6,1189,1.0,659.0,434.0,6,737,1.0,417.0,417.0
0.005,17,2,144,1,64,0.0,36.0,36.0,1,80,0.0,52.0,52.0
40.073,17,10,676,5,460,10017.0,104.0,64.0,5,216,10017.0,20.0,15.0
0.001,17,2,180,1,66,0.0,38.0,38.0,1,114,0.0,86.0,86.0
0.041,17,2,152,1,76,0.0,48.0,48.0,1,76,0.0,48.0,48.0
1790.733,17,2872,218952,1426,115612,1256.0,84.0,53.0,1446,103340,1239.0,225.0,43.0
0.011,6,12,1698,6,863,2.0,327.0,271.0,6,835,2.0,515.0,515.0
40.078,17,10,676,5,460,10018.0,104.0,64.0,5,216,10018.0,20.0,15.0
0.006,6,10,1854,5,889,1.0,621.0,621.0,5,965,1.0,697.0,697.0
0.014,6,10,1990,5,911,3.0,643.0,643.0,5,1079,3.0,811.0,811.0
40.058,17,10,676,5,460,10013.0,104.0,64.0,5,216,10013.0,20.0,15.0
0.017,6,10,1989,5,910,4.0,642.0,642.0,5,1079,4.0,811.0,811.0
0.014,6,10,1677,5,827,3.0,559.0,559.0,5,850,3.0,582.0,582.0
0.213,6,16,2778,8,1396,30.0,533.0,324.0,8,1382,19.0,529.0,239.0
0.005,6,10,1689,5,839,1.0,571.0,571.0,5,850,1.0,582.0,582.0
0.014,6,10,1989,5,910,3.0,642.0,642.0,5,1079,3.0,811.0,811.0
0.004,17,2,144,1,64,0.0,36.0,36.0,1,80,0.0,52.0,52.0
48.642,6,36,8190,19,1759,2702.0,651.0,322.0,17,6431,547.0,2126.0,478.0
0.063,6,10,1506,5,395,14.0,127.0,127.0,5,1111,14.0,843.0,843.0
40.055,17,10,676,5,460,10012.0,104.0,64.0,5,216,10012.0,20.0,15.0
40.062,17,10,676,5,460,10012.0,104.0,64.0,5,216,10014.0,20.0,15.0
0.01,6,10,1989,5,910,2.0,642.0,642.0,5,1079,2.0,811.0,811.0
0.013,17,2,152,1,56,0.0,28.0,28.0,1,96,0.0,68.0,68.0
0.132,17,2,156,1,64,0.0,36.0,36.0,1,92,0.0,64.0,64.0
0.072,6,10,1506,5,395,15.0,127.0,127.0,5,1111,16.0,843.0,843.0
0.005,6,10,2006,5,927,1.0,659.0,659.0,5,1079,1.0,811.0,811.0
1.208,6,32,13391,18,5892,71.0,2720.0,854.0,14,7499,80.0,2720.0,769.0
240.934,6,35,7039,17,2504,15056.0,555.0,268.0,18,4535,14170.0,1214.0,327.0
0.08,6,10,1506,5,395,16.0,127.0,127.0,5,1111,17.0,843.0,843.0
0.01,6,10,1989,5,910,2.0,642.0,642.0,5,1079,2.0,811.0,811.0
0.001,17,2,179,1,62,0.0,34.0,34.0,1,117,0.0,89.0,89.0
0.006,6,10,1689,5,839,1.0,571.0,571.0,5,850,1.0,582.0,582.0
0.017,6,10,1990,5,911,4.0,643.0,643.0,5,1079,4.0,811.0,811.0
0.009,6,10,1631,5,848,2.0,580.0,580.0,5,783,2.0,515.0,515.0
0.019,6,13,3735,7,497,3.0,125.0,125.0,6,3238,3.0,1470.0,1459.0
0.006,6,10,1547,5,764,1.0,496.0,496.0,5,783,1.0,515.0,515.0
0.009,6,10,1677,5,827,2.0,559.0,559.0,5,850,2.0,582.0,582.0
0.005,6,10,1989,5,927,1.0,659.0,659.0,5,1062,1.0,794.0,794.0
0.136,6,10,1506,5,395,32.0,127.0,127.0,5,1111,33.0,843.0,843.0
0.005,17,2,180,1,66,0.0,38.0,38.0,1,114,0.0,86.0,86.0
0.005,6,10,2006,5,927,1.0,659.0,659.0,5,1079,1.0,811.0,811.0
0.006,6,10,2006,5,927,1.0,659.0,659.0,5,1079,1.0,811.0,811.0
0.04,17,4,284,2,120,0.0,32.0,32.0,2,164,36.0,60.0,54.0
0.001,17,2,164,1,74,0.0,46.0,46.0,1,90,0.0,62.0,62.0
40.053,17,10,676,5,460,10012.0,104.0,64.0,5,216,10012.0,20.0,15.0
0.003,17,2,136,1,60,0.0,32.0,32.0,1,76,0.0,48.0,48.0
0.072,6,10,1506,5,395,17.0,127.0,127.0,5,1111,16.0,843.0,843.0
1778.125,17,144,45504,72,22752,25043.0,288.0,288.0,72,22752,25043.0,288.0,288.0
0.095,6,10,1506,5,395,21.0,127.0,127.0,5,1111,21.0,843.0,843.0
0.108,6,10,1506,5,395,18.0,127.0,127.0,5,1111,25.0,843.0,843.0
0.037,17,2,152,1,76,0.0,48.0,48.0,1,76,0.0,48.0,48.0
0.004,6,10,1702,5,863,1.0,595.0,595.0,5,839,1.0,571.0,571.0
40.083,17,10,676,5,460,10019.0,104.0,64.0,5,216,10020.0,20.0,15.0
0.042,17,2,136,1,60,0.0,32.0,32.0,1,76,0.0,48.0,48.0
0.076,6,10,1506,5,395,16.0,127.0,127.0,5,1111,15.0,843.0,843.0
0.004,17,4,284,2,120,1.0,32.0,32.0,2,164,0.0,60.0,54.0
0.009,6,10,1990,5,911,2.0,643.0,643.0,5,1079,2.0,811.0,811.0
0.116,6,10,1506,5,395,28.0,127.0,127.0,5,1111,26.0,843.0,843.0
0.004,6,10,2006,5,927,1.0,659.0,659.0,5,1079,1.0,811.0,811.0
1787.651,6,154,19574,92,13852,19644.0,302.0,302.0,62,5722,29305.0,83.0,83.0
0.01,6,10,1989,5,910,2.0,642.0,642.0,5,1079,2.0,811.0,811.0
0.092,6,10,1506,5,395,19.0,127.0,127.0,5,1111,21.0,843.0,843.0
0.008,6,10,1989,5,910,1.0,642.0,642.0,5,1079,2.0,811.0,811.0
0.004,6,10,1989,5,927,1.0,659.0,659.0,5,1062,1.0,794.0,794.0
1729.221,6,60,4400,40,2740,44339.0,33.0,33.0,20,1660,91002.0,31.0,31.0
1729.241,6,60,4400,40,2740,44339.0,33.0,33.0,20,1660,91003.0,31.0,31.0
40.06,17,10,676,5,460,10014.0,104.0,64.0,5,216,10014.0,20.0,15.0
0.117,6,10,1506,5,395,26.0,127.0,127.0,5,1111,28.0,843.0,843.0
0.015,6,10,1983,5,910,3.0,642.0,642.0,5,1073,3.0,805.0,805.0
0.039,17,2,136,1,60,0.0,32.0,32.0,1,76,0.0,48.0,48.0
361.753,6,21,1793,16,1030,24116.0,190.0,190.0,5,763,60009.0,462.0,247.0
0.016,6,10,1972,5,910,3.0,642.0,642.0,5,1062,3.0,794.0,794.0
0.01,6,10,1990,5,911,2.0,643.0,643.0,5,1079,2.0,811.0,811.0
0.005,17,2,185,1,73,0.0,45.0,45.0,1,112,0.0,84.0,84.0
0.006,6,10,1689,5,839,1.0,571.0,571.0,5,850,1.0,582.0,582.0
310.889,6,33,12151,18,2671,18287.0,585.0,345.0,15,9480,17917.0,1402.0,965.0
0.005,6,10,2006,5,927,1.0,659.0,659.0,5,1079,1.0,811.0,811.0
0.013,6,10,1989,5,910,3.0,642.0,642.0,5,1079,3.0,811.0,811.0
352.006,6,20,2210,6,1308,12003.0,494.0,494.0,14,902,27077.0,83.0,83.0
0.006,6,10,1547,5,764,1.0,496.0,496.0,5,783,1.0,515.0,515.0
0.006,6,10,1547,5,764,1.0,496.0,496.0,5,783,1.0,515.0,515.0
0.005,6,10,2007,5,928,1.0,660.0,660.0,5,1079,1.0,811.0,811.0
0.138,17,2,80,1,32,0.0,4.0,4.0,1,48,0.0,20.0,20.0
0.005,6,10,1689,5,839,1.0,571.0,571.0,5,850,1.0,582.0,582.0
300.346,6,16,2170,9,684,37522.0,146.0,146.0,7,1486,50029.0,419.0,398.0
40.072,17,10,676,5,460,10017.0,104.0,64.0,5,216,10016.0,20.0,15.0
0.01,6,10,1972,5,910,2.0,642.0,642.0,5,1062,2.0,794.0,794.0
0.006,6,10,1689,5,839,1.0,571.0,571.0,5,850,1.0,582.0,582.0
0.009,6,13,3735,7,497,1.0,125.0,125.0,6,3238,1.0,1470.0,1459.0
0.004,17,2,148,1,60,0.0,32.0,32.0,1,88,0.0,60.0,60.0
9.039,17,6,376,5,280,2259.0,28.0,28.0,1,96,0.0,68.0,68.0
0.071,17,2,128,1,56,0.0,28.0,28.0,1,72,0.0,44.0,44.0
0.009,6,10,1989,5,910,2.0,642.0,642.0,5,1079,2.0,811.0,811.0
0.076,6,10,1506,5,395,16.0,127.0,127.0,5,1111,16.0,843.0,843.0
0.112,6,10,1506,5,395,26.0,127.0,127.0,5,1111,23.0,843.0,843.0
0.004,17,2,148,1,60,0.0,32.0,32.0,1,88,0.0,60.0,60.0
0.005,6,10,1989,5,927,1.0,659.0,659.0,5,1062,1.0,794.0,794.0
0.01,6,10,1972,5,910,2.0,642.0,642.0,5,1062,2.0,794.0,794.0
0.004,17,2,140,1,62,0.0,34.0,34.0,1,78,0.0,50.0,50.0
0.005,6,14,3742,7,452,0.0,80.0,80.0,7,3290,0.0,1448.0,972.0
0.004,17,2,136,1,60,0.0,32.0,32.0,1,76,0.0,48.0,48.0
0.016,6,10,1972,5,910,4.0,642.0,642.0,5,1062,4.0,794.0,794.0
10.813,17,26,4101,13,1821,892.0,268.0,112.0,13,2280,892.0,587.0,147.0
0.034,6,10,1989,5,910,8.0,642.0,642.0,5,1079,8.0,811.0,811.0
0.004,17,4,284,2,120,0.0,32.0,32.0,2,164,1.0,60.0,54.0
413.32,6,29,4409,12,3102,10911.0,494.0,494.0,17,1307,25832.0,83.0,83.0
178.674,17,72,10240,36,2393,5104.0,44.0,38.0,36,7847,5104.0,239.0,189.0
0.205,6,16,2778,8,1396,29.0,533.0,324.0,8,1382,18.0,529.0,239.0
308.454,17,20,1124,10,716,34258.0,48.0,43.0,10,408,34259.0,20.0,12.0
0.005,6,10,2007,5,928,1.0,660.0,660.0,5,1079,1.0,811.0,811.0
0.131,6,10,1506,5,395,31.0,127.0,127.0,5,1111,28.0,843.0,843.0
0.077,6,44,13975,24,2503,3.0,517.0,139.0,20,11472,3.0,1402.0,744.0
300.33,6,16,2170,9,684,37520.0,146.0,146.0,7,1486,50027.0,419.0,398.0
0.002,17,2,180,1,66,0.0,38.0,38.0,1,114,0.0,86.0,86.0
0.121,6,10,1506,5,395,25.0,127.0,127.0,5,1111,28.0,843.0,843.0
0.005,6,10,2006,5,927,1.0,659.0,659.0,5,1079,1.0,811.0,811.0
0.832,6,10,1708,6,1354,166.0,1102.0,1102.0,4,354,197.0,182.0,182.0
0.013,17,2,152,1,56,0.0,28.0,28.0,1,96,0.0,68.0,68.0
0.007,6,10,1990,5,911,1.0,643.0,643.0,5,1079,1.0,811.0,811.0
0.001,17,2,180,1,65,0.0,37.0,37.0,1,115,0.0,87.0,87.0
0.004,6,10,1702,5,863,1.0,595.0,595.0,5,839,0.0,571.0,571.0
0.006,6,10,1689,5,839,1.0,571.0,571.0,5,850,1.0,582.0,582.0
0.008,6,10,1774,5,923,2.0,655.0,655.0,5,851,1.0,583.0,583.0
0.005,17,2,214,1,75,0.0,47.0,47.0,1,139,0.0,111.0,111.0
0.014,6,14,3787,7,497,2.0,125.0,125.0,7,3290,2.0,1448.0,972.0
308.733,17,20,1124,10,716,34290.0,48.0,43.0,10,408,34292.0,20.0,12.0
0.004,17,2,148,1,60,0.0,32.0,32.0,1,88,0.0,60.0,60.0
0.004,6,10,1779,5,928,1.0,660.0,660.0,5,851,1.0,583.0,583.0
0.009,6,10,1972,5,910,2.0,642.0,642.0,5,1062,2.0,794.0,794.0
0.005,6,10,1854,5,889,1.0,621.0,621.0,5,965,1.0,697.0,697.0
0.007,17,2,212,1,74,0.0,46.0,46.0,1,138,0.0,110.0,110.0
0.005,6,10,2007,5,928,1.0,660.0,660.0,5,1079,1.0,811.0,811.0
0.005,6,10,2000,5,927,1.0,659.0,659.0,5,1073,1.0,805.0,805.0
0.006,6,10,1547,5,764,1.0,496.0,496.0,5,783,1.0,515.0,515.0
494.04,6,59,11739,32,9082,6479.0,494.0,494.0,27,2657,19001.0,83.0,83.0
0.006,17,2,179,1,71,0.0,43.0,43.0,1,108,0.0,80.0,80.0
0.004,17,2,136,1,60,0.0,32.0,32.0,1,76,0.0,48.0,48.0
0.042,17,2,182,1,65,0.0,37.0,37.0,1,117,0.0,89.0,89.0
0.005,6,10,1989,5,927,1.0,659.0,659.0,5,1062,1.0,794.0,794.0
0.003,17,4,284,2,120,0.0,32.0,32.0,2,164,0.0,60.0,54.0
0.013,6,10,1983,5,910,3.0,642.0,642.0,5,1073,3.0,805.0,805.0
40.091,17,10,676,5,460,10011.0,104.0,64.0,5,216,10020.0,20.0,15.0
10.762,17,28,4418,14,1994,819.0,269.0,114.0,14,2424,819.0,587.0,145.0
0.01,17,4,284,2,120,6.0,32.0,32.0,2,164,7.0,60.0,54.0
0.01,6,12,1926,6,1189,2.0,659.0,434.0,6,737,2.0,417.0,417.0
240.01,6,9,787,5,488,60002.0,232.0,232.0,4,299,80002.0,83.0,83.0
308.762,17,20,1124,10,716,34300.0,48.0,43.0,10,408,34300.0,20.0,12.0
0.082,6,10,1506,5,395,17.0,127.0,127.0,5,1111,17.0,843.0,843.0
0.134,6,10,1506,5,395,29.0,127.0,127.0,5,1111,31.0,843.0,843.0
0.017,6,10,1972,5,910,4.0,642.0,642.0,5,1062,4.0,794.0,794.0
240.467,6,35,8923,18,2072,14144.0,693.0,225.0,17,6851,15028.0,1402.0,597.0
0.174,17,2,152,1,76,0.0,48.0,48.0,1,76,0.0,48.0,48.0
40.061,17,10,676,5,460,10013.0,104.0,64.0,5,216,10014.0,20.0,15.0
0.011,6,10,1989,5,910,2.0,642.0,642.0,5,1079,2.0,811.0,811.0
0.018,6,10,1983,5,910,4.0,642.0,642.0,5,1073,4.0,805.0,805.0
0.012,6,10,1972,5,910,3.0,642.0,642.0,5,1062,3.0,794.0,794.0
40.064,17,10,676,5,460,10012.0,104.0,64.0,5,216,10015.0,20.0,15.0
0.105,6,10,1506,5,395,23.0,127.0,127.0,5,1111,23.0,843.0,843.0
300.414,6,29,8749,14,2477,23108.0,1225.0,348.0,15,6272,21457.0,1591.0,610.0
0.001,17,2,136,1,60,0.0,32.0,32.0,1,76,0.0,48.0,48.0
0.127,6,10,1506,5,395,27.0,127.0,127.0,5,1111,27.0,843.0,843.0
0.009,6,10,1983,5,910,2.0,642.0,642.0,5,1073,2.0,805.0,805.0
0.005,6,10,2006,5,927,1.0,659.0,659.0,5,1079,1.0,811.0,811.0
0.008,6,10,2006,5,927,2.0,659.0,659.0,5,1079,2.0,811.0,811.0
0.005,17,2,144,1,64,0.0,36.0,36.0,1,80,0.0,52.0,52.0
0.006,6,10,1547,5,764,1.0,496.0,496.0,5,783,1.0,515.0,515.0
0.112,6,10,1506,5,395,24.0,127.0,127.0,5,1111,26.0,843.0,843.0
0.009,6,12,1926,6,1189,1.0,659.0,434.0,6,737,1.0,417.0,417.0
0.009,6,10,1983,5,910,2.0,642.0,642.0,5,1073,2.0,805.0,805.0
240.458,6,35,8926,18,2073,14144.0,694.0,225.0,17,6853,15028.0,1402.0,597.0
0.001,17,2,180,1,66,0.0,38.0,38.0,1,114,0.0,86.0,86.0
265.003,6,406,348847,199,21912,1338.0,2736.0,888.0,207,326935,1286.0,2914.0,1638.0
0.004,17,4,284,2,120,0.0,32.0,32.0,2,164,0.0,60.0,54.0
0.013,6,10,1990,5,911,3.0,643.0,643.0,5,1079,3.0,811.0,811.0
0.003,17,2,136,1,60,0.0,32.0,32.0,1,76,0.0,48.0,48.0
0.094,6,10,1506,5,395,20.0,127.0,127.0,5,1111,20.0,843.0,843.0
0.04,17,2,412,1,61,0.0,33.0,33.0,1,351,0.0,323.0,323.0
0.008,6,12,1926,6,1189,1.0,659.0,434.0,6,737,1.0,417.0,417.0
0.008,6,10,1989,5,910,2.0,642.0,642.0,5,1079,1.0,811.0,811.0
240.019,6,9,787,5,488,60004.0,232.0,232.0,4,299,80005.0,83.0,83.0
300.416,6,16,2170,9,684,37529.0,146.0,146.0,7,1486,50041.0,419.0,398.0
0.074,6,10,1506,5,395,16.0,127.0,127.0,5,1111,16.0,843.0,843.0
1795.54,6,547,190571,276,163707,6529.0,2883.0,910.0,271,26864,6650.0,580.0,123.0
0.001,17,2,180,1,66,0.0,38.0,38.0,1,114,0.0,86.0,86.0
40.059,17,10,676,5,460,10013.0,104.0,64.0,5,216,10013.0,20.0,15.0
0.015,6,10,1762,5,911,3.0,643.0,643.0,5,851,3.0,583.0,583.0
0.131,6,10,1506,5,395,27.0,127.0,127.0,5,1111,28.0,843.0,843.0
0.001,17,2,142,1,63,0.0,35.0,35.0,1,79,0.0,51.0,51.0
15.074,17,16,10616,9,8280,1880.0,1350.0,892.0,7,2336,2509.0,1350.0,305.0
0.009,6,10,1983,5,910,2.0,642.0,642.0,5,1073,2.0,805.0,805.0
0.004,6,10,1779,5,928,1.0,660.0,660.0,5,851,1.0,583.0,583.0
0.008,6,10,1702,5,863,2.0,595.0,595.0,5,839,1.0,571.0,571.0
0.007,6,10,1983,5,910,1.0,642.0,642.0,5,1073,1.0,805.0,805.0
0.163,17,2,152,1,76,0.0,48.0,48.0,1,76,0.0,48.0,48.0
0.014,6,10,1983,5,910,3.0,642.0,642.0,5,1073,3.0,805.0,805.0
1786.603,6,151,19402,90,13740,20074.0,302.0,302.0,61,5662,29776.0,83.0,83.0
0.005,6,10,2007,5,928,1.0,660.0,660.0,5,1079,1.0,811.0,811.0
0.019,6,10,1983,5,910,4.0,642.0,642.0,5,1073,4.0,805.0,805.0
0.011,6,10,1989,5,910,2.0,642.0,642.0,5,1079,2.0,811.0,811.0
0.006,6,10,1689,5,839,1.0,571.0,571.0,5,850,1.0,582.0,582.0
0.005,17,2,164,1,74,0.0,46.0,46.0,1,90,0.0,62.0,62.0
1756.065,6,105,6240,60,3510,29763.0,26.0,26.0,45,2730,39909.0,26.0,26.0
0.009,6,13,3735,7,497,1.0,125.0,125.0,6,3238,1.0,1470.0,1459.0
0.006,6,10,1547,5,764,1.0,496.0,496.0,5,783,1.0,515.0,515.0
0.006,17,2,132,1,58,0.0,30.0,30.0,1,74,0.0,46.0,46.0
0.005,6,10,2007,5,928,1.0,660.0,660.0,5,1079,1.0,811.0,811.0
0.093,6,10,1506,5,395,21.0,127.0,127.0,5,1111,18.0,843.0,843.0
0.446,17,64,45403,39,39095,11.0,1350.0,974.0,25,6308,16.0,1350.0,224.0
0.107,6,10,1506,5,395,23.0,127.0,127.0,5,1111,20.0,843.0,843.0
0.017,6,10,1989,5,910,4.0,642.0,642.0,5,1079,4.0,811.0,811.0
0.005,6,10,2000,5,927,1.0,659.0,659.0,5,1073,1.0,805.0,805.0
0.072,17,2,136,1,60,0.0,32.0,32.0,1,76,0.0,48.0,48.0
0.008,17,2,194,1,59,0.0,31.0,31.0,1,135,0.0,107.0,107.0
0.009,17,2,194,1,59,0.0,31.0,31.0,1,135,0.0,107.0,107.0
0.006,6,10,1547,5,764,1.0,496.0,496.0,5,783,1.0,515.0,515.0
0.173,6,23,6535,12,2065,14.0,746.0,286.0,11,4470,16.0,1324.0,778.0
0.072,17,4,352,2,130,0.0,37.0,37.0,2,222,68.0,89.0,83.0
0.015,6,10,1990,5,911,3.0,643.0,643.0,5,1079,3.0,811.0,811.0
0.0,17,2,180,1,66,0.0,38.0,38.0,1,114,0.0,86.0,86.0
15.173,17,20,11465,10,7724,1682.0,1350.0,744.0,10,3741,1682.0,1350.0,346.0
0.011,17,2,136,1,60,0.0,32.0,32.0,1,76,0.0,48.0,48.0
0.004,17,2,148,1,60,0.0,32.0,32.0,1,88,0.0,60.0,60.0
0.098,6,10,1506,5,395,20.0,127.0,127.0,5,1111,21.0,843.0,843.0
0.069,6,10,1506,5,395,15.0,127.0,127.0,5,1111,14.0,843.0,843.0
0.012,6,10,1989,5,910,3.0,642.0,642.0,5,1079,2.0,811.0,811.0
178.161,17,90,12665,45,3030,4049.0,44.0,39.0,45,9635,4049.0,239.0,186.0
0.055,6,10,1506,5,395,12.0,127.0,127.0,5,1111,12.0,843.0,843.0
168.011,17,86,12277,43,2878,4000.0,44.0,38.0,43,9399,4000.0,279.0,190.0
0.016,6,10,1990,5,911,4.0,643.0,643.0,5,1079,4.0,811.0,811.0
0.108,6,10,1506,5,395,25.0,127.0,127.0,5,1111,24.0,843.0,843.0
0.005,6,13,3690,7,452,0.0,80.0,80.0,6,3238,1.0,1470.0,1459.0
0.036,17,2,136,1,60,0.0,32.0,32.0,1,76,0.0,48.0,48.0
0.004,6,10,1989,5,927,1.0,659.0,659.0,5,1062,1.0,794.0,794.0
0.005,6,10,1547,5,764,1.0,496.0,496.0,5,783,1.0,515.0,515.0
0.009,6,10,1677,5,827,2.0,559.0,559.0,5,850,2.0,582.0,582.0
0.02,6,10,1989,5,910,5.0,642.0,642.0,5,1079,4.0,811.0,811.0
361.834,6,19,1689,15,978,25845.0,190.0,190.0,4,711,80012.0,495.0,495.0
15.093,17,15,8129,8,6046,2152.0,1350.0,727.0,7,2083,2510.0,1350.0,269.0
0.004,17,4,284,2,120,1.0,32.0,32.0,2,164,0.0,60.0,54.0
0.017,6,12,1926,6,1189,3.0,659.0,434.0,6,737,3.0,417.0,417.0
0.012,6,10,1983,5,910,2.0,642.0,642.0,5,1073,2.0,805.0,805.0
0.001,17,2,180,1,66,0.0,38.0,38.0,1,114,0.0,86.0,86.0
0.168,17,2,152,1,76,0.0,48.0,48.0,1,76,0.0,48.0,48.0
0.005,6,10,1774,5,923,1.0,655.0,655.0,5,851,1.0,583.0,583.0
0.008,17,2,194,1,59,0.0,31.0,31.0,1,135,0.0,107.0,107.0
0.005,6,10,1689,5,839,1.0,571.0,571.0,5,850,1.0,582.0,582.0
0.098,6,10,1506,5,395,20.0,127.0,127.0,5,1111,22.0,843.0,843.0
0.112,6,10,1506,5,395,25.0,127.0,127.0,5,1111,25.0,843.0,843.0
0.005,6,10,2000,5,927,1.0,659.0,659.0,5,1073,1.0,805.0,805.0
0.008,6,10,1677,5,827,2.0,559.0,559.0,5,850,1.0,582.0,582.0
40.053,17,10,676,5,460,10011.0,104.0,64.0,5,216,10011.0,20.0,15.0
0.015,6,11,2041,6,962,3.0,642.0,642.0,5,1079,3.0,811.0,811.0
0.005,6,13,3690,7,452,0.0,80.0,80.0,6,3238,1.0,1470.0,1459.0
0.01,6,10,1972,5,910,2.0,642.0,642.0,5,1062,2.0,794.0,794.0
0.005,6,10,1643,5,860,1.0,592.0,592.0,5,783,1.0,515.0,515.0
0.005,6,10,2006,5,927,1.0,659.0,659.0,5,1079,1.0,811.0,811.0
0.089,6,10,1506,5,395,18.0,127.0,127.0,5,1111,19.0,843.0,843.0
0.079,6,10,1506,5,395,17.0,127.0,127.0,5,1111,15.0,843.0,843.0
0.009,6,10,1762,5,911,2.0,643.0,643.0,5,851,2.0,583.0,583.0
281.974,6,25,6480,11,1226,28197.0,267.0,156.0,14,5254,21684.0,1400.0,781.0
0.006,6,10,1547,5,764,1.0,496.0,496.0,5,783,1.0,515.0,515.0
0.039,17,2,148,1,60,0.0,32.0,32.0,1,88,0.0,60.0,60.0
0.22,6,16,2777,8,1395,31.0,533.0,323.0,8,1382,20.0,529.0,239.0
0.012,6,10,1631,5,848,3.0,580.0,580.0,5,783,2.0,515.0,515.0
0.001,17,2,136,1,60,0.0,32.0,32.0,1,76,0.0,48.0,48.0
0.01,6,12,1926,6,1189,1.0,659.0,434.0,6,737,1.0,417.0,417.0
0.005,6,10,2006,5,927,1.0,659.0,659.0,5,1079,1.0,811.0,811.0
0.011,6,10,1990,5,911,2.0,643.0,643.0,5,1079,2.0,811.0,811.0
240.078,6,16,4480,9,963,30009.0,238.0,166.0,7,3517,40012.0,1402.0,786.0
0.008,6,12,1926,6,1189,1.0,659.0,434.0,6,737,1.0,417.0,417.0
0.092,6,10,1506,5,395,21.0,127.0,127.0,5,1111,22.0,843.0,843.0
0.018,6,10,1983,5,910,4.0,642.0,642.0,5,1073,4.0,805.0,805.0
0.151,6,10,1506,5,395,35.0,127.0,127.0,5,1111,34.0,843.0,843.0
165.072,17,74,10631,37,2482,4585.0,44.0,39.0,37,8149,4584.0,239.0,192.0
9.037,17,6,376,5,280,2259.0,28.0,28.0,1,96,0.0,68.0,68.0
0.001,17,2,180,1,66,0.0,38.0,38.0,1,114,0.0,86.0,86.0
175.26,17,72,10300,36,2403,5007.0,44.0,38.0,36,7897,5007.0,239.0,191.0
0.005,6,10,1689,5,839,1.0,571.0,571.0,5,850,1.0,582.0,582.0
0.092,6,10,1506,5,395,21.0,127.0,127.0,5,1111,21.0,843.0,843.0
0.005,17,2,179,1,71,0.0,43.0,43.0,1,108,0.0,80.0,80.0
0.006,6,12,1698,6,863,1.0,327.0,271.0,6,835,1.0,515.0,515.0
0.001,17,2,154,1,69,0.0,41.0,41.0,1,85,0.0,57.0,57.0
240.095,6,31,9308,15,6914,17149.0,2036.0,682.0,16,2394,16006.0,580.0,194.0
0.133,6,10,1506,5,395,28.0,127.0,127.0,5,1111,30.0,843.0,843.0
0.013,6,10,1677,5,827,3.0,559.0,559.0,5,850,3.0,582.0,582.0
0.004,6,10,2006,5,927,1.0,659.0,659.0,5,1079,1.0,811.0,811.0
0.01,6,10,1989,5,910,2.0,642.0,642.0,5,1079,2.0,811.0,811.0
0.001,17,2,180,1,66,0.0,38.0,38.0,1,114,0.0,86.0,86.0
0.012,6,10,1990,5,911,2.0,643.0,643.0,5,1079,3.0,811.0,811.0
0.005,17,2,179,1,71,0.0,43.0,43.0,1,108,0.0,80.0,80.0
353.471,6,20,2210,6,1308,12004.0,494.0,494.0,14,902,27189.0,83.0,83.0
0.005,6,10,1689,5,839,1.0,571.0,571.0,5,850,1.0,582.0,582.0
0.006,6,10,1547,5,764,1.0,496.0,496.0,5,783,1.0,515.0,515.0
0.004,6,10,1989,5,927,1.0,659.0,659.0,5,1062,1.0,794.0,794.0
0.111,6,10,1506,5,395,22.0,127.0,127.0,5,1111,21.0,843.0,843.0
0.005,6,10,1774,5,923,1.0,655.0,655.0,5,851,1.0,583.0,583.0
0.004,6,10,1989,5,927,1.0,659.0,659.0,5,1062,1.0,794.0,794.0
40.09,17,10,676,5,460,10019.0,104.0,64.0,5,216,10021.0,20.0,15.0
0.011,17,2,162,1,65,0.0,37.0,37.0,1,97,0.0,69.0,69.0
0.006,6,10,1547,5,764,1.0,496.0,496.0,5,783,1.0,515.0,515.0
0.005,6,10,1547,5,764,1.0,496.0,496.0,5,783,1.0,515.0,515.0
1.072,6,33,13432,18,5893,63.0,2720.0,854.0,15,7539,64.0,2720.0,769.0
0.01,17,2,164,1,74,0.0,46.0,46.0,1,90,0.0,62.0,62.0
0.088,6,10,1506,5,395,20.0,127.0,127.0,5,1111,19.0,843.0,843.0
0.003,17,2,148,1,60,0.0,32.0,32.0,1,88,0.0,60.0,60.0
0.021,6,10,1990,5,911,5.0,643.0,643.0,5,1079,5.0,811.0,811.0
0.003,17,2,136,1,60,0.0,32.0,32.0,1,76,0.0,48.0,48.0
0.005,6,10,2006,5,927,1.0,659.0,659.0,5,1079,1.0,811.0,811.0
0.012,6,10,1990,5,911,3.0,643.0,643.0,5,1079,2.0,811.0,811.0
0.004,6,10,2000,5,927,1.0,659.0,659.0,5,1073,1.0,805.0,805.0
40.07,17,10,676,5,460,10012.0,104.0,64.0,5,216,10012.0,20.0,15.0
0.005,6,10,2000,5,927,1.0,659.0,659.0,5,1073,1.0,805.0,805.0
0.131,6,10,1506,5,395,32.0,127.0,127.0,5,1111,29.0,843.0,843.0
0.003,17,2,148,1,60,0.0,32.0,32.0,1,88,0.0,60.0,60.0
0.004,6,10,2006,5,927,1.0,659.0,659.0,5,1079,1.0,811.0,811.0
0.011,6,10,1631,5,848,2.0,580.0,580.0,5,783,2.0,515.0,515.0
0.006,17,2,170,1,65,0.0,37.0,37.0,1,105,0.0,77.0,77.0
0.072,17,2,170,1,65,0.0,37.0,37.0,1,105,0.0,77.0,77.0
0.008,6,10,1989,5,910,1.0,642.0,642.0,5,1079,1.0,811.0,811.0
0.009,6,12,1926,6,1189,1.0,659.0,434.0,6,737,1.0,417.0,417.0
0.011,6,10,1990,5,911,2.0,643.0,643.0,5,1079,2.0,811.0,811.0
0.116,6,10,1506,5,395,21.0,127.0,127.0,5,1111,24.0,843.0,843.0
0.019,6,10,1762,5,911,4.0,643.0,643.0,5,851,4.0,583.0,583.0
0.004,17,2,179,1,71,0.0,43.0,43.0,1,108,0.0,80.0,80.0
40.065,17,10,676,5,460,10015.0,104.0,64.0,5,216,10015.0,20.0,15.0
0.007,6,10,1547,5,764,1.0,496.0,496.0,5,783,1.0,515.0,515.0
0.071,17,2,148,1,60,0.0,32.0,32.0,1,88,0.0,60.0,60.0
0.006,6,10,1547,5,764,1.0,496.0,496.0,5,783,1.0,515.0,515.0
0.005,6,10,2006,5,927,1.0,659.0,659.0,5,1079,1.0,811.0,811.0
0.011,6,10,1989,5,910,2.0,642.0,642.0,5,1079,2.0,811.0,811.0
0.001,17,2,180,1,66,0.0,38.0,38.0,1,114,0.0,86.0,86.0
11.507,17,28,4398,14,2312,872.0,587.0,137.0,14,2086,872.0,269.0,121.0
0.008,6,10,1677,5,827,2.0,559.0,559.0,5,850,2.0,582.0,582.0
0.085,6,10,1506,5,395,19.0,127.0,127.0,5,1111,17.0,843.0,843.0
0.007,6,10,1689,5,839,1.0,571.0,571.0,5,850,1.0,582.0,582.0
301.184,6,48,17418,26,11511,12047.0,2720.0,1043.0,22,5907,428.0,2667.0,385.0
0.013,6,10,1631,5,848,3.0,580.0,580.0,5,783,3.0,515.0,515.0
240.013,6,9,787,5,488,60003.0,232.0,232.0,4,299,80003.0,83.0,83.0
0.093,6,10,1506,5,395,20.0,127.0,127.0,5,1111,20.0,843.0,843.0
292.395,6,402,348666,196,21761,1499.0,2736.0,889.0,206,326905,1426.0,2804.0,1646.0
0.068,6,10,1506,5,395,15.0,127.0,127.0,5,1111,14.0,843.0,843.0
0.005,6,10,2007,5,928,1.0,660.0,660.0,5,1079,1.0,811.0,811.0
0.007,17,2,180,1,58,0.0,30.0,30.0,1,122,0.0,94.0,94.0
0.088,6,10,1506,5,395,19.0,127.0,127.0,5,1111,19.0,843.0,843.0
531.035,6,30,8372,16,3168,35402.0,676.0,388.0,14,5204,36229.0,1402.0,638.0
354.048,6,21,1795,16,1030,23603.0,190.0,190.0,5,765,60002.0,464.0,248.0
0.006,6,10,1547,5,764,1.0,496.0,496.0,5,783,1.0,515.0,515.0
0.014,6,10,1990,5,911,3.0,643.0,643.0,5,1079,3.0,811.0,811.0
0.006,6,10,1689,5,839,1.0,571.0,571.0,5,850,1.0,582.0,582.0
0.073,6,10,1506,5,395,15.0,127.0,127.0,5,1111,15.0,843.0,843.0
40.06,17,10,676,5,460,10013.0,104.0,64.0,5,216,10014.0,20.0,15.0
0.128,6,10,1506,5,395,29.0,127.0,127.0,5,1111,30.0,843.0,843.0
240.097,6,16,4481,9,963,30012.0,238.0,166.0,7,3518,40015.0,1402.0,786.0
0.005,17,2,170,1,65,0.0,37.0,37.0,1,105,0.0,77.0,77.0
0.005,6,10,1779,5,928,1.0,660.0,660.0,5,851,1.0,583.0,583.0
0.006,17,2,136,1,60,0.0,32.0,32.0,1,76,0.0,48.0,48.0
0.017,6,10,1972,5,910,4.0,642.0,642.0,5,1062,4.0,794.0,794.0
0.001,17,2,166,1,75,0.0,47.0,47.0,1,91,0.0,63.0,63.0
0.005,6,10,1774,5,923,1.0,655.0,655.0,5,851,1.0,583.0,583.0
0.005,6,10,2007,5,928,1.0,660.0,660.0,5,1079,1.0,811.0,811.0
0.006,17,2,148,1,60,0.0,32.0,32.0,1,88,0.0,60.0,60.0
0.014,6,10,1631,5,848,3.0,580.0,580.0,5,783,3.0,515.0,515.0
0.07,6,10,1506,5,395,15.0,127.0,127.0,5,1111,16.0,843.0,843.0
0.071,17,8,3613,4,1874,23.0,1350.0,440.0,4,1739,12.0,1350.0,406.0
0.009,6,10,1990,5,911,2.0,643.0,643.0,5,1079,2.0,811.0,811.0
0.006,6,10,1702,5,863,1.0,595.0,595.0,5,839,1.0,571.0,571.0
0.11,6,10,1506,5,395,26.0,127.0,127.0,5,1111,25.0,843.0,843.0
0.012,6,10,1990,5,911,3.0,643.0,643.0,5,1079,3.0,811.0,811.0
0.005,6,10,2007,5,928,1.0,660.0,660.0,5,1079,1.0,811.0,811.0
0.112,6,10,1506,5,395,26.0,127.0,127.0,5,1111,25.0,843.0,843.0
0.003,17,2,148,1,60,0.0,32.0,32.0,1,88,0.0,60.0,60.0
0.04,17,2,136,1,60,0.0,32.0,32.0,1,76,0.0,48.0,48.0
0.004,6,10,2007,5,928,1.0,660.0,660.0,5,1079,1.0,811.0,811.0
0.013,6,10,1631,5,848,3.0,580.0,580.0,5,783,3.0,515.0,515.0
0.004,17,2,148,1,60,0.0,32.0,32.0,1,88,0.0,60.0,60.0
0.005,6,10,2007,5,928,1.0,660.0,660.0,5,1079,1.0,811.0,811.0
0.009,6,10,2006,5,927,2.0,659.0,659.0,5,1079,2.0,811.0,811.0
0.012,6,10,1762,5,911,3.0,643.0,643.0,5,851,3.0,583.0,583.0
0.019,17,2,136,1,60,0.0,32.0,32.0,1,76,0.0,48.0,48.0
0.007,6,10,1983,5,910,1.0,642.0,642.0,5,1073,1.0,805.0,805.0
0.005,6,10,1779,5,928,1.0,660.0,660.0,5,851,1.0,583.0,583.0
0.004,17,2,148,1,60,0.0,32.0,32.0,1,88,0.0,60.0,60.0
0.004,6,10,2000,5,927,1.0,659.0,659.0,5,1073,1.0,805.0,805.0
0.083,6,10,1506,5,395,17.0,127.0,127.0,5,1111,17.0,843.0,843.0
0.005,6,10,2000,5,927,1.0,659.0,659.0,5,1073,1.0,805.0,805.0
173.327,17,96,14014,48,3233,3687.0,44.0,39.0,48,10781,3687.0,260.0,196.0
0.016,6,10,1972,5,910,3.0,642.0,642.0,5,1062,4.0,794.0,794.0
0.003,17,4,284,2,120,0.0,32.0,32.0,2,164,0.0,60.0,54.0
0.012,6,10,1972,5,910,2.0,642.0,642.0,5,1062,3.0,794.0,794.0
0.011,6,10,1990,5,911,2.0,643.0,643.0,5,1079,2.0,811.0,811.0
0.091,6,10,1506,5,395,18.0,127.0,127.0,5,1111,20.0,843.0,843.0
0.205,6,16,2782,8,1400,29.0,533.0,325.0,8,1382,18.0,529.0,239.0
0.012,6,10,1989,5,910,3.0,642.0,642.0,5,1079,3.0,811.0,811.0
0.004,17,2,136,1,60,0.0,32.0,32.0,1,76,0.0,48.0,48.0
0.005,6,10,1779,5,928,1.0,660.0,660.0,5,851,1.0,583.0,583.0
0.016,6,10,1983,5,910,4.0,642.0,642.0,5,1073,4.0,805.0,805.0
0.111,6,10,1506,5,395,24.0,127.0,127.0,5,1111,23.0,843.0,843.0
0.004,6,10,2006,5,927,1.0,659.0,659.0,5,1079,1.0,811.0,811.0
0.128,17,4,352,2,130,2.0,37.0,37.0,2,222,87.0,89.0,83.0
0.007,17,2,179,1,71,0.0,43.0,43.0,1,108,0.0,80.0,80.0
0.022,6,10,1631,5,848,5.0,580.0,580.0,5,783,5.0,515.0,515.0
0.01,6,10,1989,5,910,2.0,642.0,642.0,5,1079,2.0,811.0,811.0
0.004,6,10,2006,5,927,1.0,659.0,659.0,5,1079,1.0,811.0,811.0
0.006,6,10,1854,5,889,1.0,621.0,621.0,5,965,1.0,697.0,697.0
1772.034,6,105,6270,60,3525,30033.0,27.0,27.0,45,2745,40272.0,27.0,27.0
0.012,6,13,3735,7,497,2.0,125.0,125.0,6,3238,2.0,1470.0,1459.0
0.016,17,2,194,1,59,0.0,31.0,31.0,1,135,0.0,107.0,107.0
0.006,6,10,1547,5,764,1.0,496.0,496.0,5,783,1.0,515.0,515.0
0.076,6,10,1506,5,395,17.0,127.0,127.0,5,1111,17.0,843.0,843.0
0.004,17,2,166,1,75,0.0,47.0,47.0,1,91,0.0,63.0,63.0
0.021,6,10,1677,5,827,5.0,559.0,559.0,5,850,5.0,582.0,582.0
0.005,17,2,170,1,65,0.0,37.0,37.0,1,105,0.0,77.0,77.0
0.005,6,10,1989,5,927,1.0,659.0,659.0,5,1062,1.0,794.0,794.0
240.022,6,9,787,5,488,60005.0,232.0,232.0,4,299,80006.0,83.0,83.0
0.005,17,2,170,1,65,0.0,37.0,37.0,1,105,0.0,77.0,77.0
0.01,6,10,1989,5,910,2.0,642.0,642.0,5,1079,2.0,811.0,811.0
0.053,17,2,152,1,76,0.0,48.0,48.0,1,76,0.0,48.0,48.0
0.005,6,13,3747,7,509,0.0,137.0,137.0,6,3238,1.0,1470.0,1459.0
0.006,6,10,1854,5,889,1.0,621.0,621.0,5,965,1.0,697.0,697.0
0.013,6,10,1983,5,910,3.0,642.0,642.0,5,1073,3.0,805.0,805.0
0.008,6,10,2006,5,927,2.0,659.0,659.0,5,1079,2.0,811.0,811.0
0.13,6,10,1506,5,395,29.0,127.0,127.0,5,1111,30.0,843.0,843.0
0.001,17,2,180,1,66,0.0,38.0,38.0,1,114,0.0,86.0,86.0
0.006,6,10,1547,5,764,1.0,496.0,496.0,5,783,1.0,515.0,515.0
40.064,17,10,676,5,460,10014.0,104.0,64.0,5,216,10015.0,20.0,15.0
0.011,6,10,1972,5,910,2.0,642.0,642.0,5,1062,2.0,794.0,794.0
0.015,6,10,1972,5,910,3.0,642.0,642.0,5,1062,3.0,794.0,794.0
300.751,6,41,14174,22,8616,14321.0,2720.0,1100.0,19,5558,476.0,2667.0,435.0
0.016,6,10,1972,5,910,4.0,642.0,642.0,5,1062,3.0,794.0,794.0
240.086,6,16,4480,9,963,30010.0,238.0,166.0,7,3517,40013.0,1402.0,786.0
0.001,17,2,166,1,75,0.0,47.0,47.0,1,91,0.0,63.0,63.0
0.004,6,10,1989,5,927,1.0,659.0,659.0,5,1062,1.0,794.0,794.0
0.137,6,10,1506,5,395,32.0,127.0,127.0,5,1111,28.0,843.0,843.0
0.082,6,10,1506,5,395,19.0,127.0,127.0,5,1111,19.0,843.0,843.0
0.072,6,10,1506,5,395,15.0,127.0,127.0,5,1111,14.0,843.0,843.0
0.005,6,10,1989,5,927,1.0,659.0,659.0,5,1062,1.0,794.0,794.0
0.015,6,10,1989,5,910,3.0,642.0,642.0,5,1079,3.0,811.0,811.0
0.006,17,2,179,1,71,0.0,43.0,43.0,1,108,0.0,80.0,80.0
0.01,6,10,1972,5,910,2.0,642.0,642.0,5,1062,2.0,794.0,794.0
40.046,17,10,676,5,460,10010.0,104.0,64.0,5,216,10010.0,20.0,15.0
0.089,6,10,1506,5,395,19.0,127.0,127.0,5,1111,18.0,843.0,843.0
0.163,17,2,152,1,76,0.0,48.0,48.0,1,76,0.0,48.0,48.0
0.038,17,2,148,1,60,0.0,32.0,32.0,1,88,0.0,60.0,60.0
0.012,6,10,1677,5,827,2.0,559.0,559.0,5,850,3.0,582.0,582.0
0.005,6,10,2000,5,927,1.0,659.0,659.0,5,1073,1.0,805.0,805.0
0.005,17,4,284,2,120,0.0,32.0,32.0,2,164,1.0,60.0,54.0
0.004,17,2,148,1,60,0.0,32.0,32.0,1,88,0.0,60.0,60.0
0.007,6,10,1547,5,764,1.0,496.0,496.0,5,783,1.0,515.0,515.0
0.009,6,14,3787,7,497,1.0,125.0,125.0,7,3290,1.0,1448.0,972.0
0.004,6,10,1702,5,863,1.0,595.0,595.0,5,839,1.0,571.0,571.0
0.005,6,10,1989,5,927,1.0,659.0,659.0,5,1062,1.0,794.0,794.0
15.071,17,15,9238,8,6902,2149.0,1350.0,834.0,7,2336,2506.0,1350.0,305.0
0.008,6,10,1983,5,910,2.0,642.0,642.0,5,1073,2.0,805.0,805.0
0.014,6,10,1989,5,910,3.0,642.0,642.0,5,1079,3.0,811.0,811.0
40.059,17,10,676,5,460,10013.0,104.0,64.0,5,216,10011.0,20.0,15.0
0.006,6,10,1689,5,839,1.0,571.0,571.0,5,850,1.0,582.0,582.0
0.01,6,10,1631,5,848,2.0,580.0,580.0,5,783,2.0,515.0,515.0
0.068,17,8,3613,4,1874,22.0,1350.0,440.0,4,1739,11.0,1350.0,406.0
0.063,17,2,144,1,64,0.0,36.0,36.0,1,80,0.0,52.0,52.0
0.013,6,10,1983,5,910,3.0,642.0,642.0,5,1073,3.0,805.0,805.0
0.005,6,10,2006,5,927,1.0,659.0,659.0,5,1079,1.0,811.0,811.0
294.036,6,306,343669,121,17845,2450.0,2736.0,889.0,185,325824,1597.0,2804.0,1849.0
40.071,17,10,676,5,460,10016.0,104.0,64.0,5,216,10017.0,20.0,15.0
0.012,6,10,1989,5,910,2.0,642.0,642.0,5,1079,2.0,811.0,811.0
0.076,6,10,1506,5,395,15.0,127.0,127.0,5,1111,15.0,843.0,843.0
0.005,17,2,144,1,64,0.0,36.0,36.0,1,80,0.0,52.0,52.0
0.016,6,10,1631,5,848,4.0,580.0,580.0,5,783,3.0,515.0,515.0
0.008,6,10,1972,5,910,2.0,642.0,642.0,5,1062,2.0,794.0,794.0
0.01,6,10,1989,5,910,2.0,642.0,642.0,5,1079,2.0,811.0,811.0
11.253,17,28,4422,14,1995,853.0,270.0,114.0,14,2427,852.0,586.0,145.0
0.004,6,10,1989,5,927,1.0,659.0,659.0,5,1062,1.0,794.0,794.0
0.086,17,2,80,1,32,0.0,4.0,4.0,1,48,0.0,20.0,20.0
0.001,17,2,180,1,66,0.0,38.0,38.0,1,114,0.0,86.0,86.0
0.017,6,10,1989,5,910,4.0,642.0,642.0,5,1079,4.0,811.0,811.0
0.1,6,10,1506,5,395,22.0,127.0,127.0,5,1111,20.0,843.0,843.0
0.006,6,10,1547,5,764,1.0,496.0,496.0,5,783,1.0,515.0,515.0
0.001,17,2,136,1,60,0.0,32.0,32.0,1,76,0.0,48.0,48.0
0.01,6,10,1989,5,910,2.0,642.0,642.0,5,1079,2.0,811.0,811.0
0.004,6,10,2007,5,928,1.0,660.0,660.0,5,1079,1.0,811.0,811.0
0.003,17,2,136,1,60,0.0,32.0,32.0,1,76,0.0,48.0,48.0
0.088,6,10,1506,5,395,21.0,127.0,127.0,5,1111,18.0,843.0,843.0
0.004,6,10,1989,5,927,1.0,659.0,659.0,5,1062,1.0,794.0,794.0
11.5,17,28,4397,14,2311,872.0,586.0,137.0,14,2086,872.0,269.0,121.0
0.026,6,10,1990,5,911,6.0,643.0,643.0,5,1079,6.0,811.0,811.0
0.012,6,10,1983,5,910,3.0,642.0,642.0,5,1073,3.0,805.0,805.0
15.075,17,15,9238,8,6902,2149.0,1350.0,834.0,7,2336,2507.0,1350.0,305.0
0.012,6,10,1989,5,910,3.0,642.0,642.0,5,1079,3.0,811.0,811.0
0.125,6,10,1506,5,395,30.0,127.0,127.0,5,1111,28.0,843.0,843.0
352.28,6,20,2210,6,1308,12004.0,494.0,494.0,14,902,27098.0,83.0,83.0
0.004,17,2,148,1,60,0.0,32.0,32.0,1,88,0.0,60.0,60.0
40.051,17,10,676,5,460,10011.0,104.0,64.0,5,216,10011.0,20.0,15.0
40.059,17,10,676,5,460,10012.0,104.0,64.0,5,216,10013.0,20.0,15.0
40.063,17,10,676,5,460,10015.0,104.0,64.0,5,216,10015.0,20.0,15.0
0.01,6,10,1677,5,827,2.0,559.0,559.0,5,850,2.0,582.0,582.0
0.035,6,13,3913,7,495,5.0,123.0,123.0,6,3418,7.0,1650.0,1549.0
0.187,6,10,1506,5,395,45.0,127.0,127.0,5,1111,29.0,843.0,843.0
0.008,6,10,1989,5,910,2.0,642.0,642.0,5,1079,1.0,811.0,811.0
10.985,17,28,4397,14,2312,836.0,587.0,137.0,14,2085,836.0,268.0,120.0
351.992,6,20,2210,6,1308,12003.0,494.0,494.0,14,902,27076.0,83.0,83.0
10.869,17,28,4423,14,1995,827.0,270.0,114.0,14,2428,827.0,587.0,145.0
36.472,6,28,11295,16,1892,2431.0,538.0,350.0,12,9403,3311.0,2624.0,1096.0
40.07,17,10,676,5,460,10014.0,104.0,64.0,5,216,10016.0,20.0,15.0
179.122,17,76,10594,38,2536,4841.0,44.0,38.0,38,8058,4841.0,239.0,184.0
0.073,6,10,1506,5,395,15.0,127.0,127.0,5,1111,15.0,843.0,843.0
40.068,17,10,676,5,460,10015.0,104.0,64.0,5,216,10016.0,20.0,15.0
0.008,6,10,1677,5,827,2.0,559.0,559.0,5,850,2.0,582.0,582.0
240.125,6,32,9671,16,7238,16008.0,2309.0,712.0,16,2433,16008.0,580.0,199.0
0.069,6,10,1506,5,395,13.0,127.0,127.0,5,1111,14.0,843.0,843.0
0.068,17,8,3613,4,1874,22.0,1350.0,440.0,4,1739,11.0,1350.0,406.0
0.004,17,4,284,2,120,0.0,32.0,32.0,2,164,1.0,60.0,54.0
0.004,6,10,1989,5,927,1.0,659.0,659.0,5,1062,1.0,794.0,794.0
0.006,6,10,1854,5,889,1.0,621.0,621.0,5,965,1.0,697.0,697.0
0.005,6,10,2000,5,927,1.0,659.0,659.0,5,1073,1.0,805.0,805.0
40.061,17,10,676,5,460,10014.0,104.0,64.0,5,216,10014.0,20.0,15.0
0.083,6,10,1506,5,395,17.0,127.0,127.0,5,1111,19.0,843.0,843.0
0.007,17,2,175,1,65,0.0,37.0,37.0,1,110,0.0,82.0,82.0
0.148,17,4,352,2,130,110.0,37.0,37.0,2,222,143.0,89.0,83.0
0.114,6,10,1506,5,395,26.0,127.0,127.0,5,1111,23.0,843.0,843.0
0.116,6,10,1506,5,395,24.0,127.0,127.0,5,1111,25.0,843.0,843.0
0.005,6,10,2006,5,927,1.0,659.0,659.0,5,1079,1.0,811.0,811.0
0.005,6,10,1689,5,839,1.0,571.0,571.0,5,850,1.0,582.0,582.0
0.006,6,10,1547,5,764,1.0,496.0,496.0,5,783,1.0,515.0,515.0
172.515,17,80,11116,40,2658,4423.0,44.0,38.0,40,8458,4423.0,239.0,183.0
0.999,6,13,3930,7,2139,125.0,1328.0,923.0,6,1791,150.0,1539.0,1539.0
0.078,6,10,1506,5,395,19.0,127.0,127.0,5,1111,16.0,843.0,843.0
0.005,6,10,2006,5,927,1.0,659.0,659.0,5,1079,1.0,811.0,811.0
0.084,6,10,1506,5,395,19.0,127.0,127.0,5,1111,19.0,843.0,843.0
0.004,6,10,1702,5,863,1.0,595.0,595.0,5,839,1.0,571.0,571.0
0.005,6,10,1989,5,927,1.0,659.0,659.0,5,1062,1.0,794.0,794.0
0.018,6,10,1990,5,911,4.0,643.0,643.0,5,1079,4.0,811.0,811.0
0.012,6,14,3787,7,497,2.0,125.0,125.0,7,3290,2.0,1448.0,972.0
364.388,6,19,1689,15,978,26027.0,190.0,190.0,4,711,80014.0,495.0,495.0
0.04,17,2,136,1,60,0.0,32.0,32.0,1,76,0.0,48.0,48.0
0.006,6,10,1547,5,764,1.0,496.0,496.0,5,783,1.0,515.0,515.0
0.039,17,2,136,1,60,0.0,32.0,32.0,1,76,0.0,48.0,48.0
0.005,17,2,169,1,62,0.0,34.0,34.0,1,107,0.0,79.0,79.0
0.009,6,10,1762,5,911,2.0,643.0,643.0,5,851,2.0,583.0,583.0
0.012,6,10,1989,5,910,2.0,642.0,642.0,5,1079,2.0,811.0,811.0
0.003,17,2,148,1,60,0.0,32.0,32.0,1,88,0.0,60.0,60.0
0.069,6,10,1506,5,395,16.0,127.0,127.0,5,1111,15.0,843.0,843.0
0.001,17,2,180,1,66,0.0,38.0,38.0,1,114,0.0,86.0,86.0
0.111,6,10,1506,5,395,23.0,127.0,127.0,5,1111,23.0,843.0,843.0
0.014,6,10,1989,5,910,3.0,642.0,642.0,5,1079,3.0,811.0,811.0
0.016,17,2,136,1,60,0.0,32.0,32.0,1,76,0.0,48.0,48.0
0.008,6,10,1643,5,860,2.0,592.0,592.0,5,783,2.0,515.0,515.0
0.126,6,10,1506,5,395,29.0,127.0,127.0,5,1111,28.0,843.0,843.0
0.012,6,10,1989,5,910,3.0,642.0,642.0,5,1079,2.0,811.0,811.0
1798.661,17,3220,246521,1602,129806,1123.0,75.0,53.0,1618,116715,1112.0,227.0,44.0
0.006,17,2,179,1,71,0.0,43.0,43.0,1,108,0.0,80.0,80.0
0.01,6,10,1689,5,839,2.0,571.0,571.0,5,850,2.0,582.0,582.0
0.07,6,10,1506,5,395,15.0,127.0,127.0,5,1111,12.0,843.0,843.0
40.057,17,10,676,5,460,10013.0,104.0,64.0,5,216,10011.0,20.0,15.0
0.169,17,2,152,1,76,0.0,48.0,48.0,1,76,0.0,48.0,48.0
40.077,17,10,676,5,460,10016.0,104.0,64.0,5,216,10018.0,20.0,15.0
0.004,6,10,2006,5,927,1.0,659.0,659.0,5,1079,1.0,811.0,811.0
0.005,6,10,1774,5,923,1.0,655.0,655.0,5,851,1.0,583.0,583.0
0.018,6,10,1677,5,827,4.0,559.0,559.0,5,850,4.0,582.0,582.0
0.036,17,2,136,1,60,0.0,32.0,32.0,1,76,0.0,48.0,48.0
0.178,6,10,1506,5,395,36.0,127.0,127.0,5,1111,43.0,843.0,843.0
0.013,6,10,1990,5,911,3.0,643.0,643.0,5,1079,3.0,811.0,811.0
0.004,6,10,2006,5,927,1.0,659.0,659.0,5,1079,1.0,811.0,811.0
0.006,6,10,1643,5,860,1.0,592.0,592.0,5,783,1.0,515.0,515.0
0.006,6,10,1854,5,889,1.0,621.0,621.0,5,965,1.0,697.0,697.0
0.004,6,10,1702,5,863,0.0,595.0,595.0,5,839,1.0,571.0,571.0
0.006,6,10,1854,5,889,1.0,621.0,621.0,5,965,1.0,697.0,697.0
0.005,6,10,2007,5,928,1.0,660.0,660.0,5,1079,1.0,811.0,811.0
0.012,6,10,1989,5,910,2.0,642.0,642.0,5,1079,2.0,811.0,811.0
0.818,6,25,5555,12,1445,62.0,267.0,136.0,13,4110,57.0,1414.0,597.0
0.118,6,10,1506,5,395,27.0,127.0,127.0,5,1111,28.0,843.0,843.0
0.006,6,10,2006,5,927,1.0,659.0,659.0,5,1079,1.0,811.0,811.0
0.084,6,10,1506,5,395,18.0,127.0,127.0,5,1111,17.0,843.0,843.0
0.006,6,10,1547,5,764,1.0,496.0,496.0,5,783,1.0,515.0,515.0
0.007,17,2,179,1,71,0.0,43.0,43.0,1,108,0.0,80.0,80.0
0.024,6,10,1983,5,910,6.0,642.0,642.0,5,1073,5.0,805.0,805.0
9.037,17,6,376,5,280,2259.0,28.0,28.0,1,96,0.0,68.0,68.0
0.005,6,10,1702,5,863,1.0,595.0,595.0,5,839,1.0,571.0,571.0
0.007,17,2,132,1,58,0.0,30.0,30.0,1,74,0.0,46.0,46.0
0.08,6,10,1506,5,395,18.0,127.0,127.0,5,1111,18.0,843.0,843.0
0.006,6,10,1547,5,764,1.0,496.0,496.0,5,783,1.0,515.0,515.0
0.005,6,10,1989,5,927,1.0,659.0,659.0,5,1062,1.0,794.0,794.0
40.065,17,10,676,5,460,10014.0,104.0,64.0,5,216,10015.0,20.0,15.0
0.009,6,10,1990,5,911,2.0,643.0,643.0,5,1079,2.0,811.0,811.0
311.444,17,20,1124,10,716,34590.0,48.0,43.0,10,408,34590.0,20.0,12.0
0.004,6,10,1774,5,923,1.0,655.0,655.0,5,851,1.0,583.0,583.0
0.017,6,10,1972,5,910,4.0,642.0,642.0,5,1062,4.0,794.0,794.0
0.005,17,2,180,1,66,0.0,38.0,38.0,1,114,0.0,86.0,86.0
0.079,6,10,1506,5,395,18.0,127.0,127.0,5,1111,17.0,843.0,843.0
0.006,17,2,179,1,71,0.0,43.0,43.0,1,108,0.0,80.0,80.0
0.216,6,16,2669,8,1395,30.0,533.0,323.0,8,1274,19.0,529.0,212.0
0.005,17,2,180,1,66,0.0,38.0,38.0,1,114,0.0,86.0,86.0
438.37,6,29,4409,12,3102,10911.0,494.0,494.0,17,1307,27397.0,83.0,83.0
0.001,17,2,166,1,75,0.0,47.0,47.0,1,91,0.0,63.0,63.0
40.051,17,10,676,5,460,10011.0,104.0,64.0,5,216,10011.0,20.0,15.0
0.006,6,10,1989,5,927,1.0,659.0,659.0,5,1062,1.0,794.0,794.0
15.073,17,15,9238,8,6902,2149.0,1350.0,834.0,7,2336,2507.0,1350.0,305.0
0.005,6,10,2006,5,927,1.0,659.0,659.0,5,1079,1.0,811.0,811.0
0.009,6,10,1972,5,910,2.0,642.0,642.0,5,1062,2.0,794.0,794.0
0.013,17,2,152,1,56,0.0,28.0,28.0,1,96,0.0,68.0,68.0
0.013,6,10,1990,5,911,3.0,643.0,643.0,5,1079,3.0,811.0,811.0
0.005,6,10,2006,5,927,1.0,659.0,659.0,5,1079,1.0,811.0,811.0
0.287,17,47,24508,24,21169,12.0,1350.0,854.0,23,3339,10.0,1350.0,117.0
0.005,6,10,1774,5,923,1.0,655.0,655.0,5,851,1.0,583.0,583.0
0.009,6,10,1702,5,863,2.0,595.0,595.0,5,839,2.0,571.0,571.0
0.052,17,2,144,1,64,0.0,36.0,36.0,1,80,0.0,52.0,52.0
0.006,6,10,1689,5,839,1.0,571.0,571.0,5,850,1.0,582.0,582.0
0.053,17,2,152,1,76,0.0,48.0,48.0,1,76,0.0,48.0,48.0
0.039,17,2,182,1,65,0.0,37.0,37.0,1,117,0.0,89.0,89.0
0.004,6,10,1774,5,923,1.0,655.0,655.0,5,851,1.0,583.0,583.0
0.012,17,2,214,1,75,0.0,47.0,47.0,1,139,0.0,111.0,111.0
172.157,17,68,9774,34,2267,5216.0,44.0,38.0,34,7507,5216.0,239.0,192.0
0.004,17,4,284,2,120,0.0,32.0,32.0,2,164,1.0,60.0,54.0
379.177,6,22,2313,16,867,25278.0,195.0,195.0,6,1446,4654.0,419.0,398.0
0.016,6,10,1989,5,910,3.0,642.0,642.0,5,1079,4.0,811.0,811.0
0.014,6,10,1989,5,910,3.0,642.0,642.0,5,1079,3.0,811.0,811.0
0.003,17,4,284,2,120,0.0,32.0,32.0,2,164,0.0,60.0,54.0
0.006,6,10,1854,5,889,1.0,621.0,621.0,5,965,1.0,697.0,697.0
15.075,17,15,8322,8,6289,2149.0,1350.0,758.0,7,2033,2507.0,1350.0,262.0
0.005,17,2,170,1,65,0.0,37.0,37.0,1,105,0.0,77.0,77.0
10.742,17,28,4422,14,1994,817.0,269.0,114.0,14,2428,817.0,587.0,145.0
1783.764,6,282,39827,114,20546,15784.0,2720.0,179.0,168,19281,10680.0,1360.0,149.0
11.178,17,28,4418,14,1995,847.0,270.0,114.0,14,2423,847.0,586.0,145.0
0.014,6,13,3735,7,497,2.0,125.0,125.0,6,3238,2.0,1470.0,1459.0
300.32,6,16,2170,9,684,37520.0,146.0,146.0,7,1486,50026.0,419.0,398.0
8.948,6,38,9875,21,4397,447.0,1360.0,700.0,17,5478,545.0,2667.0,435.0
10.841,17,28,4421,14,1993,825.0,268.0,114.0,14,2428,825.0,587.0,145.0
0.004,6,10,2006,5,927,1.0,659.0,659.0,5,1079,1.0,811.0,811.0
0.009,6,10,1989,5,910,2.0,642.0,642.0,5,1079,2.0,811.0,811.0
0.006,6,10,1547,5,764,1.0,496.0,496.0,5,783,1.0,515.0,515.0
0.005,6,10,1643,5,860,1.0,592.0,592.0,5,783,1.0,515.0,515.0
40.047,17,10,676,5,460,10010.0,104.0,64.0,5,216,10010.0,20.0,15.0
0.001,17,2,180,1,66,0.0,38.0,38.0,1,114,0.0,86.0,86.0
0.067,6,10,1506,5,395,14.0,127.0,127.0,5,1111,14.0,843.0,843.0
0.006,17,2,168,1,76,0.0,48.0,48.0,1,92,0.0,64.0,64.0
0.015,6,10,1677,5,827,3.0,559.0,559.0,5,850,3.0,582.0,582.0
0.087,6,10,1506,5,395,20.0,127.0,127.0,5,1111,19.0,843.0,843.0
0.025,6,10,1990,5,911,6.0,643.0,643.0,5,1079,6.0,811.0,811.0
0.042,17,2,136,1,60,0.0,32.0,32.0,1,76,0.0,48.0,48.0
29.013,6,43,14591,21,8684,452.0,4080.0,1302.0,22,5907,1373.0,2667.0,385.0
0.005,17,2,170,1,65,0.0,37.0,37.0,1,105,0.0,77.0,77.0
0.01,6,10,2000,5,927,2.0,659.0,659.0,5,1073,2.0,805.0,805.0
7.606,6,31,6184,17,1298,475.0,267.0,195.0,14,4886,506.0,1823.0,392.0
0.011,6,10,1983,5,910,2.0,642.0,642.0,5,1073,2.0,805.0,805.0
0.008,6,12,1926,6,1189,1.0,659.0,434.0,6,737,1.0,417.0,417.0
0.006,17,2,230,1,68,0.0,40.0,40.0,1,162,0.0,134.0,134.0
0.003,17,2,136,1,60,0.0,32.0,32.0,1,76,0.0,48.0,48.0
0.009,6,10,1854,5,889,2.0,621.0,621.0,5,965,2.0,697.0,697.0
0.005,6,10,1689,5,839,1.0,571.0,571.0,5,850,1.0,582.0,582.0
0.006,6,10,1854,5,889,1.0,621.0,621.0,5,965,1.0,697.0,697.0
0.006,6,10,1547,5,764,1.0,496.0,496.0,5,783,1.0,515.0,515.0
0.135,6,10,1506,5,395,32.0,127.0,127.0,5,1111,30.0,843.0,843.0
0.005,6,10,2007,5,928,1.0,660.0,660.0,5,1079,1.0,811.0,811.0
0.013,6,10,1972,5,910,3.0,642.0,642.0,5,1062,3.0,794.0,794.0
0.011,6,10,1677,5,827,2.0,559.0,559.0,5,850,2.0,582.0,582.0
0.006,6,10,1854,5,889,1.0,621.0,621.0,5,965,1.0,697.0,697.0
0.0,17,2,140,1,62,0.0,34.0,34.0,1,78,0.0,50.0,50.0
0.052,6,13,3816,7,578,8.0,206.0,206.0,6,3238,10.0,1470.0,1459.0
0.005,17,2,209,1,64,0.0,36.0,36.0,1,145,0.0,117.0,117.0
0.005,6,14,3799,7,509,0.0,137.0,137.0,7,3290,0.0,1448.0,972.0
0.007,6,10,1547,5,764,1.0,496.0,496.0,5,783,1.0,515.0,515.0
0.008,6,10,1689,5,839,1.0,571.0,571.0,5,850,1.0,582.0,582.0
0.02,6,10,1677,5,827,5.0,559.0,559.0,5,850,5.0,582.0,582.0
10.789,17,28,4423,14,1994,821.0,269.0,114.0,14,2429,821.0,588.0,145.0
301.237,6,52,20719,27,14692,11586.0,2720.0,1234.0,25,6027,377.0,2667.0,385.0
0.014,6,10,1631,5,848,3.0,580.0,580.0,5,783,3.0,515.0,515.0
0.006,17,2,164,1,74,0.0,46.0,46.0,1,90,0.0,62.0,62.0
0.005,6,10,2007,5,928,1.0,660.0,660.0,5,1079,1.0,811.0,811.0
0.006,6,10,1547,5,764,1.0,496.0,496.0,5,783,1.0,515.0,515.0
0.001,17,2,180,1,66,0.0,38.0,38.0,1,114,0.0,86.0,86.0
294.827,6,403,350636,197,21809,1504.0,2736.0,888.0,206,328827,1438.0,2804.0,1656.0
0.084,6,10,1506,5,395,20.0,127.0,127.0,5,1111,20.0,843.0,843.0
0.006,17,2,179,1,71,0.0,43.0,43.0,1,108,0.0,80.0,80.0
0.019,6,10,1972,5,910,4.0,642.0,642.0,5,1062,4.0,794.0,794.0
0.013,6,10,1983,5,910,3.0,642.0,642.0,5,1073,3.0,805.0,805.0
0.006,6,10,1854,5,889,1.0,621.0,621.0,5,965,1.0,697.0,697.0
0.084,6,10,1506,5,395,18.0,127.0,127.0,5,1111,17.0,843.0,843.0
40.055,17,10,676,5,460,10012.0,104.0,64.0,5,216,10013.0,20.0,15.0
0.039,17,2,148,1,60,0.0,32.0,32.0,1,88,0.0,60.0,60.0
0.076,6,10,1506,5,395,18.0,127.0,127.0,5,1111,15.0,843.0,843.0
0.005,6,13,3747,7,509,0.0,137.0,137.0,6,3238,0.0,1470.0,1459.0
177.3,17,84,12118,42,2825,4324.0,44.0,39.0,42,9293,4324.0,261.0,193.0
0.017,6,10,1989,5,910,4.0,642.0,642.0,5,1079,4.0,811.0,811.0
0.001,17,2,180,1,65,0.0,37.0,37.0,1,115,0.0,87.0,87.0
0.007,6,10,1779,5,928,1.0,660.0,660.0,5,851,1.0,583.0,583.0
0.012,17,2,302,1,65,0.0,37.0,37.0,1,237,0.0,209.0,209.0
0.042,17,2,152,1,76,0.0,48.0,48.0,1,76,0.0,48.0,48.0
167.142,17,88,12720,44,2974,3886.0,44.0,39.0,44,9746,3886.0,239.0,193.0
0.022,6,10,1762,5,911,5.0,643.0,643.0,5,851,5.0,583.0,583.0
0.008,6,10,1677,5,827,1.0,559.0,559.0,5,850,1.0,582.0,582.0
0.009,6,13,3735,7,497,1.0,125.0,125.0,6,3238,1.0,1470.0,1459.0
0.005,6,10,1989,5,927,1.0,659.0,659.0,5,1062,1.0,794.0,794.0
0.034,6,10,1762,5,911,8.0,643.0,643.0,5,851,8.0,583.0,583.0
0.115,6,10,1506,5,395,24.0,127.0,127.0,5,1111,28.0,843.0,843.0
300.456,6,29,8746,14,2477,23111.0,1225.0,348.0,15,6269,21460.0,1591.0,610.0
0.001,17,2,180,1,66,0.0,38.0,38.0,1,114,0.0,86.0,86.0
0.074,6,10,1506,5,395,17.0,127.0,127.0,5,1111,15.0,843.0,843.0
0.016,6,10,1989,5,910,3.0,642.0,642.0,5,1079,3.0,811.0,811.0
0.005,17,2,213,1,69,0.0,41.0,41.0,1,144,0.0,116.0,116.0
0.006,17,2,230,1,68,0.0,40.0,40.0,1,162,0.0,134.0,134.0
40.086,17,10,676,5,460,10020.0,104.0,64.0,5,216,10020.0,20.0,15.0
0.006,17,2,427,1,129,0.0,101.0,101.0,1,298,0.0,270.0,270.0
0.113,6,10,1506,5,395,25.0,127.0,127.0,5,1111,25.0,843.0,843.0
0.015,6,10,1990,5,911,3.0,643.0,643.0,5,1079,3.0,811.0,811.0
0.017,6,10,1983,5,910,4.0,642.0,642.0,5,1073,4.0,805.0,805.0
15.246,17,17,8146,9,6074,1902.0,1350.0,646.0,8,2072,2173.0,1350.0,231.0
0.005,6,10,2006,5,927,1.0,659.0,659.0,5,1079,1.0,811.0,811.0
0.001,17,2,180,1,66,0.0,38.0,38.0,1,114,0.0,86.0,86.0
0.011,6,10,1677,5,827,2.0,559.0,559.0,5,850,2.0,582.0,582.0
0.004,6,10,1702,5,863,0.0,595.0,595.0,5,839,1.0,571.0,571.0
373.72,6,22,2313,16,867,24914.0,195.0,195.0,6,1446,4640.0,419.0,398.0
0.011,6,10,1983,5,910,2.0,642.0,642.0,5,1073,2.0,805.0,805.0
40.057,17,10,676,5,460,10013.0,104.0,64.0,5,216,10013.0,20.0,15.0
0.006,17,2,169,1,62,0.0,34.0,34.0,1,107,0.0,79.0,79.0
0.005,6,10,2006,5,927,1.0,659.0,659.0,5,1079,1.0,811.0,811.0
10.985,17,28,4390,14,2312,836.0,587.0,137.0,14,2078,836.0,269.0,120.0
0.014,6,10,1989,5,910,3.0,642.0,642.0,5,1079,3.0,811.0,811.0
0.075,6,10,1506,5,395,15.0,127.0,127.0,5,1111,17.0,843.0,843.0
0.07,6,10,1506,5,395,13.0,127.0,127.0,5,1111,14.0,843.0,843.0
0.084,6,10,1506,5,395,19.0,127.0,127.0,5,1111,16.0,843.0,843.0
0.005,6,10,2006,5,927,1.0,659.0,659.0,5,1079,1.0,811.0,811.0
0.117,6,10,1506,5,395,26.0,127.0,127.0,5,1111,27.0,843.0,843.0
44.253,6,24,9313,13,1655,3687.0,794.0,367.0,11,7658,4411.0,1360.0,1029.0
0.108,6,10,1506,5,395,20.0,127.0,127.0,5,1111,24.0,843.0,843.0
0.004,6,10,2000,5,927,1.0,659.0,659.0,5,1073,1.0,805.0,805.0
40.062,17,10,676,5,460,10013.0,104.0,64.0,5,216,10014.0,20.0,15.0
0.005,6,13,3747,7,509,0.0,137.0,137.0,6,3238,1.0,1470.0,1459.0
11.133,17,28,4423,14,1995,844.0,270.0,114.0,14,2428,844.0,587.0,145.0
0.005,6,10,2000,5,927,1.0,659.0,659.0,5,1073,1.0,805.0,805.0
0.011,6,10,1989,5,910,2.0,642.0,642.0,5,1079,2.0,811.0,811.0
0.133,17,2,170,1,65,0.0,37.0,37.0,1,105,0.0,77.0,77.0
0.014,6,10,1983,5,910,3.0,642.0,642.0,5,1073,3.0,805.0,805.0
0.005,6,10,2006,5,927,1.0,659.0,659.0,5,1079,1.0,811.0,811.0
0.005,6,10,2006,5,927,1.0,659.0,659.0,5,1079,1.0,811.0,811.0
0.013,6,10,1983,5,910,3.0,642.0,642.0,5,1073,3.0,805.0,805.0
15.219,17,46,29456,27,26150,584.0,1350.0,940.0,19,3306,843.0,1350.0,146.0
0.005,17,2,160,1,72,0.0,44.0,44.0,1,88,0.0,60.0,60.0
0.087,6,10,1506,5,395,18.0,127.0,127.0,5,1111,20.0,843.0,843.0
0.024,6,10,1972,5,910,6.0,642.0,642.0,5,1062,5.0,794.0,794.0
0.101,6,10,1506,5,395,22.0,127.0,127.0,5,1111,22.0,843.0,843.0
10.873,17,28,4421,14,1994,828.0,269.0,114.0,14,2427,828.0,586.0,145.0
0.013,6,10,1983,5,910,3.0,642.0,642.0,5,1073,3.0,805.0,805.0
0.104,6,10,1506,5,395,19.0,127.0,127.0,5,1111,23.0,843.0,843.0
40.082,17,10,676,5,460,10019.0,104.0,64.0,5,216,10019.0,20.0,15.0
40.059,17,10,676,5,460,10014.0,104.0,64.0,5,216,10013.0,20.0,15.0
0.115,6,10,1506,5,395,26.0,127.0,127.0,5,1111,27.0,843.0,843.0
0.004,6,10,2007,5,928,1.0,660.0,660.0,5,1079,1.0,811.0,811.0
0.038,17,2,136,1,60,0.0,32.0,32.0,1,76,0.0,48.0,48.0
40.068,17,10,676,5,460,10016.0,104.0,64.0,5,216,10016.0,20.0,15.0
0.001,17,2,180,1,66,0.0,38.0,38.0,1,114,0.0,86.0,86.0
0.004,6,10,2000,5,927,1.0,659.0,659.0,5,1073,1.0,805.0,805.0
0.005,6,10,2006,5,927,1.0,659.0,659.0,5,1079,1.0,811.0,811.0
0.005,6,10,1989,5,927,1.0,659.0,659.0,5,1062,1.0,794.0,794.0
20.881,58,2,144,1,72,0.0,24.0,24.0,1,72,0.0,24.0,24.0
0.017,17,2,198,1,91,0.0,63.0,63.0,1,107,0.0,79.0,79.0
0.005,6,10,2000,5,927,1.0,659.0,659.0,5,1073,1.0,805.0,805.0
0.005,6,10,1779,5,928,1.0,660.0,660.0,5,851,1.0,583.0,583.0
62.708,6,36,9704,19,4226,3483.0,1753.0,858.0,17,5478,545.0,2667.0,435.0
0.02,6,10,1983,5,910,4.0,642.0,642.0,5,1073,4.0,805.0,805.0
0.115,6,10,1506,5,395,24.0,127.0,127.0,5,1111,24.0,843.0,843.0
0.005,6,10,1774,5,923,1.0,655.0,655.0,5,851,1.0,583.0,583.0
0.006,17,2,164,1,74,0.0,46.0,46.0,1,90,0.0,62.0,62.0
0.005,6,10,2006,5,927,1.0,659.0,659.0,5,1079,1.0,811.0,811.0
0.008,6,12,1698,6,863,1.0,327.0,271.0,6,835,1.0,515.0,515.0
0.005,6,10,1989,5,927,1.0,659.0,659.0,5,1062,1.0,794.0,794.0
0.018,6,10,1990,5,911,4.0,643.0,643.0,5,1079,4.0,811.0,811.0
1769.055,17,92,8096,46,4048,39312.0,60.0,60.0,46,4048,39312.0,60.0,60.0
0.003,17,2,136,1,60,0.0,32.0,32.0,1,76,0.0,48.0,48.0
0.041,17,2,136,1,60,0.0,32.0,32.0,1,76,0.0,48.0,48.0
0.044,17,2,166,1,75,0.0,47.0,47.0,1,91,0.0,63.0,63.0
1779.126,6,243,46568,118,34054,15206.0,2476.0,962.0,125,12514,14347.0,580.0,62.0
0.004,17,2,136,1,60,0.0,32.0,32.0,1,76,0.0,48.0,48.0
0.005,6,10,2006,5,927,1.0,659.0,659.0,5,1079,1.0,811.0,811.0
0.004,17,2,148,1,60,0.0,32.0,32.0,1,88,0.0,60.0,60.0
10.983,17,28,4393,14,2310,836.0,585.0,137.0,14,2083,836.0,270.0,120.0
0.005,6,14,3742,7,452,0.0,80.0,80.0,7,3290,0.0,1448.0,972.0
0.015,6,10,1990,5,911,3.0,643.0,643.0,5,1079,3.0,811.0,811.0
0.013,6,10,1989,5,910,3.0,642.0,642.0,5,1079,3.0,811.0,811.0
0.026,17,4,596,2,122,22.0,33.0,33.0,2,474,23.0,323.0,209.0
0.001,17,2,180,1,66,0.0,38.0,38.0,1,114,0.0,86.0,86.0
0.104,6,10,1506,5,395,20.0,127.0,127.0,5,1111,23.0,843.0,843.0
0.016,6,10,1762,5,911,4.0,643.0,643.0,5,851,3.0,583.0,583.0
0.005,6,10,2007,5,928,1.0,660.0,660.0,5,1079,1.0,811.0,811.0
0.06,6,10,1506,5,395,12.0,127.0,127.0,5,1111,14.0,843.0,843.0
0.027,17,2,148,1,60,0.0,32.0,32.0,1,88,0.0,60.0,60.0
1730.675,6,50,3084,32,1875,55828.0,35.0,35.0,18,1209,101799.0,31.0,31.0
0.114,6,10,1506,5,395,22.0,127.0,127.0,5,1111,26.0,843.0,843.0
0.007,6,10,1774,5,923,1.0,655.0,655.0,5,851,1.0,583.0,583.0
0.012,6,10,1989,5,910,3.0,642.0,642.0,5,1079,2.0,811.0,811.0
0.109,6,10,1506,5,395,24.0,127.0,127.0,5,1111,25.0,843.0,843.0
0.04,17,2,136,1,60,0.0,32.0,32.0,1,76,0.0,48.0,48.0
0.081,6,10,1506,5,395,18.0,127.0,127.0,5,1111,17.0,843.0,843.0
0.004,6,10,2006,5,927,1.0,659.0,659.0,5,1079,1.0,811.0,811.0
0.118,6,10,1506,5,395,24.0,127.0,127.0,5,1111,23.0,843.0,843.0
0.01,6,10,1989,5,910,2.0,642.0,642.0,5,1079,2.0,811.0,811.0
0.004,6,10,2006,5,927,1.0,659.0,659.0,5,1079,1.0,811.0,811.0
0.071,6,10,1506,5,395,13.0,127.0,127.0,5,1111,16.0,843.0,843.0
369.506,6,22,2313,16,867,24633.0,195.0,195.0,6,1446,4640.0,419.0,398.0
0.005,6,10,1547,5,764,1.0,496.0,496.0,5,783,1.0,515.0,515.0
0.007,17,4,284,2,120,0.0,32.0,32.0,2,164,0.0,60.0,54.0
0.096,6,10,1506,5,395,22.0,127.0,127.0,5,1111,23.0,843.0,843.0
0.001,17,2,166,1,75,0.0,47.0,47.0,1,91,0.0,63.0,63.0
40.061,17,10,676,5,460,10014.0,104.0,64.0,5,216,10014.0,20.0,15.0
0.066,6,10,1506,5,395,14.0,127.0,127.0,5,1111,15.0,843.0,843.0
0.004,6,13,3747,7,509,0.0,137.0,137.0,6,3238,0.0,1470.0,1459.0
0.004,17,2,136,1,60,0.0,32.0,32.0,1,76,0.0,48.0,48.0
0.015,6,10,1972,5,910,3.0,642.0,642.0,5,1062,3.0,794.0,794.0
0.082,6,10,1506,5,395,19.0,127.0,127.0,5,1111,17.0,843.0,843.0
0.041,17,4,284,2,120,0.0,32.0,32.0,2,164,37.0,60.0,54.0
0.004,17,2,136,1,60,0.0,32.0,32.0,1,76,0.0,48.0,48.0
0.062,6,10,1506,5,395,13.0,127.0,127.0,5,1111,14.0,843.0,843.0
0.005,17,2,136,1,60,0.0,32.0,32.0,1,76,0.0,48.0,48.0
0.001,17,2,136,1,60,0.0,32.0,32.0,1,76,0.0,48.0,48.0
0.005,6,10,2006,5,927,1.0,659.0,659.0,5,1079,1.0,811.0,811.0
10.91,17,28,4423,14,1994,830.0,269.0,114.0,14,2429,830.0,588.0,145.0
0.009,6,13,3735,7,497,1.0,125.0,125.0,6,3238,1.0,1470.0,1459.0
0.004,6,10,2000,5,927,1.0,659.0,659.0,5,1073,1.0,805.0,805.0
1777.631,17,144,45504,72,22752,25036.0,288.0,288.0,72,22752,25036.0,288.0,288.0
0.119,6,10,1506,5,395,29.0,127.0,127.0,5,1111,28.0,843.0,843.0
0.02,6,10,1989,5,910,5.0,642.0,642.0,5,1079,5.0,811.0,811.0
0.005,6,10,1989,5,927,1.0,659.0,659.0,5,1062,1.0,794.0,794.0
0.119,6,10,1506,5,395,26.0,127.0,127.0,5,1111,25.0,843.0,843.0
0.004,17,4,420,2,122,0.0,33.0,33.0,2,298,0.0,145.0,121.0
0.023,6,10,1990,5,911,5.0,643.0,643.0,5,1079,5.0,811.0,811.0
0.005,17,2,140,1,62,0.0,34.0,34.0,1,78,0.0,50.0,50.0
0.336,17,42,24360,25,21211,14.0,1350.0,820.0,17,3149,16.0,1350.0,157.0
0.005,6,10,2006,5,927,1.0,659.0,659.0,5,1079,1.0,811.0,811.0
0.001,17,2,166,1,75,0.0,47.0,47.0,1,91,0.0,63.0,63.0
1770.667,6,301,97473,187,86387,9519.0,1402.0,672.0,114,11086,15669.0,452.0,70.0
0.019,6,10,1983,5,910,4.0,642.0,642.0,5,1073,4.0,805.0,805.0
40.087,17,10,676,5,460,10020.0,104.0,64.0,5,216,10021.0,20.0,15.0
0.01,6,10,1631,5,848,2.0,580.0,580.0,5,783,2.0,515.0,515.0
317.872,6,44,2910,18,1272,18698.0,46.0,46.0,26,1638,12709.0,46.0,46.0
300.357,6,16,2170,9,684,37523.0,146.0,146.0,7,1486,50032.0,419.0,398.0
0.064,6,10,1506,5,395,14.0,127.0,127.0,5,1111,15.0,843.0,843.0
0.035,17,2,152,1,76,0.0,48.0,48.0,1,76,0.0,48.0,48.0
0.005,6,10,1689,5,839,1.0,571.0,571.0,5,850,1.0,582.0,582.0
0.006,6,10,1547,5,764,1.0,496.0,496.0,5,783,1.0,515.0,515.0
0.077,6,10,1506,5,395,18.0,127.0,127.0,5,1111,16.0,843.0,843.0
26.09,17,24,14848,13,12031,2171.0,1350.0,897.0,11,2817,2606.0,1350.0,228.0
0.005,6,10,1989,5,927,1.0,659.0,659.0,5,1062,1.0,794.0,794.0
40.062,17,10,676,5,460,10014.0,104.0,64.0,5,216,10014.0,20.0,15.0
0.005,17,2,169,1,62,0.0,34.0,34.0,1,107,0.0,79.0,79.0
0.093,6,10,1506,5,395,20.0,127.0,127.0,5,1111,21.0,843.0,843.0
311.281,17,16,928,8,608,44450.0,48.0,48.0,8,320,44451.0,12.0,12.0
43.816,6,36,9555,18,4037,517.0,1572.0,821.0,18,5518,2567.0,2667.0,435.0
0.004,6,10,2007,5,928,1.0,660.0,660.0,5,1079,1.0,811.0,811.0
0.096,6,10,1506,5,395,21.0,127.0,127.0,5,1111,22.0,843.0,843.0
0.006,6,10,1689,5,839,1.0,571.0,571.0,5,850,1.0,582.0,582.0
0.12,6,10,1506,5,395,23.0,127.0,127.0,5,1111,29.0,843.0,843.0
0.005,6,10,2006,5,927,1.0,659.0,659.0,5,1079,1.0,811.0,811.0
0.006,6,10,1547,5,764,1.0,496.0,496.0,5,783,1.0,515.0,515.0
0.111,6,10,1506,5,395,25.0,127.0,127.0,5,1111,26.0,843.0,843.0
0.006,6,10,1547,5,764,1.0,496.0,496.0,5,783,1.0,515.0,515.0
0.004,17,2,152,1,76,0.0,48.0,48.0,1,76,0.0,48.0,48.0
0.005,6,10,2007,5,928,1.0,660.0,660.0,5,1079,1.0,811.0,811.0
300.018,6,11,891,6,552,60003.0,232.0,232.0,5,339,75004.0,83.0,83.0
0.03,6,10,1762,5,911,7.0,643.0,643.0,5,851,7.0,583.0,583.0
60.018,6,10,1690,6,1308,12003.0,494.0,494.0,4,382,20005.0,83.0,83.0
0.014,6,10,1989,5,910,3.0,642.0,642.0,5,1079,3.0,811.0,811.0
0.009,6,10,1989,5,910,2.0,642.0,642.0,5,1079,2.0,811.0,811.0
0.004,17,2,136,1,60,0.0,32.0,32.0,1,76,0.0,48.0,48.0
0.004,6,10,1779,5,928,1.0,660.0,660.0,5,851,1.0,583.0,583.0
0.005,6,10,2006,5,927,1.0,659.0,659.0,5,1079,1.0,811.0,811.0
0.009,6,10,1631,5,848,2.0,580.0,580.0,5,783,2.0,515.0,515.0
0.005,6,10,2006,5,927,1.0,659.0,659.0,5,1079,1.0,811.0,811.0
0.13,6,10,1506,5,395,29.0,127.0,127.0,5,1111,29.0,843.0,843.0
0.015,6,10,1989,5,910,3.0,642.0,642.0,5,1079,3.0,811.0,811.0
40.077,17,10,676,5,460,10018.0,104.0,64.0,5,216,10018.0,20.0,15.0
0.004,6,10,2007,5,928,1.0,660.0,660.0,5,1079,1.0,811.0,811.0
0.007,6,10,2006,5,927,1.0,659.0,659.0,5,1079,1.0,811.0,811.0
0.011,6,10,1989,5,910,2.0,642.0,642.0,5,1079,2.0,811.0,811.0
0.011,6,10,1989,5,910,2.0,642.0,642.0,5,1079,2.0,811.0,811.0
178.063,17,80,11462,40,2662,4565.0,44.0,38.0,40,8800,4565.0,239.0,192.0
0.147,6,10,1506,5,395,34.0,127.0,127.0,5,1111,35.0,843.0,843.0
0.042,17,2,144,1,64,0.0,36.0,36.0,1,80,0.0,52.0,52.0
0.005,17,2,170,1,65,0.0,37.0,37.0,1,105,0.0,77.0,77.0
40.056,17,10,676,5,460,10013.0,104.0,64.0,5,216,10013.0,20.0,15.0
0.217,6,10,1506,5,395,52.0,127.0,127.0,5,1111,51.0,843.0,843.0
0.014,6,10,1990,5,911,3.0,643.0,643.0,5,1079,3.0,811.0,811.0
0.006,6,10,1547,5,764,1.0,496.0,496.0,5,783,1.0,515.0,515.0
0.004,17,2,148,1,60,0.0,32.0,32.0,1,88,0.0,60.0,60.0
0.016,6,10,1989,5,910,4.0,642.0,642.0,5,1079,4.0,811.0,811.0
164.297,6,21,7397,11,1305,113.0,530.0,277.0,10,6092,18236.0,2720.0,1136.0
0.006,6,10,1547,5,764,1.0,496.0,496.0,5,783,1.0,515.0,515.0
0.012,6,10,1989,5,910,3.0,642.0,642.0,5,1079,3.0,811.0,811.0
1777.963,17,144,45504,72,22752,25037.0,288.0,288.0,72,22752,25037.0,288.0,288.0
0.164,6,10,1506,5,395,38.0,127.0,127.0,5,1111,33.0,843.0,843.0
0.001,17,2,136,1,60,0.0,32.0,32.0,1,76,0.0,48.0,48.0
0.01,6,10,1774,5,923,2.0,655.0,655.0,5,851,2.0,583.0,583.0
0.006,6,10,1547,5,764,1.0,496.0,496.0,5,783,1.0,515.0,515.0
0.112,6,10,1506,5,395,21.0,127.0,127.0,5,1111,27.0,843.0,843.0
0.006,6,10,1702,5,863,1.0,595.0,595.0,5,839,1.0,571.0,571.0
0.003,17,2,148,1,60,0.0,32.0,32.0,1,88,0.0,60.0,60.0
0.005,6,10,2000,5,927,1.0,659.0,659.0,5,1073,1.0,805.0,805.0
40.059,17,10,676,5,460,10013.0,104.0,64.0,5,216,10013.0,20.0,15.0
0.118,6,10,1506,5,395,27.0,127.0,127.0,5,1111,24.0,843.0,843.0
0.009,6,10,1677,5,827,2.0,559.0,559.0,5,850,2.0,582.0,582.0
0.001,17,2,186,1,61,0.0,33.0,33.0,1,125,0.0,97.0,97.0
0.005,6,10,2007,5,928,1.0,660.0,660.0,5,1079,1.0,811.0,811.0
0.006,6,10,1547,5,764,1.0,496.0,496.0,5,783,1.0,515.0,515.0
0.005,17,2,170,1,65,0.0,37.0,37.0,1,105,0.0,77.0,77.0
0.005,17,2,166,1,75,0.0,47.0,47.0,1,91,0.0,63.0,63.0
0.016,6,10,1989,5,910,3.0,642.0,642.0,5,1079,4.0,811.0,811.0
0.025,6,10,1989,5,910,6.0,642.0,642.0,5,1079,6.0,811.0,811.0
15.222,17,17,8105,9,6026,1899.0,1350.0,641.0,8,2079,2170.0,1350.0,231.0
0.005,6,13,3747,7,509,0.0,137.0,137.0,6,3238,0.0,1470.0,1459.0
0.009,6,10,1989,5,910,2.0,642.0,642.0,5,1079,2.0,811.0,811.0
319.395,17,20,1124,10,716,35476.0,48.0,43.0,10,408,35475.0,20.0,12.0
0.001,17,2,180,1,66,0.0,38.0,38.0,1,114,0.0,86.0,86.0
352.249,6,20,2210,6,1308,12003.0,494.0,494.0,14,902,27095.0,83.0,83.0
0.08,6,10,1506,5,395,18.0,127.0,127.0,5,1111,18.0,843.0,843.0
0.008,6,13,3747,7,509,1.0,137.0,137.0,6,3238,1.0,1470.0,1459.0
11.206,17,28,4419,14,1995,849.0,270.0,114.0,14,2424,849.0,587.0,145.0
0.015,6,10,1677,5,827,3.0,559.0,559.0,5,850,3.0,582.0,582.0
0.223,17,14,8577,7,4012,37.0,1350.0,545.0,7,4565,27.0,1350.0,624.0
0.019,6,10,1989,5,910,4.0,642.0,642.0,5,1079,4.0,811.0,811.0
0.005,6,10,2006,5,927,1.0,659.0,659.0,5,1079,1.0,811.0,811.0
0.023,6,10,1990,5,911,5.0,643.0,643.0,5,1079,5.0,811.0,811.0
174.475,17,82,11662,41,2739,4361.0,44.0,38.0,41,8923,4361.0,261.0,189.0
0.014,6,10,1972,5,910,3.0,642.0,642.0,5,1062,3.0,794.0,794.0
40.06,17,10,676,5,460,10014.0,104.0,64.0,5,216,10014.0,20.0,15.0
0.005,6,10,1774,5,923,1.0,655.0,655.0,5,851,1.0,583.0,583.0
0.004,6,10,2007,5,928,1.0,660.0,660.0,5,1079,1.0,811.0,811.0
240.082,6,16,4481,9,963,30010.0,238.0,166.0,7,3518,40012.0,1402.0,786.0
0.019,6,10,1972,5,910,4.0,642.0,642.0,5,1062,4.0,794.0,794.0
0.005,17,2,140,1,62,0.0,34.0,34.0,1,78,0.0,50.0,50.0
15.071,17,15,9238,8,6902,2149.0,1350.0,834.0,7,2336,2506.0,1350.0,305.0
11.441,17,28,4398,14,2313,867.0,588.0,137.0,14,2085,867.0,268.0,120.0
0.107,6,10,1506,5,395,22.0,127.0,127.0,5,1111,25.0,843.0,843.0
0.005,6,10,2006,5,927,1.0,659.0,659.0,5,1079,1.0,811.0,811.0
0.009,17,2,208,1,72,0.0,44.0,44.0,1,136,0.0,108.0,108.0
0.018,6,10,1972,5,910,4.0,642.0,642.0,5,1062,4.0,794.0,794.0
0.154,6,10,1506,5,395,36.0,127.0,127.0,5,1111,32.0,843.0,843.0
0.084,6,10,1506,5,395,18.0,127.0,127.0,5,1111,19.0,843.0,843.0
0.004,6,10,1989,5,927,1.0,659.0,659.0,5,1062,1.0,794.0,794.0
0.07,17,8,3613,4,1874,23.0,1350.0,440.0,4,1739,12.0,1350.0,406.0
40.065,17,10,676,5,460,10013.0,104.0,64.0,5,216,10015.0,20.0,15.0
0.015,6,10,1972,5,910,3.0,642.0,642.0,5,1062,3.0,794.0,794.0
368.994,6,22,2313,16,867,24599.0,195.0,195.0,6,1446,4638.0,419.0,398.0
0.017,6,10,1989,5,910,4.0,642.0,642.0,5,1079,4.0,811.0,811.0
94.004,6,32,14745,17,6868,5875.0,2720.0,1024.0,15,7877,6702.0,2720.0,908.0
0.024,6,10,1989,5,910,5.0,642.0,642.0,5,1079,5.0,811.0,811.0
309.601,17,18,1008,9,640,38684.0,48.0,43.0,9,368,38684.0,20.0,12.0
0.005,6,10,1689,5,839,1.0,571.0,571.0,5,850,1.0,582.0,582.0
0.005,6,10,1547,5,764,1.0,496.0,496.0,5,783,1.0,515.0,515.0
0.088,6,10,1506,5,395,20.0,127.0,127.0,5,1111,13.0,843.0,843.0
0.013,6,10,1989,5,910,3.0,642.0,642.0,5,1079,3.0,811.0,811.0
0.006,6,10,1547,5,764,1.0,496.0,496.0,5,783,1.0,515.0,515.0
1777.869,17,144,45504,72,22752,25040.0,288.0,288.0,72,22752,25040.0,288.0,288.0
0.128,17,4,352,2,130,0.0,37.0,37.0,2,222,124.0,89.0,83.0
0.005,6,10,2007,5,928,1.0,660.0,660.0,5,1079,1.0,811.0,811.0
0.008,6,10,1990,5,911,2.0,643.0,643.0,5,1079,1.0,811.0,811.0
61.504,6,30,11725,15,2068,4393.0,506.0,317.0,15,9657,4389.0,2804.0,984.0
0.096,6,10,1506,5,395,22.0,127.0,127.0,5,1111,20.0,843.0,843.0
0.005,6,10,1989,5,927,1.0,659.0,659.0,5,1062,1.0,794.0,794.0
0.02,17,2,198,1,91,0.0,63.0,63.0,1,107,0.0,79.0,79.0
0.011,6,10,1990,5,911,2.0,643.0,643.0,5,1079,2.0,811.0,811.0
40.071,17,10,676,5,460,10014.0,104.0,64.0,5,216,10016.0,20.0,15.0
0.014,6,10,2006,5,927,3.0,659.0,659.0,5,1079,3.0,811.0,811.0
0.054,17,2,152,1,76,0.0,48.0,48.0,1,76,0.0,48.0,48.0
0.012,6,10,1989,5,910,3.0,642.0,642.0,5,1079,2.0,811.0,811.0
0.084,6,10,1506,5,395,18.0,127.0,127.0,5,1111,18.0,843.0,843.0
0.007,17,2,144,1,64,0.0,36.0,36.0,1,80,0.0,52.0,52.0
1730.388,6,45,2790,30,1725,59668.0,35.0,35.0,15,1065,123594.0,31.0,31.0
0.004,17,2,136,1,60,0.0,32.0,32.0,1,76,0.0,48.0,48.0
0.008,6,10,1972,5,910,2.0,642.0,642.0,5,1062,1.0,794.0,794.0
0.01,6,10,1989,5,910,2.0,642.0,642.0,5,1079,2.0,811.0,811.0
0.004,6,10,2006,5,927,1.0,659.0,659.0,5,1079,1.0,811.0,811.0
240.107,6,31,8958,15,6480,17150.0,1604.0,633.0,16,2478,16006.0,580.0,204.0
0.005,6,10,2000,5,927,1.0,659.0,659.0,5,1073,1.0,805.0,805.0
0.01,6,10,1972,5,910,2.0,642.0,642.0,5,1062,2.0,794.0,794.0
0.005,6,10,1854,5,889,1.0,621.0,621.0,5,965,1.0,697.0,697.0
0.001,17,2,136,1,60,0.0,32.0,32.0,1,76,0.0,48.0,48.0
0.005,6,10,1989,5,927,1.0,659.0,659.0,5,1062,1.0,794.0,794.0
0.101,6,10,1506,5,395,19.0,127.0,127.0,5,1111,22.0,843.0,843.0
0.094,6,10,1506,5,395,21.0,127.0,127.0,5,1111,20.0,843.0,843.0
0.09,6,10,1506,5,395,20.0,127.0,127.0,5,1111,20.0,843.0,843.0
0.092,6,10,1506,5,395,21.0,127.0,127.0,5,1111,21.0,843.0,843.0
40.066,17,10,676,5,460,10014.0,104.0,64.0,5,216,10014.0,20.0,15.0
0.006,6,10,2007,5,928,1.0,660.0,660.0,5,1079,1.0,811.0,811.0
0.005,6,10,1547,5,764,1.0,496.0,496.0,5,783,1.0,515.0,515.0
352.771,6,20,2210,6,1308,12003.0,494.0,494.0,14,902,27136.0,83.0,83.0
0.004,17,2,234,1,61,0.0,33.0,33.0,1,173,0.0,145.0,145.0
0.019,6,10,1677,5,827,4.0,559.0,559.0,5,850,4.0,582.0,582.0
0.009,6,10,1989,5,910,2.0,642.0,642.0,5,1079,2.0,811.0,811.0
0.008,6,10,2007,5,928,2.0,660.0,660.0,5,1079,2.0,811.0,811.0
0.005,6,10,2007,5,928,1.0,660.0,660.0,5,1079,1.0,811.0,811.0
0.012,6,10,1983,5,910,2.0,642.0,642.0,5,1073,2.0,805.0,805.0
0.005,6,10,1779,5,928,1.0,660.0,660.0,5,851,1.0,583.0,583.0
0.011,6,10,1972,5,910,2.0,642.0,642.0,5,1062,2.0,794.0,794.0
0.006,6,10,1547,5,764,1.0,496.0,496.0,5,783,1.0,515.0,515.0
0.003,17,2,148,1,60,0.0,32.0,32.0,1,88,0.0,60.0,60.0
40.097,17,10,676,5,460,10023.0,104.0,64.0,5,216,10023.0,20.0,15.0
0.006,17,2,179,1,71,0.0,43.0,43.0,1,108,0.0,80.0,80.0
0.005,6,10,2006,5,927,1.0,659.0,659.0,5,1079,1.0,811.0,811.0
0.005,6,10,1643,5,860,1.0,592.0,592.0,5,783,1.0,515.0,515.0
0.004,17,4,284,2,120,0.0,32.0,32.0,2,164,0.0,60.0,54.0
0.15,6,10,1506,5,395,35.0,127.0,127.0,5,1111,35.0,843.0,843.0
0.001,17,2,136,1,60,0.0,32.0,32.0,1,76,0.0,48.0,48.0
0.124,6,10,1506,5,395,29.0,127.0,127.0,5,1111,29.0,843.0,843.0
0.006,6,10,1854,5,889,1.0,621.0,621.0,5,965,1.0,697.0,697.0
0.08,6,10,1506,5,395,16.0,127.0,127.0,5,1111,17.0,843.0,843.0
11.609,17,42,9441,21,5176,574.0,1337.0,218.0,21,4265,574.0,863.0,175.0
0.08,6,10,1506,5,395,17.0,127.0,127.0,5,1111,18.0,843.0,843.0
0.006,6,10,1547,5,764,1.0,496.0,496.0,5,783,1.0,515.0,515.0
300.333,6,16,2170,9,684,37520.0,146.0,146.0,7,1486,50027.0,419.0,398.0
0.107,6,10,1506,5,395,22.0,127.0,127.0,5,1111,22.0,843.0,843.0
0.077,6,10,1506,5,395,16.0,127.0,127.0,5,1111,15.0,843.0,843.0
0.006,6,10,1547,5,764,1.0,496.0,496.0,5,783,1.0,515.0,515.0
0.015,6,10,1762,5,911,3.0,643.0,643.0,5,851,3.0,583.0,583.0
15.158,17,19,13455,10,8344,1681.0,1350.0,806.0,9,5111,1890.0,1350.0,539.0
0.014,6,13,3735,7,497,2.0,125.0,125.0,6,3238,2.0,1470.0,1459.0
0.004,6,10,2006,5,927,1.0,659.0,659.0,5,1079,1.0,811.0,811.0
0.009,6,10,1677,5,827,2.0,559.0,559.0,5,850,2.0,582.0,582.0
0.018,6,10,1631,5,848,4.0,580.0,580.0,5,783,4.0,515.0,515.0
0.001,17,2,180,1,66,0.0,38.0,38.0,1,114,0.0,86.0,86.0
0.018,6,10,1983,5,910,4.0,642.0,642.0,5,1073,4.0,805.0,805.0
241.712,6,295,343443,108,17128,2258.0,2736.0,885.0,187,326315,1299.0,3169.0,1788.0
0.005,6,10,2006,5,927,1.0,659.0,659.0,5,1079,1.0,811.0,811.0
40.061,17,10,676,5,460,10012.0,104.0,64.0,5,216,10014.0,20.0,15.0
0.006,6,10,1547,5,764,1.0,496.0,496.0,5,783,1.0,515.0,515.0
0.004,6,10,2000,5,927,1.0,659.0,659.0,5,1073,1.0,805.0,805.0
0.218,6,16,2776,8,1394,31.0,533.0,323.0,8,1382,19.0,529.0,239.0
0.006,6,10,1854,5,889,1.0,621.0,621.0,5,965,1.0,697.0,697.0
10.811,17,28,4423,14,1994,823.0,269.0,114.0,14,2429,823.0,588.0,145.0
241.479,6,388,347498,191,21445,1270.0,2736.0,958.0,197,326053,1232.0,2804.0,1688.0
25.785,6,44,18611,23,12973,408.0,2720.0,1335.0,21,5638,1281.0,2667.0,435.0
0.005,6,10,2006,5,927,1.0,659.0,659.0,5,1079,1.0,811.0,811.0
0.012,6,10,1989,5,910,3.0,642.0,642.0,5,1079,2.0,811.0,811.0
0.008,6,10,1990,5,911,2.0,643.0,643.0,5,1079,1.0,811.0,811.0
0.092,6,10,1506,5,395,21.0,127.0,127.0,5,1111,22.0,843.0,843.0
0.004,6,10,1989,5,927,1.0,659.0,659.0,5,1062,1.0,794.0,794.0
0.001,17,2,180,1,66,0.0,38.0,38.0,1,114,0.0,86.0,86.0
1.125,6,32,13391,18,5892,66.0,2073.0,854.0,14,7499,72.0,2720.0,769.0
0.001,17,2,180,1,66,0.0,38.0,38.0,1,114,0.0,86.0,86.0
352.244,6,20,2210,6,1308,12004.0,494.0,494.0,14,902,27095.0,83.0,83.0
0.071,6,10,1506,5,395,15.0,127.0,127.0,5,1111,14.0,843.0,843.0
0.006,6,10,1689,5,839,1.0,571.0,571.0,5,850,1.0,582.0,582.0
1799.012,6,483,98653,242,87423,7464.0,421.0,368.0,241,11230,7494.0,53.0,53.0
0.089,6,10,1506,5,395,19.0,127.0,127.0,5,1111,20.0,843.0,843.0
0.005,17,2,179,1,71,0.0,43.0,43.0,1,108,0.0,80.0,80.0
0.009,6,10,1972,5,910,2.0,642.0,642.0,5,1062,2.0,794.0,794.0
0.005,6,10,2006,5,927,1.0,659.0,659.0,5,1079,1.0,811.0,811.0
0.09,6,10,1506,5,395,20.0,127.0,127.0,5,1111,16.0,843.0,843.0
0.105,6,10,1506,5,395,21.0,127.0,127.0,5,1111,19.0,843.0,843.0
0.042,17,2,184,1,61,0.0,33.0,33.0,1,123,0.0,95.0,95.0
0.006,6,10,1989,5,927,1.0,659.0,659.0,5,1062,1.0,794.0,794.0
0.112,6,10,1506,5,395,25.0,127.0,127.0,5,1111,24.0,843.0,843.0
40.06,17,10,676,5,460,10014.0,104.0,64.0,5,216,10014.0,20.0,15.0
0.071,17,2,148,1,60,0.0,32.0,32.0,1,88,0.0,60.0,60.0
0.188,6,10,1506,5,395,42.0,127.0,127.0,5,1111,42.0,843.0,843.0
0.004,17,4,284,2,120,0.0,32.0,32.0,2,164,1.0,60.0,54.0
0.006,6,10,1989,5,927,1.0,659.0,659.0,5,1062,1.0,794.0,794.0
0.004,6,10,2006,5,927,1.0,659.0,659.0,5,1079,1.0,811.0,811.0
0.007,17,2,166,1,75,0.0,47.0,47.0,1,91,0.0,63.0,63.0
0.089,6,10,1506,5,395,20.0,127.0,127.0,5,1111,20.0,843.0,843.0
0.005,6,10,1689,5,839,1.0,571.0,571.0,5,850,1.0,582.0,582.0
0.005,17,2,234,1,61,0.0,33.0,33.0,1,173,0.0,145.0,145.0
0.017,6,10,1983,5,910,4.0,642.0,642.0,5,1073,4.0,805.0,805.0
0.014,6,14,3787,7,497,2.0,125.0,125.0,7,3290,2.0,1448.0,972.0
0.042,6,10,1989,5,910,10.0,642.0,642.0,5,1079,10.0,811.0,811.0
0.134,6,10,1506,5,395,32.0,127.0,127.0,5,1111,28.0,843.0,843.0
0.055,6,10,1506,5,395,11.0,127.0,127.0,5,1111,12.0,843.0,843.0
40.064,17,10,676,5,460,10015.0,104.0,64.0,5,216,10015.0,20.0,15.0
0.001,17,2,180,1,66,0.0,38.0,38.0,1,114,0.0,86.0,86.0
0.04,17,2,198,1,91,0.0,63.0,63.0,1,107,0.0,79.0,79.0
0.01,6,10,1990,5,911,2.0,643.0,643.0,5,1079,2.0,811.0,811.0
0.004,6,10,2006,5,927,1.0,659.0,659.0,5,1079,1.0,811.0,811.0
0.004,6,13,3690,7,452,0.0,80.0,80.0,6,3238,0.0,1470.0,1459.0
356.624,6,21,1795,16,1030,23774.0,190.0,190.0,5,765,60003.0,464.0,248.0
0.009,6,10,1989,5,910,2.0,642.0,642.0,5,1079,2.0,811.0,811.0
0.258,17,44,24483,25,21221,10.0,1350.0,820.0,19,3262,10.0,1350.0,143.0
40.071,17,10,676,5,460,10014.0,104.0,64.0,5,216,10017.0,20.0,15.0
0.066,17,8,3613,4,1874,22.0,1350.0,440.0,4,1739,10.0,1350.0,406.0
0.006,6,10,2007,5,928,1.0,660.0,660.0,5,1079,1.0,811.0,811.0
0.165,17,2,213,1,69,0.0,41.0,41.0,1,144,0.0,116.0,116.0
0.171,6,3,453,2,321,171.0,241.0,241.0,1,132,0.0,92.0,92.0
14.099,17,45,10364,23,5471,635.0,1337.0,209.0,22,4893,665.0,862.0,194.0
0.004,17,2,148,1,60,0.0,32.0,32.0,1,88,0.0,60.0,60.0
0.012,6,10,1990,5,911,3.0,643.0,643.0,5,1079,3.0,811.0,811.0
0.005,17,2,164,1,74,0.0,46.0,46.0,1,90,0.0,62.0,62.0
0.01,6,14,3787,7,497,1.0,125.0,125.0,7,3290,1.0,1448.0,972.0
0.066,6,10,1506,5,395,14.0,127.0,127.0,5,1111,14.0,843.0,843.0
0.006,6,10,1854,5,889,1.0,621.0,621.0,5,965,1.0,697.0,697.0
0.033,6,10,1983,5,910,8.0,642.0,642.0,5,1073,8.0,805.0,805.0
0.004,6,10,2000,5,927,1.0,659.0,659.0,5,1073,1.0,805.0,805.0
300.346,6,16,2170,9,684,37522.0,146.0,146.0,7,1486,50030.0,419.0,398.0
0.014,6,10,1990,5,911,3.0,643.0,643.0,5,1079,3.0,811.0,811.0
0.087,6,10,1506,5,395,17.0,127.0,127.0,5,1111,20.0,843.0,843.0
0.091,6,10,1506,5,395,20.0,127.0,127.0,5,1111,21.0,843.0,843.0
0.012,6,10,1989,5,910,2.0,642.0,642.0,5,1079,3.0,811.0,811.0
0.004,6,10,2000,5,927,1.0,659.0,659.0,5,1073,1.0,805.0,805.0
0.005,6,10,1689,5,839,1.0,571.0,571.0,5,850,1.0,582.0,582.0
0.005,6,10,1547,5,764,1.0,496.0,496.0,5,783,1.0,515.0,515.0
0.028,17,2,136,1,60,0.0,32.0,32.0,1,76,0.0,48.0,48.0
0.01,6,10,1989,5,910,2.0,642.0,642.0,5,1079,2.0,811.0,811.0
0.004,6,10,2007,5,928,1.0,660.0,660.0,5,1079,1.0,811.0,811.0
0.001,17,2,180,1,66,0.0,38.0,38.0,1,114,0.0,86.0,86.0
308.713,17,20,1124,10,716,34287.0,48.0,43.0,10,408,34287.0,20.0,12.0
0.006,6,10,1643,5,860,1.0,592.0,592.0,5,783,1.0,515.0,515.0
0.011,17,2,179,1,71,0.0,43.0,43.0,1,108,0.0,80.0,80.0
0.112,6,10,1506,5,395,24.0,127.0,127.0,5,1111,22.0,843.0,843.0
0.005,6,10,1689,5,839,1.0,571.0,571.0,5,850,1.0,582.0,582.0
0.005,17,2,140,1,62,0.0,34.0,34.0,1,78,0.0,50.0,50.0
0.004,6,10,1989,5,927,1.0,659.0,659.0,5,1062,1.0,794.0,794.0
0.017,6,10,1972,5,910,4.0,642.0,642.0,5,1062,4.0,794.0,794.0
0.01,6,10,1989,5,910,2.0,642.0,642.0,5,1079,2.0,811.0,811.0
240.572,6,27,7886,12,3525,21870.0,1211.0,726.0,15,4361,17183.0,1162.0,397.0
0.081,6,10,1506,5,395,18.0,127.0,127.0,5,1111,18.0,843.0,843.0
0.005,6,10,1779,5,928,1.0,660.0,660.0,5,851,1.0,583.0,583.0
0.078,6,10,1506,5,395,17.0,127.0,127.0,5,1111,16.0,843.0,843.0
0.076,6,10,1506,5,395,16.0,127.0,127.0,5,1111,16.0,843.0,843.0
0.015,6,10,1989,5,910,3.0,642.0,642.0,5,1079,3.0,811.0,811.0
0.006,17,2,230,1,68,0.0,40.0,40.0,1,162,0.0,134.0,134.0
15.118,17,19,13436,9,8280,1886.0,1350.0,892.0,10,5156,1676.0,1350.0,487.0
0.005,17,2,179,1,71,0.0,43.0,43.0,1,108,0.0,80.0,80.0
0.009,6,10,1972,5,910,2.0,642.0,642.0,5,1062,2.0,794.0,794.0
0.064,6,10,1506,5,395,13.0,127.0,127.0,5,1111,14.0,843.0,843.0
66.233,6,27,17548,15,9603,4730.0,2804.0,1469.0,12,7945,6005.0,2316.0,1218.0
0.042,17,2,182,1,65,0.0,37.0,37.0,1,117,0.0,89.0,89.0
40.078,17,10,676,5,460,10016.0,104.0,64.0,5,216,10018.0,20.0,15.0
0.005,6,14,3742,7,452,0.0,80.0,80.0,7,3290,0.0,1448.0,972.0
174.142,17,78,11010,39,2609,4582.0,44.0,38.0,39,8401,4582.0,261.0,187.0
0.004,17,2,136,1,60,0.0,32.0,32.0,1,76,0.0,48.0,48.0
0.0,17,2,136,1,60,0.0,32.0,32.0,1,76,0.0,48.0,48.0
0.005,6,10,1643,5,860,1.0,592.0,592.0,5,783,1.0,515.0,515.0
0.013,17,2,152,1,76,0.0,48.0,48.0,1,76,0.0,48.0,48.0
352.789,6,20,2210,6,1308,12003.0,494.0,494.0,14,902,27137.0,83.0,83.0
0.005,17,2,214,1,75,0.0,47.0,47.0,1,139,0.0,111.0,111.0
0.072,17,2,170,1,65,0.0,37.0,37.0,1,105,0.0,77.0,77.0
0.01,6,10,1972,5,910,2.0,642.0,642.0,5,1062,2.0,794.0,794.0
293.123,6,308,343965,118,17696,2505.0,2736.0,889.0,190,326269,1550.0,4206.0,1797.0
0.015,17,2,198,1,91,0.0,63.0,63.0,1,107,0.0,79.0,79.0
0.006,6,10,1547,5,764,1.0,496.0,496.0,5,783,1.0,515.0,515.0
0.001,17,2,180,1,66,0.0,38.0,38.0,1,114,0.0,86.0,86.0
0.04,17,2,152,1,76,0.0,48.0,48.0,1,76,0.0,48.0,48.0
0.014,6,10,1989,5,910,3.0,642.0,642.0,5,1079,3.0,811.0,811.0
0.001,17,2,179,1,62,0.0,34.0,34.0,1,117,0.0,89.0,89.0
0.009,6,10,1972,5,910,2.0,642.0,642.0,5,1062,2.0,794.0,794.0
0.089,6,10,1506,5,395,20.0,127.0,127.0,5,1111,17.0,843.0,843.0
0.001,17,2,180,1,65,0.0,37.0,37.0,1,115,0.0,87.0,87.0
1777.305,17,143,41496,72,22752,25032.0,288.0,288.0,71,18744,25389.0,236.0,236.0
0.043,17,2,136,1,60,0.0,32.0,32.0,1,76,0.0,48.0,48.0
0.005,6,10,1702,5,863,1.0,595.0,595.0,5,839,1.0,571.0,571.0
0.008,6,10,1972,5,910,2.0,642.0,642.0,5,1062,2.0,794.0,794.0
0.007,17,2,194,1,59,0.0,31.0,31.0,1,135,0.0,107.0,107.0
0.006,6,10,1689,5,839,1.0,571.0,571.0,5,850,1.0,582.0,582.0
0.004,17,2,164,1,74,0.0,46.0,46.0,1,90,0.0,62.0,62.0
0.004,17,4,284,2,120,0.0,32.0,32.0,2,164,0.0,60.0,54.0
290.003,6,400,347828,191,21503,1526.0,2736.0,889.0,209,326325,1394.0,2804.0,1617.0
0.009,6,10,1972,5,910,2.0,642.0,642.0,5,1062,2.0,794.0,794.0
0.005,6,10,2006,5,927,1.0,659.0,659.0,5,1079,1.0,811.0,811.0
0.151,6,10,1506,5,395,28.0,127.0,127.0,5,1111,35.0,843.0,843.0
0.003,17,4,284,2,120,0.0,32.0,32.0,2,164,0.0,60.0,54.0
0.074,6,10,1506,5,395,14.0,127.0,127.0,5,1111,17.0,843.0,843.0
0.005,6,10,1779,5,928,1.0,660.0,660.0,5,851,1.0,583.0,583.0
0.129,17,2,144,1,64,0.0,36.0,36.0,1,80,0.0,52.0,52.0
0.012,6,10,1989,5,910,2.0,642.0,642.0,5,1079,3.0,811.0,811.0
40.101,17,10,676,5,460,10019.0,104.0,64.0,5,216,10022.0,20.0,15.0
0.014,6,10,1983,5,910,3.0,642.0,642.0,5,1073,3.0,805.0,805.0
99.992,6,24,9399,11,1575,80.0,794.0,367.0,13,7824,8321.0,1360.0,810.0
0.005,6,10,2006,5,927,1.0,659.0,659.0,5,1079,1.0,811.0,811.0
65.951,6,27,17576,15,9627,4710.0,2804.0,1473.0,12,7949,5980.0,2320.0,1219.0
0.014,6,10,1990,5,911,3.0,643.0,643.0,5,1079,3.0,811.0,811.0
0.009,6,10,1631,5,848,2.0,580.0,580.0,5,783,2.0,515.0,515.0
0.016,6,10,1989,5,910,4.0,642.0,642.0,5,1079,4.0,811.0,811.0
0.013,6,10,1990,5,911,3.0,643.0,643.0,5,1079,3.0,811.0,811.0
0.004,6,10,2006,5,927,1.0,659.0,659.0,5,1079,1.0,811.0,811.0
0.007,17,2,179,1,71,0.0,43.0,43.0,1,108,0.0,80.0,80.0
0.025,6,13,3735,7,497,4.0,125.0,125.0,6,3238,4.0,1470.0,1459.0
0.014,6,10,1990,5,911,3.0,643.0,643.0,5,1079,3.0,811.0,811.0
0.065,6,10,1506,5,395,16.0,127.0,127.0,5,1111,15.0,843.0,843.0
0.006,17,2,136,1,60,0.0,32.0,32.0,1,76,0.0,48.0,48.0
0.109,6,10,1506,5,395,22.0,127.0,127.0,5,1111,21.0,843.0,843.0
0.011,6,10,1990,5,911,2.0,643.0,643.0,5,1079,2.0,811.0,811.0
0.014,6,10,1990,5,911,3.0,643.0,643.0,5,1079,3.0,811.0,811.0
0.014,6,10,1972,5,910,3.0,642.0,642.0,5,1062,3.0,794.0,794.0
0.073,6,10,1506,5,395,14.0,127.0,127.0,5,1111,16.0,843.0,843.0
0.006,17,2,170,1,65,0.0,37.0,37.0,1,105,0.0,77.0,77.0
0.01,6,10,1983,5,910,2.0,642.0,642.0,5,1073,2.0,805.0,805.0
0.037,17,2,152,1,76,0.0,48.0,48.0,1,76,0.0,48.0,48.0
0.051,6,13,3913,7,495,8.0,123.0,123.0,6,3418,10.0,1650.0,1549.0
40.061,17,10,676,5,460,10014.0,104.0,64.0,5,216,10014.0,20.0,15.0
0.018,6,10,1677,5,827,4.0,559.0,559.0,5,850,4.0,582.0,582.0
0.005,17,2,214,1,75,0.0,47.0,47.0,1,139,0.0,111.0,111.0
0.006,6,10,1989,5,927,1.0,659.0,659.0,5,1062,1.0,794.0,794.0
15.031,17,42,20310,22,17089,714.0,1350.0,748.0,20,3221,789.0,1350.0,133.0
0.712,6,22,5072,11,1250,60.0,325.0,133.0,11,3822,60.0,1414.0,563.0
0.087,6,10,1506,5,395,19.0,127.0,127.0,5,1111,20.0,843.0,843.0
0.223,6,16,2669,8,1395,31.0,533.0,323.0,8,1274,20.0,529.0,212.0
0.069,17,8,3613,4,1874,23.0,1350.0,440.0,4,1739,12.0,1350.0,406.0
0.059,6,10,1506,5,395,12.0,127.0,127.0,5,1111,13.0,843.0,843.0
0.063,6,10,1506,5,395,13.0,127.0,127.0,5,1111,14.0,843.0,843.0
0.015,6,10,1762,5,911,3.0,643.0,643.0,5,851,3.0,583.0,583.0
40.065,17,10,676,5,460,10013.0,104.0,64.0,5,216,10015.0,20.0,15.0
0.027,6,10,1972,5,910,6.0,642.0,642.0,5,1062,6.0,794.0,794.0
0.162,6,10,1506,5,395,38.0,127.0,127.0,5,1111,17.0,843.0,843.0
0.013,6,10,2007,5,928,3.0,660.0,660.0,5,1079,3.0,811.0,811.0
0.004,17,4,284,2,120,0.0,32.0,32.0,2,164,0.0,60.0,54.0
40.055,17,10,676,5,460,10010.0,104.0,64.0,5,216,10012.0,20.0,15.0
0.072,6,10,1506,5,395,13.0,127.0,127.0,5,1111,16.0,843.0,843.0
308.682,17,20,1124,10,716,34291.0,48.0,43.0,10,408,34290.0,20.0,12.0
0.01,6,10,1990,5,911,2.0,643.0,643.0,5,1079,2.0,811.0,811.0
0.005,6,10,1547,5,764,1.0,496.0,496.0,5,783,1.0,515.0,515.0
0.083,6,10,1506,5,395,18.0,127.0,127.0,5,1111,17.0,843.0,843.0
240.023,6,9,787,5,488,60005.0,232.0,232.0,4,299,80006.0,83.0,83.0
0.005,17,2,140,1,62,0.0,34.0,34.0,1,78,0.0,50.0,50.0
1776.78,6,280,41506,112,22412,16005.0,2720.0,205.0,168,19094,10638.0,1360.0,150.0
0.004,17,2,148,1,60,0.0,32.0,32.0,1,88,0.0,60.0,60.0
40.074,17,10,676,5,460,10015.0,104.0,64.0,5,216,10017.0,20.0,15.0
0.004,17,4,284,2,120,1.0,32.0,32.0,2,164,0.0,60.0,54.0
0.22,6,16,2777,8,1395,31.0,533.0,323.0,8,1382,20.0,529.0,239.0
0.028,6,10,1990,5,911,7.0,643.0,643.0,5,1079,7.0,811.0,811.0
0.011,6,10,1989,5,910,2.0,642.0,642.0,5,1079,2.0,811.0,811.0
0.005,17,2,140,1,62,0.0,34.0,34.0,1,78,0.0,50.0,50.0
0.022,6,10,1990,5,911,5.0,643.0,643.0,5,1079,5.0,811.0,811.0
0.004,17,2,148,1,60,0.0,32.0,32.0,1,88,0.0,60.0,60.0
0.004,17,4,284,2,120,0.0,32.0,32.0,2,164,1.0,60.0,54.0
0.012,6,10,1631,5,848,3.0,580.0,580.0,5,783,2.0,515.0,515.0
0.207,6,16,2777,8,1395,29.0,533.0,323.0,8,1382,18.0,529.0,239.0
0.004,17,2,185,1,73,0.0,45.0,45.0,1,112,0.0,84.0,84.0
0.111,6,10,1506,5,395,26.0,127.0,127.0,5,1111,25.0,843.0,843.0
0.004,6,10,2000,5,927,1.0,659.0,659.0,5,1073,1.0,805.0,805.0
0.005,17,2,166,1,75,0.0,47.0,47.0,1,91,0.0,63.0,63.0
0.003,17,2,136,1,60,0.0,32.0,32.0,1,76,0.0,48.0,48.0
1.778,6,35,6654,19,3451,98.0,1103.0,204.0,16,3203,110.0,1402.0,391.0
0.012,6,10,1990,5,911,2.0,643.0,643.0,5,1079,2.0,811.0,811.0
0.01,6,10,1989,5,910,2.0,642.0,642.0,5,1079,2.0,811.0,811.0
0.005,6,10,1689,5,839,1.0,571.0,571.0,5,850,1.0,582.0,582.0
0.013,6,10,1972,5,910,3.0,642.0,642.0,5,1062,3.0,794.0,794.0
0.11,6,10,1506,5,395,24.0,127.0,127.0,5,1111,22.0,843.0,843.0
0.011,6,10,1990,5,911,2.0,643.0,643.0,5,1079,2.0,811.0,811.0
0.004,6,10,2007,5,928,1.0,660.0,660.0,5,1079,1.0,811.0,811.0
356.628,6,21,1795,16,1030,23775.0,190.0,190.0,5,765,60003.0,464.0,248.0
0.009,6,12,1926,6,1189,1.0,659.0,434.0,6,737,1.0,417.0,417.0
0.001,17,2,180,1,66,0.0,38.0,38.0,1,114,0.0,86.0,86.0
0.071,17,2,234,1,61,0.0,33.0,33.0,1,173,0.0,145.0,145.0
0.039,17,2,412,1,61,0.0,33.0,33.0,1,351,0.0,323.0,323.0
0.005,17,2,412,1,61,0.0,33.0,33.0,1,351,0.0,323.0,323.0
0.007,6,10,1547,5,764,1.0,496.0,496.0,5,783,1.0,515.0,515.0
40.055,17,10,676,5,460,10011.0,104.0,64.0,5,216,10013.0,20.0,15.0
0.006,17,2,214,1,75,0.0,47.0,47.0,1,139,0.0,111.0,111.0
0.029,17,4,420,2,122,0.0,33.0,33.0,2,298,0.0,145.0,121.0
0.004,17,4,284,2,120,1.0,32.0,32.0,2,164,0.0,60.0,54.0
379.153,6,22,2313,16,867,25276.0,195.0,195.0,6,1446,4698.0,419.0,398.0
0.005,6,10,2007,5,928,1.0,660.0,660.0,5,1079,1.0,811.0,811.0
0.02,6,10,1972,5,910,4.0,642.0,642.0,5,1062,4.0,794.0,794.0
40.06,17,10,676,5,460,10014.0,104.0,64.0,5,216,10014.0,20.0,15.0
0.077,6,10,1506,5,395,17.0,127.0,127.0,5,1111,17.0,843.0,843.0
0.104,6,10,1506,5,395,22.0,127.0,127.0,5,1111,23.0,843.0,843.0
0.005,6,10,1989,5,927,1.0,659.0,659.0,5,1062,1.0,794.0,794.0
0.014,6,10,1989,5,910,3.0,642.0,642.0,5,1079,3.0,811.0,811.0
0.015,6,10,1972,5,910,3.0,642.0,642.0,5,1062,3.0,794.0,794.0
0.01,6,10,1972,5,910,2.0,642.0,642.0,5,1062,2.0,794.0,794.0
0.013,6,10,1990,5,911,3.0,643.0,643.0,5,1079,3.0,811.0,811.0
0.004,6,10,1774,5,923,1.0,655.0,655.0,5,851,1.0,583.0,583.0
0.004,6,10,2006,5,927,1.0,659.0,659.0,5,1079,1.0,811.0,811.0
0.005,6,10,2006,5,927,1.0,659.0,659.0,5,1079,1.0,811.0,811.0
40.077,17,10,676,5,460,10016.0,104.0,64.0,5,216,10018.0,20.0,15.0
0.014,6,10,1631,5,848,3.0,580.0,580.0,5,783,3.0,515.0,515.0
290.328,6,315,343455,125,18050,2341.0,2736.0,888.0,190,325405,1536.0,2804.0,1792.0
0.041,17,2,166,1,75,0.0,47.0,47.0,1,91,0.0,63.0,63.0
0.006,6,10,1547,5,764,1.0,496.0,496.0,5,783,1.0,515.0,515.0
0.055,6,13,3816,7,578,9.0,206.0,206.0,6,3238,11.0,1470.0,1459.0
11.021,17,28,4422,14,1993,839.0,268.0,114.0,14,2429,839.0,588.0,145.0
0.01,6,10,1972,5,910,2.0,642.0,642.0,5,1062,2.0,794.0,794.0
0.068,17,2,152,1,76,0.0,48.0,48.0,1,76,0.0,48.0,48.0
0.008,6,10,1989,5,910,2.0,642.0,642.0,5,1079,2.0,811.0,811.0
0.003,17,4,284,2,120,0.0,32.0,32.0,2,164,0.0,60.0,54.0
0.006,6,10,1854,5,889,1.0,621.0,621.0,5,965,1.0,697.0,697.0
0.005,6,10,1643,5,860,1.0,592.0,592.0,5,783,1.0,515.0,515.0
0.006,6,10,1547,5,764,1.0,496.0,496.0,5,783,1.0,515.0,515.0
40.063,17,10,676,5,460,10014.0,104.0,64.0,5,216,10014.0,20.0,15.0
0.118,6,10,1506,5,395,27.0,127.0,127.0,5,1111,27.0,843.0,843.0
0.005,6,10,2006,5,927,1.0,659.0,659.0,5,1079,1.0,811.0,811.0
0.116,6,10,1506,5,395,26.0,127.0,127.0,5,1111,19.0,843.0,843.0
0.013,6,10,1989,5,910,3.0,642.0,642.0,5,1079,3.0,811.0,811.0
0.039,17,2,152,1,76,0.0,48.0,48.0,1,76,0.0,48.0,48.0
0.006,17,2,179,1,71,0.0,43.0,43.0,1,108,0.0,80.0,80.0
0.108,6,10,1506,5,395,25.0,127.0,127.0,5,1111,22.0,843.0,843.0
40.043,17,10,676,5,460,10009.0,104.0,64.0,5,216,10010.0,20.0,15.0
0.013,6,10,1989,5,910,3.0,642.0,642.0,5,1079,3.0,811.0,811.0
0.005,6,10,2006,5,927,1.0,659.0,659.0,5,1079,1.0,811.0,811.0
0.005,17,2,170,1,65,0.0,37.0,37.0,1,105,0.0,77.0,77.0
0.038,17,2,184,1,61,0.0,33.0,33.0,1,123,0.0,95.0,95.0
0.006,6,10,1689,5,839,1.0,571.0,571.0,5,850,1.0,582.0,582.0
361.863,6,21,1793,16,1030,24124.0,190.0,190.0,5,763,60009.0,462.0,247.0
0.004,6,10,1774,5,923,1.0,655.0,655.0,5,851,1.0,583.0,583.0
0.009,6,10,1972,5,910,2.0,642.0,642.0,5,1062,2.0,794.0,794.0
0.006,6,10,1547,5,764,1.0,496.0,496.0,5,783,1.0,515.0,515.0
10.939,17,28,4394,14,2313,833.0,588.0,137.0,14,2081,832.0,268.0,120.0
0.127,6,10,1506,5,395,24.0,127.0,127.0,5,1111,30.0,843.0,843.0
0.004,6,10,1702,5,863,1.0,595.0,595.0,5,839,1.0,571.0,571.0
0.038,17,4,284,2,120,0.0,32.0,32.0,2,164,34.0,60.0,54.0
0.11,6,10,1506,5,395,25.0,127.0,127.0,5,1111,22.0,843.0,843.0
0.017,6,10,1631,5,848,4.0,580.0,580.0,5,783,4.0,515.0,515.0
0.128,17,2,80,1,32,0.0,4.0,4.0,1,48,0.0,20.0,20.0
15.075,17,15,9239,8,6902,2149.0,1350.0,834.0,7,2337,2507.0,1350.0,305.0
0.111,6,10,1506,5,395,25.0,127.0,127.0,5,1111,21.0,843.0,843.0
0.006,6,10,1547,5,764,1.0,496.0,496.0,5,783,1.0,515.0,515.0
0.017,6,10,1990,5,911,4.0,643.0,643.0,5,1079,4.0,811.0,811.0
0.011,6,10,1990,5,911,2.0,643.0,643.0,5,1079,2.0,811.0,811.0
377.425,6,22,2313,16,867,25161.0,195.0,195.0,6,1446,4652.0,419.0,398.0
0.004,6,10,2006,5,927,1.0,659.0,659.0,5,1079,1.0,811.0,811.0
0.079,6,10,1506,5,395,16.0,127.0,127.0,5,1111,18.0,843.0,843.0
0.026,6,14,3787,7,497,4.0,125.0,125.0,7,3290,4.0,1448.0,972.0
0.005,17,2,136,1,60,0.0,32.0,32.0,1,76,0.0,48.0,48.0
0.004,17,4,284,2,120,0.0,32.0,32.0,2,164,0.0,60.0,54.0
0.015,17,2,213,1,69,0.0,41.0,41.0,1,144,0.0,116.0,116.0
0.058,6,10,1506,5,395,13.0,127.0,127.0,5,1111,12.0,843.0,843.0
0.014,6,10,1972,5,910,3.0,642.0,642.0,5,1062,3.0,794.0,794.0
0.044,6,10,1989,5,910,11.0,642.0,642.0,5,1079,10.0,811.0,811.0
40.068,17,10,676,5,460,10016.0,104.0,64.0,5,216,10015.0,20.0,15.0
0.001,17,2,180,1,66,0.0,38.0,38.0,1,114,0.0,86.0,86.0
0.008,6,10,1989,5,910,2.0,642.0,642.0,5,1079,2.0,811.0,811.0
0.005,6,14,3742,7,452,0.0,80.0,80.0,7,3290,0.0,1448.0,972.0
40.063,17,10,676,5,460,10013.0,104.0,64.0,5,216,10015.0,20.0,15.0
0.072,6,10,1506,5,395,16.0,127.0,127.0,5,1111,14.0,843.0,843.0
0.126,17,2,156,1,64,0.0,36.0,36.0,1,92,0.0,64.0,64.0
0.001,17,2,180,1,66,0.0,38.0,38.0,1,114,0.0,86.0,86.0
0.062,17,2,80,1,32,0.0,4.0,4.0,1,48,0.0,20.0,20.0
0.004,6,10,2006,5,927,1.0,659.0,659.0,5,1079,1.0,811.0,811.0
0.011,6,10,1972,5,910,2.0,642.0,642.0,5,1062,2.0,794.0,794.0
0.011,6,12,1926,6,1189,2.0,659.0,434.0,6,737,2.0,417.0,417.0
0.009,6,10,1972,5,910,2.0,642.0,642.0,5,1062,2.0,794.0,794.0
0.005,6,10,2006,5,927,1.0,659.0,659.0,5,1079,1.0,811.0,811.0
0.008,6,14,3799,7,509,1.0,137.0,137.0,7,3290,1.0,1448.0,972.0
0.005,6,10,1989,5,927,1.0,659.0,659.0,5,1062,1.0,794.0,794.0
0.006,6,10,1547,5,764,1.0,496.0,496.0,5,783,1.0,515.0,515.0
0.005,17,2,212,1,74,0.0,46.0,46.0,1,138,0.0,110.0,110.0
240.075,6,16,4482,9,963,30009.0,238.0,166.0,7,3519,40012.0,1402.0,786.0
0.009,6,12,1926,6,1189,1.0,659.0,434.0,6,737,1.0,417.0,417.0
240.086,6,16,4482,9,963,30010.0,238.0,166.0,7,3519,40013.0,1402.0,786.0
293.545,6,370,346604,189,21388,1561.0,2690.0,888.0,181,325216,1630.0,4171.0,1890.0
0.004,6,10,1702,5,863,1.0,595.0,595.0,5,839,0.0,571.0,571.0
0.017,6,10,1631,5,848,4.0,580.0,580.0,5,783,4.0,515.0,515.0
0.007,6,10,1972,5,910,1.0,642.0,642.0,5,1062,1.0,794.0,794.0
0.018,6,10,1631,5,848,4.0,580.0,580.0,5,783,4.0,515.0,515.0
0.001,17,2,180,1,66,0.0,38.0,38.0,1,114,0.0,86.0,86.0
15.183,17,20,11078,10,7419,1683.0,1350.0,713.0,10,3659,1682.0,1350.0,337.0
0.0,17,2,180,1,66,0.0,38.0,38.0,1,114,0.0,86.0,86.0
0.012,6,10,1677,5,827,3.0,559.0,559.0,5,850,3.0,582.0,582.0
0.005,6,10,1547,5,764,1.0,496.0,496.0,5,783,1.0,515.0,515.0
0.002,17,2,166,1,75,0.0,47.0,47.0,1,91,0.0,63.0,63.0
0.01,6,10,1762,5,911,2.0,643.0,643.0,5,851,2.0,583.0,583.0
0.005,6,10,1689,5,839,1.0,571.0,571.0,5,850,1.0,582.0,582.0
308.394,17,20,1124,10,716,34252.0,48.0,43.0,10,408,34252.0,20.0,12.0
0.005,6,10,2000,5,927,1.0,659.0,659.0,5,1073,1.0,805.0,805.0
61.091,6,20,10036,11,3921,6109.0,1591.0,838.0,9,6115,7620.0,2111.0,939.0
0.011,6,10,1989,5,910,2.0,642.0,642.0,5,1079,2.0,811.0,811.0
0.017,6,10,1972,5,910,4.0,642.0,642.0,5,1062,4.0,794.0,794.0
0.074,6,10,1506,5,395,18.0,127.0,127.0,5,1111,13.0,843.0,843.0
0.084,6,45,14099,25,2617,3.0,517.0,146.0,20,11482,4.0,1402.0,745.0
0.113,6,10,1506,5,395,26.0,127.0,127.0,5,1111,25.0,843.0,843.0
0.016,6,10,1990,5,911,4.0,643.0,643.0,5,1079,3.0,811.0,811.0
0.041,17,4,596,2,122,0.0,33.0,33.0,2,474,1.0,323.0,209.0
1777.787,17,144,45504,72,22752,25039.0,288.0,288.0,72,22752,25039.0,288.0,288.0
0.005,6,10,2006,5,927,1.0,659.0,659.0,5,1079,1.0,811.0,811.0
10.711,17,26,4102,13,1822,883.0,269.0,112.0,13,2280,883.0,587.0,147.0
0.009,6,10,1983,5,910,2.0,642.0,642.0,5,1073,2.0,805.0,805.0
0.013,6,10,1983,5,910,3.0,642.0,642.0,5,1073,3.0,805.0,805.0
40.057,17,10,676,5,460,10012.0,104.0,64.0,5,216,10013.0,20.0,15.0
0.014,6,10,1989,5,910,3.0,642.0,642.0,5,1079,3.0,811.0,811.0
0.005,6,10,2006,5,927,1.0,659.0,659.0,5,1079,1.0,811.0,811.0
0.005,6,10,2007,5,928,1.0,660.0,660.0,5,1079,1.0,811.0,811.0
0.005,6,10,1854,5,889,1.0,621.0,621.0,5,965,1.0,697.0,697.0
0.005,17,2,230,1,68,0.0,40.0,40.0,1,162,0.0,134.0,134.0
0.012,6,13,3735,7,497,2.0,125.0,125.0,6,3238,2.0,1470.0,1459.0
0.014,6,10,1990,5,911,3.0,643.0,643.0,5,1079,3.0,811.0,811.0
0.009,6,10,1990,5,911,2.0,643.0,643.0,5,1079,2.0,811.0,811.0
0.013,6,10,1990,5,911,3.0,643.0,643.0,5,1079,3.0,811.0,811.0
0.014,6,10,1989,5,910,3.0,642.0,642.0,5,1079,3.0,811.0,811.0
0.011,6,10,1990,5,911,2.0,643.0,643.0,5,1079,2.0,811.0,811.0
10.898,17,28,4422,14,1994,829.0,269.0,114.0,14,2428,828.0,587.0,145.0
0.006,6,10,1547,5,764,1.0,496.0,496.0,5,783,1.0,515.0,515.0
0.097,6,10,1506,5,395,21.0,127.0,127.0,5,1111,22.0,843.0,843.0
0.009,6,10,1990,5,911,2.0,643.0,643.0,5,1079,2.0,811.0,811.0
0.004,6,10,2000,5,927,1.0,659.0,659.0,5,1073,1.0,805.0,805.0
0.005,6,10,1779,5,928,1.0,660.0,660.0,5,851,1.0,583.0,583.0
265.64,6,23,5810,12,2492,24149.0,676.0,372.0,11,3318,26563.0,1402.0,550.0
0.075,6,10,1506,5,395,17.0,127.0,127.0,5,1111,14.0,843.0,843.0
372.113,6,19,1691,15,978,26579.0,190.0,190.0,4,713,80028.0,497.0,497.0
0.005,6,10,2007,5,928,1.0,660.0,660.0,5,1079,1.0,811.0,811.0
0.086,6,10,1506,5,395,19.0,127.0,127.0,5,1111,20.0,843.0,843.0
0.024,6,10,1972,5,910,5.0,642.0,642.0,5,1062,6.0,794.0,794.0
0.087,6,10,1506,5,395,19.0,127.0,127.0,5,1111,21.0,843.0,843.0
0.018,6,10,1972,5,910,4.0,642.0,642.0,5,1062,4.0,794.0,794.0
0.009,6,10,1762,5,911,2.0,643.0,643.0,5,851,2.0,583.0,583.0
0.004,17,2,136,1,60,0.0,32.0,32.0,1,76,0.0,48.0,48.0
0.091,6,10,1506,5,395,22.0,127.0,127.0,5,1111,21.0,843.0,843.0
0.086,6,10,1506,5,395,16.0,127.0,127.0,5,1111,20.0,843.0,843.0
10.826,17,28,4420,14,1993,823.0,268.0,114.0,14,2427,823.0,586.0,145.0
0.038,17,4,284,2,120,0.0,32.0,32.0,2,164,35.0,60.0,54.0
0.088,17,2,170,1,65,0.0,37.0,37.0,1,105,0.0,77.0,77.0
0.006,6,10,1547,5,764,1.0,496.0,496.0,5,783,1.0,515.0,515.0
0.007,17,2,194,1,59,0.0,31.0,31.0,1,135,0.0,107.0,107.0
40.064,17,10,676,5,460,10015.0,104.0,64.0,5,216,10015.0,20.0,15.0
0.015,6,10,1983,5,910,3.0,642.0,642.0,5,1073,3.0,805.0,805.0
0.005,6,10,1643,5,860,1.0,592.0,592.0,5,783,1.0,515.0,515.0
0.042,17,2,182,1,65,0.0,37.0,37.0,1,117,0.0,89.0,89.0
240.089,6,16,4481,9,963,30011.0,238.0,166.0,7,3518,40014.0,1402.0,786.0
11.205,17,28,4422,14,1993,849.0,268.0,114.0,14,2429,849.0,588.0,145.0
40.056,17,10,676,5,460,10013.0,104.0,64.0,5,216,10013.0,20.0,15.0
0.021,6,10,1972,5,910,5.0,642.0,642.0,5,1062,5.0,794.0,794.0
0.007,6,10,1689,5,839,1.0,571.0,571.0,5,850,1.0,582.0,582.0
0.009,6,10,1677,5,827,2.0,559.0,559.0,5,850,2.0,582.0,582.0
15.069,17,15,9239,8,6902,2148.0,1350.0,834.0,7,2337,2506.0,1350.0,305.0
0.07,6,10,1506,5,395,15.0,127.0,127.0,5,1111,15.0,843.0,843.0
0.005,6,10,2006,5,927,1.0,659.0,659.0,5,1079,1.0,811.0,811.0
0.082,6,10,1506,5,395,18.0,127.0,127.0,5,1111,18.0,843.0,843.0
0.006,17,2,248,1,68,0.0,40.0,40.0,1,180,0.0,152.0,152.0
0.009,6,10,1989,5,910,2.0,642.0,642.0,5,1079,2.0,811.0,811.0
0.09,6,10,1506,5,395,18.0,127.0,127.0,5,1111,21.0,843.0,843.0
0.112,6,10,1506,5,395,25.0,127.0,127.0,5,1111,23.0,843.0,843.0
0.011,6,10,1989,5,910,2.0,642.0,642.0,5,1079,2.0,811.0,811.0
0.094,6,10,1506,5,395,19.0,127.0,127.0,5,1111,22.0,843.0,843.0
0.119,6,30,10406,17,9046,7.0,1515.0,816.0,13,1360,9.0,249.0,114.0
40.06,17,10,676,5,460,10014.0,104.0,64.0,5,216,10014.0,20.0,15.0
361.795,6,21,1792,16,1030,24119.0,190.0,190.0,5,762,60009.0,461.0,247.0
0.003,6,10,1702,5,863,0.0,595.0,595.0,5,839,0.0,571.0,571.0
0.014,6,10,1990,5,911,3.0,643.0,643.0,5,1079,3.0,811.0,811.0
0.007,6,10,1989,5,927,1.0,659.0,659.0,5,1062,1.0,794.0,794.0
0.057,6,10,1506,5,395,14.0,127.0,127.0,5,1111,13.0,843.0,843.0
308.384,17,20,1124,10,716,34258.0,48.0,43.0,10,408,34258.0,20.0,12.0
0.004,6,10,2006,5,927,1.0,659.0,659.0,5,1079,1.0,811.0,811.0
0.005,17,2,170,1,65,0.0,37.0,37.0,1,105,0.0,77.0,77.0
0.011,6,10,1972,5,910,2.0,642.0,642.0,5,1062,2.0,794.0,794.0
0.004,17,4,284,2,120,0.0,32.0,32.0,2,164,1.0,60.0,54.0
1771.652,17,120,11460,60,5460,30027.0,63.0,63.0,60,6000,30027.0,72.0,72.0
308.452,17,20,1124,10,716,34257.0,48.0,43.0,10,408,34257.0,20.0,12.0
178.073,17,84,12228,42,2807,4343.0,44.0,38.0,42,9421,4343.0,239.0,196.0
0.004,17,2,208,1,72,0.0,44.0,44.0,1,136,0.0,108.0,108.0
0.005,6,10,2006,5,927,1.0,659.0,659.0,5,1079,1.0,811.0,811.0
0.006,6,14,3799,7,509,0.0,137.0,137.0,7,3290,0.0,1448.0,972.0
0.001,17,2,180,1,66,0.0,38.0,38.0,1,114,0.0,86.0,86.0
0.001,17,2,136,1,60,0.0,32.0,32.0,1,76,0.0,48.0,48.0
0.027,6,13,3735,7,497,4.0,125.0,125.0,6,3238,5.0,1470.0,1459.0
11.169,17,28,4421,14,1993,846.0,268.0,114.0,14,2428,846.0,587.0,145.0
0.005,6,10,1774,5,923,1.0,655.0,655.0,5,851,1.0,583.0,583.0
0.008,6,10,1983,5,910,2.0,642.0,642.0,5,1073,2.0,805.0,805.0
0.011,6,10,1989,5,910,2.0,642.0,642.0,5,1079,2.0,811.0,811.0
0.013,6,10,1989,5,910,3.0,642.0,642.0,5,1079,3.0,811.0,811.0
0.005,6,10,2007,5,928,1.0,660.0,660.0,5,1079,1.0,811.0,811.0
0.01,6,10,1989,5,910,2.0,642.0,642.0,5,1079,2.0,811.0,811.0
0.006,6,10,2006,5,927,1.0,659.0,659.0,5,1079,1.0,811.0,811.0
0.005,6,10,1989,5,927,1.0,659.0,659.0,5,1062,1.0,794.0,794.0
0.006,6,10,1547,5,764,1.0,496.0,496.0,5,783,1.0,515.0,515.0
0.005,6,10,2006,5,927,1.0,659.0,659.0,5,1079,1.0,811.0,811.0
0.006,6,10,1689,5,839,1.0,571.0,571.0,5,850,1.0,582.0,582.0
0.004,6,10,1774,5,923,1.0,655.0,655.0,5,851,1.0,583.0,583.0
0.005,6,10,1774,5,923,1.0,655.0,655.0,5,851,1.0,583.0,583.0
0.004,6,10,2006,5,927,1.0,659.0,659.0,5,1079,1.0,811.0,811.0
0.001,17,2,180,1,66,0.0,38.0,38.0,1,114,0.0,86.0,86.0
0.005,6,14,3799,7,509,0.0,137.0,137.0,7,3290,0.0,1448.0,972.0
368.552,6,22,2313,16,867,24570.0,195.0,195.0,6,1446,4637.0,419.0,398.0
0.005,17,2,170,1,65,0.0,37.0,37.0,1,105,0.0,77.0,77.0
0.001,17,2,180,1,66,0.0,38.0,38.0,1,114,0.0,86.0,86.0
0.01,17,2,179,1,71,0.0,43.0,43.0,1,108,0.0,80.0,80.0
0.001,17,2,180,1,66,0.0,38.0,38.0,1,114,0.0,86.0,86.0
0.07,6,10,1506,5,395,16.0,127.0,127.0,5,1111,14.0,843.0,843.0
0.011,6,10,1990,5,911,2.0,643.0,643.0,5,1079,2.0,811.0,811.0
0.012,6,13,3735,7,497,2.0,125.0,125.0,6,3238,2.0,1470.0,1459.0
0.008,6,13,3735,7,497,1.0,125.0,125.0,6,3238,1.0,1470.0,1459.0
317.143,17,20,1124,10,716,35223.0,48.0,43.0,10,408,35223.0,20.0,12.0
0.009,6,10,1774,5,923,2.0,655.0,655.0,5,851,2.0,583.0,583.0
0.007,6,10,1989,5,910,1.0,642.0,642.0,5,1079,1.0,811.0,811.0
0.004,6,10,1702,5,863,0.0,595.0,595.0,5,839,1.0,571.0,571.0
0.067,6,10,1506,5,395,14.0,127.0,127.0,5,1111,16.0,843.0,843.0
0.006,6,10,1989,5,927,1.0,659.0,659.0,5,1062,1.0,794.0,794.0
0.001,17,2,136,1,60,0.0,32.0,32.0,1,76,0.0,48.0,48.0
0.01,6,10,1990,5,911,2.0,643.0,643.0,5,1079,2.0,811.0,811.0
0.21,6,10,1506,5,395,46.0,127.0,127.0,5,1111,33.0,843.0,843.0
0.003,17,2,142,1,63,0.0,35.0,35.0,1,79,0.0,51.0,51.0
0.005,17,2,140,1,62,0.0,34.0,34.0,1,78,0.0,50.0,50.0
0.001,17,2,180,1,65,0.0,37.0,37.0,1,115,0.0,87.0,87.0
0.005,6,10,1547,5,764,1.0,496.0,496.0,5,783,1.0,515.0,515.0
313.166,17,20,1124,10,716,34781.0,48.0,43.0,10,408,34781.0,20.0,12.0
0.013,6,10,1983,5,910,3.0,642.0,642.0,5,1073,3.0,805.0,805.0
0.141,6,10,1506,5,395,33.0,127.0,127.0,5,1111,33.0,843.0,843.0
177.571,17,76,10748,38,2529,4799.0,44.0,38.0,38,8219,4799.0,239.0,188.0
40.058,17,10,676,5,460,10012.0,104.0,64.0,5,216,10012.0,20.0,15.0
0.01,6,10,1989,5,910,2.0,642.0,642.0,5,1079,2.0,811.0,811.0
0.004,6,10,1779,5,928,1.0,660.0,660.0,5,851,1.0,583.0,583.0
0.009,6,10,1762,5,911,2.0,643.0,643.0,5,851,2.0,583.0,583.0
0.144,6,10,1506,5,395,30.0,127.0,127.0,5,1111,33.0,843.0,843.0
0.006,17,2,179,1,71,0.0,43.0,43.0,1,108,0.0,80.0,80.0
0.013,6,10,1989,5,910,3.0,642.0,642.0,5,1079,3.0,811.0,811.0
0.005,17,2,179,1,71,0.0,43.0,43.0,1,108,0.0,80.0,80.0
0.004,6,10,2006,5,927,1.0,659.0,659.0,5,1079,1.0,811.0,811.0
0.079,6,10,1506,5,395,17.0,127.0,127.0,5,1111,17.0,843.0,843.0
0.091,6,10,1506,5,395,22.0,127.0,127.0,5,1111,21.0,843.0,843.0
0.006,6,10,1547,5,764,1.0,496.0,496.0,5,783,1.0,515.0,515.0
0.037,17,2,148,1,60,0.0,32.0,32.0,1,88,0.0,60.0,60.0
0.001,17,2,136,1,60,0.0,32.0,32.0,1,76,0.0,48.0,48.0
0.053,17,2,152,1,76,0.0,48.0,48.0,1,76,0.0,48.0,48.0
0.005,6,10,1547,5,764,1.0,496.0,496.0,5,783,1.0,515.0,515.0
0.006,6,10,1854,5,889,1.0,621.0,621.0,5,965,1.0,697.0,697.0
0.004,6,10,1774,5,923,1.0,655.0,655.0,5,851,1.0,583.0,583.0
0.103,6,10,1506,5,395,22.0,127.0,127.0,5,1111,23.0,843.0,843.0
8.668,6,35,8460,18,2030,509.0,922.0,426.0,17,6430,530.0,2720.0,478.0
0.119,6,10,1506,5,395,29.0,127.0,127.0,5,1111,24.0,843.0,843.0
0.005,17,2,170,1,65,0.0,37.0,37.0,1,105,0.0,77.0,77.0
0.005,6,10,2007,5,928,1.0,660.0,660.0,5,1079,1.0,811.0,811.0
291.669,6,325,344997,124,17997,2371.0,2736.0,825.0,201,327000,1458.0,2914.0,1692.0
40.081,17,10,676,5,460,10017.0,104.0,64.0,5,216,10019.0,20.0,15.0
0.005,6,10,2006,5,927,1.0,659.0,659.0,5,1079,1.0,811.0,811.0
0.005,17,2,152,1,68,0.0,40.0,40.0,1,84,0.0,56.0,56.0
0.008,6,10,1989,5,910,1.0,642.0,642.0,5,1079,1.0,811.0,811.0
0.005,6,10,1989,5,927,1.0,659.0,659.0,5,1062,1.0,794.0,794.0
0.001,17,2,166,1,75,0.0,47.0,47.0,1,91,0.0,63.0,63.0
0.079,6,10,1506,5,395,18.0,127.0,127.0,5,1111,16.0,843.0,843.0
1770.464,6,83,4368,42,2210,43181.0,26.0,26.0,41,2158,44260.0,26.0,26.0
0.017,6,10,1989,5,910,4.0,642.0,642.0,5,1079,4.0,811.0,811.0
0.018,6,10,1972,5,910,4.0,642.0,642.0,5,1062,4.0,794.0,794.0
0.001,17,2,180,1,66,0.0,38.0,38.0,1,114,0.0,86.0,86.0
0.006,6,10,1547,5,764,1.0,496.0,496.0,5,783,1.0,515.0,515.0
0.115,17,2,152,1,76,0.0,48.0,48.0,1,76,0.0,48.0,48.0
0.108,6,10,1506,5,395,23.0,127.0,127.0,5,1111,20.0,843.0,843.0
0.011,6,10,1990,5,911,2.0,643.0,643.0,5,1079,2.0,811.0,811.0
0.001,17,2,180,1,66,0.0,38.0,38.0,1,114,0.0,86.0,86.0
0.013,6,10,1989,5,910,3.0,642.0,642.0,5,1079,3.0,811.0,811.0
176.112,17,80,11282,40,2667,4515.0,44.0,38.0,40,8615,4515.0,239.0,187.0
0.008,6,12,1926,6,1189,1.0,659.0,434.0,6,737,1.0,417.0,417.0
0.039,17,4,284,2,120,0.0,32.0,32.0,2,164,33.0,60.0,54.0
0.019,6,10,1990,5,911,4.0,643.0,643.0,5,1079,4.0,811.0,811.0
0.005,6,10,1989,5,927,1.0,659.0,659.0,5,1062,1.0,794.0,794.0
0.144,6,10,1506,5,395,33.0,127.0,127.0,5,1111,32.0,843.0,843.0
0.005,6,13,3690,7,452,0.0,80.0,80.0,6,3238,0.0,1470.0,1459.0
40.056,17,10,676,5,460,10012.0,104.0,64.0,5,216,10013.0,20.0,15.0
0.004,6,10,1779,5,928,1.0,660.0,660.0,5,851,1.0,583.0,583.0
0.1,6,10,1506,5,395,23.0,127.0,127.0,5,1111,21.0,843.0,843.0
0.006,6,13,3747,7,509,1.0,137.0,137.0,6,3238,1.0,1470.0,1459.0
0.006,6,14,3736,7,446,1.0,74.0,74.0,7,3290,0.0,1448.0,972.0
308.472,17,20,1124,10,716,34260.0,48.0,43.0,10,408,34261.0,20.0,12.0
0.004,6,10,1774,5,923,1.0,655.0,655.0,5,851,1.0,583.0,583.0
0.014,6,10,1989,5,910,3.0,642.0,642.0,5,1079,3.0,811.0,811.0
0.077,6,10,1506,5,395,18.0,127.0,127.0,5,1111,15.0,843.0,843.0
0.04,17,2,148,1,60,0.0,32.0,32.0,1,88,0.0,60.0,60.0
0.023,6,10,1972,5,910,5.0,642.0,642.0,5,1062,5.0,794.0,794.0
0.011,6,10,1989,5,910,2.0,642.0,642.0,5,1079,2.0,811.0,811.0
0.106,6,10,1506,5,395,25.0,127.0,127.0,5,1111,22.0,843.0,843.0
0.085,17,2,144,1,64,0.0,36.0,36.0,1,80,0.0,52.0,52.0
0.004,17,2,136,1,60,0.0,32.0,32.0,1,76,0.0,48.0,48.0
40.067,17,10,676,5,460,10013.0,104.0,64.0,5,216,10015.0,20.0,15.0
0.011,6,10,1972,5,910,2.0,642.0,642.0,5,1062,2.0,794.0,794.0
53.536,6,57,27256,29,21109,336.0,2720.0,1422.0,28,6147,1976.0,2667.0,385.0
0.016,6,10,1990,5,911,4.0,643.0,643.0,5,1079,4.0,811.0,811.0
11.442,17,28,4394,14,2312,867.0,587.0,137.0,14,2082,867.0,269.0,120.0
0.004,17,2,136,1,60,0.0,32.0,32.0,1,76,0.0,48.0,48.0
0.101,6,10,1506,5,395,22.0,127.0,127.0,5,1111,22.0,843.0,843.0
0.071,17,2,144,1,64,0.0,36.0,36.0,1,80,0.0,52.0,52.0
0.004,17,2,148,1,60,0.0,32.0,32.0,1,88,0.0,60.0,60.0
0.009,6,10,1989,5,910,2.0,642.0,642.0,5,1079,2.0,811.0,811.0
0.01,6,10,1972,5,910,2.0,642.0,642.0,5,1062,2.0,794.0,794.0
0.006,6,10,1854,5,889,1.0,621.0,621.0,5,965,1.0,697.0,697.0
0.008,6,10,1677,5,827,2.0,559.0,559.0,5,850,2.0,582.0,582.0
0.009,6,10,1990,5,911,2.0,643.0,643.0,5,1079,2.0,811.0,811.0
0.001,17,2,180,1,66,0.0,38.0,38.0,1,114,0.0,86.0,86.0
300.172,6,27,7436,16,1409,20011.0,217.0,142.0,11,6027,24016.0,1679.0,778.0
0.01,6,10,1990,5,911,2.0,643.0,643.0,5,1079,2.0,811.0,811.0
40.062,17,10,676,5,460,10012.0,104.0,64.0,5,216,10014.0,20.0,15.0
0.006,6,10,1547,5,764,1.0,496.0,496.0,5,783,1.0,515.0,515.0
0.088,6,10,1506,5,395,19.0,127.0,127.0,5,1111,16.0,843.0,843.0
9.037,17,6,376,5,280,2259.0,28.0,28.0,1,96,0.0,68.0,68.0
0.006,6,10,1547,5,764,1.0,496.0,496.0,5,783,1.0,515.0,515.0
0.083,6,10,1506,5,395,19.0,127.0,127.0,5,1111,19.0,843.0,843.0
0.008,6,10,1762,5,911,1.0,643.0,643.0,5,851,2.0,583.0,583.0
0.005,6,10,2000,5,927,1.0,659.0,659.0,5,1073,1.0,805.0,805.0
0.004,6,10,1989,5,927,1.0,659.0,659.0,5,1062,1.0,794.0,794.0
0.014,6,10,1983,5,910,3.0,642.0,642.0,5,1073,3.0,805.0,805.0
0.095,6,10,1506,5,395,23.0,127.0,127.0,5,1111,20.0,843.0,843.0
0.006,6,10,1547,5,764,1.0,496.0,496.0,5,783,1.0,515.0,515.0
0.005,17,2,255,1,82,0.0,54.0,54.0,1,173,0.0,145.0,145.0
40.067,17,10,676,5,460,10014.0,104.0,64.0,5,216,10016.0,20.0,15.0
0.105,6,10,1506,5,395,24.0,127.0,127.0,5,1111,25.0,843.0,843.0
0.068,6,10,1506,5,395,15.0,127.0,127.0,5,1111,14.0,843.0,843.0
0.106,6,10,1506,5,395,24.0,127.0,127.0,5,1111,22.0,843.0,843.0
0.179,6,10,1506,5,395,41.0,127.0,127.0,5,1111,37.0,843.0,843.0
0.005,17,2,170,1,65,0.0,37.0,37.0,1,105,0.0,77.0,77.0
0.005,6,10,2000,5,927,1.0,659.0,659.0,5,1073,1.0,805.0,805.0
0.005,6,10,1854,5,889,1.0,621.0,621.0,5,965,1.0,697.0,697.0
1777.362,17,140,44240,72,22752,25032.0,288.0,288.0,68,21488,26516.0,288.0,288.0
0.069,6,10,1506,5,395,14.0,127.0,127.0,5,1111,14.0,843.0,843.0
0.008,6,10,1990,5,911,2.0,643.0,643.0,5,1079,2.0,811.0,811.0
0.009,6,10,1989,5,910,2.0,642.0,642.0,5,1079,2.0,811.0,811.0
0.066,6,10,1506,5,395,15.0,127.0,127.0,5,1111,14.0,843.0,843.0
0.016,6,10,1990,5,911,4.0,643.0,643.0,5,1079,4.0,811.0,811.0
0.011,6,10,1990,5,911,2.0,643.0,643.0,5,1079,2.0,811.0,811.0
0.006,17,2,179,1,71,0.0,43.0,43.0,1,108,0.0,80.0,80.0
0.008,6,12,1926,6,1189,1.0,659.0,434.0,6,737,1.0,417.0,417.0
0.107,6,10,1506,5,395,24.0,127.0,127.0,5,1111,24.0,843.0,843.0
0.057,17,2,152,1,76,0.0,48.0,48.0,1,76,0.0,48.0,48.0
0.005,17,2,180,1,66,0.0,38.0,38.0,1,114,0.0,86.0,86.0
40.063,17,10,676,5,460,10013.0,104.0,64.0,5,216,10013.0,20.0,15.0
0.005,6,10,1989,5,927,1.0,659.0,659.0,5,1062,1.0,794.0,794.0
0.032,6,19,9922,11,704,3.0,124.0,124.0,8,9218,4.0,2896.0,2198.0
0.071,17,2,182,1,65,0.0,37.0,37.0,1,117,0.0,89.0,89.0
0.006,6,10,1547,5,764,1.0,496.0,496.0,5,783,1.0,515.0,515.0
0.061,6,10,1506,5,395,12.0,127.0,127.0,5,1111,12.0,843.0,843.0
0.156,6,25,6544,13,2401,11.0,746.0,341.0,12,4143,13.0,1324.0,585.0
0.008,6,10,1990,5,911,2.0,643.0,643.0,5,1079,2.0,811.0,811.0
0.004,6,10,2007,5,928,1.0,660.0,660.0,5,1079,1.0,811.0,811.0
0.005,17,2,144,1,64,0.0,36.0,36.0,1,80,0.0,52.0,52.0
0.013,6,10,1989,5,910,3.0,642.0,642.0,5,1079,3.0,811.0,811.0
0.001,17,2,179,1,62,0.0,34.0,34.0,1,117,0.0,89.0,89.0
0.006,17,2,214,1,75,0.0,47.0,47.0,1,139,0.0,111.0,111.0
0.005,6,13,3747,7,509,0.0,137.0,137.0,6,3238,0.0,1470.0,1459.0
0.105,6,10,1506,5,395,20.0,127.0,127.0,5,1111,23.0,843.0,843.0
0.005,6,10,1689,5,839,1.0,571.0,571.0,5,850,1.0,582.0,582.0
0.006,6,10,1547,5,764,1.0,496.0,496.0,5,783,1.0,515.0,515.0
40.055,17,10,676,5,460,10012.0,104.0,64.0,5,216,10012.0,20.0,15.0
0.016,6,10,1989,5,910,4.0,642.0,642.0,5,1079,4.0,811.0,811.0
0.105,6,10,1506,5,395,25.0,127.0,127.0,5,1111,25.0,843.0,843.0
0.006,6,13,3747,7,509,0.0,137.0,137.0,6,3238,1.0,1470.0,1459.0
10.963,17,28,4398,14,2312,834.0,587.0,137.0,14,2086,834.0,269.0,121.0
0.005,17,2,175,1,65,0.0,37.0,37.0,1,110,0.0,82.0,82.0
0.011,6,10,1631,5,848,2.0,580.0,580.0,5,783,2.0,515.0,515.0
0.002,17,2,180,1,66,0.0,38.0,38.0,1,114,0.0,86.0,86.0
0.005,6,10,2007,5,928,1.0,660.0,660.0,5,1079,1.0,811.0,811.0
0.072,17,8,3613,4,1874,24.0,1350.0,440.0,4,1739,13.0,1350.0,406.0
0.143,6,10,1506,5,395,33.0,127.0,127.0,5,1111,32.0,843.0,843.0
0.018,6,10,1983,5,910,4.0,642.0,642.0,5,1073,4.0,805.0,805.0
15.076,17,19,10120,9,6968,1880.0,1350.0,746.0,10,3152,1671.0,1350.0,287.0
0.007,6,10,2000,5,927,1.0,659.0,659.0,5,1073,1.0,805.0,805.0
0.008,6,10,1989,5,910,2.0,642.0,642.0,5,1079,2.0,811.0,811.0
0.039,17,2,184,1,61,0.0,33.0,33.0,1,123,0.0,95.0,95.0
0.01,6,10,1990,5,911,2.0,643.0,643.0,5,1079,2.0,811.0,811.0
0.005,6,10,2000,5,927,1.0,659.0,659.0,5,1073,1.0,805.0,805.0
0.022,6,10,1677,5,827,5.0,559.0,559.0,5,850,5.0,582.0,582.0
15.073,17,15,9238,8,6902,2149.0,1350.0,834.0,7,2336,2507.0,1350.0,305.0
0.221,6,16,2674,8,1400,31.0,533.0,325.0,8,1274,20.0,529.0,212.0
0.016,6,10,1989,5,910,4.0,642.0,642.0,5,1079,4.0,811.0,811.0
0.003,17,2,148,1,60,0.0,32.0,32.0,1,88,0.0,60.0,60.0
0.015,6,13,3735,7,497,2.0,125.0,125.0,6,3238,3.0,1470.0,1459.0
0.005,6,10,1689,5,839,1.0,571.0,571.0,5,850,1.0,582.0,582.0
0.009,6,12,1926,6,1189,1.0,659.0,434.0,6,737,1.0,417.0,417.0
0.004,17,4,284,2,120,0.0,32.0,32.0,2,164,0.0,60.0,54.0
0.04,17,4,284,2,120,0.0,32.0,32.0,2,164,37.0,60.0,54.0
0.003,17,2,136,1,60,0.0,32.0,32.0,1,76,0.0,48.0,48.0
300.334,6,29,10173,16,1994,20022.0,517.0,285.0,13,8179,20026.0,1402.0,936.0
0.004,17,2,148,1,60,0.0,32.0,32.0,1,88,0.0,60.0,60.0
0.008,6,10,1989,5,910,2.0,642.0,642.0,5,1079,2.0,811.0,811.0
0.003,17,2,148,1,60,0.0,32.0,32.0,1,88,0.0,60.0,60.0
40.07,17,10,676,5,460,10015.0,104.0,64.0,5,216,10016.0,20.0,15.0
0.004,6,10,1989,5,927,1.0,659.0,659.0,5,1062,1.0,794.0,794.0
0.001,17,2,144,1,64,0.0,36.0,36.0,1,80,0.0,52.0,52.0
0.007,17,2,140,1,62,0.0,34.0,34.0,1,78,0.0,50.0,50.0
0.084,17,2,80,1,32,0.0,4.0,4.0,1,48,0.0,20.0,20.0
0.172,6,3,453,2,321,172.0,241.0,241.0,1,132,0.0,92.0,92.0
300.388,6,16,2182,9,696,37526.0,146.0,146.0,7,1486,50036.0,419.0,398.0
0.009,6,10,1990,5,911,2.0,643.0,643.0,5,1079,2.0,811.0,811.0
0.005,6,10,2000,5,927,1.0,659.0,659.0,5,1073,1.0,805.0,805.0
0.005,6,14,3799,7,509,0.0,137.0,137.0,7,3290,0.0,1448.0,972.0
0.005,6,10,1774,5,923,1.0,655.0,655.0,5,851,1.0,583.0,583.0
0.005,17,2,166,1,75,0.0,47.0,47.0,1,91,0.0,63.0,63.0
0.006,6,10,1643,5,860,1.0,592.0,592.0,5,783,1.0,515.0,515.0
0.001,17,2,180,1,66,0.0,38.0,38.0,1,114,0.0,86.0,86.0
0.005,6,13,3747,7,509,0.0,137.0,137.0,6,3238,1.0,1470.0,1459.0
0.013,6,10,1677,5,827,3.0,559.0,559.0,5,850,3.0,582.0,582.0
0.011,6,10,1983,5,910,2.0,642.0,642.0,5,1073,2.0,805.0,805.0
0.005,6,10,1989,5,927,1.0,659.0,659.0,5,1062,1.0,794.0,794.0
0.004,6,10,1989,5,927,1.0,659.0,659.0,5,1062,1.0,794.0,794.0
0.009,6,10,1677,5,827,2.0,559.0,559.0,5,850,2.0,582.0,582.0
0.154,6,10,1506,5,395,36.0,127.0,127.0,5,1111,35.0,843.0,843.0
0.012,6,13,3735,7,497,1.0,125.0,125.0,6,3238,2.0,1470.0,1459.0
300.36,6,16,2170,9,684,37524.0,146.0,146.0,7,1486,50032.0,419.0,398.0
0.003,17,2,132,1,58,0.0,30.0,30.0,1,74,0.0,46.0,46.0
240.099,6,16,4481,9,963,30012.0,238.0,166.0,7,3518,40015.0,1402.0,786.0
0.018,6,10,1989,5,910,4.0,642.0,642.0,5,1079,4.0,811.0,811.0
40.053,17,10,676,5,460,10012.0,104.0,64.0,5,216,10012.0,20.0,15.0
0.008,6,10,1989,5,910,1.0,642.0,642.0,5,1079,1.0,811.0,811.0
0.042,17,2,152,1,76,0.0,48.0,48.0,1,76,0.0,48.0,48.0
0.009,6,12,1926,6,1189,1.0,659.0,434.0,6,737,1.0,417.0,417.0
0.042,17,2,148,1,60,0.0,32.0,32.0,1,88,0.0,60.0,60.0
0.013,6,10,1990,5,911,3.0,643.0,643.0,5,1079,3.0,811.0,811.0
0.015,6,10,1972,5,910,3.0,642.0,642.0,5,1062,3.0,794.0,794.0
0.015,6,10,1990,5,911,3.0,643.0,643.0,5,1079,3.0,811.0,811.0
0.006,6,10,1547,5,764,1.0,496.0,496.0,5,783,1.0,515.0,515.0
1781.101,6,87,4628,44,2340,41420.0,26.0,26.0,43,2288,42406.0,26.0,26.0
0.076,6,10,1506,5,395,15.0,127.0,127.0,5,1111,17.0,843.0,843.0
0.005,6,10,2006,5,927,1.0,659.0,659.0,5,1079,1.0,811.0,811.0
0.014,6,10,1989,5,910,3.0,642.0,642.0,5,1079,3.0,811.0,811.0
0.009,6,10,1989,5,910,2.0,642.0,642.0,5,1079,2.0,811.0,811.0
0.057,6,10,1506,5,395,11.0,127.0,127.0,5,1111,12.0,843.0,843.0
0.012,6,10,1983,5,910,3.0,642.0,642.0,5,1073,3.0,805.0,805.0
0.12,6,10,1506,5,395,26.0,127.0,127.0,5,1111,25.0,843.0,843.0
0.207,6,16,2777,8,1395,29.0,533.0,323.0,8,1382,18.0,529.0,239.0
15.074,17,15,9238,8,6902,2149.0,1350.0,834.0,7,2336,2507.0,1350.0,305.0
65.7,6,22,10152,12,3985,5972.0,1591.0,838.0,10,6167,7281.0,2111.0,939.0
309.207,17,20,1124,10,716,34349.0,48.0,43.0,10,408,34349.0,20.0,12.0
0.011,6,10,1631,5,848,2.0,580.0,580.0,5,783,2.0,515.0,515.0
0.085,6,10,1506,5,395,18.0,127.0,127.0,5,1111,18.0,843.0,843.0
0.072,17,4,284,2,120,0.0,32.0,32.0,2,164,69.0,60.0,54.0
0.01,6,10,1989,5,910,2.0,642.0,642.0,5,1079,2.0,811.0,811.0
0.397,17,42,22892,23,18482,17.0,1350.0,775.0,19,4410,19.0,1350.0,204.0
0.081,6,10,1506,5,395,17.0,127.0,127.0,5,1111,19.0,843.0,843.0
355.407,6,20,2210,6,1308,12010.0,494.0,494.0,14,902,27338.0,83.0,83.0
0.005,6,10,1779,5,928,1.0,660.0,660.0,5,851,1.0,583.0,583.0
0.077,6,10,1506,5,395,14.0,127.0,127.0,5,1111,16.0,843.0,843.0
0.006,6,10,1547,5,764,1.0,496.0,496.0,5,783,1.0,515.0,515.0
176.551,58,3,216,2,144,176551.0,24.0,24.0,1,72,0.0,24.0,24.0
0.013,6,10,1983,5,910,3.0,642.0,642.0,5,1073,3.0,805.0,805.0
0.039,17,2,136,1,60,0.0,32.0,32.0,1,76,0.0,48.0,48.0
0.082,6,10,1506,5,395,18.0,127.0,127.0,5,1111,15.0,843.0,843.0
0.006,17,2,214,1,75,0.0,47.0,47.0,1,139,0.0,111.0,111.0
60.016,6,10,1690,6,1308,12003.0,494.0,494.0,4,382,20004.0,83.0,83.0
0.004,6,10,2006,5,927,1.0,659.0,659.0,5,1079,1.0,811.0,811.0
15.074,17,15,9238,8,6902,2149.0,1350.0,834.0,7,2336,2507.0,1350.0,305.0
1786.21,6,150,19350,90,13740,20069.0,302.0,302.0,60,5610,30274.0,83.0,83.0
178.217,17,86,12161,43,2866,4243.0,44.0,38.0,43,9295,4243.0,239.0,188.0
0.008,6,10,2000,5,927,1.0,659.0,659.0,5,1073,2.0,805.0,805.0
0.005,6,10,2000,5,927,1.0,659.0,659.0,5,1073,1.0,805.0,805.0
0.079,6,10,1506,5,395,19.0,127.0,127.0,5,1111,16.0,843.0,843.0
0.012,6,10,1677,5,827,3.0,559.0,559.0,5,850,2.0,582.0,582.0
0.007,6,12,1698,6,863,1.0,327.0,271.0,6,835,1.0,515.0,515.0
40.063,17,10,676,5,460,10012.0,104.0,64.0,5,216,10014.0,20.0,15.0
0.037,17,2,138,1,61,0.0,33.0,33.0,1,77,0.0,49.0,49.0
0.001,17,2,180,1,66,0.0,38.0,38.0,1,114,0.0,86.0,86.0
0.01,6,10,1972,5,910,2.0,642.0,642.0,5,1062,2.0,794.0,794.0
0.004,6,10,1774,5,923,1.0,655.0,655.0,5,851,1.0,583.0,583.0
0.082,6,10,1506,5,395,15.0,127.0,127.0,5,1111,18.0,843.0,843.0
0.014,6,10,1989,5,910,3.0,642.0,642.0,5,1079,3.0,811.0,811.0
0.041,17,4,284,2,120,0.0,32.0,32.0,2,164,38.0,60.0,54.0
170.12,17,78,11043,39,2601,4476.0,44.0,38.0,39,8442,4476.0,261.0,188.0
0.011,6,10,1989,5,910,2.0,642.0,642.0,5,1079,2.0,811.0,811.0
0.086,6,10,1506,5,395,21.0,127.0,127.0,5,1111,18.0,843.0,843.0
0.155,6,10,1506,5,395,34.0,127.0,127.0,5,1111,32.0,843.0,843.0
0.009,6,10,1989,5,910,2.0,642.0,642.0,5,1079,2.0,811.0,811.0
0.003,6,10,1702,5,863,0.0,595.0,595.0,5,839,0.0,571.0,571.0
0.004,17,2,166,1,75,0.0,47.0,47.0,1,91,0.0,63.0,63.0
0.004,6,10,2000,5,927,1.0,659.0,659.0,5,1073,1.0,805.0,805.0
0.001,17,2,164,1,74,0.0,46.0,46.0,1,90,0.0,62.0,62.0
0.007,17,2,194,1,59,0.0,31.0,31.0,1,135,0.0,107.0,107.0
0.011,6,12,1926,6,1189,2.0,659.0,434.0,6,737,2.0,417.0,417.0
0.006,6,10,1779,5,928,1.0,660.0,660.0,5,851,1.0,583.0,583.0
0.005,6,10,2007,5,928,1.0,660.0,660.0,5,1079,1.0,811.0,811.0
0.011,6,10,1989,5,910,2.0,642.0,642.0,5,1079,2.0,811.0,811.0
0.008,6,10,1990,5,911,2.0,643.0,643.0,5,1079,2.0,811.0,811.0
0.015,6,10,1989,5,910,3.0,642.0,642.0,5,1079,3.0,811.0,811.0
0.005,6,10,2007,5,928,1.0,660.0,660.0,5,1079,1.0,811.0,811.0
0.085,6,10,1506,5,395,20.0,127.0,127.0,5,1111,19.0,843.0,843.0
0.006,17,2,166,1,75,0.0,47.0,47.0,1,91,0.0,63.0,63.0
15.221,17,18,9401,9,6963,1899.0,1350.0,745.0,9,2438,1899.0,1350.0,242.0
0.094,6,10,1506,5,395,22.0,127.0,127.0,5,1111,20.0,843.0,843.0
0.074,6,10,1506,5,395,16.0,127.0,127.0,5,1111,15.0,843.0,843.0
0.011,6,10,1989,5,910,2.0,642.0,642.0,5,1079,2.0,811.0,811.0
10.957,17,28,4390,14,2311,834.0,586.0,137.0,14,2079,834.0,270.0,120.0
0.006,6,13,3747,7,509,0.0,137.0,137.0,6,3238,1.0,1470.0,1459.0
0.004,6,10,2006,5,927,1.0,659.0,659.0,5,1079,1.0,811.0,811.0
0.006,6,10,1689,5,839,1.0,571.0,571.0,5,850,1.0,582.0,582.0
0.017,6,10,1990,5,911,4.0,643.0,643.0,5,1079,4.0,811.0,811.0
0.005,17,2,136,1,60,0.0,32.0,32.0,1,76,0.0,48.0,48.0
0.008,6,10,1983,5,910,2.0,642.0,642.0,5,1073,1.0,805.0,805.0
0.005,6,10,1989,5,927,1.0,659.0,659.0,5,1062,1.0,794.0,794.0
0.068,6,10,1506,5,395,14.0,127.0,127.0,5,1111,15.0,843.0,843.0
0.005,6,10,1774,5,923,1.0,655.0,655.0,5,851,1.0,583.0,583.0
0.004,17,4,284,2,120,0.0,32.0,32.0,2,164,1.0,60.0,54.0
0.009,6,10,1983,5,910,2.0,642.0,642.0,5,1073,2.0,805.0,805.0
40.083,17,10,676,5,460,10017.0,104.0,64.0,5,216,10019.0,20.0,15.0
0.093,6,10,1506,5,395,21.0,127.0,127.0,5,1111,20.0,843.0,843.0
0.16,17,2,144,1,64,0.0,36.0,36.0,1,80,0.0,52.0,52.0
0.05,17,4,420,2,122,0.0,33.0,33.0,2,298,31.0,145.0,121.0
0.011,6,10,1990,5,911,2.0,643.0,643.0,5,1079,2.0,811.0,811.0
0.126,6,10,1506,5,395,30.0,127.0,127.0,5,1111,26.0,843.0,843.0
0.17,6,3,453,2,321,170.0,241.0,241.0,1,132,0.0,92.0,92.0
0.072,17,4,580,2,122,0.0,33.0,33.0,2,458,30.0,307.0,201.0
0.009,6,10,1677,5,827,2.0,559.0,559.0,5,850,2.0,582.0,582.0
0.111,6,10,1506,5,395,22.0,127.0,127.0,5,1111,21.0,843.0,843.0
0.001,17,2,136,1,60,0.0,32.0,32.0,1,76,0.0,48.0,48.0
0.005,6,10,1643,5,860,1.0,592.0,592.0,5,783,1.0,515.0,515.0
0.005,17,2,160,1,72,0.0,44.0,44.0,1,88,0.0,60.0,60.0
0.005,6,10,1989,5,927,1.0,659.0,659.0,5,1062,1.0,794.0,794.0
40.057,17,10,676,5,460,10013.0,104.0,64.0,5,216,10013.0,20.0,15.0
0.009,6,10,2006,5,927,2.0,659.0,659.0,5,1079,2.0,811.0,811.0
0.006,6,10,1643,5,860,1.0,592.0,592.0,5,783,1.0,515.0,515.0
0.057,6,10,1983,5,910,14.0,642.0,642.0,5,1073,14.0,805.0,805.0
0.037,17,2,148,1,60,0.0,32.0,32.0,1,88,0.0,60.0,60.0
0.006,6,10,2007,5,928,1.0,660.0,660.0,5,1079,1.0,811.0,811.0
0.171,6,3,453,2,321,171.0,241.0,241.0,1,132,0.0,92.0,92.0
0.006,6,10,1854,5,889,1.0,621.0,621.0,5,965,1.0,697.0,697.0
0.082,6,10,1506,5,395,19.0,127.0,127.0,5,1111,16.0,843.0,843.0
301.02,6,47,17507,25,11600,12542.0,2720.0,1174.0,22,5907,421.0,2667.0,385.0
0.171,6,10,1506,5,395,41.0,127.0,127.0,5,1111,39.0,843.0,843.0
0.023,6,10,1990,5,911,5.0,643.0,643.0,5,1079,5.0,811.0,811.0
0.012,6,10,1983,5,910,2.0,642.0,642.0,5,1073,2.0,805.0,805.0
0.012,6,10,1990,5,911,3.0,643.0,643.0,5,1079,3.0,811.0,811.0
0.005,6,10,1989,5,927,1.0,659.0,659.0,5,1062,1.0,794.0,794.0
0.069,6,10,1506,5,395,15.0,127.0,127.0,5,1111,15.0,843.0,843.0
0.091,6,10,1506,5,395,21.0,127.0,127.0,5,1111,19.0,843.0,843.0
0.005,6,10,1779,5,928,1.0,660.0,660.0,5,851,1.0,583.0,583.0
0.016,6,10,1677,5,827,4.0,559.0,559.0,5,850,3.0,582.0,582.0
0.005,6,10,1643,5,860,1.0,592.0,592.0,5,783,1.0,515.0,515.0
0.004,6,10,2007,5,928,1.0,660.0,660.0,5,1079,1.0,811.0,811.0
0.004,6,10,1779,5,928,1.0,660.0,660.0,5,851,1.0,583.0,583.0
0.005,6,10,1779,5,928,1.0,660.0,660.0,5,851,1.0,583.0,583.0
0.008,6,12,1698,6,863,1.0,327.0,271.0,6,835,1.0,515.0,515.0
0.01,6,10,1989,5,910,2.0,642.0,642.0,5,1079,2.0,811.0,811.0
0.004,17,2,136,1,60,0.0,32.0,32.0,1,76,0.0,48.0,48.0
240.601,6,40,9855,22,2369,11456.0,749.0,236.0,18,7486,14151.0,1402.0,595.0
0.102,6,10,1506,5,395,23.0,127.0,127.0,5,1111,20.0,843.0,843.0
0.01,6,12,1926,6,1189,2.0,659.0,434.0,6,737,1.0,417.0,417.0
0.008,6,10,1972,5,910,2.0,642.0,642.0,5,1062,2.0,794.0,794.0
240.18,6,48,7140,23,3313,10917.0,588.0,210.0,25,3827,10007.0,580.0,209.0
0.004,17,2,136,1,60,0.0,32.0,32.0,1,76,0.0,48.0,48.0
0.694,6,22,5072,11,1250,58.0,325.0,133.0,11,3822,58.0,1414.0,563.0
0.013,6,10,1989,5,910,3.0,642.0,642.0,5,1079,3.0,811.0,811.0
0.004,17,2,186,1,61,0.0,33.0,33.0,1,125,0.0,97.0,97.0
0.071,6,10,1506,5,395,14.0,127.0,127.0,5,1111,15.0,843.0,843.0
0.012,6,10,1631,5,848,3.0,580.0,580.0,5,783,3.0,515.0,515.0
0.037,17,2,412,1,61,0.0,33.0,33.0,1,351,0.0,323.0,323.0
0.008,6,10,1762,5,911,2.0,643.0,643.0,5,851,2.0,583.0,583.0
0.005,6,5,310,3,175,2.0,31.0,31.0,2,135,0.0,31.0,31.0
11.492,17,28,4398,14,2312,871.0,587.0,137.0,14,2086,871.0,269.0,121.0
0.078,6,10,1506,5,395,19.0,127.0,127.0,5,1111,14.0,843.0,843.0
0.012,6,10,1989,5,910,3.0,642.0,642.0,5,1079,3.0,811.0,811.0
0.005,6,10,2006,5,927,1.0,659.0,659.0,5,1079,1.0,811.0,811.0
15.078,17,16,9302,8,6912,2150.0,1350.0,836.0,8,2390,2149.0,1350.0,270.0
0.006,6,10,1689,5,839,1.0,571.0,571.0,5,850,1.0,582.0,582.0
0.093,6,10,1506,5,395,22.0,127.0,127.0,5,1111,17.0,843.0,843.0
0.006,17,2,164,1,74,0.0,46.0,46.0,1,90,0.0,62.0,62.0
0.004,17,2,136,1,60,0.0,32.0,32.0,1,76,0.0,48.0,48.0
240.011,6,9,787,5,488,60002.0,232.0,232.0,4,299,80002.0,83.0,83.0
0.011,6,10,1972,5,910,2.0,642.0,642.0,5,1062,2.0,794.0,794.0
0.013,17,2,152,1,56,0.0,28.0,28.0,1,96,0.0,68.0,68.0
240.092,6,31,9001,15,6633,17149.0,1746.0,649.0,16,2368,16006.0,580.0,218.0
0.005,6,10,2006,5,927,1.0,659.0,659.0,5,1079,1.0,811.0,811.0
0.126,6,10,1506,5,395,27.0,127.0,127.0,5,1111,28.0,843.0,843.0
174.286,17,102,14820,51,3433,3485.0,44.0,39.0,51,11387,3485.0,261.0,195.0
300.42,6,16,2170,9,684,37530.0,146.0,146.0,7,1486,50041.0,419.0,398.0
0.04,17,2,148,1,60,0.0,32.0,32.0,1,88,0.0,60.0,60.0
0.001,17,2,136,1,60,0.0,32.0,32.0,1,76,0.0,48.0,48.0
0.079,17,4,596,2,122,41.0,33.0,33.0,2,474,40.0,323.0,209.0
0.007,6,10,1677,5,827,1.0,559.0,559.0,5,850,1.0,582.0,582.0
0.008,6,10,1774,5,923,2.0,655.0,655.0,5,851,1.0,583.0,583.0
0.013,6,13,3735,7,497,2.0,125.0,125.0,6,3238,2.0,1470.0,1459.0
0.094,6,10,1506,5,395,20.0,127.0,127.0,5,1111,21.0,843.0,843.0
0.008,6,12,1926,6,1189,1.0,659.0,434.0,6,737,1.0,417.0,417.0
10.808,17,28,4418,14,1994,823.0,269.0,114.0,14,2424,823.0,587.0,145.0
0.004,6,13,3747,7,509,0.0,137.0,137.0,6,3238,0.0,1470.0,1459.0
0.018,6,10,1990,5,911,4.0,643.0,643.0,5,1079,4.0,811.0,811.0
0.004,6,10,2007,5,928,1.0,660.0,660.0,5,1079,1.0,811.0,811.0
0.007,17,2,179,1,71,0.0,43.0,43.0,1,108,0.0,80.0,80.0
0.09,6,10,1506,5,395,19.0,127.0,127.0,5,1111,18.0,843.0,843.0
40.093,17,10,676,5,460,10022.0,104.0,64.0,5,216,10020.0,20.0,15.0
0.041,17,2,170,1,65,0.0,37.0,37.0,1,105,0.0,77.0,77.0
0.057,17,2,299,1,65,0.0,37.0,37.0,1,234,0.0,206.0,206.0
0.006,17,2,170,1,65,0.0,37.0,37.0,1,105,0.0,77.0,77.0
0.004,17,2,136,1,60,0.0,32.0,32.0,1,76,0.0,48.0,48.0
169.345,17,80,11405,40,2676,4342.0,44.0,38.0,40,8729,4342.0,261.0,190.0
0.005,6,13,3747,7,509,0.0,137.0,137.0,6,3238,0.0,1470.0,1459.0
0.071,6,10,1506,5,395,15.0,127.0,127.0,5,1111,16.0,843.0,843.0
240.088,6,16,4480,9,963,30011.0,238.0,166.0,7,3517,40014.0,1402.0,786.0
40.06,17,10,676,5,460,10013.0,104.0,64.0,5,216,10014.0,20.0,15.0
0.003,17,2,186,1,61,0.0,33.0,33.0,1,125,0.0,97.0,97.0
0.004,6,14,3736,7,446,0.0,74.0,74.0,7,3290,0.0,1448.0,972.0
0.006,6,10,1774,5,923,1.0,655.0,655.0,5,851,1.0,583.0,583.0
0.029,6,10,1972,5,910,7.0,642.0,642.0,5,1062,7.0,794.0,794.0
0.005,17,2,230,1,68,0.0,40.0,40.0,1,162,0.0,134.0,134.0
1761.375,6,503,81887,290,42107,6094.0,1925.0,209.0,213,39780,8307.0,1533.0,178.0
171.299,17,96,13808,48,3229,3644.0,44.0,39.0,48,10579,3644.0,261.0,192.0
0.006,6,10,1689,5,839,1.0,571.0,571.0,5,850,1.0,582.0,582.0
0.006,17,2,178,1,81,0.0,53.0,53.0,1,97,0.0,69.0,69.0
0.178,6,3,453,2,321,178.0,241.0,241.0,1,132,0.0,92.0,92.0
0.004,17,2,148,1,60,0.0,32.0,32.0,1,88,0.0,60.0,60.0
0.012,6,10,1983,5,910,2.0,642.0,642.0,5,1073,3.0,805.0,805.0
0.003,17,2,170,1,65,0.0,37.0,37.0,1,105,0.0,77.0,77.0
0.41,17,45,26195,24,19854,17.0,1350.0,799.0,21,6341,15.0,1350.0,273.0
0.005,6,10,2007,5,928,1.0,660.0,660.0,5,1079,1.0,811.0,811.0
0.005,17,2,164,1,74,0.0,46.0,46.0,1,90,0.0,62.0,62.0
0.021,6,10,1990,5,911,5.0,643.0,643.0,5,1079,5.0,811.0,811.0
0.126,6,10,1506,5,395,28.0,127.0,127.0,5,1111,30.0,843.0,843.0
0.007,17,4,284,2,120,0.0,32.0,32.0,2,164,1.0,60.0,54.0
1778.02,17,144,45504,72,22752,25042.0,288.0,288.0,72,22752,25042.0,288.0,288.0
40.068,17,10,676,5,460,10014.0,104.0,64.0,5,216,10016.0,20.0,15.0
0.128,17,2,148,1,60,0.0,32.0,32.0,1,88,0.0,60.0,60.0
171.182,17,70,10005,35,2339,5034.0,44.0,38.0,35,7666,5034.0,249.0,191.0
0.088,6,10,1506,5,395,17.0,127.0,127.0,5,1111,17.0,843.0,843.0
0.005,17,2,166,1,75,0.0,47.0,47.0,1,91,0.0,63.0,63.0
0.004,6,10,1702,5,863,1.0,595.0,595.0,5,839,1.0,571.0,571.0
40.064,17,10,676,5,460,10014.0,104.0,64.0,5,216,10015.0,20.0,15.0
0.093,6,10,1506,5,395,20.0,127.0,127.0,5,1111,22.0,843.0,843.0
0.014,6,10,1983,5,910,3.0,642.0,642.0,5,1073,3.0,805.0,805.0
0.009,6,10,1990,5,911,2.0,643.0,643.0,5,1079,2.0,811.0,811.0
0.005,6,10,1989,5,927,1.0,659.0,659.0,5,1062,1.0,794.0,794.0
0.012,6,10,1983,5,910,2.0,642.0,642.0,5,1073,3.0,805.0,805.0
0.008,6,10,2007,5,928,1.0,660.0,660.0,5,1079,2.0,811.0,811.0
0.067,6,10,1506,5,395,14.0,127.0,127.0,5,1111,14.0,843.0,843.0
170.361,17,90,12897,45,3028,3871.0,44.0,39.0,45,9869,3871.0,260.0,191.0
0.005,6,10,1989,5,927,1.0,659.0,659.0,5,1062,1.0,794.0,794.0
0.005,6,10,2006,5,927,1.0,659.0,659.0,5,1079,1.0,811.0,811.0
1795.483,6,553,188856,280,162961,6435.0,2883.0,969.0,273,25895,6601.0,384.0,116.0
0.014,6,10,1989,5,910,3.0,642.0,642.0,5,1079,3.0,811.0,811.0
0.009,6,12,1926,6,1189,1.0,659.0,434.0,6,737,1.0,417.0,417.0
0.006,17,2,172,1,59,0.0,31.0,31.0,1,113,0.0,85.0,85.0
1777.671,17,144,41760,72,22752,25037.0,288.0,288.0,72,19008,25037.0,236.0,236.0
0.004,17,2,136,1,60,0.0,32.0,32.0,1,76,0.0,48.0,48.0
0.006,17,2,152,1,68,0.0,40.0,40.0,1,84,0.0,56.0,56.0
0.005,6,10,2006,5,927,1.0,659.0,659.0,5,1079,1.0,811.0,811.0
0.006,6,10,1547,5,764,1.0,496.0,496.0,5,783,1.0,515.0,515.0
0.005,6,10,1854,5,889,1.0,621.0,621.0,5,965,1.0,697.0,697.0
0.005,6,13,3747,7,509,0.0,137.0,137.0,6,3238,1.0,1470.0,1459.0
0.006,6,10,1547,5,764,1.0,496.0,496.0,5,783,1.0,515.0,515.0
0.004,6,10,1702,5,863,1.0,595.0,595.0,5,839,1.0,571.0,571.0
0.072,17,8,3613,4,1874,24.0,1350.0,440.0,4,1739,13.0,1350.0,406.0
0.003,17,2,136,1,60,0.0,32.0,32.0,1,76,0.0,48.0,48.0
0.004,6,10,1702,5,863,0.0,595.0,595.0,5,839,1.0,571.0,571.0
40.086,17,10,676,5,460,10019.0,104.0,64.0,5,216,10020.0,20.0,15.0
0.173,6,3,453,2,321,173.0,241.0,241.0,1,132,0.0,92.0,92.0
0.006,6,10,1547,5,764,1.0,496.0,496.0,5,783,1.0,515.0,515.0
0.011,6,10,1990,5,911,2.0,643.0,643.0,5,1079,2.0,811.0,811.0
0.01,6,10,1989,5,910,2.0,642.0,642.0,5,1079,2.0,811.0,811.0
1755.985,6,105,6270,60,3525,29761.0,27.0,27.0,45,2745,39907.0,27.0,27.0
352.001,6,20,2210,6,1308,12004.0,494.0,494.0,14,902,27076.0,83.0,83.0
0.227,6,16,2777,8,1395,32.0,533.0,323.0,8,1382,21.0,529.0,239.0
0.009,6,12,1926,6,1189,1.0,659.0,434.0,6,737,1.0,417.0,417.0
0.078,6,10,1506,5,395,15.0,127.0,127.0,5,1111,19.0,843.0,843.0
0.004,6,10,2006,5,927,1.0,659.0,659.0,5,1079,1.0,811.0,811.0
0.093,6,10,1506,5,395,21.0,127.0,127.0,5,1111,22.0,843.0,843.0
0.011,6,10,1989,5,910,2.0,642.0,642.0,5,1079,2.0,811.0,811.0
0.015,6,10,1989,5,910,3.0,642.0,642.0,5,1079,3.0,811.0,811.0
0.004,6,10,2007,5,928,1.0,660.0,660.0,5,1079,1.0,811.0,811.0
40.065,17,10,676,5,460,10014.0,104.0,64.0,5,216,10015.0,20.0,15.0
0.071,6,10,1506,5,395,15.0,127.0,127.0,5,1111,16.0,843.0,843.0
0.001,17,2,136,1,60,0.0,32.0,32.0,1,76,0.0,48.0,48.0
0.006,6,10,1547,5,764,1.0,496.0,496.0,5,783,1.0,515.0,515.0
0.005,17,2,170,1,65,0.0,37.0,37.0,1,105,0.0,77.0,77.0
0.005,17,2,424,1,72,0.0,44.0,44.0,1,352,0.0,324.0,324.0
0.006,6,10,1854,5,889,1.0,621.0,621.0,5,965,1.0,697.0,697.0
0.013,6,14,3787,7,497,2.0,125.0,125.0,7,3290,2.0,1448.0,972.0
0.041,17,2,144,1,64,0.0,36.0,36.0,1,80,0.0,52.0,52.0
0.001,17,2,132,1,58,0.0,30.0,30.0,1,74,0.0,46.0,46.0
0.012,6,10,1983,5,910,3.0,642.0,642.0,5,1073,2.0,805.0,805.0
0.006,6,10,1547,5,764,1.0,496.0,496.0,5,783,1.0,515.0,515.0
0.138,6,10,1506,5,395,32.0,127.0,127.0,5,1111,28.0,843.0,843.0
0.004,17,2,148,1,60,0.0,32.0,32.0,1,88,0.0,60.0,60.0
0.008,6,10,1989,5,910,1.0,642.0,642.0,5,1079,2.0,811.0,811.0
0.006,6,10,1547,5,764,1.0,496.0,496.0,5,783,1.0,515.0,515.0
0.005,17,2,214,1,75,0.0,47.0,47.0,1,139,0.0,111.0,111.0
0.006,6,10,1547,5,764,1.0,496.0,496.0,5,783,1.0,515.0,515.0
0.015,6,10,1983,5,910,3.0,642.0,642.0,5,1073,3.0,805.0,805.0
15.072,17,15,9238,8,6902,2149.0,1350.0,834.0,7,2336,2507.0,1350.0,305.0
0.164,17,2,152,1,76,0.0,48.0,48.0,1,76,0.0,48.0,48.0
0.016,6,10,1677,5,827,4.0,559.0,559.0,5,850,4.0,582.0,582.0
0.001,17,2,180,1,66,0.0,38.0,38.0,1,114,0.0,86.0,86.0
224.828,6,332,344413,178,13741,1270.0,1016.0,249.0,154,330672,1469.0,4206.0,2272.0
0.005,6,10,1774,5,923,1.0,655.0,655.0,5,851,1.0,583.0,583.0
0.014,6,10,1983,5,910,3.0,642.0,642.0,5,1073,3.0,805.0,805.0
0.005,17,2,170,1,65,0.0,37.0,37.0,1,105,0.0,77.0,77.0
0.005,17,2,169,1,62,0.0,34.0,34.0,1,107,0.0,79.0,79.0
0.096,6,10,1506,5,395,22.0,127.0,127.0,5,1111,22.0,843.0,843.0
0.012,6,10,1990,5,911,3.0,643.0,643.0,5,1079,3.0,811.0,811.0
0.005,17,2,136,1,60,0.0,32.0,32.0,1,76,0.0,48.0,48.0
0.006,6,10,1854,5,889,1.0,621.0,621.0,5,965,1.0,697.0,697.0
0.005,6,10,2006,5,927,1.0,659.0,659.0,5,1079,1.0,811.0,811.0
0.005,6,10,1779,5,928,1.0,660.0,660.0,5,851,1.0,583.0,583.0
0.021,6,10,1972,5,910,5.0,642.0,642.0,5,1062,5.0,794.0,794.0
0.005,6,10,2000,5,927,1.0,659.0,659.0,5,1073,1.0,805.0,805.0
0.007,6,10,1989,5,910,1.0,642.0,642.0,5,1079,1.0,811.0,811.0
40.088,17,10,676,5,460,10020.0,104.0,64.0,5,216,10021.0,20.0,15.0
0.006,6,10,1689,5,839,1.0,571.0,571.0,5,850,1.0,582.0,582.0
0.03,6,10,1972,5,910,7.0,642.0,642.0,5,1062,7.0,794.0,794.0
0.074,17,2,136,1,60,0.0,32.0,32.0,1,76,0.0,48.0,48.0
0.096,6,10,1506,5,395,22.0,127.0,127.0,5,1111,20.0,843.0,843.0
0.113,6,10,1506,5,395,24.0,127.0,127.0,5,1111,25.0,843.0,843.0
0.005,17,2,144,1,64,0.0,36.0,36.0,1,80,0.0,52.0,52.0
10.998,17,26,4046,13,2165,907.0,588.0,138.0,13,1881,907.0,268.0,116.0
0.005,6,10,1779,5,928,1.0,660.0,660.0,5,851,1.0,583.0,583.0
40.08,17,10,676,5,460,10018.0,104.0,64.0,5,216,10019.0,20.0,15.0
0.075,6,10,1506,5,395,16.0,127.0,127.0,5,1111,16.0,843.0,843.0
0.005,6,10,1643,5,860,1.0,592.0,592.0,5,783,1.0,515.0,515.0
0.001,17,2,180,1,66,0.0,38.0,38.0,1,114,0.0,86.0,86.0
0.097,6,10,1506,5,395,21.0,127.0,127.0,5,1111,22.0,843.0,843.0
0.006,6,10,1779,5,928,1.0,660.0,660.0,5,851,1.0,583.0,583.0
0.04,17,2,170,1,65,0.0,37.0,37.0,1,105,0.0,77.0,77.0
0.016,6,10,1677,5,827,3.0,559.0,559.0,5,850,3.0,582.0,582.0
0.134,6,10,1506,5,395,29.0,127.0,127.0,5,1111,28.0,843.0,843.0
0.012,6,10,1972,5,910,2.0,642.0,642.0,5,1062,2.0,794.0,794.0
0.007,6,10,1547,5,764,1.0,496.0,496.0,5,783,1.0,515.0,515.0
0.001,17,2,180,1,66,0.0,38.0,38.0,1,114,0.0,86.0,86.0
0.011,6,10,1972,5,910,2.0,642.0,642.0,5,1062,2.0,794.0,794.0
0.004,6,10,1989,5,927,1.0,659.0,659.0,5,1062,1.0,794.0,794.0
0.005,17,2,230,1,68,0.0,40.0,40.0,1,162,0.0,134.0,134.0
0.012,6,10,1762,5,911,3.0,643.0,643.0,5,851,3.0,583.0,583.0
0.005,6,10,2006,5,927,1.0,659.0,659.0,5,1079,1.0,811.0,811.0
0.007,17,2,194,1,59,0.0,31.0,31.0,1,135,0.0,107.0,107.0
40.071,17,10,676,5,460,10015.0,104.0,64.0,5,216,10017.0,20.0,15.0
0.011,6,10,1762,5,911,2.0,643.0,643.0,5,851,2.0,583.0,583.0
1696.829,17,14,1106,7,441,282804.0,35.0,35.0,7,665,282804.0,67.0,67.0
0.01,6,10,1989,5,910,2.0,642.0,642.0,5,1079,2.0,811.0,811.0
1778.104,17,144,45504,72,22752,25043.0,288.0,288.0,72,22752,25043.0,288.0,288.0
0.014,6,10,1972,5,910,3.0,642.0,642.0,5,1062,3.0,794.0,794.0
0.068,6,10,1506,5,395,15.0,127.0,127.0,5,1111,16.0,843.0,843.0
0.01,6,14,3787,7,497,1.0,125.0,125.0,7,3290,1.0,1448.0,972.0
1798.229,6,65,7396,43,4521,42814.0,1402.0,103.0,22,2875,85621.0,1111.0,82.0
0.001,17,2,180,1,66,0.0,38.0,38.0,1,114,0.0,86.0,86.0
0.012,6,10,1990,5,911,3.0,643.0,643.0,5,1079,2.0,811.0,811.0
0.011,6,10,1989,5,910,2.0,642.0,642.0,5,1079,2.0,811.0,811.0
0.074,6,10,1506,5,395,13.0,127.0,127.0,5,1111,17.0,843.0,843.0
0.072,17,2,412,1,61,0.0,33.0,33.0,1,351,0.0,323.0,323.0
0.009,6,10,1972,5,910,2.0,642.0,642.0,5,1062,2.0,794.0,794.0
0.001,17,2,180,1,66,0.0,38.0,38.0,1,114,0.0,86.0,86.0
0.004,6,10,1702,5,863,1.0,595.0,595.0,5,839,1.0,571.0,571.0
0.005,6,10,2006,5,927,1.0,659.0,659.0,5,1079,1.0,811.0,811.0
0.013,6,13,3735,7,497,2.0,125.0,125.0,6,3238,2.0,1470.0,1459.0
0.012,6,10,1989,5,910,3.0,642.0,642.0,5,1079,2.0,811.0,811.0
0.047,17,2,136,1,60,0.0,32.0,32.0,1,76,0.0,48.0,48.0
0.005,6,10,2006,5,927,1.0,659.0,659.0,5,1079,1.0,811.0,811.0
0.069,6,10,1506,5,395,15.0,127.0,127.0,5,1111,14.0,843.0,843.0
0.009,6,10,1989,5,910,2.0,642.0,642.0,5,1079,2.0,811.0,811.0
0.006,17,2,178,1,81,0.0,53.0,53.0,1,97,0.0,69.0,69.0
240.493,6,35,8924,18,2070,14146.0,691.0,225.0,17,6854,15030.0,1402.0,597.0
0.001,17,2,180,1,66,0.0,38.0,38.0,1,114,0.0,86.0,86.0
0.005,6,10,2006,5,927,1.0,659.0,659.0,5,1079,1.0,811.0,811.0
0.004,6,10,2006,5,927,1.0,659.0,659.0,5,1079,1.0,811.0,811.0
0.004,6,10,2007,5,928,1.0,660.0,660.0,5,1079,1.0,811.0,811.0
1797.571,6,244,35804,152,26032,11904.0,302.0,302.0,92,9772,19753.0,83.0,83.0
0.016,6,10,1989,5,910,4.0,642.0,642.0,5,1079,4.0,811.0,811.0
0.008,17,2,194,1,59,0.0,31.0,31.0,1,135,0.0,107.0,107.0
0.005,17,2,144,1,64,0.0,36.0,36.0,1,80,0.0,52.0,52.0
0.009,6,10,1990,5,911,2.0,643.0,643.0,5,1079,2.0,811.0,811.0
0.016,6,10,1989,5,910,4.0,642.0,642.0,5,1079,3.0,811.0,811.0
0.001,17,2,180,1,66,0.0,38.0,38.0,1,114,0.0,86.0,86.0
0.09,6,10,1990,5,911,22.0,643.0,643.0,5,1079,22.0,811.0,811.0
15.074,17,14,9191,8,6902,2149.0,1350.0,834.0,6,2289,3009.0,1350.0,353.0
0.082,6,10,1506,5,395,17.0,127.0,127.0,5,1111,18.0,843.0,843.0
0.016,6,10,1631,5,848,4.0,580.0,580.0,5,783,3.0,515.0,515.0
0.006,6,10,2007,5,928,1.0,660.0,660.0,5,1079,1.0,811.0,811.0
0.01,6,10,1990,5,911,2.0,643.0,643.0,5,1079,2.0,811.0,811.0
0.01,6,10,1990,5,911,2.0,643.0,643.0,5,1079,2.0,811.0,811.0
0.011,6,10,1990,5,911,2.0,643.0,643.0,5,1079,2.0,811.0,811.0
0.007,6,10,2000,5,927,1.0,659.0,659.0,5,1073,1.0,805.0,805.0
0.068,17,8,3613,4,1874,22.0,1350.0,440.0,4,1739,11.0,1350.0,406.0
0.004,17,2,148,1,60,0.0,32.0,32.0,1,88,0.0,60.0,60.0
0.135,6,10,1506,5,395,32.0,127.0,127.0,5,1111,30.0,843.0,843.0
0.009,6,10,1972,5,910,2.0,642.0,642.0,5,1062,2.0,794.0,794.0
0.004,6,10,2006,5,927,1.0,659.0,659.0,5,1079,1.0,811.0,811.0
0.011,6,10,1989,5,910,2.0,642.0,642.0,5,1079,2.0,811.0,811.0
0.005,6,14,3736,7,446,0.0,74.0,74.0,7,3290,0.0,1448.0,972.0
177.397,17,84,11927,42,2788,4326.0,44.0,38.0,42,9139,4326.0,261.0,189.0
0.04,17,2,148,1,60,0.0,32.0,32.0,1,88,0.0,60.0,60.0
0.083,6,10,1506,5,395,18.0,127.0,127.0,5,1111,16.0,843.0,843.0
0.086,6,10,1506,5,395,14.0,127.0,127.0,5,1111,18.0,843.0,843.0
0.126,6,10,1506,5,395,27.0,127.0,127.0,5,1111,30.0,843.0,843.0
0.011,6,10,1989,5,910,2.0,642.0,642.0,5,1079,2.0,811.0,811.0
1787.421,6,150,19350,90,13740,20083.0,302.0,302.0,60,5610,30295.0,83.0,83.0
0.106,6,10,1506,5,395,23.0,127.0,127.0,5,1111,24.0,843.0,843.0
0.015,6,10,1990,5,911,3.0,643.0,643.0,5,1079,3.0,811.0,811.0
240.09,6,16,4480,9,963,30011.0,238.0,166.0,7,3517,40014.0,1402.0,786.0
40.076,17,10,676,5,460,10016.0,104.0,64.0,5,216,10018.0,20.0,15.0
0.005,6,10,1689,5,839,1.0,571.0,571.0,5,850,1.0,582.0,582.0
0.017,6,10,1972,5,910,4.0,642.0,642.0,5,1062,4.0,794.0,794.0
0.018,6,10,1972,5,910,4.0,642.0,642.0,5,1062,4.0,794.0,794.0
0.006,6,10,1689,5,839,1.0,571.0,571.0,5,850,1.0,582.0,582.0
0.08,6,10,1506,5,395,17.0,127.0,127.0,5,1111,17.0,843.0,843.0
0.131,17,2,184,1,61,0.0,33.0,33.0,1,123,0.0,95.0,95.0
0.007,6,10,1547,5,764,1.0,496.0,496.0,5,783,1.0,515.0,515.0
0.009,6,12,1926,6,1189,1.0,659.0,434.0,6,737,1.0,417.0,417.0
0.004,6,10,2006,5,927,1.0,659.0,659.0,5,1079,1.0,811.0,811.0
0.005,17,2,140,1,62,0.0,34.0,34.0,1,78,0.0,50.0,50.0
1771.23,6,64,7361,42,4485,43200.0,1641.0,109.0,22,2876,84336.0,1112.0,82.0
0.008,6,10,1990,5,911,2.0,643.0,643.0,5,1079,2.0,811.0,811.0
0.005,17,2,169,1,62,0.0,34.0,34.0,1,107,0.0,79.0,79.0
0.013,6,10,1972,5,910,3.0,642.0,642.0,5,1062,3.0,794.0,794.0
0.039,17,4,284,2,120,0.0,32.0,32.0,2,164,36.0,60.0,54.0
0.019,6,19,9922,11,704,1.0,124.0,124.0,8,9218,2.0,2896.0,2198.0
0.002,17,2,162,1,73,0.0,45.0,45.0,1,89,0.0,61.0,61.0
413.494,6,29,4409,12,3102,10911.0,494.0,494.0,17,1307,25843.0,83.0,83.0
0.005,17,2,179,1,71,0.0,43.0,43.0,1,108,0.0,80.0,80.0
0.005,6,10,2006,5,927,1.0,659.0,659.0,5,1079,1.0,811.0,811.0
354.04,6,21,1794,16,1030,23602.0,190.0,190.0,5,764,60001.0,463.0,248.0
0.005,6,10,2006,5,927,1.0,659.0,659.0,5,1079,1.0,811.0,811.0
0.011,6,10,1972,5,910,2.0,642.0,642.0,5,1062,2.0,794.0,794.0
0.009,6,10,1990,5,911,2.0,643.0,643.0,5,1079,2.0,811.0,811.0
40.063,17,10,676,5,460,10012.0,104.0,64.0,5,216,10015.0,20.0,15.0
0.005,6,10,1547,5,764,1.0,496.0,496.0,5,783,1.0,515.0,515.0
0.113,6,10,1506,5,395,23.0,127.0,127.0,5,1111,22.0,843.0,843.0
0.009,6,10,1972,5,910,2.0,642.0,642.0,5,1062,2.0,794.0,794.0
0.018,6,10,1972,5,910,4.0,642.0,642.0,5,1062,4.0,794.0,794.0
0.181,6,3,453,2,321,181.0,241.0,241.0,1,132,0.0,92.0,92.0
240.101,6,16,4482,9,963,30012.0,238.0,166.0,7,3519,40016.0,1402.0,786.0
0.069,6,10,1506,5,395,15.0,127.0,127.0,5,1111,16.0,843.0,843.0
0.043,6,13,3816,7,578,7.0,206.0,206.0,6,3238,8.0,1470.0,1459.0
10.865,17,28,4422,14,1995,827.0,270.0,114.0,14,2427,827.0,586.0,145.0
0.005,6,10,2006,5,927,1.0,659.0,659.0,5,1079,1.0,811.0,811.0
1793.339,6,543,190506,268,163427,6716.0,2883.0,952.0,275,27079,6545.0,580.0,126.0
280.341,6,24,6115,11,1226,28034.0,267.0,156.0,13,4889,23357.0,1400.0,873.0
0.043,17,2,152,1,76,0.0,48.0,48.0,1,76,0.0,48.0,48.0
0.093,6,10,1506,5,395,21.0,127.0,127.0,5,1111,19.0,843.0,843.0
0.011,6,10,1983,5,910,2.0,642.0,642.0,5,1073,2.0,805.0,805.0
0.119,6,10,1506,5,395,25.0,127.0,127.0,5,1111,26.0,843.0,843.0
0.005,6,10,2000,5,927,1.0,659.0,659.0,5,1073,1.0,805.0,805.0
0.001,17,2,180,1,66,0.0,38.0,38.0,1,114,0.0,86.0,86.0
0.007,17,2,179,1,71,0.0,43.0,43.0,1,108,0.0,80.0,80.0
0.035,17,2,152,1,76,0.0,48.0,48.0,1,76,0.0,48.0,48.0
0.008,6,10,1989,5,910,2.0,642.0,642.0,5,1079,2.0,811.0,811.0
0.005,6,10,1643,5,860,1.0,592.0,592.0,5,783,1.0,515.0,515.0
240.69,6,37,9653,19,2173,13369.0,745.0,235.0,18,7480,14156.0,1402.0,595.0
377.298,6,21,1795,16,1030,25153.0,190.0,190.0,5,765,60024.0,464.0,248.0
0.107,6,10,1506,5,395,26.0,127.0,127.0,5,1111,23.0,843.0,843.0
0.005,17,2,166,1,75,0.0,47.0,47.0,1,91,0.0,63.0,63.0
0.005,6,10,2007,5,928,1.0,660.0,660.0,5,1079,1.0,811.0,811.0
0.001,17,2,166,1,75,0.0,47.0,47.0,1,91,0.0,63.0,63.0
0.006,6,10,1547,5,764,1.0,496.0,496.0,5,783,1.0,515.0,515.0
0.014,6,10,1989,5,910,3.0,642.0,642.0,5,1079,3.0,811.0,811.0
0.013,6,10,1972,5,910,3.0,642.0,642.0,5,1062,3.0,794.0,794.0
0.1,6,10,1506,5,395,21.0,127.0,127.0,5,1111,20.0,843.0,843.0
0.024,6,13,3735,7,497,3.0,125.0,125.0,6,3238,4.0,1470.0,1459.0
0.014,6,10,1972,5,910,3.0,642.0,642.0,5,1062,3.0,794.0,794.0
0.011,6,10,1972,5,910,2.0,642.0,642.0,5,1062,2.0,794.0,794.0
361.844,6,21,1793,16,1030,24122.0,190.0,190.0,5,763,60009.0,462.0,247.0
0.077,6,10,1506,5,395,15.0,127.0,127.0,5,1111,17.0,843.0,843.0
0.005,17,2,144,1,64,0.0,36.0,36.0,1,80,0.0,52.0,52.0
240.091,6,16,4482,9,963,30011.0,238.0,166.0,7,3519,40014.0,1402.0,786.0
0.003,17,2,136,1,60,0.0,32.0,32.0,1,76,0.0,48.0,48.0
0.127,17,2,182,1,65,0.0,37.0,37.0,1,117,0.0,89.0,89.0
0.097,6,10,1506,5,395,22.0,127.0,127.0,5,1111,22.0,843.0,843.0
10.898,17,28,4420,14,1993,829.0,268.0,114.0,14,2427,829.0,586.0,145.0
40.084,17,10,676,5,460,10020.0,104.0,64.0,5,216,10020.0,20.0,15.0
0.064,6,10,1506,5,395,14.0,127.0,127.0,5,1111,15.0,843.0,843.0
0.014,6,10,1972,5,910,3.0,642.0,642.0,5,1062,3.0,794.0,794.0
0.006,6,10,1547,5,764,1.0,496.0,496.0,5,783,1.0,515.0,515.0
0.005,6,10,2000,5,927,1.0,659.0,659.0,5,1073,1.0,805.0,805.0
0.008,17,2,194,1,59,0.0,31.0,31.0,1,135,0.0,107.0,107.0
0.053,17,2,152,1,76,0.0,48.0,48.0,1,76,0.0,48.0,48.0
0.079,6,10,1506,5,395,18.0,127.0,127.0,5,1111,16.0,843.0,843.0
0.001,17,2,180,1,66,0.0,38.0,38.0,1,114,0.0,86.0,86.0
0.014,6,10,1972,5,910,3.0,642.0,642.0,5,1062,3.0,794.0,794.0
0.001,17,2,166,1,75,0.0,47.0,47.0,1,91,0.0,63.0,63.0
0.012,6,10,1990,5,911,3.0,643.0,643.0,5,1079,2.0,811.0,811.0
40.086,17,10,676,5,460,10014.0,104.0,64.0,5,216,10020.0,20.0,15.0
0.005,6,10,2006,5,927,1.0,659.0,659.0,5,1079,1.0,811.0,811.0
40.06,17,10,676,5,460,10013.0,104.0,64.0,5,216,10014.0,20.0,15.0
0.004,6,10,2000,5,927,1.0,659.0,659.0,5,1073,1.0,805.0,805.0
0.037,17,2,152,1,76,0.0,48.0,48.0,1,76,0.0,48.0,48.0
40.057,17,10,676,5,460,10011.0,104.0,64.0,5,216,10010.0,20.0,15.0
11.17,17,28,4422,14,1994,846.0,269.0,114.0,14,2428,846.0,587.0,145.0
0.014,6,10,1983,5,910,3.0,642.0,642.0,5,1073,3.0,805.0,805.0
0.078,6,10,1506,5,395,18.0,127.0,127.0,5,1111,17.0,843.0,843.0
0.005,6,10,1779,5,928,1.0,660.0,660.0,5,851,1.0,583.0,583.0
0.014,6,10,1989,5,910,3.0,642.0,642.0,5,1079,3.0,811.0,811.0
0.004,17,2,148,1,60,0.0,32.0,32.0,1,88,0.0,60.0,60.0
0.019,6,10,1762,5,911,4.0,643.0,643.0,5,851,4.0,583.0,583.0
300.315,6,16,2170,9,684,37518.0,146.0,146.0,7,1486,50024.0,419.0,398.0
0.02,6,10,1990,5,911,4.0,643.0,643.0,5,1079,5.0,811.0,811.0
0.006,17,2,273,1,66,0.0,38.0,38.0,1,207,0.0,179.0,179.0
0.001,17,2,180,1,66,0.0,38.0,38.0,1,114,0.0,86.0,86.0
0.077,6,10,1506,5,395,17.0,127.0,127.0,5,1111,18.0,843.0,843.0
0.122,6,10,1506,5,395,26.0,127.0,127.0,5,1111,29.0,843.0,843.0
0.022,6,10,1990,5,911,5.0,643.0,643.0,5,1079,5.0,811.0,811.0
0.025,6,10,1983,5,910,6.0,642.0,642.0,5,1073,6.0,805.0,805.0
242.421,6,381,347131,179,20829,1361.0,2736.0,885.0,202,326302,1206.0,2804.0,1644.0
0.005,6,10,2007,5,928,1.0,660.0,660.0,5,1079,1.0,811.0,811.0
0.043,17,2,152,1,76,0.0,48.0,48.0,1,76,0.0,48.0,48.0
0.004,17,2,148,1,60,0.0,32.0,32.0,1,88,0.0,60.0,60.0
1770.472,6,83,4368,42,2210,43181.0,26.0,26.0,41,2158,44260.0,26.0,26.0
0.215,6,16,2777,8,1395,30.0,533.0,323.0,8,1382,19.0,529.0,239.0
0.006,6,10,1689,5,839,1.0,571.0,571.0,5,850,1.0,582.0,582.0
0.005,17,2,158,1,63,0.0,35.0,35.0,1,95,0.0,67.0,67.0
0.005,6,10,1779,5,928,1.0,660.0,660.0,5,851,1.0,583.0,583.0
0.012,6,10,1989,5,910,3.0,642.0,642.0,5,1079,3.0,811.0,811.0
0.01,6,10,1983,5,910,2.0,642.0,642.0,5,1073,2.0,805.0,805.0
123.974,6,21,8145,11,1985,82.0,1174.0,504.0,10,6160,13757.0,2720.0,958.0
0.005,6,10,1547,5,764,1.0,496.0,496.0,5,783,1.0,515.0,515.0
0.013,6,10,1972,5,910,3.0,642.0,642.0,5,1062,3.0,794.0,794.0
324.874,17,20,1124,10,716,36082.0,48.0,43.0,10,408,36082.0,20.0,12.0
0.041,17,2,136,1,60,0.0,32.0,32.0,1,76,0.0,48.0,48.0
0.103,6,10,1506,5,395,23.0,127.0,127.0,5,1111,19.0,843.0,843.0
15.073,17,15,9238,8,6902,2149.0,1350.0,834.0,7,2336,2507.0,1350.0,305.0
0.013,17,2,179,1,71,0.0,43.0,43.0,1,108,0.0,80.0,80.0
0.005,6,10,1854,5,889,1.0,621.0,621.0,5,965,1.0,697.0,697.0
0.011,6,10,1972,5,910,2.0,642.0,642.0,5,1062,2.0,794.0,794.0
0.005,6,14,3742,7,452,0.0,80.0,80.0,7,3290,0.0,1448.0,972.0
0.093,6,10,1506,5,395,21.0,127.0,127.0,5,1111,18.0,843.0,843.0
0.171,6,3,453,2,321,171.0,241.0,241.0,1,132,0.0,92.0,92.0
0.133,6,10,1506,5,395,31.0,127.0,127.0,5,1111,30.0,843.0,843.0
0.101,6,10,1506,5,395,24.0,127.0,127.0,5,1111,24.0,843.0,843.0
0.004,6,10,2000,5,927,1.0,659.0,659.0,5,1073,1.0,805.0,805.0
0.014,6,10,1983,5,910,3.0,642.0,642.0,5,1073,3.0,805.0,805.0
0.018,17,4,284,2,120,0.0,32.0,32.0,2,164,0.0,60.0,54.0
0.004,6,10,1702,5,863,1.0,595.0,595.0,5,839,1.0,571.0,571.0
0.009,6,10,1990,5,911,2.0,643.0,643.0,5,1079,2.0,811.0,811.0
0.01,6,10,1972,5,910,2.0,642.0,642.0,5,1062,2.0,794.0,794.0
240.103,6,16,4481,9,963,30012.0,238.0,166.0,7,3518,40016.0,1402.0,786.0
44.87,58,5,360,4,288,14956.0,24.0,24.0,1,72,0.0,24.0,24.0
0.013,6,13,3735,7,497,2.0,125.0,125.0,6,3238,2.0,1470.0,1459.0
0.004,6,10,2000,5,927,1.0,659.0,659.0,5,1073,1.0,805.0,805.0
292.92,6,370,346214,187,21288,1574.0,2736.0,888.0,183,324926,1609.0,3002.0,1866.0
0.005,6,10,1854,5,889,1.0,621.0,621.0,5,965,1.0,697.0,697.0
0.005,6,10,1779,5,928,1.0,660.0,660.0,5,851,1.0,583.0,583.0
1792.2,6,582,193893,296,165704,6075.0,2883.0,933.0,286,28189,6288.0,580.0,122.0
361.811,6,21,1792,16,1030,24120.0,190.0,190.0,5,762,60010.0,461.0,247.0
0.004,6,10,2007,5,928,1.0,660.0,660.0,5,1079,1.0,811.0,811.0
0.011,6,10,1989,5,910,2.0,642.0,642.0,5,1079,2.0,811.0,811.0
0.005,6,10,1989,5,927,1.0,659.0,659.0,5,1062,1.0,794.0,794.0
0.004,6,10,2006,5,927,1.0,659.0,659.0,5,1079,1.0,811.0,811.0
0.005,17,2,230,1,68,0.0,40.0,40.0,1,162,0.0,134.0,134.0
40.067,17,10,676,5,460,10016.0,104.0,64.0,5,216,10015.0,20.0,15.0
0.005,6,10,2006,5,927,1.0,659.0,659.0,5,1079,1.0,811.0,811.0
0.005,6,10,2000,5,927,1.0,659.0,659.0,5,1073,1.0,805.0,805.0
0.086,6,10,1506,5,395,18.0,127.0,127.0,5,1111,17.0,843.0,843.0
0.039,17,4,284,2,120,0.0,32.0,32.0,2,164,36.0,60.0,54.0
0.004,6,10,1989,5,927,1.0,659.0,659.0,5,1062,1.0,794.0,794.0
0.099,6,10,1506,5,395,21.0,127.0,127.0,5,1111,22.0,843.0,843.0
0.003,6,10,1702,5,863,0.0,595.0,595.0,5,839,0.0,571.0,571.0
0.005,6,10,2007,5,928,1.0,660.0,660.0,5,1079,1.0,811.0,811.0
0.005,17,2,144,1,64,0.0,36.0,36.0,1,80,0.0,52.0,52.0
0.016,17,2,198,1,91,0.0,63.0,63.0,1,107,0.0,79.0,79.0
0.011,6,13,3735,7,497,1.0,125.0,125.0,6,3238,2.0,1470.0,1459.0
0.008,6,10,1983,5,910,2.0,642.0,642.0,5,1073,2.0,805.0,805.0
0.006,17,2,164,1,74,0.0,46.0,46.0,1,90,0.0,62.0,62.0
0.011,6,10,1972,5,910,2.0,642.0,642.0,5,1062,2.0,794.0,794.0
0.005,17,2,179,1,71,0.0,43.0,43.0,1,108,0.0,80.0,80.0
0.008,6,10,1983,5,910,2.0,642.0,642.0,5,1073,2.0,805.0,805.0
0.13,6,10,1506,5,395,30.0,127.0,127.0,5,1111,28.0,843.0,843.0
0.005,6,10,2006,5,927,1.0,659.0,659.0,5,1079,1.0,811.0,811.0
0.005,6,10,1643,5,860,1.0,592.0,592.0,5,783,1.0,515.0,515.0
0.037,17,2,412,1,61,0.0,33.0,33.0,1,351,0.0,323.0,323.0
0.008,6,10,1983,5,910,2.0,642.0,642.0,5,1073,2.0,805.0,805.0
0.123,17,2,80,1,32,0.0,4.0,4.0,1,48,0.0,20.0,20.0
0.006,6,10,1689,5,839,1.0,571.0,571.0,5,850,1.0,582.0,582.0
240.094,6,16,4481,9,963,30011.0,238.0,166.0,7,3518,40015.0,1402.0,786.0
0.072,17,4,284,2,120,0.0,32.0,32.0,2,164,69.0,60.0,54.0
0.039,17,2,148,1,60,0.0,32.0,32.0,1,88,0.0,60.0,60.0
0.005,6,10,2007,5,928,1.0,660.0,660.0,5,1079,1.0,811.0,811.0
0.005,6,10,2006,5,927,1.0,659.0,659.0,5,1079,1.0,811.0,811.0
0.008,6,10,1989,5,910,2.0,642.0,642.0,5,1079,2.0,811.0,811.0
0.005,17,2,164,1,74,0.0,46.0,46.0,1,90,0.0,62.0,62.0
0.005,6,10,2007,5,928,1.0,660.0,660.0,5,1079,1.0,811.0,811.0
0.015,17,2,136,1,60,0.0,32.0,32.0,1,76,0.0,48.0,48.0
0.005,6,10,2007,5,928,1.0,660.0,660.0,5,1079,1.0,811.0,811.0
240.01,6,9,787,5,488,60002.0,232.0,232.0,4,299,80002.0,83.0,83.0
0.01,6,10,1972,5,910,2.0,642.0,642.0,5,1062,2.0,794.0,794.0
0.005,6,10,1774,5,923,1.0,655.0,655.0,5,851,1.0,583.0,583.0
0.125,6,10,1506,5,395,28.0,127.0,127.0,5,1111,27.0,843.0,843.0
0.095,6,10,1506,5,395,20.0,127.0,127.0,5,1111,19.0,843.0,843.0
0.004,6,10,2000,5,927,1.0,659.0,659.0,5,1073,1.0,805.0,805.0
0.006,6,10,1547,5,764,1.0,496.0,496.0,5,783,1.0,515.0,515.0
0.007,17,2,170,1,65,0.0,37.0,37.0,1,105,0.0,77.0,77.0
0.005,17,2,214,1,75,0.0,47.0,47.0,1,139,0.0,111.0,111.0
0.004,6,10,2006,5,927,1.0,659.0,659.0,5,1079,1.0,811.0,811.0
300.395,6,16,2170,9,684,37529.0,146.0,146.0,7,1486,50038.0,419.0,398.0
0.004,17,2,412,1,61,0.0,33.0,33.0,1,351,0.0,323.0,323.0
0.006,6,10,1547,5,764,1.0,496.0,496.0,5,783,1.0,515.0,515.0
0.004,17,4,284,2,120,0.0,32.0,32.0,2,164,0.0,60.0,54.0
0.087,6,10,1506,5,395,19.0,127.0,127.0,5,1111,17.0,843.0,843.0
0.062,6,10,1506,5,395,14.0,127.0,127.0,5,1111,13.0,843.0,843.0
0.016,17,2,198,1,91,0.0,63.0,63.0,1,107,0.0,79.0,79.0
0.01,6,10,1989,5,910,2.0,642.0,642.0,5,1079,2.0,811.0,811.0
0.008,6,10,2006,5,927,2.0,659.0,659.0,5,1079,2.0,811.0,811.0
0.009,6,10,1972,5,910,2.0,642.0,642.0,5,1062,2.0,794.0,794.0
0.005,6,10,2006,5,927,1.0,659.0,659.0,5,1079,1.0,811.0,811.0
0.005,17,2,154,1,69,0.0,41.0,41.0,1,85,0.0,57.0,57.0
0.004,6,10,2007,5,928,1.0,660.0,660.0,5,1079,1.0,811.0,811.0
1755.904,6,105,6240,60,3510,29760.0,26.0,26.0,45,2730,39906.0,26.0,26.0
40.062,17,10,676,5,460,10014.0,104.0,64.0,5,216,10014.0,20.0,15.0
0.005,6,10,2007,5,928,1.0,660.0,660.0,5,1079,1.0,811.0,811.0
325.836,6,32,11769,18,3043,19166.0,1273.0,417.0,14,8726,20446.0,2804.0,998.0
0.075,6,10,1506,5,395,16.0,127.0,127.0,5,1111,16.0,843.0,843.0
0.01,6,10,1983,5,910,2.0,642.0,642.0,5,1073,2.0,805.0,805.0
0.094,6,10,1506,5,395,21.0,127.0,127.0,5,1111,21.0,843.0,843.0
0.006,6,10,1547,5,764,1.0,496.0,496.0,5,783,1.0,515.0,515.0
0.005,6,10,1774,5,923,1.0,655.0,655.0,5,851,1.0,583.0,583.0
0.011,6,10,1989,5,910,2.0,642.0,642.0,5,1079,2.0,811.0,811.0
0.08,6,10,1506,5,395,17.0,127.0,127.0,5,1111,18.0,843.0,843.0
0.005,6,10,2007,5,928,1.0,660.0,660.0,5,1079,1.0,811.0,811.0
0.007,6,10,1547,5,764,1.0,496.0,496.0,5,783,1.0,515.0,515.0
0.006,17,2,225,1,65,0.0,37.0,37.0,1,160,0.0,132.0,132.0
0.012,6,10,1983,5,910,3.0,642.0,642.0,5,1073,2.0,805.0,805.0
0.237,6,42,11484,22,3177,11.0,1081.0,203.0,20,8307,11.0,1402.0,659.0
0.004,17,4,284,2,120,0.0,32.0,32.0,2,164,0.0,60.0,54.0
0.013,6,13,3735,7,497,2.0,125.0,125.0,6,3238,2.0,1470.0,1459.0
0.02,6,10,1989,5,910,5.0,642.0,642.0,5,1079,4.0,811.0,811.0
0.013,6,10,1677,5,827,3.0,559.0,559.0,5,850,3.0,582.0,582.0
0.11,6,10,1506,5,395,23.0,127.0,127.0,5,1111,22.0,843.0,843.0
0.01,6,10,1990,5,911,2.0,643.0,643.0,5,1079,2.0,811.0,811.0
0.005,6,10,2006,5,927,1.0,659.0,659.0,5,1079,1.0,811.0,811.0
0.022,6,10,1989,5,910,5.0,642.0,642.0,5,1079,5.0,811.0,811.0
0.006,6,10,1689,5,839,1.0,571.0,571.0,5,850,1.0,582.0,582.0
0.008,6,13,3735,7,497,1.0,125.0,125.0,6,3238,1.0,1470.0,1459.0
0.001,17,2,180,1,66,0.0,38.0,38.0,1,114,0.0,86.0,86.0
0.007,17,2,179,1,71,0.0,43.0,43.0,1,108,0.0,80.0,80.0
0.025,6,10,1990,5,911,6.0,643.0,643.0,5,1079,6.0,811.0,811.0
0.015,6,10,1990,5,911,3.0,643.0,643.0,5,1079,3.0,811.0,811.0
40.102,17,10,676,5,460,10021.0,104.0,64.0,5,216,10024.0,20.0,15.0
0.018,6,10,1972,5,910,4.0,642.0,642.0,5,1062,4.0,794.0,794.0
0.111,6,10,1506,5,395,25.0,127.0,127.0,5,1111,24.0,843.0,843.0
0.001,17,2,180,1,66,0.0,38.0,38.0,1,114,0.0,86.0,86.0
0.019,6,10,1989,5,910,4.0,642.0,642.0,5,1079,4.0,811.0,811.0
0.071,17,4,284,2,120,0.0,32.0,32.0,2,164,68.0,60.0,54.0
0.007,6,10,1547,5,764,1.0,496.0,496.0,5,783,1.0,515.0,515.0
0.004,17,2,136,1,60,0.0,32.0,32.0,1,76,0.0,48.0,48.0
0.005,6,14,3736,7,446,0.0,74.0,74.0,7,3290,0.0,1448.0,972.0
2.592,6,23,6110,13,1979,216.0,517.0,258.0,10,4131,275.0,1288.0,720.0
0.011,6,10,1990,5,911,2.0,643.0,643.0,5,1079,2.0,811.0,811.0
0.004,17,4,284,2,120,0.0,32.0,32.0,2,164,0.0,60.0,54.0
0.079,6,10,1506,5,395,17.0,127.0,127.0,5,1111,16.0,843.0,843.0
0.084,6,10,1506,5,395,19.0,127.0,127.0,5,1111,19.0,843.0,843.0
354.011,6,19,1691,15,978,25286.0,190.0,190.0,4,713,80003.0,497.0,497.0
0.004,17,4,284,2,120,0.0,32.0,32.0,2,164,0.0,60.0,54.0
0.02,6,10,1990,5,911,4.0,643.0,643.0,5,1079,5.0,811.0,811.0
240.097,6,16,4481,9,963,30012.0,238.0,166.0,7,3518,40015.0,1402.0,786.0
0.001,17,2,268,1,70,0.0,42.0,42.0,1,198,0.0,170.0,170.0
0.004,17,2,186,1,61,0.0,33.0,33.0,1,125,0.0,97.0,97.0
15.074,17,15,9238,8,6902,2149.0,1350.0,834.0,7,2336,2507.0,1350.0,305.0
240.491,6,33,8635,17,1837,15028.0,570.0,189.0,16,6798,16030.0,1402.0,597.0
0.004,17,2,148,1,60,0.0,32.0,32.0,1,88,0.0,60.0,60.0
0.007,17,2,179,1,71,0.0,43.0,43.0,1,108,0.0,80.0,80.0
40.058,17,10,676,5,460,10013.0,104.0,64.0,5,216,10013.0,20.0,15.0
0.005,6,10,1989,5,927,1.0,659.0,659.0,5,1062,1.0,794.0,794.0
1786.175,6,154,19574,92,13852,19628.0,302.0,302.0,62,5722,29281.0,83.0,83.0
0.005,6,10,2006,5,927,1.0,659.0,659.0,5,1079,1.0,811.0,811.0
0.072,6,10,1506,5,395,16.0,127.0,127.0,5,1111,13.0,843.0,843.0
40.074,17,10,676,5,460,10017.0,104.0,64.0,5,216,10017.0,20.0,15.0
0.005,6,10,2000,5,927,1.0,659.0,659.0,5,1073,1.0,805.0,805.0
0.009,6,10,1989,5,910,2.0,642.0,642.0,5,1079,2.0,811.0,811.0
0.083,6,8,3114,4,2314,27.0,1124.0,1053.0,4,800,26.0,296.0,296.0
0.012,6,10,1677,5,827,3.0,559.0,559.0,5,850,3.0,582.0,582.0
0.005,6,10,2006,5,927,1.0,659.0,659.0,5,1079,1.0,811.0,811.0
0.172,6,10,1506,5,395,39.0,127.0,127.0,5,1111,41.0,843.0,843.0
0.004,17,2,148,1,60,0.0,32.0,32.0,1,88,0.0,60.0,60.0
0.004,6,10,2006,5,927,1.0,659.0,659.0,5,1079,1.0,811.0,811.0
0.006,6,10,1643,5,860,1.0,592.0,592.0,5,783,1.0,515.0,515.0
0.004,17,2,148,1,60,0.0,32.0,32.0,1,88,0.0,60.0,60.0
10.974,17,28,4420,14,1993,835.0,268.0,114.0,14,2427,834.0,586.0,145.0
0.004,6,10,1989,5,927,1.0,659.0,659.0,5,1062,1.0,794.0,794.0
0.01,6,10,1990,5,911,2.0,643.0,643.0,5,1079,2.0,811.0,811.0
240.256,6,31,15958,15,6972,17161.0,2736.0,1032.0,16,8986,16016.0,1908.0,1163.0
0.163,17,2,152,1,76,0.0,48.0,48.0,1,76,0.0,48.0,48.0
0.073,6,10,1506,5,395,16.0,127.0,127.0,5,1111,16.0,843.0,843.0
0.076,6,10,1506,5,395,14.0,127.0,127.0,5,1111,16.0,843.0,843.0
0.024,6,14,3787,7,497,4.0,125.0,125.0,7,3290,4.0,1448.0,972.0
0.012,6,10,1972,5,910,3.0,642.0,642.0,5,1062,2.0,794.0,794.0
0.04,17,4,364,2,160,0.0,52.0,52.0,2,204,37.0,80.0,74.0
0.018,6,10,1989,5,910,4.0,642.0,642.0,5,1079,4.0,811.0,811.0
0.004,17,2,136,1,60,0.0,32.0,32.0,1,76,0.0,48.0,48.0
11.115,17,28,4422,14,1995,842.0,270.0,114.0,14,2427,842.0,586.0,145.0
0.12,6,10,1506,5,395,28.0,127.0,127.0,5,1111,28.0,843.0,843.0
15.075,17,15,9239,8,6902,2149.0,1350.0,834.0,7,2337,2507.0,1350.0,305.0
0.004,6,10,1989,5,927,1.0,659.0,659.0,5,1062,1.0,794.0,794.0
0.091,6,10,1506,5,395,20.0,127.0,127.0,5,1111,20.0,843.0,843.0
0.005,6,10,1689,5,839,1.0,571.0,571.0,5,850,1.0,582.0,582.0
0.016,6,10,1990,5,911,4.0,643.0,643.0,5,1079,3.0,811.0,811.0
0.009,6,10,1983,5,910,2.0,642.0,642.0,5,1073,2.0,805.0,805.0
0.006,6,10,1547,5,764,1.0,496.0,496.0,5,783,1.0,515.0,515.0
0.054,17,2,152,1,76,0.0,48.0,48.0,1,76,0.0,48.0,48.0
0.011,6,10,1990,5,911,2.0,643.0,643.0,5,1079,2.0,811.0,811.0
0.005,6,13,3747,7,509,0.0,137.0,137.0,6,3238,1.0,1470.0,1459.0
373.888,6,22,2313,16,867,24925.0,195.0,195.0,6,1446,4635.0,419.0,398.0
0.004,17,2,148,1,60,0.0,32.0,32.0,1,88,0.0,60.0,60.0
40.056,17,10,676,5,460,10013.0,104.0,64.0,5,216,10013.0,20.0,15.0
0.001,17,2,136,1,60,0.0,32.0,32.0,1,76,0.0,48.0,48.0
15.075,17,15,9238,8,6902,2149.0,1350.0,834.0,7,2336,2507.0,1350.0,305.0
0.011,6,10,1972,5,910,2.0,642.0,642.0,5,1062,2.0,794.0,794.0
40.073,17,10,676,5,460,10015.0,104.0,64.0,5,216,10017.0,20.0,15.0
0.022,6,10,1989,5,910,5.0,642.0,642.0,5,1079,5.0,811.0,811.0
1.148,17,6,534,3,195,572.0,37.0,37.0,3,339,537.0,89.0,85.0
0.005,6,10,1779,5,928,1.0,660.0,660.0,5,851,1.0,583.0,583.0
167.043,17,86,12327,43,2883,3977.0,44.0,39.0,43,9444,3977.0,239.0,191.0
0.004,6,10,1989,5,927,1.0,659.0,659.0,5,1062,1.0,794.0,794.0
0.006,17,2,169,1,62,0.0,34.0,34.0,1,107,0.0,79.0,79.0
0.005,6,10,2006,5,927,1.0,659.0,659.0,5,1079,1.0,811.0,811.0
0.005,17,2,230,1,68,0.0,40.0,40.0,1,162,0.0,134.0,134.0
240.027,6,9,787,5,488,60006.0,232.0,232.0,4,299,80008.0,83.0,83.0
0.005,17,2,166,1,75,0.0,47.0,47.0,1,91,0.0,63.0,63.0
0.133,6,10,1506,5,395,32.0,127.0,127.0,5,1111,30.0,843.0,843.0
0.077,6,10,1506,5,395,18.0,127.0,127.0,5,1111,17.0,843.0,843.0
0.121,6,10,1506,5,395,28.0,127.0,127.0,5,1111,29.0,843.0,843.0
0.005,6,10,1689,5,839,1.0,571.0,571.0,5,850,1.0,582.0,582.0
177.625,17,76,11041,38,2550,4799.0,44.0,39.0,38,8491,4800.0,279.0,195.0
0.007,17,2,179,1,71,0.0,43.0,43.0,1,108,0.0,80.0,80.0
40.083,17,10,676,5,460,10019.0,104.0,64.0,5,216,10020.0,20.0,15.0
0.006,6,10,1774,5,923,1.0,655.0,655.0,5,851,1.0,583.0,583.0
0.067,6,10,1506,5,395,14.0,127.0,127.0,5,1111,16.0,843.0,843.0
367.082,6,22,2313,16,867,24472.0,195.0,195.0,6,1446,4639.0,419.0,398.0
0.013,6,10,1972,5,910,3.0,642.0,642.0,5,1062,3.0,794.0,794.0
351.997,6,20,2210,6,1308,12004.0,494.0,494.0,14,902,27076.0,83.0,83.0
15.071,17,15,9238,8,6902,2148.0,1350.0,834.0,7,2336,2507.0,1350.0,305.0
240.093,6,16,4482,9,963,30011.0,238.0,166.0,7,3519,40015.0,1402.0,786.0
0.015,6,10,1972,5,910,3.0,642.0,642.0,5,1062,3.0,794.0,794.0
0.004,17,2,136,1,60,0.0,32.0,32.0,1,76,0.0,48.0,48.0
243.257,6,402,348738,198,21816,1234.0,2736.0,959.0,204,326922,1198.0,2804.0,1630.0
0.004,6,10,2007,5,928,1.0,660.0,660.0,5,1079,1.0,811.0,811.0
0.004,6,10,1989,5,927,1.0,659.0,659.0,5,1062,1.0,794.0,794.0
0.027,6,10,1972,5,910,6.0,642.0,642.0,5,1062,6.0,794.0,794.0
0.005,6,10,1989,5,927,1.0,659.0,659.0,5,1062,1.0,794.0,794.0
359.136,6,21,1795,16,1030,23942.0,190.0,190.0,5,765,60004.0,464.0,248.0
0.004,6,10,2006,5,927,1.0,659.0,659.0,5,1079,1.0,811.0,811.0
0.005,6,10,1643,5,860,1.0,592.0,592.0,5,783,1.0,515.0,515.0
0.117,17,2,80,1,32,0.0,4.0,4.0,1,48,0.0,20.0,20.0
0.014,6,10,1990,5,911,3.0,643.0,643.0,5,1079,3.0,811.0,811.0
0.008,6,12,1926,6,1189,1.0,659.0,434.0,6,737,1.0,417.0,417.0
240.014,6,9,787,5,488,60003.0,232.0,232.0,4,299,80003.0,83.0,83.0
412.961,6,29,4409,12,3102,10911.0,494.0,494.0,17,1307,25809.0,83.0,83.0
240.6,6,33,9262,16,1834,16037.0,622.0,198.0,17,7428,15035.0,1402.0,595.0
0.079,6,20,9194,11,860,7.0,280.0,280.0,9,8334,9.0,1402.0,1309.0
0.095,6,10,1506,5,395,20.0,127.0,127.0,5,1111,18.0,843.0,843.0
0.017,6,10,1990,5,911,4.0,643.0,643.0,5,1079,4.0,811.0,811.0
0.01,6,10,1989,5,910,2.0,642.0,642.0,5,1079,2.0,811.0,811.0
0.005,6,10,2000,5,927,1.0,659.0,659.0,5,1073,1.0,805.0,805.0
0.016,6,13,3735,7,497,2.0,125.0,125.0,6,3238,3.0,1470.0,1459.0
0.001,17,2,180,1,66,0.0,38.0,38.0,1,114,0.0,86.0,86.0
0.006,17,2,180,1,66,0.0,38.0,38.0,1,114,0.0,86.0,86.0
0.009,6,10,1972,5,910,2.0,642.0,642.0,5,1062,2.0,794.0,794.0
0.011,6,10,1983,5,910,2.0,642.0,642.0,5,1073,2.0,805.0,805.0
0.019,6,10,1990,5,911,4.0,643.0,643.0,5,1079,4.0,811.0,811.0
1786.652,6,154,19574,92,13852,19633.0,302.0,302.0,62,5722,29289.0,83.0,83.0
0.02,6,10,1677,5,827,4.0,559.0,559.0,5,850,5.0,582.0,582.0
0.108,6,10,1506,5,395,26.0,127.0,127.0,5,1111,23.0,843.0,843.0
0.008,6,10,1989,5,910,2.0,642.0,642.0,5,1079,1.0,811.0,811.0
0.003,17,2,148,1,60,0.0,32.0,32.0,1,88,0.0,60.0,60.0
0.005,6,10,1989,5,927,1.0,659.0,659.0,5,1062,1.0,794.0,794.0
240.01,6,9,787,5,488,60002.0,232.0,232.0,4,299,80002.0,83.0,83.0
0.009,6,10,1990,5,911,2.0,643.0,643.0,5,1079,2.0,811.0,811.0
0.007,6,10,1989,5,910,1.0,642.0,642.0,5,1079,1.0,811.0,811.0
240.084,6,20,4896,9,2182,30010.0,967.0,568.0,11,2714,24008.0,1162.0,355.0
0.008,6,10,1972,5,910,1.0,642.0,642.0,5,1062,1.0,794.0,794.0
0.084,6,10,1506,5,395,16.0,127.0,127.0,5,1111,18.0,843.0,843.0
0.005,17,2,230,1,68,0.0,40.0,40.0,1,162,0.0,134.0,134.0
300.396,6,16,2170,9,684,37528.0,146.0,146.0,7,1486,50038.0,419.0,398.0
0.072,6,10,1506,5,395,17.0,127.0,127.0,5,1111,14.0,843.0,843.0
0.077,6,10,1506,5,395,17.0,127.0,127.0,5,1111,18.0,843.0,843.0
0.112,6,10,1506,5,395,23.0,127.0,127.0,5,1111,24.0,843.0,843.0
15.077,17,15,9239,8,6902,2149.0,1350.0,834.0,7,2337,2506.0,1350.0,305.0
0.008,6,10,1990,5,911,1.0,643.0,643.0,5,1079,2.0,811.0,811.0
0.004,6,10,2006,5,927,1.0,659.0,659.0,5,1079,1.0,811.0,811.0
0.006,6,10,1547,5,764,1.0,496.0,496.0,5,783,1.0,515.0,515.0
0.017,6,10,1983,5,910,4.0,642.0,642.0,5,1073,4.0,805.0,805.0
0.108,6,10,1506,5,395,25.0,127.0,127.0,5,1111,25.0,843.0,843.0
0.006,6,10,1547,5,764,1.0,496.0,496.0,5,783,1.0,515.0,515.0
15.164,17,50,29452,26,23428,605.0,1350.0,873.0,24,6024,657.0,1350.0,223.0
0.004,6,10,2006,5,927,1.0,659.0,659.0,5,1079,1.0,811.0,811.0
0.008,17,4,284,2,120,4.0,32.0,32.0,2,164,4.0,60.0,54.0
240.017,6,9,787,5,488,60004.0,232.0,232.0,4,299,80004.0,83.0,83.0
0.078,6,10,1506,5,395,17.0,127.0,127.0,5,1111,16.0,843.0,843.0
0.004,6,10,1989,5,927,1.0,659.0,659.0,5,1062,1.0,794.0,794.0
0.001,17,2,180,1,65,0.0,37.0,37.0,1,115,0.0,87.0,87.0
0.001,17,2,180,1,66,0.0,38.0,38.0,1,114,0.0,86.0,86.0
0.006,6,10,1989,5,927,1.0,659.0,659.0,5,1062,1.0,794.0,794.0
0.073,6,10,1506,5,395,17.0,127.0,127.0,5,1111,16.0,843.0,843.0
0.07,6,10,1506,5,395,15.0,127.0,127.0,5,1111,16.0,843.0,843.0
0.093,6,10,1506,5,395,20.0,127.0,127.0,5,1111,20.0,843.0,843.0
0.02,6,10,1762,5,911,5.0,643.0,643.0,5,851,5.0,583.0,583.0
565.377,6,30,9682,16,4942,37691.0,1774.0,586.0,14,4740,43490.0,1402.0,669.0
0.186,17,2,152,1,76,0.0,48.0,48.0,1,76,0.0,48.0,48.0
0.01,6,10,1989,5,910,2.0,642.0,642.0,5,1079,2.0,811.0,811.0
0.013,6,10,1983,5,910,3.0,642.0,642.0,5,1073,3.0,805.0,805.0
0.004,17,4,284,2,120,1.0,32.0,32.0,2,164,0.0,60.0,54.0
0.04,17,2,152,1,76,0.0,48.0,48.0,1,76,0.0,48.0,48.0
0.013,6,10,1989,5,910,3.0,642.0,642.0,5,1079,3.0,811.0,811.0
0.061,6,10,1506,5,395,12.0,127.0,127.0,5,1111,14.0,843.0,843.0
0.187,6,44,11608,24,3280,8.0,1080.0,203.0,20,8328,9.0,1402.0,606.0
0.016,6,13,3735,7,497,2.0,125.0,125.0,6,3238,3.0,1470.0,1459.0
0.005,6,13,3747,7,509,0.0,137.0,137.0,6,3238,1.0,1470.0,1459.0
0.004,6,10,1774,5,923,1.0,655.0,655.0,5,851,1.0,583.0,583.0
0.005,6,10,1547,5,764,1.0,496.0,496.0,5,783,1.0,515.0,515.0
0.011,6,10,1989,5,910,2.0,642.0,642.0,5,1079,2.0,811.0,811.0
356.611,6,19,1691,15,978,25472.0,190.0,190.0,4,713,80004.0,497.0,497.0
0.006,6,10,1547,5,764,1.0,496.0,496.0,5,783,1.0,515.0,515.0
0.015,6,10,1989,5,910,3.0,642.0,642.0,5,1079,3.0,811.0,811.0
0.005,6,10,2007,5,928,1.0,660.0,660.0,5,1079,1.0,811.0,811.0
0.002,17,2,136,1,60,0.0,32.0,32.0,1,76,0.0,48.0,48.0
0.005,6,10,1689,5,839,1.0,571.0,571.0,5,850,1.0,582.0,582.0
300.381,6,16,2170,9,684,37527.0,146.0,146.0,7,1486,50036.0,419.0,398.0
0.015,6,10,1989,5,910,3.0,642.0,642.0,5,1079,3.0,811.0,811.0
240.287,6,41,8669,20,5634,12646.0,2883.0,573.0,21,3035,12014.0,580.0,241.0
496.596,6,206,172458,106,21605,4729.0,2736.0,1339.0,100,150853,5016.0,2917.0,1754.0
0.005,6,10,2006,5,927,1.0,659.0,659.0,5,1079,1.0,811.0,811.0
0.009,6,10,1983,5,910,2.0,642.0,642.0,5,1073,2.0,805.0,805.0
0.009,17,2,148,1,60,0.0,32.0,32.0,1,88,0.0,60.0,60.0
0.048,17,2,179,1,71,0.0,43.0,43.0,1,108,0.0,80.0,80.0
0.089,6,10,1506,5,395,20.0,127.0,127.0,5,1111,16.0,843.0,843.0
0.011,6,10,1983,5,910,2.0,642.0,642.0,5,1073,2.0,805.0,805.0
0.006,17,2,179,1,71,0.0,43.0,43.0,1,108,0.0,80.0,80.0
0.005,6,10,2007,5,928,1.0,660.0,660.0,5,1079,1.0,811.0,811.0
0.006,6,10,1989,5,927,1.0,659.0,659.0,5,1062,1.0,794.0,794.0
0.013,6,10,1972,5,910,3.0,642.0,642.0,5,1062,3.0,794.0,794.0
0.004,6,10,1774,5,923,1.0,655.0,655.0,5,851,1.0,583.0,583.0
0.008,6,10,1631,5,848,2.0,580.0,580.0,5,783,1.0,515.0,515.0
0.005,6,10,2007,5,928,1.0,660.0,660.0,5,1079,1.0,811.0,811.0
0.009,6,13,3735,7,497,1.0,125.0,125.0,6,3238,1.0,1470.0,1459.0
380.073,6,26,3272,18,971,22357.0,195.0,195.0,8,2301,3353.0,775.0,492.0
368.847,6,22,2313,16,867,24589.0,195.0,195.0,6,1446,4643.0,419.0,398.0
0.098,6,10,1506,5,395,22.0,127.0,127.0,5,1111,20.0,843.0,843.0
0.008,6,10,1972,5,910,2.0,642.0,642.0,5,1062,1.0,794.0,794.0
0.016,6,10,1677,5,827,4.0,559.0,559.0,5,850,4.0,582.0,582.0
0.006,6,10,1854,5,889,1.0,621.0,621.0,5,965,1.0,697.0,697.0
40.072,17,10,676,5,460,10017.0,104.0,64.0,5,216,10016.0,20.0,15.0
0.005,6,10,2006,5,927,1.0,659.0,659.0,5,1079,1.0,811.0,811.0
0.065,6,10,1506,5,395,13.0,127.0,127.0,5,1111,14.0,843.0,843.0
0.072,17,2,412,1,61,0.0,33.0,33.0,1,351,0.0,323.0,323.0
0.086,6,10,1506,5,395,18.0,127.0,127.0,5,1111,20.0,843.0,843.0
0.011,6,10,1990,5,911,2.0,643.0,643.0,5,1079,2.0,811.0,811.0
0.004,6,10,1989,5,927,1.0,659.0,659.0,5,1062,1.0,794.0,794.0
0.008,6,10,2007,5,928,2.0,660.0,660.0,5,1079,1.0,811.0,811.0
0.005,6,10,1989,5,927,1.0,659.0,659.0,5,1062,1.0,794.0,794.0
300.75,6,38,10082,21,4604,15037.0,1360.0,622.0,17,5478,535.0,2667.0,435.0
0.071,6,10,1506,5,395,16.0,127.0,127.0,5,1111,15.0,843.0,843.0
0.004,17,2,148,1,60,0.0,32.0,32.0,1,88,0.0,60.0,60.0
0.003,17,2,136,1,60,0.0,32.0,32.0,1,76,0.0,48.0,48.0
0.003,17,2,148,1,60,0.0,32.0,32.0,1,88,0.0,60.0,60.0
0.006,6,10,1774,5,923,1.0,655.0,655.0,5,851,1.0,583.0,583.0
0.017,6,10,1762,5,911,4.0,643.0,643.0,5,851,4.0,583.0,583.0
0.059,17,2,152,1,76,0.0,48.0,48.0,1,76,0.0,48.0,48.0
0.11,6,10,1506,5,395,23.0,127.0,127.0,5,1111,23.0,843.0,843.0
0.027,6,14,3787,7,497,4.0,125.0,125.0,7,3290,4.0,1448.0,972.0
240.02,6,9,787,5,488,60005.0,232.0,232.0,4,299,80005.0,83.0,83.0
0.01,6,10,1989,5,910,2.0,642.0,642.0,5,1079,2.0,811.0,811.0
0.008,6,10,1762,5,911,1.0,643.0,643.0,5,851,2.0,583.0,583.0
0.011,6,10,1972,5,910,2.0,642.0,642.0,5,1062,2.0,794.0,794.0
0.089,6,10,1506,5,395,19.0,127.0,127.0,5,1111,18.0,843.0,843.0
0.006,6,10,1689,5,839,1.0,571.0,571.0,5,850,1.0,582.0,582.0
0.009,6,10,1983,5,910,2.0,642.0,642.0,5,1073,2.0,805.0,805.0
0.024,6,10,1972,5,910,6.0,642.0,642.0,5,1062,5.0,794.0,794.0
0.005,17,2,179,1,71,0.0,43.0,43.0,1,108,0.0,80.0,80.0
0.011,6,10,1989,5,910,2.0,642.0,642.0,5,1079,2.0,811.0,811.0
0.032,6,10,1983,5,910,7.0,642.0,642.0,5,1073,7.0,805.0,805.0
0.005,6,10,2006,5,927,1.0,659.0,659.0,5,1079,1.0,811.0,811.0
0.119,6,10,1506,5,395,27.0,127.0,127.0,5,1111,26.0,843.0,843.0
40.055,17,10,676,5,460,10012.0,104.0,64.0,5,216,10012.0,20.0,15.0
0.001,17,2,136,1,60,0.0,32.0,32.0,1,76,0.0,48.0,48.0
40.072,17,10,676,5,460,10017.0,104.0,64.0,5,216,10017.0,20.0,15.0
454.452,6,53,22162,28,5841,16831.0,1402.0,547.0,25,16321,16434.0,1402.0,938.0
0.07,17,8,3613,4,1874,23.0,1350.0,440.0,4,1739,11.0,1350.0,406.0
0.001,17,2,194,1,57,0.0,29.0,29.0,1,137,0.0,109.0,109.0
0.009,6,10,1989,5,927,2.0,659.0,659.0,5,1062,2.0,794.0,794.0
0.004,17,2,136,1,60,0.0,32.0,32.0,1,76,0.0,48.0,48.0
0.012,6,13,3735,7,497,1.0,125.0,125.0,6,3238,2.0,1470.0,1459.0
0.002,17,2,136,1,60,0.0,32.0,32.0,1,76,0.0,48.0,48.0
0.024,6,10,1972,5,910,5.0,642.0,642.0,5,1062,6.0,794.0,794.0
0.013,6,10,1989,5,910,3.0,642.0,642.0,5,1079,3.0,811.0,811.0
0.163,17,2,152,1,76,0.0,48.0,48.0,1,76,0.0,48.0,48.0
0.135,6,10,1506,5,395,33.0,127.0,127.0,5,1111,20.0,843.0,843.0
11.468,17,28,4394,14,2313,869.0,588.0,137.0,14,2081,869.0,268.0,120.0
0.098,6,10,1506,5,395,23.0,127.0,127.0,5,1111,22.0,843.0,843.0
0.005,17,2,170,1,65,0.0,37.0,37.0,1,105,0.0,77.0,77.0
0.037,6,10,1972,5,910,9.0,642.0,642.0,5,1062,9.0,794.0,794.0
313.575,17,17,968,9,640,39180.0,48.0,43.0,8,328,44777.0,20.0,13.0
0.004,6,10,2006,5,927,1.0,659.0,659.0,5,1079,1.0,811.0,811.0
0.005,6,10,2000,5,927,1.0,659.0,659.0,5,1073,1.0,805.0,805.0
0.012,6,10,1989,5,910,2.0,642.0,642.0,5,1079,2.0,811.0,811.0
0.176,6,10,1506,5,395,22.0,127.0,127.0,5,1111,42.0,843.0,843.0
0.018,6,10,1989,5,910,4.0,642.0,642.0,5,1079,4.0,811.0,811.0
0.017,6,10,1990,5,911,4.0,643.0,643.0,5,1079,4.0,811.0,811.0
0.091,6,10,1506,5,395,20.0,127.0,127.0,5,1111,20.0,843.0,843.0
0.004,17,2,136,1,60,0.0,32.0,32.0,1,76,0.0,48.0,48.0
300.264,6,16,2170,9,684,37512.0,146.0,146.0,7,1486,50015.0,419.0,398.0
0.113,6,10,1506,5,395,26.0,127.0,127.0,5,1111,22.0,843.0,843.0
0.106,6,10,1506,5,395,23.0,127.0,127.0,5,1111,22.0,843.0,843.0
308.678,17,20,1124,10,716,34277.0,48.0,43.0,10,408,34283.0,20.0,12.0
0.018,6,10,1990,5,911,4.0,643.0,643.0,5,1079,4.0,811.0,811.0
0.113,6,10,1506,5,395,23.0,127.0,127.0,5,1111,25.0,843.0,843.0
40.062,17,10,676,5,460,10013.0,104.0,64.0,5,216,10014.0,20.0,15.0
0.071,17,2,234,1,61,0.0,33.0,33.0,1,173,0.0,145.0,145.0
40.082,17,10,676,5,460,10018.0,104.0,64.0,5,216,10019.0,20.0,15.0
0.004,6,10,1989,5,927,1.0,659.0,659.0,5,1062,1.0,794.0,794.0
0.005,6,10,2007,5,928,1.0,660.0,660.0,5,1079,1.0,811.0,811.0
61.232,6,36,9526,18,4008,519.0,1543.0,814.0,18,5518,3591.0,2667.0,435.0
0.11,6,10,1506,5,395,26.0,127.0,127.0,5,1111,26.0,843.0,843.0
0.008,17,4,495,2,132,0.0,38.0,38.0,2,363,3.0,176.0,153.0
0.116,6,10,1506,5,395,25.0,127.0,127.0,5,1111,25.0,843.0,843.0
0.126,17,2,80,1,32,0.0,4.0,4.0,1,48,0.0,20.0,20.0
0.046,17,2,144,1,64,0.0,36.0,36.0,1,80,0.0,52.0,52.0
40.082,17,10,676,5,460,10018.0,104.0,64.0,5,216,10019.0,20.0,15.0
0.006,6,10,1547,5,764,1.0,496.0,496.0,5,783,1.0,515.0,515.0
0.009,6,10,1972,5,910,2.0,642.0,642.0,5,1062,2.0,794.0,794.0
0.117,6,10,1506,5,395,27.0,127.0,127.0,5,1111,25.0,843.0,843.0
0.006,6,10,2006,5,927,1.0,659.0,659.0,5,1079,1.0,811.0,811.0
0.015,6,10,1989,5,910,3.0,642.0,642.0,5,1079,3.0,811.0,811.0
10.936,17,28,4420,14,1993,832.0,268.0,114.0,14,2427,832.0,586.0,145.0
0.039,17,2,170,1,65,0.0,37.0,37.0,1,105,0.0,77.0,77.0
0.086,6,10,1506,5,395,20.0,127.0,127.0,5,1111,16.0,843.0,843.0
0.084,6,10,1506,5,395,17.0,127.0,127.0,5,1111,19.0,843.0,843.0
0.069,17,8,3613,4,1874,23.0,1350.0,440.0,4,1739,11.0,1350.0,406.0
0.004,6,10,2007,5,928,1.0,660.0,660.0,5,1079,1.0,811.0,811.0
0.004,6,10,1989,5,927,1.0,659.0,659.0,5,1062,1.0,794.0,794.0
0.005,6,14,3742,8,504,0.0,80.0,80.0,6,3238,1.0,1470.0,1459.0
0.063,6,10,1506,5,395,13.0,127.0,127.0,5,1111,14.0,843.0,843.0
0.006,6,10,2006,5,927,1.0,659.0,659.0,5,1079,1.0,811.0,811.0
0.01,6,10,1989,5,910,2.0,642.0,642.0,5,1079,2.0,811.0,811.0
0.085,6,10,1506,5,395,18.0,127.0,127.0,5,1111,18.0,843.0,843.0
1.002,6,13,3930,7,2139,124.0,1328.0,923.0,6,1791,151.0,1539.0,1539.0
40.1,17,10,676,5,460,10023.0,104.0,64.0,5,216,10024.0,20.0,15.0
0.005,6,10,2000,5,927,1.0,659.0,659.0,5,1073,1.0,805.0,805.0
0.004,6,10,1774,5,923,1.0,655.0,655.0,5,851,1.0,583.0,583.0
0.089,6,10,1506,5,395,21.0,127.0,127.0,5,1111,21.0,843.0,843.0
0.01,6,10,1990,5,911,2.0,643.0,643.0,5,1079,2.0,811.0,811.0
0.015,6,10,1989,5,910,3.0,642.0,642.0,5,1079,3.0,811.0,811.0
0.006,6,10,2007,5,928,1.0,660.0,660.0,5,1079,1.0,811.0,811.0
0.003,17,2,148,1,60,0.0,32.0,32.0,1,88,0.0,60.0,60.0
0.001,17,2,180,1,66,0.0,38.0,38.0,1,114,0.0,86.0,86.0
0.093,6,10,1506,5,395,20.0,127.0,127.0,5,1111,21.0,843.0,843.0
0.004,6,10,2006,5,927,1.0,659.0,659.0,5,1079,1.0,811.0,811.0
0.006,6,10,1547,5,764,1.0,496.0,496.0,5,783,1.0,515.0,515.0
1772.607,17,120,11460,60,5460,30043.0,63.0,63.0,60,6000,30043.0,72.0,72.0
0.008,6,10,1983,5,910,2.0,642.0,642.0,5,1073,2.0,805.0,805.0
0.004,6,10,1779,5,928,1.0,660.0,660.0,5,851,1.0,583.0,583.0
264.424,17,18,1008,9,640,33036.0,48.0,43.0,9,368,33036.0,20.0,12.0
0.005,6,10,2007,5,928,1.0,660.0,660.0,5,1079,1.0,811.0,811.0
0.302,17,4,596,2,122,177.0,33.0,33.0,2,474,229.0,323.0,209.0
0.005,17,2,166,1,75,0.0,47.0,47.0,1,91,0.0,63.0,63.0
0.006,6,10,1547,5,764,1.0,496.0,496.0,5,783,1.0,515.0,515.0
0.018,6,10,1677,5,827,4.0,559.0,559.0,5,850,4.0,582.0,582.0
0.003,17,2,136,1,60,0.0,32.0,32.0,1,76,0.0,48.0,48.0
0.01,6,10,1990,5,911,2.0,643.0,643.0,5,1079,2.0,811.0,811.0
0.005,6,10,1989,5,927,1.0,659.0,659.0,5,1062,1.0,794.0,794.0
0.004,17,2,132,1,58,0.0,30.0,30.0,1,74,0.0,46.0,46.0
0.004,17,4,284,2,120,1.0,32.0,32.0,2,164,1.0,60.0,54.0
0.009,6,10,1990,5,911,2.0,643.0,643.0,5,1079,2.0,811.0,811.0
0.007,6,10,1689,5,839,1.0,571.0,571.0,5,850,1.0,582.0,582.0
0.164,17,2,152,1,76,0.0,48.0,48.0,1,76,0.0,48.0,48.0
0.005,6,10,1547,5,764,1.0,496.0,496.0,5,783,1.0,515.0,515.0
0.012,6,10,1983,5,910,3.0,642.0,642.0,5,1073,2.0,805.0,805.0
0.004,6,10,2007,5,928,1.0,660.0,660.0,5,1079,1.0,811.0,811.0
0.012,6,10,1631,5,848,2.0,580.0,580.0,5,783,3.0,515.0,515.0
0.006,6,10,1854,5,889,1.0,621.0,621.0,5,965,1.0,697.0,697.0
0.006,17,2,170,1,65,0.0,37.0,37.0,1,105,0.0,77.0,77.0
9.036,17,6,376,5,280,2259.0,28.0,28.0,1,96,0.0,68.0,68.0
0.008,6,12,1926,6,1189,1.0,659.0,434.0,6,737,1.0,417.0,417.0
0.001,17,2,180,1,66,0.0,38.0,38.0,1,114,0.0,86.0,86.0
241.272,6,300,342549,120,17753,2027.0,2736.0,959.0,180,324796,1347.0,2804.0,1855.0
0.008,6,10,1972,5,910,2.0,642.0,642.0,5,1062,1.0,794.0,794.0
0.006,6,10,2007,5,928,1.0,660.0,660.0,5,1079,1.0,811.0,811.0
0.005,6,10,2006,5,927,1.0,659.0,659.0,5,1079,1.0,811.0,811.0
40.099,17,10,676,5,460,10016.0,104.0,64.0,5,216,10024.0,20.0,15.0
0.005,6,10,2000,5,927,1.0,659.0,659.0,5,1073,1.0,805.0,805.0
0.005,6,10,2007,5,928,1.0,660.0,660.0,5,1079,1.0,811.0,811.0
0.001,17,2,180,1,66,0.0,38.0,38.0,1,114,0.0,86.0,86.0
326.223,17,20,1124,10,716,36232.0,48.0,43.0,10,408,36232.0,20.0,12.0
0.023,6,10,1989,5,910,5.0,642.0,642.0,5,1079,5.0,811.0,811.0
0.006,6,10,1774,5,923,1.0,655.0,655.0,5,851,1.0,583.0,583.0
0.012,6,10,1972,5,910,3.0,642.0,642.0,5,1062,2.0,794.0,794.0
0.005,6,10,1989,5,927,1.0,659.0,659.0,5,1062,1.0,794.0,794.0
0.085,6,10,1506,5,395,18.0,127.0,127.0,5,1111,20.0,843.0,843.0
0.004,6,10,1989,5,927,1.0,659.0,659.0,5,1062,1.0,794.0,794.0
0.018,6,10,1983,5,910,4.0,642.0,642.0,5,1073,4.0,805.0,805.0
0.006,6,10,1547,5,764,1.0,496.0,496.0,5,783,1.0,515.0,515.0
0.005,6,10,2007,5,928,1.0,660.0,660.0,5,1079,1.0,811.0,811.0
0.016,17,2,198,1,91,0.0,63.0,63.0,1,107,0.0,79.0,79.0
0.013,6,10,1989,5,910,3.0,642.0,642.0,5,1079,3.0,811.0,811.0
0.04,17,2,170,1,65,0.0,37.0,37.0,1,105,0.0,77.0,77.0
176.045,17,84,12288,42,2826,4293.0,44.0,39.0,42,9462,4293.0,239.0,197.0
0.009,6,13,3735,7,497,1.0,125.0,125.0,6,3238,1.0,1470.0,1459.0
0.004,6,10,1989,5,927,1.0,659.0,659.0,5,1062,1.0,794.0,794.0
0.016,6,10,1989,5,910,4.0,642.0,642.0,5,1079,4.0,811.0,811.0
0.013,6,10,1972,5,910,3.0,642.0,642.0,5,1062,3.0,794.0,794.0
0.005,6,10,2000,5,927,1.0,659.0,659.0,5,1073,1.0,805.0,805.0
0.001,17,2,180,1,65,0.0,37.0,37.0,1,115,0.0,87.0,87.0
0.005,6,13,3747,7,509,0.0,137.0,137.0,6,3238,1.0,1470.0,1459.0
0.277,17,44,27790,26,24766,11.0,1350.0,924.0,18,3024,12.0,1350.0,140.0
0.018,6,10,1989,5,910,4.0,642.0,642.0,5,1079,4.0,811.0,811.0
0.081,6,10,1506,5,395,18.0,127.0,127.0,5,1111,18.0,843.0,843.0
368.95,6,22,2313,16,867,24596.0,195.0,195.0,6,1446,4643.0,419.0,398.0
241.538,6,385,348160,180,20884,1349.0,2736.0,959.0,205,327276,1183.0,2916.0,1623.0
0.004,6,10,1989,5,927,1.0,659.0,659.0,5,1062,1.0,794.0,794.0
353.316,6,20,2210,6,1308,12005.0,494.0,494.0,14,902,27177.0,83.0,83.0
15.071,17,15,9238,8,6902,2149.0,1350.0,834.0,7,2336,2506.0,1350.0,305.0
0.005,6,14,3799,7,509,0.0,137.0,137.0,7,3290,0.0,1448.0,972.0
15.073,17,15,9238,8,6902,2149.0,1350.0,834.0,7,2336,2507.0,1350.0,305.0
0.001,17,2,180,1,66,0.0,38.0,38.0,1,114,0.0,86.0,86.0
0.089,6,10,1506,5,395,19.0,127.0,127.0,5,1111,18.0,843.0,843.0
0.01,6,12,1926,6,1189,2.0,659.0,434.0,6,737,2.0,417.0,417.0
0.005,6,10,2007,5,928,1.0,660.0,660.0,5,1079,1.0,811.0,811.0
0.005,6,10,2007,5,928,1.0,660.0,660.0,5,1079,1.0,811.0,811.0
0.005,6,10,2000,5,927,1.0,659.0,659.0,5,1073,1.0,805.0,805.0
0.022,6,10,1983,5,910,5.0,642.0,642.0,5,1073,5.0,805.0,805.0
0.009,6,10,1990,5,911,2.0,643.0,643.0,5,1079,2.0,811.0,811.0
0.099,6,10,1506,5,395,23.0,127.0,127.0,5,1111,24.0,843.0,843.0
0.092,6,10,1506,5,395,20.0,127.0,127.0,5,1111,21.0,843.0,843.0
293.171,6,316,343649,122,17892,2422.0,2736.0,888.0,194,325757,1519.0,2804.0,1753.0
40.057,17,10,676,5,460,10013.0,104.0,64.0,5,216,10012.0,20.0,15.0
0.059,6,10,1506,5,395,14.0,127.0,127.0,5,1111,14.0,843.0,843.0
0.013,6,10,1989,5,910,3.0,642.0,642.0,5,1079,3.0,811.0,811.0
0.009,6,10,1989,5,910,2.0,642.0,642.0,5,1079,2.0,811.0,811.0
0.005,6,10,1779,5,928,1.0,660.0,660.0,5,851,1.0,583.0,583.0
0.085,6,10,1506,5,395,17.0,127.0,127.0,5,1111,20.0,843.0,843.0
0.011,6,10,1989,5,910,2.0,642.0,642.0,5,1079,2.0,811.0,811.0
0.001,17,2,180,1,66,0.0,38.0,38.0,1,114,0.0,86.0,86.0
0.083,6,10,1506,5,395,20.0,127.0,127.0,5,1111,19.0,843.0,843.0
0.001,17,2,166,1,75,0.0,47.0,47.0,1,91,0.0,63.0,63.0
0.015,17,2,198,1,91,0.0,63.0,63.0,1,107,0.0,79.0,79.0
0.058,17,2,179,1,71,0.0,43.0,43.0,1,108,0.0,80.0,80.0
0.113,6,10,1506,5,395,24.0,127.0,127.0,5,1111,26.0,843.0,843.0
0.004,17,4,596,2,122,1.0,33.0,33.0,2,474,0.0,323.0,209.0
0.004,17,2,136,1,60,0.0,32.0,32.0,1,76,0.0,48.0,48.0
0.014,6,10,1762,5,911,3.0,643.0,643.0,5,851,3.0,583.0,583.0
0.013,6,10,1972,5,910,3.0,642.0,642.0,5,1062,3.0,794.0,794.0
0.094,6,10,1506,5,395,21.0,127.0,127.0,5,1111,20.0,843.0,843.0
0.005,6,10,2007,5,928,1.0,660.0,660.0,5,1079,1.0,811.0,811.0
0.103,6,10,1506,5,395,23.0,127.0,127.0,5,1111,22.0,843.0,843.0
0.016,6,10,1989,5,910,4.0,642.0,642.0,5,1079,3.0,811.0,811.0
0.01,6,10,1989,5,910,2.0,642.0,642.0,5,1079,2.0,811.0,811.0
0.004,17,2,136,1,60,0.0,32.0,32.0,1,76,0.0,48.0,48.0
59.307,6,10,1198,6,586,11861.0,266.0,266.0,4,612,19767.0,396.0,396.0
0.005,6,10,1989,5,927,1.0,659.0,659.0,5,1062,1.0,794.0,794.0
0.008,6,10,1989,5,910,2.0,642.0,642.0,5,1079,2.0,811.0,811.0
0.005,6,10,1989,5,927,1.0,659.0,659.0,5,1062,1.0,794.0,794.0
0.004,6,10,2006,5,927,1.0,659.0,659.0,5,1079,1.0,811.0,811.0
0.033,17,2,214,1,75,0.0,47.0,47.0,1,139,0.0,111.0,111.0
0.012,6,10,1989,5,910,3.0,642.0,642.0,5,1079,2.0,811.0,811.0
0.015,6,10,1990,5,911,3.0,643.0,643.0,5,1079,3.0,811.0,811.0
0.012,6,10,1983,5,910,3.0,642.0,642.0,5,1073,2.0,805.0,805.0
10.243,6,19,6137,11,1189,1024.0,517.0,201.0,8,4948,1462.0,1402.0,904.0
0.039,17,2,184,1,61,0.0,33.0,33.0,1,123,0.0,95.0,95.0
0.041,17,2,136,1,60,0.0,32.0,32.0,1,76,0.0,48.0,48.0
0.004,17,2,148,1,60,0.0,32.0,32.0,1,88,0.0,60.0,60.0
0.005,6,10,1689,5,839,1.0,571.0,571.0,5,850,1.0,582.0,582.0
240.096,6,34,9310,17,6824,15006.0,1832.0,659.0,17,2486,15005.0,580.0,177.0
0.132,6,10,1506,5,395,25.0,127.0,127.0,5,1111,32.0,843.0,843.0
0.01,6,10,1762,5,911,2.0,643.0,643.0,5,851,2.0,583.0,583.0
0.005,6,10,1989,5,927,1.0,659.0,659.0,5,1062,1.0,794.0,794.0
0.039,17,2,170,1,65,0.0,37.0,37.0,1,105,0.0,77.0,77.0
240.107,6,16,4481,9,963,30013.0,238.0,166.0,7,3518,40017.0,1402.0,786.0
0.005,6,10,2000,5,927,1.0,659.0,659.0,5,1073,1.0,805.0,805.0
0.006,6,10,1643,5,860,1.0,592.0,592.0,5,783,1.0,515.0,515.0
0.005,6,10,2000,5,927,1.0,659.0,659.0,5,1073,1.0,805.0,805.0
0.005,6,10,2006,5,927,1.0,659.0,659.0,5,1079,1.0,811.0,811.0
0.019,6,10,1762,5,911,4.0,643.0,643.0,5,851,4.0,583.0,583.0
0.081,6,10,1506,5,395,17.0,127.0,127.0,5,1111,17.0,843.0,843.0
0.004,17,2,136,1,60,0.0,32.0,32.0,1,76,0.0,48.0,48.0
0.006,6,10,1547,5,764,1.0,496.0,496.0,5,783,1.0,515.0,515.0
0.001,17,2,179,1,62,0.0,34.0,34.0,1,117,0.0,89.0,89.0
0.128,17,2,170,1,65,0.0,37.0,37.0,1,105,0.0,77.0,77.0
0.005,6,10,1779,5,928,1.0,660.0,660.0,5,851,1.0,583.0,583.0
0.041,17,4,284,2,120,0.0,32.0,32.0,2,164,38.0,60.0,54.0
0.111,6,10,1506,5,395,27.0,127.0,127.0,5,1111,26.0,843.0,843.0
23.793,6,36,8361,18,1889,508.0,781.0,379.0,18,6472,1391.0,2720.0,478.0
0.006,17,2,214,1,75,0.0,47.0,47.0,1,139,0.0,111.0,111.0
0.005,17,2,179,1,71,0.0,43.0,43.0,1,108,0.0,80.0,80.0
0.007,6,13,3690,7,452,1.0,80.0,80.0,6,3238,1.0,1470.0,1459.0
0.079,6,10,1506,5,395,19.0,127.0,127.0,5,1111,16.0,843.0,843.0
0.122,6,10,1506,5,395,29.0,127.0,127.0,5,1111,28.0,843.0,843.0
291.813,6,394,348693,190,21448,1543.0,2736.0,889.0,204,327245,1437.0,2914.0,1666.0
308.949,17,20,1124,10,716,34313.0,48.0,43.0,10,408,34313.0,20.0,12.0
0.005,6,10,2006,5,927,1.0,659.0,659.0,5,1079,1.0,811.0,811.0
0.012,6,10,1762,5,911,2.0,643.0,643.0,5,851,2.0,583.0,583.0
0.005,6,10,2007,5,928,1.0,660.0,660.0,5,1079,1.0,811.0,811.0
0.004,6,10,2006,5,927,1.0,659.0,659.0,5,1079,1.0,811.0,811.0
0.037,17,2,184,1,61,0.0,33.0,33.0,1,123,0.0,95.0,95.0
0.006,6,10,1689,5,839,1.0,571.0,571.0,5,850,1.0,582.0,582.0
0.131,6,10,1506,5,395,29.0,127.0,127.0,5,1111,30.0,843.0,843.0
0.014,6,10,1972,5,910,3.0,642.0,642.0,5,1062,3.0,794.0,794.0
0.072,6,10,1506,5,395,15.0,127.0,127.0,5,1111,16.0,843.0,843.0
0.091,6,10,1506,5,395,21.0,127.0,127.0,5,1111,20.0,843.0,843.0
0.001,17,2,180,1,66,0.0,38.0,38.0,1,114,0.0,86.0,86.0
0.005,6,10,2006,5,927,1.0,659.0,659.0,5,1079,1.0,811.0,811.0
0.071,17,2,144,1,64,0.0,36.0,36.0,1,80,0.0,52.0,52.0
0.005,6,10,2007,5,928,1.0,660.0,660.0,5,1079,1.0,811.0,811.0
0.01,6,10,1989,5,910,2.0,642.0,642.0,5,1079,2.0,811.0,811.0
0.032,6,14,3787,7,497,5.0,125.0,125.0,7,3290,5.0,1448.0,972.0
0.003,17,4,284,2,120,0.0,32.0,32.0,2,164,0.0,60.0,54.0
0.005,6,13,3747,7,509,0.0,137.0,137.0,6,3238,1.0,1470.0,1459.0
0.103,6,10,1506,5,395,23.0,127.0,127.0,5,1111,22.0,843.0,843.0
15.08,17,16,8574,8,6442,2150.0,1350.0,777.0,8,2132,2150.0,1350.0,238.0
0.004,17,2,152,1,76,0.0,48.0,48.0,1,76,0.0,48.0,48.0
0.012,6,10,1990,5,911,3.0,643.0,643.0,5,1079,2.0,811.0,811.0
0.041,17,2,152,1,76,0.0,48.0,48.0,1,76,0.0,48.0,48.0
0.005,6,10,1689,5,839,1.0,571.0,571.0,5,850,1.0,582.0,582.0
0.059,6,10,1506,5,395,14.0,127.0,127.0,5,1111,12.0,843.0,843.0
0.006,6,10,1547,5,764,1.0,496.0,496.0,5,783,1.0,515.0,515.0
0.005,17,2,166,1,75,0.0,47.0,47.0,1,91,0.0,63.0,63.0
0.004,6,10,2000,5,927,1.0,659.0,659.0,5,1073,1.0,805.0,805.0
0.009,6,10,1989,5,910,2.0,642.0,642.0,5,1079,2.0,811.0,811.0
0.012,6,10,2006,5,927,3.0,659.0,659.0,5,1079,2.0,811.0,811.0
0.006,6,10,1547,5,764,1.0,496.0,496.0,5,783,1.0,515.0,515.0
40.062,17,10,676,5,460,10012.0,104.0,64.0,5,216,10014.0,20.0,15.0
0.005,6,13,3747,7,509,0.0,137.0,137.0,6,3238,1.0,1470.0,1459.0
0.005,6,10,1989,5,927,1.0,659.0,659.0,5,1062,1.0,794.0,794.0
0.015,6,10,1972,5,910,3.0,642.0,642.0,5,1062,3.0,794.0,794.0
0.006,6,10,1547,5,764,1.0,496.0,496.0,5,783,1.0,515.0,515.0
40.082,17,10,676,5,460,10019.0,104.0,64.0,5,216,10019.0,20.0,15.0
0.01,6,10,1631,5,848,2.0,580.0,580.0,5,783,2.0,515.0,515.0
300.021,6,12,1782,7,1348,50003.0,494.0,494.0,5,434,75004.0,83.0,83.0
0.197,6,41,11373,22,3118,9.0,1022.0,197.0,19,8255,10.0,1402.0,659.0
0.011,6,10,1983,5,910,2.0,642.0,642.0,5,1073,2.0,805.0,805.0
240.114,6,31,8963,15,6680,17151.0,1804.0,656.0,16,2283,16007.0,580.0,180.0
0.005,6,10,1689,5,839,1.0,571.0,571.0,5,850,1.0,582.0,582.0
0.079,6,10,1506,5,395,18.0,127.0,127.0,5,1111,18.0,843.0,843.0
15.083,17,15,8059,8,5904,2150.0,1350.0,710.0,7,2155,2509.0,1350.0,279.0
15.07,17,15,9239,8,6902,2148.0,1350.0,834.0,7,2337,2506.0,1350.0,305.0
0.082,6,10,1506,5,395,20.0,127.0,127.0,5,1111,15.0,843.0,843.0
0.005,17,2,180,1,66,0.0,38.0,38.0,1,114,0.0,86.0,86.0
0.104,6,10,1506,5,395,23.0,127.0,127.0,5,1111,23.0,843.0,843.0
0.013,6,14,3787,7,497,2.0,125.0,125.0,7,3290,2.0,1448.0,972.0
0.004,6,10,2006,5,927,1.0,659.0,659.0,5,1079,1.0,811.0,811.0
0.114,6,10,1506,5,395,28.0,127.0,127.0,5,1111,26.0,843.0,843.0
0.018,6,10,1990,5,911,4.0,643.0,643.0,5,1079,4.0,811.0,811.0
0.005,17,2,170,1,65,0.0,37.0,37.0,1,105,0.0,77.0,77.0
0.005,17,2,230,1,68,0.0,40.0,40.0,1,162,0.0,134.0,134.0
296.688,6,313,344635,127,18792,2354.0,2736.0,870.0,186,325843,1603.0,2804.0,1848.0
0.069,6,10,1506,5,395,16.0,127.0,127.0,5,1111,15.0,843.0,843.0
0.006,6,10,1643,5,860,1.0,592.0,592.0,5,783,1.0,515.0,515.0
0.062,6,10,1506,5,395,13.0,127.0,127.0,5,1111,14.0,843.0,843.0
0.004,6,10,1774,5,923,1.0,655.0,655.0,5,851,1.0,583.0,583.0
0.006,6,10,1854,5,889,1.0,621.0,621.0,5,965,1.0,697.0,697.0
0.016,6,10,2006,5,927,4.0,659.0,659.0,5,1079,3.0,811.0,811.0
0.006,6,10,2007,5,928,1.0,660.0,660.0,5,1079,1.0,811.0,811.0
0.005,17,2,213,1,69,0.0,41.0,41.0,1,144,0.0,116.0,116.0
11.179,17,28,4423,14,1995,847.0,270.0,114.0,14,2428,847.0,587.0,145.0
0.005,6,10,1989,5,927,1.0,659.0,659.0,5,1062,1.0,794.0,794.0
0.012,6,10,1631,5,848,2.0,580.0,580.0,5,783,2.0,515.0,515.0
0.013,6,10,1972,5,910,3.0,642.0,642.0,5,1062,3.0,794.0,794.0
0.146,6,10,1506,5,395,32.0,127.0,127.0,5,1111,30.0,843.0,843.0
0.019,6,20,9974,11,704,1.0,124.0,124.0,9,9270,2.0,2896.0,1758.0
0.004,6,10,1702,5,863,1.0,595.0,595.0,5,839,0.0,571.0,571.0
0.128,6,10,1506,5,395,24.0,127.0,127.0,5,1111,27.0,843.0,843.0
0.008,6,10,1989,5,910,2.0,642.0,642.0,5,1079,1.0,811.0,811.0
0.005,6,10,2006,5,927,1.0,659.0,659.0,5,1079,1.0,811.0,811.0
0.005,6,10,2006,5,927,1.0,659.0,659.0,5,1079,1.0,811.0,811.0
0.006,6,10,1547,5,764,1.0,496.0,496.0,5,783,1.0,515.0,515.0
0.005,6,14,3742,8,504,0.0,80.0,80.0,6,3238,0.0,1470.0,1459.0
0.124,6,10,1506,5,395,22.0,127.0,127.0,5,1111,29.0,843.0,843.0
0.005,6,10,1989,5,927,1.0,659.0,659.0,5,1062,1.0,794.0,794.0
0.001,17,2,180,1,66,0.0,38.0,38.0,1,114,0.0,86.0,86.0
0.151,6,10,1506,5,395,32.0,127.0,127.0,5,1111,36.0,843.0,843.0
0.001,17,2,180,1,66,0.0,38.0,38.0,1,114,0.0,86.0,86.0
0.113,6,10,1506,5,395,25.0,127.0,127.0,5,1111,23.0,843.0,843.0
0.007,6,10,1689,5,839,1.0,571.0,571.0,5,850,1.0,582.0,582.0
0.005,17,2,179,1,71,0.0,43.0,43.0,1,108,0.0,80.0,80.0
0.005,6,10,2007,5,928,1.0,660.0,660.0,5,1079,1.0,811.0,811.0
0.17,17,2,152,1,76,0.0,48.0,48.0,1,76,0.0,48.0,48.0
0.006,17,2,249,1,64,0.0,36.0,36.0,1,185,0.0,157.0,157.0
0.065,6,10,1506,5,395,15.0,127.0,127.0,5,1111,14.0,843.0,843.0
240.283,6,44,8823,22,5738,11441.0,1368.0,458.0,22,3085,11441.0,580.0,241.0
0.01,6,13,3747,7,509,1.0,137.0,137.0,6,3238,1.0,1470.0,1459.0
0.006,6,10,1547,5,764,1.0,496.0,496.0,5,783,1.0,515.0,515.0
0.005,6,10,1989,5,927,1.0,659.0,659.0,5,1062,1.0,794.0,794.0
0.006,17,2,154,1,69,0.0,41.0,41.0,1,85,0.0,57.0,57.0
0.012,6,10,1989,5,910,2.0,642.0,642.0,5,1079,2.0,811.0,811.0
0.037,17,2,182,1,65,0.0,37.0,37.0,1,117,0.0,89.0,89.0
0.212,6,16,2669,8,1395,30.0,533.0,323.0,8,1274,19.0,529.0,212.0
0.008,6,10,1989,5,910,1.0,642.0,642.0,5,1079,2.0,811.0,811.0
0.075,6,10,1506,5,395,16.0,127.0,127.0,5,1111,17.0,843.0,843.0
178.574,17,88,12898,44,2961,4152.0,44.0,39.0,44,9937,4152.0,239.0,197.0
0.012,6,10,1983,5,910,3.0,642.0,642.0,5,1073,2.0,805.0,805.0
0.006,17,2,136,1,60,0.0,32.0,32.0,1,76,0.0,48.0,48.0
0.005,6,10,1989,5,927,1.0,659.0,659.0,5,1062,1.0,794.0,794.0
0.005,6,10,2006,5,927,1.0,659.0,659.0,5,1079,1.0,811.0,811.0
0.005,6,10,2007,5,928,1.0,660.0,660.0,5,1079,1.0,811.0,811.0
0.073,17,2,136,1,60,0.0,32.0,32.0,1,76,0.0,48.0,48.0
0.001,17,2,180,1,66,0.0,38.0,38.0,1,114,0.0,86.0,86.0
0.005,6,10,2006,5,927,1.0,659.0,659.0,5,1079,1.0,811.0,811.0
0.098,6,10,1506,5,395,20.0,127.0,127.0,5,1111,22.0,843.0,843.0
0.129,6,10,1506,5,395,21.0,127.0,127.0,5,1111,27.0,843.0,843.0
0.001,17,2,180,1,66,0.0,38.0,38.0,1,114,0.0,86.0,86.0
40.053,17,10,676,5,460,10012.0,104.0,64.0,5,216,10012.0,20.0,15.0
0.119,6,10,1506,5,395,25.0,127.0,127.0,5,1111,27.0,843.0,843.0
0.017,6,10,1983,5,910,4.0,642.0,642.0,5,1073,4.0,805.0,805.0
15.071,17,14,9190,8,6902,2148.0,1350.0,834.0,6,2288,3008.0,1350.0,353.0
0.067,6,10,1506,5,395,14.0,127.0,127.0,5,1111,15.0,843.0,843.0
292.869,6,390,348561,184,21124,1600.0,2736.0,888.0,206,327437,1428.0,3053.0,1649.0
40.054,17,10,676,5,460,10011.0,104.0,64.0,5,216,10012.0,20.0,15.0
0.004,6,10,1989,5,927,1.0,659.0,659.0,5,1062,1.0,794.0,794.0
0.042,17,4,596,2,122,1.0,33.0,33.0,2,474,2.0,323.0,209.0
11.257,17,28,4423,14,1995,852.0,270.0,114.0,14,2428,851.0,587.0,145.0
0.005,6,10,1689,5,839,1.0,571.0,571.0,5,850,1.0,582.0,582.0
0.071,6,10,1506,5,395,14.0,127.0,127.0,5,1111,16.0,843.0,843.0
0.024,6,10,1972,5,910,6.0,642.0,642.0,5,1062,6.0,794.0,794.0
0.008,6,10,1989,5,910,2.0,642.0,642.0,5,1079,2.0,811.0,811.0
40.069,17,10,676,5,460,10016.0,104.0,64.0,5,216,10016.0,20.0,15.0
0.013,6,10,1990,5,911,3.0,643.0,643.0,5,1079,3.0,811.0,811.0
0.004,6,10,2006,5,927,1.0,659.0,659.0,5,1079,1.0,811.0,811.0
0.04,17,2,148,1,60,0.0,32.0,32.0,1,88,0.0,60.0,60.0
0.035,6,14,3787,7,497,5.0,125.0,125.0,7,3290,5.0,1448.0,972.0
0.005,6,10,2007,5,928,1.0,660.0,660.0,5,1079,1.0,811.0,811.0
0.075,6,10,1506,5,395,17.0,127.0,127.0,5,1111,18.0,843.0,843.0
0.019,6,10,1989,5,910,4.0,642.0,642.0,5,1079,4.0,811.0,811.0
40.06,17,10,676,5,460,10011.0,104.0,64.0,5,216,10014.0,20.0,15.0
0.008,6,10,1972,5,910,1.0,642.0,642.0,5,1062,2.0,794.0,794.0
0.004,17,2,154,1,69,0.0,41.0,41.0,1,85,0.0,57.0,57.0
0.005,6,10,1774,5,923,1.0,655.0,655.0,5,851,1.0,583.0,583.0
0.005,6,10,2007,5,928,1.0,660.0,660.0,5,1079,1.0,811.0,811.0
0.007,6,10,1547,5,764,1.0,496.0,496.0,5,783,1.0,515.0,515.0
0.005,6,13,3747,7,509,0.0,137.0,137.0,6,3238,1.0,1470.0,1459.0
0.113,6,10,1506,5,395,24.0,127.0,127.0,5,1111,24.0,843.0,843.0
0.006,17,2,166,1,75,0.0,47.0,47.0,1,91,0.0,63.0,63.0
0.017,6,10,1983,5,910,4.0,642.0,642.0,5,1073,4.0,805.0,805.0
0.083,6,10,1506,5,395,18.0,127.0,127.0,5,1111,18.0,843.0,843.0
0.004,17,2,148,1,60,0.0,32.0,32.0,1,88,0.0,60.0,60.0
240.012,6,9,787,5,488,60003.0,232.0,232.0,4,299,80003.0,83.0,83.0
0.005,6,10,2006,5,927,1.0,659.0,659.0,5,1079,1.0,811.0,811.0
0.008,6,10,1990,5,911,2.0,643.0,643.0,5,1079,1.0,811.0,811.0
40.061,17,10,676,5,460,10014.0,104.0,64.0,5,216,10014.0,20.0,15.0
0.006,6,10,2006,5,927,1.0,659.0,659.0,5,1079,1.0,811.0,811.0
0.11,6,10,1506,5,395,23.0,127.0,127.0,5,1111,22.0,843.0,843.0
11.208,17,28,4422,14,1993,850.0,268.0,114.0,14,2429,849.0,588.0,145.0
0.088,6,10,1506,5,395,17.0,127.0,127.0,5,1111,20.0,843.0,843.0
240.012,6,9,787,5,488,60003.0,232.0,232.0,4,299,80003.0,83.0,83.0
0.005,17,2,166,1,75,0.0,47.0,47.0,1,91,0.0,63.0,63.0
0.116,6,10,1506,5,395,27.0,127.0,127.0,5,1111,24.0,843.0,843.0
40.067,17,10,676,5,460,10013.0,104.0,64.0,5,216,10015.0,20.0,15.0
15.097,17,15,9239,8,6902,2151.0,1350.0,834.0,7,2337,2509.0,1350.0,305.0
0.01,6,10,1990,5,911,2.0,643.0,643.0,5,1079,2.0,811.0,811.0
0.092,6,10,1506,5,395,21.0,127.0,127.0,5,1111,18.0,843.0,843.0
0.001,17,2,179,1,62,0.0,34.0,34.0,1,117,0.0,89.0,89.0
10.921,17,28,4423,14,1994,830.0,269.0,114.0,14,2429,830.0,588.0,145.0
0.038,17,2,144,1,64,0.0,36.0,36.0,1,80,0.0,52.0,52.0
0.005,6,10,2000,5,927,1.0,659.0,659.0,5,1073,1.0,805.0,805.0
0.112,6,10,1506,5,395,27.0,127.0,127.0,5,1111,24.0,843.0,843.0
0.365,6,77,37847,38,2918,9.0,517.0,104.0,39,34929,9.0,2804.0,1061.0
40.058,17,10,676,5,460,10013.0,104.0,64.0,5,216,10013.0,20.0,15.0
0.006,6,10,1989,5,927,1.0,659.0,659.0,5,1062,1.0,794.0,794.0
0.174,6,32,8653,17,2013,10.0,490.0,219.0,15,6640,11.0,1368.0,731.0
0.014,6,10,1972,5,910,3.0,642.0,642.0,5,1062,3.0,794.0,794.0
0.006,6,10,1547,5,764,1.0,496.0,496.0,5,783,1.0,515.0,515.0
0.011,6,10,1989,5,910,2.0,642.0,642.0,5,1079,2.0,811.0,811.0
0.038,17,2,148,1,60,0.0,32.0,32.0,1,88,0.0,60.0,60.0
0.108,6,10,1506,5,395,25.0,127.0,127.0,5,1111,26.0,843.0,843.0
353.986,6,21,1795,16,1030,23599.0,190.0,190.0,5,765,60001.0,464.0,248.0
0.117,6,10,1506,5,395,27.0,127.0,127.0,5,1111,26.0,843.0,843.0
0.014,6,10,1677,5,827,3.0,559.0,559.0,5,850,3.0,582.0,582.0
0.005,6,10,2000,5,927,1.0,659.0,659.0,5,1073,1.0,805.0,805.0
0.009,6,10,1972,5,910,2.0,642.0,642.0,5,1062,2.0,794.0,794.0
0.004,6,10,1779,5,928,1.0,660.0,660.0,5,851,1.0,583.0,583.0
0.004,17,2,136,1,60,0.0,32.0,32.0,1,76,0.0,48.0,48.0
0.018,6,10,1972,5,910,4.0,642.0,642.0,5,1062,4.0,794.0,794.0
0.006,6,10,1547,5,764,1.0,496.0,496.0,5,783,1.0,515.0,515.0
1792.696,6,484,98693,243,87463,7407.0,421.0,368.0,241,11230,7469.0,53.0,53.0
0.006,6,10,2006,5,927,1.0,659.0,659.0,5,1079,1.0,811.0,811.0
0.011,6,10,1983,5,910,2.0,642.0,642.0,5,1073,2.0,805.0,805.0
1756.064,6,105,6270,60,3525,29763.0,27.0,27.0,45,2745,39909.0,27.0,27.0
0.004,6,10,2006,5,927,1.0,659.0,659.0,5,1079,1.0,811.0,811.0
0.006,17,2,169,1,62,0.0,34.0,34.0,1,107,0.0,79.0,79.0
0.005,6,10,2007,5,928,1.0,660.0,660.0,5,1079,1.0,811.0,811.0
0.039,17,2,170,1,65,0.0,37.0,37.0,1,105,0.0,77.0,77.0
10.829,17,28,4422,14,1994,824.0,269.0,114.0,14,2428,824.0,587.0,145.0
0.006,6,10,1854,5,889,1.0,621.0,621.0,5,965,1.0,697.0,697.0
0.029,6,10,1983,5,910,7.0,642.0,642.0,5,1073,7.0,805.0,805.0
0.005,6,10,2006,5,927,1.0,659.0,659.0,5,1079,1.0,811.0,811.0
40.067,17,10,676,5,460,10015.0,104.0,64.0,5,216,10015.0,20.0,15.0
0.015,6,10,1983,5,910,3.0,642.0,642.0,5,1073,3.0,805.0,805.0
0.001,17,2,180,1,66,0.0,38.0,38.0,1,114,0.0,86.0,86.0
241.123,6,313,343524,113,17381,2152.0,2736.0,959.0,200,326143,1211.0,2804.0,1661.0
0.001,17,2,180,1,66,0.0,38.0,38.0,1,114,0.0,86.0,86.0
40.08,17,10,676,5,460,10017.0,104.0,64.0,5,216,10019.0,20.0,15.0
0.003,17,2,148,1,60,0.0,32.0,32.0,1,88,0.0,60.0,60.0
0.015,6,10,1989,5,910,3.0,642.0,642.0,5,1079,3.0,811.0,811.0
0.006,6,10,1547,5,764,1.0,496.0,496.0,5,783,1.0,515.0,515.0
0.115,6,10,1506,5,395,27.0,127.0,127.0,5,1111,25.0,843.0,843.0
0.003,17,2,203,1,61,0.0,33.0,33.0,1,142,0.0,114.0,114.0
1.032,6,13,3930,7,2139,129.0,1328.0,923.0,6,1791,155.0,1539.0,1539.0
0.019,6,10,1989,5,910,4.0,642.0,642.0,5,1079,4.0,811.0,811.0
0.276,6,12,2996,7,549,46.0,177.0,177.0,5,2447,42.0,1402.0,1089.0
0.004,17,2,148,1,60,0.0,32.0,32.0,1,88,0.0,60.0,60.0
0.006,6,10,1547,5,764,1.0,496.0,496.0,5,783,1.0,515.0,515.0
0.001,17,2,180,1,66,0.0,38.0,38.0,1,114,0.0,86.0,86.0
0.006,6,10,2000,5,927,1.0,659.0,659.0,5,1073,1.0,805.0,805.0
0.013,6,10,1972,5,910,3.0,642.0,642.0,5,1062,3.0,794.0,794.0
0.005,17,4,495,2,132,1.0,38.0,38.0,2,363,2.0,176.0,153.0
0.073,6,10,1506,5,395,16.0,127.0,127.0,5,1111,17.0,843.0,843.0
0.013,6,10,1990,5,911,3.0,643.0,643.0,5,1079,3.0,811.0,811.0
0.104,6,10,1506,5,395,21.0,127.0,127.0,5,1111,21.0,843.0,843.0
0.012,6,10,1990,5,911,3.0,643.0,643.0,5,1079,2.0,811.0,811.0
270.426,6,82,41365,34,5734,8194.0,944.0,304.0,48,35631,5753.0,2804.0,946.0
0.012,6,10,1990,5,911,2.0,643.0,643.0,5,1079,3.0,811.0,811.0
0.005,6,14,3736,7,446,0.0,74.0,74.0,7,3290,0.0,1448.0,972.0
0.01,6,10,1989,5,910,2.0,642.0,642.0,5,1079,2.0,811.0,811.0
0.006,17,2,140,1,62,0.0,34.0,34.0,1,78,0.0,50.0,50.0
0.005,6,10,1547,5,764,1.0,496.0,496.0,5,783,1.0,515.0,515.0
40.043,17,10,676,5,460,10010.0,104.0,64.0,5,216,10009.0,20.0,15.0
0.005,6,10,2007,5,928,1.0,660.0,660.0,5,1079,1.0,811.0,811.0
0.009,6,10,1990,5,911,2.0,643.0,643.0,5,1079,2.0,811.0,811.0
40.052,17,10,676,5,460,10012.0,104.0,64.0,5,216,10012.0,20.0,15.0
368.937,6,22,2313,16,867,24595.0,195.0,195.0,6,1446,4635.0,419.0,398.0
0.013,6,10,1990,5,911,3.0,643.0,643.0,5,1079,3.0,811.0,811.0
0.097,6,10,1506,5,395,19.0,127.0,127.0,5,1111,21.0,843.0,843.0
0.005,6,10,1854,5,889,1.0,621.0,621.0,5,965,1.0,697.0,697.0
1788.39,6,240,35580,150,25920,12002.0,302.0,302.0,90,9660,20094.0,83.0,83.0
412.003,6,29,4409,12,3102,10911.0,494.0,494.0,17,1307,25750.0,83.0,83.0
0.039,17,2,136,1,60,0.0,32.0,32.0,1,76,0.0,48.0,48.0
52.408,6,37,9949,19,4431,490.0,1360.0,727.0,18,5518,3073.0,2667.0,435.0
0.114,6,10,1506,5,395,25.0,127.0,127.0,5,1111,27.0,843.0,843.0
0.005,6,10,2000,5,927,1.0,659.0,659.0,5,1073,1.0,805.0,805.0
0.001,17,2,180,1,66,0.0,38.0,38.0,1,114,0.0,86.0,86.0
0.009,6,10,2007,5,928,2.0,660.0,660.0,5,1079,2.0,811.0,811.0
0.005,6,10,2006,5,927,1.0,659.0,659.0,5,1079,1.0,811.0,811.0
0.006,17,2,230,1,68,0.0,40.0,40.0,1,162,0.0,134.0,134.0
0.004,6,10,2006,5,927,1.0,659.0,659.0,5,1079,1.0,811.0,811.0
0.012,6,13,3735,7,497,2.0,125.0,125.0,6,3238,2.0,1470.0,1459.0
0.014,6,10,2006,5,927,3.0,659.0,659.0,5,1079,3.0,811.0,811.0
0.073,6,10,1506,5,395,16.0,127.0,127.0,5,1111,16.0,843.0,843.0
0.039,6,20,9974,11,704,3.0,124.0,124.0,9,9270,4.0,2896.0,1758.0
64.358,6,36,9704,18,4186,522.0,1753.0,858.0,18,5518,3775.0,2667.0,435.0
0.006,6,10,2006,5,927,1.0,659.0,659.0,5,1079,1.0,811.0,811.0
0.004,17,2,148,1,60,0.0,32.0,32.0,1,88,0.0,60.0,60.0
0.149,6,10,1506,5,395,30.0,127.0,127.0,5,1111,36.0,843.0,843.0
0.005,6,13,3747,7,509,0.0,137.0,137.0,6,3238,0.0,1470.0,1459.0
0.15,17,2,179,1,71,0.0,43.0,43.0,1,108,0.0,80.0,80.0
0.001,17,2,180,1,66,0.0,38.0,38.0,1,114,0.0,86.0,86.0
0.001,17,2,180,1,66,0.0,38.0,38.0,1,114,0.0,86.0,86.0
0.006,6,10,1547,5,764,1.0,496.0,496.0,5,783,1.0,515.0,515.0
0.005,17,2,144,1,64,0.0,36.0,36.0,1,80,0.0,52.0,52.0
0.004,6,10,1774,5,923,1.0,655.0,655.0,5,851,1.0,583.0,583.0
0.012,6,10,1989,5,910,3.0,642.0,642.0,5,1079,3.0,811.0,811.0
21.334,6,36,8190,18,1719,536.0,651.0,322.0,18,6471,1247.0,2720.0,478.0
0.188,17,4,596,2,122,150.0,33.0,33.0,2,474,145.0,323.0,209.0
0.009,6,12,1926,6,1189,1.0,659.0,434.0,6,737,1.0,417.0,417.0
0.005,6,10,2006,5,927,1.0,659.0,659.0,5,1079,1.0,811.0,811.0
1786.34,6,154,19574,92,13852,19630.0,302.0,302.0,62,5722,29284.0,83.0,83.0
0.097,6,10,1506,5,395,19.0,127.0,127.0,5,1111,23.0,843.0,843.0
40.066,17,10,676,5,460,10013.0,104.0,64.0,5,216,10015.0,20.0,15.0
40.058,17,10,676,5,460,10013.0,104.0,64.0,5,216,10013.0,20.0,15.0
0.007,6,10,1631,5,848,1.0,580.0,580.0,5,783,1.0,515.0,515.0
0.005,6,10,2006,5,927,1.0,659.0,659.0,5,1079,1.0,811.0,811.0
0.005,6,10,2006,5,927,1.0,659.0,659.0,5,1079,1.0,811.0,811.0
0.013,6,10,1677,5,827,3.0,559.0,559.0,5,850,3.0,582.0,582.0
0.006,6,10,2000,5,927,1.0,659.0,659.0,5,1073,1.0,805.0,805.0
0.042,17,2,152,1,76,0.0,48.0,48.0,1,76,0.0,48.0,48.0
0.012,6,10,1990,5,911,2.0,643.0,643.0,5,1079,3.0,811.0,811.0
0.003,17,2,185,1,73,0.0,45.0,45.0,1,112,0.0,84.0,84.0
40.06,17,10,676,5,460,10014.0,104.0,64.0,5,216,10014.0,20.0,15.0
0.009,6,10,1677,5,827,2.0,559.0,559.0,5,850,2.0,582.0,582.0
0.089,6,10,1506,5,395,20.0,127.0,127.0,5,1111,17.0,843.0,843.0
1794.267,6,593,193131,303,165340,5941.0,2883.0,849.0,290,27791,6208.0,580.0,119.0
0.093,6,10,1506,5,395,20.0,127.0,127.0,5,1111,22.0,843.0,843.0
0.086,6,10,1506,5,395,19.0,127.0,127.0,5,1111,15.0,843.0,843.0
0.0,17,2,180,1,66,0.0,38.0,38.0,1,114,0.0,86.0,86.0
0.016,6,10,1989,5,910,4.0,642.0,642.0,5,1079,4.0,811.0,811.0
240.464,6,37,9660,19,2175,13358.0,747.0,235.0,18,7485,14144.0,1402.0,595.0
0.017,6,13,3684,7,446,2.0,74.0,74.0,6,3238,3.0,1470.0,1459.0
40.048,17,10,676,5,460,10011.0,104.0,64.0,5,216,10011.0,20.0,15.0
0.005,17,2,144,1,64,0.0,36.0,36.0,1,80,0.0,52.0,52.0
0.004,17,2,136,1,60,0.0,32.0,32.0,1,76,0.0,48.0,48.0
0.007,6,10,1643,5,860,1.0,592.0,592.0,5,783,1.0,515.0,515.0
0.008,17,2,179,1,71,0.0,43.0,43.0,1,108,0.0,80.0,80.0
0.006,17,2,179,1,71,0.0,43.0,43.0,1,108,0.0,80.0,80.0
0.014,6,10,1989,5,910,3.0,642.0,642.0,5,1079,3.0,811.0,811.0
0.015,6,10,1990,5,911,3.0,643.0,643.0,5,1079,3.0,811.0,811.0
0.013,6,10,1972,5,910,3.0,642.0,642.0,5,1062,3.0,794.0,794.0
0.005,17,2,180,1,66,0.0,38.0,38.0,1,114,0.0,86.0,86.0
0.08,6,10,1506,5,395,18.0,127.0,127.0,5,1111,16.0,843.0,843.0
0.088,6,10,1506,5,395,20.0,127.0,127.0,5,1111,18.0,843.0,843.0
0.004,6,13,3747,7,509,0.0,137.0,137.0,6,3238,0.0,1470.0,1459.0
0.017,6,10,1990,5,911,4.0,643.0,643.0,5,1079,4.0,811.0,811.0
0.041,17,2,152,1,76,0.0,48.0,48.0,1,76,0.0,48.0,48.0
0.008,6,12,1926,6,1189,1.0,659.0,434.0,6,737,1.0,417.0,417.0
0.006,6,10,1854,5,889,1.0,621.0,621.0,5,965,1.0,697.0,697.0
0.005,6,10,1989,5,927,1.0,659.0,659.0,5,1062,1.0,794.0,794.0
0.004,6,10,2000,5,927,1.0,659.0,659.0,5,1073,1.0,805.0,805.0
0.006,6,10,1854,5,889,1.0,621.0,621.0,5,965,1.0,697.0,697.0
0.047,6,10,1983,5,910,11.0,642.0,642.0,5,1073,11.0,805.0,805.0
15.03,17,44,21688,24,18521,652.0,1350.0,743.0,20,3167,789.0,1350.0,130.0
0.013,6,10,1990,5,911,3.0,643.0,643.0,5,1079,3.0,811.0,811.0
300.345,6,16,2170,9,684,37522.0,146.0,146.0,7,1486,50029.0,419.0,398.0
0.005,17,2,169,1,62,0.0,34.0,34.0,1,107,0.0,79.0,79.0
0.008,6,10,1989,5,910,2.0,642.0,642.0,5,1079,2.0,811.0,811.0
0.005,6,10,2006,5,927,1.0,659.0,659.0,5,1079,1.0,811.0,811.0
0.101,17,2,144,1,64,0.0,36.0,36.0,1,80,0.0,52.0,52.0
0.008,6,10,1774,5,923,1.0,655.0,655.0,5,851,1.0,583.0,583.0
0.005,17,2,148,1,60,0.0,32.0,32.0,1,88,0.0,60.0,60.0
0.006,6,10,1547,5,764,1.0,496.0,496.0,5,783,1.0,515.0,515.0
0.004,17,2,152,1,76,0.0,48.0,48.0,1,76,0.0,48.0,48.0
0.028,6,10,1990,5,911,7.0,643.0,643.0,5,1079,7.0,811.0,811.0
0.005,6,10,2000,5,927,1.0,659.0,659.0,5,1073,1.0,805.0,805.0
282.568,6,23,6075,11,1226,28256.0,267.0,156.0,12,4849,25687.0,1400.0,873.0
0.006,17,2,179,1,71,0.0,43.0,43.0,1,108,0.0,80.0,80.0
240.1,6,16,4482,9,963,30012.0,238.0,166.0,7,3519,40016.0,1402.0,786.0
0.066,6,10,1506,5,395,14.0,127.0,127.0,5,1111,14.0,843.0,843.0
0.007,17,2,179,1,71,0.0,43.0,43.0,1,108,0.0,80.0,80.0
0.013,6,10,1990,5,911,3.0,643.0,643.0,5,1079,3.0,811.0,811.0
0.068,17,8,3613,4,1874,22.0,1350.0,440.0,4,1739,11.0,1350.0,406.0
0.01,6,10,1990,5,911,2.0,643.0,643.0,5,1079,2.0,811.0,811.0
0.014,6,10,1972,5,910,3.0,642.0,642.0,5,1062,3.0,794.0,794.0
0.005,6,10,1989,5,927,1.0,659.0,659.0,5,1062,1.0,794.0,794.0
0.011,6,10,1989,5,910,2.0,642.0,642.0,5,1079,2.0,811.0,811.0
0.069,6,10,1506,5,395,15.0,127.0,127.0,5,1111,14.0,843.0,843.0
293.674,6,319,344396,122,17883,2427.0,2736.0,824.0,197,326513,1498.0,2804.0,1728.0
0.005,6,10,1989,5,927,1.0,659.0,659.0,5,1062,1.0,794.0,794.0
0.005,6,13,3747,7,509,0.0,137.0,137.0,6,3238,1.0,1470.0,1459.0
0.073,17,2,412,1,61,0.0,33.0,33.0,1,351,0.0,323.0,323.0
0.006,6,12,1698,6,863,1.0,327.0,271.0,6,835,1.0,515.0,515.0
0.102,6,10,1506,5,395,21.0,127.0,127.0,5,1111,25.0,843.0,843.0
0.005,6,10,1989,5,927,1.0,659.0,659.0,5,1062,1.0,794.0,794.0
0.005,17,2,180,1,58,0.0,30.0,30.0,1,122,0.0,94.0,94.0
0.012,6,10,1972,5,910,3.0,642.0,642.0,5,1062,3.0,794.0,794.0
0.01,6,10,1989,5,910,2.0,642.0,642.0,5,1079,2.0,811.0,811.0
0.005,6,10,2007,5,928,1.0,660.0,660.0,5,1079,1.0,811.0,811.0
0.005,17,2,212,1,74,0.0,46.0,46.0,1,138,0.0,110.0,110.0
11.105,17,28,4421,14,1994,842.0,269.0,114.0,14,2427,842.0,586.0,145.0
0.015,6,10,1972,5,910,3.0,642.0,642.0,5,1062,3.0,794.0,794.0
240.088,6,16,4481,9,963,30011.0,238.0,166.0,7,3518,40014.0,1402.0,786.0
0.005,17,2,144,1,64,0.0,36.0,36.0,1,80,0.0,52.0,52.0
0.106,6,10,1506,5,395,24.0,127.0,127.0,5,1111,24.0,843.0,843.0
0.005,6,10,1689,5,839,1.0,571.0,571.0,5,850,1.0,582.0,582.0
300.024,6,12,1782,7,1348,50004.0,494.0,494.0,5,434,75005.0,83.0,83.0
0.004,17,2,148,1,60,0.0,32.0,32.0,1,88,0.0,60.0,60.0
8.943,6,36,9012,19,3525,496.0,1360.0,546.0,17,5487,546.0,2658.0,435.0
11.491,17,28,4389,14,2311,871.0,586.0,137.0,14,2078,871.0,269.0,120.0
0.005,6,10,2006,5,927,1.0,659.0,659.0,5,1079,1.0,811.0,811.0
0.012,6,10,1990,5,911,3.0,643.0,643.0,5,1079,3.0,811.0,811.0
0.012,6,10,1983,5,910,2.0,642.0,642.0,5,1073,2.0,805.0,805.0
0.182,17,4,596,2,122,144.0,33.0,33.0,2,474,145.0,323.0,209.0
0.001,17,2,142,1,63,0.0,35.0,35.0,1,79,0.0,51.0,51.0
40.058,17,10,676,5,460,10013.0,104.0,64.0,5,216,10013.0,20.0,15.0
0.041,17,4,284,2,120,1.0,32.0,32.0,2,164,37.0,60.0,54.0
0.21,6,16,2777,8,1395,30.0,533.0,323.0,8,1382,18.0,529.0,239.0
0.005,6,10,2006,5,927,1.0,659.0,659.0,5,1079,1.0,811.0,811.0
0.014,6,10,1677,5,827,3.0,559.0,559.0,5,850,3.0,582.0,582.0
0.07,6,10,1506,5,395,16.0,127.0,127.0,5,1111,15.0,843.0,843.0
0.011,6,10,1983,5,910,2.0,642.0,642.0,5,1073,2.0,805.0,805.0
240.037,6,9,787,5,488,60009.0,232.0,232.0,4,299,80003.0,83.0,83.0
0.006,6,10,1643,5,860,1.0,592.0,592.0,5,783,1.0,515.0,515.0
0.118,6,10,1506,5,395,26.0,127.0,127.0,5,1111,24.0,843.0,843.0
1770.461,17,92,8096,46,4048,39343.0,60.0,60.0,46,4048,39343.0,60.0,60.0
0.005,6,10,2000,5,927,1.0,659.0,659.0,5,1073,1.0,805.0,805.0
0.082,6,10,1506,5,395,19.0,127.0,127.0,5,1111,17.0,843.0,843.0
243.19,6,180,161889,95,9041,2587.0,1047.0,682.0,85,152848,2895.0,2804.0,1902.0
0.005,17,2,170,1,65,0.0,37.0,37.0,1,105,0.0,77.0,77.0
0.006,6,10,1972,5,910,1.0,642.0,642.0,5,1062,1.0,794.0,794.0
0.008,17,2,179,1,71,0.0,43.0,43.0,1,108,0.0,80.0,80.0
0.004,17,2,136,1,60,0.0,32.0,32.0,1,76,0.0,48.0,48.0
0.011,6,10,1972,5,910,2.0,642.0,642.0,5,1062,2.0,794.0,794.0
0.093,6,10,1506,5,395,22.0,127.0,127.0,5,1111,18.0,843.0,843.0
0.305,17,46,27054,24,21177,13.0,1350.0,854.0,22,5877,11.0,1350.0,239.0
0.01,6,10,1989,5,910,2.0,642.0,642.0,5,1079,2.0,811.0,811.0
0.004,17,2,148,1,60,0.0,32.0,32.0,1,88,0.0,60.0,60.0
300.403,6,16,2170,9,684,37529.0,146.0,146.0,7,1486,50040.0,419.0,398.0
0.009,6,10,1989,5,910,2.0,642.0,642.0,5,1079,2.0,811.0,811.0
0.004,6,10,2006,5,927,1.0,659.0,659.0,5,1079,1.0,811.0,811.0
0.011,6,10,1631,5,848,2.0,580.0,580.0,5,783,2.0,515.0,515.0
0.01,6,10,1989,5,910,2.0,642.0,642.0,5,1079,2.0,811.0,811.0
0.006,6,10,1689,5,839,1.0,571.0,571.0,5,850,1.0,582.0,582.0
0.083,6,10,1506,5,395,19.0,127.0,127.0,5,1111,16.0,843.0,843.0
0.006,6,10,2000,5,927,1.0,659.0,659.0,5,1073,1.0,805.0,805.0
0.001,17,2,166,1,75,0.0,47.0,47.0,1,91,0.0,63.0,63.0
0.011,6,10,1989,5,910,2.0,642.0,642.0,5,1079,2.0,811.0,811.0
0.005,6,10,2006,5,927,1.0,659.0,659.0,5,1079,1.0,811.0,811.0
0.084,6,10,1506,5,395,19.0,127.0,127.0,5,1111,17.0,843.0,843.0
300.39,6,16,2170,9,684,37528.0,146.0,146.0,7,1486,50038.0,419.0,398.0
0.017,6,10,1989,5,910,4.0,642.0,642.0,5,1079,4.0,811.0,811.0
0.009,6,13,3735,7,497,1.0,125.0,125.0,6,3238,1.0,1470.0,1459.0
0.016,6,10,1989,5,910,4.0,642.0,642.0,5,1079,3.0,811.0,811.0
0.005,6,10,2000,5,927,1.0,659.0,659.0,5,1073,1.0,805.0,805.0
0.011,6,10,1990,5,911,2.0,643.0,643.0,5,1079,2.0,811.0,811.0
0.061,6,10,1506,5,395,14.0,127.0,127.0,5,1111,13.0,843.0,843.0
0.004,6,10,2006,5,927,1.0,659.0,659.0,5,1079,1.0,811.0,811.0
0.008,6,10,1989,5,910,2.0,642.0,642.0,5,1079,2.0,811.0,811.0
0.005,6,10,2007,5,928,1.0,660.0,660.0,5,1079,1.0,811.0,811.0
0.006,6,14,3799,7,509,1.0,137.0,137.0,7,3290,0.0,1448.0,972.0
0.01,6,10,1972,5,910,2.0,642.0,642.0,5,1062,2.0,794.0,794.0
0.077,6,10,1506,5,395,17.0,127.0,127.0,5,1111,18.0,843.0,843.0
0.093,6,10,1506,5,395,21.0,127.0,127.0,5,1111,21.0,843.0,843.0
0.004,17,2,222,1,65,0.0,37.0,37.0,1,157,0.0,129.0,129.0
0.129,6,10,1506,5,395,27.0,127.0,127.0,5,1111,26.0,843.0,843.0
0.004,17,4,284,2,120,0.0,32.0,32.0,2,164,1.0,60.0,54.0
172.223,17,66,9538,33,2202,5381.0,44.0,38.0,33,7336,5381.0,260.0,194.0
0.067,6,10,1506,5,395,16.0,127.0,127.0,5,1111,13.0,843.0,843.0
10.872,17,28,4419,14,1995,828.0,270.0,114.0,14,2424,828.0,587.0,145.0
0.093,6,10,1506,5,395,20.0,127.0,127.0,5,1111,21.0,843.0,843.0
0.091,6,10,1506,5,395,20.0,127.0,127.0,5,1111,19.0,843.0,843.0
0.008,6,14,3787,7,497,1.0,125.0,125.0,7,3290,1.0,1448.0,972.0
0.263,17,44,24484,24,21161,11.0,1350.0,853.0,20,3323,10.0,1350.0,138.0
0.085,6,10,1506,5,395,19.0,127.0,127.0,5,1111,18.0,843.0,843.0
0.013,6,10,1989,5,910,3.0,642.0,642.0,5,1079,3.0,811.0,811.0
0.013,6,10,1989,5,927,3.0,659.0,659.0,5,1062,3.0,794.0,794.0
40.106,17,10,676,5,460,10017.0,104.0,64.0,5,216,10023.0,20.0,15.0
0.108,6,10,1506,5,395,24.0,127.0,127.0,5,1111,23.0,843.0,843.0
40.064,17,10,676,5,460,10015.0,104.0,64.0,5,216,10015.0,20.0,15.0
0.074,6,10,1506,5,395,16.0,127.0,127.0,5,1111,15.0,843.0,843.0
0.006,6,10,1547,5,764,1.0,496.0,496.0,5,783,1.0,515.0,515.0
0.009,6,10,2007,5,928,2.0,660.0,660.0,5,1079,2.0,811.0,811.0
1770.498,17,92,8096,46,4048,39344.0,60.0,60.0,46,4048,39344.0,60.0,60.0
0.094,6,10,1506,5,395,21.0,127.0,127.0,5,1111,19.0,843.0,843.0
0.001,17,2,180,1,66,0.0,38.0,38.0,1,114,0.0,86.0,86.0
0.005,6,10,1643,5,860,1.0,592.0,592.0,5,783,1.0,515.0,515.0
0.088,6,10,1506,5,395,18.0,127.0,127.0,5,1111,19.0,843.0,843.0
0.109,6,10,1506,5,395,21.0,127.0,127.0,5,1111,25.0,843.0,843.0
0.013,6,10,1631,5,848,3.0,580.0,580.0,5,783,3.0,515.0,515.0
0.005,6,13,3690,7,452,0.0,80.0,80.0,6,3238,1.0,1470.0,1459.0
0.081,6,10,1506,5,395,19.0,127.0,127.0,5,1111,18.0,843.0,843.0
0.079,6,10,1506,5,395,18.0,127.0,127.0,5,1111,17.0,843.0,843.0
240.388,6,33,9264,16,1832,16025.0,519.0,198.0,17,7432,15024.0,1402.0,595.0
0.072,17,2,170,1,65,0.0,37.0,37.0,1,105,0.0,77.0,77.0
0.005,6,10,2007,5,928,1.0,660.0,660.0,5,1079,1.0,811.0,811.0
0.009,6,10,1990,5,911,2.0,643.0,643.0,5,1079,2.0,811.0,811.0
0.008,6,10,1677,5,827,2.0,559.0,559.0,5,850,1.0,582.0,582.0
0.111,17,2,80,1,32,0.0,4.0,4.0,1,48,0.0,20.0,20.0
0.012,6,10,1631,5,848,3.0,580.0,580.0,5,783,3.0,515.0,515.0
0.005,6,10,2006,5,927,1.0,659.0,659.0,5,1079,1.0,811.0,811.0
0.012,6,10,1972,5,910,2.0,642.0,642.0,5,1062,3.0,794.0,794.0
0.003,17,2,136,1,60,0.0,32.0,32.0,1,76,0.0,48.0,48.0
0.006,6,10,2000,5,927,1.0,659.0,659.0,5,1073,1.0,805.0,805.0
0.005,6,10,2007,5,928,1.0,660.0,660.0,5,1079,1.0,811.0,811.0
0.209,6,16,2670,8,1396,29.0,533.0,324.0,8,1274,19.0,529.0,212.0
0.004,6,10,2007,5,928,1.0,660.0,660.0,5,1079,1.0,811.0,811.0
0.012,6,10,1631,5,848,2.0,580.0,580.0,5,783,2.0,515.0,515.0
0.005,6,10,2006,5,927,1.0,659.0,659.0,5,1079,1.0,811.0,811.0
40.062,17,10,676,5,460,10014.0,104.0,64.0,5,216,10014.0,20.0,15.0
0.005,17,2,148,1,60,0.0,32.0,32.0,1,88,0.0,60.0,60.0
0.012,6,10,1989,5,910,3.0,642.0,642.0,5,1079,2.0,811.0,811.0
0.005,6,10,1702,5,863,1.0,595.0,595.0,5,839,1.0,571.0,571.0
40.089,17,10,676,5,460,10018.0,104.0,64.0,5,216,10019.0,20.0,15.0
0.02,6,10,1631,5,848,5.0,580.0,580.0,5,783,5.0,515.0,515.0
0.007,6,10,1989,5,910,1.0,642.0,642.0,5,1079,1.0,811.0,811.0
311.568,17,19,1084,10,716,34605.0,48.0,43.0,9,368,38929.0,20.0,12.0
0.009,6,14,3787,7,497,1.0,125.0,125.0,7,3290,1.0,1448.0,972.0
0.171,6,10,1506,5,395,38.0,127.0,127.0,5,1111,39.0,843.0,843.0
0.086,6,10,1506,5,395,18.0,127.0,127.0,5,1111,20.0,843.0,843.0
0.098,6,10,1506,5,395,22.0,127.0,127.0,5,1111,17.0,843.0,843.0
15.079,17,15,9238,8,6902,2150.0,1350.0,834.0,7,2336,2507.0,1350.0,305.0
0.006,17,2,209,1,64,0.0,36.0,36.0,1,145,0.0,117.0,117.0
0.013,6,10,1677,5,827,3.0,559.0,559.0,5,850,3.0,582.0,582.0
0.11,6,10,1506,5,395,25.0,127.0,127.0,5,1111,23.0,843.0,843.0
0.069,17,8,3613,4,1874,23.0,1350.0,440.0,4,1739,11.0,1350.0,406.0
0.006,6,10,1547,5,764,1.0,496.0,496.0,5,783,1.0,515.0,515.0
0.067,6,10,1506,5,395,14.0,127.0,127.0,5,1111,15.0,843.0,843.0
0.004,6,10,1774,5,923,1.0,655.0,655.0,5,851,1.0,583.0,583.0
0.02,6,10,1990,5,911,5.0,643.0,643.0,5,1079,5.0,811.0,811.0
0.107,6,10,1506,5,395,23.0,127.0,127.0,5,1111,25.0,843.0,843.0
0.264,17,39,20111,22,17097,12.0,1350.0,749.0,17,3014,12.0,1350.0,149.0
300.787,6,37,9425,20,3947,15830.0,1371.0,623.0,17,5478,537.0,2667.0,435.0
0.005,17,2,293,1,73,0.0,45.0,45.0,1,220,0.0,192.0,192.0
0.094,6,10,1506,5,395,21.0,127.0,127.0,5,1111,21.0,843.0,843.0
0.005,6,10,2000,5,927,1.0,659.0,659.0,5,1073,1.0,805.0,805.0
40.054,17,10,676,5,460,10011.0,104.0,64.0,5,216,10012.0,20.0,15.0
0.01,6,10,1989,5,910,2.0,642.0,642.0,5,1079,2.0,811.0,811.0
0.006,6,10,1547,5,764,1.0,496.0,496.0,5,783,1.0,515.0,515.0
0.013,17,2,169,1,62,0.0,34.0,34.0,1,107,0.0,79.0,79.0
0.001,17,2,166,1,75,0.0,47.0,47.0,1,91,0.0,63.0,63.0
0.005,6,10,2000,5,927,1.0,659.0,659.0,5,1073,1.0,805.0,805.0
0.008,6,10,1989,5,910,2.0,642.0,642.0,5,1079,2.0,811.0,811.0
0.04,17,2,182,1,65,0.0,37.0,37.0,1,117,0.0,89.0,89.0
0.005,6,10,2007,5,928,1.0,660.0,660.0,5,1079,1.0,811.0,811.0
0.085,6,10,1506,5,395,18.0,127.0,127.0,5,1111,18.0,843.0,843.0
0.085,6,10,1506,5,395,18.0,127.0,127.0,5,1111,17.0,843.0,843.0
10.74,17,28,4420,14,1993,817.0,268.0,114.0,14,2427,817.0,586.0,145.0
0.1,6,10,1506,5,395,22.0,127.0,127.0,5,1111,22.0,843.0,843.0
0.008,6,10,2000,5,927,1.0,659.0,659.0,5,1073,2.0,805.0,805.0
0.008,6,10,1990,5,911,2.0,643.0,643.0,5,1079,2.0,811.0,811.0
0.005,17,2,213,1,69,0.0,41.0,41.0,1,144,0.0,116.0,116.0
0.005,6,10,2006,5,927,1.0,659.0,659.0,5,1079,1.0,811.0,811.0
15.076,17,16,8110,8,6020,2149.0,1350.0,724.0,8,2090,2149.0,1350.0,233.0
0.011,6,10,1677,5,827,2.0,559.0,559.0,5,850,2.0,582.0,582.0
0.007,6,10,1972,5,910,1.0,642.0,642.0,5,1062,1.0,794.0,794.0
0.014,6,10,1989,5,910,3.0,642.0,642.0,5,1079,3.0,811.0,811.0
0.01,6,12,1926,6,1189,2.0,659.0,434.0,6,737,1.0,417.0,417.0
0.796,6,25,5555,12,1445,65.0,267.0,136.0,13,4110,55.0,1414.0,597.0
0.001,17,2,194,1,57,0.0,29.0,29.0,1,137,0.0,109.0,109.0
369.471,6,22,2313,16,867,24631.0,195.0,195.0,6,1446,4637.0,419.0,398.0
0.005,6,10,2007,5,928,1.0,660.0,660.0,5,1079,1.0,811.0,811.0
0.102,6,10,1506,5,395,24.0,127.0,127.0,5,1111,23.0,843.0,843.0
0.011,6,10,1762,5,911,2.0,643.0,643.0,5,851,2.0,583.0,583.0
0.001,17,2,180,1,66,0.0,38.0,38.0,1,114,0.0,86.0,86.0
0.008,17,2,214,1,75,0.0,47.0,47.0,1,139,0.0,111.0,111.0
0.006,6,10,1689,5,839,1.0,571.0,571.0,5,850,1.0,582.0,582.0
40.069,17,10,676,5,460,10016.0,104.0,64.0,5,216,10016.0,20.0,15.0
0.121,6,10,1506,5,395,25.0,127.0,127.0,5,1111,26.0,843.0,843.0
15.077,17,17,10213,9,8079,1881.0,1350.0,869.0,8,2134,2153.0,1350.0,238.0
0.003,17,2,148,1,60,0.0,32.0,32.0,1,88,0.0,60.0,60.0
40.06,17,10,676,5,460,10012.0,104.0,64.0,5,216,10014.0,20.0,15.0
0.009,6,10,1972,5,910,2.0,642.0,642.0,5,1062,2.0,794.0,794.0
0.01,6,10,1989,5,910,2.0,642.0,642.0,5,1079,2.0,811.0,811.0
0.131,17,2,152,1,76,0.0,48.0,48.0,1,76,0.0,48.0,48.0
0.01,6,10,1989,5,910,2.0,642.0,642.0,5,1079,2.0,811.0,811.0
351.992,6,20,2210,6,1308,12004.0,494.0,494.0,14,902,27076.0,83.0,83.0
0.011,6,10,1677,5,827,2.0,559.0,559.0,5,850,2.0,582.0,582.0
15.075,17,14,9190,8,6902,2149.0,1350.0,834.0,6,2288,3008.0,1350.0,353.0
0.005,6,10,1989,5,927,1.0,659.0,659.0,5,1062,1.0,794.0,794.0
0.013,6,10,1989,5,910,3.0,642.0,642.0,5,1079,3.0,811.0,811.0
0.001,17,2,179,1,62,0.0,34.0,34.0,1,117,0.0,89.0,89.0
0.014,6,10,1677,5,827,3.0,559.0,559.0,5,850,3.0,582.0,582.0
0.009,6,10,1989,5,910,2.0,642.0,642.0,5,1079,2.0,811.0,811.0
0.003,17,4,284,2,120,0.0,32.0,32.0,2,164,0.0,60.0,54.0
0.042,17,2,148,1,60,0.0,32.0,32.0,1,88,0.0,60.0,60.0
0.005,6,10,1547,5,764,1.0,496.0,496.0,5,783,1.0,515.0,515.0
0.01,6,14,3736,7,446,1.0,74.0,74.0,7,3290,1.0,1448.0,972.0
0.006,17,4,284,2,120,0.0,32.0,32.0,2,164,0.0,60.0,54.0
0.006,6,13,3747,7,509,0.0,137.0,137.0,6,3238,1.0,1470.0,1459.0
0.238,6,16,2669,8,1395,34.0,533.0,323.0,8,1274,21.0,529.0,212.0
40.063,17,10,676,5,460,10012.0,104.0,64.0,5,216,10014.0,20.0,15.0
0.272,17,39,20146,21,17038,13.0,1350.0,783.0,18,3108,12.0,1350.0,144.0
0.024,6,10,1972,5,910,5.0,642.0,642.0,5,1062,5.0,794.0,794.0
0.015,6,10,1972,5,910,3.0,642.0,642.0,5,1062,3.0,794.0,794.0
0.004,6,10,2006,5,927,1.0,659.0,659.0,5,1079,1.0,811.0,811.0
40.071,17,10,676,5,460,10017.0,104.0,64.0,5,216,10017.0,20.0,15.0
0.129,6,10,1506,5,395,27.0,127.0,127.0,5,1111,27.0,843.0,843.0
166.326,17,78,10775,39,2600,4376.0,44.0,38.0,39,8175,4376.0,239.0,181.0
0.085,6,10,1506,5,395,19.0,127.0,127.0,5,1111,16.0,843.0,843.0
0.008,17,2,194,1,59,0.0,31.0,31.0,1,135,0.0,107.0,107.0
0.129,17,2,80,1,32,0.0,4.0,4.0,1,48,0.0,20.0,20.0
0.079,6,10,1506,5,395,16.0,127.0,127.0,5,1111,16.0,843.0,843.0
0.111,6,10,1506,5,395,24.0,127.0,127.0,5,1111,24.0,843.0,843.0
0.013,6,10,1983,5,910,3.0,642.0,642.0,5,1073,3.0,805.0,805.0
0.006,17,2,148,1,60,0.0,32.0,32.0,1,88,0.0,60.0,60.0
0.004,17,2,136,1,60,0.0,32.0,32.0,1,76,0.0,48.0,48.0
0.088,6,10,1506,5,395,19.0,127.0,127.0,5,1111,21.0,843.0,843.0
0.005,6,10,1989,5,927,1.0,659.0,659.0,5,1062,1.0,794.0,794.0
0.013,6,10,1983,5,910,3.0,642.0,642.0,5,1073,3.0,805.0,805.0
0.005,6,10,1779,5,928,1.0,660.0,660.0,5,851,1.0,583.0,583.0
0.248,6,16,2669,8,1395,35.0,533.0,323.0,8,1274,23.0,529.0,212.0
0.078,6,10,1506,5,395,18.0,127.0,127.0,5,1111,18.0,843.0,843.0
0.102,6,10,1506,5,395,20.0,127.0,127.0,5,1111,20.0,843.0,843.0
0.187,17,4,596,2,122,149.0,33.0,33.0,2,474,144.0,323.0,209.0
0.04,17,2,152,1,76,0.0,48.0,48.0,1,76,0.0,48.0,48.0
0.024,6,10,1989,5,910,6.0,642.0,642.0,5,1079,6.0,811.0,811.0
240.293,6,30,16022,16,7026,16019.0,2736.0,1031.0,14,8996,18483.0,1908.0,1032.0
0.072,17,2,148,1,60,0.0,32.0,32.0,1,88,0.0,60.0,60.0
0.02,6,10,1972,5,910,5.0,642.0,642.0,5,1062,4.0,794.0,794.0
0.004,6,10,2006,5,927,1.0,659.0,659.0,5,1079,1.0,811.0,811.0
0.255,17,4,596,2,122,132.0,33.0,33.0,2,474,125.0,323.0,209.0
0.003,17,4,284,2,120,0.0,32.0,32.0,2,164,0.0,60.0,54.0
0.005,6,10,1989,5,927,1.0,659.0,659.0,5,1062,1.0,794.0,794.0
0.089,6,10,1506,5,395,19.0,127.0,127.0,5,1111,21.0,843.0,843.0
0.039,6,10,1990,5,911,9.0,643.0,643.0,5,1079,9.0,811.0,811.0
0.039,17,2,152,1,76,0.0,48.0,48.0,1,76,0.0,48.0,48.0
240.153,6,45,6857,21,3167,12007.0,588.0,229.0,24,3690,10441.0,580.0,221.0
0.166,6,10,1506,5,395,38.0,127.0,127.0,5,1111,36.0,843.0,843.0
40.065,17,10,676,5,460,10015.0,104.0,64.0,5,216,10015.0,20.0,15.0
0.012,6,10,1972,5,910,3.0,642.0,642.0,5,1062,3.0,794.0,794.0
0.009,17,2,178,1,81,0.0,53.0,53.0,1,97,0.0,69.0,69.0
0.005,6,10,2007,5,928,1.0,660.0,660.0,5,1079,1.0,811.0,811.0
0.018,6,10,1677,5,827,4.0,559.0,559.0,5,850,4.0,582.0,582.0
0.005,17,2,214,1,75,0.0,47.0,47.0,1,139,0.0,111.0,111.0
0.053,17,2,152,1,76,0.0,48.0,48.0,1,76,0.0,48.0,48.0
0.015,6,10,1989,5,910,3.0,642.0,642.0,5,1079,3.0,811.0,811.0
0.017,6,10,1762,5,911,4.0,643.0,643.0,5,851,4.0,583.0,583.0
0.096,6,10,1506,5,395,17.0,127.0,127.0,5,1111,22.0,843.0,843.0
0.008,6,12,1926,6,1189,1.0,659.0,434.0,6,737,1.0,417.0,417.0
0.005,17,2,164,1,74,0.0,46.0,46.0,1,90,0.0,62.0,62.0
0.107,6,10,1506,5,395,26.0,127.0,127.0,5,1111,21.0,843.0,843.0
0.126,6,10,1506,5,395,29.0,127.0,127.0,5,1111,29.0,843.0,843.0
1770.395,17,92,8096,46,4048,39341.0,60.0,60.0,46,4048,39341.0,60.0,60.0
0.006,6,10,1689,5,839,1.0,571.0,571.0,5,850,1.0,582.0,582.0
0.403,17,42,20340,22,17101,19.0,1350.0,749.0,20,3239,19.0,1350.0,133.0
0.004,17,2,170,1,65,0.0,37.0,37.0,1,105,0.0,77.0,77.0
0.091,6,10,1506,5,395,21.0,127.0,127.0,5,1111,20.0,843.0,843.0
0.019,6,10,1990,5,911,4.0,643.0,643.0,5,1079,4.0,811.0,811.0
0.04,17,4,284,2,120,0.0,32.0,32.0,2,164,36.0,60.0,54.0
0.015,6,10,1983,5,910,3.0,642.0,642.0,5,1073,3.0,805.0,805.0
0.013,6,10,1989,5,910,3.0,642.0,642.0,5,1079,3.0,811.0,811.0
0.074,6,10,1506,5,395,17.0,127.0,127.0,5,1111,17.0,843.0,843.0
0.004,6,10,2000,5,927,1.0,659.0,659.0,5,1073,1.0,805.0,805.0
0.013,6,10,1631,5,848,3.0,580.0,580.0,5,783,3.0,515.0,515.0
332.119,17,20,1124,10,716,36895.0,48.0,43.0,10,408,36895.0,20.0,12.0
0.06,17,2,80,1,32,0.0,4.0,4.0,1,48,0.0,20.0,20.0
0.004,6,10,2006,5,927,1.0,659.0,659.0,5,1079,1.0,811.0,811.0
0.005,6,10,2000,5,927,1.0,659.0,659.0,5,1073,1.0,805.0,805.0
0.15,6,10,1506,5,395,33.0,127.0,127.0,5,1111,35.0,843.0,843.0
0.015,6,10,1989,5,910,3.0,642.0,642.0,5,1079,3.0,811.0,811.0
0.006,6,10,1854,5,889,1.0,621.0,621.0,5,965,1.0,697.0,697.0
0.081,6,10,1506,5,395,18.0,127.0,127.0,5,1111,16.0,843.0,843.0
0.013,6,10,1972,5,910,3.0,642.0,642.0,5,1062,3.0,794.0,794.0
0.116,6,10,1506,5,395,25.0,127.0,127.0,5,1111,25.0,843.0,843.0
11.038,17,28,4394,14,2313,840.0,588.0,137.0,14,2081,840.0,268.0,120.0
65.653,6,27,17596,15,9656,4689.0,2804.0,1478.0,12,7940,5953.0,2311.0,1218.0
0.006,6,10,1689,5,839,1.0,571.0,571.0,5,850,1.0,582.0,582.0
0.005,6,10,1989,5,927,1.0,659.0,659.0,5,1062,1.0,794.0,794.0
0.011,6,10,1989,5,910,2.0,642.0,642.0,5,1079,2.0,811.0,811.0
0.005,6,10,1547,5,764,1.0,496.0,496.0,5,783,1.0,515.0,515.0
0.008,6,12,1926,6,1189,1.0,659.0,434.0,6,737,1.0,417.0,417.0
15.086,17,17,8265,8,6038,2151.0,1350.0,726.0,9,2227,1882.0,1350.0,219.0
0.005,6,10,2007,5,928,1.0,660.0,660.0,5,1079,1.0,811.0,811.0
0.009,6,10,2006,5,927,2.0,659.0,659.0,5,1079,2.0,811.0,811.0
1769.9,6,83,4368,42,2210,43167.0,26.0,26.0,41,2158,44246.0,26.0,26.0
0.008,6,12,1926,6,1189,1.0,659.0,434.0,6,737,1.0,417.0,417.0
0.005,6,10,2006,5,927,1.0,659.0,659.0,5,1079,1.0,811.0,811.0
0.006,6,10,2007,5,928,1.0,660.0,660.0,5,1079,1.0,811.0,811.0
0.005,6,10,2006,5,927,1.0,659.0,659.0,5,1079,1.0,811.0,811.0
0.016,17,2,198,1,91,0.0,63.0,63.0,1,107,0.0,79.0,79.0
40.082,17,10,676,5,460,10018.0,104.0,64.0,5,216,10019.0,20.0,15.0
40.059,17,10,676,5,460,10013.0,104.0,64.0,5,216,10013.0,20.0,15.0
0.005,6,14,3799,7,509,0.0,137.0,137.0,7,3290,0.0,1448.0,972.0
40.069,17,10,676,5,460,10016.0,104.0,64.0,5,216,10016.0,20.0,15.0
0.005,6,10,2006,5,927,1.0,659.0,659.0,5,1079,1.0,811.0,811.0
1778.121,17,141,44556,72,22752,25042.0,288.0,288.0,69,21804,26147.0,288.0,288.0
0.005,6,10,2007,5,928,1.0,660.0,660.0,5,1079,1.0,811.0,811.0
0.091,6,10,1506,5,395,20.0,127.0,127.0,5,1111,17.0,843.0,843.0
0.011,6,10,1990,5,911,2.0,643.0,643.0,5,1079,2.0,811.0,811.0
0.013,6,10,1983,5,910,3.0,642.0,642.0,5,1073,3.0,805.0,805.0
0.005,6,10,2006,5,927,1.0,659.0,659.0,5,1079,1.0,811.0,811.0
0.127,6,10,1506,5,395,29.0,127.0,127.0,5,1111,31.0,843.0,843.0
353.613,6,20,2210,6,1308,12003.0,494.0,494.0,14,902,27200.0,83.0,83.0
0.006,6,10,1547,5,764,1.0,496.0,496.0,5,783,1.0,515.0,515.0
0.01,6,10,1677,5,827,2.0,559.0,559.0,5,850,2.0,582.0,582.0
0.01,6,10,1983,5,910,2.0,642.0,642.0,5,1073,2.0,805.0,805.0
240.103,6,16,4480,9,963,30012.0,238.0,166.0,7,3517,40016.0,1402.0,786.0
0.084,6,10,1506,5,395,17.0,127.0,127.0,5,1111,18.0,843.0,843.0
0.005,6,14,3742,7,452,0.0,80.0,80.0,7,3290,0.0,1448.0,972.0
0.001,17,2,136,1,60,0.0,32.0,32.0,1,76,0.0,48.0,48.0
0.008,17,2,132,1,58,0.0,30.0,30.0,1,74,0.0,46.0,46.0
0.005,6,10,1779,5,928,1.0,660.0,660.0,5,851,1.0,583.0,583.0
0.005,17,2,170,1,65,0.0,37.0,37.0,1,105,0.0,77.0,77.0
0.113,6,10,1506,5,395,24.0,127.0,127.0,5,1111,25.0,843.0,843.0
0.003,17,4,284,2,120,0.0,32.0,32.0,2,164,0.0,60.0,54.0
0.005,6,10,2007,5,928,1.0,660.0,660.0,5,1079,1.0,811.0,811.0
0.008,6,10,2006,5,927,1.0,659.0,659.0,5,1079,2.0,811.0,811.0
0.015,6,10,1972,5,910,3.0,642.0,642.0,5,1062,3.0,794.0,794.0
0.011,6,10,1983,5,910,2.0,642.0,642.0,5,1073,2.0,805.0,805.0
0.004,17,2,148,1,60,0.0,32.0,32.0,1,88,0.0,60.0,60.0
0.016,6,10,1983,5,910,4.0,642.0,642.0,5,1073,4.0,805.0,805.0
0.007,6,10,2006,5,927,1.0,659.0,659.0,5,1079,1.0,811.0,811.0
0.004,17,2,152,1,76,0.0,48.0,48.0,1,76,0.0,48.0,48.0
0.004,6,10,2000,5,927,1.0,659.0,659.0,5,1073,1.0,805.0,805.0
40.053,17,10,676,5,460,10012.0,104.0,64.0,5,216,10012.0,20.0,15.0
0.088,6,10,1506,5,395,19.0,127.0,127.0,5,1111,20.0,843.0,843.0
0.014,6,13,3735,7,497,2.0,125.0,125.0,6,3238,2.0,1470.0,1459.0
0.098,6,10,1506,5,395,19.0,127.0,127.0,5,1111,22.0,843.0,843.0
0.041,17,2,152,1,76,0.0,48.0,48.0,1,76,0.0,48.0,48.0
0.015,6,10,1972,5,910,3.0,642.0,642.0,5,1062,3.0,794.0,794.0
15.074,17,15,9238,8,6902,2149.0,1350.0,834.0,7,2336,2507.0,1350.0,305.0
40.072,17,10,676,5,460,10015.0,104.0,64.0,5,216,10017.0,20.0,15.0
40.081,17,10,676,5,460,10019.0,104.0,64.0,5,216,10019.0,20.0,15.0
0.014,6,13,3735,7,497,2.0,125.0,125.0,6,3238,2.0,1470.0,1459.0
0.041,17,2,152,1,76,0.0,48.0,48.0,1,76,0.0,48.0,48.0
0.004,17,2,180,1,66,0.0,38.0,38.0,1,114,0.0,86.0,86.0
0.005,6,10,2000,5,927,1.0,659.0,659.0,5,1073,1.0,805.0,805.0
0.013,17,2,152,1,56,0.0,28.0,28.0,1,96,0.0,68.0,68.0
0.006,6,10,1547,5,764,1.0,496.0,496.0,5,783,1.0,515.0,515.0
241.855,6,296,342780,118,17646,2067.0,2736.0,885.0,178,325134,1366.0,2804.0,1880.0
0.006,6,10,2006,5,927,1.0,659.0,659.0,5,1079,1.0,811.0,811.0
240.105,6,16,4480,9,963,30013.0,238.0,166.0,7,3517,40017.0,1402.0,786.0
0.001,17,2,180,1,66,0.0,38.0,38.0,1,114,0.0,86.0,86.0
0.005,17,2,144,1,64,0.0,36.0,36.0,1,80,0.0,52.0,52.0
308.69,17,20,1124,10,716,34283.0,48.0,43.0,10,408,34284.0,20.0,12.0
0.014,17,2,148,1,60,0.0,32.0,32.0,1,88,0.0,60.0,60.0
241.339,6,311,344273,121,17808,2011.0,2736.0,960.0,190,326465,1276.0,2916.0,1758.0
0.009,6,10,1677,5,827,2.0,559.0,559.0,5,850,2.0,582.0,582.0
0.084,6,10,1506,5,395,19.0,127.0,127.0,5,1111,16.0,843.0,843.0
0.121,6,10,1506,5,395,24.0,127.0,127.0,5,1111,24.0,843.0,843.0
0.024,6,14,3787,7,497,4.0,125.0,125.0,7,3290,4.0,1448.0,972.0
0.001,17,2,180,1,66,0.0,38.0,38.0,1,114,0.0,86.0,86.0
0.009,6,12,1926,6,1189,1.0,659.0,434.0,6,737,1.0,417.0,417.0
0.005,6,10,2006,5,927,1.0,659.0,659.0,5,1079,1.0,811.0,811.0
0.006,17,2,140,1,62,0.0,34.0,34.0,1,78,0.0,50.0,50.0
0.006,6,10,2006,5,927,1.0,659.0,659.0,5,1079,1.0,811.0,811.0
0.001,17,2,180,1,66,0.0,38.0,38.0,1,114,0.0,86.0,86.0
0.001,17,2,180,1,66,0.0,38.0,38.0,1,114,0.0,86.0,86.0
0.005,6,10,2000,5,927,1.0,659.0,659.0,5,1073,1.0,805.0,805.0
0.02,6,10,1631,5,848,5.0,580.0,580.0,5,783,5.0,515.0,515.0
0.095,6,10,1506,5,395,21.0,127.0,127.0,5,1111,19.0,843.0,843.0
0.068,6,10,1762,5,911,17.0,643.0,643.0,5,851,16.0,583.0,583.0
0.005,6,10,2006,5,927,1.0,659.0,659.0,5,1079,1.0,811.0,811.0
0.005,6,10,1547,5,764,1.0,496.0,496.0,5,783,1.0,515.0,515.0
0.001,17,2,132,1,58,0.0,30.0,30.0,1,74,0.0,46.0,46.0
0.016,17,2,194,1,59,0.0,31.0,31.0,1,135,0.0,107.0,107.0
0.01,6,10,1989,5,910,2.0,642.0,642.0,5,1079,2.0,811.0,811.0
0.004,17,2,148,1,60,0.0,32.0,32.0,1,88,0.0,60.0,60.0
0.081,6,10,1506,5,395,19.0,127.0,127.0,5,1111,18.0,843.0,843.0
0.068,6,10,1506,5,395,16.0,127.0,127.0,5,1111,16.0,843.0,843.0
0.014,6,10,1972,5,910,3.0,642.0,642.0,5,1062,3.0,794.0,794.0
0.006,6,10,2006,5,927,1.0,659.0,659.0,5,1079,1.0,811.0,811.0
0.006,6,10,1989,5,927,1.0,659.0,659.0,5,1062,1.0,794.0,794.0
0.141,6,10,1506,5,395,30.0,127.0,127.0,5,1111,33.0,843.0,843.0
0.004,6,10,2006,5,927,1.0,659.0,659.0,5,1079,1.0,811.0,811.0
0.004,6,10,1774,5,923,1.0,655.0,655.0,5,851,1.0,583.0,583.0
0.009,6,10,1983,5,910,2.0,642.0,642.0,5,1073,2.0,805.0,805.0
0.011,6,10,1677,5,827,2.0,559.0,559.0,5,850,2.0,582.0,582.0
240.386,6,48,9082,25,5906,10015.0,1368.0,458.0,23,3176,10926.0,580.0,219.0
15.22,17,17,8559,9,6403,1899.0,1350.0,683.0,8,2156,2170.0,1350.0,241.0
0.076,6,10,1506,5,395,18.0,127.0,127.0,5,1111,16.0,843.0,843.0
0.006,6,10,1689,5,839,1.0,571.0,571.0,5,850,1.0,582.0,582.0
0.012,6,10,1990,5,911,3.0,643.0,643.0,5,1079,2.0,811.0,811.0
0.07,6,10,1506,5,395,15.0,127.0,127.0,5,1111,14.0,843.0,843.0
1792.712,6,484,98693,243,87463,7407.0,421.0,368.0,241,11230,7469.0,53.0,53.0
0.11,6,10,1506,5,395,24.0,127.0,127.0,5,1111,22.0,843.0,843.0
0.004,6,10,1989,5,927,1.0,659.0,659.0,5,1062,1.0,794.0,794.0
0.011,6,10,1972,5,910,2.0,642.0,642.0,5,1062,2.0,794.0,794.0
0.005,6,10,1643,5,860,1.0,592.0,592.0,5,783,1.0,515.0,515.0
0.005,6,15,3794,8,504,0.0,80.0,80.0,7,3290,0.0,1448.0,972.0
0.011,6,10,1990,5,911,2.0,643.0,643.0,5,1079,2.0,811.0,811.0
242.522,6,299,347163,115,17484,2127.0,2736.0,885.0,184,329679,1325.0,3089.0,1839.0
0.007,6,10,2007,5,928,1.0,660.0,660.0,5,1079,1.0,811.0,811.0
0.014,6,10,1762,5,911,3.0,643.0,643.0,5,851,3.0,583.0,583.0
0.018,6,10,1972,5,910,4.0,642.0,642.0,5,1062,4.0,794.0,794.0
173.404,17,82,11824,41,2743,4334.0,44.0,38.0,41,9081,4334.0,239.0,193.0
0.004,17,4,284,2,120,0.0,32.0,32.0,2,164,1.0,60.0,54.0
0.004,6,10,2000,5,927,1.0,659.0,659.0,5,1073,1.0,805.0,805.0
0.005,6,14,3742,7,452,0.0,80.0,80.0,7,3290,0.0,1448.0,972.0
0.004,6,10,1779,5,928,1.0,660.0,660.0,5,851,1.0,583.0,583.0
47.772,6,33,6264,18,1338,2810.0,267.0,195.0,15,4926,609.0,1823.0,392.0
15.077,17,16,8988,8,6774,2149.0,1350.0,818.0,8,2214,2149.0,1350.0,248.0
0.007,6,13,3684,7,446,1.0,74.0,74.0,6,3238,1.0,1470.0,1459.0
0.079,6,10,1506,5,395,18.0,127.0,127.0,5,1111,14.0,843.0,843.0
0.01,6,13,3735,7,497,1.0,125.0,125.0,6,3238,2.0,1470.0,1459.0
300.077,6,12,1782,7,1348,50012.0,494.0,494.0,5,434,75018.0,83.0,83.0
9.037,17,6,376,5,280,2259.0,28.0,28.0,1,96,0.0,68.0,68.0
0.086,6,10,1506,5,395,19.0,127.0,127.0,5,1111,18.0,843.0,843.0
40.055,17,10,676,5,460,10012.0,104.0,64.0,5,216,10012.0,20.0,15.0
0.013,6,10,1990,5,911,3.0,643.0,643.0,5,1079,3.0,811.0,811.0
0.117,6,10,1506,5,395,23.0,127.0,127.0,5,1111,19.0,843.0,843.0
1799.887,6,289,27364,144,10000,12586.0,747.0,250.0,145,17364,12499.0,1625.0,71.0
0.011,6,10,1990,5,911,2.0,643.0,643.0,5,1079,2.0,811.0,811.0
0.01,6,10,1989,5,910,2.0,642.0,642.0,5,1079,2.0,811.0,811.0
0.131,17,2,148,1,60,0.0,32.0,32.0,1,88,0.0,60.0,60.0
0.073,6,10,1506,5,395,17.0,127.0,127.0,5,1111,15.0,843.0,843.0
0.016,6,10,1990,5,911,4.0,643.0,643.0,5,1079,4.0,811.0,811.0
0.113,6,10,1506,5,395,27.0,127.0,127.0,5,1111,26.0,843.0,843.0
0.006,6,10,1547,5,764,1.0,496.0,496.0,5,783,1.0,515.0,515.0
0.004,6,10,2007,5,928,1.0,660.0,660.0,5,1079,1.0,811.0,811.0
0.004,6,10,1779,5,928,1.0,660.0,660.0,5,851,0.0,583.0,583.0
0.008,6,13,3735,7,497,1.0,125.0,125.0,6,3238,1.0,1470.0,1459.0
66.319,6,88,85690,42,11294,1617.0,2833.0,1300.0,46,74396,1470.0,2804.0,1846.0
0.005,17,2,298,1,65,0.0,37.0,37.0,1,233,0.0,205.0,205.0
0.005,6,14,3736,7,446,0.0,74.0,74.0,7,3290,0.0,1448.0,972.0
0.005,6,10,1779,5,928,1.0,660.0,660.0,5,851,1.0,583.0,583.0
0.012,6,10,1983,5,910,2.0,642.0,642.0,5,1073,3.0,805.0,805.0
0.005,6,10,2006,5,927,1.0,659.0,659.0,5,1079,1.0,811.0,811.0
0.005,6,10,1547,5,764,1.0,496.0,496.0,5,783,1.0,515.0,515.0
0.005,6,10,1774,5,923,1.0,655.0,655.0,5,851,1.0,583.0,583.0
0.006,6,10,2006,5,927,1.0,659.0,659.0,5,1079,1.0,811.0,811.0
240.018,6,9,787,5,488,60004.0,232.0,232.0,4,299,80004.0,83.0,83.0
0.003,17,2,148,1,60,0.0,32.0,32.0,1,88,0.0,60.0,60.0
0.041,17,4,284,2,120,1.0,32.0,32.0,2,164,37.0,60.0,54.0
0.005,17,2,170,1,65,0.0,37.0,37.0,1,105,0.0,77.0,77.0
0.067,17,8,3613,4,1874,22.0,1350.0,440.0,4,1739,11.0,1350.0,406.0
0.011,6,10,1972,5,910,2.0,642.0,642.0,5,1062,2.0,794.0,794.0
0.081,6,10,1506,5,395,17.0,127.0,127.0,5,1111,19.0,843.0,843.0
0.006,6,10,1547,5,764,1.0,496.0,496.0,5,783,1.0,515.0,515.0
0.018,6,10,1989,5,910,4.0,642.0,642.0,5,1079,4.0,811.0,811.0
66.364,6,36,8430,18,1958,526.0,890.0,402.0,18,6472,3896.0,2720.0,478.0
0.004,6,10,2000,5,927,1.0,659.0,659.0,5,1073,1.0,805.0,805.0
0.005,6,10,2006,5,927,1.0,659.0,659.0,5,1079,1.0,811.0,811.0
0.004,17,2,148,1,60,0.0,32.0,32.0,1,88,0.0,60.0,60.0
0.04,17,2,136,1,60,0.0,32.0,32.0,1,76,0.0,48.0,48.0
0.01,6,10,1983,5,910,2.0,642.0,642.0,5,1073,2.0,805.0,805.0
0.005,6,10,2007,5,928,1.0,660.0,660.0,5,1079,1.0,811.0,811.0
0.004,6,10,1989,5,927,1.0,659.0,659.0,5,1062,1.0,794.0,794.0
1769.046,6,88,4703,44,2342,41139.0,27.0,27.0,44,2361,41139.0,26.0,24.0
295.098,6,342,345196,130,18306,2287.0,2736.0,825.0,212,326890,1398.0,2804.0,1603.0
0.1,6,10,1506,5,395,23.0,127.0,127.0,5,1111,23.0,843.0,843.0
0.1,6,10,1506,5,395,20.0,127.0,127.0,5,1111,22.0,843.0,843.0
15.102,17,16,9503,9,7415,1881.0,1350.0,795.0,7,2088,2511.0,1350.0,270.0
0.001,17,2,180,1,66,0.0,38.0,38.0,1,114,0.0,86.0,86.0
0.104,6,10,1506,5,395,19.0,127.0,127.0,5,1111,24.0,843.0,843.0
240.09,6,16,4480,9,963,30011.0,238.0,166.0,7,3517,40014.0,1402.0,786.0
0.068,17,8,3613,4,1874,22.0,1350.0,440.0,4,1739,11.0,1350.0,406.0
0.001,17,2,180,1,66,0.0,38.0,38.0,1,114,0.0,86.0,86.0
40.059,17,10,676,5,460,10013.0,104.0,64.0,5,216,10013.0,20.0,15.0
0.004,6,10,2000,5,927,1.0,659.0,659.0,5,1073,1.0,805.0,805.0
40.06,17,10,676,5,460,10014.0,104.0,64.0,5,216,10014.0,20.0,15.0
40.064,17,10,676,5,460,10014.0,104.0,64.0,5,216,10015.0,20.0,15.0
0.004,17,2,170,1,65,0.0,37.0,37.0,1,105,0.0,77.0,77.0
0.085,6,10,1506,5,395,19.0,127.0,127.0,5,1111,17.0,843.0,843.0
40.072,17,10,676,5,460,10015.0,104.0,64.0,5,216,10014.0,20.0,15.0
0.007,6,10,1643,5,860,1.0,592.0,592.0,5,783,1.0,515.0,515.0
0.099,6,10,1506,5,395,21.0,127.0,127.0,5,1111,21.0,843.0,843.0
0.004,6,10,1774,5,923,1.0,655.0,655.0,5,851,1.0,583.0,583.0
0.005,6,10,1689,5,839,1.0,571.0,571.0,5,850,1.0,582.0,582.0
0.001,17,2,180,1,65,0.0,37.0,37.0,1,115,0.0,87.0,87.0
0.01,6,13,3735,7,497,1.0,125.0,125.0,6,3238,1.0,1470.0,1459.0
0.006,17,2,166,1,75,0.0,47.0,47.0,1,91,0.0,63.0,63.0
0.005,6,10,2007,5,928,1.0,660.0,660.0,5,1079,1.0,811.0,811.0
0.012,6,12,1926,6,1189,2.0,659.0,434.0,6,737,2.0,417.0,417.0
0.016,6,10,1983,5,910,4.0,642.0,642.0,5,1073,3.0,805.0,805.0
0.009,6,10,1989,5,910,2.0,642.0,642.0,5,1079,2.0,811.0,811.0
0.017,17,2,198,1,91,0.0,63.0,63.0,1,107,0.0,79.0,79.0
0.005,6,10,1689,5,839,1.0,571.0,571.0,5,850,1.0,582.0,582.0
0.005,6,10,2006,5,927,1.0,659.0,659.0,5,1079,1.0,811.0,811.0
0.006,6,10,1547,5,764,1.0,496.0,496.0,5,783,1.0,515.0,515.0
0.011,6,10,1989,5,910,2.0,642.0,642.0,5,1079,2.0,811.0,811.0
0.001,17,2,180,1,66,0.0,38.0,38.0,1,114,0.0,86.0,86.0
0.082,17,9,4994,5,3252,20.0,1350.0,622.0,4,1742,12.0,1350.0,407.0
0.003,17,2,148,1,60,0.0,32.0,32.0,1,88,0.0,60.0,60.0
0.04,17,2,144,1,64,0.0,36.0,36.0,1,80,0.0,52.0,52.0
15.075,17,14,9190,8,6902,2149.0,1350.0,834.0,6,2288,3009.0,1350.0,353.0
0.001,17,2,180,1,66,0.0,38.0,38.0,1,114,0.0,86.0,86.0
0.191,6,10,1506,5,395,33.0,127.0,127.0,5,1111,44.0,843.0,843.0
300.057,6,12,1782,7,1348,50009.0,494.0,494.0,5,434,75012.0,83.0,83.0
0.012,6,10,1989,5,910,3.0,642.0,642.0,5,1079,3.0,811.0,811.0
0.01,6,10,1972,5,910,2.0,642.0,642.0,5,1062,2.0,794.0,794.0
0.005,17,2,169,1,62,0.0,34.0,34.0,1,107,0.0,79.0,79.0
0.012,6,15,3839,8,549,1.0,125.0,125.0,7,3290,1.0,1448.0,972.0
0.001,17,2,180,1,66,0.0,38.0,38.0,1,114,0.0,86.0,86.0
0.01,6,12,1926,6,1189,1.0,659.0,434.0,6,737,1.0,417.0,417.0
40.066,17,10,676,5,460,10014.0,104.0,64.0,5,216,10015.0,20.0,15.0
0.004,6,10,1779,5,928,1.0,660.0,660.0,5,851,1.0,583.0,583.0
0.005,17,2,230,1,68,0.0,40.0,40.0,1,162,0.0,134.0,134.0
0.005,17,2,170,1,65,0.0,37.0,37.0,1,105,0.0,77.0,77.0
0.016,6,10,1989,5,910,4.0,642.0,642.0,5,1079,4.0,811.0,811.0
0.121,6,10,1506,5,395,29.0,127.0,127.0,5,1111,26.0,843.0,843.0
240.082,6,16,4480,9,963,30010.0,238.0,166.0,7,3517,40013.0,1402.0,786.0
361.818,6,19,1688,15,978,25844.0,190.0,190.0,4,710,80012.0,494.0,494.0
0.154,6,10,1506,5,395,36.0,127.0,127.0,5,1111,38.0,843.0,843.0
300.268,6,16,2170,9,684,37514.0,146.0,146.0,7,1486,50017.0,419.0,398.0
0.006,6,10,1547,5,764,1.0,496.0,496.0,5,783,1.0,515.0,515.0
0.098,6,10,1506,5,395,20.0,127.0,127.0,5,1111,21.0,843.0,843.0
0.005,6,10,1779,5,928,1.0,660.0,660.0,5,851,1.0,583.0,583.0
0.006,6,10,1547,5,764,1.0,496.0,496.0,5,783,1.0,515.0,515.0
171.212,17,102,14841,51,3435,3424.0,44.0,39.0,51,11406,3424.0,279.0,195.0
0.13,17,2,412,1,61,0.0,33.0,33.0,1,351,0.0,323.0,323.0
0.004,17,4,284,2,120,0.0,32.0,32.0,2,164,1.0,60.0,54.0
0.147,6,10,1506,5,395,33.0,127.0,127.0,5,1111,32.0,843.0,843.0
0.012,6,10,1983,5,910,3.0,642.0,642.0,5,1073,3.0,805.0,805.0
0.003,17,2,136,1,60,0.0,32.0,32.0,1,76,0.0,48.0,48.0
0.089,6,10,1506,5,395,21.0,127.0,127.0,5,1111,19.0,843.0,843.0
0.07,17,8,3613,4,1874,23.0,1350.0,440.0,4,1739,11.0,1350.0,406.0
0.015,6,10,1983,5,910,3.0,642.0,642.0,5,1073,3.0,805.0,805.0
0.009,6,10,1990,5,911,2.0,643.0,643.0,5,1079,2.0,811.0,811.0
0.012,6,10,1972,5,910,3.0,642.0,642.0,5,1062,2.0,794.0,794.0
300.396,6,16,2170,9,684,37528.0,146.0,146.0,7,1486,50037.0,419.0,398.0
0.217,17,4,352,2,130,135.0,37.0,37.0,2,222,186.0,89.0,83.0
0.011,6,10,1990,5,911,2.0,643.0,643.0,5,1079,2.0,811.0,811.0
0.008,6,10,1547,5,764,1.0,496.0,496.0,5,783,1.0,515.0,515.0
0.004,6,10,2006,5,927,1.0,659.0,659.0,5,1079,1.0,811.0,811.0
0.005,17,2,170,1,65,0.0,37.0,37.0,1,105,0.0,77.0,77.0
0.005,6,10,2007,5,928,1.0,660.0,660.0,5,1079,1.0,811.0,811.0
0.096,6,10,1506,5,395,20.0,127.0,127.0,5,1111,22.0,843.0,843.0
0.005,17,2,144,1,64,0.0,36.0,36.0,1,80,0.0,52.0,52.0
0.007,6,10,1972,5,910,1.0,642.0,642.0,5,1062,1.0,794.0,794.0
0.125,6,10,1506,5,395,30.0,127.0,127.0,5,1111,30.0,843.0,843.0
289.747,6,324,345830,126,18747,2317.0,2736.0,871.0,198,327083,1470.0,2804.0,1730.0
0.04,17,2,156,1,64,0.0,36.0,36.0,1,92,0.0,64.0,64.0
0.004,17,2,148,1,60,0.0,32.0,32.0,1,88,0.0,60.0,60.0
0.078,6,44,13983,25,2555,3.0,517.0,139.0,19,11428,4.0,1402.0,745.0
172.291,17,90,12985,45,3023,3911.0,44.0,39.0,45,9962,3915.0,260.0,193.0
0.011,6,10,1989,5,910,2.0,642.0,642.0,5,1079,2.0,811.0,811.0
53.818,6,45,15405,22,9458,431.0,4080.0,1220.0,23,5947,2438.0,2667.0,385.0
0.009,6,10,1990,5,911,2.0,643.0,643.0,5,1079,2.0,811.0,811.0
10.75,17,28,4417,14,1993,818.0,268.0,114.0,14,2424,818.0,587.0,145.0
0.008,6,10,1972,5,910,1.0,642.0,642.0,5,1062,1.0,794.0,794.0
0.006,6,10,2007,5,928,1.0,660.0,660.0,5,1079,1.0,811.0,811.0
0.005,6,10,2007,5,928,1.0,660.0,660.0,5,1079,1.0,811.0,811.0
292.688,6,328,344855,130,18305,2268.0,2736.0,888.0,198,326550,1485.0,2769.0,1718.0
0.006,6,13,3747,7,509,1.0,137.0,137.0,6,3238,1.0,1470.0,1459.0
0.213,6,16,2669,8,1395,30.0,533.0,323.0,8,1274,19.0,529.0,212.0
0.005,17,2,160,1,72,0.0,44.0,44.0,1,88,0.0,60.0,60.0
0.006,6,10,2006,5,927,1.0,659.0,659.0,5,1079,1.0,811.0,811.0
11.218,17,28,4423,14,1994,850.0,269.0,114.0,14,2429,850.0,588.0,145.0
11.092,17,28,4399,14,2312,844.0,587.0,137.0,14,2087,844.0,270.0,121.0
0.008,6,10,1762,5,911,2.0,643.0,643.0,5,851,1.0,583.0,583.0
0.004,6,10,2006,5,927,1.0,659.0,659.0,5,1079,1.0,811.0,811.0
0.004,17,2,148,1,60,0.0,32.0,32.0,1,88,0.0,60.0,60.0
0.012,6,10,1972,5,910,3.0,642.0,642.0,5,1062,2.0,794.0,794.0
0.003,17,2,160,1,72,0.0,44.0,44.0,1,88,0.0,60.0,60.0
0.004,17,2,132,1,58,0.0,30.0,30.0,1,74,0.0,46.0,46.0
0.01,6,10,1677,5,827,2.0,559.0,559.0,5,850,2.0,582.0,582.0
0.008,17,2,238,1,66,0.0,38.0,38.0,1,172,0.0,144.0,144.0
240.027,6,9,787,5,488,60006.0,232.0,232.0,4,299,80008.0,83.0,83.0
0.006,17,4,284,2,120,1.0,32.0,32.0,2,164,1.0,60.0,54.0
0.004,6,10,2007,5,928,1.0,660.0,660.0,5,1079,1.0,811.0,811.0
0.119,6,10,1506,5,395,22.0,127.0,127.0,5,1111,26.0,843.0,843.0
0.013,6,10,1990,5,911,3.0,643.0,643.0,5,1079,3.0,811.0,811.0
0.006,6,10,1689,5,839,1.0,571.0,571.0,5,850,1.0,582.0,582.0
0.004,6,10,2006,5,927,1.0,659.0,659.0,5,1079,1.0,811.0,811.0
0.003,17,2,166,1,75,0.0,47.0,47.0,1,91,0.0,63.0,63.0
0.005,17,2,164,1,74,0.0,46.0,46.0,1,90,0.0,62.0,62.0
0.004,6,10,2007,5,928,1.0,660.0,660.0,5,1079,1.0,811.0,811.0
0.005,17,2,175,1,65,0.0,37.0,37.0,1,110,0.0,82.0,82.0
0.004,6,10,2006,5,927,1.0,659.0,659.0,5,1079,1.0,811.0,811.0
0.021,6,13,3735,7,497,3.0,125.0,125.0,6,3238,4.0,1470.0,1459.0
0.009,6,10,1990,5,911,2.0,643.0,643.0,5,1079,2.0,811.0,811.0
0.009,6,10,1989,5,910,2.0,642.0,642.0,5,1079,2.0,811.0,811.0
0.016,6,10,1990,5,911,3.0,643.0,643.0,5,1079,4.0,811.0,811.0
0.004,17,2,142,1,63,0.0,35.0,35.0,1,79,0.0,51.0,51.0
0.004,6,10,2006,5,927,1.0,659.0,659.0,5,1079,1.0,811.0,811.0
0.005,6,10,1774,5,923,1.0,655.0,655.0,5,851,1.0,583.0,583.0
0.146,6,10,1506,5,395,35.0,127.0,127.0,5,1111,33.0,843.0,843.0
40.053,17,10,676,5,460,10012.0,104.0,64.0,5,216,10012.0,20.0,15.0
0.009,6,10,1989,5,910,2.0,642.0,642.0,5,1079,2.0,811.0,811.0
354.049,6,19,1691,15,978,25289.0,190.0,190.0,4,713,80005.0,497.0,497.0
0.006,6,10,1547,5,764,1.0,496.0,496.0,5,783,1.0,515.0,515.0
0.225,17,4,596,2,122,152.0,33.0,33.0,2,474,184.0,323.0,209.0
0.007,6,10,1990,5,911,1.0,643.0,643.0,5,1079,1.0,811.0,811.0
0.101,6,10,1506,5,395,21.0,127.0,127.0,5,1111,22.0,843.0,843.0
0.009,6,10,1989,5,910,2.0,642.0,642.0,5,1079,2.0,811.0,811.0
0.164,6,10,1506,5,395,36.0,127.0,127.0,5,1111,37.0,843.0,843.0
40.071,17,10,676,5,460,10016.0,104.0,64.0,5,216,10016.0,20.0,15.0
0.005,6,10,2006,5,927,1.0,659.0,659.0,5,1079,1.0,811.0,811.0
0.006,6,14,3736,7,446,0.0,74.0,74.0,7,3290,0.0,1448.0,972.0
15.07,17,15,9238,8,6902,2148.0,1350.0,834.0,7,2336,2506.0,1350.0,305.0
0.006,6,13,3747,7,509,0.0,137.0,137.0,6,3238,1.0,1470.0,1459.0
0.015,6,10,1983,5,910,3.0,642.0,642.0,5,1073,3.0,805.0,805.0
0.006,17,2,164,1,74,0.0,46.0,46.0,1,90,0.0,62.0,62.0
0.004,17,2,148,1,60,0.0,32.0,32.0,1,88,0.0,60.0,60.0
0.005,6,10,1854,5,889,1.0,621.0,621.0,5,965,1.0,697.0,697.0
0.039,17,4,352,2,130,2.0,37.0,37.0,2,222,36.0,89.0,83.0
0.004,17,2,136,1,60,0.0,32.0,32.0,1,76,0.0,48.0,48.0
0.005,17,2,144,1,64,0.0,36.0,36.0,1,80,0.0,52.0,52.0
0.005,6,10,1854,5,889,1.0,621.0,621.0,5,965,1.0,697.0,697.0
9.039,17,6,376,5,280,2259.0,28.0,28.0,1,96,0.0,68.0,68.0
0.016,17,2,198,1,91,0.0,63.0,63.0,1,107,0.0,79.0,79.0
0.006,6,12,1698,6,863,1.0,327.0,271.0,6,835,1.0,515.0,515.0
0.072,6,10,1506,5,395,13.0,127.0,127.0,5,1111,16.0,843.0,843.0
0.012,6,10,1972,5,910,3.0,642.0,642.0,5,1062,2.0,794.0,794.0
0.005,17,2,144,1,64,0.0,36.0,36.0,1,80,0.0,52.0,52.0
1799.997,6,137,6590,76,3625,23996.0,39.0,39.0,61,2965,29995.0,35.0,35.0
0.003,17,2,148,1,60,0.0,32.0,32.0,1,88,0.0,60.0,60.0
0.077,6,10,1506,5,395,16.0,127.0,127.0,5,1111,15.0,843.0,843.0
0.101,6,10,1506,5,395,22.0,127.0,127.0,5,1111,19.0,843.0,843.0
0.104,6,10,1506,5,395,23.0,127.0,127.0,5,1111,22.0,843.0,843.0
0.005,6,10,1779,5,928,1.0,660.0,660.0,5,851,1.0,583.0,583.0
0.017,6,10,1677,5,827,4.0,559.0,559.0,5,850,4.0,582.0,582.0
