flowDurationMilliseconds,protocolIdentifier,TotPackets,TotBytes,packetTotalCount,octetTotalCount,averageInterarrivalTime,maxPacketSize,bytesPerPacket,reversePacketTotalCount,reverseOctetTotalCount,reverseAverageInterarrivalTime,reverseMaxPacketSize,reverseBytesPerPacket
0.09,6,10,1506,5,395,20.0,127.0,127.0,5,1111,18.0,843.0,843.0
1778.427,17,144,41760,72,22752,25048.0,288.0,288.0,72,19008,25048.0,236.0,236.0
0.018,6,10,1990,5,911,4.0,643.0,643.0,5,1079,4.0,811.0,811.0
0.006,6,12,1698,6,863,1.0,327.0,271.0,6,835,1.0,515.0,515.0
0.042,17,4,284,2,120,0.0,32.0,32.0,2,164,38.0,60.0,54.0
0.01,6,10,1989,5,910,2.0,642.0,642.0,5,1079,2.0,811.0,811.0
0.009,6,10,1983,5,910,2.0,642.0,642.0,5,1073,2.0,805.0,805.0
0.004,6,10,2006,5,927,1.0,659.0,659.0,5,1079,1.0,811.0,811.0
0.119,6,10,1506,5,395,28.0,127.0,127.0,5,1111,26.0,843.0,843.0
0.006,17,2,140,1,62,0.0,34.0,34.0,1,78,0.0,50.0,50.0
0.038,17,2,152,1,76,0.0,48.0,48.0,1,76,0.0,48.0,48.0
300.379,6,16,2170,9,684,37525.0,146.0,146.0,7,1486,50034.0,419.0,398.0
0.017,6,10,1990,5,911,4.0,643.0,643.0,5,1079,4.0,811.0,811.0
0.101,6,10,1506,5,395,22.0,127.0,127.0,5,1111,23.0,843.0,843.0
0.005,6,10,1989,5,927,1.0,659.0,659.0,5,1062,1.0,794.0,794.0
0.013,6,10,1631,5,848,3.0,580.0,580.0,5,783,3.0,515.0,515.0
0.112,6,10,1506,5,395,26.0,127.0,127.0,5,1111,26.0,843.0,843.0
0.042,17,4,284,2,120,0.0,32.0,32.0,2,164,38.0,60.0,54.0
0.005,6,13,3747,7,509,0.0,137.0,137.0,6,3238,0.0,1470.0,1459.0
0.014,6,10,1631,5,848,3.0,580.0,580.0,5,783,3.0,515.0,515.0
0.013,6,10,1983,5,910,3.0,642.0,642.0,5,1073,3.0,805.0,805.0
0.013,6,10,1989,5,910,3.0,642.0,642.0,5,1079,3.0,811.0,811.0
0.005,6,10,2007,5,928,1.0,660.0,660.0,5,1079,1.0,811.0,811.0
132.149,6,33,6264,18,1338,7773.0,267.0,195.0,15,4926,609.0,1823.0,392.0
240.089,6,16,4481,9,963,30011.0,238.0,166.0,7,3518,40014.0,1402.0,786.0
0.005,6,10,1854,5,889,1.0,621.0,621.0,5,965,1.0,697.0,697.0
0.108,6,10,1506,5,395,24.0,127.0,127.0,5,1111,23.0,843.0,843.0
0.134,17,2,80,1,32,0.0,4.0,4.0,1,48,0.0,20.0,20.0
0.012,6,10,1972,5,910,3.0,642.0,642.0,5,1062,3.0,794.0,794.0
0.041,17,2,136,1,60,0.0,32.0,32.0,1,76,0.0,48.0,48.0
0.001,17,2,180,1,66,0.0,38.0,38.0,1,114,0.0,86.0,86.0
0.01,6,10,1989,5,910,2.0,642.0,642.0,5,1079,2.0,811.0,811.0
0.006,6,10,1547,5,764,1.0,496.0,496.0,5,783,1.0,515.0,515.0
0.005,6,10,1643,5,860,1.0,592.0,592.0,5,783,1.0,515.0,515.0
0.062,6,10,1506,5,395,14.0,127.0,127.0,5,1111,14.0,843.0,843.0
40.059,17,10,676,5,460,10013.0,104.0,64.0,5,216,10013.0,20.0,15.0
0.019,6,10,1989,5,910,4.0,642.0,642.0,5,1079,4.0,811.0,811.0
0.017,6,10,1989,5,910,4.0,642.0,642.0,5,1079,4.0,811.0,811.0
0.004,6,10,2007,5,928,1.0,660.0,660.0,5,1079,1.0,811.0,811.0
0.005,6,10,2006,5,927,1.0,659.0,659.0,5,1079,1.0,811.0,811.0
0.005,17,2,170,1,65,0.0,37.0,37.0,1,105,0.0,77.0,77.0
0.015,6,10,1983,5,910,3.0,642.0,642.0,5,1073,3.0,805.0,805.0
0.101,6,10,1506,5,395,24.0,127.0,127.0,5,1111,24.0,843.0,843.0
0.003,6,10,1702,5,863,0.0,595.0,595.0,5,839,0.0,571.0,571.0
0.096,6,10,1506,5,395,23.0,127.0,127.0,5,1111,23.0,843.0,843.0
0.006,6,10,1689,5,839,1.0,571.0,571.0,5,850,1.0,582.0,582.0
241.763,6,20,4688,9,963,30220.0,238.0,166.0,11,3725,24175.0,1402.0,786.0
0.069,6,10,1506,5,395,14.0,127.0,127.0,5,1111,15.0,843.0,843.0
0.009,6,13,3735,7,497,1.0,125.0,125.0,6,3238,1.0,1470.0,1459.0
0.041,17,2,136,1,60,0.0,32.0,32.0,1,76,0.0,48.0,48.0
0.005,17,2,144,1,64,0.0,36.0,36.0,1,80,0.0,52.0,52.0
178.361,17,82,11571,41,2751,4458.0,44.0,39.0,41,8820,4458.0,239.0,187.0
0.071,17,8,3613,4,1874,23.0,1350.0,440.0,4,1739,13.0,1350.0,406.0
0.014,6,10,1989,5,910,3.0,642.0,642.0,5,1079,3.0,811.0,811.0
6.8,58,2,144,1,72,0.0,24.0,24.0,1,72,0.0,24.0,24.0
0.006,6,13,3690,7,452,1.0,80.0,80.0,6,3238,1.0,1470.0,1459.0
0.0,17,2,154,1,69,0.0,41.0,41.0,1,85,0.0,57.0,57.0
0.013,6,10,1762,5,911,3.0,643.0,643.0,5,851,3.0,583.0,583.0
0.067,6,10,1506,5,395,15.0,127.0,127.0,5,1111,16.0,843.0,843.0
0.013,17,2,166,1,75,0.0,47.0,47.0,1,91,0.0,63.0,63.0
0.103,6,10,1506,5,395,21.0,127.0,127.0,5,1111,22.0,843.0,843.0
0.041,17,2,152,1,76,0.0,48.0,48.0,1,76,0.0,48.0,48.0
280.67,6,26,6520,12,1266,25515.0,267.0,156.0,14,5254,21589.0,1400.0,781.0
368.778,6,22,2313,16,867,24585.0,195.0,195.0,6,1446,4642.0,419.0,398.0
0.004,17,2,136,1,60,0.0,32.0,32.0,1,76,0.0,48.0,48.0
0.11,6,10,1506,5,395,23.0,127.0,127.0,5,1111,25.0,843.0,843.0
285.201,6,30,6575,16,1433,19013.0,517.0,290.0,14,5142,21938.0,2380.0,1104.0
0.005,6,10,2006,5,927,1.0,659.0,659.0,5,1079,1.0,811.0,811.0
0.006,6,10,1989,5,927,1.0,659.0,659.0,5,1062,1.0,794.0,794.0
412.261,6,29,4409,12,3102,10911.0,494.0,494.0,17,1307,25766.0,83.0,83.0
40.065,17,10,676,5,460,10014.0,104.0,64.0,5,216,10015.0,20.0,15.0
0.003,17,4,284,2,120,0.0,32.0,32.0,2,164,0.0,60.0,54.0
0.005,17,2,230,1,68,0.0,40.0,40.0,1,162,0.0,134.0,134.0
0.001,17,2,180,1,65,0.0,37.0,37.0,1,115,0.0,87.0,87.0
308.52,17,20,1124,10,716,34273.0,48.0,43.0,10,408,34273.0,20.0,12.0
0.013,17,2,255,1,82,0.0,54.0,54.0,1,173,0.0,145.0,145.0
0.005,6,10,2007,5,928,1.0,660.0,660.0,5,1079,1.0,811.0,811.0
0.005,6,10,1689,5,839,1.0,571.0,571.0,5,850,1.0,582.0,582.0
0.006,6,12,1698,6,863,1.0,327.0,271.0,6,835,1.0,515.0,515.0
0.013,6,10,1989,5,910,3.0,642.0,642.0,5,1079,3.0,811.0,811.0
1790.607,6,339,38391,171,18117,10532.0,1920.0,460.0,168,20274,10722.0,1624.0,75.0
0.011,6,10,1677,5,827,2.0,559.0,559.0,5,850,2.0,582.0,582.0
0.005,17,2,166,1,75,0.0,47.0,47.0,1,91,0.0,63.0,63.0
0.003,17,2,136,1,60,0.0,32.0,32.0,1,76,0.0,48.0,48.0
0.092,6,13,3735,7,497,15.0,125.0,125.0,6,3238,18.0,1470.0,1459.0
0.004,6,10,1989,5,927,1.0,659.0,659.0,5,1062,1.0,794.0,794.0
0.005,17,2,148,1,60,0.0,32.0,32.0,1,88,0.0,60.0,60.0
0.006,6,10,1989,5,927,1.0,659.0,659.0,5,1062,1.0,794.0,794.0
300.784,6,40,14144,21,8586,15039.0,4080.0,1285.0,19,5558,479.0,2667.0,435.0
0.005,17,2,144,1,64,0.0,36.0,36.0,1,80,0.0,52.0,52.0
0.027,6,13,3735,7,497,4.0,125.0,125.0,6,3238,5.0,1470.0,1459.0
0.005,6,10,1989,5,927,1.0,659.0,659.0,5,1062,1.0,794.0,794.0
0.001,17,2,180,1,66,0.0,38.0,38.0,1,114,0.0,86.0,86.0
0.015,6,10,1972,5,910,3.0,642.0,642.0,5,1062,3.0,794.0,794.0
0.042,17,4,284,2,120,0.0,32.0,32.0,2,164,3.0,60.0,54.0
309.658,17,20,1124,10,716,34392.0,48.0,43.0,10,408,34392.0,20.0,12.0
0.156,6,10,1506,5,395,38.0,127.0,127.0,5,1111,38.0,843.0,843.0
1785.222,6,64,7347,42,4470,43542.0,1626.0,108.0,22,2877,85002.0,1113.0,82.0
0.079,6,10,1506,5,395,18.0,127.0,127.0,5,1111,15.0,843.0,843.0
0.069,6,10,1506,5,395,15.0,127.0,127.0,5,1111,16.0,843.0,843.0
0.113,6,10,1506,5,395,26.0,127.0,127.0,5,1111,23.0,843.0,843.0
0.009,6,10,1677,5,827,2.0,559.0,559.0,5,850,2.0,582.0,582.0
0.148,6,10,1506,5,395,34.0,127.0,127.0,5,1111,23.0,843.0,843.0
240.093,6,16,4482,9,963,30011.0,238.0,166.0,7,3519,40015.0,1402.0,786.0
0.005,6,10,2000,5,927,1.0,659.0,659.0,5,1073,1.0,805.0,805.0
0.086,6,10,1506,5,395,19.0,127.0,127.0,5,1111,19.0,843.0,843.0
0.01,6,10,1989,5,910,2.0,642.0,642.0,5,1079,2.0,811.0,811.0
0.001,17,2,178,1,81,0.0,53.0,53.0,1,97,0.0,69.0,69.0
0.029,6,10,1983,5,910,7.0,642.0,642.0,5,1073,7.0,805.0,805.0
0.005,17,2,214,1,75,0.0,47.0,47.0,1,139,0.0,111.0,111.0
0.005,6,10,2006,5,927,1.0,659.0,659.0,5,1079,1.0,811.0,811.0
0.005,6,10,2006,5,927,1.0,659.0,659.0,5,1079,1.0,811.0,811.0
0.004,6,10,1779,5,928,1.0,660.0,660.0,5,851,1.0,583.0,583.0
0.005,6,14,3742,7,452,0.0,80.0,80.0,7,3290,0.0,1448.0,972.0
0.077,6,10,1506,5,395,19.0,127.0,127.0,5,1111,16.0,843.0,843.0
0.004,6,10,1779,5,928,1.0,660.0,660.0,5,851,1.0,583.0,583.0
0.092,6,10,1506,5,395,19.0,127.0,127.0,5,1111,21.0,843.0,843.0
0.07,6,10,1506,5,395,16.0,127.0,127.0,5,1111,15.0,843.0,843.0
0.004,6,10,2007,5,928,1.0,660.0,660.0,5,1079,1.0,811.0,811.0
40.064,17,10,676,5,460,10015.0,104.0,64.0,5,216,10013.0,20.0,15.0
0.004,6,10,1989,5,927,1.0,659.0,659.0,5,1062,1.0,794.0,794.0
300.833,6,37,9597,20,4119,15833.0,1543.0,657.0,17,5478,540.0,2667.0,435.0
0.005,6,10,1779,5,928,1.0,660.0,660.0,5,851,1.0,583.0,583.0
0.004,6,10,2006,5,927,1.0,659.0,659.0,5,1079,1.0,811.0,811.0
0.079,6,10,1506,5,395,16.0,127.0,127.0,5,1111,17.0,843.0,843.0
0.001,17,2,166,1,75,0.0,47.0,47.0,1,91,0.0,63.0,63.0
0.004,6,14,3742,7,452,0.0,80.0,80.0,7,3290,0.0,1448.0,972.0
240.115,6,32,9583,16,7169,16007.0,2241.0,704.0,16,2414,16007.0,580.0,196.0
0.005,6,10,1689,5,839,1.0,571.0,571.0,5,850,1.0,582.0,582.0
0.008,6,10,1989,5,910,1.0,642.0,642.0,5,1079,1.0,811.0,811.0
0.005,6,10,1779,5,928,1.0,660.0,660.0,5,851,1.0,583.0,583.0
0.006,6,10,1547,5,764,1.0,496.0,496.0,5,783,1.0,515.0,515.0
0.004,6,10,2007,5,928,1.0,660.0,660.0,5,1079,1.0,811.0,811.0
0.004,6,10,2006,5,927,1.0,659.0,659.0,5,1079,1.0,811.0,811.0
0.102,6,10,1506,5,395,23.0,127.0,127.0,5,1111,21.0,843.0,843.0
0.008,6,10,1762,5,911,1.0,643.0,643.0,5,851,2.0,583.0,583.0
0.005,6,10,2007,5,928,1.0,660.0,660.0,5,1079,1.0,811.0,811.0
0.009,6,10,2007,5,928,2.0,660.0,660.0,5,1079,2.0,811.0,811.0
0.004,17,4,284,2,120,0.0,32.0,32.0,2,164,0.0,60.0,54.0
0.001,17,2,136,1,60,0.0,32.0,32.0,1,76,0.0,48.0,48.0
0.004,6,10,2007,5,928,1.0,660.0,660.0,5,1079,1.0,811.0,811.0
0.004,6,10,2007,5,928,1.0,660.0,660.0,5,1079,1.0,811.0,811.0
0.003,17,2,148,1,60,0.0,32.0,32.0,1,88,0.0,60.0,60.0
0.006,6,10,1547,5,764,1.0,496.0,496.0,5,783,1.0,515.0,515.0
0.005,6,10,1989,5,927,1.0,659.0,659.0,5,1062,1.0,794.0,794.0
0.045,17,2,136,1,60,0.0,32.0,32.0,1,76,0.0,48.0,48.0
290.118,6,385,347273,201,22025,1450.0,2736.0,888.0,184,325248,1585.0,2769.0,1867.0
0.025,6,10,1983,5,910,6.0,642.0,642.0,5,1073,6.0,805.0,805.0
0.13,17,4,284,2,120,0.0,32.0,32.0,2,164,126.0,60.0,54.0
40.074,17,10,676,5,460,10017.0,104.0,64.0,5,216,10017.0,20.0,15.0
0.011,17,2,179,1,71,0.0,43.0,43.0,1,108,0.0,80.0,80.0
0.077,6,10,1506,5,395,17.0,127.0,127.0,5,1111,16.0,843.0,843.0
176.156,17,86,12015,43,2858,4194.0,44.0,38.0,43,9157,4194.0,239.0,184.0
0.009,6,10,1677,5,827,2.0,559.0,559.0,5,850,2.0,582.0,582.0
0.012,6,10,1983,5,910,3.0,642.0,642.0,5,1073,3.0,805.0,805.0
0.005,6,10,2006,5,927,1.0,659.0,659.0,5,1079,1.0,811.0,811.0
0.006,17,2,230,1,68,0.0,40.0,40.0,1,162,0.0,134.0,134.0
0.005,17,2,175,1,65,0.0,37.0,37.0,1,110,0.0,82.0,82.0
0.117,6,10,1506,5,395,24.0,127.0,127.0,5,1111,24.0,843.0,843.0
0.006,17,2,170,1,65,0.0,37.0,37.0,1,105,0.0,77.0,77.0
0.092,6,10,1506,5,395,22.0,127.0,127.0,5,1111,20.0,843.0,843.0
10.91,17,28,4421,14,1994,830.0,269.0,114.0,14,2427,830.0,586.0,145.0
0.004,6,10,2007,5,928,1.0,660.0,660.0,5,1079,1.0,811.0,811.0
0.006,6,10,2007,5,928,1.0,660.0,660.0,5,1079,1.0,811.0,811.0
15.082,17,15,8193,8,6085,2150.0,1350.0,732.0,7,2108,2508.0,1350.0,273.0
0.11,6,10,1506,5,395,24.0,127.0,127.0,5,1111,24.0,843.0,843.0
0.005,6,10,1989,5,927,1.0,659.0,659.0,5,1062,1.0,794.0,794.0
559.887,6,58,21619,31,4024,18662.0,643.0,400.0,27,17595,19224.0,1932.0,809.0
309.035,17,20,1124,10,716,34322.0,48.0,43.0,10,408,34322.0,20.0,12.0
0.004,6,10,1702,5,863,1.0,595.0,595.0,5,839,1.0,571.0,571.0
0.016,6,13,3735,7,497,2.0,125.0,125.0,6,3238,3.0,1470.0,1459.0
0.007,17,2,170,1,65,0.0,37.0,37.0,1,105,0.0,77.0,77.0
0.01,6,10,1989,5,910,2.0,642.0,642.0,5,1079,2.0,811.0,811.0
0.007,6,10,2007,5,928,1.0,660.0,660.0,5,1079,1.0,811.0,811.0
0.004,6,10,2000,5,927,1.0,659.0,659.0,5,1073,1.0,805.0,805.0
0.001,17,2,136,1,60,0.0,32.0,32.0,1,76,0.0,48.0,48.0
0.005,6,10,1989,5,927,1.0,659.0,659.0,5,1062,1.0,794.0,794.0
0.006,6,10,1989,5,927,1.0,659.0,659.0,5,1062,1.0,794.0,794.0
0.012,6,10,1983,5,910,3.0,642.0,642.0,5,1073,3.0,805.0,805.0
0.004,6,10,2006,5,927,1.0,659.0,659.0,5,1079,1.0,811.0,811.0
0.115,17,4,596,2,122,44.0,33.0,33.0,2,474,73.0,323.0,209.0
0.012,6,13,3735,7,497,2.0,125.0,125.0,6,3238,2.0,1470.0,1459.0
0.129,17,4,352,2,130,0.0,37.0,37.0,2,222,92.0,89.0,83.0
0.007,6,10,1989,5,910,1.0,642.0,642.0,5,1079,1.0,811.0,811.0
30.328,6,19,9440,10,772,3369.0,240.0,240.0,9,8668,3787.0,1402.0,1365.0
0.005,17,2,170,1,65,0.0,37.0,37.0,1,105,0.0,77.0,77.0
0.041,6,10,1972,5,910,10.0,642.0,642.0,5,1062,10.0,794.0,794.0
0.055,17,4,284,2,120,0.0,32.0,32.0,2,164,42.0,60.0,54.0
0.005,17,2,170,1,65,0.0,37.0,37.0,1,105,0.0,77.0,77.0
11.087,17,28,4389,14,2311,844.0,586.0,137.0,14,2078,844.0,269.0,120.0
0.086,6,10,1506,5,395,20.0,127.0,127.0,5,1111,17.0,843.0,843.0
0.005,6,10,1689,5,839,1.0,571.0,571.0,5,850,1.0,582.0,582.0
0.003,17,2,136,1,60,0.0,32.0,32.0,1,76,0.0,48.0,48.0
0.008,6,10,1989,5,910,2.0,642.0,642.0,5,1079,1.0,811.0,811.0
0.009,6,12,1926,6,1189,1.0,659.0,434.0,6,737,1.0,417.0,417.0
0.005,17,2,194,1,59,0.0,31.0,31.0,1,135,0.0,107.0,107.0
0.004,6,10,2006,5,927,1.0,659.0,659.0,5,1079,1.0,811.0,811.0
0.006,17,2,179,1,71,0.0,43.0,43.0,1,108,0.0,80.0,80.0
0.058,17,2,148,1,60,0.0,32.0,32.0,1,88,0.0,60.0,60.0
0.014,6,10,1631,5,848,3.0,580.0,580.0,5,783,3.0,515.0,515.0
40.055,17,10,676,5,460,10012.0,104.0,64.0,5,216,10013.0,20.0,15.0
0.038,17,2,170,1,65,0.0,37.0,37.0,1,105,0.0,77.0,77.0
0.009,6,10,1989,5,927,2.0,659.0,659.0,5,1062,2.0,794.0,794.0
0.008,6,12,1926,6,1189,1.0,659.0,434.0,6,737,1.0,417.0,417.0
0.006,6,10,1643,5,860,1.0,592.0,592.0,5,783,1.0,515.0,515.0
166.245,17,86,11981,43,2871,3958.0,44.0,38.0,43,9110,3958.0,239.0,183.0
0.005,6,10,2006,5,927,1.0,659.0,659.0,5,1079,1.0,811.0,811.0
0.024,6,10,1972,5,910,6.0,642.0,642.0,5,1062,5.0,794.0,794.0
40.06,17,10,676,5,460,10014.0,104.0,64.0,5,216,10014.0,20.0,15.0
0.013,6,10,1989,5,910,3.0,642.0,642.0,5,1079,3.0,811.0,811.0
40.086,17,10,676,5,460,10020.0,104.0,64.0,5,216,10020.0,20.0,15.0
0.005,17,2,222,1,65,0.0,37.0,37.0,1,157,0.0,129.0,129.0
0.089,6,10,1506,5,395,19.0,127.0,127.0,5,1111,20.0,843.0,843.0
40.083,17,10,676,5,460,10017.0,104.0,64.0,5,216,10019.0,20.0,15.0
0.006,6,10,1854,5,889,1.0,621.0,621.0,5,965,1.0,697.0,697.0
0.013,6,10,1762,5,911,3.0,643.0,643.0,5,851,3.0,583.0,583.0
0.004,6,10,2006,5,927,1.0,659.0,659.0,5,1079,1.0,811.0,811.0
0.013,6,10,1989,5,910,3.0,642.0,642.0,5,1079,3.0,811.0,811.0
0.004,17,4,284,2,120,1.0,32.0,32.0,2,164,1.0,60.0,54.0
0.005,6,10,1643,5,860,1.0,592.0,592.0,5,783,1.0,515.0,515.0
0.016,6,10,1989,5,910,4.0,642.0,642.0,5,1079,3.0,811.0,811.0
0.005,17,2,140,1,62,0.0,34.0,34.0,1,78,0.0,50.0,50.0
0.005,6,10,2006,5,927,1.0,659.0,659.0,5,1079,1.0,811.0,811.0
0.005,17,2,170,1,65,0.0,37.0,37.0,1,105,0.0,77.0,77.0
0.051,6,14,3787,7,497,8.0,125.0,125.0,7,3290,8.0,1448.0,972.0
292.538,6,412,349239,199,21909,1477.0,2736.0,888.0,213,327330,1379.0,2769.0,1589.0
0.041,17,4,284,2,120,0.0,32.0,32.0,2,164,4.0,60.0,54.0
0.005,6,10,2000,5,927,1.0,659.0,659.0,5,1073,1.0,805.0,805.0
0.01,6,10,1972,5,910,2.0,642.0,642.0,5,1062,2.0,794.0,794.0
0.005,6,10,2006,5,927,1.0,659.0,659.0,5,1079,1.0,811.0,811.0
0.015,6,10,1631,5,848,3.0,580.0,580.0,5,783,3.0,515.0,515.0
0.125,6,10,1506,5,395,30.0,127.0,127.0,5,1111,30.0,843.0,843.0
0.007,6,10,1689,5,839,1.0,571.0,571.0,5,850,1.0,582.0,582.0
0.004,6,10,2000,5,927,1.0,659.0,659.0,5,1073,1.0,805.0,805.0
0.004,6,10,2007,5,928,1.0,660.0,660.0,5,1079,1.0,811.0,811.0
0.086,6,10,1506,5,395,17.0,127.0,127.0,5,1111,18.0,843.0,843.0
0.006,6,10,1547,5,764,1.0,496.0,496.0,5,783,1.0,515.0,515.0
0.013,6,10,1972,5,910,3.0,642.0,642.0,5,1062,3.0,794.0,794.0
0.005,6,10,1779,5,928,1.0,660.0,660.0,5,851,1.0,583.0,583.0
0.005,6,10,2007,5,928,1.0,660.0,660.0,5,1079,1.0,811.0,811.0
0.004,17,4,284,2,120,1.0,32.0,32.0,2,164,1.0,60.0,54.0
0.004,17,2,148,1,60,0.0,32.0,32.0,1,88,0.0,60.0,60.0
0.005,6,10,1854,5,889,1.0,621.0,621.0,5,965,1.0,697.0,697.0
0.006,17,2,140,1,62,0.0,34.0,34.0,1,78,0.0,50.0,50.0
0.01,6,10,1983,5,910,2.0,642.0,642.0,5,1073,2.0,805.0,805.0
10.828,17,28,4422,14,1994,824.0,269.0,114.0,14,2428,824.0,587.0,145.0
0.021,6,10,1983,5,910,5.0,642.0,642.0,5,1073,5.0,805.0,805.0
0.062,6,10,1506,5,395,13.0,127.0,127.0,5,1111,13.0,843.0,843.0
0.124,6,10,1506,5,395,26.0,127.0,127.0,5,1111,25.0,843.0,843.0
0.005,6,14,3799,7,509,0.0,137.0,137.0,7,3290,0.0,1448.0,972.0
0.004,17,2,136,1,60,0.0,32.0,32.0,1,76,0.0,48.0,48.0
0.012,6,10,1990,5,911,3.0,643.0,643.0,5,1079,3.0,811.0,811.0
169.284,17,82,11693,41,2752,4231.0,44.0,39.0,41,8941,4232.0,249.0,190.0
0.013,6,10,1990,5,911,3.0,643.0,643.0,5,1079,3.0,811.0,811.0
0.015,17,2,180,1,66,0.0,38.0,38.0,1,114,0.0,86.0,86.0
0.014,6,10,1631,5,848,3.0,580.0,580.0,5,783,3.0,515.0,515.0
0.166,6,10,1506,5,395,38.0,127.0,127.0,5,1111,31.0,843.0,843.0
0.012,6,10,1762,5,911,3.0,643.0,643.0,5,851,3.0,583.0,583.0
0.005,6,10,2000,5,927,1.0,659.0,659.0,5,1073,1.0,805.0,805.0
0.005,6,10,2006,5,927,1.0,659.0,659.0,5,1079,1.0,811.0,811.0
0.005,17,2,230,1,68,0.0,40.0,40.0,1,162,0.0,134.0,134.0
40.054,17,10,676,5,460,10012.0,104.0,64.0,5,216,10012.0,20.0,15.0
1777.486,17,144,45504,72,22752,25034.0,288.0,288.0,72,22752,25034.0,288.0,288.0
0.109,6,10,1506,5,395,24.0,127.0,127.0,5,1111,23.0,843.0,843.0
0.074,6,10,1506,5,395,16.0,127.0,127.0,5,1111,17.0,843.0,843.0
0.012,6,10,1972,5,910,3.0,642.0,642.0,5,1062,3.0,794.0,794.0
0.004,17,2,136,1,60,0.0,32.0,32.0,1,76,0.0,48.0,48.0
40.056,17,10,676,5,460,10013.0,104.0,64.0,5,216,10013.0,20.0,15.0
0.011,6,10,1972,5,910,2.0,642.0,642.0,5,1062,2.0,794.0,794.0
0.103,6,10,1506,5,395,23.0,127.0,127.0,5,1111,23.0,843.0,843.0
0.005,6,10,2006,5,927,1.0,659.0,659.0,5,1079,1.0,811.0,811.0
0.004,6,10,2006,5,927,1.0,659.0,659.0,5,1079,1.0,811.0,811.0
0.012,6,10,1989,5,910,3.0,642.0,642.0,5,1079,2.0,811.0,811.0
0.002,17,2,180,1,66,0.0,38.0,38.0,1,114,0.0,86.0,86.0
0.006,6,10,1547,5,764,1.0,496.0,496.0,5,783,1.0,515.0,515.0
40.074,17,10,676,5,460,10017.0,104.0,64.0,5,216,10016.0,20.0,15.0
0.07,17,8,3613,4,1874,23.0,1350.0,440.0,4,1739,12.0,1350.0,406.0
0.006,17,2,302,1,65,0.0,37.0,37.0,1,237,0.0,209.0,209.0
0.004,17,2,136,1,60,0.0,32.0,32.0,1,76,0.0,48.0,48.0
0.021,6,10,1983,5,910,5.0,642.0,642.0,5,1073,5.0,805.0,805.0
0.009,6,14,3787,7,497,1.0,125.0,125.0,7,3290,1.0,1448.0,972.0
0.009,6,10,1972,5,910,2.0,642.0,642.0,5,1062,2.0,794.0,794.0
0.134,6,10,1506,5,395,30.0,127.0,127.0,5,1111,22.0,843.0,843.0
0.121,6,10,1506,5,395,27.0,127.0,127.0,5,1111,23.0,843.0,843.0
361.844,6,21,1793,16,1030,24122.0,190.0,190.0,5,763,60009.0,462.0,247.0
0.081,6,10,1506,5,395,17.0,127.0,127.0,5,1111,18.0,843.0,843.0
40.069,17,10,676,5,460,10016.0,104.0,64.0,5,216,10016.0,20.0,15.0
0.012,6,10,1989,5,910,2.0,642.0,642.0,5,1079,2.0,811.0,811.0
0.012,6,10,1762,5,911,3.0,643.0,643.0,5,851,2.0,583.0,583.0
0.061,17,2,80,1,32,0.0,4.0,4.0,1,48,0.0,20.0,20.0
351.995,6,20,2210,6,1308,12003.0,494.0,494.0,14,902,27076.0,83.0,83.0
0.232,6,16,2669,8,1395,33.0,533.0,323.0,8,1274,21.0,529.0,212.0
0.11,6,10,1506,5,395,23.0,127.0,127.0,5,1111,25.0,843.0,843.0
0.014,6,10,1983,5,910,3.0,642.0,642.0,5,1073,3.0,805.0,805.0
11.265,17,28,4417,14,1994,853.0,269.0,114.0,14,2423,853.0,586.0,145.0
11.049,17,28,4393,14,2311,841.0,586.0,137.0,14,2082,841.0,269.0,120.0
172.353,17,74,10719,37,2466,4787.0,44.0,38.0,37,8253,4787.0,261.0,195.0
0.005,17,2,164,1,74,0.0,46.0,46.0,1,90,0.0,62.0,62.0
0.004,6,10,2006,5,927,1.0,659.0,659.0,5,1079,1.0,811.0,811.0
0.005,6,10,1689,5,839,1.0,571.0,571.0,5,850,1.0,582.0,582.0
0.01,6,10,1631,5,848,2.0,580.0,580.0,5,783,2.0,515.0,515.0
0.005,17,2,140,1,62,0.0,34.0,34.0,1,78,0.0,50.0,50.0
0.123,6,10,1506,5,395,26.0,127.0,127.0,5,1111,25.0,843.0,843.0
0.016,6,10,1972,5,910,4.0,642.0,642.0,5,1062,4.0,794.0,794.0
0.003,17,2,187,1,74,0.0,46.0,46.0,1,113,0.0,85.0,85.0
0.009,6,10,1983,5,910,2.0,642.0,642.0,5,1073,2.0,805.0,805.0
0.006,6,10,1643,5,860,1.0,592.0,592.0,5,783,1.0,515.0,515.0
0.085,6,10,1506,5,395,19.0,127.0,127.0,5,1111,15.0,843.0,843.0
0.001,17,2,180,1,66,0.0,38.0,38.0,1,114,0.0,86.0,86.0
0.068,6,10,1506,5,395,16.0,127.0,127.0,5,1111,12.0,843.0,843.0
0.006,6,10,2007,5,928,1.0,660.0,660.0,5,1079,1.0,811.0,811.0
0.021,6,10,1990,5,911,5.0,643.0,643.0,5,1079,5.0,811.0,811.0
0.004,6,10,2007,5,928,1.0,660.0,660.0,5,1079,1.0,811.0,811.0
0.005,17,2,179,1,71,0.0,43.0,43.0,1,108,0.0,80.0,80.0
0.07,6,10,1506,5,395,16.0,127.0,127.0,5,1111,16.0,843.0,843.0
0.006,17,2,140,1,62,0.0,34.0,34.0,1,78,0.0,50.0,50.0
0.072,6,10,1506,5,395,16.0,127.0,127.0,5,1111,17.0,843.0,843.0
0.059,17,2,152,1,76,0.0,48.0,48.0,1,76,0.0,48.0,48.0
0.003,17,2,136,1,60,0.0,32.0,32.0,1,76,0.0,48.0,48.0
0.004,6,10,2007,5,928,1.0,660.0,660.0,5,1079,1.0,811.0,811.0
0.005,17,2,146,1,65,0.0,37.0,37.0,1,81,0.0,53.0,53.0
0.077,6,10,1506,5,395,19.0,127.0,127.0,5,1111,16.0,843.0,843.0
0.043,17,4,284,2,120,5.0,32.0,32.0,2,164,40.0,60.0,54.0
177.14,17,80,11409,40,2673,4541.0,44.0,38.0,40,8736,4542.0,260.0,190.0
0.011,6,10,1972,5,910,2.0,642.0,642.0,5,1062,2.0,794.0,794.0
0.01,6,10,1983,5,910,2.0,642.0,642.0,5,1073,2.0,805.0,805.0
0.008,6,10,1689,5,839,2.0,571.0,571.0,5,850,1.0,582.0,582.0
0.039,17,2,144,1,64,0.0,36.0,36.0,1,80,0.0,52.0,52.0
0.077,6,10,1506,5,395,17.0,127.0,127.0,5,1111,18.0,843.0,843.0
0.006,6,10,2006,5,927,1.0,659.0,659.0,5,1079,1.0,811.0,811.0
0.013,6,10,1972,5,910,3.0,642.0,642.0,5,1062,3.0,794.0,794.0
0.003,17,2,184,1,61,0.0,33.0,33.0,1,123,0.0,95.0,95.0
0.001,17,2,180,1,66,0.0,38.0,38.0,1,114,0.0,86.0,86.0
0.006,6,10,1643,5,860,1.0,592.0,592.0,5,783,1.0,515.0,515.0
15.069,17,14,9190,8,6902,2148.0,1350.0,834.0,6,2288,3008.0,1350.0,353.0
0.005,6,10,2006,5,927,1.0,659.0,659.0,5,1079,1.0,811.0,811.0
0.081,6,10,1506,5,395,16.0,127.0,127.0,5,1111,18.0,843.0,843.0
0.006,6,10,1547,5,764,1.0,496.0,496.0,5,783,1.0,515.0,515.0
0.005,17,2,142,1,63,0.0,35.0,35.0,1,79,0.0,51.0,51.0
0.011,6,10,1972,5,910,2.0,642.0,642.0,5,1062,2.0,794.0,794.0
300.405,6,16,2170,9,684,37529.0,146.0,146.0,7,1486,50039.0,419.0,398.0
0.005,17,2,154,1,69,0.0,41.0,41.0,1,85,0.0,57.0,57.0
0.804,6,25,5555,12,1445,61.0,267.0,136.0,13,4110,56.0,1414.0,597.0
0.071,17,2,170,1,65,0.0,37.0,37.0,1,105,0.0,77.0,77.0
1.012,6,12,3142,6,2099,152.0,1328.0,923.0,6,1043,152.0,791.0,791.0
0.004,6,10,1774,5,923,1.0,655.0,655.0,5,851,1.0,583.0,583.0
0.08,6,10,1506,5,395,16.0,127.0,127.0,5,1111,17.0,843.0,843.0
0.003,17,2,136,1,60,0.0,32.0,32.0,1,76,0.0,48.0,48.0
0.005,6,10,2006,5,927,1.0,659.0,659.0,5,1079,1.0,811.0,811.0
0.004,6,10,1702,5,863,1.0,595.0,595.0,5,839,1.0,571.0,571.0
0.006,17,2,170,1,65,0.0,37.0,37.0,1,105,0.0,77.0,77.0
40.086,17,10,676,5,460,10018.0,104.0,64.0,5,216,10017.0,20.0,15.0
0.009,6,10,1989,5,910,2.0,642.0,642.0,5,1079,2.0,811.0,811.0
0.011,6,10,1972,5,910,2.0,642.0,642.0,5,1062,2.0,794.0,794.0
0.005,6,10,2006,5,927,1.0,659.0,659.0,5,1079,1.0,811.0,811.0
6.427,6,11,2084,6,1690,1236.0,1438.0,1438.0,5,394,1542.0,182.0,182.0
0.012,6,10,1989,5,910,3.0,642.0,642.0,5,1079,3.0,811.0,811.0
0.009,6,10,1972,5,910,2.0,642.0,642.0,5,1062,2.0,794.0,794.0
0.004,17,2,136,1,60,0.0,32.0,32.0,1,76,0.0,48.0,48.0
0.007,6,10,2000,5,927,1.0,659.0,659.0,5,1073,1.0,805.0,805.0
40.072,17,10,676,5,460,10017.0,104.0,64.0,5,216,10017.0,20.0,15.0
0.004,6,10,1774,5,923,1.0,655.0,655.0,5,851,1.0,583.0,583.0
0.01,6,10,1989,5,910,2.0,642.0,642.0,5,1079,2.0,811.0,811.0
0.009,6,10,1983,5,910,2.0,642.0,642.0,5,1073,2.0,805.0,805.0
0.005,17,2,293,1,73,0.0,45.0,45.0,1,220,0.0,192.0,192.0
0.007,17,2,179,1,71,0.0,43.0,43.0,1,108,0.0,80.0,80.0
0.006,6,10,1854,5,889,1.0,621.0,621.0,5,965,1.0,697.0,697.0
0.006,6,10,1643,5,860,1.0,592.0,592.0,5,783,1.0,515.0,515.0
0.004,6,10,2000,5,927,1.0,659.0,659.0,5,1073,1.0,805.0,805.0
0.002,17,2,180,1,66,0.0,38.0,38.0,1,114,0.0,86.0,86.0
0.069,17,8,3613,4,1874,23.0,1350.0,440.0,4,1739,11.0,1350.0,406.0
0.005,6,10,2007,5,928,1.0,660.0,660.0,5,1079,1.0,811.0,811.0
40.065,17,10,676,5,460,10015.0,104.0,64.0,5,216,10015.0,20.0,15.0
0.005,6,10,1989,5,927,1.0,659.0,659.0,5,1062,1.0,794.0,794.0
0.014,6,10,1983,5,910,3.0,642.0,642.0,5,1073,3.0,805.0,805.0
0.003,17,2,136,1,60,0.0,32.0,32.0,1,76,0.0,48.0,48.0
0.006,6,10,1547,5,764,1.0,496.0,496.0,5,783,1.0,515.0,515.0
0.018,6,10,1983,5,910,4.0,642.0,642.0,5,1073,4.0,805.0,805.0
0.004,6,10,1774,5,923,1.0,655.0,655.0,5,851,1.0,583.0,583.0
0.012,6,10,1990,5,911,2.0,643.0,643.0,5,1079,2.0,811.0,811.0
0.004,17,2,187,1,74,0.0,46.0,46.0,1,113,0.0,85.0,85.0
1777.945,17,144,45504,72,22752,25041.0,288.0,288.0,72,22752,25041.0,288.0,288.0
0.005,6,10,1774,5,923,1.0,655.0,655.0,5,851,1.0,583.0,583.0
0.084,6,10,1506,5,395,18.0,127.0,127.0,5,1111,18.0,843.0,843.0
0.008,6,10,1972,5,910,1.0,642.0,642.0,5,1062,2.0,794.0,794.0
0.003,17,2,148,1,60,0.0,32.0,32.0,1,88,0.0,60.0,60.0
0.014,6,10,1983,5,910,3.0,642.0,642.0,5,1073,3.0,805.0,805.0
0.012,6,10,1989,5,910,3.0,642.0,642.0,5,1079,2.0,811.0,811.0
0.021,6,10,1990,5,911,5.0,643.0,643.0,5,1079,5.0,811.0,811.0
0.011,6,10,1762,5,911,2.0,643.0,643.0,5,851,2.0,583.0,583.0
0.016,6,10,1989,5,910,4.0,642.0,642.0,5,1079,4.0,811.0,811.0
0.301,17,43,22116,23,18477,13.0,1350.0,775.0,20,3639,12.0,1350.0,153.0
0.004,17,4,284,2,120,0.0,32.0,32.0,2,164,0.0,60.0,54.0
0.012,6,10,1983,5,910,3.0,642.0,642.0,5,1073,2.0,805.0,805.0
0.015,6,10,1990,5,911,3.0,643.0,643.0,5,1079,3.0,811.0,811.0
0.013,6,10,1989,5,910,3.0,642.0,642.0,5,1079,3.0,811.0,811.0
0.006,6,10,2006,5,927,1.0,659.0,659.0,5,1079,1.0,811.0,811.0
0.012,6,10,1677,5,827,3.0,559.0,559.0,5,850,2.0,582.0,582.0
0.071,17,2,182,1,65,0.0,37.0,37.0,1,117,0.0,89.0,89.0
0.081,6,10,1506,5,395,19.0,127.0,127.0,5,1111,19.0,843.0,843.0
0.003,17,2,136,1,60,0.0,32.0,32.0,1,76,0.0,48.0,48.0
40.064,17,10,676,5,460,10014.0,104.0,64.0,5,216,10015.0,20.0,15.0
0.015,6,10,1989,5,910,3.0,642.0,642.0,5,1079,3.0,811.0,811.0
0.085,6,10,1506,5,395,16.0,127.0,127.0,5,1111,20.0,843.0,843.0
0.003,17,2,148,1,60,0.0,32.0,32.0,1,88,0.0,60.0,60.0
0.01,6,10,1983,5,910,2.0,642.0,642.0,5,1073,2.0,805.0,805.0
0.015,6,10,1972,5,910,3.0,642.0,642.0,5,1062,3.0,794.0,794.0
1771.626,17,120,11460,60,5460,30027.0,63.0,63.0,60,6000,30027.0,72.0,72.0
0.005,6,13,3690,7,452,0.0,80.0,80.0,6,3238,1.0,1470.0,1459.0
0.006,17,2,261,1,74,0.0,46.0,46.0,1,187,0.0,159.0,159.0
1793.7,6,310,45621,131,25673,13796.0,1939.0,203.0,179,19948,10076.0,1360.0,150.0
0.005,6,10,1989,5,927,1.0,659.0,659.0,5,1062,1.0,794.0,794.0
0.187,6,24,6480,12,2337,15.0,746.0,341.0,12,4143,15.0,1324.0,585.0
0.022,6,10,1990,5,911,5.0,643.0,643.0,5,1079,5.0,811.0,811.0
0.089,6,10,1506,5,395,19.0,127.0,127.0,5,1111,19.0,843.0,843.0
300.282,6,16,2170,9,684,37514.0,146.0,146.0,7,1486,50018.0,419.0,398.0
0.006,6,10,2006,5,927,1.0,659.0,659.0,5,1079,1.0,811.0,811.0
0.007,6,10,1702,5,863,1.0,595.0,595.0,5,839,1.0,571.0,571.0
0.129,17,2,80,1,32,0.0,4.0,4.0,1,48,0.0,20.0,20.0
0.006,6,10,1547,5,764,1.0,496.0,496.0,5,783,1.0,515.0,515.0
0.124,6,10,1506,5,395,28.0,127.0,127.0,5,1111,29.0,843.0,843.0
0.004,17,2,136,1,60,0.0,32.0,32.0,1,76,0.0,48.0,48.0
0.046,17,2,170,1,65,0.0,37.0,37.0,1,105,0.0,77.0,77.0
0.013,6,10,1990,5,911,3.0,643.0,643.0,5,1079,3.0,811.0,811.0
0.1,6,10,1506,5,395,23.0,127.0,127.0,5,1111,15.0,843.0,843.0
0.006,17,2,170,1,65,0.0,37.0,37.0,1,105,0.0,77.0,77.0
0.005,6,10,2000,5,927,1.0,659.0,659.0,5,1073,1.0,805.0,805.0
0.014,6,10,1989,5,910,3.0,642.0,642.0,5,1079,3.0,811.0,811.0
0.005,6,10,1689,5,839,1.0,571.0,571.0,5,850,1.0,582.0,582.0
0.07,6,10,1506,5,395,14.0,127.0,127.0,5,1111,14.0,843.0,843.0
0.003,17,2,136,1,60,0.0,32.0,32.0,1,76,0.0,48.0,48.0
0.182,6,10,1506,5,395,38.0,127.0,127.0,5,1111,40.0,843.0,843.0
0.14,6,10,1506,5,395,32.0,127.0,127.0,5,1111,32.0,843.0,843.0
0.006,6,10,1689,5,839,1.0,571.0,571.0,5,850,1.0,582.0,582.0
0.008,6,10,1983,5,910,2.0,642.0,642.0,5,1073,1.0,805.0,805.0
0.004,6,10,1774,5,923,1.0,655.0,655.0,5,851,1.0,583.0,583.0
0.008,6,10,1972,5,910,2.0,642.0,642.0,5,1062,1.0,794.0,794.0
0.005,6,10,2006,5,927,1.0,659.0,659.0,5,1079,1.0,811.0,811.0
0.017,6,10,1677,5,827,4.0,559.0,559.0,5,850,4.0,582.0,582.0
368.993,6,22,2313,16,867,24599.0,195.0,195.0,6,1446,4696.0,419.0,398.0
0.004,17,2,412,1,61,0.0,33.0,33.0,1,351,0.0,323.0,323.0
0.006,17,2,230,1,68,0.0,40.0,40.0,1,162,0.0,134.0,134.0
0.11,6,10,1506,5,395,23.0,127.0,127.0,5,1111,23.0,843.0,843.0
0.029,6,20,9974,11,704,2.0,124.0,124.0,9,9270,3.0,2896.0,1758.0
240.016,6,9,787,5,488,60004.0,232.0,232.0,4,299,80004.0,83.0,83.0
0.006,6,10,1689,5,839,1.0,571.0,571.0,5,850,1.0,582.0,582.0
0.007,17,2,230,1,68,0.0,40.0,40.0,1,162,0.0,134.0,134.0
0.016,6,10,1989,5,910,4.0,642.0,642.0,5,1079,4.0,811.0,811.0
0.012,6,10,1972,5,910,3.0,642.0,642.0,5,1062,3.0,794.0,794.0
0.093,6,10,1506,5,395,20.0,127.0,127.0,5,1111,19.0,843.0,843.0
0.014,6,10,1762,5,911,3.0,643.0,643.0,5,851,3.0,583.0,583.0
0.007,6,10,2007,5,928,1.0,660.0,660.0,5,1079,1.0,811.0,811.0
0.004,6,10,1702,5,863,1.0,595.0,595.0,5,839,0.0,571.0,571.0
240.108,6,16,4481,9,963,30013.0,238.0,166.0,7,3518,40017.0,1402.0,786.0
0.037,17,4,284,2,120,0.0,32.0,32.0,2,164,34.0,60.0,54.0
0.006,6,10,2007,5,928,1.0,660.0,660.0,5,1079,1.0,811.0,811.0
0.003,17,2,136,1,60,0.0,32.0,32.0,1,76,0.0,48.0,48.0
0.016,17,2,198,1,91,0.0,63.0,63.0,1,107,0.0,79.0,79.0
0.014,6,10,1631,5,848,3.0,580.0,580.0,5,783,3.0,515.0,515.0
0.011,6,10,1983,5,910,2.0,642.0,642.0,5,1073,2.0,805.0,805.0
0.085,6,10,1506,5,395,16.0,127.0,127.0,5,1111,20.0,843.0,843.0
1769.068,17,92,8096,46,4048,39312.0,60.0,60.0,46,4048,39312.0,60.0,60.0
352.681,6,20,2210,6,1308,12004.0,494.0,494.0,14,902,27129.0,83.0,83.0
0.011,6,10,1989,5,910,2.0,642.0,642.0,5,1079,2.0,811.0,811.0
11.175,17,28,4419,14,1995,847.0,270.0,114.0,14,2424,847.0,587.0,145.0
0.004,17,2,186,1,61,0.0,33.0,33.0,1,125,0.0,97.0,97.0
0.132,6,10,1506,5,395,30.0,127.0,127.0,5,1111,27.0,843.0,843.0
0.092,6,10,1506,5,395,20.0,127.0,127.0,5,1111,19.0,843.0,843.0
0.01,6,10,1989,5,910,2.0,642.0,642.0,5,1079,2.0,811.0,811.0
0.113,6,10,1506,5,395,26.0,127.0,127.0,5,1111,27.0,843.0,843.0
0.005,6,10,2006,5,927,1.0,659.0,659.0,5,1079,1.0,811.0,811.0
0.012,6,10,1989,5,910,3.0,642.0,642.0,5,1079,3.0,811.0,811.0
40.09,17,10,676,5,460,10017.0,104.0,64.0,5,216,10020.0,20.0,15.0
0.216,6,16,2670,8,1396,30.0,533.0,324.0,8,1274,19.0,529.0,212.0
0.005,6,10,2006,5,927,1.0,659.0,659.0,5,1079,1.0,811.0,811.0
0.004,17,2,136,1,60,0.0,32.0,32.0,1,76,0.0,48.0,48.0
0.011,6,13,3735,7,497,1.0,125.0,125.0,6,3238,2.0,1470.0,1459.0
0.004,6,10,2006,5,927,1.0,659.0,659.0,5,1079,1.0,811.0,811.0
320.901,17,20,1124,10,716,35644.0,48.0,43.0,10,408,35644.0,20.0,12.0
240.128,6,38,5178,19,2365,13340.0,581.0,195.0,19,2813,13340.0,564.0,259.0
0.004,6,10,2006,5,927,1.0,659.0,659.0,5,1079,1.0,811.0,811.0
0.006,6,10,1547,5,764,1.0,496.0,496.0,5,783,1.0,515.0,515.0
0.214,6,16,2777,8,1395,30.0,533.0,323.0,8,1382,19.0,529.0,239.0
0.004,6,10,1702,5,863,1.0,595.0,595.0,5,839,0.0,571.0,571.0
0.006,6,10,1547,5,764,1.0,496.0,496.0,5,783,1.0,515.0,515.0
11.141,17,28,4418,14,1994,844.0,269.0,114.0,14,2424,844.0,587.0,145.0
0.013,6,10,1990,5,911,3.0,643.0,643.0,5,1079,3.0,811.0,811.0
0.019,6,10,1989,5,910,4.0,642.0,642.0,5,1079,4.0,811.0,811.0
0.239,6,16,2669,8,1395,34.0,533.0,323.0,8,1274,21.0,529.0,212.0
0.005,6,10,1989,5,927,1.0,659.0,659.0,5,1062,1.0,794.0,794.0
0.005,6,10,1989,5,927,1.0,659.0,659.0,5,1062,1.0,794.0,794.0
40.082,17,10,676,5,460,10017.0,104.0,64.0,5,216,10019.0,20.0,15.0
0.004,17,2,213,1,69,0.0,41.0,41.0,1,144,0.0,116.0,116.0
0.005,6,10,2007,5,928,1.0,660.0,660.0,5,1079,1.0,811.0,811.0
0.009,6,13,3735,7,497,1.0,125.0,125.0,6,3238,1.0,1470.0,1459.0
0.103,6,10,1506,5,395,25.0,127.0,127.0,5,1111,22.0,843.0,843.0
0.02,6,10,1990,5,911,4.0,643.0,643.0,5,1079,4.0,811.0,811.0
0.22,6,10,1506,5,395,50.0,127.0,127.0,5,1111,49.0,843.0,843.0
40.008,17,10,676,5,460,9998.0,104.0,64.0,5,216,10001.0,20.0,15.0
0.005,17,2,136,1,60,0.0,32.0,32.0,1,76,0.0,48.0,48.0
240.459,6,34,8133,18,2945,14144.0,1220.0,248.0,16,5188,16030.0,1666.0,484.0
0.001,17,2,132,1,58,0.0,30.0,30.0,1,74,0.0,46.0,46.0
1770.388,6,82,4318,41,2159,44258.0,27.0,27.0,41,2159,44258.0,27.0,27.0
0.004,6,10,1989,5,927,1.0,659.0,659.0,5,1062,1.0,794.0,794.0
0.01,6,10,1972,5,910,2.0,642.0,642.0,5,1062,2.0,794.0,794.0
0.257,17,2,152,1,76,0.0,48.0,48.0,1,76,0.0,48.0,48.0
0.082,6,10,1506,5,395,16.0,127.0,127.0,5,1111,19.0,843.0,843.0
0.005,17,2,179,1,71,0.0,43.0,43.0,1,108,0.0,80.0,80.0
369.913,6,22,2313,16,867,24660.0,195.0,195.0,6,1446,4643.0,419.0,398.0
293.28,6,383,348220,185,21190,1593.0,2736.0,889.0,198,327030,1488.0,3084.0,1721.0
0.004,6,10,2006,5,927,1.0,659.0,659.0,5,1079,1.0,811.0,811.0
40.076,17,10,676,5,460,10018.0,104.0,64.0,5,216,10016.0,20.0,15.0
0.013,6,10,1983,5,910,3.0,642.0,642.0,5,1073,3.0,805.0,805.0
0.085,6,10,1506,5,395,19.0,127.0,127.0,5,1111,20.0,843.0,843.0
0.01,6,10,1677,5,827,2.0,559.0,559.0,5,850,2.0,582.0,582.0
0.004,6,13,3747,7,509,0.0,137.0,137.0,6,3238,0.0,1470.0,1459.0
0.155,6,10,1506,5,395,37.0,127.0,127.0,5,1111,33.0,843.0,843.0
40.066,17,10,676,5,460,10011.0,104.0,64.0,5,216,10013.0,20.0,15.0
40.078,17,10,676,5,460,10017.0,104.0,64.0,5,216,10018.0,20.0,15.0
0.099,6,10,1506,5,395,21.0,127.0,127.0,5,1111,23.0,843.0,843.0
0.003,17,2,136,1,60,0.0,32.0,32.0,1,76,0.0,48.0,48.0
0.005,17,2,140,1,62,0.0,34.0,34.0,1,78,0.0,50.0,50.0
40.067,17,10,676,5,460,10013.0,104.0,64.0,5,216,10016.0,20.0,15.0
0.113,6,10,1506,5,395,27.0,127.0,127.0,5,1111,25.0,843.0,843.0
0.017,6,10,1989,5,910,4.0,642.0,642.0,5,1079,4.0,811.0,811.0
0.006,6,10,2000,5,927,1.0,659.0,659.0,5,1073,1.0,805.0,805.0
0.005,17,2,170,1,65,0.0,37.0,37.0,1,105,0.0,77.0,77.0
0.018,6,10,1983,5,910,4.0,642.0,642.0,5,1073,4.0,805.0,805.0
354.014,6,21,1795,16,1030,23600.0,190.0,190.0,5,765,60003.0,464.0,248.0
0.089,6,10,1506,5,395,16.0,127.0,127.0,5,1111,20.0,843.0,843.0
0.077,6,10,1506,5,395,18.0,127.0,127.0,5,1111,17.0,843.0,843.0
0.072,17,4,284,2,120,0.0,32.0,32.0,2,164,32.0,60.0,54.0
0.014,6,10,1983,5,910,3.0,642.0,642.0,5,1073,3.0,805.0,805.0
0.006,6,10,1689,5,839,1.0,571.0,571.0,5,850,1.0,582.0,582.0
0.039,6,10,1677,5,827,9.0,559.0,559.0,5,850,9.0,582.0,582.0
173.139,17,76,10718,38,2548,4679.0,44.0,39.0,38,8170,4679.0,239.0,187.0
0.01,6,13,3735,7,497,1.0,125.0,125.0,6,3238,2.0,1470.0,1459.0
40.08,17,10,676,5,460,10017.0,104.0,64.0,5,216,10019.0,20.0,15.0
15.08,17,15,8193,8,6064,2150.0,1350.0,730.0,7,2129,2508.0,1350.0,276.0
0.012,6,10,1631,5,848,2.0,580.0,580.0,5,783,3.0,515.0,515.0
0.005,6,10,1774,5,923,1.0,655.0,655.0,5,851,1.0,583.0,583.0
0.035,6,13,3735,7,497,5.0,125.0,125.0,6,3238,6.0,1470.0,1459.0
0.018,6,10,1631,5,848,4.0,580.0,580.0,5,783,4.0,515.0,515.0
0.005,17,2,180,1,58,0.0,30.0,30.0,1,122,0.0,94.0,94.0
0.057,6,10,1506,5,395,13.0,127.0,127.0,5,1111,12.0,843.0,843.0
180.488,6,53,18761,30,4594,6223.0,1054.0,252.0,23,14167,8203.0,2804.0,926.0
0.005,6,10,2007,5,928,1.0,660.0,660.0,5,1079,1.0,811.0,811.0
0.014,6,10,1990,5,911,3.0,643.0,643.0,5,1079,3.0,811.0,811.0
0.011,6,10,1983,5,910,2.0,642.0,642.0,5,1073,2.0,805.0,805.0
0.094,6,10,1506,5,395,21.0,127.0,127.0,5,1111,20.0,843.0,843.0
0.004,6,10,1702,5,863,1.0,595.0,595.0,5,839,0.0,571.0,571.0
0.075,6,10,1506,5,395,17.0,127.0,127.0,5,1111,18.0,843.0,843.0
240.09,6,16,4481,9,963,30011.0,238.0,166.0,7,3518,40014.0,1402.0,786.0
0.004,6,10,2007,5,928,1.0,660.0,660.0,5,1079,1.0,811.0,811.0
0.009,6,10,1990,5,911,2.0,643.0,643.0,5,1079,2.0,811.0,811.0
0.0,17,2,180,1,66,0.0,38.0,38.0,1,114,0.0,86.0,86.0
0.006,17,2,214,1,75,0.0,47.0,47.0,1,139,0.0,111.0,111.0
1742.23,6,312,98330,191,86698,9169.0,1402.0,673.0,121,11632,14518.0,452.0,71.0
0.005,17,2,230,1,68,0.0,40.0,40.0,1,162,0.0,134.0,134.0
0.216,6,16,2669,8,1395,30.0,533.0,323.0,8,1274,19.0,529.0,212.0
0.044,17,2,152,1,76,0.0,48.0,48.0,1,76,0.0,48.0,48.0
0.004,6,10,1989,5,927,1.0,659.0,659.0,5,1062,1.0,794.0,794.0
0.012,6,10,1972,5,910,3.0,642.0,642.0,5,1062,2.0,794.0,794.0
0.017,6,10,1989,5,910,4.0,642.0,642.0,5,1079,4.0,811.0,811.0
0.003,17,4,284,2,120,0.0,32.0,32.0,2,164,1.0,60.0,54.0
0.004,6,10,2007,5,928,1.0,660.0,660.0,5,1079,1.0,811.0,811.0
0.006,17,2,166,1,75,0.0,47.0,47.0,1,91,0.0,63.0,63.0
0.065,17,2,138,1,61,0.0,33.0,33.0,1,77,0.0,49.0,49.0
0.006,6,10,2000,5,927,1.0,659.0,659.0,5,1073,1.0,805.0,805.0
10.817,17,26,4101,13,1846,892.0,269.0,114.0,13,2255,892.0,586.0,145.0
0.001,17,2,180,1,66,0.0,38.0,38.0,1,114,0.0,86.0,86.0
0.091,6,10,1506,5,395,20.0,127.0,127.0,5,1111,18.0,843.0,843.0
0.101,6,10,1506,5,395,24.0,127.0,127.0,5,1111,22.0,843.0,843.0
0.005,17,2,180,1,58,0.0,30.0,30.0,1,122,0.0,94.0,94.0
0.08,6,10,1506,5,395,16.0,127.0,127.0,5,1111,18.0,843.0,843.0
0.122,6,10,1506,5,395,24.0,127.0,127.0,5,1111,24.0,843.0,843.0
0.111,6,10,1506,5,395,26.0,127.0,127.0,5,1111,24.0,843.0,843.0
0.005,6,10,1774,5,923,1.0,655.0,655.0,5,851,1.0,583.0,583.0
308.472,17,20,1124,10,716,34260.0,48.0,43.0,10,408,34260.0,20.0,12.0
0.005,6,10,2006,5,927,1.0,659.0,659.0,5,1079,1.0,811.0,811.0
0.108,6,10,1506,5,395,21.0,127.0,127.0,5,1111,23.0,843.0,843.0
0.006,6,10,1779,5,928,1.0,660.0,660.0,5,851,1.0,583.0,583.0
240.009,6,9,787,5,488,60002.0,232.0,232.0,4,299,80002.0,83.0,83.0
0.005,6,14,3742,8,504,0.0,80.0,80.0,6,3238,0.0,1470.0,1459.0
0.038,17,2,136,1,60,0.0,32.0,32.0,1,76,0.0,48.0,48.0
11.214,17,28,4424,14,1995,850.0,270.0,114.0,14,2429,850.0,588.0,145.0
1792.257,6,576,190967,296,164351,6075.0,2883.0,925.0,280,26616,6423.0,355.0,114.0
0.017,6,10,1631,5,848,4.0,580.0,580.0,5,783,4.0,515.0,515.0
0.011,6,10,1989,5,910,2.0,642.0,642.0,5,1079,2.0,811.0,811.0
15.074,17,15,9238,8,6902,2149.0,1350.0,834.0,7,2336,2507.0,1350.0,305.0
0.078,6,10,1506,5,395,17.0,127.0,127.0,5,1111,17.0,843.0,843.0
0.004,17,2,148,1,60,0.0,32.0,32.0,1,88,0.0,60.0,60.0
0.004,6,10,2007,5,928,1.0,660.0,660.0,5,1079,1.0,811.0,811.0
40.05,17,10,676,5,460,10011.0,104.0,64.0,5,216,10011.0,20.0,15.0
242.666,6,294,342620,112,17337,2186.0,2736.0,959.0,182,325283,1340.0,2804.0,1836.0
0.084,6,10,1506,5,395,18.0,127.0,127.0,5,1111,19.0,843.0,843.0
0.007,17,2,179,1,71,0.0,43.0,43.0,1,108,0.0,80.0,80.0
0.108,6,10,1506,5,395,24.0,127.0,127.0,5,1111,23.0,843.0,843.0
0.007,6,10,1854,5,889,1.0,621.0,621.0,5,965,1.0,697.0,697.0
0.085,6,10,1506,5,395,19.0,127.0,127.0,5,1111,20.0,843.0,843.0
0.011,6,10,1972,5,910,2.0,642.0,642.0,5,1062,2.0,794.0,794.0
0.003,17,2,148,1,60,0.0,32.0,32.0,1,88,0.0,60.0,60.0
0.016,6,10,1990,5,911,3.0,643.0,643.0,5,1079,3.0,811.0,811.0
0.079,6,10,1506,5,395,17.0,127.0,127.0,5,1111,17.0,843.0,843.0
0.006,6,10,2000,5,927,1.0,659.0,659.0,5,1073,1.0,805.0,805.0
0.01,6,10,1990,5,911,2.0,643.0,643.0,5,1079,2.0,811.0,811.0
0.203,6,16,2669,8,1395,29.0,533.0,323.0,8,1274,18.0,529.0,212.0
0.868,6,43,29811,21,22958,43.0,2720.0,1840.0,22,6853,32.0,2720.0,851.0
40.063,17,10,676,5,460,10014.0,104.0,64.0,5,216,10014.0,20.0,15.0
0.006,6,10,1547,5,764,1.0,496.0,496.0,5,783,1.0,515.0,515.0
0.012,6,10,1989,5,910,3.0,642.0,642.0,5,1079,3.0,811.0,811.0
0.017,6,10,1677,5,827,4.0,559.0,559.0,5,850,4.0,582.0,582.0
0.107,6,10,1506,5,395,23.0,127.0,127.0,5,1111,26.0,843.0,843.0
0.004,6,10,2006,5,927,1.0,659.0,659.0,5,1079,1.0,811.0,811.0
0.067,6,10,1506,5,395,15.0,127.0,127.0,5,1111,14.0,843.0,843.0
0.088,6,10,1506,5,395,20.0,127.0,127.0,5,1111,20.0,843.0,843.0
0.073,17,2,170,1,65,0.0,37.0,37.0,1,105,0.0,77.0,77.0
0.042,17,2,136,1,60,0.0,32.0,32.0,1,76,0.0,48.0,48.0
0.001,17,2,166,1,75,0.0,47.0,47.0,1,91,0.0,63.0,63.0
0.014,6,10,1677,5,827,3.0,559.0,559.0,5,850,3.0,582.0,582.0
0.004,17,2,136,1,60,0.0,32.0,32.0,1,76,0.0,48.0,48.0
0.004,6,10,2007,5,928,1.0,660.0,660.0,5,1079,1.0,811.0,811.0
0.005,6,10,1643,5,860,1.0,592.0,592.0,5,783,1.0,515.0,515.0
0.006,6,10,1989,5,927,1.0,659.0,659.0,5,1062,1.0,794.0,794.0
0.01,6,10,1989,5,910,2.0,642.0,642.0,5,1079,2.0,811.0,811.0
0.005,6,10,2007,5,928,1.0,660.0,660.0,5,1079,1.0,811.0,811.0
0.006,6,10,2006,5,927,1.0,659.0,659.0,5,1079,1.0,811.0,811.0
1.308,6,18,8781,10,2994,145.0,1241.0,860.0,8,5787,151.0,1414.0,1091.0
0.071,6,10,1506,5,395,16.0,127.0,127.0,5,1111,17.0,843.0,843.0
0.093,6,10,1506,5,395,21.0,127.0,127.0,5,1111,20.0,843.0,843.0
0.01,6,12,1926,6,1189,2.0,659.0,434.0,6,737,2.0,417.0,417.0
0.014,6,10,1677,5,827,3.0,559.0,559.0,5,850,3.0,582.0,582.0
0.006,17,2,170,1,65,0.0,37.0,37.0,1,105,0.0,77.0,77.0
0.008,6,10,1972,5,910,2.0,642.0,642.0,5,1062,1.0,794.0,794.0
0.005,17,2,170,1,65,0.0,37.0,37.0,1,105,0.0,77.0,77.0
0.001,17,2,132,1,58,0.0,30.0,30.0,1,74,0.0,46.0,46.0
0.009,6,10,1989,5,910,2.0,642.0,642.0,5,1079,2.0,811.0,811.0
0.004,6,10,1989,5,927,1.0,659.0,659.0,5,1062,1.0,794.0,794.0
0.017,6,14,3787,7,497,2.0,125.0,125.0,7,3290,2.0,1448.0,972.0
0.006,6,10,1689,5,839,1.0,571.0,571.0,5,850,1.0,582.0,582.0
0.008,17,2,222,1,65,0.0,37.0,37.0,1,157,0.0,129.0,129.0
0.019,6,10,1989,5,910,4.0,642.0,642.0,5,1079,4.0,811.0,811.0
0.006,6,10,1547,5,764,1.0,496.0,496.0,5,783,1.0,515.0,515.0
0.089,6,10,1506,5,395,20.0,127.0,127.0,5,1111,21.0,843.0,843.0
0.004,6,10,2007,5,928,1.0,660.0,660.0,5,1079,1.0,811.0,811.0
40.066,17,10,676,5,460,10013.0,104.0,64.0,5,216,10015.0,20.0,15.0
0.003,17,2,148,1,60,0.0,32.0,32.0,1,88,0.0,60.0,60.0
0.007,17,2,338,1,74,0.0,46.0,46.0,1,264,0.0,236.0,236.0
0.045,6,10,1989,5,910,11.0,642.0,642.0,5,1079,11.0,811.0,811.0
240.012,6,9,787,5,488,60003.0,232.0,232.0,4,299,80003.0,83.0,83.0
0.012,6,10,1972,5,910,3.0,642.0,642.0,5,1062,2.0,794.0,794.0
0.006,6,10,1854,5,889,1.0,621.0,621.0,5,965,1.0,697.0,697.0
0.005,6,10,2007,5,928,1.0,660.0,660.0,5,1079,1.0,811.0,811.0
0.009,6,10,1972,5,910,2.0,642.0,642.0,5,1062,2.0,794.0,794.0
0.005,6,10,2006,5,927,1.0,659.0,659.0,5,1079,1.0,811.0,811.0
170.406,17,86,12237,43,2860,4057.0,44.0,38.0,43,9377,4057.0,261.0,190.0
240.103,6,32,9224,16,6742,16006.0,1812.0,657.0,16,2482,16006.0,580.0,205.0
0.25,6,16,2670,8,1396,35.0,533.0,324.0,8,1274,24.0,529.0,212.0
0.041,17,4,284,2,120,0.0,32.0,32.0,2,164,38.0,60.0,54.0
0.017,6,10,1677,5,827,4.0,559.0,559.0,5,850,4.0,582.0,582.0
0.108,6,10,1506,5,395,24.0,127.0,127.0,5,1111,25.0,843.0,843.0
40.064,17,10,676,5,460,10015.0,104.0,64.0,5,216,10015.0,20.0,15.0
0.004,17,2,136,1,60,0.0,32.0,32.0,1,76,0.0,48.0,48.0
0.112,6,10,1506,5,395,25.0,127.0,127.0,5,1111,25.0,843.0,843.0
0.001,17,2,136,1,60,0.0,32.0,32.0,1,76,0.0,48.0,48.0
0.012,6,10,1990,5,911,2.0,643.0,643.0,5,1079,3.0,811.0,811.0
0.003,17,2,148,1,60,0.0,32.0,32.0,1,88,0.0,60.0,60.0
0.011,6,10,1983,5,910,2.0,642.0,642.0,5,1073,2.0,805.0,805.0
0.005,6,10,2000,5,927,1.0,659.0,659.0,5,1073,1.0,805.0,805.0
0.004,6,10,1702,5,863,1.0,595.0,595.0,5,839,1.0,571.0,571.0
0.008,6,10,1972,5,910,2.0,642.0,642.0,5,1062,2.0,794.0,794.0
0.004,6,10,1702,5,863,1.0,595.0,595.0,5,839,0.0,571.0,571.0
0.01,6,13,3735,7,497,1.0,125.0,125.0,6,3238,1.0,1470.0,1459.0
0.011,6,10,1989,5,910,2.0,642.0,642.0,5,1079,2.0,811.0,811.0
0.005,6,10,1989,5,927,1.0,659.0,659.0,5,1062,1.0,794.0,794.0
0.082,6,10,1506,5,395,16.0,127.0,127.0,5,1111,19.0,843.0,843.0
0.021,6,14,3787,7,497,3.0,125.0,125.0,7,3290,3.0,1448.0,972.0
0.113,6,10,1506,5,395,26.0,127.0,127.0,5,1111,20.0,843.0,843.0
40.069,17,10,676,5,460,10015.0,104.0,64.0,5,216,10016.0,20.0,15.0
0.004,6,13,3690,7,452,0.0,80.0,80.0,6,3238,0.0,1470.0,1459.0
176.061,17,104,15478,52,3519,3452.0,44.0,39.0,52,11959,3452.0,261.0,201.0
0.073,6,10,1506,5,395,16.0,127.0,127.0,5,1111,16.0,843.0,843.0
15.082,17,15,9238,8,6902,2149.0,1350.0,834.0,7,2336,2507.0,1350.0,305.0
0.005,6,10,2006,5,927,1.0,659.0,659.0,5,1079,1.0,811.0,811.0
308.66,17,20,1124,10,716,34281.0,48.0,43.0,10,408,34281.0,20.0,12.0
0.005,6,10,2006,5,927,1.0,659.0,659.0,5,1079,1.0,811.0,811.0
0.005,6,10,2007,5,928,1.0,660.0,660.0,5,1079,1.0,811.0,811.0
9.038,17,6,376,5,280,2259.0,28.0,28.0,1,96,0.0,68.0,68.0
0.001,17,2,180,1,66,0.0,38.0,38.0,1,114,0.0,86.0,86.0
0.001,17,2,136,1,60,0.0,32.0,32.0,1,76,0.0,48.0,48.0
0.012,6,10,1972,5,910,2.0,642.0,642.0,5,1062,3.0,794.0,794.0
0.004,17,2,148,1,60,0.0,32.0,32.0,1,88,0.0,60.0,60.0
0.164,17,2,152,1,76,0.0,48.0,48.0,1,76,0.0,48.0,48.0
0.069,6,10,1506,5,395,16.0,127.0,127.0,5,1111,15.0,843.0,843.0
0.05,17,4,284,2,120,0.0,32.0,32.0,2,164,32.0,60.0,54.0
0.005,6,13,3747,7,509,0.0,137.0,137.0,6,3238,0.0,1470.0,1459.0
0.221,6,16,2670,8,1396,31.0,533.0,324.0,8,1274,20.0,529.0,212.0
0.018,6,10,1989,5,910,4.0,642.0,642.0,5,1079,4.0,811.0,811.0
0.039,17,2,184,1,61,0.0,33.0,33.0,1,123,0.0,95.0,95.0
361.859,6,21,1793,16,1030,24123.0,190.0,190.0,5,763,60011.0,462.0,247.0
0.005,6,10,1989,5,927,1.0,659.0,659.0,5,1062,1.0,794.0,794.0
0.006,17,2,144,1,64,0.0,36.0,36.0,1,80,0.0,52.0,52.0
0.011,6,10,1972,5,910,2.0,642.0,642.0,5,1062,2.0,794.0,794.0
0.005,17,2,170,1,65,0.0,37.0,37.0,1,105,0.0,77.0,77.0
0.013,6,10,1989,5,910,3.0,642.0,642.0,5,1079,3.0,811.0,811.0
1.032,6,12,3142,6,2099,155.0,1328.0,923.0,6,1043,155.0,791.0,791.0
0.014,6,10,1972,5,910,3.0,642.0,642.0,5,1062,3.0,794.0,794.0
0.076,6,10,1506,5,395,14.0,127.0,127.0,5,1111,18.0,843.0,843.0
0.073,17,2,152,1,76,0.0,48.0,48.0,1,76,0.0,48.0,48.0
0.009,6,10,1983,5,910,2.0,642.0,642.0,5,1073,2.0,805.0,805.0
0.12,6,10,1506,5,395,27.0,127.0,127.0,5,1111,28.0,843.0,843.0
40.054,17,10,676,5,460,10012.0,104.0,64.0,5,216,10012.0,20.0,15.0
308.506,17,18,1008,9,640,38547.0,48.0,43.0,9,368,38547.0,20.0,12.0
0.005,6,10,1989,5,927,1.0,659.0,659.0,5,1062,1.0,794.0,794.0
0.031,6,10,1989,5,910,7.0,642.0,642.0,5,1079,7.0,811.0,811.0
0.005,6,10,1702,5,863,1.0,595.0,595.0,5,839,1.0,571.0,571.0
0.014,6,10,1989,5,910,3.0,642.0,642.0,5,1079,3.0,811.0,811.0
0.006,6,10,1547,5,764,1.0,496.0,496.0,5,783,1.0,515.0,515.0
0.011,6,10,1990,5,911,2.0,643.0,643.0,5,1079,2.0,811.0,811.0
0.005,6,10,1689,5,839,1.0,571.0,571.0,5,850,1.0,582.0,582.0
324.143,17,20,1124,10,716,36001.0,48.0,43.0,10,408,36001.0,20.0,12.0
0.004,6,10,2006,5,927,1.0,659.0,659.0,5,1079,1.0,811.0,811.0
0.005,6,14,3799,7,509,0.0,137.0,137.0,7,3290,0.0,1448.0,972.0
0.006,6,10,1547,5,764,1.0,496.0,496.0,5,783,1.0,515.0,515.0
0.037,17,2,234,1,61,0.0,33.0,33.0,1,173,0.0,145.0,145.0
0.004,6,10,1774,5,923,1.0,655.0,655.0,5,851,1.0,583.0,583.0
0.011,6,10,1972,5,910,2.0,642.0,642.0,5,1062,2.0,794.0,794.0
0.004,6,10,2006,5,927,1.0,659.0,659.0,5,1079,1.0,811.0,811.0
10.761,17,28,4422,14,1994,819.0,269.0,114.0,14,2428,819.0,587.0,145.0
0.019,6,10,1677,5,827,4.0,559.0,559.0,5,850,4.0,582.0,582.0
0.006,17,2,166,1,75,0.0,47.0,47.0,1,91,0.0,63.0,63.0
0.01,6,14,3787,7,497,1.0,125.0,125.0,7,3290,1.0,1448.0,972.0
0.005,6,10,2000,5,927,1.0,659.0,659.0,5,1073,1.0,805.0,805.0
0.077,6,10,1506,5,395,17.0,127.0,127.0,5,1111,17.0,843.0,843.0
0.008,6,10,1972,5,910,2.0,642.0,642.0,5,1062,2.0,794.0,794.0
0.014,6,10,1990,5,911,3.0,643.0,643.0,5,1079,3.0,811.0,811.0
0.071,6,10,1506,5,395,16.0,127.0,127.0,5,1111,14.0,843.0,843.0
279.709,6,39,9504,15,6492,19979.0,1616.0,635.0,24,3012,12161.0,580.0,117.0
1769.155,17,92,8096,46,4048,39314.0,60.0,60.0,46,4048,39314.0,60.0,60.0
0.005,17,2,166,1,75,0.0,47.0,47.0,1,91,0.0,63.0,63.0
0.001,17,2,179,1,62,0.0,34.0,34.0,1,117,0.0,89.0,89.0
0.005,6,10,1547,5,764,1.0,496.0,496.0,5,783,1.0,515.0,515.0
0.096,6,10,1506,5,395,19.0,127.0,127.0,5,1111,21.0,843.0,843.0
0.008,17,2,194,1,59,0.0,31.0,31.0,1,135,0.0,107.0,107.0
0.005,17,2,178,1,81,0.0,53.0,53.0,1,97,0.0,69.0,69.0
0.011,6,10,1631,5,848,2.0,580.0,580.0,5,783,2.0,515.0,515.0
0.148,6,10,1506,5,395,35.0,127.0,127.0,5,1111,29.0,843.0,843.0
0.005,17,2,144,1,64,0.0,36.0,36.0,1,80,0.0,52.0,52.0
0.006,17,2,169,1,62,0.0,34.0,34.0,1,107,0.0,79.0,79.0
0.013,6,14,3736,7,446,2.0,74.0,74.0,7,3290,2.0,1448.0,972.0
40.059,17,10,676,5,460,10013.0,104.0,64.0,5,216,10014.0,20.0,15.0
0.005,6,10,2006,5,927,1.0,659.0,659.0,5,1079,1.0,811.0,811.0
0.007,6,10,1547,5,764,1.0,496.0,496.0,5,783,1.0,515.0,515.0
0.005,6,10,1547,5,764,1.0,496.0,496.0,5,783,1.0,515.0,515.0
0.011,6,10,1989,5,910,2.0,642.0,642.0,5,1079,2.0,811.0,811.0
9.042,17,6,376,5,280,2260.0,28.0,28.0,1,96,0.0,68.0,68.0
0.007,6,10,2006,5,927,1.0,659.0,659.0,5,1079,1.0,811.0,811.0
40.054,17,10,676,5,460,10012.0,104.0,64.0,5,216,10012.0,20.0,15.0
0.04,17,4,284,2,120,0.0,32.0,32.0,2,164,35.0,60.0,54.0
0.004,6,10,1702,5,863,0.0,595.0,595.0,5,839,1.0,571.0,571.0
0.007,6,10,2007,5,928,1.0,660.0,660.0,5,1079,1.0,811.0,811.0
0.004,6,10,1774,5,923,1.0,655.0,655.0,5,851,1.0,583.0,583.0
0.016,6,10,1631,5,848,4.0,580.0,580.0,5,783,3.0,515.0,515.0
0.006,6,13,3747,7,509,0.0,137.0,137.0,6,3238,1.0,1470.0,1459.0
0.011,6,10,1972,5,910,2.0,642.0,642.0,5,1062,2.0,794.0,794.0
40.075,17,10,676,5,460,10017.0,104.0,64.0,5,216,10017.0,20.0,15.0
0.007,6,10,1547,5,764,1.0,496.0,496.0,5,783,1.0,515.0,515.0
0.015,6,10,1983,5,910,3.0,642.0,642.0,5,1073,3.0,805.0,805.0
0.009,6,10,1990,5,911,2.0,643.0,643.0,5,1079,2.0,811.0,811.0
0.038,17,2,148,1,60,0.0,32.0,32.0,1,88,0.0,60.0,60.0
0.005,6,10,1989,5,927,1.0,659.0,659.0,5,1062,1.0,794.0,794.0
0.024,6,10,1989,5,910,6.0,642.0,642.0,5,1079,6.0,811.0,811.0
0.008,17,2,160,1,72,0.0,44.0,44.0,1,88,0.0,60.0,60.0
0.008,6,10,1990,5,911,2.0,643.0,643.0,5,1079,2.0,811.0,811.0
0.014,6,10,1762,5,911,3.0,643.0,643.0,5,851,3.0,583.0,583.0
0.012,6,10,1990,5,911,2.0,643.0,643.0,5,1079,2.0,811.0,811.0
0.091,6,10,1506,5,395,16.0,127.0,127.0,5,1111,19.0,843.0,843.0
0.113,6,10,1506,5,395,17.0,127.0,127.0,5,1111,26.0,843.0,843.0
0.004,6,10,1702,5,863,1.0,595.0,595.0,5,839,0.0,571.0,571.0
0.08,6,10,1506,5,395,15.0,127.0,127.0,5,1111,19.0,843.0,843.0
0.001,17,2,136,1,60,0.0,32.0,32.0,1,76,0.0,48.0,48.0
0.012,6,10,1990,5,911,3.0,643.0,643.0,5,1079,2.0,811.0,811.0
0.005,6,10,1989,5,927,1.0,659.0,659.0,5,1062,1.0,794.0,794.0
300.634,6,34,6335,19,1409,16701.0,267.0,154.0,15,4926,607.0,1823.0,392.0
0.006,6,10,1547,5,764,1.0,496.0,496.0,5,783,1.0,515.0,515.0
40.088,17,10,676,5,460,10016.0,104.0,64.0,5,216,10018.0,20.0,15.0
0.076,6,10,1506,5,395,16.0,127.0,127.0,5,1111,16.0,843.0,843.0
308.447,17,20,1124,10,716,34257.0,48.0,43.0,10,408,34257.0,20.0,12.0
0.001,17,2,136,1,60,0.0,32.0,32.0,1,76,0.0,48.0,48.0
0.014,6,13,3735,7,497,2.0,125.0,125.0,6,3238,2.0,1470.0,1459.0
0.004,6,10,1702,5,863,0.0,595.0,595.0,5,839,1.0,571.0,571.0
0.004,6,10,1774,5,923,1.0,655.0,655.0,5,851,1.0,583.0,583.0
0.04,17,2,184,1,61,0.0,33.0,33.0,1,123,0.0,95.0,95.0
0.006,17,2,164,1,74,0.0,46.0,46.0,1,90,0.0,62.0,62.0
0.037,17,2,136,1,60,0.0,32.0,32.0,1,76,0.0,48.0,48.0
0.084,6,10,1506,5,395,19.0,127.0,127.0,5,1111,18.0,843.0,843.0
40.063,17,10,676,5,460,10013.0,104.0,64.0,5,216,10014.0,20.0,15.0
0.004,6,10,2006,5,927,1.0,659.0,659.0,5,1079,1.0,811.0,811.0
0.007,6,10,1547,5,764,1.0,496.0,496.0,5,783,1.0,515.0,515.0
0.01,6,10,1989,5,910,2.0,642.0,642.0,5,1079,2.0,811.0,811.0
0.006,6,10,1547,5,764,1.0,496.0,496.0,5,783,1.0,515.0,515.0
354.049,6,20,1755,16,1042,23603.0,190.0,190.0,4,713,80005.0,497.0,497.0
0.077,6,10,1506,5,395,14.0,127.0,127.0,5,1111,17.0,843.0,843.0
308.434,17,20,1124,10,716,34255.0,48.0,43.0,10,408,34256.0,20.0,12.0
0.005,6,10,1689,5,839,1.0,571.0,571.0,5,850,1.0,582.0,582.0
0.01,6,10,1983,5,910,2.0,642.0,642.0,5,1073,2.0,805.0,805.0
0.001,17,2,154,1,69,0.0,41.0,41.0,1,85,0.0,57.0,57.0
0.006,6,10,2006,5,927,1.0,659.0,659.0,5,1079,1.0,811.0,811.0
0.003,17,2,186,1,61,0.0,33.0,33.0,1,125,0.0,97.0,97.0
0.009,6,10,1990,5,911,2.0,643.0,643.0,5,1079,2.0,811.0,811.0
0.005,6,10,1854,5,889,1.0,621.0,621.0,5,965,1.0,697.0,697.0
0.005,17,2,170,1,65,0.0,37.0,37.0,1,105,0.0,77.0,77.0
0.005,6,10,1689,5,839,1.0,571.0,571.0,5,850,1.0,582.0,582.0
0.197,6,10,1506,5,395,46.0,127.0,127.0,5,1111,44.0,843.0,843.0
0.171,6,3,453,2,321,171.0,241.0,241.0,1,132,0.0,92.0,92.0
0.084,6,10,1506,5,395,18.0,127.0,127.0,5,1111,20.0,843.0,843.0
0.02,6,10,1990,5,911,4.0,643.0,643.0,5,1079,5.0,811.0,811.0
0.001,17,2,179,1,62,0.0,34.0,34.0,1,117,0.0,89.0,89.0
15.069,17,15,9238,8,6902,2148.0,1350.0,834.0,7,2336,2506.0,1350.0,305.0
0.004,6,10,2007,5,928,1.0,660.0,660.0,5,1079,1.0,811.0,811.0
0.005,17,2,136,1,60,0.0,32.0,32.0,1,76,0.0,48.0,48.0
0.005,6,10,2006,5,927,1.0,659.0,659.0,5,1079,1.0,811.0,811.0
176.214,17,96,13633,48,3228,3748.0,44.0,39.0,48,10405,3749.0,261.0,188.0
0.089,6,10,1506,5,395,19.0,127.0,127.0,5,1111,18.0,843.0,843.0
0.005,6,10,1854,5,889,1.0,621.0,621.0,5,965,1.0,697.0,697.0
0.062,6,10,1506,5,395,15.0,127.0,127.0,5,1111,14.0,843.0,843.0
0.004,6,10,2007,5,928,1.0,660.0,660.0,5,1079,1.0,811.0,811.0
0.004,17,2,170,1,65,0.0,37.0,37.0,1,105,0.0,77.0,77.0
0.005,6,10,2000,5,927,1.0,659.0,659.0,5,1073,1.0,805.0,805.0
10.919,17,28,4421,14,1994,831.0,269.0,114.0,14,2427,831.0,586.0,145.0
0.02,6,10,1972,5,910,4.0,642.0,642.0,5,1062,4.0,794.0,794.0
0.071,6,10,1506,5,395,15.0,127.0,127.0,5,1111,14.0,843.0,843.0
0.025,6,10,1983,5,910,6.0,642.0,642.0,5,1073,6.0,805.0,805.0
0.005,6,10,2006,5,927,1.0,659.0,659.0,5,1079,1.0,811.0,811.0
0.016,6,10,1972,5,910,4.0,642.0,642.0,5,1062,3.0,794.0,794.0
0.005,6,10,2006,5,927,1.0,659.0,659.0,5,1079,1.0,811.0,811.0
0.052,17,2,152,1,76,0.0,48.0,48.0,1,76,0.0,48.0,48.0
0.009,6,10,1972,5,910,2.0,642.0,642.0,5,1062,2.0,794.0,794.0
0.007,6,10,1989,5,910,1.0,642.0,642.0,5,1079,1.0,811.0,811.0
0.069,6,10,1506,5,395,15.0,127.0,127.0,5,1111,14.0,843.0,843.0
0.007,17,2,230,1,68,0.0,40.0,40.0,1,162,0.0,134.0,134.0
0.006,6,10,1689,5,839,1.0,571.0,571.0,5,850,1.0,582.0,582.0
0.012,6,10,1990,5,911,3.0,643.0,643.0,5,1079,2.0,811.0,811.0
0.004,6,10,1989,5,927,1.0,659.0,659.0,5,1062,1.0,794.0,794.0
0.159,6,10,1506,5,395,39.0,127.0,127.0,5,1111,37.0,843.0,843.0
0.094,6,10,1506,5,395,20.0,127.0,127.0,5,1111,20.0,843.0,843.0
0.004,17,2,136,1,60,0.0,32.0,32.0,1,76,0.0,48.0,48.0
11.129,17,28,4422,14,1993,843.0,268.0,114.0,14,2429,843.0,588.0,145.0
0.013,6,10,1989,5,910,3.0,642.0,642.0,5,1079,3.0,811.0,811.0
0.005,17,2,170,1,65,0.0,37.0,37.0,1,105,0.0,77.0,77.0
0.064,6,10,1506,5,395,13.0,127.0,127.0,5,1111,13.0,843.0,843.0
0.169,6,10,1506,5,395,37.0,127.0,127.0,5,1111,38.0,843.0,843.0
0.004,6,10,2006,5,927,1.0,659.0,659.0,5,1079,1.0,811.0,811.0
0.086,6,10,1506,5,395,18.0,127.0,127.0,5,1111,19.0,843.0,843.0
0.005,6,10,2007,5,928,1.0,660.0,660.0,5,1079,1.0,811.0,811.0
0.049,6,10,1506,5,395,10.0,127.0,127.0,5,1111,11.0,843.0,843.0
0.014,6,10,1989,5,910,3.0,642.0,642.0,5,1079,3.0,811.0,811.0
0.008,6,10,1762,5,911,2.0,643.0,643.0,5,851,1.0,583.0,583.0
0.003,6,10,1702,5,863,0.0,595.0,595.0,5,839,0.0,571.0,571.0
0.006,6,10,1547,5,764,1.0,496.0,496.0,5,783,1.0,515.0,515.0
40.061,17,10,676,5,460,10013.0,104.0,64.0,5,216,10014.0,20.0,15.0
0.005,6,10,2000,5,927,1.0,659.0,659.0,5,1073,1.0,805.0,805.0
0.009,6,10,1989,5,910,2.0,642.0,642.0,5,1079,2.0,811.0,811.0
0.003,17,2,148,1,60,0.0,32.0,32.0,1,88,0.0,60.0,60.0
0.004,6,10,2006,5,927,1.0,659.0,659.0,5,1079,1.0,811.0,811.0
0.039,17,4,284,2,120,0.0,32.0,32.0,2,164,33.0,60.0,54.0
0.014,6,10,1972,5,910,3.0,642.0,642.0,5,1062,3.0,794.0,794.0
0.086,6,10,1506,5,395,21.0,127.0,127.0,5,1111,20.0,843.0,843.0
0.144,6,10,1506,5,395,34.0,127.0,127.0,5,1111,32.0,843.0,843.0
0.015,6,10,1990,5,911,3.0,643.0,643.0,5,1079,3.0,811.0,811.0
175.146,17,88,12534,44,2955,4073.0,44.0,39.0,44,9579,4073.0,239.0,189.0
0.006,6,10,1547,5,764,1.0,496.0,496.0,5,783,1.0,515.0,515.0
240.03,6,9,787,5,488,60007.0,232.0,232.0,4,299,80007.0,83.0,83.0
0.01,6,10,1989,5,910,2.0,642.0,642.0,5,1079,2.0,811.0,811.0
0.011,6,10,1677,5,827,2.0,559.0,559.0,5,850,2.0,582.0,582.0
0.089,6,10,1506,5,395,20.0,127.0,127.0,5,1111,21.0,843.0,843.0
0.001,17,2,180,1,66,0.0,38.0,38.0,1,114,0.0,86.0,86.0
11.525,17,28,4392,14,2311,874.0,586.0,137.0,14,2081,874.0,268.0,120.0
0.015,6,20,9974,11,704,1.0,124.0,124.0,9,9270,1.0,2896.0,1758.0
0.041,17,4,284,2,120,3.0,32.0,32.0,2,164,2.0,60.0,54.0
0.085,6,10,1506,5,395,18.0,127.0,127.0,5,1111,19.0,843.0,843.0
0.005,6,13,3684,7,446,0.0,74.0,74.0,6,3238,0.0,1470.0,1459.0
0.006,6,10,1854,5,889,1.0,621.0,621.0,5,965,1.0,697.0,697.0
0.011,6,12,1926,6,1189,2.0,659.0,434.0,6,737,2.0,417.0,417.0
0.101,6,10,1506,5,395,22.0,127.0,127.0,5,1111,22.0,843.0,843.0
0.101,6,10,1506,5,395,21.0,127.0,127.0,5,1111,22.0,843.0,843.0
0.094,6,10,1506,5,395,22.0,127.0,127.0,5,1111,17.0,843.0,843.0
0.006,6,10,1689,5,839,1.0,571.0,571.0,5,850,1.0,582.0,582.0
0.004,6,10,2006,5,927,1.0,659.0,659.0,5,1079,1.0,811.0,811.0
0.005,17,2,144,1,64,0.0,36.0,36.0,1,80,0.0,52.0,52.0
240.083,6,16,4481,9,963,30010.0,238.0,166.0,7,3518,40013.0,1402.0,786.0
0.017,6,10,1972,5,910,4.0,642.0,642.0,5,1062,4.0,794.0,794.0
70.847,6,26,9525,12,1627,77.0,794.0,367.0,14,7898,5439.0,1360.0,732.0
0.011,6,10,1972,5,910,2.0,642.0,642.0,5,1062,2.0,794.0,794.0
0.003,17,2,136,1,60,0.0,32.0,32.0,1,76,0.0,48.0,48.0
0.005,6,10,2006,5,927,1.0,659.0,659.0,5,1079,1.0,811.0,811.0
240.008,6,9,787,5,488,60002.0,232.0,232.0,4,299,80001.0,83.0,83.0
0.001,17,2,136,1,60,0.0,32.0,32.0,1,76,0.0,48.0,48.0
0.01,6,10,1677,5,827,2.0,559.0,559.0,5,850,2.0,582.0,582.0
0.009,6,10,1989,5,910,2.0,642.0,642.0,5,1079,2.0,811.0,811.0
0.007,17,2,179,1,71,0.0,43.0,43.0,1,108,0.0,80.0,80.0
0.067,6,10,1506,5,395,14.0,127.0,127.0,5,1111,14.0,843.0,843.0
0.006,6,10,1689,5,839,1.0,571.0,571.0,5,850,1.0,582.0,582.0
0.005,6,10,1989,5,927,1.0,659.0,659.0,5,1062,1.0,794.0,794.0
0.085,6,10,1506,5,395,18.0,127.0,127.0,5,1111,18.0,843.0,843.0
0.005,17,2,144,1,64,0.0,36.0,36.0,1,80,0.0,52.0,52.0
0.072,17,4,596,2,122,1.0,33.0,33.0,2,474,0.0,323.0,209.0
0.008,17,2,140,1,62,0.0,34.0,34.0,1,78,0.0,50.0,50.0
0.009,6,10,1643,5,860,2.0,592.0,592.0,5,783,2.0,515.0,515.0
0.001,17,2,136,1,60,0.0,32.0,32.0,1,76,0.0,48.0,48.0
0.001,17,2,166,1,75,0.0,47.0,47.0,1,91,0.0,63.0,63.0
0.042,17,2,182,1,65,0.0,37.0,37.0,1,117,0.0,89.0,89.0
39.558,6,46,18350,23,12403,411.0,2720.0,1431.0,23,5947,1790.0,2667.0,385.0
0.012,6,10,1990,5,911,2.0,643.0,643.0,5,1079,3.0,811.0,811.0
40.081,17,10,676,5,460,10019.0,104.0,64.0,5,216,10018.0,20.0,15.0
0.005,6,10,1774,5,923,1.0,655.0,655.0,5,851,1.0,583.0,583.0
0.003,17,4,284,2,120,0.0,32.0,32.0,2,164,0.0,60.0,54.0
23.642,17,23,14800,13,12031,1967.0,1350.0,897.0,10,2769,2623.0,1350.0,248.0
0.083,6,10,1506,5,395,19.0,127.0,127.0,5,1111,20.0,843.0,843.0
0.006,17,2,154,1,69,0.0,41.0,41.0,1,85,0.0,57.0,57.0
0.205,6,16,2669,8,1395,29.0,533.0,323.0,8,1274,18.0,529.0,212.0
0.016,6,10,1990,5,911,4.0,643.0,643.0,5,1079,4.0,811.0,811.0
0.005,6,10,1643,5,860,1.0,592.0,592.0,5,783,1.0,515.0,515.0
0.129,17,2,80,1,32,0.0,4.0,4.0,1,48,0.0,20.0,20.0
0.076,6,10,1506,5,395,16.0,127.0,127.0,5,1111,17.0,843.0,843.0
40.056,17,10,676,5,460,10012.0,104.0,64.0,5,216,10013.0,20.0,15.0
0.011,6,10,1631,5,848,2.0,580.0,580.0,5,783,2.0,515.0,515.0
0.007,6,10,1547,5,764,1.0,496.0,496.0,5,783,1.0,515.0,515.0
0.013,6,10,1989,5,910,3.0,642.0,642.0,5,1079,3.0,811.0,811.0
78.86,6,667,686412,350,664354,54.0,4080.0,2057.0,317,22058,249.0,2667.0,183.0
0.011,6,10,1762,5,911,2.0,643.0,643.0,5,851,2.0,583.0,583.0
0.006,6,10,1547,5,764,1.0,496.0,496.0,5,783,1.0,515.0,515.0
413.529,6,29,4409,12,3102,10913.0,494.0,494.0,17,1307,25845.0,83.0,83.0
0.015,6,10,1990,5,911,3.0,643.0,643.0,5,1079,3.0,811.0,811.0
0.009,6,10,1689,5,839,2.0,571.0,571.0,5,850,2.0,582.0,582.0
0.005,17,2,170,1,65,0.0,37.0,37.0,1,105,0.0,77.0,77.0
368.631,6,22,2313,16,867,24575.0,195.0,195.0,6,1446,4639.0,419.0,398.0
0.201,6,16,2777,8,1395,28.0,533.0,323.0,8,1382,18.0,529.0,239.0
0.011,6,10,1677,5,827,2.0,559.0,559.0,5,850,2.0,582.0,582.0
15.072,17,14,9191,8,6902,2149.0,1350.0,834.0,6,2289,3008.0,1350.0,353.0
0.006,6,10,2006,5,927,1.0,659.0,659.0,5,1079,1.0,811.0,811.0
0.126,17,2,182,1,65,0.0,37.0,37.0,1,117,0.0,89.0,89.0
0.003,17,2,136,1,60,0.0,32.0,32.0,1,76,0.0,48.0,48.0
0.159,6,10,1506,5,395,37.0,127.0,127.0,5,1111,38.0,843.0,843.0
0.006,6,10,2007,5,928,1.0,660.0,660.0,5,1079,1.0,811.0,811.0
0.008,6,12,1926,6,1189,1.0,659.0,434.0,6,737,1.0,417.0,417.0
167.286,17,90,12717,45,3009,3801.0,44.0,38.0,45,9708,3801.0,239.0,187.0
0.006,6,10,1854,5,889,1.0,621.0,621.0,5,965,1.0,697.0,697.0
0.005,6,13,3747,7,509,0.0,137.0,137.0,6,3238,0.0,1470.0,1459.0
0.021,6,10,1983,5,910,5.0,642.0,642.0,5,1073,5.0,805.0,805.0
0.077,6,10,1506,5,395,17.0,127.0,127.0,5,1111,16.0,843.0,843.0
0.007,17,2,222,1,65,0.0,37.0,37.0,1,157,0.0,129.0,129.0
11.336,17,28,4423,14,1995,859.0,270.0,114.0,14,2428,859.0,587.0,145.0
0.033,17,2,299,1,65,0.0,37.0,37.0,1,234,0.0,206.0,206.0
0.005,6,10,2006,5,927,1.0,659.0,659.0,5,1079,1.0,811.0,811.0
0.005,6,10,2006,5,927,1.0,659.0,659.0,5,1079,1.0,811.0,811.0
0.008,6,10,1989,5,910,2.0,642.0,642.0,5,1079,1.0,811.0,811.0
0.006,17,2,179,1,71,0.0,43.0,43.0,1,108,0.0,80.0,80.0
0.004,6,10,1702,5,863,0.0,595.0,595.0,5,839,1.0,571.0,571.0
0.005,17,2,169,1,62,0.0,34.0,34.0,1,107,0.0,79.0,79.0
0.072,17,2,136,1,60,0.0,32.0,32.0,1,76,0.0,48.0,48.0
313.75,17,18,1044,10,716,34844.0,48.0,43.0,8,328,44800.0,20.0,13.0
0.008,6,10,1990,5,911,2.0,643.0,643.0,5,1079,2.0,811.0,811.0
0.008,6,10,1989,5,910,2.0,642.0,642.0,5,1079,2.0,811.0,811.0
9.04,17,6,376,5,280,2260.0,28.0,28.0,1,96,0.0,68.0,68.0
0.113,6,10,1506,5,395,25.0,127.0,127.0,5,1111,24.0,843.0,843.0
0.007,6,10,1854,5,889,1.0,621.0,621.0,5,965,1.0,697.0,697.0
0.022,6,10,1989,5,910,5.0,642.0,642.0,5,1079,5.0,811.0,811.0
0.004,6,10,1779,5,928,1.0,660.0,660.0,5,851,1.0,583.0,583.0
0.01,6,10,1762,5,911,2.0,643.0,643.0,5,851,2.0,583.0,583.0
168.257,17,84,12224,42,2818,4103.0,44.0,39.0,42,9406,4103.0,261.0,195.0
0.006,6,10,1689,5,839,1.0,571.0,571.0,5,850,1.0,582.0,582.0
0.098,6,10,1506,5,395,21.0,127.0,127.0,5,1111,22.0,843.0,843.0
0.001,17,2,180,1,65,0.0,37.0,37.0,1,115,0.0,87.0,87.0
0.007,6,10,1643,5,860,1.0,592.0,592.0,5,783,1.0,515.0,515.0
0.004,6,10,1989,5,927,1.0,659.0,659.0,5,1062,1.0,794.0,794.0
0.093,6,10,1506,5,395,20.0,127.0,127.0,5,1111,21.0,843.0,843.0
0.001,17,2,136,1,60,0.0,32.0,32.0,1,76,0.0,48.0,48.0
240.102,6,16,4480,9,963,30012.0,238.0,166.0,7,3517,40015.0,1402.0,786.0
308.466,17,20,1124,10,716,34260.0,48.0,43.0,10,408,34263.0,20.0,12.0
0.098,6,10,1506,5,395,22.0,127.0,127.0,5,1111,23.0,843.0,843.0
0.004,17,2,184,1,61,0.0,33.0,33.0,1,123,0.0,95.0,95.0
0.004,6,10,2006,5,927,1.0,659.0,659.0,5,1079,1.0,811.0,811.0
0.124,6,10,1506,5,395,25.0,127.0,127.0,5,1111,26.0,843.0,843.0
0.006,17,2,424,1,72,0.0,44.0,44.0,1,352,0.0,324.0,324.0
40.064,17,10,676,5,460,10014.0,104.0,64.0,5,216,10015.0,20.0,15.0
0.011,6,10,1989,5,910,2.0,642.0,642.0,5,1079,2.0,811.0,811.0
1729.23,6,60,4400,40,2740,44339.0,33.0,33.0,20,1660,91002.0,31.0,31.0
0.006,17,2,230,1,68,0.0,40.0,40.0,1,162,0.0,134.0,134.0
0.006,17,2,152,1,76,0.0,48.0,48.0,1,76,0.0,48.0,48.0
0.013,6,10,1990,5,911,3.0,643.0,643.0,5,1079,3.0,811.0,811.0
0.005,17,2,230,1,68,0.0,40.0,40.0,1,162,0.0,134.0,134.0
0.003,17,2,136,1,60,0.0,32.0,32.0,1,76,0.0,48.0,48.0
0.006,6,10,2006,5,927,1.0,659.0,659.0,5,1079,1.0,811.0,811.0
0.004,6,10,1989,5,927,1.0,659.0,659.0,5,1062,1.0,794.0,794.0
0.004,6,10,1774,5,923,1.0,655.0,655.0,5,851,1.0,583.0,583.0
0.001,17,2,180,1,66,0.0,38.0,38.0,1,114,0.0,86.0,86.0
240.105,6,31,8914,15,6534,17150.0,1658.0,639.0,16,2380,16006.0,580.0,192.0
0.005,6,10,1779,5,928,1.0,660.0,660.0,5,851,1.0,583.0,583.0
40.055,17,10,676,5,460,10012.0,104.0,64.0,5,216,10012.0,20.0,15.0
10.835,17,26,4102,13,1845,894.0,268.0,113.0,13,2257,894.0,588.0,145.0
0.012,6,10,1762,5,911,2.0,643.0,643.0,5,851,2.0,583.0,583.0
40.055,17,10,676,5,460,10013.0,104.0,64.0,5,216,10012.0,20.0,15.0
0.003,17,2,148,1,60,0.0,32.0,32.0,1,88,0.0,60.0,60.0
240.089,6,16,4481,9,963,30011.0,238.0,166.0,7,3518,40014.0,1402.0,786.0
0.005,17,2,214,1,75,0.0,47.0,47.0,1,139,0.0,111.0,111.0
0.005,6,10,2000,5,927,1.0,659.0,659.0,5,1073,1.0,805.0,805.0
0.074,6,10,1506,5,395,16.0,127.0,127.0,5,1111,14.0,843.0,843.0
0.006,6,12,1698,6,863,1.0,327.0,271.0,6,835,1.0,515.0,515.0
0.121,6,10,1506,5,395,27.0,127.0,127.0,5,1111,27.0,843.0,843.0
0.005,6,10,2006,5,927,1.0,659.0,659.0,5,1079,1.0,811.0,811.0
0.008,17,2,179,1,71,0.0,43.0,43.0,1,108,0.0,80.0,80.0
0.34,17,49,29873,29,26280,12.0,1350.0,878.0,20,3593,15.0,1350.0,151.0
0.011,6,10,1972,5,910,2.0,642.0,642.0,5,1062,2.0,794.0,794.0
334.062,17,20,1124,10,716,37103.0,48.0,43.0,10,408,37103.0,20.0,12.0
0.006,17,2,179,1,71,0.0,43.0,43.0,1,108,0.0,80.0,80.0
0.162,17,2,152,1,76,0.0,48.0,48.0,1,76,0.0,48.0,48.0
0.004,6,10,1774,5,923,1.0,655.0,655.0,5,851,1.0,583.0,583.0
0.009,6,12,1926,6,1189,1.0,659.0,434.0,6,737,1.0,417.0,417.0
0.011,6,10,1983,5,910,2.0,642.0,642.0,5,1073,2.0,805.0,805.0
0.004,17,2,148,1,60,0.0,32.0,32.0,1,88,0.0,60.0,60.0
0.001,17,2,166,1,75,0.0,47.0,47.0,1,91,0.0,63.0,63.0
0.012,6,10,1762,5,911,2.0,643.0,643.0,5,851,2.0,583.0,583.0
0.088,6,10,1506,5,395,20.0,127.0,127.0,5,1111,19.0,843.0,843.0
0.006,6,10,1547,5,764,1.0,496.0,496.0,5,783,1.0,515.0,515.0
0.007,17,2,140,1,62,0.0,34.0,34.0,1,78,0.0,50.0,50.0
0.006,6,10,2000,5,927,1.0,659.0,659.0,5,1073,1.0,805.0,805.0
0.009,6,10,1989,5,910,2.0,642.0,642.0,5,1079,2.0,811.0,811.0
115.413,6,22,7437,11,1305,107.0,530.0,277.0,11,6132,11524.0,2720.0,946.0
0.001,17,2,180,1,66,0.0,38.0,38.0,1,114,0.0,86.0,86.0
0.003,17,2,148,1,60,0.0,32.0,32.0,1,88,0.0,60.0,60.0
0.01,6,10,1972,5,910,2.0,642.0,642.0,5,1062,2.0,794.0,794.0
0.084,6,10,1506,5,395,20.0,127.0,127.0,5,1111,17.0,843.0,843.0
0.015,6,10,1990,5,911,3.0,643.0,643.0,5,1079,3.0,811.0,811.0
0.003,17,2,136,1,60,0.0,32.0,32.0,1,76,0.0,48.0,48.0
0.01,6,10,1972,5,910,2.0,642.0,642.0,5,1062,2.0,794.0,794.0
0.001,17,2,180,1,66,0.0,38.0,38.0,1,114,0.0,86.0,86.0
40.076,17,10,676,5,460,10018.0,104.0,64.0,5,216,10018.0,20.0,15.0
0.011,6,10,1989,5,910,2.0,642.0,642.0,5,1079,2.0,811.0,811.0
0.018,6,10,1983,5,910,4.0,642.0,642.0,5,1073,4.0,805.0,805.0
0.004,17,4,284,2,120,0.0,32.0,32.0,2,164,0.0,60.0,54.0
0.006,6,10,2006,5,927,1.0,659.0,659.0,5,1079,1.0,811.0,811.0
0.006,6,10,1689,5,839,1.0,571.0,571.0,5,850,1.0,582.0,582.0
0.005,6,10,2006,5,927,1.0,659.0,659.0,5,1079,1.0,811.0,811.0
0.006,6,10,1689,5,839,1.0,571.0,571.0,5,850,1.0,582.0,582.0
0.095,6,10,1506,5,395,21.0,127.0,127.0,5,1111,22.0,843.0,843.0
0.071,17,2,182,1,65,0.0,37.0,37.0,1,117,0.0,89.0,89.0
1778.525,17,142,44872,72,22752,25048.0,288.0,288.0,70,22120,25774.0,288.0,288.0
0.115,6,10,1506,5,395,21.0,127.0,127.0,5,1111,22.0,843.0,843.0
0.005,6,13,3690,7,452,0.0,80.0,80.0,6,3238,1.0,1470.0,1459.0
0.006,6,10,1547,5,764,1.0,496.0,496.0,5,783,1.0,515.0,515.0
0.088,6,10,1506,5,395,19.0,127.0,127.0,5,1111,19.0,843.0,843.0
0.077,6,10,1506,5,395,16.0,127.0,127.0,5,1111,16.0,843.0,843.0
0.089,6,10,1506,5,395,19.0,127.0,127.0,5,1111,21.0,843.0,843.0
0.014,6,10,1989,5,910,3.0,642.0,642.0,5,1079,3.0,811.0,811.0
0.005,6,10,1989,5,927,1.0,659.0,659.0,5,1062,1.0,794.0,794.0
0.004,6,10,2007,5,928,1.0,660.0,660.0,5,1079,1.0,811.0,811.0
240.09,6,16,4482,9,963,30011.0,238.0,166.0,7,3519,40014.0,1402.0,786.0
0.005,6,10,1989,5,927,1.0,659.0,659.0,5,1062,1.0,794.0,794.0
0.092,6,10,1506,5,395,21.0,127.0,127.0,5,1111,20.0,843.0,843.0
0.005,6,10,2006,5,927,1.0,659.0,659.0,5,1079,1.0,811.0,811.0
0.005,17,2,222,1,65,0.0,37.0,37.0,1,157,0.0,129.0,129.0
0.08,6,10,1506,5,395,14.0,127.0,127.0,5,1111,15.0,843.0,843.0
0.006,6,10,1689,5,839,1.0,571.0,571.0,5,850,1.0,582.0,582.0
0.016,6,10,1972,5,910,3.0,642.0,642.0,5,1062,4.0,794.0,794.0
0.005,6,10,1547,5,764,1.0,496.0,496.0,5,783,1.0,515.0,515.0
0.006,6,10,1547,5,764,1.0,496.0,496.0,5,783,1.0,515.0,515.0
0.005,6,10,2006,5,927,1.0,659.0,659.0,5,1079,1.0,811.0,811.0
0.001,17,2,180,1,66,0.0,38.0,38.0,1,114,0.0,86.0,86.0
0.04,17,2,184,1,61,0.0,33.0,33.0,1,123,0.0,95.0,95.0
366.913,6,22,2313,16,867,24460.0,195.0,195.0,6,1446,4635.0,419.0,398.0
0.023,6,10,1631,5,848,5.0,580.0,580.0,5,783,5.0,515.0,515.0
0.022,6,10,1989,5,910,5.0,642.0,642.0,5,1079,5.0,811.0,811.0
0.001,17,2,180,1,66,0.0,38.0,38.0,1,114,0.0,86.0,86.0
0.009,6,10,1990,5,911,2.0,643.0,643.0,5,1079,2.0,811.0,811.0
0.04,17,2,148,1,60,0.0,32.0,32.0,1,88,0.0,60.0,60.0
240.015,6,9,787,5,488,60003.0,232.0,232.0,4,299,80003.0,83.0,83.0
0.005,17,2,170,1,65,0.0,37.0,37.0,1,105,0.0,77.0,77.0
0.012,6,10,1983,5,910,3.0,642.0,642.0,5,1073,3.0,805.0,805.0
0.01,6,10,1990,5,911,2.0,643.0,643.0,5,1079,2.0,811.0,811.0
0.005,6,10,2006,5,927,1.0,659.0,659.0,5,1079,1.0,811.0,811.0
0.004,17,2,148,1,60,0.0,32.0,32.0,1,88,0.0,60.0,60.0
40.063,17,10,676,5,460,10013.0,104.0,64.0,5,216,10015.0,20.0,15.0
0.001,17,2,166,1,75,0.0,47.0,47.0,1,91,0.0,63.0,63.0
0.067,6,10,1506,5,395,14.0,127.0,127.0,5,1111,14.0,843.0,843.0
0.005,6,10,2007,5,928,1.0,660.0,660.0,5,1079,1.0,811.0,811.0
0.085,6,10,1506,5,395,17.0,127.0,127.0,5,1111,18.0,843.0,843.0
0.01,6,10,1983,5,910,2.0,642.0,642.0,5,1073,2.0,805.0,805.0
0.005,6,10,1643,5,860,1.0,592.0,592.0,5,783,1.0,515.0,515.0
1799.149,17,2993,225242,1490,119253,1208.0,82.0,52.0,1503,105989,1197.0,226.0,42.0
0.037,17,4,284,2,120,0.0,32.0,32.0,2,164,35.0,60.0,54.0
0.005,6,10,2006,5,927,1.0,659.0,659.0,5,1079,1.0,811.0,811.0
0.01,6,10,2007,5,928,2.0,660.0,660.0,5,1079,2.0,811.0,811.0
0.04,17,2,156,1,64,0.0,36.0,36.0,1,92,0.0,64.0,64.0
0.009,6,13,3735,7,497,1.0,125.0,125.0,6,3238,1.0,1470.0,1459.0
0.005,6,10,2006,5,927,1.0,659.0,659.0,5,1079,1.0,811.0,811.0
0.018,6,10,1631,5,848,4.0,580.0,580.0,5,783,4.0,515.0,515.0
0.003,17,2,148,1,60,0.0,32.0,32.0,1,88,0.0,60.0,60.0
0.005,6,13,3747,7,509,0.0,137.0,137.0,6,3238,1.0,1470.0,1459.0
0.003,17,2,148,1,60,0.0,32.0,32.0,1,88,0.0,60.0,60.0
0.116,6,10,1506,5,395,26.0,127.0,127.0,5,1111,25.0,843.0,843.0
0.005,6,10,2007,5,928,1.0,660.0,660.0,5,1079,1.0,811.0,811.0
0.004,17,4,284,2,120,1.0,32.0,32.0,2,164,0.0,60.0,54.0
0.006,6,10,1547,5,764,1.0,496.0,496.0,5,783,1.0,515.0,515.0
0.068,6,10,1506,5,395,15.0,127.0,127.0,5,1111,14.0,843.0,843.0
40.021,17,10,676,5,460,10003.0,104.0,64.0,5,216,10004.0,20.0,15.0
0.014,6,10,1990,5,911,3.0,643.0,643.0,5,1079,3.0,811.0,811.0
0.008,6,10,1990,5,911,2.0,643.0,643.0,5,1079,1.0,811.0,811.0
0.127,6,10,1506,5,395,22.0,127.0,127.0,5,1111,30.0,843.0,843.0
0.007,17,2,132,1,58,0.0,30.0,30.0,1,74,0.0,46.0,46.0
0.042,17,4,284,2,120,0.0,32.0,32.0,2,164,5.0,60.0,54.0
0.025,6,10,1983,5,910,6.0,642.0,642.0,5,1073,6.0,805.0,805.0
0.013,6,10,1989,5,910,3.0,642.0,642.0,5,1079,3.0,811.0,811.0
0.006,6,10,1854,5,889,1.0,621.0,621.0,5,965,1.0,697.0,697.0
0.006,6,10,2000,5,927,1.0,659.0,659.0,5,1073,1.0,805.0,805.0
11.012,17,28,4422,14,1994,838.0,269.0,114.0,14,2428,838.0,587.0,145.0
0.005,6,10,2007,5,928,1.0,660.0,660.0,5,1079,1.0,811.0,811.0
240.012,6,9,787,5,488,60003.0,232.0,232.0,4,299,80002.0,83.0,83.0
0.005,6,10,2000,5,927,1.0,659.0,659.0,5,1073,1.0,805.0,805.0
0.167,6,10,1506,5,395,40.0,127.0,127.0,5,1111,39.0,843.0,843.0
0.011,6,10,1989,5,910,2.0,642.0,642.0,5,1079,2.0,811.0,811.0
0.005,6,10,1689,5,839,1.0,571.0,571.0,5,850,1.0,582.0,582.0
0.042,17,4,284,2,120,0.0,32.0,32.0,2,164,29.0,60.0,54.0
0.005,17,2,144,1,64,0.0,36.0,36.0,1,80,0.0,52.0,52.0
0.083,6,10,1506,5,395,18.0,127.0,127.0,5,1111,19.0,843.0,843.0
0.01,6,10,1989,5,910,2.0,642.0,642.0,5,1079,2.0,811.0,811.0
0.005,6,10,2000,5,927,1.0,659.0,659.0,5,1073,1.0,805.0,805.0
0.005,6,10,2000,5,927,1.0,659.0,659.0,5,1073,1.0,805.0,805.0
0.084,6,10,1506,5,395,17.0,127.0,127.0,5,1111,20.0,843.0,843.0
0.021,6,10,1677,5,827,5.0,559.0,559.0,5,850,5.0,582.0,582.0
0.117,6,10,1506,5,395,25.0,127.0,127.0,5,1111,24.0,843.0,843.0
0.01,6,10,1989,5,910,2.0,642.0,642.0,5,1079,2.0,811.0,811.0
0.102,6,10,1506,5,395,18.0,127.0,127.0,5,1111,23.0,843.0,843.0
0.075,6,10,1506,5,395,14.0,127.0,127.0,5,1111,17.0,843.0,843.0
0.004,17,2,148,1,60,0.0,32.0,32.0,1,88,0.0,60.0,60.0
177.431,17,84,11858,42,2803,4327.0,44.0,38.0,42,9055,4327.0,239.0,187.0
0.004,6,10,1779,5,928,1.0,660.0,660.0,5,851,1.0,583.0,583.0
0.006,17,2,230,1,68,0.0,40.0,40.0,1,162,0.0,134.0,134.0
301.273,6,32,9492,18,2979,17721.0,990.0,407.0,14,6513,23174.0,1591.0,723.0
0.008,17,2,179,1,71,0.0,43.0,43.0,1,108,0.0,80.0,80.0
0.064,6,10,1506,5,395,13.0,127.0,127.0,5,1111,14.0,843.0,843.0
0.004,6,10,1702,5,863,1.0,595.0,595.0,5,839,0.0,571.0,571.0
0.005,6,14,3736,7,446,0.0,74.0,74.0,7,3290,0.0,1448.0,972.0
0.088,6,10,1506,5,395,19.0,127.0,127.0,5,1111,18.0,843.0,843.0
0.015,6,10,1762,5,911,3.0,643.0,643.0,5,851,3.0,583.0,583.0
0.02,6,10,1989,5,910,5.0,642.0,642.0,5,1079,4.0,811.0,811.0
0.016,6,10,1990,5,911,4.0,643.0,643.0,5,1079,4.0,811.0,811.0
0.005,6,10,1774,5,923,1.0,655.0,655.0,5,851,1.0,583.0,583.0
0.102,6,10,1506,5,395,21.0,127.0,127.0,5,1111,23.0,843.0,843.0
0.005,6,10,1989,5,927,1.0,659.0,659.0,5,1062,1.0,794.0,794.0
0.093,6,10,1506,5,395,20.0,127.0,127.0,5,1111,21.0,843.0,843.0
0.133,6,10,1506,5,395,31.0,127.0,127.0,5,1111,29.0,843.0,843.0
40.056,17,10,676,5,460,10011.0,104.0,64.0,5,216,10013.0,20.0,15.0
0.005,6,13,3747,7,509,0.0,137.0,137.0,6,3238,0.0,1470.0,1459.0
0.005,6,10,1643,5,860,1.0,592.0,592.0,5,783,1.0,515.0,515.0
0.112,6,10,1506,5,395,23.0,127.0,127.0,5,1111,20.0,843.0,843.0
0.009,6,12,1926,6,1189,1.0,659.0,434.0,6,737,1.0,417.0,417.0
0.01,6,10,1677,5,827,2.0,559.0,559.0,5,850,2.0,582.0,582.0
0.005,6,10,1989,5,927,1.0,659.0,659.0,5,1062,1.0,794.0,794.0
10.918,17,28,4423,14,1994,831.0,269.0,114.0,14,2429,831.0,588.0,145.0
0.005,6,10,1774,5,923,1.0,655.0,655.0,5,851,1.0,583.0,583.0
0.093,6,10,1506,5,395,22.0,127.0,127.0,5,1111,21.0,843.0,843.0
0.067,17,8,3613,4,1874,22.0,1350.0,440.0,4,1739,11.0,1350.0,406.0
0.007,17,2,194,1,59,0.0,31.0,31.0,1,135,0.0,107.0,107.0
0.005,6,10,2007,5,928,1.0,660.0,660.0,5,1079,1.0,811.0,811.0
0.005,6,10,2000,5,927,1.0,659.0,659.0,5,1073,1.0,805.0,805.0
0.006,17,2,170,1,65,0.0,37.0,37.0,1,105,0.0,77.0,77.0
0.006,6,10,1547,5,764,1.0,496.0,496.0,5,783,1.0,515.0,515.0
0.004,6,10,1702,5,863,1.0,595.0,595.0,5,839,0.0,571.0,571.0
0.006,17,2,225,1,65,0.0,37.0,37.0,1,160,0.0,132.0,132.0
0.005,6,10,2000,5,927,1.0,659.0,659.0,5,1073,1.0,805.0,805.0
0.005,6,10,1702,5,863,1.0,595.0,595.0,5,839,1.0,571.0,571.0
0.038,17,4,284,2,120,0.0,32.0,32.0,2,164,34.0,60.0,54.0
0.002,17,2,180,1,66,0.0,38.0,38.0,1,114,0.0,86.0,86.0
0.019,6,10,1989,5,910,4.0,642.0,642.0,5,1079,4.0,811.0,811.0
0.107,6,10,1506,5,395,25.0,127.0,127.0,5,1111,25.0,843.0,843.0
0.001,17,2,180,1,66,0.0,38.0,38.0,1,114,0.0,86.0,86.0
0.015,6,10,1972,5,910,3.0,642.0,642.0,5,1062,3.0,794.0,794.0
0.011,6,10,1972,5,910,2.0,642.0,642.0,5,1062,2.0,794.0,794.0
240.02,6,9,787,5,488,60005.0,232.0,232.0,4,299,80005.0,83.0,83.0
0.138,17,4,596,2,122,67.0,33.0,33.0,2,474,98.0,323.0,209.0
0.168,6,10,1506,5,395,28.0,127.0,127.0,5,1111,39.0,843.0,843.0
0.004,17,4,284,2,120,0.0,32.0,32.0,2,164,0.0,60.0,54.0
0.015,6,13,3913,7,495,2.0,123.0,123.0,6,3418,2.0,1650.0,1549.0
0.004,6,10,2007,5,928,1.0,660.0,660.0,5,1079,1.0,811.0,811.0
0.008,6,10,1689,5,839,2.0,571.0,571.0,5,850,1.0,582.0,582.0
0.003,17,4,284,2,120,0.0,32.0,32.0,2,164,0.0,60.0,54.0
0.004,6,10,2007,5,928,1.0,660.0,660.0,5,1079,1.0,811.0,811.0
0.019,6,10,1972,5,910,4.0,642.0,642.0,5,1062,4.0,794.0,794.0
0.005,17,2,170,1,65,0.0,37.0,37.0,1,105,0.0,77.0,77.0
0.006,6,10,1779,5,928,1.0,660.0,660.0,5,851,1.0,583.0,583.0
0.026,6,13,3735,7,497,4.0,125.0,125.0,6,3238,5.0,1470.0,1459.0
0.005,6,10,1989,5,927,1.0,659.0,659.0,5,1062,1.0,794.0,794.0
0.005,6,13,3690,7,452,0.0,80.0,80.0,6,3238,1.0,1470.0,1459.0
0.016,6,10,1989,5,910,4.0,642.0,642.0,5,1079,4.0,811.0,811.0
0.007,17,2,179,1,71,0.0,43.0,43.0,1,108,0.0,80.0,80.0
0.006,6,10,1547,5,764,1.0,496.0,496.0,5,783,1.0,515.0,515.0
0.008,6,12,1926,6,1189,1.0,659.0,434.0,6,737,1.0,417.0,417.0
0.005,6,10,1989,5,927,1.0,659.0,659.0,5,1062,1.0,794.0,794.0
0.095,6,10,1506,5,395,20.0,127.0,127.0,5,1111,20.0,843.0,843.0
0.072,17,2,412,1,61,0.0,33.0,33.0,1,351,0.0,323.0,323.0
0.01,6,10,1990,5,911,2.0,643.0,643.0,5,1079,2.0,811.0,811.0
0.139,6,10,1506,5,395,32.0,127.0,127.0,5,1111,31.0,843.0,843.0
0.005,6,10,2006,5,927,1.0,659.0,659.0,5,1079,1.0,811.0,811.0
0.001,17,2,180,1,66,0.0,38.0,38.0,1,114,0.0,86.0,86.0
0.004,6,10,2006,5,927,1.0,659.0,659.0,5,1079,1.0,811.0,811.0
366.446,6,22,2313,16,867,24429.0,195.0,195.0,6,1446,4637.0,419.0,398.0
0.094,6,10,1506,5,395,20.0,127.0,127.0,5,1111,20.0,843.0,843.0
0.005,17,2,136,1,60,0.0,32.0,32.0,1,76,0.0,48.0,48.0
0.003,17,2,185,1,73,0.0,45.0,45.0,1,112,0.0,84.0,84.0
0.004,6,10,1779,5,928,1.0,660.0,660.0,5,851,1.0,583.0,583.0
29.973,6,26,11203,13,1748,2497.0,538.0,350.0,13,9455,2497.0,2804.0,1096.0
40.064,17,10,676,5,460,10015.0,104.0,64.0,5,216,10014.0,20.0,15.0
0.087,6,10,1506,5,395,19.0,127.0,127.0,5,1111,20.0,843.0,843.0
164.389,17,74,10274,37,2456,4566.0,44.0,38.0,37,7818,4566.0,261.0,183.0
0.004,6,10,2000,5,927,1.0,659.0,659.0,5,1073,1.0,805.0,805.0
0.002,17,2,180,1,66,0.0,38.0,38.0,1,114,0.0,86.0,86.0
0.009,6,10,2006,5,927,2.0,659.0,659.0,5,1079,2.0,811.0,811.0
0.066,6,10,1506,5,395,15.0,127.0,127.0,5,1111,13.0,843.0,843.0
0.149,6,10,1506,5,395,32.0,127.0,127.0,5,1111,33.0,843.0,843.0
0.014,6,10,1762,5,911,3.0,643.0,643.0,5,851,3.0,583.0,583.0
0.009,6,10,1983,5,910,2.0,642.0,642.0,5,1073,2.0,805.0,805.0
0.002,17,2,136,1,60,0.0,32.0,32.0,1,76,0.0,48.0,48.0
0.005,17,2,293,1,73,0.0,45.0,45.0,1,220,0.0,192.0,192.0
0.001,17,2,136,1,60,0.0,32.0,32.0,1,76,0.0,48.0,48.0
0.132,6,10,1506,5,395,31.0,127.0,127.0,5,1111,29.0,843.0,843.0
0.023,6,10,1983,5,910,5.0,642.0,642.0,5,1073,5.0,805.0,805.0
0.004,6,10,2006,5,927,1.0,659.0,659.0,5,1079,1.0,811.0,811.0
0.005,6,10,1774,5,923,1.0,655.0,655.0,5,851,1.0,583.0,583.0
0.012,6,10,1989,5,910,2.0,642.0,642.0,5,1079,2.0,811.0,811.0
0.042,17,2,170,1,65,0.0,37.0,37.0,1,105,0.0,77.0,77.0
0.006,17,2,209,1,64,0.0,36.0,36.0,1,145,0.0,117.0,117.0
289.906,6,401,348699,195,21716,1494.0,2736.0,889.0,206,326983,1414.0,2804.0,1647.0
40.06,17,10,676,5,460,10013.0,104.0,64.0,5,216,10014.0,20.0,15.0
0.004,6,10,1702,5,863,1.0,595.0,595.0,5,839,1.0,571.0,571.0
167.254,17,88,12802,44,2957,3889.0,44.0,39.0,44,9845,3889.0,279.0,195.0
0.004,17,2,136,1,60,0.0,32.0,32.0,1,76,0.0,48.0,48.0
0.001,17,2,180,1,65,0.0,37.0,37.0,1,115,0.0,87.0,87.0
0.005,6,10,2000,5,927,1.0,659.0,659.0,5,1073,1.0,805.0,805.0
0.094,6,10,1506,5,395,21.0,127.0,127.0,5,1111,20.0,843.0,843.0
441.127,6,26,4253,12,3102,10911.0,494.0,494.0,14,1151,33932.0,83.0,83.0
1729.247,6,60,4400,40,2740,44339.0,33.0,33.0,20,1660,91004.0,31.0,31.0
0.009,6,10,1989,5,910,2.0,642.0,642.0,5,1079,2.0,811.0,811.0
0.005,6,10,2006,5,927,1.0,659.0,659.0,5,1079,1.0,811.0,811.0
360.035,6,21,3981,13,3142,30002.0,494.0,494.0,8,839,51433.0,83.0,83.0
0.11,6,10,1506,5,395,23.0,127.0,127.0,5,1111,23.0,843.0,843.0
0.005,6,10,2007,5,928,1.0,660.0,660.0,5,1079,1.0,811.0,811.0
0.004,6,10,1989,5,927,1.0,659.0,659.0,5,1062,1.0,794.0,794.0
0.113,6,10,1506,5,395,26.0,127.0,127.0,5,1111,24.0,843.0,843.0
0.087,6,10,1506,5,395,17.0,127.0,127.0,5,1111,19.0,843.0,843.0
0.002,17,2,180,1,66,0.0,38.0,38.0,1,114,0.0,86.0,86.0
0.015,6,10,1989,5,910,3.0,642.0,642.0,5,1079,3.0,811.0,811.0
0.006,6,10,1547,5,764,1.0,496.0,496.0,5,783,1.0,515.0,515.0
0.079,6,10,1506,5,395,16.0,127.0,127.0,5,1111,18.0,843.0,843.0
0.023,6,10,1990,5,911,5.0,643.0,643.0,5,1079,5.0,811.0,811.0
0.005,6,10,2000,5,927,1.0,659.0,659.0,5,1073,1.0,805.0,805.0
0.007,17,2,179,1,71,0.0,43.0,43.0,1,108,0.0,80.0,80.0
0.013,6,10,1677,5,827,3.0,559.0,559.0,5,850,3.0,582.0,582.0
0.006,6,10,1689,5,839,1.0,571.0,571.0,5,850,1.0,582.0,582.0
0.116,6,10,1506,5,395,24.0,127.0,127.0,5,1111,25.0,843.0,843.0
0.015,6,10,1631,5,848,3.0,580.0,580.0,5,783,3.0,515.0,515.0
240.098,6,16,4481,9,963,30012.0,238.0,166.0,7,3518,40015.0,1402.0,786.0
0.009,6,10,1677,5,827,2.0,559.0,559.0,5,850,2.0,582.0,582.0
0.041,17,2,152,1,76,0.0,48.0,48.0,1,76,0.0,48.0,48.0
40.066,17,10,676,5,460,10015.0,104.0,64.0,5,216,10015.0,20.0,15.0
0.005,6,10,1643,5,860,1.0,592.0,592.0,5,783,1.0,515.0,515.0
0.017,6,10,1990,5,911,4.0,643.0,643.0,5,1079,4.0,811.0,811.0
0.004,17,4,284,2,120,0.0,32.0,32.0,2,164,0.0,60.0,54.0
0.116,6,10,1506,5,395,23.0,127.0,127.0,5,1111,25.0,843.0,843.0
40.081,17,10,676,5,460,10019.0,104.0,64.0,5,216,10019.0,20.0,15.0
1792.682,6,287,27105,145,9980,12449.0,747.0,270.0,142,17125,12714.0,1625.0,72.0
0.007,6,10,1972,5,910,1.0,642.0,642.0,5,1062,1.0,794.0,794.0
0.01,6,13,3735,7,497,1.0,125.0,125.0,6,3238,2.0,1470.0,1459.0
0.07,6,10,1506,5,395,16.0,127.0,127.0,5,1111,14.0,843.0,843.0
0.15,6,10,1506,5,395,36.0,127.0,127.0,5,1111,34.0,843.0,843.0
291.075,6,396,347770,202,22066,1448.0,2736.0,888.0,194,325704,1508.0,2804.0,1753.0
0.005,6,14,3742,8,504,0.0,80.0,80.0,6,3238,0.0,1470.0,1459.0
0.006,6,10,1547,5,764,1.0,496.0,496.0,5,783,1.0,515.0,515.0
0.019,6,10,1989,5,910,4.0,642.0,642.0,5,1079,4.0,811.0,811.0
240.093,6,16,4482,9,963,30011.0,238.0,166.0,7,3519,40015.0,1402.0,786.0
40.087,17,10,676,5,460,10020.0,104.0,64.0,5,216,10021.0,20.0,15.0
0.016,6,10,1983,5,910,3.0,642.0,642.0,5,1073,4.0,805.0,805.0
15.086,17,14,7290,7,5219,2509.0,1350.0,717.0,7,2071,2509.0,1350.0,267.0
40.059,17,10,676,5,460,10012.0,104.0,64.0,5,216,10014.0,20.0,15.0
0.006,6,10,1547,5,764,1.0,496.0,496.0,5,783,1.0,515.0,515.0
309.304,17,20,1124,10,716,34352.0,48.0,43.0,10,408,34352.0,20.0,12.0
1.911,6,22,7705,12,1485,173.0,517.0,287.0,10,6220,18.0,1402.0,813.0
0.005,17,2,170,1,65,0.0,37.0,37.0,1,105,0.0,77.0,77.0
0.005,6,10,2006,5,927,1.0,659.0,659.0,5,1079,1.0,811.0,811.0
0.006,6,12,1698,6,863,1.0,327.0,271.0,6,835,1.0,515.0,515.0
0.07,17,8,3613,4,1874,23.0,1350.0,440.0,4,1739,11.0,1350.0,406.0
0.077,6,10,1506,5,395,17.0,127.0,127.0,5,1111,17.0,843.0,843.0
11.035,17,28,4398,14,2312,840.0,587.0,137.0,14,2086,840.0,269.0,121.0
0.005,6,10,2006,5,927,1.0,659.0,659.0,5,1079,1.0,811.0,811.0
0.011,6,10,1677,5,827,2.0,559.0,559.0,5,850,2.0,582.0,582.0
0.005,17,2,170,1,65,0.0,37.0,37.0,1,105,0.0,77.0,77.0
0.012,6,10,1990,5,911,3.0,643.0,643.0,5,1079,3.0,811.0,811.0
0.063,6,10,1506,5,395,12.0,127.0,127.0,5,1111,15.0,843.0,843.0
300.417,6,16,2170,9,684,37530.0,146.0,146.0,7,1486,50040.0,419.0,398.0
0.006,6,10,1643,5,860,1.0,592.0,592.0,5,783,1.0,515.0,515.0
0.005,6,10,2006,5,927,1.0,659.0,659.0,5,1079,1.0,811.0,811.0
0.001,17,2,180,1,66,0.0,38.0,38.0,1,114,0.0,86.0,86.0
0.007,6,10,1854,5,889,1.0,621.0,621.0,5,965,1.0,697.0,697.0
0.01,6,10,1972,5,910,2.0,642.0,642.0,5,1062,2.0,794.0,794.0
0.005,6,10,2007,5,928,1.0,660.0,660.0,5,1079,1.0,811.0,811.0
0.014,6,10,1990,5,911,3.0,643.0,643.0,5,1079,3.0,811.0,811.0
0.025,17,2,132,1,58,0.0,30.0,30.0,1,74,0.0,46.0,46.0
0.011,6,10,1990,5,911,2.0,643.0,643.0,5,1079,2.0,811.0,811.0
0.168,17,2,152,1,76,0.0,48.0,48.0,1,76,0.0,48.0,48.0
0.07,6,10,1506,5,395,15.0,127.0,127.0,5,1111,14.0,843.0,843.0
0.076,6,10,1506,5,395,16.0,127.0,127.0,5,1111,18.0,843.0,843.0
0.005,17,2,293,1,73,0.0,45.0,45.0,1,220,0.0,192.0,192.0
0.003,17,2,170,1,65,0.0,37.0,37.0,1,105,0.0,77.0,77.0
0.014,6,10,1631,5,848,3.0,580.0,580.0,5,783,3.0,515.0,515.0
0.008,6,10,1677,5,827,2.0,559.0,559.0,5,850,2.0,582.0,582.0
0.008,6,13,3747,7,509,1.0,137.0,137.0,6,3238,1.0,1470.0,1459.0
0.01,6,10,1989,5,910,2.0,642.0,642.0,5,1079,2.0,811.0,811.0
0.005,6,10,1989,5,927,1.0,659.0,659.0,5,1062,1.0,794.0,794.0
0.006,17,2,170,1,65,0.0,37.0,37.0,1,105,0.0,77.0,77.0
0.003,17,2,132,1,58,0.0,30.0,30.0,1,74,0.0,46.0,46.0
40.034,17,10,676,5,460,10007.0,104.0,64.0,5,216,10007.0,20.0,15.0
0.004,17,2,148,1,60,0.0,32.0,32.0,1,88,0.0,60.0,60.0
0.014,6,10,1983,5,910,3.0,642.0,642.0,5,1073,3.0,805.0,805.0
0.009,6,13,3735,7,497,1.0,125.0,125.0,6,3238,1.0,1470.0,1459.0
0.004,17,2,148,1,60,0.0,32.0,32.0,1,88,0.0,60.0,60.0
0.004,17,2,148,1,60,0.0,32.0,32.0,1,88,0.0,60.0,60.0
0.003,17,2,148,1,60,0.0,32.0,32.0,1,88,0.0,60.0,60.0
0.01,6,14,3787,7,497,1.0,125.0,125.0,7,3290,1.0,1448.0,972.0
0.005,6,10,1854,5,889,1.0,621.0,621.0,5,965,1.0,697.0,697.0
0.054,6,13,3735,7,497,8.0,125.0,125.0,6,3238,10.0,1470.0,1459.0
0.008,6,13,3735,7,497,1.0,125.0,125.0,6,3238,1.0,1470.0,1459.0
0.142,6,10,1506,5,395,32.0,127.0,127.0,5,1111,32.0,843.0,843.0
40.059,17,10,676,5,460,10013.0,104.0,64.0,5,216,10013.0,20.0,15.0
0.01,6,10,1631,5,848,2.0,580.0,580.0,5,783,2.0,515.0,515.0
0.04,17,4,284,2,120,1.0,32.0,32.0,2,164,36.0,60.0,54.0
0.005,6,10,1854,5,889,1.0,621.0,621.0,5,965,1.0,697.0,697.0
0.008,6,12,1926,6,1189,1.0,659.0,434.0,6,737,1.0,417.0,417.0
0.005,6,10,1989,5,927,1.0,659.0,659.0,5,1062,1.0,794.0,794.0
0.011,6,10,1972,5,910,2.0,642.0,642.0,5,1062,2.0,794.0,794.0
0.003,17,2,184,1,61,0.0,33.0,33.0,1,123,0.0,95.0,95.0
0.005,6,10,2007,5,928,1.0,660.0,660.0,5,1079,1.0,811.0,811.0
15.072,17,14,9190,8,6902,2149.0,1350.0,834.0,6,2288,3008.0,1350.0,353.0
0.116,6,10,1506,5,395,23.0,127.0,127.0,5,1111,26.0,843.0,843.0
0.005,6,10,1779,5,928,1.0,660.0,660.0,5,851,1.0,583.0,583.0
0.013,17,2,152,1,56,0.0,28.0,28.0,1,96,0.0,68.0,68.0
0.01,6,10,1989,5,910,2.0,642.0,642.0,5,1079,2.0,811.0,811.0
0.005,17,2,166,1,75,0.0,47.0,47.0,1,91,0.0,63.0,63.0
1791.539,6,485,98733,244,87503,7372.0,421.0,368.0,241,11230,7464.0,53.0,53.0
0.009,6,12,1926,6,1189,1.0,659.0,434.0,6,737,1.0,417.0,417.0
0.001,17,2,180,1,66,0.0,38.0,38.0,1,114,0.0,86.0,86.0
0.015,6,10,1989,5,910,3.0,642.0,642.0,5,1079,3.0,811.0,811.0
0.003,17,2,132,1,58,0.0,30.0,30.0,1,74,0.0,46.0,46.0
0.011,6,10,1989,5,910,2.0,642.0,642.0,5,1079,2.0,811.0,811.0
0.222,6,16,2670,8,1396,31.0,533.0,324.0,8,1274,20.0,529.0,212.0
0.004,17,2,170,1,65,0.0,37.0,37.0,1,105,0.0,77.0,77.0
0.168,17,2,152,1,76,0.0,48.0,48.0,1,76,0.0,48.0,48.0
0.009,6,10,1989,5,910,2.0,642.0,642.0,5,1079,2.0,811.0,811.0
40.068,17,10,676,5,460,10016.0,104.0,64.0,5,216,10016.0,20.0,15.0
0.116,6,10,1506,5,395,26.0,127.0,127.0,5,1111,27.0,843.0,843.0
0.013,6,10,1631,5,848,3.0,580.0,580.0,5,783,3.0,515.0,515.0
0.005,6,10,2007,5,928,1.0,660.0,660.0,5,1079,1.0,811.0,811.0
0.008,6,10,2007,5,928,2.0,660.0,660.0,5,1079,2.0,811.0,811.0
0.02,17,2,214,1,75,0.0,47.0,47.0,1,139,0.0,111.0,111.0
0.074,6,10,1506,5,395,17.0,127.0,127.0,5,1111,12.0,843.0,843.0
0.009,6,12,1926,6,1189,1.0,659.0,434.0,6,737,1.0,417.0,417.0
0.012,6,10,1762,5,911,2.0,643.0,643.0,5,851,2.0,583.0,583.0
0.012,6,13,3735,7,497,1.0,125.0,125.0,6,3238,2.0,1470.0,1459.0
0.008,6,12,1926,6,1189,1.0,659.0,434.0,6,737,1.0,417.0,417.0
0.003,17,4,284,2,120,0.0,32.0,32.0,2,164,0.0,60.0,54.0
0.01,6,10,1631,5,848,2.0,580.0,580.0,5,783,2.0,515.0,515.0
11.113,17,28,4423,14,1994,842.0,269.0,114.0,14,2429,842.0,588.0,145.0
0.015,6,10,1972,5,910,3.0,642.0,642.0,5,1062,3.0,794.0,794.0
300.32,6,16,2170,9,684,37519.0,146.0,146.0,7,1486,50026.0,419.0,398.0
240.114,6,31,9170,15,6821,17151.0,1946.0,671.0,16,2349,16007.0,580.0,188.0
0.01,6,12,1926,6,1189,2.0,659.0,434.0,6,737,1.0,417.0,417.0
11.173,17,28,4417,14,1993,846.0,268.0,114.0,14,2424,846.0,587.0,145.0
0.005,6,13,3747,7,509,0.0,137.0,137.0,6,3238,1.0,1470.0,1459.0
0.128,17,2,136,1,60,0.0,32.0,32.0,1,76,0.0,48.0,48.0
0.011,6,10,1631,5,848,2.0,580.0,580.0,5,783,2.0,515.0,515.0
361.839,6,21,1793,16,1030,24122.0,190.0,190.0,5,763,60009.0,462.0,247.0
0.004,17,4,284,2,120,1.0,32.0,32.0,2,164,1.0,60.0,54.0
163.412,17,74,10653,37,2466,4539.0,44.0,38.0,37,8187,4539.0,239.0,193.0
0.008,6,10,1989,5,910,2.0,642.0,642.0,5,1079,1.0,811.0,811.0
0.116,6,10,1506,5,395,26.0,127.0,127.0,5,1111,25.0,843.0,843.0
0.005,6,10,2006,5,927,1.0,659.0,659.0,5,1079,1.0,811.0,811.0
1799.977,6,138,6704,77,3704,23683.0,39.0,39.0,61,3000,29995.0,35.0,35.0
0.095,6,10,1506,5,395,19.0,127.0,127.0,5,1111,22.0,843.0,843.0
0.013,17,2,194,1,59,0.0,31.0,31.0,1,135,0.0,107.0,107.0
0.006,6,14,3799,7,509,0.0,137.0,137.0,7,3290,0.0,1448.0,972.0
0.004,6,10,2006,5,927,1.0,659.0,659.0,5,1079,1.0,811.0,811.0
0.001,17,2,136,1,60,0.0,32.0,32.0,1,76,0.0,48.0,48.0
0.006,6,10,1643,5,860,1.0,592.0,592.0,5,783,1.0,515.0,515.0
0.001,17,2,180,1,66,0.0,38.0,38.0,1,114,0.0,86.0,86.0
1797.531,17,2946,225845,1466,118823,1226.0,84.0,53.0,1480,107022,1215.0,227.0,44.0
40.073,17,10,676,5,460,10017.0,104.0,64.0,5,216,10017.0,20.0,15.0
0.002,17,2,180,1,66,0.0,38.0,38.0,1,114,0.0,86.0,86.0
40.078,17,10,676,5,460,10018.0,104.0,64.0,5,216,10018.0,20.0,15.0
0.021,6,10,1605,5,388,5.0,120.0,120.0,5,1217,5.0,949.0,949.0
0.005,6,10,1689,5,839,1.0,571.0,571.0,5,850,1.0,582.0,582.0
0.005,6,10,1547,5,764,1.0,496.0,496.0,5,783,1.0,515.0,515.0
0.006,6,10,1689,5,839,1.0,571.0,571.0,5,850,1.0,582.0,582.0
0.005,6,13,3690,7,452,0.0,80.0,80.0,6,3238,1.0,1470.0,1459.0
290.707,6,384,347511,192,21553,1522.0,2736.0,889.0,192,325958,1522.0,2804.0,1775.0
0.006,6,10,1854,5,889,1.0,621.0,621.0,5,965,1.0,697.0,697.0
0.004,6,13,3747,7,509,0.0,137.0,137.0,6,3238,0.0,1470.0,1459.0
0.012,6,10,1990,5,911,3.0,643.0,643.0,5,1079,2.0,811.0,811.0
0.005,6,10,2006,5,927,1.0,659.0,659.0,5,1079,1.0,811.0,811.0
0.004,6,10,1774,5,923,1.0,655.0,655.0,5,851,1.0,583.0,583.0
40.065,17,10,676,5,460,10013.0,104.0,64.0,5,216,10015.0,20.0,15.0
0.005,17,2,222,1,65,0.0,37.0,37.0,1,157,0.0,129.0,129.0
0.001,17,2,180,1,66,0.0,38.0,38.0,1,114,0.0,86.0,86.0
0.005,6,13,3747,7,509,0.0,137.0,137.0,6,3238,1.0,1470.0,1459.0
0.014,6,10,1983,5,910,3.0,642.0,642.0,5,1073,3.0,805.0,805.0
40.056,17,10,676,5,460,10011.0,104.0,64.0,5,216,10013.0,20.0,15.0
0.084,6,10,1506,5,395,18.0,127.0,127.0,5,1111,18.0,843.0,843.0
0.005,6,13,3747,7,509,0.0,137.0,137.0,6,3238,0.0,1470.0,1459.0
0.006,6,10,2006,5,927,1.0,659.0,659.0,5,1079,1.0,811.0,811.0
40.065,17,10,676,5,460,10015.0,104.0,64.0,5,216,10015.0,20.0,15.0
0.005,6,10,2006,5,927,1.0,659.0,659.0,5,1079,1.0,811.0,811.0
308.37,17,20,1124,10,716,34253.0,48.0,43.0,10,408,34253.0,20.0,12.0
0.005,6,10,1547,5,764,1.0,496.0,496.0,5,783,1.0,515.0,515.0
0.005,6,10,2007,5,928,1.0,660.0,660.0,5,1079,1.0,811.0,811.0
0.005,17,2,170,1,65,0.0,37.0,37.0,1,105,0.0,77.0,77.0
0.004,6,10,1989,5,927,1.0,659.0,659.0,5,1062,1.0,794.0,794.0
0.008,6,10,1972,5,910,1.0,642.0,642.0,5,1062,2.0,794.0,794.0
0.018,6,10,1989,5,910,4.0,642.0,642.0,5,1079,4.0,811.0,811.0
0.006,6,10,2006,5,927,1.0,659.0,659.0,5,1079,1.0,811.0,811.0
0.004,17,2,136,1,60,0.0,32.0,32.0,1,76,0.0,48.0,48.0
0.005,6,10,1547,5,764,1.0,496.0,496.0,5,783,1.0,515.0,515.0
0.005,17,2,170,1,65,0.0,37.0,37.0,1,105,0.0,77.0,77.0
9.038,17,6,376,5,280,2259.0,28.0,28.0,1,96,0.0,68.0,68.0
0.001,17,2,136,1,60,0.0,32.0,32.0,1,76,0.0,48.0,48.0
0.005,17,2,170,1,65,0.0,37.0,37.0,1,105,0.0,77.0,77.0
0.094,6,10,1506,5,395,19.0,127.0,127.0,5,1111,20.0,843.0,843.0
0.005,6,10,1689,5,839,1.0,571.0,571.0,5,850,1.0,582.0,582.0
0.006,6,10,1547,5,764,1.0,496.0,496.0,5,783,1.0,515.0,515.0
0.013,6,10,1972,5,910,3.0,642.0,642.0,5,1062,3.0,794.0,794.0
0.066,6,10,1506,5,395,14.0,127.0,127.0,5,1111,13.0,843.0,843.0
0.005,6,13,3747,7,509,0.0,137.0,137.0,6,3238,0.0,1470.0,1459.0
0.01,6,10,1989,5,910,2.0,642.0,642.0,5,1079,2.0,811.0,811.0
0.013,6,10,1989,5,910,3.0,642.0,642.0,5,1079,3.0,811.0,811.0
0.003,17,2,148,1,60,0.0,32.0,32.0,1,88,0.0,60.0,60.0
0.015,6,10,1989,5,910,3.0,642.0,642.0,5,1079,3.0,811.0,811.0
0.009,6,10,1972,5,910,2.0,642.0,642.0,5,1062,2.0,794.0,794.0
0.017,6,10,1990,5,911,4.0,643.0,643.0,5,1079,4.0,811.0,811.0
0.007,6,10,1547,5,764,1.0,496.0,496.0,5,783,1.0,515.0,515.0
40.056,17,10,676,5,460,10013.0,104.0,64.0,5,216,10012.0,20.0,15.0
0.006,17,2,178,1,81,0.0,53.0,53.0,1,97,0.0,69.0,69.0
40.081,17,10,676,5,460,10019.0,104.0,64.0,5,216,10019.0,20.0,15.0
40.066,17,10,676,5,460,10015.0,104.0,64.0,5,216,10015.0,20.0,15.0
0.018,6,13,3735,7,497,3.0,125.0,125.0,6,3238,3.0,1470.0,1459.0
0.018,6,10,1983,5,910,4.0,642.0,642.0,5,1073,4.0,805.0,805.0
0.004,6,10,1702,5,863,1.0,595.0,595.0,5,839,1.0,571.0,571.0
0.003,17,2,160,1,72,0.0,44.0,44.0,1,88,0.0,60.0,60.0
0.005,17,2,170,1,65,0.0,37.0,37.0,1,105,0.0,77.0,77.0
0.009,6,10,1990,5,911,2.0,643.0,643.0,5,1079,2.0,811.0,811.0
0.006,6,10,1689,5,839,1.0,571.0,571.0,5,850,1.0,582.0,582.0
0.008,6,10,1990,5,911,2.0,643.0,643.0,5,1079,2.0,811.0,811.0
0.152,6,10,1506,5,395,34.0,127.0,127.0,5,1111,33.0,843.0,843.0
0.013,6,10,1983,5,910,3.0,642.0,642.0,5,1073,3.0,805.0,805.0
0.012,6,10,1989,5,910,3.0,642.0,642.0,5,1079,3.0,811.0,811.0
0.006,6,10,2006,5,927,1.0,659.0,659.0,5,1079,1.0,811.0,811.0
0.004,6,14,3742,8,504,0.0,80.0,80.0,6,3238,0.0,1470.0,1459.0
0.006,6,10,1643,5,860,1.0,592.0,592.0,5,783,1.0,515.0,515.0
0.013,6,10,2006,5,927,3.0,659.0,659.0,5,1079,3.0,811.0,811.0
0.006,6,10,2000,5,927,1.0,659.0,659.0,5,1073,1.0,805.0,805.0
0.005,6,10,2006,5,927,1.0,659.0,659.0,5,1079,1.0,811.0,811.0
0.004,6,10,1989,5,927,1.0,659.0,659.0,5,1062,1.0,794.0,794.0
0.005,6,10,2007,5,928,1.0,660.0,660.0,5,1079,1.0,811.0,811.0
0.132,6,10,1506,5,395,28.0,127.0,127.0,5,1111,32.0,843.0,843.0
0.049,6,10,1506,5,395,11.0,127.0,127.0,5,1111,11.0,843.0,843.0
0.006,17,2,179,1,71,0.0,43.0,43.0,1,108,0.0,80.0,80.0
0.004,6,10,2006,5,927,1.0,659.0,659.0,5,1079,1.0,811.0,811.0
40.065,17,10,676,5,460,10013.0,104.0,64.0,5,216,10014.0,20.0,15.0
0.013,6,10,1972,5,910,3.0,642.0,642.0,5,1062,3.0,794.0,794.0
0.134,6,10,1506,5,395,30.0,127.0,127.0,5,1111,29.0,843.0,843.0
0.005,6,14,3799,7,509,0.0,137.0,137.0,7,3290,0.0,1448.0,972.0
0.017,6,10,1631,5,848,4.0,580.0,580.0,5,783,4.0,515.0,515.0
0.004,6,10,2007,5,928,1.0,660.0,660.0,5,1079,1.0,811.0,811.0
0.008,6,10,1677,5,827,2.0,559.0,559.0,5,850,2.0,582.0,582.0
40.06,17,10,676,5,460,10013.0,104.0,64.0,5,216,10014.0,20.0,15.0
864.457,6,74,30979,38,7366,23363.0,1173.0,538.0,36,23613,24698.0,1402.0,869.0
0.004,17,4,284,2,120,0.0,32.0,32.0,2,164,1.0,60.0,54.0
0.094,6,10,1506,5,395,22.0,127.0,127.0,5,1111,20.0,843.0,843.0
178.13,17,84,11686,42,2799,4344.0,44.0,38.0,42,8887,4344.0,249.0,183.0
0.005,17,2,144,1,64,0.0,36.0,36.0,1,80,0.0,52.0,52.0
0.005,6,10,2000,5,927,1.0,659.0,659.0,5,1073,1.0,805.0,805.0
0.006,6,10,1547,5,764,1.0,496.0,496.0,5,783,1.0,515.0,515.0
0.085,6,10,1506,5,395,20.0,127.0,127.0,5,1111,18.0,843.0,843.0
0.025,17,2,136,1,60,0.0,32.0,32.0,1,76,0.0,48.0,48.0
546.842,6,21,1795,16,1030,36456.0,190.0,190.0,5,765,60001.0,464.0,248.0
0.006,6,10,1689,5,839,1.0,571.0,571.0,5,850,1.0,582.0,582.0
0.008,6,10,1989,5,910,1.0,642.0,642.0,5,1079,1.0,811.0,811.0
0.013,6,10,1762,5,911,3.0,643.0,643.0,5,851,3.0,583.0,583.0
0.006,17,2,214,1,75,0.0,47.0,47.0,1,139,0.0,111.0,111.0
0.039,17,2,136,1,60,0.0,32.0,32.0,1,76,0.0,48.0,48.0
0.012,6,10,1990,5,911,2.0,643.0,643.0,5,1079,2.0,811.0,811.0
0.009,6,10,1990,5,911,2.0,643.0,643.0,5,1079,2.0,811.0,811.0
0.04,17,2,152,1,76,0.0,48.0,48.0,1,76,0.0,48.0,48.0
0.005,17,2,154,1,69,0.0,41.0,41.0,1,85,0.0,57.0,57.0
0.006,6,10,1547,5,764,1.0,496.0,496.0,5,783,1.0,515.0,515.0
0.011,6,14,3787,7,497,1.0,125.0,125.0,7,3290,1.0,1448.0,972.0
0.009,6,10,1989,5,910,2.0,642.0,642.0,5,1079,2.0,811.0,811.0
0.006,6,10,1547,5,764,1.0,496.0,496.0,5,783,1.0,515.0,515.0
0.018,6,10,1989,5,910,4.0,642.0,642.0,5,1079,4.0,811.0,811.0
0.008,6,10,1989,5,910,2.0,642.0,642.0,5,1079,1.0,811.0,811.0
0.005,6,10,1989,5,927,1.0,659.0,659.0,5,1062,1.0,794.0,794.0
0.014,6,10,1972,5,910,3.0,642.0,642.0,5,1062,3.0,794.0,794.0
0.018,6,10,1983,5,910,4.0,642.0,642.0,5,1073,4.0,805.0,805.0
0.005,6,10,2006,5,927,1.0,659.0,659.0,5,1079,1.0,811.0,811.0
240.159,6,44,6799,21,3168,12007.0,588.0,229.0,23,3631,10916.0,580.0,242.0
0.009,6,12,1926,6,1189,1.0,659.0,434.0,6,737,1.0,417.0,417.0
0.072,17,2,146,1,65,0.0,37.0,37.0,1,81,0.0,53.0,53.0
11.151,17,28,4423,14,1995,845.0,270.0,114.0,14,2428,845.0,587.0,145.0
242.043,6,310,343342,117,17597,2086.0,2736.0,885.0,193,325745,1260.0,2804.0,1725.0
40.087,17,10,676,5,460,10021.0,104.0,64.0,5,216,10021.0,20.0,15.0
0.005,6,10,2006,5,927,1.0,659.0,659.0,5,1079,1.0,811.0,811.0
0.016,6,10,1631,5,848,4.0,580.0,580.0,5,783,4.0,515.0,515.0
0.098,6,10,1506,5,395,24.0,127.0,127.0,5,1111,19.0,843.0,843.0
0.005,17,2,166,1,75,0.0,47.0,47.0,1,91,0.0,63.0,63.0
0.097,6,10,1506,5,395,21.0,127.0,127.0,5,1111,23.0,843.0,843.0
0.005,17,2,169,1,62,0.0,34.0,34.0,1,107,0.0,79.0,79.0
0.004,6,10,2006,5,927,1.0,659.0,659.0,5,1079,1.0,811.0,811.0
0.004,6,10,1989,5,927,1.0,659.0,659.0,5,1062,1.0,794.0,794.0
0.004,17,2,132,1,58,0.0,30.0,30.0,1,74,0.0,46.0,46.0
0.039,17,2,148,1,60,0.0,32.0,32.0,1,88,0.0,60.0,60.0
0.005,17,2,180,1,66,0.0,38.0,38.0,1,114,0.0,86.0,86.0
0.003,17,2,148,1,60,0.0,32.0,32.0,1,88,0.0,60.0,60.0
0.133,6,10,1506,5,395,31.0,127.0,127.0,5,1111,28.0,843.0,843.0
0.011,6,10,1990,5,911,2.0,643.0,643.0,5,1079,2.0,811.0,811.0
0.003,17,4,284,2,120,0.0,32.0,32.0,2,164,0.0,60.0,54.0
0.009,6,12,1926,6,1189,1.0,659.0,434.0,6,737,1.0,417.0,417.0
0.005,6,10,1854,5,889,1.0,621.0,621.0,5,965,1.0,697.0,697.0
0.008,6,10,1990,5,911,2.0,643.0,643.0,5,1079,1.0,811.0,811.0
0.087,6,10,1506,5,395,17.0,127.0,127.0,5,1111,18.0,843.0,843.0
240.091,6,30,9473,15,7039,17149.0,2164.0,695.0,15,2434,17149.0,580.0,205.0
15.073,17,15,9239,8,6902,2149.0,1350.0,834.0,7,2337,2507.0,1350.0,305.0
0.005,6,10,1643,5,860,1.0,592.0,592.0,5,783,1.0,515.0,515.0
11.014,17,28,4423,14,1995,838.0,270.0,114.0,14,2428,838.0,587.0,145.0
0.006,6,10,1689,5,839,1.0,571.0,571.0,5,850,1.0,582.0,582.0
0.037,17,4,284,2,120,0.0,32.0,32.0,2,164,33.0,60.0,54.0
0.115,6,10,1506,5,395,24.0,127.0,127.0,5,1111,25.0,843.0,843.0
0.005,6,10,2006,5,927,1.0,659.0,659.0,5,1079,1.0,811.0,811.0
0.006,17,2,136,1,60,0.0,32.0,32.0,1,76,0.0,48.0,48.0
0.011,6,10,1990,5,911,2.0,643.0,643.0,5,1079,2.0,811.0,811.0
15.212,17,18,8786,9,6472,1898.0,1350.0,691.0,9,2314,1897.0,1350.0,229.0
0.097,6,10,1506,5,395,23.0,127.0,127.0,5,1111,22.0,843.0,843.0
0.006,6,10,1547,5,764,1.0,496.0,496.0,5,783,1.0,515.0,515.0
169.094,17,70,10120,35,2332,4973.0,44.0,38.0,35,7788,4973.0,260.0,194.0
0.005,6,10,2006,5,927,1.0,659.0,659.0,5,1079,1.0,811.0,811.0
0.058,17,2,152,1,76,0.0,48.0,48.0,1,76,0.0,48.0,48.0
0.083,6,10,1506,5,395,18.0,127.0,127.0,5,1111,14.0,843.0,843.0
0.006,17,2,273,1,66,0.0,38.0,38.0,1,207,0.0,179.0,179.0
0.008,6,12,1926,6,1189,1.0,659.0,434.0,6,737,1.0,417.0,417.0
0.004,17,2,170,1,65,0.0,37.0,37.0,1,105,0.0,77.0,77.0
0.006,6,10,1689,5,839,1.0,571.0,571.0,5,850,1.0,582.0,582.0
0.015,6,10,1972,5,910,3.0,642.0,642.0,5,1062,3.0,794.0,794.0
300.874,6,41,11444,22,5841,14327.0,4080.0,983.0,19,5603,482.0,2667.0,402.0
0.004,6,10,1989,5,927,1.0,659.0,659.0,5,1062,1.0,794.0,794.0
0.005,6,10,2007,5,928,1.0,660.0,660.0,5,1079,1.0,811.0,811.0
308.424,17,20,1124,10,716,34255.0,48.0,43.0,10,408,34255.0,20.0,12.0
9.037,17,6,376,5,280,2259.0,28.0,28.0,1,96,0.0,68.0,68.0
0.01,6,10,1677,5,827,2.0,559.0,559.0,5,850,2.0,582.0,582.0
0.111,6,10,1506,5,395,24.0,127.0,127.0,5,1111,26.0,843.0,843.0
0.011,6,10,1972,5,910,2.0,642.0,642.0,5,1062,2.0,794.0,794.0
40.059,17,10,676,5,460,10013.0,104.0,64.0,5,216,10013.0,20.0,15.0
240.096,6,30,9113,15,6867,17149.0,1992.0,676.0,15,2246,17149.0,580.0,182.0
0.006,6,10,1547,5,764,1.0,496.0,496.0,5,783,1.0,515.0,515.0
0.004,17,2,142,1,63,0.0,35.0,35.0,1,79,0.0,51.0,51.0
0.007,17,2,230,1,68,0.0,40.0,40.0,1,162,0.0,134.0,134.0
0.073,6,10,1506,5,395,16.0,127.0,127.0,5,1111,15.0,843.0,843.0
0.013,6,10,1990,5,911,3.0,643.0,643.0,5,1079,3.0,811.0,811.0
0.095,6,10,1506,5,395,21.0,127.0,127.0,5,1111,23.0,843.0,843.0
0.121,6,10,1506,5,395,26.0,127.0,127.0,5,1111,25.0,843.0,843.0
0.013,6,10,1989,5,910,3.0,642.0,642.0,5,1079,3.0,811.0,811.0
163.368,17,84,12014,42,2804,3984.0,44.0,38.0,42,9210,3984.0,239.0,191.0
0.145,6,10,1506,5,395,31.0,127.0,127.0,5,1111,32.0,843.0,843.0
462.699,6,29,8141,15,3116,33049.0,676.0,388.0,14,5025,30973.0,1402.0,612.0
0.004,6,10,2006,5,927,1.0,659.0,659.0,5,1079,1.0,811.0,811.0
0.005,6,10,1547,5,764,1.0,496.0,496.0,5,783,1.0,515.0,515.0
0.04,17,2,412,1,61,0.0,33.0,33.0,1,351,0.0,323.0,323.0
0.004,17,2,136,1,60,0.0,32.0,32.0,1,76,0.0,48.0,48.0
269.874,6,63,51344,32,3205,8705.0,1229.0,380.0,31,48139,8995.0,3763.0,1789.0
0.085,6,10,1506,5,395,18.0,127.0,127.0,5,1111,15.0,843.0,843.0
0.045,17,2,148,1,60,0.0,32.0,32.0,1,88,0.0,60.0,60.0
0.005,6,10,2000,5,927,1.0,659.0,659.0,5,1073,1.0,805.0,805.0
0.091,6,10,1506,5,395,16.0,127.0,127.0,5,1111,21.0,843.0,843.0
0.007,6,10,1547,5,764,1.0,496.0,496.0,5,783,1.0,515.0,515.0
0.005,6,13,3747,7,509,0.0,137.0,137.0,6,3238,0.0,1470.0,1459.0
0.008,17,2,179,1,71,0.0,43.0,43.0,1,108,0.0,80.0,80.0
0.151,6,10,1506,5,395,37.0,127.0,127.0,5,1111,36.0,843.0,843.0
0.091,6,10,1506,5,395,19.0,127.0,127.0,5,1111,20.0,843.0,843.0
0.004,6,10,1774,5,923,1.0,655.0,655.0,5,851,1.0,583.0,583.0
0.009,6,10,1990,5,911,2.0,643.0,643.0,5,1079,2.0,811.0,811.0
0.007,6,10,1547,5,764,1.0,496.0,496.0,5,783,1.0,515.0,515.0
0.001,17,2,178,1,81,0.0,53.0,53.0,1,97,0.0,69.0,69.0
0.005,6,10,2006,5,927,1.0,659.0,659.0,5,1079,1.0,811.0,811.0
0.064,6,10,1506,5,395,15.0,127.0,127.0,5,1111,11.0,843.0,843.0
0.006,6,10,2007,5,928,1.0,660.0,660.0,5,1079,1.0,811.0,811.0
0.097,6,10,1506,5,395,23.0,127.0,127.0,5,1111,21.0,843.0,843.0
0.046,17,2,152,1,76,0.0,48.0,48.0,1,76,0.0,48.0,48.0
40.076,17,10,676,5,460,10016.0,104.0,64.0,5,216,10018.0,20.0,15.0
0.001,17,2,164,1,74,0.0,46.0,46.0,1,90,0.0,62.0,62.0
0.154,6,10,1506,5,395,34.0,127.0,127.0,5,1111,34.0,843.0,843.0
242.107,6,306,343256,127,18107,1921.0,2736.0,958.0,179,325149,1360.0,2769.0,1868.0
0.005,17,2,273,1,66,0.0,38.0,38.0,1,207,0.0,179.0,179.0
1770.601,17,120,11460,60,5460,30009.0,63.0,63.0,60,6000,30009.0,72.0,72.0
0.009,6,13,3735,7,497,1.0,125.0,125.0,6,3238,1.0,1470.0,1459.0
0.077,6,10,1506,5,395,16.0,127.0,127.0,5,1111,16.0,843.0,843.0
240.093,6,16,4482,9,963,30011.0,238.0,166.0,7,3519,40014.0,1402.0,786.0
15.097,17,15,9238,8,6902,2149.0,1350.0,834.0,7,2336,2510.0,1350.0,305.0
0.066,6,10,1506,5,395,14.0,127.0,127.0,5,1111,15.0,843.0,843.0
0.139,6,10,1506,5,395,28.0,127.0,127.0,5,1111,29.0,843.0,843.0
0.001,17,2,180,1,66,0.0,38.0,38.0,1,114,0.0,86.0,86.0
174.045,17,76,10792,38,2529,4703.0,44.0,38.0,38,8263,4703.0,239.0,189.0
0.037,17,2,152,1,76,0.0,48.0,48.0,1,76,0.0,48.0,48.0
0.005,6,10,2006,5,927,1.0,659.0,659.0,5,1079,1.0,811.0,811.0
389.497,17,152,21492,76,5143,5193.0,44.0,39.0,76,16349,5193.0,239.0,187.0
0.069,17,2,80,1,32,0.0,4.0,4.0,1,48,0.0,20.0,20.0
0.005,6,10,2006,5,927,1.0,659.0,659.0,5,1079,1.0,811.0,811.0
0.009,6,10,1983,5,910,2.0,642.0,642.0,5,1073,2.0,805.0,805.0
0.003,17,4,284,2,120,0.0,32.0,32.0,2,164,0.0,60.0,54.0
0.005,6,10,2000,5,927,1.0,659.0,659.0,5,1073,1.0,805.0,805.0
240.257,6,33,10000,16,2091,16016.0,539.0,250.0,17,7909,15015.0,1402.0,639.0
0.009,6,10,1972,5,910,2.0,642.0,642.0,5,1062,2.0,794.0,794.0
11.014,17,28,4422,14,1993,838.0,268.0,114.0,14,2429,838.0,588.0,145.0
0.008,6,10,1990,5,911,2.0,643.0,643.0,5,1079,2.0,811.0,811.0
0.014,6,10,1972,5,910,3.0,642.0,642.0,5,1062,3.0,794.0,794.0
0.012,17,2,138,1,61,0.0,33.0,33.0,1,77,0.0,49.0,49.0
0.099,6,10,1506,5,395,20.0,127.0,127.0,5,1111,23.0,843.0,843.0
0.041,6,3,210,2,132,41.0,28.0,28.0,1,78,0.0,26.0,26.0
0.005,6,10,1989,5,927,1.0,659.0,659.0,5,1062,1.0,794.0,794.0
40.084,17,10,676,5,460,10017.0,104.0,64.0,5,216,10020.0,20.0,15.0
15.07,17,14,9190,8,6902,2148.0,1350.0,834.0,6,2288,3008.0,1350.0,353.0
0.012,6,10,1989,5,910,3.0,642.0,642.0,5,1079,3.0,811.0,811.0
1786.358,6,240,46435,116,33958,15533.0,2473.0,929.0,124,12477,14523.0,580.0,62.0
0.087,6,10,1506,5,395,18.0,127.0,127.0,5,1111,20.0,843.0,843.0
0.004,6,10,2000,5,927,1.0,659.0,659.0,5,1073,1.0,805.0,805.0
0.004,6,10,1774,5,923,1.0,655.0,655.0,5,851,1.0,583.0,583.0
0.004,6,10,1989,5,927,1.0,659.0,659.0,5,1062,1.0,794.0,794.0
0.111,17,2,80,1,32,0.0,4.0,4.0,1,48,0.0,20.0,20.0
0.005,6,10,2007,5,928,1.0,660.0,660.0,5,1079,1.0,811.0,811.0
0.124,17,4,352,2,130,0.0,37.0,37.0,2,222,53.0,89.0,83.0
0.005,6,10,2006,5,927,1.0,659.0,659.0,5,1079,1.0,811.0,811.0
0.042,17,2,136,1,60,0.0,32.0,32.0,1,76,0.0,48.0,48.0
0.008,6,10,1989,5,910,2.0,642.0,642.0,5,1079,2.0,811.0,811.0
0.01,17,2,144,1,64,0.0,36.0,36.0,1,80,0.0,52.0,52.0
0.005,17,2,170,1,65,0.0,37.0,37.0,1,105,0.0,77.0,77.0
0.001,17,2,166,1,75,0.0,47.0,47.0,1,91,0.0,63.0,63.0
0.06,6,10,1506,5,395,14.0,127.0,127.0,5,1111,13.0,843.0,843.0
15.076,17,15,9239,8,6902,2149.0,1350.0,834.0,7,2337,2507.0,1350.0,305.0
0.125,6,10,1506,5,395,29.0,127.0,127.0,5,1111,26.0,843.0,843.0
0.004,17,2,148,1,60,0.0,32.0,32.0,1,88,0.0,60.0,60.0
300.32,6,16,2170,9,684,37518.0,146.0,146.0,7,1486,50024.0,419.0,398.0
0.041,17,2,152,1,76,0.0,48.0,48.0,1,76,0.0,48.0,48.0
0.1,6,10,1506,5,395,22.0,127.0,127.0,5,1111,23.0,843.0,843.0
0.005,6,10,1779,5,928,1.0,660.0,660.0,5,851,1.0,583.0,583.0
1761.54,6,592,195028,306,166438,5775.0,2883.0,885.0,286,28590,6180.0,580.0,124.0
0.008,6,10,1762,5,911,2.0,643.0,643.0,5,851,1.0,583.0,583.0
300.321,6,16,2170,9,684,37519.0,146.0,146.0,7,1486,50025.0,419.0,398.0
0.006,6,10,1854,5,889,1.0,621.0,621.0,5,965,1.0,697.0,697.0
0.008,17,2,164,1,74,0.0,46.0,46.0,1,90,0.0,62.0,62.0
0.016,6,10,1762,5,911,4.0,643.0,643.0,5,851,4.0,583.0,583.0
0.005,17,2,170,1,65,0.0,37.0,37.0,1,105,0.0,77.0,77.0
0.163,17,2,152,1,76,0.0,48.0,48.0,1,76,0.0,48.0,48.0
0.018,6,10,1762,5,911,4.0,643.0,643.0,5,851,4.0,583.0,583.0
0.121,6,10,1506,5,395,25.0,127.0,127.0,5,1111,22.0,843.0,843.0
40.07,17,10,676,5,460,10015.0,104.0,64.0,5,216,10016.0,20.0,15.0
0.042,17,2,152,1,76,0.0,48.0,48.0,1,76,0.0,48.0,48.0
0.005,6,10,2006,5,927,1.0,659.0,659.0,5,1079,1.0,811.0,811.0
0.006,6,10,1689,5,839,1.0,571.0,571.0,5,850,1.0,582.0,582.0
0.005,6,13,3690,7,452,0.0,80.0,80.0,6,3238,1.0,1470.0,1459.0
0.001,17,2,180,1,66,0.0,38.0,38.0,1,114,0.0,86.0,86.0
0.011,6,10,1972,5,910,2.0,642.0,642.0,5,1062,2.0,794.0,794.0
10.718,17,26,4102,13,1823,884.0,270.0,112.0,13,2279,884.0,586.0,147.0
0.005,6,10,1989,5,927,1.0,659.0,659.0,5,1062,1.0,794.0,794.0
0.007,6,10,1989,5,910,1.0,642.0,642.0,5,1079,1.0,811.0,811.0
0.005,6,10,1774,5,923,1.0,655.0,655.0,5,851,1.0,583.0,583.0
0.007,6,10,1990,5,911,1.0,643.0,643.0,5,1079,1.0,811.0,811.0
0.004,17,2,186,1,61,0.0,33.0,33.0,1,125,0.0,97.0,97.0
0.141,6,10,1506,5,395,33.0,127.0,127.0,5,1111,31.0,843.0,843.0
0.013,6,10,1983,5,910,3.0,642.0,642.0,5,1073,3.0,805.0,805.0
0.017,6,10,1677,5,827,4.0,559.0,559.0,5,850,4.0,582.0,582.0
0.009,6,10,1972,5,910,2.0,642.0,642.0,5,1062,2.0,794.0,794.0
0.005,17,2,230,1,68,0.0,40.0,40.0,1,162,0.0,134.0,134.0
0.006,6,10,2007,5,928,1.0,660.0,660.0,5,1079,1.0,811.0,811.0
0.066,6,10,1506,5,395,15.0,127.0,127.0,5,1111,15.0,843.0,843.0
240.158,6,48,6801,23,3316,10916.0,588.0,211.0,25,3485,10006.0,580.0,181.0
11.281,17,28,4418,14,1994,855.0,269.0,114.0,14,2424,855.0,587.0,145.0
0.012,6,10,1972,5,910,3.0,642.0,642.0,5,1062,2.0,794.0,794.0
0.102,6,10,1506,5,395,22.0,127.0,127.0,5,1111,23.0,843.0,843.0
0.008,6,10,1989,5,927,2.0,659.0,659.0,5,1062,2.0,794.0,794.0
0.081,6,10,1506,5,395,16.0,127.0,127.0,5,1111,18.0,843.0,843.0
0.102,6,10,1506,5,395,23.0,127.0,127.0,5,1111,22.0,843.0,843.0
0.005,6,10,2000,5,927,1.0,659.0,659.0,5,1073,1.0,805.0,805.0
0.005,6,10,2000,5,927,1.0,659.0,659.0,5,1073,1.0,805.0,805.0
3.465,17,6,312,3,184,1665.0,48.0,33.0,3,128,1665.0,20.0,14.0
0.071,6,10,1506,5,395,15.0,127.0,127.0,5,1111,16.0,843.0,843.0
0.005,6,10,1689,5,839,1.0,571.0,571.0,5,850,1.0,582.0,582.0
0.192,6,26,7379,13,3253,14.0,1402.0,428.0,13,4126,14.0,1324.0,688.0
0.018,6,10,1762,5,911,4.0,643.0,643.0,5,851,4.0,583.0,583.0
0.004,6,10,2007,5,928,1.0,660.0,660.0,5,1079,1.0,811.0,811.0
0.011,6,10,1677,5,827,2.0,559.0,559.0,5,850,2.0,582.0,582.0
2.156,6,34,8475,17,2085,134.0,517.0,237.0,17,6390,134.0,1402.0,548.0
367.142,6,22,2313,16,867,24476.0,195.0,195.0,6,1446,4635.0,419.0,398.0
240.013,6,9,787,5,488,60003.0,232.0,232.0,4,299,80003.0,83.0,83.0
0.005,6,10,2000,5,927,1.0,659.0,659.0,5,1073,1.0,805.0,805.0
0.001,17,2,179,1,62,0.0,34.0,34.0,1,117,0.0,89.0,89.0
0.005,6,10,1643,5,860,1.0,592.0,592.0,5,783,1.0,515.0,515.0
301.151,6,27,6643,13,2556,25095.0,676.0,372.0,14,4087,18552.0,1402.0,478.0
0.009,6,10,1762,5,911,2.0,643.0,643.0,5,851,2.0,583.0,583.0
0.016,6,10,1989,5,910,4.0,642.0,642.0,5,1079,3.0,811.0,811.0
0.011,6,10,1989,5,910,2.0,642.0,642.0,5,1079,2.0,811.0,811.0
0.101,6,10,1506,5,395,23.0,127.0,127.0,5,1111,23.0,843.0,843.0
0.005,6,10,2006,5,927,1.0,659.0,659.0,5,1079,1.0,811.0,811.0
0.016,17,2,198,1,91,0.0,63.0,63.0,1,107,0.0,79.0,79.0
0.037,17,2,148,1,60,0.0,32.0,32.0,1,88,0.0,60.0,60.0
0.005,6,10,1643,5,860,1.0,592.0,592.0,5,783,1.0,515.0,515.0
0.138,6,10,1506,5,395,30.0,127.0,127.0,5,1111,28.0,843.0,843.0
0.004,17,4,284,2,120,1.0,32.0,32.0,2,164,1.0,60.0,54.0
0.005,6,10,1989,5,927,1.0,659.0,659.0,5,1062,1.0,794.0,794.0
0.007,6,10,1779,5,928,1.0,660.0,660.0,5,851,1.0,583.0,583.0
0.213,17,4,352,2,130,176.0,37.0,37.0,2,222,141.0,89.0,83.0
0.072,6,10,1506,5,395,16.0,127.0,127.0,5,1111,13.0,843.0,843.0
0.018,6,10,1989,5,910,4.0,642.0,642.0,5,1079,4.0,811.0,811.0
40.092,17,10,676,5,460,10016.0,104.0,64.0,5,216,10022.0,20.0,15.0
0.041,17,2,136,1,60,0.0,32.0,32.0,1,76,0.0,48.0,48.0
0.023,6,10,1990,5,911,5.0,643.0,643.0,5,1079,5.0,811.0,811.0
0.006,6,10,1779,5,928,1.0,660.0,660.0,5,851,1.0,583.0,583.0
0.084,6,10,1506,5,395,20.0,127.0,127.0,5,1111,16.0,843.0,843.0
310.01,17,20,1124,10,716,34431.0,48.0,43.0,10,408,34431.0,20.0,12.0
0.004,6,15,3794,8,504,0.0,80.0,80.0,7,3290,0.0,1448.0,972.0
0.26,6,16,2669,8,1395,37.0,533.0,323.0,8,1274,25.0,529.0,212.0
0.082,6,10,1506,5,395,19.0,127.0,127.0,5,1111,16.0,843.0,843.0
0.14,6,10,1506,5,395,31.0,127.0,127.0,5,1111,32.0,843.0,843.0
11.233,17,28,4422,14,1994,851.0,269.0,114.0,14,2428,851.0,587.0,145.0
0.001,17,2,136,1,60,0.0,32.0,32.0,1,76,0.0,48.0,48.0
170.202,17,76,10879,38,2532,4599.0,44.0,38.0,38,8347,4599.0,239.0,191.0
0.004,6,10,1702,5,863,1.0,595.0,595.0,5,839,1.0,571.0,571.0
173.099,17,76,10864,38,2525,4678.0,44.0,38.0,38,8339,4678.0,239.0,191.0
0.077,6,10,1506,5,395,17.0,127.0,127.0,5,1111,15.0,843.0,843.0
0.001,17,2,180,1,66,0.0,38.0,38.0,1,114,0.0,86.0,86.0
10.744,17,28,4423,14,1995,818.0,270.0,114.0,14,2428,818.0,587.0,145.0
0.01,6,10,1989,5,910,2.0,642.0,642.0,5,1079,2.0,811.0,811.0
0.145,17,4,596,2,122,141.0,33.0,33.0,2,474,107.0,323.0,209.0
0.013,6,10,1990,5,911,3.0,643.0,643.0,5,1079,3.0,811.0,811.0
0.005,6,10,1989,5,927,1.0,659.0,659.0,5,1062,1.0,794.0,794.0
0.056,17,2,179,1,71,0.0,43.0,43.0,1,108,0.0,80.0,80.0
0.004,17,2,136,1,60,0.0,32.0,32.0,1,76,0.0,48.0,48.0
240.083,6,25,16058,13,1720,20006.0,770.0,349.0,12,14338,21825.0,2804.0,1522.0
0.012,6,10,1989,5,910,3.0,642.0,642.0,5,1079,2.0,811.0,811.0
0.037,6,10,1989,5,910,9.0,642.0,642.0,5,1079,9.0,811.0,811.0
0.071,6,10,1506,5,395,15.0,127.0,127.0,5,1111,15.0,843.0,843.0
0.009,6,10,1762,5,911,2.0,643.0,643.0,5,851,2.0,583.0,583.0
0.006,6,10,1989,5,927,1.0,659.0,659.0,5,1062,1.0,794.0,794.0
299.316,17,132,19104,66,4438,4604.0,44.0,39.0,66,14666,4604.0,261.0,194.0
0.02,6,10,1702,5,863,4.0,595.0,595.0,5,839,4.0,571.0,571.0
0.005,17,2,156,1,70,0.0,42.0,42.0,1,86,0.0,58.0,58.0
0.004,17,2,148,1,60,0.0,32.0,32.0,1,88,0.0,60.0,60.0
0.005,6,10,1779,5,928,1.0,660.0,660.0,5,851,1.0,583.0,583.0
308.528,17,20,1124,10,716,34274.0,48.0,43.0,10,408,34274.0,20.0,12.0
0.001,17,2,136,1,60,0.0,32.0,32.0,1,76,0.0,48.0,48.0
0.108,6,10,1506,5,395,25.0,127.0,127.0,5,1111,21.0,843.0,843.0
0.013,6,10,1990,5,911,3.0,643.0,643.0,5,1079,3.0,811.0,811.0
40.033,17,10,676,5,460,10007.0,104.0,64.0,5,216,10007.0,20.0,15.0
0.121,6,10,1506,5,395,23.0,127.0,127.0,5,1111,27.0,843.0,843.0
0.005,6,10,2006,5,927,1.0,659.0,659.0,5,1079,1.0,811.0,811.0
10.912,17,26,4074,13,2164,900.0,587.0,138.0,13,1910,900.0,269.0,118.0
40.049,17,10,676,5,460,10011.0,104.0,64.0,5,216,10011.0,20.0,15.0
0.073,6,10,1506,5,395,15.0,127.0,127.0,5,1111,15.0,843.0,843.0
0.105,6,10,1506,5,395,22.0,127.0,127.0,5,1111,25.0,843.0,843.0
0.005,6,10,2006,5,927,1.0,659.0,659.0,5,1079,1.0,811.0,811.0
0.005,17,2,140,1,62,0.0,34.0,34.0,1,78,0.0,50.0,50.0
15.074,17,15,9238,8,6902,2149.0,1350.0,834.0,7,2336,2507.0,1350.0,305.0
10.911,17,28,4421,14,1993,830.0,268.0,114.0,14,2428,830.0,587.0,145.0
40.065,17,10,676,5,460,10013.0,104.0,64.0,5,216,10015.0,20.0,15.0
0.001,17,2,180,1,66,0.0,38.0,38.0,1,114,0.0,86.0,86.0
0.003,17,2,136,1,60,0.0,32.0,32.0,1,76,0.0,48.0,48.0
0.019,6,10,1677,5,827,4.0,559.0,559.0,5,850,4.0,582.0,582.0
0.005,6,10,2000,5,927,1.0,659.0,659.0,5,1073,1.0,805.0,805.0
5.162,58,2,144,1,72,0.0,24.0,24.0,1,72,0.0,24.0,24.0
0.069,6,10,1506,5,395,14.0,127.0,127.0,5,1111,16.0,843.0,843.0
0.006,6,10,1547,5,764,1.0,496.0,496.0,5,783,1.0,515.0,515.0
0.014,6,10,1631,5,848,3.0,580.0,580.0,5,783,3.0,515.0,515.0
40.074,17,10,676,5,460,10015.0,104.0,64.0,5,216,10017.0,20.0,15.0
0.006,17,2,178,1,81,0.0,53.0,53.0,1,97,0.0,69.0,69.0
0.113,6,10,1506,5,395,23.0,127.0,127.0,5,1111,24.0,843.0,843.0
309.388,17,20,1124,10,716,34361.0,48.0,43.0,10,408,34361.0,20.0,12.0
0.004,6,10,2006,5,927,1.0,659.0,659.0,5,1079,1.0,811.0,811.0
9.036,17,6,376,5,280,2259.0,28.0,28.0,1,96,0.0,68.0,68.0
0.009,6,13,3735,7,497,1.0,125.0,125.0,6,3238,1.0,1470.0,1459.0
10.854,17,28,4421,14,1994,826.0,269.0,114.0,14,2427,826.0,586.0,145.0
0.136,6,10,1506,5,395,33.0,127.0,127.0,5,1111,32.0,843.0,843.0
0.02,6,10,1972,5,910,5.0,642.0,642.0,5,1062,5.0,794.0,794.0
0.004,6,10,2007,5,928,1.0,660.0,660.0,5,1079,1.0,811.0,811.0
0.004,6,10,2006,5,927,1.0,659.0,659.0,5,1079,1.0,811.0,811.0
1772.287,6,103,6205,59,3485,30556.0,27.0,27.0,44,2720,41214.0,27.0,27.0
351.994,6,20,2210,6,1308,12003.0,494.0,494.0,14,902,27076.0,83.0,83.0
0.012,6,10,1989,5,910,3.0,642.0,642.0,5,1079,3.0,811.0,811.0
0.005,6,10,2000,5,927,1.0,659.0,659.0,5,1073,1.0,805.0,805.0
0.005,6,10,2006,5,927,1.0,659.0,659.0,5,1079,1.0,811.0,811.0
0.076,6,10,1506,5,395,16.0,127.0,127.0,5,1111,16.0,843.0,843.0
1727.906,6,48,2957,31,1800,57596.0,35.0,35.0,17,1157,107989.0,31.0,31.0
0.007,6,10,1689,5,839,1.0,571.0,571.0,5,850,1.0,582.0,582.0
0.012,6,10,1989,5,910,3.0,642.0,642.0,5,1079,2.0,811.0,811.0
300.03,6,12,1782,7,1348,50005.0,494.0,494.0,5,434,75006.0,83.0,83.0
0.013,17,2,152,1,56,0.0,28.0,28.0,1,96,0.0,68.0,68.0
0.005,17,2,214,1,75,0.0,47.0,47.0,1,139,0.0,111.0,111.0
15.073,17,15,9238,8,6902,2149.0,1350.0,834.0,7,2336,2507.0,1350.0,305.0
0.077,6,10,1506,5,395,15.0,127.0,127.0,5,1111,18.0,843.0,843.0
0.0,17,2,154,1,69,0.0,41.0,41.0,1,85,0.0,57.0,57.0
0.091,6,10,1506,5,395,21.0,127.0,127.0,5,1111,22.0,843.0,843.0
11.028,17,28,4422,14,1994,839.0,269.0,114.0,14,2428,839.0,587.0,145.0
0.006,6,10,1643,5,860,1.0,592.0,592.0,5,783,1.0,515.0,515.0
0.012,6,10,1983,5,910,3.0,642.0,642.0,5,1073,2.0,805.0,805.0
0.02,6,10,1989,5,910,5.0,642.0,642.0,5,1079,5.0,811.0,811.0
0.001,17,2,180,1,66,0.0,38.0,38.0,1,114,0.0,86.0,86.0
0.005,6,10,2007,5,928,1.0,660.0,660.0,5,1079,1.0,811.0,811.0
0.003,17,2,136,1,60,0.0,32.0,32.0,1,76,0.0,48.0,48.0
0.006,6,10,1547,5,764,1.0,496.0,496.0,5,783,1.0,515.0,515.0
0.206,6,16,2674,8,1400,29.0,533.0,325.0,8,1274,18.0,529.0,212.0
0.015,6,10,1989,5,910,3.0,642.0,642.0,5,1079,3.0,811.0,811.0
0.017,6,10,1983,5,910,4.0,642.0,642.0,5,1073,4.0,805.0,805.0
0.012,6,10,1972,5,910,3.0,642.0,642.0,5,1062,3.0,794.0,794.0
0.009,6,10,1972,5,910,2.0,642.0,642.0,5,1062,2.0,794.0,794.0
308.52,17,18,1008,9,640,38548.0,48.0,43.0,9,368,38548.0,20.0,12.0
0.02,6,10,2000,5,927,4.0,659.0,659.0,5,1073,5.0,805.0,805.0
40.062,17,10,676,5,460,10013.0,104.0,64.0,5,216,10014.0,20.0,15.0
0.008,6,10,1990,5,911,2.0,643.0,643.0,5,1079,2.0,811.0,811.0
0.012,6,10,1972,5,910,2.0,642.0,642.0,5,1062,3.0,794.0,794.0
0.04,17,2,184,1,61,0.0,33.0,33.0,1,123,0.0,95.0,95.0
0.005,17,2,166,1,75,0.0,47.0,47.0,1,91,0.0,63.0,63.0
0.012,6,10,1762,5,911,3.0,643.0,643.0,5,851,3.0,583.0,583.0
0.056,6,10,1506,5,395,12.0,127.0,127.0,5,1111,12.0,843.0,843.0
0.014,6,10,1983,5,910,3.0,642.0,642.0,5,1073,3.0,805.0,805.0
0.003,17,2,187,1,74,0.0,46.0,46.0,1,113,0.0,85.0,85.0
40.059,17,10,676,5,460,10013.0,104.0,64.0,5,216,10013.0,20.0,15.0
0.009,6,10,1990,5,911,2.0,643.0,643.0,5,1079,2.0,811.0,811.0
0.005,6,10,1989,5,927,1.0,659.0,659.0,5,1062,1.0,794.0,794.0
0.091,6,10,1506,5,395,21.0,127.0,127.0,5,1111,20.0,843.0,843.0
0.011,6,10,1972,5,910,2.0,642.0,642.0,5,1062,2.0,794.0,794.0
0.01,6,10,1989,5,910,2.0,642.0,642.0,5,1079,2.0,811.0,811.0
0.004,17,2,148,1,60,0.0,32.0,32.0,1,88,0.0,60.0,60.0
0.941,6,25,8490,14,2106,72.0,1139.0,378.0,11,6384,76.0,2720.0,988.0
0.098,6,10,1506,5,395,19.0,127.0,127.0,5,1111,22.0,843.0,843.0
0.134,17,2,80,1,32,0.0,4.0,4.0,1,48,0.0,20.0,20.0
0.006,6,10,1689,5,839,1.0,571.0,571.0,5,850,1.0,582.0,582.0
0.008,6,12,1926,6,1189,1.0,659.0,434.0,6,737,1.0,417.0,417.0
40.074,17,10,676,5,460,10016.0,104.0,64.0,5,216,10017.0,20.0,15.0
0.068,6,10,1506,5,395,14.0,127.0,127.0,5,1111,15.0,843.0,843.0
0.007,6,10,1989,5,910,1.0,642.0,642.0,5,1079,1.0,811.0,811.0
0.072,6,10,1506,5,395,17.0,127.0,127.0,5,1111,16.0,843.0,843.0
0.005,6,10,1989,5,927,1.0,659.0,659.0,5,1062,1.0,794.0,794.0
0.017,6,10,1990,5,911,4.0,643.0,643.0,5,1079,4.0,811.0,811.0
0.005,6,10,1989,5,927,1.0,659.0,659.0,5,1062,1.0,794.0,794.0
0.009,6,10,1762,5,911,2.0,643.0,643.0,5,851,2.0,583.0,583.0
0.042,6,10,1972,5,910,10.0,642.0,642.0,5,1062,10.0,794.0,794.0
0.091,6,10,1506,5,395,22.0,127.0,127.0,5,1111,16.0,843.0,843.0
40.067,17,10,676,5,460,10015.0,104.0,64.0,5,216,10015.0,20.0,15.0
0.006,17,2,166,1,75,0.0,47.0,47.0,1,91,0.0,63.0,63.0
166.226,17,88,12702,44,2945,3865.0,44.0,38.0,44,9757,3865.0,279.0,193.0
0.095,6,10,1506,5,395,18.0,127.0,127.0,5,1111,22.0,843.0,843.0
0.011,6,10,1677,5,827,2.0,559.0,559.0,5,850,2.0,582.0,582.0
0.096,6,10,1506,5,395,22.0,127.0,127.0,5,1111,21.0,843.0,843.0
10.88,17,28,4417,14,1994,828.0,269.0,114.0,14,2423,828.0,586.0,145.0
40.066,17,10,676,5,460,10015.0,104.0,64.0,5,216,10015.0,20.0,15.0
0.006,6,10,1547,5,764,1.0,496.0,496.0,5,783,1.0,515.0,515.0
0.01,17,2,179,1,71,0.0,43.0,43.0,1,108,0.0,80.0,80.0
0.007,6,10,1989,5,910,1.0,642.0,642.0,5,1079,1.0,811.0,811.0
11.028,17,28,4420,14,1993,839.0,268.0,114.0,14,2427,839.0,586.0,145.0
0.079,6,10,1506,5,395,17.0,127.0,127.0,5,1111,18.0,843.0,843.0
0.005,6,10,2000,5,927,1.0,659.0,659.0,5,1073,1.0,805.0,805.0
0.004,17,2,214,1,75,0.0,47.0,47.0,1,139,0.0,111.0,111.0
0.015,6,10,1989,5,910,3.0,642.0,642.0,5,1079,3.0,811.0,811.0
0.004,17,2,148,1,60,0.0,32.0,32.0,1,88,0.0,60.0,60.0
0.005,17,2,166,1,75,0.0,47.0,47.0,1,91,0.0,63.0,63.0
0.017,6,10,1989,5,910,4.0,642.0,642.0,5,1079,4.0,811.0,811.0
0.006,6,10,1547,5,764,1.0,496.0,496.0,5,783,1.0,515.0,515.0
0.012,6,10,1983,5,910,3.0,642.0,642.0,5,1073,3.0,805.0,805.0
0.019,6,10,1989,5,910,4.0,642.0,642.0,5,1079,4.0,811.0,811.0
0.01,6,10,1990,5,911,2.0,643.0,643.0,5,1079,2.0,811.0,811.0
290.927,6,394,347505,195,21722,1499.0,2736.0,889.0,199,325783,1469.0,4113.0,1714.0
0.005,6,10,2006,5,927,1.0,659.0,659.0,5,1079,1.0,811.0,811.0
0.016,6,10,1990,5,911,3.0,643.0,643.0,5,1079,4.0,811.0,811.0
0.112,6,10,1506,5,395,22.0,127.0,127.0,5,1111,25.0,843.0,843.0
0.001,17,2,166,1,75,0.0,47.0,47.0,1,91,0.0,63.0,63.0
0.001,17,2,180,1,66,0.0,38.0,38.0,1,114,0.0,86.0,86.0
0.005,6,10,2006,5,927,1.0,659.0,659.0,5,1079,1.0,811.0,811.0
0.011,6,10,1983,5,910,2.0,642.0,642.0,5,1073,2.0,805.0,805.0
0.075,6,10,1506,5,395,15.0,127.0,127.0,5,1111,15.0,843.0,843.0
0.005,6,10,1547,5,764,1.0,496.0,496.0,5,783,1.0,515.0,515.0
0.017,6,10,1983,5,910,4.0,642.0,642.0,5,1073,4.0,805.0,805.0
0.001,17,2,179,1,62,0.0,34.0,34.0,1,117,0.0,89.0,89.0
0.006,6,10,1854,5,889,1.0,621.0,621.0,5,965,1.0,697.0,697.0
0.14,6,10,1506,5,395,31.0,127.0,127.0,5,1111,21.0,843.0,843.0
0.143,6,10,1506,5,395,25.0,127.0,127.0,5,1111,31.0,843.0,843.0
173.191,17,77,11004,39,2615,4557.0,44.0,39.0,38,8389,4679.0,239.0,192.0
0.001,17,2,154,1,69,0.0,41.0,41.0,1,85,0.0,57.0,57.0
40.055,17,10,676,5,460,10012.0,104.0,64.0,5,216,10013.0,20.0,15.0
0.13,17,2,136,1,60,0.0,32.0,32.0,1,76,0.0,48.0,48.0
0.009,6,10,1989,5,910,2.0,642.0,642.0,5,1079,2.0,811.0,811.0
0.086,6,10,1506,5,395,20.0,127.0,127.0,5,1111,20.0,843.0,843.0
0.014,6,10,1989,5,910,3.0,642.0,642.0,5,1079,3.0,811.0,811.0
0.122,6,10,1506,5,395,23.0,127.0,127.0,5,1111,25.0,843.0,843.0
0.005,6,10,1989,5,927,1.0,659.0,659.0,5,1062,1.0,794.0,794.0
0.013,6,10,1989,5,910,3.0,642.0,642.0,5,1079,3.0,811.0,811.0
171.135,17,82,11451,41,2728,4278.0,44.0,38.0,41,8723,4278.0,239.0,184.0
0.001,17,2,166,1,75,0.0,47.0,47.0,1,91,0.0,63.0,63.0
0.005,6,14,3799,7,509,0.0,137.0,137.0,7,3290,0.0,1448.0,972.0
0.004,6,10,1989,5,927,1.0,659.0,659.0,5,1062,1.0,794.0,794.0
0.005,6,10,2007,5,928,1.0,660.0,660.0,5,1079,1.0,811.0,811.0
0.009,6,10,1989,5,910,2.0,642.0,642.0,5,1079,2.0,811.0,811.0
0.005,6,10,1779,5,928,1.0,660.0,660.0,5,851,1.0,583.0,583.0
48.232,6,28,9605,14,1707,3710.0,794.0,367.0,14,7898,3700.0,1360.0,732.0
214.427,6,26,7230,8,1395,31.0,533.0,323.0,18,5835,12610.0,529.0,376.0
0.004,6,10,2000,5,927,1.0,659.0,659.0,5,1073,1.0,805.0,805.0
0.148,6,10,1506,5,395,32.0,127.0,127.0,5,1111,34.0,843.0,843.0
0.001,17,2,180,1,66,0.0,38.0,38.0,1,114,0.0,86.0,86.0
0.005,6,13,3747,7,509,0.0,137.0,137.0,6,3238,0.0,1470.0,1459.0
0.079,6,10,1506,5,395,17.0,127.0,127.0,5,1111,16.0,843.0,843.0
300.591,6,34,6335,19,1409,16699.0,267.0,154.0,15,4926,610.0,1823.0,392.0
0.004,6,10,1702,5,863,1.0,595.0,595.0,5,839,0.0,571.0,571.0
0.006,17,2,154,1,69,0.0,41.0,41.0,1,85,0.0,57.0,57.0
0.014,6,10,1972,5,910,3.0,642.0,642.0,5,1062,3.0,794.0,794.0
0.02,6,10,1983,5,910,4.0,642.0,642.0,5,1073,4.0,805.0,805.0
0.171,6,10,1506,5,395,40.0,127.0,127.0,5,1111,38.0,843.0,843.0
0.014,6,10,1762,5,911,3.0,643.0,643.0,5,851,3.0,583.0,583.0
10.907,17,28,4421,14,1993,830.0,268.0,114.0,14,2428,830.0,587.0,145.0
0.042,17,4,420,2,122,0.0,33.0,33.0,2,298,5.0,145.0,121.0
0.009,6,12,1926,6,1189,1.0,659.0,434.0,6,737,1.0,417.0,417.0
0.005,6,10,1989,5,927,1.0,659.0,659.0,5,1062,1.0,794.0,794.0
0.006,6,10,2007,5,928,1.0,660.0,660.0,5,1079,1.0,811.0,811.0
0.016,6,13,3735,7,497,2.0,125.0,125.0,6,3238,3.0,1470.0,1459.0
0.019,17,2,136,1,60,0.0,32.0,32.0,1,76,0.0,48.0,48.0
0.003,17,2,136,1,60,0.0,32.0,32.0,1,76,0.0,48.0,48.0
0.001,17,2,180,1,66,0.0,38.0,38.0,1,114,0.0,86.0,86.0
0.004,6,10,2007,5,928,1.0,660.0,660.0,5,1079,1.0,811.0,811.0
0.004,17,2,136,1,60,0.0,32.0,32.0,1,76,0.0,48.0,48.0
0.006,17,2,169,1,62,0.0,34.0,34.0,1,107,0.0,79.0,79.0
15.071,17,15,9238,8,6902,2149.0,1350.0,834.0,7,2336,2506.0,1350.0,305.0
0.011,6,10,1990,5,911,2.0,643.0,643.0,5,1079,2.0,811.0,811.0
10.913,17,28,4418,14,1994,831.0,269.0,114.0,14,2424,831.0,587.0,145.0
242.507,6,301,344004,121,17806,2020.0,2736.0,959.0,180,326198,1354.0,2804.0,1863.0
0.003,17,2,136,1,60,0.0,32.0,32.0,1,76,0.0,48.0,48.0
15.077,17,16,9303,8,6912,2149.0,1350.0,836.0,8,2391,2149.0,1350.0,270.0
0.004,17,2,148,1,60,0.0,32.0,32.0,1,88,0.0,60.0,60.0
0.009,6,10,1989,5,910,2.0,642.0,642.0,5,1079,2.0,811.0,811.0
0.019,6,13,3816,7,578,3.0,206.0,206.0,6,3238,3.0,1470.0,1459.0
240.084,6,21,4925,11,941,24008.0,180.0,93.0,10,3984,26674.0,1592.0,576.0
0.006,6,10,1547,5,764,1.0,496.0,496.0,5,783,1.0,515.0,515.0
0.005,6,10,2006,5,927,1.0,659.0,659.0,5,1079,1.0,811.0,811.0
0.101,6,10,1506,5,395,23.0,127.0,127.0,5,1111,23.0,843.0,843.0
0.007,6,10,1989,5,910,1.0,642.0,642.0,5,1079,1.0,811.0,811.0
0.006,6,10,2000,5,927,1.0,659.0,659.0,5,1073,1.0,805.0,805.0
0.073,6,10,1506,5,395,17.0,127.0,127.0,5,1111,16.0,843.0,843.0
0.044,17,2,152,1,76,0.0,48.0,48.0,1,76,0.0,48.0,48.0
0.006,17,2,179,1,71,0.0,43.0,43.0,1,108,0.0,80.0,80.0
0.086,6,10,1506,5,395,19.0,127.0,127.0,5,1111,17.0,843.0,843.0
0.009,6,13,3735,7,497,1.0,125.0,125.0,6,3238,1.0,1470.0,1459.0
0.016,17,2,198,1,91,0.0,63.0,63.0,1,107,0.0,79.0,79.0
0.004,6,10,1702,5,863,1.0,595.0,595.0,5,839,0.0,571.0,571.0
0.011,6,10,1972,5,910,2.0,642.0,642.0,5,1062,2.0,794.0,794.0
0.001,17,2,180,1,66,0.0,38.0,38.0,1,114,0.0,86.0,86.0
0.005,6,10,2006,5,927,1.0,659.0,659.0,5,1079,1.0,811.0,811.0
0.012,6,10,1989,5,910,3.0,642.0,642.0,5,1079,2.0,811.0,811.0
0.154,17,4,596,2,122,78.0,33.0,33.0,2,474,78.0,323.0,209.0
361.767,6,19,1688,15,978,25840.0,190.0,190.0,4,710,80012.0,494.0,494.0
0.107,6,10,1506,5,395,24.0,127.0,127.0,5,1111,23.0,843.0,843.0
0.006,6,10,2006,5,927,1.0,659.0,659.0,5,1079,1.0,811.0,811.0
0.006,6,10,2007,5,928,1.0,660.0,660.0,5,1079,1.0,811.0,811.0
40.054,17,10,676,5,460,10012.0,104.0,64.0,5,216,10012.0,20.0,15.0
0.011,6,10,1989,5,910,2.0,642.0,642.0,5,1079,2.0,811.0,811.0
0.009,6,10,1990,5,911,2.0,643.0,643.0,5,1079,2.0,811.0,811.0
0.005,6,10,2006,5,927,1.0,659.0,659.0,5,1079,1.0,811.0,811.0
0.011,6,10,1989,5,910,2.0,642.0,642.0,5,1079,2.0,811.0,811.0
0.039,17,4,284,2,120,0.0,32.0,32.0,2,164,35.0,60.0,54.0
0.074,6,10,1506,5,395,16.0,127.0,127.0,5,1111,15.0,843.0,843.0
0.023,6,10,1989,5,910,5.0,642.0,642.0,5,1079,5.0,811.0,811.0
0.038,17,2,136,1,60,0.0,32.0,32.0,1,76,0.0,48.0,48.0
0.007,17,2,179,1,71,0.0,43.0,43.0,1,108,0.0,80.0,80.0
0.007,6,10,1990,5,911,1.0,643.0,643.0,5,1079,1.0,811.0,811.0
0.005,6,10,1989,5,927,1.0,659.0,659.0,5,1062,1.0,794.0,794.0
0.04,17,2,136,1,60,0.0,32.0,32.0,1,76,0.0,48.0,48.0
0.005,6,10,1643,5,860,1.0,592.0,592.0,5,783,1.0,515.0,515.0
0.01,6,10,1972,5,910,2.0,642.0,642.0,5,1062,2.0,794.0,794.0
40.068,17,10,676,5,460,10016.0,104.0,64.0,5,216,10016.0,20.0,15.0
0.005,17,2,168,1,76,0.0,48.0,48.0,1,92,0.0,64.0,64.0
0.004,6,10,1702,5,863,1.0,595.0,595.0,5,839,0.0,571.0,571.0
0.015,6,10,1990,5,911,3.0,643.0,643.0,5,1079,3.0,811.0,811.0
0.001,17,2,180,1,66,0.0,38.0,38.0,1,114,0.0,86.0,86.0
0.019,6,10,1990,5,911,4.0,643.0,643.0,5,1079,4.0,811.0,811.0
0.04,17,2,412,1,61,0.0,33.0,33.0,1,351,0.0,323.0,323.0
0.004,17,2,148,1,60,0.0,32.0,32.0,1,88,0.0,60.0,60.0
0.006,6,10,1547,5,764,1.0,496.0,496.0,5,783,1.0,515.0,515.0
0.008,6,10,1631,5,848,1.0,580.0,580.0,5,783,2.0,515.0,515.0
0.005,17,2,169,1,62,0.0,34.0,34.0,1,107,0.0,79.0,79.0
0.005,6,14,3742,8,504,0.0,80.0,80.0,6,3238,0.0,1470.0,1459.0
0.015,6,10,1983,5,910,3.0,642.0,642.0,5,1073,3.0,805.0,805.0
0.08,6,10,1506,5,395,17.0,127.0,127.0,5,1111,19.0,843.0,843.0
40.064,17,10,676,5,460,10014.0,104.0,64.0,5,216,10015.0,20.0,15.0
0.012,6,10,1983,5,910,3.0,642.0,642.0,5,1073,2.0,805.0,805.0
21.292,6,37,9566,18,4008,518.0,1543.0,814.0,19,5558,1173.0,1360.0,398.0
361.846,6,21,1792,16,1030,24123.0,190.0,190.0,5,762,60009.0,461.0,247.0
10.725,17,26,4101,13,1846,885.0,269.0,114.0,13,2255,884.0,586.0,145.0
0.009,6,10,1989,5,910,2.0,642.0,642.0,5,1079,2.0,811.0,811.0
0.005,6,10,1547,5,764,1.0,496.0,496.0,5,783,1.0,515.0,515.0
0.005,17,2,166,1,75,0.0,47.0,47.0,1,91,0.0,63.0,63.0
0.012,6,10,1972,5,910,2.0,642.0,642.0,5,1062,2.0,794.0,794.0
0.014,6,10,1989,5,910,3.0,642.0,642.0,5,1079,3.0,811.0,811.0
0.006,6,10,1547,5,764,1.0,496.0,496.0,5,783,1.0,515.0,515.0
0.005,6,10,2006,5,927,1.0,659.0,659.0,5,1079,1.0,811.0,811.0
0.005,6,10,1854,5,889,1.0,621.0,621.0,5,965,1.0,697.0,697.0
0.005,17,2,170,1,65,0.0,37.0,37.0,1,105,0.0,77.0,77.0
40.061,17,10,676,5,460,10013.0,104.0,64.0,5,216,10014.0,20.0,15.0
0.069,6,10,1506,5,395,16.0,127.0,127.0,5,1111,13.0,843.0,843.0
0.064,6,10,1506,5,395,15.0,127.0,127.0,5,1111,15.0,843.0,843.0
0.006,6,12,1698,6,863,1.0,327.0,271.0,6,835,1.0,515.0,515.0
0.005,6,10,2007,5,928,1.0,660.0,660.0,5,1079,1.0,811.0,811.0
0.098,6,10,1506,5,395,22.0,127.0,127.0,5,1111,21.0,843.0,843.0
0.042,17,2,234,1,61,0.0,33.0,33.0,1,173,0.0,145.0,145.0
0.018,6,6,716,3,458,7.0,302.0,302.0,3,258,7.0,102.0,102.0
0.004,6,10,2006,5,927,1.0,659.0,659.0,5,1079,1.0,811.0,811.0
164.138,17,78,11037,39,2601,4319.0,44.0,38.0,39,8436,4319.0,239.0,188.0
6.132,6,26,12125,14,1040,471.0,304.0,304.0,12,11085,556.0,1402.0,1161.0
82.746,6,22,8497,12,2236,71.0,1345.0,574.0,10,6261,9175.0,2720.0,974.0
0.008,17,2,299,1,65,0.0,37.0,37.0,1,234,0.0,206.0,206.0
0.006,6,10,1547,5,764,1.0,496.0,496.0,5,783,1.0,515.0,515.0
40.055,17,10,676,5,460,10012.0,104.0,64.0,5,216,10012.0,20.0,15.0
0.015,6,13,3735,7,497,2.0,125.0,125.0,6,3238,2.0,1470.0,1459.0
0.014,6,10,1990,5,911,3.0,643.0,643.0,5,1079,3.0,811.0,811.0
0.013,6,10,1983,5,910,3.0,642.0,642.0,5,1073,3.0,805.0,805.0
0.079,6,10,1506,5,395,17.0,127.0,127.0,5,1111,18.0,843.0,843.0
240.097,6,32,9465,16,6897,16006.0,1971.0,674.0,16,2568,16006.0,580.0,216.0
40.06,17,10,676,5,460,10014.0,104.0,64.0,5,216,10014.0,20.0,15.0
0.005,17,2,164,1,74,0.0,46.0,46.0,1,90,0.0,62.0,62.0
0.007,17,2,214,1,75,0.0,47.0,47.0,1,139,0.0,111.0,111.0
0.008,6,10,1990,5,911,1.0,643.0,643.0,5,1079,2.0,811.0,811.0
15.076,17,16,8627,8,6466,2149.0,1350.0,780.0,8,2161,2149.0,1350.0,242.0
0.003,17,4,284,2,120,0.0,32.0,32.0,2,164,0.0,60.0,54.0
0.006,17,2,169,1,62,0.0,34.0,34.0,1,107,0.0,79.0,79.0
0.082,6,10,1506,5,395,18.0,127.0,127.0,5,1111,16.0,843.0,843.0
240.018,6,9,787,5,488,60004.0,232.0,232.0,4,299,80005.0,83.0,83.0
10.928,17,28,4389,14,2311,832.0,586.0,137.0,14,2078,832.0,269.0,120.0
0.004,6,10,2006,5,927,1.0,659.0,659.0,5,1079,1.0,811.0,811.0
329.824,6,773,882506,396,859422,834.0,4080.0,2298.0,377,23084,100.0,2667.0,204.0
40.07,17,10,676,5,460,10014.0,104.0,64.0,5,216,10016.0,20.0,15.0
0.004,17,2,148,1,60,0.0,32.0,32.0,1,88,0.0,60.0,60.0
0.016,6,10,1972,5,910,3.0,642.0,642.0,5,1062,4.0,794.0,794.0
0.109,6,10,1506,5,395,22.0,127.0,127.0,5,1111,25.0,843.0,843.0
0.006,6,10,1547,5,764,1.0,496.0,496.0,5,783,1.0,515.0,515.0
0.035,17,2,152,1,76,0.0,48.0,48.0,1,76,0.0,48.0,48.0
0.001,17,2,180,1,66,0.0,38.0,38.0,1,114,0.0,86.0,86.0
0.125,6,10,1506,5,395,29.0,127.0,127.0,5,1111,29.0,843.0,843.0
0.005,6,10,2007,5,928,1.0,660.0,660.0,5,1079,1.0,811.0,811.0
0.015,6,10,1989,5,910,3.0,642.0,642.0,5,1079,3.0,811.0,811.0
0.23,6,16,2675,8,1401,32.0,533.0,325.0,8,1274,21.0,529.0,212.0
0.006,6,10,1547,5,764,1.0,496.0,496.0,5,783,1.0,515.0,515.0
0.017,6,10,1990,5,911,4.0,643.0,643.0,5,1079,4.0,811.0,811.0
0.078,6,10,1506,5,395,17.0,127.0,127.0,5,1111,17.0,843.0,843.0
0.006,6,10,2006,5,927,1.0,659.0,659.0,5,1079,1.0,811.0,811.0
0.005,6,10,2000,5,927,1.0,659.0,659.0,5,1073,1.0,805.0,805.0
0.01,6,10,1989,5,910,2.0,642.0,642.0,5,1079,2.0,811.0,811.0
0.127,6,10,1506,5,395,20.0,127.0,127.0,5,1111,29.0,843.0,843.0
0.01,6,10,1989,5,910,2.0,642.0,642.0,5,1079,2.0,811.0,811.0
0.009,6,10,1989,5,910,2.0,642.0,642.0,5,1079,2.0,811.0,811.0
0.006,6,10,2006,5,927,1.0,659.0,659.0,5,1079,1.0,811.0,811.0
0.016,6,10,1631,5,848,4.0,580.0,580.0,5,783,3.0,515.0,515.0
372.369,6,22,2313,16,867,24824.0,195.0,195.0,6,1446,4663.0,419.0,398.0
0.073,6,10,1506,5,395,16.0,127.0,127.0,5,1111,16.0,843.0,843.0
0.173,6,10,1506,5,395,40.0,127.0,127.0,5,1111,41.0,843.0,843.0
10.775,17,28,4421,14,1993,820.0,268.0,114.0,14,2428,820.0,587.0,145.0
11.043,17,28,4388,14,2311,840.0,586.0,137.0,14,2077,840.0,268.0,120.0
0.096,6,10,1506,5,395,21.0,127.0,127.0,5,1111,18.0,843.0,843.0
0.154,6,10,1506,5,395,29.0,127.0,127.0,5,1111,36.0,843.0,843.0
0.069,17,8,3613,4,1874,23.0,1350.0,440.0,4,1739,11.0,1350.0,406.0
0.095,6,10,1506,5,395,18.0,127.0,127.0,5,1111,20.0,843.0,843.0
0.004,6,10,1989,5,927,1.0,659.0,659.0,5,1062,1.0,794.0,794.0
0.017,6,10,1989,5,910,4.0,642.0,642.0,5,1079,4.0,811.0,811.0
0.005,17,2,166,1,75,0.0,47.0,47.0,1,91,0.0,63.0,63.0
0.009,6,12,1926,6,1189,1.0,659.0,434.0,6,737,1.0,417.0,417.0
0.004,6,10,2000,5,927,1.0,659.0,659.0,5,1073,1.0,805.0,805.0
0.0,17,2,136,1,60,0.0,32.0,32.0,1,76,0.0,48.0,48.0
0.011,6,10,1990,5,911,2.0,643.0,643.0,5,1079,2.0,811.0,811.0
0.011,6,10,1989,5,910,2.0,642.0,642.0,5,1079,2.0,811.0,811.0
0.011,6,10,1631,5,848,2.0,580.0,580.0,5,783,2.0,515.0,515.0
0.083,6,10,1506,5,395,18.0,127.0,127.0,5,1111,18.0,843.0,843.0
0.005,6,10,1989,5,927,1.0,659.0,659.0,5,1062,1.0,794.0,794.0
0.005,6,10,2006,5,927,1.0,659.0,659.0,5,1079,1.0,811.0,811.0
0.01,6,10,1989,5,910,2.0,642.0,642.0,5,1079,2.0,811.0,811.0
0.131,6,10,1506,5,395,29.0,127.0,127.0,5,1111,27.0,843.0,843.0
0.005,17,2,230,1,68,0.0,40.0,40.0,1,162,0.0,134.0,134.0
0.005,6,14,3742,8,504,0.0,80.0,80.0,6,3238,1.0,1470.0,1459.0
166.323,17,90,12685,45,3015,3780.0,44.0,39.0,45,9670,3779.0,239.0,186.0
0.014,6,10,1990,5,911,3.0,643.0,643.0,5,1079,3.0,811.0,811.0
0.004,6,10,1702,5,863,0.0,595.0,595.0,5,839,1.0,571.0,571.0
0.004,6,10,2007,5,928,1.0,660.0,660.0,5,1079,1.0,811.0,811.0
253.103,6,52,13722,26,10549,10124.0,1515.0,613.0,26,3173,10123.0,580.0,139.0
0.005,17,2,170,1,65,0.0,37.0,37.0,1,105,0.0,77.0,77.0
0.131,6,10,1506,5,395,29.0,127.0,127.0,5,1111,29.0,843.0,843.0
40.053,17,10,676,5,460,10012.0,104.0,64.0,5,216,10012.0,20.0,15.0
15.095,17,15,7943,8,5922,2152.0,1350.0,712.0,7,2021,2510.0,1350.0,260.0
0.139,6,10,1506,5,395,32.0,127.0,127.0,5,1111,34.0,843.0,843.0
0.006,6,13,3684,7,446,0.0,74.0,74.0,6,3238,1.0,1470.0,1459.0
0.004,6,10,2000,5,927,1.0,659.0,659.0,5,1073,1.0,805.0,805.0
0.129,6,10,1506,5,395,29.0,127.0,127.0,5,1111,30.0,843.0,843.0
0.009,6,12,1926,6,1189,1.0,659.0,434.0,6,737,1.0,417.0,417.0
0.016,6,10,1989,5,910,4.0,642.0,642.0,5,1079,4.0,811.0,811.0
0.069,6,10,1506,5,395,15.0,127.0,127.0,5,1111,12.0,843.0,843.0
0.012,6,10,1989,5,910,3.0,642.0,642.0,5,1079,3.0,811.0,811.0
65.935,6,27,17934,15,9982,4709.0,2804.0,1532.0,12,7952,5978.0,2437.0,1220.0
0.015,6,10,1972,5,910,3.0,642.0,642.0,5,1062,3.0,794.0,794.0
0.13,6,14,4389,8,923,18.0,238.0,166.0,6,3466,18.0,1402.0,786.0
0.009,6,10,1677,5,827,2.0,559.0,559.0,5,850,2.0,582.0,582.0
0.011,6,10,1983,5,910,2.0,642.0,642.0,5,1073,2.0,805.0,805.0
0.009,6,10,1989,5,910,2.0,642.0,642.0,5,1079,2.0,811.0,811.0
0.008,17,2,148,1,60,0.0,32.0,32.0,1,88,0.0,60.0,60.0
64.422,6,24,8608,13,1683,5368.0,684.0,333.0,11,6925,6435.0,1402.0,1057.0
11.153,17,28,4423,14,1994,845.0,269.0,114.0,14,2429,843.0,588.0,145.0
0.006,6,10,1854,5,889,1.0,621.0,621.0,5,965,1.0,697.0,697.0
0.005,6,10,1854,5,889,1.0,621.0,621.0,5,965,1.0,697.0,697.0
0.001,17,2,136,1,60,0.0,32.0,32.0,1,76,0.0,48.0,48.0
0.022,6,13,3735,7,497,3.0,125.0,125.0,6,3238,4.0,1470.0,1459.0
0.005,6,10,2006,5,927,1.0,659.0,659.0,5,1079,1.0,811.0,811.0
0.11,6,10,1506,5,395,23.0,127.0,127.0,5,1111,23.0,843.0,843.0
0.01,6,10,1677,5,827,2.0,559.0,559.0,5,850,2.0,582.0,582.0
0.005,6,10,1779,5,928,1.0,660.0,660.0,5,851,1.0,583.0,583.0
0.011,6,10,1990,5,911,2.0,643.0,643.0,5,1079,2.0,811.0,811.0
0.005,17,2,230,1,68,0.0,40.0,40.0,1,162,0.0,134.0,134.0
0.006,6,10,1689,5,839,1.0,571.0,571.0,5,850,1.0,582.0,582.0
0.015,6,10,1990,5,911,3.0,643.0,643.0,5,1079,3.0,811.0,811.0
0.129,17,2,80,1,32,0.0,4.0,4.0,1,48,0.0,20.0,20.0
1787.123,6,150,19350,90,13740,20079.0,302.0,302.0,60,5610,30290.0,83.0,83.0
0.019,6,10,1762,5,911,4.0,643.0,643.0,5,851,4.0,583.0,583.0
0.005,17,2,136,1,60,0.0,32.0,32.0,1,76,0.0,48.0,48.0
0.121,6,10,1506,5,395,27.0,127.0,127.0,5,1111,23.0,843.0,843.0
178.348,17,88,12256,44,2938,4147.0,44.0,38.0,44,9318,4147.0,239.0,183.0
0.006,6,10,1689,5,839,1.0,571.0,571.0,5,850,1.0,582.0,582.0
0.005,6,10,1689,5,839,1.0,571.0,571.0,5,850,1.0,582.0,582.0
0.006,6,10,1643,5,860,1.0,592.0,592.0,5,783,1.0,515.0,515.0
0.005,6,10,1989,5,927,1.0,659.0,659.0,5,1062,1.0,794.0,794.0
0.012,6,10,1989,5,910,3.0,642.0,642.0,5,1079,3.0,811.0,811.0
0.013,6,10,1983,5,910,3.0,642.0,642.0,5,1073,3.0,805.0,805.0
0.017,6,10,1972,5,910,4.0,642.0,642.0,5,1062,4.0,794.0,794.0
0.124,6,10,1506,5,395,28.0,127.0,127.0,5,1111,27.0,843.0,843.0
15.307,17,19,10986,9,4425,1909.0,1350.0,463.0,10,6561,1697.0,1350.0,628.0
0.09,6,10,1506,5,395,20.0,127.0,127.0,5,1111,19.0,843.0,843.0
0.012,6,10,1989,5,910,3.0,642.0,642.0,5,1079,2.0,811.0,811.0
0.001,17,2,180,1,66,0.0,38.0,38.0,1,114,0.0,86.0,86.0
0.005,6,10,1774,5,923,1.0,655.0,655.0,5,851,1.0,583.0,583.0
25.335,6,37,10002,19,4484,495.0,1360.0,738.0,18,5518,1480.0,2667.0,435.0
300.255,6,16,2182,9,696,37510.0,146.0,146.0,7,1486,50014.0,419.0,398.0
0.006,17,2,140,1,62,0.0,34.0,34.0,1,78,0.0,50.0,50.0
0.825,6,10,2009,6,1655,165.0,1403.0,1403.0,4,354,196.0,182.0,182.0
309.57,17,20,1124,10,716,34382.0,48.0,43.0,10,408,34382.0,20.0,12.0
0.005,6,10,2006,5,927,1.0,659.0,659.0,5,1079,1.0,811.0,811.0
0.005,17,2,212,1,63,0.0,35.0,35.0,1,149,0.0,121.0,121.0
0.005,6,10,2006,5,927,1.0,659.0,659.0,5,1079,1.0,811.0,811.0
0.001,17,2,180,1,66,0.0,38.0,38.0,1,114,0.0,86.0,86.0
0.07,6,10,1506,5,395,16.0,127.0,127.0,5,1111,16.0,843.0,843.0
300.839,6,40,9774,22,4211,14325.0,1543.0,657.0,18,5563,509.0,2667.0,402.0
0.093,6,10,1506,5,395,20.0,127.0,127.0,5,1111,22.0,843.0,843.0
0.005,6,10,2006,5,927,1.0,659.0,659.0,5,1079,1.0,811.0,811.0
40.102,17,10,676,5,460,10024.0,104.0,64.0,5,216,10024.0,20.0,15.0
10.77,17,28,4421,14,1993,820.0,268.0,114.0,14,2428,820.0,587.0,145.0
0.008,6,10,1989,5,910,1.0,642.0,642.0,5,1079,2.0,811.0,811.0
0.114,6,10,1506,5,395,26.0,127.0,127.0,5,1111,26.0,843.0,843.0
0.072,17,2,234,1,61,0.0,33.0,33.0,1,173,0.0,145.0,145.0
0.013,6,10,1983,5,910,3.0,642.0,642.0,5,1073,3.0,805.0,805.0
0.015,6,10,1990,5,911,3.0,643.0,643.0,5,1079,3.0,811.0,811.0
0.006,17,2,170,1,65,0.0,37.0,37.0,1,105,0.0,77.0,77.0
0.116,6,10,1506,5,395,25.0,127.0,127.0,5,1111,26.0,843.0,843.0
0.039,17,2,184,1,61,0.0,33.0,33.0,1,123,0.0,95.0,95.0
0.01,6,10,1677,5,827,2.0,559.0,559.0,5,850,2.0,582.0,582.0
0.005,6,10,1547,5,764,1.0,496.0,496.0,5,783,1.0,515.0,515.0
176.045,17,76,10488,38,2530,4757.0,44.0,38.0,38,7958,4757.0,239.0,181.0
0.005,6,10,2006,5,927,1.0,659.0,659.0,5,1079,1.0,811.0,811.0
0.038,17,2,412,1,61,0.0,33.0,33.0,1,351,0.0,323.0,323.0
0.081,6,10,1506,5,395,18.0,127.0,127.0,5,1111,17.0,843.0,843.0
0.008,6,10,1990,5,911,2.0,643.0,643.0,5,1079,2.0,811.0,811.0
0.005,6,10,1989,5,927,1.0,659.0,659.0,5,1062,1.0,794.0,794.0
40.063,17,10,676,5,460,10015.0,104.0,64.0,5,216,10015.0,20.0,15.0
0.094,6,10,1506,5,395,19.0,127.0,127.0,5,1111,21.0,843.0,843.0
0.013,6,10,1983,5,910,3.0,642.0,642.0,5,1073,3.0,805.0,805.0
0.001,17,2,164,1,74,0.0,46.0,46.0,1,90,0.0,62.0,62.0
0.001,17,2,136,1,60,0.0,32.0,32.0,1,76,0.0,48.0,48.0
0.112,6,10,1506,5,395,24.0,127.0,127.0,5,1111,25.0,843.0,843.0
0.09,6,10,1506,5,395,20.0,127.0,127.0,5,1111,20.0,843.0,843.0
0.005,17,2,169,1,62,0.0,34.0,34.0,1,107,0.0,79.0,79.0
0.004,6,10,1774,5,923,1.0,655.0,655.0,5,851,1.0,583.0,583.0
0.001,17,2,180,1,66,0.0,38.0,38.0,1,114,0.0,86.0,86.0
0.037,17,4,284,2,120,0.0,32.0,32.0,2,164,33.0,60.0,54.0
167.055,17,86,11972,43,2877,3977.0,44.0,38.0,43,9095,3977.0,239.0,183.0
0.006,6,10,1547,5,764,1.0,496.0,496.0,5,783,1.0,515.0,515.0
0.005,17,2,184,1,68,0.0,40.0,40.0,1,116,0.0,88.0,88.0
0.006,6,10,1689,5,839,1.0,571.0,571.0,5,850,1.0,582.0,582.0
0.005,6,10,2007,5,928,1.0,660.0,660.0,5,1079,1.0,811.0,811.0
0.012,6,10,1989,5,910,3.0,642.0,642.0,5,1079,3.0,811.0,811.0
0.006,6,10,1989,5,927,1.0,659.0,659.0,5,1062,1.0,794.0,794.0
0.004,6,10,2006,5,927,1.0,659.0,659.0,5,1079,1.0,811.0,811.0
0.01,6,10,1989,5,910,2.0,642.0,642.0,5,1079,2.0,811.0,811.0
0.086,6,10,1506,5,395,20.0,127.0,127.0,5,1111,13.0,843.0,843.0
0.006,6,10,1547,5,764,1.0,496.0,496.0,5,783,1.0,515.0,515.0
0.07,6,10,1506,5,395,16.0,127.0,127.0,5,1111,15.0,843.0,843.0
0.086,6,10,1506,5,395,20.0,127.0,127.0,5,1111,19.0,843.0,843.0
0.04,17,2,166,1,75,0.0,47.0,47.0,1,91,0.0,63.0,63.0
0.013,6,10,1989,5,910,3.0,642.0,642.0,5,1079,3.0,811.0,811.0
0.019,6,10,1762,5,911,4.0,643.0,643.0,5,851,4.0,583.0,583.0
0.04,17,4,284,2,120,1.0,32.0,32.0,2,164,36.0,60.0,54.0
0.005,6,10,1989,5,927,1.0,659.0,659.0,5,1062,1.0,794.0,794.0
0.004,17,2,904,1,576,0.0,548.0,548.0,1,328,0.0,300.0,300.0
0.003,17,2,187,1,74,0.0,46.0,46.0,1,113,0.0,85.0,85.0
332.533,17,20,1124,10,716,36934.0,48.0,43.0,10,408,36934.0,20.0,12.0
0.079,6,10,1506,5,395,17.0,127.0,127.0,5,1111,16.0,843.0,843.0
0.093,6,10,1506,5,395,22.0,127.0,127.0,5,1111,20.0,843.0,843.0
0.212,6,16,2777,8,1395,30.0,533.0,323.0,8,1382,18.0,529.0,239.0
0.015,6,10,1972,5,910,3.0,642.0,642.0,5,1062,3.0,794.0,794.0
0.034,6,13,3735,7,497,5.0,125.0,125.0,6,3238,6.0,1470.0,1459.0
0.006,6,10,1643,5,860,1.0,592.0,592.0,5,783,1.0,515.0,515.0
0.04,6,10,1990,5,911,10.0,643.0,643.0,5,1079,10.0,811.0,811.0
0.096,6,10,1506,5,395,21.0,127.0,127.0,5,1111,17.0,843.0,843.0
0.01,6,10,1762,5,911,2.0,643.0,643.0,5,851,2.0,583.0,583.0
0.005,17,2,136,1,60,0.0,32.0,32.0,1,76,0.0,48.0,48.0
0.018,6,10,1972,5,910,4.0,642.0,642.0,5,1062,4.0,794.0,794.0
0.011,6,10,1989,5,910,2.0,642.0,642.0,5,1079,2.0,811.0,811.0
0.005,6,13,3747,7,509,0.0,137.0,137.0,6,3238,0.0,1470.0,1459.0
0.009,6,13,3735,7,497,1.0,125.0,125.0,6,3238,1.0,1470.0,1459.0
0.005,6,10,2006,5,927,1.0,659.0,659.0,5,1079,1.0,811.0,811.0
0.004,17,2,148,1,60,0.0,32.0,32.0,1,88,0.0,60.0,60.0
15.08,17,16,8903,8,6677,2150.0,1350.0,806.0,8,2226,2150.0,1350.0,250.0
0.01,6,10,1677,5,827,2.0,559.0,559.0,5,850,2.0,582.0,582.0
0.004,6,10,1702,5,863,1.0,595.0,595.0,5,839,0.0,571.0,571.0
0.005,6,10,2000,5,927,1.0,659.0,659.0,5,1073,1.0,805.0,805.0
0.013,6,10,1989,5,910,3.0,642.0,642.0,5,1079,3.0,811.0,811.0
40.075,17,10,676,5,460,10017.0,104.0,64.0,5,216,10017.0,20.0,15.0
1781.488,6,234,45993,112,33728,16049.0,2474.0,1072.0,122,12265,14723.0,580.0,62.0
0.006,17,2,144,1,64,0.0,36.0,36.0,1,80,0.0,52.0,52.0
0.001,17,2,180,1,66,0.0,38.0,38.0,1,114,0.0,86.0,86.0
0.027,6,10,1989,5,910,6.0,642.0,642.0,5,1079,6.0,811.0,811.0
0.012,6,10,1973,5,911,3.0,643.0,643.0,5,1062,3.0,794.0,794.0
0.017,6,10,1972,5,910,4.0,642.0,642.0,5,1062,4.0,794.0,794.0
0.004,6,10,1989,5,927,1.0,659.0,659.0,5,1062,1.0,794.0,794.0
0.005,6,10,1547,5,764,1.0,496.0,496.0,5,783,1.0,515.0,515.0
0.219,6,16,2669,8,1395,31.0,533.0,323.0,8,1274,20.0,529.0,212.0
0.094,6,10,1506,5,395,18.0,127.0,127.0,5,1111,20.0,843.0,843.0
0.012,6,14,3787,7,497,2.0,125.0,125.0,7,3290,1.0,1448.0,972.0
0.01,6,10,1972,5,910,2.0,642.0,642.0,5,1062,2.0,794.0,794.0
0.075,6,10,1506,5,395,18.0,127.0,127.0,5,1111,17.0,843.0,843.0
10.899,17,28,4421,14,1994,830.0,269.0,114.0,14,2427,830.0,586.0,145.0
0.006,17,2,179,1,71,0.0,43.0,43.0,1,108,0.0,80.0,80.0
1729.228,6,62,4504,40,2740,44339.0,33.0,33.0,22,1764,82336.0,31.0,31.0
300.509,6,31,10500,17,2501,18781.0,517.0,321.0,14,7999,18499.0,1402.0,907.0
0.073,6,10,1506,5,395,16.0,127.0,127.0,5,1111,17.0,843.0,843.0
0.113,6,10,1506,5,395,25.0,127.0,127.0,5,1111,23.0,843.0,843.0
0.068,6,10,1506,5,395,14.0,127.0,127.0,5,1111,15.0,843.0,843.0
0.014,6,10,1989,5,910,3.0,642.0,642.0,5,1079,3.0,811.0,811.0
0.088,6,10,1506,5,395,20.0,127.0,127.0,5,1111,18.0,843.0,843.0
0.094,6,10,1506,5,395,20.0,127.0,127.0,5,1111,22.0,843.0,843.0
0.151,6,10,1506,5,395,34.0,127.0,127.0,5,1111,35.0,843.0,843.0
0.005,6,10,2007,5,928,1.0,660.0,660.0,5,1079,1.0,811.0,811.0
0.008,6,12,1926,6,1189,1.0,659.0,434.0,6,737,1.0,417.0,417.0
0.002,17,2,136,1,60,0.0,32.0,32.0,1,76,0.0,48.0,48.0
0.105,6,10,1506,5,395,26.0,127.0,127.0,5,1111,25.0,843.0,843.0
0.219,17,4,352,2,130,182.0,37.0,37.0,2,222,147.0,89.0,83.0
0.013,6,14,3787,7,497,2.0,125.0,125.0,7,3290,2.0,1448.0,972.0
0.014,6,10,1972,5,910,3.0,642.0,642.0,5,1062,3.0,794.0,794.0
0.003,17,2,136,1,60,0.0,32.0,32.0,1,76,0.0,48.0,48.0
0.012,6,10,1989,5,910,2.0,642.0,642.0,5,1079,2.0,811.0,811.0
0.006,6,12,1698,6,863,1.0,327.0,271.0,6,835,1.0,515.0,515.0
0.004,6,10,1702,5,863,1.0,595.0,595.0,5,839,0.0,571.0,571.0
0.005,6,10,2007,5,928,1.0,660.0,660.0,5,1079,1.0,811.0,811.0
0.019,6,10,1990,5,911,4.0,643.0,643.0,5,1079,4.0,811.0,811.0
0.114,6,10,1506,5,395,23.0,127.0,127.0,5,1111,27.0,843.0,843.0
240.021,6,22,3474,12,1820,21820.0,599.0,171.0,10,1654,26668.0,580.0,225.0
0.038,17,2,152,1,76,0.0,48.0,48.0,1,76,0.0,48.0,48.0
10.949,17,28,4399,14,2313,833.0,588.0,137.0,14,2086,833.0,269.0,121.0
0.016,6,10,1677,5,827,4.0,559.0,559.0,5,850,3.0,582.0,582.0
0.005,6,10,2006,5,927,1.0,659.0,659.0,5,1079,1.0,811.0,811.0
0.006,17,2,179,1,71,0.0,43.0,43.0,1,108,0.0,80.0,80.0
0.005,6,10,2006,5,927,1.0,659.0,659.0,5,1079,1.0,811.0,811.0
0.015,6,10,1990,5,911,3.0,643.0,643.0,5,1079,3.0,811.0,811.0
0.015,6,10,1972,5,910,3.0,642.0,642.0,5,1062,3.0,794.0,794.0
0.119,6,10,1506,5,395,23.0,127.0,127.0,5,1111,27.0,843.0,843.0
0.015,6,10,1983,5,910,3.0,642.0,642.0,5,1073,3.0,805.0,805.0
0.001,17,2,180,1,66,0.0,38.0,38.0,1,114,0.0,86.0,86.0
10.766,17,28,4422,14,1994,819.0,269.0,114.0,14,2428,819.0,587.0,145.0
23.092,6,39,22846,20,1110,1215.0,290.0,290.0,19,21736,1280.0,1414.0,1310.0
0.012,6,10,1989,5,910,3.0,642.0,642.0,5,1079,3.0,811.0,811.0
0.04,17,2,148,1,60,0.0,32.0,32.0,1,88,0.0,60.0,60.0
0.003,17,4,284,2,120,0.0,32.0,32.0,2,164,0.0,60.0,54.0
0.008,6,10,1990,5,911,1.0,643.0,643.0,5,1079,2.0,811.0,811.0
0.005,6,10,2007,5,928,1.0,660.0,660.0,5,1079,1.0,811.0,811.0
0.093,6,10,1506,5,395,19.0,127.0,127.0,5,1111,20.0,843.0,843.0
0.119,6,10,1506,5,395,26.0,127.0,127.0,5,1111,23.0,843.0,843.0
15.119,17,19,12122,10,8344,1676.0,1350.0,806.0,9,3778,1886.0,1350.0,391.0
0.005,6,10,1547,5,764,1.0,496.0,496.0,5,783,1.0,515.0,515.0
0.006,6,10,1689,5,839,1.0,571.0,571.0,5,850,1.0,582.0,582.0
0.165,17,2,152,1,76,0.0,48.0,48.0,1,76,0.0,48.0,48.0
0.016,6,10,1990,5,911,4.0,643.0,643.0,5,1079,4.0,811.0,811.0
0.005,6,13,3747,7,509,0.0,137.0,137.0,6,3238,0.0,1470.0,1459.0
0.088,6,10,1506,5,395,21.0,127.0,127.0,5,1111,18.0,843.0,843.0
0.014,6,10,1990,5,911,3.0,643.0,643.0,5,1079,3.0,811.0,811.0
0.005,6,10,1689,5,839,1.0,571.0,571.0,5,850,1.0,582.0,582.0
0.006,6,10,2007,5,928,1.0,660.0,660.0,5,1079,1.0,811.0,811.0
0.26,17,44,27889,26,24770,10.0,1350.0,924.0,18,3119,12.0,1350.0,145.0
15.081,17,16,8670,8,6488,2150.0,1350.0,783.0,8,2182,2150.0,1350.0,244.0
0.006,6,10,2006,5,927,1.0,659.0,659.0,5,1079,1.0,811.0,811.0
0.016,17,2,198,1,91,0.0,63.0,63.0,1,107,0.0,79.0,79.0
0.025,6,10,1689,5,839,6.0,571.0,571.0,5,850,6.0,582.0,582.0
0.01,6,10,1677,5,827,2.0,559.0,559.0,5,850,2.0,582.0,582.0
0.126,6,10,1506,5,395,28.0,127.0,127.0,5,1111,28.0,843.0,843.0
0.082,6,10,1506,5,395,18.0,127.0,127.0,5,1111,15.0,843.0,843.0
0.006,6,13,3684,7,446,0.0,74.0,74.0,6,3238,1.0,1470.0,1459.0
0.088,6,10,1506,5,395,16.0,127.0,127.0,5,1111,19.0,843.0,843.0
40.062,17,10,676,5,460,10012.0,104.0,64.0,5,216,10014.0,20.0,15.0
0.005,6,10,2007,5,928,1.0,660.0,660.0,5,1079,1.0,811.0,811.0
0.004,6,10,1989,5,927,1.0,659.0,659.0,5,1062,1.0,794.0,794.0
0.003,17,2,148,1,60,0.0,32.0,32.0,1,88,0.0,60.0,60.0
0.065,6,10,1506,5,395,15.0,127.0,127.0,5,1111,14.0,843.0,843.0
0.017,6,10,1989,5,910,4.0,642.0,642.0,5,1079,4.0,811.0,811.0
0.001,17,2,179,1,62,0.0,34.0,34.0,1,117,0.0,89.0,89.0
0.028,6,10,1990,5,911,7.0,643.0,643.0,5,1079,6.0,811.0,811.0
0.005,6,10,1989,5,927,1.0,659.0,659.0,5,1062,1.0,794.0,794.0
301.545,6,44,15600,23,9733,13706.0,4080.0,1254.0,21,5867,469.0,2667.0,385.0
0.02,6,10,1989,5,910,5.0,642.0,642.0,5,1079,4.0,811.0,811.0
300.963,6,34,9858,17,3439,18810.0,757.0,422.0,17,6419,18810.0,1593.0,553.0
0.006,6,10,1854,5,889,1.0,621.0,621.0,5,965,1.0,697.0,697.0
0.003,17,2,148,1,60,0.0,32.0,32.0,1,88,0.0,60.0,60.0
240.456,6,35,8924,18,2071,14144.0,692.0,225.0,17,6853,15028.0,1402.0,597.0
40.062,17,10,676,5,460,10014.0,104.0,64.0,5,216,10014.0,20.0,15.0
0.076,6,10,1506,5,395,17.0,127.0,127.0,5,1111,16.0,843.0,843.0
0.012,6,10,1990,5,911,3.0,643.0,643.0,5,1079,2.0,811.0,811.0
0.118,6,10,1506,5,395,25.0,127.0,127.0,5,1111,20.0,843.0,843.0
0.005,17,2,140,1,62,0.0,34.0,34.0,1,78,0.0,50.0,50.0
0.095,6,10,1506,5,395,22.0,127.0,127.0,5,1111,19.0,843.0,843.0
0.005,6,10,2000,5,927,1.0,659.0,659.0,5,1073,1.0,805.0,805.0
0.006,6,10,1854,5,889,1.0,621.0,621.0,5,965,1.0,697.0,697.0
0.02,6,13,3735,7,497,3.0,125.0,125.0,6,3238,4.0,1470.0,1459.0
0.012,6,10,1989,5,910,3.0,642.0,642.0,5,1079,3.0,811.0,811.0
0.006,6,10,1989,5,927,1.0,659.0,659.0,5,1062,1.0,794.0,794.0
0.016,6,10,1990,5,911,3.0,643.0,643.0,5,1079,4.0,811.0,811.0
0.112,6,10,1506,5,395,27.0,127.0,127.0,5,1111,27.0,843.0,843.0
0.123,6,10,1506,5,395,29.0,127.0,127.0,5,1111,28.0,843.0,843.0
0.018,6,13,3735,7,497,3.0,125.0,125.0,6,3238,3.0,1470.0,1459.0
0.218,6,16,2670,8,1396,31.0,533.0,324.0,8,1274,20.0,529.0,212.0
0.009,6,10,1989,5,910,2.0,642.0,642.0,5,1079,2.0,811.0,811.0
40.072,17,10,676,5,460,10017.0,104.0,64.0,5,216,10017.0,20.0,15.0
0.038,17,4,420,2,122,0.0,33.0,33.0,2,298,35.0,145.0,121.0
40.064,17,10,676,5,460,10013.0,104.0,64.0,5,216,10014.0,20.0,15.0
0.013,6,10,1983,5,910,3.0,642.0,642.0,5,1073,3.0,805.0,805.0
0.005,6,13,3747,7,509,0.0,137.0,137.0,6,3238,1.0,1470.0,1459.0
0.037,17,4,420,2,122,0.0,33.0,33.0,2,298,0.0,145.0,121.0
0.087,6,10,1506,5,395,19.0,127.0,127.0,5,1111,20.0,843.0,843.0
10.979,17,28,4398,14,2312,836.0,587.0,137.0,14,2086,836.0,269.0,121.0
523.795,6,37,13810,20,3451,27568.0,676.0,400.0,17,10359,28982.0,1402.0,946.0
0.006,6,10,1547,5,764,1.0,496.0,496.0,5,783,1.0,515.0,515.0
0.004,6,10,1702,5,863,1.0,595.0,595.0,5,839,0.0,571.0,571.0
0.006,6,10,1702,5,863,1.0,595.0,595.0,5,839,1.0,571.0,571.0
0.019,6,10,1990,5,911,4.0,643.0,643.0,5,1079,4.0,811.0,811.0
0.014,6,10,1989,5,910,3.0,642.0,642.0,5,1079,3.0,811.0,811.0
0.09,6,10,1506,5,395,19.0,127.0,127.0,5,1111,21.0,843.0,843.0
0.005,6,10,1989,5,927,1.0,659.0,659.0,5,1062,1.0,794.0,794.0
0.005,6,10,2006,5,927,1.0,659.0,659.0,5,1079,1.0,811.0,811.0
0.005,6,10,2007,5,928,1.0,660.0,660.0,5,1079,1.0,811.0,811.0
0.007,17,2,299,1,65,0.0,37.0,37.0,1,234,0.0,206.0,206.0
40.058,17,10,676,5,460,10013.0,104.0,64.0,5,216,10013.0,20.0,15.0
0.004,6,10,2007,5,928,1.0,660.0,660.0,5,1079,1.0,811.0,811.0
0.007,6,10,1983,5,910,1.0,642.0,642.0,5,1073,1.0,805.0,805.0
0.01,6,10,1762,5,911,2.0,643.0,643.0,5,851,2.0,583.0,583.0
0.005,6,13,3690,7,452,0.0,80.0,80.0,6,3238,1.0,1470.0,1459.0
0.003,17,2,160,1,72,0.0,44.0,44.0,1,88,0.0,60.0,60.0
0.016,6,10,1989,5,910,4.0,642.0,642.0,5,1079,4.0,811.0,811.0
0.004,17,2,136,1,60,0.0,32.0,32.0,1,76,0.0,48.0,48.0
0.003,17,2,148,1,60,0.0,32.0,32.0,1,88,0.0,60.0,60.0
0.012,6,10,1972,5,910,2.0,642.0,642.0,5,1062,3.0,794.0,794.0
0.036,17,2,184,1,61,0.0,33.0,33.0,1,123,0.0,95.0,95.0
0.007,6,10,1547,5,764,1.0,496.0,496.0,5,783,1.0,515.0,515.0
0.009,6,10,1990,5,911,2.0,643.0,643.0,5,1079,2.0,811.0,811.0
0.004,17,2,148,1,60,0.0,32.0,32.0,1,88,0.0,60.0,60.0
0.01,6,10,1983,5,910,2.0,642.0,642.0,5,1073,2.0,805.0,805.0
0.208,6,10,1506,5,395,44.0,127.0,127.0,5,1111,50.0,843.0,843.0
40.085,17,10,676,5,460,10020.0,104.0,64.0,5,216,10020.0,20.0,15.0
300.39,6,16,2170,9,684,37528.0,146.0,146.0,7,1486,50037.0,419.0,398.0
0.006,6,12,1698,6,863,1.0,327.0,271.0,6,835,1.0,515.0,515.0
0.009,6,10,1677,5,827,2.0,559.0,559.0,5,850,2.0,582.0,582.0
0.016,6,10,1989,5,910,4.0,642.0,642.0,5,1079,3.0,811.0,811.0
0.113,6,10,1506,5,395,23.0,127.0,127.0,5,1111,24.0,843.0,843.0
0.005,6,10,1854,5,889,1.0,621.0,621.0,5,965,1.0,697.0,697.0
0.005,6,10,2006,5,927,1.0,659.0,659.0,5,1079,1.0,811.0,811.0
0.005,6,10,1547,5,764,1.0,496.0,496.0,5,783,1.0,515.0,515.0
0.005,17,2,180,1,66,0.0,38.0,38.0,1,114,0.0,86.0,86.0
0.041,17,2,412,1,61,0.0,33.0,33.0,1,351,0.0,323.0,323.0
0.007,17,2,179,1,71,0.0,43.0,43.0,1,108,0.0,80.0,80.0
0.006,6,10,1547,5,764,1.0,496.0,496.0,5,783,1.0,515.0,515.0
0.005,6,14,3799,7,509,0.0,137.0,137.0,7,3290,0.0,1448.0,972.0
0.005,17,2,170,1,65,0.0,37.0,37.0,1,105,0.0,77.0,77.0
0.011,6,10,1983,5,910,2.0,642.0,642.0,5,1073,2.0,805.0,805.0
0.135,6,10,1506,5,395,29.0,127.0,127.0,5,1111,31.0,843.0,843.0
0.005,6,10,2000,5,927,1.0,659.0,659.0,5,1073,1.0,805.0,805.0
0.092,6,10,1506,5,395,20.0,127.0,127.0,5,1111,19.0,843.0,843.0
300.018,6,12,1782,7,1348,50003.0,494.0,494.0,5,434,75004.0,83.0,83.0
0.005,6,10,2007,5,928,1.0,660.0,660.0,5,1079,1.0,811.0,811.0
0.072,6,10,1506,5,395,16.0,127.0,127.0,5,1111,14.0,843.0,843.0
0.001,17,2,180,1,66,0.0,38.0,38.0,1,114,0.0,86.0,86.0
0.013,6,10,1983,5,910,3.0,642.0,642.0,5,1073,3.0,805.0,805.0
0.004,6,10,2006,5,927,1.0,659.0,659.0,5,1079,1.0,811.0,811.0
0.005,6,10,2000,5,927,1.0,659.0,659.0,5,1073,1.0,805.0,805.0
0.011,6,10,1989,5,910,2.0,642.0,642.0,5,1079,2.0,811.0,811.0
0.006,17,2,222,1,65,0.0,37.0,37.0,1,157,0.0,129.0,129.0
40.048,17,10,676,5,460,10011.0,104.0,64.0,5,216,10011.0,20.0,15.0
0.073,17,4,352,2,130,2.0,37.0,37.0,2,222,69.0,89.0,83.0
0.001,17,2,180,1,66,0.0,38.0,38.0,1,114,0.0,86.0,86.0
0.004,6,10,1989,5,927,1.0,659.0,659.0,5,1062,1.0,794.0,794.0
0.004,6,10,2006,5,927,1.0,659.0,659.0,5,1079,1.0,811.0,811.0
0.014,6,10,1990,5,911,3.0,643.0,643.0,5,1079,3.0,811.0,811.0
0.006,6,10,1989,5,927,1.0,659.0,659.0,5,1062,1.0,794.0,794.0
85.76,6,26,9525,12,1627,78.0,794.0,367.0,14,7898,6586.0,1360.0,732.0
0.039,17,2,136,1,60,0.0,32.0,32.0,1,76,0.0,48.0,48.0
0.009,6,10,1989,5,910,2.0,642.0,642.0,5,1079,2.0,811.0,811.0
0.15,6,10,1506,5,395,31.0,127.0,127.0,5,1111,34.0,843.0,843.0
0.006,6,10,2007,5,928,1.0,660.0,660.0,5,1079,1.0,811.0,811.0
0.009,6,10,1990,5,911,2.0,643.0,643.0,5,1079,2.0,811.0,811.0
0.173,6,10,1506,5,395,42.0,127.0,127.0,5,1111,42.0,843.0,843.0
0.012,6,10,1990,5,911,3.0,643.0,643.0,5,1079,3.0,811.0,811.0
0.011,6,10,1983,5,910,2.0,642.0,642.0,5,1073,2.0,805.0,805.0
0.041,17,4,284,2,120,0.0,32.0,32.0,2,164,4.0,60.0,54.0
0.011,6,12,1926,6,1189,2.0,659.0,434.0,6,737,2.0,417.0,417.0
0.01,6,10,1762,5,911,2.0,643.0,643.0,5,851,2.0,583.0,583.0
0.017,6,14,3787,7,497,2.0,125.0,125.0,7,3290,2.0,1448.0,972.0
0.01,6,10,1990,5,911,2.0,643.0,643.0,5,1079,2.0,811.0,811.0
0.022,6,10,1989,5,910,5.0,642.0,642.0,5,1079,5.0,811.0,811.0
0.003,17,4,284,2,120,0.0,32.0,32.0,2,164,0.0,60.0,54.0
0.012,6,10,1990,5,911,2.0,643.0,643.0,5,1079,3.0,811.0,811.0
0.007,6,10,1989,5,910,1.0,642.0,642.0,5,1079,1.0,811.0,811.0
0.013,17,2,152,1,76,0.0,48.0,48.0,1,76,0.0,48.0,48.0
244.001,6,25,11604,13,6869,20333.0,2736.0,1032.0,12,4735,22181.0,1657.0,1367.0
0.039,17,2,148,1,60,0.0,32.0,32.0,1,88,0.0,60.0,60.0
0.009,6,10,1989,5,927,2.0,659.0,659.0,5,1062,2.0,794.0,794.0
9.04,17,6,376,5,280,2260.0,28.0,28.0,1,96,0.0,68.0,68.0
0.009,6,10,1677,5,827,2.0,559.0,559.0,5,850,2.0,582.0,582.0
0.001,17,2,166,1,75,0.0,47.0,47.0,1,91,0.0,63.0,63.0
0.005,6,10,1774,5,923,1.0,655.0,655.0,5,851,1.0,583.0,583.0
0.004,17,4,284,2,120,1.0,32.0,32.0,2,164,0.0,60.0,54.0
10.769,17,28,4423,14,1995,820.0,270.0,114.0,14,2428,820.0,587.0,145.0
0.119,6,10,1506,5,395,26.0,127.0,127.0,5,1111,29.0,843.0,843.0
240.018,6,9,787,5,488,60004.0,232.0,232.0,4,299,80004.0,83.0,83.0
240.03,6,9,787,5,488,60007.0,232.0,232.0,4,299,80009.0,83.0,83.0
0.004,17,2,213,1,69,0.0,41.0,41.0,1,144,0.0,116.0,116.0
0.005,6,10,1774,5,923,1.0,655.0,655.0,5,851,1.0,583.0,583.0
0.02,6,13,3735,7,497,3.0,125.0,125.0,6,3238,3.0,1470.0,1459.0
0.111,6,10,1506,5,395,24.0,127.0,127.0,5,1111,25.0,843.0,843.0
0.004,17,2,136,1,60,0.0,32.0,32.0,1,76,0.0,48.0,48.0
40.062,17,10,676,5,460,10014.0,104.0,64.0,5,216,10014.0,20.0,15.0
0.005,6,10,1989,5,927,1.0,659.0,659.0,5,1062,1.0,794.0,794.0
0.077,6,10,1506,5,395,18.0,127.0,127.0,5,1111,17.0,843.0,843.0
304.737,6,52,14462,26,11047,12189.0,1515.0,646.0,26,3415,12189.0,580.0,158.0
0.125,6,10,1506,5,395,28.0,127.0,127.0,5,1111,22.0,843.0,843.0
0.076,6,10,1506,5,395,17.0,127.0,127.0,5,1111,18.0,843.0,843.0
361.84,6,19,1688,15,978,25845.0,190.0,190.0,4,710,80012.0,494.0,494.0
0.001,17,2,180,1,66,0.0,38.0,38.0,1,114,0.0,86.0,86.0
0.105,6,10,1506,5,395,21.0,127.0,127.0,5,1111,24.0,843.0,843.0
0.04,17,2,184,1,61,0.0,33.0,33.0,1,123,0.0,95.0,95.0
240.093,6,16,4482,9,963,30011.0,238.0,166.0,7,3519,40014.0,1402.0,786.0
0.013,6,10,1631,5,848,3.0,580.0,580.0,5,783,3.0,515.0,515.0
0.004,17,2,148,1,60,0.0,32.0,32.0,1,88,0.0,60.0,60.0
11.627,17,34,6369,17,2656,716.0,270.0,128.0,17,3713,716.0,1144.0,190.0
0.001,17,2,166,1,75,0.0,47.0,47.0,1,91,0.0,63.0,63.0
0.005,6,13,3747,7,509,0.0,137.0,137.0,6,3238,0.0,1470.0,1459.0
11.599,17,28,4398,14,2313,879.0,588.0,137.0,14,2085,879.0,268.0,120.0
0.014,6,10,1677,5,827,3.0,559.0,559.0,5,850,3.0,582.0,582.0
0.07,17,2,152,1,76,0.0,48.0,48.0,1,76,0.0,48.0,48.0
0.015,17,2,198,1,91,0.0,63.0,63.0,1,107,0.0,79.0,79.0
0.019,6,10,1972,5,910,4.0,642.0,642.0,5,1062,4.0,794.0,794.0
0.006,17,2,214,1,75,0.0,47.0,47.0,1,139,0.0,111.0,111.0
0.006,6,10,2007,5,928,1.0,660.0,660.0,5,1079,1.0,811.0,811.0
0.069,6,10,1506,5,395,16.0,127.0,127.0,5,1111,14.0,843.0,843.0
0.007,6,10,1547,5,764,1.0,496.0,496.0,5,783,1.0,515.0,515.0
40.066,17,10,676,5,460,10015.0,104.0,64.0,5,216,10015.0,20.0,15.0
0.01,6,10,1972,5,910,2.0,642.0,642.0,5,1062,2.0,794.0,794.0
0.005,17,2,140,1,62,0.0,34.0,34.0,1,78,0.0,50.0,50.0
0.031,6,12,4063,7,675,5.0,299.0,299.0,5,3388,6.0,1718.0,1560.0
0.101,6,10,1506,5,395,23.0,127.0,127.0,5,1111,21.0,843.0,843.0
311.768,17,20,1124,10,716,34634.0,48.0,43.0,10,408,34634.0,20.0,12.0
15.079,17,15,8464,8,6223,2150.0,1350.0,749.0,7,2241,2508.0,1350.0,292.0
0.011,6,10,1989,5,910,2.0,642.0,642.0,5,1079,2.0,811.0,811.0
174.106,17,70,10127,35,2338,5120.0,44.0,38.0,35,7789,5120.0,261.0,194.0
0.005,6,10,2006,5,927,1.0,659.0,659.0,5,1079,1.0,811.0,811.0
0.113,6,10,1506,5,395,22.0,127.0,127.0,5,1111,24.0,843.0,843.0
0.005,17,2,170,1,65,0.0,37.0,37.0,1,105,0.0,77.0,77.0
0.005,17,2,170,1,65,0.0,37.0,37.0,1,105,0.0,77.0,77.0
0.001,17,2,136,1,60,0.0,32.0,32.0,1,76,0.0,48.0,48.0
0.098,6,10,1506,5,395,20.0,127.0,127.0,5,1111,22.0,843.0,843.0
0.006,6,10,1689,5,839,1.0,571.0,571.0,5,850,1.0,582.0,582.0
0.074,6,10,1506,5,395,16.0,127.0,127.0,5,1111,15.0,843.0,843.0
0.006,6,10,1547,5,764,1.0,496.0,496.0,5,783,1.0,515.0,515.0
0.004,6,10,2000,5,927,1.0,659.0,659.0,5,1073,1.0,805.0,805.0
0.004,17,2,136,1,60,0.0,32.0,32.0,1,76,0.0,48.0,48.0
300.172,6,16,2170,9,684,37501.0,146.0,146.0,7,1486,50001.0,419.0,398.0
0.145,6,10,1506,5,395,34.0,127.0,127.0,5,1111,30.0,843.0,843.0
0.01,6,10,1990,5,911,2.0,643.0,643.0,5,1079,2.0,811.0,811.0
0.005,6,10,2000,5,927,1.0,659.0,659.0,5,1073,1.0,805.0,805.0
0.005,6,10,1989,5,927,1.0,659.0,659.0,5,1062,1.0,794.0,794.0
0.011,6,10,1983,5,910,2.0,642.0,642.0,5,1073,2.0,805.0,805.0
0.005,6,14,3742,7,452,0.0,80.0,80.0,7,3290,0.0,1448.0,972.0
0.02,6,10,1989,5,910,5.0,642.0,642.0,5,1079,4.0,811.0,811.0
0.005,6,10,2006,5,927,1.0,659.0,659.0,5,1079,1.0,811.0,811.0
0.005,6,13,3747,7,509,0.0,137.0,137.0,6,3238,0.0,1470.0,1459.0
0.015,6,10,1990,5,911,3.0,643.0,643.0,5,1079,3.0,811.0,811.0
40.057,17,10,676,5,460,10011.0,104.0,64.0,5,216,10013.0,20.0,15.0
0.006,6,10,2006,5,927,1.0,659.0,659.0,5,1079,1.0,811.0,811.0
0.004,17,2,152,1,76,0.0,48.0,48.0,1,76,0.0,48.0,48.0
312.812,17,20,1124,10,716,34750.0,48.0,43.0,10,408,34750.0,20.0,12.0
0.225,6,16,2778,8,1396,32.0,533.0,324.0,8,1382,20.0,529.0,239.0
10.929,17,28,4421,14,1994,831.0,269.0,114.0,14,2427,831.0,586.0,145.0
0.004,6,10,2007,5,928,1.0,660.0,660.0,5,1079,1.0,811.0,811.0
0.016,6,10,1762,5,911,4.0,643.0,643.0,5,851,4.0,583.0,583.0
0.004,6,10,2000,5,927,1.0,659.0,659.0,5,1073,1.0,805.0,805.0
0.005,17,2,179,1,71,0.0,43.0,43.0,1,108,0.0,80.0,80.0
0.067,17,8,3613,4,1874,22.0,1350.0,440.0,4,1739,11.0,1350.0,406.0
0.004,17,2,144,1,64,0.0,36.0,36.0,1,80,0.0,52.0,52.0
0.005,6,10,2007,5,928,1.0,660.0,660.0,5,1079,1.0,811.0,811.0
0.005,6,10,1854,5,889,1.0,621.0,621.0,5,965,1.0,697.0,697.0
0.006,17,2,170,1,65,0.0,37.0,37.0,1,105,0.0,77.0,77.0
0.009,17,2,222,1,65,0.0,37.0,37.0,1,157,0.0,129.0,129.0
0.1,6,10,1506,5,395,22.0,127.0,127.0,5,1111,22.0,843.0,843.0
0.005,6,10,2006,5,927,1.0,659.0,659.0,5,1079,1.0,811.0,811.0
40.06,17,10,676,5,460,10014.0,104.0,64.0,5,216,10014.0,20.0,15.0
0.088,6,10,1506,5,395,18.0,127.0,127.0,5,1111,17.0,843.0,843.0
0.007,6,10,1689,5,839,1.0,571.0,571.0,5,850,1.0,582.0,582.0
0.171,17,2,152,1,76,0.0,48.0,48.0,1,76,0.0,48.0,48.0
0.005,6,10,2006,5,927,1.0,659.0,659.0,5,1079,1.0,811.0,811.0
0.04,6,13,3735,7,497,6.0,125.0,125.0,6,3238,8.0,1470.0,1459.0
1786.676,6,150,19350,90,13740,20074.0,302.0,302.0,60,5610,30282.0,83.0,83.0
1.174,6,30,13240,17,5841,73.0,2720.0,854.0,13,7399,83.0,2720.0,858.0
300.09,6,19,4659,11,1102,30008.0,238.0,130.0,8,3557,42869.0,1402.0,786.0
0.117,6,10,1506,5,395,25.0,127.0,127.0,5,1111,23.0,843.0,843.0
0.125,6,10,1506,5,395,29.0,127.0,127.0,5,1111,27.0,843.0,843.0
0.01,6,10,1989,5,910,2.0,642.0,642.0,5,1079,2.0,811.0,811.0
0.016,6,10,1762,5,911,4.0,643.0,643.0,5,851,4.0,583.0,583.0
0.009,6,12,1926,6,1189,1.0,659.0,434.0,6,737,1.0,417.0,417.0
0.133,6,10,1506,5,395,30.0,127.0,127.0,5,1111,31.0,843.0,843.0
240.488,6,35,8924,18,2072,14146.0,693.0,225.0,17,6852,15030.0,1402.0,597.0
0.009,6,10,1972,5,910,2.0,642.0,642.0,5,1062,2.0,794.0,794.0
0.003,17,2,136,1,60,0.0,32.0,32.0,1,76,0.0,48.0,48.0
0.005,6,10,2006,5,927,1.0,659.0,659.0,5,1079,1.0,811.0,811.0
0.072,6,10,1506,5,395,15.0,127.0,127.0,5,1111,16.0,843.0,843.0
0.013,6,10,1983,5,910,3.0,642.0,642.0,5,1073,3.0,805.0,805.0
0.012,6,10,1990,5,911,2.0,643.0,643.0,5,1079,3.0,811.0,811.0
0.001,17,2,180,1,66,0.0,38.0,38.0,1,114,0.0,86.0,86.0
0.083,17,2,152,1,76,0.0,48.0,48.0,1,76,0.0,48.0,48.0
0.094,6,10,1506,5,395,17.0,127.0,127.0,5,1111,21.0,843.0,843.0
0.07,17,8,3613,4,1874,23.0,1350.0,440.0,4,1739,11.0,1350.0,406.0
240.093,6,16,4480,9,963,30011.0,238.0,166.0,7,3517,40015.0,1402.0,786.0
0.005,6,10,2000,5,927,1.0,659.0,659.0,5,1073,1.0,805.0,805.0
0.169,17,2,152,1,76,0.0,48.0,48.0,1,76,0.0,48.0,48.0
40.063,17,10,676,5,460,10014.0,104.0,64.0,5,216,10015.0,20.0,15.0
40.062,17,10,676,5,460,10012.0,104.0,64.0,5,216,10013.0,20.0,15.0
301.047,6,50,15461,28,9509,11149.0,2720.0,927.0,22,5952,423.0,2667.0,361.0
0.017,6,10,1631,5,848,4.0,580.0,580.0,5,783,4.0,515.0,515.0
0.005,6,10,1774,5,923,1.0,655.0,655.0,5,851,1.0,583.0,583.0
0.01,6,10,1990,5,911,2.0,643.0,643.0,5,1079,2.0,811.0,811.0
0.006,6,10,1547,5,764,1.0,496.0,496.0,5,783,1.0,515.0,515.0
0.018,6,10,1989,5,910,4.0,642.0,642.0,5,1079,4.0,811.0,811.0
0.022,6,10,1983,5,910,5.0,642.0,642.0,5,1073,5.0,805.0,805.0
0.011,6,13,3735,7,497,1.0,125.0,125.0,6,3238,2.0,1470.0,1459.0
0.008,6,10,1989,5,910,2.0,642.0,642.0,5,1079,2.0,811.0,811.0
352.272,6,20,2210,6,1308,12004.0,494.0,494.0,14,902,27097.0,83.0,83.0
0.076,6,10,1506,5,395,17.0,127.0,127.0,5,1111,14.0,843.0,843.0
0.003,17,2,148,1,60,0.0,32.0,32.0,1,88,0.0,60.0,60.0
0.039,17,2,412,1,61,0.0,33.0,33.0,1,351,0.0,323.0,323.0
0.042,17,2,152,1,76,0.0,48.0,48.0,1,76,0.0,48.0,48.0
0.041,17,4,284,2,120,0.0,32.0,32.0,2,164,38.0,60.0,54.0
0.004,17,2,148,1,60,0.0,32.0,32.0,1,88,0.0,60.0,60.0
0.012,6,11,2042,6,963,2.0,643.0,643.0,5,1079,3.0,811.0,811.0
308.508,17,20,1124,10,716,34271.0,48.0,43.0,10,408,34272.0,20.0,12.0
0.005,6,10,1779,5,928,1.0,660.0,660.0,5,851,1.0,583.0,583.0
0.012,6,10,1989,5,910,2.0,642.0,642.0,5,1079,3.0,811.0,811.0
0.001,17,2,136,1,60,0.0,32.0,32.0,1,76,0.0,48.0,48.0
0.014,6,10,1989,5,910,3.0,642.0,642.0,5,1079,3.0,811.0,811.0
0.069,6,10,1506,5,395,14.0,127.0,127.0,5,1111,15.0,843.0,843.0
0.001,17,2,180,1,66,0.0,38.0,38.0,1,114,0.0,86.0,86.0
0.014,6,10,1983,5,910,3.0,642.0,642.0,5,1073,3.0,805.0,805.0
15.074,17,14,8055,8,5988,2149.0,1350.0,720.0,6,2067,3009.0,1350.0,316.0
0.077,6,10,1506,5,395,16.0,127.0,127.0,5,1111,15.0,843.0,843.0
0.009,6,10,1631,5,848,2.0,580.0,580.0,5,783,2.0,515.0,515.0
0.005,6,10,1774,5,923,1.0,655.0,655.0,5,851,1.0,583.0,583.0
40.073,17,10,676,5,460,10016.0,104.0,64.0,5,216,10017.0,20.0,15.0
0.006,6,10,1547,5,764,1.0,496.0,496.0,5,783,1.0,515.0,515.0
0.004,6,10,2007,5,928,1.0,660.0,660.0,5,1079,1.0,811.0,811.0
0.111,6,10,1506,5,395,26.0,127.0,127.0,5,1111,26.0,843.0,843.0
0.061,6,10,1506,5,395,13.0,127.0,127.0,5,1111,13.0,843.0,843.0
240.02,6,9,787,5,488,60005.0,232.0,232.0,4,299,80005.0,83.0,83.0
0.127,17,2,80,1,32,0.0,4.0,4.0,1,48,0.0,20.0,20.0
0.012,6,10,1989,5,910,3.0,642.0,642.0,5,1079,3.0,811.0,811.0
295.343,6,319,343810,123,17942,2420.0,2736.0,888.0,196,325868,1514.0,2804.0,1744.0
0.004,6,10,2007,5,928,1.0,660.0,660.0,5,1079,1.0,811.0,811.0
361.833,6,21,1792,16,1030,24122.0,190.0,190.0,5,762,60010.0,461.0,247.0
0.226,6,16,2777,8,1395,32.0,533.0,323.0,8,1382,20.0,529.0,239.0
0.003,17,4,284,2,120,0.0,32.0,32.0,2,164,0.0,60.0,54.0
0.01,6,10,1972,5,910,2.0,642.0,642.0,5,1062,2.0,794.0,794.0
0.009,6,13,3735,7,497,1.0,125.0,125.0,6,3238,1.0,1470.0,1459.0
0.038,17,2,136,1,60,0.0,32.0,32.0,1,76,0.0,48.0,48.0
0.005,17,2,136,1,60,0.0,32.0,32.0,1,76,0.0,48.0,48.0
0.005,6,10,2006,5,927,1.0,659.0,659.0,5,1079,1.0,811.0,811.0
0.022,6,10,1989,5,910,5.0,642.0,642.0,5,1079,5.0,811.0,811.0
40.074,17,10,676,5,460,10017.0,104.0,64.0,5,216,10017.0,20.0,15.0
0.01,6,12,1926,6,1189,1.0,659.0,434.0,6,737,1.0,417.0,417.0
10.84,17,28,4421,14,1994,825.0,269.0,114.0,14,2427,824.0,586.0,145.0
0.012,6,10,1631,5,848,3.0,580.0,580.0,5,783,3.0,515.0,515.0
0.098,6,10,1506,5,395,23.0,127.0,127.0,5,1111,23.0,843.0,843.0
0.005,6,10,2000,5,927,1.0,659.0,659.0,5,1073,1.0,805.0,805.0
0.018,6,10,1983,5,910,4.0,642.0,642.0,5,1073,4.0,805.0,805.0
0.005,6,10,2007,5,928,1.0,660.0,660.0,5,1079,1.0,811.0,811.0
0.082,17,2,184,1,61,0.0,33.0,33.0,1,123,0.0,95.0,95.0
0.064,17,2,144,1,64,0.0,36.0,36.0,1,80,0.0,52.0,52.0
0.005,6,13,3690,7,452,0.0,80.0,80.0,6,3238,0.0,1470.0,1459.0
0.018,6,10,1631,5,848,4.0,580.0,580.0,5,783,4.0,515.0,515.0
0.107,6,10,1506,5,395,22.0,127.0,127.0,5,1111,26.0,843.0,843.0
0.006,6,10,2007,5,928,1.0,660.0,660.0,5,1079,1.0,811.0,811.0
0.004,17,2,185,1,73,0.0,45.0,45.0,1,112,0.0,84.0,84.0
300.373,6,25,7303,15,1357,21455.0,217.0,142.0,10,5946,26706.0,1679.0,903.0
0.067,17,8,3613,4,1874,22.0,1350.0,440.0,4,1739,11.0,1350.0,406.0
0.172,17,2,152,1,76,0.0,48.0,48.0,1,76,0.0,48.0,48.0
0.006,6,10,1643,5,860,1.0,592.0,592.0,5,783,1.0,515.0,515.0
40.054,17,10,676,5,460,10012.0,104.0,64.0,5,216,10012.0,20.0,15.0
0.012,6,10,1972,5,910,2.0,642.0,642.0,5,1062,2.0,794.0,794.0
40.056,17,10,676,5,460,10013.0,104.0,64.0,5,216,10013.0,20.0,15.0
0.012,6,10,1990,5,911,3.0,643.0,643.0,5,1079,3.0,811.0,811.0
0.138,6,10,1506,5,395,33.0,127.0,127.0,5,1111,32.0,843.0,843.0
0.005,6,10,1779,5,928,1.0,660.0,660.0,5,851,1.0,583.0,583.0
0.004,6,10,1774,5,923,1.0,655.0,655.0,5,851,1.0,583.0,583.0
0.005,6,10,2006,5,927,1.0,659.0,659.0,5,1079,1.0,811.0,811.0
1787.387,6,154,19574,92,13852,19641.0,302.0,302.0,62,5722,29301.0,83.0,83.0
0.005,6,10,2007,5,928,1.0,660.0,660.0,5,1079,1.0,811.0,811.0
0.004,6,10,1779,5,928,1.0,660.0,660.0,5,851,1.0,583.0,583.0
15.379,17,42,20244,22,17083,731.0,1350.0,748.0,20,3161,807.0,1350.0,130.0
0.004,17,2,136,1,60,0.0,32.0,32.0,1,76,0.0,48.0,48.0
0.015,6,10,1983,5,910,3.0,642.0,642.0,5,1073,3.0,805.0,805.0
0.078,6,10,1506,5,395,17.0,127.0,127.0,5,1111,17.0,843.0,843.0
0.007,17,4,284,2,120,0.0,32.0,32.0,2,164,0.0,60.0,54.0
0.006,6,10,1854,5,889,1.0,621.0,621.0,5,965,1.0,697.0,697.0
0.005,6,10,2006,5,927,1.0,659.0,659.0,5,1079,1.0,811.0,811.0
0.004,6,10,1989,5,927,1.0,659.0,659.0,5,1062,1.0,794.0,794.0
0.072,17,4,284,2,120,0.0,32.0,32.0,2,164,30.0,60.0,54.0
0.004,17,2,148,1,60,0.0,32.0,32.0,1,88,0.0,60.0,60.0
0.001,17,2,166,1,75,0.0,47.0,47.0,1,91,0.0,63.0,63.0
0.006,6,10,1689,5,839,1.0,571.0,571.0,5,850,1.0,582.0,582.0
0.171,6,3,453,2,321,171.0,241.0,241.0,1,132,0.0,92.0,92.0
0.011,6,10,1972,5,910,2.0,642.0,642.0,5,1062,2.0,794.0,794.0
0.004,6,10,1989,5,927,1.0,659.0,659.0,5,1062,1.0,794.0,794.0
0.0,17,2,180,1,66,0.0,38.0,38.0,1,114,0.0,86.0,86.0
0.006,17,2,230,1,68,0.0,40.0,40.0,1,162,0.0,134.0,134.0
0.015,6,10,1972,5,910,3.0,642.0,642.0,5,1062,3.0,794.0,794.0
0.121,6,10,1506,5,395,27.0,127.0,127.0,5,1111,26.0,843.0,843.0
0.168,17,2,152,1,76,0.0,48.0,48.0,1,76,0.0,48.0,48.0
0.02,6,10,1990,5,911,5.0,643.0,643.0,5,1079,5.0,811.0,811.0
0.005,17,2,222,1,65,0.0,37.0,37.0,1,157,0.0,129.0,129.0
1786.857,6,155,19626,92,13852,19635.0,302.0,302.0,63,5774,28820.0,83.0,83.0
0.096,6,10,1506,5,395,22.0,127.0,127.0,5,1111,22.0,843.0,843.0
0.011,6,10,1989,5,910,2.0,642.0,642.0,5,1079,2.0,811.0,811.0
0.005,6,10,1689,5,839,1.0,571.0,571.0,5,850,1.0,582.0,582.0
11.165,17,28,4422,14,1995,846.0,270.0,114.0,14,2427,846.0,586.0,145.0
0.003,17,2,136,1,60,0.0,32.0,32.0,1,76,0.0,48.0,48.0
0.006,17,2,214,1,75,0.0,47.0,47.0,1,139,0.0,111.0,111.0
0.015,6,10,1983,5,910,3.0,642.0,642.0,5,1073,3.0,805.0,805.0
0.003,17,2,148,1,60,0.0,32.0,32.0,1,88,0.0,60.0,60.0
0.005,6,10,2000,5,927,1.0,659.0,659.0,5,1073,1.0,805.0,805.0
0.001,17,2,136,1,60,0.0,32.0,32.0,1,76,0.0,48.0,48.0
0.04,17,2,152,1,76,0.0,48.0,48.0,1,76,0.0,48.0,48.0
0.094,6,10,1506,5,395,19.0,127.0,127.0,5,1111,21.0,843.0,843.0
0.006,6,10,1643,5,860,1.0,592.0,592.0,5,783,1.0,515.0,515.0
0.069,6,10,1506,5,395,15.0,127.0,127.0,5,1111,14.0,843.0,843.0
0.009,6,10,1990,5,911,2.0,643.0,643.0,5,1079,2.0,811.0,811.0
240.105,6,32,9493,16,7039,16007.0,2110.0,690.0,16,2454,16006.0,580.0,201.0
0.013,6,10,1762,5,911,3.0,643.0,643.0,5,851,3.0,583.0,583.0
0.007,6,10,1762,5,911,1.0,643.0,643.0,5,851,1.0,583.0,583.0
0.006,6,10,2006,5,927,1.0,659.0,659.0,5,1079,1.0,811.0,811.0
0.004,6,10,1989,5,927,1.0,659.0,659.0,5,1062,1.0,794.0,794.0
151.201,58,3,216,2,144,151201.0,24.0,24.0,1,72,0.0,24.0,24.0
0.011,6,10,1972,5,910,2.0,642.0,642.0,5,1062,2.0,794.0,794.0
40.054,17,10,676,5,460,10012.0,104.0,64.0,5,216,10012.0,20.0,15.0
0.169,6,10,1506,5,395,41.0,127.0,127.0,5,1111,39.0,843.0,843.0
40.062,17,10,676,5,460,10014.0,104.0,64.0,5,216,10014.0,20.0,15.0
0.171,17,2,152,1,76,0.0,48.0,48.0,1,76,0.0,48.0,48.0
40.056,17,10,676,5,460,10013.0,104.0,64.0,5,216,10012.0,20.0,15.0
0.001,17,2,180,1,65,0.0,37.0,37.0,1,115,0.0,87.0,87.0
0.022,6,10,1990,5,911,5.0,643.0,643.0,5,1079,5.0,811.0,811.0
10.854,17,28,4422,14,1995,826.0,270.0,114.0,14,2427,826.0,586.0,145.0
323.77,6,634,736303,336,716837,966.0,4080.0,2276.0,298,19466,106.0,2667.0,215.0
0.07,6,10,1506,5,395,14.0,127.0,127.0,5,1111,16.0,843.0,843.0
293.284,6,390,348581,194,21645,1519.0,2736.0,888.0,196,326936,1504.0,2804.0,1740.0
0.001,17,2,180,1,66,0.0,38.0,38.0,1,114,0.0,86.0,86.0
0.004,17,2,164,1,74,0.0,46.0,46.0,1,90,0.0,62.0,62.0
0.005,6,10,2007,5,928,1.0,660.0,660.0,5,1079,1.0,811.0,811.0
0.009,6,10,1983,5,910,2.0,642.0,642.0,5,1073,2.0,805.0,805.0
0.082,6,10,1506,5,395,18.0,127.0,127.0,5,1111,20.0,843.0,843.0
40.095,17,10,676,5,460,10021.0,104.0,64.0,5,216,10022.0,20.0,15.0
0.019,6,10,1990,5,911,4.0,643.0,643.0,5,1079,4.0,811.0,811.0
0.006,6,14,3799,7,509,1.0,137.0,137.0,7,3290,0.0,1448.0,972.0
0.135,6,10,1506,5,395,32.0,127.0,127.0,5,1111,30.0,843.0,843.0
0.005,6,10,1547,5,764,1.0,496.0,496.0,5,783,1.0,515.0,515.0
0.005,6,10,2006,5,927,1.0,659.0,659.0,5,1079,1.0,811.0,811.0
0.075,6,10,1506,5,395,16.0,127.0,127.0,5,1111,16.0,843.0,843.0
0.005,6,10,1989,5,927,1.0,659.0,659.0,5,1062,1.0,794.0,794.0
40.066,17,10,676,5,460,10014.0,104.0,64.0,5,216,10015.0,20.0,15.0
0.115,6,10,1506,5,395,27.0,127.0,127.0,5,1111,22.0,843.0,843.0
0.006,6,10,2006,5,927,1.0,659.0,659.0,5,1079,1.0,811.0,811.0
0.005,6,10,1989,5,927,1.0,659.0,659.0,5,1062,1.0,794.0,794.0
0.011,6,13,3735,7,497,1.0,125.0,125.0,6,3238,2.0,1470.0,1459.0
0.038,17,2,136,1,60,0.0,32.0,32.0,1,76,0.0,48.0,48.0
0.109,6,10,1506,5,395,21.0,127.0,127.0,5,1111,24.0,843.0,843.0
30.178,6,46,16628,23,10865,409.0,2720.0,1414.0,23,5763,1364.0,2667.0,402.0
0.076,6,10,1506,5,395,16.0,127.0,127.0,5,1111,15.0,843.0,843.0
0.089,6,10,1506,5,395,19.0,127.0,127.0,5,1111,16.0,843.0,843.0
0.016,6,10,1677,5,827,4.0,559.0,559.0,5,850,4.0,582.0,582.0
0.015,6,10,1631,5,848,3.0,580.0,580.0,5,783,3.0,515.0,515.0
0.109,6,10,1506,5,395,26.0,127.0,127.0,5,1111,24.0,843.0,843.0
0.006,6,10,1689,5,839,1.0,571.0,571.0,5,850,1.0,582.0,582.0
0.083,6,10,1506,5,395,18.0,127.0,127.0,5,1111,17.0,843.0,843.0
0.004,17,2,148,1,60,0.0,32.0,32.0,1,88,0.0,60.0,60.0
10.731,17,28,4421,14,1993,817.0,268.0,114.0,14,2428,817.0,587.0,145.0
40.061,17,10,676,5,460,10014.0,104.0,64.0,5,216,10014.0,20.0,15.0
300.035,6,12,1782,7,1348,50005.0,494.0,494.0,5,434,75008.0,83.0,83.0
0.004,6,10,1702,5,863,0.0,595.0,595.0,5,839,1.0,571.0,571.0
0.016,6,13,3735,7,497,2.0,125.0,125.0,6,3238,3.0,1470.0,1459.0
0.015,6,10,1990,5,911,3.0,643.0,643.0,5,1079,3.0,811.0,811.0
0.004,6,10,2006,5,927,1.0,659.0,659.0,5,1079,1.0,811.0,811.0
0.004,17,4,284,2,120,0.0,32.0,32.0,2,164,0.0,60.0,54.0
0.174,6,10,1506,5,395,41.0,127.0,127.0,5,1111,40.0,843.0,843.0
0.006,6,10,2007,5,928,1.0,660.0,660.0,5,1079,1.0,811.0,811.0
40.057,17,10,676,5,460,10013.0,104.0,64.0,5,216,10012.0,20.0,15.0
40.051,17,10,676,5,460,10011.0,104.0,64.0,5,216,10012.0,20.0,15.0
0.009,6,10,1989,5,910,2.0,642.0,642.0,5,1079,2.0,811.0,811.0
0.011,6,10,1989,5,910,2.0,642.0,642.0,5,1079,2.0,811.0,811.0
0.068,6,10,1506,5,395,16.0,127.0,127.0,5,1111,14.0,843.0,843.0
0.022,6,10,1972,5,910,5.0,642.0,642.0,5,1062,5.0,794.0,794.0
300.396,6,16,2170,9,684,37528.0,146.0,146.0,7,1486,50037.0,419.0,398.0
0.037,6,10,1972,5,910,9.0,642.0,642.0,5,1062,9.0,794.0,794.0
0.003,17,2,136,1,60,0.0,32.0,32.0,1,76,0.0,48.0,48.0
15.103,17,15,8243,8,6142,2151.0,1350.0,739.0,7,2101,2510.0,1350.0,272.0
9.037,17,6,376,5,280,2259.0,28.0,28.0,1,96,0.0,68.0,68.0
0.019,17,2,136,1,60,0.0,32.0,32.0,1,76,0.0,48.0,48.0
0.014,6,10,1989,5,910,3.0,642.0,642.0,5,1079,3.0,811.0,811.0
0.009,6,10,1989,5,910,2.0,642.0,642.0,5,1079,2.0,811.0,811.0
0.09,6,10,1506,5,395,20.0,127.0,127.0,5,1111,19.0,843.0,843.0
0.005,6,10,2007,5,928,1.0,660.0,660.0,5,1079,1.0,811.0,811.0
0.005,6,10,1643,5,860,1.0,592.0,592.0,5,783,1.0,515.0,515.0
2.16,6,43,11001,22,2615,102.0,517.0,245.0,21,8386,107.0,1402.0,520.0
0.005,6,10,1547,5,764,1.0,496.0,496.0,5,783,1.0,515.0,515.0
313.255,17,18,1008,9,640,39143.0,48.0,43.0,9,368,39145.0,20.0,12.0
0.005,6,10,1779,5,928,1.0,660.0,660.0,5,851,1.0,583.0,583.0
0.005,6,10,1702,5,863,1.0,595.0,595.0,5,839,1.0,571.0,571.0
354.061,6,19,1691,15,978,25290.0,190.0,190.0,4,713,80005.0,497.0,497.0
0.005,6,10,1643,5,860,1.0,592.0,592.0,5,783,1.0,515.0,515.0
121.062,6,55,18860,30,4626,4174.0,1052.0,235.0,25,14234,5042.0,1402.0,861.0
1799.993,6,137,6590,76,3625,23996.0,39.0,39.0,61,2965,29995.0,35.0,35.0
0.007,6,10,1547,5,764,1.0,496.0,496.0,5,783,1.0,515.0,515.0
0.107,6,10,1506,5,395,23.0,127.0,127.0,5,1111,23.0,843.0,843.0
40.077,17,10,676,5,460,10017.0,104.0,64.0,5,216,10018.0,20.0,15.0
0.001,17,2,180,1,66,0.0,38.0,38.0,1,114,0.0,86.0,86.0
0.005,6,10,1643,5,860,1.0,592.0,592.0,5,783,1.0,515.0,515.0
0.005,17,2,194,1,59,0.0,31.0,31.0,1,135,0.0,107.0,107.0
0.006,17,2,136,1,60,0.0,32.0,32.0,1,76,0.0,48.0,48.0
0.005,6,10,2006,5,927,1.0,659.0,659.0,5,1079,1.0,811.0,811.0
0.011,6,10,1972,5,910,2.0,642.0,642.0,5,1062,2.0,794.0,794.0
1787.466,6,150,19350,90,13740,20083.0,302.0,302.0,60,5610,30295.0,83.0,83.0
0.009,6,10,1972,5,910,2.0,642.0,642.0,5,1062,2.0,794.0,794.0
40.07,17,10,676,5,460,10016.0,104.0,64.0,5,216,10016.0,20.0,15.0
0.003,17,2,136,1,60,0.0,32.0,32.0,1,76,0.0,48.0,48.0
0.011,6,10,1972,5,910,2.0,642.0,642.0,5,1062,2.0,794.0,794.0
0.004,6,10,1779,5,928,1.0,660.0,660.0,5,851,1.0,583.0,583.0
354.003,6,19,1691,15,978,25285.0,190.0,190.0,4,713,80003.0,497.0,497.0
0.006,6,10,2006,5,927,1.0,659.0,659.0,5,1079,1.0,811.0,811.0
0.006,17,2,169,1,62,0.0,34.0,34.0,1,107,0.0,79.0,79.0
0.018,6,10,1989,5,910,4.0,642.0,642.0,5,1079,4.0,811.0,811.0
0.074,6,10,1506,5,395,14.0,127.0,127.0,5,1111,16.0,843.0,843.0
308.598,17,20,1124,10,716,34274.0,48.0,43.0,10,408,34274.0,20.0,12.0
0.002,17,2,174,1,72,0.0,44.0,44.0,1,102,0.0,74.0,74.0
0.003,17,2,136,1,60,0.0,32.0,32.0,1,76,0.0,48.0,48.0
0.006,6,10,1547,5,764,1.0,496.0,496.0,5,783,1.0,515.0,515.0
0.008,6,10,1983,5,910,1.0,642.0,642.0,5,1073,2.0,805.0,805.0
240.092,6,31,9005,15,6762,17149.0,1886.0,665.0,16,2243,16005.0,580.0,175.0
0.004,6,10,1779,5,928,1.0,660.0,660.0,5,851,1.0,583.0,583.0
240.106,6,16,4482,9,963,30013.0,238.0,166.0,7,3519,40017.0,1402.0,786.0
15.073,17,14,9190,8,6902,2149.0,1350.0,834.0,6,2288,3008.0,1350.0,353.0
0.008,6,10,1605,5,388,2.0,120.0,120.0,5,1217,2.0,949.0,949.0
0.005,6,10,1779,5,928,1.0,660.0,660.0,5,851,1.0,583.0,583.0
240.023,6,9,787,5,488,60005.0,232.0,232.0,4,299,80006.0,83.0,83.0
0.082,6,10,1506,5,395,15.0,127.0,127.0,5,1111,17.0,843.0,843.0
0.005,6,13,3747,7,509,0.0,137.0,137.0,6,3238,1.0,1470.0,1459.0
0.018,6,10,1972,5,910,4.0,642.0,642.0,5,1062,4.0,794.0,794.0
0.011,6,10,1989,5,910,2.0,642.0,642.0,5,1079,2.0,811.0,811.0
0.005,6,10,2006,5,927,1.0,659.0,659.0,5,1079,1.0,811.0,811.0
0.012,6,10,1983,5,910,3.0,642.0,642.0,5,1073,2.0,805.0,805.0
0.005,6,13,3747,7,509,0.0,137.0,137.0,6,3238,1.0,1470.0,1459.0
0.005,17,2,166,1,75,0.0,47.0,47.0,1,91,0.0,63.0,63.0
1.036,6,30,12711,17,3312,64.0,1360.0,517.0,13,9399,72.0,2720.0,985.0
0.041,17,2,348,1,61,0.0,33.0,33.0,1,287,0.0,259.0,259.0
240.098,6,31,9378,15,7004,17149.0,2129.0,692.0,16,2374,16006.0,580.0,191.0
1729.211,6,60,4400,40,2740,44338.0,33.0,33.0,20,1660,91002.0,31.0,31.0
0.005,6,10,2006,5,927,1.0,659.0,659.0,5,1079,1.0,811.0,811.0
0.01,6,10,1983,5,910,2.0,642.0,642.0,5,1073,2.0,805.0,805.0
0.001,17,2,180,1,66,0.0,38.0,38.0,1,114,0.0,86.0,86.0
0.01,6,10,1990,5,911,2.0,643.0,643.0,5,1079,2.0,811.0,811.0
0.105,6,10,1506,5,395,22.0,127.0,127.0,5,1111,24.0,843.0,843.0
0.007,6,10,2007,5,928,1.0,660.0,660.0,5,1079,1.0,811.0,811.0
0.007,6,10,1989,5,910,1.0,642.0,642.0,5,1079,1.0,811.0,811.0
0.111,6,10,1506,5,395,18.0,127.0,127.0,5,1111,26.0,843.0,843.0
0.005,6,10,1854,5,889,1.0,621.0,621.0,5,965,1.0,697.0,697.0
10.928,17,28,4423,14,1994,832.0,269.0,114.0,14,2429,832.0,588.0,145.0
0.005,6,10,1689,5,839,1.0,571.0,571.0,5,850,1.0,582.0,582.0
0.073,6,10,1506,5,395,15.0,127.0,127.0,5,1111,17.0,843.0,843.0
40.063,17,10,676,5,460,10014.0,104.0,64.0,5,216,10014.0,20.0,15.0
0.006,6,10,1547,5,764,1.0,496.0,496.0,5,783,1.0,515.0,515.0
0.076,6,10,1506,5,395,15.0,127.0,127.0,5,1111,17.0,843.0,843.0
0.011,6,10,1989,5,910,2.0,642.0,642.0,5,1079,2.0,811.0,811.0
0.014,6,10,1631,5,848,3.0,580.0,580.0,5,783,3.0,515.0,515.0
0.008,6,10,1989,5,927,1.0,659.0,659.0,5,1062,2.0,794.0,794.0
309.119,17,20,1124,10,716,34339.0,48.0,43.0,10,408,34339.0,20.0,12.0
0.006,6,10,1547,5,764,1.0,496.0,496.0,5,783,1.0,515.0,515.0
0.078,6,10,1506,5,395,17.0,127.0,127.0,5,1111,17.0,843.0,843.0
0.108,6,10,1506,5,395,24.0,127.0,127.0,5,1111,25.0,843.0,843.0
0.006,6,10,1643,5,860,1.0,592.0,592.0,5,783,1.0,515.0,515.0
0.005,6,13,3747,7,509,0.0,137.0,137.0,6,3238,0.0,1470.0,1459.0
1.023,6,12,3134,6,2099,154.0,1328.0,923.0,6,1035,154.0,791.0,791.0
0.099,6,10,1506,5,395,23.0,127.0,127.0,5,1111,20.0,843.0,843.0
0.115,6,10,1506,5,395,26.0,127.0,127.0,5,1111,25.0,843.0,843.0
0.006,6,10,1643,5,860,1.0,592.0,592.0,5,783,1.0,515.0,515.0
0.011,6,10,1989,5,910,2.0,642.0,642.0,5,1079,2.0,811.0,811.0
301.223,6,27,9197,15,1961,21515.0,568.0,293.0,12,7236,27383.0,2370.0,1102.0
0.11,6,10,1506,5,395,25.0,127.0,127.0,5,1111,25.0,843.0,843.0
0.005,6,13,3747,7,509,0.0,137.0,137.0,6,3238,0.0,1470.0,1459.0
0.005,17,2,164,1,74,0.0,46.0,46.0,1,90,0.0,62.0,62.0
0.007,6,10,1547,5,764,1.0,496.0,496.0,5,783,1.0,515.0,515.0
0.004,17,2,148,1,60,0.0,32.0,32.0,1,88,0.0,60.0,60.0
0.004,17,2,170,1,65,0.0,37.0,37.0,1,105,0.0,77.0,77.0
0.014,6,10,1972,5,910,3.0,642.0,642.0,5,1062,3.0,794.0,794.0
0.104,6,10,1506,5,395,21.0,127.0,127.0,5,1111,24.0,843.0,843.0
0.011,6,6,716,3,458,4.0,302.0,302.0,3,258,4.0,102.0,102.0
0.013,6,10,1972,5,910,3.0,642.0,642.0,5,1062,3.0,794.0,794.0
0.004,6,10,2006,5,927,1.0,659.0,659.0,5,1079,1.0,811.0,811.0
0.06,6,10,1506,5,395,14.0,127.0,127.0,5,1111,14.0,843.0,843.0
0.001,17,2,136,1,60,0.0,32.0,32.0,1,76,0.0,48.0,48.0
0.091,6,10,1506,5,395,20.0,127.0,127.0,5,1111,20.0,843.0,843.0
40.054,17,10,676,5,460,10012.0,104.0,64.0,5,216,10012.0,20.0,15.0
0.006,6,10,1547,5,764,1.0,496.0,496.0,5,783,1.0,515.0,515.0
0.118,6,10,1506,5,395,24.0,127.0,127.0,5,1111,23.0,843.0,843.0
0.005,17,2,164,1,74,0.0,46.0,46.0,1,90,0.0,62.0,62.0
240.093,6,16,4481,9,963,30011.0,238.0,166.0,7,3518,40015.0,1402.0,786.0
0.1,6,10,1506,5,395,22.0,127.0,127.0,5,1111,19.0,843.0,843.0
0.068,17,8,3613,4,1874,22.0,1350.0,440.0,4,1739,11.0,1350.0,406.0
0.016,6,10,1983,5,910,4.0,642.0,642.0,5,1073,4.0,805.0,805.0
40.099,17,10,676,5,460,10017.0,104.0,64.0,5,216,10018.0,20.0,15.0
0.003,17,2,170,1,65,0.0,37.0,37.0,1,105,0.0,77.0,77.0
0.013,6,10,1989,5,910,3.0,642.0,642.0,5,1079,3.0,811.0,811.0
40.051,17,10,676,5,460,10011.0,104.0,64.0,5,216,10011.0,20.0,15.0
5.157,6,24,7042,14,1879,396.0,801.0,282.0,10,5163,572.0,1925.0,774.0
0.011,6,10,1989,5,910,2.0,642.0,642.0,5,1079,2.0,811.0,811.0
0.006,17,2,170,1,65,0.0,37.0,37.0,1,105,0.0,77.0,77.0
40.054,17,10,676,5,460,10012.0,104.0,64.0,5,216,10012.0,20.0,15.0
0.115,6,10,1506,5,395,26.0,127.0,127.0,5,1111,26.0,843.0,843.0
0.012,6,10,1972,5,910,3.0,642.0,642.0,5,1062,2.0,794.0,794.0
240.102,6,16,4482,9,963,30012.0,238.0,166.0,7,3519,40016.0,1402.0,786.0
0.005,6,10,2000,5,927,1.0,659.0,659.0,5,1073,1.0,805.0,805.0
0.014,6,10,1990,5,911,3.0,643.0,643.0,5,1079,3.0,811.0,811.0
40.068,17,10,676,5,460,10014.0,104.0,64.0,5,216,10016.0,20.0,15.0
0.171,17,2,152,1,76,0.0,48.0,48.0,1,76,0.0,48.0,48.0
0.006,6,10,1547,5,764,1.0,496.0,496.0,5,783,1.0,515.0,515.0
0.005,6,10,1774,5,923,1.0,655.0,655.0,5,851,1.0,583.0,583.0
0.005,17,2,164,1,74,0.0,46.0,46.0,1,90,0.0,62.0,62.0
0.007,17,2,179,1,71,0.0,43.0,43.0,1,108,0.0,80.0,80.0
0.006,6,10,1643,5,860,1.0,592.0,592.0,5,783,1.0,515.0,515.0
0.077,6,10,1506,5,395,18.0,127.0,127.0,5,1111,15.0,843.0,843.0
0.066,6,10,1506,5,395,15.0,127.0,127.0,5,1111,13.0,843.0,843.0
0.085,6,10,1506,5,395,17.0,127.0,127.0,5,1111,19.0,843.0,843.0
0.014,6,10,1989,5,910,3.0,642.0,642.0,5,1079,3.0,811.0,811.0
0.006,17,2,180,1,66,0.0,38.0,38.0,1,114,0.0,86.0,86.0
0.011,6,10,1989,5,910,2.0,642.0,642.0,5,1079,2.0,811.0,811.0
0.005,17,2,164,1,74,0.0,46.0,46.0,1,90,0.0,62.0,62.0
0.037,17,2,136,1,60,0.0,32.0,32.0,1,76,0.0,48.0,48.0
0.006,6,10,1689,5,839,1.0,571.0,571.0,5,850,1.0,582.0,582.0
0.005,6,10,1989,5,927,1.0,659.0,659.0,5,1062,1.0,794.0,794.0
0.006,6,10,1547,5,764,1.0,496.0,496.0,5,783,1.0,515.0,515.0
0.004,6,10,1702,5,863,1.0,595.0,595.0,5,839,1.0,571.0,571.0
0.004,17,2,136,1,60,0.0,32.0,32.0,1,76,0.0,48.0,48.0
0.115,6,10,1506,5,395,27.0,127.0,127.0,5,1111,27.0,843.0,843.0
0.01,6,10,1972,5,910,2.0,642.0,642.0,5,1062,2.0,794.0,794.0
0.087,6,10,1506,5,395,21.0,127.0,127.0,5,1111,17.0,843.0,843.0
0.127,17,2,170,1,65,0.0,37.0,37.0,1,105,0.0,77.0,77.0
0.009,6,10,2007,5,928,2.0,660.0,660.0,5,1079,2.0,811.0,811.0
0.037,17,4,284,2,120,0.0,32.0,32.0,2,164,0.0,60.0,54.0
1799.776,6,253,25546,103,9485,17643.0,586.0,66.0,150,16061,12078.0,1360.0,130.0
0.164,6,10,1506,5,395,38.0,127.0,127.0,5,1111,35.0,843.0,843.0
0.012,6,10,1990,5,911,2.0,643.0,643.0,5,1079,3.0,811.0,811.0
0.005,6,10,1779,5,928,1.0,660.0,660.0,5,851,1.0,583.0,583.0
0.064,6,10,1506,5,395,14.0,127.0,127.0,5,1111,12.0,843.0,843.0
0.014,6,10,1989,5,910,3.0,642.0,642.0,5,1079,3.0,811.0,811.0
10.734,17,28,4417,14,1993,817.0,268.0,114.0,14,2424,817.0,587.0,145.0
0.006,6,10,1779,5,928,1.0,660.0,660.0,5,851,1.0,583.0,583.0
40.055,17,10,676,5,460,10011.0,104.0,64.0,5,216,10013.0,20.0,15.0
0.038,17,2,170,1,65,0.0,37.0,37.0,1,105,0.0,77.0,77.0
0.016,6,10,1989,5,910,3.0,642.0,642.0,5,1079,3.0,811.0,811.0
0.005,6,10,2007,5,928,1.0,660.0,660.0,5,1079,1.0,811.0,811.0
0.004,17,2,148,1,60,0.0,32.0,32.0,1,88,0.0,60.0,60.0
0.009,6,10,1972,5,910,2.0,642.0,642.0,5,1062,2.0,794.0,794.0
0.123,6,10,1506,5,395,29.0,127.0,127.0,5,1111,30.0,843.0,843.0
0.015,6,10,1990,5,911,3.0,643.0,643.0,5,1079,3.0,811.0,811.0
30.583,58,2,144,1,72,0.0,24.0,24.0,1,72,0.0,24.0,24.0
0.004,6,10,2007,5,928,1.0,660.0,660.0,5,1079,1.0,811.0,811.0
0.005,6,10,2006,5,927,1.0,659.0,659.0,5,1079,1.0,811.0,811.0
0.005,6,10,2006,5,927,1.0,659.0,659.0,5,1079,1.0,811.0,811.0
0.091,6,10,1506,5,395,22.0,127.0,127.0,5,1111,20.0,843.0,843.0
0.016,6,10,1989,5,910,4.0,642.0,642.0,5,1079,4.0,811.0,811.0
0.01,6,10,1677,5,827,2.0,559.0,559.0,5,850,2.0,582.0,582.0
0.001,17,2,142,1,63,0.0,35.0,35.0,1,79,0.0,51.0,51.0
0.006,17,2,169,1,62,0.0,34.0,34.0,1,107,0.0,79.0,79.0
0.138,6,10,1506,5,395,23.0,127.0,127.0,5,1111,29.0,843.0,843.0
40.074,17,10,676,5,460,10016.0,104.0,64.0,5,216,10017.0,20.0,15.0
0.005,6,10,2006,5,927,1.0,659.0,659.0,5,1079,1.0,811.0,811.0
0.004,6,10,2006,5,927,1.0,659.0,659.0,5,1079,1.0,811.0,811.0
0.018,17,2,152,1,56,0.0,28.0,28.0,1,96,0.0,68.0,68.0
0.012,6,10,1631,5,848,3.0,580.0,580.0,5,783,2.0,515.0,515.0
0.095,6,10,1506,5,395,20.0,127.0,127.0,5,1111,21.0,843.0,843.0
0.006,6,10,1547,5,764,1.0,496.0,496.0,5,783,1.0,515.0,515.0
0.098,6,10,1506,5,395,21.0,127.0,127.0,5,1111,21.0,843.0,843.0
0.001,17,2,268,1,70,0.0,42.0,42.0,1,198,0.0,170.0,170.0
0.012,6,10,1989,5,910,2.0,642.0,642.0,5,1079,2.0,811.0,811.0
0.005,6,10,1989,5,927,1.0,659.0,659.0,5,1062,1.0,794.0,794.0
0.068,6,10,1506,5,395,14.0,127.0,127.0,5,1111,15.0,843.0,843.0
0.005,6,10,2006,5,927,1.0,659.0,659.0,5,1079,1.0,811.0,811.0
0.005,17,2,166,1,75,0.0,47.0,47.0,1,91,0.0,63.0,63.0
0.11,6,10,1506,5,395,24.0,127.0,127.0,5,1111,25.0,843.0,843.0
0.003,17,2,152,1,76,0.0,48.0,48.0,1,76,0.0,48.0,48.0
0.007,17,2,194,1,59,0.0,31.0,31.0,1,135,0.0,107.0,107.0
0.005,17,2,136,1,60,0.0,32.0,32.0,1,76,0.0,48.0,48.0
0.011,6,10,1972,5,910,2.0,642.0,642.0,5,1062,2.0,794.0,794.0
240.016,6,9,787,5,488,60004.0,232.0,232.0,4,299,80004.0,83.0,83.0
240.299,6,40,5255,19,2383,13349.0,588.0,196.0,21,2872,12014.0,580.0,221.0
0.005,6,10,1774,5,923,1.0,655.0,655.0,5,851,1.0,583.0,583.0
0.01,6,10,1677,5,827,2.0,559.0,559.0,5,850,2.0,582.0,582.0
0.01,6,12,1926,6,1189,2.0,659.0,434.0,6,737,2.0,417.0,417.0
0.008,6,10,1972,5,910,2.0,642.0,642.0,5,1062,2.0,794.0,794.0
317.568,17,20,1124,10,716,35270.0,48.0,43.0,10,408,35270.0,20.0,12.0
0.004,17,2,148,1,60,0.0,32.0,32.0,1,88,0.0,60.0,60.0
0.005,17,2,214,1,75,0.0,47.0,47.0,1,139,0.0,111.0,111.0
0.005,6,10,1702,5,863,1.0,595.0,595.0,5,839,1.0,571.0,571.0
0.005,6,10,1689,5,839,1.0,571.0,571.0,5,850,1.0,582.0,582.0
0.005,6,13,3690,7,452,0.0,80.0,80.0,6,3238,0.0,1470.0,1459.0
240.333,6,33,8639,17,1838,15020.0,571.0,189.0,16,6801,16021.0,1402.0,597.0
0.006,6,10,1547,5,764,1.0,496.0,496.0,5,783,1.0,515.0,515.0
0.005,6,10,2006,5,927,1.0,659.0,659.0,5,1079,1.0,811.0,811.0
300.867,6,38,9768,20,4089,15835.0,1543.0,651.0,18,5679,510.0,1360.0,412.0
0.014,6,10,1972,5,910,3.0,642.0,642.0,5,1062,3.0,794.0,794.0
0.1,6,10,1506,5,395,21.0,127.0,127.0,5,1111,21.0,843.0,843.0
0.012,6,10,1762,5,911,2.0,643.0,643.0,5,851,3.0,583.0,583.0
0.088,6,10,1506,5,395,19.0,127.0,127.0,5,1111,18.0,843.0,843.0
0.002,17,2,152,1,76,0.0,48.0,48.0,1,76,0.0,48.0,48.0
0.004,6,10,1702,5,863,1.0,595.0,595.0,5,839,1.0,571.0,571.0
0.016,6,10,1983,5,910,4.0,642.0,642.0,5,1073,3.0,805.0,805.0
0.012,17,2,338,1,74,0.0,46.0,46.0,1,264,0.0,236.0,236.0
0.006,6,10,1854,5,889,1.0,621.0,621.0,5,965,1.0,697.0,697.0
0.092,6,10,1506,5,395,20.0,127.0,127.0,5,1111,19.0,843.0,843.0
0.009,6,10,1983,5,910,2.0,642.0,642.0,5,1073,2.0,805.0,805.0
0.216,6,16,2777,8,1395,30.0,533.0,323.0,8,1382,19.0,529.0,239.0
0.015,6,10,1983,5,910,3.0,642.0,642.0,5,1073,3.0,805.0,805.0
0.09,6,10,1506,5,395,17.0,127.0,127.0,5,1111,17.0,843.0,843.0
0.008,6,10,1972,5,910,2.0,642.0,642.0,5,1062,1.0,794.0,794.0
40.063,17,10,676,5,460,10015.0,104.0,64.0,5,216,10013.0,20.0,15.0
0.015,6,10,1989,5,910,3.0,642.0,642.0,5,1079,3.0,811.0,811.0
0.008,6,10,1972,5,910,2.0,642.0,642.0,5,1062,1.0,794.0,794.0
0.005,6,10,1689,5,839,1.0,571.0,571.0,5,850,1.0,582.0,582.0
0.004,6,10,1702,5,863,0.0,595.0,595.0,5,839,1.0,571.0,571.0
40.074,17,10,676,5,460,10014.0,104.0,64.0,5,216,10017.0,20.0,15.0
0.02,6,10,2006,5,927,4.0,659.0,659.0,5,1079,5.0,811.0,811.0
0.034,6,13,3735,7,497,5.0,125.0,125.0,6,3238,6.0,1470.0,1459.0
0.012,6,10,1990,5,911,3.0,643.0,643.0,5,1079,3.0,811.0,811.0
0.017,6,10,1990,5,911,4.0,643.0,643.0,5,1079,4.0,811.0,811.0
1787.532,6,150,19350,90,13740,20084.0,302.0,302.0,60,5610,30297.0,83.0,83.0
0.001,17,2,180,1,66,0.0,38.0,38.0,1,114,0.0,86.0,86.0
0.018,17,2,160,1,72,0.0,44.0,44.0,1,88,0.0,60.0,60.0
240.485,6,37,9658,19,2174,13360.0,746.0,235.0,18,7484,14145.0,1402.0,595.0
308.574,17,20,1124,10,716,34271.0,48.0,43.0,10,408,34271.0,20.0,12.0
0.126,6,10,1506,5,395,26.0,127.0,127.0,5,1111,29.0,843.0,843.0
0.009,6,12,1926,6,1189,1.0,659.0,434.0,6,737,1.0,417.0,417.0
0.01,6,10,1990,5,911,2.0,643.0,643.0,5,1079,2.0,811.0,811.0
0.1,6,10,1506,5,395,21.0,127.0,127.0,5,1111,21.0,843.0,843.0
0.005,17,2,164,1,74,0.0,46.0,46.0,1,90,0.0,62.0,62.0
0.087,6,10,1506,5,395,19.0,127.0,127.0,5,1111,18.0,843.0,843.0
0.004,6,10,1989,5,927,1.0,659.0,659.0,5,1062,1.0,794.0,794.0
0.005,6,10,2006,5,927,1.0,659.0,659.0,5,1079,1.0,811.0,811.0
0.005,17,2,140,1,62,0.0,34.0,34.0,1,78,0.0,50.0,50.0
0.013,6,10,1989,5,910,3.0,642.0,642.0,5,1079,3.0,811.0,811.0
0.077,6,10,1506,5,395,16.0,127.0,127.0,5,1111,15.0,843.0,843.0
0.027,6,13,3735,7,497,4.0,125.0,125.0,6,3238,5.0,1470.0,1459.0
0.105,6,10,1506,5,395,25.0,127.0,127.0,5,1111,23.0,843.0,843.0
0.094,6,10,1506,5,395,21.0,127.0,127.0,5,1111,21.0,843.0,843.0
40.078,17,10,676,5,460,10016.0,104.0,64.0,5,216,10018.0,20.0,15.0
0.009,6,10,1989,5,910,2.0,642.0,642.0,5,1079,2.0,811.0,811.0
0.004,6,10,2006,5,927,1.0,659.0,659.0,5,1079,1.0,811.0,811.0
0.006,17,2,164,1,74,0.0,46.0,46.0,1,90,0.0,62.0,62.0
240.355,6,28,11188,14,5560,18488.0,1368.0,806.0,14,5628,18488.0,1655.0,815.0
0.006,17,2,180,1,66,0.0,38.0,38.0,1,114,0.0,86.0,86.0
0.004,6,10,1989,5,927,1.0,659.0,659.0,5,1062,1.0,794.0,794.0
0.005,6,10,2007,5,928,1.0,660.0,660.0,5,1079,1.0,811.0,811.0
0.006,6,10,1989,5,927,1.0,659.0,659.0,5,1062,1.0,794.0,794.0
0.041,17,2,380,1,61,0.0,33.0,33.0,1,319,0.0,291.0,291.0
266.454,6,42,10163,18,6914,15673.0,1882.0,664.0,24,3249,11584.0,580.0,132.0
371.201,6,24,2405,17,919,23200.0,195.0,195.0,7,1486,3904.0,419.0,398.0
0.005,6,10,2007,5,928,1.0,660.0,660.0,5,1079,1.0,811.0,811.0
0.039,17,2,156,1,64,0.0,36.0,36.0,1,92,0.0,64.0,64.0
0.014,6,10,1989,5,910,3.0,642.0,642.0,5,1079,3.0,811.0,811.0
0.005,6,10,1989,5,927,1.0,659.0,659.0,5,1062,1.0,794.0,794.0
0.018,6,10,1989,5,910,4.0,642.0,642.0,5,1079,4.0,811.0,811.0
0.143,6,10,1506,5,395,32.0,127.0,127.0,5,1111,33.0,843.0,843.0
0.01,6,10,1631,5,848,2.0,580.0,580.0,5,783,2.0,515.0,515.0
0.005,17,2,140,1,62,0.0,34.0,34.0,1,78,0.0,50.0,50.0
0.011,6,10,1990,5,911,2.0,643.0,643.0,5,1079,2.0,811.0,811.0
0.014,6,10,1989,5,910,3.0,642.0,642.0,5,1079,3.0,811.0,811.0
0.099,6,10,1506,5,395,23.0,127.0,127.0,5,1111,24.0,843.0,843.0
0.006,6,10,2006,5,927,1.0,659.0,659.0,5,1079,1.0,811.0,811.0
0.08,6,10,1506,5,395,18.0,127.0,127.0,5,1111,15.0,843.0,843.0
0.011,6,10,1972,5,910,2.0,642.0,642.0,5,1062,2.0,794.0,794.0
0.006,6,10,1547,5,764,1.0,496.0,496.0,5,783,1.0,515.0,515.0
0.01,17,2,136,1,60,0.0,32.0,32.0,1,76,0.0,48.0,48.0
0.017,6,10,1983,5,910,4.0,642.0,642.0,5,1073,4.0,805.0,805.0
0.009,6,10,1989,5,910,2.0,642.0,642.0,5,1079,2.0,811.0,811.0
0.114,6,10,1506,5,395,24.0,127.0,127.0,5,1111,23.0,843.0,843.0
0.006,6,10,1547,5,764,1.0,496.0,496.0,5,783,1.0,515.0,515.0
0.081,6,10,1506,5,395,19.0,127.0,127.0,5,1111,16.0,843.0,843.0
0.014,6,10,1989,5,910,3.0,642.0,642.0,5,1079,3.0,811.0,811.0
0.096,6,10,1506,5,395,21.0,127.0,127.0,5,1111,20.0,843.0,843.0
10.935,17,28,4421,14,1993,832.0,268.0,114.0,14,2428,832.0,587.0,145.0
0.017,6,10,1677,5,827,4.0,559.0,559.0,5,850,4.0,582.0,582.0
352.251,6,20,2210,6,1308,12003.0,494.0,494.0,14,902,27096.0,83.0,83.0
0.005,6,10,1689,5,839,1.0,571.0,571.0,5,850,1.0,582.0,582.0
0.004,6,10,2006,5,927,1.0,659.0,659.0,5,1079,1.0,811.0,811.0
0.025,6,10,1989,5,910,6.0,642.0,642.0,5,1079,6.0,811.0,811.0
0.013,6,10,1989,5,910,3.0,642.0,642.0,5,1079,3.0,811.0,811.0
172.091,17,78,11181,39,2625,4528.0,44.0,39.0,39,8556,4528.0,239.0,191.0
0.013,6,10,1972,5,910,3.0,642.0,642.0,5,1062,3.0,794.0,794.0
0.108,6,10,1506,5,395,25.0,127.0,127.0,5,1111,25.0,843.0,843.0
0.001,17,2,180,1,66,0.0,38.0,38.0,1,114,0.0,86.0,86.0
40.057,17,10,676,5,460,10013.0,104.0,64.0,5,216,10013.0,20.0,15.0
0.005,6,13,3747,7,509,0.0,137.0,137.0,6,3238,1.0,1470.0,1459.0
0.006,6,10,1854,5,889,1.0,621.0,621.0,5,965,1.0,697.0,697.0
0.071,6,10,1506,5,395,15.0,127.0,127.0,5,1111,15.0,843.0,843.0
0.006,6,10,1989,5,927,1.0,659.0,659.0,5,1062,1.0,794.0,794.0
0.011,6,10,1989,5,910,2.0,642.0,642.0,5,1079,2.0,811.0,811.0
40.067,17,10,676,5,460,10014.0,104.0,64.0,5,216,10015.0,20.0,15.0
0.005,17,2,164,1,74,0.0,46.0,46.0,1,90,0.0,62.0,62.0
0.005,6,10,1689,5,839,1.0,571.0,571.0,5,850,1.0,582.0,582.0
1.115,6,14,3961,7,2138,139.0,1328.0,923.0,7,1823,141.0,1300.0,769.0
9.036,17,6,376,5,280,2259.0,28.0,28.0,1,96,0.0,68.0,68.0
0.006,6,10,1547,5,764,1.0,496.0,496.0,5,783,1.0,515.0,515.0
0.012,6,10,1989,5,910,2.0,642.0,642.0,5,1079,3.0,811.0,811.0
0.004,6,10,2006,5,927,1.0,659.0,659.0,5,1079,1.0,811.0,811.0
0.004,6,10,2000,5,927,1.0,659.0,659.0,5,1073,1.0,805.0,805.0
0.013,6,10,1989,5,910,3.0,642.0,642.0,5,1079,3.0,811.0,811.0
0.019,6,10,1989,5,910,4.0,642.0,642.0,5,1079,4.0,811.0,811.0
0.018,6,10,1972,5,910,4.0,642.0,642.0,5,1062,4.0,794.0,794.0
40.059,17,10,676,5,460,10011.0,104.0,64.0,5,216,10014.0,20.0,15.0
0.009,6,10,1989,5,910,2.0,642.0,642.0,5,1079,2.0,811.0,811.0
0.06,17,2,152,1,76,0.0,48.0,48.0,1,76,0.0,48.0,48.0
0.007,17,2,179,1,71,0.0,43.0,43.0,1,108,0.0,80.0,80.0
0.004,17,4,336,2,124,0.0,34.0,34.0,2,212,0.0,84.0,78.0
300.477,6,27,7433,16,1409,20031.0,217.0,142.0,11,6024,24043.0,1679.0,777.0
175.262,17,82,11546,41,2736,4381.0,44.0,38.0,41,8810,4381.0,261.0,186.0
0.009,6,12,1926,6,1189,1.0,659.0,434.0,6,737,1.0,417.0,417.0
378.692,6,22,2313,16,867,25246.0,195.0,195.0,6,1446,4659.0,419.0,398.0
0.005,6,10,2006,5,927,1.0,659.0,659.0,5,1079,1.0,811.0,811.0
0.016,17,2,198,1,91,0.0,63.0,63.0,1,107,0.0,79.0,79.0
0.005,6,10,2000,5,927,1.0,659.0,659.0,5,1073,1.0,805.0,805.0
0.007,6,10,2007,5,928,1.0,660.0,660.0,5,1079,1.0,811.0,811.0
0.013,6,10,1631,5,848,3.0,580.0,580.0,5,783,3.0,515.0,515.0
0.095,6,10,1506,5,395,21.0,127.0,127.0,5,1111,20.0,843.0,843.0
176.066,17,88,12797,44,2970,4094.0,44.0,39.0,44,9827,4094.0,261.0,195.0
0.016,6,10,1989,5,910,4.0,642.0,642.0,5,1079,4.0,811.0,811.0
0.084,6,10,1506,5,395,20.0,127.0,127.0,5,1111,17.0,843.0,843.0
0.124,17,4,284,2,120,0.0,32.0,32.0,2,164,121.0,60.0,54.0
0.021,6,10,1989,5,910,5.0,642.0,642.0,5,1079,5.0,811.0,811.0
0.013,6,10,1972,5,910,3.0,642.0,642.0,5,1062,3.0,794.0,794.0
0.005,6,10,2007,5,928,1.0,660.0,660.0,5,1079,1.0,811.0,811.0
0.002,17,2,180,1,66,0.0,38.0,38.0,1,114,0.0,86.0,86.0
0.122,6,10,1506,5,395,27.0,127.0,127.0,5,1111,28.0,843.0,843.0
0.005,17,2,214,1,75,0.0,47.0,47.0,1,139,0.0,111.0,111.0
0.005,6,10,1689,5,839,1.0,571.0,571.0,5,850,1.0,582.0,582.0
0.005,6,10,1689,5,839,1.0,571.0,571.0,5,850,1.0,582.0,582.0
0.005,17,2,180,1,66,0.0,38.0,38.0,1,114,0.0,86.0,86.0
0.005,6,10,2007,5,928,1.0,660.0,660.0,5,1079,1.0,811.0,811.0
50.39,6,26,9479,13,1655,4199.0,794.0,367.0,13,7824,4187.0,1360.0,810.0
0.013,6,13,3735,7,497,2.0,125.0,125.0,6,3238,2.0,1470.0,1459.0
0.068,17,8,3613,4,1874,22.0,1350.0,440.0,4,1739,11.0,1350.0,406.0
0.003,17,2,136,1,60,0.0,32.0,32.0,1,76,0.0,48.0,48.0
0.017,17,2,198,1,91,0.0,63.0,63.0,1,107,0.0,79.0,79.0
0.006,6,10,1547,5,764,1.0,496.0,496.0,5,783,1.0,515.0,515.0
0.089,6,10,1506,5,395,21.0,127.0,127.0,5,1111,18.0,843.0,843.0
0.005,6,10,1643,5,860,1.0,592.0,592.0,5,783,1.0,515.0,515.0
0.022,6,10,1605,5,388,5.0,120.0,120.0,5,1217,5.0,949.0,949.0
0.005,17,2,152,1,68,0.0,40.0,40.0,1,84,0.0,56.0,56.0
0.012,6,10,1983,5,910,3.0,642.0,642.0,5,1073,3.0,805.0,805.0
0.012,6,10,1989,5,910,3.0,642.0,642.0,5,1079,3.0,811.0,811.0
0.005,6,10,2000,5,927,1.0,659.0,659.0,5,1073,1.0,805.0,805.0
180.484,6,62,19375,36,4976,5156.0,1054.0,221.0,26,14399,7219.0,2804.0,870.0
0.005,6,13,3690,7,452,0.0,80.0,80.0,6,3238,1.0,1470.0,1459.0
240.297,6,42,8721,21,5686,12014.0,1515.0,509.0,21,3035,12014.0,580.0,241.0
0.005,6,10,2007,5,928,1.0,660.0,660.0,5,1079,1.0,811.0,811.0
0.022,6,10,1990,5,911,5.0,643.0,643.0,5,1079,5.0,811.0,811.0
386.453,6,22,2313,16,867,25763.0,195.0,195.0,6,1446,4660.0,419.0,398.0
178.092,17,96,13890,48,3235,3789.0,44.0,39.0,48,10655,3789.0,239.0,193.0
0.079,6,10,1506,5,395,18.0,127.0,127.0,5,1111,17.0,843.0,843.0
0.118,6,10,1506,5,395,27.0,127.0,127.0,5,1111,25.0,843.0,843.0
0.071,17,2,170,1,65,0.0,37.0,37.0,1,105,0.0,77.0,77.0
40.954,6,37,9744,18,4186,520.0,1753.0,858.0,19,5558,2266.0,1360.0,398.0
412.273,6,29,4409,12,3102,10913.0,494.0,494.0,17,1307,25766.0,83.0,83.0
0.206,6,16,2778,8,1396,29.0,533.0,324.0,8,1382,18.0,529.0,239.0
11.134,17,28,4421,14,1993,844.0,268.0,114.0,14,2428,844.0,587.0,145.0
0.004,6,10,1702,5,863,1.0,595.0,595.0,5,839,1.0,571.0,571.0
0.002,17,2,136,1,60,0.0,32.0,32.0,1,76,0.0,48.0,48.0
0.005,6,10,2000,5,927,1.0,659.0,659.0,5,1073,1.0,805.0,805.0
40.057,17,10,676,5,460,10012.0,104.0,64.0,5,216,10012.0,20.0,15.0
0.152,6,10,1506,5,395,34.0,127.0,127.0,5,1111,36.0,843.0,843.0
0.006,6,10,1547,5,764,1.0,496.0,496.0,5,783,1.0,515.0,515.0
40.063,17,10,676,5,460,10014.0,104.0,64.0,5,216,10014.0,20.0,15.0
0.006,6,13,3690,7,452,1.0,80.0,80.0,6,3238,1.0,1470.0,1459.0
0.039,17,2,136,1,60,0.0,32.0,32.0,1,76,0.0,48.0,48.0
0.005,17,2,222,1,65,0.0,37.0,37.0,1,157,0.0,129.0,129.0
0.004,6,10,1989,5,927,1.0,659.0,659.0,5,1062,1.0,794.0,794.0
40.071,17,10,676,5,460,10016.0,104.0,64.0,5,216,10016.0,20.0,15.0
0.013,17,2,152,1,56,0.0,28.0,28.0,1,96,0.0,68.0,68.0
0.082,6,10,1506,5,395,20.0,127.0,127.0,5,1111,19.0,843.0,843.0
0.004,6,10,1702,5,863,1.0,595.0,595.0,5,839,0.0,571.0,571.0
0.017,6,10,1990,5,911,4.0,643.0,643.0,5,1079,4.0,811.0,811.0
11.163,17,28,4417,14,1994,846.0,269.0,114.0,14,2423,846.0,586.0,145.0
1.064,6,22,7070,13,1687,88.0,517.0,249.0,9,5383,132.0,1402.0,817.0
308.355,17,20,1124,10,716,34255.0,48.0,43.0,10,408,34255.0,20.0,12.0
0.007,6,10,2006,5,927,1.0,659.0,659.0,5,1079,1.0,811.0,811.0
40.058,17,10,676,5,460,10013.0,104.0,64.0,5,216,10013.0,20.0,15.0
0.005,17,2,179,1,71,0.0,43.0,43.0,1,108,0.0,80.0,80.0
0.099,6,10,1506,5,395,21.0,127.0,127.0,5,1111,21.0,843.0,843.0
0.011,6,10,1989,5,910,2.0,642.0,642.0,5,1079,2.0,811.0,811.0
0.014,6,10,1631,5,848,3.0,580.0,580.0,5,783,3.0,515.0,515.0
412.028,6,29,4409,12,3102,10914.0,494.0,494.0,17,1307,25751.0,83.0,83.0
0.004,6,10,2007,5,928,1.0,660.0,660.0,5,1079,1.0,811.0,811.0
0.003,17,4,284,2,120,0.0,32.0,32.0,2,164,0.0,60.0,54.0
0.006,6,10,1547,5,764,1.0,496.0,496.0,5,783,1.0,515.0,515.0
0.09,17,2,144,1,64,0.0,36.0,36.0,1,80,0.0,52.0,52.0
377.995,6,407,353768,207,27482,1834.0,2736.0,834.0,200,326286,1899.0,2804.0,1764.0
0.005,6,10,1989,5,927,1.0,659.0,659.0,5,1062,1.0,794.0,794.0
240.016,6,9,787,5,488,60004.0,232.0,232.0,4,299,80004.0,83.0,83.0
0.106,6,10,1506,5,395,24.0,127.0,127.0,5,1111,23.0,843.0,843.0
0.014,6,10,1989,5,910,3.0,642.0,642.0,5,1079,3.0,811.0,811.0
0.02,6,10,1972,5,910,5.0,642.0,642.0,5,1062,5.0,794.0,794.0
40.077,17,10,676,5,460,10016.0,104.0,64.0,5,216,10018.0,20.0,15.0
0.037,17,4,284,2,120,0.0,32.0,32.0,2,164,33.0,60.0,54.0
0.005,17,2,214,1,75,0.0,47.0,47.0,1,139,0.0,111.0,111.0
0.004,6,10,1779,5,928,1.0,660.0,660.0,5,851,1.0,583.0,583.0
0.039,17,4,284,2,120,0.0,32.0,32.0,2,164,36.0,60.0,54.0
171.339,17,78,11089,39,2600,4508.0,44.0,38.0,39,8489,4508.0,239.0,189.0
0.173,17,2,152,1,76,0.0,48.0,48.0,1,76,0.0,48.0,48.0
0.041,17,4,420,2,122,0.0,33.0,33.0,2,298,37.0,145.0,121.0
0.001,17,2,180,1,66,0.0,38.0,38.0,1,114,0.0,86.0,86.0
0.042,17,2,412,1,61,0.0,33.0,33.0,1,351,0.0,323.0,323.0
0.013,6,10,1990,5,911,3.0,643.0,643.0,5,1079,3.0,811.0,811.0
0.005,6,10,2006,5,927,1.0,659.0,659.0,5,1079,1.0,811.0,811.0
0.067,17,8,3613,4,1874,22.0,1350.0,440.0,4,1739,11.0,1350.0,406.0
0.005,6,13,3747,7,509,0.0,137.0,137.0,6,3238,1.0,1470.0,1459.0
0.019,6,10,1990,5,911,4.0,643.0,643.0,5,1079,4.0,811.0,811.0
40.055,17,10,676,5,460,10012.0,104.0,64.0,5,216,10012.0,20.0,15.0
0.001,17,2,180,1,66,0.0,38.0,38.0,1,114,0.0,86.0,86.0
0.005,17,2,148,1,60,0.0,32.0,32.0,1,88,0.0,60.0,60.0
0.014,6,10,1631,5,848,3.0,580.0,580.0,5,783,3.0,515.0,515.0
40.06,17,10,676,5,460,10014.0,104.0,64.0,5,216,10014.0,20.0,15.0
0.006,17,2,140,1,62,0.0,34.0,34.0,1,78,0.0,50.0,50.0
10.792,17,28,4423,14,1995,821.0,270.0,114.0,14,2428,821.0,587.0,145.0
0.005,6,10,2006,5,927,1.0,659.0,659.0,5,1079,1.0,811.0,811.0
0.012,6,10,1983,5,910,3.0,642.0,642.0,5,1073,3.0,805.0,805.0
0.004,6,10,2007,5,928,1.0,660.0,660.0,5,1079,1.0,811.0,811.0
240.079,6,16,4482,9,963,30009.0,238.0,166.0,7,3519,40012.0,1402.0,786.0
240.011,6,9,787,5,488,60002.0,232.0,232.0,4,299,80003.0,83.0,83.0
0.011,6,10,1989,5,910,2.0,642.0,642.0,5,1079,2.0,811.0,811.0
0.01,6,10,1762,5,911,2.0,643.0,643.0,5,851,2.0,583.0,583.0
0.122,6,10,1506,5,395,24.0,127.0,127.0,5,1111,27.0,843.0,843.0
0.004,17,2,132,1,58,0.0,30.0,30.0,1,74,0.0,46.0,46.0
0.006,6,12,1698,6,863,1.0,327.0,271.0,6,835,1.0,515.0,515.0
0.088,6,10,1506,5,395,19.0,127.0,127.0,5,1111,19.0,843.0,843.0
0.091,6,10,1506,5,395,20.0,127.0,127.0,5,1111,18.0,843.0,843.0
0.011,6,10,1990,5,911,2.0,643.0,643.0,5,1079,2.0,811.0,811.0
0.016,6,10,1989,5,910,3.0,642.0,642.0,5,1079,3.0,811.0,811.0
0.128,6,10,1506,5,395,28.0,127.0,127.0,5,1111,22.0,843.0,843.0
0.072,6,10,1506,5,395,16.0,127.0,127.0,5,1111,16.0,843.0,843.0
32.836,6,36,8316,18,1845,521.0,777.0,364.0,18,6471,1923.0,2720.0,478.0
0.005,6,10,1779,5,928,1.0,660.0,660.0,5,851,1.0,583.0,583.0
0.006,6,10,1854,5,889,1.0,621.0,621.0,5,965,1.0,697.0,697.0
0.005,6,10,2007,5,928,1.0,660.0,660.0,5,1079,1.0,811.0,811.0
1778.862,17,143,45188,72,22752,25051.0,288.0,288.0,71,22436,25411.0,288.0,288.0
0.03,6,6,716,3,458,9.0,302.0,302.0,3,258,8.0,102.0,102.0
0.005,6,10,1689,5,839,1.0,571.0,571.0,5,850,1.0,582.0,582.0
0.008,6,10,2000,5,927,2.0,659.0,659.0,5,1073,1.0,805.0,805.0
0.015,6,10,1972,5,910,3.0,642.0,642.0,5,1062,3.0,794.0,794.0
0.013,6,10,1972,5,910,3.0,642.0,642.0,5,1062,3.0,794.0,794.0
0.001,17,2,180,1,66,0.0,38.0,38.0,1,114,0.0,86.0,86.0
0.001,17,2,136,1,60,0.0,32.0,32.0,1,76,0.0,48.0,48.0
0.005,17,2,169,1,62,0.0,34.0,34.0,1,107,0.0,79.0,79.0
0.007,17,2,222,1,65,0.0,37.0,37.0,1,157,0.0,129.0,129.0
0.004,6,10,2006,5,927,1.0,659.0,659.0,5,1079,1.0,811.0,811.0
0.049,6,10,1989,5,910,12.0,642.0,642.0,5,1079,12.0,811.0,811.0
0.118,6,10,1506,5,395,26.0,127.0,127.0,5,1111,25.0,843.0,843.0
0.006,6,10,1547,5,764,1.0,496.0,496.0,5,783,1.0,515.0,515.0
0.006,6,10,1774,5,923,1.0,655.0,655.0,5,851,1.0,583.0,583.0
40.071,17,10,676,5,460,10016.0,104.0,64.0,5,216,10016.0,20.0,15.0
0.005,17,2,179,1,71,0.0,43.0,43.0,1,108,0.0,80.0,80.0
0.005,17,2,164,1,74,0.0,46.0,46.0,1,90,0.0,62.0,62.0
1778.644,17,144,41760,72,22752,25051.0,288.0,288.0,72,19008,25051.0,236.0,236.0
0.017,6,10,1983,5,910,4.0,642.0,642.0,5,1073,4.0,805.0,805.0
0.016,6,10,1983,5,910,3.0,642.0,642.0,5,1073,4.0,805.0,805.0
0.015,6,10,1677,5,827,3.0,559.0,559.0,5,850,3.0,582.0,582.0
0.041,17,2,412,1,61,0.0,33.0,33.0,1,351,0.0,323.0,323.0
0.013,6,10,1990,5,911,3.0,643.0,643.0,5,1079,3.0,811.0,811.0
0.072,17,2,412,1,61,0.0,33.0,33.0,1,351,0.0,323.0,323.0
0.114,6,10,1506,5,395,24.0,127.0,127.0,5,1111,24.0,843.0,843.0
178.144,17,78,11045,39,2597,4687.0,44.0,38.0,39,8448,4687.0,239.0,188.0
0.001,17,2,180,1,66,0.0,38.0,38.0,1,114,0.0,86.0,86.0
40.052,17,10,676,5,460,10012.0,104.0,64.0,5,216,10012.0,20.0,15.0
0.006,6,13,3747,7,509,0.0,137.0,137.0,6,3238,1.0,1470.0,1459.0
0.014,6,10,1631,5,848,3.0,580.0,580.0,5,783,3.0,515.0,515.0
240.019,6,9,787,5,488,60004.0,232.0,232.0,4,299,80005.0,83.0,83.0
0.098,6,10,1506,5,395,21.0,127.0,127.0,5,1111,22.0,843.0,843.0
0.072,6,10,1506,5,395,15.0,127.0,127.0,5,1111,14.0,843.0,843.0
0.136,6,10,1506,5,395,31.0,127.0,127.0,5,1111,27.0,843.0,843.0
0.013,6,10,1989,5,910,3.0,642.0,642.0,5,1079,3.0,811.0,811.0
0.003,17,2,185,1,73,0.0,45.0,45.0,1,112,0.0,84.0,84.0
0.005,6,13,3747,7,509,0.0,137.0,137.0,6,3238,1.0,1470.0,1459.0
0.012,6,10,1989,5,910,3.0,642.0,642.0,5,1079,2.0,811.0,811.0
0.006,6,10,1689,5,839,1.0,571.0,571.0,5,850,1.0,582.0,582.0
0.006,6,10,2006,5,927,1.0,659.0,659.0,5,1079,1.0,811.0,811.0
0.014,6,10,1990,5,911,3.0,643.0,643.0,5,1079,3.0,811.0,811.0
0.043,6,10,1989,5,910,10.0,642.0,642.0,5,1079,10.0,811.0,811.0
0.013,6,10,1989,5,910,3.0,642.0,642.0,5,1079,3.0,811.0,811.0
0.086,6,10,1506,5,395,20.0,127.0,127.0,5,1111,18.0,843.0,843.0
0.119,6,10,1506,5,395,25.0,127.0,127.0,5,1111,27.0,843.0,843.0
0.115,6,10,1506,5,395,25.0,127.0,127.0,5,1111,25.0,843.0,843.0
0.004,17,2,186,1,61,0.0,33.0,33.0,1,125,0.0,97.0,97.0
308.738,17,20,1124,10,716,34292.0,48.0,43.0,10,408,34297.0,20.0,12.0
0.109,6,10,1506,5,395,25.0,127.0,127.0,5,1111,26.0,843.0,843.0
0.003,17,2,136,1,60,0.0,32.0,32.0,1,76,0.0,48.0,48.0
0.005,6,10,1989,5,927,1.0,659.0,659.0,5,1062,1.0,794.0,794.0
0.106,6,10,1506,5,395,22.0,127.0,127.0,5,1111,23.0,843.0,843.0
0.082,6,10,1506,5,395,18.0,127.0,127.0,5,1111,19.0,843.0,843.0
0.007,6,10,1989,5,910,1.0,642.0,642.0,5,1079,1.0,811.0,811.0
0.106,6,10,1506,5,395,24.0,127.0,127.0,5,1111,22.0,843.0,843.0
0.018,6,10,1972,5,910,4.0,642.0,642.0,5,1062,4.0,794.0,794.0
0.01,6,10,1989,5,910,2.0,642.0,642.0,5,1079,2.0,811.0,811.0
0.005,6,10,2007,5,928,1.0,660.0,660.0,5,1079,1.0,811.0,811.0
11.555,17,28,4394,14,2311,876.0,586.0,137.0,14,2083,876.0,270.0,120.0
1771.588,17,120,11460,60,5460,30026.0,63.0,63.0,60,6000,30026.0,72.0,72.0
0.004,6,10,1702,5,863,1.0,595.0,595.0,5,839,1.0,571.0,571.0
0.068,6,10,1506,5,395,14.0,127.0,127.0,5,1111,15.0,843.0,843.0
0.005,6,10,2006,5,927,1.0,659.0,659.0,5,1079,1.0,811.0,811.0
353.45,6,20,2210,6,1308,12003.0,494.0,494.0,14,902,27188.0,83.0,83.0
0.012,6,10,1990,5,911,3.0,643.0,643.0,5,1079,3.0,811.0,811.0
240.121,6,31,9351,15,6919,17151.0,2043.0,682.0,16,2432,16007.0,580.0,199.0
0.011,6,10,1990,5,911,2.0,643.0,643.0,5,1079,2.0,811.0,811.0
9.036,17,6,376,5,280,2259.0,28.0,28.0,1,96,0.0,68.0,68.0
0.012,6,10,1983,5,910,3.0,642.0,642.0,5,1073,3.0,805.0,805.0
0.052,17,2,152,1,76,0.0,48.0,48.0,1,76,0.0,48.0,48.0
0.005,6,10,2006,5,927,1.0,659.0,659.0,5,1079,1.0,811.0,811.0
0.096,6,10,1506,5,395,22.0,127.0,127.0,5,1111,22.0,843.0,843.0
0.006,6,10,1547,5,764,1.0,496.0,496.0,5,783,1.0,515.0,515.0
15.082,17,15,8122,8,6045,2150.0,1350.0,727.0,7,2077,2508.0,1350.0,268.0
0.099,6,10,1506,5,395,23.0,127.0,127.0,5,1111,22.0,843.0,843.0
0.015,6,10,1762,5,911,3.0,643.0,643.0,5,851,3.0,583.0,583.0
0.005,6,10,1989,5,927,1.0,659.0,659.0,5,1062,1.0,794.0,794.0
1.003,6,13,3930,7,2139,125.0,1328.0,923.0,6,1791,150.0,1539.0,1539.0
0.02,6,10,1972,5,910,5.0,642.0,642.0,5,1062,5.0,794.0,794.0
0.002,17,2,185,1,73,0.0,45.0,45.0,1,112,0.0,84.0,84.0
0.004,6,10,1989,5,927,1.0,659.0,659.0,5,1062,1.0,794.0,794.0
0.011,6,10,1677,5,827,2.0,559.0,559.0,5,850,2.0,582.0,582.0
0.008,6,10,1972,5,910,2.0,642.0,642.0,5,1062,1.0,794.0,794.0
0.153,17,4,352,2,130,82.0,37.0,37.0,2,222,112.0,89.0,83.0
0.081,6,10,1506,5,395,19.0,127.0,127.0,5,1111,18.0,843.0,843.0
300.973,6,46,16220,24,10313,13085.0,2720.0,1165.0,22,5907,419.0,2667.0,385.0
15.179,17,21,14879,10,9658,1681.0,1350.0,937.0,11,5221,1512.0,1350.0,446.0
0.149,6,10,1506,5,395,28.0,127.0,127.0,5,1111,20.0,843.0,843.0
0.001,17,2,142,1,63,0.0,35.0,35.0,1,79,0.0,51.0,51.0
0.01,6,10,1990,5,911,2.0,643.0,643.0,5,1079,2.0,811.0,811.0
0.129,6,10,1506,5,395,27.0,127.0,127.0,5,1111,26.0,843.0,843.0
0.01,6,10,1989,5,910,2.0,642.0,642.0,5,1079,2.0,811.0,811.0
0.005,17,2,164,1,74,0.0,46.0,46.0,1,90,0.0,62.0,62.0
0.006,17,2,179,1,71,0.0,43.0,43.0,1,108,0.0,80.0,80.0
0.019,6,10,1989,5,910,4.0,642.0,642.0,5,1079,4.0,811.0,811.0
285.189,6,27,6407,15,1369,20370.0,517.0,290.0,12,5038,25926.0,2380.0,1104.0
0.01,6,10,1677,5,827,2.0,559.0,559.0,5,850,2.0,582.0,582.0
0.01,6,10,1972,5,910,2.0,642.0,642.0,5,1062,2.0,794.0,794.0
0.016,17,2,179,1,71,0.0,43.0,43.0,1,108,0.0,80.0,80.0
0.013,6,10,1990,5,911,3.0,643.0,643.0,5,1079,3.0,811.0,811.0
0.017,6,10,1990,5,911,4.0,643.0,643.0,5,1079,4.0,811.0,811.0
0.012,6,10,1989,5,910,2.0,642.0,642.0,5,1079,3.0,811.0,811.0
0.015,6,10,1989,5,910,3.0,642.0,642.0,5,1079,3.0,811.0,811.0
0.006,17,2,180,1,66,0.0,38.0,38.0,1,114,0.0,86.0,86.0
1759.338,6,450,65983,255,35389,6926.0,613.0,195.0,195,30594,9068.0,453.0,144.0
0.12,6,10,1506,5,395,28.0,127.0,127.0,5,1111,23.0,843.0,843.0
0.069,6,10,1506,5,395,15.0,127.0,127.0,5,1111,13.0,843.0,843.0
0.005,6,10,2006,5,927,1.0,659.0,659.0,5,1079,1.0,811.0,811.0
0.006,6,10,1689,5,839,1.0,571.0,571.0,5,850,1.0,582.0,582.0
0.009,6,10,2007,5,928,2.0,660.0,660.0,5,1079,2.0,811.0,811.0
0.005,6,10,1989,5,927,1.0,659.0,659.0,5,1062,1.0,794.0,794.0
0.006,6,10,1547,5,764,1.0,496.0,496.0,5,783,1.0,515.0,515.0
0.075,6,10,1506,5,395,15.0,127.0,127.0,5,1111,17.0,843.0,843.0
0.003,17,4,284,2,120,0.0,32.0,32.0,2,164,0.0,60.0,54.0
40.059,17,10,676,5,460,10011.0,104.0,64.0,5,216,10013.0,20.0,15.0
40.064,17,10,676,5,460,10013.0,104.0,64.0,5,216,10015.0,20.0,15.0
0.003,17,2,136,1,60,0.0,32.0,32.0,1,76,0.0,48.0,48.0
0.039,17,4,420,2,122,0.0,33.0,33.0,2,298,1.0,145.0,121.0
0.008,17,2,194,1,59,0.0,31.0,31.0,1,135,0.0,107.0,107.0
0.006,6,10,1689,5,839,1.0,571.0,571.0,5,850,1.0,582.0,582.0
15.08,17,16,8182,8,6039,2150.0,1350.0,726.0,8,2143,2150.0,1350.0,239.0
240.018,6,9,787,5,488,60004.0,232.0,232.0,4,299,80004.0,83.0,83.0
0.09,6,10,1506,5,395,19.0,127.0,127.0,5,1111,21.0,843.0,843.0
40.055,17,10,676,5,460,10012.0,104.0,64.0,5,216,10012.0,20.0,15.0
0.122,17,2,80,1,32,0.0,4.0,4.0,1,48,0.0,20.0,20.0
0.004,17,2,187,1,74,0.0,46.0,46.0,1,113,0.0,85.0,85.0
0.007,17,2,178,1,65,0.0,37.0,37.0,1,113,0.0,85.0,85.0
0.168,6,3,453,2,321,168.0,241.0,241.0,1,132,0.0,92.0,92.0
8.941,6,36,9771,19,4293,496.0,1360.0,700.0,17,5478,546.0,2667.0,435.0
0.076,6,10,1506,5,395,15.0,127.0,127.0,5,1111,17.0,843.0,843.0
0.006,6,10,1547,5,764,1.0,496.0,496.0,5,783,1.0,515.0,515.0
0.019,6,10,1989,5,910,4.0,642.0,642.0,5,1079,4.0,811.0,811.0
0.098,6,10,1506,5,395,21.0,127.0,127.0,5,1111,18.0,843.0,843.0
40.101,17,10,676,5,460,10024.0,104.0,64.0,5,216,10024.0,20.0,15.0
290.839,6,401,347836,195,21703,1499.0,1867.0,770.0,206,326133,1418.0,2804.0,1634.0
0.004,6,10,2000,5,927,1.0,659.0,659.0,5,1073,1.0,805.0,805.0
0.126,6,10,1506,5,395,29.0,127.0,127.0,5,1111,28.0,843.0,843.0
0.016,6,10,1989,5,910,3.0,642.0,642.0,5,1079,4.0,811.0,811.0
0.005,6,10,2006,5,927,1.0,659.0,659.0,5,1079,1.0,811.0,811.0
1799.808,6,138,6669,76,3664,23997.0,39.0,39.0,62,3005,29021.0,35.0,35.0
0.012,6,10,1989,5,910,3.0,642.0,642.0,5,1079,2.0,811.0,811.0
0.004,17,2,136,1,60,0.0,32.0,32.0,1,76,0.0,48.0,48.0
0.004,17,2,148,1,60,0.0,32.0,32.0,1,88,0.0,60.0,60.0
0.003,17,2,132,1,58,0.0,30.0,30.0,1,74,0.0,46.0,46.0
0.005,6,10,2000,5,927,1.0,659.0,659.0,5,1073,1.0,805.0,805.0
10.865,17,28,4424,14,1995,827.0,270.0,114.0,14,2429,827.0,588.0,145.0
0.011,6,10,1677,5,827,2.0,559.0,559.0,5,850,2.0,582.0,582.0
10.767,17,28,4423,14,1994,819.0,269.0,114.0,14,2429,819.0,588.0,145.0
0.005,6,10,1774,5,923,1.0,655.0,655.0,5,851,1.0,583.0,583.0
0.005,17,2,170,1,65,0.0,37.0,37.0,1,105,0.0,77.0,77.0
0.009,6,10,1972,5,910,2.0,642.0,642.0,5,1062,2.0,794.0,794.0
0.089,6,10,1506,5,395,21.0,127.0,127.0,5,1111,21.0,843.0,843.0
0.005,6,10,2007,5,928,1.0,660.0,660.0,5,1079,1.0,811.0,811.0
40.073,17,10,676,5,460,10017.0,104.0,64.0,5,216,10017.0,20.0,15.0
0.104,6,10,1506,5,395,21.0,127.0,127.0,5,1111,21.0,843.0,843.0
0.037,17,2,182,1,65,0.0,37.0,37.0,1,117,0.0,89.0,89.0
0.006,17,2,170,1,65,0.0,37.0,37.0,1,105,0.0,77.0,77.0
0.004,6,10,1989,5,927,1.0,659.0,659.0,5,1062,1.0,794.0,794.0
0.004,6,10,1774,5,923,1.0,655.0,655.0,5,851,1.0,583.0,583.0
0.094,6,10,1506,5,395,21.0,127.0,127.0,5,1111,21.0,843.0,843.0
0.039,17,2,170,1,65,0.0,37.0,37.0,1,105,0.0,77.0,77.0
240.318,6,32,8589,16,1787,16021.0,572.0,189.0,16,6802,16021.0,1402.0,597.0
0.005,6,10,1989,5,927,1.0,659.0,659.0,5,1062,1.0,794.0,794.0
0.011,6,10,1989,5,910,2.0,642.0,642.0,5,1079,2.0,811.0,811.0
0.006,6,10,1547,5,764,1.0,496.0,496.0,5,783,1.0,515.0,515.0
280.67,6,25,6480,11,1226,28067.0,267.0,156.0,14,5254,21589.0,1400.0,781.0
0.023,6,10,1989,5,910,5.0,642.0,642.0,5,1079,5.0,811.0,811.0
0.117,6,10,1506,5,395,24.0,127.0,127.0,5,1111,27.0,843.0,843.0
300.345,6,16,2170,9,684,37522.0,146.0,146.0,7,1486,50030.0,419.0,398.0
0.005,6,10,2000,5,927,1.0,659.0,659.0,5,1073,1.0,805.0,805.0
0.01,6,10,1983,5,910,2.0,642.0,642.0,5,1073,2.0,805.0,805.0
0.005,6,10,2007,5,928,1.0,660.0,660.0,5,1079,1.0,811.0,811.0
0.006,6,10,1547,5,764,1.0,496.0,496.0,5,783,1.0,515.0,515.0
0.001,17,2,180,1,66,0.0,38.0,38.0,1,114,0.0,86.0,86.0
0.031,6,10,1631,5,848,7.0,580.0,580.0,5,783,7.0,515.0,515.0
0.004,6,10,1702,5,863,1.0,595.0,595.0,5,839,0.0,571.0,571.0
0.005,6,10,1989,5,927,1.0,659.0,659.0,5,1062,1.0,794.0,794.0
0.071,17,4,364,2,160,0.0,52.0,52.0,2,204,29.0,80.0,74.0
176.223,17,72,10378,36,2402,5034.0,44.0,38.0,36,7976,5034.0,252.0,193.0
0.021,6,10,1989,5,910,5.0,642.0,642.0,5,1079,5.0,811.0,811.0
0.005,6,10,2006,5,927,1.0,659.0,659.0,5,1079,1.0,811.0,811.0
0.009,6,10,1989,5,910,2.0,642.0,642.0,5,1079,2.0,811.0,811.0
0.074,6,10,1506,5,395,16.0,127.0,127.0,5,1111,17.0,843.0,843.0
0.006,6,10,1547,5,764,1.0,496.0,496.0,5,783,1.0,515.0,515.0
0.004,6,10,1702,5,863,0.0,595.0,595.0,5,839,1.0,571.0,571.0
0.005,17,2,230,1,68,0.0,40.0,40.0,1,162,0.0,134.0,134.0
40.069,17,10,676,5,460,10016.0,104.0,64.0,5,216,10016.0,20.0,15.0
0.112,6,10,1506,5,395,24.0,127.0,127.0,5,1111,24.0,843.0,843.0
0.015,6,10,1989,5,910,3.0,642.0,642.0,5,1079,3.0,811.0,811.0
0.078,6,10,1506,5,395,16.0,127.0,127.0,5,1111,18.0,843.0,843.0
0.001,17,2,180,1,66,0.0,38.0,38.0,1,114,0.0,86.0,86.0
0.001,17,2,248,1,68,0.0,40.0,40.0,1,180,0.0,152.0,152.0
0.018,6,10,1989,5,910,4.0,642.0,642.0,5,1079,4.0,811.0,811.0
0.005,6,10,2006,5,927,1.0,659.0,659.0,5,1079,1.0,811.0,811.0
0.016,6,10,1983,5,910,3.0,642.0,642.0,5,1073,4.0,805.0,805.0
0.016,6,10,1631,5,848,4.0,580.0,580.0,5,783,3.0,515.0,515.0
0.125,6,10,1506,5,395,27.0,127.0,127.0,5,1111,22.0,843.0,843.0
0.005,17,2,170,1,65,0.0,37.0,37.0,1,105,0.0,77.0,77.0
0.007,6,10,2006,5,927,1.0,659.0,659.0,5,1079,1.0,811.0,811.0
0.106,6,10,1506,5,395,23.0,127.0,127.0,5,1111,23.0,843.0,843.0
0.086,6,10,1506,5,395,19.0,127.0,127.0,5,1111,19.0,843.0,843.0
0.113,6,10,1506,5,395,23.0,127.0,127.0,5,1111,26.0,843.0,843.0
0.001,17,2,180,1,66,0.0,38.0,38.0,1,114,0.0,86.0,86.0
0.005,6,10,2006,5,927,1.0,659.0,659.0,5,1079,1.0,811.0,811.0
295.606,6,399,348263,204,22175,1456.0,2736.0,889.0,195,326088,1523.0,2804.0,1745.0
0.011,6,10,1989,5,910,2.0,642.0,642.0,5,1079,2.0,811.0,811.0
0.081,6,10,1506,5,395,19.0,127.0,127.0,5,1111,19.0,843.0,843.0
0.005,6,10,1779,5,928,1.0,660.0,660.0,5,851,1.0,583.0,583.0
0.007,6,10,1762,5,911,1.0,643.0,643.0,5,851,1.0,583.0,583.0
300.332,6,16,2170,9,684,37520.0,146.0,146.0,7,1486,50026.0,419.0,398.0
0.013,6,10,1677,5,827,3.0,559.0,559.0,5,850,3.0,582.0,582.0
1770.722,6,135,6510,75,3585,23928.0,39.0,39.0,60,2925,30008.0,35.0,35.0
0.017,6,10,1989,5,910,4.0,642.0,642.0,5,1079,4.0,811.0,811.0
0.005,17,2,169,1,62,0.0,34.0,34.0,1,107,0.0,79.0,79.0
0.114,17,2,144,1,64,0.0,36.0,36.0,1,80,0.0,52.0,52.0
240.009,6,9,787,5,488,60002.0,232.0,232.0,4,299,80002.0,83.0,83.0
10.897,17,28,4423,14,1995,828.0,270.0,114.0,14,2428,829.0,587.0,145.0
15.074,17,15,9238,8,6902,2149.0,1350.0,834.0,7,2336,2507.0,1350.0,305.0
0.004,6,10,1702,5,863,1.0,595.0,595.0,5,839,1.0,571.0,571.0
0.005,6,10,2000,5,927,1.0,659.0,659.0,5,1073,1.0,805.0,805.0
0.008,6,10,1762,5,911,1.0,643.0,643.0,5,851,2.0,583.0,583.0
0.006,6,10,1547,5,764,1.0,496.0,496.0,5,783,1.0,515.0,515.0
0.006,6,10,1547,5,764,1.0,496.0,496.0,5,783,1.0,515.0,515.0
0.072,6,10,1506,5,395,15.0,127.0,127.0,5,1111,16.0,843.0,843.0
0.008,6,12,1926,6,1189,1.0,659.0,434.0,6,737,1.0,417.0,417.0
0.129,6,10,1506,5,395,25.0,127.0,127.0,5,1111,28.0,843.0,843.0
9.041,17,6,376,5,280,2260.0,28.0,28.0,1,96,0.0,68.0,68.0
0.071,6,10,1506,5,395,15.0,127.0,127.0,5,1111,16.0,843.0,843.0
240.539,6,33,8638,17,1839,15031.0,572.0,189.0,16,6799,16033.0,1402.0,597.0
0.094,6,10,1506,5,395,22.0,127.0,127.0,5,1111,21.0,843.0,843.0
308.547,17,20,1124,10,716,34268.0,48.0,43.0,10,408,34268.0,20.0,12.0
0.006,6,10,1547,5,764,1.0,496.0,496.0,5,783,1.0,515.0,515.0
0.005,17,2,249,1,64,0.0,36.0,36.0,1,185,0.0,157.0,157.0
0.005,17,2,170,1,65,0.0,37.0,37.0,1,105,0.0,77.0,77.0
0.005,6,10,1689,5,839,1.0,571.0,571.0,5,850,1.0,582.0,582.0
0.005,6,10,1989,5,927,1.0,659.0,659.0,5,1062,1.0,794.0,794.0
0.014,6,10,1989,5,910,3.0,642.0,642.0,5,1079,3.0,811.0,811.0
0.074,6,10,1506,5,395,16.0,127.0,127.0,5,1111,17.0,843.0,843.0
0.009,6,10,1989,5,910,2.0,642.0,642.0,5,1079,2.0,811.0,811.0
0.134,6,10,1506,5,395,29.0,127.0,127.0,5,1111,32.0,843.0,843.0
0.0,17,2,154,1,69,0.0,41.0,41.0,1,85,0.0,57.0,57.0
0.004,6,10,1702,5,863,0.0,595.0,595.0,5,839,1.0,571.0,571.0
0.006,17,2,212,1,74,0.0,46.0,46.0,1,138,0.0,110.0,110.0
240.239,6,37,10575,19,2267,13346.0,559.0,254.0,18,8308,14131.0,1402.0,614.0
1791.524,6,481,98467,242,87370,7433.0,421.0,369.0,239,11097,7526.0,53.0,53.0
0.012,6,13,3735,7,497,2.0,125.0,125.0,6,3238,2.0,1470.0,1459.0
0.012,6,10,1989,5,910,3.0,642.0,642.0,5,1079,3.0,811.0,811.0
413.561,6,29,4409,12,3102,10914.0,494.0,494.0,17,1307,25847.0,83.0,83.0
0.014,6,10,1983,5,910,3.0,642.0,642.0,5,1073,3.0,805.0,805.0
0.004,17,4,284,2,120,0.0,32.0,32.0,2,164,0.0,60.0,54.0
0.004,6,10,2007,5,928,1.0,660.0,660.0,5,1079,1.0,811.0,811.0
0.022,6,10,1989,5,910,5.0,642.0,642.0,5,1079,5.0,811.0,811.0
0.09,6,10,1506,5,395,16.0,127.0,127.0,5,1111,20.0,843.0,843.0
0.038,17,2,412,1,61,0.0,33.0,33.0,1,351,0.0,323.0,323.0
0.007,6,10,1547,5,764,1.0,496.0,496.0,5,783,1.0,515.0,515.0
0.074,6,10,1506,5,395,15.0,127.0,127.0,5,1111,17.0,843.0,843.0
0.004,6,10,1702,5,863,1.0,595.0,595.0,5,839,1.0,571.0,571.0
0.004,6,10,2006,5,927,1.0,659.0,659.0,5,1079,1.0,811.0,811.0
0.003,17,2,136,1,60,0.0,32.0,32.0,1,76,0.0,48.0,48.0
0.005,17,2,152,1,68,0.0,40.0,40.0,1,84,0.0,56.0,56.0
0.008,6,10,1989,5,910,2.0,642.0,642.0,5,1079,2.0,811.0,811.0
352.245,6,20,2210,6,1308,12003.0,494.0,494.0,14,902,27095.0,83.0,83.0
0.005,6,10,2000,5,927,1.0,659.0,659.0,5,1073,1.0,805.0,805.0
0.007,6,10,1972,5,910,1.0,642.0,642.0,5,1062,1.0,794.0,794.0
11.183,17,28,4423,14,1995,847.0,270.0,114.0,14,2428,847.0,587.0,145.0
0.009,6,10,1762,5,911,2.0,643.0,643.0,5,851,2.0,583.0,583.0
0.005,6,14,3799,7,509,0.0,137.0,137.0,7,3290,0.0,1448.0,972.0
0.006,6,10,1547,5,764,1.0,496.0,496.0,5,783,1.0,515.0,515.0
0.006,17,2,214,1,75,0.0,47.0,47.0,1,139,0.0,111.0,111.0
0.008,6,10,1989,5,910,2.0,642.0,642.0,5,1079,2.0,811.0,811.0
0.004,17,2,136,1,60,0.0,32.0,32.0,1,76,0.0,48.0,48.0
0.005,6,10,1643,5,860,1.0,592.0,592.0,5,783,1.0,515.0,515.0
240.114,6,31,8983,15,6645,17151.0,1769.0,652.0,16,2338,16007.0,580.0,187.0
0.006,6,10,1547,5,764,1.0,496.0,496.0,5,783,1.0,515.0,515.0
0.007,6,10,1989,5,910,1.0,642.0,642.0,5,1079,1.0,811.0,811.0
0.011,6,10,1972,5,910,2.0,642.0,642.0,5,1062,2.0,794.0,794.0
0.006,6,10,2006,5,927,1.0,659.0,659.0,5,1079,1.0,811.0,811.0
9.039,17,6,376,5,280,2259.0,28.0,28.0,1,96,0.0,68.0,68.0
0.013,6,10,1631,5,848,3.0,580.0,580.0,5,783,3.0,515.0,515.0
0.01,6,10,1989,5,910,2.0,642.0,642.0,5,1079,2.0,811.0,811.0
0.068,17,8,3613,4,1874,22.0,1350.0,440.0,4,1739,11.0,1350.0,406.0
0.013,6,10,1989,5,910,3.0,642.0,642.0,5,1079,3.0,811.0,811.0
0.006,6,10,1547,5,764,1.0,496.0,496.0,5,783,1.0,515.0,515.0
0.005,6,10,1989,5,927,1.0,659.0,659.0,5,1062,1.0,794.0,794.0
0.039,17,2,234,1,61,0.0,33.0,33.0,1,173,0.0,145.0,145.0
1781.106,6,90,4834,46,2470,39580.0,26.0,26.0,44,2364,41419.0,26.0,25.0
0.015,6,10,1983,5,910,3.0,642.0,642.0,5,1073,3.0,805.0,805.0
0.006,6,10,1854,5,889,1.0,621.0,621.0,5,965,1.0,697.0,697.0
0.006,6,14,3799,7,509,0.0,137.0,137.0,7,3290,1.0,1448.0,972.0
1795.245,6,64,7361,42,4485,43786.0,1641.0,109.0,22,2876,85478.0,1112.0,82.0
0.011,6,10,1983,5,910,2.0,642.0,642.0,5,1073,2.0,805.0,805.0
0.005,6,10,2006,5,927,1.0,659.0,659.0,5,1079,1.0,811.0,811.0
0.005,6,10,2000,5,927,1.0,659.0,659.0,5,1073,1.0,805.0,805.0
0.005,6,10,2000,5,927,1.0,659.0,659.0,5,1073,1.0,805.0,805.0
0.003,17,2,136,1,60,0.0,32.0,32.0,1,76,0.0,48.0,48.0
0.005,6,10,2006,5,927,1.0,659.0,659.0,5,1079,1.0,811.0,811.0
0.01,6,10,1990,5,911,2.0,643.0,643.0,5,1079,2.0,811.0,811.0
0.011,6,10,1677,5,827,2.0,559.0,559.0,5,850,2.0,582.0,582.0
0.006,6,10,1854,5,889,1.0,621.0,621.0,5,965,1.0,697.0,697.0
15.075,17,19,10120,9,6968,1880.0,1350.0,746.0,10,3152,1671.0,1350.0,287.0
0.009,6,10,1990,5,911,2.0,643.0,643.0,5,1079,2.0,811.0,811.0
40.051,17,10,676,5,460,10011.0,104.0,64.0,5,216,10011.0,20.0,15.0
0.001,17,2,179,1,62,0.0,34.0,34.0,1,117,0.0,89.0,89.0
0.005,6,10,1779,5,928,1.0,660.0,660.0,5,851,1.0,583.0,583.0
0.007,6,10,1972,5,910,1.0,642.0,642.0,5,1062,1.0,794.0,794.0
308.726,17,20,1124,10,716,34287.0,48.0,43.0,10,408,34288.0,20.0,12.0
0.131,17,2,80,1,32,0.0,4.0,4.0,1,48,0.0,20.0,20.0
0.007,6,10,1547,5,764,1.0,496.0,496.0,5,783,1.0,515.0,515.0
1773.243,6,65,7413,43,4537,42220.0,1402.0,104.0,22,2876,84432.0,1112.0,82.0
0.006,6,10,1547,5,764,1.0,496.0,496.0,5,783,1.0,515.0,515.0
0.01,6,10,1972,5,910,2.0,642.0,642.0,5,1062,2.0,794.0,794.0
0.005,6,13,3684,7,446,0.0,74.0,74.0,6,3238,0.0,1470.0,1459.0
0.005,6,13,3747,7,509,0.0,137.0,137.0,6,3238,0.0,1470.0,1459.0
0.004,6,10,1989,5,927,1.0,659.0,659.0,5,1062,1.0,794.0,794.0
0.003,17,2,148,1,60,0.0,32.0,32.0,1,88,0.0,60.0,60.0
0.005,17,2,240,1,61,0.0,33.0,33.0,1,179,0.0,151.0,151.0
0.005,17,2,180,1,58,0.0,30.0,30.0,1,122,0.0,94.0,94.0
0.006,6,10,1547,5,764,1.0,496.0,496.0,5,783,1.0,515.0,515.0
0.007,6,10,1989,5,927,1.0,659.0,659.0,5,1062,1.0,794.0,794.0
0.074,6,10,1506,5,395,17.0,127.0,127.0,5,1111,16.0,843.0,843.0
0.082,6,10,1506,5,395,16.0,127.0,127.0,5,1111,19.0,843.0,843.0
0.001,17,2,180,1,66,0.0,38.0,38.0,1,114,0.0,86.0,86.0
300.415,6,16,2170,9,684,37531.0,146.0,146.0,7,1486,50041.0,419.0,398.0
0.085,6,10,1506,5,395,16.0,127.0,127.0,5,1111,17.0,843.0,843.0
0.014,6,10,1972,5,910,3.0,642.0,642.0,5,1062,3.0,794.0,794.0
0.008,6,10,1989,5,910,2.0,642.0,642.0,5,1079,1.0,811.0,811.0
0.005,6,10,2007,5,928,1.0,660.0,660.0,5,1079,1.0,811.0,811.0
0.004,17,2,148,1,60,0.0,32.0,32.0,1,88,0.0,60.0,60.0
0.091,6,10,1506,5,395,20.0,127.0,127.0,5,1111,19.0,843.0,843.0
0.01,6,10,1990,5,911,2.0,643.0,643.0,5,1079,2.0,811.0,811.0
0.003,17,2,148,1,60,0.0,32.0,32.0,1,88,0.0,60.0,60.0
322.176,6,811,796611,359,771443,899.0,4080.0,2266.0,452,25168,66.0,2667.0,228.0
0.004,17,2,162,1,65,0.0,37.0,37.0,1,97,0.0,69.0,69.0
0.102,6,10,1506,5,395,17.0,127.0,127.0,5,1111,23.0,843.0,843.0
0.109,6,10,1506,5,395,24.0,127.0,127.0,5,1111,21.0,843.0,843.0
40.07,17,10,676,5,460,10015.0,104.0,64.0,5,216,10016.0,20.0,15.0
0.013,6,10,1990,5,911,3.0,643.0,643.0,5,1079,3.0,811.0,811.0
0.068,6,10,1506,5,395,14.0,127.0,127.0,5,1111,14.0,843.0,843.0
0.004,6,10,2006,5,927,1.0,659.0,659.0,5,1079,1.0,811.0,811.0
0.071,6,10,1506,5,395,15.0,127.0,127.0,5,1111,15.0,843.0,843.0
0.006,6,10,1547,5,764,1.0,496.0,496.0,5,783,1.0,515.0,515.0
240.013,6,9,787,5,488,60003.0,232.0,232.0,4,299,80003.0,83.0,83.0
0.009,6,10,1990,5,911,2.0,643.0,643.0,5,1079,2.0,811.0,811.0
0.009,6,10,1989,5,910,2.0,642.0,642.0,5,1079,2.0,811.0,811.0
0.123,6,10,1506,5,395,29.0,127.0,127.0,5,1111,29.0,843.0,843.0
0.005,6,10,1779,5,928,1.0,660.0,660.0,5,851,1.0,583.0,583.0
0.064,6,10,1506,5,395,15.0,127.0,127.0,5,1111,15.0,843.0,843.0
0.125,6,10,1506,5,395,25.0,127.0,127.0,5,1111,28.0,843.0,843.0
0.004,6,10,2000,5,927,1.0,659.0,659.0,5,1073,1.0,805.0,805.0
0.009,6,10,1972,5,910,2.0,642.0,642.0,5,1062,2.0,794.0,794.0
0.006,6,10,1547,5,764,1.0,496.0,496.0,5,783,1.0,515.0,515.0
0.013,6,10,1762,5,911,3.0,643.0,643.0,5,851,3.0,583.0,583.0
0.08,6,10,1506,5,395,18.0,127.0,127.0,5,1111,18.0,843.0,843.0
0.004,6,10,2000,5,927,1.0,659.0,659.0,5,1073,1.0,805.0,805.0
1793.298,6,302,97525,187,86390,9641.0,2001.0,678.0,115,11135,15730.0,452.0,70.0
0.004,17,2,136,1,60,0.0,32.0,32.0,1,76,0.0,48.0,48.0
0.009,6,12,1926,6,1189,1.0,659.0,434.0,6,737,1.0,417.0,417.0
0.137,6,10,1506,5,395,23.0,127.0,127.0,5,1111,32.0,843.0,843.0
0.012,6,10,1972,5,910,3.0,642.0,642.0,5,1062,2.0,794.0,794.0
0.004,6,10,2006,5,927,1.0,659.0,659.0,5,1079,1.0,811.0,811.0
0.014,6,10,2006,5,927,3.0,659.0,659.0,5,1079,3.0,811.0,811.0
0.084,6,10,1506,5,395,19.0,127.0,127.0,5,1111,16.0,843.0,843.0
0.006,6,10,1689,5,839,1.0,571.0,571.0,5,850,1.0,582.0,582.0
0.004,6,10,2007,5,928,1.0,660.0,660.0,5,1079,1.0,811.0,811.0
0.068,17,8,3613,4,1874,22.0,1350.0,440.0,4,1739,11.0,1350.0,406.0
0.012,6,10,1972,5,910,2.0,642.0,642.0,5,1062,2.0,794.0,794.0
0.014,6,14,3787,7,497,2.0,125.0,125.0,7,3290,2.0,1448.0,972.0
15.078,17,14,9190,8,6902,2149.0,1350.0,834.0,6,2288,3009.0,1350.0,353.0
0.099,6,10,1506,5,395,18.0,127.0,127.0,5,1111,22.0,843.0,843.0
0.005,6,10,1547,5,764,1.0,496.0,496.0,5,783,1.0,515.0,515.0
11.162,17,28,4418,14,1995,846.0,270.0,114.0,14,2423,846.0,586.0,145.0
0.009,6,10,1989,5,910,2.0,642.0,642.0,5,1079,2.0,811.0,811.0
0.208,6,16,2669,8,1395,29.0,533.0,323.0,8,1274,18.0,529.0,212.0
240.083,6,16,4482,9,963,30010.0,238.0,166.0,7,3519,40013.0,1402.0,786.0
0.005,6,10,1689,5,839,1.0,571.0,571.0,5,850,1.0,582.0,582.0
0.004,6,10,1989,5,927,1.0,659.0,659.0,5,1062,1.0,794.0,794.0
0.005,6,10,1774,5,923,1.0,655.0,655.0,5,851,1.0,583.0,583.0
0.001,17,2,136,1,60,0.0,32.0,32.0,1,76,0.0,48.0,48.0
0.104,6,10,1506,5,395,25.0,127.0,127.0,5,1111,21.0,843.0,843.0
0.004,6,10,2006,5,927,1.0,659.0,659.0,5,1079,1.0,811.0,811.0
0.085,6,10,1506,5,395,19.0,127.0,127.0,5,1111,16.0,843.0,843.0
0.005,6,10,2006,5,927,1.0,659.0,659.0,5,1079,1.0,811.0,811.0
40.059,17,10,676,5,460,10013.0,104.0,64.0,5,216,10013.0,20.0,15.0
0.005,6,10,1689,5,839,1.0,571.0,571.0,5,850,1.0,582.0,582.0
0.001,17,2,180,1,66,0.0,38.0,38.0,1,114,0.0,86.0,86.0
0.11,6,10,1506,5,395,23.0,127.0,127.0,5,1111,22.0,843.0,843.0
0.006,17,2,170,1,65,0.0,37.0,37.0,1,105,0.0,77.0,77.0
0.007,6,10,1972,5,910,1.0,642.0,642.0,5,1062,1.0,794.0,794.0
0.011,6,10,1983,5,910,2.0,642.0,642.0,5,1073,2.0,805.0,805.0
0.009,6,10,1631,5,848,2.0,580.0,580.0,5,783,2.0,515.0,515.0
0.005,6,10,1989,5,927,1.0,659.0,659.0,5,1062,1.0,794.0,794.0
0.015,6,10,1983,5,910,3.0,642.0,642.0,5,1073,3.0,805.0,805.0
0.005,17,2,144,1,64,0.0,36.0,36.0,1,80,0.0,52.0,52.0
0.013,17,2,152,1,76,0.0,48.0,48.0,1,76,0.0,48.0,48.0
0.08,6,10,1506,5,395,17.0,127.0,127.0,5,1111,19.0,843.0,843.0
0.003,17,2,132,1,58,0.0,30.0,30.0,1,74,0.0,46.0,46.0
0.013,6,10,1990,5,911,3.0,643.0,643.0,5,1079,3.0,811.0,811.0
0.095,6,10,1506,5,395,19.0,127.0,127.0,5,1111,20.0,843.0,843.0
0.005,6,10,2006,5,927,1.0,659.0,659.0,5,1079,1.0,811.0,811.0
0.005,6,10,2007,5,928,1.0,660.0,660.0,5,1079,1.0,811.0,811.0
0.06,6,10,1506,5,395,13.0,127.0,127.0,5,1111,13.0,843.0,843.0
0.01,6,10,1990,5,911,2.0,643.0,643.0,5,1079,2.0,811.0,811.0
0.005,17,2,170,1,65,0.0,37.0,37.0,1,105,0.0,77.0,77.0
0.009,6,10,1989,5,910,2.0,642.0,642.0,5,1079,2.0,811.0,811.0
0.006,17,2,191,1,70,0.0,42.0,42.0,1,121,0.0,93.0,93.0
0.005,17,2,213,1,69,0.0,41.0,41.0,1,144,0.0,116.0,116.0
0.007,17,2,194,1,59,0.0,31.0,31.0,1,135,0.0,107.0,107.0
0.013,6,10,1989,5,910,3.0,642.0,642.0,5,1079,3.0,811.0,811.0
240.014,6,9,787,5,488,60003.0,232.0,232.0,4,299,80003.0,83.0,83.0
0.006,6,10,2000,5,927,1.0,659.0,659.0,5,1073,1.0,805.0,805.0
0.013,6,10,1989,5,910,3.0,642.0,642.0,5,1079,3.0,811.0,811.0
0.116,6,10,1506,5,395,26.0,127.0,127.0,5,1111,23.0,843.0,843.0
0.006,6,10,2006,5,927,1.0,659.0,659.0,5,1079,1.0,811.0,811.0
0.013,6,10,1605,5,388,3.0,120.0,120.0,5,1217,3.0,949.0,949.0
365.983,6,22,2313,16,867,24398.0,195.0,195.0,6,1446,4634.0,419.0,398.0
0.006,6,10,1989,5,927,1.0,659.0,659.0,5,1062,1.0,794.0,794.0
0.006,6,10,2007,5,928,1.0,660.0,660.0,5,1079,1.0,811.0,811.0
0.064,6,10,1506,5,395,13.0,127.0,127.0,5,1111,15.0,843.0,843.0
0.004,17,4,284,2,120,0.0,32.0,32.0,2,164,1.0,60.0,54.0
40.071,17,10,676,5,460,10014.0,104.0,64.0,5,216,10017.0,20.0,15.0
0.004,17,2,148,1,60,0.0,32.0,32.0,1,88,0.0,60.0,60.0
0.008,6,10,1972,5,910,2.0,642.0,642.0,5,1062,1.0,794.0,794.0
0.005,6,10,1989,5,927,1.0,659.0,659.0,5,1062,1.0,794.0,794.0
0.085,6,10,1506,5,395,17.0,127.0,127.0,5,1111,19.0,843.0,843.0
0.004,6,10,2007,5,928,1.0,660.0,660.0,5,1079,1.0,811.0,811.0
0.01,6,12,1926,6,1189,2.0,659.0,434.0,6,737,1.0,417.0,417.0
0.005,6,10,1547,5,764,1.0,496.0,496.0,5,783,1.0,515.0,515.0
0.111,6,10,1506,5,395,22.0,127.0,127.0,5,1111,23.0,843.0,843.0
0.008,6,10,1989,5,910,1.0,642.0,642.0,5,1079,1.0,811.0,811.0
10.86,17,26,4101,13,1821,895.0,268.0,112.0,13,2280,896.0,587.0,147.0
0.003,17,2,136,1,60,0.0,32.0,32.0,1,76,0.0,48.0,48.0
0.024,6,10,1989,5,910,5.0,642.0,642.0,5,1079,6.0,811.0,811.0
0.001,17,2,180,1,66,0.0,38.0,38.0,1,114,0.0,86.0,86.0
0.018,6,10,1989,5,910,4.0,642.0,642.0,5,1079,4.0,811.0,811.0
0.156,6,10,1242,5,751,39.0,495.0,495.0,5,491,37.0,223.0,223.0
0.004,6,10,2006,5,927,1.0,659.0,659.0,5,1079,1.0,811.0,811.0
361.763,6,19,1688,15,978,25840.0,190.0,190.0,4,710,80020.0,494.0,494.0
0.005,17,2,169,1,62,0.0,34.0,34.0,1,107,0.0,79.0,79.0
0.004,6,10,2007,5,928,1.0,660.0,660.0,5,1079,1.0,811.0,811.0
0.01,6,13,3735,7,497,1.0,125.0,125.0,6,3238,1.0,1470.0,1459.0
0.005,6,13,3747,7,509,0.0,137.0,137.0,6,3238,1.0,1470.0,1459.0
11.029,17,28,4390,14,2312,839.0,587.0,137.0,14,2078,839.0,269.0,120.0
40.062,17,10,676,5,460,10014.0,104.0,64.0,5,216,10014.0,20.0,15.0
0.005,6,10,1854,5,889,1.0,621.0,621.0,5,965,1.0,697.0,697.0
0.011,6,10,1989,5,910,2.0,642.0,642.0,5,1079,2.0,811.0,811.0
0.01,6,10,1762,5,911,2.0,643.0,643.0,5,851,2.0,583.0,583.0
0.004,17,2,136,1,60,0.0,32.0,32.0,1,76,0.0,48.0,48.0
0.092,6,10,1506,5,395,21.0,127.0,127.0,5,1111,17.0,843.0,843.0
0.004,6,10,1989,5,927,1.0,659.0,659.0,5,1062,1.0,794.0,794.0
1041.699,6,68,27254,35,7822,30638.0,1774.0,598.0,33,19432,30678.0,1402.0,843.0
1769.174,17,92,8096,46,4048,39314.0,60.0,60.0,46,4048,39314.0,60.0,60.0
0.012,6,10,1972,5,910,3.0,642.0,642.0,5,1062,3.0,794.0,794.0
0.012,6,10,1989,5,910,2.0,642.0,642.0,5,1079,3.0,811.0,811.0
0.005,6,10,1702,5,863,1.0,595.0,595.0,5,839,1.0,571.0,571.0
10.793,17,28,4423,14,1995,821.0,270.0,114.0,14,2428,821.0,587.0,145.0
0.004,6,10,1989,5,927,1.0,659.0,659.0,5,1062,1.0,794.0,794.0
0.004,17,2,136,1,60,0.0,32.0,32.0,1,76,0.0,48.0,48.0
0.011,6,10,1989,5,910,2.0,642.0,642.0,5,1079,2.0,811.0,811.0
0.009,6,10,1762,5,911,2.0,643.0,643.0,5,851,2.0,583.0,583.0
11.156,17,28,4423,14,1994,845.0,269.0,114.0,14,2429,845.0,588.0,145.0
0.009,6,10,2007,5,928,2.0,660.0,660.0,5,1079,2.0,811.0,811.0
0.001,17,2,136,1,60,0.0,32.0,32.0,1,76,0.0,48.0,48.0
0.021,6,10,1677,5,827,5.0,559.0,559.0,5,850,5.0,582.0,582.0
0.955,6,30,12790,16,6286,63.0,2720.0,935.0,14,6504,60.0,2749.0,988.0
0.006,17,2,214,1,75,0.0,47.0,47.0,1,139,0.0,111.0,111.0
0.001,17,2,166,1,75,0.0,47.0,47.0,1,91,0.0,63.0,63.0
0.071,17,4,284,2,120,0.0,32.0,32.0,2,164,68.0,60.0,54.0
0.009,17,2,148,1,60,0.0,32.0,32.0,1,88,0.0,60.0,60.0
0.018,6,10,1631,5,848,4.0,580.0,580.0,5,783,4.0,515.0,515.0
0.008,6,10,1702,5,863,1.0,595.0,595.0,5,839,1.0,571.0,571.0
40.073,17,10,676,5,460,10015.0,104.0,64.0,5,216,10010.0,20.0,15.0
0.009,6,10,1990,5,911,2.0,643.0,643.0,5,1079,2.0,811.0,811.0
0.071,6,10,1506,5,395,15.0,127.0,127.0,5,1111,15.0,843.0,843.0
0.033,6,10,1989,5,910,8.0,642.0,642.0,5,1079,8.0,811.0,811.0
0.001,17,2,180,1,66,0.0,38.0,38.0,1,114,0.0,86.0,86.0
0.112,6,10,1506,5,395,25.0,127.0,127.0,5,1111,22.0,843.0,843.0
0.081,6,10,1506,5,395,15.0,127.0,127.0,5,1111,18.0,843.0,843.0
0.068,6,10,1506,5,395,14.0,127.0,127.0,5,1111,16.0,843.0,843.0
243.365,6,301,343381,120,17754,2045.0,2736.0,959.0,181,325627,1352.0,2804.0,1849.0
0.006,6,10,1547,5,764,1.0,496.0,496.0,5,783,1.0,515.0,515.0
0.005,6,10,1547,5,764,1.0,496.0,496.0,5,783,1.0,515.0,515.0
0.005,6,10,2000,5,927,1.0,659.0,659.0,5,1073,1.0,805.0,805.0
0.084,6,10,1506,5,395,18.0,127.0,127.0,5,1111,17.0,843.0,843.0
0.096,6,10,1506,5,395,21.0,127.0,127.0,5,1111,22.0,843.0,843.0
0.014,6,10,1989,5,910,3.0,642.0,642.0,5,1079,3.0,811.0,811.0
0.031,6,19,9922,11,704,3.0,124.0,124.0,8,9218,4.0,2896.0,2198.0
0.005,6,10,1989,5,927,1.0,659.0,659.0,5,1062,1.0,794.0,794.0
0.005,6,14,3799,7,509,0.0,137.0,137.0,7,3290,0.0,1448.0,972.0
0.085,6,10,1506,5,395,18.0,127.0,127.0,5,1111,18.0,843.0,843.0
0.01,6,10,1989,5,910,2.0,642.0,642.0,5,1079,2.0,811.0,811.0
0.011,6,10,1989,5,910,2.0,642.0,642.0,5,1079,2.0,811.0,811.0
0.004,6,10,2007,5,928,1.0,660.0,660.0,5,1079,1.0,811.0,811.0
175.498,17,74,10417,37,2468,4874.0,44.0,38.0,37,7949,4874.0,261.0,186.0
0.251,17,2,152,1,76,0.0,48.0,48.0,1,76,0.0,48.0,48.0
0.005,6,10,1989,5,927,1.0,659.0,659.0,5,1062,1.0,794.0,794.0
0.005,6,10,2006,5,927,1.0,659.0,659.0,5,1079,1.0,811.0,811.0
0.005,6,14,3799,7,509,0.0,137.0,137.0,7,3290,0.0,1448.0,972.0
0.103,6,10,1506,5,395,22.0,127.0,127.0,5,1111,25.0,843.0,843.0
0.003,17,2,136,1,60,0.0,32.0,32.0,1,76,0.0,48.0,48.0
0.007,6,10,2006,5,927,1.0,659.0,659.0,5,1079,1.0,811.0,811.0
0.004,17,2,148,1,60,0.0,32.0,32.0,1,88,0.0,60.0,60.0
0.071,6,10,1506,5,395,17.0,127.0,127.0,5,1111,15.0,843.0,843.0
10.818,17,28,4422,14,1994,824.0,269.0,114.0,14,2428,824.0,587.0,145.0
0.008,6,10,1989,5,910,2.0,642.0,642.0,5,1079,1.0,811.0,811.0
0.007,17,2,179,1,71,0.0,43.0,43.0,1,108,0.0,80.0,80.0
40.079,17,10,676,5,460,10015.0,104.0,64.0,5,216,10018.0,20.0,15.0
0.006,17,2,140,1,62,0.0,34.0,34.0,1,78,0.0,50.0,50.0
0.095,6,10,1506,5,395,20.0,127.0,127.0,5,1111,22.0,843.0,843.0
0.003,17,2,412,1,61,0.0,33.0,33.0,1,351,0.0,323.0,323.0
40.059,17,10,676,5,460,10014.0,104.0,64.0,5,216,10014.0,20.0,15.0
0.004,6,10,1779,5,928,1.0,660.0,660.0,5,851,1.0,583.0,583.0
300.379,6,16,2170,9,684,37526.0,146.0,146.0,7,1486,50035.0,419.0,398.0
0.126,6,10,1506,5,395,29.0,127.0,127.0,5,1111,29.0,843.0,843.0
0.009,6,10,1989,5,910,2.0,642.0,642.0,5,1079,2.0,811.0,811.0
0.004,6,10,2006,5,927,1.0,659.0,659.0,5,1079,1.0,811.0,811.0
40.058,17,10,676,5,460,10013.0,104.0,64.0,5,216,10013.0,20.0,15.0
0.011,6,10,1762,5,911,2.0,643.0,643.0,5,851,2.0,583.0,583.0
40.072,17,10,676,5,460,10016.0,104.0,64.0,5,216,10017.0,20.0,15.0
0.004,6,10,2007,5,928,1.0,660.0,660.0,5,1079,1.0,811.0,811.0
0.063,6,10,1506,5,395,14.0,127.0,127.0,5,1111,13.0,843.0,843.0
0.01,6,10,1972,5,910,2.0,642.0,642.0,5,1062,2.0,794.0,794.0
0.037,17,2,148,1,60,0.0,32.0,32.0,1,88,0.0,60.0,60.0
1.432,6,20,9197,11,3370,143.0,1414.0,729.0,9,5827,148.0,1801.0,1363.0
0.004,6,10,2007,5,928,1.0,660.0,660.0,5,1079,1.0,811.0,811.0
0.006,17,2,170,1,65,0.0,37.0,37.0,1,105,0.0,77.0,77.0
0.006,6,10,1547,5,764,1.0,496.0,496.0,5,783,1.0,515.0,515.0
0.004,6,10,1989,5,927,1.0,659.0,659.0,5,1062,1.0,794.0,794.0
0.032,6,10,1990,5,911,7.0,643.0,643.0,5,1079,7.0,811.0,811.0
300.309,6,16,2170,9,684,37518.0,146.0,146.0,7,1486,50024.0,419.0,398.0
0.005,6,10,2007,5,928,1.0,660.0,660.0,5,1079,1.0,811.0,811.0
0.006,6,10,1854,5,889,1.0,621.0,621.0,5,965,1.0,697.0,697.0
0.09,6,10,1506,5,395,21.0,127.0,127.0,5,1111,19.0,843.0,843.0
0.133,6,10,1506,5,395,31.0,127.0,127.0,5,1111,24.0,843.0,843.0
0.006,6,10,1643,5,860,1.0,592.0,592.0,5,783,1.0,515.0,515.0
0.128,6,10,1506,5,395,28.0,127.0,127.0,5,1111,24.0,843.0,843.0
0.008,6,10,1972,5,910,2.0,642.0,642.0,5,1062,1.0,794.0,794.0
0.037,6,10,1972,5,910,9.0,642.0,642.0,5,1062,9.0,794.0,794.0
0.093,6,10,1506,5,395,20.0,127.0,127.0,5,1111,20.0,843.0,843.0
0.004,6,10,1989,5,927,1.0,659.0,659.0,5,1062,1.0,794.0,794.0
0.005,6,10,1689,5,839,1.0,571.0,571.0,5,850,1.0,582.0,582.0
0.007,17,2,144,1,64,0.0,36.0,36.0,1,80,0.0,52.0,52.0
0.078,6,10,1506,5,395,19.0,127.0,127.0,5,1111,17.0,843.0,843.0
0.127,17,2,184,1,61,0.0,33.0,33.0,1,123,0.0,95.0,95.0
0.007,6,10,1547,5,764,1.0,496.0,496.0,5,783,1.0,515.0,515.0
0.006,6,10,1547,5,764,1.0,496.0,496.0,5,783,1.0,515.0,515.0
308.511,17,20,1124,10,716,34264.0,48.0,43.0,10,408,34264.0,20.0,12.0
0.013,6,10,1972,5,910,3.0,642.0,642.0,5,1062,3.0,794.0,794.0
15.126,17,29,21419,18,18692,888.0,1350.0,1010.0,11,2727,1509.0,1350.0,219.0
0.001,17,2,180,1,66,0.0,38.0,38.0,1,114,0.0,86.0,86.0
0.006,17,2,169,1,62,0.0,34.0,34.0,1,107,0.0,79.0,79.0
0.005,6,10,1989,5,927,1.0,659.0,659.0,5,1062,1.0,794.0,794.0
0.027,17,2,144,1,64,0.0,36.0,36.0,1,80,0.0,52.0,52.0
0.075,6,10,1506,5,395,17.0,127.0,127.0,5,1111,13.0,843.0,843.0
0.063,17,2,152,1,76,0.0,48.0,48.0,1,76,0.0,48.0,48.0
0.012,6,10,1972,5,910,3.0,642.0,642.0,5,1062,3.0,794.0,794.0
40.072,17,10,676,5,460,10013.0,104.0,64.0,5,216,10016.0,20.0,15.0
0.009,6,14,3965,7,495,1.0,123.0,123.0,7,3470,1.0,1448.0,1032.0
0.005,6,10,1854,5,889,1.0,621.0,621.0,5,965,1.0,697.0,697.0
0.01,6,10,1989,5,910,2.0,642.0,642.0,5,1079,2.0,811.0,811.0
0.006,6,10,1547,5,764,1.0,496.0,496.0,5,783,1.0,515.0,515.0
0.006,6,10,1547,5,764,1.0,496.0,496.0,5,783,1.0,515.0,515.0
0.005,6,10,2006,5,927,1.0,659.0,659.0,5,1079,1.0,811.0,811.0
0.006,6,10,1547,5,764,1.0,496.0,496.0,5,783,1.0,515.0,515.0
0.001,17,2,180,1,66,0.0,38.0,38.0,1,114,0.0,86.0,86.0
300.33,6,16,2170,9,684,37520.0,146.0,146.0,7,1486,50026.0,419.0,398.0
15.079,17,15,9239,8,6902,2150.0,1350.0,834.0,7,2337,2507.0,1350.0,305.0
0.006,6,10,1689,5,839,1.0,571.0,571.0,5,850,1.0,582.0,582.0
300.333,6,16,2170,9,684,37522.0,146.0,146.0,7,1486,50028.0,419.0,398.0
167.47,17,78,10915,39,2604,4406.0,44.0,38.0,39,8311,4406.0,239.0,185.0
0.009,6,10,2006,5,927,2.0,659.0,659.0,5,1079,2.0,811.0,811.0
0.006,6,10,1547,5,764,1.0,496.0,496.0,5,783,1.0,515.0,515.0
0.111,17,4,548,2,122,74.0,33.0,33.0,2,426,39.0,275.0,185.0
0.003,17,2,136,1,60,0.0,32.0,32.0,1,76,0.0,48.0,48.0
0.315,6,77,37842,40,3022,8.0,517.0,104.0,37,34820,8.0,2804.0,1134.0
0.017,6,10,1774,5,923,4.0,655.0,655.0,5,851,4.0,583.0,583.0
0.113,6,10,1506,5,395,25.0,127.0,127.0,5,1111,24.0,843.0,843.0
300.094,6,19,4660,11,1102,30009.0,238.0,130.0,8,3558,42870.0,1402.0,786.0
0.005,17,2,187,1,71,0.0,43.0,43.0,1,116,0.0,88.0,88.0
320.851,17,17,960,9,640,40094.0,48.0,43.0,8,320,45820.0,12.0,12.0
0.006,6,10,1547,5,764,1.0,496.0,496.0,5,783,1.0,515.0,515.0
0.014,6,10,1972,5,910,3.0,642.0,642.0,5,1062,3.0,794.0,794.0
0.011,6,10,1990,5,911,2.0,643.0,643.0,5,1079,2.0,811.0,811.0
0.023,6,10,1989,5,910,5.0,642.0,642.0,5,1079,5.0,811.0,811.0
240.017,6,9,787,5,488,60004.0,232.0,232.0,4,299,80004.0,83.0,83.0
0.004,17,4,284,2,120,0.0,32.0,32.0,2,164,1.0,60.0,54.0
0.006,6,13,3690,7,452,1.0,80.0,80.0,6,3238,1.0,1470.0,1459.0
0.005,6,10,1779,5,928,1.0,660.0,660.0,5,851,1.0,583.0,583.0
0.028,6,10,1990,5,911,7.0,643.0,643.0,5,1079,6.0,811.0,811.0
0.085,6,10,1506,5,395,19.0,127.0,127.0,5,1111,19.0,843.0,843.0
0.073,6,10,1506,5,395,15.0,127.0,127.0,5,1111,14.0,843.0,843.0
0.248,17,4,596,2,122,177.0,33.0,33.0,2,474,176.0,323.0,209.0
0.008,6,10,1972,5,910,2.0,642.0,642.0,5,1062,1.0,794.0,794.0
0.004,6,10,1989,5,927,1.0,659.0,659.0,5,1062,1.0,794.0,794.0
0.166,17,2,152,1,76,0.0,48.0,48.0,1,76,0.0,48.0,48.0
0.004,6,10,2007,5,928,1.0,660.0,660.0,5,1079,1.0,811.0,811.0
174.335,17,80,11197,40,2667,4470.0,44.0,38.0,40,8530,4470.0,261.0,185.0
40.076,17,10,676,5,460,10016.0,104.0,64.0,5,216,10018.0,20.0,15.0
0.021,6,10,1972,5,910,5.0,642.0,642.0,5,1062,5.0,794.0,794.0
0.014,6,10,1990,5,911,3.0,643.0,643.0,5,1079,3.0,811.0,811.0
0.005,6,10,2007,5,928,1.0,660.0,660.0,5,1079,1.0,811.0,811.0
0.01,6,10,1983,5,910,2.0,642.0,642.0,5,1073,2.0,805.0,805.0
0.013,6,10,1990,5,911,3.0,643.0,643.0,5,1079,3.0,811.0,811.0
0.013,6,10,1990,5,911,3.0,643.0,643.0,5,1079,3.0,811.0,811.0
0.935,6,25,8463,14,2079,71.0,1144.0,371.0,11,6384,76.0,2720.0,988.0
0.005,6,14,3742,8,504,0.0,80.0,80.0,6,3238,1.0,1470.0,1459.0
0.006,6,10,1547,5,764,1.0,496.0,496.0,5,783,1.0,515.0,515.0
0.084,6,10,1506,5,395,20.0,127.0,127.0,5,1111,18.0,843.0,843.0
0.004,6,10,1989,5,927,1.0,659.0,659.0,5,1062,1.0,794.0,794.0
0.089,6,10,1506,5,395,20.0,127.0,127.0,5,1111,18.0,843.0,843.0
0.1,6,10,1506,5,395,21.0,127.0,127.0,5,1111,20.0,843.0,843.0
0.015,6,10,1990,5,911,3.0,643.0,643.0,5,1079,3.0,811.0,811.0
0.013,6,10,1989,5,910,3.0,642.0,642.0,5,1079,3.0,811.0,811.0
0.011,6,10,1990,5,911,2.0,643.0,643.0,5,1079,2.0,811.0,811.0
40.072,17,10,676,5,460,10015.0,104.0,64.0,5,216,10015.0,20.0,15.0
0.003,17,2,148,1,60,0.0,32.0,32.0,1,88,0.0,60.0,60.0
0.001,17,2,136,1,60,0.0,32.0,32.0,1,76,0.0,48.0,48.0
0.194,6,10,1506,5,395,44.0,127.0,127.0,5,1111,46.0,843.0,843.0
40.057,17,10,676,5,460,10013.0,104.0,64.0,5,216,10013.0,20.0,15.0
0.038,17,4,420,2,122,0.0,33.0,33.0,2,298,35.0,145.0,121.0
0.0,17,2,136,1,60,0.0,32.0,32.0,1,76,0.0,48.0,48.0
0.001,17,2,180,1,66,0.0,38.0,38.0,1,114,0.0,86.0,86.0
0.089,6,10,1506,5,395,18.0,127.0,127.0,5,1111,19.0,843.0,843.0
0.003,17,2,136,1,60,0.0,32.0,32.0,1,76,0.0,48.0,48.0
0.003,17,2,203,1,61,0.0,33.0,33.0,1,142,0.0,114.0,114.0
40.06,17,10,676,5,460,10014.0,104.0,64.0,5,216,10014.0,20.0,15.0
0.013,6,10,1631,5,848,3.0,580.0,580.0,5,783,3.0,515.0,515.0
0.073,6,10,1506,5,395,16.0,127.0,127.0,5,1111,13.0,843.0,843.0
1737.224,6,64,7344,42,4469,42371.0,1625.0,108.0,22,2875,82716.0,1111.0,82.0
0.017,6,10,1983,5,910,4.0,642.0,642.0,5,1073,4.0,805.0,805.0
0.005,6,10,1989,5,927,1.0,659.0,659.0,5,1062,1.0,794.0,794.0
0.009,6,10,1972,5,910,2.0,642.0,642.0,5,1062,2.0,794.0,794.0
0.006,17,2,228,1,82,0.0,54.0,54.0,1,146,0.0,118.0,118.0
0.009,6,10,1990,5,911,2.0,643.0,643.0,5,1079,2.0,811.0,811.0
0.116,6,10,1506,5,395,23.0,127.0,127.0,5,1111,28.0,843.0,843.0
0.038,17,2,412,1,61,0.0,33.0,33.0,1,351,0.0,323.0,323.0
40.096,17,10,676,5,460,10015.0,104.0,64.0,5,216,10023.0,20.0,15.0
40.059,17,10,676,5,460,10013.0,104.0,64.0,5,216,10013.0,20.0,15.0
0.034,17,2,152,1,76,0.0,48.0,48.0,1,76,0.0,48.0,48.0
0.094,6,10,1506,5,395,20.0,127.0,127.0,5,1111,20.0,843.0,843.0
0.08,6,10,1506,5,395,17.0,127.0,127.0,5,1111,18.0,843.0,843.0
40.073,17,10,676,5,460,10015.0,104.0,64.0,5,216,10017.0,20.0,15.0
0.004,6,10,2006,5,927,1.0,659.0,659.0,5,1079,1.0,811.0,811.0
0.018,6,10,1677,5,827,4.0,559.0,559.0,5,850,4.0,582.0,582.0
0.005,6,14,3799,7,509,0.0,137.0,137.0,7,3290,0.0,1448.0,972.0
0.007,6,10,1689,5,839,1.0,571.0,571.0,5,850,1.0,582.0,582.0
0.005,17,2,152,1,68,0.0,40.0,40.0,1,84,0.0,56.0,56.0
0.126,6,10,1506,5,395,25.0,127.0,127.0,5,1111,25.0,843.0,843.0
0.104,6,10,1506,5,395,22.0,127.0,127.0,5,1111,18.0,843.0,843.0
0.013,6,13,3735,7,497,2.0,125.0,125.0,6,3238,2.0,1470.0,1459.0
0.008,6,10,1547,5,764,1.0,496.0,496.0,5,783,1.0,515.0,515.0
0.135,6,10,1506,5,395,31.0,127.0,127.0,5,1111,30.0,843.0,843.0
0.005,6,10,2007,5,928,1.0,660.0,660.0,5,1079,1.0,811.0,811.0
0.004,6,10,2000,5,927,1.0,659.0,659.0,5,1073,1.0,805.0,805.0
0.116,6,10,1506,5,395,24.0,127.0,127.0,5,1111,24.0,843.0,843.0
40.071,17,10,676,5,460,10016.0,104.0,64.0,5,216,10016.0,20.0,15.0
240.02,6,9,787,5,488,60005.0,232.0,232.0,4,299,80005.0,83.0,83.0
0.111,6,10,1506,5,395,25.0,127.0,127.0,5,1111,21.0,843.0,843.0
0.13,17,4,284,2,120,0.0,32.0,32.0,2,164,127.0,60.0,54.0
0.045,6,14,3868,7,578,7.0,206.0,206.0,7,3290,7.0,1448.0,972.0
0.004,17,4,284,2,120,0.0,32.0,32.0,2,164,1.0,60.0,54.0
0.005,6,10,1989,5,927,1.0,659.0,659.0,5,1062,1.0,794.0,794.0
0.011,6,10,1989,5,910,2.0,642.0,642.0,5,1079,2.0,811.0,811.0
0.005,6,14,3742,7,452,0.0,80.0,80.0,7,3290,0.0,1448.0,972.0
10.926,17,26,4075,13,2140,901.0,587.0,136.0,13,1935,901.0,270.0,120.0
0.012,6,10,1762,5,911,3.0,643.0,643.0,5,851,3.0,583.0,583.0
0.005,6,10,1702,5,863,1.0,595.0,595.0,5,839,1.0,571.0,571.0
15.429,17,48,26861,27,23484,592.0,1350.0,841.0,21,3377,770.0,1350.0,132.0
0.004,6,10,2007,5,928,1.0,660.0,660.0,5,1079,1.0,811.0,811.0
0.115,6,10,1506,5,395,21.0,127.0,127.0,5,1111,26.0,843.0,843.0
0.13,6,10,1506,5,395,32.0,127.0,127.0,5,1111,28.0,843.0,843.0
0.005,6,10,2007,5,928,1.0,660.0,660.0,5,1079,1.0,811.0,811.0
0.001,17,2,180,1,66,0.0,38.0,38.0,1,114,0.0,86.0,86.0
0.004,6,10,2007,5,928,1.0,660.0,660.0,5,1079,1.0,811.0,811.0
0.006,6,10,1547,5,764,1.0,496.0,496.0,5,783,1.0,515.0,515.0
0.006,6,10,1547,5,764,1.0,496.0,496.0,5,783,1.0,515.0,515.0
0.011,6,10,1762,5,911,2.0,643.0,643.0,5,851,2.0,583.0,583.0
0.009,6,10,1762,5,911,2.0,643.0,643.0,5,851,2.0,583.0,583.0
300.355,6,16,2170,9,684,37523.0,146.0,146.0,7,1486,50031.0,419.0,398.0
0.08,6,10,1506,5,395,17.0,127.0,127.0,5,1111,17.0,843.0,843.0
0.005,6,14,3799,7,509,0.0,137.0,137.0,7,3290,0.0,1448.0,972.0
10.787,17,26,4101,13,1822,889.0,269.0,112.0,13,2279,889.0,586.0,147.0
40.061,17,10,676,5,460,10013.0,104.0,64.0,5,216,10014.0,20.0,15.0
0.079,6,10,1506,5,395,17.0,127.0,127.0,5,1111,17.0,843.0,843.0
0.092,6,10,1506,5,395,20.0,127.0,127.0,5,1111,21.0,843.0,843.0
0.078,6,10,1506,5,395,17.0,127.0,127.0,5,1111,16.0,843.0,843.0
0.007,6,10,1547,5,764,1.0,496.0,496.0,5,783,1.0,515.0,515.0
361.741,6,21,1793,16,1030,24116.0,190.0,190.0,5,763,60009.0,462.0,247.0
0.009,6,10,1972,5,910,2.0,642.0,642.0,5,1062,2.0,794.0,794.0
0.006,6,10,1643,5,860,1.0,592.0,592.0,5,783,1.0,515.0,515.0
0.087,6,10,1506,5,395,19.0,127.0,127.0,5,1111,20.0,843.0,843.0
0.004,6,10,2006,5,927,1.0,659.0,659.0,5,1079,1.0,811.0,811.0
0.006,6,10,1854,5,889,1.0,621.0,621.0,5,965,1.0,697.0,697.0
0.009,6,10,1989,5,910,2.0,642.0,642.0,5,1079,2.0,811.0,811.0
0.005,6,10,1689,5,839,1.0,571.0,571.0,5,850,1.0,582.0,582.0
0.012,6,10,1972,5,910,3.0,642.0,642.0,5,1062,2.0,794.0,794.0
0.004,6,10,2007,5,928,1.0,660.0,660.0,5,1079,1.0,811.0,811.0
0.001,17,2,180,1,66,0.0,38.0,38.0,1,114,0.0,86.0,86.0
0.126,6,10,1506,5,395,27.0,127.0,127.0,5,1111,26.0,843.0,843.0
0.005,17,2,144,1,64,0.0,36.0,36.0,1,80,0.0,52.0,52.0
0.005,17,2,169,1,62,0.0,34.0,34.0,1,107,0.0,79.0,79.0
0.016,6,10,1990,5,911,4.0,643.0,643.0,5,1079,4.0,811.0,811.0
0.067,6,10,1506,5,395,14.0,127.0,127.0,5,1111,14.0,843.0,843.0
0.017,6,10,1989,5,910,4.0,642.0,642.0,5,1079,4.0,811.0,811.0
0.001,17,2,136,1,60,0.0,32.0,32.0,1,76,0.0,48.0,48.0
0.079,6,10,1506,5,395,17.0,127.0,127.0,5,1111,18.0,843.0,843.0
0.098,6,10,1506,5,395,15.0,127.0,127.0,5,1111,20.0,843.0,843.0
0.094,6,10,1506,5,395,22.0,127.0,127.0,5,1111,19.0,843.0,843.0
0.006,6,10,1547,5,764,1.0,496.0,496.0,5,783,1.0,515.0,515.0
0.004,6,10,2000,5,927,1.0,659.0,659.0,5,1073,1.0,805.0,805.0
0.011,6,10,1989,5,910,2.0,642.0,642.0,5,1079,2.0,811.0,811.0
0.005,17,2,136,1,60,0.0,32.0,32.0,1,76,0.0,48.0,48.0
40.045,17,10,676,5,460,10010.0,104.0,64.0,5,216,10010.0,20.0,15.0
0.004,6,10,1989,5,927,1.0,659.0,659.0,5,1062,1.0,794.0,794.0
0.094,6,10,1506,5,395,19.0,127.0,127.0,5,1111,22.0,843.0,843.0
40.074,17,10,676,5,460,10015.0,104.0,64.0,5,216,10017.0,20.0,15.0
0.001,17,2,180,1,66,0.0,38.0,38.0,1,114,0.0,86.0,86.0
0.003,17,2,148,1,60,0.0,32.0,32.0,1,88,0.0,60.0,60.0
0.005,6,10,1854,5,889,1.0,621.0,621.0,5,965,1.0,697.0,697.0
1.184,6,32,13392,18,5893,69.0,2720.0,854.0,14,7499,77.0,2720.0,769.0
0.012,6,13,3735,7,497,2.0,125.0,125.0,6,3238,2.0,1470.0,1459.0
267.799,6,63,31874,29,4477,9564.0,944.0,297.0,34,27397,8115.0,2804.0,1024.0
0.005,17,2,148,1,60,0.0,32.0,32.0,1,88,0.0,60.0,60.0
311.672,17,20,1124,10,716,34620.0,48.0,43.0,10,408,34622.0,20.0,12.0
0.093,6,10,1506,5,395,20.0,127.0,127.0,5,1111,22.0,843.0,843.0
412.011,6,29,4409,12,3102,10912.0,494.0,494.0,17,1307,25750.0,83.0,83.0
0.006,6,10,1547,5,764,1.0,496.0,496.0,5,783,1.0,515.0,515.0
0.007,17,2,194,1,59,0.0,31.0,31.0,1,135,0.0,107.0,107.0
0.001,17,2,180,1,66,0.0,38.0,38.0,1,114,0.0,86.0,86.0
40.077,17,10,676,5,460,10013.0,104.0,64.0,5,216,10017.0,20.0,15.0
0.005,6,10,1989,5,927,1.0,659.0,659.0,5,1062,1.0,794.0,794.0
0.005,17,2,225,1,65,0.0,37.0,37.0,1,160,0.0,132.0,132.0
15.084,17,15,9015,8,6759,2150.0,1350.0,816.0,7,2256,2509.0,1350.0,294.0
0.133,6,10,1506,5,395,32.0,127.0,127.0,5,1111,28.0,843.0,843.0
240.09,6,16,4482,9,963,30011.0,238.0,166.0,7,3519,40014.0,1402.0,786.0
0.006,6,10,1547,5,764,1.0,496.0,496.0,5,783,1.0,515.0,515.0
0.005,17,2,180,1,66,0.0,38.0,38.0,1,114,0.0,86.0,86.0
40.089,17,10,676,5,460,10020.0,104.0,64.0,5,216,10021.0,20.0,15.0
0.001,17,2,180,1,66,0.0,38.0,38.0,1,114,0.0,86.0,86.0
0.006,6,10,2006,5,927,1.0,659.0,659.0,5,1079,1.0,811.0,811.0
0.005,6,10,2000,5,927,1.0,659.0,659.0,5,1073,1.0,805.0,805.0
361.829,6,21,1792,16,1030,24121.0,190.0,190.0,5,762,60010.0,461.0,247.0
0.022,6,10,1990,5,911,5.0,643.0,643.0,5,1079,5.0,811.0,811.0
0.013,6,10,1989,5,910,3.0,642.0,642.0,5,1079,3.0,811.0,811.0
0.082,6,10,1506,5,395,17.0,127.0,127.0,5,1111,18.0,843.0,843.0
1730.413,6,45,2790,30,1725,59669.0,35.0,35.0,15,1065,123595.0,31.0,31.0
0.008,17,2,148,1,60,0.0,32.0,32.0,1,88,0.0,60.0,60.0
0.013,6,10,1990,5,911,3.0,643.0,643.0,5,1079,3.0,811.0,811.0
0.311,17,4,352,2,130,164.0,37.0,37.0,2,222,258.0,89.0,83.0
0.004,6,10,2006,5,927,1.0,659.0,659.0,5,1079,1.0,811.0,811.0
0.005,6,10,2007,5,928,1.0,660.0,660.0,5,1079,1.0,811.0,811.0
0.005,6,10,2007,5,928,1.0,660.0,660.0,5,1079,1.0,811.0,811.0
0.005,6,13,3747,7,509,0.0,137.0,137.0,6,3238,1.0,1470.0,1459.0
1792.693,6,480,98427,241,87330,7469.0,421.0,369.0,239,11097,7531.0,53.0,53.0
0.137,6,10,1506,5,395,31.0,127.0,127.0,5,1111,28.0,843.0,843.0
167.177,17,74,10826,37,2476,4643.0,44.0,38.0,37,8350,4643.0,279.0,197.0
0.064,6,10,1506,5,395,15.0,127.0,127.0,5,1111,15.0,843.0,843.0
0.006,6,10,1779,5,928,1.0,660.0,660.0,5,851,1.0,583.0,583.0
0.092,6,10,1506,5,395,21.0,127.0,127.0,5,1111,18.0,843.0,843.0
0.071,6,10,1506,5,395,15.0,127.0,127.0,5,1111,15.0,843.0,843.0
15.109,17,16,10616,9,8280,1882.0,1350.0,892.0,7,2336,2511.0,1350.0,305.0
0.085,6,10,1506,5,395,18.0,127.0,127.0,5,1111,18.0,843.0,843.0
0.217,17,4,352,2,130,146.0,37.0,37.0,2,222,177.0,89.0,83.0
0.264,17,13,10469,8,8229,37.0,1350.0,1000.0,5,2240,61.0,1350.0,420.0
0.004,17,2,136,1,60,0.0,32.0,32.0,1,76,0.0,48.0,48.0
0.001,17,2,136,1,60,0.0,32.0,32.0,1,76,0.0,48.0,48.0
0.004,6,10,2000,5,927,1.0,659.0,659.0,5,1073,1.0,805.0,805.0
0.006,17,2,180,1,66,0.0,38.0,38.0,1,114,0.0,86.0,86.0
1760.717,6,460,69381,268,36386,6594.0,613.0,189.0,192,32995,9217.0,613.0,152.0
0.009,6,10,1972,5,910,2.0,642.0,642.0,5,1062,2.0,794.0,794.0
0.155,6,10,1506,5,395,31.0,127.0,127.0,5,1111,25.0,843.0,843.0
11.177,17,28,4423,14,1994,847.0,269.0,114.0,14,2429,847.0,588.0,145.0
40.064,17,10,676,5,460,10013.0,104.0,64.0,5,216,10015.0,20.0,15.0
0.004,17,4,284,2,120,1.0,32.0,32.0,2,164,1.0,60.0,54.0
240.123,6,31,7696,16,5269,16008.0,1515.0,493.0,15,2427,17151.0,580.0,204.0
0.005,6,10,1774,5,923,1.0,655.0,655.0,5,851,1.0,583.0,583.0
0.005,6,13,3747,7,509,0.0,137.0,137.0,6,3238,0.0,1470.0,1459.0
0.002,17,2,180,1,66,0.0,38.0,38.0,1,114,0.0,86.0,86.0
40.056,17,10,676,5,460,10012.0,104.0,64.0,5,216,10013.0,20.0,15.0
0.017,6,13,3735,7,497,2.0,125.0,125.0,6,3238,3.0,1470.0,1459.0
40.062,17,10,676,5,460,10014.0,104.0,64.0,5,216,10014.0,20.0,15.0
0.006,6,12,1698,6,863,1.0,327.0,271.0,6,835,1.0,515.0,515.0
0.012,6,10,1989,5,910,2.0,642.0,642.0,5,1079,2.0,811.0,811.0
0.011,6,10,1983,5,910,2.0,642.0,642.0,5,1073,2.0,805.0,805.0
0.004,6,10,2007,5,928,1.0,660.0,660.0,5,1079,1.0,811.0,811.0
0.138,17,2,412,1,61,0.0,33.0,33.0,1,351,0.0,323.0,323.0
0.008,6,10,1677,5,827,2.0,559.0,559.0,5,850,1.0,582.0,582.0
0.005,6,10,2007,5,928,1.0,660.0,660.0,5,1079,1.0,811.0,811.0
0.004,17,4,284,2,120,0.0,32.0,32.0,2,164,1.0,60.0,54.0
0.131,17,2,170,1,65,0.0,37.0,37.0,1,105,0.0,77.0,77.0
0.009,6,10,1989,5,910,2.0,642.0,642.0,5,1079,2.0,811.0,811.0
0.005,6,13,3747,7,509,0.0,137.0,137.0,6,3238,0.0,1470.0,1459.0
0.009,6,10,1972,5,910,2.0,642.0,642.0,5,1062,2.0,794.0,794.0
0.014,6,10,1972,5,910,3.0,642.0,642.0,5,1062,3.0,794.0,794.0
331.568,17,20,1124,10,716,36834.0,48.0,43.0,10,408,36834.0,20.0,12.0
308.438,17,20,1124,10,716,34256.0,48.0,43.0,10,408,34256.0,20.0,12.0
0.006,6,10,1547,5,764,1.0,496.0,496.0,5,783,1.0,515.0,515.0
0.097,6,10,1506,5,395,21.0,127.0,127.0,5,1111,20.0,843.0,843.0
0.039,17,2,148,1,60,0.0,32.0,32.0,1,88,0.0,60.0,60.0
0.005,17,2,140,1,62,0.0,34.0,34.0,1,78,0.0,50.0,50.0
0.005,17,2,170,1,65,0.0,37.0,37.0,1,105,0.0,77.0,77.0
0.01,6,10,1990,5,911,2.0,643.0,643.0,5,1079,2.0,811.0,811.0
0.004,6,10,2007,5,928,1.0,660.0,660.0,5,1079,1.0,811.0,811.0
320.34,6,31,11001,17,3407,20021.0,1373.0,503.0,14,7594,20023.0,1402.0,857.0
0.059,6,10,1506,5,395,13.0,127.0,127.0,5,1111,12.0,843.0,843.0
0.005,6,10,2000,5,927,1.0,659.0,659.0,5,1073,1.0,805.0,805.0
0.109,6,10,1506,5,395,22.0,127.0,127.0,5,1111,23.0,843.0,843.0
0.029,6,10,1972,5,910,7.0,642.0,642.0,5,1062,7.0,794.0,794.0
0.004,17,2,136,1,60,0.0,32.0,32.0,1,76,0.0,48.0,48.0
15.076,17,16,8587,8,6401,2149.0,1350.0,772.0,8,2186,2149.0,1350.0,245.0
240.013,6,9,787,5,488,60003.0,232.0,232.0,4,299,80003.0,83.0,83.0
0.08,6,10,1506,5,395,18.0,127.0,127.0,5,1111,19.0,843.0,843.0
0.001,17,2,180,1,66,0.0,38.0,38.0,1,114,0.0,86.0,86.0
0.097,6,10,1506,5,395,20.0,127.0,127.0,5,1111,22.0,843.0,843.0
0.08,6,10,1506,5,395,16.0,127.0,127.0,5,1111,19.0,843.0,843.0
0.005,6,10,1689,5,839,1.0,571.0,571.0,5,850,1.0,582.0,582.0
0.096,6,10,1506,5,395,22.0,127.0,127.0,5,1111,23.0,843.0,843.0
0.015,6,10,1983,5,910,3.0,642.0,642.0,5,1073,3.0,805.0,805.0
0.125,6,10,1506,5,395,30.0,127.0,127.0,5,1111,30.0,843.0,843.0
0.04,17,2,148,1,60,0.0,32.0,32.0,1,88,0.0,60.0,60.0
0.004,17,2,136,1,60,0.0,32.0,32.0,1,76,0.0,48.0,48.0
0.013,6,10,1989,5,910,3.0,642.0,642.0,5,1079,3.0,811.0,811.0
0.008,17,2,307,1,61,0.0,33.0,33.0,1,246,0.0,218.0,218.0
0.006,6,10,2007,5,928,1.0,660.0,660.0,5,1079,1.0,811.0,811.0
0.003,17,4,284,2,120,0.0,32.0,32.0,2,164,0.0,60.0,54.0
0.008,17,2,194,1,59,0.0,31.0,31.0,1,135,0.0,107.0,107.0
0.008,6,10,1547,5,764,2.0,496.0,496.0,5,783,1.0,515.0,515.0
0.007,6,10,1689,5,839,1.0,571.0,571.0,5,850,1.0,582.0,582.0
0.003,17,2,136,1,60,0.0,32.0,32.0,1,76,0.0,48.0,48.0
0.005,6,10,1989,5,927,1.0,659.0,659.0,5,1062,1.0,794.0,794.0
0.005,6,10,1779,5,928,1.0,660.0,660.0,5,851,1.0,583.0,583.0
0.08,6,10,1506,5,395,19.0,127.0,127.0,5,1111,19.0,843.0,843.0
0.005,6,10,1774,5,923,1.0,655.0,655.0,5,851,1.0,583.0,583.0
0.004,17,2,148,1,60,0.0,32.0,32.0,1,88,0.0,60.0,60.0
0.005,6,10,1643,5,860,1.0,592.0,592.0,5,783,1.0,515.0,515.0
0.005,6,10,1689,5,839,1.0,571.0,571.0,5,850,1.0,582.0,582.0
0.109,6,10,1506,5,395,25.0,127.0,127.0,5,1111,24.0,843.0,843.0
0.037,17,2,144,1,64,0.0,36.0,36.0,1,80,0.0,52.0,52.0
0.006,6,10,1547,5,764,1.0,496.0,496.0,5,783,1.0,515.0,515.0
0.004,17,2,148,1,60,0.0,32.0,32.0,1,88,0.0,60.0,60.0
0.005,17,2,214,1,75,0.0,47.0,47.0,1,139,0.0,111.0,111.0
0.001,17,2,164,1,74,0.0,46.0,46.0,1,90,0.0,62.0,62.0
0.006,6,10,1689,5,839,1.0,571.0,571.0,5,850,1.0,582.0,582.0
0.003,17,4,284,2,120,0.0,32.0,32.0,2,164,1.0,60.0,54.0
10.827,17,28,4423,14,1995,824.0,270.0,114.0,14,2428,823.0,587.0,145.0
0.116,6,10,1506,5,395,25.0,127.0,127.0,5,1111,28.0,843.0,843.0
0.005,6,10,2006,5,927,1.0,659.0,659.0,5,1079,1.0,811.0,811.0
0.005,6,14,3736,7,446,0.0,74.0,74.0,7,3290,0.0,1448.0,972.0
0.005,6,10,1774,5,923,1.0,655.0,655.0,5,851,1.0,583.0,583.0
65.609,6,27,17524,15,9579,4686.0,2804.0,1465.0,12,7945,5948.0,2316.0,1218.0
0.008,6,10,1774,5,923,1.0,655.0,655.0,5,851,1.0,583.0,583.0
40.081,17,10,676,5,460,10018.0,104.0,64.0,5,216,10019.0,20.0,15.0
0.178,17,2,152,1,76,0.0,48.0,48.0,1,76,0.0,48.0,48.0
0.081,6,10,1506,5,395,18.0,127.0,127.0,5,1111,17.0,843.0,843.0
40.055,17,10,676,5,460,10013.0,104.0,64.0,5,216,10012.0,20.0,15.0
0.094,6,10,1506,5,395,20.0,127.0,127.0,5,1111,20.0,843.0,843.0
0.013,6,10,1989,5,910,3.0,642.0,642.0,5,1079,3.0,811.0,811.0
0.006,17,2,179,1,71,0.0,43.0,43.0,1,108,0.0,80.0,80.0
0.005,6,10,1779,5,928,1.0,660.0,660.0,5,851,1.0,583.0,583.0
178.128,17,72,10182,36,2394,5089.0,44.0,38.0,36,7788,5089.0,239.0,188.0
0.086,6,10,1506,5,395,21.0,127.0,127.0,5,1111,18.0,843.0,843.0
0.037,17,2,148,1,60,0.0,32.0,32.0,1,88,0.0,60.0,60.0
0.004,17,2,148,1,60,0.0,32.0,32.0,1,88,0.0,60.0,60.0
0.004,6,10,1702,5,863,1.0,595.0,595.0,5,839,1.0,571.0,571.0
0.01,6,14,3787,7,497,1.0,125.0,125.0,7,3290,1.0,1448.0,972.0
0.005,6,10,1547,5,764,1.0,496.0,496.0,5,783,1.0,515.0,515.0
0.008,6,10,1779,5,928,1.0,660.0,660.0,5,851,1.0,583.0,583.0
0.006,6,12,1698,6,863,1.0,327.0,271.0,6,835,1.0,515.0,515.0
174.541,17,80,11327,40,2652,4475.0,44.0,38.0,40,8675,4475.0,261.0,188.0
0.014,6,10,1990,5,911,3.0,643.0,643.0,5,1079,3.0,811.0,811.0
0.01,6,10,1677,5,827,2.0,559.0,559.0,5,850,2.0,582.0,582.0
0.005,6,10,2007,5,928,1.0,660.0,660.0,5,1079,1.0,811.0,811.0
0.009,6,10,1990,5,911,2.0,643.0,643.0,5,1079,2.0,811.0,811.0
0.005,6,10,1989,5,927,1.0,659.0,659.0,5,1062,1.0,794.0,794.0
0.005,6,10,2006,5,927,1.0,659.0,659.0,5,1079,1.0,811.0,811.0
0.007,17,2,307,1,61,0.0,33.0,33.0,1,246,0.0,218.0,218.0
0.001,17,2,166,1,75,0.0,47.0,47.0,1,91,0.0,63.0,63.0
40.068,17,10,676,5,460,10016.0,104.0,64.0,5,216,10016.0,20.0,15.0
0.006,17,2,144,1,64,0.0,36.0,36.0,1,80,0.0,52.0,52.0
0.009,6,10,1990,5,911,2.0,643.0,643.0,5,1079,2.0,811.0,811.0
0.125,6,10,1506,5,395,30.0,127.0,127.0,5,1111,30.0,843.0,843.0
0.004,17,2,148,1,60,0.0,32.0,32.0,1,88,0.0,60.0,60.0
0.145,6,10,1506,5,395,34.0,127.0,127.0,5,1111,34.0,843.0,843.0
0.005,17,2,166,1,75,0.0,47.0,47.0,1,91,0.0,63.0,63.0
0.012,6,10,1972,5,910,3.0,642.0,642.0,5,1062,3.0,794.0,794.0
0.006,6,10,1547,5,764,1.0,496.0,496.0,5,783,1.0,515.0,515.0
0.125,6,10,1506,5,395,30.0,127.0,127.0,5,1111,29.0,843.0,843.0
0.003,17,4,284,2,120,0.0,32.0,32.0,2,164,0.0,60.0,54.0
0.041,17,2,152,1,76,0.0,48.0,48.0,1,76,0.0,48.0,48.0
0.01,6,10,1990,5,911,2.0,643.0,643.0,5,1079,2.0,811.0,811.0
0.01,6,10,1643,5,860,2.0,592.0,592.0,5,783,2.0,515.0,515.0
0.005,6,10,2000,5,927,1.0,659.0,659.0,5,1073,1.0,805.0,805.0
0.227,6,16,2778,8,1396,32.0,533.0,324.0,8,1382,20.0,529.0,239.0
0.005,6,10,1989,5,927,1.0,659.0,659.0,5,1062,1.0,794.0,794.0
240.249,6,41,5240,20,2440,12644.0,588.0,197.0,21,2800,12012.0,580.0,212.0
0.004,17,2,148,1,60,0.0,32.0,32.0,1,88,0.0,60.0,60.0
0.004,17,4,284,2,120,0.0,32.0,32.0,2,164,1.0,60.0,54.0
0.007,6,13,3747,7,509,1.0,137.0,137.0,6,3238,1.0,1470.0,1459.0
1792.812,6,487,98813,246,87583,7317.0,421.0,368.0,241,11230,7469.0,53.0,53.0
0.009,6,10,1989,5,910,2.0,642.0,642.0,5,1079,2.0,811.0,811.0
308.613,17,20,1124,10,716,34276.0,48.0,43.0,10,408,34276.0,20.0,12.0
0.004,17,2,136,1,60,0.0,32.0,32.0,1,76,0.0,48.0,48.0
0.019,6,10,1990,5,911,4.0,643.0,643.0,5,1079,4.0,811.0,811.0
0.016,6,10,1990,5,911,4.0,643.0,643.0,5,1079,3.0,811.0,811.0
0.004,6,10,1779,5,928,1.0,660.0,660.0,5,851,1.0,583.0,583.0
0.005,6,10,1989,5,927,1.0,659.0,659.0,5,1062,1.0,794.0,794.0
0.011,6,10,1631,5,848,2.0,580.0,580.0,5,783,2.0,515.0,515.0
361.826,6,21,1793,16,1030,24121.0,190.0,190.0,5,763,60010.0,462.0,247.0
0.005,17,2,140,1,62,0.0,34.0,34.0,1,78,0.0,50.0,50.0
0.013,6,10,1990,5,911,3.0,643.0,643.0,5,1079,3.0,811.0,811.0
0.009,6,10,1990,5,911,2.0,643.0,643.0,5,1079,2.0,811.0,811.0
1757.113,6,107,6374,60,3525,29780.0,27.0,27.0,47,2849,38197.0,27.0,27.0
0.011,6,10,1677,5,827,2.0,559.0,559.0,5,850,2.0,582.0,582.0
0.009,6,10,1972,5,910,2.0,642.0,642.0,5,1062,2.0,794.0,794.0
300.106,6,12,1782,7,1348,50017.0,494.0,494.0,5,434,75015.0,83.0,83.0
0.007,6,10,1989,5,927,1.0,659.0,659.0,5,1062,1.0,794.0,794.0
0.013,6,10,1990,5,911,3.0,643.0,643.0,5,1079,3.0,811.0,811.0
0.006,6,10,1547,5,764,1.0,496.0,496.0,5,783,1.0,515.0,515.0
0.068,6,10,1506,5,395,13.0,127.0,127.0,5,1111,15.0,843.0,843.0
0.005,6,10,1989,5,927,1.0,659.0,659.0,5,1062,1.0,794.0,794.0
0.005,6,10,1774,5,923,1.0,655.0,655.0,5,851,1.0,583.0,583.0
0.122,17,2,80,1,32,0.0,4.0,4.0,1,48,0.0,20.0,20.0
0.014,6,10,1689,5,839,3.0,571.0,571.0,5,850,3.0,582.0,582.0
0.009,6,10,1989,5,910,2.0,642.0,642.0,5,1079,2.0,811.0,811.0
0.06,17,2,152,1,76,0.0,48.0,48.0,1,76,0.0,48.0,48.0
0.014,6,10,1972,5,910,3.0,642.0,642.0,5,1062,3.0,794.0,794.0
0.009,6,10,1983,5,910,2.0,642.0,642.0,5,1073,2.0,805.0,805.0
281.76,6,22,6035,9,1146,35219.0,267.0,156.0,13,4889,23479.0,1400.0,873.0
0.012,6,6,716,3,458,5.0,302.0,302.0,3,258,3.0,102.0,102.0
0.156,6,10,1506,5,395,38.0,127.0,127.0,5,1111,35.0,843.0,843.0
0.005,6,10,2006,5,927,1.0,659.0,659.0,5,1079,1.0,811.0,811.0
40.076,17,10,676,5,460,10015.0,104.0,64.0,5,216,10018.0,20.0,15.0
0.005,6,13,3747,7,509,0.0,137.0,137.0,6,3238,0.0,1470.0,1459.0
10.718,17,26,4102,13,1822,884.0,269.0,112.0,13,2280,884.0,587.0,147.0
0.066,17,8,3613,4,1874,22.0,1350.0,440.0,4,1739,11.0,1350.0,406.0
0.016,6,10,1631,5,848,4.0,580.0,580.0,5,783,4.0,515.0,515.0
0.014,6,10,1689,5,839,3.0,571.0,571.0,5,850,3.0,582.0,582.0
174.078,17,80,11416,40,2672,4463.0,44.0,38.0,40,8744,4463.0,239.0,190.0
0.023,6,10,1989,5,910,5.0,642.0,642.0,5,1079,5.0,811.0,811.0
0.006,6,10,1689,5,839,1.0,571.0,571.0,5,850,1.0,582.0,582.0
0.004,6,10,1989,5,927,1.0,659.0,659.0,5,1062,1.0,794.0,794.0
0.006,6,10,1689,5,839,1.0,571.0,571.0,5,850,1.0,582.0,582.0
0.005,17,2,140,1,62,0.0,34.0,34.0,1,78,0.0,50.0,50.0
0.01,6,10,1989,5,910,2.0,642.0,642.0,5,1079,2.0,811.0,811.0
0.091,6,10,1506,5,395,20.0,127.0,127.0,5,1111,18.0,843.0,843.0
0.085,6,10,1506,5,395,16.0,127.0,127.0,5,1111,20.0,843.0,843.0
0.005,6,10,2007,5,928,1.0,660.0,660.0,5,1079,1.0,811.0,811.0
0.107,6,10,1506,5,395,20.0,127.0,127.0,5,1111,24.0,843.0,843.0
0.015,6,10,1989,5,910,3.0,642.0,642.0,5,1079,3.0,811.0,811.0
0.008,6,10,1990,5,911,2.0,643.0,643.0,5,1079,2.0,811.0,811.0
0.001,17,2,180,1,66,0.0,38.0,38.0,1,114,0.0,86.0,86.0
0.008,6,10,1972,5,910,2.0,642.0,642.0,5,1062,2.0,794.0,794.0
0.012,6,10,1989,5,910,2.0,642.0,642.0,5,1079,2.0,811.0,811.0
0.006,6,10,1547,5,764,1.0,496.0,496.0,5,783,1.0,515.0,515.0
0.085,6,10,1506,5,395,18.0,127.0,127.0,5,1111,17.0,843.0,843.0
1786.81,6,710,724587,230,86221,7802.0,2536.0,989.0,480,638366,3730.0,4206.0,1533.0
0.14,6,10,1506,5,395,33.0,127.0,127.0,5,1111,30.0,843.0,843.0
0.014,6,10,1983,5,910,3.0,642.0,642.0,5,1073,3.0,805.0,805.0
0.004,6,10,2006,5,927,1.0,659.0,659.0,5,1079,1.0,811.0,811.0
0.093,6,10,1506,5,395,20.0,127.0,127.0,5,1111,21.0,843.0,843.0
0.005,6,14,3799,7,509,0.0,137.0,137.0,7,3290,0.0,1448.0,972.0
0.005,17,2,222,1,65,0.0,37.0,37.0,1,157,0.0,129.0,129.0
0.006,6,10,1643,5,860,1.0,592.0,592.0,5,783,1.0,515.0,515.0
0.019,6,10,1983,5,910,4.0,642.0,642.0,5,1073,4.0,805.0,805.0
0.004,17,4,284,2,120,0.0,32.0,32.0,2,164,1.0,60.0,54.0
0.005,6,14,3742,8,504,0.0,80.0,80.0,6,3238,0.0,1470.0,1459.0
0.01,6,10,1972,5,910,2.0,642.0,642.0,5,1062,2.0,794.0,794.0
0.004,6,10,1990,5,928,1.0,660.0,660.0,5,1062,1.0,794.0,794.0
0.072,17,2,148,1,60,0.0,32.0,32.0,1,88,0.0,60.0,60.0
0.173,6,3,453,2,321,173.0,241.0,241.0,1,132,0.0,92.0,92.0
0.001,17,2,136,1,60,0.0,32.0,32.0,1,76,0.0,48.0,48.0
0.009,6,10,1983,5,910,2.0,642.0,642.0,5,1073,2.0,805.0,805.0
0.005,6,10,2000,5,927,1.0,659.0,659.0,5,1073,1.0,805.0,805.0
177.072,17,80,11360,40,2666,4540.0,44.0,38.0,40,8694,4540.0,239.0,189.0
0.014,6,10,1990,5,911,3.0,643.0,643.0,5,1079,3.0,811.0,811.0
0.009,6,12,1926,6,1189,1.0,659.0,434.0,6,737,1.0,417.0,417.0
0.042,17,4,420,2,122,0.0,33.0,33.0,2,298,38.0,145.0,121.0
0.122,6,10,1506,5,395,28.0,127.0,127.0,5,1111,23.0,843.0,843.0
0.007,6,10,1547,5,764,1.0,496.0,496.0,5,783,1.0,515.0,515.0
0.017,6,10,1990,5,911,4.0,643.0,643.0,5,1079,4.0,811.0,811.0
0.001,17,2,180,1,66,0.0,38.0,38.0,1,114,0.0,86.0,86.0
0.005,6,10,1774,5,923,1.0,655.0,655.0,5,851,1.0,583.0,583.0
0.01,6,10,1989,5,910,2.0,642.0,642.0,5,1079,2.0,811.0,811.0
0.04,17,2,156,1,64,0.0,36.0,36.0,1,92,0.0,64.0,64.0
0.003,17,4,284,2,120,0.0,32.0,32.0,2,164,0.0,60.0,54.0
0.009,6,10,1983,5,910,2.0,642.0,642.0,5,1073,2.0,805.0,805.0
0.009,6,10,1989,5,910,2.0,642.0,642.0,5,1079,2.0,811.0,811.0
0.041,6,10,1972,5,910,10.0,642.0,642.0,5,1062,10.0,794.0,794.0
0.012,6,10,1989,5,910,3.0,642.0,642.0,5,1079,3.0,811.0,811.0
0.011,6,10,1762,5,911,2.0,643.0,643.0,5,851,2.0,583.0,583.0
0.016,6,10,1990,5,911,3.0,643.0,643.0,5,1079,4.0,811.0,811.0
0.004,6,10,2006,5,927,1.0,659.0,659.0,5,1079,1.0,811.0,811.0
0.017,6,10,1972,5,910,4.0,642.0,642.0,5,1062,4.0,794.0,794.0
40.08,17,10,676,5,460,10018.0,104.0,64.0,5,216,10019.0,20.0,15.0
0.017,6,10,1989,5,910,4.0,642.0,642.0,5,1079,4.0,811.0,811.0
281.757,6,23,6075,10,1186,31305.0,267.0,156.0,13,4889,23479.0,1400.0,873.0
0.037,17,2,136,1,60,0.0,32.0,32.0,1,76,0.0,48.0,48.0
0.006,17,2,154,1,69,0.0,41.0,41.0,1,85,0.0,57.0,57.0
0.007,17,2,148,1,60,0.0,32.0,32.0,1,88,0.0,60.0,60.0
0.049,17,2,136,1,60,0.0,32.0,32.0,1,76,0.0,48.0,48.0
0.008,6,12,1926,6,1189,1.0,659.0,434.0,6,737,1.0,417.0,417.0
0.004,17,4,284,2,120,1.0,32.0,32.0,2,164,0.0,60.0,54.0
0.004,17,2,136,1,60,0.0,32.0,32.0,1,76,0.0,48.0,48.0
0.004,6,10,2000,5,927,1.0,659.0,659.0,5,1073,1.0,805.0,805.0
240.337,6,36,9935,19,1954,13351.0,571.0,189.0,17,7981,15020.0,1402.0,645.0
0.077,6,10,1506,5,395,17.0,127.0,127.0,5,1111,18.0,843.0,843.0
15.077,17,15,9239,8,6902,2149.0,1350.0,834.0,7,2337,2508.0,1350.0,305.0
240.094,6,16,4481,9,963,30011.0,238.0,166.0,7,3518,40015.0,1402.0,786.0
1.138,6,11,1566,6,455,224.0,127.0,127.0,5,1111,25.0,843.0,843.0
10.739,17,28,4423,14,1995,817.0,270.0,114.0,14,2428,817.0,587.0,145.0
0.01,6,10,2006,5,927,2.0,659.0,659.0,5,1079,2.0,811.0,811.0
15.075,17,15,9238,8,6902,2149.0,1350.0,834.0,7,2336,2507.0,1350.0,305.0
0.127,17,2,136,1,60,0.0,32.0,32.0,1,76,0.0,48.0,48.0
0.005,6,10,1643,5,860,1.0,592.0,592.0,5,783,1.0,515.0,515.0
0.004,6,10,1989,5,927,1.0,659.0,659.0,5,1062,1.0,794.0,794.0
0.078,6,10,1506,5,395,18.0,127.0,127.0,5,1111,18.0,843.0,843.0
0.005,6,13,3690,7,452,0.0,80.0,80.0,6,3238,1.0,1470.0,1459.0
0.04,17,2,148,1,60,0.0,32.0,32.0,1,88,0.0,60.0,60.0
0.083,6,10,1506,5,395,18.0,127.0,127.0,5,1111,17.0,843.0,843.0
0.006,6,10,1547,5,764,1.0,496.0,496.0,5,783,1.0,515.0,515.0
0.013,6,10,1989,5,910,3.0,642.0,642.0,5,1079,3.0,811.0,811.0
0.006,6,10,1547,5,764,1.0,496.0,496.0,5,783,1.0,515.0,515.0
0.005,6,10,1854,5,889,1.0,621.0,621.0,5,965,1.0,697.0,697.0
0.01,6,10,1983,5,910,2.0,642.0,642.0,5,1073,2.0,805.0,805.0
0.001,17,2,180,1,66,0.0,38.0,38.0,1,114,0.0,86.0,86.0
0.016,6,10,1762,5,911,3.0,643.0,643.0,5,851,3.0,583.0,583.0
0.005,6,10,2007,5,928,1.0,660.0,660.0,5,1079,1.0,811.0,811.0
308.321,17,20,1124,10,716,34251.0,48.0,43.0,10,408,34251.0,20.0,12.0
0.035,17,2,152,1,76,0.0,48.0,48.0,1,76,0.0,48.0,48.0
0.005,6,13,3690,7,452,0.0,80.0,80.0,6,3238,1.0,1470.0,1459.0
0.138,17,2,152,1,76,0.0,48.0,48.0,1,76,0.0,48.0,48.0
0.004,17,2,186,1,61,0.0,33.0,33.0,1,125,0.0,97.0,97.0
0.001,17,2,180,1,66,0.0,38.0,38.0,1,114,0.0,86.0,86.0
0.082,6,10,1506,5,395,19.0,127.0,127.0,5,1111,18.0,843.0,843.0
0.006,17,2,136,1,60,0.0,32.0,32.0,1,76,0.0,48.0,48.0
0.005,6,10,2006,5,927,1.0,659.0,659.0,5,1079,1.0,811.0,811.0
0.052,6,10,1983,5,910,13.0,642.0,642.0,5,1073,12.0,805.0,805.0
0.062,17,2,148,1,60,0.0,32.0,32.0,1,88,0.0,60.0,60.0
1772.438,6,105,6270,60,3525,30040.0,27.0,27.0,45,2745,40281.0,27.0,27.0
0.005,6,10,1989,5,927,1.0,659.0,659.0,5,1062,1.0,794.0,794.0
40.066,17,10,676,5,460,10013.0,104.0,64.0,5,216,10015.0,20.0,15.0
0.014,6,10,1989,5,910,3.0,642.0,642.0,5,1079,3.0,811.0,811.0
0.013,6,10,1990,5,911,3.0,643.0,643.0,5,1079,3.0,811.0,811.0
0.005,17,2,136,1,60,0.0,32.0,32.0,1,76,0.0,48.0,48.0
0.045,6,10,1990,5,911,11.0,643.0,643.0,5,1079,11.0,811.0,811.0
300.326,6,25,7291,14,1305,23101.0,217.0,142.0,11,5986,30032.0,1679.0,903.0
0.006,17,2,230,1,68,0.0,40.0,40.0,1,162,0.0,134.0,134.0
0.004,6,10,1774,5,923,1.0,655.0,655.0,5,851,1.0,583.0,583.0
0.004,17,2,136,1,60,0.0,32.0,32.0,1,76,0.0,48.0,48.0
0.326,17,49,28289,27,24822,12.0,1350.0,891.0,22,3467,12.0,1350.0,129.0
0.007,17,2,179,1,71,0.0,43.0,43.0,1,108,0.0,80.0,80.0
0.004,6,10,2007,5,928,1.0,660.0,660.0,5,1079,1.0,811.0,811.0
0.003,17,4,284,2,120,0.0,32.0,32.0,2,164,0.0,60.0,54.0
0.005,17,2,222,1,65,0.0,37.0,37.0,1,157,0.0,129.0,129.0
0.005,6,10,2006,5,927,1.0,659.0,659.0,5,1079,1.0,811.0,811.0
0.001,17,2,174,1,72,0.0,44.0,44.0,1,102,0.0,74.0,74.0
0.004,17,4,284,2,120,0.0,32.0,32.0,2,164,0.0,60.0,54.0
0.005,6,10,2000,5,927,1.0,659.0,659.0,5,1073,1.0,805.0,805.0
0.007,17,2,179,1,71,0.0,43.0,43.0,1,108,0.0,80.0,80.0
0.005,6,10,2006,5,927,1.0,659.0,659.0,5,1079,1.0,811.0,811.0
11.274,17,28,4418,14,1994,854.0,269.0,114.0,14,2424,854.0,587.0,145.0
0.005,6,10,2000,5,927,1.0,659.0,659.0,5,1073,1.0,805.0,805.0
66.538,6,28,17598,15,9603,4752.0,2804.0,1469.0,13,7995,5530.0,2428.0,1044.0
40.045,17,10,676,5,460,10010.0,104.0,64.0,5,216,10009.0,20.0,15.0
0.09,6,10,1506,5,395,18.0,127.0,127.0,5,1111,19.0,843.0,843.0
0.014,6,10,1631,5,848,3.0,580.0,580.0,5,783,3.0,515.0,515.0
11.0,17,28,4395,14,2312,837.0,587.0,137.0,14,2083,837.0,270.0,120.0
0.01,6,10,1677,5,827,2.0,559.0,559.0,5,850,2.0,582.0,582.0
0.073,6,10,1506,5,395,15.0,127.0,127.0,5,1111,16.0,843.0,843.0
0.006,6,10,1854,5,889,1.0,621.0,621.0,5,965,1.0,697.0,697.0
0.018,6,10,1990,5,911,4.0,643.0,643.0,5,1079,4.0,811.0,811.0
15.219,17,18,8603,9,6289,1898.0,1350.0,670.0,9,2314,1898.0,1350.0,229.0
0.006,6,10,1547,5,764,1.0,496.0,496.0,5,783,1.0,515.0,515.0
0.077,6,10,1506,5,395,17.0,127.0,127.0,5,1111,17.0,843.0,843.0
0.093,6,10,1506,5,395,21.0,127.0,127.0,5,1111,22.0,843.0,843.0
0.041,17,2,136,1,60,0.0,32.0,32.0,1,76,0.0,48.0,48.0
0.125,6,10,1506,5,395,29.0,127.0,127.0,5,1111,27.0,843.0,843.0
0.108,6,10,1506,5,395,25.0,127.0,127.0,5,1111,24.0,843.0,843.0
0.004,6,14,3742,7,452,0.0,80.0,80.0,7,3290,0.0,1448.0,972.0
0.103,6,10,1506,5,395,24.0,127.0,127.0,5,1111,24.0,843.0,843.0
0.08,17,8,3613,4,1874,26.0,1350.0,440.0,4,1739,10.0,1350.0,406.0
0.108,6,10,1506,5,395,24.0,127.0,127.0,5,1111,23.0,843.0,843.0
0.008,6,10,1989,5,910,1.0,642.0,642.0,5,1079,2.0,811.0,811.0
0.005,6,10,1643,5,860,1.0,592.0,592.0,5,783,1.0,515.0,515.0
0.005,17,2,169,1,62,0.0,34.0,34.0,1,107,0.0,79.0,79.0
0.005,17,2,179,1,71,0.0,43.0,43.0,1,108,0.0,80.0,80.0
0.573,6,30,10283,15,8942,40.0,2883.0,1166.0,15,1341,40.0,255.0,93.0
0.004,6,14,3742,8,504,0.0,80.0,80.0,6,3238,0.0,1470.0,1459.0
0.007,17,2,136,1,60,0.0,32.0,32.0,1,76,0.0,48.0,48.0
0.004,6,10,1774,5,923,1.0,655.0,655.0,5,851,1.0,583.0,583.0
0.019,6,10,1989,5,910,4.0,642.0,642.0,5,1079,4.0,811.0,811.0
0.038,17,2,182,1,65,0.0,37.0,37.0,1,117,0.0,89.0,89.0
0.001,17,2,136,1,60,0.0,32.0,32.0,1,76,0.0,48.0,48.0
0.013,6,10,1990,5,911,3.0,643.0,643.0,5,1079,3.0,811.0,811.0
0.004,6,10,2007,5,928,1.0,660.0,660.0,5,1079,1.0,811.0,811.0
0.015,6,10,1972,5,910,3.0,642.0,642.0,5,1062,3.0,794.0,794.0
0.008,6,10,1989,5,910,2.0,642.0,642.0,5,1079,1.0,811.0,811.0
0.005,6,10,1779,5,928,1.0,660.0,660.0,5,851,1.0,583.0,583.0
0.008,6,10,1989,5,910,2.0,642.0,642.0,5,1079,2.0,811.0,811.0
40.058,17,10,676,5,460,10013.0,104.0,64.0,5,216,10013.0,20.0,15.0
0.005,6,13,3747,7,509,0.0,137.0,137.0,6,3238,0.0,1470.0,1459.0
0.009,6,10,1972,5,910,2.0,642.0,642.0,5,1062,2.0,794.0,794.0
0.004,6,10,2006,5,927,1.0,659.0,659.0,5,1079,1.0,811.0,811.0
0.319,17,4,352,2,130,211.0,37.0,37.0,2,222,211.0,89.0,83.0
0.132,6,10,1506,5,395,28.0,127.0,127.0,5,1111,28.0,843.0,843.0
0.279,17,4,352,2,130,240.0,37.0,37.0,2,222,144.0,89.0,83.0
0.005,6,10,1689,5,839,1.0,571.0,571.0,5,850,1.0,582.0,582.0
0.013,6,10,2006,5,927,3.0,659.0,659.0,5,1079,3.0,811.0,811.0
0.065,6,10,1506,5,395,15.0,127.0,127.0,5,1111,14.0,843.0,843.0
0.001,17,2,174,1,72,0.0,44.0,44.0,1,102,0.0,74.0,74.0
0.074,6,10,1506,5,395,16.0,127.0,127.0,5,1111,16.0,843.0,843.0
0.091,6,10,1506,5,395,20.0,127.0,127.0,5,1111,18.0,843.0,843.0
0.008,6,10,1989,5,910,1.0,642.0,642.0,5,1079,1.0,811.0,811.0
300.17,6,41,12533,22,6975,14285.0,2720.0,866.0,19,5558,16666.0,2667.0,435.0
0.006,6,10,1779,5,928,1.0,660.0,660.0,5,851,1.0,583.0,583.0
10.911,17,28,4420,14,1995,831.0,270.0,114.0,14,2425,831.0,588.0,145.0
0.006,6,10,1547,5,764,1.0,496.0,496.0,5,783,1.0,515.0,515.0
308.585,17,20,1124,10,716,34273.0,48.0,43.0,10,408,34273.0,20.0,12.0
0.006,6,10,1689,5,839,1.0,571.0,571.0,5,850,1.0,582.0,582.0
0.041,17,2,148,1,60,0.0,32.0,32.0,1,88,0.0,60.0,60.0
0.009,6,10,1989,5,910,2.0,642.0,642.0,5,1079,2.0,811.0,811.0
0.083,6,10,1506,5,395,16.0,127.0,127.0,5,1111,18.0,843.0,843.0
0.005,6,10,2006,5,927,1.0,659.0,659.0,5,1079,1.0,811.0,811.0
0.006,6,10,1643,5,860,1.0,592.0,592.0,5,783,1.0,515.0,515.0
0.005,17,2,230,1,68,0.0,40.0,40.0,1,162,0.0,134.0,134.0
0.001,17,2,136,1,60,0.0,32.0,32.0,1,76,0.0,48.0,48.0
0.005,17,2,164,1,74,0.0,46.0,46.0,1,90,0.0,62.0,62.0
0.776,6,23,5112,12,1290,62.0,325.0,133.0,11,3822,66.0,1414.0,563.0
0.005,6,10,2006,5,927,1.0,659.0,659.0,5,1079,1.0,811.0,811.0
0.086,17,4,420,2,122,0.0,33.0,33.0,2,298,82.0,145.0,121.0
0.134,17,2,80,1,32,0.0,4.0,4.0,1,48,0.0,20.0,20.0
0.005,17,2,214,1,75,0.0,47.0,47.0,1,139,0.0,111.0,111.0
0.004,6,10,1989,5,927,1.0,659.0,659.0,5,1062,1.0,794.0,794.0
0.007,6,13,3735,7,497,1.0,125.0,125.0,6,3238,1.0,1470.0,1459.0
0.017,6,10,1989,5,910,4.0,642.0,642.0,5,1079,4.0,811.0,811.0
0.068,17,8,3613,4,1874,22.0,1350.0,440.0,4,1739,11.0,1350.0,406.0
0.005,6,10,1989,5,927,1.0,659.0,659.0,5,1062,1.0,794.0,794.0
0.005,17,2,193,1,71,0.0,43.0,43.0,1,122,0.0,94.0,94.0
0.004,6,10,2006,5,927,1.0,659.0,659.0,5,1079,1.0,811.0,811.0
0.006,6,10,2006,5,927,1.0,659.0,659.0,5,1079,1.0,811.0,811.0
0.006,6,10,1547,5,764,1.0,496.0,496.0,5,783,1.0,515.0,515.0
361.859,6,19,1689,15,978,25847.0,190.0,190.0,4,711,80012.0,495.0,495.0
0.105,6,10,1506,5,395,25.0,127.0,127.0,5,1111,24.0,843.0,843.0
0.127,17,2,170,1,65,0.0,37.0,37.0,1,105,0.0,77.0,77.0
0.006,6,10,1774,5,923,1.0,655.0,655.0,5,851,1.0,583.0,583.0
0.004,6,10,1989,5,927,1.0,659.0,659.0,5,1062,1.0,794.0,794.0
0.017,6,10,1989,5,910,4.0,642.0,642.0,5,1079,4.0,811.0,811.0
0.103,6,10,1506,5,395,24.0,127.0,127.0,5,1111,20.0,843.0,843.0
0.078,6,10,1506,5,395,18.0,127.0,127.0,5,1111,17.0,843.0,843.0
246.944,6,362,378132,152,23166,1635.0,2899.0,953.0,210,354966,1181.0,4206.0,1869.0
0.037,17,2,170,1,65,0.0,37.0,37.0,1,105,0.0,77.0,77.0
0.001,17,2,180,1,66,0.0,38.0,38.0,1,114,0.0,86.0,86.0
0.013,6,10,1989,5,910,3.0,642.0,642.0,5,1079,3.0,811.0,811.0
0.003,17,4,284,2,120,0.0,32.0,32.0,2,164,0.0,60.0,54.0
0.003,17,2,148,1,60,0.0,32.0,32.0,1,88,0.0,60.0,60.0
0.013,17,2,152,1,56,0.0,28.0,28.0,1,96,0.0,68.0,68.0
0.167,17,2,152,1,76,0.0,48.0,48.0,1,76,0.0,48.0,48.0
40.074,17,10,676,5,460,10017.0,104.0,64.0,5,216,10017.0,20.0,15.0
0.06,6,10,1506,5,395,11.0,127.0,127.0,5,1111,14.0,843.0,843.0
0.001,17,2,180,1,66,0.0,38.0,38.0,1,114,0.0,86.0,86.0
0.019,6,10,1762,5,911,4.0,643.0,643.0,5,851,4.0,583.0,583.0
0.005,6,10,1989,5,927,1.0,659.0,659.0,5,1062,1.0,794.0,794.0
0.067,6,10,1506,5,395,16.0,127.0,127.0,5,1111,16.0,843.0,843.0
0.011,6,10,1989,5,910,2.0,642.0,642.0,5,1079,2.0,811.0,811.0
0.004,17,2,148,1,60,0.0,32.0,32.0,1,88,0.0,60.0,60.0
0.009,6,10,1677,5,827,2.0,559.0,559.0,5,850,2.0,582.0,582.0
0.013,6,13,3735,7,497,2.0,125.0,125.0,6,3238,2.0,1470.0,1459.0
0.012,6,10,1990,5,911,3.0,643.0,643.0,5,1079,3.0,811.0,811.0
0.004,17,2,136,1,60,0.0,32.0,32.0,1,76,0.0,48.0,48.0
241.158,6,375,346654,191,21459,1269.0,2736.0,886.0,184,325195,1317.0,2804.0,1813.0
0.005,6,10,2007,5,928,1.0,660.0,660.0,5,1079,1.0,811.0,811.0
0.01,6,10,1983,5,910,2.0,642.0,642.0,5,1073,2.0,805.0,805.0
0.001,17,2,180,1,66,0.0,38.0,38.0,1,114,0.0,86.0,86.0
240.092,6,16,4482,9,963,30011.0,238.0,166.0,7,3519,40014.0,1402.0,786.0
0.005,6,10,2006,5,927,1.0,659.0,659.0,5,1079,1.0,811.0,811.0
0.003,17,2,148,1,60,0.0,32.0,32.0,1,88,0.0,60.0,60.0
0.014,6,10,1990,5,911,3.0,643.0,643.0,5,1079,3.0,811.0,811.0
0.04,17,2,348,1,61,0.0,33.0,33.0,1,287,0.0,259.0,259.0
0.005,6,10,1774,5,923,1.0,655.0,655.0,5,851,1.0,583.0,583.0
0.005,6,10,2000,5,927,1.0,659.0,659.0,5,1073,1.0,805.0,805.0
300.324,6,16,2170,9,684,37519.0,146.0,146.0,7,1486,50025.0,419.0,398.0
0.099,6,10,1506,5,395,23.0,127.0,127.0,5,1111,22.0,843.0,843.0
0.012,6,10,1989,5,910,3.0,642.0,642.0,5,1079,3.0,811.0,811.0
0.004,6,10,2000,5,927,1.0,659.0,659.0,5,1073,1.0,805.0,805.0
0.095,6,10,1506,5,395,18.0,127.0,127.0,5,1111,20.0,843.0,843.0
0.007,17,2,194,1,59,0.0,31.0,31.0,1,135,0.0,107.0,107.0
0.014,6,10,1983,5,910,3.0,642.0,642.0,5,1073,3.0,805.0,805.0
0.1,6,10,1506,5,395,20.0,127.0,127.0,5,1111,24.0,843.0,843.0
0.005,6,10,1779,5,928,1.0,660.0,660.0,5,851,1.0,583.0,583.0
240.013,6,9,787,5,488,60003.0,232.0,232.0,4,299,80003.0,83.0,83.0
300.024,6,12,1782,7,1348,50004.0,494.0,494.0,5,434,75005.0,83.0,83.0
0.015,6,10,1989,5,910,3.0,642.0,642.0,5,1079,3.0,811.0,811.0
0.006,6,10,1689,5,839,1.0,571.0,571.0,5,850,1.0,582.0,582.0
0.005,6,10,2006,5,927,1.0,659.0,659.0,5,1079,1.0,811.0,811.0
285.244,6,30,7551,16,1433,19016.0,517.0,290.0,14,6118,21941.0,2379.0,1078.0
0.003,17,2,185,1,73,0.0,45.0,45.0,1,112,0.0,84.0,84.0
0.071,17,2,148,1,60,0.0,32.0,32.0,1,88,0.0,60.0,60.0
0.006,6,10,1689,5,839,1.0,571.0,571.0,5,850,1.0,582.0,582.0
240.648,6,35,8922,18,2070,14153.0,691.0,225.0,17,6852,15038.0,1402.0,597.0
0.005,6,10,1702,5,863,1.0,595.0,595.0,5,839,1.0,571.0,571.0
0.193,17,15,8471,7,6034,32.0,1350.0,834.0,8,2437,23.0,1350.0,276.0
0.005,6,10,2006,5,927,1.0,659.0,659.0,5,1079,1.0,811.0,811.0
0.01,6,10,1972,5,910,2.0,642.0,642.0,5,1062,2.0,794.0,794.0
0.013,6,10,1989,5,910,3.0,642.0,642.0,5,1079,3.0,811.0,811.0
0.08,6,10,1506,5,395,17.0,127.0,127.0,5,1111,19.0,843.0,843.0
0.005,6,10,2000,5,927,1.0,659.0,659.0,5,1073,1.0,805.0,805.0
0.019,6,10,1983,5,910,4.0,642.0,642.0,5,1073,4.0,805.0,805.0
0.041,17,4,352,2,130,0.0,37.0,37.0,2,222,1.0,89.0,83.0
0.006,6,10,1547,5,764,1.0,496.0,496.0,5,783,1.0,515.0,515.0
0.088,6,10,1506,5,395,20.0,127.0,127.0,5,1111,21.0,843.0,843.0
308.536,17,20,1124,10,716,34275.0,48.0,43.0,10,408,34275.0,20.0,12.0
0.005,6,10,1689,5,839,1.0,571.0,571.0,5,850,1.0,582.0,582.0
0.005,6,10,1643,5,860,1.0,592.0,592.0,5,783,1.0,515.0,515.0
0.015,6,10,1990,5,911,3.0,643.0,643.0,5,1079,3.0,811.0,811.0
40.064,17,10,676,5,460,10015.0,104.0,64.0,5,216,10015.0,20.0,15.0
0.007,6,10,1689,5,839,1.0,571.0,571.0,5,850,1.0,582.0,582.0
0.237,6,16,2669,8,1395,33.0,533.0,323.0,8,1274,22.0,529.0,212.0
0.01,6,10,1990,5,911,2.0,643.0,643.0,5,1079,2.0,811.0,811.0
0.015,6,10,1631,5,848,3.0,580.0,580.0,5,783,3.0,515.0,515.0
0.007,6,10,1547,5,764,1.0,496.0,496.0,5,783,1.0,515.0,515.0
0.005,17,4,495,2,132,2.0,38.0,38.0,2,363,1.0,176.0,153.0
0.086,6,10,1506,5,395,16.0,127.0,127.0,5,1111,20.0,843.0,843.0
0.125,6,10,1506,5,395,29.0,127.0,127.0,5,1111,21.0,843.0,843.0
0.019,6,10,1983,5,910,4.0,642.0,642.0,5,1073,4.0,805.0,805.0
0.005,6,11,2058,6,979,0.0,659.0,659.0,5,1079,1.0,811.0,811.0
0.04,17,2,170,1,65,0.0,37.0,37.0,1,105,0.0,77.0,77.0
0.011,6,14,3787,7,497,1.0,125.0,125.0,7,3290,1.0,1448.0,972.0
0.08,6,10,1506,5,395,16.0,127.0,127.0,5,1111,19.0,843.0,843.0
371.067,6,22,2313,16,867,24737.0,195.0,195.0,6,1446,4684.0,419.0,398.0
0.013,6,10,1972,5,910,3.0,642.0,642.0,5,1062,3.0,794.0,794.0
0.004,6,10,2007,5,928,1.0,660.0,660.0,5,1079,1.0,811.0,811.0
0.012,6,10,1990,5,911,2.0,643.0,643.0,5,1079,2.0,811.0,811.0
0.005,17,2,144,1,64,0.0,36.0,36.0,1,80,0.0,52.0,52.0
0.432,6,24,8232,12,1699,39.0,748.0,263.0,12,6533,39.0,2333.0,983.0
309.052,17,20,1124,10,716,34324.0,48.0,43.0,10,408,34324.0,20.0,12.0
0.028,17,2,148,1,60,0.0,32.0,32.0,1,88,0.0,60.0,60.0
0.222,6,16,2670,8,1396,31.0,533.0,324.0,8,1274,20.0,529.0,212.0
0.006,6,10,1547,5,764,1.0,496.0,496.0,5,783,1.0,515.0,515.0
0.093,6,10,1506,5,395,20.0,127.0,127.0,5,1111,19.0,843.0,843.0
0.066,17,8,3613,4,1874,22.0,1350.0,440.0,4,1739,11.0,1350.0,406.0
0.005,6,10,2006,5,927,1.0,659.0,659.0,5,1079,1.0,811.0,811.0
0.004,6,10,1779,5,928,1.0,660.0,660.0,5,851,1.0,583.0,583.0
0.011,6,10,1989,5,910,2.0,642.0,642.0,5,1079,2.0,811.0,811.0
0.001,17,2,180,1,66,0.0,38.0,38.0,1,114,0.0,86.0,86.0
0.073,6,10,1506,5,395,16.0,127.0,127.0,5,1111,16.0,843.0,843.0
0.005,6,10,1643,5,860,1.0,592.0,592.0,5,783,1.0,515.0,515.0
0.004,6,10,2000,5,927,1.0,659.0,659.0,5,1073,1.0,805.0,805.0
308.603,17,20,1124,10,716,34275.0,48.0,43.0,10,408,34275.0,20.0,12.0
177.514,17,86,12251,43,2868,4226.0,44.0,38.0,43,9383,4226.0,239.0,190.0
0.086,6,10,1506,5,395,19.0,127.0,127.0,5,1111,18.0,843.0,843.0
0.004,17,2,136,1,60,0.0,32.0,32.0,1,76,0.0,48.0,48.0
300.213,6,27,7436,16,1409,20014.0,217.0,142.0,11,6027,24020.0,1679.0,778.0
15.186,17,22,14930,11,9724,1515.0,1350.0,856.0,11,5206,1515.0,1350.0,445.0
0.004,6,10,2007,5,928,1.0,660.0,660.0,5,1079,1.0,811.0,811.0
0.019,6,10,1990,5,911,4.0,643.0,643.0,5,1079,4.0,811.0,811.0
0.005,6,10,2006,5,927,1.0,659.0,659.0,5,1079,1.0,811.0,811.0
15.076,17,11,4407,5,2354,3762.0,1350.0,442.0,6,2053,3008.0,1350.0,314.0
0.004,17,2,166,1,75,0.0,47.0,47.0,1,91,0.0,63.0,63.0
0.013,6,10,1989,5,910,3.0,642.0,642.0,5,1079,3.0,811.0,811.0
0.007,6,10,1547,5,764,1.0,496.0,496.0,5,783,1.0,515.0,515.0
0.006,6,10,1643,5,860,1.0,592.0,592.0,5,783,1.0,515.0,515.0
1747.219,6,301,97334,185,86210,9495.0,2001.0,690.0,116,11124,15193.0,452.0,70.0
0.013,6,10,1762,5,911,3.0,643.0,643.0,5,851,3.0,583.0,583.0
60.953,6,29,17669,18,9782,3585.0,1402.0,983.0,11,7887,6081.0,2310.0,1217.0
240.691,6,24,5208,11,941,24069.0,180.0,93.0,13,4267,20057.0,1593.0,447.0
0.127,6,10,1506,5,395,30.0,127.0,127.0,5,1111,26.0,843.0,843.0
0.146,6,10,1506,5,395,34.0,127.0,127.0,5,1111,34.0,843.0,843.0
68.392,6,36,9704,18,4186,518.0,1753.0,858.0,18,5518,4013.0,2667.0,435.0
40.064,17,10,676,5,460,10013.0,104.0,64.0,5,216,10015.0,20.0,15.0
0.006,6,10,1854,5,889,1.0,621.0,621.0,5,965,1.0,697.0,697.0
0.038,17,2,148,1,60,0.0,32.0,32.0,1,88,0.0,60.0,60.0
365.947,6,22,2313,16,867,24396.0,195.0,195.0,6,1446,4636.0,419.0,398.0
309.558,17,20,1124,10,716,34381.0,48.0,43.0,10,408,34381.0,20.0,12.0
0.012,6,10,1990,5,911,3.0,643.0,643.0,5,1079,2.0,811.0,811.0
0.004,6,10,1774,5,923,1.0,655.0,655.0,5,851,1.0,583.0,583.0
0.176,6,10,1506,5,395,20.0,127.0,127.0,5,1111,37.0,843.0,843.0
0.007,17,2,194,1,59,0.0,31.0,31.0,1,135,0.0,107.0,107.0
15.08,17,14,9190,8,6902,2149.0,1350.0,834.0,6,2288,3009.0,1350.0,353.0
0.0,17,2,132,1,58,0.0,30.0,30.0,1,74,0.0,46.0,46.0
0.116,6,10,1506,5,395,26.0,127.0,127.0,5,1111,26.0,843.0,843.0
0.012,6,10,1989,5,910,3.0,642.0,642.0,5,1079,3.0,811.0,811.0
0.005,6,10,1689,5,839,1.0,571.0,571.0,5,850,1.0,582.0,582.0
1778.355,17,144,45504,72,22752,25047.0,288.0,288.0,72,22752,25047.0,288.0,288.0
0.016,6,10,1631,5,848,4.0,580.0,580.0,5,783,3.0,515.0,515.0
0.095,6,10,1506,5,395,21.0,127.0,127.0,5,1111,18.0,843.0,843.0
0.004,17,2,146,1,65,0.0,37.0,37.0,1,81,0.0,53.0,53.0
0.023,6,14,3787,7,497,3.0,125.0,125.0,7,3290,3.0,1448.0,972.0
0.097,6,10,1506,5,395,20.0,127.0,127.0,5,1111,21.0,843.0,843.0
0.004,6,10,2006,5,927,1.0,659.0,659.0,5,1079,1.0,811.0,811.0
0.005,17,2,154,1,69,0.0,41.0,41.0,1,85,0.0,57.0,57.0
10.843,17,28,4418,14,1994,825.0,269.0,114.0,14,2424,825.0,587.0,145.0
0.115,6,10,1506,5,395,24.0,127.0,127.0,5,1111,25.0,843.0,843.0
0.001,17,2,166,1,75,0.0,47.0,47.0,1,91,0.0,63.0,63.0
0.24,17,16,8821,8,6213,34.0,1350.0,748.0,8,2608,25.0,1350.0,298.0
40.055,17,10,676,5,460,10012.0,104.0,64.0,5,216,10013.0,20.0,15.0
0.005,6,10,1689,5,839,1.0,571.0,571.0,5,850,1.0,582.0,582.0
0.023,6,10,1989,5,910,5.0,642.0,642.0,5,1079,5.0,811.0,811.0
0.016,6,10,1990,5,911,3.0,643.0,643.0,5,1079,3.0,811.0,811.0
0.006,6,10,1547,5,764,1.0,496.0,496.0,5,783,1.0,515.0,515.0
0.005,6,10,2000,5,927,1.0,659.0,659.0,5,1073,1.0,805.0,805.0
0.005,17,2,164,1,74,0.0,46.0,46.0,1,90,0.0,62.0,62.0
0.007,6,13,3690,7,452,1.0,80.0,80.0,6,3238,1.0,1470.0,1459.0
0.005,6,10,1689,5,839,1.0,571.0,571.0,5,850,1.0,582.0,582.0
240.053,6,9,799,5,500,60013.0,232.0,232.0,4,299,80004.0,83.0,83.0
330.637,6,21,2768,7,1854,10036.0,494.0,494.0,14,914,25433.0,83.0,83.0
0.008,6,10,1989,5,910,2.0,642.0,642.0,5,1079,2.0,811.0,811.0
0.04,17,2,152,1,76,0.0,48.0,48.0,1,76,0.0,48.0,48.0
0.005,6,10,1689,5,839,1.0,571.0,571.0,5,850,1.0,582.0,582.0
285.766,17,154,21195,77,5229,3760.0,44.0,39.0,77,15966,3760.0,239.0,179.0
0.001,17,2,180,1,66,0.0,38.0,38.0,1,114,0.0,86.0,86.0
0.011,6,10,1677,5,827,2.0,559.0,559.0,5,850,2.0,582.0,582.0
0.005,6,10,2006,5,927,1.0,659.0,659.0,5,1079,1.0,811.0,811.0
240.013,6,9,787,5,488,60003.0,232.0,232.0,4,299,80003.0,83.0,83.0
0.115,6,10,1506,5,395,23.0,127.0,127.0,5,1111,24.0,843.0,843.0
0.005,6,10,1689,5,839,1.0,571.0,571.0,5,850,1.0,582.0,582.0
0.032,17,2,164,1,74,0.0,46.0,46.0,1,90,0.0,62.0,62.0
0.129,6,10,1506,5,395,29.0,127.0,127.0,5,1111,19.0,843.0,843.0
313.054,17,16,928,8,608,44703.0,48.0,48.0,8,320,44703.0,12.0,12.0
0.074,6,10,1506,5,395,16.0,127.0,127.0,5,1111,15.0,843.0,843.0
1719.269,6,62,7176,41,4384,42981.0,1402.0,107.0,21,2792,85955.0,1111.0,85.0
0.005,6,10,1989,5,927,1.0,659.0,659.0,5,1062,1.0,794.0,794.0
0.139,6,10,1506,5,395,31.0,127.0,127.0,5,1111,30.0,843.0,843.0
0.006,6,10,1689,5,839,1.0,571.0,571.0,5,850,1.0,582.0,582.0
0.005,6,10,1854,5,889,1.0,621.0,621.0,5,965,1.0,697.0,697.0
0.003,17,2,136,1,60,0.0,32.0,32.0,1,76,0.0,48.0,48.0
0.006,6,10,1643,5,860,1.0,592.0,592.0,5,783,1.0,515.0,515.0
240.714,6,35,8922,18,2072,14157.0,693.0,225.0,17,6850,15042.0,1402.0,597.0
0.005,6,10,1854,5,889,1.0,621.0,621.0,5,965,1.0,697.0,697.0
0.123,17,2,80,1,32,0.0,4.0,4.0,1,48,0.0,20.0,20.0
0.006,17,2,179,1,71,0.0,43.0,43.0,1,108,0.0,80.0,80.0
0.09,6,10,1506,5,395,21.0,127.0,127.0,5,1111,20.0,843.0,843.0
0.005,17,2,154,1,69,0.0,41.0,41.0,1,85,0.0,57.0,57.0
0.01,6,10,1989,5,910,2.0,642.0,642.0,5,1079,2.0,811.0,811.0
0.106,6,10,1506,5,395,22.0,127.0,127.0,5,1111,19.0,843.0,843.0
0.004,6,10,2000,5,927,1.0,659.0,659.0,5,1073,1.0,805.0,805.0
0.009,6,13,3735,7,497,1.0,125.0,125.0,6,3238,1.0,1470.0,1459.0
11.587,17,32,5451,16,2667,761.0,587.0,138.0,16,2784,761.0,588.0,146.0
0.039,17,2,156,1,64,0.0,36.0,36.0,1,92,0.0,64.0,64.0
0.007,6,10,2007,5,928,1.0,660.0,660.0,5,1079,1.0,811.0,811.0
0.001,17,2,180,1,66,0.0,38.0,38.0,1,114,0.0,86.0,86.0
0.079,6,10,1506,5,395,17.0,127.0,127.0,5,1111,15.0,843.0,843.0
0.004,17,2,148,1,60,0.0,32.0,32.0,1,88,0.0,60.0,60.0
0.012,6,10,1989,5,910,3.0,642.0,642.0,5,1079,3.0,811.0,811.0
0.005,6,10,1689,5,839,1.0,571.0,571.0,5,850,1.0,582.0,582.0
0.004,6,10,1702,5,863,1.0,595.0,595.0,5,839,1.0,571.0,571.0
0.01,6,10,1631,5,848,2.0,580.0,580.0,5,783,2.0,515.0,515.0
0.005,6,10,2007,5,928,1.0,660.0,660.0,5,1079,1.0,811.0,811.0
0.005,6,13,3747,7,509,0.0,137.0,137.0,6,3238,1.0,1470.0,1459.0
0.752,6,10,2289,6,1935,150.0,1683.0,1683.0,4,354,170.0,182.0,182.0
300.585,6,34,6335,19,1409,16699.0,267.0,154.0,15,4926,611.0,1823.0,392.0
0.094,6,10,1506,5,395,22.0,127.0,127.0,5,1111,20.0,843.0,843.0
0.001,17,2,142,1,63,0.0,35.0,35.0,1,79,0.0,51.0,51.0
0.011,6,10,1631,5,848,2.0,580.0,580.0,5,783,2.0,515.0,515.0
0.005,17,2,166,1,75,0.0,47.0,47.0,1,91,0.0,63.0,63.0
0.009,6,12,1926,6,1189,1.0,659.0,434.0,6,737,1.0,417.0,417.0
0.248,17,38,20196,21,17041,12.0,1350.0,783.0,17,3155,11.0,1350.0,157.0
0.004,6,10,1779,5,928,1.0,660.0,660.0,5,851,1.0,583.0,583.0
0.014,6,10,1989,5,910,3.0,642.0,642.0,5,1079,3.0,811.0,811.0
0.008,6,10,1972,5,910,2.0,642.0,642.0,5,1062,2.0,794.0,794.0
0.101,6,10,1506,5,395,21.0,127.0,127.0,5,1111,23.0,843.0,843.0
0.082,6,10,1506,5,395,17.0,127.0,127.0,5,1111,19.0,843.0,843.0
0.009,6,10,1990,5,911,2.0,643.0,643.0,5,1079,2.0,811.0,811.0
0.131,6,10,1506,5,395,30.0,127.0,127.0,5,1111,24.0,843.0,843.0
0.005,17,2,170,1,65,0.0,37.0,37.0,1,105,0.0,77.0,77.0
0.113,6,10,1506,5,395,26.0,127.0,127.0,5,1111,26.0,843.0,843.0
0.773,6,25,5459,12,1557,64.0,325.0,152.0,13,3902,55.0,1414.0,563.0
0.093,6,10,1506,5,395,20.0,127.0,127.0,5,1111,20.0,843.0,843.0
10.923,17,28,4423,14,1995,831.0,270.0,114.0,14,2428,831.0,587.0,145.0
0.115,6,10,1506,5,395,27.0,127.0,127.0,5,1111,27.0,843.0,843.0
0.102,6,10,1506,5,395,21.0,127.0,127.0,5,1111,23.0,843.0,843.0
0.004,17,2,136,1,60,0.0,32.0,32.0,1,76,0.0,48.0,48.0
0.005,6,10,2007,5,928,1.0,660.0,660.0,5,1079,1.0,811.0,811.0
40.065,17,10,676,5,460,10015.0,104.0,64.0,5,216,10015.0,20.0,15.0
240.104,6,18,5744,10,1027,26678.0,238.0,166.0,8,4717,34299.0,1402.0,858.0
0.005,6,10,1702,5,863,1.0,595.0,595.0,5,839,1.0,571.0,571.0
0.128,6,10,1506,5,395,29.0,127.0,127.0,5,1111,28.0,843.0,843.0
0.005,6,10,2006,5,927,1.0,659.0,659.0,5,1079,1.0,811.0,811.0
0.006,17,2,144,1,64,0.0,36.0,36.0,1,80,0.0,52.0,52.0
0.001,17,2,180,1,66,0.0,38.0,38.0,1,114,0.0,86.0,86.0
0.012,6,10,1972,5,910,3.0,642.0,642.0,5,1062,2.0,794.0,794.0
0.072,6,10,1506,5,395,13.0,127.0,127.0,5,1111,15.0,843.0,843.0
0.073,6,10,1506,5,395,16.0,127.0,127.0,5,1111,15.0,843.0,843.0
1786.888,6,151,19497,90,13752,20077.0,302.0,302.0,61,5745,29781.0,83.0,83.0
0.004,6,10,2000,5,927,1.0,659.0,659.0,5,1073,1.0,805.0,805.0
0.02,6,10,1972,5,910,5.0,642.0,642.0,5,1062,4.0,794.0,794.0
0.011,6,10,1983,5,910,2.0,642.0,642.0,5,1073,2.0,805.0,805.0
0.01,6,10,1989,5,910,2.0,642.0,642.0,5,1079,2.0,811.0,811.0
0.005,6,10,2006,5,927,1.0,659.0,659.0,5,1079,1.0,811.0,811.0
240.023,6,9,787,5,488,60005.0,232.0,232.0,4,299,80006.0,83.0,83.0
0.01,6,10,1990,5,911,2.0,643.0,643.0,5,1079,2.0,811.0,811.0
240.082,6,16,4481,9,963,30010.0,238.0,166.0,7,3518,40013.0,1402.0,786.0
0.008,6,10,1990,5,911,2.0,643.0,643.0,5,1079,2.0,811.0,811.0
0.004,6,10,2006,5,927,1.0,659.0,659.0,5,1079,1.0,811.0,811.0
0.215,6,16,2777,8,1395,30.0,533.0,323.0,8,1382,19.0,529.0,239.0
0.012,6,10,1774,5,923,3.0,655.0,655.0,5,851,3.0,583.0,583.0
0.005,6,10,2006,5,927,1.0,659.0,659.0,5,1079,1.0,811.0,811.0
0.005,6,10,1779,5,928,1.0,660.0,660.0,5,851,1.0,583.0,583.0
0.004,6,10,2000,5,927,1.0,659.0,659.0,5,1073,1.0,805.0,805.0
40.081,17,10,676,5,460,10018.0,104.0,64.0,5,216,10019.0,20.0,15.0
15.144,17,20,13504,10,8344,1679.0,1350.0,806.0,10,5160,1679.0,1350.0,488.0
0.004,6,10,2007,5,928,1.0,660.0,660.0,5,1079,1.0,811.0,811.0
0.005,6,10,1779,5,928,1.0,660.0,660.0,5,851,1.0,583.0,583.0
1770.471,6,83,4368,42,2210,43181.0,26.0,26.0,41,2158,44260.0,26.0,26.0
0.09,6,10,1506,5,395,20.0,127.0,127.0,5,1111,19.0,843.0,843.0
0.006,17,2,144,1,64,0.0,36.0,36.0,1,80,0.0,52.0,52.0
0.004,17,2,136,1,60,0.0,32.0,32.0,1,76,0.0,48.0,48.0
0.004,6,10,1989,5,927,1.0,659.0,659.0,5,1062,1.0,794.0,794.0
0.006,6,10,1547,5,764,1.0,496.0,496.0,5,783,1.0,515.0,515.0
0.091,6,10,1506,5,395,20.0,127.0,127.0,5,1111,17.0,843.0,843.0
0.005,6,10,2007,5,928,1.0,660.0,660.0,5,1079,1.0,811.0,811.0
171.183,17,80,11142,40,2664,4389.0,44.0,38.0,40,8478,4389.0,239.0,183.0
0.003,17,2,136,1,60,0.0,32.0,32.0,1,76,0.0,48.0,48.0
0.016,6,10,1989,5,910,3.0,642.0,642.0,5,1079,3.0,811.0,811.0
0.012,6,10,1677,5,827,3.0,559.0,559.0,5,850,3.0,582.0,582.0
178.108,17,78,11089,39,2600,4686.0,44.0,38.0,39,8489,4686.0,239.0,189.0
0.006,6,10,1547,5,764,1.0,496.0,496.0,5,783,1.0,515.0,515.0
0.071,6,10,1506,5,395,15.0,127.0,127.0,5,1111,17.0,843.0,843.0
283.208,6,26,9320,11,1226,28320.0,267.0,156.0,15,8094,20228.0,1400.0,936.0
0.011,6,10,1989,5,910,2.0,642.0,642.0,5,1079,2.0,811.0,811.0
0.005,6,14,3742,7,452,0.0,80.0,80.0,7,3290,0.0,1448.0,972.0
0.012,6,10,1989,5,910,3.0,642.0,642.0,5,1079,3.0,811.0,811.0
0.009,6,10,1972,5,910,2.0,642.0,642.0,5,1062,2.0,794.0,794.0
240.089,6,16,4482,9,963,30011.0,238.0,166.0,7,3519,40014.0,1402.0,786.0
15.313,17,44,24813,24,19854,664.0,1350.0,799.0,20,4959,804.0,1350.0,219.0
0.085,6,10,1506,5,395,16.0,127.0,127.0,5,1111,19.0,843.0,843.0
0.005,17,2,170,1,65,0.0,37.0,37.0,1,105,0.0,77.0,77.0
0.006,6,10,1547,5,764,1.0,496.0,496.0,5,783,1.0,515.0,515.0
0.007,6,10,1990,5,911,1.0,643.0,643.0,5,1079,1.0,811.0,811.0
0.04,17,2,184,1,61,0.0,33.0,33.0,1,123,0.0,95.0,95.0
0.005,6,10,2007,5,928,1.0,660.0,660.0,5,1079,1.0,811.0,811.0
0.01,6,12,1926,6,1189,2.0,659.0,434.0,6,737,2.0,417.0,417.0
0.005,6,10,2006,5,927,1.0,659.0,659.0,5,1079,1.0,811.0,811.0
0.006,17,2,178,1,81,0.0,53.0,53.0,1,97,0.0,69.0,69.0
15.078,17,15,8385,8,6142,2150.0,1350.0,739.0,7,2243,2508.0,1350.0,292.0
40.069,17,10,676,5,460,10015.0,104.0,64.0,5,216,10016.0,20.0,15.0
0.001,17,2,180,1,66,0.0,38.0,38.0,1,114,0.0,86.0,86.0
0.014,6,10,1989,5,910,3.0,642.0,642.0,5,1079,3.0,811.0,811.0
0.01,6,12,1926,6,1189,1.0,659.0,434.0,6,737,1.0,417.0,417.0
300.091,6,19,4661,11,1102,30008.0,238.0,130.0,8,3559,42869.0,1402.0,786.0
0.006,6,12,1698,6,863,1.0,327.0,271.0,6,835,1.0,515.0,515.0
0.005,17,2,169,1,62,0.0,34.0,34.0,1,107,0.0,79.0,79.0
0.014,6,10,1989,5,910,3.0,642.0,642.0,5,1079,3.0,811.0,811.0
0.013,6,13,3735,7,497,2.0,125.0,125.0,6,3238,2.0,1470.0,1459.0
1729.207,6,60,4400,40,2740,44338.0,33.0,33.0,20,1660,91001.0,31.0,31.0
0.003,17,2,136,1,60,0.0,32.0,32.0,1,76,0.0,48.0,48.0
0.013,6,10,1989,5,910,3.0,642.0,642.0,5,1079,3.0,811.0,811.0
0.13,6,10,1506,5,395,25.0,127.0,127.0,5,1111,28.0,843.0,843.0
0.008,17,2,170,1,65,0.0,37.0,37.0,1,105,0.0,77.0,77.0
0.004,17,2,152,1,76,0.0,48.0,48.0,1,76,0.0,48.0,48.0
0.008,6,10,1677,5,827,2.0,559.0,559.0,5,850,2.0,582.0,582.0
0.124,17,4,284,2,120,0.0,32.0,32.0,2,164,120.0,60.0,54.0
0.104,6,10,1506,5,395,24.0,127.0,127.0,5,1111,24.0,843.0,843.0
0.004,6,10,1779,5,928,1.0,660.0,660.0,5,851,1.0,583.0,583.0
0.001,17,2,180,1,66,0.0,38.0,38.0,1,114,0.0,86.0,86.0
0.004,17,2,230,1,68,0.0,40.0,40.0,1,162,0.0,134.0,134.0
0.005,6,10,2000,5,927,1.0,659.0,659.0,5,1073,1.0,805.0,805.0
11.001,17,28,4369,14,2312,837.0,587.0,137.0,14,2057,837.0,268.0,118.0
40.063,17,10,676,5,460,10013.0,104.0,64.0,5,216,10015.0,20.0,15.0
15.118,17,17,9362,9,7255,1884.0,1350.0,778.0,8,2107,2153.0,1350.0,235.0
0.083,6,10,1506,5,395,18.0,127.0,127.0,5,1111,20.0,843.0,843.0
0.095,6,18,7607,10,808,10.0,280.0,280.0,8,6799,12.0,1402.0,1275.0
0.005,6,10,2006,5,927,1.0,659.0,659.0,5,1079,1.0,811.0,811.0
0.005,6,10,2000,5,927,1.0,659.0,659.0,5,1073,1.0,805.0,805.0
0.009,6,10,1989,5,910,2.0,642.0,642.0,5,1079,2.0,811.0,811.0
0.001,17,2,164,1,74,0.0,46.0,46.0,1,90,0.0,62.0,62.0
0.004,17,2,136,1,60,0.0,32.0,32.0,1,76,0.0,48.0,48.0
240.089,6,16,4481,9,963,30011.0,238.0,166.0,7,3518,40014.0,1402.0,786.0
0.013,6,10,1990,5,911,3.0,643.0,643.0,5,1079,3.0,811.0,811.0
0.001,17,2,180,1,66,0.0,38.0,38.0,1,114,0.0,86.0,86.0
0.005,6,10,2006,5,927,1.0,659.0,659.0,5,1079,1.0,811.0,811.0
0.005,6,10,2000,5,927,1.0,659.0,659.0,5,1073,1.0,805.0,805.0
0.006,17,2,164,1,74,0.0,46.0,46.0,1,90,0.0,62.0,62.0
0.094,17,9,4991,5,3252,23.0,1350.0,622.0,4,1739,11.0,1350.0,406.0
0.218,6,16,2669,8,1395,31.0,533.0,323.0,8,1274,20.0,529.0,212.0
0.018,6,10,1983,5,910,4.0,642.0,642.0,5,1073,4.0,805.0,805.0
0.015,6,10,1983,5,910,3.0,642.0,642.0,5,1073,3.0,805.0,805.0
0.069,6,10,1506,5,395,14.0,127.0,127.0,5,1111,16.0,843.0,843.0
0.006,17,2,178,1,65,0.0,37.0,37.0,1,113,0.0,85.0,85.0
0.061,17,2,80,1,32,0.0,4.0,4.0,1,48,0.0,20.0,20.0
0.01,6,10,1990,5,911,2.0,643.0,643.0,5,1079,2.0,811.0,811.0
308.584,17,20,1124,10,716,34272.0,48.0,43.0,10,408,34272.0,20.0,12.0
0.01,6,10,1983,5,910,2.0,642.0,642.0,5,1073,2.0,805.0,805.0
40.097,17,10,676,5,460,10023.0,104.0,64.0,5,216,10023.0,20.0,15.0
0.007,17,2,193,1,71,0.0,43.0,43.0,1,122,0.0,94.0,94.0
0.07,6,10,1506,5,395,15.0,127.0,127.0,5,1111,15.0,843.0,843.0
0.005,17,2,144,1,64,0.0,36.0,36.0,1,80,0.0,52.0,52.0
0.005,17,2,230,1,68,0.0,40.0,40.0,1,162,0.0,134.0,134.0
0.002,17,2,194,1,57,0.0,29.0,29.0,1,137,0.0,109.0,109.0
0.005,6,10,2006,5,927,1.0,659.0,659.0,5,1079,1.0,811.0,811.0
0.005,6,10,2000,5,927,1.0,659.0,659.0,5,1073,1.0,805.0,805.0
0.004,6,10,2007,5,928,1.0,660.0,660.0,5,1079,1.0,811.0,811.0
0.006,6,10,1547,5,764,1.0,496.0,496.0,5,783,1.0,515.0,515.0
0.012,6,10,1631,5,848,3.0,580.0,580.0,5,783,3.0,515.0,515.0
0.005,6,10,2000,5,927,1.0,659.0,659.0,5,1073,1.0,805.0,805.0
0.178,6,10,1506,5,395,43.0,127.0,127.0,5,1111,40.0,843.0,843.0
0.103,6,10,1506,5,395,23.0,127.0,127.0,5,1111,22.0,843.0,843.0
0.014,6,10,1989,5,910,3.0,642.0,642.0,5,1079,3.0,811.0,811.0
0.116,6,10,1506,5,395,23.0,127.0,127.0,5,1111,26.0,843.0,843.0
0.004,6,10,2006,5,927,1.0,659.0,659.0,5,1079,1.0,811.0,811.0
0.012,6,10,1989,5,910,2.0,642.0,642.0,5,1079,3.0,811.0,811.0
0.001,17,2,180,1,66,0.0,38.0,38.0,1,114,0.0,86.0,86.0
0.003,17,2,136,1,60,0.0,32.0,32.0,1,76,0.0,48.0,48.0
0.067,17,8,3613,4,1874,22.0,1350.0,440.0,4,1739,10.0,1350.0,406.0
0.014,6,10,1972,5,910,3.0,642.0,642.0,5,1062,3.0,794.0,794.0
0.004,17,2,170,1,65,0.0,37.0,37.0,1,105,0.0,77.0,77.0
0.006,6,14,3736,7,446,1.0,74.0,74.0,7,3290,0.0,1448.0,972.0
0.012,6,10,1989,5,910,2.0,642.0,642.0,5,1079,2.0,811.0,811.0
0.009,17,4,284,2,120,0.0,32.0,32.0,2,164,0.0,60.0,54.0
0.017,6,10,1972,5,910,4.0,642.0,642.0,5,1062,4.0,794.0,794.0
0.005,17,2,214,1,75,0.0,47.0,47.0,1,139,0.0,111.0,111.0
0.044,17,2,152,1,76,0.0,48.0,48.0,1,76,0.0,48.0,48.0
0.011,6,10,1972,5,910,2.0,642.0,642.0,5,1062,2.0,794.0,794.0
0.006,6,10,1643,5,860,1.0,592.0,592.0,5,783,1.0,515.0,515.0
0.004,6,10,1702,5,863,1.0,595.0,595.0,5,839,1.0,571.0,571.0
166.183,17,102,15006,51,3427,3323.0,44.0,39.0,51,11579,3323.0,279.0,199.0
175.12,17,82,11661,41,2736,4377.0,44.0,38.0,41,8925,4377.0,260.0,189.0
300.899,6,37,8261,20,1830,15836.0,651.0,249.0,17,6431,547.0,2720.0,478.0
0.113,6,10,1506,5,395,27.0,127.0,127.0,5,1111,24.0,843.0,843.0
0.015,6,10,1631,5,848,3.0,580.0,580.0,5,783,3.0,515.0,515.0
0.001,17,2,357,1,68,0.0,40.0,40.0,1,289,0.0,261.0,261.0
0.004,6,10,1702,5,863,1.0,595.0,595.0,5,839,1.0,571.0,571.0
66.528,6,27,17573,15,9632,4752.0,2804.0,1474.0,12,7941,6033.0,2312.0,1218.0
0.103,6,10,1506,5,395,24.0,127.0,127.0,5,1111,22.0,843.0,843.0
0.005,6,10,2000,5,927,1.0,659.0,659.0,5,1073,1.0,805.0,805.0
0.005,6,13,3747,7,509,0.0,137.0,137.0,6,3238,0.0,1470.0,1459.0
0.092,6,10,1506,5,395,20.0,127.0,127.0,5,1111,20.0,843.0,843.0
0.005,6,10,2000,5,927,1.0,659.0,659.0,5,1073,1.0,805.0,805.0
37.865,6,26,9479,13,1655,3155.0,794.0,367.0,13,7824,3144.0,1360.0,810.0
0.084,6,10,1506,5,395,17.0,127.0,127.0,5,1111,18.0,843.0,843.0
0.077,6,10,1506,5,395,16.0,127.0,127.0,5,1111,16.0,843.0,843.0
1798.551,17,2790,213672,1390,112661,1294.0,84.0,53.0,1400,101011,1282.0,227.0,44.0
0.125,6,10,1506,5,395,28.0,127.0,127.0,5,1111,30.0,843.0,843.0
0.001,17,2,180,1,66,0.0,38.0,38.0,1,114,0.0,86.0,86.0
0.01,6,10,1677,5,827,2.0,559.0,559.0,5,850,2.0,582.0,582.0
40.061,17,10,676,5,460,10013.0,104.0,64.0,5,216,10013.0,20.0,15.0
0.12,6,10,1506,5,395,28.0,127.0,127.0,5,1111,26.0,843.0,843.0
0.008,6,10,1972,5,910,1.0,642.0,642.0,5,1062,2.0,794.0,794.0
0.007,6,10,1989,5,927,1.0,659.0,659.0,5,1062,1.0,794.0,794.0
0.093,6,10,1506,5,395,17.0,127.0,127.0,5,1111,22.0,843.0,843.0
0.089,6,10,1506,5,395,18.0,127.0,127.0,5,1111,20.0,843.0,843.0
0.015,6,10,1631,5,848,3.0,580.0,580.0,5,783,3.0,515.0,515.0
300.336,6,16,2170,9,684,37521.0,146.0,146.0,7,1486,50028.0,419.0,398.0
0.005,6,10,1643,5,860,1.0,592.0,592.0,5,783,1.0,515.0,515.0
0.006,6,10,1689,5,839,1.0,571.0,571.0,5,850,1.0,582.0,582.0
0.162,6,10,1506,5,395,39.0,127.0,127.0,5,1111,37.0,843.0,843.0
0.07,17,8,3613,4,1874,23.0,1350.0,440.0,4,1739,12.0,1350.0,406.0
0.013,6,10,1989,5,910,3.0,642.0,642.0,5,1079,3.0,811.0,811.0
309.222,17,18,1008,9,640,38636.0,48.0,43.0,9,368,38636.0,20.0,12.0
0.039,17,2,148,1,60,0.0,32.0,32.0,1,88,0.0,60.0,60.0
40.061,17,10,676,5,460,10013.0,104.0,64.0,5,216,10014.0,20.0,15.0
0.001,17,2,180,1,66,0.0,38.0,38.0,1,114,0.0,86.0,86.0
40.055,17,10,676,5,460,10013.0,104.0,64.0,5,216,10011.0,20.0,15.0
0.008,6,10,1990,5,911,1.0,643.0,643.0,5,1079,2.0,811.0,811.0
0.088,6,10,1506,5,395,18.0,127.0,127.0,5,1111,19.0,843.0,843.0
0.004,6,10,1779,5,928,1.0,660.0,660.0,5,851,1.0,583.0,583.0
240.02,6,9,787,5,488,60005.0,232.0,232.0,4,299,80006.0,83.0,83.0
0.014,6,10,1990,5,911,3.0,643.0,643.0,5,1079,3.0,811.0,811.0
0.007,6,10,2006,5,927,1.0,659.0,659.0,5,1079,1.0,811.0,811.0
0.005,6,10,1689,5,839,1.0,571.0,571.0,5,850,1.0,582.0,582.0
0.001,17,2,180,1,66,0.0,38.0,38.0,1,114,0.0,86.0,86.0
0.005,17,2,166,1,75,0.0,47.0,47.0,1,91,0.0,63.0,63.0
309.158,6,23,4657,13,2427,25763.0,676.0,348.0,10,2230,27680.0,821.0,425.0
0.047,6,14,3787,7,497,7.0,125.0,125.0,7,3290,7.0,1448.0,972.0
169.18,17,86,12339,43,2885,4027.0,44.0,39.0,43,9454,4028.0,239.0,191.0
0.008,6,14,3787,7,497,1.0,125.0,125.0,7,3290,1.0,1448.0,972.0
0.006,17,2,170,1,65,0.0,37.0,37.0,1,105,0.0,77.0,77.0
0.087,6,10,1506,5,395,20.0,127.0,127.0,5,1111,16.0,843.0,843.0
0.012,6,10,1989,5,910,2.0,642.0,642.0,5,1079,3.0,811.0,811.0
0.008,6,10,1972,5,910,2.0,642.0,642.0,5,1062,2.0,794.0,794.0
352.667,6,20,2210,6,1308,12003.0,494.0,494.0,14,902,27128.0,83.0,83.0
0.006,6,10,1547,5,764,1.0,496.0,496.0,5,783,1.0,515.0,515.0
0.01,6,10,1983,5,910,2.0,642.0,642.0,5,1073,2.0,805.0,805.0
300.374,6,16,2170,9,684,37525.0,146.0,146.0,7,1486,50034.0,419.0,398.0
0.004,6,10,1702,5,863,1.0,595.0,595.0,5,839,1.0,571.0,571.0
0.009,6,10,1989,5,910,2.0,642.0,642.0,5,1079,2.0,811.0,811.0
0.014,6,10,1989,5,910,3.0,642.0,642.0,5,1079,3.0,811.0,811.0
40.076,17,10,676,5,460,10018.0,104.0,64.0,5,216,10018.0,20.0,15.0
0.011,6,10,1972,5,910,2.0,642.0,642.0,5,1062,2.0,794.0,794.0
0.01,6,10,1989,5,910,2.0,642.0,642.0,5,1079,2.0,811.0,811.0
0.005,17,2,179,1,71,0.0,43.0,43.0,1,108,0.0,80.0,80.0
171.332,17,78,11195,39,2606,4508.0,44.0,38.0,39,8589,4508.0,239.0,192.0
240.083,6,16,4481,9,963,30010.0,238.0,166.0,7,3518,40013.0,1402.0,786.0
0.004,6,10,1779,5,928,1.0,660.0,660.0,5,851,1.0,583.0,583.0
0.005,6,10,2006,5,927,1.0,659.0,659.0,5,1079,1.0,811.0,811.0
9.036,17,6,376,5,280,2259.0,28.0,28.0,1,96,0.0,68.0,68.0
0.015,6,10,1762,5,911,3.0,643.0,643.0,5,851,3.0,583.0,583.0
0.121,6,10,1506,5,395,26.0,127.0,127.0,5,1111,26.0,843.0,843.0
0.09,6,10,1506,5,395,20.0,127.0,127.0,5,1111,20.0,843.0,843.0
0.012,6,10,1983,5,910,2.0,642.0,642.0,5,1073,3.0,805.0,805.0
0.01,6,10,1990,5,911,2.0,643.0,643.0,5,1079,2.0,811.0,811.0
0.069,6,10,1506,5,395,15.0,127.0,127.0,5,1111,15.0,843.0,843.0
0.004,6,14,3799,7,509,0.0,137.0,137.0,7,3290,0.0,1448.0,972.0
0.006,6,10,1547,5,764,1.0,496.0,496.0,5,783,1.0,515.0,515.0
0.014,17,2,148,1,60,0.0,32.0,32.0,1,88,0.0,60.0,60.0
0.011,6,14,3787,7,497,1.0,125.0,125.0,7,3290,1.0,1448.0,972.0
0.005,6,10,2006,5,927,1.0,659.0,659.0,5,1079,1.0,811.0,811.0
240.097,6,34,9498,17,6766,15006.0,1774.0,652.0,17,2732,15005.0,580.0,204.0
0.006,6,10,1854,5,889,1.0,621.0,621.0,5,965,1.0,697.0,697.0
311.95,17,20,1124,10,716,34646.0,48.0,43.0,10,408,34645.0,20.0,12.0
0.005,6,10,1989,5,927,1.0,659.0,659.0,5,1062,1.0,794.0,794.0
0.005,6,10,2006,5,927,1.0,659.0,659.0,5,1079,1.0,811.0,811.0
0.042,17,4,352,2,130,0.0,37.0,37.0,2,222,3.0,89.0,83.0
0.005,6,10,1547,5,764,1.0,496.0,496.0,5,783,1.0,515.0,515.0
0.005,6,13,3747,7,509,0.0,137.0,137.0,6,3238,1.0,1470.0,1459.0
0.005,17,2,170,1,65,0.0,37.0,37.0,1,105,0.0,77.0,77.0
0.001,17,2,180,1,66,0.0,38.0,38.0,1,114,0.0,86.0,86.0
0.034,6,10,1631,5,848,8.0,580.0,580.0,5,783,8.0,515.0,515.0
0.012,6,10,1989,5,910,3.0,642.0,642.0,5,1079,3.0,811.0,811.0
0.073,6,10,1506,5,395,16.0,127.0,127.0,5,1111,17.0,843.0,843.0
0.006,6,10,1689,5,839,1.0,571.0,571.0,5,850,1.0,582.0,582.0
40.076,17,10,676,5,460,10015.0,104.0,64.0,5,216,10018.0,20.0,15.0
0.003,17,4,284,2,120,0.0,32.0,32.0,2,164,0.0,60.0,54.0
0.011,6,10,1989,5,910,2.0,642.0,642.0,5,1079,2.0,811.0,811.0
0.006,6,10,2006,5,927,1.0,659.0,659.0,5,1079,1.0,811.0,811.0
0.071,6,10,1506,5,395,17.0,127.0,127.0,5,1111,15.0,843.0,843.0
240.749,6,37,9661,19,2175,13372.0,747.0,235.0,18,7486,14159.0,1402.0,595.0
15.075,17,15,8056,8,6019,2149.0,1350.0,724.0,7,2037,2507.0,1350.0,263.0
65.662,6,27,17551,15,9602,4690.0,2846.0,1469.0,12,7949,5954.0,2320.0,1219.0
0.066,17,8,3613,4,1874,22.0,1350.0,440.0,4,1739,10.0,1350.0,406.0
0.006,6,10,1547,5,764,1.0,496.0,496.0,5,783,1.0,515.0,515.0
0.005,6,14,3736,7,446,0.0,74.0,74.0,7,3290,0.0,1448.0,972.0
0.003,17,4,284,2,120,0.0,32.0,32.0,2,164,0.0,60.0,54.0
0.011,6,10,1762,5,911,2.0,643.0,643.0,5,851,2.0,583.0,583.0
0.004,17,2,136,1,60,0.0,32.0,32.0,1,76,0.0,48.0,48.0
0.005,17,2,170,1,65,0.0,37.0,37.0,1,105,0.0,77.0,77.0
0.005,6,10,2007,5,928,1.0,660.0,660.0,5,1079,1.0,811.0,811.0
0.005,6,13,3747,7,509,0.0,137.0,137.0,6,3238,0.0,1470.0,1459.0
0.02,6,10,1972,5,910,5.0,642.0,642.0,5,1062,4.0,794.0,794.0
0.004,6,10,1702,5,863,1.0,595.0,595.0,5,839,0.0,571.0,571.0
0.04,17,2,148,1,60,0.0,32.0,32.0,1,88,0.0,60.0,60.0
0.107,6,10,1506,5,395,24.0,127.0,127.0,5,1111,22.0,843.0,843.0
0.004,6,10,1989,5,927,1.0,659.0,659.0,5,1062,1.0,794.0,794.0
0.006,6,10,1547,5,764,1.0,496.0,496.0,5,783,1.0,515.0,515.0
0.012,6,10,1983,5,910,3.0,642.0,642.0,5,1073,3.0,805.0,805.0
15.071,17,15,9238,8,6902,2149.0,1350.0,834.0,7,2336,2507.0,1350.0,305.0
0.101,6,10,1506,5,395,23.0,127.0,127.0,5,1111,20.0,843.0,843.0
0.016,17,2,198,1,91,0.0,63.0,63.0,1,107,0.0,79.0,79.0
0.012,6,10,1989,5,910,3.0,642.0,642.0,5,1079,2.0,811.0,811.0
1781.145,6,90,4834,46,2470,39580.0,26.0,26.0,44,2364,41421.0,26.0,25.0
0.007,17,2,213,1,69,0.0,41.0,41.0,1,144,0.0,116.0,116.0
0.004,6,10,1989,5,927,1.0,659.0,659.0,5,1062,1.0,794.0,794.0
0.038,6,14,3787,7,497,6.0,125.0,125.0,7,3290,6.0,1448.0,972.0
0.01,6,10,1989,5,910,2.0,642.0,642.0,5,1079,2.0,811.0,811.0
0.005,6,10,1643,5,860,1.0,592.0,592.0,5,783,1.0,515.0,515.0
0.021,6,13,3735,7,497,3.0,125.0,125.0,6,3238,4.0,1470.0,1459.0
0.004,6,10,2006,5,927,1.0,659.0,659.0,5,1079,1.0,811.0,811.0
242.131,6,390,348260,195,21662,1248.0,2736.0,885.0,195,326598,1248.0,2804.0,1710.0
0.01,6,12,1926,6,1189,2.0,659.0,434.0,6,737,1.0,417.0,417.0
0.009,6,10,1989,5,910,2.0,642.0,642.0,5,1079,2.0,811.0,811.0
0.012,6,10,1972,5,910,2.0,642.0,642.0,5,1062,3.0,794.0,794.0
0.001,17,2,180,1,66,0.0,38.0,38.0,1,114,0.0,86.0,86.0
0.02,6,10,1677,5,827,4.0,559.0,559.0,5,850,4.0,582.0,582.0
0.015,6,10,1631,5,848,3.0,580.0,580.0,5,783,3.0,515.0,515.0
0.088,6,10,1506,5,395,19.0,127.0,127.0,5,1111,18.0,843.0,843.0
0.136,6,24,10988,12,6091,12.0,2736.0,1089.0,12,4897,12.0,1655.0,853.0
0.005,6,13,3690,7,452,0.0,80.0,80.0,6,3238,0.0,1470.0,1459.0
0.005,6,10,2006,5,927,1.0,659.0,659.0,5,1079,1.0,811.0,811.0
0.005,6,10,2006,5,927,1.0,659.0,659.0,5,1079,1.0,811.0,811.0
0.112,17,4,596,2,122,75.0,33.0,33.0,2,474,72.0,323.0,209.0
0.001,17,2,136,1,60,0.0,32.0,32.0,1,76,0.0,48.0,48.0
0.005,6,10,2007,5,928,1.0,660.0,660.0,5,1079,1.0,811.0,811.0
10.798,17,28,4418,14,1993,822.0,268.0,114.0,14,2425,822.0,588.0,145.0
0.134,17,2,80,1,32,0.0,4.0,4.0,1,48,0.0,20.0,20.0
0.136,6,10,1506,5,395,27.0,127.0,127.0,5,1111,32.0,843.0,843.0
0.312,17,44,26463,25,23397,13.0,1350.0,907.0,19,3066,13.0,1350.0,133.0
0.08,6,10,1506,5,395,18.0,127.0,127.0,5,1111,17.0,843.0,843.0
10.977,17,28,4418,14,1994,836.0,269.0,114.0,14,2424,836.0,587.0,145.0
40.06,17,10,676,5,460,10014.0,104.0,64.0,5,216,10014.0,20.0,15.0
0.062,6,10,1506,5,395,13.0,127.0,127.0,5,1111,12.0,843.0,843.0
0.011,6,10,1677,5,827,2.0,559.0,559.0,5,850,2.0,582.0,582.0
0.005,17,2,136,1,60,0.0,32.0,32.0,1,76,0.0,48.0,48.0
0.073,6,10,1506,5,395,16.0,127.0,127.0,5,1111,16.0,843.0,843.0
0.004,6,10,1989,5,927,1.0,659.0,659.0,5,1062,1.0,794.0,794.0
0.09,6,10,1506,5,395,17.0,127.0,127.0,5,1111,19.0,843.0,843.0
9.038,17,6,376,5,280,2259.0,28.0,28.0,1,96,0.0,68.0,68.0
0.014,6,10,1990,5,911,3.0,643.0,643.0,5,1079,3.0,811.0,811.0
0.004,6,14,3799,7,509,0.0,137.0,137.0,7,3290,0.0,1448.0,972.0
0.005,6,14,3799,7,509,0.0,137.0,137.0,7,3290,0.0,1448.0,972.0
0.001,17,2,180,1,66,0.0,38.0,38.0,1,114,0.0,86.0,86.0
0.008,6,10,1983,5,910,2.0,642.0,642.0,5,1073,2.0,805.0,805.0
0.016,17,2,180,1,66,0.0,38.0,38.0,1,114,0.0,86.0,86.0
0.004,6,10,2006,5,927,1.0,659.0,659.0,5,1079,1.0,811.0,811.0
0.075,6,10,1506,5,395,14.0,127.0,127.0,5,1111,17.0,843.0,843.0
0.005,17,2,230,1,68,0.0,40.0,40.0,1,162,0.0,134.0,134.0
1799.733,17,122,11651,61,5551,29995.0,63.0,63.0,61,6100,29995.0,72.0,72.0
277.267,6,24,7212,14,1759,21328.0,253.0,207.0,10,5453,30807.0,1402.0,703.0
0.004,6,10,1774,5,923,1.0,655.0,655.0,5,851,1.0,583.0,583.0
0.006,6,10,1547,5,764,1.0,496.0,496.0,5,783,1.0,515.0,515.0
0.005,17,2,140,1,62,0.0,34.0,34.0,1,78,0.0,50.0,50.0
0.005,6,10,1989,5,927,1.0,659.0,659.0,5,1062,1.0,794.0,794.0
0.008,6,10,1762,5,911,2.0,643.0,643.0,5,851,2.0,583.0,583.0
0.004,6,10,1774,5,923,1.0,655.0,655.0,5,851,1.0,583.0,583.0
0.005,6,10,2007,5,928,1.0,660.0,660.0,5,1079,1.0,811.0,811.0
0.076,6,10,1506,5,395,17.0,127.0,127.0,5,1111,16.0,843.0,843.0
0.005,6,10,1774,5,923,1.0,655.0,655.0,5,851,1.0,583.0,583.0
0.004,6,10,2006,5,927,1.0,659.0,659.0,5,1079,1.0,811.0,811.0
0.104,6,10,1506,5,395,22.0,127.0,127.0,5,1111,24.0,843.0,843.0
0.143,6,10,1506,5,395,33.0,127.0,127.0,5,1111,31.0,843.0,843.0
0.001,17,2,180,1,66,0.0,38.0,38.0,1,114,0.0,86.0,86.0
0.02,6,10,1990,5,911,5.0,643.0,643.0,5,1079,5.0,811.0,811.0
0.006,6,10,2007,5,928,1.0,660.0,660.0,5,1079,1.0,811.0,811.0
0.01,6,10,2007,5,928,2.0,660.0,660.0,5,1079,2.0,811.0,811.0
0.004,6,10,1702,5,863,1.0,595.0,595.0,5,839,1.0,571.0,571.0
0.004,6,10,1989,5,927,1.0,659.0,659.0,5,1062,1.0,794.0,794.0
0.017,6,10,1983,5,910,4.0,642.0,642.0,5,1073,4.0,805.0,805.0
0.015,6,10,1972,5,910,3.0,642.0,642.0,5,1062,3.0,794.0,794.0
0.087,6,10,1506,5,395,19.0,127.0,127.0,5,1111,18.0,843.0,843.0
0.015,6,10,1983,5,910,3.0,642.0,642.0,5,1073,3.0,805.0,805.0
292.684,6,403,348800,195,21696,1508.0,2736.0,824.0,208,327104,1413.0,2804.0,1630.0
0.012,6,10,1990,5,911,3.0,643.0,643.0,5,1079,2.0,811.0,811.0
0.09,6,10,1506,5,395,20.0,127.0,127.0,5,1111,21.0,843.0,843.0
0.014,17,2,136,1,60,0.0,32.0,32.0,1,76,0.0,48.0,48.0
0.004,17,4,284,2,120,0.0,32.0,32.0,2,164,0.0,60.0,54.0
66.118,6,32,20217,15,11895,4722.0,2804.0,1588.0,17,8322,4124.0,2309.0,743.0
361.785,6,21,1793,16,1030,24119.0,190.0,190.0,5,763,60009.0,462.0,247.0
0.023,6,10,1989,5,910,5.0,642.0,642.0,5,1079,5.0,811.0,811.0
0.101,6,10,1506,5,395,23.0,127.0,127.0,5,1111,24.0,843.0,843.0
0.005,6,10,1689,5,839,1.0,571.0,571.0,5,850,1.0,582.0,582.0
0.105,6,10,1506,5,395,23.0,127.0,127.0,5,1111,23.0,843.0,843.0
0.22,6,25,11371,12,5707,20.0,1788.0,1015.0,13,5664,17.0,1656.0,830.0
0.011,6,10,1631,5,848,2.0,580.0,580.0,5,783,2.0,515.0,515.0
0.105,6,10,1506,5,395,21.0,127.0,127.0,5,1111,24.0,843.0,843.0
0.005,6,10,2007,5,928,1.0,660.0,660.0,5,1079,1.0,811.0,811.0
0.008,6,10,1989,5,910,2.0,642.0,642.0,5,1079,1.0,811.0,811.0
0.006,6,10,1547,5,764,1.0,496.0,496.0,5,783,1.0,515.0,515.0
0.13,17,2,412,1,61,0.0,33.0,33.0,1,351,0.0,323.0,323.0
0.016,6,10,1989,5,910,3.0,642.0,642.0,5,1079,4.0,811.0,811.0
0.105,6,10,1506,5,395,23.0,127.0,127.0,5,1111,22.0,843.0,843.0
0.022,6,10,1989,5,910,5.0,642.0,642.0,5,1079,5.0,811.0,811.0
11.186,17,28,4421,14,1994,847.0,269.0,114.0,14,2427,847.0,586.0,145.0
0.138,6,10,1506,5,395,28.0,127.0,127.0,5,1111,32.0,843.0,843.0
0.02,6,10,1989,5,910,5.0,642.0,642.0,5,1079,4.0,811.0,811.0
162.698,6,24,9399,11,1575,68.0,794.0,367.0,13,7824,13547.0,1360.0,810.0
0.005,6,10,1779,5,928,1.0,660.0,660.0,5,851,1.0,583.0,583.0
0.004,17,4,284,2,120,0.0,32.0,32.0,2,164,0.0,60.0,54.0
0.009,6,10,2006,5,927,2.0,659.0,659.0,5,1079,2.0,811.0,811.0
0.018,6,10,1990,5,911,4.0,643.0,643.0,5,1079,4.0,811.0,811.0
0.09,6,10,1506,5,395,20.0,127.0,127.0,5,1111,19.0,843.0,843.0
0.004,17,2,148,1,60,0.0,32.0,32.0,1,88,0.0,60.0,60.0
354.084,6,19,1691,15,978,25291.0,190.0,190.0,4,713,80002.0,497.0,497.0
0.001,17,2,180,1,66,0.0,38.0,38.0,1,114,0.0,86.0,86.0
0.011,6,10,1677,5,827,2.0,559.0,559.0,5,850,2.0,582.0,582.0
240.012,6,9,787,5,488,60003.0,232.0,232.0,4,299,80003.0,83.0,83.0
308.536,17,20,1124,10,716,34266.0,48.0,43.0,10,408,34263.0,20.0,12.0
0.006,6,10,1643,5,860,1.0,592.0,592.0,5,783,1.0,515.0,515.0
0.069,6,10,1506,5,395,15.0,127.0,127.0,5,1111,15.0,843.0,843.0
0.014,6,10,1972,5,910,3.0,642.0,642.0,5,1062,3.0,794.0,794.0
0.015,6,10,1983,5,910,3.0,642.0,642.0,5,1073,3.0,805.0,805.0
53.555,6,315,344168,116,17588,465.0,2736.0,888.0,199,326580,270.0,2804.0,1700.0
0.007,6,10,1854,5,889,1.0,621.0,621.0,5,965,1.0,697.0,697.0
0.016,6,10,1989,5,910,3.0,642.0,642.0,5,1079,4.0,811.0,811.0
0.091,6,10,1506,5,395,21.0,127.0,127.0,5,1111,22.0,843.0,843.0
0.005,6,10,1774,5,923,1.0,655.0,655.0,5,851,1.0,583.0,583.0
0.01,6,10,1983,5,910,2.0,642.0,642.0,5,1073,2.0,805.0,805.0
0.171,17,2,213,1,69,0.0,41.0,41.0,1,144,0.0,116.0,116.0
0.006,6,10,1547,5,764,1.0,496.0,496.0,5,783,1.0,515.0,515.0
0.039,17,4,596,2,122,0.0,33.0,33.0,2,474,1.0,323.0,209.0
10.748,17,28,4423,14,1995,817.0,270.0,114.0,14,2428,818.0,587.0,145.0
0.004,17,4,284,2,120,1.0,32.0,32.0,2,164,0.0,60.0,54.0
0.084,6,10,1506,5,395,18.0,127.0,127.0,5,1111,20.0,843.0,843.0
0.075,6,10,1506,5,395,17.0,127.0,127.0,5,1111,16.0,843.0,843.0
0.004,17,4,284,2,120,0.0,32.0,32.0,2,164,0.0,60.0,54.0
301.181,6,47,22060,27,16233,11583.0,2720.0,1374.0,20,5827,475.0,2667.0,385.0
289.917,6,405,348102,193,21603,1509.0,2691.0,889.0,212,326499,1374.0,2804.0,1593.0
0.009,6,12,1926,6,1189,1.0,659.0,434.0,6,737,1.0,417.0,417.0
0.005,17,2,222,1,65,0.0,37.0,37.0,1,157,0.0,129.0,129.0
0.006,6,10,1989,5,927,1.0,659.0,659.0,5,1062,1.0,794.0,794.0
240.021,6,9,787,5,488,60005.0,232.0,232.0,4,299,80005.0,83.0,83.0
0.004,6,10,1989,5,927,1.0,659.0,659.0,5,1062,1.0,794.0,794.0
40.062,17,10,676,5,460,10014.0,104.0,64.0,5,216,10014.0,20.0,15.0
0.004,17,2,136,1,60,0.0,32.0,32.0,1,76,0.0,48.0,48.0
0.005,6,14,3742,7,452,0.0,80.0,80.0,7,3290,0.0,1448.0,972.0
40.058,17,10,676,5,460,10012.0,104.0,64.0,5,216,10013.0,20.0,15.0
0.006,17,2,187,1,71,0.0,43.0,43.0,1,116,0.0,88.0,88.0
0.004,6,10,1702,5,863,0.0,595.0,595.0,5,839,1.0,571.0,571.0
0.004,6,10,2007,5,928,1.0,660.0,660.0,5,1079,1.0,811.0,811.0
333.868,17,20,1124,10,716,37082.0,48.0,43.0,10,408,37082.0,20.0,12.0
0.012,6,10,1990,5,911,3.0,643.0,643.0,5,1079,2.0,811.0,811.0
0.005,17,2,170,1,65,0.0,37.0,37.0,1,105,0.0,77.0,77.0
0.096,6,10,1506,5,395,22.0,127.0,127.0,5,1111,19.0,843.0,843.0
305.444,58,5,360,4,288,101814.0,24.0,24.0,1,72,0.0,24.0,24.0
0.005,6,10,2006,5,927,1.0,659.0,659.0,5,1079,1.0,811.0,811.0
368.759,6,22,2313,16,867,24583.0,195.0,195.0,6,1446,4703.0,419.0,398.0
0.145,17,2,152,1,76,0.0,48.0,48.0,1,76,0.0,48.0,48.0
0.013,17,2,152,1,56,0.0,28.0,28.0,1,96,0.0,68.0,68.0
0.172,6,10,1506,5,395,38.0,127.0,127.0,5,1111,25.0,843.0,843.0
0.012,6,13,3735,7,497,2.0,125.0,125.0,6,3238,2.0,1470.0,1459.0
40.069,17,10,676,5,460,10013.0,104.0,64.0,5,216,10016.0,20.0,15.0
0.007,17,2,179,1,71,0.0,43.0,43.0,1,108,0.0,80.0,80.0
0.005,17,2,136,1,60,0.0,32.0,32.0,1,76,0.0,48.0,48.0
0.005,6,13,3690,7,452,0.0,80.0,80.0,6,3238,1.0,1470.0,1459.0
0.018,6,10,1677,5,827,4.0,559.0,559.0,5,850,4.0,582.0,582.0
0.009,6,10,1989,5,910,2.0,642.0,642.0,5,1079,2.0,811.0,811.0
0.006,6,10,2006,5,927,1.0,659.0,659.0,5,1079,1.0,811.0,811.0
0.004,6,10,1989,5,927,1.0,659.0,659.0,5,1062,1.0,794.0,794.0
0.017,6,10,1990,5,911,4.0,643.0,643.0,5,1079,4.0,811.0,811.0
0.006,17,2,179,1,71,0.0,43.0,43.0,1,108,0.0,80.0,80.0
43.332,6,36,8427,18,1955,525.0,887.0,401.0,18,6472,2541.0,2126.0,478.0
0.004,17,2,148,1,60,0.0,32.0,32.0,1,88,0.0,60.0,60.0
0.012,6,10,1989,5,910,3.0,642.0,642.0,5,1079,3.0,811.0,811.0
0.006,6,10,1689,5,839,1.0,571.0,571.0,5,850,1.0,582.0,582.0
0.005,6,10,2006,5,927,1.0,659.0,659.0,5,1079,1.0,811.0,811.0
0.127,6,10,1506,5,395,24.0,127.0,127.0,5,1111,25.0,843.0,843.0
0.081,6,10,1506,5,395,18.0,127.0,127.0,5,1111,15.0,843.0,843.0
1777.557,17,144,45504,72,22752,25035.0,288.0,288.0,72,22752,25035.0,288.0,288.0
0.009,6,13,3735,7,497,1.0,125.0,125.0,6,3238,1.0,1470.0,1459.0
0.006,6,10,1547,5,764,1.0,496.0,496.0,5,783,1.0,515.0,515.0
0.005,6,10,2007,5,928,1.0,660.0,660.0,5,1079,1.0,811.0,811.0
0.079,6,10,1506,5,395,16.0,127.0,127.0,5,1111,17.0,843.0,843.0
0.006,6,13,3690,7,452,1.0,80.0,80.0,6,3238,1.0,1470.0,1459.0
0.074,17,4,284,2,120,1.0,32.0,32.0,2,164,71.0,60.0,54.0
0.015,6,10,1989,5,910,3.0,642.0,642.0,5,1079,3.0,811.0,811.0
0.004,6,10,2000,5,927,1.0,659.0,659.0,5,1073,1.0,805.0,805.0
0.005,6,10,1547,5,764,1.0,496.0,496.0,5,783,1.0,515.0,515.0
0.006,6,10,1689,5,839,1.0,571.0,571.0,5,850,1.0,582.0,582.0
0.006,17,2,230,1,68,0.0,40.0,40.0,1,162,0.0,134.0,134.0
0.039,17,2,136,1,60,0.0,32.0,32.0,1,76,0.0,48.0,48.0
0.072,6,10,1506,5,395,14.0,127.0,127.0,5,1111,17.0,843.0,843.0
1733.228,6,66,7466,44,4586,40307.0,1402.0,103.0,22,2880,82526.0,1116.0,82.0
0.047,6,10,1989,5,910,11.0,642.0,642.0,5,1079,11.0,811.0,811.0
0.006,6,15,3794,8,504,0.0,80.0,80.0,7,3290,0.0,1448.0,972.0
0.004,6,10,2007,5,928,1.0,660.0,660.0,5,1079,1.0,811.0,811.0
0.055,17,2,179,1,71,0.0,43.0,43.0,1,108,0.0,80.0,80.0
0.105,6,10,1506,5,395,22.0,127.0,127.0,5,1111,25.0,843.0,843.0
40.056,17,10,676,5,460,10013.0,104.0,64.0,5,216,10013.0,20.0,15.0
313.921,17,20,1124,10,716,34866.0,48.0,43.0,10,408,34866.0,20.0,12.0
0.001,17,2,136,1,60,0.0,32.0,32.0,1,76,0.0,48.0,48.0
0.004,6,10,2000,5,927,1.0,659.0,659.0,5,1073,1.0,805.0,805.0
0.037,17,2,170,1,65,0.0,37.0,37.0,1,105,0.0,77.0,77.0
0.001,17,2,180,1,66,0.0,38.0,38.0,1,114,0.0,86.0,86.0
10.815,17,26,4100,13,1845,892.0,268.0,113.0,13,2255,892.0,586.0,145.0
0.006,6,13,3684,7,446,0.0,74.0,74.0,6,3238,1.0,1470.0,1459.0
171.063,17,88,12728,44,2962,3978.0,44.0,39.0,44,9766,3978.0,261.0,193.0
0.234,17,39,20263,21,17041,11.0,1350.0,783.0,18,3222,10.0,1350.0,151.0
0.015,6,10,1990,5,911,3.0,643.0,643.0,5,1079,3.0,811.0,811.0
0.006,6,10,1854,5,889,1.0,621.0,621.0,5,965,1.0,697.0,697.0
0.007,6,10,1547,5,764,1.0,496.0,496.0,5,783,1.0,515.0,515.0
0.104,6,10,1506,5,395,23.0,127.0,127.0,5,1111,23.0,843.0,843.0
0.005,6,10,2006,5,927,1.0,659.0,659.0,5,1079,1.0,811.0,811.0
0.087,6,10,1506,5,395,20.0,127.0,127.0,5,1111,19.0,843.0,843.0
0.015,6,10,1972,5,910,3.0,642.0,642.0,5,1062,3.0,794.0,794.0
0.005,6,10,1547,5,764,1.0,496.0,496.0,5,783,1.0,515.0,515.0
0.007,6,10,1774,5,923,1.0,655.0,655.0,5,851,1.0,583.0,583.0
0.052,17,2,152,1,76,0.0,48.0,48.0,1,76,0.0,48.0,48.0
241.393,6,397,347843,192,21510,1263.0,2736.0,959.0,205,326333,1183.0,2804.0,1618.0
0.003,17,2,152,1,76,0.0,48.0,48.0,1,76,0.0,48.0,48.0
0.005,6,10,2007,5,928,1.0,660.0,660.0,5,1079,1.0,811.0,811.0
0.149,6,14,3108,8,601,21.0,177.0,177.0,6,2507,29.0,1402.0,1089.0
0.005,6,10,1689,5,839,1.0,571.0,571.0,5,850,1.0,582.0,582.0
0.004,6,10,2006,5,927,1.0,659.0,659.0,5,1079,1.0,811.0,811.0
0.005,6,10,2006,5,927,1.0,659.0,659.0,5,1079,1.0,811.0,811.0
0.101,6,10,1506,5,395,21.0,127.0,127.0,5,1111,22.0,843.0,843.0
0.004,17,2,136,1,60,0.0,32.0,32.0,1,76,0.0,48.0,48.0
0.042,17,2,182,1,65,0.0,37.0,37.0,1,117,0.0,89.0,89.0
0.037,17,2,146,1,65,0.0,37.0,37.0,1,81,0.0,53.0,53.0
0.004,6,10,1774,5,923,1.0,655.0,655.0,5,851,1.0,583.0,583.0
0.005,6,13,3747,7,509,0.0,137.0,137.0,6,3238,0.0,1470.0,1459.0
0.018,6,10,1983,5,910,4.0,642.0,642.0,5,1073,4.0,805.0,805.0
0.018,6,10,1989,5,910,4.0,642.0,642.0,5,1079,4.0,811.0,811.0
0.085,6,10,1506,5,395,18.0,127.0,127.0,5,1111,17.0,843.0,843.0
0.013,6,10,1990,5,911,3.0,643.0,643.0,5,1079,3.0,811.0,811.0
0.02,6,10,1989,5,910,4.0,642.0,642.0,5,1079,4.0,811.0,811.0
0.174,6,12,2996,7,549,29.0,177.0,177.0,5,2447,34.0,1402.0,1089.0
0.016,6,10,1972,5,910,4.0,642.0,642.0,5,1062,3.0,794.0,794.0
0.005,17,2,144,1,64,0.0,36.0,36.0,1,80,0.0,52.0,52.0
0.005,6,10,1989,5,927,1.0,659.0,659.0,5,1062,1.0,794.0,794.0
0.005,17,2,230,1,68,0.0,40.0,40.0,1,162,0.0,134.0,134.0
240.017,6,9,787,5,488,60004.0,232.0,232.0,4,299,80004.0,83.0,83.0
1.0,6,14,3962,7,2139,125.0,1328.0,923.0,7,1823,125.0,1300.0,769.0
15.075,17,15,9238,8,6902,2149.0,1350.0,834.0,7,2336,2507.0,1350.0,305.0
0.006,6,10,1547,5,764,1.0,496.0,496.0,5,783,1.0,515.0,515.0
0.012,6,10,1989,5,910,3.0,642.0,642.0,5,1079,2.0,811.0,811.0
0.019,6,13,3735,7,497,3.0,125.0,125.0,6,3238,3.0,1470.0,1459.0
0.005,17,2,169,1,62,0.0,34.0,34.0,1,107,0.0,79.0,79.0
0.008,6,12,1926,6,1189,1.0,659.0,434.0,6,737,1.0,417.0,417.0
0.135,6,22,7331,12,2913,11.0,1402.0,380.0,10,4418,13.0,1324.0,778.0
0.01,6,10,1972,5,910,2.0,642.0,642.0,5,1062,2.0,794.0,794.0
0.01,6,10,1990,5,911,2.0,643.0,643.0,5,1079,2.0,811.0,811.0
0.004,17,2,136,1,60,0.0,32.0,32.0,1,76,0.0,48.0,48.0
0.015,6,10,1990,5,911,3.0,643.0,643.0,5,1079,3.0,811.0,811.0
0.013,6,10,1989,5,910,3.0,642.0,642.0,5,1079,3.0,811.0,811.0
0.007,6,10,1643,5,860,1.0,592.0,592.0,5,783,1.0,515.0,515.0
0.005,6,10,2006,5,927,1.0,659.0,659.0,5,1079,1.0,811.0,811.0
0.01,6,10,1990,5,911,2.0,643.0,643.0,5,1079,2.0,811.0,811.0
0.076,6,10,1506,5,395,17.0,127.0,127.0,5,1111,17.0,843.0,843.0
176.441,17,94,13695,47,3160,3835.0,44.0,39.0,47,10535,3835.0,239.0,196.0
0.004,17,2,136,1,60,0.0,32.0,32.0,1,76,0.0,48.0,48.0
166.271,17,76,10766,38,2537,4493.0,44.0,38.0,38,8229,4493.0,261.0,188.0
0.027,6,10,1989,5,910,6.0,642.0,642.0,5,1079,6.0,811.0,811.0
0.003,17,2,186,1,61,0.0,33.0,33.0,1,125,0.0,97.0,97.0
0.008,6,10,1774,5,923,2.0,655.0,655.0,5,851,2.0,583.0,583.0
0.004,6,10,1702,5,863,0.0,595.0,595.0,5,839,1.0,571.0,571.0
0.102,6,10,1506,5,395,24.0,127.0,127.0,5,1111,24.0,843.0,843.0
0.01,6,10,1983,5,910,2.0,642.0,642.0,5,1073,2.0,805.0,805.0
0.005,17,2,214,1,75,0.0,47.0,47.0,1,139,0.0,111.0,111.0
40.058,17,10,676,5,460,10013.0,104.0,64.0,5,216,10013.0,20.0,15.0
0.005,17,2,194,1,59,0.0,31.0,31.0,1,135,0.0,107.0,107.0
0.013,6,10,1762,5,911,3.0,643.0,643.0,5,851,3.0,583.0,583.0
0.005,6,10,1689,5,839,1.0,571.0,571.0,5,850,1.0,582.0,582.0
0.016,6,10,1989,5,910,3.0,642.0,642.0,5,1079,4.0,811.0,811.0
355.726,6,20,2210,6,1308,12007.0,494.0,494.0,14,902,27362.0,83.0,83.0
0.015,6,10,1762,5,911,3.0,643.0,643.0,5,851,3.0,583.0,583.0
0.009,6,10,1990,5,911,2.0,643.0,643.0,5,1079,2.0,811.0,811.0
0.11,6,10,1506,5,395,23.0,127.0,127.0,5,1111,21.0,843.0,843.0
0.004,6,10,2006,5,927,1.0,659.0,659.0,5,1079,1.0,811.0,811.0
0.004,17,4,284,2,120,0.0,32.0,32.0,2,164,0.0,60.0,54.0
0.095,6,10,1506,5,395,21.0,127.0,127.0,5,1111,19.0,843.0,843.0
0.079,6,10,1506,5,395,14.0,127.0,127.0,5,1111,18.0,843.0,843.0
64.501,6,44,18618,23,12980,409.0,2720.0,1336.0,21,5638,3216.0,2667.0,435.0
0.015,6,10,1989,5,910,3.0,642.0,642.0,5,1079,3.0,811.0,811.0
0.015,6,10,1983,5,910,3.0,642.0,642.0,5,1073,3.0,805.0,805.0
0.005,17,2,182,1,72,0.0,44.0,44.0,1,110,0.0,82.0,82.0
0.077,6,10,1506,5,395,15.0,127.0,127.0,5,1111,17.0,843.0,843.0
0.016,6,10,1990,5,911,4.0,643.0,643.0,5,1079,3.0,811.0,811.0
0.071,17,4,284,2,120,0.0,32.0,32.0,2,164,67.0,60.0,54.0
40.057,17,10,676,5,460,10013.0,104.0,64.0,5,216,10013.0,20.0,15.0
0.007,6,10,1972,5,910,1.0,642.0,642.0,5,1062,1.0,794.0,794.0
0.011,6,10,1972,5,910,2.0,642.0,642.0,5,1062,2.0,794.0,794.0
0.005,6,10,2000,5,927,1.0,659.0,659.0,5,1073,1.0,805.0,805.0
0.001,17,2,268,1,70,0.0,42.0,42.0,1,198,0.0,170.0,170.0
0.014,6,10,1990,5,911,3.0,643.0,643.0,5,1079,3.0,811.0,811.0
308.574,17,20,1124,10,716,34271.0,48.0,43.0,10,408,34271.0,20.0,12.0
0.001,17,2,136,1,60,0.0,32.0,32.0,1,76,0.0,48.0,48.0
0.123,6,10,1506,5,395,28.0,127.0,127.0,5,1111,26.0,843.0,843.0
0.099,6,10,1506,5,395,23.0,127.0,127.0,5,1111,23.0,843.0,843.0
0.095,6,10,1506,5,395,20.0,127.0,127.0,5,1111,22.0,843.0,843.0
308.532,17,20,1124,10,716,34274.0,48.0,43.0,10,408,34274.0,20.0,12.0
10.733,17,28,4423,14,1994,817.0,269.0,114.0,14,2429,817.0,588.0,145.0
0.006,6,10,1547,5,764,1.0,496.0,496.0,5,783,1.0,515.0,515.0
0.005,6,10,2006,5,927,1.0,659.0,659.0,5,1079,1.0,811.0,811.0
0.004,6,10,1774,5,923,1.0,655.0,655.0,5,851,1.0,583.0,583.0
0.009,6,12,1926,6,1189,1.0,659.0,434.0,6,737,1.0,417.0,417.0
0.008,17,2,170,1,65,0.0,37.0,37.0,1,105,0.0,77.0,77.0
0.005,6,10,2000,5,927,1.0,659.0,659.0,5,1073,1.0,805.0,805.0
300.34,6,16,2170,9,684,37522.0,146.0,146.0,7,1486,50029.0,419.0,398.0
1786.455,6,154,19574,92,13852,19631.0,302.0,302.0,62,5722,29286.0,83.0,83.0
15.08,17,15,8625,8,6373,2150.0,1350.0,768.0,7,2252,2508.0,1350.0,293.0
0.005,6,10,1854,5,889,1.0,621.0,621.0,5,965,1.0,697.0,697.0
0.012,6,10,1983,5,910,3.0,642.0,642.0,5,1073,2.0,805.0,805.0
0.006,17,2,179,1,71,0.0,43.0,43.0,1,108,0.0,80.0,80.0
240.011,6,9,787,5,488,60002.0,232.0,232.0,4,299,80002.0,83.0,83.0
0.086,6,10,1506,5,395,20.0,127.0,127.0,5,1111,19.0,843.0,843.0
0.117,6,10,1506,5,395,25.0,127.0,127.0,5,1111,25.0,843.0,843.0
125.989,6,14,2938,8,2504,17965.0,1414.0,1086.0,6,434,25151.0,182.0,182.0
0.106,6,10,1506,5,395,24.0,127.0,127.0,5,1111,22.0,843.0,843.0
0.109,6,10,1506,5,395,23.0,127.0,127.0,5,1111,24.0,843.0,843.0
0.067,17,8,3613,4,1874,22.0,1350.0,440.0,4,1739,11.0,1350.0,406.0
0.001,17,2,166,1,75,0.0,47.0,47.0,1,91,0.0,63.0,63.0
240.012,6,9,787,5,488,60003.0,232.0,232.0,4,299,80002.0,83.0,83.0
0.001,17,2,132,1,58,0.0,30.0,30.0,1,74,0.0,46.0,46.0
0.005,6,10,1989,5,927,1.0,659.0,659.0,5,1062,1.0,794.0,794.0
0.144,6,10,1506,5,395,32.0,127.0,127.0,5,1111,31.0,843.0,843.0
0.005,6,10,2007,5,928,1.0,660.0,660.0,5,1079,1.0,811.0,811.0
0.006,6,10,1547,5,764,1.0,496.0,496.0,5,783,1.0,515.0,515.0
0.005,6,10,2006,5,927,1.0,659.0,659.0,5,1079,1.0,811.0,811.0
0.082,6,10,1506,5,395,18.0,127.0,127.0,5,1111,17.0,843.0,843.0
9.043,17,6,376,5,280,2260.0,28.0,28.0,1,96,0.0,68.0,68.0
0.005,17,2,230,1,68,0.0,40.0,40.0,1,162,0.0,134.0,134.0
0.005,6,10,2006,5,927,1.0,659.0,659.0,5,1079,1.0,811.0,811.0
0.008,6,10,1989,5,927,2.0,659.0,659.0,5,1062,1.0,794.0,794.0
0.059,17,2,152,1,76,0.0,48.0,48.0,1,76,0.0,48.0,48.0
0.098,6,10,1506,5,395,21.0,127.0,127.0,5,1111,21.0,843.0,843.0
0.005,6,10,2000,5,927,1.0,659.0,659.0,5,1073,1.0,805.0,805.0
0.007,6,10,1689,5,839,1.0,571.0,571.0,5,850,1.0,582.0,582.0
0.081,6,10,1506,5,395,14.0,127.0,127.0,5,1111,18.0,843.0,843.0
106.999,58,3,216,2,144,106999.0,24.0,24.0,1,72,0.0,24.0,24.0
300.029,6,12,1782,7,1348,50004.0,494.0,494.0,5,434,75006.0,83.0,83.0
0.006,6,10,1547,5,764,1.0,496.0,496.0,5,783,1.0,515.0,515.0
40.066,17,10,676,5,460,10011.0,104.0,64.0,5,216,10015.0,20.0,15.0
0.015,6,10,1989,5,910,3.0,642.0,642.0,5,1079,3.0,811.0,811.0
0.016,6,10,1983,5,910,4.0,642.0,642.0,5,1073,3.0,805.0,805.0
0.119,6,10,1506,5,395,27.0,127.0,127.0,5,1111,26.0,843.0,843.0
0.02,6,10,1983,5,910,4.0,642.0,642.0,5,1073,5.0,805.0,805.0
361.777,6,21,1793,16,1030,24118.0,190.0,190.0,5,763,60014.0,462.0,247.0
0.006,6,10,1547,5,764,1.0,496.0,496.0,5,783,1.0,515.0,515.0
0.011,6,10,1983,5,910,2.0,642.0,642.0,5,1073,2.0,805.0,805.0
0.001,17,2,180,1,66,0.0,38.0,38.0,1,114,0.0,86.0,86.0
0.016,6,13,3735,7,497,2.0,125.0,125.0,6,3238,3.0,1470.0,1459.0
0.008,6,10,1762,5,911,1.0,643.0,643.0,5,851,2.0,583.0,583.0
0.004,6,10,1702,5,863,1.0,595.0,595.0,5,839,0.0,571.0,571.0
0.152,6,10,1506,5,395,35.0,127.0,127.0,5,1111,33.0,843.0,843.0
15.073,17,15,9238,8,6902,2149.0,1350.0,834.0,7,2336,2507.0,1350.0,305.0
0.005,17,2,170,1,65,0.0,37.0,37.0,1,105,0.0,77.0,77.0
0.008,6,10,1972,5,910,1.0,642.0,642.0,5,1062,2.0,794.0,794.0
0.018,6,13,3735,7,497,3.0,125.0,125.0,6,3238,3.0,1470.0,1459.0
0.004,6,10,2006,5,927,1.0,659.0,659.0,5,1079,1.0,811.0,811.0
0.001,17,2,180,1,66,0.0,38.0,38.0,1,114,0.0,86.0,86.0
308.677,17,20,1124,10,716,34283.0,48.0,43.0,10,408,34283.0,20.0,12.0
15.083,17,16,8482,8,6415,2150.0,1350.0,773.0,8,2067,2150.0,1350.0,230.0
0.006,17,2,179,1,71,0.0,43.0,43.0,1,108,0.0,80.0,80.0
0.009,6,12,1926,6,1189,1.0,659.0,434.0,6,737,1.0,417.0,417.0
0.004,6,10,1989,5,927,1.0,659.0,659.0,5,1062,1.0,794.0,794.0
0.037,17,4,284,2,120,0.0,32.0,32.0,2,164,34.0,60.0,54.0
0.005,6,14,3799,7,509,0.0,137.0,137.0,7,3290,0.0,1448.0,972.0
331.893,17,20,1124,10,716,36863.0,48.0,43.0,10,408,36863.0,20.0,12.0
0.006,6,10,1547,5,764,1.0,496.0,496.0,5,783,1.0,515.0,515.0
0.005,6,10,2006,5,927,1.0,659.0,659.0,5,1079,1.0,811.0,811.0
0.006,6,10,2007,5,928,1.0,660.0,660.0,5,1079,1.0,811.0,811.0
0.013,17,2,152,1,76,0.0,48.0,48.0,1,76,0.0,48.0,48.0
0.103,6,10,1506,5,395,25.0,127.0,127.0,5,1111,22.0,843.0,843.0
0.079,6,10,1506,5,395,18.0,127.0,127.0,5,1111,17.0,843.0,843.0
240.105,6,32,9602,16,7023,16007.0,2094.0,688.0,16,2579,16006.0,580.0,217.0
0.007,17,2,179,1,71,0.0,43.0,43.0,1,108,0.0,80.0,80.0
0.004,6,10,1989,5,927,1.0,659.0,659.0,5,1062,1.0,794.0,794.0
0.011,6,14,3787,7,497,1.0,125.0,125.0,7,3290,1.0,1448.0,972.0
0.001,17,2,180,1,66,0.0,38.0,38.0,1,114,0.0,86.0,86.0
0.103,6,10,1506,5,395,25.0,127.0,127.0,5,1111,24.0,843.0,843.0
0.004,6,10,1989,5,927,1.0,659.0,659.0,5,1062,1.0,794.0,794.0
240.101,6,16,4481,9,963,30012.0,238.0,166.0,7,3518,40016.0,1402.0,786.0
0.005,6,10,1989,5,927,1.0,659.0,659.0,5,1062,1.0,794.0,794.0
0.004,6,10,2007,5,928,1.0,660.0,660.0,5,1079,1.0,811.0,811.0
0.009,6,10,1983,5,910,2.0,642.0,642.0,5,1073,2.0,805.0,805.0
0.005,17,2,140,1,62,0.0,34.0,34.0,1,78,0.0,50.0,50.0
0.998,6,13,3922,7,2139,125.0,1328.0,923.0,6,1783,150.0,1539.0,1539.0
0.004,6,10,1774,5,923,1.0,655.0,655.0,5,851,1.0,583.0,583.0
11.219,17,28,4419,14,1994,850.0,269.0,114.0,14,2425,850.0,588.0,145.0
0.012,6,10,1762,5,911,2.0,643.0,643.0,5,851,3.0,583.0,583.0
0.005,6,10,2000,5,927,1.0,659.0,659.0,5,1073,1.0,805.0,805.0
0.005,6,10,1989,5,927,1.0,659.0,659.0,5,1062,1.0,794.0,794.0
0.004,17,4,284,2,120,0.0,32.0,32.0,2,164,0.0,60.0,54.0
0.004,6,10,1779,5,928,1.0,660.0,660.0,5,851,1.0,583.0,583.0
63.632,6,38,12854,19,7296,491.0,2720.0,1300.0,19,5558,3525.0,2667.0,435.0
0.2,6,3,453,2,321,200.0,241.0,241.0,1,132,0.0,92.0,92.0
0.005,6,10,1989,5,927,1.0,659.0,659.0,5,1062,1.0,794.0,794.0
0.155,6,10,1506,5,395,31.0,127.0,127.0,5,1111,36.0,843.0,843.0
0.007,6,10,1972,5,910,1.0,642.0,642.0,5,1062,1.0,794.0,794.0
0.009,6,10,1989,5,910,2.0,642.0,642.0,5,1079,2.0,811.0,811.0
0.007,6,10,1989,5,910,1.0,642.0,642.0,5,1079,1.0,811.0,811.0
0.016,6,10,1677,5,827,3.0,559.0,559.0,5,850,4.0,582.0,582.0
0.03,6,10,1989,5,910,7.0,642.0,642.0,5,1079,7.0,811.0,811.0
0.005,6,10,2007,5,928,1.0,660.0,660.0,5,1079,1.0,811.0,811.0
0.113,6,10,1506,5,395,27.0,127.0,127.0,5,1111,25.0,843.0,843.0
0.007,6,10,1689,5,839,1.0,571.0,571.0,5,850,1.0,582.0,582.0
0.001,17,2,136,1,60,0.0,32.0,32.0,1,76,0.0,48.0,48.0
0.006,6,10,2007,5,928,1.0,660.0,660.0,5,1079,1.0,811.0,811.0
0.005,6,10,1689,5,839,1.0,571.0,571.0,5,850,1.0,582.0,582.0
0.013,6,10,1989,5,910,3.0,642.0,642.0,5,1079,3.0,811.0,811.0
0.008,6,10,1989,5,910,2.0,642.0,642.0,5,1079,1.0,811.0,811.0
0.072,6,25,10106,12,8836,6.0,2883.0,1173.0,13,1270,5.0,253.0,99.0
10.852,17,28,4423,14,1994,825.0,269.0,114.0,14,2429,825.0,588.0,145.0
0.005,6,10,1689,5,839,1.0,571.0,571.0,5,850,1.0,582.0,582.0
40.063,17,10,676,5,460,10014.0,104.0,64.0,5,216,10015.0,20.0,15.0
0.009,6,12,1926,6,1189,1.0,659.0,434.0,6,737,1.0,417.0,417.0
0.009,6,10,1989,5,910,2.0,642.0,642.0,5,1079,2.0,811.0,811.0
0.018,6,10,1972,5,910,4.0,642.0,642.0,5,1062,4.0,794.0,794.0
0.011,6,10,1989,5,910,2.0,642.0,642.0,5,1079,2.0,811.0,811.0
0.034,17,2,213,1,69,0.0,41.0,41.0,1,144,0.0,116.0,116.0
240.095,6,16,4481,9,963,30011.0,238.0,166.0,7,3518,40015.0,1402.0,786.0
0.101,6,10,1506,5,395,23.0,127.0,127.0,5,1111,22.0,843.0,843.0
0.016,6,10,1631,5,848,4.0,580.0,580.0,5,783,3.0,515.0,515.0
0.03,6,10,1762,5,911,7.0,643.0,643.0,5,851,7.0,583.0,583.0
175.038,17,78,11183,39,2621,4606.0,44.0,39.0,39,8562,4606.0,239.0,191.0
0.006,6,10,1547,5,764,1.0,496.0,496.0,5,783,1.0,515.0,515.0
0.005,6,10,2000,5,927,1.0,659.0,659.0,5,1073,1.0,805.0,805.0
173.057,17,80,11207,40,2664,4437.0,44.0,38.0,40,8543,4437.0,260.0,185.0
0.088,6,10,1506,5,395,18.0,127.0,127.0,5,1111,18.0,843.0,843.0
0.004,6,10,1774,5,923,1.0,655.0,655.0,5,851,1.0,583.0,583.0
167.037,17,86,12365,43,2892,3977.0,44.0,39.0,43,9473,3977.0,239.0,192.0
0.015,6,10,1972,5,910,3.0,642.0,642.0,5,1062,3.0,794.0,794.0
0.011,6,10,1989,5,910,2.0,642.0,642.0,5,1079,2.0,811.0,811.0
0.016,6,10,1677,5,827,3.0,559.0,559.0,5,850,4.0,582.0,582.0
0.075,6,10,1506,5,395,17.0,127.0,127.0,5,1111,13.0,843.0,843.0
0.008,6,10,1989,5,910,2.0,642.0,642.0,5,1079,1.0,811.0,811.0
0.005,17,2,214,1,75,0.0,47.0,47.0,1,139,0.0,111.0,111.0
40.066,17,10,676,5,460,10015.0,104.0,64.0,5,216,10015.0,20.0,15.0
0.004,17,4,284,2,120,0.0,32.0,32.0,2,164,1.0,60.0,54.0
0.005,17,2,170,1,65,0.0,37.0,37.0,1,105,0.0,77.0,77.0
0.01,6,10,1983,5,910,2.0,642.0,642.0,5,1073,2.0,805.0,805.0
0.005,6,10,2006,5,927,1.0,659.0,659.0,5,1079,1.0,811.0,811.0
0.007,17,2,170,1,65,0.0,37.0,37.0,1,105,0.0,77.0,77.0
0.005,6,10,1689,5,839,1.0,571.0,571.0,5,850,1.0,582.0,582.0
0.001,17,2,180,1,66,0.0,38.0,38.0,1,114,0.0,86.0,86.0
0.006,6,10,1547,5,764,1.0,496.0,496.0,5,783,1.0,515.0,515.0
0.042,17,2,184,1,61,0.0,33.0,33.0,1,123,0.0,95.0,95.0
11.401,17,28,4389,14,2312,864.0,587.0,137.0,14,2077,864.0,268.0,120.0
0.004,6,10,2006,5,927,1.0,659.0,659.0,5,1079,1.0,811.0,811.0
0.004,6,10,1702,5,863,0.0,595.0,595.0,5,839,1.0,571.0,571.0
0.005,6,10,1643,5,860,1.0,592.0,592.0,5,783,1.0,515.0,515.0
0.005,6,10,1989,5,927,1.0,659.0,659.0,5,1062,1.0,794.0,794.0
0.005,6,10,2006,5,927,1.0,659.0,659.0,5,1079,1.0,811.0,811.0
0.005,6,10,2006,5,927,1.0,659.0,659.0,5,1079,1.0,811.0,811.0
0.081,6,10,1506,5,395,18.0,127.0,127.0,5,1111,15.0,843.0,843.0
0.012,6,14,3787,7,497,1.0,125.0,125.0,7,3290,1.0,1448.0,972.0
0.004,17,2,148,1,60,0.0,32.0,32.0,1,88,0.0,60.0,60.0
0.004,6,10,2007,5,928,1.0,660.0,660.0,5,1079,1.0,811.0,811.0
40.068,17,10,676,5,460,10016.0,104.0,64.0,5,216,10016.0,20.0,15.0
0.005,6,10,2007,5,928,1.0,660.0,660.0,5,1079,1.0,811.0,811.0
0.017,6,10,1989,5,910,4.0,642.0,642.0,5,1079,4.0,811.0,811.0
0.005,6,10,1989,5,927,1.0,659.0,659.0,5,1062,1.0,794.0,794.0
0.005,6,10,2006,5,927,1.0,659.0,659.0,5,1079,1.0,811.0,811.0
0.005,6,13,3747,7,509,0.0,137.0,137.0,6,3238,0.0,1470.0,1459.0
0.005,17,2,148,1,60,0.0,32.0,32.0,1,88,0.0,60.0,60.0
0.101,6,10,1506,5,395,24.0,127.0,127.0,5,1111,23.0,843.0,843.0
40.066,17,10,676,5,460,10014.0,104.0,64.0,5,216,10015.0,20.0,15.0
0.017,6,10,1990,5,911,4.0,643.0,643.0,5,1079,4.0,811.0,811.0
0.005,6,10,2007,5,928,1.0,660.0,660.0,5,1079,1.0,811.0,811.0
0.004,6,10,1989,5,927,1.0,659.0,659.0,5,1062,1.0,794.0,794.0
0.016,6,10,1677,5,827,4.0,559.0,559.0,5,850,3.0,582.0,582.0
0.015,6,10,1990,5,911,3.0,643.0,643.0,5,1079,3.0,811.0,811.0
300.023,6,12,1782,7,1348,50003.0,494.0,494.0,5,434,75004.0,83.0,83.0
0.091,6,10,1506,5,395,19.0,127.0,127.0,5,1111,21.0,843.0,843.0
0.151,6,10,1506,5,395,36.0,127.0,127.0,5,1111,30.0,843.0,843.0
0.171,6,3,453,2,321,171.0,241.0,241.0,1,132,0.0,92.0,92.0
0.004,17,2,148,1,60,0.0,32.0,32.0,1,88,0.0,60.0,60.0
0.038,17,2,136,1,60,0.0,32.0,32.0,1,76,0.0,48.0,48.0
0.11,6,10,1506,5,395,25.0,127.0,127.0,5,1111,24.0,843.0,843.0
0.079,6,10,1506,5,395,18.0,127.0,127.0,5,1111,17.0,843.0,843.0
0.001,17,2,180,1,66,0.0,38.0,38.0,1,114,0.0,86.0,86.0
0.001,17,2,180,1,66,0.0,38.0,38.0,1,114,0.0,86.0,86.0
0.012,6,10,1989,5,910,3.0,642.0,642.0,5,1079,2.0,811.0,811.0
0.005,6,14,3736,7,446,0.0,74.0,74.0,7,3290,0.0,1448.0,972.0
0.004,6,10,1779,5,928,1.0,660.0,660.0,5,851,1.0,583.0,583.0
0.001,17,2,180,1,66,0.0,38.0,38.0,1,114,0.0,86.0,86.0
240.497,6,37,9660,19,2175,13360.0,747.0,235.0,18,7485,14146.0,1402.0,595.0
0.004,6,10,2006,5,927,1.0,659.0,659.0,5,1079,1.0,811.0,811.0
0.004,17,2,136,1,60,0.0,32.0,32.0,1,76,0.0,48.0,48.0
1798.247,17,3420,257736,1704,136366,1055.0,75.0,52.0,1716,121370,1048.0,226.0,42.0
240.09,6,32,9311,16,6797,16006.0,1868.0,663.0,16,2514,16005.0,580.0,209.0
0.011,6,10,1990,5,911,2.0,643.0,643.0,5,1079,2.0,811.0,811.0
0.002,17,2,180,1,66,0.0,38.0,38.0,1,114,0.0,86.0,86.0
0.005,6,10,1989,5,927,1.0,659.0,659.0,5,1062,1.0,794.0,794.0
354.079,6,19,1691,15,978,25291.0,190.0,190.0,4,713,80003.0,497.0,497.0
0.042,17,2,152,1,76,0.0,48.0,48.0,1,76,0.0,48.0,48.0
0.006,6,10,1854,5,889,1.0,621.0,621.0,5,965,1.0,697.0,697.0
10.886,17,28,4422,14,1994,829.0,269.0,114.0,14,2428,828.0,587.0,145.0
0.016,6,10,1990,5,911,4.0,643.0,643.0,5,1079,3.0,811.0,811.0
0.073,6,10,1506,5,395,16.0,127.0,127.0,5,1111,15.0,843.0,843.0
0.005,6,13,3747,7,509,0.0,137.0,137.0,6,3238,0.0,1470.0,1459.0
0.005,6,10,1989,5,927,1.0,659.0,659.0,5,1062,1.0,794.0,794.0
0.042,17,4,284,2,120,0.0,32.0,32.0,2,164,39.0,60.0,54.0
0.005,6,10,1989,5,927,1.0,659.0,659.0,5,1062,1.0,794.0,794.0
0.005,6,13,3747,7,509,0.0,137.0,137.0,6,3238,0.0,1470.0,1459.0
0.005,17,2,144,1,64,0.0,36.0,36.0,1,80,0.0,52.0,52.0
161.088,6,22,9233,11,1575,74.0,794.0,367.0,11,7658,16096.0,1360.0,1029.0
0.005,6,10,2007,5,928,1.0,660.0,660.0,5,1079,1.0,811.0,811.0
0.005,6,13,3747,7,509,0.0,137.0,137.0,6,3238,1.0,1470.0,1459.0
0.005,6,10,1689,5,839,1.0,571.0,571.0,5,850,1.0,582.0,582.0
0.006,6,10,1547,5,764,1.0,496.0,496.0,5,783,1.0,515.0,515.0
0.015,6,10,1762,5,911,3.0,643.0,643.0,5,851,3.0,583.0,583.0
0.039,17,4,284,2,120,0.0,32.0,32.0,2,164,34.0,60.0,54.0
0.032,6,10,1983,5,910,8.0,642.0,642.0,5,1073,7.0,805.0,805.0
0.091,6,10,1506,5,395,20.0,127.0,127.0,5,1111,20.0,843.0,843.0
0.069,6,10,1989,5,910,17.0,642.0,642.0,5,1079,17.0,811.0,811.0
0.014,6,10,1972,5,910,3.0,642.0,642.0,5,1062,3.0,794.0,794.0
0.01,6,10,1972,5,910,2.0,642.0,642.0,5,1062,2.0,794.0,794.0
0.005,6,10,1689,5,839,1.0,571.0,571.0,5,850,1.0,582.0,582.0
0.123,6,10,1506,5,395,27.0,127.0,127.0,5,1111,26.0,843.0,843.0
0.086,6,10,1506,5,395,19.0,127.0,127.0,5,1111,19.0,843.0,843.0
0.003,17,2,148,1,60,0.0,32.0,32.0,1,88,0.0,60.0,60.0
0.005,6,10,2007,5,928,1.0,660.0,660.0,5,1079,1.0,811.0,811.0
10.799,17,28,4418,14,1995,822.0,270.0,114.0,14,2423,822.0,586.0,145.0
0.009,6,13,3735,7,497,1.0,125.0,125.0,6,3238,1.0,1470.0,1459.0
0.093,6,10,1506,5,395,20.0,127.0,127.0,5,1111,21.0,843.0,843.0
0.012,6,10,1677,5,827,3.0,559.0,559.0,5,850,2.0,582.0,582.0
494.146,6,33,12116,18,2671,29067.0,585.0,345.0,15,9445,31006.0,1402.0,961.0
0.005,6,10,2000,5,927,1.0,659.0,659.0,5,1073,1.0,805.0,805.0
0.005,6,10,2000,5,927,1.0,659.0,659.0,5,1073,1.0,805.0,805.0
11.155,17,28,4418,14,1993,845.0,268.0,114.0,14,2425,845.0,588.0,145.0
0.006,17,2,179,1,71,0.0,43.0,43.0,1,108,0.0,80.0,80.0
0.071,6,10,1506,5,395,15.0,127.0,127.0,5,1111,13.0,843.0,843.0
353.359,6,20,2210,6,1308,12003.0,494.0,494.0,14,902,27181.0,83.0,83.0
0.015,6,10,1677,5,827,3.0,559.0,559.0,5,850,3.0,582.0,582.0
0.011,6,10,1972,5,910,2.0,642.0,642.0,5,1062,2.0,794.0,794.0
0.005,6,10,2007,5,928,1.0,660.0,660.0,5,1079,1.0,811.0,811.0
0.006,6,10,1547,5,764,1.0,496.0,496.0,5,783,1.0,515.0,515.0
0.001,17,2,180,1,66,0.0,38.0,38.0,1,114,0.0,86.0,86.0
1777.937,17,144,45504,72,22752,25041.0,288.0,288.0,72,22752,25041.0,288.0,288.0
0.009,6,12,1926,6,1189,1.0,659.0,434.0,6,737,1.0,417.0,417.0
0.1,6,10,1506,5,395,18.0,127.0,127.0,5,1111,23.0,843.0,843.0
0.014,6,10,1972,5,910,3.0,642.0,642.0,5,1062,3.0,794.0,794.0
0.009,6,10,1972,5,910,2.0,642.0,642.0,5,1062,2.0,794.0,794.0
0.114,6,10,1506,5,395,23.0,127.0,127.0,5,1111,28.0,843.0,843.0
0.005,17,2,214,1,75,0.0,47.0,47.0,1,139,0.0,111.0,111.0
317.461,17,20,1124,10,716,35266.0,48.0,43.0,10,408,35266.0,20.0,12.0
0.007,17,2,179,1,71,0.0,43.0,43.0,1,108,0.0,80.0,80.0
0.037,17,2,136,1,60,0.0,32.0,32.0,1,76,0.0,48.0,48.0
0.113,6,10,1506,5,395,24.0,127.0,127.0,5,1111,21.0,843.0,843.0
0.004,17,2,148,1,60,0.0,32.0,32.0,1,88,0.0,60.0,60.0
0.005,6,10,2000,5,927,1.0,659.0,659.0,5,1073,1.0,805.0,805.0
1764.011,6,453,66498,254,35296,6972.0,613.0,197.0,199,31202,8908.0,453.0,146.0
0.094,6,10,1506,5,395,20.0,127.0,127.0,5,1111,19.0,843.0,843.0
0.005,6,10,2000,5,927,1.0,659.0,659.0,5,1073,1.0,805.0,805.0
0.026,6,10,1989,5,910,6.0,642.0,642.0,5,1079,6.0,811.0,811.0
0.067,6,10,1506,5,395,16.0,127.0,127.0,5,1111,15.0,843.0,843.0
0.156,17,2,152,1,76,0.0,48.0,48.0,1,76,0.0,48.0,48.0
0.003,17,2,170,1,65,0.0,37.0,37.0,1,105,0.0,77.0,77.0
0.117,6,10,1506,5,395,27.0,127.0,127.0,5,1111,23.0,843.0,843.0
0.116,6,10,1506,5,395,21.0,127.0,127.0,5,1111,24.0,843.0,843.0
0.814,6,10,2009,6,1655,162.0,1403.0,1403.0,4,354,192.0,182.0,182.0
0.004,6,10,2006,5,927,1.0,659.0,659.0,5,1079,1.0,811.0,811.0
0.007,6,10,2006,5,927,1.0,659.0,659.0,5,1079,1.0,811.0,811.0
0.003,17,2,136,1,60,0.0,32.0,32.0,1,76,0.0,48.0,48.0
0.009,6,10,2000,5,927,2.0,659.0,659.0,5,1073,2.0,805.0,805.0
0.005,6,10,1989,5,927,1.0,659.0,659.0,5,1062,1.0,794.0,794.0
0.015,6,10,1677,5,827,3.0,559.0,559.0,5,850,3.0,582.0,582.0
301.261,6,52,19503,29,13511,10759.0,2720.0,1230.0,23,5992,411.0,2667.0,361.0
0.012,6,10,1631,5,848,3.0,580.0,580.0,5,783,2.0,515.0,515.0
0.013,6,10,1762,5,911,3.0,643.0,643.0,5,851,3.0,583.0,583.0
308.282,17,20,1124,10,716,34235.0,48.0,43.0,10,408,34241.0,20.0,12.0
0.001,17,2,179,1,62,0.0,34.0,34.0,1,117,0.0,89.0,89.0
40.053,17,10,676,5,460,10012.0,104.0,64.0,5,216,10012.0,20.0,15.0
0.005,6,10,2007,5,928,1.0,660.0,660.0,5,1079,1.0,811.0,811.0
0.009,6,10,1989,5,910,2.0,642.0,642.0,5,1079,2.0,811.0,811.0
0.138,6,29,10461,16,8994,9.0,2261.0,906.0,13,1467,10.0,304.0,131.0
10.98,17,28,4422,14,1994,835.0,269.0,114.0,14,2428,835.0,587.0,145.0
0.004,6,10,2007,5,928,1.0,660.0,660.0,5,1079,1.0,811.0,811.0
0.074,6,10,1506,5,395,18.0,127.0,127.0,5,1111,14.0,843.0,843.0
0.005,17,2,179,1,71,0.0,43.0,43.0,1,108,0.0,80.0,80.0
0.013,6,10,1990,5,911,3.0,643.0,643.0,5,1079,3.0,811.0,811.0
0.012,6,10,1631,5,848,3.0,580.0,580.0,5,783,3.0,515.0,515.0
0.137,6,10,1506,5,395,32.0,127.0,127.0,5,1111,32.0,843.0,843.0
0.078,6,10,1506,5,395,16.0,127.0,127.0,5,1111,17.0,843.0,843.0
0.089,6,10,1506,5,395,21.0,127.0,127.0,5,1111,20.0,843.0,843.0
0.001,17,2,180,1,66,0.0,38.0,38.0,1,114,0.0,86.0,86.0
0.004,6,10,1779,5,928,1.0,660.0,660.0,5,851,1.0,583.0,583.0
0.109,6,10,1506,5,395,21.0,127.0,127.0,5,1111,21.0,843.0,843.0
0.006,6,10,1547,5,764,1.0,496.0,496.0,5,783,1.0,515.0,515.0
0.037,6,10,1972,5,910,9.0,642.0,642.0,5,1062,9.0,794.0,794.0
0.005,6,13,3690,7,452,0.0,80.0,80.0,6,3238,1.0,1470.0,1459.0
0.013,6,13,3735,7,497,2.0,125.0,125.0,6,3238,2.0,1470.0,1459.0
0.018,6,10,1983,5,910,4.0,642.0,642.0,5,1073,4.0,805.0,805.0
0.009,6,10,1972,5,910,2.0,642.0,642.0,5,1062,2.0,794.0,794.0
0.067,17,8,3613,4,1874,22.0,1350.0,440.0,4,1739,11.0,1350.0,406.0
0.005,17,2,136,1,60,0.0,32.0,32.0,1,76,0.0,48.0,48.0
0.008,6,10,1972,5,910,2.0,642.0,642.0,5,1062,1.0,794.0,794.0
0.099,6,10,1506,5,395,20.0,127.0,127.0,5,1111,22.0,843.0,843.0
0.01,6,10,1631,5,848,2.0,580.0,580.0,5,783,2.0,515.0,515.0
0.01,6,10,1990,5,911,2.0,643.0,643.0,5,1079,2.0,811.0,811.0
0.019,6,10,1972,5,910,4.0,642.0,642.0,5,1062,4.0,794.0,794.0
15.075,17,16,8923,8,6640,2149.0,1350.0,802.0,8,2283,2149.0,1350.0,257.0
0.009,6,10,1989,5,910,2.0,642.0,642.0,5,1079,2.0,811.0,811.0
0.071,6,10,1506,5,395,16.0,127.0,127.0,5,1111,16.0,843.0,843.0
0.072,17,2,148,1,60,0.0,32.0,32.0,1,88,0.0,60.0,60.0
240.091,6,16,4481,9,963,30011.0,238.0,166.0,7,3518,40014.0,1402.0,786.0
0.005,6,10,2007,5,928,1.0,660.0,660.0,5,1079,1.0,811.0,811.0
0.005,6,10,2007,5,928,1.0,660.0,660.0,5,1079,1.0,811.0,811.0
0.005,17,2,144,1,64,0.0,36.0,36.0,1,80,0.0,52.0,52.0
0.006,17,2,230,1,68,0.0,40.0,40.0,1,162,0.0,134.0,134.0
0.004,6,10,2006,5,927,1.0,659.0,659.0,5,1079,1.0,811.0,811.0
0.168,17,2,152,1,76,0.0,48.0,48.0,1,76,0.0,48.0,48.0
0.009,6,10,1762,5,911,2.0,643.0,643.0,5,851,2.0,583.0,583.0
0.106,6,10,1506,5,395,24.0,127.0,127.0,5,1111,22.0,843.0,843.0
40.07,17,10,676,5,460,10016.0,104.0,64.0,5,216,10016.0,20.0,15.0
11.454,17,28,4390,14,2312,868.0,587.0,137.0,14,2078,868.0,269.0,120.0
40.065,17,10,676,5,460,10015.0,104.0,64.0,5,216,10015.0,20.0,15.0
0.085,6,10,1506,5,395,18.0,127.0,127.0,5,1111,19.0,843.0,843.0
240.02,6,9,787,5,488,60005.0,232.0,232.0,4,299,80005.0,83.0,83.0
0.013,6,10,1972,5,910,3.0,642.0,642.0,5,1062,3.0,794.0,794.0
0.07,6,10,1506,5,395,16.0,127.0,127.0,5,1111,17.0,843.0,843.0
0.005,6,10,1779,5,928,1.0,660.0,660.0,5,851,1.0,583.0,583.0
0.218,6,16,2670,8,1396,31.0,533.0,324.0,8,1274,20.0,529.0,212.0
0.001,17,2,136,1,60,0.0,32.0,32.0,1,76,0.0,48.0,48.0
0.111,6,10,1506,5,395,26.0,127.0,127.0,5,1111,21.0,843.0,843.0
0.008,17,2,179,1,71,0.0,43.0,43.0,1,108,0.0,80.0,80.0
0.088,6,10,1506,5,395,18.0,127.0,127.0,5,1111,18.0,843.0,843.0
0.109,6,10,1506,5,395,26.0,127.0,127.0,5,1111,26.0,843.0,843.0
0.041,17,4,596,2,122,0.0,33.0,33.0,2,474,38.0,323.0,209.0
0.007,6,12,1698,6,863,1.0,327.0,271.0,6,835,1.0,515.0,515.0
0.075,6,10,1506,5,395,17.0,127.0,127.0,5,1111,15.0,843.0,843.0
0.005,6,10,1774,5,923,1.0,655.0,655.0,5,851,1.0,583.0,583.0
0.119,6,10,1506,5,395,27.0,127.0,127.0,5,1111,27.0,843.0,843.0
0.012,6,10,1989,5,910,2.0,642.0,642.0,5,1079,2.0,811.0,811.0
0.042,17,2,170,1,65,0.0,37.0,37.0,1,105,0.0,77.0,77.0
0.005,6,10,2006,5,927,1.0,659.0,659.0,5,1079,1.0,811.0,811.0
293.872,6,376,347045,184,21131,1605.0,2736.0,888.0,192,325914,1538.0,2804.0,1774.0
240.074,6,16,4481,9,963,30009.0,238.0,166.0,7,3518,40011.0,1402.0,786.0
0.044,17,4,284,2,120,4.0,32.0,32.0,2,164,39.0,60.0,54.0
0.014,6,10,1631,5,848,3.0,580.0,580.0,5,783,3.0,515.0,515.0
0.004,17,2,148,1,60,0.0,32.0,32.0,1,88,0.0,60.0,60.0
0.051,6,10,1989,5,910,12.0,642.0,642.0,5,1079,12.0,811.0,811.0
0.004,6,10,1989,5,927,1.0,659.0,659.0,5,1062,1.0,794.0,794.0
240.713,6,35,8922,18,2071,14157.0,692.0,225.0,17,6851,15042.0,1402.0,597.0
0.001,17,2,164,1,74,0.0,46.0,46.0,1,90,0.0,62.0,62.0
40.057,17,10,676,5,460,10012.0,104.0,64.0,5,216,10013.0,20.0,15.0
40.052,17,10,676,5,460,10012.0,104.0,64.0,5,216,10012.0,20.0,15.0
0.001,17,2,180,1,66,0.0,38.0,38.0,1,114,0.0,86.0,86.0
0.005,6,10,1779,5,928,1.0,660.0,660.0,5,851,1.0,583.0,583.0
40.054,17,10,676,5,460,10012.0,104.0,64.0,5,216,10012.0,20.0,15.0
1770.594,6,82,4315,41,2159,44263.0,27.0,27.0,41,2156,44263.0,24.0,24.0
0.006,6,10,1547,5,764,1.0,496.0,496.0,5,783,1.0,515.0,515.0
0.078,6,10,1506,5,395,17.0,127.0,127.0,5,1111,17.0,843.0,843.0
0.015,6,10,1989,5,910,3.0,642.0,642.0,5,1079,3.0,811.0,811.0
0.087,6,10,1506,5,395,19.0,127.0,127.0,5,1111,20.0,843.0,843.0
0.108,6,10,1506,5,395,25.0,127.0,127.0,5,1111,26.0,843.0,843.0
40.062,17,10,676,5,460,10012.0,104.0,64.0,5,216,10014.0,20.0,15.0
9.036,17,6,376,5,280,2259.0,28.0,28.0,1,96,0.0,68.0,68.0
40.063,17,10,676,5,460,10012.0,104.0,64.0,5,216,10014.0,20.0,15.0
0.01,6,10,1631,5,848,2.0,580.0,580.0,5,783,2.0,515.0,515.0
161.594,17,78,11003,39,2605,4252.0,44.0,38.0,39,8398,4252.0,252.0,187.0
0.007,17,2,179,1,71,0.0,43.0,43.0,1,108,0.0,80.0,80.0
0.069,6,10,1506,5,395,15.0,127.0,127.0,5,1111,14.0,843.0,843.0
0.01,6,10,1983,5,910,2.0,642.0,642.0,5,1073,2.0,805.0,805.0
1795.618,6,307,97998,190,86570,9500.0,2001.0,672.0,117,11428,15479.0,452.0,71.0
240.019,6,9,787,5,488,60004.0,232.0,232.0,4,299,80005.0,83.0,83.0
0.013,6,10,1989,5,910,3.0,642.0,642.0,5,1079,3.0,811.0,811.0
0.007,6,10,1547,5,764,1.0,496.0,496.0,5,783,1.0,515.0,515.0
0.005,6,10,2000,5,927,1.0,659.0,659.0,5,1073,1.0,805.0,805.0
176.125,17,76,10778,38,2544,4759.0,44.0,38.0,38,8234,4759.0,239.0,188.0
0.003,17,2,136,1,60,0.0,32.0,32.0,1,76,0.0,48.0,48.0
0.004,6,10,1774,5,923,1.0,655.0,655.0,5,851,1.0,583.0,583.0
0.003,17,2,185,1,73,0.0,45.0,45.0,1,112,0.0,84.0,84.0
0.006,6,10,1689,5,839,1.0,571.0,571.0,5,850,1.0,582.0,582.0
376.37,6,22,2313,16,867,25091.0,195.0,195.0,6,1446,4643.0,419.0,398.0
300.393,6,16,2170,9,684,37529.0,146.0,146.0,7,1486,50038.0,419.0,398.0
0.008,6,10,1854,5,889,2.0,621.0,621.0,5,965,2.0,697.0,697.0
0.004,17,2,148,1,60,0.0,32.0,32.0,1,88,0.0,60.0,60.0
0.078,6,10,1506,5,395,17.0,127.0,127.0,5,1111,18.0,843.0,843.0
0.016,6,10,1990,5,911,4.0,643.0,643.0,5,1079,3.0,811.0,811.0
0.004,17,2,148,1,60,0.0,32.0,32.0,1,88,0.0,60.0,60.0
0.06,17,2,152,1,76,0.0,48.0,48.0,1,76,0.0,48.0,48.0
0.011,6,10,1989,5,910,2.0,642.0,642.0,5,1079,2.0,811.0,811.0
0.004,6,10,1779,5,928,1.0,660.0,660.0,5,851,1.0,583.0,583.0
0.015,6,10,1989,5,910,3.0,642.0,642.0,5,1079,3.0,811.0,811.0
0.071,6,10,1506,5,395,15.0,127.0,127.0,5,1111,16.0,843.0,843.0
0.14,6,10,1506,5,395,34.0,127.0,127.0,5,1111,32.0,843.0,843.0
0.015,17,2,166,1,75,0.0,47.0,47.0,1,91,0.0,63.0,63.0
0.006,6,10,1547,5,764,1.0,496.0,496.0,5,783,1.0,515.0,515.0
0.009,6,10,1989,5,910,2.0,642.0,642.0,5,1079,2.0,811.0,811.0
0.092,6,10,1506,5,395,18.0,127.0,127.0,5,1111,19.0,843.0,843.0
40.075,17,10,676,5,460,10015.0,104.0,64.0,5,216,10017.0,20.0,15.0
0.069,6,10,1506,5,395,15.0,127.0,127.0,5,1111,16.0,843.0,843.0
0.006,17,2,179,1,71,0.0,43.0,43.0,1,108,0.0,80.0,80.0
0.006,17,2,169,1,62,0.0,34.0,34.0,1,107,0.0,79.0,79.0
0.214,6,16,2669,8,1395,30.0,533.0,323.0,8,1274,19.0,529.0,212.0
0.008,6,10,1989,5,910,1.0,642.0,642.0,5,1079,2.0,811.0,811.0
0.005,6,10,1989,5,927,1.0,659.0,659.0,5,1062,1.0,794.0,794.0
0.11,6,10,1506,5,395,24.0,127.0,127.0,5,1111,26.0,843.0,843.0
1769.279,17,92,8096,46,4048,39317.0,60.0,60.0,46,4048,39317.0,60.0,60.0
0.005,17,2,169,1,62,0.0,34.0,34.0,1,107,0.0,79.0,79.0
0.012,6,10,1762,5,911,3.0,643.0,643.0,5,851,2.0,583.0,583.0
0.094,6,10,1506,5,395,21.0,127.0,127.0,5,1111,20.0,843.0,843.0
0.067,17,8,3613,4,1874,22.0,1350.0,440.0,4,1739,11.0,1350.0,406.0
0.004,17,2,148,1,60,0.0,32.0,32.0,1,88,0.0,60.0,60.0
0.005,17,2,170,1,65,0.0,37.0,37.0,1,105,0.0,77.0,77.0
11.152,17,28,4423,14,1994,845.0,269.0,114.0,14,2429,845.0,588.0,145.0
0.118,17,2,152,1,76,0.0,48.0,48.0,1,76,0.0,48.0,48.0
0.004,17,4,284,2,120,0.0,32.0,32.0,2,164,0.0,60.0,54.0
0.011,6,10,1972,5,910,2.0,642.0,642.0,5,1062,2.0,794.0,794.0
0.016,6,10,1762,5,911,4.0,643.0,643.0,5,851,4.0,583.0,583.0
0.021,6,10,1689,5,839,5.0,571.0,571.0,5,850,5.0,582.0,582.0
0.093,6,10,1506,5,395,20.0,127.0,127.0,5,1111,20.0,843.0,843.0
0.094,6,10,1506,5,395,21.0,127.0,127.0,5,1111,18.0,843.0,843.0
0.004,17,2,148,1,60,0.0,32.0,32.0,1,88,0.0,60.0,60.0
0.117,6,18,8136,10,808,13.0,280.0,280.0,8,7328,15.0,1402.0,1380.0
0.01,6,10,1989,5,910,2.0,642.0,642.0,5,1079,2.0,811.0,811.0
0.013,6,10,1990,5,911,3.0,643.0,643.0,5,1079,3.0,811.0,811.0
0.005,6,10,2000,5,927,1.0,659.0,659.0,5,1073,1.0,805.0,805.0
0.013,6,10,1677,5,827,3.0,559.0,559.0,5,850,3.0,582.0,582.0
0.005,6,10,1989,5,927,1.0,659.0,659.0,5,1062,1.0,794.0,794.0
0.037,17,2,136,1,60,0.0,32.0,32.0,1,76,0.0,48.0,48.0
0.004,6,13,3690,7,452,0.0,80.0,80.0,6,3238,0.0,1470.0,1459.0
0.124,17,2,170,1,65,0.0,37.0,37.0,1,105,0.0,77.0,77.0
0.159,6,10,1506,5,395,36.0,127.0,127.0,5,1111,32.0,843.0,843.0
0.073,6,10,1506,5,395,16.0,127.0,127.0,5,1111,16.0,843.0,843.0
0.079,6,10,1506,5,395,17.0,127.0,127.0,5,1111,17.0,843.0,843.0
0.004,17,4,284,2,120,0.0,32.0,32.0,2,164,0.0,60.0,54.0
0.004,6,10,1774,5,923,1.0,655.0,655.0,5,851,1.0,583.0,583.0
0.005,6,10,1989,5,927,1.0,659.0,659.0,5,1062,1.0,794.0,794.0
300.795,6,39,11672,21,6154,15039.0,2720.0,880.0,18,5518,507.0,2667.0,435.0
1769.065,17,92,8096,46,4048,39312.0,60.0,60.0,46,4048,39312.0,60.0,60.0
0.099,6,10,1506,5,395,20.0,127.0,127.0,5,1111,23.0,843.0,843.0
0.079,6,10,1506,5,395,18.0,127.0,127.0,5,1111,15.0,843.0,843.0
0.004,6,10,1779,5,928,1.0,660.0,660.0,5,851,1.0,583.0,583.0
0.004,6,10,1702,5,863,1.0,595.0,595.0,5,839,1.0,571.0,571.0
0.004,6,10,2006,5,927,1.0,659.0,659.0,5,1079,1.0,811.0,811.0
0.004,6,10,2006,5,927,1.0,659.0,659.0,5,1079,1.0,811.0,811.0
0.04,17,4,284,2,120,0.0,32.0,32.0,2,164,36.0,60.0,54.0
0.013,6,10,1972,5,910,3.0,642.0,642.0,5,1062,3.0,794.0,794.0
0.06,6,10,1989,5,910,15.0,642.0,642.0,5,1079,15.0,811.0,811.0
0.006,6,13,3690,7,452,0.0,80.0,80.0,6,3238,1.0,1470.0,1459.0
0.011,6,10,1631,5,848,2.0,580.0,580.0,5,783,2.0,515.0,515.0
0.005,17,2,170,1,65,0.0,37.0,37.0,1,105,0.0,77.0,77.0
0.168,17,2,152,1,76,0.0,48.0,48.0,1,76,0.0,48.0,48.0
40.077,17,10,676,5,460,10014.0,104.0,64.0,5,216,10018.0,20.0,15.0
0.011,6,10,1990,5,911,2.0,643.0,643.0,5,1079,2.0,811.0,811.0
0.12,6,10,1506,5,395,26.0,127.0,127.0,5,1111,25.0,843.0,843.0
271.036,17,18,1008,9,640,33863.0,48.0,43.0,9,368,33863.0,20.0,12.0
0.004,17,4,284,2,120,0.0,32.0,32.0,2,164,0.0,60.0,54.0
1794.126,6,553,189891,278,163814,6476.0,2883.0,1002.0,275,26077,6547.0,580.0,114.0
0.15,6,10,1506,5,395,34.0,127.0,127.0,5,1111,33.0,843.0,843.0
0.005,6,10,2007,5,928,1.0,660.0,660.0,5,1079,1.0,811.0,811.0
0.005,17,2,152,1,68,0.0,40.0,40.0,1,84,0.0,56.0,56.0
0.004,6,10,2006,5,927,1.0,659.0,659.0,5,1079,1.0,811.0,811.0
0.011,6,10,1990,5,911,2.0,643.0,643.0,5,1079,2.0,811.0,811.0
0.009,6,10,1989,5,910,2.0,642.0,642.0,5,1079,2.0,811.0,811.0
0.012,6,10,1972,5,910,3.0,642.0,642.0,5,1062,3.0,794.0,794.0
0.009,6,10,1972,5,910,2.0,642.0,642.0,5,1062,2.0,794.0,794.0
0.008,6,10,1989,5,910,2.0,642.0,642.0,5,1079,2.0,811.0,811.0
10.789,17,28,4423,14,1995,821.0,270.0,114.0,14,2428,821.0,587.0,145.0
0.005,6,10,1779,5,928,1.0,660.0,660.0,5,851,1.0,583.0,583.0
1729.223,6,60,4400,40,2740,44339.0,33.0,33.0,20,1660,91002.0,31.0,31.0
0.006,6,10,2000,5,927,1.0,659.0,659.0,5,1073,1.0,805.0,805.0
0.004,6,10,2000,5,927,1.0,659.0,659.0,5,1073,1.0,805.0,805.0
0.268,17,44,25838,25,21235,11.0,1350.0,821.0,19,4603,11.0,1350.0,214.0
0.039,17,2,148,1,60,0.0,32.0,32.0,1,88,0.0,60.0,60.0
0.011,6,10,1983,5,910,2.0,642.0,642.0,5,1073,2.0,805.0,805.0
0.005,6,10,1689,5,839,1.0,571.0,571.0,5,850,1.0,582.0,582.0
0.009,6,10,1989,5,910,2.0,642.0,642.0,5,1079,2.0,811.0,811.0
0.004,6,10,2006,5,927,1.0,659.0,659.0,5,1079,1.0,811.0,811.0
0.005,6,10,1689,5,839,1.0,571.0,571.0,5,850,1.0,582.0,582.0
0.087,6,10,1506,5,395,19.0,127.0,127.0,5,1111,20.0,843.0,843.0
0.003,17,2,148,1,60,0.0,32.0,32.0,1,88,0.0,60.0,60.0
0.006,6,10,1854,5,889,1.0,621.0,621.0,5,965,1.0,697.0,697.0
0.006,6,10,1547,5,764,1.0,496.0,496.0,5,783,1.0,515.0,515.0
0.083,6,10,1506,5,395,17.0,127.0,127.0,5,1111,17.0,843.0,843.0
0.006,6,10,1689,5,839,1.0,571.0,571.0,5,850,1.0,582.0,582.0
0.005,6,10,2007,5,928,1.0,660.0,660.0,5,1079,1.0,811.0,811.0
0.005,6,10,2007,5,928,1.0,660.0,660.0,5,1079,1.0,811.0,811.0
0.008,6,10,2006,5,927,1.0,659.0,659.0,5,1079,2.0,811.0,811.0
0.144,6,10,1506,5,395,33.0,127.0,127.0,5,1111,22.0,843.0,843.0
0.111,6,10,1506,5,395,26.0,127.0,127.0,5,1111,22.0,843.0,843.0
0.113,6,10,1506,5,395,25.0,127.0,127.0,5,1111,22.0,843.0,843.0
0.185,6,10,1506,5,395,42.0,127.0,127.0,5,1111,43.0,843.0,843.0
0.006,17,2,179,1,71,0.0,43.0,43.0,1,108,0.0,80.0,80.0
0.005,17,2,164,1,74,0.0,46.0,46.0,1,90,0.0,62.0,62.0
0.019,6,10,1972,5,910,4.0,642.0,642.0,5,1062,4.0,794.0,794.0
0.005,17,2,166,1,75,0.0,47.0,47.0,1,91,0.0,63.0,63.0
0.006,6,10,2006,5,927,1.0,659.0,659.0,5,1079,1.0,811.0,811.0
0.006,6,10,1547,5,764,1.0,496.0,496.0,5,783,1.0,515.0,515.0
308.536,17,18,1008,9,640,38559.0,48.0,43.0,9,368,38559.0,20.0,12.0
0.004,6,10,1702,5,863,1.0,595.0,595.0,5,839,0.0,571.0,571.0
0.129,17,2,80,1,32,0.0,4.0,4.0,1,48,0.0,20.0,20.0
0.005,6,10,2006,5,927,1.0,659.0,659.0,5,1079,1.0,811.0,811.0
0.167,17,2,152,1,76,0.0,48.0,48.0,1,76,0.0,48.0,48.0
0.015,6,10,1972,5,910,3.0,642.0,642.0,5,1062,3.0,794.0,794.0
0.129,6,10,1506,5,395,29.0,127.0,127.0,5,1111,28.0,843.0,843.0
1792.952,6,305,97893,188,86467,9587.0,2001.0,678.0,117,11426,15456.0,452.0,71.0
297.477,6,365,347237,129,18263,2324.0,2736.0,889.0,236,328974,1265.0,2804.0,1433.0
0.288,17,38,20219,21,17026,14.0,1350.0,782.0,17,3193,14.0,1350.0,159.0
0.01,6,10,1990,5,911,2.0,643.0,643.0,5,1079,2.0,811.0,811.0
240.333,6,42,8731,21,5698,12016.0,2883.0,573.0,21,3033,12016.0,580.0,241.0
0.004,6,10,2007,5,928,1.0,660.0,660.0,5,1079,1.0,811.0,811.0
0.1,6,10,1506,5,395,21.0,127.0,127.0,5,1111,22.0,843.0,843.0
0.004,17,2,148,1,60,0.0,32.0,32.0,1,88,0.0,60.0,60.0
0.006,6,10,1689,5,839,1.0,571.0,571.0,5,850,1.0,582.0,582.0
0.01,6,14,3787,7,497,1.0,125.0,125.0,7,3290,1.0,1448.0,972.0
0.117,6,10,1506,5,395,27.0,127.0,127.0,5,1111,27.0,843.0,843.0
784.646,6,49,20662,26,4426,31385.0,676.0,438.0,23,16236,32936.0,1402.0,1002.0
0.006,6,10,1547,5,764,1.0,496.0,496.0,5,783,1.0,515.0,515.0
0.016,6,10,1972,5,910,3.0,642.0,642.0,5,1062,4.0,794.0,794.0
0.008,6,10,1989,5,910,1.0,642.0,642.0,5,1079,1.0,811.0,811.0
0.012,6,13,3735,7,497,2.0,125.0,125.0,6,3238,2.0,1470.0,1459.0
0.014,6,10,1983,5,910,3.0,642.0,642.0,5,1073,3.0,805.0,805.0
0.099,6,10,1506,5,395,21.0,127.0,127.0,5,1111,21.0,843.0,843.0
0.006,17,2,193,1,71,0.0,43.0,43.0,1,122,0.0,94.0,94.0
0.045,17,2,136,1,60,0.0,32.0,32.0,1,76,0.0,48.0,48.0
0.141,6,10,1506,5,395,27.0,127.0,127.0,5,1111,33.0,843.0,843.0
0.005,6,10,2000,5,927,1.0,659.0,659.0,5,1073,1.0,805.0,805.0
0.074,6,10,1506,5,395,15.0,127.0,127.0,5,1111,16.0,843.0,843.0
0.087,6,10,1506,5,395,18.0,127.0,127.0,5,1111,16.0,843.0,843.0
0.008,6,10,1631,5,848,2.0,580.0,580.0,5,783,2.0,515.0,515.0
0.005,6,10,1643,5,860,1.0,592.0,592.0,5,783,1.0,515.0,515.0
0.099,6,10,1506,5,395,21.0,127.0,127.0,5,1111,21.0,843.0,843.0
0.149,6,10,1506,5,395,34.0,127.0,127.0,5,1111,35.0,843.0,843.0
0.015,6,10,1983,5,910,3.0,642.0,642.0,5,1073,3.0,805.0,805.0
0.005,6,10,2007,5,928,1.0,660.0,660.0,5,1079,1.0,811.0,811.0
0.004,6,10,2006,5,927,1.0,659.0,659.0,5,1079,1.0,811.0,811.0
0.014,6,10,1989,5,910,3.0,642.0,642.0,5,1079,3.0,811.0,811.0
0.016,6,10,1990,5,911,3.0,643.0,643.0,5,1079,4.0,811.0,811.0
0.01,6,10,1989,5,910,2.0,642.0,642.0,5,1079,2.0,811.0,811.0
0.006,6,10,1689,5,839,1.0,571.0,571.0,5,850,1.0,582.0,582.0
0.006,6,10,1547,5,764,1.0,496.0,496.0,5,783,1.0,515.0,515.0
0.005,6,10,1547,5,764,1.0,496.0,496.0,5,783,1.0,515.0,515.0
0.014,17,2,152,1,56,0.0,28.0,28.0,1,96,0.0,68.0,68.0
0.006,17,2,160,1,72,0.0,44.0,44.0,1,88,0.0,60.0,60.0
0.006,6,10,1547,5,764,1.0,496.0,496.0,5,783,1.0,515.0,515.0
0.005,6,10,1989,5,927,1.0,659.0,659.0,5,1062,1.0,794.0,794.0
0.001,17,2,180,1,66,0.0,38.0,38.0,1,114,0.0,86.0,86.0
0.005,6,10,1989,5,927,1.0,659.0,659.0,5,1062,1.0,794.0,794.0
0.063,6,10,1506,5,395,13.0,127.0,127.0,5,1111,13.0,843.0,843.0
40.061,17,10,676,5,460,10013.0,104.0,64.0,5,216,10010.0,20.0,15.0
0.067,17,8,3613,4,1874,22.0,1350.0,440.0,4,1739,11.0,1350.0,406.0
15.265,17,52,30218,27,22678,586.0,1350.0,811.0,25,7540,633.0,1350.0,273.0
10.786,17,28,4422,14,1995,821.0,270.0,114.0,14,2427,821.0,586.0,145.0
0.007,6,13,3747,7,509,1.0,137.0,137.0,6,3238,1.0,1470.0,1459.0
0.004,6,10,2006,5,927,1.0,659.0,659.0,5,1079,1.0,811.0,811.0
0.005,6,10,2007,5,928,1.0,660.0,660.0,5,1079,1.0,811.0,811.0
0.004,6,10,1774,5,923,1.0,655.0,655.0,5,851,1.0,583.0,583.0
0.009,6,10,1972,5,910,2.0,642.0,642.0,5,1062,2.0,794.0,794.0
0.075,6,10,1506,5,395,14.0,127.0,127.0,5,1111,16.0,843.0,843.0
0.014,6,10,1972,5,910,3.0,642.0,642.0,5,1062,3.0,794.0,794.0
15.169,17,21,11493,10,7869,1682.0,1350.0,758.0,11,3624,1514.0,1350.0,301.0
0.004,6,10,1702,5,863,1.0,595.0,595.0,5,839,1.0,571.0,571.0
0.069,17,8,3613,4,1874,23.0,1350.0,440.0,4,1739,11.0,1350.0,406.0
0.017,6,10,1972,5,910,4.0,642.0,642.0,5,1062,4.0,794.0,794.0
0.005,17,2,140,1,62,0.0,34.0,34.0,1,78,0.0,50.0,50.0
0.003,17,4,284,2,120,0.0,32.0,32.0,2,164,0.0,60.0,54.0
0.01,6,10,1989,5,910,2.0,642.0,642.0,5,1079,2.0,811.0,811.0
0.007,6,10,2006,5,927,1.0,659.0,659.0,5,1079,1.0,811.0,811.0
0.01,6,10,1972,5,910,2.0,642.0,642.0,5,1062,2.0,794.0,794.0
0.009,6,10,1779,5,928,2.0,660.0,660.0,5,851,2.0,583.0,583.0
0.099,6,10,1506,5,395,22.0,127.0,127.0,5,1111,23.0,843.0,843.0
367.32,6,22,2313,16,867,24488.0,195.0,195.0,6,1446,4661.0,419.0,398.0
0.006,6,12,1698,6,863,1.0,327.0,271.0,6,835,1.0,515.0,515.0
0.001,17,2,180,1,66,0.0,38.0,38.0,1,114,0.0,86.0,86.0
0.02,6,10,1989,5,910,5.0,642.0,642.0,5,1079,4.0,811.0,811.0
0.016,6,10,1990,5,911,3.0,643.0,643.0,5,1079,3.0,811.0,811.0
0.006,6,10,1547,5,764,1.0,496.0,496.0,5,783,1.0,515.0,515.0
0.004,6,10,1702,5,863,1.0,595.0,595.0,5,839,0.0,571.0,571.0
0.006,6,10,1547,5,764,1.0,496.0,496.0,5,783,1.0,515.0,515.0
0.005,6,10,2006,5,927,1.0,659.0,659.0,5,1079,1.0,811.0,811.0
0.004,17,2,152,1,76,0.0,48.0,48.0,1,76,0.0,48.0,48.0
0.006,6,10,1547,5,764,1.0,496.0,496.0,5,783,1.0,515.0,515.0
0.005,6,10,2007,5,928,1.0,660.0,660.0,5,1079,1.0,811.0,811.0
0.006,17,2,170,1,65,0.0,37.0,37.0,1,105,0.0,77.0,77.0
375.022,6,22,2313,16,867,25001.0,195.0,195.0,6,1446,4644.0,419.0,398.0
0.011,6,13,3735,7,497,1.0,125.0,125.0,6,3238,2.0,1470.0,1459.0
0.104,6,10,1506,5,395,24.0,127.0,127.0,5,1111,21.0,843.0,843.0
0.005,17,2,214,1,75,0.0,47.0,47.0,1,139,0.0,111.0,111.0
0.088,6,10,1506,5,395,18.0,127.0,127.0,5,1111,19.0,843.0,843.0
0.005,17,2,170,1,65,0.0,37.0,37.0,1,105,0.0,77.0,77.0
0.008,6,10,1989,5,910,2.0,642.0,642.0,5,1079,2.0,811.0,811.0
0.009,6,13,3735,7,497,1.0,125.0,125.0,6,3238,1.0,1470.0,1459.0
0.004,17,2,136,1,60,0.0,32.0,32.0,1,76,0.0,48.0,48.0
0.015,6,10,1989,5,910,3.0,642.0,642.0,5,1079,3.0,811.0,811.0
0.003,17,2,148,1,60,0.0,32.0,32.0,1,88,0.0,60.0,60.0
0.01,6,10,1983,5,910,2.0,642.0,642.0,5,1073,2.0,805.0,805.0
0.001,17,2,184,1,68,0.0,40.0,40.0,1,116,0.0,88.0,88.0
0.066,6,10,1506,5,395,14.0,127.0,127.0,5,1111,15.0,843.0,843.0
0.005,17,2,168,1,76,0.0,48.0,48.0,1,92,0.0,64.0,64.0
0.004,6,10,1702,5,863,1.0,595.0,595.0,5,839,0.0,571.0,571.0
0.051,6,10,943,5,395,9.0,127.0,127.0,5,548,9.0,280.0,280.0
0.022,6,10,1972,5,910,5.0,642.0,642.0,5,1062,5.0,794.0,794.0
0.129,17,2,80,1,32,0.0,4.0,4.0,1,48,0.0,20.0,20.0
0.201,6,10,1506,5,395,38.0,127.0,127.0,5,1111,45.0,843.0,843.0
0.039,17,2,182,1,65,0.0,37.0,37.0,1,117,0.0,89.0,89.0
0.001,17,2,136,1,60,0.0,32.0,32.0,1,76,0.0,48.0,48.0
10.731,17,26,4097,13,1846,885.0,269.0,114.0,13,2251,885.0,586.0,145.0
0.068,6,10,1506,5,395,16.0,127.0,127.0,5,1111,15.0,843.0,843.0
0.122,17,2,184,1,61,0.0,33.0,33.0,1,123,0.0,95.0,95.0
0.009,6,10,1762,5,911,2.0,643.0,643.0,5,851,2.0,583.0,583.0
11.071,17,28,4421,14,1994,839.0,269.0,114.0,14,2427,839.0,586.0,145.0
0.07,6,10,1506,5,395,15.0,127.0,127.0,5,1111,15.0,843.0,843.0
0.005,6,10,1774,5,923,1.0,655.0,655.0,5,851,1.0,583.0,583.0
314.797,17,20,1124,10,716,34963.0,48.0,43.0,10,408,34963.0,20.0,12.0
0.005,17,2,166,1,75,0.0,47.0,47.0,1,91,0.0,63.0,63.0
0.015,6,10,1990,5,911,3.0,643.0,643.0,5,1079,3.0,811.0,811.0
0.012,6,10,1989,5,910,3.0,642.0,642.0,5,1079,3.0,811.0,811.0
0.004,6,10,1989,5,927,1.0,659.0,659.0,5,1062,1.0,794.0,794.0
10.866,17,28,4421,14,1993,827.0,268.0,114.0,14,2428,827.0,587.0,145.0
0.002,17,2,136,1,60,0.0,32.0,32.0,1,76,0.0,48.0,48.0
0.999,6,13,3930,7,2139,125.0,1328.0,923.0,6,1791,150.0,1539.0,1539.0
0.018,6,10,1631,5,848,4.0,580.0,580.0,5,783,4.0,515.0,515.0
0.012,6,10,1983,5,910,3.0,642.0,642.0,5,1073,3.0,805.0,805.0
351.988,6,20,2210,6,1308,12003.0,494.0,494.0,14,902,27075.0,83.0,83.0
0.012,6,10,1989,5,910,2.0,642.0,642.0,5,1079,2.0,811.0,811.0
323.553,17,20,1124,10,716,35935.0,48.0,43.0,10,408,35935.0,20.0,12.0
240.036,6,9,787,5,488,60009.0,232.0,232.0,4,299,80010.0,83.0,83.0
0.005,17,2,262,1,66,0.0,38.0,38.0,1,196,0.0,168.0,168.0
175.263,17,72,10212,36,2403,5007.0,44.0,38.0,36,7809,5007.0,252.0,188.0
0.014,6,10,1989,5,910,3.0,642.0,642.0,5,1079,3.0,811.0,811.0
40.026,17,10,676,5,460,10004.0,104.0,64.0,5,216,10005.0,20.0,15.0
0.089,6,10,1506,5,395,19.0,127.0,127.0,5,1111,20.0,843.0,843.0
11.092,17,28,4398,14,2311,844.0,586.0,137.0,14,2087,844.0,270.0,121.0
0.001,17,2,180,1,66,0.0,38.0,38.0,1,114,0.0,86.0,86.0
0.005,6,10,2006,5,927,1.0,659.0,659.0,5,1079,1.0,811.0,811.0
0.005,6,13,3747,7,509,0.0,137.0,137.0,6,3238,0.0,1470.0,1459.0
0.009,6,10,1990,5,911,2.0,643.0,643.0,5,1079,2.0,811.0,811.0
0.013,6,10,1972,5,910,3.0,642.0,642.0,5,1062,3.0,794.0,794.0
0.012,6,10,1762,5,911,3.0,643.0,643.0,5,851,3.0,583.0,583.0
0.006,6,10,1547,5,764,1.0,496.0,496.0,5,783,1.0,515.0,515.0
0.005,6,10,2006,5,927,1.0,659.0,659.0,5,1079,1.0,811.0,811.0
1770.464,6,81,4264,41,2158,44260.0,26.0,26.0,40,2106,45395.0,26.0,26.0
308.765,17,18,1008,9,640,38581.0,48.0,43.0,9,368,38580.0,20.0,12.0
0.004,17,2,144,1,64,0.0,36.0,36.0,1,80,0.0,52.0,52.0
0.001,17,2,166,1,75,0.0,47.0,47.0,1,91,0.0,63.0,63.0
0.006,6,10,1547,5,764,1.0,496.0,496.0,5,783,1.0,515.0,515.0
172.217,17,76,10748,38,2529,4654.0,44.0,38.0,38,8219,4654.0,239.0,188.0
0.005,6,10,1643,5,860,1.0,592.0,592.0,5,783,1.0,515.0,515.0
0.021,6,10,1989,5,910,5.0,642.0,642.0,5,1079,5.0,811.0,811.0
0.006,17,2,179,1,71,0.0,43.0,43.0,1,108,0.0,80.0,80.0
0.01,6,10,1972,5,910,2.0,642.0,642.0,5,1062,2.0,794.0,794.0
0.016,6,10,1989,5,910,3.0,642.0,642.0,5,1079,4.0,811.0,811.0
0.011,6,10,1990,5,911,2.0,643.0,643.0,5,1079,2.0,811.0,811.0
0.004,17,2,148,1,60,0.0,32.0,32.0,1,88,0.0,60.0,60.0
0.073,6,10,1506,5,395,15.0,127.0,127.0,5,1111,17.0,843.0,843.0
0.006,6,10,1643,5,860,1.0,592.0,592.0,5,783,1.0,515.0,515.0
0.053,17,2,152,1,76,0.0,48.0,48.0,1,76,0.0,48.0,48.0
0.04,17,2,152,1,76,0.0,48.0,48.0,1,76,0.0,48.0,48.0
0.006,17,2,144,1,64,0.0,36.0,36.0,1,80,0.0,52.0,52.0
0.004,6,10,2006,5,927,1.0,659.0,659.0,5,1079,1.0,811.0,811.0
0.01,6,12,1926,6,1189,1.0,659.0,434.0,6,737,2.0,417.0,417.0
412.283,6,29,4409,12,3102,10912.0,494.0,494.0,17,1307,25767.0,83.0,83.0
301.066,6,48,16816,26,10864,12042.0,2720.0,1222.0,22,5952,423.0,2667.0,361.0
0.013,6,10,1990,5,911,3.0,643.0,643.0,5,1079,3.0,811.0,811.0
0.006,6,10,1547,5,764,1.0,496.0,496.0,5,783,1.0,515.0,515.0
0.001,17,2,136,1,60,0.0,32.0,32.0,1,76,0.0,48.0,48.0
1777.789,17,144,45504,72,22752,25039.0,288.0,288.0,72,22752,25039.0,288.0,288.0
0.005,6,10,2007,5,928,1.0,660.0,660.0,5,1079,1.0,811.0,811.0
0.085,6,10,1506,5,395,16.0,127.0,127.0,5,1111,19.0,843.0,843.0
0.102,6,10,1506,5,395,23.0,127.0,127.0,5,1111,22.0,843.0,843.0
240.284,6,19,4799,9,2305,30035.0,1102.0,613.0,10,2494,26694.0,1162.0,393.0
0.004,6,10,1702,5,863,0.0,595.0,595.0,5,839,1.0,571.0,571.0
0.005,6,10,2007,5,928,1.0,660.0,660.0,5,1079,1.0,811.0,811.0
0.004,6,13,3747,7,509,0.0,137.0,137.0,6,3238,0.0,1470.0,1459.0
0.005,6,10,1547,5,764,1.0,496.0,496.0,5,783,1.0,515.0,515.0
40.056,17,10,676,5,460,10011.0,104.0,64.0,5,216,10013.0,20.0,15.0
0.013,6,10,1989,5,910,3.0,642.0,642.0,5,1079,3.0,811.0,811.0
0.013,6,10,1972,5,910,3.0,642.0,642.0,5,1062,3.0,794.0,794.0
0.005,6,10,2007,5,928,1.0,660.0,660.0,5,1079,1.0,811.0,811.0
0.006,17,2,184,1,68,0.0,40.0,40.0,1,116,0.0,88.0,88.0
0.004,6,10,2000,5,927,1.0,659.0,659.0,5,1073,1.0,805.0,805.0
0.006,6,10,1547,5,764,1.0,496.0,496.0,5,783,1.0,515.0,515.0
0.02,6,10,1989,5,910,4.0,642.0,642.0,5,1079,4.0,811.0,811.0
0.004,17,2,136,1,60,0.0,32.0,32.0,1,76,0.0,48.0,48.0
0.103,6,10,1506,5,395,22.0,127.0,127.0,5,1111,23.0,843.0,843.0
0.095,6,10,1506,5,395,21.0,127.0,127.0,5,1111,20.0,843.0,843.0
240.014,6,9,787,5,488,60003.0,232.0,232.0,4,299,80004.0,83.0,83.0
0.073,6,10,1506,5,395,15.0,127.0,127.0,5,1111,16.0,843.0,843.0
0.014,6,10,1989,5,910,3.0,642.0,642.0,5,1079,3.0,811.0,811.0
0.132,6,10,1506,5,395,28.0,127.0,127.0,5,1111,29.0,843.0,843.0
0.099,6,10,1506,5,395,21.0,127.0,127.0,5,1111,22.0,843.0,843.0
240.094,6,16,4481,9,963,30011.0,238.0,166.0,7,3518,40015.0,1402.0,786.0
0.004,17,2,234,1,61,0.0,33.0,33.0,1,173,0.0,145.0,145.0
0.004,6,10,2007,5,928,1.0,660.0,660.0,5,1079,1.0,811.0,811.0
0.009,6,10,1989,5,910,2.0,642.0,642.0,5,1079,2.0,811.0,811.0
0.006,17,2,144,1,64,0.0,36.0,36.0,1,80,0.0,52.0,52.0
0.017,6,10,1972,5,910,4.0,642.0,642.0,5,1062,4.0,794.0,794.0
0.011,6,10,1983,5,910,2.0,642.0,642.0,5,1073,2.0,805.0,805.0
0.081,6,10,1506,5,395,18.0,127.0,127.0,5,1111,17.0,843.0,843.0
11.199,17,28,4422,14,1994,848.0,269.0,114.0,14,2428,848.0,587.0,145.0
354.082,6,21,1795,16,1030,23605.0,190.0,190.0,5,765,60002.0,464.0,248.0
0.004,6,10,2006,5,927,1.0,659.0,659.0,5,1079,1.0,811.0,811.0
240.013,6,9,787,5,488,60003.0,232.0,232.0,4,299,80003.0,83.0,83.0
0.016,6,10,2007,5,928,4.0,660.0,660.0,5,1079,4.0,811.0,811.0
0.005,17,2,166,1,75,0.0,47.0,47.0,1,91,0.0,63.0,63.0
0.011,17,2,180,1,66,0.0,38.0,38.0,1,114,0.0,86.0,86.0
240.016,6,9,787,5,488,60004.0,232.0,232.0,4,299,80004.0,83.0,83.0
0.005,6,10,2007,5,928,1.0,660.0,660.0,5,1079,1.0,811.0,811.0
0.01,6,10,1989,5,910,2.0,642.0,642.0,5,1079,2.0,811.0,811.0
0.003,17,2,136,1,60,0.0,32.0,32.0,1,76,0.0,48.0,48.0
0.129,6,10,1506,5,395,31.0,127.0,127.0,5,1111,26.0,843.0,843.0
0.096,6,10,1506,5,395,22.0,127.0,127.0,5,1111,17.0,843.0,843.0
0.003,17,2,160,1,72,0.0,44.0,44.0,1,88,0.0,60.0,60.0
0.081,6,10,1506,5,395,19.0,127.0,127.0,5,1111,16.0,843.0,843.0
0.004,6,10,2006,5,927,1.0,659.0,659.0,5,1079,1.0,811.0,811.0
0.004,17,2,148,1,60,0.0,32.0,32.0,1,88,0.0,60.0,60.0
368.399,6,22,2313,16,867,24559.0,195.0,195.0,6,1446,4634.0,419.0,398.0
0.103,6,10,1506,5,395,22.0,127.0,127.0,5,1111,24.0,843.0,843.0
0.012,6,10,1989,5,910,3.0,642.0,642.0,5,1079,2.0,811.0,811.0
369.001,6,22,2313,16,867,24600.0,195.0,195.0,6,1446,4658.0,419.0,398.0
0.005,17,2,170,1,65,0.0,37.0,37.0,1,105,0.0,77.0,77.0
0.076,6,44,14081,25,2555,3.0,517.0,139.0,19,11526,3.0,1402.0,752.0
0.005,6,13,3747,7,509,0.0,137.0,137.0,6,3238,1.0,1470.0,1459.0
0.12,6,10,1506,5,395,28.0,127.0,127.0,5,1111,25.0,843.0,843.0
0.008,6,10,1989,5,910,2.0,642.0,642.0,5,1079,1.0,811.0,811.0
0.005,6,10,2000,5,927,1.0,659.0,659.0,5,1073,1.0,805.0,805.0
240.197,6,45,5866,23,2874,10917.0,588.0,207.0,22,2992,11437.0,580.0,203.0
0.115,6,10,1506,5,395,24.0,127.0,127.0,5,1111,26.0,843.0,843.0
0.13,17,4,352,2,130,2.0,37.0,37.0,2,222,91.0,89.0,83.0
10.944,17,28,4420,14,1993,833.0,268.0,114.0,14,2427,833.0,586.0,145.0
0.033,17,2,148,1,60,0.0,32.0,32.0,1,88,0.0,60.0,60.0
0.055,17,2,152,1,76,0.0,48.0,48.0,1,76,0.0,48.0,48.0
0.099,6,10,1506,5,395,22.0,127.0,127.0,5,1111,23.0,843.0,843.0
0.012,6,10,1677,5,827,3.0,559.0,559.0,5,850,3.0,582.0,582.0
0.004,6,10,1702,5,863,1.0,595.0,595.0,5,839,0.0,571.0,571.0
0.001,17,2,180,1,66,0.0,38.0,38.0,1,114,0.0,86.0,86.0
0.004,6,10,2006,5,927,1.0,659.0,659.0,5,1079,1.0,811.0,811.0
0.038,17,2,234,1,61,0.0,33.0,33.0,1,173,0.0,145.0,145.0
9.037,17,6,376,5,280,2259.0,28.0,28.0,1,96,0.0,68.0,68.0
0.012,6,10,1989,5,910,3.0,642.0,642.0,5,1079,3.0,811.0,811.0
0.004,6,14,3742,7,452,0.0,80.0,80.0,7,3290,0.0,1448.0,972.0
0.006,6,10,1547,5,764,1.0,496.0,496.0,5,783,1.0,515.0,515.0
0.093,6,10,1506,5,395,19.0,127.0,127.0,5,1111,21.0,843.0,843.0
11.21,17,28,4422,14,1994,848.0,269.0,114.0,14,2428,849.0,587.0,145.0
0.034,17,2,148,1,60,0.0,32.0,32.0,1,88,0.0,60.0,60.0
0.006,6,10,1854,5,889,1.0,621.0,621.0,5,965,1.0,697.0,697.0
0.016,6,10,1990,5,911,4.0,643.0,643.0,5,1079,3.0,811.0,811.0
15.083,17,16,8407,8,6179,2150.0,1350.0,744.0,8,2228,2150.0,1350.0,250.0
0.005,6,10,1643,5,860,1.0,592.0,592.0,5,783,1.0,515.0,515.0
0.013,17,2,152,1,56,0.0,28.0,28.0,1,96,0.0,68.0,68.0
0.011,6,10,1989,5,910,2.0,642.0,642.0,5,1079,2.0,811.0,811.0
0.005,6,10,1689,5,839,1.0,571.0,571.0,5,850,1.0,582.0,582.0
0.005,6,10,2006,5,927,1.0,659.0,659.0,5,1079,1.0,811.0,811.0
0.117,6,10,1506,5,395,27.0,127.0,127.0,5,1111,23.0,843.0,843.0
0.006,17,2,178,1,65,0.0,37.0,37.0,1,113,0.0,85.0,85.0
0.013,6,10,1989,5,910,3.0,642.0,642.0,5,1079,3.0,811.0,811.0
0.005,6,10,1854,5,889,1.0,621.0,621.0,5,965,1.0,697.0,697.0
0.007,6,10,1643,5,860,1.0,592.0,592.0,5,783,1.0,515.0,515.0
0.013,6,10,1972,5,910,3.0,642.0,642.0,5,1062,3.0,794.0,794.0
0.005,6,10,2006,5,927,1.0,659.0,659.0,5,1079,1.0,811.0,811.0
0.015,6,13,3735,7,497,2.0,125.0,125.0,6,3238,2.0,1470.0,1459.0
0.012,6,10,1702,5,863,3.0,595.0,595.0,5,839,3.0,571.0,571.0
0.008,6,10,1989,5,910,2.0,642.0,642.0,5,1079,1.0,811.0,811.0
0.005,6,10,1689,5,839,1.0,571.0,571.0,5,850,1.0,582.0,582.0
0.005,6,10,1547,5,764,1.0,496.0,496.0,5,783,1.0,515.0,515.0
0.005,6,10,1547,5,764,1.0,496.0,496.0,5,783,1.0,515.0,515.0
0.017,6,10,1989,5,910,4.0,642.0,642.0,5,1079,4.0,811.0,811.0
0.009,6,12,1926,6,1189,1.0,659.0,434.0,6,737,1.0,417.0,417.0
0.003,17,4,420,2,122,0.0,33.0,33.0,2,298,0.0,145.0,121.0
0.013,6,10,1972,5,910,3.0,642.0,642.0,5,1062,3.0,794.0,794.0
308.949,17,20,1124,10,716,34320.0,48.0,43.0,10,408,34320.0,20.0,12.0
0.005,17,2,152,1,68,0.0,40.0,40.0,1,84,0.0,56.0,56.0
0.005,6,10,1774,5,923,1.0,655.0,655.0,5,851,1.0,583.0,583.0
0.004,6,10,2006,5,927,1.0,659.0,659.0,5,1079,1.0,811.0,811.0
240.086,6,16,4482,9,963,30010.0,238.0,166.0,7,3519,40013.0,1402.0,786.0
0.008,6,10,1762,5,911,2.0,643.0,643.0,5,851,2.0,583.0,583.0
0.004,17,2,132,1,58,0.0,30.0,30.0,1,74,0.0,46.0,46.0
0.005,6,10,2006,5,927,1.0,659.0,659.0,5,1079,1.0,811.0,811.0
0.015,6,10,1762,5,911,3.0,643.0,643.0,5,851,3.0,583.0,583.0
0.006,6,10,1689,5,839,1.0,571.0,571.0,5,850,1.0,582.0,582.0
0.006,6,10,1547,5,764,1.0,496.0,496.0,5,783,1.0,515.0,515.0
0.004,17,4,284,2,120,0.0,32.0,32.0,2,164,1.0,60.0,54.0
15.078,17,15,8040,8,6016,2149.0,1350.0,724.0,7,2024,2508.0,1350.0,261.0
0.083,17,2,144,1,64,0.0,36.0,36.0,1,80,0.0,52.0,52.0
0.017,6,10,1989,5,910,4.0,642.0,642.0,5,1079,4.0,811.0,811.0
0.005,6,10,2000,5,927,1.0,659.0,659.0,5,1073,1.0,805.0,805.0
0.108,6,10,1506,5,395,24.0,127.0,127.0,5,1111,24.0,843.0,843.0
0.072,6,10,1506,5,395,16.0,127.0,127.0,5,1111,15.0,843.0,843.0
0.019,6,10,1983,5,910,4.0,642.0,642.0,5,1073,4.0,805.0,805.0
0.018,6,10,1990,5,911,4.0,643.0,643.0,5,1079,4.0,811.0,811.0
0.102,6,10,1506,5,395,22.0,127.0,127.0,5,1111,20.0,843.0,843.0
0.151,17,4,596,2,122,147.0,33.0,33.0,2,474,110.0,323.0,209.0
0.023,6,10,1989,5,910,5.0,642.0,642.0,5,1079,5.0,811.0,811.0
0.005,6,10,2000,5,927,1.0,659.0,659.0,5,1073,1.0,805.0,805.0
0.026,6,10,1990,5,911,6.0,643.0,643.0,5,1079,6.0,811.0,811.0
0.24,6,16,2777,8,1395,34.0,533.0,323.0,8,1382,21.0,529.0,239.0
308.377,17,20,1124,10,716,34257.0,48.0,43.0,10,408,34257.0,20.0,12.0
0.009,6,10,1989,5,910,2.0,642.0,642.0,5,1079,2.0,811.0,811.0
11.542,17,28,4395,14,2312,875.0,587.0,137.0,14,2083,875.0,270.0,120.0
0.005,6,10,1779,5,928,1.0,660.0,660.0,5,851,1.0,583.0,583.0
0.004,17,2,160,1,72,0.0,44.0,44.0,1,88,0.0,60.0,60.0
0.003,17,2,148,1,60,0.0,32.0,32.0,1,88,0.0,60.0,60.0
0.013,6,10,1990,5,911,3.0,643.0,643.0,5,1079,3.0,811.0,811.0
0.073,6,10,1506,5,395,15.0,127.0,127.0,5,1111,14.0,843.0,843.0
0.016,6,14,3787,7,497,2.0,125.0,125.0,7,3290,2.0,1448.0,972.0
0.006,6,10,1547,5,764,1.0,496.0,496.0,5,783,1.0,515.0,515.0
0.005,6,14,3742,7,452,0.0,80.0,80.0,7,3290,0.0,1448.0,972.0
0.005,6,10,1989,5,927,1.0,659.0,659.0,5,1062,1.0,794.0,794.0
15.078,17,16,8322,8,6038,2150.0,1350.0,726.0,8,2284,2149.0,1350.0,257.0
0.003,17,2,136,1,60,0.0,32.0,32.0,1,76,0.0,48.0,48.0
0.009,6,12,1926,6,1189,1.0,659.0,434.0,6,737,1.0,417.0,417.0
0.005,6,10,2006,5,927,1.0,659.0,659.0,5,1079,1.0,811.0,811.0
0.007,17,2,194,1,59,0.0,31.0,31.0,1,135,0.0,107.0,107.0
1.068,6,29,7768,17,2784,66.0,1477.0,515.0,12,4984,80.0,2745.0,561.0
0.083,6,10,1506,5,395,17.0,127.0,127.0,5,1111,19.0,843.0,843.0
0.005,17,2,169,1,62,0.0,34.0,34.0,1,107,0.0,79.0,79.0
0.107,6,10,1506,5,395,19.0,127.0,127.0,5,1111,24.0,843.0,843.0
0.005,6,14,3742,8,504,0.0,80.0,80.0,6,3238,1.0,1470.0,1459.0
241.824,6,397,347579,208,22330,1168.0,2736.0,959.0,189,325249,1286.0,2769.0,1762.0
0.008,6,10,2006,5,927,1.0,659.0,659.0,5,1079,1.0,811.0,811.0
0.091,6,10,1506,5,395,18.0,127.0,127.0,5,1111,20.0,843.0,843.0
0.01,6,10,1983,5,910,2.0,642.0,642.0,5,1073,2.0,805.0,805.0
0.038,17,2,184,1,61,0.0,33.0,33.0,1,123,0.0,95.0,95.0
0.005,6,10,2006,5,927,1.0,659.0,659.0,5,1079,1.0,811.0,811.0
0.169,17,2,152,1,76,0.0,48.0,48.0,1,76,0.0,48.0,48.0
0.004,17,2,148,1,60,0.0,32.0,32.0,1,88,0.0,60.0,60.0
0.006,6,10,1854,5,889,1.0,621.0,621.0,5,965,1.0,697.0,697.0
0.007,6,10,1643,5,860,1.0,592.0,592.0,5,783,1.0,515.0,515.0
0.005,6,10,2007,5,928,1.0,660.0,660.0,5,1079,1.0,811.0,811.0
0.007,17,2,179,1,71,0.0,43.0,43.0,1,108,0.0,80.0,80.0
0.005,6,10,2000,5,927,1.0,659.0,659.0,5,1073,1.0,805.0,805.0
0.005,6,10,1643,5,860,1.0,592.0,592.0,5,783,1.0,515.0,515.0
10.784,17,28,4420,14,1993,821.0,268.0,114.0,14,2427,821.0,586.0,145.0
0.005,6,10,1989,5,927,1.0,659.0,659.0,5,1062,1.0,794.0,794.0
0.004,17,2,166,1,75,0.0,47.0,47.0,1,91,0.0,63.0,63.0
0.018,6,10,1631,5,848,4.0,580.0,580.0,5,783,4.0,515.0,515.0
10.869,17,26,4096,13,1845,897.0,268.0,113.0,13,2251,896.0,586.0,145.0
0.067,6,10,1506,5,395,12.0,127.0,127.0,5,1111,16.0,843.0,843.0
40.058,17,10,676,5,460,10013.0,104.0,64.0,5,216,10013.0,20.0,15.0
0.126,6,10,1506,5,395,30.0,127.0,127.0,5,1111,17.0,843.0,843.0
15.077,17,19,9115,9,6381,1881.0,1350.0,681.0,10,2734,1671.0,1350.0,245.0
0.13,6,10,1506,5,395,31.0,127.0,127.0,5,1111,31.0,843.0,843.0
0.039,17,2,166,1,75,0.0,47.0,47.0,1,91,0.0,63.0,63.0
0.012,6,10,1983,5,910,3.0,642.0,642.0,5,1073,2.0,805.0,805.0
0.006,17,2,170,1,65,0.0,37.0,37.0,1,105,0.0,77.0,77.0
294.017,6,378,347556,188,21970,1572.0,2736.0,812.0,190,325586,1555.0,2804.0,1803.0
0.006,17,2,169,1,62,0.0,34.0,34.0,1,107,0.0,79.0,79.0
0.006,6,10,1854,5,889,1.0,621.0,621.0,5,965,1.0,697.0,697.0
10.805,17,28,4417,14,1993,822.0,268.0,114.0,14,2424,822.0,587.0,145.0
0.097,6,10,1506,5,395,21.0,127.0,127.0,5,1111,19.0,843.0,843.0
0.005,6,10,1779,5,928,1.0,660.0,660.0,5,851,1.0,583.0,583.0
0.004,17,2,136,1,60,0.0,32.0,32.0,1,76,0.0,48.0,48.0
0.005,6,10,1989,5,927,1.0,659.0,659.0,5,1062,1.0,794.0,794.0
0.007,17,2,170,1,65,0.0,37.0,37.0,1,105,0.0,77.0,77.0
385.028,6,19,1691,15,978,27502.0,190.0,190.0,4,713,80035.0,497.0,497.0
0.066,6,10,1506,5,395,16.0,127.0,127.0,5,1111,14.0,843.0,843.0
0.008,6,10,2006,5,927,2.0,659.0,659.0,5,1079,2.0,811.0,811.0
0.001,17,2,179,1,62,0.0,34.0,34.0,1,117,0.0,89.0,89.0
0.012,6,10,1989,5,910,2.0,642.0,642.0,5,1079,3.0,811.0,811.0
0.005,6,10,2006,5,927,1.0,659.0,659.0,5,1079,1.0,811.0,811.0
0.04,17,2,152,1,76,0.0,48.0,48.0,1,76,0.0,48.0,48.0
0.082,6,10,1506,5,395,18.0,127.0,127.0,5,1111,16.0,843.0,843.0
0.003,17,2,136,1,60,0.0,32.0,32.0,1,76,0.0,48.0,48.0
0.01,6,10,1972,5,910,2.0,642.0,642.0,5,1062,2.0,794.0,794.0
0.001,17,2,180,1,66,0.0,38.0,38.0,1,114,0.0,86.0,86.0
0.013,17,2,152,1,56,0.0,28.0,28.0,1,96,0.0,68.0,68.0
10.817,17,28,4421,14,1993,823.0,268.0,114.0,14,2428,823.0,587.0,145.0
0.005,6,10,2006,5,927,1.0,659.0,659.0,5,1079,1.0,811.0,811.0
0.004,17,2,144,1,64,0.0,36.0,36.0,1,80,0.0,52.0,52.0
40.055,17,10,676,5,460,10012.0,104.0,64.0,5,216,10013.0,20.0,15.0
0.008,6,10,1972,5,910,2.0,642.0,642.0,5,1062,2.0,794.0,794.0
0.079,6,10,1506,5,395,16.0,127.0,127.0,5,1111,19.0,843.0,843.0
0.123,6,10,1506,5,395,29.0,127.0,127.0,5,1111,26.0,843.0,843.0
0.005,6,14,3799,7,509,0.0,137.0,137.0,7,3290,0.0,1448.0,972.0
0.006,6,10,1547,5,764,1.0,496.0,496.0,5,783,1.0,515.0,515.0
0.008,6,12,1926,6,1189,1.0,659.0,434.0,6,737,1.0,417.0,417.0
0.114,6,10,1506,5,395,21.0,127.0,127.0,5,1111,26.0,843.0,843.0
0.005,6,10,1854,5,889,1.0,621.0,621.0,5,965,1.0,697.0,697.0
0.013,6,10,1631,5,848,3.0,580.0,580.0,5,783,3.0,515.0,515.0
0.006,6,10,1689,5,839,1.0,571.0,571.0,5,850,1.0,582.0,582.0
0.122,17,2,80,1,32,0.0,4.0,4.0,1,48,0.0,20.0,20.0
0.004,6,10,1702,5,863,1.0,595.0,595.0,5,839,1.0,571.0,571.0
0.128,6,10,1506,5,395,26.0,127.0,127.0,5,1111,30.0,843.0,843.0
0.006,6,10,1689,5,839,1.0,571.0,571.0,5,850,1.0,582.0,582.0
0.09,6,10,1506,5,395,18.0,127.0,127.0,5,1111,20.0,843.0,843.0
309.858,17,20,1124,10,716,34415.0,48.0,43.0,10,408,34418.0,20.0,12.0
0.115,17,4,352,2,130,43.0,37.0,37.0,2,222,76.0,89.0,83.0
0.005,6,10,1854,5,889,1.0,621.0,621.0,5,965,1.0,697.0,697.0
0.004,17,4,284,2,120,0.0,32.0,32.0,2,164,1.0,60.0,54.0
66.251,6,34,25140,19,17033,3680.0,2804.0,1603.0,15,8107,4720.0,2322.0,1219.0
15.072,17,14,9190,8,6902,2149.0,1350.0,834.0,6,2288,3008.0,1350.0,353.0
0.015,6,14,3787,7,497,2.0,125.0,125.0,7,3290,2.0,1448.0,972.0
240.483,6,35,8926,18,2073,14145.0,694.0,225.0,17,6853,15029.0,1402.0,597.0
1797.973,17,3230,243102,1607,128643,1119.0,82.0,52.0,1623,114459,1108.0,226.0,42.0
240.467,6,18,7342,10,2076,26718.0,1368.0,520.0,8,5266,34351.0,2802.0,1210.0
0.007,6,10,1547,5,764,1.0,496.0,496.0,5,783,1.0,515.0,515.0
0.01,6,10,1972,5,910,2.0,642.0,642.0,5,1062,2.0,794.0,794.0
0.145,6,10,1506,5,395,30.0,127.0,127.0,5,1111,34.0,843.0,843.0
368.86,6,22,2313,16,867,24590.0,195.0,195.0,6,1446,4647.0,419.0,398.0
0.081,6,10,1506,5,395,18.0,127.0,127.0,5,1111,16.0,843.0,843.0
0.086,6,10,1506,5,395,20.0,127.0,127.0,5,1111,20.0,843.0,843.0
0.13,17,4,284,2,120,0.0,32.0,32.0,2,164,127.0,60.0,54.0
240.495,6,39,9800,20,2224,12657.0,744.0,235.0,19,7576,13360.0,1402.0,549.0
0.006,17,2,164,1,74,0.0,46.0,46.0,1,90,0.0,62.0,62.0
0.006,17,2,214,1,75,0.0,47.0,47.0,1,139,0.0,111.0,111.0
0.005,6,10,2000,5,927,1.0,659.0,659.0,5,1073,1.0,805.0,805.0
0.01,6,10,1990,5,911,2.0,643.0,643.0,5,1079,2.0,811.0,811.0
0.013,6,10,1972,5,910,3.0,642.0,642.0,5,1062,3.0,794.0,794.0
0.105,6,10,1506,5,395,18.0,127.0,127.0,5,1111,24.0,843.0,843.0
0.004,6,10,2006,5,927,1.0,659.0,659.0,5,1079,1.0,811.0,811.0
0.104,6,10,1506,5,395,21.0,127.0,127.0,5,1111,24.0,843.0,843.0
0.041,17,2,144,1,64,0.0,36.0,36.0,1,80,0.0,52.0,52.0
1778.073,17,144,45504,72,22752,25040.0,288.0,288.0,72,22752,25032.0,288.0,288.0
0.014,6,10,1990,5,911,3.0,643.0,643.0,5,1079,3.0,811.0,811.0
0.007,6,10,2007,5,928,1.0,660.0,660.0,5,1079,1.0,811.0,811.0
0.005,6,10,1989,5,927,1.0,659.0,659.0,5,1062,1.0,794.0,794.0
0.005,17,2,225,1,65,0.0,37.0,37.0,1,160,0.0,132.0,132.0
0.091,6,10,1506,5,395,21.0,127.0,127.0,5,1111,20.0,843.0,843.0
0.004,17,2,136,1,60,0.0,32.0,32.0,1,76,0.0,48.0,48.0
0.017,17,2,185,1,73,0.0,45.0,45.0,1,112,0.0,84.0,84.0
1759.533,6,304,98281,187,86999,9459.0,2001.0,683.0,117,11282,15168.0,452.0,71.0
0.005,6,10,2007,5,928,1.0,660.0,660.0,5,1079,1.0,811.0,811.0
0.005,17,2,170,1,65,0.0,37.0,37.0,1,105,0.0,77.0,77.0
0.005,6,10,2006,5,927,1.0,659.0,659.0,5,1079,1.0,811.0,811.0
0.006,6,10,1547,5,764,1.0,496.0,496.0,5,783,1.0,515.0,515.0
0.017,6,10,2007,5,928,4.0,660.0,660.0,5,1079,4.0,811.0,811.0
0.01,6,10,1989,5,910,2.0,642.0,642.0,5,1079,2.0,811.0,811.0
0.006,6,10,2007,5,928,1.0,660.0,660.0,5,1079,1.0,811.0,811.0
0.005,6,10,1774,5,923,1.0,655.0,655.0,5,851,1.0,583.0,583.0
361.81,6,21,1793,16,1030,24120.0,190.0,190.0,5,763,60009.0,462.0,247.0
240.013,6,9,787,5,488,60003.0,232.0,232.0,4,299,80003.0,83.0,83.0
0.019,6,10,1989,5,910,4.0,642.0,642.0,5,1079,4.0,811.0,811.0
0.006,17,2,179,1,71,0.0,43.0,43.0,1,108,0.0,80.0,80.0
0.01,6,10,1677,5,827,2.0,559.0,559.0,5,850,2.0,582.0,582.0
178.497,17,78,10996,39,2605,4697.0,44.0,38.0,39,8391,4697.0,261.0,187.0
0.021,17,2,170,1,65,0.0,37.0,37.0,1,105,0.0,77.0,77.0
0.005,6,10,2006,5,927,1.0,659.0,659.0,5,1079,1.0,811.0,811.0
0.011,6,10,1989,5,910,2.0,642.0,642.0,5,1079,2.0,811.0,811.0
40.087,17,10,676,5,460,10020.0,104.0,64.0,5,216,10020.0,20.0,15.0
0.004,6,10,2007,5,928,1.0,660.0,660.0,5,1079,1.0,811.0,811.0
40.061,17,10,676,5,460,10014.0,104.0,64.0,5,216,10014.0,20.0,15.0
0.065,17,8,3613,4,1874,21.0,1350.0,440.0,4,1739,11.0,1350.0,406.0
0.087,6,10,1506,5,395,20.0,127.0,127.0,5,1111,16.0,843.0,843.0
0.008,6,10,1990,5,911,2.0,643.0,643.0,5,1079,2.0,811.0,811.0
0.018,6,10,1989,5,910,4.0,642.0,642.0,5,1079,4.0,811.0,811.0
0.009,6,10,1990,5,911,2.0,643.0,643.0,5,1079,2.0,811.0,811.0
0.006,17,2,152,1,68,0.0,40.0,40.0,1,84,0.0,56.0,56.0
0.005,6,10,1689,5,839,1.0,571.0,571.0,5,850,1.0,582.0,582.0
0.112,6,10,1506,5,395,22.0,127.0,127.0,5,1111,23.0,843.0,843.0
0.005,17,2,170,1,65,0.0,37.0,37.0,1,105,0.0,77.0,77.0
10.843,17,28,4420,14,1993,825.0,268.0,114.0,14,2427,825.0,586.0,145.0
0.005,6,10,2006,5,927,1.0,659.0,659.0,5,1079,1.0,811.0,811.0
0.006,6,10,2007,5,928,1.0,660.0,660.0,5,1079,1.0,811.0,811.0
40.055,17,10,676,5,460,10013.0,104.0,64.0,5,216,10013.0,20.0,15.0
374.745,6,21,1795,16,1030,24983.0,190.0,190.0,5,765,60021.0,464.0,248.0
0.011,6,10,1762,5,911,2.0,643.0,643.0,5,851,2.0,583.0,583.0
0.015,6,10,1989,5,910,3.0,642.0,642.0,5,1079,3.0,811.0,811.0
0.001,17,2,180,1,66,0.0,38.0,38.0,1,114,0.0,86.0,86.0
294.663,6,323,345091,127,18147,2338.0,2736.0,888.0,196,326944,1511.0,3053.0,1740.0
0.003,17,4,284,2,120,0.0,32.0,32.0,2,164,0.0,60.0,54.0
0.006,6,10,1689,5,839,1.0,571.0,571.0,5,850,1.0,582.0,582.0
0.014,17,2,152,1,56,0.0,28.0,28.0,1,96,0.0,68.0,68.0
0.01,6,10,1989,5,910,2.0,642.0,642.0,5,1079,2.0,811.0,811.0
0.006,6,10,1547,5,764,1.0,496.0,496.0,5,783,1.0,515.0,515.0
0.006,6,10,1547,5,764,1.0,496.0,496.0,5,783,1.0,515.0,515.0
0.143,6,10,1506,5,395,33.0,127.0,127.0,5,1111,16.0,843.0,843.0
0.005,6,10,1774,5,923,1.0,655.0,655.0,5,851,1.0,583.0,583.0
0.04,17,2,182,1,65,0.0,37.0,37.0,1,117,0.0,89.0,89.0
0.005,6,10,2007,5,928,1.0,660.0,660.0,5,1079,1.0,811.0,811.0
0.013,6,10,1972,5,910,3.0,642.0,642.0,5,1062,3.0,794.0,794.0
0.173,6,10,1506,5,395,40.0,127.0,127.0,5,1111,41.0,843.0,843.0
0.072,6,10,1506,5,395,15.0,127.0,127.0,5,1111,16.0,843.0,843.0
0.004,6,10,1989,5,927,1.0,659.0,659.0,5,1062,1.0,794.0,794.0
0.091,6,10,1506,5,395,20.0,127.0,127.0,5,1111,21.0,843.0,843.0
0.041,17,2,184,1,61,0.0,33.0,33.0,1,123,0.0,95.0,95.0
0.014,6,10,1989,5,910,3.0,642.0,642.0,5,1079,3.0,811.0,811.0
0.004,17,2,148,1,60,0.0,32.0,32.0,1,88,0.0,60.0,60.0
0.064,6,10,1506,5,395,13.0,127.0,127.0,5,1111,15.0,843.0,843.0
177.165,17,84,11970,42,2813,4321.0,44.0,38.0,42,9157,4320.0,239.0,190.0
0.006,6,10,1689,5,839,1.0,571.0,571.0,5,850,1.0,582.0,582.0
0.005,6,10,2000,5,927,1.0,659.0,659.0,5,1073,1.0,805.0,805.0
0.007,6,10,1990,5,911,1.0,643.0,643.0,5,1079,1.0,811.0,811.0
0.066,6,10,1506,5,395,15.0,127.0,127.0,5,1111,15.0,843.0,843.0
0.005,6,10,1854,5,889,1.0,621.0,621.0,5,965,1.0,697.0,697.0
0.021,6,10,1983,5,910,5.0,642.0,642.0,5,1073,5.0,805.0,805.0
0.005,6,10,1989,5,927,1.0,659.0,659.0,5,1062,1.0,794.0,794.0
0.001,17,2,180,1,66,0.0,38.0,38.0,1,114,0.0,86.0,86.0
0.001,17,2,180,1,66,0.0,38.0,38.0,1,114,0.0,86.0,86.0
277.313,6,25,7263,15,1811,19808.0,253.0,207.0,10,5452,30812.0,1402.0,703.0
0.006,6,10,1547,5,764,1.0,496.0,496.0,5,783,1.0,515.0,515.0
0.094,6,10,1506,5,395,21.0,127.0,127.0,5,1111,19.0,843.0,843.0
0.013,17,2,152,1,56,0.0,28.0,28.0,1,96,0.0,68.0,68.0
0.005,6,10,2000,5,927,1.0,659.0,659.0,5,1073,1.0,805.0,805.0
0.009,6,10,1631,5,848,2.0,580.0,580.0,5,783,2.0,515.0,515.0
0.011,6,10,1990,5,911,2.0,643.0,643.0,5,1079,2.0,811.0,811.0
0.004,17,2,164,1,74,0.0,46.0,46.0,1,90,0.0,62.0,62.0
0.084,6,10,1506,5,395,19.0,127.0,127.0,5,1111,19.0,843.0,843.0
0.086,6,10,1506,5,395,19.0,127.0,127.0,5,1111,15.0,843.0,843.0
1778.44,17,143,45188,72,22752,25047.0,288.0,288.0,71,22436,25403.0,288.0,288.0
0.005,6,10,1702,5,863,1.0,595.0,595.0,5,839,1.0,571.0,571.0
0.005,6,10,1547,5,764,1.0,496.0,496.0,5,783,1.0,515.0,515.0
174.027,17,74,10361,37,2473,4834.0,44.0,38.0,37,7888,4834.0,239.0,185.0
0.006,6,10,2006,5,927,1.0,659.0,659.0,5,1079,1.0,811.0,811.0
40.074,17,10,676,5,460,10014.0,104.0,64.0,5,216,10016.0,20.0,15.0
0.012,6,10,1990,5,911,3.0,643.0,643.0,5,1079,3.0,811.0,811.0
0.01,6,10,1972,5,910,2.0,642.0,642.0,5,1062,2.0,794.0,794.0
0.003,17,2,136,1,60,0.0,32.0,32.0,1,76,0.0,48.0,48.0
240.034,6,9,787,5,488,60008.0,232.0,232.0,4,299,80006.0,83.0,83.0
0.006,6,10,1689,5,839,1.0,571.0,571.0,5,850,1.0,582.0,582.0
300.403,6,27,7433,16,1409,20026.0,217.0,142.0,11,6024,24035.0,1679.0,777.0
0.005,6,10,2006,5,927,1.0,659.0,659.0,5,1079,1.0,811.0,811.0
0.005,6,10,2006,5,927,1.0,659.0,659.0,5,1079,1.0,811.0,811.0
0.001,17,2,180,1,66,0.0,38.0,38.0,1,114,0.0,86.0,86.0
0.008,6,10,1972,5,910,2.0,642.0,642.0,5,1062,2.0,794.0,794.0
0.009,6,10,1972,5,910,2.0,642.0,642.0,5,1062,2.0,794.0,794.0
0.003,17,2,148,1,60,0.0,32.0,32.0,1,88,0.0,60.0,60.0
0.006,6,10,2006,5,927,1.0,659.0,659.0,5,1079,1.0,811.0,811.0
0.004,6,10,1779,5,928,1.0,660.0,660.0,5,851,1.0,583.0,583.0
0.023,6,10,1990,5,911,5.0,643.0,643.0,5,1079,5.0,811.0,811.0
0.134,6,10,1506,5,395,28.0,127.0,127.0,5,1111,29.0,843.0,843.0
0.068,6,10,1506,5,395,13.0,127.0,127.0,5,1111,16.0,843.0,843.0
40.085,17,10,676,5,460,10019.0,104.0,64.0,5,216,10020.0,20.0,15.0
240.375,6,25,4174,12,1808,21849.0,539.0,235.0,13,2366,20028.0,1320.0,242.0
0.122,6,10,1506,5,395,25.0,127.0,127.0,5,1111,27.0,843.0,843.0
66.087,6,22,10152,12,3985,6007.0,1591.0,838.0,10,6167,7324.0,2111.0,939.0
0.004,6,10,2007,5,928,1.0,660.0,660.0,5,1079,1.0,811.0,811.0
0.001,17,2,180,1,66,0.0,38.0,38.0,1,114,0.0,86.0,86.0
0.001,17,2,180,1,66,0.0,38.0,38.0,1,114,0.0,86.0,86.0
0.006,6,10,1643,5,860,1.0,592.0,592.0,5,783,1.0,515.0,515.0
0.005,6,10,2000,5,927,1.0,659.0,659.0,5,1073,1.0,805.0,805.0
0.005,6,10,1854,5,889,1.0,621.0,621.0,5,965,1.0,697.0,697.0
0.038,17,4,284,2,120,0.0,32.0,32.0,2,164,34.0,60.0,54.0
157.278,17,80,11368,40,2668,4032.0,44.0,38.0,40,8700,4032.0,239.0,189.0
0.004,6,10,2000,5,927,1.0,659.0,659.0,5,1073,1.0,805.0,805.0
0.005,6,14,3736,7,446,0.0,74.0,74.0,7,3290,0.0,1448.0,972.0
0.005,6,10,2000,5,927,1.0,659.0,659.0,5,1073,1.0,805.0,805.0
0.012,6,10,1762,5,911,3.0,643.0,643.0,5,851,2.0,583.0,583.0
0.111,6,10,1506,5,395,26.0,127.0,127.0,5,1111,20.0,843.0,843.0
0.095,6,10,1506,5,395,20.0,127.0,127.0,5,1111,21.0,843.0,843.0
40.071,17,10,676,5,460,10016.0,104.0,64.0,5,216,10012.0,20.0,15.0
0.009,6,10,1989,5,910,2.0,642.0,642.0,5,1079,2.0,811.0,811.0
0.005,6,10,2007,5,928,1.0,660.0,660.0,5,1079,1.0,811.0,811.0
0.005,6,10,2006,5,927,1.0,659.0,659.0,5,1079,1.0,811.0,811.0
0.005,6,13,3747,7,509,0.0,137.0,137.0,6,3238,1.0,1470.0,1459.0
0.001,17,2,180,1,66,0.0,38.0,38.0,1,114,0.0,86.0,86.0
0.013,6,10,1989,5,910,3.0,642.0,642.0,5,1079,3.0,811.0,811.0
0.021,6,13,3735,7,497,3.0,125.0,125.0,6,3238,4.0,1470.0,1459.0
0.012,6,10,1972,5,910,2.0,642.0,642.0,5,1062,3.0,794.0,794.0
0.029,6,10,1990,5,911,7.0,643.0,643.0,5,1079,7.0,811.0,811.0
291.208,6,381,347765,194,21647,1508.0,2736.0,888.0,187,326118,1565.0,4206.0,1828.0
0.013,6,10,1972,5,910,3.0,642.0,642.0,5,1062,3.0,794.0,794.0
0.046,6,10,1989,5,910,11.0,642.0,642.0,5,1079,11.0,811.0,811.0
0.093,6,10,1506,5,395,16.0,127.0,127.0,5,1111,18.0,843.0,843.0
0.093,6,10,1506,5,395,22.0,127.0,127.0,5,1111,22.0,843.0,843.0
40.084,17,10,676,5,460,10017.0,104.0,64.0,5,216,10020.0,20.0,15.0
0.006,6,10,1547,5,764,1.0,496.0,496.0,5,783,1.0,515.0,515.0
0.011,6,10,1990,5,911,2.0,643.0,643.0,5,1079,2.0,811.0,811.0
0.118,6,10,1506,5,395,28.0,127.0,127.0,5,1111,19.0,843.0,843.0
0.125,6,10,4887,5,773,31.0,517.0,517.0,5,4114,21.0,1402.0,1282.0
10.981,17,28,4419,14,1995,835.0,270.0,114.0,14,2424,835.0,587.0,145.0
0.001,17,2,180,1,66,0.0,38.0,38.0,1,114,0.0,86.0,86.0
15.074,17,15,9238,8,6902,2149.0,1350.0,834.0,7,2336,2507.0,1350.0,305.0
0.003,17,2,152,1,76,0.0,48.0,48.0,1,76,0.0,48.0,48.0
0.118,6,10,1506,5,395,21.0,127.0,127.0,5,1111,21.0,843.0,843.0
0.005,6,10,1989,5,927,1.0,659.0,659.0,5,1062,1.0,794.0,794.0
0.068,17,8,3613,4,1874,22.0,1350.0,440.0,4,1739,11.0,1350.0,406.0
0.022,17,2,152,1,76,0.0,48.0,48.0,1,76,0.0,48.0,48.0
0.005,17,4,284,2,120,0.0,32.0,32.0,2,164,0.0,60.0,54.0
0.005,6,10,2007,5,928,1.0,660.0,660.0,5,1079,1.0,811.0,811.0
0.005,6,10,1989,5,927,1.0,659.0,659.0,5,1062,1.0,794.0,794.0
0.071,6,10,1506,5,395,13.0,127.0,127.0,5,1111,16.0,843.0,843.0
10.837,17,28,4423,14,1995,824.0,270.0,114.0,14,2428,825.0,587.0,145.0
0.005,6,10,2006,5,927,1.0,659.0,659.0,5,1079,1.0,811.0,811.0
0.005,6,10,2007,5,928,1.0,660.0,660.0,5,1079,1.0,811.0,811.0
40.062,17,10,676,5,460,10014.0,104.0,64.0,5,216,10014.0,20.0,15.0
0.004,6,10,1989,5,927,1.0,659.0,659.0,5,1062,1.0,794.0,794.0
0.004,17,4,284,2,120,0.0,32.0,32.0,2,164,1.0,60.0,54.0
0.005,6,13,3747,7,509,0.0,137.0,137.0,6,3238,1.0,1470.0,1459.0
0.004,6,10,1779,5,928,1.0,660.0,660.0,5,851,1.0,583.0,583.0
0.012,6,10,1989,5,910,3.0,642.0,642.0,5,1079,2.0,811.0,811.0
0.003,17,2,148,1,60,0.0,32.0,32.0,1,88,0.0,60.0,60.0
240.015,6,9,787,5,488,60003.0,232.0,232.0,4,299,80003.0,83.0,83.0
0.071,17,8,3613,4,1874,23.0,1350.0,440.0,4,1739,13.0,1350.0,406.0
0.204,6,16,2670,8,1396,29.0,533.0,324.0,8,1274,18.0,529.0,212.0
0.061,6,10,1506,5,395,13.0,127.0,127.0,5,1111,14.0,843.0,843.0
0.015,6,10,1762,5,911,3.0,643.0,643.0,5,851,3.0,583.0,583.0
0.006,6,10,1547,5,764,1.0,496.0,496.0,5,783,1.0,515.0,515.0
0.009,6,10,1989,5,910,2.0,642.0,642.0,5,1079,2.0,811.0,811.0
0.02,6,10,1631,5,848,4.0,580.0,580.0,5,783,4.0,515.0,515.0
0.003,17,4,284,2,120,0.0,32.0,32.0,2,164,0.0,60.0,54.0
0.005,6,13,3747,7,509,0.0,137.0,137.0,6,3238,0.0,1470.0,1459.0
0.011,6,10,1989,5,910,2.0,642.0,642.0,5,1079,2.0,811.0,811.0
0.077,6,10,1506,5,395,17.0,127.0,127.0,5,1111,16.0,843.0,843.0
0.015,6,10,1631,5,848,3.0,580.0,580.0,5,783,3.0,515.0,515.0
0.004,6,10,1702,5,863,0.0,595.0,595.0,5,839,1.0,571.0,571.0
0.01,6,10,1989,5,910,2.0,642.0,642.0,5,1079,2.0,811.0,811.0
0.108,6,10,1506,5,395,22.0,127.0,127.0,5,1111,22.0,843.0,843.0
0.005,6,10,1689,5,839,1.0,571.0,571.0,5,850,1.0,582.0,582.0
356.652,6,19,1691,15,978,25475.0,190.0,190.0,4,713,80016.0,497.0,497.0
291.548,6,377,347280,187,21287,1567.0,2736.0,888.0,190,325993,1542.0,2804.0,1796.0
0.004,6,10,2007,5,928,1.0,660.0,660.0,5,1079,1.0,811.0,811.0
0.012,6,10,1990,5,911,2.0,643.0,643.0,5,1079,2.0,811.0,811.0
309.045,17,20,1124,10,716,34326.0,48.0,43.0,10,408,34328.0,20.0,12.0
0.008,6,10,1990,5,911,2.0,643.0,643.0,5,1079,2.0,811.0,811.0
0.285,17,41,20290,22,17100,13.0,1350.0,749.0,19,3190,12.0,1350.0,139.0
0.004,6,10,2006,5,927,1.0,659.0,659.0,5,1079,1.0,811.0,811.0
0.07,6,10,1506,5,395,16.0,127.0,127.0,5,1111,16.0,843.0,843.0
40.068,17,10,676,5,460,10016.0,104.0,64.0,5,216,10016.0,20.0,15.0
0.005,6,10,1989,5,927,1.0,659.0,659.0,5,1062,1.0,794.0,794.0
0.005,6,14,3736,7,446,0.0,74.0,74.0,7,3290,0.0,1448.0,972.0
0.014,6,10,1990,5,911,3.0,643.0,643.0,5,1079,3.0,811.0,811.0
0.005,6,10,2007,5,928,1.0,660.0,660.0,5,1079,1.0,811.0,811.0
15.072,17,14,9190,8,6902,2149.0,1350.0,834.0,6,2288,3008.0,1350.0,353.0
0.008,6,10,1989,5,910,2.0,642.0,642.0,5,1079,1.0,811.0,811.0
0.066,17,8,3613,4,1874,22.0,1350.0,440.0,4,1739,11.0,1350.0,406.0
0.068,6,10,1506,5,395,15.0,127.0,127.0,5,1111,15.0,843.0,843.0
302.13,6,238,202937,130,191758,2340.0,3083.0,1743.0,108,11179,2822.0,2667.0,236.0
240.084,6,16,4481,9,963,30010.0,238.0,166.0,7,3518,40013.0,1402.0,786.0
0.006,17,2,179,1,71,0.0,43.0,43.0,1,108,0.0,80.0,80.0
0.012,6,10,1762,5,911,2.0,643.0,643.0,5,851,2.0,583.0,583.0
40.083,17,10,676,5,460,10016.0,104.0,64.0,5,216,10019.0,20.0,15.0
0.005,17,2,169,1,62,0.0,34.0,34.0,1,107,0.0,79.0,79.0
0.012,6,10,1989,5,910,3.0,642.0,642.0,5,1079,3.0,811.0,811.0
0.028,6,10,1677,5,827,7.0,559.0,559.0,5,850,7.0,582.0,582.0
0.005,17,2,169,1,62,0.0,34.0,34.0,1,107,0.0,79.0,79.0
0.013,6,13,3735,7,497,2.0,125.0,125.0,6,3238,2.0,1470.0,1459.0
0.004,6,10,1702,5,863,1.0,595.0,595.0,5,839,0.0,571.0,571.0
0.005,6,10,2006,5,927,1.0,659.0,659.0,5,1079,1.0,811.0,811.0
0.009,6,12,1926,6,1189,1.0,659.0,434.0,6,737,1.0,417.0,417.0
0.005,17,2,169,1,62,0.0,34.0,34.0,1,107,0.0,79.0,79.0
0.001,17,2,180,1,66,0.0,38.0,38.0,1,114,0.0,86.0,86.0
0.005,6,10,1689,5,839,1.0,571.0,571.0,5,850,1.0,582.0,582.0
0.039,17,4,284,2,120,0.0,32.0,32.0,2,164,34.0,60.0,54.0
0.001,17,2,142,1,63,0.0,35.0,35.0,1,79,0.0,51.0,51.0
15.074,17,11,4682,5,2262,3760.0,1350.0,424.0,6,2420,3008.0,1350.0,375.0
0.003,17,2,148,1,60,0.0,32.0,32.0,1,88,0.0,60.0,60.0
0.026,6,10,1989,5,910,6.0,642.0,642.0,5,1079,6.0,811.0,811.0
0.041,17,2,136,1,60,0.0,32.0,32.0,1,76,0.0,48.0,48.0
0.008,6,10,1990,5,911,2.0,643.0,643.0,5,1079,2.0,811.0,811.0
15.076,17,15,8074,8,6055,2149.0,1350.0,728.0,7,2019,2507.0,1350.0,260.0
0.015,6,10,1972,5,910,3.0,642.0,642.0,5,1062,3.0,794.0,794.0
0.28,17,44,24322,24,21179,12.0,1350.0,854.0,20,3143,11.0,1350.0,129.0
0.006,17,2,180,1,58,0.0,30.0,30.0,1,122,0.0,94.0,94.0
0.01,6,10,1989,5,910,2.0,642.0,642.0,5,1079,2.0,811.0,811.0
0.015,6,13,3735,7,497,2.0,125.0,125.0,6,3238,2.0,1470.0,1459.0
0.015,6,10,1990,5,911,3.0,643.0,643.0,5,1079,3.0,811.0,811.0
0.035,6,10,1972,5,910,8.0,642.0,642.0,5,1062,8.0,794.0,794.0
0.011,6,10,1990,5,911,2.0,643.0,643.0,5,1079,2.0,811.0,811.0
11.109,17,28,4423,14,1994,842.0,269.0,114.0,14,2429,842.0,588.0,145.0
0.008,17,2,367,1,99,0.0,71.0,71.0,1,268,0.0,240.0,240.0
0.005,6,10,2006,5,927,1.0,659.0,659.0,5,1079,1.0,811.0,811.0
0.021,6,10,1989,5,910,5.0,642.0,642.0,5,1079,5.0,811.0,811.0
0.011,6,10,1990,5,911,2.0,643.0,643.0,5,1079,2.0,811.0,811.0
173.405,17,78,11161,39,2596,4563.0,44.0,38.0,39,8565,4563.0,239.0,191.0
240.076,6,20,4872,10,889,26675.0,180.0,93.0,10,3983,26674.0,1591.0,575.0
0.013,6,13,3735,7,497,2.0,125.0,125.0,6,3238,2.0,1470.0,1459.0
0.011,6,10,1989,5,910,2.0,642.0,642.0,5,1079,2.0,811.0,811.0
0.066,6,10,1506,5,395,14.0,127.0,127.0,5,1111,15.0,843.0,843.0
0.004,17,2,186,1,61,0.0,33.0,33.0,1,125,0.0,97.0,97.0
0.011,6,12,1698,6,863,2.0,327.0,271.0,6,835,2.0,515.0,515.0
301.019,6,44,14221,24,8394,13087.0,2720.0,925.0,20,5827,467.0,2667.0,385.0
0.014,6,10,1990,5,911,3.0,643.0,643.0,5,1079,3.0,811.0,811.0
0.127,6,10,1506,5,395,29.0,127.0,127.0,5,1111,29.0,843.0,843.0
0.001,17,2,136,1,60,0.0,32.0,32.0,1,76,0.0,48.0,48.0
0.322,6,16,2674,8,1400,46.0,533.0,325.0,8,1274,30.0,529.0,212.0
0.006,6,10,1547,5,764,1.0,496.0,496.0,5,783,1.0,515.0,515.0
0.005,17,2,136,1,60,0.0,32.0,32.0,1,76,0.0,48.0,48.0
0.037,17,2,148,1,60,0.0,32.0,32.0,1,88,0.0,60.0,60.0
0.104,6,10,1506,5,395,22.0,127.0,127.0,5,1111,25.0,843.0,843.0
40.071,17,10,676,5,460,10014.0,104.0,64.0,5,216,10016.0,20.0,15.0
0.005,6,10,2006,5,927,1.0,659.0,659.0,5,1079,1.0,811.0,811.0
0.004,6,10,1702,5,863,1.0,595.0,595.0,5,839,1.0,571.0,571.0
0.016,6,10,1990,5,911,3.0,643.0,643.0,5,1079,3.0,811.0,811.0
0.019,6,10,1972,5,910,4.0,642.0,642.0,5,1062,4.0,794.0,794.0
0.005,17,2,170,1,65,0.0,37.0,37.0,1,105,0.0,77.0,77.0
40.061,17,10,676,5,460,10012.0,104.0,64.0,5,216,10014.0,20.0,15.0
0.016,6,10,1631,5,848,4.0,580.0,580.0,5,783,4.0,515.0,515.0
1799.999,6,243,25915,94,16466,19354.0,2720.0,160.0,149,9449,12161.0,225.0,49.0
0.003,17,2,148,1,60,0.0,32.0,32.0,1,88,0.0,60.0,60.0
0.005,6,10,2006,5,927,1.0,659.0,659.0,5,1079,1.0,811.0,811.0
0.044,17,2,136,1,60,0.0,32.0,32.0,1,76,0.0,48.0,48.0
253.432,6,41,9844,18,6815,14907.0,1368.0,534.0,23,3029,11519.0,580.0,130.0
0.078,6,10,1506,5,395,16.0,127.0,127.0,5,1111,16.0,843.0,843.0
0.012,6,10,1990,5,911,3.0,643.0,643.0,5,1079,3.0,811.0,811.0
0.004,17,2,136,1,60,0.0,32.0,32.0,1,76,0.0,48.0,48.0
0.005,6,10,2000,5,927,1.0,659.0,659.0,5,1073,1.0,805.0,805.0
0.01,6,10,1972,5,910,2.0,642.0,642.0,5,1062,2.0,794.0,794.0
0.005,6,10,2006,5,927,1.0,659.0,659.0,5,1079,1.0,811.0,811.0
0.007,17,2,214,1,75,0.0,47.0,47.0,1,139,0.0,111.0,111.0
0.122,17,2,80,1,32,0.0,4.0,4.0,1,48,0.0,20.0,20.0
900.921,6,61,22806,32,6181,29061.0,973.0,501.0,29,16625,30030.0,1402.0,795.0
0.008,6,12,1926,6,1189,1.0,659.0,434.0,6,737,1.0,417.0,417.0
0.005,6,10,2000,5,927,1.0,659.0,659.0,5,1073,1.0,805.0,805.0
0.089,6,10,1506,5,395,18.0,127.0,127.0,5,1111,21.0,843.0,843.0
0.006,17,2,214,1,75,0.0,47.0,47.0,1,139,0.0,111.0,111.0
0.101,6,10,1506,5,395,19.0,127.0,127.0,5,1111,23.0,843.0,843.0
0.156,6,16,4622,8,993,22.0,517.0,290.0,8,3629,20.0,1402.0,1068.0
0.006,6,13,3747,7,509,0.0,137.0,137.0,6,3238,1.0,1470.0,1459.0
1770.86,6,311,98814,191,87221,9320.0,1402.0,671.0,120,11593,14881.0,452.0,71.0
0.003,17,2,148,1,60,0.0,32.0,32.0,1,88,0.0,60.0,60.0
0.018,6,10,1972,5,910,4.0,642.0,642.0,5,1062,4.0,794.0,794.0
0.005,17,2,164,1,74,0.0,46.0,46.0,1,90,0.0,62.0,62.0
0.1,6,10,1506,5,395,23.0,127.0,127.0,5,1111,22.0,843.0,843.0
0.012,6,10,1989,5,910,3.0,642.0,642.0,5,1079,3.0,811.0,811.0
0.011,6,10,1972,5,910,2.0,642.0,642.0,5,1062,2.0,794.0,794.0
11.283,17,28,4421,14,1993,855.0,268.0,114.0,14,2428,855.0,587.0,145.0
10.793,17,28,4421,14,1994,821.0,269.0,114.0,14,2427,821.0,586.0,145.0
0.014,6,10,1989,5,910,3.0,642.0,642.0,5,1079,3.0,811.0,811.0
0.014,6,10,1983,5,910,3.0,642.0,642.0,5,1073,3.0,805.0,805.0
0.112,6,10,1506,5,395,25.0,127.0,127.0,5,1111,23.0,843.0,843.0
0.008,6,10,1547,5,764,2.0,496.0,496.0,5,783,1.0,515.0,515.0
40.083,17,10,676,5,460,10017.0,104.0,64.0,5,216,10020.0,20.0,15.0
0.092,6,10,1506,5,395,19.0,127.0,127.0,5,1111,21.0,843.0,843.0
0.076,6,10,1506,5,395,17.0,127.0,127.0,5,1111,17.0,843.0,843.0
174.173,17,80,11544,40,2668,4465.0,44.0,38.0,40,8876,4465.0,239.0,193.0
0.005,6,10,1547,5,764,1.0,496.0,496.0,5,783,1.0,515.0,515.0
0.017,6,10,1989,5,910,4.0,642.0,642.0,5,1079,4.0,811.0,811.0
0.016,6,10,1762,5,911,4.0,643.0,643.0,5,851,4.0,583.0,583.0
0.006,6,10,2000,5,927,1.0,659.0,659.0,5,1073,1.0,805.0,805.0
0.012,6,10,1983,5,910,2.0,642.0,642.0,5,1073,3.0,805.0,805.0
0.004,17,4,284,2,120,0.0,32.0,32.0,2,164,0.0,60.0,54.0
0.013,6,10,1631,5,848,3.0,580.0,580.0,5,783,3.0,515.0,515.0
240.27,6,47,9030,24,5854,10446.0,1368.0,458.0,23,3176,10921.0,580.0,219.0
0.065,6,10,1506,5,395,15.0,127.0,127.0,5,1111,12.0,843.0,843.0
0.004,6,10,1989,5,927,1.0,659.0,659.0,5,1062,1.0,794.0,794.0
0.134,6,10,1506,5,395,25.0,127.0,127.0,5,1111,29.0,843.0,843.0
0.011,6,10,1972,5,910,2.0,642.0,642.0,5,1062,2.0,794.0,794.0
0.006,6,10,1547,5,764,1.0,496.0,496.0,5,783,1.0,515.0,515.0
0.014,6,10,1762,5,911,3.0,643.0,643.0,5,851,3.0,583.0,583.0
0.004,6,10,1779,5,928,1.0,660.0,660.0,5,851,1.0,583.0,583.0
0.056,17,2,299,1,65,0.0,37.0,37.0,1,234,0.0,206.0,206.0
0.04,17,2,148,1,60,0.0,32.0,32.0,1,88,0.0,60.0,60.0
0.123,6,10,1506,5,395,28.0,127.0,127.0,5,1111,25.0,843.0,843.0
0.008,6,10,1989,5,910,2.0,642.0,642.0,5,1079,2.0,811.0,811.0
0.076,6,10,1506,5,395,14.0,127.0,127.0,5,1111,17.0,843.0,843.0
0.108,6,10,1506,5,395,24.0,127.0,127.0,5,1111,23.0,843.0,843.0
0.009,6,10,1989,5,910,2.0,642.0,642.0,5,1079,2.0,811.0,811.0
0.082,6,10,1506,5,395,19.0,127.0,127.0,5,1111,16.0,843.0,843.0
0.071,6,10,1506,5,395,16.0,127.0,127.0,5,1111,14.0,843.0,843.0
0.01,6,10,1989,5,910,2.0,642.0,642.0,5,1079,2.0,811.0,811.0
0.011,6,10,1972,5,910,2.0,642.0,642.0,5,1062,2.0,794.0,794.0
0.018,6,10,1989,5,910,4.0,642.0,642.0,5,1079,4.0,811.0,811.0
241.523,6,382,346892,196,21700,1238.0,2736.0,959.0,186,325192,1305.0,2804.0,1792.0
352.729,6,20,2210,6,1308,12003.0,494.0,494.0,14,902,27132.0,83.0,83.0
40.081,17,10,676,5,460,10019.0,104.0,64.0,5,216,10019.0,20.0,15.0
0.006,6,10,1547,5,764,1.0,496.0,496.0,5,783,1.0,515.0,515.0
0.075,6,10,1506,5,395,16.0,127.0,127.0,5,1111,17.0,843.0,843.0
0.005,6,10,2006,5,927,1.0,659.0,659.0,5,1079,1.0,811.0,811.0
0.015,6,10,1631,5,848,3.0,580.0,580.0,5,783,3.0,515.0,515.0
0.008,17,2,168,1,76,0.0,48.0,48.0,1,92,0.0,64.0,64.0
40.061,17,10,676,5,460,10012.0,104.0,64.0,5,216,10013.0,20.0,15.0
40.099,17,10,676,5,460,10023.0,104.0,64.0,5,216,10024.0,20.0,15.0
0.004,17,2,148,1,60,0.0,32.0,32.0,1,88,0.0,60.0,60.0
0.013,6,10,1989,5,910,3.0,642.0,642.0,5,1079,3.0,811.0,811.0
0.014,6,10,1983,5,910,3.0,642.0,642.0,5,1073,3.0,805.0,805.0
0.005,6,10,2006,5,927,1.0,659.0,659.0,5,1079,1.0,811.0,811.0
300.392,6,16,2170,9,684,37528.0,146.0,146.0,7,1486,50037.0,419.0,398.0
0.005,6,10,1689,5,839,1.0,571.0,571.0,5,850,1.0,582.0,582.0
0.005,6,10,1547,5,764,1.0,496.0,496.0,5,783,1.0,515.0,515.0
305.002,17,16,928,8,608,43553.0,48.0,48.0,8,320,43553.0,12.0,12.0
0.093,6,10,1506,5,395,22.0,127.0,127.0,5,1111,19.0,843.0,843.0
0.107,6,10,1506,5,395,23.0,127.0,127.0,5,1111,25.0,843.0,843.0
0.016,6,10,1631,5,848,4.0,580.0,580.0,5,783,3.0,515.0,515.0
0.014,6,10,1990,5,911,3.0,643.0,643.0,5,1079,3.0,811.0,811.0
0.04,17,2,182,1,65,0.0,37.0,37.0,1,117,0.0,89.0,89.0
0.008,6,12,1926,6,1189,1.0,659.0,434.0,6,737,1.0,417.0,417.0
11.102,17,28,4423,14,1995,841.0,270.0,114.0,14,2428,841.0,587.0,145.0
1755.35,6,538,187403,275,162715,6406.0,2883.0,969.0,263,24688,6699.0,388.0,109.0
0.064,6,10,1506,5,395,13.0,127.0,127.0,5,1111,14.0,843.0,843.0
0.04,17,2,182,1,65,0.0,37.0,37.0,1,117,0.0,89.0,89.0
0.097,6,10,1506,5,395,21.0,127.0,127.0,5,1111,22.0,843.0,843.0
0.001,17,2,166,1,75,0.0,47.0,47.0,1,91,0.0,63.0,63.0
0.004,17,2,148,1,60,0.0,32.0,32.0,1,88,0.0,60.0,60.0
0.005,17,2,164,1,74,0.0,46.0,46.0,1,90,0.0,62.0,62.0
0.017,6,10,1990,5,911,4.0,643.0,643.0,5,1079,4.0,811.0,811.0
0.011,6,10,1989,5,910,2.0,642.0,642.0,5,1079,2.0,811.0,811.0
0.084,6,10,1506,5,395,18.0,127.0,127.0,5,1111,18.0,843.0,843.0
0.005,6,10,2007,5,928,1.0,660.0,660.0,5,1079,1.0,811.0,811.0
0.005,6,10,1989,5,927,1.0,659.0,659.0,5,1062,1.0,794.0,794.0
0.009,6,10,1631,5,848,2.0,580.0,580.0,5,783,2.0,515.0,515.0
0.001,17,2,180,1,66,0.0,38.0,38.0,1,114,0.0,86.0,86.0
0.081,6,10,1506,5,395,18.0,127.0,127.0,5,1111,19.0,843.0,843.0
0.004,17,2,136,1,60,0.0,32.0,32.0,1,76,0.0,48.0,48.0
0.005,6,13,3747,7,509,0.0,137.0,137.0,6,3238,0.0,1470.0,1459.0
0.006,17,2,160,1,72,0.0,44.0,44.0,1,88,0.0,60.0,60.0
0.093,6,10,1506,5,395,21.0,127.0,127.0,5,1111,18.0,843.0,843.0
0.014,6,10,1990,5,911,3.0,643.0,643.0,5,1079,3.0,811.0,811.0
0.091,6,10,1506,5,395,21.0,127.0,127.0,5,1111,20.0,843.0,843.0
300.376,6,16,2170,9,684,37526.0,146.0,146.0,7,1486,50035.0,419.0,398.0
0.005,6,13,3747,7,509,0.0,137.0,137.0,6,3238,1.0,1470.0,1459.0
40.057,17,10,676,5,460,10013.0,104.0,64.0,5,216,10012.0,20.0,15.0
0.013,6,10,1990,5,911,3.0,643.0,643.0,5,1079,3.0,811.0,811.0
0.01,6,10,1990,5,911,2.0,643.0,643.0,5,1079,2.0,811.0,811.0
0.117,6,10,1506,5,395,26.0,127.0,127.0,5,1111,25.0,843.0,843.0
15.072,17,15,9238,8,6902,2149.0,1350.0,834.0,7,2336,2507.0,1350.0,305.0
0.365,17,43,23098,24,18513,15.0,1350.0,743.0,19,4585,15.0,1350.0,213.0
0.005,17,2,214,1,75,0.0,47.0,47.0,1,139,0.0,111.0,111.0
0.005,6,10,2006,5,927,1.0,659.0,659.0,5,1079,1.0,811.0,811.0
0.09,6,10,1506,5,395,19.0,127.0,127.0,5,1111,16.0,843.0,843.0
0.077,6,10,1506,5,395,15.0,127.0,127.0,5,1111,18.0,843.0,843.0
0.015,6,10,1989,5,910,3.0,642.0,642.0,5,1079,3.0,811.0,811.0
0.043,6,10,1972,5,910,10.0,642.0,642.0,5,1062,10.0,794.0,794.0
308.636,17,20,1124,10,716,34286.0,48.0,43.0,10,408,34286.0,20.0,12.0
0.045,6,10,1989,5,910,11.0,642.0,642.0,5,1079,11.0,811.0,811.0
0.004,6,10,2007,5,928,1.0,660.0,660.0,5,1079,1.0,811.0,811.0
0.015,6,10,1989,5,910,3.0,642.0,642.0,5,1079,3.0,811.0,811.0
0.004,6,10,1702,5,863,1.0,595.0,595.0,5,839,1.0,571.0,571.0
0.01,6,10,1762,5,911,2.0,643.0,643.0,5,851,2.0,583.0,583.0
0.004,6,10,2000,5,927,1.0,659.0,659.0,5,1073,1.0,805.0,805.0
0.072,6,10,1506,5,395,16.0,127.0,127.0,5,1111,17.0,843.0,843.0
0.005,6,10,1779,5,928,1.0,660.0,660.0,5,851,1.0,583.0,583.0
0.005,6,10,2000,5,927,1.0,659.0,659.0,5,1073,1.0,805.0,805.0
40.053,17,10,676,5,460,10012.0,104.0,64.0,5,216,10011.0,20.0,15.0
0.005,6,10,2006,5,927,1.0,659.0,659.0,5,1079,1.0,811.0,811.0
9.037,17,6,376,5,280,2259.0,28.0,28.0,1,96,0.0,68.0,68.0
40.066,17,10,676,5,460,10013.0,104.0,64.0,5,216,10015.0,20.0,15.0
0.105,6,10,1506,5,395,25.0,127.0,127.0,5,1111,25.0,843.0,843.0
0.034,17,2,152,1,76,0.0,48.0,48.0,1,76,0.0,48.0,48.0
10.938,17,28,4422,14,1994,832.0,269.0,114.0,14,2428,832.0,587.0,145.0
0.012,6,10,1677,5,827,3.0,559.0,559.0,5,850,3.0,582.0,582.0
0.006,6,10,2006,5,927,1.0,659.0,659.0,5,1079,1.0,811.0,811.0
0.005,6,10,2007,5,928,1.0,660.0,660.0,5,1079,1.0,811.0,811.0
371.216,6,22,2313,16,867,24747.0,195.0,195.0,6,1446,4639.0,419.0,398.0
0.003,17,2,148,1,60,0.0,32.0,32.0,1,88,0.0,60.0,60.0
0.014,6,10,1972,5,910,3.0,642.0,642.0,5,1062,3.0,794.0,794.0
0.126,17,2,182,1,65,0.0,37.0,37.0,1,117,0.0,89.0,89.0
0.071,6,10,1506,5,395,15.0,127.0,127.0,5,1111,16.0,843.0,843.0
240.09,6,16,4482,9,963,30011.0,238.0,166.0,7,3519,40014.0,1402.0,786.0
0.035,6,10,1989,5,910,8.0,642.0,642.0,5,1079,8.0,811.0,811.0
0.099,6,10,1506,5,395,22.0,127.0,127.0,5,1111,19.0,843.0,843.0
0.014,6,13,3735,7,497,2.0,125.0,125.0,6,3238,2.0,1470.0,1459.0
0.001,17,2,136,1,60,0.0,32.0,32.0,1,76,0.0,48.0,48.0
177.14,17,94,13383,47,3164,3850.0,44.0,39.0,47,10219,3850.0,239.0,189.0
0.201,6,10,1506,5,395,45.0,127.0,127.0,5,1111,46.0,843.0,843.0
0.11,6,10,1506,5,395,23.0,127.0,127.0,5,1111,23.0,843.0,843.0
10.936,17,28,4392,14,2313,833.0,588.0,137.0,14,2079,833.0,270.0,120.0
0.118,6,10,1506,5,395,26.0,127.0,127.0,5,1111,24.0,843.0,843.0
0.115,17,4,284,2,120,112.0,32.0,32.0,2,164,111.0,60.0,54.0
0.005,6,10,2000,5,927,1.0,659.0,659.0,5,1073,1.0,805.0,805.0
0.005,6,10,2006,5,927,1.0,659.0,659.0,5,1079,1.0,811.0,811.0
0.02,6,10,1983,5,910,5.0,642.0,642.0,5,1073,4.0,805.0,805.0
0.009,6,10,1989,5,910,2.0,642.0,642.0,5,1079,2.0,811.0,811.0
0.001,17,2,179,1,62,0.0,34.0,34.0,1,117,0.0,89.0,89.0
0.005,6,10,1989,5,927,1.0,659.0,659.0,5,1062,1.0,794.0,794.0
0.001,17,2,180,1,66,0.0,38.0,38.0,1,114,0.0,86.0,86.0
0.012,6,13,3735,7,497,2.0,125.0,125.0,6,3238,2.0,1470.0,1459.0
0.006,6,10,1547,5,764,1.0,496.0,496.0,5,783,1.0,515.0,515.0
0.009,6,12,1926,6,1189,1.0,659.0,434.0,6,737,1.0,417.0,417.0
0.005,6,10,2007,5,928,1.0,660.0,660.0,5,1079,1.0,811.0,811.0
291.027,6,389,348584,200,21964,1462.0,2736.0,888.0,189,326620,1547.0,2804.0,1820.0
292.699,6,389,347223,200,21965,1470.0,1868.0,770.0,189,325258,1556.0,2804.0,1792.0
309.086,17,20,1124,10,716,34328.0,48.0,43.0,10,408,34329.0,20.0,12.0
0.016,6,10,1677,5,827,3.0,559.0,559.0,5,850,3.0,582.0,582.0
0.009,6,10,1677,5,827,2.0,559.0,559.0,5,850,2.0,582.0,582.0
0.004,6,10,1989,5,927,1.0,659.0,659.0,5,1062,1.0,794.0,794.0
0.005,6,10,2007,5,928,1.0,660.0,660.0,5,1079,1.0,811.0,811.0
0.005,6,10,1989,5,927,1.0,659.0,659.0,5,1062,1.0,794.0,794.0
0.041,6,10,1989,5,910,10.0,642.0,642.0,5,1079,10.0,811.0,811.0
0.087,6,10,1506,5,395,20.0,127.0,127.0,5,1111,19.0,843.0,843.0
0.005,6,10,2006,5,927,1.0,659.0,659.0,5,1079,1.0,811.0,811.0
0.087,6,10,1506,5,395,19.0,127.0,127.0,5,1111,18.0,843.0,843.0
0.005,17,2,170,1,65,0.0,37.0,37.0,1,105,0.0,77.0,77.0
0.004,6,10,1989,5,927,1.0,659.0,659.0,5,1062,1.0,794.0,794.0
0.005,6,10,2007,5,928,1.0,660.0,660.0,5,1079,1.0,811.0,811.0
0.09,6,10,1506,5,395,18.0,127.0,127.0,5,1111,21.0,843.0,843.0
0.005,6,10,1689,5,839,1.0,571.0,571.0,5,850,1.0,582.0,582.0
300.338,6,16,2170,9,684,37520.0,146.0,146.0,7,1486,50026.0,419.0,398.0
0.008,6,12,1926,6,1189,1.0,659.0,434.0,6,737,1.0,417.0,417.0
0.111,6,10,1506,5,395,25.0,127.0,127.0,5,1111,17.0,843.0,843.0
0.117,6,10,1506,5,395,25.0,127.0,127.0,5,1111,25.0,843.0,843.0
0.009,6,10,1972,5,910,2.0,642.0,642.0,5,1062,2.0,794.0,794.0
0.015,17,2,412,1,61,0.0,33.0,33.0,1,351,0.0,323.0,323.0
0.006,6,10,1547,5,764,1.0,496.0,496.0,5,783,1.0,515.0,515.0
0.099,6,10,1506,5,395,22.0,127.0,127.0,5,1111,22.0,843.0,843.0
0.005,17,2,136,1,60,0.0,32.0,32.0,1,76,0.0,48.0,48.0
0.005,6,10,2007,5,928,1.0,660.0,660.0,5,1079,1.0,811.0,811.0
309.519,17,20,1124,10,716,34377.0,48.0,43.0,10,408,34377.0,20.0,12.0
0.005,6,10,1989,5,927,1.0,659.0,659.0,5,1062,1.0,794.0,794.0
0.004,17,2,136,1,60,0.0,32.0,32.0,1,76,0.0,48.0,48.0
0.005,6,10,2007,5,928,1.0,660.0,660.0,5,1079,1.0,811.0,811.0
0.06,6,10,1506,5,395,13.0,127.0,127.0,5,1111,13.0,843.0,843.0
0.013,17,2,152,1,56,0.0,28.0,28.0,1,96,0.0,68.0,68.0
0.005,6,10,1989,5,927,1.0,659.0,659.0,5,1062,1.0,794.0,794.0
0.071,6,10,1506,5,395,13.0,127.0,127.0,5,1111,16.0,843.0,843.0
0.005,6,10,1854,5,889,1.0,621.0,621.0,5,965,1.0,697.0,697.0
0.005,17,2,170,1,65,0.0,37.0,37.0,1,105,0.0,77.0,77.0
0.004,6,10,2006,5,927,1.0,659.0,659.0,5,1079,1.0,811.0,811.0
0.005,17,2,169,1,62,0.0,34.0,34.0,1,107,0.0,79.0,79.0
0.018,6,10,1990,5,911,4.0,643.0,643.0,5,1079,4.0,811.0,811.0
0.006,6,10,1547,5,764,1.0,496.0,496.0,5,783,1.0,515.0,515.0
0.027,6,10,1762,5,911,6.0,643.0,643.0,5,851,6.0,583.0,583.0
0.006,17,2,154,1,69,0.0,41.0,41.0,1,85,0.0,57.0,57.0
178.072,17,92,13390,46,3063,3956.0,44.0,38.0,46,10327,3956.0,239.0,196.0
0.004,6,10,1702,5,863,1.0,595.0,595.0,5,839,0.0,571.0,571.0
12.321,17,42,9463,21,5173,608.0,1337.0,218.0,21,4290,608.0,861.0,176.0
0.004,17,4,284,2,120,1.0,32.0,32.0,2,164,0.0,60.0,54.0
0.006,6,10,1547,5,764,1.0,496.0,496.0,5,783,1.0,515.0,515.0
0.015,6,10,1990,5,911,3.0,643.0,643.0,5,1079,3.0,811.0,811.0
1772.283,6,104,6218,59,3473,30555.0,27.0,27.0,45,2745,40278.0,27.0,27.0
0.006,6,12,1698,6,863,1.0,327.0,271.0,6,835,1.0,515.0,515.0
0.099,6,10,1506,5,395,21.0,127.0,127.0,5,1111,24.0,843.0,843.0
0.005,6,10,2007,5,928,1.0,660.0,660.0,5,1079,1.0,811.0,811.0
300.247,6,29,10050,17,1491,18765.0,260.0,149.0,12,8559,21837.0,1561.0,990.0
0.006,6,10,1547,5,764,1.0,496.0,496.0,5,783,1.0,515.0,515.0
290.735,6,309,343243,112,17375,2619.0,2736.0,888.0,197,325868,1483.0,2804.0,1724.0
0.014,6,10,1631,5,848,3.0,580.0,580.0,5,783,3.0,515.0,515.0
0.005,6,10,2006,5,927,1.0,659.0,659.0,5,1079,1.0,811.0,811.0
0.038,17,2,148,1,60,0.0,32.0,32.0,1,88,0.0,60.0,60.0
0.006,17,2,293,1,73,0.0,45.0,45.0,1,220,0.0,192.0,192.0
0.001,17,2,136,1,60,0.0,32.0,32.0,1,76,0.0,48.0,48.0
0.093,6,10,1506,5,395,18.0,127.0,127.0,5,1111,22.0,843.0,843.0
0.016,6,10,1989,5,910,4.0,642.0,642.0,5,1079,4.0,811.0,811.0
0.004,6,10,1989,5,927,1.0,659.0,659.0,5,1062,1.0,794.0,794.0
0.111,6,10,1506,5,395,26.0,127.0,127.0,5,1111,25.0,843.0,843.0
0.005,6,10,2006,5,927,1.0,659.0,659.0,5,1079,1.0,811.0,811.0
0.167,17,2,152,1,76,0.0,48.0,48.0,1,76,0.0,48.0,48.0
0.004,6,10,2006,5,927,1.0,659.0,659.0,5,1079,1.0,811.0,811.0
0.013,6,14,3787,7,497,2.0,125.0,125.0,7,3290,2.0,1448.0,972.0
0.005,17,2,148,1,60,0.0,32.0,32.0,1,88,0.0,60.0,60.0
0.013,6,10,1972,5,910,3.0,642.0,642.0,5,1062,3.0,794.0,794.0
0.012,6,10,1989,5,910,3.0,642.0,642.0,5,1079,3.0,811.0,811.0
0.009,6,12,1926,6,1189,1.0,659.0,434.0,6,737,1.0,417.0,417.0
0.005,17,2,158,1,63,0.0,35.0,35.0,1,95,0.0,67.0,67.0
0.004,6,10,2007,5,928,1.0,660.0,660.0,5,1079,1.0,811.0,811.0
0.022,6,10,1990,5,911,5.0,643.0,643.0,5,1079,5.0,811.0,811.0
0.042,17,2,412,1,61,0.0,33.0,33.0,1,351,0.0,323.0,323.0
240.017,6,9,787,5,488,60004.0,232.0,232.0,4,299,80004.0,83.0,83.0
0.04,17,2,144,1,64,0.0,36.0,36.0,1,80,0.0,52.0,52.0
0.005,6,13,3690,7,452,0.0,80.0,80.0,6,3238,1.0,1470.0,1459.0
0.056,6,10,1506,5,395,11.0,127.0,127.0,5,1111,12.0,843.0,843.0
0.003,17,2,136,1,60,0.0,32.0,32.0,1,76,0.0,48.0,48.0
0.012,6,10,1983,5,910,3.0,642.0,642.0,5,1073,3.0,805.0,805.0
0.005,6,10,2000,5,927,1.0,659.0,659.0,5,1073,1.0,805.0,805.0
0.005,17,4,495,2,132,0.0,38.0,38.0,2,363,2.0,176.0,153.0
0.152,6,10,1506,5,395,35.0,127.0,127.0,5,1111,35.0,843.0,843.0
240.096,6,31,8870,15,6599,17149.0,1721.0,647.0,16,2271,16006.0,580.0,178.0
0.005,17,2,179,1,71,0.0,43.0,43.0,1,108,0.0,80.0,80.0
0.004,6,10,2006,5,927,1.0,659.0,659.0,5,1079,1.0,811.0,811.0
0.004,17,2,185,1,73,0.0,45.0,45.0,1,112,0.0,84.0,84.0
0.005,6,10,2006,5,927,1.0,659.0,659.0,5,1079,1.0,811.0,811.0
0.006,6,10,1547,5,764,1.0,496.0,496.0,5,783,1.0,515.0,515.0
0.01,6,10,1972,5,910,2.0,642.0,642.0,5,1062,2.0,794.0,794.0
0.013,6,10,1989,5,910,3.0,642.0,642.0,5,1079,3.0,811.0,811.0
0.01,6,10,1990,5,911,2.0,643.0,643.0,5,1079,2.0,811.0,811.0
0.013,6,10,1983,5,910,3.0,642.0,642.0,5,1073,3.0,805.0,805.0
0.044,17,2,152,1,76,0.0,48.0,48.0,1,76,0.0,48.0,48.0
0.006,17,2,148,1,60,0.0,32.0,32.0,1,88,0.0,60.0,60.0
0.079,6,10,1506,5,395,16.0,127.0,127.0,5,1111,17.0,843.0,843.0
0.006,6,10,2006,5,927,1.0,659.0,659.0,5,1079,1.0,811.0,811.0
0.003,6,10,1702,5,863,0.0,595.0,595.0,5,839,0.0,571.0,571.0
0.062,6,10,1506,5,395,14.0,127.0,127.0,5,1111,14.0,843.0,843.0
0.084,6,10,1506,5,395,15.0,127.0,127.0,5,1111,19.0,843.0,843.0
0.004,17,2,148,1,60,0.0,32.0,32.0,1,88,0.0,60.0,60.0
0.016,6,10,1631,5,848,4.0,580.0,580.0,5,783,3.0,515.0,515.0
0.005,6,10,2007,5,928,1.0,660.0,660.0,5,1079,1.0,811.0,811.0
0.005,6,10,2006,5,927,1.0,659.0,659.0,5,1079,1.0,811.0,811.0
0.017,6,10,1989,5,910,4.0,642.0,642.0,5,1079,4.0,811.0,811.0
316.82,17,20,1124,10,716,35188.0,48.0,43.0,10,408,35188.0,20.0,12.0
0.008,6,10,1989,5,910,2.0,642.0,642.0,5,1079,2.0,811.0,811.0
0.006,6,10,1689,5,839,1.0,571.0,571.0,5,850,1.0,582.0,582.0
0.01,6,10,1989,5,910,2.0,642.0,642.0,5,1079,2.0,811.0,811.0
0.017,17,2,198,1,91,0.0,63.0,63.0,1,107,0.0,79.0,79.0
351.986,6,20,2210,6,1308,12003.0,494.0,494.0,14,902,27075.0,83.0,83.0
0.006,6,14,3742,8,504,0.0,80.0,80.0,6,3238,1.0,1470.0,1459.0
0.011,6,13,3735,7,497,1.0,125.0,125.0,6,3238,2.0,1470.0,1459.0
40.075,17,10,676,5,460,10017.0,104.0,64.0,5,216,10017.0,20.0,15.0
0.015,6,10,1990,5,911,3.0,643.0,643.0,5,1079,3.0,811.0,811.0
0.057,6,10,1506,5,395,12.0,127.0,127.0,5,1111,13.0,843.0,843.0
0.006,17,2,179,1,71,0.0,43.0,43.0,1,108,0.0,80.0,80.0
0.012,6,10,1677,5,827,2.0,559.0,559.0,5,850,2.0,582.0,582.0
0.011,6,13,3735,7,497,1.0,125.0,125.0,6,3238,2.0,1470.0,1459.0
0.01,6,10,1989,5,910,2.0,642.0,642.0,5,1079,2.0,811.0,811.0
0.072,6,10,1506,5,395,16.0,127.0,127.0,5,1111,15.0,843.0,843.0
0.011,6,10,1990,5,911,2.0,643.0,643.0,5,1079,2.0,811.0,811.0
0.085,6,10,1506,5,395,18.0,127.0,127.0,5,1111,19.0,843.0,843.0
0.001,17,2,136,1,60,0.0,32.0,32.0,1,76,0.0,48.0,48.0
0.123,6,10,1506,5,395,28.0,127.0,127.0,5,1111,25.0,843.0,843.0
0.019,17,2,213,1,69,0.0,41.0,41.0,1,144,0.0,116.0,116.0
1778.503,17,143,45188,72,22752,25048.0,288.0,288.0,71,22436,25406.0,288.0,288.0
0.005,6,10,1643,5,860,1.0,592.0,592.0,5,783,1.0,515.0,515.0
0.013,6,10,1677,5,827,3.0,559.0,559.0,5,850,3.0,582.0,582.0
0.018,6,10,1990,5,911,4.0,643.0,643.0,5,1079,4.0,811.0,811.0
0.005,6,10,2006,5,927,1.0,659.0,659.0,5,1079,1.0,811.0,811.0
0.005,6,10,1779,5,928,1.0,660.0,660.0,5,851,1.0,583.0,583.0
0.013,6,10,1762,5,911,3.0,643.0,643.0,5,851,3.0,583.0,583.0
0.011,6,10,1972,5,910,2.0,642.0,642.0,5,1062,2.0,794.0,794.0
0.076,6,10,1506,5,395,16.0,127.0,127.0,5,1111,15.0,843.0,843.0
240.097,6,16,4481,9,963,30012.0,238.0,166.0,7,3518,40015.0,1402.0,786.0
0.01,6,10,1972,5,910,2.0,642.0,642.0,5,1062,2.0,794.0,794.0
0.007,6,10,1643,5,860,1.0,592.0,592.0,5,783,1.0,515.0,515.0
0.006,6,10,1689,5,839,1.0,571.0,571.0,5,850,1.0,582.0,582.0
40.054,17,10,676,5,460,10012.0,104.0,64.0,5,216,10012.0,20.0,15.0
0.01,6,10,1989,5,910,2.0,642.0,642.0,5,1079,2.0,811.0,811.0
0.011,6,10,1677,5,827,2.0,559.0,559.0,5,850,2.0,582.0,582.0
0.004,17,2,162,1,65,0.0,37.0,37.0,1,97,0.0,69.0,69.0
11.217,17,28,4421,14,1994,850.0,269.0,114.0,14,2427,850.0,586.0,145.0
40.048,17,10,676,5,460,10010.0,104.0,64.0,5,216,10011.0,20.0,15.0
0.005,17,2,164,1,74,0.0,46.0,46.0,1,90,0.0,62.0,62.0
11.009,17,28,4394,14,1994,838.0,269.0,114.0,14,2400,838.0,587.0,143.0
0.004,6,10,1702,5,863,1.0,595.0,595.0,5,839,1.0,571.0,571.0
0.005,6,10,2007,5,928,1.0,660.0,660.0,5,1079,1.0,811.0,811.0
0.006,17,2,179,1,71,0.0,43.0,43.0,1,108,0.0,80.0,80.0
0.004,6,10,1989,5,927,1.0,659.0,659.0,5,1062,1.0,794.0,794.0
0.014,6,10,1972,5,910,3.0,642.0,642.0,5,1062,3.0,794.0,794.0
0.004,6,10,1702,5,863,1.0,595.0,595.0,5,839,1.0,571.0,571.0
0.147,6,10,1506,5,395,33.0,127.0,127.0,5,1111,35.0,843.0,843.0
0.012,6,10,1989,5,910,2.0,642.0,642.0,5,1079,3.0,811.0,811.0
0.006,6,10,1779,5,928,1.0,660.0,660.0,5,851,1.0,583.0,583.0
0.038,6,10,1990,5,911,9.0,643.0,643.0,5,1079,9.0,811.0,811.0
0.005,6,10,2006,5,927,1.0,659.0,659.0,5,1079,1.0,811.0,811.0
0.013,6,10,1989,5,910,3.0,642.0,642.0,5,1079,3.0,811.0,811.0
240.032,6,9,787,5,488,60008.0,232.0,232.0,4,299,80010.0,83.0,83.0
0.013,6,14,3787,7,497,2.0,125.0,125.0,7,3290,2.0,1448.0,972.0
0.011,6,12,1926,6,1189,2.0,659.0,434.0,6,737,2.0,417.0,417.0
0.004,17,2,136,1,60,0.0,32.0,32.0,1,76,0.0,48.0,48.0
15.071,17,15,9238,8,6902,2149.0,1350.0,834.0,7,2336,2507.0,1350.0,305.0
0.015,6,14,3787,7,497,2.0,125.0,125.0,7,3290,2.0,1448.0,972.0
0.006,6,13,3747,7,509,1.0,137.0,137.0,6,3238,1.0,1470.0,1459.0
0.005,6,10,1854,5,889,1.0,621.0,621.0,5,965,1.0,697.0,697.0
0.018,6,10,1990,5,911,4.0,643.0,643.0,5,1079,4.0,811.0,811.0
0.013,6,10,1631,5,848,3.0,580.0,580.0,5,783,3.0,515.0,515.0
11.107,17,28,4422,14,1994,842.0,269.0,114.0,14,2428,842.0,587.0,145.0
309.851,17,20,1124,10,716,34414.0,48.0,43.0,10,408,34413.0,20.0,12.0
0.082,6,10,1506,5,395,19.0,127.0,127.0,5,1111,16.0,843.0,843.0
0.14,6,10,1506,5,395,31.0,127.0,127.0,5,1111,31.0,843.0,843.0
0.012,6,10,1972,5,910,2.0,642.0,642.0,5,1062,3.0,794.0,794.0
0.006,6,10,1547,5,764,1.0,496.0,496.0,5,783,1.0,515.0,515.0
0.071,6,10,1506,5,395,15.0,127.0,127.0,5,1111,15.0,843.0,843.0
0.005,6,10,2000,5,927,1.0,659.0,659.0,5,1073,1.0,805.0,805.0
71.358,6,33,6264,18,1338,4197.0,267.0,195.0,15,4926,605.0,1823.0,392.0
0.009,6,12,1926,6,1189,1.0,659.0,434.0,6,737,1.0,417.0,417.0
0.068,6,10,1506,5,395,15.0,127.0,127.0,5,1111,16.0,843.0,843.0
0.006,17,2,170,1,65,0.0,37.0,37.0,1,105,0.0,77.0,77.0
0.23,6,16,2777,8,1395,32.0,533.0,323.0,8,1382,21.0,529.0,239.0
0.005,6,10,2007,5,928,1.0,660.0,660.0,5,1079,1.0,811.0,811.0
10.732,17,28,4423,14,1995,817.0,270.0,114.0,14,2428,817.0,587.0,145.0
0.022,6,10,1989,5,910,5.0,642.0,642.0,5,1079,5.0,811.0,811.0
0.012,6,10,1990,5,911,3.0,643.0,643.0,5,1079,3.0,811.0,811.0
0.016,6,10,1983,5,910,3.0,642.0,642.0,5,1073,4.0,805.0,805.0
352.243,6,20,2210,6,1308,12003.0,494.0,494.0,14,902,27095.0,83.0,83.0
0.004,17,2,136,1,60,0.0,32.0,32.0,1,76,0.0,48.0,48.0
0.097,6,10,1506,5,395,23.0,127.0,127.0,5,1111,22.0,843.0,843.0
0.006,6,10,2007,5,928,1.0,660.0,660.0,5,1079,1.0,811.0,811.0
0.011,17,2,225,1,65,0.0,37.0,37.0,1,160,0.0,132.0,132.0
0.007,17,2,230,1,68,0.0,40.0,40.0,1,162,0.0,134.0,134.0
242.112,6,299,343810,120,17749,2034.0,2736.0,885.0,179,326061,1360.0,3053.0,1874.0
0.01,6,10,1972,5,910,2.0,642.0,642.0,5,1062,2.0,794.0,794.0
0.005,6,14,3736,7,446,0.0,74.0,74.0,7,3290,0.0,1448.0,972.0
0.07,6,10,1506,5,395,15.0,127.0,127.0,5,1111,15.0,843.0,843.0
0.005,17,2,230,1,68,0.0,40.0,40.0,1,162,0.0,134.0,134.0
0.194,17,4,596,2,122,122.0,33.0,33.0,2,474,154.0,323.0,209.0
0.005,6,10,2006,5,927,1.0,659.0,659.0,5,1079,1.0,811.0,811.0
0.005,6,10,2007,5,928,1.0,660.0,660.0,5,1079,1.0,811.0,811.0
0.067,6,10,1506,5,395,15.0,127.0,127.0,5,1111,14.0,843.0,843.0
0.006,17,2,144,1,64,0.0,36.0,36.0,1,80,0.0,52.0,52.0
0.006,6,10,1547,5,764,1.0,496.0,496.0,5,783,1.0,515.0,515.0
0.089,6,10,1506,5,395,19.0,127.0,127.0,5,1111,20.0,843.0,843.0
0.005,6,10,2007,5,928,1.0,660.0,660.0,5,1079,1.0,811.0,811.0
10.831,17,28,4419,14,1994,824.0,269.0,114.0,14,2425,824.0,588.0,145.0
0.013,6,10,1989,5,910,3.0,642.0,642.0,5,1079,3.0,811.0,811.0
0.011,6,10,1983,5,910,2.0,642.0,642.0,5,1073,2.0,805.0,805.0
0.003,6,10,1702,5,863,0.0,595.0,595.0,5,839,0.0,571.0,571.0
0.083,6,10,1506,5,395,18.0,127.0,127.0,5,1111,19.0,843.0,843.0
0.007,17,2,144,1,64,0.0,36.0,36.0,1,80,0.0,52.0,52.0
0.047,6,13,3816,7,578,7.0,206.0,206.0,6,3238,9.0,1470.0,1459.0
240.011,6,9,787,5,488,60002.0,232.0,232.0,4,299,80003.0,83.0,83.0
21.045,17,23,14800,13,12031,1751.0,1350.0,897.0,10,2769,2335.0,1350.0,248.0
0.039,17,2,152,1,76,0.0,48.0,48.0,1,76,0.0,48.0,48.0
0.009,6,10,2006,5,927,2.0,659.0,659.0,5,1079,2.0,811.0,811.0
0.005,6,10,2000,5,927,1.0,659.0,659.0,5,1073,1.0,805.0,805.0
0.005,6,10,2006,5,927,1.0,659.0,659.0,5,1079,1.0,811.0,811.0
0.005,6,14,3912,7,622,0.0,250.0,250.0,7,3290,0.0,1448.0,972.0
0.004,6,10,2006,5,927,1.0,659.0,659.0,5,1079,1.0,811.0,811.0
0.059,17,2,152,1,76,0.0,48.0,48.0,1,76,0.0,48.0,48.0
0.006,17,2,214,1,75,0.0,47.0,47.0,1,139,0.0,111.0,111.0
0.005,6,13,3747,7,509,0.0,137.0,137.0,6,3238,0.0,1470.0,1459.0
0.119,6,10,1506,5,395,25.0,127.0,127.0,5,1111,26.0,843.0,843.0
0.074,6,10,1506,5,395,17.0,127.0,127.0,5,1111,15.0,843.0,843.0
0.043,17,2,170,1,65,0.0,37.0,37.0,1,105,0.0,77.0,77.0
0.012,6,10,1631,5,848,3.0,580.0,580.0,5,783,3.0,515.0,515.0
40.044,17,10,676,5,460,10010.0,104.0,64.0,5,216,10010.0,20.0,15.0
0.012,6,10,1990,5,911,2.0,643.0,643.0,5,1079,2.0,811.0,811.0
0.082,6,10,1506,5,395,19.0,127.0,127.0,5,1111,15.0,843.0,843.0
0.017,6,10,1972,5,910,4.0,642.0,642.0,5,1062,4.0,794.0,794.0
0.005,17,2,175,1,65,0.0,37.0,37.0,1,110,0.0,82.0,82.0
0.005,6,10,1689,5,839,1.0,571.0,571.0,5,850,1.0,582.0,582.0
0.109,6,10,1506,5,395,22.0,127.0,127.0,5,1111,26.0,843.0,843.0
0.01,6,13,3735,7,497,1.0,125.0,125.0,6,3238,1.0,1470.0,1459.0
0.004,17,2,170,1,65,0.0,37.0,37.0,1,105,0.0,77.0,77.0
0.006,6,10,1547,5,764,1.0,496.0,496.0,5,783,1.0,515.0,515.0
0.005,6,10,2007,5,928,1.0,660.0,660.0,5,1079,1.0,811.0,811.0
0.067,6,10,1506,5,395,15.0,127.0,127.0,5,1111,14.0,843.0,843.0
0.005,6,10,2006,5,927,1.0,659.0,659.0,5,1079,1.0,811.0,811.0
0.003,17,2,160,1,72,0.0,44.0,44.0,1,88,0.0,60.0,60.0
1791.346,6,493,99532,249,88182,7222.0,421.0,365.0,244,11350,7371.0,53.0,53.0
0.004,17,4,284,2,120,0.0,32.0,32.0,2,164,1.0,60.0,54.0
325.748,17,20,1124,10,716,36179.0,48.0,43.0,10,408,36179.0,20.0,12.0
0.016,6,10,1990,5,911,3.0,643.0,643.0,5,1079,3.0,811.0,811.0
0.005,6,10,2006,5,927,1.0,659.0,659.0,5,1079,1.0,811.0,811.0
0.015,6,10,1972,5,910,3.0,642.0,642.0,5,1062,3.0,794.0,794.0
174.354,17,86,12172,43,2868,4151.0,44.0,38.0,43,9304,4151.0,261.0,188.0
0.009,6,10,1990,5,911,2.0,643.0,643.0,5,1079,2.0,811.0,811.0
0.005,6,10,2006,5,927,1.0,659.0,659.0,5,1079,1.0,811.0,811.0
0.006,6,10,1547,5,764,1.0,496.0,496.0,5,783,1.0,515.0,515.0
0.014,6,10,1989,5,910,3.0,642.0,642.0,5,1079,3.0,811.0,811.0
0.005,6,10,1689,5,839,1.0,571.0,571.0,5,850,1.0,582.0,582.0
0.006,6,10,1547,5,764,1.0,496.0,496.0,5,783,1.0,515.0,515.0
0.112,6,10,1506,5,395,25.0,127.0,127.0,5,1111,26.0,843.0,843.0
0.004,17,2,179,1,71,0.0,43.0,43.0,1,108,0.0,80.0,80.0
0.012,17,2,152,1,76,0.0,48.0,48.0,1,76,0.0,48.0,48.0
240.225,6,29,7457,15,5331,17158.0,1368.0,506.0,14,2126,18478.0,580.0,198.0
0.008,6,12,1926,6,1189,1.0,659.0,434.0,6,737,1.0,417.0,417.0
0.013,6,10,1990,5,911,3.0,643.0,643.0,5,1079,3.0,811.0,811.0
0.005,6,10,2006,5,927,1.0,659.0,659.0,5,1079,1.0,811.0,811.0
0.125,17,4,596,2,122,1.0,33.0,33.0,2,474,85.0,323.0,209.0
0.005,6,10,2006,5,927,1.0,659.0,659.0,5,1079,1.0,811.0,811.0
0.008,6,12,1926,6,1189,1.0,659.0,434.0,6,737,1.0,417.0,417.0
15.075,17,16,8539,8,6377,2149.0,1350.0,769.0,8,2162,2149.0,1350.0,242.0
0.001,17,2,180,1,66,0.0,38.0,38.0,1,114,0.0,86.0,86.0
0.069,6,10,1506,5,395,15.0,127.0,127.0,5,1111,14.0,843.0,843.0
0.006,6,10,1689,5,839,1.0,571.0,571.0,5,850,1.0,582.0,582.0
0.015,6,10,1983,5,910,3.0,642.0,642.0,5,1073,3.0,805.0,805.0
0.005,6,10,1643,5,860,1.0,592.0,592.0,5,783,1.0,515.0,515.0
40.058,17,10,676,5,460,10012.0,104.0,64.0,5,216,10013.0,20.0,15.0
0.012,6,10,1972,5,910,3.0,642.0,642.0,5,1062,3.0,794.0,794.0
0.004,17,2,136,1,60,0.0,32.0,32.0,1,76,0.0,48.0,48.0
0.015,6,10,1631,5,848,3.0,580.0,580.0,5,783,3.0,515.0,515.0
0.004,6,10,2006,5,927,1.0,659.0,659.0,5,1079,1.0,811.0,811.0
0.006,6,10,1854,5,889,1.0,621.0,621.0,5,965,1.0,697.0,697.0
0.013,6,10,1631,5,848,3.0,580.0,580.0,5,783,3.0,515.0,515.0
0.003,17,2,148,1,60,0.0,32.0,32.0,1,88,0.0,60.0,60.0
0.068,6,10,1506,5,395,14.0,127.0,127.0,5,1111,15.0,843.0,843.0
0.008,6,10,1990,5,911,2.0,643.0,643.0,5,1079,1.0,811.0,811.0
0.014,6,10,1990,5,911,3.0,643.0,643.0,5,1079,3.0,811.0,811.0
0.013,6,10,1990,5,911,3.0,643.0,643.0,5,1079,3.0,811.0,811.0
0.073,17,8,3613,4,1874,24.0,1350.0,440.0,4,1739,13.0,1350.0,406.0
0.006,6,10,1854,5,889,1.0,621.0,621.0,5,965,1.0,697.0,697.0
0.011,6,10,2007,5,928,2.0,660.0,660.0,5,1079,2.0,811.0,811.0
0.084,6,10,1506,5,395,19.0,127.0,127.0,5,1111,14.0,843.0,843.0
0.005,6,10,2007,5,928,1.0,660.0,660.0,5,1079,1.0,811.0,811.0
0.082,6,10,1506,5,395,17.0,127.0,127.0,5,1111,19.0,843.0,843.0
0.009,6,10,1972,5,910,2.0,642.0,642.0,5,1062,2.0,794.0,794.0
0.071,17,2,148,1,60,0.0,32.0,32.0,1,88,0.0,60.0,60.0
0.006,6,10,1547,5,764,1.0,496.0,496.0,5,783,1.0,515.0,515.0
0.004,17,4,284,2,120,1.0,32.0,32.0,2,164,0.0,60.0,54.0
0.005,17,2,164,1,74,0.0,46.0,46.0,1,90,0.0,62.0,62.0
308.685,17,18,1008,9,640,38578.0,48.0,43.0,9,368,38578.0,20.0,12.0
0.001,17,2,180,1,66,0.0,38.0,38.0,1,114,0.0,86.0,86.0
0.013,6,10,1972,5,910,3.0,642.0,642.0,5,1062,3.0,794.0,794.0
15.074,17,15,9238,8,6902,2149.0,1350.0,834.0,7,2336,2507.0,1350.0,305.0
0.006,6,10,1547,5,764,1.0,496.0,496.0,5,783,1.0,515.0,515.0
0.044,6,10,1983,5,910,11.0,642.0,642.0,5,1073,10.0,805.0,805.0
0.039,17,2,184,1,61,0.0,33.0,33.0,1,123,0.0,95.0,95.0
0.003,6,10,1702,5,863,0.0,595.0,595.0,5,839,0.0,571.0,571.0
0.04,17,2,182,1,65,0.0,37.0,37.0,1,117,0.0,89.0,89.0
0.015,6,10,1983,5,910,3.0,642.0,642.0,5,1073,3.0,805.0,805.0
0.041,17,4,352,2,130,1.0,37.0,37.0,2,222,0.0,89.0,83.0
0.109,6,10,1506,5,395,25.0,127.0,127.0,5,1111,23.0,843.0,843.0
0.121,6,10,1506,5,395,28.0,127.0,127.0,5,1111,28.0,843.0,843.0
1792.588,6,491,99452,247,88102,7286.0,421.0,365.0,244,11350,7376.0,53.0,53.0
0.005,6,10,2007,5,928,1.0,660.0,660.0,5,1079,1.0,811.0,811.0
0.098,6,10,1506,5,395,23.0,127.0,127.0,5,1111,21.0,843.0,843.0
10.954,17,28,4389,14,2312,834.0,587.0,137.0,14,2077,834.0,268.0,120.0
0.014,6,10,1990,5,911,3.0,643.0,643.0,5,1079,3.0,811.0,811.0
0.004,17,4,284,2,120,1.0,32.0,32.0,2,164,0.0,60.0,54.0
0.0,17,2,180,1,65,0.0,37.0,37.0,1,115,0.0,87.0,87.0
0.003,17,2,148,1,60,0.0,32.0,32.0,1,88,0.0,60.0,60.0
0.005,6,13,3747,7,509,0.0,137.0,137.0,6,3238,0.0,1470.0,1459.0
240.092,6,16,4482,9,963,30011.0,238.0,166.0,7,3519,40015.0,1402.0,786.0
0.004,17,2,148,1,60,0.0,32.0,32.0,1,88,0.0,60.0,60.0
40.058,17,10,676,5,460,10013.0,104.0,64.0,5,216,10013.0,20.0,15.0
0.009,6,12,1926,6,1189,1.0,659.0,434.0,6,737,1.0,417.0,417.0
0.006,6,10,1547,5,764,1.0,496.0,496.0,5,783,1.0,515.0,515.0
0.005,6,10,2006,5,927,1.0,659.0,659.0,5,1079,1.0,811.0,811.0
0.016,6,10,1983,5,910,3.0,642.0,642.0,5,1073,3.0,805.0,805.0
0.006,6,10,1643,5,860,1.0,592.0,592.0,5,783,1.0,515.0,515.0
0.005,6,10,2006,5,927,1.0,659.0,659.0,5,1079,1.0,811.0,811.0
0.011,17,2,179,1,71,0.0,43.0,43.0,1,108,0.0,80.0,80.0
0.006,6,10,1547,5,764,1.0,496.0,496.0,5,783,1.0,515.0,515.0
0.022,6,10,1983,5,910,5.0,642.0,642.0,5,1073,5.0,805.0,805.0
0.038,17,4,284,2,120,0.0,32.0,32.0,2,164,35.0,60.0,54.0
0.004,6,10,2007,5,928,1.0,660.0,660.0,5,1079,1.0,811.0,811.0
40.07,17,10,676,5,460,10015.0,104.0,64.0,5,216,10016.0,20.0,15.0
0.005,17,2,170,1,65,0.0,37.0,37.0,1,105,0.0,77.0,77.0
0.01,6,10,1983,5,910,2.0,642.0,642.0,5,1073,2.0,805.0,805.0
0.057,6,10,1506,5,395,13.0,127.0,127.0,5,1111,14.0,843.0,843.0
0.013,17,2,152,1,56,0.0,28.0,28.0,1,96,0.0,68.0,68.0
0.068,17,8,3613,4,1874,22.0,1350.0,440.0,4,1739,11.0,1350.0,406.0
0.019,6,10,1990,5,911,4.0,643.0,643.0,5,1079,4.0,811.0,811.0
0.005,17,2,169,1,62,0.0,34.0,34.0,1,107,0.0,79.0,79.0
0.008,6,10,1990,5,911,1.0,643.0,643.0,5,1079,1.0,811.0,811.0
0.091,6,10,1506,5,395,21.0,127.0,127.0,5,1111,16.0,843.0,843.0
0.001,17,2,180,1,66,0.0,38.0,38.0,1,114,0.0,86.0,86.0
0.011,6,10,1972,5,910,2.0,642.0,642.0,5,1062,2.0,794.0,794.0
0.001,17,2,179,1,62,0.0,34.0,34.0,1,117,0.0,89.0,89.0
0.004,17,4,284,2,120,1.0,32.0,32.0,2,164,1.0,60.0,54.0
0.011,6,10,1972,5,910,2.0,642.0,642.0,5,1062,2.0,794.0,794.0
0.086,6,10,1506,5,395,20.0,127.0,127.0,5,1111,20.0,843.0,843.0
0.071,6,10,1506,5,395,16.0,127.0,127.0,5,1111,16.0,843.0,843.0
0.005,6,10,2007,5,928,1.0,660.0,660.0,5,1079,1.0,811.0,811.0
0.013,6,10,1989,5,910,3.0,642.0,642.0,5,1079,3.0,811.0,811.0
0.017,6,10,1972,5,910,4.0,642.0,642.0,5,1062,4.0,794.0,794.0
0.006,17,2,170,1,65,0.0,37.0,37.0,1,105,0.0,77.0,77.0
0.001,17,2,180,1,66,0.0,38.0,38.0,1,114,0.0,86.0,86.0
300.836,6,37,9740,20,4262,15833.0,1686.0,686.0,17,5478,542.0,2667.0,435.0
0.001,17,2,286,1,64,0.0,36.0,36.0,1,222,0.0,194.0,194.0
0.006,6,10,1547,5,764,1.0,496.0,496.0,5,783,1.0,515.0,515.0
40.059,17,10,676,5,460,10013.0,104.0,64.0,5,216,10013.0,20.0,15.0
0.012,6,10,1983,5,910,3.0,642.0,642.0,5,1073,2.0,805.0,805.0
0.013,6,10,1989,5,910,3.0,642.0,642.0,5,1079,3.0,811.0,811.0
0.069,17,8,3613,4,1874,23.0,1350.0,440.0,4,1739,11.0,1350.0,406.0
0.014,6,10,1631,5,848,3.0,580.0,580.0,5,783,3.0,515.0,515.0
11.179,17,28,4424,14,1995,847.0,270.0,114.0,14,2429,847.0,588.0,145.0
0.094,6,10,1506,5,395,19.0,127.0,127.0,5,1111,22.0,843.0,843.0
0.005,6,10,1854,5,889,1.0,621.0,621.0,5,965,1.0,697.0,697.0
126.054,6,14,2938,8,2504,17973.0,1414.0,1086.0,6,434,25163.0,182.0,182.0
0.005,17,2,175,1,65,0.0,37.0,37.0,1,110,0.0,82.0,82.0
0.013,6,13,3735,7,497,2.0,125.0,125.0,6,3238,2.0,1470.0,1459.0
0.006,17,2,166,1,75,0.0,47.0,47.0,1,91,0.0,63.0,63.0
0.006,6,10,1854,5,889,1.0,621.0,621.0,5,965,1.0,697.0,697.0
0.01,6,10,1972,5,910,2.0,642.0,642.0,5,1062,2.0,794.0,794.0
11.331,17,28,4417,14,1993,859.0,268.0,114.0,14,2424,859.0,587.0,145.0
175.113,17,78,11037,39,2601,4608.0,44.0,38.0,39,8436,4608.0,239.0,188.0
0.005,6,10,2006,5,927,1.0,659.0,659.0,5,1079,1.0,811.0,811.0
0.009,6,10,1989,5,910,2.0,642.0,642.0,5,1079,2.0,811.0,811.0
0.101,6,10,1506,5,395,21.0,127.0,127.0,5,1111,21.0,843.0,843.0
0.01,6,10,1972,5,910,2.0,642.0,642.0,5,1062,2.0,794.0,794.0
0.176,17,2,152,1,76,0.0,48.0,48.0,1,76,0.0,48.0,48.0
0.006,6,10,1547,5,764,1.0,496.0,496.0,5,783,1.0,515.0,515.0
0.072,17,4,284,2,120,1.0,32.0,32.0,2,164,34.0,60.0,54.0
15.073,17,15,9239,8,6902,2149.0,1350.0,834.0,7,2337,2507.0,1350.0,305.0
0.004,6,10,2007,5,928,1.0,660.0,660.0,5,1079,1.0,811.0,811.0
309.249,17,20,1124,10,716,34346.0,48.0,43.0,10,408,34346.0,20.0,12.0
0.104,6,10,1506,5,395,23.0,127.0,127.0,5,1111,23.0,843.0,843.0
0.012,6,10,1989,5,910,3.0,642.0,642.0,5,1079,2.0,811.0,811.0
382.009,58,6,432,5,360,95502.0,24.0,24.0,1,72,0.0,24.0,24.0
240.09,6,34,9682,18,7203,14122.0,2172.0,696.0,16,2479,16005.0,580.0,204.0
0.005,17,2,170,1,65,0.0,37.0,37.0,1,105,0.0,77.0,77.0
1729.203,6,62,4504,40,2740,44338.0,33.0,33.0,22,1764,82333.0,31.0,31.0
0.005,17,2,187,1,71,0.0,43.0,43.0,1,116,0.0,88.0,88.0
0.006,6,10,2007,5,928,1.0,660.0,660.0,5,1079,1.0,811.0,811.0
0.098,6,10,1506,5,395,19.0,127.0,127.0,5,1111,23.0,843.0,843.0
0.143,6,10,1506,5,395,30.0,127.0,127.0,5,1111,32.0,843.0,843.0
175.548,17,78,11059,39,2597,4619.0,44.0,38.0,39,8462,4619.0,239.0,188.0
0.018,6,13,3735,7,497,3.0,125.0,125.0,6,3238,3.0,1470.0,1459.0
0.004,17,2,136,1,60,0.0,32.0,32.0,1,76,0.0,48.0,48.0
0.009,6,10,1990,5,911,2.0,643.0,643.0,5,1079,2.0,811.0,811.0
40.055,17,10,676,5,460,10012.0,104.0,64.0,5,216,10012.0,20.0,15.0
0.091,6,10,1506,5,395,20.0,127.0,127.0,5,1111,20.0,843.0,843.0
0.065,6,10,1506,5,395,14.0,127.0,127.0,5,1111,12.0,843.0,843.0
0.004,6,10,1779,5,928,1.0,660.0,660.0,5,851,1.0,583.0,583.0
0.008,6,10,1989,5,910,1.0,642.0,642.0,5,1079,1.0,811.0,811.0
0.118,6,10,1506,5,395,23.0,127.0,127.0,5,1111,26.0,843.0,843.0
0.097,6,10,1506,5,395,21.0,127.0,127.0,5,1111,18.0,843.0,843.0
0.004,6,10,1774,5,923,1.0,655.0,655.0,5,851,1.0,583.0,583.0
0.004,6,10,1702,5,863,1.0,595.0,595.0,5,839,0.0,571.0,571.0
0.004,6,10,2007,5,928,1.0,660.0,660.0,5,1079,1.0,811.0,811.0
0.126,6,10,1506,5,395,30.0,127.0,127.0,5,1111,29.0,843.0,843.0
0.005,6,10,2006,5,927,1.0,659.0,659.0,5,1079,1.0,811.0,811.0
0.001,17,2,180,1,66,0.0,38.0,38.0,1,114,0.0,86.0,86.0
0.019,6,10,1762,5,911,4.0,643.0,643.0,5,851,4.0,583.0,583.0
0.042,6,10,1972,5,910,10.0,642.0,642.0,5,1062,10.0,794.0,794.0
0.006,6,10,1547,5,764,1.0,496.0,496.0,5,783,1.0,515.0,515.0
40.068,17,10,676,5,460,10015.0,104.0,64.0,5,216,10016.0,20.0,15.0
0.004,6,10,1702,5,863,1.0,595.0,595.0,5,839,1.0,571.0,571.0
0.004,17,2,168,1,76,0.0,48.0,48.0,1,92,0.0,64.0,64.0
0.003,6,10,1702,5,863,0.0,595.0,595.0,5,839,0.0,571.0,571.0
0.005,6,10,2000,5,927,1.0,659.0,659.0,5,1073,1.0,805.0,805.0
0.004,6,10,1989,5,927,1.0,659.0,659.0,5,1062,1.0,794.0,794.0
0.003,17,4,284,2,120,0.0,32.0,32.0,2,164,0.0,60.0,54.0
0.013,6,10,1631,5,848,3.0,580.0,580.0,5,783,3.0,515.0,515.0
0.003,17,2,136,1,60,0.0,32.0,32.0,1,76,0.0,48.0,48.0
40.069,17,10,676,5,460,10016.0,104.0,64.0,5,216,10016.0,20.0,15.0
0.003,17,2,136,1,60,0.0,32.0,32.0,1,76,0.0,48.0,48.0
0.005,6,10,2000,5,927,1.0,659.0,659.0,5,1073,1.0,805.0,805.0
0.05,6,10,1631,5,848,12.0,580.0,580.0,5,783,12.0,515.0,515.0
0.006,6,10,1547,5,764,1.0,496.0,496.0,5,783,1.0,515.0,515.0
0.013,6,10,1990,5,911,3.0,643.0,643.0,5,1079,3.0,811.0,811.0
0.005,17,2,164,1,74,0.0,46.0,46.0,1,90,0.0,62.0,62.0
0.011,6,10,1631,5,848,2.0,580.0,580.0,5,783,2.0,515.0,515.0
0.006,6,10,1547,5,764,1.0,496.0,496.0,5,783,1.0,515.0,515.0
0.015,6,10,1631,5,848,3.0,580.0,580.0,5,783,3.0,515.0,515.0
11.099,17,28,4421,14,1994,841.0,269.0,114.0,14,2427,841.0,586.0,145.0
0.102,6,10,1506,5,395,20.0,127.0,127.0,5,1111,21.0,843.0,843.0
0.066,6,10,1506,5,395,16.0,127.0,127.0,5,1111,13.0,843.0,843.0
0.005,17,2,164,1,74,0.0,46.0,46.0,1,90,0.0,62.0,62.0
0.007,6,10,1779,5,928,1.0,660.0,660.0,5,851,1.0,583.0,583.0
368.918,6,24,2405,17,919,23057.0,195.0,195.0,7,1486,3918.0,419.0,398.0
0.077,6,45,14025,25,2555,3.0,517.0,139.0,20,11470,3.0,1402.0,744.0
0.011,6,10,1983,5,910,2.0,642.0,642.0,5,1073,2.0,805.0,805.0
0.041,17,4,284,2,120,1.0,32.0,32.0,2,164,37.0,60.0,54.0
0.015,6,10,1972,5,910,3.0,642.0,642.0,5,1062,3.0,794.0,794.0
0.008,6,10,1990,5,911,2.0,643.0,643.0,5,1079,2.0,811.0,811.0
11.107,17,28,4367,14,2312,845.0,587.0,137.0,14,2055,845.0,270.0,118.0
0.006,6,10,1689,5,839,1.0,571.0,571.0,5,850,1.0,582.0,582.0
0.124,6,10,1506,5,395,30.0,127.0,127.0,5,1111,28.0,843.0,843.0
0.014,6,10,1989,5,910,3.0,642.0,642.0,5,1079,3.0,811.0,811.0
0.004,6,10,2006,5,927,1.0,659.0,659.0,5,1079,1.0,811.0,811.0
301.018,6,45,16803,23,10896,13682.0,2908.0,1243.0,22,5907,420.0,2667.0,385.0
10.802,17,28,4418,14,1994,821.0,269.0,114.0,14,2424,822.0,587.0,145.0
0.065,6,10,1506,5,395,14.0,127.0,127.0,5,1111,15.0,843.0,843.0
0.073,17,4,352,2,130,1.0,37.0,37.0,2,222,70.0,89.0,83.0
0.111,6,10,1506,5,395,26.0,127.0,127.0,5,1111,25.0,843.0,843.0
0.009,6,10,1972,5,910,2.0,642.0,642.0,5,1062,2.0,794.0,794.0
0.041,17,2,170,1,65,0.0,37.0,37.0,1,105,0.0,77.0,77.0
0.005,6,10,2006,5,927,1.0,659.0,659.0,5,1079,1.0,811.0,811.0
63.721,6,35,7959,17,2441,551.0,1376.0,576.0,18,5518,3738.0,2667.0,435.0
0.092,6,10,1506,5,395,20.0,127.0,127.0,5,1111,19.0,843.0,843.0
40.08,17,10,676,5,460,10019.0,104.0,64.0,5,216,10019.0,20.0,15.0
0.841,6,27,8977,15,1639,48.0,517.0,211.0,12,7338,62.0,1402.0,839.0
0.007,6,10,2006,5,927,1.0,659.0,659.0,5,1079,1.0,811.0,811.0
0.107,6,10,1506,5,395,22.0,127.0,127.0,5,1111,26.0,843.0,843.0
240.118,6,20,7516,11,2636,24011.0,1368.0,517.0,9,4880,30014.0,1657.0,1101.0
0.796,6,25,5555,12,1445,62.0,267.0,136.0,13,4110,55.0,1414.0,597.0
0.005,6,10,2007,5,928,1.0,660.0,660.0,5,1079,1.0,811.0,811.0
15.128,17,15,9239,8,6902,2152.0,1350.0,834.0,7,2337,2512.0,1350.0,305.0
0.104,6,10,1506,5,395,23.0,127.0,127.0,5,1111,21.0,843.0,843.0
1770.807,6,135,6510,75,3585,23926.0,39.0,39.0,60,2925,30009.0,35.0,35.0
300.372,6,16,2170,9,684,37526.0,146.0,146.0,7,1486,50034.0,419.0,398.0
13.798,17,29,4502,16,2520,912.0,587.0,129.0,13,1982,1140.0,269.0,124.0
240.091,6,31,9197,15,6871,17149.0,1995.0,677.0,16,2326,16005.0,580.0,185.0
0.007,6,10,1989,5,910,1.0,642.0,642.0,5,1079,1.0,811.0,811.0
40.057,17,10,676,5,460,10013.0,104.0,64.0,5,216,10013.0,20.0,15.0
0.009,6,10,1972,5,910,2.0,642.0,642.0,5,1062,2.0,794.0,794.0
1733.269,6,64,7344,42,4469,42274.0,1625.0,108.0,22,2875,82528.0,1111.0,82.0
0.015,6,10,1989,5,910,3.0,642.0,642.0,5,1079,3.0,811.0,811.0
0.004,6,10,1779,5,928,1.0,660.0,660.0,5,851,1.0,583.0,583.0
0.013,6,10,1989,5,910,3.0,642.0,642.0,5,1079,3.0,811.0,811.0
40.058,17,10,676,5,460,10013.0,104.0,64.0,5,216,10013.0,20.0,15.0
40.073,17,10,676,5,460,10017.0,104.0,64.0,5,216,10017.0,20.0,15.0
0.005,6,10,2000,5,927,1.0,659.0,659.0,5,1073,1.0,805.0,805.0
0.034,17,2,152,1,76,0.0,48.0,48.0,1,76,0.0,48.0,48.0
0.012,6,10,1990,5,911,3.0,643.0,643.0,5,1079,2.0,811.0,811.0
0.013,6,10,1983,5,910,3.0,642.0,642.0,5,1073,3.0,805.0,805.0
240.086,6,19,5068,9,2305,30010.0,1102.0,613.0,10,2763,26675.0,1162.0,447.0
0.001,17,2,180,1,65,0.0,37.0,37.0,1,115,0.0,87.0,87.0
0.01,6,10,1854,5,889,2.0,621.0,621.0,5,965,2.0,697.0,697.0
0.038,6,10,1989,5,910,9.0,642.0,642.0,5,1079,9.0,811.0,811.0
0.005,6,10,1989,5,927,1.0,659.0,659.0,5,1062,1.0,794.0,794.0
0.008,6,10,1972,5,910,2.0,642.0,642.0,5,1062,2.0,794.0,794.0
0.129,17,2,80,1,32,0.0,4.0,4.0,1,48,0.0,20.0,20.0
0.004,17,4,284,2,120,0.0,32.0,32.0,2,164,0.0,60.0,54.0
0.003,17,2,148,1,60,0.0,32.0,32.0,1,88,0.0,60.0,60.0
0.133,6,10,1506,5,395,29.0,127.0,127.0,5,1111,31.0,843.0,843.0
0.004,6,10,2006,5,927,1.0,659.0,659.0,5,1079,1.0,811.0,811.0
240.332,6,33,8640,17,1839,15020.0,572.0,189.0,16,6801,16021.0,1402.0,597.0
240.085,6,16,4481,9,963,30010.0,238.0,166.0,7,3518,40013.0,1402.0,786.0
0.001,17,2,180,1,66,0.0,38.0,38.0,1,114,0.0,86.0,86.0
0.006,6,10,1547,5,764,1.0,496.0,496.0,5,783,1.0,515.0,515.0
0.072,17,2,182,1,65,0.0,37.0,37.0,1,117,0.0,89.0,89.0
0.005,6,13,3747,7,509,0.0,137.0,137.0,6,3238,1.0,1470.0,1459.0
0.112,6,10,1506,5,395,23.0,127.0,127.0,5,1111,24.0,843.0,843.0
0.005,6,10,2007,5,928,1.0,660.0,660.0,5,1079,1.0,811.0,811.0
0.009,6,10,1972,5,910,2.0,642.0,642.0,5,1062,2.0,794.0,794.0
0.01,6,10,1631,5,848,2.0,580.0,580.0,5,783,2.0,515.0,515.0
308.803,17,20,1124,10,716,34297.0,48.0,43.0,10,408,34297.0,20.0,12.0
40.084,17,10,676,5,460,10020.0,104.0,64.0,5,216,10020.0,20.0,15.0
325.889,17,20,1124,10,716,36198.0,48.0,43.0,10,408,36200.0,20.0,12.0
11.137,17,28,4421,14,1993,844.0,268.0,114.0,14,2428,844.0,587.0,145.0
0.009,6,10,1989,5,910,2.0,642.0,642.0,5,1079,2.0,811.0,811.0
0.06,17,2,152,1,76,0.0,48.0,48.0,1,76,0.0,48.0,48.0
0.012,6,10,1989,5,910,3.0,642.0,642.0,5,1079,2.0,811.0,811.0
0.007,6,10,1989,5,910,1.0,642.0,642.0,5,1079,1.0,811.0,811.0
0.005,6,10,1774,5,923,1.0,655.0,655.0,5,851,1.0,583.0,583.0
40.067,17,10,676,5,460,10014.0,104.0,64.0,5,216,10015.0,20.0,15.0
0.083,6,10,1506,5,395,19.0,127.0,127.0,5,1111,14.0,843.0,843.0
0.281,6,16,2783,8,1401,40.0,533.0,325.0,8,1382,27.0,529.0,239.0
0.24,17,39,20260,21,17044,12.0,1350.0,783.0,18,3216,10.0,1350.0,150.0
0.004,17,2,136,1,60,0.0,32.0,32.0,1,76,0.0,48.0,48.0
0.011,6,10,1989,5,910,2.0,642.0,642.0,5,1079,2.0,811.0,811.0
0.081,6,10,1506,5,395,18.0,127.0,127.0,5,1111,19.0,843.0,843.0
0.007,17,2,179,1,71,0.0,43.0,43.0,1,108,0.0,80.0,80.0
0.005,6,10,1779,5,928,1.0,660.0,660.0,5,851,1.0,583.0,583.0
0.009,6,10,1990,5,911,2.0,643.0,643.0,5,1079,2.0,811.0,811.0
0.041,17,2,152,1,76,0.0,48.0,48.0,1,76,0.0,48.0,48.0
0.076,6,10,1506,5,395,16.0,127.0,127.0,5,1111,17.0,843.0,843.0
0.005,6,10,2006,5,927,1.0,659.0,659.0,5,1079,1.0,811.0,811.0
0.013,6,10,1762,5,911,3.0,643.0,643.0,5,851,3.0,583.0,583.0
0.039,17,2,186,1,61,0.0,33.0,33.0,1,125,0.0,97.0,97.0
0.039,17,4,284,2,120,1.0,32.0,32.0,2,164,35.0,60.0,54.0
0.003,17,4,284,2,120,0.0,32.0,32.0,2,164,0.0,60.0,54.0
0.096,6,10,1506,5,395,23.0,127.0,127.0,5,1111,21.0,843.0,843.0
0.007,6,10,1972,5,910,1.0,642.0,642.0,5,1062,1.0,794.0,794.0
0.009,6,10,1990,5,911,2.0,643.0,643.0,5,1079,2.0,811.0,811.0
40.059,17,10,676,5,460,10012.0,104.0,64.0,5,216,10013.0,20.0,15.0
0.006,6,10,1547,5,764,1.0,496.0,496.0,5,783,1.0,515.0,515.0
40.081,17,10,676,5,460,10019.0,104.0,64.0,5,216,10019.0,20.0,15.0
240.019,6,9,787,5,488,60004.0,232.0,232.0,4,299,80005.0,83.0,83.0
0.008,6,10,1989,5,910,2.0,642.0,642.0,5,1079,1.0,811.0,811.0
0.001,17,2,180,1,66,0.0,38.0,38.0,1,114,0.0,86.0,86.0
0.165,17,2,213,1,69,0.0,41.0,41.0,1,144,0.0,116.0,116.0
0.063,6,10,1506,5,395,15.0,127.0,127.0,5,1111,14.0,843.0,843.0
0.001,17,2,166,1,75,0.0,47.0,47.0,1,91,0.0,63.0,63.0
0.016,6,10,1631,5,848,3.0,580.0,580.0,5,783,3.0,515.0,515.0
300.019,6,12,1782,7,1348,50003.0,494.0,494.0,5,434,75003.0,83.0,83.0
0.005,6,10,1989,5,927,1.0,659.0,659.0,5,1062,1.0,794.0,794.0
351.99,6,20,2210,6,1308,12003.0,494.0,494.0,14,902,27075.0,83.0,83.0
0.006,6,10,1689,5,839,1.0,571.0,571.0,5,850,1.0,582.0,582.0
0.001,17,2,154,1,69,0.0,41.0,41.0,1,85,0.0,57.0,57.0
0.068,17,8,3613,4,1874,22.0,1350.0,440.0,4,1739,11.0,1350.0,406.0
0.005,17,2,148,1,60,0.0,32.0,32.0,1,88,0.0,60.0,60.0
0.068,17,8,3613,4,1874,22.0,1350.0,440.0,4,1739,11.0,1350.0,406.0
0.035,6,10,1989,5,910,8.0,642.0,642.0,5,1079,8.0,811.0,811.0
0.042,17,2,136,1,60,0.0,32.0,32.0,1,76,0.0,48.0,48.0
0.005,6,13,3747,7,509,0.0,137.0,137.0,6,3238,1.0,1470.0,1459.0
0.007,6,10,1547,5,764,1.0,496.0,496.0,5,783,1.0,515.0,515.0
0.009,17,4,284,2,120,5.0,32.0,32.0,2,164,5.0,60.0,54.0
0.005,6,10,2007,5,928,1.0,660.0,660.0,5,1079,1.0,811.0,811.0
0.076,6,10,1506,5,395,17.0,127.0,127.0,5,1111,18.0,843.0,843.0
0.008,6,10,1762,5,911,2.0,643.0,643.0,5,851,1.0,583.0,583.0
0.079,6,10,1506,5,395,18.0,127.0,127.0,5,1111,16.0,843.0,843.0
0.009,6,10,1990,5,911,2.0,643.0,643.0,5,1079,2.0,811.0,811.0
0.089,6,10,1506,5,395,21.0,127.0,127.0,5,1111,19.0,843.0,843.0
0.074,6,10,1506,5,395,15.0,127.0,127.0,5,1111,15.0,843.0,843.0
0.078,6,10,1506,5,395,18.0,127.0,127.0,5,1111,16.0,843.0,843.0
0.017,6,13,3735,7,497,2.0,125.0,125.0,6,3238,3.0,1470.0,1459.0
0.005,6,10,1779,5,928,1.0,660.0,660.0,5,851,1.0,583.0,583.0
0.006,17,2,214,1,75,0.0,47.0,47.0,1,139,0.0,111.0,111.0
0.095,6,10,1506,5,395,21.0,127.0,127.0,5,1111,22.0,843.0,843.0
0.001,17,2,136,1,60,0.0,32.0,32.0,1,76,0.0,48.0,48.0
0.015,6,11,1729,6,879,3.0,559.0,559.0,5,850,3.0,582.0,582.0
0.001,17,2,180,1,66,0.0,38.0,38.0,1,114,0.0,86.0,86.0
1777.27,6,65,7402,43,4522,42315.0,1402.0,103.0,22,2880,84623.0,1116.0,82.0
97.847,6,22,8186,11,1985,93.0,1174.0,504.0,11,6201,9767.0,1791.0,958.0
0.004,6,10,1989,5,927,1.0,659.0,659.0,5,1062,1.0,794.0,794.0
372.142,6,21,1793,16,1030,24809.0,190.0,190.0,5,763,60014.0,462.0,247.0
0.025,6,10,1972,5,910,6.0,642.0,642.0,5,1062,6.0,794.0,794.0
0.04,17,2,136,1,60,0.0,32.0,32.0,1,76,0.0,48.0,48.0
0.004,17,2,148,1,60,0.0,32.0,32.0,1,88,0.0,60.0,60.0
0.005,6,10,2006,5,927,1.0,659.0,659.0,5,1079,1.0,811.0,811.0
0.005,17,2,154,1,69,0.0,41.0,41.0,1,85,0.0,57.0,57.0
0.005,6,10,1547,5,764,1.0,496.0,496.0,5,783,1.0,515.0,515.0
0.004,6,10,2006,5,927,1.0,659.0,659.0,5,1079,1.0,811.0,811.0
168.167,17,80,11504,40,2674,4311.0,44.0,38.0,40,8830,4311.0,252.0,192.0
10.898,17,28,4419,14,1995,830.0,270.0,114.0,14,2424,830.0,587.0,145.0
0.013,6,10,1990,5,911,3.0,643.0,643.0,5,1079,3.0,811.0,811.0
0.054,6,10,1972,5,910,13.0,642.0,642.0,5,1062,13.0,794.0,794.0
0.006,6,10,1547,5,764,1.0,496.0,496.0,5,783,1.0,515.0,515.0
0.012,6,10,1972,5,910,3.0,642.0,642.0,5,1062,3.0,794.0,794.0
0.106,6,10,1506,5,395,25.0,127.0,127.0,5,1111,25.0,843.0,843.0
0.004,6,10,2007,5,928,1.0,660.0,660.0,5,1079,1.0,811.0,811.0
40.075,17,10,676,5,460,10016.0,104.0,64.0,5,216,10018.0,20.0,15.0
0.005,6,10,2006,5,927,1.0,659.0,659.0,5,1079,1.0,811.0,811.0
424.389,6,24,6552,13,2336,35365.0,585.0,330.0,11,4216,36436.0,1402.0,727.0
0.08,6,10,1506,5,395,18.0,127.0,127.0,5,1111,16.0,843.0,843.0
0.009,6,10,1677,5,827,2.0,559.0,559.0,5,850,2.0,582.0,582.0
0.004,6,10,2000,5,927,1.0,659.0,659.0,5,1073,1.0,805.0,805.0
0.009,6,13,3735,7,497,1.0,125.0,125.0,6,3238,1.0,1470.0,1459.0
40.056,17,10,676,5,460,10011.0,104.0,64.0,5,216,10012.0,20.0,15.0
0.004,17,2,160,1,72,0.0,44.0,44.0,1,88,0.0,60.0,60.0
0.014,6,13,3735,7,497,2.0,125.0,125.0,6,3238,2.0,1470.0,1459.0
0.011,6,10,1989,5,910,2.0,642.0,642.0,5,1079,2.0,811.0,811.0
0.011,6,10,1990,5,911,2.0,643.0,643.0,5,1079,2.0,811.0,811.0
0.095,6,10,1506,5,395,15.0,127.0,127.0,5,1111,22.0,843.0,843.0
0.004,17,2,148,1,60,0.0,32.0,32.0,1,88,0.0,60.0,60.0
0.006,17,2,230,1,68,0.0,40.0,40.0,1,162,0.0,134.0,134.0
0.006,6,10,1547,5,764,1.0,496.0,496.0,5,783,1.0,515.0,515.0
0.009,6,10,1983,5,910,2.0,642.0,642.0,5,1073,2.0,805.0,805.0
368.338,6,22,2313,16,867,24555.0,195.0,195.0,6,1446,4639.0,419.0,398.0
0.006,6,10,1643,5,860,1.0,592.0,592.0,5,783,1.0,515.0,515.0
0.08,6,10,1506,5,395,18.0,127.0,127.0,5,1111,15.0,843.0,843.0
159.67,6,22,8465,12,2204,73.0,1345.0,564.0,10,6261,17722.0,2720.0,974.0
0.005,17,2,214,1,75,0.0,47.0,47.0,1,139,0.0,111.0,111.0
0.004,17,2,152,1,76,0.0,48.0,48.0,1,76,0.0,48.0,48.0
0.01,6,10,1972,5,910,2.0,642.0,642.0,5,1062,2.0,794.0,794.0
0.019,6,10,1989,5,910,4.0,642.0,642.0,5,1079,4.0,811.0,811.0
0.005,6,10,2007,5,928,1.0,660.0,660.0,5,1079,1.0,811.0,811.0
0.013,17,2,152,1,56,0.0,28.0,28.0,1,96,0.0,68.0,68.0
0.169,17,2,152,1,76,0.0,48.0,48.0,1,76,0.0,48.0,48.0
0.009,6,10,1989,5,910,2.0,642.0,642.0,5,1079,2.0,811.0,811.0
0.003,17,2,136,1,60,0.0,32.0,32.0,1,76,0.0,48.0,48.0
0.01,6,10,1972,5,910,2.0,642.0,642.0,5,1062,2.0,794.0,794.0
40.065,17,10,676,5,460,10014.0,104.0,64.0,5,216,10015.0,20.0,15.0
0.008,6,10,1972,5,910,1.0,642.0,642.0,5,1062,2.0,794.0,794.0
0.012,6,10,1677,5,827,3.0,559.0,559.0,5,850,2.0,582.0,582.0
0.01,6,10,1989,5,910,2.0,642.0,642.0,5,1079,2.0,811.0,811.0
0.004,6,10,2006,5,927,1.0,659.0,659.0,5,1079,1.0,811.0,811.0
0.013,6,10,1972,5,910,3.0,642.0,642.0,5,1062,3.0,794.0,794.0
0.001,17,2,154,1,69,0.0,41.0,41.0,1,85,0.0,57.0,57.0
0.006,6,10,1547,5,764,1.0,496.0,496.0,5,783,1.0,515.0,515.0
0.082,6,10,1506,5,395,19.0,127.0,127.0,5,1111,19.0,843.0,843.0
0.006,6,10,1547,5,764,1.0,496.0,496.0,5,783,1.0,515.0,515.0
0.005,6,10,1689,5,839,1.0,571.0,571.0,5,850,1.0,582.0,582.0
0.15,6,10,1506,5,395,35.0,127.0,127.0,5,1111,36.0,843.0,843.0
0.014,6,10,1989,5,910,3.0,642.0,642.0,5,1079,3.0,811.0,811.0
0.006,6,12,1698,6,863,1.0,327.0,271.0,6,835,1.0,515.0,515.0
0.004,17,2,136,1,60,0.0,32.0,32.0,1,76,0.0,48.0,48.0
0.008,6,10,1989,5,910,2.0,642.0,642.0,5,1079,1.0,811.0,811.0
0.011,6,10,1972,5,910,2.0,642.0,642.0,5,1062,2.0,794.0,794.0
0.001,17,2,180,1,66,0.0,38.0,38.0,1,114,0.0,86.0,86.0
166.299,17,76,10804,38,2538,4494.0,44.0,38.0,38,8266,4494.0,239.0,189.0
240.018,6,9,787,5,488,60004.0,232.0,232.0,4,299,80004.0,83.0,83.0
66.186,6,22,10140,12,3973,6016.0,1579.0,835.0,10,6167,7335.0,2111.0,939.0
0.072,17,4,596,2,122,1.0,33.0,33.0,2,474,32.0,323.0,209.0
0.077,6,10,1506,5,395,16.0,127.0,127.0,5,1111,16.0,843.0,843.0
0.003,17,2,148,1,60,0.0,32.0,32.0,1,88,0.0,60.0,60.0
0.006,6,10,1547,5,764,1.0,496.0,496.0,5,783,1.0,515.0,515.0
0.112,6,10,1506,5,395,23.0,127.0,127.0,5,1111,23.0,843.0,843.0
354.02,6,21,1795,16,1030,23601.0,190.0,190.0,5,765,60001.0,464.0,248.0
0.006,6,10,2006,5,927,1.0,659.0,659.0,5,1079,1.0,811.0,811.0
0.016,17,2,198,1,91,0.0,63.0,63.0,1,107,0.0,79.0,79.0
0.004,6,10,2006,5,927,1.0,659.0,659.0,5,1079,1.0,811.0,811.0
0.015,6,10,1990,5,911,3.0,643.0,643.0,5,1079,3.0,811.0,811.0
1.131,6,27,10463,14,1575,87.0,517.0,211.0,13,8888,94.0,1402.0,911.0
0.072,17,2,182,1,65,0.0,37.0,37.0,1,117,0.0,89.0,89.0
0.013,6,10,1677,5,827,3.0,559.0,559.0,5,850,3.0,582.0,582.0
0.007,6,10,1989,5,910,1.0,642.0,642.0,5,1079,1.0,811.0,811.0
0.004,6,10,1989,5,927,1.0,659.0,659.0,5,1062,1.0,794.0,794.0
0.005,6,10,1779,5,928,1.0,660.0,660.0,5,851,1.0,583.0,583.0
10.822,17,28,4423,14,1995,823.0,270.0,114.0,14,2428,823.0,587.0,145.0
0.005,6,10,2006,5,927,1.0,659.0,659.0,5,1079,1.0,811.0,811.0
10.737,17,28,4417,14,1994,817.0,269.0,114.0,14,2423,817.0,586.0,145.0
0.068,6,10,1506,5,395,16.0,127.0,127.0,5,1111,14.0,843.0,843.0
0.081,6,10,1506,5,395,16.0,127.0,127.0,5,1111,18.0,843.0,843.0
10.879,17,28,4422,14,1994,827.0,269.0,114.0,14,2428,827.0,587.0,145.0
0.005,6,14,3736,7,446,0.0,74.0,74.0,7,3290,0.0,1448.0,972.0
0.011,17,2,148,1,60,0.0,32.0,32.0,1,88,0.0,60.0,60.0
0.006,6,10,1854,5,889,1.0,621.0,621.0,5,965,1.0,697.0,697.0
0.115,6,10,1506,5,395,25.0,127.0,127.0,5,1111,24.0,843.0,843.0
0.004,6,10,2006,5,927,1.0,659.0,659.0,5,1079,1.0,811.0,811.0
0.005,6,10,1547,5,764,1.0,496.0,496.0,5,783,1.0,515.0,515.0
0.087,6,10,1506,5,395,20.0,127.0,127.0,5,1111,20.0,843.0,843.0
0.012,6,10,1972,5,910,3.0,642.0,642.0,5,1062,2.0,794.0,794.0
0.003,17,2,132,1,58,0.0,30.0,30.0,1,74,0.0,46.0,46.0
0.016,6,10,1983,5,910,4.0,642.0,642.0,5,1073,3.0,805.0,805.0
0.005,6,10,2007,5,928,1.0,660.0,660.0,5,1079,1.0,811.0,811.0
0.006,6,10,1547,5,764,1.0,496.0,496.0,5,783,1.0,515.0,515.0
0.004,6,10,1702,5,863,1.0,595.0,595.0,5,839,0.0,571.0,571.0
0.039,17,2,170,1,65,0.0,37.0,37.0,1,105,0.0,77.0,77.0
0.001,17,2,136,1,60,0.0,32.0,32.0,1,76,0.0,48.0,48.0
0.008,6,10,1989,5,910,2.0,642.0,642.0,5,1079,2.0,811.0,811.0
0.011,6,13,3735,7,497,1.0,125.0,125.0,6,3238,2.0,1470.0,1459.0
0.005,6,10,2000,5,927,1.0,659.0,659.0,5,1073,1.0,805.0,805.0
15.084,17,16,8252,8,6005,2150.0,1350.0,722.0,8,2247,2150.0,1350.0,252.0
0.004,17,2,148,1,60,0.0,32.0,32.0,1,88,0.0,60.0,60.0
0.005,6,10,2000,5,927,1.0,659.0,659.0,5,1073,1.0,805.0,805.0
0.126,17,2,80,1,32,0.0,4.0,4.0,1,48,0.0,20.0,20.0
15.088,17,15,8023,8,5974,2150.0,1350.0,718.0,7,2049,2509.0,1350.0,264.0
0.011,6,10,1972,5,910,2.0,642.0,642.0,5,1062,2.0,794.0,794.0
1778.829,17,142,44872,72,22752,25051.0,288.0,288.0,70,22120,25769.0,288.0,288.0
0.006,17,2,152,1,68,0.0,40.0,40.0,1,84,0.0,56.0,56.0
0.081,6,10,1506,5,395,16.0,127.0,127.0,5,1111,16.0,843.0,843.0
0.087,6,10,1506,5,395,18.0,127.0,127.0,5,1111,17.0,843.0,843.0
40.072,17,10,676,5,460,10015.0,104.0,64.0,5,216,10017.0,20.0,15.0
0.012,6,14,3965,7,495,1.0,123.0,123.0,7,3470,2.0,1448.0,1032.0
40.059,17,10,676,5,460,10013.0,104.0,64.0,5,216,10013.0,20.0,15.0
241.92,6,302,343299,119,17708,2050.0,2736.0,886.0,183,325591,1329.0,2914.0,1826.0
0.001,17,2,136,1,60,0.0,32.0,32.0,1,76,0.0,48.0,48.0
0.006,6,10,1689,5,839,1.0,571.0,571.0,5,850,1.0,582.0,582.0
0.017,6,10,1989,5,910,4.0,642.0,642.0,5,1079,4.0,811.0,811.0
11.465,17,28,4398,14,2311,869.0,586.0,137.0,14,2087,869.0,270.0,121.0
0.002,17,2,136,1,60,0.0,32.0,32.0,1,76,0.0,48.0,48.0
0.066,17,8,3613,4,1874,22.0,1350.0,440.0,4,1739,10.0,1350.0,406.0
0.018,6,10,1762,5,911,4.0,643.0,643.0,5,851,4.0,583.0,583.0
351.988,6,20,2210,6,1308,12003.0,494.0,494.0,14,902,27075.0,83.0,83.0
0.041,17,4,284,2,120,0.0,32.0,32.0,2,164,37.0,60.0,54.0
0.042,17,2,136,1,60,0.0,32.0,32.0,1,76,0.0,48.0,48.0
0.005,17,2,170,1,65,0.0,37.0,37.0,1,105,0.0,77.0,77.0
0.006,6,10,1643,5,860,1.0,592.0,592.0,5,783,1.0,515.0,515.0
0.004,6,10,2006,5,927,1.0,659.0,659.0,5,1079,1.0,811.0,811.0
0.006,6,10,1989,5,927,1.0,659.0,659.0,5,1062,1.0,794.0,794.0
0.007,6,10,1547,5,764,1.0,496.0,496.0,5,783,1.0,515.0,515.0
40.052,17,10,676,5,460,10012.0,104.0,64.0,5,216,10012.0,20.0,15.0
0.005,6,10,1779,5,928,1.0,660.0,660.0,5,851,1.0,583.0,583.0
0.015,6,10,1989,5,910,3.0,642.0,642.0,5,1079,3.0,811.0,811.0
0.07,6,10,1506,5,395,16.0,127.0,127.0,5,1111,15.0,843.0,843.0
15.236,17,18,8350,9,6149,1900.0,1350.0,655.0,9,2201,1900.0,1350.0,216.0
240.084,6,15,6564,7,5847,40014.0,3210.0,1829.0,8,717,34297.0,293.0,293.0
0.115,6,10,1506,5,395,27.0,127.0,127.0,5,1111,27.0,843.0,843.0
0.004,6,10,1989,5,927,1.0,659.0,659.0,5,1062,1.0,794.0,794.0
0.003,17,4,284,2,120,0.0,32.0,32.0,2,164,0.0,60.0,54.0
0.013,6,10,1989,5,910,3.0,642.0,642.0,5,1079,3.0,811.0,811.0
0.004,6,10,1779,5,928,1.0,660.0,660.0,5,851,1.0,583.0,583.0
0.006,6,10,1547,5,764,1.0,496.0,496.0,5,783,1.0,515.0,515.0
0.005,17,2,164,1,74,0.0,46.0,46.0,1,90,0.0,62.0,62.0
0.007,6,10,1972,5,910,1.0,642.0,642.0,5,1062,1.0,794.0,794.0
0.001,17,2,180,1,66,0.0,38.0,38.0,1,114,0.0,86.0,86.0
0.005,6,10,2006,5,927,1.0,659.0,659.0,5,1079,1.0,811.0,811.0
0.101,6,10,1506,5,395,23.0,127.0,127.0,5,1111,22.0,843.0,843.0
40.068,17,10,676,5,460,10016.0,104.0,64.0,5,216,10016.0,20.0,15.0
0.091,6,10,1506,5,395,19.0,127.0,127.0,5,1111,20.0,843.0,843.0
0.011,6,10,1762,5,911,2.0,643.0,643.0,5,851,2.0,583.0,583.0
0.004,17,2,166,1,75,0.0,47.0,47.0,1,91,0.0,63.0,63.0
0.006,6,10,1547,5,764,1.0,496.0,496.0,5,783,1.0,515.0,515.0
0.023,6,10,1762,5,911,5.0,643.0,643.0,5,851,5.0,583.0,583.0
0.004,6,10,2006,5,927,1.0,659.0,659.0,5,1079,1.0,811.0,811.0
0.006,6,10,1547,5,764,1.0,496.0,496.0,5,783,1.0,515.0,515.0
0.005,6,10,1989,5,927,1.0,659.0,659.0,5,1062,1.0,794.0,794.0
241.885,6,368,346198,190,21406,1279.0,2736.0,959.0,178,324792,1366.0,2804.0,1878.0
294.084,6,409,349600,199,21905,1485.0,2736.0,888.0,210,327695,1407.0,3036.0,1616.0
0.014,6,10,1990,5,911,3.0,643.0,643.0,5,1079,3.0,811.0,811.0
0.012,6,13,3735,7,497,1.0,125.0,125.0,6,3238,2.0,1470.0,1459.0
0.076,6,10,1506,5,395,17.0,127.0,127.0,5,1111,17.0,843.0,843.0
0.137,6,10,1506,5,395,30.0,127.0,127.0,5,1111,28.0,843.0,843.0
0.011,6,10,1631,5,848,2.0,580.0,580.0,5,783,2.0,515.0,515.0
0.005,6,10,1547,5,764,1.0,496.0,496.0,5,783,1.0,515.0,515.0
0.128,17,2,80,1,32,0.0,4.0,4.0,1,48,0.0,20.0,20.0
0.005,17,2,136,1,60,0.0,32.0,32.0,1,76,0.0,48.0,48.0
0.253,17,4,352,2,130,179.0,37.0,37.0,2,222,178.0,89.0,83.0
0.006,6,13,3747,7,509,0.0,137.0,137.0,6,3238,1.0,1470.0,1459.0
0.005,6,10,2006,5,927,1.0,659.0,659.0,5,1079,1.0,811.0,811.0
0.01,6,10,1972,5,910,2.0,642.0,642.0,5,1062,2.0,794.0,794.0
0.13,17,4,284,2,120,0.0,32.0,32.0,2,164,121.0,60.0,54.0
0.095,6,10,1506,5,395,21.0,127.0,127.0,5,1111,22.0,843.0,843.0
0.011,6,10,1989,5,910,2.0,642.0,642.0,5,1079,2.0,811.0,811.0
0.006,6,10,1854,5,889,1.0,621.0,621.0,5,965,1.0,697.0,697.0
0.004,6,10,1779,5,928,1.0,660.0,660.0,5,851,1.0,583.0,583.0
0.041,17,2,148,1,60,0.0,32.0,32.0,1,88,0.0,60.0,60.0
0.087,6,10,1506,5,395,20.0,127.0,127.0,5,1111,18.0,843.0,843.0
0.12,6,10,1506,5,395,28.0,127.0,127.0,5,1111,29.0,843.0,843.0
0.003,17,2,162,1,65,0.0,37.0,37.0,1,97,0.0,69.0,69.0
240.646,6,36,8973,19,2122,13367.0,691.0,225.0,17,6851,15038.0,1402.0,597.0
1776.986,17,142,44872,72,22752,25026.0,288.0,288.0,70,22120,25752.0,288.0,288.0
300.017,6,11,891,6,552,60002.0,232.0,232.0,5,339,75003.0,83.0,83.0
1.26,17,23,16973,10,4288,140.0,1350.0,400.0,13,12685,100.0,1350.0,947.0
0.004,6,10,1702,5,863,1.0,595.0,595.0,5,839,1.0,571.0,571.0
0.015,6,10,1762,5,911,3.0,643.0,643.0,5,851,3.0,583.0,583.0
0.006,6,10,1854,5,889,1.0,621.0,621.0,5,965,1.0,697.0,697.0
0.111,6,10,1506,5,395,27.0,127.0,127.0,5,1111,25.0,843.0,843.0
0.009,6,10,1989,5,910,2.0,642.0,642.0,5,1079,2.0,811.0,811.0
0.005,6,13,3747,7,509,0.0,137.0,137.0,6,3238,1.0,1470.0,1459.0
371.55,6,22,2313,16,867,24770.0,195.0,195.0,6,1446,4638.0,419.0,398.0
0.109,6,10,1506,5,395,24.0,127.0,127.0,5,1111,25.0,843.0,843.0
0.005,6,13,3690,7,452,0.0,80.0,80.0,6,3238,0.0,1470.0,1459.0
0.025,6,10,1972,5,910,6.0,642.0,642.0,5,1062,6.0,794.0,794.0
0.015,6,10,1631,5,848,3.0,580.0,580.0,5,783,3.0,515.0,515.0
0.005,6,10,2007,5,928,1.0,660.0,660.0,5,1079,1.0,811.0,811.0
0.018,6,10,1972,5,910,4.0,642.0,642.0,5,1062,4.0,794.0,794.0
0.068,17,8,3613,4,1874,22.0,1350.0,440.0,4,1739,10.0,1350.0,406.0
0.087,6,10,1506,5,395,19.0,127.0,127.0,5,1111,19.0,843.0,843.0
0.108,6,10,1506,5,395,24.0,127.0,127.0,5,1111,23.0,843.0,843.0
0.019,6,10,1990,5,911,4.0,643.0,643.0,5,1079,4.0,811.0,811.0
0.006,17,2,140,1,62,0.0,34.0,34.0,1,78,0.0,50.0,50.0
1778.496,17,144,41760,72,22752,25049.0,288.0,288.0,72,19008,25049.0,236.0,236.0
0.006,6,10,1547,5,764,1.0,496.0,496.0,5,783,1.0,515.0,515.0
0.086,6,10,1506,5,395,19.0,127.0,127.0,5,1111,20.0,843.0,843.0
10.804,17,26,4102,13,1821,891.0,268.0,112.0,13,2281,891.0,588.0,147.0
0.005,6,14,3799,7,509,0.0,137.0,137.0,7,3290,0.0,1448.0,972.0
0.088,6,10,1506,5,395,18.0,127.0,127.0,5,1111,18.0,843.0,843.0
0.088,6,10,1506,5,395,19.0,127.0,127.0,5,1111,19.0,843.0,843.0
0.005,17,2,164,1,74,0.0,46.0,46.0,1,90,0.0,62.0,62.0
15.084,17,16,8538,8,6299,2150.0,1350.0,759.0,8,2239,2150.0,1350.0,251.0
0.005,17,2,169,1,62,0.0,34.0,34.0,1,107,0.0,79.0,79.0
0.005,17,2,164,1,74,0.0,46.0,46.0,1,90,0.0,62.0,62.0
0.102,6,10,1506,5,395,22.0,127.0,127.0,5,1111,21.0,843.0,843.0
0.004,6,10,1774,5,923,1.0,655.0,655.0,5,851,1.0,583.0,583.0
0.017,6,10,1990,5,911,4.0,643.0,643.0,5,1079,4.0,811.0,811.0
0.003,17,2,136,1,60,0.0,32.0,32.0,1,76,0.0,48.0,48.0
0.005,6,14,3742,7,452,0.0,80.0,80.0,7,3290,0.0,1448.0,972.0
15.076,17,15,9238,8,6902,2149.0,1350.0,834.0,7,2336,2507.0,1350.0,305.0
0.005,17,2,184,1,68,0.0,40.0,40.0,1,116,0.0,88.0,88.0
0.104,6,10,1506,5,395,20.0,127.0,127.0,5,1111,22.0,843.0,843.0
0.076,6,10,1506,5,395,17.0,127.0,127.0,5,1111,17.0,843.0,843.0
0.113,6,10,1506,5,395,26.0,127.0,127.0,5,1111,26.0,843.0,843.0
0.084,17,2,152,1,76,0.0,48.0,48.0,1,76,0.0,48.0,48.0
0.003,17,2,136,1,60,0.0,32.0,32.0,1,76,0.0,48.0,48.0
0.016,6,10,1631,5,848,3.0,580.0,580.0,5,783,4.0,515.0,515.0
0.01,6,10,1972,5,910,2.0,642.0,642.0,5,1062,2.0,794.0,794.0
15.073,17,15,9238,8,6902,2149.0,1350.0,834.0,7,2336,2507.0,1350.0,305.0
0.003,17,2,148,1,60,0.0,32.0,32.0,1,88,0.0,60.0,60.0
0.017,6,10,1989,5,910,4.0,642.0,642.0,5,1079,4.0,811.0,811.0
0.01,17,2,144,1,64,0.0,36.0,36.0,1,80,0.0,52.0,52.0
0.015,6,10,1972,5,910,3.0,642.0,642.0,5,1062,3.0,794.0,794.0
0.005,6,10,1854,5,889,1.0,621.0,621.0,5,965,1.0,697.0,697.0
0.167,17,2,152,1,76,0.0,48.0,48.0,1,76,0.0,48.0,48.0
0.004,6,10,1989,5,927,1.0,659.0,659.0,5,1062,1.0,794.0,794.0
0.01,6,10,1990,5,911,2.0,643.0,643.0,5,1079,2.0,811.0,811.0
0.008,6,13,3735,7,497,1.0,125.0,125.0,6,3238,1.0,1470.0,1459.0
0.098,6,10,1506,5,395,19.0,127.0,127.0,5,1111,21.0,843.0,843.0
40.047,17,10,676,5,460,10011.0,104.0,64.0,5,216,10011.0,20.0,15.0
0.009,6,10,2007,5,928,2.0,660.0,660.0,5,1079,2.0,811.0,811.0
0.005,17,2,179,1,71,0.0,43.0,43.0,1,108,0.0,80.0,80.0
0.005,6,10,2006,5,927,1.0,659.0,659.0,5,1079,1.0,811.0,811.0
0.008,6,10,1983,5,910,1.0,642.0,642.0,5,1073,2.0,805.0,805.0
0.015,17,2,198,1,91,0.0,63.0,63.0,1,107,0.0,79.0,79.0
373.651,6,22,2313,16,867,24910.0,195.0,195.0,6,1446,4637.0,419.0,398.0
0.004,6,10,1702,5,863,1.0,595.0,595.0,5,839,1.0,571.0,571.0
0.006,17,2,299,1,65,0.0,37.0,37.0,1,234,0.0,206.0,206.0
0.005,17,2,187,1,71,0.0,43.0,43.0,1,116,0.0,88.0,88.0
0.02,6,14,3787,7,497,3.0,125.0,125.0,7,3290,3.0,1448.0,972.0
0.0,17,2,136,1,60,0.0,32.0,32.0,1,76,0.0,48.0,48.0
0.039,17,4,284,2,120,0.0,32.0,32.0,2,164,36.0,60.0,54.0
0.005,6,10,1854,5,889,1.0,621.0,621.0,5,965,1.0,697.0,697.0
0.031,6,10,1972,5,910,7.0,642.0,642.0,5,1062,7.0,794.0,794.0
0.092,6,10,1506,5,395,21.0,127.0,127.0,5,1111,17.0,843.0,843.0
0.004,17,2,136,1,60,0.0,32.0,32.0,1,76,0.0,48.0,48.0
0.083,6,10,1506,5,395,18.0,127.0,127.0,5,1111,20.0,843.0,843.0
0.007,6,10,1689,5,839,1.0,571.0,571.0,5,850,1.0,582.0,582.0
0.015,6,10,1990,5,911,3.0,643.0,643.0,5,1079,3.0,811.0,811.0
240.096,6,16,4480,9,963,30012.0,238.0,166.0,7,3517,40015.0,1402.0,786.0
0.097,6,10,1506,5,395,23.0,127.0,127.0,5,1111,21.0,843.0,843.0
0.005,6,10,2007,5,928,1.0,660.0,660.0,5,1079,1.0,811.0,811.0
0.006,17,2,299,1,65,0.0,37.0,37.0,1,234,0.0,206.0,206.0
0.005,6,10,1989,5,927,1.0,659.0,659.0,5,1062,1.0,794.0,794.0
0.005,6,10,1779,5,928,1.0,660.0,660.0,5,851,1.0,583.0,583.0
0.045,17,2,184,1,61,0.0,33.0,33.0,1,123,0.0,95.0,95.0
0.013,6,10,1631,5,848,3.0,580.0,580.0,5,783,3.0,515.0,515.0
0.004,6,10,2006,5,927,1.0,659.0,659.0,5,1079,1.0,811.0,811.0
0.01,6,10,1990,5,911,2.0,643.0,643.0,5,1079,2.0,811.0,811.0
0.091,17,2,152,1,76,0.0,48.0,48.0,1,76,0.0,48.0,48.0
0.007,17,2,179,1,71,0.0,43.0,43.0,1,108,0.0,80.0,80.0
0.006,6,10,1643,5,860,1.0,592.0,592.0,5,783,1.0,515.0,515.0
0.099,6,10,1506,5,395,16.0,127.0,127.0,5,1111,22.0,843.0,843.0
0.118,6,10,1506,5,395,26.0,127.0,127.0,5,1111,23.0,843.0,843.0
0.17,17,2,152,1,76,0.0,48.0,48.0,1,76,0.0,48.0,48.0
0.001,17,2,166,1,75,0.0,47.0,47.0,1,91,0.0,63.0,63.0
0.009,6,10,1989,5,910,2.0,642.0,642.0,5,1079,2.0,811.0,811.0
0.04,6,10,1677,5,827,10.0,559.0,559.0,5,850,10.0,582.0,582.0
0.004,6,10,2000,5,927,1.0,659.0,659.0,5,1073,1.0,805.0,805.0
0.001,17,2,180,1,66,0.0,38.0,38.0,1,114,0.0,86.0,86.0
0.005,6,10,1989,5,927,1.0,659.0,659.0,5,1062,1.0,794.0,794.0
0.01,6,10,1972,5,910,2.0,642.0,642.0,5,1062,2.0,794.0,794.0
0.012,6,10,1990,5,911,3.0,643.0,643.0,5,1079,3.0,811.0,811.0
1799.66,17,3306,254519,1646,133342,1094.0,84.0,53.0,1660,121177,1082.0,1350.0,44.0
0.075,6,10,1506,5,395,16.0,127.0,127.0,5,1111,16.0,843.0,843.0
0.15,17,4,580,2,122,111.0,33.0,33.0,2,458,145.0,307.0,201.0
0.018,6,10,1990,5,911,4.0,643.0,643.0,5,1079,4.0,811.0,811.0
0.012,6,10,1983,5,910,2.0,642.0,642.0,5,1073,2.0,805.0,805.0
0.004,6,10,2006,5,927,1.0,659.0,659.0,5,1079,1.0,811.0,811.0
10.926,17,28,4423,14,1994,831.0,269.0,114.0,14,2429,831.0,588.0,145.0
0.001,17,2,180,1,66,0.0,38.0,38.0,1,114,0.0,86.0,86.0
0.014,6,10,1983,5,910,3.0,642.0,642.0,5,1073,3.0,805.0,805.0
0.009,6,10,1762,5,911,2.0,643.0,643.0,5,851,2.0,583.0,583.0
0.005,6,10,2007,5,928,1.0,660.0,660.0,5,1079,1.0,811.0,811.0
0.004,17,2,136,1,60,0.0,32.0,32.0,1,76,0.0,48.0,48.0
354.025,6,21,1795,16,1030,23601.0,190.0,190.0,5,765,60001.0,464.0,248.0
0.01,6,10,1774,5,923,2.0,655.0,655.0,5,851,2.0,583.0,583.0
0.011,6,10,1989,5,910,2.0,642.0,642.0,5,1079,2.0,811.0,811.0
0.005,6,10,1774,5,923,1.0,655.0,655.0,5,851,1.0,583.0,583.0
0.004,6,10,2006,5,927,1.0,659.0,659.0,5,1079,1.0,811.0,811.0
0.022,6,10,1990,5,911,5.0,643.0,643.0,5,1079,5.0,811.0,811.0
0.004,6,10,2006,5,927,1.0,659.0,659.0,5,1079,1.0,811.0,811.0
0.015,6,10,1677,5,827,3.0,559.0,559.0,5,850,3.0,582.0,582.0
309.484,17,20,1124,10,716,34373.0,48.0,43.0,10,408,34373.0,20.0,12.0
1799.787,6,330,67592,136,47090,13330.0,2790.0,396.0,194,20502,9324.0,1360.0,148.0
0.02,6,10,1989,5,910,4.0,642.0,642.0,5,1079,5.0,811.0,811.0
0.013,6,14,3787,7,497,2.0,125.0,125.0,7,3290,2.0,1448.0,972.0
0.012,6,10,1989,5,910,2.0,642.0,642.0,5,1079,3.0,811.0,811.0
0.037,6,10,1989,5,910,9.0,642.0,642.0,5,1079,9.0,811.0,811.0
0.022,6,10,1989,5,910,5.0,642.0,642.0,5,1079,5.0,811.0,811.0
0.11,6,10,1506,5,395,26.0,127.0,127.0,5,1111,22.0,843.0,843.0
0.004,6,10,2006,5,927,1.0,659.0,659.0,5,1079,1.0,811.0,811.0
0.07,17,8,3613,4,1874,23.0,1350.0,440.0,4,1739,11.0,1350.0,406.0
0.086,6,10,1506,5,395,19.0,127.0,127.0,5,1111,20.0,843.0,843.0
0.017,6,10,1990,5,911,4.0,643.0,643.0,5,1079,4.0,811.0,811.0
240.013,6,9,787,5,488,60003.0,232.0,232.0,4,299,80002.0,83.0,83.0
0.019,6,10,1677,5,827,4.0,559.0,559.0,5,850,4.0,582.0,582.0
164.304,17,84,12288,42,2826,4007.0,44.0,39.0,42,9462,4007.0,239.0,197.0
240.138,6,47,7026,23,3290,10915.0,588.0,230.0,24,3736,10440.0,580.0,206.0
0.005,6,10,1989,5,927,1.0,659.0,659.0,5,1062,1.0,794.0,794.0
0.09,6,10,1506,5,395,21.0,127.0,127.0,5,1111,21.0,843.0,843.0
0.012,6,10,1605,5,388,3.0,120.0,120.0,5,1217,2.0,949.0,949.0
0.004,6,10,1779,5,928,1.0,660.0,660.0,5,851,1.0,583.0,583.0
0.008,6,10,1989,5,910,2.0,642.0,642.0,5,1079,2.0,811.0,811.0
0.006,6,10,1643,5,860,1.0,592.0,592.0,5,783,1.0,515.0,515.0
0.005,6,14,3742,7,452,0.0,80.0,80.0,7,3290,0.0,1448.0,972.0
0.005,6,14,3799,7,509,0.0,137.0,137.0,7,3290,0.0,1448.0,972.0
0.017,6,10,1989,5,910,4.0,642.0,642.0,5,1079,4.0,811.0,811.0
0.008,17,2,194,1,59,0.0,31.0,31.0,1,135,0.0,107.0,107.0
177.3,17,80,11587,40,2677,4546.0,44.0,38.0,40,8910,4546.0,261.0,194.0
0.005,6,10,1989,5,927,1.0,659.0,659.0,5,1062,1.0,794.0,794.0
0.004,17,2,412,1,61,0.0,33.0,33.0,1,351,0.0,323.0,323.0
0.008,6,10,1989,5,910,2.0,642.0,642.0,5,1079,2.0,811.0,811.0
358.196,6,20,2210,6,1308,12017.0,494.0,494.0,14,902,27551.0,83.0,83.0
0.006,6,10,1547,5,764,1.0,496.0,496.0,5,783,1.0,515.0,515.0
0.098,6,10,1506,5,395,24.0,127.0,127.0,5,1111,20.0,843.0,843.0
0.224,6,16,2778,8,1396,32.0,533.0,324.0,8,1382,20.0,529.0,239.0
0.008,6,12,1926,6,1189,1.0,659.0,434.0,6,737,1.0,417.0,417.0
0.005,6,10,1689,5,839,1.0,571.0,571.0,5,850,1.0,582.0,582.0
0.009,6,10,1677,5,827,2.0,559.0,559.0,5,850,2.0,582.0,582.0
0.011,6,10,1990,5,911,2.0,643.0,643.0,5,1079,2.0,811.0,811.0
0.007,6,10,1983,5,910,1.0,642.0,642.0,5,1073,1.0,805.0,805.0
0.006,6,10,2007,5,928,1.0,660.0,660.0,5,1079,1.0,811.0,811.0
0.009,6,10,1989,5,910,2.0,642.0,642.0,5,1079,2.0,811.0,811.0
0.085,6,10,1506,5,395,19.0,127.0,127.0,5,1111,20.0,843.0,843.0
0.134,6,10,1506,5,395,28.0,127.0,127.0,5,1111,23.0,843.0,843.0
0.004,17,2,222,1,65,0.0,37.0,37.0,1,157,0.0,129.0,129.0
30.277,6,82,75389,42,3256,738.0,517.0,262.0,40,72133,776.0,2804.0,1893.0
0.004,6,10,2006,5,927,1.0,659.0,659.0,5,1079,1.0,811.0,811.0
0.042,17,4,352,2,130,0.0,37.0,37.0,2,222,3.0,89.0,83.0
0.005,6,10,2006,5,927,1.0,659.0,659.0,5,1079,1.0,811.0,811.0
0.008,6,10,1989,5,910,2.0,642.0,642.0,5,1079,2.0,811.0,811.0
0.004,6,10,2006,5,927,1.0,659.0,659.0,5,1079,1.0,811.0,811.0
0.009,6,10,1989,5,910,2.0,642.0,642.0,5,1079,2.0,811.0,811.0
0.119,17,2,80,1,32,0.0,4.0,4.0,1,48,0.0,20.0,20.0
0.006,17,2,170,1,65,0.0,37.0,37.0,1,105,0.0,77.0,77.0
0.001,17,2,180,1,66,0.0,38.0,38.0,1,114,0.0,86.0,86.0
0.037,17,2,176,1,80,0.0,52.0,52.0,1,96,0.0,68.0,68.0
0.013,17,2,179,1,71,0.0,43.0,43.0,1,108,0.0,80.0,80.0
0.119,6,10,1506,5,395,23.0,127.0,127.0,5,1111,23.0,843.0,843.0
0.006,6,10,1547,5,764,1.0,496.0,496.0,5,783,1.0,515.0,515.0
0.007,6,10,1972,5,910,1.0,642.0,642.0,5,1062,1.0,794.0,794.0
0.004,6,10,2000,5,927,1.0,659.0,659.0,5,1073,1.0,805.0,805.0
0.006,6,10,1854,5,889,1.0,621.0,621.0,5,965,1.0,697.0,697.0
0.106,6,10,1506,5,395,24.0,127.0,127.0,5,1111,24.0,843.0,843.0
0.038,17,2,152,1,76,0.0,48.0,48.0,1,76,0.0,48.0,48.0
0.01,6,10,1972,5,910,2.0,642.0,642.0,5,1062,2.0,794.0,794.0
0.1,6,10,1506,5,395,22.0,127.0,127.0,5,1111,23.0,843.0,843.0
0.004,6,10,2006,5,927,1.0,659.0,659.0,5,1079,1.0,811.0,811.0
0.005,6,10,2006,5,927,1.0,659.0,659.0,5,1079,1.0,811.0,811.0
0.005,6,10,1547,5,764,1.0,496.0,496.0,5,783,1.0,515.0,515.0
0.015,6,10,1990,5,911,3.0,643.0,643.0,5,1079,3.0,811.0,811.0
0.053,17,2,152,1,76,0.0,48.0,48.0,1,76,0.0,48.0,48.0
0.164,6,10,1506,5,395,36.0,127.0,127.0,5,1111,26.0,843.0,843.0
0.001,17,2,180,1,66,0.0,38.0,38.0,1,114,0.0,86.0,86.0
0.018,6,10,1990,5,911,4.0,643.0,643.0,5,1079,4.0,811.0,811.0
0.005,6,10,1689,5,839,1.0,571.0,571.0,5,850,1.0,582.0,582.0
0.011,6,10,1972,5,910,2.0,642.0,642.0,5,1062,2.0,794.0,794.0
0.118,6,10,1506,5,395,28.0,127.0,127.0,5,1111,26.0,843.0,843.0
0.005,6,10,1989,5,927,1.0,659.0,659.0,5,1062,1.0,794.0,794.0
0.11,6,10,1506,5,395,26.0,127.0,127.0,5,1111,26.0,843.0,843.0
0.014,6,10,1983,5,910,3.0,642.0,642.0,5,1073,3.0,805.0,805.0
0.006,6,10,2006,5,927,1.0,659.0,659.0,5,1079,1.0,811.0,811.0
40.071,17,10,676,5,460,10017.0,104.0,64.0,5,216,10016.0,20.0,15.0
40.049,17,10,676,5,460,10011.0,104.0,64.0,5,216,10011.0,20.0,15.0
0.071,6,10,1506,5,395,17.0,127.0,127.0,5,1111,15.0,843.0,843.0
0.128,17,4,284,2,120,1.0,32.0,32.0,2,164,124.0,60.0,54.0
0.005,6,10,1989,5,927,1.0,659.0,659.0,5,1062,1.0,794.0,794.0
0.07,6,10,1506,5,395,17.0,127.0,127.0,5,1111,15.0,843.0,843.0
0.012,6,13,3735,7,497,2.0,125.0,125.0,6,3238,2.0,1470.0,1459.0
0.01,6,10,1989,5,910,2.0,642.0,642.0,5,1079,2.0,811.0,811.0
0.008,6,12,1926,6,1189,1.0,659.0,434.0,6,737,1.0,417.0,417.0
0.077,6,10,1506,5,395,17.0,127.0,127.0,5,1111,16.0,843.0,843.0
40.056,17,10,676,5,460,10013.0,104.0,64.0,5,216,10013.0,20.0,15.0
0.012,6,10,1972,5,910,3.0,642.0,642.0,5,1062,2.0,794.0,794.0
0.014,6,10,1989,5,910,3.0,642.0,642.0,5,1079,3.0,811.0,811.0
0.005,6,10,1689,5,839,1.0,571.0,571.0,5,850,1.0,582.0,582.0
0.125,6,10,1506,5,395,28.0,127.0,127.0,5,1111,28.0,843.0,843.0
0.005,6,10,2007,5,928,1.0,660.0,660.0,5,1079,1.0,811.0,811.0
0.011,6,10,1983,5,910,2.0,642.0,642.0,5,1073,2.0,805.0,805.0
0.005,17,2,179,1,71,0.0,43.0,43.0,1,108,0.0,80.0,80.0
40.061,17,10,676,5,460,10013.0,104.0,64.0,5,216,10014.0,20.0,15.0
0.012,6,10,1990,5,911,3.0,643.0,643.0,5,1079,3.0,811.0,811.0
600.556,6,44,16438,23,6416,27296.0,1574.0,579.0,21,10022,30026.0,1402.0,812.0
0.038,17,4,284,2,120,0.0,32.0,32.0,2,164,32.0,60.0,54.0
0.006,6,10,1547,5,764,1.0,496.0,496.0,5,783,1.0,515.0,515.0
0.015,17,2,198,1,91,0.0,63.0,63.0,1,107,0.0,79.0,79.0
0.005,6,10,2000,5,927,1.0,659.0,659.0,5,1073,1.0,805.0,805.0
0.007,17,2,214,1,75,0.0,47.0,47.0,1,139,0.0,111.0,111.0
0.004,17,2,170,1,65,0.0,37.0,37.0,1,105,0.0,77.0,77.0
0.085,6,10,1506,5,395,19.0,127.0,127.0,5,1111,20.0,843.0,843.0
0.099,6,10,1506,5,395,22.0,127.0,127.0,5,1111,23.0,843.0,843.0
0.006,6,10,1547,5,764,1.0,496.0,496.0,5,783,1.0,515.0,515.0
0.005,6,10,2006,5,927,1.0,659.0,659.0,5,1079,1.0,811.0,811.0
0.006,6,10,1643,5,860,1.0,592.0,592.0,5,783,1.0,515.0,515.0
0.005,6,10,2000,5,927,1.0,659.0,659.0,5,1073,1.0,805.0,805.0
312.002,17,20,1124,10,716,34660.0,48.0,43.0,10,408,34660.0,20.0,12.0
176.46,17,91,13309,46,3090,3921.0,44.0,39.0,45,10219,4010.0,261.0,199.0
0.016,6,10,1990,5,911,4.0,643.0,643.0,5,1079,4.0,811.0,811.0
240.085,6,16,4481,9,963,30010.0,238.0,166.0,7,3518,40013.0,1402.0,786.0
11.136,17,28,4398,14,2311,848.0,586.0,137.0,14,2087,848.0,270.0,121.0
11.776,17,30,4617,15,2098,829.0,269.0,111.0,15,2519,829.0,586.0,139.0
0.013,17,2,152,1,56,0.0,28.0,28.0,1,96,0.0,68.0,68.0
0.001,17,2,180,1,66,0.0,38.0,38.0,1,114,0.0,86.0,86.0
0.004,6,10,2006,5,927,1.0,659.0,659.0,5,1079,1.0,811.0,811.0
0.006,6,10,1854,5,889,1.0,621.0,621.0,5,965,1.0,697.0,697.0
0.005,6,10,2006,5,927,1.0,659.0,659.0,5,1079,1.0,811.0,811.0
0.009,6,10,1989,5,910,2.0,642.0,642.0,5,1079,2.0,811.0,811.0
0.006,6,10,1547,5,764,1.0,496.0,496.0,5,783,1.0,515.0,515.0
0.006,6,10,1547,5,764,1.0,496.0,496.0,5,783,1.0,515.0,515.0
0.004,6,10,2007,5,928,1.0,660.0,660.0,5,1079,1.0,811.0,811.0
0.017,6,10,1972,5,910,4.0,642.0,642.0,5,1062,4.0,794.0,794.0
0.005,6,10,1643,5,860,1.0,592.0,592.0,5,783,1.0,515.0,515.0
0.006,6,10,1547,5,764,1.0,496.0,496.0,5,783,1.0,515.0,515.0
0.176,6,10,1677,5,827,43.0,559.0,559.0,5,850,44.0,582.0,582.0
0.005,6,10,2006,5,927,1.0,659.0,659.0,5,1079,1.0,811.0,811.0
0.006,6,10,1689,5,839,1.0,571.0,571.0,5,850,1.0,582.0,582.0
10.981,17,26,4101,13,1845,906.0,268.0,113.0,13,2256,906.0,587.0,145.0
0.004,6,10,2007,5,928,1.0,660.0,660.0,5,1079,1.0,811.0,811.0
0.072,6,10,1506,5,395,15.0,127.0,127.0,5,1111,14.0,843.0,843.0
0.004,6,10,1774,5,923,1.0,655.0,655.0,5,851,1.0,583.0,583.0
0.001,17,2,180,1,66,0.0,38.0,38.0,1,114,0.0,86.0,86.0
0.005,6,10,2007,5,928,1.0,660.0,660.0,5,1079,1.0,811.0,811.0
0.001,17,2,179,1,62,0.0,34.0,34.0,1,117,0.0,89.0,89.0
0.069,6,10,1506,5,395,16.0,127.0,127.0,5,1111,13.0,843.0,843.0
0.005,17,2,169,1,62,0.0,34.0,34.0,1,107,0.0,79.0,79.0
1799.849,6,136,6550,76,3625,23997.0,39.0,39.0,60,2925,29993.0,35.0,35.0
0.004,6,10,1989,5,927,1.0,659.0,659.0,5,1062,1.0,794.0,794.0
0.088,6,10,1506,5,395,20.0,127.0,127.0,5,1111,19.0,843.0,843.0
0.103,6,10,1506,5,395,17.0,127.0,127.0,5,1111,22.0,843.0,843.0
0.001,17,2,136,1,60,0.0,32.0,32.0,1,76,0.0,48.0,48.0
175.296,17,92,13232,46,3096,3895.0,44.0,39.0,46,10136,3895.0,239.0,192.0
0.005,6,10,2007,5,928,1.0,660.0,660.0,5,1079,1.0,811.0,811.0
0.074,6,10,1506,5,395,14.0,127.0,127.0,5,1111,16.0,843.0,843.0
240.105,6,16,4480,9,963,30013.0,238.0,166.0,7,3517,40017.0,1402.0,786.0
0.001,17,2,180,1,66,0.0,38.0,38.0,1,114,0.0,86.0,86.0
0.12,6,10,1506,5,395,25.0,127.0,127.0,5,1111,27.0,843.0,843.0
0.001,17,2,180,1,66,0.0,38.0,38.0,1,114,0.0,86.0,86.0
242.222,6,333,345744,142,18974,1717.0,2736.0,960.0,191,326770,1274.0,3003.0,1750.0
173.028,17,78,11024,39,2601,4553.0,44.0,38.0,39,8423,4553.0,261.0,187.0
0.015,6,13,3735,7,497,2.0,125.0,125.0,6,3238,2.0,1470.0,1459.0
0.006,17,2,170,1,65,0.0,37.0,37.0,1,105,0.0,77.0,77.0
0.011,6,10,1677,5,827,2.0,559.0,559.0,5,850,2.0,582.0,582.0
0.019,6,10,1762,5,911,4.0,643.0,643.0,5,851,4.0,583.0,583.0
0.007,6,10,1689,5,839,1.0,571.0,571.0,5,850,1.0,582.0,582.0
0.067,17,8,3613,4,1874,22.0,1350.0,440.0,4,1739,10.0,1350.0,406.0
0.018,6,10,1972,5,910,4.0,642.0,642.0,5,1062,4.0,794.0,794.0
0.087,6,10,1506,5,395,19.0,127.0,127.0,5,1111,16.0,843.0,843.0
40.062,17,10,676,5,460,10012.0,104.0,64.0,5,216,10014.0,20.0,15.0
0.003,17,4,284,2,120,0.0,32.0,32.0,2,164,0.0,60.0,54.0
0.205,6,16,2777,8,1395,29.0,533.0,323.0,8,1382,18.0,529.0,239.0
0.005,6,10,1989,5,927,1.0,659.0,659.0,5,1062,1.0,794.0,794.0
0.089,6,10,1506,5,395,21.0,127.0,127.0,5,1111,17.0,843.0,843.0
0.006,6,10,1547,5,764,1.0,496.0,496.0,5,783,1.0,515.0,515.0
0.006,6,14,3799,7,509,0.0,137.0,137.0,7,3290,0.0,1448.0,972.0
0.014,6,10,1989,5,910,3.0,642.0,642.0,5,1079,3.0,811.0,811.0
0.015,6,10,1983,5,910,3.0,642.0,642.0,5,1073,3.0,805.0,805.0
40.055,17,10,676,5,460,10013.0,104.0,64.0,5,216,10011.0,20.0,15.0
0.001,17,2,136,1,60,0.0,32.0,32.0,1,76,0.0,48.0,48.0
0.004,6,10,2006,5,927,1.0,659.0,659.0,5,1079,1.0,811.0,811.0
0.139,6,10,1506,5,395,24.0,127.0,127.0,5,1111,33.0,843.0,843.0
0.004,6,10,1702,5,863,1.0,595.0,595.0,5,839,1.0,571.0,571.0
0.017,6,13,3735,7,497,2.0,125.0,125.0,6,3238,3.0,1470.0,1459.0
0.008,6,10,1989,5,910,1.0,642.0,642.0,5,1079,1.0,811.0,811.0
0.009,6,10,1989,5,910,2.0,642.0,642.0,5,1079,2.0,811.0,811.0
0.008,6,12,1926,6,1189,1.0,659.0,434.0,6,737,1.0,417.0,417.0
40.072,17,10,676,5,460,10015.0,104.0,64.0,5,216,10017.0,20.0,15.0
0.015,6,10,1983,5,910,3.0,642.0,642.0,5,1073,3.0,805.0,805.0
0.004,17,2,186,1,61,0.0,33.0,33.0,1,125,0.0,97.0,97.0
0.112,6,10,1506,5,395,25.0,127.0,127.0,5,1111,24.0,843.0,843.0
0.005,6,10,2000,5,927,1.0,659.0,659.0,5,1073,1.0,805.0,805.0
0.016,6,10,1989,5,910,4.0,642.0,642.0,5,1079,3.0,811.0,811.0
0.006,6,10,1547,5,764,1.0,496.0,496.0,5,783,1.0,515.0,515.0
0.005,17,2,230,1,68,0.0,40.0,40.0,1,162,0.0,134.0,134.0
0.016,6,10,1989,5,910,4.0,642.0,642.0,5,1079,3.0,811.0,811.0
0.009,6,10,1983,5,910,2.0,642.0,642.0,5,1073,2.0,805.0,805.0
11.181,17,28,4422,14,1995,847.0,270.0,114.0,14,2427,847.0,586.0,145.0
0.013,6,14,3787,7,497,2.0,125.0,125.0,7,3290,2.0,1448.0,972.0
0.166,6,10,1506,5,395,37.0,127.0,127.0,5,1111,34.0,843.0,843.0
0.005,17,2,169,1,62,0.0,34.0,34.0,1,107,0.0,79.0,79.0
0.183,6,46,11696,25,3304,7.0,1021.0,182.0,21,8392,8.0,1402.0,606.0
0.012,6,10,1989,5,910,3.0,642.0,642.0,5,1079,2.0,811.0,811.0
0.005,6,10,2007,5,928,1.0,660.0,660.0,5,1079,1.0,811.0,811.0
0.016,17,2,198,1,91,0.0,63.0,63.0,1,107,0.0,79.0,79.0
0.006,17,2,142,1,63,0.0,35.0,35.0,1,79,0.0,51.0,51.0
0.014,6,10,1990,5,911,3.0,643.0,643.0,5,1079,3.0,811.0,811.0
240.163,6,49,7013,25,3391,10006.0,588.0,230.0,24,3622,10441.0,580.0,197.0
0.038,17,4,284,2,120,0.0,32.0,32.0,2,164,35.0,60.0,54.0
0.175,17,2,152,1,76,0.0,48.0,48.0,1,76,0.0,48.0,48.0
0.005,6,13,3690,7,452,0.0,80.0,80.0,6,3238,1.0,1470.0,1459.0
0.071,17,2,166,1,75,0.0,47.0,47.0,1,91,0.0,63.0,63.0
0.009,6,10,1972,5,910,2.0,642.0,642.0,5,1062,2.0,794.0,794.0
243.127,6,319,343901,121,17796,2026.0,2736.0,885.0,198,326105,1234.0,2804.0,1679.0
0.041,17,2,152,1,76,0.0,48.0,48.0,1,76,0.0,48.0,48.0
0.005,6,10,1689,5,839,1.0,571.0,571.0,5,850,1.0,582.0,582.0
0.007,17,2,194,1,59,0.0,31.0,31.0,1,135,0.0,107.0,107.0
0.003,17,2,136,1,60,0.0,32.0,32.0,1,76,0.0,48.0,48.0
0.086,6,10,1506,5,395,20.0,127.0,127.0,5,1111,20.0,843.0,843.0
0.033,6,10,1762,5,911,8.0,643.0,643.0,5,851,8.0,583.0,583.0
0.005,6,10,1643,5,860,1.0,592.0,592.0,5,783,1.0,515.0,515.0
0.06,17,2,152,1,76,0.0,48.0,48.0,1,76,0.0,48.0,48.0
0.042,17,4,284,2,120,0.0,32.0,32.0,2,164,38.0,60.0,54.0
0.006,6,10,2006,5,927,1.0,659.0,659.0,5,1079,1.0,811.0,811.0
0.009,6,10,1989,5,910,2.0,642.0,642.0,5,1079,2.0,811.0,811.0
0.011,6,10,1989,5,910,2.0,642.0,642.0,5,1079,2.0,811.0,811.0
0.077,17,4,352,2,130,0.0,37.0,37.0,2,222,74.0,89.0,83.0
0.01,6,10,1990,5,911,2.0,643.0,643.0,5,1079,2.0,811.0,811.0
15.073,17,15,9238,8,6902,2149.0,1350.0,834.0,7,2336,2507.0,1350.0,305.0
0.006,17,2,247,1,72,0.0,44.0,44.0,1,175,0.0,147.0,147.0
240.212,6,27,4527,13,1876,20017.0,555.0,238.0,14,2651,18477.0,1114.0,240.0
0.088,6,10,1506,5,395,20.0,127.0,127.0,5,1111,17.0,843.0,843.0
40.058,17,10,676,5,460,10013.0,104.0,64.0,5,216,10013.0,20.0,15.0
0.015,6,13,3735,7,497,2.0,125.0,125.0,6,3238,2.0,1470.0,1459.0
0.004,17,2,148,1,60,0.0,32.0,32.0,1,88,0.0,60.0,60.0
0.099,6,10,1506,5,395,22.0,127.0,127.0,5,1111,23.0,843.0,843.0
0.01,6,10,1983,5,910,2.0,642.0,642.0,5,1073,2.0,805.0,805.0
0.0,17,2,136,1,60,0.0,32.0,32.0,1,76,0.0,48.0,48.0
0.011,6,14,3787,7,497,1.0,125.0,125.0,7,3290,1.0,1448.0,972.0
0.009,6,10,1631,5,848,2.0,580.0,580.0,5,783,2.0,515.0,515.0
0.084,6,10,1506,5,395,17.0,127.0,127.0,5,1111,19.0,843.0,843.0
0.005,17,2,222,1,65,0.0,37.0,37.0,1,157,0.0,129.0,129.0
0.004,6,10,1702,5,863,0.0,595.0,595.0,5,839,1.0,571.0,571.0
0.204,6,16,2669,8,1395,29.0,533.0,323.0,8,1274,18.0,529.0,212.0
0.009,6,12,1926,6,1189,1.0,659.0,434.0,6,737,1.0,417.0,417.0
0.007,6,10,1547,5,764,1.0,496.0,496.0,5,783,1.0,515.0,515.0
240.098,6,16,4481,9,963,30012.0,238.0,166.0,7,3518,40016.0,1402.0,786.0
0.077,6,10,1506,5,395,16.0,127.0,127.0,5,1111,15.0,843.0,843.0
0.005,6,10,1774,5,923,1.0,655.0,655.0,5,851,1.0,583.0,583.0
0.137,6,10,1506,5,395,27.0,127.0,127.0,5,1111,30.0,843.0,843.0
0.012,6,10,1631,5,848,2.0,580.0,580.0,5,783,3.0,515.0,515.0
0.065,6,10,1506,5,395,15.0,127.0,127.0,5,1111,13.0,843.0,843.0
0.008,6,10,1989,5,927,2.0,659.0,659.0,5,1062,2.0,794.0,794.0
0.015,17,2,198,1,91,0.0,63.0,63.0,1,107,0.0,79.0,79.0
0.003,17,4,284,2,120,0.0,32.0,32.0,2,164,0.0,60.0,54.0
40.071,17,10,676,5,460,10015.0,104.0,64.0,5,216,10016.0,20.0,15.0
0.004,6,10,2006,5,927,1.0,659.0,659.0,5,1079,1.0,811.0,811.0
0.202,6,16,2783,8,1401,28.0,533.0,325.0,8,1382,18.0,529.0,239.0
0.111,6,10,1506,5,395,22.0,127.0,127.0,5,1111,24.0,843.0,843.0
0.088,6,10,1506,5,395,18.0,127.0,127.0,5,1111,20.0,843.0,843.0
0.006,6,10,1547,5,764,1.0,496.0,496.0,5,783,1.0,515.0,515.0
0.006,6,10,1689,5,839,1.0,571.0,571.0,5,850,1.0,582.0,582.0
0.004,17,2,148,1,60,0.0,32.0,32.0,1,88,0.0,60.0,60.0
1.013,6,13,3922,7,2139,126.0,1328.0,923.0,6,1783,152.0,1539.0,1539.0
0.005,6,10,2007,5,928,1.0,660.0,660.0,5,1079,1.0,811.0,811.0
0.01,17,2,179,1,71,0.0,43.0,43.0,1,108,0.0,80.0,80.0
0.017,6,10,1989,5,910,4.0,642.0,642.0,5,1079,4.0,811.0,811.0
40.056,17,10,676,5,460,10011.0,104.0,64.0,5,216,10013.0,20.0,15.0
0.005,17,2,166,1,75,0.0,47.0,47.0,1,91,0.0,63.0,63.0
40.055,17,10,676,5,460,10012.0,104.0,64.0,5,216,10013.0,20.0,15.0
0.012,6,10,1989,5,910,3.0,642.0,642.0,5,1079,3.0,811.0,811.0
0.005,17,2,144,1,64,0.0,36.0,36.0,1,80,0.0,52.0,52.0
0.004,6,10,2006,5,927,1.0,659.0,659.0,5,1079,1.0,811.0,811.0
0.098,6,10,1506,5,395,19.0,127.0,127.0,5,1111,22.0,843.0,843.0
0.012,17,2,170,1,65,0.0,37.0,37.0,1,105,0.0,77.0,77.0
0.098,6,10,1506,5,395,22.0,127.0,127.0,5,1111,23.0,843.0,843.0
0.007,17,2,180,1,66,0.0,38.0,38.0,1,114,0.0,86.0,86.0
308.846,17,20,1124,10,716,34301.0,48.0,43.0,10,408,34301.0,20.0,12.0
0.011,6,10,1989,5,910,2.0,642.0,642.0,5,1079,2.0,811.0,811.0
0.017,6,10,1983,5,910,4.0,642.0,642.0,5,1073,4.0,805.0,805.0
0.042,17,2,234,1,61,0.0,33.0,33.0,1,173,0.0,145.0,145.0
0.016,6,10,1983,5,910,4.0,642.0,642.0,5,1073,3.0,805.0,805.0
0.111,6,10,1506,5,395,23.0,127.0,127.0,5,1111,26.0,843.0,843.0
241.173,6,368,346415,186,21187,1303.0,2736.0,885.0,182,325228,1332.0,2804.0,1835.0
0.093,6,10,1506,5,395,20.0,127.0,127.0,5,1111,18.0,843.0,843.0
0.013,6,10,1989,5,910,3.0,642.0,642.0,5,1079,3.0,811.0,811.0
0.008,6,10,1972,5,910,2.0,642.0,642.0,5,1062,1.0,794.0,794.0
0.04,17,4,352,2,130,0.0,37.0,37.0,2,222,0.0,89.0,83.0
0.071,6,10,1506,5,395,15.0,127.0,127.0,5,1111,14.0,843.0,843.0
0.05,6,10,1989,5,910,12.0,642.0,642.0,5,1079,12.0,811.0,811.0
0.01,6,10,1631,5,848,2.0,580.0,580.0,5,783,2.0,515.0,515.0
9.038,17,6,376,5,280,2259.0,28.0,28.0,1,96,0.0,68.0,68.0
0.001,17,2,140,1,62,0.0,34.0,34.0,1,78,0.0,50.0,50.0
1799.984,6,138,6704,77,3704,23684.0,39.0,39.0,61,3000,29995.0,35.0,35.0
0.13,6,10,1506,5,395,26.0,127.0,127.0,5,1111,28.0,843.0,843.0
0.004,6,10,2007,5,928,1.0,660.0,660.0,5,1079,1.0,811.0,811.0
0.005,6,10,1547,5,764,1.0,496.0,496.0,5,783,1.0,515.0,515.0
0.091,6,10,1506,5,395,19.0,127.0,127.0,5,1111,19.0,843.0,843.0
0.011,6,10,1762,5,911,2.0,643.0,643.0,5,851,2.0,583.0,583.0
0.006,6,10,1547,5,764,1.0,496.0,496.0,5,783,1.0,515.0,515.0
0.014,6,10,1990,5,911,3.0,643.0,643.0,5,1079,3.0,811.0,811.0
0.005,6,10,2007,5,928,1.0,660.0,660.0,5,1079,1.0,811.0,811.0
11.109,17,28,4423,14,1994,841.0,269.0,114.0,14,2429,841.0,588.0,145.0
0.005,17,4,284,2,120,1.0,32.0,32.0,2,164,0.0,60.0,54.0
0.005,6,14,3742,7,452,0.0,80.0,80.0,7,3290,0.0,1448.0,972.0
0.01,6,10,1989,5,910,2.0,642.0,642.0,5,1079,2.0,811.0,811.0
0.083,6,10,1506,5,395,15.0,127.0,127.0,5,1111,18.0,843.0,843.0
0.008,6,10,1972,5,910,2.0,642.0,642.0,5,1062,1.0,794.0,794.0
0.008,6,10,1762,5,911,1.0,643.0,643.0,5,851,2.0,583.0,583.0
0.001,17,2,140,1,62,0.0,34.0,34.0,1,78,0.0,50.0,50.0
0.005,6,10,1774,5,923,1.0,655.0,655.0,5,851,1.0,583.0,583.0
0.004,6,10,1989,5,927,1.0,659.0,659.0,5,1062,1.0,794.0,794.0
0.068,17,8,3613,4,1874,22.0,1350.0,440.0,4,1739,11.0,1350.0,406.0
0.11,6,10,1506,5,395,22.0,127.0,127.0,5,1111,26.0,843.0,843.0
0.113,6,10,1506,5,395,16.0,127.0,127.0,5,1111,26.0,843.0,843.0
0.005,6,10,2006,5,927,1.0,659.0,659.0,5,1079,1.0,811.0,811.0
0.101,6,10,1506,5,395,23.0,127.0,127.0,5,1111,24.0,843.0,843.0
0.133,6,10,1506,5,395,31.0,127.0,127.0,5,1111,30.0,843.0,843.0
0.072,6,10,1506,5,395,17.0,127.0,127.0,5,1111,13.0,843.0,843.0
0.007,17,2,144,1,64,0.0,36.0,36.0,1,80,0.0,52.0,52.0
0.068,6,10,1506,5,395,15.0,127.0,127.0,5,1111,14.0,843.0,843.0
0.005,6,10,2007,5,928,1.0,660.0,660.0,5,1079,1.0,811.0,811.0
0.056,6,10,1506,5,395,12.0,127.0,127.0,5,1111,13.0,843.0,843.0
0.005,6,10,1989,5,927,1.0,659.0,659.0,5,1062,1.0,794.0,794.0
0.014,6,10,1972,5,910,3.0,642.0,642.0,5,1062,3.0,794.0,794.0
0.105,6,10,1506,5,395,20.0,127.0,127.0,5,1111,23.0,843.0,843.0
0.006,6,10,1989,5,927,1.0,659.0,659.0,5,1062,1.0,794.0,794.0
0.01,6,10,1762,5,911,2.0,643.0,643.0,5,851,2.0,583.0,583.0
0.004,17,2,136,1,60,0.0,32.0,32.0,1,76,0.0,48.0,48.0
0.004,6,10,1989,5,927,1.0,659.0,659.0,5,1062,1.0,794.0,794.0
177.067,17,72,10302,36,2401,5058.0,44.0,38.0,36,7901,5059.0,261.0,191.0
0.014,6,10,1983,5,910,3.0,642.0,642.0,5,1073,3.0,805.0,805.0
0.01,6,10,1677,5,827,2.0,559.0,559.0,5,850,2.0,582.0,582.0
0.005,17,2,166,1,75,0.0,47.0,47.0,1,91,0.0,63.0,63.0
0.01,6,10,1989,5,910,2.0,642.0,642.0,5,1079,2.0,811.0,811.0
0.002,17,2,136,1,60,0.0,32.0,32.0,1,76,0.0,48.0,48.0
0.008,17,2,140,1,62,0.0,34.0,34.0,1,78,0.0,50.0,50.0
353.534,6,20,2210,6,1308,12003.0,494.0,494.0,14,902,27194.0,83.0,83.0
0.017,17,2,166,1,75,0.0,47.0,47.0,1,91,0.0,63.0,63.0
5.113,58,2,144,1,72,0.0,24.0,24.0,1,72,0.0,24.0,24.0
0.005,6,10,1547,5,764,1.0,496.0,496.0,5,783,1.0,515.0,515.0
0.013,6,10,1989,5,910,3.0,642.0,642.0,5,1079,3.0,811.0,811.0
0.006,6,10,1689,5,839,1.0,571.0,571.0,5,850,1.0,582.0,582.0
0.005,17,2,140,1,62,0.0,34.0,34.0,1,78,0.0,50.0,50.0
0.073,17,4,352,2,130,1.0,37.0,37.0,2,222,34.0,89.0,83.0
0.011,6,10,1762,5,911,2.0,643.0,643.0,5,851,2.0,583.0,583.0
0.088,6,10,1506,5,395,19.0,127.0,127.0,5,1111,17.0,843.0,843.0
0.068,6,10,1506,5,395,14.0,127.0,127.0,5,1111,12.0,843.0,843.0
0.006,6,10,2006,5,927,1.0,659.0,659.0,5,1079,1.0,811.0,811.0
0.106,6,10,1506,5,395,24.0,127.0,127.0,5,1111,21.0,843.0,843.0
0.016,6,10,1989,5,910,4.0,642.0,642.0,5,1079,4.0,811.0,811.0
0.129,17,4,284,2,120,0.0,32.0,32.0,2,164,126.0,60.0,54.0
0.053,17,2,152,1,76,0.0,48.0,48.0,1,76,0.0,48.0,48.0
173.028,17,74,10327,37,2465,4806.0,44.0,38.0,37,7862,4806.0,239.0,184.0
0.008,6,10,1989,5,910,1.0,642.0,642.0,5,1079,2.0,811.0,811.0
40.053,17,10,676,5,460,10012.0,104.0,64.0,5,216,10012.0,20.0,15.0
0.099,6,10,1506,5,395,21.0,127.0,127.0,5,1111,22.0,843.0,843.0
0.066,6,10,1506,5,395,15.0,127.0,127.0,5,1111,14.0,843.0,843.0
0.005,6,14,3742,8,504,0.0,80.0,80.0,6,3238,0.0,1470.0,1459.0
0.101,6,10,1506,5,395,20.0,127.0,127.0,5,1111,23.0,843.0,843.0
40.071,17,10,676,5,460,10016.0,104.0,64.0,5,216,10017.0,20.0,15.0
0.015,6,10,1631,5,848,3.0,580.0,580.0,5,783,3.0,515.0,515.0
0.012,6,10,1989,5,910,2.0,642.0,642.0,5,1079,2.0,811.0,811.0
10.904,17,28,4419,14,1995,830.0,270.0,114.0,14,2424,830.0,587.0,145.0
0.215,6,16,2778,8,1396,30.0,533.0,324.0,8,1382,19.0,529.0,239.0
0.004,17,2,164,1,74,0.0,46.0,46.0,1,90,0.0,62.0,62.0
40.096,17,10,676,5,460,10023.0,104.0,64.0,5,216,10023.0,20.0,15.0
0.041,17,2,182,1,65,0.0,37.0,37.0,1,117,0.0,89.0,89.0
0.077,6,10,1506,5,395,17.0,127.0,127.0,5,1111,18.0,843.0,843.0
11.389,17,28,4394,14,1993,863.0,268.0,114.0,14,2401,863.0,588.0,143.0
0.003,17,2,160,1,72,0.0,44.0,44.0,1,88,0.0,60.0,60.0
0.001,17,2,136,1,60,0.0,32.0,32.0,1,76,0.0,48.0,48.0
10.789,17,28,4422,14,1994,821.0,269.0,114.0,14,2428,821.0,587.0,145.0
40.078,17,10,676,5,460,10017.0,104.0,64.0,5,216,10018.0,20.0,15.0
0.005,6,10,1689,5,839,1.0,571.0,571.0,5,850,1.0,582.0,582.0
0.003,6,10,1702,5,863,0.0,595.0,595.0,5,839,0.0,571.0,571.0
507.458,6,35,9710,19,4000,28192.0,676.0,429.0,16,5710,29830.0,1402.0,608.0
0.009,6,10,1989,5,910,2.0,642.0,642.0,5,1079,2.0,811.0,811.0
0.004,17,4,284,2,120,0.0,32.0,32.0,2,164,0.0,60.0,54.0
1796.964,6,244,35804,152,26032,11900.0,302.0,302.0,92,9772,19746.0,83.0,83.0
241.023,6,39,9824,21,2302,12050.0,746.0,235.0,18,7522,14177.0,1402.0,599.0
15.07,17,15,9239,8,6902,2148.0,1350.0,834.0,7,2337,2506.0,1350.0,305.0
0.004,17,4,284,2,120,0.0,32.0,32.0,2,164,0.0,60.0,54.0
0.005,17,2,170,1,65,0.0,37.0,37.0,1,105,0.0,77.0,77.0
0.004,17,2,169,1,62,0.0,34.0,34.0,1,107,0.0,79.0,79.0
0.007,6,10,1547,5,764,1.0,496.0,496.0,5,783,1.0,515.0,515.0
0.004,17,2,136,1,60,0.0,32.0,32.0,1,76,0.0,48.0,48.0
0.118,17,2,80,1,32,0.0,4.0,4.0,1,48,0.0,20.0,20.0
0.012,6,10,1972,5,910,3.0,642.0,642.0,5,1062,2.0,794.0,794.0
0.005,6,10,2000,5,927,1.0,659.0,659.0,5,1073,1.0,805.0,805.0
0.003,6,10,1702,5,863,0.0,595.0,595.0,5,839,0.0,571.0,571.0
0.082,6,10,1506,5,395,16.0,127.0,127.0,5,1111,17.0,843.0,843.0
0.099,6,10,1506,5,395,20.0,127.0,127.0,5,1111,18.0,843.0,843.0
0.003,17,2,136,1,60,0.0,32.0,32.0,1,76,0.0,48.0,48.0
0.095,6,10,1506,5,395,20.0,127.0,127.0,5,1111,23.0,843.0,843.0
1786.279,6,154,19574,92,13852,19629.0,302.0,302.0,62,5722,29283.0,83.0,83.0
300.038,6,12,1782,7,1348,50006.0,494.0,494.0,5,434,75007.0,83.0,83.0
0.014,6,10,1631,5,848,3.0,580.0,580.0,5,783,3.0,515.0,515.0
0.01,6,10,1972,5,910,2.0,642.0,642.0,5,1062,2.0,794.0,794.0
0.008,6,10,1989,5,910,2.0,642.0,642.0,5,1079,2.0,811.0,811.0
0.075,6,10,1506,5,395,15.0,127.0,127.0,5,1111,17.0,843.0,843.0
0.004,6,10,2006,5,927,1.0,659.0,659.0,5,1079,1.0,811.0,811.0
308.438,17,18,1008,9,640,38547.0,48.0,43.0,9,368,38547.0,20.0,12.0
0.094,6,10,1506,5,395,20.0,127.0,127.0,5,1111,20.0,843.0,843.0
0.138,6,10,1506,5,395,28.0,127.0,127.0,5,1111,32.0,843.0,843.0
0.006,6,10,1643,5,860,1.0,592.0,592.0,5,783,1.0,515.0,515.0
0.013,6,10,1762,5,911,3.0,643.0,643.0,5,851,3.0,583.0,583.0
0.006,6,10,1547,5,764,1.0,496.0,496.0,5,783,1.0,515.0,515.0
0.089,6,10,1506,5,395,17.0,127.0,127.0,5,1111,19.0,843.0,843.0
0.008,6,10,1989,5,910,1.0,642.0,642.0,5,1079,2.0,811.0,811.0
0.09,6,10,1506,5,395,20.0,127.0,127.0,5,1111,17.0,843.0,843.0
0.316,17,16,9965,7,6861,52.0,1350.0,952.0,9,3104,35.0,1350.0,316.0
0.009,6,10,1972,5,910,2.0,642.0,642.0,5,1062,2.0,794.0,794.0
0.005,6,10,1989,5,927,1.0,659.0,659.0,5,1062,1.0,794.0,794.0
0.137,6,10,1506,5,395,33.0,127.0,127.0,5,1111,29.0,843.0,843.0
40.052,17,10,676,5,460,10010.0,104.0,64.0,5,216,10012.0,20.0,15.0
10.808,17,28,4423,14,1995,822.0,270.0,114.0,14,2428,822.0,587.0,145.0
0.001,17,2,136,1,60,0.0,32.0,32.0,1,76,0.0,48.0,48.0
0.001,17,2,166,1,75,0.0,47.0,47.0,1,91,0.0,63.0,63.0
0.005,17,2,152,1,68,0.0,40.0,40.0,1,84,0.0,56.0,56.0
0.102,6,10,1506,5,395,24.0,127.0,127.0,5,1111,24.0,843.0,843.0
0.206,6,16,2777,8,1395,29.0,533.0,323.0,8,1382,18.0,529.0,239.0
0.072,17,2,166,1,75,0.0,47.0,47.0,1,91,0.0,63.0,63.0
0.016,6,10,1989,5,910,3.0,642.0,642.0,5,1079,3.0,811.0,811.0
0.08,6,10,1506,5,395,17.0,127.0,127.0,5,1111,19.0,843.0,843.0
0.216,17,4,596,2,122,144.0,33.0,33.0,2,474,175.0,323.0,209.0
0.005,6,10,1774,5,923,1.0,655.0,655.0,5,851,1.0,583.0,583.0
0.005,6,10,1774,5,923,1.0,655.0,655.0,5,851,1.0,583.0,583.0
0.085,6,10,1506,5,395,19.0,127.0,127.0,5,1111,19.0,843.0,843.0
9.039,17,6,376,5,280,2259.0,28.0,28.0,1,96,0.0,68.0,68.0
0.011,6,10,1990,5,911,2.0,643.0,643.0,5,1079,2.0,811.0,811.0
0.009,6,10,1972,5,910,2.0,642.0,642.0,5,1062,2.0,794.0,794.0
0.112,6,10,1506,5,395,27.0,127.0,127.0,5,1111,25.0,843.0,843.0
0.005,17,2,214,1,75,0.0,47.0,47.0,1,139,0.0,111.0,111.0
0.156,6,10,1506,5,395,36.0,127.0,127.0,5,1111,34.0,843.0,843.0
0.008,6,10,1547,5,764,2.0,496.0,496.0,5,783,1.0,515.0,515.0
0.02,6,13,3816,7,578,3.0,206.0,206.0,6,3238,3.0,1470.0,1459.0
361.82,6,21,1793,16,1030,24121.0,190.0,190.0,5,763,60009.0,462.0,247.0
0.129,6,10,1506,5,395,30.0,127.0,127.0,5,1111,23.0,843.0,843.0
0.005,6,10,2006,5,927,1.0,659.0,659.0,5,1079,1.0,811.0,811.0
0.005,6,10,1547,5,764,1.0,496.0,496.0,5,783,1.0,515.0,515.0
0.014,6,10,1677,5,827,3.0,559.0,559.0,5,850,3.0,582.0,582.0
40.069,17,10,676,5,460,10014.0,104.0,64.0,5,216,10016.0,20.0,15.0
0.006,6,10,1547,5,764,1.0,496.0,496.0,5,783,1.0,515.0,515.0
0.08,6,10,1506,5,395,18.0,127.0,127.0,5,1111,15.0,843.0,843.0
0.011,6,10,1990,5,911,2.0,643.0,643.0,5,1079,2.0,811.0,811.0
290.668,6,369,346175,189,21393,1546.0,2736.0,889.0,180,324782,1623.0,2804.0,1900.0
0.124,6,10,1506,5,395,28.0,127.0,127.0,5,1111,29.0,843.0,843.0
0.038,17,2,182,1,65,0.0,37.0,37.0,1,117,0.0,89.0,89.0
0.129,17,2,80,1,32,0.0,4.0,4.0,1,48,0.0,20.0,20.0
0.01,17,2,138,1,61,0.0,33.0,33.0,1,77,0.0,49.0,49.0
0.114,6,10,1506,5,395,26.0,127.0,127.0,5,1111,24.0,843.0,843.0
0.124,17,2,182,1,65,0.0,37.0,37.0,1,117,0.0,89.0,89.0
0.005,6,10,2000,5,927,1.0,659.0,659.0,5,1073,1.0,805.0,805.0
0.007,6,10,1989,5,927,1.0,659.0,659.0,5,1062,1.0,794.0,794.0
0.004,6,10,2000,5,927,1.0,659.0,659.0,5,1073,1.0,805.0,805.0
89.847,17,6,348,3,228,44806.0,48.0,48.0,3,120,44860.0,12.0,12.0
0.005,17,2,170,1,65,0.0,37.0,37.0,1,105,0.0,77.0,77.0
0.008,6,10,1989,5,910,2.0,642.0,642.0,5,1079,2.0,811.0,811.0
0.008,6,10,1989,5,910,2.0,642.0,642.0,5,1079,2.0,811.0,811.0
0.043,17,2,152,1,76,0.0,48.0,48.0,1,76,0.0,48.0,48.0
40.059,17,10,676,5,460,10014.0,104.0,64.0,5,216,10014.0,20.0,15.0
0.093,6,10,1506,5,395,18.0,127.0,127.0,5,1111,21.0,843.0,843.0
413.595,6,29,4409,12,3102,10911.0,494.0,494.0,17,1307,25849.0,83.0,83.0
0.014,6,10,1990,5,911,3.0,643.0,643.0,5,1079,3.0,811.0,811.0
0.005,6,10,2007,5,928,1.0,660.0,660.0,5,1079,1.0,811.0,811.0
0.001,17,2,136,1,60,0.0,32.0,32.0,1,76,0.0,48.0,48.0
352.243,6,20,2210,6,1308,12004.0,494.0,494.0,14,902,27095.0,83.0,83.0
0.106,6,10,1506,5,395,24.0,127.0,127.0,5,1111,22.0,843.0,843.0
0.005,6,10,2007,5,928,1.0,660.0,660.0,5,1079,1.0,811.0,811.0
0.007,6,10,1547,5,764,1.0,496.0,496.0,5,783,1.0,515.0,515.0
40.065,17,10,676,5,460,10014.0,104.0,64.0,5,216,10015.0,20.0,15.0
1787.569,6,154,19574,92,13852,19643.0,302.0,302.0,62,5722,29304.0,83.0,83.0
0.134,17,2,80,1,32,0.0,4.0,4.0,1,48,0.0,20.0,20.0
368.977,6,22,2313,16,867,24598.0,195.0,195.0,6,1446,4637.0,419.0,398.0
0.004,17,4,284,2,120,0.0,32.0,32.0,2,164,1.0,60.0,54.0
0.025,6,10,1972,5,910,6.0,642.0,642.0,5,1062,6.0,794.0,794.0
0.098,6,10,1506,5,395,22.0,127.0,127.0,5,1111,23.0,843.0,843.0
0.006,6,10,1547,5,764,1.0,496.0,496.0,5,783,1.0,515.0,515.0
0.006,6,10,1643,5,860,1.0,592.0,592.0,5,783,1.0,515.0,515.0
0.005,6,10,1989,5,927,1.0,659.0,659.0,5,1062,1.0,794.0,794.0
0.068,17,8,3613,4,1874,22.0,1350.0,440.0,4,1739,11.0,1350.0,406.0
300.073,6,12,1782,7,1348,50012.0,494.0,494.0,5,434,75017.0,83.0,83.0
0.005,6,10,2000,5,927,1.0,659.0,659.0,5,1073,1.0,805.0,805.0
177.016,6,15,3479,8,2136,25287.0,676.0,428.0,7,1343,29502.0,825.0,491.0
0.145,6,10,1506,5,395,34.0,127.0,127.0,5,1111,33.0,843.0,843.0
0.015,6,10,1989,5,910,3.0,642.0,642.0,5,1079,3.0,811.0,811.0
0.006,6,10,1643,5,860,1.0,592.0,592.0,5,783,1.0,515.0,515.0
0.006,6,10,2006,5,927,1.0,659.0,659.0,5,1079,1.0,811.0,811.0
0.005,6,10,2006,5,927,1.0,659.0,659.0,5,1079,1.0,811.0,811.0
0.004,6,10,2007,5,928,1.0,660.0,660.0,5,1079,1.0,811.0,811.0
0.003,17,2,136,1,60,0.0,32.0,32.0,1,76,0.0,48.0,48.0
0.138,6,10,1506,5,395,31.0,127.0,127.0,5,1111,26.0,843.0,843.0
0.04,17,4,284,2,120,0.0,32.0,32.0,2,164,37.0,60.0,54.0
0.006,6,10,1547,5,764,1.0,496.0,496.0,5,783,1.0,515.0,515.0
172.317,17,78,11221,39,2598,4534.0,44.0,38.0,39,8623,4534.0,261.0,193.0
0.005,6,10,1989,5,927,1.0,659.0,659.0,5,1062,1.0,794.0,794.0
0.006,6,10,1547,5,764,1.0,496.0,496.0,5,783,1.0,515.0,515.0
0.117,6,10,1506,5,395,28.0,127.0,127.0,5,1111,24.0,843.0,843.0
1776.76,17,144,41760,72,22752,25024.0,288.0,288.0,72,19008,25024.0,236.0,236.0
0.001,17,2,180,1,66,0.0,38.0,38.0,1,114,0.0,86.0,86.0
0.007,6,10,1689,5,839,1.0,571.0,571.0,5,850,1.0,582.0,582.0
0.103,6,10,1506,5,395,25.0,127.0,127.0,5,1111,23.0,843.0,843.0
0.005,6,10,1689,5,839,1.0,571.0,571.0,5,850,1.0,582.0,582.0
0.099,6,10,1506,5,395,21.0,127.0,127.0,5,1111,21.0,843.0,843.0
0.001,17,2,180,1,66,0.0,38.0,38.0,1,114,0.0,86.0,86.0
0.009,6,10,1762,5,911,2.0,643.0,643.0,5,851,2.0,583.0,583.0
0.005,6,10,1989,5,927,1.0,659.0,659.0,5,1062,1.0,794.0,794.0
1.067,6,30,6018,14,1788,71.0,267.0,135.0,16,4230,59.0,1414.0,597.0
300.016,6,11,891,6,552,60002.0,232.0,232.0,5,339,75003.0,83.0,83.0
0.015,6,10,1631,5,848,3.0,580.0,580.0,5,783,3.0,515.0,515.0
0.013,17,2,152,1,56,0.0,28.0,28.0,1,96,0.0,68.0,68.0
0.131,6,10,1506,5,395,30.0,127.0,127.0,5,1111,23.0,843.0,843.0
0.01,6,10,1990,5,911,2.0,643.0,643.0,5,1079,2.0,811.0,811.0
0.006,6,10,1547,5,764,1.0,496.0,496.0,5,783,1.0,515.0,515.0
0.012,6,10,1990,5,911,3.0,643.0,643.0,5,1079,2.0,811.0,811.0
0.087,6,10,1506,5,395,19.0,127.0,127.0,5,1111,19.0,843.0,843.0
0.079,6,10,1506,5,395,17.0,127.0,127.0,5,1111,18.0,843.0,843.0
0.012,6,10,1989,5,910,3.0,642.0,642.0,5,1079,2.0,811.0,811.0
268.164,6,21,3870,12,2393,24378.0,663.0,293.0,9,1477,33520.0,824.0,337.0
0.13,17,2,186,1,61,0.0,33.0,33.0,1,125,0.0,97.0,97.0
0.004,6,10,2000,5,927,1.0,659.0,659.0,5,1073,1.0,805.0,805.0
10.877,17,28,4422,14,1994,827.0,269.0,114.0,14,2428,827.0,587.0,145.0
0.069,17,8,3613,4,1874,23.0,1350.0,440.0,4,1739,12.0,1350.0,406.0
0.011,6,10,1990,5,911,2.0,643.0,643.0,5,1079,2.0,811.0,811.0
292.825,6,383,347468,197,21803,1494.0,2736.0,825.0,186,325665,1582.0,3226.0,1837.0
0.082,6,10,1506,5,395,17.0,127.0,127.0,5,1111,18.0,843.0,843.0
0.003,17,2,136,1,60,0.0,32.0,32.0,1,76,0.0,48.0,48.0
0.093,6,10,1506,5,395,20.0,127.0,127.0,5,1111,18.0,843.0,843.0
0.006,6,10,1547,5,764,1.0,496.0,496.0,5,783,1.0,515.0,515.0
0.005,6,10,1643,5,860,1.0,592.0,592.0,5,783,1.0,515.0,515.0
0.005,17,2,170,1,65,0.0,37.0,37.0,1,105,0.0,77.0,77.0
0.006,6,10,1547,5,764,1.0,496.0,496.0,5,783,1.0,515.0,515.0
0.012,6,14,3787,7,497,1.0,125.0,125.0,7,3290,2.0,1448.0,972.0
0.016,6,10,1989,5,910,3.0,642.0,642.0,5,1079,4.0,811.0,811.0
0.038,17,4,596,2,122,0.0,33.0,33.0,2,474,1.0,323.0,209.0
0.012,6,10,1677,5,827,3.0,559.0,559.0,5,850,3.0,582.0,582.0
0.005,17,2,140,1,62,0.0,34.0,34.0,1,78,0.0,50.0,50.0
0.006,6,13,3747,7,509,0.0,137.0,137.0,6,3238,1.0,1470.0,1459.0
11.279,17,28,4423,14,1994,855.0,269.0,114.0,14,2429,855.0,588.0,145.0
0.017,6,10,1972,5,910,4.0,642.0,642.0,5,1062,4.0,794.0,794.0
0.005,6,10,2007,5,928,1.0,660.0,660.0,5,1079,1.0,811.0,811.0
0.006,17,2,166,1,75,0.0,47.0,47.0,1,91,0.0,63.0,63.0
0.008,6,12,1926,6,1189,1.0,659.0,434.0,6,737,1.0,417.0,417.0
0.102,6,10,1506,5,395,20.0,127.0,127.0,5,1111,24.0,843.0,843.0
40.065,17,10,676,5,460,10015.0,104.0,64.0,5,216,10015.0,20.0,15.0
0.003,17,4,284,2,120,0.0,32.0,32.0,2,164,0.0,60.0,54.0
0.006,6,10,2006,5,927,1.0,659.0,659.0,5,1079,1.0,811.0,811.0
0.001,17,2,136,1,60,0.0,32.0,32.0,1,76,0.0,48.0,48.0
0.005,6,10,2007,5,928,1.0,660.0,660.0,5,1079,1.0,811.0,811.0
0.006,6,10,1643,5,860,1.0,592.0,592.0,5,783,1.0,515.0,515.0
0.065,6,10,1506,5,395,14.0,127.0,127.0,5,1111,15.0,843.0,843.0
0.005,6,10,1547,5,764,1.0,496.0,496.0,5,783,1.0,515.0,515.0
40.078,17,10,676,5,460,10017.0,104.0,64.0,5,216,10018.0,20.0,15.0
0.004,6,10,2006,5,927,1.0,659.0,659.0,5,1079,1.0,811.0,811.0
482.307,6,28,10305,15,2606,34448.0,676.0,363.0,13,7699,40189.0,1402.0,1003.0
0.124,17,2,80,1,32,0.0,4.0,4.0,1,48,0.0,20.0,20.0
0.074,6,10,1506,5,395,16.0,127.0,127.0,5,1111,15.0,843.0,843.0
0.129,17,2,80,1,32,0.0,4.0,4.0,1,48,0.0,20.0,20.0
0.013,6,10,1677,5,827,3.0,559.0,559.0,5,850,3.0,582.0,582.0
0.005,6,14,3799,7,509,0.0,137.0,137.0,7,3290,0.0,1448.0,972.0
0.014,6,10,1631,5,848,3.0,580.0,580.0,5,783,3.0,515.0,515.0
0.005,6,10,1689,5,839,1.0,571.0,571.0,5,850,1.0,582.0,582.0
10.898,17,28,4395,14,1995,829.0,270.0,114.0,14,2400,829.0,587.0,143.0
0.005,6,10,1779,5,928,1.0,660.0,660.0,5,851,1.0,583.0,583.0
0.093,6,10,1506,5,395,21.0,127.0,127.0,5,1111,18.0,843.0,843.0
0.006,6,10,1689,5,839,1.0,571.0,571.0,5,850,1.0,582.0,582.0
0.005,17,2,175,1,65,0.0,37.0,37.0,1,110,0.0,82.0,82.0
0.001,17,2,136,1,60,0.0,32.0,32.0,1,76,0.0,48.0,48.0
0.07,6,10,1506,5,395,16.0,127.0,127.0,5,1111,16.0,843.0,843.0
240.085,6,16,4481,9,963,30010.0,238.0,166.0,7,3518,40013.0,1402.0,786.0
0.004,6,10,2006,5,927,1.0,659.0,659.0,5,1079,1.0,811.0,811.0
0.018,17,2,179,1,71,0.0,43.0,43.0,1,108,0.0,80.0,80.0
0.008,6,10,1989,5,927,2.0,659.0,659.0,5,1062,1.0,794.0,794.0
0.005,17,2,164,1,74,0.0,46.0,46.0,1,90,0.0,62.0,62.0
356.6,6,21,1795,16,1030,23773.0,190.0,190.0,5,765,60004.0,464.0,248.0
40.064,17,10,676,5,460,10015.0,104.0,64.0,5,216,10015.0,20.0,15.0
0.009,6,10,1972,5,910,2.0,642.0,642.0,5,1062,2.0,794.0,794.0
0.005,17,2,169,1,62,0.0,34.0,34.0,1,107,0.0,79.0,79.0
0.005,6,10,1689,5,839,1.0,571.0,571.0,5,850,1.0,582.0,582.0
0.019,6,20,9974,11,704,1.0,124.0,124.0,9,9270,2.0,2896.0,1758.0
0.017,6,10,1989,5,910,4.0,642.0,642.0,5,1079,4.0,811.0,811.0
0.107,6,10,1506,5,395,25.0,127.0,127.0,5,1111,21.0,843.0,843.0
0.04,17,2,182,1,65,0.0,37.0,37.0,1,117,0.0,89.0,89.0
0.008,6,10,1989,5,910,1.0,642.0,642.0,5,1079,2.0,811.0,811.0
0.043,17,2,152,1,76,0.0,48.0,48.0,1,76,0.0,48.0,48.0
308.912,17,20,1124,10,716,34316.0,48.0,43.0,10,408,34316.0,20.0,12.0
0.013,6,10,1972,5,910,3.0,642.0,642.0,5,1062,3.0,794.0,794.0
300.353,6,16,2170,9,684,37523.0,146.0,146.0,7,1486,50030.0,419.0,398.0
40.074,17,10,676,5,460,10016.0,104.0,64.0,5,216,10016.0,20.0,15.0
0.001,17,2,180,1,66,0.0,38.0,38.0,1,114,0.0,86.0,86.0
308.534,17,20,1124,10,716,34267.0,48.0,43.0,10,408,34267.0,20.0,12.0
0.004,6,10,1774,5,923,1.0,655.0,655.0,5,851,1.0,583.0,583.0
40.059,17,10,676,5,460,10012.0,104.0,64.0,5,216,10013.0,20.0,15.0
0.041,17,4,284,2,120,0.0,32.0,32.0,2,164,30.0,60.0,54.0
322.854,17,20,1124,10,716,35859.0,48.0,43.0,10,408,35858.0,20.0,12.0
0.036,17,2,169,1,62,0.0,34.0,34.0,1,107,0.0,79.0,79.0
0.006,6,10,1854,5,889,1.0,621.0,621.0,5,965,1.0,697.0,697.0
0.022,6,10,1631,5,848,5.0,580.0,580.0,5,783,5.0,515.0,515.0
0.093,6,10,1506,5,395,21.0,127.0,127.0,5,1111,20.0,843.0,843.0
0.119,6,10,1506,5,395,21.0,127.0,127.0,5,1111,26.0,843.0,843.0
0.014,6,10,1972,5,910,3.0,642.0,642.0,5,1062,3.0,794.0,794.0
0.087,6,10,1506,5,395,21.0,127.0,127.0,5,1111,18.0,843.0,843.0
371.565,6,22,2313,16,867,24771.0,195.0,195.0,6,1446,4638.0,419.0,398.0
0.09,6,10,1506,5,395,18.0,127.0,127.0,5,1111,21.0,843.0,843.0
0.012,6,10,1990,5,911,3.0,643.0,643.0,5,1079,3.0,811.0,811.0
0.006,6,10,1547,5,764,1.0,496.0,496.0,5,783,1.0,515.0,515.0
0.168,6,10,1506,5,395,18.0,127.0,127.0,5,1111,38.0,843.0,843.0
0.003,17,2,148,1,60,0.0,32.0,32.0,1,88,0.0,60.0,60.0
0.001,17,2,180,1,66,0.0,38.0,38.0,1,114,0.0,86.0,86.0
0.013,6,10,1972,5,910,3.0,642.0,642.0,5,1062,3.0,794.0,794.0
0.013,6,10,1972,5,910,3.0,642.0,642.0,5,1062,3.0,794.0,794.0
0.018,6,10,1983,5,910,4.0,642.0,642.0,5,1073,4.0,805.0,805.0
0.005,17,2,180,1,66,0.0,38.0,38.0,1,114,0.0,86.0,86.0
0.004,6,10,1989,5,927,1.0,659.0,659.0,5,1062,1.0,794.0,794.0
0.006,6,10,1689,5,839,1.0,571.0,571.0,5,850,1.0,582.0,582.0
1777.708,17,144,41760,72,22752,25038.0,288.0,288.0,72,19008,25037.0,236.0,236.0
11.295,17,28,4421,14,1994,856.0,269.0,114.0,14,2427,855.0,586.0,145.0
0.009,6,13,3735,7,497,1.0,125.0,125.0,6,3238,1.0,1470.0,1459.0
0.011,6,10,1983,5,910,2.0,642.0,642.0,5,1073,2.0,805.0,805.0
0.017,6,10,1983,5,910,4.0,642.0,642.0,5,1073,4.0,805.0,805.0
0.012,6,10,1631,5,848,3.0,580.0,580.0,5,783,3.0,515.0,515.0
0.005,6,10,2006,5,927,1.0,659.0,659.0,5,1079,1.0,811.0,811.0
10.923,17,26,4167,13,1866,901.0,269.0,115.0,13,2301,901.0,588.0,149.0
9.039,17,6,376,5,280,2259.0,28.0,28.0,1,96,0.0,68.0,68.0
0.126,17,2,148,1,60,0.0,32.0,32.0,1,88,0.0,60.0,60.0
0.005,6,10,2000,5,927,1.0,659.0,659.0,5,1073,1.0,805.0,805.0
0.013,6,10,1989,5,910,3.0,642.0,642.0,5,1079,3.0,811.0,811.0
0.015,6,10,1677,5,827,3.0,559.0,559.0,5,850,3.0,582.0,582.0
0.113,6,10,1506,5,395,24.0,127.0,127.0,5,1111,23.0,843.0,843.0
0.003,17,2,148,1,60,0.0,32.0,32.0,1,88,0.0,60.0,60.0
0.002,17,2,180,1,66,0.0,38.0,38.0,1,114,0.0,86.0,86.0
0.025,6,10,1989,5,910,6.0,642.0,642.0,5,1079,6.0,811.0,811.0
0.013,17,2,148,1,60,0.0,32.0,32.0,1,88,0.0,60.0,60.0
15.233,17,17,8604,9,6322,1900.0,1350.0,674.0,8,2282,2171.0,1350.0,257.0
0.112,6,10,1762,5,911,28.0,643.0,643.0,5,851,28.0,583.0,583.0
11.105,17,28,4421,14,1993,841.0,268.0,114.0,14,2428,841.0,587.0,145.0
1.028,6,12,3134,6,2099,154.0,1328.0,923.0,6,1035,154.0,791.0,791.0
0.022,6,10,1989,5,910,5.0,642.0,642.0,5,1079,5.0,811.0,811.0
0.005,6,10,1854,5,889,1.0,621.0,621.0,5,965,1.0,697.0,697.0
0.073,6,10,1506,5,395,16.0,127.0,127.0,5,1111,16.0,843.0,843.0
0.001,17,2,180,1,66,0.0,38.0,38.0,1,114,0.0,86.0,86.0
0.005,6,10,2007,5,928,1.0,660.0,660.0,5,1079,1.0,811.0,811.0
0.005,6,10,2007,5,928,1.0,660.0,660.0,5,1079,1.0,811.0,811.0
0.001,17,2,166,1,75,0.0,47.0,47.0,1,91,0.0,63.0,63.0
0.006,6,10,1854,5,889,1.0,621.0,621.0,5,965,1.0,697.0,697.0
300.789,6,37,9597,20,4119,15831.0,1543.0,657.0,17,5478,538.0,2667.0,435.0
0.003,17,2,152,1,76,0.0,48.0,48.0,1,76,0.0,48.0,48.0
0.021,6,14,3787,7,497,3.0,125.0,125.0,7,3290,3.0,1448.0,972.0
0.005,17,4,284,2,120,0.0,32.0,32.0,2,164,1.0,60.0,54.0
300.124,6,23,7503,13,2718,25010.0,1368.0,406.0,10,4785,33346.0,1657.0,1067.0
0.004,17,2,166,1,75,0.0,47.0,47.0,1,91,0.0,63.0,63.0
0.051,17,4,596,2,122,1.0,33.0,33.0,2,474,2.0,323.0,209.0
0.003,17,2,136,1,60,0.0,32.0,32.0,1,76,0.0,48.0,48.0
0.009,6,10,1989,5,910,2.0,642.0,642.0,5,1079,2.0,811.0,811.0
0.108,6,10,1506,5,395,21.0,127.0,127.0,5,1111,25.0,843.0,843.0
10.89,17,26,4101,13,1821,898.0,268.0,112.0,13,2280,898.0,587.0,147.0
0.0,17,2,140,1,62,0.0,34.0,34.0,1,78,0.0,50.0,50.0
0.007,6,10,1762,5,911,1.0,643.0,643.0,5,851,1.0,583.0,583.0
0.073,6,10,1506,5,395,17.0,127.0,127.0,5,1111,17.0,843.0,843.0
0.006,6,10,1547,5,764,1.0,496.0,496.0,5,783,1.0,515.0,515.0
0.005,17,2,179,1,71,0.0,43.0,43.0,1,108,0.0,80.0,80.0
0.01,6,10,1983,5,910,2.0,642.0,642.0,5,1073,2.0,805.0,805.0
310.56,17,20,1124,10,716,34500.0,48.0,43.0,10,408,34500.0,20.0,12.0
240.09,6,16,4481,9,963,30011.0,238.0,166.0,7,3518,40014.0,1402.0,786.0
0.095,6,10,1506,5,395,21.0,127.0,127.0,5,1111,21.0,843.0,843.0
0.009,6,10,1972,5,910,2.0,642.0,642.0,5,1062,2.0,794.0,794.0
0.078,6,10,1506,5,395,15.0,127.0,127.0,5,1111,17.0,843.0,843.0
0.004,17,4,284,2,120,0.0,32.0,32.0,2,164,0.0,60.0,54.0
0.005,6,13,3747,7,509,0.0,137.0,137.0,6,3238,1.0,1470.0,1459.0
0.169,17,2,152,1,76,0.0,48.0,48.0,1,76,0.0,48.0,48.0
0.078,6,10,1506,5,395,17.0,127.0,127.0,5,1111,14.0,843.0,843.0
0.005,17,2,170,1,65,0.0,37.0,37.0,1,105,0.0,77.0,77.0
15.072,17,15,9238,8,6902,2149.0,1350.0,834.0,7,2336,2507.0,1350.0,305.0
0.003,17,2,148,1,60,0.0,32.0,32.0,1,88,0.0,60.0,60.0
0.004,6,10,2006,5,927,1.0,659.0,659.0,5,1079,1.0,811.0,811.0
0.004,6,10,2007,5,928,1.0,660.0,660.0,5,1079,1.0,811.0,811.0
0.04,17,2,170,1,65,0.0,37.0,37.0,1,105,0.0,77.0,77.0
0.021,6,10,1989,5,910,5.0,642.0,642.0,5,1079,5.0,811.0,811.0
0.003,17,2,136,1,60,0.0,32.0,32.0,1,76,0.0,48.0,48.0
11.401,17,28,4399,14,2312,864.0,587.0,137.0,14,2087,864.0,270.0,121.0
0.004,6,10,2007,5,928,1.0,660.0,660.0,5,1079,1.0,811.0,811.0
0.011,6,10,1989,5,910,2.0,642.0,642.0,5,1079,2.0,811.0,811.0
308.424,17,20,1124,10,716,34257.0,48.0,43.0,10,408,34255.0,20.0,12.0
0.228,6,16,2778,8,1396,32.0,533.0,324.0,8,1382,20.0,529.0,239.0
0.014,6,10,1983,5,910,3.0,642.0,642.0,5,1073,3.0,805.0,805.0
0.128,17,2,80,1,32,0.0,4.0,4.0,1,48,0.0,20.0,20.0
0.004,17,2,152,1,76,0.0,48.0,48.0,1,76,0.0,48.0,48.0
0.014,6,10,1972,5,910,3.0,642.0,642.0,5,1062,3.0,794.0,794.0
40.062,17,10,676,5,460,10014.0,104.0,64.0,5,216,10014.0,20.0,15.0
0.008,6,10,1989,5,910,2.0,642.0,642.0,5,1079,2.0,811.0,811.0
0.015,6,10,1989,5,910,3.0,642.0,642.0,5,1079,3.0,811.0,811.0
0.062,6,10,1506,5,395,14.0,127.0,127.0,5,1111,13.0,843.0,843.0
0.005,6,10,2006,5,927,1.0,659.0,659.0,5,1079,1.0,811.0,811.0
0.012,6,10,1972,5,910,3.0,642.0,642.0,5,1062,2.0,794.0,794.0
0.005,17,2,178,1,81,0.0,53.0,53.0,1,97,0.0,69.0,69.0
11.212,17,28,4418,14,1993,849.0,268.0,114.0,14,2425,849.0,588.0,145.0
0.005,17,2,180,1,66,0.0,38.0,38.0,1,114,0.0,86.0,86.0
40.067,17,10,676,5,460,10014.0,104.0,64.0,5,216,10015.0,20.0,15.0
0.094,6,10,1506,5,395,21.0,127.0,127.0,5,1111,18.0,843.0,843.0
0.083,6,10,1506,5,395,17.0,127.0,127.0,5,1111,20.0,843.0,843.0
0.14,6,10,1506,5,395,33.0,127.0,127.0,5,1111,32.0,843.0,843.0
0.093,6,10,1506,5,395,19.0,127.0,127.0,5,1111,20.0,843.0,843.0
0.074,6,10,1506,5,395,16.0,127.0,127.0,5,1111,16.0,843.0,843.0
0.01,6,10,1989,5,910,2.0,642.0,642.0,5,1079,2.0,811.0,811.0
0.004,6,10,1989,5,927,1.0,659.0,659.0,5,1062,1.0,794.0,794.0
0.075,17,8,3613,4,1874,25.0,1350.0,440.0,4,1739,14.0,1350.0,406.0
0.007,6,10,2007,5,928,1.0,660.0,660.0,5,1079,1.0,811.0,811.0
0.008,6,10,1689,5,839,2.0,571.0,571.0,5,850,1.0,582.0,582.0
0.002,17,2,166,1,75,0.0,47.0,47.0,1,91,0.0,63.0,63.0
0.005,6,10,1779,5,928,1.0,660.0,660.0,5,851,1.0,583.0,583.0
0.001,17,2,180,1,66,0.0,38.0,38.0,1,114,0.0,86.0,86.0
0.005,6,10,1989,5,927,1.0,659.0,659.0,5,1062,1.0,794.0,794.0
0.001,17,2,180,1,66,0.0,38.0,38.0,1,114,0.0,86.0,86.0
0.093,6,10,1506,5,395,19.0,127.0,127.0,5,1111,21.0,843.0,843.0
0.006,6,10,1643,5,860,1.0,592.0,592.0,5,783,1.0,515.0,515.0
0.006,6,10,1547,5,764,1.0,496.0,496.0,5,783,1.0,515.0,515.0
0.007,6,10,1990,5,911,1.0,643.0,643.0,5,1079,1.0,811.0,811.0
0.006,6,10,1854,5,889,1.0,621.0,621.0,5,965,1.0,697.0,697.0
0.101,6,10,1506,5,395,20.0,127.0,127.0,5,1111,21.0,843.0,843.0
0.006,6,10,1547,5,764,1.0,496.0,496.0,5,783,1.0,515.0,515.0
0.005,6,10,1689,5,839,1.0,571.0,571.0,5,850,1.0,582.0,582.0
0.004,6,10,2006,5,927,1.0,659.0,659.0,5,1079,1.0,811.0,811.0
0.017,6,10,1990,5,911,4.0,643.0,643.0,5,1079,4.0,811.0,811.0
0.005,6,10,2007,5,928,1.0,660.0,660.0,5,1079,1.0,811.0,811.0
0.006,6,10,1989,5,927,1.0,659.0,659.0,5,1062,1.0,794.0,794.0
0.014,6,10,1972,5,910,3.0,642.0,642.0,5,1062,3.0,794.0,794.0
0.015,6,10,1989,5,910,3.0,642.0,642.0,5,1079,3.0,811.0,811.0
0.071,6,10,1506,5,395,15.0,127.0,127.0,5,1111,16.0,843.0,843.0
0.012,6,10,1677,5,827,3.0,559.0,559.0,5,850,3.0,582.0,582.0
0.112,6,10,1506,5,395,24.0,127.0,127.0,5,1111,24.0,843.0,843.0
0.041,17,2,412,1,61,0.0,33.0,33.0,1,351,0.0,323.0,323.0
240.101,6,16,4481,9,963,30012.0,238.0,166.0,7,3518,40016.0,1402.0,786.0
240.091,6,16,4480,9,963,30011.0,238.0,166.0,7,3517,40014.0,1402.0,786.0
0.089,6,10,1506,5,395,20.0,127.0,127.0,5,1111,20.0,843.0,843.0
0.105,6,10,1506,5,395,24.0,127.0,127.0,5,1111,24.0,843.0,843.0
0.003,17,2,136,1,60,0.0,32.0,32.0,1,76,0.0,48.0,48.0
0.005,17,4,284,2,120,0.0,32.0,32.0,2,164,1.0,60.0,54.0
0.012,6,13,3735,7,497,2.0,125.0,125.0,6,3238,2.0,1470.0,1459.0
0.095,6,10,1506,5,395,19.0,127.0,127.0,5,1111,22.0,843.0,843.0
0.004,6,10,2006,5,927,1.0,659.0,659.0,5,1079,1.0,811.0,811.0
0.004,6,10,2006,5,927,1.0,659.0,659.0,5,1079,1.0,811.0,811.0
0.008,6,12,1926,6,1189,1.0,659.0,434.0,6,737,1.0,417.0,417.0
0.232,6,10,1506,5,395,55.0,127.0,127.0,5,1111,40.0,843.0,843.0
0.071,17,2,144,1,64,0.0,36.0,36.0,1,80,0.0,52.0,52.0
0.102,6,10,1506,5,395,22.0,127.0,127.0,5,1111,25.0,843.0,843.0
0.093,6,10,1506,5,395,20.0,127.0,127.0,5,1111,17.0,843.0,843.0
15.186,17,41,20303,23,17141,688.0,1350.0,717.0,18,3162,891.0,1350.0,147.0
0.005,6,10,1854,5,889,1.0,621.0,621.0,5,965,1.0,697.0,697.0
0.003,17,4,284,2,120,0.0,32.0,32.0,2,164,0.0,60.0,54.0
0.006,6,10,1689,5,839,1.0,571.0,571.0,5,850,1.0,582.0,582.0
0.006,17,2,214,1,75,0.0,47.0,47.0,1,139,0.0,111.0,111.0
0.005,17,2,170,1,65,0.0,37.0,37.0,1,105,0.0,77.0,77.0
0.004,6,10,2006,5,927,1.0,659.0,659.0,5,1079,1.0,811.0,811.0
0.005,6,10,2006,5,927,1.0,659.0,659.0,5,1079,1.0,811.0,811.0
0.006,6,10,1689,5,839,1.0,571.0,571.0,5,850,1.0,582.0,582.0
0.129,17,2,80,1,32,0.0,4.0,4.0,1,48,0.0,20.0,20.0
0.005,6,10,2007,5,928,1.0,660.0,660.0,5,1079,1.0,811.0,811.0
0.005,6,10,2007,5,928,1.0,660.0,660.0,5,1079,1.0,811.0,811.0
0.005,6,10,1854,5,889,1.0,621.0,621.0,5,965,1.0,697.0,697.0
0.009,6,10,2000,5,927,2.0,659.0,659.0,5,1073,2.0,805.0,805.0
15.071,17,14,9191,8,6902,2148.0,1350.0,834.0,6,2289,3008.0,1350.0,353.0
0.001,17,2,180,1,66,0.0,38.0,38.0,1,114,0.0,86.0,86.0
0.005,6,10,2007,5,928,1.0,660.0,660.0,5,1079,1.0,811.0,811.0
0.005,6,10,2000,5,927,1.0,659.0,659.0,5,1073,1.0,805.0,805.0
0.013,6,10,1972,5,910,3.0,642.0,642.0,5,1062,3.0,794.0,794.0
0.008,6,10,1677,5,827,2.0,559.0,559.0,5,850,2.0,582.0,582.0
0.004,17,2,136,1,60,0.0,32.0,32.0,1,76,0.0,48.0,48.0
0.005,6,10,2006,5,927,1.0,659.0,659.0,5,1079,1.0,811.0,811.0
1.086,6,31,12747,18,3352,63.0,1360.0,517.0,13,9395,74.0,2720.0,984.0
0.02,6,10,1983,5,910,5.0,642.0,642.0,5,1073,5.0,805.0,805.0
0.067,17,8,3613,4,1874,22.0,1350.0,440.0,4,1739,11.0,1350.0,406.0
0.079,6,10,1506,5,395,17.0,127.0,127.0,5,1111,17.0,843.0,843.0
0.006,6,10,1989,5,927,1.0,659.0,659.0,5,1062,1.0,794.0,794.0
0.069,6,10,1506,5,395,14.0,127.0,127.0,5,1111,15.0,843.0,843.0
40.052,17,10,676,5,460,10012.0,104.0,64.0,5,216,10012.0,20.0,15.0
0.006,6,10,1547,5,764,1.0,496.0,496.0,5,783,1.0,515.0,515.0
0.009,6,12,1698,6,863,1.0,327.0,271.0,6,835,1.0,515.0,515.0
0.072,6,10,1506,5,395,14.0,127.0,127.0,5,1111,15.0,843.0,843.0
0.003,17,2,148,1,60,0.0,32.0,32.0,1,88,0.0,60.0,60.0
0.114,6,10,1506,5,395,27.0,127.0,127.0,5,1111,25.0,843.0,843.0
0.076,6,10,1506,5,395,16.0,127.0,127.0,5,1111,18.0,843.0,843.0
0.133,6,10,1506,5,395,23.0,127.0,127.0,5,1111,31.0,843.0,843.0
0.04,17,2,186,1,61,0.0,33.0,33.0,1,125,0.0,97.0,97.0
0.114,6,10,1506,5,395,26.0,127.0,127.0,5,1111,26.0,843.0,843.0
0.014,6,10,1989,5,910,3.0,642.0,642.0,5,1079,3.0,811.0,811.0
0.06,17,2,152,1,76,0.0,48.0,48.0,1,76,0.0,48.0,48.0
0.113,6,10,1506,5,395,23.0,127.0,127.0,5,1111,27.0,843.0,843.0
0.004,6,10,1779,5,928,1.0,660.0,660.0,5,851,1.0,583.0,583.0
0.011,6,10,1631,5,848,2.0,580.0,580.0,5,783,2.0,515.0,515.0
0.041,17,2,152,1,76,0.0,48.0,48.0,1,76,0.0,48.0,48.0
0.006,17,2,136,1,60,0.0,32.0,32.0,1,76,0.0,48.0,48.0
291.292,6,312,344006,118,17691,2489.0,2736.0,889.0,194,326315,1509.0,2804.0,1756.0
0.005,6,10,2006,5,927,1.0,659.0,659.0,5,1079,1.0,811.0,811.0
0.068,6,10,1506,5,395,14.0,127.0,127.0,5,1111,13.0,843.0,843.0
0.004,6,10,1702,5,863,0.0,595.0,595.0,5,839,1.0,571.0,571.0
0.015,6,14,3787,7,497,2.0,125.0,125.0,7,3290,2.0,1448.0,972.0
0.118,6,10,1506,5,395,25.0,127.0,127.0,5,1111,26.0,843.0,843.0
0.015,6,10,1989,5,910,3.0,642.0,642.0,5,1079,3.0,811.0,811.0
0.005,17,2,230,1,68,0.0,40.0,40.0,1,162,0.0,134.0,134.0
0.006,17,2,179,1,71,0.0,43.0,43.0,1,108,0.0,80.0,80.0
0.011,6,10,1631,5,848,2.0,580.0,580.0,5,783,2.0,515.0,515.0
0.006,6,10,1547,5,764,1.0,496.0,496.0,5,783,1.0,515.0,515.0
0.009,6,10,1990,5,911,2.0,643.0,643.0,5,1079,2.0,811.0,811.0
0.104,6,10,1506,5,395,25.0,127.0,127.0,5,1111,19.0,843.0,843.0
0.009,6,10,1990,5,911,2.0,643.0,643.0,5,1079,2.0,811.0,811.0
0.004,17,4,284,2,120,1.0,32.0,32.0,2,164,1.0,60.0,54.0
0.075,6,10,1506,5,395,17.0,127.0,127.0,5,1111,17.0,843.0,843.0
0.082,6,10,1506,5,395,17.0,127.0,127.0,5,1111,18.0,843.0,843.0
0.003,17,2,136,1,60,0.0,32.0,32.0,1,76,0.0,48.0,48.0
0.012,6,10,1677,5,827,2.0,559.0,559.0,5,850,3.0,582.0,582.0
0.095,6,10,1506,5,395,20.0,127.0,127.0,5,1111,22.0,843.0,843.0
0.096,6,10,1506,5,395,21.0,127.0,127.0,5,1111,22.0,843.0,843.0
240.093,6,32,9529,16,6997,16006.0,2070.0,685.0,16,2532,16006.0,580.0,211.0
40.053,17,10,676,5,460,10012.0,104.0,64.0,5,216,10012.0,20.0,15.0
0.011,6,10,1990,5,911,2.0,643.0,643.0,5,1079,2.0,811.0,811.0
0.008,6,10,1990,5,911,2.0,643.0,643.0,5,1079,2.0,811.0,811.0
240.028,6,9,787,5,488,60007.0,232.0,232.0,4,299,80008.0,83.0,83.0
0.009,6,10,1990,5,911,2.0,643.0,643.0,5,1079,2.0,811.0,811.0
0.014,6,10,1972,5,910,3.0,642.0,642.0,5,1062,3.0,794.0,794.0
0.027,6,10,1990,5,911,6.0,643.0,643.0,5,1079,6.0,811.0,811.0
0.095,6,10,1506,5,395,18.0,127.0,127.0,5,1111,20.0,843.0,843.0
0.016,6,10,1989,5,910,4.0,642.0,642.0,5,1079,3.0,811.0,811.0
0.108,6,10,1506,5,395,23.0,127.0,127.0,5,1111,24.0,843.0,843.0
0.114,6,10,1506,5,395,26.0,127.0,127.0,5,1111,25.0,843.0,843.0
0.006,6,10,1689,5,839,1.0,571.0,571.0,5,850,1.0,582.0,582.0
0.009,6,10,1972,5,910,2.0,642.0,642.0,5,1062,2.0,794.0,794.0
0.005,6,10,2000,5,927,1.0,659.0,659.0,5,1073,1.0,805.0,805.0
0.01,6,10,1990,5,911,2.0,643.0,643.0,5,1079,2.0,811.0,811.0
0.104,6,10,1506,5,395,21.0,127.0,127.0,5,1111,25.0,843.0,843.0
0.008,6,10,1972,5,910,2.0,642.0,642.0,5,1062,2.0,794.0,794.0
0.005,6,10,2007,5,928,1.0,660.0,660.0,5,1079,1.0,811.0,811.0
0.041,17,4,352,2,130,1.0,37.0,37.0,2,222,37.0,89.0,83.0
0.006,17,2,230,1,68,0.0,40.0,40.0,1,162,0.0,134.0,134.0
0.01,6,10,1972,5,910,2.0,642.0,642.0,5,1062,2.0,794.0,794.0
0.071,17,4,284,2,120,0.0,32.0,32.0,2,164,67.0,60.0,54.0
0.1,6,10,1506,5,395,21.0,127.0,127.0,5,1111,23.0,843.0,843.0
0.005,17,2,164,1,74,0.0,46.0,46.0,1,90,0.0,62.0,62.0
0.013,6,10,1989,5,910,3.0,642.0,642.0,5,1079,3.0,811.0,811.0
0.114,6,10,1506,5,395,26.0,127.0,127.0,5,1111,22.0,843.0,843.0
240.122,6,30,9250,15,6807,17151.0,1930.0,670.0,15,2443,17151.0,580.0,236.0
0.021,6,13,3735,7,497,3.0,125.0,125.0,6,3238,4.0,1470.0,1459.0
0.107,6,10,1506,5,395,26.0,127.0,127.0,5,1111,23.0,843.0,843.0
0.004,6,10,1702,5,863,1.0,595.0,595.0,5,839,1.0,571.0,571.0
0.005,17,2,170,1,65,0.0,37.0,37.0,1,105,0.0,77.0,77.0
0.019,6,10,1989,5,910,4.0,642.0,642.0,5,1079,4.0,811.0,811.0
0.006,6,10,1854,5,889,1.0,621.0,621.0,5,965,1.0,697.0,697.0
0.005,6,10,1989,5,927,1.0,659.0,659.0,5,1062,1.0,794.0,794.0
0.05,6,13,3816,7,578,8.0,206.0,206.0,6,3238,10.0,1470.0,1459.0
66.11,6,28,18468,16,10516,4407.0,2804.0,1382.0,12,7952,5994.0,2323.0,1220.0
0.004,6,13,3747,7,509,0.0,137.0,137.0,6,3238,0.0,1470.0,1459.0
0.02,6,10,1983,5,910,4.0,642.0,642.0,5,1073,4.0,805.0,805.0
300.168,6,25,8108,13,1793,25013.0,815.0,277.0,12,6315,27287.0,1402.0,813.0
66.301,6,22,10140,12,3973,6027.0,1579.0,835.0,10,6167,7348.0,2111.0,939.0
0.115,6,10,1506,5,395,25.0,127.0,127.0,5,1111,27.0,843.0,843.0
0.007,6,10,1547,5,764,1.0,496.0,496.0,5,783,1.0,515.0,515.0
0.005,6,10,2007,5,928,1.0,660.0,660.0,5,1079,1.0,811.0,811.0
0.006,6,10,1989,5,927,1.0,659.0,659.0,5,1062,1.0,794.0,794.0
0.005,6,10,2006,5,927,1.0,659.0,659.0,5,1079,1.0,811.0,811.0
0.072,17,4,284,2,120,1.0,32.0,32.0,2,164,32.0,60.0,54.0
0.071,6,10,1506,5,395,15.0,127.0,127.0,5,1111,14.0,843.0,843.0
0.004,6,10,2007,5,928,1.0,660.0,660.0,5,1079,1.0,811.0,811.0
11.146,17,28,4398,14,2312,848.0,587.0,137.0,14,2086,848.0,269.0,121.0
0.042,17,2,170,1,65,0.0,37.0,37.0,1,105,0.0,77.0,77.0
0.006,6,10,1547,5,764,1.0,496.0,496.0,5,783,1.0,515.0,515.0
0.083,6,10,1506,5,395,18.0,127.0,127.0,5,1111,16.0,843.0,843.0
0.012,6,10,1989,5,910,2.0,642.0,642.0,5,1079,3.0,811.0,811.0
0.062,6,10,1506,5,395,14.0,127.0,127.0,5,1111,13.0,843.0,843.0
0.015,6,10,1983,5,910,3.0,642.0,642.0,5,1073,3.0,805.0,805.0
0.006,6,10,1547,5,764,1.0,496.0,496.0,5,783,1.0,515.0,515.0
0.011,6,13,3735,7,497,1.0,125.0,125.0,6,3238,2.0,1470.0,1459.0
0.006,6,10,1547,5,764,1.0,496.0,496.0,5,783,1.0,515.0,515.0
0.005,6,10,1774,5,923,1.0,655.0,655.0,5,851,1.0,583.0,583.0
0.005,6,10,2000,5,927,1.0,659.0,659.0,5,1073,1.0,805.0,805.0
0.013,17,2,152,1,56,0.0,28.0,28.0,1,96,0.0,68.0,68.0
40.073,17,10,676,5,460,10016.0,104.0,64.0,5,216,10017.0,20.0,15.0
52.107,6,321,344950,125,18058,420.0,2736.0,825.0,196,326892,267.0,2804.0,1730.0
0.016,6,10,1983,5,910,4.0,642.0,642.0,5,1073,4.0,805.0,805.0
0.004,6,10,2000,5,927,1.0,659.0,659.0,5,1073,1.0,805.0,805.0
0.016,6,10,1989,5,910,4.0,642.0,642.0,5,1079,4.0,811.0,811.0
0.013,6,10,1990,5,911,3.0,643.0,643.0,5,1079,3.0,811.0,811.0
0.082,6,10,1506,5,395,20.0,127.0,127.0,5,1111,18.0,843.0,843.0
0.005,6,10,2006,5,927,1.0,659.0,659.0,5,1079,1.0,811.0,811.0
1786.355,6,154,19574,92,13852,19630.0,302.0,302.0,62,5722,29284.0,83.0,83.0
0.005,6,14,3799,7,509,0.0,137.0,137.0,7,3290,0.0,1448.0,972.0
0.008,6,10,2007,5,928,2.0,660.0,660.0,5,1079,2.0,811.0,811.0
0.001,17,2,136,1,60,0.0,32.0,32.0,1,76,0.0,48.0,48.0
0.037,17,4,420,2,122,0.0,33.0,33.0,2,298,33.0,145.0,121.0
0.017,6,13,3735,7,497,2.0,125.0,125.0,6,3238,3.0,1470.0,1459.0
40.057,17,10,676,5,460,10013.0,104.0,64.0,5,216,10013.0,20.0,15.0
0.005,6,14,3736,7,446,0.0,74.0,74.0,7,3290,0.0,1448.0,972.0
0.004,17,4,284,2,120,1.0,32.0,32.0,2,164,0.0,60.0,54.0
0.005,6,10,1702,5,863,1.0,595.0,595.0,5,839,1.0,571.0,571.0
0.005,6,10,2007,5,928,1.0,660.0,660.0,5,1079,1.0,811.0,811.0
0.039,17,2,170,1,65,0.0,37.0,37.0,1,105,0.0,77.0,77.0
0.005,6,10,2006,5,927,1.0,659.0,659.0,5,1079,1.0,811.0,811.0
15.071,17,15,9238,8,6902,2148.0,1350.0,834.0,7,2336,2506.0,1350.0,305.0
0.007,6,10,1547,5,764,1.0,496.0,496.0,5,783,1.0,515.0,515.0
0.01,6,10,1762,5,911,2.0,643.0,643.0,5,851,2.0,583.0,583.0
0.088,6,10,1506,5,395,21.0,127.0,127.0,5,1111,17.0,843.0,843.0
0.001,17,2,180,1,66,0.0,38.0,38.0,1,114,0.0,86.0,86.0
0.001,17,2,180,1,66,0.0,38.0,38.0,1,114,0.0,86.0,86.0
0.22,6,16,2778,8,1396,31.0,533.0,324.0,8,1382,19.0,529.0,239.0
40.069,17,10,676,5,460,10014.0,104.0,64.0,5,216,10016.0,20.0,15.0
175.316,6,24,9399,11,1575,77.0,794.0,367.0,13,7824,14599.0,1360.0,810.0
0.138,6,10,1506,5,395,33.0,127.0,127.0,5,1111,33.0,843.0,843.0
1756.066,6,105,6270,60,3525,29763.0,27.0,27.0,45,2745,39909.0,27.0,27.0
0.001,17,2,136,1,60,0.0,32.0,32.0,1,76,0.0,48.0,48.0
0.005,6,10,1989,5,927,1.0,659.0,659.0,5,1062,1.0,794.0,794.0
0.078,6,10,1506,5,395,17.0,127.0,127.0,5,1111,16.0,843.0,843.0
0.005,6,10,1989,5,927,1.0,659.0,659.0,5,1062,1.0,794.0,794.0
0.011,6,10,1990,5,911,2.0,643.0,643.0,5,1079,2.0,811.0,811.0
0.005,17,2,179,1,71,0.0,43.0,43.0,1,108,0.0,80.0,80.0
0.012,6,10,1762,5,911,2.0,643.0,643.0,5,851,3.0,583.0,583.0
0.087,6,6,716,3,458,28.0,302.0,302.0,3,258,17.0,102.0,102.0
0.005,6,10,2006,5,927,1.0,659.0,659.0,5,1079,1.0,811.0,811.0
0.003,17,2,148,1,60,0.0,32.0,32.0,1,88,0.0,60.0,60.0
0.001,17,2,180,1,66,0.0,38.0,38.0,1,114,0.0,86.0,86.0
0.004,17,2,148,1,60,0.0,32.0,32.0,1,88,0.0,60.0,60.0
0.018,6,10,1990,5,911,4.0,643.0,643.0,5,1079,4.0,811.0,811.0
0.001,17,2,180,1,66,0.0,38.0,38.0,1,114,0.0,86.0,86.0
0.01,6,10,1990,5,911,2.0,643.0,643.0,5,1079,2.0,811.0,811.0
0.004,17,2,148,1,60,0.0,32.0,32.0,1,88,0.0,60.0,60.0
0.001,17,2,180,1,66,0.0,38.0,38.0,1,114,0.0,86.0,86.0
0.004,17,2,148,1,60,0.0,32.0,32.0,1,88,0.0,60.0,60.0
0.096,6,10,1506,5,395,20.0,127.0,127.0,5,1111,22.0,843.0,843.0
0.013,6,10,1989,5,910,3.0,642.0,642.0,5,1079,3.0,811.0,811.0
0.014,6,10,1983,5,910,3.0,642.0,642.0,5,1073,3.0,805.0,805.0
0.04,17,2,146,1,65,0.0,37.0,37.0,1,81,0.0,53.0,53.0
0.028,6,10,1972,5,910,7.0,642.0,642.0,5,1062,7.0,794.0,794.0
0.005,17,4,284,2,120,0.0,32.0,32.0,2,164,1.0,60.0,54.0
0.009,6,10,2006,5,927,2.0,659.0,659.0,5,1079,2.0,811.0,811.0
0.001,17,2,174,1,72,0.0,44.0,44.0,1,102,0.0,74.0,74.0
0.014,6,10,1989,5,910,3.0,642.0,642.0,5,1079,3.0,811.0,811.0
0.005,6,10,1854,5,889,1.0,621.0,621.0,5,965,1.0,697.0,697.0
0.001,17,2,180,1,66,0.0,38.0,38.0,1,114,0.0,86.0,86.0
0.006,17,2,214,1,75,0.0,47.0,47.0,1,139,0.0,111.0,111.0
0.039,17,2,148,1,60,0.0,32.0,32.0,1,88,0.0,60.0,60.0
0.013,6,10,1983,5,910,3.0,642.0,642.0,5,1073,3.0,805.0,805.0
0.081,6,10,1506,5,395,18.0,127.0,127.0,5,1111,18.0,843.0,843.0
0.004,6,10,1702,5,863,1.0,595.0,595.0,5,839,1.0,571.0,571.0
0.004,6,10,2006,5,927,1.0,659.0,659.0,5,1079,1.0,811.0,811.0
0.067,6,10,1506,5,395,16.0,127.0,127.0,5,1111,14.0,843.0,843.0
0.01,6,10,1762,5,911,2.0,643.0,643.0,5,851,2.0,583.0,583.0
0.005,6,10,2006,5,927,1.0,659.0,659.0,5,1079,1.0,811.0,811.0
0.004,6,10,1702,5,863,0.0,595.0,595.0,5,839,1.0,571.0,571.0
0.01,6,10,1983,5,910,2.0,642.0,642.0,5,1073,2.0,805.0,805.0
0.011,6,13,3735,7,497,1.0,125.0,125.0,6,3238,2.0,1470.0,1459.0
241.302,6,314,343507,124,17954,1961.0,2736.0,885.0,190,325553,1276.0,2769.0,1753.0
0.004,6,10,2007,5,928,1.0,660.0,660.0,5,1079,1.0,811.0,811.0
0.078,6,10,1506,5,395,18.0,127.0,127.0,5,1111,16.0,843.0,843.0
0.011,6,10,1983,5,910,2.0,642.0,642.0,5,1073,2.0,805.0,805.0
0.006,6,10,1547,5,764,1.0,496.0,496.0,5,783,1.0,515.0,515.0
0.005,17,2,213,1,69,0.0,41.0,41.0,1,144,0.0,116.0,116.0
0.009,6,10,1989,5,910,2.0,642.0,642.0,5,1079,2.0,811.0,811.0
0.011,6,10,1983,5,910,2.0,642.0,642.0,5,1073,2.0,805.0,805.0
0.113,6,10,1506,5,395,25.0,127.0,127.0,5,1111,23.0,843.0,843.0
0.037,17,2,136,1,60,0.0,32.0,32.0,1,76,0.0,48.0,48.0
0.002,17,2,180,1,66,0.0,38.0,38.0,1,114,0.0,86.0,86.0
0.004,6,10,1702,5,863,1.0,595.0,595.0,5,839,1.0,571.0,571.0
0.249,6,10,1506,5,395,24.0,127.0,127.0,5,1111,60.0,843.0,843.0
0.003,17,4,284,2,120,0.0,32.0,32.0,2,164,0.0,60.0,54.0
0.009,6,10,1983,5,910,2.0,642.0,642.0,5,1073,2.0,805.0,805.0
0.124,6,10,1506,5,395,29.0,127.0,127.0,5,1111,29.0,843.0,843.0
0.005,6,10,2000,5,927,1.0,659.0,659.0,5,1073,1.0,805.0,805.0
0.001,17,2,180,1,65,0.0,37.0,37.0,1,115,0.0,87.0,87.0
40.062,17,10,676,5,460,10013.0,104.0,64.0,5,216,10014.0,20.0,15.0
352.499,6,20,2210,6,1308,12005.0,494.0,494.0,14,902,27115.0,83.0,83.0
0.018,6,10,1989,5,910,4.0,642.0,642.0,5,1079,4.0,811.0,811.0
0.014,6,10,1983,5,910,3.0,642.0,642.0,5,1073,3.0,805.0,805.0
0.013,6,10,1989,5,910,3.0,642.0,642.0,5,1079,3.0,811.0,811.0
0.009,6,10,1677,5,827,2.0,559.0,559.0,5,850,2.0,582.0,582.0
0.004,6,10,1702,5,863,0.0,595.0,595.0,5,839,1.0,571.0,571.0
0.013,6,10,1972,5,910,3.0,642.0,642.0,5,1062,3.0,794.0,794.0
0.127,6,10,1506,5,395,31.0,127.0,127.0,5,1111,30.0,843.0,843.0
0.01,6,13,3747,7,509,1.0,137.0,137.0,6,3238,1.0,1470.0,1459.0
0.015,6,10,1989,5,910,3.0,642.0,642.0,5,1079,3.0,811.0,811.0
0.004,6,10,1702,5,863,0.0,595.0,595.0,5,839,1.0,571.0,571.0
240.098,6,29,9338,15,6880,17149.0,2005.0,678.0,14,2458,18468.0,580.0,246.0
0.016,6,10,1989,5,910,4.0,642.0,642.0,5,1079,3.0,811.0,811.0
0.003,17,2,148,1,60,0.0,32.0,32.0,1,88,0.0,60.0,60.0
0.004,17,2,136,1,60,0.0,32.0,32.0,1,76,0.0,48.0,48.0
0.005,6,10,2000,5,927,1.0,659.0,659.0,5,1073,1.0,805.0,805.0
0.01,6,10,1990,5,911,2.0,643.0,643.0,5,1079,2.0,811.0,811.0
0.014,6,10,1989,5,910,3.0,642.0,642.0,5,1079,3.0,811.0,811.0
0.744,6,25,5555,12,1445,56.0,267.0,136.0,13,4110,51.0,1414.0,597.0
0.005,17,2,144,1,64,0.0,36.0,36.0,1,80,0.0,52.0,52.0
1798.777,17,2927,224070,1453,117768,1238.0,84.0,53.0,1474,106302,1221.0,227.0,44.0
0.012,6,10,1990,5,911,3.0,643.0,643.0,5,1079,3.0,811.0,811.0
0.009,6,10,1972,5,910,2.0,642.0,642.0,5,1062,2.0,794.0,794.0
0.073,6,10,1506,5,395,14.0,127.0,127.0,5,1111,14.0,843.0,843.0
0.012,6,14,3787,7,497,1.0,125.0,125.0,7,3290,1.0,1448.0,972.0
0.01,6,10,1990,5,911,2.0,643.0,643.0,5,1079,2.0,811.0,811.0
0.004,6,10,1779,5,928,1.0,660.0,660.0,5,851,0.0,583.0,583.0
0.126,17,4,284,2,120,0.0,32.0,32.0,2,164,123.0,60.0,54.0
0.011,6,10,2000,5,927,2.0,659.0,659.0,5,1073,2.0,805.0,805.0
0.004,6,10,1774,5,923,1.0,655.0,655.0,5,851,1.0,583.0,583.0
0.09,6,10,1506,5,395,18.0,127.0,127.0,5,1111,18.0,843.0,843.0
0.013,6,10,1990,5,911,3.0,643.0,643.0,5,1079,3.0,811.0,811.0
0.012,6,10,1983,5,910,3.0,642.0,642.0,5,1073,2.0,805.0,805.0
0.005,6,10,1989,5,927,1.0,659.0,659.0,5,1062,1.0,794.0,794.0
0.014,6,10,1677,5,827,3.0,559.0,559.0,5,850,3.0,582.0,582.0
312.77,17,20,1124,10,716,34737.0,48.0,43.0,10,408,34737.0,20.0,12.0
0.009,6,10,1989,5,910,2.0,642.0,642.0,5,1079,2.0,811.0,811.0
0.005,6,10,2007,5,928,1.0,660.0,660.0,5,1079,1.0,811.0,811.0
0.005,6,10,1689,5,839,1.0,571.0,571.0,5,850,1.0,582.0,582.0
0.011,6,10,1990,5,911,2.0,643.0,643.0,5,1079,2.0,811.0,811.0
0.071,6,10,1506,5,395,16.0,127.0,127.0,5,1111,15.0,843.0,843.0
40.075,17,10,676,5,460,10017.0,104.0,64.0,5,216,10017.0,20.0,15.0
0.021,6,10,1989,5,910,5.0,642.0,642.0,5,1079,5.0,811.0,811.0
0.068,17,8,3613,4,1874,22.0,1350.0,440.0,4,1739,11.0,1350.0,406.0
0.009,6,13,3735,7,497,1.0,125.0,125.0,6,3238,1.0,1470.0,1459.0
0.007,17,2,179,1,71,0.0,43.0,43.0,1,108,0.0,80.0,80.0
0.01,6,10,1983,5,910,2.0,642.0,642.0,5,1073,2.0,805.0,805.0
0.009,6,13,3735,7,497,1.0,125.0,125.0,6,3238,1.0,1470.0,1459.0
0.005,6,10,2000,5,927,1.0,659.0,659.0,5,1073,1.0,805.0,805.0
0.005,6,10,1547,5,764,1.0,496.0,496.0,5,783,1.0,515.0,515.0
0.016,6,10,1989,5,910,3.0,642.0,642.0,5,1079,4.0,811.0,811.0
0.001,17,2,180,1,66,0.0,38.0,38.0,1,114,0.0,86.0,86.0
0.012,6,10,1972,5,910,2.0,642.0,642.0,5,1062,3.0,794.0,794.0
0.005,6,10,1989,5,927,1.0,659.0,659.0,5,1062,1.0,794.0,794.0
0.01,6,10,1972,5,910,2.0,642.0,642.0,5,1062,2.0,794.0,794.0
0.006,6,10,1547,5,764,1.0,496.0,496.0,5,783,1.0,515.0,515.0
0.132,17,2,80,1,32,0.0,4.0,4.0,1,48,0.0,20.0,20.0
0.005,17,2,214,1,75,0.0,47.0,47.0,1,139,0.0,111.0,111.0
0.006,6,10,1547,5,764,1.0,496.0,496.0,5,783,1.0,515.0,515.0
240.018,6,9,787,5,488,60004.0,232.0,232.0,4,299,80002.0,83.0,83.0
0.01,6,13,3735,7,497,1.0,125.0,125.0,6,3238,1.0,1470.0,1459.0
0.117,6,10,1506,5,395,26.0,127.0,127.0,5,1111,26.0,843.0,843.0
0.013,6,10,1972,5,910,3.0,642.0,642.0,5,1062,3.0,794.0,794.0
0.005,6,10,2000,5,927,1.0,659.0,659.0,5,1073,1.0,805.0,805.0
0.061,6,10,1506,5,395,13.0,127.0,127.0,5,1111,14.0,843.0,843.0
0.016,6,10,1762,5,911,3.0,643.0,643.0,5,851,3.0,583.0,583.0
0.001,17,2,166,1,75,0.0,47.0,47.0,1,91,0.0,63.0,63.0
0.127,6,10,1506,5,395,26.0,127.0,127.0,5,1111,25.0,843.0,843.0
0.008,6,10,1983,5,910,2.0,642.0,642.0,5,1073,2.0,805.0,805.0
0.005,6,10,1854,5,889,1.0,621.0,621.0,5,965,1.0,697.0,697.0
0.006,6,10,1547,5,764,1.0,496.0,496.0,5,783,1.0,515.0,515.0
0.007,6,10,1989,5,927,1.0,659.0,659.0,5,1062,1.0,794.0,794.0
308.365,17,20,1124,10,716,34256.0,48.0,43.0,10,408,34256.0,20.0,12.0
0.078,6,10,1506,5,395,19.0,127.0,127.0,5,1111,18.0,843.0,843.0
40.052,17,10,676,5,460,10011.0,104.0,64.0,5,216,10009.0,20.0,15.0
0.011,6,10,1972,5,910,2.0,642.0,642.0,5,1062,2.0,794.0,794.0
308.71,17,20,1124,10,716,34287.0,48.0,43.0,10,408,34285.0,20.0,12.0
0.013,6,10,1990,5,911,3.0,643.0,643.0,5,1079,3.0,811.0,811.0
40.058,17,10,676,5,460,10013.0,104.0,64.0,5,216,10013.0,20.0,15.0
0.006,6,10,1547,5,764,1.0,496.0,496.0,5,783,1.0,515.0,515.0
0.004,17,2,136,1,60,0.0,32.0,32.0,1,76,0.0,48.0,48.0
0.005,6,10,2007,5,928,1.0,660.0,660.0,5,1079,1.0,811.0,811.0
0.005,6,10,1989,5,927,1.0,659.0,659.0,5,1062,1.0,794.0,794.0
0.006,6,10,1854,5,889,1.0,621.0,621.0,5,965,1.0,697.0,697.0
0.011,6,10,1983,5,910,2.0,642.0,642.0,5,1073,2.0,805.0,805.0
0.039,17,2,234,1,61,0.0,33.0,33.0,1,173,0.0,145.0,145.0
0.001,17,2,140,1,62,0.0,34.0,34.0,1,78,0.0,50.0,50.0
0.008,6,10,1990,5,911,2.0,643.0,643.0,5,1079,2.0,811.0,811.0
0.006,6,10,1547,5,764,1.0,496.0,496.0,5,783,1.0,515.0,515.0
0.007,17,2,179,1,71,0.0,43.0,43.0,1,108,0.0,80.0,80.0
0.004,6,10,2006,5,927,1.0,659.0,659.0,5,1079,1.0,811.0,811.0
0.011,6,10,1631,5,848,2.0,580.0,580.0,5,783,2.0,515.0,515.0
0.015,6,10,1972,5,910,3.0,642.0,642.0,5,1062,3.0,794.0,794.0
0.015,6,14,3787,7,497,2.0,125.0,125.0,7,3290,2.0,1448.0,972.0
0.001,17,2,180,1,66,0.0,38.0,38.0,1,114,0.0,86.0,86.0
0.005,6,10,2007,5,928,1.0,660.0,660.0,5,1079,1.0,811.0,811.0
0.006,6,10,1643,5,860,1.0,592.0,592.0,5,783,1.0,515.0,515.0
0.005,6,10,1689,5,839,1.0,571.0,571.0,5,850,1.0,582.0,582.0
0.007,17,2,179,1,71,0.0,43.0,43.0,1,108,0.0,80.0,80.0
240.359,6,39,5036,19,2364,13353.0,581.0,195.0,20,2672,12650.0,566.0,203.0
308.31,17,20,1124,10,716,34241.0,48.0,43.0,10,408,34241.0,20.0,12.0
1.007,6,12,3134,6,2099,151.0,1328.0,923.0,6,1035,151.0,791.0,791.0
66.75,58,5,360,4,288,22250.0,24.0,24.0,1,72,0.0,24.0,24.0
0.008,6,10,1677,5,827,2.0,559.0,559.0,5,850,1.0,582.0,582.0
40.049,17,10,676,5,460,10010.0,104.0,64.0,5,216,10011.0,20.0,15.0
0.005,6,10,1989,5,927,1.0,659.0,659.0,5,1062,1.0,794.0,794.0
0.01,6,10,1762,5,911,2.0,643.0,643.0,5,851,2.0,583.0,583.0
10.991,17,28,4370,14,2311,837.0,586.0,137.0,14,2059,837.0,270.0,119.0
0.125,6,10,1506,5,395,29.0,127.0,127.0,5,1111,26.0,843.0,843.0
40.053,17,10,676,5,460,10012.0,104.0,64.0,5,216,10012.0,20.0,15.0
0.006,6,10,1643,5,860,1.0,592.0,592.0,5,783,1.0,515.0,515.0
0.008,6,12,1926,6,1189,1.0,659.0,434.0,6,737,1.0,417.0,417.0
0.012,6,10,1990,5,911,3.0,643.0,643.0,5,1079,3.0,811.0,811.0
0.013,6,10,1989,5,910,3.0,642.0,642.0,5,1079,3.0,811.0,811.0
300.342,6,16,2170,9,684,37522.0,146.0,146.0,7,1486,50028.0,419.0,398.0
0.005,6,15,3794,8,504,0.0,80.0,80.0,7,3290,0.0,1448.0,972.0
0.005,6,10,2006,5,927,1.0,659.0,659.0,5,1079,1.0,811.0,811.0
0.006,6,10,1547,5,764,1.0,496.0,496.0,5,783,1.0,515.0,515.0
0.022,6,10,1983,5,910,5.0,642.0,642.0,5,1073,5.0,805.0,805.0
0.006,17,2,179,1,71,0.0,43.0,43.0,1,108,0.0,80.0,80.0
40.057,17,10,676,5,460,10012.0,104.0,64.0,5,216,10012.0,20.0,15.0
0.005,6,10,2006,5,927,1.0,659.0,659.0,5,1079,1.0,811.0,811.0
0.105,6,10,1506,5,395,24.0,127.0,127.0,5,1111,25.0,843.0,843.0
0.006,17,2,230,1,68,0.0,40.0,40.0,1,162,0.0,134.0,134.0
0.009,6,13,3735,7,497,1.0,125.0,125.0,6,3238,1.0,1470.0,1459.0
40.083,17,10,676,5,460,10020.0,104.0,64.0,5,216,10019.0,20.0,15.0
0.774,6,22,5072,11,1250,66.0,325.0,133.0,11,3822,66.0,1414.0,563.0
1730.396,6,47,2913,31,1777,57679.0,35.0,35.0,16,1136,115354.0,31.0,31.0
0.001,17,2,180,1,66,0.0,38.0,38.0,1,114,0.0,86.0,86.0
40.053,17,10,676,5,460,10012.0,104.0,64.0,5,216,10012.0,20.0,15.0
0.01,6,13,3735,7,497,1.0,125.0,125.0,6,3238,1.0,1470.0,1459.0
0.009,6,10,1990,5,911,2.0,643.0,643.0,5,1079,2.0,811.0,811.0
0.017,6,10,1762,5,911,4.0,643.0,643.0,5,851,4.0,583.0,583.0
0.073,6,10,1506,5,395,16.0,127.0,127.0,5,1111,17.0,843.0,843.0
0.011,6,10,1631,5,848,2.0,580.0,580.0,5,783,2.0,515.0,515.0
0.007,6,10,1990,5,911,1.0,643.0,643.0,5,1079,1.0,811.0,811.0
0.008,17,2,194,1,59,0.0,31.0,31.0,1,135,0.0,107.0,107.0
0.06,6,10,1506,5,395,13.0,127.0,127.0,5,1111,14.0,843.0,843.0
0.004,17,2,164,1,74,0.0,46.0,46.0,1,90,0.0,62.0,62.0
0.321,17,41,23006,22,18407,15.0,1350.0,808.0,19,4599,14.0,1350.0,214.0
10.734,17,28,4421,14,1993,817.0,268.0,114.0,14,2428,817.0,587.0,145.0
565.445,6,41,15346,20,4037,29760.0,676.0,427.0,21,11309,25270.0,1402.0,785.0
0.004,6,10,2007,5,928,1.0,660.0,660.0,5,1079,1.0,811.0,811.0
0.004,6,10,1989,5,927,1.0,659.0,659.0,5,1062,1.0,794.0,794.0
0.005,6,10,2006,5,927,1.0,659.0,659.0,5,1079,1.0,811.0,811.0
0.004,6,10,1989,5,927,1.0,659.0,659.0,5,1062,1.0,794.0,794.0
0.016,6,10,1989,5,910,3.0,642.0,642.0,5,1079,3.0,811.0,811.0
0.017,6,10,1990,5,911,4.0,643.0,643.0,5,1079,4.0,811.0,811.0
0.005,6,10,1689,5,839,1.0,571.0,571.0,5,850,1.0,582.0,582.0
0.18,6,10,1506,5,395,36.0,127.0,127.0,5,1111,40.0,843.0,843.0
0.006,17,2,170,1,65,0.0,37.0,37.0,1,105,0.0,77.0,77.0
0.004,6,10,2000,5,927,1.0,659.0,659.0,5,1073,1.0,805.0,805.0
0.1,6,10,1506,5,395,22.0,127.0,127.0,5,1111,18.0,843.0,843.0
0.005,17,2,168,1,76,0.0,48.0,48.0,1,92,0.0,64.0,64.0
0.01,6,10,1631,5,848,2.0,580.0,580.0,5,783,2.0,515.0,515.0
0.005,6,10,2006,5,927,1.0,659.0,659.0,5,1079,1.0,811.0,811.0
0.066,6,10,1506,5,395,14.0,127.0,127.0,5,1111,14.0,843.0,843.0
0.009,6,10,1677,5,827,2.0,559.0,559.0,5,850,2.0,582.0,582.0
0.004,6,10,2000,5,927,1.0,659.0,659.0,5,1073,1.0,805.0,805.0
0.007,17,2,179,1,71,0.0,43.0,43.0,1,108,0.0,80.0,80.0
0.013,6,10,1989,5,910,3.0,642.0,642.0,5,1079,3.0,811.0,811.0
0.001,17,2,180,1,66,0.0,38.0,38.0,1,114,0.0,86.0,86.0
1756.309,6,107,6374,60,3525,29767.0,27.0,27.0,47,2849,38179.0,27.0,27.0
0.005,6,13,3747,7,509,0.0,137.0,137.0,6,3238,1.0,1470.0,1459.0
0.059,6,10,1972,5,910,14.0,642.0,642.0,5,1062,14.0,794.0,794.0
0.005,6,10,2006,5,927,1.0,659.0,659.0,5,1079,1.0,811.0,811.0
0.011,6,10,1762,5,911,2.0,643.0,643.0,5,851,2.0,583.0,583.0
0.164,17,2,152,1,76,0.0,48.0,48.0,1,76,0.0,48.0,48.0
0.126,17,2,182,1,65,0.0,37.0,37.0,1,117,0.0,89.0,89.0
40.083,6,70,31789,37,3553,1113.0,802.0,179.0,33,28236,1252.0,2092.0,1020.0
240.035,6,9,787,5,488,60008.0,232.0,232.0,4,299,80002.0,83.0,83.0
0.12,6,24,6480,11,2285,10.0,746.0,341.0,13,4195,9.0,1324.0,585.0
0.015,6,10,1631,5,848,3.0,580.0,580.0,5,783,3.0,515.0,515.0
0.006,17,2,299,1,65,0.0,37.0,37.0,1,234,0.0,206.0,206.0
0.005,6,10,2006,5,927,1.0,659.0,659.0,5,1079,1.0,811.0,811.0
0.041,17,2,152,1,76,0.0,48.0,48.0,1,76,0.0,48.0,48.0
1781.235,6,64,7358,42,4484,43444.0,1640.0,109.0,22,2874,84811.0,1110.0,82.0
0.009,6,10,1983,5,910,2.0,642.0,642.0,5,1073,2.0,805.0,805.0
0.005,6,10,1547,5,764,1.0,496.0,496.0,5,783,1.0,515.0,515.0
168.107,17,72,10384,36,2415,4802.0,44.0,39.0,36,7969,4802.0,252.0,193.0
40.059,17,10,676,5,460,10013.0,104.0,64.0,5,216,10014.0,20.0,15.0
354.056,6,19,1691,15,978,25289.0,190.0,190.0,4,713,80002.0,497.0,497.0
0.012,6,10,1989,5,910,3.0,642.0,642.0,5,1079,3.0,811.0,811.0
0.007,17,2,144,1,64,0.0,36.0,36.0,1,80,0.0,52.0,52.0
354.015,6,21,1795,16,1030,23601.0,190.0,190.0,5,765,60002.0,464.0,248.0
0.009,6,10,1762,5,911,2.0,643.0,643.0,5,851,2.0,583.0,583.0
0.003,17,2,148,1,60,0.0,32.0,32.0,1,88,0.0,60.0,60.0
0.709,6,22,5072,11,1250,60.0,325.0,133.0,11,3822,59.0,1414.0,563.0
0.018,6,10,1983,5,910,4.0,642.0,642.0,5,1073,4.0,805.0,805.0
0.005,6,10,2000,5,927,1.0,659.0,659.0,5,1073,1.0,805.0,805.0
0.004,6,10,1702,5,863,1.0,595.0,595.0,5,839,1.0,571.0,571.0
0.17,6,4,493,2,321,170.0,241.0,241.0,2,172,0.0,92.0,92.0
300.749,6,36,9700,19,4222,16708.0,1686.0,686.0,17,5478,537.0,2667.0,435.0
0.003,17,2,148,1,60,0.0,32.0,32.0,1,88,0.0,60.0,60.0
10.818,17,28,4422,14,1994,823.0,269.0,114.0,14,2428,823.0,587.0,145.0
0.005,6,10,1547,5,764,1.0,496.0,496.0,5,783,1.0,515.0,515.0
0.097,6,10,1506,5,395,21.0,127.0,127.0,5,1111,23.0,843.0,843.0
0.017,6,10,1972,5,910,4.0,642.0,642.0,5,1062,4.0,794.0,794.0
0.016,17,2,160,1,72,0.0,44.0,44.0,1,88,0.0,60.0,60.0
0.021,6,10,1989,5,910,5.0,642.0,642.0,5,1079,5.0,811.0,811.0
0.005,6,10,1702,5,863,1.0,595.0,595.0,5,839,1.0,571.0,571.0
0.022,6,9,1190,5,751,5.0,495.0,495.0,4,439,5.0,223.0,223.0
0.087,6,10,1506,5,395,20.0,127.0,127.0,5,1111,19.0,843.0,843.0
0.085,6,10,1506,5,395,18.0,127.0,127.0,5,1111,18.0,843.0,843.0
0.039,17,2,148,1,60,0.0,32.0,32.0,1,88,0.0,60.0,60.0
10.806,17,28,4421,14,1994,822.0,269.0,114.0,14,2427,822.0,586.0,145.0
0.004,6,10,2006,5,927,1.0,659.0,659.0,5,1079,1.0,811.0,811.0
125.997,6,14,2938,8,2504,17965.0,1414.0,1086.0,6,434,25151.0,182.0,182.0
0.005,6,10,2007,5,928,1.0,660.0,660.0,5,1079,1.0,811.0,811.0
0.005,6,10,2007,5,928,1.0,660.0,660.0,5,1079,1.0,811.0,811.0
0.004,17,2,148,1,60,0.0,32.0,32.0,1,88,0.0,60.0,60.0
0.012,6,10,1990,5,911,2.0,643.0,643.0,5,1079,3.0,811.0,811.0
40.054,17,10,676,5,460,10012.0,104.0,64.0,5,216,10012.0,20.0,15.0
0.014,6,10,1762,5,911,3.0,643.0,643.0,5,851,3.0,583.0,583.0
0.001,17,2,180,1,66,0.0,38.0,38.0,1,114,0.0,86.0,86.0
0.022,6,10,1989,5,910,5.0,642.0,642.0,5,1079,5.0,811.0,811.0
0.124,6,10,1506,5,395,27.0,127.0,127.0,5,1111,28.0,843.0,843.0
0.002,17,2,136,1,60,0.0,32.0,32.0,1,76,0.0,48.0,48.0
0.005,6,10,1547,5,764,1.0,496.0,496.0,5,783,1.0,515.0,515.0
40.063,17,10,676,5,460,10013.0,104.0,64.0,5,216,10015.0,20.0,15.0
0.001,17,2,180,1,66,0.0,38.0,38.0,1,114,0.0,86.0,86.0
0.009,6,10,1990,5,911,2.0,643.0,643.0,5,1079,2.0,811.0,811.0
0.009,6,12,1926,6,1189,1.0,659.0,434.0,6,737,1.0,417.0,417.0
0.005,17,2,170,1,65,0.0,37.0,37.0,1,105,0.0,77.0,77.0
0.015,6,10,1989,5,910,3.0,642.0,642.0,5,1079,3.0,811.0,811.0
10.823,17,28,4422,14,1994,822.0,269.0,114.0,14,2428,824.0,587.0,145.0
0.021,6,10,1989,5,910,5.0,642.0,642.0,5,1079,5.0,811.0,811.0
369.794,6,22,2313,16,867,24652.0,195.0,195.0,6,1446,4646.0,419.0,398.0
0.038,17,2,182,1,65,0.0,37.0,37.0,1,117,0.0,89.0,89.0
0.005,6,10,1779,5,928,1.0,660.0,660.0,5,851,1.0,583.0,583.0
0.015,6,10,1972,5,910,3.0,642.0,642.0,5,1062,3.0,794.0,794.0
0.079,6,10,1506,5,395,17.0,127.0,127.0,5,1111,17.0,843.0,843.0
0.127,6,10,1506,5,395,29.0,127.0,127.0,5,1111,26.0,843.0,843.0
0.02,6,10,1989,5,910,5.0,642.0,642.0,5,1079,5.0,811.0,811.0
0.007,17,2,132,1,58,0.0,30.0,30.0,1,74,0.0,46.0,46.0
0.005,6,10,2007,5,928,1.0,660.0,660.0,5,1079,1.0,811.0,811.0
0.005,6,10,1989,5,927,1.0,659.0,659.0,5,1062,1.0,794.0,794.0
0.007,6,10,1983,5,910,1.0,642.0,642.0,5,1073,1.0,805.0,805.0
177.2,17,80,11022,40,2685,4543.0,44.0,39.0,40,8337,4543.0,239.0,180.0
46.865,6,453,404583,228,388037,87.0,4080.0,1952.0,225,16546,208.0,2667.0,215.0
0.016,17,2,198,1,91,0.0,63.0,63.0,1,107,0.0,79.0,79.0
0.005,6,10,1989,5,927,1.0,659.0,659.0,5,1062,1.0,794.0,794.0
0.004,17,2,136,1,60,0.0,32.0,32.0,1,76,0.0,48.0,48.0
0.059,6,10,1990,5,911,14.0,643.0,643.0,5,1079,14.0,811.0,811.0
0.004,6,10,1779,5,928,1.0,660.0,660.0,5,851,1.0,583.0,583.0
0.018,6,10,1990,5,911,4.0,643.0,643.0,5,1079,4.0,811.0,811.0
0.04,17,2,144,1,64,0.0,36.0,36.0,1,80,0.0,52.0,52.0
0.138,6,10,1506,5,395,33.0,127.0,127.0,5,1111,30.0,843.0,843.0
0.011,6,10,1762,5,911,2.0,643.0,643.0,5,851,2.0,583.0,583.0
0.005,17,2,164,1,74,0.0,46.0,46.0,1,90,0.0,62.0,62.0
0.012,6,10,1989,5,910,2.0,642.0,642.0,5,1079,3.0,811.0,811.0
0.015,6,10,1989,5,910,3.0,642.0,642.0,5,1079,3.0,811.0,811.0
412.273,6,29,4409,12,3102,10911.0,494.0,494.0,17,1307,25766.0,83.0,83.0
0.008,6,10,2006,5,927,1.0,659.0,659.0,5,1079,2.0,811.0,811.0
0.067,6,10,1506,5,395,16.0,127.0,127.0,5,1111,14.0,843.0,843.0
0.005,6,10,1989,5,927,1.0,659.0,659.0,5,1062,1.0,794.0,794.0
0.075,6,10,1506,5,395,16.0,127.0,127.0,5,1111,15.0,843.0,843.0
0.81,6,14,5367,8,4933,115.0,2828.0,1533.0,6,434,113.0,182.0,182.0
0.008,6,10,1972,5,910,1.0,642.0,642.0,5,1062,2.0,794.0,794.0
0.008,6,10,1983,5,910,2.0,642.0,642.0,5,1073,1.0,805.0,805.0
0.005,6,10,2006,5,927,1.0,659.0,659.0,5,1079,1.0,811.0,811.0
0.012,6,10,1983,5,910,3.0,642.0,642.0,5,1073,3.0,805.0,805.0
0.005,17,2,140,1,62,0.0,34.0,34.0,1,78,0.0,50.0,50.0
0.003,17,2,185,1,73,0.0,45.0,45.0,1,112,0.0,84.0,84.0
175.089,17,76,10836,38,2521,4731.0,44.0,38.0,38,8315,4732.0,260.0,190.0
0.131,6,10,1506,5,395,29.0,127.0,127.0,5,1111,30.0,843.0,843.0
0.074,6,10,1506,5,395,15.0,127.0,127.0,5,1111,15.0,843.0,843.0
0.005,6,10,1989,5,927,1.0,659.0,659.0,5,1062,1.0,794.0,794.0
0.009,6,10,2000,5,927,2.0,659.0,659.0,5,1073,2.0,805.0,805.0
0.1,6,10,1506,5,395,22.0,127.0,127.0,5,1111,20.0,843.0,843.0
0.008,6,13,3735,7,497,1.0,125.0,125.0,6,3238,1.0,1470.0,1459.0
0.006,6,10,2007,5,928,1.0,660.0,660.0,5,1079,1.0,811.0,811.0
0.017,6,10,1989,5,910,4.0,642.0,642.0,5,1079,4.0,811.0,811.0
40.07,17,10,676,5,460,10014.0,104.0,64.0,5,216,10016.0,20.0,15.0
240.011,6,9,787,5,488,60002.0,232.0,232.0,4,299,80002.0,83.0,83.0
240.21,6,76,55378,43,3751,5719.0,1226.0,498.0,33,51627,7506.0,3021.0,1720.0
165.182,17,98,13525,49,3322,3441.0,44.0,39.0,49,10203,3441.0,239.0,180.0
240.092,6,16,4481,9,963,30011.0,238.0,166.0,7,3518,40014.0,1402.0,786.0
0.092,6,10,1506,5,395,19.0,127.0,127.0,5,1111,20.0,843.0,843.0
0.013,6,10,1972,5,910,3.0,642.0,642.0,5,1062,3.0,794.0,794.0
0.167,6,10,1506,5,395,39.0,127.0,127.0,5,1111,41.0,843.0,843.0
0.004,17,2,148,1,60,0.0,32.0,32.0,1,88,0.0,60.0,60.0
0.004,6,10,2000,5,927,1.0,659.0,659.0,5,1073,1.0,805.0,805.0
0.016,6,10,1990,5,911,3.0,643.0,643.0,5,1079,3.0,811.0,811.0
0.109,6,10,1506,5,395,24.0,127.0,127.0,5,1111,22.0,843.0,843.0
0.091,6,10,1506,5,395,20.0,127.0,127.0,5,1111,19.0,843.0,843.0
40.066,17,10,676,5,460,10014.0,104.0,64.0,5,216,10015.0,20.0,15.0
0.005,17,2,140,1,62,0.0,34.0,34.0,1,78,0.0,50.0,50.0
0.005,6,10,2007,5,928,1.0,660.0,660.0,5,1079,1.0,811.0,811.0
0.01,6,10,1990,5,911,2.0,643.0,643.0,5,1079,2.0,811.0,811.0
1793.815,6,310,98626,191,87269,9441.0,1963.0,672.0,119,11357,15201.0,452.0,70.0
0.005,6,10,2000,5,927,1.0,659.0,659.0,5,1073,1.0,805.0,805.0
0.006,6,10,1547,5,764,1.0,496.0,496.0,5,783,1.0,515.0,515.0
0.005,6,10,1989,5,927,1.0,659.0,659.0,5,1062,1.0,794.0,794.0
240.084,6,16,4482,9,963,30010.0,238.0,166.0,7,3519,40013.0,1402.0,786.0
173.14,17,78,11183,39,2609,4556.0,44.0,38.0,39,8574,4556.0,239.0,191.0
0.005,6,10,1547,5,764,1.0,496.0,496.0,5,783,1.0,515.0,515.0
0.162,6,10,1506,5,395,37.0,127.0,127.0,5,1111,32.0,843.0,843.0
0.071,17,8,3613,4,1874,23.0,1350.0,440.0,4,1739,11.0,1350.0,406.0
0.006,6,10,1547,5,764,1.0,496.0,496.0,5,783,1.0,515.0,515.0
0.003,17,2,208,1,72,0.0,44.0,44.0,1,136,0.0,108.0,108.0
0.005,6,10,2006,5,927,1.0,659.0,659.0,5,1079,1.0,811.0,811.0
0.022,6,10,1989,5,910,5.0,642.0,642.0,5,1079,5.0,811.0,811.0
0.008,6,13,3860,7,622,1.0,250.0,250.0,6,3238,1.0,1470.0,1459.0
0.018,17,2,198,1,91,0.0,63.0,63.0,1,107,0.0,79.0,79.0
0.004,17,4,284,2,120,0.0,32.0,32.0,2,164,0.0,60.0,54.0
308.41,17,20,1124,10,716,34253.0,48.0,43.0,10,408,34252.0,20.0,12.0
0.183,6,10,1506,5,395,26.0,127.0,127.0,5,1111,40.0,843.0,843.0
0.252,17,39,20193,21,17038,12.0,1350.0,783.0,18,3155,11.0,1350.0,147.0
300.326,6,16,2170,9,684,37520.0,146.0,146.0,7,1486,50027.0,419.0,398.0
40.053,17,10,676,5,460,10011.0,104.0,64.0,5,216,10009.0,20.0,15.0
0.004,17,4,284,2,120,0.0,32.0,32.0,2,164,0.0,60.0,54.0
0.014,6,10,1972,5,910,3.0,642.0,642.0,5,1062,3.0,794.0,794.0
0.004,17,2,136,1,60,0.0,32.0,32.0,1,76,0.0,48.0,48.0
1795.234,6,576,192654,294,165224,6127.0,2883.0,942.0,282,27430,6388.0,580.0,117.0
0.008,6,10,1972,5,910,1.0,642.0,642.0,5,1062,2.0,794.0,794.0
0.04,17,2,152,1,76,0.0,48.0,48.0,1,76,0.0,48.0,48.0
0.001,17,2,180,1,66,0.0,38.0,38.0,1,114,0.0,86.0,86.0
0.015,6,10,1983,5,910,3.0,642.0,642.0,5,1073,3.0,805.0,805.0
0.004,6,10,1702,5,863,0.0,595.0,595.0,5,839,1.0,571.0,571.0
0.078,6,10,1506,5,395,18.0,127.0,127.0,5,1111,18.0,843.0,843.0
0.005,6,10,2000,5,927,1.0,659.0,659.0,5,1073,1.0,805.0,805.0
0.008,6,10,1983,5,910,1.0,642.0,642.0,5,1073,1.0,805.0,805.0
1756.142,6,105,6270,60,3525,29764.0,27.0,27.0,45,2745,39911.0,27.0,27.0
0.094,6,10,1506,5,395,21.0,127.0,127.0,5,1111,20.0,843.0,843.0
0.11,6,10,1506,5,395,26.0,127.0,127.0,5,1111,25.0,843.0,843.0
0.004,6,10,2006,5,927,1.0,659.0,659.0,5,1079,1.0,811.0,811.0
1.249,6,32,13392,18,5893,73.0,2720.0,854.0,14,7499,82.0,2720.0,769.0
0.041,17,2,152,1,76,0.0,48.0,48.0,1,76,0.0,48.0,48.0
0.079,6,10,1506,5,395,18.0,127.0,127.0,5,1111,16.0,843.0,843.0
40.032,17,10,676,5,460,10006.0,104.0,64.0,5,216,10006.0,20.0,15.0
0.076,6,10,1506,5,395,16.0,127.0,127.0,5,1111,17.0,843.0,843.0
0.006,6,10,1547,5,764,1.0,496.0,496.0,5,783,1.0,515.0,515.0
326.732,6,19,2158,6,1308,12004.0,494.0,494.0,13,850,27227.0,83.0,83.0
0.009,6,10,1677,5,827,2.0,559.0,559.0,5,850,2.0,582.0,582.0
65.723,6,27,17740,15,9800,4694.0,2804.0,1502.0,12,7940,5959.0,2311.0,1218.0
0.004,17,2,154,1,69,0.0,41.0,41.0,1,85,0.0,57.0,57.0
0.005,6,10,1989,5,927,1.0,659.0,659.0,5,1062,1.0,794.0,794.0
0.104,6,10,1506,5,395,25.0,127.0,127.0,5,1111,21.0,843.0,843.0
0.006,6,10,1547,5,764,1.0,496.0,496.0,5,783,1.0,515.0,515.0
0.008,6,13,3735,7,497,1.0,125.0,125.0,6,3238,1.0,1470.0,1459.0
0.021,6,10,1972,5,910,5.0,642.0,642.0,5,1062,5.0,794.0,794.0
0.006,6,10,1643,5,860,1.0,592.0,592.0,5,783,1.0,515.0,515.0
0.004,6,10,1989,5,927,1.0,659.0,659.0,5,1062,1.0,794.0,794.0
240.103,6,16,4482,9,963,30012.0,238.0,166.0,7,3519,40016.0,1402.0,786.0
0.004,6,10,2007,5,928,1.0,660.0,660.0,5,1079,1.0,811.0,811.0
0.072,6,10,1506,5,395,17.0,127.0,127.0,5,1111,17.0,843.0,843.0
0.006,6,10,1547,5,764,1.0,496.0,496.0,5,783,1.0,515.0,515.0
300.335,6,16,2170,9,684,37520.0,146.0,146.0,7,1486,50027.0,419.0,398.0
0.007,6,10,1547,5,764,1.0,496.0,496.0,5,783,1.0,515.0,515.0
0.095,6,10,1506,5,395,18.0,127.0,127.0,5,1111,23.0,843.0,843.0
0.014,6,10,1989,5,910,3.0,642.0,642.0,5,1079,3.0,811.0,811.0
0.005,6,10,2000,5,927,1.0,659.0,659.0,5,1073,1.0,805.0,805.0
0.106,6,10,1506,5,395,22.0,127.0,127.0,5,1111,24.0,843.0,843.0
0.027,6,10,1990,5,911,6.0,643.0,643.0,5,1079,6.0,811.0,811.0
0.005,6,10,2007,5,928,1.0,660.0,660.0,5,1079,1.0,811.0,811.0
0.016,6,10,1990,5,911,3.0,643.0,643.0,5,1079,3.0,811.0,811.0
0.017,6,10,1989,5,910,4.0,642.0,642.0,5,1079,4.0,811.0,811.0
0.004,6,10,1779,5,928,1.0,660.0,660.0,5,851,1.0,583.0,583.0
0.008,6,10,1972,5,910,2.0,642.0,642.0,5,1062,2.0,794.0,794.0
0.0,17,2,179,1,62,0.0,34.0,34.0,1,117,0.0,89.0,89.0
1729.217,6,60,4400,40,2740,44338.0,33.0,33.0,20,1660,91002.0,31.0,31.0
0.005,6,10,1547,5,764,1.0,496.0,496.0,5,783,1.0,515.0,515.0
0.1,17,2,152,1,76,0.0,48.0,48.0,1,76,0.0,48.0,48.0
0.062,6,10,1506,5,395,14.0,127.0,127.0,5,1111,12.0,843.0,843.0
0.008,6,10,1762,5,911,2.0,643.0,643.0,5,851,2.0,583.0,583.0
0.009,6,10,1990,5,911,2.0,643.0,643.0,5,1079,2.0,811.0,811.0
40.065,17,10,676,5,460,10012.0,104.0,64.0,5,216,10015.0,20.0,15.0
0.06,17,2,80,1,32,0.0,4.0,4.0,1,48,0.0,20.0,20.0
0.001,17,2,180,1,66,0.0,38.0,38.0,1,114,0.0,86.0,86.0
0.014,6,10,1983,5,910,3.0,642.0,642.0,5,1073,3.0,805.0,805.0
0.014,6,10,1989,5,910,3.0,642.0,642.0,5,1079,3.0,811.0,811.0
10.782,17,28,4421,14,1994,821.0,269.0,114.0,14,2427,821.0,586.0,145.0
0.005,6,10,1643,5,860,1.0,592.0,592.0,5,783,1.0,515.0,515.0
0.005,6,10,1774,5,923,1.0,655.0,655.0,5,851,1.0,583.0,583.0
0.053,17,2,152,1,76,0.0,48.0,48.0,1,76,0.0,48.0,48.0
0.006,6,13,3690,7,452,0.0,80.0,80.0,6,3238,1.0,1470.0,1459.0
0.067,6,10,1506,5,395,14.0,127.0,127.0,5,1111,13.0,843.0,843.0
0.008,6,10,1972,5,910,2.0,642.0,642.0,5,1062,2.0,794.0,794.0
0.109,6,10,1506,5,395,25.0,127.0,127.0,5,1111,24.0,843.0,843.0
0.013,6,10,1989,5,910,3.0,642.0,642.0,5,1079,3.0,811.0,811.0
0.131,6,10,1506,5,395,28.0,127.0,127.0,5,1111,19.0,843.0,843.0
0.011,6,10,1972,5,910,2.0,642.0,642.0,5,1062,2.0,794.0,794.0
0.006,6,10,2006,5,927,1.0,659.0,659.0,5,1079,1.0,811.0,811.0
0.004,6,10,1774,5,923,1.0,655.0,655.0,5,851,1.0,583.0,583.0
40.064,17,10,676,5,460,10014.0,104.0,64.0,5,216,10015.0,20.0,15.0
0.005,6,10,2006,5,927,1.0,659.0,659.0,5,1079,1.0,811.0,811.0
0.107,6,10,1506,5,395,25.0,127.0,127.0,5,1111,25.0,843.0,843.0
0.004,17,4,284,2,120,0.0,32.0,32.0,2,164,0.0,60.0,54.0
0.005,6,10,1854,5,889,1.0,621.0,621.0,5,965,1.0,697.0,697.0
0.01,6,10,1989,5,910,2.0,642.0,642.0,5,1079,2.0,811.0,811.0
0.113,6,10,1506,5,395,24.0,127.0,127.0,5,1111,25.0,843.0,843.0
0.006,6,10,1689,5,839,1.0,571.0,571.0,5,850,1.0,582.0,582.0
0.112,6,10,1506,5,395,26.0,127.0,127.0,5,1111,24.0,843.0,843.0
0.037,17,2,152,1,76,0.0,48.0,48.0,1,76,0.0,48.0,48.0
0.012,6,10,1990,5,911,3.0,643.0,643.0,5,1079,3.0,811.0,811.0
0.005,6,10,1989,5,927,1.0,659.0,659.0,5,1062,1.0,794.0,794.0
0.004,6,10,2000,5,927,1.0,659.0,659.0,5,1073,1.0,805.0,805.0
0.016,6,10,1762,5,911,4.0,643.0,643.0,5,851,3.0,583.0,583.0
0.01,6,10,1989,5,910,2.0,642.0,642.0,5,1079,2.0,811.0,811.0
0.005,6,10,2006,5,927,1.0,659.0,659.0,5,1079,1.0,811.0,811.0
0.01,6,10,1989,5,910,2.0,642.0,642.0,5,1079,2.0,811.0,811.0
0.005,6,10,2006,5,927,1.0,659.0,659.0,5,1079,1.0,811.0,811.0
0.011,6,10,1990,5,911,2.0,643.0,643.0,5,1079,2.0,811.0,811.0
0.005,6,10,2007,5,928,1.0,660.0,660.0,5,1079,1.0,811.0,811.0
0.001,17,2,174,1,72,0.0,44.0,44.0,1,102,0.0,74.0,74.0
0.005,6,10,1989,5,927,1.0,659.0,659.0,5,1062,1.0,794.0,794.0
0.005,17,2,174,1,63,0.0,35.0,35.0,1,111,0.0,83.0,83.0
11.037,17,28,4396,14,2311,840.0,586.0,137.0,14,2085,840.0,268.0,120.0
0.006,6,10,1689,5,839,1.0,571.0,571.0,5,850,1.0,582.0,582.0
0.022,6,10,1990,5,911,5.0,643.0,643.0,5,1079,5.0,811.0,811.0
0.005,17,2,168,1,76,0.0,48.0,48.0,1,92,0.0,64.0,64.0
0.033,6,10,1972,5,910,8.0,642.0,642.0,5,1062,8.0,794.0,794.0
0.005,6,10,1547,5,764,1.0,496.0,496.0,5,783,1.0,515.0,515.0
0.007,6,10,1547,5,764,1.0,496.0,496.0,5,783,1.0,515.0,515.0
0.014,6,10,1983,5,910,3.0,642.0,642.0,5,1073,3.0,805.0,805.0
40.064,17,10,676,5,460,10013.0,104.0,64.0,5,216,10015.0,20.0,15.0
0.006,6,12,1698,6,863,1.0,327.0,271.0,6,835,1.0,515.0,515.0
0.013,6,10,1989,5,910,3.0,642.0,642.0,5,1079,3.0,811.0,811.0
0.005,6,10,1643,5,860,1.0,592.0,592.0,5,783,1.0,515.0,515.0
0.005,17,2,166,1,75,0.0,47.0,47.0,1,91,0.0,63.0,63.0
0.014,6,10,1989,5,910,3.0,642.0,642.0,5,1079,3.0,811.0,811.0
0.006,6,10,1547,5,764,1.0,496.0,496.0,5,783,1.0,515.0,515.0
0.005,17,2,166,1,75,0.0,47.0,47.0,1,91,0.0,63.0,63.0
0.007,6,10,1972,5,910,1.0,642.0,642.0,5,1062,1.0,794.0,794.0
0.017,6,10,1631,5,848,4.0,580.0,580.0,5,783,4.0,515.0,515.0
0.016,6,10,1990,5,911,3.0,643.0,643.0,5,1079,4.0,811.0,811.0
0.006,6,10,1547,5,764,1.0,496.0,496.0,5,783,1.0,515.0,515.0
0.011,6,10,1990,5,911,2.0,643.0,643.0,5,1079,2.0,811.0,811.0
0.096,6,10,1506,5,395,22.0,127.0,127.0,5,1111,19.0,843.0,843.0
0.007,17,2,136,1,60,0.0,32.0,32.0,1,76,0.0,48.0,48.0
0.079,6,13,3735,7,497,13.0,125.0,125.0,6,3238,15.0,1470.0,1459.0
0.112,6,10,1506,5,395,24.0,127.0,127.0,5,1111,23.0,843.0,843.0
0.013,6,10,1677,5,827,3.0,559.0,559.0,5,850,3.0,582.0,582.0
0.005,6,10,1689,5,839,1.0,571.0,571.0,5,850,1.0,582.0,582.0
0.005,6,10,1774,5,923,1.0,655.0,655.0,5,851,1.0,583.0,583.0
0.005,6,10,1779,5,928,1.0,660.0,660.0,5,851,1.0,583.0,583.0
0.004,6,10,1989,5,927,1.0,659.0,659.0,5,1062,1.0,794.0,794.0
0.001,17,2,136,1,60,0.0,32.0,32.0,1,76,0.0,48.0,48.0
0.012,6,10,2006,5,927,3.0,659.0,659.0,5,1079,2.0,811.0,811.0
0.069,6,10,1506,5,395,16.0,127.0,127.0,5,1111,15.0,843.0,843.0
0.01,6,10,1631,5,848,2.0,580.0,580.0,5,783,2.0,515.0,515.0
0.005,6,10,2006,5,927,1.0,659.0,659.0,5,1079,1.0,811.0,811.0
0.005,6,10,1547,5,764,1.0,496.0,496.0,5,783,1.0,515.0,515.0
0.063,6,10,1506,5,395,13.0,127.0,127.0,5,1111,13.0,843.0,843.0
0.005,6,10,1547,5,764,1.0,496.0,496.0,5,783,1.0,515.0,515.0
0.1,6,10,1506,5,395,21.0,127.0,127.0,5,1111,22.0,843.0,843.0
0.097,6,10,1506,5,395,22.0,127.0,127.0,5,1111,19.0,843.0,843.0
295.383,6,390,347084,204,22159,1455.0,2736.0,825.0,186,324925,1596.0,3012.0,1832.0
0.005,17,2,170,1,65,0.0,37.0,37.0,1,105,0.0,77.0,77.0
0.009,6,12,1926,6,1189,1.0,659.0,434.0,6,737,1.0,417.0,417.0
0.003,17,2,186,1,61,0.0,33.0,33.0,1,125,0.0,97.0,97.0
9.037,17,6,376,5,280,2259.0,28.0,28.0,1,96,0.0,68.0,68.0
0.009,6,10,1762,5,911,2.0,643.0,643.0,5,851,2.0,583.0,583.0
0.086,6,10,1506,5,395,19.0,127.0,127.0,5,1111,19.0,843.0,843.0
40.068,17,10,676,5,460,10016.0,104.0,64.0,5,216,10016.0,20.0,15.0
0.023,6,10,1972,5,910,5.0,642.0,642.0,5,1062,5.0,794.0,794.0
0.005,6,10,2007,5,928,1.0,660.0,660.0,5,1079,1.0,811.0,811.0
0.01,17,2,136,1,60,0.0,32.0,32.0,1,76,0.0,48.0,48.0
0.006,17,2,148,1,60,0.0,32.0,32.0,1,88,0.0,60.0,60.0
0.079,17,8,3613,4,1874,26.0,1350.0,440.0,4,1739,11.0,1350.0,406.0
0.005,6,10,2000,5,927,1.0,659.0,659.0,5,1073,1.0,805.0,805.0
0.001,17,2,180,1,66,0.0,38.0,38.0,1,114,0.0,86.0,86.0
0.005,6,10,2000,5,927,1.0,659.0,659.0,5,1073,1.0,805.0,805.0
0.066,17,8,3613,4,1874,22.0,1350.0,440.0,4,1739,11.0,1350.0,406.0
0.001,17,2,179,1,62,0.0,34.0,34.0,1,117,0.0,89.0,89.0
0.004,6,10,2000,5,927,1.0,659.0,659.0,5,1073,1.0,805.0,805.0
240.085,6,16,4481,9,963,30010.0,238.0,166.0,7,3518,40013.0,1402.0,786.0
240.073,6,22,4977,12,993,21824.0,180.0,93.0,10,3984,26674.0,1592.0,576.0
0.005,17,2,180,1,58,0.0,30.0,30.0,1,122,0.0,94.0,94.0
0.013,6,10,1631,5,848,3.0,580.0,580.0,5,783,3.0,515.0,515.0
254.903,6,19,4637,9,963,31862.0,238.0,166.0,10,3674,28322.0,1402.0,786.0
0.011,6,13,3735,7,497,1.0,125.0,125.0,6,3238,2.0,1470.0,1459.0
40.062,17,10,676,5,460,10014.0,104.0,64.0,5,216,10014.0,20.0,15.0
0.054,6,10,1972,5,910,13.0,642.0,642.0,5,1062,13.0,794.0,794.0
0.025,6,10,1972,5,910,6.0,642.0,642.0,5,1062,6.0,794.0,794.0
40.058,17,10,676,5,460,10013.0,104.0,64.0,5,216,10013.0,20.0,15.0
5.354,6,25,6186,14,1564,411.0,474.0,201.0,11,4622,535.0,1925.0,675.0
0.001,17,2,180,1,66,0.0,38.0,38.0,1,114,0.0,86.0,86.0
240.672,6,39,9746,20,2190,12665.0,710.0,228.0,19,7556,13368.0,1402.0,547.0
0.018,6,10,1983,5,910,4.0,642.0,642.0,5,1073,4.0,805.0,805.0
175.263,17,74,10653,37,2466,4868.0,44.0,38.0,37,8187,4868.0,239.0,193.0
0.005,6,10,2006,5,927,1.0,659.0,659.0,5,1079,1.0,811.0,811.0
0.019,6,10,1972,5,910,4.0,642.0,642.0,5,1062,4.0,794.0,794.0
0.019,17,2,136,1,60,0.0,32.0,32.0,1,76,0.0,48.0,48.0
0.005,17,2,170,1,65,0.0,37.0,37.0,1,105,0.0,77.0,77.0
322.407,17,20,1124,10,716,35808.0,48.0,43.0,10,408,35808.0,20.0,12.0
0.095,6,10,1506,5,395,23.0,127.0,127.0,5,1111,22.0,843.0,843.0
308.541,17,20,1124,10,716,34275.0,48.0,43.0,10,408,34275.0,20.0,12.0
0.005,6,10,1854,5,889,1.0,621.0,621.0,5,965,1.0,697.0,697.0
0.003,17,2,132,1,58,0.0,30.0,30.0,1,74,0.0,46.0,46.0
0.012,6,10,1989,5,910,3.0,642.0,642.0,5,1079,3.0,811.0,811.0
367.161,6,22,2313,16,867,24477.0,195.0,195.0,6,1446,4636.0,419.0,398.0
0.006,6,10,1643,5,860,1.0,592.0,592.0,5,783,1.0,515.0,515.0
0.008,17,2,144,1,64,0.0,36.0,36.0,1,80,0.0,52.0,52.0
0.089,6,10,1506,5,395,19.0,127.0,127.0,5,1111,20.0,843.0,843.0
0.004,6,10,2006,5,927,1.0,659.0,659.0,5,1079,1.0,811.0,811.0
0.012,6,10,1990,5,911,3.0,643.0,643.0,5,1079,2.0,811.0,811.0
240.027,6,9,787,5,488,60006.0,232.0,232.0,4,299,80004.0,83.0,83.0
0.006,6,10,2006,5,927,1.0,659.0,659.0,5,1079,1.0,811.0,811.0
0.004,17,2,170,1,65,0.0,37.0,37.0,1,105,0.0,77.0,77.0
40.059,17,10,676,5,460,10013.0,104.0,64.0,5,216,10013.0,20.0,15.0
0.005,17,2,160,1,72,0.0,44.0,44.0,1,88,0.0,60.0,60.0
0.009,6,10,1972,5,910,2.0,642.0,642.0,5,1062,2.0,794.0,794.0
0.134,17,2,80,1,32,0.0,4.0,4.0,1,48,0.0,20.0,20.0
0.006,6,10,1547,5,764,1.0,496.0,496.0,5,783,1.0,515.0,515.0
0.01,6,10,1990,5,911,2.0,643.0,643.0,5,1079,2.0,811.0,811.0
0.014,6,10,1983,5,910,3.0,642.0,642.0,5,1073,3.0,805.0,805.0
0.012,6,10,1631,5,848,3.0,580.0,580.0,5,783,2.0,515.0,515.0
0.127,17,2,170,1,65,0.0,37.0,37.0,1,105,0.0,77.0,77.0
0.01,6,10,1990,5,911,2.0,643.0,643.0,5,1079,2.0,811.0,811.0
0.071,6,10,1506,5,395,16.0,127.0,127.0,5,1111,16.0,843.0,843.0
40.066,17,10,676,5,460,10014.0,104.0,64.0,5,216,10015.0,20.0,15.0
0.005,6,13,3747,7,509,0.0,137.0,137.0,6,3238,1.0,1470.0,1459.0
0.021,6,10,1972,5,910,5.0,642.0,642.0,5,1062,5.0,794.0,794.0
0.042,17,2,152,1,76,0.0,48.0,48.0,1,76,0.0,48.0,48.0
0.262,17,44,26717,27,23499,10.0,1350.0,842.0,17,3218,12.0,1350.0,161.0
0.007,6,14,3799,7,509,1.0,137.0,137.0,7,3290,1.0,1448.0,972.0
0.004,6,10,2006,5,927,1.0,659.0,659.0,5,1079,1.0,811.0,811.0
0.045,17,2,152,1,76,0.0,48.0,48.0,1,76,0.0,48.0,48.0
310.748,17,18,1008,9,640,38836.0,48.0,43.0,9,368,38836.0,20.0,12.0
353.478,6,20,2210,6,1308,12004.0,494.0,494.0,14,902,27190.0,83.0,83.0
0.112,6,10,1506,5,395,22.0,127.0,127.0,5,1111,26.0,843.0,843.0
0.015,6,10,1990,5,911,3.0,643.0,643.0,5,1079,3.0,811.0,811.0
0.006,17,2,170,1,65,0.0,37.0,37.0,1,105,0.0,77.0,77.0
0.006,6,10,1689,5,839,1.0,571.0,571.0,5,850,1.0,582.0,582.0
0.005,6,10,2007,5,928,1.0,660.0,660.0,5,1079,1.0,811.0,811.0
0.127,17,4,596,2,122,1.0,33.0,33.0,2,474,54.0,323.0,209.0
0.013,6,10,1989,5,910,3.0,642.0,642.0,5,1079,3.0,811.0,811.0
0.072,17,4,352,2,130,0.0,37.0,37.0,2,222,69.0,89.0,83.0
40.071,17,10,676,5,460,10016.0,104.0,64.0,5,216,10016.0,20.0,15.0
40.062,17,10,676,5,460,10012.0,104.0,64.0,5,216,10014.0,20.0,15.0
0.005,6,10,1779,5,928,1.0,660.0,660.0,5,851,1.0,583.0,583.0
0.005,6,13,3747,7,509,0.0,137.0,137.0,6,3238,1.0,1470.0,1459.0
0.005,6,10,1779,5,928,1.0,660.0,660.0,5,851,1.0,583.0,583.0
0.001,17,2,180,1,66,0.0,38.0,38.0,1,114,0.0,86.0,86.0
0.129,6,10,1506,5,395,29.0,127.0,127.0,5,1111,27.0,843.0,843.0
0.042,17,2,148,1,60,0.0,32.0,32.0,1,88,0.0,60.0,60.0
1799.998,6,258,42839,97,30863,18437.0,2720.0,329.0,161,11976,11249.0,1062.0,75.0
0.073,6,10,1506,5,395,14.0,127.0,127.0,5,1111,15.0,843.0,843.0
0.004,6,10,1774,5,923,1.0,655.0,655.0,5,851,1.0,583.0,583.0
40.08,17,10,676,5,460,10018.0,104.0,64.0,5,216,10019.0,20.0,15.0
0.021,6,10,1972,5,910,5.0,642.0,642.0,5,1062,5.0,794.0,794.0
0.012,6,10,1983,5,910,3.0,642.0,642.0,5,1073,2.0,805.0,805.0
0.005,6,10,2007,5,928,1.0,660.0,660.0,5,1079,1.0,811.0,811.0
0.096,6,10,1506,5,395,20.0,127.0,127.0,5,1111,21.0,843.0,843.0
0.016,6,10,1989,5,910,4.0,642.0,642.0,5,1079,4.0,811.0,811.0
0.001,17,2,180,1,66,0.0,38.0,38.0,1,114,0.0,86.0,86.0
0.004,17,2,148,1,60,0.0,32.0,32.0,1,88,0.0,60.0,60.0
0.06,6,10,1506,5,395,14.0,127.0,127.0,5,1111,13.0,843.0,843.0
0.003,17,2,136,1,60,0.0,32.0,32.0,1,76,0.0,48.0,48.0
0.044,17,2,152,1,76,0.0,48.0,48.0,1,76,0.0,48.0,48.0
0.005,6,13,3747,7,509,0.0,137.0,137.0,6,3238,0.0,1470.0,1459.0
10.905,17,28,4418,14,1994,830.0,269.0,114.0,14,2424,830.0,587.0,145.0
0.005,6,10,1547,5,764,1.0,496.0,496.0,5,783,1.0,515.0,515.0
0.011,6,10,1762,5,911,2.0,643.0,643.0,5,851,2.0,583.0,583.0
0.007,6,10,2000,5,927,1.0,659.0,659.0,5,1073,1.0,805.0,805.0
0.001,17,2,180,1,66,0.0,38.0,38.0,1,114,0.0,86.0,86.0
0.018,6,10,1989,5,910,4.0,642.0,642.0,5,1079,4.0,811.0,811.0
0.055,6,10,1506,5,395,12.0,127.0,127.0,5,1111,12.0,843.0,843.0
40.057,17,10,676,5,460,10011.0,104.0,64.0,5,216,10013.0,20.0,15.0
300.305,6,16,2170,9,684,37517.0,146.0,146.0,7,1486,50023.0,419.0,398.0
0.005,17,2,144,1,64,0.0,36.0,36.0,1,80,0.0,52.0,52.0
1795.19,6,491,99873,246,88483,7327.0,421.0,365.0,245,11390,7356.0,53.0,53.0
0.005,6,13,3747,7,509,0.0,137.0,137.0,6,3238,0.0,1470.0,1459.0
10.854,17,28,4421,14,1993,826.0,268.0,114.0,14,2428,826.0,587.0,145.0
0.004,17,4,284,2,120,0.0,32.0,32.0,2,164,0.0,60.0,54.0
0.015,6,10,1631,5,848,3.0,580.0,580.0,5,783,3.0,515.0,515.0
0.001,17,2,142,1,63,0.0,35.0,35.0,1,79,0.0,51.0,51.0
0.014,6,10,1762,5,911,3.0,643.0,643.0,5,851,3.0,583.0,583.0
0.073,6,10,1506,5,395,16.0,127.0,127.0,5,1111,14.0,843.0,843.0
0.006,6,10,1547,5,764,1.0,496.0,496.0,5,783,1.0,515.0,515.0
0.014,6,10,1972,5,910,3.0,642.0,642.0,5,1062,3.0,794.0,794.0
240.013,6,9,787,5,488,60003.0,232.0,232.0,4,299,80003.0,83.0,83.0
0.094,6,10,1506,5,395,22.0,127.0,127.0,5,1111,21.0,843.0,843.0
0.067,17,8,3613,4,1874,22.0,1350.0,440.0,4,1739,11.0,1350.0,406.0
0.106,6,10,1506,5,395,23.0,127.0,127.0,5,1111,24.0,843.0,843.0
0.081,6,10,1506,5,395,19.0,127.0,127.0,5,1111,19.0,843.0,843.0
0.016,6,10,1983,5,910,3.0,642.0,642.0,5,1073,4.0,805.0,805.0
0.006,6,10,1854,5,889,1.0,621.0,621.0,5,965,1.0,697.0,697.0
0.013,17,2,152,1,56,0.0,28.0,28.0,1,96,0.0,68.0,68.0
0.004,6,10,1989,5,927,1.0,659.0,659.0,5,1062,1.0,794.0,794.0
0.07,17,8,3613,4,1874,23.0,1350.0,440.0,4,1739,12.0,1350.0,406.0
0.004,6,10,1989,5,927,1.0,659.0,659.0,5,1062,1.0,794.0,794.0
0.006,6,10,1689,5,839,1.0,571.0,571.0,5,850,1.0,582.0,582.0
0.004,6,10,2006,5,927,1.0,659.0,659.0,5,1079,1.0,811.0,811.0
0.006,6,10,2006,5,927,1.0,659.0,659.0,5,1079,1.0,811.0,811.0
0.131,17,4,284,2,120,0.0,32.0,32.0,2,164,128.0,60.0,54.0
0.004,17,4,284,2,120,0.0,32.0,32.0,2,164,0.0,60.0,54.0
0.005,6,10,2006,5,927,1.0,659.0,659.0,5,1079,1.0,811.0,811.0
40.06,17,10,676,5,460,10013.0,104.0,64.0,5,216,10014.0,20.0,15.0
0.001,17,2,136,1,60,0.0,32.0,32.0,1,76,0.0,48.0,48.0
11.072,17,28,4423,14,1994,839.0,269.0,114.0,14,2429,839.0,588.0,145.0
0.006,6,10,1547,5,764,1.0,496.0,496.0,5,783,1.0,515.0,515.0
0.005,6,10,2006,5,927,1.0,659.0,659.0,5,1079,1.0,811.0,811.0
240.009,6,9,787,5,488,60002.0,232.0,232.0,4,299,80002.0,83.0,83.0
0.01,6,10,1989,5,910,2.0,642.0,642.0,5,1079,2.0,811.0,811.0
0.005,6,10,2006,5,927,1.0,659.0,659.0,5,1079,1.0,811.0,811.0
0.147,17,4,352,2,130,107.0,37.0,37.0,2,222,143.0,89.0,83.0
0.008,6,12,1926,6,1189,1.0,659.0,434.0,6,737,1.0,417.0,417.0
15.073,17,14,9190,8,6902,2149.0,1350.0,834.0,6,2288,3008.0,1350.0,353.0
0.004,17,2,136,1,60,0.0,32.0,32.0,1,76,0.0,48.0,48.0
0.005,6,10,2006,5,927,1.0,659.0,659.0,5,1079,1.0,811.0,811.0
308.615,17,18,1008,9,640,38560.0,48.0,43.0,9,368,38560.0,20.0,12.0
0.005,6,10,1689,5,839,1.0,571.0,571.0,5,850,1.0,582.0,582.0
0.004,6,10,2007,5,928,1.0,660.0,660.0,5,1079,1.0,811.0,811.0
0.014,6,13,3735,7,497,2.0,125.0,125.0,6,3238,2.0,1470.0,1459.0
0.011,6,10,1989,5,910,2.0,642.0,642.0,5,1079,2.0,811.0,811.0
0.004,17,2,148,1,60,0.0,32.0,32.0,1,88,0.0,60.0,60.0
0.005,17,2,230,1,68,0.0,40.0,40.0,1,162,0.0,134.0,134.0
0.001,17,2,294,1,64,0.0,36.0,36.0,1,230,0.0,202.0,202.0
0.004,6,10,2006,5,927,1.0,659.0,659.0,5,1079,1.0,811.0,811.0
40.068,17,10,676,5,460,10013.0,104.0,64.0,5,216,10016.0,20.0,15.0
0.012,6,10,1631,5,848,3.0,580.0,580.0,5,783,3.0,515.0,515.0
0.006,6,10,1547,5,764,1.0,496.0,496.0,5,783,1.0,515.0,515.0
0.008,17,2,169,1,62,0.0,34.0,34.0,1,107,0.0,79.0,79.0
0.005,6,10,2006,5,927,1.0,659.0,659.0,5,1079,1.0,811.0,811.0
0.013,6,10,1762,5,911,3.0,643.0,643.0,5,851,3.0,583.0,583.0
0.11,6,10,1506,5,395,26.0,127.0,127.0,5,1111,26.0,843.0,843.0
1772.682,17,120,11460,60,5460,30045.0,63.0,63.0,60,6000,30045.0,72.0,72.0
1797.334,17,3046,233368,1514,122908,1187.0,84.0,53.0,1532,110460,1173.0,227.0,44.0
0.278,17,45,27908,27,24828,10.0,1350.0,891.0,18,3080,13.0,1350.0,143.0
0.012,6,10,1631,5,848,3.0,580.0,580.0,5,783,2.0,515.0,515.0
0.013,6,10,1972,5,910,3.0,642.0,642.0,5,1062,3.0,794.0,794.0
0.007,17,2,179,1,71,0.0,43.0,43.0,1,108,0.0,80.0,80.0
0.011,6,10,1989,5,910,2.0,642.0,642.0,5,1079,2.0,811.0,811.0
0.08,6,10,1506,5,395,17.0,127.0,127.0,5,1111,18.0,843.0,843.0
0.004,17,2,148,1,60,0.0,32.0,32.0,1,88,0.0,60.0,60.0
0.089,6,10,1506,5,395,20.0,127.0,127.0,5,1111,18.0,843.0,843.0
10.828,17,28,4421,14,1994,824.0,269.0,114.0,14,2427,823.0,586.0,145.0
0.094,6,10,1506,5,395,20.0,127.0,127.0,5,1111,22.0,843.0,843.0
0.019,6,10,1989,5,910,4.0,642.0,642.0,5,1079,4.0,811.0,811.0
40.064,17,10,676,5,460,10014.0,104.0,64.0,5,216,10015.0,20.0,15.0
0.005,17,2,179,1,71,0.0,43.0,43.0,1,108,0.0,80.0,80.0
0.008,6,10,1972,5,910,1.0,642.0,642.0,5,1062,1.0,794.0,794.0
0.098,6,10,1506,5,395,19.0,127.0,127.0,5,1111,23.0,843.0,843.0
571.204,6,57,22828,30,5320,19696.0,676.0,467.0,27,17508,19661.0,1402.0,894.0
15.23,17,23,10905,12,8170,1382.0,1350.0,652.0,11,2735,1520.0,1350.0,220.0
0.007,17,2,166,1,75,0.0,47.0,47.0,1,91,0.0,63.0,63.0
0.29,6,10,1506,5,395,71.0,127.0,127.0,5,1111,21.0,843.0,843.0
0.069,6,10,1506,5,395,16.0,127.0,127.0,5,1111,13.0,843.0,843.0
0.007,6,10,2006,5,927,1.0,659.0,659.0,5,1079,1.0,811.0,811.0
269.575,17,18,1008,9,640,33689.0,48.0,43.0,9,368,33689.0,20.0,12.0
0.005,6,10,2006,5,927,1.0,659.0,659.0,5,1079,1.0,811.0,811.0
0.099,6,10,1506,5,395,20.0,127.0,127.0,5,1111,24.0,843.0,843.0
1799.84,6,136,6550,76,3625,23997.0,39.0,39.0,60,2925,29993.0,35.0,35.0
0.081,6,10,1506,5,395,17.0,127.0,127.0,5,1111,18.0,843.0,843.0
0.115,6,10,1506,5,395,20.0,127.0,127.0,5,1111,27.0,843.0,843.0
0.005,6,10,2006,5,927,1.0,659.0,659.0,5,1079,1.0,811.0,811.0
0.002,17,2,180,1,66,0.0,38.0,38.0,1,114,0.0,86.0,86.0
40.086,17,10,676,5,460,10019.0,104.0,64.0,5,216,10019.0,20.0,15.0
0.074,6,10,1506,5,395,16.0,127.0,127.0,5,1111,16.0,843.0,843.0
1778.901,17,141,44556,72,22752,25053.0,288.0,288.0,69,21804,26159.0,288.0,288.0
0.008,6,10,1989,5,927,2.0,659.0,659.0,5,1062,2.0,794.0,794.0
0.068,17,8,3613,4,1874,22.0,1350.0,440.0,4,1739,11.0,1350.0,406.0
0.116,6,10,1506,5,395,22.0,127.0,127.0,5,1111,26.0,843.0,843.0
312.094,17,20,1124,10,716,34662.0,48.0,43.0,10,408,34662.0,20.0,12.0
0.517,6,66,41605,29,33856,18.0,2736.0,1701.0,37,7749,14.0,1656.0,646.0
0.004,17,4,284,2,120,0.0,32.0,32.0,2,164,1.0,60.0,54.0
0.012,17,2,152,1,76,0.0,48.0,48.0,1,76,0.0,48.0,48.0
0.079,6,10,1506,5,395,18.0,127.0,127.0,5,1111,17.0,843.0,843.0
0.116,6,10,1506,5,395,25.0,127.0,127.0,5,1111,24.0,843.0,843.0
0.061,6,10,1506,5,395,13.0,127.0,127.0,5,1111,14.0,843.0,843.0
0.006,6,10,1547,5,764,1.0,496.0,496.0,5,783,1.0,515.0,515.0
0.008,6,12,1926,6,1189,1.0,659.0,434.0,6,737,1.0,417.0,417.0
0.124,6,10,1506,5,395,29.0,127.0,127.0,5,1111,26.0,843.0,843.0
0.005,6,10,2006,5,927,1.0,659.0,659.0,5,1079,1.0,811.0,811.0
0.008,6,12,1926,6,1189,1.0,659.0,434.0,6,737,1.0,417.0,417.0
0.009,6,10,1677,5,827,2.0,559.0,559.0,5,850,2.0,582.0,582.0
0.005,6,13,3747,7,509,0.0,137.0,137.0,6,3238,0.0,1470.0,1459.0
0.006,6,10,1547,5,764,1.0,496.0,496.0,5,783,1.0,515.0,515.0
0.005,6,10,1689,5,839,1.0,571.0,571.0,5,850,1.0,582.0,582.0
0.038,17,2,152,1,76,0.0,48.0,48.0,1,76,0.0,48.0,48.0
0.005,6,10,1989,5,927,1.0,659.0,659.0,5,1062,1.0,794.0,794.0
0.008,6,10,1983,5,910,2.0,642.0,642.0,5,1073,1.0,805.0,805.0
1770.313,6,83,4368,42,2210,43177.0,26.0,26.0,41,2158,44256.0,26.0,26.0
0.004,6,10,2000,5,927,1.0,659.0,659.0,5,1073,1.0,805.0,805.0
289.68,6,315,344587,120,17799,2434.0,2694.0,825.0,195,326788,1493.0,2804.0,1759.0
0.016,6,10,1972,5,910,4.0,642.0,642.0,5,1062,3.0,794.0,794.0
0.006,6,10,1689,5,839,1.0,571.0,571.0,5,850,1.0,582.0,582.0
0.014,6,10,1989,5,910,3.0,642.0,642.0,5,1079,3.0,811.0,811.0
0.006,6,10,1547,5,764,1.0,496.0,496.0,5,783,1.0,515.0,515.0
0.005,17,2,140,1,62,0.0,34.0,34.0,1,78,0.0,50.0,50.0
0.005,6,10,2000,5,927,1.0,659.0,659.0,5,1073,1.0,805.0,805.0
0.012,6,14,3787,7,497,2.0,125.0,125.0,7,3290,2.0,1448.0,972.0
0.004,17,4,284,2,120,0.0,32.0,32.0,2,164,0.0,60.0,54.0
300.026,6,12,1782,7,1348,50004.0,494.0,494.0,5,434,75005.0,83.0,83.0
0.015,17,2,198,1,91,0.0,63.0,63.0,1,107,0.0,79.0,79.0
0.005,6,10,2006,5,927,1.0,659.0,659.0,5,1079,1.0,811.0,811.0
0.012,6,10,1972,5,910,3.0,642.0,642.0,5,1062,2.0,794.0,794.0
0.01,6,10,1989,5,910,2.0,642.0,642.0,5,1079,2.0,811.0,811.0
301.131,6,46,16649,24,10742,13092.0,2720.0,1218.0,22,5907,425.0,2667.0,385.0
0.087,6,10,1506,5,395,15.0,127.0,127.0,5,1111,19.0,843.0,843.0
0.005,6,10,2000,5,927,1.0,659.0,659.0,5,1073,1.0,805.0,805.0
0.13,17,2,136,1,60,0.0,32.0,32.0,1,76,0.0,48.0,48.0
0.018,6,10,1631,5,848,4.0,580.0,580.0,5,783,4.0,515.0,515.0
55.949,6,37,12647,18,7089,519.0,4080.0,1584.0,19,5558,3099.0,2667.0,435.0
0.011,6,10,1990,5,911,2.0,643.0,643.0,5,1079,2.0,811.0,811.0
0.203,6,10,1506,5,395,48.0,127.0,127.0,5,1111,22.0,843.0,843.0
0.006,17,2,166,1,75,0.0,47.0,47.0,1,91,0.0,63.0,63.0
0.006,17,2,166,1,75,0.0,47.0,47.0,1,91,0.0,63.0,63.0
0.007,6,10,2007,5,928,1.0,660.0,660.0,5,1079,1.0,811.0,811.0
0.005,6,10,2007,5,928,1.0,660.0,660.0,5,1079,1.0,811.0,811.0
0.005,6,10,2006,5,927,1.0,659.0,659.0,5,1079,1.0,811.0,811.0
0.005,6,10,1989,5,927,1.0,659.0,659.0,5,1062,1.0,794.0,794.0
0.001,17,2,180,1,66,0.0,38.0,38.0,1,114,0.0,86.0,86.0
40.052,17,10,676,5,460,10012.0,104.0,64.0,5,216,10012.0,20.0,15.0
0.076,6,10,1506,5,395,16.0,127.0,127.0,5,1111,17.0,843.0,843.0
0.006,6,10,1547,5,764,1.0,496.0,496.0,5,783,1.0,515.0,515.0
0.091,6,10,1506,5,395,20.0,127.0,127.0,5,1111,18.0,843.0,843.0
0.012,6,10,1972,5,910,3.0,642.0,642.0,5,1062,3.0,794.0,794.0
0.098,6,10,1506,5,395,20.0,127.0,127.0,5,1111,20.0,843.0,843.0
0.133,6,10,1506,5,395,27.0,127.0,127.0,5,1111,29.0,843.0,843.0
0.118,6,10,1506,5,395,29.0,127.0,127.0,5,1111,26.0,843.0,843.0
0.001,17,2,180,1,66,0.0,38.0,38.0,1,114,0.0,86.0,86.0
0.007,6,10,1547,5,764,1.0,496.0,496.0,5,783,1.0,515.0,515.0
0.009,6,10,1972,5,910,2.0,642.0,642.0,5,1062,2.0,794.0,794.0
0.143,6,10,1506,5,395,33.0,127.0,127.0,5,1111,30.0,843.0,843.0
0.001,17,2,180,1,66,0.0,38.0,38.0,1,114,0.0,86.0,86.0
0.005,17,2,146,1,65,0.0,37.0,37.0,1,81,0.0,53.0,53.0
0.15,6,10,1506,5,395,34.0,127.0,127.0,5,1111,34.0,843.0,843.0
0.006,6,10,1643,5,860,1.0,592.0,592.0,5,783,1.0,515.0,515.0
0.008,6,10,1989,5,910,2.0,642.0,642.0,5,1079,2.0,811.0,811.0
0.006,6,10,1547,5,764,1.0,496.0,496.0,5,783,1.0,515.0,515.0
0.006,17,2,140,1,62,0.0,34.0,34.0,1,78,0.0,50.0,50.0
0.009,6,10,1989,5,910,2.0,642.0,642.0,5,1079,2.0,811.0,811.0
0.089,6,10,1506,5,395,19.0,127.0,127.0,5,1111,19.0,843.0,843.0
0.302,17,47,28472,27,24823,11.0,1350.0,891.0,20,3649,14.0,1350.0,154.0
0.005,6,10,1989,5,927,1.0,659.0,659.0,5,1062,1.0,794.0,794.0
0.095,6,10,1506,5,395,20.0,127.0,127.0,5,1111,18.0,843.0,843.0
1771.683,17,120,11460,60,5460,30028.0,63.0,63.0,60,6000,30028.0,72.0,72.0
0.011,6,10,1972,5,910,2.0,642.0,642.0,5,1062,2.0,794.0,794.0
0.017,6,10,1989,5,910,4.0,642.0,642.0,5,1079,4.0,811.0,811.0
294.846,6,413,348919,203,22111,1459.0,2736.0,888.0,210,326808,1410.0,2804.0,1611.0
0.097,6,10,1506,5,395,22.0,127.0,127.0,5,1111,18.0,843.0,843.0
11.066,17,28,4424,14,1995,838.0,270.0,114.0,14,2429,838.0,588.0,145.0
0.004,6,10,2000,5,927,1.0,659.0,659.0,5,1073,1.0,805.0,805.0
0.001,17,2,180,1,66,0.0,38.0,38.0,1,114,0.0,86.0,86.0
0.009,17,2,194,1,59,0.0,31.0,31.0,1,135,0.0,107.0,107.0
0.005,6,10,2006,5,927,1.0,659.0,659.0,5,1079,1.0,811.0,811.0
0.006,6,10,2006,5,927,1.0,659.0,659.0,5,1079,1.0,811.0,811.0
0.006,6,10,1689,5,839,1.0,571.0,571.0,5,850,1.0,582.0,582.0
0.004,17,2,148,1,60,0.0,32.0,32.0,1,88,0.0,60.0,60.0
351.989,6,20,2210,6,1308,12004.0,494.0,494.0,14,902,27075.0,83.0,83.0
15.265,17,47,27245,25,21221,634.0,1350.0,820.0,22,6024,725.0,1350.0,245.0
0.005,6,10,2007,5,928,1.0,660.0,660.0,5,1079,1.0,811.0,811.0
0.074,6,10,1506,5,395,16.0,127.0,127.0,5,1111,14.0,843.0,843.0
240.09,6,16,4480,9,963,30011.0,238.0,166.0,7,3517,40014.0,1402.0,786.0
0.084,6,10,1506,5,395,18.0,127.0,127.0,5,1111,20.0,843.0,843.0
0.06,6,10,1506,5,395,12.0,127.0,127.0,5,1111,14.0,843.0,843.0
174.175,17,80,11271,40,2668,4465.0,44.0,38.0,40,8603,4465.0,239.0,187.0
0.014,6,10,1989,5,910,3.0,642.0,642.0,5,1079,3.0,811.0,811.0
0.026,6,10,1972,5,910,6.0,642.0,642.0,5,1062,6.0,794.0,794.0
0.013,6,10,1989,5,910,3.0,642.0,642.0,5,1079,3.0,811.0,811.0
0.115,6,10,1506,5,395,27.0,127.0,127.0,5,1111,28.0,843.0,843.0
0.077,6,10,1506,5,395,18.0,127.0,127.0,5,1111,15.0,843.0,843.0
40.1,17,10,676,5,460,10024.0,104.0,64.0,5,216,10024.0,20.0,15.0
0.006,6,10,1854,5,889,1.0,621.0,621.0,5,965,1.0,697.0,697.0
0.012,6,10,1989,5,910,3.0,642.0,642.0,5,1079,3.0,811.0,811.0
10.986,17,28,4424,14,1995,836.0,270.0,114.0,14,2429,836.0,588.0,145.0
0.169,17,2,152,1,76,0.0,48.0,48.0,1,76,0.0,48.0,48.0
0.01,6,10,1989,5,910,2.0,642.0,642.0,5,1079,2.0,811.0,811.0
0.005,6,10,1779,5,928,1.0,660.0,660.0,5,851,1.0,583.0,583.0
40.065,17,10,676,5,460,10014.0,104.0,64.0,5,216,10015.0,20.0,15.0
0.022,6,10,1989,5,910,5.0,642.0,642.0,5,1079,5.0,811.0,811.0
0.167,17,2,152,1,76,0.0,48.0,48.0,1,76,0.0,48.0,48.0
0.007,6,10,1989,5,927,1.0,659.0,659.0,5,1062,1.0,794.0,794.0
0.005,6,10,1689,5,839,1.0,571.0,571.0,5,850,1.0,582.0,582.0
0.019,6,10,1631,5,848,4.0,580.0,580.0,5,783,4.0,515.0,515.0
0.006,6,10,1689,5,839,1.0,571.0,571.0,5,850,1.0,582.0,582.0
0.062,17,2,80,1,32,0.0,4.0,4.0,1,48,0.0,20.0,20.0
308.555,17,20,1124,10,716,34270.0,48.0,43.0,10,408,34270.0,20.0,12.0
0.006,6,10,1854,5,889,1.0,621.0,621.0,5,965,1.0,697.0,697.0
0.098,6,10,1506,5,395,19.0,127.0,127.0,5,1111,22.0,843.0,843.0
0.006,17,2,169,1,62,0.0,34.0,34.0,1,107,0.0,79.0,79.0
0.007,6,10,1989,5,910,1.0,642.0,642.0,5,1079,1.0,811.0,811.0
310.477,17,18,1008,9,640,38802.0,48.0,43.0,9,368,38802.0,20.0,12.0
0.005,6,10,1854,5,889,1.0,621.0,621.0,5,965,1.0,697.0,697.0
0.007,17,2,160,1,72,0.0,44.0,44.0,1,88,0.0,60.0,60.0
0.013,6,10,1631,5,848,3.0,580.0,580.0,5,783,3.0,515.0,515.0
0.008,17,2,170,1,65,0.0,37.0,37.0,1,105,0.0,77.0,77.0
294.62,6,393,348626,197,21805,1503.0,2736.0,888.0,196,326821,1510.0,2804.0,1739.0
0.209,6,16,2670,8,1396,29.0,533.0,324.0,8,1274,19.0,529.0,212.0
40.059,17,10,676,5,460,10013.0,104.0,64.0,5,216,10014.0,20.0,15.0
0.005,17,2,180,1,58,0.0,30.0,30.0,1,122,0.0,94.0,94.0
240.098,6,16,4482,9,963,30012.0,238.0,166.0,7,3519,40015.0,1402.0,786.0
0.038,17,2,170,1,65,0.0,37.0,37.0,1,105,0.0,77.0,77.0
0.012,6,10,1989,5,910,3.0,642.0,642.0,5,1079,2.0,811.0,811.0
0.008,6,13,3735,7,497,1.0,125.0,125.0,6,3238,1.0,1470.0,1459.0
0.068,6,10,1506,5,395,16.0,127.0,127.0,5,1111,14.0,843.0,843.0
0.039,17,4,352,2,130,0.0,37.0,37.0,2,222,1.0,89.0,83.0
0.006,6,10,1547,5,764,1.0,496.0,496.0,5,783,1.0,515.0,515.0
0.004,17,4,420,2,122,0.0,33.0,33.0,2,298,1.0,145.0,121.0
0.006,6,10,1689,5,839,1.0,571.0,571.0,5,850,1.0,582.0,582.0
15.077,17,16,9303,8,6912,2149.0,1350.0,836.0,8,2391,2149.0,1350.0,270.0
0.005,6,10,2000,5,927,1.0,659.0,659.0,5,1073,1.0,805.0,805.0
0.015,6,10,1762,5,911,3.0,643.0,643.0,5,851,3.0,583.0,583.0
0.001,17,2,180,1,66,0.0,38.0,38.0,1,114,0.0,86.0,86.0
9.042,17,6,376,5,280,2260.0,28.0,28.0,1,96,0.0,68.0,68.0
0.006,17,2,170,1,65,0.0,37.0,37.0,1,105,0.0,77.0,77.0
0.008,6,10,1990,5,911,2.0,643.0,643.0,5,1079,1.0,811.0,811.0
0.001,17,2,142,1,63,0.0,35.0,35.0,1,79,0.0,51.0,51.0
5.108,6,21,5923,12,1436,464.0,474.0,201.0,9,4487,638.0,1925.0,804.0
0.005,6,10,1854,5,889,1.0,621.0,621.0,5,965,1.0,697.0,697.0
0.012,6,14,3787,7,497,2.0,125.0,125.0,7,3290,1.0,1448.0,972.0
0.007,17,4,284,2,120,0.0,32.0,32.0,2,164,0.0,60.0,54.0
0.014,6,10,1972,5,910,3.0,642.0,642.0,5,1062,3.0,794.0,794.0
0.015,6,10,1983,5,910,3.0,642.0,642.0,5,1073,3.0,805.0,805.0
0.009,6,13,3735,7,497,1.0,125.0,125.0,6,3238,1.0,1470.0,1459.0
240.09,6,16,4481,9,963,30011.0,238.0,166.0,7,3518,40014.0,1402.0,786.0
0.003,17,2,187,1,74,0.0,46.0,46.0,1,113,0.0,85.0,85.0
0.019,6,10,1983,5,910,4.0,642.0,642.0,5,1073,4.0,805.0,805.0
10.741,17,26,4102,13,1846,886.0,269.0,114.0,13,2256,886.0,587.0,145.0
0.007,17,2,164,1,74,0.0,46.0,46.0,1,90,0.0,62.0,62.0
0.071,6,10,1506,5,395,15.0,127.0,127.0,5,1111,16.0,843.0,843.0
0.109,6,14,4389,8,923,15.0,238.0,166.0,6,3466,14.0,1402.0,786.0
0.004,6,10,1774,5,923,1.0,655.0,655.0,5,851,1.0,583.0,583.0
0.005,17,2,179,1,71,0.0,43.0,43.0,1,108,0.0,80.0,80.0
0.052,17,2,152,1,76,0.0,48.0,48.0,1,76,0.0,48.0,48.0
0.014,6,10,1762,5,911,3.0,643.0,643.0,5,851,3.0,583.0,583.0
0.005,6,10,1689,5,839,1.0,571.0,571.0,5,850,1.0,582.0,582.0
0.016,6,10,1990,5,911,3.0,643.0,643.0,5,1079,4.0,811.0,811.0
0.005,6,13,3690,7,452,0.0,80.0,80.0,6,3238,1.0,1470.0,1459.0
0.04,17,2,152,1,76,0.0,48.0,48.0,1,76,0.0,48.0,48.0
0.116,6,10,1506,5,395,27.0,127.0,127.0,5,1111,23.0,843.0,843.0
0.006,17,2,169,1,62,0.0,34.0,34.0,1,107,0.0,79.0,79.0
0.122,6,10,1506,5,395,29.0,127.0,127.0,5,1111,28.0,843.0,843.0
0.013,6,10,1989,5,910,3.0,642.0,642.0,5,1079,3.0,811.0,811.0
40.08,17,10,676,5,460,10018.0,104.0,64.0,5,216,10019.0,20.0,15.0
40.06,17,10,676,5,460,10014.0,104.0,64.0,5,216,10014.0,20.0,15.0
0.147,6,10,1506,5,395,32.0,127.0,127.0,5,1111,35.0,843.0,843.0
0.101,6,10,1506,5,395,23.0,127.0,127.0,5,1111,20.0,843.0,843.0
0.004,6,10,2007,5,928,1.0,660.0,660.0,5,1079,1.0,811.0,811.0
0.013,6,10,1972,5,910,3.0,642.0,642.0,5,1062,3.0,794.0,794.0
40.061,17,10,676,5,460,10014.0,104.0,64.0,5,216,10014.0,20.0,15.0
177.147,17,86,12135,43,2875,4217.0,44.0,38.0,43,9260,4217.0,239.0,187.0
0.021,6,10,1983,5,910,5.0,642.0,642.0,5,1073,5.0,805.0,805.0
0.007,17,2,194,1,59,0.0,31.0,31.0,1,135,0.0,107.0,107.0
0.004,17,4,284,2,120,0.0,32.0,32.0,2,164,1.0,60.0,54.0
40.065,17,10,676,5,460,10015.0,104.0,64.0,5,216,10015.0,20.0,15.0
0.009,6,13,3735,7,497,1.0,125.0,125.0,6,3238,1.0,1470.0,1459.0
0.012,6,10,1989,5,910,2.0,642.0,642.0,5,1079,3.0,811.0,811.0
0.001,17,2,136,1,60,0.0,32.0,32.0,1,76,0.0,48.0,48.0
0.015,6,10,1983,5,910,3.0,642.0,642.0,5,1073,3.0,805.0,805.0
40.076,17,10,676,5,460,10017.0,104.0,64.0,5,216,10018.0,20.0,15.0
0.071,17,8,3613,4,1874,23.0,1350.0,440.0,4,1739,12.0,1350.0,406.0
0.009,6,10,1631,5,848,2.0,580.0,580.0,5,783,2.0,515.0,515.0
0.098,6,10,1506,5,395,20.0,127.0,127.0,5,1111,18.0,843.0,843.0
0.017,6,10,1989,5,910,4.0,642.0,642.0,5,1079,4.0,811.0,811.0
0.038,17,2,170,1,65,0.0,37.0,37.0,1,105,0.0,77.0,77.0
0.017,6,10,1762,5,911,4.0,643.0,643.0,5,851,4.0,583.0,583.0
0.006,6,10,1547,5,764,1.0,496.0,496.0,5,783,1.0,515.0,515.0
0.008,6,10,1989,5,910,2.0,642.0,642.0,5,1079,2.0,811.0,811.0
0.089,6,10,1506,5,395,20.0,127.0,127.0,5,1111,19.0,843.0,843.0
0.019,6,10,1989,5,910,4.0,642.0,642.0,5,1079,4.0,811.0,811.0
0.011,6,10,1972,5,910,2.0,642.0,642.0,5,1062,2.0,794.0,794.0
0.004,6,10,2000,5,927,1.0,659.0,659.0,5,1073,1.0,805.0,805.0
0.006,6,13,3747,7,509,1.0,137.0,137.0,6,3238,1.0,1470.0,1459.0
0.012,6,10,1990,5,911,3.0,643.0,643.0,5,1079,2.0,811.0,811.0
0.017,6,10,1677,5,827,4.0,559.0,559.0,5,850,4.0,582.0,582.0
0.106,6,10,1506,5,395,20.0,127.0,127.0,5,1111,22.0,843.0,843.0
0.041,17,2,152,1,76,0.0,48.0,48.0,1,76,0.0,48.0,48.0
0.008,6,10,1989,5,910,2.0,642.0,642.0,5,1079,1.0,811.0,811.0
0.018,6,10,1990,5,911,4.0,643.0,643.0,5,1079,4.0,811.0,811.0
0.097,6,10,1506,5,395,21.0,127.0,127.0,5,1111,22.0,843.0,843.0
11.54,17,28,4395,14,2313,875.0,588.0,137.0,14,2082,875.0,269.0,120.0
11.007,17,28,4423,14,1994,838.0,269.0,114.0,14,2429,838.0,588.0,145.0
0.116,6,10,1506,5,395,25.0,127.0,127.0,5,1111,20.0,843.0,843.0
0.081,17,8,3613,4,1874,27.0,1350.0,440.0,4,1739,12.0,1350.0,406.0
0.084,6,10,1506,5,395,20.0,127.0,127.0,5,1111,18.0,843.0,843.0
0.087,17,2,152,1,76,0.0,48.0,48.0,1,76,0.0,48.0,48.0
0.011,6,14,3787,7,497,1.0,125.0,125.0,7,3290,1.0,1448.0,972.0
0.013,6,10,1990,5,911,3.0,643.0,643.0,5,1079,3.0,811.0,811.0
0.005,6,10,1774,5,923,1.0,655.0,655.0,5,851,1.0,583.0,583.0
0.053,17,2,152,1,76,0.0,48.0,48.0,1,76,0.0,48.0,48.0
0.001,17,2,180,1,65,0.0,37.0,37.0,1,115,0.0,87.0,87.0
0.009,6,10,1983,5,910,2.0,642.0,642.0,5,1073,2.0,805.0,805.0
0.016,6,13,3735,7,497,2.0,125.0,125.0,6,3238,3.0,1470.0,1459.0
0.004,6,10,2006,5,927,1.0,659.0,659.0,5,1079,1.0,811.0,811.0
0.013,6,10,1983,5,910,3.0,642.0,642.0,5,1073,3.0,805.0,805.0
0.141,6,10,1506,5,395,32.0,127.0,127.0,5,1111,32.0,843.0,843.0
0.014,6,10,1972,5,910,3.0,642.0,642.0,5,1062,3.0,794.0,794.0
0.04,17,4,284,2,120,1.0,32.0,32.0,2,164,36.0,60.0,54.0
0.004,6,10,2000,5,927,1.0,659.0,659.0,5,1073,1.0,805.0,805.0
0.005,17,2,179,1,71,0.0,43.0,43.0,1,108,0.0,80.0,80.0
15.191,17,15,8665,8,6464,2165.0,1350.0,780.0,7,2201,2526.0,1350.0,286.0
0.006,6,10,1643,5,860,1.0,592.0,592.0,5,783,1.0,515.0,515.0
0.001,17,2,180,1,66,0.0,38.0,38.0,1,114,0.0,86.0,86.0
0.009,6,12,1926,6,1189,1.0,659.0,434.0,6,737,1.0,417.0,417.0
0.007,6,10,1547,5,764,1.0,496.0,496.0,5,783,1.0,515.0,515.0
0.001,17,2,180,1,66,0.0,38.0,38.0,1,114,0.0,86.0,86.0
0.005,6,10,1547,5,764,1.0,496.0,496.0,5,783,1.0,515.0,515.0
0.013,6,10,1677,5,827,3.0,559.0,559.0,5,850,3.0,582.0,582.0
0.008,6,12,1926,6,1189,1.0,659.0,434.0,6,737,1.0,417.0,417.0
0.069,6,10,1506,5,395,15.0,127.0,127.0,5,1111,16.0,843.0,843.0
0.005,17,2,170,1,65,0.0,37.0,37.0,1,105,0.0,77.0,77.0
300.381,6,84,54501,47,3541,6530.0,524.0,215.0,37,50960,8343.0,4206.0,1581.0
0.005,6,10,2006,5,927,1.0,659.0,659.0,5,1079,1.0,811.0,811.0
0.041,17,2,148,1,60,0.0,32.0,32.0,1,88,0.0,60.0,60.0
0.111,6,10,1506,5,395,25.0,127.0,127.0,5,1111,24.0,843.0,843.0
0.006,6,10,1547,5,764,1.0,496.0,496.0,5,783,1.0,515.0,515.0
0.012,6,10,1972,5,910,3.0,642.0,642.0,5,1062,2.0,794.0,794.0
0.003,17,2,132,1,58,0.0,30.0,30.0,1,74,0.0,46.0,46.0
0.005,6,10,1779,5,928,1.0,660.0,660.0,5,851,1.0,583.0,583.0
0.006,6,10,2006,5,927,1.0,659.0,659.0,5,1079,1.0,811.0,811.0
0.012,6,10,1972,5,910,3.0,642.0,642.0,5,1062,2.0,794.0,794.0
0.001,17,2,136,1,60,0.0,32.0,32.0,1,76,0.0,48.0,48.0
0.013,6,10,1972,5,910,3.0,642.0,642.0,5,1062,3.0,794.0,794.0
0.03,6,10,1990,5,911,7.0,643.0,643.0,5,1079,7.0,811.0,811.0
0.001,17,2,180,1,66,0.0,38.0,38.0,1,114,0.0,86.0,86.0
0.004,6,10,1779,5,928,1.0,660.0,660.0,5,851,1.0,583.0,583.0
11.173,17,28,4422,14,1995,846.0,270.0,114.0,14,2427,846.0,586.0,145.0
0.008,6,10,1547,5,764,2.0,496.0,496.0,5,783,1.0,515.0,515.0
0.005,6,10,2007,5,928,1.0,660.0,660.0,5,1079,1.0,811.0,811.0
0.013,6,10,1990,5,911,3.0,643.0,643.0,5,1079,3.0,811.0,811.0
0.11,6,10,1506,5,395,25.0,127.0,127.0,5,1111,25.0,843.0,843.0
0.005,17,2,168,1,76,0.0,48.0,48.0,1,92,0.0,64.0,64.0
0.005,17,2,222,1,65,0.0,37.0,37.0,1,157,0.0,129.0,129.0
0.15,6,10,1506,5,395,30.0,127.0,127.0,5,1111,33.0,843.0,843.0
0.006,6,10,1547,5,764,1.0,496.0,496.0,5,783,1.0,515.0,515.0
0.003,17,2,136,1,60,0.0,32.0,32.0,1,76,0.0,48.0,48.0
0.004,17,2,136,1,60,0.0,32.0,32.0,1,76,0.0,48.0,48.0
0.005,6,10,1989,5,927,1.0,659.0,659.0,5,1062,1.0,794.0,794.0
0.081,6,10,1506,5,395,19.0,127.0,127.0,5,1111,18.0,843.0,843.0
0.021,6,10,1972,5,910,5.0,642.0,642.0,5,1062,5.0,794.0,794.0
0.016,6,10,1990,5,911,4.0,643.0,643.0,5,1079,3.0,811.0,811.0
0.095,6,10,1506,5,395,19.0,127.0,127.0,5,1111,21.0,843.0,843.0
0.008,6,10,1972,5,910,2.0,642.0,642.0,5,1062,2.0,794.0,794.0
0.006,6,10,1547,5,764,1.0,496.0,496.0,5,783,1.0,515.0,515.0
0.006,6,10,1643,5,860,1.0,592.0,592.0,5,783,1.0,515.0,515.0
40.07,17,10,676,5,460,10016.0,104.0,64.0,5,216,10016.0,20.0,15.0
0.071,17,2,156,1,64,0.0,36.0,36.0,1,92,0.0,64.0,64.0
0.001,17,2,180,1,66,0.0,38.0,38.0,1,114,0.0,86.0,86.0
240.034,6,9,787,5,488,60008.0,232.0,232.0,4,299,80010.0,83.0,83.0
0.053,17,2,152,1,76,0.0,48.0,48.0,1,76,0.0,48.0,48.0
0.006,6,10,1547,5,764,1.0,496.0,496.0,5,783,1.0,515.0,515.0
0.005,17,2,225,1,65,0.0,37.0,37.0,1,160,0.0,132.0,132.0
0.006,6,10,1547,5,764,1.0,496.0,496.0,5,783,1.0,515.0,515.0
0.014,6,10,1983,5,910,3.0,642.0,642.0,5,1073,3.0,805.0,805.0
292.238,6,17,1215,4,448,3.0,232.0,232.0,13,767,24352.0,83.0,83.0
0.011,6,10,1989,5,910,2.0,642.0,642.0,5,1079,2.0,811.0,811.0
0.004,17,4,284,2,120,0.0,32.0,32.0,2,164,1.0,60.0,54.0
0.093,6,10,1506,5,395,22.0,127.0,127.0,5,1111,18.0,843.0,843.0
0.005,17,2,166,1,75,0.0,47.0,47.0,1,91,0.0,63.0,63.0
0.015,6,10,1983,5,910,3.0,642.0,642.0,5,1073,3.0,805.0,805.0
0.005,17,2,170,1,65,0.0,37.0,37.0,1,105,0.0,77.0,77.0
40.062,17,10,676,5,460,10013.0,104.0,64.0,5,216,10014.0,20.0,15.0
0.005,17,2,164,1,74,0.0,46.0,46.0,1,90,0.0,62.0,62.0
0.01,6,10,1631,5,848,2.0,580.0,580.0,5,783,2.0,515.0,515.0
0.117,6,10,1506,5,395,26.0,127.0,127.0,5,1111,24.0,843.0,843.0
0.008,6,10,2006,5,927,2.0,659.0,659.0,5,1079,1.0,811.0,811.0
0.019,6,10,1972,5,910,4.0,642.0,642.0,5,1062,4.0,794.0,794.0
0.095,6,10,1506,5,395,21.0,127.0,127.0,5,1111,21.0,843.0,843.0
0.005,6,13,3747,7,509,0.0,137.0,137.0,6,3238,0.0,1470.0,1459.0
0.005,17,2,144,1,64,0.0,36.0,36.0,1,80,0.0,52.0,52.0
240.099,6,16,4482,9,963,30012.0,238.0,166.0,7,3519,40016.0,1402.0,786.0
0.006,6,10,1547,5,764,1.0,496.0,496.0,5,783,1.0,515.0,515.0
0.001,17,2,180,1,66,0.0,38.0,38.0,1,114,0.0,86.0,86.0
0.003,17,2,148,1,60,0.0,32.0,32.0,1,88,0.0,60.0,60.0
0.074,6,10,1506,5,395,16.0,127.0,127.0,5,1111,18.0,843.0,843.0
0.07,6,10,1506,5,395,16.0,127.0,127.0,5,1111,13.0,843.0,843.0
0.005,6,10,1989,5,927,1.0,659.0,659.0,5,1062,1.0,794.0,794.0
0.009,6,10,1972,5,910,2.0,642.0,642.0,5,1062,2.0,794.0,794.0
0.005,6,10,1989,5,927,1.0,659.0,659.0,5,1062,1.0,794.0,794.0
0.006,6,10,1689,5,839,1.0,571.0,571.0,5,850,1.0,582.0,582.0
0.011,6,10,2000,5,927,2.0,659.0,659.0,5,1073,2.0,805.0,805.0
0.007,6,10,2007,5,928,1.0,660.0,660.0,5,1079,1.0,811.0,811.0
0.013,6,13,3735,7,497,2.0,125.0,125.0,6,3238,2.0,1470.0,1459.0
0.092,6,10,1506,5,395,18.0,127.0,127.0,5,1111,21.0,843.0,843.0
0.077,6,10,1506,5,395,16.0,127.0,127.0,5,1111,17.0,843.0,843.0
280.637,6,26,6520,12,1266,25512.0,267.0,156.0,14,5254,21586.0,1400.0,781.0
0.005,6,10,1989,5,927,1.0,659.0,659.0,5,1062,1.0,794.0,794.0
178.464,17,72,10415,36,2402,5098.0,44.0,38.0,36,8013,5098.0,261.0,194.0
0.006,17,2,179,1,71,0.0,43.0,43.0,1,108,0.0,80.0,80.0
0.009,6,13,3735,7,497,1.0,125.0,125.0,6,3238,1.0,1470.0,1459.0
0.011,6,10,1990,5,911,2.0,643.0,643.0,5,1079,2.0,811.0,811.0
0.004,17,4,284,2,120,0.0,32.0,32.0,2,164,1.0,60.0,54.0
0.089,6,10,1506,5,395,20.0,127.0,127.0,5,1111,20.0,843.0,843.0
9.036,17,6,376,5,280,2259.0,28.0,28.0,1,96,0.0,68.0,68.0
0.004,6,10,1989,5,927,1.0,659.0,659.0,5,1062,1.0,794.0,794.0
0.005,6,10,2000,5,927,1.0,659.0,659.0,5,1073,1.0,805.0,805.0
0.015,6,10,1989,5,910,3.0,642.0,642.0,5,1079,3.0,811.0,811.0
0.005,6,10,1779,5,928,1.0,660.0,660.0,5,851,1.0,583.0,583.0
0.008,6,10,1990,5,911,2.0,643.0,643.0,5,1079,2.0,811.0,811.0
0.006,6,10,1689,5,839,1.0,571.0,571.0,5,850,1.0,582.0,582.0
0.005,6,10,1779,5,928,1.0,660.0,660.0,5,851,1.0,583.0,583.0
0.004,17,4,284,2,120,0.0,32.0,32.0,2,164,0.0,60.0,54.0
0.089,6,10,1506,5,395,20.0,127.0,127.0,5,1111,18.0,843.0,843.0
0.135,6,10,1506,5,395,33.0,127.0,127.0,5,1111,31.0,843.0,843.0
0.004,6,10,2000,5,927,1.0,659.0,659.0,5,1073,1.0,805.0,805.0
0.011,6,10,1989,5,910,2.0,642.0,642.0,5,1079,2.0,811.0,811.0
0.09,6,10,1506,5,395,21.0,127.0,127.0,5,1111,20.0,843.0,843.0
0.005,6,10,2000,5,927,1.0,659.0,659.0,5,1073,1.0,805.0,805.0
0.011,6,10,1989,5,910,2.0,642.0,642.0,5,1079,2.0,811.0,811.0
295.351,6,306,344217,115,17536,2590.0,2694.0,889.0,191,326681,1554.0,4206.0,1789.0
0.138,6,10,1506,5,395,30.0,127.0,127.0,5,1111,31.0,843.0,843.0
0.004,6,10,1989,5,927,1.0,659.0,659.0,5,1062,1.0,794.0,794.0
0.009,6,10,1983,5,910,2.0,642.0,642.0,5,1073,2.0,805.0,805.0
0.074,6,10,1506,5,395,17.0,127.0,127.0,5,1111,15.0,843.0,843.0
371.29,6,22,2313,16,867,24752.0,195.0,195.0,6,1446,4642.0,419.0,398.0
300.683,6,37,8261,20,1830,15825.0,651.0,249.0,17,6431,535.0,2126.0,478.0
0.001,17,2,136,1,60,0.0,32.0,32.0,1,76,0.0,48.0,48.0
1770.154,6,303,97756,187,86476,9516.0,2001.0,679.0,116,11280,15392.0,452.0,70.0
0.001,17,2,180,1,66,0.0,38.0,38.0,1,114,0.0,86.0,86.0
0.096,6,10,1506,5,395,18.0,127.0,127.0,5,1111,21.0,843.0,843.0
0.011,17,2,247,1,72,0.0,44.0,44.0,1,175,0.0,147.0,147.0
40.058,17,10,676,5,460,10013.0,104.0,64.0,5,216,10013.0,20.0,15.0
0.084,6,10,1506,5,395,20.0,127.0,127.0,5,1111,18.0,843.0,843.0
0.014,6,10,1989,5,910,3.0,642.0,642.0,5,1079,3.0,811.0,811.0
0.06,17,2,152,1,76,0.0,48.0,48.0,1,76,0.0,48.0,48.0
0.005,6,10,1547,5,764,1.0,496.0,496.0,5,783,1.0,515.0,515.0
0.013,6,10,1972,5,910,3.0,642.0,642.0,5,1062,3.0,794.0,794.0
0.006,6,10,1689,5,839,1.0,571.0,571.0,5,850,1.0,582.0,582.0
0.002,17,2,180,1,66,0.0,38.0,38.0,1,114,0.0,86.0,86.0
0.009,6,10,1990,5,911,2.0,643.0,643.0,5,1079,2.0,811.0,811.0
0.107,6,10,1506,5,395,24.0,127.0,127.0,5,1111,24.0,843.0,843.0
0.076,17,8,3613,4,1874,25.0,1350.0,440.0,4,1739,11.0,1350.0,406.0
0.001,17,2,174,1,72,0.0,44.0,44.0,1,102,0.0,74.0,74.0
0.005,17,2,170,1,65,0.0,37.0,37.0,1,105,0.0,77.0,77.0
0.001,17,2,180,1,66,0.0,38.0,38.0,1,114,0.0,86.0,86.0
0.004,6,10,2007,5,928,1.0,660.0,660.0,5,1079,1.0,811.0,811.0
45.147,6,38,12939,19,7381,491.0,2720.0,1317.0,19,5558,2498.0,2667.0,435.0
376.046,6,22,2313,16,867,25069.0,195.0,195.0,6,1446,4642.0,419.0,398.0
0.006,6,10,1547,5,764,1.0,496.0,496.0,5,783,1.0,515.0,515.0
0.004,6,10,1774,5,923,1.0,655.0,655.0,5,851,1.0,583.0,583.0
0.103,6,10,1506,5,395,20.0,127.0,127.0,5,1111,23.0,843.0,843.0
0.015,6,10,1631,5,848,3.0,580.0,580.0,5,783,3.0,515.0,515.0
0.005,6,10,1643,5,860,1.0,592.0,592.0,5,783,1.0,515.0,515.0
0.004,6,10,1702,5,863,1.0,595.0,595.0,5,839,0.0,571.0,571.0
0.005,6,10,1689,5,839,1.0,571.0,571.0,5,850,1.0,582.0,582.0
15.071,17,15,9238,8,6902,2149.0,1350.0,834.0,7,2336,2506.0,1350.0,305.0
0.016,6,10,1983,5,910,4.0,642.0,642.0,5,1073,3.0,805.0,805.0
0.005,6,10,1989,5,927,1.0,659.0,659.0,5,1062,1.0,794.0,794.0
0.008,6,14,3799,7,509,1.0,137.0,137.0,7,3290,1.0,1448.0,972.0
0.004,6,10,2006,5,927,1.0,659.0,659.0,5,1079,1.0,811.0,811.0
0.011,6,10,1989,5,910,2.0,642.0,642.0,5,1079,2.0,811.0,811.0
0.001,17,2,136,1,60,0.0,32.0,32.0,1,76,0.0,48.0,48.0
0.024,6,10,1983,5,910,5.0,642.0,642.0,5,1073,6.0,805.0,805.0
0.059,17,2,80,1,32,0.0,4.0,4.0,1,48,0.0,20.0,20.0
0.01,6,10,1989,5,910,2.0,642.0,642.0,5,1079,2.0,811.0,811.0
0.006,6,10,1547,5,764,1.0,496.0,496.0,5,783,1.0,515.0,515.0
0.005,17,2,170,1,65,0.0,37.0,37.0,1,105,0.0,77.0,77.0
0.017,6,10,1989,5,910,4.0,642.0,642.0,5,1079,4.0,811.0,811.0
0.007,17,2,179,1,71,0.0,43.0,43.0,1,108,0.0,80.0,80.0
0.005,6,10,1779,5,928,1.0,660.0,660.0,5,851,1.0,583.0,583.0
0.014,6,10,1990,5,911,3.0,643.0,643.0,5,1079,3.0,811.0,811.0
65.721,6,22,10140,12,3973,5974.0,1579.0,835.0,10,6167,7284.0,2111.0,939.0
0.005,6,10,1547,5,764,1.0,496.0,496.0,5,783,1.0,515.0,515.0
0.011,17,2,164,1,74,0.0,46.0,46.0,1,90,0.0,62.0,62.0
0.086,6,10,1506,5,395,20.0,127.0,127.0,5,1111,16.0,843.0,843.0
40.055,17,10,676,5,460,10013.0,104.0,64.0,5,216,10013.0,20.0,15.0
0.004,6,10,1702,5,863,1.0,595.0,595.0,5,839,1.0,571.0,571.0
0.018,6,13,3735,7,497,3.0,125.0,125.0,6,3238,3.0,1470.0,1459.0
0.017,6,10,1990,5,911,4.0,643.0,643.0,5,1079,4.0,811.0,811.0
0.015,6,10,1989,5,910,3.0,642.0,642.0,5,1079,3.0,811.0,811.0
0.005,6,10,2007,5,928,1.0,660.0,660.0,5,1079,1.0,811.0,811.0
0.006,6,10,1854,5,889,1.0,621.0,621.0,5,965,1.0,697.0,697.0
0.012,6,10,1990,5,911,3.0,643.0,643.0,5,1079,3.0,811.0,811.0
0.017,6,10,1677,5,827,4.0,559.0,559.0,5,850,4.0,582.0,582.0
0.006,17,2,148,1,60,0.0,32.0,32.0,1,88,0.0,60.0,60.0
0.01,6,10,1972,5,910,2.0,642.0,642.0,5,1062,2.0,794.0,794.0
11.249,17,28,4419,14,1994,852.0,269.0,114.0,14,2425,852.0,588.0,145.0
0.162,6,10,1266,5,775,40.0,519.0,519.0,5,491,39.0,223.0,223.0
0.013,6,10,1983,5,910,3.0,642.0,642.0,5,1073,3.0,805.0,805.0
0.018,6,10,1990,5,911,4.0,643.0,643.0,5,1079,4.0,811.0,811.0
0.016,6,10,1972,5,910,3.0,642.0,642.0,5,1062,4.0,794.0,794.0
40.085,17,10,676,5,460,10017.0,104.0,64.0,5,216,10019.0,20.0,15.0
0.006,6,10,1547,5,764,1.0,496.0,496.0,5,783,1.0,515.0,515.0
0.005,6,10,2007,5,928,1.0,660.0,660.0,5,1079,1.0,811.0,811.0
0.005,17,2,169,1,62,0.0,34.0,34.0,1,107,0.0,79.0,79.0
0.005,6,13,3747,7,509,0.0,137.0,137.0,6,3238,1.0,1470.0,1459.0
0.005,6,10,2007,5,928,1.0,660.0,660.0,5,1079,1.0,811.0,811.0
0.016,6,10,1677,5,827,4.0,559.0,559.0,5,850,3.0,582.0,582.0
0.005,6,10,1547,5,764,1.0,496.0,496.0,5,783,1.0,515.0,515.0
0.006,6,10,1643,5,860,1.0,592.0,592.0,5,783,1.0,515.0,515.0
11.1,17,28,4419,14,1995,841.0,270.0,114.0,14,2424,841.0,587.0,145.0
0.003,17,2,160,1,72,0.0,44.0,44.0,1,88,0.0,60.0,60.0
0.005,6,10,1854,5,889,1.0,621.0,621.0,5,965,1.0,697.0,697.0
0.03,6,10,1989,5,910,7.0,642.0,642.0,5,1079,7.0,811.0,811.0
0.006,17,2,179,1,71,0.0,43.0,43.0,1,108,0.0,80.0,80.0
40.057,17,10,676,5,460,10012.0,104.0,64.0,5,216,10013.0,20.0,15.0
0.007,6,10,1547,5,764,1.0,496.0,496.0,5,783,1.0,515.0,515.0
40.057,17,10,676,5,460,10013.0,104.0,64.0,5,216,10013.0,20.0,15.0
65.108,6,21,8146,11,1985,83.0,1174.0,504.0,10,6161,7215.0,2720.0,958.0
0.014,6,10,1631,5,848,3.0,580.0,580.0,5,783,3.0,515.0,515.0
0.005,17,2,214,1,75,0.0,47.0,47.0,1,139,0.0,111.0,111.0
0.006,6,10,1547,5,764,1.0,496.0,496.0,5,783,1.0,515.0,515.0
0.001,17,2,180,1,66,0.0,38.0,38.0,1,114,0.0,86.0,86.0
0.004,6,14,3742,7,452,0.0,80.0,80.0,7,3290,0.0,1448.0,972.0
40.074,17,10,676,5,460,10015.0,104.0,64.0,5,216,10017.0,20.0,15.0
0.007,6,10,1854,5,889,1.0,621.0,621.0,5,965,1.0,697.0,697.0
0.126,17,2,184,1,61,0.0,33.0,33.0,1,123,0.0,95.0,95.0
0.013,6,10,1990,5,911,3.0,643.0,643.0,5,1079,3.0,811.0,811.0
0.029,6,10,1990,5,911,7.0,643.0,643.0,5,1079,7.0,811.0,811.0
0.014,6,10,1989,5,910,3.0,642.0,642.0,5,1079,3.0,811.0,811.0
351.999,6,20,2210,6,1308,12003.0,494.0,494.0,14,902,27076.0,83.0,83.0
0.006,6,10,1547,5,764,1.0,496.0,496.0,5,783,1.0,515.0,515.0
0.005,6,10,1989,5,927,1.0,659.0,659.0,5,1062,1.0,794.0,794.0
40.06,17,10,676,5,460,10013.0,104.0,64.0,5,216,10012.0,20.0,15.0
0.009,6,10,1990,5,911,2.0,643.0,643.0,5,1079,2.0,811.0,811.0
0.095,6,10,1506,5,395,22.0,127.0,127.0,5,1111,21.0,843.0,843.0
0.004,17,2,656,1,328,0.0,300.0,300.0,1,328,0.0,300.0,300.0
0.005,17,2,144,1,64,0.0,36.0,36.0,1,80,0.0,52.0,52.0
0.012,6,10,1990,5,911,3.0,643.0,643.0,5,1079,3.0,811.0,811.0
0.019,6,10,1989,5,910,4.0,642.0,642.0,5,1079,4.0,811.0,811.0
0.013,6,10,1990,5,911,3.0,643.0,643.0,5,1079,3.0,811.0,811.0
0.008,6,10,1983,5,910,2.0,642.0,642.0,5,1073,2.0,805.0,805.0
0.174,6,10,1506,5,395,42.0,127.0,127.0,5,1111,40.0,843.0,843.0
40.067,17,10,676,5,460,10015.0,104.0,64.0,5,216,10015.0,20.0,15.0
0.096,6,10,1506,5,395,21.0,127.0,127.0,5,1111,17.0,843.0,843.0
0.005,6,10,1989,5,927,1.0,659.0,659.0,5,1062,1.0,794.0,794.0
40.059,17,10,676,5,460,10013.0,104.0,64.0,5,216,10013.0,20.0,15.0
0.016,6,10,1972,5,910,4.0,642.0,642.0,5,1062,4.0,794.0,794.0
0.006,6,10,1547,5,764,1.0,496.0,496.0,5,783,1.0,515.0,515.0
75.25,58,5,360,4,288,25083.0,24.0,24.0,1,72,0.0,24.0,24.0
0.01,6,10,1762,5,911,2.0,643.0,643.0,5,851,2.0,583.0,583.0
15.075,17,15,9238,8,6902,2149.0,1350.0,834.0,7,2336,2507.0,1350.0,305.0
240.015,6,9,787,5,488,60003.0,232.0,232.0,4,299,80004.0,83.0,83.0
0.005,17,2,180,1,66,0.0,38.0,38.0,1,114,0.0,86.0,86.0
0.001,17,2,180,1,66,0.0,38.0,38.0,1,114,0.0,86.0,86.0
0.005,17,2,166,1,75,0.0,47.0,47.0,1,91,0.0,63.0,63.0
240.093,6,16,4481,9,963,30011.0,238.0,166.0,7,3518,40015.0,1402.0,786.0
240.089,6,30,7938,15,5585,17149.0,1515.0,534.0,15,2353,17149.0,580.0,195.0
0.021,6,10,2007,5,928,5.0,660.0,660.0,5,1079,5.0,811.0,811.0
0.011,6,10,1762,5,911,2.0,643.0,643.0,5,851,2.0,583.0,583.0
308.378,17,20,1124,10,716,34257.0,48.0,43.0,10,408,34257.0,20.0,12.0
0.005,6,14,3742,8,504,0.0,80.0,80.0,6,3238,0.0,1470.0,1459.0
0.011,6,10,1990,5,911,2.0,643.0,643.0,5,1079,2.0,811.0,811.0
0.04,17,2,166,1,75,0.0,47.0,47.0,1,91,0.0,63.0,63.0
0.008,6,10,1972,5,910,2.0,642.0,642.0,5,1062,2.0,794.0,794.0
1787.359,6,244,35804,152,26032,11836.0,302.0,302.0,92,9772,19641.0,83.0,83.0
0.012,6,10,1972,5,910,3.0,642.0,642.0,5,1062,3.0,794.0,794.0
40.075,17,10,676,5,460,10016.0,104.0,64.0,5,216,10018.0,20.0,15.0
0.014,6,10,1972,5,910,3.0,642.0,642.0,5,1062,3.0,794.0,794.0
40.068,17,10,676,5,460,10014.0,104.0,64.0,5,216,10015.0,20.0,15.0
0.097,6,10,1506,5,395,22.0,127.0,127.0,5,1111,22.0,843.0,843.0
0.041,17,4,284,2,120,0.0,32.0,32.0,2,164,38.0,60.0,54.0
0.006,6,10,2006,5,927,1.0,659.0,659.0,5,1079,1.0,811.0,811.0
0.041,17,2,184,1,61,0.0,33.0,33.0,1,123,0.0,95.0,95.0
0.005,6,10,1689,5,839,1.0,571.0,571.0,5,850,1.0,582.0,582.0
0.004,6,10,2006,5,927,1.0,659.0,659.0,5,1079,1.0,811.0,811.0
0.012,17,2,180,1,66,0.0,38.0,38.0,1,114,0.0,86.0,86.0
40.065,17,10,676,5,460,10013.0,104.0,64.0,5,216,10015.0,20.0,15.0
0.005,17,2,170,1,65,0.0,37.0,37.0,1,105,0.0,77.0,77.0
1780.974,6,95,6776,45,2488,40475.0,37.0,37.0,50,4288,36345.0,443.0,211.0
0.008,6,10,1989,5,927,2.0,659.0,659.0,5,1062,2.0,794.0,794.0
0.001,17,2,166,1,75,0.0,47.0,47.0,1,91,0.0,63.0,63.0
0.005,6,10,2000,5,927,1.0,659.0,659.0,5,1073,1.0,805.0,805.0
177.369,17,84,11978,42,2797,4325.0,44.0,38.0,42,9181,4326.0,261.0,190.0
0.004,6,10,2007,5,928,1.0,660.0,660.0,5,1079,1.0,811.0,811.0
0.006,6,10,1547,5,764,1.0,496.0,496.0,5,783,1.0,515.0,515.0
0.126,6,10,1506,5,395,29.0,127.0,127.0,5,1111,29.0,843.0,843.0
0.013,6,10,1989,5,910,3.0,642.0,642.0,5,1079,3.0,811.0,811.0
0.007,17,2,179,1,71,0.0,43.0,43.0,1,108,0.0,80.0,80.0
0.043,17,2,152,1,76,0.0,48.0,48.0,1,76,0.0,48.0,48.0
312.836,17,20,1124,10,716,34752.0,48.0,43.0,10,408,34752.0,20.0,12.0
0.004,6,10,1989,5,927,1.0,659.0,659.0,5,1062,1.0,794.0,794.0
0.171,6,3,453,2,321,171.0,241.0,241.0,1,132,0.0,92.0,92.0
0.037,17,2,234,1,61,0.0,33.0,33.0,1,173,0.0,145.0,145.0
0.067,6,10,1506,5,395,16.0,127.0,127.0,5,1111,13.0,843.0,843.0
0.005,6,10,2006,5,927,1.0,659.0,659.0,5,1079,1.0,811.0,811.0
0.008,6,10,1983,5,910,2.0,642.0,642.0,5,1073,2.0,805.0,805.0
0.019,6,10,1677,5,827,4.0,559.0,559.0,5,850,4.0,582.0,582.0
0.005,17,2,140,1,62,0.0,34.0,34.0,1,78,0.0,50.0,50.0
0.006,6,10,1854,5,889,1.0,621.0,621.0,5,965,1.0,697.0,697.0
0.005,6,10,1779,5,928,1.0,660.0,660.0,5,851,1.0,583.0,583.0
0.005,6,14,3799,7,509,0.0,137.0,137.0,7,3290,0.0,1448.0,972.0
240.099,6,16,4480,9,963,30012.0,238.0,166.0,7,3517,40016.0,1402.0,786.0
0.1,6,10,1506,5,395,19.0,127.0,127.0,5,1111,22.0,843.0,843.0
0.001,17,2,166,1,75,0.0,47.0,47.0,1,91,0.0,63.0,63.0
243.378,6,14,1047,5,488,60844.0,232.0,232.0,9,559,30421.0,83.0,83.0
322.806,17,20,1124,10,716,35853.0,48.0,43.0,10,408,35853.0,20.0,12.0
0.016,17,2,198,1,91,0.0,63.0,63.0,1,107,0.0,79.0,79.0
0.004,17,2,148,1,60,0.0,32.0,32.0,1,88,0.0,60.0,60.0
0.005,17,2,144,1,64,0.0,36.0,36.0,1,80,0.0,52.0,52.0
0.013,6,10,1990,5,911,3.0,643.0,643.0,5,1079,3.0,811.0,811.0
0.004,17,2,148,1,60,0.0,32.0,32.0,1,88,0.0,60.0,60.0
0.009,6,10,1989,5,910,2.0,642.0,642.0,5,1079,2.0,811.0,811.0
0.126,6,10,1506,5,395,20.0,127.0,127.0,5,1111,30.0,843.0,843.0
0.014,6,10,1983,5,910,3.0,642.0,642.0,5,1073,3.0,805.0,805.0
0.006,6,10,1689,5,839,1.0,571.0,571.0,5,850,1.0,582.0,582.0
0.005,17,2,136,1,60,0.0,32.0,32.0,1,76,0.0,48.0,48.0
0.077,6,10,1506,5,395,18.0,127.0,127.0,5,1111,16.0,843.0,843.0
0.003,17,2,148,1,60,0.0,32.0,32.0,1,88,0.0,60.0,60.0
0.005,6,10,1989,5,927,1.0,659.0,659.0,5,1062,1.0,794.0,794.0
0.075,6,10,1506,5,395,16.0,127.0,127.0,5,1111,14.0,843.0,843.0
0.001,17,2,180,1,66,0.0,38.0,38.0,1,114,0.0,86.0,86.0
0.013,6,10,1989,5,910,3.0,642.0,642.0,5,1079,3.0,811.0,811.0
1770.244,6,84,4422,42,2211,43175.0,27.0,27.0,42,2211,43175.0,27.0,27.0
0.003,17,2,136,1,60,0.0,32.0,32.0,1,76,0.0,48.0,48.0
0.015,6,10,1972,5,910,3.0,642.0,642.0,5,1062,3.0,794.0,794.0
0.005,17,2,144,1,64,0.0,36.0,36.0,1,80,0.0,52.0,52.0
0.012,6,10,1631,5,848,2.0,580.0,580.0,5,783,3.0,515.0,515.0
240.092,6,16,4481,9,963,30011.0,238.0,166.0,7,3518,40014.0,1402.0,786.0
0.005,6,10,1774,5,923,1.0,655.0,655.0,5,851,1.0,583.0,583.0
0.069,6,10,1506,5,395,14.0,127.0,127.0,5,1111,14.0,843.0,843.0
0.003,17,4,284,2,120,0.0,32.0,32.0,2,164,0.0,60.0,54.0
0.073,6,10,1506,5,395,16.0,127.0,127.0,5,1111,17.0,843.0,843.0
40.065,17,10,676,5,460,10015.0,104.0,64.0,5,216,10014.0,20.0,15.0
0.017,6,10,1972,5,910,4.0,642.0,642.0,5,1062,4.0,794.0,794.0
59.843,6,39,9156,21,3629,455.0,1360.0,546.0,18,5527,3510.0,2658.0,435.0
0.147,6,10,1506,5,395,33.0,127.0,127.0,5,1111,34.0,843.0,843.0
0.13,6,10,1506,5,395,31.0,127.0,127.0,5,1111,28.0,843.0,843.0
0.005,17,2,166,1,75,0.0,47.0,47.0,1,91,0.0,63.0,63.0
40.06,17,10,676,5,460,10013.0,104.0,64.0,5,216,10014.0,20.0,15.0
0.004,6,10,1702,5,863,1.0,595.0,595.0,5,839,0.0,571.0,571.0
90.395,6,880,949177,428,922864,94.0,4080.0,2269.0,452,26313,200.0,2667.0,200.0
0.124,17,2,148,1,60,0.0,32.0,32.0,1,88,0.0,60.0,60.0
0.004,17,4,284,2,120,0.0,32.0,32.0,2,164,0.0,60.0,54.0
0.001,17,2,136,1,60,0.0,32.0,32.0,1,76,0.0,48.0,48.0
0.064,6,10,1506,5,395,13.0,127.0,127.0,5,1111,14.0,843.0,843.0
0.01,6,10,1677,5,827,2.0,559.0,559.0,5,850,2.0,582.0,582.0
0.009,6,10,1677,5,827,2.0,559.0,559.0,5,850,2.0,582.0,582.0
0.071,6,10,1506,5,395,14.0,127.0,127.0,5,1111,15.0,843.0,843.0
0.005,6,10,1547,5,764,1.0,496.0,496.0,5,783,1.0,515.0,515.0
0.005,6,10,1779,5,928,1.0,660.0,660.0,5,851,1.0,583.0,583.0
0.102,6,10,1506,5,395,23.0,127.0,127.0,5,1111,15.0,843.0,843.0
0.074,6,10,1506,5,395,16.0,127.0,127.0,5,1111,16.0,843.0,843.0
0.039,17,4,420,2,122,0.0,33.0,33.0,2,298,35.0,145.0,121.0
0.006,6,10,2006,5,927,1.0,659.0,659.0,5,1079,1.0,811.0,811.0
0.074,6,10,1506,5,395,17.0,127.0,127.0,5,1111,16.0,843.0,843.0
10.887,17,28,4422,14,1995,829.0,270.0,114.0,14,2427,829.0,586.0,145.0
0.005,6,10,2007,5,928,1.0,660.0,660.0,5,1079,1.0,811.0,811.0
0.005,6,10,1643,5,860,1.0,592.0,592.0,5,783,1.0,515.0,515.0
0.005,6,10,2007,5,928,1.0,660.0,660.0,5,1079,1.0,811.0,811.0
0.117,6,10,1506,5,395,26.0,127.0,127.0,5,1111,27.0,843.0,843.0
0.072,6,10,1506,5,395,15.0,127.0,127.0,5,1111,15.0,843.0,843.0
0.004,6,10,2006,5,927,1.0,659.0,659.0,5,1079,1.0,811.0,811.0
0.005,6,10,2000,5,927,1.0,659.0,659.0,5,1073,1.0,805.0,805.0
0.001,17,2,180,1,66,0.0,38.0,38.0,1,114,0.0,86.0,86.0
0.009,6,10,1972,5,910,2.0,642.0,642.0,5,1062,2.0,794.0,794.0
0.006,6,13,3690,7,452,1.0,80.0,80.0,6,3238,1.0,1470.0,1459.0
0.014,6,10,1631,5,848,3.0,580.0,580.0,5,783,3.0,515.0,515.0
40.06,17,10,676,5,460,10011.0,104.0,64.0,5,216,10014.0,20.0,15.0
0.005,6,10,1689,5,839,1.0,571.0,571.0,5,850,1.0,582.0,582.0
0.079,6,10,1506,5,395,17.0,127.0,127.0,5,1111,16.0,843.0,843.0
0.086,6,10,1506,5,395,19.0,127.0,127.0,5,1111,15.0,843.0,843.0
0.012,6,10,1989,5,910,3.0,642.0,642.0,5,1079,2.0,811.0,811.0
0.005,6,10,1989,5,927,1.0,659.0,659.0,5,1062,1.0,794.0,794.0
0.028,6,10,1989,5,910,7.0,642.0,642.0,5,1079,6.0,811.0,811.0
0.042,17,2,184,1,61,0.0,33.0,33.0,1,123,0.0,95.0,95.0
0.014,6,10,1990,5,911,3.0,643.0,643.0,5,1079,3.0,811.0,811.0
0.004,6,10,2006,5,927,1.0,659.0,659.0,5,1079,1.0,811.0,811.0
0.005,6,10,2000,5,927,1.0,659.0,659.0,5,1073,1.0,805.0,805.0
40.067,17,10,676,5,460,10014.0,104.0,64.0,5,216,10016.0,20.0,15.0
0.015,6,10,1989,5,910,3.0,642.0,642.0,5,1079,3.0,811.0,811.0
0.004,6,10,1989,5,927,1.0,659.0,659.0,5,1062,1.0,794.0,794.0
11.074,17,28,4422,14,1994,839.0,269.0,114.0,14,2428,839.0,587.0,145.0
0.077,6,10,1506,5,395,16.0,127.0,127.0,5,1111,18.0,843.0,843.0
0.04,17,2,182,1,65,0.0,37.0,37.0,1,117,0.0,89.0,89.0
54.887,6,42,13510,21,7643,455.0,1887.0,1128.0,21,5867,2735.0,2667.0,385.0
0.005,6,10,1989,5,927,1.0,659.0,659.0,5,1062,1.0,794.0,794.0
0.012,6,6,716,3,458,4.0,302.0,302.0,3,258,4.0,102.0,102.0
0.004,6,10,1774,5,923,1.0,655.0,655.0,5,851,1.0,583.0,583.0
0.005,6,10,2007,5,928,1.0,660.0,660.0,5,1079,1.0,811.0,811.0
0.005,6,10,1989,5,927,1.0,659.0,659.0,5,1062,1.0,794.0,794.0
0.003,17,2,162,1,65,0.0,37.0,37.0,1,97,0.0,69.0,69.0
0.003,17,2,148,1,60,0.0,32.0,32.0,1,88,0.0,60.0,60.0
0.006,6,10,1547,5,764,1.0,496.0,496.0,5,783,1.0,515.0,515.0
0.012,6,10,1677,5,827,2.0,559.0,559.0,5,850,3.0,582.0,582.0
176.444,17,70,10007,35,2330,5189.0,44.0,38.0,35,7677,5189.0,239.0,191.0
0.005,6,10,1854,5,889,1.0,621.0,621.0,5,965,1.0,697.0,697.0
0.004,17,2,148,1,60,0.0,32.0,32.0,1,88,0.0,60.0,60.0
0.081,6,10,1506,5,395,15.0,127.0,127.0,5,1111,18.0,843.0,843.0
1777.341,17,144,41760,72,22752,25032.0,288.0,288.0,72,19008,25032.0,236.0,236.0
0.006,6,10,1854,5,889,1.0,621.0,621.0,5,965,1.0,697.0,697.0
177.151,17,86,12316,43,2875,4217.0,44.0,38.0,43,9441,4217.0,260.0,191.0
0.016,6,10,1983,5,910,4.0,642.0,642.0,5,1073,3.0,805.0,805.0
40.051,17,10,676,5,460,10012.0,104.0,64.0,5,216,10012.0,20.0,15.0
0.089,6,10,1506,5,395,20.0,127.0,127.0,5,1111,20.0,843.0,843.0
0.004,6,10,1702,5,863,1.0,595.0,595.0,5,839,1.0,571.0,571.0
11.252,17,28,4421,14,1994,853.0,269.0,114.0,14,2427,853.0,586.0,145.0
0.009,6,10,1972,5,910,2.0,642.0,642.0,5,1062,2.0,794.0,794.0
40.066,17,10,676,5,460,10014.0,104.0,64.0,5,216,10015.0,20.0,15.0
0.086,6,10,1506,5,395,19.0,127.0,127.0,5,1111,18.0,843.0,843.0
0.13,6,10,1506,5,395,28.0,127.0,127.0,5,1111,29.0,843.0,843.0
0.005,6,10,2006,5,927,1.0,659.0,659.0,5,1079,1.0,811.0,811.0
40.058,17,10,676,5,460,10013.0,104.0,64.0,5,216,10013.0,20.0,15.0
0.202,6,16,2777,8,1395,28.0,533.0,323.0,8,1382,18.0,529.0,239.0
0.01,6,10,1972,5,910,2.0,642.0,642.0,5,1062,2.0,794.0,794.0
15.088,17,15,8021,8,5965,2151.0,1350.0,717.0,7,2056,2509.0,1350.0,265.0
0.006,6,10,1989,5,927,1.0,659.0,659.0,5,1062,1.0,794.0,794.0
0.072,17,4,284,2,120,0.0,32.0,32.0,2,164,69.0,60.0,54.0
0.022,6,10,1972,5,910,5.0,642.0,642.0,5,1062,5.0,794.0,794.0
0.01,6,10,1972,5,910,2.0,642.0,642.0,5,1062,2.0,794.0,794.0
0.005,6,14,3736,7,446,0.0,74.0,74.0,7,3290,0.0,1448.0,972.0
0.072,17,2,144,1,64,0.0,36.0,36.0,1,80,0.0,52.0,52.0
0.013,17,2,152,1,56,0.0,28.0,28.0,1,96,0.0,68.0,68.0
0.023,6,10,1990,5,911,5.0,643.0,643.0,5,1079,5.0,811.0,811.0
0.017,6,10,1972,5,910,4.0,642.0,642.0,5,1062,4.0,794.0,794.0
0.005,6,10,1689,5,839,1.0,571.0,571.0,5,850,1.0,582.0,582.0
0.005,6,13,3690,7,452,0.0,80.0,80.0,6,3238,1.0,1470.0,1459.0
0.08,17,2,136,1,60,0.0,32.0,32.0,1,76,0.0,48.0,48.0
0.005,6,10,2006,5,927,1.0,659.0,659.0,5,1079,1.0,811.0,811.0
0.015,17,2,198,1,91,0.0,63.0,63.0,1,107,0.0,79.0,79.0
0.006,6,10,2006,5,927,1.0,659.0,659.0,5,1079,1.0,811.0,811.0
0.118,6,10,1506,5,395,28.0,127.0,127.0,5,1111,28.0,843.0,843.0
0.006,17,2,170,1,65,0.0,37.0,37.0,1,105,0.0,77.0,77.0
0.004,17,2,136,1,60,0.0,32.0,32.0,1,76,0.0,48.0,48.0
0.009,6,10,1989,5,910,2.0,642.0,642.0,5,1079,2.0,811.0,811.0
0.078,6,10,1506,5,395,17.0,127.0,127.0,5,1111,16.0,843.0,843.0
0.006,6,10,1547,5,764,1.0,496.0,496.0,5,783,1.0,515.0,515.0
0.005,6,10,1643,5,860,1.0,592.0,592.0,5,783,1.0,515.0,515.0
0.128,6,10,1506,5,395,26.0,127.0,127.0,5,1111,26.0,843.0,843.0
0.005,17,2,180,1,66,0.0,38.0,38.0,1,114,0.0,86.0,86.0
0.079,6,10,1506,5,395,19.0,127.0,127.0,5,1111,18.0,843.0,843.0
0.005,6,13,3690,7,452,0.0,80.0,80.0,6,3238,1.0,1470.0,1459.0
0.017,6,10,1631,5,848,4.0,580.0,580.0,5,783,4.0,515.0,515.0
300.021,6,12,1782,7,1348,50003.0,494.0,494.0,5,434,75004.0,83.0,83.0
31.396,6,24,9313,13,1655,2616.0,794.0,367.0,11,7658,3126.0,1360.0,1029.0
0.005,6,10,2006,5,927,1.0,659.0,659.0,5,1079,1.0,811.0,811.0
301.118,6,45,14852,24,8985,13092.0,2720.0,999.0,21,5867,446.0,2667.0,385.0
43.1,6,46,17849,23,11902,413.0,2720.0,1368.0,23,5947,1951.0,2667.0,385.0
0.004,17,2,148,1,60,0.0,32.0,32.0,1,88,0.0,60.0,60.0
0.039,17,2,148,1,60,0.0,32.0,32.0,1,88,0.0,60.0,60.0
0.011,6,10,1990,5,911,2.0,643.0,643.0,5,1079,2.0,811.0,811.0
0.01,6,10,1547,5,764,2.0,496.0,496.0,5,783,2.0,515.0,515.0
0.005,6,10,1689,5,839,1.0,571.0,571.0,5,850,1.0,582.0,582.0
0.022,6,10,1989,5,910,5.0,642.0,642.0,5,1079,5.0,811.0,811.0
1730.43,6,45,2790,30,1725,59670.0,35.0,35.0,15,1065,123596.0,31.0,31.0
0.024,17,2,136,1,60,0.0,32.0,32.0,1,76,0.0,48.0,48.0
0.012,6,10,1990,5,911,3.0,643.0,643.0,5,1079,3.0,811.0,811.0
0.005,17,2,166,1,75,0.0,47.0,47.0,1,91,0.0,63.0,63.0
2.559,6,26,6264,15,2308,182.0,521.0,336.0,11,3956,245.0,1330.0,700.0
0.212,6,16,2777,8,1395,30.0,533.0,323.0,8,1382,19.0,529.0,239.0
40.095,17,10,676,5,460,10021.0,104.0,64.0,5,216,10023.0,20.0,15.0
0.004,17,2,136,1,60,0.0,32.0,32.0,1,76,0.0,48.0,48.0
0.006,6,10,1689,5,839,1.0,571.0,571.0,5,850,1.0,582.0,582.0
0.017,6,10,1989,5,910,4.0,642.0,642.0,5,1079,4.0,811.0,811.0
0.01,6,10,1990,5,911,2.0,643.0,643.0,5,1079,2.0,811.0,811.0
0.016,6,10,1762,5,911,4.0,643.0,643.0,5,851,3.0,583.0,583.0
0.006,6,10,1547,5,764,1.0,496.0,496.0,5,783,1.0,515.0,515.0
0.085,6,10,1506,5,395,18.0,127.0,127.0,5,1111,18.0,843.0,843.0
0.004,17,2,136,1,60,0.0,32.0,32.0,1,76,0.0,48.0,48.0
0.005,6,10,1779,5,928,1.0,660.0,660.0,5,851,1.0,583.0,583.0
0.005,6,10,1643,5,860,1.0,592.0,592.0,5,783,1.0,515.0,515.0
10.802,17,28,4422,14,1995,822.0,270.0,114.0,14,2427,822.0,586.0,145.0
0.005,6,10,1689,5,839,1.0,571.0,571.0,5,850,1.0,582.0,582.0
1790.482,6,240,35580,150,25920,12016.0,302.0,302.0,90,9660,20117.0,83.0,83.0
15.074,17,15,9239,8,6902,2149.0,1350.0,834.0,7,2337,2507.0,1350.0,305.0
0.124,6,10,1506,5,395,29.0,127.0,127.0,5,1111,28.0,843.0,843.0
0.005,6,10,2006,5,927,1.0,659.0,659.0,5,1079,1.0,811.0,811.0
0.07,6,10,1506,5,395,15.0,127.0,127.0,5,1111,14.0,843.0,843.0
0.117,6,10,1506,5,395,28.0,127.0,127.0,5,1111,22.0,843.0,843.0
0.011,6,10,1989,5,910,2.0,642.0,642.0,5,1079,2.0,811.0,811.0
0.005,6,14,3736,7,446,0.0,74.0,74.0,7,3290,0.0,1448.0,972.0
0.01,6,10,1677,5,827,2.0,559.0,559.0,5,850,2.0,582.0,582.0
0.011,6,10,1677,5,827,2.0,559.0,559.0,5,850,2.0,582.0,582.0
0.07,6,10,1506,5,395,14.0,127.0,127.0,5,1111,15.0,843.0,843.0
0.08,6,10,1506,5,395,15.0,127.0,127.0,5,1111,17.0,843.0,843.0
0.001,17,2,180,1,66,0.0,38.0,38.0,1,114,0.0,86.0,86.0
10.82,17,28,4419,14,1995,823.0,270.0,114.0,14,2424,823.0,587.0,145.0
240.153,6,46,6750,22,3220,11435.0,588.0,229.0,24,3530,10441.0,580.0,206.0
0.038,17,2,412,1,61,0.0,33.0,33.0,1,351,0.0,323.0,323.0
309.21,17,18,1008,9,640,38636.0,48.0,43.0,9,368,38636.0,20.0,12.0
0.001,17,2,180,1,66,0.0,38.0,38.0,1,114,0.0,86.0,86.0
312.184,17,18,1008,9,640,39006.0,48.0,43.0,9,368,39004.0,20.0,12.0
0.005,6,10,1689,5,839,1.0,571.0,571.0,5,850,1.0,582.0,582.0
0.054,6,10,1506,5,395,12.0,127.0,127.0,5,1111,11.0,843.0,843.0
0.024,6,10,1989,5,910,6.0,642.0,642.0,5,1079,6.0,811.0,811.0
0.006,17,2,166,1,75,0.0,47.0,47.0,1,91,0.0,63.0,63.0
0.009,6,12,1926,6,1189,1.0,659.0,434.0,6,737,1.0,417.0,417.0
240.463,6,36,10182,18,1883,14143.0,555.0,187.0,18,8299,14142.0,1402.0,613.0
0.004,17,2,148,1,60,0.0,32.0,32.0,1,88,0.0,60.0,60.0
0.018,6,10,1983,5,910,4.0,642.0,642.0,5,1073,4.0,805.0,805.0
0.072,17,4,284,2,120,0.0,32.0,32.0,2,164,69.0,60.0,54.0
0.005,6,10,2006,5,927,1.0,659.0,659.0,5,1079,1.0,811.0,811.0
0.017,6,10,1989,5,910,4.0,642.0,642.0,5,1079,4.0,811.0,811.0
0.001,17,2,136,1,60,0.0,32.0,32.0,1,76,0.0,48.0,48.0
0.006,17,2,230,1,68,0.0,40.0,40.0,1,162,0.0,134.0,134.0
0.007,17,2,194,1,59,0.0,31.0,31.0,1,135,0.0,107.0,107.0
0.005,6,10,2000,5,927,1.0,659.0,659.0,5,1073,1.0,805.0,805.0
0.004,17,2,148,1,60,0.0,32.0,32.0,1,88,0.0,60.0,60.0
0.011,6,10,1989,5,910,2.0,642.0,642.0,5,1079,2.0,811.0,811.0
0.004,17,2,136,1,60,0.0,32.0,32.0,1,76,0.0,48.0,48.0
0.004,6,10,2000,5,927,1.0,659.0,659.0,5,1073,1.0,805.0,805.0
0.001,17,2,180,1,66,0.0,38.0,38.0,1,114,0.0,86.0,86.0
0.007,6,10,1547,5,764,1.0,496.0,496.0,5,783,1.0,515.0,515.0
9.039,17,6,376,5,280,2259.0,28.0,28.0,1,96,0.0,68.0,68.0
0.003,17,2,148,1,60,0.0,32.0,32.0,1,88,0.0,60.0,60.0
0.026,6,14,3787,7,497,4.0,125.0,125.0,7,3290,4.0,1448.0,972.0
0.01,6,10,1972,5,910,2.0,642.0,642.0,5,1062,2.0,794.0,794.0
0.011,6,10,1983,5,910,2.0,642.0,642.0,5,1073,2.0,805.0,805.0
0.005,6,10,2000,5,927,1.0,659.0,659.0,5,1073,1.0,805.0,805.0
0.023,6,10,1990,5,911,5.0,643.0,643.0,5,1079,5.0,811.0,811.0
0.005,6,10,1989,5,927,1.0,659.0,659.0,5,1062,1.0,794.0,794.0
0.006,6,10,2000,5,927,1.0,659.0,659.0,5,1073,1.0,805.0,805.0
0.006,6,12,1698,6,863,1.0,327.0,271.0,6,835,1.0,515.0,515.0
240.011,6,9,787,5,488,60002.0,232.0,232.0,4,299,80002.0,83.0,83.0
0.017,6,10,1972,5,910,4.0,642.0,642.0,5,1062,4.0,794.0,794.0
0.289,17,39,20171,21,17043,14.0,1350.0,783.0,18,3128,13.0,1350.0,145.0
0.047,6,10,1990,5,911,11.0,643.0,643.0,5,1079,11.0,811.0,811.0
0.006,6,10,2007,5,928,1.0,660.0,660.0,5,1079,1.0,811.0,811.0
0.039,17,4,284,2,120,0.0,32.0,32.0,2,164,36.0,60.0,54.0
240.016,6,9,787,5,488,60004.0,232.0,232.0,4,299,80004.0,83.0,83.0
10.699,17,28,4421,14,1994,814.0,269.0,114.0,14,2427,814.0,586.0,145.0
0.095,6,26,10207,13,8838,7.0,2883.0,1360.0,13,1369,7.0,259.0,115.0
0.009,6,10,1631,5,848,2.0,580.0,580.0,5,783,2.0,515.0,515.0
0.103,6,10,1506,5,395,24.0,127.0,127.0,5,1111,23.0,843.0,843.0
0.006,17,2,144,1,64,0.0,36.0,36.0,1,80,0.0,52.0,52.0
15.22,17,40,21557,22,18414,723.0,1350.0,809.0,18,3143,893.0,1350.0,146.0
0.012,6,10,1989,5,910,3.0,642.0,642.0,5,1079,2.0,811.0,811.0
0.087,6,10,1506,5,395,20.0,127.0,127.0,5,1111,19.0,843.0,843.0
0.005,17,2,144,1,64,0.0,36.0,36.0,1,80,0.0,52.0,52.0
0.001,17,2,136,1,60,0.0,32.0,32.0,1,76,0.0,48.0,48.0
0.003,17,2,148,1,60,0.0,32.0,32.0,1,88,0.0,60.0,60.0
0.004,6,10,1779,5,928,1.0,660.0,660.0,5,851,1.0,583.0,583.0
0.07,17,8,3613,4,1874,23.0,1350.0,440.0,4,1739,12.0,1350.0,406.0
240.294,6,36,10397,18,2211,14134.0,555.0,253.0,18,8186,14134.0,1402.0,604.0
40.06,17,10,676,5,460,10012.0,104.0,64.0,5,216,10014.0,20.0,15.0
0.167,17,2,152,1,76,0.0,48.0,48.0,1,76,0.0,48.0,48.0
0.01,6,10,1989,5,927,2.0,659.0,659.0,5,1062,2.0,794.0,794.0
0.098,6,10,1506,5,395,21.0,127.0,127.0,5,1111,21.0,843.0,843.0
0.008,6,12,1926,6,1189,1.0,659.0,434.0,6,737,1.0,417.0,417.0
0.004,17,2,152,1,76,0.0,48.0,48.0,1,76,0.0,48.0,48.0
0.012,6,10,1631,5,848,2.0,580.0,580.0,5,783,3.0,515.0,515.0
0.02,17,2,138,1,61,0.0,33.0,33.0,1,77,0.0,49.0,49.0
0.008,17,2,194,1,59,0.0,31.0,31.0,1,135,0.0,107.0,107.0
0.066,17,8,3613,4,1874,22.0,1350.0,440.0,4,1739,11.0,1350.0,406.0
10.758,17,26,4103,13,1846,887.0,269.0,114.0,13,2257,887.0,588.0,145.0
0.101,6,10,1506,5,395,23.0,127.0,127.0,5,1111,20.0,843.0,843.0
0.008,6,10,2007,5,928,2.0,660.0,660.0,5,1079,1.0,811.0,811.0
40.066,17,10,676,5,460,10015.0,104.0,64.0,5,216,10015.0,20.0,15.0
412.004,6,29,4409,12,3102,10912.0,494.0,494.0,17,1307,25750.0,83.0,83.0
0.004,17,2,148,1,60,0.0,32.0,32.0,1,88,0.0,60.0,60.0
0.056,17,2,152,1,76,0.0,48.0,48.0,1,76,0.0,48.0,48.0
0.013,6,10,1972,5,910,3.0,642.0,642.0,5,1062,3.0,794.0,794.0
0.145,6,10,1506,5,395,35.0,127.0,127.0,5,1111,32.0,843.0,843.0
0.009,6,10,1631,5,848,2.0,580.0,580.0,5,783,2.0,515.0,515.0
0.014,6,10,1990,5,911,3.0,643.0,643.0,5,1079,3.0,811.0,811.0
0.017,6,10,1990,5,911,4.0,643.0,643.0,5,1079,4.0,811.0,811.0
0.008,17,2,194,1,59,0.0,31.0,31.0,1,135,0.0,107.0,107.0
0.004,6,10,2006,5,927,1.0,659.0,659.0,5,1079,1.0,811.0,811.0
0.079,6,10,1506,5,395,16.0,127.0,127.0,5,1111,17.0,843.0,843.0
0.005,17,2,230,1,68,0.0,40.0,40.0,1,162,0.0,134.0,134.0
0.001,17,2,180,1,66,0.0,38.0,38.0,1,114,0.0,86.0,86.0
0.005,6,13,3690,7,452,0.0,80.0,80.0,6,3238,1.0,1470.0,1459.0
0.004,6,10,2007,5,928,1.0,660.0,660.0,5,1079,1.0,811.0,811.0
0.039,17,2,186,1,61,0.0,33.0,33.0,1,125,0.0,97.0,97.0
0.006,6,10,1547,5,764,1.0,496.0,496.0,5,783,1.0,515.0,515.0
240.018,6,9,787,5,488,60004.0,232.0,232.0,4,299,80005.0,83.0,83.0
40.049,17,10,676,5,460,10011.0,104.0,64.0,5,216,10011.0,20.0,15.0
15.082,17,15,8143,8,6024,2150.0,1350.0,725.0,7,2119,2508.0,1350.0,274.0
0.005,6,10,2006,5,927,1.0,659.0,659.0,5,1079,1.0,811.0,811.0
0.006,6,10,2000,5,927,1.0,659.0,659.0,5,1073,1.0,805.0,805.0
0.006,6,10,1547,5,764,1.0,496.0,496.0,5,783,1.0,515.0,515.0
0.012,6,10,1631,5,848,3.0,580.0,580.0,5,783,2.0,515.0,515.0
0.013,6,10,1983,5,910,3.0,642.0,642.0,5,1073,3.0,805.0,805.0
40.056,17,10,676,5,460,10013.0,104.0,64.0,5,216,10013.0,20.0,15.0
0.054,17,2,152,1,76,0.0,48.0,48.0,1,76,0.0,48.0,48.0
0.138,6,10,1506,5,395,30.0,127.0,127.0,5,1111,33.0,843.0,843.0
0.004,6,10,2007,5,928,1.0,660.0,660.0,5,1079,1.0,811.0,811.0
0.107,6,10,1506,5,395,25.0,127.0,127.0,5,1111,26.0,843.0,843.0
15.073,17,15,9238,8,6902,2149.0,1350.0,834.0,7,2336,2506.0,1350.0,305.0
0.008,6,10,1983,5,910,2.0,642.0,642.0,5,1073,2.0,805.0,805.0
0.107,6,10,1506,5,395,25.0,127.0,127.0,5,1111,23.0,843.0,843.0
0.227,17,2,152,1,76,0.0,48.0,48.0,1,76,0.0,48.0,48.0
0.005,17,2,179,1,71,0.0,43.0,43.0,1,108,0.0,80.0,80.0
0.005,6,13,3747,7,509,0.0,137.0,137.0,6,3238,0.0,1470.0,1459.0
10.804,17,28,4421,14,1993,822.0,268.0,114.0,14,2428,822.0,587.0,145.0
0.003,17,2,136,1,60,0.0,32.0,32.0,1,76,0.0,48.0,48.0
0.037,17,2,136,1,60,0.0,32.0,32.0,1,76,0.0,48.0,48.0
0.005,17,2,144,1,64,0.0,36.0,36.0,1,80,0.0,52.0,52.0
11.211,17,28,4420,14,1993,849.0,268.0,114.0,14,2427,848.0,586.0,145.0
126.128,6,14,2938,8,2504,17980.0,1414.0,1086.0,6,434,25169.0,182.0,182.0
0.005,6,10,2006,5,927,1.0,659.0,659.0,5,1079,1.0,811.0,811.0
0.008,6,10,1989,5,910,2.0,642.0,642.0,5,1079,2.0,811.0,811.0
0.005,6,10,1689,5,839,1.0,571.0,571.0,5,850,1.0,582.0,582.0
0.071,17,2,148,1,60,0.0,32.0,32.0,1,88,0.0,60.0,60.0
0.005,6,10,1989,5,927,1.0,659.0,659.0,5,1062,1.0,794.0,794.0
0.009,6,10,1762,5,911,2.0,643.0,643.0,5,851,2.0,583.0,583.0
0.005,17,2,140,1,62,0.0,34.0,34.0,1,78,0.0,50.0,50.0
0.011,6,14,3787,7,497,1.0,125.0,125.0,7,3290,1.0,1448.0,972.0
0.068,17,8,3613,4,1874,22.0,1350.0,440.0,4,1739,11.0,1350.0,406.0
0.01,6,10,1854,5,889,2.0,621.0,621.0,5,965,2.0,697.0,697.0
0.005,6,10,2006,5,927,1.0,659.0,659.0,5,1079,1.0,811.0,811.0
0.015,6,10,1972,5,910,3.0,642.0,642.0,5,1062,3.0,794.0,794.0
0.018,6,10,1989,5,910,4.0,642.0,642.0,5,1079,4.0,811.0,811.0
0.001,17,2,180,1,66,0.0,38.0,38.0,1,114,0.0,86.0,86.0
0.162,17,2,152,1,76,0.0,48.0,48.0,1,76,0.0,48.0,48.0
0.089,6,10,1506,5,395,20.0,127.0,127.0,5,1111,19.0,843.0,843.0
0.132,17,2,166,1,75,0.0,47.0,47.0,1,91,0.0,63.0,63.0
0.004,6,10,2006,5,927,1.0,659.0,659.0,5,1079,1.0,811.0,811.0
0.005,6,10,1643,5,860,1.0,592.0,592.0,5,783,1.0,515.0,515.0
0.024,6,10,1677,5,827,6.0,559.0,559.0,5,850,5.0,582.0,582.0
0.006,6,10,2007,5,928,1.0,660.0,660.0,5,1079,1.0,811.0,811.0
308.293,17,20,1124,10,716,34240.0,48.0,43.0,10,408,34240.0,20.0,12.0
0.004,6,10,2000,5,927,1.0,659.0,659.0,5,1073,1.0,805.0,805.0
0.004,6,10,2007,5,928,1.0,660.0,660.0,5,1079,1.0,811.0,811.0
0.119,6,10,1506,5,395,25.0,127.0,127.0,5,1111,25.0,843.0,843.0
0.109,6,10,1506,5,395,23.0,127.0,127.0,5,1111,23.0,843.0,843.0
0.107,6,10,1506,5,395,24.0,127.0,127.0,5,1111,22.0,843.0,843.0
0.087,6,10,1506,5,395,17.0,127.0,127.0,5,1111,19.0,843.0,843.0
0.004,6,10,2006,5,927,1.0,659.0,659.0,5,1079,1.0,811.0,811.0
0.005,17,2,144,1,64,0.0,36.0,36.0,1,80,0.0,52.0,52.0
0.005,6,10,2000,5,927,1.0,659.0,659.0,5,1073,1.0,805.0,805.0
0.119,6,10,1506,5,395,27.0,127.0,127.0,5,1111,28.0,843.0,843.0
353.329,6,20,2210,6,1308,12004.0,494.0,494.0,14,902,27178.0,83.0,83.0
0.012,6,10,1983,5,910,2.0,642.0,642.0,5,1073,3.0,805.0,805.0
0.003,17,4,284,2,120,0.0,32.0,32.0,2,164,0.0,60.0,54.0
0.009,6,10,1989,5,910,2.0,642.0,642.0,5,1079,2.0,811.0,811.0
364.385,6,21,1795,16,1030,24292.0,190.0,190.0,5,765,60010.0,464.0,248.0
309.271,17,20,1124,10,716,34349.0,48.0,43.0,10,408,34349.0,20.0,12.0
0.005,6,10,2000,5,927,1.0,659.0,659.0,5,1073,1.0,805.0,805.0
0.005,17,2,164,1,74,0.0,46.0,46.0,1,90,0.0,62.0,62.0
0.004,17,4,284,2,120,1.0,32.0,32.0,2,164,0.0,60.0,54.0
0.003,17,2,136,1,60,0.0,32.0,32.0,1,76,0.0,48.0,48.0
0.084,6,10,1506,5,395,19.0,127.0,127.0,5,1111,19.0,843.0,843.0
0.001,17,2,180,1,66,0.0,38.0,38.0,1,114,0.0,86.0,86.0
0.004,6,10,1779,5,928,1.0,660.0,660.0,5,851,1.0,583.0,583.0
15.088,17,16,8983,8,6707,2151.0,1350.0,810.0,8,2276,2151.0,1350.0,256.0
0.006,6,10,1643,5,860,1.0,592.0,592.0,5,783,1.0,515.0,515.0
0.005,6,10,2006,5,927,1.0,659.0,659.0,5,1079,1.0,811.0,811.0
0.113,6,10,1506,5,395,26.0,127.0,127.0,5,1111,23.0,843.0,843.0
0.1,6,10,1506,5,395,23.0,127.0,127.0,5,1111,20.0,843.0,843.0
0.084,6,10,1506,5,395,20.0,127.0,127.0,5,1111,18.0,843.0,843.0
40.074,17,10,676,5,460,10015.0,104.0,64.0,5,216,10015.0,20.0,15.0
0.005,6,10,1854,5,889,1.0,621.0,621.0,5,965,1.0,697.0,697.0
0.006,6,10,1689,5,839,1.0,571.0,571.0,5,850,1.0,582.0,582.0
0.022,6,10,1972,5,910,5.0,642.0,642.0,5,1062,5.0,794.0,794.0
40.064,17,10,676,5,460,10014.0,104.0,64.0,5,216,10015.0,20.0,15.0
0.125,6,10,1506,5,395,30.0,127.0,127.0,5,1111,26.0,843.0,843.0
0.004,6,14,3742,7,452,0.0,80.0,80.0,7,3290,0.0,1448.0,972.0
0.002,17,2,185,1,73,0.0,45.0,45.0,1,112,0.0,84.0,84.0
0.005,6,10,2006,5,927,1.0,659.0,659.0,5,1079,1.0,811.0,811.0
0.004,6,10,1989,5,927,1.0,659.0,659.0,5,1062,1.0,794.0,794.0
0.129,6,10,1506,5,395,29.0,127.0,127.0,5,1111,30.0,843.0,843.0
0.004,17,2,148,1,60,0.0,32.0,32.0,1,88,0.0,60.0,60.0
0.003,17,2,152,1,76,0.0,48.0,48.0,1,76,0.0,48.0,48.0
0.005,6,10,2007,5,928,1.0,660.0,660.0,5,1079,1.0,811.0,811.0
0.109,6,10,1506,5,395,23.0,127.0,127.0,5,1111,22.0,843.0,843.0
0.008,17,2,299,1,65,0.0,37.0,37.0,1,234,0.0,206.0,206.0
0.005,6,10,2000,5,927,1.0,659.0,659.0,5,1073,1.0,805.0,805.0
0.07,6,10,1506,5,395,15.0,127.0,127.0,5,1111,17.0,843.0,843.0
0.208,6,16,2777,8,1395,29.0,533.0,323.0,8,1382,19.0,529.0,239.0
241.418,6,313,343163,114,17442,2136.0,2736.0,886.0,199,325721,1219.0,2804.0,1668.0
0.005,6,10,1689,5,839,1.0,571.0,571.0,5,850,1.0,582.0,582.0
0.013,6,10,1762,5,911,3.0,643.0,643.0,5,851,3.0,583.0,583.0
0.006,17,2,169,1,62,0.0,34.0,34.0,1,107,0.0,79.0,79.0
0.116,6,10,1506,5,395,24.0,127.0,127.0,5,1111,26.0,843.0,843.0
0.059,6,10,1983,5,910,14.0,642.0,642.0,5,1073,14.0,805.0,805.0
0.062,6,10,1506,5,395,13.0,127.0,127.0,5,1111,15.0,843.0,843.0
0.005,6,10,2006,5,927,1.0,659.0,659.0,5,1079,1.0,811.0,811.0
0.005,6,10,1774,5,923,1.0,655.0,655.0,5,851,1.0,583.0,583.0
0.015,6,10,1990,5,911,3.0,643.0,643.0,5,1079,3.0,811.0,811.0
364.407,6,19,1689,15,978,26029.0,190.0,190.0,4,711,80015.0,495.0,495.0
0.005,6,10,2006,5,927,1.0,659.0,659.0,5,1079,1.0,811.0,811.0
0.233,6,16,2778,8,1396,33.0,533.0,324.0,8,1382,21.0,529.0,239.0
0.006,17,2,335,1,68,0.0,40.0,40.0,1,267,0.0,239.0,239.0
0.006,6,10,1547,5,764,1.0,496.0,496.0,5,783,1.0,515.0,515.0
10.857,17,26,4101,13,1821,896.0,268.0,112.0,13,2280,895.0,587.0,147.0
0.073,17,2,170,1,65,0.0,37.0,37.0,1,105,0.0,77.0,77.0
240.241,6,40,5374,20,2430,12644.0,581.0,195.0,20,2944,12644.0,566.0,270.0
0.01,6,10,1972,5,910,2.0,642.0,642.0,5,1062,2.0,794.0,794.0
0.084,6,10,1506,5,395,17.0,127.0,127.0,5,1111,17.0,843.0,843.0
0.097,6,10,1506,5,395,18.0,127.0,127.0,5,1111,20.0,843.0,843.0
0.014,6,10,1990,5,911,3.0,643.0,643.0,5,1079,3.0,811.0,811.0
0.011,6,10,1972,5,910,2.0,642.0,642.0,5,1062,2.0,794.0,794.0
0.005,6,10,1689,5,839,1.0,571.0,571.0,5,850,1.0,582.0,582.0
0.052,17,2,144,1,64,0.0,36.0,36.0,1,80,0.0,52.0,52.0
0.039,17,2,182,1,65,0.0,37.0,37.0,1,117,0.0,89.0,89.0
292.527,6,376,346532,186,21228,1581.0,2736.0,888.0,190,325304,1547.0,2804.0,1792.0
40.066,17,10,676,5,460,10015.0,104.0,64.0,5,216,10015.0,20.0,15.0
0.005,6,10,2006,5,927,1.0,659.0,659.0,5,1079,1.0,811.0,811.0
0.074,6,10,1506,5,395,17.0,127.0,127.0,5,1111,17.0,843.0,843.0
0.005,6,10,2006,5,927,1.0,659.0,659.0,5,1079,1.0,811.0,811.0
0.083,6,10,1506,5,395,17.0,127.0,127.0,5,1111,17.0,843.0,843.0
0.063,6,10,1506,5,395,13.0,127.0,127.0,5,1111,13.0,843.0,843.0
0.005,6,10,2006,5,927,1.0,659.0,659.0,5,1079,1.0,811.0,811.0
0.001,17,2,180,1,66,0.0,38.0,38.0,1,114,0.0,86.0,86.0
0.102,6,10,1506,5,395,22.0,127.0,127.0,5,1111,20.0,843.0,843.0
0.071,17,2,396,1,61,0.0,33.0,33.0,1,335,0.0,307.0,307.0
0.028,6,10,1989,5,910,6.0,642.0,642.0,5,1079,7.0,811.0,811.0
0.01,6,10,1972,5,910,2.0,642.0,642.0,5,1062,2.0,794.0,794.0
0.045,6,10,1990,5,911,11.0,643.0,643.0,5,1079,11.0,811.0,811.0
0.146,6,10,1506,5,395,32.0,127.0,127.0,5,1111,33.0,843.0,843.0
0.005,6,10,1643,5,860,1.0,592.0,592.0,5,783,1.0,515.0,515.0
240.476,6,20,7221,11,1823,24047.0,990.0,418.0,9,5398,30059.0,1591.0,984.0
10.817,17,28,4421,14,1994,823.0,269.0,114.0,14,2427,823.0,586.0,145.0
0.076,17,2,144,1,64,0.0,36.0,36.0,1,80,0.0,52.0,52.0
253.304,6,38,9598,15,6521,18093.0,1645.0,638.0,23,3077,11513.0,580.0,133.0
0.009,6,10,1989,5,910,2.0,642.0,642.0,5,1079,2.0,811.0,811.0
0.088,6,10,1506,5,395,19.0,127.0,127.0,5,1111,19.0,843.0,843.0
0.008,6,10,1989,5,910,2.0,642.0,642.0,5,1079,1.0,811.0,811.0
0.15,6,10,1506,5,395,28.0,127.0,127.0,5,1111,36.0,843.0,843.0
0.016,6,10,1972,5,910,4.0,642.0,642.0,5,1062,4.0,794.0,794.0
0.008,6,10,1989,5,910,1.0,642.0,642.0,5,1079,1.0,811.0,811.0
0.11,6,10,1506,5,395,26.0,127.0,127.0,5,1111,23.0,843.0,843.0
0.005,6,10,1689,5,839,1.0,571.0,571.0,5,850,1.0,582.0,582.0
0.01,6,10,1989,5,910,2.0,642.0,642.0,5,1079,2.0,811.0,811.0
0.077,6,10,1506,5,395,16.0,127.0,127.0,5,1111,17.0,843.0,843.0
0.004,17,2,136,1,60,0.0,32.0,32.0,1,76,0.0,48.0,48.0
0.005,6,10,1989,5,927,1.0,659.0,659.0,5,1062,1.0,794.0,794.0
0.082,6,10,1506,5,395,18.0,127.0,127.0,5,1111,18.0,843.0,843.0
0.02,6,10,1631,5,848,5.0,580.0,580.0,5,783,5.0,515.0,515.0
11.107,17,28,4390,14,2312,845.0,587.0,137.0,14,2078,845.0,269.0,120.0
10.882,17,28,4422,14,1993,828.0,268.0,114.0,14,2429,828.0,588.0,145.0
240.094,6,16,4481,9,963,30011.0,238.0,166.0,7,3518,40015.0,1402.0,786.0
0.011,17,2,179,1,71,0.0,43.0,43.0,1,108,0.0,80.0,80.0
0.013,6,10,1990,5,911,3.0,643.0,643.0,5,1079,3.0,811.0,811.0
0.003,17,2,136,1,60,0.0,32.0,32.0,1,76,0.0,48.0,48.0
0.017,6,10,1990,5,911,4.0,643.0,643.0,5,1079,4.0,811.0,811.0
10.858,17,28,4421,14,1994,826.0,269.0,114.0,14,2427,826.0,586.0,145.0
0.004,6,10,2006,5,927,1.0,659.0,659.0,5,1079,1.0,811.0,811.0
1789.152,6,287,27099,144,9928,12511.0,747.0,270.0,143,17171,12599.0,1626.0,71.0
0.013,6,10,1989,5,910,3.0,642.0,642.0,5,1079,3.0,811.0,811.0
0.004,6,10,2006,5,927,1.0,659.0,659.0,5,1079,1.0,811.0,811.0
0.005,6,10,2006,5,927,1.0,659.0,659.0,5,1079,1.0,811.0,811.0
0.123,6,10,1506,5,395,25.0,127.0,127.0,5,1111,23.0,843.0,843.0
0.109,6,10,1506,5,395,23.0,127.0,127.0,5,1111,25.0,843.0,843.0
0.005,6,14,3799,7,509,0.0,137.0,137.0,7,3290,0.0,1448.0,972.0
0.005,6,10,1643,5,860,1.0,592.0,592.0,5,783,1.0,515.0,515.0
0.037,17,2,380,1,61,0.0,33.0,33.0,1,319,0.0,291.0,291.0
0.042,6,13,3735,7,497,7.0,125.0,125.0,6,3238,8.0,1470.0,1459.0
0.011,6,10,1989,5,910,2.0,642.0,642.0,5,1079,2.0,811.0,811.0
0.012,6,10,1972,5,910,2.0,642.0,642.0,5,1062,2.0,794.0,794.0
300.358,6,16,2170,9,684,37523.0,146.0,146.0,7,1486,50031.0,419.0,398.0
40.066,17,10,676,5,460,10013.0,104.0,64.0,5,216,10015.0,20.0,15.0
0.067,6,10,1506,5,395,14.0,127.0,127.0,5,1111,16.0,843.0,843.0
0.07,6,10,1506,5,395,17.0,127.0,127.0,5,1111,13.0,843.0,843.0
0.006,17,2,166,1,75,0.0,47.0,47.0,1,91,0.0,63.0,63.0
0.045,17,2,144,1,64,0.0,36.0,36.0,1,80,0.0,52.0,52.0
0.004,17,2,136,1,60,0.0,32.0,32.0,1,76,0.0,48.0,48.0
10.819,17,28,4419,14,1994,823.0,269.0,114.0,14,2425,823.0,588.0,145.0
11.179,17,28,4422,14,1994,847.0,269.0,114.0,14,2428,847.0,587.0,145.0
0.007,6,10,1854,5,889,1.0,621.0,621.0,5,965,1.0,697.0,697.0
0.005,6,10,1854,5,889,1.0,621.0,621.0,5,965,1.0,697.0,697.0
0.194,6,10,1506,5,395,47.0,127.0,127.0,5,1111,44.0,843.0,843.0
6.059,6,28,12352,15,1396,432.0,304.0,304.0,13,10956,504.0,1402.0,1140.0
0.11,6,10,1506,5,395,25.0,127.0,127.0,5,1111,24.0,843.0,843.0
0.004,6,10,2006,5,927,1.0,659.0,659.0,5,1079,1.0,811.0,811.0
0.005,6,10,1854,5,889,1.0,621.0,621.0,5,965,1.0,697.0,697.0
0.013,6,10,1631,5,848,3.0,580.0,580.0,5,783,3.0,515.0,515.0
582.62,6,34,8502,18,3230,34271.0,655.0,381.0,16,5272,34837.0,1402.0,492.0
0.001,17,2,142,1,63,0.0,35.0,35.0,1,79,0.0,51.0,51.0
0.006,17,2,144,1,64,0.0,36.0,36.0,1,80,0.0,52.0,52.0
0.07,17,8,3613,4,1874,23.0,1350.0,440.0,4,1739,12.0,1350.0,406.0
0.107,6,10,1506,5,395,21.0,127.0,127.0,5,1111,25.0,843.0,843.0
371.527,6,22,2313,16,867,24768.0,195.0,195.0,6,1446,4638.0,419.0,398.0
0.004,6,10,1774,5,923,1.0,655.0,655.0,5,851,1.0,583.0,583.0
300.405,6,16,2170,9,684,37530.0,146.0,146.0,7,1486,50040.0,419.0,398.0
0.01,6,10,1989,5,910,2.0,642.0,642.0,5,1079,2.0,811.0,811.0
0.016,6,10,1972,5,910,4.0,642.0,642.0,5,1062,3.0,794.0,794.0
0.006,6,10,1854,5,889,1.0,621.0,621.0,5,965,1.0,697.0,697.0
0.013,6,10,1989,5,910,3.0,642.0,642.0,5,1079,3.0,811.0,811.0
0.005,6,13,3747,7,509,0.0,137.0,137.0,6,3238,1.0,1470.0,1459.0
0.001,17,2,180,1,66,0.0,38.0,38.0,1,114,0.0,86.0,86.0
40.055,17,10,676,5,460,10013.0,104.0,64.0,5,216,10013.0,20.0,15.0
0.004,6,10,1779,5,928,1.0,660.0,660.0,5,851,1.0,583.0,583.0
0.005,17,2,166,1,75,0.0,47.0,47.0,1,91,0.0,63.0,63.0
0.039,17,4,284,2,120,0.0,32.0,32.0,2,164,36.0,60.0,54.0
0.001,17,2,180,1,66,0.0,38.0,38.0,1,114,0.0,86.0,86.0
0.019,6,10,1989,5,910,4.0,642.0,642.0,5,1079,4.0,811.0,811.0
0.005,6,10,1774,5,923,1.0,655.0,655.0,5,851,1.0,583.0,583.0
0.017,6,10,1989,5,910,4.0,642.0,642.0,5,1079,4.0,811.0,811.0
0.005,17,2,214,1,75,0.0,47.0,47.0,1,139,0.0,111.0,111.0
0.123,6,14,4388,8,923,17.0,238.0,166.0,6,3465,16.0,1402.0,786.0
0.028,6,10,1990,5,911,7.0,643.0,643.0,5,1079,7.0,811.0,811.0
240.012,6,9,787,5,488,60003.0,232.0,232.0,4,299,80002.0,83.0,83.0
0.084,6,10,1506,5,395,17.0,127.0,127.0,5,1111,20.0,843.0,843.0
0.005,6,10,1989,5,927,1.0,659.0,659.0,5,1062,1.0,794.0,794.0
0.019,6,10,1972,5,910,4.0,642.0,642.0,5,1062,4.0,794.0,794.0
0.007,6,10,1689,5,839,1.0,571.0,571.0,5,850,1.0,582.0,582.0
0.001,17,2,180,1,66,0.0,38.0,38.0,1,114,0.0,86.0,86.0
57.246,6,26,5212,14,1186,4403.0,180.0,75.0,12,4026,5204.0,1593.0,678.0
0.108,6,10,1506,5,395,23.0,127.0,127.0,5,1111,25.0,843.0,843.0
0.001,17,2,166,1,75,0.0,47.0,47.0,1,91,0.0,63.0,63.0
0.103,6,10,1506,5,395,24.0,127.0,127.0,5,1111,24.0,843.0,843.0
0.008,6,10,1972,5,910,1.0,642.0,642.0,5,1062,2.0,794.0,794.0
0.005,6,10,1702,5,863,1.0,595.0,595.0,5,839,1.0,571.0,571.0
0.057,17,2,179,1,71,0.0,43.0,43.0,1,108,0.0,80.0,80.0
0.076,6,10,1506,5,395,17.0,127.0,127.0,5,1111,16.0,843.0,843.0
0.011,6,10,1990,5,911,2.0,643.0,643.0,5,1079,2.0,811.0,811.0
0.006,6,10,1547,5,764,1.0,496.0,496.0,5,783,1.0,515.0,515.0
0.013,6,10,1983,5,910,3.0,642.0,642.0,5,1073,3.0,805.0,805.0
0.005,6,10,1689,5,839,1.0,571.0,571.0,5,850,1.0,582.0,582.0
0.01,6,10,1989,5,910,2.0,642.0,642.0,5,1079,2.0,811.0,811.0
0.005,6,10,1689,5,839,1.0,571.0,571.0,5,850,1.0,582.0,582.0
11.138,17,28,4388,14,2311,848.0,586.0,137.0,14,2077,848.0,268.0,120.0
240.018,6,9,787,5,488,60004.0,232.0,232.0,4,299,80005.0,83.0,83.0
0.012,6,14,3787,7,497,2.0,125.0,125.0,7,3290,1.0,1448.0,972.0
0.102,6,10,1506,5,395,20.0,127.0,127.0,5,1111,22.0,843.0,843.0
0.018,6,10,1677,5,827,4.0,559.0,559.0,5,850,4.0,582.0,582.0
0.004,17,4,420,2,122,0.0,33.0,33.0,2,298,0.0,145.0,121.0
0.001,17,2,136,1,60,0.0,32.0,32.0,1,76,0.0,48.0,48.0
301.133,6,49,22847,26,16900,12045.0,4080.0,1582.0,23,5947,407.0,2667.0,385.0
169.074,17,94,13709,47,3165,3675.0,44.0,39.0,47,10544,3675.0,239.0,196.0
0.011,6,10,1762,5,911,2.0,643.0,643.0,5,851,2.0,583.0,583.0
0.006,6,10,1547,5,764,1.0,496.0,496.0,5,783,1.0,515.0,515.0
0.111,6,10,1506,5,395,25.0,127.0,127.0,5,1111,25.0,843.0,843.0
177.37,17,86,12119,43,2871,4222.0,44.0,38.0,43,9248,4223.0,239.0,187.0
0.008,6,10,1989,5,910,2.0,642.0,642.0,5,1079,1.0,811.0,811.0
0.072,17,2,170,1,65,0.0,37.0,37.0,1,105,0.0,77.0,77.0
0.012,6,14,3787,7,497,2.0,125.0,125.0,7,3290,1.0,1448.0,972.0
300.425,6,16,2170,9,684,37531.0,146.0,146.0,7,1486,50041.0,419.0,398.0
11.08,17,28,4422,14,1994,840.0,269.0,114.0,14,2428,840.0,587.0,145.0
0.006,6,10,1547,5,764,1.0,496.0,496.0,5,783,1.0,515.0,515.0
40.064,17,10,676,5,460,10015.0,104.0,64.0,5,216,10014.0,20.0,15.0
0.015,6,10,1983,5,910,3.0,642.0,642.0,5,1073,3.0,805.0,805.0
0.014,6,10,1989,5,910,3.0,642.0,642.0,5,1079,3.0,811.0,811.0
0.003,17,2,152,1,76,0.0,48.0,48.0,1,76,0.0,48.0,48.0
0.005,6,10,1989,5,927,1.0,659.0,659.0,5,1062,1.0,794.0,794.0
0.005,17,2,166,1,75,0.0,47.0,47.0,1,91,0.0,63.0,63.0
0.012,6,10,1990,5,911,3.0,643.0,643.0,5,1079,3.0,811.0,811.0
0.126,6,10,1506,5,395,27.0,127.0,127.0,5,1111,27.0,843.0,843.0
8.938,6,38,10447,19,4889,496.0,1360.0,682.0,19,5558,485.0,2667.0,435.0
0.022,17,2,166,1,75,0.0,47.0,47.0,1,91,0.0,63.0,63.0
0.014,6,10,1990,5,911,3.0,643.0,643.0,5,1079,3.0,811.0,811.0
40.055,17,10,676,5,460,10011.0,104.0,64.0,5,216,10013.0,20.0,15.0
0.037,17,2,148,1,60,0.0,32.0,32.0,1,88,0.0,60.0,60.0
0.006,6,10,1547,5,764,1.0,496.0,496.0,5,783,1.0,515.0,515.0
11.232,17,28,4422,14,1995,851.0,270.0,114.0,14,2427,851.0,586.0,145.0
0.012,6,10,1972,5,910,3.0,642.0,642.0,5,1062,2.0,794.0,794.0
40.054,17,10,676,5,460,10012.0,104.0,64.0,5,216,10012.0,20.0,15.0
0.087,6,10,1506,5,395,20.0,127.0,127.0,5,1111,20.0,843.0,843.0
0.003,17,2,148,1,60,0.0,32.0,32.0,1,88,0.0,60.0,60.0
0.175,17,2,152,1,76,0.0,48.0,48.0,1,76,0.0,48.0,48.0
0.005,6,10,2007,5,928,1.0,660.0,660.0,5,1079,1.0,811.0,811.0
10.994,17,28,4421,14,1994,837.0,269.0,114.0,14,2427,837.0,586.0,145.0
40.062,17,10,676,5,460,10014.0,104.0,64.0,5,216,10014.0,20.0,15.0
0.005,6,10,2006,5,927,1.0,659.0,659.0,5,1079,1.0,811.0,811.0
0.044,17,2,148,1,60,0.0,32.0,32.0,1,88,0.0,60.0,60.0
0.004,17,4,284,2,120,0.0,32.0,32.0,2,164,1.0,60.0,54.0
0.004,6,10,2006,5,927,1.0,659.0,659.0,5,1079,1.0,811.0,811.0
0.005,6,10,2006,5,927,1.0,659.0,659.0,5,1079,1.0,811.0,811.0
0.019,6,10,1762,5,911,4.0,643.0,643.0,5,851,4.0,583.0,583.0
0.016,6,10,1972,5,910,4.0,642.0,642.0,5,1062,3.0,794.0,794.0
0.068,17,8,3613,4,1874,22.0,1350.0,440.0,4,1739,11.0,1350.0,406.0
0.005,6,10,2007,5,928,1.0,660.0,660.0,5,1079,1.0,811.0,811.0
0.15,6,10,1506,5,395,32.0,127.0,127.0,5,1111,35.0,843.0,843.0
0.069,17,8,3613,4,1874,23.0,1350.0,440.0,4,1739,12.0,1350.0,406.0
0.041,17,2,136,1,60,0.0,32.0,32.0,1,76,0.0,48.0,48.0
0.006,17,2,169,1,62,0.0,34.0,34.0,1,107,0.0,79.0,79.0
0.121,6,10,1506,5,395,28.0,127.0,127.0,5,1111,29.0,843.0,843.0
0.087,6,10,1506,5,395,19.0,127.0,127.0,5,1111,20.0,843.0,843.0
0.005,17,2,166,1,75,0.0,47.0,47.0,1,91,0.0,63.0,63.0
0.06,17,2,152,1,76,0.0,48.0,48.0,1,76,0.0,48.0,48.0
0.001,17,2,179,1,62,0.0,34.0,34.0,1,117,0.0,89.0,89.0
0.012,6,10,1990,5,911,2.0,643.0,643.0,5,1079,2.0,811.0,811.0
0.013,17,2,152,1,76,0.0,48.0,48.0,1,76,0.0,48.0,48.0
0.071,17,2,148,1,60,0.0,32.0,32.0,1,88,0.0,60.0,60.0
0.012,6,10,1989,5,910,3.0,642.0,642.0,5,1079,3.0,811.0,811.0
0.006,6,10,1689,5,839,1.0,571.0,571.0,5,850,1.0,582.0,582.0
0.05,6,19,9922,11,704,5.0,124.0,124.0,8,9218,7.0,2896.0,2198.0
0.006,6,10,1547,5,764,1.0,496.0,496.0,5,783,1.0,515.0,515.0
0.004,6,10,1702,5,863,1.0,595.0,595.0,5,839,0.0,571.0,571.0
0.156,6,10,1506,5,395,35.0,127.0,127.0,5,1111,36.0,843.0,843.0
0.02,6,10,1989,5,910,4.0,642.0,642.0,5,1079,4.0,811.0,811.0
0.009,6,10,1677,5,827,2.0,559.0,559.0,5,850,2.0,582.0,582.0
40.101,17,10,676,5,460,10024.0,104.0,64.0,5,216,10024.0,20.0,15.0
0.115,6,10,1506,5,395,23.0,127.0,127.0,5,1111,25.0,843.0,843.0
0.015,6,10,1983,5,910,3.0,642.0,642.0,5,1073,3.0,805.0,805.0
0.004,6,10,2006,5,927,1.0,659.0,659.0,5,1079,1.0,811.0,811.0
0.004,6,10,1702,5,863,0.0,595.0,595.0,5,839,1.0,571.0,571.0
0.038,17,2,186,1,61,0.0,33.0,33.0,1,125,0.0,97.0,97.0
0.007,6,10,1972,5,910,1.0,642.0,642.0,5,1062,1.0,794.0,794.0
0.012,6,10,1990,5,911,3.0,643.0,643.0,5,1079,3.0,811.0,811.0
0.005,17,2,230,1,68,0.0,40.0,40.0,1,162,0.0,134.0,134.0
0.002,17,2,142,1,63,0.0,35.0,35.0,1,79,0.0,51.0,51.0
0.005,17,2,170,1,65,0.0,37.0,37.0,1,105,0.0,77.0,77.0
0.005,17,2,140,1,62,0.0,34.0,34.0,1,78,0.0,50.0,50.0
0.11,6,10,1506,5,395,25.0,127.0,127.0,5,1111,26.0,843.0,843.0
0.004,6,10,1779,5,928,1.0,660.0,660.0,5,851,0.0,583.0,583.0
0.123,17,2,80,1,32,0.0,4.0,4.0,1,48,0.0,20.0,20.0
0.006,6,10,1643,5,860,1.0,592.0,592.0,5,783,1.0,515.0,515.0
0.005,17,2,178,1,65,0.0,37.0,37.0,1,113,0.0,85.0,85.0
0.047,6,10,1983,5,910,11.0,642.0,642.0,5,1073,11.0,805.0,805.0
0.001,17,2,180,1,66,0.0,38.0,38.0,1,114,0.0,86.0,86.0
0.005,6,10,2006,5,927,1.0,659.0,659.0,5,1079,1.0,811.0,811.0
1791.918,6,560,191580,283,164453,6354.0,2883.0,947.0,277,27127,6492.0,580.0,122.0
0.003,17,2,152,1,76,0.0,48.0,48.0,1,76,0.0,48.0,48.0
0.005,6,10,2007,5,928,1.0,660.0,660.0,5,1079,1.0,811.0,811.0
40.061,17,10,676,5,460,10012.0,104.0,64.0,5,216,10014.0,20.0,15.0
0.005,6,10,1989,5,927,1.0,659.0,659.0,5,1062,1.0,794.0,794.0
0.005,6,10,2000,5,927,1.0,659.0,659.0,5,1073,1.0,805.0,805.0
40.069,17,10,676,5,460,10016.0,104.0,64.0,5,216,10016.0,20.0,15.0
0.005,6,10,1702,5,863,1.0,595.0,595.0,5,839,1.0,571.0,571.0
0.101,6,10,1506,5,395,23.0,127.0,127.0,5,1111,23.0,843.0,843.0
0.147,6,10,1506,5,395,35.0,127.0,127.0,5,1111,35.0,843.0,843.0
0.012,6,13,3735,7,497,1.0,125.0,125.0,6,3238,2.0,1470.0,1459.0
0.025,6,10,1989,5,910,6.0,642.0,642.0,5,1079,6.0,811.0,811.0
0.03,6,10,1677,5,827,7.0,559.0,559.0,5,850,7.0,582.0,582.0
0.004,17,2,148,1,60,0.0,32.0,32.0,1,88,0.0,60.0,60.0
0.006,17,2,179,1,71,0.0,43.0,43.0,1,108,0.0,80.0,80.0
0.072,17,2,144,1,64,0.0,36.0,36.0,1,80,0.0,52.0,52.0
0.012,6,10,1983,5,910,3.0,642.0,642.0,5,1073,3.0,805.0,805.0
0.006,6,10,1547,5,764,1.0,496.0,496.0,5,783,1.0,515.0,515.0
0.204,6,16,2669,8,1395,29.0,533.0,323.0,8,1274,18.0,529.0,212.0
0.11,6,10,1506,5,395,25.0,127.0,127.0,5,1111,26.0,843.0,843.0
300.424,6,29,11496,16,1939,20028.0,506.0,271.0,13,9557,2333.0,2804.0,985.0
0.004,17,2,136,1,60,0.0,32.0,32.0,1,76,0.0,48.0,48.0
40.058,17,10,676,5,460,10013.0,104.0,64.0,5,216,10013.0,20.0,15.0
0.127,6,10,1506,5,395,28.0,127.0,127.0,5,1111,29.0,843.0,843.0
0.022,6,10,1762,5,911,5.0,643.0,643.0,5,851,5.0,583.0,583.0
0.166,6,10,1506,5,395,30.0,127.0,127.0,5,1111,40.0,843.0,843.0
308.517,17,20,1124,10,716,34273.0,48.0,43.0,10,408,34272.0,20.0,12.0
0.067,17,8,3613,4,1874,22.0,1350.0,440.0,4,1739,11.0,1350.0,406.0
0.012,6,10,1989,5,910,2.0,642.0,642.0,5,1079,3.0,811.0,811.0
0.006,6,10,1547,5,764,1.0,496.0,496.0,5,783,1.0,515.0,515.0
0.004,6,10,2006,5,927,1.0,659.0,659.0,5,1079,1.0,811.0,811.0
11.083,17,28,4423,14,1995,840.0,270.0,114.0,14,2428,839.0,587.0,145.0
0.014,6,10,1972,5,910,3.0,642.0,642.0,5,1062,3.0,794.0,794.0
0.004,17,2,148,1,60,0.0,32.0,32.0,1,88,0.0,60.0,60.0
0.013,6,10,1990,5,911,3.0,643.0,643.0,5,1079,3.0,811.0,811.0
178.059,17,82,11619,41,2731,4451.0,44.0,38.0,41,8888,4451.0,239.0,188.0
0.019,6,10,1989,5,910,4.0,642.0,642.0,5,1079,4.0,811.0,811.0
0.009,6,10,1989,5,910,2.0,642.0,642.0,5,1079,2.0,811.0,811.0
0.003,17,2,136,1,60,0.0,32.0,32.0,1,76,0.0,48.0,48.0
0.001,17,2,136,1,60,0.0,32.0,32.0,1,76,0.0,48.0,48.0
0.037,17,4,420,2,122,0.0,33.0,33.0,2,298,33.0,145.0,121.0
0.004,6,10,1702,5,863,0.0,595.0,595.0,5,839,1.0,571.0,571.0
0.052,17,2,152,1,76,0.0,48.0,48.0,1,76,0.0,48.0,48.0
0.005,17,2,209,1,64,0.0,36.0,36.0,1,145,0.0,117.0,117.0
0.004,6,10,1989,5,927,1.0,659.0,659.0,5,1062,1.0,794.0,794.0
0.014,6,13,3735,7,497,2.0,125.0,125.0,6,3238,2.0,1470.0,1459.0
0.005,6,10,1989,5,927,1.0,659.0,659.0,5,1062,1.0,794.0,794.0
0.053,17,2,152,1,76,0.0,48.0,48.0,1,76,0.0,48.0,48.0
0.005,6,10,1854,5,889,1.0,621.0,621.0,5,965,1.0,697.0,697.0
0.015,6,10,1989,5,910,3.0,642.0,642.0,5,1079,3.0,811.0,811.0
0.004,6,10,1774,5,923,1.0,655.0,655.0,5,851,1.0,583.0,583.0
0.003,17,2,136,1,60,0.0,32.0,32.0,1,76,0.0,48.0,48.0
0.004,6,10,2007,5,928,1.0,660.0,660.0,5,1079,1.0,811.0,811.0
0.005,17,2,166,1,75,0.0,47.0,47.0,1,91,0.0,63.0,63.0
0.001,17,2,136,1,60,0.0,32.0,32.0,1,76,0.0,48.0,48.0
40.057,17,10,676,5,460,10013.0,104.0,64.0,5,216,10013.0,20.0,15.0
0.008,6,10,1989,5,910,2.0,642.0,642.0,5,1079,2.0,811.0,811.0
0.005,6,10,1989,5,927,1.0,659.0,659.0,5,1062,1.0,794.0,794.0
332.532,17,20,1124,10,716,36934.0,48.0,43.0,10,408,36934.0,20.0,12.0
40.079,17,10,676,5,460,10017.0,104.0,64.0,5,216,10018.0,20.0,15.0
0.016,6,10,1972,5,910,3.0,642.0,642.0,5,1062,3.0,794.0,794.0
0.009,6,12,1926,6,1189,1.0,659.0,434.0,6,737,1.0,417.0,417.0
40.07,17,10,676,5,460,10014.0,104.0,64.0,5,216,10015.0,20.0,15.0
40.087,17,10,676,5,460,10019.0,104.0,64.0,5,216,10021.0,20.0,15.0
0.132,17,4,284,2,120,0.0,32.0,32.0,2,164,128.0,60.0,54.0
40.067,17,10,676,5,460,10016.0,104.0,64.0,5,216,10012.0,20.0,15.0
0.018,6,10,1972,5,910,4.0,642.0,642.0,5,1062,4.0,794.0,794.0
0.012,6,10,1677,5,827,3.0,559.0,559.0,5,850,2.0,582.0,582.0
0.066,6,36,7861,22,2246,3.0,517.0,122.0,14,5615,4.0,2694.0,542.0
10.782,17,26,4103,13,1823,889.0,270.0,112.0,13,2280,889.0,587.0,147.0
1.032,6,13,3930,7,2139,128.0,1328.0,923.0,6,1791,155.0,1539.0,1539.0
0.006,6,10,1547,5,764,1.0,496.0,496.0,5,783,1.0,515.0,515.0
0.009,6,10,1643,5,860,2.0,592.0,592.0,5,783,2.0,515.0,515.0
0.029,6,10,1990,5,911,7.0,643.0,643.0,5,1079,7.0,811.0,811.0
0.001,17,2,136,1,60,0.0,32.0,32.0,1,76,0.0,48.0,48.0
0.01,6,12,1926,6,1189,2.0,659.0,434.0,6,737,1.0,417.0,417.0
0.005,17,2,166,1,75,0.0,47.0,47.0,1,91,0.0,63.0,63.0
0.008,6,10,1989,5,910,1.0,642.0,642.0,5,1079,2.0,811.0,811.0
0.015,6,10,1972,5,910,3.0,642.0,642.0,5,1062,3.0,794.0,794.0
0.085,6,10,1506,5,395,20.0,127.0,127.0,5,1111,17.0,843.0,843.0
0.011,6,10,1983,5,910,2.0,642.0,642.0,5,1073,2.0,805.0,805.0
0.005,6,10,2006,5,927,1.0,659.0,659.0,5,1079,1.0,811.0,811.0
0.005,6,10,2006,5,927,1.0,659.0,659.0,5,1079,1.0,811.0,811.0
0.006,6,10,1547,5,764,1.0,496.0,496.0,5,783,1.0,515.0,515.0
0.006,6,10,2006,5,927,1.0,659.0,659.0,5,1079,1.0,811.0,811.0
0.125,6,10,1506,5,395,30.0,127.0,127.0,5,1111,26.0,843.0,843.0
0.006,17,2,179,1,71,0.0,43.0,43.0,1,108,0.0,80.0,80.0
0.009,6,10,1762,5,911,2.0,643.0,643.0,5,851,2.0,583.0,583.0
0.012,6,10,1989,5,910,2.0,642.0,642.0,5,1079,3.0,811.0,811.0
0.01,6,13,3735,7,497,1.0,125.0,125.0,6,3238,1.0,1470.0,1459.0
0.005,6,10,1774,5,923,1.0,655.0,655.0,5,851,1.0,583.0,583.0
40.058,17,10,676,5,460,10013.0,104.0,64.0,5,216,10013.0,20.0,15.0
0.004,6,10,2007,5,928,1.0,660.0,660.0,5,1079,1.0,811.0,811.0
0.013,6,10,1989,5,910,3.0,642.0,642.0,5,1079,3.0,811.0,811.0
0.013,6,10,1972,5,910,3.0,642.0,642.0,5,1062,3.0,794.0,794.0
0.001,17,2,180,1,66,0.0,38.0,38.0,1,114,0.0,86.0,86.0
0.004,6,10,2007,5,928,1.0,660.0,660.0,5,1079,1.0,811.0,811.0
0.012,6,10,1990,5,911,3.0,643.0,643.0,5,1079,2.0,811.0,811.0
0.002,17,2,148,1,60,0.0,32.0,32.0,1,88,0.0,60.0,60.0
0.007,6,10,2007,5,928,1.0,660.0,660.0,5,1079,1.0,811.0,811.0
240.013,6,9,787,5,488,60003.0,232.0,232.0,4,299,80003.0,83.0,83.0
0.097,6,10,1506,5,395,16.0,127.0,127.0,5,1111,22.0,843.0,843.0
0.071,17,2,170,1,65,0.0,37.0,37.0,1,105,0.0,77.0,77.0
0.015,6,10,1989,5,910,3.0,642.0,642.0,5,1079,3.0,811.0,811.0
0.167,6,10,1506,5,395,40.0,127.0,127.0,5,1111,39.0,843.0,843.0
0.016,6,13,3913,7,495,2.0,123.0,123.0,6,3418,3.0,1650.0,1549.0
0.005,6,10,2007,5,928,1.0,660.0,660.0,5,1079,1.0,811.0,811.0
0.018,6,10,1983,5,910,4.0,642.0,642.0,5,1073,4.0,805.0,805.0
1770.806,6,135,6510,75,3585,23926.0,39.0,39.0,60,2925,30009.0,35.0,35.0
0.07,17,8,3613,4,1874,23.0,1350.0,440.0,4,1739,12.0,1350.0,406.0
0.02,6,10,1990,5,911,4.0,643.0,643.0,5,1079,5.0,811.0,811.0
0.037,17,2,136,1,60,0.0,32.0,32.0,1,76,0.0,48.0,48.0
0.138,6,10,1506,5,395,28.0,127.0,127.0,5,1111,28.0,843.0,843.0
0.005,6,10,1689,5,839,1.0,571.0,571.0,5,850,1.0,582.0,582.0
0.005,6,10,2000,5,927,1.0,659.0,659.0,5,1073,1.0,805.0,805.0
0.101,6,10,1506,5,395,23.0,127.0,127.0,5,1111,22.0,843.0,843.0
0.085,6,10,1506,5,395,20.0,127.0,127.0,5,1111,19.0,843.0,843.0
0.012,6,10,1972,5,910,2.0,642.0,642.0,5,1062,3.0,794.0,794.0
0.006,6,10,1547,5,764,1.0,496.0,496.0,5,783,1.0,515.0,515.0
0.009,6,12,1926,6,1189,1.0,659.0,434.0,6,737,1.0,417.0,417.0
0.109,6,10,1506,5,395,23.0,127.0,127.0,5,1111,22.0,843.0,843.0
0.01,6,13,3735,7,497,1.0,125.0,125.0,6,3238,1.0,1470.0,1459.0
0.095,6,10,1506,5,395,20.0,127.0,127.0,5,1111,21.0,843.0,843.0
240.024,6,9,787,5,488,60006.0,232.0,232.0,4,299,80006.0,83.0,83.0
0.005,6,10,1989,5,927,1.0,659.0,659.0,5,1062,1.0,794.0,794.0
0.008,6,12,1926,6,1189,1.0,659.0,434.0,6,737,1.0,417.0,417.0
0.014,6,10,1972,5,910,3.0,642.0,642.0,5,1062,3.0,794.0,794.0
40.066,17,10,676,5,460,10015.0,104.0,64.0,5,216,10015.0,20.0,15.0
0.004,6,10,2006,5,927,1.0,659.0,659.0,5,1079,1.0,811.0,811.0
0.005,6,10,1547,5,764,1.0,496.0,496.0,5,783,1.0,515.0,515.0
0.004,17,4,284,2,120,0.0,32.0,32.0,2,164,0.0,60.0,54.0
0.005,6,10,2007,5,928,1.0,660.0,660.0,5,1079,1.0,811.0,811.0
0.005,17,2,136,1,60,0.0,32.0,32.0,1,76,0.0,48.0,48.0
0.04,17,2,170,1,65,0.0,37.0,37.0,1,105,0.0,77.0,77.0
0.061,6,10,1506,5,395,14.0,127.0,127.0,5,1111,12.0,843.0,843.0
0.011,6,10,1983,5,910,2.0,642.0,642.0,5,1073,2.0,805.0,805.0
0.006,17,2,222,1,65,0.0,37.0,37.0,1,157,0.0,129.0,129.0
0.011,6,10,1989,5,910,2.0,642.0,642.0,5,1079,2.0,811.0,811.0
164.389,17,74,10417,37,2456,4566.0,44.0,38.0,37,7961,4566.0,239.0,187.0
1764.214,6,65,7396,43,4521,42005.0,1402.0,103.0,22,2875,84002.0,1111.0,82.0
0.024,6,10,1990,5,911,6.0,643.0,643.0,5,1079,5.0,811.0,811.0
0.005,6,10,2006,5,927,1.0,659.0,659.0,5,1079,1.0,811.0,811.0
40.085,17,10,676,5,460,10018.0,104.0,64.0,5,216,10020.0,20.0,15.0
15.08,17,16,9303,8,6912,2150.0,1350.0,836.0,8,2391,2150.0,1350.0,270.0
0.008,6,10,1990,5,911,2.0,643.0,643.0,5,1079,2.0,811.0,811.0
0.006,6,10,1689,5,839,1.0,571.0,571.0,5,850,1.0,582.0,582.0
40.092,17,10,676,5,460,10020.0,104.0,64.0,5,216,10020.0,20.0,15.0
11.747,17,40,9288,20,4538,612.0,1297.0,198.0,20,4750,612.0,1290.0,209.0
0.006,17,2,299,1,65,0.0,37.0,37.0,1,234,0.0,206.0,206.0
0.004,17,4,284,2,120,1.0,32.0,32.0,2,164,0.0,60.0,54.0
0.004,6,10,1989,5,927,1.0,659.0,659.0,5,1062,1.0,794.0,794.0
0.012,6,14,3787,7,497,2.0,125.0,125.0,7,3290,1.0,1448.0,972.0
0.084,6,10,1506,5,395,19.0,127.0,127.0,5,1111,17.0,843.0,843.0
0.006,17,2,164,1,74,0.0,46.0,46.0,1,90,0.0,62.0,62.0
0.005,6,10,1989,5,927,1.0,659.0,659.0,5,1062,1.0,794.0,794.0
0.005,6,10,2006,5,927,1.0,659.0,659.0,5,1079,1.0,811.0,811.0
0.021,6,10,1989,5,910,5.0,642.0,642.0,5,1079,5.0,811.0,811.0
240.126,6,23,7707,12,2916,21829.0,1368.0,571.0,11,4791,24012.0,1657.0,842.0
240.552,6,33,8620,17,1821,15032.0,554.0,185.0,16,6799,16033.0,1402.0,597.0
0.017,6,10,1990,5,911,4.0,643.0,643.0,5,1079,4.0,811.0,811.0
0.011,6,10,1762,5,911,2.0,643.0,643.0,5,851,2.0,583.0,583.0
0.004,6,10,2006,5,927,1.0,659.0,659.0,5,1079,1.0,811.0,811.0
0.102,6,10,1506,5,395,24.0,127.0,127.0,5,1111,20.0,843.0,843.0
354.009,6,21,1795,16,1030,23600.0,190.0,190.0,5,765,60006.0,464.0,248.0
0.008,6,10,1989,5,910,2.0,642.0,642.0,5,1079,2.0,811.0,811.0
0.004,17,2,148,1,60,0.0,32.0,32.0,1,88,0.0,60.0,60.0
0.011,6,10,1989,5,910,2.0,642.0,642.0,5,1079,2.0,811.0,811.0
0.023,6,10,1983,5,910,5.0,642.0,642.0,5,1073,5.0,805.0,805.0
10.751,17,26,4103,13,1846,887.0,269.0,114.0,13,2257,887.0,588.0,145.0
0.008,6,10,2006,5,927,1.0,659.0,659.0,5,1079,2.0,811.0,811.0
0.004,17,2,148,1,60,0.0,32.0,32.0,1,88,0.0,60.0,60.0
0.013,6,10,1989,5,910,3.0,642.0,642.0,5,1079,3.0,811.0,811.0
0.006,6,10,1989,5,927,1.0,659.0,659.0,5,1062,1.0,794.0,794.0
0.038,17,2,166,1,75,0.0,47.0,47.0,1,91,0.0,63.0,63.0
240.267,6,27,8682,13,2449,20022.0,1288.0,444.0,14,6233,18481.0,1592.0,610.0
0.005,6,10,1989,5,927,1.0,659.0,659.0,5,1062,1.0,794.0,794.0
0.004,6,10,1774,5,923,1.0,655.0,655.0,5,851,1.0,583.0,583.0
0.005,6,10,1989,5,927,1.0,659.0,659.0,5,1062,1.0,794.0,794.0
0.006,6,10,1854,5,889,1.0,621.0,621.0,5,965,1.0,697.0,697.0
1.058,6,28,12272,16,3260,70.0,1360.0,517.0,12,9012,81.0,2720.0,1065.0
0.005,6,10,1989,5,927,1.0,659.0,659.0,5,1062,1.0,794.0,794.0
0.009,6,10,1643,5,860,2.0,592.0,592.0,5,783,2.0,515.0,515.0
0.001,17,2,180,1,66,0.0,38.0,38.0,1,114,0.0,86.0,86.0
0.111,6,10,1506,5,395,23.0,127.0,127.0,5,1111,25.0,843.0,843.0
0.005,6,10,2007,5,928,1.0,660.0,660.0,5,1079,1.0,811.0,811.0
0.004,17,2,148,1,60,0.0,32.0,32.0,1,88,0.0,60.0,60.0
0.154,6,10,1506,5,395,37.0,127.0,127.0,5,1111,35.0,843.0,843.0
0.812,6,10,937,6,427,162.0,107.0,107.0,4,510,182.0,294.0,294.0
0.01,6,10,1631,5,848,2.0,580.0,580.0,5,783,2.0,515.0,515.0
0.019,6,10,1631,5,848,4.0,580.0,580.0,5,783,4.0,515.0,515.0
1792.498,6,491,99452,247,88102,7286.0,421.0,365.0,244,11350,7376.0,53.0,53.0
0.009,6,13,3735,7,497,1.0,125.0,125.0,6,3238,1.0,1470.0,1459.0
0.005,6,10,2006,5,927,1.0,659.0,659.0,5,1079,1.0,811.0,811.0
0.003,17,2,148,1,60,0.0,32.0,32.0,1,88,0.0,60.0,60.0
0.004,6,10,2006,5,927,1.0,659.0,659.0,5,1079,1.0,811.0,811.0
0.11,6,10,1506,5,395,27.0,127.0,127.0,5,1111,26.0,843.0,843.0
0.004,6,10,2007,5,928,1.0,660.0,660.0,5,1079,1.0,811.0,811.0
40.071,17,10,676,5,460,10016.0,104.0,64.0,5,216,10016.0,20.0,15.0
0.01,6,10,1989,5,910,2.0,642.0,642.0,5,1079,2.0,811.0,811.0
0.108,6,10,1506,5,395,14.0,127.0,127.0,5,1111,24.0,843.0,843.0
0.005,6,10,1547,5,764,1.0,496.0,496.0,5,783,1.0,515.0,515.0
0.025,17,2,148,1,60,0.0,32.0,32.0,1,88,0.0,60.0,60.0
0.008,6,12,1698,6,863,1.0,327.0,271.0,6,835,1.0,515.0,515.0
0.037,17,2,144,1,64,0.0,36.0,36.0,1,80,0.0,52.0,52.0
0.004,6,10,2007,5,928,1.0,660.0,660.0,5,1079,1.0,811.0,811.0
0.004,17,4,284,2,120,0.0,32.0,32.0,2,164,0.0,60.0,54.0
0.014,6,10,1990,5,911,3.0,643.0,643.0,5,1079,3.0,811.0,811.0
0.005,6,14,3736,7,446,0.0,74.0,74.0,7,3290,0.0,1448.0,972.0
0.004,6,10,1774,5,923,1.0,655.0,655.0,5,851,1.0,583.0,583.0
40.066,17,10,676,5,460,10014.0,104.0,64.0,5,216,10015.0,20.0,15.0
0.07,6,10,1506,5,395,14.0,127.0,127.0,5,1111,16.0,843.0,843.0
30.57,6,27,9572,15,1789,2183.0,517.0,252.0,12,7783,2778.0,1402.0,794.0
0.006,6,10,1989,5,927,1.0,659.0,659.0,5,1062,1.0,794.0,794.0
0.005,6,10,1689,5,839,1.0,571.0,571.0,5,850,1.0,582.0,582.0
0.112,6,10,1506,5,395,24.0,127.0,127.0,5,1111,23.0,843.0,843.0
0.038,17,4,284,2,120,0.0,32.0,32.0,2,164,35.0,60.0,54.0
0.014,6,10,1983,5,910,3.0,642.0,642.0,5,1073,3.0,805.0,805.0
0.006,6,10,1547,5,764,1.0,496.0,496.0,5,783,1.0,515.0,515.0
240.013,6,9,787,5,488,60003.0,232.0,232.0,4,299,80003.0,83.0,83.0
0.137,6,10,1506,5,395,31.0,127.0,127.0,5,1111,33.0,843.0,843.0
0.001,17,2,180,1,66,0.0,38.0,38.0,1,114,0.0,86.0,86.0
0.011,6,10,1989,5,910,2.0,642.0,642.0,5,1079,2.0,811.0,811.0
0.008,6,10,1983,5,910,2.0,642.0,642.0,5,1073,1.0,805.0,805.0
0.004,17,2,136,1,60,0.0,32.0,32.0,1,76,0.0,48.0,48.0
0.089,6,10,1506,5,395,19.0,127.0,127.0,5,1111,17.0,843.0,843.0
0.019,6,10,1989,5,910,4.0,642.0,642.0,5,1079,4.0,811.0,811.0
1774.949,6,98,7110,49,2696,36977.0,50.0,37.0,49,4414,36977.0,490.0,266.0
0.005,6,10,1774,5,923,1.0,655.0,655.0,5,851,1.0,583.0,583.0
0.049,6,10,1990,5,911,12.0,643.0,643.0,5,1079,12.0,811.0,811.0
40.056,17,10,676,5,460,10013.0,104.0,64.0,5,216,10012.0,20.0,15.0
0.011,6,10,1989,5,910,2.0,642.0,642.0,5,1079,2.0,811.0,811.0
0.003,6,10,1702,5,863,0.0,595.0,595.0,5,839,0.0,571.0,571.0
0.004,6,10,1989,5,927,1.0,659.0,659.0,5,1062,1.0,794.0,794.0
0.005,6,10,1854,5,889,1.0,621.0,621.0,5,965,1.0,697.0,697.0
0.083,6,10,1506,5,395,20.0,127.0,127.0,5,1111,18.0,843.0,843.0
0.085,6,10,1506,5,395,20.0,127.0,127.0,5,1111,18.0,843.0,843.0
0.003,17,4,284,2,120,0.0,32.0,32.0,2,164,0.0,60.0,54.0
374.682,6,21,1794,16,1030,24978.0,190.0,190.0,5,764,60018.0,463.0,248.0
0.008,6,10,1677,5,827,2.0,559.0,559.0,5,850,1.0,582.0,582.0
0.005,6,10,2007,5,928,1.0,660.0,660.0,5,1079,1.0,811.0,811.0
0.005,6,10,1689,5,839,1.0,571.0,571.0,5,850,1.0,582.0,582.0
0.013,6,10,1990,5,911,3.0,643.0,643.0,5,1079,3.0,811.0,811.0
25.298,6,10,1179,6,570,5059.0,250.0,250.0,4,609,8421.0,393.0,393.0
0.042,17,4,284,2,120,0.0,32.0,32.0,2,164,39.0,60.0,54.0
0.064,6,10,1506,5,395,14.0,127.0,127.0,5,1111,13.0,843.0,843.0
0.005,6,10,1779,5,928,1.0,660.0,660.0,5,851,1.0,583.0,583.0
0.004,6,10,2006,5,927,1.0,659.0,659.0,5,1079,1.0,811.0,811.0
0.004,17,2,412,1,61,0.0,33.0,33.0,1,351,0.0,323.0,323.0
0.042,6,10,1631,5,848,10.0,580.0,580.0,5,783,10.0,515.0,515.0
0.019,6,10,1990,5,911,4.0,643.0,643.0,5,1079,4.0,811.0,811.0
10.878,17,28,4418,14,1995,827.0,270.0,114.0,14,2423,827.0,586.0,145.0
0.005,6,10,1989,5,927,1.0,659.0,659.0,5,1062,1.0,794.0,794.0
11.081,17,29,4566,15,2166,783.0,269.0,116.0,14,2400,843.0,587.0,143.0
0.015,6,10,1989,5,910,3.0,642.0,642.0,5,1079,3.0,811.0,811.0
40.056,17,10,676,5,460,10013.0,104.0,64.0,5,216,10013.0,20.0,15.0
0.008,6,10,1989,5,910,2.0,642.0,642.0,5,1079,2.0,811.0,811.0
0.007,17,2,194,1,59,0.0,31.0,31.0,1,135,0.0,107.0,107.0
0.01,6,10,1972,5,910,2.0,642.0,642.0,5,1062,2.0,794.0,794.0
0.053,17,2,152,1,76,0.0,48.0,48.0,1,76,0.0,48.0,48.0
173.151,17,82,11649,41,2735,4328.0,44.0,38.0,41,8914,4328.0,239.0,189.0
0.02,6,10,1983,5,910,4.0,642.0,642.0,5,1073,5.0,805.0,805.0
0.395,17,4,596,2,122,189.0,33.0,33.0,2,474,310.0,323.0,209.0
60.544,58,5,360,4,288,20181.0,24.0,24.0,1,72,0.0,24.0,24.0
40.067,17,10,676,5,460,10015.0,104.0,64.0,5,216,10015.0,20.0,15.0
0.003,17,4,284,2,120,0.0,32.0,32.0,2,164,0.0,60.0,54.0
0.004,6,10,1774,5,923,1.0,655.0,655.0,5,851,1.0,583.0,583.0
0.042,17,2,184,1,61,0.0,33.0,33.0,1,123,0.0,95.0,95.0
300.352,6,16,2170,9,684,37521.0,146.0,146.0,7,1486,50027.0,419.0,398.0
0.005,17,2,154,1,69,0.0,41.0,41.0,1,85,0.0,57.0,57.0
0.006,17,2,180,1,66,0.0,38.0,38.0,1,114,0.0,86.0,86.0
0.005,6,10,2006,5,927,1.0,659.0,659.0,5,1079,1.0,811.0,811.0
0.005,6,10,2006,5,927,1.0,659.0,659.0,5,1079,1.0,811.0,811.0
0.005,6,10,2006,5,927,1.0,659.0,659.0,5,1079,1.0,811.0,811.0
0.007,17,2,299,1,65,0.0,37.0,37.0,1,234,0.0,206.0,206.0
0.003,17,2,136,1,60,0.0,32.0,32.0,1,76,0.0,48.0,48.0
0.004,6,10,2006,5,927,1.0,659.0,659.0,5,1079,1.0,811.0,811.0
0.005,6,10,1643,5,860,1.0,592.0,592.0,5,783,1.0,515.0,515.0
0.006,6,10,1547,5,764,1.0,496.0,496.0,5,783,1.0,515.0,515.0
0.067,17,8,3613,4,1874,22.0,1350.0,440.0,4,1739,11.0,1350.0,406.0
0.006,6,10,1547,5,764,1.0,496.0,496.0,5,783,1.0,515.0,515.0
0.005,17,2,230,1,68,0.0,40.0,40.0,1,162,0.0,134.0,134.0
0.014,6,10,1972,5,910,3.0,642.0,642.0,5,1062,3.0,794.0,794.0
0.005,17,2,140,1,62,0.0,34.0,34.0,1,78,0.0,50.0,50.0
0.12,6,10,1506,5,395,28.0,127.0,127.0,5,1111,25.0,843.0,843.0
0.076,6,10,1506,5,395,17.0,127.0,127.0,5,1111,17.0,843.0,843.0
0.32,17,17,8980,9,6540,40.0,1350.0,698.0,8,2440,26.0,1350.0,277.0
0.012,6,10,1972,5,910,2.0,642.0,642.0,5,1062,2.0,794.0,794.0
0.005,17,2,136,1,60,0.0,32.0,32.0,1,76,0.0,48.0,48.0
0.061,6,10,1506,5,395,14.0,127.0,127.0,5,1111,13.0,843.0,843.0
300.787,6,35,7982,18,2504,17693.0,1368.0,438.0,17,5478,538.0,2667.0,435.0
0.012,6,10,1989,5,910,3.0,642.0,642.0,5,1079,3.0,811.0,811.0
0.162,17,2,152,1,76,0.0,48.0,48.0,1,76,0.0,48.0,48.0
10.899,17,28,4421,14,1993,830.0,268.0,114.0,14,2428,829.0,587.0,145.0
0.081,6,10,1762,5,911,20.0,643.0,643.0,5,851,20.0,583.0,583.0
0.006,17,2,170,1,65,0.0,37.0,37.0,1,105,0.0,77.0,77.0
0.037,17,2,136,1,60,0.0,32.0,32.0,1,76,0.0,48.0,48.0
0.013,6,10,1983,5,910,3.0,642.0,642.0,5,1073,3.0,805.0,805.0
0.005,6,10,1989,5,927,1.0,659.0,659.0,5,1062,1.0,794.0,794.0
0.098,6,10,1506,5,395,19.0,127.0,127.0,5,1111,20.0,843.0,843.0
0.215,6,16,2674,8,1400,30.0,533.0,325.0,8,1274,19.0,529.0,212.0
0.016,6,10,1990,5,911,4.0,643.0,643.0,5,1079,3.0,811.0,811.0
0.015,6,10,1990,5,911,3.0,643.0,643.0,5,1079,3.0,811.0,811.0
0.015,6,10,1972,5,910,3.0,642.0,642.0,5,1062,3.0,794.0,794.0
0.008,6,10,1989,5,910,2.0,642.0,642.0,5,1079,1.0,811.0,811.0
0.005,6,10,1854,5,889,1.0,621.0,621.0,5,965,1.0,697.0,697.0
40.071,17,10,676,5,460,10016.0,104.0,64.0,5,216,10016.0,20.0,15.0
0.115,6,10,1506,5,395,23.0,127.0,127.0,5,1111,25.0,843.0,843.0
0.098,6,10,1506,5,395,23.0,127.0,127.0,5,1111,19.0,843.0,843.0
0.005,6,10,2007,5,928,1.0,660.0,660.0,5,1079,1.0,811.0,811.0
10.88,17,28,4416,14,1993,827.0,268.0,114.0,14,2423,828.0,586.0,145.0
308.492,17,20,1124,10,716,34261.0,48.0,43.0,10,408,34262.0,20.0,12.0
0.114,6,10,1506,5,395,26.0,127.0,127.0,5,1111,25.0,843.0,843.0
0.005,6,10,1774,5,923,1.0,655.0,655.0,5,851,1.0,583.0,583.0
0.015,6,10,1631,5,848,3.0,580.0,580.0,5,783,3.0,515.0,515.0
0.006,6,10,1547,5,764,1.0,496.0,496.0,5,783,1.0,515.0,515.0
240.32,6,43,8771,21,5686,12015.0,1515.0,509.0,22,3085,11443.0,580.0,241.0
0.003,6,10,1702,5,863,0.0,595.0,595.0,5,839,0.0,571.0,571.0
0.003,17,2,136,1,60,0.0,32.0,32.0,1,76,0.0,48.0,48.0
0.006,6,10,1774,5,923,1.0,655.0,655.0,5,851,1.0,583.0,583.0
0.091,6,10,1506,5,395,20.0,127.0,127.0,5,1111,19.0,843.0,843.0
0.007,6,10,1547,5,764,1.0,496.0,496.0,5,783,1.0,515.0,515.0
369.584,6,22,2313,16,867,24638.0,195.0,195.0,6,1446,4641.0,419.0,398.0
0.04,17,4,284,2,120,0.0,32.0,32.0,2,164,37.0,60.0,54.0
300.018,6,12,1782,7,1348,50003.0,494.0,494.0,5,434,75003.0,83.0,83.0
0.071,17,2,148,1,60,0.0,32.0,32.0,1,88,0.0,60.0,60.0
0.069,17,8,3613,4,1874,23.0,1350.0,440.0,4,1739,11.0,1350.0,406.0
0.004,6,10,1702,5,863,1.0,595.0,595.0,5,839,0.0,571.0,571.0
0.001,17,2,180,1,66,0.0,38.0,38.0,1,114,0.0,86.0,86.0
0.117,6,10,1506,5,395,24.0,127.0,127.0,5,1111,24.0,843.0,843.0
0.015,6,10,1631,5,848,3.0,580.0,580.0,5,783,3.0,515.0,515.0
0.004,6,10,2006,5,927,1.0,659.0,659.0,5,1079,1.0,811.0,811.0
0.016,6,10,1990,5,911,4.0,643.0,643.0,5,1079,4.0,811.0,811.0
0.004,6,10,2006,5,927,1.0,659.0,659.0,5,1079,1.0,811.0,811.0
0.083,6,10,1506,5,395,20.0,127.0,127.0,5,1111,17.0,843.0,843.0
40.069,17,10,676,5,460,10016.0,104.0,64.0,5,216,10016.0,20.0,15.0
364.359,6,19,1688,15,978,26025.0,190.0,190.0,4,710,80015.0,494.0,494.0
0.001,17,2,180,1,66,0.0,38.0,38.0,1,114,0.0,86.0,86.0
0.005,6,10,2007,5,928,1.0,660.0,660.0,5,1079,1.0,811.0,811.0
0.006,6,10,1643,5,860,1.0,592.0,592.0,5,783,1.0,515.0,515.0
0.004,6,10,1702,5,863,0.0,595.0,595.0,5,839,1.0,571.0,571.0
0.009,6,10,1989,5,910,2.0,642.0,642.0,5,1079,2.0,811.0,811.0
0.089,6,10,1506,5,395,19.0,127.0,127.0,5,1111,19.0,843.0,843.0
0.009,6,10,1990,5,911,2.0,643.0,643.0,5,1079,2.0,811.0,811.0
0.004,6,14,3742,7,452,0.0,80.0,80.0,7,3290,0.0,1448.0,972.0
0.004,17,2,136,1,60,0.0,32.0,32.0,1,76,0.0,48.0,48.0
0.011,17,2,213,1,69,0.0,41.0,41.0,1,144,0.0,116.0,116.0
0.042,17,2,234,1,61,0.0,33.0,33.0,1,173,0.0,145.0,145.0
0.002,17,2,152,1,76,0.0,48.0,48.0,1,76,0.0,48.0,48.0
32.965,6,259,226124,137,214385,134.0,4080.0,1816.0,122,11739,271.0,2667.0,236.0
0.172,17,2,152,1,76,0.0,48.0,48.0,1,76,0.0,48.0,48.0
0.091,6,10,1506,5,395,17.0,127.0,127.0,5,1111,21.0,843.0,843.0
0.005,6,10,2006,5,927,1.0,659.0,659.0,5,1079,1.0,811.0,811.0
0.006,6,10,1547,5,764,1.0,496.0,496.0,5,783,1.0,515.0,515.0
0.005,6,10,1779,5,928,1.0,660.0,660.0,5,851,1.0,583.0,583.0
10.863,17,28,4420,14,1993,826.0,268.0,114.0,14,2427,826.0,586.0,145.0
0.013,6,10,1677,5,827,3.0,559.0,559.0,5,850,3.0,582.0,582.0
0.004,6,10,2006,5,927,1.0,659.0,659.0,5,1079,1.0,811.0,811.0
0.012,6,10,1972,5,910,3.0,642.0,642.0,5,1062,2.0,794.0,794.0
0.003,17,2,136,1,60,0.0,32.0,32.0,1,76,0.0,48.0,48.0
368.939,6,22,2313,16,867,24595.0,195.0,195.0,6,1446,4646.0,419.0,398.0
0.022,6,10,1631,5,848,5.0,580.0,580.0,5,783,5.0,515.0,515.0
0.076,6,10,1506,5,395,16.0,127.0,127.0,5,1111,16.0,843.0,843.0
0.005,6,10,1989,5,927,1.0,659.0,659.0,5,1062,1.0,794.0,794.0
280.826,6,25,6480,11,1226,28082.0,267.0,156.0,14,5254,21601.0,1400.0,781.0
0.001,17,2,180,1,66,0.0,38.0,38.0,1,114,0.0,86.0,86.0
1.036,6,13,3930,7,2139,129.0,1328.0,923.0,6,1791,155.0,1539.0,1539.0
0.007,6,10,1547,5,764,1.0,496.0,496.0,5,783,1.0,515.0,515.0
0.004,6,10,2007,5,928,1.0,660.0,660.0,5,1079,1.0,811.0,811.0
0.006,17,2,166,1,75,0.0,47.0,47.0,1,91,0.0,63.0,63.0
0.005,6,10,2007,5,928,1.0,660.0,660.0,5,1079,1.0,811.0,811.0
0.016,6,10,1762,5,911,3.0,643.0,643.0,5,851,3.0,583.0,583.0
0.01,6,10,1990,5,911,2.0,643.0,643.0,5,1079,2.0,811.0,811.0
0.01,6,10,1989,5,910,2.0,642.0,642.0,5,1079,2.0,811.0,811.0
0.071,17,8,3613,4,1874,23.0,1350.0,440.0,4,1739,12.0,1350.0,406.0
0.005,6,10,2007,5,928,1.0,660.0,660.0,5,1079,1.0,811.0,811.0
0.129,17,2,80,1,32,0.0,4.0,4.0,1,48,0.0,20.0,20.0
133.217,6,21,8145,11,1985,78.0,1174.0,504.0,10,6160,14783.0,2720.0,958.0
0.011,6,10,1990,5,911,2.0,643.0,643.0,5,1079,2.0,811.0,811.0
0.004,6,10,1702,5,863,1.0,595.0,595.0,5,839,1.0,571.0,571.0
0.001,17,2,180,1,66,0.0,38.0,38.0,1,114,0.0,86.0,86.0
0.012,6,10,1990,5,911,2.0,643.0,643.0,5,1079,2.0,811.0,811.0
0.013,6,10,1989,5,910,3.0,642.0,642.0,5,1079,3.0,811.0,811.0
0.01,17,2,142,1,63,0.0,35.0,35.0,1,79,0.0,51.0,51.0
0.031,6,13,3735,7,497,5.0,125.0,125.0,6,3238,6.0,1470.0,1459.0
0.07,6,10,1506,5,395,15.0,127.0,127.0,5,1111,16.0,843.0,843.0
0.012,6,10,1990,5,911,3.0,643.0,643.0,5,1079,3.0,811.0,811.0
11.222,17,29,4552,14,1995,851.0,270.0,114.0,15,2557,790.0,588.0,142.0
0.006,6,10,1689,5,839,1.0,571.0,571.0,5,850,1.0,582.0,582.0
0.012,6,10,1989,5,910,3.0,642.0,642.0,5,1079,3.0,811.0,811.0
0.012,6,10,1677,5,827,3.0,559.0,559.0,5,850,2.0,582.0,582.0
0.007,6,12,1698,6,863,1.0,327.0,271.0,6,835,1.0,515.0,515.0
0.005,6,10,2006,5,927,1.0,659.0,659.0,5,1079,1.0,811.0,811.0
11.18,17,28,4422,14,1994,847.0,269.0,114.0,14,2428,847.0,587.0,145.0
0.005,6,10,1989,5,927,1.0,659.0,659.0,5,1062,1.0,794.0,794.0
40.076,17,10,676,5,460,10016.0,104.0,64.0,5,216,10018.0,20.0,15.0
0.003,17,2,148,1,60,0.0,32.0,32.0,1,88,0.0,60.0,60.0
0.004,6,10,1989,5,927,1.0,659.0,659.0,5,1062,1.0,794.0,794.0
40.094,17,10,676,5,460,10020.0,104.0,64.0,5,216,10022.0,20.0,15.0
0.008,6,13,3735,7,497,1.0,125.0,125.0,6,3238,1.0,1470.0,1459.0
40.086,17,10,676,5,460,10020.0,104.0,64.0,5,216,10020.0,20.0,15.0
0.005,6,10,1547,5,764,1.0,496.0,496.0,5,783,1.0,515.0,515.0
0.005,6,10,2007,5,928,1.0,660.0,660.0,5,1079,1.0,811.0,811.0
0.005,6,10,2007,5,928,1.0,660.0,660.0,5,1079,1.0,811.0,811.0
0.004,17,2,136,1,60,0.0,32.0,32.0,1,76,0.0,48.0,48.0
412.254,6,29,4409,12,3102,10912.0,494.0,494.0,17,1307,25765.0,83.0,83.0
145.596,6,24,9037,12,3176,132.0,1360.0,666.0,12,5861,13219.0,2720.0,894.0
0.032,6,13,3735,7,497,5.0,125.0,125.0,6,3238,6.0,1470.0,1459.0
0.004,17,2,166,1,75,0.0,47.0,47.0,1,91,0.0,63.0,63.0
0.005,17,2,179,1,71,0.0,43.0,43.0,1,108,0.0,80.0,80.0
0.0,17,2,140,1,62,0.0,34.0,34.0,1,78,0.0,50.0,50.0
0.005,6,10,1689,5,839,1.0,571.0,571.0,5,850,1.0,582.0,582.0
0.004,6,10,2006,5,927,1.0,659.0,659.0,5,1079,1.0,811.0,811.0
0.103,6,10,1506,5,395,24.0,127.0,127.0,5,1111,24.0,843.0,843.0
0.014,6,10,1989,5,910,3.0,642.0,642.0,5,1079,3.0,811.0,811.0
0.013,6,10,1989,5,910,3.0,642.0,642.0,5,1079,3.0,811.0,811.0
0.008,6,12,1926,6,1189,1.0,659.0,434.0,6,737,1.0,417.0,417.0
0.008,6,12,1926,6,1189,1.0,659.0,434.0,6,737,1.0,417.0,417.0
325.626,17,20,1124,10,716,36168.0,48.0,43.0,10,408,36168.0,20.0,12.0
0.004,17,2,148,1,60,0.0,32.0,32.0,1,88,0.0,60.0,60.0
0.004,6,10,1702,5,863,1.0,595.0,595.0,5,839,1.0,571.0,571.0
183.234,17,90,12907,45,3032,4163.0,44.0,39.0,45,9875,4164.0,252.0,191.0
0.004,6,10,2006,5,927,1.0,659.0,659.0,5,1079,1.0,811.0,811.0
0.004,17,2,148,1,60,0.0,32.0,32.0,1,88,0.0,60.0,60.0
0.016,6,10,1990,5,911,3.0,643.0,643.0,5,1079,4.0,811.0,811.0
0.025,6,13,3913,7,495,4.0,123.0,123.0,6,3418,5.0,1650.0,1549.0
323.97,17,20,1124,10,716,35983.0,48.0,43.0,10,408,35984.0,20.0,12.0
0.082,6,10,1506,5,395,18.0,127.0,127.0,5,1111,15.0,843.0,843.0
0.016,6,10,1989,5,910,4.0,642.0,642.0,5,1079,4.0,811.0,811.0
0.01,6,10,1989,5,910,2.0,642.0,642.0,5,1079,2.0,811.0,811.0
0.01,6,10,1983,5,910,2.0,642.0,642.0,5,1073,2.0,805.0,805.0
0.011,6,10,1972,5,910,2.0,642.0,642.0,5,1062,2.0,794.0,794.0
0.006,6,10,1547,5,764,1.0,496.0,496.0,5,783,1.0,515.0,515.0
0.005,17,2,164,1,74,0.0,46.0,46.0,1,90,0.0,62.0,62.0
0.01,6,10,1854,5,889,2.0,621.0,621.0,5,965,2.0,697.0,697.0
0.014,6,10,1989,5,910,3.0,642.0,642.0,5,1079,3.0,811.0,811.0
0.005,6,10,2006,5,927,1.0,659.0,659.0,5,1079,1.0,811.0,811.0
0.012,6,10,1989,5,910,2.0,642.0,642.0,5,1079,3.0,811.0,811.0
0.014,6,10,1989,5,910,3.0,642.0,642.0,5,1079,3.0,811.0,811.0
0.061,6,10,1506,5,395,13.0,127.0,127.0,5,1111,14.0,843.0,843.0
40.064,17,10,676,5,460,10013.0,104.0,64.0,5,216,10015.0,20.0,15.0
0.004,6,10,1702,5,863,1.0,595.0,595.0,5,839,1.0,571.0,571.0
0.09,6,10,1506,5,395,18.0,127.0,127.0,5,1111,19.0,843.0,843.0
0.272,17,2,152,1,76,0.0,48.0,48.0,1,76,0.0,48.0,48.0
0.015,6,10,1989,5,910,3.0,642.0,642.0,5,1079,3.0,811.0,811.0
0.01,6,10,1972,5,910,2.0,642.0,642.0,5,1062,2.0,794.0,794.0
10.786,17,28,4422,14,1994,821.0,269.0,114.0,14,2428,821.0,587.0,145.0
0.007,17,2,194,1,59,0.0,31.0,31.0,1,135,0.0,107.0,107.0
0.024,6,10,1762,5,911,6.0,643.0,643.0,5,851,6.0,583.0,583.0
0.013,6,10,1762,5,911,3.0,643.0,643.0,5,851,3.0,583.0,583.0
0.005,17,2,230,1,68,0.0,40.0,40.0,1,162,0.0,134.0,134.0
10.912,17,28,4422,14,1993,830.0,268.0,114.0,14,2429,830.0,588.0,145.0
0.127,17,4,284,2,120,0.0,32.0,32.0,2,164,123.0,60.0,54.0
0.012,6,10,1762,5,911,3.0,643.0,643.0,5,851,2.0,583.0,583.0
0.009,6,12,1926,6,1189,1.0,659.0,434.0,6,737,1.0,417.0,417.0
0.011,6,10,1989,5,910,2.0,642.0,642.0,5,1079,2.0,811.0,811.0
0.005,6,10,1854,5,889,1.0,621.0,621.0,5,965,1.0,697.0,697.0
40.091,17,10,676,5,460,10020.0,104.0,64.0,5,216,10021.0,20.0,15.0
0.009,6,10,1762,5,911,2.0,643.0,643.0,5,851,2.0,583.0,583.0
240.088,6,16,4482,9,963,30011.0,238.0,166.0,7,3519,40014.0,1402.0,786.0
1261.539,6,99,12491,58,8762,22132.0,302.0,302.0,41,3729,31538.0,83.0,83.0
0.001,17,2,180,1,66,0.0,38.0,38.0,1,114,0.0,86.0,86.0
0.012,6,10,1677,5,827,3.0,559.0,559.0,5,850,3.0,582.0,582.0
0.005,6,10,1989,5,927,1.0,659.0,659.0,5,1062,1.0,794.0,794.0
0.005,6,10,2000,5,927,1.0,659.0,659.0,5,1073,1.0,805.0,805.0
0.018,6,13,3735,7,497,3.0,125.0,125.0,6,3238,3.0,1470.0,1459.0
0.003,6,10,1702,5,863,0.0,595.0,595.0,5,839,0.0,571.0,571.0
0.001,17,2,180,1,66,0.0,38.0,38.0,1,114,0.0,86.0,86.0
0.003,17,2,148,1,60,0.0,32.0,32.0,1,88,0.0,60.0,60.0
15.074,17,15,9238,8,6902,2149.0,1350.0,834.0,7,2336,2507.0,1350.0,305.0
0.017,6,10,1762,5,911,4.0,643.0,643.0,5,851,4.0,583.0,583.0
0.004,6,10,2007,5,928,1.0,660.0,660.0,5,1079,1.0,811.0,811.0
0.072,6,10,1506,5,395,15.0,127.0,127.0,5,1111,15.0,843.0,843.0
0.04,17,4,284,2,120,1.0,32.0,32.0,2,164,36.0,60.0,54.0
0.005,6,10,1547,5,764,1.0,496.0,496.0,5,783,1.0,515.0,515.0
0.001,17,2,136,1,60,0.0,32.0,32.0,1,76,0.0,48.0,48.0
0.004,17,2,166,1,75,0.0,47.0,47.0,1,91,0.0,63.0,63.0
0.006,6,10,1689,5,839,1.0,571.0,571.0,5,850,1.0,582.0,582.0
0.005,17,2,169,1,62,0.0,34.0,34.0,1,107,0.0,79.0,79.0
11.148,17,28,4389,14,2311,848.0,586.0,137.0,14,2078,848.0,269.0,120.0
0.009,6,10,1631,5,848,2.0,580.0,580.0,5,783,2.0,515.0,515.0
0.087,6,10,1506,5,395,19.0,127.0,127.0,5,1111,19.0,843.0,843.0
0.005,6,10,2006,5,927,1.0,659.0,659.0,5,1079,1.0,811.0,811.0
10.957,17,28,4394,14,1994,834.0,269.0,114.0,14,2400,834.0,587.0,143.0
0.011,17,2,302,1,65,0.0,37.0,37.0,1,237,0.0,209.0,209.0
0.001,17,2,136,1,60,0.0,32.0,32.0,1,76,0.0,48.0,48.0
0.003,17,2,148,1,60,0.0,32.0,32.0,1,88,0.0,60.0,60.0
0.003,17,2,148,1,60,0.0,32.0,32.0,1,88,0.0,60.0,60.0
1755.906,6,105,6240,60,3510,29760.0,26.0,26.0,45,2730,39906.0,26.0,26.0
0.005,17,2,169,1,62,0.0,34.0,34.0,1,107,0.0,79.0,79.0
0.006,6,10,1547,5,764,1.0,496.0,496.0,5,783,1.0,515.0,515.0
0.006,17,2,262,1,66,0.0,38.0,38.0,1,196,0.0,168.0,168.0
0.016,6,10,1972,5,910,4.0,642.0,642.0,5,1062,4.0,794.0,794.0
40.089,17,10,676,5,460,10021.0,104.0,64.0,5,216,10021.0,20.0,15.0
240.174,6,48,7118,23,3288,10916.0,588.0,230.0,25,3830,10007.0,580.0,229.0
0.039,17,2,144,1,64,0.0,36.0,36.0,1,80,0.0,52.0,52.0
0.015,17,2,198,1,91,0.0,63.0,63.0,1,107,0.0,79.0,79.0
0.001,17,2,136,1,60,0.0,32.0,32.0,1,76,0.0,48.0,48.0
0.033,6,10,1989,5,910,8.0,642.0,642.0,5,1079,8.0,811.0,811.0
176.477,17,78,11247,39,2606,4644.0,44.0,38.0,39,8641,4644.0,261.0,193.0
0.157,6,10,1506,5,395,37.0,127.0,127.0,5,1111,35.0,843.0,843.0
0.004,6,10,2007,5,928,1.0,660.0,660.0,5,1079,1.0,811.0,811.0
0.071,6,10,1506,5,395,16.0,127.0,127.0,5,1111,14.0,843.0,843.0
0.078,6,10,1506,5,395,16.0,127.0,127.0,5,1111,16.0,843.0,843.0
40.051,17,10,676,5,460,10012.0,104.0,64.0,5,216,10012.0,20.0,15.0
1379.174,6,88,5248,49,2872,28731.0,27.0,27.0,39,2376,36293.0,27.0,26.0
0.006,6,10,1668,5,951,1.0,683.0,683.0,5,717,1.0,449.0,449.0
308.443,17,20,1124,10,716,34256.0,48.0,43.0,10,408,34256.0,20.0,12.0
40.071,17,10,676,5,460,10014.0,104.0,64.0,5,216,10017.0,20.0,15.0
40.07,17,10,676,5,460,10015.0,104.0,64.0,5,216,10016.0,20.0,15.0
0.006,6,10,1689,5,839,1.0,571.0,571.0,5,850,1.0,582.0,582.0
0.015,6,10,1989,5,910,3.0,642.0,642.0,5,1079,3.0,811.0,811.0
0.001,17,2,136,1,60,0.0,32.0,32.0,1,76,0.0,48.0,48.0
0.01,6,10,1990,5,911,2.0,643.0,643.0,5,1079,2.0,811.0,811.0
0.005,6,10,2007,5,928,1.0,660.0,660.0,5,1079,1.0,811.0,811.0
300.402,6,16,2170,9,684,37529.0,146.0,146.0,7,1486,50038.0,419.0,398.0
10.89,17,28,4421,14,1994,829.0,269.0,114.0,14,2427,829.0,586.0,145.0
0.013,6,10,1983,5,910,3.0,642.0,642.0,5,1073,3.0,805.0,805.0
0.005,6,10,1989,5,927,1.0,659.0,659.0,5,1062,1.0,794.0,794.0
0.012,6,10,1762,5,911,3.0,643.0,643.0,5,851,2.0,583.0,583.0
0.011,6,10,1989,5,910,2.0,642.0,642.0,5,1079,2.0,811.0,811.0
0.001,17,2,180,1,65,0.0,37.0,37.0,1,115,0.0,87.0,87.0
0.014,6,10,1989,5,910,3.0,642.0,642.0,5,1079,3.0,811.0,811.0
0.004,17,2,148,1,60,0.0,32.0,32.0,1,88,0.0,60.0,60.0
0.054,17,2,152,1,76,0.0,48.0,48.0,1,76,0.0,48.0,48.0
0.006,17,2,170,1,65,0.0,37.0,37.0,1,105,0.0,77.0,77.0
0.015,6,10,1631,5,848,3.0,580.0,580.0,5,783,3.0,515.0,515.0
0.085,6,10,1506,5,395,20.0,127.0,127.0,5,1111,17.0,843.0,843.0
0.0,17,2,179,1,62,0.0,34.0,34.0,1,117,0.0,89.0,89.0
40.071,17,10,676,5,460,10014.0,104.0,64.0,5,216,10016.0,20.0,15.0
1796.063,6,289,27054,146,10035,12386.0,748.0,270.0,143,17019,12648.0,1467.0,70.0
0.01,6,12,1926,6,1189,2.0,659.0,434.0,6,737,2.0,417.0,417.0
613.45,6,33,9482,18,3948,36085.0,676.0,429.0,15,5534,39531.0,1402.0,678.0
412.269,6,29,4409,12,3102,10912.0,494.0,494.0,17,1307,25766.0,83.0,83.0
0.007,17,2,164,1,74,0.0,46.0,46.0,1,90,0.0,62.0,62.0
0.008,6,10,1547,5,764,1.0,496.0,496.0,5,783,1.0,515.0,515.0
0.008,6,10,1989,5,910,2.0,642.0,642.0,5,1079,2.0,811.0,811.0
0.074,6,10,1506,5,395,16.0,127.0,127.0,5,1111,15.0,843.0,843.0
0.008,6,10,2006,5,927,2.0,659.0,659.0,5,1079,2.0,811.0,811.0
0.004,6,10,2006,5,927,1.0,659.0,659.0,5,1079,1.0,811.0,811.0
0.006,6,10,1689,5,839,1.0,571.0,571.0,5,850,1.0,582.0,582.0
0.081,6,10,1506,5,395,17.0,127.0,127.0,5,1111,18.0,843.0,843.0
0.011,6,10,1990,5,911,2.0,643.0,643.0,5,1079,2.0,811.0,811.0
0.005,6,10,1989,5,927,1.0,659.0,659.0,5,1062,1.0,794.0,794.0
0.005,6,10,1779,5,928,1.0,660.0,660.0,5,851,1.0,583.0,583.0
0.01,6,10,1631,5,848,2.0,580.0,580.0,5,783,2.0,515.0,515.0
0.009,6,10,1989,5,910,2.0,642.0,642.0,5,1079,2.0,811.0,811.0
0.015,6,10,1989,5,910,3.0,642.0,642.0,5,1079,3.0,811.0,811.0
15.072,17,15,9238,8,6902,2149.0,1350.0,834.0,7,2336,2507.0,1350.0,305.0
0.013,6,14,3787,7,497,2.0,125.0,125.0,7,3290,2.0,1448.0,972.0
0.101,6,10,1506,5,395,23.0,127.0,127.0,5,1111,23.0,843.0,843.0
0.009,6,10,1983,5,910,2.0,642.0,642.0,5,1073,2.0,805.0,805.0
0.005,6,10,2006,5,927,1.0,659.0,659.0,5,1079,1.0,811.0,811.0
352.845,6,20,2210,6,1308,12004.0,494.0,494.0,14,902,27141.0,83.0,83.0
0.007,6,10,1547,5,764,1.0,496.0,496.0,5,783,1.0,515.0,515.0
0.004,6,10,2006,5,927,1.0,659.0,659.0,5,1079,1.0,811.0,811.0
0.028,6,10,1631,5,848,6.0,580.0,580.0,5,783,6.0,515.0,515.0
0.012,6,10,1972,5,910,2.0,642.0,642.0,5,1062,3.0,794.0,794.0
0.009,6,12,1926,6,1189,1.0,659.0,434.0,6,737,1.0,417.0,417.0
0.012,6,10,1989,5,910,3.0,642.0,642.0,5,1079,3.0,811.0,811.0
0.006,17,2,249,1,64,0.0,36.0,36.0,1,185,0.0,157.0,157.0
0.013,6,10,1983,5,910,3.0,642.0,642.0,5,1073,3.0,805.0,805.0
0.006,6,10,1547,5,764,1.0,496.0,496.0,5,783,1.0,515.0,515.0
10.873,17,28,4421,14,1993,827.0,268.0,114.0,14,2428,827.0,587.0,145.0
0.006,6,10,1547,5,764,1.0,496.0,496.0,5,783,1.0,515.0,515.0
0.067,17,8,3613,4,1874,22.0,1350.0,440.0,4,1739,11.0,1350.0,406.0
0.004,17,2,136,1,60,0.0,32.0,32.0,1,76,0.0,48.0,48.0
0.08,6,10,1506,5,395,16.0,127.0,127.0,5,1111,19.0,843.0,843.0
0.043,17,2,152,1,76,0.0,48.0,48.0,1,76,0.0,48.0,48.0
0.005,17,2,212,1,74,0.0,46.0,46.0,1,138,0.0,110.0,110.0
0.005,6,10,1547,5,764,1.0,496.0,496.0,5,783,1.0,515.0,515.0
0.005,6,10,2007,5,928,1.0,660.0,660.0,5,1079,1.0,811.0,811.0
0.015,6,10,1972,5,910,3.0,642.0,642.0,5,1062,3.0,794.0,794.0
0.122,6,10,1506,5,395,27.0,127.0,127.0,5,1111,24.0,843.0,843.0
0.01,6,10,1989,5,910,2.0,642.0,642.0,5,1079,2.0,811.0,811.0
0.011,6,10,1989,5,910,2.0,642.0,642.0,5,1079,2.0,811.0,811.0
0.003,17,4,284,2,120,0.0,32.0,32.0,2,164,0.0,60.0,54.0
0.129,17,2,148,1,60,0.0,32.0,32.0,1,88,0.0,60.0,60.0
0.005,6,10,2006,5,927,1.0,659.0,659.0,5,1079,1.0,811.0,811.0
0.001,17,2,180,1,66,0.0,38.0,38.0,1,114,0.0,86.0,86.0
1799.961,17,122,11651,61,5551,29999.0,63.0,63.0,61,6100,29999.0,72.0,72.0
0.005,6,10,2006,5,927,1.0,659.0,659.0,5,1079,1.0,811.0,811.0
0.005,6,10,2006,5,927,1.0,659.0,659.0,5,1079,1.0,811.0,811.0
0.005,6,10,2006,5,927,1.0,659.0,659.0,5,1079,1.0,811.0,811.0
0.012,6,20,10099,11,829,1.0,249.0,249.0,9,9270,1.0,2896.0,1758.0
0.077,6,10,1506,5,395,17.0,127.0,127.0,5,1111,17.0,843.0,843.0
0.011,6,10,1677,5,827,2.0,559.0,559.0,5,850,2.0,582.0,582.0
0.004,6,10,1989,5,927,1.0,659.0,659.0,5,1062,1.0,794.0,794.0
0.009,6,12,1926,6,1189,1.0,659.0,434.0,6,737,1.0,417.0,417.0
0.003,17,2,148,1,60,0.0,32.0,32.0,1,88,0.0,60.0,60.0
40.077,17,10,676,5,460,10018.0,104.0,64.0,5,216,10018.0,20.0,15.0
0.037,17,2,152,1,76,0.0,48.0,48.0,1,76,0.0,48.0,48.0
0.091,6,10,1506,5,395,19.0,127.0,127.0,5,1111,18.0,843.0,843.0
0.005,6,10,2000,5,927,1.0,659.0,659.0,5,1073,1.0,805.0,805.0
0.011,6,10,1677,5,827,2.0,559.0,559.0,5,850,2.0,582.0,582.0
0.009,6,10,1762,5,911,2.0,643.0,643.0,5,851,2.0,583.0,583.0
0.011,6,10,1972,5,910,2.0,642.0,642.0,5,1062,2.0,794.0,794.0
0.007,6,10,1547,5,764,1.0,496.0,496.0,5,783,1.0,515.0,515.0
0.016,6,10,1989,5,910,3.0,642.0,642.0,5,1079,3.0,811.0,811.0
0.005,17,2,144,1,64,0.0,36.0,36.0,1,80,0.0,52.0,52.0
0.037,17,4,284,2,120,0.0,32.0,32.0,2,164,33.0,60.0,54.0
0.005,17,2,214,1,75,0.0,47.0,47.0,1,139,0.0,111.0,111.0
0.067,17,8,3613,4,1874,22.0,1350.0,440.0,4,1739,11.0,1350.0,406.0
0.004,17,2,136,1,60,0.0,32.0,32.0,1,76,0.0,48.0,48.0
0.009,6,12,1926,6,1189,1.0,659.0,434.0,6,737,1.0,417.0,417.0
0.078,6,10,1506,5,395,18.0,127.0,127.0,5,1111,17.0,843.0,843.0
0.003,17,2,152,1,76,0.0,48.0,48.0,1,76,0.0,48.0,48.0
0.009,6,10,1989,5,910,2.0,642.0,642.0,5,1079,2.0,811.0,811.0
40.064,17,10,676,5,460,10015.0,104.0,64.0,5,216,10015.0,20.0,15.0
0.024,6,10,1983,5,910,6.0,642.0,642.0,5,1073,6.0,805.0,805.0
0.075,6,10,1506,5,395,18.0,127.0,127.0,5,1111,14.0,843.0,843.0
0.128,6,10,1506,5,395,26.0,127.0,127.0,5,1111,28.0,843.0,843.0
0.091,6,10,1506,5,395,20.0,127.0,127.0,5,1111,21.0,843.0,843.0
0.065,6,10,1506,5,395,15.0,127.0,127.0,5,1111,15.0,843.0,843.0
0.016,6,10,1989,5,910,3.0,642.0,642.0,5,1079,3.0,811.0,811.0
240.084,6,16,4480,9,963,30010.0,238.0,166.0,7,3517,40013.0,1402.0,786.0
0.02,6,10,1631,5,848,4.0,580.0,580.0,5,783,4.0,515.0,515.0
0.005,6,10,1547,5,764,1.0,496.0,496.0,5,783,1.0,515.0,515.0
0.005,6,10,1989,5,927,1.0,659.0,659.0,5,1062,1.0,794.0,794.0
0.007,6,10,1689,5,839,1.0,571.0,571.0,5,850,1.0,582.0,582.0
0.006,6,10,1989,5,927,1.0,659.0,659.0,5,1062,1.0,794.0,794.0
0.006,6,10,1689,5,839,1.0,571.0,571.0,5,850,1.0,582.0,582.0
0.005,6,10,1779,5,928,1.0,660.0,660.0,5,851,1.0,583.0,583.0
0.009,6,10,1983,5,910,2.0,642.0,642.0,5,1073,2.0,805.0,805.0
0.163,6,10,1506,5,395,34.0,127.0,127.0,5,1111,36.0,843.0,843.0
0.039,17,2,184,1,61,0.0,33.0,33.0,1,123,0.0,95.0,95.0
15.086,17,15,7938,8,5923,2149.0,1350.0,712.0,7,2015,2509.0,1350.0,259.0
240.088,6,16,4481,9,963,30011.0,238.0,166.0,7,3518,40014.0,1402.0,786.0
0.015,6,10,1983,5,910,3.0,642.0,642.0,5,1073,3.0,805.0,805.0
0.005,6,10,1989,5,927,1.0,659.0,659.0,5,1062,1.0,794.0,794.0
40.084,17,10,676,5,460,10017.0,104.0,64.0,5,216,10018.0,20.0,15.0
0.098,6,10,1506,5,395,21.0,127.0,127.0,5,1111,19.0,843.0,843.0
0.122,6,10,1506,5,395,23.0,127.0,127.0,5,1111,28.0,843.0,843.0
0.013,6,10,1989,5,910,3.0,642.0,642.0,5,1079,3.0,811.0,811.0
0.006,17,2,170,1,65,0.0,37.0,37.0,1,105,0.0,77.0,77.0
0.006,6,10,1854,5,889,1.0,621.0,621.0,5,965,1.0,697.0,697.0
0.048,17,2,152,1,76,0.0,48.0,48.0,1,76,0.0,48.0,48.0
240.103,6,16,4482,9,963,30012.0,238.0,166.0,7,3519,40016.0,1402.0,786.0
0.07,6,10,1506,5,395,16.0,127.0,127.0,5,1111,13.0,843.0,843.0
0.005,6,10,2006,5,927,1.0,659.0,659.0,5,1079,1.0,811.0,811.0
0.005,6,10,2006,5,927,1.0,659.0,659.0,5,1079,1.0,811.0,811.0
0.009,6,10,1972,5,910,2.0,642.0,642.0,5,1062,2.0,794.0,794.0
0.123,6,10,1506,5,395,25.0,127.0,127.0,5,1111,27.0,843.0,843.0
0.007,6,10,1547,5,764,1.0,496.0,496.0,5,783,1.0,515.0,515.0
0.04,17,2,170,1,65,0.0,37.0,37.0,1,105,0.0,77.0,77.0
0.083,6,10,1506,5,395,18.0,127.0,127.0,5,1111,18.0,843.0,843.0
0.077,6,10,1506,5,395,15.0,127.0,127.0,5,1111,18.0,843.0,843.0
11.124,17,28,4423,14,1995,846.0,270.0,114.0,14,2428,845.0,587.0,145.0
0.001,17,2,180,1,66,0.0,38.0,38.0,1,114,0.0,86.0,86.0
0.001,17,2,180,1,66,0.0,38.0,38.0,1,114,0.0,86.0,86.0
1764.232,6,65,7413,43,4537,42005.0,1402.0,104.0,22,2876,84002.0,1112.0,82.0
0.1,6,10,1506,5,395,18.0,127.0,127.0,5,1111,21.0,843.0,843.0
0.004,17,4,284,2,120,0.0,32.0,32.0,2,164,0.0,60.0,54.0
0.004,6,10,1774,5,923,1.0,655.0,655.0,5,851,1.0,583.0,583.0
0.094,6,10,1506,5,395,21.0,127.0,127.0,5,1111,20.0,843.0,843.0
0.009,6,10,1983,5,910,2.0,642.0,642.0,5,1073,2.0,805.0,805.0
0.005,6,10,1689,5,839,1.0,571.0,571.0,5,850,1.0,582.0,582.0
0.004,6,10,1989,5,927,1.0,659.0,659.0,5,1062,1.0,794.0,794.0
0.001,17,2,179,1,62,0.0,34.0,34.0,1,117,0.0,89.0,89.0
0.005,17,2,302,1,65,0.0,37.0,37.0,1,237,0.0,209.0,209.0
40.063,17,10,676,5,460,10014.0,104.0,64.0,5,216,10015.0,20.0,15.0
178.112,17,78,11125,39,2601,4686.0,44.0,38.0,39,8524,4687.0,260.0,190.0
0.079,6,10,1506,5,395,15.0,127.0,127.0,5,1111,17.0,843.0,843.0
377.22,6,24,2405,17,919,23576.0,195.0,195.0,7,1486,3904.0,419.0,398.0
0.018,6,10,1990,5,911,4.0,643.0,643.0,5,1079,4.0,811.0,811.0
0.109,6,10,1506,5,395,24.0,127.0,127.0,5,1111,25.0,843.0,843.0
0.005,6,10,1689,5,839,1.0,571.0,571.0,5,850,1.0,582.0,582.0
0.001,17,2,180,1,66,0.0,38.0,38.0,1,114,0.0,86.0,86.0
0.046,17,4,352,2,130,6.0,37.0,37.0,2,222,42.0,89.0,83.0
0.703,6,22,5072,11,1250,59.0,325.0,133.0,11,3822,59.0,1414.0,563.0
0.001,17,2,180,1,66,0.0,38.0,38.0,1,114,0.0,86.0,86.0
0.009,6,10,2007,5,928,2.0,660.0,660.0,5,1079,2.0,811.0,811.0
0.116,6,10,1506,5,395,26.0,127.0,127.0,5,1111,28.0,843.0,843.0
0.015,6,10,1631,5,848,3.0,580.0,580.0,5,783,3.0,515.0,515.0
17.962,17,24,14849,13,12031,1494.0,1350.0,897.0,11,2818,1793.0,1350.0,228.0
0.004,6,10,2006,5,927,1.0,659.0,659.0,5,1079,1.0,811.0,811.0
0.004,6,10,2006,5,927,1.0,659.0,659.0,5,1079,1.0,811.0,811.0
0.005,6,10,1989,5,927,1.0,659.0,659.0,5,1062,1.0,794.0,794.0
0.085,6,10,1506,5,395,19.0,127.0,127.0,5,1111,19.0,843.0,843.0
0.007,6,10,1989,5,927,1.0,659.0,659.0,5,1062,1.0,794.0,794.0
0.013,6,10,1989,5,910,3.0,642.0,642.0,5,1079,3.0,811.0,811.0
0.018,6,10,1989,5,910,4.0,642.0,642.0,5,1079,4.0,811.0,811.0
0.006,6,10,2007,5,928,1.0,660.0,660.0,5,1079,1.0,811.0,811.0
0.004,6,10,1989,5,927,1.0,659.0,659.0,5,1062,1.0,794.0,794.0
0.001,17,2,166,1,75,0.0,47.0,47.0,1,91,0.0,63.0,63.0
0.009,6,12,1926,6,1189,1.0,659.0,434.0,6,737,1.0,417.0,417.0
0.021,6,13,3735,7,497,3.0,125.0,125.0,6,3238,4.0,1470.0,1459.0
0.008,6,10,1989,5,910,2.0,642.0,642.0,5,1079,1.0,811.0,811.0
0.077,6,10,1506,5,395,17.0,127.0,127.0,5,1111,18.0,843.0,843.0
0.01,17,2,148,1,60,0.0,32.0,32.0,1,88,0.0,60.0,60.0
0.11,6,10,1506,5,395,25.0,127.0,127.0,5,1111,22.0,843.0,843.0
40.07,6,67,31571,35,3387,1178.0,740.0,172.0,32,28184,1292.0,2092.0,1020.0
0.015,6,10,1990,5,911,3.0,643.0,643.0,5,1079,3.0,811.0,811.0
0.013,6,10,1989,5,910,3.0,642.0,642.0,5,1079,3.0,811.0,811.0
0.006,6,10,2000,5,927,1.0,659.0,659.0,5,1073,1.0,805.0,805.0
0.005,6,10,1547,5,764,1.0,496.0,496.0,5,783,1.0,515.0,515.0
0.136,6,10,1506,5,395,31.0,127.0,127.0,5,1111,28.0,843.0,843.0
0.011,6,10,1989,5,910,2.0,642.0,642.0,5,1079,2.0,811.0,811.0
0.006,17,2,170,1,65,0.0,37.0,37.0,1,105,0.0,77.0,77.0
0.084,6,10,1506,5,395,19.0,127.0,127.0,5,1111,20.0,843.0,843.0
0.006,6,10,1689,5,839,1.0,571.0,571.0,5,850,1.0,582.0,582.0
240.095,6,32,9495,16,7048,16006.0,2120.0,691.0,16,2447,16006.0,580.0,200.0
40.069,17,10,676,5,460,10014.0,104.0,64.0,5,216,10016.0,20.0,15.0
0.005,6,10,2007,5,928,1.0,660.0,660.0,5,1079,1.0,811.0,811.0
0.005,17,2,170,1,65,0.0,37.0,37.0,1,105,0.0,77.0,77.0
0.005,17,2,212,1,74,0.0,46.0,46.0,1,138,0.0,110.0,110.0
0.001,17,2,180,1,66,0.0,38.0,38.0,1,114,0.0,86.0,86.0
0.013,6,10,1972,5,910,3.0,642.0,642.0,5,1062,3.0,794.0,794.0
0.017,6,10,1972,5,910,4.0,642.0,642.0,5,1062,4.0,794.0,794.0
0.093,6,10,1506,5,395,18.0,127.0,127.0,5,1111,18.0,843.0,843.0
0.017,6,10,1762,5,911,4.0,643.0,643.0,5,851,4.0,583.0,583.0
0.005,6,10,2007,5,928,1.0,660.0,660.0,5,1079,1.0,811.0,811.0
0.005,6,10,2000,5,927,1.0,659.0,659.0,5,1073,1.0,805.0,805.0
40.065,17,10,676,5,460,10015.0,104.0,64.0,5,216,10015.0,20.0,15.0
0.006,6,10,1689,5,839,1.0,571.0,571.0,5,850,1.0,582.0,582.0
0.013,6,10,1990,5,911,3.0,643.0,643.0,5,1079,3.0,811.0,811.0
0.005,6,10,1989,5,927,1.0,659.0,659.0,5,1062,1.0,794.0,794.0
0.005,6,10,2006,5,927,1.0,659.0,659.0,5,1079,1.0,811.0,811.0
0.004,6,10,2007,5,928,1.0,660.0,660.0,5,1079,1.0,811.0,811.0
0.104,6,10,1506,5,395,19.0,127.0,127.0,5,1111,22.0,843.0,843.0
0.044,17,2,136,1,60,0.0,32.0,32.0,1,76,0.0,48.0,48.0
0.014,17,2,152,1,56,0.0,28.0,28.0,1,96,0.0,68.0,68.0
0.12,6,10,1506,5,395,18.0,127.0,127.0,5,1111,27.0,843.0,843.0
240.094,6,16,4481,9,963,30011.0,238.0,166.0,7,3518,40015.0,1402.0,786.0
0.082,6,10,1506,5,395,19.0,127.0,127.0,5,1111,16.0,843.0,843.0
0.018,6,10,1631,5,848,4.0,580.0,580.0,5,783,4.0,515.0,515.0
361.835,6,21,1793,16,1030,24122.0,190.0,190.0,5,763,60013.0,462.0,247.0
0.076,6,10,1506,5,395,18.0,127.0,127.0,5,1111,16.0,843.0,843.0
0.006,6,10,1689,5,839,1.0,571.0,571.0,5,850,1.0,582.0,582.0
0.016,17,2,198,1,91,0.0,63.0,63.0,1,107,0.0,79.0,79.0
0.124,6,10,1506,5,395,28.0,127.0,127.0,5,1111,28.0,843.0,843.0
0.103,6,10,1506,5,395,24.0,127.0,127.0,5,1111,24.0,843.0,843.0
0.004,6,10,1989,5,927,1.0,659.0,659.0,5,1062,1.0,794.0,794.0
0.004,17,2,148,1,60,0.0,32.0,32.0,1,88,0.0,60.0,60.0
0.002,17,2,152,1,68,0.0,40.0,40.0,1,84,0.0,56.0,56.0
40.054,17,10,676,5,460,10012.0,104.0,64.0,5,216,10012.0,20.0,15.0
40.074,17,10,676,5,460,10016.0,104.0,64.0,5,216,10017.0,20.0,15.0
0.121,6,10,1506,5,395,25.0,127.0,127.0,5,1111,18.0,843.0,843.0
0.005,6,10,1774,5,923,1.0,655.0,655.0,5,851,1.0,583.0,583.0
0.001,17,2,180,1,66,0.0,38.0,38.0,1,114,0.0,86.0,86.0
0.005,6,10,1779,5,928,1.0,660.0,660.0,5,851,1.0,583.0,583.0
1788.893,6,275,25652,139,9080,12962.0,747.0,263.0,136,16572,13251.0,1624.0,73.0
0.014,6,10,1677,5,827,3.0,559.0,559.0,5,850,3.0,582.0,582.0
0.012,6,10,1989,5,910,3.0,642.0,642.0,5,1079,3.0,811.0,811.0
0.009,6,10,1762,5,911,2.0,643.0,643.0,5,851,2.0,583.0,583.0
1770.48,6,83,4368,42,2210,43181.0,26.0,26.0,41,2158,44261.0,26.0,26.0
0.008,6,10,1762,5,911,2.0,643.0,643.0,5,851,1.0,583.0,583.0
175.458,17,100,14420,50,3346,3580.0,44.0,38.0,50,11074,3580.0,239.0,193.0
0.11,6,10,1506,5,395,25.0,127.0,127.0,5,1111,22.0,843.0,843.0
28.006,6,36,6441,20,1430,1474.0,267.0,195.0,16,5011,565.0,1823.0,363.0
0.118,6,10,1506,5,395,27.0,127.0,127.0,5,1111,27.0,843.0,843.0
0.004,6,10,2007,5,928,1.0,660.0,660.0,5,1079,1.0,811.0,811.0
40.059,17,10,676,5,460,10013.0,104.0,64.0,5,216,10013.0,20.0,15.0
300.39,6,16,2170,9,684,37528.0,146.0,146.0,7,1486,50037.0,419.0,398.0
0.006,6,10,1689,5,839,1.0,571.0,571.0,5,850,1.0,582.0,582.0
0.004,6,14,3742,7,452,0.0,80.0,80.0,7,3290,0.0,1448.0,972.0
0.005,17,2,136,1,60,0.0,32.0,32.0,1,76,0.0,48.0,48.0
175.573,17,76,11002,38,2553,4745.0,44.0,39.0,38,8449,4745.0,260.0,194.0
0.005,17,2,164,1,74,0.0,46.0,46.0,1,90,0.0,62.0,62.0
0.009,6,13,3747,7,509,1.0,137.0,137.0,6,3238,1.0,1470.0,1459.0
0.09,6,10,1506,5,395,20.0,127.0,127.0,5,1111,18.0,843.0,843.0
0.006,6,10,1689,5,839,1.0,571.0,571.0,5,850,1.0,582.0,582.0
0.015,6,10,1677,5,827,3.0,559.0,559.0,5,850,3.0,582.0,582.0
0.124,17,4,284,2,120,0.0,32.0,32.0,2,164,121.0,60.0,54.0
0.171,6,3,453,2,321,171.0,241.0,241.0,1,132,0.0,92.0,92.0
40.052,17,10,676,5,460,10012.0,104.0,64.0,5,216,10012.0,20.0,15.0
40.068,17,10,676,5,460,10016.0,104.0,64.0,5,216,10016.0,20.0,15.0
0.004,17,2,142,1,63,0.0,35.0,35.0,1,79,0.0,51.0,51.0
0.004,17,2,148,1,60,0.0,32.0,32.0,1,88,0.0,60.0,60.0
300.229,6,16,2170,9,684,37507.0,146.0,146.0,7,1486,50010.0,419.0,398.0
0.111,6,10,1506,5,395,25.0,127.0,127.0,5,1111,25.0,843.0,843.0
9.036,17,6,376,5,280,2259.0,28.0,28.0,1,96,0.0,68.0,68.0
0.006,6,10,1779,5,928,1.0,660.0,660.0,5,851,1.0,583.0,583.0
0.104,6,10,1506,5,395,21.0,127.0,127.0,5,1111,24.0,843.0,843.0
0.011,6,10,1972,5,910,2.0,642.0,642.0,5,1062,2.0,794.0,794.0
0.071,17,4,284,2,120,0.0,32.0,32.0,2,164,35.0,60.0,54.0
0.004,17,2,148,1,60,0.0,32.0,32.0,1,88,0.0,60.0,60.0
0.012,6,13,3735,7,497,2.0,125.0,125.0,6,3238,2.0,1470.0,1459.0
0.012,6,10,1989,5,910,3.0,642.0,642.0,5,1079,3.0,811.0,811.0
0.005,6,10,2006,5,927,1.0,659.0,659.0,5,1079,1.0,811.0,811.0
0.024,6,10,1762,5,911,6.0,643.0,643.0,5,851,5.0,583.0,583.0
0.004,17,2,154,1,69,0.0,41.0,41.0,1,85,0.0,57.0,57.0
0.006,17,4,284,2,120,1.0,32.0,32.0,2,164,0.0,60.0,54.0
0.038,17,4,284,2,120,0.0,32.0,32.0,2,164,35.0,60.0,54.0
0.005,6,10,1989,5,927,1.0,659.0,659.0,5,1062,1.0,794.0,794.0
0.04,17,2,128,1,56,0.0,28.0,28.0,1,72,0.0,44.0,44.0
0.005,6,10,1689,5,839,1.0,571.0,571.0,5,850,1.0,582.0,582.0
0.004,6,10,2007,5,928,1.0,660.0,660.0,5,1079,1.0,811.0,811.0
0.01,6,10,1972,5,910,2.0,642.0,642.0,5,1062,2.0,794.0,794.0
0.014,6,10,1677,5,827,3.0,559.0,559.0,5,850,3.0,582.0,582.0
0.166,17,2,152,1,76,0.0,48.0,48.0,1,76,0.0,48.0,48.0
0.004,6,10,1989,5,927,1.0,659.0,659.0,5,1062,1.0,794.0,794.0
0.006,6,10,2006,5,927,1.0,659.0,659.0,5,1079,1.0,811.0,811.0
0.006,6,10,1547,5,764,1.0,496.0,496.0,5,783,1.0,515.0,515.0
0.005,6,10,1779,5,928,1.0,660.0,660.0,5,851,1.0,583.0,583.0
0.01,6,10,1989,5,910,2.0,642.0,642.0,5,1079,2.0,811.0,811.0
0.014,6,10,1990,5,911,3.0,643.0,643.0,5,1079,3.0,811.0,811.0
0.01,6,10,1983,5,910,2.0,642.0,642.0,5,1073,2.0,805.0,805.0
0.007,17,2,214,1,75,0.0,47.0,47.0,1,139,0.0,111.0,111.0
0.078,6,10,1506,5,395,16.0,127.0,127.0,5,1111,18.0,843.0,843.0
40.056,17,10,676,5,460,10013.0,104.0,64.0,5,216,10013.0,20.0,15.0
0.006,6,10,1547,5,764,1.0,496.0,496.0,5,783,1.0,515.0,515.0
0.006,6,10,2006,5,927,1.0,659.0,659.0,5,1079,1.0,811.0,811.0
0.034,17,2,152,1,76,0.0,48.0,48.0,1,76,0.0,48.0,48.0
0.005,6,10,2006,5,927,1.0,659.0,659.0,5,1079,1.0,811.0,811.0
0.006,17,2,225,1,65,0.0,37.0,37.0,1,160,0.0,132.0,132.0
0.054,17,2,152,1,76,0.0,48.0,48.0,1,76,0.0,48.0,48.0
0.005,6,10,1779,5,928,1.0,660.0,660.0,5,851,1.0,583.0,583.0
0.013,6,10,1989,5,910,3.0,642.0,642.0,5,1079,3.0,811.0,811.0
40.065,17,10,676,5,460,10014.0,104.0,64.0,5,216,10010.0,20.0,15.0
1709.213,6,61,7143,40,4348,43825.0,1641.0,113.0,21,2795,85452.0,1114.0,85.0
0.004,17,2,136,1,60,0.0,32.0,32.0,1,76,0.0,48.0,48.0
0.011,6,10,1989,5,910,2.0,642.0,642.0,5,1079,2.0,811.0,811.0
0.005,6,10,2006,5,927,1.0,659.0,659.0,5,1079,1.0,811.0,811.0
0.006,6,10,1547,5,764,1.0,496.0,496.0,5,783,1.0,515.0,515.0
0.006,6,10,1547,5,764,1.0,496.0,496.0,5,783,1.0,515.0,515.0
0.003,17,2,136,1,60,0.0,32.0,32.0,1,76,0.0,48.0,48.0
0.106,6,10,1506,5,395,23.0,127.0,127.0,5,1111,24.0,843.0,843.0
0.088,6,10,1506,5,395,18.0,127.0,127.0,5,1111,20.0,843.0,843.0
240.091,6,16,4480,9,963,30011.0,238.0,166.0,7,3517,40014.0,1402.0,786.0
0.005,17,2,144,1,64,0.0,36.0,36.0,1,80,0.0,52.0,52.0
40.069,17,10,676,5,460,10016.0,104.0,64.0,5,216,10016.0,20.0,15.0
11.179,17,28,4422,14,1994,847.0,269.0,114.0,14,2428,847.0,587.0,145.0
0.004,6,10,2007,5,928,1.0,660.0,660.0,5,1079,1.0,811.0,811.0
0.008,6,10,1989,5,910,2.0,642.0,642.0,5,1079,2.0,811.0,811.0
0.088,6,10,1506,5,395,20.0,127.0,127.0,5,1111,19.0,843.0,843.0
2.668,6,23,6087,13,1955,222.0,517.0,253.0,10,4132,283.0,1288.0,720.0
0.004,6,10,2000,5,927,1.0,659.0,659.0,5,1073,1.0,805.0,805.0
0.011,6,10,1677,5,827,2.0,559.0,559.0,5,850,2.0,582.0,582.0
0.005,6,10,2000,5,927,1.0,659.0,659.0,5,1073,1.0,805.0,805.0
0.011,6,10,1972,5,910,2.0,642.0,642.0,5,1062,2.0,794.0,794.0
0.003,17,2,136,1,60,0.0,32.0,32.0,1,76,0.0,48.0,48.0
0.01,6,10,1631,5,848,2.0,580.0,580.0,5,783,2.0,515.0,515.0
0.018,6,10,1983,5,910,4.0,642.0,642.0,5,1073,4.0,805.0,805.0
0.006,6,10,1547,5,764,1.0,496.0,496.0,5,783,1.0,515.0,515.0
240.081,6,16,4481,9,963,30010.0,238.0,166.0,7,3518,40013.0,1402.0,786.0
0.04,17,2,148,1,60,0.0,32.0,32.0,1,88,0.0,60.0,60.0
12.099,17,29,4493,15,2415,852.0,586.0,133.0,14,2078,917.0,269.0,120.0
15.078,17,16,8580,8,6352,2150.0,1350.0,766.0,8,2228,2149.0,1350.0,250.0
40.061,17,10,676,5,460,10014.0,104.0,64.0,5,216,10014.0,20.0,15.0
0.015,6,10,1990,5,911,3.0,643.0,643.0,5,1079,3.0,811.0,811.0
0.003,17,2,136,1,60,0.0,32.0,32.0,1,76,0.0,48.0,48.0
0.005,6,10,2007,5,928,1.0,660.0,660.0,5,1079,1.0,811.0,811.0
240.009,6,9,787,5,488,60002.0,232.0,232.0,4,299,80002.0,83.0,83.0
0.072,17,2,136,1,60,0.0,32.0,32.0,1,76,0.0,48.0,48.0
0.004,6,10,2006,5,927,1.0,659.0,659.0,5,1079,1.0,811.0,811.0
0.009,6,10,1990,5,911,2.0,643.0,643.0,5,1079,2.0,811.0,811.0
0.004,17,4,284,2,120,1.0,32.0,32.0,2,164,0.0,60.0,54.0
0.009,6,10,1972,5,910,2.0,642.0,642.0,5,1062,2.0,794.0,794.0
0.004,6,10,2006,5,927,1.0,659.0,659.0,5,1079,1.0,811.0,811.0
300.781,6,35,11630,19,2954,16710.0,801.0,389.0,16,8676,16051.0,1402.0,783.0
0.009,6,10,1972,5,910,2.0,642.0,642.0,5,1062,2.0,794.0,794.0
0.009,6,10,1990,5,911,2.0,643.0,643.0,5,1079,2.0,811.0,811.0
0.005,6,10,1689,5,839,1.0,571.0,571.0,5,850,1.0,582.0,582.0
0.004,17,2,136,1,60,0.0,32.0,32.0,1,76,0.0,48.0,48.0
1778.802,6,276,38985,112,22223,16024.0,2720.0,199.0,164,16762,10912.0,1360.0,130.0
0.155,6,10,1506,5,395,37.0,127.0,127.0,5,1111,37.0,843.0,843.0
110.261,6,22,8498,12,2236,72.0,1345.0,574.0,10,6262,12232.0,2720.0,975.0
308.949,17,20,1124,10,716,34312.0,48.0,43.0,10,408,34313.0,20.0,12.0
0.013,6,10,1983,5,910,3.0,642.0,642.0,5,1073,3.0,805.0,805.0
0.013,6,10,1972,5,910,3.0,642.0,642.0,5,1062,3.0,794.0,794.0
0.011,6,10,1989,5,910,2.0,642.0,642.0,5,1079,2.0,811.0,811.0
0.017,6,10,1631,5,848,4.0,580.0,580.0,5,783,4.0,515.0,515.0
0.055,6,10,1506,5,395,12.0,127.0,127.0,5,1111,12.0,843.0,843.0
0.008,17,2,179,1,71,0.0,43.0,43.0,1,108,0.0,80.0,80.0
0.008,17,2,194,1,59,0.0,31.0,31.0,1,135,0.0,107.0,107.0
0.081,6,10,1506,5,395,15.0,127.0,127.0,5,1111,19.0,843.0,843.0
15.071,17,16,10617,9,8280,1880.0,1350.0,892.0,7,2337,2508.0,1350.0,305.0
0.002,17,2,148,1,60,0.0,32.0,32.0,1,88,0.0,60.0,60.0
0.006,6,10,2000,5,927,1.0,659.0,659.0,5,1073,1.0,805.0,805.0
0.014,6,10,1990,5,911,3.0,643.0,643.0,5,1079,3.0,811.0,811.0
0.088,6,10,1506,5,395,16.0,127.0,127.0,5,1111,21.0,843.0,843.0
0.105,6,10,1506,5,395,21.0,127.0,127.0,5,1111,22.0,843.0,843.0
0.011,6,10,1983,5,910,2.0,642.0,642.0,5,1073,2.0,805.0,805.0
0.004,6,10,2007,5,928,1.0,660.0,660.0,5,1079,1.0,811.0,811.0
0.006,6,10,1643,5,860,1.0,592.0,592.0,5,783,1.0,515.0,515.0
0.014,6,6,716,3,458,5.0,302.0,302.0,3,258,5.0,102.0,102.0
40.057,17,10,676,5,460,10012.0,104.0,64.0,5,216,10013.0,20.0,15.0
240.016,6,9,787,5,488,60004.0,232.0,232.0,4,299,80004.0,83.0,83.0
0.076,6,10,1506,5,395,18.0,127.0,127.0,5,1111,18.0,843.0,843.0
0.005,6,13,3690,7,452,0.0,80.0,80.0,6,3238,1.0,1470.0,1459.0
0.022,6,10,1990,5,911,5.0,643.0,643.0,5,1079,5.0,811.0,811.0
0.0,17,2,166,1,75,0.0,47.0,47.0,1,91,0.0,63.0,63.0
0.008,6,10,1983,5,910,2.0,642.0,642.0,5,1073,2.0,805.0,805.0
1760.635,6,480,70652,268,36403,6594.0,613.0,188.0,212,34249,8343.0,613.0,155.0
300.169,6,41,13764,21,8166,14999.0,2830.0,1215.0,20,5598,15789.0,2667.0,435.0
0.114,6,10,1506,5,395,24.0,127.0,127.0,5,1111,23.0,843.0,843.0
0.285,17,48,29778,28,26200,10.0,1350.0,907.0,20,3578,12.0,1350.0,150.0
0.009,6,10,1989,5,910,2.0,642.0,642.0,5,1079,2.0,811.0,811.0
0.09,6,10,1506,5,395,21.0,127.0,127.0,5,1111,19.0,843.0,843.0
0.006,6,10,1547,5,764,1.0,496.0,496.0,5,783,1.0,515.0,515.0
0.006,6,10,1547,5,764,1.0,496.0,496.0,5,783,1.0,515.0,515.0
0.038,17,2,182,1,65,0.0,37.0,37.0,1,117,0.0,89.0,89.0
0.008,6,10,1972,5,910,2.0,642.0,642.0,5,1062,1.0,794.0,794.0
0.094,6,10,1506,5,395,19.0,127.0,127.0,5,1111,21.0,843.0,843.0
308.351,17,18,1008,9,640,38536.0,48.0,43.0,9,368,38536.0,20.0,12.0
0.26,17,13,9139,7,6851,43.0,1350.0,950.0,6,2288,46.0,1350.0,353.0
0.005,6,14,3742,8,504,0.0,80.0,80.0,6,3238,0.0,1470.0,1459.0
0.04,17,2,170,1,65,0.0,37.0,37.0,1,105,0.0,77.0,77.0
0.017,6,10,1983,5,910,4.0,642.0,642.0,5,1073,4.0,805.0,805.0
0.008,6,10,1989,5,910,2.0,642.0,642.0,5,1079,2.0,811.0,811.0
40.068,17,10,676,5,460,10015.0,104.0,64.0,5,216,10016.0,20.0,15.0
0.095,6,10,1506,5,395,20.0,127.0,127.0,5,1111,18.0,843.0,843.0
310.307,17,20,1124,10,716,34463.0,48.0,43.0,10,408,34463.0,20.0,12.0
0.009,6,10,2006,5,927,2.0,659.0,659.0,5,1079,2.0,811.0,811.0
0.01,6,12,1926,6,1189,1.0,659.0,434.0,6,737,1.0,417.0,417.0
0.013,6,10,1989,5,910,3.0,642.0,642.0,5,1079,3.0,811.0,811.0
0.01,6,10,1989,5,910,2.0,642.0,642.0,5,1079,2.0,811.0,811.0
0.119,6,10,1506,5,395,28.0,127.0,127.0,5,1111,26.0,843.0,843.0
0.004,6,10,1774,5,923,1.0,655.0,655.0,5,851,1.0,583.0,583.0
0.01,6,10,1989,5,910,2.0,642.0,642.0,5,1079,2.0,811.0,811.0
0.005,6,10,2006,5,927,1.0,659.0,659.0,5,1079,1.0,811.0,811.0
40.056,17,10,676,5,460,10013.0,104.0,64.0,5,216,10011.0,20.0,15.0
0.014,6,10,1972,5,910,3.0,642.0,642.0,5,1062,3.0,794.0,794.0
0.016,6,10,1990,5,911,3.0,643.0,643.0,5,1079,3.0,811.0,811.0
0.095,6,10,1506,5,395,19.0,127.0,127.0,5,1111,22.0,843.0,843.0
0.006,17,2,144,1,64,0.0,36.0,36.0,1,80,0.0,52.0,52.0
40.065,17,10,676,5,460,10015.0,104.0,64.0,5,216,10015.0,20.0,15.0
0.005,17,2,169,1,62,0.0,34.0,34.0,1,107,0.0,79.0,79.0
0.004,6,10,1702,5,863,0.0,595.0,595.0,5,839,1.0,571.0,571.0
0.082,6,10,1506,5,395,19.0,127.0,127.0,5,1111,15.0,843.0,843.0
0.016,6,10,1762,5,911,4.0,643.0,643.0,5,851,3.0,583.0,583.0
0.016,6,10,1989,5,910,4.0,642.0,642.0,5,1079,4.0,811.0,811.0
0.041,17,2,182,1,65,0.0,37.0,37.0,1,117,0.0,89.0,89.0
0.006,6,10,2007,5,928,1.0,660.0,660.0,5,1079,1.0,811.0,811.0
0.117,6,10,1506,5,395,24.0,127.0,127.0,5,1111,24.0,843.0,843.0
0.016,6,10,1990,5,911,4.0,643.0,643.0,5,1079,4.0,811.0,811.0
0.012,6,10,1972,5,910,3.0,642.0,642.0,5,1062,3.0,794.0,794.0
0.017,6,13,3735,7,497,2.0,125.0,125.0,6,3238,3.0,1470.0,1459.0
0.086,6,10,1506,5,395,19.0,127.0,127.0,5,1111,17.0,843.0,843.0
40.057,17,10,676,5,460,10013.0,104.0,64.0,5,216,10013.0,20.0,15.0
0.042,17,2,166,1,75,0.0,47.0,47.0,1,91,0.0,63.0,63.0
0.006,6,10,1854,5,889,1.0,621.0,621.0,5,965,1.0,697.0,697.0
0.136,6,29,10401,16,8994,9.0,2261.0,1020.0,13,1407,10.0,325.0,121.0
0.006,6,10,1547,5,764,1.0,496.0,496.0,5,783,1.0,515.0,515.0
0.012,6,10,1990,5,911,3.0,643.0,643.0,5,1079,3.0,811.0,811.0
0.012,6,10,1990,5,911,3.0,643.0,643.0,5,1079,2.0,811.0,811.0
0.004,17,4,284,2,120,0.0,32.0,32.0,2,164,0.0,60.0,54.0
176.014,17,68,9488,34,2245,5333.0,44.0,38.0,34,7243,5333.0,239.0,185.0
0.005,6,10,1989,5,927,1.0,659.0,659.0,5,1062,1.0,794.0,794.0
241.166,6,304,343570,125,17999,1944.0,2736.0,958.0,179,325571,1354.0,2769.0,1871.0
0.038,17,2,184,1,61,0.0,33.0,33.0,1,123,0.0,95.0,95.0
0.005,6,10,1989,5,927,1.0,659.0,659.0,5,1062,1.0,794.0,794.0
0.005,17,2,179,1,71,0.0,43.0,43.0,1,108,0.0,80.0,80.0
10.926,17,28,4417,14,1994,831.0,269.0,114.0,14,2423,831.0,586.0,145.0
0.085,6,10,1506,5,395,14.0,127.0,127.0,5,1111,19.0,843.0,843.0
0.071,6,10,1506,5,395,16.0,127.0,127.0,5,1111,13.0,843.0,843.0
0.006,6,10,1547,5,764,1.0,496.0,496.0,5,783,1.0,515.0,515.0
0.072,17,2,234,1,61,0.0,33.0,33.0,1,173,0.0,145.0,145.0
0.015,17,2,198,1,91,0.0,63.0,63.0,1,107,0.0,79.0,79.0
240.078,6,16,4480,9,963,30009.0,238.0,166.0,7,3517,40012.0,1402.0,786.0
15.074,17,15,9238,8,6902,2149.0,1350.0,834.0,7,2336,2507.0,1350.0,305.0
0.005,6,10,2007,5,928,1.0,660.0,660.0,5,1079,1.0,811.0,811.0
0.11,6,10,1506,5,395,18.0,127.0,127.0,5,1111,23.0,843.0,843.0
0.005,6,10,1689,5,839,1.0,571.0,571.0,5,850,1.0,582.0,582.0
0.005,6,10,2007,5,928,1.0,660.0,660.0,5,1079,1.0,811.0,811.0
0.008,17,2,194,1,59,0.0,31.0,31.0,1,135,0.0,107.0,107.0
0.004,6,10,1989,5,927,1.0,659.0,659.0,5,1062,1.0,794.0,794.0
0.009,6,10,1983,5,910,2.0,642.0,642.0,5,1073,2.0,805.0,805.0
11.153,17,28,4421,14,1994,845.0,269.0,114.0,14,2427,845.0,586.0,145.0
0.003,17,2,148,1,60,0.0,32.0,32.0,1,88,0.0,60.0,60.0
240.014,6,9,787,5,488,60003.0,232.0,232.0,4,299,80003.0,83.0,83.0
0.112,6,10,1506,5,395,20.0,127.0,127.0,5,1111,25.0,843.0,843.0
0.041,17,2,148,1,60,0.0,32.0,32.0,1,88,0.0,60.0,60.0
0.005,6,10,1702,5,863,1.0,595.0,595.0,5,839,1.0,571.0,571.0
0.006,6,10,1689,5,839,1.0,571.0,571.0,5,850,1.0,582.0,582.0
11.302,17,28,4399,14,2313,860.0,588.0,137.0,14,2086,860.0,269.0,121.0
0.017,6,10,1972,5,910,4.0,642.0,642.0,5,1062,4.0,794.0,794.0
0.005,6,10,2006,5,927,1.0,659.0,659.0,5,1079,1.0,811.0,811.0
0.009,6,10,1989,5,910,2.0,642.0,642.0,5,1079,2.0,811.0,811.0
0.005,17,2,230,1,68,0.0,40.0,40.0,1,162,0.0,134.0,134.0
0.094,6,10,1506,5,395,22.0,127.0,127.0,5,1111,21.0,843.0,843.0
0.006,6,14,3799,7,509,0.0,137.0,137.0,7,3290,0.0,1448.0,972.0
0.005,6,10,2006,5,927,1.0,659.0,659.0,5,1079,1.0,811.0,811.0
0.005,6,13,3747,7,509,0.0,137.0,137.0,6,3238,0.0,1470.0,1459.0
0.009,6,10,1762,5,911,2.0,643.0,643.0,5,851,2.0,583.0,583.0
0.005,6,10,2007,5,928,1.0,660.0,660.0,5,1079,1.0,811.0,811.0
0.012,6,10,1989,5,910,3.0,642.0,642.0,5,1079,2.0,811.0,811.0
0.01,6,10,1972,5,910,2.0,642.0,642.0,5,1062,2.0,794.0,794.0
0.007,6,10,2000,5,927,1.0,659.0,659.0,5,1073,1.0,805.0,805.0
1799.646,17,122,11651,61,5551,29993.0,63.0,63.0,61,6100,29993.0,72.0,72.0
0.005,17,2,164,1,74,0.0,46.0,46.0,1,90,0.0,62.0,62.0
0.076,6,10,1506,5,395,16.0,127.0,127.0,5,1111,15.0,843.0,843.0
240.098,6,16,4480,9,963,30012.0,238.0,166.0,7,3517,40015.0,1402.0,786.0
0.013,6,10,1989,5,910,3.0,642.0,642.0,5,1079,3.0,811.0,811.0
0.053,17,2,169,1,62,0.0,34.0,34.0,1,107,0.0,79.0,79.0
0.009,6,10,1972,5,910,2.0,642.0,642.0,5,1062,2.0,794.0,794.0
0.156,6,10,1506,5,395,37.0,127.0,127.0,5,1111,25.0,843.0,843.0
0.083,6,10,1506,5,395,18.0,127.0,127.0,5,1111,18.0,843.0,843.0
0.019,6,10,1989,5,910,4.0,642.0,642.0,5,1079,4.0,811.0,811.0
0.105,6,10,1506,5,395,22.0,127.0,127.0,5,1111,24.0,843.0,843.0
0.001,17,2,166,1,75,0.0,47.0,47.0,1,91,0.0,63.0,63.0
0.01,6,10,1972,5,910,2.0,642.0,642.0,5,1062,2.0,794.0,794.0
0.095,6,10,1506,5,395,21.0,127.0,127.0,5,1111,18.0,843.0,843.0
0.016,6,10,1990,5,911,3.0,643.0,643.0,5,1079,4.0,811.0,811.0
0.004,6,10,2006,5,927,1.0,659.0,659.0,5,1079,1.0,811.0,811.0
0.013,6,10,1762,5,911,3.0,643.0,643.0,5,851,3.0,583.0,583.0
0.003,17,2,148,1,60,0.0,32.0,32.0,1,88,0.0,60.0,60.0
0.006,6,13,3747,7,509,0.0,137.0,137.0,6,3238,1.0,1470.0,1459.0
0.006,6,10,2007,5,928,1.0,660.0,660.0,5,1079,1.0,811.0,811.0
0.015,6,10,1990,5,911,3.0,643.0,643.0,5,1079,3.0,811.0,811.0
0.003,17,2,136,1,60,0.0,32.0,32.0,1,76,0.0,48.0,48.0
0.018,6,10,1989,5,910,4.0,642.0,642.0,5,1079,4.0,811.0,811.0
0.01,6,10,1983,5,910,2.0,642.0,642.0,5,1073,2.0,805.0,805.0
0.123,6,10,1506,5,395,27.0,127.0,127.0,5,1111,24.0,843.0,843.0
0.001,17,2,179,1,62,0.0,34.0,34.0,1,117,0.0,89.0,89.0
0.042,17,4,284,2,120,0.0,32.0,32.0,2,164,38.0,60.0,54.0
0.017,6,10,1990,5,911,4.0,643.0,643.0,5,1079,4.0,811.0,811.0
0.004,6,10,1989,5,927,1.0,659.0,659.0,5,1062,1.0,794.0,794.0
0.006,6,10,1547,5,764,1.0,496.0,496.0,5,783,1.0,515.0,515.0
324.177,17,18,1008,9,640,40506.0,48.0,43.0,9,368,40506.0,20.0,12.0
0.004,6,10,2007,5,928,1.0,660.0,660.0,5,1079,1.0,811.0,811.0
240.104,6,16,4481,9,963,30013.0,238.0,166.0,7,3518,40016.0,1402.0,786.0
0.078,6,10,1506,5,395,18.0,127.0,127.0,5,1111,16.0,843.0,843.0
0.003,17,4,284,2,120,0.0,32.0,32.0,2,164,0.0,60.0,54.0
0.014,6,12,1926,6,1189,2.0,659.0,434.0,6,737,2.0,417.0,417.0
0.038,17,2,148,1,60,0.0,32.0,32.0,1,88,0.0,60.0,60.0
0.005,17,2,164,1,74,0.0,46.0,46.0,1,90,0.0,62.0,62.0
0.005,6,10,2006,5,927,1.0,659.0,659.0,5,1079,1.0,811.0,811.0
0.003,17,2,148,1,60,0.0,32.0,32.0,1,88,0.0,60.0,60.0
0.013,6,10,1989,5,910,3.0,642.0,642.0,5,1079,3.0,811.0,811.0
11.209,17,28,4422,14,1994,849.0,269.0,114.0,14,2428,849.0,587.0,145.0
0.005,17,2,180,1,58,0.0,30.0,30.0,1,122,0.0,94.0,94.0
0.009,6,10,1989,5,910,2.0,642.0,642.0,5,1079,2.0,811.0,811.0
0.005,6,10,1689,5,839,1.0,571.0,571.0,5,850,1.0,582.0,582.0
0.004,6,10,1774,5,923,1.0,655.0,655.0,5,851,1.0,583.0,583.0
0.004,17,2,136,1,60,0.0,32.0,32.0,1,76,0.0,48.0,48.0
0.009,6,10,1990,5,911,2.0,643.0,643.0,5,1079,2.0,811.0,811.0
1787.131,6,154,19574,92,13852,19638.0,302.0,302.0,62,5722,29297.0,83.0,83.0
0.112,6,10,1506,5,395,24.0,127.0,127.0,5,1111,22.0,843.0,843.0
0.006,6,10,1854,5,889,1.0,621.0,621.0,5,965,1.0,697.0,697.0
1770.471,17,92,8096,46,4048,39343.0,60.0,60.0,46,4048,39343.0,60.0,60.0
0.009,6,10,1990,5,911,2.0,643.0,643.0,5,1079,2.0,811.0,811.0
0.005,6,10,1854,5,889,1.0,621.0,621.0,5,965,1.0,697.0,697.0
0.01,6,10,1972,5,910,2.0,642.0,642.0,5,1062,2.0,794.0,794.0
0.08,6,10,1506,5,395,17.0,127.0,127.0,5,1111,16.0,843.0,843.0
0.005,6,10,2000,5,927,1.0,659.0,659.0,5,1073,1.0,805.0,805.0
0.005,6,10,1989,5,927,1.0,659.0,659.0,5,1062,1.0,794.0,794.0
332.882,17,20,1124,10,716,36977.0,48.0,43.0,10,408,36974.0,20.0,12.0
0.012,6,10,1983,5,910,3.0,642.0,642.0,5,1073,3.0,805.0,805.0
0.005,6,10,1643,5,860,1.0,592.0,592.0,5,783,1.0,515.0,515.0
0.008,6,10,1972,5,910,2.0,642.0,642.0,5,1062,1.0,794.0,794.0
0.006,6,10,1689,5,839,1.0,571.0,571.0,5,850,1.0,582.0,582.0
0.001,17,2,180,1,66,0.0,38.0,38.0,1,114,0.0,86.0,86.0
0.006,6,10,1547,5,764,1.0,496.0,496.0,5,783,1.0,515.0,515.0
0.014,6,10,1972,5,910,3.0,642.0,642.0,5,1062,3.0,794.0,794.0
0.004,17,2,148,1,60,0.0,32.0,32.0,1,88,0.0,60.0,60.0
0.03,6,10,1990,5,911,7.0,643.0,643.0,5,1079,7.0,811.0,811.0
0.004,6,10,2006,5,927,1.0,659.0,659.0,5,1079,1.0,811.0,811.0
0.016,6,10,1972,5,910,3.0,642.0,642.0,5,1062,3.0,794.0,794.0
0.004,17,2,148,1,60,0.0,32.0,32.0,1,88,0.0,60.0,60.0
0.004,6,10,2006,5,927,1.0,659.0,659.0,5,1079,1.0,811.0,811.0
0.005,6,10,1989,5,927,1.0,659.0,659.0,5,1062,1.0,794.0,794.0
0.095,6,10,1506,5,395,21.0,127.0,127.0,5,1111,21.0,843.0,843.0
0.005,17,2,179,1,71,0.0,43.0,43.0,1,108,0.0,80.0,80.0
0.093,6,10,1506,5,395,21.0,127.0,127.0,5,1111,21.0,843.0,843.0
0.01,6,10,1983,5,910,2.0,642.0,642.0,5,1073,2.0,805.0,805.0
0.005,17,2,164,1,74,0.0,46.0,46.0,1,90,0.0,62.0,62.0
0.012,6,10,1990,5,911,3.0,643.0,643.0,5,1079,2.0,811.0,811.0
0.015,6,10,1990,5,911,3.0,643.0,643.0,5,1079,3.0,811.0,811.0
0.06,6,10,1506,5,395,13.0,127.0,127.0,5,1111,14.0,843.0,843.0
0.017,6,10,1972,5,910,4.0,642.0,642.0,5,1062,4.0,794.0,794.0
0.005,6,10,1989,5,927,1.0,659.0,659.0,5,1062,1.0,794.0,794.0
0.003,17,2,162,1,65,0.0,37.0,37.0,1,97,0.0,69.0,69.0
0.005,17,2,164,1,74,0.0,46.0,46.0,1,90,0.0,62.0,62.0
0.001,17,2,180,1,66,0.0,38.0,38.0,1,114,0.0,86.0,86.0
300.35,6,16,2170,9,684,37522.0,146.0,146.0,7,1486,50029.0,419.0,398.0
0.006,6,10,1547,5,764,1.0,496.0,496.0,5,783,1.0,515.0,515.0
0.005,6,10,2007,5,928,1.0,660.0,660.0,5,1079,1.0,811.0,811.0
240.09,6,16,4480,9,963,30011.0,238.0,166.0,7,3517,40014.0,1402.0,786.0
0.014,17,2,160,1,72,0.0,44.0,44.0,1,88,0.0,60.0,60.0
0.008,6,10,1989,5,910,2.0,642.0,642.0,5,1079,2.0,811.0,811.0
0.005,6,10,1989,5,927,1.0,659.0,659.0,5,1062,1.0,794.0,794.0
0.015,6,10,1989,5,910,3.0,642.0,642.0,5,1079,3.0,811.0,811.0
0.006,6,10,2000,5,927,1.0,659.0,659.0,5,1073,1.0,805.0,805.0
0.031,6,10,1972,5,910,7.0,642.0,642.0,5,1062,7.0,794.0,794.0
1750.36,6,440,64908,252,35168,6973.0,613.0,197.0,188,29740,9359.0,453.0,142.0
11.207,17,28,4417,14,1993,849.0,268.0,114.0,14,2424,849.0,587.0,145.0
240.248,6,23,7155,12,1170,21840.0,217.0,179.0,11,5985,24024.0,1679.0,902.0
0.009,6,10,1762,5,911,2.0,643.0,643.0,5,851,2.0,583.0,583.0
40.063,17,10,676,5,460,10013.0,104.0,64.0,5,216,10013.0,20.0,15.0
0.006,6,10,2007,5,928,1.0,660.0,660.0,5,1079,1.0,811.0,811.0
0.215,6,16,2782,8,1400,30.0,533.0,325.0,8,1382,19.0,529.0,239.0
0.005,6,10,1689,5,839,1.0,571.0,571.0,5,850,1.0,582.0,582.0
0.076,6,10,1506,5,395,14.0,127.0,127.0,5,1111,15.0,843.0,843.0
0.011,6,10,1677,5,827,2.0,559.0,559.0,5,850,2.0,582.0,582.0
0.005,6,10,2000,5,927,1.0,659.0,659.0,5,1073,1.0,805.0,805.0
0.011,6,10,1989,5,910,2.0,642.0,642.0,5,1079,2.0,811.0,811.0
0.001,17,2,140,1,62,0.0,34.0,34.0,1,78,0.0,50.0,50.0
0.132,6,10,1506,5,395,30.0,127.0,127.0,5,1111,29.0,843.0,843.0
0.004,6,10,1989,5,927,1.0,659.0,659.0,5,1062,1.0,794.0,794.0
0.012,6,10,1983,5,910,2.0,642.0,642.0,5,1073,3.0,805.0,805.0
0.07,17,8,3613,4,1874,23.0,1350.0,440.0,4,1739,12.0,1350.0,406.0
0.019,6,10,1989,5,910,4.0,642.0,642.0,5,1079,4.0,811.0,811.0
0.04,17,4,284,2,120,0.0,32.0,32.0,2,164,36.0,60.0,54.0
0.08,6,10,1506,5,395,16.0,127.0,127.0,5,1111,18.0,843.0,843.0
0.098,6,10,1506,5,395,20.0,127.0,127.0,5,1111,23.0,843.0,843.0
0.005,6,10,1989,5,927,1.0,659.0,659.0,5,1062,1.0,794.0,794.0
0.02,6,10,1989,5,910,4.0,642.0,642.0,5,1079,4.0,811.0,811.0
0.004,17,2,136,1,60,0.0,32.0,32.0,1,76,0.0,48.0,48.0
0.097,6,10,1506,5,395,21.0,127.0,127.0,5,1111,22.0,843.0,843.0
0.115,6,10,1506,5,395,23.0,127.0,127.0,5,1111,24.0,843.0,843.0
0.004,17,2,160,1,72,0.0,44.0,44.0,1,88,0.0,60.0,60.0
0.005,6,10,1774,5,923,1.0,655.0,655.0,5,851,1.0,583.0,583.0
0.005,17,2,164,1,74,0.0,46.0,46.0,1,90,0.0,62.0,62.0
0.001,17,2,180,1,66,0.0,38.0,38.0,1,114,0.0,86.0,86.0
0.005,6,10,1689,5,839,1.0,571.0,571.0,5,850,1.0,582.0,582.0
0.005,6,10,1779,5,928,1.0,660.0,660.0,5,851,1.0,583.0,583.0
0.006,6,12,1698,6,863,1.0,327.0,271.0,6,835,1.0,515.0,515.0
0.006,6,10,1547,5,764,1.0,496.0,496.0,5,783,1.0,515.0,515.0
15.071,17,15,9238,8,6902,2149.0,1350.0,834.0,7,2336,2507.0,1350.0,305.0
0.072,17,4,352,2,130,0.0,37.0,37.0,2,222,33.0,89.0,83.0
0.128,17,2,80,1,32,0.0,4.0,4.0,1,48,0.0,20.0,20.0
0.018,6,10,1989,5,910,4.0,642.0,642.0,5,1079,4.0,811.0,811.0
0.01,6,10,1677,5,827,2.0,559.0,559.0,5,850,2.0,582.0,582.0
0.108,6,10,1506,5,395,23.0,127.0,127.0,5,1111,26.0,843.0,843.0
0.004,6,10,1779,5,928,1.0,660.0,660.0,5,851,1.0,583.0,583.0
0.006,17,2,144,1,64,0.0,36.0,36.0,1,80,0.0,52.0,52.0
0.02,6,10,1762,5,911,4.0,643.0,643.0,5,851,5.0,583.0,583.0
0.012,6,13,3735,7,497,2.0,125.0,125.0,6,3238,2.0,1470.0,1459.0
0.012,6,10,1972,5,910,2.0,642.0,642.0,5,1062,3.0,794.0,794.0
0.081,6,10,1506,5,395,18.0,127.0,127.0,5,1111,19.0,843.0,843.0
15.073,17,14,9190,8,6902,2149.0,1350.0,834.0,6,2288,3008.0,1350.0,353.0
0.004,6,10,2006,5,927,1.0,659.0,659.0,5,1079,1.0,811.0,811.0
0.011,6,10,1989,5,910,2.0,642.0,642.0,5,1079,2.0,811.0,811.0
0.002,17,2,136,1,60,0.0,32.0,32.0,1,76,0.0,48.0,48.0
0.004,17,2,148,1,60,0.0,32.0,32.0,1,88,0.0,60.0,60.0
366.84,6,22,2313,16,867,24456.0,195.0,195.0,6,1446,4638.0,419.0,398.0
0.005,6,10,2000,5,927,1.0,659.0,659.0,5,1073,1.0,805.0,805.0
0.077,6,10,1506,5,395,16.0,127.0,127.0,5,1111,18.0,843.0,843.0
0.005,6,10,2007,5,928,1.0,660.0,660.0,5,1079,1.0,811.0,811.0
0.11,6,10,1506,5,395,23.0,127.0,127.0,5,1111,22.0,843.0,843.0
0.005,17,2,179,1,71,0.0,43.0,43.0,1,108,0.0,80.0,80.0
0.005,6,10,2006,5,927,1.0,659.0,659.0,5,1079,1.0,811.0,811.0
0.022,6,10,1983,5,910,5.0,642.0,642.0,5,1073,5.0,805.0,805.0
0.346,17,41,22993,23,18472,15.0,1350.0,775.0,18,4521,16.0,1350.0,223.0
0.006,6,10,1547,5,764,1.0,496.0,496.0,5,783,1.0,515.0,515.0
0.004,6,10,2006,5,927,1.0,659.0,659.0,5,1079,1.0,811.0,811.0
0.006,6,10,1547,5,764,1.0,496.0,496.0,5,783,1.0,515.0,515.0
0.008,6,12,1926,6,1189,1.0,659.0,434.0,6,737,1.0,417.0,417.0
40.055,17,10,676,5,460,10013.0,104.0,64.0,5,216,10012.0,20.0,15.0
0.007,17,2,179,1,71,0.0,43.0,43.0,1,108,0.0,80.0,80.0
40.054,17,10,676,5,460,10012.0,104.0,64.0,5,216,10012.0,20.0,15.0
0.004,6,10,1774,5,923,1.0,655.0,655.0,5,851,1.0,583.0,583.0
312.897,17,20,1124,10,716,34759.0,48.0,43.0,10,408,34759.0,20.0,12.0
0.04,17,2,182,1,65,0.0,37.0,37.0,1,117,0.0,89.0,89.0
0.124,17,2,184,1,61,0.0,33.0,33.0,1,123,0.0,95.0,95.0
0.109,6,10,1506,5,395,24.0,127.0,127.0,5,1111,26.0,843.0,843.0
0.005,17,2,144,1,64,0.0,36.0,36.0,1,80,0.0,52.0,52.0
0.037,17,4,284,2,120,0.0,32.0,32.0,2,164,33.0,60.0,54.0
0.166,17,2,152,1,76,0.0,48.0,48.0,1,76,0.0,48.0,48.0
0.005,6,10,1989,5,927,1.0,659.0,659.0,5,1062,1.0,794.0,794.0
0.005,6,14,3742,7,452,0.0,80.0,80.0,7,3290,0.0,1448.0,972.0
0.005,17,2,148,1,60,0.0,32.0,32.0,1,88,0.0,60.0,60.0
0.005,6,10,1989,5,927,1.0,659.0,659.0,5,1062,1.0,794.0,794.0
240.217,6,37,6872,18,3282,14130.0,880.0,334.0,19,3590,13343.0,1306.0,370.0
0.041,17,2,184,1,61,0.0,33.0,33.0,1,123,0.0,95.0,95.0
10.965,17,28,4422,14,1994,835.0,269.0,114.0,14,2428,835.0,587.0,145.0
0.003,17,2,148,1,60,0.0,32.0,32.0,1,88,0.0,60.0,60.0
0.015,6,10,1989,5,910,3.0,642.0,642.0,5,1079,3.0,811.0,811.0
0.125,17,2,80,1,32,0.0,4.0,4.0,1,48,0.0,20.0,20.0
0.006,6,10,1547,5,764,1.0,496.0,496.0,5,783,1.0,515.0,515.0
0.005,6,10,2006,5,927,1.0,659.0,659.0,5,1079,1.0,811.0,811.0
0.005,6,10,1989,5,927,1.0,659.0,659.0,5,1062,1.0,794.0,794.0
0.009,6,10,1989,5,910,2.0,642.0,642.0,5,1079,2.0,811.0,811.0
0.004,17,4,284,2,120,0.0,32.0,32.0,2,164,1.0,60.0,54.0
0.01,6,10,1990,5,911,2.0,643.0,643.0,5,1079,2.0,811.0,811.0
0.011,6,10,1989,5,910,2.0,642.0,642.0,5,1079,2.0,811.0,811.0
0.016,6,10,1990,5,911,4.0,643.0,643.0,5,1079,3.0,811.0,811.0
0.006,6,10,1689,5,839,1.0,571.0,571.0,5,850,1.0,582.0,582.0
0.016,6,10,1972,5,910,4.0,642.0,642.0,5,1062,4.0,794.0,794.0
0.007,6,10,1989,5,910,1.0,642.0,642.0,5,1079,1.0,811.0,811.0
40.056,17,10,676,5,460,10013.0,104.0,64.0,5,216,10013.0,20.0,15.0
0.091,6,10,1506,5,395,19.0,127.0,127.0,5,1111,20.0,843.0,843.0
0.008,6,12,1926,6,1189,1.0,659.0,434.0,6,737,1.0,417.0,417.0
0.018,6,10,1989,5,910,4.0,642.0,642.0,5,1079,4.0,811.0,811.0
240.093,6,32,8997,16,6541,16006.0,1612.0,634.0,16,2456,16006.0,580.0,202.0
0.007,6,10,1983,5,910,1.0,642.0,642.0,5,1073,1.0,805.0,805.0
0.017,6,10,1762,5,911,4.0,643.0,643.0,5,851,4.0,583.0,583.0
0.016,6,10,1972,5,910,3.0,642.0,642.0,5,1062,4.0,794.0,794.0
0.013,6,10,1989,5,910,3.0,642.0,642.0,5,1079,3.0,811.0,811.0
0.08,6,10,1506,5,395,17.0,127.0,127.0,5,1111,17.0,843.0,843.0
0.006,6,10,1989,5,927,1.0,659.0,659.0,5,1062,1.0,794.0,794.0
0.005,6,13,3747,7,509,0.0,137.0,137.0,6,3238,0.0,1470.0,1459.0
0.001,17,2,179,1,62,0.0,34.0,34.0,1,117,0.0,89.0,89.0
0.006,6,10,1547,5,764,1.0,496.0,496.0,5,783,1.0,515.0,515.0
0.004,6,10,2006,5,927,1.0,659.0,659.0,5,1079,1.0,811.0,811.0
0.006,6,10,1689,5,839,1.0,571.0,571.0,5,850,1.0,582.0,582.0
0.013,6,10,1972,5,910,3.0,642.0,642.0,5,1062,3.0,794.0,794.0
0.072,17,4,352,2,130,2.0,37.0,37.0,2,222,31.0,89.0,83.0
0.14,6,10,1506,5,395,32.0,127.0,127.0,5,1111,34.0,843.0,843.0
0.004,6,10,1989,5,927,1.0,659.0,659.0,5,1062,1.0,794.0,794.0
0.005,17,2,230,1,68,0.0,40.0,40.0,1,162,0.0,134.0,134.0
0.009,6,10,1762,5,911,2.0,643.0,643.0,5,851,2.0,583.0,583.0
0.1,6,10,1506,5,395,21.0,127.0,127.0,5,1111,23.0,843.0,843.0
0.085,6,10,1506,5,395,16.0,127.0,127.0,5,1111,18.0,843.0,843.0
0.007,6,10,1689,5,839,1.0,571.0,571.0,5,850,1.0,582.0,582.0
0.005,17,2,169,1,62,0.0,34.0,34.0,1,107,0.0,79.0,79.0
0.004,17,2,148,1,60,0.0,32.0,32.0,1,88,0.0,60.0,60.0
0.005,17,2,214,1,75,0.0,47.0,47.0,1,139,0.0,111.0,111.0
0.071,17,2,144,1,64,0.0,36.0,36.0,1,80,0.0,52.0,52.0
0.111,6,10,1506,5,395,26.0,127.0,127.0,5,1111,24.0,843.0,843.0
0.066,6,10,1506,5,395,14.0,127.0,127.0,5,1111,15.0,843.0,843.0
0.027,6,10,1677,5,827,6.0,559.0,559.0,5,850,6.0,582.0,582.0
0.14,6,10,1506,5,395,32.0,127.0,127.0,5,1111,30.0,843.0,843.0
0.146,6,10,1506,5,395,34.0,127.0,127.0,5,1111,32.0,843.0,843.0
0.058,17,2,162,1,65,0.0,37.0,37.0,1,97,0.0,69.0,69.0
0.096,6,10,1506,5,395,20.0,127.0,127.0,5,1111,22.0,843.0,843.0
0.004,6,10,2000,5,927,1.0,659.0,659.0,5,1073,1.0,805.0,805.0
0.005,17,2,230,1,68,0.0,40.0,40.0,1,162,0.0,134.0,134.0
0.012,6,10,1972,5,910,3.0,642.0,642.0,5,1062,2.0,794.0,794.0
0.101,6,10,1506,5,395,21.0,127.0,127.0,5,1111,24.0,843.0,843.0
40.063,17,10,676,5,460,10015.0,104.0,64.0,5,216,10014.0,20.0,15.0
0.012,6,10,1990,5,911,3.0,643.0,643.0,5,1079,3.0,811.0,811.0
0.096,6,10,1506,5,395,21.0,127.0,127.0,5,1111,22.0,843.0,843.0
0.003,17,2,148,1,60,0.0,32.0,32.0,1,88,0.0,60.0,60.0
0.009,6,13,3735,7,497,1.0,125.0,125.0,6,3238,1.0,1470.0,1459.0
0.003,17,2,148,1,60,0.0,32.0,32.0,1,88,0.0,60.0,60.0
0.006,6,10,2000,5,927,1.0,659.0,659.0,5,1073,1.0,805.0,805.0
0.01,6,10,1677,5,827,2.0,559.0,559.0,5,850,2.0,582.0,582.0
0.015,6,10,1972,5,910,3.0,642.0,642.0,5,1062,3.0,794.0,794.0
76.424,6,22,8495,12,2236,73.0,1345.0,574.0,10,6259,8473.0,2720.0,974.0
0.005,6,14,3736,7,446,0.0,74.0,74.0,7,3290,0.0,1448.0,972.0
0.003,17,2,148,1,60,0.0,32.0,32.0,1,88,0.0,60.0,60.0
0.006,6,10,1989,5,927,1.0,659.0,659.0,5,1062,1.0,794.0,794.0
0.014,6,10,1990,5,911,3.0,643.0,643.0,5,1079,3.0,811.0,811.0
0.043,17,2,136,1,60,0.0,32.0,32.0,1,76,0.0,48.0,48.0
1.897,6,35,8390,18,1958,111.0,890.0,402.0,17,6432,110.0,2720.0,478.0
0.014,6,10,1990,5,911,3.0,643.0,643.0,5,1079,3.0,811.0,811.0
0.067,6,10,1506,5,395,14.0,127.0,127.0,5,1111,14.0,843.0,843.0
0.004,6,10,2000,5,927,1.0,659.0,659.0,5,1073,1.0,805.0,805.0
0.217,6,16,2670,8,1396,31.0,533.0,324.0,8,1274,20.0,529.0,212.0
0.016,6,10,1983,5,910,4.0,642.0,642.0,5,1073,3.0,805.0,805.0
240.109,6,16,4481,9,963,30013.0,238.0,166.0,7,3518,40017.0,1402.0,786.0
0.005,17,2,214,1,75,0.0,47.0,47.0,1,139,0.0,111.0,111.0
0.006,6,10,1547,5,764,1.0,496.0,496.0,5,783,1.0,515.0,515.0
0.011,6,11,2024,6,962,2.0,642.0,642.0,5,1062,2.0,794.0,794.0
0.005,6,14,3742,7,452,0.0,80.0,80.0,7,3290,0.0,1448.0,972.0
0.012,6,10,1989,5,910,3.0,642.0,642.0,5,1079,3.0,811.0,811.0
0.092,6,10,1989,5,910,23.0,642.0,642.0,5,1079,23.0,811.0,811.0
0.038,17,2,144,1,64,0.0,36.0,36.0,1,80,0.0,52.0,52.0
0.008,6,12,1926,6,1189,1.0,659.0,434.0,6,737,1.0,417.0,417.0
0.1,6,10,1506,5,395,22.0,127.0,127.0,5,1111,23.0,843.0,843.0
0.001,17,2,136,1,60,0.0,32.0,32.0,1,76,0.0,48.0,48.0
0.009,6,10,1983,5,910,2.0,642.0,642.0,5,1073,2.0,805.0,805.0
40.06,17,10,676,5,460,10014.0,104.0,64.0,5,216,10014.0,20.0,15.0
0.006,6,10,1547,5,764,1.0,496.0,496.0,5,783,1.0,515.0,515.0
0.007,6,10,1779,5,928,1.0,660.0,660.0,5,851,1.0,583.0,583.0
0.013,6,10,1983,5,910,3.0,642.0,642.0,5,1073,3.0,805.0,805.0
0.005,6,10,2006,5,927,1.0,659.0,659.0,5,1079,1.0,811.0,811.0
0.016,6,10,1989,5,910,4.0,642.0,642.0,5,1079,4.0,811.0,811.0
15.071,17,15,9238,8,6902,2149.0,1350.0,834.0,7,2336,2506.0,1350.0,305.0
0.005,6,10,2006,5,927,1.0,659.0,659.0,5,1079,1.0,811.0,811.0
174.152,17,72,10404,36,2402,4975.0,44.0,38.0,36,8002,4975.0,261.0,194.0
0.005,6,10,1774,5,923,1.0,655.0,655.0,5,851,1.0,583.0,583.0
0.017,6,10,1990,5,911,4.0,643.0,643.0,5,1079,4.0,811.0,811.0
40.058,17,10,676,5,460,10013.0,104.0,64.0,5,216,10013.0,20.0,15.0
0.009,6,10,1972,5,910,2.0,642.0,642.0,5,1062,2.0,794.0,794.0
0.006,6,10,1547,5,764,1.0,496.0,496.0,5,783,1.0,515.0,515.0
0.015,6,10,1989,5,910,3.0,642.0,642.0,5,1079,3.0,811.0,811.0
40.06,17,10,676,5,460,10014.0,104.0,64.0,5,216,10014.0,20.0,15.0
0.014,6,10,1972,5,910,3.0,642.0,642.0,5,1062,3.0,794.0,794.0
0.005,6,10,1774,5,923,1.0,655.0,655.0,5,851,1.0,583.0,583.0
0.174,17,4,352,2,130,132.0,37.0,37.0,2,222,135.0,89.0,83.0
0.006,6,10,2000,5,927,1.0,659.0,659.0,5,1073,1.0,805.0,805.0
0.111,6,10,1506,5,395,23.0,127.0,127.0,5,1111,26.0,843.0,843.0
0.005,6,10,2006,5,927,1.0,659.0,659.0,5,1079,1.0,811.0,811.0
0.013,6,14,3787,7,497,2.0,125.0,125.0,7,3290,2.0,1448.0,972.0
0.037,17,2,186,1,61,0.0,33.0,33.0,1,125,0.0,97.0,97.0
40.079,17,10,676,5,460,10019.0,104.0,64.0,5,216,10019.0,20.0,15.0
0.048,6,10,1506,5,395,11.0,127.0,127.0,5,1111,11.0,843.0,843.0
0.003,17,2,148,1,60,0.0,32.0,32.0,1,88,0.0,60.0,60.0
177.254,17,92,13069,46,3072,3938.0,44.0,38.0,46,9997,3938.0,261.0,189.0
0.076,6,10,1506,5,395,17.0,127.0,127.0,5,1111,15.0,843.0,843.0
40.07,17,10,676,5,460,10014.0,104.0,64.0,5,216,10016.0,20.0,15.0
40.077,17,10,676,5,460,10018.0,104.0,64.0,5,216,10018.0,20.0,15.0
0.002,17,2,142,1,63,0.0,35.0,35.0,1,79,0.0,51.0,51.0
0.005,6,10,2000,5,927,1.0,659.0,659.0,5,1073,1.0,805.0,805.0
0.004,17,4,284,2,120,1.0,32.0,32.0,2,164,0.0,60.0,54.0
0.005,6,10,2000,5,927,1.0,659.0,659.0,5,1073,1.0,805.0,805.0
0.007,6,10,1774,5,923,1.0,655.0,655.0,5,851,1.0,583.0,583.0
360.032,6,21,3981,13,3142,30002.0,494.0,494.0,8,839,51432.0,83.0,83.0
0.005,17,2,168,1,76,0.0,48.0,48.0,1,92,0.0,64.0,64.0
0.016,6,10,1677,5,827,3.0,559.0,559.0,5,850,3.0,582.0,582.0
0.017,6,10,1972,5,910,4.0,642.0,642.0,5,1062,4.0,794.0,794.0
0.117,6,10,1506,5,395,25.0,127.0,127.0,5,1111,25.0,843.0,843.0
0.097,6,10,1506,5,395,20.0,127.0,127.0,5,1111,20.0,843.0,843.0
0.079,6,10,1506,5,395,18.0,127.0,127.0,5,1111,17.0,843.0,843.0
0.018,6,10,1989,5,910,4.0,642.0,642.0,5,1079,4.0,811.0,811.0
0.019,6,10,1983,5,910,4.0,642.0,642.0,5,1073,4.0,805.0,805.0
0.029,6,10,1989,5,910,7.0,642.0,642.0,5,1079,7.0,811.0,811.0
0.004,17,4,284,2,120,0.0,32.0,32.0,2,164,0.0,60.0,54.0
0.008,6,10,1990,5,911,1.0,643.0,643.0,5,1079,2.0,811.0,811.0
0.067,17,8,3613,4,1874,22.0,1350.0,440.0,4,1739,10.0,1350.0,406.0
0.016,6,10,1983,5,910,4.0,642.0,642.0,5,1073,4.0,805.0,805.0
173.449,17,88,12839,44,2961,4033.0,44.0,39.0,44,9878,4033.0,260.0,196.0
0.092,6,10,1506,5,395,20.0,127.0,127.0,5,1111,20.0,843.0,843.0
0.014,6,10,1989,5,910,3.0,642.0,642.0,5,1079,3.0,811.0,811.0
0.005,6,13,3690,7,452,0.0,80.0,80.0,6,3238,0.0,1470.0,1459.0
0.017,17,2,198,1,91,0.0,63.0,63.0,1,107,0.0,79.0,79.0
0.006,6,10,2007,5,928,1.0,660.0,660.0,5,1079,1.0,811.0,811.0
0.013,6,10,1989,5,910,3.0,642.0,642.0,5,1079,3.0,811.0,811.0
0.002,17,2,136,1,60,0.0,32.0,32.0,1,76,0.0,48.0,48.0
0.005,6,10,2000,5,927,1.0,659.0,659.0,5,1073,1.0,805.0,805.0
0.007,6,10,1547,5,764,1.0,496.0,496.0,5,783,1.0,515.0,515.0
0.017,6,13,3735,7,497,2.0,125.0,125.0,6,3238,3.0,1470.0,1459.0
0.004,6,10,2006,5,927,1.0,659.0,659.0,5,1079,1.0,811.0,811.0
0.005,6,10,1643,5,860,1.0,592.0,592.0,5,783,1.0,515.0,515.0
0.072,17,2,184,1,61,0.0,33.0,33.0,1,123,0.0,95.0,95.0
0.005,6,10,1989,5,927,1.0,659.0,659.0,5,1062,1.0,794.0,794.0
0.069,17,8,3613,4,1874,23.0,1350.0,440.0,4,1739,11.0,1350.0,406.0
0.08,6,10,1506,5,395,16.0,127.0,127.0,5,1111,14.0,843.0,843.0
0.111,6,10,1506,5,395,24.0,127.0,127.0,5,1111,22.0,843.0,843.0
0.015,6,10,1989,5,910,3.0,642.0,642.0,5,1079,3.0,811.0,811.0
300.026,6,12,1782,7,1348,50004.0,494.0,494.0,5,434,75006.0,83.0,83.0
0.021,6,13,3735,7,497,3.0,125.0,125.0,6,3238,4.0,1470.0,1459.0
0.009,6,13,3735,7,497,1.0,125.0,125.0,6,3238,1.0,1470.0,1459.0
0.006,6,10,1547,5,764,1.0,496.0,496.0,5,783,1.0,515.0,515.0
0.006,6,10,1547,5,764,1.0,496.0,496.0,5,783,1.0,515.0,515.0
0.071,17,2,136,1,60,0.0,32.0,32.0,1,76,0.0,48.0,48.0
0.158,6,10,1506,5,395,35.0,127.0,127.0,5,1111,36.0,843.0,843.0
0.005,6,10,2006,5,927,1.0,659.0,659.0,5,1079,1.0,811.0,811.0
0.014,6,10,1989,5,910,3.0,642.0,642.0,5,1079,3.0,811.0,811.0
0.068,6,10,1506,5,395,15.0,127.0,127.0,5,1111,16.0,843.0,843.0
0.013,6,10,1972,5,910,3.0,642.0,642.0,5,1062,3.0,794.0,794.0
10.994,17,28,4398,14,2311,837.0,586.0,137.0,14,2087,837.0,270.0,121.0
0.005,6,10,2006,5,927,1.0,659.0,659.0,5,1079,1.0,811.0,811.0
0.004,6,10,2006,5,927,1.0,659.0,659.0,5,1079,1.0,811.0,811.0
300.206,6,27,7436,16,1409,20013.0,217.0,142.0,11,6027,24019.0,1679.0,778.0
0.004,17,4,284,2,120,0.0,32.0,32.0,2,164,1.0,60.0,54.0
25.373,17,88,49614,40,18439,649.0,1350.0,432.0,48,31175,539.0,1350.0,621.0
0.074,6,10,1506,5,395,17.0,127.0,127.0,5,1111,18.0,843.0,843.0
0.004,17,4,284,2,120,0.0,32.0,32.0,2,164,0.0,60.0,54.0
0.017,6,10,1990,5,911,4.0,643.0,643.0,5,1079,4.0,811.0,811.0
241.188,6,20,6392,11,1871,24118.0,1038.0,434.0,9,4521,30147.0,1592.0,809.0
0.004,6,10,2000,5,927,1.0,659.0,659.0,5,1073,1.0,805.0,805.0
0.071,17,2,170,1,65,0.0,37.0,37.0,1,105,0.0,77.0,77.0
0.013,6,10,1631,5,848,3.0,580.0,580.0,5,783,3.0,515.0,515.0
0.011,17,2,179,1,71,0.0,43.0,43.0,1,108,0.0,80.0,80.0
0.006,6,10,1547,5,764,1.0,496.0,496.0,5,783,1.0,515.0,515.0
0.005,6,10,1547,5,764,1.0,496.0,496.0,5,783,1.0,515.0,515.0
300.766,6,38,9637,21,4159,15038.0,1360.0,547.0,17,5478,536.0,2667.0,435.0
240.08,6,16,4482,9,963,30010.0,238.0,166.0,7,3519,40013.0,1402.0,786.0
0.004,6,10,2000,5,927,1.0,659.0,659.0,5,1073,1.0,805.0,805.0
0.005,17,2,166,1,75,0.0,47.0,47.0,1,91,0.0,63.0,63.0
0.004,17,2,148,1,60,0.0,32.0,32.0,1,88,0.0,60.0,60.0
0.006,6,10,1689,5,839,1.0,571.0,571.0,5,850,1.0,582.0,582.0
15.072,17,16,10617,9,8280,1880.0,1350.0,892.0,7,2337,2508.0,1350.0,305.0
0.018,6,10,1989,5,910,4.0,642.0,642.0,5,1079,4.0,811.0,811.0
11.064,17,28,4396,14,2311,842.0,586.0,137.0,14,2085,842.0,268.0,120.0
1742.721,6,301,97446,186,86347,9420.0,1402.0,690.0,115,11099,15286.0,452.0,70.0
0.001,17,2,180,1,66,0.0,38.0,38.0,1,114,0.0,86.0,86.0
0.008,6,10,1989,5,910,2.0,642.0,642.0,5,1079,1.0,811.0,811.0
0.005,6,10,1774,5,923,1.0,655.0,655.0,5,851,1.0,583.0,583.0
10.871,17,28,4419,14,1995,827.0,270.0,114.0,14,2424,827.0,587.0,145.0
0.005,6,10,2007,5,928,1.0,660.0,660.0,5,1079,1.0,811.0,811.0
40.061,17,10,676,5,460,10014.0,104.0,64.0,5,216,10014.0,20.0,15.0
0.01,6,10,1983,5,910,2.0,642.0,642.0,5,1073,2.0,805.0,805.0
0.048,17,4,352,2,130,4.0,37.0,37.0,2,222,43.0,89.0,83.0
0.008,17,2,222,1,65,0.0,37.0,37.0,1,157,0.0,129.0,129.0
0.043,17,2,170,1,65,0.0,37.0,37.0,1,105,0.0,77.0,77.0
0.013,17,2,152,1,56,0.0,28.0,28.0,1,96,0.0,68.0,68.0
0.089,6,10,1506,5,395,17.0,127.0,127.0,5,1111,21.0,843.0,843.0
0.004,6,10,2006,5,927,1.0,659.0,659.0,5,1079,1.0,811.0,811.0
10.756,17,28,4422,14,1994,818.0,269.0,114.0,14,2428,818.0,587.0,145.0
0.005,6,13,3747,7,509,0.0,137.0,137.0,6,3238,1.0,1470.0,1459.0
308.199,17,20,1124,10,716,34230.0,48.0,43.0,10,408,34230.0,20.0,12.0
0.006,6,10,1547,5,764,1.0,496.0,496.0,5,783,1.0,515.0,515.0
0.006,6,10,1689,5,839,1.0,571.0,571.0,5,850,1.0,582.0,582.0
0.005,6,10,2007,5,928,1.0,660.0,660.0,5,1079,1.0,811.0,811.0
0.006,6,10,1702,5,863,1.0,595.0,595.0,5,839,1.0,571.0,571.0
40.062,17,10,676,5,460,10014.0,104.0,64.0,5,216,10014.0,20.0,15.0
0.006,6,10,1643,5,860,1.0,592.0,592.0,5,783,1.0,515.0,515.0
0.085,6,10,1506,5,395,18.0,127.0,127.0,5,1111,18.0,843.0,843.0
0.012,6,10,1972,5,910,3.0,642.0,642.0,5,1062,2.0,794.0,794.0
0.005,6,10,1854,5,889,1.0,621.0,621.0,5,965,1.0,697.0,697.0
0.01,6,10,1989,5,910,2.0,642.0,642.0,5,1079,2.0,811.0,811.0
40.07,17,10,676,5,460,10014.0,104.0,64.0,5,216,10016.0,20.0,15.0
0.006,6,10,1547,5,764,1.0,496.0,496.0,5,783,1.0,515.0,515.0
0.01,6,10,1677,5,827,2.0,559.0,559.0,5,850,2.0,582.0,582.0
0.1,6,10,1506,5,395,23.0,127.0,127.0,5,1111,20.0,843.0,843.0
0.109,6,10,1506,5,395,24.0,127.0,127.0,5,1111,25.0,843.0,843.0
0.005,17,2,180,1,58,0.0,30.0,30.0,1,122,0.0,94.0,94.0
0.015,6,10,1989,5,910,3.0,642.0,642.0,5,1079,3.0,811.0,811.0
0.006,6,10,1989,5,927,1.0,659.0,659.0,5,1062,1.0,794.0,794.0
0.001,17,2,136,1,60,0.0,32.0,32.0,1,76,0.0,48.0,48.0
0.008,6,10,1989,5,927,2.0,659.0,659.0,5,1062,2.0,794.0,794.0
0.012,6,10,1989,5,910,3.0,642.0,642.0,5,1079,3.0,811.0,811.0
0.015,6,10,1983,5,910,3.0,642.0,642.0,5,1073,3.0,805.0,805.0
0.01,6,10,1990,5,911,2.0,643.0,643.0,5,1079,2.0,811.0,811.0
0.003,17,2,136,1,60,0.0,32.0,32.0,1,76,0.0,48.0,48.0
0.019,6,10,1762,5,911,4.0,643.0,643.0,5,851,4.0,583.0,583.0
0.004,17,4,284,2,120,1.0,32.0,32.0,2,164,0.0,60.0,54.0
0.007,17,2,169,1,62,0.0,34.0,34.0,1,107,0.0,79.0,79.0
0.004,6,10,2006,5,927,1.0,659.0,659.0,5,1079,1.0,811.0,811.0
0.006,6,10,1547,5,764,1.0,496.0,496.0,5,783,1.0,515.0,515.0
1791.648,6,270,25283,135,8800,13370.0,747.0,295.0,135,16483,13370.0,1626.0,72.0
317.362,17,20,1124,10,716,35247.0,48.0,43.0,10,408,35248.0,20.0,12.0
0.164,17,2,152,1,76,0.0,48.0,48.0,1,76,0.0,48.0,48.0
0.1,6,10,1506,5,395,20.0,127.0,127.0,5,1111,23.0,843.0,843.0
0.014,6,10,1972,5,910,3.0,642.0,642.0,5,1062,3.0,794.0,794.0
0.02,6,13,3735,7,497,3.0,125.0,125.0,6,3238,3.0,1470.0,1459.0
0.069,17,8,3613,4,1874,23.0,1350.0,440.0,4,1739,12.0,1350.0,406.0
0.007,6,10,1990,5,911,1.0,643.0,643.0,5,1079,1.0,811.0,811.0
0.006,17,2,214,1,75,0.0,47.0,47.0,1,139,0.0,111.0,111.0
0.012,6,10,1989,5,910,3.0,642.0,642.0,5,1079,3.0,811.0,811.0
0.102,6,10,1506,5,395,22.0,127.0,127.0,5,1111,23.0,843.0,843.0
0.005,6,10,2000,5,927,1.0,659.0,659.0,5,1073,1.0,805.0,805.0
0.079,6,10,1506,5,395,16.0,127.0,127.0,5,1111,18.0,843.0,843.0
240.089,6,16,4480,9,963,30011.0,238.0,166.0,7,3517,40014.0,1402.0,786.0
0.128,6,10,1506,5,395,26.0,127.0,127.0,5,1111,29.0,843.0,843.0
412.65,6,29,4409,12,3102,10911.0,494.0,494.0,17,1307,25790.0,83.0,83.0
0.009,6,10,1989,5,910,2.0,642.0,642.0,5,1079,2.0,811.0,811.0
0.004,6,10,2000,5,927,1.0,659.0,659.0,5,1073,1.0,805.0,805.0
0.005,17,2,166,1,75,0.0,47.0,47.0,1,91,0.0,63.0,63.0
0.006,6,10,1989,5,927,1.0,659.0,659.0,5,1062,1.0,794.0,794.0
0.078,6,10,1506,5,395,17.0,127.0,127.0,5,1111,18.0,843.0,843.0
0.005,6,10,1779,5,928,1.0,660.0,660.0,5,851,1.0,583.0,583.0
15.073,17,14,9190,8,6902,2149.0,1350.0,834.0,6,2288,3008.0,1350.0,353.0
0.011,6,10,1677,5,827,2.0,559.0,559.0,5,850,2.0,582.0,582.0
0.004,6,10,2007,5,928,1.0,660.0,660.0,5,1079,1.0,811.0,811.0
0.077,6,10,1506,5,395,17.0,127.0,127.0,5,1111,16.0,843.0,843.0
0.003,17,2,136,1,60,0.0,32.0,32.0,1,76,0.0,48.0,48.0
0.001,17,2,179,1,62,0.0,34.0,34.0,1,117,0.0,89.0,89.0
0.005,6,10,2007,5,928,1.0,660.0,660.0,5,1079,1.0,811.0,811.0
241.385,6,384,347919,191,21466,1270.0,2736.0,960.0,193,326453,1257.0,2804.0,1729.0
0.118,6,10,1506,5,395,24.0,127.0,127.0,5,1111,23.0,843.0,843.0
0.007,6,10,1547,5,764,1.0,496.0,496.0,5,783,1.0,515.0,515.0
0.004,6,10,1989,5,927,1.0,659.0,659.0,5,1062,1.0,794.0,794.0
0.005,6,10,1989,5,927,1.0,659.0,659.0,5,1062,1.0,794.0,794.0
0.008,6,10,1972,5,910,2.0,642.0,642.0,5,1062,2.0,794.0,794.0
0.005,17,2,164,1,74,0.0,46.0,46.0,1,90,0.0,62.0,62.0
0.01,6,10,1989,5,910,2.0,642.0,642.0,5,1079,2.0,811.0,811.0
1770.474,6,83,4368,42,2210,43181.0,26.0,26.0,41,2158,44260.0,26.0,26.0
0.023,6,10,1989,5,910,5.0,642.0,642.0,5,1079,5.0,811.0,811.0
0.006,6,10,1547,5,764,1.0,496.0,496.0,5,783,1.0,515.0,515.0
0.005,6,10,2006,5,927,1.0,659.0,659.0,5,1079,1.0,811.0,811.0
0.011,6,10,1762,5,911,2.0,643.0,643.0,5,851,2.0,583.0,583.0
0.075,6,10,1506,5,395,16.0,127.0,127.0,5,1111,14.0,843.0,843.0
0.008,6,10,1989,5,910,2.0,642.0,642.0,5,1079,1.0,811.0,811.0
0.012,6,10,1989,5,910,3.0,642.0,642.0,5,1079,2.0,811.0,811.0
0.01,17,2,170,1,65,0.0,37.0,37.0,1,105,0.0,77.0,77.0
0.005,6,10,2006,5,927,1.0,659.0,659.0,5,1079,1.0,811.0,811.0
40.05,17,10,676,5,460,10011.0,104.0,64.0,5,216,10011.0,20.0,15.0
0.162,17,2,152,1,76,0.0,48.0,48.0,1,76,0.0,48.0,48.0
0.077,6,10,1506,5,395,16.0,127.0,127.0,5,1111,17.0,843.0,843.0
0.004,6,10,2007,5,928,1.0,660.0,660.0,5,1079,1.0,811.0,811.0
0.012,6,10,1972,5,910,3.0,642.0,642.0,5,1062,3.0,794.0,794.0
0.075,6,10,1506,5,395,16.0,127.0,127.0,5,1111,17.0,843.0,843.0
0.013,6,10,1989,5,910,3.0,642.0,642.0,5,1079,3.0,811.0,811.0
0.114,6,10,1506,5,395,26.0,127.0,127.0,5,1111,25.0,843.0,843.0
0.071,6,10,1506,5,395,15.0,127.0,127.0,5,1111,16.0,843.0,843.0
0.005,17,2,164,1,74,0.0,46.0,46.0,1,90,0.0,62.0,62.0
0.04,17,2,182,1,65,0.0,37.0,37.0,1,117,0.0,89.0,89.0
0.005,6,10,2006,5,927,1.0,659.0,659.0,5,1079,1.0,811.0,811.0
40.058,17,10,676,5,460,10012.0,104.0,64.0,5,216,10013.0,20.0,15.0
11.033,17,28,4398,14,2311,840.0,586.0,137.0,14,2087,840.0,270.0,121.0
0.027,17,2,148,1,60,0.0,32.0,32.0,1,88,0.0,60.0,60.0
0.015,6,10,1677,5,827,3.0,559.0,559.0,5,850,3.0,582.0,582.0
0.012,6,10,1990,5,911,3.0,643.0,643.0,5,1079,3.0,811.0,811.0
0.012,6,10,1983,5,910,3.0,642.0,642.0,5,1073,3.0,805.0,805.0
174.111,17,96,13962,48,3248,3704.0,44.0,39.0,48,10714,3704.0,261.0,195.0
0.007,6,10,1689,5,839,1.0,571.0,571.0,5,850,1.0,582.0,582.0
0.005,6,10,1689,5,839,1.0,571.0,571.0,5,850,1.0,582.0,582.0
0.005,17,2,222,1,65,0.0,37.0,37.0,1,157,0.0,129.0,129.0
0.014,6,10,1990,5,911,3.0,643.0,643.0,5,1079,3.0,811.0,811.0
0.008,6,10,1689,5,839,1.0,571.0,571.0,5,850,2.0,582.0,582.0
0.005,17,2,213,1,69,0.0,41.0,41.0,1,144,0.0,116.0,116.0
0.058,6,10,1506,5,395,13.0,127.0,127.0,5,1111,14.0,843.0,843.0
0.012,6,10,1990,5,911,2.0,643.0,643.0,5,1079,2.0,811.0,811.0
0.094,6,10,1506,5,395,16.0,127.0,127.0,5,1111,22.0,843.0,843.0
0.005,6,10,1989,5,927,1.0,659.0,659.0,5,1062,1.0,794.0,794.0
15.07,17,15,9238,8,6902,2148.0,1350.0,834.0,7,2336,2506.0,1350.0,305.0
0.006,6,10,1779,5,928,1.0,660.0,660.0,5,851,1.0,583.0,583.0
0.005,17,2,136,1,60,0.0,32.0,32.0,1,76,0.0,48.0,48.0
0.004,6,10,2000,5,927,1.0,659.0,659.0,5,1073,1.0,805.0,805.0
0.171,6,3,453,2,321,171.0,241.0,241.0,1,132,0.0,92.0,92.0
0.009,6,10,1990,5,911,2.0,643.0,643.0,5,1079,2.0,811.0,811.0
0.011,6,10,1983,5,910,2.0,642.0,642.0,5,1073,2.0,805.0,805.0
0.014,17,2,170,1,65,0.0,37.0,37.0,1,105,0.0,77.0,77.0
295.027,6,407,349088,197,21815,1505.0,2736.0,889.0,210,327273,1411.0,2804.0,1614.0
0.099,6,10,1506,5,395,17.0,127.0,127.0,5,1111,21.0,843.0,843.0
0.095,6,10,1506,5,395,21.0,127.0,127.0,5,1111,19.0,843.0,843.0
0.1,6,10,1506,5,395,18.0,127.0,127.0,5,1111,23.0,843.0,843.0
0.083,6,10,1506,5,395,18.0,127.0,127.0,5,1111,16.0,843.0,843.0
0.005,6,10,1989,5,927,1.0,659.0,659.0,5,1062,1.0,794.0,794.0
0.004,17,4,284,2,120,0.0,32.0,32.0,2,164,1.0,60.0,54.0
0.001,17,2,136,1,60,0.0,32.0,32.0,1,76,0.0,48.0,48.0
0.005,6,10,2006,5,927,1.0,659.0,659.0,5,1079,1.0,811.0,811.0
0.071,17,4,284,2,120,0.0,32.0,32.0,2,164,26.0,60.0,54.0
0.008,6,10,1983,5,910,2.0,642.0,642.0,5,1073,2.0,805.0,805.0
0.007,6,10,1547,5,764,1.0,496.0,496.0,5,783,1.0,515.0,515.0
0.011,6,10,1990,5,911,2.0,643.0,643.0,5,1079,2.0,811.0,811.0
0.104,6,10,1506,5,395,24.0,127.0,127.0,5,1111,24.0,843.0,843.0
0.015,6,10,1989,5,910,3.0,642.0,642.0,5,1079,3.0,811.0,811.0
0.09,6,10,1506,5,395,19.0,127.0,127.0,5,1111,19.0,843.0,843.0
0.122,6,10,1506,5,395,29.0,127.0,127.0,5,1111,30.0,843.0,843.0
0.005,6,10,1854,5,889,1.0,621.0,621.0,5,965,1.0,697.0,697.0
0.008,6,10,1983,5,910,2.0,642.0,642.0,5,1073,1.0,805.0,805.0
0.004,6,10,2006,5,927,1.0,659.0,659.0,5,1079,1.0,811.0,811.0
0.003,17,2,184,1,61,0.0,33.0,33.0,1,123,0.0,95.0,95.0
0.007,6,10,1689,5,839,1.0,571.0,571.0,5,850,1.0,582.0,582.0
0.08,6,10,1506,5,395,17.0,127.0,127.0,5,1111,14.0,843.0,843.0
11.021,17,28,4418,14,1993,838.0,268.0,114.0,14,2425,838.0,588.0,145.0
0.007,6,13,3747,7,509,1.0,137.0,137.0,6,3238,1.0,1470.0,1459.0
0.006,6,10,1547,5,764,1.0,496.0,496.0,5,783,1.0,515.0,515.0
0.095,6,10,1506,5,395,22.0,127.0,127.0,5,1111,19.0,843.0,843.0
0.004,6,10,2006,5,927,1.0,659.0,659.0,5,1079,1.0,811.0,811.0
0.005,17,2,152,1,68,0.0,40.0,40.0,1,84,0.0,56.0,56.0
0.015,6,10,1990,5,911,3.0,643.0,643.0,5,1079,3.0,811.0,811.0
0.003,17,2,148,1,60,0.0,32.0,32.0,1,88,0.0,60.0,60.0
0.089,6,10,1506,5,395,19.0,127.0,127.0,5,1111,19.0,843.0,843.0
0.004,6,10,1702,5,863,1.0,595.0,595.0,5,839,0.0,571.0,571.0
0.084,17,2,148,1,60,0.0,32.0,32.0,1,88,0.0,60.0,60.0
0.012,6,10,1990,5,911,3.0,643.0,643.0,5,1079,2.0,811.0,811.0
11.087,17,28,4422,14,1994,840.0,269.0,114.0,14,2428,840.0,587.0,145.0
0.016,6,10,1990,5,911,3.0,643.0,643.0,5,1079,4.0,811.0,811.0
0.006,6,10,1547,5,764,1.0,496.0,496.0,5,783,1.0,515.0,515.0
0.067,6,10,1506,5,395,15.0,127.0,127.0,5,1111,15.0,843.0,843.0
0.118,6,10,1506,5,395,25.0,127.0,127.0,5,1111,25.0,843.0,843.0
0.106,6,10,1506,5,395,23.0,127.0,127.0,5,1111,25.0,843.0,843.0
1790.032,6,285,27120,144,9871,12517.0,748.0,295.0,141,17249,12785.0,1625.0,73.0
40.063,17,10,676,5,460,10015.0,104.0,64.0,5,216,10014.0,20.0,15.0
0.004,6,10,1702,5,863,1.0,595.0,595.0,5,839,0.0,571.0,571.0
0.089,6,10,1506,5,395,21.0,127.0,127.0,5,1111,19.0,843.0,843.0
0.004,6,10,2006,5,927,1.0,659.0,659.0,5,1079,1.0,811.0,811.0
0.009,6,14,3787,7,497,1.0,125.0,125.0,7,3290,1.0,1448.0,972.0
0.011,6,10,1990,5,911,2.0,643.0,643.0,5,1079,2.0,811.0,811.0
0.109,6,10,1506,5,395,26.0,127.0,127.0,5,1111,25.0,843.0,843.0
0.011,6,10,1989,5,910,2.0,642.0,642.0,5,1079,2.0,811.0,811.0
0.013,6,10,1989,5,910,3.0,642.0,642.0,5,1079,3.0,811.0,811.0
0.094,6,10,1506,5,395,22.0,127.0,127.0,5,1111,21.0,843.0,843.0
0.013,6,10,1972,5,910,3.0,642.0,642.0,5,1062,3.0,794.0,794.0
9.014,6,37,10002,19,4484,500.0,1360.0,738.0,18,5518,517.0,1360.0,398.0
0.004,6,10,2000,5,927,1.0,659.0,659.0,5,1073,1.0,805.0,805.0
0.005,6,10,2006,5,927,1.0,659.0,659.0,5,1079,1.0,811.0,811.0
0.001,17,2,180,1,66,0.0,38.0,38.0,1,114,0.0,86.0,86.0
0.012,6,10,1762,5,911,3.0,643.0,643.0,5,851,2.0,583.0,583.0
0.004,17,4,284,2,120,0.0,32.0,32.0,2,164,0.0,60.0,54.0
0.018,6,10,1972,5,910,4.0,642.0,642.0,5,1062,4.0,794.0,794.0
0.031,6,13,3735,7,497,5.0,125.0,125.0,6,3238,6.0,1470.0,1459.0
0.004,6,10,2006,5,927,1.0,659.0,659.0,5,1079,1.0,811.0,811.0
0.006,6,10,1547,5,764,1.0,496.0,496.0,5,783,1.0,515.0,515.0
0.022,6,10,1989,5,910,5.0,642.0,642.0,5,1079,5.0,811.0,811.0
0.015,17,2,230,1,68,0.0,40.0,40.0,1,162,0.0,134.0,134.0
0.006,6,10,1547,5,764,1.0,496.0,496.0,5,783,1.0,515.0,515.0
0.012,6,10,1972,5,910,3.0,642.0,642.0,5,1062,3.0,794.0,794.0
1800.0,6,239,25701,93,16414,19565.0,1913.0,162.0,146,9287,12412.0,225.0,49.0
356.643,6,21,1795,16,1030,23776.0,190.0,190.0,5,765,60003.0,464.0,248.0
0.065,6,10,1506,5,395,13.0,127.0,127.0,5,1111,14.0,843.0,843.0
0.004,17,2,136,1,60,0.0,32.0,32.0,1,76,0.0,48.0,48.0
0.005,6,10,1989,5,927,1.0,659.0,659.0,5,1062,1.0,794.0,794.0
0.009,6,12,1926,6,1189,1.0,659.0,434.0,6,737,1.0,417.0,417.0
0.013,6,10,1983,5,910,3.0,642.0,642.0,5,1073,3.0,805.0,805.0
0.005,6,10,2000,5,927,1.0,659.0,659.0,5,1073,1.0,805.0,805.0
0.008,6,10,1689,5,839,2.0,571.0,571.0,5,850,1.0,582.0,582.0
0.071,6,10,1506,5,395,17.0,127.0,127.0,5,1111,15.0,843.0,843.0
0.012,6,10,1990,5,911,3.0,643.0,643.0,5,1079,2.0,811.0,811.0
0.005,6,10,1779,5,928,1.0,660.0,660.0,5,851,1.0,583.0,583.0
0.134,6,10,1242,5,751,33.0,495.0,495.0,5,491,30.0,223.0,223.0
0.006,6,10,2000,5,927,1.0,659.0,659.0,5,1073,1.0,805.0,805.0
0.072,17,4,284,2,120,1.0,32.0,32.0,2,164,68.0,60.0,54.0
0.041,17,4,352,2,130,0.0,37.0,37.0,2,222,4.0,89.0,83.0
0.015,6,10,1972,5,910,3.0,642.0,642.0,5,1062,3.0,794.0,794.0
94.677,6,20,7931,10,1523,170.0,794.0,367.0,10,6408,10500.0,1360.0,999.0
0.001,17,2,180,1,66,0.0,38.0,38.0,1,114,0.0,86.0,86.0
0.009,17,2,194,1,59,0.0,31.0,31.0,1,135,0.0,107.0,107.0
0.025,6,10,1990,5,911,6.0,643.0,643.0,5,1079,6.0,811.0,811.0
174.039,17,80,11270,40,2664,4462.0,44.0,38.0,40,8606,4462.0,239.0,187.0
0.001,17,2,180,1,66,0.0,38.0,38.0,1,114,0.0,86.0,86.0
11.123,17,28,4418,14,1994,843.0,269.0,114.0,14,2424,843.0,587.0,145.0
0.009,6,10,1677,5,827,2.0,559.0,559.0,5,850,2.0,582.0,582.0
0.01,6,10,1677,5,827,2.0,559.0,559.0,5,850,2.0,582.0,582.0
0.003,17,2,185,1,73,0.0,45.0,45.0,1,112,0.0,84.0,84.0
15.075,17,15,9239,8,6902,2149.0,1350.0,834.0,7,2337,2507.0,1350.0,305.0
40.061,17,10,676,5,460,10014.0,104.0,64.0,5,216,10014.0,20.0,15.0
0.014,6,10,1983,5,910,3.0,642.0,642.0,5,1073,3.0,805.0,805.0
0.006,6,10,1547,5,764,1.0,496.0,496.0,5,783,1.0,515.0,515.0
0.021,6,10,1762,5,911,5.0,643.0,643.0,5,851,5.0,583.0,583.0
0.005,17,2,178,1,65,0.0,37.0,37.0,1,113,0.0,85.0,85.0
0.171,6,3,453,2,321,171.0,241.0,241.0,1,132,0.0,92.0,92.0
0.013,6,10,1972,5,910,3.0,642.0,642.0,5,1062,3.0,794.0,794.0
0.075,6,10,1506,5,395,17.0,127.0,127.0,5,1111,16.0,843.0,843.0
0.01,6,12,1926,6,1189,2.0,659.0,434.0,6,737,1.0,417.0,417.0
0.097,6,10,1506,5,395,22.0,127.0,127.0,5,1111,22.0,843.0,843.0
0.239,6,10,1506,5,395,57.0,127.0,127.0,5,1111,58.0,843.0,843.0
0.011,6,10,1983,5,910,2.0,642.0,642.0,5,1073,2.0,805.0,805.0
40.053,17,10,676,5,460,10012.0,104.0,64.0,5,216,10012.0,20.0,15.0
0.026,6,10,1677,5,827,6.0,559.0,559.0,5,850,6.0,582.0,582.0
40.053,17,10,676,5,460,10012.0,104.0,64.0,5,216,10012.0,20.0,15.0
0.204,6,16,2778,8,1396,29.0,533.0,324.0,8,1382,18.0,529.0,239.0
0.005,6,10,1689,5,839,1.0,571.0,571.0,5,850,1.0,582.0,582.0
0.004,17,2,162,1,65,0.0,37.0,37.0,1,97,0.0,69.0,69.0
0.114,6,10,1506,5,395,24.0,127.0,127.0,5,1111,25.0,843.0,843.0
0.094,6,10,1506,5,395,22.0,127.0,127.0,5,1111,20.0,843.0,843.0
0.006,6,10,1689,5,839,1.0,571.0,571.0,5,850,1.0,582.0,582.0
0.004,6,10,2006,5,927,1.0,659.0,659.0,5,1079,1.0,811.0,811.0
0.01,6,10,1989,5,910,2.0,642.0,642.0,5,1079,2.0,811.0,811.0
0.004,17,4,284,2,120,1.0,32.0,32.0,2,164,0.0,60.0,54.0
0.055,17,2,152,1,76,0.0,48.0,48.0,1,76,0.0,48.0,48.0
0.001,17,2,180,1,66,0.0,38.0,38.0,1,114,0.0,86.0,86.0
1777.687,17,144,45504,72,22752,25037.0,288.0,288.0,72,22752,25037.0,288.0,288.0
0.009,6,10,1972,5,910,2.0,642.0,642.0,5,1062,2.0,794.0,794.0
0.076,6,10,1506,5,395,17.0,127.0,127.0,5,1111,16.0,843.0,843.0
0.102,6,10,1506,5,395,22.0,127.0,127.0,5,1111,20.0,843.0,843.0
240.296,6,46,8939,23,5802,10922.0,1368.0,458.0,23,3137,10922.0,580.0,241.0
0.005,6,10,2006,5,927,1.0,659.0,659.0,5,1079,1.0,811.0,811.0
0.005,6,10,2006,5,927,1.0,659.0,659.0,5,1079,1.0,811.0,811.0
10.906,17,28,4421,14,1994,830.0,269.0,114.0,14,2427,830.0,586.0,145.0
40.043,17,10,676,5,460,10010.0,104.0,64.0,5,216,10010.0,20.0,15.0
240.089,6,16,4482,9,963,30011.0,238.0,166.0,7,3519,40014.0,1402.0,786.0
0.009,6,10,1983,5,910,2.0,642.0,642.0,5,1073,2.0,805.0,805.0
0.008,6,10,1983,5,910,1.0,642.0,642.0,5,1073,1.0,805.0,805.0
40.059,17,10,676,5,460,10013.0,104.0,64.0,5,216,10013.0,20.0,15.0
0.013,6,10,1990,5,911,3.0,643.0,643.0,5,1079,3.0,811.0,811.0
0.005,17,2,152,1,76,0.0,48.0,48.0,1,76,0.0,48.0,48.0
67.274,6,21,8145,11,1985,85.0,1174.0,504.0,10,6160,7456.0,2720.0,958.0
366.154,6,32,11205,17,3371,22884.0,676.0,413.0,15,7834,26151.0,1402.0,882.0
40.059,17,10,676,5,460,10012.0,104.0,64.0,5,216,10013.0,20.0,15.0
0.014,6,10,1990,5,911,3.0,643.0,643.0,5,1079,3.0,811.0,811.0
0.008,6,10,1983,5,910,2.0,642.0,642.0,5,1073,1.0,805.0,805.0
0.006,6,10,1643,5,860,1.0,592.0,592.0,5,783,1.0,515.0,515.0
0.013,6,13,3735,7,497,2.0,125.0,125.0,6,3238,2.0,1470.0,1459.0
0.004,17,2,148,1,60,0.0,32.0,32.0,1,88,0.0,60.0,60.0
15.115,17,15,8265,8,6095,2153.0,1350.0,733.0,7,2170,2510.0,1350.0,282.0
0.005,6,10,2007,5,928,1.0,660.0,660.0,5,1079,1.0,811.0,811.0
240.014,6,9,787,5,488,60003.0,232.0,232.0,4,299,80004.0,83.0,83.0
0.018,6,10,1990,5,911,4.0,643.0,643.0,5,1079,4.0,811.0,811.0
0.011,6,10,1989,5,910,2.0,642.0,642.0,5,1079,2.0,811.0,811.0
0.074,6,14,3787,7,497,12.0,125.0,125.0,7,3290,12.0,1448.0,972.0
0.001,17,2,180,1,66,0.0,38.0,38.0,1,114,0.0,86.0,86.0
0.071,6,10,1506,5,395,16.0,127.0,127.0,5,1111,15.0,843.0,843.0
0.797,6,10,2009,6,1655,159.0,1403.0,1403.0,4,354,188.0,182.0,182.0
0.003,17,2,148,1,60,0.0,32.0,32.0,1,88,0.0,60.0,60.0
0.006,6,10,1643,5,860,1.0,592.0,592.0,5,783,1.0,515.0,515.0
0.006,6,10,1547,5,764,1.0,496.0,496.0,5,783,1.0,515.0,515.0
0.038,17,2,152,1,76,0.0,48.0,48.0,1,76,0.0,48.0,48.0
0.005,6,10,1689,5,839,1.0,571.0,571.0,5,850,1.0,582.0,582.0
0.015,6,10,1989,5,910,3.0,642.0,642.0,5,1079,3.0,811.0,811.0
10.806,17,28,4418,14,1994,822.0,269.0,114.0,14,2424,822.0,587.0,145.0
0.005,6,10,1689,5,839,1.0,571.0,571.0,5,850,1.0,582.0,582.0
137.903,6,22,8495,12,2236,78.0,1345.0,574.0,10,6259,15303.0,2720.0,974.0
0.006,17,2,179,1,71,0.0,43.0,43.0,1,108,0.0,80.0,80.0
0.005,17,2,180,1,58,0.0,30.0,30.0,1,122,0.0,94.0,94.0
0.013,6,10,1972,5,910,3.0,642.0,642.0,5,1062,3.0,794.0,794.0
0.004,6,10,2006,5,927,1.0,659.0,659.0,5,1079,1.0,811.0,811.0
0.001,17,2,142,1,63,0.0,35.0,35.0,1,79,0.0,51.0,51.0
0.006,6,10,1779,5,928,1.0,660.0,660.0,5,851,1.0,583.0,583.0
40.068,17,10,676,5,460,10014.0,104.0,64.0,5,216,10016.0,20.0,15.0
0.095,6,10,1506,5,395,21.0,127.0,127.0,5,1111,21.0,843.0,843.0
0.011,6,10,1762,5,911,2.0,643.0,643.0,5,851,2.0,583.0,583.0
0.027,6,10,1762,5,911,6.0,643.0,643.0,5,851,6.0,583.0,583.0
0.005,6,10,2007,5,928,1.0,660.0,660.0,5,1079,1.0,811.0,811.0
0.006,6,10,2007,5,928,1.0,660.0,660.0,5,1079,1.0,811.0,811.0
360.032,6,21,3981,13,3142,30002.0,494.0,494.0,8,839,51432.0,83.0,83.0
0.08,6,10,1506,5,395,16.0,127.0,127.0,5,1111,19.0,843.0,843.0
0.018,6,10,1983,5,910,4.0,642.0,642.0,5,1073,4.0,805.0,805.0
0.108,6,10,1506,5,395,26.0,127.0,127.0,5,1111,23.0,843.0,843.0
0.106,6,10,1506,5,395,23.0,127.0,127.0,5,1111,22.0,843.0,843.0
0.009,6,10,1972,5,910,2.0,642.0,642.0,5,1062,2.0,794.0,794.0
0.01,6,10,1990,5,911,2.0,643.0,643.0,5,1079,2.0,811.0,811.0
0.009,6,10,2006,5,927,2.0,659.0,659.0,5,1079,2.0,811.0,811.0
0.121,6,10,1506,5,395,27.0,127.0,127.0,5,1111,27.0,843.0,843.0
40.054,17,10,676,5,460,10012.0,104.0,64.0,5,216,10012.0,20.0,15.0
0.005,6,10,2006,5,927,1.0,659.0,659.0,5,1079,1.0,811.0,811.0
0.006,6,10,2007,5,928,1.0,660.0,660.0,5,1079,1.0,811.0,811.0
0.123,6,10,1506,5,395,28.0,127.0,127.0,5,1111,25.0,843.0,843.0
0.078,6,10,1506,5,395,16.0,127.0,127.0,5,1111,17.0,843.0,843.0
0.004,6,10,2007,5,928,1.0,660.0,660.0,5,1079,1.0,811.0,811.0
0.012,6,10,1983,5,910,3.0,642.0,642.0,5,1073,3.0,805.0,805.0
0.004,6,10,2006,5,927,1.0,659.0,659.0,5,1079,1.0,811.0,811.0
0.005,6,10,1989,5,927,1.0,659.0,659.0,5,1062,1.0,794.0,794.0
0.037,17,2,148,1,60,0.0,32.0,32.0,1,88,0.0,60.0,60.0
0.006,6,10,1547,5,764,1.0,496.0,496.0,5,783,1.0,515.0,515.0
0.145,6,10,1506,5,395,34.0,127.0,127.0,5,1111,21.0,843.0,843.0
0.004,6,10,2006,5,927,1.0,659.0,659.0,5,1079,1.0,811.0,811.0
0.098,6,10,1506,5,395,22.0,127.0,127.0,5,1111,19.0,843.0,843.0
0.005,6,10,1854,5,889,1.0,621.0,621.0,5,965,1.0,697.0,697.0
323.526,17,20,1124,10,716,35935.0,48.0,43.0,10,408,35935.0,20.0,12.0
0.1,6,10,1506,5,395,21.0,127.0,127.0,5,1111,22.0,843.0,843.0
0.257,17,39,20051,21,17037,12.0,1350.0,783.0,18,3014,11.0,1350.0,139.0
0.006,6,10,1547,5,764,1.0,496.0,496.0,5,783,1.0,515.0,515.0
0.006,6,10,1689,5,839,1.0,571.0,571.0,5,850,1.0,582.0,582.0
0.037,17,4,284,2,120,0.0,32.0,32.0,2,164,33.0,60.0,54.0
0.012,6,13,3735,7,497,2.0,125.0,125.0,6,3238,2.0,1470.0,1459.0
0.001,17,2,180,1,66,0.0,38.0,38.0,1,114,0.0,86.0,86.0
0.006,6,10,1547,5,764,1.0,496.0,496.0,5,783,1.0,515.0,515.0
0.014,6,10,1972,5,910,3.0,642.0,642.0,5,1062,3.0,794.0,794.0
0.012,6,10,1631,5,848,2.0,580.0,580.0,5,783,3.0,515.0,515.0
0.127,6,10,1506,5,395,30.0,127.0,127.0,5,1111,28.0,843.0,843.0
0.264,17,15,8641,8,4076,37.0,1350.0,481.0,7,4565,34.0,1350.0,624.0
0.004,6,10,2007,5,928,1.0,660.0,660.0,5,1079,1.0,811.0,811.0
0.064,6,10,1506,5,395,13.0,127.0,127.0,5,1111,15.0,843.0,843.0
0.013,6,10,1990,5,911,3.0,643.0,643.0,5,1079,3.0,811.0,811.0
40.06,17,10,676,5,460,10014.0,104.0,64.0,5,216,10014.0,20.0,15.0
0.006,17,2,230,1,68,0.0,40.0,40.0,1,162,0.0,134.0,134.0
0.001,17,2,180,1,66,0.0,38.0,38.0,1,114,0.0,86.0,86.0
0.077,6,10,1506,5,395,18.0,127.0,127.0,5,1111,15.0,843.0,843.0
0.058,6,10,3665,5,773,14.0,517.0,517.0,5,2892,11.0,1402.0,1312.0
15.074,17,14,9191,8,6902,2149.0,1350.0,834.0,6,2289,3008.0,1350.0,353.0
0.005,6,14,3736,7,446,0.0,74.0,74.0,7,3290,0.0,1448.0,972.0
0.039,6,10,1989,5,910,9.0,642.0,642.0,5,1079,9.0,811.0,811.0
0.984,6,12,3142,6,2099,148.0,1328.0,923.0,6,1043,148.0,791.0,791.0
0.016,6,10,1989,5,910,4.0,642.0,642.0,5,1079,3.0,811.0,811.0
0.008,17,2,164,1,74,0.0,46.0,46.0,1,90,0.0,62.0,62.0
0.005,6,14,3736,7,446,0.0,74.0,74.0,7,3290,0.0,1448.0,972.0
0.086,6,10,1506,5,395,18.0,127.0,127.0,5,1111,19.0,843.0,843.0
0.005,6,10,2006,5,927,1.0,659.0,659.0,5,1079,1.0,811.0,811.0
0.007,6,10,1547,5,764,1.0,496.0,496.0,5,783,1.0,515.0,515.0
0.037,17,2,152,1,76,0.0,48.0,48.0,1,76,0.0,48.0,48.0
0.109,6,10,1506,5,395,23.0,127.0,127.0,5,1111,20.0,843.0,843.0
0.005,6,10,1989,5,927,1.0,659.0,659.0,5,1062,1.0,794.0,794.0
0.009,6,10,1989,5,910,2.0,642.0,642.0,5,1079,2.0,811.0,811.0
40.061,17,10,676,5,460,10014.0,104.0,64.0,5,216,10014.0,20.0,15.0
0.005,17,2,170,1,65,0.0,37.0,37.0,1,105,0.0,77.0,77.0
0.099,6,10,1506,5,395,22.0,127.0,127.0,5,1111,20.0,843.0,843.0
181.397,17,76,10838,38,2537,4902.0,44.0,38.0,38,8301,4902.0,239.0,190.0
0.005,6,10,2006,5,927,1.0,659.0,659.0,5,1079,1.0,811.0,811.0
0.005,6,10,2007,5,928,1.0,660.0,660.0,5,1079,1.0,811.0,811.0
0.069,6,10,1506,5,395,16.0,127.0,127.0,5,1111,13.0,843.0,843.0
0.129,17,2,80,1,32,0.0,4.0,4.0,1,48,0.0,20.0,20.0
0.008,6,10,2000,5,927,2.0,659.0,659.0,5,1073,1.0,805.0,805.0
240.095,6,16,4481,9,963,30011.0,238.0,166.0,7,3518,40015.0,1402.0,786.0
0.009,6,10,1989,5,910,2.0,642.0,642.0,5,1079,2.0,811.0,811.0
0.005,6,10,1989,5,927,1.0,659.0,659.0,5,1062,1.0,794.0,794.0
0.006,6,10,1854,5,889,1.0,621.0,621.0,5,965,1.0,697.0,697.0
0.004,6,10,2006,5,927,1.0,659.0,659.0,5,1079,1.0,811.0,811.0
300.327,6,16,2170,9,684,37519.0,146.0,146.0,7,1486,50026.0,419.0,398.0
0.01,6,10,1989,5,910,2.0,642.0,642.0,5,1079,2.0,811.0,811.0
0.01,6,10,1989,5,910,2.0,642.0,642.0,5,1079,2.0,811.0,811.0
0.005,6,10,1702,5,863,1.0,595.0,595.0,5,839,1.0,571.0,571.0
0.069,6,10,1506,5,395,15.0,127.0,127.0,5,1111,15.0,843.0,843.0
0.015,6,10,1972,5,910,3.0,642.0,642.0,5,1062,3.0,794.0,794.0
15.224,17,17,8268,9,5972,1899.0,1350.0,635.0,8,2296,2170.0,1350.0,259.0
0.028,6,10,1631,5,848,6.0,580.0,580.0,5,783,6.0,515.0,515.0
0.015,6,10,1989,5,910,3.0,642.0,642.0,5,1079,3.0,811.0,811.0
360.04,6,21,3981,13,3142,30003.0,494.0,494.0,8,839,51433.0,83.0,83.0
0.112,6,10,1506,5,395,25.0,127.0,127.0,5,1111,22.0,843.0,843.0
0.012,6,10,1989,5,910,3.0,642.0,642.0,5,1079,3.0,811.0,811.0
0.004,6,10,2007,5,928,1.0,660.0,660.0,5,1079,1.0,811.0,811.0
0.005,17,2,212,1,74,0.0,46.0,46.0,1,138,0.0,110.0,110.0
0.005,17,2,144,1,64,0.0,36.0,36.0,1,80,0.0,52.0,52.0
0.005,6,10,1643,5,860,1.0,592.0,592.0,5,783,1.0,515.0,515.0
0.019,6,10,1631,5,848,4.0,580.0,580.0,5,783,4.0,515.0,515.0
0.004,6,10,2000,5,927,1.0,659.0,659.0,5,1073,1.0,805.0,805.0
15.072,17,15,9238,8,6902,2149.0,1350.0,834.0,7,2336,2507.0,1350.0,305.0
0.019,6,13,3735,7,497,3.0,125.0,125.0,6,3238,3.0,1470.0,1459.0
0.013,6,10,1677,5,827,3.0,559.0,559.0,5,850,3.0,582.0,582.0
0.004,6,10,1702,5,863,1.0,595.0,595.0,5,839,1.0,571.0,571.0
40.065,17,10,676,5,460,10015.0,104.0,64.0,5,216,10015.0,20.0,15.0
0.008,17,2,299,1,65,0.0,37.0,37.0,1,234,0.0,206.0,206.0
0.012,6,10,1990,5,911,2.0,643.0,643.0,5,1079,3.0,811.0,811.0
0.004,6,10,2006,5,927,1.0,659.0,659.0,5,1079,1.0,811.0,811.0
0.018,6,10,1989,5,910,4.0,642.0,642.0,5,1079,4.0,811.0,811.0
0.004,17,2,148,1,60,0.0,32.0,32.0,1,88,0.0,60.0,60.0
0.005,6,10,2006,5,927,1.0,659.0,659.0,5,1079,1.0,811.0,811.0
0.11,6,10,1506,5,395,23.0,127.0,127.0,5,1111,25.0,843.0,843.0
0.004,17,2,185,1,73,0.0,45.0,45.0,1,112,0.0,84.0,84.0
0.114,6,10,1506,5,395,25.0,127.0,127.0,5,1111,26.0,843.0,843.0
0.056,17,2,179,1,71,0.0,43.0,43.0,1,108,0.0,80.0,80.0
0.006,6,10,2000,5,927,1.0,659.0,659.0,5,1073,1.0,805.0,805.0
0.013,6,10,1989,5,910,3.0,642.0,642.0,5,1079,3.0,811.0,811.0
0.026,6,10,1989,5,910,6.0,642.0,642.0,5,1079,6.0,811.0,811.0
0.103,6,10,1506,5,395,23.0,127.0,127.0,5,1111,23.0,843.0,843.0
0.002,17,2,136,1,60,0.0,32.0,32.0,1,76,0.0,48.0,48.0
0.016,6,10,1972,5,910,4.0,642.0,642.0,5,1062,4.0,794.0,794.0
0.057,17,2,136,1,60,0.0,32.0,32.0,1,76,0.0,48.0,48.0
0.011,6,10,1990,5,911,2.0,643.0,643.0,5,1079,2.0,811.0,811.0
0.149,6,10,1506,5,395,31.0,127.0,127.0,5,1111,29.0,843.0,843.0
0.003,17,2,152,1,76,0.0,48.0,48.0,1,76,0.0,48.0,48.0
0.01,6,10,2000,5,927,2.0,659.0,659.0,5,1073,2.0,805.0,805.0
0.006,6,10,1547,5,764,1.0,496.0,496.0,5,783,1.0,515.0,515.0
0.009,6,10,1989,5,910,2.0,642.0,642.0,5,1079,2.0,811.0,811.0
40.059,17,10,676,5,460,10012.0,104.0,64.0,5,216,10014.0,20.0,15.0
0.004,6,10,1702,5,863,0.0,595.0,595.0,5,839,1.0,571.0,571.0
0.006,17,2,179,1,71,0.0,43.0,43.0,1,108,0.0,80.0,80.0
0.037,17,2,146,1,65,0.0,37.0,37.0,1,81,0.0,53.0,53.0
0.118,6,10,1506,5,395,25.0,127.0,127.0,5,1111,27.0,843.0,843.0
300.027,6,12,1782,7,1348,50004.0,494.0,494.0,5,434,75006.0,83.0,83.0
310.055,17,20,1124,10,716,34437.0,48.0,43.0,10,408,34436.0,20.0,12.0
0.076,6,10,1506,5,395,17.0,127.0,127.0,5,1111,14.0,843.0,843.0
0.005,6,10,2006,5,927,1.0,659.0,659.0,5,1079,1.0,811.0,811.0
0.055,17,2,144,1,64,0.0,36.0,36.0,1,80,0.0,52.0,52.0
354.038,6,19,1691,15,978,25288.0,190.0,190.0,4,713,80003.0,497.0,497.0
0.009,6,10,1989,5,910,2.0,642.0,642.0,5,1079,2.0,811.0,811.0
40.071,17,10,676,5,460,10012.0,104.0,64.0,5,216,10014.0,20.0,15.0
0.071,17,2,148,1,60,0.0,32.0,32.0,1,88,0.0,60.0,60.0
0.005,17,2,144,1,64,0.0,36.0,36.0,1,80,0.0,52.0,52.0
0.071,17,2,182,1,65,0.0,37.0,37.0,1,117,0.0,89.0,89.0
353.327,6,20,2210,6,1308,12004.0,494.0,494.0,14,902,27178.0,83.0,83.0
0.005,6,10,2006,5,927,1.0,659.0,659.0,5,1079,1.0,811.0,811.0
0.005,17,2,170,1,65,0.0,37.0,37.0,1,105,0.0,77.0,77.0
0.001,17,2,166,1,75,0.0,47.0,47.0,1,91,0.0,63.0,63.0
0.005,17,2,179,1,71,0.0,43.0,43.0,1,108,0.0,80.0,80.0
40.066,17,10,676,5,460,10015.0,104.0,64.0,5,216,10015.0,20.0,15.0
0.004,6,10,1702,5,863,1.0,595.0,595.0,5,839,1.0,571.0,571.0
0.039,17,2,166,1,75,0.0,47.0,47.0,1,91,0.0,63.0,63.0
0.052,6,10,1506,5,395,12.0,127.0,127.0,5,1111,11.0,843.0,843.0
0.071,17,2,144,1,64,0.0,36.0,36.0,1,80,0.0,52.0,52.0
0.006,17,2,170,1,65,0.0,37.0,37.0,1,105,0.0,77.0,77.0
0.004,6,10,1989,5,927,1.0,659.0,659.0,5,1062,1.0,794.0,794.0
0.006,6,10,1643,5,860,1.0,592.0,592.0,5,783,1.0,515.0,515.0
0.123,17,2,80,1,32,0.0,4.0,4.0,1,48,0.0,20.0,20.0
0.002,17,2,152,1,76,0.0,48.0,48.0,1,76,0.0,48.0,48.0
0.012,6,12,1926,6,1189,2.0,659.0,434.0,6,737,2.0,417.0,417.0
0.005,6,10,1547,5,764,1.0,496.0,496.0,5,783,1.0,515.0,515.0
0.068,17,8,3613,4,1874,22.0,1350.0,440.0,4,1739,11.0,1350.0,406.0
0.011,6,10,1989,5,910,2.0,642.0,642.0,5,1079,2.0,811.0,811.0
0.005,6,10,1643,5,860,1.0,592.0,592.0,5,783,1.0,515.0,515.0
0.144,17,2,152,1,76,0.0,48.0,48.0,1,76,0.0,48.0,48.0
0.006,6,10,1689,5,839,1.0,571.0,571.0,5,850,1.0,582.0,582.0
0.003,17,2,184,1,61,0.0,33.0,33.0,1,123,0.0,95.0,95.0
0.088,6,10,1506,5,395,19.0,127.0,127.0,5,1111,18.0,843.0,843.0
15.076,17,16,8703,8,6467,2149.0,1350.0,780.0,8,2236,2149.0,1350.0,251.0
0.005,17,2,169,1,62,0.0,34.0,34.0,1,107,0.0,79.0,79.0
0.004,17,4,284,2,120,1.0,32.0,32.0,2,164,0.0,60.0,54.0
0.11,6,10,1506,5,395,22.0,127.0,127.0,5,1111,26.0,843.0,843.0
0.012,6,10,1972,5,910,3.0,642.0,642.0,5,1062,3.0,794.0,794.0
0.01,17,4,284,2,120,0.0,32.0,32.0,2,164,0.0,60.0,54.0
240.097,6,16,4482,9,963,30012.0,238.0,166.0,7,3519,40015.0,1402.0,786.0
0.005,17,2,170,1,65,0.0,37.0,37.0,1,105,0.0,77.0,77.0
0.04,17,2,184,1,61,0.0,33.0,33.0,1,123,0.0,95.0,95.0
11.151,17,28,4420,14,1993,845.0,268.0,114.0,14,2427,845.0,586.0,145.0
0.011,6,10,1983,5,910,2.0,642.0,642.0,5,1073,2.0,805.0,805.0
0.072,6,10,1506,5,395,16.0,127.0,127.0,5,1111,16.0,843.0,843.0
0.04,17,2,182,1,65,0.0,37.0,37.0,1,117,0.0,89.0,89.0
0.013,6,10,1989,5,910,3.0,642.0,642.0,5,1079,3.0,811.0,811.0
0.006,6,10,1854,5,889,1.0,621.0,621.0,5,965,1.0,697.0,697.0
0.011,6,10,1643,5,860,2.0,592.0,592.0,5,783,2.0,515.0,515.0
0.004,6,10,1774,5,923,1.0,655.0,655.0,5,851,1.0,583.0,583.0
0.005,17,2,144,1,64,0.0,36.0,36.0,1,80,0.0,52.0,52.0
0.126,17,2,148,1,60,0.0,32.0,32.0,1,88,0.0,60.0,60.0
0.128,6,10,1506,5,395,29.0,127.0,127.0,5,1111,29.0,843.0,843.0
0.024,6,10,1989,5,910,6.0,642.0,642.0,5,1079,6.0,811.0,811.0
0.04,17,2,182,1,65,0.0,37.0,37.0,1,117,0.0,89.0,89.0
0.011,6,12,1926,6,1189,2.0,659.0,434.0,6,737,2.0,417.0,417.0
0.001,17,2,180,1,66,0.0,38.0,38.0,1,114,0.0,86.0,86.0
1.539,6,36,6735,19,3451,85.0,1103.0,204.0,17,3284,92.0,1796.0,396.0
0.005,6,10,2007,5,928,1.0,660.0,660.0,5,1079,1.0,811.0,811.0
0.005,6,10,1989,5,927,1.0,659.0,659.0,5,1062,1.0,794.0,794.0
0.014,6,10,1989,5,910,3.0,642.0,642.0,5,1079,3.0,811.0,811.0
0.001,17,2,180,1,66,0.0,38.0,38.0,1,114,0.0,86.0,86.0
0.084,17,4,284,2,120,0.0,32.0,32.0,2,164,74.0,60.0,54.0
0.029,6,10,1762,5,911,7.0,643.0,643.0,5,851,7.0,583.0,583.0
0.135,17,2,136,1,60,0.0,32.0,32.0,1,76,0.0,48.0,48.0
0.012,6,10,1989,5,910,2.0,642.0,642.0,5,1079,2.0,811.0,811.0
11.273,17,28,4417,14,1994,854.0,269.0,114.0,14,2423,854.0,586.0,145.0
0.132,6,10,1506,5,395,30.0,127.0,127.0,5,1111,29.0,843.0,843.0
0.009,6,10,1972,5,910,2.0,642.0,642.0,5,1062,2.0,794.0,794.0
244.569,6,57,19622,27,12364,9406.0,1973.0,781.0,30,7258,8433.0,2380.0,406.0
40.069,17,10,676,5,460,10015.0,104.0,64.0,5,216,10016.0,20.0,15.0
0.006,17,2,152,1,68,0.0,40.0,40.0,1,84,0.0,56.0,56.0
240.019,6,9,787,5,488,60004.0,232.0,232.0,4,299,80005.0,83.0,83.0
0.052,6,10,1506,5,395,12.0,127.0,127.0,5,1111,12.0,843.0,843.0
0.149,6,10,1506,5,395,24.0,127.0,127.0,5,1111,32.0,843.0,843.0
0.004,6,10,2007,5,928,1.0,660.0,660.0,5,1079,1.0,811.0,811.0
0.088,6,10,1506,5,395,19.0,127.0,127.0,5,1111,20.0,843.0,843.0
0.009,6,10,1989,5,910,2.0,642.0,642.0,5,1079,2.0,811.0,811.0
0.016,6,10,1989,5,910,4.0,642.0,642.0,5,1079,3.0,811.0,811.0
40.062,17,10,676,5,460,10014.0,104.0,64.0,5,216,10014.0,20.0,15.0
0.126,17,2,148,1,60,0.0,32.0,32.0,1,88,0.0,60.0,60.0
40.069,17,10,676,5,460,10015.0,104.0,64.0,5,216,10016.0,20.0,15.0
0.01,6,10,1762,5,911,2.0,643.0,643.0,5,851,2.0,583.0,583.0
0.001,17,2,166,1,75,0.0,47.0,47.0,1,91,0.0,63.0,63.0
0.011,6,6,716,3,458,4.0,302.0,302.0,3,258,4.0,102.0,102.0
40.06,17,10,676,5,460,10012.0,104.0,64.0,5,216,10014.0,20.0,15.0
40.054,17,10,676,5,460,10012.0,104.0,64.0,5,216,10012.0,20.0,15.0
318.078,17,20,1124,10,716,35327.0,48.0,43.0,10,408,35328.0,20.0,12.0
0.007,17,2,179,1,71,0.0,43.0,43.0,1,108,0.0,80.0,80.0
0.004,17,2,136,1,60,0.0,32.0,32.0,1,76,0.0,48.0,48.0
0.009,6,10,1990,5,911,2.0,643.0,643.0,5,1079,2.0,811.0,811.0
0.171,17,2,152,1,76,0.0,48.0,48.0,1,76,0.0,48.0,48.0
0.005,6,10,2007,5,928,1.0,660.0,660.0,5,1079,1.0,811.0,811.0
0.094,6,10,1506,5,395,21.0,127.0,127.0,5,1111,21.0,843.0,843.0
0.077,6,10,1506,5,395,16.0,127.0,127.0,5,1111,15.0,843.0,843.0
0.067,6,10,1506,5,395,15.0,127.0,127.0,5,1111,15.0,843.0,843.0
240.075,6,20,4872,10,889,26675.0,180.0,93.0,10,3983,26674.0,1591.0,575.0
0.039,17,4,284,2,120,0.0,32.0,32.0,2,164,35.0,60.0,54.0
0.092,6,10,1506,5,395,21.0,127.0,127.0,5,1111,20.0,843.0,843.0
0.009,6,10,1972,5,910,2.0,642.0,642.0,5,1062,2.0,794.0,794.0
0.004,6,10,1989,5,927,1.0,659.0,659.0,5,1062,1.0,794.0,794.0
0.01,6,10,1989,5,910,2.0,642.0,642.0,5,1079,2.0,811.0,811.0
354.072,6,21,1795,16,1030,23604.0,190.0,190.0,5,765,60001.0,464.0,248.0
0.013,6,10,1989,5,910,3.0,642.0,642.0,5,1079,3.0,811.0,811.0
0.081,6,10,1506,5,395,15.0,127.0,127.0,5,1111,18.0,843.0,843.0
0.02,6,10,1990,5,911,5.0,643.0,643.0,5,1079,5.0,811.0,811.0
40.056,17,10,676,5,460,10013.0,104.0,64.0,5,216,10013.0,20.0,15.0
0.005,6,10,2006,5,927,1.0,659.0,659.0,5,1079,1.0,811.0,811.0
0.012,6,10,1990,5,911,3.0,643.0,643.0,5,1079,3.0,811.0,811.0
0.006,6,10,1547,5,764,1.0,496.0,496.0,5,783,1.0,515.0,515.0
0.012,6,10,1990,5,911,3.0,643.0,643.0,5,1079,2.0,811.0,811.0
0.004,17,2,148,1,60,0.0,32.0,32.0,1,88,0.0,60.0,60.0
0.028,6,10,1762,5,911,7.0,643.0,643.0,5,851,6.0,583.0,583.0
1.915,6,22,7705,12,1485,174.0,517.0,287.0,10,6220,17.0,1402.0,813.0
15.226,17,39,20139,21,17025,759.0,1350.0,782.0,18,3114,893.0,1350.0,145.0
0.005,6,10,1689,5,839,1.0,571.0,571.0,5,850,1.0,582.0,582.0
0.078,6,10,1506,5,395,17.0,127.0,127.0,5,1111,17.0,843.0,843.0
0.001,17,2,180,1,66,0.0,38.0,38.0,1,114,0.0,86.0,86.0
15.074,17,15,9238,8,6902,2149.0,1350.0,834.0,7,2336,2507.0,1350.0,305.0
0.126,6,10,1506,5,395,22.0,127.0,127.0,5,1111,26.0,843.0,843.0
0.006,6,10,1643,5,860,1.0,592.0,592.0,5,783,1.0,515.0,515.0
0.07,6,10,1506,5,395,16.0,127.0,127.0,5,1111,16.0,843.0,843.0
0.004,6,10,2006,5,927,1.0,659.0,659.0,5,1079,1.0,811.0,811.0
0.006,6,10,2000,5,927,1.0,659.0,659.0,5,1073,1.0,805.0,805.0
0.072,17,2,156,1,64,0.0,36.0,36.0,1,92,0.0,64.0,64.0
0.004,17,4,284,2,120,1.0,32.0,32.0,2,164,1.0,60.0,54.0
0.009,6,14,3787,7,497,1.0,125.0,125.0,7,3290,1.0,1448.0,972.0
40.063,17,10,676,5,460,10014.0,104.0,64.0,5,216,10014.0,20.0,15.0
15.076,17,15,8143,8,5946,2149.0,1350.0,715.0,7,2197,2508.0,1350.0,285.0
0.01,6,10,1983,5,910,2.0,642.0,642.0,5,1073,2.0,805.0,805.0
164.308,17,82,11896,41,2761,4107.0,44.0,39.0,41,9135,4107.0,261.0,194.0
0.011,6,10,1989,5,910,2.0,642.0,642.0,5,1079,2.0,811.0,811.0
0.005,6,10,2007,5,928,1.0,660.0,660.0,5,1079,1.0,811.0,811.0
0.004,17,2,148,1,60,0.0,32.0,32.0,1,88,0.0,60.0,60.0
0.006,17,2,230,1,68,0.0,40.0,40.0,1,162,0.0,134.0,134.0
0.019,6,10,1989,5,910,4.0,642.0,642.0,5,1079,4.0,811.0,811.0
1729.226,6,60,4400,40,2740,44339.0,33.0,33.0,20,1660,91003.0,31.0,31.0
0.006,6,10,1689,5,839,1.0,571.0,571.0,5,850,1.0,582.0,582.0
0.006,6,10,1689,5,839,1.0,571.0,571.0,5,850,1.0,582.0,582.0
0.005,6,10,2007,5,928,1.0,660.0,660.0,5,1079,1.0,811.0,811.0
0.004,6,10,1702,5,863,0.0,595.0,595.0,5,839,1.0,571.0,571.0
0.095,6,10,1506,5,395,22.0,127.0,127.0,5,1111,21.0,843.0,843.0
300.314,6,16,2170,9,684,37518.0,146.0,146.0,7,1486,50024.0,419.0,398.0
0.004,17,2,136,1,60,0.0,32.0,32.0,1,76,0.0,48.0,48.0
0.014,6,10,1631,5,848,3.0,580.0,580.0,5,783,3.0,515.0,515.0
0.085,6,10,1506,5,395,17.0,127.0,127.0,5,1111,19.0,843.0,843.0
300.446,6,19,3081,11,1647,30044.0,517.0,266.0,8,1434,34341.0,821.0,336.0
292.983,6,411,349589,198,21858,1487.0,2736.0,825.0,213,327731,1381.0,2916.0,1591.0
0.011,6,10,1631,5,848,2.0,580.0,580.0,5,783,2.0,515.0,515.0
0.015,6,10,1762,5,911,3.0,643.0,643.0,5,851,3.0,583.0,583.0
0.013,6,10,1972,5,910,3.0,642.0,642.0,5,1062,3.0,794.0,794.0
0.01,6,10,1989,5,910,2.0,642.0,642.0,5,1079,2.0,811.0,811.0
0.006,6,10,1547,5,764,1.0,496.0,496.0,5,783,1.0,515.0,515.0
40.053,17,10,676,5,460,10012.0,104.0,64.0,5,216,10011.0,20.0,15.0
0.111,6,10,1506,5,395,23.0,127.0,127.0,5,1111,23.0,843.0,843.0
0.006,6,10,1854,5,889,1.0,621.0,621.0,5,965,1.0,697.0,697.0
0.142,6,10,1506,5,395,26.0,127.0,127.0,5,1111,32.0,843.0,843.0
353.445,6,20,2210,6,1308,12004.0,494.0,494.0,14,902,27187.0,83.0,83.0
0.005,6,10,2007,5,928,1.0,660.0,660.0,5,1079,1.0,811.0,811.0
0.071,17,4,284,2,120,0.0,32.0,32.0,2,164,69.0,60.0,54.0
0.004,6,10,1989,5,927,1.0,659.0,659.0,5,1062,1.0,794.0,794.0
0.012,6,13,3735,7,497,1.0,125.0,125.0,6,3238,2.0,1470.0,1459.0
0.012,6,10,1983,5,910,2.0,642.0,642.0,5,1073,2.0,805.0,805.0
0.005,6,14,3736,7,446,0.0,74.0,74.0,7,3290,0.0,1448.0,972.0
0.006,6,10,1643,5,860,1.0,592.0,592.0,5,783,1.0,515.0,515.0
0.008,6,12,1926,6,1189,1.0,659.0,434.0,6,737,1.0,417.0,417.0
0.134,6,10,1506,5,395,24.0,127.0,127.0,5,1111,25.0,843.0,843.0
0.109,6,10,1506,5,395,26.0,127.0,127.0,5,1111,25.0,843.0,843.0
0.005,6,10,1989,5,927,1.0,659.0,659.0,5,1062,1.0,794.0,794.0
0.113,6,10,1506,5,395,25.0,127.0,127.0,5,1111,23.0,843.0,843.0
0.082,6,10,1506,5,395,19.0,127.0,127.0,5,1111,18.0,843.0,843.0
0.006,6,10,1547,5,764,1.0,496.0,496.0,5,783,1.0,515.0,515.0
1557.179,6,229,41679,86,30837,18319.0,2720.0,385.0,143,10842,10965.0,1062.0,80.0
0.001,17,2,166,1,75,0.0,47.0,47.0,1,91,0.0,63.0,63.0
0.015,6,10,1983,5,910,3.0,642.0,642.0,5,1073,3.0,805.0,805.0
0.014,17,2,203,1,61,0.0,33.0,33.0,1,142,0.0,114.0,114.0
0.019,6,10,1990,5,911,4.0,643.0,643.0,5,1079,4.0,811.0,811.0
0.02,6,10,1990,5,911,5.0,643.0,643.0,5,1079,4.0,811.0,811.0
0.005,17,2,180,1,66,0.0,38.0,38.0,1,114,0.0,86.0,86.0
0.105,6,10,1506,5,395,25.0,127.0,127.0,5,1111,25.0,843.0,843.0
0.009,6,10,1762,5,911,2.0,643.0,643.0,5,851,2.0,583.0,583.0
0.02,6,10,1972,5,910,5.0,642.0,642.0,5,1062,4.0,794.0,794.0
0.039,17,2,182,1,65,0.0,37.0,37.0,1,117,0.0,89.0,89.0
0.183,6,10,1506,5,395,43.0,127.0,127.0,5,1111,42.0,843.0,843.0
0.004,6,10,1702,5,863,1.0,595.0,595.0,5,839,0.0,571.0,571.0
240.47,6,39,9797,20,2225,12656.0,745.0,235.0,19,7572,13359.0,1402.0,549.0
0.01,6,10,1989,5,910,2.0,642.0,642.0,5,1079,2.0,811.0,811.0
0.004,6,10,2006,5,927,1.0,659.0,659.0,5,1079,1.0,811.0,811.0
0.001,17,2,180,1,66,0.0,38.0,38.0,1,114,0.0,86.0,86.0
0.005,6,10,2007,5,928,1.0,660.0,660.0,5,1079,1.0,811.0,811.0
0.07,17,8,3613,4,1874,23.0,1350.0,440.0,4,1739,12.0,1350.0,406.0
0.008,6,10,1990,5,911,1.0,643.0,643.0,5,1079,2.0,811.0,811.0
0.138,6,10,1506,5,395,34.0,127.0,127.0,5,1111,32.0,843.0,843.0
0.001,17,2,166,1,75,0.0,47.0,47.0,1,91,0.0,63.0,63.0
0.006,6,10,1689,5,839,1.0,571.0,571.0,5,850,1.0,582.0,582.0
0.085,6,10,1506,5,395,19.0,127.0,127.0,5,1111,18.0,843.0,843.0
0.005,6,10,2007,5,928,1.0,660.0,660.0,5,1079,1.0,811.0,811.0
0.006,6,10,1643,5,860,1.0,592.0,592.0,5,783,1.0,515.0,515.0
240.099,6,16,4480,9,963,30012.0,238.0,166.0,7,3517,40016.0,1402.0,786.0
240.116,6,16,4480,9,963,30014.0,238.0,166.0,7,3517,40016.0,1402.0,786.0
0.017,6,10,1762,5,911,4.0,643.0,643.0,5,851,4.0,583.0,583.0
0.005,6,10,1854,5,889,1.0,621.0,621.0,5,965,1.0,697.0,697.0
0.004,17,4,284,2,120,0.0,32.0,32.0,2,164,0.0,60.0,54.0
0.005,6,14,3736,7,446,0.0,74.0,74.0,7,3290,0.0,1448.0,972.0
15.173,17,21,11287,10,7549,1682.0,1350.0,726.0,11,3738,1514.0,1350.0,311.0
0.017,6,10,1631,5,848,4.0,580.0,580.0,5,783,4.0,515.0,515.0
0.009,6,12,1926,6,1189,1.0,659.0,434.0,6,737,1.0,417.0,417.0
0.005,6,10,1774,5,923,1.0,655.0,655.0,5,851,1.0,583.0,583.0
0.006,6,10,1689,5,839,1.0,571.0,571.0,5,850,1.0,582.0,582.0
0.005,17,2,144,1,64,0.0,36.0,36.0,1,80,0.0,52.0,52.0
0.004,6,10,2007,5,928,1.0,660.0,660.0,5,1079,1.0,811.0,811.0
0.094,6,10,1506,5,395,22.0,127.0,127.0,5,1111,21.0,843.0,843.0
0.005,6,13,3747,7,509,0.0,137.0,137.0,6,3238,1.0,1470.0,1459.0
0.01,6,13,3735,7,497,1.0,125.0,125.0,6,3238,2.0,1470.0,1459.0
0.006,6,10,1547,5,764,1.0,496.0,496.0,5,783,1.0,515.0,515.0
0.021,6,10,1989,5,910,5.0,642.0,642.0,5,1079,5.0,811.0,811.0
0.043,17,2,152,1,76,0.0,48.0,48.0,1,76,0.0,48.0,48.0
0.001,17,2,166,1,75,0.0,47.0,47.0,1,91,0.0,63.0,63.0
0.001,17,2,136,1,60,0.0,32.0,32.0,1,76,0.0,48.0,48.0
0.006,6,10,1774,5,923,1.0,655.0,655.0,5,851,1.0,583.0,583.0
0.005,6,10,2007,5,928,1.0,660.0,660.0,5,1079,1.0,811.0,811.0
0.011,6,10,1989,5,910,2.0,642.0,642.0,5,1079,2.0,811.0,811.0
0.005,6,10,1854,5,889,1.0,621.0,621.0,5,965,1.0,697.0,697.0
0.144,6,10,1506,5,395,32.0,127.0,127.0,5,1111,27.0,843.0,843.0
40.077,17,10,676,5,460,10016.0,104.0,64.0,5,216,10018.0,20.0,15.0
0.003,17,2,148,1,60,0.0,32.0,32.0,1,88,0.0,60.0,60.0
0.11,6,10,1506,5,395,25.0,127.0,127.0,5,1111,25.0,843.0,843.0
0.012,6,10,1677,5,827,3.0,559.0,559.0,5,850,3.0,582.0,582.0
40.061,17,10,676,5,460,10014.0,104.0,64.0,5,216,10014.0,20.0,15.0
0.02,6,10,1677,5,827,4.0,559.0,559.0,5,850,5.0,582.0,582.0
0.009,6,10,1989,5,910,2.0,642.0,642.0,5,1079,2.0,811.0,811.0
0.004,17,2,170,1,65,0.0,37.0,37.0,1,105,0.0,77.0,77.0
40.081,17,10,676,5,460,10019.0,104.0,64.0,5,216,10019.0,20.0,15.0
0.005,17,2,222,1,65,0.0,37.0,37.0,1,157,0.0,129.0,129.0
0.005,6,10,2006,5,927,1.0,659.0,659.0,5,1079,1.0,811.0,811.0
0.134,6,10,1506,5,395,32.0,127.0,127.0,5,1111,31.0,843.0,843.0
0.009,6,10,1989,5,910,2.0,642.0,642.0,5,1079,2.0,811.0,811.0
0.187,6,44,11610,24,3282,8.0,1082.0,203.0,20,8328,9.0,1402.0,606.0
0.014,6,10,1990,5,911,3.0,643.0,643.0,5,1079,3.0,811.0,811.0
0.005,17,2,214,1,75,0.0,47.0,47.0,1,139,0.0,111.0,111.0
0.006,6,10,1547,5,764,1.0,496.0,496.0,5,783,1.0,515.0,515.0
0.006,17,2,166,1,75,0.0,47.0,47.0,1,91,0.0,63.0,63.0
40.062,17,10,676,5,460,10013.0,104.0,64.0,5,216,10014.0,20.0,15.0
0.174,17,2,152,1,76,0.0,48.0,48.0,1,76,0.0,48.0,48.0
0.005,6,10,2006,5,927,1.0,659.0,659.0,5,1079,1.0,811.0,811.0
0.011,6,10,1990,5,911,2.0,643.0,643.0,5,1079,2.0,811.0,811.0
241.607,6,364,346856,185,21140,1313.0,2736.0,959.0,179,325716,1357.0,2804.0,1872.0
243.155,6,21,6492,12,1402,22105.0,253.0,195.0,9,5090,30394.0,1402.0,769.0
0.005,6,13,3747,7,509,0.0,137.0,137.0,6,3238,1.0,1470.0,1459.0
0.012,6,10,1677,5,827,3.0,559.0,559.0,5,850,2.0,582.0,582.0
0.004,17,2,136,1,60,0.0,32.0,32.0,1,76,0.0,48.0,48.0
8.976,6,37,9823,20,4345,472.0,1360.0,700.0,17,5478,548.0,2667.0,435.0
0.004,17,2,170,1,65,0.0,37.0,37.0,1,105,0.0,77.0,77.0
352.837,6,20,2210,6,1308,12003.0,494.0,494.0,14,902,27141.0,83.0,83.0
0.005,6,10,1547,5,764,1.0,496.0,496.0,5,783,1.0,515.0,515.0
40.066,17,10,676,5,460,10014.0,104.0,64.0,5,216,10015.0,20.0,15.0
0.101,6,10,1506,5,395,19.0,127.0,127.0,5,1111,22.0,843.0,843.0
0.122,17,2,80,1,32,0.0,4.0,4.0,1,48,0.0,20.0,20.0
0.007,6,10,1989,5,910,1.0,642.0,642.0,5,1079,1.0,811.0,811.0
0.016,6,10,1989,5,910,4.0,642.0,642.0,5,1079,4.0,811.0,811.0
0.005,6,10,1989,5,927,1.0,659.0,659.0,5,1062,1.0,794.0,794.0
0.008,6,10,1762,5,911,2.0,643.0,643.0,5,851,1.0,583.0,583.0
0.009,6,10,1972,5,910,2.0,642.0,642.0,5,1062,2.0,794.0,794.0
0.006,6,10,1643,5,860,1.0,592.0,592.0,5,783,1.0,515.0,515.0
0.016,6,10,1631,5,848,4.0,580.0,580.0,5,783,3.0,515.0,515.0
0.006,6,10,1547,5,764,1.0,496.0,496.0,5,783,1.0,515.0,515.0
0.005,6,10,2006,5,927,1.0,659.0,659.0,5,1079,1.0,811.0,811.0
0.078,6,10,1506,5,395,17.0,127.0,127.0,5,1111,18.0,843.0,843.0
0.167,17,2,152,1,76,0.0,48.0,48.0,1,76,0.0,48.0,48.0
0.016,6,10,1989,5,910,3.0,642.0,642.0,5,1079,3.0,811.0,811.0
0.008,17,2,179,1,71,0.0,43.0,43.0,1,108,0.0,80.0,80.0
0.084,6,10,1506,5,395,20.0,127.0,127.0,5,1111,16.0,843.0,843.0
40.072,17,10,676,5,460,10014.0,104.0,64.0,5,216,10016.0,20.0,15.0
0.023,17,2,275,1,67,0.0,39.0,39.0,1,208,0.0,180.0,180.0
0.008,6,14,3787,7,497,1.0,125.0,125.0,7,3290,1.0,1448.0,972.0
0.006,6,10,1643,5,860,1.0,592.0,592.0,5,783,1.0,515.0,515.0
291.924,6,407,349347,198,21858,1481.0,2736.0,888.0,209,327489,1403.0,3721.0,1623.0
0.005,6,10,2006,5,927,1.0,659.0,659.0,5,1079,1.0,811.0,811.0
0.012,6,10,1677,5,827,2.0,559.0,559.0,5,850,3.0,582.0,582.0
0.011,6,10,1990,5,911,2.0,643.0,643.0,5,1079,2.0,811.0,811.0
0.004,6,10,2000,5,927,1.0,659.0,659.0,5,1073,1.0,805.0,805.0
0.084,6,10,1506,5,395,18.0,127.0,127.0,5,1111,15.0,843.0,843.0
0.007,6,10,1547,5,764,1.0,496.0,496.0,5,783,1.0,515.0,515.0
0.095,6,10,1506,5,395,23.0,127.0,127.0,5,1111,21.0,843.0,843.0
0.031,6,10,1990,5,911,7.0,643.0,643.0,5,1079,7.0,811.0,811.0
0.004,17,2,148,1,60,0.0,32.0,32.0,1,88,0.0,60.0,60.0
40.064,17,10,676,5,460,10015.0,104.0,64.0,5,216,10015.0,20.0,15.0
40.068,17,10,676,5,460,10015.0,104.0,64.0,5,216,10016.0,20.0,15.0
0.014,6,10,1762,5,911,3.0,643.0,643.0,5,851,3.0,583.0,583.0
0.005,6,14,3799,7,509,0.0,137.0,137.0,7,3290,0.0,1448.0,972.0
0.086,6,10,1506,5,395,19.0,127.0,127.0,5,1111,18.0,843.0,843.0
0.006,6,10,1547,5,764,1.0,496.0,496.0,5,783,1.0,515.0,515.0
435.02,6,47,8807,24,6690,6155.0,494.0,494.0,23,2117,19773.0,83.0,83.0
0.004,6,10,2007,5,928,1.0,660.0,660.0,5,1079,1.0,811.0,811.0
0.009,6,10,1989,5,910,2.0,642.0,642.0,5,1079,2.0,811.0,811.0
0.007,6,10,1643,5,860,1.0,592.0,592.0,5,783,1.0,515.0,515.0
0.007,17,2,179,1,71,0.0,43.0,43.0,1,108,0.0,80.0,80.0
300.018,6,12,1782,7,1348,50003.0,494.0,494.0,5,434,75003.0,83.0,83.0
0.005,6,10,2006,5,927,1.0,659.0,659.0,5,1079,1.0,811.0,811.0
290.363,6,401,352750,192,21557,1520.0,2736.0,889.0,209,331193,1395.0,4171.0,1642.0
0.001,17,2,180,1,66,0.0,38.0,38.0,1,114,0.0,86.0,86.0
0.004,6,10,2006,5,927,1.0,659.0,659.0,5,1079,1.0,811.0,811.0
0.005,17,2,144,1,64,0.0,36.0,36.0,1,80,0.0,52.0,52.0
0.004,6,10,1989,5,927,1.0,659.0,659.0,5,1062,1.0,794.0,794.0
241.924,6,305,343508,129,18224,1890.0,2006.0,886.0,176,325284,1382.0,2769.0,1904.0
240.089,6,16,4480,9,963,30011.0,238.0,166.0,7,3517,40014.0,1402.0,786.0
0.069,17,8,3613,4,1874,23.0,1350.0,440.0,4,1739,11.0,1350.0,406.0
0.007,6,10,1989,5,927,1.0,659.0,659.0,5,1062,1.0,794.0,794.0
0.003,17,2,148,1,60,0.0,32.0,32.0,1,88,0.0,60.0,60.0
0.071,17,2,144,1,64,0.0,36.0,36.0,1,80,0.0,52.0,52.0
0.014,6,10,1989,5,910,3.0,642.0,642.0,5,1079,3.0,811.0,811.0
0.041,17,2,136,1,60,0.0,32.0,32.0,1,76,0.0,48.0,48.0
0.072,6,10,1506,5,395,14.0,127.0,127.0,5,1111,16.0,843.0,843.0
0.042,17,4,420,2,122,0.0,33.0,33.0,2,298,39.0,145.0,121.0
0.166,17,2,152,1,76,0.0,48.0,48.0,1,76,0.0,48.0,48.0
0.013,6,10,1983,5,910,3.0,642.0,642.0,5,1073,3.0,805.0,805.0
0.008,17,2,179,1,71,0.0,43.0,43.0,1,108,0.0,80.0,80.0
0.019,6,10,1762,5,911,4.0,643.0,643.0,5,851,4.0,583.0,583.0
40.06,17,10,676,5,460,10014.0,104.0,64.0,5,216,10014.0,20.0,15.0
0.081,6,10,1506,5,395,16.0,127.0,127.0,5,1111,19.0,843.0,843.0
0.016,6,10,1990,5,911,4.0,643.0,643.0,5,1079,3.0,811.0,811.0
292.542,6,395,349164,197,22446,1492.0,2736.0,871.0,198,326718,1484.0,2913.0,1728.0
308.44,17,18,1044,10,716,34257.0,48.0,43.0,8,328,44044.0,20.0,13.0
0.005,6,10,2007,5,928,1.0,660.0,660.0,5,1079,1.0,811.0,811.0
0.005,17,2,140,1,62,0.0,34.0,34.0,1,78,0.0,50.0,50.0
0.001,17,2,180,1,66,0.0,38.0,38.0,1,114,0.0,86.0,86.0
0.005,6,10,1779,5,928,1.0,660.0,660.0,5,851,1.0,583.0,583.0
0.03,17,2,160,1,72,0.0,44.0,44.0,1,88,0.0,60.0,60.0
0.014,6,10,1990,5,911,3.0,643.0,643.0,5,1079,3.0,811.0,811.0
0.014,6,10,1983,5,910,3.0,642.0,642.0,5,1073,3.0,805.0,805.0
0.078,6,10,1506,5,395,17.0,127.0,127.0,5,1111,18.0,843.0,843.0
0.016,6,10,1990,5,911,3.0,643.0,643.0,5,1079,3.0,811.0,811.0
0.005,6,10,2006,5,927,1.0,659.0,659.0,5,1079,1.0,811.0,811.0
0.003,17,2,136,1,60,0.0,32.0,32.0,1,76,0.0,48.0,48.0
0.154,6,10,1506,5,395,36.0,127.0,127.0,5,1111,35.0,843.0,843.0
0.107,6,10,1506,5,395,24.0,127.0,127.0,5,1111,25.0,843.0,843.0
0.005,6,10,1989,5,927,1.0,659.0,659.0,5,1062,1.0,794.0,794.0
0.01,6,10,1989,5,910,2.0,642.0,642.0,5,1079,2.0,811.0,811.0
0.014,6,10,1972,5,910,3.0,642.0,642.0,5,1062,3.0,794.0,794.0
0.078,6,10,1506,5,395,17.0,127.0,127.0,5,1111,17.0,843.0,843.0
0.004,6,10,1989,5,927,1.0,659.0,659.0,5,1062,1.0,794.0,794.0
0.004,6,10,2007,5,928,1.0,660.0,660.0,5,1079,1.0,811.0,811.0
0.003,17,2,136,1,60,0.0,32.0,32.0,1,76,0.0,48.0,48.0
40.057,17,10,676,5,460,10013.0,104.0,64.0,5,216,10013.0,20.0,15.0
0.003,17,2,136,1,60,0.0,32.0,32.0,1,76,0.0,48.0,48.0
0.009,6,10,1990,5,911,2.0,643.0,643.0,5,1079,2.0,811.0,811.0
0.005,17,2,180,1,66,0.0,38.0,38.0,1,114,0.0,86.0,86.0
163.543,17,72,10399,36,2409,4672.0,44.0,38.0,36,7990,4672.0,261.0,193.0
0.141,6,10,1506,5,395,30.0,127.0,127.0,5,1111,32.0,843.0,843.0
0.135,6,10,1506,5,395,31.0,127.0,127.0,5,1111,27.0,843.0,843.0
0.015,6,10,1972,5,910,3.0,642.0,642.0,5,1062,3.0,794.0,794.0
0.004,6,10,2006,5,927,1.0,659.0,659.0,5,1079,1.0,811.0,811.0
0.04,17,2,148,1,60,0.0,32.0,32.0,1,88,0.0,60.0,60.0
240.302,6,30,7664,14,3409,18484.0,967.0,668.0,16,4255,16019.0,1162.0,341.0
11.138,17,28,4423,14,1994,844.0,269.0,114.0,14,2429,844.0,588.0,145.0
0.007,6,10,2007,5,928,1.0,660.0,660.0,5,1079,1.0,811.0,811.0
0.011,6,10,1989,5,910,2.0,642.0,642.0,5,1079,2.0,811.0,811.0
0.006,17,2,164,1,74,0.0,46.0,46.0,1,90,0.0,62.0,62.0
0.003,17,2,136,1,60,0.0,32.0,32.0,1,76,0.0,48.0,48.0
40.057,17,10,676,5,460,10012.0,104.0,64.0,5,216,10013.0,20.0,15.0
0.01,6,10,1983,5,910,2.0,642.0,642.0,5,1073,2.0,805.0,805.0
0.005,17,2,164,1,74,0.0,46.0,46.0,1,90,0.0,62.0,62.0
0.008,6,10,1990,5,911,2.0,643.0,643.0,5,1079,2.0,811.0,811.0
0.083,6,10,1506,5,395,18.0,127.0,127.0,5,1111,17.0,843.0,843.0
0.006,17,2,214,1,75,0.0,47.0,47.0,1,139,0.0,111.0,111.0
0.015,6,10,1989,5,910,3.0,642.0,642.0,5,1079,3.0,811.0,811.0
0.006,6,10,1547,5,764,1.0,496.0,496.0,5,783,1.0,515.0,515.0
0.004,17,2,136,1,60,0.0,32.0,32.0,1,76,0.0,48.0,48.0
0.005,6,14,3742,7,452,0.0,80.0,80.0,7,3290,0.0,1448.0,972.0
0.003,17,2,208,1,72,0.0,44.0,44.0,1,136,0.0,108.0,108.0
300.026,6,12,1782,7,1348,50004.0,494.0,494.0,5,434,75005.0,83.0,83.0
0.022,6,10,1989,5,910,5.0,642.0,642.0,5,1079,5.0,811.0,811.0
0.105,6,10,1506,5,395,23.0,127.0,127.0,5,1111,24.0,843.0,843.0
0.005,6,10,2007,5,928,1.0,660.0,660.0,5,1079,1.0,811.0,811.0
0.005,6,10,2000,5,927,1.0,659.0,659.0,5,1073,1.0,805.0,805.0
11.034,17,28,4398,14,2311,840.0,586.0,137.0,14,2087,840.0,270.0,121.0
0.006,6,10,1547,5,764,1.0,496.0,496.0,5,783,1.0,515.0,515.0
0.01,6,10,1677,5,827,2.0,559.0,559.0,5,850,2.0,582.0,582.0
0.001,17,2,166,1,75,0.0,47.0,47.0,1,91,0.0,63.0,63.0
0.115,6,10,1506,5,395,27.0,127.0,127.0,5,1111,24.0,843.0,843.0
0.004,6,10,1702,5,863,1.0,595.0,595.0,5,839,1.0,571.0,571.0
0.019,6,10,1990,5,911,4.0,643.0,643.0,5,1079,4.0,811.0,811.0
0.013,6,10,1631,5,848,3.0,580.0,580.0,5,783,3.0,515.0,515.0
0.087,6,10,1506,5,395,21.0,127.0,127.0,5,1111,13.0,843.0,843.0
0.005,17,2,136,1,60,0.0,32.0,32.0,1,76,0.0,48.0,48.0
40.067,17,10,676,5,460,10016.0,104.0,64.0,5,216,10016.0,20.0,15.0
0.013,6,10,1990,5,911,3.0,643.0,643.0,5,1079,3.0,811.0,811.0
0.082,6,10,1506,5,395,16.0,127.0,127.0,5,1111,18.0,843.0,843.0
309.129,17,20,1124,10,716,34333.0,48.0,43.0,10,408,34334.0,20.0,12.0
0.005,6,10,2007,5,928,1.0,660.0,660.0,5,1079,1.0,811.0,811.0
0.126,6,10,1506,5,395,29.0,127.0,127.0,5,1111,30.0,843.0,843.0
366.971,6,22,2313,16,867,24464.0,195.0,195.0,6,1446,4635.0,419.0,398.0
0.005,6,10,2006,5,927,1.0,659.0,659.0,5,1079,1.0,811.0,811.0
0.017,6,10,1983,5,910,4.0,642.0,642.0,5,1073,4.0,805.0,805.0
0.005,6,10,1989,5,927,1.0,659.0,659.0,5,1062,1.0,794.0,794.0
0.016,6,10,1631,5,848,4.0,580.0,580.0,5,783,3.0,515.0,515.0
0.007,6,10,1989,5,910,1.0,642.0,642.0,5,1079,1.0,811.0,811.0
100.84,6,22,9233,11,1575,71.0,794.0,367.0,11,7658,10071.0,1360.0,1029.0
0.014,6,10,1990,5,911,3.0,643.0,643.0,5,1079,3.0,811.0,811.0
0.151,6,10,1506,5,395,35.0,127.0,127.0,5,1111,32.0,843.0,843.0
0.123,17,2,80,1,32,0.0,4.0,4.0,1,48,0.0,20.0,20.0
0.019,6,10,1972,5,910,4.0,642.0,642.0,5,1062,4.0,794.0,794.0
0.005,17,2,180,1,66,0.0,38.0,38.0,1,114,0.0,86.0,86.0
0.043,17,4,284,2,120,3.0,32.0,32.0,2,164,39.0,60.0,54.0
40.06,17,10,676,5,460,10014.0,104.0,64.0,5,216,10014.0,20.0,15.0
0.005,6,10,1779,5,928,1.0,660.0,660.0,5,851,1.0,583.0,583.0
0.004,6,10,2007,5,928,1.0,660.0,660.0,5,1079,1.0,811.0,811.0
0.012,6,10,1983,5,910,3.0,642.0,642.0,5,1073,3.0,805.0,805.0
0.006,6,10,1547,5,764,1.0,496.0,496.0,5,783,1.0,515.0,515.0
0.011,6,12,1926,6,1189,2.0,659.0,434.0,6,737,2.0,417.0,417.0
0.006,6,10,1547,5,764,1.0,496.0,496.0,5,783,1.0,515.0,515.0
0.011,6,10,1762,5,911,2.0,643.0,643.0,5,851,2.0,583.0,583.0
0.005,17,2,160,1,72,0.0,44.0,44.0,1,88,0.0,60.0,60.0
0.004,6,10,1989,5,927,1.0,659.0,659.0,5,1062,1.0,794.0,794.0
0.014,6,10,1990,5,911,3.0,643.0,643.0,5,1079,3.0,811.0,811.0
40.06,17,10,676,5,460,10013.0,104.0,64.0,5,216,10014.0,20.0,15.0
0.21,6,16,2778,8,1396,30.0,533.0,324.0,8,1382,19.0,529.0,239.0
0.039,17,2,152,1,76,0.0,48.0,48.0,1,76,0.0,48.0,48.0
0.001,17,2,136,1,60,0.0,32.0,32.0,1,76,0.0,48.0,48.0
0.005,6,13,3747,7,509,0.0,137.0,137.0,6,3238,1.0,1470.0,1459.0
0.01,6,14,3787,7,497,1.0,125.0,125.0,7,3290,1.0,1448.0,972.0
0.005,6,13,3747,7,509,0.0,137.0,137.0,6,3238,0.0,1470.0,1459.0
300.787,6,40,14782,21,9224,15039.0,4080.0,1392.0,19,5558,478.0,2667.0,435.0
0.004,17,2,136,1,60,0.0,32.0,32.0,1,76,0.0,48.0,48.0
0.004,17,2,136,1,60,0.0,32.0,32.0,1,76,0.0,48.0,48.0
0.01,6,10,1631,5,848,2.0,580.0,580.0,5,783,2.0,515.0,515.0
0.072,6,10,1506,5,395,16.0,127.0,127.0,5,1111,16.0,843.0,843.0
0.01,6,10,1972,5,910,2.0,642.0,642.0,5,1062,2.0,794.0,794.0
0.005,17,4,495,2,132,1.0,38.0,38.0,2,363,2.0,176.0,153.0
0.003,17,2,136,1,60,0.0,32.0,32.0,1,76,0.0,48.0,48.0
0.004,17,2,152,1,68,0.0,40.0,40.0,1,84,0.0,56.0,56.0
0.005,6,13,3747,7,509,0.0,137.0,137.0,6,3238,0.0,1470.0,1459.0
0.005,6,10,2006,5,927,1.0,659.0,659.0,5,1079,1.0,811.0,811.0
0.006,6,10,1689,5,839,1.0,571.0,571.0,5,850,1.0,582.0,582.0
0.004,6,10,2000,5,927,1.0,659.0,659.0,5,1073,1.0,805.0,805.0
0.005,6,10,2006,5,927,1.0,659.0,659.0,5,1079,1.0,811.0,811.0
0.005,6,14,3736,7,446,0.0,74.0,74.0,7,3290,0.0,1448.0,972.0
0.068,6,10,1506,5,395,16.0,127.0,127.0,5,1111,14.0,843.0,843.0
0.017,17,2,170,1,65,0.0,37.0,37.0,1,105,0.0,77.0,77.0
0.065,6,10,1506,5,395,12.0,127.0,127.0,5,1111,16.0,843.0,843.0
0.014,6,10,1677,5,827,3.0,559.0,559.0,5,850,3.0,582.0,582.0
0.026,6,10,1990,5,911,6.0,643.0,643.0,5,1079,6.0,811.0,811.0
0.001,17,2,180,1,66,0.0,38.0,38.0,1,114,0.0,86.0,86.0
0.003,17,2,136,1,60,0.0,32.0,32.0,1,76,0.0,48.0,48.0
0.005,6,10,2007,5,928,1.0,660.0,660.0,5,1079,1.0,811.0,811.0
0.099,6,10,1506,5,395,21.0,127.0,127.0,5,1111,20.0,843.0,843.0
0.005,6,14,3799,7,509,0.0,137.0,137.0,7,3290,0.0,1448.0,972.0
0.006,6,10,1547,5,764,1.0,496.0,496.0,5,783,1.0,515.0,515.0
0.004,6,10,1702,5,863,1.0,595.0,595.0,5,839,0.0,571.0,571.0
0.005,6,10,2006,5,927,1.0,659.0,659.0,5,1079,1.0,811.0,811.0
369.942,6,24,2405,17,919,23121.0,195.0,195.0,7,1486,3902.0,419.0,398.0
0.006,17,2,144,1,64,0.0,36.0,36.0,1,80,0.0,52.0,52.0
0.014,6,10,1990,5,911,3.0,643.0,643.0,5,1079,3.0,811.0,811.0
0.005,17,2,212,1,74,0.0,46.0,46.0,1,138,0.0,110.0,110.0
1798.774,6,387,106289,171,84278,10580.0,2790.0,573.0,216,22011,8365.0,1360.0,142.0
0.078,6,10,1506,5,395,16.0,127.0,127.0,5,1111,17.0,843.0,843.0
0.005,6,10,2007,5,928,1.0,660.0,660.0,5,1079,1.0,811.0,811.0
0.008,6,10,1990,5,911,2.0,643.0,643.0,5,1079,1.0,811.0,811.0
0.063,6,10,1506,5,395,13.0,127.0,127.0,5,1111,14.0,843.0,843.0
0.007,6,10,1989,5,910,1.0,642.0,642.0,5,1079,1.0,811.0,811.0
0.011,6,10,1990,5,911,2.0,643.0,643.0,5,1079,2.0,811.0,811.0
0.004,6,10,2007,5,928,1.0,660.0,660.0,5,1079,1.0,811.0,811.0
0.005,6,10,1689,5,839,1.0,571.0,571.0,5,850,1.0,582.0,582.0
40.061,17,10,676,5,460,10014.0,104.0,64.0,5,216,10014.0,20.0,15.0
0.088,6,10,1506,5,395,18.0,127.0,127.0,5,1111,20.0,843.0,843.0
0.012,6,13,3735,7,497,2.0,125.0,125.0,6,3238,2.0,1470.0,1459.0
0.012,6,10,1983,5,910,3.0,642.0,642.0,5,1073,3.0,805.0,805.0
9.036,17,6,376,5,280,2259.0,28.0,28.0,1,96,0.0,68.0,68.0
0.004,17,2,148,1,60,0.0,32.0,32.0,1,88,0.0,60.0,60.0
0.005,6,10,1989,5,927,1.0,659.0,659.0,5,1062,1.0,794.0,794.0
0.004,17,2,136,1,60,0.0,32.0,32.0,1,76,0.0,48.0,48.0
0.01,6,10,1677,5,827,2.0,559.0,559.0,5,850,2.0,582.0,582.0
0.004,6,10,1779,5,928,1.0,660.0,660.0,5,851,1.0,583.0,583.0
40.053,17,10,676,5,460,10012.0,104.0,64.0,5,216,10012.0,20.0,15.0
0.081,6,10,1506,5,395,17.0,127.0,127.0,5,1111,15.0,843.0,843.0
0.005,6,10,1989,5,927,1.0,659.0,659.0,5,1062,1.0,794.0,794.0
0.006,6,10,1774,5,923,1.0,655.0,655.0,5,851,1.0,583.0,583.0
0.004,17,4,284,2,120,0.0,32.0,32.0,2,164,1.0,60.0,54.0
0.016,6,10,1972,5,910,3.0,642.0,642.0,5,1062,4.0,794.0,794.0
0.012,6,10,1972,5,910,3.0,642.0,642.0,5,1062,3.0,794.0,794.0
0.171,17,2,152,1,76,0.0,48.0,48.0,1,76,0.0,48.0,48.0
0.005,6,10,1779,5,928,1.0,660.0,660.0,5,851,1.0,583.0,583.0
0.01,6,10,1983,5,910,2.0,642.0,642.0,5,1073,2.0,805.0,805.0
0.142,6,10,1506,5,395,34.0,127.0,127.0,5,1111,29.0,843.0,843.0
0.009,6,10,1983,5,910,2.0,642.0,642.0,5,1073,2.0,805.0,805.0
0.103,6,10,1506,5,395,23.0,127.0,127.0,5,1111,23.0,843.0,843.0
40.038,17,10,676,5,460,10008.0,104.0,64.0,5,216,10008.0,20.0,15.0
0.003,17,2,136,1,60,0.0,32.0,32.0,1,76,0.0,48.0,48.0
0.012,6,10,1989,5,910,3.0,642.0,642.0,5,1079,2.0,811.0,811.0
0.006,17,2,164,1,74,0.0,46.0,46.0,1,90,0.0,62.0,62.0
300.312,6,16,2170,9,684,37518.0,146.0,146.0,7,1486,50024.0,419.0,398.0
0.071,17,2,186,1,61,0.0,33.0,33.0,1,125,0.0,97.0,97.0
167.184,17,76,10742,38,2536,4518.0,44.0,38.0,38,8206,4518.0,261.0,187.0
40.059,17,10,676,5,460,10012.0,104.0,64.0,5,216,10013.0,20.0,15.0
354.023,6,21,1795,16,1030,23601.0,190.0,190.0,5,765,60002.0,464.0,248.0
1756.282,6,564,191596,291,164855,6056.0,2883.0,947.0,273,26741,6456.0,580.0,121.0
353.35,6,20,2210,6,1308,12003.0,494.0,494.0,14,902,27180.0,83.0,83.0
0.006,6,10,1547,5,764,1.0,496.0,496.0,5,783,1.0,515.0,515.0
241.837,6,380,347275,190,21404,1279.0,2736.0,959.0,190,325871,1279.0,2804.0,1755.0
0.004,6,10,2006,5,927,1.0,659.0,659.0,5,1079,1.0,811.0,811.0
0.003,17,2,136,1,60,0.0,32.0,32.0,1,76,0.0,48.0,48.0
0.004,6,10,2006,5,927,1.0,659.0,659.0,5,1079,1.0,811.0,811.0
0.028,6,10,1762,5,911,6.0,643.0,643.0,5,851,7.0,583.0,583.0
0.068,17,8,3613,4,1874,22.0,1350.0,440.0,4,1739,11.0,1350.0,406.0
292.484,6,379,347358,191,21504,1539.0,2736.0,889.0,188,325854,1564.0,4206.0,1816.0
372.009,6,24,2405,17,919,23250.0,195.0,195.0,7,1486,3905.0,419.0,398.0
126.013,6,14,2938,8,2504,17968.0,1414.0,1086.0,6,434,25155.0,182.0,182.0
0.011,17,2,179,1,71,0.0,43.0,43.0,1,108,0.0,80.0,80.0
0.011,6,10,1990,5,911,2.0,643.0,643.0,5,1079,2.0,811.0,811.0
241.488,6,377,347280,194,21613,1251.0,2736.0,959.0,183,325667,1326.0,2804.0,1827.0
0.014,6,10,1677,5,827,3.0,559.0,559.0,5,850,3.0,582.0,582.0
0.017,6,10,1989,5,910,4.0,642.0,642.0,5,1079,4.0,811.0,811.0
1730.404,6,50,3080,32,1852,55819.0,35.0,35.0,18,1228,101783.0,31.0,31.0
413.344,6,29,4409,12,3102,10913.0,494.0,494.0,17,1307,25833.0,83.0,83.0
0.004,6,10,1989,5,927,1.0,659.0,659.0,5,1062,1.0,794.0,794.0
240.03,6,9,787,5,488,60007.0,232.0,232.0,4,299,80009.0,83.0,83.0
0.016,6,10,1989,5,910,4.0,642.0,642.0,5,1079,3.0,811.0,811.0
0.006,6,10,1547,5,764,1.0,496.0,496.0,5,783,1.0,515.0,515.0
301.742,6,36,8496,19,2065,16763.0,886.0,318.0,17,6431,525.0,2720.0,478.0
0.01,6,10,1990,5,911,2.0,643.0,643.0,5,1079,2.0,811.0,811.0
0.004,17,2,142,1,63,0.0,35.0,35.0,1,79,0.0,51.0,51.0
0.004,17,2,136,1,60,0.0,32.0,32.0,1,76,0.0,48.0,48.0
308.679,17,20,1124,10,716,34284.0,48.0,43.0,10,408,34284.0,20.0,12.0
0.004,6,10,2006,5,927,1.0,659.0,659.0,5,1079,1.0,811.0,811.0
40.086,17,10,676,5,460,10020.0,104.0,64.0,5,216,10020.0,20.0,15.0
0.072,6,10,1506,5,395,15.0,127.0,127.0,5,1111,15.0,843.0,843.0
0.005,17,2,209,1,64,0.0,36.0,36.0,1,145,0.0,117.0,117.0
40.11,17,10,676,5,460,10025.0,104.0,64.0,5,216,10026.0,20.0,15.0
0.005,6,10,1643,5,860,1.0,592.0,592.0,5,783,1.0,515.0,515.0
0.016,6,10,1677,5,827,3.0,559.0,559.0,5,850,3.0,582.0,582.0
0.129,17,2,80,1,32,0.0,4.0,4.0,1,48,0.0,20.0,20.0
0.02,17,2,213,1,69,0.0,41.0,41.0,1,144,0.0,116.0,116.0
0.012,6,10,1989,5,910,3.0,642.0,642.0,5,1079,2.0,811.0,811.0
0.001,17,2,136,1,60,0.0,32.0,32.0,1,76,0.0,48.0,48.0
0.016,6,10,1631,5,848,4.0,580.0,580.0,5,783,3.0,515.0,515.0
0.005,6,10,2007,5,928,1.0,660.0,660.0,5,1079,1.0,811.0,811.0
0.004,6,10,1702,5,863,1.0,595.0,595.0,5,839,0.0,571.0,571.0
0.005,6,10,1989,5,927,1.0,659.0,659.0,5,1062,1.0,794.0,794.0
0.006,6,10,1689,5,839,1.0,571.0,571.0,5,850,1.0,582.0,582.0
40.06,17,10,676,5,460,10014.0,104.0,64.0,5,216,10014.0,20.0,15.0
0.099,6,10,1506,5,395,23.0,127.0,127.0,5,1111,20.0,843.0,843.0
0.042,17,4,284,2,120,0.0,32.0,32.0,2,164,39.0,60.0,54.0
0.113,6,10,1506,5,395,25.0,127.0,127.0,5,1111,23.0,843.0,843.0
0.101,6,10,1506,5,395,23.0,127.0,127.0,5,1111,22.0,843.0,843.0
40.053,17,10,676,5,460,10012.0,104.0,64.0,5,216,10012.0,20.0,15.0
0.008,6,10,1990,5,911,2.0,643.0,643.0,5,1079,2.0,811.0,811.0
0.001,17,2,180,1,66,0.0,38.0,38.0,1,114,0.0,86.0,86.0
0.11,6,10,1506,5,395,25.0,127.0,127.0,5,1111,24.0,843.0,843.0
0.012,6,10,1989,5,910,2.0,642.0,642.0,5,1079,3.0,811.0,811.0
0.005,6,10,1774,5,923,1.0,655.0,655.0,5,851,1.0,583.0,583.0
0.017,6,10,1990,5,911,4.0,643.0,643.0,5,1079,4.0,811.0,811.0
0.009,6,12,1926,6,1189,1.0,659.0,434.0,6,737,1.0,417.0,417.0
0.076,6,10,1506,5,395,16.0,127.0,127.0,5,1111,15.0,843.0,843.0
0.014,6,10,1989,5,910,3.0,642.0,642.0,5,1079,3.0,811.0,811.0
0.006,6,10,1547,5,764,1.0,496.0,496.0,5,783,1.0,515.0,515.0
0.001,17,2,140,1,62,0.0,34.0,34.0,1,78,0.0,50.0,50.0
0.006,17,2,140,1,62,0.0,34.0,34.0,1,78,0.0,50.0,50.0
0.09,6,10,1506,5,395,21.0,127.0,127.0,5,1111,21.0,843.0,843.0
0.004,6,10,1989,5,927,1.0,659.0,659.0,5,1062,1.0,794.0,794.0
40.069,17,10,676,5,460,10014.0,104.0,64.0,5,216,10016.0,20.0,15.0
0.079,6,10,1506,5,395,16.0,127.0,127.0,5,1111,18.0,843.0,843.0
0.013,6,10,1990,5,911,3.0,643.0,643.0,5,1079,3.0,811.0,811.0
40.064,17,10,676,5,460,10015.0,104.0,64.0,5,216,10015.0,20.0,15.0
0.001,17,2,180,1,66,0.0,38.0,38.0,1,114,0.0,86.0,86.0
0.043,17,2,412,1,61,0.0,33.0,33.0,1,351,0.0,323.0,323.0
0.006,6,10,1547,5,764,1.0,496.0,496.0,5,783,1.0,515.0,515.0
0.004,17,2,136,1,60,0.0,32.0,32.0,1,76,0.0,48.0,48.0
0.074,6,10,1506,5,395,17.0,127.0,127.0,5,1111,17.0,843.0,843.0
0.004,17,2,136,1,60,0.0,32.0,32.0,1,76,0.0,48.0,48.0
309.162,17,20,1124,10,716,34337.0,48.0,43.0,10,408,34337.0,20.0,12.0
0.003,17,2,148,1,60,0.0,32.0,32.0,1,88,0.0,60.0,60.0
0.004,6,10,1779,5,928,1.0,660.0,660.0,5,851,1.0,583.0,583.0
0.108,6,10,1506,5,395,22.0,127.0,127.0,5,1111,22.0,843.0,843.0
0.005,17,2,212,1,74,0.0,46.0,46.0,1,138,0.0,110.0,110.0
0.004,17,2,148,1,60,0.0,32.0,32.0,1,88,0.0,60.0,60.0
308.906,17,20,1124,10,716,34309.0,48.0,43.0,10,408,34309.0,20.0,12.0
0.007,6,10,2000,5,927,1.0,659.0,659.0,5,1073,1.0,805.0,805.0
0.021,6,10,1677,5,827,5.0,559.0,559.0,5,850,5.0,582.0,582.0
0.015,6,10,1990,5,911,3.0,643.0,643.0,5,1079,3.0,811.0,811.0
361.835,6,19,1689,15,978,25845.0,190.0,190.0,4,711,80013.0,495.0,495.0
0.018,6,10,1989,5,910,4.0,642.0,642.0,5,1079,4.0,811.0,811.0
0.004,6,10,2007,5,928,1.0,660.0,660.0,5,1079,1.0,811.0,811.0
619.858,6,55,21214,28,5188,22957.0,676.0,530.0,27,16026,23840.0,1402.0,812.0
0.119,6,10,1506,5,395,25.0,127.0,127.0,5,1111,24.0,843.0,843.0
40.057,17,10,676,5,460,10012.0,104.0,64.0,5,216,10013.0,20.0,15.0
0.064,6,10,1506,5,395,14.0,127.0,127.0,5,1111,14.0,843.0,843.0
0.013,6,10,1972,5,910,3.0,642.0,642.0,5,1062,3.0,794.0,794.0
0.106,6,10,1506,5,395,25.0,127.0,127.0,5,1111,26.0,843.0,843.0
0.005,6,10,2007,5,928,1.0,660.0,660.0,5,1079,1.0,811.0,811.0
0.001,17,2,180,1,66,0.0,38.0,38.0,1,114,0.0,86.0,86.0
0.004,6,10,2006,5,927,1.0,659.0,659.0,5,1079,1.0,811.0,811.0
0.08,6,10,1506,5,395,16.0,127.0,127.0,5,1111,19.0,843.0,843.0
0.009,6,10,1779,5,928,2.0,660.0,660.0,5,851,2.0,583.0,583.0
0.003,17,2,148,1,60,0.0,32.0,32.0,1,88,0.0,60.0,60.0
0.01,17,2,214,1,75,0.0,47.0,47.0,1,139,0.0,111.0,111.0
369.856,6,22,2313,16,867,24657.0,195.0,195.0,6,1446,4636.0,419.0,398.0
15.072,17,15,9238,8,6902,2149.0,1350.0,834.0,7,2336,2507.0,1350.0,305.0
0.139,6,10,1506,5,395,32.0,127.0,127.0,5,1111,32.0,843.0,843.0
0.001,17,2,180,1,66,0.0,38.0,38.0,1,114,0.0,86.0,86.0
0.061,6,10,1506,5,395,14.0,127.0,127.0,5,1111,13.0,843.0,843.0
0.003,17,2,148,1,60,0.0,32.0,32.0,1,88,0.0,60.0,60.0
0.016,6,10,1972,5,910,3.0,642.0,642.0,5,1062,3.0,794.0,794.0
0.079,6,10,1506,5,395,18.0,127.0,127.0,5,1111,18.0,843.0,843.0
0.134,17,2,80,1,32,0.0,4.0,4.0,1,48,0.0,20.0,20.0
0.009,6,10,1989,5,910,2.0,642.0,642.0,5,1079,2.0,811.0,811.0
0.003,17,2,136,1,60,0.0,32.0,32.0,1,76,0.0,48.0,48.0
0.005,6,10,2006,5,927,1.0,659.0,659.0,5,1079,1.0,811.0,811.0
0.018,6,10,1762,5,911,4.0,643.0,643.0,5,851,4.0,583.0,583.0
372.153,6,22,2313,16,867,24810.0,195.0,195.0,6,1446,4646.0,419.0,398.0
0.005,17,2,214,1,75,0.0,47.0,47.0,1,139,0.0,111.0,111.0
0.009,6,10,1762,5,911,2.0,643.0,643.0,5,851,2.0,583.0,583.0
0.004,6,10,2006,5,927,1.0,659.0,659.0,5,1079,1.0,811.0,811.0
0.006,6,10,1547,5,764,1.0,496.0,496.0,5,783,1.0,515.0,515.0
0.001,17,2,180,1,66,0.0,38.0,38.0,1,114,0.0,86.0,86.0
0.006,6,10,1547,5,764,1.0,496.0,496.0,5,783,1.0,515.0,515.0
0.004,6,10,2007,5,928,1.0,660.0,660.0,5,1079,1.0,811.0,811.0
40.065,17,10,676,5,460,10013.0,104.0,64.0,5,216,10015.0,20.0,15.0
0.037,6,10,1989,5,910,9.0,642.0,642.0,5,1079,9.0,811.0,811.0
0.015,6,14,3787,7,497,2.0,125.0,125.0,7,3290,2.0,1448.0,972.0
0.005,6,10,2006,5,927,1.0,659.0,659.0,5,1079,1.0,811.0,811.0
0.006,6,10,1547,5,764,1.0,496.0,496.0,5,783,1.0,515.0,515.0
0.011,6,10,1972,5,910,2.0,642.0,642.0,5,1062,2.0,794.0,794.0
0.088,6,10,1506,5,395,19.0,127.0,127.0,5,1111,18.0,843.0,843.0
40.073,17,10,676,5,460,10015.0,104.0,64.0,5,216,10017.0,20.0,15.0
0.072,17,2,148,1,60,0.0,32.0,32.0,1,88,0.0,60.0,60.0
0.006,6,10,1547,5,764,1.0,496.0,496.0,5,783,1.0,515.0,515.0
293.817,6,322,345734,135,19206,2192.0,2736.0,870.0,187,326528,1579.0,2804.0,1841.0
0.006,6,10,1689,5,839,1.0,571.0,571.0,5,850,1.0,582.0,582.0
0.071,17,4,364,2,160,0.0,52.0,52.0,2,204,31.0,80.0,74.0
0.022,6,10,1989,5,910,5.0,642.0,642.0,5,1079,5.0,811.0,811.0
0.004,6,10,2006,5,927,1.0,659.0,659.0,5,1079,1.0,811.0,811.0
0.013,6,10,1989,5,910,3.0,642.0,642.0,5,1079,3.0,811.0,811.0
0.016,6,10,1983,5,910,3.0,642.0,642.0,5,1073,4.0,805.0,805.0
0.005,6,10,2007,5,928,1.0,660.0,660.0,5,1079,1.0,811.0,811.0
15.072,17,14,9190,8,6902,2149.0,1350.0,834.0,6,2288,3008.0,1350.0,353.0
0.005,6,10,1989,5,927,1.0,659.0,659.0,5,1062,1.0,794.0,794.0
1778.343,17,138,43608,72,22752,25046.0,288.0,288.0,66,20856,27347.0,288.0,288.0
0.012,6,10,1972,5,910,2.0,642.0,642.0,5,1062,2.0,794.0,794.0
0.086,6,10,1506,5,395,17.0,127.0,127.0,5,1111,19.0,843.0,843.0
321.228,17,20,1124,10,716,35677.0,48.0,43.0,10,408,35677.0,20.0,12.0
0.005,6,10,2000,5,927,1.0,659.0,659.0,5,1073,1.0,805.0,805.0
0.005,17,2,179,1,71,0.0,43.0,43.0,1,108,0.0,80.0,80.0
0.012,6,10,1990,5,911,3.0,643.0,643.0,5,1079,2.0,811.0,811.0
0.066,17,8,3613,4,1874,22.0,1350.0,440.0,4,1739,11.0,1350.0,406.0
241.15,6,381,347648,177,20735,1370.0,2736.0,886.0,204,326913,1187.0,2804.0,1630.0
0.003,17,4,284,2,120,0.0,32.0,32.0,2,164,0.0,60.0,54.0
67.044,6,49,18292,24,12265,403.0,2720.0,1252.0,25,6027,2786.0,2667.0,385.0
0.014,6,10,1972,5,910,3.0,642.0,642.0,5,1062,3.0,794.0,794.0
637.571,6,55,24783,29,7730,22768.0,1402.0,621.0,26,17053,25501.0,1402.0,981.0
0.005,6,10,2006,5,927,1.0,659.0,659.0,5,1079,1.0,811.0,811.0
24.784,6,50,20273,25,14246,387.0,2720.0,1321.0,25,6027,1025.0,1360.0,358.0
0.012,6,10,1631,5,848,3.0,580.0,580.0,5,783,2.0,515.0,515.0
0.005,6,10,1689,5,839,1.0,571.0,571.0,5,850,1.0,582.0,582.0
240.087,6,16,4481,9,963,30010.0,238.0,166.0,7,3518,40014.0,1402.0,786.0
0.004,6,10,1989,5,927,1.0,659.0,659.0,5,1062,1.0,794.0,794.0
0.001,17,2,180,1,66,0.0,38.0,38.0,1,114,0.0,86.0,86.0
240.113,6,31,9305,16,6800,16007.0,1871.0,663.0,15,2505,17150.0,580.0,214.0
0.141,6,10,1266,5,775,35.0,519.0,519.0,5,491,34.0,223.0,223.0
0.014,6,10,1972,5,910,3.0,642.0,642.0,5,1062,3.0,794.0,794.0
0.027,6,10,1989,5,910,6.0,642.0,642.0,5,1079,6.0,811.0,811.0
0.106,6,10,1506,5,395,24.0,127.0,127.0,5,1111,22.0,843.0,843.0
0.01,6,10,1989,5,910,2.0,642.0,642.0,5,1079,2.0,811.0,811.0
0.006,17,2,299,1,65,0.0,37.0,37.0,1,234,0.0,206.0,206.0
0.022,6,10,1990,5,911,5.0,643.0,643.0,5,1079,5.0,811.0,811.0
0.009,6,10,1990,5,911,2.0,643.0,643.0,5,1079,2.0,811.0,811.0
0.221,17,14,8577,7,4012,36.0,1350.0,545.0,7,4565,27.0,1350.0,624.0
0.006,17,2,179,1,71,0.0,43.0,43.0,1,108,0.0,80.0,80.0
0.003,17,2,136,1,60,0.0,32.0,32.0,1,76,0.0,48.0,48.0
1783.801,6,275,39115,112,22393,16069.0,2720.0,200.0,163,16722,11010.0,1360.0,130.0
40.059,17,10,676,5,460,10011.0,104.0,64.0,5,216,10013.0,20.0,15.0
0.067,6,10,1506,5,395,15.0,127.0,127.0,5,1111,14.0,843.0,843.0
0.069,17,8,3613,4,1874,23.0,1350.0,440.0,4,1739,11.0,1350.0,406.0
0.004,17,4,284,2,120,0.0,32.0,32.0,2,164,1.0,60.0,54.0
0.004,6,10,1989,5,927,1.0,659.0,659.0,5,1062,1.0,794.0,794.0
356.595,6,21,1795,16,1030,23773.0,190.0,190.0,5,765,60003.0,464.0,248.0
0.007,6,10,1990,5,911,1.0,643.0,643.0,5,1079,1.0,811.0,811.0
0.116,6,10,1506,5,395,28.0,127.0,127.0,5,1111,22.0,843.0,843.0
0.005,6,10,2007,5,928,1.0,660.0,660.0,5,1079,1.0,811.0,811.0
0.005,6,13,3747,7,509,0.0,137.0,137.0,6,3238,0.0,1470.0,1459.0
0.014,6,14,3787,7,497,2.0,125.0,125.0,7,3290,2.0,1448.0,972.0
0.015,6,10,1989,5,910,3.0,642.0,642.0,5,1079,3.0,811.0,811.0
0.166,17,2,152,1,76,0.0,48.0,48.0,1,76,0.0,48.0,48.0
0.177,6,10,1506,5,395,41.0,127.0,127.0,5,1111,41.0,843.0,843.0
15.08,17,15,8139,8,6097,2150.0,1350.0,734.0,7,2042,2508.0,1350.0,263.0
15.07,17,15,9238,8,6902,2148.0,1350.0,834.0,7,2336,2506.0,1350.0,305.0
1133.493,6,59,22450,31,7792,37783.0,1273.0,561.0,28,14658,39755.0,1402.0,824.0
0.071,17,4,420,2,122,1.0,33.0,33.0,2,298,67.0,145.0,121.0
40.1,17,10,676,5,460,10022.0,104.0,64.0,5,216,10024.0,20.0,15.0
1793.595,6,591,198503,291,166165,6184.0,2883.0,909.0,300,32338,5998.0,1666.0,146.0
0.003,17,2,136,1,60,0.0,32.0,32.0,1,76,0.0,48.0,48.0
0.004,17,2,148,1,60,0.0,32.0,32.0,1,88,0.0,60.0,60.0
0.005,6,10,2007,5,928,1.0,660.0,660.0,5,1079,1.0,811.0,811.0
0.004,6,10,2006,5,927,1.0,659.0,659.0,5,1079,1.0,811.0,811.0
0.005,6,10,1989,5,927,1.0,659.0,659.0,5,1062,1.0,794.0,794.0
0.008,6,10,1983,5,910,2.0,642.0,642.0,5,1073,2.0,805.0,805.0
0.167,17,2,152,1,76,0.0,48.0,48.0,1,76,0.0,48.0,48.0
0.007,6,10,1547,5,764,1.0,496.0,496.0,5,783,1.0,515.0,515.0
0.006,6,13,3747,7,509,0.0,137.0,137.0,6,3238,1.0,1470.0,1459.0
11.57,17,28,4393,14,2312,876.0,587.0,137.0,14,2081,877.0,268.0,120.0
0.017,6,13,3735,7,497,2.0,125.0,125.0,6,3238,3.0,1470.0,1459.0
0.078,6,10,1506,5,395,15.0,127.0,127.0,5,1111,16.0,843.0,843.0
0.005,17,2,169,1,62,0.0,34.0,34.0,1,107,0.0,79.0,79.0
0.008,6,10,1983,5,910,2.0,642.0,642.0,5,1073,2.0,805.0,805.0
0.01,6,10,1989,5,910,2.0,642.0,642.0,5,1079,2.0,811.0,811.0
0.004,6,10,1702,5,863,1.0,595.0,595.0,5,839,0.0,571.0,571.0
0.122,6,10,1506,5,395,29.0,127.0,127.0,5,1111,29.0,843.0,843.0
0.015,6,10,1631,5,848,3.0,580.0,580.0,5,783,3.0,515.0,515.0
0.006,6,10,1547,5,764,1.0,496.0,496.0,5,783,1.0,515.0,515.0
0.011,6,10,1972,5,910,2.0,642.0,642.0,5,1062,2.0,794.0,794.0
0.026,6,10,1989,5,910,6.0,642.0,642.0,5,1079,6.0,811.0,811.0
0.017,6,10,1972,5,910,4.0,642.0,642.0,5,1062,4.0,794.0,794.0
0.226,6,16,2668,8,1394,32.0,533.0,323.0,8,1274,20.0,529.0,212.0
40.064,17,10,676,5,460,10013.0,104.0,64.0,5,216,10015.0,20.0,15.0
0.004,6,10,2006,5,927,1.0,659.0,659.0,5,1079,1.0,811.0,811.0
0.084,6,10,1506,5,395,18.0,127.0,127.0,5,1111,18.0,843.0,843.0
0.072,6,10,1506,5,395,17.0,127.0,127.0,5,1111,15.0,843.0,843.0
0.005,6,10,1989,5,927,1.0,659.0,659.0,5,1062,1.0,794.0,794.0
0.012,6,10,1677,5,827,2.0,559.0,559.0,5,850,2.0,582.0,582.0
0.152,6,10,1506,5,395,33.0,127.0,127.0,5,1111,34.0,843.0,843.0
0.024,6,7,695,4,448,8.0,232.0,232.0,3,247,7.0,83.0,83.0
40.062,17,10,676,5,460,10014.0,104.0,64.0,5,216,10014.0,20.0,15.0
300.475,6,19,3081,11,1647,30047.0,517.0,266.0,8,1434,34347.0,821.0,336.0
0.005,17,2,170,1,65,0.0,37.0,37.0,1,105,0.0,77.0,77.0
0.016,6,10,1990,5,911,4.0,643.0,643.0,5,1079,3.0,811.0,811.0
0.005,6,10,2006,5,927,1.0,659.0,659.0,5,1079,1.0,811.0,811.0
240.014,6,9,787,5,488,60003.0,232.0,232.0,4,299,80003.0,83.0,83.0
0.008,6,13,3735,7,497,1.0,125.0,125.0,6,3238,1.0,1470.0,1459.0
0.091,6,10,1506,5,395,21.0,127.0,127.0,5,1111,20.0,843.0,843.0
0.017,17,2,180,1,66,0.0,38.0,38.0,1,114,0.0,86.0,86.0
0.071,17,4,284,2,120,0.0,32.0,32.0,2,164,68.0,60.0,54.0
0.006,6,10,1547,5,764,1.0,496.0,496.0,5,783,1.0,515.0,515.0
0.012,6,10,1972,5,910,2.0,642.0,642.0,5,1062,2.0,794.0,794.0
0.001,17,2,180,1,66,0.0,38.0,38.0,1,114,0.0,86.0,86.0
0.005,17,2,164,1,74,0.0,46.0,46.0,1,90,0.0,62.0,62.0
0.096,6,10,1506,5,395,23.0,127.0,127.0,5,1111,19.0,843.0,843.0
0.013,6,10,1983,5,910,3.0,642.0,642.0,5,1073,3.0,805.0,805.0
0.071,17,2,148,1,60,0.0,32.0,32.0,1,88,0.0,60.0,60.0
0.003,17,4,284,2,120,0.0,32.0,32.0,2,164,0.0,60.0,54.0
0.005,6,10,2006,5,927,1.0,659.0,659.0,5,1079,1.0,811.0,811.0
0.071,17,4,284,2,120,0.0,32.0,32.0,2,164,31.0,60.0,54.0
0.024,6,10,1631,5,848,5.0,580.0,580.0,5,783,6.0,515.0,515.0
0.04,17,2,152,1,76,0.0,48.0,48.0,1,76,0.0,48.0,48.0
0.008,6,10,1983,5,910,2.0,642.0,642.0,5,1073,1.0,805.0,805.0
0.016,6,10,1990,5,911,4.0,643.0,643.0,5,1079,3.0,811.0,811.0
240.01,6,9,787,5,488,60002.0,232.0,232.0,4,299,80002.0,83.0,83.0
0.009,6,13,3735,7,497,1.0,125.0,125.0,6,3238,1.0,1470.0,1459.0
0.071,6,10,1506,5,395,15.0,127.0,127.0,5,1111,15.0,843.0,843.0
0.005,17,2,212,1,74,0.0,46.0,46.0,1,138,0.0,110.0,110.0
0.006,17,2,144,1,64,0.0,36.0,36.0,1,80,0.0,52.0,52.0
10.919,17,28,4423,14,1994,830.0,269.0,114.0,14,2429,831.0,588.0,145.0
0.012,6,10,1677,5,827,3.0,559.0,559.0,5,850,2.0,582.0,582.0
0.104,6,10,1506,5,395,23.0,127.0,127.0,5,1111,25.0,843.0,843.0
11.192,17,28,4424,14,1995,848.0,270.0,114.0,14,2429,848.0,588.0,145.0
0.009,6,10,1631,5,848,2.0,580.0,580.0,5,783,2.0,515.0,515.0
0.01,6,10,1972,5,910,2.0,642.0,642.0,5,1062,2.0,794.0,794.0
175.85,6,22,9233,11,1575,81.0,794.0,367.0,11,7658,17571.0,1360.0,1029.0
0.006,6,10,1547,5,764,1.0,496.0,496.0,5,783,1.0,515.0,515.0
0.011,6,10,1972,5,910,2.0,642.0,642.0,5,1062,2.0,794.0,794.0
0.016,6,10,1762,5,911,4.0,643.0,643.0,5,851,3.0,583.0,583.0
0.005,17,2,179,1,71,0.0,43.0,43.0,1,108,0.0,80.0,80.0
0.006,6,10,1547,5,764,1.0,496.0,496.0,5,783,1.0,515.0,515.0
0.015,6,10,1983,5,910,3.0,642.0,642.0,5,1073,3.0,805.0,805.0
0.001,17,2,180,1,66,0.0,38.0,38.0,1,114,0.0,86.0,86.0
40.055,17,10,676,5,460,10012.0,104.0,64.0,5,216,10013.0,20.0,15.0
0.023,6,10,1762,5,911,5.0,643.0,643.0,5,851,5.0,583.0,583.0
0.074,6,10,1506,5,395,16.0,127.0,127.0,5,1111,16.0,843.0,843.0
0.005,17,2,144,1,64,0.0,36.0,36.0,1,80,0.0,52.0,52.0
0.004,6,10,1989,5,927,1.0,659.0,659.0,5,1062,1.0,794.0,794.0
0.004,6,10,2007,5,928,1.0,660.0,660.0,5,1079,1.0,811.0,811.0
0.006,6,10,1547,5,764,1.0,496.0,496.0,5,783,1.0,515.0,515.0
0.066,6,10,1506,5,395,16.0,127.0,127.0,5,1111,14.0,843.0,843.0
11.212,17,28,4421,14,1994,850.0,269.0,114.0,14,2427,850.0,586.0,145.0
0.214,6,16,2778,8,1396,30.0,533.0,324.0,8,1382,19.0,529.0,239.0
0.012,6,10,1762,5,911,3.0,643.0,643.0,5,851,3.0,583.0,583.0
0.005,17,2,170,1,65,0.0,37.0,37.0,1,105,0.0,77.0,77.0
0.004,17,2,136,1,60,0.0,32.0,32.0,1,76,0.0,48.0,48.0
0.005,17,2,164,1,74,0.0,46.0,46.0,1,90,0.0,62.0,62.0
0.005,6,10,2007,5,928,1.0,660.0,660.0,5,1079,1.0,811.0,811.0
0.005,6,10,2006,5,927,1.0,659.0,659.0,5,1079,1.0,811.0,811.0
0.101,6,10,1506,5,395,23.0,127.0,127.0,5,1111,15.0,843.0,843.0
0.005,6,10,2007,5,928,1.0,660.0,660.0,5,1079,1.0,811.0,811.0
0.014,6,10,1631,5,848,3.0,580.0,580.0,5,783,3.0,515.0,515.0
0.012,6,10,1989,5,910,3.0,642.0,642.0,5,1079,2.0,811.0,811.0
163.358,17,66,9399,33,2202,5104.0,44.0,38.0,33,7197,5104.0,261.0,190.0
0.04,17,2,412,1,61,0.0,33.0,33.0,1,351,0.0,323.0,323.0
0.007,6,10,1989,5,910,1.0,642.0,642.0,5,1079,1.0,811.0,811.0
0.008,17,2,148,1,60,0.0,32.0,32.0,1,88,0.0,60.0,60.0
0.005,17,2,169,1,62,0.0,34.0,34.0,1,107,0.0,79.0,79.0
0.009,6,10,1677,5,827,2.0,559.0,559.0,5,850,2.0,582.0,582.0
0.009,6,10,1990,5,911,2.0,643.0,643.0,5,1079,2.0,811.0,811.0
40.056,17,10,676,5,460,10013.0,104.0,64.0,5,216,10013.0,20.0,15.0
0.012,6,10,1989,5,910,3.0,642.0,642.0,5,1079,3.0,811.0,811.0
0.001,17,2,180,1,66,0.0,38.0,38.0,1,114,0.0,86.0,86.0
0.042,17,2,148,1,60,0.0,32.0,32.0,1,88,0.0,60.0,60.0
0.08,6,10,1506,5,395,15.0,127.0,127.0,5,1111,17.0,843.0,843.0
0.005,6,10,2007,5,928,1.0,660.0,660.0,5,1079,1.0,811.0,811.0
10.915,17,28,4423,14,1994,831.0,269.0,114.0,14,2429,831.0,588.0,145.0
0.039,17,2,182,1,65,0.0,37.0,37.0,1,117,0.0,89.0,89.0
0.129,17,2,80,1,32,0.0,4.0,4.0,1,48,0.0,20.0,20.0
0.006,6,10,1689,5,839,1.0,571.0,571.0,5,850,1.0,582.0,582.0
0.005,6,10,2000,5,927,1.0,659.0,659.0,5,1073,1.0,805.0,805.0
0.006,6,10,1547,5,764,1.0,496.0,496.0,5,783,1.0,515.0,515.0
0.087,6,10,1506,5,395,20.0,127.0,127.0,5,1111,17.0,843.0,843.0
300.39,6,29,8763,14,2477,23106.0,1225.0,348.0,15,6286,21456.0,1592.0,612.0
0.005,17,2,144,1,64,0.0,36.0,36.0,1,80,0.0,52.0,52.0
0.004,17,2,136,1,60,0.0,32.0,32.0,1,76,0.0,48.0,48.0
0.006,17,2,170,1,65,0.0,37.0,37.0,1,105,0.0,77.0,77.0
1770.308,6,84,4418,42,2210,43177.0,26.0,26.0,42,2208,43177.0,24.0,24.0
0.187,17,2,152,1,76,0.0,48.0,48.0,1,76,0.0,48.0,48.0
0.093,6,10,1506,5,395,22.0,127.0,127.0,5,1111,21.0,843.0,843.0
0.011,6,10,1631,5,848,2.0,580.0,580.0,5,783,2.0,515.0,515.0
0.012,6,10,1990,5,911,2.0,643.0,643.0,5,1079,3.0,811.0,811.0
0.009,6,10,1631,5,848,2.0,580.0,580.0,5,783,2.0,515.0,515.0
0.097,6,10,1506,5,395,21.0,127.0,127.0,5,1111,20.0,843.0,843.0
0.004,17,2,186,1,61,0.0,33.0,33.0,1,125,0.0,97.0,97.0
0.103,6,10,1506,5,395,23.0,127.0,127.0,5,1111,16.0,843.0,843.0
0.013,6,10,1990,5,911,3.0,643.0,643.0,5,1079,3.0,811.0,811.0
0.009,6,10,1989,5,910,2.0,642.0,642.0,5,1079,2.0,811.0,811.0
0.003,17,2,148,1,60,0.0,32.0,32.0,1,88,0.0,60.0,60.0
0.008,6,10,1989,5,910,2.0,642.0,642.0,5,1079,1.0,811.0,811.0
0.013,6,10,1983,5,910,3.0,642.0,642.0,5,1073,3.0,805.0,805.0
310.155,17,20,1124,10,716,34447.0,48.0,43.0,10,408,34447.0,20.0,12.0
40.091,17,10,676,5,460,10021.0,104.0,64.0,5,216,10021.0,20.0,15.0
0.006,6,10,2006,5,927,1.0,659.0,659.0,5,1079,1.0,811.0,811.0
0.077,6,10,1990,5,911,19.0,643.0,643.0,5,1079,19.0,811.0,811.0
0.009,6,13,3735,7,497,1.0,125.0,125.0,6,3238,1.0,1470.0,1459.0
0.004,6,10,1989,5,927,1.0,659.0,659.0,5,1062,1.0,794.0,794.0
0.128,17,2,80,1,32,0.0,4.0,4.0,1,48,0.0,20.0,20.0
40.068,17,10,676,5,460,10015.0,104.0,64.0,5,216,10016.0,20.0,15.0
0.005,6,10,2000,5,927,1.0,659.0,659.0,5,1073,1.0,805.0,805.0
0.011,6,10,1990,5,911,2.0,643.0,643.0,5,1079,2.0,811.0,811.0
0.006,6,10,1643,5,860,1.0,592.0,592.0,5,783,1.0,515.0,515.0
0.005,6,10,1989,5,927,1.0,659.0,659.0,5,1062,1.0,794.0,794.0
0.086,6,10,1506,5,395,17.0,127.0,127.0,5,1111,19.0,843.0,843.0
0.097,6,10,1506,5,395,23.0,127.0,127.0,5,1111,21.0,843.0,843.0
0.018,6,10,1990,5,911,4.0,643.0,643.0,5,1079,4.0,811.0,811.0
0.014,6,10,1989,5,910,3.0,642.0,642.0,5,1079,3.0,811.0,811.0
1787.368,6,154,19574,92,13852,19641.0,302.0,302.0,62,5722,29301.0,83.0,83.0
0.012,6,10,1762,5,911,3.0,643.0,643.0,5,851,2.0,583.0,583.0
289.981,6,414,348601,202,22069,1442.0,2736.0,889.0,212,326532,1374.0,2804.0,1593.0
0.011,6,10,1990,5,911,2.0,643.0,643.0,5,1079,2.0,811.0,811.0
0.008,6,10,1972,5,910,2.0,642.0,642.0,5,1062,2.0,794.0,794.0
0.005,6,10,2000,5,927,1.0,659.0,659.0,5,1073,1.0,805.0,805.0
0.006,6,10,1547,5,764,1.0,496.0,496.0,5,783,1.0,515.0,515.0
240.089,6,16,4481,9,963,30011.0,238.0,166.0,7,3518,40014.0,1402.0,786.0
0.108,6,10,1506,5,395,24.0,127.0,127.0,5,1111,22.0,843.0,843.0
0.016,6,10,1989,5,910,4.0,642.0,642.0,5,1079,4.0,811.0,811.0
0.016,6,10,1989,5,910,4.0,642.0,642.0,5,1079,4.0,811.0,811.0
0.017,6,10,1972,5,910,4.0,642.0,642.0,5,1062,4.0,794.0,794.0
0.012,6,10,1972,5,910,2.0,642.0,642.0,5,1062,3.0,794.0,794.0
0.067,6,10,1506,5,395,14.0,127.0,127.0,5,1111,16.0,843.0,843.0
0.013,6,10,1762,5,911,3.0,643.0,643.0,5,851,3.0,583.0,583.0
0.011,6,10,1983,5,910,2.0,642.0,642.0,5,1073,2.0,805.0,805.0
0.016,17,2,198,1,91,0.0,63.0,63.0,1,107,0.0,79.0,79.0
0.005,6,10,1689,5,839,1.0,571.0,571.0,5,850,1.0,582.0,582.0
0.027,6,10,1631,5,848,6.0,580.0,580.0,5,783,6.0,515.0,515.0
0.011,6,13,3735,7,497,1.0,125.0,125.0,6,3238,2.0,1470.0,1459.0
0.005,6,14,3736,7,446,0.0,74.0,74.0,7,3290,0.0,1448.0,972.0
0.008,6,10,1972,5,910,1.0,642.0,642.0,5,1062,2.0,794.0,794.0
0.005,17,2,169,1,62,0.0,34.0,34.0,1,107,0.0,79.0,79.0
40.06,17,10,676,5,460,10014.0,104.0,64.0,5,216,10014.0,20.0,15.0
0.005,6,10,1989,5,927,1.0,659.0,659.0,5,1062,1.0,794.0,794.0
0.005,6,10,1689,5,839,1.0,571.0,571.0,5,850,1.0,582.0,582.0
174.282,17,76,10954,38,2541,4710.0,44.0,38.0,38,8413,4710.0,239.0,193.0
0.038,17,2,148,1,60,0.0,32.0,32.0,1,88,0.0,60.0,60.0
0.006,6,10,2006,5,927,1.0,659.0,659.0,5,1079,1.0,811.0,811.0
0.103,6,10,1506,5,395,22.0,127.0,127.0,5,1111,20.0,843.0,843.0
377.977,6,20,2210,6,1308,12003.0,494.0,494.0,14,902,29074.0,83.0,83.0
0.007,6,10,1762,5,911,1.0,643.0,643.0,5,851,1.0,583.0,583.0
0.004,6,10,2006,5,927,1.0,659.0,659.0,5,1079,1.0,811.0,811.0
0.016,6,10,1983,5,910,4.0,642.0,642.0,5,1073,4.0,805.0,805.0
0.099,6,10,1506,5,395,20.0,127.0,127.0,5,1111,19.0,843.0,843.0
0.004,6,10,2006,5,927,1.0,659.0,659.0,5,1079,1.0,811.0,811.0
0.024,6,10,1989,5,910,6.0,642.0,642.0,5,1079,6.0,811.0,811.0
0.103,6,10,1506,5,395,22.0,127.0,127.0,5,1111,15.0,843.0,843.0
300.447,6,16,2170,9,684,37534.0,146.0,146.0,7,1486,50045.0,419.0,398.0
40.08,17,10,676,5,460,10019.0,104.0,64.0,5,216,10019.0,20.0,15.0
0.005,6,10,2006,5,927,1.0,659.0,659.0,5,1079,1.0,811.0,811.0
0.004,6,10,1702,5,863,0.0,595.0,595.0,5,839,1.0,571.0,571.0
0.006,6,10,1689,5,839,1.0,571.0,571.0,5,850,1.0,582.0,582.0
1.974,6,37,6775,21,3555,98.0,1103.0,204.0,16,3220,122.0,1796.0,396.0
0.005,6,10,2007,5,928,1.0,660.0,660.0,5,1079,1.0,811.0,811.0
40.065,17,10,676,5,460,10015.0,104.0,64.0,5,216,10015.0,20.0,15.0
1787.5,6,154,19574,92,13852,19642.0,302.0,302.0,62,5722,29303.0,83.0,83.0
0.018,6,10,1989,5,910,4.0,642.0,642.0,5,1079,4.0,811.0,811.0
0.123,6,10,1506,5,395,29.0,127.0,127.0,5,1111,28.0,843.0,843.0
0.138,6,10,1506,5,395,33.0,127.0,127.0,5,1111,24.0,843.0,843.0
289.863,6,384,348152,196,21747,1486.0,2736.0,888.0,188,326405,1550.0,2804.0,1819.0
0.005,6,13,3690,7,452,0.0,80.0,80.0,6,3238,1.0,1470.0,1459.0
0.017,6,10,1972,5,910,4.0,642.0,642.0,5,1062,4.0,794.0,794.0
0.103,6,10,1506,5,395,23.0,127.0,127.0,5,1111,23.0,843.0,843.0
0.004,6,10,2006,5,927,1.0,659.0,659.0,5,1079,1.0,811.0,811.0
40.054,17,10,676,5,460,10011.0,104.0,64.0,5,216,10012.0,20.0,15.0
0.005,17,2,136,1,60,0.0,32.0,32.0,1,76,0.0,48.0,48.0
0.019,6,10,1989,5,910,4.0,642.0,642.0,5,1079,4.0,811.0,811.0
0.001,17,2,180,1,66,0.0,38.0,38.0,1,114,0.0,86.0,86.0
0.008,6,10,1677,5,827,2.0,559.0,559.0,5,850,2.0,582.0,582.0
0.005,17,2,170,1,65,0.0,37.0,37.0,1,105,0.0,77.0,77.0
0.103,6,10,1506,5,395,21.0,127.0,127.0,5,1111,23.0,843.0,843.0
0.014,17,2,138,1,61,0.0,33.0,33.0,1,77,0.0,49.0,49.0
0.059,17,2,152,1,76,0.0,48.0,48.0,1,76,0.0,48.0,48.0
0.089,6,10,1506,5,395,21.0,127.0,127.0,5,1111,20.0,843.0,843.0
0.084,6,10,1506,5,395,16.0,127.0,127.0,5,1111,18.0,843.0,843.0
40.054,17,10,676,5,460,10012.0,104.0,64.0,5,216,10012.0,20.0,15.0
0.004,6,10,1702,5,863,1.0,595.0,595.0,5,839,0.0,571.0,571.0
0.04,17,2,412,1,61,0.0,33.0,33.0,1,351,0.0,323.0,323.0
240.094,6,32,9338,16,6784,16006.0,1856.0,661.0,16,2554,16006.0,580.0,214.0
0.012,6,10,1989,5,910,3.0,642.0,642.0,5,1079,2.0,811.0,811.0
0.072,6,10,1506,5,395,15.0,127.0,127.0,5,1111,15.0,843.0,843.0
40.07,17,10,676,5,460,10014.0,104.0,64.0,5,216,10016.0,20.0,15.0
0.105,6,10,1506,5,395,22.0,127.0,127.0,5,1111,22.0,843.0,843.0
0.005,6,10,2007,5,928,1.0,660.0,660.0,5,1079,1.0,811.0,811.0
0.005,6,10,2007,5,928,1.0,660.0,660.0,5,1079,1.0,811.0,811.0
0.001,17,2,142,1,63,0.0,35.0,35.0,1,79,0.0,51.0,51.0
0.005,17,2,140,1,62,0.0,34.0,34.0,1,78,0.0,50.0,50.0
0.005,6,10,1989,5,927,1.0,659.0,659.0,5,1062,1.0,794.0,794.0
0.079,6,10,1506,5,395,19.0,127.0,127.0,5,1111,16.0,843.0,843.0
40.015,17,10,676,5,460,10002.0,104.0,64.0,5,216,10003.0,20.0,15.0
308.763,17,20,1124,10,716,34292.0,48.0,43.0,10,408,34292.0,20.0,12.0
0.127,6,10,1506,5,395,28.0,127.0,127.0,5,1111,29.0,843.0,843.0
240.016,6,9,787,5,488,60004.0,232.0,232.0,4,299,80004.0,83.0,83.0
40.061,17,10,676,5,460,10014.0,104.0,64.0,5,216,10014.0,20.0,15.0
26.476,6,40,12767,20,7169,470.0,2720.0,1056.0,20,5598,1384.0,1360.0,398.0
240.108,6,34,9475,18,7115,14124.0,2083.0,687.0,16,2360,16007.0,580.0,190.0
40.075,17,10,676,5,460,10016.0,104.0,64.0,5,216,10017.0,20.0,15.0
0.015,6,10,1677,5,827,3.0,559.0,559.0,5,850,3.0,582.0,582.0
0.011,6,10,1989,5,910,2.0,642.0,642.0,5,1079,2.0,811.0,811.0
0.015,6,10,1631,5,848,3.0,580.0,580.0,5,783,3.0,515.0,515.0
0.006,6,10,1643,5,860,1.0,592.0,592.0,5,783,1.0,515.0,515.0
0.129,17,2,80,1,32,0.0,4.0,4.0,1,48,0.0,20.0,20.0
0.019,6,10,1972,5,910,4.0,642.0,642.0,5,1062,4.0,794.0,794.0
0.001,17,2,136,1,60,0.0,32.0,32.0,1,76,0.0,48.0,48.0
1770.615,17,120,11460,60,5460,30010.0,63.0,63.0,60,6000,30010.0,72.0,72.0
0.129,6,10,1506,5,395,31.0,127.0,127.0,5,1111,29.0,843.0,843.0
0.099,6,10,1506,5,395,19.0,127.0,127.0,5,1111,21.0,843.0,843.0
0.22,6,16,2669,8,1395,31.0,533.0,323.0,8,1274,20.0,529.0,212.0
241.144,6,303,343065,118,17648,2061.0,2736.0,885.0,185,325417,1310.0,2804.0,1804.0
0.025,6,10,1989,5,910,6.0,642.0,642.0,5,1079,6.0,811.0,811.0
0.014,6,10,1972,5,910,3.0,642.0,642.0,5,1062,3.0,794.0,794.0
0.037,6,10,1989,5,910,9.0,642.0,642.0,5,1079,9.0,811.0,811.0
0.004,6,10,1989,5,927,1.0,659.0,659.0,5,1062,1.0,794.0,794.0
0.015,6,10,1990,5,911,3.0,643.0,643.0,5,1079,3.0,811.0,811.0
40.069,17,10,676,5,460,10014.0,104.0,64.0,5,216,10012.0,20.0,15.0
0.005,6,14,3736,7,446,0.0,74.0,74.0,7,3290,0.0,1448.0,972.0
0.07,6,10,1506,5,395,16.0,127.0,127.0,5,1111,16.0,843.0,843.0
0.006,6,10,1689,5,839,1.0,571.0,571.0,5,850,1.0,582.0,582.0
0.005,6,10,2006,5,927,1.0,659.0,659.0,5,1079,1.0,811.0,811.0
65.901,6,28,17634,16,9690,4393.0,2804.0,1264.0,12,7944,5976.0,2315.0,1218.0
0.005,6,10,1989,5,927,1.0,659.0,659.0,5,1062,1.0,794.0,794.0
0.07,17,8,3613,4,1874,23.0,1350.0,440.0,4,1739,12.0,1350.0,406.0
0.004,6,10,1779,5,928,1.0,660.0,660.0,5,851,1.0,583.0,583.0
0.014,6,10,1989,5,910,3.0,642.0,642.0,5,1079,3.0,811.0,811.0
0.004,6,10,1774,5,923,1.0,655.0,655.0,5,851,1.0,583.0,583.0
0.005,17,2,168,1,76,0.0,48.0,48.0,1,92,0.0,64.0,64.0
0.005,6,10,1989,5,927,1.0,659.0,659.0,5,1062,1.0,794.0,794.0
0.011,6,10,1972,5,910,2.0,642.0,642.0,5,1062,2.0,794.0,794.0
0.001,17,2,166,1,75,0.0,47.0,47.0,1,91,0.0,63.0,63.0
0.004,17,2,136,1,60,0.0,32.0,32.0,1,76,0.0,48.0,48.0
0.101,6,10,1506,5,395,21.0,127.0,127.0,5,1111,20.0,843.0,843.0
0.01,6,10,1989,5,910,2.0,642.0,642.0,5,1079,2.0,811.0,811.0
0.11,6,10,1506,5,395,23.0,127.0,127.0,5,1111,24.0,843.0,843.0
10.758,17,28,4423,14,1994,819.0,269.0,114.0,14,2429,819.0,588.0,145.0
40.067,17,10,676,5,460,10016.0,104.0,64.0,5,216,10016.0,20.0,15.0
351.998,6,20,2210,6,1308,12004.0,494.0,494.0,14,902,27076.0,83.0,83.0
0.092,6,10,1506,5,395,21.0,127.0,127.0,5,1111,19.0,843.0,843.0
310.031,17,20,1124,10,716,34433.0,48.0,43.0,10,408,34433.0,20.0,12.0
0.103,6,10,1506,5,395,22.0,127.0,127.0,5,1111,22.0,843.0,843.0
0.005,6,10,1643,5,860,1.0,592.0,592.0,5,783,1.0,515.0,515.0
0.156,6,10,1506,5,395,36.0,127.0,127.0,5,1111,37.0,843.0,843.0
0.004,6,10,1702,5,863,1.0,595.0,595.0,5,839,0.0,571.0,571.0
0.006,6,10,1689,5,839,1.0,571.0,571.0,5,850,1.0,582.0,582.0
0.112,6,10,1506,5,395,25.0,127.0,127.0,5,1111,25.0,843.0,843.0
0.037,17,4,284,2,120,0.0,32.0,32.0,2,164,33.0,60.0,54.0
0.007,6,10,1983,5,910,1.0,642.0,642.0,5,1073,1.0,805.0,805.0
0.005,6,10,1779,5,928,1.0,660.0,660.0,5,851,1.0,583.0,583.0
0.005,6,10,2007,5,928,1.0,660.0,660.0,5,1079,1.0,811.0,811.0
0.006,6,13,3690,7,452,0.0,80.0,80.0,6,3238,1.0,1470.0,1459.0
0.004,17,2,162,1,65,0.0,37.0,37.0,1,97,0.0,69.0,69.0
0.01,6,10,1989,5,910,2.0,642.0,642.0,5,1079,2.0,811.0,811.0
0.003,17,2,136,1,60,0.0,32.0,32.0,1,76,0.0,48.0,48.0
169.092,17,74,10604,37,2474,4696.0,44.0,38.0,37,8130,4696.0,261.0,191.0
40.087,17,10,676,5,460,10019.0,104.0,64.0,5,216,10021.0,20.0,15.0
0.006,6,10,1547,5,764,1.0,496.0,496.0,5,783,1.0,515.0,515.0
361.859,6,21,1793,16,1030,24123.0,190.0,190.0,5,763,60010.0,462.0,247.0
15.072,17,14,9190,8,6902,2148.0,1350.0,834.0,6,2288,3008.0,1350.0,353.0
0.004,17,2,136,1,60,0.0,32.0,32.0,1,76,0.0,48.0,48.0
0.009,6,10,1972,5,910,2.0,642.0,642.0,5,1062,2.0,794.0,794.0
0.007,6,10,1990,5,911,1.0,643.0,643.0,5,1079,1.0,811.0,811.0
310.961,17,16,892,8,564,44410.0,48.0,42.0,8,328,44409.0,20.0,13.0
0.005,6,10,2007,5,928,1.0,660.0,660.0,5,1079,1.0,811.0,811.0
0.176,6,10,1506,5,395,40.0,127.0,127.0,5,1111,40.0,843.0,843.0
0.008,6,10,1989,5,910,2.0,642.0,642.0,5,1079,2.0,811.0,811.0
0.267,17,45,25798,25,21217,11.0,1350.0,820.0,20,4581,11.0,1350.0,201.0
0.114,6,10,1506,5,395,26.0,127.0,127.0,5,1111,27.0,843.0,843.0
0.006,17,2,424,1,72,0.0,44.0,44.0,1,352,0.0,324.0,324.0
0.003,17,4,284,2,120,0.0,32.0,32.0,2,164,0.0,60.0,54.0
0.072,6,10,1506,5,395,16.0,127.0,127.0,5,1111,15.0,843.0,843.0
0.122,6,10,1506,5,395,27.0,127.0,127.0,5,1111,28.0,843.0,843.0
0.024,6,10,1989,5,910,6.0,642.0,642.0,5,1079,5.0,811.0,811.0
40.057,17,10,676,5,460,10013.0,104.0,64.0,5,216,10013.0,20.0,15.0
0.005,17,2,170,1,65,0.0,37.0,37.0,1,105,0.0,77.0,77.0
0.005,6,10,1689,5,839,1.0,571.0,571.0,5,850,1.0,582.0,582.0
1.03,6,12,3134,6,2099,155.0,1328.0,923.0,6,1035,155.0,791.0,791.0
0.163,6,10,1506,5,395,37.0,127.0,127.0,5,1111,37.0,843.0,843.0
0.004,17,2,136,1,60,0.0,32.0,32.0,1,76,0.0,48.0,48.0
0.005,6,10,1989,5,927,1.0,659.0,659.0,5,1062,1.0,794.0,794.0
10.927,17,28,4398,14,2313,832.0,588.0,137.0,14,2085,832.0,268.0,120.0
0.012,6,10,1990,5,911,2.0,643.0,643.0,5,1079,2.0,811.0,811.0
11.122,17,28,4422,14,1994,843.0,269.0,114.0,14,2428,843.0,587.0,145.0
0.01,6,13,3735,7,497,1.0,125.0,125.0,6,3238,2.0,1470.0,1459.0
0.006,6,10,2006,5,927,1.0,659.0,659.0,5,1079,1.0,811.0,811.0
0.005,6,10,1689,5,839,1.0,571.0,571.0,5,850,1.0,582.0,582.0
0.012,6,10,1972,5,910,2.0,642.0,642.0,5,1062,2.0,794.0,794.0
0.013,6,10,1677,5,827,3.0,559.0,559.0,5,850,3.0,582.0,582.0
1772.62,17,120,11460,60,5460,30044.0,63.0,63.0,60,6000,30044.0,72.0,72.0
0.083,6,10,1506,5,395,18.0,127.0,127.0,5,1111,17.0,843.0,843.0
0.001,17,2,180,1,66,0.0,38.0,38.0,1,114,0.0,86.0,86.0
0.01,6,10,1983,5,910,2.0,642.0,642.0,5,1073,2.0,805.0,805.0
0.001,17,2,180,1,66,0.0,38.0,38.0,1,114,0.0,86.0,86.0
0.001,17,2,180,1,66,0.0,38.0,38.0,1,114,0.0,86.0,86.0
0.014,6,10,1990,5,911,3.0,643.0,643.0,5,1079,3.0,811.0,811.0
0.004,17,2,148,1,60,0.0,32.0,32.0,1,88,0.0,60.0,60.0
0.012,6,10,1989,5,910,3.0,642.0,642.0,5,1079,3.0,811.0,811.0
0.005,6,10,1779,5,928,1.0,660.0,660.0,5,851,1.0,583.0,583.0
0.225,6,16,2778,8,1396,32.0,533.0,324.0,8,1382,20.0,529.0,239.0
0.001,17,2,180,1,66,0.0,38.0,38.0,1,114,0.0,86.0,86.0
10.712,17,26,4103,13,1847,883.0,270.0,114.0,13,2256,883.0,587.0,145.0
1786.163,6,150,19350,90,13740,20069.0,302.0,302.0,60,5610,30273.0,83.0,83.0
0.118,6,10,1506,5,395,23.0,127.0,127.0,5,1111,24.0,843.0,843.0
0.005,17,2,170,1,65,0.0,37.0,37.0,1,105,0.0,77.0,77.0
40.07,17,10,676,5,460,10015.0,104.0,64.0,5,216,10016.0,20.0,15.0
0.009,17,2,164,1,74,0.0,46.0,46.0,1,90,0.0,62.0,62.0
0.005,6,10,2006,5,927,1.0,659.0,659.0,5,1079,1.0,811.0,811.0
0.005,6,10,2007,5,928,1.0,660.0,660.0,5,1079,1.0,811.0,811.0
0.005,6,10,2006,5,927,1.0,659.0,659.0,5,1079,1.0,811.0,811.0
0.005,6,10,2007,5,928,1.0,660.0,660.0,5,1079,1.0,811.0,811.0
0.124,6,10,1506,5,395,28.0,127.0,127.0,5,1111,27.0,843.0,843.0
0.011,6,14,3787,7,497,1.0,125.0,125.0,7,3290,1.0,1448.0,972.0
0.012,6,13,3735,7,497,2.0,125.0,125.0,6,3238,2.0,1470.0,1459.0
0.004,17,2,136,1,60,0.0,32.0,32.0,1,76,0.0,48.0,48.0
0.001,17,2,180,1,66,0.0,38.0,38.0,1,114,0.0,86.0,86.0
0.004,17,2,148,1,60,0.0,32.0,32.0,1,88,0.0,60.0,60.0
0.018,6,10,1989,5,910,4.0,642.0,642.0,5,1079,4.0,811.0,811.0
120.837,6,52,18627,30,4575,4166.0,1054.0,252.0,22,14052,5753.0,2804.0,1075.0
0.004,6,10,2006,5,927,1.0,659.0,659.0,5,1079,1.0,811.0,811.0
0.012,6,10,1989,5,910,3.0,642.0,642.0,5,1079,3.0,811.0,811.0
0.007,17,2,179,1,71,0.0,43.0,43.0,1,108,0.0,80.0,80.0
0.005,6,10,1689,5,839,1.0,571.0,571.0,5,850,1.0,582.0,582.0
0.006,6,12,1698,6,863,1.0,327.0,271.0,6,835,1.0,515.0,515.0
0.127,17,4,284,2,120,0.0,32.0,32.0,2,164,124.0,60.0,54.0
0.11,17,2,80,1,32,0.0,4.0,4.0,1,48,0.0,20.0,20.0
0.011,6,12,1926,6,1189,2.0,659.0,434.0,6,737,2.0,417.0,417.0
0.006,6,10,1547,5,764,1.0,496.0,496.0,5,783,1.0,515.0,515.0
0.013,6,10,1677,5,827,3.0,559.0,559.0,5,850,3.0,582.0,582.0
0.008,17,2,194,1,59,0.0,31.0,31.0,1,135,0.0,107.0,107.0
40.078,17,10,676,5,460,10016.0,104.0,64.0,5,216,10018.0,20.0,15.0
0.013,6,10,1677,5,827,3.0,559.0,559.0,5,850,3.0,582.0,582.0
0.069,6,10,1506,5,395,15.0,127.0,127.0,5,1111,15.0,843.0,843.0
0.006,17,2,179,1,71,0.0,43.0,43.0,1,108,0.0,80.0,80.0
0.004,6,10,1702,5,863,1.0,595.0,595.0,5,839,1.0,571.0,571.0
0.001,17,2,180,1,66,0.0,38.0,38.0,1,114,0.0,86.0,86.0
11.454,17,28,4399,14,2312,868.0,587.0,137.0,14,2087,868.0,270.0,121.0
0.007,6,14,3742,7,452,1.0,80.0,80.0,7,3290,1.0,1448.0,972.0
0.116,6,10,1506,5,395,28.0,127.0,127.0,5,1111,24.0,843.0,843.0
0.013,6,10,1631,5,848,3.0,580.0,580.0,5,783,3.0,515.0,515.0
0.006,6,10,1547,5,764,1.0,496.0,496.0,5,783,1.0,515.0,515.0
0.022,6,13,3735,7,497,3.0,125.0,125.0,6,3238,4.0,1470.0,1459.0
0.041,17,4,284,2,120,0.0,32.0,32.0,2,164,38.0,60.0,54.0
1757.857,6,557,169741,283,143544,6233.0,2883.0,841.0,274,26197,6439.0,381.0,116.0
313.532,17,20,1124,10,716,34819.0,48.0,43.0,10,408,34822.0,20.0,12.0
0.005,6,10,2000,5,927,1.0,659.0,659.0,5,1073,1.0,805.0,805.0
0.009,6,10,1689,5,839,2.0,571.0,571.0,5,850,2.0,582.0,582.0
0.011,6,10,1972,5,910,2.0,642.0,642.0,5,1062,2.0,794.0,794.0
0.005,17,2,140,1,62,0.0,34.0,34.0,1,78,0.0,50.0,50.0
0.005,6,14,3742,7,452,0.0,80.0,80.0,7,3290,0.0,1448.0,972.0
0.012,6,10,1972,5,910,3.0,642.0,642.0,5,1062,3.0,794.0,794.0
0.006,17,2,298,1,65,0.0,37.0,37.0,1,233,0.0,205.0,205.0
0.01,6,10,1989,5,910,2.0,642.0,642.0,5,1079,2.0,811.0,811.0
0.003,17,2,136,1,60,0.0,32.0,32.0,1,76,0.0,48.0,48.0
0.012,6,10,1983,5,910,3.0,642.0,642.0,5,1073,3.0,805.0,805.0
40.05,17,10,676,5,460,10010.0,104.0,64.0,5,216,10011.0,20.0,15.0
0.006,6,10,2000,5,927,1.0,659.0,659.0,5,1073,1.0,805.0,805.0
40.059,17,10,676,5,460,10013.0,104.0,64.0,5,216,10014.0,20.0,15.0
40.056,17,10,676,5,460,10013.0,104.0,64.0,5,216,10013.0,20.0,15.0
0.106,6,10,1506,5,395,25.0,127.0,127.0,5,1111,23.0,843.0,843.0
0.083,6,10,1506,5,395,18.0,127.0,127.0,5,1111,17.0,843.0,843.0
0.004,6,14,3742,7,452,0.0,80.0,80.0,7,3290,0.0,1448.0,972.0
291.658,6,390,349872,193,22923,1519.0,2736.0,919.0,197,326949,1488.0,2804.0,1749.0
0.009,6,13,3747,7,509,1.0,137.0,137.0,6,3238,1.0,1470.0,1459.0
1755.901,6,105,6270,60,3525,29760.0,27.0,27.0,45,2745,39905.0,27.0,27.0
0.004,17,2,148,1,60,0.0,32.0,32.0,1,88,0.0,60.0,60.0
1727.908,6,51,3124,32,1875,55738.0,35.0,35.0,19,1249,95990.0,31.0,31.0
0.006,6,10,1547,5,764,1.0,496.0,496.0,5,783,1.0,515.0,515.0
0.039,17,2,412,1,61,0.0,33.0,33.0,1,351,0.0,323.0,323.0
0.011,6,10,2000,5,927,2.0,659.0,659.0,5,1073,2.0,805.0,805.0
0.006,6,13,3690,7,452,0.0,80.0,80.0,6,3238,1.0,1470.0,1459.0
0.047,6,10,1506,5,395,11.0,127.0,127.0,5,1111,10.0,843.0,843.0
0.011,6,10,1989,5,910,2.0,642.0,642.0,5,1079,2.0,811.0,811.0
0.019,6,10,1972,5,910,4.0,642.0,642.0,5,1062,4.0,794.0,794.0
0.007,6,10,1990,5,911,1.0,643.0,643.0,5,1079,1.0,811.0,811.0
0.006,6,10,1547,5,764,1.0,496.0,496.0,5,783,1.0,515.0,515.0
0.007,6,10,2007,5,928,1.0,660.0,660.0,5,1079,1.0,811.0,811.0
0.012,6,10,1605,5,388,3.0,120.0,120.0,5,1217,3.0,949.0,949.0
9.035,17,6,376,5,280,2258.0,28.0,28.0,1,96,0.0,68.0,68.0
0.004,6,10,1702,5,863,0.0,595.0,595.0,5,839,1.0,571.0,571.0
0.017,6,10,1762,5,911,4.0,643.0,643.0,5,851,4.0,583.0,583.0
0.001,17,2,154,1,69,0.0,41.0,41.0,1,85,0.0,57.0,57.0
0.179,6,3,453,2,321,179.0,241.0,241.0,1,132,0.0,92.0,92.0
0.015,6,10,1990,5,911,3.0,643.0,643.0,5,1079,3.0,811.0,811.0
0.005,6,10,1643,5,860,1.0,592.0,592.0,5,783,1.0,515.0,515.0
0.004,6,10,2006,5,927,1.0,659.0,659.0,5,1079,1.0,811.0,811.0
0.009,6,12,1926,6,1189,1.0,659.0,434.0,6,737,1.0,417.0,417.0
0.005,6,10,1779,5,928,1.0,660.0,660.0,5,851,1.0,583.0,583.0
352.244,6,20,2210,6,1308,12003.0,494.0,494.0,14,902,27095.0,83.0,83.0
0.005,6,10,1643,5,860,1.0,592.0,592.0,5,783,1.0,515.0,515.0
0.066,17,8,3613,4,1874,22.0,1350.0,440.0,4,1739,10.0,1350.0,406.0
0.004,6,10,2006,5,927,1.0,659.0,659.0,5,1079,1.0,811.0,811.0
0.008,6,10,1989,5,910,2.0,642.0,642.0,5,1079,2.0,811.0,811.0
0.003,17,2,148,1,60,0.0,32.0,32.0,1,88,0.0,60.0,60.0
0.728,6,22,5072,11,1250,63.0,325.0,133.0,11,3822,62.0,1414.0,563.0
11.289,17,28,4421,14,1994,855.0,269.0,114.0,14,2427,855.0,586.0,145.0
0.008,6,10,1989,5,910,2.0,642.0,642.0,5,1079,2.0,811.0,811.0
0.003,17,2,136,1,60,0.0,32.0,32.0,1,76,0.0,48.0,48.0
0.076,6,10,1506,5,395,15.0,127.0,127.0,5,1111,15.0,843.0,843.0
0.006,6,10,1547,5,764,1.0,496.0,496.0,5,783,1.0,515.0,515.0
0.01,6,10,1972,5,910,2.0,642.0,642.0,5,1062,2.0,794.0,794.0
0.048,6,10,1762,5,911,12.0,643.0,643.0,5,851,11.0,583.0,583.0
0.005,6,10,2006,5,927,1.0,659.0,659.0,5,1079,1.0,811.0,811.0
11.513,17,28,4400,14,2313,873.0,588.0,137.0,14,2087,873.0,270.0,121.0
0.004,6,10,1774,5,923,1.0,655.0,655.0,5,851,1.0,583.0,583.0
0.013,17,2,152,1,56,0.0,28.0,28.0,1,96,0.0,68.0,68.0
0.004,6,10,1779,5,928,1.0,660.0,660.0,5,851,0.0,583.0,583.0
0.006,17,2,214,1,75,0.0,47.0,47.0,1,139,0.0,111.0,111.0
0.086,6,10,1506,5,395,19.0,127.0,127.0,5,1111,19.0,843.0,843.0
0.005,6,10,2007,5,928,1.0,660.0,660.0,5,1079,1.0,811.0,811.0
0.133,6,10,1506,5,395,30.0,127.0,127.0,5,1111,29.0,843.0,843.0
0.038,17,2,148,1,60,0.0,32.0,32.0,1,88,0.0,60.0,60.0
0.001,17,2,166,1,75,0.0,47.0,47.0,1,91,0.0,63.0,63.0
0.04,17,4,284,2,120,1.0,32.0,32.0,2,164,36.0,60.0,54.0
0.006,6,10,1547,5,764,1.0,496.0,496.0,5,783,1.0,515.0,515.0
240.123,6,16,4481,9,963,30015.0,238.0,166.0,7,3518,40018.0,1402.0,786.0
0.008,6,10,2007,5,928,2.0,660.0,660.0,5,1079,2.0,811.0,811.0
0.076,6,10,1506,5,395,17.0,127.0,127.0,5,1111,18.0,843.0,843.0
0.037,17,4,284,2,120,0.0,32.0,32.0,2,164,34.0,60.0,54.0
240.247,6,29,10821,15,4948,17160.0,1368.0,693.0,14,5873,18480.0,1657.0,733.0
1796.781,17,2612,196478,1298,103967,1385.0,82.0,52.0,1314,92511,1368.0,226.0,42.0
0.213,17,4,352,2,130,143.0,37.0,37.0,2,222,174.0,89.0,83.0
40.07,17,10,676,5,460,10016.0,104.0,64.0,5,216,10016.0,20.0,15.0
0.008,6,10,1990,5,911,2.0,643.0,643.0,5,1079,2.0,811.0,811.0
0.202,6,16,2669,8,1395,28.0,533.0,323.0,8,1274,18.0,529.0,212.0
15.072,17,15,9238,8,6902,2149.0,1350.0,834.0,7,2336,2507.0,1350.0,305.0
0.006,17,2,230,1,68,0.0,40.0,40.0,1,162,0.0,134.0,134.0
0.024,6,10,1972,5,910,6.0,642.0,642.0,5,1062,5.0,794.0,794.0
40.063,17,10,676,5,460,10015.0,104.0,64.0,5,216,10015.0,20.0,15.0
0.005,6,10,1643,5,860,1.0,592.0,592.0,5,783,1.0,515.0,515.0
0.072,17,2,136,1,60,0.0,32.0,32.0,1,76,0.0,48.0,48.0
0.11,6,10,1506,5,395,24.0,127.0,127.0,5,1111,23.0,843.0,843.0
0.005,6,10,2006,5,927,1.0,659.0,659.0,5,1079,1.0,811.0,811.0
0.081,6,10,1506,5,395,19.0,127.0,127.0,5,1111,17.0,843.0,843.0
0.719,6,22,5072,11,1250,61.0,325.0,133.0,11,3822,61.0,1414.0,563.0
0.103,6,10,1506,5,395,23.0,127.0,127.0,5,1111,18.0,843.0,843.0
0.012,6,10,1983,5,910,2.0,642.0,642.0,5,1073,3.0,805.0,805.0
0.003,17,4,284,2,120,0.0,32.0,32.0,2,164,0.0,60.0,54.0
0.006,6,10,1547,5,764,1.0,496.0,496.0,5,783,1.0,515.0,515.0
1.599,6,11,989,7,479,266.0,107.0,107.0,4,510,444.0,294.0,294.0
0.004,6,11,2041,6,979,0.0,659.0,659.0,5,1062,1.0,794.0,794.0
120.672,6,39,8864,23,2852,5485.0,593.0,165.0,16,6012,8044.0,2694.0,738.0
0.01,6,13,3735,7,497,1.0,125.0,125.0,6,3238,2.0,1470.0,1459.0
1786.329,6,150,19350,90,13740,20071.0,302.0,302.0,60,5610,30276.0,83.0,83.0
0.005,17,2,170,1,65,0.0,37.0,37.0,1,105,0.0,77.0,77.0
0.008,6,10,1990,5,911,2.0,643.0,643.0,5,1079,1.0,811.0,811.0
0.1,6,10,1506,5,395,23.0,127.0,127.0,5,1111,23.0,843.0,843.0
0.122,6,10,1506,5,395,28.0,127.0,127.0,5,1111,24.0,843.0,843.0
0.004,17,2,136,1,60,0.0,32.0,32.0,1,76,0.0,48.0,48.0
0.004,17,2,412,1,61,0.0,33.0,33.0,1,351,0.0,323.0,323.0
0.008,6,10,1989,5,927,2.0,659.0,659.0,5,1062,2.0,794.0,794.0
0.005,6,10,2000,5,927,1.0,659.0,659.0,5,1073,1.0,805.0,805.0
0.004,6,10,1774,5,923,1.0,655.0,655.0,5,851,1.0,583.0,583.0
0.11,6,10,1506,5,395,24.0,127.0,127.0,5,1111,23.0,843.0,843.0
0.007,6,10,1547,5,764,1.0,496.0,496.0,5,783,1.0,515.0,515.0
0.107,6,10,1506,5,395,20.0,127.0,127.0,5,1111,23.0,843.0,843.0
1500.87,6,69,22109,36,8430,42882.0,1073.0,545.0,33,13679,45026.0,1402.0,597.0
366.197,6,22,2313,16,867,24413.0,195.0,195.0,6,1446,4641.0,419.0,398.0
0.003,17,4,284,2,120,0.0,32.0,32.0,2,164,1.0,60.0,54.0
0.177,6,3,453,2,321,177.0,241.0,241.0,1,132,0.0,92.0,92.0
0.013,6,13,3735,7,497,2.0,125.0,125.0,6,3238,2.0,1470.0,1459.0
24.61,6,36,8190,18,1719,527.0,651.0,322.0,18,6471,1439.0,2720.0,478.0
240.094,6,21,4926,12,993,21826.0,180.0,93.0,9,3933,30011.0,1593.0,576.0
1788.71,6,292,42717,121,25248,14904.0,2720.0,214.0,171,17469,10521.0,1360.0,131.0
0.004,17,2,194,1,57,0.0,29.0,29.0,1,137,0.0,109.0,109.0
0.165,6,10,1506,5,395,40.0,127.0,127.0,5,1111,28.0,843.0,843.0
11.206,17,28,4418,14,1994,848.0,269.0,114.0,14,2424,848.0,587.0,145.0
0.008,6,10,2006,5,927,1.0,659.0,659.0,5,1079,2.0,811.0,811.0
324.21,17,20,1124,10,716,36014.0,48.0,43.0,10,408,36011.0,20.0,12.0
0.071,17,8,3613,4,1874,23.0,1350.0,440.0,4,1739,12.0,1350.0,406.0
177.183,17,70,9977,35,2338,5211.0,44.0,38.0,35,7639,5211.0,239.0,190.0
0.001,17,2,136,1,60,0.0,32.0,32.0,1,76,0.0,48.0,48.0
0.104,6,10,1506,5,395,23.0,127.0,127.0,5,1111,22.0,843.0,843.0
0.014,6,10,1972,5,910,3.0,642.0,642.0,5,1062,3.0,794.0,794.0
0.057,6,10,1506,5,395,13.0,127.0,127.0,5,1111,13.0,843.0,843.0
0.004,6,10,1989,5,927,1.0,659.0,659.0,5,1062,1.0,794.0,794.0
0.005,6,10,2006,5,927,1.0,659.0,659.0,5,1079,1.0,811.0,811.0
0.086,6,10,1506,5,395,17.0,127.0,127.0,5,1111,18.0,843.0,843.0
0.209,6,10,1506,5,395,48.0,127.0,127.0,5,1111,44.0,843.0,843.0
0.069,6,10,1506,5,395,14.0,127.0,127.0,5,1111,15.0,843.0,843.0
0.08,6,10,1506,5,395,16.0,127.0,127.0,5,1111,17.0,843.0,843.0
0.008,17,4,284,2,120,5.0,32.0,32.0,2,164,5.0,60.0,54.0
0.004,6,10,2007,5,928,1.0,660.0,660.0,5,1079,1.0,811.0,811.0
0.005,17,2,136,1,60,0.0,32.0,32.0,1,76,0.0,48.0,48.0
0.004,6,10,1702,5,863,1.0,595.0,595.0,5,839,1.0,571.0,571.0
0.116,17,2,179,1,71,0.0,43.0,43.0,1,108,0.0,80.0,80.0
0.014,6,10,1972,5,910,3.0,642.0,642.0,5,1062,3.0,794.0,794.0
0.005,6,10,2007,5,928,1.0,660.0,660.0,5,1079,1.0,811.0,811.0
0.005,6,10,1779,5,928,1.0,660.0,660.0,5,851,1.0,583.0,583.0
0.009,6,10,1989,5,910,2.0,642.0,642.0,5,1079,2.0,811.0,811.0
0.089,6,10,1506,5,395,19.0,127.0,127.0,5,1111,18.0,843.0,843.0
0.018,6,10,1972,5,910,4.0,642.0,642.0,5,1062,4.0,794.0,794.0
0.001,17,2,180,1,66,0.0,38.0,38.0,1,114,0.0,86.0,86.0
0.005,17,2,140,1,62,0.0,34.0,34.0,1,78,0.0,50.0,50.0
0.005,6,10,2007,5,928,1.0,660.0,660.0,5,1079,1.0,811.0,811.0
0.004,17,2,148,1,60,0.0,32.0,32.0,1,88,0.0,60.0,60.0
0.005,6,10,2000,5,927,1.0,659.0,659.0,5,1073,1.0,805.0,805.0
0.066,17,8,3613,4,1874,22.0,1350.0,440.0,4,1739,11.0,1350.0,406.0
0.004,17,2,142,1,63,0.0,35.0,35.0,1,79,0.0,51.0,51.0
0.005,6,13,3747,7,509,0.0,137.0,137.0,6,3238,0.0,1470.0,1459.0
159.075,17,76,10834,38,2530,4299.0,44.0,38.0,38,8304,4299.0,239.0,190.0
0.005,17,2,164,1,74,0.0,46.0,46.0,1,90,0.0,62.0,62.0
0.005,6,10,1989,5,927,1.0,659.0,659.0,5,1062,1.0,794.0,794.0
240.142,6,31,9323,15,6923,17153.0,2048.0,683.0,16,2400,16008.0,580.0,195.0
0.005,6,10,1689,5,839,1.0,571.0,571.0,5,850,1.0,582.0,582.0
0.005,17,2,170,1,65,0.0,37.0,37.0,1,105,0.0,77.0,77.0
0.011,6,10,1972,5,910,2.0,642.0,642.0,5,1062,2.0,794.0,794.0
0.088,6,10,1506,5,395,21.0,127.0,127.0,5,1111,18.0,843.0,843.0
15.074,17,14,9190,8,6902,2149.0,1350.0,834.0,6,2288,3008.0,1350.0,353.0
0.039,17,4,284,2,120,0.0,32.0,32.0,2,164,32.0,60.0,54.0
0.006,6,10,1547,5,764,1.0,496.0,496.0,5,783,1.0,515.0,515.0
40.066,17,10,676,5,460,10015.0,104.0,64.0,5,216,10015.0,20.0,15.0
366.432,6,30,6180,19,4936,20357.0,494.0,494.0,11,1244,36642.0,83.0,83.0
0.005,6,10,2000,5,927,1.0,659.0,659.0,5,1073,1.0,805.0,805.0
0.009,6,10,1972,5,910,2.0,642.0,642.0,5,1062,2.0,794.0,794.0
0.011,6,10,1972,5,910,2.0,642.0,642.0,5,1062,2.0,794.0,794.0
0.005,6,10,1989,5,927,1.0,659.0,659.0,5,1062,1.0,794.0,794.0
0.014,6,10,1689,5,839,3.0,571.0,571.0,5,850,3.0,582.0,582.0
0.002,17,2,166,1,75,0.0,47.0,47.0,1,91,0.0,63.0,63.0
0.005,6,10,1547,5,764,1.0,496.0,496.0,5,783,1.0,515.0,515.0
0.009,6,10,1972,5,910,2.0,642.0,642.0,5,1062,2.0,794.0,794.0
0.004,17,2,148,1,60,0.0,32.0,32.0,1,88,0.0,60.0,60.0
252.444,6,19,4727,9,2112,31555.0,909.0,549.0,10,2615,28049.0,1162.0,417.0
0.075,6,10,1506,5,395,16.0,127.0,127.0,5,1111,17.0,843.0,843.0
0.004,6,10,1702,5,863,1.0,595.0,595.0,5,839,1.0,571.0,571.0
177.078,17,76,10783,38,2529,4785.0,44.0,38.0,38,8254,4785.0,261.0,189.0
0.005,6,10,2006,5,927,1.0,659.0,659.0,5,1079,1.0,811.0,811.0
0.076,6,10,1506,5,395,17.0,127.0,127.0,5,1111,17.0,843.0,843.0
0.006,6,10,1547,5,764,1.0,496.0,496.0,5,783,1.0,515.0,515.0
0.006,6,10,1774,5,923,1.0,655.0,655.0,5,851,1.0,583.0,583.0
390.631,6,22,2313,16,867,26042.0,195.0,195.0,6,1446,4663.0,419.0,398.0
0.044,17,2,152,1,76,0.0,48.0,48.0,1,76,0.0,48.0,48.0
0.229,6,16,2670,8,1396,32.0,533.0,324.0,8,1274,21.0,529.0,212.0
0.007,6,10,1689,5,839,1.0,571.0,571.0,5,850,1.0,582.0,582.0
0.01,6,10,1762,5,911,2.0,643.0,643.0,5,851,2.0,583.0,583.0
0.015,6,13,3735,7,497,2.0,125.0,125.0,6,3238,3.0,1470.0,1459.0
0.011,6,10,1983,5,910,2.0,642.0,642.0,5,1073,2.0,805.0,805.0
0.005,6,10,1989,5,927,1.0,659.0,659.0,5,1062,1.0,794.0,794.0
0.006,6,10,1643,5,860,1.0,592.0,592.0,5,783,1.0,515.0,515.0
0.005,6,10,1547,5,764,1.0,496.0,496.0,5,783,1.0,515.0,515.0
0.008,6,10,1972,5,910,2.0,642.0,642.0,5,1062,2.0,794.0,794.0
0.001,17,2,140,1,62,0.0,34.0,34.0,1,78,0.0,50.0,50.0
0.013,6,10,1989,5,910,3.0,642.0,642.0,5,1079,3.0,811.0,811.0
0.004,17,2,148,1,60,0.0,32.0,32.0,1,88,0.0,60.0,60.0
0.004,6,10,2006,5,927,1.0,659.0,659.0,5,1079,1.0,811.0,811.0
0.005,6,10,2007,5,928,1.0,660.0,660.0,5,1079,1.0,811.0,811.0
0.086,6,10,1506,5,395,19.0,127.0,127.0,5,1111,21.0,843.0,843.0
40.068,17,10,676,5,460,10015.0,104.0,64.0,5,216,10016.0,20.0,15.0
0.001,17,2,180,1,66,0.0,38.0,38.0,1,114,0.0,86.0,86.0
0.037,17,2,152,1,76,0.0,48.0,48.0,1,76,0.0,48.0,48.0
10.957,17,28,4417,14,1994,832.0,269.0,114.0,14,2423,834.0,586.0,145.0
0.003,17,4,284,2,120,0.0,32.0,32.0,2,164,0.0,60.0,54.0
0.013,6,10,1631,5,848,3.0,580.0,580.0,5,783,3.0,515.0,515.0
0.005,6,10,1547,5,764,1.0,496.0,496.0,5,783,1.0,515.0,515.0
0.005,17,2,144,1,64,0.0,36.0,36.0,1,80,0.0,52.0,52.0
0.006,6,10,2007,5,928,1.0,660.0,660.0,5,1079,1.0,811.0,811.0
15.071,17,15,9238,8,6902,2149.0,1350.0,834.0,7,2336,2507.0,1350.0,305.0
0.01,6,10,1989,5,910,2.0,642.0,642.0,5,1079,2.0,811.0,811.0
240.016,6,9,787,5,488,60004.0,232.0,232.0,4,299,80004.0,83.0,83.0
0.097,6,10,1506,5,395,21.0,127.0,127.0,5,1111,23.0,843.0,843.0
361.809,6,19,1689,15,978,25843.0,190.0,190.0,4,711,80013.0,495.0,495.0
0.001,17,2,166,1,75,0.0,47.0,47.0,1,91,0.0,63.0,63.0
0.02,6,10,1989,5,910,5.0,642.0,642.0,5,1079,5.0,811.0,811.0
0.005,17,2,148,1,60,0.0,32.0,32.0,1,88,0.0,60.0,60.0
0.083,6,10,1506,5,395,18.0,127.0,127.0,5,1111,17.0,843.0,843.0
40.057,17,10,676,5,460,10013.0,104.0,64.0,5,216,10013.0,20.0,15.0
0.004,6,10,1989,5,927,1.0,659.0,659.0,5,1062,1.0,794.0,794.0
0.08,6,10,1506,5,395,17.0,127.0,127.0,5,1111,18.0,843.0,843.0
0.006,17,2,209,1,64,0.0,36.0,36.0,1,145,0.0,117.0,117.0
0.095,6,10,1506,5,395,23.0,127.0,127.0,5,1111,20.0,843.0,843.0
0.094,6,10,1506,5,395,21.0,127.0,127.0,5,1111,21.0,843.0,843.0
0.086,6,10,1506,5,395,18.0,127.0,127.0,5,1111,20.0,843.0,843.0
0.014,6,10,1631,5,848,3.0,580.0,580.0,5,783,3.0,515.0,515.0
0.005,6,10,2000,5,927,1.0,659.0,659.0,5,1073,1.0,805.0,805.0
0.131,17,2,182,1,65,0.0,37.0,37.0,1,117,0.0,89.0,89.0
0.005,6,10,2000,5,927,1.0,659.0,659.0,5,1073,1.0,805.0,805.0
0.001,17,2,180,1,66,0.0,38.0,38.0,1,114,0.0,86.0,86.0
0.006,6,10,2007,5,928,1.0,660.0,660.0,5,1079,1.0,811.0,811.0
0.01,6,10,1677,5,827,2.0,559.0,559.0,5,850,2.0,582.0,582.0
0.005,6,10,2007,5,928,1.0,660.0,660.0,5,1079,1.0,811.0,811.0
0.006,6,10,2000,5,927,1.0,659.0,659.0,5,1073,1.0,805.0,805.0
0.009,6,10,1762,5,911,2.0,643.0,643.0,5,851,2.0,583.0,583.0
40.053,17,10,676,5,460,10012.0,104.0,64.0,5,216,10012.0,20.0,15.0
0.121,6,10,1506,5,395,22.0,127.0,127.0,5,1111,27.0,843.0,843.0
0.01,6,10,1677,5,827,2.0,559.0,559.0,5,850,2.0,582.0,582.0
0.005,6,10,2007,5,928,1.0,660.0,660.0,5,1079,1.0,811.0,811.0
0.021,6,10,1972,5,910,5.0,642.0,642.0,5,1062,5.0,794.0,794.0
0.004,6,10,2006,5,927,1.0,659.0,659.0,5,1079,1.0,811.0,811.0
0.005,17,2,170,1,65,0.0,37.0,37.0,1,105,0.0,77.0,77.0
0.073,17,8,3613,4,1874,24.0,1350.0,440.0,4,1739,12.0,1350.0,406.0
0.071,17,2,182,1,65,0.0,37.0,37.0,1,117,0.0,89.0,89.0
308.569,17,20,1124,10,716,34271.0,48.0,43.0,10,408,34271.0,20.0,12.0
0.085,6,10,1506,5,395,17.0,127.0,127.0,5,1111,17.0,843.0,843.0
0.012,6,10,1972,5,910,2.0,642.0,642.0,5,1062,3.0,794.0,794.0
0.004,6,10,1989,5,927,1.0,659.0,659.0,5,1062,1.0,794.0,794.0
0.018,6,10,1989,5,910,4.0,642.0,642.0,5,1079,4.0,811.0,811.0
0.808,6,25,5555,12,1445,62.0,267.0,136.0,13,4110,56.0,1414.0,597.0
1757.112,6,455,65688,252,35168,7000.0,613.0,197.0,203,30520,8698.0,453.0,142.0
300.695,6,34,6335,19,1409,16705.0,267.0,154.0,15,4926,609.0,1823.0,392.0
0.074,6,10,1506,5,395,15.0,127.0,127.0,5,1111,16.0,843.0,843.0
0.001,17,2,180,1,65,0.0,37.0,37.0,1,115,0.0,87.0,87.0
240.023,6,9,787,5,488,60005.0,232.0,232.0,4,299,80006.0,83.0,83.0
0.093,6,10,1506,5,395,21.0,127.0,127.0,5,1111,19.0,843.0,843.0
0.088,6,10,1506,5,395,20.0,127.0,127.0,5,1111,20.0,843.0,843.0
0.103,6,10,1506,5,395,23.0,127.0,127.0,5,1111,23.0,843.0,843.0
0.005,6,10,2006,5,927,1.0,659.0,659.0,5,1079,1.0,811.0,811.0
0.004,6,10,1774,5,923,1.0,655.0,655.0,5,851,1.0,583.0,583.0
0.029,6,13,3735,7,497,4.0,125.0,125.0,6,3238,5.0,1470.0,1459.0
0.01,6,10,1989,5,910,2.0,642.0,642.0,5,1079,2.0,811.0,811.0
0.072,17,4,420,2,122,0.0,33.0,33.0,2,298,67.0,145.0,121.0
10.924,17,28,4421,14,1994,831.0,269.0,114.0,14,2427,831.0,586.0,145.0
368.947,6,24,2405,17,919,23059.0,195.0,195.0,7,1486,3902.0,419.0,398.0
0.06,6,10,1506,5,395,14.0,127.0,127.0,5,1111,12.0,843.0,843.0
0.014,6,10,1989,5,910,3.0,642.0,642.0,5,1079,3.0,811.0,811.0
0.129,17,2,148,1,60,0.0,32.0,32.0,1,88,0.0,60.0,60.0
0.005,6,10,2000,5,927,1.0,659.0,659.0,5,1073,1.0,805.0,805.0
0.008,6,13,3735,7,497,1.0,125.0,125.0,6,3238,1.0,1470.0,1459.0
0.005,17,2,169,1,62,0.0,34.0,34.0,1,107,0.0,79.0,79.0
0.016,6,10,1989,5,910,3.0,642.0,642.0,5,1079,4.0,811.0,811.0
0.005,6,10,2007,5,928,1.0,660.0,660.0,5,1079,1.0,811.0,811.0
0.003,17,4,284,2,120,0.0,32.0,32.0,2,164,0.0,60.0,54.0
0.008,6,10,2006,5,927,2.0,659.0,659.0,5,1079,1.0,811.0,811.0
0.005,6,10,1547,5,764,1.0,496.0,496.0,5,783,1.0,515.0,515.0
0.01,6,10,1990,5,911,2.0,643.0,643.0,5,1079,2.0,811.0,811.0
0.001,17,2,180,1,66,0.0,38.0,38.0,1,114,0.0,86.0,86.0
0.081,6,10,1506,5,395,18.0,127.0,127.0,5,1111,19.0,843.0,843.0
0.126,6,10,1506,5,395,27.0,127.0,127.0,5,1111,27.0,843.0,843.0
0.01,6,10,1972,5,910,2.0,642.0,642.0,5,1062,2.0,794.0,794.0
0.108,6,10,1506,5,395,23.0,127.0,127.0,5,1111,25.0,843.0,843.0
0.111,6,10,1506,5,395,25.0,127.0,127.0,5,1111,24.0,843.0,843.0
0.011,6,10,1989,5,910,2.0,642.0,642.0,5,1079,2.0,811.0,811.0
0.004,6,10,2006,5,927,1.0,659.0,659.0,5,1079,1.0,811.0,811.0
0.013,6,10,1989,5,910,3.0,642.0,642.0,5,1079,3.0,811.0,811.0
0.001,17,2,136,1,60,0.0,32.0,32.0,1,76,0.0,48.0,48.0
0.004,17,2,148,1,60,0.0,32.0,32.0,1,88,0.0,60.0,60.0
0.004,17,2,148,1,60,0.0,32.0,32.0,1,88,0.0,60.0,60.0
0.116,6,10,1506,5,395,28.0,127.0,127.0,5,1111,26.0,843.0,843.0
0.001,17,2,180,1,66,0.0,38.0,38.0,1,114,0.0,86.0,86.0
0.005,6,10,1779,5,928,1.0,660.0,660.0,5,851,1.0,583.0,583.0
300.161,6,39,12453,20,6895,15789.0,4080.0,1212.0,19,5558,16666.0,2667.0,435.0
178.148,17,98,13887,49,3303,3711.0,44.0,39.0,49,10584,3711.0,239.0,188.0
0.005,17,2,170,1,65,0.0,37.0,37.0,1,105,0.0,77.0,77.0
0.001,17,2,179,1,62,0.0,34.0,34.0,1,117,0.0,89.0,89.0
0.011,6,10,1972,5,910,2.0,642.0,642.0,5,1062,2.0,794.0,794.0
0.011,6,10,1989,5,910,2.0,642.0,642.0,5,1079,2.0,811.0,811.0
0.014,6,10,1989,5,910,3.0,642.0,642.0,5,1079,3.0,811.0,811.0
0.053,17,2,152,1,76,0.0,48.0,48.0,1,76,0.0,48.0,48.0
0.095,6,10,1506,5,395,20.0,127.0,127.0,5,1111,21.0,843.0,843.0
177.039,17,86,12345,43,2900,4215.0,44.0,39.0,43,9445,4215.0,239.0,191.0
0.039,17,4,352,2,130,0.0,37.0,37.0,2,222,35.0,89.0,83.0
0.004,17,2,136,1,60,0.0,32.0,32.0,1,76,0.0,48.0,48.0
0.008,6,10,1643,5,860,2.0,592.0,592.0,5,783,1.0,515.0,515.0
0.009,6,10,1631,5,848,2.0,580.0,580.0,5,783,2.0,515.0,515.0
0.005,6,10,1989,5,927,1.0,659.0,659.0,5,1062,1.0,794.0,794.0
0.08,17,8,3613,4,1874,26.0,1350.0,440.0,4,1739,13.0,1350.0,406.0
0.005,17,2,170,1,65,0.0,37.0,37.0,1,105,0.0,77.0,77.0
0.159,6,10,1506,5,395,39.0,127.0,127.0,5,1111,37.0,843.0,843.0
0.017,6,13,3735,7,497,2.0,125.0,125.0,6,3238,3.0,1470.0,1459.0
0.01,6,10,1547,5,764,2.0,496.0,496.0,5,783,2.0,515.0,515.0
0.091,6,10,1506,5,395,19.0,127.0,127.0,5,1111,20.0,843.0,843.0
0.004,6,10,2006,5,927,1.0,659.0,659.0,5,1079,1.0,811.0,811.0
0.005,17,2,214,1,75,0.0,47.0,47.0,1,139,0.0,111.0,111.0
0.005,17,2,144,1,64,0.0,36.0,36.0,1,80,0.0,52.0,52.0
0.001,17,2,180,1,65,0.0,37.0,37.0,1,115,0.0,87.0,87.0
178.28,17,72,10467,36,2399,5093.0,44.0,38.0,36,8068,5093.0,260.0,196.0
0.101,6,10,1506,5,395,20.0,127.0,127.0,5,1111,23.0,843.0,843.0
0.013,6,13,3735,7,497,2.0,125.0,125.0,6,3238,2.0,1470.0,1459.0
0.006,6,10,2006,5,927,1.0,659.0,659.0,5,1079,1.0,811.0,811.0
0.006,6,10,1547,5,764,1.0,496.0,496.0,5,783,1.0,515.0,515.0
0.097,6,10,1506,5,395,21.0,127.0,127.0,5,1111,21.0,843.0,843.0
0.001,17,2,180,1,66,0.0,38.0,38.0,1,114,0.0,86.0,86.0
0.008,6,10,1989,5,927,2.0,659.0,659.0,5,1062,2.0,794.0,794.0
0.005,6,10,1643,5,860,1.0,592.0,592.0,5,783,1.0,515.0,515.0
0.012,6,10,1677,5,827,3.0,559.0,559.0,5,850,2.0,582.0,582.0
0.012,6,10,1989,5,910,2.0,642.0,642.0,5,1079,3.0,811.0,811.0
0.075,6,10,1506,5,395,16.0,127.0,127.0,5,1111,16.0,843.0,843.0
0.169,17,2,152,1,76,0.0,48.0,48.0,1,76,0.0,48.0,48.0
0.158,6,10,1506,5,395,37.0,127.0,127.0,5,1111,34.0,843.0,843.0
30.168,6,27,5963,15,1928,2154.0,517.0,260.0,12,4035,2742.0,1330.0,590.0
0.005,6,10,1547,5,764,1.0,496.0,496.0,5,783,1.0,515.0,515.0
0.038,17,4,336,2,124,0.0,34.0,34.0,2,212,1.0,84.0,78.0
0.004,17,2,136,1,60,0.0,32.0,32.0,1,76,0.0,48.0,48.0
0.04,17,4,284,2,120,0.0,32.0,32.0,2,164,1.0,60.0,54.0
10.905,17,28,4423,14,1994,830.0,269.0,114.0,14,2429,830.0,588.0,145.0
0.117,6,10,1506,5,395,28.0,127.0,127.0,5,1111,26.0,843.0,843.0
0.021,6,10,1990,5,911,5.0,643.0,643.0,5,1079,5.0,811.0,811.0
0.095,6,10,1506,5,395,19.0,127.0,127.0,5,1111,22.0,843.0,843.0
0.004,6,10,2007,5,928,1.0,660.0,660.0,5,1079,1.0,811.0,811.0
40.074,17,10,676,5,460,10017.0,104.0,64.0,5,216,10017.0,20.0,15.0
0.018,6,10,1605,5,388,4.0,120.0,120.0,5,1217,4.0,949.0,949.0
0.068,17,8,3613,4,1874,22.0,1350.0,440.0,4,1739,11.0,1350.0,406.0
0.005,6,10,1643,5,860,1.0,592.0,592.0,5,783,1.0,515.0,515.0
0.004,6,10,1779,5,928,1.0,660.0,660.0,5,851,1.0,583.0,583.0
0.073,6,10,1506,5,395,17.0,127.0,127.0,5,1111,14.0,843.0,843.0
0.005,6,10,2007,5,928,1.0,660.0,660.0,5,1079,1.0,811.0,811.0
0.043,17,2,148,1,60,0.0,32.0,32.0,1,88,0.0,60.0,60.0
0.004,6,10,2000,5,927,1.0,659.0,659.0,5,1073,1.0,805.0,805.0
301.051,6,46,16808,24,10901,13089.0,2720.0,1238.0,22,5907,423.0,2667.0,385.0
0.171,17,2,152,1,76,0.0,48.0,48.0,1,76,0.0,48.0,48.0
0.005,17,2,180,1,66,0.0,38.0,38.0,1,114,0.0,86.0,86.0
0.004,17,2,148,1,60,0.0,32.0,32.0,1,88,0.0,60.0,60.0
0.023,6,10,1983,5,910,5.0,642.0,642.0,5,1073,5.0,805.0,805.0
0.005,6,10,1702,5,863,1.0,595.0,595.0,5,839,1.0,571.0,571.0
0.005,6,13,3690,7,452,0.0,80.0,80.0,6,3238,0.0,1470.0,1459.0
0.011,6,10,1972,5,910,2.0,642.0,642.0,5,1062,2.0,794.0,794.0
0.218,6,16,2670,8,1396,31.0,533.0,324.0,8,1274,20.0,529.0,212.0
0.004,17,2,136,1,60,0.0,32.0,32.0,1,76,0.0,48.0,48.0
0.001,17,2,180,1,66,0.0,38.0,38.0,1,114,0.0,86.0,86.0
0.005,6,10,2006,5,927,1.0,659.0,659.0,5,1079,1.0,811.0,811.0
0.011,6,10,1972,5,910,2.0,642.0,642.0,5,1062,2.0,794.0,794.0
240.076,6,16,4481,9,963,30009.0,238.0,166.0,7,3518,40012.0,1402.0,786.0
0.001,17,2,164,1,74,0.0,46.0,46.0,1,90,0.0,62.0,62.0
0.081,6,10,1506,5,395,17.0,127.0,127.0,5,1111,18.0,843.0,843.0
0.011,6,10,1989,5,910,2.0,642.0,642.0,5,1079,2.0,811.0,811.0
0.005,17,2,144,1,64,0.0,36.0,36.0,1,80,0.0,52.0,52.0
0.092,6,10,1506,5,395,20.0,127.0,127.0,5,1111,18.0,843.0,843.0
0.005,6,10,2006,5,927,1.0,659.0,659.0,5,1079,1.0,811.0,811.0
0.004,6,10,1774,5,923,1.0,655.0,655.0,5,851,1.0,583.0,583.0
0.001,17,2,136,1,60,0.0,32.0,32.0,1,76,0.0,48.0,48.0
0.003,17,2,148,1,60,0.0,32.0,32.0,1,88,0.0,60.0,60.0
175.368,17,84,11752,42,2803,4277.0,44.0,38.0,42,8949,4277.0,239.0,185.0
0.079,6,10,1506,5,395,17.0,127.0,127.0,5,1111,17.0,843.0,843.0
0.015,6,10,1972,5,910,3.0,642.0,642.0,5,1062,3.0,794.0,794.0
0.079,6,10,1506,5,395,17.0,127.0,127.0,5,1111,16.0,843.0,843.0
0.072,17,8,3613,4,1874,24.0,1350.0,440.0,4,1739,12.0,1350.0,406.0
0.014,6,10,1990,5,911,3.0,643.0,643.0,5,1079,3.0,811.0,811.0
0.008,17,2,238,1,66,0.0,38.0,38.0,1,172,0.0,144.0,144.0
0.168,17,2,152,1,76,0.0,48.0,48.0,1,76,0.0,48.0,48.0
0.223,6,16,2777,8,1395,31.0,533.0,323.0,8,1382,20.0,529.0,239.0
0.005,6,10,2007,5,928,1.0,660.0,660.0,5,1079,1.0,811.0,811.0
0.006,6,10,1643,5,860,1.0,592.0,592.0,5,783,1.0,515.0,515.0
0.005,6,10,2007,5,928,1.0,660.0,660.0,5,1079,1.0,811.0,811.0
288.368,6,402,348554,193,21601,1501.0,2736.0,889.0,209,326953,1386.0,2804.0,1620.0
0.005,6,10,1989,5,927,1.0,659.0,659.0,5,1062,1.0,794.0,794.0
0.004,6,10,1989,5,927,1.0,659.0,659.0,5,1062,1.0,794.0,794.0
0.006,17,2,140,1,62,0.0,34.0,34.0,1,78,0.0,50.0,50.0
0.003,17,2,136,1,60,0.0,32.0,32.0,1,76,0.0,48.0,48.0
0.012,6,10,1989,5,910,2.0,642.0,642.0,5,1079,3.0,811.0,811.0
40.065,17,10,676,5,460,10014.0,104.0,64.0,5,216,10015.0,20.0,15.0
5.09,6,21,5923,12,1436,462.0,474.0,201.0,9,4487,635.0,1925.0,804.0
40.034,17,10,676,5,460,10007.0,104.0,64.0,5,216,10007.0,20.0,15.0
0.081,6,10,1506,5,395,17.0,127.0,127.0,5,1111,17.0,843.0,843.0
0.005,6,10,1989,5,927,1.0,659.0,659.0,5,1062,1.0,794.0,794.0
11.181,17,28,4417,14,1994,847.0,269.0,114.0,14,2423,847.0,586.0,145.0
0.01,6,10,1972,5,910,2.0,642.0,642.0,5,1062,2.0,794.0,794.0
0.004,17,2,136,1,60,0.0,32.0,32.0,1,76,0.0,48.0,48.0
0.01,6,10,1989,5,910,2.0,642.0,642.0,5,1079,2.0,811.0,811.0
0.082,6,10,1506,5,395,16.0,127.0,127.0,5,1111,19.0,843.0,843.0
240.104,6,38,7319,19,2238,13338.0,517.0,205.0,19,5081,13338.0,1467.0,453.0
0.053,17,2,152,1,76,0.0,48.0,48.0,1,76,0.0,48.0,48.0
0.011,6,11,2035,6,962,2.0,642.0,642.0,5,1073,2.0,805.0,805.0
310.363,17,20,1124,10,716,34470.0,48.0,43.0,10,408,34470.0,20.0,12.0
40.07,17,10,676,5,460,10016.0,104.0,64.0,5,216,10016.0,20.0,15.0
0.005,6,10,1989,5,927,1.0,659.0,659.0,5,1062,1.0,794.0,794.0
0.077,6,10,1506,5,395,18.0,127.0,127.0,5,1111,16.0,843.0,843.0
0.109,6,10,1506,5,395,24.0,127.0,127.0,5,1111,21.0,843.0,843.0
0.037,17,2,136,1,60,0.0,32.0,32.0,1,76,0.0,48.0,48.0
0.007,17,2,179,1,71,0.0,43.0,43.0,1,108,0.0,80.0,80.0
0.096,6,10,1506,5,395,20.0,127.0,127.0,5,1111,21.0,843.0,843.0
0.08,6,10,1506,5,395,17.0,127.0,127.0,5,1111,19.0,843.0,843.0
11.607,17,28,4391,14,2313,880.0,588.0,137.0,14,2078,878.0,269.0,120.0
294.782,6,391,348016,198,21871,1496.0,2736.0,889.0,193,326145,1535.0,2804.0,1765.0
240.024,6,9,787,5,488,60006.0,232.0,232.0,4,299,80007.0,83.0,83.0
0.004,6,10,2006,5,927,1.0,659.0,659.0,5,1079,1.0,811.0,811.0
0.001,17,2,132,1,58,0.0,30.0,30.0,1,74,0.0,46.0,46.0
0.004,6,10,1702,5,863,1.0,595.0,595.0,5,839,1.0,571.0,571.0
0.001,17,2,180,1,66,0.0,38.0,38.0,1,114,0.0,86.0,86.0
0.039,17,2,136,1,60,0.0,32.0,32.0,1,76,0.0,48.0,48.0
0.004,6,10,1779,5,928,1.0,660.0,660.0,5,851,1.0,583.0,583.0
0.004,6,10,2006,5,927,1.0,659.0,659.0,5,1079,1.0,811.0,811.0
0.103,6,10,1506,5,395,24.0,127.0,127.0,5,1111,22.0,843.0,843.0
0.013,6,10,1990,5,911,3.0,643.0,643.0,5,1079,3.0,811.0,811.0
0.015,6,10,1631,5,848,3.0,580.0,580.0,5,783,3.0,515.0,515.0
0.004,6,10,2007,5,928,1.0,660.0,660.0,5,1079,1.0,811.0,811.0
159.533,17,76,10744,38,2542,4311.0,44.0,38.0,38,8202,4311.0,252.0,187.0
0.005,6,10,1779,5,928,1.0,660.0,660.0,5,851,1.0,583.0,583.0
0.07,17,8,3613,4,1874,23.0,1350.0,440.0,4,1739,12.0,1350.0,406.0
0.004,6,10,2006,5,927,1.0,659.0,659.0,5,1079,1.0,811.0,811.0
40.07,17,10,676,5,460,10014.0,104.0,64.0,5,216,10016.0,20.0,15.0
0.064,6,10,1506,5,395,14.0,127.0,127.0,5,1111,15.0,843.0,843.0
0.109,6,10,1506,5,395,23.0,127.0,127.0,5,1111,22.0,843.0,843.0
0.008,6,12,1926,6,1189,1.0,659.0,434.0,6,737,1.0,417.0,417.0
0.005,6,10,1643,5,860,1.0,592.0,592.0,5,783,1.0,515.0,515.0
0.009,6,10,1983,5,910,2.0,642.0,642.0,5,1073,2.0,805.0,805.0
0.257,17,40,21610,22,18418,12.0,1350.0,809.0,18,3192,11.0,1350.0,149.0
0.012,6,10,1677,5,827,2.0,559.0,559.0,5,850,3.0,582.0,582.0
0.015,6,10,1989,5,910,3.0,642.0,642.0,5,1079,3.0,811.0,811.0
0.027,6,10,1631,5,848,6.0,580.0,580.0,5,783,6.0,515.0,515.0
0.082,6,10,1506,5,395,18.0,127.0,127.0,5,1111,17.0,843.0,843.0
0.037,17,2,170,1,65,0.0,37.0,37.0,1,105,0.0,77.0,77.0
0.005,6,10,1643,5,860,1.0,592.0,592.0,5,783,1.0,515.0,515.0
0.063,17,2,170,1,65,0.0,37.0,37.0,1,105,0.0,77.0,77.0
0.005,6,10,1547,5,764,1.0,496.0,496.0,5,783,1.0,515.0,515.0
0.004,6,10,1989,5,927,1.0,659.0,659.0,5,1062,1.0,794.0,794.0
0.005,17,2,170,1,65,0.0,37.0,37.0,1,105,0.0,77.0,77.0
0.001,17,2,180,1,66,0.0,38.0,38.0,1,114,0.0,86.0,86.0
0.014,6,10,1972,5,910,3.0,642.0,642.0,5,1062,3.0,794.0,794.0
0.005,17,2,166,1,75,0.0,47.0,47.0,1,91,0.0,63.0,63.0
0.013,6,10,1989,5,910,3.0,642.0,642.0,5,1079,3.0,811.0,811.0
0.015,6,10,1972,5,910,3.0,642.0,642.0,5,1062,3.0,794.0,794.0
0.01,6,10,1989,5,910,2.0,642.0,642.0,5,1079,2.0,811.0,811.0
0.016,6,14,3787,7,497,2.0,125.0,125.0,7,3290,2.0,1448.0,972.0
0.016,6,10,1983,5,910,4.0,642.0,642.0,5,1073,4.0,805.0,805.0
0.072,6,10,1506,5,395,14.0,127.0,127.0,5,1111,16.0,843.0,843.0
0.125,6,10,1506,5,395,27.0,127.0,127.0,5,1111,26.0,843.0,843.0
0.016,6,10,1983,5,910,4.0,642.0,642.0,5,1073,3.0,805.0,805.0
0.012,6,10,1631,5,848,3.0,580.0,580.0,5,783,3.0,515.0,515.0
0.011,6,10,1762,5,911,2.0,643.0,643.0,5,851,2.0,583.0,583.0
0.003,17,2,148,1,60,0.0,32.0,32.0,1,88,0.0,60.0,60.0
0.014,6,10,1989,5,910,3.0,642.0,642.0,5,1079,3.0,811.0,811.0
0.031,6,13,3735,7,497,5.0,125.0,125.0,6,3238,6.0,1470.0,1459.0
308.311,17,20,1124,10,716,34242.0,48.0,43.0,10,408,34242.0,20.0,12.0
0.215,17,4,580,2,122,176.0,33.0,33.0,2,458,144.0,307.0,201.0
0.018,6,10,1989,5,910,4.0,642.0,642.0,5,1079,4.0,811.0,811.0
0.004,6,10,1779,5,928,1.0,660.0,660.0,5,851,1.0,583.0,583.0
0.005,6,14,3736,7,446,0.0,74.0,74.0,7,3290,0.0,1448.0,972.0
0.005,6,10,2006,5,927,1.0,659.0,659.0,5,1079,1.0,811.0,811.0
0.062,6,10,1506,5,395,13.0,127.0,127.0,5,1111,14.0,843.0,843.0
0.02,6,10,1762,5,911,5.0,643.0,643.0,5,851,4.0,583.0,583.0
0.004,6,10,2006,5,927,1.0,659.0,659.0,5,1079,1.0,811.0,811.0
0.004,17,2,148,1,60,0.0,32.0,32.0,1,88,0.0,60.0,60.0
0.004,17,2,148,1,60,0.0,32.0,32.0,1,88,0.0,60.0,60.0
0.005,6,10,1989,5,927,1.0,659.0,659.0,5,1062,1.0,794.0,794.0
0.021,6,10,1972,5,910,5.0,642.0,642.0,5,1062,5.0,794.0,794.0
0.006,6,12,1698,6,863,1.0,327.0,271.0,6,835,1.0,515.0,515.0
10.811,17,28,4422,14,1994,823.0,269.0,114.0,14,2428,823.0,587.0,145.0
0.006,17,2,144,1,64,0.0,36.0,36.0,1,80,0.0,52.0,52.0
40.067,17,10,676,5,460,10014.0,104.0,64.0,5,216,10015.0,20.0,15.0
11.173,17,28,4417,14,1993,846.0,268.0,114.0,14,2424,846.0,587.0,145.0
0.008,6,10,1989,5,910,2.0,642.0,642.0,5,1079,2.0,811.0,811.0
10.76,17,28,4422,14,1993,818.0,268.0,114.0,14,2429,818.0,588.0,145.0
0.007,17,2,148,1,60,0.0,32.0,32.0,1,88,0.0,60.0,60.0
0.015,6,13,3735,7,497,2.0,125.0,125.0,6,3238,2.0,1470.0,1459.0
240.014,6,9,787,5,488,60003.0,232.0,232.0,4,299,80003.0,83.0,83.0
0.087,6,10,1506,5,395,19.0,127.0,127.0,5,1111,19.0,843.0,843.0
0.072,6,10,1506,5,395,14.0,127.0,127.0,5,1111,16.0,843.0,843.0
0.005,6,10,1779,5,928,1.0,660.0,660.0,5,851,1.0,583.0,583.0
15.262,17,18,8574,9,6361,1907.0,1350.0,678.0,9,2213,1904.0,1350.0,217.0
0.007,6,10,1990,5,911,1.0,643.0,643.0,5,1079,1.0,811.0,811.0
0.018,6,10,1972,5,910,4.0,642.0,642.0,5,1062,4.0,794.0,794.0
0.006,17,2,239,1,63,0.0,35.0,35.0,1,176,0.0,148.0,148.0
0.005,6,10,1779,5,928,1.0,660.0,660.0,5,851,1.0,583.0,583.0
0.006,6,10,1547,5,764,1.0,496.0,496.0,5,783,1.0,515.0,515.0
0.001,17,2,180,1,66,0.0,38.0,38.0,1,114,0.0,86.0,86.0
0.005,6,10,2007,5,928,1.0,660.0,660.0,5,1079,1.0,811.0,811.0
0.001,17,2,166,1,75,0.0,47.0,47.0,1,91,0.0,63.0,63.0
40.061,17,10,676,5,460,10014.0,104.0,64.0,5,216,10014.0,20.0,15.0
0.017,6,10,1990,5,911,4.0,643.0,643.0,5,1079,4.0,811.0,811.0
0.065,6,10,1506,5,395,15.0,127.0,127.0,5,1111,14.0,843.0,843.0
0.009,6,10,1990,5,911,2.0,643.0,643.0,5,1079,2.0,811.0,811.0
0.014,6,10,1631,5,848,3.0,580.0,580.0,5,783,3.0,515.0,515.0
40.057,17,10,676,5,460,10013.0,104.0,64.0,5,216,10013.0,20.0,15.0
0.013,6,10,1677,5,827,3.0,559.0,559.0,5,850,3.0,582.0,582.0
240.809,6,319,337947,128,10428,1896.0,1581.0,537.0,191,327519,1267.0,2804.0,1774.0
294.469,6,322,343738,126,18103,2355.0,2736.0,888.0,196,325635,1510.0,2804.0,1733.0
0.084,6,10,1506,5,395,19.0,127.0,127.0,5,1111,18.0,843.0,843.0
0.005,17,2,140,1,62,0.0,34.0,34.0,1,78,0.0,50.0,50.0
0.064,6,10,1506,5,395,14.0,127.0,127.0,5,1111,12.0,843.0,843.0
0.001,17,2,180,1,66,0.0,38.0,38.0,1,114,0.0,86.0,86.0
0.012,6,10,1631,5,848,3.0,580.0,580.0,5,783,2.0,515.0,515.0
0.095,6,10,1506,5,395,20.0,127.0,127.0,5,1111,22.0,843.0,843.0
0.021,6,10,1983,5,910,5.0,642.0,642.0,5,1073,5.0,805.0,805.0
40.071,17,10,676,5,460,10015.0,104.0,64.0,5,216,10017.0,20.0,15.0
0.041,17,2,152,1,76,0.0,48.0,48.0,1,76,0.0,48.0,48.0
0.022,6,10,1677,5,827,5.0,559.0,559.0,5,850,5.0,582.0,582.0
0.087,6,10,1506,5,395,18.0,127.0,127.0,5,1111,15.0,843.0,843.0
0.006,17,2,179,1,71,0.0,43.0,43.0,1,108,0.0,80.0,80.0
0.01,6,10,1677,5,827,2.0,559.0,559.0,5,850,2.0,582.0,582.0
0.017,6,10,1989,5,910,4.0,642.0,642.0,5,1079,4.0,811.0,811.0
0.003,17,2,136,1,60,0.0,32.0,32.0,1,76,0.0,48.0,48.0
0.12,6,10,1506,5,395,29.0,127.0,127.0,5,1111,27.0,843.0,843.0
0.095,6,10,1506,5,395,20.0,127.0,127.0,5,1111,21.0,843.0,843.0
0.01,6,10,1990,5,911,2.0,643.0,643.0,5,1079,2.0,811.0,811.0
11.038,17,28,4391,14,2312,840.0,587.0,137.0,14,2079,840.0,270.0,120.0
0.009,6,10,1989,5,927,2.0,659.0,659.0,5,1062,2.0,794.0,794.0
0.005,6,10,2006,5,927,1.0,659.0,659.0,5,1079,1.0,811.0,811.0
0.058,17,2,144,1,64,0.0,36.0,36.0,1,80,0.0,52.0,52.0
354.076,6,21,1795,16,1030,23605.0,190.0,190.0,5,765,60004.0,464.0,248.0
0.008,6,10,1983,5,910,2.0,642.0,642.0,5,1073,2.0,805.0,805.0
0.117,6,10,1506,5,395,28.0,127.0,127.0,5,1111,27.0,843.0,843.0
0.005,6,10,2000,5,927,1.0,659.0,659.0,5,1073,1.0,805.0,805.0
0.001,17,2,180,1,66,0.0,38.0,38.0,1,114,0.0,86.0,86.0
40.065,17,10,676,5,460,10013.0,104.0,64.0,5,216,10015.0,20.0,15.0
0.094,6,10,1506,5,395,21.0,127.0,127.0,5,1111,20.0,843.0,843.0
0.462,6,28,13516,15,3898,33.0,1511.0,780.0,13,9618,38.0,1402.0,992.0
0.006,6,10,1547,5,764,1.0,496.0,496.0,5,783,1.0,515.0,515.0
0.004,6,10,1774,5,923,1.0,655.0,655.0,5,851,1.0,583.0,583.0
0.005,6,10,2006,5,927,1.0,659.0,659.0,5,1079,1.0,811.0,811.0
0.001,17,2,180,1,66,0.0,38.0,38.0,1,114,0.0,86.0,86.0
0.004,6,10,2006,5,927,1.0,659.0,659.0,5,1079,1.0,811.0,811.0
0.01,6,10,1989,5,910,2.0,642.0,642.0,5,1079,2.0,811.0,811.0
0.267,17,4,352,2,130,227.0,37.0,37.0,2,222,143.0,89.0,83.0
0.005,6,10,2006,5,927,1.0,659.0,659.0,5,1079,1.0,811.0,811.0
0.04,17,2,412,1,61,0.0,33.0,33.0,1,351,0.0,323.0,323.0
0.005,6,10,1989,5,927,1.0,659.0,659.0,5,1062,1.0,794.0,794.0
190.215,58,3,216,2,144,190215.0,24.0,24.0,1,72,0.0,24.0,24.0
0.07,6,10,1506,5,395,15.0,127.0,127.0,5,1111,15.0,843.0,843.0
0.014,6,10,1989,5,910,3.0,642.0,642.0,5,1079,3.0,811.0,811.0
0.024,6,10,1972,5,910,6.0,642.0,642.0,5,1062,6.0,794.0,794.0
1799.837,6,136,6550,76,3625,23997.0,39.0,39.0,60,2925,29993.0,35.0,35.0
0.007,6,10,1547,5,764,1.0,496.0,496.0,5,783,1.0,515.0,515.0
0.053,6,10,1506,5,395,11.0,127.0,127.0,5,1111,12.0,843.0,843.0
0.004,6,10,1702,5,863,1.0,595.0,595.0,5,839,1.0,571.0,571.0
0.091,6,10,1506,5,395,19.0,127.0,127.0,5,1111,21.0,843.0,843.0
0.014,6,13,3735,7,497,2.0,125.0,125.0,6,3238,2.0,1470.0,1459.0
300.026,6,12,1782,7,1348,50004.0,494.0,494.0,5,434,75005.0,83.0,83.0
0.013,6,11,2041,6,962,2.0,642.0,642.0,5,1079,3.0,811.0,811.0
0.015,6,10,1989,5,910,3.0,642.0,642.0,5,1079,3.0,811.0,811.0
0.006,17,2,136,1,60,0.0,32.0,32.0,1,76,0.0,48.0,48.0
0.009,6,10,1989,5,910,2.0,642.0,642.0,5,1079,2.0,811.0,811.0
0.004,6,10,2000,5,927,1.0,659.0,659.0,5,1073,1.0,805.0,805.0
0.002,17,2,180,1,66,0.0,38.0,38.0,1,114,0.0,86.0,86.0
0.016,6,10,1990,5,911,4.0,643.0,643.0,5,1079,3.0,811.0,811.0
0.001,17,2,180,1,66,0.0,38.0,38.0,1,114,0.0,86.0,86.0
0.004,6,10,2000,5,927,1.0,659.0,659.0,5,1073,1.0,805.0,805.0
0.005,6,10,2007,5,928,1.0,660.0,660.0,5,1079,1.0,811.0,811.0
0.006,6,10,1547,5,764,1.0,496.0,496.0,5,783,1.0,515.0,515.0
0.042,6,10,1989,5,910,10.0,642.0,642.0,5,1079,10.0,811.0,811.0
0.008,17,2,144,1,64,0.0,36.0,36.0,1,80,0.0,52.0,52.0
0.191,6,10,1506,5,395,45.0,127.0,127.0,5,1111,42.0,843.0,843.0
0.003,17,4,284,2,120,0.0,32.0,32.0,2,164,0.0,60.0,54.0
0.068,17,8,3613,4,1874,22.0,1350.0,440.0,4,1739,12.0,1350.0,406.0
0.009,6,10,1854,5,889,2.0,621.0,621.0,5,965,2.0,697.0,697.0
0.001,17,2,180,1,66,0.0,38.0,38.0,1,114,0.0,86.0,86.0
0.005,6,10,2006,5,927,1.0,659.0,659.0,5,1079,1.0,811.0,811.0
0.101,6,10,1506,5,395,23.0,127.0,127.0,5,1111,24.0,843.0,843.0
0.013,17,2,168,1,76,0.0,48.0,48.0,1,92,0.0,64.0,64.0
0.006,17,2,170,1,65,0.0,37.0,37.0,1,105,0.0,77.0,77.0
0.014,6,10,1989,5,910,3.0,642.0,642.0,5,1079,3.0,811.0,811.0
0.006,17,4,284,2,120,2.0,32.0,32.0,2,164,2.0,60.0,54.0
0.109,6,10,1506,5,395,26.0,127.0,127.0,5,1111,26.0,843.0,843.0
0.007,6,10,1547,5,764,1.0,496.0,496.0,5,783,1.0,515.0,515.0
0.167,17,2,152,1,76,0.0,48.0,48.0,1,76,0.0,48.0,48.0
0.119,6,10,1506,5,395,27.0,127.0,127.0,5,1111,28.0,843.0,843.0
0.01,6,10,1990,5,911,2.0,643.0,643.0,5,1079,2.0,811.0,811.0
0.084,6,10,1506,5,395,20.0,127.0,127.0,5,1111,18.0,843.0,843.0
0.004,6,10,2006,5,927,1.0,659.0,659.0,5,1079,1.0,811.0,811.0
0.011,6,10,1972,5,910,2.0,642.0,642.0,5,1062,2.0,794.0,794.0
0.005,17,2,367,1,99,0.0,71.0,71.0,1,268,0.0,240.0,240.0
0.004,6,10,2000,5,927,1.0,659.0,659.0,5,1073,1.0,805.0,805.0
309.295,17,20,1124,10,716,34351.0,48.0,43.0,10,408,34351.0,20.0,12.0
0.012,6,10,1989,5,910,3.0,642.0,642.0,5,1079,2.0,811.0,811.0
0.005,6,10,1989,5,927,1.0,659.0,659.0,5,1062,1.0,794.0,794.0
0.005,6,10,1774,5,923,1.0,655.0,655.0,5,851,1.0,583.0,583.0
0.012,6,10,1989,5,910,3.0,642.0,642.0,5,1079,2.0,811.0,811.0
0.016,6,10,1677,5,827,3.0,559.0,559.0,5,850,4.0,582.0,582.0
0.018,6,10,1990,5,911,4.0,643.0,643.0,5,1079,4.0,811.0,811.0
0.005,6,10,2006,5,927,1.0,659.0,659.0,5,1079,1.0,811.0,811.0
0.11,6,10,1506,5,395,23.0,127.0,127.0,5,1111,25.0,843.0,843.0
0.004,6,10,1774,5,923,1.0,655.0,655.0,5,851,1.0,583.0,583.0
0.005,6,10,2000,5,927,1.0,659.0,659.0,5,1073,1.0,805.0,805.0
0.004,17,2,136,1,60,0.0,32.0,32.0,1,76,0.0,48.0,48.0
0.007,6,10,1983,5,910,1.0,642.0,642.0,5,1073,1.0,805.0,805.0
0.003,17,2,152,1,76,0.0,48.0,48.0,1,76,0.0,48.0,48.0
0.241,6,16,2778,8,1396,34.0,533.0,324.0,8,1382,21.0,529.0,239.0
0.091,6,10,1506,5,395,20.0,127.0,127.0,5,1111,16.0,843.0,843.0
0.004,6,10,2006,5,927,1.0,659.0,659.0,5,1079,1.0,811.0,811.0
0.005,17,2,166,1,75,0.0,47.0,47.0,1,91,0.0,63.0,63.0
0.09,6,10,1506,5,395,19.0,127.0,127.0,5,1111,19.0,843.0,843.0
0.096,6,10,1506,5,395,21.0,127.0,127.0,5,1111,19.0,843.0,843.0
0.014,6,10,1983,5,910,3.0,642.0,642.0,5,1073,3.0,805.0,805.0
0.071,17,4,284,2,120,0.0,32.0,32.0,2,164,68.0,60.0,54.0
0.12,6,10,1506,5,395,27.0,127.0,127.0,5,1111,28.0,843.0,843.0
0.031,6,10,1989,5,910,7.0,642.0,642.0,5,1079,7.0,811.0,811.0
0.012,6,10,1972,5,910,3.0,642.0,642.0,5,1062,3.0,794.0,794.0
0.013,6,10,1989,5,910,3.0,642.0,642.0,5,1079,3.0,811.0,811.0
0.089,6,10,1506,5,395,18.0,127.0,127.0,5,1111,18.0,843.0,843.0
0.004,17,4,284,2,120,0.0,32.0,32.0,2,164,0.0,60.0,54.0
0.019,6,10,1989,5,910,4.0,642.0,642.0,5,1079,4.0,811.0,811.0
0.003,17,2,148,1,60,0.0,32.0,32.0,1,88,0.0,60.0,60.0
0.006,6,10,1854,5,889,1.0,621.0,621.0,5,965,1.0,697.0,697.0
0.011,6,10,1989,5,910,2.0,642.0,642.0,5,1079,2.0,811.0,811.0
0.001,17,2,180,1,66,0.0,38.0,38.0,1,114,0.0,86.0,86.0
0.013,6,13,3735,7,497,2.0,125.0,125.0,6,3238,2.0,1470.0,1459.0
0.006,6,10,2007,5,928,1.0,660.0,660.0,5,1079,1.0,811.0,811.0
0.004,6,10,1702,5,863,1.0,595.0,595.0,5,839,1.0,571.0,571.0
5.184,6,23,6467,13,1827,431.0,801.0,282.0,10,4640,575.0,1925.0,824.0
0.005,6,10,2006,5,927,1.0,659.0,659.0,5,1079,1.0,811.0,811.0
0.006,6,10,1689,5,839,1.0,571.0,571.0,5,850,1.0,582.0,582.0
0.072,17,4,352,2,130,0.0,37.0,37.0,2,222,69.0,89.0,83.0
0.011,6,10,1990,5,911,2.0,643.0,643.0,5,1079,2.0,811.0,811.0
0.009,6,10,1989,5,910,2.0,642.0,642.0,5,1079,2.0,811.0,811.0
0.005,6,10,2000,5,927,1.0,659.0,659.0,5,1073,1.0,805.0,805.0
0.094,6,10,1506,5,395,19.0,127.0,127.0,5,1111,22.0,843.0,843.0
314.732,17,20,1124,10,716,34963.0,48.0,43.0,10,408,34962.0,20.0,12.0
0.01,6,10,1989,5,910,2.0,642.0,642.0,5,1079,2.0,811.0,811.0
0.005,6,10,2007,5,928,1.0,660.0,660.0,5,1079,1.0,811.0,811.0
0.015,6,10,1762,5,911,3.0,643.0,643.0,5,851,3.0,583.0,583.0
0.041,17,2,170,1,65,0.0,37.0,37.0,1,105,0.0,77.0,77.0
0.004,6,10,2006,5,927,1.0,659.0,659.0,5,1079,1.0,811.0,811.0
0.004,17,4,284,2,120,0.0,32.0,32.0,2,164,1.0,60.0,54.0
0.003,17,4,284,2,120,0.0,32.0,32.0,2,164,0.0,60.0,54.0
0.014,6,10,1983,5,910,3.0,642.0,642.0,5,1073,3.0,805.0,805.0
0.006,6,10,1547,5,764,1.0,496.0,496.0,5,783,1.0,515.0,515.0
0.069,6,10,1506,5,395,16.0,127.0,127.0,5,1111,14.0,843.0,843.0
0.005,6,10,1989,5,927,1.0,659.0,659.0,5,1062,1.0,794.0,794.0
241.379,6,309,343718,109,17186,2234.0,2736.0,960.0,200,326532,1212.0,2804.0,1663.0
0.012,6,10,1990,5,911,3.0,643.0,643.0,5,1079,2.0,811.0,811.0
10.937,17,28,4422,14,1994,832.0,269.0,114.0,14,2428,832.0,587.0,145.0
0.006,17,2,170,1,65,0.0,37.0,37.0,1,105,0.0,77.0,77.0
0.04,17,2,152,1,76,0.0,48.0,48.0,1,76,0.0,48.0,48.0
0.019,6,10,1972,5,910,4.0,642.0,642.0,5,1062,4.0,794.0,794.0
0.079,6,10,1506,5,395,19.0,127.0,127.0,5,1111,16.0,843.0,843.0
0.005,6,10,1989,5,927,1.0,659.0,659.0,5,1062,1.0,794.0,794.0
0.066,6,10,1506,5,395,14.0,127.0,127.0,5,1111,14.0,843.0,843.0
0.005,6,10,1547,5,764,1.0,496.0,496.0,5,783,1.0,515.0,515.0
178.139,17,94,13443,47,3169,3872.0,44.0,39.0,47,10274,3872.0,239.0,190.0
0.263,17,39,20261,21,17041,13.0,1350.0,783.0,18,3220,11.0,1350.0,150.0
0.006,6,10,1689,5,839,1.0,571.0,571.0,5,850,1.0,582.0,582.0
0.136,6,10,1506,5,395,30.0,127.0,127.0,5,1111,30.0,843.0,843.0
11.428,17,28,4389,14,2312,866.0,587.0,137.0,14,2077,866.0,268.0,120.0
334.505,17,20,1124,10,716,37152.0,48.0,43.0,10,408,37152.0,20.0,12.0
0.005,6,10,2006,5,927,1.0,659.0,659.0,5,1079,1.0,811.0,811.0
11.116,17,28,4420,14,1993,842.0,268.0,114.0,14,2427,842.0,586.0,145.0
0.091,6,10,1506,5,395,21.0,127.0,127.0,5,1111,16.0,843.0,843.0
0.008,6,10,1972,5,910,2.0,642.0,642.0,5,1062,1.0,794.0,794.0
0.005,6,10,2006,5,927,1.0,659.0,659.0,5,1079,1.0,811.0,811.0
0.016,17,2,180,1,66,0.0,38.0,38.0,1,114,0.0,86.0,86.0
0.091,6,10,1506,5,395,22.0,127.0,127.0,5,1111,17.0,843.0,843.0
0.05,17,4,284,2,120,0.0,32.0,32.0,2,164,42.0,60.0,54.0
0.005,6,10,2006,5,927,1.0,659.0,659.0,5,1079,1.0,811.0,811.0
0.076,6,10,1506,5,395,17.0,127.0,127.0,5,1111,16.0,843.0,843.0
0.008,6,10,1990,5,911,1.0,643.0,643.0,5,1079,2.0,811.0,811.0
0.011,6,10,1972,5,910,2.0,642.0,642.0,5,1062,2.0,794.0,794.0
0.008,17,2,226,1,97,0.0,69.0,69.0,1,129,0.0,101.0,101.0
0.068,6,10,1506,5,395,14.0,127.0,127.0,5,1111,16.0,843.0,843.0
0.109,6,10,1506,5,395,24.0,127.0,127.0,5,1111,24.0,843.0,843.0
388.54,6,22,2313,16,867,25902.0,195.0,195.0,6,1446,4636.0,419.0,398.0
0.071,6,10,1506,5,395,17.0,127.0,127.0,5,1111,17.0,843.0,843.0
300.324,6,16,2170,9,684,37519.0,146.0,146.0,7,1486,50025.0,419.0,398.0
0.005,6,10,2007,5,928,1.0,660.0,660.0,5,1079,1.0,811.0,811.0
0.062,6,10,1506,5,395,13.0,127.0,127.0,5,1111,14.0,843.0,843.0
0.014,6,10,1631,5,848,3.0,580.0,580.0,5,783,3.0,515.0,515.0
0.005,17,2,140,1,62,0.0,34.0,34.0,1,78,0.0,50.0,50.0
0.005,6,10,1689,5,839,1.0,571.0,571.0,5,850,1.0,582.0,582.0
0.021,6,13,3816,7,578,3.0,206.0,206.0,6,3238,4.0,1470.0,1459.0
0.009,6,10,1990,5,911,2.0,643.0,643.0,5,1079,2.0,811.0,811.0
0.11,6,10,1506,5,395,23.0,127.0,127.0,5,1111,24.0,843.0,843.0
0.006,17,2,212,1,74,0.0,46.0,46.0,1,138,0.0,110.0,110.0
0.047,17,2,170,1,65,0.0,37.0,37.0,1,105,0.0,77.0,77.0
0.015,6,10,1972,5,910,3.0,642.0,642.0,5,1062,3.0,794.0,794.0
0.062,6,10,1506,5,395,14.0,127.0,127.0,5,1111,14.0,843.0,843.0
0.005,6,10,1643,5,860,1.0,592.0,592.0,5,783,1.0,515.0,515.0
0.078,6,10,1506,5,395,18.0,127.0,127.0,5,1111,14.0,843.0,843.0
0.013,6,10,1972,5,910,3.0,642.0,642.0,5,1062,3.0,794.0,794.0
0.005,6,10,1989,5,927,1.0,659.0,659.0,5,1062,1.0,794.0,794.0
0.016,6,14,3787,7,497,2.0,125.0,125.0,7,3290,2.0,1448.0,972.0
0.143,6,10,1506,5,395,33.0,127.0,127.0,5,1111,34.0,843.0,843.0
0.011,6,10,1990,5,911,2.0,643.0,643.0,5,1079,2.0,811.0,811.0
0.006,6,10,1547,5,764,1.0,496.0,496.0,5,783,1.0,515.0,515.0
0.005,17,2,212,1,63,0.0,35.0,35.0,1,149,0.0,121.0,121.0
0.006,6,10,1643,5,860,1.0,592.0,592.0,5,783,1.0,515.0,515.0
0.061,6,10,1506,5,395,13.0,127.0,127.0,5,1111,14.0,843.0,843.0
0.124,6,10,1506,5,395,15.0,127.0,127.0,5,1111,29.0,843.0,843.0
0.066,6,10,1506,5,395,14.0,127.0,127.0,5,1111,15.0,843.0,843.0
240.089,6,31,8973,15,6581,17149.0,1707.0,645.0,16,2392,16005.0,580.0,194.0
11.174,17,28,4424,14,1995,847.0,270.0,114.0,14,2429,846.0,588.0,145.0
0.001,17,2,136,1,60,0.0,32.0,32.0,1,76,0.0,48.0,48.0
0.081,6,10,1506,5,395,17.0,127.0,127.0,5,1111,20.0,843.0,843.0
0.004,6,10,2007,5,928,1.0,660.0,660.0,5,1079,1.0,811.0,811.0
0.129,6,10,1506,5,395,30.0,127.0,127.0,5,1111,28.0,843.0,843.0
0.11,6,10,1506,5,395,25.0,127.0,127.0,5,1111,23.0,843.0,843.0
0.029,17,2,180,1,66,0.0,38.0,38.0,1,114,0.0,86.0,86.0
0.005,6,10,1547,5,764,1.0,496.0,496.0,5,783,1.0,515.0,515.0
0.017,6,10,1989,5,910,4.0,642.0,642.0,5,1079,4.0,811.0,811.0
0.009,6,10,1989,5,910,2.0,642.0,642.0,5,1079,2.0,811.0,811.0
0.005,6,10,1643,5,860,1.0,592.0,592.0,5,783,1.0,515.0,515.0
0.006,6,13,3747,7,509,1.0,137.0,137.0,6,3238,1.0,1470.0,1459.0
0.022,6,10,1990,5,911,5.0,643.0,643.0,5,1079,5.0,811.0,811.0
0.005,6,10,2007,5,928,1.0,660.0,660.0,5,1079,1.0,811.0,811.0
240.031,6,9,787,5,488,60007.0,232.0,232.0,4,299,80009.0,83.0,83.0
0.005,6,13,3690,7,452,0.0,80.0,80.0,6,3238,0.0,1470.0,1459.0
240.021,6,9,787,5,488,60005.0,232.0,232.0,4,299,80004.0,83.0,83.0
0.005,6,10,2007,5,928,1.0,660.0,660.0,5,1079,1.0,811.0,811.0
40.042,17,10,676,5,460,10009.0,104.0,64.0,5,216,10009.0,20.0,15.0
0.004,6,10,1779,5,928,1.0,660.0,660.0,5,851,1.0,583.0,583.0
0.005,6,10,2007,5,928,1.0,660.0,660.0,5,1079,1.0,811.0,811.0
0.006,17,2,230,1,68,0.0,40.0,40.0,1,162,0.0,134.0,134.0
1792.692,6,479,98387,240,87290,7500.0,421.0,369.0,239,11097,7531.0,53.0,53.0
40.065,17,10,676,5,460,10014.0,104.0,64.0,5,216,10015.0,20.0,15.0
0.006,17,2,164,1,74,0.0,46.0,46.0,1,90,0.0,62.0,62.0
0.005,6,10,2006,5,927,1.0,659.0,659.0,5,1079,1.0,811.0,811.0
0.011,6,10,1983,5,910,2.0,642.0,642.0,5,1073,2.0,805.0,805.0
0.013,6,10,1989,5,910,3.0,642.0,642.0,5,1079,3.0,811.0,811.0
0.006,17,4,284,2,120,3.0,32.0,32.0,2,164,3.0,60.0,54.0
0.009,6,10,1983,5,910,2.0,642.0,642.0,5,1073,2.0,805.0,805.0
0.006,6,10,1854,5,889,1.0,621.0,621.0,5,965,1.0,697.0,697.0
10.809,17,28,4422,14,1994,823.0,269.0,114.0,14,2428,823.0,587.0,145.0
0.003,17,2,148,1,60,0.0,32.0,32.0,1,88,0.0,60.0,60.0
0.006,6,10,1547,5,764,1.0,496.0,496.0,5,783,1.0,515.0,515.0
0.068,6,10,1506,5,395,15.0,127.0,127.0,5,1111,14.0,843.0,843.0
0.004,6,10,2000,5,927,1.0,659.0,659.0,5,1073,1.0,805.0,805.0
168.143,17,84,12117,42,2833,4100.0,44.0,39.0,42,9284,4100.0,239.0,193.0
0.044,17,2,144,1,64,0.0,36.0,36.0,1,80,0.0,52.0,52.0
40.063,17,10,676,5,460,10012.0,104.0,64.0,5,216,10015.0,20.0,15.0
0.004,6,10,2000,5,927,1.0,659.0,659.0,5,1073,1.0,805.0,805.0
10.811,17,26,4102,13,1822,892.0,269.0,112.0,13,2280,892.0,587.0,147.0
0.012,6,10,1972,5,910,2.0,642.0,642.0,5,1062,2.0,794.0,794.0
0.016,6,10,1972,5,910,4.0,642.0,642.0,5,1062,4.0,794.0,794.0
0.114,6,10,1506,5,395,26.0,127.0,127.0,5,1111,26.0,843.0,843.0
0.089,6,10,1506,5,395,19.0,127.0,127.0,5,1111,19.0,843.0,843.0
0.005,17,2,193,1,71,0.0,43.0,43.0,1,122,0.0,94.0,94.0
0.001,17,2,180,1,66,0.0,38.0,38.0,1,114,0.0,86.0,86.0
0.147,6,10,1506,5,395,34.0,127.0,127.0,5,1111,35.0,843.0,843.0
0.072,17,2,170,1,65,0.0,37.0,37.0,1,105,0.0,77.0,77.0
0.008,6,10,1854,5,889,1.0,621.0,621.0,5,965,1.0,697.0,697.0
0.004,6,10,1989,5,927,1.0,659.0,659.0,5,1062,1.0,794.0,794.0
0.004,6,10,1779,5,928,1.0,660.0,660.0,5,851,0.0,583.0,583.0
0.705,6,22,5072,11,1250,65.0,325.0,133.0,11,3822,59.0,1414.0,563.0
164.374,17,80,11665,40,2689,4214.0,44.0,39.0,40,8976,4214.0,261.0,196.0
0.004,17,2,136,1,60,0.0,32.0,32.0,1,76,0.0,48.0,48.0
0.001,17,2,180,1,66,0.0,38.0,38.0,1,114,0.0,86.0,86.0
0.009,6,12,1926,6,1189,1.0,659.0,434.0,6,737,1.0,417.0,417.0
0.01,6,14,3787,7,497,1.0,125.0,125.0,7,3290,1.0,1448.0,972.0
0.005,6,10,2000,5,927,1.0,659.0,659.0,5,1073,1.0,805.0,805.0
0.041,17,2,152,1,76,0.0,48.0,48.0,1,76,0.0,48.0,48.0
0.001,17,2,136,1,60,0.0,32.0,32.0,1,76,0.0,48.0,48.0
0.01,6,10,1989,5,910,2.0,642.0,642.0,5,1079,2.0,811.0,811.0
0.013,17,2,152,1,56,0.0,28.0,28.0,1,96,0.0,68.0,68.0
372.272,6,22,2313,16,867,24818.0,195.0,195.0,6,1446,4635.0,419.0,398.0
0.005,6,10,1989,5,927,1.0,659.0,659.0,5,1062,1.0,794.0,794.0
0.015,17,2,198,1,91,0.0,63.0,63.0,1,107,0.0,79.0,79.0
0.004,6,10,2007,5,928,1.0,660.0,660.0,5,1079,1.0,811.0,811.0
0.004,6,10,1989,5,927,1.0,659.0,659.0,5,1062,1.0,794.0,794.0
0.01,6,10,1990,5,911,2.0,643.0,643.0,5,1079,2.0,811.0,811.0
0.009,6,10,1983,5,910,2.0,642.0,642.0,5,1073,2.0,805.0,805.0
0.018,6,10,1762,5,911,4.0,643.0,643.0,5,851,4.0,583.0,583.0
0.004,6,10,1774,5,923,1.0,655.0,655.0,5,851,1.0,583.0,583.0
0.007,6,10,1547,5,764,1.0,496.0,496.0,5,783,1.0,515.0,515.0
0.004,17,2,148,1,60,0.0,32.0,32.0,1,88,0.0,60.0,60.0
0.018,6,10,1990,5,911,4.0,643.0,643.0,5,1079,4.0,811.0,811.0
0.005,17,2,179,1,71,0.0,43.0,43.0,1,108,0.0,80.0,80.0
0.006,6,10,1547,5,764,1.0,496.0,496.0,5,783,1.0,515.0,515.0
0.006,6,10,1689,5,839,1.0,571.0,571.0,5,850,1.0,582.0,582.0
0.013,6,10,1631,5,848,3.0,580.0,580.0,5,783,3.0,515.0,515.0
0.015,6,10,1762,5,911,3.0,643.0,643.0,5,851,3.0,583.0,583.0
0.003,17,4,284,2,120,0.0,32.0,32.0,2,164,0.0,60.0,54.0
0.014,6,10,1677,5,827,3.0,559.0,559.0,5,850,3.0,582.0,582.0
0.121,6,10,1506,5,395,27.0,127.0,127.0,5,1111,25.0,843.0,843.0
1792.299,6,559,191354,284,164480,6333.0,2883.0,947.0,275,26874,6541.0,580.0,123.0
0.068,17,8,3613,4,1874,22.0,1350.0,440.0,4,1739,11.0,1350.0,406.0
0.006,17,2,299,1,65,0.0,37.0,37.0,1,234,0.0,206.0,206.0
40.068,17,10,676,5,460,10013.0,104.0,64.0,5,216,10016.0,20.0,15.0
0.005,6,10,2000,5,927,1.0,659.0,659.0,5,1073,1.0,805.0,805.0
0.005,6,10,2006,5,927,1.0,659.0,659.0,5,1079,1.0,811.0,811.0
0.011,6,10,1972,5,910,2.0,642.0,642.0,5,1062,2.0,794.0,794.0
0.006,6,10,1689,5,839,1.0,571.0,571.0,5,850,1.0,582.0,582.0
0.005,17,4,284,2,120,1.0,32.0,32.0,2,164,1.0,60.0,54.0
0.097,6,10,1506,5,395,22.0,127.0,127.0,5,1111,20.0,843.0,843.0
0.008,6,12,1926,6,1189,1.0,659.0,434.0,6,737,1.0,417.0,417.0
0.004,6,10,1702,5,863,1.0,595.0,595.0,5,839,0.0,571.0,571.0
40.061,17,10,676,5,460,10014.0,104.0,64.0,5,216,10014.0,20.0,15.0
0.009,6,12,1926,6,1189,1.0,659.0,434.0,6,737,1.0,417.0,417.0
0.015,6,10,1989,5,910,3.0,642.0,642.0,5,1079,3.0,811.0,811.0
0.005,6,13,3747,7,509,0.0,137.0,137.0,6,3238,1.0,1470.0,1459.0
0.018,6,10,1983,5,910,4.0,642.0,642.0,5,1073,4.0,805.0,805.0
0.016,6,10,1989,5,910,3.0,642.0,642.0,5,1079,4.0,811.0,811.0
0.69,6,23,5165,12,1343,62.0,325.0,122.0,11,3822,58.0,1414.0,563.0
0.105,6,10,1506,5,395,23.0,127.0,127.0,5,1111,22.0,843.0,843.0
0.01,6,12,1926,6,1189,2.0,659.0,434.0,6,737,1.0,417.0,417.0
0.013,6,10,1989,5,910,3.0,642.0,642.0,5,1079,3.0,811.0,811.0
0.119,6,10,1506,5,395,27.0,127.0,127.0,5,1111,27.0,843.0,843.0
0.004,6,10,2000,5,927,1.0,659.0,659.0,5,1073,1.0,805.0,805.0
40.069,17,10,676,5,460,10014.0,104.0,64.0,5,216,10016.0,20.0,15.0
0.073,6,10,1506,5,395,16.0,127.0,127.0,5,1111,14.0,843.0,843.0
0.006,6,10,1547,5,764,1.0,496.0,496.0,5,783,1.0,515.0,515.0
0.013,6,10,1631,5,848,3.0,580.0,580.0,5,783,3.0,515.0,515.0
0.006,17,2,194,1,57,0.0,29.0,29.0,1,137,0.0,109.0,109.0
0.005,6,10,2000,5,927,1.0,659.0,659.0,5,1073,1.0,805.0,805.0
0.01,6,10,1989,5,910,2.0,642.0,642.0,5,1079,2.0,811.0,811.0
0.004,17,2,222,1,65,0.0,37.0,37.0,1,157,0.0,129.0,129.0
40.075,17,10,676,5,460,10017.0,104.0,64.0,5,216,10017.0,20.0,15.0
240.159,6,16,4481,9,963,30019.0,238.0,166.0,7,3518,40020.0,1402.0,786.0
0.006,6,10,1643,5,860,1.0,592.0,592.0,5,783,1.0,515.0,515.0
0.019,6,10,1990,5,911,4.0,643.0,643.0,5,1079,4.0,811.0,811.0
0.004,6,10,2007,5,928,1.0,660.0,660.0,5,1079,1.0,811.0,811.0
0.081,6,10,1506,5,395,15.0,127.0,127.0,5,1111,18.0,843.0,843.0
0.006,6,10,2007,5,928,1.0,660.0,660.0,5,1079,1.0,811.0,811.0
0.037,17,2,156,1,64,0.0,36.0,36.0,1,92,0.0,64.0,64.0
0.005,6,10,2000,5,927,1.0,659.0,659.0,5,1073,1.0,805.0,805.0
0.005,6,10,2006,5,927,1.0,659.0,659.0,5,1079,1.0,811.0,811.0
0.016,6,10,1983,5,910,3.0,642.0,642.0,5,1073,4.0,805.0,805.0
0.005,6,10,2006,5,927,1.0,659.0,659.0,5,1079,1.0,811.0,811.0
11.236,17,28,4394,14,1994,851.0,269.0,114.0,14,2400,851.0,587.0,143.0
0.006,6,10,1779,5,928,1.0,660.0,660.0,5,851,1.0,583.0,583.0
166.213,17,70,9955,35,2331,4888.0,44.0,38.0,35,7624,4888.0,239.0,189.0
15.07,17,15,9239,8,6902,2148.0,1350.0,834.0,7,2337,2506.0,1350.0,305.0
0.012,6,10,1989,5,910,3.0,642.0,642.0,5,1079,3.0,811.0,811.0
0.012,6,10,1989,5,910,3.0,642.0,642.0,5,1079,3.0,811.0,811.0
0.003,17,2,136,1,60,0.0,32.0,32.0,1,76,0.0,48.0,48.0
1782.716,6,284,37101,118,19944,15235.0,2799.0,166.0,166,17157,10803.0,1360.0,129.0
0.009,6,10,1983,5,910,2.0,642.0,642.0,5,1073,2.0,805.0,805.0
0.005,6,10,1774,5,923,1.0,655.0,655.0,5,851,1.0,583.0,583.0
0.011,6,10,1972,5,910,2.0,642.0,642.0,5,1062,2.0,794.0,794.0
0.01,6,10,1983,5,910,2.0,642.0,642.0,5,1073,2.0,805.0,805.0
0.005,17,2,144,1,64,0.0,36.0,36.0,1,80,0.0,52.0,52.0
9.014,6,37,9811,19,4293,500.0,1360.0,700.0,18,5518,518.0,1360.0,398.0
0.015,6,10,1631,5,848,3.0,580.0,580.0,5,783,3.0,515.0,515.0
15.074,17,14,9190,8,6902,2149.0,1350.0,834.0,6,2288,3008.0,1350.0,353.0
0.007,6,10,2007,5,928,1.0,660.0,660.0,5,1079,1.0,811.0,811.0
0.077,6,10,1506,5,395,18.0,127.0,127.0,5,1111,15.0,843.0,843.0
40.075,17,10,676,5,460,10016.0,104.0,64.0,5,216,10017.0,20.0,15.0
0.06,17,2,152,1,76,0.0,48.0,48.0,1,76,0.0,48.0,48.0
0.007,6,10,1854,5,889,1.0,621.0,621.0,5,965,1.0,697.0,697.0
0.09,6,10,1506,5,395,18.0,127.0,127.0,5,1111,22.0,843.0,843.0
310.832,17,20,1124,10,716,34523.0,48.0,43.0,10,408,34523.0,20.0,12.0
0.005,6,10,1643,5,860,1.0,592.0,592.0,5,783,1.0,515.0,515.0
0.082,6,10,1506,5,395,15.0,127.0,127.0,5,1111,19.0,843.0,843.0
0.005,6,14,3742,7,452,0.0,80.0,80.0,7,3290,0.0,1448.0,972.0
0.006,6,10,1547,5,764,1.0,496.0,496.0,5,783,1.0,515.0,515.0
0.012,6,10,1989,5,910,2.0,642.0,642.0,5,1079,3.0,811.0,811.0
0.005,6,13,3747,7,509,0.0,137.0,137.0,6,3238,1.0,1470.0,1459.0
0.113,6,10,1506,5,395,20.0,127.0,127.0,5,1111,24.0,843.0,843.0
0.006,6,10,1547,5,764,1.0,496.0,496.0,5,783,1.0,515.0,515.0
0.06,17,2,152,1,76,0.0,48.0,48.0,1,76,0.0,48.0,48.0
1.244,17,49,27438,26,22612,49.0,1350.0,841.0,23,4826,46.0,1350.0,181.0
0.006,6,10,1547,5,764,1.0,496.0,496.0,5,783,1.0,515.0,515.0
0.011,6,10,1972,5,910,2.0,642.0,642.0,5,1062,2.0,794.0,794.0
0.097,6,10,1506,5,395,22.0,127.0,127.0,5,1111,21.0,843.0,843.0
0.099,6,10,1506,5,395,20.0,127.0,127.0,5,1111,20.0,843.0,843.0
0.006,6,10,1547,5,764,1.0,496.0,496.0,5,783,1.0,515.0,515.0
0.013,17,2,152,1,56,0.0,28.0,28.0,1,96,0.0,68.0,68.0
0.005,6,10,1989,5,927,1.0,659.0,659.0,5,1062,1.0,794.0,794.0
40.064,17,10,676,5,460,10014.0,104.0,64.0,5,216,10015.0,20.0,15.0
40.08,17,10,676,5,460,10017.0,104.0,64.0,5,216,10017.0,20.0,15.0
0.005,6,10,1989,5,927,1.0,659.0,659.0,5,1062,1.0,794.0,794.0
0.217,6,16,2776,8,1394,31.0,533.0,323.0,8,1382,19.0,529.0,239.0
0.052,17,2,152,1,76,0.0,48.0,48.0,1,76,0.0,48.0,48.0
0.004,6,10,1989,5,927,1.0,659.0,659.0,5,1062,1.0,794.0,794.0
40.058,17,10,676,5,460,10012.0,104.0,64.0,5,216,10013.0,20.0,15.0
0.011,6,10,1990,5,911,2.0,643.0,643.0,5,1079,2.0,811.0,811.0
0.078,6,10,1506,5,395,18.0,127.0,127.0,5,1111,16.0,843.0,843.0
1792.268,6,566,189206,287,163325,6266.0,2883.0,939.0,279,25881,6446.0,370.0,113.0
0.004,6,10,2006,5,927,1.0,659.0,659.0,5,1079,1.0,811.0,811.0
40.079,17,10,676,5,460,10019.0,104.0,64.0,5,216,10019.0,20.0,15.0
0.006,17,2,166,1,75,0.0,47.0,47.0,1,91,0.0,63.0,63.0
0.012,6,10,1989,5,910,3.0,642.0,642.0,5,1079,3.0,811.0,811.0
0.083,6,10,1506,5,395,19.0,127.0,127.0,5,1111,17.0,843.0,843.0
0.001,17,2,180,1,66,0.0,38.0,38.0,1,114,0.0,86.0,86.0
0.011,6,10,1983,5,910,2.0,642.0,642.0,5,1073,2.0,805.0,805.0
0.105,6,10,1506,5,395,23.0,127.0,127.0,5,1111,23.0,843.0,843.0
0.126,6,10,1506,5,395,28.0,127.0,127.0,5,1111,27.0,843.0,843.0
0.005,6,10,2006,5,927,1.0,659.0,659.0,5,1079,1.0,811.0,811.0
0.018,6,10,1972,5,910,4.0,642.0,642.0,5,1062,4.0,794.0,794.0
0.001,17,2,180,1,66,0.0,38.0,38.0,1,114,0.0,86.0,86.0
0.021,6,10,1762,5,911,5.0,643.0,643.0,5,851,5.0,583.0,583.0
0.005,6,13,3747,7,509,0.0,137.0,137.0,6,3238,1.0,1470.0,1459.0
0.005,6,10,2006,5,927,1.0,659.0,659.0,5,1079,1.0,811.0,811.0
0.139,6,10,1506,5,395,30.0,127.0,127.0,5,1111,29.0,843.0,843.0
308.577,17,20,1124,10,716,34279.0,48.0,43.0,10,408,34279.0,20.0,12.0
0.006,17,2,148,1,60,0.0,32.0,32.0,1,88,0.0,60.0,60.0
0.006,17,2,275,1,67,0.0,39.0,39.0,1,208,0.0,180.0,180.0
0.004,6,10,2006,5,927,1.0,659.0,659.0,5,1079,1.0,811.0,811.0
0.004,17,4,284,2,120,0.0,32.0,32.0,2,164,0.0,60.0,54.0
0.004,17,2,148,1,60,0.0,32.0,32.0,1,88,0.0,60.0,60.0
0.006,6,10,1689,5,839,1.0,571.0,571.0,5,850,1.0,582.0,582.0
240.101,6,16,4480,9,963,30012.0,238.0,166.0,7,3517,40016.0,1402.0,786.0
0.004,6,10,2007,5,928,1.0,660.0,660.0,5,1079,1.0,811.0,811.0
0.004,6,10,2006,5,927,1.0,659.0,659.0,5,1079,1.0,811.0,811.0
0.058,6,10,1506,5,395,13.0,127.0,127.0,5,1111,11.0,843.0,843.0
40.088,17,10,676,5,460,10015.0,104.0,64.0,5,216,10021.0,20.0,15.0
0.073,6,10,1506,5,395,16.0,127.0,127.0,5,1111,15.0,843.0,843.0
0.004,6,10,2006,5,927,1.0,659.0,659.0,5,1079,1.0,811.0,811.0
0.1,6,10,1506,5,395,24.0,127.0,127.0,5,1111,23.0,843.0,843.0
0.058,17,2,178,1,65,0.0,37.0,37.0,1,113,0.0,85.0,85.0
0.006,6,10,1547,5,764,1.0,496.0,496.0,5,783,1.0,515.0,515.0
0.005,6,10,1774,5,923,1.0,655.0,655.0,5,851,1.0,583.0,583.0
0.102,6,10,1506,5,395,23.0,127.0,127.0,5,1111,21.0,843.0,843.0
0.005,6,10,2000,5,927,1.0,659.0,659.0,5,1073,1.0,805.0,805.0
0.008,6,10,1762,5,911,1.0,643.0,643.0,5,851,1.0,583.0,583.0
15.137,17,12,5016,6,2904,3021.0,1350.0,456.0,6,2112,3021.0,1350.0,324.0
1799.633,6,240,46707,112,33965,16212.0,2499.0,1039.0,128,12742,14170.0,580.0,61.0
0.04,17,2,152,1,76,0.0,48.0,48.0,1,76,0.0,48.0,48.0
0.033,6,10,1989,5,910,8.0,642.0,642.0,5,1079,8.0,811.0,811.0
0.01,6,10,1983,5,910,2.0,642.0,642.0,5,1073,2.0,805.0,805.0
0.013,6,10,1972,5,910,3.0,642.0,642.0,5,1062,3.0,794.0,794.0
0.008,6,10,1972,5,910,1.0,642.0,642.0,5,1062,2.0,794.0,794.0
0.005,6,10,1989,5,927,1.0,659.0,659.0,5,1062,1.0,794.0,794.0
0.005,17,2,187,1,71,0.0,43.0,43.0,1,116,0.0,88.0,88.0
0.01,6,10,1989,5,910,2.0,642.0,642.0,5,1079,2.0,811.0,811.0
0.128,6,10,1506,5,395,27.0,127.0,127.0,5,1111,25.0,843.0,843.0
0.016,6,10,1972,5,910,3.0,642.0,642.0,5,1062,3.0,794.0,794.0
0.006,6,10,2006,5,927,1.0,659.0,659.0,5,1079,1.0,811.0,811.0
0.001,17,2,180,1,66,0.0,38.0,38.0,1,114,0.0,86.0,86.0
0.003,17,2,148,1,60,0.0,32.0,32.0,1,88,0.0,60.0,60.0
0.099,6,10,1506,5,395,21.0,127.0,127.0,5,1111,22.0,843.0,843.0
430.997,6,33,12051,18,2671,25352.0,585.0,345.0,15,9380,26496.0,1402.0,954.0
0.005,6,10,1989,5,927,1.0,659.0,659.0,5,1062,1.0,794.0,794.0
40.065,17,10,676,5,460,10013.0,104.0,64.0,5,216,10015.0,20.0,15.0
40.059,17,10,676,5,460,10014.0,104.0,64.0,5,216,10013.0,20.0,15.0
0.004,6,10,2007,5,928,1.0,660.0,660.0,5,1079,1.0,811.0,811.0
0.006,6,10,1643,5,860,1.0,592.0,592.0,5,783,1.0,515.0,515.0
0.123,6,10,1506,5,395,28.0,127.0,127.0,5,1111,26.0,843.0,843.0
0.006,17,2,148,1,60,0.0,32.0,32.0,1,88,0.0,60.0,60.0
240.018,6,9,787,5,488,60004.0,232.0,232.0,4,299,80004.0,83.0,83.0
0.005,6,10,2006,5,927,1.0,659.0,659.0,5,1079,1.0,811.0,811.0
0.006,6,10,2006,5,927,1.0,659.0,659.0,5,1079,1.0,811.0,811.0
0.006,6,10,1989,5,910,1.0,642.0,642.0,5,1079,1.0,811.0,811.0
0.004,6,10,2006,5,927,1.0,659.0,659.0,5,1079,1.0,811.0,811.0
0.003,17,4,284,2,120,0.0,32.0,32.0,2,164,0.0,60.0,54.0
0.008,6,12,1926,6,1189,1.0,659.0,434.0,6,737,1.0,417.0,417.0
0.005,17,2,164,1,74,0.0,46.0,46.0,1,90,0.0,62.0,62.0
0.005,6,10,2006,5,927,1.0,659.0,659.0,5,1079,1.0,811.0,811.0
0.006,17,2,179,1,71,0.0,43.0,43.0,1,108,0.0,80.0,80.0
9.04,17,6,376,5,280,2260.0,28.0,28.0,1,96,0.0,68.0,68.0
0.759,6,22,5168,11,1138,64.0,267.0,115.0,11,4030,63.0,1414.0,597.0
0.004,17,2,164,1,74,0.0,46.0,46.0,1,90,0.0,62.0,62.0
0.006,6,10,1689,5,839,1.0,571.0,571.0,5,850,1.0,582.0,582.0
0.034,6,10,1972,5,910,8.0,642.0,642.0,5,1062,8.0,794.0,794.0
0.005,6,13,3747,7,509,0.0,137.0,137.0,6,3238,1.0,1470.0,1459.0
0.027,6,10,1605,5,388,6.0,120.0,120.0,5,1217,6.0,949.0,949.0
0.004,6,10,1989,5,927,1.0,659.0,659.0,5,1062,1.0,794.0,794.0
0.075,6,10,1506,5,395,15.0,127.0,127.0,5,1111,17.0,843.0,843.0
40.068,17,10,676,5,460,10013.0,104.0,64.0,5,216,10016.0,20.0,15.0
9.036,17,6,376,5,280,2259.0,28.0,28.0,1,96,0.0,68.0,68.0
0.094,6,10,1506,5,395,20.0,127.0,127.0,5,1111,20.0,843.0,843.0
0.006,6,10,1547,5,764,1.0,496.0,496.0,5,783,1.0,515.0,515.0
0.012,6,10,1990,5,911,3.0,643.0,643.0,5,1079,3.0,811.0,811.0
0.006,6,10,1547,5,764,1.0,496.0,496.0,5,783,1.0,515.0,515.0
0.015,17,2,198,1,91,0.0,63.0,63.0,1,107,0.0,79.0,79.0
0.005,6,10,2006,5,927,1.0,659.0,659.0,5,1079,1.0,811.0,811.0
0.005,6,10,1989,5,927,1.0,659.0,659.0,5,1062,1.0,794.0,794.0
0.107,6,10,1506,5,395,20.0,127.0,127.0,5,1111,26.0,843.0,843.0
0.005,17,2,214,1,75,0.0,47.0,47.0,1,139,0.0,111.0,111.0
0.014,6,10,1989,5,910,3.0,642.0,642.0,5,1079,3.0,811.0,811.0
0.005,6,10,2007,5,928,1.0,660.0,660.0,5,1079,1.0,811.0,811.0
0.131,6,10,1506,5,395,30.0,127.0,127.0,5,1111,28.0,843.0,843.0
0.008,6,12,1926,6,1189,1.0,659.0,434.0,6,737,1.0,417.0,417.0
0.005,6,10,2007,5,928,1.0,660.0,660.0,5,1079,1.0,811.0,811.0
0.006,17,2,214,1,75,0.0,47.0,47.0,1,139,0.0,111.0,111.0
0.014,6,10,1983,5,910,3.0,642.0,642.0,5,1073,3.0,805.0,805.0
1798.361,17,2964,225753,1477,119748,1218.0,84.0,53.0,1487,106005,1210.0,227.0,43.0
0.005,6,10,2006,5,927,1.0,659.0,659.0,5,1079,1.0,811.0,811.0
0.076,17,8,3613,4,1874,25.0,1350.0,440.0,4,1739,11.0,1350.0,406.0
0.006,17,2,179,1,71,0.0,43.0,43.0,1,108,0.0,80.0,80.0
0.001,17,2,136,1,60,0.0,32.0,32.0,1,76,0.0,48.0,48.0
0.082,6,10,1506,5,395,18.0,127.0,127.0,5,1111,19.0,843.0,843.0
40.063,17,10,676,5,460,10014.0,104.0,64.0,5,216,10014.0,20.0,15.0
0.08,17,2,148,1,60,0.0,32.0,32.0,1,88,0.0,60.0,60.0
0.008,6,10,1990,5,911,2.0,643.0,643.0,5,1079,1.0,811.0,811.0
240.088,6,16,4480,9,963,30011.0,238.0,166.0,7,3517,40014.0,1402.0,786.0
0.005,6,10,1547,5,764,1.0,496.0,496.0,5,783,1.0,515.0,515.0
0.024,6,10,1677,5,827,6.0,559.0,559.0,5,850,5.0,582.0,582.0
0.001,17,2,180,1,66,0.0,38.0,38.0,1,114,0.0,86.0,86.0
11.442,17,28,4398,14,2312,867.0,587.0,137.0,14,2086,867.0,269.0,121.0
0.005,17,2,169,1,62,0.0,34.0,34.0,1,107,0.0,79.0,79.0
0.012,6,10,1972,5,910,3.0,642.0,642.0,5,1062,2.0,794.0,794.0
0.007,6,10,1774,5,923,1.0,655.0,655.0,5,851,1.0,583.0,583.0
0.0,17,2,166,1,75,0.0,47.0,47.0,1,91,0.0,63.0,63.0
0.013,6,10,1989,5,910,3.0,642.0,642.0,5,1079,3.0,811.0,811.0
301.213,6,54,25473,28,19406,11156.0,4080.0,1521.0,26,6067,361.0,2667.0,385.0
15.078,17,15,9255,8,6912,2149.0,1350.0,836.0,7,2343,2508.0,1350.0,306.0
5.087,6,21,5923,12,1436,462.0,474.0,201.0,9,4487,635.0,1925.0,804.0
0.006,6,10,1547,5,764,1.0,496.0,496.0,5,783,1.0,515.0,515.0
0.005,17,2,140,1,62,0.0,34.0,34.0,1,78,0.0,50.0,50.0
0.016,6,10,1983,5,910,3.0,642.0,642.0,5,1073,3.0,805.0,805.0
1777.847,17,144,45504,72,22752,25040.0,288.0,288.0,72,22752,25040.0,288.0,288.0
0.012,6,10,1972,5,910,2.0,642.0,642.0,5,1062,2.0,794.0,794.0
0.215,6,16,2779,8,1397,30.0,533.0,324.0,8,1382,19.0,529.0,239.0
0.005,6,10,2007,5,928,1.0,660.0,660.0,5,1079,1.0,811.0,811.0
0.038,17,2,136,1,60,0.0,32.0,32.0,1,76,0.0,48.0,48.0
0.014,6,10,1972,5,910,3.0,642.0,642.0,5,1062,3.0,794.0,794.0
11.104,17,28,4422,14,1994,842.0,269.0,114.0,14,2428,841.0,587.0,145.0
0.005,17,2,169,1,62,0.0,34.0,34.0,1,107,0.0,79.0,79.0
0.008,6,10,1989,5,910,2.0,642.0,642.0,5,1079,2.0,811.0,811.0
0.003,17,2,136,1,60,0.0,32.0,32.0,1,76,0.0,48.0,48.0
0.037,17,2,170,1,65,0.0,37.0,37.0,1,105,0.0,77.0,77.0
10.961,17,28,4400,14,2313,835.0,588.0,137.0,14,2087,835.0,270.0,121.0
292.544,6,325,344715,115,17524,2566.0,2686.0,888.0,210,327191,1399.0,2804.0,1613.0
0.07,6,10,1506,5,395,15.0,127.0,127.0,5,1111,16.0,843.0,843.0
0.001,17,2,180,1,66,0.0,38.0,38.0,1,114,0.0,86.0,86.0
0.005,17,2,140,1,62,0.0,34.0,34.0,1,78,0.0,50.0,50.0
0.112,6,10,1506,5,395,23.0,127.0,127.0,5,1111,24.0,843.0,843.0
0.004,6,10,2000,5,927,1.0,659.0,659.0,5,1073,1.0,805.0,805.0
0.085,6,10,1506,5,395,20.0,127.0,127.0,5,1111,20.0,843.0,843.0
0.007,17,2,179,1,71,0.0,43.0,43.0,1,108,0.0,80.0,80.0
0.018,6,10,1762,5,911,4.0,643.0,643.0,5,851,4.0,583.0,583.0
0.01,6,10,1989,5,910,2.0,642.0,642.0,5,1079,2.0,811.0,811.0
0.005,6,10,2007,5,928,1.0,660.0,660.0,5,1079,1.0,811.0,811.0
0.004,17,4,284,2,120,0.0,32.0,32.0,2,164,1.0,60.0,54.0
0.097,6,10,1506,5,395,19.0,127.0,127.0,5,1111,23.0,843.0,843.0
0.018,6,10,1972,5,910,4.0,642.0,642.0,5,1062,4.0,794.0,794.0
15.076,17,14,9190,8,6902,2149.0,1350.0,834.0,6,2288,3009.0,1350.0,353.0
0.091,6,10,1506,5,395,21.0,127.0,127.0,5,1111,18.0,843.0,843.0
0.08,6,10,1506,5,395,17.0,127.0,127.0,5,1111,15.0,843.0,843.0
40.046,17,10,676,5,460,10010.0,104.0,64.0,5,216,10010.0,20.0,15.0
240.104,6,16,4481,9,963,30013.0,238.0,166.0,7,3518,40016.0,1402.0,786.0
0.006,6,10,1547,5,764,1.0,496.0,496.0,5,783,1.0,515.0,515.0
240.189,6,27,14301,13,9289,20015.0,2736.0,1436.0,14,5012,18475.0,1656.0,1069.0
0.005,17,2,169,1,62,0.0,34.0,34.0,1,107,0.0,79.0,79.0
0.038,17,2,148,1,60,0.0,32.0,32.0,1,88,0.0,60.0,60.0
0.16,6,10,1506,5,395,38.0,127.0,127.0,5,1111,37.0,843.0,843.0
0.013,6,10,1989,5,910,3.0,642.0,642.0,5,1079,3.0,811.0,811.0
0.006,6,10,1547,5,764,1.0,496.0,496.0,5,783,1.0,515.0,515.0
0.005,17,2,170,1,65,0.0,37.0,37.0,1,105,0.0,77.0,77.0
44.783,6,43,17345,21,11438,452.0,4080.0,1761.0,22,5907,2124.0,2667.0,385.0
0.006,6,10,1989,5,927,1.0,659.0,659.0,5,1062,1.0,794.0,794.0
0.005,6,10,1702,5,863,1.0,595.0,595.0,5,839,1.0,571.0,571.0
19.029,17,50,10995,25,5782,787.0,1337.0,203.0,25,5213,788.0,861.0,180.0
0.094,17,2,144,1,64,0.0,36.0,36.0,1,80,0.0,52.0,52.0
0.006,6,10,1547,5,764,1.0,496.0,496.0,5,783,1.0,515.0,515.0
0.116,6,10,1506,5,395,24.0,127.0,127.0,5,1111,26.0,843.0,843.0
0.011,6,10,1989,5,910,2.0,642.0,642.0,5,1079,2.0,811.0,811.0
0.006,6,10,1689,5,839,1.0,571.0,571.0,5,850,1.0,582.0,582.0
0.089,6,10,1506,5,395,18.0,127.0,127.0,5,1111,20.0,843.0,843.0
240.184,6,45,6419,21,3169,12009.0,588.0,229.0,24,3250,10441.0,580.0,181.0
0.102,6,10,1506,5,395,22.0,127.0,127.0,5,1111,21.0,843.0,843.0
0.083,6,10,1506,5,395,18.0,127.0,127.0,5,1111,15.0,843.0,843.0
0.006,6,10,2006,5,927,1.0,659.0,659.0,5,1079,1.0,811.0,811.0
0.032,6,10,1989,5,910,8.0,642.0,642.0,5,1079,8.0,811.0,811.0
40.053,17,10,676,5,460,10012.0,104.0,64.0,5,216,10012.0,20.0,15.0
0.069,6,10,1506,5,395,15.0,127.0,127.0,5,1111,14.0,843.0,843.0
0.001,17,2,180,1,66,0.0,38.0,38.0,1,114,0.0,86.0,86.0
0.005,6,10,2006,5,927,1.0,659.0,659.0,5,1079,1.0,811.0,811.0
0.001,17,2,180,1,66,0.0,38.0,38.0,1,114,0.0,86.0,86.0
386.711,6,28,4357,12,3102,10912.0,494.0,494.0,16,1255,25780.0,83.0,83.0
0.005,6,10,2000,5,927,1.0,659.0,659.0,5,1073,1.0,805.0,805.0
0.004,17,2,178,1,81,0.0,53.0,53.0,1,97,0.0,69.0,69.0
0.001,17,2,136,1,60,0.0,32.0,32.0,1,76,0.0,48.0,48.0
0.012,6,10,1990,5,911,2.0,643.0,643.0,5,1079,3.0,811.0,811.0
0.003,17,2,148,1,60,0.0,32.0,32.0,1,88,0.0,60.0,60.0
0.117,6,10,1506,5,395,27.0,127.0,127.0,5,1111,24.0,843.0,843.0
0.01,6,10,1762,5,911,2.0,643.0,643.0,5,851,2.0,583.0,583.0
0.011,6,10,1762,5,911,2.0,643.0,643.0,5,851,2.0,583.0,583.0
40.089,17,10,676,5,460,10014.0,104.0,64.0,5,216,10021.0,20.0,15.0
0.005,6,10,2006,5,927,1.0,659.0,659.0,5,1079,1.0,811.0,811.0
0.012,6,10,1983,5,910,3.0,642.0,642.0,5,1073,3.0,805.0,805.0
0.005,6,10,1547,5,764,1.0,496.0,496.0,5,783,1.0,515.0,515.0
0.009,6,12,1926,6,1189,1.0,659.0,434.0,6,737,1.0,417.0,417.0
310.387,17,18,1008,9,640,38782.0,48.0,43.0,9,368,38782.0,20.0,12.0
241.176,6,311,343916,123,17900,1976.0,2736.0,885.0,188,326016,1289.0,2804.0,1776.0
240.018,6,9,787,5,488,60004.0,232.0,232.0,4,299,80005.0,83.0,83.0
0.007,6,10,1547,5,764,1.0,496.0,496.0,5,783,1.0,515.0,515.0
0.082,6,10,1506,5,395,18.0,127.0,127.0,5,1111,15.0,843.0,843.0
0.005,6,10,1854,5,889,1.0,621.0,621.0,5,965,1.0,697.0,697.0
0.011,6,13,3913,7,495,1.0,123.0,123.0,6,3418,2.0,1650.0,1549.0
0.029,17,2,152,1,56,0.0,28.0,28.0,1,96,0.0,68.0,68.0
0.27,17,41,20489,23,17144,12.0,1350.0,717.0,18,3345,12.0,1350.0,157.0
0.131,6,10,1506,5,395,29.0,127.0,127.0,5,1111,19.0,843.0,843.0
0.018,6,10,1990,5,911,4.0,643.0,643.0,5,1079,4.0,811.0,811.0
0.01,6,10,1762,5,911,2.0,643.0,643.0,5,851,2.0,583.0,583.0
0.069,17,8,3613,4,1874,23.0,1350.0,440.0,4,1739,12.0,1350.0,406.0
0.004,6,10,2000,5,927,1.0,659.0,659.0,5,1073,1.0,805.0,805.0
300.014,6,11,891,6,552,60002.0,232.0,232.0,5,339,75003.0,83.0,83.0
0.004,6,10,1989,5,927,1.0,659.0,659.0,5,1062,1.0,794.0,794.0
0.001,17,2,166,1,75,0.0,47.0,47.0,1,91,0.0,63.0,63.0
0.009,6,10,1989,5,910,2.0,642.0,642.0,5,1079,2.0,811.0,811.0
0.011,6,10,1990,5,911,2.0,643.0,643.0,5,1079,2.0,811.0,811.0
291.002,6,308,343833,111,17336,2645.0,2736.0,889.0,197,326497,1484.0,2804.0,1728.0
0.004,6,10,1989,5,927,1.0,659.0,659.0,5,1062,1.0,794.0,794.0
0.041,17,4,284,2,120,0.0,32.0,32.0,2,164,5.0,60.0,54.0
0.027,6,10,1990,5,911,6.0,643.0,643.0,5,1079,6.0,811.0,811.0
0.02,17,2,140,1,62,0.0,34.0,34.0,1,78,0.0,50.0,50.0
0.114,6,10,1506,5,395,26.0,127.0,127.0,5,1111,25.0,843.0,843.0
0.041,17,4,420,2,122,0.0,33.0,33.0,2,298,4.0,145.0,121.0
0.009,6,10,1989,5,910,2.0,642.0,642.0,5,1079,2.0,811.0,811.0
0.005,6,10,2006,5,927,1.0,659.0,659.0,5,1079,1.0,811.0,811.0
0.004,6,10,1989,5,927,1.0,659.0,659.0,5,1062,1.0,794.0,794.0
0.066,6,10,1506,5,395,15.0,127.0,127.0,5,1111,14.0,843.0,843.0
0.004,6,10,1702,5,863,1.0,595.0,595.0,5,839,1.0,571.0,571.0
0.006,6,10,1689,5,839,1.0,571.0,571.0,5,850,1.0,582.0,582.0
0.005,17,2,214,1,75,0.0,47.0,47.0,1,139,0.0,111.0,111.0
0.084,6,10,1506,5,395,20.0,127.0,127.0,5,1111,19.0,843.0,843.0
0.004,6,10,1702,5,863,1.0,595.0,595.0,5,839,1.0,571.0,571.0
0.013,6,10,1989,5,910,3.0,642.0,642.0,5,1079,3.0,811.0,811.0
0.001,17,2,180,1,66,0.0,38.0,38.0,1,114,0.0,86.0,86.0
0.004,17,2,148,1,60,0.0,32.0,32.0,1,88,0.0,60.0,60.0
0.233,6,16,2777,8,1395,33.0,533.0,323.0,8,1382,21.0,529.0,239.0
242.74,6,31,12301,17,1708,15171.0,260.0,207.0,14,10593,18669.0,1561.0,985.0
0.074,6,10,1506,5,395,16.0,127.0,127.0,5,1111,15.0,843.0,843.0
0.1,6,10,1506,5,395,21.0,127.0,127.0,5,1111,22.0,843.0,843.0
15.076,17,15,9238,8,6902,2149.0,1350.0,834.0,7,2336,2507.0,1350.0,305.0
0.162,6,10,1506,5,395,37.0,127.0,127.0,5,1111,33.0,843.0,843.0
0.005,6,10,1779,5,928,1.0,660.0,660.0,5,851,1.0,583.0,583.0
15.286,17,42,21722,23,18475,693.0,1350.0,775.0,19,3247,847.0,1350.0,142.0
352.855,6,20,2210,6,1308,12003.0,494.0,494.0,14,902,27142.0,83.0,83.0
40.06,17,10,676,5,460,10013.0,104.0,64.0,5,216,10013.0,20.0,15.0
0.006,6,10,2006,5,927,1.0,659.0,659.0,5,1079,1.0,811.0,811.0
0.005,17,2,214,1,75,0.0,47.0,47.0,1,139,0.0,111.0,111.0
0.111,6,10,1506,5,395,24.0,127.0,127.0,5,1111,23.0,843.0,843.0
0.004,6,10,2006,5,927,1.0,659.0,659.0,5,1079,1.0,811.0,811.0
164.499,17,78,11202,39,2609,4328.0,44.0,38.0,39,8593,4328.0,261.0,192.0
40.063,17,10,676,5,460,10014.0,104.0,64.0,5,216,10014.0,20.0,15.0
0.004,6,10,2007,5,928,1.0,660.0,660.0,5,1079,1.0,811.0,811.0
0.017,6,14,3787,7,497,2.0,125.0,125.0,7,3290,2.0,1448.0,972.0
1799.763,17,2842,217567,1413,114484,1274.0,84.0,53.0,1429,103083,1260.0,227.0,44.0
40.063,17,10,676,5,460,10014.0,104.0,64.0,5,216,10014.0,20.0,15.0
240.094,6,31,8958,15,6576,17149.0,1699.0,644.0,16,2382,16006.0,580.0,192.0
0.081,6,10,1506,5,395,16.0,127.0,127.0,5,1111,18.0,843.0,843.0
0.011,6,10,1605,5,388,2.0,120.0,120.0,5,1217,2.0,949.0,949.0
0.095,6,10,1506,5,395,19.0,127.0,127.0,5,1111,21.0,843.0,843.0
40.055,17,10,676,5,460,10012.0,104.0,64.0,5,216,10013.0,20.0,15.0
0.005,6,10,2007,5,928,1.0,660.0,660.0,5,1079,1.0,811.0,811.0
0.004,6,14,3742,7,452,0.0,80.0,80.0,7,3290,0.0,1448.0,972.0
0.013,6,10,1762,5,911,3.0,643.0,643.0,5,851,3.0,583.0,583.0
1119.174,6,155,21712,59,15754,19296.0,2720.0,279.0,96,5958,11779.0,148.0,48.0
0.011,6,10,1990,5,911,2.0,643.0,643.0,5,1079,2.0,811.0,811.0
0.004,6,10,2007,5,928,1.0,660.0,660.0,5,1079,1.0,811.0,811.0
0.005,6,10,2000,5,927,1.0,659.0,659.0,5,1073,1.0,805.0,805.0
0.005,17,2,154,1,69,0.0,41.0,41.0,1,85,0.0,57.0,57.0
0.005,6,13,3747,7,509,0.0,137.0,137.0,6,3238,0.0,1470.0,1459.0
0.005,6,10,2006,5,927,1.0,659.0,659.0,5,1079,1.0,811.0,811.0
0.094,6,10,1506,5,395,18.0,127.0,127.0,5,1111,22.0,843.0,843.0
0.005,6,10,2000,5,927,1.0,659.0,659.0,5,1073,1.0,805.0,805.0
0.015,6,10,1990,5,911,3.0,643.0,643.0,5,1079,3.0,811.0,811.0
0.005,6,13,3690,7,452,0.0,80.0,80.0,6,3238,1.0,1470.0,1459.0
0.117,6,10,1506,5,395,26.0,127.0,127.0,5,1111,26.0,843.0,843.0
0.018,17,2,136,1,60,0.0,32.0,32.0,1,76,0.0,48.0,48.0
40.087,17,10,676,5,460,10020.0,104.0,64.0,5,216,10020.0,20.0,15.0
40.059,17,10,676,5,460,10012.0,104.0,64.0,5,216,10014.0,20.0,15.0
0.005,6,10,2006,5,927,1.0,659.0,659.0,5,1079,1.0,811.0,811.0
0.007,6,10,1990,5,911,1.0,643.0,643.0,5,1079,1.0,811.0,811.0
0.004,6,10,1702,5,863,1.0,595.0,595.0,5,839,0.0,571.0,571.0
0.17,17,2,152,1,76,0.0,48.0,48.0,1,76,0.0,48.0,48.0
0.005,6,10,1774,5,923,1.0,655.0,655.0,5,851,1.0,583.0,583.0
0.004,6,14,3742,7,452,0.0,80.0,80.0,7,3290,0.0,1448.0,972.0
0.001,17,2,180,1,66,0.0,38.0,38.0,1,114,0.0,86.0,86.0
0.005,6,10,1774,5,923,1.0,655.0,655.0,5,851,1.0,583.0,583.0
240.111,6,28,6799,14,4618,18470.0,1368.0,486.0,14,2181,18469.0,580.0,180.0
0.01,6,12,1926,6,1189,1.0,659.0,434.0,6,737,2.0,417.0,417.0
0.013,17,2,179,1,71,0.0,43.0,43.0,1,108,0.0,80.0,80.0
0.013,6,10,1989,5,910,3.0,642.0,642.0,5,1079,3.0,811.0,811.0
40.067,17,10,676,5,460,10015.0,104.0,64.0,5,216,10016.0,20.0,15.0
0.004,17,2,136,1,60,0.0,32.0,32.0,1,76,0.0,48.0,48.0
0.008,6,10,1990,5,911,2.0,643.0,643.0,5,1079,2.0,811.0,811.0
0.005,6,10,2006,5,927,1.0,659.0,659.0,5,1079,1.0,811.0,811.0
0.004,6,10,2007,5,928,1.0,660.0,660.0,5,1079,1.0,811.0,811.0
0.098,6,10,1506,5,395,21.0,127.0,127.0,5,1111,21.0,843.0,843.0
0.004,6,10,1702,5,863,1.0,595.0,595.0,5,839,1.0,571.0,571.0
0.106,6,10,1506,5,395,24.0,127.0,127.0,5,1111,25.0,843.0,843.0
0.005,6,10,2007,5,928,1.0,660.0,660.0,5,1079,1.0,811.0,811.0
0.005,6,10,1989,5,927,1.0,659.0,659.0,5,1062,1.0,794.0,794.0
0.139,6,10,1506,5,395,33.0,127.0,127.0,5,1111,16.0,843.0,843.0
0.008,6,10,1989,5,910,2.0,642.0,642.0,5,1079,2.0,811.0,811.0
0.042,17,2,148,1,60,0.0,32.0,32.0,1,88,0.0,60.0,60.0
0.006,6,10,1547,5,764,1.0,496.0,496.0,5,783,1.0,515.0,515.0
0.001,17,2,180,1,66,0.0,38.0,38.0,1,114,0.0,86.0,86.0
0.068,6,10,1506,5,395,15.0,127.0,127.0,5,1111,14.0,843.0,843.0
0.04,17,4,284,2,120,0.0,32.0,32.0,2,164,36.0,60.0,54.0
0.005,6,10,1689,5,839,1.0,571.0,571.0,5,850,1.0,582.0,582.0
10.751,17,28,4422,14,1995,818.0,270.0,114.0,14,2427,818.0,586.0,145.0
0.006,6,10,1689,5,839,1.0,571.0,571.0,5,850,1.0,582.0,582.0
0.006,6,10,2006,5,927,1.0,659.0,659.0,5,1079,1.0,811.0,811.0
0.038,17,2,198,1,91,0.0,63.0,63.0,1,107,0.0,79.0,79.0
0.112,17,2,168,1,76,0.0,48.0,48.0,1,92,0.0,64.0,64.0
1769.76,6,84,4419,42,2211,43163.0,27.0,27.0,42,2208,43163.0,24.0,24.0
0.015,6,10,1990,5,911,3.0,643.0,643.0,5,1079,3.0,811.0,811.0
0.011,6,10,1989,5,910,2.0,642.0,642.0,5,1079,2.0,811.0,811.0
177.321,17,80,11632,40,2690,4546.0,44.0,39.0,40,8942,4546.0,252.0,195.0
0.006,6,10,1547,5,764,1.0,496.0,496.0,5,783,1.0,515.0,515.0
0.005,17,2,180,1,58,0.0,30.0,30.0,1,122,0.0,94.0,94.0
0.019,6,10,1762,5,911,4.0,643.0,643.0,5,851,4.0,583.0,583.0
0.076,6,10,1506,5,395,18.0,127.0,127.0,5,1111,15.0,843.0,843.0
0.006,6,10,1989,5,927,1.0,659.0,659.0,5,1062,1.0,794.0,794.0
0.095,6,10,1506,5,395,20.0,127.0,127.0,5,1111,21.0,843.0,843.0
356.59,6,21,1795,16,1030,23772.0,190.0,190.0,5,765,60005.0,464.0,248.0
0.003,17,2,185,1,73,0.0,45.0,45.0,1,112,0.0,84.0,84.0
0.013,17,2,152,1,56,0.0,28.0,28.0,1,96,0.0,68.0,68.0
0.128,6,10,1506,5,395,27.0,127.0,127.0,5,1111,24.0,843.0,843.0
1798.562,17,2741,209585,1368,110861,1315.0,84.0,53.0,1373,98724,1310.0,227.0,43.0
10.927,17,28,4418,14,1994,832.0,269.0,114.0,14,2424,831.0,587.0,145.0
0.073,6,10,1506,5,395,17.0,127.0,127.0,5,1111,14.0,843.0,843.0
0.004,6,10,1779,5,928,1.0,660.0,660.0,5,851,1.0,583.0,583.0
0.005,17,2,170,1,65,0.0,37.0,37.0,1,105,0.0,77.0,77.0
0.01,6,10,1972,5,910,2.0,642.0,642.0,5,1062,2.0,794.0,794.0
240.101,6,16,4481,9,963,30012.0,238.0,166.0,7,3518,40016.0,1402.0,786.0
0.009,6,14,3787,7,497,1.0,125.0,125.0,7,3290,1.0,1448.0,972.0
0.005,17,2,144,1,64,0.0,36.0,36.0,1,80,0.0,52.0,52.0
0.217,6,16,2777,8,1395,31.0,533.0,323.0,8,1382,19.0,529.0,239.0
0.006,6,10,1689,5,839,1.0,571.0,571.0,5,850,1.0,582.0,582.0
285.217,6,30,6574,16,1433,19014.0,517.0,290.0,14,5141,21939.0,2379.0,1104.0
0.006,17,2,180,1,66,0.0,38.0,38.0,1,114,0.0,86.0,86.0
0.12,6,10,1506,5,395,26.0,127.0,127.0,5,1111,28.0,843.0,843.0
0.014,6,10,1972,5,910,3.0,642.0,642.0,5,1062,3.0,794.0,794.0
0.005,17,2,170,1,65,0.0,37.0,37.0,1,105,0.0,77.0,77.0
0.01,6,10,1631,5,848,2.0,580.0,580.0,5,783,2.0,515.0,515.0
0.004,17,2,412,1,61,0.0,33.0,33.0,1,351,0.0,323.0,323.0
0.175,6,10,1506,5,395,40.0,127.0,127.0,5,1111,40.0,843.0,843.0
10.836,17,28,4420,14,1995,824.0,270.0,114.0,14,2425,824.0,588.0,145.0
0.003,17,4,284,2,120,0.0,32.0,32.0,2,164,0.0,60.0,54.0
0.005,6,10,1854,5,889,1.0,621.0,621.0,5,965,1.0,697.0,697.0
0.005,6,10,1989,5,927,1.0,659.0,659.0,5,1062,1.0,794.0,794.0
0.005,6,10,2006,5,927,1.0,659.0,659.0,5,1079,1.0,811.0,811.0
0.005,6,10,2000,5,927,1.0,659.0,659.0,5,1073,1.0,805.0,805.0
0.005,6,10,2007,5,928,1.0,660.0,660.0,5,1079,1.0,811.0,811.0
0.022,6,10,1605,5,388,5.0,120.0,120.0,5,1217,5.0,949.0,949.0
0.002,17,2,180,1,66,0.0,38.0,38.0,1,114,0.0,86.0,86.0
0.005,6,13,3747,7,509,0.0,137.0,137.0,6,3238,1.0,1470.0,1459.0
0.005,6,10,2007,5,928,1.0,660.0,660.0,5,1079,1.0,811.0,811.0
0.175,17,2,152,1,76,0.0,48.0,48.0,1,76,0.0,48.0,48.0
0.005,6,10,2006,5,927,1.0,659.0,659.0,5,1079,1.0,811.0,811.0
0.005,17,2,144,1,64,0.0,36.0,36.0,1,80,0.0,52.0,52.0
0.054,17,2,152,1,76,0.0,48.0,48.0,1,76,0.0,48.0,48.0
40.082,17,10,676,5,460,10017.0,104.0,64.0,5,216,10019.0,20.0,15.0
40.059,17,10,676,5,460,10012.0,104.0,64.0,5,216,10014.0,20.0,15.0
0.017,6,10,1972,5,910,4.0,642.0,642.0,5,1062,4.0,794.0,794.0
0.007,6,10,1854,5,889,1.0,621.0,621.0,5,965,1.0,697.0,697.0
0.008,6,12,1926,6,1189,1.0,659.0,434.0,6,737,1.0,417.0,417.0
0.103,6,10,1506,5,395,23.0,127.0,127.0,5,1111,24.0,843.0,843.0
0.006,6,10,1643,5,860,1.0,592.0,592.0,5,783,1.0,515.0,515.0
0.09,6,10,1506,5,395,19.0,127.0,127.0,5,1111,18.0,843.0,843.0
0.041,17,2,156,1,64,0.0,36.0,36.0,1,92,0.0,64.0,64.0
0.084,6,10,1506,5,395,18.0,127.0,127.0,5,1111,16.0,843.0,843.0
0.014,6,10,1989,5,910,3.0,642.0,642.0,5,1079,3.0,811.0,811.0
0.022,6,10,1762,5,911,5.0,643.0,643.0,5,851,5.0,583.0,583.0
0.007,17,2,194,1,59,0.0,31.0,31.0,1,135,0.0,107.0,107.0
0.119,6,10,1506,5,395,28.0,127.0,127.0,5,1111,28.0,843.0,843.0
0.126,17,4,596,2,122,0.0,33.0,33.0,2,474,87.0,323.0,209.0
0.017,6,14,3787,7,497,2.0,125.0,125.0,7,3290,2.0,1448.0,972.0
0.012,6,10,1762,5,911,3.0,643.0,643.0,5,851,3.0,583.0,583.0
0.014,6,10,1762,5,911,3.0,643.0,643.0,5,851,3.0,583.0,583.0
0.004,6,10,1702,5,863,1.0,595.0,595.0,5,839,0.0,571.0,571.0
0.001,17,2,180,1,66,0.0,38.0,38.0,1,114,0.0,86.0,86.0
0.01,6,10,1989,5,910,2.0,642.0,642.0,5,1079,2.0,811.0,811.0
0.072,17,8,3613,4,1874,24.0,1350.0,440.0,4,1739,12.0,1350.0,406.0
0.005,6,10,2000,5,927,1.0,659.0,659.0,5,1073,1.0,805.0,805.0
0.007,6,10,1983,5,910,1.0,642.0,642.0,5,1073,1.0,805.0,805.0
0.004,6,10,1702,5,863,1.0,595.0,595.0,5,839,0.0,571.0,571.0
0.01,6,10,1972,5,910,2.0,642.0,642.0,5,1062,2.0,794.0,794.0
0.004,6,10,1702,5,863,1.0,595.0,595.0,5,839,0.0,571.0,571.0
1730.362,6,45,2790,30,1725,59667.0,35.0,35.0,15,1065,123588.0,31.0,31.0
0.016,6,10,1983,5,910,4.0,642.0,642.0,5,1073,3.0,805.0,805.0
0.14,6,10,1506,5,395,29.0,127.0,127.0,5,1111,27.0,843.0,843.0
0.012,6,10,1990,5,911,2.0,643.0,643.0,5,1079,3.0,811.0,811.0
0.043,17,2,152,1,76,0.0,48.0,48.0,1,76,0.0,48.0,48.0
0.001,17,2,180,1,66,0.0,38.0,38.0,1,114,0.0,86.0,86.0
0.042,17,2,152,1,76,0.0,48.0,48.0,1,76,0.0,48.0,48.0
0.016,6,10,1989,5,910,4.0,642.0,642.0,5,1079,3.0,811.0,811.0
0.005,17,2,166,1,75,0.0,47.0,47.0,1,91,0.0,63.0,63.0
0.005,6,10,1989,5,927,1.0,659.0,659.0,5,1062,1.0,794.0,794.0
240.172,6,18,7342,10,2076,26685.0,1368.0,520.0,8,5266,34309.0,2802.0,1210.0
0.046,17,2,152,1,76,0.0,48.0,48.0,1,76,0.0,48.0,48.0
0.049,6,10,1989,5,910,12.0,642.0,642.0,5,1079,12.0,811.0,811.0
300.321,6,16,2170,9,684,37519.0,146.0,146.0,7,1486,50026.0,419.0,398.0
0.004,17,2,148,1,60,0.0,32.0,32.0,1,88,0.0,60.0,60.0
0.006,6,10,1547,5,764,1.0,496.0,496.0,5,783,1.0,515.0,515.0
0.179,6,10,1506,5,395,43.0,127.0,127.0,5,1111,39.0,843.0,843.0
240.074,6,20,4874,11,941,24007.0,180.0,93.0,9,3933,30009.0,1593.0,576.0
0.003,17,2,136,1,60,0.0,32.0,32.0,1,76,0.0,48.0,48.0
0.003,17,2,148,1,60,0.0,32.0,32.0,1,88,0.0,60.0,60.0
9.041,17,6,376,5,280,2260.0,28.0,28.0,1,96,0.0,68.0,68.0
0.01,6,10,1990,5,911,2.0,643.0,643.0,5,1079,2.0,811.0,811.0
0.098,6,10,1506,5,395,22.0,127.0,127.0,5,1111,22.0,843.0,843.0
0.012,6,10,1972,5,910,3.0,642.0,642.0,5,1062,3.0,794.0,794.0
0.004,6,10,2000,5,927,1.0,659.0,659.0,5,1073,1.0,805.0,805.0
0.006,17,2,170,1,65,0.0,37.0,37.0,1,105,0.0,77.0,77.0
0.04,17,4,352,2,130,1.0,37.0,37.0,2,222,35.0,89.0,83.0
0.006,6,10,1689,5,839,1.0,571.0,571.0,5,850,1.0,582.0,582.0
0.004,6,10,1779,5,928,1.0,660.0,660.0,5,851,1.0,583.0,583.0
40.059,17,10,676,5,460,10014.0,104.0,64.0,5,216,10013.0,20.0,15.0
0.011,6,10,1631,5,848,2.0,580.0,580.0,5,783,2.0,515.0,515.0
40.059,17,10,676,5,460,10012.0,104.0,64.0,5,216,10014.0,20.0,15.0
0.015,6,10,1631,5,848,3.0,580.0,580.0,5,783,3.0,515.0,515.0
0.004,6,10,1774,5,923,1.0,655.0,655.0,5,851,0.0,583.0,583.0
0.004,6,10,2007,5,928,1.0,660.0,660.0,5,1079,1.0,811.0,811.0
0.073,6,10,1506,5,395,15.0,127.0,127.0,5,1111,15.0,843.0,843.0
0.109,6,10,1506,5,395,26.0,127.0,127.0,5,1111,22.0,843.0,843.0
0.005,6,10,1643,5,860,1.0,592.0,592.0,5,783,1.0,515.0,515.0
0.073,17,2,186,1,61,0.0,33.0,33.0,1,125,0.0,97.0,97.0
0.015,6,10,1989,5,910,3.0,642.0,642.0,5,1079,3.0,811.0,811.0
0.052,17,2,152,1,76,0.0,48.0,48.0,1,76,0.0,48.0,48.0
0.026,6,14,3868,7,578,4.0,206.0,206.0,7,3290,4.0,1448.0,972.0
308.31,17,19,1084,10,716,34243.0,48.0,43.0,9,368,38514.0,20.0,12.0
0.012,6,10,1989,5,910,3.0,642.0,642.0,5,1079,3.0,811.0,811.0
0.001,17,2,180,1,66,0.0,38.0,38.0,1,114,0.0,86.0,86.0
0.002,17,2,136,1,60,0.0,32.0,32.0,1,76,0.0,48.0,48.0
0.016,6,10,1989,5,910,4.0,642.0,642.0,5,1079,3.0,811.0,811.0
0.137,17,2,152,1,76,0.0,48.0,48.0,1,76,0.0,48.0,48.0
40.053,17,10,676,5,460,10012.0,104.0,64.0,5,216,10012.0,20.0,15.0
0.077,17,4,596,2,122,0.0,33.0,33.0,2,474,31.0,323.0,209.0
354.02,6,21,1795,16,1030,23601.0,190.0,190.0,5,765,60001.0,464.0,248.0
0.017,6,10,1972,5,910,4.0,642.0,642.0,5,1062,4.0,794.0,794.0
0.079,6,10,1506,5,395,16.0,127.0,127.0,5,1111,18.0,843.0,843.0
0.016,6,10,1983,5,910,3.0,642.0,642.0,5,1073,4.0,805.0,805.0
0.017,6,10,1762,5,911,4.0,643.0,643.0,5,851,4.0,583.0,583.0
0.001,17,2,180,1,66,0.0,38.0,38.0,1,114,0.0,86.0,86.0
0.016,6,10,1989,5,910,3.0,642.0,642.0,5,1079,3.0,811.0,811.0
0.007,17,2,230,1,68,0.0,40.0,40.0,1,162,0.0,134.0,134.0
0.012,6,10,1972,5,910,3.0,642.0,642.0,5,1062,2.0,794.0,794.0
0.077,6,10,1506,5,395,17.0,127.0,127.0,5,1111,14.0,843.0,843.0
0.014,6,10,1990,5,911,3.0,643.0,643.0,5,1079,3.0,811.0,811.0
0.003,17,2,152,1,76,0.0,48.0,48.0,1,76,0.0,48.0,48.0
0.008,6,10,1762,5,911,2.0,643.0,643.0,5,851,2.0,583.0,583.0
321.004,17,18,1008,9,640,40110.0,48.0,43.0,9,368,40108.0,20.0,12.0
0.003,17,2,148,1,60,0.0,32.0,32.0,1,88,0.0,60.0,60.0
0.014,6,14,3787,7,497,2.0,125.0,125.0,7,3290,2.0,1448.0,972.0
0.09,6,10,1506,5,395,18.0,127.0,127.0,5,1111,21.0,843.0,843.0
0.133,17,4,420,2,122,0.0,33.0,33.0,2,298,8.0,145.0,121.0
0.006,17,2,170,1,65,0.0,37.0,37.0,1,105,0.0,77.0,77.0
0.012,6,13,3735,7,497,2.0,125.0,125.0,6,3238,2.0,1470.0,1459.0
0.096,6,10,1506,5,395,21.0,127.0,127.0,5,1111,19.0,843.0,843.0
0.005,17,2,179,1,71,0.0,43.0,43.0,1,108,0.0,80.0,80.0
0.012,6,10,1631,5,848,2.0,580.0,580.0,5,783,3.0,515.0,515.0
294.3,6,331,344613,124,17986,2392.0,2736.0,887.0,207,326627,1428.0,2804.0,1636.0
0.005,6,10,1774,5,923,1.0,655.0,655.0,5,851,1.0,583.0,583.0
167.082,17,74,10623,37,2478,4641.0,44.0,38.0,37,8145,4641.0,239.0,192.0
0.15,6,10,1506,5,395,26.0,127.0,127.0,5,1111,34.0,843.0,843.0
294.535,6,324,345331,121,18478,2454.0,2736.0,870.0,203,326853,1458.0,2804.0,1682.0
15.141,17,20,13503,10,8344,1678.0,1350.0,806.0,10,5159,1679.0,1350.0,487.0
0.005,17,2,213,1,69,0.0,41.0,41.0,1,144,0.0,116.0,116.0
0.139,6,10,1506,5,395,29.0,127.0,127.0,5,1111,31.0,843.0,843.0
0.005,6,10,1854,5,889,1.0,621.0,621.0,5,965,1.0,697.0,697.0
0.007,17,2,146,1,65,0.0,37.0,37.0,1,81,0.0,53.0,53.0
0.008,6,10,1989,5,910,2.0,642.0,642.0,5,1079,2.0,811.0,811.0
0.001,17,2,178,1,81,0.0,53.0,53.0,1,97,0.0,69.0,69.0
0.006,17,2,179,1,71,0.0,43.0,43.0,1,108,0.0,80.0,80.0
0.085,6,10,1506,5,395,17.0,127.0,127.0,5,1111,18.0,843.0,843.0
40.071,17,10,676,5,460,10016.0,104.0,64.0,5,216,10016.0,20.0,15.0
0.005,17,2,166,1,75,0.0,47.0,47.0,1,91,0.0,63.0,63.0
0.098,6,10,1506,5,395,22.0,127.0,127.0,5,1111,22.0,843.0,843.0
0.006,6,10,2007,5,928,1.0,660.0,660.0,5,1079,1.0,811.0,811.0
170.042,17,86,12007,43,2862,4048.0,44.0,38.0,43,9145,4048.0,249.0,184.0
0.005,17,2,179,1,71,0.0,43.0,43.0,1,108,0.0,80.0,80.0
0.012,6,10,1989,5,910,3.0,642.0,642.0,5,1079,3.0,811.0,811.0
0.176,6,3,453,2,321,176.0,241.0,241.0,1,132,0.0,92.0,92.0
0.004,6,10,2000,5,927,1.0,659.0,659.0,5,1073,1.0,805.0,805.0
0.114,6,10,1506,5,395,26.0,127.0,127.0,5,1111,25.0,843.0,843.0
0.003,17,2,148,1,60,0.0,32.0,32.0,1,88,0.0,60.0,60.0
0.01,6,10,1989,5,910,2.0,642.0,642.0,5,1079,2.0,811.0,811.0
0.039,17,2,148,1,60,0.0,32.0,32.0,1,88,0.0,60.0,60.0
0.004,17,2,148,1,60,0.0,32.0,32.0,1,88,0.0,60.0,60.0
0.015,17,2,198,1,91,0.0,63.0,63.0,1,107,0.0,79.0,79.0
0.073,17,2,184,1,61,0.0,33.0,33.0,1,123,0.0,95.0,95.0
0.006,6,10,1689,5,839,1.0,571.0,571.0,5,850,1.0,582.0,582.0
0.005,17,2,170,1,65,0.0,37.0,37.0,1,105,0.0,77.0,77.0
0.001,17,2,180,1,66,0.0,38.0,38.0,1,114,0.0,86.0,86.0
0.004,17,2,148,1,60,0.0,32.0,32.0,1,88,0.0,60.0,60.0
0.004,6,10,1989,5,927,1.0,659.0,659.0,5,1062,1.0,794.0,794.0
0.005,6,10,1854,5,889,1.0,621.0,621.0,5,965,1.0,697.0,697.0
0.009,6,10,1989,5,910,2.0,642.0,642.0,5,1079,2.0,811.0,811.0
0.184,6,10,1506,5,395,45.0,127.0,127.0,5,1111,42.0,843.0,843.0
0.006,17,2,179,1,71,0.0,43.0,43.0,1,108,0.0,80.0,80.0
0.006,6,10,1989,5,927,1.0,659.0,659.0,5,1062,1.0,794.0,794.0
0.011,6,13,3735,7,497,1.0,125.0,125.0,6,3238,2.0,1470.0,1459.0
0.03,17,2,136,1,60,0.0,32.0,32.0,1,76,0.0,48.0,48.0
0.017,6,10,1631,5,848,4.0,580.0,580.0,5,783,4.0,515.0,515.0
0.003,17,2,136,1,60,0.0,32.0,32.0,1,76,0.0,48.0,48.0
0.012,6,13,3735,7,497,2.0,125.0,125.0,6,3238,2.0,1470.0,1459.0
0.005,6,10,1989,5,927,1.0,659.0,659.0,5,1062,1.0,794.0,794.0
0.004,6,10,2007,5,928,1.0,660.0,660.0,5,1079,1.0,811.0,811.0
0.081,6,10,1506,5,395,19.0,127.0,127.0,5,1111,17.0,843.0,843.0
0.013,6,10,1989,5,910,3.0,642.0,642.0,5,1079,3.0,811.0,811.0
0.002,17,2,180,1,66,0.0,38.0,38.0,1,114,0.0,86.0,86.0
0.005,6,10,2007,5,928,1.0,660.0,660.0,5,1079,1.0,811.0,811.0
0.013,17,2,152,1,56,0.0,28.0,28.0,1,96,0.0,68.0,68.0
0.021,6,10,1990,5,911,5.0,643.0,643.0,5,1079,5.0,811.0,811.0
0.141,6,10,1506,5,395,32.0,127.0,127.0,5,1111,33.0,843.0,843.0
0.005,6,10,2006,5,927,1.0,659.0,659.0,5,1079,1.0,811.0,811.0
0.064,6,10,1506,5,395,14.0,127.0,127.0,5,1111,15.0,843.0,843.0
0.005,6,10,1547,5,764,1.0,496.0,496.0,5,783,1.0,515.0,515.0
0.038,17,2,152,1,76,0.0,48.0,48.0,1,76,0.0,48.0,48.0
0.01,6,10,1989,5,910,2.0,642.0,642.0,5,1079,2.0,811.0,811.0
0.005,6,10,2006,5,927,1.0,659.0,659.0,5,1079,1.0,811.0,811.0
0.103,6,10,1506,5,395,25.0,127.0,127.0,5,1111,18.0,843.0,843.0
0.004,6,10,2007,5,928,1.0,660.0,660.0,5,1079,1.0,811.0,811.0
86.976,6,26,9525,12,1627,76.0,794.0,367.0,14,7898,6681.0,1360.0,732.0
0.006,6,10,1643,5,860,1.0,592.0,592.0,5,783,1.0,515.0,515.0
0.131,6,10,1506,5,395,25.0,127.0,127.0,5,1111,27.0,843.0,843.0
0.005,6,10,2007,5,928,1.0,660.0,660.0,5,1079,1.0,811.0,811.0
0.004,17,2,299,1,65,0.0,37.0,37.0,1,234,0.0,206.0,206.0
15.086,17,15,8242,8,6090,2150.0,1350.0,733.0,7,2152,2509.0,1350.0,279.0
0.005,6,10,1989,5,927,1.0,659.0,659.0,5,1062,1.0,794.0,794.0
0.008,6,10,1762,5,911,2.0,643.0,643.0,5,851,1.0,583.0,583.0
0.005,6,10,2000,5,927,1.0,659.0,659.0,5,1073,1.0,805.0,805.0
0.004,17,2,148,1,60,0.0,32.0,32.0,1,88,0.0,60.0,60.0
0.005,17,2,214,1,75,0.0,47.0,47.0,1,139,0.0,111.0,111.0
0.004,6,10,2007,5,928,1.0,660.0,660.0,5,1079,1.0,811.0,811.0
0.117,6,10,1506,5,395,27.0,127.0,127.0,5,1111,25.0,843.0,843.0
0.006,6,10,1854,5,889,1.0,621.0,621.0,5,965,1.0,697.0,697.0
0.005,6,10,1689,5,839,1.0,571.0,571.0,5,850,1.0,582.0,582.0
0.005,6,10,2007,5,928,1.0,660.0,660.0,5,1079,1.0,811.0,811.0
0.009,6,10,1762,5,911,2.0,643.0,643.0,5,851,2.0,583.0,583.0
0.003,17,2,148,1,60,0.0,32.0,32.0,1,88,0.0,60.0,60.0
0.053,17,2,152,1,76,0.0,48.0,48.0,1,76,0.0,48.0,48.0
0.004,6,10,2006,5,927,1.0,659.0,659.0,5,1079,1.0,811.0,811.0
0.019,6,10,1983,5,910,4.0,642.0,642.0,5,1073,4.0,805.0,805.0
0.005,6,10,2006,5,927,1.0,659.0,659.0,5,1079,1.0,811.0,811.0
0.005,6,10,2007,5,928,1.0,660.0,660.0,5,1079,1.0,811.0,811.0
0.005,6,10,1854,5,889,1.0,621.0,621.0,5,965,1.0,697.0,697.0
0.005,6,10,1989,5,927,1.0,659.0,659.0,5,1062,1.0,794.0,794.0
0.009,6,10,1990,5,911,2.0,643.0,643.0,5,1079,2.0,811.0,811.0
0.004,17,4,284,2,120,0.0,32.0,32.0,2,164,0.0,60.0,54.0
0.005,6,10,2007,5,928,1.0,660.0,660.0,5,1079,1.0,811.0,811.0
0.004,17,2,184,1,61,0.0,33.0,33.0,1,123,0.0,95.0,95.0
0.008,6,10,1972,5,910,1.0,642.0,642.0,5,1062,2.0,794.0,794.0
0.02,6,10,1990,5,911,5.0,643.0,643.0,5,1079,5.0,811.0,811.0
0.092,6,10,1506,5,395,21.0,127.0,127.0,5,1111,18.0,843.0,843.0
0.124,17,2,80,1,32,0.0,4.0,4.0,1,48,0.0,20.0,20.0
40.058,17,10,676,5,460,10013.0,104.0,64.0,5,216,10013.0,20.0,15.0
1777.462,17,143,45188,72,22752,25033.0,288.0,288.0,71,22436,25391.0,288.0,288.0
0.005,6,10,1774,5,923,1.0,655.0,655.0,5,851,1.0,583.0,583.0
0.012,6,10,1983,5,910,3.0,642.0,642.0,5,1073,2.0,805.0,805.0
0.004,17,2,136,1,60,0.0,32.0,32.0,1,76,0.0,48.0,48.0
0.012,6,10,1989,5,910,3.0,642.0,642.0,5,1079,2.0,811.0,811.0
0.006,6,10,1989,5,927,1.0,659.0,659.0,5,1062,1.0,794.0,794.0
0.008,6,10,1677,5,827,2.0,559.0,559.0,5,850,2.0,582.0,582.0
0.0,17,2,142,1,63,0.0,35.0,35.0,1,79,0.0,51.0,51.0
0.006,6,10,2006,5,927,1.0,659.0,659.0,5,1079,1.0,811.0,811.0
0.09,6,10,1506,5,395,21.0,127.0,127.0,5,1111,20.0,843.0,843.0
0.084,6,10,1506,5,395,19.0,127.0,127.0,5,1111,19.0,843.0,843.0
240.039,6,9,787,5,488,60009.0,232.0,232.0,4,299,80012.0,83.0,83.0
0.113,6,10,1506,5,395,24.0,127.0,127.0,5,1111,21.0,843.0,843.0
308.436,17,20,1124,10,716,34264.0,48.0,43.0,10,408,34257.0,20.0,12.0
0.004,17,2,148,1,60,0.0,32.0,32.0,1,88,0.0,60.0,60.0
0.057,17,2,144,1,64,0.0,36.0,36.0,1,80,0.0,52.0,52.0
0.005,6,10,2006,5,927,1.0,659.0,659.0,5,1079,1.0,811.0,811.0
0.005,17,2,230,1,68,0.0,40.0,40.0,1,162,0.0,134.0,134.0
1778.405,17,144,41760,72,22752,25047.0,288.0,288.0,72,19008,25047.0,236.0,236.0
0.006,6,10,1854,5,889,1.0,621.0,621.0,5,965,1.0,697.0,697.0
0.019,6,10,1631,5,848,4.0,580.0,580.0,5,783,4.0,515.0,515.0
0.081,6,10,1506,5,395,18.0,127.0,127.0,5,1111,16.0,843.0,843.0
0.001,17,2,154,1,69,0.0,41.0,41.0,1,85,0.0,57.0,57.0
0.087,6,10,1506,5,395,17.0,127.0,127.0,5,1111,20.0,843.0,843.0
0.006,17,2,140,1,62,0.0,34.0,34.0,1,78,0.0,50.0,50.0
309.939,17,20,1124,10,716,34423.0,48.0,43.0,10,408,34423.0,20.0,12.0
0.05,6,10,1983,5,910,12.0,642.0,642.0,5,1073,12.0,805.0,805.0
0.01,6,12,1926,6,1189,1.0,659.0,434.0,6,737,2.0,417.0,417.0
0.091,6,10,1506,5,395,18.0,127.0,127.0,5,1111,20.0,843.0,843.0
0.003,17,2,136,1,60,0.0,32.0,32.0,1,76,0.0,48.0,48.0
0.009,17,2,255,1,82,0.0,54.0,54.0,1,173,0.0,145.0,145.0
0.006,6,10,1547,5,764,1.0,496.0,496.0,5,783,1.0,515.0,515.0
0.069,17,8,3613,4,1874,23.0,1350.0,440.0,4,1739,11.0,1350.0,406.0
0.195,6,10,1506,5,395,17.0,127.0,127.0,5,1111,47.0,843.0,843.0
300.452,6,27,7433,16,1409,20030.0,217.0,142.0,11,6024,24036.0,1679.0,777.0
0.003,17,2,148,1,60,0.0,32.0,32.0,1,88,0.0,60.0,60.0
36.967,6,37,12342,18,6784,521.0,4080.0,1508.0,19,5558,2044.0,2667.0,435.0
0.09,6,10,1506,5,395,19.0,127.0,127.0,5,1111,17.0,843.0,843.0
1.161,6,30,13240,17,5841,72.0,2074.0,854.0,13,7399,80.0,2720.0,858.0
0.006,6,10,2006,5,927,1.0,659.0,659.0,5,1079,1.0,811.0,811.0
0.013,6,12,1926,6,1189,2.0,659.0,434.0,6,737,2.0,417.0,417.0
0.005,6,10,2007,5,928,1.0,660.0,660.0,5,1079,1.0,811.0,811.0
178.576,17,80,11270,40,2664,4578.0,44.0,38.0,40,8606,4578.0,239.0,187.0
0.005,6,13,3747,7,509,0.0,137.0,137.0,6,3238,0.0,1470.0,1459.0
253.604,6,38,9831,15,6665,18114.0,1788.0,654.0,23,3166,11527.0,580.0,140.0
0.004,17,4,284,2,120,0.0,32.0,32.0,2,164,1.0,60.0,54.0
0.005,17,2,144,1,64,0.0,36.0,36.0,1,80,0.0,52.0,52.0
0.005,6,10,2007,5,928,1.0,660.0,660.0,5,1079,1.0,811.0,811.0
0.009,6,13,3735,7,497,1.0,125.0,125.0,6,3238,1.0,1470.0,1459.0
0.005,6,10,1643,5,860,1.0,592.0,592.0,5,783,1.0,515.0,515.0
191.341,17,6,488,3,190,95652.0,37.0,35.0,3,298,95650.0,89.0,71.0
0.005,17,2,230,1,68,0.0,40.0,40.0,1,162,0.0,134.0,134.0
0.094,6,10,1506,5,395,19.0,127.0,127.0,5,1111,21.0,843.0,843.0
0.011,6,10,1677,5,827,2.0,559.0,559.0,5,850,2.0,582.0,582.0
0.003,17,4,284,2,120,0.0,32.0,32.0,2,164,0.0,60.0,54.0
0.006,17,2,179,1,71,0.0,43.0,43.0,1,108,0.0,80.0,80.0
0.097,6,10,1506,5,395,18.0,127.0,127.0,5,1111,20.0,843.0,843.0
0.005,6,10,1989,5,927,1.0,659.0,659.0,5,1062,1.0,794.0,794.0
0.009,6,10,2006,5,927,2.0,659.0,659.0,5,1079,2.0,811.0,811.0
0.004,6,10,1702,5,863,1.0,595.0,595.0,5,839,0.0,571.0,571.0
15.075,17,15,9238,8,6902,2149.0,1350.0,834.0,7,2336,2507.0,1350.0,305.0
162.369,17,86,12017,43,2871,3865.0,44.0,38.0,43,9146,3865.0,252.0,184.0
175.032,17,82,11799,41,2742,4375.0,44.0,38.0,41,9057,4375.0,261.0,192.0
0.009,6,10,1990,5,911,2.0,643.0,643.0,5,1079,2.0,811.0,811.0
40.061,17,10,676,5,460,10012.0,104.0,64.0,5,216,10014.0,20.0,15.0
240.015,6,9,787,5,488,60003.0,232.0,232.0,4,299,80004.0,83.0,83.0
0.008,6,11,1906,6,941,1.0,621.0,621.0,5,965,1.0,697.0,697.0
0.231,6,16,2669,8,1395,33.0,533.0,323.0,8,1274,21.0,529.0,212.0
0.018,6,10,1983,5,910,4.0,642.0,642.0,5,1073,4.0,805.0,805.0
0.005,17,2,213,1,69,0.0,41.0,41.0,1,144,0.0,116.0,116.0
0.007,6,10,1762,5,911,1.0,643.0,643.0,5,851,1.0,583.0,583.0
0.091,6,10,1506,5,395,18.0,127.0,127.0,5,1111,21.0,843.0,843.0
0.015,6,10,1990,5,911,3.0,643.0,643.0,5,1079,3.0,811.0,811.0
367.349,6,22,2313,16,867,24489.0,195.0,195.0,6,1446,4639.0,419.0,398.0
0.004,17,2,136,1,60,0.0,32.0,32.0,1,76,0.0,48.0,48.0
0.001,17,2,179,1,62,0.0,34.0,34.0,1,117,0.0,89.0,89.0
0.01,6,10,1989,5,910,2.0,642.0,642.0,5,1079,2.0,811.0,811.0
0.005,6,10,2006,5,927,1.0,659.0,659.0,5,1079,1.0,811.0,811.0
1792.823,6,485,98733,244,87503,7377.0,421.0,368.0,241,11230,7469.0,53.0,53.0
0.067,6,10,1506,5,395,16.0,127.0,127.0,5,1111,16.0,843.0,843.0
0.01,6,10,1990,5,911,2.0,643.0,643.0,5,1079,2.0,811.0,811.0
0.006,6,10,1689,5,839,1.0,571.0,571.0,5,850,1.0,582.0,582.0
0.174,17,2,152,1,76,0.0,48.0,48.0,1,76,0.0,48.0,48.0
0.018,6,10,1989,5,910,4.0,642.0,642.0,5,1079,4.0,811.0,811.0
0.013,6,10,1990,5,911,3.0,643.0,643.0,5,1079,3.0,811.0,811.0
0.006,6,10,1547,5,764,1.0,496.0,496.0,5,783,1.0,515.0,515.0
0.18,6,10,1506,5,395,35.0,127.0,127.0,5,1111,39.0,843.0,843.0
0.009,6,10,1972,5,910,2.0,642.0,642.0,5,1062,2.0,794.0,794.0
0.006,17,2,214,1,75,0.0,47.0,47.0,1,139,0.0,111.0,111.0
0.079,6,10,1506,5,395,15.0,127.0,127.0,5,1111,17.0,843.0,843.0
0.017,6,10,1972,5,910,4.0,642.0,642.0,5,1062,4.0,794.0,794.0
0.018,6,10,1989,5,910,4.0,642.0,642.0,5,1079,4.0,811.0,811.0
0.015,6,10,1989,5,910,3.0,642.0,642.0,5,1079,3.0,811.0,811.0
0.103,6,10,1506,5,395,19.0,127.0,127.0,5,1111,22.0,843.0,843.0
0.012,6,10,1990,5,911,3.0,643.0,643.0,5,1079,2.0,811.0,811.0
0.014,6,10,1989,5,910,3.0,642.0,642.0,5,1079,3.0,811.0,811.0
0.01,6,10,1983,5,910,2.0,642.0,642.0,5,1073,2.0,805.0,805.0
240.096,6,16,4481,9,963,30012.0,238.0,166.0,7,3518,40015.0,1402.0,786.0
0.006,17,2,230,1,68,0.0,40.0,40.0,1,162,0.0,134.0,134.0
0.006,6,10,1547,5,764,1.0,496.0,496.0,5,783,1.0,515.0,515.0
0.12,6,10,1506,5,395,27.0,127.0,127.0,5,1111,25.0,843.0,843.0
0.005,6,10,2006,5,927,1.0,659.0,659.0,5,1079,1.0,811.0,811.0
0.004,6,10,2007,5,928,1.0,660.0,660.0,5,1079,1.0,811.0,811.0
0.004,6,10,1989,5,927,1.0,659.0,659.0,5,1062,1.0,794.0,794.0
0.004,17,4,284,2,120,0.0,32.0,32.0,2,164,1.0,60.0,54.0
0.113,6,10,1506,5,395,27.0,127.0,127.0,5,1111,23.0,843.0,843.0
0.134,6,10,1506,5,395,31.0,127.0,127.0,5,1111,30.0,843.0,843.0
0.008,6,13,3735,7,497,1.0,125.0,125.0,6,3238,1.0,1470.0,1459.0
0.001,17,2,174,1,72,0.0,44.0,44.0,1,102,0.0,74.0,74.0
0.003,17,2,160,1,72,0.0,44.0,44.0,1,88,0.0,60.0,60.0
0.011,6,10,1983,5,910,2.0,642.0,642.0,5,1073,2.0,805.0,805.0
0.006,17,2,230,1,68,0.0,40.0,40.0,1,162,0.0,134.0,134.0
0.003,17,2,136,1,60,0.0,32.0,32.0,1,76,0.0,48.0,48.0
0.005,6,14,3742,8,504,0.0,80.0,80.0,6,3238,1.0,1470.0,1459.0
0.006,6,10,2007,5,928,1.0,660.0,660.0,5,1079,1.0,811.0,811.0
0.005,6,14,3742,7,452,0.0,80.0,80.0,7,3290,0.0,1448.0,972.0
0.006,6,10,1989,5,927,1.0,659.0,659.0,5,1062,1.0,794.0,794.0
0.004,6,10,2007,5,928,1.0,660.0,660.0,5,1079,1.0,811.0,811.0
0.099,6,10,1506,5,395,23.0,127.0,127.0,5,1111,21.0,843.0,843.0
0.005,6,10,1689,5,839,1.0,571.0,571.0,5,850,1.0,582.0,582.0
0.006,6,10,1547,5,764,1.0,496.0,496.0,5,783,1.0,515.0,515.0
0.005,6,13,3690,7,452,0.0,80.0,80.0,6,3238,0.0,1470.0,1459.0
0.01,6,10,1762,5,911,2.0,643.0,643.0,5,851,2.0,583.0,583.0
0.004,6,10,1779,5,928,1.0,660.0,660.0,5,851,1.0,583.0,583.0
0.005,6,10,1989,5,927,1.0,659.0,659.0,5,1062,1.0,794.0,794.0
0.01,6,10,1989,5,910,2.0,642.0,642.0,5,1079,2.0,811.0,811.0
23.107,6,39,22801,21,1150,1155.0,290.0,290.0,18,21651,1356.0,2021.0,1394.0
0.012,6,10,1989,5,910,2.0,642.0,642.0,5,1079,3.0,811.0,811.0
0.006,6,10,2007,5,928,1.0,660.0,660.0,5,1079,1.0,811.0,811.0
0.005,6,10,2000,5,927,1.0,659.0,659.0,5,1073,1.0,805.0,805.0
0.105,6,10,1506,5,395,24.0,127.0,127.0,5,1111,23.0,843.0,843.0
40.059,17,10,676,5,460,10013.0,104.0,64.0,5,216,10013.0,20.0,15.0
0.006,6,10,1689,5,839,1.0,571.0,571.0,5,850,1.0,582.0,582.0
0.001,17,2,180,1,66,0.0,38.0,38.0,1,114,0.0,86.0,86.0
1756.873,6,473,69462,266,36246,6629.0,613.0,189.0,207,33216,8528.0,613.0,151.0
0.011,6,10,1990,5,911,2.0,643.0,643.0,5,1079,2.0,811.0,811.0
0.011,6,10,1990,5,911,2.0,643.0,643.0,5,1079,2.0,811.0,811.0
0.178,6,10,1506,5,395,37.0,127.0,127.0,5,1111,39.0,843.0,843.0
0.13,17,2,182,1,65,0.0,37.0,37.0,1,117,0.0,89.0,89.0
0.006,6,10,1547,5,764,1.0,496.0,496.0,5,783,1.0,515.0,515.0
0.001,17,2,142,1,63,0.0,35.0,35.0,1,79,0.0,51.0,51.0
0.006,17,2,262,1,67,0.0,39.0,39.0,1,195,0.0,167.0,167.0
0.013,6,10,1972,5,910,3.0,642.0,642.0,5,1062,3.0,794.0,794.0
0.005,6,10,2000,5,927,1.0,659.0,659.0,5,1073,1.0,805.0,805.0
0.013,6,10,1989,5,910,3.0,642.0,642.0,5,1079,3.0,811.0,811.0
0.075,6,10,1506,5,395,16.0,127.0,127.0,5,1111,16.0,843.0,843.0
9.04,17,6,376,5,280,2260.0,28.0,28.0,1,96,0.0,68.0,68.0
0.079,6,10,1506,5,395,19.0,127.0,127.0,5,1111,16.0,843.0,843.0
0.039,17,2,170,1,65,0.0,37.0,37.0,1,105,0.0,77.0,77.0
0.004,6,10,2006,5,927,1.0,659.0,659.0,5,1079,1.0,811.0,811.0
40.068,17,10,676,5,460,10016.0,104.0,64.0,5,216,10015.0,20.0,15.0
0.017,6,10,1990,5,911,4.0,643.0,643.0,5,1079,4.0,811.0,811.0
0.018,6,10,1989,5,910,4.0,642.0,642.0,5,1079,4.0,811.0,811.0
40.063,17,10,676,5,460,10015.0,104.0,64.0,5,216,10014.0,20.0,15.0
0.009,6,10,1983,5,910,2.0,642.0,642.0,5,1073,2.0,805.0,805.0
0.087,6,10,1506,5,395,20.0,127.0,127.0,5,1111,20.0,843.0,843.0
0.005,6,10,2006,5,927,1.0,659.0,659.0,5,1079,1.0,811.0,811.0
0.004,17,4,284,2,120,0.0,32.0,32.0,2,164,0.0,60.0,54.0
0.01,6,10,1762,5,911,2.0,643.0,643.0,5,851,2.0,583.0,583.0
0.006,17,2,427,1,129,0.0,101.0,101.0,1,298,0.0,270.0,270.0
0.005,6,10,1774,5,923,1.0,655.0,655.0,5,851,1.0,583.0,583.0
0.004,6,10,1989,5,927,1.0,659.0,659.0,5,1062,1.0,794.0,794.0
0.001,17,2,180,1,66,0.0,38.0,38.0,1,114,0.0,86.0,86.0
0.004,17,4,284,2,120,0.0,32.0,32.0,2,164,1.0,60.0,54.0
10.775,17,28,4424,14,1995,820.0,270.0,114.0,14,2429,820.0,588.0,145.0
0.013,6,10,1972,5,910,3.0,642.0,642.0,5,1062,3.0,794.0,794.0
0.013,6,10,1990,5,911,3.0,643.0,643.0,5,1079,3.0,811.0,811.0
0.116,6,10,1506,5,395,25.0,127.0,127.0,5,1111,23.0,843.0,843.0
0.005,6,10,2000,5,927,1.0,659.0,659.0,5,1073,1.0,805.0,805.0
0.006,6,10,1643,5,860,1.0,592.0,592.0,5,783,1.0,515.0,515.0
0.009,6,10,1762,5,911,2.0,643.0,643.0,5,851,2.0,583.0,583.0
0.076,6,10,1506,5,395,17.0,127.0,127.0,5,1111,16.0,843.0,843.0
0.005,6,10,2006,5,927,1.0,659.0,659.0,5,1079,1.0,811.0,811.0
0.116,6,10,1506,5,395,26.0,127.0,127.0,5,1111,24.0,843.0,843.0
0.006,17,2,212,1,74,0.0,46.0,46.0,1,138,0.0,110.0,110.0
0.088,6,10,1506,5,395,17.0,127.0,127.0,5,1111,18.0,843.0,843.0
1799.791,6,136,6589,76,3664,23997.0,39.0,39.0,60,2925,30006.0,35.0,35.0
0.116,6,10,1506,5,395,25.0,127.0,127.0,5,1111,25.0,843.0,843.0
0.071,17,2,186,1,61,0.0,33.0,33.0,1,125,0.0,97.0,97.0
0.244,6,592,1123376,150,9272,1.0,859.0,480.0,442,1114104,0.0,4188.0,2496.0
0.005,17,2,166,1,75,0.0,47.0,47.0,1,91,0.0,63.0,63.0
0.006,6,10,2007,5,928,1.0,660.0,660.0,5,1079,1.0,811.0,811.0
0.011,6,10,1989,5,910,2.0,642.0,642.0,5,1079,2.0,811.0,811.0
0.005,17,2,140,1,62,0.0,34.0,34.0,1,78,0.0,50.0,50.0
0.005,6,10,2007,5,928,1.0,660.0,660.0,5,1079,1.0,811.0,811.0
0.004,17,4,284,2,120,0.0,32.0,32.0,2,164,0.0,60.0,54.0
0.005,6,10,2006,5,927,1.0,659.0,659.0,5,1079,1.0,811.0,811.0
178.063,17,76,10572,38,2529,4812.0,44.0,38.0,38,8043,4812.0,239.0,183.0
0.005,6,10,2006,5,927,1.0,659.0,659.0,5,1079,1.0,811.0,811.0
0.005,6,10,2007,5,928,1.0,660.0,660.0,5,1079,1.0,811.0,811.0
0.005,6,10,1689,5,839,1.0,571.0,571.0,5,850,1.0,582.0,582.0
0.006,6,10,1547,5,764,1.0,496.0,496.0,5,783,1.0,515.0,515.0
240.113,6,16,4480,9,963,30014.0,238.0,166.0,7,3517,40018.0,1402.0,786.0
0.026,6,10,1762,5,911,6.0,643.0,643.0,5,851,6.0,583.0,583.0
313.797,17,20,1124,10,716,34852.0,48.0,43.0,10,408,34852.0,20.0,12.0
0.035,17,4,420,2,122,0.0,33.0,33.0,2,298,1.0,145.0,121.0
0.008,6,10,1762,5,911,2.0,643.0,643.0,5,851,2.0,583.0,583.0
292.517,6,386,348214,194,21668,1515.0,2692.0,770.0,192,326546,1531.0,2930.0,1778.0
0.005,6,13,3747,7,509,0.0,137.0,137.0,6,3238,0.0,1470.0,1459.0
0.005,6,10,1779,5,928,1.0,660.0,660.0,5,851,1.0,583.0,583.0
0.007,6,10,1689,5,839,1.0,571.0,571.0,5,850,1.0,582.0,582.0
0.044,17,2,152,1,76,0.0,48.0,48.0,1,76,0.0,48.0,48.0
0.011,6,10,1972,5,910,2.0,642.0,642.0,5,1062,2.0,794.0,794.0
40.067,17,10,676,5,460,10015.0,104.0,64.0,5,216,10015.0,20.0,15.0
0.005,6,10,1989,5,927,1.0,659.0,659.0,5,1062,1.0,794.0,794.0
15.071,17,15,9238,8,6902,2148.0,1350.0,834.0,7,2336,2506.0,1350.0,305.0
1778.963,17,145,45820,73,23068,24701.0,288.0,288.0,72,22752,25048.0,288.0,288.0
0.085,6,10,1506,5,395,20.0,127.0,127.0,5,1111,19.0,843.0,843.0
0.204,17,17,10138,9,7731,25.0,1350.0,831.0,8,2407,18.0,1350.0,272.0
0.004,6,10,2007,5,928,1.0,660.0,660.0,5,1079,1.0,811.0,811.0
0.006,17,2,170,1,65,0.0,37.0,37.0,1,105,0.0,77.0,77.0
0.074,6,10,1506,5,395,15.0,127.0,127.0,5,1111,16.0,843.0,843.0
0.006,6,10,1547,5,764,1.0,496.0,496.0,5,783,1.0,515.0,515.0
0.006,6,10,1689,5,839,1.0,571.0,571.0,5,850,1.0,582.0,582.0
0.001,17,2,180,1,66,0.0,38.0,38.0,1,114,0.0,86.0,86.0
0.011,6,10,1972,5,910,2.0,642.0,642.0,5,1062,2.0,794.0,794.0
40.082,17,10,676,5,460,10016.0,104.0,64.0,5,216,10019.0,20.0,15.0
0.04,17,4,420,2,122,0.0,33.0,33.0,2,298,0.0,145.0,121.0
240.019,6,9,787,5,488,60004.0,232.0,232.0,4,299,80003.0,83.0,83.0
0.005,17,2,140,1,62,0.0,34.0,34.0,1,78,0.0,50.0,50.0
0.007,6,10,1774,5,923,1.0,655.0,655.0,5,851,1.0,583.0,583.0
0.006,6,10,1547,5,764,1.0,496.0,496.0,5,783,1.0,515.0,515.0
0.152,6,10,1506,5,395,33.0,127.0,127.0,5,1111,34.0,843.0,843.0
0.004,6,10,1779,5,928,1.0,660.0,660.0,5,851,1.0,583.0,583.0
15.076,17,15,9239,8,6902,2149.0,1350.0,834.0,7,2337,2507.0,1350.0,305.0
1729.226,6,60,4400,40,2740,44339.0,33.0,33.0,20,1660,91003.0,31.0,31.0
0.005,6,10,2000,5,927,1.0,659.0,659.0,5,1073,1.0,805.0,805.0
0.013,6,10,1972,5,910,3.0,642.0,642.0,5,1062,3.0,794.0,794.0
0.099,6,10,1506,5,395,24.0,127.0,127.0,5,1111,20.0,843.0,843.0
0.005,17,2,214,1,75,0.0,47.0,47.0,1,139,0.0,111.0,111.0
0.012,17,2,152,1,56,0.0,28.0,28.0,1,96,0.0,68.0,68.0
0.006,6,10,1643,5,860,1.0,592.0,592.0,5,783,1.0,515.0,515.0
15.263,17,48,26013,26,22594,609.0,1350.0,841.0,22,3419,725.0,1350.0,127.0
0.005,6,10,1689,5,839,1.0,571.0,571.0,5,850,1.0,582.0,582.0
0.071,17,4,596,2,122,6.0,33.0,33.0,2,474,24.0,323.0,209.0
0.005,17,2,140,1,62,0.0,34.0,34.0,1,78,0.0,50.0,50.0
240.108,6,16,4482,9,963,30013.0,238.0,166.0,7,3519,40017.0,1402.0,786.0
0.066,17,8,3613,4,1874,22.0,1350.0,440.0,4,1739,10.0,1350.0,406.0
0.011,6,10,1990,5,911,2.0,643.0,643.0,5,1079,2.0,811.0,811.0
0.038,17,4,284,2,120,0.0,32.0,32.0,2,164,35.0,60.0,54.0
0.004,17,2,148,1,60,0.0,32.0,32.0,1,88,0.0,60.0,60.0
0.005,6,10,2000,5,927,1.0,659.0,659.0,5,1073,1.0,805.0,805.0
0.006,6,10,1989,5,927,1.0,659.0,659.0,5,1062,1.0,794.0,794.0
40.057,17,10,676,5,460,10012.0,104.0,64.0,5,216,10012.0,20.0,15.0
0.009,6,10,1990,5,911,2.0,643.0,643.0,5,1079,2.0,811.0,811.0
0.004,6,10,1774,5,923,1.0,655.0,655.0,5,851,1.0,583.0,583.0
240.017,6,9,787,5,488,60004.0,232.0,232.0,4,299,80005.0,83.0,83.0
0.006,17,2,164,1,74,0.0,46.0,46.0,1,90,0.0,62.0,62.0
0.005,17,2,144,1,64,0.0,36.0,36.0,1,80,0.0,52.0,52.0
0.176,6,10,1506,5,395,42.0,127.0,127.0,5,1111,27.0,843.0,843.0
0.004,17,4,284,2,120,1.0,32.0,32.0,2,164,0.0,60.0,54.0
0.095,6,10,1506,5,395,20.0,127.0,127.0,5,1111,21.0,843.0,843.0
61.04,58,5,360,4,288,20346.0,24.0,24.0,1,72,0.0,24.0,24.0
0.021,17,2,136,1,60,0.0,32.0,32.0,1,76,0.0,48.0,48.0
0.139,6,10,1506,5,395,24.0,127.0,127.0,5,1111,29.0,843.0,843.0
0.007,17,2,179,1,71,0.0,43.0,43.0,1,108,0.0,80.0,80.0
0.007,6,10,1989,5,910,1.0,642.0,642.0,5,1079,1.0,811.0,811.0
0.082,6,10,1506,5,395,18.0,127.0,127.0,5,1111,18.0,843.0,843.0
0.211,6,10,1506,5,395,47.0,127.0,127.0,5,1111,46.0,843.0,843.0
0.005,6,10,1643,5,860,1.0,592.0,592.0,5,783,1.0,515.0,515.0
10.733,17,26,4103,13,1822,885.0,269.0,112.0,13,2281,885.0,588.0,147.0
0.095,6,10,1506,5,395,22.0,127.0,127.0,5,1111,22.0,843.0,843.0
0.014,6,10,1983,5,910,3.0,642.0,642.0,5,1073,3.0,805.0,805.0
0.004,6,10,2006,5,927,1.0,659.0,659.0,5,1079,1.0,811.0,811.0
0.053,17,2,152,1,76,0.0,48.0,48.0,1,76,0.0,48.0,48.0
0.006,6,10,1547,5,764,1.0,496.0,496.0,5,783,1.0,515.0,515.0
0.011,6,10,1990,5,911,2.0,643.0,643.0,5,1079,2.0,811.0,811.0
0.01,6,10,1983,5,910,2.0,642.0,642.0,5,1073,2.0,805.0,805.0
40.06,17,10,676,5,460,10013.0,104.0,64.0,5,216,10014.0,20.0,15.0
0.08,6,10,1506,5,395,18.0,127.0,127.0,5,1111,17.0,843.0,843.0
0.004,6,10,2007,5,928,1.0,660.0,660.0,5,1079,1.0,811.0,811.0
0.072,6,10,1506,5,395,15.0,127.0,127.0,5,1111,17.0,843.0,843.0
0.009,6,10,1989,5,910,2.0,642.0,642.0,5,1079,2.0,811.0,811.0
0.004,17,2,136,1,60,0.0,32.0,32.0,1,76,0.0,48.0,48.0
0.215,6,16,2778,8,1396,30.0,533.0,324.0,8,1382,19.0,529.0,239.0
0.004,6,10,1702,5,863,0.0,595.0,595.0,5,839,1.0,571.0,571.0
300.017,6,11,891,6,552,60002.0,232.0,232.0,5,339,75003.0,83.0,83.0
0.005,6,10,2006,5,927,1.0,659.0,659.0,5,1079,1.0,811.0,811.0
0.01,6,10,1990,5,911,2.0,643.0,643.0,5,1079,2.0,811.0,811.0
0.004,17,2,136,1,60,0.0,32.0,32.0,1,76,0.0,48.0,48.0
0.004,6,10,2006,5,927,1.0,659.0,659.0,5,1079,1.0,811.0,811.0
0.006,17,2,212,1,74,0.0,46.0,46.0,1,138,0.0,110.0,110.0
0.001,17,2,180,1,66,0.0,38.0,38.0,1,114,0.0,86.0,86.0
40.061,17,10,676,5,460,10012.0,104.0,64.0,5,216,10014.0,20.0,15.0
0.005,17,2,169,1,62,0.0,34.0,34.0,1,107,0.0,79.0,79.0
0.172,17,2,152,1,76,0.0,48.0,48.0,1,76,0.0,48.0,48.0
0.005,6,13,3690,7,452,0.0,80.0,80.0,6,3238,0.0,1470.0,1459.0
0.129,17,2,80,1,32,0.0,4.0,4.0,1,48,0.0,20.0,20.0
0.008,6,10,1990,5,911,2.0,643.0,643.0,5,1079,1.0,811.0,811.0
0.006,6,12,1698,6,863,1.0,327.0,271.0,6,835,1.0,515.0,515.0
0.129,6,10,1506,5,395,30.0,127.0,127.0,5,1111,22.0,843.0,843.0
0.005,6,10,1854,5,889,1.0,621.0,621.0,5,965,1.0,697.0,697.0
40.057,17,10,676,5,460,10013.0,104.0,64.0,5,216,10013.0,20.0,15.0
0.005,6,10,1989,5,927,1.0,659.0,659.0,5,1062,1.0,794.0,794.0
0.071,17,8,3613,4,1874,23.0,1350.0,440.0,4,1739,12.0,1350.0,406.0
0.016,6,10,1990,5,911,4.0,643.0,643.0,5,1079,3.0,811.0,811.0
0.007,6,10,1547,5,764,1.0,496.0,496.0,5,783,1.0,515.0,515.0
0.007,6,10,1762,5,911,1.0,643.0,643.0,5,851,1.0,583.0,583.0
0.004,6,10,1989,5,927,1.0,659.0,659.0,5,1062,1.0,794.0,794.0
354.056,6,19,1691,15,978,25289.0,190.0,190.0,4,713,80002.0,497.0,497.0
0.015,6,10,1972,5,910,3.0,642.0,642.0,5,1062,3.0,794.0,794.0
1747.567,6,472,67703,255,35389,6880.0,613.0,195.0,217,32314,8090.0,613.0,148.0
0.004,17,2,170,1,65,0.0,37.0,37.0,1,105,0.0,77.0,77.0
0.017,6,10,1972,5,910,4.0,642.0,642.0,5,1062,4.0,794.0,794.0
0.014,6,10,1972,5,910,3.0,642.0,642.0,5,1062,3.0,794.0,794.0
0.006,6,10,2006,5,927,1.0,659.0,659.0,5,1079,1.0,811.0,811.0
40.077,17,10,676,5,460,10018.0,104.0,64.0,5,216,10018.0,20.0,15.0
292.129,6,324,345061,128,18214,2300.0,2736.0,889.0,196,326847,1498.0,2804.0,1739.0
240.018,6,9,787,5,488,60004.0,232.0,232.0,4,299,80005.0,83.0,83.0
0.012,6,10,1762,5,911,3.0,643.0,643.0,5,851,2.0,583.0,583.0
1742.167,6,301,97362,185,86282,9468.0,2001.0,696.0,116,11080,15149.0,452.0,70.0
0.012,6,10,1990,5,911,2.0,643.0,643.0,5,1079,2.0,811.0,811.0
0.003,17,2,185,1,73,0.0,45.0,45.0,1,112,0.0,84.0,84.0
0.092,6,10,1506,5,395,18.0,127.0,127.0,5,1111,19.0,843.0,843.0
0.013,6,10,1990,5,911,3.0,643.0,643.0,5,1079,3.0,811.0,811.0
0.009,6,10,1631,5,848,2.0,580.0,580.0,5,783,2.0,515.0,515.0
0.004,6,10,1989,5,927,1.0,659.0,659.0,5,1062,1.0,794.0,794.0
0.014,6,10,1989,5,910,3.0,642.0,642.0,5,1079,3.0,811.0,811.0
0.001,17,2,180,1,66,0.0,38.0,38.0,1,114,0.0,86.0,86.0
0.099,6,10,1506,5,395,19.0,127.0,127.0,5,1111,24.0,843.0,843.0
0.004,17,2,140,1,62,0.0,34.0,34.0,1,78,0.0,50.0,50.0
0.005,6,10,2000,5,927,1.0,659.0,659.0,5,1073,1.0,805.0,805.0
0.004,6,10,1989,5,927,1.0,659.0,659.0,5,1062,1.0,794.0,794.0
0.076,6,10,1506,5,395,17.0,127.0,127.0,5,1111,15.0,843.0,843.0
0.06,17,2,152,1,76,0.0,48.0,48.0,1,76,0.0,48.0,48.0
0.015,6,10,1989,5,910,3.0,642.0,642.0,5,1079,3.0,811.0,811.0
0.005,6,10,2006,5,927,1.0,659.0,659.0,5,1079,1.0,811.0,811.0
0.016,17,2,198,1,91,0.0,63.0,63.0,1,107,0.0,79.0,79.0
0.005,6,10,2006,5,927,1.0,659.0,659.0,5,1079,1.0,811.0,811.0
0.011,6,10,1972,5,910,2.0,642.0,642.0,5,1062,2.0,794.0,794.0
0.099,6,10,1506,5,395,21.0,127.0,127.0,5,1111,23.0,843.0,843.0
40.055,17,10,676,5,460,10012.0,104.0,64.0,5,216,10013.0,20.0,15.0
0.005,6,10,2007,5,928,1.0,660.0,660.0,5,1079,1.0,811.0,811.0
0.005,6,10,2000,5,927,1.0,659.0,659.0,5,1073,1.0,805.0,805.0
0.005,6,10,2007,5,928,1.0,660.0,660.0,5,1079,1.0,811.0,811.0
0.011,6,10,1631,5,848,2.0,580.0,580.0,5,783,2.0,515.0,515.0
0.004,17,2,148,1,60,0.0,32.0,32.0,1,88,0.0,60.0,60.0
1047.886,6,301,59217,152,52250,6939.0,421.0,355.0,149,6967,7079.0,53.0,53.0
0.01,6,13,3735,7,497,1.0,125.0,125.0,6,3238,1.0,1470.0,1459.0
0.139,6,10,1506,5,395,32.0,127.0,127.0,5,1111,30.0,843.0,843.0
0.023,17,2,427,1,129,0.0,101.0,101.0,1,298,0.0,270.0,270.0
0.009,6,10,2006,5,927,2.0,659.0,659.0,5,1079,2.0,811.0,811.0
0.005,6,10,1989,5,927,1.0,659.0,659.0,5,1062,1.0,794.0,794.0
0.084,6,10,1506,5,395,18.0,127.0,127.0,5,1111,15.0,843.0,843.0
0.011,6,10,1983,5,910,2.0,642.0,642.0,5,1073,2.0,805.0,805.0
0.009,17,2,132,1,58,0.0,30.0,30.0,1,74,0.0,46.0,46.0
0.004,6,10,2007,5,928,1.0,660.0,660.0,5,1079,1.0,811.0,811.0
0.006,6,10,2007,5,928,1.0,660.0,660.0,5,1079,1.0,811.0,811.0
368.454,6,22,2313,16,867,24563.0,195.0,195.0,6,1446,4692.0,419.0,398.0
0.18,17,2,194,1,59,0.0,31.0,31.0,1,135,0.0,107.0,107.0
0.005,6,10,1774,5,923,1.0,655.0,655.0,5,851,1.0,583.0,583.0
0.005,6,10,2007,5,928,1.0,660.0,660.0,5,1079,1.0,811.0,811.0
0.013,6,10,1989,5,910,3.0,642.0,642.0,5,1079,3.0,811.0,811.0
0.009,6,10,1989,5,910,2.0,642.0,642.0,5,1079,2.0,811.0,811.0
0.008,6,10,1762,5,911,2.0,643.0,643.0,5,851,2.0,583.0,583.0
0.006,6,14,3742,7,452,1.0,80.0,80.0,7,3290,0.0,1448.0,972.0
0.006,6,10,2000,5,927,1.0,659.0,659.0,5,1073,1.0,805.0,805.0
0.014,17,2,140,1,62,0.0,34.0,34.0,1,78,0.0,50.0,50.0
0.067,6,10,1506,5,395,15.0,127.0,127.0,5,1111,13.0,843.0,843.0
352.251,6,20,2210,6,1308,12004.0,494.0,494.0,14,902,27095.0,83.0,83.0
0.065,6,10,1506,5,395,14.0,127.0,127.0,5,1111,14.0,843.0,843.0
308.934,17,20,1124,10,716,34311.0,48.0,43.0,10,408,34311.0,20.0,12.0
0.005,6,14,3742,7,452,0.0,80.0,80.0,7,3290,0.0,1448.0,972.0
0.007,6,10,1547,5,764,1.0,496.0,496.0,5,783,1.0,515.0,515.0
0.005,6,13,3690,7,452,0.0,80.0,80.0,6,3238,1.0,1470.0,1459.0
0.101,6,10,1506,5,395,23.0,127.0,127.0,5,1111,21.0,843.0,843.0
0.077,17,4,284,2,120,0.0,32.0,32.0,2,164,37.0,60.0,54.0
0.02,6,10,1631,5,848,5.0,580.0,580.0,5,783,5.0,515.0,515.0
0.009,6,10,1990,5,911,2.0,643.0,643.0,5,1079,2.0,811.0,811.0
0.068,6,10,1506,5,395,16.0,127.0,127.0,5,1111,16.0,843.0,843.0
0.004,6,10,2007,5,928,1.0,660.0,660.0,5,1079,1.0,811.0,811.0
0.013,6,10,1990,5,911,3.0,643.0,643.0,5,1079,3.0,811.0,811.0
0.079,6,10,1506,5,395,19.0,127.0,127.0,5,1111,17.0,843.0,843.0
0.001,17,2,180,1,66,0.0,38.0,38.0,1,114,0.0,86.0,86.0
0.016,6,10,1990,5,911,3.0,643.0,643.0,5,1079,3.0,811.0,811.0
0.054,17,4,284,2,120,50.0,32.0,32.0,2,164,16.0,60.0,54.0
0.011,6,10,1989,5,910,2.0,642.0,642.0,5,1079,2.0,811.0,811.0
0.022,6,10,1762,5,911,5.0,643.0,643.0,5,851,5.0,583.0,583.0
0.012,6,10,1631,5,848,2.0,580.0,580.0,5,783,3.0,515.0,515.0
0.005,6,10,2007,5,928,1.0,660.0,660.0,5,1079,1.0,811.0,811.0
40.074,17,10,676,5,460,10010.0,104.0,64.0,5,216,10017.0,20.0,15.0
0.132,17,4,284,2,120,0.0,32.0,32.0,2,164,60.0,60.0,54.0
369.872,6,22,2313,16,867,24658.0,195.0,195.0,6,1446,4638.0,419.0,398.0
1743.239,6,65,7396,43,4521,41505.0,1402.0,103.0,22,2875,83003.0,1111.0,82.0
0.117,6,10,1506,5,395,25.0,127.0,127.0,5,1111,27.0,843.0,843.0
0.019,6,10,1631,5,848,4.0,580.0,580.0,5,783,4.0,515.0,515.0
0.001,17,2,180,1,66,0.0,38.0,38.0,1,114,0.0,86.0,86.0
240.111,6,31,9323,15,7049,17150.0,2174.0,697.0,16,2274,16006.0,580.0,179.0
0.087,6,10,1506,5,395,20.0,127.0,127.0,5,1111,20.0,843.0,843.0
0.005,17,2,170,1,65,0.0,37.0,37.0,1,105,0.0,77.0,77.0
0.054,17,2,152,1,76,0.0,48.0,48.0,1,76,0.0,48.0,48.0
300.086,6,19,4660,11,1102,30008.0,238.0,130.0,8,3558,42869.0,1402.0,786.0
0.008,6,10,1972,5,910,2.0,642.0,642.0,5,1062,1.0,794.0,794.0
0.013,6,10,1989,5,910,3.0,642.0,642.0,5,1079,3.0,811.0,811.0
0.003,17,2,148,1,60,0.0,32.0,32.0,1,88,0.0,60.0,60.0
0.039,17,2,148,1,60,0.0,32.0,32.0,1,88,0.0,60.0,60.0
0.041,17,4,284,2,120,1.0,32.0,32.0,2,164,4.0,60.0,54.0
0.004,6,10,1989,5,927,1.0,659.0,659.0,5,1062,1.0,794.0,794.0
0.005,6,10,2006,5,927,1.0,659.0,659.0,5,1079,1.0,811.0,811.0
0.007,6,10,1689,5,839,1.0,571.0,571.0,5,850,1.0,582.0,582.0
0.009,6,12,1698,6,863,1.0,327.0,271.0,6,835,1.0,515.0,515.0
0.004,17,4,284,2,120,1.0,32.0,32.0,2,164,0.0,60.0,54.0
0.008,17,2,132,1,58,0.0,30.0,30.0,1,74,0.0,46.0,46.0
0.005,6,10,1989,5,927,1.0,659.0,659.0,5,1062,1.0,794.0,794.0
0.076,6,10,1506,5,395,16.0,127.0,127.0,5,1111,17.0,843.0,843.0
0.022,6,10,1990,5,911,5.0,643.0,643.0,5,1079,5.0,811.0,811.0
0.071,6,10,1506,5,395,15.0,127.0,127.0,5,1111,15.0,843.0,843.0
0.004,17,4,284,2,120,0.0,32.0,32.0,2,164,1.0,60.0,54.0
240.145,6,16,4482,9,963,30018.0,238.0,166.0,7,3519,40021.0,1402.0,786.0
0.005,17,2,140,1,62,0.0,34.0,34.0,1,78,0.0,50.0,50.0
0.003,17,2,136,1,60,0.0,32.0,32.0,1,76,0.0,48.0,48.0
0.02,6,10,1972,5,910,5.0,642.0,642.0,5,1062,5.0,794.0,794.0
0.02,17,4,284,2,120,12.0,32.0,32.0,2,164,10.0,60.0,54.0
40.053,17,10,676,5,460,10012.0,104.0,64.0,5,216,10012.0,20.0,15.0
373.638,6,22,2313,16,867,24909.0,195.0,195.0,6,1446,4640.0,419.0,398.0
0.005,17,2,170,1,65,0.0,37.0,37.0,1,105,0.0,77.0,77.0
0.004,17,4,284,2,120,1.0,32.0,32.0,2,164,1.0,60.0,54.0
0.006,6,10,1547,5,764,1.0,496.0,496.0,5,783,1.0,515.0,515.0
0.004,17,2,148,1,60,0.0,32.0,32.0,1,88,0.0,60.0,60.0
0.038,17,2,182,1,65,0.0,37.0,37.0,1,117,0.0,89.0,89.0
0.013,6,10,1990,5,911,3.0,643.0,643.0,5,1079,3.0,811.0,811.0
0.104,6,10,1506,5,395,24.0,127.0,127.0,5,1111,18.0,843.0,843.0
172.084,17,78,11041,39,2602,4528.0,44.0,38.0,39,8439,4528.0,239.0,188.0
0.005,6,10,2000,5,927,1.0,659.0,659.0,5,1073,1.0,805.0,805.0
240.091,6,16,4481,9,963,30011.0,238.0,166.0,7,3518,40014.0,1402.0,786.0
0.011,6,10,1983,5,910,2.0,642.0,642.0,5,1073,2.0,805.0,805.0
0.005,6,10,1774,5,923,1.0,655.0,655.0,5,851,1.0,583.0,583.0
178.087,17,80,11280,40,2673,4566.0,44.0,38.0,40,8607,4566.0,252.0,187.0
0.005,6,10,2006,5,927,1.0,659.0,659.0,5,1079,1.0,811.0,811.0
0.01,6,10,1990,5,911,2.0,643.0,643.0,5,1079,2.0,811.0,811.0
0.008,6,10,1972,5,910,2.0,642.0,642.0,5,1062,1.0,794.0,794.0
0.172,6,10,1506,5,395,38.0,127.0,127.0,5,1111,42.0,843.0,843.0
1756.228,6,107,6374,60,3525,29765.0,27.0,27.0,47,2849,38177.0,27.0,27.0
0.263,17,38,20201,21,17036,13.0,1350.0,783.0,17,3165,12.0,1350.0,158.0
0.006,17,2,166,1,75,0.0,47.0,47.0,1,91,0.0,63.0,63.0
0.045,17,2,152,1,76,0.0,48.0,48.0,1,76,0.0,48.0,48.0
0.013,6,10,1762,5,911,3.0,643.0,643.0,5,851,3.0,583.0,583.0
40.057,17,10,676,5,460,10013.0,104.0,64.0,5,216,10013.0,20.0,15.0
0.006,6,10,1547,5,764,1.0,496.0,496.0,5,783,1.0,515.0,515.0
181.097,17,84,11840,42,2808,4416.0,44.0,38.0,42,9032,4416.0,261.0,187.0
300.354,6,16,2170,9,684,37524.0,146.0,146.0,7,1486,50031.0,419.0,398.0
0.015,6,10,1972,5,910,3.0,642.0,642.0,5,1062,3.0,794.0,794.0
293.95,6,407,348445,201,22021,1469.0,2736.0,889.0,206,326424,1433.0,2804.0,1644.0
0.023,17,2,152,1,56,0.0,28.0,28.0,1,96,0.0,68.0,68.0
0.137,6,10,1506,5,395,31.0,127.0,127.0,5,1111,31.0,843.0,843.0
0.004,6,10,2006,5,927,1.0,659.0,659.0,5,1079,1.0,811.0,811.0
0.005,17,2,169,1,62,0.0,34.0,34.0,1,107,0.0,79.0,79.0
0.009,6,10,1983,5,910,2.0,642.0,642.0,5,1073,2.0,805.0,805.0
0.004,6,10,1989,5,927,1.0,659.0,659.0,5,1062,1.0,794.0,794.0
0.014,6,10,1989,5,910,3.0,642.0,642.0,5,1079,3.0,811.0,811.0
0.016,17,2,198,1,91,0.0,63.0,63.0,1,107,0.0,79.0,79.0
0.005,6,10,1547,5,764,1.0,496.0,496.0,5,783,1.0,515.0,515.0
1757.035,6,103,6166,59,3473,30292.0,27.0,27.0,44,2693,40860.0,27.0,27.0
0.011,17,2,179,1,71,0.0,43.0,43.0,1,108,0.0,80.0,80.0
0.012,6,10,1990,5,911,3.0,643.0,643.0,5,1079,3.0,811.0,811.0
0.073,17,2,148,1,60,0.0,32.0,32.0,1,88,0.0,60.0,60.0
0.147,6,10,1506,5,395,34.0,127.0,127.0,5,1111,34.0,843.0,843.0
0.004,6,10,1702,5,863,1.0,595.0,595.0,5,839,0.0,571.0,571.0
0.084,6,10,1506,5,395,18.0,127.0,127.0,5,1111,16.0,843.0,843.0
0.087,6,10,1506,5,395,20.0,127.0,127.0,5,1111,18.0,843.0,843.0
0.04,17,2,182,1,65,0.0,37.0,37.0,1,117,0.0,89.0,89.0
0.02,6,10,1972,5,910,5.0,642.0,642.0,5,1062,5.0,794.0,794.0
0.066,6,10,1506,5,395,14.0,127.0,127.0,5,1111,14.0,843.0,843.0
0.04,17,2,136,1,60,0.0,32.0,32.0,1,76,0.0,48.0,48.0
0.001,17,2,180,1,66,0.0,38.0,38.0,1,114,0.0,86.0,86.0
0.064,6,10,1506,5,395,14.0,127.0,127.0,5,1111,13.0,843.0,843.0
308.565,17,20,1124,10,716,34262.0,48.0,43.0,10,408,34269.0,20.0,12.0
0.101,6,10,1506,5,395,23.0,127.0,127.0,5,1111,23.0,843.0,843.0
0.098,6,10,1506,5,395,21.0,127.0,127.0,5,1111,21.0,843.0,843.0
0.011,6,10,1989,5,910,2.0,642.0,642.0,5,1079,2.0,811.0,811.0
0.006,6,10,1854,5,889,1.0,621.0,621.0,5,965,1.0,697.0,697.0
303.287,6,126,111461,56,7067,5514.0,1065.0,592.0,70,104394,4395.0,4206.0,1625.0
0.101,6,10,1506,5,395,22.0,127.0,127.0,5,1111,22.0,843.0,843.0
0.013,17,2,152,1,56,0.0,28.0,28.0,1,96,0.0,68.0,68.0
0.012,6,10,1989,5,910,3.0,642.0,642.0,5,1079,2.0,811.0,811.0
300.37,6,16,2170,9,684,37525.0,146.0,146.0,7,1486,50034.0,419.0,398.0
0.005,6,10,1989,5,927,1.0,659.0,659.0,5,1062,1.0,794.0,794.0
0.001,17,2,180,1,66,0.0,38.0,38.0,1,114,0.0,86.0,86.0
171.425,17,90,13050,45,3017,3895.0,44.0,39.0,45,10033,3896.0,260.0,194.0
0.012,6,10,1990,5,911,3.0,643.0,643.0,5,1079,2.0,811.0,811.0
0.006,6,10,1547,5,764,1.0,496.0,496.0,5,783,1.0,515.0,515.0
0.001,17,2,154,1,69,0.0,41.0,41.0,1,85,0.0,57.0,57.0
0.113,6,10,1506,5,395,23.0,127.0,127.0,5,1111,23.0,843.0,843.0
0.038,17,4,284,2,120,0.0,32.0,32.0,2,164,34.0,60.0,54.0
0.015,6,13,3735,7,497,2.0,125.0,125.0,6,3238,2.0,1470.0,1459.0
0.015,6,10,1989,5,910,3.0,642.0,642.0,5,1079,3.0,811.0,811.0
0.006,6,10,1547,5,764,1.0,496.0,496.0,5,783,1.0,515.0,515.0
0.01,6,10,1972,5,910,2.0,642.0,642.0,5,1062,2.0,794.0,794.0
0.021,6,10,1990,5,911,5.0,643.0,643.0,5,1079,5.0,811.0,811.0
0.008,6,12,1698,6,863,1.0,327.0,271.0,6,835,1.0,515.0,515.0
0.01,6,10,1989,5,910,2.0,642.0,642.0,5,1079,2.0,811.0,811.0
0.003,17,4,284,2,120,0.0,32.0,32.0,2,164,0.0,60.0,54.0
0.001,17,2,136,1,60,0.0,32.0,32.0,1,76,0.0,48.0,48.0
0.011,6,12,1926,6,1189,2.0,659.0,434.0,6,737,2.0,417.0,417.0
0.038,17,2,148,1,60,0.0,32.0,32.0,1,88,0.0,60.0,60.0
0.006,6,10,1547,5,764,1.0,496.0,496.0,5,783,1.0,515.0,515.0
0.004,17,2,169,1,62,0.0,34.0,34.0,1,107,0.0,79.0,79.0
0.086,6,10,1506,5,395,18.0,127.0,127.0,5,1111,20.0,843.0,843.0
0.004,6,10,2006,5,927,1.0,659.0,659.0,5,1079,1.0,811.0,811.0
0.04,17,4,284,2,120,0.0,32.0,32.0,2,164,36.0,60.0,54.0
0.107,6,10,1506,5,395,19.0,127.0,127.0,5,1111,22.0,843.0,843.0
0.004,6,10,1989,5,927,1.0,659.0,659.0,5,1062,1.0,794.0,794.0
40.059,17,10,676,5,460,10013.0,104.0,64.0,5,216,10013.0,20.0,15.0
0.017,6,10,1983,5,910,4.0,642.0,642.0,5,1073,4.0,805.0,805.0
0.011,6,10,1989,5,910,2.0,642.0,642.0,5,1079,2.0,811.0,811.0
0.006,6,10,2006,5,927,1.0,659.0,659.0,5,1079,1.0,811.0,811.0
0.058,6,10,1506,5,395,12.0,127.0,127.0,5,1111,13.0,843.0,843.0
0.006,17,2,169,1,62,0.0,34.0,34.0,1,107,0.0,79.0,79.0
0.004,6,10,1989,5,927,1.0,659.0,659.0,5,1062,1.0,794.0,794.0
361.845,6,21,1792,16,1030,24123.0,190.0,190.0,5,762,60011.0,461.0,247.0
0.001,17,2,180,1,66,0.0,38.0,38.0,1,114,0.0,86.0,86.0
0.004,17,4,284,2,120,0.0,32.0,32.0,2,164,1.0,60.0,54.0
0.007,6,10,1547,5,764,1.0,496.0,496.0,5,783,1.0,515.0,515.0
0.005,6,10,1779,5,928,1.0,660.0,660.0,5,851,1.0,583.0,583.0
0.005,6,10,1989,5,927,1.0,659.0,659.0,5,1062,1.0,794.0,794.0
10.906,17,26,4101,13,1821,899.0,268.0,112.0,13,2280,899.0,587.0,147.0
0.016,6,10,1989,5,910,3.0,642.0,642.0,5,1079,3.0,811.0,811.0
0.123,17,2,80,1,32,0.0,4.0,4.0,1,48,0.0,20.0,20.0
0.023,6,10,1972,5,910,5.0,642.0,642.0,5,1062,5.0,794.0,794.0
0.012,6,10,1983,5,910,2.0,642.0,642.0,5,1073,3.0,805.0,805.0
0.004,6,10,1774,5,923,1.0,655.0,655.0,5,851,1.0,583.0,583.0
0.037,17,2,182,1,65,0.0,37.0,37.0,1,117,0.0,89.0,89.0
0.001,17,2,180,1,66,0.0,38.0,38.0,1,114,0.0,86.0,86.0
0.01,6,10,1989,5,910,2.0,642.0,642.0,5,1079,2.0,811.0,811.0
0.005,6,10,1689,5,839,1.0,571.0,571.0,5,850,1.0,582.0,582.0
40.062,17,10,676,5,460,10012.0,104.0,64.0,5,216,10014.0,20.0,15.0
0.109,6,18,7621,10,808,12.0,280.0,280.0,8,6813,14.0,1402.0,1277.0
0.006,6,10,1547,5,764,1.0,496.0,496.0,5,783,1.0,515.0,515.0
0.006,6,10,1547,5,764,1.0,496.0,496.0,5,783,1.0,515.0,515.0
0.005,6,10,2000,5,927,1.0,659.0,659.0,5,1073,1.0,805.0,805.0
0.005,6,10,2006,5,927,1.0,659.0,659.0,5,1079,1.0,811.0,811.0
0.009,6,12,1926,6,1189,1.0,659.0,434.0,6,737,1.0,417.0,417.0
40.101,17,10,676,5,460,10024.0,104.0,64.0,5,216,10024.0,20.0,15.0
0.005,6,10,1689,5,839,1.0,571.0,571.0,5,850,1.0,582.0,582.0
0.015,6,10,1983,5,910,3.0,642.0,642.0,5,1073,3.0,805.0,805.0
0.013,6,10,1677,5,827,3.0,559.0,559.0,5,850,3.0,582.0,582.0
0.106,6,10,1506,5,395,24.0,127.0,127.0,5,1111,22.0,843.0,843.0
0.005,6,10,2006,5,927,1.0,659.0,659.0,5,1079,1.0,811.0,811.0
0.005,6,10,2000,5,927,1.0,659.0,659.0,5,1073,1.0,805.0,805.0
0.016,6,10,1989,5,910,3.0,642.0,642.0,5,1079,4.0,811.0,811.0
0.015,6,10,1990,5,911,3.0,643.0,643.0,5,1079,3.0,811.0,811.0
0.005,17,2,180,1,66,0.0,38.0,38.0,1,114,0.0,86.0,86.0
5.17,6,25,7106,14,1891,397.0,801.0,282.0,11,5215,516.0,1925.0,774.0
0.005,6,13,3747,7,509,0.0,137.0,137.0,6,3238,0.0,1470.0,1459.0
40.069,17,10,676,5,460,10014.0,104.0,64.0,5,216,10016.0,20.0,15.0
0.006,6,10,1547,5,764,1.0,496.0,496.0,5,783,1.0,515.0,515.0
0.014,17,2,152,1,56,0.0,28.0,28.0,1,96,0.0,68.0,68.0
0.005,6,10,1989,5,927,1.0,659.0,659.0,5,1062,1.0,794.0,794.0
0.004,6,13,3690,7,452,0.0,80.0,80.0,6,3238,0.0,1470.0,1459.0
0.011,6,10,1989,5,910,2.0,642.0,642.0,5,1079,2.0,811.0,811.0
365.983,6,22,2313,16,867,24398.0,195.0,195.0,6,1446,4649.0,419.0,398.0
0.01,6,10,1990,5,911,2.0,643.0,643.0,5,1079,2.0,811.0,811.0
0.005,17,2,193,1,71,0.0,43.0,43.0,1,122,0.0,94.0,94.0
0.005,6,10,2000,5,927,1.0,659.0,659.0,5,1073,1.0,805.0,805.0
0.138,6,10,1506,5,395,33.0,127.0,127.0,5,1111,31.0,843.0,843.0
9.041,17,6,376,5,280,2260.0,28.0,28.0,1,96,0.0,68.0,68.0
0.003,17,2,148,1,60,0.0,32.0,32.0,1,88,0.0,60.0,60.0
0.006,6,10,1643,5,860,1.0,592.0,592.0,5,783,1.0,515.0,515.0
10.887,17,28,4422,14,1994,828.0,269.0,114.0,14,2428,828.0,587.0,145.0
240.101,6,16,4480,9,963,30012.0,238.0,166.0,7,3517,40016.0,1402.0,786.0
0.006,6,10,1643,5,860,1.0,592.0,592.0,5,783,1.0,515.0,515.0
0.002,17,2,180,1,66,0.0,38.0,38.0,1,114,0.0,86.0,86.0
0.005,6,10,2000,5,927,1.0,659.0,659.0,5,1073,1.0,805.0,805.0
0.014,6,10,1983,5,910,3.0,642.0,642.0,5,1073,3.0,805.0,805.0
0.01,6,10,1972,5,910,2.0,642.0,642.0,5,1062,2.0,794.0,794.0
0.004,6,10,2007,5,928,1.0,660.0,660.0,5,1079,1.0,811.0,811.0
0.013,6,10,1989,5,910,3.0,642.0,642.0,5,1079,3.0,811.0,811.0
0.006,17,2,146,1,65,0.0,37.0,37.0,1,81,0.0,53.0,53.0
0.009,6,10,1972,5,910,2.0,642.0,642.0,5,1062,2.0,794.0,794.0
0.005,17,2,170,1,65,0.0,37.0,37.0,1,105,0.0,77.0,77.0
0.004,17,2,169,1,62,0.0,34.0,34.0,1,107,0.0,79.0,79.0
0.006,17,2,136,1,60,0.0,32.0,32.0,1,76,0.0,48.0,48.0
0.003,17,4,284,2,120,0.0,32.0,32.0,2,164,0.0,60.0,54.0
0.013,6,10,1990,5,911,3.0,643.0,643.0,5,1079,3.0,811.0,811.0
0.021,6,10,1990,5,911,5.0,643.0,643.0,5,1079,5.0,811.0,811.0
0.01,6,10,1677,5,827,2.0,559.0,559.0,5,850,2.0,582.0,582.0
0.2,6,16,2778,8,1396,28.0,533.0,324.0,8,1382,17.0,529.0,239.0
0.005,6,10,1779,5,928,1.0,660.0,660.0,5,851,1.0,583.0,583.0
0.006,6,10,1854,5,889,1.0,621.0,621.0,5,965,1.0,697.0,697.0
0.004,6,10,2006,5,927,1.0,659.0,659.0,5,1079,1.0,811.0,811.0
0.379,17,40,20270,22,17083,18.0,1350.0,748.0,18,3187,18.0,1350.0,149.0
300.311,6,16,2170,9,684,37519.0,146.0,146.0,7,1486,50024.0,419.0,398.0
367.183,6,24,2405,17,919,22948.0,195.0,195.0,7,1486,3961.0,419.0,398.0
15.07,17,14,9190,8,6902,2148.0,1350.0,834.0,6,2288,3008.0,1350.0,353.0
0.016,6,10,1989,5,910,3.0,642.0,642.0,5,1079,3.0,811.0,811.0
0.042,17,2,136,1,60,0.0,32.0,32.0,1,76,0.0,48.0,48.0
0.019,6,10,1989,5,910,4.0,642.0,642.0,5,1079,4.0,811.0,811.0
0.017,6,13,3735,7,497,2.0,125.0,125.0,6,3238,3.0,1470.0,1459.0
15.075,17,15,9238,8,6902,2149.0,1350.0,834.0,7,2336,2507.0,1350.0,305.0
0.088,17,4,352,2,130,49.0,37.0,37.0,2,222,49.0,89.0,83.0
40.07,17,10,676,5,460,10016.0,104.0,64.0,5,216,10016.0,20.0,15.0
0.017,6,10,1972,5,910,4.0,642.0,642.0,5,1062,4.0,794.0,794.0
174.215,17,88,12728,44,2955,4051.0,44.0,39.0,44,9773,4051.0,239.0,194.0
0.01,6,10,1990,5,911,2.0,643.0,643.0,5,1079,2.0,811.0,811.0
0.004,6,10,1702,5,863,1.0,595.0,595.0,5,839,0.0,571.0,571.0
0.013,6,7,695,4,448,4.0,232.0,232.0,3,247,4.0,83.0,83.0
0.006,17,2,180,1,66,0.0,38.0,38.0,1,114,0.0,86.0,86.0
0.005,6,10,1989,5,927,1.0,659.0,659.0,5,1062,1.0,794.0,794.0
0.005,17,2,168,1,76,0.0,48.0,48.0,1,92,0.0,64.0,64.0
0.005,6,10,1547,5,764,1.0,496.0,496.0,5,783,1.0,515.0,515.0
0.016,6,10,1989,5,910,4.0,642.0,642.0,5,1079,3.0,811.0,811.0
0.001,17,2,180,1,66,0.0,38.0,38.0,1,114,0.0,86.0,86.0
0.005,6,10,1547,5,764,1.0,496.0,496.0,5,783,1.0,515.0,515.0
0.09,6,10,1506,5,395,19.0,127.0,127.0,5,1111,20.0,843.0,843.0
0.003,17,2,148,1,60,0.0,32.0,32.0,1,88,0.0,60.0,60.0
0.005,6,10,2006,5,927,1.0,659.0,659.0,5,1079,1.0,811.0,811.0
0.118,6,10,1506,5,395,25.0,127.0,127.0,5,1111,23.0,843.0,843.0
40.056,17,10,676,5,460,10013.0,104.0,64.0,5,216,10013.0,20.0,15.0
0.005,6,10,1989,5,927,1.0,659.0,659.0,5,1062,1.0,794.0,794.0
0.107,6,10,1506,5,395,23.0,127.0,127.0,5,1111,25.0,843.0,843.0
0.069,17,8,3613,4,1874,23.0,1350.0,440.0,4,1739,11.0,1350.0,406.0
0.005,6,13,3690,7,452,0.0,80.0,80.0,6,3238,0.0,1470.0,1459.0
0.004,17,4,284,2,120,0.0,32.0,32.0,2,164,1.0,60.0,54.0
0.004,6,10,1989,5,927,1.0,659.0,659.0,5,1062,1.0,794.0,794.0
0.006,17,2,230,1,68,0.0,40.0,40.0,1,162,0.0,134.0,134.0
0.003,17,4,284,2,120,0.0,32.0,32.0,2,164,0.0,60.0,54.0
0.004,17,2,148,1,60,0.0,32.0,32.0,1,88,0.0,60.0,60.0
0.013,17,2,152,1,56,0.0,28.0,28.0,1,96,0.0,68.0,68.0
0.129,6,10,1506,5,395,31.0,127.0,127.0,5,1111,29.0,843.0,843.0
352.25,6,20,2210,6,1308,12003.0,494.0,494.0,14,902,27095.0,83.0,83.0
0.077,6,10,1506,5,395,16.0,127.0,127.0,5,1111,17.0,843.0,843.0
40.065,17,10,676,5,460,10015.0,104.0,64.0,5,216,10015.0,20.0,15.0
0.186,17,16,8765,9,6197,23.0,1350.0,660.0,7,2568,21.0,1350.0,338.0
0.017,6,13,3816,7,578,2.0,206.0,206.0,6,3238,3.0,1470.0,1459.0
0.014,6,10,1990,5,911,3.0,643.0,643.0,5,1079,3.0,811.0,811.0
0.104,6,10,1506,5,395,23.0,127.0,127.0,5,1111,24.0,843.0,843.0
0.041,17,2,412,1,61,0.0,33.0,33.0,1,351,0.0,323.0,323.0
0.006,6,10,1547,5,764,1.0,496.0,496.0,5,783,1.0,515.0,515.0
240.393,6,44,8823,22,5738,11447.0,1368.0,458.0,22,3085,11447.0,580.0,241.0
0.006,6,10,1547,5,764,1.0,496.0,496.0,5,783,1.0,515.0,515.0
0.091,6,10,1506,5,395,18.0,127.0,127.0,5,1111,20.0,843.0,843.0
0.016,6,10,1990,5,911,4.0,643.0,643.0,5,1079,3.0,811.0,811.0
0.012,6,10,1631,5,848,3.0,580.0,580.0,5,783,2.0,515.0,515.0
0.005,6,10,2007,5,928,1.0,660.0,660.0,5,1079,1.0,811.0,811.0
0.153,6,10,1506,5,395,36.0,127.0,127.0,5,1111,32.0,843.0,843.0
0.018,6,10,1990,5,911,4.0,643.0,643.0,5,1079,4.0,811.0,811.0
15.083,17,16,8723,8,6655,2150.0,1350.0,803.0,8,2068,2150.0,1350.0,230.0
0.001,17,2,180,1,66,0.0,38.0,38.0,1,114,0.0,86.0,86.0
0.005,6,10,2000,5,927,1.0,659.0,659.0,5,1073,1.0,805.0,805.0
10.803,17,26,4103,13,1823,891.0,270.0,112.0,13,2280,891.0,587.0,147.0
0.039,17,4,284,2,120,0.0,32.0,32.0,2,164,36.0,60.0,54.0
0.004,6,10,2006,5,927,1.0,659.0,659.0,5,1079,1.0,811.0,811.0
0.1,6,10,1506,5,395,19.0,127.0,127.0,5,1111,20.0,843.0,843.0
0.014,6,10,1990,5,911,3.0,643.0,643.0,5,1079,3.0,811.0,811.0
0.025,6,10,1989,5,910,6.0,642.0,642.0,5,1079,6.0,811.0,811.0
0.006,6,10,1854,5,889,1.0,621.0,621.0,5,965,1.0,697.0,697.0
0.182,6,10,1506,5,395,43.0,127.0,127.0,5,1111,41.0,843.0,843.0
0.019,6,10,1989,5,910,4.0,642.0,642.0,5,1079,4.0,811.0,811.0
0.013,6,10,1989,5,910,3.0,642.0,642.0,5,1079,3.0,811.0,811.0
0.077,6,40,10597,22,2461,3.0,517.0,146.0,18,8136,4.0,1402.0,599.0
0.009,6,14,3787,7,497,1.0,125.0,125.0,7,3290,1.0,1448.0,972.0
0.005,6,10,1689,5,839,1.0,571.0,571.0,5,850,1.0,582.0,582.0
0.082,6,10,1506,5,395,18.0,127.0,127.0,5,1111,17.0,843.0,843.0
0.008,6,10,1972,5,910,2.0,642.0,642.0,5,1062,2.0,794.0,794.0
0.076,6,10,1506,5,395,18.0,127.0,127.0,5,1111,17.0,843.0,843.0
0.006,6,10,1989,5,927,1.0,659.0,659.0,5,1062,1.0,794.0,794.0
0.007,6,10,1972,5,910,1.0,642.0,642.0,5,1062,1.0,794.0,794.0
0.004,6,10,2007,5,928,1.0,660.0,660.0,5,1079,1.0,811.0,811.0
0.108,6,10,1506,5,395,24.0,127.0,127.0,5,1111,22.0,843.0,843.0
0.099,6,10,1506,5,395,19.0,127.0,127.0,5,1111,21.0,843.0,843.0
0.008,17,2,148,1,60,0.0,32.0,32.0,1,88,0.0,60.0,60.0
0.004,6,10,2007,5,928,1.0,660.0,660.0,5,1079,1.0,811.0,811.0
0.174,6,3,453,2,321,174.0,241.0,241.0,1,132,0.0,92.0,92.0
0.004,6,10,1702,5,863,1.0,595.0,595.0,5,839,1.0,571.0,571.0
0.006,6,10,1689,5,839,1.0,571.0,571.0,5,850,1.0,582.0,582.0
0.007,6,10,1779,5,928,1.0,660.0,660.0,5,851,1.0,583.0,583.0
0.087,6,10,1506,5,395,19.0,127.0,127.0,5,1111,20.0,843.0,843.0
0.008,6,12,1926,6,1189,1.0,659.0,434.0,6,737,1.0,417.0,417.0
0.005,6,13,3747,7,509,0.0,137.0,137.0,6,3238,1.0,1470.0,1459.0
0.005,17,2,170,1,65,0.0,37.0,37.0,1,105,0.0,77.0,77.0
40.062,17,10,676,5,460,10012.0,104.0,64.0,5,216,10014.0,20.0,15.0
10.978,17,28,4422,14,1994,835.0,269.0,114.0,14,2428,835.0,587.0,145.0
0.103,6,10,1506,5,395,25.0,127.0,127.0,5,1111,21.0,843.0,843.0
0.001,17,2,166,1,75,0.0,47.0,47.0,1,91,0.0,63.0,63.0
40.063,17,10,676,5,460,10014.0,104.0,64.0,5,216,10014.0,20.0,15.0
308.629,17,20,1124,10,716,34280.0,48.0,43.0,10,408,34285.0,20.0,12.0
0.012,6,10,1989,5,910,3.0,642.0,642.0,5,1079,2.0,811.0,811.0
0.038,17,2,146,1,65,0.0,37.0,37.0,1,81,0.0,53.0,53.0
0.017,6,10,1990,5,911,4.0,643.0,643.0,5,1079,4.0,811.0,811.0
0.006,6,10,1547,5,764,1.0,496.0,496.0,5,783,1.0,515.0,515.0
0.016,6,10,1990,5,911,3.0,643.0,643.0,5,1079,3.0,811.0,811.0
0.005,6,10,1989,5,927,1.0,659.0,659.0,5,1062,1.0,794.0,794.0
0.006,6,13,3747,7,509,1.0,137.0,137.0,6,3238,1.0,1470.0,1459.0
0.085,6,10,1506,5,395,17.0,127.0,127.0,5,1111,19.0,843.0,843.0
0.008,17,2,185,1,73,0.0,45.0,45.0,1,112,0.0,84.0,84.0
0.004,6,10,1779,5,928,1.0,660.0,660.0,5,851,1.0,583.0,583.0
0.007,6,10,1547,5,764,1.0,496.0,496.0,5,783,1.0,515.0,515.0
0.01,6,10,1990,5,911,2.0,643.0,643.0,5,1079,2.0,811.0,811.0
0.006,6,10,1689,5,839,1.0,571.0,571.0,5,850,1.0,582.0,582.0
0.094,6,10,1506,5,395,21.0,127.0,127.0,5,1111,22.0,843.0,843.0
0.13,17,2,148,1,60,0.0,32.0,32.0,1,88,0.0,60.0,60.0
0.009,6,13,3735,7,497,1.0,125.0,125.0,6,3238,1.0,1470.0,1459.0
300.78,6,39,13269,21,7751,15039.0,2720.0,1146.0,18,5518,507.0,2667.0,435.0
11.18,17,28,4422,14,1993,847.0,268.0,114.0,14,2429,847.0,588.0,145.0
0.01,6,10,1990,5,911,2.0,643.0,643.0,5,1079,2.0,811.0,811.0
0.001,17,2,180,1,65,0.0,37.0,37.0,1,115,0.0,87.0,87.0
0.004,6,10,1779,5,928,1.0,660.0,660.0,5,851,1.0,583.0,583.0
0.005,6,10,2006,5,927,1.0,659.0,659.0,5,1079,1.0,811.0,811.0
0.004,6,10,1989,5,927,1.0,659.0,659.0,5,1062,1.0,794.0,794.0
0.085,6,10,1506,5,395,18.0,127.0,127.0,5,1111,15.0,843.0,843.0
0.082,6,10,1506,5,395,18.0,127.0,127.0,5,1111,17.0,843.0,843.0
0.015,17,2,198,1,91,0.0,63.0,63.0,1,107,0.0,79.0,79.0
0.011,6,10,1989,5,910,2.0,642.0,642.0,5,1079,2.0,811.0,811.0
0.009,6,10,1983,5,910,2.0,642.0,642.0,5,1073,2.0,805.0,805.0
319.164,17,20,1124,10,716,35456.0,48.0,43.0,10,408,35455.0,20.0,12.0
0.078,6,10,1506,5,395,17.0,127.0,127.0,5,1111,15.0,843.0,843.0
0.095,6,10,1506,5,395,20.0,127.0,127.0,5,1111,22.0,843.0,843.0
10.778,17,28,4421,14,1994,820.0,269.0,114.0,14,2427,820.0,586.0,145.0
0.009,6,10,1983,5,910,2.0,642.0,642.0,5,1073,2.0,805.0,805.0
0.176,6,10,1506,5,395,41.0,127.0,127.0,5,1111,33.0,843.0,843.0
0.005,6,14,3742,7,452,0.0,80.0,80.0,7,3290,0.0,1448.0,972.0
40.08,17,10,676,5,460,10019.0,104.0,64.0,5,216,10019.0,20.0,15.0
0.136,6,10,1506,5,395,31.0,127.0,127.0,5,1111,31.0,843.0,843.0
0.006,6,10,1547,5,764,1.0,496.0,496.0,5,783,1.0,515.0,515.0
0.005,6,10,1774,5,923,1.0,655.0,655.0,5,851,1.0,583.0,583.0
10.693,6,29,10301,16,8994,712.0,2883.0,1166.0,13,1307,890.0,346.0,105.0
0.006,6,10,1547,5,764,1.0,496.0,496.0,5,783,1.0,515.0,515.0
0.004,6,10,2007,5,928,1.0,660.0,660.0,5,1079,1.0,811.0,811.0
0.021,6,10,1989,5,910,5.0,642.0,642.0,5,1079,5.0,811.0,811.0
0.01,6,10,1983,5,910,2.0,642.0,642.0,5,1073,2.0,805.0,805.0
40.074,17,10,676,5,460,10015.0,104.0,64.0,5,216,10017.0,20.0,15.0
0.004,6,10,2006,5,927,1.0,659.0,659.0,5,1079,1.0,811.0,811.0
0.009,6,10,1989,5,910,2.0,642.0,642.0,5,1079,2.0,811.0,811.0
0.022,6,10,1990,5,911,5.0,643.0,643.0,5,1079,5.0,811.0,811.0
0.067,17,8,3613,4,1874,22.0,1350.0,440.0,4,1739,11.0,1350.0,406.0
0.005,6,10,2000,5,927,1.0,659.0,659.0,5,1073,1.0,805.0,805.0
0.005,6,14,3799,7,509,0.0,137.0,137.0,7,3290,0.0,1448.0,972.0
0.005,6,10,2000,5,927,1.0,659.0,659.0,5,1073,1.0,805.0,805.0
0.012,6,10,1990,5,911,2.0,643.0,643.0,5,1079,3.0,811.0,811.0
0.101,6,10,1506,5,395,21.0,127.0,127.0,5,1111,23.0,843.0,843.0
0.038,17,2,148,1,60,0.0,32.0,32.0,1,88,0.0,60.0,60.0
0.006,17,2,230,1,68,0.0,40.0,40.0,1,162,0.0,134.0,134.0
1.018,6,13,3922,7,2139,128.0,1328.0,923.0,6,1783,153.0,1539.0,1539.0
10.99,17,26,4074,13,2164,906.0,587.0,138.0,13,1910,906.0,269.0,118.0
0.117,6,10,1506,5,395,24.0,127.0,127.0,5,1111,25.0,843.0,843.0
0.004,6,10,2006,5,927,1.0,659.0,659.0,5,1079,1.0,811.0,811.0
0.167,17,2,152,1,76,0.0,48.0,48.0,1,76,0.0,48.0,48.0
0.006,6,10,1779,5,928,1.0,660.0,660.0,5,851,1.0,583.0,583.0
15.14,17,15,8302,8,6140,2156.0,1350.0,739.0,7,2162,2515.0,1350.0,280.0
0.041,17,2,182,1,65,0.0,37.0,37.0,1,117,0.0,89.0,89.0
1797.364,17,3149,241292,1568,127023,1147.0,84.0,53.0,1581,114269,1137.0,227.0,44.0
0.004,6,10,1774,5,923,1.0,655.0,655.0,5,851,1.0,583.0,583.0
0.007,17,2,164,1,74,0.0,46.0,46.0,1,90,0.0,62.0,62.0
413.267,6,29,4409,12,3102,10911.0,494.0,494.0,17,1307,25829.0,83.0,83.0
0.004,6,10,1774,5,923,1.0,655.0,655.0,5,851,1.0,583.0,583.0
0.005,6,10,2007,5,928,1.0,660.0,660.0,5,1079,1.0,811.0,811.0
0.005,6,13,3747,7,509,0.0,137.0,137.0,6,3238,1.0,1470.0,1459.0
0.041,17,4,284,2,120,1.0,32.0,32.0,2,164,37.0,60.0,54.0
0.01,6,10,1989,5,910,2.0,642.0,642.0,5,1079,2.0,811.0,811.0
0.078,6,10,1506,5,395,17.0,127.0,127.0,5,1111,17.0,843.0,843.0
0.071,6,10,1506,5,395,15.0,127.0,127.0,5,1111,16.0,843.0,843.0
0.005,6,10,1689,5,839,1.0,571.0,571.0,5,850,1.0,582.0,582.0
0.037,17,4,284,2,120,0.0,32.0,32.0,2,164,33.0,60.0,54.0
0.013,6,10,1677,5,827,3.0,559.0,559.0,5,850,3.0,582.0,582.0
394.362,6,24,2405,17,919,24647.0,195.0,195.0,7,1486,3912.0,419.0,398.0
0.078,6,10,1506,5,395,18.0,127.0,127.0,5,1111,14.0,843.0,843.0
0.001,17,2,180,1,66,0.0,38.0,38.0,1,114,0.0,86.0,86.0
0.005,6,10,1643,5,860,1.0,592.0,592.0,5,783,1.0,515.0,515.0
0.091,6,10,1506,5,395,20.0,127.0,127.0,5,1111,18.0,843.0,843.0
0.227,6,16,2669,8,1395,32.0,533.0,323.0,8,1274,20.0,529.0,212.0
0.005,6,10,1547,5,764,1.0,496.0,496.0,5,783,1.0,515.0,515.0
0.108,6,10,1506,5,395,23.0,127.0,127.0,5,1111,23.0,843.0,843.0
0.012,6,10,1990,5,911,3.0,643.0,643.0,5,1079,2.0,811.0,811.0
0.004,6,10,2006,5,927,1.0,659.0,659.0,5,1079,1.0,811.0,811.0
0.004,17,2,148,1,60,0.0,32.0,32.0,1,88,0.0,60.0,60.0
180.314,6,42,9196,24,3014,7839.0,664.0,160.0,18,6182,10606.0,1402.0,525.0
40.062,17,10,676,5,460,10014.0,104.0,64.0,5,216,10014.0,20.0,15.0
0.088,6,10,1506,5,395,19.0,127.0,127.0,5,1111,19.0,843.0,843.0
0.001,17,2,179,1,62,0.0,34.0,34.0,1,117,0.0,89.0,89.0
0.017,6,10,1989,5,910,4.0,642.0,642.0,5,1079,4.0,811.0,811.0
40.067,17,10,676,5,460,10016.0,104.0,64.0,5,216,10015.0,20.0,15.0
0.02,6,10,1972,5,910,5.0,642.0,642.0,5,1062,4.0,794.0,794.0
0.126,17,2,136,1,60,0.0,32.0,32.0,1,76,0.0,48.0,48.0
1793.856,6,288,27236,146,10044,12371.0,747.0,270.0,142,17192,12722.0,1625.0,72.0
300.542,6,36,12419,20,1850,15817.0,300.0,158.0,16,10569,20035.0,2804.0,1081.0
66.176,6,31,17900,14,9574,5090.0,2804.0,1475.0,17,8326,4128.0,2313.0,675.0
0.004,6,10,1989,5,927,1.0,659.0,659.0,5,1062,1.0,794.0,794.0
0.005,17,2,214,1,75,0.0,47.0,47.0,1,139,0.0,111.0,111.0
0.014,6,10,1989,5,910,3.0,642.0,642.0,5,1079,3.0,811.0,811.0
0.001,17,2,180,1,66,0.0,38.0,38.0,1,114,0.0,86.0,86.0
0.006,6,10,1547,5,764,1.0,496.0,496.0,5,783,1.0,515.0,515.0
0.145,6,10,1506,5,395,32.0,127.0,127.0,5,1111,31.0,843.0,843.0
0.005,6,10,2006,5,927,1.0,659.0,659.0,5,1079,1.0,811.0,811.0
0.005,6,10,1989,5,927,1.0,659.0,659.0,5,1062,1.0,794.0,794.0
0.003,17,2,136,1,60,0.0,32.0,32.0,1,76,0.0,48.0,48.0
0.063,6,10,1506,5,395,14.0,127.0,127.0,5,1111,14.0,843.0,843.0
0.005,6,13,3747,7,509,0.0,137.0,137.0,6,3238,0.0,1470.0,1459.0
0.016,6,10,1631,5,848,4.0,580.0,580.0,5,783,4.0,515.0,515.0
0.004,6,10,2006,5,927,1.0,659.0,659.0,5,1079,1.0,811.0,811.0
0.004,17,2,136,1,60,0.0,32.0,32.0,1,76,0.0,48.0,48.0
0.052,17,2,152,1,76,0.0,48.0,48.0,1,76,0.0,48.0,48.0
0.002,17,2,180,1,66,0.0,38.0,38.0,1,114,0.0,86.0,86.0
1786.363,6,150,19350,90,13740,20071.0,302.0,302.0,60,5610,30277.0,83.0,83.0
0.116,6,10,1506,5,395,25.0,127.0,127.0,5,1111,27.0,843.0,843.0
0.005,6,10,2006,5,927,1.0,659.0,659.0,5,1079,1.0,811.0,811.0
0.009,6,13,3735,7,497,1.0,125.0,125.0,6,3238,1.0,1470.0,1459.0
0.004,17,4,284,2,120,0.0,32.0,32.0,2,164,1.0,60.0,54.0
0.018,17,4,284,2,120,0.0,32.0,32.0,2,164,0.0,60.0,54.0
0.008,6,10,1972,5,910,2.0,642.0,642.0,5,1062,2.0,794.0,794.0
0.02,6,10,1762,5,911,5.0,643.0,643.0,5,851,5.0,583.0,583.0
0.009,6,12,1926,6,1189,1.0,659.0,434.0,6,737,1.0,417.0,417.0
0.009,6,10,1631,5,848,2.0,580.0,580.0,5,783,2.0,515.0,515.0
0.015,6,10,1990,5,911,3.0,643.0,643.0,5,1079,3.0,811.0,811.0
40.077,17,10,676,5,460,10015.0,104.0,64.0,5,216,10017.0,20.0,15.0
240.017,6,9,787,5,488,60004.0,232.0,232.0,4,299,80004.0,83.0,83.0
0.083,6,10,1506,5,395,19.0,127.0,127.0,5,1111,18.0,843.0,843.0
0.002,17,2,136,1,60,0.0,32.0,32.0,1,76,0.0,48.0,48.0
0.008,6,10,1677,5,827,2.0,559.0,559.0,5,850,1.0,582.0,582.0
0.009,6,13,3913,7,495,1.0,123.0,123.0,6,3418,1.0,1650.0,1549.0
0.005,6,10,1989,5,927,1.0,659.0,659.0,5,1062,1.0,794.0,794.0
0.09,6,10,1506,5,395,21.0,127.0,127.0,5,1111,20.0,843.0,843.0
0.005,17,2,180,1,66,0.0,38.0,38.0,1,114,0.0,86.0,86.0
0.005,6,10,1643,5,860,1.0,592.0,592.0,5,783,1.0,515.0,515.0
240.087,6,16,4481,9,963,30010.0,238.0,166.0,7,3518,40014.0,1402.0,786.0
0.005,6,10,2006,5,927,1.0,659.0,659.0,5,1079,1.0,811.0,811.0
0.079,6,10,1506,5,395,18.0,127.0,127.0,5,1111,16.0,843.0,843.0
0.005,6,10,1774,5,923,1.0,655.0,655.0,5,851,1.0,583.0,583.0
0.005,17,2,169,1,62,0.0,34.0,34.0,1,107,0.0,79.0,79.0
0.004,17,2,136,1,60,0.0,32.0,32.0,1,76,0.0,48.0,48.0
40.052,17,10,676,5,460,10012.0,104.0,64.0,5,216,10012.0,20.0,15.0
309.26,17,20,1124,10,716,34351.0,48.0,43.0,10,408,34350.0,20.0,12.0
40.079,17,10,676,5,460,10014.0,104.0,64.0,5,216,10018.0,20.0,15.0
0.164,6,10,1506,5,395,33.0,127.0,127.0,5,1111,28.0,843.0,843.0
0.006,6,10,1547,5,764,1.0,496.0,496.0,5,783,1.0,515.0,515.0
354.022,6,21,1795,16,1030,23601.0,190.0,190.0,5,765,60002.0,464.0,248.0
0.012,6,10,1983,5,910,3.0,642.0,642.0,5,1073,3.0,805.0,805.0
0.005,6,13,3747,7,509,0.0,137.0,137.0,6,3238,1.0,1470.0,1459.0
0.006,6,10,1547,5,764,1.0,496.0,496.0,5,783,1.0,515.0,515.0
0.117,17,2,80,1,32,0.0,4.0,4.0,1,48,0.0,20.0,20.0
0.005,6,10,2007,5,928,1.0,660.0,660.0,5,1079,1.0,811.0,811.0
0.072,6,10,1506,5,395,15.0,127.0,127.0,5,1111,15.0,843.0,843.0
0.064,6,10,1506,5,395,15.0,127.0,127.0,5,1111,15.0,843.0,843.0
0.005,6,10,1547,5,764,1.0,496.0,496.0,5,783,1.0,515.0,515.0
0.009,6,10,1983,5,910,2.0,642.0,642.0,5,1073,2.0,805.0,805.0
0.011,6,10,1989,5,910,2.0,642.0,642.0,5,1079,2.0,811.0,811.0
0.082,6,10,1506,5,395,18.0,127.0,127.0,5,1111,17.0,843.0,843.0
0.01,6,10,1762,5,911,2.0,643.0,643.0,5,851,2.0,583.0,583.0
0.014,6,10,1990,5,911,3.0,643.0,643.0,5,1079,3.0,811.0,811.0
0.082,6,10,1506,5,395,17.0,127.0,127.0,5,1111,17.0,843.0,843.0
40.064,17,10,676,5,460,10012.0,104.0,64.0,5,216,10015.0,20.0,15.0
0.004,17,2,412,1,61,0.0,33.0,33.0,1,351,0.0,323.0,323.0
15.073,17,14,9190,8,6902,2149.0,1350.0,834.0,6,2288,3008.0,1350.0,353.0
0.012,6,10,1983,5,910,3.0,642.0,642.0,5,1073,3.0,805.0,805.0
10.867,17,28,4420,14,1995,827.0,270.0,114.0,14,2425,827.0,588.0,145.0
0.069,17,8,3613,4,1874,23.0,1350.0,440.0,4,1739,12.0,1350.0,406.0
0.004,17,2,208,1,72,0.0,44.0,44.0,1,136,0.0,108.0,108.0
40.055,17,10,676,5,460,10012.0,104.0,64.0,5,216,9999.0,20.0,15.0
0.091,6,10,1506,5,395,21.0,127.0,127.0,5,1111,21.0,843.0,843.0
0.005,6,10,1854,5,889,1.0,621.0,621.0,5,965,1.0,697.0,697.0
0.081,6,10,1506,5,395,14.0,127.0,127.0,5,1111,19.0,843.0,843.0
0.005,6,14,3736,7,446,0.0,74.0,74.0,7,3290,0.0,1448.0,972.0
0.005,17,2,166,1,75,0.0,47.0,47.0,1,91,0.0,63.0,63.0
0.014,6,10,1989,5,910,3.0,642.0,642.0,5,1079,3.0,811.0,811.0
0.003,17,2,148,1,60,0.0,32.0,32.0,1,88,0.0,60.0,60.0
0.126,6,10,1506,5,395,27.0,127.0,127.0,5,1111,27.0,843.0,843.0
0.005,6,10,1774,5,923,1.0,655.0,655.0,5,851,1.0,583.0,583.0
0.005,6,10,1779,5,928,1.0,660.0,660.0,5,851,1.0,583.0,583.0
0.015,6,10,1990,5,911,3.0,643.0,643.0,5,1079,3.0,811.0,811.0
0.016,6,10,1762,5,911,3.0,643.0,643.0,5,851,4.0,583.0,583.0
0.093,6,10,1506,5,395,17.0,127.0,127.0,5,1111,22.0,843.0,843.0
0.082,6,10,1506,5,395,19.0,127.0,127.0,5,1111,19.0,843.0,843.0
0.016,6,10,1983,5,910,3.0,642.0,642.0,5,1073,3.0,805.0,805.0
0.004,6,10,2006,5,927,1.0,659.0,659.0,5,1079,1.0,811.0,811.0
0.04,17,4,420,2,122,0.0,33.0,33.0,2,298,37.0,145.0,121.0
0.004,6,10,2006,5,927,1.0,659.0,659.0,5,1079,1.0,811.0,811.0
0.004,17,4,284,2,120,0.0,32.0,32.0,2,164,0.0,60.0,54.0
0.014,6,10,1989,5,910,3.0,642.0,642.0,5,1079,3.0,811.0,811.0
361.857,6,19,1689,15,978,25846.0,190.0,190.0,4,711,80018.0,495.0,495.0
0.013,6,10,1989,5,910,3.0,642.0,642.0,5,1079,3.0,811.0,811.0
0.011,6,10,1989,5,910,2.0,642.0,642.0,5,1079,2.0,811.0,811.0
0.005,6,10,2007,5,928,1.0,660.0,660.0,5,1079,1.0,811.0,811.0
0.005,17,2,213,1,69,0.0,41.0,41.0,1,144,0.0,116.0,116.0
40.079,17,10,676,5,460,10018.0,104.0,64.0,5,216,10018.0,20.0,15.0
0.005,6,10,2006,5,927,1.0,659.0,659.0,5,1079,1.0,811.0,811.0
0.014,17,2,168,1,76,0.0,48.0,48.0,1,92,0.0,64.0,64.0
0.004,6,10,1989,5,927,1.0,659.0,659.0,5,1062,1.0,794.0,794.0
0.006,6,10,1547,5,764,1.0,496.0,496.0,5,783,1.0,515.0,515.0
0.005,6,10,2006,5,927,1.0,659.0,659.0,5,1079,1.0,811.0,811.0
0.004,6,10,1702,5,863,0.0,595.0,595.0,5,839,1.0,571.0,571.0
0.038,17,2,170,1,65,0.0,37.0,37.0,1,105,0.0,77.0,77.0
0.005,6,10,1689,5,839,1.0,571.0,571.0,5,850,1.0,582.0,582.0
0.011,6,10,1677,5,827,2.0,559.0,559.0,5,850,2.0,582.0,582.0
0.185,6,10,1506,5,395,45.0,127.0,127.0,5,1111,43.0,843.0,843.0
0.016,6,10,1989,5,910,4.0,642.0,642.0,5,1079,4.0,811.0,811.0
0.045,17,2,136,1,60,0.0,32.0,32.0,1,76,0.0,48.0,48.0
0.089,6,10,1506,5,395,19.0,127.0,127.0,5,1111,19.0,843.0,843.0
0.015,6,10,1972,5,910,3.0,642.0,642.0,5,1062,3.0,794.0,794.0
0.001,17,2,136,1,60,0.0,32.0,32.0,1,76,0.0,48.0,48.0
0.017,6,10,1983,5,910,4.0,642.0,642.0,5,1073,4.0,805.0,805.0
0.009,6,10,1989,5,910,2.0,642.0,642.0,5,1079,2.0,811.0,811.0
0.005,6,10,1689,5,839,1.0,571.0,571.0,5,850,1.0,582.0,582.0
0.011,6,10,1677,5,827,2.0,559.0,559.0,5,850,2.0,582.0,582.0
0.091,6,10,1506,5,395,20.0,127.0,127.0,5,1111,21.0,843.0,843.0
0.04,17,4,596,2,122,0.0,33.0,33.0,2,474,31.0,323.0,209.0
352.773,6,20,2210,6,1308,12005.0,494.0,494.0,14,902,27135.0,83.0,83.0
0.012,6,10,1990,5,911,2.0,643.0,643.0,5,1079,2.0,811.0,811.0
309.884,17,20,1124,10,716,34417.0,48.0,43.0,10,408,34417.0,20.0,12.0
0.01,6,10,1989,5,910,2.0,642.0,642.0,5,1079,2.0,811.0,811.0
10.994,17,28,4394,14,2313,836.0,588.0,137.0,14,2081,836.0,268.0,120.0
0.007,17,2,247,1,68,0.0,40.0,40.0,1,179,0.0,151.0,151.0
0.017,6,10,1990,5,911,4.0,643.0,643.0,5,1079,4.0,811.0,811.0
0.005,17,2,136,1,60,0.0,32.0,32.0,1,76,0.0,48.0,48.0
0.025,6,13,3816,7,578,4.0,206.0,206.0,6,3238,4.0,1470.0,1459.0
0.005,6,10,2007,5,928,1.0,660.0,660.0,5,1079,1.0,811.0,811.0
0.053,6,10,1506,5,395,12.0,127.0,127.0,5,1111,13.0,843.0,843.0
11.518,17,30,4619,15,2098,815.0,269.0,111.0,15,2521,814.0,588.0,140.0
0.001,17,2,180,1,65,0.0,37.0,37.0,1,115,0.0,87.0,87.0
40.052,17,10,676,5,460,10012.0,104.0,64.0,5,216,10012.0,20.0,15.0
0.004,17,4,284,2,120,0.0,32.0,32.0,2,164,0.0,60.0,54.0
0.068,6,10,1506,5,395,16.0,127.0,127.0,5,1111,14.0,843.0,843.0
240.139,6,31,9133,15,6819,17152.0,1943.0,671.0,16,2314,16009.0,580.0,184.0
0.004,17,4,284,2,120,1.0,32.0,32.0,2,164,0.0,60.0,54.0
0.005,6,10,1689,5,839,1.0,571.0,571.0,5,850,1.0,582.0,582.0
0.005,6,14,3736,7,446,0.0,74.0,74.0,7,3290,0.0,1448.0,972.0
0.005,17,2,170,1,65,0.0,37.0,37.0,1,105,0.0,77.0,77.0
0.005,6,10,1689,5,839,1.0,571.0,571.0,5,850,1.0,582.0,582.0
308.432,17,20,1124,10,716,34263.0,48.0,43.0,10,408,34263.0,20.0,12.0
40.076,17,10,676,5,460,10017.0,104.0,64.0,5,216,10015.0,20.0,15.0
0.005,6,10,1854,5,889,1.0,621.0,621.0,5,965,1.0,697.0,697.0
240.087,6,16,4482,9,963,30010.0,238.0,166.0,7,3519,40014.0,1402.0,786.0
0.005,6,10,2007,5,928,1.0,660.0,660.0,5,1079,1.0,811.0,811.0
11.175,17,28,4423,14,1994,847.0,269.0,114.0,14,2429,846.0,588.0,145.0
241.508,6,311,343104,118,17650,2064.0,2736.0,959.0,193,325454,1257.0,2804.0,1723.0
0.007,6,10,1989,5,910,1.0,642.0,642.0,5,1079,1.0,811.0,811.0
0.072,17,4,420,2,122,0.0,33.0,33.0,2,298,0.0,145.0,121.0
0.012,6,10,1989,5,910,3.0,642.0,642.0,5,1079,2.0,811.0,811.0
0.01,6,10,1989,5,910,2.0,642.0,642.0,5,1079,2.0,811.0,811.0
0.005,17,2,214,1,75,0.0,47.0,47.0,1,139,0.0,111.0,111.0
0.006,6,10,2006,5,927,1.0,659.0,659.0,5,1079,1.0,811.0,811.0
0.02,6,10,1989,5,910,5.0,642.0,642.0,5,1079,5.0,811.0,811.0
0.069,6,10,1506,5,395,14.0,127.0,127.0,5,1111,15.0,843.0,843.0
0.003,17,2,152,1,76,0.0,48.0,48.0,1,76,0.0,48.0,48.0
0.01,6,10,1972,5,910,2.0,642.0,642.0,5,1062,2.0,794.0,794.0
0.009,6,10,1990,5,911,2.0,643.0,643.0,5,1079,2.0,811.0,811.0
0.005,17,2,170,1,65,0.0,37.0,37.0,1,105,0.0,77.0,77.0
0.003,17,2,152,1,76,0.0,48.0,48.0,1,76,0.0,48.0,48.0
0.005,6,10,2006,5,927,1.0,659.0,659.0,5,1079,1.0,811.0,811.0
0.022,6,10,1989,5,910,5.0,642.0,642.0,5,1079,5.0,811.0,811.0
0.088,6,10,1506,5,395,20.0,127.0,127.0,5,1111,20.0,843.0,843.0
0.067,17,2,144,1,64,0.0,36.0,36.0,1,80,0.0,52.0,52.0
0.015,6,10,1983,5,910,3.0,642.0,642.0,5,1073,3.0,805.0,805.0
0.067,17,8,3613,4,1874,22.0,1350.0,440.0,4,1739,11.0,1350.0,406.0
0.012,6,10,1989,5,910,3.0,642.0,642.0,5,1079,3.0,811.0,811.0
0.012,6,10,1677,5,827,2.0,559.0,559.0,5,850,3.0,582.0,582.0
0.043,17,4,352,2,130,1.0,37.0,37.0,2,222,39.0,89.0,83.0
0.003,17,2,136,1,60,0.0,32.0,32.0,1,76,0.0,48.0,48.0
0.012,6,10,1972,5,910,3.0,642.0,642.0,5,1062,3.0,794.0,794.0
0.005,6,10,1989,5,927,1.0,659.0,659.0,5,1062,1.0,794.0,794.0
0.005,6,10,2006,5,927,1.0,659.0,659.0,5,1079,1.0,811.0,811.0
0.005,6,10,1643,5,860,1.0,592.0,592.0,5,783,1.0,515.0,515.0
0.103,6,10,1506,5,395,22.0,127.0,127.0,5,1111,23.0,843.0,843.0
0.001,17,2,180,1,66,0.0,38.0,38.0,1,114,0.0,86.0,86.0
0.005,17,2,169,1,62,0.0,34.0,34.0,1,107,0.0,79.0,79.0
0.009,6,13,3816,7,578,1.0,206.0,206.0,6,3238,1.0,1470.0,1459.0
0.004,6,10,2006,5,927,1.0,659.0,659.0,5,1079,1.0,811.0,811.0
0.005,6,10,2000,5,927,1.0,659.0,659.0,5,1073,1.0,805.0,805.0
0.012,6,10,1631,5,848,2.0,580.0,580.0,5,783,3.0,515.0,515.0
0.11,6,10,1506,5,395,23.0,127.0,127.0,5,1111,22.0,843.0,843.0
0.014,6,13,3735,7,497,2.0,125.0,125.0,6,3238,2.0,1470.0,1459.0
0.018,6,10,1983,5,910,4.0,642.0,642.0,5,1073,4.0,805.0,805.0
240.023,6,9,787,5,488,60005.0,232.0,232.0,4,299,80007.0,83.0,83.0
0.174,17,2,152,1,76,0.0,48.0,48.0,1,76,0.0,48.0,48.0
0.019,6,10,1983,5,910,4.0,642.0,642.0,5,1073,4.0,805.0,805.0
0.004,6,10,1989,5,927,1.0,659.0,659.0,5,1062,1.0,794.0,794.0
0.083,6,10,1506,5,395,18.0,127.0,127.0,5,1111,18.0,843.0,843.0
0.006,6,10,1689,5,839,1.0,571.0,571.0,5,850,1.0,582.0,582.0
0.009,6,10,2006,5,927,2.0,659.0,659.0,5,1079,2.0,811.0,811.0
0.014,6,10,1990,5,911,3.0,643.0,643.0,5,1079,3.0,811.0,811.0
0.094,6,10,1506,5,395,21.0,127.0,127.0,5,1111,22.0,843.0,843.0
0.018,6,10,1990,5,911,4.0,643.0,643.0,5,1079,4.0,811.0,811.0
0.008,6,10,1990,5,911,2.0,643.0,643.0,5,1079,1.0,811.0,811.0
0.005,6,10,1689,5,839,1.0,571.0,571.0,5,850,1.0,582.0,582.0
0.094,6,10,1506,5,395,18.0,127.0,127.0,5,1111,21.0,843.0,843.0
0.005,6,10,2007,5,928,1.0,660.0,660.0,5,1079,1.0,811.0,811.0
0.001,17,2,136,1,60,0.0,32.0,32.0,1,76,0.0,48.0,48.0
0.005,17,2,144,1,64,0.0,36.0,36.0,1,80,0.0,52.0,52.0
10.792,17,28,4421,14,1993,821.0,268.0,114.0,14,2428,821.0,587.0,145.0
0.067,17,8,3613,4,1874,22.0,1350.0,440.0,4,1739,11.0,1350.0,406.0
0.038,17,2,182,1,65,0.0,37.0,37.0,1,117,0.0,89.0,89.0
0.004,17,4,284,2,120,0.0,32.0,32.0,2,164,1.0,60.0,54.0
0.008,6,10,1989,5,910,2.0,642.0,642.0,5,1079,2.0,811.0,811.0
0.015,6,10,1677,5,827,3.0,559.0,559.0,5,850,3.0,582.0,582.0
0.005,6,10,2006,5,927,1.0,659.0,659.0,5,1079,1.0,811.0,811.0
0.009,6,10,1972,5,910,2.0,642.0,642.0,5,1062,2.0,794.0,794.0
40.073,17,10,676,5,460,10015.0,104.0,64.0,5,216,10017.0,20.0,15.0
0.009,6,10,1983,5,910,2.0,642.0,642.0,5,1073,2.0,805.0,805.0
152.274,6,26,9525,12,1627,83.0,794.0,367.0,14,7898,11704.0,1360.0,732.0
0.004,17,2,136,1,60,0.0,32.0,32.0,1,76,0.0,48.0,48.0
0.017,6,10,1989,5,910,4.0,642.0,642.0,5,1079,4.0,811.0,811.0
0.004,6,10,2006,5,927,1.0,659.0,659.0,5,1079,1.0,811.0,811.0
1786.319,6,154,19574,92,13852,19629.0,302.0,302.0,62,5722,29283.0,83.0,83.0
0.001,17,2,136,1,60,0.0,32.0,32.0,1,76,0.0,48.0,48.0
0.033,6,13,3816,7,578,5.0,206.0,206.0,6,3238,6.0,1470.0,1459.0
0.004,17,2,136,1,60,0.0,32.0,32.0,1,76,0.0,48.0,48.0
289.299,6,359,355751,197,21908,1476.0,2736.0,889.0,162,333843,1796.0,4206.0,2198.0
0.011,6,10,1990,5,911,2.0,643.0,643.0,5,1079,2.0,811.0,811.0
0.004,6,10,1702,5,863,1.0,595.0,595.0,5,839,1.0,571.0,571.0
0.004,17,2,148,1,60,0.0,32.0,32.0,1,88,0.0,60.0,60.0
0.087,6,10,1506,5,395,18.0,127.0,127.0,5,1111,18.0,843.0,843.0
0.012,6,10,1972,5,910,2.0,642.0,642.0,5,1062,3.0,794.0,794.0
0.012,6,10,1983,5,910,3.0,642.0,642.0,5,1073,3.0,805.0,805.0
40.057,17,10,676,5,460,10013.0,104.0,64.0,5,216,10012.0,20.0,15.0
0.005,17,2,164,1,74,0.0,46.0,46.0,1,90,0.0,62.0,62.0
0.004,17,4,284,2,120,1.0,32.0,32.0,2,164,0.0,60.0,54.0
0.009,6,10,1631,5,848,2.0,580.0,580.0,5,783,2.0,515.0,515.0
0.001,17,2,180,1,65,0.0,37.0,37.0,1,115,0.0,87.0,87.0
0.004,6,10,1702,5,863,1.0,595.0,595.0,5,839,1.0,571.0,571.0
0.012,6,10,1677,5,827,3.0,559.0,559.0,5,850,3.0,582.0,582.0
0.168,6,3,453,2,321,168.0,241.0,241.0,1,132,0.0,92.0,92.0
0.005,6,10,1774,5,923,1.0,655.0,655.0,5,851,1.0,583.0,583.0
0.005,6,10,2007,5,928,1.0,660.0,660.0,5,1079,1.0,811.0,811.0
0.143,6,10,1506,5,395,25.0,127.0,127.0,5,1111,29.0,843.0,843.0
0.041,17,4,364,2,160,0.0,52.0,52.0,2,204,3.0,80.0,74.0
240.09,6,16,4481,9,963,30011.0,238.0,166.0,7,3518,40014.0,1402.0,786.0
0.004,6,10,2006,5,927,1.0,659.0,659.0,5,1079,1.0,811.0,811.0
0.001,17,2,180,1,66,0.0,38.0,38.0,1,114,0.0,86.0,86.0
0.125,6,10,1506,5,395,30.0,127.0,127.0,5,1111,27.0,843.0,843.0
0.006,6,10,2000,5,927,1.0,659.0,659.0,5,1073,1.0,805.0,805.0
0.071,6,10,1506,5,395,15.0,127.0,127.0,5,1111,16.0,843.0,843.0
0.013,6,10,1983,5,910,3.0,642.0,642.0,5,1073,3.0,805.0,805.0
0.006,6,10,1547,5,764,1.0,496.0,496.0,5,783,1.0,515.0,515.0
0.005,6,10,2000,5,927,1.0,659.0,659.0,5,1073,1.0,805.0,805.0
0.006,6,10,1547,5,764,1.0,496.0,496.0,5,783,1.0,515.0,515.0
0.018,6,10,1989,5,910,4.0,642.0,642.0,5,1079,4.0,811.0,811.0
10.824,17,26,4098,13,1821,893.0,268.0,112.0,13,2277,893.0,588.0,147.0
0.003,17,4,284,2,120,0.0,32.0,32.0,2,164,0.0,60.0,54.0
0.116,6,10,1506,5,395,25.0,127.0,127.0,5,1111,26.0,843.0,843.0
0.001,17,2,180,1,66,0.0,38.0,38.0,1,114,0.0,86.0,86.0
0.015,6,10,1989,5,910,3.0,642.0,642.0,5,1079,3.0,811.0,811.0
0.132,17,2,136,1,60,0.0,32.0,32.0,1,76,0.0,48.0,48.0
0.104,6,10,1506,5,395,24.0,127.0,127.0,5,1111,22.0,843.0,843.0
0.004,6,10,2006,5,927,1.0,659.0,659.0,5,1079,1.0,811.0,811.0
0.003,17,2,148,1,60,0.0,32.0,32.0,1,88,0.0,60.0,60.0
308.382,17,20,1124,10,716,34250.0,48.0,43.0,10,408,34250.0,20.0,12.0
0.005,6,10,1689,5,839,1.0,571.0,571.0,5,850,1.0,582.0,582.0
0.098,6,10,1506,5,395,22.0,127.0,127.0,5,1111,21.0,843.0,843.0
0.004,6,10,1989,5,927,1.0,659.0,659.0,5,1062,1.0,794.0,794.0
0.022,6,10,1989,5,910,5.0,642.0,642.0,5,1079,5.0,811.0,811.0
0.004,17,2,148,1,60,0.0,32.0,32.0,1,88,0.0,60.0,60.0
0.014,6,10,1990,5,911,3.0,643.0,643.0,5,1079,3.0,811.0,811.0
0.004,6,10,1989,5,927,1.0,659.0,659.0,5,1062,1.0,794.0,794.0
0.006,17,2,169,1,62,0.0,34.0,34.0,1,107,0.0,79.0,79.0
0.005,6,10,1989,5,927,1.0,659.0,659.0,5,1062,1.0,794.0,794.0
0.008,6,10,1989,5,910,2.0,642.0,642.0,5,1079,2.0,811.0,811.0
0.098,6,10,1506,5,395,19.0,127.0,127.0,5,1111,21.0,843.0,843.0
0.004,17,2,136,1,60,0.0,32.0,32.0,1,76,0.0,48.0,48.0
1.081,6,32,13391,18,5892,63.0,2720.0,854.0,14,7499,69.0,2720.0,769.0
0.004,6,10,2006,5,927,1.0,659.0,659.0,5,1079,1.0,811.0,811.0
0.003,17,2,136,1,60,0.0,32.0,32.0,1,76,0.0,48.0,48.0
0.009,6,10,1677,5,827,2.0,559.0,559.0,5,850,2.0,582.0,582.0
0.006,6,10,1547,5,764,1.0,496.0,496.0,5,783,1.0,515.0,515.0
0.127,17,2,412,1,61,0.0,33.0,33.0,1,351,0.0,323.0,323.0
0.086,6,10,1506,5,395,19.0,127.0,127.0,5,1111,17.0,843.0,843.0
300.132,6,38,10085,20,4567,15787.0,2077.0,744.0,18,5518,17644.0,2667.0,435.0
0.046,17,2,166,1,75,0.0,47.0,47.0,1,91,0.0,63.0,63.0
40.065,17,10,676,5,460,10015.0,104.0,64.0,5,216,10015.0,20.0,15.0
0.009,6,10,1989,5,910,2.0,642.0,642.0,5,1079,2.0,811.0,811.0
10.798,17,28,4423,14,1994,822.0,269.0,114.0,14,2429,822.0,588.0,145.0
0.001,17,2,178,1,81,0.0,53.0,53.0,1,97,0.0,69.0,69.0
0.007,6,10,2006,5,927,1.0,659.0,659.0,5,1079,1.0,811.0,811.0
0.005,6,10,1643,5,860,1.0,592.0,592.0,5,783,1.0,515.0,515.0
0.049,6,10,1989,5,910,12.0,642.0,642.0,5,1079,12.0,811.0,811.0
0.06,6,10,1506,5,395,13.0,127.0,127.0,5,1111,13.0,843.0,843.0
0.065,6,10,1506,5,395,15.0,127.0,127.0,5,1111,13.0,843.0,843.0
0.005,17,2,144,1,64,0.0,36.0,36.0,1,80,0.0,52.0,52.0
0.006,17,2,170,1,65,0.0,37.0,37.0,1,105,0.0,77.0,77.0
0.006,6,10,1547,5,764,1.0,496.0,496.0,5,783,1.0,515.0,515.0
0.005,6,13,3747,7,509,0.0,137.0,137.0,6,3238,1.0,1470.0,1459.0
0.074,6,10,1506,5,395,17.0,127.0,127.0,5,1111,16.0,843.0,843.0
0.088,6,10,1506,5,395,16.0,127.0,127.0,5,1111,20.0,843.0,843.0
0.132,17,4,284,2,120,0.0,32.0,32.0,2,164,128.0,60.0,54.0
0.005,17,2,166,1,75,0.0,47.0,47.0,1,91,0.0,63.0,63.0
0.002,17,2,136,1,60,0.0,32.0,32.0,1,76,0.0,48.0,48.0
0.009,6,10,1972,5,910,2.0,642.0,642.0,5,1062,2.0,794.0,794.0
1777.706,17,141,44556,72,22752,25036.0,288.0,288.0,69,21804,26141.0,288.0,288.0
300.419,6,27,7433,16,1409,20027.0,217.0,142.0,11,6024,24037.0,1679.0,777.0
0.136,6,10,1506,5,395,33.0,127.0,127.0,5,1111,18.0,843.0,843.0
40.053,17,10,676,5,460,10011.0,104.0,64.0,5,216,10012.0,20.0,15.0
0.012,6,10,1983,5,910,3.0,642.0,642.0,5,1073,2.0,805.0,805.0
0.061,6,10,1506,5,395,13.0,127.0,127.0,5,1111,14.0,843.0,843.0
0.005,6,10,2006,5,927,1.0,659.0,659.0,5,1079,1.0,811.0,811.0
0.004,6,10,1989,5,927,1.0,659.0,659.0,5,1062,1.0,794.0,794.0
0.006,17,2,144,1,64,0.0,36.0,36.0,1,80,0.0,52.0,52.0
15.073,17,15,9238,8,6902,2149.0,1350.0,834.0,7,2336,2507.0,1350.0,305.0
176.156,17,76,10826,38,2536,4760.0,44.0,38.0,38,8290,4760.0,261.0,190.0
0.005,6,13,3747,7,509,0.0,137.0,137.0,6,3238,1.0,1470.0,1459.0
314.255,17,20,1124,10,716,34903.0,48.0,43.0,10,408,34902.0,20.0,12.0
0.076,6,10,1506,5,395,17.0,127.0,127.0,5,1111,17.0,843.0,843.0
1778.618,17,143,45188,72,22752,25050.0,288.0,288.0,71,22436,25408.0,288.0,288.0
0.013,6,10,1983,5,910,3.0,642.0,642.0,5,1073,3.0,805.0,805.0
0.0,17,2,136,1,60,0.0,32.0,32.0,1,76,0.0,48.0,48.0
0.007,17,2,162,1,65,0.0,37.0,37.0,1,97,0.0,69.0,69.0
0.005,6,10,2006,5,927,1.0,659.0,659.0,5,1079,1.0,811.0,811.0
0.079,6,10,1506,5,395,18.0,127.0,127.0,5,1111,16.0,843.0,843.0
0.005,6,10,1643,5,860,1.0,592.0,592.0,5,783,1.0,515.0,515.0
0.012,6,10,1983,5,910,3.0,642.0,642.0,5,1073,3.0,805.0,805.0
176.319,17,84,11772,42,2806,4300.0,44.0,38.0,42,8966,4300.0,239.0,185.0
0.008,6,10,1677,5,827,2.0,559.0,559.0,5,850,2.0,582.0,582.0
0.016,6,10,1989,5,910,4.0,642.0,642.0,5,1079,3.0,811.0,811.0
0.059,17,2,80,1,32,0.0,4.0,4.0,1,48,0.0,20.0,20.0
300.307,6,16,2170,9,684,37517.0,146.0,146.0,7,1486,50023.0,419.0,398.0
0.017,6,10,1990,5,911,4.0,643.0,643.0,5,1079,4.0,811.0,811.0
0.006,17,2,225,1,65,0.0,37.0,37.0,1,160,0.0,132.0,132.0
0.013,6,13,3735,7,497,2.0,125.0,125.0,6,3238,2.0,1470.0,1459.0
240.155,6,46,6773,22,3222,11435.0,588.0,230.0,24,3551,10441.0,580.0,208.0
175.29,17,84,11582,42,2799,4275.0,44.0,38.0,42,8783,4275.0,239.0,181.0
0.006,6,10,1854,5,889,1.0,621.0,621.0,5,965,1.0,697.0,697.0
0.039,17,4,352,2,130,0.0,37.0,37.0,2,222,2.0,89.0,83.0
0.005,6,10,2007,5,928,1.0,660.0,660.0,5,1079,1.0,811.0,811.0
0.006,17,2,169,1,62,0.0,34.0,34.0,1,107,0.0,79.0,79.0
0.001,17,2,180,1,66,0.0,38.0,38.0,1,114,0.0,86.0,86.0
0.005,6,10,2006,5,927,1.0,659.0,659.0,5,1079,1.0,811.0,811.0
0.004,17,4,284,2,120,0.0,32.0,32.0,2,164,0.0,60.0,54.0
0.009,6,10,1972,5,910,2.0,642.0,642.0,5,1062,2.0,794.0,794.0
308.544,17,20,1124,10,716,34268.0,48.0,43.0,10,408,34268.0,20.0,12.0
0.006,6,10,1547,5,764,1.0,496.0,496.0,5,783,1.0,515.0,515.0
0.001,17,2,180,1,66,0.0,38.0,38.0,1,114,0.0,86.0,86.0
0.005,6,10,2006,5,927,1.0,659.0,659.0,5,1079,1.0,811.0,811.0
0.093,6,10,1506,5,395,20.0,127.0,127.0,5,1111,20.0,843.0,843.0
40.066,17,10,676,5,460,10015.0,104.0,64.0,5,216,10015.0,20.0,15.0
0.088,6,10,1506,5,395,21.0,127.0,127.0,5,1111,20.0,843.0,843.0
0.003,17,2,148,1,60,0.0,32.0,32.0,1,88,0.0,60.0,60.0
0.014,6,13,3735,7,497,2.0,125.0,125.0,6,3238,2.0,1470.0,1459.0
0.015,6,10,1989,5,910,3.0,642.0,642.0,5,1079,3.0,811.0,811.0
0.137,17,4,284,2,120,1.0,32.0,32.0,2,164,118.0,60.0,54.0
0.119,6,10,1506,5,395,26.0,127.0,127.0,5,1111,21.0,843.0,843.0
0.003,17,2,136,1,60,0.0,32.0,32.0,1,76,0.0,48.0,48.0
0.073,17,2,186,1,61,0.0,33.0,33.0,1,125,0.0,97.0,97.0
0.005,6,10,2006,5,927,1.0,659.0,659.0,5,1079,1.0,811.0,811.0
0.015,6,10,1990,5,911,3.0,643.0,643.0,5,1079,3.0,811.0,811.0
0.005,6,10,2000,5,927,1.0,659.0,659.0,5,1073,1.0,805.0,805.0
0.098,6,10,1506,5,395,20.0,127.0,127.0,5,1111,22.0,843.0,843.0
0.038,17,2,152,1,76,0.0,48.0,48.0,1,76,0.0,48.0,48.0
0.016,6,10,1990,5,911,4.0,643.0,643.0,5,1079,4.0,811.0,811.0
0.017,6,10,1990,5,911,4.0,643.0,643.0,5,1079,4.0,811.0,811.0
0.015,6,10,1989,5,910,3.0,642.0,642.0,5,1079,3.0,811.0,811.0
0.001,17,2,166,1,75,0.0,47.0,47.0,1,91,0.0,63.0,63.0
0.001,17,2,180,1,66,0.0,38.0,38.0,1,114,0.0,86.0,86.0
0.005,6,14,3736,7,446,0.0,74.0,74.0,7,3290,0.0,1448.0,972.0
0.005,17,2,170,1,65,0.0,37.0,37.0,1,105,0.0,77.0,77.0
0.005,6,10,2006,5,927,1.0,659.0,659.0,5,1079,1.0,811.0,811.0
0.005,6,10,1989,5,927,1.0,659.0,659.0,5,1062,1.0,794.0,794.0
0.019,6,10,1972,5,910,4.0,642.0,642.0,5,1062,4.0,794.0,794.0
0.004,6,10,2007,5,928,1.0,660.0,660.0,5,1079,1.0,811.0,811.0
240.094,6,16,4481,9,963,30011.0,238.0,166.0,7,3518,40015.0,1402.0,786.0
0.01,6,10,1989,5,910,2.0,642.0,642.0,5,1079,2.0,811.0,811.0
0.011,6,10,1990,5,911,2.0,643.0,643.0,5,1079,2.0,811.0,811.0
0.003,17,2,148,1,60,0.0,32.0,32.0,1,88,0.0,60.0,60.0
0.004,6,10,2007,5,928,1.0,660.0,660.0,5,1079,1.0,811.0,811.0
0.001,17,2,136,1,60,0.0,32.0,32.0,1,76,0.0,48.0,48.0
66.305,6,28,17642,15,9638,4736.0,2804.0,1475.0,13,8004,5511.0,2323.0,1045.0
0.009,6,10,1677,5,827,2.0,559.0,559.0,5,850,2.0,582.0,582.0
0.005,6,10,1989,5,927,1.0,659.0,659.0,5,1062,1.0,794.0,794.0
0.086,6,10,1506,5,395,17.0,127.0,127.0,5,1111,16.0,843.0,843.0
0.002,17,2,185,1,73,0.0,45.0,45.0,1,112,0.0,84.0,84.0
0.016,6,10,1989,5,910,3.0,642.0,642.0,5,1079,4.0,811.0,811.0
300.022,6,12,1782,7,1348,50003.0,494.0,494.0,5,434,75004.0,83.0,83.0
0.093,6,10,1506,5,395,21.0,127.0,127.0,5,1111,21.0,843.0,843.0
0.105,6,10,1506,5,395,25.0,127.0,127.0,5,1111,25.0,843.0,843.0
0.785,6,10,937,6,427,157.0,107.0,107.0,4,510,175.0,294.0,294.0
0.005,6,10,1779,5,928,1.0,660.0,660.0,5,851,1.0,583.0,583.0
0.021,6,10,1989,5,910,5.0,642.0,642.0,5,1079,5.0,811.0,811.0
0.011,6,10,1989,5,910,2.0,642.0,642.0,5,1079,2.0,811.0,811.0
300.342,6,16,2170,9,684,37521.0,146.0,146.0,7,1486,50028.0,419.0,398.0
0.009,6,10,1972,5,910,2.0,642.0,642.0,5,1062,2.0,794.0,794.0
242.399,6,391,347521,190,21414,1282.0,2736.0,960.0,201,326107,1211.0,2804.0,1652.0
0.069,6,10,1506,5,395,16.0,127.0,127.0,5,1111,15.0,843.0,843.0
0.004,17,2,144,1,64,0.0,36.0,36.0,1,80,0.0,52.0,52.0
0.004,17,2,148,1,60,0.0,32.0,32.0,1,88,0.0,60.0,60.0
0.004,6,10,1702,5,863,1.0,595.0,595.0,5,839,1.0,571.0,571.0
309.53,17,20,1124,10,716,34378.0,48.0,43.0,10,408,34378.0,20.0,12.0
0.005,6,10,2007,5,928,1.0,660.0,660.0,5,1079,1.0,811.0,811.0
0.071,17,2,148,1,60,0.0,32.0,32.0,1,88,0.0,60.0,60.0
0.093,6,10,1506,5,395,19.0,127.0,127.0,5,1111,22.0,843.0,843.0
0.106,6,10,1506,5,395,16.0,127.0,127.0,5,1111,24.0,843.0,843.0
0.006,6,10,1854,5,889,1.0,621.0,621.0,5,965,1.0,697.0,697.0
0.073,6,10,1506,5,395,17.0,127.0,127.0,5,1111,13.0,843.0,843.0
313.154,17,20,1124,10,716,34781.0,48.0,43.0,10,408,34781.0,20.0,12.0
0.011,6,10,1990,5,911,2.0,643.0,643.0,5,1079,2.0,811.0,811.0
0.087,6,10,1506,5,395,21.0,127.0,127.0,5,1111,19.0,843.0,843.0
0.099,6,10,1506,5,395,22.0,127.0,127.0,5,1111,21.0,843.0,843.0
0.005,6,10,1547,5,764,1.0,496.0,496.0,5,783,1.0,515.0,515.0
0.004,6,10,2006,5,927,1.0,659.0,659.0,5,1079,1.0,811.0,811.0
0.004,6,10,1702,5,863,0.0,595.0,595.0,5,839,1.0,571.0,571.0
0.025,6,10,1972,5,910,6.0,642.0,642.0,5,1062,6.0,794.0,794.0
0.006,6,10,1689,5,839,1.0,571.0,571.0,5,850,1.0,582.0,582.0
0.004,17,2,162,1,65,0.0,37.0,37.0,1,97,0.0,69.0,69.0
0.009,6,12,1926,6,1189,1.0,659.0,434.0,6,737,1.0,417.0,417.0
292.125,6,413,348848,205,22200,1431.0,2736.0,888.0,208,326648,1411.0,2804.0,1627.0
0.003,17,4,284,2,120,0.0,32.0,32.0,2,164,0.0,60.0,54.0
240.285,6,41,9803,20,3381,12644.0,880.0,333.0,21,6422,12012.0,1507.0,591.0
0.005,6,10,2007,5,928,1.0,660.0,660.0,5,1079,1.0,811.0,811.0
15.072,17,15,9238,8,6902,2149.0,1350.0,834.0,7,2336,2507.0,1350.0,305.0
0.005,17,2,170,1,65,0.0,37.0,37.0,1,105,0.0,77.0,77.0
0.012,6,10,1990,5,911,3.0,643.0,643.0,5,1079,3.0,811.0,811.0
0.005,6,10,1689,5,839,1.0,571.0,571.0,5,850,1.0,582.0,582.0
0.006,6,10,1547,5,764,1.0,496.0,496.0,5,783,1.0,515.0,515.0
40.056,17,10,676,5,460,10013.0,104.0,64.0,5,216,10013.0,20.0,15.0
0.005,17,2,164,1,74,0.0,46.0,46.0,1,90,0.0,62.0,62.0
0.085,6,10,1506,5,395,15.0,127.0,127.0,5,1111,19.0,843.0,843.0
0.004,6,10,1779,5,928,1.0,660.0,660.0,5,851,1.0,583.0,583.0
0.007,6,10,1972,5,910,1.0,642.0,642.0,5,1062,1.0,794.0,794.0
366.981,6,22,2313,16,867,24465.0,195.0,195.0,6,1446,4634.0,419.0,398.0
0.085,6,10,1506,5,395,20.0,127.0,127.0,5,1111,19.0,843.0,843.0
552.474,6,39,13806,21,3413,27623.0,661.0,385.0,18,10393,28965.0,1402.0,859.0
0.075,6,10,1506,5,395,15.0,127.0,127.0,5,1111,16.0,843.0,843.0
0.011,6,10,1990,5,911,2.0,643.0,643.0,5,1079,2.0,811.0,811.0
0.005,17,2,179,1,71,0.0,43.0,43.0,1,108,0.0,80.0,80.0
37.794,6,38,9663,19,4060,491.0,2903.0,1085.0,19,5603,2090.0,2667.0,402.0
0.091,6,10,1506,5,395,20.0,127.0,127.0,5,1111,19.0,843.0,843.0
0.013,6,10,1677,5,827,3.0,559.0,559.0,5,850,3.0,582.0,582.0
0.017,6,10,1972,5,910,4.0,642.0,642.0,5,1062,4.0,794.0,794.0
0.003,17,2,136,1,60,0.0,32.0,32.0,1,76,0.0,48.0,48.0
240.258,6,36,10553,18,2211,14132.0,555.0,253.0,18,8342,14132.0,1402.0,617.0
0.006,6,10,1689,5,839,1.0,571.0,571.0,5,850,1.0,582.0,582.0
0.048,17,2,144,1,64,0.0,36.0,36.0,1,80,0.0,52.0,52.0
0.006,17,2,179,1,71,0.0,43.0,43.0,1,108,0.0,80.0,80.0
0.087,6,10,1506,5,395,20.0,127.0,127.0,5,1111,18.0,843.0,843.0
0.015,6,10,1972,5,910,3.0,642.0,642.0,5,1062,3.0,794.0,794.0
308.478,17,20,1124,10,716,34261.0,48.0,43.0,10,408,34261.0,20.0,12.0
0.009,6,12,1926,6,1189,1.0,659.0,434.0,6,737,1.0,417.0,417.0
0.03,6,10,1972,5,910,7.0,642.0,642.0,5,1062,7.0,794.0,794.0
10.957,17,28,4419,14,1995,834.0,270.0,114.0,14,2424,833.0,587.0,145.0
0.005,17,2,180,1,58,0.0,30.0,30.0,1,122,0.0,94.0,94.0
0.015,6,10,1989,5,910,3.0,642.0,642.0,5,1079,3.0,811.0,811.0
0.075,6,10,1506,5,395,15.0,127.0,127.0,5,1111,17.0,843.0,843.0
0.005,6,10,1989,5,927,1.0,659.0,659.0,5,1062,1.0,794.0,794.0
0.004,6,10,1989,5,927,1.0,659.0,659.0,5,1062,1.0,794.0,794.0
0.006,6,10,1689,5,839,1.0,571.0,571.0,5,850,1.0,582.0,582.0
0.005,6,14,3742,8,504,0.0,80.0,80.0,6,3238,1.0,1470.0,1459.0
40.091,17,10,676,5,460,10016.0,104.0,64.0,5,216,10021.0,20.0,15.0
0.003,17,4,284,2,120,0.0,32.0,32.0,2,164,0.0,60.0,54.0
0.005,6,10,1989,5,927,1.0,659.0,659.0,5,1062,1.0,794.0,794.0
15.075,17,15,9238,8,6902,2149.0,1350.0,834.0,7,2336,2507.0,1350.0,305.0
40.065,17,10,676,5,460,10015.0,104.0,64.0,5,216,10015.0,20.0,15.0
0.08,6,10,1506,5,395,15.0,127.0,127.0,5,1111,18.0,843.0,843.0
0.091,6,10,1506,5,395,19.0,127.0,127.0,5,1111,21.0,843.0,843.0
315.293,17,20,1124,10,716,35019.0,48.0,43.0,10,408,35018.0,20.0,12.0
0.005,17,2,214,1,75,0.0,47.0,47.0,1,139,0.0,111.0,111.0
0.006,6,10,1547,5,764,1.0,496.0,496.0,5,783,1.0,515.0,515.0
0.009,6,10,1989,5,910,2.0,642.0,642.0,5,1079,2.0,811.0,811.0
0.007,6,10,1547,5,764,1.0,496.0,496.0,5,783,1.0,515.0,515.0
0.001,17,2,180,1,66,0.0,38.0,38.0,1,114,0.0,86.0,86.0
300.315,6,16,2170,9,684,37518.0,146.0,146.0,7,1486,50024.0,419.0,398.0
0.007,6,10,1989,5,927,1.0,659.0,659.0,5,1062,1.0,794.0,794.0
0.062,6,10,1506,5,395,14.0,127.0,127.0,5,1111,13.0,843.0,843.0
0.061,6,10,1506,5,395,13.0,127.0,127.0,5,1111,14.0,843.0,843.0
0.006,6,10,1854,5,889,1.0,621.0,621.0,5,965,1.0,697.0,697.0
0.024,6,10,1990,5,911,5.0,643.0,643.0,5,1079,6.0,811.0,811.0
0.013,6,10,1989,5,910,3.0,642.0,642.0,5,1079,3.0,811.0,811.0
300.323,6,28,7485,16,1409,20021.0,217.0,142.0,12,6076,21844.0,1402.0,680.0
0.021,6,10,1989,5,910,5.0,642.0,642.0,5,1079,5.0,811.0,811.0
0.005,6,10,1989,5,927,1.0,659.0,659.0,5,1062,1.0,794.0,794.0
0.004,17,4,284,2,120,0.0,32.0,32.0,2,164,0.0,60.0,54.0
0.079,6,10,1506,5,395,17.0,127.0,127.0,5,1111,19.0,843.0,843.0
40.084,17,10,676,5,460,10020.0,104.0,64.0,5,216,10019.0,20.0,15.0
0.008,6,10,1677,5,827,2.0,559.0,559.0,5,850,1.0,582.0,582.0
0.01,6,10,1989,5,910,2.0,642.0,642.0,5,1079,2.0,811.0,811.0
0.092,6,10,1506,5,395,19.0,127.0,127.0,5,1111,19.0,843.0,843.0
308.825,17,20,1124,10,716,34299.0,48.0,43.0,10,408,34299.0,20.0,12.0
0.006,17,2,179,1,71,0.0,43.0,43.0,1,108,0.0,80.0,80.0
240.07,6,21,4924,11,941,24007.0,180.0,93.0,10,3983,26674.0,1591.0,575.0
0.01,6,10,1677,5,827,2.0,559.0,559.0,5,850,2.0,582.0,582.0
0.006,6,10,1547,5,764,1.0,496.0,496.0,5,783,1.0,515.0,515.0
0.067,6,10,1506,5,395,14.0,127.0,127.0,5,1111,14.0,843.0,843.0
0.006,17,2,170,1,65,0.0,37.0,37.0,1,105,0.0,77.0,77.0
0.005,6,10,1779,5,928,1.0,660.0,660.0,5,851,1.0,583.0,583.0
0.006,17,2,194,1,59,0.0,31.0,31.0,1,135,0.0,107.0,107.0
40.081,17,10,676,5,460,10019.0,104.0,64.0,5,216,10019.0,20.0,15.0
0.031,6,10,1989,5,910,7.0,642.0,642.0,5,1079,7.0,811.0,811.0
5.076,6,21,5923,12,1436,461.0,474.0,201.0,9,4487,634.0,1925.0,804.0
0.033,6,10,1605,5,388,8.0,120.0,120.0,5,1217,8.0,949.0,949.0
0.124,6,10,1506,5,395,28.0,127.0,127.0,5,1111,25.0,843.0,843.0
0.004,6,10,2006,5,927,1.0,659.0,659.0,5,1079,1.0,811.0,811.0
0.014,6,10,1762,5,911,3.0,643.0,643.0,5,851,3.0,583.0,583.0
0.005,6,10,1547,5,764,1.0,496.0,496.0,5,783,1.0,515.0,515.0
0.005,6,10,1989,5,927,1.0,659.0,659.0,5,1062,1.0,794.0,794.0
0.005,6,10,2006,5,927,1.0,659.0,659.0,5,1079,1.0,811.0,811.0
0.013,6,13,3735,7,497,2.0,125.0,125.0,6,3238,2.0,1470.0,1459.0
0.094,6,10,1506,5,395,19.0,127.0,127.0,5,1111,18.0,843.0,843.0
0.014,6,10,1989,5,910,3.0,642.0,642.0,5,1079,3.0,811.0,811.0
0.009,6,10,1989,5,910,2.0,642.0,642.0,5,1079,2.0,811.0,811.0
0.001,17,2,136,1,60,0.0,32.0,32.0,1,76,0.0,48.0,48.0
0.017,6,10,1983,5,910,4.0,642.0,642.0,5,1073,4.0,805.0,805.0
0.013,6,10,1989,5,910,3.0,642.0,642.0,5,1079,3.0,811.0,811.0
0.004,6,10,1702,5,863,1.0,595.0,595.0,5,839,1.0,571.0,571.0
0.064,6,10,1506,5,395,14.0,127.0,127.0,5,1111,12.0,843.0,843.0
0.07,6,10,1506,5,395,16.0,127.0,127.0,5,1111,15.0,843.0,843.0
0.004,17,2,179,1,71,0.0,43.0,43.0,1,108,0.0,80.0,80.0
0.005,17,2,136,1,60,0.0,32.0,32.0,1,76,0.0,48.0,48.0
0.081,6,10,1506,5,395,19.0,127.0,127.0,5,1111,17.0,843.0,843.0
0.007,6,13,3747,7,509,1.0,137.0,137.0,6,3238,1.0,1470.0,1459.0
0.006,6,10,1689,5,839,1.0,571.0,571.0,5,850,1.0,582.0,582.0
0.129,6,10,1506,5,395,30.0,127.0,127.0,5,1111,28.0,843.0,843.0
1.151,6,33,13431,18,5892,67.0,2073.0,854.0,15,7539,70.0,2720.0,769.0
0.085,6,10,1506,5,395,19.0,127.0,127.0,5,1111,19.0,843.0,843.0
0.005,6,10,2006,5,927,1.0,659.0,659.0,5,1079,1.0,811.0,811.0
0.078,6,10,1506,5,395,16.0,127.0,127.0,5,1111,18.0,843.0,843.0
291.043,6,407,348885,202,22075,1447.0,2736.0,889.0,205,326810,1426.0,2804.0,1655.0
0.001,17,2,180,1,65,0.0,37.0,37.0,1,115,0.0,87.0,87.0
0.076,6,10,1506,5,395,17.0,127.0,127.0,5,1111,15.0,843.0,843.0
0.737,6,25,5459,12,1557,60.0,325.0,152.0,13,3902,52.0,1414.0,563.0
0.004,6,10,1989,5,927,1.0,659.0,659.0,5,1062,1.0,794.0,794.0
0.001,17,2,136,1,60,0.0,32.0,32.0,1,76,0.0,48.0,48.0
0.039,17,2,136,1,60,0.0,32.0,32.0,1,76,0.0,48.0,48.0
0.01,6,10,1989,5,910,2.0,642.0,642.0,5,1079,2.0,811.0,811.0
0.004,6,10,2007,5,928,1.0,660.0,660.0,5,1079,1.0,811.0,811.0
177.171,17,88,12403,44,2935,4120.0,44.0,38.0,44,9468,4120.0,260.0,187.0
0.009,6,13,3747,7,509,1.0,137.0,137.0,6,3238,1.0,1470.0,1459.0
0.0,17,2,136,1,60,0.0,32.0,32.0,1,76,0.0,48.0,48.0
0.008,6,10,1972,5,910,2.0,642.0,642.0,5,1062,2.0,794.0,794.0
300.338,6,16,2170,9,684,37521.0,146.0,146.0,7,1486,50028.0,419.0,398.0
40.09,17,10,676,5,460,10019.0,104.0,64.0,5,216,10021.0,20.0,15.0
1756.31,6,107,6374,60,3525,29767.0,27.0,27.0,47,2849,38179.0,27.0,27.0
0.005,6,10,1989,5,927,1.0,659.0,659.0,5,1062,1.0,794.0,794.0
66.067,6,24,7182,13,1458,5505.0,464.0,258.0,11,5724,6585.0,1288.0,643.0
0.117,6,10,1506,5,395,25.0,127.0,127.0,5,1111,27.0,843.0,843.0
40.068,17,10,676,5,460,10014.0,104.0,64.0,5,216,10016.0,20.0,15.0
0.039,17,2,182,1,65,0.0,37.0,37.0,1,117,0.0,89.0,89.0
0.015,6,13,3735,7,497,2.0,125.0,125.0,6,3238,2.0,1470.0,1459.0
0.004,17,2,166,1,75,0.0,47.0,47.0,1,91,0.0,63.0,63.0
0.018,6,10,1990,5,911,4.0,643.0,643.0,5,1079,4.0,811.0,811.0
0.087,6,10,1989,5,910,21.0,642.0,642.0,5,1079,21.0,811.0,811.0
0.005,6,10,2007,5,928,1.0,660.0,660.0,5,1079,1.0,811.0,811.0
0.005,6,10,1779,5,928,1.0,660.0,660.0,5,851,1.0,583.0,583.0
0.012,6,10,1972,5,910,3.0,642.0,642.0,5,1062,2.0,794.0,794.0
0.246,17,15,8641,8,4076,35.0,1350.0,481.0,7,4565,31.0,1350.0,624.0
0.006,6,10,1547,5,764,1.0,496.0,496.0,5,783,1.0,515.0,515.0
0.004,17,2,136,1,60,0.0,32.0,32.0,1,76,0.0,48.0,48.0
0.076,6,10,1506,5,395,17.0,127.0,127.0,5,1111,17.0,843.0,843.0
0.039,17,2,182,1,65,0.0,37.0,37.0,1,117,0.0,89.0,89.0
0.07,6,10,1506,5,395,16.0,127.0,127.0,5,1111,15.0,843.0,843.0
0.001,17,2,180,1,66,0.0,38.0,38.0,1,114,0.0,86.0,86.0
0.009,6,10,1983,5,910,2.0,642.0,642.0,5,1073,2.0,805.0,805.0
15.077,17,15,8415,8,6192,2149.0,1350.0,746.0,7,2223,2508.0,1350.0,289.0
0.097,6,10,1506,5,395,21.0,127.0,127.0,5,1111,22.0,843.0,843.0
0.013,6,13,3913,7,495,2.0,123.0,123.0,6,3418,2.0,1650.0,1549.0
0.005,6,10,2006,5,927,1.0,659.0,659.0,5,1079,1.0,811.0,811.0
0.005,6,10,1689,5,839,1.0,571.0,571.0,5,850,1.0,582.0,582.0
0.005,6,10,1702,5,863,1.0,595.0,595.0,5,839,1.0,571.0,571.0
0.038,17,2,182,1,65,0.0,37.0,37.0,1,117,0.0,89.0,89.0
0.006,6,10,1547,5,764,1.0,496.0,496.0,5,783,1.0,515.0,515.0
0.006,17,2,136,1,60,0.0,32.0,32.0,1,76,0.0,48.0,48.0
0.013,6,10,1990,5,911,3.0,643.0,643.0,5,1079,3.0,811.0,811.0
0.006,6,10,1547,5,764,1.0,496.0,496.0,5,783,1.0,515.0,515.0
0.004,6,10,1702,5,863,1.0,595.0,595.0,5,839,0.0,571.0,571.0
282.63,6,25,7304,11,1226,28263.0,267.0,156.0,14,6078,21739.0,1400.0,919.0
11.501,17,28,4395,14,2312,872.0,587.0,137.0,14,2083,872.0,270.0,120.0
0.139,6,10,1506,5,395,30.0,127.0,127.0,5,1111,33.0,843.0,843.0
0.004,6,10,2006,5,927,1.0,659.0,659.0,5,1079,1.0,811.0,811.0
0.005,6,13,3747,7,509,0.0,137.0,137.0,6,3238,1.0,1470.0,1459.0
369.01,6,22,2313,16,867,24600.0,195.0,195.0,6,1446,4645.0,419.0,398.0
0.117,6,10,1506,5,395,25.0,127.0,127.0,5,1111,28.0,843.0,843.0
0.006,6,10,1547,5,764,1.0,496.0,496.0,5,783,1.0,515.0,515.0
0.118,6,10,1506,5,395,24.0,127.0,127.0,5,1111,26.0,843.0,843.0
0.009,6,10,1972,5,910,2.0,642.0,642.0,5,1062,2.0,794.0,794.0
0.005,6,10,2006,5,927,1.0,659.0,659.0,5,1079,1.0,811.0,811.0
0.006,6,10,1547,5,764,1.0,496.0,496.0,5,783,1.0,515.0,515.0
10.812,17,28,4422,14,1995,822.0,270.0,114.0,14,2427,822.0,586.0,145.0
29.253,6,37,9746,19,4228,492.0,1360.0,687.0,18,5518,1710.0,2667.0,435.0
0.096,6,10,1506,5,395,21.0,127.0,127.0,5,1111,19.0,843.0,843.0
0.009,6,10,1983,5,910,2.0,642.0,642.0,5,1073,2.0,805.0,805.0
450.867,6,30,8786,16,3832,30057.0,676.0,427.0,14,4954,34681.0,1402.0,705.0
0.005,6,10,1643,5,860,1.0,592.0,592.0,5,783,1.0,515.0,515.0
0.061,6,10,1506,5,395,13.0,127.0,127.0,5,1111,14.0,843.0,843.0
0.011,6,10,1989,5,910,2.0,642.0,642.0,5,1079,2.0,811.0,811.0
0.017,6,10,1972,5,910,4.0,642.0,642.0,5,1062,4.0,794.0,794.0
0.012,6,10,1972,5,910,2.0,642.0,642.0,5,1062,3.0,794.0,794.0
0.071,17,8,3613,4,1874,23.0,1350.0,440.0,4,1739,11.0,1350.0,406.0
0.005,6,10,2000,5,927,1.0,659.0,659.0,5,1073,1.0,805.0,805.0
0.005,6,10,1989,5,927,1.0,659.0,659.0,5,1062,1.0,794.0,794.0
0.011,6,10,1990,5,911,2.0,643.0,643.0,5,1079,2.0,811.0,811.0
0.022,6,10,1631,5,848,5.0,580.0,580.0,5,783,5.0,515.0,515.0
0.011,6,10,1989,5,910,2.0,642.0,642.0,5,1079,2.0,811.0,811.0
0.003,17,2,148,1,60,0.0,32.0,32.0,1,88,0.0,60.0,60.0
178.449,17,82,11571,41,2728,4461.0,44.0,38.0,41,8843,4461.0,239.0,187.0
0.004,17,2,412,1,61,0.0,33.0,33.0,1,351,0.0,323.0,323.0
0.006,6,10,1643,5,860,1.0,592.0,592.0,5,783,1.0,515.0,515.0
0.003,17,4,284,2,120,0.0,32.0,32.0,2,164,0.0,60.0,54.0
0.007,6,10,1689,5,839,1.0,571.0,571.0,5,850,1.0,582.0,582.0
0.037,17,2,156,1,64,0.0,36.0,36.0,1,92,0.0,64.0,64.0
0.076,6,10,1506,5,395,16.0,127.0,127.0,5,1111,18.0,843.0,843.0
0.011,6,10,1972,5,910,2.0,642.0,642.0,5,1062,2.0,794.0,794.0
0.004,17,4,284,2,120,0.0,32.0,32.0,2,164,1.0,60.0,54.0
240.175,6,64,53683,32,3167,7747.0,1226.0,498.0,32,50516,7747.0,2804.0,1744.0
0.015,6,10,1677,5,827,3.0,559.0,559.0,5,850,3.0,582.0,582.0
0.053,6,10,1506,5,395,12.0,127.0,127.0,5,1111,12.0,843.0,843.0
40.051,17,10,676,5,460,10011.0,104.0,64.0,5,216,10011.0,20.0,15.0
0.005,6,13,3690,7,452,0.0,80.0,80.0,6,3238,1.0,1470.0,1459.0
40.092,17,10,676,5,460,10019.0,104.0,64.0,5,216,10021.0,20.0,15.0
0.009,6,10,1972,5,910,2.0,642.0,642.0,5,1062,2.0,794.0,794.0
0.037,17,2,148,1,60,0.0,32.0,32.0,1,88,0.0,60.0,60.0
0.115,6,10,1506,5,395,24.0,127.0,127.0,5,1111,24.0,843.0,843.0
0.018,17,2,198,1,91,0.0,63.0,63.0,1,107,0.0,79.0,79.0
0.004,17,2,136,1,60,0.0,32.0,32.0,1,76,0.0,48.0,48.0
0.005,17,2,170,1,65,0.0,37.0,37.0,1,105,0.0,77.0,77.0
0.004,6,10,2000,5,927,1.0,659.0,659.0,5,1073,1.0,805.0,805.0
0.005,6,14,3742,7,452,0.0,80.0,80.0,7,3290,0.0,1448.0,972.0
0.079,6,10,1506,5,395,19.0,127.0,127.0,5,1111,18.0,843.0,843.0
0.005,6,10,2006,5,927,1.0,659.0,659.0,5,1079,1.0,811.0,811.0
240.026,6,9,787,5,488,60006.0,232.0,232.0,4,299,80007.0,83.0,83.0
1798.199,6,244,46675,119,34107,15238.0,1368.0,899.0,125,12568,14501.0,580.0,62.0
0.008,17,2,194,1,59,0.0,31.0,31.0,1,135,0.0,107.0,107.0
0.088,6,10,1506,5,395,17.0,127.0,127.0,5,1111,18.0,843.0,843.0
40.068,17,10,676,5,460,10014.0,104.0,64.0,5,216,10016.0,20.0,15.0
0.008,6,10,1854,5,889,1.0,621.0,621.0,5,965,1.0,697.0,697.0
0.079,6,10,1506,5,395,17.0,127.0,127.0,5,1111,16.0,843.0,843.0
0.009,6,10,1989,5,910,2.0,642.0,642.0,5,1079,2.0,811.0,811.0
0.11,6,10,1506,5,395,25.0,127.0,127.0,5,1111,24.0,843.0,843.0
0.011,6,10,1989,5,910,2.0,642.0,642.0,5,1079,2.0,811.0,811.0
0.017,6,14,3787,7,497,2.0,125.0,125.0,7,3290,2.0,1448.0,972.0
0.011,6,10,1989,5,910,2.0,642.0,642.0,5,1079,2.0,811.0,811.0
0.005,17,2,169,1,62,0.0,34.0,34.0,1,107,0.0,79.0,79.0
0.005,6,10,2006,5,927,1.0,659.0,659.0,5,1079,1.0,811.0,811.0
0.005,6,10,2006,5,927,1.0,659.0,659.0,5,1079,1.0,811.0,811.0
0.127,6,10,1506,5,395,29.0,127.0,127.0,5,1111,26.0,843.0,843.0
0.011,6,10,1762,5,911,2.0,643.0,643.0,5,851,2.0,583.0,583.0
0.086,6,10,1506,5,395,19.0,127.0,127.0,5,1111,19.0,843.0,843.0
0.005,17,2,140,1,62,0.0,34.0,34.0,1,78,0.0,50.0,50.0
0.006,17,2,164,1,74,0.0,46.0,46.0,1,90,0.0,62.0,62.0
0.007,17,2,179,1,71,0.0,43.0,43.0,1,108,0.0,80.0,80.0
1729.22,6,65,7413,42,4485,42176.0,1402.0,104.0,23,2928,78592.0,1112.0,82.0
40.052,17,10,676,5,460,10012.0,104.0,64.0,5,216,10012.0,20.0,15.0
0.004,17,2,180,1,66,0.0,38.0,38.0,1,114,0.0,86.0,86.0
0.041,17,4,284,2,120,0.0,32.0,32.0,2,164,37.0,60.0,54.0
0.005,17,2,179,1,71,0.0,43.0,43.0,1,108,0.0,80.0,80.0
172.444,17,76,10718,38,2537,4660.0,44.0,38.0,38,8181,4660.0,239.0,187.0
0.008,6,10,1972,5,910,2.0,642.0,642.0,5,1062,2.0,794.0,794.0
40.052,17,10,676,5,460,10012.0,104.0,64.0,5,216,10012.0,20.0,15.0
0.004,6,10,1702,5,863,1.0,595.0,595.0,5,839,0.0,571.0,571.0
0.013,6,10,1990,5,911,3.0,643.0,643.0,5,1079,3.0,811.0,811.0
300.345,6,16,2170,9,684,37522.0,146.0,146.0,7,1486,50030.0,419.0,398.0
1778.972,17,142,44872,72,22752,25052.0,288.0,288.0,70,22120,25775.0,288.0,288.0
0.009,6,10,1989,5,910,2.0,642.0,642.0,5,1079,2.0,811.0,811.0
0.013,6,10,1990,5,911,3.0,643.0,643.0,5,1079,3.0,811.0,811.0
0.005,6,10,2000,5,927,1.0,659.0,659.0,5,1073,1.0,805.0,805.0
0.005,6,10,2006,5,927,1.0,659.0,659.0,5,1079,1.0,811.0,811.0
0.017,6,10,1989,5,910,4.0,642.0,642.0,5,1079,4.0,811.0,811.0
0.012,6,10,1972,5,910,2.0,642.0,642.0,5,1062,3.0,794.0,794.0
15.069,17,15,9238,8,6902,2148.0,1350.0,834.0,7,2336,2506.0,1350.0,305.0
0.04,17,2,186,1,61,0.0,33.0,33.0,1,125,0.0,97.0,97.0
0.011,6,12,1926,6,1189,2.0,659.0,434.0,6,737,2.0,417.0,417.0
1792.22,6,560,189676,284,163730,6332.0,2883.0,936.0,276,25946,6517.0,383.0,110.0
0.005,6,10,2000,5,927,1.0,659.0,659.0,5,1073,1.0,805.0,805.0
0.18,17,4,596,2,122,108.0,33.0,33.0,2,474,176.0,323.0,209.0
0.116,6,10,1506,5,395,28.0,127.0,127.0,5,1111,25.0,843.0,843.0
0.205,6,16,2777,8,1395,29.0,533.0,323.0,8,1382,18.0,529.0,239.0
0.015,6,10,1990,5,911,3.0,643.0,643.0,5,1079,3.0,811.0,811.0
0.006,6,10,1689,5,839,1.0,571.0,571.0,5,850,1.0,582.0,582.0
0.015,6,10,1677,5,827,3.0,559.0,559.0,5,850,3.0,582.0,582.0
0.004,6,10,2007,5,928,1.0,660.0,660.0,5,1079,1.0,811.0,811.0
1791.425,6,491,99452,247,88102,7281.0,421.0,365.0,244,11350,7371.0,53.0,53.0
0.001,17,2,180,1,66,0.0,38.0,38.0,1,114,0.0,86.0,86.0
0.013,6,10,1762,5,911,3.0,643.0,643.0,5,851,3.0,583.0,583.0
0.102,6,10,1506,5,395,22.0,127.0,127.0,5,1111,24.0,843.0,843.0
0.009,6,13,3735,7,497,1.0,125.0,125.0,6,3238,1.0,1470.0,1459.0
0.016,6,10,1983,5,910,4.0,642.0,642.0,5,1073,4.0,805.0,805.0
0.098,6,10,1506,5,395,21.0,127.0,127.0,5,1111,24.0,843.0,843.0
0.006,6,10,1989,5,927,1.0,659.0,659.0,5,1062,1.0,794.0,794.0
0.066,6,10,1506,5,395,14.0,127.0,127.0,5,1111,15.0,843.0,843.0
0.006,17,4,495,2,132,3.0,38.0,38.0,2,363,0.0,176.0,153.0
0.018,6,10,1983,5,910,4.0,642.0,642.0,5,1073,4.0,805.0,805.0
0.076,6,10,1506,5,395,16.0,127.0,127.0,5,1111,18.0,843.0,843.0
0.01,6,10,1677,5,827,2.0,559.0,559.0,5,850,2.0,582.0,582.0
0.005,6,10,2000,5,927,1.0,659.0,659.0,5,1073,1.0,805.0,805.0
0.008,6,10,1631,5,848,2.0,580.0,580.0,5,783,1.0,515.0,515.0
0.01,6,10,1989,5,910,2.0,642.0,642.0,5,1079,2.0,811.0,811.0
0.004,6,10,1702,5,863,0.0,595.0,595.0,5,839,1.0,571.0,571.0
0.109,6,10,1506,5,395,25.0,127.0,127.0,5,1111,22.0,843.0,843.0
0.011,6,10,1677,5,827,2.0,559.0,559.0,5,850,2.0,582.0,582.0
0.007,6,10,1547,5,764,1.0,496.0,496.0,5,783,1.0,515.0,515.0
0.084,6,10,1506,5,395,18.0,127.0,127.0,5,1111,19.0,843.0,843.0
0.008,6,10,1972,5,910,2.0,642.0,642.0,5,1062,2.0,794.0,794.0
0.017,6,10,1989,5,910,4.0,642.0,642.0,5,1079,4.0,811.0,811.0
0.025,17,4,284,2,120,0.0,32.0,32.0,2,164,0.0,60.0,54.0
0.095,17,2,144,1,64,0.0,36.0,36.0,1,80,0.0,52.0,52.0
241.84,6,20,4688,9,963,30230.0,238.0,166.0,11,3725,24183.0,1402.0,786.0
0.01,6,10,1989,5,910,2.0,642.0,642.0,5,1079,2.0,811.0,811.0
0.004,17,2,148,1,60,0.0,32.0,32.0,1,88,0.0,60.0,60.0
0.003,17,2,148,1,60,0.0,32.0,32.0,1,88,0.0,60.0,60.0
0.077,6,10,1506,5,395,16.0,127.0,127.0,5,1111,15.0,843.0,843.0
0.005,6,15,3794,8,504,0.0,80.0,80.0,7,3290,0.0,1448.0,972.0
0.005,17,2,170,1,65,0.0,37.0,37.0,1,105,0.0,77.0,77.0
0.006,6,10,1547,5,764,1.0,496.0,496.0,5,783,1.0,515.0,515.0
0.007,6,10,1989,5,910,1.0,642.0,642.0,5,1079,1.0,811.0,811.0
0.012,6,14,3787,7,497,2.0,125.0,125.0,7,3290,1.0,1448.0,972.0
0.012,6,10,1677,5,827,3.0,559.0,559.0,5,850,2.0,582.0,582.0
0.008,6,10,1989,5,910,2.0,642.0,642.0,5,1079,2.0,811.0,811.0
40.058,17,10,676,5,460,10013.0,104.0,64.0,5,216,10013.0,20.0,15.0
0.017,17,2,198,1,91,0.0,63.0,63.0,1,107,0.0,79.0,79.0
0.017,6,10,1983,5,910,4.0,642.0,642.0,5,1073,4.0,805.0,805.0
20.899,6,36,9669,18,4151,521.0,1686.0,849.0,18,5518,1219.0,2667.0,435.0
40.059,17,10,676,5,460,10013.0,104.0,64.0,5,216,10013.0,20.0,15.0
0.062,6,10,1506,5,395,14.0,127.0,127.0,5,1111,14.0,843.0,843.0
0.072,17,2,148,1,60,0.0,32.0,32.0,1,88,0.0,60.0,60.0
0.013,6,10,1989,5,910,3.0,642.0,642.0,5,1079,3.0,811.0,811.0
0.01,6,10,1631,5,848,2.0,580.0,580.0,5,783,2.0,515.0,515.0
0.062,6,10,1506,5,395,14.0,127.0,127.0,5,1111,15.0,843.0,843.0
0.057,6,10,1506,5,395,13.0,127.0,127.0,5,1111,14.0,843.0,843.0
0.11,6,10,1506,5,395,24.0,127.0,127.0,5,1111,25.0,843.0,843.0
0.013,6,10,1989,5,910,3.0,642.0,642.0,5,1079,3.0,811.0,811.0
0.006,6,10,1547,5,764,1.0,496.0,496.0,5,783,1.0,515.0,515.0
0.009,6,10,1972,5,910,2.0,642.0,642.0,5,1062,2.0,794.0,794.0
0.078,6,10,1506,5,395,17.0,127.0,127.0,5,1111,14.0,843.0,843.0
0.098,6,10,1506,5,395,21.0,127.0,127.0,5,1111,20.0,843.0,843.0
0.006,6,10,1689,5,839,1.0,571.0,571.0,5,850,1.0,582.0,582.0
0.005,6,10,2000,5,927,1.0,659.0,659.0,5,1073,1.0,805.0,805.0
0.008,6,12,1926,6,1189,1.0,659.0,434.0,6,737,1.0,417.0,417.0
0.133,6,10,1506,5,395,28.0,127.0,127.0,5,1111,27.0,843.0,843.0
0.014,6,10,1989,5,910,3.0,642.0,642.0,5,1079,3.0,811.0,811.0
317.058,17,20,1124,10,716,35214.0,48.0,43.0,10,408,35215.0,20.0,12.0
0.006,6,10,1547,5,764,1.0,496.0,496.0,5,783,1.0,515.0,515.0
0.006,6,13,3747,7,509,0.0,137.0,137.0,6,3238,1.0,1470.0,1459.0
0.004,6,10,1702,5,863,1.0,595.0,595.0,5,839,0.0,571.0,571.0
0.013,6,10,1631,5,848,3.0,580.0,580.0,5,783,3.0,515.0,515.0
0.009,6,10,1677,5,827,2.0,559.0,559.0,5,850,2.0,582.0,582.0
0.005,6,10,2007,5,928,1.0,660.0,660.0,5,1079,1.0,811.0,811.0
0.005,6,10,2000,5,927,1.0,659.0,659.0,5,1073,1.0,805.0,805.0
0.225,6,16,2782,8,1400,32.0,533.0,325.0,8,1382,20.0,529.0,239.0
0.089,6,10,1506,5,395,19.0,127.0,127.0,5,1111,20.0,843.0,843.0
0.006,17,2,230,1,68,0.0,40.0,40.0,1,162,0.0,134.0,134.0
0.092,6,10,1506,5,395,20.0,127.0,127.0,5,1111,16.0,843.0,843.0
15.071,17,14,9190,8,6902,2149.0,1350.0,834.0,6,2288,3008.0,1350.0,353.0
0.068,6,10,1506,5,395,15.0,127.0,127.0,5,1111,14.0,843.0,843.0
0.004,17,2,148,1,60,0.0,32.0,32.0,1,88,0.0,60.0,60.0
0.01,6,10,1989,5,910,2.0,642.0,642.0,5,1079,2.0,811.0,811.0
0.039,17,2,186,1,61,0.0,33.0,33.0,1,125,0.0,97.0,97.0
0.004,6,10,1989,5,927,1.0,659.0,659.0,5,1062,1.0,794.0,794.0
0.012,6,10,1989,5,910,3.0,642.0,642.0,5,1079,2.0,811.0,811.0
0.016,6,10,1762,5,911,3.0,643.0,643.0,5,851,3.0,583.0,583.0
0.013,6,10,1631,5,848,3.0,580.0,580.0,5,783,3.0,515.0,515.0
0.005,17,2,166,1,75,0.0,47.0,47.0,1,91,0.0,63.0,63.0
0.067,17,8,3613,4,1874,22.0,1350.0,440.0,4,1739,11.0,1350.0,406.0
0.007,6,10,1547,5,764,1.0,496.0,496.0,5,783,1.0,515.0,515.0
0.005,6,10,1689,5,839,1.0,571.0,571.0,5,850,1.0,582.0,582.0
0.005,6,10,1989,5,927,1.0,659.0,659.0,5,1062,1.0,794.0,794.0
0.074,6,10,1506,5,395,16.0,127.0,127.0,5,1111,17.0,843.0,843.0
0.09,6,10,1506,5,395,19.0,127.0,127.0,5,1111,18.0,843.0,843.0
0.029,6,10,1983,5,910,7.0,642.0,642.0,5,1073,7.0,805.0,805.0
0.01,6,12,1926,6,1189,2.0,659.0,434.0,6,737,2.0,417.0,417.0
0.005,6,10,2000,5,927,1.0,659.0,659.0,5,1073,1.0,805.0,805.0
0.047,6,10,1989,5,910,11.0,642.0,642.0,5,1079,11.0,811.0,811.0
10.981,17,28,4370,14,2312,836.0,587.0,137.0,14,2058,836.0,269.0,119.0
0.005,6,10,1689,5,839,1.0,571.0,571.0,5,850,1.0,582.0,582.0
0.005,6,10,2006,5,927,1.0,659.0,659.0,5,1079,1.0,811.0,811.0
0.053,17,2,152,1,76,0.0,48.0,48.0,1,76,0.0,48.0,48.0
0.005,6,10,2006,5,927,1.0,659.0,659.0,5,1079,1.0,811.0,811.0
40.067,17,10,676,5,460,10016.0,104.0,64.0,5,216,10014.0,20.0,15.0
0.008,6,12,1926,6,1189,1.0,659.0,434.0,6,737,1.0,417.0,417.0
0.869,6,10,1873,6,1519,173.0,1267.0,1267.0,4,354,205.0,182.0,182.0
0.01,6,10,1972,5,910,2.0,642.0,642.0,5,1062,2.0,794.0,794.0
0.125,6,10,1506,5,395,27.0,127.0,127.0,5,1111,26.0,843.0,843.0
0.192,6,28,11692,14,5719,14.0,1368.0,828.0,14,5973,14.0,1656.0,748.0
0.02,6,10,1989,5,910,4.0,642.0,642.0,5,1079,5.0,811.0,811.0
0.012,6,10,1972,5,910,3.0,642.0,642.0,5,1062,3.0,794.0,794.0
0.011,6,10,1972,5,910,2.0,642.0,642.0,5,1062,2.0,794.0,794.0
0.096,6,10,1506,5,395,22.0,127.0,127.0,5,1111,21.0,843.0,843.0
40.066,17,10,676,5,460,10015.0,104.0,64.0,5,216,10015.0,20.0,15.0
0.006,17,2,222,1,65,0.0,37.0,37.0,1,157,0.0,129.0,129.0
0.16,6,10,1506,5,395,32.0,127.0,127.0,5,1111,35.0,843.0,843.0
1.096,6,33,13431,18,5892,64.0,2720.0,854.0,15,7539,65.0,2720.0,769.0
0.008,6,10,1547,5,764,1.0,496.0,496.0,5,783,2.0,515.0,515.0
0.223,6,16,2669,8,1395,31.0,533.0,323.0,8,1274,20.0,529.0,212.0
0.021,6,10,1972,5,910,5.0,642.0,642.0,5,1062,5.0,794.0,794.0
0.126,6,10,1506,5,395,28.0,127.0,127.0,5,1111,28.0,843.0,843.0
0.01,6,10,1990,5,911,2.0,643.0,643.0,5,1079,2.0,811.0,811.0
0.062,17,2,80,1,32,0.0,4.0,4.0,1,48,0.0,20.0,20.0
0.013,17,2,152,1,56,0.0,28.0,28.0,1,96,0.0,68.0,68.0
0.085,6,10,1506,5,395,17.0,127.0,127.0,5,1111,19.0,843.0,843.0
0.289,17,15,8641,8,4076,41.0,1350.0,481.0,7,4565,39.0,1350.0,624.0
0.009,6,10,1762,5,911,2.0,643.0,643.0,5,851,2.0,583.0,583.0
0.131,6,10,1506,5,395,26.0,127.0,127.0,5,1111,29.0,843.0,843.0
0.108,6,10,1506,5,395,26.0,127.0,127.0,5,1111,19.0,843.0,843.0
1788.116,6,210,14472,78,6156,23220.0,46.0,46.0,132,8316,13648.0,46.0,46.0
353.998,6,21,1795,16,1030,23599.0,190.0,190.0,5,765,60002.0,464.0,248.0
40.052,17,10,676,5,460,10012.0,104.0,64.0,5,216,10012.0,20.0,15.0
0.014,6,10,1677,5,827,3.0,559.0,559.0,5,850,3.0,582.0,582.0
0.005,6,10,1989,5,927,1.0,659.0,659.0,5,1062,1.0,794.0,794.0
0.007,6,10,1972,5,910,1.0,642.0,642.0,5,1062,1.0,794.0,794.0
316.957,17,20,1124,10,716,35203.0,48.0,43.0,10,408,35203.0,20.0,12.0
15.071,17,14,9190,8,6902,2149.0,1350.0,834.0,6,2288,3008.0,1350.0,353.0
40.066,17,10,676,5,460,10015.0,104.0,64.0,5,216,10015.0,20.0,15.0
0.005,6,10,1989,5,927,1.0,659.0,659.0,5,1062,1.0,794.0,794.0
0.017,6,10,1989,5,910,4.0,642.0,642.0,5,1079,4.0,811.0,811.0
0.015,6,10,1972,5,910,3.0,642.0,642.0,5,1062,3.0,794.0,794.0
0.042,17,2,186,1,61,0.0,33.0,33.0,1,125,0.0,97.0,97.0
0.053,17,2,148,1,60,0.0,32.0,32.0,1,88,0.0,60.0,60.0
0.069,6,10,1506,5,395,16.0,127.0,127.0,5,1111,13.0,843.0,843.0
0.004,17,2,144,1,64,0.0,36.0,36.0,1,80,0.0,52.0,52.0
0.005,6,10,2006,5,927,1.0,659.0,659.0,5,1079,1.0,811.0,811.0
0.009,6,10,1990,5,911,2.0,643.0,643.0,5,1079,2.0,811.0,811.0
240.468,6,36,10553,18,2211,14143.0,555.0,253.0,18,8342,14143.0,1402.0,617.0
0.006,6,10,1547,5,764,1.0,496.0,496.0,5,783,1.0,515.0,515.0
0.073,17,8,3613,4,1874,23.0,1350.0,440.0,4,1739,14.0,1350.0,406.0
0.112,6,10,1506,5,395,25.0,127.0,127.0,5,1111,20.0,843.0,843.0
0.005,6,10,1779,5,928,1.0,660.0,660.0,5,851,1.0,583.0,583.0
0.005,6,13,3747,7,509,0.0,137.0,137.0,6,3238,1.0,1470.0,1459.0
0.001,17,2,136,1,60,0.0,32.0,32.0,1,76,0.0,48.0,48.0
0.13,17,4,284,2,120,1.0,32.0,32.0,2,164,126.0,60.0,54.0
0.123,6,10,1506,5,395,25.0,127.0,127.0,5,1111,25.0,843.0,843.0
0.094,6,10,1506,5,395,21.0,127.0,127.0,5,1111,20.0,843.0,843.0
0.005,17,2,170,1,65,0.0,37.0,37.0,1,105,0.0,77.0,77.0
10.717,17,28,4416,14,1993,816.0,268.0,114.0,14,2423,816.0,586.0,145.0
0.006,6,10,2007,5,928,1.0,660.0,660.0,5,1079,1.0,811.0,811.0
0.017,6,10,1989,5,910,4.0,642.0,642.0,5,1079,4.0,811.0,811.0
0.018,6,10,1631,5,848,4.0,580.0,580.0,5,783,4.0,515.0,515.0
0.005,6,10,2007,5,928,1.0,660.0,660.0,5,1079,1.0,811.0,811.0
0.012,6,10,1983,5,910,3.0,642.0,642.0,5,1073,2.0,805.0,805.0
240.12,6,30,9084,15,6763,17151.0,1888.0,665.0,15,2321,17151.0,580.0,219.0
0.006,6,10,1689,5,839,1.0,571.0,571.0,5,850,1.0,582.0,582.0
0.07,6,10,1506,5,395,16.0,127.0,127.0,5,1111,16.0,843.0,843.0
0.005,17,2,169,1,62,0.0,34.0,34.0,1,107,0.0,79.0,79.0
0.004,6,10,2000,5,927,1.0,659.0,659.0,5,1073,1.0,805.0,805.0
0.005,6,10,1854,5,889,1.0,621.0,621.0,5,965,1.0,697.0,697.0
0.01,6,10,1983,5,910,2.0,642.0,642.0,5,1073,2.0,805.0,805.0
0.038,17,2,396,1,61,0.0,33.0,33.0,1,335,0.0,307.0,307.0
301.377,6,56,26388,30,20321,10392.0,2720.0,1363.0,26,6067,367.0,2667.0,385.0
0.005,6,10,2000,5,927,1.0,659.0,659.0,5,1073,1.0,805.0,805.0
0.014,6,10,1990,5,911,3.0,643.0,643.0,5,1079,3.0,811.0,811.0
0.005,17,2,179,1,71,0.0,43.0,43.0,1,108,0.0,80.0,80.0
0.012,6,10,1989,5,910,2.0,642.0,642.0,5,1079,3.0,811.0,811.0
0.092,6,10,1506,5,395,19.0,127.0,127.0,5,1111,19.0,843.0,843.0
0.01,6,10,1989,5,910,2.0,642.0,642.0,5,1079,2.0,811.0,811.0
0.003,17,2,148,1,60,0.0,32.0,32.0,1,88,0.0,60.0,60.0
0.005,6,10,2006,5,927,1.0,659.0,659.0,5,1079,1.0,811.0,811.0
0.006,17,2,298,1,65,0.0,37.0,37.0,1,233,0.0,205.0,205.0
0.004,6,10,2000,5,927,1.0,659.0,659.0,5,1073,1.0,805.0,805.0
0.004,6,10,1702,5,863,1.0,595.0,595.0,5,839,1.0,571.0,571.0
0.001,17,2,166,1,75,0.0,47.0,47.0,1,91,0.0,63.0,63.0
0.037,17,2,148,1,60,0.0,32.0,32.0,1,88,0.0,60.0,60.0
0.118,6,10,1506,5,395,25.0,127.0,127.0,5,1111,26.0,843.0,843.0
0.005,17,2,214,1,75,0.0,47.0,47.0,1,139,0.0,111.0,111.0
0.069,6,10,1506,5,395,14.0,127.0,127.0,5,1111,16.0,843.0,843.0
0.005,6,10,2007,5,928,1.0,660.0,660.0,5,1079,1.0,811.0,811.0
0.01,6,10,1990,5,911,2.0,643.0,643.0,5,1079,2.0,811.0,811.0
40.056,17,10,676,5,460,10013.0,104.0,64.0,5,216,10013.0,20.0,15.0
0.006,6,10,1689,5,839,1.0,571.0,571.0,5,850,1.0,582.0,582.0
40.98,58,5,360,4,288,13660.0,24.0,24.0,1,72,0.0,24.0,24.0
0.005,6,10,1643,5,860,1.0,592.0,592.0,5,783,1.0,515.0,515.0
0.011,6,10,1990,5,911,2.0,643.0,643.0,5,1079,2.0,811.0,811.0
361.814,6,19,1689,15,978,25843.0,190.0,190.0,4,711,80014.0,495.0,495.0
0.013,6,10,1990,5,911,3.0,643.0,643.0,5,1079,3.0,811.0,811.0
0.005,6,13,3747,7,509,0.0,137.0,137.0,6,3238,0.0,1470.0,1459.0
0.005,17,2,146,1,65,0.0,37.0,37.0,1,81,0.0,53.0,53.0
0.144,6,10,1506,5,395,34.0,127.0,127.0,5,1111,25.0,843.0,843.0
0.005,6,10,2007,5,928,1.0,660.0,660.0,5,1079,1.0,811.0,811.0
0.113,6,10,1506,5,395,24.0,127.0,127.0,5,1111,25.0,843.0,843.0
0.01,6,10,1972,5,910,2.0,642.0,642.0,5,1062,2.0,794.0,794.0
0.07,17,8,3613,4,1874,23.0,1350.0,440.0,4,1739,12.0,1350.0,406.0
0.008,6,10,1990,5,911,1.0,643.0,643.0,5,1079,2.0,811.0,811.0
0.005,6,10,2007,5,928,1.0,660.0,660.0,5,1079,1.0,811.0,811.0
0.005,6,10,2000,5,927,1.0,659.0,659.0,5,1073,1.0,805.0,805.0
15.073,17,15,9238,8,6902,2149.0,1350.0,834.0,7,2336,2507.0,1350.0,305.0
0.011,6,10,1989,5,910,2.0,642.0,642.0,5,1079,2.0,811.0,811.0
0.02,17,2,164,1,74,0.0,46.0,46.0,1,90,0.0,62.0,62.0
0.008,6,10,1989,5,910,2.0,642.0,642.0,5,1079,1.0,811.0,811.0
0.036,17,4,284,2,120,0.0,32.0,32.0,2,164,33.0,60.0,54.0
0.017,6,10,1677,5,827,4.0,559.0,559.0,5,850,4.0,582.0,582.0
0.013,6,10,1677,5,827,3.0,559.0,559.0,5,850,3.0,582.0,582.0
0.005,6,10,1989,5,927,1.0,659.0,659.0,5,1062,1.0,794.0,794.0
0.039,17,2,148,1,60,0.0,32.0,32.0,1,88,0.0,60.0,60.0
11.505,17,28,4389,14,2311,872.0,586.0,137.0,14,2078,872.0,269.0,120.0
0.008,6,10,1762,5,911,1.0,643.0,643.0,5,851,2.0,583.0,583.0
0.008,6,10,1677,5,827,2.0,559.0,559.0,5,850,2.0,582.0,582.0
0.061,17,2,80,1,32,0.0,4.0,4.0,1,48,0.0,20.0,20.0
0.041,17,2,184,1,61,0.0,33.0,33.0,1,123,0.0,95.0,95.0
0.006,17,2,273,1,66,0.0,38.0,38.0,1,207,0.0,179.0,179.0
0.011,6,10,1989,5,910,2.0,642.0,642.0,5,1079,2.0,811.0,811.0
0.014,6,10,1989,5,910,3.0,642.0,642.0,5,1079,3.0,811.0,811.0
0.006,6,10,1854,5,889,1.0,621.0,621.0,5,965,1.0,697.0,697.0
0.015,6,10,1972,5,910,3.0,642.0,642.0,5,1062,3.0,794.0,794.0
0.004,17,2,208,1,72,0.0,44.0,44.0,1,136,0.0,108.0,108.0
0.003,17,2,148,1,60,0.0,32.0,32.0,1,88,0.0,60.0,60.0
0.072,17,2,136,1,60,0.0,32.0,32.0,1,76,0.0,48.0,48.0
0.007,17,2,194,1,59,0.0,31.0,31.0,1,135,0.0,107.0,107.0
0.009,6,12,1926,6,1189,1.0,659.0,434.0,6,737,1.0,417.0,417.0
0.125,6,10,1506,5,395,30.0,127.0,127.0,5,1111,25.0,843.0,843.0
0.038,17,2,152,1,76,0.0,48.0,48.0,1,76,0.0,48.0,48.0
0.004,6,10,1702,5,863,1.0,595.0,595.0,5,839,1.0,571.0,571.0
0.064,6,10,1506,5,395,15.0,127.0,127.0,5,1111,13.0,843.0,843.0
0.025,6,10,1990,5,911,6.0,643.0,643.0,5,1079,6.0,811.0,811.0
0.005,6,10,1989,5,927,1.0,659.0,659.0,5,1062,1.0,794.0,794.0
0.014,6,10,1983,5,910,3.0,642.0,642.0,5,1073,3.0,805.0,805.0
0.11,6,10,1506,5,395,21.0,127.0,127.0,5,1111,26.0,843.0,843.0
0.006,6,10,1547,5,764,1.0,496.0,496.0,5,783,1.0,515.0,515.0
240.027,6,9,787,5,488,60006.0,232.0,232.0,4,299,80008.0,83.0,83.0
0.01,6,10,1990,5,911,2.0,643.0,643.0,5,1079,2.0,811.0,811.0
0.005,6,10,1643,5,860,1.0,592.0,592.0,5,783,1.0,515.0,515.0
0.162,6,10,1506,5,395,36.0,127.0,127.0,5,1111,39.0,843.0,843.0
0.005,6,10,2006,5,927,1.0,659.0,659.0,5,1079,1.0,811.0,811.0
240.42,6,30,12314,16,6311,16028.0,2167.0,1096.0,14,6003,18493.0,1656.0,877.0
0.038,17,2,152,1,76,0.0,48.0,48.0,1,76,0.0,48.0,48.0
0.002,17,2,148,1,60,0.0,32.0,32.0,1,88,0.0,60.0,60.0
113.586,6,26,9525,12,1627,76.0,794.0,367.0,14,7898,8727.0,1360.0,732.0
240.094,6,16,4482,9,963,30011.0,238.0,166.0,7,3519,40015.0,1402.0,786.0
0.012,6,13,3735,7,497,2.0,125.0,125.0,6,3238,2.0,1470.0,1459.0
0.117,6,10,1506,5,395,28.0,127.0,127.0,5,1111,15.0,843.0,843.0
0.0,17,2,179,1,62,0.0,34.0,34.0,1,117,0.0,89.0,89.0
0.049,6,13,3735,7,497,8.0,125.0,125.0,6,3238,9.0,1470.0,1459.0
0.005,17,2,214,1,75,0.0,47.0,47.0,1,139,0.0,111.0,111.0
0.003,17,2,136,1,60,0.0,32.0,32.0,1,76,0.0,48.0,48.0
0.006,17,2,178,1,65,0.0,37.0,37.0,1,113,0.0,85.0,85.0
40.065,17,10,676,5,460,10015.0,104.0,64.0,5,216,10015.0,20.0,15.0
0.006,6,10,1547,5,764,1.0,496.0,496.0,5,783,1.0,515.0,515.0
0.005,6,10,2007,5,928,1.0,660.0,660.0,5,1079,1.0,811.0,811.0
0.011,6,10,1989,5,910,2.0,642.0,642.0,5,1079,2.0,811.0,811.0
300.208,6,39,10113,21,4595,15001.0,1360.0,620.0,18,5518,17649.0,2667.0,435.0
374.664,6,21,1796,16,1030,24977.0,190.0,190.0,5,766,60022.0,465.0,249.0
15.083,17,15,8733,8,6631,2150.0,1350.0,800.0,7,2102,2508.0,1350.0,272.0
0.005,6,10,1774,5,923,1.0,655.0,655.0,5,851,1.0,583.0,583.0
0.001,17,2,166,1,75,0.0,47.0,47.0,1,91,0.0,63.0,63.0
0.009,6,10,1989,5,910,2.0,642.0,642.0,5,1079,2.0,811.0,811.0
0.106,6,10,1506,5,395,26.0,127.0,127.0,5,1111,25.0,843.0,843.0
0.092,6,10,1506,5,395,22.0,127.0,127.0,5,1111,17.0,843.0,843.0
0.012,6,10,1990,5,911,3.0,643.0,643.0,5,1079,3.0,811.0,811.0
0.003,17,2,234,1,61,0.0,33.0,33.0,1,173,0.0,145.0,145.0
0.088,6,10,1506,5,395,21.0,127.0,127.0,5,1111,14.0,843.0,843.0
0.005,17,2,154,1,69,0.0,41.0,41.0,1,85,0.0,57.0,57.0
0.129,17,2,136,1,60,0.0,32.0,32.0,1,76,0.0,48.0,48.0
0.078,6,10,1506,5,395,16.0,127.0,127.0,5,1111,17.0,843.0,843.0
0.041,17,2,412,1,61,0.0,33.0,33.0,1,351,0.0,323.0,323.0
0.091,6,10,1506,5,395,19.0,127.0,127.0,5,1111,20.0,843.0,843.0
0.005,6,10,2007,5,928,1.0,660.0,660.0,5,1079,1.0,811.0,811.0
0.005,17,4,495,2,132,1.0,38.0,38.0,2,363,2.0,176.0,153.0
0.005,6,13,3747,7,509,0.0,137.0,137.0,6,3238,0.0,1470.0,1459.0
0.004,17,4,284,2,120,0.0,32.0,32.0,2,164,0.0,60.0,54.0
0.004,6,10,1779,5,928,1.0,660.0,660.0,5,851,1.0,583.0,583.0
0.007,17,2,164,1,74,0.0,46.0,46.0,1,90,0.0,62.0,62.0
0.004,6,10,1989,5,927,1.0,659.0,659.0,5,1062,1.0,794.0,794.0
0.004,17,2,208,1,72,0.0,44.0,44.0,1,136,0.0,108.0,108.0
0.019,6,10,1989,5,910,4.0,642.0,642.0,5,1079,4.0,811.0,811.0
0.005,17,2,154,1,69,0.0,41.0,41.0,1,85,0.0,57.0,57.0
282.322,6,23,6075,10,1186,31369.0,267.0,156.0,13,4889,23516.0,1400.0,873.0
0.008,6,10,1989,5,910,2.0,642.0,642.0,5,1079,2.0,811.0,811.0
0.002,17,2,180,1,66,0.0,38.0,38.0,1,114,0.0,86.0,86.0
0.006,6,10,1547,5,764,1.0,496.0,496.0,5,783,1.0,515.0,515.0
0.005,6,13,3747,7,509,0.0,137.0,137.0,6,3238,0.0,1470.0,1459.0
0.005,17,2,170,1,65,0.0,37.0,37.0,1,105,0.0,77.0,77.0
40.069,17,10,676,5,460,10014.0,104.0,64.0,5,216,10016.0,20.0,15.0
0.087,6,10,1506,5,395,20.0,127.0,127.0,5,1111,18.0,843.0,843.0
0.01,6,10,1989,5,910,2.0,642.0,642.0,5,1079,2.0,811.0,811.0
11.033,17,28,4399,14,2312,840.0,587.0,137.0,14,2087,840.0,270.0,121.0
0.013,6,10,1972,5,910,3.0,642.0,642.0,5,1062,3.0,794.0,794.0
0.004,6,10,2000,5,927,1.0,659.0,659.0,5,1073,1.0,805.0,805.0
0.011,6,10,1989,5,910,2.0,642.0,642.0,5,1079,2.0,811.0,811.0
0.004,6,10,1702,5,863,1.0,595.0,595.0,5,839,0.0,571.0,571.0
0.009,6,10,1989,5,910,2.0,642.0,642.0,5,1079,2.0,811.0,811.0
0.007,6,10,1972,5,910,1.0,642.0,642.0,5,1062,1.0,794.0,794.0
0.174,17,2,152,1,76,0.0,48.0,48.0,1,76,0.0,48.0,48.0
0.04,17,4,284,2,120,0.0,32.0,32.0,2,164,36.0,60.0,54.0
0.067,17,8,3613,4,1874,22.0,1350.0,440.0,4,1739,11.0,1350.0,406.0
0.011,6,10,1972,5,910,2.0,642.0,642.0,5,1062,2.0,794.0,794.0
0.098,6,10,1506,5,395,20.0,127.0,127.0,5,1111,21.0,843.0,843.0
0.006,6,10,1547,5,764,1.0,496.0,496.0,5,783,1.0,515.0,515.0
0.094,6,10,1506,5,395,22.0,127.0,127.0,5,1111,17.0,843.0,843.0
0.005,6,10,2006,5,927,1.0,659.0,659.0,5,1079,1.0,811.0,811.0
0.006,6,10,1547,5,764,1.0,496.0,496.0,5,783,1.0,515.0,515.0
0.014,6,10,1972,5,910,3.0,642.0,642.0,5,1062,3.0,794.0,794.0
1778.144,17,143,41496,72,22752,25044.0,288.0,288.0,71,18744,25401.0,236.0,236.0
0.005,17,2,184,1,61,0.0,33.0,33.0,1,123,0.0,95.0,95.0
0.012,6,10,1631,5,848,3.0,580.0,580.0,5,783,3.0,515.0,515.0
0.011,6,10,1989,5,910,2.0,642.0,642.0,5,1079,2.0,811.0,811.0
0.006,6,10,2000,5,927,1.0,659.0,659.0,5,1073,1.0,805.0,805.0
0.056,17,2,179,1,71,0.0,43.0,43.0,1,108,0.0,80.0,80.0
0.005,17,2,136,1,60,0.0,32.0,32.0,1,76,0.0,48.0,48.0
0.013,17,2,152,1,56,0.0,28.0,28.0,1,96,0.0,68.0,68.0
0.042,17,4,284,2,120,0.0,32.0,32.0,2,164,38.0,60.0,54.0
0.005,6,10,1854,5,889,1.0,621.0,621.0,5,965,1.0,697.0,697.0
0.005,6,10,1989,5,927,1.0,659.0,659.0,5,1062,1.0,794.0,794.0
0.003,17,2,148,1,60,0.0,32.0,32.0,1,88,0.0,60.0,60.0
0.006,17,2,214,1,75,0.0,47.0,47.0,1,139,0.0,111.0,111.0
0.069,17,8,3613,4,1874,23.0,1350.0,440.0,4,1739,12.0,1350.0,406.0
0.015,6,10,1983,5,910,3.0,642.0,642.0,5,1073,3.0,805.0,805.0
0.078,17,2,148,1,60,0.0,32.0,32.0,1,88,0.0,60.0,60.0
0.012,6,10,1989,5,910,3.0,642.0,642.0,5,1079,3.0,811.0,811.0
0.02,6,10,1983,5,910,4.0,642.0,642.0,5,1073,4.0,805.0,805.0
0.006,6,10,1547,5,764,1.0,496.0,496.0,5,783,1.0,515.0,515.0
40.071,17,10,676,5,460,10014.0,104.0,64.0,5,216,10016.0,20.0,15.0
0.215,6,16,2674,8,1400,30.0,533.0,325.0,8,1274,19.0,529.0,212.0
0.007,6,10,1643,5,860,1.0,592.0,592.0,5,783,1.0,515.0,515.0
0.086,6,10,1506,5,395,20.0,127.0,127.0,5,1111,16.0,843.0,843.0
0.086,6,10,1506,5,395,19.0,127.0,127.0,5,1111,18.0,843.0,843.0
0.005,6,10,2007,5,928,1.0,660.0,660.0,5,1079,1.0,811.0,811.0
0.007,17,4,284,2,120,4.0,32.0,32.0,2,164,3.0,60.0,54.0
0.005,6,10,1702,5,863,1.0,595.0,595.0,5,839,1.0,571.0,571.0
0.011,6,10,1990,5,911,2.0,643.0,643.0,5,1079,2.0,811.0,811.0
0.017,6,10,1677,5,827,4.0,559.0,559.0,5,850,4.0,582.0,582.0
0.004,17,2,136,1,60,0.0,32.0,32.0,1,76,0.0,48.0,48.0
0.04,17,2,136,1,60,0.0,32.0,32.0,1,76,0.0,48.0,48.0
40.057,17,10,676,5,460,10013.0,104.0,64.0,5,216,10013.0,20.0,15.0
0.019,6,10,1990,5,911,4.0,643.0,643.0,5,1079,4.0,811.0,811.0
0.006,6,10,1547,5,764,1.0,496.0,496.0,5,783,1.0,515.0,515.0
0.042,17,2,136,1,60,0.0,32.0,32.0,1,76,0.0,48.0,48.0
0.013,6,10,1983,5,910,3.0,642.0,642.0,5,1073,3.0,805.0,805.0
0.014,6,10,1990,5,911,3.0,643.0,643.0,5,1079,3.0,811.0,811.0
0.016,6,13,3735,7,497,2.0,125.0,125.0,6,3238,3.0,1470.0,1459.0
0.015,6,10,1983,5,910,3.0,642.0,642.0,5,1073,3.0,805.0,805.0
0.017,6,10,1989,5,910,4.0,642.0,642.0,5,1079,4.0,811.0,811.0
0.004,17,2,148,1,60,0.0,32.0,32.0,1,88,0.0,60.0,60.0
0.005,6,10,2000,5,927,1.0,659.0,659.0,5,1073,1.0,805.0,805.0
0.001,17,2,164,1,74,0.0,46.0,46.0,1,90,0.0,62.0,62.0
0.003,17,2,144,1,64,0.0,36.0,36.0,1,80,0.0,52.0,52.0
0.004,6,10,2007,5,928,1.0,660.0,660.0,5,1079,1.0,811.0,811.0
0.005,6,14,3799,7,509,0.0,137.0,137.0,7,3290,0.0,1448.0,972.0
0.005,6,10,1779,5,928,1.0,660.0,660.0,5,851,1.0,583.0,583.0
0.038,17,2,186,1,61,0.0,33.0,33.0,1,125,0.0,97.0,97.0
0.005,6,10,2006,5,927,1.0,659.0,659.0,5,1079,1.0,811.0,811.0
0.063,6,10,1506,5,395,13.0,127.0,127.0,5,1111,13.0,843.0,843.0
0.005,6,10,1779,5,928,1.0,660.0,660.0,5,851,1.0,583.0,583.0
0.005,17,2,136,1,60,0.0,32.0,32.0,1,76,0.0,48.0,48.0
40.062,17,10,676,5,460,10012.0,104.0,64.0,5,216,10014.0,20.0,15.0
40.062,17,10,676,5,460,10014.0,104.0,64.0,5,216,10014.0,20.0,15.0
0.01,6,10,1762,5,911,2.0,643.0,643.0,5,851,2.0,583.0,583.0
0.012,6,10,1677,5,827,2.0,559.0,559.0,5,850,2.0,582.0,582.0
0.006,17,2,179,1,71,0.0,43.0,43.0,1,108,0.0,80.0,80.0
0.007,6,10,1779,5,928,1.0,660.0,660.0,5,851,1.0,583.0,583.0
0.129,17,2,80,1,32,0.0,4.0,4.0,1,48,0.0,20.0,20.0
0.005,6,10,1854,5,889,1.0,621.0,621.0,5,965,1.0,697.0,697.0
0.005,6,10,1643,5,860,1.0,592.0,592.0,5,783,1.0,515.0,515.0
0.005,6,10,1689,5,839,1.0,571.0,571.0,5,850,1.0,582.0,582.0
0.019,6,10,1989,5,910,4.0,642.0,642.0,5,1079,4.0,811.0,811.0
0.005,6,10,1989,5,927,1.0,659.0,659.0,5,1062,1.0,794.0,794.0
54.94,6,38,13325,19,7767,495.0,2720.0,1395.0,19,5558,3042.0,2667.0,435.0
0.005,6,10,2007,5,928,1.0,660.0,660.0,5,1079,1.0,811.0,811.0
0.017,6,10,1972,5,910,4.0,642.0,642.0,5,1062,4.0,794.0,794.0
0.012,6,10,1677,5,827,2.0,559.0,559.0,5,850,3.0,582.0,582.0
0.084,6,10,1506,5,395,16.0,127.0,127.0,5,1111,19.0,843.0,843.0
1686.951,17,14,1106,7,441,281157.0,35.0,35.0,7,665,281157.0,67.0,67.0
0.018,6,10,1631,5,848,4.0,580.0,580.0,5,783,4.0,515.0,515.0
0.014,6,10,1762,5,911,3.0,643.0,643.0,5,851,3.0,583.0,583.0
0.021,17,2,214,1,75,0.0,47.0,47.0,1,139,0.0,111.0,111.0
0.006,17,2,178,1,81,0.0,53.0,53.0,1,97,0.0,69.0,69.0
0.005,17,2,230,1,68,0.0,40.0,40.0,1,162,0.0,134.0,134.0
0.09,6,10,1506,5,395,20.0,127.0,127.0,5,1111,18.0,843.0,843.0
0.114,6,10,1506,5,395,25.0,127.0,127.0,5,1111,25.0,843.0,843.0
0.119,6,10,1506,5,395,27.0,127.0,127.0,5,1111,28.0,843.0,843.0
0.005,6,10,2006,5,927,1.0,659.0,659.0,5,1079,1.0,811.0,811.0
0.009,6,10,1989,5,910,2.0,642.0,642.0,5,1079,2.0,811.0,811.0
0.032,6,14,3787,7,497,5.0,125.0,125.0,7,3290,5.0,1448.0,972.0
0.104,6,10,1506,5,395,23.0,127.0,127.0,5,1111,23.0,843.0,843.0
0.11,6,10,1506,5,395,24.0,127.0,127.0,5,1111,25.0,843.0,843.0
0.071,17,2,136,1,60,0.0,32.0,32.0,1,76,0.0,48.0,48.0
0.012,6,10,1762,5,911,2.0,643.0,643.0,5,851,3.0,583.0,583.0
0.02,6,10,1989,5,910,4.0,642.0,642.0,5,1079,5.0,811.0,811.0
0.071,17,2,184,1,61,0.0,33.0,33.0,1,123,0.0,95.0,95.0
40.059,17,10,676,5,460,10013.0,104.0,64.0,5,216,10013.0,20.0,15.0
0.004,6,10,2006,5,927,1.0,659.0,659.0,5,1079,1.0,811.0,811.0
0.084,6,10,1506,5,395,16.0,127.0,127.0,5,1111,19.0,843.0,843.0
0.122,6,10,1506,5,395,27.0,127.0,127.0,5,1111,24.0,843.0,843.0
0.017,6,10,1989,5,910,4.0,642.0,642.0,5,1079,4.0,811.0,811.0
0.004,17,2,148,1,60,0.0,32.0,32.0,1,88,0.0,60.0,60.0
0.006,6,10,1689,5,839,1.0,571.0,571.0,5,850,1.0,582.0,582.0
0.003,17,2,148,1,60,0.0,32.0,32.0,1,88,0.0,60.0,60.0
0.012,6,13,3735,7,497,2.0,125.0,125.0,6,3238,2.0,1470.0,1459.0
0.012,6,10,1983,5,910,3.0,642.0,642.0,5,1073,2.0,805.0,805.0
0.005,6,10,1643,5,860,1.0,592.0,592.0,5,783,1.0,515.0,515.0
0.092,6,10,1506,5,395,18.0,127.0,127.0,5,1111,18.0,843.0,843.0
0.102,6,10,1506,5,395,23.0,127.0,127.0,5,1111,23.0,843.0,843.0
0.004,6,10,1702,5,863,1.0,595.0,595.0,5,839,1.0,571.0,571.0
0.088,6,10,1506,5,395,18.0,127.0,127.0,5,1111,20.0,843.0,843.0
40.082,17,10,676,5,460,10016.0,104.0,64.0,5,216,10019.0,20.0,15.0
0.016,6,10,1983,5,910,4.0,642.0,642.0,5,1073,4.0,805.0,805.0
0.01,6,10,1990,5,911,2.0,643.0,643.0,5,1079,2.0,811.0,811.0
0.01,6,10,1989,5,910,2.0,642.0,642.0,5,1079,2.0,811.0,811.0
0.028,6,10,1972,5,910,7.0,642.0,642.0,5,1062,6.0,794.0,794.0
0.006,17,2,164,1,74,0.0,46.0,46.0,1,90,0.0,62.0,62.0
0.005,6,10,1989,5,927,1.0,659.0,659.0,5,1062,1.0,794.0,794.0
0.015,6,10,1972,5,910,3.0,642.0,642.0,5,1062,3.0,794.0,794.0
0.006,6,13,3747,7,509,0.0,137.0,137.0,6,3238,1.0,1470.0,1459.0
0.002,17,2,152,1,76,0.0,48.0,48.0,1,76,0.0,48.0,48.0
0.146,6,10,1506,5,395,32.0,127.0,127.0,5,1111,31.0,843.0,843.0
0.008,6,10,1547,5,764,1.0,496.0,496.0,5,783,1.0,515.0,515.0
0.005,6,10,2000,5,927,1.0,659.0,659.0,5,1073,1.0,805.0,805.0
0.01,6,10,1972,5,910,2.0,642.0,642.0,5,1062,2.0,794.0,794.0
0.006,17,2,148,1,66,0.0,38.0,38.0,1,82,0.0,54.0,54.0
0.144,6,10,1506,5,395,31.0,127.0,127.0,5,1111,31.0,843.0,843.0
0.007,6,10,1989,5,910,1.0,642.0,642.0,5,1079,1.0,811.0,811.0
0.005,17,2,169,1,62,0.0,34.0,34.0,1,107,0.0,79.0,79.0
300.153,6,45,18855,24,13217,13042.0,2720.0,1358.0,21,5638,14999.0,2667.0,435.0
0.004,6,10,1989,5,927,1.0,659.0,659.0,5,1062,1.0,794.0,794.0
0.006,17,2,180,1,66,0.0,38.0,38.0,1,114,0.0,86.0,86.0
178.5,17,78,11277,39,2609,4697.0,44.0,38.0,39,8668,4697.0,239.0,194.0
0.011,6,10,1983,5,910,2.0,642.0,642.0,5,1073,2.0,805.0,805.0
0.005,6,10,1547,5,764,1.0,496.0,496.0,5,783,1.0,515.0,515.0
0.005,17,2,170,1,65,0.0,37.0,37.0,1,105,0.0,77.0,77.0
0.007,6,10,1972,5,910,1.0,642.0,642.0,5,1062,1.0,794.0,794.0
0.042,17,2,184,1,61,0.0,33.0,33.0,1,123,0.0,95.0,95.0
0.007,6,10,1643,5,860,1.0,592.0,592.0,5,783,1.0,515.0,515.0
0.136,6,10,1506,5,395,32.0,127.0,127.0,5,1111,28.0,843.0,843.0
0.087,6,10,1506,5,395,17.0,127.0,127.0,5,1111,20.0,843.0,843.0
0.004,6,10,2006,5,927,1.0,659.0,659.0,5,1079,1.0,811.0,811.0
351.987,6,20,2210,6,1308,12003.0,494.0,494.0,14,902,27075.0,83.0,83.0
0.011,6,10,1972,5,910,2.0,642.0,642.0,5,1062,2.0,794.0,794.0
15.072,17,14,9190,8,6902,2149.0,1350.0,834.0,6,2288,3008.0,1350.0,353.0
0.017,6,10,1677,5,827,4.0,559.0,559.0,5,850,4.0,582.0,582.0
0.004,6,10,2006,5,927,1.0,659.0,659.0,5,1079,1.0,811.0,811.0
0.099,6,10,1506,5,395,20.0,127.0,127.0,5,1111,23.0,843.0,843.0
0.005,6,13,3690,7,452,0.0,80.0,80.0,6,3238,0.0,1470.0,1459.0
0.005,17,2,170,1,65,0.0,37.0,37.0,1,105,0.0,77.0,77.0
0.004,6,10,2006,5,927,1.0,659.0,659.0,5,1079,1.0,811.0,811.0
0.117,6,10,1506,5,395,24.0,127.0,127.0,5,1111,25.0,843.0,843.0
0.006,6,10,1643,5,860,1.0,592.0,592.0,5,783,1.0,515.0,515.0
0.232,6,16,2669,8,1395,33.0,533.0,323.0,8,1274,21.0,529.0,212.0
0.006,6,10,2006,5,927,1.0,659.0,659.0,5,1079,1.0,811.0,811.0
0.009,6,10,1989,5,910,2.0,642.0,642.0,5,1079,2.0,811.0,811.0
0.005,17,2,164,1,74,0.0,46.0,46.0,1,90,0.0,62.0,62.0
0.001,17,2,180,1,66,0.0,38.0,38.0,1,114,0.0,86.0,86.0
0.001,17,2,180,1,66,0.0,38.0,38.0,1,114,0.0,86.0,86.0
15.07,17,15,9238,8,6902,2148.0,1350.0,834.0,7,2336,2507.0,1350.0,305.0
40.063,17,10,676,5,460,10014.0,104.0,64.0,5,216,10014.0,20.0,15.0
5.159,6,23,6467,13,1827,429.0,801.0,282.0,10,4640,572.0,1925.0,824.0
0.013,6,10,1972,5,910,3.0,642.0,642.0,5,1062,3.0,794.0,794.0
0.015,6,10,1989,5,910,3.0,642.0,642.0,5,1079,3.0,811.0,811.0
165.475,17,80,11593,40,2690,4242.0,44.0,39.0,40,8903,4242.0,261.0,194.0
0.013,6,10,1990,5,911,3.0,643.0,643.0,5,1079,3.0,811.0,811.0
0.004,6,10,2006,5,927,1.0,659.0,659.0,5,1079,1.0,811.0,811.0
0.012,6,10,1631,5,848,2.0,580.0,580.0,5,783,2.0,515.0,515.0
0.001,17,2,180,1,66,0.0,38.0,38.0,1,114,0.0,86.0,86.0
0.001,17,2,180,1,66,0.0,38.0,38.0,1,114,0.0,86.0,86.0
0.001,17,2,180,1,66,0.0,38.0,38.0,1,114,0.0,86.0,86.0
176.371,17,82,11548,41,2736,4409.0,44.0,38.0,41,8812,4409.0,261.0,186.0
0.037,17,2,412,1,61,0.0,33.0,33.0,1,351,0.0,323.0,323.0
0.012,6,10,1989,5,927,3.0,659.0,659.0,5,1062,2.0,794.0,794.0
0.018,6,10,1972,5,910,4.0,642.0,642.0,5,1062,4.0,794.0,794.0
0.006,6,10,1689,5,839,1.0,571.0,571.0,5,850,1.0,582.0,582.0
0.082,6,10,1506,5,395,16.0,127.0,127.0,5,1111,19.0,843.0,843.0
0.004,6,10,2007,5,928,1.0,660.0,660.0,5,1079,1.0,811.0,811.0
0.016,6,10,1989,5,910,4.0,642.0,642.0,5,1079,3.0,811.0,811.0
177.537,17,82,11691,41,2733,4438.0,44.0,38.0,41,8958,4438.0,239.0,190.0
11.506,17,28,4399,14,2312,872.0,587.0,137.0,14,2087,872.0,270.0,121.0
0.005,17,2,230,1,68,0.0,40.0,40.0,1,162,0.0,134.0,134.0
165.076,17,78,11024,39,2601,4343.0,44.0,38.0,39,8423,4344.0,261.0,187.0
0.005,17,2,170,1,65,0.0,37.0,37.0,1,105,0.0,77.0,77.0
0.006,6,10,1547,5,764,1.0,496.0,496.0,5,783,1.0,515.0,515.0
0.171,17,2,152,1,76,0.0,48.0,48.0,1,76,0.0,48.0,48.0
0.012,6,10,1972,5,910,3.0,642.0,642.0,5,1062,2.0,794.0,794.0
0.005,6,10,2006,5,927,1.0,659.0,659.0,5,1079,1.0,811.0,811.0
0.043,17,2,148,1,60,0.0,32.0,32.0,1,88,0.0,60.0,60.0
0.012,6,10,1989,5,910,3.0,642.0,642.0,5,1079,3.0,811.0,811.0
0.038,17,2,148,1,60,0.0,32.0,32.0,1,88,0.0,60.0,60.0
8.995,6,39,10487,20,4929,473.0,1360.0,682.0,19,5558,488.0,2667.0,435.0
0.071,17,4,284,2,120,0.0,32.0,32.0,2,164,67.0,60.0,54.0
0.105,6,10,1506,5,395,23.0,127.0,127.0,5,1111,18.0,843.0,843.0
1729.206,6,60,4400,40,2740,44338.0,33.0,33.0,20,1660,91001.0,31.0,31.0
40.062,17,10,676,5,460,10014.0,104.0,64.0,5,216,10013.0,20.0,15.0
0.09,6,10,1506,5,395,17.0,127.0,127.0,5,1111,20.0,843.0,843.0
1.012,6,25,8493,14,2109,77.0,1142.0,379.0,11,6384,83.0,2720.0,988.0
0.02,6,10,1983,5,910,5.0,642.0,642.0,5,1073,5.0,805.0,805.0
1.003,6,13,3929,7,2138,125.0,1328.0,923.0,6,1791,150.0,1539.0,1539.0
0.012,6,10,1989,5,910,2.0,642.0,642.0,5,1079,2.0,811.0,811.0
0.111,6,10,1506,5,395,24.0,127.0,127.0,5,1111,23.0,843.0,843.0
0.018,6,10,1990,5,911,4.0,643.0,643.0,5,1079,4.0,811.0,811.0
0.003,17,2,185,1,73,0.0,45.0,45.0,1,112,0.0,84.0,84.0
0.001,17,2,180,1,66,0.0,38.0,38.0,1,114,0.0,86.0,86.0
0.079,6,10,1506,5,395,18.0,127.0,127.0,5,1111,15.0,843.0,843.0
354.052,6,21,1795,16,1030,23603.0,190.0,190.0,5,765,60004.0,464.0,248.0
0.014,6,10,1762,5,911,3.0,643.0,643.0,5,851,3.0,583.0,583.0
0.003,6,10,1702,5,863,0.0,595.0,595.0,5,839,0.0,571.0,571.0
0.006,6,10,1989,5,927,1.0,659.0,659.0,5,1062,1.0,794.0,794.0
0.001,17,2,180,1,66,0.0,38.0,38.0,1,114,0.0,86.0,86.0
40.059,17,10,676,5,460,10014.0,104.0,64.0,5,216,10014.0,20.0,15.0
0.082,6,10,1506,5,395,19.0,127.0,127.0,5,1111,17.0,843.0,843.0
0.004,6,10,1702,5,863,1.0,595.0,595.0,5,839,0.0,571.0,571.0
0.008,6,12,1926,6,1189,1.0,659.0,434.0,6,737,1.0,417.0,417.0
0.005,17,2,140,1,62,0.0,34.0,34.0,1,78,0.0,50.0,50.0
0.095,6,10,1506,5,395,20.0,127.0,127.0,5,1111,22.0,843.0,843.0
0.005,6,14,3742,7,452,0.0,80.0,80.0,7,3290,0.0,1448.0,972.0
0.003,17,2,136,1,60,0.0,32.0,32.0,1,76,0.0,48.0,48.0
0.006,17,2,164,1,74,0.0,46.0,46.0,1,90,0.0,62.0,62.0
0.001,17,2,180,1,66,0.0,38.0,38.0,1,114,0.0,86.0,86.0
0.009,6,14,3787,7,497,1.0,125.0,125.0,7,3290,1.0,1448.0,972.0
0.088,6,10,1506,5,395,17.0,127.0,127.0,5,1111,19.0,843.0,843.0
0.019,6,10,1983,5,910,4.0,642.0,642.0,5,1073,4.0,805.0,805.0
0.004,6,10,2006,5,927,1.0,659.0,659.0,5,1079,1.0,811.0,811.0
0.002,17,2,180,1,66,0.0,38.0,38.0,1,114,0.0,86.0,86.0
0.006,17,2,230,1,68,0.0,40.0,40.0,1,162,0.0,134.0,134.0
0.003,17,4,284,2,120,0.0,32.0,32.0,2,164,0.0,60.0,54.0
309.324,17,18,1008,9,640,38649.0,48.0,43.0,9,368,38649.0,20.0,12.0
0.016,6,10,1990,5,911,4.0,643.0,643.0,5,1079,3.0,811.0,811.0
1730.102,6,45,2790,30,1725,59658.0,35.0,35.0,15,1065,123568.0,31.0,31.0
11.179,17,28,4423,14,1994,847.0,269.0,114.0,14,2429,847.0,588.0,145.0
0.018,6,10,1989,5,910,4.0,642.0,642.0,5,1079,4.0,811.0,811.0
0.004,6,10,2000,5,927,1.0,659.0,659.0,5,1073,1.0,805.0,805.0
0.076,6,10,1506,5,395,17.0,127.0,127.0,5,1111,17.0,843.0,843.0
0.005,17,2,136,1,60,0.0,32.0,32.0,1,76,0.0,48.0,48.0
40.068,17,10,676,5,460,10014.0,104.0,64.0,5,216,10016.0,20.0,15.0
0.005,6,10,2006,5,927,1.0,659.0,659.0,5,1079,1.0,811.0,811.0
0.005,17,2,170,1,65,0.0,37.0,37.0,1,105,0.0,77.0,77.0
0.005,6,10,1989,5,927,1.0,659.0,659.0,5,1062,1.0,794.0,794.0
0.022,17,2,146,1,65,0.0,37.0,37.0,1,81,0.0,53.0,53.0
0.094,6,10,1506,5,395,21.0,127.0,127.0,5,1111,21.0,843.0,843.0
0.109,6,10,1506,5,395,24.0,127.0,127.0,5,1111,23.0,843.0,843.0
0.005,6,10,1989,5,927,1.0,659.0,659.0,5,1062,1.0,794.0,794.0
0.007,6,10,1989,5,910,1.0,642.0,642.0,5,1079,1.0,811.0,811.0
11.137,17,26,4164,13,1865,915.0,268.0,115.0,13,2299,914.0,586.0,148.0
0.025,6,10,1972,5,910,6.0,642.0,642.0,5,1062,6.0,794.0,794.0
0.011,6,10,1677,5,827,2.0,559.0,559.0,5,850,2.0,582.0,582.0
0.005,6,10,1989,5,927,1.0,659.0,659.0,5,1062,1.0,794.0,794.0
0.004,17,2,148,1,60,0.0,32.0,32.0,1,88,0.0,60.0,60.0
0.004,17,4,284,2,120,0.0,32.0,32.0,2,164,1.0,60.0,54.0
0.084,6,10,1506,5,395,19.0,127.0,127.0,5,1111,18.0,843.0,843.0
0.012,6,14,3787,7,497,2.0,125.0,125.0,7,3290,2.0,1448.0,972.0
0.005,6,10,2006,5,927,1.0,659.0,659.0,5,1079,1.0,811.0,811.0
331.632,17,20,1124,10,716,36841.0,48.0,43.0,10,408,36841.0,20.0,12.0
0.001,17,2,180,1,66,0.0,38.0,38.0,1,114,0.0,86.0,86.0
0.004,6,10,1989,5,927,1.0,659.0,659.0,5,1062,1.0,794.0,794.0
0.004,17,2,148,1,60,0.0,32.0,32.0,1,88,0.0,60.0,60.0
0.009,6,10,1631,5,848,2.0,580.0,580.0,5,783,2.0,515.0,515.0
0.005,6,10,2006,5,927,1.0,659.0,659.0,5,1079,1.0,811.0,811.0
0.004,17,4,284,2,120,0.0,32.0,32.0,2,164,0.0,60.0,54.0
0.005,17,2,179,1,71,0.0,43.0,43.0,1,108,0.0,80.0,80.0
361.857,6,21,1793,16,1030,24123.0,190.0,190.0,5,763,60010.0,462.0,247.0
0.004,6,10,2006,5,927,1.0,659.0,659.0,5,1079,1.0,811.0,811.0
373.839,6,22,2313,16,867,24922.0,195.0,195.0,6,1446,4674.0,419.0,398.0
0.015,6,13,3735,7,497,2.0,125.0,125.0,6,3238,2.0,1470.0,1459.0
0.005,6,10,2006,5,927,1.0,659.0,659.0,5,1079,1.0,811.0,811.0
0.071,6,10,1506,5,395,15.0,127.0,127.0,5,1111,16.0,843.0,843.0
0.14,6,10,1506,5,395,32.0,127.0,127.0,5,1111,34.0,843.0,843.0
0.019,6,10,1990,5,911,4.0,643.0,643.0,5,1079,4.0,811.0,811.0
0.04,17,4,284,2,120,0.0,32.0,32.0,2,164,36.0,60.0,54.0
0.06,17,2,152,1,76,0.0,48.0,48.0,1,76,0.0,48.0,48.0
0.004,17,2,132,1,58,0.0,30.0,30.0,1,74,0.0,46.0,46.0
0.001,17,2,180,1,66,0.0,38.0,38.0,1,114,0.0,86.0,86.0
0.089,6,10,1506,5,395,19.0,127.0,127.0,5,1111,17.0,843.0,843.0
0.088,6,10,1506,5,395,16.0,127.0,127.0,5,1111,21.0,843.0,843.0
0.006,6,10,1547,5,764,1.0,496.0,496.0,5,783,1.0,515.0,515.0
0.011,6,10,1990,5,911,2.0,643.0,643.0,5,1079,2.0,811.0,811.0
15.071,17,15,9238,8,6902,2148.0,1350.0,834.0,7,2336,2507.0,1350.0,305.0
0.019,17,2,198,1,91,0.0,63.0,63.0,1,107,0.0,79.0,79.0
0.009,6,10,1972,5,910,2.0,642.0,642.0,5,1062,2.0,794.0,794.0
0.007,6,10,1547,5,764,1.0,496.0,496.0,5,783,1.0,515.0,515.0
0.096,6,10,1506,5,395,20.0,127.0,127.0,5,1111,23.0,843.0,843.0
0.07,17,2,148,1,60,0.0,32.0,32.0,1,88,0.0,60.0,60.0
10.823,17,28,4423,14,1994,824.0,269.0,114.0,14,2429,823.0,588.0,145.0
0.004,6,10,1774,5,923,1.0,655.0,655.0,5,851,1.0,583.0,583.0
0.014,6,10,1989,5,910,3.0,642.0,642.0,5,1079,3.0,811.0,811.0
0.005,6,10,1779,5,928,1.0,660.0,660.0,5,851,1.0,583.0,583.0
0.071,17,2,148,1,60,0.0,32.0,32.0,1,88,0.0,60.0,60.0
0.004,6,10,2000,5,927,1.0,659.0,659.0,5,1073,1.0,805.0,805.0
0.005,17,2,214,1,75,0.0,47.0,47.0,1,139,0.0,111.0,111.0
0.005,17,2,144,1,64,0.0,36.0,36.0,1,80,0.0,52.0,52.0
0.011,6,10,1989,5,910,2.0,642.0,642.0,5,1079,2.0,811.0,811.0
40.07,17,10,676,5,460,10015.0,104.0,64.0,5,216,10016.0,20.0,15.0
1.141,17,6,764,3,183,569.0,33.0,33.0,3,581,550.0,307.0,165.0
0.006,6,10,1643,5,860,1.0,592.0,592.0,5,783,1.0,515.0,515.0
0.001,17,2,180,1,65,0.0,37.0,37.0,1,115,0.0,87.0,87.0
0.093,6,10,1506,5,395,22.0,127.0,127.0,5,1111,20.0,843.0,843.0
0.004,17,2,152,1,76,0.0,48.0,48.0,1,76,0.0,48.0,48.0
0.112,6,10,1506,5,395,25.0,127.0,127.0,5,1111,26.0,843.0,843.0
0.033,6,10,1990,5,911,8.0,643.0,643.0,5,1079,8.0,811.0,811.0
0.083,6,10,1506,5,395,18.0,127.0,127.0,5,1111,19.0,843.0,843.0
0.071,17,2,136,1,60,0.0,32.0,32.0,1,76,0.0,48.0,48.0
0.004,17,2,136,1,60,0.0,32.0,32.0,1,76,0.0,48.0,48.0
0.005,6,10,2007,5,928,1.0,660.0,660.0,5,1079,1.0,811.0,811.0
0.01,6,10,1972,5,910,2.0,642.0,642.0,5,1062,2.0,794.0,794.0
0.11,6,10,1506,5,395,26.0,127.0,127.0,5,1111,25.0,843.0,843.0
0.014,17,4,284,2,120,1.0,32.0,32.0,2,164,1.0,60.0,54.0
0.003,17,2,148,1,60,0.0,32.0,32.0,1,88,0.0,60.0,60.0
0.005,6,14,3799,7,509,0.0,137.0,137.0,7,3290,0.0,1448.0,972.0
0.081,6,10,1506,5,395,17.0,127.0,127.0,5,1111,18.0,843.0,843.0
0.005,6,10,1547,5,764,1.0,496.0,496.0,5,783,1.0,515.0,515.0
0.005,17,2,144,1,64,0.0,36.0,36.0,1,80,0.0,52.0,52.0
0.09,6,10,1506,5,395,19.0,127.0,127.0,5,1111,18.0,843.0,843.0
10.788,17,28,4423,14,1995,821.0,270.0,114.0,14,2428,821.0,587.0,145.0
308.732,17,19,1084,10,716,34303.0,48.0,43.0,9,368,33076.0,20.0,12.0
0.008,6,12,1926,6,1189,1.0,659.0,434.0,6,737,1.0,417.0,417.0
0.005,17,2,170,1,65,0.0,37.0,37.0,1,105,0.0,77.0,77.0
0.012,6,10,1990,5,911,2.0,643.0,643.0,5,1079,3.0,811.0,811.0
0.005,6,10,1689,5,839,1.0,571.0,571.0,5,850,1.0,582.0,582.0
0.018,6,10,1989,5,910,4.0,642.0,642.0,5,1079,4.0,811.0,811.0
0.005,17,2,157,1,59,0.0,31.0,31.0,1,98,0.0,70.0,70.0
0.08,6,10,1506,5,395,15.0,127.0,127.0,5,1111,17.0,843.0,843.0
0.006,6,13,3747,7,509,0.0,137.0,137.0,6,3238,1.0,1470.0,1459.0
40.084,17,10,676,5,460,10020.0,104.0,64.0,5,216,10019.0,20.0,15.0
10.897,17,28,4417,14,1994,829.0,269.0,114.0,14,2423,829.0,586.0,145.0
15.076,17,15,9238,8,6902,2148.0,1350.0,834.0,7,2336,2507.0,1350.0,305.0
11.035,17,28,4399,14,2313,840.0,588.0,137.0,14,2086,840.0,269.0,121.0
0.071,17,8,3613,4,1874,23.0,1350.0,440.0,4,1739,12.0,1350.0,406.0
0.078,6,10,1506,5,395,17.0,127.0,127.0,5,1111,14.0,843.0,843.0
0.001,17,2,136,1,60,0.0,32.0,32.0,1,76,0.0,48.0,48.0
0.081,6,10,1506,5,395,16.0,127.0,127.0,5,1111,17.0,843.0,843.0
0.013,6,10,1972,5,910,3.0,642.0,642.0,5,1062,3.0,794.0,794.0
0.009,6,10,2006,5,927,2.0,659.0,659.0,5,1079,2.0,811.0,811.0
0.039,17,2,136,1,60,0.0,32.0,32.0,1,76,0.0,48.0,48.0
0.354,17,43,20686,23,17168,16.0,1350.0,718.0,20,3518,13.0,1350.0,147.0
0.011,6,10,1989,5,910,2.0,642.0,642.0,5,1079,2.0,811.0,811.0
0.117,17,2,80,1,32,0.0,4.0,4.0,1,48,0.0,20.0,20.0
0.043,17,2,184,1,61,0.0,33.0,33.0,1,123,0.0,95.0,95.0
0.001,17,2,180,1,66,0.0,38.0,38.0,1,114,0.0,86.0,86.0
0.005,6,10,1643,5,860,1.0,592.0,592.0,5,783,1.0,515.0,515.0
0.038,6,13,3913,7,495,6.0,123.0,123.0,6,3418,7.0,1650.0,1549.0
0.012,6,10,1990,5,911,3.0,643.0,643.0,5,1079,2.0,811.0,811.0
0.005,6,10,2007,5,928,1.0,660.0,660.0,5,1079,1.0,811.0,811.0
0.005,17,2,170,1,65,0.0,37.0,37.0,1,105,0.0,77.0,77.0
0.183,6,10,1506,5,395,29.0,127.0,127.0,5,1111,42.0,843.0,843.0
0.135,6,10,1506,5,395,29.0,127.0,127.0,5,1111,30.0,843.0,843.0
0.006,6,10,1854,5,889,1.0,621.0,621.0,5,965,1.0,697.0,697.0
0.014,6,10,1989,5,910,3.0,642.0,642.0,5,1079,3.0,811.0,811.0
0.004,6,10,2006,5,927,1.0,659.0,659.0,5,1079,1.0,811.0,811.0
0.012,6,10,1983,5,910,3.0,642.0,642.0,5,1073,3.0,805.0,805.0
9.037,17,6,376,5,280,2259.0,28.0,28.0,1,96,0.0,68.0,68.0
0.071,6,10,1506,5,395,16.0,127.0,127.0,5,1111,16.0,843.0,843.0
0.006,17,2,179,1,71,0.0,43.0,43.0,1,108,0.0,80.0,80.0
15.074,17,14,9191,8,6902,2149.0,1350.0,834.0,6,2289,3009.0,1350.0,353.0
0.012,6,10,1990,5,911,3.0,643.0,643.0,5,1079,2.0,811.0,811.0
0.005,17,2,170,1,65,0.0,37.0,37.0,1,105,0.0,77.0,77.0
0.119,6,10,1506,5,395,25.0,127.0,127.0,5,1111,27.0,843.0,843.0
0.01,6,10,1972,5,910,2.0,642.0,642.0,5,1062,2.0,794.0,794.0
0.006,6,10,1854,5,889,1.0,621.0,621.0,5,965,1.0,697.0,697.0
0.006,6,10,1547,5,764,1.0,496.0,496.0,5,783,1.0,515.0,515.0
0.009,6,12,1926,6,1189,1.0,659.0,434.0,6,737,1.0,417.0,417.0
0.004,17,2,185,1,73,0.0,45.0,45.0,1,112,0.0,84.0,84.0
294.336,6,329,345298,123,17948,2412.0,2736.0,888.0,206,327350,1435.0,2804.0,1649.0
0.005,17,2,169,1,62,0.0,34.0,34.0,1,107,0.0,79.0,79.0
0.011,6,10,1762,5,911,2.0,643.0,643.0,5,851,2.0,583.0,583.0
0.01,6,10,1989,5,910,2.0,642.0,642.0,5,1079,2.0,811.0,811.0
0.017,6,10,1983,5,910,4.0,642.0,642.0,5,1073,4.0,805.0,805.0
0.099,6,10,1506,5,395,21.0,127.0,127.0,5,1111,21.0,843.0,843.0
0.011,6,10,1990,5,911,2.0,643.0,643.0,5,1079,2.0,811.0,811.0
285.247,6,30,6573,16,1433,19016.0,517.0,290.0,14,5140,21941.0,2378.0,1104.0
176.313,17,74,10483,37,2466,4897.0,44.0,38.0,37,8017,4897.0,260.0,188.0
240.113,6,30,9553,15,7026,17150.0,2151.0,694.0,15,2527,17150.0,580.0,217.0
177.878,6,22,8499,12,2236,73.0,1345.0,574.0,10,6263,19745.0,2720.0,975.0
0.018,6,10,1989,5,910,4.0,642.0,642.0,5,1079,4.0,811.0,811.0
300.955,6,41,10951,22,5164,14331.0,1360.0,708.0,19,5787,487.0,2667.0,385.0
0.008,6,6,716,3,458,3.0,302.0,302.0,3,258,3.0,102.0,102.0
0.004,17,2,148,1,60,0.0,32.0,32.0,1,88,0.0,60.0,60.0
0.018,6,10,1989,5,910,4.0,642.0,642.0,5,1079,4.0,811.0,811.0
0.003,17,2,148,1,60,0.0,32.0,32.0,1,88,0.0,60.0,60.0
0.006,6,10,2000,5,927,1.0,659.0,659.0,5,1073,1.0,805.0,805.0
0.006,17,2,175,1,65,0.0,37.0,37.0,1,110,0.0,82.0,82.0
0.004,6,10,1702,5,863,1.0,595.0,595.0,5,839,0.0,571.0,571.0
0.004,17,2,136,1,60,0.0,32.0,32.0,1,76,0.0,48.0,48.0
0.08,6,10,1506,5,395,17.0,127.0,127.0,5,1111,19.0,843.0,843.0
0.005,6,10,1643,5,860,1.0,592.0,592.0,5,783,1.0,515.0,515.0
0.002,17,2,166,1,75,0.0,47.0,47.0,1,91,0.0,63.0,63.0
175.441,17,78,11089,39,2591,4616.0,44.0,38.0,39,8498,4616.0,252.0,189.0
0.008,17,2,214,1,75,0.0,47.0,47.0,1,139,0.0,111.0,111.0
40.058,17,10,676,5,460,10013.0,104.0,64.0,5,216,10013.0,20.0,15.0
0.001,17,2,180,1,66,0.0,38.0,38.0,1,114,0.0,86.0,86.0
0.066,6,10,1506,5,395,13.0,127.0,127.0,5,1111,15.0,843.0,843.0
0.004,6,10,2007,5,928,1.0,660.0,660.0,5,1079,1.0,811.0,811.0
103.478,6,22,8496,12,2236,72.0,1345.0,574.0,10,6260,11479.0,2720.0,974.0
0.005,17,2,152,1,68,0.0,40.0,40.0,1,84,0.0,56.0,56.0
0.019,6,10,1989,5,910,4.0,642.0,642.0,5,1079,4.0,811.0,811.0
0.005,6,10,2006,5,927,1.0,659.0,659.0,5,1079,1.0,811.0,811.0
0.006,6,10,1689,5,839,1.0,571.0,571.0,5,850,1.0,582.0,582.0
0.013,6,10,1972,5,910,3.0,642.0,642.0,5,1062,3.0,794.0,794.0
0.003,17,2,148,1,60,0.0,32.0,32.0,1,88,0.0,60.0,60.0
0.006,6,10,2006,5,927,1.0,659.0,659.0,5,1079,1.0,811.0,811.0
0.005,6,10,1989,5,927,1.0,659.0,659.0,5,1062,1.0,794.0,794.0
0.026,6,10,1972,5,910,6.0,642.0,642.0,5,1062,6.0,794.0,794.0
0.005,6,10,1702,5,863,1.0,595.0,595.0,5,839,1.0,571.0,571.0
0.017,6,10,1990,5,911,4.0,643.0,643.0,5,1079,4.0,811.0,811.0
0.016,6,10,1972,5,910,3.0,642.0,642.0,5,1062,3.0,794.0,794.0
0.123,17,2,80,1,32,0.0,4.0,4.0,1,48,0.0,20.0,20.0
0.006,6,10,1854,5,889,1.0,621.0,621.0,5,965,1.0,697.0,697.0
0.007,6,10,1547,5,764,1.0,496.0,496.0,5,783,1.0,515.0,515.0
40.085,17,10,676,5,460,10020.0,104.0,64.0,5,216,10019.0,20.0,15.0
0.102,6,10,1506,5,395,24.0,127.0,127.0,5,1111,22.0,843.0,843.0
40.082,17,10,676,5,460,10019.0,104.0,64.0,5,216,10019.0,20.0,15.0
0.006,6,10,1547,5,764,1.0,496.0,496.0,5,783,1.0,515.0,515.0
0.071,17,2,148,1,60,0.0,32.0,32.0,1,88,0.0,60.0,60.0
0.018,6,10,1762,5,911,4.0,643.0,643.0,5,851,4.0,583.0,583.0
353.374,6,20,2210,6,1308,12003.0,494.0,494.0,14,902,27182.0,83.0,83.0
0.071,17,2,184,1,61,0.0,33.0,33.0,1,123,0.0,95.0,95.0
0.011,6,10,1631,5,848,2.0,580.0,580.0,5,783,2.0,515.0,515.0
0.005,6,10,2006,5,927,1.0,659.0,659.0,5,1079,1.0,811.0,811.0
0.013,17,2,152,1,56,0.0,28.0,28.0,1,96,0.0,68.0,68.0
0.087,6,10,1506,5,395,19.0,127.0,127.0,5,1111,17.0,843.0,843.0
0.007,6,10,2007,5,928,1.0,660.0,660.0,5,1079,1.0,811.0,811.0
0.085,6,10,1506,5,395,20.0,127.0,127.0,5,1111,17.0,843.0,843.0
0.004,17,2,166,1,75,0.0,47.0,47.0,1,91,0.0,63.0,63.0
40.058,17,10,676,5,460,10013.0,104.0,64.0,5,216,10013.0,20.0,15.0
1756.069,6,105,6270,60,3525,29763.0,27.0,27.0,45,2745,39909.0,27.0,27.0
0.018,6,10,1989,5,910,4.0,642.0,642.0,5,1079,4.0,811.0,811.0
0.005,17,2,154,1,69,0.0,41.0,41.0,1,85,0.0,57.0,57.0
40.077,17,10,676,5,460,10016.0,104.0,64.0,5,216,10018.0,20.0,15.0
0.082,6,10,1506,5,395,19.0,127.0,127.0,5,1111,19.0,843.0,843.0
10.879,17,28,4394,14,1994,827.0,269.0,114.0,14,2400,827.0,587.0,143.0
0.042,17,4,284,2,120,1.0,32.0,32.0,2,164,38.0,60.0,54.0
0.005,17,2,166,1,75,0.0,47.0,47.0,1,91,0.0,63.0,63.0
0.025,17,2,198,1,91,0.0,63.0,63.0,1,107,0.0,79.0,79.0
0.012,6,10,1989,5,910,3.0,642.0,642.0,5,1079,2.0,811.0,811.0
0.06,17,2,152,1,76,0.0,48.0,48.0,1,76,0.0,48.0,48.0
0.007,6,10,1547,5,764,1.0,496.0,496.0,5,783,1.0,515.0,515.0
240.077,6,16,4482,9,963,30009.0,238.0,166.0,7,3519,40012.0,1402.0,786.0
0.085,6,10,1506,5,395,18.0,127.0,127.0,5,1111,19.0,843.0,843.0
0.005,17,2,179,1,71,0.0,43.0,43.0,1,108,0.0,80.0,80.0
166.278,17,76,10891,38,2543,4493.0,44.0,38.0,38,8348,4493.0,261.0,191.0
0.007,6,10,1854,5,889,1.0,621.0,621.0,5,965,1.0,697.0,697.0
0.009,6,10,1989,5,910,2.0,642.0,642.0,5,1079,2.0,811.0,811.0
0.004,6,10,1779,5,928,1.0,660.0,660.0,5,851,1.0,583.0,583.0
0.006,17,2,169,1,62,0.0,34.0,34.0,1,107,0.0,79.0,79.0
0.004,17,2,136,1,60,0.0,32.0,32.0,1,76,0.0,48.0,48.0
0.005,6,10,2007,5,928,1.0,660.0,660.0,5,1079,1.0,811.0,811.0
0.003,17,2,148,1,60,0.0,32.0,32.0,1,88,0.0,60.0,60.0
0.016,17,2,198,1,91,0.0,63.0,63.0,1,107,0.0,79.0,79.0
0.092,6,10,1506,5,395,21.0,127.0,127.0,5,1111,19.0,843.0,843.0
0.012,6,10,1990,5,911,3.0,643.0,643.0,5,1079,3.0,811.0,811.0
0.003,17,4,284,2,120,0.0,32.0,32.0,2,164,0.0,60.0,54.0
0.011,6,10,1990,5,911,2.0,643.0,643.0,5,1079,2.0,811.0,811.0
0.011,6,10,1990,5,911,2.0,643.0,643.0,5,1079,2.0,811.0,811.0
0.005,6,10,2006,5,927,1.0,659.0,659.0,5,1079,1.0,811.0,811.0
0.16,6,22,6483,11,2013,14.0,746.0,286.0,11,4470,14.0,1324.0,778.0
0.011,6,10,1989,5,910,2.0,642.0,642.0,5,1079,2.0,811.0,811.0
0.039,17,4,284,2,120,0.0,32.0,32.0,2,164,36.0,60.0,54.0
0.119,6,10,1506,5,395,26.0,127.0,127.0,5,1111,28.0,843.0,843.0
0.014,6,10,1990,5,911,3.0,643.0,643.0,5,1079,3.0,811.0,811.0
0.005,6,13,3747,7,509,0.0,137.0,137.0,6,3238,0.0,1470.0,1459.0
240.603,6,37,15580,18,8541,14153.0,2279.0,1087.0,19,7039,13366.0,1655.0,755.0
1741.965,6,303,97754,187,86475,9365.0,2001.0,685.0,116,11279,15147.0,452.0,70.0
0.118,6,10,1506,5,395,23.0,127.0,127.0,5,1111,26.0,843.0,843.0
0.005,6,10,1547,5,764,1.0,496.0,496.0,5,783,1.0,515.0,515.0
0.005,6,13,3747,7,509,0.0,137.0,137.0,6,3238,1.0,1470.0,1459.0
0.06,17,2,152,1,76,0.0,48.0,48.0,1,76,0.0,48.0,48.0
167.134,17,70,10101,35,2339,4915.0,44.0,38.0,35,7762,4915.0,239.0,193.0
0.122,6,10,1506,5,395,24.0,127.0,127.0,5,1111,28.0,843.0,843.0
0.004,6,10,1989,5,927,1.0,659.0,659.0,5,1062,1.0,794.0,794.0
1772.321,6,107,6374,60,3525,30038.0,27.0,27.0,47,2849,38527.0,27.0,27.0
0.01,6,10,1762,5,911,2.0,643.0,643.0,5,851,2.0,583.0,583.0
240.108,6,16,4481,9,963,30013.0,238.0,166.0,7,3518,40017.0,1402.0,786.0
0.072,17,2,182,1,65,0.0,37.0,37.0,1,117,0.0,89.0,89.0
0.004,6,10,1702,5,863,1.0,595.0,595.0,5,839,1.0,571.0,571.0
0.011,17,2,169,1,62,0.0,34.0,34.0,1,107,0.0,79.0,79.0
0.006,17,2,214,1,75,0.0,47.0,47.0,1,139,0.0,111.0,111.0
0.005,6,13,3747,7,509,0.0,137.0,137.0,6,3238,1.0,1470.0,1459.0
0.011,6,10,1677,5,827,2.0,559.0,559.0,5,850,2.0,582.0,582.0
1770.312,6,84,4420,42,2210,43177.0,26.0,26.0,42,2210,43177.0,26.0,26.0
0.008,6,10,2006,5,927,2.0,659.0,659.0,5,1079,1.0,811.0,811.0
0.005,17,2,140,1,62,0.0,34.0,34.0,1,78,0.0,50.0,50.0
0.229,6,16,2669,8,1395,32.0,533.0,323.0,8,1274,21.0,529.0,212.0
0.167,17,2,152,1,76,0.0,48.0,48.0,1,76,0.0,48.0,48.0
0.088,6,10,1506,5,395,19.0,127.0,127.0,5,1111,19.0,843.0,843.0
0.004,6,10,2007,5,928,1.0,660.0,660.0,5,1079,1.0,811.0,811.0
52.173,6,37,9697,19,4018,499.0,1360.0,645.0,18,5679,3059.0,2715.0,449.0
0.013,6,10,1989,5,910,3.0,642.0,642.0,5,1079,3.0,811.0,811.0
0.011,6,13,3735,7,497,1.0,125.0,125.0,6,3238,2.0,1470.0,1459.0
0.005,17,2,235,1,64,0.0,36.0,36.0,1,171,0.0,143.0,143.0
361.833,6,21,1793,16,1030,24122.0,190.0,190.0,5,763,60009.0,462.0,247.0
0.003,17,2,136,1,60,0.0,32.0,32.0,1,76,0.0,48.0,48.0
0.009,6,10,1989,5,910,2.0,642.0,642.0,5,1079,2.0,811.0,811.0
367.309,6,22,2313,16,867,24487.0,195.0,195.0,6,1446,4657.0,419.0,398.0
0.008,17,2,170,1,65,0.0,37.0,37.0,1,105,0.0,77.0,77.0
0.122,6,10,1506,5,395,28.0,127.0,127.0,5,1111,27.0,843.0,843.0
309.153,17,20,1124,10,716,34336.0,48.0,43.0,10,408,34336.0,20.0,12.0
0.051,17,2,186,1,61,0.0,33.0,33.0,1,125,0.0,97.0,97.0
0.039,17,2,234,1,61,0.0,33.0,33.0,1,173,0.0,145.0,145.0
0.006,6,10,2006,5,927,1.0,659.0,659.0,5,1079,1.0,811.0,811.0
0.077,6,10,1506,5,395,16.0,127.0,127.0,5,1111,18.0,843.0,843.0
0.066,6,10,1506,5,395,13.0,127.0,127.0,5,1111,15.0,843.0,843.0
36.15,6,48,22438,25,16720,375.0,2720.0,1426.0,23,5718,1635.0,2667.0,435.0
0.004,6,10,1989,5,927,1.0,659.0,659.0,5,1062,1.0,794.0,794.0
66.511,6,83,24430,43,16512,1583.0,2660.0,703.0,40,7918,1705.0,1330.0,350.0
0.005,6,10,2006,5,927,1.0,659.0,659.0,5,1079,1.0,811.0,811.0
0.004,17,2,144,1,64,0.0,36.0,36.0,1,80,0.0,52.0,52.0
0.001,17,2,180,1,66,0.0,38.0,38.0,1,114,0.0,86.0,86.0
40.068,17,10,676,5,460,10016.0,104.0,64.0,5,216,10016.0,20.0,15.0
0.01,6,10,1983,5,910,2.0,642.0,642.0,5,1073,2.0,805.0,805.0
0.124,6,10,1506,5,395,30.0,127.0,127.0,5,1111,29.0,843.0,843.0
0.018,6,10,1631,5,848,4.0,580.0,580.0,5,783,4.0,515.0,515.0
0.01,6,10,1989,5,910,2.0,642.0,642.0,5,1079,2.0,811.0,811.0
0.006,6,10,1547,5,764,1.0,496.0,496.0,5,783,1.0,515.0,515.0
0.005,6,10,2006,5,927,1.0,659.0,659.0,5,1079,1.0,811.0,811.0
0.125,6,14,4390,8,923,17.0,238.0,166.0,6,3467,16.0,1402.0,786.0
177.252,17,88,13116,44,2955,4122.0,44.0,39.0,44,10161,4122.0,279.0,202.0
0.006,6,10,1854,5,889,1.0,621.0,621.0,5,965,1.0,697.0,697.0
240.264,6,40,5298,19,2374,13347.0,588.0,196.0,21,2924,12012.0,580.0,228.0
240.091,6,28,6703,14,4607,18468.0,1368.0,485.0,14,2096,18468.0,580.0,170.0
0.068,6,10,1506,5,395,14.0,127.0,127.0,5,1111,15.0,843.0,843.0
40.059,17,10,676,5,460,10013.0,104.0,64.0,5,216,10013.0,20.0,15.0
0.005,6,10,2006,5,927,1.0,659.0,659.0,5,1079,1.0,811.0,811.0
0.068,17,8,3613,4,1874,22.0,1350.0,440.0,4,1739,12.0,1350.0,406.0
0.107,6,10,1506,5,395,20.0,127.0,127.0,5,1111,24.0,843.0,843.0
0.013,17,4,284,2,120,0.0,32.0,32.0,2,164,0.0,60.0,54.0
0.008,6,10,1762,5,911,2.0,643.0,643.0,5,851,2.0,583.0,583.0
0.019,6,10,1762,5,911,4.0,643.0,643.0,5,851,4.0,583.0,583.0
0.001,17,2,180,1,66,0.0,38.0,38.0,1,114,0.0,86.0,86.0
0.006,6,10,1547,5,764,1.0,496.0,496.0,5,783,1.0,515.0,515.0
0.067,6,10,1506,5,395,16.0,127.0,127.0,5,1111,13.0,843.0,843.0
0.007,17,2,179,1,71,0.0,43.0,43.0,1,108,0.0,80.0,80.0
0.797,6,10,2009,6,1655,159.0,1403.0,1403.0,4,354,187.0,182.0,182.0
40.065,17,10,676,5,460,10014.0,104.0,64.0,5,216,10015.0,20.0,15.0
0.046,6,10,1983,5,910,11.0,642.0,642.0,5,1073,11.0,805.0,805.0
0.001,17,2,180,1,66,0.0,38.0,38.0,1,114,0.0,86.0,86.0
0.006,6,10,1547,5,764,1.0,496.0,496.0,5,783,1.0,515.0,515.0
0.004,17,2,148,1,60,0.0,32.0,32.0,1,88,0.0,60.0,60.0
177.816,6,25,9773,12,1627,83.0,794.0,367.0,13,8146,14806.0,1360.0,846.0
0.088,6,10,1506,5,395,20.0,127.0,127.0,5,1111,20.0,843.0,843.0
0.007,6,10,1972,5,910,1.0,642.0,642.0,5,1062,1.0,794.0,794.0
0.004,6,10,2007,5,928,1.0,660.0,660.0,5,1079,1.0,811.0,811.0
0.004,6,10,2006,5,927,1.0,659.0,659.0,5,1079,1.0,811.0,811.0
40.055,17,10,676,5,460,10013.0,104.0,64.0,5,216,10013.0,20.0,15.0
0.018,6,10,1990,5,911,4.0,643.0,643.0,5,1079,4.0,811.0,811.0
0.007,6,10,1689,5,839,1.0,571.0,571.0,5,850,1.0,582.0,582.0
0.004,6,10,1989,5,927,1.0,659.0,659.0,5,1062,1.0,794.0,794.0
0.089,6,10,1506,5,395,19.0,127.0,127.0,5,1111,20.0,843.0,843.0
0.005,6,10,2007,5,928,1.0,660.0,660.0,5,1079,1.0,811.0,811.0
0.041,17,2,152,1,76,0.0,48.0,48.0,1,76,0.0,48.0,48.0
0.017,6,13,3735,7,497,2.0,125.0,125.0,6,3238,3.0,1470.0,1459.0
0.009,6,10,1631,5,848,2.0,580.0,580.0,5,783,2.0,515.0,515.0
0.084,6,10,1506,5,395,20.0,127.0,127.0,5,1111,17.0,843.0,843.0
0.011,6,10,1990,5,911,2.0,643.0,643.0,5,1079,2.0,811.0,811.0
0.003,6,10,1702,5,863,0.0,595.0,595.0,5,839,0.0,571.0,571.0
0.006,6,12,1698,6,863,1.0,327.0,271.0,6,835,1.0,515.0,515.0
0.009,17,2,179,1,71,0.0,43.0,43.0,1,108,0.0,80.0,80.0
40.074,17,10,676,5,460,10016.0,104.0,64.0,5,216,10017.0,20.0,15.0
0.008,6,10,1989,5,910,2.0,642.0,642.0,5,1079,2.0,811.0,811.0
0.018,6,10,1989,5,910,4.0,642.0,642.0,5,1079,4.0,811.0,811.0
0.016,6,10,1990,5,911,4.0,643.0,643.0,5,1079,3.0,811.0,811.0
0.01,6,10,1989,5,910,2.0,642.0,642.0,5,1079,2.0,811.0,811.0
0.004,6,10,1774,5,923,1.0,655.0,655.0,5,851,1.0,583.0,583.0
0.069,6,10,1506,5,395,15.0,127.0,127.0,5,1111,16.0,843.0,843.0
0.04,17,4,352,2,130,0.0,37.0,37.0,2,222,3.0,89.0,83.0
857.557,6,45,16490,24,5114,37285.0,676.0,480.0,21,11376,39877.0,1402.0,856.0
0.006,6,10,1547,5,764,1.0,496.0,496.0,5,783,1.0,515.0,515.0
0.107,6,10,1506,5,395,22.0,127.0,127.0,5,1111,21.0,843.0,843.0
0.015,6,10,1989,5,910,3.0,642.0,642.0,5,1079,3.0,811.0,811.0
0.013,6,10,1972,5,910,3.0,642.0,642.0,5,1062,3.0,794.0,794.0
0.202,6,16,2778,8,1396,28.0,533.0,324.0,8,1382,18.0,529.0,239.0
0.005,6,10,1854,5,889,1.0,621.0,621.0,5,965,1.0,697.0,697.0
0.018,6,10,1605,5,388,4.0,120.0,120.0,5,1217,4.0,949.0,949.0
0.008,6,10,1972,5,910,2.0,642.0,642.0,5,1062,2.0,794.0,794.0
0.006,6,10,1689,5,839,1.0,571.0,571.0,5,850,1.0,582.0,582.0
0.047,17,2,170,1,65,0.0,37.0,37.0,1,105,0.0,77.0,77.0
0.005,17,2,180,1,66,0.0,38.0,38.0,1,114,0.0,86.0,86.0
0.012,6,10,1990,5,911,3.0,643.0,643.0,5,1079,2.0,811.0,811.0
0.006,6,10,1547,5,764,1.0,496.0,496.0,5,783,1.0,515.0,515.0
312.009,17,20,1124,10,716,34653.0,48.0,43.0,10,408,34653.0,20.0,12.0
0.124,6,10,1506,5,395,23.0,127.0,127.0,5,1111,29.0,843.0,843.0
0.103,6,10,1506,5,395,24.0,127.0,127.0,5,1111,22.0,843.0,843.0
0.016,6,10,1989,5,910,4.0,642.0,642.0,5,1079,3.0,811.0,811.0
0.011,6,10,1972,5,910,2.0,642.0,642.0,5,1062,2.0,794.0,794.0
0.01,6,10,1990,5,911,2.0,643.0,643.0,5,1079,2.0,811.0,811.0
0.016,6,10,1989,5,910,4.0,642.0,642.0,5,1079,3.0,811.0,811.0
0.005,6,10,2007,5,928,1.0,660.0,660.0,5,1079,1.0,811.0,811.0
308.4,17,20,1124,10,716,34251.0,48.0,43.0,10,408,34251.0,20.0,12.0
0.005,6,10,1689,5,839,1.0,571.0,571.0,5,850,1.0,582.0,582.0
0.014,6,10,1631,5,848,3.0,580.0,580.0,5,783,3.0,515.0,515.0
1777.932,17,147,42656,74,23384,24355.0,288.0,288.0,73,19272,24693.0,236.0,236.0
0.007,6,10,1643,5,860,1.0,592.0,592.0,5,783,1.0,515.0,515.0
0.001,17,2,136,1,60,0.0,32.0,32.0,1,76,0.0,48.0,48.0
0.009,6,12,1926,6,1189,1.0,659.0,434.0,6,737,1.0,417.0,417.0
0.004,6,10,1989,5,927,1.0,659.0,659.0,5,1062,1.0,794.0,794.0
57.586,6,36,9704,19,4226,3199.0,1753.0,858.0,17,5478,538.0,2667.0,435.0
0.125,17,2,144,1,64,0.0,36.0,36.0,1,80,0.0,52.0,52.0
0.01,6,10,1983,5,910,2.0,642.0,642.0,5,1073,2.0,805.0,805.0
0.078,6,10,1506,5,395,17.0,127.0,127.0,5,1111,16.0,843.0,843.0
0.018,6,13,3735,7,497,2.0,125.0,125.0,6,3238,3.0,1470.0,1459.0
10.582,6,31,10332,17,9046,661.0,2261.0,906.0,14,1286,813.0,209.0,93.0
0.005,6,10,2007,5,928,1.0,660.0,660.0,5,1079,1.0,811.0,811.0
0.001,17,2,180,1,66,0.0,38.0,38.0,1,114,0.0,86.0,86.0
0.016,6,10,1989,5,910,3.0,642.0,642.0,5,1079,4.0,811.0,811.0
0.017,6,10,1990,5,911,4.0,643.0,643.0,5,1079,4.0,811.0,811.0
276.171,6,20,3797,11,2323,27613.0,676.0,348.0,9,1474,34517.0,821.0,336.0
0.004,6,10,1774,5,923,1.0,655.0,655.0,5,851,1.0,583.0,583.0
0.001,17,2,180,1,66,0.0,38.0,38.0,1,114,0.0,86.0,86.0
0.067,6,10,1506,5,395,14.0,127.0,127.0,5,1111,16.0,843.0,843.0
308.722,17,18,1008,9,640,38578.0,48.0,43.0,9,368,38578.0,20.0,12.0
0.004,6,10,1989,5,927,1.0,659.0,659.0,5,1062,1.0,794.0,794.0
0.04,17,2,152,1,76,0.0,48.0,48.0,1,76,0.0,48.0,48.0
0.014,6,10,1677,5,827,3.0,559.0,559.0,5,850,3.0,582.0,582.0
0.01,6,10,1989,5,910,2.0,642.0,642.0,5,1079,2.0,811.0,811.0
0.007,6,10,1547,5,764,1.0,496.0,496.0,5,783,1.0,515.0,515.0
0.008,6,10,1983,5,910,2.0,642.0,642.0,5,1073,1.0,805.0,805.0
0.001,17,2,180,1,66,0.0,38.0,38.0,1,114,0.0,86.0,86.0
0.014,6,10,1989,5,910,3.0,642.0,642.0,5,1079,3.0,811.0,811.0
0.016,6,10,1677,5,827,4.0,559.0,559.0,5,850,3.0,582.0,582.0
0.006,6,10,1547,5,764,1.0,496.0,496.0,5,783,1.0,515.0,515.0
0.004,6,10,2007,5,928,1.0,660.0,660.0,5,1079,1.0,811.0,811.0
0.005,6,13,3747,7,509,0.0,137.0,137.0,6,3238,1.0,1470.0,1459.0
0.005,6,10,1989,5,927,1.0,659.0,659.0,5,1062,1.0,794.0,794.0
0.011,6,10,1989,5,910,2.0,642.0,642.0,5,1079,2.0,811.0,811.0
0.01,6,10,1989,5,910,2.0,642.0,642.0,5,1079,2.0,811.0,811.0
0.018,6,10,1989,5,910,4.0,642.0,642.0,5,1079,4.0,811.0,811.0
0.003,17,2,148,1,60,0.0,32.0,32.0,1,88,0.0,60.0,60.0
0.006,6,10,1547,5,764,1.0,496.0,496.0,5,783,1.0,515.0,515.0
0.005,6,10,2000,5,927,1.0,659.0,659.0,5,1073,1.0,805.0,805.0
0.006,17,2,185,1,73,0.0,45.0,45.0,1,112,0.0,84.0,84.0
0.079,6,10,1506,5,395,18.0,127.0,127.0,5,1111,16.0,843.0,843.0
0.026,6,10,1989,5,910,6.0,642.0,642.0,5,1079,6.0,811.0,811.0
0.071,17,4,284,2,120,0.0,32.0,32.0,2,164,68.0,60.0,54.0
0.001,17,2,180,1,66,0.0,38.0,38.0,1,114,0.0,86.0,86.0
0.022,6,10,1631,5,848,5.0,580.0,580.0,5,783,5.0,515.0,515.0
0.005,6,14,3799,7,509,0.0,137.0,137.0,7,3290,0.0,1448.0,972.0
0.006,6,10,1547,5,764,1.0,496.0,496.0,5,783,1.0,515.0,515.0
0.006,6,10,1643,5,860,1.0,592.0,592.0,5,783,1.0,515.0,515.0
172.135,17,78,11233,39,2605,4529.0,44.0,38.0,39,8628,4529.0,252.0,193.0
0.106,6,10,1506,5,395,21.0,127.0,127.0,5,1111,18.0,843.0,843.0
0.005,6,10,2007,5,928,1.0,660.0,660.0,5,1079,1.0,811.0,811.0
0.0,17,2,142,1,63,0.0,35.0,35.0,1,79,0.0,51.0,51.0
0.185,6,10,1506,5,395,44.0,127.0,127.0,5,1111,43.0,843.0,843.0
0.012,6,10,1990,5,911,3.0,643.0,643.0,5,1079,2.0,811.0,811.0
0.012,6,10,1972,5,910,3.0,642.0,642.0,5,1062,3.0,794.0,794.0
0.01,6,10,1972,5,910,2.0,642.0,642.0,5,1062,2.0,794.0,794.0
0.013,6,10,1983,5,910,3.0,642.0,642.0,5,1073,3.0,805.0,805.0
0.006,6,10,2007,5,928,1.0,660.0,660.0,5,1079,1.0,811.0,811.0
0.004,17,2,136,1,60,0.0,32.0,32.0,1,76,0.0,48.0,48.0
0.015,6,10,1677,5,827,3.0,559.0,559.0,5,850,3.0,582.0,582.0
0.005,6,10,2006,5,927,1.0,659.0,659.0,5,1079,1.0,811.0,811.0
300.807,6,37,9775,20,4297,15831.0,2720.0,693.0,17,5478,538.0,2667.0,435.0
0.005,6,10,1689,5,839,1.0,571.0,571.0,5,850,1.0,582.0,582.0
0.005,6,10,1689,5,839,1.0,571.0,571.0,5,850,1.0,582.0,582.0
40.054,17,10,676,5,460,10012.0,104.0,64.0,5,216,10012.0,20.0,15.0
0.097,6,10,1506,5,395,23.0,127.0,127.0,5,1111,20.0,843.0,843.0
0.001,17,2,180,1,65,0.0,37.0,37.0,1,115,0.0,87.0,87.0
0.102,6,10,1506,5,395,24.0,127.0,127.0,5,1111,23.0,843.0,843.0
0.073,17,2,80,1,32,0.0,4.0,4.0,1,48,0.0,20.0,20.0
0.001,17,2,180,1,66,0.0,38.0,38.0,1,114,0.0,86.0,86.0
1770.271,6,81,4264,41,2158,44255.0,26.0,26.0,40,2106,45390.0,26.0,26.0
0.114,6,10,1506,5,395,25.0,127.0,127.0,5,1111,25.0,843.0,843.0
0.001,17,2,180,1,66,0.0,38.0,38.0,1,114,0.0,86.0,86.0
0.099,6,10,1506,5,395,22.0,127.0,127.0,5,1111,22.0,843.0,843.0
0.005,6,10,2000,5,927,1.0,659.0,659.0,5,1073,1.0,805.0,805.0
0.006,6,10,2000,5,927,1.0,659.0,659.0,5,1073,1.0,805.0,805.0
120.617,6,62,19668,36,5335,3446.0,1054.0,231.0,26,14333,4824.0,2804.0,997.0
0.018,6,10,1983,5,910,4.0,642.0,642.0,5,1073,4.0,805.0,805.0
0.005,6,10,1854,5,889,1.0,621.0,621.0,5,965,1.0,697.0,697.0
0.038,17,2,152,1,76,0.0,48.0,48.0,1,76,0.0,48.0,48.0
11.037,17,28,4396,14,2311,840.0,586.0,137.0,14,2085,840.0,268.0,120.0
0.204,6,16,2670,8,1396,29.0,533.0,324.0,8,1274,18.0,529.0,212.0
176.149,17,82,12034,41,2756,4403.0,44.0,39.0,41,9278,4403.0,239.0,198.0
0.099,6,10,1506,5,395,19.0,127.0,127.0,5,1111,22.0,843.0,843.0
308.582,17,20,1124,10,716,34273.0,48.0,43.0,10,408,34273.0,20.0,12.0
0.016,6,10,1989,5,910,3.0,642.0,642.0,5,1079,4.0,811.0,811.0
1799.841,6,136,6550,76,3625,23997.0,39.0,39.0,60,2925,29991.0,35.0,35.0
0.005,6,13,3747,7,509,0.0,137.0,137.0,6,3238,0.0,1470.0,1459.0
0.087,6,10,1506,5,395,18.0,127.0,127.0,5,1111,18.0,843.0,843.0
300.194,6,16,2170,9,684,37503.0,146.0,146.0,7,1486,50004.0,419.0,398.0
0.008,6,10,1989,5,910,2.0,642.0,642.0,5,1079,1.0,811.0,811.0
0.012,6,10,1983,5,910,2.0,642.0,642.0,5,1073,2.0,805.0,805.0
240.096,6,26,19326,14,1772,18468.0,770.0,349.0,12,17554,21826.0,2804.0,1880.0
0.011,6,10,1762,5,911,2.0,643.0,643.0,5,851,2.0,583.0,583.0
0.005,6,10,1643,5,860,1.0,592.0,592.0,5,783,1.0,515.0,515.0
0.006,6,10,1547,5,764,1.0,496.0,496.0,5,783,1.0,515.0,515.0
0.006,17,2,170,1,65,0.0,37.0,37.0,1,105,0.0,77.0,77.0
0.005,6,10,1774,5,923,1.0,655.0,655.0,5,851,1.0,583.0,583.0
0.099,6,10,1506,5,395,20.0,127.0,127.0,5,1111,21.0,843.0,843.0
0.006,17,2,154,1,69,0.0,41.0,41.0,1,85,0.0,57.0,57.0
0.017,6,10,1983,5,910,4.0,642.0,642.0,5,1073,4.0,805.0,805.0
0.102,6,10,1506,5,395,24.0,127.0,127.0,5,1111,24.0,843.0,843.0
0.091,6,10,1506,5,395,20.0,127.0,127.0,5,1111,21.0,843.0,843.0
0.011,6,10,1762,5,911,2.0,643.0,643.0,5,851,2.0,583.0,583.0
0.003,17,2,148,1,60,0.0,32.0,32.0,1,88,0.0,60.0,60.0
0.005,17,2,180,1,66,0.0,38.0,38.0,1,114,0.0,86.0,86.0
0.004,6,10,1989,5,927,1.0,659.0,659.0,5,1062,1.0,794.0,794.0
0.001,17,2,180,1,66,0.0,38.0,38.0,1,114,0.0,86.0,86.0
413.521,6,29,4409,12,3102,10913.0,494.0,494.0,17,1307,25844.0,83.0,83.0
0.005,6,10,2006,5,927,1.0,659.0,659.0,5,1079,1.0,811.0,811.0
0.004,6,10,1989,5,927,1.0,659.0,659.0,5,1062,1.0,794.0,794.0
0.027,6,10,1990,5,911,6.0,643.0,643.0,5,1079,6.0,811.0,811.0
0.007,17,2,299,1,65,0.0,37.0,37.0,1,234,0.0,206.0,206.0
0.017,6,10,1972,5,910,4.0,642.0,642.0,5,1062,4.0,794.0,794.0
0.015,6,10,1990,5,911,3.0,643.0,643.0,5,1079,3.0,811.0,811.0
0.008,6,10,1677,5,827,2.0,559.0,559.0,5,850,2.0,582.0,582.0
290.404,6,399,348468,199,21897,1466.0,2690.0,825.0,200,326571,1459.0,2769.0,1699.0
0.009,6,10,1990,5,911,2.0,643.0,643.0,5,1079,2.0,811.0,811.0
0.078,6,10,1506,5,395,17.0,127.0,127.0,5,1111,14.0,843.0,843.0
0.012,6,10,1983,5,910,2.0,642.0,642.0,5,1073,3.0,805.0,805.0
0.007,17,2,194,1,59,0.0,31.0,31.0,1,135,0.0,107.0,107.0
0.119,6,10,1506,5,395,24.0,127.0,127.0,5,1111,27.0,843.0,843.0
50.006,6,43,18208,22,12570,420.0,2720.0,1457.0,21,5638,2491.0,2667.0,435.0
0.02,6,10,1990,5,911,4.0,643.0,643.0,5,1079,4.0,811.0,811.0
0.006,6,10,1689,5,839,1.0,571.0,571.0,5,850,1.0,582.0,582.0
0.803,6,10,937,6,427,160.0,107.0,107.0,4,510,178.0,294.0,294.0
0.004,6,10,2006,5,927,1.0,659.0,659.0,5,1079,1.0,811.0,811.0
1778.96,6,304,97564,187,86463,9564.0,2804.0,679.0,117,11101,15335.0,452.0,68.0
0.005,6,10,2006,5,927,1.0,659.0,659.0,5,1079,1.0,811.0,811.0
0.005,6,10,2007,5,928,1.0,660.0,660.0,5,1079,1.0,811.0,811.0
0.005,6,10,2006,5,927,1.0,659.0,659.0,5,1079,1.0,811.0,811.0
0.103,6,10,1506,5,395,22.0,127.0,127.0,5,1111,24.0,843.0,843.0
0.104,6,10,1506,5,395,22.0,127.0,127.0,5,1111,22.0,843.0,843.0
0.006,6,10,1643,5,860,1.0,592.0,592.0,5,783,1.0,515.0,515.0
0.078,6,10,1506,5,395,17.0,127.0,127.0,5,1111,17.0,843.0,843.0
0.004,6,10,2006,5,927,1.0,659.0,659.0,5,1079,1.0,811.0,811.0
0.1,6,10,1506,5,395,22.0,127.0,127.0,5,1111,16.0,843.0,843.0
0.005,17,2,140,1,62,0.0,34.0,34.0,1,78,0.0,50.0,50.0
0.013,6,10,1972,5,910,3.0,642.0,642.0,5,1062,3.0,794.0,794.0
0.006,17,2,225,1,65,0.0,37.0,37.0,1,160,0.0,132.0,132.0
0.081,6,10,1506,5,395,13.0,127.0,127.0,5,1111,19.0,843.0,843.0
0.163,17,2,152,1,76,0.0,48.0,48.0,1,76,0.0,48.0,48.0
0.174,17,16,8809,8,6328,24.0,1350.0,763.0,8,2481,16.0,1350.0,282.0
240.125,6,46,6907,22,3222,11434.0,588.0,230.0,24,3685,10440.0,580.0,220.0
166.347,17,78,11037,39,2601,4377.0,44.0,38.0,39,8436,4377.0,239.0,188.0
0.094,6,10,1506,5,395,20.0,127.0,127.0,5,1111,22.0,843.0,843.0
178.532,17,78,11087,39,2608,4698.0,44.0,38.0,39,8479,4698.0,252.0,189.0
0.008,6,12,1926,6,1189,1.0,659.0,434.0,6,737,1.0,417.0,417.0
40.055,17,10,676,5,460,10012.0,104.0,64.0,5,216,10013.0,20.0,15.0
0.111,6,10,1506,5,395,24.0,127.0,127.0,5,1111,25.0,843.0,843.0
0.003,17,2,136,1,60,0.0,32.0,32.0,1,76,0.0,48.0,48.0
0.001,17,2,180,1,66,0.0,38.0,38.0,1,114,0.0,86.0,86.0
40.053,17,10,676,5,460,10012.0,104.0,64.0,5,216,10012.0,20.0,15.0
0.005,17,2,214,1,75,0.0,47.0,47.0,1,139,0.0,111.0,111.0
11.218,17,28,4422,14,1994,850.0,269.0,114.0,14,2428,850.0,587.0,145.0
0.011,6,10,1972,5,910,2.0,642.0,642.0,5,1062,2.0,794.0,794.0
0.009,6,10,1677,5,827,2.0,559.0,559.0,5,850,2.0,582.0,582.0
0.03,6,13,3735,7,497,4.0,125.0,125.0,6,3238,5.0,1470.0,1459.0
0.005,6,10,2007,5,928,1.0,660.0,660.0,5,1079,1.0,811.0,811.0
0.004,6,10,2006,5,927,1.0,659.0,659.0,5,1079,1.0,811.0,811.0
0.005,6,10,2007,5,928,1.0,660.0,660.0,5,1079,1.0,811.0,811.0
15.074,17,16,9104,8,7040,2149.0,1350.0,852.0,8,2064,2149.0,1350.0,230.0
0.01,6,10,1989,5,910,2.0,642.0,642.0,5,1079,2.0,811.0,811.0
57.755,6,36,8426,18,1955,519.0,887.0,401.0,18,6471,3389.0,2720.0,478.0
0.005,6,10,2006,5,927,1.0,659.0,659.0,5,1079,1.0,811.0,811.0
0.005,6,14,3742,7,452,0.0,80.0,80.0,7,3290,0.0,1448.0,972.0
10.735,17,28,4424,14,1995,817.0,270.0,114.0,14,2429,817.0,588.0,145.0
40.048,17,10,676,5,460,10010.0,104.0,64.0,5,216,10011.0,20.0,15.0
0.004,17,4,420,2,122,0.0,33.0,33.0,2,298,0.0,145.0,121.0
0.172,6,3,453,2,321,172.0,241.0,241.0,1,132,0.0,92.0,92.0
0.004,6,10,1702,5,863,0.0,595.0,595.0,5,839,1.0,571.0,571.0
0.008,17,2,238,1,66,0.0,38.0,38.0,1,172,0.0,144.0,144.0
0.111,6,10,1506,5,395,25.0,127.0,127.0,5,1111,25.0,843.0,843.0
0.067,17,8,3613,4,1874,22.0,1350.0,440.0,4,1739,11.0,1350.0,406.0
9.037,17,6,376,5,280,2259.0,28.0,28.0,1,96,0.0,68.0,68.0
0.101,6,10,1506,5,395,23.0,127.0,127.0,5,1111,19.0,843.0,843.0
0.012,6,10,1990,5,911,2.0,643.0,643.0,5,1079,3.0,811.0,811.0
0.005,6,10,2007,5,928,1.0,660.0,660.0,5,1079,1.0,811.0,811.0
0.009,6,10,1983,5,910,2.0,642.0,642.0,5,1073,2.0,805.0,805.0
0.011,6,10,1762,5,911,2.0,643.0,643.0,5,851,2.0,583.0,583.0
0.018,6,10,1989,5,910,4.0,642.0,642.0,5,1079,4.0,811.0,811.0
0.004,6,10,2007,5,928,1.0,660.0,660.0,5,1079,1.0,811.0,811.0
0.072,17,8,3613,4,1874,24.0,1350.0,440.0,4,1739,12.0,1350.0,406.0
0.005,6,10,1989,5,927,1.0,659.0,659.0,5,1062,1.0,794.0,794.0
0.006,6,10,2007,5,928,1.0,660.0,660.0,5,1079,1.0,811.0,811.0
0.011,6,10,1762,5,911,2.0,643.0,643.0,5,851,2.0,583.0,583.0
0.005,17,2,213,1,69,0.0,41.0,41.0,1,144,0.0,116.0,116.0
0.002,17,2,136,1,60,0.0,32.0,32.0,1,76,0.0,48.0,48.0
0.111,6,10,1506,5,395,24.0,127.0,127.0,5,1111,25.0,843.0,843.0
0.098,6,10,1506,5,395,19.0,127.0,127.0,5,1111,20.0,843.0,843.0
0.005,6,10,2006,5,927,1.0,659.0,659.0,5,1079,1.0,811.0,811.0
0.001,17,2,166,1,75,0.0,47.0,47.0,1,91,0.0,63.0,63.0
0.087,6,10,1506,5,395,16.0,127.0,127.0,5,1111,20.0,843.0,843.0
0.005,6,10,2007,5,928,1.0,660.0,660.0,5,1079,1.0,811.0,811.0
0.011,6,10,1983,5,910,2.0,642.0,642.0,5,1073,2.0,805.0,805.0
10.775,17,28,4422,14,1993,820.0,268.0,114.0,14,2429,820.0,588.0,145.0
0.04,17,2,152,1,76,0.0,48.0,48.0,1,76,0.0,48.0,48.0
0.005,6,10,2000,5,927,1.0,659.0,659.0,5,1073,1.0,805.0,805.0
0.067,6,10,1506,5,395,16.0,127.0,127.0,5,1111,15.0,843.0,843.0
0.009,6,10,1989,5,910,2.0,642.0,642.0,5,1079,2.0,811.0,811.0
0.011,6,10,1989,5,910,2.0,642.0,642.0,5,1079,2.0,811.0,811.0
0.003,17,2,148,1,60,0.0,32.0,32.0,1,88,0.0,60.0,60.0
0.091,6,10,1506,5,395,21.0,127.0,127.0,5,1111,20.0,843.0,843.0
0.024,6,10,1990,5,911,5.0,643.0,643.0,5,1079,6.0,811.0,811.0
0.006,6,10,1547,5,764,1.0,496.0,496.0,5,783,1.0,515.0,515.0
0.017,6,10,1989,5,910,4.0,642.0,642.0,5,1079,4.0,811.0,811.0
0.098,6,10,1506,5,395,23.0,127.0,127.0,5,1111,21.0,843.0,843.0
40.072,17,10,676,5,460,10017.0,104.0,64.0,5,216,10017.0,20.0,15.0
0.005,6,10,2000,5,927,1.0,659.0,659.0,5,1073,1.0,805.0,805.0
0.008,6,10,1983,5,910,2.0,642.0,642.0,5,1073,2.0,805.0,805.0
0.005,17,2,164,1,74,0.0,46.0,46.0,1,90,0.0,62.0,62.0
0.005,6,10,2007,5,928,1.0,660.0,660.0,5,1079,1.0,811.0,811.0
0.11,6,10,1506,5,395,23.0,127.0,127.0,5,1111,20.0,843.0,843.0
0.003,17,2,136,1,60,0.0,32.0,32.0,1,76,0.0,48.0,48.0
10.878,17,28,4418,14,1994,827.0,269.0,114.0,14,2424,827.0,587.0,145.0
0.004,17,4,284,2,120,0.0,32.0,32.0,2,164,1.0,60.0,54.0
0.005,17,2,225,1,65,0.0,37.0,37.0,1,160,0.0,132.0,132.0
0.005,6,10,1989,5,927,1.0,659.0,659.0,5,1062,1.0,794.0,794.0
0.037,17,4,284,2,120,0.0,32.0,32.0,2,164,34.0,60.0,54.0
0.037,17,2,186,1,61,0.0,33.0,33.0,1,125,0.0,97.0,97.0
0.142,6,10,1506,5,395,32.0,127.0,127.0,5,1111,31.0,843.0,843.0
0.038,6,10,1990,5,911,9.0,643.0,643.0,5,1079,9.0,811.0,811.0
0.013,6,10,1989,5,910,3.0,642.0,642.0,5,1079,3.0,811.0,811.0
334.396,17,20,1124,10,716,37140.0,48.0,43.0,10,408,37140.0,20.0,12.0
0.011,6,10,1989,5,910,2.0,642.0,642.0,5,1079,2.0,811.0,811.0
0.005,6,10,2006,5,927,1.0,659.0,659.0,5,1079,1.0,811.0,811.0
0.027,6,10,1989,5,910,6.0,642.0,642.0,5,1079,6.0,811.0,811.0
0.013,6,10,1983,5,910,3.0,642.0,642.0,5,1073,3.0,805.0,805.0
0.006,6,10,1689,5,839,1.0,571.0,571.0,5,850,1.0,582.0,582.0
0.01,6,10,1689,5,839,2.0,571.0,571.0,5,850,2.0,582.0,582.0
0.005,6,10,2007,5,928,1.0,660.0,660.0,5,1079,1.0,811.0,811.0
0.06,17,2,152,1,76,0.0,48.0,48.0,1,76,0.0,48.0,48.0
0.013,6,10,2006,5,927,3.0,659.0,659.0,5,1079,3.0,811.0,811.0
0.006,6,10,2006,5,927,1.0,659.0,659.0,5,1079,1.0,811.0,811.0
0.006,6,10,1547,5,764,1.0,496.0,496.0,5,783,1.0,515.0,515.0
0.018,6,10,1990,5,911,4.0,643.0,643.0,5,1079,4.0,811.0,811.0
0.004,6,10,2006,5,927,1.0,659.0,659.0,5,1079,1.0,811.0,811.0
0.005,17,2,170,1,65,0.0,37.0,37.0,1,105,0.0,77.0,77.0
0.004,17,2,136,1,60,0.0,32.0,32.0,1,76,0.0,48.0,48.0
40.064,17,10,676,5,460,10014.0,104.0,64.0,5,216,10015.0,20.0,15.0
0.005,6,10,2007,5,928,1.0,660.0,660.0,5,1079,1.0,811.0,811.0
0.005,6,10,2007,5,928,1.0,660.0,660.0,5,1079,1.0,811.0,811.0
0.023,6,12,1926,6,1189,4.0,659.0,434.0,6,737,4.0,417.0,417.0
172.103,17,80,11360,40,2666,4412.0,44.0,38.0,40,8694,4412.0,239.0,189.0
0.006,17,2,180,1,66,0.0,38.0,38.0,1,114,0.0,86.0,86.0
0.004,17,2,148,1,60,0.0,32.0,32.0,1,88,0.0,60.0,60.0
0.005,6,10,1989,5,927,1.0,659.0,659.0,5,1062,1.0,794.0,794.0
0.004,17,2,166,1,75,0.0,47.0,47.0,1,91,0.0,63.0,63.0
0.006,6,10,1547,5,764,1.0,496.0,496.0,5,783,1.0,515.0,515.0
1779.227,17,140,44240,72,22752,25049.0,288.0,288.0,68,21488,26555.0,288.0,288.0
0.006,6,10,1547,5,764,1.0,496.0,496.0,5,783,1.0,515.0,515.0
0.088,6,10,1506,5,395,19.0,127.0,127.0,5,1111,21.0,843.0,843.0
0.015,6,10,1677,5,827,3.0,559.0,559.0,5,850,3.0,582.0,582.0
0.011,6,10,1990,5,911,2.0,643.0,643.0,5,1079,2.0,811.0,811.0
40.048,17,10,676,5,460,10011.0,104.0,64.0,5,216,10011.0,20.0,15.0
0.079,6,10,1506,5,395,18.0,127.0,127.0,5,1111,14.0,843.0,843.0
0.005,17,2,170,1,65,0.0,37.0,37.0,1,105,0.0,77.0,77.0
0.01,6,10,1989,5,910,2.0,642.0,642.0,5,1079,2.0,811.0,811.0
240.098,6,16,4481,9,963,30012.0,238.0,166.0,7,3518,40015.0,1402.0,786.0
0.092,6,10,1506,5,395,22.0,127.0,127.0,5,1111,22.0,843.0,843.0
0.076,6,10,1506,5,395,17.0,127.0,127.0,5,1111,18.0,843.0,843.0
11.037,17,28,4400,14,2313,840.0,588.0,137.0,14,2087,840.0,270.0,121.0
0.072,6,10,1506,5,395,15.0,127.0,127.0,5,1111,14.0,843.0,843.0
0.006,17,2,170,1,65,0.0,37.0,37.0,1,105,0.0,77.0,77.0
0.009,6,10,1989,5,910,2.0,642.0,642.0,5,1079,2.0,811.0,811.0
0.205,6,16,2777,8,1395,29.0,533.0,323.0,8,1382,18.0,529.0,239.0
0.004,6,10,1989,5,927,1.0,659.0,659.0,5,1062,1.0,794.0,794.0
0.0,17,2,136,1,60,0.0,32.0,32.0,1,76,0.0,48.0,48.0
0.006,6,10,1854,5,889,1.0,621.0,621.0,5,965,1.0,697.0,697.0
0.006,17,2,230,1,68,0.0,40.0,40.0,1,162,0.0,134.0,134.0
0.003,17,2,148,1,60,0.0,32.0,32.0,1,88,0.0,60.0,60.0
0.005,17,2,179,1,71,0.0,43.0,43.0,1,108,0.0,80.0,80.0
0.001,17,2,136,1,60,0.0,32.0,32.0,1,76,0.0,48.0,48.0
0.001,17,2,180,1,66,0.0,38.0,38.0,1,114,0.0,86.0,86.0
0.006,17,2,282,1,69,0.0,41.0,41.0,1,213,0.0,185.0,185.0
1760.72,6,456,68132,264,36894,6694.0,613.0,196.0,192,31238,9217.0,469.0,145.0
0.009,6,10,1762,5,911,2.0,643.0,643.0,5,851,2.0,583.0,583.0
0.169,17,2,152,1,76,0.0,48.0,48.0,1,76,0.0,48.0,48.0
0.008,6,12,1926,6,1189,1.0,659.0,434.0,6,737,1.0,417.0,417.0
0.014,6,10,1983,5,910,3.0,642.0,642.0,5,1073,3.0,805.0,805.0
0.013,6,10,1762,5,911,3.0,643.0,643.0,5,851,3.0,583.0,583.0
0.005,17,2,170,1,65,0.0,37.0,37.0,1,105,0.0,77.0,77.0
0.086,6,10,1506,5,395,20.0,127.0,127.0,5,1111,16.0,843.0,843.0
1757.711,6,436,64684,252,35168,7002.0,613.0,197.0,184,29516,9604.0,453.0,142.0
0.099,6,10,1506,5,395,21.0,127.0,127.0,5,1111,21.0,843.0,843.0
0.009,6,10,1972,5,910,2.0,642.0,642.0,5,1062,2.0,794.0,794.0
0.01,6,14,3787,7,497,1.0,125.0,125.0,7,3290,1.0,1448.0,972.0
0.004,6,10,2007,5,928,1.0,660.0,660.0,5,1079,1.0,811.0,811.0
0.005,6,10,1689,5,839,1.0,571.0,571.0,5,850,1.0,582.0,582.0
0.017,6,13,3735,7,497,2.0,125.0,125.0,6,3238,3.0,1470.0,1459.0
0.008,6,12,1926,6,1189,1.0,659.0,434.0,6,737,1.0,417.0,417.0
0.011,6,10,1989,5,910,2.0,642.0,642.0,5,1079,2.0,811.0,811.0
0.004,6,10,1989,5,927,1.0,659.0,659.0,5,1062,1.0,794.0,794.0
240.934,6,28,9629,15,1791,17209.0,417.0,247.0,13,7838,20073.0,2804.0,1020.0
264.959,6,28,9512,15,2606,18925.0,676.0,363.0,13,6906,22079.0,1402.0,890.0
0.236,17,44,27897,26,24790,9.0,1350.0,925.0,18,3107,10.0,1350.0,144.0
0.005,6,10,2007,5,928,1.0,660.0,660.0,5,1079,1.0,811.0,811.0
0.017,6,10,1989,5,910,4.0,642.0,642.0,5,1079,4.0,811.0,811.0
0.074,6,10,1506,5,395,16.0,127.0,127.0,5,1111,17.0,843.0,843.0
0.005,6,10,1854,5,889,1.0,621.0,621.0,5,965,1.0,697.0,697.0
0.009,6,10,1972,5,910,2.0,642.0,642.0,5,1062,2.0,794.0,794.0
0.003,17,2,136,1,60,0.0,32.0,32.0,1,76,0.0,48.0,48.0
0.019,6,10,1972,5,910,4.0,642.0,642.0,5,1062,4.0,794.0,794.0
40.062,17,10,676,5,460,10014.0,104.0,64.0,5,216,10014.0,20.0,15.0
1770.306,6,83,4368,42,2210,43177.0,26.0,26.0,41,2158,44256.0,26.0,26.0
0.007,6,10,1989,5,910,1.0,642.0,642.0,5,1079,1.0,811.0,811.0
0.031,17,4,284,2,120,0.0,32.0,32.0,2,164,1.0,60.0,54.0
1773.378,6,309,98005,189,86504,9432.0,2001.0,690.0,120,11501,14902.0,452.0,70.0
0.001,17,2,180,1,66,0.0,38.0,38.0,1,114,0.0,86.0,86.0
0.005,6,10,2006,5,927,1.0,659.0,659.0,5,1079,1.0,811.0,811.0
0.043,17,2,170,1,65,0.0,37.0,37.0,1,105,0.0,77.0,77.0
0.015,6,10,1972,5,910,3.0,642.0,642.0,5,1062,3.0,794.0,794.0
367.047,6,22,2313,16,867,24469.0,195.0,195.0,6,1446,4641.0,419.0,398.0
300.099,6,19,4660,11,1102,30009.0,238.0,130.0,8,3558,42870.0,1402.0,786.0
1772.124,6,105,6270,60,3525,30035.0,27.0,27.0,45,2745,40274.0,27.0,27.0
0.02,6,10,1989,5,910,5.0,642.0,642.0,5,1079,5.0,811.0,811.0
0.01,6,10,1989,5,910,2.0,642.0,642.0,5,1079,2.0,811.0,811.0
0.08,6,10,1506,5,395,17.0,127.0,127.0,5,1111,17.0,843.0,843.0
0.005,6,13,3747,7,509,0.0,137.0,137.0,6,3238,1.0,1470.0,1459.0
0.001,17,2,180,1,66,0.0,38.0,38.0,1,114,0.0,86.0,86.0
0.001,17,2,180,1,66,0.0,38.0,38.0,1,114,0.0,86.0,86.0
0.006,6,10,1547,5,764,1.0,496.0,496.0,5,783,1.0,515.0,515.0
0.217,6,16,2777,8,1395,31.0,533.0,323.0,8,1382,19.0,529.0,239.0
0.153,6,10,1506,5,395,36.0,127.0,127.0,5,1111,30.0,843.0,843.0
40.107,17,10,676,5,460,10018.0,104.0,64.0,5,216,10024.0,20.0,15.0
0.118,17,4,352,2,130,47.0,37.0,37.0,2,222,79.0,89.0,83.0
0.011,6,10,1990,5,911,2.0,643.0,643.0,5,1079,2.0,811.0,811.0
0.005,6,10,1854,5,889,1.0,621.0,621.0,5,965,1.0,697.0,697.0
0.005,6,13,3747,7,509,0.0,137.0,137.0,6,3238,1.0,1470.0,1459.0
169.373,17,82,11747,41,2735,4234.0,44.0,38.0,41,9012,4234.0,261.0,191.0
0.04,17,2,148,1,60,0.0,32.0,32.0,1,88,0.0,60.0,60.0
0.004,6,10,2007,5,928,1.0,660.0,660.0,5,1079,1.0,811.0,811.0
0.01,6,10,1990,5,911,2.0,643.0,643.0,5,1079,2.0,811.0,811.0
0.005,6,10,2006,5,927,1.0,659.0,659.0,5,1079,1.0,811.0,811.0
0.013,6,10,1989,5,910,3.0,642.0,642.0,5,1079,3.0,811.0,811.0
172.224,17,72,10098,36,2394,4920.0,44.0,38.0,36,7704,4920.0,261.0,186.0
0.011,6,10,1989,5,910,2.0,642.0,642.0,5,1079,2.0,811.0,811.0
11.188,17,28,4398,14,2312,850.0,587.0,137.0,14,2086,851.0,269.0,121.0
0.007,17,2,194,1,59,0.0,31.0,31.0,1,135,0.0,107.0,107.0
0.005,17,2,140,1,62,0.0,34.0,34.0,1,78,0.0,50.0,50.0
0.008,6,10,1983,5,910,2.0,642.0,642.0,5,1073,1.0,805.0,805.0
0.168,6,10,1506,5,395,41.0,127.0,127.0,5,1111,38.0,843.0,843.0
0.005,6,10,1774,5,923,1.0,655.0,655.0,5,851,1.0,583.0,583.0
0.04,17,4,336,2,124,1.0,34.0,34.0,2,212,1.0,84.0,78.0
0.005,6,10,1689,5,839,1.0,571.0,571.0,5,850,1.0,582.0,582.0
0.006,6,10,1643,5,860,1.0,592.0,592.0,5,783,1.0,515.0,515.0
0.012,6,10,1989,5,910,3.0,642.0,642.0,5,1079,3.0,811.0,811.0
0.003,17,2,148,1,60,0.0,32.0,32.0,1,88,0.0,60.0,60.0
0.005,17,2,169,1,62,0.0,34.0,34.0,1,107,0.0,79.0,79.0
300.488,6,16,2170,9,684,37540.0,146.0,146.0,7,1486,50054.0,419.0,398.0
40.06,17,10,676,5,460,10014.0,104.0,64.0,5,216,10014.0,20.0,15.0
0.004,6,10,2000,5,927,1.0,659.0,659.0,5,1073,1.0,805.0,805.0
0.149,6,10,1506,5,395,35.0,127.0,127.0,5,1111,34.0,843.0,843.0
0.006,6,10,1547,5,764,1.0,496.0,496.0,5,783,1.0,515.0,515.0
40.05,17,10,676,5,460,10011.0,104.0,64.0,5,216,10011.0,20.0,15.0
0.067,6,10,1506,5,395,14.0,127.0,127.0,5,1111,14.0,843.0,843.0
0.014,6,10,1989,5,910,3.0,642.0,642.0,5,1079,3.0,811.0,811.0
309.116,17,20,1124,10,716,34328.0,48.0,43.0,10,408,34330.0,20.0,12.0
40.061,17,10,676,5,460,10014.0,104.0,64.0,5,216,10014.0,20.0,15.0
0.001,17,2,180,1,66,0.0,38.0,38.0,1,114,0.0,86.0,86.0
0.07,6,10,1506,5,395,15.0,127.0,127.0,5,1111,15.0,843.0,843.0
0.014,6,10,1677,5,827,3.0,559.0,559.0,5,850,3.0,582.0,582.0
0.007,17,2,148,1,60,0.0,32.0,32.0,1,88,0.0,60.0,60.0
0.005,6,10,2006,5,927,1.0,659.0,659.0,5,1079,1.0,811.0,811.0
0.006,17,2,164,1,74,0.0,46.0,46.0,1,90,0.0,62.0,62.0
0.013,6,10,1631,5,848,3.0,580.0,580.0,5,783,3.0,515.0,515.0
0.018,6,10,1983,5,910,4.0,642.0,642.0,5,1073,4.0,805.0,805.0
0.012,6,10,1631,5,848,3.0,580.0,580.0,5,783,3.0,515.0,515.0
0.117,6,10,1506,5,395,22.0,127.0,127.0,5,1111,28.0,843.0,843.0
0.006,6,10,1854,5,889,1.0,621.0,621.0,5,965,1.0,697.0,697.0
0.005,6,13,3747,7,509,0.0,137.0,137.0,6,3238,0.0,1470.0,1459.0
0.025,6,10,1983,5,910,6.0,642.0,642.0,5,1073,6.0,805.0,805.0
0.065,6,10,1506,5,395,14.0,127.0,127.0,5,1111,14.0,843.0,843.0
0.011,6,10,1989,5,910,2.0,642.0,642.0,5,1079,2.0,811.0,811.0
0.009,6,10,1989,5,910,2.0,642.0,642.0,5,1079,2.0,811.0,811.0
0.008,6,10,1990,5,911,2.0,643.0,643.0,5,1079,2.0,811.0,811.0
0.009,17,2,164,1,74,0.0,46.0,46.0,1,90,0.0,62.0,62.0
0.053,6,10,1972,5,910,13.0,642.0,642.0,5,1062,13.0,794.0,794.0
0.005,17,2,230,1,68,0.0,40.0,40.0,1,162,0.0,134.0,134.0
0.006,6,10,1854,5,889,1.0,621.0,621.0,5,965,1.0,697.0,697.0
240.09,6,16,4480,9,963,30011.0,238.0,166.0,7,3517,40014.0,1402.0,786.0
0.005,17,2,164,1,74,0.0,46.0,46.0,1,90,0.0,62.0,62.0
47.39,6,35,7950,17,2432,549.0,1367.0,573.0,18,5518,2777.0,2667.0,435.0
0.013,6,10,1631,5,848,3.0,580.0,580.0,5,783,3.0,515.0,515.0
126.055,6,14,2938,8,2504,17973.0,1414.0,1086.0,6,434,25163.0,182.0,182.0
0.001,17,2,136,1,60,0.0,32.0,32.0,1,76,0.0,48.0,48.0
0.009,6,10,1631,5,848,2.0,580.0,580.0,5,783,2.0,515.0,515.0
0.006,6,10,1854,5,889,1.0,621.0,621.0,5,965,1.0,697.0,697.0
0.012,17,2,138,1,61,0.0,33.0,33.0,1,77,0.0,49.0,49.0
0.012,6,10,1972,5,910,3.0,642.0,642.0,5,1062,3.0,794.0,794.0
0.037,17,2,136,1,60,0.0,32.0,32.0,1,76,0.0,48.0,48.0
154.916,6,21,8143,11,1985,79.0,1174.0,504.0,10,6158,17194.0,2720.0,957.0
0.007,6,10,1779,5,928,1.0,660.0,660.0,5,851,1.0,583.0,583.0
40.036,17,10,676,5,460,10006.0,104.0,64.0,5,216,10007.0,20.0,15.0
0.006,6,10,1643,5,860,1.0,592.0,592.0,5,783,1.0,515.0,515.0
0.776,6,10,2009,6,1655,155.0,1403.0,1403.0,4,354,179.0,182.0,182.0
0.004,6,10,2007,5,928,1.0,660.0,660.0,5,1079,1.0,811.0,811.0
0.013,6,10,1989,5,910,3.0,642.0,642.0,5,1079,3.0,811.0,811.0
0.006,6,10,1547,5,764,1.0,496.0,496.0,5,783,1.0,515.0,515.0
0.023,6,10,1972,5,910,5.0,642.0,642.0,5,1062,5.0,794.0,794.0
0.004,17,4,284,2,120,0.0,32.0,32.0,2,164,0.0,60.0,54.0
0.013,17,2,144,1,64,0.0,36.0,36.0,1,80,0.0,52.0,52.0
412.0,6,29,4409,12,3102,10911.0,494.0,494.0,17,1307,25749.0,83.0,83.0
0.003,17,2,136,1,60,0.0,32.0,32.0,1,76,0.0,48.0,48.0
163.287,17,86,12563,43,2897,3887.0,44.0,39.0,43,9666,3887.0,239.0,196.0
0.005,17,2,148,1,60,0.0,32.0,32.0,1,88,0.0,60.0,60.0
0.11,6,10,1506,5,395,24.0,127.0,127.0,5,1111,24.0,843.0,843.0
300.792,6,39,8965,21,3402,15039.0,2134.0,629.0,18,5563,507.0,2667.0,402.0
320.04,17,18,1008,9,640,39988.0,48.0,43.0,9,368,39988.0,20.0,12.0
0.008,6,10,1983,5,910,2.0,642.0,642.0,5,1073,2.0,805.0,805.0
0.155,6,10,1506,5,395,37.0,127.0,127.0,5,1111,33.0,843.0,843.0
0.12,17,16,9883,7,3597,15.0,1350.0,485.0,9,6286,11.0,1350.0,670.0
0.013,6,10,1990,5,911,3.0,643.0,643.0,5,1079,3.0,811.0,811.0
0.005,6,10,1989,5,927,1.0,659.0,659.0,5,1062,1.0,794.0,794.0
0.005,6,10,1547,5,764,1.0,496.0,496.0,5,783,1.0,515.0,515.0
0.005,6,10,1854,5,889,1.0,621.0,621.0,5,965,1.0,697.0,697.0
0.003,17,2,148,1,60,0.0,32.0,32.0,1,88,0.0,60.0,60.0
0.005,6,15,3794,8,504,0.0,80.0,80.0,7,3290,0.0,1448.0,972.0
0.005,6,10,1779,5,928,1.0,660.0,660.0,5,851,1.0,583.0,583.0
0.005,6,10,2006,5,927,1.0,659.0,659.0,5,1079,1.0,811.0,811.0
0.004,6,10,2006,5,927,1.0,659.0,659.0,5,1079,1.0,811.0,811.0
0.005,6,10,1989,5,927,1.0,659.0,659.0,5,1062,1.0,794.0,794.0
292.257,6,411,348371,214,22683,1372.0,2736.0,889.0,197,325688,1491.0,2769.0,1723.0
0.091,6,10,1506,5,395,21.0,127.0,127.0,5,1111,21.0,843.0,843.0
0.005,6,10,2006,5,927,1.0,659.0,659.0,5,1079,1.0,811.0,811.0
0.005,17,2,169,1,62,0.0,34.0,34.0,1,107,0.0,79.0,79.0
0.276,17,4,596,2,122,150.0,33.0,33.0,2,474,239.0,323.0,209.0
0.005,6,10,2000,5,927,1.0,659.0,659.0,5,1073,1.0,805.0,805.0
240.368,6,43,5536,22,2541,11446.0,588.0,196.0,21,2995,12018.0,580.0,236.0
0.009,6,10,1989,5,910,2.0,642.0,642.0,5,1079,2.0,811.0,811.0
10.826,17,28,4422,14,1993,823.0,268.0,114.0,14,2429,823.0,588.0,145.0
0.004,6,10,2006,5,927,1.0,659.0,659.0,5,1079,1.0,811.0,811.0
19.653,6,45,16095,23,10188,410.0,2282.0,1154.0,22,5907,927.0,2667.0,385.0
0.037,17,2,148,1,60,0.0,32.0,32.0,1,88,0.0,60.0,60.0
0.072,6,10,1506,5,395,15.0,127.0,127.0,5,1111,16.0,843.0,843.0
0.011,17,2,170,1,65,0.0,37.0,37.0,1,105,0.0,77.0,77.0
300.934,6,33,10373,18,2887,17702.0,799.0,388.0,15,7486,17206.0,1402.0,744.0
0.005,6,10,2006,5,927,1.0,659.0,659.0,5,1079,1.0,811.0,811.0
0.013,6,10,1990,5,911,3.0,643.0,643.0,5,1079,3.0,811.0,811.0
0.067,6,10,1506,5,395,15.0,127.0,127.0,5,1111,15.0,843.0,843.0
0.08,6,10,1506,5,395,19.0,127.0,127.0,5,1111,17.0,843.0,843.0
0.011,6,10,1990,5,911,2.0,643.0,643.0,5,1079,2.0,811.0,811.0
0.011,6,10,1631,5,848,2.0,580.0,580.0,5,783,2.0,515.0,515.0
0.005,6,13,3747,7,509,0.0,137.0,137.0,6,3238,0.0,1470.0,1459.0
241.268,6,297,342578,121,17802,2010.0,2736.0,885.0,176,324776,1378.0,2804.0,1901.0
178.129,17,92,13482,46,3063,3956.0,44.0,38.0,46,10419,3958.0,261.0,198.0
0.017,6,10,1989,5,910,4.0,642.0,642.0,5,1079,4.0,811.0,811.0
0.011,6,13,3735,7,497,1.0,125.0,125.0,6,3238,2.0,1470.0,1459.0
0.039,17,2,170,1,65,0.0,37.0,37.0,1,105,0.0,77.0,77.0
2.567,6,23,6109,13,1978,213.0,517.0,258.0,10,4131,272.0,1288.0,720.0
0.009,6,10,1972,5,910,2.0,642.0,642.0,5,1062,2.0,794.0,794.0
0.006,6,10,1854,5,889,1.0,621.0,621.0,5,965,1.0,697.0,697.0
0.1,6,10,1506,5,395,23.0,127.0,127.0,5,1111,21.0,843.0,843.0
361.83,6,21,1793,16,1030,24122.0,190.0,190.0,5,763,60011.0,462.0,247.0
0.005,6,10,2006,5,927,1.0,659.0,659.0,5,1079,1.0,811.0,811.0
0.003,17,2,148,1,60,0.0,32.0,32.0,1,88,0.0,60.0,60.0
0.067,17,8,3613,4,1874,22.0,1350.0,440.0,4,1739,12.0,1350.0,406.0
40.062,17,10,676,5,460,10014.0,104.0,64.0,5,216,10014.0,20.0,15.0
0.107,6,10,1506,5,395,24.0,127.0,127.0,5,1111,25.0,843.0,843.0
0.013,6,10,1972,5,910,3.0,642.0,642.0,5,1062,3.0,794.0,794.0
0.01,6,10,1989,5,910,2.0,642.0,642.0,5,1079,2.0,811.0,811.0
0.071,6,10,1506,5,395,15.0,127.0,127.0,5,1111,15.0,843.0,843.0
0.012,6,10,1990,5,911,3.0,643.0,643.0,5,1079,3.0,811.0,811.0
0.129,6,10,1506,5,395,30.0,127.0,127.0,5,1111,27.0,843.0,843.0
0.004,17,2,170,1,65,0.0,37.0,37.0,1,105,0.0,77.0,77.0
0.008,6,12,1926,6,1189,1.0,659.0,434.0,6,737,1.0,417.0,417.0
0.004,6,10,2006,5,927,1.0,659.0,659.0,5,1079,1.0,811.0,811.0
240.131,6,30,7013,15,4690,17151.0,1368.0,487.0,15,2323,17151.0,580.0,191.0
0.004,6,10,1989,5,927,1.0,659.0,659.0,5,1062,1.0,794.0,794.0
139.649,6,36,9704,19,4226,7758.0,1753.0,858.0,17,5478,538.0,2667.0,435.0
0.005,6,13,3747,7,509,0.0,137.0,137.0,6,3238,1.0,1470.0,1459.0
0.01,6,10,1983,5,910,2.0,642.0,642.0,5,1073,2.0,805.0,805.0
0.041,17,2,152,1,76,0.0,48.0,48.0,1,76,0.0,48.0,48.0
0.005,17,2,144,1,64,0.0,36.0,36.0,1,80,0.0,52.0,52.0
40.059,17,10,676,5,460,10014.0,104.0,64.0,5,216,10014.0,20.0,15.0
0.007,6,10,1989,5,927,1.0,659.0,659.0,5,1062,1.0,794.0,794.0
0.116,6,10,1506,5,395,26.0,127.0,127.0,5,1111,28.0,843.0,843.0
0.006,6,10,1689,5,839,1.0,571.0,571.0,5,850,1.0,582.0,582.0
0.014,6,10,1990,5,911,3.0,643.0,643.0,5,1079,3.0,811.0,811.0
0.006,6,10,2006,5,927,1.0,659.0,659.0,5,1079,1.0,811.0,811.0
0.074,6,10,1506,5,395,16.0,127.0,127.0,5,1111,16.0,843.0,843.0
0.006,6,10,1689,5,839,1.0,571.0,571.0,5,850,1.0,582.0,582.0
0.149,6,10,1506,5,395,36.0,127.0,127.0,5,1111,35.0,843.0,843.0
0.01,6,10,1989,5,910,2.0,642.0,642.0,5,1079,2.0,811.0,811.0
0.128,6,10,1506,5,395,31.0,127.0,127.0,5,1111,28.0,843.0,843.0
40.051,17,10,676,5,460,10011.0,104.0,64.0,5,216,10012.0,20.0,15.0
40.068,17,10,676,5,460,10013.0,104.0,64.0,5,216,10016.0,20.0,15.0
0.014,6,10,1990,5,911,3.0,643.0,643.0,5,1079,3.0,811.0,811.0
0.072,6,10,1506,5,395,17.0,127.0,127.0,5,1111,16.0,843.0,843.0
0.011,6,10,1989,5,910,2.0,642.0,642.0,5,1079,2.0,811.0,811.0
0.123,6,10,1506,5,395,25.0,127.0,127.0,5,1111,29.0,843.0,843.0
1770.834,6,81,4264,41,2158,44269.0,26.0,26.0,40,2106,45404.0,26.0,26.0
240.274,6,42,8719,21,5686,12013.0,1515.0,509.0,21,3033,12013.0,580.0,241.0
0.323,17,45,26685,26,23470,12.0,1350.0,874.0,19,3215,15.0,1350.0,141.0
40.067,17,10,676,5,460,10014.0,104.0,64.0,5,216,10016.0,20.0,15.0
0.077,6,10,1506,5,395,17.0,127.0,127.0,5,1111,17.0,843.0,843.0
0.005,6,10,2006,5,927,1.0,659.0,659.0,5,1079,1.0,811.0,811.0
0.003,17,4,284,2,120,0.0,32.0,32.0,2,164,0.0,60.0,54.0
10.824,17,28,4419,14,1995,824.0,270.0,114.0,14,2424,824.0,587.0,145.0
0.063,6,10,1506,5,395,15.0,127.0,127.0,5,1111,13.0,843.0,843.0
0.005,6,10,2007,5,928,1.0,660.0,660.0,5,1079,1.0,811.0,811.0
0.006,6,10,1547,5,764,1.0,496.0,496.0,5,783,1.0,515.0,515.0
0.005,6,10,1989,5,927,1.0,659.0,659.0,5,1062,1.0,794.0,794.0
0.005,17,2,180,1,66,0.0,38.0,38.0,1,114,0.0,86.0,86.0
0.215,6,16,2777,8,1395,30.0,533.0,323.0,8,1382,19.0,529.0,239.0
308.442,17,20,1124,10,716,34257.0,48.0,43.0,10,408,34257.0,20.0,12.0
0.01,6,10,1972,5,910,2.0,642.0,642.0,5,1062,2.0,794.0,794.0
0.077,6,10,1506,5,395,16.0,127.0,127.0,5,1111,18.0,843.0,843.0
0.096,6,10,1506,5,395,20.0,127.0,127.0,5,1111,22.0,843.0,843.0
0.099,6,10,1506,5,395,22.0,127.0,127.0,5,1111,21.0,843.0,843.0
0.167,17,2,152,1,76,0.0,48.0,48.0,1,76,0.0,48.0,48.0
40.062,17,10,676,5,460,10010.0,104.0,64.0,5,216,10013.0,20.0,15.0
40.084,17,10,676,5,460,10020.0,104.0,64.0,5,216,10020.0,20.0,15.0
0.013,6,10,1989,5,910,3.0,642.0,642.0,5,1079,3.0,811.0,811.0
0.115,6,10,1506,5,395,23.0,127.0,127.0,5,1111,24.0,843.0,843.0
0.003,17,4,284,2,120,0.0,32.0,32.0,2,164,0.0,60.0,54.0
0.011,6,10,1990,5,911,2.0,643.0,643.0,5,1079,2.0,811.0,811.0
0.076,6,10,1506,5,395,16.0,127.0,127.0,5,1111,15.0,843.0,843.0
0.017,6,10,1990,5,911,4.0,643.0,643.0,5,1079,4.0,811.0,811.0
0.005,6,10,2006,5,927,1.0,659.0,659.0,5,1079,1.0,811.0,811.0
0.005,6,10,2006,5,927,1.0,659.0,659.0,5,1079,1.0,811.0,811.0
0.06,17,2,152,1,76,0.0,48.0,48.0,1,76,0.0,48.0,48.0
0.09,6,10,1506,5,395,20.0,127.0,127.0,5,1111,20.0,843.0,843.0
0.01,6,10,1990,5,911,2.0,643.0,643.0,5,1079,2.0,811.0,811.0
0.005,6,10,2006,5,927,1.0,659.0,659.0,5,1079,1.0,811.0,811.0
1778.449,17,142,44872,72,22752,25047.0,288.0,288.0,70,22120,25773.0,288.0,288.0
40.058,17,10,676,5,460,10013.0,104.0,64.0,5,216,10013.0,20.0,15.0
0.011,6,10,1983,5,910,2.0,642.0,642.0,5,1073,2.0,805.0,805.0
0.017,6,10,1677,5,827,4.0,559.0,559.0,5,850,4.0,582.0,582.0
0.116,6,10,1506,5,395,26.0,127.0,127.0,5,1111,24.0,843.0,843.0
0.005,6,10,2006,5,927,1.0,659.0,659.0,5,1079,1.0,811.0,811.0
0.108,17,2,80,1,32,0.0,4.0,4.0,1,48,0.0,20.0,20.0
0.009,6,10,1989,5,910,2.0,642.0,642.0,5,1079,2.0,811.0,811.0
0.005,6,10,1989,5,927,1.0,659.0,659.0,5,1062,1.0,794.0,794.0
0.009,6,10,1983,5,910,2.0,642.0,642.0,5,1073,2.0,805.0,805.0
0.006,17,2,169,1,62,0.0,34.0,34.0,1,107,0.0,79.0,79.0
0.006,6,10,1547,5,764,1.0,496.0,496.0,5,783,1.0,515.0,515.0
0.005,6,10,2006,5,927,1.0,659.0,659.0,5,1079,1.0,811.0,811.0
0.013,6,10,1972,5,910,3.0,642.0,642.0,5,1062,3.0,794.0,794.0
0.012,6,10,1972,5,910,3.0,642.0,642.0,5,1062,3.0,794.0,794.0
0.004,6,10,1989,5,927,1.0,659.0,659.0,5,1062,1.0,794.0,794.0
11.481,17,28,4418,14,1994,870.0,269.0,114.0,14,2424,870.0,587.0,145.0
0.005,6,10,1854,5,889,1.0,621.0,621.0,5,965,1.0,697.0,697.0
0.005,6,10,2000,5,927,1.0,659.0,659.0,5,1073,1.0,805.0,805.0
40.067,17,10,676,5,460,10014.0,104.0,64.0,5,216,10016.0,20.0,15.0
0.018,6,10,1989,5,910,4.0,642.0,642.0,5,1079,4.0,811.0,811.0
1770.731,6,135,6510,75,3585,23928.0,39.0,39.0,60,2925,30008.0,35.0,35.0
0.17,17,2,152,1,76,0.0,48.0,48.0,1,76,0.0,48.0,48.0
1777.696,17,144,45504,72,22752,25037.0,288.0,288.0,72,22752,25037.0,288.0,288.0
0.076,6,10,1506,5,395,15.0,127.0,127.0,5,1111,18.0,843.0,843.0
0.015,6,10,1972,5,910,3.0,642.0,642.0,5,1062,3.0,794.0,794.0
372.406,6,26,3272,18,971,21906.0,195.0,195.0,8,2301,3342.0,775.0,492.0
11.555,17,28,4389,14,2311,876.0,586.0,137.0,14,2078,876.0,269.0,120.0
40.059,17,10,676,5,460,10013.0,104.0,64.0,5,216,10013.0,20.0,15.0
0.005,6,10,2006,5,927,1.0,659.0,659.0,5,1079,1.0,811.0,811.0
0.004,17,2,148,1,60,0.0,32.0,32.0,1,88,0.0,60.0,60.0
0.005,17,4,284,2,120,0.0,32.0,32.0,2,164,1.0,60.0,54.0
0.004,6,10,1989,5,927,1.0,659.0,659.0,5,1062,1.0,794.0,794.0
0.006,6,10,1643,5,860,1.0,592.0,592.0,5,783,1.0,515.0,515.0
0.006,6,10,1689,5,839,1.0,571.0,571.0,5,850,1.0,582.0,582.0
0.004,17,2,148,1,60,0.0,32.0,32.0,1,88,0.0,60.0,60.0
0.01,6,10,1990,5,911,2.0,643.0,643.0,5,1079,2.0,811.0,811.0
240.016,6,9,787,5,488,60004.0,232.0,232.0,4,299,80004.0,83.0,83.0
40.076,17,10,676,5,460,10014.0,104.0,64.0,5,216,10018.0,20.0,15.0
0.182,6,10,1506,5,395,39.0,127.0,127.0,5,1111,39.0,843.0,843.0
0.07,6,10,1506,5,395,15.0,127.0,127.0,5,1111,14.0,843.0,843.0
0.172,17,2,152,1,76,0.0,48.0,48.0,1,76,0.0,48.0,48.0
0.004,6,10,2000,5,927,1.0,659.0,659.0,5,1073,1.0,805.0,805.0
0.006,6,10,1547,5,764,1.0,496.0,496.0,5,783,1.0,515.0,515.0
40.054,17,10,676,5,460,10012.0,104.0,64.0,5,216,10008.0,20.0,15.0
0.006,6,10,1643,5,860,1.0,592.0,592.0,5,783,1.0,515.0,515.0
0.01,17,2,263,1,60,0.0,32.0,32.0,1,203,0.0,175.0,175.0
0.005,6,10,2000,5,927,1.0,659.0,659.0,5,1073,1.0,805.0,805.0
0.013,6,10,1983,5,910,3.0,642.0,642.0,5,1073,3.0,805.0,805.0
0.005,6,10,2006,5,927,1.0,659.0,659.0,5,1079,1.0,811.0,811.0
0.087,6,10,1506,5,395,19.0,127.0,127.0,5,1111,18.0,843.0,843.0
0.04,17,2,144,1,64,0.0,36.0,36.0,1,80,0.0,52.0,52.0
0.005,6,10,2006,5,927,1.0,659.0,659.0,5,1079,1.0,811.0,811.0
0.008,6,10,1989,5,910,1.0,642.0,642.0,5,1079,2.0,811.0,811.0
0.005,6,10,2007,5,928,1.0,660.0,660.0,5,1079,1.0,811.0,811.0
0.006,6,10,1547,5,764,1.0,496.0,496.0,5,783,1.0,515.0,515.0
0.095,6,10,1506,5,395,21.0,127.0,127.0,5,1111,22.0,843.0,843.0
0.012,6,10,1983,5,910,3.0,642.0,642.0,5,1073,2.0,805.0,805.0
0.005,6,13,3690,7,452,0.0,80.0,80.0,6,3238,1.0,1470.0,1459.0
0.013,6,10,1972,5,910,3.0,642.0,642.0,5,1062,3.0,794.0,794.0
11.28,17,28,4418,14,1994,855.0,269.0,114.0,14,2424,855.0,587.0,145.0
0.006,6,10,1547,5,764,1.0,496.0,496.0,5,783,1.0,515.0,515.0
0.004,6,10,2007,5,928,1.0,660.0,660.0,5,1079,1.0,811.0,811.0
0.011,6,10,1989,5,910,2.0,642.0,642.0,5,1079,2.0,811.0,811.0
0.008,6,13,3735,7,497,1.0,125.0,125.0,6,3238,1.0,1470.0,1459.0
0.005,6,10,2006,5,927,1.0,659.0,659.0,5,1079,1.0,811.0,811.0
0.006,6,10,1854,5,889,1.0,621.0,621.0,5,965,1.0,697.0,697.0
11.162,17,28,4417,14,1993,846.0,268.0,114.0,14,2424,846.0,587.0,145.0
0.124,6,10,1506,5,395,19.0,127.0,127.0,5,1111,28.0,843.0,843.0
0.004,6,10,2006,5,927,1.0,659.0,659.0,5,1079,1.0,811.0,811.0
0.005,17,2,144,1,64,0.0,36.0,36.0,1,80,0.0,52.0,52.0
1777.357,17,144,41760,72,22752,25033.0,288.0,288.0,72,19008,25033.0,236.0,236.0
0.005,6,10,2006,5,927,1.0,659.0,659.0,5,1079,1.0,811.0,811.0
0.016,6,13,3735,7,497,2.0,125.0,125.0,6,3238,3.0,1470.0,1459.0
0.005,6,10,2006,5,927,1.0,659.0,659.0,5,1079,1.0,811.0,811.0
15.075,17,14,9190,8,6902,2149.0,1350.0,834.0,6,2288,3009.0,1350.0,353.0
300.419,6,29,8507,14,2477,23109.0,1225.0,348.0,15,6030,21458.0,1434.0,583.0
0.005,6,10,1689,5,839,1.0,571.0,571.0,5,850,1.0,582.0,582.0
0.004,6,10,1702,5,863,1.0,595.0,595.0,5,839,1.0,571.0,571.0
0.013,6,10,1677,5,827,3.0,559.0,559.0,5,850,3.0,582.0,582.0
40.072,17,10,676,5,460,10014.0,104.0,64.0,5,216,10017.0,20.0,15.0
240.01,6,9,787,5,488,60002.0,232.0,232.0,4,299,80002.0,83.0,83.0
0.004,6,10,1989,5,927,1.0,659.0,659.0,5,1062,1.0,794.0,794.0
0.008,6,12,1926,6,1189,1.0,659.0,434.0,6,737,1.0,417.0,417.0
0.005,6,10,2006,5,927,1.0,659.0,659.0,5,1079,1.0,811.0,811.0
0.005,6,10,2006,5,927,1.0,659.0,659.0,5,1079,1.0,811.0,811.0
0.005,6,10,1643,5,860,1.0,592.0,592.0,5,783,1.0,515.0,515.0
0.106,6,10,1506,5,395,23.0,127.0,127.0,5,1111,21.0,843.0,843.0
0.012,6,10,1990,5,911,3.0,643.0,643.0,5,1079,2.0,811.0,811.0
0.089,6,10,1506,5,395,20.0,127.0,127.0,5,1111,21.0,843.0,843.0
0.17,6,3,453,2,321,170.0,241.0,241.0,1,132,0.0,92.0,92.0
0.005,6,10,1989,5,927,1.0,659.0,659.0,5,1062,1.0,794.0,794.0
0.006,6,10,2007,5,928,1.0,660.0,660.0,5,1079,1.0,811.0,811.0
0.214,6,10,1506,5,395,50.0,127.0,127.0,5,1111,51.0,843.0,843.0
40.058,17,10,676,5,460,10013.0,104.0,64.0,5,216,10013.0,20.0,15.0
0.073,6,10,1506,5,395,15.0,127.0,127.0,5,1111,17.0,843.0,843.0
300.335,6,16,2170,9,684,37520.0,146.0,146.0,7,1486,50027.0,419.0,398.0
0.001,17,2,180,1,66,0.0,38.0,38.0,1,114,0.0,86.0,86.0
11.035,17,28,4394,14,2313,839.0,588.0,137.0,14,2081,839.0,268.0,120.0
0.07,6,10,1506,5,395,16.0,127.0,127.0,5,1111,15.0,843.0,843.0
0.009,6,10,1990,5,911,2.0,643.0,643.0,5,1079,2.0,811.0,811.0
0.006,6,10,1547,5,764,1.0,496.0,496.0,5,783,1.0,515.0,515.0
0.005,6,10,1989,5,927,1.0,659.0,659.0,5,1062,1.0,794.0,794.0
0.011,6,10,1990,5,911,2.0,643.0,643.0,5,1079,2.0,811.0,811.0
0.01,6,10,1989,5,910,2.0,642.0,642.0,5,1079,2.0,811.0,811.0
0.005,6,10,1689,5,839,1.0,571.0,571.0,5,850,1.0,582.0,582.0
163.103,17,74,10838,37,2480,4530.0,44.0,39.0,37,8358,4530.0,260.0,197.0
0.129,6,10,1506,5,395,22.0,127.0,127.0,5,1111,29.0,843.0,843.0
0.005,6,10,1989,5,927,1.0,659.0,659.0,5,1062,1.0,794.0,794.0
0.01,6,10,1762,5,911,2.0,643.0,643.0,5,851,2.0,583.0,583.0
0.003,17,2,148,1,60,0.0,32.0,32.0,1,88,0.0,60.0,60.0
0.105,6,10,1506,5,395,23.0,127.0,127.0,5,1111,25.0,843.0,843.0
0.005,6,10,2000,5,927,1.0,659.0,659.0,5,1073,1.0,805.0,805.0
0.037,17,2,152,1,76,0.0,48.0,48.0,1,76,0.0,48.0,48.0
1756.23,6,569,191175,301,165188,5854.0,2883.0,879.0,268,25987,6577.0,580.0,118.0
0.005,6,10,2000,5,927,1.0,659.0,659.0,5,1073,1.0,805.0,805.0
0.018,6,10,1972,5,910,4.0,642.0,642.0,5,1062,4.0,794.0,794.0
175.371,17,78,11067,39,2593,4614.0,44.0,38.0,39,8474,4614.0,239.0,189.0
0.004,6,10,1989,5,927,1.0,659.0,659.0,5,1062,1.0,794.0,794.0
0.005,6,10,1547,5,764,1.0,496.0,496.0,5,783,1.0,515.0,515.0
0.041,6,10,1990,5,911,10.0,643.0,643.0,5,1079,10.0,811.0,811.0
0.088,6,10,1506,5,395,21.0,127.0,127.0,5,1111,12.0,843.0,843.0
0.042,17,2,170,1,65,0.0,37.0,37.0,1,105,0.0,77.0,77.0
0.013,6,10,1989,5,910,3.0,642.0,642.0,5,1079,3.0,811.0,811.0
0.005,6,10,1854,5,889,1.0,621.0,621.0,5,965,1.0,697.0,697.0
0.122,6,10,1506,5,395,24.0,127.0,127.0,5,1111,29.0,843.0,843.0
243.093,6,21,6492,12,1402,22099.0,253.0,195.0,9,5090,30386.0,1402.0,769.0
310.7,17,20,1124,10,716,34508.0,48.0,43.0,10,408,34508.0,20.0,12.0
54.079,6,44,14464,22,8557,428.0,2720.0,1092.0,22,5907,2567.0,2667.0,385.0
0.017,6,10,1631,5,848,4.0,580.0,580.0,5,783,4.0,515.0,515.0
315.335,17,20,1124,10,716,35025.0,48.0,43.0,10,408,35025.0,20.0,12.0
0.005,6,10,2006,5,927,1.0,659.0,659.0,5,1079,1.0,811.0,811.0
0.007,6,10,1854,5,889,1.0,621.0,621.0,5,965,1.0,697.0,697.0
0.077,6,10,1506,5,395,17.0,127.0,127.0,5,1111,16.0,843.0,843.0
0.006,6,10,1643,5,860,1.0,592.0,592.0,5,783,1.0,515.0,515.0
0.002,17,2,136,1,60,0.0,32.0,32.0,1,76,0.0,48.0,48.0
0.016,6,10,1989,5,910,4.0,642.0,642.0,5,1079,3.0,811.0,811.0
291.449,6,399,348500,208,22369,1407.0,2736.0,889.0,191,326131,1533.0,2804.0,1786.0
0.039,17,2,184,1,61,0.0,33.0,33.0,1,123,0.0,95.0,95.0
0.004,6,10,1702,5,863,1.0,595.0,595.0,5,839,0.0,571.0,571.0
0.001,17,2,180,1,66,0.0,38.0,38.0,1,114,0.0,86.0,86.0
0.01,17,2,214,1,75,0.0,47.0,47.0,1,139,0.0,111.0,111.0
0.004,6,10,2006,5,927,1.0,659.0,659.0,5,1079,1.0,811.0,811.0
0.005,6,10,2000,5,927,1.0,659.0,659.0,5,1073,1.0,805.0,805.0
0.004,17,2,136,1,60,0.0,32.0,32.0,1,76,0.0,48.0,48.0
0.004,6,10,2007,5,928,1.0,660.0,660.0,5,1079,1.0,811.0,811.0
0.011,6,10,1972,5,910,2.0,642.0,642.0,5,1062,2.0,794.0,794.0
0.005,6,13,3747,7,509,0.0,137.0,137.0,6,3238,1.0,1470.0,1459.0
0.005,17,2,164,1,74,0.0,46.0,46.0,1,90,0.0,62.0,62.0
0.005,6,10,2006,5,927,1.0,659.0,659.0,5,1079,1.0,811.0,811.0
0.006,6,10,1547,5,764,1.0,496.0,496.0,5,783,1.0,515.0,515.0
0.009,6,10,1677,5,827,2.0,559.0,559.0,5,850,2.0,582.0,582.0
0.001,17,2,180,1,66,0.0,38.0,38.0,1,114,0.0,86.0,86.0
0.015,6,10,1972,5,910,3.0,642.0,642.0,5,1062,3.0,794.0,794.0
0.006,6,10,1643,5,860,1.0,592.0,592.0,5,783,1.0,515.0,515.0
0.003,17,2,185,1,73,0.0,45.0,45.0,1,112,0.0,84.0,84.0
0.068,17,8,3613,4,1874,22.0,1350.0,440.0,4,1739,11.0,1350.0,406.0
291.132,6,317,343666,118,17689,2488.0,2736.0,889.0,199,325977,1470.0,2804.0,1706.0
0.006,6,10,1547,5,764,1.0,496.0,496.0,5,783,1.0,515.0,515.0
0.01,6,10,1989,5,910,2.0,642.0,642.0,5,1079,2.0,811.0,811.0
0.099,6,10,1506,5,395,23.0,127.0,127.0,5,1111,22.0,843.0,843.0
0.022,6,13,3913,7,495,3.0,123.0,123.0,6,3418,4.0,1650.0,1549.0
0.007,6,10,1989,5,910,1.0,642.0,642.0,5,1079,1.0,811.0,811.0
40.094,17,10,676,5,460,10018.0,104.0,64.0,5,216,10022.0,20.0,15.0
0.005,6,10,2007,5,928,1.0,660.0,660.0,5,1079,1.0,811.0,811.0
0.013,6,10,1989,5,910,3.0,642.0,642.0,5,1079,3.0,811.0,811.0
0.013,17,2,152,1,56,0.0,28.0,28.0,1,96,0.0,68.0,68.0
0.004,6,10,1774,5,923,1.0,655.0,655.0,5,851,1.0,583.0,583.0
0.075,6,10,1506,5,395,15.0,127.0,127.0,5,1111,14.0,843.0,843.0
0.01,6,10,1854,6,941,2.0,621.0,621.0,4,913,2.0,697.0,697.0
308.54,17,20,1124,10,716,34268.0,48.0,43.0,10,408,34268.0,20.0,12.0
0.015,6,10,1972,5,910,3.0,642.0,642.0,5,1062,3.0,794.0,794.0
10.717,17,26,4103,13,1823,883.0,270.0,112.0,13,2280,883.0,587.0,147.0
0.012,6,10,1989,5,910,3.0,642.0,642.0,5,1079,3.0,811.0,811.0
0.073,6,10,1506,5,395,15.0,127.0,127.0,5,1111,17.0,843.0,843.0
0.038,6,10,1972,5,910,9.0,642.0,642.0,5,1062,9.0,794.0,794.0
0.006,6,10,1547,5,764,1.0,496.0,496.0,5,783,1.0,515.0,515.0
301.045,6,47,21016,26,15378,12041.0,2720.0,1300.0,21,5638,443.0,2667.0,435.0
0.115,6,10,1506,5,395,27.0,127.0,127.0,5,1111,25.0,843.0,843.0
0.006,17,2,179,1,71,0.0,43.0,43.0,1,108,0.0,80.0,80.0
308.435,17,20,1124,10,716,34256.0,48.0,43.0,10,408,34256.0,20.0,12.0
0.008,6,12,1926,6,1189,1.0,659.0,434.0,6,737,1.0,417.0,417.0
15.075,17,15,8011,8,5946,2149.0,1350.0,715.0,7,2065,2507.0,1350.0,267.0
240.009,6,9,787,5,488,60002.0,232.0,232.0,4,299,80002.0,83.0,83.0
0.005,6,10,1989,5,927,1.0,659.0,659.0,5,1062,1.0,794.0,794.0
0.005,6,10,2000,5,927,1.0,659.0,659.0,5,1073,1.0,805.0,805.0
0.009,6,10,1990,5,911,2.0,643.0,643.0,5,1079,2.0,811.0,811.0
0.003,17,2,132,1,58,0.0,30.0,30.0,1,74,0.0,46.0,46.0
0.014,6,10,1972,5,910,3.0,642.0,642.0,5,1062,3.0,794.0,794.0
0.013,6,10,1990,5,911,3.0,643.0,643.0,5,1079,3.0,811.0,811.0
0.084,6,10,1506,5,395,19.0,127.0,127.0,5,1111,19.0,843.0,843.0
0.005,6,10,1779,5,928,1.0,660.0,660.0,5,851,1.0,583.0,583.0
0.003,17,4,284,2,120,0.0,32.0,32.0,2,164,0.0,60.0,54.0
40.06,17,10,676,5,460,10013.0,104.0,64.0,5,216,10014.0,20.0,15.0
0.018,6,10,1762,5,911,4.0,643.0,643.0,5,851,4.0,583.0,583.0
0.014,6,10,1631,5,848,3.0,580.0,580.0,5,783,3.0,515.0,515.0
0.005,6,10,2000,5,927,1.0,659.0,659.0,5,1073,1.0,805.0,805.0
0.081,6,10,1506,5,395,17.0,127.0,127.0,5,1111,18.0,843.0,843.0
0.011,6,12,1926,6,1189,2.0,659.0,434.0,6,737,2.0,417.0,417.0
0.195,6,10,1506,5,395,44.0,127.0,127.0,5,1111,31.0,843.0,843.0
0.016,6,10,1989,5,910,4.0,642.0,642.0,5,1079,4.0,811.0,811.0
0.007,17,2,136,1,60,0.0,32.0,32.0,1,76,0.0,48.0,48.0
0.001,17,2,180,1,66,0.0,38.0,38.0,1,114,0.0,86.0,86.0
178.107,17,78,11285,39,2626,4686.0,44.0,39.0,39,8659,4686.0,239.0,194.0
0.003,17,4,284,2,120,0.0,32.0,32.0,2,164,0.0,60.0,54.0
0.109,6,10,1506,5,395,25.0,127.0,127.0,5,1111,22.0,843.0,843.0
0.001,17,2,180,1,66,0.0,38.0,38.0,1,114,0.0,86.0,86.0
0.006,6,10,1643,5,860,1.0,592.0,592.0,5,783,1.0,515.0,515.0
0.005,6,10,1989,5,927,1.0,659.0,659.0,5,1062,1.0,794.0,794.0
0.013,6,14,3787,7,497,2.0,125.0,125.0,7,3290,2.0,1448.0,972.0
0.019,6,10,1990,5,911,4.0,643.0,643.0,5,1079,4.0,811.0,811.0
0.124,6,10,1506,5,395,23.0,127.0,127.0,5,1111,23.0,843.0,843.0
0.005,6,10,2006,5,927,1.0,659.0,659.0,5,1079,1.0,811.0,811.0
0.191,6,45,11623,24,3252,8.0,1021.0,182.0,21,8371,9.0,1402.0,659.0
0.012,6,10,1972,5,910,3.0,642.0,642.0,5,1062,3.0,794.0,794.0
0.008,6,10,1989,5,910,2.0,642.0,642.0,5,1079,2.0,811.0,811.0
0.038,17,2,144,1,64,0.0,36.0,36.0,1,80,0.0,52.0,52.0
0.009,6,10,1989,5,910,2.0,642.0,642.0,5,1079,2.0,811.0,811.0
0.004,17,4,284,2,120,0.0,32.0,32.0,2,164,0.0,60.0,54.0
0.01,6,10,1983,5,910,2.0,642.0,642.0,5,1073,2.0,805.0,805.0
0.01,6,10,1990,5,911,2.0,643.0,643.0,5,1079,2.0,811.0,811.0
0.006,6,10,1547,5,764,1.0,496.0,496.0,5,783,1.0,515.0,515.0
0.123,6,10,1506,5,395,27.0,127.0,127.0,5,1111,27.0,843.0,843.0
0.005,6,10,1989,5,927,1.0,659.0,659.0,5,1062,1.0,794.0,794.0
0.114,6,10,1506,5,395,26.0,127.0,127.0,5,1111,26.0,843.0,843.0
0.005,6,10,2000,5,927,1.0,659.0,659.0,5,1073,1.0,805.0,805.0
0.001,17,2,180,1,66,0.0,38.0,38.0,1,114,0.0,86.0,86.0
0.015,6,10,1989,5,910,3.0,642.0,642.0,5,1079,3.0,811.0,811.0
352.247,6,20,2210,6,1308,12003.0,494.0,494.0,14,902,27095.0,83.0,83.0
11.455,17,28,4398,14,2311,868.0,586.0,137.0,14,2087,868.0,270.0,121.0
0.004,6,10,1989,5,927,1.0,659.0,659.0,5,1062,1.0,794.0,794.0
0.119,6,10,1506,5,395,27.0,127.0,127.0,5,1111,29.0,843.0,843.0
0.005,6,10,2006,5,927,1.0,659.0,659.0,5,1079,1.0,811.0,811.0
0.014,6,10,1989,5,910,3.0,642.0,642.0,5,1079,3.0,811.0,811.0
0.005,6,10,2007,5,928,1.0,660.0,660.0,5,1079,1.0,811.0,811.0
66.225,6,27,17546,15,9603,4730.0,2804.0,1469.0,12,7943,6005.0,2314.0,1218.0
0.009,6,10,1983,5,910,2.0,642.0,642.0,5,1073,2.0,805.0,805.0
0.143,6,10,1506,5,395,32.0,127.0,127.0,5,1111,31.0,843.0,843.0
0.004,17,2,148,1,60,0.0,32.0,32.0,1,88,0.0,60.0,60.0
0.006,6,13,3747,7,509,1.0,137.0,137.0,6,3238,1.0,1470.0,1459.0
0.009,6,10,1677,5,827,2.0,559.0,559.0,5,850,2.0,582.0,582.0
0.069,6,10,1506,5,395,15.0,127.0,127.0,5,1111,12.0,843.0,843.0
0.017,6,10,1989,5,910,4.0,642.0,642.0,5,1079,4.0,811.0,811.0
0.005,17,2,148,1,60,0.0,32.0,32.0,1,88,0.0,60.0,60.0
0.005,17,2,273,1,66,0.0,38.0,38.0,1,207,0.0,179.0,179.0
240.112,6,31,9541,15,6981,17150.0,2105.0,689.0,16,2560,16007.0,580.0,215.0
0.005,17,2,166,1,75,0.0,47.0,47.0,1,91,0.0,63.0,63.0
0.001,17,2,180,1,66,0.0,38.0,38.0,1,114,0.0,86.0,86.0
0.005,6,10,1989,5,927,1.0,659.0,659.0,5,1062,1.0,794.0,794.0
0.008,6,10,1983,5,910,1.0,642.0,642.0,5,1073,2.0,805.0,805.0
28.329,6,33,6264,18,1338,1666.0,267.0,195.0,15,4926,615.0,1823.0,392.0
0.008,6,10,1983,5,910,2.0,642.0,642.0,5,1073,2.0,805.0,805.0
0.006,17,2,179,1,71,0.0,43.0,43.0,1,108,0.0,80.0,80.0
0.006,6,10,1547,5,764,1.0,496.0,496.0,5,783,1.0,515.0,515.0
0.021,6,10,1762,5,911,5.0,643.0,643.0,5,851,5.0,583.0,583.0
0.007,6,10,2007,5,928,1.0,660.0,660.0,5,1079,1.0,811.0,811.0
40.065,17,10,676,5,460,10013.0,104.0,64.0,5,216,10015.0,20.0,15.0
0.004,17,4,284,2,120,0.0,32.0,32.0,2,164,1.0,60.0,54.0
372.026,6,22,2313,16,867,24801.0,195.0,195.0,6,1446,4647.0,419.0,398.0
0.014,6,10,1990,5,911,3.0,643.0,643.0,5,1079,3.0,811.0,811.0
0.006,17,2,424,1,72,0.0,44.0,44.0,1,352,0.0,324.0,324.0
0.005,6,10,1643,5,860,1.0,592.0,592.0,5,783,1.0,515.0,515.0
0.096,6,10,1506,5,395,20.0,127.0,127.0,5,1111,23.0,843.0,843.0
0.015,6,10,1989,5,910,3.0,642.0,642.0,5,1079,3.0,811.0,811.0
0.001,17,2,180,1,66,0.0,38.0,38.0,1,114,0.0,86.0,86.0
361.821,6,21,1793,16,1030,24121.0,190.0,190.0,5,763,60009.0,462.0,247.0
0.182,6,3,453,2,321,182.0,241.0,241.0,1,132,0.0,92.0,92.0
0.005,6,10,2006,5,927,1.0,659.0,659.0,5,1079,1.0,811.0,811.0
0.004,17,2,148,1,60,0.0,32.0,32.0,1,88,0.0,60.0,60.0
178.038,17,80,11341,40,2672,4564.0,44.0,38.0,40,8669,4564.0,239.0,188.0
0.014,6,10,1983,5,910,3.0,642.0,642.0,5,1073,3.0,805.0,805.0
0.009,6,10,1990,5,911,2.0,643.0,643.0,5,1079,2.0,811.0,811.0
240.101,6,32,9541,16,7091,16006.0,2161.0,695.0,16,2450,16006.0,580.0,201.0
40.061,17,10,676,5,460,10014.0,104.0,64.0,5,216,10014.0,20.0,15.0
0.04,17,4,284,2,120,0.0,32.0,32.0,2,164,36.0,60.0,54.0
0.012,6,10,1677,5,827,3.0,559.0,559.0,5,850,3.0,582.0,582.0
0.109,6,10,1506,5,395,19.0,127.0,127.0,5,1111,25.0,843.0,843.0
0.005,17,2,164,1,74,0.0,46.0,46.0,1,90,0.0,62.0,62.0
0.013,6,10,1762,5,911,3.0,643.0,643.0,5,851,3.0,583.0,583.0
10.877,17,28,4394,14,1994,827.0,269.0,114.0,14,2400,827.0,587.0,143.0
0.007,6,10,1989,5,927,1.0,659.0,659.0,5,1062,1.0,794.0,794.0
0.112,6,10,1506,5,395,27.0,127.0,127.0,5,1111,27.0,843.0,843.0
0.006,6,10,1547,5,764,1.0,496.0,496.0,5,783,1.0,515.0,515.0
0.072,17,2,182,1,65,0.0,37.0,37.0,1,117,0.0,89.0,89.0
301.052,6,37,8498,20,2066,15844.0,887.0,308.0,17,6432,557.0,2720.0,478.0
0.142,6,10,1506,5,395,30.0,127.0,127.0,5,1111,30.0,843.0,843.0
0.003,17,2,186,1,61,0.0,33.0,33.0,1,125,0.0,97.0,97.0
0.009,6,10,1972,5,910,2.0,642.0,642.0,5,1062,2.0,794.0,794.0
0.015,6,10,1631,5,848,3.0,580.0,580.0,5,783,3.0,515.0,515.0
0.104,6,10,1506,5,395,21.0,127.0,127.0,5,1111,20.0,843.0,843.0
0.001,17,2,179,1,62,0.0,34.0,34.0,1,117,0.0,89.0,89.0
0.001,17,2,166,1,75,0.0,47.0,47.0,1,91,0.0,63.0,63.0
0.006,17,2,194,1,59,0.0,31.0,31.0,1,135,0.0,107.0,107.0
0.006,6,10,1547,5,764,1.0,496.0,496.0,5,783,1.0,515.0,515.0
0.123,6,10,1506,5,395,27.0,127.0,127.0,5,1111,28.0,843.0,843.0
0.014,6,10,1990,5,911,3.0,643.0,643.0,5,1079,3.0,811.0,811.0
0.005,17,2,164,1,74,0.0,46.0,46.0,1,90,0.0,62.0,62.0
0.014,6,10,1990,5,911,3.0,643.0,643.0,5,1079,3.0,811.0,811.0
0.185,6,10,1506,5,395,40.0,127.0,127.0,5,1111,42.0,843.0,843.0
0.011,6,10,1983,5,910,2.0,642.0,642.0,5,1073,2.0,805.0,805.0
0.098,6,10,1506,5,395,22.0,127.0,127.0,5,1111,22.0,843.0,843.0
0.064,17,2,144,1,64,0.0,36.0,36.0,1,80,0.0,52.0,52.0
0.012,6,10,1631,5,848,3.0,580.0,580.0,5,783,2.0,515.0,515.0
0.001,17,2,180,1,66,0.0,38.0,38.0,1,114,0.0,86.0,86.0
0.006,17,2,152,1,68,0.0,40.0,40.0,1,84,0.0,56.0,56.0
0.013,6,10,1990,5,911,3.0,643.0,643.0,5,1079,3.0,811.0,811.0
0.003,17,4,284,2,120,0.0,32.0,32.0,2,164,1.0,60.0,54.0
0.078,6,10,1506,5,395,17.0,127.0,127.0,5,1111,17.0,843.0,843.0
0.025,6,10,1972,5,910,6.0,642.0,642.0,5,1062,6.0,794.0,794.0
0.04,17,2,136,1,60,0.0,32.0,32.0,1,76,0.0,48.0,48.0
0.082,6,10,1506,5,395,16.0,127.0,127.0,5,1111,19.0,843.0,843.0
0.005,6,14,3736,7,446,0.0,74.0,74.0,7,3290,0.0,1448.0,972.0
240.043,6,9,787,5,488,60010.0,232.0,232.0,4,299,80013.0,83.0,83.0
300.017,6,12,1782,7,1348,50002.0,494.0,494.0,5,434,75003.0,83.0,83.0
11.485,17,29,4566,15,2166,808.0,269.0,116.0,14,2400,870.0,587.0,143.0
0.013,6,10,1972,5,910,3.0,642.0,642.0,5,1062,3.0,794.0,794.0
0.006,6,10,1689,5,839,1.0,571.0,571.0,5,850,1.0,582.0,582.0
0.018,6,10,1989,5,910,4.0,642.0,642.0,5,1079,4.0,811.0,811.0
40.069,17,10,676,5,460,10016.0,104.0,64.0,5,216,10016.0,20.0,15.0
0.177,17,2,194,1,59,0.0,31.0,31.0,1,135,0.0,107.0,107.0
0.11,6,10,1506,5,395,23.0,127.0,127.0,5,1111,24.0,843.0,843.0
0.004,6,10,2007,5,928,1.0,660.0,660.0,5,1079,1.0,811.0,811.0
0.004,17,2,136,1,60,0.0,32.0,32.0,1,76,0.0,48.0,48.0
0.11,6,10,1506,5,395,25.0,127.0,127.0,5,1111,24.0,843.0,843.0
0.005,6,10,2006,5,927,1.0,659.0,659.0,5,1079,1.0,811.0,811.0
11.142,17,28,4398,14,2313,848.0,588.0,137.0,14,2085,848.0,268.0,120.0
300.31,6,16,2170,9,684,37517.0,146.0,146.0,7,1486,50023.0,419.0,398.0
0.005,6,10,2000,5,927,1.0,659.0,659.0,5,1073,1.0,805.0,805.0
0.015,6,10,1983,5,910,3.0,642.0,642.0,5,1073,3.0,805.0,805.0
0.009,17,2,194,1,59,0.0,31.0,31.0,1,135,0.0,107.0,107.0
0.036,17,2,166,1,75,0.0,47.0,47.0,1,91,0.0,63.0,63.0
0.015,6,10,1983,5,910,3.0,642.0,642.0,5,1073,3.0,805.0,805.0
0.004,6,10,2007,5,928,1.0,660.0,660.0,5,1079,1.0,811.0,811.0
361.856,6,21,1793,16,1030,24123.0,190.0,190.0,5,763,60011.0,462.0,247.0
240.116,6,31,9033,15,6692,17151.0,1815.0,657.0,16,2341,16007.0,580.0,187.0
0.005,6,10,2007,5,928,1.0,660.0,660.0,5,1079,1.0,811.0,811.0
0.005,6,10,2006,5,927,1.0,659.0,659.0,5,1079,1.0,811.0,811.0
0.091,6,10,1506,5,395,21.0,127.0,127.0,5,1111,21.0,843.0,843.0
0.004,6,10,2006,5,927,1.0,659.0,659.0,5,1079,1.0,811.0,811.0
11.186,17,28,4418,14,1994,848.0,269.0,114.0,14,2424,848.0,587.0,145.0
0.005,17,2,230,1,68,0.0,40.0,40.0,1,162,0.0,134.0,134.0
0.04,17,4,284,2,120,0.0,32.0,32.0,2,164,37.0,60.0,54.0
240.116,6,32,9189,16,6701,16007.0,1773.0,652.0,16,2488,16007.0,580.0,206.0
352.977,6,20,2210,6,1308,12003.0,494.0,494.0,14,902,27151.0,83.0,83.0
0.007,17,2,225,1,65,0.0,37.0,37.0,1,160,0.0,132.0,132.0
900.498,6,42,9112,27,7328,34634.0,494.0,494.0,15,1784,64320.0,83.0,83.0
0.091,6,10,1506,5,395,21.0,127.0,127.0,5,1111,18.0,843.0,843.0
15.077,17,15,9238,8,6902,2149.0,1350.0,834.0,7,2336,2508.0,1350.0,305.0
11.085,17,28,4423,14,1994,840.0,269.0,114.0,14,2429,840.0,588.0,145.0
240.017,6,9,787,5,488,60004.0,232.0,232.0,4,299,80004.0,83.0,83.0
0.012,6,10,1989,5,910,2.0,642.0,642.0,5,1079,3.0,811.0,811.0
0.005,17,2,180,1,66,0.0,38.0,38.0,1,114,0.0,86.0,86.0
0.096,6,10,1506,5,395,21.0,127.0,127.0,5,1111,23.0,843.0,843.0
0.005,17,2,166,1,75,0.0,47.0,47.0,1,91,0.0,63.0,63.0
0.005,6,10,1989,5,927,1.0,659.0,659.0,5,1062,1.0,794.0,794.0
0.004,6,10,2006,5,927,1.0,659.0,659.0,5,1079,1.0,811.0,811.0
0.005,6,10,1854,5,889,1.0,621.0,621.0,5,965,1.0,697.0,697.0
353.961,6,21,1795,16,1030,23597.0,190.0,190.0,5,765,60001.0,464.0,248.0
10.914,17,28,4422,14,1993,831.0,268.0,114.0,14,2429,831.0,588.0,145.0
0.001,17,2,180,1,66,0.0,38.0,38.0,1,114,0.0,86.0,86.0
0.019,6,10,1989,5,910,4.0,642.0,642.0,5,1079,4.0,811.0,811.0
0.005,6,10,1779,5,928,1.0,660.0,660.0,5,851,1.0,583.0,583.0
0.018,6,10,1631,5,848,4.0,580.0,580.0,5,783,4.0,515.0,515.0
0.008,6,10,1989,5,910,2.0,642.0,642.0,5,1079,1.0,811.0,811.0
0.078,6,10,1506,5,395,18.0,127.0,127.0,5,1111,17.0,843.0,843.0
65.133,6,46,19286,23,13568,411.0,2720.0,1401.0,23,5718,2952.0,2667.0,435.0
0.012,6,10,1677,5,827,3.0,559.0,559.0,5,850,3.0,582.0,582.0
0.001,17,2,180,1,66,0.0,38.0,38.0,1,114,0.0,86.0,86.0
240.122,6,31,9069,15,6781,17151.0,1905.0,667.0,16,2288,16007.0,580.0,181.0
0.004,6,10,2000,5,927,1.0,659.0,659.0,5,1073,1.0,805.0,805.0
0.008,6,10,1983,5,910,2.0,642.0,642.0,5,1073,2.0,805.0,805.0
0.007,17,2,299,1,65,0.0,37.0,37.0,1,234,0.0,206.0,206.0
0.016,6,10,1990,5,911,4.0,643.0,643.0,5,1079,4.0,811.0,811.0
0.004,17,2,136,1,60,0.0,32.0,32.0,1,76,0.0,48.0,48.0
308.539,17,20,1124,10,716,34267.0,48.0,43.0,10,408,34267.0,20.0,12.0
0.065,6,10,1506,5,395,14.0,127.0,127.0,5,1111,15.0,843.0,843.0
0.001,17,2,136,1,60,0.0,32.0,32.0,1,76,0.0,48.0,48.0
0.067,17,8,3613,4,1874,22.0,1350.0,440.0,4,1739,11.0,1350.0,406.0
0.008,6,10,2007,5,928,1.0,660.0,660.0,5,1079,2.0,811.0,811.0
0.084,6,10,1506,5,395,19.0,127.0,127.0,5,1111,17.0,843.0,843.0
0.003,17,2,136,1,60,0.0,32.0,32.0,1,76,0.0,48.0,48.0
0.005,6,10,1774,5,923,1.0,655.0,655.0,5,851,1.0,583.0,583.0
0.004,6,10,2006,5,927,1.0,659.0,659.0,5,1079,1.0,811.0,811.0
0.801,6,10,2009,6,1655,160.0,1403.0,1403.0,4,354,190.0,182.0,182.0
0.005,17,2,164,1,74,0.0,46.0,46.0,1,90,0.0,62.0,62.0
0.002,17,2,180,1,66,0.0,38.0,38.0,1,114,0.0,86.0,86.0
0.005,6,14,3799,7,509,0.0,137.0,137.0,7,3290,0.0,1448.0,972.0
0.113,6,10,1506,5,395,24.0,127.0,127.0,5,1111,25.0,843.0,843.0
0.003,17,2,136,1,60,0.0,32.0,32.0,1,76,0.0,48.0,48.0
0.104,6,10,1506,5,395,23.0,127.0,127.0,5,1111,24.0,843.0,843.0
0.069,17,8,3613,4,1874,23.0,1350.0,440.0,4,1739,12.0,1350.0,406.0
0.007,6,10,1989,5,910,1.0,642.0,642.0,5,1079,1.0,811.0,811.0
0.005,6,10,2006,5,927,1.0,659.0,659.0,5,1079,1.0,811.0,811.0
0.006,6,10,1689,5,839,1.0,571.0,571.0,5,850,1.0,582.0,582.0
0.005,6,10,1774,5,923,1.0,655.0,655.0,5,851,1.0,583.0,583.0
0.012,6,10,1989,5,910,3.0,642.0,642.0,5,1079,3.0,811.0,811.0
0.023,6,10,1972,5,910,5.0,642.0,642.0,5,1062,5.0,794.0,794.0
0.004,6,10,1989,5,927,1.0,659.0,659.0,5,1062,1.0,794.0,794.0
40.079,17,10,676,5,460,10017.0,104.0,64.0,5,216,10019.0,20.0,15.0
0.006,6,10,1547,5,764,1.0,496.0,496.0,5,783,1.0,515.0,515.0
266.431,6,38,9619,15,6552,19030.0,1677.0,641.0,23,3067,12110.0,580.0,133.0
309.692,17,20,1124,10,716,34396.0,48.0,43.0,10,408,34396.0,20.0,12.0
0.021,6,10,1972,5,910,5.0,642.0,642.0,5,1062,5.0,794.0,794.0
240.273,6,42,8719,21,5686,12013.0,2883.0,573.0,21,3033,12013.0,580.0,241.0
0.088,6,10,1506,5,395,19.0,127.0,127.0,5,1111,18.0,843.0,843.0
0.005,6,10,2000,5,927,1.0,659.0,659.0,5,1073,1.0,805.0,805.0
0.115,6,10,1506,5,395,25.0,127.0,127.0,5,1111,23.0,843.0,843.0
0.07,6,10,1506,5,395,15.0,127.0,127.0,5,1111,16.0,843.0,843.0
0.005,6,10,2007,5,928,1.0,660.0,660.0,5,1079,1.0,811.0,811.0
300.684,6,29,8840,14,2479,23129.0,1227.0,348.0,15,6361,21477.0,1591.0,620.0
0.007,6,10,1762,5,911,1.0,643.0,643.0,5,851,1.0,583.0,583.0
0.012,6,10,1990,5,911,3.0,643.0,643.0,5,1079,3.0,811.0,811.0
0.01,6,10,1990,5,911,2.0,643.0,643.0,5,1079,2.0,811.0,811.0
0.001,17,2,180,1,66,0.0,38.0,38.0,1,114,0.0,86.0,86.0
0.084,6,10,1506,5,395,18.0,127.0,127.0,5,1111,19.0,843.0,843.0
0.005,6,14,3799,7,509,0.0,137.0,137.0,7,3290,0.0,1448.0,972.0
0.007,6,10,1547,5,764,1.0,496.0,496.0,5,783,1.0,515.0,515.0
0.008,6,10,1990,5,911,2.0,643.0,643.0,5,1079,2.0,811.0,811.0
0.073,6,10,1506,5,395,16.0,127.0,127.0,5,1111,15.0,843.0,843.0
0.016,6,10,1989,5,910,4.0,642.0,642.0,5,1079,3.0,811.0,811.0
0.007,6,10,1547,5,764,1.0,496.0,496.0,5,783,1.0,515.0,515.0
40.054,17,10,676,5,460,10012.0,104.0,64.0,5,216,10011.0,20.0,15.0
0.01,6,10,1990,5,911,2.0,643.0,643.0,5,1079,2.0,811.0,811.0
0.023,6,10,1989,5,910,5.0,642.0,642.0,5,1079,5.0,811.0,811.0
0.085,6,10,1506,5,395,17.0,127.0,127.0,5,1111,19.0,843.0,843.0
0.005,6,10,2006,5,927,1.0,659.0,659.0,5,1079,1.0,811.0,811.0
0.005,6,10,1989,5,927,1.0,659.0,659.0,5,1062,1.0,794.0,794.0
1792.647,6,490,99412,246,88062,7316.0,421.0,365.0,244,11350,7376.0,53.0,53.0
0.005,17,2,166,1,75,0.0,47.0,47.0,1,91,0.0,63.0,63.0
0.006,6,10,1547,5,764,1.0,496.0,496.0,5,783,1.0,515.0,515.0
0.004,6,10,2000,5,927,1.0,659.0,659.0,5,1073,1.0,805.0,805.0
0.005,17,2,166,1,75,0.0,47.0,47.0,1,91,0.0,63.0,63.0
0.089,6,10,1506,5,395,20.0,127.0,127.0,5,1111,19.0,843.0,843.0
0.028,6,10,1990,5,911,7.0,643.0,643.0,5,1079,7.0,811.0,811.0
40.088,17,10,676,5,460,10020.0,104.0,64.0,5,216,10021.0,20.0,15.0
0.103,6,10,1506,5,395,23.0,127.0,127.0,5,1111,20.0,843.0,843.0
21.39,6,37,9811,19,4293,502.0,1360.0,700.0,18,5518,1248.0,2667.0,435.0
0.004,6,10,1702,5,863,1.0,595.0,595.0,5,839,0.0,571.0,571.0
0.035,6,10,1631,5,848,8.0,580.0,580.0,5,783,8.0,515.0,515.0
0.015,17,2,198,1,91,0.0,63.0,63.0,1,107,0.0,79.0,79.0
0.001,17,2,180,1,66,0.0,38.0,38.0,1,114,0.0,86.0,86.0
0.003,17,2,136,1,60,0.0,32.0,32.0,1,76,0.0,48.0,48.0
0.008,6,10,1983,5,910,2.0,642.0,642.0,5,1073,2.0,805.0,805.0
0.002,17,2,180,1,66,0.0,38.0,38.0,1,114,0.0,86.0,86.0
0.007,17,2,299,1,65,0.0,37.0,37.0,1,234,0.0,206.0,206.0
240.02,6,9,787,5,488,60005.0,232.0,232.0,4,299,80005.0,83.0,83.0
0.011,6,10,1990,5,911,2.0,643.0,643.0,5,1079,2.0,811.0,811.0
0.005,6,13,3747,7,509,0.0,137.0,137.0,6,3238,1.0,1470.0,1459.0
0.01,6,10,1990,5,911,2.0,643.0,643.0,5,1079,2.0,811.0,811.0
0.017,6,10,1989,5,910,4.0,642.0,642.0,5,1079,4.0,811.0,811.0
0.006,6,10,1779,5,928,1.0,660.0,660.0,5,851,1.0,583.0,583.0
0.004,6,10,2006,5,927,1.0,659.0,659.0,5,1079,1.0,811.0,811.0
0.004,17,4,284,2,120,0.0,32.0,32.0,2,164,0.0,60.0,54.0
0.01,6,10,1990,5,911,2.0,643.0,643.0,5,1079,2.0,811.0,811.0
0.003,17,2,136,1,60,0.0,32.0,32.0,1,76,0.0,48.0,48.0
0.169,6,3,453,2,321,169.0,241.0,241.0,1,132,0.0,92.0,92.0
0.147,6,30,10457,17,9046,9.0,1515.0,816.0,13,1411,11.0,321.0,122.0
0.015,6,10,1972,5,910,3.0,642.0,642.0,5,1062,3.0,794.0,794.0
0.01,6,10,1989,5,910,2.0,642.0,642.0,5,1079,2.0,811.0,811.0
0.011,6,12,1926,6,1189,2.0,659.0,434.0,6,737,2.0,417.0,417.0
0.006,6,10,1547,5,764,1.0,496.0,496.0,5,783,1.0,515.0,515.0
0.003,17,2,160,1,72,0.0,44.0,44.0,1,88,0.0,60.0,60.0
0.005,6,10,2006,5,927,1.0,659.0,659.0,5,1079,1.0,811.0,811.0
0.009,6,10,1989,5,910,2.0,642.0,642.0,5,1079,2.0,811.0,811.0
40.055,17,10,676,5,460,10012.0,104.0,64.0,5,216,10012.0,20.0,15.0
0.009,6,12,1926,6,1189,1.0,659.0,434.0,6,737,1.0,417.0,417.0
40.057,17,10,676,5,460,10013.0,104.0,64.0,5,216,10013.0,20.0,15.0
0.004,17,2,148,1,60,0.0,32.0,32.0,1,88,0.0,60.0,60.0
0.111,6,10,1506,5,395,25.0,127.0,127.0,5,1111,23.0,843.0,843.0
0.085,6,10,1506,5,395,15.0,127.0,127.0,5,1111,19.0,843.0,843.0
0.074,6,10,1506,5,395,14.0,127.0,127.0,5,1111,17.0,843.0,843.0
0.005,6,10,2000,5,927,1.0,659.0,659.0,5,1073,1.0,805.0,805.0
0.012,6,10,1990,5,911,2.0,643.0,643.0,5,1079,3.0,811.0,811.0
0.089,6,10,1506,5,395,19.0,127.0,127.0,5,1111,17.0,843.0,843.0
0.118,6,25,7327,12,3201,9.0,1402.0,428.0,13,4126,8.0,1324.0,688.0
0.025,6,19,9922,11,704,2.0,124.0,124.0,8,9218,3.0,2896.0,2198.0
11.097,17,28,4423,14,1994,841.0,269.0,114.0,14,2429,841.0,588.0,145.0
0.009,6,10,1972,5,910,2.0,642.0,642.0,5,1062,2.0,794.0,794.0
0.06,17,2,152,1,76,0.0,48.0,48.0,1,76,0.0,48.0,48.0
0.005,6,10,2006,5,927,1.0,659.0,659.0,5,1079,1.0,811.0,811.0
0.005,6,10,2007,5,928,1.0,660.0,660.0,5,1079,1.0,811.0,811.0
292.142,6,377,348029,194,22288,1513.0,2736.0,870.0,183,325741,1605.0,2914.0,1882.0
0.014,6,10,1989,5,910,3.0,642.0,642.0,5,1079,3.0,811.0,811.0
0.07,6,10,1506,5,395,14.0,127.0,127.0,5,1111,15.0,843.0,843.0
413.572,6,29,4409,12,3102,10911.0,494.0,494.0,17,1307,25848.0,83.0,83.0
0.072,6,10,1506,5,395,14.0,127.0,127.0,5,1111,16.0,843.0,843.0
0.006,6,10,2006,5,927,1.0,659.0,659.0,5,1079,1.0,811.0,811.0
0.005,6,10,2006,5,927,1.0,659.0,659.0,5,1079,1.0,811.0,811.0
0.016,6,10,1631,5,848,4.0,580.0,580.0,5,783,3.0,515.0,515.0
0.015,6,10,1972,5,910,3.0,642.0,642.0,5,1062,3.0,794.0,794.0
0.005,6,13,3690,7,452,0.0,80.0,80.0,6,3238,1.0,1470.0,1459.0
0.006,6,10,1547,5,764,1.0,496.0,496.0,5,783,1.0,515.0,515.0
0.017,6,10,1972,5,910,4.0,642.0,642.0,5,1062,4.0,794.0,794.0
0.006,6,10,1547,5,764,1.0,496.0,496.0,5,783,1.0,515.0,515.0
0.014,6,10,1677,5,827,3.0,559.0,559.0,5,850,3.0,582.0,582.0
0.111,6,10,1506,5,395,22.0,127.0,127.0,5,1111,25.0,843.0,843.0
0.005,6,10,1689,5,839,1.0,571.0,571.0,5,850,1.0,582.0,582.0
0.006,6,10,1854,5,889,1.0,621.0,621.0,5,965,1.0,697.0,697.0
0.014,6,10,1983,5,910,3.0,642.0,642.0,5,1073,3.0,805.0,805.0
0.01,6,10,1989,5,910,2.0,642.0,642.0,5,1079,2.0,811.0,811.0
0.005,6,10,1989,5,927,1.0,659.0,659.0,5,1062,1.0,794.0,794.0
0.008,6,10,1990,5,911,2.0,643.0,643.0,5,1079,2.0,811.0,811.0
10.818,17,28,4420,14,1993,824.0,268.0,114.0,14,2427,824.0,586.0,145.0
300.368,6,25,7300,15,1357,21454.0,217.0,142.0,10,5943,26701.0,1679.0,902.0
40.07,17,10,676,5,460,10016.0,104.0,64.0,5,216,10014.0,20.0,15.0
0.006,6,10,1854,5,889,1.0,621.0,621.0,5,965,1.0,697.0,697.0
10.787,17,28,4419,14,1994,820.0,269.0,114.0,14,2425,820.0,588.0,145.0
11.146,17,28,4417,14,1994,844.0,269.0,114.0,14,2423,844.0,586.0,145.0
0.004,6,10,2007,5,928,1.0,660.0,660.0,5,1079,1.0,811.0,811.0
40.062,17,10,676,5,460,10014.0,104.0,64.0,5,216,10014.0,20.0,15.0
0.005,17,2,179,1,71,0.0,43.0,43.0,1,108,0.0,80.0,80.0
0.216,6,16,2777,8,1395,30.0,533.0,323.0,8,1382,19.0,529.0,239.0
0.005,17,2,140,1,62,0.0,34.0,34.0,1,78,0.0,50.0,50.0
0.005,6,10,1854,5,889,1.0,621.0,621.0,5,965,1.0,697.0,697.0
0.039,17,2,152,1,76,0.0,48.0,48.0,1,76,0.0,48.0,48.0
0.004,6,10,2006,5,927,1.0,659.0,659.0,5,1079,1.0,811.0,811.0
0.004,6,10,2006,5,927,1.0,659.0,659.0,5,1079,1.0,811.0,811.0
0.01,6,14,3787,7,497,1.0,125.0,125.0,7,3290,1.0,1448.0,972.0
241.707,6,380,346719,192,21509,1265.0,2736.0,885.0,188,325210,1292.0,2999.0,1772.0
0.005,6,10,1989,5,927,1.0,659.0,659.0,5,1062,1.0,794.0,794.0
0.007,17,2,136,1,60,0.0,32.0,32.0,1,76,0.0,48.0,48.0
0.006,6,10,1547,5,764,1.0,496.0,496.0,5,783,1.0,515.0,515.0
0.18,6,39,13383,18,8456,10.0,2922.0,751.0,21,4927,8.0,1587.0,478.0
0.008,6,12,1926,6,1189,1.0,659.0,434.0,6,737,1.0,417.0,417.0
0.004,6,10,2006,5,927,1.0,659.0,659.0,5,1079,1.0,811.0,811.0
0.01,6,13,3735,7,497,1.0,125.0,125.0,6,3238,1.0,1470.0,1459.0
0.001,17,2,180,1,66,0.0,38.0,38.0,1,114,0.0,86.0,86.0
0.017,6,10,1983,5,910,4.0,642.0,642.0,5,1073,4.0,805.0,805.0
0.005,6,10,2006,5,927,1.0,659.0,659.0,5,1079,1.0,811.0,811.0
0.006,6,10,1547,5,764,1.0,496.0,496.0,5,783,1.0,515.0,515.0
0.087,6,10,1506,5,395,19.0,127.0,127.0,5,1111,17.0,843.0,843.0
0.101,6,10,1506,5,395,24.0,127.0,127.0,5,1111,24.0,843.0,843.0
0.006,6,10,1547,5,764,1.0,496.0,496.0,5,783,1.0,515.0,515.0
0.09,6,10,1506,5,395,16.0,127.0,127.0,5,1111,19.0,843.0,843.0
0.006,6,10,1547,5,764,1.0,496.0,496.0,5,783,1.0,515.0,515.0
308.357,17,20,1124,10,716,34255.0,48.0,43.0,10,408,34255.0,20.0,12.0
0.011,6,10,1990,5,911,2.0,643.0,643.0,5,1079,2.0,811.0,811.0
0.004,6,10,2007,5,928,1.0,660.0,660.0,5,1079,1.0,811.0,811.0
0.005,17,2,164,1,74,0.0,46.0,46.0,1,90,0.0,62.0,62.0
0.122,6,10,1506,5,395,28.0,127.0,127.0,5,1111,29.0,843.0,843.0
0.008,17,2,214,1,75,0.0,47.0,47.0,1,139,0.0,111.0,111.0
0.006,6,10,1547,5,764,1.0,496.0,496.0,5,783,1.0,515.0,515.0
0.01,6,10,1989,5,910,2.0,642.0,642.0,5,1079,2.0,811.0,811.0
0.091,6,10,1506,5,395,20.0,127.0,127.0,5,1111,20.0,843.0,843.0
0.011,6,10,1989,5,910,2.0,642.0,642.0,5,1079,2.0,811.0,811.0
0.001,17,2,180,1,66,0.0,38.0,38.0,1,114,0.0,86.0,86.0
0.005,6,13,3747,7,509,0.0,137.0,137.0,6,3238,0.0,1470.0,1459.0
0.005,6,10,1989,5,927,1.0,659.0,659.0,5,1062,1.0,794.0,794.0
0.004,17,4,284,2,120,0.0,32.0,32.0,2,164,0.0,60.0,54.0
40.096,17,10,676,5,460,10016.0,104.0,64.0,5,216,10021.0,20.0,15.0
0.012,6,10,1989,5,910,3.0,642.0,642.0,5,1079,2.0,811.0,811.0
0.092,6,10,1506,5,395,21.0,127.0,127.0,5,1111,16.0,843.0,843.0
0.124,17,2,80,1,32,0.0,4.0,4.0,1,48,0.0,20.0,20.0
1772.618,17,120,11460,60,5460,30043.0,63.0,63.0,60,6000,30044.0,72.0,72.0
0.004,17,2,136,1,60,0.0,32.0,32.0,1,76,0.0,48.0,48.0
0.001,17,2,180,1,66,0.0,38.0,38.0,1,114,0.0,86.0,86.0
0.01,6,10,1983,5,910,2.0,642.0,642.0,5,1073,2.0,805.0,805.0
0.012,6,10,1972,5,910,3.0,642.0,642.0,5,1062,3.0,794.0,794.0
0.107,6,10,1506,5,395,26.0,127.0,127.0,5,1111,23.0,843.0,843.0
11.023,17,28,4421,14,1993,839.0,268.0,114.0,14,2428,839.0,587.0,145.0
0.006,17,2,214,1,75,0.0,47.0,47.0,1,139,0.0,111.0,111.0
0.122,6,10,1506,5,395,28.0,127.0,127.0,5,1111,27.0,843.0,843.0
0.125,6,10,1506,5,395,28.0,127.0,127.0,5,1111,27.0,843.0,843.0
0.01,17,2,194,1,59,0.0,31.0,31.0,1,135,0.0,107.0,107.0
0.005,6,10,1643,5,860,1.0,592.0,592.0,5,783,1.0,515.0,515.0
0.006,6,10,1547,5,764,1.0,496.0,496.0,5,783,1.0,515.0,515.0
0.005,17,2,169,1,62,0.0,34.0,34.0,1,107,0.0,79.0,79.0
0.001,17,2,180,1,66,0.0,38.0,38.0,1,114,0.0,86.0,86.0
0.001,17,2,180,1,66,0.0,38.0,38.0,1,114,0.0,86.0,86.0
0.069,17,8,3613,4,1874,23.0,1350.0,440.0,4,1739,11.0,1350.0,406.0
0.001,17,2,142,1,63,0.0,35.0,35.0,1,79,0.0,51.0,51.0
0.006,6,10,1547,5,764,1.0,496.0,496.0,5,783,1.0,515.0,515.0
0.006,17,2,136,1,60,0.0,32.0,32.0,1,76,0.0,48.0,48.0
0.091,6,10,1506,5,395,19.0,127.0,127.0,5,1111,18.0,843.0,843.0
0.004,6,10,2007,5,928,1.0,660.0,660.0,5,1079,1.0,811.0,811.0
0.004,6,13,3747,7,509,0.0,137.0,137.0,6,3238,0.0,1470.0,1459.0
0.005,6,14,3742,8,504,0.0,80.0,80.0,6,3238,0.0,1470.0,1459.0
0.097,6,10,1506,5,395,20.0,127.0,127.0,5,1111,23.0,843.0,843.0
0.006,6,10,1547,5,764,1.0,496.0,496.0,5,783,1.0,515.0,515.0
0.007,6,10,1774,5,923,1.0,655.0,655.0,5,851,1.0,583.0,583.0
1797.358,17,2576,197410,1277,103698,1408.0,84.0,53.0,1299,93712,1384.0,227.0,44.0
0.096,6,10,1506,5,395,19.0,127.0,127.0,5,1111,20.0,843.0,843.0
0.005,6,10,2006,5,927,1.0,659.0,659.0,5,1079,1.0,811.0,811.0
0.079,6,10,1506,5,395,18.0,127.0,127.0,5,1111,16.0,843.0,843.0
0.032,6,10,1972,5,910,7.0,642.0,642.0,5,1062,8.0,794.0,794.0
0.04,17,4,420,2,122,0.0,33.0,33.0,2,298,37.0,145.0,121.0
0.004,17,4,420,2,122,0.0,33.0,33.0,2,298,0.0,145.0,121.0
0.226,6,16,2778,8,1396,32.0,533.0,324.0,8,1382,20.0,529.0,239.0
40.089,17,10,676,5,460,10018.0,104.0,64.0,5,216,10021.0,20.0,15.0
0.096,6,10,1506,5,395,21.0,127.0,127.0,5,1111,21.0,843.0,843.0
0.007,6,10,1547,5,764,1.0,496.0,496.0,5,783,1.0,515.0,515.0
310.628,17,20,1124,10,716,34500.0,48.0,43.0,10,408,34500.0,20.0,12.0
0.009,6,10,1972,5,910,2.0,642.0,642.0,5,1062,2.0,794.0,794.0
0.003,17,2,136,1,60,0.0,32.0,32.0,1,76,0.0,48.0,48.0
0.039,6,10,1990,5,911,9.0,643.0,643.0,5,1079,9.0,811.0,811.0
0.001,17,2,180,1,66,0.0,38.0,38.0,1,114,0.0,86.0,86.0
0.006,6,10,1547,5,764,1.0,496.0,496.0,5,783,1.0,515.0,515.0
0.037,17,2,412,1,61,0.0,33.0,33.0,1,351,0.0,323.0,323.0
0.017,6,10,1989,5,910,4.0,642.0,642.0,5,1079,4.0,811.0,811.0
0.01,6,13,3735,7,497,1.0,125.0,125.0,6,3238,2.0,1470.0,1459.0
308.388,17,20,1124,10,716,34250.0,48.0,43.0,10,408,34250.0,20.0,12.0
0.006,6,10,1547,5,764,1.0,496.0,496.0,5,783,1.0,515.0,515.0
0.005,6,10,1779,5,928,1.0,660.0,660.0,5,851,1.0,583.0,583.0
177.054,17,80,11270,40,2664,4539.0,44.0,38.0,40,8606,4539.0,239.0,187.0
0.011,6,10,1990,5,911,2.0,643.0,643.0,5,1079,2.0,811.0,811.0
0.021,6,10,1989,5,910,5.0,642.0,642.0,5,1079,5.0,811.0,811.0
0.005,6,10,2006,5,927,1.0,659.0,659.0,5,1079,1.0,811.0,811.0
0.12,6,10,1506,5,395,26.0,127.0,127.0,5,1111,27.0,843.0,843.0
40.065,17,10,676,5,460,10015.0,104.0,64.0,5,216,10015.0,20.0,15.0
0.124,6,10,1506,5,395,29.0,127.0,127.0,5,1111,24.0,843.0,843.0
0.006,6,10,1854,5,889,1.0,621.0,621.0,5,965,1.0,697.0,697.0
0.014,6,10,1990,5,911,3.0,643.0,643.0,5,1079,3.0,811.0,811.0
0.005,17,2,136,1,60,0.0,32.0,32.0,1,76,0.0,48.0,48.0
368.817,6,22,2313,16,867,24587.0,195.0,195.0,6,1446,4636.0,419.0,398.0
40.064,17,10,676,5,460,10013.0,104.0,64.0,5,216,10015.0,20.0,15.0
0.011,6,10,1972,5,910,2.0,642.0,642.0,5,1062,2.0,794.0,794.0
0.005,17,4,420,2,122,1.0,33.0,33.0,2,298,0.0,145.0,121.0
0.001,17,2,136,1,60,0.0,32.0,32.0,1,76,0.0,48.0,48.0
40.068,17,10,676,5,460,10016.0,104.0,64.0,5,216,10016.0,20.0,15.0
0.15,6,10,1506,5,395,30.0,127.0,127.0,5,1111,33.0,843.0,843.0
325.76,17,20,1124,10,716,36180.0,48.0,43.0,10,408,36180.0,20.0,12.0
0.093,6,10,1506,5,395,22.0,127.0,127.0,5,1111,20.0,843.0,843.0
40.059,17,10,676,5,460,10014.0,104.0,64.0,5,216,10014.0,20.0,15.0
0.092,6,10,1506,5,395,16.0,127.0,127.0,5,1111,21.0,843.0,843.0
0.082,6,10,1506,5,395,17.0,127.0,127.0,5,1111,19.0,843.0,843.0
291.832,6,312,343592,126,18107,2334.0,2693.0,889.0,186,325485,1577.0,2804.0,1836.0
0.079,6,10,1506,5,395,18.0,127.0,127.0,5,1111,13.0,843.0,843.0
0.006,6,10,1689,5,839,1.0,571.0,571.0,5,850,1.0,582.0,582.0
40.07,17,10,676,5,460,10016.0,104.0,64.0,5,216,10016.0,20.0,15.0
0.006,6,10,2007,5,928,1.0,660.0,660.0,5,1079,1.0,811.0,811.0
0.005,6,10,2006,5,927,1.0,659.0,659.0,5,1079,1.0,811.0,811.0
0.004,6,10,2006,5,927,1.0,659.0,659.0,5,1079,1.0,811.0,811.0
0.005,6,10,1989,5,927,1.0,659.0,659.0,5,1062,1.0,794.0,794.0
0.008,6,12,1926,6,1189,1.0,659.0,434.0,6,737,1.0,417.0,417.0
0.02,6,10,1983,5,910,5.0,642.0,642.0,5,1073,5.0,805.0,805.0
0.008,6,14,3787,7,497,1.0,125.0,125.0,7,3290,1.0,1448.0,972.0
0.006,6,10,1547,5,764,1.0,496.0,496.0,5,783,1.0,515.0,515.0
0.006,6,10,1689,5,839,1.0,571.0,571.0,5,850,1.0,582.0,582.0
0.018,6,10,1990,5,911,4.0,643.0,643.0,5,1079,4.0,811.0,811.0
0.006,17,2,179,1,71,0.0,43.0,43.0,1,108,0.0,80.0,80.0
0.004,6,10,2006,5,927,1.0,659.0,659.0,5,1079,1.0,811.0,811.0
0.008,6,10,1989,5,910,2.0,642.0,642.0,5,1079,1.0,811.0,811.0
0.004,6,10,2007,5,928,1.0,660.0,660.0,5,1079,1.0,811.0,811.0
0.004,17,2,148,1,60,0.0,32.0,32.0,1,88,0.0,60.0,60.0
0.009,6,10,1990,5,911,2.0,643.0,643.0,5,1079,2.0,811.0,811.0
0.003,17,2,170,1,65,0.0,37.0,37.0,1,105,0.0,77.0,77.0
0.098,6,10,1506,5,395,23.0,127.0,127.0,5,1111,22.0,843.0,843.0
0.011,6,10,1972,5,910,2.0,642.0,642.0,5,1062,2.0,794.0,794.0
0.004,17,4,284,2,120,0.0,32.0,32.0,2,164,1.0,60.0,54.0
15.275,17,17,8616,9,6362,1903.0,1350.0,678.0,8,2254,2178.0,1350.0,253.0
0.005,6,14,3736,7,446,0.0,74.0,74.0,7,3290,0.0,1448.0,972.0
0.005,6,10,2006,5,927,1.0,659.0,659.0,5,1079,1.0,811.0,811.0
280.757,6,24,6115,10,1186,31195.0,267.0,156.0,14,4929,21596.0,1400.0,873.0
353.578,6,20,2210,6,1308,12003.0,494.0,494.0,14,902,27198.0,83.0,83.0
0.021,6,10,1990,5,911,5.0,643.0,643.0,5,1079,5.0,811.0,811.0
0.051,6,10,1989,5,910,12.0,642.0,642.0,5,1079,12.0,811.0,811.0
0.123,17,4,284,2,120,0.0,32.0,32.0,2,164,120.0,60.0,54.0
0.005,6,10,2007,5,928,1.0,660.0,660.0,5,1079,1.0,811.0,811.0
0.011,6,10,1989,5,910,2.0,642.0,642.0,5,1079,2.0,811.0,811.0
0.039,17,2,148,1,60,0.0,32.0,32.0,1,88,0.0,60.0,60.0
356.593,6,21,1795,16,1030,23772.0,190.0,190.0,5,765,60002.0,464.0,248.0
0.006,6,10,1547,5,764,1.0,496.0,496.0,5,783,1.0,515.0,515.0
0.005,6,10,2006,5,927,1.0,659.0,659.0,5,1079,1.0,811.0,811.0
11.075,17,28,4424,14,1995,839.0,270.0,114.0,14,2429,839.0,588.0,145.0
0.073,6,10,1506,5,395,17.0,127.0,127.0,5,1111,15.0,843.0,843.0
314.55,17,20,1124,10,716,34943.0,48.0,43.0,10,408,34943.0,20.0,12.0
0.014,6,10,1972,5,910,3.0,642.0,642.0,5,1062,3.0,794.0,794.0
0.111,6,10,1506,5,395,25.0,127.0,127.0,5,1111,25.0,843.0,843.0
0.005,17,2,140,1,62,0.0,34.0,34.0,1,78,0.0,50.0,50.0
0.005,6,10,2000,5,927,1.0,659.0,659.0,5,1073,1.0,805.0,805.0
0.016,6,10,1972,5,910,4.0,642.0,642.0,5,1062,4.0,794.0,794.0
0.004,6,10,2000,5,927,1.0,659.0,659.0,5,1073,1.0,805.0,805.0
0.005,6,10,1989,5,927,1.0,659.0,659.0,5,1062,1.0,794.0,794.0
0.006,17,2,230,1,68,0.0,40.0,40.0,1,162,0.0,134.0,134.0
0.131,6,10,1506,5,395,29.0,127.0,127.0,5,1111,31.0,843.0,843.0
0.011,6,10,1983,5,910,2.0,642.0,642.0,5,1073,2.0,805.0,805.0
0.004,17,2,136,1,60,0.0,32.0,32.0,1,76,0.0,48.0,48.0
0.076,6,10,1506,5,395,16.0,127.0,127.0,5,1111,14.0,843.0,843.0
0.003,17,2,148,1,60,0.0,32.0,32.0,1,88,0.0,60.0,60.0
0.006,6,10,1547,5,764,1.0,496.0,496.0,5,783,1.0,515.0,515.0
0.068,6,10,1506,5,395,13.0,127.0,127.0,5,1111,16.0,843.0,843.0
0.004,6,10,1989,5,927,1.0,659.0,659.0,5,1062,1.0,794.0,794.0
0.005,6,10,1989,5,927,1.0,659.0,659.0,5,1062,1.0,794.0,794.0
0.135,6,10,1506,5,395,32.0,127.0,127.0,5,1111,28.0,843.0,843.0
0.001,17,2,166,1,75,0.0,47.0,47.0,1,91,0.0,63.0,63.0
0.004,6,10,2000,5,927,1.0,659.0,659.0,5,1073,1.0,805.0,805.0
0.006,6,10,2000,5,927,1.0,659.0,659.0,5,1073,1.0,805.0,805.0
0.163,6,10,1506,5,395,35.0,127.0,127.0,5,1111,39.0,843.0,843.0
1799.613,17,3302,252723,1643,133176,1095.0,84.0,53.0,1659,119547,1085.0,227.0,44.0
0.021,6,13,3735,7,497,3.0,125.0,125.0,6,3238,4.0,1470.0,1459.0
0.005,17,2,222,1,65,0.0,37.0,37.0,1,157,0.0,129.0,129.0
0.024,6,10,1990,5,911,6.0,643.0,643.0,5,1079,5.0,811.0,811.0
0.006,6,10,1643,5,860,1.0,592.0,592.0,5,783,1.0,515.0,515.0
0.011,6,10,1989,5,910,2.0,642.0,642.0,5,1079,2.0,811.0,811.0
0.012,6,10,1990,5,911,3.0,643.0,643.0,5,1079,3.0,811.0,811.0
300.311,6,16,2170,9,684,37518.0,146.0,146.0,7,1486,50024.0,419.0,398.0
1730.416,6,45,2790,30,1725,59669.0,35.0,35.0,15,1065,123588.0,31.0,31.0
0.001,17,2,136,1,60,0.0,32.0,32.0,1,76,0.0,48.0,48.0
309.006,17,20,1124,10,716,34326.0,48.0,43.0,10,408,34326.0,20.0,12.0
0.004,17,2,136,1,60,0.0,32.0,32.0,1,76,0.0,48.0,48.0
0.005,17,2,214,1,75,0.0,47.0,47.0,1,139,0.0,111.0,111.0
0.012,6,10,1631,5,848,2.0,580.0,580.0,5,783,2.0,515.0,515.0
0.129,17,4,336,2,124,0.0,34.0,34.0,2,212,86.0,84.0,78.0
0.005,6,10,2006,5,927,1.0,659.0,659.0,5,1079,1.0,811.0,811.0
173.368,17,78,10853,39,2613,4562.0,44.0,39.0,39,8240,4562.0,239.0,183.0
0.013,6,10,1972,5,910,3.0,642.0,642.0,5,1062,3.0,794.0,794.0
290.669,6,384,348142,200,21968,1460.0,2736.0,825.0,184,326174,1588.0,2804.0,1862.0
18.007,6,33,6264,18,1338,1059.0,267.0,195.0,15,4926,609.0,1823.0,392.0
0.004,6,10,2007,5,928,1.0,660.0,660.0,5,1079,1.0,811.0,811.0
279.346,6,42,13874,17,6965,17459.0,1985.0,676.0,25,6909,11639.0,2377.0,350.0
342.209,6,33,10704,18,2762,20129.0,676.0,363.0,15,7942,20154.0,1402.0,794.0
10.77,17,28,4421,14,1993,819.0,268.0,114.0,14,2428,819.0,587.0,145.0
1738.239,6,64,7360,42,4484,42396.0,1640.0,109.0,22,2876,82765.0,1112.0,82.0
0.011,6,12,1926,6,1189,2.0,659.0,434.0,6,737,2.0,417.0,417.0
0.004,6,10,1702,5,863,1.0,595.0,595.0,5,839,0.0,571.0,571.0
0.005,6,10,2007,5,928,1.0,660.0,660.0,5,1079,1.0,811.0,811.0
0.009,6,10,1989,5,910,2.0,642.0,642.0,5,1079,2.0,811.0,811.0
0.102,6,10,1506,5,395,23.0,127.0,127.0,5,1111,24.0,843.0,843.0
0.088,6,10,1506,5,395,20.0,127.0,127.0,5,1111,20.0,843.0,843.0
0.073,6,10,1506,5,395,16.0,127.0,127.0,5,1111,14.0,843.0,843.0
0.01,6,10,1983,5,910,2.0,642.0,642.0,5,1073,2.0,805.0,805.0
0.01,6,12,1926,6,1189,1.0,659.0,434.0,6,737,2.0,417.0,417.0
0.012,6,10,1631,5,848,2.0,580.0,580.0,5,783,2.0,515.0,515.0
0.018,6,13,3735,7,497,2.0,125.0,125.0,6,3238,3.0,1470.0,1459.0
0.007,17,2,179,1,71,0.0,43.0,43.0,1,108,0.0,80.0,80.0
0.096,6,10,1506,5,395,21.0,127.0,127.0,5,1111,21.0,843.0,843.0
0.075,6,10,1506,5,395,17.0,127.0,127.0,5,1111,17.0,843.0,843.0
0.115,6,10,1506,5,395,18.0,127.0,127.0,5,1111,26.0,843.0,843.0
0.003,17,2,170,1,65,0.0,37.0,37.0,1,105,0.0,77.0,77.0
40.05,17,10,676,5,460,10011.0,104.0,64.0,5,216,10011.0,20.0,15.0
0.004,6,10,2006,5,927,1.0,659.0,659.0,5,1079,1.0,811.0,811.0
0.004,6,10,2006,5,927,1.0,659.0,659.0,5,1079,1.0,811.0,811.0
0.093,6,10,1506,5,395,19.0,127.0,127.0,5,1111,19.0,843.0,843.0
0.079,6,10,1506,5,395,18.0,127.0,127.0,5,1111,17.0,843.0,843.0
0.003,17,2,160,1,72,0.0,44.0,44.0,1,88,0.0,60.0,60.0
0.008,6,10,1989,5,910,2.0,642.0,642.0,5,1079,1.0,811.0,811.0
0.016,6,10,2006,5,927,4.0,659.0,659.0,5,1079,4.0,811.0,811.0
10.79,17,28,4417,14,1993,821.0,268.0,114.0,14,2424,821.0,587.0,145.0
0.078,6,10,1506,5,395,17.0,127.0,127.0,5,1111,18.0,843.0,843.0
40.061,17,10,676,5,460,10014.0,104.0,64.0,5,216,10014.0,20.0,15.0
0.004,17,2,162,1,65,0.0,37.0,37.0,1,97,0.0,69.0,69.0
0.089,17,4,596,2,122,49.0,33.0,33.0,2,474,51.0,323.0,209.0
0.041,17,2,136,1,60,0.0,32.0,32.0,1,76,0.0,48.0,48.0
0.016,6,10,1972,5,910,4.0,642.0,642.0,5,1062,3.0,794.0,794.0
172.156,17,76,10924,38,2538,4652.0,44.0,38.0,38,8386,4652.0,239.0,192.0
0.006,17,2,169,1,62,0.0,34.0,34.0,1,107,0.0,79.0,79.0
0.006,6,10,1643,5,860,1.0,592.0,592.0,5,783,1.0,515.0,515.0
0.071,17,2,144,1,64,0.0,36.0,36.0,1,80,0.0,52.0,52.0
0.014,6,10,1990,5,911,3.0,643.0,643.0,5,1079,3.0,811.0,811.0
0.095,6,10,1506,5,395,20.0,127.0,127.0,5,1111,18.0,843.0,843.0
0.008,6,10,1762,5,911,2.0,643.0,643.0,5,851,2.0,583.0,583.0
11.155,17,28,4422,14,1994,845.0,269.0,114.0,14,2428,845.0,587.0,145.0
0.013,6,10,1990,5,911,3.0,643.0,643.0,5,1079,3.0,811.0,811.0
40.054,17,10,676,5,460,10011.0,104.0,64.0,5,216,10012.0,20.0,15.0
0.004,17,4,284,2,120,0.0,32.0,32.0,2,164,1.0,60.0,54.0
0.005,6,10,2006,5,927,1.0,659.0,659.0,5,1079,1.0,811.0,811.0
0.15,6,10,1506,5,395,35.0,127.0,127.0,5,1111,36.0,843.0,843.0
0.05,17,2,214,1,75,0.0,47.0,47.0,1,139,0.0,111.0,111.0
0.01,6,10,1990,5,911,2.0,643.0,643.0,5,1079,2.0,811.0,811.0
0.112,6,10,1506,5,395,24.0,127.0,127.0,5,1111,23.0,843.0,843.0
0.005,6,10,2006,5,927,1.0,659.0,659.0,5,1079,1.0,811.0,811.0
0.018,6,10,1989,5,910,4.0,642.0,642.0,5,1079,4.0,811.0,811.0
0.005,6,10,1854,5,889,1.0,621.0,621.0,5,965,1.0,697.0,697.0
10.97,17,26,4069,13,2139,905.0,586.0,136.0,13,1930,905.0,269.0,120.0
0.001,17,2,180,1,66,0.0,38.0,38.0,1,114,0.0,86.0,86.0
0.005,6,13,3690,7,452,0.0,80.0,80.0,6,3238,1.0,1470.0,1459.0
0.016,6,10,1989,5,910,3.0,642.0,642.0,5,1079,3.0,811.0,811.0
0.013,6,10,1989,5,910,3.0,642.0,642.0,5,1079,3.0,811.0,811.0
311.394,17,20,1124,10,716,34590.0,48.0,43.0,10,408,34586.0,20.0,12.0
325.424,17,20,1124,10,716,36144.0,48.0,43.0,10,408,36144.0,20.0,12.0
75.084,6,75,68471,40,43367,1925.0,2804.0,1794.0,35,25104,2203.0,2822.0,1293.0
0.005,6,10,2007,5,928,1.0,660.0,660.0,5,1079,1.0,811.0,811.0
0.01,6,10,1989,5,927,2.0,659.0,659.0,5,1062,2.0,794.0,794.0
0.017,6,10,1989,5,910,4.0,642.0,642.0,5,1079,4.0,811.0,811.0
0.004,17,2,136,1,60,0.0,32.0,32.0,1,76,0.0,48.0,48.0
40.056,17,10,676,5,460,10012.0,104.0,64.0,5,216,10013.0,20.0,15.0
241.318,6,48,22987,23,3360,10969.0,944.0,271.0,25,19627,10054.0,2804.0,1017.0
0.009,6,10,1989,5,910,2.0,642.0,642.0,5,1079,2.0,811.0,811.0
0.169,6,3,453,2,321,169.0,241.0,241.0,1,132,0.0,92.0,92.0
0.005,6,10,1989,5,927,1.0,659.0,659.0,5,1062,1.0,794.0,794.0
0.005,6,10,1854,5,889,1.0,621.0,621.0,5,965,1.0,697.0,697.0
0.005,6,10,1989,5,927,1.0,659.0,659.0,5,1062,1.0,794.0,794.0
0.004,6,10,2007,5,928,1.0,660.0,660.0,5,1079,1.0,811.0,811.0
0.011,6,13,3735,7,497,1.0,125.0,125.0,6,3238,2.0,1470.0,1459.0
0.041,17,2,170,1,65,0.0,37.0,37.0,1,105,0.0,77.0,77.0
0.007,6,10,1854,5,889,1.0,621.0,621.0,5,965,1.0,697.0,697.0
0.061,6,10,1506,5,395,14.0,127.0,127.0,5,1111,12.0,843.0,843.0
0.127,17,4,352,2,130,1.0,37.0,37.0,2,222,87.0,89.0,83.0
0.117,6,10,1506,5,395,26.0,127.0,127.0,5,1111,23.0,843.0,843.0
0.076,6,10,1506,5,395,15.0,127.0,127.0,5,1111,18.0,843.0,843.0
0.091,6,10,1506,5,395,22.0,127.0,127.0,5,1111,20.0,843.0,843.0
0.087,6,10,1506,5,395,19.0,127.0,127.0,5,1111,20.0,843.0,843.0
361.764,6,19,1689,15,978,25840.0,190.0,190.0,4,711,80014.0,495.0,495.0
10.997,17,28,4420,14,1995,837.0,270.0,114.0,14,2425,837.0,588.0,145.0
0.004,6,10,2006,5,927,1.0,659.0,659.0,5,1079,0.0,811.0,811.0
0.076,6,10,1506,5,395,18.0,127.0,127.0,5,1111,16.0,843.0,843.0
0.012,6,10,1972,5,910,2.0,642.0,642.0,5,1062,3.0,794.0,794.0
309.842,17,20,1124,10,716,34413.0,48.0,43.0,10,408,34413.0,20.0,12.0
0.082,6,10,1506,5,395,16.0,127.0,127.0,5,1111,18.0,843.0,843.0
0.062,6,10,1506,5,395,13.0,127.0,127.0,5,1111,15.0,843.0,843.0
0.005,6,10,1689,5,839,1.0,571.0,571.0,5,850,1.0,582.0,582.0
0.005,6,10,1643,5,860,1.0,592.0,592.0,5,783,1.0,515.0,515.0
10.81,17,28,4423,14,1995,822.0,270.0,114.0,14,2428,822.0,587.0,145.0
11.183,17,28,4423,14,1995,847.0,270.0,114.0,14,2428,847.0,587.0,145.0
0.006,6,14,3736,7,446,0.0,74.0,74.0,7,3290,0.0,1448.0,972.0
1782.842,6,277,38157,114,21391,15776.0,2720.0,190.0,163,16766,11004.0,1360.0,129.0
0.017,6,10,1983,5,910,4.0,642.0,642.0,5,1073,4.0,805.0,805.0
0.008,6,10,2006,5,927,2.0,659.0,659.0,5,1079,2.0,811.0,811.0
0.005,6,10,2000,5,927,1.0,659.0,659.0,5,1073,1.0,805.0,805.0
10.812,17,28,4422,14,1994,823.0,269.0,114.0,14,2428,823.0,587.0,145.0
240.282,6,43,8773,21,5686,12013.0,1515.0,509.0,22,3087,11441.0,580.0,241.0
0.008,6,10,1990,5,911,2.0,643.0,643.0,5,1079,1.0,811.0,811.0
0.004,6,10,2007,5,928,1.0,660.0,660.0,5,1079,1.0,811.0,811.0
0.005,6,10,2006,5,927,1.0,659.0,659.0,5,1079,1.0,811.0,811.0
0.013,6,10,1990,5,911,3.0,643.0,643.0,5,1079,3.0,811.0,811.0
0.005,6,10,2006,5,927,1.0,659.0,659.0,5,1079,1.0,811.0,811.0
0.004,6,10,2006,5,927,1.0,659.0,659.0,5,1079,1.0,811.0,811.0
0.038,17,2,170,1,65,0.0,37.0,37.0,1,105,0.0,77.0,77.0
0.016,6,10,1990,5,911,4.0,643.0,643.0,5,1079,3.0,811.0,811.0
0.008,6,10,1762,5,911,1.0,643.0,643.0,5,851,2.0,583.0,583.0
0.001,17,2,180,1,66,0.0,38.0,38.0,1,114,0.0,86.0,86.0
0.006,6,10,1689,5,839,1.0,571.0,571.0,5,850,1.0,582.0,582.0
0.012,6,10,1983,5,910,3.0,642.0,642.0,5,1073,2.0,805.0,805.0
0.005,6,10,2007,5,928,1.0,660.0,660.0,5,1079,1.0,811.0,811.0
0.101,6,10,1506,5,395,20.0,127.0,127.0,5,1111,22.0,843.0,843.0
0.004,17,2,144,1,64,0.0,36.0,36.0,1,80,0.0,52.0,52.0
40.065,17,10,676,5,460,10013.0,104.0,64.0,5,216,10014.0,20.0,15.0
0.011,6,10,1762,5,911,2.0,643.0,643.0,5,851,2.0,583.0,583.0
0.001,17,2,180,1,66,0.0,38.0,38.0,1,114,0.0,86.0,86.0
0.008,6,10,1989,5,910,2.0,642.0,642.0,5,1079,2.0,811.0,811.0
0.006,6,10,1547,5,764,1.0,496.0,496.0,5,783,1.0,515.0,515.0
0.052,17,2,152,1,76,0.0,48.0,48.0,1,76,0.0,48.0,48.0
371.229,6,22,2313,16,867,24748.0,195.0,195.0,6,1446,4644.0,419.0,398.0
0.016,6,10,1989,5,910,4.0,642.0,642.0,5,1079,3.0,811.0,811.0
65.624,6,28,17652,15,9656,4687.0,2804.0,1478.0,13,7996,5455.0,2315.0,1044.0
0.065,6,10,1506,5,395,15.0,127.0,127.0,5,1111,14.0,843.0,843.0
300.398,6,16,2182,9,696,37527.0,146.0,146.0,7,1486,50038.0,419.0,398.0
0.024,6,10,1983,5,910,6.0,642.0,642.0,5,1073,5.0,805.0,805.0
0.005,6,10,2007,5,928,1.0,660.0,660.0,5,1079,1.0,811.0,811.0
0.005,6,10,2007,5,928,1.0,660.0,660.0,5,1079,1.0,811.0,811.0
15.079,17,15,9238,8,6902,2150.0,1350.0,834.0,7,2336,2507.0,1350.0,305.0
0.006,17,2,166,1,75,0.0,47.0,47.0,1,91,0.0,63.0,63.0
0.071,17,4,284,2,120,0.0,32.0,32.0,2,164,67.0,60.0,54.0
351.987,6,20,2210,6,1308,12003.0,494.0,494.0,14,902,27075.0,83.0,83.0
0.042,17,2,166,1,75,0.0,47.0,47.0,1,91,0.0,63.0,63.0
0.011,6,10,1983,5,910,2.0,642.0,642.0,5,1073,2.0,805.0,805.0
0.005,6,10,2000,5,927,1.0,659.0,659.0,5,1073,1.0,805.0,805.0
320.179,6,42,2784,17,1232,20011.0,46.0,46.0,25,1552,13335.0,46.0,46.0
11.204,17,28,4424,14,1995,849.0,270.0,114.0,14,2429,849.0,588.0,145.0
10.924,17,28,4421,14,1994,831.0,269.0,114.0,14,2427,831.0,586.0,145.0
0.032,6,10,1983,5,910,8.0,642.0,642.0,5,1073,8.0,805.0,805.0
0.005,6,10,1989,5,927,1.0,659.0,659.0,5,1062,1.0,794.0,794.0
0.011,6,10,1989,5,910,2.0,642.0,642.0,5,1079,2.0,811.0,811.0
0.125,6,10,1506,5,395,30.0,127.0,127.0,5,1111,26.0,843.0,843.0
0.005,6,10,2006,5,927,1.0,659.0,659.0,5,1079,1.0,811.0,811.0
0.07,17,8,3613,4,1874,23.0,1350.0,440.0,4,1739,12.0,1350.0,406.0
0.095,6,10,1506,5,395,20.0,127.0,127.0,5,1111,19.0,843.0,843.0
0.005,17,2,170,1,65,0.0,37.0,37.0,1,105,0.0,77.0,77.0
0.005,6,10,1774,5,923,1.0,655.0,655.0,5,851,1.0,583.0,583.0
0.004,17,2,148,1,60,0.0,32.0,32.0,1,88,0.0,60.0,60.0
0.005,6,10,2006,5,927,1.0,659.0,659.0,5,1079,1.0,811.0,811.0
0.075,6,10,1506,5,395,16.0,127.0,127.0,5,1111,15.0,843.0,843.0
0.005,6,10,1779,5,928,1.0,660.0,660.0,5,851,1.0,583.0,583.0
0.006,17,2,170,1,65,0.0,37.0,37.0,1,105,0.0,77.0,77.0
1792.505,6,563,190051,293,164541,6138.0,2883.0,848.0,270,25510,6663.0,387.0,114.0
0.068,17,8,3613,4,1874,22.0,1350.0,440.0,4,1739,12.0,1350.0,406.0
0.004,6,10,1774,5,923,1.0,655.0,655.0,5,851,1.0,583.0,583.0
1778.357,17,144,45504,72,22752,25047.0,288.0,288.0,72,22752,25047.0,288.0,288.0
0.005,6,10,2006,5,927,1.0,659.0,659.0,5,1079,1.0,811.0,811.0
0.009,6,10,1972,5,910,2.0,642.0,642.0,5,1062,2.0,794.0,794.0
301.022,6,44,17696,24,12098,13087.0,2720.0,1234.0,20,5598,463.0,2667.0,435.0
0.089,17,2,80,1,32,0.0,4.0,4.0,1,48,0.0,20.0,20.0
0.092,6,10,1506,5,395,20.0,127.0,127.0,5,1111,20.0,843.0,843.0
0.005,17,2,164,1,74,0.0,46.0,46.0,1,90,0.0,62.0,62.0
0.006,6,10,1989,5,927,1.0,659.0,659.0,5,1062,1.0,794.0,794.0
0.015,6,10,1631,5,848,3.0,580.0,580.0,5,783,3.0,515.0,515.0
0.005,17,2,140,1,62,0.0,34.0,34.0,1,78,0.0,50.0,50.0
0.005,6,10,1989,5,927,1.0,659.0,659.0,5,1062,1.0,794.0,794.0
0.057,17,2,179,1,71,0.0,43.0,43.0,1,108,0.0,80.0,80.0
0.004,6,10,2006,5,927,1.0,659.0,659.0,5,1079,1.0,811.0,811.0
0.005,6,10,2007,5,928,1.0,660.0,660.0,5,1079,1.0,811.0,811.0
0.097,6,10,1506,5,395,22.0,127.0,127.0,5,1111,20.0,843.0,843.0
0.11,6,10,1506,5,395,24.0,127.0,127.0,5,1111,25.0,843.0,843.0
0.086,6,10,1506,5,395,19.0,127.0,127.0,5,1111,18.0,843.0,843.0
0.005,17,2,170,1,65,0.0,37.0,37.0,1,105,0.0,77.0,77.0
15.073,17,15,9238,8,6902,2149.0,1350.0,834.0,7,2336,2507.0,1350.0,305.0
0.005,6,10,2006,5,927,1.0,659.0,659.0,5,1079,1.0,811.0,811.0
0.014,6,10,1989,5,910,3.0,642.0,642.0,5,1079,3.0,811.0,811.0
0.008,6,10,1689,5,839,1.0,571.0,571.0,5,850,2.0,582.0,582.0
240.014,6,9,787,5,488,60003.0,232.0,232.0,4,299,80003.0,83.0,83.0
0.062,6,10,1506,5,395,14.0,127.0,127.0,5,1111,15.0,843.0,843.0
0.074,6,10,1506,5,395,16.0,127.0,127.0,5,1111,16.0,843.0,843.0
0.005,17,4,495,2,132,0.0,38.0,38.0,2,363,2.0,176.0,153.0
0.012,6,10,1989,5,910,2.0,642.0,642.0,5,1079,3.0,811.0,811.0
0.012,6,10,1990,5,911,3.0,643.0,643.0,5,1079,3.0,811.0,811.0
0.015,6,10,1990,5,911,3.0,643.0,643.0,5,1079,3.0,811.0,811.0
0.005,6,10,2007,5,928,1.0,660.0,660.0,5,1079,1.0,811.0,811.0
0.081,6,10,1506,5,395,18.0,127.0,127.0,5,1111,16.0,843.0,843.0
0.006,6,10,2000,5,927,1.0,659.0,659.0,5,1073,1.0,805.0,805.0
0.137,17,2,80,1,32,0.0,4.0,4.0,1,48,0.0,20.0,20.0
300.304,6,27,7433,16,1409,20020.0,217.0,142.0,11,6024,24026.0,1679.0,777.0
0.074,6,10,1506,5,395,17.0,127.0,127.0,5,1111,15.0,843.0,843.0
300.392,6,16,2170,9,684,37528.0,146.0,146.0,7,1486,50037.0,419.0,398.0
0.007,6,10,1989,5,910,1.0,642.0,642.0,5,1079,1.0,811.0,811.0
0.017,6,10,1972,5,910,4.0,642.0,642.0,5,1062,4.0,794.0,794.0
0.005,6,13,3747,7,509,0.0,137.0,137.0,6,3238,1.0,1470.0,1459.0
0.128,17,2,148,1,60,0.0,32.0,32.0,1,88,0.0,60.0,60.0
0.003,17,2,136,1,60,0.0,32.0,32.0,1,76,0.0,48.0,48.0
0.005,6,10,1779,5,928,1.0,660.0,660.0,5,851,1.0,583.0,583.0
0.109,6,10,1506,5,395,24.0,127.0,127.0,5,1111,24.0,843.0,843.0
0.005,6,10,2006,5,927,1.0,659.0,659.0,5,1079,1.0,811.0,811.0
0.006,6,10,1689,5,839,1.0,571.0,571.0,5,850,1.0,582.0,582.0
0.012,6,10,1762,5,911,3.0,643.0,643.0,5,851,3.0,583.0,583.0
0.018,6,10,1972,5,910,4.0,642.0,642.0,5,1062,4.0,794.0,794.0
0.059,6,10,1506,5,395,12.0,127.0,127.0,5,1111,13.0,843.0,843.0
0.006,17,2,144,1,64,0.0,36.0,36.0,1,80,0.0,52.0,52.0
40.067,17,10,676,5,460,10015.0,104.0,64.0,5,216,10015.0,20.0,15.0
0.008,6,10,1972,5,910,2.0,642.0,642.0,5,1062,1.0,794.0,794.0
240.022,6,9,787,5,488,60005.0,232.0,232.0,4,299,80004.0,83.0,83.0
0.005,6,10,1989,5,927,1.0,659.0,659.0,5,1062,1.0,794.0,794.0
0.004,17,2,186,1,61,0.0,33.0,33.0,1,125,0.0,97.0,97.0
0.006,6,10,1854,5,889,1.0,621.0,621.0,5,965,1.0,697.0,697.0
0.06,6,10,1506,5,395,14.0,127.0,127.0,5,1111,14.0,843.0,843.0
0.002,17,2,152,1,76,0.0,48.0,48.0,1,76,0.0,48.0,48.0
0.135,6,10,1506,5,395,33.0,127.0,127.0,5,1111,28.0,843.0,843.0
0.012,6,10,1989,5,910,2.0,642.0,642.0,5,1079,2.0,811.0,811.0
0.001,17,2,140,1,62,0.0,34.0,34.0,1,78,0.0,50.0,50.0
11.212,17,28,4422,14,1994,849.0,269.0,114.0,14,2428,849.0,587.0,145.0
0.006,6,10,2007,5,928,1.0,660.0,660.0,5,1079,1.0,811.0,811.0
15.085,17,19,9639,9,7314,1882.0,1350.0,784.0,10,2325,1672.0,1350.0,204.0
0.017,6,10,1972,5,910,4.0,642.0,642.0,5,1062,4.0,794.0,794.0
0.055,17,2,148,1,60,0.0,32.0,32.0,1,88,0.0,60.0,60.0
0.022,6,10,1972,5,910,5.0,642.0,642.0,5,1062,5.0,794.0,794.0
0.027,6,10,1989,5,910,6.0,642.0,642.0,5,1079,6.0,811.0,811.0
0.01,6,14,3787,7,497,1.0,125.0,125.0,7,3290,1.0,1448.0,972.0
0.109,6,10,1506,5,395,24.0,127.0,127.0,5,1111,22.0,843.0,843.0
0.005,6,10,1779,5,928,1.0,660.0,660.0,5,851,1.0,583.0,583.0
0.012,6,10,1972,5,910,3.0,642.0,642.0,5,1062,3.0,794.0,794.0
0.013,6,10,1972,5,910,3.0,642.0,642.0,5,1062,3.0,794.0,794.0
308.836,17,20,1124,10,716,34301.0,48.0,43.0,10,408,34301.0,20.0,12.0
240.085,6,16,4481,9,963,30010.0,238.0,166.0,7,3518,40013.0,1402.0,786.0
25.493,6,11,4897,6,566,5098.0,254.0,254.0,5,4331,3.0,1402.0,1354.0
0.01,6,10,1677,5,827,2.0,559.0,559.0,5,850,2.0,582.0,582.0
0.004,6,10,1774,5,923,1.0,655.0,655.0,5,851,1.0,583.0,583.0
0.004,17,2,148,1,60,0.0,32.0,32.0,1,88,0.0,60.0,60.0
0.004,6,10,2006,5,927,1.0,659.0,659.0,5,1079,1.0,811.0,811.0
0.006,17,2,184,1,68,0.0,40.0,40.0,1,116,0.0,88.0,88.0
0.001,17,2,179,1,62,0.0,34.0,34.0,1,117,0.0,89.0,89.0
0.005,6,10,2000,5,927,1.0,659.0,659.0,5,1073,1.0,805.0,805.0
0.011,6,10,1989,5,910,2.0,642.0,642.0,5,1079,2.0,811.0,811.0
0.127,6,10,1506,5,395,29.0,127.0,127.0,5,1111,24.0,843.0,843.0
0.006,6,10,2006,5,927,1.0,659.0,659.0,5,1079,1.0,811.0,811.0
1.119,17,2,144,1,64,0.0,36.0,36.0,1,80,0.0,52.0,52.0
0.004,6,10,1989,5,927,1.0,659.0,659.0,5,1062,1.0,794.0,794.0
0.014,6,10,1990,5,911,3.0,643.0,643.0,5,1079,3.0,811.0,811.0
0.018,6,10,1990,5,911,4.0,643.0,643.0,5,1079,4.0,811.0,811.0
5.498,6,38,25524,18,15988,323.0,2804.0,2149.0,20,9536,282.0,1288.0,1212.0
0.007,6,10,2000,5,927,1.0,659.0,659.0,5,1073,1.0,805.0,805.0
0.009,6,13,3735,7,497,1.0,125.0,125.0,6,3238,1.0,1470.0,1459.0
0.005,6,13,3747,7,509,0.0,137.0,137.0,6,3238,0.0,1470.0,1459.0
0.001,17,2,136,1,60,0.0,32.0,32.0,1,76,0.0,48.0,48.0
0.006,17,2,144,1,64,0.0,36.0,36.0,1,80,0.0,52.0,52.0
40.056,17,10,676,5,460,10012.0,104.0,64.0,5,216,10011.0,20.0,15.0
0.006,17,2,236,1,64,0.0,36.0,36.0,1,172,0.0,144.0,144.0
0.004,6,10,1989,5,927,1.0,659.0,659.0,5,1062,1.0,794.0,794.0
0.056,6,10,1506,5,395,13.0,127.0,127.0,5,1111,13.0,843.0,843.0
0.007,17,2,179,1,71,0.0,43.0,43.0,1,108,0.0,80.0,80.0
0.122,6,10,1506,5,395,26.0,127.0,127.0,5,1111,27.0,843.0,843.0
0.001,17,2,179,1,62,0.0,34.0,34.0,1,117,0.0,89.0,89.0
0.001,17,2,180,1,66,0.0,38.0,38.0,1,114,0.0,86.0,86.0
0.004,17,2,148,1,60,0.0,32.0,32.0,1,88,0.0,60.0,60.0
0.015,6,10,1989,5,910,3.0,642.0,642.0,5,1079,3.0,811.0,811.0
40.071,17,10,676,5,460,10015.0,104.0,64.0,5,216,10016.0,20.0,15.0
0.077,6,10,1506,5,395,18.0,127.0,127.0,5,1111,17.0,843.0,843.0
11.032,17,27,4245,14,2017,839.0,268.0,116.0,13,2228,910.0,587.0,143.0
0.004,6,10,1774,5,923,1.0,655.0,655.0,5,851,0.0,583.0,583.0
0.002,17,2,152,1,76,0.0,48.0,48.0,1,76,0.0,48.0,48.0
0.082,6,10,1506,5,395,13.0,127.0,127.0,5,1111,18.0,843.0,843.0
0.059,6,10,1506,5,395,12.0,127.0,127.0,5,1111,13.0,843.0,843.0
0.075,6,10,1506,5,395,17.0,127.0,127.0,5,1111,16.0,843.0,843.0
0.017,6,10,1989,5,910,4.0,642.0,642.0,5,1079,4.0,811.0,811.0
0.006,17,2,202,1,69,0.0,41.0,41.0,1,133,0.0,105.0,105.0
0.005,6,10,1689,5,839,1.0,571.0,571.0,5,850,1.0,582.0,582.0
0.001,17,2,180,1,66,0.0,38.0,38.0,1,114,0.0,86.0,86.0
0.068,17,8,3613,4,1874,22.0,1350.0,440.0,4,1739,12.0,1350.0,406.0
0.005,6,10,1774,5,923,1.0,655.0,655.0,5,851,1.0,583.0,583.0
0.071,17,4,336,2,124,0.0,34.0,34.0,2,212,29.0,84.0,78.0
0.005,6,10,2007,5,928,1.0,660.0,660.0,5,1079,1.0,811.0,811.0
0.14,6,10,1506,5,395,29.0,127.0,127.0,5,1111,33.0,843.0,843.0
40.052,17,10,676,5,460,10012.0,104.0,64.0,5,216,10012.0,20.0,15.0
0.013,17,2,148,1,60,0.0,32.0,32.0,1,88,0.0,60.0,60.0
1799.649,17,122,11651,61,5551,29993.0,63.0,63.0,61,6100,29993.0,72.0,72.0
0.001,17,2,192,1,71,0.0,43.0,43.0,1,121,0.0,93.0,93.0
177.45,17,74,10491,37,2473,4929.0,44.0,38.0,37,8018,4929.0,261.0,188.0
0.005,6,10,2007,5,928,1.0,660.0,660.0,5,1079,1.0,811.0,811.0
0.004,17,4,284,2,120,0.0,32.0,32.0,2,164,0.0,60.0,54.0
0.001,17,2,154,1,69,0.0,41.0,41.0,1,85,0.0,57.0,57.0
0.008,6,10,2006,5,927,2.0,659.0,659.0,5,1079,2.0,811.0,811.0
0.013,6,10,1989,5,910,3.0,642.0,642.0,5,1079,3.0,811.0,811.0
40.07,17,10,676,5,460,10014.0,104.0,64.0,5,216,10016.0,20.0,15.0
0.005,17,2,214,1,75,0.0,47.0,47.0,1,139,0.0,111.0,111.0
0.155,6,10,1506,5,395,37.0,127.0,127.0,5,1111,37.0,843.0,843.0
0.068,6,10,1506,5,395,13.0,127.0,127.0,5,1111,16.0,843.0,843.0
0.005,6,10,1689,5,839,1.0,571.0,571.0,5,850,1.0,582.0,582.0
0.004,17,2,136,1,60,0.0,32.0,32.0,1,76,0.0,48.0,48.0
308.453,17,20,1124,10,716,34258.0,48.0,43.0,10,408,34258.0,20.0,12.0
0.004,17,2,170,1,65,0.0,37.0,37.0,1,105,0.0,77.0,77.0
0.011,6,10,1989,5,910,2.0,642.0,642.0,5,1079,2.0,811.0,811.0
1772.12,6,104,6218,59,3473,30553.0,27.0,27.0,45,2745,40274.0,27.0,27.0
0.01,6,10,1677,5,827,2.0,559.0,559.0,5,850,2.0,582.0,582.0
0.001,17,2,180,1,66,0.0,38.0,38.0,1,114,0.0,86.0,86.0
0.014,6,10,1989,5,910,3.0,642.0,642.0,5,1079,3.0,811.0,811.0
1728.931,6,61,7124,40,4332,44331.0,1625.0,112.0,21,2792,86438.0,1111.0,85.0
0.006,6,10,1547,5,764,1.0,496.0,496.0,5,783,1.0,515.0,515.0
0.022,6,10,1762,5,911,5.0,643.0,643.0,5,851,5.0,583.0,583.0
0.008,6,12,1926,6,1189,1.0,659.0,434.0,6,737,1.0,417.0,417.0
40.051,17,10,676,5,460,10011.0,104.0,64.0,5,216,10012.0,20.0,15.0
1787.321,6,154,19574,92,13852,19640.0,302.0,302.0,62,5722,29300.0,83.0,83.0
0.008,6,10,1972,5,910,1.0,642.0,642.0,5,1062,2.0,794.0,794.0
0.013,6,10,1989,5,910,3.0,642.0,642.0,5,1079,3.0,811.0,811.0
0.131,6,10,1506,5,395,31.0,127.0,127.0,5,1111,28.0,843.0,843.0
0.17,17,2,152,1,76,0.0,48.0,48.0,1,76,0.0,48.0,48.0
0.016,6,10,1983,5,910,4.0,642.0,642.0,5,1073,3.0,805.0,805.0
0.015,6,10,1631,5,848,3.0,580.0,580.0,5,783,3.0,515.0,515.0
300.732,6,36,9226,19,3748,16707.0,1360.0,591.0,17,5478,536.0,2667.0,435.0
40.058,17,10,676,5,460,10012.0,104.0,64.0,5,216,10013.0,20.0,15.0
0.015,6,10,1989,5,910,3.0,642.0,642.0,5,1079,3.0,811.0,811.0
1778.367,17,144,45504,72,22752,25047.0,288.0,288.0,72,22752,25047.0,288.0,288.0
0.018,6,10,1677,5,827,4.0,559.0,559.0,5,850,4.0,582.0,582.0
0.005,6,10,1689,5,839,1.0,571.0,571.0,5,850,1.0,582.0,582.0
0.006,6,10,2007,5,928,1.0,660.0,660.0,5,1079,1.0,811.0,811.0
0.107,6,10,1506,5,395,24.0,127.0,127.0,5,1111,23.0,843.0,843.0
0.004,17,4,284,2,120,0.0,32.0,32.0,2,164,1.0,60.0,54.0
0.009,6,10,1983,5,910,2.0,642.0,642.0,5,1073,2.0,805.0,805.0
0.015,6,13,3735,7,497,2.0,125.0,125.0,6,3238,2.0,1470.0,1459.0
0.006,17,2,166,1,75,0.0,47.0,47.0,1,91,0.0,63.0,63.0
0.125,17,2,80,1,32,0.0,4.0,4.0,1,48,0.0,20.0,20.0
9.035,17,6,376,5,280,2258.0,28.0,28.0,1,96,0.0,68.0,68.0
0.005,6,10,2006,5,927,1.0,659.0,659.0,5,1079,1.0,811.0,811.0
1799.994,6,267,43995,105,31938,17019.0,2720.0,326.0,162,12057,11179.0,1062.0,75.0
0.072,6,10,1506,5,395,12.0,127.0,127.0,5,1111,15.0,843.0,843.0
0.001,17,2,166,1,75,0.0,47.0,47.0,1,91,0.0,63.0,63.0
0.009,6,10,1989,5,910,2.0,642.0,642.0,5,1079,2.0,811.0,811.0
0.005,6,10,2006,5,927,1.0,659.0,659.0,5,1079,1.0,811.0,811.0
0.075,6,10,1506,5,395,16.0,127.0,127.0,5,1111,16.0,843.0,843.0
0.014,6,10,1989,5,910,3.0,642.0,642.0,5,1079,2.0,811.0,811.0
40.062,17,10,676,5,460,10014.0,104.0,64.0,5,216,10014.0,20.0,15.0
40.059,17,10,676,5,460,10013.0,104.0,64.0,5,216,10014.0,20.0,15.0
0.004,17,2,148,1,60,0.0,32.0,32.0,1,88,0.0,60.0,60.0
0.001,17,2,180,1,66,0.0,38.0,38.0,1,114,0.0,86.0,86.0
0.015,6,10,1983,5,910,3.0,642.0,642.0,5,1073,3.0,805.0,805.0
0.118,6,10,1506,5,395,25.0,127.0,127.0,5,1111,25.0,843.0,843.0
11.144,17,28,4418,14,1994,844.0,269.0,114.0,14,2424,844.0,587.0,145.0
0.008,6,10,1989,5,910,2.0,642.0,642.0,5,1079,1.0,811.0,811.0
0.007,17,2,194,1,59,0.0,31.0,31.0,1,135,0.0,107.0,107.0
0.13,6,10,1506,5,395,32.0,127.0,127.0,5,1111,22.0,843.0,843.0
0.078,6,10,1506,5,395,16.0,127.0,127.0,5,1111,17.0,843.0,843.0
369.5,6,22,2313,16,867,24633.0,195.0,195.0,6,1446,4641.0,419.0,398.0
317.919,17,20,1124,10,716,35317.0,48.0,43.0,10,408,35317.0,20.0,12.0
0.016,6,10,1677,5,827,4.0,559.0,559.0,5,850,4.0,582.0,582.0
0.042,17,2,152,1,76,0.0,48.0,48.0,1,76,0.0,48.0,48.0
0.005,6,13,3684,7,446,0.0,74.0,74.0,6,3238,1.0,1470.0,1459.0
0.001,17,2,180,1,66,0.0,38.0,38.0,1,114,0.0,86.0,86.0
0.005,17,2,170,1,65,0.0,37.0,37.0,1,105,0.0,77.0,77.0
0.185,6,43,11486,23,3171,8.0,1023.0,197.0,20,8315,9.0,1402.0,605.0
0.004,6,10,2006,5,927,1.0,659.0,659.0,5,1079,1.0,811.0,811.0
0.016,6,10,1990,5,911,4.0,643.0,643.0,5,1079,3.0,811.0,811.0
0.013,6,10,1989,5,910,3.0,642.0,642.0,5,1079,3.0,811.0,811.0
0.004,6,10,1989,5,927,1.0,659.0,659.0,5,1062,1.0,794.0,794.0
0.004,17,2,136,1,60,0.0,32.0,32.0,1,76,0.0,48.0,48.0
40.054,17,10,676,5,460,10012.0,104.0,64.0,5,216,10012.0,20.0,15.0
0.08,6,10,1506,5,395,17.0,127.0,127.0,5,1111,18.0,843.0,843.0
0.093,6,10,1506,5,395,21.0,127.0,127.0,5,1111,21.0,843.0,843.0
0.006,6,10,1547,5,764,1.0,496.0,496.0,5,783,1.0,515.0,515.0
0.039,17,2,152,1,76,0.0,48.0,48.0,1,76,0.0,48.0,48.0
0.004,17,2,186,1,61,0.0,33.0,33.0,1,125,0.0,97.0,97.0
0.01,6,13,3735,7,497,1.0,125.0,125.0,6,3238,2.0,1470.0,1459.0
40.066,17,10,676,5,460,10013.0,104.0,64.0,5,216,10015.0,20.0,15.0
0.074,6,10,1506,5,395,16.0,127.0,127.0,5,1111,17.0,843.0,843.0
0.011,6,10,1989,5,910,2.0,642.0,642.0,5,1079,2.0,811.0,811.0
322.839,17,20,1124,10,716,35858.0,48.0,43.0,10,408,35859.0,20.0,12.0
0.084,17,4,596,2,122,45.0,33.0,33.0,2,474,43.0,323.0,209.0
0.005,17,2,170,1,65,0.0,37.0,37.0,1,105,0.0,77.0,77.0
0.016,6,10,1972,5,910,3.0,642.0,642.0,5,1062,4.0,794.0,794.0
0.096,6,10,1506,5,395,22.0,127.0,127.0,5,1111,19.0,843.0,843.0
0.087,6,10,1506,5,395,19.0,127.0,127.0,5,1111,18.0,843.0,843.0
0.006,6,10,1854,5,889,1.0,621.0,621.0,5,965,1.0,697.0,697.0
0.136,17,4,284,2,120,1.0,32.0,32.0,2,164,60.0,60.0,54.0
0.053,17,2,152,1,76,0.0,48.0,48.0,1,76,0.0,48.0,48.0
0.095,6,10,1506,5,395,19.0,127.0,127.0,5,1111,23.0,843.0,843.0
0.004,17,2,136,1,60,0.0,32.0,32.0,1,76,0.0,48.0,48.0
0.003,17,2,148,1,60,0.0,32.0,32.0,1,88,0.0,60.0,60.0
15.083,17,15,9238,8,6902,2150.0,1350.0,834.0,7,2336,2508.0,1350.0,305.0
241.487,6,396,348781,196,21722,1238.0,2736.0,960.0,200,327059,1213.0,2804.0,1666.0
0.071,6,10,1506,5,395,16.0,127.0,127.0,5,1111,12.0,843.0,843.0
0.005,6,13,3690,7,452,0.0,80.0,80.0,6,3238,1.0,1470.0,1459.0
40.061,17,10,676,5,460,10014.0,104.0,64.0,5,216,10014.0,20.0,15.0
0.004,17,2,148,1,60,0.0,32.0,32.0,1,88,0.0,60.0,60.0
0.005,6,10,2007,5,928,1.0,660.0,660.0,5,1079,1.0,811.0,811.0
15.078,17,15,8026,8,5919,2150.0,1350.0,711.0,7,2107,2508.0,1350.0,273.0
0.009,6,10,1762,5,911,2.0,643.0,643.0,5,851,2.0,583.0,583.0
0.005,6,10,1989,5,927,1.0,659.0,659.0,5,1062,1.0,794.0,794.0
0.005,6,10,1779,5,928,1.0,660.0,660.0,5,851,1.0,583.0,583.0
148.761,6,26,9167,14,3289,91.0,1360.0,539.0,12,5878,13508.0,2720.0,897.0
0.012,6,10,1990,5,911,3.0,643.0,643.0,5,1079,2.0,811.0,811.0
0.013,6,10,1983,5,910,3.0,642.0,642.0,5,1073,3.0,805.0,805.0
37.936,6,43,18532,22,12894,431.0,4080.0,1497.0,21,5638,1888.0,2667.0,435.0
0.011,6,10,1989,5,910,2.0,642.0,642.0,5,1079,2.0,811.0,811.0
0.005,6,10,2006,5,927,1.0,659.0,659.0,5,1079,1.0,811.0,811.0
10.891,17,28,4422,14,1994,829.0,269.0,114.0,14,2428,829.0,587.0,145.0
0.004,6,10,1779,5,928,1.0,660.0,660.0,5,851,1.0,583.0,583.0
0.019,6,10,1762,5,911,4.0,643.0,643.0,5,851,4.0,583.0,583.0
0.005,6,10,1854,5,889,1.0,621.0,621.0,5,965,1.0,697.0,697.0
0.012,6,10,1631,5,848,2.0,580.0,580.0,5,783,3.0,515.0,515.0
240.022,6,9,787,5,488,60005.0,232.0,232.0,4,299,80006.0,83.0,83.0
0.004,6,10,1774,5,923,1.0,655.0,655.0,5,851,1.0,583.0,583.0
0.019,6,10,1677,5,827,4.0,559.0,559.0,5,850,4.0,582.0,582.0
0.072,17,4,284,2,120,0.0,32.0,32.0,2,164,66.0,60.0,54.0
0.071,6,10,1506,5,395,15.0,127.0,127.0,5,1111,15.0,843.0,843.0
1778.45,17,141,44556,72,22752,25047.0,288.0,288.0,69,21804,26151.0,288.0,288.0
1776.751,6,279,39383,115,22577,15584.0,2720.0,197.0,164,16806,10899.0,1360.0,129.0
0.006,6,10,1989,5,927,1.0,659.0,659.0,5,1062,1.0,794.0,794.0
0.013,17,2,152,1,56,0.0,28.0,28.0,1,96,0.0,68.0,68.0
240.17,6,40,5278,20,2426,12640.0,588.0,196.0,20,2852,12640.0,580.0,225.0
0.226,6,16,2777,8,1395,32.0,533.0,323.0,8,1382,20.0,529.0,239.0
0.006,17,2,170,1,65,0.0,37.0,37.0,1,105,0.0,77.0,77.0
0.005,6,10,1643,5,860,1.0,592.0,592.0,5,783,1.0,515.0,515.0
0.01,6,10,1990,5,911,2.0,643.0,643.0,5,1079,2.0,811.0,811.0
40.088,17,10,676,5,460,10019.0,104.0,64.0,5,216,10021.0,20.0,15.0
0.088,6,10,1506,5,395,18.0,127.0,127.0,5,1111,20.0,843.0,843.0
0.005,6,10,2000,5,927,1.0,659.0,659.0,5,1073,1.0,805.0,805.0
0.011,6,10,1972,5,910,2.0,642.0,642.0,5,1062,2.0,794.0,794.0
0.014,6,14,3787,7,497,2.0,125.0,125.0,7,3290,2.0,1448.0,972.0
0.008,6,12,1926,6,1189,1.0,659.0,434.0,6,737,1.0,417.0,417.0
0.005,6,10,1689,5,839,1.0,571.0,571.0,5,850,1.0,582.0,582.0
0.005,6,10,1774,5,923,1.0,655.0,655.0,5,851,1.0,583.0,583.0
1730.431,6,48,2957,31,1800,57681.0,35.0,35.0,17,1157,108147.0,31.0,31.0
240.069,6,21,4926,11,941,24006.0,180.0,93.0,10,3985,26674.0,1593.0,576.0
0.079,6,10,1506,5,395,16.0,127.0,127.0,5,1111,19.0,843.0,843.0
0.115,6,10,1506,5,395,26.0,127.0,127.0,5,1111,26.0,843.0,843.0
0.014,6,10,1989,5,910,3.0,642.0,642.0,5,1079,3.0,811.0,811.0
0.088,6,10,1506,5,395,20.0,127.0,127.0,5,1111,19.0,843.0,843.0
0.009,6,10,1989,5,910,2.0,642.0,642.0,5,1079,2.0,811.0,811.0
0.005,17,2,193,1,71,0.0,43.0,43.0,1,122,0.0,94.0,94.0
0.04,17,4,284,2,120,1.0,32.0,32.0,2,164,36.0,60.0,54.0
0.145,6,10,1506,5,395,33.0,127.0,127.0,5,1111,32.0,843.0,843.0
0.01,6,10,1983,5,910,2.0,642.0,642.0,5,1073,2.0,805.0,805.0
0.017,6,10,1972,5,910,4.0,642.0,642.0,5,1062,4.0,794.0,794.0
0.007,6,10,2007,5,928,1.0,660.0,660.0,5,1079,1.0,811.0,811.0
0.016,6,10,1631,5,848,4.0,580.0,580.0,5,783,3.0,515.0,515.0
0.004,6,10,2006,5,927,1.0,659.0,659.0,5,1079,1.0,811.0,811.0
0.014,6,10,1983,5,910,3.0,642.0,642.0,5,1073,3.0,805.0,805.0
0.005,6,10,2007,5,928,1.0,660.0,660.0,5,1079,1.0,811.0,811.0
0.012,6,10,1972,5,910,3.0,642.0,642.0,5,1062,2.0,794.0,794.0
240.122,6,30,9353,15,7129,17151.0,2253.0,705.0,15,2224,17150.0,580.0,205.0
0.02,6,10,1990,5,911,4.0,643.0,643.0,5,1079,5.0,811.0,811.0
0.005,17,2,160,1,72,0.0,44.0,44.0,1,88,0.0,60.0,60.0
240.3,6,31,8947,16,6661,16020.0,1886.0,648.0,15,2286,17164.0,580.0,187.0
0.078,6,10,1506,5,395,18.0,127.0,127.0,5,1111,17.0,843.0,843.0
0.13,6,10,1506,5,395,27.0,127.0,127.0,5,1111,26.0,843.0,843.0
0.013,6,10,1990,5,911,3.0,643.0,643.0,5,1079,3.0,811.0,811.0
0.003,17,2,148,1,60,0.0,32.0,32.0,1,88,0.0,60.0,60.0
40.067,17,10,676,5,460,10015.0,104.0,64.0,5,216,10016.0,20.0,15.0
0.117,6,10,1506,5,395,27.0,127.0,127.0,5,1111,26.0,843.0,843.0
0.114,6,10,1506,5,395,25.0,127.0,127.0,5,1111,22.0,843.0,843.0
0.083,6,10,1506,5,395,17.0,127.0,127.0,5,1111,17.0,843.0,843.0
0.013,6,10,1972,5,910,3.0,642.0,642.0,5,1062,3.0,794.0,794.0
0.005,6,10,2000,5,927,1.0,659.0,659.0,5,1073,1.0,805.0,805.0
0.007,6,10,1972,5,910,1.0,642.0,642.0,5,1062,1.0,794.0,794.0
0.004,6,10,2007,5,928,1.0,660.0,660.0,5,1079,1.0,811.0,811.0
0.012,6,10,1989,5,910,3.0,642.0,642.0,5,1079,3.0,811.0,811.0
10.792,17,24,3783,12,1674,971.0,269.0,111.0,12,2109,971.0,588.0,147.0
0.203,6,16,2669,8,1395,29.0,533.0,323.0,8,1274,18.0,529.0,212.0
0.005,17,2,194,1,59,0.0,31.0,31.0,1,135,0.0,107.0,107.0
0.004,17,2,136,1,60,0.0,32.0,32.0,1,76,0.0,48.0,48.0
0.005,6,10,2007,5,928,1.0,660.0,660.0,5,1079,1.0,811.0,811.0
0.005,6,10,1989,5,927,1.0,659.0,659.0,5,1062,1.0,794.0,794.0
0.079,6,10,1506,5,395,18.0,127.0,127.0,5,1111,19.0,843.0,843.0
0.005,6,10,2006,5,927,1.0,659.0,659.0,5,1079,1.0,811.0,811.0
0.012,6,10,1631,5,848,3.0,580.0,580.0,5,783,3.0,515.0,515.0
0.218,6,10,1506,5,395,51.0,127.0,127.0,5,1111,52.0,843.0,843.0
0.013,6,10,1990,5,911,3.0,643.0,643.0,5,1079,3.0,811.0,811.0
0.005,6,14,3736,7,446,0.0,74.0,74.0,7,3290,0.0,1448.0,972.0
0.009,6,10,1990,5,911,2.0,643.0,643.0,5,1079,2.0,811.0,811.0
300.338,6,16,2170,9,684,37522.0,146.0,146.0,7,1486,50029.0,419.0,398.0
0.005,17,2,164,1,74,0.0,46.0,46.0,1,90,0.0,62.0,62.0
0.009,6,10,1989,5,910,2.0,642.0,642.0,5,1079,2.0,811.0,811.0
40.056,17,10,676,5,460,10013.0,104.0,64.0,5,216,10013.0,20.0,15.0
0.073,6,10,1506,5,395,17.0,127.0,127.0,5,1111,17.0,843.0,843.0
0.006,6,10,1854,5,889,1.0,621.0,621.0,5,965,1.0,697.0,697.0
0.004,6,10,2006,5,927,1.0,659.0,659.0,5,1079,1.0,811.0,811.0
0.012,6,6,716,3,458,5.0,302.0,302.0,3,258,4.0,102.0,102.0
0.004,6,10,1779,5,928,1.0,660.0,660.0,5,851,1.0,583.0,583.0
0.005,6,10,2006,5,927,1.0,659.0,659.0,5,1079,1.0,811.0,811.0
0.037,17,2,234,1,61,0.0,33.0,33.0,1,173,0.0,145.0,145.0
0.005,6,13,3690,7,452,0.0,80.0,80.0,6,3238,1.0,1470.0,1459.0
0.001,17,2,180,1,66,0.0,38.0,38.0,1,114,0.0,86.0,86.0
0.111,6,10,1506,5,395,24.0,127.0,127.0,5,1111,25.0,843.0,843.0
0.103,6,10,1506,5,395,23.0,127.0,127.0,5,1111,22.0,843.0,843.0
240.51,6,33,8638,17,1838,15029.0,571.0,189.0,16,6800,16031.0,1402.0,597.0
0.004,6,10,1774,5,923,1.0,655.0,655.0,5,851,1.0,583.0,583.0
0.004,6,10,2006,5,927,1.0,659.0,659.0,5,1079,1.0,811.0,811.0
0.005,17,2,179,1,71,0.0,43.0,43.0,1,108,0.0,80.0,80.0
0.009,6,10,1677,5,827,2.0,559.0,559.0,5,850,2.0,582.0,582.0
15.137,17,17,10673,9,8280,1885.0,1350.0,892.0,8,2393,2152.0,1350.0,271.0
0.056,6,10,1506,5,395,13.0,127.0,127.0,5,1111,12.0,843.0,843.0
0.043,17,2,152,1,76,0.0,48.0,48.0,1,76,0.0,48.0,48.0
0.009,6,12,1926,6,1189,1.0,659.0,434.0,6,737,1.0,417.0,417.0
0.11,6,10,1506,5,395,24.0,127.0,127.0,5,1111,24.0,843.0,843.0
0.098,6,10,1506,5,395,21.0,127.0,127.0,5,1111,23.0,843.0,843.0
0.013,6,10,1989,5,910,3.0,642.0,642.0,5,1079,3.0,811.0,811.0
0.089,6,10,1506,5,395,20.0,127.0,127.0,5,1111,17.0,843.0,843.0
0.001,17,2,180,1,66,0.0,38.0,38.0,1,114,0.0,86.0,86.0
0.17,6,10,1506,5,395,38.0,127.0,127.0,5,1111,41.0,843.0,843.0
0.114,17,4,596,2,122,111.0,33.0,33.0,2,474,110.0,323.0,209.0
0.004,6,10,1989,5,927,1.0,659.0,659.0,5,1062,1.0,794.0,794.0
0.004,6,10,1702,5,863,1.0,595.0,595.0,5,839,1.0,571.0,571.0
0.007,6,10,1689,5,839,1.0,571.0,571.0,5,850,1.0,582.0,582.0
0.312,17,4,352,2,130,182.0,37.0,37.0,2,222,240.0,89.0,83.0
40.066,17,10,676,5,460,10013.0,104.0,64.0,5,216,10015.0,20.0,15.0
1772.307,6,106,6322,60,3525,30038.0,27.0,27.0,46,2797,39383.0,27.0,27.0
0.039,17,2,148,1,60,0.0,32.0,32.0,1,88,0.0,60.0,60.0
0.004,6,10,1989,5,927,1.0,659.0,659.0,5,1062,1.0,794.0,794.0
0.001,17,2,166,1,75,0.0,47.0,47.0,1,91,0.0,63.0,63.0
0.006,6,10,1689,5,839,1.0,571.0,571.0,5,850,1.0,582.0,582.0
0.06,6,10,1506,5,395,12.0,127.0,127.0,5,1111,14.0,843.0,843.0
0.009,6,10,1989,5,910,2.0,642.0,642.0,5,1079,2.0,811.0,811.0
0.005,6,10,2006,5,927,1.0,659.0,659.0,5,1079,1.0,811.0,811.0
0.001,17,2,179,1,62,0.0,34.0,34.0,1,117,0.0,89.0,89.0
0.007,17,2,299,1,65,0.0,37.0,37.0,1,234,0.0,206.0,206.0
0.006,6,10,1547,5,764,1.0,496.0,496.0,5,783,1.0,515.0,515.0
0.066,6,10,1506,5,395,14.0,127.0,127.0,5,1111,14.0,843.0,843.0
0.093,6,10,1506,5,395,17.0,127.0,127.0,5,1111,21.0,843.0,843.0
0.005,17,2,169,1,62,0.0,34.0,34.0,1,107,0.0,79.0,79.0
0.098,6,10,1506,5,395,20.0,127.0,127.0,5,1111,22.0,843.0,843.0
0.004,6,10,2007,5,928,1.0,660.0,660.0,5,1079,1.0,811.0,811.0
0.005,6,10,2006,5,927,1.0,659.0,659.0,5,1079,1.0,811.0,811.0
0.043,17,2,152,1,76,0.0,48.0,48.0,1,76,0.0,48.0,48.0
0.006,6,10,1643,5,860,1.0,592.0,592.0,5,783,1.0,515.0,515.0
0.004,17,2,148,1,60,0.0,32.0,32.0,1,88,0.0,60.0,60.0
0.004,6,10,2000,5,927,1.0,659.0,659.0,5,1073,1.0,805.0,805.0
0.005,6,10,1989,5,927,1.0,659.0,659.0,5,1062,1.0,794.0,794.0
0.091,6,10,1506,5,395,19.0,127.0,127.0,5,1111,18.0,843.0,843.0
0.012,6,10,1989,5,910,3.0,642.0,642.0,5,1079,3.0,811.0,811.0
0.068,17,8,3613,4,1874,22.0,1350.0,440.0,4,1739,11.0,1350.0,406.0
0.219,17,14,8577,7,4012,36.0,1350.0,545.0,7,4565,27.0,1350.0,624.0
0.004,17,2,148,1,60,0.0,32.0,32.0,1,88,0.0,60.0,60.0
0.012,6,10,1990,5,911,2.0,643.0,643.0,5,1079,3.0,811.0,811.0
0.004,17,2,148,1,60,0.0,32.0,32.0,1,88,0.0,60.0,60.0
0.006,17,2,179,1,71,0.0,43.0,43.0,1,108,0.0,80.0,80.0
0.041,17,2,152,1,76,0.0,48.0,48.0,1,76,0.0,48.0,48.0
0.005,6,13,3747,7,509,0.0,137.0,137.0,6,3238,1.0,1470.0,1459.0
0.005,6,10,2007,5,928,1.0,660.0,660.0,5,1079,1.0,811.0,811.0
1772.71,6,288,42575,118,25146,15150.0,2801.0,223.0,170,17429,10488.0,1360.0,131.0
0.009,6,10,1989,5,927,2.0,659.0,659.0,5,1062,2.0,794.0,794.0
0.014,6,10,1972,5,910,3.0,642.0,642.0,5,1062,3.0,794.0,794.0
0.005,6,13,3747,7,509,0.0,137.0,137.0,6,3238,1.0,1470.0,1459.0
1.091,6,28,10518,15,1627,77.0,517.0,211.0,13,8891,90.0,1402.0,911.0
310.21,17,20,1124,10,716,34453.0,48.0,43.0,10,408,34453.0,20.0,12.0
0.006,6,10,1547,5,764,1.0,496.0,496.0,5,783,1.0,515.0,515.0
0.004,17,2,175,1,65,0.0,37.0,37.0,1,110,0.0,82.0,82.0
0.078,6,10,1506,5,395,17.0,127.0,127.0,5,1111,16.0,843.0,843.0
240.182,6,52,24986,24,2240,10442.0,590.0,196.0,28,22746,8895.0,1577.0,1014.0
0.004,6,10,2007,5,928,1.0,660.0,660.0,5,1079,1.0,811.0,811.0
0.005,6,10,1989,5,927,1.0,659.0,659.0,5,1062,1.0,794.0,794.0
0.006,6,10,1854,5,889,1.0,621.0,621.0,5,965,1.0,697.0,697.0
0.004,6,10,1779,5,928,1.0,660.0,660.0,5,851,1.0,583.0,583.0
0.003,17,2,136,1,60,0.0,32.0,32.0,1,76,0.0,48.0,48.0
0.004,6,10,1702,5,863,1.0,595.0,595.0,5,839,1.0,571.0,571.0
0.014,17,2,152,1,56,0.0,28.0,28.0,1,96,0.0,68.0,68.0
0.063,6,10,1506,5,395,13.0,127.0,127.0,5,1111,15.0,843.0,843.0
0.097,6,10,1506,5,395,21.0,127.0,127.0,5,1111,21.0,843.0,843.0
0.005,6,10,1779,5,928,1.0,660.0,660.0,5,851,1.0,583.0,583.0
0.083,6,10,1506,5,395,18.0,127.0,127.0,5,1111,17.0,843.0,843.0
0.006,6,10,2006,5,927,1.0,659.0,659.0,5,1079,1.0,811.0,811.0
0.006,6,10,1547,5,764,1.0,496.0,496.0,5,783,1.0,515.0,515.0
0.012,6,10,1989,5,910,3.0,642.0,642.0,5,1079,2.0,811.0,811.0
0.015,6,10,1989,5,910,3.0,642.0,642.0,5,1079,3.0,811.0,811.0
0.108,6,10,1506,5,395,22.0,127.0,127.0,5,1111,24.0,843.0,843.0
0.004,6,10,2006,5,927,1.0,659.0,659.0,5,1079,1.0,811.0,811.0
0.005,17,2,166,1,75,0.0,47.0,47.0,1,91,0.0,63.0,63.0
0.005,17,2,158,1,71,0.0,43.0,43.0,1,87,0.0,59.0,59.0
0.004,6,10,2007,5,928,1.0,660.0,660.0,5,1079,1.0,811.0,811.0
0.009,6,10,1989,5,910,2.0,642.0,642.0,5,1079,2.0,811.0,811.0
165.075,17,74,10568,37,2482,4585.0,44.0,39.0,37,8086,4585.0,260.0,190.0
0.012,6,10,1972,5,910,3.0,642.0,642.0,5,1062,3.0,794.0,794.0
0.013,6,10,1972,5,910,3.0,642.0,642.0,5,1062,3.0,794.0,794.0
0.006,17,2,170,1,65,0.0,37.0,37.0,1,105,0.0,77.0,77.0
0.005,6,10,2006,5,927,1.0,659.0,659.0,5,1079,1.0,811.0,811.0
0.01,6,10,1989,5,910,2.0,642.0,642.0,5,1079,2.0,811.0,811.0
0.014,6,10,1989,5,910,3.0,642.0,642.0,5,1079,3.0,811.0,811.0
0.004,6,10,1989,5,927,1.0,659.0,659.0,5,1062,1.0,794.0,794.0
9.038,17,6,376,5,280,2259.0,28.0,28.0,1,96,0.0,68.0,68.0
0.001,17,2,142,1,63,0.0,35.0,35.0,1,79,0.0,51.0,51.0
0.004,6,10,2006,5,927,1.0,659.0,659.0,5,1079,1.0,811.0,811.0
0.013,6,10,1990,5,911,3.0,643.0,643.0,5,1079,3.0,811.0,811.0
0.069,6,10,1506,5,395,15.0,127.0,127.0,5,1111,15.0,843.0,843.0
120.537,6,42,12649,24,3884,5240.0,1055.0,239.0,18,8765,7090.0,2694.0,869.0
0.013,6,10,1972,5,910,3.0,642.0,642.0,5,1062,3.0,794.0,794.0
0.043,17,2,152,1,76,0.0,48.0,48.0,1,76,0.0,48.0,48.0
0.005,6,14,3742,7,452,0.0,80.0,80.0,7,3290,0.0,1448.0,972.0
0.01,6,10,1677,5,827,2.0,559.0,559.0,5,850,2.0,582.0,582.0
0.059,6,10,1506,5,395,12.0,127.0,127.0,5,1111,14.0,843.0,843.0
0.005,6,10,1689,5,839,1.0,571.0,571.0,5,850,1.0,582.0,582.0
0.039,17,2,184,1,61,0.0,33.0,33.0,1,123,0.0,95.0,95.0
0.041,17,4,420,2,122,0.0,33.0,33.0,2,298,3.0,145.0,121.0
0.006,6,10,1774,5,923,1.0,655.0,655.0,5,851,1.0,583.0,583.0
0.018,6,10,1989,5,910,4.0,642.0,642.0,5,1079,4.0,811.0,811.0
0.099,6,10,1506,5,395,24.0,127.0,127.0,5,1111,22.0,843.0,843.0
40.062,17,10,676,5,460,10013.0,104.0,64.0,5,216,10014.0,20.0,15.0
0.01,6,10,1990,5,911,2.0,643.0,643.0,5,1079,2.0,811.0,811.0
0.009,6,10,1990,5,911,2.0,643.0,643.0,5,1079,2.0,811.0,811.0
0.036,17,4,284,2,120,0.0,32.0,32.0,2,164,33.0,60.0,54.0
0.004,6,10,1774,5,923,1.0,655.0,655.0,5,851,1.0,583.0,583.0
0.001,17,2,142,1,63,0.0,35.0,35.0,1,79,0.0,51.0,51.0
0.005,17,2,212,1,74,0.0,46.0,46.0,1,138,0.0,110.0,110.0
0.004,6,10,1779,5,928,1.0,660.0,660.0,5,851,1.0,583.0,583.0
0.005,6,10,2006,5,927,1.0,659.0,659.0,5,1079,1.0,811.0,811.0
0.006,6,10,1547,5,764,1.0,496.0,496.0,5,783,1.0,515.0,515.0
0.001,17,2,180,1,66,0.0,38.0,38.0,1,114,0.0,86.0,86.0
0.094,6,10,1506,5,395,20.0,127.0,127.0,5,1111,22.0,843.0,843.0
0.087,6,10,1506,5,395,20.0,127.0,127.0,5,1111,17.0,843.0,843.0
89.017,6,22,8498,12,2236,73.0,1345.0,574.0,10,6262,9872.0,1776.0,975.0
0.082,6,10,1506,5,395,17.0,127.0,127.0,5,1111,18.0,843.0,843.0
0.676,6,25,5459,12,1557,51.0,325.0,152.0,13,3902,47.0,1414.0,563.0
0.129,6,10,1506,5,395,28.0,127.0,127.0,5,1111,29.0,843.0,843.0
0.004,6,10,2007,5,928,1.0,660.0,660.0,5,1079,1.0,811.0,811.0
0.008,17,2,179,1,71,0.0,43.0,43.0,1,108,0.0,80.0,80.0
0.005,17,2,148,1,60,0.0,32.0,32.0,1,88,0.0,60.0,60.0
0.01,6,6,716,3,458,3.0,302.0,302.0,3,258,3.0,102.0,102.0
10.765,17,28,4421,14,1993,820.0,268.0,114.0,14,2428,819.0,587.0,145.0
240.03,6,9,787,5,488,60007.0,232.0,232.0,4,299,80009.0,83.0,83.0
0.034,6,10,1989,5,910,8.0,642.0,642.0,5,1079,8.0,811.0,811.0
0.01,6,10,1983,5,910,2.0,642.0,642.0,5,1073,2.0,805.0,805.0
0.003,17,2,148,1,60,0.0,32.0,32.0,1,88,0.0,60.0,60.0
0.003,17,2,136,1,60,0.0,32.0,32.0,1,76,0.0,48.0,48.0
0.005,6,10,1774,5,923,1.0,655.0,655.0,5,851,1.0,583.0,583.0
0.142,6,10,1506,5,395,33.0,127.0,127.0,5,1111,30.0,843.0,843.0
0.004,17,2,186,1,61,0.0,33.0,33.0,1,125,0.0,97.0,97.0
0.042,17,4,364,2,160,0.0,52.0,52.0,2,204,2.0,80.0,74.0
0.041,17,2,148,1,60,0.0,32.0,32.0,1,88,0.0,60.0,60.0
0.002,17,2,136,1,60,0.0,32.0,32.0,1,76,0.0,48.0,48.0
0.09,17,2,144,1,64,0.0,36.0,36.0,1,80,0.0,52.0,52.0
0.011,6,10,1972,5,910,2.0,642.0,642.0,5,1062,2.0,794.0,794.0
40.057,17,10,676,5,460,10013.0,104.0,64.0,5,216,10013.0,20.0,15.0
0.006,6,10,1643,5,860,1.0,592.0,592.0,5,783,1.0,515.0,515.0
0.042,17,2,148,1,60,0.0,32.0,32.0,1,88,0.0,60.0,60.0
240.076,6,21,4926,11,941,24007.0,180.0,93.0,10,3985,26674.0,1593.0,576.0
0.087,6,10,1506,5,395,19.0,127.0,127.0,5,1111,20.0,843.0,843.0
0.004,6,10,2006,5,927,1.0,659.0,659.0,5,1079,1.0,811.0,811.0
0.038,17,2,148,1,60,0.0,32.0,32.0,1,88,0.0,60.0,60.0
0.006,6,10,1547,5,764,1.0,496.0,496.0,5,783,1.0,515.0,515.0
0.005,6,10,2006,5,927,1.0,659.0,659.0,5,1079,1.0,811.0,811.0
356.56,6,21,1795,16,1030,23770.0,190.0,190.0,5,765,60001.0,464.0,248.0
0.006,6,10,1689,5,839,1.0,571.0,571.0,5,850,1.0,582.0,582.0
0.081,6,10,1506,5,395,18.0,127.0,127.0,5,1111,19.0,843.0,843.0
0.005,6,10,2000,5,927,1.0,659.0,659.0,5,1073,1.0,805.0,805.0
0.005,6,10,1989,5,927,1.0,659.0,659.0,5,1062,1.0,794.0,794.0
0.073,6,10,1506,5,395,16.0,127.0,127.0,5,1111,15.0,843.0,843.0
0.17,6,3,453,2,321,170.0,241.0,241.0,1,132,0.0,92.0,92.0
0.129,6,10,1506,5,395,30.0,127.0,127.0,5,1111,29.0,843.0,843.0
0.017,6,10,1972,5,910,4.0,642.0,642.0,5,1062,4.0,794.0,794.0
0.005,6,13,3747,7,509,0.0,137.0,137.0,6,3238,1.0,1470.0,1459.0
0.013,6,10,1989,5,910,3.0,642.0,642.0,5,1079,3.0,811.0,811.0
0.005,17,2,180,1,66,0.0,38.0,38.0,1,114,0.0,86.0,86.0
0.173,6,3,453,2,321,173.0,241.0,241.0,1,132,0.0,92.0,92.0
240.128,6,33,9597,17,7107,15008.0,1515.0,622.0,16,2490,16008.0,580.0,206.0
0.007,6,10,1547,5,764,1.0,496.0,496.0,5,783,1.0,515.0,515.0
0.008,17,4,284,2,120,5.0,32.0,32.0,2,164,4.0,60.0,54.0
0.006,17,2,230,1,68,0.0,40.0,40.0,1,162,0.0,134.0,134.0
0.005,6,10,2007,5,928,1.0,660.0,660.0,5,1079,1.0,811.0,811.0
0.004,17,4,284,2,120,0.0,32.0,32.0,2,164,0.0,60.0,54.0
40.056,17,10,676,5,460,10012.0,104.0,64.0,5,216,10013.0,20.0,15.0
0.087,6,10,1506,5,395,19.0,127.0,127.0,5,1111,20.0,843.0,843.0
0.009,6,10,1677,5,827,2.0,559.0,559.0,5,850,2.0,582.0,582.0
0.074,6,10,1506,5,395,16.0,127.0,127.0,5,1111,16.0,843.0,843.0
0.005,6,10,2000,5,927,1.0,659.0,659.0,5,1073,1.0,805.0,805.0
0.004,17,2,230,1,68,0.0,40.0,40.0,1,162,0.0,134.0,134.0
0.003,17,2,148,1,60,0.0,32.0,32.0,1,88,0.0,60.0,60.0
0.122,6,10,1506,5,395,26.0,127.0,127.0,5,1111,26.0,843.0,843.0
0.012,6,10,1677,5,827,3.0,559.0,559.0,5,850,3.0,582.0,582.0
0.095,6,10,1506,5,395,23.0,127.0,127.0,5,1111,20.0,843.0,843.0
0.004,6,10,2006,5,927,1.0,659.0,659.0,5,1079,1.0,811.0,811.0
15.18,17,25,13082,13,8504,1264.0,1350.0,626.0,12,4578,1378.0,1350.0,353.0
0.004,17,4,284,2,120,1.0,32.0,32.0,2,164,0.0,60.0,54.0
300.04,6,12,1782,7,1348,50006.0,494.0,494.0,5,434,75009.0,83.0,83.0
1798.854,17,2867,215894,1426,114126,1262.0,75.0,52.0,1441,101768,1249.0,226.0,42.0
0.004,6,10,2006,5,927,1.0,659.0,659.0,5,1079,1.0,811.0,811.0
0.008,6,11,1814,6,963,1.0,643.0,643.0,5,851,1.0,583.0,583.0
0.004,17,2,136,1,60,0.0,32.0,32.0,1,76,0.0,48.0,48.0
0.111,6,10,1506,5,395,24.0,127.0,127.0,5,1111,25.0,843.0,843.0
1730.46,6,48,2957,31,1800,57682.0,35.0,35.0,17,1157,108148.0,31.0,31.0
0.005,17,2,164,1,74,0.0,46.0,46.0,1,90,0.0,62.0,62.0
0.005,6,10,1689,5,839,1.0,571.0,571.0,5,850,1.0,582.0,582.0
0.066,6,10,1506,5,395,15.0,127.0,127.0,5,1111,14.0,843.0,843.0
0.009,6,10,1983,5,910,2.0,642.0,642.0,5,1073,2.0,805.0,805.0
0.008,6,10,1989,5,910,2.0,642.0,642.0,5,1079,1.0,811.0,811.0
412.002,6,29,4409,12,3102,10912.0,494.0,494.0,17,1307,25749.0,83.0,83.0
0.004,6,10,2000,5,927,1.0,659.0,659.0,5,1073,1.0,805.0,805.0
0.003,17,2,136,1,60,0.0,32.0,32.0,1,76,0.0,48.0,48.0
308.701,17,20,1124,10,716,34286.0,48.0,43.0,10,408,34286.0,20.0,12.0
0.011,6,10,1762,5,911,2.0,643.0,643.0,5,851,2.0,583.0,583.0
0.042,17,4,420,2,122,0.0,33.0,33.0,2,298,3.0,145.0,121.0
0.005,6,10,1643,5,860,1.0,592.0,592.0,5,783,1.0,515.0,515.0
0.076,6,10,1506,5,395,18.0,127.0,127.0,5,1111,16.0,843.0,843.0
0.001,17,2,140,1,62,0.0,34.0,34.0,1,78,0.0,50.0,50.0
0.004,6,10,2007,5,928,1.0,660.0,660.0,5,1079,1.0,811.0,811.0
0.013,6,10,1983,5,910,3.0,642.0,642.0,5,1073,3.0,805.0,805.0
0.015,6,10,1989,5,910,3.0,642.0,642.0,5,1079,3.0,811.0,811.0
0.017,6,10,1972,5,910,4.0,642.0,642.0,5,1062,4.0,794.0,794.0
0.005,6,10,2007,5,928,1.0,660.0,660.0,5,1079,1.0,811.0,811.0
0.006,17,2,170,1,65,0.0,37.0,37.0,1,105,0.0,77.0,77.0
0.005,6,10,2000,5,927,1.0,659.0,659.0,5,1073,1.0,805.0,805.0
0.013,6,10,1677,5,827,3.0,559.0,559.0,5,850,3.0,582.0,582.0
0.072,17,4,336,2,124,1.0,34.0,34.0,2,212,32.0,84.0,78.0
300.398,6,16,2170,9,684,37527.0,146.0,146.0,7,1486,50037.0,419.0,398.0
0.01,6,10,1972,5,910,2.0,642.0,642.0,5,1062,2.0,794.0,794.0
0.006,17,2,184,1,68,0.0,40.0,40.0,1,116,0.0,88.0,88.0
0.005,6,10,1779,5,928,1.0,660.0,660.0,5,851,1.0,583.0,583.0
0.106,6,10,1506,5,395,23.0,127.0,127.0,5,1111,25.0,843.0,843.0
0.072,6,10,1506,5,395,15.0,127.0,127.0,5,1111,15.0,843.0,843.0
0.005,6,10,1779,5,928,1.0,660.0,660.0,5,851,1.0,583.0,583.0
1799.918,6,137,6590,76,3625,23995.0,39.0,39.0,61,2965,29994.0,35.0,35.0
0.006,6,10,1643,5,860,1.0,592.0,592.0,5,783,1.0,515.0,515.0
351.986,6,20,2210,6,1308,12003.0,494.0,494.0,14,902,27075.0,83.0,83.0
0.008,6,10,1972,5,910,2.0,642.0,642.0,5,1062,1.0,794.0,794.0
0.003,17,2,152,1,76,0.0,48.0,48.0,1,76,0.0,48.0,48.0
0.153,6,10,1506,5,395,34.0,127.0,127.0,5,1111,36.0,843.0,843.0
0.056,6,10,1506,5,395,12.0,127.0,127.0,5,1111,13.0,843.0,843.0
0.012,6,10,1677,5,827,3.0,559.0,559.0,5,850,2.0,582.0,582.0
0.005,6,10,1779,5,928,1.0,660.0,660.0,5,851,1.0,583.0,583.0
40.066,17,10,676,5,460,10015.0,104.0,64.0,5,216,10015.0,20.0,15.0
0.029,6,10,1990,5,911,7.0,643.0,643.0,5,1079,7.0,811.0,811.0
0.005,6,14,3742,7,452,0.0,80.0,80.0,7,3290,0.0,1448.0,972.0
0.006,6,10,1547,5,764,1.0,496.0,496.0,5,783,1.0,515.0,515.0
0.004,17,2,136,1,60,0.0,32.0,32.0,1,76,0.0,48.0,48.0
0.009,6,10,1990,5,911,2.0,643.0,643.0,5,1079,2.0,811.0,811.0
1756.775,6,105,6270,60,3525,29775.0,27.0,27.0,45,2745,39925.0,27.0,27.0
0.013,6,10,1989,5,910,3.0,642.0,642.0,5,1079,3.0,811.0,811.0
0.01,6,10,1990,5,911,2.0,643.0,643.0,5,1079,2.0,811.0,811.0
0.094,6,10,1506,5,395,22.0,127.0,127.0,5,1111,20.0,843.0,843.0
240.025,6,9,787,5,488,60006.0,232.0,232.0,4,299,80007.0,83.0,83.0
0.009,6,12,1926,6,1189,1.0,659.0,434.0,6,737,1.0,417.0,417.0
0.005,17,2,230,1,68,0.0,40.0,40.0,1,162,0.0,134.0,134.0
309.182,17,20,1124,10,716,34339.0,48.0,43.0,10,408,34339.0,20.0,12.0
0.006,6,10,1547,5,764,1.0,496.0,496.0,5,783,1.0,515.0,515.0
0.082,6,10,1506,5,395,19.0,127.0,127.0,5,1111,18.0,843.0,843.0
0.013,17,2,152,1,56,0.0,28.0,28.0,1,96,0.0,68.0,68.0
0.004,17,2,148,1,60,0.0,32.0,32.0,1,88,0.0,60.0,60.0
126.237,6,29,15755,13,14921,10499.0,2828.0,2055.0,16,834,8400.0,182.0,182.0
0.001,17,2,180,1,66,0.0,38.0,38.0,1,114,0.0,86.0,86.0
240.177,6,23,7539,12,2686,21834.0,1368.0,513.0,11,4853,24017.0,1655.0,854.0
0.005,6,14,3742,8,504,0.0,80.0,80.0,6,3238,0.0,1470.0,1459.0
0.009,6,10,1989,5,910,2.0,642.0,642.0,5,1079,2.0,811.0,811.0
0.004,6,10,1702,5,863,1.0,595.0,595.0,5,839,1.0,571.0,571.0
0.016,6,10,1972,5,910,4.0,642.0,642.0,5,1062,3.0,794.0,794.0
11.134,17,28,4423,14,1994,844.0,269.0,114.0,14,2429,844.0,588.0,145.0
0.073,6,10,1506,5,395,17.0,127.0,127.0,5,1111,17.0,843.0,843.0
300.205,6,29,12064,16,5891,20013.0,1368.0,721.0,13,6173,25016.0,1703.0,916.0
0.014,6,10,1989,5,910,3.0,642.0,642.0,5,1079,3.0,811.0,811.0
0.001,17,2,166,1,75,0.0,47.0,47.0,1,91,0.0,63.0,63.0
0.006,6,13,3747,7,509,1.0,137.0,137.0,6,3238,1.0,1470.0,1459.0
0.006,6,10,1643,5,860,1.0,592.0,592.0,5,783,1.0,515.0,515.0
0.08,6,10,1506,5,395,19.0,127.0,127.0,5,1111,18.0,843.0,843.0
0.006,6,10,1689,5,839,1.0,571.0,571.0,5,850,1.0,582.0,582.0
40.072,17,10,676,5,460,10014.0,104.0,64.0,5,216,10016.0,20.0,15.0
0.012,6,10,1990,5,911,2.0,643.0,643.0,5,1079,3.0,811.0,811.0
0.005,6,10,1779,5,928,1.0,660.0,660.0,5,851,1.0,583.0,583.0
0.004,6,10,2007,5,928,1.0,660.0,660.0,5,1079,1.0,811.0,811.0
0.005,6,10,1774,5,923,1.0,655.0,655.0,5,851,1.0,583.0,583.0
0.004,17,2,136,1,60,0.0,32.0,32.0,1,76,0.0,48.0,48.0
0.082,6,10,1506,5,395,19.0,127.0,127.0,5,1111,17.0,843.0,843.0
0.011,6,10,1989,5,910,2.0,642.0,642.0,5,1079,2.0,811.0,811.0
0.098,6,10,1506,5,395,22.0,127.0,127.0,5,1111,18.0,843.0,843.0
0.012,6,10,1990,5,911,3.0,643.0,643.0,5,1079,3.0,811.0,811.0
0.08,6,10,1506,5,395,17.0,127.0,127.0,5,1111,16.0,843.0,843.0
0.016,6,10,1631,5,848,3.0,580.0,580.0,5,783,3.0,515.0,515.0
0.005,6,10,1854,5,889,1.0,621.0,621.0,5,965,1.0,697.0,697.0
0.001,17,2,136,1,60,0.0,32.0,32.0,1,76,0.0,48.0,48.0
0.035,17,2,152,1,76,0.0,48.0,48.0,1,76,0.0,48.0,48.0
0.007,17,2,194,1,59,0.0,31.0,31.0,1,135,0.0,107.0,107.0
0.017,6,10,1989,5,910,4.0,642.0,642.0,5,1079,4.0,811.0,811.0
0.022,6,10,1989,5,910,5.0,642.0,642.0,5,1079,5.0,811.0,811.0
0.012,6,10,1972,5,910,3.0,642.0,642.0,5,1062,2.0,794.0,794.0
0.06,17,2,80,1,32,0.0,4.0,4.0,1,48,0.0,20.0,20.0
0.011,6,10,1990,5,911,2.0,643.0,643.0,5,1079,2.0,811.0,811.0
0.005,6,10,2007,5,928,1.0,660.0,660.0,5,1079,1.0,811.0,811.0
240.084,6,16,4481,9,963,30010.0,238.0,166.0,7,3518,40013.0,1402.0,786.0
0.004,6,10,1989,5,927,1.0,659.0,659.0,5,1062,1.0,794.0,794.0
0.106,6,10,1506,5,395,23.0,127.0,127.0,5,1111,23.0,843.0,843.0
0.059,17,2,152,1,76,0.0,48.0,48.0,1,76,0.0,48.0,48.0
0.006,6,10,1547,5,764,1.0,496.0,496.0,5,783,1.0,515.0,515.0
0.001,17,2,180,1,66,0.0,38.0,38.0,1,114,0.0,86.0,86.0
0.097,6,10,1506,5,395,21.0,127.0,127.0,5,1111,22.0,843.0,843.0
15.076,17,16,8637,8,6566,2149.0,1350.0,792.0,8,2071,2149.0,1350.0,230.0
0.004,6,10,1779,5,928,1.0,660.0,660.0,5,851,0.0,583.0,583.0
0.012,6,10,1677,5,827,3.0,559.0,559.0,5,850,2.0,582.0,582.0
300.301,6,16,2170,9,684,37516.0,146.0,146.0,7,1486,50022.0,419.0,398.0
169.292,17,92,13074,46,3102,3761.0,44.0,39.0,46,9972,3761.0,239.0,188.0
0.01,6,10,1972,5,910,2.0,642.0,642.0,5,1062,2.0,794.0,794.0
240.12,6,32,9614,16,6998,16008.0,2068.0,685.0,16,2616,16007.0,580.0,222.0
9.04,17,6,376,5,280,2260.0,28.0,28.0,1,96,0.0,68.0,68.0
40.056,17,10,676,5,460,10013.0,104.0,64.0,5,216,10013.0,20.0,15.0
0.004,17,4,284,2,120,0.0,32.0,32.0,2,164,0.0,60.0,54.0
0.008,6,10,1983,5,910,2.0,642.0,642.0,5,1073,1.0,805.0,805.0
0.009,6,10,1972,5,910,2.0,642.0,642.0,5,1062,2.0,794.0,794.0
0.09,6,10,1506,5,395,21.0,127.0,127.0,5,1111,21.0,843.0,843.0
0.009,6,12,1926,6,1189,1.0,659.0,434.0,6,737,1.0,417.0,417.0
0.005,17,2,180,1,58,0.0,30.0,30.0,1,122,0.0,94.0,94.0
0.088,6,10,1506,5,395,20.0,127.0,127.0,5,1111,21.0,843.0,843.0
0.001,17,2,140,1,62,0.0,34.0,34.0,1,78,0.0,50.0,50.0
0.083,6,10,1506,5,395,18.0,127.0,127.0,5,1111,19.0,843.0,843.0
0.008,6,10,1989,5,910,2.0,642.0,642.0,5,1079,1.0,811.0,811.0
0.004,6,10,2000,5,927,1.0,659.0,659.0,5,1073,1.0,805.0,805.0
0.12,6,10,1506,5,395,28.0,127.0,127.0,5,1111,28.0,843.0,843.0
0.001,17,2,180,1,66,0.0,38.0,38.0,1,114,0.0,86.0,86.0
240.09,6,32,9217,16,6549,16006.0,1622.0,635.0,16,2668,16005.0,580.0,228.0
0.005,6,10,2007,5,928,1.0,660.0,660.0,5,1079,1.0,811.0,811.0
0.005,6,10,2006,5,927,1.0,659.0,659.0,5,1079,1.0,811.0,811.0
0.016,6,10,1631,5,848,4.0,580.0,580.0,5,783,4.0,515.0,515.0
241.814,6,347,345191,122,17849,1998.0,2736.0,885.0,225,327342,1079.0,2804.0,1468.0
0.015,6,10,1983,5,910,3.0,642.0,642.0,5,1073,3.0,805.0,805.0
0.159,6,10,1506,5,395,35.0,127.0,127.0,5,1111,36.0,843.0,843.0
0.003,17,2,148,1,60,0.0,32.0,32.0,1,88,0.0,60.0,60.0
0.005,6,10,2006,5,927,1.0,659.0,659.0,5,1079,1.0,811.0,811.0
0.004,17,2,148,1,60,0.0,32.0,32.0,1,88,0.0,60.0,60.0
0.038,17,2,152,1,76,0.0,48.0,48.0,1,76,0.0,48.0,48.0
0.01,6,10,1677,5,827,2.0,559.0,559.0,5,850,2.0,582.0,582.0
0.004,6,10,2007,5,928,1.0,660.0,660.0,5,1079,1.0,811.0,811.0
0.004,6,10,2007,5,928,1.0,660.0,660.0,5,1079,1.0,811.0,811.0
0.005,6,10,1989,5,927,1.0,659.0,659.0,5,1062,1.0,794.0,794.0
15.072,17,15,9239,8,6902,2149.0,1350.0,834.0,7,2337,2507.0,1350.0,305.0
0.042,6,10,1983,5,910,10.0,642.0,642.0,5,1073,10.0,805.0,805.0
0.171,6,3,453,2,321,171.0,241.0,241.0,1,132,0.0,92.0,92.0
0.014,6,10,1989,5,910,3.0,642.0,642.0,5,1079,3.0,811.0,811.0
40.07,17,10,676,5,460,10016.0,104.0,64.0,5,216,10016.0,20.0,15.0
0.004,17,2,136,1,60,0.0,32.0,32.0,1,76,0.0,48.0,48.0
0.006,6,10,1547,5,764,1.0,496.0,496.0,5,783,1.0,515.0,515.0
0.188,6,44,11551,24,3222,8.0,1022.0,197.0,20,8329,9.0,1402.0,606.0
0.081,6,10,1506,5,395,17.0,127.0,127.0,5,1111,16.0,843.0,843.0
0.011,6,10,1972,5,910,2.0,642.0,642.0,5,1062,2.0,794.0,794.0
0.053,17,2,152,1,76,0.0,48.0,48.0,1,76,0.0,48.0,48.0
0.004,17,2,148,1,60,0.0,32.0,32.0,1,88,0.0,60.0,60.0
240.476,6,37,9662,19,2177,13359.0,749.0,236.0,18,7485,14145.0,1402.0,595.0
0.004,6,10,1989,5,927,1.0,659.0,659.0,5,1062,1.0,794.0,794.0
0.011,6,10,1989,5,910,2.0,642.0,642.0,5,1079,2.0,811.0,811.0
0.004,6,10,2006,5,927,1.0,659.0,659.0,5,1079,1.0,811.0,811.0
0.012,6,10,1972,5,910,3.0,642.0,642.0,5,1062,2.0,794.0,794.0
0.004,17,2,136,1,60,0.0,32.0,32.0,1,76,0.0,48.0,48.0
0.013,6,10,1990,5,911,3.0,643.0,643.0,5,1079,3.0,811.0,811.0
0.022,6,10,1989,5,910,5.0,642.0,642.0,5,1079,5.0,811.0,811.0
0.01,6,10,1983,5,910,2.0,642.0,642.0,5,1073,2.0,805.0,805.0
0.089,6,10,1506,5,395,20.0,127.0,127.0,5,1111,21.0,843.0,843.0
0.011,6,10,1989,5,910,2.0,642.0,642.0,5,1079,2.0,811.0,811.0
0.038,17,2,136,1,60,0.0,32.0,32.0,1,76,0.0,48.0,48.0
0.037,17,4,284,2,120,0.0,32.0,32.0,2,164,33.0,60.0,54.0
0.006,6,10,1547,5,764,1.0,496.0,496.0,5,783,1.0,515.0,515.0
40.062,17,10,676,5,460,10013.0,104.0,64.0,5,216,10013.0,20.0,15.0
0.024,6,10,1989,5,910,5.0,642.0,642.0,5,1079,5.0,811.0,811.0
0.023,6,10,1989,5,910,5.0,642.0,642.0,5,1079,5.0,811.0,811.0
4.542,58,2,144,1,72,0.0,24.0,24.0,1,72,0.0,24.0,24.0
0.041,17,2,136,1,60,0.0,32.0,32.0,1,76,0.0,48.0,48.0
0.167,17,2,152,1,76,0.0,48.0,48.0,1,76,0.0,48.0,48.0
0.005,6,10,2006,5,927,1.0,659.0,659.0,5,1079,1.0,811.0,811.0
0.005,6,10,2006,5,927,1.0,659.0,659.0,5,1079,1.0,811.0,811.0
0.012,17,2,166,1,75,0.0,47.0,47.0,1,91,0.0,63.0,63.0
0.006,6,10,1547,5,764,1.0,496.0,496.0,5,783,1.0,515.0,515.0
0.003,17,2,144,1,64,0.0,36.0,36.0,1,80,0.0,52.0,52.0
0.117,6,10,1506,5,395,28.0,127.0,127.0,5,1111,27.0,843.0,843.0
0.005,6,10,2007,5,928,1.0,660.0,660.0,5,1079,1.0,811.0,811.0
0.057,17,2,152,1,76,0.0,48.0,48.0,1,76,0.0,48.0,48.0
0.013,6,10,1762,5,911,3.0,643.0,643.0,5,851,3.0,583.0,583.0
0.012,6,10,1983,5,910,3.0,642.0,642.0,5,1073,2.0,805.0,805.0
0.004,6,10,2006,5,927,1.0,659.0,659.0,5,1079,1.0,811.0,811.0
0.006,17,2,170,1,65,0.0,37.0,37.0,1,105,0.0,77.0,77.0
0.086,6,10,1506,5,395,18.0,127.0,127.0,5,1111,19.0,843.0,843.0
0.013,6,10,1989,5,910,3.0,642.0,642.0,5,1079,3.0,811.0,811.0
0.014,6,10,1972,5,910,3.0,642.0,642.0,5,1062,3.0,794.0,794.0
0.004,6,10,1702,5,863,1.0,595.0,595.0,5,839,1.0,571.0,571.0
0.006,6,10,1689,5,839,1.0,571.0,571.0,5,850,1.0,582.0,582.0
0.071,6,10,1506,5,395,14.0,127.0,127.0,5,1111,17.0,843.0,843.0
0.003,17,2,136,1,60,0.0,32.0,32.0,1,76,0.0,48.0,48.0
294.207,6,28,10012,15,3303,21008.0,1373.0,503.0,13,6709,24510.0,1402.0,862.0
0.002,17,2,136,1,60,0.0,32.0,32.0,1,76,0.0,48.0,48.0
0.006,6,10,1547,5,764,1.0,496.0,496.0,5,783,1.0,515.0,515.0
297.991,6,375,326818,185,312130,1618.0,4080.0,1904.0,190,14688,1575.0,2667.0,228.0
0.006,6,10,1547,5,764,1.0,496.0,496.0,5,783,1.0,515.0,515.0
0.005,6,13,3690,7,452,0.0,80.0,80.0,6,3238,1.0,1470.0,1459.0
0.017,6,10,1972,5,910,4.0,642.0,642.0,5,1062,4.0,794.0,794.0
0.008,6,10,1631,5,848,2.0,580.0,580.0,5,783,2.0,515.0,515.0
0.008,6,12,1926,6,1189,1.0,659.0,434.0,6,737,1.0,417.0,417.0
0.001,17,2,180,1,66,0.0,38.0,38.0,1,114,0.0,86.0,86.0
0.004,6,10,2000,5,927,1.0,659.0,659.0,5,1073,1.0,805.0,805.0
0.043,6,13,3816,7,578,7.0,206.0,206.0,6,3238,8.0,1470.0,1459.0
0.0,17,2,166,1,75,0.0,47.0,47.0,1,91,0.0,63.0,63.0
354.023,6,21,1795,16,1030,23601.0,190.0,190.0,5,765,60002.0,464.0,248.0
0.116,17,2,80,1,32,0.0,4.0,4.0,1,48,0.0,20.0,20.0
173.343,17,80,11338,40,2676,4444.0,44.0,38.0,40,8662,4444.0,239.0,188.0
0.004,6,10,1989,5,927,1.0,659.0,659.0,5,1062,1.0,794.0,794.0
0.005,6,10,1989,5,927,1.0,659.0,659.0,5,1062,1.0,794.0,794.0
0.012,6,10,1677,5,827,3.0,559.0,559.0,5,850,3.0,582.0,582.0
0.009,6,10,1983,5,910,2.0,642.0,642.0,5,1073,2.0,805.0,805.0
0.105,6,10,1506,5,395,21.0,127.0,127.0,5,1111,22.0,843.0,843.0
0.093,6,10,1506,5,395,21.0,127.0,127.0,5,1111,19.0,843.0,843.0
0.005,6,10,1989,5,927,1.0,659.0,659.0,5,1062,1.0,794.0,794.0
0.001,17,2,180,1,66,0.0,38.0,38.0,1,114,0.0,86.0,86.0
0.005,17,2,166,1,75,0.0,47.0,47.0,1,91,0.0,63.0,63.0
0.101,6,10,1506,5,395,20.0,127.0,127.0,5,1111,24.0,843.0,843.0
0.074,6,10,1506,5,395,16.0,127.0,127.0,5,1111,15.0,843.0,843.0
0.083,6,10,1506,5,395,18.0,127.0,127.0,5,1111,19.0,843.0,843.0
0.01,6,10,1983,5,910,2.0,642.0,642.0,5,1073,2.0,805.0,805.0
0.007,17,2,194,1,59,0.0,31.0,31.0,1,135,0.0,107.0,107.0
0.016,6,10,1990,5,911,4.0,643.0,643.0,5,1079,3.0,811.0,811.0
0.005,6,10,1547,5,764,1.0,496.0,496.0,5,783,1.0,515.0,515.0
0.005,6,10,2006,5,927,1.0,659.0,659.0,5,1079,1.0,811.0,811.0
1797.758,6,267,31659,109,15137,16644.0,2074.0,124.0,158,16522,11449.0,1360.0,130.0
0.1,6,10,1506,5,395,20.0,127.0,127.0,5,1111,21.0,843.0,843.0
0.016,6,13,3735,7,497,2.0,125.0,125.0,6,3238,3.0,1470.0,1459.0
0.021,6,10,1983,5,910,5.0,642.0,642.0,5,1073,5.0,805.0,805.0
0.008,6,10,1762,5,911,2.0,643.0,643.0,5,851,2.0,583.0,583.0
0.01,6,13,3735,7,497,1.0,125.0,125.0,6,3238,2.0,1470.0,1459.0
0.115,17,2,144,1,64,0.0,36.0,36.0,1,80,0.0,52.0,52.0
0.013,6,10,1972,5,910,3.0,642.0,642.0,5,1062,3.0,794.0,794.0
0.116,6,10,1506,5,395,26.0,127.0,127.0,5,1111,24.0,843.0,843.0
548.171,6,34,13217,17,3220,34260.0,676.0,388.0,17,9997,30506.0,1402.0,910.0
0.107,6,10,1506,5,395,18.0,127.0,127.0,5,1111,24.0,843.0,843.0
0.129,6,10,1506,5,395,28.0,127.0,127.0,5,1111,26.0,843.0,843.0
0.057,6,10,1506,5,395,11.0,127.0,127.0,5,1111,12.0,843.0,843.0
0.158,6,10,1506,5,395,31.0,127.0,127.0,5,1111,34.0,843.0,843.0
0.005,6,14,3742,7,452,0.0,80.0,80.0,7,3290,0.0,1448.0,972.0
0.001,17,2,180,1,66,0.0,38.0,38.0,1,114,0.0,86.0,86.0
0.005,6,10,2007,5,928,1.0,660.0,660.0,5,1079,1.0,811.0,811.0
0.005,6,10,2007,5,928,1.0,660.0,660.0,5,1079,1.0,811.0,811.0
0.01,6,10,1989,5,910,2.0,642.0,642.0,5,1079,2.0,811.0,811.0
0.008,6,10,1989,5,910,2.0,642.0,642.0,5,1079,1.0,811.0,811.0
266.521,6,42,10353,18,7039,15677.0,2007.0,678.0,24,3314,11587.0,580.0,137.0
11.468,17,28,4370,14,2311,869.0,586.0,137.0,14,2059,869.0,270.0,119.0
0.015,6,10,1989,5,910,3.0,642.0,642.0,5,1079,3.0,811.0,811.0
0.114,6,10,1506,5,395,24.0,127.0,127.0,5,1111,24.0,843.0,843.0
0.099,6,10,1506,5,395,20.0,127.0,127.0,5,1111,21.0,843.0,843.0
0.006,17,2,164,1,74,0.0,46.0,46.0,1,90,0.0,62.0,62.0
0.018,6,10,1972,5,910,4.0,642.0,642.0,5,1062,4.0,794.0,794.0
0.004,6,10,1779,5,928,1.0,660.0,660.0,5,851,1.0,583.0,583.0
0.075,6,10,1506,5,395,15.0,127.0,127.0,5,1111,17.0,843.0,843.0
0.041,17,4,284,2,120,0.0,32.0,32.0,2,164,38.0,60.0,54.0
0.013,6,10,1983,5,910,3.0,642.0,642.0,5,1073,3.0,805.0,805.0
11.174,17,28,4419,14,1994,847.0,269.0,114.0,14,2425,846.0,588.0,145.0
0.337,17,41,21537,22,18413,16.0,1350.0,808.0,19,3124,15.0,1350.0,136.0
0.027,6,10,1989,5,910,6.0,642.0,642.0,5,1079,6.0,811.0,811.0
1772.607,17,120,11460,60,5460,30043.0,63.0,63.0,60,6000,30043.0,72.0,72.0
0.001,17,2,166,1,75,0.0,47.0,47.0,1,91,0.0,63.0,63.0
0.009,6,10,1774,5,923,2.0,655.0,655.0,5,851,2.0,583.0,583.0
0.01,6,10,1972,5,910,2.0,642.0,642.0,5,1062,2.0,794.0,794.0
40.067,17,10,676,5,460,10014.0,104.0,64.0,5,216,10015.0,20.0,15.0
0.005,6,13,3690,7,452,0.0,80.0,80.0,6,3238,0.0,1470.0,1459.0
0.003,17,2,136,1,60,0.0,32.0,32.0,1,76,0.0,48.0,48.0
0.001,17,2,180,1,66,0.0,38.0,38.0,1,114,0.0,86.0,86.0
0.006,6,10,1643,5,860,1.0,592.0,592.0,5,783,1.0,515.0,515.0
0.003,17,2,136,1,60,0.0,32.0,32.0,1,76,0.0,48.0,48.0
1.025,6,14,3962,7,2139,128.0,1328.0,923.0,7,1823,128.0,1300.0,769.0
0.014,6,10,1762,5,911,3.0,643.0,643.0,5,851,3.0,583.0,583.0
0.094,6,10,1506,5,395,22.0,127.0,127.0,5,1111,22.0,843.0,843.0
0.011,6,13,3735,7,497,1.0,125.0,125.0,6,3238,2.0,1470.0,1459.0
0.006,6,10,1854,5,889,1.0,621.0,621.0,5,965,1.0,697.0,697.0
0.009,6,10,1989,5,910,2.0,642.0,642.0,5,1079,2.0,811.0,811.0
0.004,6,10,2000,5,927,1.0,659.0,659.0,5,1073,1.0,805.0,805.0
0.005,6,13,3747,7,509,0.0,137.0,137.0,6,3238,1.0,1470.0,1459.0
0.109,6,10,1506,5,395,25.0,127.0,127.0,5,1111,24.0,843.0,843.0
0.005,6,10,2000,5,927,1.0,659.0,659.0,5,1073,1.0,805.0,805.0
0.004,6,10,1779,5,928,1.0,660.0,660.0,5,851,1.0,583.0,583.0
0.001,17,2,180,1,66,0.0,38.0,38.0,1,114,0.0,86.0,86.0
0.011,6,10,1989,5,910,2.0,642.0,642.0,5,1079,2.0,811.0,811.0
0.005,6,10,2006,5,927,1.0,659.0,659.0,5,1079,1.0,811.0,811.0
0.014,6,10,1762,5,911,3.0,643.0,643.0,5,851,3.0,583.0,583.0
0.005,6,10,1689,5,839,1.0,571.0,571.0,5,850,1.0,582.0,582.0
0.001,17,2,180,1,66,0.0,38.0,38.0,1,114,0.0,86.0,86.0
0.001,17,2,142,1,63,0.0,35.0,35.0,1,79,0.0,51.0,51.0
0.005,6,10,1689,5,839,1.0,571.0,571.0,5,850,1.0,582.0,582.0
0.115,6,10,1506,5,395,25.0,127.0,127.0,5,1111,22.0,843.0,843.0
40.065,17,10,676,5,460,10013.0,104.0,64.0,5,216,10015.0,20.0,15.0
0.008,6,10,1677,5,827,2.0,559.0,559.0,5,850,2.0,582.0,582.0
0.004,17,2,136,1,60,0.0,32.0,32.0,1,76,0.0,48.0,48.0
0.077,6,10,1506,5,395,16.0,127.0,127.0,5,1111,18.0,843.0,843.0
0.009,17,2,203,1,61,0.0,33.0,33.0,1,142,0.0,114.0,114.0
0.005,6,10,1689,5,839,1.0,571.0,571.0,5,850,1.0,582.0,582.0
0.005,6,10,1989,5,927,1.0,659.0,659.0,5,1062,1.0,794.0,794.0
0.1,6,10,1506,5,395,21.0,127.0,127.0,5,1111,21.0,843.0,843.0
0.015,6,10,1972,5,910,3.0,642.0,642.0,5,1062,3.0,794.0,794.0
0.097,6,10,1506,5,395,22.0,127.0,127.0,5,1111,21.0,843.0,843.0
0.005,6,10,2006,5,927,1.0,659.0,659.0,5,1079,1.0,811.0,811.0
40.054,17,10,676,5,460,10012.0,104.0,64.0,5,216,10012.0,20.0,15.0
11.168,17,28,4421,14,1993,846.0,268.0,114.0,14,2428,846.0,587.0,145.0
324.847,6,686,736767,360,715907,904.0,4080.0,2205.0,326,20860,100.0,2667.0,205.0
0.013,6,10,1989,5,910,3.0,642.0,642.0,5,1079,3.0,811.0,811.0
40.063,17,10,676,5,460,10015.0,104.0,64.0,5,216,10015.0,20.0,15.0
0.011,6,10,1990,5,911,2.0,643.0,643.0,5,1079,2.0,811.0,811.0
40.054,17,10,676,5,460,10012.0,104.0,64.0,5,216,10012.0,20.0,15.0
31.62,6,36,9962,18,4444,520.0,1689.0,923.0,18,5518,1850.0,2667.0,435.0
240.246,6,24,3552,11,1802,24021.0,585.0,244.0,13,1750,20019.0,442.0,154.0
0.014,6,10,1983,5,910,3.0,642.0,642.0,5,1073,3.0,805.0,805.0
0.005,6,10,1989,5,927,1.0,659.0,659.0,5,1062,1.0,794.0,794.0
8.949,6,35,9731,18,4253,526.0,1360.0,700.0,17,5478,546.0,2667.0,435.0
0.009,6,10,1983,5,910,2.0,642.0,642.0,5,1073,2.0,805.0,805.0
0.005,17,2,179,1,71,0.0,43.0,43.0,1,108,0.0,80.0,80.0
0.078,6,10,1506,5,395,17.0,127.0,127.0,5,1111,17.0,843.0,843.0
0.005,6,14,3799,7,509,0.0,137.0,137.0,7,3290,0.0,1448.0,972.0
0.006,6,10,1689,5,839,1.0,571.0,571.0,5,850,1.0,582.0,582.0
0.001,17,2,180,1,65,0.0,37.0,37.0,1,115,0.0,87.0,87.0
0.004,6,10,2000,5,927,1.0,659.0,659.0,5,1073,1.0,805.0,805.0
0.175,17,2,152,1,76,0.0,48.0,48.0,1,76,0.0,48.0,48.0
0.029,6,8,832,4,522,9.0,302.0,302.0,4,310,8.0,102.0,102.0
0.072,6,10,1506,5,395,17.0,127.0,127.0,5,1111,16.0,843.0,843.0
0.005,17,2,144,1,64,0.0,36.0,36.0,1,80,0.0,52.0,52.0
0.06,6,10,1506,5,395,13.0,127.0,127.0,5,1111,12.0,843.0,843.0
0.115,6,10,1506,5,395,27.0,127.0,127.0,5,1111,23.0,843.0,843.0
0.005,17,2,144,1,64,0.0,36.0,36.0,1,80,0.0,52.0,52.0
0.014,6,10,1989,5,910,3.0,642.0,642.0,5,1079,3.0,811.0,811.0
0.043,17,2,144,1,64,0.0,36.0,36.0,1,80,0.0,52.0,52.0
0.01,6,10,1989,5,910,2.0,642.0,642.0,5,1079,2.0,811.0,811.0
0.006,6,10,1989,5,927,1.0,659.0,659.0,5,1062,1.0,794.0,794.0
0.004,17,2,136,1,60,0.0,32.0,32.0,1,76,0.0,48.0,48.0
0.005,6,10,2006,5,927,1.0,659.0,659.0,5,1079,1.0,811.0,811.0
331.819,17,20,1124,10,716,36853.0,48.0,43.0,10,408,36853.0,20.0,12.0
0.01,6,10,1989,5,910,2.0,642.0,642.0,5,1079,2.0,811.0,811.0
0.006,17,2,170,1,65,0.0,37.0,37.0,1,105,0.0,77.0,77.0
0.039,17,2,412,1,61,0.0,33.0,33.0,1,351,0.0,323.0,323.0
300.19,6,38,10073,20,4555,15790.0,1689.0,744.0,18,5518,17648.0,2667.0,435.0
0.005,6,10,2007,5,928,1.0,660.0,660.0,5,1079,1.0,811.0,811.0
0.102,6,10,1506,5,395,22.0,127.0,127.0,5,1111,22.0,843.0,843.0
0.004,6,10,1702,5,863,1.0,595.0,595.0,5,839,1.0,571.0,571.0
157.189,6,26,9525,12,1627,86.0,794.0,367.0,14,7898,12081.0,1360.0,732.0
0.015,6,10,1631,5,848,3.0,580.0,580.0,5,783,3.0,515.0,515.0
0.006,17,2,166,1,75,0.0,47.0,47.0,1,91,0.0,63.0,63.0
0.012,6,10,1631,5,848,3.0,580.0,580.0,5,783,2.0,515.0,515.0
0.005,6,10,1989,5,927,1.0,659.0,659.0,5,1062,1.0,794.0,794.0
0.039,17,4,284,2,120,0.0,32.0,32.0,2,164,36.0,60.0,54.0
0.116,6,10,1506,5,395,24.0,127.0,127.0,5,1111,23.0,843.0,843.0
164.194,17,70,10136,35,2337,4829.0,44.0,38.0,35,7799,4829.0,261.0,194.0
0.004,6,10,2006,5,927,1.0,659.0,659.0,5,1079,1.0,811.0,811.0
0.01,6,10,1677,5,827,2.0,559.0,559.0,5,850,2.0,582.0,582.0
0.005,6,10,1779,5,928,1.0,660.0,660.0,5,851,1.0,583.0,583.0
0.166,17,2,152,1,76,0.0,48.0,48.0,1,76,0.0,48.0,48.0
0.006,6,12,1698,6,863,1.0,327.0,271.0,6,835,1.0,515.0,515.0
0.089,6,10,1506,5,395,20.0,127.0,127.0,5,1111,19.0,843.0,843.0
0.006,6,10,1547,5,764,1.0,496.0,496.0,5,783,1.0,515.0,515.0
0.005,6,10,2000,5,927,1.0,659.0,659.0,5,1073,1.0,805.0,805.0
0.008,17,2,154,1,69,0.0,41.0,41.0,1,85,0.0,57.0,57.0
0.112,6,10,1506,5,395,21.0,127.0,127.0,5,1111,26.0,843.0,843.0
0.013,6,10,1972,5,910,3.0,642.0,642.0,5,1062,3.0,794.0,794.0
799.368,6,37,11779,19,5273,44409.0,1273.0,534.0,18,6506,43491.0,1402.0,618.0
0.006,6,10,1547,5,764,1.0,496.0,496.0,5,783,1.0,515.0,515.0
0.003,17,2,148,1,60,0.0,32.0,32.0,1,88,0.0,60.0,60.0
240.086,6,16,4482,9,963,30010.0,238.0,166.0,7,3519,40013.0,1402.0,786.0
0.006,6,10,1643,5,860,1.0,592.0,592.0,5,783,1.0,515.0,515.0
0.005,6,10,1689,5,839,1.0,571.0,571.0,5,850,1.0,582.0,582.0
0.006,6,10,1547,5,764,1.0,496.0,496.0,5,783,1.0,515.0,515.0
40.061,17,10,676,5,460,10014.0,104.0,64.0,5,216,10014.0,20.0,15.0
0.072,6,10,1506,5,395,16.0,127.0,127.0,5,1111,17.0,843.0,843.0
0.004,17,4,284,2,120,1.0,32.0,32.0,2,164,0.0,60.0,54.0
11.436,17,28,4422,14,1994,871.0,269.0,114.0,14,2428,871.0,587.0,145.0
0.011,6,10,1972,5,910,2.0,642.0,642.0,5,1062,2.0,794.0,794.0
0.006,6,10,1989,5,927,1.0,659.0,659.0,5,1062,1.0,794.0,794.0
0.012,6,10,1972,5,910,3.0,642.0,642.0,5,1062,3.0,794.0,794.0
0.086,6,10,1506,5,395,19.0,127.0,127.0,5,1111,17.0,843.0,843.0
0.019,6,10,1989,5,910,4.0,642.0,642.0,5,1079,4.0,811.0,811.0
0.012,6,10,1972,5,910,3.0,642.0,642.0,5,1062,2.0,794.0,794.0
0.005,6,10,2007,5,928,1.0,660.0,660.0,5,1079,1.0,811.0,811.0
0.013,6,10,1990,5,911,3.0,643.0,643.0,5,1079,3.0,811.0,811.0
0.02,6,10,1972,5,910,5.0,642.0,642.0,5,1062,4.0,794.0,794.0
0.005,17,2,169,1,62,0.0,34.0,34.0,1,107,0.0,79.0,79.0
0.082,6,10,1506,5,395,17.0,127.0,127.0,5,1111,13.0,843.0,843.0
0.112,6,10,1506,5,395,25.0,127.0,127.0,5,1111,24.0,843.0,843.0
0.007,6,10,1547,5,764,1.0,496.0,496.0,5,783,1.0,515.0,515.0
0.014,6,10,1983,5,910,3.0,642.0,642.0,5,1073,3.0,805.0,805.0
0.147,6,10,1506,5,395,18.0,127.0,127.0,5,1111,34.0,843.0,843.0
0.005,6,10,2000,5,927,1.0,659.0,659.0,5,1073,1.0,805.0,805.0
0.107,6,10,1506,5,395,23.0,127.0,127.0,5,1111,24.0,843.0,843.0
0.081,6,10,1506,5,395,18.0,127.0,127.0,5,1111,17.0,843.0,843.0
0.013,6,10,1989,5,910,3.0,642.0,642.0,5,1079,3.0,811.0,811.0
0.006,17,2,154,1,69,0.0,41.0,41.0,1,85,0.0,57.0,57.0
0.0,17,2,136,1,60,0.0,32.0,32.0,1,76,0.0,48.0,48.0
0.013,6,10,1990,5,911,3.0,643.0,643.0,5,1079,3.0,811.0,811.0
0.038,17,4,420,2,122,0.0,33.0,33.0,2,298,35.0,145.0,121.0
413.231,6,29,4409,12,3102,10914.0,494.0,494.0,17,1307,25826.0,83.0,83.0
0.018,6,10,1990,5,911,4.0,643.0,643.0,5,1079,4.0,811.0,811.0
0.042,17,4,284,2,120,0.0,32.0,32.0,2,164,39.0,60.0,54.0
0.005,6,10,1643,5,860,1.0,592.0,592.0,5,783,1.0,515.0,515.0
0.007,17,2,299,1,65,0.0,37.0,37.0,1,234,0.0,206.0,206.0
0.062,6,14,3868,7,578,10.0,206.0,206.0,7,3290,10.0,1448.0,972.0
0.012,6,13,3735,7,497,2.0,125.0,125.0,6,3238,2.0,1470.0,1459.0
0.007,17,2,194,1,59,0.0,31.0,31.0,1,135,0.0,107.0,107.0
0.019,6,10,1677,5,827,4.0,559.0,559.0,5,850,4.0,582.0,582.0
0.005,6,10,2006,5,927,1.0,659.0,659.0,5,1079,1.0,811.0,811.0
40.077,17,10,676,5,460,10016.0,104.0,64.0,5,216,10018.0,20.0,15.0
290.572,6,322,344587,132,18422,2218.0,2694.0,889.0,190,326165,1537.0,2769.0,1797.0
0.172,17,2,152,1,76,0.0,48.0,48.0,1,76,0.0,48.0,48.0
0.01,6,10,1989,5,910,2.0,642.0,642.0,5,1079,2.0,811.0,811.0
0.008,6,10,1989,5,910,2.0,642.0,642.0,5,1079,1.0,811.0,811.0
0.005,6,10,2007,5,928,1.0,660.0,660.0,5,1079,1.0,811.0,811.0
0.069,17,8,3613,4,1874,23.0,1350.0,440.0,4,1739,11.0,1350.0,406.0
0.158,17,2,80,1,32,0.0,4.0,4.0,1,48,0.0,20.0,20.0
0.013,6,10,1989,5,910,3.0,642.0,642.0,5,1079,3.0,811.0,811.0
300.026,6,12,1782,7,1348,50004.0,494.0,494.0,5,434,75005.0,83.0,83.0
1789.036,6,153,19820,91,14094,19878.0,302.0,302.0,62,5726,29328.0,83.0,83.0
0.006,6,10,1779,5,928,1.0,660.0,660.0,5,851,1.0,583.0,583.0
0.004,6,10,1989,5,927,1.0,659.0,659.0,5,1062,1.0,794.0,794.0
0.067,6,10,1506,5,395,14.0,127.0,127.0,5,1111,15.0,843.0,843.0
0.366,17,49,27164,29,23637,13.0,1350.0,787.0,20,3527,16.0,1350.0,148.0
0.01,6,10,1989,5,910,2.0,642.0,642.0,5,1079,2.0,811.0,811.0
0.007,17,2,194,1,59,0.0,31.0,31.0,1,135,0.0,107.0,107.0
0.005,6,10,1854,5,889,1.0,621.0,621.0,5,965,1.0,697.0,697.0
0.009,6,10,1972,5,910,2.0,642.0,642.0,5,1062,2.0,794.0,794.0
0.004,6,10,1779,5,928,1.0,660.0,660.0,5,851,1.0,583.0,583.0
0.007,6,10,2006,5,927,1.0,659.0,659.0,5,1079,1.0,811.0,811.0
161.689,6,21,8113,11,1953,80.0,1174.0,493.0,10,6160,17947.0,2720.0,958.0
0.012,6,10,1990,5,911,3.0,643.0,643.0,5,1079,2.0,811.0,811.0
0.02,6,10,1972,5,910,5.0,642.0,642.0,5,1062,4.0,794.0,794.0
0.005,6,10,2007,5,928,1.0,660.0,660.0,5,1079,1.0,811.0,811.0
62.591,6,36,8190,19,1759,3477.0,651.0,322.0,17,6431,560.0,2126.0,478.0
0.029,6,10,1972,5,910,7.0,642.0,642.0,5,1062,7.0,794.0,794.0
0.023,17,2,198,1,91,0.0,63.0,63.0,1,107,0.0,79.0,79.0
0.005,6,10,1689,5,839,1.0,571.0,571.0,5,850,1.0,582.0,582.0
0.005,17,2,179,1,71,0.0,43.0,43.0,1,108,0.0,80.0,80.0
0.001,17,2,180,1,66,0.0,38.0,38.0,1,114,0.0,86.0,86.0
292.963,6,330,345369,119,17742,2482.0,2736.0,889.0,211,327627,1395.0,2804.0,1607.0
0.008,6,10,1990,5,911,2.0,643.0,643.0,5,1079,2.0,811.0,811.0
0.103,6,10,1506,5,395,23.0,127.0,127.0,5,1111,24.0,843.0,843.0
0.005,17,2,170,1,65,0.0,37.0,37.0,1,105,0.0,77.0,77.0
354.016,6,21,1795,16,1030,23601.0,190.0,190.0,5,765,60002.0,464.0,248.0
0.13,6,10,1506,5,395,30.0,127.0,127.0,5,1111,27.0,843.0,843.0
0.005,6,10,1643,5,860,1.0,592.0,592.0,5,783,1.0,515.0,515.0
0.16,6,10,1506,5,395,38.0,127.0,127.0,5,1111,38.0,843.0,843.0
0.067,6,10,1506,5,395,15.0,127.0,127.0,5,1111,13.0,843.0,843.0
0.119,6,10,1506,5,395,25.0,127.0,127.0,5,1111,25.0,843.0,843.0
280.824,6,25,6480,12,1266,25529.0,267.0,156.0,13,5214,23401.0,1400.0,781.0
0.004,17,2,136,1,60,0.0,32.0,32.0,1,76,0.0,48.0,48.0
0.005,17,2,140,1,62,0.0,34.0,34.0,1,78,0.0,50.0,50.0
0.017,6,10,1677,5,827,4.0,559.0,559.0,5,850,4.0,582.0,582.0
0.008,6,10,1972,5,910,2.0,642.0,642.0,5,1062,1.0,794.0,794.0
0.019,6,10,1989,5,910,4.0,642.0,642.0,5,1079,4.0,811.0,811.0
0.02,6,10,1989,5,910,4.0,642.0,642.0,5,1079,4.0,811.0,811.0
0.002,17,2,166,1,75,0.0,47.0,47.0,1,91,0.0,63.0,63.0
0.01,6,10,1677,5,827,2.0,559.0,559.0,5,850,2.0,582.0,582.0
0.006,6,12,1698,6,863,1.0,327.0,271.0,6,835,1.0,515.0,515.0
0.016,6,10,1990,5,911,3.0,643.0,643.0,5,1079,4.0,811.0,811.0
0.006,6,10,1547,5,764,1.0,496.0,496.0,5,783,1.0,515.0,515.0
0.005,6,10,2007,5,928,1.0,660.0,660.0,5,1079,1.0,811.0,811.0
176.535,17,82,11973,41,2751,4413.0,44.0,39.0,41,9222,4413.0,239.0,196.0
300.322,6,16,2170,9,684,37519.0,146.0,146.0,7,1486,50025.0,419.0,398.0
0.017,6,10,1972,5,910,4.0,642.0,642.0,5,1062,4.0,794.0,794.0
0.005,6,10,2007,5,928,1.0,660.0,660.0,5,1079,1.0,811.0,811.0
0.015,6,10,1989,5,910,3.0,642.0,642.0,5,1079,3.0,811.0,811.0
0.084,6,10,1506,5,395,17.0,127.0,127.0,5,1111,19.0,843.0,843.0
0.092,6,10,1506,5,395,21.0,127.0,127.0,5,1111,21.0,843.0,843.0
0.013,6,10,1990,5,911,3.0,643.0,643.0,5,1079,3.0,811.0,811.0
0.009,6,10,1989,5,910,2.0,642.0,642.0,5,1079,2.0,811.0,811.0
0.01,6,14,3787,7,497,1.0,125.0,125.0,7,3290,1.0,1448.0,972.0
0.011,6,10,1989,5,910,2.0,642.0,642.0,5,1079,2.0,811.0,811.0
0.006,17,2,302,1,65,0.0,37.0,37.0,1,237,0.0,209.0,209.0
415.677,6,29,4409,12,3102,10915.0,494.0,494.0,17,1307,25978.0,83.0,83.0
0.006,6,10,1854,5,889,1.0,621.0,621.0,5,965,1.0,697.0,697.0
0.006,17,2,166,1,75,0.0,47.0,47.0,1,91,0.0,63.0,63.0
0.071,6,10,1506,5,395,15.0,127.0,127.0,5,1111,14.0,843.0,843.0
0.005,6,10,2006,5,927,1.0,659.0,659.0,5,1079,1.0,811.0,811.0
0.005,6,10,2006,5,927,1.0,659.0,659.0,5,1079,1.0,811.0,811.0
0.006,6,10,2007,5,928,1.0,660.0,660.0,5,1079,1.0,811.0,811.0
0.005,6,10,2006,5,927,1.0,659.0,659.0,5,1079,1.0,811.0,811.0
0.013,6,10,1631,5,848,3.0,580.0,580.0,5,783,3.0,515.0,515.0
0.151,6,10,1506,5,395,25.0,127.0,127.0,5,1111,33.0,843.0,843.0
0.014,6,10,1972,5,910,3.0,642.0,642.0,5,1062,3.0,794.0,794.0
0.006,6,10,1689,5,839,1.0,571.0,571.0,5,850,1.0,582.0,582.0
1782.4,6,303,97579,188,86445,9531.0,1402.0,672.0,115,11134,15635.0,452.0,70.0
0.014,6,10,1989,5,910,3.0,642.0,642.0,5,1079,3.0,811.0,811.0
0.006,17,2,175,1,65,0.0,37.0,37.0,1,110,0.0,82.0,82.0
0.219,6,16,2778,8,1396,31.0,533.0,324.0,8,1382,20.0,529.0,239.0
0.014,6,10,1989,5,910,3.0,642.0,642.0,5,1079,3.0,811.0,811.0
0.112,6,10,1506,5,395,23.0,127.0,127.0,5,1111,26.0,843.0,843.0
0.111,6,10,1506,5,395,23.0,127.0,127.0,5,1111,24.0,843.0,843.0
0.008,17,2,179,1,71,0.0,43.0,43.0,1,108,0.0,80.0,80.0
0.016,6,10,1631,5,848,3.0,580.0,580.0,5,783,4.0,515.0,515.0
0.014,6,10,1990,5,911,3.0,643.0,643.0,5,1079,3.0,811.0,811.0
0.011,6,10,1762,5,911,2.0,643.0,643.0,5,851,2.0,583.0,583.0
315.508,17,20,1124,10,716,35042.0,48.0,43.0,10,408,35042.0,20.0,12.0
0.13,6,10,1506,5,395,25.0,127.0,127.0,5,1111,30.0,843.0,843.0
0.009,6,10,1989,5,910,2.0,642.0,642.0,5,1079,2.0,811.0,811.0
300.244,6,16,2170,9,684,37509.0,146.0,146.0,7,1486,50012.0,419.0,398.0
40.076,17,10,676,5,460,10018.0,104.0,64.0,5,216,10017.0,20.0,15.0
0.005,6,10,2007,5,928,1.0,660.0,660.0,5,1079,1.0,811.0,811.0
0.006,17,2,238,1,66,0.0,38.0,38.0,1,172,0.0,144.0,144.0
15.071,17,15,9238,8,6902,2149.0,1350.0,834.0,7,2336,2507.0,1350.0,305.0
0.012,6,10,1989,5,910,3.0,642.0,642.0,5,1079,2.0,811.0,811.0
0.091,6,10,1506,5,395,20.0,127.0,127.0,5,1111,20.0,843.0,843.0
0.005,17,2,412,1,61,0.0,33.0,33.0,1,351,0.0,323.0,323.0
15.089,17,15,8336,8,6300,2151.0,1350.0,759.0,7,2036,2509.0,1350.0,262.0
0.013,6,10,1762,5,911,3.0,643.0,643.0,5,851,3.0,583.0,583.0
40.064,17,10,676,5,460,10013.0,104.0,64.0,5,216,10015.0,20.0,15.0
0.012,6,10,1677,5,827,3.0,559.0,559.0,5,850,2.0,582.0,582.0
0.005,17,2,140,1,62,0.0,34.0,34.0,1,78,0.0,50.0,50.0
0.005,6,10,2000,5,927,1.0,659.0,659.0,5,1073,1.0,805.0,805.0
0.004,6,10,2006,5,927,1.0,659.0,659.0,5,1079,0.0,811.0,811.0
0.03,6,10,1990,5,911,7.0,643.0,643.0,5,1079,7.0,811.0,811.0
0.097,6,10,1506,5,395,21.0,127.0,127.0,5,1111,22.0,843.0,843.0
0.005,6,10,2006,5,927,1.0,659.0,659.0,5,1079,1.0,811.0,811.0
0.004,6,10,2006,5,927,1.0,659.0,659.0,5,1079,1.0,811.0,811.0
0.089,6,10,1506,5,395,19.0,127.0,127.0,5,1111,17.0,843.0,843.0
0.008,6,13,3735,7,497,1.0,125.0,125.0,6,3238,1.0,1470.0,1459.0
15.083,17,15,8351,8,6283,2150.0,1350.0,757.0,7,2068,2508.0,1350.0,267.0
0.005,17,2,148,1,60,0.0,32.0,32.0,1,88,0.0,60.0,60.0
0.103,6,10,1506,5,395,22.0,127.0,127.0,5,1111,22.0,843.0,843.0
15.078,17,16,9303,8,6912,2150.0,1350.0,836.0,8,2391,2150.0,1350.0,270.0
0.001,17,2,136,1,60,0.0,32.0,32.0,1,76,0.0,48.0,48.0
0.005,6,10,1689,5,839,1.0,571.0,571.0,5,850,1.0,582.0,582.0
10.747,17,28,4421,14,1993,818.0,268.0,114.0,14,2428,818.0,587.0,145.0
310.052,6,405,348185,198,21865,1573.0,2736.0,889.0,207,326320,1505.0,2804.0,1626.0
0.012,6,10,1989,5,910,3.0,642.0,642.0,5,1079,2.0,811.0,811.0
0.006,6,10,1547,5,764,1.0,496.0,496.0,5,783,1.0,515.0,515.0
1.124,6,32,12787,17,3312,70.0,1360.0,517.0,15,9475,66.0,2720.0,886.0
40.065,17,10,676,5,460,10013.0,104.0,64.0,5,216,10014.0,20.0,15.0
0.005,6,10,2000,5,927,1.0,659.0,659.0,5,1073,1.0,805.0,805.0
10.821,17,28,4421,14,1993,823.0,268.0,114.0,14,2428,823.0,587.0,145.0
40.059,17,10,676,5,460,10013.0,104.0,64.0,5,216,10013.0,20.0,15.0
240.301,6,35,10342,17,1831,15018.0,555.0,187.0,18,8511,14135.0,1417.0,631.0
0.033,6,10,1983,5,910,8.0,642.0,642.0,5,1073,8.0,805.0,805.0
0.266,17,2,80,1,32,0.0,4.0,4.0,1,48,0.0,20.0,20.0
0.006,17,2,179,1,71,0.0,43.0,43.0,1,108,0.0,80.0,80.0
0.005,17,2,225,1,65,0.0,37.0,37.0,1,160,0.0,132.0,132.0
0.006,6,10,1547,5,764,1.0,496.0,496.0,5,783,1.0,515.0,515.0
0.123,17,2,170,1,65,0.0,37.0,37.0,1,105,0.0,77.0,77.0
0.004,17,2,170,1,65,0.0,37.0,37.0,1,105,0.0,77.0,77.0
0.04,17,4,284,2,120,0.0,32.0,32.0,2,164,36.0,60.0,54.0
0.159,6,10,1506,5,395,31.0,127.0,127.0,5,1111,38.0,843.0,843.0
0.103,6,10,1506,5,395,23.0,127.0,127.0,5,1111,22.0,843.0,843.0
0.001,17,2,174,1,72,0.0,44.0,44.0,1,102,0.0,74.0,74.0
0.006,6,10,1689,5,839,1.0,571.0,571.0,5,850,1.0,582.0,582.0
0.006,6,12,1698,6,863,1.0,327.0,271.0,6,835,1.0,515.0,515.0
166.317,17,8,1340,4,272,55436.0,40.0,40.0,4,1068,55437.0,239.0,239.0
0.01,6,13,3735,7,497,1.0,125.0,125.0,6,3238,1.0,1470.0,1459.0
0.001,17,2,180,1,66,0.0,38.0,38.0,1,114,0.0,86.0,86.0
15.072,17,15,9238,8,6902,2149.0,1350.0,834.0,7,2336,2507.0,1350.0,305.0
0.006,6,10,1774,5,923,1.0,655.0,655.0,5,851,1.0,583.0,583.0
0.005,17,2,230,1,68,0.0,40.0,40.0,1,162,0.0,134.0,134.0
0.076,6,10,1506,5,395,16.0,127.0,127.0,5,1111,17.0,843.0,843.0
0.006,6,10,1643,5,860,1.0,592.0,592.0,5,783,1.0,515.0,515.0
0.095,6,10,1506,5,395,19.0,127.0,127.0,5,1111,19.0,843.0,843.0
0.008,6,10,1990,5,911,2.0,643.0,643.0,5,1079,2.0,811.0,811.0
293.691,6,339,344770,148,19500,1997.0,2736.0,888.0,191,325270,1545.0,2804.0,1801.0
0.013,6,10,1972,5,910,3.0,642.0,642.0,5,1062,3.0,794.0,794.0
0.004,6,10,2000,5,927,1.0,659.0,659.0,5,1073,1.0,805.0,805.0
0.079,6,10,1506,5,395,16.0,127.0,127.0,5,1111,16.0,843.0,843.0
0.012,6,10,1990,5,911,3.0,643.0,643.0,5,1079,3.0,811.0,811.0
0.015,17,2,198,1,91,0.0,63.0,63.0,1,107,0.0,79.0,79.0
240.532,6,33,9264,16,1835,16033.0,623.0,199.0,17,7429,15031.0,1402.0,595.0
0.015,6,10,1989,5,910,3.0,642.0,642.0,5,1079,3.0,811.0,811.0
0.04,17,2,170,1,65,0.0,37.0,37.0,1,105,0.0,77.0,77.0
0.013,6,10,1983,5,910,3.0,642.0,642.0,5,1073,3.0,805.0,805.0
172.427,17,84,11809,42,2796,4205.0,44.0,38.0,42,9013,4205.0,261.0,186.0
0.101,6,10,1506,5,395,20.0,127.0,127.0,5,1111,22.0,843.0,843.0
0.022,6,10,1972,5,910,5.0,642.0,642.0,5,1062,5.0,794.0,794.0
0.005,6,10,2006,5,927,1.0,659.0,659.0,5,1079,1.0,811.0,811.0
0.006,17,2,194,1,59,0.0,31.0,31.0,1,135,0.0,107.0,107.0
0.012,6,10,1972,5,910,2.0,642.0,642.0,5,1062,2.0,794.0,794.0
0.073,6,10,1506,5,395,16.0,127.0,127.0,5,1111,14.0,843.0,843.0
0.005,17,2,170,1,65,0.0,37.0,37.0,1,105,0.0,77.0,77.0
0.006,6,10,1854,5,889,1.0,621.0,621.0,5,965,1.0,697.0,697.0
0.105,6,10,1506,5,395,24.0,127.0,127.0,5,1111,24.0,843.0,843.0
241.256,6,381,346797,195,21673,1243.0,2695.0,960.0,186,325124,1304.0,2804.0,1792.0
0.017,6,10,1972,5,910,4.0,642.0,642.0,5,1062,4.0,794.0,794.0
0.012,6,10,1990,5,911,2.0,643.0,643.0,5,1079,2.0,811.0,811.0
240.151,6,41,5377,21,2479,12007.0,588.0,197.0,20,2898,12639.0,580.0,231.0
0.027,6,10,1989,5,910,6.0,642.0,642.0,5,1079,6.0,811.0,811.0
40.073,17,10,676,5,460,10016.0,104.0,64.0,5,216,10017.0,20.0,15.0
0.006,6,10,1547,5,764,1.0,496.0,496.0,5,783,1.0,515.0,515.0
0.007,17,4,284,2,120,0.0,32.0,32.0,2,164,0.0,60.0,54.0
0.01,6,10,1989,5,910,2.0,642.0,642.0,5,1079,2.0,811.0,811.0
0.012,6,10,1762,5,911,3.0,643.0,643.0,5,851,2.0,583.0,583.0
0.004,6,10,1779,5,928,1.0,660.0,660.0,5,851,1.0,583.0,583.0
0.004,17,4,284,2,120,0.0,32.0,32.0,2,164,1.0,60.0,54.0
0.085,6,10,1506,5,395,18.0,127.0,127.0,5,1111,20.0,843.0,843.0
0.083,6,10,1506,5,395,18.0,127.0,127.0,5,1111,18.0,843.0,843.0
0.004,6,10,1989,5,927,1.0,659.0,659.0,5,1062,1.0,794.0,794.0
0.015,6,10,1989,5,910,3.0,642.0,642.0,5,1079,3.0,811.0,811.0
0.005,6,10,2006,5,927,1.0,659.0,659.0,5,1079,1.0,811.0,811.0
0.011,6,10,1972,5,910,2.0,642.0,642.0,5,1062,2.0,794.0,794.0
0.016,6,10,1972,5,910,3.0,642.0,642.0,5,1062,3.0,794.0,794.0
0.042,17,2,182,1,65,0.0,37.0,37.0,1,117,0.0,89.0,89.0
0.005,6,10,1854,5,889,1.0,621.0,621.0,5,965,1.0,697.0,697.0
0.071,6,10,1506,5,395,13.0,127.0,127.0,5,1111,16.0,843.0,843.0
0.005,6,14,3742,8,504,0.0,80.0,80.0,6,3238,1.0,1470.0,1459.0
0.003,17,2,136,1,60,0.0,32.0,32.0,1,76,0.0,48.0,48.0
0.009,6,10,1989,5,910,2.0,642.0,642.0,5,1079,2.0,811.0,811.0
354.062,6,19,1691,15,978,25290.0,190.0,190.0,4,713,80005.0,497.0,497.0
0.118,6,10,1506,5,395,25.0,127.0,127.0,5,1111,26.0,843.0,843.0
0.004,6,10,1989,5,927,1.0,659.0,659.0,5,1062,1.0,794.0,794.0
0.014,6,10,1983,5,910,3.0,642.0,642.0,5,1073,3.0,805.0,805.0
0.014,6,10,1677,5,827,3.0,559.0,559.0,5,850,3.0,582.0,582.0
0.005,6,10,2006,5,927,1.0,659.0,659.0,5,1079,1.0,811.0,811.0
0.083,6,10,1506,5,395,17.0,127.0,127.0,5,1111,17.0,843.0,843.0
0.013,6,10,1989,5,910,3.0,642.0,642.0,5,1079,3.0,811.0,811.0
0.039,6,13,3735,7,497,6.0,125.0,125.0,6,3238,7.0,1470.0,1459.0
0.004,6,10,1989,5,927,1.0,659.0,659.0,5,1062,1.0,794.0,794.0
0.039,17,4,284,2,120,0.0,32.0,32.0,2,164,36.0,60.0,54.0
0.013,6,10,1989,5,910,3.0,642.0,642.0,5,1079,3.0,811.0,811.0
0.067,6,10,1506,5,395,15.0,127.0,127.0,5,1111,14.0,843.0,843.0
240.093,6,16,4480,9,963,30011.0,238.0,166.0,7,3517,40015.0,1402.0,786.0
0.005,6,10,1643,5,860,1.0,592.0,592.0,5,783,1.0,515.0,515.0
0.014,6,10,1990,5,911,3.0,643.0,643.0,5,1079,3.0,811.0,811.0
0.004,6,10,1779,5,928,1.0,660.0,660.0,5,851,1.0,583.0,583.0
0.004,6,10,1779,5,928,1.0,660.0,660.0,5,851,1.0,583.0,583.0
0.015,6,10,1983,5,910,3.0,642.0,642.0,5,1073,3.0,805.0,805.0
0.005,6,10,1547,5,764,1.0,496.0,496.0,5,783,1.0,515.0,515.0
0.006,6,10,1547,5,764,1.0,496.0,496.0,5,783,1.0,515.0,515.0
0.168,6,10,1506,5,395,38.0,127.0,127.0,5,1111,40.0,843.0,843.0
0.103,6,10,1506,5,395,23.0,127.0,127.0,5,1111,22.0,843.0,843.0
0.006,6,10,1547,5,764,1.0,496.0,496.0,5,783,1.0,515.0,515.0
0.015,6,10,1972,5,910,3.0,642.0,642.0,5,1062,3.0,794.0,794.0
0.005,17,2,169,1,62,0.0,34.0,34.0,1,107,0.0,79.0,79.0
178.101,17,86,12383,43,2874,4240.0,44.0,38.0,43,9509,4240.0,261.0,193.0
0.071,6,10,1506,5,395,16.0,127.0,127.0,5,1111,16.0,843.0,843.0
0.004,6,10,1989,5,927,1.0,659.0,659.0,5,1062,1.0,794.0,794.0
0.077,6,10,1506,5,395,18.0,127.0,127.0,5,1111,17.0,843.0,843.0
0.006,6,10,2000,5,927,1.0,659.0,659.0,5,1073,1.0,805.0,805.0
0.005,6,10,2006,5,927,1.0,659.0,659.0,5,1079,1.0,811.0,811.0
0.004,6,10,2007,5,928,1.0,660.0,660.0,5,1079,1.0,811.0,811.0
0.014,6,10,1972,5,910,3.0,642.0,642.0,5,1062,3.0,794.0,794.0
0.035,17,2,152,1,76,0.0,48.0,48.0,1,76,0.0,48.0,48.0
0.009,6,10,1972,5,910,2.0,642.0,642.0,5,1062,2.0,794.0,794.0
1787.612,6,150,19350,90,13740,20085.0,302.0,302.0,60,5610,30298.0,83.0,83.0
0.009,6,10,1989,5,910,2.0,642.0,642.0,5,1079,2.0,811.0,811.0
0.012,6,10,1972,5,910,3.0,642.0,642.0,5,1062,2.0,794.0,794.0
0.147,6,10,1506,5,395,32.0,127.0,127.0,5,1111,35.0,843.0,843.0
0.004,6,10,2006,5,927,1.0,659.0,659.0,5,1079,1.0,811.0,811.0
1770.467,6,83,4368,42,2210,43181.0,26.0,26.0,41,2158,44260.0,26.0,26.0
40.052,17,10,676,5,460,10012.0,104.0,64.0,5,216,10012.0,20.0,15.0
0.012,6,10,1983,5,910,3.0,642.0,642.0,5,1073,3.0,805.0,805.0
0.009,6,10,1989,5,910,2.0,642.0,642.0,5,1079,2.0,811.0,811.0
15.075,17,15,9238,8,6902,2149.0,1350.0,834.0,7,2336,2507.0,1350.0,305.0
0.003,17,2,148,1,60,0.0,32.0,32.0,1,88,0.0,60.0,60.0
0.006,6,10,1643,5,860,1.0,592.0,592.0,5,783,1.0,515.0,515.0
0.022,6,10,1983,5,910,5.0,642.0,642.0,5,1073,5.0,805.0,805.0
0.093,6,10,1506,5,395,22.0,127.0,127.0,5,1111,19.0,843.0,843.0
0.006,6,10,1547,5,764,1.0,496.0,496.0,5,783,1.0,515.0,515.0
240.085,6,16,4481,9,963,30010.0,238.0,166.0,7,3518,40013.0,1402.0,786.0
0.001,17,2,179,1,62,0.0,34.0,34.0,1,117,0.0,89.0,89.0
46.011,6,40,10527,20,4929,472.0,1360.0,682.0,20,5598,2412.0,2667.0,435.0
0.02,6,10,1990,5,911,4.0,643.0,643.0,5,1079,4.0,811.0,811.0
240.012,6,9,787,5,488,60003.0,232.0,232.0,4,299,80002.0,83.0,83.0
0.001,17,2,179,1,62,0.0,34.0,34.0,1,117,0.0,89.0,89.0
0.191,6,3,453,2,321,191.0,241.0,241.0,1,132,0.0,92.0,92.0
0.01,6,10,1989,5,910,2.0,642.0,642.0,5,1079,2.0,811.0,811.0
0.016,6,10,1762,5,911,4.0,643.0,643.0,5,851,3.0,583.0,583.0
0.008,6,10,1990,5,911,2.0,643.0,643.0,5,1079,2.0,811.0,811.0
0.003,17,2,136,1,60,0.0,32.0,32.0,1,76,0.0,48.0,48.0
0.084,6,10,1506,5,395,19.0,127.0,127.0,5,1111,15.0,843.0,843.0
0.005,6,10,1779,5,928,1.0,660.0,660.0,5,851,1.0,583.0,583.0
0.014,6,10,1605,5,388,3.0,120.0,120.0,5,1217,3.0,949.0,949.0
168.131,17,74,10736,37,2469,4670.0,44.0,38.0,37,8267,4670.0,261.0,195.0
0.004,6,10,1989,5,927,1.0,659.0,659.0,5,1062,1.0,794.0,794.0
40.053,17,10,676,5,460,10012.0,104.0,64.0,5,216,10012.0,20.0,15.0
0.011,6,10,1989,5,910,2.0,642.0,642.0,5,1079,2.0,811.0,811.0
0.008,17,2,230,1,68,0.0,40.0,40.0,1,162,0.0,134.0,134.0
0.013,6,10,1990,5,911,3.0,643.0,643.0,5,1079,3.0,811.0,811.0
0.097,6,10,1506,5,395,19.0,127.0,127.0,5,1111,23.0,843.0,843.0
0.091,6,10,1506,5,395,21.0,127.0,127.0,5,1111,21.0,843.0,843.0
0.06,17,2,152,1,76,0.0,48.0,48.0,1,76,0.0,48.0,48.0
0.092,6,10,1506,5,395,19.0,127.0,127.0,5,1111,20.0,843.0,843.0
0.005,17,2,170,1,65,0.0,37.0,37.0,1,105,0.0,77.0,77.0
0.02,6,10,1989,5,910,5.0,642.0,642.0,5,1079,5.0,811.0,811.0
0.012,6,10,1989,5,910,3.0,642.0,642.0,5,1079,2.0,811.0,811.0
0.004,17,4,284,2,120,0.0,32.0,32.0,2,164,1.0,60.0,54.0
0.011,6,10,1972,5,910,2.0,642.0,642.0,5,1062,2.0,794.0,794.0
0.005,6,10,2006,5,927,1.0,659.0,659.0,5,1079,1.0,811.0,811.0
0.017,6,10,1990,5,911,4.0,643.0,643.0,5,1079,4.0,811.0,811.0
0.008,6,10,1972,5,910,2.0,642.0,642.0,5,1062,2.0,794.0,794.0
0.008,6,13,3735,7,497,1.0,125.0,125.0,6,3238,1.0,1470.0,1459.0
0.111,6,10,1506,5,395,26.0,127.0,127.0,5,1111,21.0,843.0,843.0
0.085,6,10,1506,5,395,19.0,127.0,127.0,5,1111,17.0,843.0,843.0
0.005,6,14,3742,8,504,0.0,80.0,80.0,6,3238,1.0,1470.0,1459.0
0.089,6,10,1506,5,395,20.0,127.0,127.0,5,1111,20.0,843.0,843.0
0.005,6,10,1989,5,927,1.0,659.0,659.0,5,1062,1.0,794.0,794.0
0.005,6,10,1989,5,927,1.0,659.0,659.0,5,1062,1.0,794.0,794.0
0.004,17,2,148,1,60,0.0,32.0,32.0,1,88,0.0,60.0,60.0
1791.773,6,324,51578,136,31069,13271.0,2799.0,241.0,188,20509,9580.0,1360.0,149.0
0.005,6,10,2006,5,927,1.0,659.0,659.0,5,1079,1.0,811.0,811.0
0.005,6,10,2000,5,927,1.0,659.0,659.0,5,1073,1.0,805.0,805.0
0.107,6,10,1506,5,395,23.0,127.0,127.0,5,1111,25.0,843.0,843.0
0.11,6,10,1506,5,395,25.0,127.0,127.0,5,1111,25.0,843.0,843.0
0.005,6,10,2007,5,928,1.0,660.0,660.0,5,1079,1.0,811.0,811.0
0.016,6,10,1989,5,910,3.0,642.0,642.0,5,1079,3.0,811.0,811.0
0.004,6,10,1702,5,863,1.0,595.0,595.0,5,839,1.0,571.0,571.0
0.085,6,10,1506,5,395,18.0,127.0,127.0,5,1111,20.0,843.0,843.0
0.021,17,2,180,1,66,0.0,38.0,38.0,1,114,0.0,86.0,86.0
0.012,6,10,1972,5,910,3.0,642.0,642.0,5,1062,3.0,794.0,794.0
0.005,17,2,144,1,64,0.0,36.0,36.0,1,80,0.0,52.0,52.0
0.092,6,10,1506,5,395,21.0,127.0,127.0,5,1111,17.0,843.0,843.0
0.004,6,10,1702,5,863,1.0,595.0,595.0,5,839,0.0,571.0,571.0
0.019,6,10,1972,5,910,4.0,642.0,642.0,5,1062,4.0,794.0,794.0
0.005,6,10,1702,5,863,1.0,595.0,595.0,5,839,1.0,571.0,571.0
0.006,6,10,1854,5,889,1.0,621.0,621.0,5,965,1.0,697.0,697.0
0.04,17,2,170,1,65,0.0,37.0,37.0,1,105,0.0,77.0,77.0
0.008,6,10,1989,5,910,2.0,642.0,642.0,5,1079,2.0,811.0,811.0
0.005,6,10,1989,5,927,1.0,659.0,659.0,5,1062,1.0,794.0,794.0
0.004,6,10,2006,5,927,1.0,659.0,659.0,5,1079,1.0,811.0,811.0
0.128,6,10,1506,5,395,20.0,127.0,127.0,5,1111,28.0,843.0,843.0
0.096,6,10,1506,5,395,22.0,127.0,127.0,5,1111,23.0,843.0,843.0
0.006,6,10,1547,5,764,1.0,496.0,496.0,5,783,1.0,515.0,515.0
0.012,6,10,1989,5,910,2.0,642.0,642.0,5,1079,2.0,811.0,811.0
0.001,17,2,180,1,66,0.0,38.0,38.0,1,114,0.0,86.0,86.0
40.06,17,10,676,5,460,10012.0,104.0,64.0,5,216,10014.0,20.0,15.0
0.016,17,2,198,1,91,0.0,63.0,63.0,1,107,0.0,79.0,79.0
0.013,6,10,1989,5,910,3.0,642.0,642.0,5,1079,3.0,811.0,811.0
0.109,6,10,1506,5,395,23.0,127.0,127.0,5,1111,25.0,843.0,843.0
0.005,17,2,164,1,74,0.0,46.0,46.0,1,90,0.0,62.0,62.0
0.004,6,10,1779,5,928,1.0,660.0,660.0,5,851,0.0,583.0,583.0
0.037,17,2,148,1,60,0.0,32.0,32.0,1,88,0.0,60.0,60.0
0.011,6,10,1990,5,911,2.0,643.0,643.0,5,1079,2.0,811.0,811.0
172.163,17,82,11645,41,2726,4303.0,44.0,38.0,41,8919,4303.0,239.0,189.0
0.012,6,10,1762,5,911,3.0,643.0,643.0,5,851,3.0,583.0,583.0
0.003,17,2,136,1,60,0.0,32.0,32.0,1,76,0.0,48.0,48.0
25.6,58,5,360,4,288,8533.0,24.0,24.0,1,72,0.0,24.0,24.0
0.004,17,2,136,1,60,0.0,32.0,32.0,1,76,0.0,48.0,48.0
0.004,6,10,1989,5,927,1.0,659.0,659.0,5,1062,1.0,794.0,794.0
0.009,6,10,1677,5,827,2.0,559.0,559.0,5,850,2.0,582.0,582.0
40.091,17,10,676,5,460,10019.0,104.0,64.0,5,216,10022.0,20.0,15.0
0.006,6,10,1643,5,860,1.0,592.0,592.0,5,783,1.0,515.0,515.0
0.038,17,4,284,2,120,0.0,32.0,32.0,2,164,34.0,60.0,54.0
0.087,6,10,1506,5,395,19.0,127.0,127.0,5,1111,20.0,843.0,843.0
0.011,6,10,1972,5,910,2.0,642.0,642.0,5,1062,2.0,794.0,794.0
0.005,6,10,1989,5,927,1.0,659.0,659.0,5,1062,1.0,794.0,794.0
0.001,17,2,136,1,60,0.0,32.0,32.0,1,76,0.0,48.0,48.0
0.078,6,10,1506,5,395,18.0,127.0,127.0,5,1111,17.0,843.0,843.0
0.068,6,10,1506,5,395,15.0,127.0,127.0,5,1111,15.0,843.0,843.0
0.004,17,2,136,1,60,0.0,32.0,32.0,1,76,0.0,48.0,48.0
0.003,17,2,148,1,60,0.0,32.0,32.0,1,88,0.0,60.0,60.0
0.035,6,10,1605,5,388,8.0,120.0,120.0,5,1217,8.0,949.0,949.0
0.071,17,2,184,1,61,0.0,33.0,33.0,1,123,0.0,95.0,95.0
0.009,6,10,1989,5,910,2.0,642.0,642.0,5,1079,2.0,811.0,811.0
40.059,17,10,676,5,460,10013.0,104.0,64.0,5,216,10012.0,20.0,15.0
0.07,17,8,3613,4,1874,23.0,1350.0,440.0,4,1739,11.0,1350.0,406.0
0.003,17,4,284,2,120,0.0,32.0,32.0,2,164,0.0,60.0,54.0
0.079,6,10,1506,5,395,16.0,127.0,127.0,5,1111,17.0,843.0,843.0
0.005,6,10,1643,5,860,1.0,592.0,592.0,5,783,1.0,515.0,515.0
0.079,6,10,1506,5,395,16.0,127.0,127.0,5,1111,16.0,843.0,843.0
0.003,17,2,148,1,60,0.0,32.0,32.0,1,88,0.0,60.0,60.0
0.008,6,13,3735,7,497,1.0,125.0,125.0,6,3238,1.0,1470.0,1459.0
0.005,6,10,2000,5,927,1.0,659.0,659.0,5,1073,1.0,805.0,805.0
0.004,6,10,1702,5,863,1.0,595.0,595.0,5,839,1.0,571.0,571.0
0.001,17,2,180,1,66,0.0,38.0,38.0,1,114,0.0,86.0,86.0
0.084,6,10,1506,5,395,19.0,127.0,127.0,5,1111,19.0,843.0,843.0
0.011,6,10,1989,5,910,2.0,642.0,642.0,5,1079,2.0,811.0,811.0
0.005,17,2,169,1,62,0.0,34.0,34.0,1,107,0.0,79.0,79.0
0.111,6,10,1506,5,395,24.0,127.0,127.0,5,1111,22.0,843.0,843.0
0.005,6,14,3736,7,446,0.0,74.0,74.0,7,3290,0.0,1448.0,972.0
0.005,6,14,3799,7,509,0.0,137.0,137.0,7,3290,0.0,1448.0,972.0
353.965,6,21,1795,16,1030,23597.0,190.0,190.0,5,765,60002.0,464.0,248.0
0.01,6,14,3787,7,497,1.0,125.0,125.0,7,3290,1.0,1448.0,972.0
0.005,6,10,1689,5,839,1.0,571.0,571.0,5,850,1.0,582.0,582.0
0.004,6,10,1702,5,863,1.0,595.0,595.0,5,839,0.0,571.0,571.0
1750.243,6,437,64752,251,35116,7000.0,613.0,197.0,186,29636,9460.0,453.0,142.0
10.822,17,28,4421,14,1994,824.0,269.0,114.0,14,2427,824.0,586.0,145.0
0.037,17,2,148,1,60,0.0,32.0,32.0,1,88,0.0,60.0,60.0
0.007,6,10,1547,5,764,1.0,496.0,496.0,5,783,1.0,515.0,515.0
240.153,6,19,7534,10,2204,26683.0,1496.0,562.0,9,5330,30018.0,2802.0,1210.0
40.073,17,10,676,5,460,10017.0,104.0,64.0,5,216,10017.0,20.0,15.0
40.06,17,10,676,5,460,10014.0,104.0,64.0,5,216,10014.0,20.0,15.0
0.103,6,10,1506,5,395,22.0,127.0,127.0,5,1111,24.0,843.0,843.0
0.004,6,10,2006,5,927,1.0,659.0,659.0,5,1079,1.0,811.0,811.0
80.99,58,3,216,2,144,80990.0,24.0,24.0,1,72,0.0,24.0,24.0
0.01,6,13,3735,7,497,1.0,125.0,125.0,6,3238,2.0,1470.0,1459.0
0.006,6,10,1547,5,764,1.0,496.0,496.0,5,783,1.0,515.0,515.0
0.005,6,13,3747,7,509,0.0,137.0,137.0,6,3238,1.0,1470.0,1459.0
0.02,17,2,148,1,60,0.0,32.0,32.0,1,88,0.0,60.0,60.0
0.004,17,2,136,1,60,0.0,32.0,32.0,1,76,0.0,48.0,48.0
0.005,6,10,2006,5,927,1.0,659.0,659.0,5,1079,1.0,811.0,811.0
0.007,6,10,2006,5,927,1.0,659.0,659.0,5,1079,1.0,811.0,811.0
0.004,17,2,136,1,60,0.0,32.0,32.0,1,76,0.0,48.0,48.0
65.703,6,23,10192,12,3973,5973.0,1579.0,835.0,11,6219,6553.0,1402.0,805.0
300.179,6,23,7621,13,2686,25014.0,1368.0,400.0,10,4935,33352.0,1656.0,1104.0
0.076,6,10,1506,5,395,15.0,127.0,127.0,5,1111,18.0,843.0,843.0
0.001,17,2,180,1,66,0.0,38.0,38.0,1,114,0.0,86.0,86.0
0.115,6,10,1506,5,395,24.0,127.0,127.0,5,1111,24.0,843.0,843.0
0.006,6,10,1854,5,889,1.0,621.0,621.0,5,965,1.0,697.0,697.0
0.005,6,10,2006,5,927,1.0,659.0,659.0,5,1079,1.0,811.0,811.0
0.004,6,10,2007,5,928,1.0,660.0,660.0,5,1079,1.0,811.0,811.0
0.013,6,10,1989,5,910,3.0,642.0,642.0,5,1079,3.0,811.0,811.0
0.018,6,13,3913,7,495,3.0,123.0,123.0,6,3418,3.0,1650.0,1549.0
0.147,6,10,1506,5,395,34.0,127.0,127.0,5,1111,33.0,843.0,843.0
0.013,6,10,1677,5,827,3.0,559.0,559.0,5,850,3.0,582.0,582.0
0.021,6,10,1677,5,827,5.0,559.0,559.0,5,850,5.0,582.0,582.0
0.071,6,10,1506,5,395,15.0,127.0,127.0,5,1111,16.0,843.0,843.0
0.005,6,10,2006,5,927,1.0,659.0,659.0,5,1079,1.0,811.0,811.0
0.011,6,10,1989,5,910,2.0,642.0,642.0,5,1079,2.0,811.0,811.0
0.021,6,10,1989,5,910,5.0,642.0,642.0,5,1079,5.0,811.0,811.0
0.005,6,10,2006,5,927,1.0,659.0,659.0,5,1079,1.0,811.0,811.0
0.008,6,10,2007,5,928,2.0,660.0,660.0,5,1079,1.0,811.0,811.0
0.072,17,4,284,2,120,0.0,32.0,32.0,2,164,69.0,60.0,54.0
0.004,6,10,1702,5,863,1.0,595.0,595.0,5,839,0.0,571.0,571.0
40.081,17,10,676,5,460,10018.0,104.0,64.0,5,216,10019.0,20.0,15.0
0.007,6,10,1547,5,764,1.0,496.0,496.0,5,783,1.0,515.0,515.0
0.017,6,10,1989,5,910,4.0,642.0,642.0,5,1079,4.0,811.0,811.0
0.01,6,10,1990,5,911,2.0,643.0,643.0,5,1079,2.0,811.0,811.0
0.006,6,10,1547,5,764,1.0,496.0,496.0,5,783,1.0,515.0,515.0
0.004,6,10,1779,5,928,1.0,660.0,660.0,5,851,1.0,583.0,583.0
1771.318,6,306,98394,189,87165,9421.0,2001.0,678.0,117,11229,15269.0,452.0,70.0
0.005,6,10,2000,5,927,1.0,659.0,659.0,5,1073,1.0,805.0,805.0
0.01,6,10,1983,5,910,2.0,642.0,642.0,5,1073,2.0,805.0,805.0
0.004,6,10,1989,5,927,1.0,659.0,659.0,5,1062,1.0,794.0,794.0
1792.538,6,491,99665,246,88275,7315.0,421.0,364.0,245,11390,7346.0,53.0,53.0
0.01,6,10,1989,5,910,2.0,642.0,642.0,5,1079,2.0,811.0,811.0
0.004,17,2,136,1,60,0.0,32.0,32.0,1,76,0.0,48.0,48.0
0.003,17,2,152,1,76,0.0,48.0,48.0,1,76,0.0,48.0,48.0
0.006,6,10,1547,5,764,1.0,496.0,496.0,5,783,1.0,515.0,515.0
0.005,6,10,2007,5,928,1.0,660.0,660.0,5,1079,1.0,811.0,811.0
235.219,6,39,9922,21,4404,11752.0,1360.0,588.0,18,5518,13826.0,2667.0,435.0
241.265,6,396,348837,202,22027,1200.0,2736.0,885.0,194,326810,1250.0,4171.0,1759.0
9.037,17,6,376,5,280,2259.0,28.0,28.0,1,96,0.0,68.0,68.0
0.003,17,2,148,1,60,0.0,32.0,32.0,1,88,0.0,60.0,60.0
0.004,17,2,148,1,60,0.0,32.0,32.0,1,88,0.0,60.0,60.0
0.013,6,10,1989,5,910,3.0,642.0,642.0,5,1079,3.0,811.0,811.0
0.001,17,2,179,1,62,0.0,34.0,34.0,1,117,0.0,89.0,89.0
0.112,6,10,1506,5,395,24.0,127.0,127.0,5,1111,25.0,843.0,843.0
0.004,17,2,136,1,60,0.0,32.0,32.0,1,76,0.0,48.0,48.0
0.11,6,10,1506,5,395,24.0,127.0,127.0,5,1111,22.0,843.0,843.0
308.872,17,18,1008,9,640,38593.0,48.0,43.0,9,368,38593.0,20.0,12.0
0.005,6,10,1689,5,839,1.0,571.0,571.0,5,850,1.0,582.0,582.0
240.308,6,30,11227,15,4943,17164.0,1368.0,692.0,15,6284,17164.0,1656.0,785.0
0.007,6,10,1989,5,910,1.0,642.0,642.0,5,1079,1.0,811.0,811.0
40.06,17,10,676,5,460,10014.0,104.0,64.0,5,216,10013.0,20.0,15.0
240.157,6,46,6626,22,3224,11435.0,588.0,230.0,24,3402,10441.0,580.0,195.0
0.006,6,10,1547,5,764,1.0,496.0,496.0,5,783,1.0,515.0,515.0
0.001,17,2,180,1,66,0.0,38.0,38.0,1,114,0.0,86.0,86.0
0.014,6,10,1990,5,911,3.0,643.0,643.0,5,1079,3.0,811.0,811.0
0.011,6,10,1972,5,910,2.0,642.0,642.0,5,1062,2.0,794.0,794.0
15.071,17,14,9190,8,6902,2148.0,1350.0,834.0,6,2288,3008.0,1350.0,353.0
0.095,6,10,1506,5,395,20.0,127.0,127.0,5,1111,20.0,843.0,843.0
0.006,6,10,1547,5,764,1.0,496.0,496.0,5,783,1.0,515.0,515.0
0.012,6,10,1972,5,910,3.0,642.0,642.0,5,1062,3.0,794.0,794.0
0.004,6,10,1779,5,928,1.0,660.0,660.0,5,851,1.0,583.0,583.0
0.001,17,2,179,1,62,0.0,34.0,34.0,1,117,0.0,89.0,89.0
0.012,6,10,1989,5,910,2.0,642.0,642.0,5,1079,2.0,811.0,811.0
0.005,17,2,213,1,69,0.0,41.0,41.0,1,144,0.0,116.0,116.0
0.005,17,2,164,1,74,0.0,46.0,46.0,1,90,0.0,62.0,62.0
0.005,6,10,2006,5,927,1.0,659.0,659.0,5,1079,1.0,811.0,811.0
0.004,6,10,1702,5,863,1.0,595.0,595.0,5,839,1.0,571.0,571.0
0.008,6,13,3735,7,497,1.0,125.0,125.0,6,3238,1.0,1470.0,1459.0
0.007,6,10,1983,5,910,1.0,642.0,642.0,5,1073,1.0,805.0,805.0
0.005,6,10,1774,5,923,1.0,655.0,655.0,5,851,1.0,583.0,583.0
0.004,6,10,2006,5,927,1.0,659.0,659.0,5,1079,1.0,811.0,811.0
0.005,6,10,1989,5,927,1.0,659.0,659.0,5,1062,1.0,794.0,794.0
0.005,6,10,2006,5,927,1.0,659.0,659.0,5,1079,1.0,811.0,811.0
0.012,6,10,1677,5,827,3.0,559.0,559.0,5,850,2.0,582.0,582.0
0.005,6,10,1643,5,860,1.0,592.0,592.0,5,783,1.0,515.0,515.0
0.037,17,2,152,1,76,0.0,48.0,48.0,1,76,0.0,48.0,48.0
0.01,6,10,1989,5,910,2.0,642.0,642.0,5,1079,2.0,811.0,811.0
0.008,6,10,1972,5,910,1.0,642.0,642.0,5,1062,2.0,794.0,794.0
0.019,6,10,1972,5,910,4.0,642.0,642.0,5,1062,4.0,794.0,794.0
0.003,17,2,136,1,60,0.0,32.0,32.0,1,76,0.0,48.0,48.0
0.068,6,10,1506,5,395,15.0,127.0,127.0,5,1111,15.0,843.0,843.0
351.993,6,20,2210,6,1308,12003.0,494.0,494.0,14,902,27076.0,83.0,83.0
0.024,6,10,1762,5,911,6.0,643.0,643.0,5,851,6.0,583.0,583.0
0.08,6,10,1506,5,395,17.0,127.0,127.0,5,1111,18.0,843.0,843.0
0.012,6,10,1972,5,910,3.0,642.0,642.0,5,1062,2.0,794.0,794.0
0.074,17,2,412,1,61,0.0,33.0,33.0,1,351,0.0,323.0,323.0
0.005,6,10,1689,5,839,1.0,571.0,571.0,5,850,1.0,582.0,582.0
0.006,6,10,1643,5,860,1.0,592.0,592.0,5,783,1.0,515.0,515.0
0.006,6,10,1547,5,764,1.0,496.0,496.0,5,783,1.0,515.0,515.0
0.004,6,10,2006,5,927,1.0,659.0,659.0,5,1079,1.0,811.0,811.0
0.002,17,2,136,1,60,0.0,32.0,32.0,1,76,0.0,48.0,48.0
0.005,6,10,2006,5,927,1.0,659.0,659.0,5,1079,1.0,811.0,811.0
0.015,17,2,198,1,91,0.0,63.0,63.0,1,107,0.0,79.0,79.0
0.014,6,10,1983,5,910,3.0,642.0,642.0,5,1073,3.0,805.0,805.0
0.079,6,10,1506,5,395,16.0,127.0,127.0,5,1111,15.0,843.0,843.0
291.9,6,400,348061,191,21508,1536.0,2736.0,889.0,209,326553,1403.0,2804.0,1618.0
0.012,6,10,1989,5,910,3.0,642.0,642.0,5,1079,2.0,811.0,811.0
0.088,6,10,1506,5,395,20.0,127.0,127.0,5,1111,20.0,843.0,843.0
0.012,6,13,3735,7,497,1.0,125.0,125.0,6,3238,2.0,1470.0,1459.0
0.005,6,13,3690,7,452,0.0,80.0,80.0,6,3238,1.0,1470.0,1459.0
0.006,6,10,1643,5,860,1.0,592.0,592.0,5,783,1.0,515.0,515.0
240.088,6,16,4481,9,963,30011.0,238.0,166.0,7,3518,40014.0,1402.0,786.0
0.003,17,2,148,1,60,0.0,32.0,32.0,1,88,0.0,60.0,60.0
0.042,17,2,184,1,61,0.0,33.0,33.0,1,123,0.0,95.0,95.0
0.129,17,2,80,1,32,0.0,4.0,4.0,1,48,0.0,20.0,20.0
0.208,6,16,2778,8,1396,29.0,533.0,324.0,8,1382,18.0,529.0,239.0
0.079,6,10,1506,5,395,17.0,127.0,127.0,5,1111,14.0,843.0,843.0
0.006,17,2,261,1,74,0.0,46.0,46.0,1,187,0.0,159.0,159.0
0.108,6,10,1506,5,395,24.0,127.0,127.0,5,1111,25.0,843.0,843.0
0.005,17,2,169,1,62,0.0,34.0,34.0,1,107,0.0,79.0,79.0
177.294,17,84,12164,42,2825,4324.0,44.0,39.0,42,9339,4324.0,239.0,194.0
0.011,6,10,1972,5,910,2.0,642.0,642.0,5,1062,2.0,794.0,794.0
0.005,6,10,1689,5,839,1.0,571.0,571.0,5,850,1.0,582.0,582.0
0.039,17,2,136,1,60,0.0,32.0,32.0,1,76,0.0,48.0,48.0
0.008,6,13,3735,7,497,1.0,125.0,125.0,6,3238,1.0,1470.0,1459.0
0.005,6,10,2007,5,928,1.0,660.0,660.0,5,1079,1.0,811.0,811.0
0.02,6,10,1983,5,910,4.0,642.0,642.0,5,1073,5.0,805.0,805.0
0.006,17,2,214,1,75,0.0,47.0,47.0,1,139,0.0,111.0,111.0
354.016,6,19,1690,15,978,25286.0,190.0,190.0,4,712,80004.0,496.0,496.0
0.002,17,2,166,1,75,0.0,47.0,47.0,1,91,0.0,63.0,63.0
0.009,6,10,1990,5,911,2.0,643.0,643.0,5,1079,2.0,811.0,811.0
0.011,6,12,1926,6,1189,2.0,659.0,434.0,6,737,2.0,417.0,417.0
0.02,6,10,1990,5,911,5.0,643.0,643.0,5,1079,5.0,811.0,811.0
0.004,17,2,136,1,60,0.0,32.0,32.0,1,76,0.0,48.0,48.0
0.0,17,2,166,1,75,0.0,47.0,47.0,1,91,0.0,63.0,63.0
0.008,6,10,1989,5,910,2.0,642.0,642.0,5,1079,2.0,811.0,811.0
0.004,6,10,1702,5,863,1.0,595.0,595.0,5,839,0.0,571.0,571.0
0.44,17,55,28908,32,25140,14.0,1350.0,757.0,23,3768,16.0,1350.0,135.0
0.005,6,10,1989,5,927,1.0,659.0,659.0,5,1062,1.0,794.0,794.0
0.014,6,10,1989,5,910,3.0,642.0,642.0,5,1079,3.0,811.0,811.0
0.005,17,2,136,1,60,0.0,32.0,32.0,1,76,0.0,48.0,48.0
0.092,6,10,1506,5,395,21.0,127.0,127.0,5,1111,21.0,843.0,843.0
40.058,17,10,676,5,460,10013.0,104.0,64.0,5,216,10013.0,20.0,15.0
0.011,6,10,1983,5,910,2.0,642.0,642.0,5,1073,2.0,805.0,805.0
0.005,6,10,1989,5,927,1.0,659.0,659.0,5,1062,1.0,794.0,794.0
0.015,6,10,1677,5,827,3.0,559.0,559.0,5,850,3.0,582.0,582.0
0.04,17,2,144,1,64,0.0,36.0,36.0,1,80,0.0,52.0,52.0
0.141,6,10,1506,5,395,30.0,127.0,127.0,5,1111,31.0,843.0,843.0
0.082,6,10,1506,5,395,19.0,127.0,127.0,5,1111,16.0,843.0,843.0
0.001,17,2,180,1,66,0.0,38.0,38.0,1,114,0.0,86.0,86.0
0.124,6,10,1506,5,395,28.0,127.0,127.0,5,1111,28.0,843.0,843.0
0.009,6,12,1926,6,1189,1.0,659.0,434.0,6,737,1.0,417.0,417.0
0.013,6,10,1990,5,911,3.0,643.0,643.0,5,1079,3.0,811.0,811.0
0.088,6,10,1506,5,395,18.0,127.0,127.0,5,1111,19.0,843.0,843.0
0.072,17,2,170,1,65,0.0,37.0,37.0,1,105,0.0,77.0,77.0
0.109,6,10,1506,5,395,23.0,127.0,127.0,5,1111,23.0,843.0,843.0
0.014,6,10,1983,5,910,3.0,642.0,642.0,5,1073,3.0,805.0,805.0
0.004,6,10,2006,5,927,1.0,659.0,659.0,5,1079,1.0,811.0,811.0
300.174,6,28,7500,16,1421,20011.0,217.0,142.0,12,6079,21836.0,1679.0,778.0
0.012,6,10,1989,5,910,2.0,642.0,642.0,5,1079,2.0,811.0,811.0
40.064,17,10,676,5,460,10013.0,104.0,64.0,5,216,10014.0,20.0,15.0
0.098,6,10,1506,5,395,22.0,127.0,127.0,5,1111,22.0,843.0,843.0
0.072,17,8,3613,4,1874,24.0,1350.0,440.0,4,1739,12.0,1350.0,406.0
0.01,6,10,1990,5,911,2.0,643.0,643.0,5,1079,2.0,811.0,811.0
0.096,6,10,1506,5,395,22.0,127.0,127.0,5,1111,22.0,843.0,843.0
0.01,6,14,3787,7,497,1.0,125.0,125.0,7,3290,1.0,1448.0,972.0
0.038,17,4,596,2,122,0.0,33.0,33.0,2,474,1.0,323.0,209.0
0.013,6,10,1762,5,911,3.0,643.0,643.0,5,851,3.0,583.0,583.0
0.016,6,10,1983,5,910,3.0,642.0,642.0,5,1073,4.0,805.0,805.0
0.081,6,10,1506,5,395,17.0,127.0,127.0,5,1111,19.0,843.0,843.0
0.081,6,10,1506,5,395,17.0,127.0,127.0,5,1111,17.0,843.0,843.0
0.006,6,10,1547,5,764,1.0,496.0,496.0,5,783,1.0,515.0,515.0
0.09,6,10,1506,5,395,19.0,127.0,127.0,5,1111,19.0,843.0,843.0
0.091,6,10,1506,5,395,20.0,127.0,127.0,5,1111,17.0,843.0,843.0
0.01,6,10,1983,5,910,2.0,642.0,642.0,5,1073,2.0,805.0,805.0
44.911,6,226,196066,125,185167,152.0,3697.0,1783.0,101,10899,447.0,2667.0,236.0
0.107,6,10,1506,5,395,23.0,127.0,127.0,5,1111,24.0,843.0,843.0
0.07,17,8,3613,4,1874,23.0,1350.0,440.0,4,1739,12.0,1350.0,406.0
0.004,17,2,148,1,60,0.0,32.0,32.0,1,88,0.0,60.0,60.0
2.737,6,26,6127,14,2100,210.0,517.0,303.0,12,4027,234.0,1330.0,589.0
0.075,6,10,1506,5,395,17.0,127.0,127.0,5,1111,15.0,843.0,843.0
0.068,6,10,1506,5,395,16.0,127.0,127.0,5,1111,16.0,843.0,843.0
0.039,17,2,136,1,60,0.0,32.0,32.0,1,76,0.0,48.0,48.0
0.006,6,10,1643,5,860,1.0,592.0,592.0,5,783,1.0,515.0,515.0
15.351,17,40,20352,22,17082,729.0,1350.0,748.0,18,3270,901.0,1350.0,153.0
0.076,6,10,1506,5,395,16.0,127.0,127.0,5,1111,18.0,843.0,843.0
0.01,6,10,1677,5,827,2.0,559.0,559.0,5,850,2.0,582.0,582.0
0.603,6,27,8978,15,1639,35.0,517.0,211.0,12,7339,44.0,1402.0,839.0
0.001,17,2,180,1,66,0.0,38.0,38.0,1,114,0.0,86.0,86.0
0.005,6,10,1689,5,839,1.0,571.0,571.0,5,850,1.0,582.0,582.0
0.006,6,10,2006,5,927,1.0,659.0,659.0,5,1079,1.0,811.0,811.0
0.007,6,10,1983,5,910,1.0,642.0,642.0,5,1073,1.0,805.0,805.0
0.009,6,10,1762,5,911,2.0,643.0,643.0,5,851,2.0,583.0,583.0
0.005,6,10,2000,5,927,1.0,659.0,659.0,5,1073,1.0,805.0,805.0
0.005,17,2,225,1,65,0.0,37.0,37.0,1,160,0.0,132.0,132.0
0.014,6,10,1989,5,910,3.0,642.0,642.0,5,1079,3.0,811.0,811.0
0.005,6,10,2007,5,928,1.0,660.0,660.0,5,1079,1.0,811.0,811.0
0.006,6,10,1547,5,764,1.0,496.0,496.0,5,783,1.0,515.0,515.0
0.005,6,10,1989,5,927,1.0,659.0,659.0,5,1062,1.0,794.0,794.0
0.001,17,2,180,1,66,0.0,38.0,38.0,1,114,0.0,86.0,86.0
0.005,6,10,2006,5,927,1.0,659.0,659.0,5,1079,1.0,811.0,811.0
0.187,6,10,1506,5,395,40.0,127.0,127.0,5,1111,44.0,843.0,843.0
0.005,6,10,1989,5,927,1.0,659.0,659.0,5,1062,1.0,794.0,794.0
0.118,17,2,80,1,32,0.0,4.0,4.0,1,48,0.0,20.0,20.0
0.075,6,10,1506,5,395,16.0,127.0,127.0,5,1111,17.0,843.0,843.0
0.172,6,10,1506,5,395,42.0,127.0,127.0,5,1111,41.0,843.0,843.0
0.005,6,10,2007,5,928,1.0,660.0,660.0,5,1079,1.0,811.0,811.0
0.129,17,4,336,2,124,0.0,34.0,34.0,2,212,6.0,84.0,78.0
0.009,6,10,1983,5,910,2.0,642.0,642.0,5,1073,2.0,805.0,805.0
0.001,17,2,180,1,66,0.0,38.0,38.0,1,114,0.0,86.0,86.0
0.081,6,10,1506,5,395,17.0,127.0,127.0,5,1111,16.0,843.0,843.0
0.014,6,10,1762,5,911,3.0,643.0,643.0,5,851,3.0,583.0,583.0
0.005,6,10,2007,5,928,1.0,660.0,660.0,5,1079,1.0,811.0,811.0
0.079,6,10,1506,5,395,17.0,127.0,127.0,5,1111,17.0,843.0,843.0
0.021,17,2,222,1,65,0.0,37.0,37.0,1,157,0.0,129.0,129.0
0.005,17,2,209,1,64,0.0,36.0,36.0,1,145,0.0,117.0,117.0
0.017,6,10,1983,5,910,4.0,642.0,642.0,5,1073,4.0,805.0,805.0
0.006,6,10,1643,5,860,1.0,592.0,592.0,5,783,1.0,515.0,515.0
40.085,17,10,676,5,460,10019.0,104.0,64.0,5,216,10020.0,20.0,15.0
0.005,6,10,1643,5,860,1.0,592.0,592.0,5,783,1.0,515.0,515.0
0.014,6,10,1677,5,827,3.0,559.0,559.0,5,850,3.0,582.0,582.0
15.07,17,14,9190,8,6902,2148.0,1350.0,834.0,6,2288,3008.0,1350.0,353.0
0.057,17,2,136,1,60,0.0,32.0,32.0,1,76,0.0,48.0,48.0
1769.354,17,92,8096,46,4048,39318.0,60.0,60.0,46,4048,39318.0,60.0,60.0
0.012,6,10,1989,5,910,2.0,642.0,642.0,5,1079,3.0,811.0,811.0
0.006,6,10,1689,5,839,1.0,571.0,571.0,5,850,1.0,582.0,582.0
0.006,6,10,2006,5,927,1.0,659.0,659.0,5,1079,1.0,811.0,811.0
0.001,17,2,180,1,66,0.0,38.0,38.0,1,114,0.0,86.0,86.0
0.006,6,10,1689,5,839,1.0,571.0,571.0,5,850,1.0,582.0,582.0
0.005,6,10,1774,5,923,1.0,655.0,655.0,5,851,1.0,583.0,583.0
0.005,17,2,166,1,75,0.0,47.0,47.0,1,91,0.0,63.0,63.0
0.004,6,10,2007,5,928,1.0,660.0,660.0,5,1079,1.0,811.0,811.0
0.01,6,6,716,3,458,3.0,302.0,302.0,3,258,3.0,102.0,102.0
0.096,6,10,1506,5,395,21.0,127.0,127.0,5,1111,19.0,843.0,843.0
0.009,6,12,1926,6,1189,1.0,659.0,434.0,6,737,1.0,417.0,417.0
293.69,6,392,348192,191,21487,1545.0,2736.0,888.0,201,326705,1468.0,2804.0,1691.0
0.09,6,10,1506,5,395,20.0,127.0,127.0,5,1111,21.0,843.0,843.0
0.216,6,10,1506,5,395,44.0,127.0,127.0,5,1111,50.0,843.0,843.0
0.003,17,2,148,1,60,0.0,32.0,32.0,1,88,0.0,60.0,60.0
40.057,17,10,676,5,460,10013.0,104.0,64.0,5,216,10013.0,20.0,15.0
0.111,6,10,1506,5,395,24.0,127.0,127.0,5,1111,26.0,843.0,843.0
0.006,6,12,1698,6,863,1.0,327.0,271.0,6,835,1.0,515.0,515.0
0.003,17,2,144,1,64,0.0,36.0,36.0,1,80,0.0,52.0,52.0
0.013,6,10,1989,5,910,3.0,642.0,642.0,5,1079,3.0,811.0,811.0
0.004,6,10,1774,5,923,1.0,655.0,655.0,5,851,1.0,583.0,583.0
0.005,6,10,1989,5,927,1.0,659.0,659.0,5,1062,1.0,794.0,794.0
0.005,6,10,1689,5,839,1.0,571.0,571.0,5,850,1.0,582.0,582.0
0.004,6,10,1989,5,927,1.0,659.0,659.0,5,1062,1.0,794.0,794.0
0.014,6,10,1989,5,910,3.0,642.0,642.0,5,1079,3.0,811.0,811.0
0.005,17,2,214,1,73,0.0,45.0,45.0,1,141,0.0,113.0,113.0
0.006,6,10,1854,5,889,1.0,621.0,621.0,5,965,1.0,697.0,697.0
0.006,6,10,1547,5,764,1.0,496.0,496.0,5,783,1.0,515.0,515.0
300.409,6,16,2170,9,684,37530.0,146.0,146.0,7,1486,50040.0,419.0,398.0
0.004,6,10,1774,5,923,1.0,655.0,655.0,5,851,1.0,583.0,583.0
0.075,6,10,1506,5,395,17.0,127.0,127.0,5,1111,16.0,843.0,843.0
0.005,17,2,164,1,74,0.0,46.0,46.0,1,90,0.0,62.0,62.0
0.001,17,2,180,1,66,0.0,38.0,38.0,1,114,0.0,86.0,86.0
0.016,6,10,1989,5,910,4.0,642.0,642.0,5,1079,4.0,811.0,811.0
300.394,6,16,2170,9,684,37528.0,146.0,146.0,7,1486,50037.0,419.0,398.0
0.005,6,10,2006,5,927,1.0,659.0,659.0,5,1079,1.0,811.0,811.0
240.08,6,16,4481,9,963,30010.0,238.0,166.0,7,3518,40012.0,1402.0,786.0
0.003,17,2,170,1,65,0.0,37.0,37.0,1,105,0.0,77.0,77.0
0.005,17,2,179,1,71,0.0,43.0,43.0,1,108,0.0,80.0,80.0
0.015,6,10,1677,5,827,3.0,559.0,559.0,5,850,3.0,582.0,582.0
0.004,6,10,2006,5,927,1.0,659.0,659.0,5,1079,1.0,811.0,811.0
0.006,6,10,1547,5,764,1.0,496.0,496.0,5,783,1.0,515.0,515.0
0.005,6,10,1689,6,891,1.0,571.0,571.0,4,798,1.0,582.0,582.0
0.035,6,10,1989,5,910,8.0,642.0,642.0,5,1079,8.0,811.0,811.0
0.009,6,10,1989,5,910,2.0,642.0,642.0,5,1079,2.0,811.0,811.0
0.064,6,10,1506,5,395,14.0,127.0,127.0,5,1111,14.0,843.0,843.0
0.004,6,14,3742,7,452,0.0,80.0,80.0,7,3290,0.0,1448.0,972.0
0.042,17,2,144,1,64,0.0,36.0,36.0,1,80,0.0,52.0,52.0
0.012,6,10,1983,5,910,2.0,642.0,642.0,5,1073,3.0,805.0,805.0
0.005,6,10,1989,5,927,1.0,659.0,659.0,5,1062,1.0,794.0,794.0
40.069,17,10,676,5,460,10016.0,104.0,64.0,5,216,10016.0,20.0,15.0
0.383,6,16,2777,8,1395,54.0,533.0,323.0,8,1382,37.0,529.0,239.0
0.014,6,10,1989,5,910,3.0,642.0,642.0,5,1079,3.0,811.0,811.0
0.005,6,10,1779,5,928,1.0,660.0,660.0,5,851,1.0,583.0,583.0
0.09,6,10,1506,5,395,21.0,127.0,127.0,5,1111,21.0,843.0,843.0
0.004,6,10,2006,5,927,1.0,659.0,659.0,5,1079,1.0,811.0,811.0
0.035,17,2,214,1,75,0.0,47.0,47.0,1,139,0.0,111.0,111.0
5.236,58,2,144,1,72,0.0,24.0,24.0,1,72,0.0,24.0,24.0
0.042,17,2,148,1,60,0.0,32.0,32.0,1,88,0.0,60.0,60.0
0.005,17,2,164,1,74,0.0,46.0,46.0,1,90,0.0,62.0,62.0
0.005,6,10,2006,5,927,1.0,659.0,659.0,5,1079,1.0,811.0,811.0
0.061,17,2,80,1,32,0.0,4.0,4.0,1,48,0.0,20.0,20.0
0.117,6,28,10233,15,8942,8.0,2883.0,1166.0,13,1291,9.0,207.0,102.0
0.088,6,10,1506,5,395,20.0,127.0,127.0,5,1111,17.0,843.0,843.0
300.334,6,16,2170,9,684,37521.0,146.0,146.0,7,1486,50028.0,419.0,398.0
0.04,17,2,182,1,65,0.0,37.0,37.0,1,117,0.0,89.0,89.0
0.082,6,10,1506,5,395,17.0,127.0,127.0,5,1111,16.0,843.0,843.0
0.014,6,10,1990,5,911,3.0,643.0,643.0,5,1079,3.0,811.0,811.0
0.096,6,10,1506,5,395,21.0,127.0,127.0,5,1111,21.0,843.0,843.0
0.02,6,10,1989,5,910,5.0,642.0,642.0,5,1079,5.0,811.0,811.0
0.001,17,2,166,1,75,0.0,47.0,47.0,1,91,0.0,63.0,63.0
300.204,6,29,7552,16,1421,20013.0,217.0,142.0,13,6131,20018.0,1402.0,680.0
0.105,6,10,1506,5,395,23.0,127.0,127.0,5,1111,23.0,843.0,843.0
0.006,6,10,2007,5,928,1.0,660.0,660.0,5,1079,1.0,811.0,811.0
0.037,17,4,352,2,130,0.0,37.0,37.0,2,222,34.0,89.0,83.0
294.421,6,370,346457,130,18305,2282.0,2688.0,824.0,240,328152,1231.0,2804.0,1402.0
0.037,17,2,148,1,60,0.0,32.0,32.0,1,88,0.0,60.0,60.0
0.046,6,20,9974,11,704,4.0,124.0,124.0,9,9270,5.0,2896.0,1758.0
0.039,17,2,412,1,61,0.0,33.0,33.0,1,351,0.0,323.0,323.0
0.007,6,10,1547,5,764,1.0,496.0,496.0,5,783,1.0,515.0,515.0
0.007,17,2,299,1,65,0.0,37.0,37.0,1,234,0.0,206.0,206.0
0.006,17,4,284,2,120,3.0,32.0,32.0,2,164,3.0,60.0,54.0
0.05,17,4,284,2,120,0.0,32.0,32.0,2,164,40.0,60.0,54.0
0.003,17,2,148,1,60,0.0,32.0,32.0,1,88,0.0,60.0,60.0
1787.391,6,154,19574,92,13852,19641.0,302.0,302.0,62,5722,29301.0,83.0,83.0
0.096,6,10,1506,5,395,22.0,127.0,127.0,5,1111,19.0,843.0,843.0
0.004,17,2,136,1,60,0.0,32.0,32.0,1,76,0.0,48.0,48.0
0.005,6,10,2007,5,928,1.0,660.0,660.0,5,1079,1.0,811.0,811.0
0.009,6,10,1983,5,910,2.0,642.0,642.0,5,1073,2.0,805.0,805.0
0.081,6,10,1506,5,395,17.0,127.0,127.0,5,1111,18.0,843.0,843.0
0.958,6,29,7768,17,2784,59.0,1477.0,515.0,12,4984,71.0,2745.0,561.0
0.001,17,2,180,1,66,0.0,38.0,38.0,1,114,0.0,86.0,86.0
0.075,6,10,1506,5,395,14.0,127.0,127.0,5,1111,17.0,843.0,843.0
0.01,6,10,1972,5,910,2.0,642.0,642.0,5,1062,2.0,794.0,794.0
40.055,17,10,676,5,460,10012.0,104.0,64.0,5,216,10013.0,20.0,15.0
300.334,6,16,2170,9,684,37520.0,146.0,146.0,7,1486,50027.0,419.0,398.0
9.039,17,6,376,5,280,2259.0,28.0,28.0,1,96,0.0,68.0,68.0
11.134,17,28,4418,14,1994,844.0,269.0,114.0,14,2424,844.0,587.0,145.0
0.089,6,10,1506,5,395,19.0,127.0,127.0,5,1111,19.0,843.0,843.0
0.004,6,10,2006,5,927,1.0,659.0,659.0,5,1079,1.0,811.0,811.0
0.08,6,10,1506,5,395,19.0,127.0,127.0,5,1111,15.0,843.0,843.0
0.104,6,10,1506,5,395,19.0,127.0,127.0,5,1111,24.0,843.0,843.0
0.003,17,2,136,1,60,0.0,32.0,32.0,1,76,0.0,48.0,48.0
368.611,6,22,2313,16,867,24574.0,195.0,195.0,6,1446,4635.0,419.0,398.0
0.005,17,2,170,1,65,0.0,37.0,37.0,1,105,0.0,77.0,77.0
0.006,6,10,1547,5,764,1.0,496.0,496.0,5,783,1.0,515.0,515.0
40.059,17,10,676,5,460,10013.0,104.0,64.0,5,216,10014.0,20.0,15.0
40.074,17,10,676,5,460,10016.0,104.0,64.0,5,216,10014.0,20.0,15.0
0.01,6,13,3735,7,497,1.0,125.0,125.0,6,3238,2.0,1470.0,1459.0
0.009,6,14,3787,7,497,1.0,125.0,125.0,7,3290,1.0,1448.0,972.0
0.006,17,2,169,1,62,0.0,34.0,34.0,1,107,0.0,79.0,79.0
0.005,17,2,154,1,69,0.0,41.0,41.0,1,85,0.0,57.0,57.0
0.004,6,10,1774,5,923,1.0,655.0,655.0,5,851,1.0,583.0,583.0
0.005,6,10,1989,5,927,1.0,659.0,659.0,5,1062,1.0,794.0,794.0
0.127,6,10,1506,5,395,26.0,127.0,127.0,5,1111,28.0,843.0,843.0
0.006,17,2,140,1,62,0.0,34.0,34.0,1,78,0.0,50.0,50.0
796.462,6,68,13938,38,10876,13596.0,494.0,494.0,30,3062,27464.0,83.0,83.0
0.012,6,10,1972,5,910,3.0,642.0,642.0,5,1062,2.0,794.0,794.0
0.005,6,10,2006,5,927,1.0,659.0,659.0,5,1079,1.0,811.0,811.0
11.537,17,28,4398,14,2312,875.0,587.0,137.0,14,2086,875.0,269.0,121.0
0.004,6,10,2006,5,927,1.0,659.0,659.0,5,1079,1.0,811.0,811.0
0.085,6,10,1506,5,395,19.0,127.0,127.0,5,1111,19.0,843.0,843.0
0.001,17,2,180,1,66,0.0,38.0,38.0,1,114,0.0,86.0,86.0
354.003,6,21,1795,16,1030,23600.0,190.0,190.0,5,765,60002.0,464.0,248.0
0.004,17,4,284,2,120,0.0,32.0,32.0,2,164,0.0,60.0,54.0
351.986,6,20,2210,6,1308,12002.0,494.0,494.0,14,902,27075.0,83.0,83.0
0.081,6,10,1506,5,395,18.0,127.0,127.0,5,1111,17.0,843.0,843.0
0.074,17,4,596,2,122,3.0,33.0,33.0,2,474,35.0,323.0,209.0
40.054,17,10,676,5,460,10012.0,104.0,64.0,5,216,10011.0,20.0,15.0
0.188,17,4,352,2,130,147.0,37.0,37.0,2,222,151.0,89.0,83.0
1799.851,6,136,6550,76,3625,23998.0,39.0,39.0,60,2925,29993.0,35.0,35.0
0.005,6,10,2006,5,927,1.0,659.0,659.0,5,1079,1.0,811.0,811.0
0.005,6,10,1989,5,927,1.0,659.0,659.0,5,1062,1.0,794.0,794.0
170.13,17,88,12672,44,2961,3956.0,44.0,39.0,44,9711,3956.0,239.0,192.0
0.006,17,2,166,1,75,0.0,47.0,47.0,1,91,0.0,63.0,63.0
368.622,6,22,2313,16,867,24574.0,195.0,195.0,6,1446,4638.0,419.0,398.0
174.107,17,90,12943,45,3033,3956.0,44.0,39.0,45,9910,3956.0,239.0,192.0
0.005,17,2,152,1,68,0.0,40.0,40.0,1,84,0.0,56.0,56.0
0.005,17,2,170,1,65,0.0,37.0,37.0,1,105,0.0,77.0,77.0
0.08,6,10,1506,5,395,16.0,127.0,127.0,5,1111,19.0,843.0,843.0
177.029,17,82,11717,41,2730,4425.0,44.0,38.0,41,8987,4425.0,239.0,191.0
300.285,6,27,7433,16,1409,20019.0,217.0,142.0,11,6024,24024.0,1679.0,777.0
33.58,6,49,21610,25,15623,383.0,2720.0,1459.0,24,5987,1452.0,2667.0,385.0
0.111,6,10,1506,5,395,24.0,127.0,127.0,5,1111,22.0,843.0,843.0
26.051,6,36,8469,18,1997,508.0,889.0,415.0,18,6472,1524.0,2126.0,478.0
0.005,6,10,2007,5,928,1.0,660.0,660.0,5,1079,1.0,811.0,811.0
240.118,6,23,9079,12,4170,21828.0,1368.0,710.0,11,4909,24011.0,1657.0,1082.0
0.015,6,10,1972,5,910,3.0,642.0,642.0,5,1062,3.0,794.0,794.0
0.013,6,10,1983,5,910,3.0,642.0,642.0,5,1073,3.0,805.0,805.0
0.069,6,10,1506,5,395,15.0,127.0,127.0,5,1111,14.0,843.0,843.0
0.009,17,2,214,1,75,0.0,47.0,47.0,1,139,0.0,111.0,111.0
0.008,6,10,1854,5,889,2.0,621.0,621.0,5,965,2.0,697.0,697.0
0.006,6,10,1643,5,860,1.0,592.0,592.0,5,783,1.0,515.0,515.0
156.8,58,5,360,4,288,52266.0,24.0,24.0,1,72,0.0,24.0,24.0
0.072,17,2,234,1,61,0.0,33.0,33.0,1,173,0.0,145.0,145.0
0.004,6,10,2006,5,927,1.0,659.0,659.0,5,1079,1.0,811.0,811.0
0.105,6,10,1506,5,395,20.0,127.0,127.0,5,1111,23.0,843.0,843.0
0.008,6,10,1689,5,839,2.0,571.0,571.0,5,850,1.0,582.0,582.0
0.003,17,2,136,1,60,0.0,32.0,32.0,1,76,0.0,48.0,48.0
0.005,6,10,2006,5,927,1.0,659.0,659.0,5,1079,1.0,811.0,811.0
0.065,6,10,1506,5,395,15.0,127.0,127.0,5,1111,13.0,843.0,843.0
300.441,6,16,2170,9,684,37533.0,146.0,146.0,7,1486,50046.0,419.0,398.0
0.041,17,2,184,1,61,0.0,33.0,33.0,1,123,0.0,95.0,95.0
0.188,6,10,1506,5,395,22.0,127.0,127.0,5,1111,43.0,843.0,843.0
0.004,6,10,2006,5,927,1.0,659.0,659.0,5,1079,1.0,811.0,811.0
0.085,6,10,1506,5,395,18.0,127.0,127.0,5,1111,19.0,843.0,843.0
0.005,6,10,2007,5,928,1.0,660.0,660.0,5,1079,1.0,811.0,811.0
0.055,6,10,1506,5,395,13.0,127.0,127.0,5,1111,13.0,843.0,843.0
0.01,6,10,1989,5,910,2.0,642.0,642.0,5,1079,2.0,811.0,811.0
0.071,17,8,3613,4,1874,23.0,1350.0,440.0,4,1739,12.0,1350.0,406.0
0.017,6,10,1631,5,848,4.0,580.0,580.0,5,783,4.0,515.0,515.0
0.005,6,10,2007,5,928,1.0,660.0,660.0,5,1079,1.0,811.0,811.0
0.089,6,10,1506,5,395,21.0,127.0,127.0,5,1111,21.0,843.0,843.0
0.015,6,10,1989,5,910,3.0,642.0,642.0,5,1079,3.0,811.0,811.0
0.006,6,10,1854,5,889,1.0,621.0,621.0,5,965,1.0,697.0,697.0
0.005,6,10,1779,5,928,1.0,660.0,660.0,5,851,1.0,583.0,583.0
0.008,17,2,214,1,75,0.0,47.0,47.0,1,139,0.0,111.0,111.0
0.009,6,12,1926,6,1189,1.0,659.0,434.0,6,737,1.0,417.0,417.0
0.016,6,10,1990,5,911,4.0,643.0,643.0,5,1079,4.0,811.0,811.0
0.078,6,10,1506,5,395,16.0,127.0,127.0,5,1111,16.0,843.0,843.0
0.037,6,13,3735,7,497,6.0,125.0,125.0,6,3238,7.0,1470.0,1459.0
40.063,17,10,676,5,460,10012.0,104.0,64.0,5,216,10011.0,20.0,15.0
0.005,6,10,1989,5,927,1.0,659.0,659.0,5,1062,1.0,794.0,794.0
0.109,6,10,1506,5,395,24.0,127.0,127.0,5,1111,25.0,843.0,843.0
0.006,6,10,1547,5,764,1.0,496.0,496.0,5,783,1.0,515.0,515.0
0.105,17,2,80,1,32,0.0,4.0,4.0,1,48,0.0,20.0,20.0
0.005,17,2,214,1,75,0.0,47.0,47.0,1,139,0.0,111.0,111.0
0.096,6,10,1506,5,395,16.0,127.0,127.0,5,1111,20.0,843.0,843.0
0.149,6,10,1506,5,395,36.0,127.0,127.0,5,1111,34.0,843.0,843.0
0.012,6,10,1990,5,911,3.0,643.0,643.0,5,1079,2.0,811.0,811.0
0.011,6,10,1989,5,910,2.0,642.0,642.0,5,1079,2.0,811.0,811.0
0.133,6,10,1506,5,395,29.0,127.0,127.0,5,1111,29.0,843.0,843.0
360.027,6,21,3981,13,3142,30002.0,494.0,494.0,8,839,51432.0,83.0,83.0
0.112,6,10,1506,5,395,25.0,127.0,127.0,5,1111,24.0,843.0,843.0
0.006,6,10,1547,5,764,1.0,496.0,496.0,5,783,1.0,515.0,515.0
0.006,6,10,1689,5,839,1.0,571.0,571.0,5,850,1.0,582.0,582.0
0.005,6,10,1989,5,927,1.0,659.0,659.0,5,1062,1.0,794.0,794.0
0.079,6,10,1506,5,395,18.0,127.0,127.0,5,1111,15.0,843.0,843.0
0.005,6,10,1643,5,860,1.0,592.0,592.0,5,783,1.0,515.0,515.0
15.07,17,15,9238,8,6902,2149.0,1350.0,834.0,7,2336,2506.0,1350.0,305.0
0.011,6,13,3735,7,497,1.0,125.0,125.0,6,3238,2.0,1470.0,1459.0
0.005,6,14,3742,8,504,0.0,80.0,80.0,6,3238,1.0,1470.0,1459.0
0.081,6,10,1506,5,395,18.0,127.0,127.0,5,1111,18.0,843.0,843.0
0.015,6,10,1972,5,910,3.0,642.0,642.0,5,1062,3.0,794.0,794.0
0.025,6,10,1762,5,911,6.0,643.0,643.0,5,851,6.0,583.0,583.0
0.005,6,13,3747,7,509,0.0,137.0,137.0,6,3238,0.0,1470.0,1459.0
0.011,6,13,3735,7,497,1.0,125.0,125.0,6,3238,2.0,1470.0,1459.0
0.005,6,10,2006,5,927,1.0,659.0,659.0,5,1079,1.0,811.0,811.0
0.006,17,2,140,1,62,0.0,34.0,34.0,1,78,0.0,50.0,50.0
0.07,6,10,1506,5,395,17.0,127.0,127.0,5,1111,16.0,843.0,843.0
0.118,6,10,1506,5,395,25.0,127.0,127.0,5,1111,22.0,843.0,843.0
0.005,6,10,1547,5,764,1.0,496.0,496.0,5,783,1.0,515.0,515.0
0.014,6,10,1677,5,827,3.0,559.0,559.0,5,850,3.0,582.0,582.0
0.003,17,2,148,1,60,0.0,32.0,32.0,1,88,0.0,60.0,60.0
309.473,17,20,1124,10,716,34371.0,48.0,43.0,10,408,34370.0,20.0,12.0
0.015,6,13,3735,7,497,2.0,125.0,125.0,6,3238,3.0,1470.0,1459.0
0.009,6,10,1989,5,910,2.0,642.0,642.0,5,1079,2.0,811.0,811.0
0.127,17,2,182,1,65,0.0,37.0,37.0,1,117,0.0,89.0,89.0
0.003,17,2,136,1,60,0.0,32.0,32.0,1,76,0.0,48.0,48.0
0.004,17,2,148,1,60,0.0,32.0,32.0,1,88,0.0,60.0,60.0
0.093,6,10,1506,5,395,21.0,127.0,127.0,5,1111,18.0,843.0,843.0
0.013,6,10,1989,5,910,3.0,642.0,642.0,5,1079,3.0,811.0,811.0
0.078,6,10,1506,5,395,17.0,127.0,127.0,5,1111,17.0,843.0,843.0
0.099,6,10,1506,5,395,22.0,127.0,127.0,5,1111,20.0,843.0,843.0
0.072,17,4,596,2,122,0.0,33.0,33.0,2,474,68.0,323.0,209.0
0.004,17,2,234,1,61,0.0,33.0,33.0,1,173,0.0,145.0,145.0
0.001,17,2,180,1,66,0.0,38.0,38.0,1,114,0.0,86.0,86.0
0.01,6,14,3787,7,497,1.0,125.0,125.0,7,3290,1.0,1448.0,972.0
15.074,17,14,9190,8,6902,2149.0,1350.0,834.0,6,2288,3008.0,1350.0,353.0
0.124,17,2,80,1,32,0.0,4.0,4.0,1,48,0.0,20.0,20.0
0.103,6,10,1506,5,395,23.0,127.0,127.0,5,1111,23.0,843.0,843.0
0.017,6,10,1989,5,910,4.0,642.0,642.0,5,1079,4.0,811.0,811.0
0.004,6,10,2006,5,927,1.0,659.0,659.0,5,1079,1.0,811.0,811.0
0.014,6,10,1677,5,827,3.0,559.0,559.0,5,850,3.0,582.0,582.0
0.005,6,10,1989,5,927,1.0,659.0,659.0,5,1062,1.0,794.0,794.0
0.005,17,2,170,1,65,0.0,37.0,37.0,1,105,0.0,77.0,77.0
240.09,6,16,4480,9,963,30011.0,238.0,166.0,7,3517,40014.0,1402.0,786.0
0.11,6,10,1506,5,395,25.0,127.0,127.0,5,1111,23.0,843.0,843.0
0.01,6,10,1762,5,911,2.0,643.0,643.0,5,851,2.0,583.0,583.0
0.005,6,10,2000,5,927,1.0,659.0,659.0,5,1073,1.0,805.0,805.0
65.823,6,27,17549,15,9603,4701.0,2804.0,1469.0,12,7946,5969.0,2317.0,1219.0
40.065,17,10,676,5,460,10015.0,104.0,64.0,5,216,10015.0,20.0,15.0
0.105,6,10,1506,5,395,23.0,127.0,127.0,5,1111,21.0,843.0,843.0
0.0,17,2,179,1,62,0.0,34.0,34.0,1,117,0.0,89.0,89.0
0.016,6,10,1990,5,911,3.0,643.0,643.0,5,1079,3.0,811.0,811.0
0.055,17,2,148,1,60,0.0,32.0,32.0,1,88,0.0,60.0,60.0
169.086,17,84,12040,42,2789,4123.0,44.0,38.0,42,9251,4124.0,239.0,192.0
0.212,6,10,1506,5,395,50.0,127.0,127.0,5,1111,48.0,843.0,843.0
0.219,17,4,352,2,130,147.0,37.0,37.0,2,222,179.0,89.0,83.0
0.079,6,10,1506,5,395,17.0,127.0,127.0,5,1111,19.0,843.0,843.0
0.005,6,10,2000,5,927,1.0,659.0,659.0,5,1073,1.0,805.0,805.0
0.005,6,10,1689,5,839,1.0,571.0,571.0,5,850,1.0,582.0,582.0
40.063,17,10,676,5,460,10013.0,104.0,64.0,5,216,10014.0,20.0,15.0
0.004,17,2,136,1,60,0.0,32.0,32.0,1,76,0.0,48.0,48.0
310.817,17,20,1124,10,716,34521.0,48.0,43.0,10,408,34521.0,20.0,12.0
1741.841,6,303,97649,188,86514,9314.0,2001.0,673.0,115,11135,15279.0,452.0,70.0
0.129,17,2,166,1,75,0.0,47.0,47.0,1,91,0.0,63.0,63.0
178.197,17,86,12385,43,2897,4242.0,44.0,39.0,43,9488,4242.0,249.0,192.0
593.672,6,32,5142,14,3700,23094.0,494.0,494.0,18,1442,34921.0,83.0,83.0
0.06,6,10,1506,5,395,13.0,127.0,127.0,5,1111,14.0,843.0,843.0
0.003,17,2,148,1,60,0.0,32.0,32.0,1,88,0.0,60.0,60.0
1770.385,6,87,4626,44,2340,41170.0,26.0,26.0,43,2286,42151.0,26.0,25.0
0.235,6,26,6596,14,2453,17.0,746.0,341.0,12,4143,20.0,1324.0,585.0
171.064,17,64,9176,32,2123,5518.0,44.0,38.0,32,7053,5518.0,239.0,192.0
0.001,17,2,180,1,66,0.0,38.0,38.0,1,114,0.0,86.0,86.0
0.128,6,10,1506,5,395,24.0,127.0,127.0,5,1111,27.0,843.0,843.0
0.006,6,10,1547,5,764,1.0,496.0,496.0,5,783,1.0,515.0,515.0
40.075,17,10,676,5,460,10016.0,104.0,64.0,5,216,10018.0,20.0,15.0
0.014,6,10,1990,5,911,3.0,643.0,643.0,5,1079,3.0,811.0,811.0
0.005,6,10,1643,5,860,1.0,592.0,592.0,5,783,1.0,515.0,515.0
309.064,17,20,1124,10,716,34333.0,48.0,43.0,10,408,34333.0,20.0,12.0
0.005,6,14,3736,7,446,0.0,74.0,74.0,7,3290,0.0,1448.0,972.0
0.121,6,10,1506,5,395,27.0,127.0,127.0,5,1111,25.0,843.0,843.0
0.005,6,10,2006,5,927,1.0,659.0,659.0,5,1079,1.0,811.0,811.0
0.007,17,2,179,1,71,0.0,43.0,43.0,1,108,0.0,80.0,80.0
0.01,6,12,1926,6,1189,2.0,659.0,434.0,6,737,2.0,417.0,417.0
0.081,6,10,1506,5,395,18.0,127.0,127.0,5,1111,16.0,843.0,843.0
0.142,6,10,1506,5,395,31.0,127.0,127.0,5,1111,26.0,843.0,843.0
0.005,6,10,1989,5,927,1.0,659.0,659.0,5,1062,1.0,794.0,794.0
0.011,6,10,1990,5,911,2.0,643.0,643.0,5,1079,2.0,811.0,811.0
0.014,6,10,1972,5,910,3.0,642.0,642.0,5,1062,3.0,794.0,794.0
0.05,17,2,152,1,76,0.0,48.0,48.0,1,76,0.0,48.0,48.0
0.012,6,10,1989,5,910,2.0,642.0,642.0,5,1079,2.0,811.0,811.0
0.004,17,2,184,1,61,0.0,33.0,33.0,1,123,0.0,95.0,95.0
308.488,17,20,1124,10,716,34262.0,48.0,43.0,10,408,34262.0,20.0,12.0
0.004,6,10,2007,5,928,1.0,660.0,660.0,5,1079,1.0,811.0,811.0
0.019,6,10,1972,5,910,4.0,642.0,642.0,5,1062,4.0,794.0,794.0
0.017,6,10,1990,5,911,4.0,643.0,643.0,5,1079,4.0,811.0,811.0
0.009,6,10,1983,5,910,2.0,642.0,642.0,5,1073,2.0,805.0,805.0
0.01,17,2,148,1,60,0.0,32.0,32.0,1,88,0.0,60.0,60.0
240.144,6,44,6742,21,3172,12007.0,588.0,230.0,23,3570,10915.0,580.0,236.0
0.117,6,10,1506,5,395,24.0,127.0,127.0,5,1111,25.0,843.0,843.0
0.04,17,2,234,1,61,0.0,33.0,33.0,1,173,0.0,145.0,145.0
240.087,6,16,4482,9,963,30010.0,238.0,166.0,7,3519,40014.0,1402.0,786.0
0.085,6,10,1506,5,395,20.0,127.0,127.0,5,1111,17.0,843.0,843.0
0.02,6,10,1989,5,910,5.0,642.0,642.0,5,1079,5.0,811.0,811.0
0.006,6,10,1547,5,764,1.0,496.0,496.0,5,783,1.0,515.0,515.0
0.01,6,10,1989,5,910,2.0,642.0,642.0,5,1079,2.0,811.0,811.0
378.705,6,22,2313,16,867,25247.0,195.0,195.0,6,1446,4637.0,419.0,398.0
0.108,6,10,1506,5,395,24.0,127.0,127.0,5,1111,26.0,843.0,843.0
0.005,6,10,1989,5,927,1.0,659.0,659.0,5,1062,1.0,794.0,794.0
11.069,17,28,4424,14,1995,840.0,270.0,114.0,14,2429,840.0,588.0,145.0
0.008,6,10,2000,5,927,1.0,659.0,659.0,5,1073,1.0,805.0,805.0
0.142,6,10,1506,5,395,32.0,127.0,127.0,5,1111,33.0,843.0,843.0
0.005,6,10,1989,5,927,1.0,659.0,659.0,5,1062,1.0,794.0,794.0
0.072,17,4,596,2,122,0.0,33.0,33.0,2,474,68.0,323.0,209.0
0.011,6,13,3735,7,497,1.0,125.0,125.0,6,3238,2.0,1470.0,1459.0
240.086,6,16,4480,9,963,30010.0,238.0,166.0,7,3517,40013.0,1402.0,786.0
0.005,17,2,154,1,69,0.0,41.0,41.0,1,85,0.0,57.0,57.0
0.11,6,10,1506,5,395,26.0,127.0,127.0,5,1111,23.0,843.0,843.0
40.061,17,10,676,5,460,10014.0,104.0,64.0,5,216,10014.0,20.0,15.0
0.006,6,10,1547,5,764,1.0,496.0,496.0,5,783,1.0,515.0,515.0
0.01,6,13,3690,7,452,1.0,80.0,80.0,6,3238,2.0,1470.0,1459.0
0.004,6,10,2006,5,927,1.0,659.0,659.0,5,1079,1.0,811.0,811.0
0.004,6,10,1702,5,863,1.0,595.0,595.0,5,839,1.0,571.0,571.0
0.015,6,10,1983,5,910,3.0,642.0,642.0,5,1073,3.0,805.0,805.0
0.105,6,10,1506,5,395,24.0,127.0,127.0,5,1111,25.0,843.0,843.0
0.04,17,2,136,1,60,0.0,32.0,32.0,1,76,0.0,48.0,48.0
0.014,6,10,1990,5,911,3.0,643.0,643.0,5,1079,3.0,811.0,811.0
0.218,6,16,2778,8,1396,31.0,533.0,324.0,8,1382,19.0,529.0,239.0
0.03,6,20,9974,11,704,2.0,124.0,124.0,9,9270,3.0,2896.0,1758.0
0.003,17,2,148,1,60,0.0,32.0,32.0,1,88,0.0,60.0,60.0
0.008,6,10,1990,5,911,2.0,643.0,643.0,5,1079,1.0,811.0,811.0
0.007,17,2,291,1,66,0.0,38.0,38.0,1,225,0.0,197.0,197.0
0.005,6,10,2006,5,927,1.0,659.0,659.0,5,1079,1.0,811.0,811.0
0.005,17,2,214,1,75,0.0,47.0,47.0,1,139,0.0,111.0,111.0
294.065,6,393,347480,199,21915,1485.0,2736.0,889.0,194,325565,1523.0,2769.0,1752.0
241.464,6,327,344709,122,17858,1995.0,2736.0,959.0,205,326851,1183.0,2804.0,1621.0
11.095,17,28,4394,14,2312,844.0,587.0,137.0,14,2082,844.0,269.0,120.0
40.065,17,10,676,5,460,10015.0,104.0,64.0,5,216,10015.0,20.0,15.0
0.004,17,2,170,1,65,0.0,37.0,37.0,1,105,0.0,77.0,77.0
0.004,6,10,1774,5,923,1.0,655.0,655.0,5,851,1.0,583.0,583.0
0.005,6,10,1989,5,927,1.0,659.0,659.0,5,1062,1.0,794.0,794.0
0.005,6,10,1989,5,927,1.0,659.0,659.0,5,1062,1.0,794.0,794.0
0.001,17,2,140,1,62,0.0,34.0,34.0,1,78,0.0,50.0,50.0
0.005,6,10,2006,5,927,1.0,659.0,659.0,5,1079,1.0,811.0,811.0
0.122,6,10,1506,5,395,29.0,127.0,127.0,5,1111,29.0,843.0,843.0
0.005,6,10,1989,5,927,1.0,659.0,659.0,5,1062,1.0,794.0,794.0
0.006,6,10,1689,5,839,1.0,571.0,571.0,5,850,1.0,582.0,582.0
40.076,17,10,676,5,460,10018.0,104.0,64.0,5,216,10018.0,20.0,15.0
0.012,6,10,1989,5,910,3.0,642.0,642.0,5,1079,3.0,811.0,811.0
0.009,6,13,3735,7,497,1.0,125.0,125.0,6,3238,1.0,1470.0,1459.0
40.073,17,10,676,5,460,10015.0,104.0,64.0,5,216,10017.0,20.0,15.0
0.144,6,10,1506,5,395,32.0,127.0,127.0,5,1111,35.0,843.0,843.0
0.017,6,20,9974,11,704,1.0,124.0,124.0,9,9270,2.0,2896.0,1758.0
40.075,17,10,676,5,460,10015.0,104.0,64.0,5,216,10017.0,20.0,15.0
0.037,17,2,144,1,64,0.0,36.0,36.0,1,80,0.0,52.0,52.0
0.04,17,2,170,1,65,0.0,37.0,37.0,1,105,0.0,77.0,77.0
0.118,6,10,1506,5,395,25.0,127.0,127.0,5,1111,27.0,843.0,843.0
0.01,6,10,1989,5,910,2.0,642.0,642.0,5,1079,2.0,811.0,811.0
0.005,6,10,1989,5,927,1.0,659.0,659.0,5,1062,1.0,794.0,794.0
9.037,17,6,376,5,280,2259.0,28.0,28.0,1,96,0.0,68.0,68.0
0.005,6,14,3799,7,509,0.0,137.0,137.0,7,3290,0.0,1448.0,972.0
0.02,6,10,1989,5,910,4.0,642.0,642.0,5,1079,4.0,811.0,811.0
0.157,6,10,1983,5,910,39.0,642.0,642.0,5,1073,39.0,805.0,805.0
0.005,6,10,1547,5,764,1.0,496.0,496.0,5,783,1.0,515.0,515.0
0.005,6,10,1779,5,928,1.0,660.0,660.0,5,851,1.0,583.0,583.0
0.082,6,10,1506,5,395,19.0,127.0,127.0,5,1111,17.0,843.0,843.0
0.04,17,2,182,1,65,0.0,37.0,37.0,1,117,0.0,89.0,89.0
280.213,6,23,6075,11,1226,28021.0,267.0,156.0,12,4849,25472.0,1400.0,873.0
0.021,6,10,1972,5,910,5.0,642.0,642.0,5,1062,5.0,794.0,794.0
0.083,6,10,1506,5,395,18.0,127.0,127.0,5,1111,18.0,843.0,843.0
0.127,17,2,136,1,60,0.0,32.0,32.0,1,76,0.0,48.0,48.0
0.076,17,2,148,1,60,0.0,32.0,32.0,1,88,0.0,60.0,60.0
114.856,6,22,8496,12,2236,76.0,1345.0,574.0,10,6260,12742.0,2720.0,974.0
0.073,17,2,80,1,32,0.0,4.0,4.0,1,48,0.0,20.0,20.0
0.09,6,10,1506,5,395,19.0,127.0,127.0,5,1111,21.0,843.0,843.0
0.005,6,10,2006,5,927,1.0,659.0,659.0,5,1079,1.0,811.0,811.0
162.375,17,86,12473,43,2897,3866.0,44.0,39.0,43,9576,3866.0,239.0,194.0
0.103,6,10,1506,5,395,21.0,127.0,127.0,5,1111,22.0,843.0,843.0
0.006,6,10,1774,5,923,1.0,655.0,655.0,5,851,1.0,583.0,583.0
0.119,6,10,1506,5,395,27.0,127.0,127.0,5,1111,25.0,843.0,843.0
0.007,6,10,1689,5,839,1.0,571.0,571.0,5,850,1.0,582.0,582.0
1740.59,6,298,97133,184,86162,9511.0,2001.0,690.0,114,10971,15403.0,452.0,70.0
0.005,6,10,1989,5,927,1.0,659.0,659.0,5,1062,1.0,794.0,794.0
10.822,17,28,4419,14,1995,823.0,270.0,114.0,14,2424,823.0,587.0,145.0
0.004,17,4,284,2,120,1.0,32.0,32.0,2,164,0.0,60.0,54.0
0.004,17,2,136,1,60,0.0,32.0,32.0,1,76,0.0,48.0,48.0
0.004,6,10,1989,5,927,1.0,659.0,659.0,5,1062,1.0,794.0,794.0
0.015,6,10,1990,5,911,3.0,643.0,643.0,5,1079,3.0,811.0,811.0
0.071,6,10,1506,5,395,16.0,127.0,127.0,5,1111,15.0,843.0,843.0
0.005,6,10,1547,5,764,1.0,496.0,496.0,5,783,1.0,515.0,515.0
0.121,6,10,1506,5,395,24.0,127.0,127.0,5,1111,25.0,843.0,843.0
0.006,6,13,3747,7,509,0.0,137.0,137.0,6,3238,1.0,1470.0,1459.0
0.009,6,10,1972,5,910,2.0,642.0,642.0,5,1062,2.0,794.0,794.0
289.668,6,329,345021,128,18845,2280.0,2691.0,812.0,201,326176,1448.0,2804.0,1697.0
0.003,17,4,284,2,120,0.0,32.0,32.0,2,164,0.0,60.0,54.0
354.011,6,21,1795,16,1030,23600.0,190.0,190.0,5,765,60005.0,464.0,248.0
0.072,17,2,136,1,60,0.0,32.0,32.0,1,76,0.0,48.0,48.0
15.45,17,57,35229,32,28573,496.0,1350.0,864.0,25,6656,642.0,1350.0,238.0
0.02,6,10,1990,5,911,5.0,643.0,643.0,5,1079,5.0,811.0,811.0
0.005,6,10,2007,5,928,1.0,660.0,660.0,5,1079,1.0,811.0,811.0
300.419,6,16,2170,9,684,37531.0,146.0,146.0,7,1486,50041.0,419.0,398.0
0.013,6,10,1972,5,910,3.0,642.0,642.0,5,1062,3.0,794.0,794.0
0.01,6,10,1989,5,910,2.0,642.0,642.0,5,1079,2.0,811.0,811.0
0.006,6,10,1689,5,839,1.0,571.0,571.0,5,850,1.0,582.0,582.0
0.012,6,10,1631,5,848,3.0,580.0,580.0,5,783,2.0,515.0,515.0
0.06,6,10,1506,5,395,14.0,127.0,127.0,5,1111,11.0,843.0,843.0
0.111,6,10,1506,5,395,24.0,127.0,127.0,5,1111,23.0,843.0,843.0
0.007,6,10,1547,5,764,1.0,496.0,496.0,5,783,1.0,515.0,515.0
0.105,6,10,1506,5,395,24.0,127.0,127.0,5,1111,21.0,843.0,843.0
0.018,6,10,1989,5,910,4.0,642.0,642.0,5,1079,4.0,811.0,811.0
0.005,6,10,1547,5,764,1.0,496.0,496.0,5,783,1.0,515.0,515.0
0.005,6,10,2006,5,927,1.0,659.0,659.0,5,1079,1.0,811.0,811.0
0.004,6,10,2007,5,928,1.0,660.0,660.0,5,1079,1.0,811.0,811.0
0.053,17,2,152,1,76,0.0,48.0,48.0,1,76,0.0,48.0,48.0
0.006,6,10,1547,5,764,1.0,496.0,496.0,5,783,1.0,515.0,515.0
0.012,6,10,1989,5,910,3.0,642.0,642.0,5,1079,3.0,811.0,811.0
0.021,6,10,1989,5,910,5.0,642.0,642.0,5,1079,5.0,811.0,811.0
0.078,6,10,1506,5,395,18.0,127.0,127.0,5,1111,16.0,843.0,843.0
0.038,17,2,182,1,65,0.0,37.0,37.0,1,117,0.0,89.0,89.0
0.013,6,10,1972,5,910,3.0,642.0,642.0,5,1062,3.0,794.0,794.0
0.005,6,10,1989,5,927,1.0,659.0,659.0,5,1062,1.0,794.0,794.0
40.052,17,10,676,5,460,10012.0,104.0,64.0,5,216,10012.0,20.0,15.0
11.035,17,28,4420,14,1993,840.0,268.0,114.0,14,2427,840.0,586.0,145.0
0.073,6,10,1506,5,395,15.0,127.0,127.0,5,1111,16.0,843.0,843.0
0.005,6,10,2000,5,927,1.0,659.0,659.0,5,1073,1.0,805.0,805.0
0.008,6,10,1990,5,911,2.0,643.0,643.0,5,1079,1.0,811.0,811.0
67.803,6,22,8465,12,2204,75.0,1345.0,564.0,10,6261,7514.0,1776.0,974.0
0.006,6,10,1689,5,839,1.0,571.0,571.0,5,850,1.0,582.0,582.0
0.014,6,10,1677,5,827,3.0,559.0,559.0,5,850,3.0,582.0,582.0
0.016,6,10,1677,5,827,4.0,559.0,559.0,5,850,4.0,582.0,582.0
0.015,6,10,1631,5,848,3.0,580.0,580.0,5,783,3.0,515.0,515.0
0.064,6,10,1506,5,395,13.0,127.0,127.0,5,1111,14.0,843.0,843.0
314.396,17,20,1124,10,716,34922.0,48.0,43.0,10,408,34919.0,20.0,12.0
0.037,6,13,3816,7,578,6.0,206.0,206.0,6,3238,7.0,1470.0,1459.0
0.004,6,15,3794,8,504,0.0,80.0,80.0,7,3290,0.0,1448.0,972.0
0.098,6,10,1506,5,395,21.0,127.0,127.0,5,1111,20.0,843.0,843.0
0.058,17,2,148,1,60,0.0,32.0,32.0,1,88,0.0,60.0,60.0
0.009,17,2,146,1,65,0.0,37.0,37.0,1,81,0.0,53.0,53.0
0.004,6,10,1989,5,927,1.0,659.0,659.0,5,1062,1.0,794.0,794.0
0.069,17,8,3613,4,1874,23.0,1350.0,440.0,4,1739,12.0,1350.0,406.0
0.001,17,2,154,1,69,0.0,41.0,41.0,1,85,0.0,57.0,57.0
0.096,6,10,1506,5,395,23.0,127.0,127.0,5,1111,22.0,843.0,843.0
0.005,6,10,2006,5,927,1.0,659.0,659.0,5,1079,1.0,811.0,811.0
0.012,6,10,1972,5,910,3.0,642.0,642.0,5,1062,3.0,794.0,794.0
0.018,6,10,1762,5,911,4.0,643.0,643.0,5,851,4.0,583.0,583.0
0.005,6,10,2000,5,927,1.0,659.0,659.0,5,1073,1.0,805.0,805.0
0.013,6,10,1631,5,848,3.0,580.0,580.0,5,783,3.0,515.0,515.0
0.012,6,14,3787,7,497,2.0,125.0,125.0,7,3290,1.0,1448.0,972.0
0.016,6,10,1990,5,911,3.0,643.0,643.0,5,1079,3.0,811.0,811.0
0.014,6,10,1983,5,910,3.0,642.0,642.0,5,1073,3.0,805.0,805.0
0.005,6,10,2007,5,928,1.0,660.0,660.0,5,1079,1.0,811.0,811.0
0.81,6,10,1905,6,1551,162.0,1299.0,1299.0,4,354,193.0,182.0,182.0
0.005,6,10,1779,5,928,1.0,660.0,660.0,5,851,1.0,583.0,583.0
0.009,6,10,1990,5,911,2.0,643.0,643.0,5,1079,2.0,811.0,811.0
0.134,17,2,80,1,32,0.0,4.0,4.0,1,48,0.0,20.0,20.0
0.078,6,10,1506,5,395,17.0,127.0,127.0,5,1111,15.0,843.0,843.0
0.012,6,14,3787,7,497,2.0,125.0,125.0,7,3290,1.0,1448.0,972.0
0.143,6,10,1506,5,395,32.0,127.0,127.0,5,1111,34.0,843.0,843.0
0.005,6,10,1854,5,889,1.0,621.0,621.0,5,965,1.0,697.0,697.0
0.028,6,10,1972,5,910,6.0,642.0,642.0,5,1062,6.0,794.0,794.0
0.012,6,10,1972,5,910,3.0,642.0,642.0,5,1062,2.0,794.0,794.0
0.004,6,10,1702,5,863,0.0,595.0,595.0,5,839,1.0,571.0,571.0
0.006,6,10,1689,5,839,1.0,571.0,571.0,5,850,1.0,582.0,582.0
0.006,6,10,1547,5,764,1.0,496.0,496.0,5,783,1.0,515.0,515.0
240.096,6,34,9332,18,6839,14123.0,1807.0,656.0,16,2493,16006.0,580.0,206.0
0.006,6,13,3747,7,509,0.0,137.0,137.0,6,3238,1.0,1470.0,1459.0
0.014,6,10,1972,5,910,3.0,642.0,642.0,5,1062,3.0,794.0,794.0
0.005,6,10,1643,5,860,1.0,592.0,592.0,5,783,1.0,515.0,515.0
0.001,17,2,180,1,66,0.0,38.0,38.0,1,114,0.0,86.0,86.0
0.006,6,10,1989,5,927,1.0,659.0,659.0,5,1062,1.0,794.0,794.0
0.003,6,10,1702,5,863,0.0,595.0,595.0,5,839,0.0,571.0,571.0
0.011,6,10,1983,5,910,2.0,642.0,642.0,5,1073,2.0,805.0,805.0
0.059,6,8,3114,4,2314,19.0,1124.0,1053.0,4,800,17.0,296.0,296.0
0.006,17,2,209,1,64,0.0,36.0,36.0,1,145,0.0,117.0,117.0
0.009,6,10,1972,5,910,2.0,642.0,642.0,5,1062,2.0,794.0,794.0
240.275,6,43,8771,21,5686,12013.0,1515.0,509.0,22,3085,11441.0,580.0,241.0
0.001,17,2,136,1,60,0.0,32.0,32.0,1,76,0.0,48.0,48.0
0.043,17,2,148,1,60,0.0,32.0,32.0,1,88,0.0,60.0,60.0
0.01,6,10,1972,5,910,2.0,642.0,642.0,5,1062,2.0,794.0,794.0
0.007,6,10,1990,5,911,1.0,643.0,643.0,5,1079,1.0,811.0,811.0
240.249,6,42,5387,21,2479,12012.0,588.0,197.0,21,2908,12012.0,580.0,226.0
0.012,6,10,1631,5,848,3.0,580.0,580.0,5,783,2.0,515.0,515.0
0.005,17,2,140,1,62,0.0,34.0,34.0,1,78,0.0,50.0,50.0
0.011,6,12,1926,6,1189,2.0,659.0,434.0,6,737,2.0,417.0,417.0
0.104,6,10,1506,5,395,19.0,127.0,127.0,5,1111,24.0,843.0,843.0
0.012,6,10,1631,5,848,2.0,580.0,580.0,5,783,2.0,515.0,515.0
0.003,17,2,148,1,60,0.0,32.0,32.0,1,88,0.0,60.0,60.0
300.339,6,25,7300,15,1357,21452.0,217.0,142.0,10,5943,26699.0,1679.0,902.0
0.015,6,10,1972,5,910,3.0,642.0,642.0,5,1062,3.0,794.0,794.0
40.069,17,10,676,5,460,10016.0,104.0,64.0,5,216,10016.0,20.0,15.0
0.006,6,10,1547,5,764,1.0,496.0,496.0,5,783,1.0,515.0,515.0
0.005,6,10,1989,5,927,1.0,659.0,659.0,5,1062,1.0,794.0,794.0
0.017,6,13,3735,7,497,2.0,125.0,125.0,6,3238,3.0,1470.0,1459.0
0.022,6,14,3787,7,497,3.0,125.0,125.0,7,3290,3.0,1448.0,972.0
0.005,6,10,1989,5,927,1.0,659.0,659.0,5,1062,1.0,794.0,794.0
1798.133,17,2709,207236,1348,109250,1334.0,84.0,53.0,1361,97986,1322.0,227.0,43.0
0.01,6,13,3747,7,509,1.0,137.0,137.0,6,3238,1.0,1470.0,1459.0
0.097,6,10,1506,5,395,21.0,127.0,127.0,5,1111,19.0,843.0,843.0
0.23,6,16,2782,8,1400,32.0,533.0,325.0,8,1382,21.0,529.0,239.0
0.013,6,10,1762,5,911,3.0,643.0,643.0,5,851,3.0,583.0,583.0
0.095,6,10,1506,5,395,19.0,127.0,127.0,5,1111,20.0,843.0,843.0
0.014,6,10,1762,5,911,3.0,643.0,643.0,5,851,3.0,583.0,583.0
0.001,17,2,180,1,66,0.0,38.0,38.0,1,114,0.0,86.0,86.0
0.005,6,10,2007,5,928,1.0,660.0,660.0,5,1079,1.0,811.0,811.0
0.041,17,2,152,1,76,0.0,48.0,48.0,1,76,0.0,48.0,48.0
0.006,6,10,1547,5,764,1.0,496.0,496.0,5,783,1.0,515.0,515.0
0.093,6,10,1506,5,395,16.0,127.0,127.0,5,1111,22.0,843.0,843.0
0.005,6,13,3747,7,509,0.0,137.0,137.0,6,3238,1.0,1470.0,1459.0
0.016,6,10,1989,5,910,4.0,642.0,642.0,5,1079,3.0,811.0,811.0
0.014,6,10,1990,5,911,3.0,643.0,643.0,5,1079,3.0,811.0,811.0
0.116,6,10,1506,5,395,24.0,127.0,127.0,5,1111,25.0,843.0,843.0
0.005,6,10,2000,5,927,1.0,659.0,659.0,5,1073,1.0,805.0,805.0
0.018,17,2,198,1,91,0.0,63.0,63.0,1,107,0.0,79.0,79.0
0.011,6,10,1631,5,848,2.0,580.0,580.0,5,783,2.0,515.0,515.0
0.015,6,10,1631,5,848,3.0,580.0,580.0,5,783,3.0,515.0,515.0
0.02,6,10,1972,5,910,4.0,642.0,642.0,5,1062,4.0,794.0,794.0
0.079,6,10,1506,5,395,16.0,127.0,127.0,5,1111,18.0,843.0,843.0
0.009,6,10,1990,5,911,2.0,643.0,643.0,5,1079,2.0,811.0,811.0
0.094,6,10,1506,5,395,22.0,127.0,127.0,5,1111,15.0,843.0,843.0
40.088,17,10,676,5,460,10017.0,104.0,64.0,5,216,10021.0,20.0,15.0
0.017,6,10,1990,5,911,4.0,643.0,643.0,5,1079,4.0,811.0,811.0
0.005,6,10,1689,5,839,1.0,571.0,571.0,5,850,1.0,582.0,582.0
40.056,17,10,676,5,460,10013.0,104.0,64.0,5,216,10013.0,20.0,15.0
0.075,6,10,1506,5,395,14.0,127.0,127.0,5,1111,18.0,843.0,843.0
0.014,6,10,1990,5,911,3.0,643.0,643.0,5,1079,3.0,811.0,811.0
0.014,6,10,1989,5,910,3.0,642.0,642.0,5,1079,3.0,811.0,811.0
0.092,6,10,1506,5,395,20.0,127.0,127.0,5,1111,19.0,843.0,843.0
0.005,17,2,148,1,60,0.0,32.0,32.0,1,88,0.0,60.0,60.0
0.012,6,10,1989,5,910,3.0,642.0,642.0,5,1079,2.0,811.0,811.0
0.014,6,10,1631,5,848,3.0,580.0,580.0,5,783,3.0,515.0,515.0
0.01,6,10,1989,5,910,2.0,642.0,642.0,5,1079,2.0,811.0,811.0
0.005,6,10,2006,5,927,1.0,659.0,659.0,5,1079,1.0,811.0,811.0
0.004,17,2,136,1,60,0.0,32.0,32.0,1,76,0.0,48.0,48.0
0.006,17,2,222,1,65,0.0,37.0,37.0,1,157,0.0,129.0,129.0
0.015,6,10,1762,5,911,3.0,643.0,643.0,5,851,3.0,583.0,583.0
0.005,6,10,2006,5,927,1.0,659.0,659.0,5,1079,1.0,811.0,811.0
0.018,6,10,1990,5,911,4.0,643.0,643.0,5,1079,4.0,811.0,811.0
0.004,17,4,284,2,120,0.0,32.0,32.0,2,164,1.0,60.0,54.0
11.109,17,28,4421,14,1994,842.0,269.0,114.0,14,2427,842.0,586.0,145.0
0.148,6,10,1506,5,395,34.0,127.0,127.0,5,1111,34.0,843.0,843.0
0.105,6,10,1506,5,395,22.0,127.0,127.0,5,1111,23.0,843.0,843.0
40.063,17,10,676,5,460,10015.0,104.0,64.0,5,216,10015.0,20.0,15.0
0.003,17,2,136,1,60,0.0,32.0,32.0,1,76,0.0,48.0,48.0
0.005,6,10,1689,5,839,1.0,571.0,571.0,5,850,1.0,582.0,582.0
0.005,6,10,2006,5,927,1.0,659.0,659.0,5,1079,1.0,811.0,811.0
0.007,6,10,1689,5,839,1.0,571.0,571.0,5,850,1.0,582.0,582.0
0.215,6,16,2777,8,1395,30.0,533.0,323.0,8,1382,19.0,529.0,239.0
0.009,6,10,1989,5,910,2.0,642.0,642.0,5,1079,2.0,811.0,811.0
0.124,6,10,1506,5,395,28.0,127.0,127.0,5,1111,29.0,843.0,843.0
0.006,17,2,179,1,71,0.0,43.0,43.0,1,108,0.0,80.0,80.0
0.006,6,10,1547,5,764,1.0,496.0,496.0,5,783,1.0,515.0,515.0
0.008,6,10,1983,5,910,2.0,642.0,642.0,5,1073,2.0,805.0,805.0
0.069,6,10,1506,5,395,16.0,127.0,127.0,5,1111,14.0,843.0,843.0
40.06,17,10,676,5,460,10012.0,104.0,64.0,5,216,10014.0,20.0,15.0
0.001,17,2,180,1,66,0.0,38.0,38.0,1,114,0.0,86.0,86.0
0.001,17,2,180,1,65,0.0,37.0,37.0,1,115,0.0,87.0,87.0
0.007,17,2,194,1,59,0.0,31.0,31.0,1,135,0.0,107.0,107.0
0.006,6,10,1643,5,860,1.0,592.0,592.0,5,783,1.0,515.0,515.0
0.141,6,10,1506,5,395,33.0,127.0,127.0,5,1111,33.0,843.0,843.0
0.005,6,14,3799,7,509,0.0,137.0,137.0,7,3290,0.0,1448.0,972.0
0.005,6,10,1774,5,923,1.0,655.0,655.0,5,851,1.0,583.0,583.0
0.005,6,10,2000,5,927,1.0,659.0,659.0,5,1073,1.0,805.0,805.0
0.008,6,10,1989,5,910,2.0,642.0,642.0,5,1079,2.0,811.0,811.0
0.004,17,2,148,1,60,0.0,32.0,32.0,1,88,0.0,60.0,60.0
315.191,17,20,1124,10,716,35007.0,48.0,43.0,10,408,35007.0,20.0,12.0
0.005,6,10,2006,5,927,1.0,659.0,659.0,5,1079,1.0,811.0,811.0
40.067,17,10,676,5,460,10014.0,104.0,64.0,5,216,10015.0,20.0,15.0
0.074,6,10,1506,5,395,16.0,127.0,127.0,5,1111,15.0,843.0,843.0
0.07,6,10,1506,5,395,15.0,127.0,127.0,5,1111,15.0,843.0,843.0
0.005,17,2,178,1,65,0.0,37.0,37.0,1,113,0.0,85.0,85.0
0.084,6,10,1506,5,395,18.0,127.0,127.0,5,1111,18.0,843.0,843.0
0.005,17,2,166,1,75,0.0,47.0,47.0,1,91,0.0,63.0,63.0
15.07,17,15,9238,8,6902,2148.0,1350.0,834.0,7,2336,2506.0,1350.0,305.0
0.09,17,2,144,1,64,0.0,36.0,36.0,1,80,0.0,52.0,52.0
171.3,17,72,10328,36,2410,4894.0,44.0,38.0,36,7918,4894.0,249.0,191.0
0.141,6,20,8575,11,860,14.0,280.0,280.0,9,7715,16.0,1402.0,1206.0
0.132,6,10,1506,5,395,31.0,127.0,127.0,5,1111,30.0,843.0,843.0
354.064,6,19,1691,15,978,25290.0,190.0,190.0,4,713,80005.0,497.0,497.0
0.068,17,8,3613,4,1874,22.0,1350.0,440.0,4,1739,11.0,1350.0,406.0
0.024,6,10,1989,5,910,5.0,642.0,642.0,5,1079,6.0,811.0,811.0
0.006,6,10,1854,5,889,1.0,621.0,621.0,5,965,1.0,697.0,697.0
289.549,6,378,346564,196,21765,1484.0,2736.0,889.0,182,324799,1599.0,2804.0,1876.0
0.008,6,12,1926,6,1189,1.0,659.0,434.0,6,737,1.0,417.0,417.0
0.208,6,16,2782,8,1400,29.0,533.0,325.0,8,1382,18.0,529.0,239.0
0.004,6,10,2007,5,928,1.0,660.0,660.0,5,1079,1.0,811.0,811.0
0.006,6,10,1547,5,764,1.0,496.0,496.0,5,783,1.0,515.0,515.0
0.091,6,10,1506,5,395,18.0,127.0,127.0,5,1111,21.0,843.0,843.0
0.003,17,2,136,1,60,0.0,32.0,32.0,1,76,0.0,48.0,48.0
0.009,17,2,213,1,69,0.0,41.0,41.0,1,144,0.0,116.0,116.0
0.005,6,10,2007,5,928,1.0,660.0,660.0,5,1079,1.0,811.0,811.0
0.005,6,10,2006,5,927,1.0,659.0,659.0,5,1079,1.0,811.0,811.0
0.007,6,10,1989,5,910,1.0,642.0,642.0,5,1079,1.0,811.0,811.0
0.004,17,2,148,1,60,0.0,32.0,32.0,1,88,0.0,60.0,60.0
0.006,6,10,1643,5,860,1.0,592.0,592.0,5,783,1.0,515.0,515.0
0.11,6,10,1506,5,395,22.0,127.0,127.0,5,1111,23.0,843.0,843.0
0.216,6,16,2778,8,1396,30.0,533.0,324.0,8,1382,19.0,529.0,239.0
0.009,6,10,1972,5,910,2.0,642.0,642.0,5,1062,2.0,794.0,794.0
0.138,6,10,1506,5,395,31.0,127.0,127.0,5,1111,32.0,843.0,843.0
0.003,17,2,136,1,60,0.0,32.0,32.0,1,76,0.0,48.0,48.0
0.005,6,10,2000,5,927,1.0,659.0,659.0,5,1073,1.0,805.0,805.0
0.005,6,10,2006,5,927,1.0,659.0,659.0,5,1079,1.0,811.0,811.0
0.026,6,10,1983,5,910,6.0,642.0,642.0,5,1073,6.0,805.0,805.0
0.006,6,10,1689,5,839,1.0,571.0,571.0,5,850,1.0,582.0,582.0
0.004,17,2,412,1,61,0.0,33.0,33.0,1,351,0.0,323.0,323.0
0.07,6,10,1506,5,395,15.0,127.0,127.0,5,1111,16.0,843.0,843.0
0.15,6,10,1242,5,751,37.0,495.0,495.0,5,491,33.0,223.0,223.0
0.012,6,10,1677,5,827,2.0,559.0,559.0,5,850,2.0,582.0,582.0
0.005,6,10,2000,5,927,1.0,659.0,659.0,5,1073,1.0,805.0,805.0
0.004,6,10,2007,5,928,1.0,660.0,660.0,5,1079,1.0,811.0,811.0
0.011,6,10,1989,5,910,2.0,642.0,642.0,5,1079,2.0,811.0,811.0
0.11,6,10,1506,5,395,25.0,127.0,127.0,5,1111,23.0,843.0,843.0
0.005,6,10,2007,5,928,1.0,660.0,660.0,5,1079,1.0,811.0,811.0
0.019,6,10,1989,5,910,4.0,642.0,642.0,5,1079,4.0,811.0,811.0
0.083,6,10,1506,5,395,18.0,127.0,127.0,5,1111,17.0,843.0,843.0
0.009,6,10,1989,5,910,2.0,642.0,642.0,5,1079,2.0,811.0,811.0
0.009,6,13,3735,7,497,1.0,125.0,125.0,6,3238,1.0,1470.0,1459.0
0.005,17,2,144,1,64,0.0,36.0,36.0,1,80,0.0,52.0,52.0
40.066,17,10,676,5,460,10015.0,104.0,64.0,5,216,10015.0,20.0,15.0
0.006,6,10,1643,5,860,1.0,592.0,592.0,5,783,1.0,515.0,515.0
0.015,6,10,1990,5,911,3.0,643.0,643.0,5,1079,3.0,811.0,811.0
0.014,6,10,1631,5,848,3.0,580.0,580.0,5,783,3.0,515.0,515.0
0.013,6,10,1972,5,910,3.0,642.0,642.0,5,1062,3.0,794.0,794.0
1782.801,6,296,51517,121,34130,14855.0,2720.0,301.0,175,17387,10245.0,1360.0,129.0
0.006,6,10,1547,5,764,1.0,496.0,496.0,5,783,1.0,515.0,515.0
0.008,17,2,140,1,62,0.0,34.0,34.0,1,78,0.0,50.0,50.0
0.093,6,10,1506,5,395,21.0,127.0,127.0,5,1111,19.0,843.0,843.0
0.004,17,2,148,1,60,0.0,32.0,32.0,1,88,0.0,60.0,60.0
0.01,6,10,1762,5,911,2.0,643.0,643.0,5,851,2.0,583.0,583.0
0.005,6,10,2007,5,928,1.0,660.0,660.0,5,1079,1.0,811.0,811.0
0.006,17,2,170,1,65,0.0,37.0,37.0,1,105,0.0,77.0,77.0
0.005,6,10,1854,5,889,1.0,621.0,621.0,5,965,1.0,697.0,697.0
0.005,17,2,249,1,64,0.0,36.0,36.0,1,185,0.0,157.0,157.0
240.112,6,32,8088,18,5716,14124.0,1515.0,531.0,14,2372,18469.0,580.0,204.0
0.007,6,10,1547,5,764,1.0,496.0,496.0,5,783,1.0,515.0,515.0
10.819,17,28,4421,14,1994,823.0,269.0,114.0,14,2427,823.0,586.0,145.0
0.01,6,10,1631,5,848,2.0,580.0,580.0,5,783,2.0,515.0,515.0
1729.241,6,60,4400,40,2740,44339.0,33.0,33.0,20,1660,91003.0,31.0,31.0
0.004,6,10,1702,5,863,1.0,595.0,595.0,5,839,0.0,571.0,571.0
0.073,6,10,1506,5,395,16.0,127.0,127.0,5,1111,16.0,843.0,843.0
0.013,6,14,3787,7,497,2.0,125.0,125.0,7,3290,2.0,1448.0,972.0
0.009,6,10,1989,5,910,2.0,642.0,642.0,5,1079,2.0,811.0,811.0
0.012,6,10,1631,5,848,3.0,580.0,580.0,5,783,2.0,515.0,515.0
57.346,6,39,12075,20,6517,465.0,1360.0,947.0,19,5558,3176.0,2667.0,435.0
0.005,6,10,1643,5,860,1.0,592.0,592.0,5,783,1.0,515.0,515.0
0.004,17,2,148,1,60,0.0,32.0,32.0,1,88,0.0,60.0,60.0
0.113,6,10,1506,5,395,25.0,127.0,127.0,5,1111,22.0,843.0,843.0
0.001,17,2,130,1,65,0.0,37.0,37.0,1,65,0.0,37.0,37.0
0.004,6,10,2007,5,928,1.0,660.0,660.0,5,1079,1.0,811.0,811.0
0.003,17,2,148,1,60,0.0,32.0,32.0,1,88,0.0,60.0,60.0
0.004,17,4,284,2,120,0.0,32.0,32.0,2,164,0.0,60.0,54.0
0.015,6,10,1972,5,910,3.0,642.0,642.0,5,1062,3.0,794.0,794.0
0.137,17,2,80,1,32,0.0,4.0,4.0,1,48,0.0,20.0,20.0
0.003,17,2,136,1,60,0.0,32.0,32.0,1,76,0.0,48.0,48.0
0.161,6,10,1506,5,395,38.0,127.0,127.0,5,1111,36.0,843.0,843.0
0.1,6,10,1506,5,395,23.0,127.0,127.0,5,1111,20.0,843.0,843.0
300.055,6,12,1782,7,1348,50009.0,494.0,494.0,5,434,75012.0,83.0,83.0
10.817,17,28,4418,14,1993,823.0,268.0,114.0,14,2425,823.0,588.0,145.0
0.009,6,10,1983,5,910,2.0,642.0,642.0,5,1073,2.0,805.0,805.0
361.828,6,19,1689,15,978,25844.0,190.0,190.0,4,711,80013.0,495.0,495.0
0.004,6,10,2006,5,927,1.0,659.0,659.0,5,1079,1.0,811.0,811.0
0.005,17,2,179,1,71,0.0,43.0,43.0,1,108,0.0,80.0,80.0
0.005,6,10,1689,5,839,1.0,571.0,571.0,5,850,1.0,582.0,582.0
0.01,6,13,3735,7,497,1.0,125.0,125.0,6,3238,1.0,1470.0,1459.0
0.019,6,10,1972,5,910,4.0,642.0,642.0,5,1062,4.0,794.0,794.0
0.071,17,4,284,2,120,0.0,32.0,32.0,2,164,68.0,60.0,54.0
0.194,17,4,596,2,122,145.0,33.0,33.0,2,474,152.0,323.0,209.0
0.074,6,10,1506,5,395,17.0,127.0,127.0,5,1111,18.0,843.0,843.0
0.01,6,10,1989,5,910,2.0,642.0,642.0,5,1079,2.0,811.0,811.0
0.003,17,2,148,1,60,0.0,32.0,32.0,1,88,0.0,60.0,60.0
0.005,17,2,148,1,60,0.0,32.0,32.0,1,88,0.0,60.0,60.0
0.011,6,10,1983,5,910,2.0,642.0,642.0,5,1073,2.0,805.0,805.0
0.011,6,10,1989,5,910,2.0,642.0,642.0,5,1079,2.0,811.0,811.0
0.008,6,10,1774,5,923,1.0,655.0,655.0,5,851,1.0,583.0,583.0
353.035,6,20,2210,6,1308,12014.0,494.0,494.0,14,902,27156.0,83.0,83.0
289.234,6,391,348301,203,22113,1431.0,2736.0,825.0,188,326188,1546.0,2804.0,1818.0
0.001,17,2,179,1,62,0.0,34.0,34.0,1,117,0.0,89.0,89.0
0.006,6,10,1547,5,764,1.0,496.0,496.0,5,783,1.0,515.0,515.0
97.6,58,5,360,4,288,32533.0,24.0,24.0,1,72,0.0,24.0,24.0
0.01,6,10,1677,5,827,2.0,559.0,559.0,5,850,2.0,582.0,582.0
0.017,6,10,1631,5,848,4.0,580.0,580.0,5,783,4.0,515.0,515.0
0.012,6,10,1677,5,827,2.0,559.0,559.0,5,850,3.0,582.0,582.0
0.02,17,2,170,1,65,0.0,37.0,37.0,1,105,0.0,77.0,77.0
300.877,6,40,9774,22,4211,14327.0,1543.0,657.0,18,5563,511.0,2667.0,402.0
0.011,6,10,1989,5,910,2.0,642.0,642.0,5,1079,2.0,811.0,811.0
0.07,6,10,1506,5,395,15.0,127.0,127.0,5,1111,15.0,843.0,843.0
0.04,17,4,420,2,122,0.0,33.0,33.0,2,298,3.0,145.0,121.0
0.005,6,10,2006,5,927,1.0,659.0,659.0,5,1079,1.0,811.0,811.0
0.016,6,10,1989,5,910,3.0,642.0,642.0,5,1079,3.0,811.0,811.0
0.125,6,10,1506,5,395,25.0,127.0,127.0,5,1111,27.0,843.0,843.0
0.013,6,10,1990,5,911,3.0,643.0,643.0,5,1079,3.0,811.0,811.0
0.005,17,2,263,1,60,0.0,32.0,32.0,1,203,0.0,175.0,175.0
0.043,6,10,1762,5,911,10.0,643.0,643.0,5,851,10.0,583.0,583.0
0.067,6,10,1506,5,395,14.0,127.0,127.0,5,1111,15.0,843.0,843.0
0.004,6,10,1779,5,928,1.0,660.0,660.0,5,851,1.0,583.0,583.0
0.87,6,23,7974,13,1539,72.0,517.0,287.0,10,6435,17.0,1402.0,843.0
0.096,6,10,1506,5,395,21.0,127.0,127.0,5,1111,22.0,843.0,843.0
0.003,17,2,148,1,60,0.0,32.0,32.0,1,88,0.0,60.0,60.0
0.097,6,10,1506,5,395,15.0,127.0,127.0,5,1111,21.0,843.0,843.0
0.005,6,10,1689,5,839,1.0,571.0,571.0,5,850,1.0,582.0,582.0
0.006,17,2,222,1,65,0.0,37.0,37.0,1,157,0.0,129.0,129.0
0.008,6,12,1926,6,1189,1.0,659.0,434.0,6,737,1.0,417.0,417.0
0.039,17,4,284,2,120,0.0,32.0,32.0,2,164,36.0,60.0,54.0
0.123,6,10,1506,5,395,30.0,127.0,127.0,5,1111,26.0,843.0,843.0
0.108,6,10,1506,5,395,25.0,127.0,127.0,5,1111,24.0,843.0,843.0
0.005,6,10,2006,5,927,1.0,659.0,659.0,5,1079,1.0,811.0,811.0
0.007,6,10,1983,5,910,1.0,642.0,642.0,5,1073,1.0,805.0,805.0
0.008,6,10,1972,5,910,2.0,642.0,642.0,5,1062,1.0,794.0,794.0
0.007,17,2,179,1,71,0.0,43.0,43.0,1,108,0.0,80.0,80.0
0.014,6,10,1762,5,911,3.0,643.0,643.0,5,851,3.0,583.0,583.0
11.246,17,28,4422,14,1994,852.0,269.0,114.0,14,2428,852.0,587.0,145.0
0.038,17,2,148,1,60,0.0,32.0,32.0,1,88,0.0,60.0,60.0
0.003,17,2,148,1,60,0.0,32.0,32.0,1,88,0.0,60.0,60.0
178.48,17,78,11067,39,2593,4696.0,44.0,38.0,39,8474,4696.0,239.0,189.0
0.013,6,10,1989,5,910,3.0,642.0,642.0,5,1079,3.0,811.0,811.0
0.006,6,10,1689,5,839,1.0,571.0,571.0,5,850,1.0,582.0,582.0
0.016,6,13,3735,7,497,2.0,125.0,125.0,6,3238,3.0,1470.0,1459.0
0.013,6,10,1972,5,910,3.0,642.0,642.0,5,1062,3.0,794.0,794.0
0.006,17,2,169,1,62,0.0,34.0,34.0,1,107,0.0,79.0,79.0
0.044,17,2,148,1,60,0.0,32.0,32.0,1,88,0.0,60.0,60.0
0.066,17,8,3613,4,1874,22.0,1350.0,440.0,4,1739,11.0,1350.0,406.0
0.01,6,12,1926,6,1189,1.0,659.0,434.0,6,737,1.0,417.0,417.0
15.069,17,15,9238,8,6902,2148.0,1350.0,834.0,7,2336,2506.0,1350.0,305.0
0.005,6,10,1689,5,839,1.0,571.0,571.0,5,850,1.0,582.0,582.0
0.005,6,10,1779,5,928,1.0,660.0,660.0,5,851,1.0,583.0,583.0
0.007,6,10,1689,5,839,1.0,571.0,571.0,5,850,1.0,582.0,582.0
0.072,17,2,148,1,60,0.0,32.0,32.0,1,88,0.0,60.0,60.0
0.101,6,10,1506,5,395,22.0,127.0,127.0,5,1111,23.0,843.0,843.0
0.04,17,4,284,2,120,0.0,32.0,32.0,2,164,36.0,60.0,54.0
0.304,17,43,20867,22,17099,14.0,1350.0,749.0,21,3768,13.0,1350.0,151.0
0.006,6,10,1689,5,839,1.0,571.0,571.0,5,850,1.0,582.0,582.0
0.08,6,10,1506,5,395,17.0,127.0,127.0,5,1111,17.0,843.0,843.0
0.013,6,10,1972,5,910,3.0,642.0,642.0,5,1062,3.0,794.0,794.0
0.011,6,10,1989,5,910,2.0,642.0,642.0,5,1079,2.0,811.0,811.0
11.027,17,29,4565,15,2165,779.0,268.0,116.0,14,2400,839.0,587.0,143.0
0.084,17,2,80,1,32,0.0,4.0,4.0,1,48,0.0,20.0,20.0
0.01,6,10,1972,5,910,2.0,642.0,642.0,5,1062,2.0,794.0,794.0
0.074,6,10,1506,5,395,17.0,127.0,127.0,5,1111,15.0,843.0,843.0
0.1,6,10,1506,5,395,23.0,127.0,127.0,5,1111,18.0,843.0,843.0
0.005,17,2,230,1,68,0.0,40.0,40.0,1,162,0.0,134.0,134.0
0.011,6,10,1989,5,910,2.0,642.0,642.0,5,1079,2.0,811.0,811.0
0.006,6,10,1854,5,889,1.0,621.0,621.0,5,965,1.0,697.0,697.0
0.094,6,10,1506,5,395,19.0,127.0,127.0,5,1111,20.0,843.0,843.0
0.067,6,10,1506,5,395,14.0,127.0,127.0,5,1111,15.0,843.0,843.0
0.013,6,10,1989,5,910,3.0,642.0,642.0,5,1079,3.0,811.0,811.0
0.005,6,10,2007,5,928,1.0,660.0,660.0,5,1079,1.0,811.0,811.0
0.005,6,10,2006,5,927,1.0,659.0,659.0,5,1079,1.0,811.0,811.0
172.175,17,76,10912,38,2545,4653.0,44.0,38.0,38,8367,4653.0,252.0,192.0
0.005,6,10,1989,5,927,1.0,659.0,659.0,5,1062,1.0,794.0,794.0
0.138,6,10,1506,5,395,32.0,127.0,127.0,5,1111,29.0,843.0,843.0
0.013,6,10,1989,5,910,3.0,642.0,642.0,5,1079,3.0,811.0,811.0
0.013,6,10,1989,5,910,3.0,642.0,642.0,5,1079,3.0,811.0,811.0
0.016,6,10,1989,5,910,4.0,642.0,642.0,5,1079,4.0,811.0,811.0
0.072,17,4,420,2,122,0.0,33.0,33.0,2,298,33.0,145.0,121.0
0.001,17,2,180,1,66,0.0,38.0,38.0,1,114,0.0,86.0,86.0
176.146,17,82,11241,41,2756,4403.0,44.0,39.0,41,8485,4403.0,239.0,178.0
0.005,6,10,1689,5,839,1.0,571.0,571.0,5,850,1.0,582.0,582.0
0.005,6,10,2007,5,928,1.0,660.0,660.0,5,1079,1.0,811.0,811.0
0.106,6,10,1506,5,395,25.0,127.0,127.0,5,1111,23.0,843.0,843.0
10.85,17,28,4424,14,1995,826.0,270.0,114.0,14,2429,826.0,588.0,145.0
0.038,17,2,152,1,76,0.0,48.0,48.0,1,76,0.0,48.0,48.0
0.117,6,10,1506,5,395,26.0,127.0,127.0,5,1111,26.0,843.0,843.0
0.004,17,2,136,1,60,0.0,32.0,32.0,1,76,0.0,48.0,48.0
40.061,17,10,676,5,460,10013.0,104.0,64.0,5,216,10014.0,20.0,15.0
0.017,6,10,1989,5,910,4.0,642.0,642.0,5,1079,4.0,811.0,811.0
0.005,6,10,1989,5,927,1.0,659.0,659.0,5,1062,1.0,794.0,794.0
0.013,6,10,1989,5,910,3.0,642.0,642.0,5,1079,3.0,811.0,811.0
0.005,17,2,140,1,62,0.0,34.0,34.0,1,78,0.0,50.0,50.0
0.054,6,14,3965,7,495,8.0,123.0,123.0,7,3470,9.0,1448.0,1032.0
0.005,6,10,2006,5,927,1.0,659.0,659.0,5,1079,1.0,811.0,811.0
0.012,6,10,1990,5,911,3.0,643.0,643.0,5,1079,3.0,811.0,811.0
40.056,17,10,676,5,460,10012.0,104.0,64.0,5,216,10013.0,20.0,15.0
0.015,6,10,1989,5,910,3.0,642.0,642.0,5,1079,3.0,811.0,811.0
0.042,17,4,284,2,120,1.0,32.0,32.0,2,164,38.0,60.0,54.0
0.04,17,2,170,1,65,0.0,37.0,37.0,1,105,0.0,77.0,77.0
0.005,6,10,1702,5,863,1.0,595.0,595.0,5,839,1.0,571.0,571.0
0.005,6,10,1989,5,927,1.0,659.0,659.0,5,1062,1.0,794.0,794.0
0.005,6,10,2006,5,927,1.0,659.0,659.0,5,1079,1.0,811.0,811.0
0.004,17,2,136,1,60,0.0,32.0,32.0,1,76,0.0,48.0,48.0
40.064,17,10,676,5,460,10014.0,104.0,64.0,5,216,10013.0,20.0,15.0
0.014,6,10,1762,5,911,3.0,643.0,643.0,5,851,3.0,583.0,583.0
0.071,17,4,284,2,120,0.0,32.0,32.0,2,164,31.0,60.0,54.0
0.006,6,10,1547,5,764,1.0,496.0,496.0,5,783,1.0,515.0,515.0
0.017,6,10,1989,5,910,4.0,642.0,642.0,5,1079,4.0,811.0,811.0
0.004,6,10,2006,5,927,1.0,659.0,659.0,5,1079,1.0,811.0,811.0
0.086,6,10,1506,5,395,19.0,127.0,127.0,5,1111,19.0,843.0,843.0
175.221,17,92,12994,46,3081,3893.0,44.0,38.0,46,9913,3893.0,261.0,187.0
0.059,17,2,152,1,76,0.0,48.0,48.0,1,76,0.0,48.0,48.0
40.061,17,10,676,5,460,10013.0,104.0,64.0,5,216,10014.0,20.0,15.0
300.311,6,16,2170,9,684,37517.0,146.0,146.0,7,1486,50023.0,419.0,398.0
0.004,6,10,2006,5,927,1.0,659.0,659.0,5,1079,1.0,811.0,811.0
0.001,17,2,166,1,75,0.0,47.0,47.0,1,91,0.0,63.0,63.0
0.041,17,2,144,1,64,0.0,36.0,36.0,1,80,0.0,52.0,52.0
0.112,6,10,1506,5,395,23.0,127.0,127.0,5,1111,23.0,843.0,843.0
11.032,17,28,4397,14,2311,840.0,586.0,137.0,14,2086,840.0,269.0,121.0
282.883,6,26,6520,12,1266,25716.0,267.0,156.0,14,5254,21751.0,1400.0,781.0
0.047,17,2,152,1,76,0.0,48.0,48.0,1,76,0.0,48.0,48.0
0.005,17,2,170,1,65,0.0,37.0,37.0,1,105,0.0,77.0,77.0
0.014,6,10,1990,5,911,3.0,643.0,643.0,5,1079,3.0,811.0,811.0
0.016,6,14,3787,7,497,2.0,125.0,125.0,7,3290,2.0,1448.0,972.0
0.005,6,13,3747,7,509,0.0,137.0,137.0,6,3238,0.0,1470.0,1459.0
0.006,6,10,2006,5,927,1.0,659.0,659.0,5,1079,1.0,811.0,811.0
0.011,6,10,1762,5,911,2.0,643.0,643.0,5,851,2.0,583.0,583.0
281.519,6,25,6805,11,1226,28151.0,267.0,156.0,14,5579,21654.0,1400.0,716.0
0.005,6,10,1989,5,927,1.0,659.0,659.0,5,1062,1.0,794.0,794.0
0.001,17,2,179,1,62,0.0,34.0,34.0,1,117,0.0,89.0,89.0
300.325,6,16,2170,9,684,37519.0,146.0,146.0,7,1486,50026.0,419.0,398.0
10.733,17,28,4421,14,1994,817.0,269.0,114.0,14,2427,817.0,586.0,145.0
0.019,6,10,1972,5,910,4.0,642.0,642.0,5,1062,4.0,794.0,794.0
0.005,6,10,2006,5,927,1.0,659.0,659.0,5,1079,1.0,811.0,811.0
0.011,6,10,1983,5,910,2.0,642.0,642.0,5,1073,2.0,805.0,805.0
0.004,6,10,1989,5,927,1.0,659.0,659.0,5,1062,1.0,794.0,794.0
0.001,17,2,166,1,75,0.0,47.0,47.0,1,91,0.0,63.0,63.0
0.006,6,10,1689,5,839,1.0,571.0,571.0,5,850,1.0,582.0,582.0
0.005,6,10,2007,5,928,1.0,660.0,660.0,5,1079,1.0,811.0,811.0
11.214,17,28,4423,14,1995,849.0,270.0,114.0,14,2428,849.0,587.0,145.0
40.07,17,10,676,5,460,10011.0,104.0,64.0,5,216,10016.0,20.0,15.0
0.011,6,10,1677,5,827,2.0,559.0,559.0,5,850,2.0,582.0,582.0
0.005,6,14,3799,7,509,0.0,137.0,137.0,7,3290,0.0,1448.0,972.0
0.001,17,2,180,1,65,0.0,37.0,37.0,1,115,0.0,87.0,87.0
0.22,6,16,2669,8,1395,31.0,533.0,323.0,8,1274,20.0,529.0,212.0
0.005,6,13,3747,7,509,0.0,137.0,137.0,6,3238,1.0,1470.0,1459.0
0.013,6,10,1983,5,910,3.0,642.0,642.0,5,1073,3.0,805.0,805.0
240.179,6,36,20078,17,14673,15011.0,2736.0,1378.0,19,5405,13340.0,1655.0,1102.0
0.009,6,10,1972,5,910,2.0,642.0,642.0,5,1062,2.0,794.0,794.0
0.006,17,2,166,1,75,0.0,47.0,47.0,1,91,0.0,63.0,63.0
0.028,6,10,1990,5,911,7.0,643.0,643.0,5,1079,7.0,811.0,811.0
5.148,58,2,144,1,72,0.0,24.0,24.0,1,72,0.0,24.0,24.0
0.009,17,2,170,1,65,0.0,37.0,37.0,1,105,0.0,77.0,77.0
0.012,6,10,1972,5,910,3.0,642.0,642.0,5,1062,3.0,794.0,794.0
0.005,6,10,2006,5,927,1.0,659.0,659.0,5,1079,1.0,811.0,811.0
0.001,17,2,180,1,66,0.0,38.0,38.0,1,114,0.0,86.0,86.0
0.005,6,10,2007,5,928,1.0,660.0,660.0,5,1079,1.0,811.0,811.0
0.007,17,2,194,1,59,0.0,31.0,31.0,1,135,0.0,107.0,107.0
0.008,6,12,1926,6,1189,1.0,659.0,434.0,6,737,1.0,417.0,417.0
0.007,17,2,179,1,71,0.0,43.0,43.0,1,108,0.0,80.0,80.0
309.361,17,18,1008,9,640,38653.0,48.0,43.0,9,368,38653.0,20.0,12.0
0.014,6,10,1762,5,911,3.0,643.0,643.0,5,851,3.0,583.0,583.0
0.006,6,10,1643,5,860,1.0,592.0,592.0,5,783,1.0,515.0,515.0
15.319,17,41,20346,22,17091,728.0,1350.0,748.0,19,3255,849.0,1350.0,143.0
0.001,17,2,136,1,60,0.0,32.0,32.0,1,76,0.0,48.0,48.0
0.012,6,10,1972,5,910,3.0,642.0,642.0,5,1062,2.0,794.0,794.0
0.081,6,10,1506,5,395,16.0,127.0,127.0,5,1111,19.0,843.0,843.0
0.103,6,10,1506,5,395,21.0,127.0,127.0,5,1111,23.0,843.0,843.0
0.009,6,10,1990,5,911,2.0,643.0,643.0,5,1079,2.0,811.0,811.0
11.021,17,28,4418,14,1995,839.0,270.0,114.0,14,2423,839.0,586.0,145.0
0.005,17,2,136,1,60,0.0,32.0,32.0,1,76,0.0,48.0,48.0
0.005,17,2,170,1,65,0.0,37.0,37.0,1,105,0.0,77.0,77.0
0.137,17,2,152,1,76,0.0,48.0,48.0,1,76,0.0,48.0,48.0
40.057,17,10,676,5,460,10013.0,104.0,64.0,5,216,10013.0,20.0,15.0
367.062,6,22,2313,16,867,24470.0,195.0,195.0,6,1446,4638.0,419.0,398.0
0.005,6,10,2006,5,927,1.0,659.0,659.0,5,1079,1.0,811.0,811.0
240.093,6,16,4480,9,963,30011.0,238.0,166.0,7,3517,40014.0,1402.0,786.0
0.001,17,2,180,1,66,0.0,38.0,38.0,1,114,0.0,86.0,86.0
0.005,6,10,2006,5,927,1.0,659.0,659.0,5,1079,1.0,811.0,811.0
0.005,6,10,2000,5,927,1.0,659.0,659.0,5,1073,1.0,805.0,805.0
0.003,17,2,136,1,60,0.0,32.0,32.0,1,76,0.0,48.0,48.0
0.061,6,10,1506,5,395,13.0,127.0,127.0,5,1111,14.0,843.0,843.0
0.005,6,13,3690,7,452,0.0,80.0,80.0,6,3238,1.0,1470.0,1459.0
0.005,6,10,1989,5,927,1.0,659.0,659.0,5,1062,1.0,794.0,794.0
308.701,17,20,1124,10,716,34285.0,48.0,43.0,10,408,34285.0,20.0,12.0
240.089,6,16,4481,9,963,30011.0,238.0,166.0,7,3518,40014.0,1402.0,786.0
0.004,17,2,152,1,76,0.0,48.0,48.0,1,76,0.0,48.0,48.0
168.496,17,74,10442,37,2465,4680.0,44.0,38.0,37,7977,4680.0,261.0,187.0
0.001,17,2,180,1,66,0.0,38.0,38.0,1,114,0.0,86.0,86.0
0.101,6,10,1506,5,395,24.0,127.0,127.0,5,1111,14.0,843.0,843.0
0.001,17,2,166,1,75,0.0,47.0,47.0,1,91,0.0,63.0,63.0
282.562,6,24,10297,14,4130,21735.0,1601.0,678.0,10,6167,7361.0,2111.0,939.0
0.113,6,10,1506,5,395,26.0,127.0,127.0,5,1111,23.0,843.0,843.0
0.069,6,10,1506,5,395,15.0,127.0,127.0,5,1111,14.0,843.0,843.0
0.014,6,10,1989,5,910,3.0,642.0,642.0,5,1079,3.0,811.0,811.0
0.005,17,2,157,1,59,0.0,31.0,31.0,1,98,0.0,70.0,70.0
240.453,6,35,8926,18,2074,14144.0,695.0,226.0,17,6852,15028.0,1402.0,597.0
0.005,17,2,140,1,62,0.0,34.0,34.0,1,78,0.0,50.0,50.0
300.307,6,16,2170,9,684,37517.0,146.0,146.0,7,1486,50023.0,419.0,398.0
0.115,6,10,1506,5,395,27.0,127.0,127.0,5,1111,23.0,843.0,843.0
0.004,6,10,2007,5,928,1.0,660.0,660.0,5,1079,1.0,811.0,811.0
40.066,17,10,676,5,460,10015.0,104.0,64.0,5,216,10015.0,20.0,15.0
0.004,6,10,1702,5,863,1.0,595.0,595.0,5,839,0.0,571.0,571.0
0.024,6,10,1972,5,910,6.0,642.0,642.0,5,1062,5.0,794.0,794.0
0.001,17,2,166,1,75,0.0,47.0,47.0,1,91,0.0,63.0,63.0
0.22,6,16,2777,8,1395,31.0,533.0,323.0,8,1382,19.0,529.0,239.0
0.009,6,12,1926,6,1189,1.0,659.0,434.0,6,737,1.0,417.0,417.0
0.006,17,2,164,1,74,0.0,46.0,46.0,1,90,0.0,62.0,62.0
300.401,6,16,2170,9,684,37529.0,146.0,146.0,7,1486,50038.0,419.0,398.0
0.005,6,14,3742,7,452,0.0,80.0,80.0,7,3290,0.0,1448.0,972.0
0.005,6,10,1989,5,927,1.0,659.0,659.0,5,1062,1.0,794.0,794.0
0.019,6,10,1989,5,910,4.0,642.0,642.0,5,1079,4.0,811.0,811.0
0.007,6,10,1547,5,764,1.0,496.0,496.0,5,783,1.0,515.0,515.0
0.004,6,10,2006,5,927,1.0,659.0,659.0,5,1079,1.0,811.0,811.0
0.122,17,2,80,1,32,0.0,4.0,4.0,1,48,0.0,20.0,20.0
1770.725,6,135,6510,75,3585,23925.0,39.0,39.0,60,2925,30008.0,35.0,35.0
0.015,6,10,1990,5,911,3.0,643.0,643.0,5,1079,3.0,811.0,811.0
0.01,6,10,1983,5,910,2.0,642.0,642.0,5,1073,2.0,805.0,805.0
0.004,17,2,148,1,60,0.0,32.0,32.0,1,88,0.0,60.0,60.0
15.07,17,15,9238,8,6902,2148.0,1350.0,834.0,7,2336,2507.0,1350.0,305.0
240.09,6,16,4480,9,963,30011.0,238.0,166.0,7,3517,40014.0,1402.0,786.0
0.005,6,10,1689,5,839,1.0,571.0,571.0,5,850,1.0,582.0,582.0
0.009,6,10,1762,5,911,2.0,643.0,643.0,5,851,2.0,583.0,583.0
0.013,6,10,1989,5,910,3.0,642.0,642.0,5,1079,3.0,811.0,811.0
0.001,17,2,178,1,81,0.0,53.0,53.0,1,97,0.0,69.0,69.0
0.004,6,10,2006,5,927,1.0,659.0,659.0,5,1079,1.0,811.0,811.0
0.111,6,10,1506,5,395,26.0,127.0,127.0,5,1111,24.0,843.0,843.0
0.006,6,10,1854,5,889,1.0,621.0,621.0,5,965,1.0,697.0,697.0
0.004,6,10,2007,5,928,1.0,660.0,660.0,5,1079,1.0,811.0,811.0
0.004,6,10,1989,5,927,1.0,659.0,659.0,5,1062,1.0,794.0,794.0
40.065,17,10,676,5,460,10014.0,104.0,64.0,5,216,10015.0,20.0,15.0
0.005,17,2,214,1,75,0.0,47.0,47.0,1,139,0.0,111.0,111.0
40.057,17,10,676,5,460,10013.0,104.0,64.0,5,216,10013.0,20.0,15.0
0.021,6,10,1983,5,910,5.0,642.0,642.0,5,1073,5.0,805.0,805.0
0.042,17,4,596,2,122,0.0,33.0,33.0,2,474,3.0,323.0,209.0
0.002,17,2,418,1,72,0.0,44.0,44.0,1,346,0.0,318.0,318.0
0.039,17,4,284,2,120,0.0,32.0,32.0,2,164,35.0,60.0,54.0
169.155,17,72,10158,36,2402,4832.0,44.0,38.0,36,7756,4832.0,239.0,187.0
0.013,6,10,1972,5,910,3.0,642.0,642.0,5,1062,3.0,794.0,794.0
0.005,6,13,3747,7,509,0.0,137.0,137.0,6,3238,0.0,1470.0,1459.0
0.124,6,10,1506,5,395,27.0,127.0,127.0,5,1111,28.0,843.0,843.0
0.005,6,10,1989,5,927,1.0,659.0,659.0,5,1062,1.0,794.0,794.0
0.004,6,10,2006,5,927,1.0,659.0,659.0,5,1079,1.0,811.0,811.0
0.005,6,10,1547,5,764,1.0,496.0,496.0,5,783,1.0,515.0,515.0
0.001,17,2,180,1,66,0.0,38.0,38.0,1,114,0.0,86.0,86.0
0.078,6,10,1506,5,395,17.0,127.0,127.0,5,1111,18.0,843.0,843.0
0.102,6,10,1506,5,395,17.0,127.0,127.0,5,1111,23.0,843.0,843.0
0.004,6,10,1702,5,863,1.0,595.0,595.0,5,839,0.0,571.0,571.0
0.004,6,10,1702,5,863,1.0,595.0,595.0,5,839,0.0,571.0,571.0
0.012,6,10,1989,5,910,3.0,642.0,642.0,5,1079,3.0,811.0,811.0
0.005,6,10,1779,5,928,1.0,660.0,660.0,5,851,1.0,583.0,583.0
0.005,6,10,1689,5,839,1.0,571.0,571.0,5,850,1.0,582.0,582.0
0.001,17,2,136,1,60,0.0,32.0,32.0,1,76,0.0,48.0,48.0
0.006,6,10,2007,5,928,1.0,660.0,660.0,5,1079,1.0,811.0,811.0
0.022,6,10,1972,5,910,5.0,642.0,642.0,5,1062,5.0,794.0,794.0
293.875,6,400,348135,197,21801,1499.0,2736.0,888.0,203,326334,1454.0,2804.0,1670.0
0.016,6,10,1990,5,911,4.0,643.0,643.0,5,1079,4.0,811.0,811.0
0.006,6,10,2000,5,927,1.0,659.0,659.0,5,1073,1.0,805.0,805.0
0.037,17,2,170,1,65,0.0,37.0,37.0,1,105,0.0,77.0,77.0
0.005,6,10,1989,5,927,1.0,659.0,659.0,5,1062,1.0,794.0,794.0
0.017,6,10,1983,5,910,4.0,642.0,642.0,5,1073,4.0,805.0,805.0
0.005,6,10,2006,5,927,1.0,659.0,659.0,5,1079,1.0,811.0,811.0
1764.722,6,471,67706,262,35932,6761.0,613.0,192.0,209,31774,8483.0,453.0,143.0
0.112,6,10,1506,5,395,27.0,127.0,127.0,5,1111,24.0,843.0,843.0
0.02,6,10,1972,5,910,5.0,642.0,642.0,5,1062,5.0,794.0,794.0
0.043,17,2,412,1,61,0.0,33.0,33.0,1,351,0.0,323.0,323.0
0.005,6,10,1989,5,927,1.0,659.0,659.0,5,1062,1.0,794.0,794.0
0.037,17,2,412,1,61,0.0,33.0,33.0,1,351,0.0,323.0,323.0
0.013,6,10,1989,5,910,3.0,642.0,642.0,5,1079,3.0,811.0,811.0
264.425,17,18,1008,9,640,33036.0,48.0,43.0,9,368,33037.0,20.0,12.0
0.011,6,10,1989,5,910,2.0,642.0,642.0,5,1079,2.0,811.0,811.0
0.009,6,10,1972,5,910,2.0,642.0,642.0,5,1062,2.0,794.0,794.0
0.004,6,10,2006,5,927,1.0,659.0,659.0,5,1079,1.0,811.0,811.0
0.004,6,10,2007,5,928,1.0,660.0,660.0,5,1079,1.0,811.0,811.0
0.096,6,10,1506,5,395,22.0,127.0,127.0,5,1111,20.0,843.0,843.0
0.007,17,2,180,1,66,0.0,38.0,38.0,1,114,0.0,86.0,86.0
0.006,17,2,166,1,75,0.0,47.0,47.0,1,91,0.0,63.0,63.0
0.009,6,10,1677,5,827,2.0,559.0,559.0,5,850,2.0,582.0,582.0
240.087,6,16,4480,9,963,30010.0,238.0,166.0,7,3517,40013.0,1402.0,786.0
0.006,6,10,1989,5,927,1.0,659.0,659.0,5,1062,1.0,794.0,794.0
0.005,17,2,240,1,61,0.0,33.0,33.0,1,179,0.0,151.0,151.0
0.177,6,46,11671,25,3305,7.0,1022.0,182.0,21,8366,8.0,1402.0,605.0
0.004,6,10,2006,5,927,1.0,659.0,659.0,5,1079,1.0,811.0,811.0
0.083,6,10,1506,5,395,18.0,127.0,127.0,5,1111,16.0,843.0,843.0
240.632,6,36,8987,19,2137,13366.0,694.0,225.0,17,6850,15037.0,1402.0,597.0
0.013,6,10,1990,5,911,3.0,643.0,643.0,5,1079,3.0,811.0,811.0
0.007,6,10,1774,5,923,1.0,655.0,655.0,5,851,1.0,583.0,583.0
0.005,6,10,2006,5,927,1.0,659.0,659.0,5,1079,1.0,811.0,811.0
0.001,17,2,179,1,62,0.0,34.0,34.0,1,117,0.0,89.0,89.0
0.039,17,4,284,2,120,0.0,32.0,32.0,2,164,35.0,60.0,54.0
0.003,17,2,152,1,76,0.0,48.0,48.0,1,76,0.0,48.0,48.0
0.091,6,10,1506,5,395,19.0,127.0,127.0,5,1111,18.0,843.0,843.0
0.006,6,10,1547,5,764,1.0,496.0,496.0,5,783,1.0,515.0,515.0
0.004,6,10,2007,5,928,1.0,660.0,660.0,5,1079,1.0,811.0,811.0
0.005,6,10,2007,5,928,1.0,660.0,660.0,5,1079,1.0,811.0,811.0
0.013,6,10,1972,5,910,3.0,642.0,642.0,5,1062,3.0,794.0,794.0
0.005,6,14,3736,7,446,0.0,74.0,74.0,7,3290,0.0,1448.0,972.0
335.874,17,20,1124,10,716,37305.0,48.0,43.0,10,408,37304.0,20.0,12.0
0.004,17,2,148,1,60,0.0,32.0,32.0,1,88,0.0,60.0,60.0
0.159,6,10,1506,5,395,37.0,127.0,127.0,5,1111,34.0,843.0,843.0
0.004,6,10,1779,5,928,1.0,660.0,660.0,5,851,1.0,583.0,583.0
0.005,6,10,1989,5,927,1.0,659.0,659.0,5,1062,1.0,794.0,794.0
0.004,17,4,284,2,120,0.0,32.0,32.0,2,164,0.0,60.0,54.0
0.107,6,10,1506,5,395,22.0,127.0,127.0,5,1111,23.0,843.0,843.0
15.071,17,15,9238,8,6902,2149.0,1350.0,834.0,7,2336,2507.0,1350.0,305.0
0.001,17,2,180,1,66,0.0,38.0,38.0,1,114,0.0,86.0,86.0
0.005,6,10,2006,5,927,1.0,659.0,659.0,5,1079,1.0,811.0,811.0
0.009,6,10,1990,5,911,2.0,643.0,643.0,5,1079,2.0,811.0,811.0
40.061,17,10,676,5,460,10014.0,104.0,64.0,5,216,10014.0,20.0,15.0
0.004,17,2,162,1,65,0.0,37.0,37.0,1,97,0.0,69.0,69.0
0.004,17,4,284,2,120,1.0,32.0,32.0,2,164,0.0,60.0,54.0
40.072,17,10,676,5,460,10017.0,104.0,64.0,5,216,10017.0,20.0,15.0
0.088,6,10,1506,5,395,18.0,127.0,127.0,5,1111,20.0,843.0,843.0
0.07,6,10,1506,5,395,14.0,127.0,127.0,5,1111,15.0,843.0,843.0
0.017,6,10,1990,5,911,4.0,643.0,643.0,5,1079,4.0,811.0,811.0
0.113,6,10,1506,5,395,23.0,127.0,127.0,5,1111,22.0,843.0,843.0
0.014,17,2,166,1,75,0.0,47.0,47.0,1,91,0.0,63.0,63.0
11.168,17,28,4421,14,1994,846.0,269.0,114.0,14,2427,846.0,586.0,145.0
0.004,6,10,2007,5,928,1.0,660.0,660.0,5,1079,1.0,811.0,811.0
0.008,17,2,136,1,60,0.0,32.0,32.0,1,76,0.0,48.0,48.0
0.005,6,10,1989,5,927,1.0,659.0,659.0,5,1062,1.0,794.0,794.0
40.064,17,10,676,5,460,10013.0,104.0,64.0,5,216,10014.0,20.0,15.0
0.006,6,10,1547,5,764,1.0,496.0,496.0,5,783,1.0,515.0,515.0
0.007,17,2,170,1,65,0.0,37.0,37.0,1,105,0.0,77.0,77.0
0.006,17,2,179,1,71,0.0,43.0,43.0,1,108,0.0,80.0,80.0
0.119,6,10,1506,5,395,26.0,127.0,127.0,5,1111,26.0,843.0,843.0
308.587,17,18,1008,9,640,38558.0,48.0,43.0,9,368,38558.0,20.0,12.0
0.01,6,10,1990,5,911,2.0,643.0,643.0,5,1079,2.0,811.0,811.0
0.04,17,2,166,1,75,0.0,47.0,47.0,1,91,0.0,63.0,63.0
0.005,6,10,2006,5,927,1.0,659.0,659.0,5,1079,1.0,811.0,811.0
0.004,17,4,284,2,120,0.0,32.0,32.0,2,164,0.0,60.0,54.0
0.125,6,10,1506,5,395,27.0,127.0,127.0,5,1111,29.0,843.0,843.0
0.004,6,10,2006,5,927,1.0,659.0,659.0,5,1079,1.0,811.0,811.0
0.009,6,10,1983,5,910,2.0,642.0,642.0,5,1073,2.0,805.0,805.0
0.018,6,10,1983,5,910,4.0,642.0,642.0,5,1073,4.0,805.0,805.0
0.087,6,10,1506,5,395,19.0,127.0,127.0,5,1111,18.0,843.0,843.0
0.105,6,10,1506,5,395,21.0,127.0,127.0,5,1111,23.0,843.0,843.0
331.893,17,20,1124,10,716,36863.0,48.0,43.0,10,408,36863.0,20.0,12.0
300.342,6,16,2170,9,684,37521.0,146.0,146.0,7,1486,50028.0,419.0,398.0
0.006,6,10,2007,5,928,1.0,660.0,660.0,5,1079,1.0,811.0,811.0
240.338,6,26,4537,13,1880,20025.0,559.0,239.0,13,2657,20025.0,1611.0,283.0
0.011,6,10,1983,5,910,2.0,642.0,642.0,5,1073,2.0,805.0,805.0
0.005,6,10,1989,5,927,1.0,659.0,659.0,5,1062,1.0,794.0,794.0
0.006,6,10,1643,5,860,1.0,592.0,592.0,5,783,1.0,515.0,515.0
0.001,17,2,180,1,66,0.0,38.0,38.0,1,114,0.0,86.0,86.0
0.005,6,14,3736,7,446,0.0,74.0,74.0,7,3290,0.0,1448.0,972.0
0.005,6,10,1643,5,860,1.0,592.0,592.0,5,783,1.0,515.0,515.0
0.011,6,10,1989,5,910,2.0,642.0,642.0,5,1079,2.0,811.0,811.0
0.068,6,10,1506,5,395,14.0,127.0,127.0,5,1111,14.0,843.0,843.0
0.006,6,10,2006,5,927,1.0,659.0,659.0,5,1079,1.0,811.0,811.0
0.004,6,10,1989,5,927,1.0,659.0,659.0,5,1062,1.0,794.0,794.0
0.006,6,10,1547,5,764,1.0,496.0,496.0,5,783,1.0,515.0,515.0
0.14,6,10,1506,5,395,29.0,127.0,127.0,5,1111,30.0,843.0,843.0
0.001,17,2,180,1,66,0.0,38.0,38.0,1,114,0.0,86.0,86.0
0.013,6,10,1983,5,910,3.0,642.0,642.0,5,1073,3.0,805.0,805.0
240.244,6,36,10524,18,2215,14131.0,559.0,254.0,18,8309,14131.0,1402.0,614.0
0.015,6,10,1983,5,910,3.0,642.0,642.0,5,1073,3.0,805.0,805.0
0.005,17,2,169,1,62,0.0,34.0,34.0,1,107,0.0,79.0,79.0
0.005,6,10,1989,5,927,1.0,659.0,659.0,5,1062,1.0,794.0,794.0
0.006,6,10,1547,5,764,1.0,496.0,496.0,5,783,1.0,515.0,515.0
15.08,17,15,8019,8,5991,2150.0,1350.0,720.0,7,2028,2508.0,1350.0,261.0
0.004,6,10,2000,5,927,1.0,659.0,659.0,5,1073,1.0,805.0,805.0
1729.227,6,60,4400,40,2740,44339.0,33.0,33.0,20,1660,91002.0,31.0,31.0
0.017,6,10,1989,5,910,4.0,642.0,642.0,5,1079,4.0,811.0,811.0
0.107,6,10,1506,5,395,24.0,127.0,127.0,5,1111,25.0,843.0,843.0
0.001,17,2,180,1,66,0.0,38.0,38.0,1,114,0.0,86.0,86.0
0.016,6,10,1983,5,910,3.0,642.0,642.0,5,1073,3.0,805.0,805.0
0.012,6,10,1972,5,910,3.0,642.0,642.0,5,1062,3.0,794.0,794.0
0.082,6,10,1506,5,395,18.0,127.0,127.0,5,1111,15.0,843.0,843.0
0.019,6,10,1631,5,848,4.0,580.0,580.0,5,783,4.0,515.0,515.0
0.005,6,10,2006,5,927,1.0,659.0,659.0,5,1079,1.0,811.0,811.0
0.016,6,10,1989,5,910,4.0,642.0,642.0,5,1079,3.0,811.0,811.0
15.076,17,15,9239,8,6902,2149.0,1350.0,834.0,7,2337,2507.0,1350.0,305.0
0.015,6,10,1677,5,827,3.0,559.0,559.0,5,850,3.0,582.0,582.0
0.006,6,10,1854,5,889,1.0,621.0,621.0,5,965,1.0,697.0,697.0
0.069,17,8,3613,4,1874,23.0,1350.0,440.0,4,1739,11.0,1350.0,406.0
300.321,6,16,2170,9,684,37519.0,146.0,146.0,7,1486,50026.0,419.0,398.0
0.072,6,10,1506,5,395,15.0,127.0,127.0,5,1111,16.0,843.0,843.0
0.098,6,10,1506,5,395,22.0,127.0,127.0,5,1111,21.0,843.0,843.0
0.006,6,10,1547,5,764,1.0,496.0,496.0,5,783,1.0,515.0,515.0
0.005,17,2,164,1,74,0.0,46.0,46.0,1,90,0.0,62.0,62.0
0.005,6,10,1989,5,927,1.0,659.0,659.0,5,1062,1.0,794.0,794.0
0.014,6,10,1762,5,911,3.0,643.0,643.0,5,851,3.0,583.0,583.0
0.109,6,10,1506,5,395,25.0,127.0,127.0,5,1111,25.0,843.0,843.0
0.007,6,10,1547,5,764,1.0,496.0,496.0,5,783,1.0,515.0,515.0
0.169,6,10,1506,5,395,38.0,127.0,127.0,5,1111,37.0,843.0,843.0
1730.385,6,45,2790,30,1725,59668.0,35.0,35.0,15,1065,123593.0,31.0,31.0
15.069,17,15,9238,8,6902,2148.0,1350.0,834.0,7,2336,2506.0,1350.0,305.0
0.005,6,10,1989,5,927,1.0,659.0,659.0,5,1062,1.0,794.0,794.0
0.005,6,10,2007,5,928,1.0,660.0,660.0,5,1079,1.0,811.0,811.0
0.139,6,10,1506,5,395,30.0,127.0,127.0,5,1111,29.0,843.0,843.0
0.014,6,10,1631,5,848,3.0,580.0,580.0,5,783,3.0,515.0,515.0
0.005,6,10,1774,5,923,1.0,655.0,655.0,5,851,1.0,583.0,583.0
0.008,17,2,194,1,59,0.0,31.0,31.0,1,135,0.0,107.0,107.0
15.579,17,21,8766,11,6563,1554.0,1350.0,568.0,10,2203,1726.0,1350.0,192.0
0.075,6,10,1506,5,395,16.0,127.0,127.0,5,1111,13.0,843.0,843.0
0.072,6,10,1506,5,395,14.0,127.0,127.0,5,1111,17.0,843.0,843.0
0.005,6,10,1989,5,927,1.0,659.0,659.0,5,1062,1.0,794.0,794.0
0.247,6,16,2778,8,1396,35.0,533.0,324.0,8,1382,23.0,529.0,239.0
0.005,6,10,2000,5,927,1.0,659.0,659.0,5,1073,1.0,805.0,805.0
0.009,6,10,1989,5,910,2.0,642.0,642.0,5,1079,2.0,811.0,811.0
0.006,6,10,1854,5,889,1.0,621.0,621.0,5,965,1.0,697.0,697.0
10.884,17,28,4423,14,1995,828.0,270.0,114.0,14,2428,828.0,587.0,145.0
0.072,17,4,420,2,122,0.0,33.0,33.0,2,298,68.0,145.0,121.0
0.102,6,10,1506,5,395,24.0,127.0,127.0,5,1111,21.0,843.0,843.0
0.041,17,2,170,1,65,0.0,37.0,37.0,1,105,0.0,77.0,77.0
240.086,6,16,4480,9,963,30010.0,238.0,166.0,7,3517,40013.0,1402.0,786.0
0.006,17,2,164,1,74,0.0,46.0,46.0,1,90,0.0,62.0,62.0
0.04,17,2,148,1,60,0.0,32.0,32.0,1,88,0.0,60.0,60.0
0.014,6,10,1983,5,910,3.0,642.0,642.0,5,1073,3.0,805.0,805.0
0.01,6,10,1989,5,910,2.0,642.0,642.0,5,1079,2.0,811.0,811.0
0.001,17,2,142,1,63,0.0,35.0,35.0,1,79,0.0,51.0,51.0
0.006,6,10,1854,5,889,1.0,621.0,621.0,5,965,1.0,697.0,697.0
10.778,17,28,4417,14,1993,820.0,268.0,114.0,14,2424,820.0,587.0,145.0
40.061,17,10,676,5,460,10012.0,104.0,64.0,5,216,10014.0,20.0,15.0
0.005,17,2,164,1,74,0.0,46.0,46.0,1,90,0.0,62.0,62.0
0.005,6,10,2000,5,927,1.0,659.0,659.0,5,1073,1.0,805.0,805.0
0.004,6,10,2000,5,927,1.0,659.0,659.0,5,1073,1.0,805.0,805.0
0.005,17,2,179,1,71,0.0,43.0,43.0,1,108,0.0,80.0,80.0
0.011,6,10,1762,5,911,2.0,643.0,643.0,5,851,2.0,583.0,583.0
0.005,17,2,170,1,65,0.0,37.0,37.0,1,105,0.0,77.0,77.0
0.004,17,2,136,1,60,0.0,32.0,32.0,1,76,0.0,48.0,48.0
0.116,6,10,1506,5,395,26.0,127.0,127.0,5,1111,25.0,843.0,843.0
0.005,17,2,136,1,60,0.0,32.0,32.0,1,76,0.0,48.0,48.0
40.076,17,10,676,5,460,10018.0,104.0,64.0,5,216,10018.0,20.0,15.0
0.005,6,10,1643,5,860,1.0,592.0,592.0,5,783,1.0,515.0,515.0
0.09,6,10,1506,5,395,19.0,127.0,127.0,5,1111,18.0,843.0,843.0
11.187,17,28,4423,14,1995,848.0,270.0,114.0,14,2428,848.0,587.0,145.0
0.006,6,10,1689,5,839,1.0,571.0,571.0,5,850,1.0,582.0,582.0
240.443,6,41,5498,20,2706,12653.0,588.0,207.0,21,2792,12019.0,580.0,210.0
351.988,6,20,2210,6,1308,12003.0,494.0,494.0,14,902,27075.0,83.0,83.0
0.004,6,10,1989,5,927,1.0,659.0,659.0,5,1062,1.0,794.0,794.0
0.279,17,40,20509,22,17087,13.0,1350.0,748.0,18,3422,12.0,1350.0,162.0
0.001,17,2,180,1,66,0.0,38.0,38.0,1,114,0.0,86.0,86.0
0.02,6,10,1972,5,910,5.0,642.0,642.0,5,1062,4.0,794.0,794.0
360.036,6,21,3981,13,3142,30003.0,494.0,494.0,8,839,51433.0,83.0,83.0
0.011,6,10,1972,5,910,2.0,642.0,642.0,5,1062,2.0,794.0,794.0
0.004,6,10,1989,5,927,1.0,659.0,659.0,5,1062,1.0,794.0,794.0
0.012,6,13,3735,7,497,2.0,125.0,125.0,6,3238,2.0,1470.0,1459.0
0.012,6,10,1989,5,910,3.0,642.0,642.0,5,1079,3.0,811.0,811.0
0.067,6,10,1506,5,395,16.0,127.0,127.0,5,1111,13.0,843.0,843.0
0.042,17,4,284,2,120,0.0,32.0,32.0,2,164,32.0,60.0,54.0
0.013,6,10,1990,5,911,3.0,643.0,643.0,5,1079,3.0,811.0,811.0
0.014,6,10,1762,5,911,3.0,643.0,643.0,5,851,3.0,583.0,583.0
0.014,6,10,1983,5,910,3.0,642.0,642.0,5,1073,3.0,805.0,805.0
0.008,17,2,194,1,59,0.0,31.0,31.0,1,135,0.0,107.0,107.0
0.004,6,10,2006,5,927,1.0,659.0,659.0,5,1079,1.0,811.0,811.0
0.011,6,13,3747,7,509,1.0,137.0,137.0,6,3238,2.0,1470.0,1459.0
40.066,17,10,676,5,460,10015.0,104.0,64.0,5,216,10015.0,20.0,15.0
0.015,6,10,1972,5,910,3.0,642.0,642.0,5,1062,3.0,794.0,794.0
0.004,6,10,1702,5,863,0.0,595.0,595.0,5,839,1.0,571.0,571.0
0.003,17,2,148,1,60,0.0,32.0,32.0,1,88,0.0,60.0,60.0
40.085,17,10,676,5,460,10020.0,104.0,64.0,5,216,10020.0,20.0,15.0
0.004,6,10,2007,5,928,1.0,660.0,660.0,5,1079,1.0,811.0,811.0
0.001,17,2,180,1,66,0.0,38.0,38.0,1,114,0.0,86.0,86.0
0.005,6,10,1989,5,927,1.0,659.0,659.0,5,1062,1.0,794.0,794.0
0.079,6,10,1506,5,395,16.0,127.0,127.0,5,1111,18.0,843.0,843.0
0.011,6,10,1972,5,910,2.0,642.0,642.0,5,1062,2.0,794.0,794.0
0.098,6,10,1506,5,395,18.0,127.0,127.0,5,1111,23.0,843.0,843.0
0.001,17,2,142,1,63,0.0,35.0,35.0,1,79,0.0,51.0,51.0
0.005,6,10,1989,5,927,1.0,659.0,659.0,5,1062,1.0,794.0,794.0
0.004,6,10,1774,5,923,1.0,655.0,655.0,5,851,1.0,583.0,583.0
240.013,6,9,787,5,488,60003.0,232.0,232.0,4,299,80003.0,83.0,83.0
0.01,6,10,1983,5,910,2.0,642.0,642.0,5,1073,2.0,805.0,805.0
0.004,6,10,1779,5,928,1.0,660.0,660.0,5,851,1.0,583.0,583.0
11.09,17,28,4422,14,1994,840.0,269.0,114.0,14,2428,840.0,587.0,145.0
0.075,6,10,1506,5,395,17.0,127.0,127.0,5,1111,17.0,843.0,843.0
0.005,6,10,2007,5,928,1.0,660.0,660.0,5,1079,1.0,811.0,811.0
0.005,6,10,2007,5,928,1.0,660.0,660.0,5,1079,1.0,811.0,811.0
0.007,17,2,299,1,65,0.0,37.0,37.0,1,234,0.0,206.0,206.0
0.004,17,2,136,1,60,0.0,32.0,32.0,1,76,0.0,48.0,48.0
308.968,17,20,1124,10,716,34316.0,48.0,43.0,10,408,34318.0,20.0,12.0
1770.554,6,84,4495,42,2238,43183.0,27.0,27.0,42,2257,43183.0,26.0,24.0
0.01,6,10,1989,5,910,2.0,642.0,642.0,5,1079,2.0,811.0,811.0
242.639,6,377,347722,193,21562,1263.0,2736.0,959.0,184,326160,1325.0,2804.0,1819.0
0.005,6,10,2007,5,928,1.0,660.0,660.0,5,1079,1.0,811.0,811.0
0.17,17,2,152,1,76,0.0,48.0,48.0,1,76,0.0,48.0,48.0
0.033,6,10,1989,5,910,8.0,642.0,642.0,5,1079,8.0,811.0,811.0
703.103,17,160,23400,80,5386,8900.0,44.0,39.0,80,18014,8900.0,239.0,197.0
0.009,6,10,1972,5,910,2.0,642.0,642.0,5,1062,2.0,794.0,794.0
0.078,6,10,1506,5,395,17.0,127.0,127.0,5,1111,17.0,843.0,843.0
292.218,6,384,348016,199,21915,1475.0,2736.0,889.0,185,326101,1588.0,4136.0,1850.0
0.008,6,10,1972,5,910,2.0,642.0,642.0,5,1062,1.0,794.0,794.0
40.055,17,10,676,5,460,10013.0,104.0,64.0,5,216,10013.0,20.0,15.0
0.04,17,2,148,1,60,0.0,32.0,32.0,1,88,0.0,60.0,60.0
0.016,6,10,1972,5,910,3.0,642.0,642.0,5,1062,4.0,794.0,794.0
0.012,6,10,1990,5,911,3.0,643.0,643.0,5,1079,3.0,811.0,811.0
0.005,17,2,169,1,62,0.0,34.0,34.0,1,107,0.0,79.0,79.0
0.004,6,10,2006,5,927,1.0,659.0,659.0,5,1079,1.0,811.0,811.0
0.015,6,10,1990,5,911,3.0,643.0,643.0,5,1079,3.0,811.0,811.0
0.004,6,10,1779,5,928,1.0,660.0,660.0,5,851,1.0,583.0,583.0
0.104,6,10,1506,5,395,24.0,127.0,127.0,5,1111,25.0,843.0,843.0
0.023,6,10,1989,5,910,5.0,642.0,642.0,5,1079,5.0,811.0,811.0
0.013,6,10,1972,5,910,3.0,642.0,642.0,5,1062,3.0,794.0,794.0
0.005,6,10,2006,5,927,1.0,659.0,659.0,5,1079,1.0,811.0,811.0
0.072,17,2,156,1,64,0.0,36.0,36.0,1,92,0.0,64.0,64.0
0.013,6,13,3735,7,497,2.0,125.0,125.0,6,3238,2.0,1470.0,1459.0
0.001,17,2,194,1,57,0.0,29.0,29.0,1,137,0.0,109.0,109.0
0.006,6,10,1547,5,764,1.0,496.0,496.0,5,783,1.0,515.0,515.0
0.005,6,10,2007,5,928,1.0,660.0,660.0,5,1079,1.0,811.0,811.0
0.104,6,10,1506,5,395,23.0,127.0,127.0,5,1111,21.0,843.0,843.0
0.004,6,10,2006,5,927,1.0,659.0,659.0,5,1079,1.0,811.0,811.0
0.019,6,10,1972,5,910,4.0,642.0,642.0,5,1062,4.0,794.0,794.0
0.008,6,10,1677,5,827,1.0,559.0,559.0,5,850,2.0,582.0,582.0
0.006,6,10,1547,5,764,1.0,496.0,496.0,5,783,1.0,515.0,515.0
255.054,6,19,4638,9,963,31881.0,238.0,166.0,10,3675,28339.0,1402.0,786.0
0.001,17,2,180,1,66,0.0,38.0,38.0,1,114,0.0,86.0,86.0
0.281,17,41,20317,21,17028,14.0,1350.0,782.0,20,3289,12.0,1350.0,136.0
0.009,6,10,1972,5,910,2.0,642.0,642.0,5,1062,2.0,794.0,794.0
177.065,17,76,11143,38,2555,4785.0,44.0,39.0,38,8588,4785.0,261.0,198.0
0.005,6,10,2007,5,928,1.0,660.0,660.0,5,1079,1.0,811.0,811.0
0.004,6,10,2006,5,927,1.0,659.0,659.0,5,1079,1.0,811.0,811.0
0.006,17,2,230,1,68,0.0,40.0,40.0,1,162,0.0,134.0,134.0
0.018,6,14,3787,7,497,3.0,125.0,125.0,7,3290,3.0,1448.0,972.0
15.071,17,15,9238,8,6902,2148.0,1350.0,834.0,7,2336,2506.0,1350.0,305.0
0.011,6,10,1972,5,910,2.0,642.0,642.0,5,1062,2.0,794.0,794.0
0.12,6,10,1506,5,395,27.0,127.0,127.0,5,1111,23.0,843.0,843.0
0.017,6,10,1702,5,863,4.0,595.0,595.0,5,839,4.0,571.0,571.0
0.012,6,10,1989,5,910,3.0,642.0,642.0,5,1079,2.0,811.0,811.0
0.005,6,10,2006,5,927,1.0,659.0,659.0,5,1079,1.0,811.0,811.0
0.335,17,53,34487,30,28501,11.0,1350.0,922.0,23,5986,12.0,1350.0,232.0
0.004,6,10,1989,5,927,1.0,659.0,659.0,5,1062,1.0,794.0,794.0
0.005,6,10,1989,5,927,1.0,659.0,659.0,5,1062,1.0,794.0,794.0
0.086,6,10,1506,5,395,19.0,127.0,127.0,5,1111,20.0,843.0,843.0
0.005,6,10,1989,5,927,1.0,659.0,659.0,5,1062,1.0,794.0,794.0
10.944,17,28,4419,14,1995,833.0,270.0,114.0,14,2424,832.0,587.0,145.0
0.028,6,14,3868,7,578,4.0,206.0,206.0,7,3290,4.0,1448.0,972.0
0.01,6,10,1983,5,910,2.0,642.0,642.0,5,1073,2.0,805.0,805.0
0.006,6,10,1547,5,764,1.0,496.0,496.0,5,783,1.0,515.0,515.0
0.004,17,2,148,1,60,0.0,32.0,32.0,1,88,0.0,60.0,60.0
0.005,6,10,1779,5,928,1.0,660.0,660.0,5,851,1.0,583.0,583.0
0.009,6,10,1990,5,911,2.0,643.0,643.0,5,1079,2.0,811.0,811.0
40.067,17,10,676,5,460,10015.0,104.0,64.0,5,216,10015.0,20.0,15.0
0.007,6,10,1983,5,910,1.0,642.0,642.0,5,1073,1.0,805.0,805.0
0.011,6,10,1989,5,910,2.0,642.0,642.0,5,1079,2.0,811.0,811.0
10.764,17,28,4423,14,1994,819.0,269.0,114.0,14,2429,819.0,588.0,145.0
0.753,6,11,3130,6,1415,101.0,1163.0,1163.0,5,1715,126.0,1503.0,1503.0
0.008,6,10,2006,5,927,2.0,659.0,659.0,5,1079,1.0,811.0,811.0
0.004,6,14,3742,7,452,0.0,80.0,80.0,7,3290,0.0,1448.0,972.0
40.08,17,10,676,5,460,10016.0,104.0,64.0,5,216,10019.0,20.0,15.0
0.001,17,2,180,1,66,0.0,38.0,38.0,1,114,0.0,86.0,86.0
10.749,17,28,4423,14,1995,818.0,270.0,114.0,14,2428,818.0,587.0,145.0
0.006,6,10,2007,5,928,1.0,660.0,660.0,5,1079,1.0,811.0,811.0
290.725,6,410,349501,199,21906,1468.0,2736.0,888.0,211,327595,1384.0,2804.0,1607.0
0.004,6,10,1989,5,927,1.0,659.0,659.0,5,1062,1.0,794.0,794.0
0.082,6,10,1506,5,395,18.0,127.0,127.0,5,1111,18.0,843.0,843.0
0.015,6,10,1990,5,911,3.0,643.0,643.0,5,1079,3.0,811.0,811.0
0.003,17,4,284,2,120,0.0,32.0,32.0,2,164,0.0,60.0,54.0
0.005,6,10,2007,5,928,1.0,660.0,660.0,5,1079,1.0,811.0,811.0
0.004,6,10,2006,5,927,1.0,659.0,659.0,5,1079,1.0,811.0,811.0
0.005,6,10,2007,5,928,1.0,660.0,660.0,5,1079,1.0,811.0,811.0
0.093,6,10,1506,5,395,21.0,127.0,127.0,5,1111,22.0,843.0,843.0
0.116,6,10,1506,5,395,22.0,127.0,127.0,5,1111,23.0,843.0,843.0
0.005,6,10,2006,5,927,1.0,659.0,659.0,5,1079,1.0,811.0,811.0
40.059,17,10,676,5,460,10013.0,104.0,64.0,5,216,10014.0,20.0,15.0
0.005,6,10,2006,5,927,1.0,659.0,659.0,5,1079,1.0,811.0,811.0
0.01,6,10,1689,5,839,2.0,571.0,571.0,5,850,2.0,582.0,582.0
0.005,6,10,2007,5,928,1.0,660.0,660.0,5,1079,1.0,811.0,811.0
0.009,6,10,1972,5,910,2.0,642.0,642.0,5,1062,2.0,794.0,794.0
0.018,6,10,1989,5,910,4.0,642.0,642.0,5,1079,4.0,811.0,811.0
0.014,6,10,1689,5,839,3.0,571.0,571.0,5,850,3.0,582.0,582.0
0.005,6,10,1854,5,889,1.0,621.0,621.0,5,965,1.0,697.0,697.0
1778.114,17,144,45504,72,22752,25043.0,288.0,288.0,72,22752,25043.0,288.0,288.0
0.005,6,10,1547,5,764,1.0,496.0,496.0,5,783,1.0,515.0,515.0
40.061,17,10,676,5,460,10012.0,104.0,64.0,5,216,10014.0,20.0,15.0
0.013,6,10,1677,5,827,3.0,559.0,559.0,5,850,3.0,582.0,582.0
0.003,17,2,136,1,60,0.0,32.0,32.0,1,76,0.0,48.0,48.0
240.096,6,16,4481,9,963,30012.0,238.0,166.0,7,3518,40015.0,1402.0,786.0
0.005,17,2,170,1,65,0.0,37.0,37.0,1,105,0.0,77.0,77.0
0.008,6,10,1989,5,910,2.0,642.0,642.0,5,1079,2.0,811.0,811.0
0.01,6,10,1983,5,910,2.0,642.0,642.0,5,1073,2.0,805.0,805.0
0.005,6,10,1989,5,927,1.0,659.0,659.0,5,1062,1.0,794.0,794.0
0.006,6,10,1547,5,764,1.0,496.0,496.0,5,783,1.0,515.0,515.0
0.001,17,2,180,1,66,0.0,38.0,38.0,1,114,0.0,86.0,86.0
0.107,6,10,1506,5,395,25.0,127.0,127.0,5,1111,24.0,843.0,843.0
0.011,6,10,1990,5,911,2.0,643.0,643.0,5,1079,2.0,811.0,811.0
0.004,6,10,2000,5,927,1.0,659.0,659.0,5,1073,1.0,805.0,805.0
0.006,6,10,1547,5,764,1.0,496.0,496.0,5,783,1.0,515.0,515.0
0.003,17,2,136,1,60,0.0,32.0,32.0,1,76,0.0,48.0,48.0
40.05,17,10,676,5,460,10011.0,104.0,64.0,5,216,10011.0,20.0,15.0
0.004,6,10,2007,5,928,1.0,660.0,660.0,5,1079,1.0,811.0,811.0
0.095,6,10,1506,5,395,20.0,127.0,127.0,5,1111,21.0,843.0,843.0
0.033,6,10,1762,5,911,8.0,643.0,643.0,5,851,8.0,583.0,583.0
0.001,17,2,179,1,62,0.0,34.0,34.0,1,117,0.0,89.0,89.0
0.006,6,10,1854,5,889,1.0,621.0,621.0,5,965,1.0,697.0,697.0
0.003,17,2,148,1,60,0.0,32.0,32.0,1,88,0.0,60.0,60.0
0.085,6,10,1506,5,395,18.0,127.0,127.0,5,1111,20.0,843.0,843.0
374.73,6,21,1795,16,1030,24982.0,190.0,190.0,5,765,60022.0,464.0,248.0
240.023,6,9,787,5,488,60005.0,232.0,232.0,4,299,80006.0,83.0,83.0
0.003,17,2,136,1,60,0.0,32.0,32.0,1,76,0.0,48.0,48.0
0.061,6,10,1506,5,395,13.0,127.0,127.0,5,1111,14.0,843.0,843.0
0.066,17,8,3613,4,1874,22.0,1350.0,440.0,4,1739,11.0,1350.0,406.0
0.098,6,10,1506,5,395,21.0,127.0,127.0,5,1111,22.0,843.0,843.0
0.005,6,10,2000,5,927,1.0,659.0,659.0,5,1073,1.0,805.0,805.0
0.233,6,10,1506,5,395,38.0,127.0,127.0,5,1111,55.0,843.0,843.0
0.012,17,2,148,1,60,0.0,32.0,32.0,1,88,0.0,60.0,60.0
0.004,17,2,136,1,60,0.0,32.0,32.0,1,76,0.0,48.0,48.0
0.004,17,4,284,2,120,0.0,32.0,32.0,2,164,1.0,60.0,54.0
0.005,6,10,1989,5,927,1.0,659.0,659.0,5,1062,1.0,794.0,794.0
0.006,6,10,1547,5,764,1.0,496.0,496.0,5,783,1.0,515.0,515.0
0.12,6,10,1506,5,395,27.0,127.0,127.0,5,1111,26.0,843.0,843.0
0.705,6,22,5072,11,1250,60.0,325.0,133.0,11,3822,59.0,1414.0,563.0
0.005,6,10,1989,5,927,1.0,659.0,659.0,5,1062,1.0,794.0,794.0
40.066,17,10,676,5,460,10013.0,104.0,64.0,5,216,10015.0,20.0,15.0
0.016,6,13,3735,7,497,2.0,125.0,125.0,6,3238,3.0,1470.0,1459.0
290.014,6,395,347582,199,21920,1464.0,2736.0,889.0,196,325662,1487.0,2804.0,1733.0
0.013,17,2,170,1,65,0.0,37.0,37.0,1,105,0.0,77.0,77.0
0.005,6,10,1689,5,839,1.0,571.0,571.0,5,850,1.0,582.0,582.0
0.019,6,10,1972,5,910,4.0,642.0,642.0,5,1062,4.0,794.0,794.0
0.004,17,2,148,1,60,0.0,32.0,32.0,1,88,0.0,60.0,60.0
0.006,6,10,1547,5,764,1.0,496.0,496.0,5,783,1.0,515.0,515.0
0.009,6,10,1774,5,923,2.0,655.0,655.0,5,851,2.0,583.0,583.0
102.984,6,26,9525,12,1627,75.0,794.0,367.0,14,7898,7911.0,1360.0,732.0
0.087,6,10,1506,5,395,20.0,127.0,127.0,5,1111,16.0,843.0,843.0
0.005,6,13,3747,7,509,0.0,137.0,137.0,6,3238,0.0,1470.0,1459.0
0.012,6,10,1989,5,910,2.0,642.0,642.0,5,1079,3.0,811.0,811.0
0.005,6,10,1774,5,923,1.0,655.0,655.0,5,851,1.0,583.0,583.0
0.013,6,10,1990,5,911,3.0,643.0,643.0,5,1079,3.0,811.0,811.0
0.001,17,2,180,1,66,0.0,38.0,38.0,1,114,0.0,86.0,86.0
0.075,6,10,1506,5,395,16.0,127.0,127.0,5,1111,17.0,843.0,843.0
0.068,6,10,1506,5,395,15.0,127.0,127.0,5,1111,15.0,843.0,843.0
0.113,6,10,1506,5,395,26.0,127.0,127.0,5,1111,25.0,843.0,843.0
0.007,17,2,132,1,58,0.0,30.0,30.0,1,74,0.0,46.0,46.0
0.045,6,10,1702,5,863,11.0,595.0,595.0,5,839,11.0,571.0,571.0
0.0,17,2,154,1,69,0.0,41.0,41.0,1,85,0.0,57.0,57.0
0.005,17,2,212,1,74,0.0,46.0,46.0,1,138,0.0,110.0,110.0
0.005,6,10,1689,5,839,1.0,571.0,571.0,5,850,1.0,582.0,582.0
0.015,6,10,1989,5,910,3.0,642.0,642.0,5,1079,3.0,811.0,811.0
0.003,17,2,148,1,60,0.0,32.0,32.0,1,88,0.0,60.0,60.0
0.005,6,10,2006,5,927,1.0,659.0,659.0,5,1079,1.0,811.0,811.0
0.075,6,10,1506,5,395,16.0,127.0,127.0,5,1111,16.0,843.0,843.0
0.042,17,4,352,2,130,2.0,37.0,37.0,2,222,4.0,89.0,83.0
0.101,6,10,1506,5,395,23.0,127.0,127.0,5,1111,22.0,843.0,843.0
0.009,6,10,1989,5,910,2.0,642.0,642.0,5,1079,2.0,811.0,811.0
0.011,6,10,1972,5,910,2.0,642.0,642.0,5,1062,2.0,794.0,794.0
0.01,6,10,1972,5,910,2.0,642.0,642.0,5,1062,2.0,794.0,794.0
0.005,6,10,2007,5,928,1.0,660.0,660.0,5,1079,1.0,811.0,811.0
240.708,6,34,8873,18,2073,14157.0,694.0,225.0,16,6800,16045.0,2804.0,663.0
0.004,17,4,284,2,120,0.0,32.0,32.0,2,164,1.0,60.0,54.0
0.009,6,13,3735,7,497,1.0,125.0,125.0,6,3238,1.0,1470.0,1459.0
0.007,6,10,1689,5,839,1.0,571.0,571.0,5,850,1.0,582.0,582.0
0.004,17,2,170,1,65,0.0,37.0,37.0,1,105,0.0,77.0,77.0
318.465,6,31,10498,17,2710,19904.0,676.0,363.0,14,7788,19878.0,1402.0,881.0
0.054,6,10,1506,5,395,13.0,127.0,127.0,5,1111,12.0,843.0,843.0
1799.837,6,244,35804,152,26032,11919.0,302.0,302.0,92,9772,19778.0,83.0,83.0
0.007,6,10,1989,5,910,1.0,642.0,642.0,5,1079,1.0,811.0,811.0
40.057,17,10,676,5,460,10013.0,104.0,64.0,5,216,10013.0,20.0,15.0
0.005,6,10,2006,5,927,1.0,659.0,659.0,5,1079,1.0,811.0,811.0
0.014,17,2,140,1,62,0.0,34.0,34.0,1,78,0.0,50.0,50.0
0.127,17,2,184,1,61,0.0,33.0,33.0,1,123,0.0,95.0,95.0
0.067,17,8,3613,4,1874,22.0,1350.0,440.0,4,1739,11.0,1350.0,406.0
0.006,17,2,166,1,75,0.0,47.0,47.0,1,91,0.0,63.0,63.0
49.638,6,388,348442,197,21828,253.0,2736.0,888.0,191,326614,261.0,2804.0,1779.0
0.016,6,10,1989,5,910,4.0,642.0,642.0,5,1079,3.0,811.0,811.0
0.004,17,2,214,1,75,0.0,47.0,47.0,1,139,0.0,111.0,111.0
0.006,6,10,1989,5,927,1.0,659.0,659.0,5,1062,1.0,794.0,794.0
0.013,6,10,1989,5,910,3.0,642.0,642.0,5,1079,3.0,811.0,811.0
0.018,6,10,1762,5,911,4.0,643.0,643.0,5,851,4.0,583.0,583.0
0.008,6,10,1990,5,911,2.0,643.0,643.0,5,1079,2.0,811.0,811.0
15.073,17,15,9239,8,6902,2149.0,1350.0,834.0,7,2337,2507.0,1350.0,305.0
0.006,6,10,1547,5,764,1.0,496.0,496.0,5,783,1.0,515.0,515.0
0.005,6,10,2007,5,928,1.0,660.0,660.0,5,1079,1.0,811.0,811.0
0.111,6,10,1506,5,395,25.0,127.0,127.0,5,1111,26.0,843.0,843.0
372.328,6,22,2313,16,867,24821.0,195.0,195.0,6,1446,4710.0,419.0,398.0
0.004,17,2,148,1,60,0.0,32.0,32.0,1,88,0.0,60.0,60.0
0.005,6,10,2006,5,927,1.0,659.0,659.0,5,1079,1.0,811.0,811.0
0.003,17,2,148,1,60,0.0,32.0,32.0,1,88,0.0,60.0,60.0
0.005,6,10,2000,5,927,1.0,659.0,659.0,5,1073,1.0,805.0,805.0
0.012,6,10,1972,5,910,3.0,642.0,642.0,5,1062,2.0,794.0,794.0
0.005,6,10,2006,5,927,1.0,659.0,659.0,5,1079,1.0,811.0,811.0
0.005,17,2,169,1,62,0.0,34.0,34.0,1,107,0.0,79.0,79.0
0.006,6,10,1547,5,764,1.0,496.0,496.0,5,783,1.0,515.0,515.0
0.004,6,10,2006,5,927,1.0,659.0,659.0,5,1079,1.0,811.0,811.0
0.003,17,2,148,1,60,0.0,32.0,32.0,1,88,0.0,60.0,60.0
0.007,6,10,1972,5,910,1.0,642.0,642.0,5,1062,1.0,794.0,794.0
300.312,6,16,2170,9,684,37518.0,146.0,146.0,7,1486,50024.0,419.0,398.0
0.013,6,10,1989,5,910,3.0,642.0,642.0,5,1079,3.0,811.0,811.0
0.06,17,2,148,1,60,0.0,32.0,32.0,1,88,0.0,60.0,60.0
0.005,6,10,1779,5,928,1.0,660.0,660.0,5,851,1.0,583.0,583.0
0.109,6,10,1506,5,395,24.0,127.0,127.0,5,1111,25.0,843.0,843.0
0.126,6,10,1506,5,395,30.0,127.0,127.0,5,1111,28.0,843.0,843.0
0.099,6,10,1506,5,395,22.0,127.0,127.0,5,1111,21.0,843.0,843.0
0.084,6,10,1506,5,395,16.0,127.0,127.0,5,1111,17.0,843.0,843.0
0.005,6,10,1779,5,928,1.0,660.0,660.0,5,851,1.0,583.0,583.0
0.004,6,10,1779,5,928,1.0,660.0,660.0,5,851,1.0,583.0,583.0
40.073,17,10,676,5,460,10016.0,104.0,64.0,5,216,10017.0,20.0,15.0
0.001,17,2,154,1,69,0.0,41.0,41.0,1,85,0.0,57.0,57.0
0.094,6,10,1506,5,395,21.0,127.0,127.0,5,1111,22.0,843.0,843.0
0.102,6,10,1506,5,395,23.0,127.0,127.0,5,1111,23.0,843.0,843.0
0.006,6,10,1989,5,927,1.0,659.0,659.0,5,1062,1.0,794.0,794.0
0.006,6,10,1547,5,764,1.0,496.0,496.0,5,783,1.0,515.0,515.0
0.006,6,13,3747,7,509,0.0,137.0,137.0,6,3238,1.0,1470.0,1459.0
0.005,6,10,2006,5,927,1.0,659.0,659.0,5,1079,1.0,811.0,811.0
0.004,6,10,2006,5,927,1.0,659.0,659.0,5,1079,1.0,811.0,811.0
0.005,17,2,154,1,69,0.0,41.0,41.0,1,85,0.0,57.0,57.0
0.005,6,10,2006,5,927,1.0,659.0,659.0,5,1079,1.0,811.0,811.0
0.005,6,13,3690,7,452,0.0,80.0,80.0,6,3238,0.0,1470.0,1459.0
0.028,6,10,1990,5,911,7.0,643.0,643.0,5,1079,6.0,811.0,811.0
0.012,6,10,1983,5,910,3.0,642.0,642.0,5,1073,3.0,805.0,805.0
0.004,6,10,1702,5,863,1.0,595.0,595.0,5,839,1.0,571.0,571.0
330.433,17,20,1124,10,716,36700.0,48.0,43.0,10,408,36700.0,20.0,12.0
0.005,6,10,1989,5,927,1.0,659.0,659.0,5,1062,1.0,794.0,794.0
0.008,6,12,1926,6,1189,1.0,659.0,434.0,6,737,1.0,417.0,417.0
0.042,17,2,166,1,75,0.0,47.0,47.0,1,91,0.0,63.0,63.0
0.007,6,10,1547,5,764,1.0,496.0,496.0,5,783,1.0,515.0,515.0
0.004,6,10,1774,5,923,1.0,655.0,655.0,5,851,1.0,583.0,583.0
0.005,6,10,1774,5,923,1.0,655.0,655.0,5,851,1.0,583.0,583.0
0.007,6,10,1989,5,927,1.0,659.0,659.0,5,1062,1.0,794.0,794.0
0.01,6,10,1989,5,910,2.0,642.0,642.0,5,1079,2.0,811.0,811.0
0.012,6,10,1989,5,910,3.0,642.0,642.0,5,1079,3.0,811.0,811.0
0.017,6,10,1989,5,910,4.0,642.0,642.0,5,1079,4.0,811.0,811.0
0.008,6,10,1762,5,911,2.0,643.0,643.0,5,851,2.0,583.0,583.0
0.009,6,10,1990,5,911,2.0,643.0,643.0,5,1079,2.0,811.0,811.0
0.016,6,10,1990,5,911,4.0,643.0,643.0,5,1079,4.0,811.0,811.0
0.005,6,14,3742,7,452,0.0,80.0,80.0,7,3290,0.0,1448.0,972.0
0.006,17,2,194,1,59,0.0,31.0,31.0,1,135,0.0,107.0,107.0
0.005,6,10,1989,5,927,1.0,659.0,659.0,5,1062,1.0,794.0,794.0
158.43,17,76,10816,38,2553,4281.0,44.0,39.0,38,8263,4281.0,239.0,189.0
0.004,6,10,1702,5,863,1.0,595.0,595.0,5,839,1.0,571.0,571.0
0.113,6,10,1506,5,395,26.0,127.0,127.0,5,1111,23.0,843.0,843.0
367.384,6,24,3180,17,919,22961.0,195.0,195.0,7,2261,3861.0,775.0,492.0
0.005,6,10,2006,5,927,1.0,659.0,659.0,5,1079,1.0,811.0,811.0
0.082,6,10,1506,5,395,17.0,127.0,127.0,5,1111,19.0,843.0,843.0
0.08,6,10,1506,5,395,16.0,127.0,127.0,5,1111,18.0,843.0,843.0
0.023,6,10,1990,5,911,5.0,643.0,643.0,5,1079,5.0,811.0,811.0
0.003,17,2,148,1,60,0.0,32.0,32.0,1,88,0.0,60.0,60.0
0.005,17,2,170,1,65,0.0,37.0,37.0,1,105,0.0,77.0,77.0
0.003,17,2,136,1,60,0.0,32.0,32.0,1,76,0.0,48.0,48.0
0.103,6,10,1506,5,395,24.0,127.0,127.0,5,1111,25.0,843.0,843.0
0.013,17,2,152,1,56,0.0,28.0,28.0,1,96,0.0,68.0,68.0
0.062,6,10,1506,5,395,13.0,127.0,127.0,5,1111,14.0,843.0,843.0
0.079,6,10,1506,5,395,19.0,127.0,127.0,5,1111,14.0,843.0,843.0
10.814,17,28,4424,14,1995,823.0,270.0,114.0,14,2429,823.0,588.0,145.0
368.928,6,22,2313,16,867,24595.0,195.0,195.0,6,1446,4642.0,419.0,398.0
0.001,17,2,180,1,66,0.0,38.0,38.0,1,114,0.0,86.0,86.0
0.009,6,10,1983,5,910,2.0,642.0,642.0,5,1073,2.0,805.0,805.0
0.216,6,16,2671,8,1397,30.0,533.0,324.0,8,1274,19.0,529.0,212.0
0.006,6,10,1547,5,764,1.0,496.0,496.0,5,783,1.0,515.0,515.0
0.015,6,10,1989,5,910,3.0,642.0,642.0,5,1079,3.0,811.0,811.0
242.91,6,320,344427,123,17903,1991.0,2736.0,885.0,197,326524,1239.0,2804.0,1691.0
0.092,6,10,1506,5,395,20.0,127.0,127.0,5,1111,19.0,843.0,843.0
0.007,17,2,179,1,71,0.0,43.0,43.0,1,108,0.0,80.0,80.0
15.073,17,15,9238,8,6902,2149.0,1350.0,834.0,7,2336,2507.0,1350.0,305.0
40.06,17,10,676,5,460,10013.0,104.0,64.0,5,216,10014.0,20.0,15.0
0.014,6,10,1677,5,827,3.0,559.0,559.0,5,850,3.0,582.0,582.0
0.097,6,10,1506,5,395,20.0,127.0,127.0,5,1111,23.0,843.0,843.0
0.135,6,10,1506,5,395,31.0,127.0,127.0,5,1111,30.0,843.0,843.0
0.004,17,2,148,1,60,0.0,32.0,32.0,1,88,0.0,60.0,60.0
0.005,6,10,1989,5,927,1.0,659.0,659.0,5,1062,1.0,794.0,794.0
0.005,6,10,2007,5,928,1.0,660.0,660.0,5,1079,1.0,811.0,811.0
0.01,6,10,1972,5,910,2.0,642.0,642.0,5,1062,2.0,794.0,794.0
0.099,6,10,1506,5,395,22.0,127.0,127.0,5,1111,22.0,843.0,843.0
0.011,6,10,1631,5,848,2.0,580.0,580.0,5,783,2.0,515.0,515.0
0.009,6,10,1989,5,910,2.0,642.0,642.0,5,1079,2.0,811.0,811.0
0.087,6,10,1506,5,395,20.0,127.0,127.0,5,1111,17.0,843.0,843.0
40.061,17,10,676,5,460,10014.0,104.0,64.0,5,216,10014.0,20.0,15.0
0.042,17,2,144,1,64,0.0,36.0,36.0,1,80,0.0,52.0,52.0
40.057,17,10,676,5,460,10013.0,104.0,64.0,5,216,10013.0,20.0,15.0
0.04,17,2,152,1,76,0.0,48.0,48.0,1,76,0.0,48.0,48.0
0.106,6,10,1506,5,395,22.0,127.0,127.0,5,1111,24.0,843.0,843.0
0.01,6,14,3787,7,497,1.0,125.0,125.0,7,3290,1.0,1448.0,972.0
0.005,17,2,230,1,68,0.0,40.0,40.0,1,162,0.0,134.0,134.0
310.803,17,20,1124,10,716,34518.0,48.0,43.0,10,408,34518.0,20.0,12.0
0.004,17,2,148,1,60,0.0,32.0,32.0,1,88,0.0,60.0,60.0
0.005,17,2,179,1,71,0.0,43.0,43.0,1,108,0.0,80.0,80.0
0.141,6,10,1506,5,395,34.0,127.0,127.0,5,1111,28.0,843.0,843.0
0.005,6,14,3736,7,446,0.0,74.0,74.0,7,3290,0.0,1448.0,972.0
0.011,6,13,3735,7,497,1.0,125.0,125.0,6,3238,2.0,1470.0,1459.0
0.005,6,13,3747,7,509,0.0,137.0,137.0,6,3238,0.0,1470.0,1459.0
0.019,6,13,3735,7,497,3.0,125.0,125.0,6,3238,3.0,1470.0,1459.0
0.008,6,10,1972,5,910,2.0,642.0,642.0,5,1062,1.0,794.0,794.0
0.011,6,10,1989,5,910,2.0,642.0,642.0,5,1079,2.0,811.0,811.0
0.011,6,10,1983,5,910,2.0,642.0,642.0,5,1073,2.0,805.0,805.0
0.006,17,2,164,1,74,0.0,46.0,46.0,1,90,0.0,62.0,62.0
0.04,6,19,9922,11,704,3.0,124.0,124.0,8,9218,5.0,2896.0,2198.0
0.104,6,10,1506,5,395,23.0,127.0,127.0,5,1111,20.0,843.0,843.0
0.005,17,2,166,1,75,0.0,47.0,47.0,1,91,0.0,63.0,63.0
0.005,6,10,1689,5,839,1.0,571.0,571.0,5,850,1.0,582.0,582.0
0.014,6,10,1989,5,910,3.0,642.0,642.0,5,1079,3.0,811.0,811.0
0.131,6,10,1506,5,395,31.0,127.0,127.0,5,1111,27.0,843.0,843.0
0.008,6,10,1972,5,910,2.0,642.0,642.0,5,1062,2.0,794.0,794.0
0.005,6,10,2000,5,927,1.0,659.0,659.0,5,1073,1.0,805.0,805.0
0.114,6,10,1506,5,395,22.0,127.0,127.0,5,1111,25.0,843.0,843.0
0.012,6,10,1631,5,848,3.0,580.0,580.0,5,783,2.0,515.0,515.0
0.131,6,10,1506,5,395,26.0,127.0,127.0,5,1111,28.0,843.0,843.0
0.005,6,10,2007,5,928,1.0,660.0,660.0,5,1079,1.0,811.0,811.0
0.083,6,10,1506,5,395,18.0,127.0,127.0,5,1111,18.0,843.0,843.0
0.009,6,10,1989,5,910,2.0,642.0,642.0,5,1079,2.0,811.0,811.0
0.021,6,10,1989,5,910,5.0,642.0,642.0,5,1079,5.0,811.0,811.0
240.099,6,31,9142,15,6897,17149.0,2019.0,680.0,16,2245,16006.0,580.0,175.0
0.01,6,10,1990,5,911,2.0,643.0,643.0,5,1079,2.0,811.0,811.0
0.001,17,2,180,1,66,0.0,38.0,38.0,1,114,0.0,86.0,86.0
0.004,6,10,2007,5,928,1.0,660.0,660.0,5,1079,1.0,811.0,811.0
0.005,6,10,1643,5,860,1.0,592.0,592.0,5,783,1.0,515.0,515.0
40.064,17,10,676,5,460,10015.0,104.0,64.0,5,216,10015.0,20.0,15.0
0.007,6,10,2007,5,928,1.0,660.0,660.0,5,1079,1.0,811.0,811.0
0.001,17,2,136,1,60,0.0,32.0,32.0,1,76,0.0,48.0,48.0
0.128,6,10,1506,5,395,30.0,127.0,127.0,5,1111,14.0,843.0,843.0
0.005,6,10,2007,5,928,1.0,660.0,660.0,5,1079,1.0,811.0,811.0
0.005,6,10,1689,5,839,1.0,571.0,571.0,5,850,1.0,582.0,582.0
0.003,17,2,136,1,60,0.0,32.0,32.0,1,76,0.0,48.0,48.0
0.005,6,10,1702,5,863,1.0,595.0,595.0,5,839,1.0,571.0,571.0
0.148,17,2,170,1,65,0.0,37.0,37.0,1,105,0.0,77.0,77.0
0.004,17,2,148,1,60,0.0,32.0,32.0,1,88,0.0,60.0,60.0
0.005,6,10,1702,5,863,1.0,595.0,595.0,5,839,1.0,571.0,571.0
40.076,17,10,676,5,460,10015.0,104.0,64.0,5,216,10018.0,20.0,15.0
0.038,17,2,182,1,65,0.0,37.0,37.0,1,117,0.0,89.0,89.0
0.005,17,2,170,1,65,0.0,37.0,37.0,1,105,0.0,77.0,77.0
0.015,6,10,1983,5,910,3.0,642.0,642.0,5,1073,3.0,805.0,805.0
0.005,6,10,2006,5,927,1.0,659.0,659.0,5,1079,1.0,811.0,811.0
0.049,17,2,128,1,56,0.0,28.0,28.0,1,72,0.0,44.0,44.0
0.008,6,10,1972,5,910,2.0,642.0,642.0,5,1062,2.0,794.0,794.0
0.075,6,10,1506,5,395,16.0,127.0,127.0,5,1111,16.0,843.0,843.0
0.004,6,10,1702,5,863,1.0,595.0,595.0,5,839,0.0,571.0,571.0
0.01,6,10,1990,5,911,2.0,643.0,643.0,5,1079,2.0,811.0,811.0
171.349,17,80,11351,40,2668,4393.0,44.0,38.0,40,8683,4393.0,261.0,189.0
0.016,6,10,1972,5,910,4.0,642.0,642.0,5,1062,4.0,794.0,794.0
0.01,6,10,1989,5,910,2.0,642.0,642.0,5,1079,2.0,811.0,811.0
0.01,6,10,1677,5,827,2.0,559.0,559.0,5,850,2.0,582.0,582.0
0.019,6,10,1990,5,911,4.0,643.0,643.0,5,1079,4.0,811.0,811.0
0.004,6,10,2006,5,927,1.0,659.0,659.0,5,1079,1.0,811.0,811.0
0.129,6,10,1506,5,395,29.0,127.0,127.0,5,1111,28.0,843.0,843.0
0.113,6,10,1506,5,395,26.0,127.0,127.0,5,1111,23.0,843.0,843.0
0.005,17,2,144,1,64,0.0,36.0,36.0,1,80,0.0,52.0,52.0
0.01,6,10,1989,5,910,2.0,642.0,642.0,5,1079,2.0,811.0,811.0
0.038,17,2,182,1,65,0.0,37.0,37.0,1,117,0.0,89.0,89.0
0.019,6,10,1990,5,911,4.0,643.0,643.0,5,1079,4.0,811.0,811.0
0.071,17,4,284,2,120,0.0,32.0,32.0,2,164,68.0,60.0,54.0
0.002,17,2,180,1,66,0.0,38.0,38.0,1,114,0.0,86.0,86.0
0.012,6,12,1926,6,1189,2.0,659.0,434.0,6,737,2.0,417.0,417.0
0.004,6,10,2006,5,927,1.0,659.0,659.0,5,1079,1.0,811.0,811.0
0.009,6,10,1972,5,910,2.0,642.0,642.0,5,1062,2.0,794.0,794.0
0.001,17,2,180,1,66,0.0,38.0,38.0,1,114,0.0,86.0,86.0
0.007,6,10,1762,5,911,1.0,643.0,643.0,5,851,1.0,583.0,583.0
40.081,17,10,676,5,460,10019.0,104.0,64.0,5,216,10019.0,20.0,15.0
0.004,17,2,148,1,60,0.0,32.0,32.0,1,88,0.0,60.0,60.0
0.245,17,15,8641,8,4076,35.0,1350.0,481.0,7,4565,31.0,1350.0,624.0
0.015,6,10,1989,5,910,3.0,642.0,642.0,5,1079,3.0,811.0,811.0
0.004,17,2,136,1,60,0.0,32.0,32.0,1,76,0.0,48.0,48.0
0.004,6,10,1989,5,927,1.0,659.0,659.0,5,1062,1.0,794.0,794.0
361.797,6,21,1793,16,1030,24119.0,190.0,190.0,5,763,60009.0,462.0,247.0
0.012,6,10,1983,5,910,3.0,642.0,642.0,5,1073,3.0,805.0,805.0
0.005,6,10,1689,5,839,1.0,571.0,571.0,5,850,1.0,582.0,582.0
0.003,17,2,148,1,60,0.0,32.0,32.0,1,88,0.0,60.0,60.0
0.006,6,10,2007,5,928,1.0,660.0,660.0,5,1079,1.0,811.0,811.0
0.006,17,2,275,1,67,0.0,39.0,39.0,1,208,0.0,180.0,180.0
0.001,17,2,136,1,60,0.0,32.0,32.0,1,76,0.0,48.0,48.0
0.014,6,10,1972,5,910,3.0,642.0,642.0,5,1062,3.0,794.0,794.0
0.004,6,10,2006,5,927,1.0,659.0,659.0,5,1079,1.0,811.0,811.0
0.015,6,10,1972,5,910,3.0,642.0,642.0,5,1062,3.0,794.0,794.0
15.069,17,15,9238,8,6902,2148.0,1350.0,834.0,7,2336,2506.0,1350.0,305.0
0.004,17,2,148,1,60,0.0,32.0,32.0,1,88,0.0,60.0,60.0
1765.659,6,543,187993,284,163168,6239.0,2883.0,945.0,259,24825,6843.0,387.0,113.0
24.223,6,36,7990,17,2432,554.0,1367.0,573.0,19,5558,1336.0,1360.0,398.0
0.006,17,2,194,1,59,0.0,31.0,31.0,1,135,0.0,107.0,107.0
0.011,6,13,3735,7,497,1.0,125.0,125.0,6,3238,2.0,1470.0,1459.0
0.077,6,10,1506,5,395,17.0,127.0,127.0,5,1111,15.0,843.0,843.0
0.01,6,10,1762,5,911,2.0,643.0,643.0,5,851,2.0,583.0,583.0
0.088,6,10,1506,5,395,18.0,127.0,127.0,5,1111,20.0,843.0,843.0
0.005,17,2,136,1,60,0.0,32.0,32.0,1,76,0.0,48.0,48.0
0.006,6,10,1854,5,889,1.0,621.0,621.0,5,965,1.0,697.0,697.0
11.451,17,28,4398,14,2313,868.0,588.0,137.0,14,2085,868.0,268.0,120.0
40.057,17,10,676,5,460,10013.0,104.0,64.0,5,216,10013.0,20.0,15.0
0.005,6,10,2006,5,927,1.0,659.0,659.0,5,1079,1.0,811.0,811.0
40.067,17,10,676,5,460,10014.0,104.0,64.0,5,216,10015.0,20.0,15.0
0.008,6,10,1989,5,910,2.0,642.0,642.0,5,1079,2.0,811.0,811.0
0.005,17,2,164,1,74,0.0,46.0,46.0,1,90,0.0,62.0,62.0
240.009,6,9,787,5,488,60002.0,232.0,232.0,4,299,80002.0,83.0,83.0
0.005,6,10,2007,5,928,1.0,660.0,660.0,5,1079,1.0,811.0,811.0
0.004,6,10,2007,5,928,1.0,660.0,660.0,5,1079,1.0,811.0,811.0
40.067,17,10,676,5,460,10014.0,104.0,64.0,5,216,10016.0,20.0,15.0
0.069,17,8,3613,4,1874,23.0,1350.0,440.0,4,1739,12.0,1350.0,406.0
308.307,17,20,1124,10,716,34242.0,48.0,43.0,10,408,34242.0,20.0,12.0
0.005,6,10,2006,5,927,1.0,659.0,659.0,5,1079,1.0,811.0,811.0
0.023,6,10,1990,5,911,5.0,643.0,643.0,5,1079,5.0,811.0,811.0
0.004,6,10,2007,5,928,1.0,660.0,660.0,5,1079,1.0,811.0,811.0
0.103,6,10,1506,5,395,23.0,127.0,127.0,5,1111,21.0,843.0,843.0
0.27,17,46,27966,26,23456,10.0,1350.0,874.0,20,4510,11.0,1350.0,197.0
0.148,6,10,1506,5,395,34.0,127.0,127.0,5,1111,32.0,843.0,843.0
0.005,6,10,2000,5,927,1.0,659.0,659.0,5,1073,1.0,805.0,805.0
0.134,6,10,1506,5,395,31.0,127.0,127.0,5,1111,29.0,843.0,843.0
0.009,6,10,1972,5,910,2.0,642.0,642.0,5,1062,2.0,794.0,794.0
0.005,6,10,1774,5,923,1.0,655.0,655.0,5,851,1.0,583.0,583.0
0.006,6,10,1547,5,764,1.0,496.0,496.0,5,783,1.0,515.0,515.0
0.01,6,10,1989,5,910,2.0,642.0,642.0,5,1079,2.0,811.0,811.0
0.005,6,10,2000,5,927,1.0,659.0,659.0,5,1073,1.0,805.0,805.0
0.005,6,10,1989,5,927,1.0,659.0,659.0,5,1062,1.0,794.0,794.0
10.949,17,28,4423,14,1995,833.0,270.0,114.0,14,2428,833.0,587.0,145.0
0.005,6,10,1989,5,927,1.0,659.0,659.0,5,1062,1.0,794.0,794.0
0.005,6,10,2000,5,927,1.0,659.0,659.0,5,1073,1.0,805.0,805.0
280.763,6,24,6440,10,1186,31195.0,267.0,156.0,14,5254,21596.0,1400.0,781.0
11.36,17,29,4566,15,2166,800.0,269.0,116.0,14,2400,861.0,587.0,143.0
0.005,6,10,2006,5,927,1.0,659.0,659.0,5,1079,1.0,811.0,811.0
0.074,6,10,1506,5,395,16.0,127.0,127.0,5,1111,17.0,843.0,843.0
0.004,17,2,164,1,74,0.0,46.0,46.0,1,90,0.0,62.0,62.0
0.005,17,2,170,1,65,0.0,37.0,37.0,1,105,0.0,77.0,77.0
0.332,17,44,24512,24,21166,14.0,1350.0,853.0,20,3346,14.0,1350.0,139.0
0.081,6,10,1506,5,395,15.0,127.0,127.0,5,1111,18.0,843.0,843.0
0.004,6,10,2007,5,928,1.0,660.0,660.0,5,1079,1.0,811.0,811.0
0.005,6,10,2006,5,927,1.0,659.0,659.0,5,1079,1.0,811.0,811.0
0.006,17,2,136,1,60,0.0,32.0,32.0,1,76,0.0,48.0,48.0
9.036,17,6,376,5,280,2259.0,28.0,28.0,1,96,0.0,68.0,68.0
1727.95,6,45,2790,30,1725,59584.0,35.0,35.0,15,1065,123419.0,31.0,31.0
0.058,6,10,1506,5,395,14.0,127.0,127.0,5,1111,12.0,843.0,843.0
0.004,6,10,2006,5,927,1.0,659.0,659.0,5,1079,1.0,811.0,811.0
0.04,17,2,136,1,60,0.0,32.0,32.0,1,76,0.0,48.0,48.0
308.377,17,20,1124,10,716,34249.0,48.0,43.0,10,408,34249.0,20.0,12.0
0.078,6,10,1506,5,395,16.0,127.0,127.0,5,1111,16.0,843.0,843.0
0.009,6,12,1926,6,1189,1.0,659.0,434.0,6,737,1.0,417.0,417.0
0.006,6,10,1547,5,764,1.0,496.0,496.0,5,783,1.0,515.0,515.0
0.007,6,10,1989,5,910,1.0,642.0,642.0,5,1079,1.0,811.0,811.0
0.003,17,2,148,1,60,0.0,32.0,32.0,1,88,0.0,60.0,60.0
0.039,17,4,284,2,120,0.0,32.0,32.0,2,164,36.0,60.0,54.0
300.478,6,16,2170,9,684,37535.0,146.0,146.0,7,1486,50049.0,419.0,398.0
0.009,6,10,1972,5,910,2.0,642.0,642.0,5,1062,2.0,794.0,794.0
0.005,6,10,2006,5,927,1.0,659.0,659.0,5,1079,1.0,811.0,811.0
0.093,6,10,1506,5,395,19.0,127.0,127.0,5,1111,18.0,843.0,843.0
0.003,17,2,136,1,60,0.0,32.0,32.0,1,76,0.0,48.0,48.0
10.772,17,28,4420,14,1995,820.0,270.0,114.0,14,2425,820.0,588.0,145.0
291.976,6,17,1215,4,448,2.0,232.0,232.0,13,767,24331.0,83.0,83.0
0.042,17,2,148,1,60,0.0,32.0,32.0,1,88,0.0,60.0,60.0
0.003,17,2,148,1,60,0.0,32.0,32.0,1,88,0.0,60.0,60.0
0.006,6,10,1547,5,764,1.0,496.0,496.0,5,783,1.0,515.0,515.0
0.004,17,2,136,1,60,0.0,32.0,32.0,1,76,0.0,48.0,48.0
0.005,17,2,140,1,62,0.0,34.0,34.0,1,78,0.0,50.0,50.0
0.007,17,2,194,1,59,0.0,31.0,31.0,1,135,0.0,107.0,107.0
0.131,6,10,1506,5,395,30.0,127.0,127.0,5,1111,28.0,843.0,843.0
0.006,6,10,1989,5,927,1.0,659.0,659.0,5,1062,1.0,794.0,794.0
0.009,6,10,1983,5,910,2.0,642.0,642.0,5,1073,2.0,805.0,805.0
0.087,6,10,1506,5,395,18.0,127.0,127.0,5,1111,16.0,843.0,843.0
0.134,17,2,80,1,32,0.0,4.0,4.0,1,48,0.0,20.0,20.0
0.107,6,10,1506,5,395,23.0,127.0,127.0,5,1111,24.0,843.0,843.0
0.01,6,12,1926,6,1189,1.0,659.0,434.0,6,737,1.0,417.0,417.0
0.001,17,2,136,1,60,0.0,32.0,32.0,1,76,0.0,48.0,48.0
0.015,6,10,1972,5,910,3.0,642.0,642.0,5,1062,3.0,794.0,794.0
0.003,17,2,136,1,60,0.0,32.0,32.0,1,76,0.0,48.0,48.0
0.279,6,16,2669,8,1395,39.0,533.0,323.0,8,1274,27.0,529.0,212.0
0.005,17,2,230,1,68,0.0,40.0,40.0,1,162,0.0,134.0,134.0
0.039,17,2,136,1,60,0.0,32.0,32.0,1,76,0.0,48.0,48.0
0.003,6,10,1702,5,863,0.0,595.0,595.0,5,839,0.0,571.0,571.0
0.017,17,2,140,1,62,0.0,34.0,34.0,1,78,0.0,50.0,50.0
15.074,17,15,9238,8,6902,2149.0,1350.0,834.0,7,2336,2507.0,1350.0,305.0
0.005,6,13,3747,7,509,0.0,137.0,137.0,6,3238,1.0,1470.0,1459.0
0.006,6,10,1689,5,839,1.0,571.0,571.0,5,850,1.0,582.0,582.0
0.017,6,10,1972,5,910,4.0,642.0,642.0,5,1062,4.0,794.0,794.0
0.101,6,10,1506,5,395,21.0,127.0,127.0,5,1111,20.0,843.0,843.0
309.077,17,20,1124,10,716,34327.0,48.0,43.0,10,408,34328.0,20.0,12.0
0.005,6,10,1689,5,839,1.0,571.0,571.0,5,850,1.0,582.0,582.0
160.492,17,68,9774,34,2267,4863.0,44.0,38.0,34,7507,4863.0,239.0,192.0
65.802,6,27,18157,15,10210,4700.0,2804.0,1570.0,12,7947,5967.0,2318.0,1219.0
0.005,17,2,222,1,65,0.0,37.0,37.0,1,157,0.0,129.0,129.0
0.005,6,10,1774,5,923,1.0,655.0,655.0,5,851,1.0,583.0,583.0
0.005,17,2,170,1,65,0.0,37.0,37.0,1,105,0.0,77.0,77.0
0.005,6,10,1779,5,928,1.0,660.0,660.0,5,851,1.0,583.0,583.0
0.014,6,10,1990,5,911,3.0,643.0,643.0,5,1079,3.0,811.0,811.0
0.111,6,10,1506,5,395,26.0,127.0,127.0,5,1111,25.0,843.0,843.0
0.003,17,2,136,1,60,0.0,32.0,32.0,1,76,0.0,48.0,48.0
0.005,17,2,193,1,71,0.0,43.0,43.0,1,122,0.0,94.0,94.0
0.009,6,10,1983,5,910,2.0,642.0,642.0,5,1073,2.0,805.0,805.0
0.007,6,10,1547,5,764,1.0,496.0,496.0,5,783,1.0,515.0,515.0
0.04,17,4,284,2,120,0.0,32.0,32.0,2,164,36.0,60.0,54.0
0.033,6,10,1972,5,910,8.0,642.0,642.0,5,1062,8.0,794.0,794.0
0.077,6,10,1506,5,395,17.0,127.0,127.0,5,1111,15.0,843.0,843.0
0.081,6,10,1506,5,395,19.0,127.0,127.0,5,1111,18.0,843.0,843.0
0.011,6,10,1989,5,910,2.0,642.0,642.0,5,1079,2.0,811.0,811.0
0.042,17,2,152,1,76,0.0,48.0,48.0,1,76,0.0,48.0,48.0
0.067,17,8,3613,4,1874,22.0,1350.0,440.0,4,1739,11.0,1350.0,406.0
0.067,6,10,1506,5,395,15.0,127.0,127.0,5,1111,14.0,843.0,843.0
0.005,6,10,1854,5,889,1.0,621.0,621.0,5,965,1.0,697.0,697.0
0.01,6,10,1983,5,910,2.0,642.0,642.0,5,1073,2.0,805.0,805.0
0.009,6,13,3747,7,509,1.0,137.0,137.0,6,3238,1.0,1470.0,1459.0
0.006,6,10,1547,5,764,1.0,496.0,496.0,5,783,1.0,515.0,515.0
0.009,6,13,3735,7,497,1.0,125.0,125.0,6,3238,1.0,1470.0,1459.0
0.092,6,10,1506,5,395,22.0,127.0,127.0,5,1111,17.0,843.0,843.0
0.013,6,10,1990,5,911,3.0,643.0,643.0,5,1079,3.0,811.0,811.0
0.012,6,10,1989,5,910,2.0,642.0,642.0,5,1079,2.0,811.0,811.0
0.013,17,2,230,1,68,0.0,40.0,40.0,1,162,0.0,134.0,134.0
0.008,6,10,1983,5,910,2.0,642.0,642.0,5,1073,1.0,805.0,805.0
0.011,6,10,1972,5,910,2.0,642.0,642.0,5,1062,2.0,794.0,794.0
0.005,17,2,180,1,58,0.0,30.0,30.0,1,122,0.0,94.0,94.0
312.556,17,20,1124,10,716,34721.0,48.0,43.0,10,408,34721.0,20.0,12.0
0.083,6,10,1506,5,395,18.0,127.0,127.0,5,1111,16.0,843.0,843.0
0.014,6,10,1989,5,910,3.0,642.0,642.0,5,1079,3.0,811.0,811.0
0.005,6,10,2006,5,927,1.0,659.0,659.0,5,1079,1.0,811.0,811.0
0.04,17,2,152,1,76,0.0,48.0,48.0,1,76,0.0,48.0,48.0
0.005,6,10,2007,5,928,1.0,660.0,660.0,5,1079,1.0,811.0,811.0
0.005,17,2,169,1,62,0.0,34.0,34.0,1,107,0.0,79.0,79.0
0.013,6,10,1989,5,910,3.0,642.0,642.0,5,1079,3.0,811.0,811.0
0.004,6,10,2007,5,928,1.0,660.0,660.0,5,1079,1.0,811.0,811.0
0.068,6,10,1506,5,395,14.0,127.0,127.0,5,1111,15.0,843.0,843.0
0.006,17,2,180,1,66,0.0,38.0,38.0,1,114,0.0,86.0,86.0
0.006,6,10,1547,5,764,1.0,496.0,496.0,5,783,1.0,515.0,515.0
0.038,6,10,1631,5,848,9.0,580.0,580.0,5,783,9.0,515.0,515.0
0.004,17,2,148,1,60,0.0,32.0,32.0,1,88,0.0,60.0,60.0
0.145,6,10,1506,5,395,33.0,127.0,127.0,5,1111,34.0,843.0,843.0
310.687,17,20,1124,10,716,34506.0,48.0,43.0,10,408,34506.0,20.0,12.0
0.098,6,10,1506,5,395,21.0,127.0,127.0,5,1111,20.0,843.0,843.0
0.005,6,10,1779,5,928,1.0,660.0,660.0,5,851,1.0,583.0,583.0
0.005,17,2,172,1,59,0.0,31.0,31.0,1,113,0.0,85.0,85.0
0.014,6,10,1990,5,911,3.0,643.0,643.0,5,1079,3.0,811.0,811.0
0.013,6,10,1972,5,910,3.0,642.0,642.0,5,1062,3.0,794.0,794.0
11.256,17,28,4422,14,1993,853.0,268.0,114.0,14,2429,853.0,588.0,145.0
0.001,17,2,180,1,66,0.0,38.0,38.0,1,114,0.0,86.0,86.0
0.064,6,10,1506,5,395,14.0,127.0,127.0,5,1111,14.0,843.0,843.0
0.005,6,10,1774,5,923,1.0,655.0,655.0,5,851,1.0,583.0,583.0
0.009,6,10,1983,5,910,2.0,642.0,642.0,5,1073,2.0,805.0,805.0
0.027,6,10,1983,5,910,6.0,642.0,642.0,5,1073,6.0,805.0,805.0
0.005,6,10,1989,5,927,1.0,659.0,659.0,5,1062,1.0,794.0,794.0
0.005,6,10,2007,5,928,1.0,660.0,660.0,5,1079,1.0,811.0,811.0
0.017,6,10,1989,5,910,4.0,642.0,642.0,5,1079,4.0,811.0,811.0
0.012,6,10,1677,5,827,3.0,559.0,559.0,5,850,2.0,582.0,582.0
0.074,6,10,1506,5,395,15.0,127.0,127.0,5,1111,16.0,843.0,843.0
0.075,6,10,1506,5,395,17.0,127.0,127.0,5,1111,17.0,843.0,843.0
11.008,17,28,4398,14,2312,838.0,587.0,137.0,14,2086,838.0,269.0,121.0
40.065,17,10,676,5,460,10013.0,104.0,64.0,5,216,10015.0,20.0,15.0
0.005,6,10,1774,5,923,1.0,655.0,655.0,5,851,1.0,583.0,583.0
0.005,6,10,2006,5,927,1.0,659.0,659.0,5,1079,1.0,811.0,811.0
0.014,6,13,3735,7,497,2.0,125.0,125.0,6,3238,2.0,1470.0,1459.0
0.004,17,2,136,1,60,0.0,32.0,32.0,1,76,0.0,48.0,48.0
0.006,6,10,1547,5,764,1.0,496.0,496.0,5,783,1.0,515.0,515.0
0.004,6,10,2006,5,927,1.0,659.0,659.0,5,1079,1.0,811.0,811.0
300.022,6,12,1782,7,1348,50003.0,494.0,494.0,5,434,75004.0,83.0,83.0
0.008,6,10,2007,5,928,1.0,660.0,660.0,5,1079,1.0,811.0,811.0
0.004,17,2,148,1,60,0.0,32.0,32.0,1,88,0.0,60.0,60.0
300.321,6,16,2170,9,684,37518.0,146.0,146.0,7,1486,50025.0,419.0,398.0
0.006,17,2,170,1,65,0.0,37.0,37.0,1,105,0.0,77.0,77.0
40.067,17,10,676,5,460,10013.0,104.0,64.0,5,216,10014.0,20.0,15.0
0.004,6,10,2006,5,927,1.0,659.0,659.0,5,1079,1.0,811.0,811.0
0.04,17,2,152,1,76,0.0,48.0,48.0,1,76,0.0,48.0,48.0
240.015,6,9,787,5,488,60003.0,232.0,232.0,4,299,80004.0,83.0,83.0
0.09,6,10,1506,5,395,17.0,127.0,127.0,5,1111,19.0,843.0,843.0
0.009,6,10,1989,5,910,2.0,642.0,642.0,5,1079,2.0,811.0,811.0
0.167,17,2,152,1,76,0.0,48.0,48.0,1,76,0.0,48.0,48.0
0.005,6,10,1989,5,927,1.0,659.0,659.0,5,1062,1.0,794.0,794.0
0.099,6,10,1506,5,395,22.0,127.0,127.0,5,1111,22.0,843.0,843.0
0.027,6,13,3816,7,578,4.0,206.0,206.0,6,3238,5.0,1470.0,1459.0
0.005,6,10,2007,5,928,1.0,660.0,660.0,5,1079,1.0,811.0,811.0
0.086,6,10,1506,5,395,19.0,127.0,127.0,5,1111,20.0,843.0,843.0
0.013,6,10,1989,5,910,3.0,642.0,642.0,5,1079,3.0,811.0,811.0
0.003,17,2,148,1,60,0.0,32.0,32.0,1,88,0.0,60.0,60.0
40.103,17,10,676,5,460,10018.0,104.0,64.0,5,216,10013.0,20.0,15.0
0.012,6,10,1989,5,910,3.0,642.0,642.0,5,1079,2.0,811.0,811.0
0.004,6,10,2007,5,928,1.0,660.0,660.0,5,1079,1.0,811.0,811.0
0.13,17,2,80,1,32,0.0,4.0,4.0,1,48,0.0,20.0,20.0
0.009,6,10,1631,5,848,2.0,580.0,580.0,5,783,2.0,515.0,515.0
0.005,17,2,170,1,65,0.0,37.0,37.0,1,105,0.0,77.0,77.0
0.005,17,2,170,1,65,0.0,37.0,37.0,1,105,0.0,77.0,77.0
0.013,6,10,1989,5,910,3.0,642.0,642.0,5,1079,3.0,811.0,811.0
0.006,6,10,2007,5,928,1.0,660.0,660.0,5,1079,1.0,811.0,811.0
0.009,6,12,1926,6,1189,1.0,659.0,434.0,6,737,1.0,417.0,417.0
0.006,6,10,1547,5,764,1.0,496.0,496.0,5,783,1.0,515.0,515.0
0.059,17,2,152,1,76,0.0,48.0,48.0,1,76,0.0,48.0,48.0
0.005,6,10,2007,5,928,1.0,660.0,660.0,5,1079,1.0,811.0,811.0
0.039,17,2,182,1,65,0.0,37.0,37.0,1,117,0.0,89.0,89.0
0.139,6,10,1506,5,395,32.0,127.0,127.0,5,1111,31.0,843.0,843.0
0.015,6,10,1631,5,848,3.0,580.0,580.0,5,783,3.0,515.0,515.0
0.008,6,10,1989,5,910,2.0,642.0,642.0,5,1079,2.0,811.0,811.0
0.213,6,16,2782,8,1400,30.0,533.0,325.0,8,1382,19.0,529.0,239.0
0.006,6,10,1854,5,889,1.0,621.0,621.0,5,965,1.0,697.0,697.0
1792.41,6,546,190656,271,163600,6638.0,2883.0,952.0,275,27056,6541.0,580.0,124.0
0.005,17,2,230,1,68,0.0,40.0,40.0,1,162,0.0,134.0,134.0
0.005,6,10,1689,5,839,1.0,571.0,571.0,5,850,1.0,582.0,582.0
0.012,6,10,1972,5,910,3.0,642.0,642.0,5,1062,2.0,794.0,794.0
0.004,6,10,1702,5,863,0.0,595.0,595.0,5,839,1.0,571.0,571.0
0.007,17,2,194,1,59,0.0,31.0,31.0,1,135,0.0,107.0,107.0
15.08,17,16,8702,8,6448,2150.0,1350.0,778.0,8,2254,2150.0,1350.0,253.0
0.006,17,2,148,1,60,0.0,32.0,32.0,1,88,0.0,60.0,60.0
0.009,6,10,1989,5,910,2.0,642.0,642.0,5,1079,2.0,811.0,811.0
0.005,6,10,1989,5,927,1.0,659.0,659.0,5,1062,1.0,794.0,794.0
40.068,17,10,676,5,460,10014.0,104.0,64.0,5,216,10016.0,20.0,15.0
0.001,17,2,136,1,60,0.0,32.0,32.0,1,76,0.0,48.0,48.0
0.005,6,10,2000,5,927,1.0,659.0,659.0,5,1073,1.0,805.0,805.0
0.124,6,10,1506,5,395,25.0,127.0,127.0,5,1111,27.0,843.0,843.0
0.004,17,4,284,2,120,0.0,32.0,32.0,2,164,1.0,60.0,54.0
0.0,17,2,164,1,74,0.0,46.0,46.0,1,90,0.0,62.0,62.0
15.072,17,15,9238,8,6902,2149.0,1350.0,834.0,7,2336,2507.0,1350.0,305.0
0.006,17,4,284,2,120,0.0,32.0,32.0,2,164,0.0,60.0,54.0
172.362,17,86,12379,43,2885,4103.0,44.0,39.0,43,9494,4103.0,260.0,192.0
40.073,17,10,676,5,460,10015.0,104.0,64.0,5,216,10017.0,20.0,15.0
0.088,6,10,1506,5,395,19.0,127.0,127.0,5,1111,18.0,843.0,843.0
0.019,6,10,1677,5,827,4.0,559.0,559.0,5,850,4.0,582.0,582.0
0.005,6,10,2007,5,928,1.0,660.0,660.0,5,1079,1.0,811.0,811.0
0.066,6,10,1506,5,395,14.0,127.0,127.0,5,1111,12.0,843.0,843.0
0.012,6,10,1989,5,910,3.0,642.0,642.0,5,1079,3.0,811.0,811.0
10.717,17,28,4421,14,1994,816.0,269.0,114.0,14,2427,816.0,586.0,145.0
0.016,6,10,1989,5,910,4.0,642.0,642.0,5,1079,4.0,811.0,811.0
0.005,6,10,2000,5,927,1.0,659.0,659.0,5,1073,1.0,805.0,805.0
0.005,6,10,2006,5,927,1.0,659.0,659.0,5,1079,1.0,811.0,811.0
23.075,6,39,22801,21,1150,1153.0,290.0,290.0,18,21651,1354.0,2021.0,1394.0
0.005,6,10,2006,5,927,1.0,659.0,659.0,5,1079,1.0,811.0,811.0
0.016,6,10,1972,5,910,4.0,642.0,642.0,5,1062,3.0,794.0,794.0
0.007,6,10,1989,5,910,1.0,642.0,642.0,5,1079,1.0,811.0,811.0
0.016,6,12,1926,6,1189,3.0,659.0,434.0,6,737,3.0,417.0,417.0
365.969,6,22,2313,16,867,24397.0,195.0,195.0,6,1446,4685.0,419.0,398.0
0.006,6,10,1547,5,764,1.0,496.0,496.0,5,783,1.0,515.0,515.0
240.08,6,20,4873,11,941,24008.0,180.0,93.0,9,3932,30009.0,1592.0,576.0
0.011,6,10,1989,5,910,2.0,642.0,642.0,5,1079,2.0,811.0,811.0
0.01,6,10,1990,5,911,2.0,643.0,643.0,5,1079,2.0,811.0,811.0
0.027,17,2,144,1,64,0.0,36.0,36.0,1,80,0.0,52.0,52.0
0.01,6,10,1990,5,911,2.0,643.0,643.0,5,1079,2.0,811.0,811.0
0.043,17,2,152,1,76,0.0,48.0,48.0,1,76,0.0,48.0,48.0
0.006,6,10,1689,5,839,1.0,571.0,571.0,5,850,1.0,582.0,582.0
0.116,6,10,1506,5,395,27.0,127.0,127.0,5,1111,23.0,843.0,843.0
0.01,6,10,1989,5,910,2.0,642.0,642.0,5,1079,2.0,811.0,811.0
0.001,17,2,180,1,66,0.0,38.0,38.0,1,114,0.0,86.0,86.0
1777.391,17,144,41760,72,22752,25033.0,288.0,288.0,72,19008,25033.0,236.0,236.0
0.001,17,2,154,1,69,0.0,41.0,41.0,1,85,0.0,57.0,57.0
0.087,6,10,1506,5,395,18.0,127.0,127.0,5,1111,19.0,843.0,843.0
0.005,6,10,1779,5,928,1.0,660.0,660.0,5,851,1.0,583.0,583.0
0.006,17,2,179,1,71,0.0,43.0,43.0,1,108,0.0,80.0,80.0
0.006,6,10,1854,5,889,1.0,621.0,621.0,5,965,1.0,697.0,697.0
0.005,6,10,1989,5,927,1.0,659.0,659.0,5,1062,1.0,794.0,794.0
0.076,6,10,1506,5,395,16.0,127.0,127.0,5,1111,16.0,843.0,843.0
0.011,6,10,1631,5,848,2.0,580.0,580.0,5,783,2.0,515.0,515.0
0.017,6,10,1631,5,848,4.0,580.0,580.0,5,783,4.0,515.0,515.0
0.004,6,10,1989,5,927,1.0,659.0,659.0,5,1062,1.0,794.0,794.0
0.016,6,10,1972,5,910,4.0,642.0,642.0,5,1062,3.0,794.0,794.0
9.038,17,6,376,5,280,2259.0,28.0,28.0,1,96,0.0,68.0,68.0
0.237,6,10,1506,5,395,33.0,127.0,127.0,5,1111,57.0,843.0,843.0
300.319,6,16,2170,9,684,37518.0,146.0,146.0,7,1486,50024.0,419.0,398.0
0.005,6,10,2007,5,928,1.0,660.0,660.0,5,1079,1.0,811.0,811.0
0.006,6,10,1689,5,839,1.0,571.0,571.0,5,850,1.0,582.0,582.0
0.004,6,10,1774,5,923,1.0,655.0,655.0,5,851,1.0,583.0,583.0
10.978,17,28,4393,14,2311,835.0,586.0,137.0,14,2082,835.0,269.0,120.0
0.006,6,10,1689,5,839,1.0,571.0,571.0,5,850,1.0,582.0,582.0
0.001,17,2,166,1,75,0.0,47.0,47.0,1,91,0.0,63.0,63.0
10.776,17,28,4423,14,1994,820.0,269.0,114.0,14,2429,820.0,588.0,145.0
0.085,6,10,1506,5,395,17.0,127.0,127.0,5,1111,18.0,843.0,843.0
0.007,17,2,166,1,75,0.0,47.0,47.0,1,91,0.0,63.0,63.0
0.005,6,10,2006,5,927,1.0,659.0,659.0,5,1079,1.0,811.0,811.0
0.009,6,10,1677,5,827,2.0,559.0,559.0,5,850,2.0,582.0,582.0
0.005,17,2,169,1,62,0.0,34.0,34.0,1,107,0.0,79.0,79.0
0.005,17,2,214,1,75,0.0,47.0,47.0,1,139,0.0,111.0,111.0
0.094,6,10,1506,5,395,18.0,127.0,127.0,5,1111,22.0,843.0,843.0
0.011,6,10,1631,5,848,2.0,580.0,580.0,5,783,2.0,515.0,515.0
0.006,6,10,1854,5,889,1.0,621.0,621.0,5,965,1.0,697.0,697.0
0.005,6,10,1989,5,927,1.0,659.0,659.0,5,1062,1.0,794.0,794.0
0.006,17,2,214,1,75,0.0,47.0,47.0,1,139,0.0,111.0,111.0
0.166,17,2,152,1,76,0.0,48.0,48.0,1,76,0.0,48.0,48.0
0.005,6,10,2000,5,927,1.0,659.0,659.0,5,1073,1.0,805.0,805.0
0.005,6,10,1989,5,927,1.0,659.0,659.0,5,1062,1.0,794.0,794.0
0.006,6,10,1547,5,764,1.0,496.0,496.0,5,783,1.0,515.0,515.0
0.009,6,10,1989,5,910,2.0,642.0,642.0,5,1079,2.0,811.0,811.0
0.163,17,2,152,1,76,0.0,48.0,48.0,1,76,0.0,48.0,48.0
40.066,17,10,676,5,460,10014.0,104.0,64.0,5,216,10015.0,20.0,15.0
0.011,6,10,1989,5,910,2.0,642.0,642.0,5,1079,2.0,811.0,811.0
240.022,6,9,787,5,488,60005.0,232.0,232.0,4,299,80006.0,83.0,83.0
0.009,6,10,1990,5,911,2.0,643.0,643.0,5,1079,2.0,811.0,811.0
0.003,17,2,148,1,60,0.0,32.0,32.0,1,88,0.0,60.0,60.0
0.011,6,10,1677,5,827,2.0,559.0,559.0,5,850,2.0,582.0,582.0
0.005,17,2,184,1,68,0.0,40.0,40.0,1,116,0.0,88.0,88.0
0.115,6,10,1506,5,395,28.0,127.0,127.0,5,1111,23.0,843.0,843.0
0.005,17,2,170,1,65,0.0,37.0,37.0,1,105,0.0,77.0,77.0
40.056,17,10,676,5,460,10012.0,104.0,64.0,5,216,10013.0,20.0,15.0
0.102,6,10,1506,5,395,22.0,127.0,127.0,5,1111,21.0,843.0,843.0
0.009,6,10,1990,5,911,2.0,643.0,643.0,5,1079,2.0,811.0,811.0
0.072,17,4,284,2,120,0.0,32.0,32.0,2,164,68.0,60.0,54.0
240.088,6,16,4480,9,963,30011.0,238.0,166.0,7,3517,40013.0,1402.0,786.0
0.013,6,10,1989,5,910,3.0,642.0,642.0,5,1079,3.0,811.0,811.0
0.011,6,10,1677,5,827,2.0,559.0,559.0,5,850,2.0,582.0,582.0
0.005,6,10,1779,5,928,1.0,660.0,660.0,5,851,1.0,583.0,583.0
0.011,6,10,1990,5,911,2.0,643.0,643.0,5,1079,2.0,811.0,811.0
0.005,17,2,169,1,62,0.0,34.0,34.0,1,107,0.0,79.0,79.0
291.721,6,308,344151,126,18100,2333.0,2736.0,888.0,182,326051,1611.0,2879.0,1884.0
0.125,6,10,1506,5,395,29.0,127.0,127.0,5,1111,19.0,843.0,843.0
0.062,6,10,1506,5,395,13.0,127.0,127.0,5,1111,14.0,843.0,843.0
1771.567,17,120,11460,60,5460,30026.0,63.0,63.0,60,6000,30026.0,72.0,72.0
172.155,17,72,10244,36,2394,4918.0,44.0,38.0,36,7850,4918.0,239.0,190.0
0.005,6,10,2006,5,927,1.0,659.0,659.0,5,1079,1.0,811.0,811.0
0.018,6,10,1677,5,827,4.0,559.0,559.0,5,850,4.0,582.0,582.0
40.09,17,10,676,5,460,10015.0,104.0,64.0,5,216,10017.0,20.0,15.0
0.166,17,2,152,1,76,0.0,48.0,48.0,1,76,0.0,48.0,48.0
0.086,6,10,1506,5,395,17.0,127.0,127.0,5,1111,18.0,843.0,843.0
0.015,6,13,3735,7,497,2.0,125.0,125.0,6,3238,2.0,1470.0,1459.0
0.038,17,2,152,1,76,0.0,48.0,48.0,1,76,0.0,48.0,48.0
240.033,6,9,787,5,488,60008.0,232.0,232.0,4,299,80010.0,83.0,83.0
0.128,6,10,1506,5,395,29.0,127.0,127.0,5,1111,23.0,843.0,843.0
66.451,6,27,9565,13,1667,69.0,794.0,367.0,14,7898,5101.0,1360.0,732.0
1741.735,6,302,98314,186,87020,9414.0,2001.0,690.0,116,11294,15145.0,452.0,70.0
0.027,6,10,1989,5,910,6.0,642.0,642.0,5,1079,6.0,811.0,811.0
0.009,6,10,1989,5,910,2.0,642.0,642.0,5,1079,2.0,811.0,811.0
0.122,6,10,1506,5,395,26.0,127.0,127.0,5,1111,25.0,843.0,843.0
0.005,6,10,2006,5,927,1.0,659.0,659.0,5,1079,1.0,811.0,811.0
0.01,6,10,1983,5,910,2.0,642.0,642.0,5,1073,2.0,805.0,805.0
0.005,6,10,2006,5,927,1.0,659.0,659.0,5,1079,1.0,811.0,811.0
0.008,6,10,1972,5,910,2.0,642.0,642.0,5,1062,1.0,794.0,794.0
0.021,6,13,3735,7,497,3.0,125.0,125.0,6,3238,4.0,1470.0,1459.0
0.018,6,10,1989,5,910,4.0,642.0,642.0,5,1079,4.0,811.0,811.0
0.005,6,10,2007,5,928,1.0,660.0,660.0,5,1079,1.0,811.0,811.0
11.15,17,28,4423,14,1994,845.0,269.0,114.0,14,2429,845.0,588.0,145.0
0.04,17,2,412,1,61,0.0,33.0,33.0,1,351,0.0,323.0,323.0
240.088,6,31,9172,15,6810,17149.0,1933.0,670.0,16,2362,16005.0,580.0,190.0
0.007,6,10,1547,5,764,1.0,496.0,496.0,5,783,1.0,515.0,515.0
0.113,6,10,1506,5,395,26.0,127.0,127.0,5,1111,25.0,843.0,843.0
0.112,6,10,1506,5,395,22.0,127.0,127.0,5,1111,26.0,843.0,843.0
0.01,6,10,1989,5,910,2.0,642.0,642.0,5,1079,2.0,811.0,811.0
0.004,6,10,2000,5,927,1.0,659.0,659.0,5,1073,1.0,805.0,805.0
353.326,6,20,2210,6,1308,12004.0,494.0,494.0,14,902,27178.0,83.0,83.0
0.011,6,10,1990,5,911,2.0,643.0,643.0,5,1079,2.0,811.0,811.0
40.064,17,10,676,5,460,10013.0,104.0,64.0,5,216,10015.0,20.0,15.0
0.005,6,10,2000,5,927,1.0,659.0,659.0,5,1073,1.0,805.0,805.0
0.005,17,2,170,1,65,0.0,37.0,37.0,1,105,0.0,77.0,77.0
0.006,6,10,1643,5,860,1.0,592.0,592.0,5,783,1.0,515.0,515.0
0.005,6,10,2007,5,928,1.0,660.0,660.0,5,1079,1.0,811.0,811.0
0.005,17,2,180,1,66,0.0,38.0,38.0,1,114,0.0,86.0,86.0
0.025,6,10,1677,5,827,6.0,559.0,559.0,5,850,6.0,582.0,582.0
0.097,6,10,1506,5,395,21.0,127.0,127.0,5,1111,22.0,843.0,843.0
0.006,17,2,230,1,68,0.0,40.0,40.0,1,162,0.0,134.0,134.0
303.981,6,46,29672,24,18647,13216.0,2736.0,1337.0,22,11025,14475.0,1655.0,988.0
0.022,6,13,3913,7,495,3.0,123.0,123.0,6,3418,4.0,1650.0,1549.0
0.011,6,10,1677,5,827,2.0,559.0,559.0,5,850,2.0,582.0,582.0
0.022,6,10,1990,5,911,5.0,643.0,643.0,5,1079,5.0,811.0,811.0
0.003,17,2,136,1,60,0.0,32.0,32.0,1,76,0.0,48.0,48.0
11.162,17,28,4421,14,1994,846.0,269.0,114.0,14,2427,846.0,586.0,145.0
0.005,6,10,1702,5,863,1.0,595.0,595.0,5,839,1.0,571.0,571.0
0.021,17,2,213,1,69,0.0,41.0,41.0,1,144,0.0,116.0,116.0
0.004,6,10,2006,5,927,1.0,659.0,659.0,5,1079,1.0,811.0,811.0
0.016,6,10,1972,5,910,4.0,642.0,642.0,5,1062,3.0,794.0,794.0
0.006,17,2,148,1,60,0.0,32.0,32.0,1,88,0.0,60.0,60.0
0.005,6,10,1989,5,927,1.0,659.0,659.0,5,1062,1.0,794.0,794.0
40.068,17,10,676,5,460,10014.0,104.0,64.0,5,216,10016.0,20.0,15.0
0.076,6,10,1506,5,395,16.0,127.0,127.0,5,1111,14.0,843.0,843.0
0.077,17,4,596,2,122,5.0,33.0,33.0,2,474,73.0,323.0,209.0
0.016,6,10,1990,5,911,3.0,643.0,643.0,5,1079,4.0,811.0,811.0
0.083,6,10,1506,5,395,16.0,127.0,127.0,5,1111,19.0,843.0,843.0
0.004,6,10,1774,5,923,1.0,655.0,655.0,5,851,1.0,583.0,583.0
1.01,6,13,3922,7,2139,126.0,1328.0,923.0,6,1783,151.0,1539.0,1539.0
0.004,6,10,1989,5,927,1.0,659.0,659.0,5,1062,1.0,794.0,794.0
0.009,6,10,1989,5,910,2.0,642.0,642.0,5,1079,2.0,811.0,811.0
40.062,17,10,676,5,460,10014.0,104.0,64.0,5,216,10014.0,20.0,15.0
0.001,17,2,136,1,60,0.0,32.0,32.0,1,76,0.0,48.0,48.0
0.01,17,2,214,1,75,0.0,47.0,47.0,1,139,0.0,111.0,111.0
0.004,6,10,1989,5,927,1.0,659.0,659.0,5,1062,1.0,794.0,794.0
300.409,6,27,8913,14,1878,23108.0,517.0,285.0,13,7035,25033.0,1402.0,909.0
0.191,17,2,202,1,69,0.0,41.0,41.0,1,133,0.0,105.0,105.0
0.005,6,10,2007,5,928,1.0,660.0,660.0,5,1079,1.0,811.0,811.0
0.004,6,10,2000,5,927,1.0,659.0,659.0,5,1073,1.0,805.0,805.0
0.005,17,2,180,1,66,0.0,38.0,38.0,1,114,0.0,86.0,86.0
0.009,6,10,1989,5,910,2.0,642.0,642.0,5,1079,2.0,811.0,811.0
0.027,6,13,3735,7,497,4.0,125.0,125.0,6,3238,5.0,1470.0,1459.0
0.005,17,2,164,1,74,0.0,46.0,46.0,1,90,0.0,62.0,62.0
0.005,6,10,1774,5,923,1.0,655.0,655.0,5,851,1.0,583.0,583.0
0.004,17,2,136,1,60,0.0,32.0,32.0,1,76,0.0,48.0,48.0
0.019,6,10,1631,5,848,4.0,580.0,580.0,5,783,4.0,515.0,515.0
0.012,6,10,1990,5,911,3.0,643.0,643.0,5,1079,2.0,811.0,811.0
0.015,6,10,1762,5,911,3.0,643.0,643.0,5,851,3.0,583.0,583.0
0.06,6,10,1506,5,395,14.0,127.0,127.0,5,1111,11.0,843.0,843.0
0.082,6,10,1506,5,395,17.0,127.0,127.0,5,1111,18.0,843.0,843.0
0.224,6,16,2670,8,1396,32.0,533.0,324.0,8,1274,20.0,529.0,212.0
0.005,6,10,1643,5,860,1.0,592.0,592.0,5,783,1.0,515.0,515.0
0.005,6,10,2007,5,928,1.0,660.0,660.0,5,1079,1.0,811.0,811.0
366.428,6,22,2313,16,867,24428.0,195.0,195.0,6,1446,4635.0,419.0,398.0
0.006,6,13,3690,7,452,0.0,80.0,80.0,6,3238,1.0,1470.0,1459.0
0.005,17,2,166,1,75,0.0,47.0,47.0,1,91,0.0,63.0,63.0
0.131,6,10,1506,5,395,22.0,127.0,127.0,5,1111,31.0,843.0,843.0
0.178,6,10,1506,5,395,36.0,127.0,127.0,5,1111,39.0,843.0,843.0
0.165,6,10,1506,5,395,40.0,127.0,127.0,5,1111,27.0,843.0,843.0
0.013,6,10,1990,5,911,3.0,643.0,643.0,5,1079,3.0,811.0,811.0
0.004,17,2,148,1,60,0.0,32.0,32.0,1,88,0.0,60.0,60.0
0.01,6,12,1926,6,1189,2.0,659.0,434.0,6,737,2.0,417.0,417.0
351.991,6,20,2210,6,1308,12003.0,494.0,494.0,14,902,27076.0,83.0,83.0
0.004,6,10,2007,5,928,1.0,660.0,660.0,5,1079,1.0,811.0,811.0
0.006,6,10,2006,5,927,1.0,659.0,659.0,5,1079,1.0,811.0,811.0
0.006,6,10,2006,5,927,1.0,659.0,659.0,5,1079,1.0,811.0,811.0
240.086,6,16,4480,9,963,30010.0,238.0,166.0,7,3517,40013.0,1402.0,786.0
0.005,6,10,1854,5,889,1.0,621.0,621.0,5,965,1.0,697.0,697.0
300.411,6,16,2170,9,684,37530.0,146.0,146.0,7,1486,50040.0,419.0,398.0
0.105,6,10,1506,5,395,23.0,127.0,127.0,5,1111,22.0,843.0,843.0
0.041,17,2,136,1,60,0.0,32.0,32.0,1,76,0.0,48.0,48.0
0.009,6,10,1972,5,910,2.0,642.0,642.0,5,1062,2.0,794.0,794.0
0.013,6,10,1990,5,911,3.0,643.0,643.0,5,1079,3.0,811.0,811.0
0.007,6,10,1689,5,839,1.0,571.0,571.0,5,850,1.0,582.0,582.0
0.084,6,10,1506,5,395,20.0,127.0,127.0,5,1111,19.0,843.0,843.0
0.185,17,4,352,2,130,144.0,37.0,37.0,2,222,144.0,89.0,83.0
0.016,17,2,179,1,71,0.0,43.0,43.0,1,108,0.0,80.0,80.0
0.005,17,2,213,1,69,0.0,41.0,41.0,1,144,0.0,116.0,116.0
0.005,6,10,2006,5,927,1.0,659.0,659.0,5,1079,1.0,811.0,811.0
0.008,6,10,1983,5,910,2.0,642.0,642.0,5,1073,1.0,805.0,805.0
1792.818,6,488,98853,247,87623,7287.0,421.0,368.0,241,11230,7469.0,53.0,53.0
0.005,17,2,154,1,69,0.0,41.0,41.0,1,85,0.0,57.0,57.0
0.001,17,2,180,1,66,0.0,38.0,38.0,1,114,0.0,86.0,86.0
0.009,6,10,2006,5,927,2.0,659.0,659.0,5,1079,2.0,811.0,811.0
0.082,6,10,1506,5,395,18.0,127.0,127.0,5,1111,20.0,843.0,843.0
47.09,58,3,216,2,144,47090.0,24.0,24.0,1,72,0.0,24.0,24.0
0.012,6,10,1989,5,910,3.0,642.0,642.0,5,1079,3.0,811.0,811.0
1.093,6,13,3930,7,2139,136.0,1328.0,923.0,6,1791,163.0,1539.0,1539.0
0.088,6,10,1506,5,395,16.0,127.0,127.0,5,1111,20.0,843.0,843.0
0.019,17,4,284,2,120,0.0,32.0,32.0,2,164,0.0,60.0,54.0
0.001,17,2,180,1,66,0.0,38.0,38.0,1,114,0.0,86.0,86.0
0.004,6,10,2007,5,928,1.0,660.0,660.0,5,1079,1.0,811.0,811.0
0.106,6,10,1506,5,395,24.0,127.0,127.0,5,1111,22.0,843.0,843.0
0.005,17,2,180,1,66,0.0,38.0,38.0,1,114,0.0,86.0,86.0
0.004,17,2,136,1,60,0.0,32.0,32.0,1,76,0.0,48.0,48.0
368.532,6,24,2405,17,919,23033.0,195.0,195.0,7,1486,3911.0,419.0,398.0
0.004,6,10,1989,5,927,1.0,659.0,659.0,5,1062,1.0,794.0,794.0
0.01,6,10,1989,5,910,2.0,642.0,642.0,5,1079,2.0,811.0,811.0
0.005,6,10,2007,5,928,1.0,660.0,660.0,5,1079,1.0,811.0,811.0
0.004,6,10,2006,5,927,1.0,659.0,659.0,5,1079,1.0,811.0,811.0
308.309,17,20,1124,10,716,34242.0,48.0,43.0,10,408,34242.0,20.0,12.0
0.09,6,10,1506,5,395,15.0,127.0,127.0,5,1111,21.0,843.0,843.0
0.005,17,2,166,1,75,0.0,47.0,47.0,1,91,0.0,63.0,63.0
0.001,17,2,180,1,66,0.0,38.0,38.0,1,114,0.0,86.0,86.0
0.069,6,10,1506,5,395,13.0,127.0,127.0,5,1111,16.0,843.0,843.0
0.013,6,10,1972,5,910,3.0,642.0,642.0,5,1062,3.0,794.0,794.0
29.233,6,36,9526,18,4008,520.0,1543.0,814.0,18,5518,1709.0,2667.0,435.0
0.01,6,10,1762,5,911,2.0,643.0,643.0,5,851,2.0,583.0,583.0
556.222,6,56,22508,29,5258,19863.0,676.0,467.0,27,17250,21391.0,1402.0,932.0
0.011,6,10,1989,5,910,2.0,642.0,642.0,5,1079,2.0,811.0,811.0
240.658,6,37,6868,18,3278,14156.0,880.0,333.0,19,3590,13369.0,1306.0,370.0
0.004,6,10,2006,5,927,1.0,659.0,659.0,5,1079,1.0,811.0,811.0
1792.587,6,549,188368,277,162737,6494.0,2883.0,921.0,272,25631,6614.0,366.0,116.0
0.007,6,10,1547,5,764,1.0,496.0,496.0,5,783,1.0,515.0,515.0
0.006,6,10,1547,5,764,1.0,496.0,496.0,5,783,1.0,515.0,515.0
0.059,6,10,1506,5,395,13.0,127.0,127.0,5,1111,13.0,843.0,843.0
0.168,17,2,152,1,76,0.0,48.0,48.0,1,76,0.0,48.0,48.0
0.006,6,10,1547,5,764,1.0,496.0,496.0,5,783,1.0,515.0,515.0
0.019,6,10,1677,5,827,4.0,559.0,559.0,5,850,4.0,582.0,582.0
0.004,17,4,284,2,120,0.0,32.0,32.0,2,164,0.0,60.0,54.0
0.006,6,10,1689,5,839,1.0,571.0,571.0,5,850,1.0,582.0,582.0
0.1,6,10,1506,5,395,20.0,127.0,127.0,5,1111,21.0,843.0,843.0
0.014,6,10,1631,5,848,3.0,580.0,580.0,5,783,3.0,515.0,515.0
0.117,6,10,1506,5,395,24.0,127.0,127.0,5,1111,28.0,843.0,843.0
0.084,6,10,1506,5,395,18.0,127.0,127.0,5,1111,19.0,843.0,843.0
0.1,6,10,1506,5,395,23.0,127.0,127.0,5,1111,22.0,843.0,843.0
0.079,6,10,1506,5,395,17.0,127.0,127.0,5,1111,14.0,843.0,843.0
0.012,6,10,1989,5,910,2.0,642.0,642.0,5,1079,2.0,811.0,811.0
0.004,6,10,2000,5,927,1.0,659.0,659.0,5,1073,1.0,805.0,805.0
0.005,17,2,170,1,65,0.0,37.0,37.0,1,105,0.0,77.0,77.0
0.008,6,10,1990,5,911,2.0,643.0,643.0,5,1079,2.0,811.0,811.0
0.006,6,10,1547,5,764,1.0,496.0,496.0,5,783,1.0,515.0,515.0
0.006,6,10,1547,5,764,1.0,496.0,496.0,5,783,1.0,515.0,515.0
0.012,6,10,1989,5,910,3.0,642.0,642.0,5,1079,3.0,811.0,811.0
0.012,6,10,1677,5,827,3.0,559.0,559.0,5,850,2.0,582.0,582.0
0.016,6,10,1631,5,848,4.0,580.0,580.0,5,783,3.0,515.0,515.0
0.09,6,10,1506,5,395,18.0,127.0,127.0,5,1111,21.0,843.0,843.0
0.13,6,10,1506,5,395,30.0,127.0,127.0,5,1111,30.0,843.0,843.0
0.006,6,10,1547,5,764,1.0,496.0,496.0,5,783,1.0,515.0,515.0
0.02,6,10,1990,5,911,5.0,643.0,643.0,5,1079,5.0,811.0,811.0
0.003,17,2,185,1,73,0.0,45.0,45.0,1,112,0.0,84.0,84.0
0.068,17,2,144,1,64,0.0,36.0,36.0,1,80,0.0,52.0,52.0
0.018,6,10,1990,5,911,4.0,643.0,643.0,5,1079,4.0,811.0,811.0
0.013,6,10,1989,5,910,3.0,642.0,642.0,5,1079,3.0,811.0,811.0
0.187,6,10,1506,5,395,46.0,127.0,127.0,5,1111,43.0,843.0,843.0
0.005,6,10,1643,5,860,1.0,592.0,592.0,5,783,1.0,515.0,515.0
309.325,17,20,1124,10,716,34355.0,48.0,43.0,10,408,34355.0,20.0,12.0
0.006,6,10,1547,5,764,1.0,496.0,496.0,5,783,1.0,515.0,515.0
0.096,6,10,1506,5,395,21.0,127.0,127.0,5,1111,22.0,843.0,843.0
0.021,6,10,1990,5,911,5.0,643.0,643.0,5,1079,5.0,811.0,811.0
0.004,6,10,2006,5,927,1.0,659.0,659.0,5,1079,1.0,811.0,811.0
0.089,6,10,1506,5,395,19.0,127.0,127.0,5,1111,19.0,843.0,843.0
15.072,17,15,9238,8,6902,2149.0,1350.0,834.0,7,2336,2507.0,1350.0,305.0
0.005,6,10,2006,5,927,1.0,659.0,659.0,5,1079,1.0,811.0,811.0
0.007,6,14,3799,7,509,1.0,137.0,137.0,7,3290,1.0,1448.0,972.0
0.005,6,10,1989,5,927,1.0,659.0,659.0,5,1062,1.0,794.0,794.0
0.008,6,14,3787,7,497,1.0,125.0,125.0,7,3290,1.0,1448.0,972.0
1769.251,17,92,8096,46,4048,39316.0,60.0,60.0,46,4048,39316.0,60.0,60.0
0.005,6,10,2007,5,928,1.0,660.0,660.0,5,1079,1.0,811.0,811.0
0.015,6,10,1989,5,910,3.0,642.0,642.0,5,1079,3.0,811.0,811.0
8.964,6,36,9771,19,4293,498.0,1360.0,700.0,17,5478,547.0,2667.0,435.0
0.005,6,10,1643,5,860,1.0,592.0,592.0,5,783,1.0,515.0,515.0
0.006,17,2,367,1,99,0.0,71.0,71.0,1,268,0.0,240.0,240.0
0.012,6,10,1989,5,910,3.0,642.0,642.0,5,1079,3.0,811.0,811.0
0.076,6,10,1506,5,395,17.0,127.0,127.0,5,1111,17.0,843.0,843.0
0.01,6,10,1989,5,910,2.0,642.0,642.0,5,1079,2.0,811.0,811.0
0.221,6,10,1506,5,395,51.0,127.0,127.0,5,1111,33.0,843.0,843.0
0.004,17,2,136,1,60,0.0,32.0,32.0,1,76,0.0,48.0,48.0
0.003,17,2,148,1,60,0.0,32.0,32.0,1,88,0.0,60.0,60.0
370.973,6,24,2405,17,919,23185.0,195.0,195.0,7,1486,3913.0,419.0,398.0
0.004,17,2,136,1,60,0.0,32.0,32.0,1,76,0.0,48.0,48.0
0.013,6,10,2006,5,927,3.0,659.0,659.0,5,1079,3.0,811.0,811.0
0.004,6,10,2006,5,927,1.0,659.0,659.0,5,1079,1.0,811.0,811.0
308.603,17,18,1008,9,640,38559.0,48.0,43.0,9,368,38559.0,20.0,12.0
0.106,6,10,1506,5,395,26.0,127.0,127.0,5,1111,23.0,843.0,843.0
0.004,6,10,2007,5,928,1.0,660.0,660.0,5,1079,1.0,811.0,811.0
240.163,6,17,7290,9,2024,30020.0,1496.0,780.0,8,5266,34308.0,2802.0,1210.0
0.004,6,10,2006,5,927,1.0,659.0,659.0,5,1079,1.0,811.0,811.0
0.009,6,10,1990,5,911,2.0,643.0,643.0,5,1079,2.0,811.0,811.0
0.004,6,10,2006,5,927,1.0,659.0,659.0,5,1079,1.0,811.0,811.0
0.004,6,10,2007,5,928,1.0,660.0,660.0,5,1079,1.0,811.0,811.0
0.007,17,2,214,1,75,0.0,47.0,47.0,1,139,0.0,111.0,111.0
0.005,6,10,1989,5,927,1.0,659.0,659.0,5,1062,1.0,794.0,794.0
0.076,6,10,1506,5,395,15.0,127.0,127.0,5,1111,18.0,843.0,843.0
15.086,17,15,8398,8,6216,2151.0,1350.0,749.0,7,2182,2509.0,1350.0,283.0
40.056,17,10,676,5,460,10011.0,104.0,64.0,5,216,10013.0,20.0,15.0
0.008,6,10,1983,5,910,2.0,642.0,642.0,5,1073,1.0,805.0,805.0
0.013,6,10,1989,5,910,3.0,642.0,642.0,5,1079,3.0,811.0,811.0
0.009,6,10,1990,5,911,2.0,643.0,643.0,5,1079,2.0,811.0,811.0
0.005,17,2,164,1,74,0.0,46.0,46.0,1,90,0.0,62.0,62.0
0.014,6,10,1677,5,827,3.0,559.0,559.0,5,850,3.0,582.0,582.0
0.771,6,26,5552,13,1650,56.0,325.0,140.0,13,3902,55.0,1414.0,563.0
291.767,6,390,347431,198,21856,1481.0,2736.0,888.0,192,325575,1527.0,2804.0,1772.0
0.072,17,4,284,2,120,1.0,32.0,32.0,2,164,68.0,60.0,54.0
0.259,17,2,152,1,76,0.0,48.0,48.0,1,76,0.0,48.0,48.0
0.019,6,10,1972,5,910,4.0,642.0,642.0,5,1062,4.0,794.0,794.0
0.039,17,2,152,1,76,0.0,48.0,48.0,1,76,0.0,48.0,48.0
0.08,6,10,1506,5,395,15.0,127.0,127.0,5,1111,18.0,843.0,843.0
0.001,17,2,180,1,66,0.0,38.0,38.0,1,114,0.0,86.0,86.0
0.015,6,10,1972,5,910,3.0,642.0,642.0,5,1062,3.0,794.0,794.0
0.091,6,10,1506,5,395,18.0,127.0,127.0,5,1111,20.0,843.0,843.0
0.005,17,2,148,1,60,0.0,32.0,32.0,1,88,0.0,60.0,60.0
0.066,6,10,1506,5,395,15.0,127.0,127.0,5,1111,15.0,843.0,843.0
10.86,17,28,4421,14,1993,827.0,268.0,114.0,14,2428,827.0,587.0,145.0
10.806,17,28,4418,14,1994,823.0,269.0,114.0,14,2424,823.0,587.0,145.0
0.133,6,10,1506,5,395,27.0,127.0,127.0,5,1111,30.0,843.0,843.0
0.068,6,10,1506,5,395,14.0,127.0,127.0,5,1111,14.0,843.0,843.0
180.44,6,392,348095,193,21571,939.0,2691.0,885.0,199,326524,9.0,2804.0,1664.0
0.005,17,2,170,1,65,0.0,37.0,37.0,1,105,0.0,77.0,77.0
0.005,6,13,3747,7,509,0.0,137.0,137.0,6,3238,0.0,1470.0,1459.0
0.135,17,2,412,1,61,0.0,33.0,33.0,1,351,0.0,323.0,323.0
0.006,6,10,1547,5,764,1.0,496.0,496.0,5,783,1.0,515.0,515.0
0.015,6,10,1990,5,911,3.0,643.0,643.0,5,1079,3.0,811.0,811.0
0.019,6,10,1989,5,910,4.0,642.0,642.0,5,1079,4.0,811.0,811.0
0.006,17,2,214,1,75,0.0,47.0,47.0,1,139,0.0,111.0,111.0
0.007,6,10,1547,5,764,1.0,496.0,496.0,5,783,1.0,515.0,515.0
0.013,6,10,1989,5,910,3.0,642.0,642.0,5,1079,3.0,811.0,811.0
0.081,6,10,1506,5,395,19.0,127.0,127.0,5,1111,16.0,843.0,843.0
0.005,6,10,2006,5,927,1.0,659.0,659.0,5,1079,1.0,811.0,811.0
0.077,6,10,1506,5,395,17.0,127.0,127.0,5,1111,16.0,843.0,843.0
0.001,17,2,180,1,66,0.0,38.0,38.0,1,114,0.0,86.0,86.0
0.004,6,10,1779,5,928,1.0,660.0,660.0,5,851,1.0,583.0,583.0
0.008,6,10,1547,5,764,2.0,496.0,496.0,5,783,1.0,515.0,515.0
0.012,6,10,1990,5,911,3.0,643.0,643.0,5,1079,2.0,811.0,811.0
0.072,17,2,128,1,56,0.0,28.0,28.0,1,72,0.0,44.0,44.0
0.01,6,10,1989,5,910,2.0,642.0,642.0,5,1079,2.0,811.0,811.0
0.009,6,10,1989,5,910,2.0,642.0,642.0,5,1079,2.0,811.0,811.0
0.073,6,10,1506,5,395,16.0,127.0,127.0,5,1111,17.0,843.0,843.0
0.01,6,14,3787,7,497,1.0,125.0,125.0,7,3290,1.0,1448.0,972.0
0.009,6,10,1990,5,911,2.0,643.0,643.0,5,1079,2.0,811.0,811.0
0.006,6,10,1547,5,764,1.0,496.0,496.0,5,783,1.0,515.0,515.0
10.876,17,28,4421,14,1993,827.0,268.0,114.0,14,2428,827.0,587.0,145.0
0.005,6,10,2007,5,928,1.0,660.0,660.0,5,1079,1.0,811.0,811.0
0.001,17,2,136,1,60,0.0,32.0,32.0,1,76,0.0,48.0,48.0
0.006,6,10,1689,5,839,1.0,571.0,571.0,5,850,1.0,582.0,582.0
0.07,6,10,1506,5,395,14.0,127.0,127.0,5,1111,15.0,843.0,843.0
0.004,17,4,284,2,120,0.0,32.0,32.0,2,164,0.0,60.0,54.0
0.011,6,10,1983,5,910,2.0,642.0,642.0,5,1073,2.0,805.0,805.0
40.07,17,10,676,5,460,10015.0,104.0,64.0,5,216,10016.0,20.0,15.0
0.005,17,2,140,1,62,0.0,34.0,34.0,1,78,0.0,50.0,50.0
0.042,17,2,170,1,65,0.0,37.0,37.0,1,105,0.0,77.0,77.0
40.076,17,10,676,5,460,10015.0,104.0,64.0,5,216,10018.0,20.0,15.0
0.012,6,10,1989,5,910,2.0,642.0,642.0,5,1079,2.0,811.0,811.0
0.078,6,10,1506,5,395,16.0,127.0,127.0,5,1111,19.0,843.0,843.0
0.007,17,4,284,2,120,5.0,32.0,32.0,2,164,4.0,60.0,54.0
40.057,17,10,676,5,460,10012.0,104.0,64.0,5,216,10013.0,20.0,15.0
0.005,6,10,1779,5,928,1.0,660.0,660.0,5,851,1.0,583.0,583.0
0.062,6,10,1506,5,395,15.0,127.0,127.0,5,1111,13.0,843.0,843.0
0.014,6,10,1990,5,911,3.0,643.0,643.0,5,1079,3.0,811.0,811.0
0.008,17,2,136,1,60,0.0,32.0,32.0,1,76,0.0,48.0,48.0
0.006,6,10,1689,5,839,1.0,571.0,571.0,5,850,1.0,582.0,582.0
0.39,17,43,20608,24,17185,16.0,1350.0,688.0,19,3423,17.0,1350.0,152.0
164.388,17,72,10288,36,2402,4696.0,44.0,38.0,36,7886,4696.0,261.0,191.0
0.005,6,10,2007,5,928,1.0,660.0,660.0,5,1079,1.0,811.0,811.0
0.018,6,10,1983,5,910,4.0,642.0,642.0,5,1073,4.0,805.0,805.0
0.017,6,10,1762,5,911,4.0,643.0,643.0,5,851,4.0,583.0,583.0
0.087,6,10,1506,5,395,19.0,127.0,127.0,5,1111,17.0,843.0,843.0
0.006,17,2,170,1,65,0.0,37.0,37.0,1,105,0.0,77.0,77.0
0.003,17,2,148,1,60,0.0,32.0,32.0,1,88,0.0,60.0,60.0
11.095,17,28,4397,14,2311,844.0,586.0,137.0,14,2086,844.0,269.0,121.0
0.006,6,10,2007,5,928,1.0,660.0,660.0,5,1079,1.0,811.0,811.0
0.005,17,4,284,2,120,1.0,32.0,32.0,2,164,1.0,60.0,54.0
0.04,17,2,136,1,60,0.0,32.0,32.0,1,76,0.0,48.0,48.0
0.005,6,10,1989,5,927,1.0,659.0,659.0,5,1062,1.0,794.0,794.0
0.009,6,10,1983,5,910,2.0,642.0,642.0,5,1073,2.0,805.0,805.0
0.005,6,10,2006,5,927,1.0,659.0,659.0,5,1079,1.0,811.0,811.0
65.667,6,27,17554,15,9615,4690.0,2804.0,1471.0,12,7939,5955.0,2424.0,1217.0
0.005,6,10,2006,5,927,1.0,659.0,659.0,5,1079,1.0,811.0,811.0
0.142,6,10,1506,5,395,32.0,127.0,127.0,5,1111,33.0,843.0,843.0
0.097,6,10,1506,5,395,23.0,127.0,127.0,5,1111,22.0,843.0,843.0
0.016,6,10,1983,5,910,3.0,642.0,642.0,5,1073,3.0,805.0,805.0
0.017,6,14,3787,7,497,2.0,125.0,125.0,7,3290,2.0,1448.0,972.0
0.049,17,2,156,1,64,0.0,36.0,36.0,1,92,0.0,64.0,64.0
0.087,6,10,1506,5,395,18.0,127.0,127.0,5,1111,19.0,843.0,843.0
0.009,17,2,148,1,60,0.0,32.0,32.0,1,88,0.0,60.0,60.0
0.088,6,10,1506,5,395,20.0,127.0,127.0,5,1111,19.0,843.0,843.0
240.095,6,16,4480,9,963,30011.0,238.0,166.0,7,3517,40015.0,1402.0,786.0
0.07,6,10,1506,5,395,16.0,127.0,127.0,5,1111,15.0,843.0,843.0
0.407,17,2,144,1,64,0.0,36.0,36.0,1,80,0.0,52.0,52.0
0.104,6,10,1506,5,395,22.0,127.0,127.0,5,1111,23.0,843.0,843.0
0.005,6,10,2006,5,927,1.0,659.0,659.0,5,1079,1.0,811.0,811.0
0.013,6,10,1631,5,848,3.0,580.0,580.0,5,783,3.0,515.0,515.0
0.06,6,10,1506,5,395,13.0,127.0,127.0,5,1111,14.0,843.0,843.0
172.373,17,94,13431,47,3170,3747.0,44.0,39.0,47,10261,3747.0,239.0,190.0
40.064,17,10,676,5,460,10015.0,104.0,64.0,5,216,10015.0,20.0,15.0
0.01,6,10,1989,5,910,2.0,642.0,642.0,5,1079,2.0,811.0,811.0
0.006,17,2,180,1,66,0.0,38.0,38.0,1,114,0.0,86.0,86.0
0.005,6,10,1643,5,860,1.0,592.0,592.0,5,783,1.0,515.0,515.0
0.007,17,2,194,1,59,0.0,31.0,31.0,1,135,0.0,107.0,107.0
0.022,6,10,1990,5,911,5.0,643.0,643.0,5,1079,5.0,811.0,811.0
0.007,6,10,1547,5,764,1.0,496.0,496.0,5,783,1.0,515.0,515.0
310.289,17,20,1124,10,716,34462.0,48.0,43.0,10,408,34462.0,20.0,12.0
0.068,6,10,1506,5,395,15.0,127.0,127.0,5,1111,11.0,843.0,843.0
240.019,6,9,787,5,488,60004.0,232.0,232.0,4,299,80005.0,83.0,83.0
0.006,6,10,1547,5,764,1.0,496.0,496.0,5,783,1.0,515.0,515.0
0.004,6,10,2007,5,928,1.0,660.0,660.0,5,1079,1.0,811.0,811.0
0.112,6,10,1506,5,395,25.0,127.0,127.0,5,1111,25.0,843.0,843.0
0.011,6,13,3735,7,497,1.0,125.0,125.0,6,3238,2.0,1470.0,1459.0
0.006,6,10,1547,5,764,1.0,496.0,496.0,5,783,1.0,515.0,515.0
0.165,6,10,1506,5,395,38.0,127.0,127.0,5,1111,36.0,843.0,843.0
40.055,17,10,676,5,460,10012.0,104.0,64.0,5,216,10012.0,20.0,15.0
40.067,17,10,676,5,460,10015.0,104.0,64.0,5,216,10015.0,20.0,15.0
0.005,6,10,2006,5,927,1.0,659.0,659.0,5,1079,1.0,811.0,811.0
0.003,17,4,284,2,120,0.0,32.0,32.0,2,164,0.0,60.0,54.0
0.153,6,10,1506,5,395,34.0,127.0,127.0,5,1111,29.0,843.0,843.0
240.011,6,9,787,5,488,60002.0,232.0,232.0,4,299,80002.0,83.0,83.0
0.005,6,10,2007,5,928,1.0,660.0,660.0,5,1079,1.0,811.0,811.0
0.005,6,10,1989,5,927,1.0,659.0,659.0,5,1062,1.0,794.0,794.0
0.005,6,10,2006,5,927,1.0,659.0,659.0,5,1079,1.0,811.0,811.0
40.081,17,10,676,5,460,10015.0,104.0,64.0,5,216,10019.0,20.0,15.0
0.01,6,10,1989,5,910,2.0,642.0,642.0,5,1079,2.0,811.0,811.0
100.97,6,22,8497,12,2236,72.0,1345.0,574.0,10,6261,11200.0,1776.0,974.0
0.01,6,10,1989,5,910,2.0,642.0,642.0,5,1079,2.0,811.0,811.0
0.005,6,13,3747,7,509,0.0,137.0,137.0,6,3238,0.0,1470.0,1459.0
60.713,6,26,17508,14,9563,4670.0,2804.0,1473.0,12,7945,5507.0,2111.0,1044.0
0.001,17,2,180,1,66,0.0,38.0,38.0,1,114,0.0,86.0,86.0
0.006,6,10,1547,5,764,1.0,496.0,496.0,5,783,1.0,515.0,515.0
0.009,6,10,1990,5,911,2.0,643.0,643.0,5,1079,2.0,811.0,811.0
0.004,6,10,2007,5,928,1.0,660.0,660.0,5,1079,1.0,811.0,811.0
0.011,17,2,138,1,61,0.0,33.0,33.0,1,77,0.0,49.0,49.0
0.115,6,10,1506,5,395,26.0,127.0,127.0,5,1111,22.0,843.0,843.0
0.1,6,10,1506,5,395,21.0,127.0,127.0,5,1111,20.0,843.0,843.0
0.012,6,10,1972,5,910,3.0,642.0,642.0,5,1062,2.0,794.0,794.0
0.006,6,10,2000,5,927,1.0,659.0,659.0,5,1073,1.0,805.0,805.0
0.004,6,10,2000,5,927,1.0,659.0,659.0,5,1073,1.0,805.0,805.0
1730.202,6,64,7360,42,4484,42200.0,1640.0,109.0,22,2876,82382.0,1112.0,82.0
0.004,17,2,148,1,60,0.0,32.0,32.0,1,88,0.0,60.0,60.0
0.005,6,10,1547,5,764,1.0,496.0,496.0,5,783,1.0,515.0,515.0
0.003,17,2,136,1,60,0.0,32.0,32.0,1,76,0.0,48.0,48.0
0.104,6,10,1506,5,395,24.0,127.0,127.0,5,1111,22.0,843.0,843.0
0.111,6,10,1506,5,395,26.0,127.0,127.0,5,1111,26.0,843.0,843.0
0.01,6,10,1989,5,910,2.0,642.0,642.0,5,1079,2.0,811.0,811.0
0.009,6,12,1926,6,1189,1.0,659.0,434.0,6,737,1.0,417.0,417.0
0.005,6,14,3799,7,509,0.0,137.0,137.0,7,3290,0.0,1448.0,972.0
0.009,6,10,1631,5,848,2.0,580.0,580.0,5,783,2.0,515.0,515.0
0.004,17,2,164,1,74,0.0,46.0,46.0,1,90,0.0,62.0,62.0
0.128,17,2,80,1,32,0.0,4.0,4.0,1,48,0.0,20.0,20.0
0.216,6,16,2669,8,1395,30.0,533.0,323.0,8,1274,19.0,529.0,212.0
0.004,6,10,1702,5,863,1.0,595.0,595.0,5,839,0.0,571.0,571.0
0.007,6,10,1547,5,764,1.0,496.0,496.0,5,783,1.0,515.0,515.0
0.005,17,2,146,1,65,0.0,37.0,37.0,1,81,0.0,53.0,53.0
0.007,6,10,1547,5,764,1.0,496.0,496.0,5,783,1.0,515.0,515.0
0.004,6,10,2000,5,927,1.0,659.0,659.0,5,1073,1.0,805.0,805.0
246.77,6,22,4793,9,963,30846.0,238.0,166.0,13,3830,20564.0,1402.0,786.0
0.011,6,10,1990,5,911,2.0,643.0,643.0,5,1079,2.0,811.0,811.0
0.011,6,14,3787,7,497,1.0,125.0,125.0,7,3290,1.0,1448.0,972.0
0.128,17,2,80,1,32,0.0,4.0,4.0,1,48,0.0,20.0,20.0
0.012,6,10,1990,5,911,3.0,643.0,643.0,5,1079,2.0,811.0,811.0
369.375,6,22,2313,16,867,24625.0,195.0,195.0,6,1446,4681.0,419.0,398.0
0.001,17,2,179,1,62,0.0,34.0,34.0,1,117,0.0,89.0,89.0
0.004,17,2,148,1,60,0.0,32.0,32.0,1,88,0.0,60.0,60.0
0.005,6,10,2007,5,928,1.0,660.0,660.0,5,1079,1.0,811.0,811.0
167.024,17,78,11037,39,2601,4395.0,44.0,38.0,39,8436,4395.0,239.0,188.0
0.007,17,2,194,1,59,0.0,31.0,31.0,1,135,0.0,107.0,107.0
0.039,17,4,420,2,122,0.0,33.0,33.0,2,298,36.0,145.0,121.0
0.004,6,10,2006,5,927,1.0,659.0,659.0,5,1079,1.0,811.0,811.0
0.015,6,10,1989,5,910,3.0,642.0,642.0,5,1079,3.0,811.0,811.0
0.007,6,10,1547,5,764,1.0,496.0,496.0,5,783,1.0,515.0,515.0
0.113,6,10,1506,5,395,24.0,127.0,127.0,5,1111,24.0,843.0,843.0
353.986,6,19,1691,15,978,25284.0,190.0,190.0,4,713,80002.0,497.0,497.0
40.085,17,10,676,5,460,10020.0,104.0,64.0,5,216,10020.0,20.0,15.0
0.099,6,10,1506,5,395,22.0,127.0,127.0,5,1111,20.0,843.0,843.0
0.096,6,10,1506,5,395,22.0,127.0,127.0,5,1111,23.0,843.0,843.0
0.006,17,2,170,1,65,0.0,37.0,37.0,1,105,0.0,77.0,77.0
40.067,17,10,676,5,460,10016.0,104.0,64.0,5,216,10015.0,20.0,15.0
0.014,6,10,1990,5,911,3.0,643.0,643.0,5,1079,3.0,811.0,811.0
0.126,6,10,1506,5,395,30.0,127.0,127.0,5,1111,28.0,843.0,843.0
0.011,6,10,1677,5,827,2.0,559.0,559.0,5,850,2.0,582.0,582.0
0.014,6,10,1983,5,910,3.0,642.0,642.0,5,1073,3.0,805.0,805.0
0.04,17,2,182,1,65,0.0,37.0,37.0,1,117,0.0,89.0,89.0
0.001,17,2,180,1,66,0.0,38.0,38.0,1,114,0.0,86.0,86.0
0.098,6,10,1506,5,395,24.0,127.0,127.0,5,1111,23.0,843.0,843.0
0.004,17,2,144,1,64,0.0,36.0,36.0,1,80,0.0,52.0,52.0
0.01,6,13,3735,7,497,1.0,125.0,125.0,6,3238,2.0,1470.0,1459.0
0.01,6,10,1983,5,910,2.0,642.0,642.0,5,1073,2.0,805.0,805.0
0.004,17,2,166,1,75,0.0,47.0,47.0,1,91,0.0,63.0,63.0
0.004,6,10,1702,5,863,1.0,595.0,595.0,5,839,0.0,571.0,571.0
0.005,6,10,1989,5,927,1.0,659.0,659.0,5,1062,1.0,794.0,794.0
0.005,6,10,1547,5,764,1.0,496.0,496.0,5,783,1.0,515.0,515.0
0.005,17,2,166,1,75,0.0,47.0,47.0,1,91,0.0,63.0,63.0
0.072,17,4,284,2,120,0.0,32.0,32.0,2,164,68.0,60.0,54.0
0.005,6,14,3799,7,509,0.0,137.0,137.0,7,3290,0.0,1448.0,972.0
0.143,6,10,1506,5,395,32.0,127.0,127.0,5,1111,34.0,843.0,843.0
0.001,17,2,180,1,66,0.0,38.0,38.0,1,114,0.0,86.0,86.0
0.005,6,10,2006,5,927,1.0,659.0,659.0,5,1079,1.0,811.0,811.0
0.013,6,10,1972,5,910,3.0,642.0,642.0,5,1062,3.0,794.0,794.0
0.017,6,10,1972,5,910,4.0,642.0,642.0,5,1062,4.0,794.0,794.0
354.009,6,21,1795,16,1030,23600.0,190.0,190.0,5,765,60002.0,464.0,248.0
0.092,6,10,1506,5,395,17.0,127.0,127.0,5,1111,22.0,843.0,843.0
0.008,6,10,1989,5,910,2.0,642.0,642.0,5,1079,2.0,811.0,811.0
0.013,6,10,1989,5,910,3.0,642.0,642.0,5,1079,3.0,811.0,811.0
0.006,17,2,222,1,65,0.0,37.0,37.0,1,157,0.0,129.0,129.0
0.037,17,2,136,1,60,0.0,32.0,32.0,1,76,0.0,48.0,48.0
0.011,6,10,1983,5,910,2.0,642.0,642.0,5,1073,2.0,805.0,805.0
0.015,6,10,1972,5,910,3.0,642.0,642.0,5,1062,3.0,794.0,794.0
0.005,6,10,2007,5,928,1.0,660.0,660.0,5,1079,1.0,811.0,811.0
15.074,17,15,9238,8,6902,2149.0,1350.0,834.0,7,2336,2507.0,1350.0,305.0
0.005,17,2,144,1,64,0.0,36.0,36.0,1,80,0.0,52.0,52.0
0.01,6,10,1762,5,911,2.0,643.0,643.0,5,851,2.0,583.0,583.0
0.005,6,10,2006,5,927,1.0,659.0,659.0,5,1079,1.0,811.0,811.0
0.005,6,10,1779,5,928,1.0,660.0,660.0,5,851,1.0,583.0,583.0
10.915,17,28,4419,14,1994,831.0,269.0,114.0,14,2425,831.0,588.0,145.0
126.075,6,14,2938,8,2504,17976.0,1414.0,1086.0,6,434,25167.0,182.0,182.0
40.057,17,10,676,5,460,10013.0,104.0,64.0,5,216,10013.0,20.0,15.0
0.137,6,10,1506,5,395,31.0,127.0,127.0,5,1111,29.0,843.0,843.0
0.004,6,10,1774,5,923,1.0,655.0,655.0,5,851,1.0,583.0,583.0
40.077,17,10,676,5,460,10017.0,104.0,64.0,5,216,10018.0,20.0,15.0
0.001,17,2,136,1,60,0.0,32.0,32.0,1,76,0.0,48.0,48.0
0.01,6,10,1990,5,911,2.0,643.0,643.0,5,1079,2.0,811.0,811.0
0.005,6,10,1779,5,928,1.0,660.0,660.0,5,851,1.0,583.0,583.0
0.005,6,14,3736,7,446,0.0,74.0,74.0,7,3290,0.0,1448.0,972.0
0.127,17,2,412,1,61,0.0,33.0,33.0,1,351,0.0,323.0,323.0
167.037,17,84,11976,42,2816,4074.0,44.0,39.0,42,9160,4074.0,239.0,190.0
0.016,6,10,1972,5,910,4.0,642.0,642.0,5,1062,4.0,794.0,794.0
0.038,17,2,170,1,65,0.0,37.0,37.0,1,105,0.0,77.0,77.0
0.09,6,10,1506,5,395,21.0,127.0,127.0,5,1111,20.0,843.0,843.0
0.005,6,13,3690,7,452,0.0,80.0,80.0,6,3238,1.0,1470.0,1459.0
40.073,17,10,676,5,460,10015.0,104.0,64.0,5,216,10017.0,20.0,15.0
0.075,6,10,1506,5,395,17.0,127.0,127.0,5,1111,15.0,843.0,843.0
0.001,17,2,179,1,62,0.0,34.0,34.0,1,117,0.0,89.0,89.0
0.012,6,10,1990,5,911,3.0,643.0,643.0,5,1079,3.0,811.0,811.0
0.003,17,4,284,2,120,0.0,32.0,32.0,2,164,0.0,60.0,54.0
0.048,17,2,170,1,65,0.0,37.0,37.0,1,105,0.0,77.0,77.0
0.004,17,2,136,1,60,0.0,32.0,32.0,1,76,0.0,48.0,48.0
0.003,17,2,136,1,60,0.0,32.0,32.0,1,76,0.0,48.0,48.0
0.071,17,4,284,2,120,0.0,32.0,32.0,2,164,67.0,60.0,54.0
1778.117,17,144,41760,72,22752,25043.0,288.0,288.0,72,19008,25043.0,236.0,236.0
0.042,17,4,284,2,120,0.0,32.0,32.0,2,164,38.0,60.0,54.0
0.014,6,10,1990,5,911,3.0,643.0,643.0,5,1079,3.0,811.0,811.0
0.007,6,10,1547,5,764,1.0,496.0,496.0,5,783,1.0,515.0,515.0
0.006,6,10,1689,5,839,1.0,571.0,571.0,5,850,1.0,582.0,582.0
0.006,6,10,1643,5,860,1.0,592.0,592.0,5,783,1.0,515.0,515.0
170.146,17,86,12109,43,2895,4051.0,44.0,39.0,43,9214,4051.0,239.0,186.0
0.124,17,2,80,1,32,0.0,4.0,4.0,1,48,0.0,20.0,20.0
1783.463,6,321,77586,147,60471,12215.0,2736.0,1015.0,174,17115,10308.0,580.0,68.0
1792.722,6,484,98693,243,87463,7407.0,421.0,368.0,241,11230,7469.0,53.0,53.0
0.006,17,4,284,2,120,0.0,32.0,32.0,2,164,0.0,60.0,54.0
0.005,6,10,2000,5,927,1.0,659.0,659.0,5,1073,1.0,805.0,805.0
0.091,17,2,170,1,65,0.0,37.0,37.0,1,105,0.0,77.0,77.0
0.006,6,10,1547,5,764,1.0,496.0,496.0,5,783,1.0,515.0,515.0
0.005,6,10,2006,5,927,1.0,659.0,659.0,5,1079,1.0,811.0,811.0
0.005,17,2,169,1,62,0.0,34.0,34.0,1,107,0.0,79.0,79.0
0.087,6,10,1506,5,395,18.0,127.0,127.0,5,1111,20.0,843.0,843.0
0.082,6,10,1506,5,395,18.0,127.0,127.0,5,1111,18.0,843.0,843.0
0.015,6,10,1631,5,848,3.0,580.0,580.0,5,783,3.0,515.0,515.0
0.011,6,10,1989,5,910,2.0,642.0,642.0,5,1079,2.0,811.0,811.0
0.006,6,10,1643,5,860,1.0,592.0,592.0,5,783,1.0,515.0,515.0
0.016,17,2,198,1,91,0.0,63.0,63.0,1,107,0.0,79.0,79.0
15.083,17,15,8564,8,6407,2150.0,1350.0,772.0,7,2157,2509.0,1350.0,280.0
0.019,6,10,1972,5,910,4.0,642.0,642.0,5,1062,4.0,794.0,794.0
40.074,17,10,676,5,460,10014.0,104.0,64.0,5,216,10015.0,20.0,15.0
0.006,17,2,160,1,72,0.0,44.0,44.0,1,88,0.0,60.0,60.0
0.072,17,2,144,1,64,0.0,36.0,36.0,1,80,0.0,52.0,52.0
0.018,6,10,1990,5,911,4.0,643.0,643.0,5,1079,4.0,811.0,811.0
0.006,17,4,284,2,120,2.0,32.0,32.0,2,164,2.0,60.0,54.0
0.004,6,10,1774,5,923,1.0,655.0,655.0,5,851,1.0,583.0,583.0
0.005,6,10,1779,5,928,1.0,660.0,660.0,5,851,1.0,583.0,583.0
0.004,6,10,1779,5,928,1.0,660.0,660.0,5,851,1.0,583.0,583.0
0.005,6,10,1547,5,764,1.0,496.0,496.0,5,783,1.0,515.0,515.0
0.005,6,12,1698,6,863,1.0,327.0,271.0,6,835,1.0,515.0,515.0
0.021,6,13,3735,7,497,3.0,125.0,125.0,6,3238,4.0,1470.0,1459.0
0.053,6,10,1972,5,910,13.0,642.0,642.0,5,1062,13.0,794.0,794.0
0.004,6,10,1989,5,927,1.0,659.0,659.0,5,1062,1.0,794.0,794.0
0.015,6,10,1989,5,910,3.0,642.0,642.0,5,1079,3.0,811.0,811.0
0.014,6,13,3735,7,497,2.0,125.0,125.0,6,3238,2.0,1470.0,1459.0
0.006,17,2,164,1,74,0.0,46.0,46.0,1,90,0.0,62.0,62.0
0.005,6,10,2007,5,928,1.0,660.0,660.0,5,1079,1.0,811.0,811.0
0.016,6,10,1990,5,911,4.0,643.0,643.0,5,1079,3.0,811.0,811.0
0.005,17,2,144,1,64,0.0,36.0,36.0,1,80,0.0,52.0,52.0
0.008,6,10,1983,5,910,1.0,642.0,642.0,5,1073,2.0,805.0,805.0
0.004,6,10,1989,5,927,1.0,659.0,659.0,5,1062,1.0,794.0,794.0
0.129,6,10,1506,5,395,28.0,127.0,127.0,5,1111,27.0,843.0,843.0
0.423,6,22,7184,11,1635,41.0,748.0,263.0,11,5549,41.0,2332.0,993.0
0.007,6,10,1547,5,764,1.0,496.0,496.0,5,783,1.0,515.0,515.0
0.012,6,10,1989,5,910,3.0,642.0,642.0,5,1079,2.0,811.0,811.0
0.008,6,10,1990,5,911,2.0,643.0,643.0,5,1079,2.0,811.0,811.0
0.012,6,10,1972,5,910,3.0,642.0,642.0,5,1062,2.0,794.0,794.0
0.005,6,13,3747,7,509,0.0,137.0,137.0,6,3238,0.0,1470.0,1459.0
0.005,6,10,2007,5,928,1.0,660.0,660.0,5,1079,1.0,811.0,811.0
0.005,6,14,3742,7,452,0.0,80.0,80.0,7,3290,0.0,1448.0,972.0
0.005,17,2,144,1,64,0.0,36.0,36.0,1,80,0.0,52.0,52.0
0.009,6,10,1989,5,910,2.0,642.0,642.0,5,1079,2.0,811.0,811.0
0.014,6,10,1989,5,910,3.0,642.0,642.0,5,1079,3.0,811.0,811.0
242.353,6,373,346689,189,21348,1289.0,2736.0,959.0,184,325341,1324.0,2804.0,1814.0
0.093,6,10,1506,5,395,21.0,127.0,127.0,5,1111,17.0,843.0,843.0
0.005,6,14,3742,7,452,0.0,80.0,80.0,7,3290,0.0,1448.0,972.0
0.003,17,2,148,1,60,0.0,32.0,32.0,1,88,0.0,60.0,60.0
0.113,6,10,1506,5,395,26.0,127.0,127.0,5,1111,23.0,843.0,843.0
0.006,6,10,1643,5,860,1.0,592.0,592.0,5,783,1.0,515.0,515.0
0.004,6,10,2007,5,928,1.0,660.0,660.0,5,1079,1.0,811.0,811.0
0.006,6,10,1547,5,764,1.0,496.0,496.0,5,783,1.0,515.0,515.0
0.103,6,10,1506,5,395,24.0,127.0,127.0,5,1111,21.0,843.0,843.0
0.11,6,10,1506,5,395,25.0,127.0,127.0,5,1111,25.0,843.0,843.0
1770.444,6,82,4318,41,2159,44260.0,27.0,27.0,41,2159,44260.0,27.0,27.0
0.104,6,10,1506,5,395,24.0,127.0,127.0,5,1111,22.0,843.0,843.0
0.077,6,10,1506,5,395,17.0,127.0,127.0,5,1111,15.0,843.0,843.0
0.015,6,10,1990,5,911,3.0,643.0,643.0,5,1079,3.0,811.0,811.0
0.006,6,10,1643,5,860,1.0,592.0,592.0,5,783,1.0,515.0,515.0
0.013,6,10,1677,5,827,3.0,559.0,559.0,5,850,3.0,582.0,582.0
0.006,6,10,2007,5,928,1.0,660.0,660.0,5,1079,1.0,811.0,811.0
0.016,6,10,1990,5,911,4.0,643.0,643.0,5,1079,4.0,811.0,811.0
0.011,6,10,1677,5,827,2.0,559.0,559.0,5,850,2.0,582.0,582.0
0.017,6,10,1972,5,910,4.0,642.0,642.0,5,1062,4.0,794.0,794.0
40.062,17,10,676,5,460,10014.0,104.0,64.0,5,216,10014.0,20.0,15.0
0.08,6,10,1506,5,395,18.0,127.0,127.0,5,1111,15.0,843.0,843.0
164.115,17,70,10105,35,2334,4826.0,44.0,38.0,35,7771,4826.0,239.0,194.0
0.004,6,10,1989,5,927,1.0,659.0,659.0,5,1062,1.0,794.0,794.0
0.013,6,10,1989,5,910,3.0,642.0,642.0,5,1079,3.0,811.0,811.0
0.088,6,10,1506,5,395,19.0,127.0,127.0,5,1111,18.0,843.0,843.0
0.225,6,16,2779,8,1397,32.0,533.0,324.0,8,1382,20.0,529.0,239.0
0.003,17,2,136,1,60,0.0,32.0,32.0,1,76,0.0,48.0,48.0
10.791,17,28,4419,14,1994,821.0,269.0,114.0,14,2425,821.0,588.0,145.0
0.001,17,2,180,1,66,0.0,38.0,38.0,1,114,0.0,86.0,86.0
0.004,6,10,2007,5,928,1.0,660.0,660.0,5,1079,1.0,811.0,811.0
0.005,17,2,214,1,75,0.0,47.0,47.0,1,139,0.0,111.0,111.0
40.07,17,10,676,5,460,10015.0,104.0,64.0,5,216,10016.0,20.0,15.0
0.004,6,10,2007,5,928,1.0,660.0,660.0,5,1079,1.0,811.0,811.0
0.108,6,10,1506,5,395,23.0,127.0,127.0,5,1111,22.0,843.0,843.0
0.214,6,16,2669,8,1395,30.0,533.0,323.0,8,1274,19.0,529.0,212.0
240.027,6,9,787,5,488,60006.0,232.0,232.0,4,299,80008.0,83.0,83.0
0.005,6,10,1689,5,839,1.0,571.0,571.0,5,850,1.0,582.0,582.0
0.019,17,2,164,1,74,0.0,46.0,46.0,1,90,0.0,62.0,62.0
289.961,6,310,343889,114,18070,2566.0,2736.0,867.0,196,325819,1486.0,2804.0,1763.0
0.013,6,10,1762,5,911,3.0,643.0,643.0,5,851,3.0,583.0,583.0
300.023,6,12,1782,7,1348,50003.0,494.0,494.0,5,434,75004.0,83.0,83.0
10.971,17,29,4567,15,2166,775.0,269.0,116.0,14,2401,835.0,588.0,143.0
0.01,6,10,1989,5,910,2.0,642.0,642.0,5,1079,2.0,811.0,811.0
0.005,6,10,2000,5,927,1.0,659.0,659.0,5,1073,1.0,805.0,805.0
0.005,17,2,194,1,59,0.0,31.0,31.0,1,135,0.0,107.0,107.0
0.132,6,10,1506,5,395,26.0,127.0,127.0,5,1111,27.0,843.0,843.0
0.005,6,10,2000,5,927,1.0,659.0,659.0,5,1073,1.0,805.0,805.0
0.083,6,10,1506,5,395,19.0,127.0,127.0,5,1111,17.0,843.0,843.0
0.105,6,10,1506,5,395,25.0,127.0,127.0,5,1111,23.0,843.0,843.0
0.098,6,10,1506,5,395,21.0,127.0,127.0,5,1111,21.0,843.0,843.0
0.015,6,10,1762,5,911,3.0,643.0,643.0,5,851,3.0,583.0,583.0
0.008,6,10,1677,5,827,2.0,559.0,559.0,5,850,2.0,582.0,582.0
0.109,6,10,1506,5,395,26.0,127.0,127.0,5,1111,24.0,843.0,843.0
40.202,6,44,10745,26,3171,1608.0,980.0,199.0,18,7574,2364.0,2694.0,603.0
0.018,6,10,1983,5,910,4.0,642.0,642.0,5,1073,4.0,805.0,805.0
0.004,17,2,148,1,60,0.0,32.0,32.0,1,88,0.0,60.0,60.0
0.003,17,2,180,1,66,0.0,38.0,38.0,1,114,0.0,86.0,86.0
11.004,17,28,4397,14,2311,838.0,586.0,137.0,14,2086,837.0,269.0,121.0
0.006,17,2,166,1,75,0.0,47.0,47.0,1,91,0.0,63.0,63.0
0.011,6,10,1972,5,910,2.0,642.0,642.0,5,1062,2.0,794.0,794.0
240.011,6,9,787,5,488,60002.0,232.0,232.0,4,299,80002.0,83.0,83.0
0.115,6,10,1506,5,395,27.0,127.0,127.0,5,1111,26.0,843.0,843.0
0.075,6,10,1506,5,395,17.0,127.0,127.0,5,1111,17.0,843.0,843.0
0.005,6,10,2006,5,927,1.0,659.0,659.0,5,1079,1.0,811.0,811.0
0.006,6,10,1643,5,860,1.0,592.0,592.0,5,783,1.0,515.0,515.0
0.27,17,4,596,2,122,231.0,33.0,33.0,2,474,142.0,323.0,209.0
0.01,6,10,1990,5,911,2.0,643.0,643.0,5,1079,2.0,811.0,811.0
0.004,17,2,136,1,60,0.0,32.0,32.0,1,76,0.0,48.0,48.0
0.006,17,2,257,1,59,0.0,31.0,31.0,1,198,0.0,170.0,170.0
368.51,6,22,2313,16,867,24567.0,195.0,195.0,6,1446,4635.0,419.0,398.0
0.001,17,2,180,1,66,0.0,38.0,38.0,1,114,0.0,86.0,86.0
0.071,17,4,420,2,122,0.0,33.0,33.0,2,298,66.0,145.0,121.0
0.013,6,10,1989,5,910,3.0,642.0,642.0,5,1079,3.0,811.0,811.0
0.008,6,12,1926,6,1189,1.0,659.0,434.0,6,737,1.0,417.0,417.0
0.007,6,10,1989,5,910,1.0,642.0,642.0,5,1079,1.0,811.0,811.0
0.014,6,10,1990,5,911,3.0,643.0,643.0,5,1079,3.0,811.0,811.0
0.006,6,10,1643,5,860,1.0,592.0,592.0,5,783,1.0,515.0,515.0
0.005,6,10,2007,5,928,1.0,660.0,660.0,5,1079,1.0,811.0,811.0
0.113,6,10,1506,5,395,26.0,127.0,127.0,5,1111,25.0,843.0,843.0
0.073,17,4,420,2,122,1.0,33.0,33.0,2,298,69.0,145.0,121.0
0.005,6,10,1547,5,764,1.0,496.0,496.0,5,783,1.0,515.0,515.0
0.005,6,10,2006,5,927,1.0,659.0,659.0,5,1079,1.0,811.0,811.0
311.006,17,20,1124,10,716,34543.0,48.0,43.0,10,408,34541.0,20.0,12.0
0.011,6,10,1989,5,910,2.0,642.0,642.0,5,1079,2.0,811.0,811.0
0.006,17,2,179,1,71,0.0,43.0,43.0,1,108,0.0,80.0,80.0
0.123,6,10,1506,5,395,28.0,127.0,127.0,5,1111,25.0,843.0,843.0
0.004,6,10,2007,5,928,1.0,660.0,660.0,5,1079,1.0,811.0,811.0
0.013,6,10,1989,5,910,3.0,642.0,642.0,5,1079,3.0,811.0,811.0
0.006,6,10,1689,5,839,1.0,571.0,571.0,5,850,1.0,582.0,582.0
0.012,6,10,1972,5,910,3.0,642.0,642.0,5,1062,3.0,794.0,794.0
0.004,6,10,2006,5,927,1.0,659.0,659.0,5,1079,1.0,811.0,811.0
0.007,17,2,132,1,58,0.0,30.0,30.0,1,74,0.0,46.0,46.0
240.019,6,9,787,5,488,60004.0,232.0,232.0,4,299,80005.0,83.0,83.0
0.016,17,2,198,1,91,0.0,63.0,63.0,1,107,0.0,79.0,79.0
0.107,6,10,1506,5,395,21.0,127.0,127.0,5,1111,23.0,843.0,843.0
0.014,6,10,1689,5,839,3.0,571.0,571.0,5,850,3.0,582.0,582.0
0.006,6,10,1643,5,860,1.0,592.0,592.0,5,783,1.0,515.0,515.0
0.004,17,4,284,2,120,0.0,32.0,32.0,2,164,0.0,60.0,54.0
0.006,6,10,2007,5,928,1.0,660.0,660.0,5,1079,1.0,811.0,811.0
0.022,6,10,1989,5,910,5.0,642.0,642.0,5,1079,5.0,811.0,811.0
0.006,6,10,1547,5,764,1.0,496.0,496.0,5,783,1.0,515.0,515.0
0.013,6,10,1762,5,911,3.0,643.0,643.0,5,851,3.0,583.0,583.0
121.035,6,60,19247,36,5016,3458.0,1054.0,210.0,24,14231,5262.0,2804.0,926.0
0.071,17,2,136,1,60,0.0,32.0,32.0,1,76,0.0,48.0,48.0
0.067,6,10,1506,5,395,14.0,127.0,127.0,5,1111,14.0,843.0,843.0
0.272,17,4,596,2,122,232.0,33.0,33.0,2,474,145.0,323.0,209.0
40.055,17,10,676,5,460,10013.0,104.0,64.0,5,216,10013.0,20.0,15.0
0.013,6,10,1631,5,848,3.0,580.0,580.0,5,783,3.0,515.0,515.0
0.037,17,2,148,1,60,0.0,32.0,32.0,1,88,0.0,60.0,60.0
0.005,6,14,3736,7,446,0.0,74.0,74.0,7,3290,0.0,1448.0,972.0
0.006,17,2,168,1,76,0.0,48.0,48.0,1,92,0.0,64.0,64.0
0.005,6,13,3747,7,509,0.0,137.0,137.0,6,3238,0.0,1470.0,1459.0
0.0,17,2,154,1,69,0.0,41.0,41.0,1,85,0.0,57.0,57.0
0.089,6,10,1506,5,395,19.0,127.0,127.0,5,1111,19.0,843.0,843.0
0.008,6,10,1547,5,764,1.0,496.0,496.0,5,783,1.0,515.0,515.0
0.003,17,2,136,1,60,0.0,32.0,32.0,1,76,0.0,48.0,48.0
0.005,6,10,1854,5,889,1.0,621.0,621.0,5,965,1.0,697.0,697.0
0.01,6,10,1989,5,910,2.0,642.0,642.0,5,1079,2.0,811.0,811.0
0.024,6,10,1990,5,911,6.0,643.0,643.0,5,1079,6.0,811.0,811.0
0.008,6,10,1972,5,910,2.0,642.0,642.0,5,1062,2.0,794.0,794.0
0.003,17,4,284,2,120,0.0,32.0,32.0,2,164,0.0,60.0,54.0
0.006,6,14,3736,7,446,0.0,74.0,74.0,7,3290,0.0,1448.0,972.0
0.114,6,10,1506,5,395,27.0,127.0,127.0,5,1111,26.0,843.0,843.0
64.403,6,450,669857,168,14399,385.0,1477.0,942.0,282,655458,229.0,4206.0,2313.0
0.007,17,2,194,1,59,0.0,31.0,31.0,1,135,0.0,107.0,107.0
0.005,6,10,2006,5,927,1.0,659.0,659.0,5,1079,1.0,811.0,811.0
0.004,6,10,2000,5,927,1.0,659.0,659.0,5,1073,1.0,805.0,805.0
0.008,6,10,1972,5,910,2.0,642.0,642.0,5,1062,2.0,794.0,794.0
0.01,6,13,3735,7,497,1.0,125.0,125.0,6,3238,2.0,1470.0,1459.0
0.005,17,2,140,1,62,0.0,34.0,34.0,1,78,0.0,50.0,50.0
0.169,17,2,152,1,76,0.0,48.0,48.0,1,76,0.0,48.0,48.0
0.017,6,10,1989,5,910,4.0,642.0,642.0,5,1079,4.0,811.0,811.0
0.097,6,10,1506,5,395,20.0,127.0,127.0,5,1111,21.0,843.0,843.0
0.041,17,2,136,1,60,0.0,32.0,32.0,1,76,0.0,48.0,48.0
11.172,17,28,4421,14,1994,846.0,269.0,114.0,14,2427,846.0,586.0,145.0
0.06,17,2,152,1,76,0.0,48.0,48.0,1,76,0.0,48.0,48.0
0.005,17,2,144,1,64,0.0,36.0,36.0,1,80,0.0,52.0,52.0
0.006,6,10,1643,5,860,1.0,592.0,592.0,5,783,1.0,515.0,515.0
0.004,6,10,2006,5,927,1.0,659.0,659.0,5,1079,1.0,811.0,811.0
0.058,6,10,1506,5,395,14.0,127.0,127.0,5,1111,13.0,843.0,843.0
0.069,6,10,1506,5,395,15.0,127.0,127.0,5,1111,13.0,843.0,843.0
300.023,6,12,1782,7,1348,50003.0,494.0,494.0,5,434,75004.0,83.0,83.0
40.059,17,10,676,5,460,10013.0,104.0,64.0,5,216,10013.0,20.0,15.0
0.001,17,2,180,1,66,0.0,38.0,38.0,1,114,0.0,86.0,86.0
0.005,6,10,1689,5,839,1.0,571.0,571.0,5,850,1.0,582.0,582.0
0.006,6,10,1547,5,764,1.0,496.0,496.0,5,783,1.0,515.0,515.0
0.014,6,10,1990,5,911,3.0,643.0,643.0,5,1079,3.0,811.0,811.0
0.236,6,16,2669,8,1395,33.0,533.0,323.0,8,1274,21.0,529.0,212.0
0.014,6,10,1972,5,910,3.0,642.0,642.0,5,1062,3.0,794.0,794.0
0.063,6,10,1506,5,395,13.0,127.0,127.0,5,1111,14.0,843.0,843.0
59.777,6,38,9841,19,4238,503.0,3113.0,1144.0,19,5603,3311.0,2667.0,402.0
0.162,17,2,152,1,76,0.0,48.0,48.0,1,76,0.0,48.0,48.0
0.018,6,10,1677,5,827,4.0,559.0,559.0,5,850,4.0,582.0,582.0
0.005,6,10,2006,5,927,1.0,659.0,659.0,5,1079,1.0,811.0,811.0
0.005,6,10,2007,5,928,1.0,660.0,660.0,5,1079,1.0,811.0,811.0
240.33,6,36,10503,18,2194,14136.0,538.0,250.0,18,8309,14135.0,1402.0,614.0
0.001,17,2,180,1,66,0.0,38.0,38.0,1,114,0.0,86.0,86.0
0.009,6,10,1989,5,910,2.0,642.0,642.0,5,1079,2.0,811.0,811.0
0.115,6,10,1506,5,395,28.0,127.0,127.0,5,1111,24.0,843.0,843.0
0.007,17,2,179,1,71,0.0,43.0,43.0,1,108,0.0,80.0,80.0
0.14,6,10,1506,5,395,32.0,127.0,127.0,5,1111,34.0,843.0,843.0
0.017,17,2,152,1,56,0.0,28.0,28.0,1,96,0.0,68.0,68.0
0.007,6,10,1990,5,911,1.0,643.0,643.0,5,1079,1.0,811.0,811.0
0.006,17,2,170,1,65,0.0,37.0,37.0,1,105,0.0,77.0,77.0
0.009,6,10,1989,5,910,2.0,642.0,642.0,5,1079,2.0,811.0,811.0
0.005,17,2,209,1,64,0.0,36.0,36.0,1,145,0.0,117.0,117.0
0.009,6,10,1631,5,848,2.0,580.0,580.0,5,783,2.0,515.0,515.0
11.107,17,28,4422,14,1994,841.0,269.0,114.0,14,2428,841.0,587.0,145.0
0.013,6,10,1989,5,910,3.0,642.0,642.0,5,1079,3.0,811.0,811.0
0.129,6,10,1506,5,395,30.0,127.0,127.0,5,1111,27.0,843.0,843.0
0.086,6,10,1506,5,395,19.0,127.0,127.0,5,1111,19.0,843.0,843.0
0.129,17,2,136,1,60,0.0,32.0,32.0,1,76,0.0,48.0,48.0
40.05,17,10,676,5,460,10011.0,104.0,64.0,5,216,10011.0,20.0,15.0
0.011,6,10,1989,5,910,2.0,642.0,642.0,5,1079,2.0,811.0,811.0
40.079,17,10,676,5,460,10016.0,104.0,64.0,5,216,10018.0,20.0,15.0
0.117,6,10,1506,5,395,24.0,127.0,127.0,5,1111,17.0,843.0,843.0
0.148,6,10,1506,5,395,29.0,127.0,127.0,5,1111,22.0,843.0,843.0
0.007,17,2,194,1,59,0.0,31.0,31.0,1,135,0.0,107.0,107.0
0.098,6,10,1506,5,395,22.0,127.0,127.0,5,1111,21.0,843.0,843.0
0.086,6,10,1506,5,395,19.0,127.0,127.0,5,1111,19.0,843.0,843.0
0.005,6,10,1547,5,764,1.0,496.0,496.0,5,783,1.0,515.0,515.0
40.057,17,10,676,5,460,10013.0,104.0,64.0,5,216,10013.0,20.0,15.0
0.005,6,10,2000,5,927,1.0,659.0,659.0,5,1073,1.0,805.0,805.0
0.001,17,2,178,1,81,0.0,53.0,53.0,1,97,0.0,69.0,69.0
0.005,6,10,1989,5,927,1.0,659.0,659.0,5,1062,1.0,794.0,794.0
0.005,6,10,1854,5,889,1.0,621.0,621.0,5,965,1.0,697.0,697.0
0.005,6,10,1689,5,839,1.0,571.0,571.0,5,850,1.0,582.0,582.0
0.004,6,10,2006,5,927,1.0,659.0,659.0,5,1079,1.0,811.0,811.0
1756.063,6,105,6270,60,3525,29763.0,27.0,27.0,45,2745,39909.0,27.0,27.0
0.005,6,10,2006,5,927,1.0,659.0,659.0,5,1079,1.0,811.0,811.0
0.004,6,10,2006,5,927,1.0,659.0,659.0,5,1079,1.0,811.0,811.0
0.01,6,10,1631,5,848,2.0,580.0,580.0,5,783,2.0,515.0,515.0
0.014,6,10,1989,5,910,3.0,642.0,642.0,5,1079,3.0,811.0,811.0
300.38,6,27,8913,14,1878,23105.0,517.0,285.0,13,7035,25031.0,1402.0,909.0
0.007,6,10,1989,5,910,1.0,642.0,642.0,5,1079,1.0,811.0,811.0
0.005,6,10,1643,5,860,1.0,592.0,592.0,5,783,1.0,515.0,515.0
0.134,17,2,179,1,71,0.0,43.0,43.0,1,108,0.0,80.0,80.0
0.005,6,14,3736,7,446,0.0,74.0,74.0,7,3290,0.0,1448.0,972.0
329.726,17,20,1124,10,716,36621.0,48.0,43.0,10,408,36621.0,20.0,12.0
0.005,6,10,1547,5,764,1.0,496.0,496.0,5,783,1.0,515.0,515.0
0.091,6,10,1506,5,395,18.0,127.0,127.0,5,1111,20.0,843.0,843.0
0.004,6,10,1989,5,927,1.0,659.0,659.0,5,1062,1.0,794.0,794.0
0.096,6,10,1506,5,395,19.0,127.0,127.0,5,1111,22.0,843.0,843.0
0.013,6,10,1989,5,910,3.0,642.0,642.0,5,1079,3.0,811.0,811.0
0.012,6,10,1762,5,911,3.0,643.0,643.0,5,851,3.0,583.0,583.0
0.005,17,2,164,1,74,0.0,46.0,46.0,1,90,0.0,62.0,62.0
369.55,6,22,2313,16,867,24636.0,195.0,195.0,6,1446,4639.0,419.0,398.0
0.005,17,2,148,1,60,0.0,32.0,32.0,1,88,0.0,60.0,60.0
0.077,6,10,1506,5,395,15.0,127.0,127.0,5,1111,15.0,843.0,843.0
11.036,17,28,4395,14,2313,840.0,588.0,137.0,14,2082,840.0,269.0,120.0
30.87,58,5,360,4,288,10290.0,24.0,24.0,1,72,0.0,24.0,24.0
300.381,6,16,2170,9,684,37526.0,146.0,146.0,7,1486,50035.0,419.0,398.0
0.005,6,10,1989,5,927,1.0,659.0,659.0,5,1062,1.0,794.0,794.0
0.003,17,2,148,1,60,0.0,32.0,32.0,1,88,0.0,60.0,60.0
0.007,17,2,132,1,58,0.0,30.0,30.0,1,74,0.0,46.0,46.0
0.098,6,10,1506,5,395,15.0,127.0,127.0,5,1111,23.0,843.0,843.0
0.004,6,10,1702,5,863,1.0,595.0,595.0,5,839,0.0,571.0,571.0
0.005,6,13,3747,7,509,0.0,137.0,137.0,6,3238,0.0,1470.0,1459.0
0.168,17,2,152,1,76,0.0,48.0,48.0,1,76,0.0,48.0,48.0
0.015,6,10,1972,5,910,3.0,642.0,642.0,5,1062,3.0,794.0,794.0
0.005,6,10,1854,5,889,1.0,621.0,621.0,5,965,1.0,697.0,697.0
0.01,6,10,1989,5,910,2.0,642.0,642.0,5,1079,2.0,811.0,811.0
0.09,6,10,1506,5,395,18.0,127.0,127.0,5,1111,18.0,843.0,843.0
0.017,6,10,1989,5,910,4.0,642.0,642.0,5,1079,4.0,811.0,811.0
0.006,17,2,170,1,65,0.0,37.0,37.0,1,105,0.0,77.0,77.0
0.005,6,10,2006,5,927,1.0,659.0,659.0,5,1079,1.0,811.0,811.0
0.006,6,10,1547,5,764,1.0,496.0,496.0,5,783,1.0,515.0,515.0
0.006,6,10,2000,5,927,1.0,659.0,659.0,5,1073,1.0,805.0,805.0
0.005,17,2,170,1,65,0.0,37.0,37.0,1,105,0.0,77.0,77.0
1770.829,17,120,11460,60,5460,30013.0,63.0,63.0,60,6000,30013.0,72.0,72.0
0.005,17,2,170,1,65,0.0,37.0,37.0,1,105,0.0,77.0,77.0
0.005,6,10,1547,5,764,1.0,496.0,496.0,5,783,1.0,515.0,515.0
0.018,6,10,1983,5,910,4.0,642.0,642.0,5,1073,4.0,805.0,805.0
0.004,6,10,1989,5,927,1.0,659.0,659.0,5,1062,1.0,794.0,794.0
0.016,6,10,1983,5,910,4.0,642.0,642.0,5,1073,4.0,805.0,805.0
0.005,17,2,164,1,74,0.0,46.0,46.0,1,90,0.0,62.0,62.0
0.081,6,10,1506,5,395,19.0,127.0,127.0,5,1111,16.0,843.0,843.0
0.018,6,10,1677,5,827,4.0,559.0,559.0,5,850,4.0,582.0,582.0
353.998,6,21,1807,16,1042,23599.0,190.0,190.0,5,765,60003.0,464.0,248.0
0.004,6,10,2000,5,927,1.0,659.0,659.0,5,1073,1.0,805.0,805.0
0.015,6,10,1631,5,848,3.0,580.0,580.0,5,783,3.0,515.0,515.0
0.006,6,10,1547,5,764,1.0,496.0,496.0,5,783,1.0,515.0,515.0
0.006,17,2,169,1,62,0.0,34.0,34.0,1,107,0.0,79.0,79.0
0.008,6,10,1990,5,911,2.0,643.0,643.0,5,1079,2.0,811.0,811.0
0.006,6,10,2000,5,927,1.0,659.0,659.0,5,1073,1.0,805.0,805.0
0.005,6,10,2007,5,928,1.0,660.0,660.0,5,1079,1.0,811.0,811.0
0.001,17,2,180,1,66,0.0,38.0,38.0,1,114,0.0,86.0,86.0
11.178,17,28,4419,14,1992,847.0,267.0,114.0,14,2427,847.0,586.0,145.0
0.005,6,10,2000,5,927,1.0,659.0,659.0,5,1073,1.0,805.0,805.0
0.01,6,10,1989,5,910,2.0,642.0,642.0,5,1079,2.0,811.0,811.0
0.009,6,10,1989,5,910,2.0,642.0,642.0,5,1079,2.0,811.0,811.0
40.05,17,10,676,5,460,10011.0,104.0,64.0,5,216,10011.0,20.0,15.0
0.063,17,2,152,1,76,0.0,48.0,48.0,1,76,0.0,48.0,48.0
0.009,6,10,1983,5,910,2.0,642.0,642.0,5,1073,2.0,805.0,805.0
0.004,6,10,2000,5,927,1.0,659.0,659.0,5,1073,1.0,805.0,805.0
0.079,6,10,1506,5,395,19.0,127.0,127.0,5,1111,15.0,843.0,843.0
280.467,6,23,6075,10,1186,31163.0,267.0,156.0,13,4889,23370.0,1400.0,873.0
0.012,6,10,1983,5,910,3.0,642.0,642.0,5,1073,3.0,805.0,805.0
0.122,6,10,1506,5,395,23.0,127.0,127.0,5,1111,26.0,843.0,843.0
0.006,6,10,1643,5,860,1.0,592.0,592.0,5,783,1.0,515.0,515.0
0.005,17,2,209,1,64,0.0,36.0,36.0,1,145,0.0,117.0,117.0
0.009,6,10,1972,5,910,2.0,642.0,642.0,5,1062,2.0,794.0,794.0
40.055,17,10,676,5,460,10012.0,104.0,64.0,5,216,10012.0,20.0,15.0
0.005,6,10,1989,5,927,1.0,659.0,659.0,5,1062,1.0,794.0,794.0
0.013,6,10,1983,5,910,3.0,642.0,642.0,5,1073,3.0,805.0,805.0
354.014,6,21,1795,16,1030,23600.0,190.0,190.0,5,765,60001.0,464.0,248.0
0.107,6,10,1506,5,395,24.0,127.0,127.0,5,1111,22.0,843.0,843.0
0.087,6,10,1506,5,395,18.0,127.0,127.0,5,1111,17.0,843.0,843.0
0.257,17,44,24389,24,21174,11.0,1350.0,854.0,20,3215,10.0,1350.0,132.0
223.143,6,27,1816,10,768,24793.0,46.0,46.0,17,1048,13938.0,46.0,46.0
0.005,6,10,2006,5,927,1.0,659.0,659.0,5,1079,1.0,811.0,811.0
0.073,6,10,1506,5,395,17.0,127.0,127.0,5,1111,15.0,843.0,843.0
0.01,6,10,1983,5,910,2.0,642.0,642.0,5,1073,2.0,805.0,805.0
40.058,17,10,676,5,460,10013.0,104.0,64.0,5,216,10013.0,20.0,15.0
312.221,17,20,1124,10,716,34676.0,48.0,43.0,10,408,34676.0,20.0,12.0
0.012,6,10,1972,5,910,3.0,642.0,642.0,5,1062,3.0,794.0,794.0
0.015,6,10,1989,5,910,3.0,642.0,642.0,5,1079,3.0,811.0,811.0
0.005,6,10,2000,5,927,1.0,659.0,659.0,5,1073,1.0,805.0,805.0
0.001,17,2,136,1,60,0.0,32.0,32.0,1,76,0.0,48.0,48.0
0.005,17,2,170,1,65,0.0,37.0,37.0,1,105,0.0,77.0,77.0
0.006,6,10,1854,5,889,1.0,621.0,621.0,5,965,1.0,697.0,697.0
0.005,6,10,2000,5,927,1.0,659.0,659.0,5,1073,1.0,805.0,805.0
0.007,6,10,1547,5,764,1.0,496.0,496.0,5,783,1.0,515.0,515.0
0.008,6,10,1990,5,911,2.0,643.0,643.0,5,1079,2.0,811.0,811.0
0.012,6,10,1989,5,910,2.0,642.0,642.0,5,1079,3.0,811.0,811.0
40.071,17,10,676,5,460,10015.0,104.0,64.0,5,216,10016.0,20.0,15.0
0.01,6,10,1983,5,910,2.0,642.0,642.0,5,1073,2.0,805.0,805.0
0.012,6,10,1989,5,910,3.0,642.0,642.0,5,1079,2.0,811.0,811.0
0.085,6,10,1506,5,395,19.0,127.0,127.0,5,1111,17.0,843.0,843.0
0.007,17,2,179,1,71,0.0,43.0,43.0,1,108,0.0,80.0,80.0
0.184,6,10,1506,5,395,43.0,127.0,127.0,5,1111,43.0,843.0,843.0
0.073,6,10,1506,5,395,16.0,127.0,127.0,5,1111,15.0,843.0,843.0
0.005,6,10,2007,5,928,1.0,660.0,660.0,5,1079,1.0,811.0,811.0
0.005,17,2,164,1,74,0.0,46.0,46.0,1,90,0.0,62.0,62.0
40.057,17,10,676,5,460,10013.0,104.0,64.0,5,216,10013.0,20.0,15.0
0.001,17,2,180,1,66,0.0,38.0,38.0,1,114,0.0,86.0,86.0
0.005,17,2,179,1,71,0.0,43.0,43.0,1,108,0.0,80.0,80.0
0.004,17,2,148,1,60,0.0,32.0,32.0,1,88,0.0,60.0,60.0
10.746,17,28,4423,14,1995,818.0,270.0,114.0,14,2428,818.0,587.0,145.0
0.009,6,10,2007,5,928,2.0,660.0,660.0,5,1079,2.0,811.0,811.0
0.101,6,10,1506,5,395,21.0,127.0,127.0,5,1111,22.0,843.0,843.0
0.007,6,10,1989,5,910,1.0,642.0,642.0,5,1079,1.0,811.0,811.0
40.063,17,10,676,5,460,10015.0,104.0,64.0,5,216,10015.0,20.0,15.0
0.004,6,10,2006,5,927,1.0,659.0,659.0,5,1079,1.0,811.0,811.0
0.005,6,10,1854,5,889,1.0,621.0,621.0,5,965,1.0,697.0,697.0
0.122,6,10,1506,5,395,26.0,127.0,127.0,5,1111,27.0,843.0,843.0
0.155,6,10,1506,5,395,34.0,127.0,127.0,5,1111,35.0,843.0,843.0
11.338,17,28,4398,14,2311,863.0,586.0,137.0,14,2087,863.0,270.0,121.0
0.006,6,13,3747,7,509,0.0,137.0,137.0,6,3238,1.0,1470.0,1459.0
0.004,17,2,136,1,60,0.0,32.0,32.0,1,76,0.0,48.0,48.0
0.102,6,10,1506,5,395,23.0,127.0,127.0,5,1111,25.0,843.0,843.0
0.13,17,4,284,2,120,0.0,32.0,32.0,2,164,126.0,60.0,54.0
0.04,17,2,184,1,61,0.0,33.0,33.0,1,123,0.0,95.0,95.0
0.005,6,10,2006,5,927,1.0,659.0,659.0,5,1079,1.0,811.0,811.0
0.004,6,10,2007,5,928,1.0,660.0,660.0,5,1079,1.0,811.0,811.0
0.006,6,10,1990,5,911,1.0,643.0,643.0,5,1079,1.0,811.0,811.0
0.086,6,10,1506,5,395,18.0,127.0,127.0,5,1111,20.0,843.0,843.0
0.01,6,10,1972,5,910,2.0,642.0,642.0,5,1062,2.0,794.0,794.0
0.012,6,10,1989,5,910,3.0,642.0,642.0,5,1079,3.0,811.0,811.0
30.69,6,25,8066,14,2988,2352.0,1191.0,449.0,11,5078,3058.0,1402.0,751.0
0.013,6,10,1989,5,910,3.0,642.0,642.0,5,1079,3.0,811.0,811.0
0.005,6,10,2006,5,927,1.0,659.0,659.0,5,1079,1.0,811.0,811.0
0.005,6,10,1547,5,764,1.0,496.0,496.0,5,783,1.0,515.0,515.0
0.011,6,10,1631,5,848,2.0,580.0,580.0,5,783,2.0,515.0,515.0
0.005,6,10,2000,5,927,1.0,659.0,659.0,5,1073,1.0,805.0,805.0
10.792,17,28,4422,14,1994,819.0,269.0,114.0,14,2428,821.0,587.0,145.0
0.016,6,10,1989,5,910,4.0,642.0,642.0,5,1079,3.0,811.0,811.0
0.063,17,2,144,1,64,0.0,36.0,36.0,1,80,0.0,52.0,52.0
0.004,6,10,2006,5,927,1.0,659.0,659.0,5,1079,1.0,811.0,811.0
0.056,17,2,179,1,71,0.0,43.0,43.0,1,108,0.0,80.0,80.0
0.011,6,10,1972,5,910,2.0,642.0,642.0,5,1062,2.0,794.0,794.0
15.072,17,14,9190,8,6902,2149.0,1350.0,834.0,6,2288,3008.0,1350.0,353.0
0.007,6,10,1989,5,910,1.0,642.0,642.0,5,1079,1.0,811.0,811.0
0.006,6,10,1779,5,928,1.0,660.0,660.0,5,851,1.0,583.0,583.0
10.911,17,28,4422,14,1994,831.0,269.0,114.0,14,2428,831.0,587.0,145.0
1778.333,17,144,41760,72,22752,25046.0,288.0,288.0,72,19008,25046.0,236.0,236.0
15.07,17,15,9238,8,6902,2148.0,1350.0,834.0,7,2336,2506.0,1350.0,305.0
0.006,6,10,1643,5,860,1.0,592.0,592.0,5,783,1.0,515.0,515.0
0.004,6,10,2006,5,927,1.0,659.0,659.0,5,1079,1.0,811.0,811.0
0.005,6,10,1689,5,839,1.0,571.0,571.0,5,850,1.0,582.0,582.0
11.034,17,28,4398,14,2311,840.0,586.0,137.0,14,2087,840.0,270.0,121.0
0.012,6,10,1677,5,827,2.0,559.0,559.0,5,850,3.0,582.0,582.0
0.006,6,10,1689,5,839,1.0,571.0,571.0,5,850,1.0,582.0,582.0
0.236,6,11,1558,6,447,39.0,127.0,127.0,5,1111,54.0,843.0,843.0
0.006,6,10,1547,5,764,1.0,496.0,496.0,5,783,1.0,515.0,515.0
0.104,6,10,1506,5,395,23.0,127.0,127.0,5,1111,24.0,843.0,843.0
0.001,17,2,166,1,75,0.0,47.0,47.0,1,91,0.0,63.0,63.0
0.007,17,2,214,1,75,0.0,47.0,47.0,1,139,0.0,111.0,111.0
0.015,6,10,1990,5,911,3.0,643.0,643.0,5,1079,3.0,811.0,811.0
0.008,6,10,1983,5,910,2.0,642.0,642.0,5,1073,1.0,805.0,805.0
0.092,6,10,1506,5,395,20.0,127.0,127.0,5,1111,16.0,843.0,843.0
0.004,6,10,1774,5,923,1.0,655.0,655.0,5,851,1.0,583.0,583.0
354.057,6,21,1795,16,1030,23603.0,190.0,190.0,5,765,60003.0,464.0,248.0
173.073,17,82,11597,41,2736,4326.0,44.0,38.0,41,8861,4326.0,239.0,188.0
0.005,6,13,3747,7,509,0.0,137.0,137.0,6,3238,0.0,1470.0,1459.0
40.081,17,10,676,5,460,10019.0,104.0,64.0,5,216,10019.0,20.0,15.0
0.118,6,10,1506,5,395,22.0,127.0,127.0,5,1111,25.0,843.0,843.0
300.439,6,19,3081,11,1647,30043.0,517.0,266.0,8,1434,34341.0,821.0,336.0
0.056,17,2,179,1,71,0.0,43.0,43.0,1,108,0.0,80.0,80.0
0.017,6,10,1762,5,911,4.0,643.0,643.0,5,851,4.0,583.0,583.0
0.005,6,10,2007,5,928,1.0,660.0,660.0,5,1079,1.0,811.0,811.0
0.003,17,2,136,1,60,0.0,32.0,32.0,1,76,0.0,48.0,48.0
369.471,6,22,2313,16,867,24631.0,195.0,195.0,6,1446,4634.0,419.0,398.0
0.012,6,10,1972,5,910,3.0,642.0,642.0,5,1062,2.0,794.0,794.0
0.11,6,10,1506,5,395,23.0,127.0,127.0,5,1111,24.0,843.0,843.0
0.004,6,10,1702,5,863,1.0,595.0,595.0,5,839,1.0,571.0,571.0
0.013,6,10,1972,5,910,3.0,642.0,642.0,5,1062,3.0,794.0,794.0
0.01,6,10,1762,5,911,2.0,643.0,643.0,5,851,2.0,583.0,583.0
0.008,6,10,1989,5,910,1.0,642.0,642.0,5,1079,1.0,811.0,811.0
0.006,6,10,1547,5,764,1.0,496.0,496.0,5,783,1.0,515.0,515.0
0.015,6,10,1989,5,910,3.0,642.0,642.0,5,1079,3.0,811.0,811.0
0.134,17,2,80,1,32,0.0,4.0,4.0,1,48,0.0,20.0,20.0
0.006,6,10,1547,5,764,1.0,496.0,496.0,5,783,1.0,515.0,515.0
0.171,6,3,453,2,321,171.0,241.0,241.0,1,132,0.0,92.0,92.0
0.005,6,10,1989,5,927,1.0,659.0,659.0,5,1062,1.0,794.0,794.0
0.068,6,10,1506,5,395,15.0,127.0,127.0,5,1111,14.0,843.0,843.0
0.005,17,2,166,1,75,0.0,47.0,47.0,1,91,0.0,63.0,63.0
0.021,6,10,1972,5,910,5.0,642.0,642.0,5,1062,5.0,794.0,794.0
0.005,6,10,1547,5,764,1.0,496.0,496.0,5,783,1.0,515.0,515.0
0.005,6,10,2000,5,927,1.0,659.0,659.0,5,1073,1.0,805.0,805.0
0.005,6,10,1774,5,923,1.0,655.0,655.0,5,851,1.0,583.0,583.0
0.091,6,10,1506,5,395,20.0,127.0,127.0,5,1111,16.0,843.0,843.0
0.073,6,10,1506,5,395,15.0,127.0,127.0,5,1111,15.0,843.0,843.0
0.005,6,10,1547,5,764,1.0,496.0,496.0,5,783,1.0,515.0,515.0
40.07,17,10,676,5,460,10016.0,104.0,64.0,5,216,10016.0,20.0,15.0
0.005,17,2,166,1,75,0.0,47.0,47.0,1,91,0.0,63.0,63.0
0.015,6,10,1989,5,910,3.0,642.0,642.0,5,1079,3.0,811.0,811.0
0.014,6,10,1990,5,911,3.0,643.0,643.0,5,1079,3.0,811.0,811.0
0.006,6,10,1547,5,764,1.0,496.0,496.0,5,783,1.0,515.0,515.0
0.067,6,10,1506,5,395,15.0,127.0,127.0,5,1111,15.0,843.0,843.0
0.006,6,10,1547,5,764,1.0,496.0,496.0,5,783,1.0,515.0,515.0
0.004,17,4,284,2,120,0.0,32.0,32.0,2,164,1.0,60.0,54.0
0.104,6,10,1506,5,395,22.0,127.0,127.0,5,1111,23.0,843.0,843.0
1774.345,6,913,736015,331,91540,5376.0,2537.0,977.0,582,644475,3053.0,4206.0,1223.0
9.037,17,6,376,5,280,2259.0,28.0,28.0,1,96,0.0,68.0,68.0
0.001,17,2,180,1,66,0.0,38.0,38.0,1,114,0.0,86.0,86.0
0.005,6,10,2007,5,928,1.0,660.0,660.0,5,1079,1.0,811.0,811.0
0.064,6,10,1506,5,395,14.0,127.0,127.0,5,1111,14.0,843.0,843.0
40.074,17,10,676,5,460,10016.0,104.0,64.0,5,216,10017.0,20.0,15.0
0.115,6,10,1506,5,395,24.0,127.0,127.0,5,1111,25.0,843.0,843.0
0.001,17,2,152,1,68,0.0,40.0,40.0,1,84,0.0,56.0,56.0
0.048,17,2,412,1,61,0.0,33.0,33.0,1,351,0.0,323.0,323.0
0.077,6,10,1506,5,395,16.0,127.0,127.0,5,1111,18.0,843.0,843.0
0.004,17,2,136,1,60,0.0,32.0,32.0,1,76,0.0,48.0,48.0
0.111,6,10,1506,5,395,25.0,127.0,127.0,5,1111,24.0,843.0,843.0
0.006,6,10,1689,5,839,1.0,571.0,571.0,5,850,1.0,582.0,582.0
0.007,6,10,1989,5,910,1.0,642.0,642.0,5,1079,1.0,811.0,811.0
0.005,6,10,2006,5,927,1.0,659.0,659.0,5,1079,1.0,811.0,811.0
0.006,17,2,132,1,58,0.0,30.0,30.0,1,74,0.0,46.0,46.0
0.005,6,10,2007,5,928,1.0,660.0,660.0,5,1079,1.0,811.0,811.0
0.014,6,10,1989,5,910,3.0,642.0,642.0,5,1079,3.0,811.0,811.0
0.005,6,10,1643,5,860,1.0,592.0,592.0,5,783,1.0,515.0,515.0
0.001,17,2,179,1,62,0.0,34.0,34.0,1,117,0.0,89.0,89.0
0.006,17,2,166,1,75,0.0,47.0,47.0,1,91,0.0,63.0,63.0
1778.251,17,144,41760,72,22752,25045.0,288.0,288.0,72,19008,25045.0,236.0,236.0
0.011,6,10,1972,5,910,2.0,642.0,642.0,5,1062,2.0,794.0,794.0
40.068,17,10,676,5,460,10014.0,104.0,64.0,5,216,10016.0,20.0,15.0
0.003,17,2,136,1,60,0.0,32.0,32.0,1,76,0.0,48.0,48.0
0.127,17,2,412,1,61,0.0,33.0,33.0,1,351,0.0,323.0,323.0
0.091,6,10,1506,5,395,20.0,127.0,127.0,5,1111,20.0,843.0,843.0
0.07,6,10,1506,5,395,14.0,127.0,127.0,5,1111,15.0,843.0,843.0
0.001,17,2,154,1,69,0.0,41.0,41.0,1,85,0.0,57.0,57.0
40.061,17,10,676,5,460,10013.0,104.0,64.0,5,216,10014.0,20.0,15.0
0.126,17,2,144,1,64,0.0,36.0,36.0,1,80,0.0,52.0,52.0
0.005,6,10,1689,5,839,1.0,571.0,571.0,5,850,1.0,582.0,582.0
0.001,17,2,180,1,66,0.0,38.0,38.0,1,114,0.0,86.0,86.0
0.06,17,2,152,1,76,0.0,48.0,48.0,1,76,0.0,48.0,48.0
0.088,6,10,1506,5,395,20.0,127.0,127.0,5,1111,19.0,843.0,843.0
0.011,6,10,1983,5,910,2.0,642.0,642.0,5,1073,2.0,805.0,805.0
0.001,17,2,180,1,66,0.0,38.0,38.0,1,114,0.0,86.0,86.0
0.018,6,13,3735,7,497,2.0,125.0,125.0,6,3238,3.0,1470.0,1459.0
0.005,17,2,140,1,62,0.0,34.0,34.0,1,78,0.0,50.0,50.0
0.007,6,10,2007,5,928,1.0,660.0,660.0,5,1079,1.0,811.0,811.0
240.389,6,36,9438,18,1941,14140.0,486.0,166.0,18,7497,14140.0,1402.0,595.0
0.004,17,2,136,1,60,0.0,32.0,32.0,1,76,0.0,48.0,48.0
312.255,17,18,1008,9,640,39015.0,48.0,43.0,9,368,39015.0,20.0,12.0
0.106,6,10,1506,5,395,21.0,127.0,127.0,5,1111,24.0,843.0,843.0
0.008,6,10,1547,5,764,1.0,496.0,496.0,5,783,1.0,515.0,515.0
0.109,6,10,1677,5,827,27.0,559.0,559.0,5,850,27.0,582.0,582.0
0.077,6,10,1506,5,395,17.0,127.0,127.0,5,1111,17.0,843.0,843.0
300.063,6,45,17815,24,12177,13038.0,2720.0,1242.0,21,5638,14994.0,2667.0,435.0
0.016,6,10,1989,5,910,3.0,642.0,642.0,5,1079,3.0,811.0,811.0
0.005,6,10,2006,5,927,1.0,659.0,659.0,5,1079,1.0,811.0,811.0
0.131,6,10,1506,5,395,28.0,127.0,127.0,5,1111,27.0,843.0,843.0
0.006,6,10,1547,5,764,1.0,496.0,496.0,5,783,1.0,515.0,515.0
1790.89,6,244,35804,152,26032,11860.0,302.0,302.0,92,9772,19680.0,83.0,83.0
0.009,6,10,1989,5,910,2.0,642.0,642.0,5,1079,2.0,811.0,811.0
178.388,17,80,11373,40,2664,4573.0,44.0,38.0,40,8709,4574.0,261.0,189.0
0.001,17,2,180,1,66,0.0,38.0,38.0,1,114,0.0,86.0,86.0
0.015,6,10,1631,5,848,3.0,580.0,580.0,5,783,3.0,515.0,515.0
0.016,6,10,1989,5,910,3.0,642.0,642.0,5,1079,3.0,811.0,811.0
15.08,17,15,8520,8,6312,2150.0,1350.0,761.0,7,2208,2508.0,1350.0,287.0
0.011,6,10,1631,5,848,2.0,580.0,580.0,5,783,2.0,515.0,515.0
0.014,6,10,1990,5,911,3.0,643.0,643.0,5,1079,3.0,811.0,811.0
0.015,6,10,1990,5,911,3.0,643.0,643.0,5,1079,3.0,811.0,811.0
0.004,17,2,170,1,65,0.0,37.0,37.0,1,105,0.0,77.0,77.0
0.241,6,16,2670,8,1396,34.0,533.0,324.0,8,1274,21.0,529.0,212.0
0.012,6,6,716,3,458,5.0,302.0,302.0,3,258,4.0,102.0,102.0
0.005,6,10,1643,5,860,1.0,592.0,592.0,5,783,1.0,515.0,515.0
0.004,6,10,2000,5,927,1.0,659.0,659.0,5,1073,1.0,805.0,805.0
0.013,17,2,152,1,56,0.0,28.0,28.0,1,96,0.0,68.0,68.0
0.012,6,10,1677,5,827,3.0,559.0,559.0,5,850,3.0,582.0,582.0
0.018,6,10,1677,5,827,4.0,559.0,559.0,5,850,4.0,582.0,582.0
15.074,17,15,9239,8,6902,2149.0,1350.0,834.0,7,2337,2507.0,1350.0,305.0
0.071,17,4,352,2,130,1.0,37.0,37.0,2,222,32.0,89.0,83.0
0.02,6,13,3735,7,497,3.0,125.0,125.0,6,3238,4.0,1470.0,1459.0
0.089,6,10,1506,5,395,18.0,127.0,127.0,5,1111,20.0,843.0,843.0
0.005,17,2,170,1,65,0.0,37.0,37.0,1,105,0.0,77.0,77.0
0.136,6,10,1506,5,395,29.0,127.0,127.0,5,1111,32.0,843.0,843.0
0.005,17,2,164,1,74,0.0,46.0,46.0,1,90,0.0,62.0,62.0
0.008,6,12,1926,6,1189,1.0,659.0,434.0,6,737,1.0,417.0,417.0
40.057,17,10,676,5,460,10013.0,104.0,64.0,5,216,10013.0,20.0,15.0
0.005,6,10,2006,5,927,1.0,659.0,659.0,5,1079,1.0,811.0,811.0
0.125,6,10,1506,5,395,27.0,127.0,127.0,5,1111,28.0,843.0,843.0
0.091,6,10,1506,5,395,18.0,127.0,127.0,5,1111,20.0,843.0,843.0
0.087,6,10,1506,5,395,19.0,127.0,127.0,5,1111,20.0,843.0,843.0
0.004,6,10,2000,5,927,1.0,659.0,659.0,5,1073,1.0,805.0,805.0
0.016,17,2,213,1,69,0.0,41.0,41.0,1,144,0.0,116.0,116.0
0.005,6,10,1689,5,839,1.0,571.0,571.0,5,850,1.0,582.0,582.0
0.11,6,10,1506,5,395,24.0,127.0,127.0,5,1111,26.0,843.0,843.0
0.085,6,10,1506,5,395,20.0,127.0,127.0,5,1111,17.0,843.0,843.0
0.003,17,2,148,1,60,0.0,32.0,32.0,1,88,0.0,60.0,60.0
10.934,17,28,4420,14,1993,832.0,268.0,114.0,14,2427,832.0,586.0,145.0
0.126,6,10,1506,5,395,28.0,127.0,127.0,5,1111,22.0,843.0,843.0
266.558,6,25,8098,9,2024,33319.0,1496.0,780.0,16,6074,17770.0,2802.0,475.0
0.016,6,10,1677,5,827,3.0,559.0,559.0,5,850,4.0,582.0,582.0
0.01,17,2,148,1,60,0.0,32.0,32.0,1,88,0.0,60.0,60.0
0.006,6,10,1547,5,764,1.0,496.0,496.0,5,783,1.0,515.0,515.0
0.012,6,10,1989,5,910,2.0,642.0,642.0,5,1079,2.0,811.0,811.0
0.012,6,10,1989,5,910,3.0,642.0,642.0,5,1079,3.0,811.0,811.0
0.001,17,2,154,1,69,0.0,41.0,41.0,1,85,0.0,57.0,57.0
0.009,6,10,1989,5,910,2.0,642.0,642.0,5,1079,2.0,811.0,811.0
0.027,17,2,160,1,72,0.0,44.0,44.0,1,88,0.0,60.0,60.0
0.022,6,13,3816,7,578,3.0,206.0,206.0,6,3238,4.0,1470.0,1459.0
0.009,6,10,1972,5,910,2.0,642.0,642.0,5,1062,2.0,794.0,794.0
0.008,6,10,2000,5,927,2.0,659.0,659.0,5,1073,1.0,805.0,805.0
0.004,6,10,2007,5,928,1.0,660.0,660.0,5,1079,1.0,811.0,811.0
0.005,6,10,2006,5,927,1.0,659.0,659.0,5,1079,1.0,811.0,811.0
0.005,6,10,1643,5,860,1.0,592.0,592.0,5,783,1.0,515.0,515.0
0.004,17,4,284,2,120,0.0,32.0,32.0,2,164,1.0,60.0,54.0
0.0,17,2,140,1,62,0.0,34.0,34.0,1,78,0.0,50.0,50.0
0.011,6,10,1983,5,910,2.0,642.0,642.0,5,1073,2.0,805.0,805.0
0.07,17,8,3613,4,1874,23.0,1350.0,440.0,4,1739,12.0,1350.0,406.0
0.004,6,10,1989,5,927,1.0,659.0,659.0,5,1062,1.0,794.0,794.0
0.01,6,10,1972,5,910,2.0,642.0,642.0,5,1062,2.0,794.0,794.0
0.038,17,2,144,1,64,0.0,36.0,36.0,1,80,0.0,52.0,52.0
0.119,6,10,1506,5,395,20.0,127.0,127.0,5,1111,25.0,843.0,843.0
0.001,17,2,180,1,66,0.0,38.0,38.0,1,114,0.0,86.0,86.0
0.006,6,10,1643,5,860,1.0,592.0,592.0,5,783,1.0,515.0,515.0
0.005,6,10,1689,5,839,1.0,571.0,571.0,5,850,1.0,582.0,582.0
0.001,17,2,180,1,66,0.0,38.0,38.0,1,114,0.0,86.0,86.0
0.005,6,10,1643,5,860,1.0,592.0,592.0,5,783,1.0,515.0,515.0
0.009,6,10,1762,5,911,2.0,643.0,643.0,5,851,2.0,583.0,583.0
0.095,6,10,1506,5,395,21.0,127.0,127.0,5,1111,19.0,843.0,843.0
40.065,17,10,676,5,460,10015.0,104.0,64.0,5,216,10015.0,20.0,15.0
0.018,6,13,3735,7,497,2.0,125.0,125.0,6,3238,3.0,1470.0,1459.0
0.009,6,10,1972,5,910,2.0,642.0,642.0,5,1062,2.0,794.0,794.0
0.009,6,10,1990,5,911,2.0,643.0,643.0,5,1079,2.0,811.0,811.0
0.005,6,14,3742,7,452,0.0,80.0,80.0,7,3290,0.0,1448.0,972.0
177.228,17,76,10864,38,2545,4789.0,44.0,38.0,38,8319,4789.0,239.0,190.0
0.008,6,10,1989,5,910,1.0,642.0,642.0,5,1079,1.0,811.0,811.0
0.006,6,12,1698,6,863,1.0,327.0,271.0,6,835,1.0,515.0,515.0
0.023,6,10,1677,5,827,5.0,559.0,559.0,5,850,5.0,582.0,582.0
0.009,17,2,136,1,60,0.0,32.0,32.0,1,76,0.0,48.0,48.0
0.001,17,2,180,1,66,0.0,38.0,38.0,1,114,0.0,86.0,86.0
0.006,6,10,1547,5,764,1.0,496.0,496.0,5,783,1.0,515.0,515.0
0.014,6,10,1989,5,910,3.0,642.0,642.0,5,1079,3.0,811.0,811.0
0.012,6,13,3735,7,497,2.0,125.0,125.0,6,3238,2.0,1470.0,1459.0
0.005,6,10,2007,5,928,1.0,660.0,660.0,5,1079,1.0,811.0,811.0
0.004,6,10,1989,5,927,1.0,659.0,659.0,5,1062,1.0,794.0,794.0
0.016,17,2,198,1,91,0.0,63.0,63.0,1,107,0.0,79.0,79.0
0.017,6,10,1990,5,911,4.0,643.0,643.0,5,1079,4.0,811.0,811.0
0.013,6,10,1631,5,848,3.0,580.0,580.0,5,783,3.0,515.0,515.0
0.009,6,10,1972,5,910,2.0,642.0,642.0,5,1062,2.0,794.0,794.0
0.008,6,10,1989,5,910,2.0,642.0,642.0,5,1079,2.0,811.0,811.0
0.041,17,4,580,2,122,2.0,33.0,33.0,2,458,2.0,307.0,201.0
1778.719,17,144,45504,72,22752,25051.0,288.0,288.0,72,22752,25051.0,288.0,288.0
0.004,6,10,1989,5,927,1.0,659.0,659.0,5,1062,1.0,794.0,794.0
10.892,17,28,4422,14,1994,829.0,269.0,114.0,14,2428,829.0,587.0,145.0
0.008,6,10,2006,5,927,2.0,659.0,659.0,5,1079,1.0,811.0,811.0
0.008,6,10,1677,5,827,2.0,559.0,559.0,5,850,1.0,582.0,582.0
0.011,6,10,1972,5,910,2.0,642.0,642.0,5,1062,2.0,794.0,794.0
0.005,6,10,1774,5,923,1.0,655.0,655.0,5,851,1.0,583.0,583.0
0.003,17,2,148,1,60,0.0,32.0,32.0,1,88,0.0,60.0,60.0
0.005,17,4,284,2,120,0.0,32.0,32.0,2,164,0.0,60.0,54.0
0.021,6,10,1983,5,910,5.0,642.0,642.0,5,1073,5.0,805.0,805.0
0.128,6,10,1506,5,395,28.0,127.0,127.0,5,1111,29.0,843.0,843.0
0.087,6,10,1506,5,395,15.0,127.0,127.0,5,1111,20.0,843.0,843.0
0.04,17,4,352,2,130,1.0,37.0,37.0,2,222,0.0,89.0,83.0
0.007,17,2,136,1,60,0.0,32.0,32.0,1,76,0.0,48.0,48.0
240.011,6,9,787,5,488,60002.0,232.0,232.0,4,299,80003.0,83.0,83.0
0.081,6,10,1506,5,395,16.0,127.0,127.0,5,1111,16.0,843.0,843.0
0.015,6,10,1983,5,910,3.0,642.0,642.0,5,1073,3.0,805.0,805.0
0.018,6,10,1990,5,911,4.0,643.0,643.0,5,1079,4.0,811.0,811.0
0.814,6,32,18306,17,11733,50.0,2720.0,1377.0,15,6573,46.0,2720.0,851.0
0.113,17,2,152,1,76,0.0,48.0,48.0,1,76,0.0,48.0,48.0
0.006,6,10,1547,5,764,1.0,496.0,496.0,5,783,1.0,515.0,515.0
0.103,6,10,1506,5,395,20.0,127.0,127.0,5,1111,23.0,843.0,843.0
0.009,6,10,2007,5,928,2.0,660.0,660.0,5,1079,2.0,811.0,811.0
0.131,17,2,80,1,32,0.0,4.0,4.0,1,48,0.0,20.0,20.0
848.283,6,46,2468,23,1222,38556.0,26.0,26.0,23,1246,38556.0,26.0,25.0
0.006,6,10,1547,5,764,1.0,496.0,496.0,5,783,1.0,515.0,515.0
0.005,6,13,3690,7,452,0.0,80.0,80.0,6,3238,1.0,1470.0,1459.0
0.005,6,10,2006,5,927,1.0,659.0,659.0,5,1079,1.0,811.0,811.0
0.004,17,2,148,1,60,0.0,32.0,32.0,1,88,0.0,60.0,60.0
0.006,6,10,1547,5,764,1.0,496.0,496.0,5,783,1.0,515.0,515.0
0.006,6,10,2000,5,927,1.0,659.0,659.0,5,1073,1.0,805.0,805.0
0.04,17,2,412,1,61,0.0,33.0,33.0,1,351,0.0,323.0,323.0
240.093,6,31,9041,15,6598,17149.0,1723.0,646.0,16,2443,16006.0,580.0,200.0
0.134,6,10,1506,5,395,30.0,127.0,127.0,5,1111,33.0,843.0,843.0
0.004,6,10,2007,5,928,1.0,660.0,660.0,5,1079,1.0,811.0,811.0
0.071,6,10,1506,5,395,15.0,127.0,127.0,5,1111,15.0,843.0,843.0
0.067,6,10,1506,5,395,14.0,127.0,127.0,5,1111,16.0,843.0,843.0
0.112,17,2,80,1,32,0.0,4.0,4.0,1,48,0.0,20.0,20.0
0.005,6,10,2006,5,927,1.0,659.0,659.0,5,1079,1.0,811.0,811.0
0.102,6,10,1506,5,395,14.0,127.0,127.0,5,1111,24.0,843.0,843.0
0.01,6,10,1972,5,910,2.0,642.0,642.0,5,1062,2.0,794.0,794.0
0.004,6,10,1989,5,927,1.0,659.0,659.0,5,1062,1.0,794.0,794.0
0.114,6,10,1506,5,395,25.0,127.0,127.0,5,1111,23.0,843.0,843.0
0.005,6,10,1689,5,839,1.0,571.0,571.0,5,850,1.0,582.0,582.0
0.005,6,10,1989,5,927,1.0,659.0,659.0,5,1062,1.0,794.0,794.0
0.102,6,10,1506,5,395,21.0,127.0,127.0,5,1111,25.0,843.0,843.0
0.171,6,3,453,2,321,171.0,241.0,241.0,1,132,0.0,92.0,92.0
0.388,17,17,10021,8,6917,55.0,1350.0,836.0,9,3104,37.0,1350.0,316.0
0.005,17,2,225,1,65,0.0,37.0,37.0,1,160,0.0,132.0,132.0
0.003,17,2,148,1,60,0.0,32.0,32.0,1,88,0.0,60.0,60.0
0.013,6,10,1990,5,911,3.0,643.0,643.0,5,1079,3.0,811.0,811.0
0.127,6,10,1506,5,395,26.0,127.0,127.0,5,1111,26.0,843.0,843.0
0.117,6,10,1506,5,395,27.0,127.0,127.0,5,1111,25.0,843.0,843.0
0.001,17,2,180,1,66,0.0,38.0,38.0,1,114,0.0,86.0,86.0
0.005,6,10,2006,5,927,1.0,659.0,659.0,5,1079,1.0,811.0,811.0
0.07,17,8,3613,4,1874,23.0,1350.0,440.0,4,1739,12.0,1350.0,406.0
0.004,17,2,136,1,60,0.0,32.0,32.0,1,76,0.0,48.0,48.0
0.005,6,10,1779,5,928,1.0,660.0,660.0,5,851,1.0,583.0,583.0
0.086,6,10,1506,5,395,18.0,127.0,127.0,5,1111,17.0,843.0,843.0
0.005,6,10,1989,5,927,1.0,659.0,659.0,5,1062,1.0,794.0,794.0
0.125,17,2,412,1,61,0.0,33.0,33.0,1,351,0.0,323.0,323.0
0.001,17,2,212,1,64,0.0,36.0,36.0,1,148,0.0,120.0,120.0
0.011,6,10,1989,5,910,2.0,642.0,642.0,5,1079,2.0,811.0,811.0
0.011,6,10,1972,5,910,2.0,642.0,642.0,5,1062,2.0,794.0,794.0
40.056,17,10,676,5,460,10012.0,104.0,64.0,5,216,10013.0,20.0,15.0
0.071,17,2,166,1,75,0.0,47.0,47.0,1,91,0.0,63.0,63.0
0.21,6,16,2777,8,1395,30.0,533.0,323.0,8,1382,19.0,529.0,239.0
0.011,6,10,1989,5,910,2.0,642.0,642.0,5,1079,2.0,811.0,811.0
0.005,6,10,2000,5,927,1.0,659.0,659.0,5,1073,1.0,805.0,805.0
0.059,6,10,1506,5,395,13.0,127.0,127.0,5,1111,14.0,843.0,843.0
0.005,17,2,168,1,76,0.0,48.0,48.0,1,92,0.0,64.0,64.0
0.01,6,10,1631,5,848,2.0,580.0,580.0,5,783,2.0,515.0,515.0
0.015,6,13,3735,7,497,2.0,125.0,125.0,6,3238,3.0,1470.0,1459.0
0.004,6,10,1989,5,927,1.0,659.0,659.0,5,1062,1.0,794.0,794.0
0.014,6,10,1762,5,911,3.0,643.0,643.0,5,851,3.0,583.0,583.0
10.856,17,28,4422,14,1994,826.0,269.0,114.0,14,2428,826.0,587.0,145.0
0.005,6,10,1779,5,928,1.0,660.0,660.0,5,851,1.0,583.0,583.0
240.124,6,33,9489,16,7030,16007.0,2090.0,619.0,17,2459,15007.0,580.0,195.0
0.017,6,10,1972,5,910,4.0,642.0,642.0,5,1062,4.0,794.0,794.0
240.093,6,32,9327,16,6899,16006.0,1971.0,674.0,16,2428,16006.0,580.0,198.0
0.005,6,10,1854,5,889,1.0,621.0,621.0,5,965,1.0,697.0,697.0
0.014,6,10,1972,5,910,3.0,642.0,642.0,5,1062,3.0,794.0,794.0
0.005,6,10,1547,5,764,1.0,496.0,496.0,5,783,1.0,515.0,515.0
0.005,6,10,2006,5,927,1.0,659.0,659.0,5,1079,1.0,811.0,811.0
40.064,17,10,676,5,460,10015.0,104.0,64.0,5,216,10014.0,20.0,15.0
0.007,6,10,1854,5,889,1.0,621.0,621.0,5,965,1.0,697.0,697.0
240.102,6,16,4481,9,963,30012.0,238.0,166.0,7,3518,40015.0,1402.0,786.0
0.212,6,16,2777,8,1395,30.0,533.0,323.0,8,1382,19.0,529.0,239.0
0.17,6,3,453,2,321,170.0,241.0,241.0,1,132,0.0,92.0,92.0
0.022,6,10,1989,5,910,5.0,642.0,642.0,5,1079,5.0,811.0,811.0
0.004,6,10,1989,5,927,1.0,659.0,659.0,5,1062,1.0,794.0,794.0
0.114,6,10,1506,5,395,27.0,127.0,127.0,5,1111,26.0,843.0,843.0
0.007,6,10,2006,5,927,1.0,659.0,659.0,5,1079,1.0,811.0,811.0
0.007,6,10,2007,5,928,1.0,660.0,660.0,5,1079,1.0,811.0,811.0
241.611,6,307,344085,124,17967,1964.0,2736.0,886.0,183,326118,1327.0,2769.0,1830.0
0.06,17,2,80,1,32,0.0,4.0,4.0,1,48,0.0,20.0,20.0
354.039,6,21,1795,16,1030,23602.0,190.0,190.0,5,765,60002.0,464.0,248.0
311.858,17,20,1124,10,716,34636.0,48.0,43.0,10,408,34636.0,20.0,12.0
0.005,17,2,180,1,58,0.0,30.0,30.0,1,122,0.0,94.0,94.0
0.004,6,10,1989,5,927,1.0,659.0,659.0,5,1062,1.0,794.0,794.0
0.329,17,47,28074,27,23497,12.0,1350.0,842.0,20,4577,13.0,1350.0,200.0
0.005,6,13,3747,7,509,0.0,137.0,137.0,6,3238,1.0,1470.0,1459.0
0.006,6,10,1547,5,764,1.0,496.0,496.0,5,783,1.0,515.0,515.0
0.006,6,10,1547,5,764,1.0,496.0,496.0,5,783,1.0,515.0,515.0
0.142,6,10,1506,5,395,32.0,127.0,127.0,5,1111,35.0,843.0,843.0
0.005,6,10,1547,5,764,1.0,496.0,496.0,5,783,1.0,515.0,515.0
0.006,6,10,1547,5,764,1.0,496.0,496.0,5,783,1.0,515.0,515.0
0.006,17,2,170,1,65,0.0,37.0,37.0,1,105,0.0,77.0,77.0
172.402,17,82,11341,41,2738,4309.0,44.0,38.0,41,8603,4309.0,239.0,181.0
0.016,6,10,1989,5,910,4.0,642.0,642.0,5,1079,3.0,811.0,811.0
0.015,6,10,1989,5,910,3.0,642.0,642.0,5,1079,3.0,811.0,811.0
0.264,17,39,20187,21,17049,13.0,1350.0,783.0,18,3138,11.0,1350.0,146.0
40.061,17,10,676,5,460,10014.0,104.0,64.0,5,216,10014.0,20.0,15.0
0.005,17,2,166,1,75,0.0,47.0,47.0,1,91,0.0,63.0,63.0
0.072,17,4,364,2,160,0.0,52.0,52.0,2,204,0.0,80.0,74.0
361.791,6,21,1792,16,1030,24119.0,190.0,190.0,5,762,60009.0,461.0,247.0
0.009,6,10,1989,5,910,2.0,642.0,642.0,5,1079,2.0,811.0,811.0
0.039,17,2,148,1,60,0.0,32.0,32.0,1,88,0.0,60.0,60.0
0.009,6,10,1989,5,910,2.0,642.0,642.0,5,1079,2.0,811.0,811.0
0.006,6,10,1774,5,923,1.0,655.0,655.0,5,851,1.0,583.0,583.0
0.221,17,4,596,2,122,148.0,33.0,33.0,2,474,179.0,323.0,209.0
0.012,6,10,1989,5,910,2.0,642.0,642.0,5,1079,3.0,811.0,811.0
412.62,6,35,13325,17,3220,25788.0,676.0,388.0,18,10105,20740.0,1402.0,832.0
1210.877,6,196,36509,77,29215,15932.0,2720.0,414.0,119,7294,10260.0,148.0,49.0
1.11,6,31,12753,17,3312,69.0,1360.0,517.0,14,9441,71.0,2720.0,985.0
0.005,17,2,166,1,75,0.0,47.0,47.0,1,91,0.0,63.0,63.0
0.007,6,10,1762,5,911,1.0,643.0,643.0,5,851,1.0,583.0,583.0
0.021,6,10,1983,5,910,5.0,642.0,642.0,5,1073,5.0,805.0,805.0
0.016,6,10,1983,5,910,4.0,642.0,642.0,5,1073,4.0,805.0,805.0
40.062,17,10,676,5,460,10011.0,104.0,64.0,5,216,10014.0,20.0,15.0
0.004,6,10,1702,5,863,1.0,595.0,595.0,5,839,1.0,571.0,571.0
0.005,6,10,1989,5,927,1.0,659.0,659.0,5,1062,1.0,794.0,794.0
10.738,17,28,4421,14,1993,817.0,268.0,114.0,14,2428,817.0,587.0,145.0
0.011,6,10,1990,5,911,2.0,643.0,643.0,5,1079,2.0,811.0,811.0
0.062,17,2,80,1,32,0.0,4.0,4.0,1,48,0.0,20.0,20.0
0.072,17,4,352,2,130,0.0,37.0,37.0,2,222,32.0,89.0,83.0
0.005,6,10,2007,5,928,1.0,660.0,660.0,5,1079,1.0,811.0,811.0
0.038,6,10,1631,5,848,9.0,580.0,580.0,5,783,9.0,515.0,515.0
0.227,6,16,2670,8,1396,32.0,533.0,324.0,8,1274,20.0,529.0,212.0
0.005,17,2,214,1,75,0.0,47.0,47.0,1,139,0.0,111.0,111.0
0.006,6,10,1989,5,927,1.0,659.0,659.0,5,1062,1.0,794.0,794.0
0.005,6,10,2000,5,927,1.0,659.0,659.0,5,1073,1.0,805.0,805.0
0.016,6,10,1972,5,910,3.0,642.0,642.0,5,1062,4.0,794.0,794.0
0.107,6,10,1506,5,395,25.0,127.0,127.0,5,1111,24.0,843.0,843.0
374.485,6,22,2313,16,867,24965.0,195.0,195.0,6,1446,4668.0,419.0,398.0
0.108,6,10,1506,5,395,23.0,127.0,127.0,5,1111,24.0,843.0,843.0
352.274,6,20,2210,6,1308,12003.0,494.0,494.0,14,902,27097.0,83.0,83.0
0.016,6,10,1983,5,910,4.0,642.0,642.0,5,1073,3.0,805.0,805.0
0.009,6,10,1990,5,911,2.0,643.0,643.0,5,1079,2.0,811.0,811.0
0.005,6,10,2007,5,928,1.0,660.0,660.0,5,1079,1.0,811.0,811.0
11.17,17,28,4421,14,1994,846.0,269.0,114.0,14,2427,846.0,586.0,145.0
11.026,17,28,4422,14,1995,839.0,270.0,114.0,14,2427,839.0,586.0,145.0
0.006,6,10,1689,5,839,1.0,571.0,571.0,5,850,1.0,582.0,582.0
0.01,6,10,1990,5,911,2.0,643.0,643.0,5,1079,2.0,811.0,811.0
0.005,17,2,170,1,65,0.0,37.0,37.0,1,105,0.0,77.0,77.0
0.016,6,10,1972,5,910,3.0,642.0,642.0,5,1062,3.0,794.0,794.0
0.093,6,10,1506,5,395,21.0,127.0,127.0,5,1111,19.0,843.0,843.0
0.003,17,2,148,1,60,0.0,32.0,32.0,1,88,0.0,60.0,60.0
0.006,6,10,1774,5,923,1.0,655.0,655.0,5,851,1.0,583.0,583.0
0.019,6,10,1677,5,827,4.0,559.0,559.0,5,850,4.0,582.0,582.0
0.161,6,10,1506,5,395,38.0,127.0,127.0,5,1111,38.0,843.0,843.0
0.007,6,10,1983,5,910,1.0,642.0,642.0,5,1073,1.0,805.0,805.0
40.087,17,10,676,5,460,10021.0,104.0,64.0,5,216,10021.0,20.0,15.0
0.016,6,10,1677,5,827,3.0,559.0,559.0,5,850,4.0,582.0,582.0
0.006,6,10,1547,5,764,1.0,496.0,496.0,5,783,1.0,515.0,515.0
0.001,17,2,180,1,66,0.0,38.0,38.0,1,114,0.0,86.0,86.0
11.499,17,28,4397,14,2312,872.0,587.0,137.0,14,2085,872.0,268.0,120.0
0.005,6,10,2000,5,927,1.0,659.0,659.0,5,1073,1.0,805.0,805.0
0.004,6,10,2006,5,927,1.0,659.0,659.0,5,1079,1.0,811.0,811.0
0.005,17,2,184,1,68,0.0,40.0,40.0,1,116,0.0,88.0,88.0
40.069,17,10,676,5,460,10016.0,104.0,64.0,5,216,10016.0,20.0,15.0
0.003,17,2,148,1,60,0.0,32.0,32.0,1,88,0.0,60.0,60.0
0.006,6,10,1547,5,764,1.0,496.0,496.0,5,783,1.0,515.0,515.0
0.004,6,10,1702,5,863,1.0,595.0,595.0,5,839,1.0,571.0,571.0
0.014,6,10,1631,5,848,3.0,580.0,580.0,5,783,3.0,515.0,515.0
0.005,17,2,170,1,65,0.0,37.0,37.0,1,105,0.0,77.0,77.0
0.006,17,2,186,1,61,0.0,33.0,33.0,1,125,0.0,97.0,97.0
0.168,17,2,152,1,76,0.0,48.0,48.0,1,76,0.0,48.0,48.0
240.092,6,16,4481,9,963,30011.0,238.0,166.0,7,3518,40014.0,1402.0,786.0
0.005,17,2,148,1,60,0.0,32.0,32.0,1,88,0.0,60.0,60.0
0.005,6,10,1689,5,839,1.0,571.0,571.0,5,850,1.0,582.0,582.0
0.084,6,10,1506,5,395,18.0,127.0,127.0,5,1111,17.0,843.0,843.0
0.149,6,10,1506,5,395,36.0,127.0,127.0,5,1111,36.0,843.0,843.0
1730.392,6,45,2790,30,1725,59668.0,35.0,35.0,15,1065,123594.0,31.0,31.0
0.006,17,2,214,1,75,0.0,47.0,47.0,1,139,0.0,111.0,111.0
0.11,6,10,1506,5,395,25.0,127.0,127.0,5,1111,23.0,843.0,843.0
0.216,6,16,2669,8,1395,30.0,533.0,323.0,8,1274,19.0,529.0,212.0
360.079,6,15,2515,9,1946,45009.0,494.0,494.0,6,569,72015.0,83.0,83.0
0.008,6,13,3735,7,497,1.0,125.0,125.0,6,3238,1.0,1470.0,1459.0
40.065,17,10,676,5,460,10015.0,104.0,64.0,5,216,10015.0,20.0,15.0
0.009,6,10,1990,5,911,2.0,643.0,643.0,5,1079,2.0,811.0,811.0
0.004,6,10,2000,5,927,1.0,659.0,659.0,5,1073,1.0,805.0,805.0
0.018,6,10,1983,5,910,4.0,642.0,642.0,5,1073,4.0,805.0,805.0
40.071,17,10,676,5,460,10015.0,104.0,64.0,5,216,10016.0,20.0,15.0
0.02,6,10,1990,5,911,5.0,643.0,643.0,5,1079,5.0,811.0,811.0
0.011,6,10,1990,5,911,2.0,643.0,643.0,5,1079,2.0,811.0,811.0
0.012,6,13,3735,7,497,2.0,125.0,125.0,6,3238,2.0,1470.0,1459.0
424.742,6,23,4657,13,2427,35395.0,676.0,348.0,10,2230,40520.0,821.0,425.0
0.015,6,10,1762,5,911,3.0,643.0,643.0,5,851,3.0,583.0,583.0
15.074,17,15,9238,8,6902,2149.0,1350.0,834.0,7,2336,2507.0,1350.0,305.0
148.327,6,21,8146,11,1985,81.0,1174.0,504.0,10,6161,16462.0,2720.0,958.0
0.004,6,10,2000,5,927,1.0,659.0,659.0,5,1073,1.0,805.0,805.0
0.043,17,4,352,2,130,0.0,37.0,37.0,2,222,4.0,89.0,83.0
0.136,6,10,1506,5,395,31.0,127.0,127.0,5,1111,22.0,843.0,843.0
0.005,6,10,2006,5,927,1.0,659.0,659.0,5,1079,1.0,811.0,811.0
0.223,6,16,2782,8,1400,31.0,533.0,325.0,8,1382,20.0,529.0,239.0
242.055,6,309,344326,109,17173,2241.0,2736.0,885.0,200,327153,1216.0,3053.0,1667.0
0.005,17,2,166,1,75,0.0,47.0,47.0,1,91,0.0,63.0,63.0
40.054,17,10,676,5,460,10012.0,104.0,64.0,5,216,10012.0,20.0,15.0
0.003,17,2,148,1,60,0.0,32.0,32.0,1,88,0.0,60.0,60.0
0.006,6,10,1547,5,764,1.0,496.0,496.0,5,783,1.0,515.0,515.0
0.078,6,10,1506,5,395,17.0,127.0,127.0,5,1111,17.0,843.0,843.0
0.075,6,10,1506,5,395,16.0,127.0,127.0,5,1111,18.0,843.0,843.0
308.506,17,20,1124,10,716,34267.0,48.0,43.0,10,408,34271.0,20.0,12.0
0.005,17,2,213,1,69,0.0,41.0,41.0,1,144,0.0,116.0,116.0
0.109,6,10,1506,5,395,21.0,127.0,127.0,5,1111,18.0,843.0,843.0
0.013,6,10,1972,5,910,3.0,642.0,642.0,5,1062,3.0,794.0,794.0
0.091,6,10,1506,5,395,18.0,127.0,127.0,5,1111,17.0,843.0,843.0
368.807,6,22,2313,16,867,24587.0,195.0,195.0,6,1446,4644.0,419.0,398.0
0.005,17,2,166,1,75,0.0,47.0,47.0,1,91,0.0,63.0,63.0
0.129,17,2,80,1,32,0.0,4.0,4.0,1,48,0.0,20.0,20.0
0.008,6,10,1689,5,839,2.0,571.0,571.0,5,850,2.0,582.0,582.0
66.188,6,27,17618,15,9656,4727.0,2804.0,1478.0,12,7962,6002.0,2333.0,1221.0
0.005,6,10,2006,5,927,1.0,659.0,659.0,5,1079,1.0,811.0,811.0
0.006,6,10,1854,5,889,1.0,621.0,621.0,5,965,1.0,697.0,697.0
0.004,6,10,2000,5,927,1.0,659.0,659.0,5,1073,1.0,805.0,805.0
0.076,6,10,1506,5,395,16.0,127.0,127.0,5,1111,17.0,843.0,843.0
0.004,6,10,1779,5,928,1.0,660.0,660.0,5,851,1.0,583.0,583.0
40.082,17,10,676,5,460,10017.0,104.0,64.0,5,216,10019.0,20.0,15.0
0.005,17,2,214,1,75,0.0,47.0,47.0,1,139,0.0,111.0,111.0
165.118,17,82,11731,41,2734,4127.0,44.0,38.0,41,8997,4127.0,261.0,191.0
0.014,6,10,1972,5,910,3.0,642.0,642.0,5,1062,3.0,794.0,794.0
28.246,6,24,4946,12,2374,2567.0,967.0,432.0,12,2572,2567.0,1162.0,323.0
0.012,6,10,1762,5,911,3.0,643.0,643.0,5,851,3.0,583.0,583.0
0.001,17,2,136,1,60,0.0,32.0,32.0,1,76,0.0,48.0,48.0
60.561,6,25,17447,14,9563,4658.0,2804.0,1473.0,11,7884,6043.0,2307.0,1217.0
0.006,6,10,2007,5,928,1.0,660.0,660.0,5,1079,1.0,811.0,811.0
0.006,6,10,1547,5,764,1.0,496.0,496.0,5,783,1.0,515.0,515.0
240.095,6,31,9305,15,6720,17149.0,1843.0,660.0,16,2585,16006.0,580.0,218.0
0.077,6,10,1506,5,395,16.0,127.0,127.0,5,1111,17.0,843.0,843.0
0.103,6,10,1506,5,395,22.0,127.0,127.0,5,1111,20.0,843.0,843.0
0.052,6,10,1631,5,848,13.0,580.0,580.0,5,783,12.0,515.0,515.0
0.006,6,10,1547,5,764,1.0,496.0,496.0,5,783,1.0,515.0,515.0
0.09,6,10,1506,5,395,20.0,127.0,127.0,5,1111,21.0,843.0,843.0
367.251,6,22,2313,16,867,24483.0,195.0,195.0,6,1446,4644.0,419.0,398.0
0.006,6,10,1547,5,764,1.0,496.0,496.0,5,783,1.0,515.0,515.0
0.007,6,10,1779,5,928,1.0,660.0,660.0,5,851,1.0,583.0,583.0
300.018,6,12,1782,7,1348,50003.0,494.0,494.0,5,434,75003.0,83.0,83.0
0.014,6,10,1972,5,910,3.0,642.0,642.0,5,1062,3.0,794.0,794.0
0.004,17,2,136,1,60,0.0,32.0,32.0,1,76,0.0,48.0,48.0
405.034,6,27,5001,15,2531,28931.0,676.0,348.0,12,2470,31362.0,821.0,306.0
0.004,6,10,2006,5,927,1.0,659.0,659.0,5,1079,1.0,811.0,811.0
1778.019,17,144,41760,72,22752,25042.0,288.0,288.0,72,19008,25042.0,236.0,236.0
0.004,17,4,284,2,120,1.0,32.0,32.0,2,164,1.0,60.0,54.0
0.004,17,2,152,1,76,0.0,48.0,48.0,1,76,0.0,48.0,48.0
0.012,6,10,1990,5,911,3.0,643.0,643.0,5,1079,2.0,811.0,811.0
0.016,6,10,1990,5,911,3.0,643.0,643.0,5,1079,3.0,811.0,811.0
0.005,6,10,2000,5,927,1.0,659.0,659.0,5,1073,1.0,805.0,805.0
0.096,6,10,1506,5,395,20.0,127.0,127.0,5,1111,22.0,843.0,843.0
0.042,17,2,152,1,76,0.0,48.0,48.0,1,76,0.0,48.0,48.0
0.005,17,2,140,1,62,0.0,34.0,34.0,1,78,0.0,50.0,50.0
0.013,6,10,1972,5,910,3.0,642.0,642.0,5,1062,3.0,794.0,794.0
0.005,6,10,2007,5,928,1.0,660.0,660.0,5,1079,1.0,811.0,811.0
40.081,17,10,676,5,460,10017.0,104.0,64.0,5,216,10019.0,20.0,15.0
0.01,6,10,1990,5,911,2.0,643.0,643.0,5,1079,2.0,811.0,811.0
15.07,17,15,9238,8,6902,2148.0,1350.0,834.0,7,2336,2506.0,1350.0,305.0
367.353,6,22,2313,16,867,24490.0,195.0,195.0,6,1446,4633.0,419.0,398.0
0.005,17,2,148,1,60,0.0,32.0,32.0,1,88,0.0,60.0,60.0
0.016,6,10,1989,5,910,3.0,642.0,642.0,5,1079,4.0,811.0,811.0
0.105,6,10,1506,5,395,24.0,127.0,127.0,5,1111,23.0,843.0,843.0
0.01,6,10,1989,5,910,2.0,642.0,642.0,5,1079,2.0,811.0,811.0
0.01,6,12,1926,6,1189,2.0,659.0,434.0,6,737,2.0,417.0,417.0
70.123,58,5,360,4,288,23374.0,24.0,24.0,1,72,0.0,24.0,24.0
0.001,17,2,179,1,62,0.0,34.0,34.0,1,117,0.0,89.0,89.0
0.006,6,10,1854,5,889,1.0,621.0,621.0,5,965,1.0,697.0,697.0
0.02,6,10,1989,5,910,4.0,642.0,642.0,5,1079,5.0,811.0,811.0
1778.63,17,144,45504,72,22752,25051.0,288.0,288.0,72,22752,25051.0,288.0,288.0
353.609,6,20,2210,6,1308,12004.0,494.0,494.0,14,902,27200.0,83.0,83.0
0.074,6,10,1506,5,395,16.0,127.0,127.0,5,1111,14.0,843.0,843.0
0.009,6,10,2007,5,928,2.0,660.0,660.0,5,1079,2.0,811.0,811.0
293.793,6,386,347525,199,21905,1483.0,2688.0,824.0,187,325620,1579.0,4157.0,1815.0
0.134,17,4,364,2,160,0.0,52.0,52.0,2,204,97.0,80.0,74.0
0.166,17,2,152,1,76,0.0,48.0,48.0,1,76,0.0,48.0,48.0
0.013,6,10,1990,5,911,3.0,643.0,643.0,5,1079,3.0,811.0,811.0
0.162,17,2,152,1,76,0.0,48.0,48.0,1,76,0.0,48.0,48.0
0.006,17,4,284,2,120,1.0,32.0,32.0,2,164,0.0,60.0,54.0
0.01,6,10,1972,5,910,2.0,642.0,642.0,5,1062,2.0,794.0,794.0
0.006,6,10,1689,5,839,1.0,571.0,571.0,5,850,1.0,582.0,582.0
0.006,6,10,1689,5,839,1.0,571.0,571.0,5,850,1.0,582.0,582.0
0.006,17,2,166,1,75,0.0,47.0,47.0,1,91,0.0,63.0,63.0
171.143,17,76,10671,38,2521,4625.0,44.0,38.0,38,8150,4625.0,239.0,186.0
1787.512,6,150,19350,90,13740,20084.0,302.0,302.0,60,5610,30296.0,83.0,83.0
0.006,6,10,2006,5,927,1.0,659.0,659.0,5,1079,1.0,811.0,811.0
40.079,17,10,676,5,460,10014.0,104.0,64.0,5,216,10014.0,20.0,15.0
0.006,17,2,136,1,60,0.0,32.0,32.0,1,76,0.0,48.0,48.0
0.118,6,10,1506,5,395,29.0,127.0,127.0,5,1111,27.0,843.0,843.0
0.005,6,14,3799,7,509,0.0,137.0,137.0,7,3290,0.0,1448.0,972.0
0.005,6,10,2000,5,927,1.0,659.0,659.0,5,1073,1.0,805.0,805.0
0.012,6,10,1631,5,848,3.0,580.0,580.0,5,783,2.0,515.0,515.0
0.001,17,2,180,1,66,0.0,38.0,38.0,1,114,0.0,86.0,86.0
0.015,17,2,198,1,91,0.0,63.0,63.0,1,107,0.0,79.0,79.0
0.013,6,10,1990,5,911,3.0,643.0,643.0,5,1079,3.0,811.0,811.0
0.096,6,10,1506,5,395,22.0,127.0,127.0,5,1111,14.0,843.0,843.0
0.005,17,2,166,1,75,0.0,47.0,47.0,1,91,0.0,63.0,63.0
0.003,17,2,148,1,60,0.0,32.0,32.0,1,88,0.0,60.0,60.0
0.005,6,10,1689,5,839,1.0,571.0,571.0,5,850,1.0,582.0,582.0
0.001,17,2,178,1,81,0.0,53.0,53.0,1,97,0.0,69.0,69.0
0.002,17,2,166,1,75,0.0,47.0,47.0,1,91,0.0,63.0,63.0
0.16,6,10,1506,5,395,36.0,127.0,127.0,5,1111,37.0,843.0,843.0
0.038,17,4,284,2,120,0.0,32.0,32.0,2,164,35.0,60.0,54.0
0.005,6,10,1989,5,927,1.0,659.0,659.0,5,1062,1.0,794.0,794.0
0.009,6,10,1990,5,911,2.0,643.0,643.0,5,1079,2.0,811.0,811.0
175.266,17,74,10722,37,2466,4868.0,44.0,38.0,37,8256,4868.0,261.0,195.0
0.042,17,2,146,1,65,0.0,37.0,37.0,1,81,0.0,53.0,53.0
40.088,17,10,676,5,460,10018.0,104.0,64.0,5,216,10020.0,20.0,15.0
0.004,17,2,136,1,60,0.0,32.0,32.0,1,76,0.0,48.0,48.0
0.005,6,10,1854,5,889,1.0,621.0,621.0,5,965,1.0,697.0,697.0
0.006,6,10,1854,5,889,1.0,621.0,621.0,5,965,1.0,697.0,697.0
0.127,6,10,1506,5,395,28.0,127.0,127.0,5,1111,29.0,843.0,843.0
0.012,6,10,1605,5,388,2.0,120.0,120.0,5,1217,3.0,949.0,949.0
0.005,6,10,2006,5,927,1.0,659.0,659.0,5,1079,1.0,811.0,811.0
0.005,6,10,2007,5,928,1.0,660.0,660.0,5,1079,1.0,811.0,811.0
0.001,17,2,180,1,66,0.0,38.0,38.0,1,114,0.0,86.0,86.0
0.068,17,8,3613,4,1874,22.0,1350.0,440.0,4,1739,11.0,1350.0,406.0
0.04,17,2,156,1,64,0.0,36.0,36.0,1,92,0.0,64.0,64.0
0.056,17,2,179,1,71,0.0,43.0,43.0,1,108,0.0,80.0,80.0
40.097,17,10,676,5,460,10022.0,104.0,64.0,5,216,10023.0,20.0,15.0
0.005,6,10,1547,5,764,1.0,496.0,496.0,5,783,1.0,515.0,515.0
0.005,6,10,2007,5,928,1.0,660.0,660.0,5,1079,1.0,811.0,811.0
0.216,17,4,596,2,122,141.0,33.0,33.0,2,474,179.0,323.0,209.0
0.011,6,10,1989,5,910,2.0,642.0,642.0,5,1079,2.0,811.0,811.0
0.005,6,10,1779,5,928,1.0,660.0,660.0,5,851,1.0,583.0,583.0
0.005,6,10,1989,5,927,1.0,659.0,659.0,5,1062,1.0,794.0,794.0
40.06,17,10,676,5,460,10014.0,104.0,64.0,5,216,10014.0,20.0,15.0
40.059,17,10,676,5,460,10012.0,104.0,64.0,5,216,10013.0,20.0,15.0
0.017,6,10,1677,5,827,4.0,559.0,559.0,5,850,4.0,582.0,582.0
0.006,6,10,1547,5,764,1.0,496.0,496.0,5,783,1.0,515.0,515.0
0.001,17,2,180,1,66,0.0,38.0,38.0,1,114,0.0,86.0,86.0
0.008,6,10,1989,5,910,2.0,642.0,642.0,5,1079,2.0,811.0,811.0
135.489,58,3,216,2,144,135489.0,24.0,24.0,1,72,0.0,24.0,24.0
0.022,6,10,1990,5,911,5.0,643.0,643.0,5,1079,5.0,811.0,811.0
0.075,6,10,1506,5,395,17.0,127.0,127.0,5,1111,15.0,843.0,843.0
0.003,17,2,136,1,60,0.0,32.0,32.0,1,76,0.0,48.0,48.0
0.014,6,10,1972,5,910,3.0,642.0,642.0,5,1062,3.0,794.0,794.0
0.004,6,10,2007,5,928,1.0,660.0,660.0,5,1079,1.0,811.0,811.0
0.015,6,10,1605,5,388,3.0,120.0,120.0,5,1217,3.0,949.0,949.0
0.007,6,10,1547,5,764,1.0,496.0,496.0,5,783,1.0,515.0,515.0
0.011,6,10,1762,5,911,2.0,643.0,643.0,5,851,2.0,583.0,583.0
40.058,17,10,676,5,460,10011.0,104.0,64.0,5,216,10013.0,20.0,15.0
175.377,17,86,12792,43,2903,4175.0,44.0,39.0,43,9889,4175.0,279.0,201.0
0.127,6,10,1506,5,395,23.0,127.0,127.0,5,1111,25.0,843.0,843.0
0.01,6,10,1989,5,910,2.0,642.0,642.0,5,1079,2.0,811.0,811.0
0.931,6,25,8493,14,2109,71.0,1142.0,379.0,11,6384,75.0,2720.0,988.0
0.072,17,4,352,2,130,1.0,37.0,37.0,2,222,28.0,89.0,83.0
0.012,6,10,1989,5,910,3.0,642.0,642.0,5,1079,2.0,811.0,811.0
0.009,6,12,1926,6,1189,1.0,659.0,434.0,6,737,1.0,417.0,417.0
0.004,6,10,2006,5,927,1.0,659.0,659.0,5,1079,1.0,811.0,811.0
0.042,17,2,136,1,60,0.0,32.0,32.0,1,76,0.0,48.0,48.0
0.029,6,10,1631,5,848,7.0,580.0,580.0,5,783,7.0,515.0,515.0
0.007,17,2,148,1,60,0.0,32.0,32.0,1,88,0.0,60.0,60.0
0.063,6,10,1506,5,395,12.0,127.0,127.0,5,1111,15.0,843.0,843.0
0.005,6,10,1989,5,927,1.0,659.0,659.0,5,1062,1.0,794.0,794.0
0.022,6,10,1990,5,911,5.0,643.0,643.0,5,1079,5.0,811.0,811.0
0.004,6,10,1702,5,863,0.0,595.0,595.0,5,839,1.0,571.0,571.0
0.014,6,10,1677,5,827,3.0,559.0,559.0,5,850,3.0,582.0,582.0
0.006,17,2,169,1,62,0.0,34.0,34.0,1,107,0.0,79.0,79.0
0.044,6,14,3868,7,578,7.0,206.0,206.0,7,3290,7.0,1448.0,972.0
0.001,17,2,136,1,60,0.0,32.0,32.0,1,76,0.0,48.0,48.0
240.023,6,9,787,5,488,60005.0,232.0,232.0,4,299,80007.0,83.0,83.0
0.114,6,10,1506,5,395,23.0,127.0,127.0,5,1111,24.0,843.0,843.0
0.079,6,10,1506,5,395,18.0,127.0,127.0,5,1111,18.0,843.0,843.0
0.013,6,10,1983,5,910,3.0,642.0,642.0,5,1073,3.0,805.0,805.0
0.01,6,10,1983,5,910,2.0,642.0,642.0,5,1073,2.0,805.0,805.0
0.084,6,10,1506,5,395,19.0,127.0,127.0,5,1111,19.0,843.0,843.0
0.006,6,10,1547,5,764,1.0,496.0,496.0,5,783,1.0,515.0,515.0
15.075,17,15,9254,8,6912,2149.0,1350.0,836.0,7,2342,2507.0,1350.0,306.0
0.003,17,2,136,1,60,0.0,32.0,32.0,1,76,0.0,48.0,48.0
240.094,6,31,9272,15,6895,17149.0,2019.0,679.0,16,2377,16006.0,580.0,192.0
0.095,6,10,1506,5,395,21.0,127.0,127.0,5,1111,20.0,843.0,843.0
0.006,6,10,1689,5,839,1.0,571.0,571.0,5,850,1.0,582.0,582.0
0.077,6,10,1506,5,395,16.0,127.0,127.0,5,1111,16.0,843.0,843.0
11.171,17,28,4417,14,1993,847.0,268.0,114.0,14,2424,847.0,587.0,145.0
0.014,6,10,1989,5,910,3.0,642.0,642.0,5,1079,3.0,811.0,811.0
0.003,6,10,1702,5,863,0.0,595.0,595.0,5,839,0.0,571.0,571.0
0.079,6,10,1506,5,395,16.0,127.0,127.0,5,1111,16.0,843.0,843.0
0.096,6,10,1506,5,395,23.0,127.0,127.0,5,1111,21.0,843.0,843.0
0.005,6,10,2000,5,927,1.0,659.0,659.0,5,1073,1.0,805.0,805.0
0.088,6,10,1506,5,395,19.0,127.0,127.0,5,1111,18.0,843.0,843.0
0.007,17,2,194,1,59,0.0,31.0,31.0,1,135,0.0,107.0,107.0
1770.304,6,87,4626,44,2340,41168.0,26.0,26.0,43,2286,42149.0,26.0,25.0
0.005,6,10,1779,5,928,1.0,660.0,660.0,5,851,1.0,583.0,583.0
0.005,6,10,1854,5,889,1.0,621.0,621.0,5,965,1.0,697.0,697.0
0.001,17,2,136,1,60,0.0,32.0,32.0,1,76,0.0,48.0,48.0
240.191,6,21,6466,11,1770,24019.0,936.0,400.0,10,4696,26687.0,1591.0,694.0
0.004,6,10,2000,5,927,1.0,659.0,659.0,5,1073,1.0,805.0,805.0
0.005,6,10,1989,5,927,1.0,659.0,659.0,5,1062,1.0,794.0,794.0
0.142,6,10,1506,5,395,33.0,127.0,127.0,5,1111,25.0,843.0,843.0
0.005,6,10,2000,5,927,1.0,659.0,659.0,5,1073,1.0,805.0,805.0
0.005,6,10,2007,5,928,1.0,660.0,660.0,5,1079,1.0,811.0,811.0
0.008,17,2,170,1,65,0.0,37.0,37.0,1,105,0.0,77.0,77.0
0.098,6,10,1506,5,395,23.0,127.0,127.0,5,1111,23.0,843.0,843.0
0.008,6,10,1547,5,764,2.0,496.0,496.0,5,783,1.0,515.0,515.0
9.036,17,6,376,5,280,2259.0,28.0,28.0,1,96,0.0,68.0,68.0
0.091,6,10,1506,5,395,20.0,127.0,127.0,5,1111,20.0,843.0,843.0
0.118,6,10,1506,5,395,27.0,127.0,127.0,5,1111,22.0,843.0,843.0
0.01,6,10,1983,5,910,2.0,642.0,642.0,5,1073,2.0,805.0,805.0
0.008,6,10,1990,5,911,2.0,643.0,643.0,5,1079,2.0,811.0,811.0
0.005,6,10,2006,5,927,1.0,659.0,659.0,5,1079,1.0,811.0,811.0
0.005,6,10,2007,5,928,1.0,660.0,660.0,5,1079,1.0,811.0,811.0
40.054,17,10,676,5,460,10012.0,104.0,64.0,5,216,10012.0,20.0,15.0
0.105,6,10,1506,5,395,21.0,127.0,127.0,5,1111,25.0,843.0,843.0
0.069,6,10,1506,5,395,16.0,127.0,127.0,5,1111,15.0,843.0,843.0
0.006,17,2,225,1,65,0.0,37.0,37.0,1,160,0.0,132.0,132.0
240.308,6,35,10702,18,2211,14135.0,555.0,253.0,17,8491,15019.0,1887.0,691.0
0.011,6,10,1983,5,910,2.0,642.0,642.0,5,1073,2.0,805.0,805.0
0.109,6,10,1506,5,395,26.0,127.0,127.0,5,1111,24.0,843.0,843.0
181.401,17,76,10845,38,2537,4902.0,44.0,38.0,38,8308,4902.0,260.0,190.0
0.005,6,10,2007,5,928,1.0,660.0,660.0,5,1079,1.0,811.0,811.0
0.014,6,10,1990,5,911,3.0,643.0,643.0,5,1079,3.0,811.0,811.0
0.004,17,2,136,1,60,0.0,32.0,32.0,1,76,0.0,48.0,48.0
40.063,17,10,676,5,460,10014.0,104.0,64.0,5,216,10014.0,20.0,15.0
0.011,6,10,1989,5,910,2.0,642.0,642.0,5,1079,2.0,811.0,811.0
0.004,17,2,136,1,60,0.0,32.0,32.0,1,76,0.0,48.0,48.0
0.041,17,4,284,2,120,0.0,32.0,32.0,2,164,38.0,60.0,54.0
0.014,6,10,1989,5,910,3.0,642.0,642.0,5,1079,3.0,811.0,811.0
0.013,6,10,1990,5,911,3.0,643.0,643.0,5,1079,3.0,811.0,811.0
0.001,17,2,180,1,66,0.0,38.0,38.0,1,114,0.0,86.0,86.0
240.28,6,44,8823,22,5738,11441.0,1368.0,458.0,22,3085,11441.0,580.0,241.0
0.104,6,10,1506,5,395,22.0,127.0,127.0,5,1111,23.0,843.0,843.0
0.119,6,10,1506,5,395,26.0,127.0,127.0,5,1111,24.0,843.0,843.0
0.005,6,10,2000,5,927,1.0,659.0,659.0,5,1073,1.0,805.0,805.0
9.035,17,6,376,5,280,2258.0,28.0,28.0,1,96,0.0,68.0,68.0
0.01,6,10,1972,5,910,2.0,642.0,642.0,5,1062,2.0,794.0,794.0
0.015,6,10,1972,5,910,3.0,642.0,642.0,5,1062,3.0,794.0,794.0
0.005,6,10,2007,5,928,1.0,660.0,660.0,5,1079,1.0,811.0,811.0
0.004,6,10,1779,5,928,1.0,660.0,660.0,5,851,1.0,583.0,583.0
300.455,6,25,7300,15,1357,21461.0,217.0,142.0,10,5943,26710.0,1679.0,902.0
0.004,6,10,2007,5,928,1.0,660.0,660.0,5,1079,1.0,811.0,811.0
0.004,6,10,1774,5,923,1.0,655.0,655.0,5,851,1.0,583.0,583.0
0.083,6,10,1506,5,395,19.0,127.0,127.0,5,1111,19.0,843.0,843.0
0.012,6,10,1990,5,911,3.0,643.0,643.0,5,1079,2.0,811.0,811.0
0.101,6,10,1506,5,395,17.0,127.0,127.0,5,1111,24.0,843.0,843.0
0.005,17,2,136,1,60,0.0,32.0,32.0,1,76,0.0,48.0,48.0
0.003,17,2,136,1,60,0.0,32.0,32.0,1,76,0.0,48.0,48.0
11.211,17,28,4421,14,1994,850.0,269.0,114.0,14,2427,850.0,586.0,145.0
0.221,6,16,2669,8,1395,31.0,533.0,323.0,8,1274,20.0,529.0,212.0
0.011,6,10,1983,5,910,2.0,642.0,642.0,5,1073,2.0,805.0,805.0
0.081,6,10,1506,5,395,16.0,127.0,127.0,5,1111,19.0,843.0,843.0
0.004,17,4,284,2,120,0.0,32.0,32.0,2,164,1.0,60.0,54.0
0.165,6,10,1506,5,395,21.0,127.0,127.0,5,1111,39.0,843.0,843.0
0.085,6,10,1506,5,395,19.0,127.0,127.0,5,1111,17.0,843.0,843.0
0.009,6,10,1990,5,911,2.0,643.0,643.0,5,1079,2.0,811.0,811.0
11.181,17,28,4398,14,2312,851.0,587.0,137.0,14,2086,851.0,269.0,121.0
0.005,17,2,169,1,62,0.0,34.0,34.0,1,107,0.0,79.0,79.0
0.081,6,10,1506,5,395,17.0,127.0,127.0,5,1111,19.0,843.0,843.0
15.082,17,16,9303,8,6912,2150.0,1350.0,836.0,8,2391,2150.0,1350.0,270.0
0.007,6,10,2000,5,927,1.0,659.0,659.0,5,1073,1.0,805.0,805.0
11.192,17,28,4419,14,1995,848.0,270.0,114.0,14,2424,848.0,587.0,145.0
0.103,6,10,1506,5,395,21.0,127.0,127.0,5,1111,22.0,843.0,843.0
0.062,6,10,1506,5,395,14.0,127.0,127.0,5,1111,14.0,843.0,843.0
366.977,6,21,1795,16,1030,24465.0,190.0,190.0,5,765,60013.0,464.0,248.0
0.005,17,2,230,1,68,0.0,40.0,40.0,1,162,0.0,134.0,134.0
0.004,6,10,2007,5,928,1.0,660.0,660.0,5,1079,1.0,811.0,811.0
294.413,6,400,349019,194,21644,1525.0,2736.0,888.0,206,327375,1436.0,2933.0,1649.0
0.011,6,10,1990,5,911,2.0,643.0,643.0,5,1079,2.0,811.0,811.0
0.005,17,2,152,1,68,0.0,40.0,40.0,1,84,0.0,56.0,56.0
0.005,6,10,2007,5,928,1.0,660.0,660.0,5,1079,1.0,811.0,811.0
0.009,6,10,1989,5,910,2.0,642.0,642.0,5,1079,2.0,811.0,811.0
0.016,6,10,1972,5,910,4.0,642.0,642.0,5,1062,3.0,794.0,794.0
0.082,6,10,1506,5,395,17.0,127.0,127.0,5,1111,19.0,843.0,843.0
0.013,6,10,1762,5,911,3.0,643.0,643.0,5,851,3.0,583.0,583.0
0.005,6,10,1989,5,927,1.0,659.0,659.0,5,1062,1.0,794.0,794.0
0.005,17,2,213,1,69,0.0,41.0,41.0,1,144,0.0,116.0,116.0
0.005,6,10,2007,5,928,1.0,660.0,660.0,5,1079,1.0,811.0,811.0
0.004,6,10,1702,5,863,1.0,595.0,595.0,5,839,1.0,571.0,571.0
0.109,6,10,1506,5,395,22.0,127.0,127.0,5,1111,24.0,843.0,843.0
40.074,17,10,676,5,460,10017.0,104.0,64.0,5,216,10017.0,20.0,15.0
0.005,6,13,3747,7,509,0.0,137.0,137.0,6,3238,1.0,1470.0,1459.0
0.008,6,12,1926,6,1189,1.0,659.0,434.0,6,737,1.0,417.0,417.0
0.009,6,10,1972,5,910,2.0,642.0,642.0,5,1062,2.0,794.0,794.0
0.098,6,10,1506,5,395,21.0,127.0,127.0,5,1111,21.0,843.0,843.0
0.018,6,10,1972,5,910,4.0,642.0,642.0,5,1062,4.0,794.0,794.0
0.125,6,10,1506,5,395,28.0,127.0,127.0,5,1111,25.0,843.0,843.0
40.059,17,10,676,5,460,10014.0,104.0,64.0,5,216,10014.0,20.0,15.0
0.028,6,13,3735,7,497,4.0,125.0,125.0,6,3238,5.0,1470.0,1459.0
0.005,6,13,3747,7,509,0.0,137.0,137.0,6,3238,1.0,1470.0,1459.0
0.011,6,10,1983,5,910,2.0,642.0,642.0,5,1073,2.0,805.0,805.0
0.011,6,10,1989,5,910,2.0,642.0,642.0,5,1079,2.0,811.0,811.0
241.394,6,381,347373,192,21519,1263.0,4104.0,960.0,189,325854,1283.0,3957.0,1765.0
0.005,6,10,1989,5,927,1.0,659.0,659.0,5,1062,1.0,794.0,794.0
0.005,6,10,2007,5,928,1.0,660.0,660.0,5,1079,1.0,811.0,811.0
0.001,17,2,164,1,74,0.0,46.0,46.0,1,90,0.0,62.0,62.0
0.091,6,10,1506,5,395,17.0,127.0,127.0,5,1111,20.0,843.0,843.0
0.009,6,10,1989,5,910,2.0,642.0,642.0,5,1079,2.0,811.0,811.0
0.01,6,10,1989,5,910,2.0,642.0,642.0,5,1079,2.0,811.0,811.0
0.006,6,10,1989,5,927,1.0,659.0,659.0,5,1062,1.0,794.0,794.0
0.008,6,10,1972,5,910,2.0,642.0,642.0,5,1062,2.0,794.0,794.0
0.004,6,10,1702,5,863,1.0,595.0,595.0,5,839,0.0,571.0,571.0
0.041,17,2,148,1,60,0.0,32.0,32.0,1,88,0.0,60.0,60.0
0.014,6,13,3735,7,497,2.0,125.0,125.0,6,3238,2.0,1470.0,1459.0
0.012,6,10,1989,5,910,3.0,642.0,642.0,5,1079,2.0,811.0,811.0
0.004,6,10,1702,5,863,1.0,595.0,595.0,5,839,0.0,571.0,571.0
0.004,17,4,284,2,120,0.0,32.0,32.0,2,164,1.0,60.0,54.0
0.115,6,10,1506,5,395,25.0,127.0,127.0,5,1111,23.0,843.0,843.0
0.074,6,45,14036,25,2555,3.0,517.0,139.0,20,11481,3.0,1402.0,745.0
0.115,6,10,1506,5,395,27.0,127.0,127.0,5,1111,20.0,843.0,843.0
0.013,6,10,1989,5,910,3.0,642.0,642.0,5,1079,3.0,811.0,811.0
0.007,6,10,1547,5,764,1.0,496.0,496.0,5,783,1.0,515.0,515.0
240.329,6,29,12057,14,6247,18486.0,1373.0,920.0,15,5810,17166.0,1655.0,837.0
0.071,6,10,1506,5,395,16.0,127.0,127.0,5,1111,15.0,843.0,843.0
0.005,6,10,2006,5,927,1.0,659.0,659.0,5,1079,1.0,811.0,811.0
0.02,6,10,1990,5,911,5.0,643.0,643.0,5,1079,4.0,811.0,811.0
0.135,6,10,1506,5,395,29.0,127.0,127.0,5,1111,29.0,843.0,843.0
0.01,6,10,1989,5,910,2.0,642.0,642.0,5,1079,2.0,811.0,811.0
0.087,6,10,1506,5,395,19.0,127.0,127.0,5,1111,16.0,843.0,843.0
0.005,6,10,2000,5,927,1.0,659.0,659.0,5,1073,1.0,805.0,805.0
0.093,6,10,1506,5,395,18.0,127.0,127.0,5,1111,20.0,843.0,843.0
40.093,17,10,676,5,460,10020.0,104.0,64.0,5,216,10022.0,20.0,15.0
0.028,6,10,1972,5,910,7.0,642.0,642.0,5,1062,7.0,794.0,794.0
0.005,17,2,144,1,64,0.0,36.0,36.0,1,80,0.0,52.0,52.0
0.017,6,10,1989,5,910,4.0,642.0,642.0,5,1079,4.0,811.0,811.0
0.018,6,10,1983,5,910,4.0,642.0,642.0,5,1073,4.0,805.0,805.0
0.004,6,10,2000,5,927,1.0,659.0,659.0,5,1073,1.0,805.0,805.0
0.004,6,10,1779,5,928,1.0,660.0,660.0,5,851,1.0,583.0,583.0
0.127,17,4,420,2,122,0.0,33.0,33.0,2,298,86.0,145.0,121.0
0.009,17,2,194,1,59,0.0,31.0,31.0,1,135,0.0,107.0,107.0
0.013,6,10,1762,5,911,3.0,643.0,643.0,5,851,3.0,583.0,583.0
0.006,6,10,1643,5,860,1.0,592.0,592.0,5,783,1.0,515.0,515.0
412.257,6,29,4409,12,3102,10911.0,494.0,494.0,17,1307,25765.0,83.0,83.0
0.086,6,10,1506,5,395,19.0,127.0,127.0,5,1111,18.0,843.0,843.0
0.007,6,10,2006,5,927,1.0,659.0,659.0,5,1079,1.0,811.0,811.0
309.195,17,20,1124,10,716,34340.0,48.0,43.0,10,408,34340.0,20.0,12.0
0.072,17,4,284,2,120,0.0,32.0,32.0,2,164,69.0,60.0,54.0
0.007,17,2,179,1,71,0.0,43.0,43.0,1,108,0.0,80.0,80.0
240.094,6,16,4481,9,963,30011.0,238.0,166.0,7,3518,40015.0,1402.0,786.0
0.02,6,10,1989,5,910,4.0,642.0,642.0,5,1079,5.0,811.0,811.0
0.188,17,4,352,2,130,148.0,37.0,37.0,2,222,145.0,89.0,83.0
0.081,6,10,1506,5,395,17.0,127.0,127.0,5,1111,19.0,843.0,843.0
0.001,17,2,294,1,64,0.0,36.0,36.0,1,230,0.0,202.0,202.0
0.006,17,2,170,1,65,0.0,37.0,37.0,1,105,0.0,77.0,77.0
175.452,17,80,11565,40,2681,4498.0,44.0,39.0,40,8884,4498.0,261.0,194.0
0.005,6,10,2006,5,927,1.0,659.0,659.0,5,1079,1.0,811.0,811.0
0.004,17,2,136,1,60,0.0,32.0,32.0,1,76,0.0,48.0,48.0
0.006,6,10,1547,5,764,1.0,496.0,496.0,5,783,1.0,515.0,515.0
0.005,6,10,1989,5,927,1.0,659.0,659.0,5,1062,1.0,794.0,794.0
40.052,17,10,676,5,460,10012.0,104.0,64.0,5,216,10012.0,20.0,15.0
0.009,6,10,1762,5,911,2.0,643.0,643.0,5,851,2.0,583.0,583.0
0.004,6,10,2006,5,927,1.0,659.0,659.0,5,1079,1.0,811.0,811.0
0.011,6,10,1989,5,910,2.0,642.0,642.0,5,1079,2.0,811.0,811.0
0.004,6,10,1774,5,923,1.0,655.0,655.0,5,851,1.0,583.0,583.0
9.035,17,6,376,5,280,2258.0,28.0,28.0,1,96,0.0,68.0,68.0
0.01,6,10,1990,5,911,2.0,643.0,643.0,5,1079,2.0,811.0,811.0
0.011,6,10,1990,5,911,2.0,643.0,643.0,5,1079,2.0,811.0,811.0
0.005,17,2,164,1,74,0.0,46.0,46.0,1,90,0.0,62.0,62.0
0.004,17,4,284,2,120,0.0,32.0,32.0,2,164,0.0,60.0,54.0
0.073,6,10,1506,5,395,15.0,127.0,127.0,5,1111,15.0,843.0,843.0
1730.375,6,45,2790,30,1725,59668.0,35.0,35.0,15,1065,123592.0,31.0,31.0
0.124,6,10,1506,5,395,28.0,127.0,127.0,5,1111,30.0,843.0,843.0
0.006,6,10,1854,5,889,1.0,621.0,621.0,5,965,1.0,697.0,697.0
0.006,17,2,172,1,59,0.0,31.0,31.0,1,113,0.0,85.0,85.0
0.005,6,10,1989,5,927,1.0,659.0,659.0,5,1062,1.0,794.0,794.0
0.006,6,10,1689,5,839,1.0,571.0,571.0,5,850,1.0,582.0,582.0
593.635,6,32,5142,14,3700,23093.0,494.0,494.0,18,1442,34919.0,83.0,83.0
0.004,6,10,1989,5,927,1.0,659.0,659.0,5,1062,1.0,794.0,794.0
0.009,6,10,1972,5,910,2.0,642.0,642.0,5,1062,2.0,794.0,794.0
0.083,6,10,1506,5,395,16.0,127.0,127.0,5,1111,20.0,843.0,843.0
0.006,6,10,1689,5,839,1.0,571.0,571.0,5,850,1.0,582.0,582.0
0.013,6,10,1990,5,911,3.0,643.0,643.0,5,1079,3.0,811.0,811.0
0.004,6,10,1989,5,927,1.0,659.0,659.0,5,1062,1.0,794.0,794.0
0.011,6,10,1972,5,910,2.0,642.0,642.0,5,1062,2.0,794.0,794.0
0.072,6,10,1506,5,395,16.0,127.0,127.0,5,1111,15.0,843.0,843.0
0.067,6,10,1506,5,395,13.0,127.0,127.0,5,1111,13.0,843.0,843.0
0.115,6,10,1506,5,395,26.0,127.0,127.0,5,1111,25.0,843.0,843.0
0.005,6,10,1689,5,839,1.0,571.0,571.0,5,850,1.0,582.0,582.0
0.104,6,10,1506,5,395,23.0,127.0,127.0,5,1111,19.0,843.0,843.0
0.019,6,10,1989,5,910,4.0,642.0,642.0,5,1079,4.0,811.0,811.0
0.004,17,2,148,1,60,0.0,32.0,32.0,1,88,0.0,60.0,60.0
292.472,6,391,348085,187,21287,1572.0,2736.0,888.0,204,326798,1440.0,2804.0,1664.0
40.055,17,10,676,5,460,10013.0,104.0,64.0,5,216,10007.0,20.0,15.0
0.005,6,14,3799,7,509,0.0,137.0,137.0,7,3290,0.0,1448.0,972.0
10.792,17,28,4422,14,1995,821.0,270.0,114.0,14,2427,821.0,586.0,145.0
0.006,6,10,1547,5,764,1.0,496.0,496.0,5,783,1.0,515.0,515.0
0.016,6,10,1972,5,910,4.0,642.0,642.0,5,1062,3.0,794.0,794.0
0.07,17,8,3613,4,1874,23.0,1350.0,440.0,4,1739,11.0,1350.0,406.0
0.004,6,10,1702,5,863,1.0,595.0,595.0,5,839,0.0,571.0,571.0
0.172,17,2,152,1,76,0.0,48.0,48.0,1,76,0.0,48.0,48.0
0.006,6,10,1643,5,860,1.0,592.0,592.0,5,783,1.0,515.0,515.0
0.045,17,2,148,1,60,0.0,32.0,32.0,1,88,0.0,60.0,60.0
0.093,6,10,1506,5,395,21.0,127.0,127.0,5,1111,21.0,843.0,843.0
174.227,17,80,11827,40,2684,4467.0,44.0,39.0,40,9143,4467.0,260.0,200.0
0.06,6,10,1506,5,395,13.0,127.0,127.0,5,1111,14.0,843.0,843.0
0.005,6,10,2007,5,928,1.0,660.0,660.0,5,1079,1.0,811.0,811.0
0.011,6,10,1989,5,910,2.0,642.0,642.0,5,1079,2.0,811.0,811.0
0.007,6,10,1990,5,911,1.0,643.0,643.0,5,1079,1.0,811.0,811.0
0.015,6,10,1972,5,910,3.0,642.0,642.0,5,1062,3.0,794.0,794.0
0.005,17,2,170,1,65,0.0,37.0,37.0,1,105,0.0,77.0,77.0
0.012,6,10,1972,5,910,3.0,642.0,642.0,5,1062,2.0,794.0,794.0
0.083,6,10,1506,5,395,19.0,127.0,127.0,5,1111,17.0,843.0,843.0
0.015,6,10,1989,5,910,3.0,642.0,642.0,5,1079,3.0,811.0,811.0
0.173,6,3,453,2,321,173.0,241.0,241.0,1,132,0.0,92.0,92.0
0.005,6,10,2006,5,927,1.0,659.0,659.0,5,1079,1.0,811.0,811.0
0.006,6,10,1689,5,839,1.0,571.0,571.0,5,850,1.0,582.0,582.0
0.005,6,10,1689,5,839,1.0,571.0,571.0,5,850,1.0,582.0,582.0
0.004,6,10,1779,5,928,1.0,660.0,660.0,5,851,1.0,583.0,583.0
0.107,6,10,1506,5,395,25.0,127.0,127.0,5,1111,21.0,843.0,843.0
0.006,6,10,1547,5,764,1.0,496.0,496.0,5,783,1.0,515.0,515.0
0.272,6,10,1506,5,395,58.0,127.0,127.0,5,1111,63.0,843.0,843.0
0.086,6,10,1506,5,395,20.0,127.0,127.0,5,1111,20.0,843.0,843.0
0.179,6,10,1506,5,395,43.0,127.0,127.0,5,1111,39.0,843.0,843.0
0.015,6,10,1983,5,910,3.0,642.0,642.0,5,1073,3.0,805.0,805.0
15.446,17,48,22141,25,18574,642.0,1350.0,714.0,23,3567,700.0,1350.0,127.0
0.007,17,2,194,1,59,0.0,31.0,31.0,1,135,0.0,107.0,107.0
40.061,17,10,676,5,460,10013.0,104.0,64.0,5,216,10014.0,20.0,15.0
0.005,6,10,2006,5,927,1.0,659.0,659.0,5,1079,1.0,811.0,811.0
0.005,6,10,2006,5,927,1.0,659.0,659.0,5,1079,1.0,811.0,811.0
40.067,17,10,676,5,460,10015.0,104.0,64.0,5,216,10016.0,20.0,15.0
0.004,17,2,148,1,60,0.0,32.0,32.0,1,88,0.0,60.0,60.0
0.006,17,2,146,1,65,0.0,37.0,37.0,1,81,0.0,53.0,53.0
0.005,6,10,1989,5,927,1.0,659.0,659.0,5,1062,1.0,794.0,794.0
0.006,6,10,1643,5,860,1.0,592.0,592.0,5,783,1.0,515.0,515.0
0.014,6,10,1989,5,910,3.0,642.0,642.0,5,1079,3.0,811.0,811.0
0.005,17,2,140,1,62,0.0,34.0,34.0,1,78,0.0,50.0,50.0
0.006,6,10,1854,5,889,1.0,621.0,621.0,5,965,1.0,697.0,697.0
0.006,6,10,1689,5,839,1.0,571.0,571.0,5,850,1.0,582.0,582.0
0.024,6,10,1972,5,910,5.0,642.0,642.0,5,1062,6.0,794.0,794.0
0.013,6,10,1990,5,911,3.0,643.0,643.0,5,1079,3.0,811.0,811.0
0.006,6,10,1689,5,839,1.0,571.0,571.0,5,850,1.0,582.0,582.0
0.004,17,4,284,2,120,0.0,32.0,32.0,2,164,0.0,60.0,54.0
0.008,6,12,1926,6,1189,1.0,659.0,434.0,6,737,1.0,417.0,417.0
0.024,6,10,1677,5,827,6.0,559.0,559.0,5,850,5.0,582.0,582.0
0.005,6,10,2006,5,927,1.0,659.0,659.0,5,1079,1.0,811.0,811.0
0.072,17,4,284,2,120,0.0,32.0,32.0,2,164,68.0,60.0,54.0
0.083,6,44,14037,25,2617,3.0,517.0,146.0,19,11420,4.0,1402.0,744.0
0.07,6,10,1506,5,395,15.0,127.0,127.0,5,1111,14.0,843.0,843.0
0.004,6,10,2006,5,927,1.0,659.0,659.0,5,1079,1.0,811.0,811.0
0.006,17,2,144,1,64,0.0,36.0,36.0,1,80,0.0,52.0,52.0
0.083,6,10,1506,5,395,18.0,127.0,127.0,5,1111,19.0,843.0,843.0
0.005,6,10,1774,5,923,1.0,655.0,655.0,5,851,1.0,583.0,583.0
0.014,6,10,1631,5,848,3.0,580.0,580.0,5,783,3.0,515.0,515.0
0.167,17,2,152,1,76,0.0,48.0,48.0,1,76,0.0,48.0,48.0
294.663,6,322,343991,121,17841,2455.0,2736.0,888.0,201,326150,1473.0,2804.0,1697.0
0.01,6,10,1989,5,910,2.0,642.0,642.0,5,1079,2.0,811.0,811.0
0.006,6,10,2006,5,927,1.0,659.0,659.0,5,1079,1.0,811.0,811.0
0.005,6,10,1689,5,839,1.0,571.0,571.0,5,850,1.0,582.0,582.0
0.01,6,10,1990,5,911,2.0,643.0,643.0,5,1079,2.0,811.0,811.0
40.054,17,10,676,5,460,10012.0,104.0,64.0,5,216,10012.0,20.0,15.0
0.013,6,10,1990,5,911,3.0,643.0,643.0,5,1079,3.0,811.0,811.0
0.008,6,12,1926,6,1189,1.0,659.0,434.0,6,737,1.0,417.0,417.0
0.012,6,10,1972,5,910,3.0,642.0,642.0,5,1062,2.0,794.0,794.0
0.005,6,10,1989,5,927,1.0,659.0,659.0,5,1062,1.0,794.0,794.0
0.115,6,10,1506,5,395,28.0,127.0,127.0,5,1111,25.0,843.0,843.0
0.039,17,2,152,1,76,0.0,48.0,48.0,1,76,0.0,48.0,48.0
0.001,17,2,174,1,72,0.0,44.0,44.0,1,102,0.0,74.0,74.0
0.013,6,10,2007,5,928,3.0,660.0,660.0,5,1079,3.0,811.0,811.0
40.059,17,10,676,5,460,10013.0,104.0,64.0,5,216,10013.0,20.0,15.0
0.005,6,10,1989,5,927,1.0,659.0,659.0,5,1062,1.0,794.0,794.0
0.006,6,10,1854,5,889,1.0,621.0,621.0,5,965,1.0,697.0,697.0
0.044,17,2,152,1,76,0.0,48.0,48.0,1,76,0.0,48.0,48.0
0.017,6,10,1677,5,827,4.0,559.0,559.0,5,850,4.0,582.0,582.0
0.011,6,10,1989,5,910,2.0,642.0,642.0,5,1079,2.0,811.0,811.0
0.017,6,10,1989,5,910,4.0,642.0,642.0,5,1079,4.0,811.0,811.0
0.008,6,10,1990,5,911,2.0,643.0,643.0,5,1079,1.0,811.0,811.0
0.096,6,45,14196,25,2617,4.0,517.0,146.0,20,11579,4.0,1402.0,752.0
0.026,6,10,1989,5,910,6.0,642.0,642.0,5,1079,6.0,811.0,811.0
0.005,6,13,3747,7,509,0.0,137.0,137.0,6,3238,1.0,1470.0,1459.0
0.171,17,2,152,1,76,0.0,48.0,48.0,1,76,0.0,48.0,48.0
0.072,17,8,3613,4,1874,24.0,1350.0,440.0,4,1739,12.0,1350.0,406.0
0.001,17,2,180,1,66,0.0,38.0,38.0,1,114,0.0,86.0,86.0
0.001,17,2,180,1,66,0.0,38.0,38.0,1,114,0.0,86.0,86.0
0.018,6,10,1990,5,911,4.0,643.0,643.0,5,1079,4.0,811.0,811.0
0.005,17,2,164,1,74,0.0,46.0,46.0,1,90,0.0,62.0,62.0
1786.923,6,161,20442,95,14334,19009.0,302.0,302.0,66,6108,27491.0,83.0,83.0
0.005,6,10,1989,5,927,1.0,659.0,659.0,5,1062,1.0,794.0,794.0
360.027,6,21,3981,13,3142,30002.0,494.0,494.0,8,839,51431.0,83.0,83.0
40.061,17,10,676,5,460,10014.0,104.0,64.0,5,216,10014.0,20.0,15.0
40.108,17,10,676,5,460,10015.0,104.0,64.0,5,216,10020.0,20.0,15.0
0.07,6,10,1506,5,395,16.0,127.0,127.0,5,1111,16.0,843.0,843.0
269.407,6,20,3797,11,2323,26937.0,676.0,348.0,9,1474,33671.0,821.0,336.0
0.009,6,12,1926,6,1189,1.0,659.0,434.0,6,737,1.0,417.0,417.0
0.01,17,2,184,1,61,0.0,33.0,33.0,1,123,0.0,95.0,95.0
0.088,6,10,1506,5,395,17.0,127.0,127.0,5,1111,17.0,843.0,843.0
0.035,6,10,1989,5,910,8.0,642.0,642.0,5,1079,8.0,811.0,811.0
34.384,6,40,10527,20,4929,471.0,1360.0,682.0,20,5598,1800.0,2667.0,435.0
0.093,6,10,1506,5,395,18.0,127.0,127.0,5,1111,21.0,843.0,843.0
0.108,6,10,1506,5,395,17.0,127.0,127.0,5,1111,25.0,843.0,843.0
0.098,6,10,1506,5,395,20.0,127.0,127.0,5,1111,23.0,843.0,843.0
0.004,17,2,148,1,60,0.0,32.0,32.0,1,88,0.0,60.0,60.0
1770.726,6,135,6510,75,3585,23925.0,39.0,39.0,60,2925,30008.0,35.0,35.0
0.01,6,10,2006,5,927,2.0,659.0,659.0,5,1079,2.0,811.0,811.0
0.07,17,2,148,1,60,0.0,32.0,32.0,1,88,0.0,60.0,60.0
0.016,6,10,1989,5,910,3.0,642.0,642.0,5,1079,4.0,811.0,811.0
0.037,17,2,182,1,65,0.0,37.0,37.0,1,117,0.0,89.0,89.0
0.012,6,10,1972,5,910,2.0,642.0,642.0,5,1062,2.0,794.0,794.0
0.004,6,10,2007,5,928,1.0,660.0,660.0,5,1079,1.0,811.0,811.0
0.038,6,10,1762,5,911,9.0,643.0,643.0,5,851,9.0,583.0,583.0
0.079,6,10,1506,5,395,18.0,127.0,127.0,5,1111,16.0,843.0,843.0
0.008,6,10,1983,5,910,1.0,642.0,642.0,5,1073,2.0,805.0,805.0
0.003,6,10,1702,5,863,0.0,595.0,595.0,5,839,0.0,571.0,571.0
0.006,17,2,169,1,62,0.0,34.0,34.0,1,107,0.0,79.0,79.0
309.005,17,19,1084,10,716,34316.0,48.0,43.0,9,368,38611.0,20.0,12.0
0.006,6,10,1547,5,764,1.0,496.0,496.0,5,783,1.0,515.0,515.0
0.005,6,10,1689,5,839,1.0,571.0,571.0,5,850,1.0,582.0,582.0
15.072,17,15,9238,8,6902,2149.0,1350.0,834.0,7,2336,2507.0,1350.0,305.0
0.018,6,10,1762,5,911,4.0,643.0,643.0,5,851,4.0,583.0,583.0
0.004,6,10,2006,5,927,1.0,659.0,659.0,5,1079,1.0,811.0,811.0
0.005,6,10,2007,5,928,1.0,660.0,660.0,5,1079,1.0,811.0,811.0
40.075,17,10,676,5,460,10013.0,104.0,64.0,5,216,10017.0,20.0,15.0
0.006,6,10,1689,5,839,1.0,571.0,571.0,5,850,1.0,582.0,582.0
0.005,6,10,1643,5,860,1.0,592.0,592.0,5,783,1.0,515.0,515.0
40.072,17,10,676,5,460,10015.0,104.0,64.0,5,216,10017.0,20.0,15.0
0.222,6,16,2778,8,1396,31.0,533.0,324.0,8,1382,20.0,529.0,239.0
40.063,17,10,676,5,460,10012.0,104.0,64.0,5,216,10015.0,20.0,15.0
290.242,6,19,2879,10,1527,32249.0,533.0,249.0,9,1352,36275.0,529.0,175.0
0.01,6,10,1989,5,910,2.0,642.0,642.0,5,1079,2.0,811.0,811.0
0.013,6,10,1989,5,910,3.0,642.0,642.0,5,1079,3.0,811.0,811.0
0.001,17,2,180,1,65,0.0,37.0,37.0,1,115,0.0,87.0,87.0
0.004,17,2,136,1,60,0.0,32.0,32.0,1,76,0.0,48.0,48.0
0.005,6,10,2006,5,927,1.0,659.0,659.0,5,1079,1.0,811.0,811.0
0.076,6,10,1506,5,395,17.0,127.0,127.0,5,1111,17.0,843.0,843.0
0.04,17,2,148,1,60,0.0,32.0,32.0,1,88,0.0,60.0,60.0
15.223,17,40,21616,22,18413,723.0,1350.0,808.0,18,3203,893.0,1350.0,149.0
0.005,6,13,3690,7,452,0.0,80.0,80.0,6,3238,0.0,1470.0,1459.0
40.056,17,10,676,5,460,10013.0,104.0,64.0,5,216,10013.0,20.0,15.0
0.014,6,10,1972,5,910,3.0,642.0,642.0,5,1062,3.0,794.0,794.0
0.005,6,10,2006,5,927,1.0,659.0,659.0,5,1079,1.0,811.0,811.0
0.018,6,10,1990,5,911,4.0,643.0,643.0,5,1079,4.0,811.0,811.0
0.008,6,10,1989,5,910,2.0,642.0,642.0,5,1079,1.0,811.0,811.0
0.01,6,10,1677,5,827,2.0,559.0,559.0,5,850,2.0,582.0,582.0
0.005,6,10,2006,5,927,1.0,659.0,659.0,5,1079,1.0,811.0,811.0
0.005,6,10,1689,5,839,1.0,571.0,571.0,5,850,1.0,582.0,582.0
0.006,6,10,1547,5,764,1.0,496.0,496.0,5,783,1.0,515.0,515.0
0.099,6,10,1506,5,395,24.0,127.0,127.0,5,1111,20.0,843.0,843.0
0.108,6,10,1506,5,395,26.0,127.0,127.0,5,1111,25.0,843.0,843.0
0.012,6,10,1990,5,911,2.0,643.0,643.0,5,1079,3.0,811.0,811.0
0.084,6,10,1506,5,395,16.0,127.0,127.0,5,1111,20.0,843.0,843.0
0.005,6,10,1547,5,764,1.0,496.0,496.0,5,783,1.0,515.0,515.0
0.145,6,10,1506,5,395,34.0,127.0,127.0,5,1111,25.0,843.0,843.0
0.003,17,2,148,1,60,0.0,32.0,32.0,1,88,0.0,60.0,60.0
241.048,6,26,9163,13,2696,20087.0,990.0,503.0,13,6467,20087.0,1592.0,722.0
0.007,6,10,1990,5,911,1.0,643.0,643.0,5,1079,1.0,811.0,811.0
0.006,6,10,2006,5,927,1.0,659.0,659.0,5,1079,1.0,811.0,811.0
0.006,6,10,1547,5,764,1.0,496.0,496.0,5,783,1.0,515.0,515.0
0.005,17,2,230,1,68,0.0,40.0,40.0,1,162,0.0,134.0,134.0
0.126,6,10,1506,5,395,28.0,127.0,127.0,5,1111,29.0,843.0,843.0
0.115,6,10,1506,5,395,27.0,127.0,127.0,5,1111,22.0,843.0,843.0
241.751,6,399,349013,196,21721,1239.0,2736.0,960.0,203,327292,1196.0,2804.0,1641.0
0.003,17,4,284,2,120,0.0,32.0,32.0,2,164,0.0,60.0,54.0
0.29,17,44,26654,25,23387,12.0,1350.0,907.0,19,3267,12.0,1350.0,143.0
0.004,6,10,1989,5,927,1.0,659.0,659.0,5,1062,1.0,794.0,794.0
0.161,6,10,1242,5,751,40.0,495.0,495.0,5,491,38.0,223.0,223.0
0.03,6,10,1990,5,911,7.0,643.0,643.0,5,1079,7.0,811.0,811.0
0.006,17,2,179,1,71,0.0,43.0,43.0,1,108,0.0,80.0,80.0
0.01,6,10,1990,5,911,2.0,643.0,643.0,5,1079,2.0,811.0,811.0
0.005,6,10,1989,5,927,1.0,659.0,659.0,5,1062,1.0,794.0,794.0
0.116,6,10,1506,5,395,28.0,127.0,127.0,5,1111,26.0,843.0,843.0
0.005,17,2,170,1,65,0.0,37.0,37.0,1,105,0.0,77.0,77.0
0.047,17,4,284,2,120,9.0,32.0,32.0,2,164,43.0,60.0,54.0
0.111,6,10,1506,5,395,25.0,127.0,127.0,5,1111,24.0,843.0,843.0
0.01,6,10,1983,5,910,2.0,642.0,642.0,5,1073,2.0,805.0,805.0
0.019,6,10,1972,5,910,4.0,642.0,642.0,5,1062,4.0,794.0,794.0
0.011,6,10,1990,5,911,2.0,643.0,643.0,5,1079,2.0,811.0,811.0
0.005,6,10,2006,5,927,1.0,659.0,659.0,5,1079,1.0,811.0,811.0
11.389,17,28,4399,14,2312,863.0,587.0,137.0,14,2087,863.0,270.0,121.0
0.006,6,10,1689,5,839,1.0,571.0,571.0,5,850,1.0,582.0,582.0
0.005,6,10,2006,5,927,1.0,659.0,659.0,5,1079,1.0,811.0,811.0
0.128,17,2,80,1,32,0.0,4.0,4.0,1,48,0.0,20.0,20.0
0.004,17,4,284,2,120,1.0,32.0,32.0,2,164,0.0,60.0,54.0
0.013,6,10,1989,5,910,3.0,642.0,642.0,5,1079,3.0,811.0,811.0
0.004,6,10,1702,5,863,1.0,595.0,595.0,5,839,1.0,571.0,571.0
0.005,6,10,1989,5,927,1.0,659.0,659.0,5,1062,1.0,794.0,794.0
0.005,6,10,2006,5,927,1.0,659.0,659.0,5,1079,1.0,811.0,811.0
0.005,6,10,1689,5,839,1.0,571.0,571.0,5,850,1.0,582.0,582.0
0.005,6,10,2006,5,927,1.0,659.0,659.0,5,1079,1.0,811.0,811.0
0.009,17,2,162,1,65,0.0,37.0,37.0,1,97,0.0,69.0,69.0
0.003,17,4,284,2,120,0.0,32.0,32.0,2,164,0.0,60.0,54.0
11.501,17,28,4390,14,2312,872.0,587.0,137.0,14,2078,872.0,269.0,120.0
0.044,17,2,152,1,76,0.0,48.0,48.0,1,76,0.0,48.0,48.0
0.004,6,10,1702,5,863,1.0,595.0,595.0,5,839,1.0,571.0,571.0
240.018,6,9,787,5,488,60004.0,232.0,232.0,4,299,80004.0,83.0,83.0
40.064,17,10,676,5,460,10012.0,104.0,64.0,5,216,10015.0,20.0,15.0
0.086,6,10,1506,5,395,20.0,127.0,127.0,5,1111,20.0,843.0,843.0
0.005,17,2,194,1,59,0.0,31.0,31.0,1,135,0.0,107.0,107.0
0.099,6,10,1506,5,395,22.0,127.0,127.0,5,1111,21.0,843.0,843.0
0.004,6,10,2000,5,927,1.0,659.0,659.0,5,1073,1.0,805.0,805.0
0.006,6,10,1547,5,764,1.0,496.0,496.0,5,783,1.0,515.0,515.0
0.005,6,10,2006,5,927,1.0,659.0,659.0,5,1079,1.0,811.0,811.0
0.092,6,10,1506,5,395,20.0,127.0,127.0,5,1111,20.0,843.0,843.0
0.109,6,10,1506,5,395,24.0,127.0,127.0,5,1111,22.0,843.0,843.0
0.005,6,10,1689,5,839,1.0,571.0,571.0,5,850,1.0,582.0,582.0
0.088,6,10,1506,5,395,19.0,127.0,127.0,5,1111,21.0,843.0,843.0
0.012,6,10,1972,5,910,3.0,642.0,642.0,5,1062,2.0,794.0,794.0
0.005,6,10,1989,5,927,1.0,659.0,659.0,5,1062,1.0,794.0,794.0
0.005,17,2,170,1,65,0.0,37.0,37.0,1,105,0.0,77.0,77.0
0.004,6,10,2007,5,928,1.0,660.0,660.0,5,1079,1.0,811.0,811.0
0.012,6,10,2006,5,927,3.0,659.0,659.0,5,1079,2.0,811.0,811.0
0.006,17,2,179,1,71,0.0,43.0,43.0,1,108,0.0,80.0,80.0
0.006,17,2,180,1,66,0.0,38.0,38.0,1,114,0.0,86.0,86.0
0.003,17,2,148,1,60,0.0,32.0,32.0,1,88,0.0,60.0,60.0
0.001,17,2,140,1,62,0.0,34.0,34.0,1,78,0.0,50.0,50.0
0.015,17,2,198,1,91,0.0,63.0,63.0,1,107,0.0,79.0,79.0
0.004,6,10,2007,5,928,1.0,660.0,660.0,5,1079,1.0,811.0,811.0
0.003,17,4,284,2,120,0.0,32.0,32.0,2,164,0.0,60.0,54.0
0.122,17,2,80,1,32,0.0,4.0,4.0,1,48,0.0,20.0,20.0
300.334,6,16,2170,9,684,37520.0,146.0,146.0,7,1486,50026.0,419.0,398.0
0.005,6,10,1854,5,889,1.0,621.0,621.0,5,965,1.0,697.0,697.0
314.269,17,20,1124,10,716,34905.0,48.0,43.0,10,408,34905.0,20.0,12.0
40.059,17,10,676,5,460,10011.0,104.0,64.0,5,216,10013.0,20.0,15.0
40.058,17,10,676,5,460,10013.0,104.0,64.0,5,216,10013.0,20.0,15.0
0.219,6,16,2777,8,1395,31.0,533.0,323.0,8,1382,20.0,529.0,239.0
0.008,6,10,1989,5,910,2.0,642.0,642.0,5,1079,1.0,811.0,811.0
723.12,17,142,20828,71,4779,10330.0,44.0,39.0,71,16049,10330.0,261.0,198.0
0.089,6,10,1506,5,395,21.0,127.0,127.0,5,1111,17.0,843.0,843.0
15.082,17,15,8103,8,5996,2150.0,1350.0,721.0,7,2107,2508.0,1350.0,273.0
0.172,6,3,453,2,321,172.0,241.0,241.0,1,132,0.0,92.0,92.0
0.011,6,10,1983,5,910,2.0,642.0,642.0,5,1073,2.0,805.0,805.0
0.001,17,2,136,1,60,0.0,32.0,32.0,1,76,0.0,48.0,48.0
0.004,6,10,2000,5,927,1.0,659.0,659.0,5,1073,1.0,805.0,805.0
0.15,6,10,1506,5,395,36.0,127.0,127.0,5,1111,34.0,843.0,843.0
0.102,6,10,1506,5,395,23.0,127.0,127.0,5,1111,18.0,843.0,843.0
0.006,6,10,1547,5,764,1.0,496.0,496.0,5,783,1.0,515.0,515.0
0.007,6,10,1779,5,928,1.0,660.0,660.0,5,851,1.0,583.0,583.0
310.059,17,20,1124,10,716,34437.0,48.0,43.0,10,408,34437.0,20.0,12.0
0.01,6,10,1983,5,910,2.0,642.0,642.0,5,1073,2.0,805.0,805.0
0.155,6,10,1506,5,395,29.0,127.0,127.0,5,1111,33.0,843.0,843.0
0.027,6,10,1990,5,911,6.0,643.0,643.0,5,1079,6.0,811.0,811.0
0.656,17,20,10036,9,7383,82.0,1350.0,792.0,11,2653,56.0,1350.0,213.0
0.005,17,2,169,1,62,0.0,34.0,34.0,1,107,0.0,79.0,79.0
0.093,6,10,1506,5,395,20.0,127.0,127.0,5,1111,21.0,843.0,843.0
0.132,6,10,1506,5,395,30.0,127.0,127.0,5,1111,27.0,843.0,843.0
0.086,6,10,1506,5,395,19.0,127.0,127.0,5,1111,18.0,843.0,843.0
0.005,6,10,2000,5,927,1.0,659.0,659.0,5,1073,1.0,805.0,805.0
0.005,6,10,2006,5,927,1.0,659.0,659.0,5,1079,1.0,811.0,811.0
0.015,6,13,3735,7,497,2.0,125.0,125.0,6,3238,2.0,1470.0,1459.0
0.005,17,4,284,2,120,0.0,32.0,32.0,2,164,0.0,60.0,54.0
0.013,17,2,152,1,56,0.0,28.0,28.0,1,96,0.0,68.0,68.0
0.039,17,2,152,1,76,0.0,48.0,48.0,1,76,0.0,48.0,48.0
0.096,6,10,1506,5,395,20.0,127.0,127.0,5,1111,21.0,843.0,843.0
0.005,17,2,179,1,71,0.0,43.0,43.0,1,108,0.0,80.0,80.0
0.005,17,2,225,1,65,0.0,37.0,37.0,1,160,0.0,132.0,132.0
0.005,6,10,1989,5,927,1.0,659.0,659.0,5,1062,1.0,794.0,794.0
0.014,17,2,152,1,56,0.0,28.0,28.0,1,96,0.0,68.0,68.0
0.005,6,10,2000,5,927,1.0,659.0,659.0,5,1073,1.0,805.0,805.0
295.53,6,407,348930,198,21860,1500.0,2736.0,888.0,209,327070,1420.0,2804.0,1621.0
0.08,6,10,1506,5,395,17.0,127.0,127.0,5,1111,16.0,843.0,843.0
0.003,17,2,136,1,60,0.0,32.0,32.0,1,76,0.0,48.0,48.0
0.006,17,2,230,1,68,0.0,40.0,40.0,1,162,0.0,134.0,134.0
141.136,6,24,9399,11,1575,76.0,794.0,367.0,13,7824,11750.0,1360.0,810.0
0.001,17,2,136,1,60,0.0,32.0,32.0,1,76,0.0,48.0,48.0
0.005,6,10,2007,5,928,1.0,660.0,660.0,5,1079,1.0,811.0,811.0
0.009,6,10,1972,5,910,2.0,642.0,642.0,5,1062,2.0,794.0,794.0
0.009,6,12,1926,6,1189,1.0,659.0,434.0,6,737,1.0,417.0,417.0
0.005,6,10,1774,5,923,1.0,655.0,655.0,5,851,1.0,583.0,583.0
40.064,17,10,676,5,460,10013.0,104.0,64.0,5,216,10015.0,20.0,15.0
0.005,6,10,2007,5,928,1.0,660.0,660.0,5,1079,1.0,811.0,811.0
0.105,6,10,1506,5,395,23.0,127.0,127.0,5,1111,22.0,843.0,843.0
0.01,6,13,3735,7,497,1.0,125.0,125.0,6,3238,1.0,1470.0,1459.0
0.04,17,2,152,1,76,0.0,48.0,48.0,1,76,0.0,48.0,48.0
0.009,6,10,1983,5,910,2.0,642.0,642.0,5,1073,2.0,805.0,805.0
0.004,6,10,2007,5,928,1.0,660.0,660.0,5,1079,1.0,811.0,811.0
0.005,6,10,1989,5,927,1.0,659.0,659.0,5,1062,1.0,794.0,794.0
0.013,6,10,1631,5,848,3.0,580.0,580.0,5,783,3.0,515.0,515.0
0.004,6,10,2006,5,927,1.0,659.0,659.0,5,1079,1.0,811.0,811.0
1.024,6,12,3142,6,2099,154.0,1328.0,923.0,6,1043,154.0,791.0,791.0
0.004,6,10,2006,5,927,1.0,659.0,659.0,5,1079,1.0,811.0,811.0
0.005,17,2,164,1,74,0.0,46.0,46.0,1,90,0.0,62.0,62.0
1680.063,6,80,4210,40,2106,43077.0,26.0,26.0,40,2104,43077.0,24.0,24.0
0.016,6,10,1989,5,910,4.0,642.0,642.0,5,1079,4.0,811.0,811.0
0.001,17,2,180,1,66,0.0,38.0,38.0,1,114,0.0,86.0,86.0
0.016,6,10,1989,5,910,4.0,642.0,642.0,5,1079,3.0,811.0,811.0
0.001,17,2,180,1,66,0.0,38.0,38.0,1,114,0.0,86.0,86.0
0.005,6,10,1643,5,860,1.0,592.0,592.0,5,783,1.0,515.0,515.0
0.005,6,10,2007,5,928,1.0,660.0,660.0,5,1079,1.0,811.0,811.0
0.008,6,10,1989,5,910,1.0,642.0,642.0,5,1079,2.0,811.0,811.0
0.003,17,2,136,1,60,0.0,32.0,32.0,1,76,0.0,48.0,48.0
40.089,17,10,676,5,460,10016.0,104.0,64.0,5,216,10021.0,20.0,15.0
0.014,6,13,3735,7,497,2.0,125.0,125.0,6,3238,2.0,1470.0,1459.0
0.01,6,10,2006,5,927,2.0,659.0,659.0,5,1079,2.0,811.0,811.0
0.005,17,2,214,1,75,0.0,47.0,47.0,1,139,0.0,111.0,111.0
0.098,6,10,1506,5,395,21.0,127.0,127.0,5,1111,22.0,843.0,843.0
40.059,17,10,676,5,460,10013.0,104.0,64.0,5,216,10013.0,20.0,15.0
0.006,6,10,1547,5,764,1.0,496.0,496.0,5,783,1.0,515.0,515.0
0.005,6,10,2007,5,928,1.0,660.0,660.0,5,1079,1.0,811.0,811.0
0.005,6,10,2006,5,927,1.0,659.0,659.0,5,1079,1.0,811.0,811.0
0.015,6,20,9974,11,704,1.0,124.0,124.0,9,9270,1.0,2896.0,1758.0
0.005,6,10,1989,5,927,1.0,659.0,659.0,5,1062,1.0,794.0,794.0
15.074,17,15,9238,8,6902,2149.0,1350.0,834.0,7,2336,2506.0,1350.0,305.0
353.705,6,20,2210,6,1308,12004.0,494.0,494.0,14,902,27207.0,83.0,83.0
0.004,6,10,1702,5,863,1.0,595.0,595.0,5,839,1.0,571.0,571.0
0.004,17,2,193,1,71,0.0,43.0,43.0,1,122,0.0,94.0,94.0
0.003,17,2,187,1,74,0.0,46.0,46.0,1,113,0.0,85.0,85.0
10.711,17,26,4102,13,1846,883.0,269.0,114.0,13,2256,883.0,587.0,145.0
0.009,6,10,1989,5,910,2.0,642.0,642.0,5,1079,2.0,811.0,811.0
0.008,6,10,1989,5,910,2.0,642.0,642.0,5,1079,2.0,811.0,811.0
0.009,6,10,1990,5,911,2.0,643.0,643.0,5,1079,2.0,811.0,811.0
0.02,6,10,1990,5,911,4.0,643.0,643.0,5,1079,5.0,811.0,811.0
1792.533,6,489,99372,245,88022,7346.0,421.0,365.0,244,11350,7376.0,53.0,53.0
0.005,6,10,1643,5,860,1.0,592.0,592.0,5,783,1.0,515.0,515.0
0.005,6,10,1779,5,928,1.0,660.0,660.0,5,851,1.0,583.0,583.0
0.011,6,13,3735,7,497,1.0,125.0,125.0,6,3238,2.0,1470.0,1459.0
0.017,6,10,1972,5,910,4.0,642.0,642.0,5,1062,4.0,794.0,794.0
1.018,6,13,3930,7,2139,127.0,1328.0,923.0,6,1791,153.0,1539.0,1539.0
0.005,6,10,2006,5,927,1.0,659.0,659.0,5,1079,1.0,811.0,811.0
15.168,17,20,11085,10,7522,1682.0,1350.0,724.0,10,3563,1682.0,1350.0,328.0
0.005,6,10,2007,5,928,1.0,660.0,660.0,5,1079,1.0,811.0,811.0
0.012,6,10,1989,5,910,3.0,642.0,642.0,5,1079,3.0,811.0,811.0
0.007,6,10,2006,5,927,1.0,659.0,659.0,5,1079,1.0,811.0,811.0
0.04,17,2,170,1,65,0.0,37.0,37.0,1,105,0.0,77.0,77.0
0.004,17,2,148,1,60,0.0,32.0,32.0,1,88,0.0,60.0,60.0
0.006,17,2,214,1,75,0.0,47.0,47.0,1,139,0.0,111.0,111.0
0.118,6,10,1506,5,395,29.0,127.0,127.0,5,1111,24.0,843.0,843.0
367.164,6,22,2313,16,867,24477.0,195.0,195.0,6,1446,4636.0,419.0,398.0
0.001,17,2,136,1,60,0.0,32.0,32.0,1,76,0.0,48.0,48.0
0.005,6,10,2000,5,927,1.0,659.0,659.0,5,1073,1.0,805.0,805.0
0.017,6,10,1983,5,910,4.0,642.0,642.0,5,1073,4.0,805.0,805.0
0.015,6,10,1990,5,911,3.0,643.0,643.0,5,1079,3.0,811.0,811.0
0.056,17,2,136,1,60,0.0,32.0,32.0,1,76,0.0,48.0,48.0
0.001,17,2,136,1,60,0.0,32.0,32.0,1,76,0.0,48.0,48.0
40.054,17,10,676,5,460,10012.0,104.0,64.0,5,216,10012.0,20.0,15.0
0.014,6,10,1677,5,827,3.0,559.0,559.0,5,850,3.0,582.0,582.0
0.173,17,2,152,1,76,0.0,48.0,48.0,1,76,0.0,48.0,48.0
0.005,6,10,1774,5,923,1.0,655.0,655.0,5,851,1.0,583.0,583.0
0.013,6,10,1972,5,910,3.0,642.0,642.0,5,1062,3.0,794.0,794.0
0.187,17,4,596,2,122,146.0,33.0,33.0,2,474,147.0,323.0,209.0
0.014,6,10,1762,5,911,3.0,643.0,643.0,5,851,3.0,583.0,583.0
0.007,6,10,1547,5,764,1.0,496.0,496.0,5,783,1.0,515.0,515.0
0.018,6,13,3735,7,497,3.0,125.0,125.0,6,3238,3.0,1470.0,1459.0
15.27,17,17,8330,9,6130,1905.0,1350.0,653.0,8,2200,2177.0,1350.0,247.0
0.005,6,10,2000,5,927,1.0,659.0,659.0,5,1073,1.0,805.0,805.0
0.099,6,10,1506,5,395,20.0,127.0,127.0,5,1111,24.0,843.0,843.0
0.021,6,10,1983,5,910,5.0,642.0,642.0,5,1073,5.0,805.0,805.0
0.009,17,4,284,2,120,5.0,32.0,32.0,2,164,5.0,60.0,54.0
0.011,6,10,1972,5,910,2.0,642.0,642.0,5,1062,2.0,794.0,794.0
332.77,17,20,1124,10,716,36960.0,48.0,43.0,10,408,36960.0,20.0,12.0
300.307,6,19,3084,11,1647,30030.0,517.0,266.0,8,1437,34328.0,824.0,337.0
40.062,17,10,676,5,460,10013.0,104.0,64.0,5,216,10014.0,20.0,15.0
0.009,6,10,1990,5,911,2.0,643.0,643.0,5,1079,2.0,811.0,811.0
0.004,17,2,136,1,60,0.0,32.0,32.0,1,76,0.0,48.0,48.0
0.256,17,39,20201,20,16977,13.0,1350.0,820.0,19,3224,12.0,1350.0,141.0
0.006,6,10,1774,5,923,1.0,655.0,655.0,5,851,1.0,583.0,583.0
40.032,17,10,676,5,460,10006.0,104.0,64.0,5,216,10007.0,20.0,15.0
0.009,6,10,1989,5,910,2.0,642.0,642.0,5,1079,2.0,811.0,811.0
0.004,6,10,2006,5,927,1.0,659.0,659.0,5,1079,1.0,811.0,811.0
10.89,17,28,4422,14,1993,829.0,268.0,114.0,14,2429,829.0,588.0,145.0
1792.424,6,497,100113,253,88763,7112.0,421.0,365.0,244,11350,7375.0,53.0,53.0
0.005,6,10,2000,5,927,1.0,659.0,659.0,5,1073,1.0,805.0,805.0
0.101,6,10,1506,5,395,22.0,127.0,127.0,5,1111,22.0,843.0,843.0
0.089,6,10,1506,5,395,19.0,127.0,127.0,5,1111,19.0,843.0,843.0
0.071,6,10,1506,5,395,15.0,127.0,127.0,5,1111,16.0,843.0,843.0
0.011,6,10,1990,5,911,2.0,643.0,643.0,5,1079,2.0,811.0,811.0
0.02,6,10,1989,5,910,5.0,642.0,642.0,5,1079,4.0,811.0,811.0
300.241,6,16,2170,9,684,37507.0,146.0,146.0,7,1486,50011.0,419.0,398.0
10.711,17,28,4423,14,1994,815.0,269.0,114.0,14,2429,815.0,588.0,145.0
131.299,6,48,13730,25,10468,5470.0,1515.0,610.0,23,3262,5968.0,580.0,171.0
0.012,6,10,1972,5,910,2.0,642.0,642.0,5,1062,2.0,794.0,794.0
0.011,6,10,1972,5,910,2.0,642.0,642.0,5,1062,2.0,794.0,794.0
0.11,6,10,1506,5,395,24.0,127.0,127.0,5,1111,23.0,843.0,843.0
0.006,6,10,1643,5,860,1.0,592.0,592.0,5,783,1.0,515.0,515.0
0.108,6,10,1506,5,395,23.0,127.0,127.0,5,1111,22.0,843.0,843.0
0.005,6,14,3736,7,446,0.0,74.0,74.0,7,3290,0.0,1448.0,972.0
368.555,6,22,2313,16,867,24570.0,195.0,195.0,6,1446,4641.0,419.0,398.0
0.005,17,2,144,1,64,0.0,36.0,36.0,1,80,0.0,52.0,52.0
0.015,6,10,1983,5,910,3.0,642.0,642.0,5,1073,3.0,805.0,805.0
0.005,6,10,1689,5,839,1.0,571.0,571.0,5,850,1.0,582.0,582.0
0.082,6,10,1506,5,395,18.0,127.0,127.0,5,1111,15.0,843.0,843.0
0.039,17,2,144,1,64,0.0,36.0,36.0,1,80,0.0,52.0,52.0
40.068,17,10,676,5,460,10016.0,104.0,64.0,5,216,10016.0,20.0,15.0
40.058,17,10,676,5,460,10013.0,104.0,64.0,5,216,10013.0,20.0,15.0
0.009,6,12,1926,6,1189,1.0,659.0,434.0,6,737,1.0,417.0,417.0
0.005,6,10,2000,5,927,1.0,659.0,659.0,5,1073,1.0,805.0,805.0
10.803,17,28,4421,14,1993,822.0,268.0,114.0,14,2428,822.0,587.0,145.0
0.013,6,10,1983,5,910,3.0,642.0,642.0,5,1073,3.0,805.0,805.0
0.005,6,10,2000,5,927,1.0,659.0,659.0,5,1073,1.0,805.0,805.0
0.09,6,10,1506,5,395,20.0,127.0,127.0,5,1111,20.0,843.0,843.0
0.013,6,10,1989,5,910,3.0,642.0,642.0,5,1079,3.0,811.0,811.0
0.009,6,13,3735,7,497,1.0,125.0,125.0,6,3238,1.0,1470.0,1459.0
0.005,6,10,1989,5,927,1.0,659.0,659.0,5,1062,1.0,794.0,794.0
352.668,6,20,2210,6,1308,12003.0,494.0,494.0,14,902,27128.0,83.0,83.0
0.079,6,10,1506,5,395,16.0,127.0,127.0,5,1111,18.0,843.0,843.0
0.013,6,10,1989,5,910,3.0,642.0,642.0,5,1079,3.0,811.0,811.0
1792.758,6,241,46399,117,33996,15454.0,2475.0,962.0,124,12403,14575.0,580.0,61.0
0.015,17,2,198,1,91,0.0,63.0,63.0,1,107,0.0,79.0,79.0
0.006,6,10,1643,5,860,1.0,592.0,592.0,5,783,1.0,515.0,515.0
0.013,6,10,1990,5,911,3.0,643.0,643.0,5,1079,3.0,811.0,811.0
1773.364,17,120,11460,60,5460,30056.0,63.0,63.0,60,6000,30056.0,72.0,72.0
0.004,6,10,1702,5,863,1.0,595.0,595.0,5,839,1.0,571.0,571.0
0.009,6,14,3787,7,497,1.0,125.0,125.0,7,3290,1.0,1448.0,972.0
0.009,6,10,1631,5,848,2.0,580.0,580.0,5,783,2.0,515.0,515.0
0.006,6,10,1643,5,860,1.0,592.0,592.0,5,783,1.0,515.0,515.0
0.01,6,10,1990,5,911,2.0,643.0,643.0,5,1079,2.0,811.0,811.0
0.076,6,10,1506,5,395,16.0,127.0,127.0,5,1111,18.0,843.0,843.0
0.014,6,10,1983,5,910,3.0,642.0,642.0,5,1073,3.0,805.0,805.0
1771.33,6,313,98968,192,87345,9273.0,1402.0,672.0,121,11623,14761.0,452.0,70.0
0.004,6,10,1989,5,927,1.0,659.0,659.0,5,1062,1.0,794.0,794.0
0.006,6,10,2007,5,928,1.0,660.0,660.0,5,1079,1.0,811.0,811.0
0.018,6,10,1677,5,827,4.0,559.0,559.0,5,850,4.0,582.0,582.0
0.008,6,10,1983,5,910,2.0,642.0,642.0,5,1073,2.0,805.0,805.0
0.005,6,10,1547,5,764,1.0,496.0,496.0,5,783,1.0,515.0,515.0
0.006,6,10,1547,5,764,1.0,496.0,496.0,5,783,1.0,515.0,515.0
0.114,6,10,1506,5,395,19.0,127.0,127.0,5,1111,27.0,843.0,843.0
0.004,17,2,136,1,60,0.0,32.0,32.0,1,76,0.0,48.0,48.0
0.004,17,2,142,1,63,0.0,35.0,35.0,1,79,0.0,51.0,51.0
0.014,6,10,1631,5,848,3.0,580.0,580.0,5,783,3.0,515.0,515.0
11.468,17,28,4394,14,1994,869.0,269.0,114.0,14,2400,869.0,587.0,143.0
0.005,17,2,144,1,64,0.0,36.0,36.0,1,80,0.0,52.0,52.0
0.005,6,10,2006,5,927,1.0,659.0,659.0,5,1079,1.0,811.0,811.0
0.001,17,2,180,1,66,0.0,38.0,38.0,1,114,0.0,86.0,86.0
0.003,17,2,148,1,60,0.0,32.0,32.0,1,88,0.0,60.0,60.0
0.095,6,10,1506,5,395,20.0,127.0,127.0,5,1111,23.0,843.0,843.0
0.006,6,10,1547,5,764,1.0,496.0,496.0,5,783,1.0,515.0,515.0
0.006,6,10,1854,5,889,1.0,621.0,621.0,5,965,1.0,697.0,697.0
0.169,17,2,152,1,76,0.0,48.0,48.0,1,76,0.0,48.0,48.0
0.006,6,10,2006,5,927,1.0,659.0,659.0,5,1079,1.0,811.0,811.0
66.324,6,22,8550,12,2328,6029.0,1002.0,424.0,10,6222,7351.0,2241.0,949.0
40.066,17,10,676,5,460,10011.0,104.0,64.0,5,216,10009.0,20.0,15.0
1769.916,6,85,4496,42,2211,43167.0,27.0,27.0,43,2285,42139.0,26.0,24.0
11.163,17,28,4420,14,1993,846.0,268.0,114.0,14,2427,846.0,586.0,145.0
0.086,6,10,1506,5,395,19.0,127.0,127.0,5,1111,18.0,843.0,843.0
0.006,6,10,1547,5,764,1.0,496.0,496.0,5,783,1.0,515.0,515.0
0.004,6,10,1702,5,863,1.0,595.0,595.0,5,839,1.0,571.0,571.0
0.098,6,10,1506,5,395,22.0,127.0,127.0,5,1111,21.0,843.0,843.0
0.088,6,10,1506,5,395,21.0,127.0,127.0,5,1111,17.0,843.0,843.0
0.015,6,14,3787,7,497,2.0,125.0,125.0,7,3290,2.0,1448.0,972.0
0.01,6,13,3735,7,497,1.0,125.0,125.0,6,3238,1.0,1470.0,1459.0
0.014,6,10,1989,5,910,3.0,642.0,642.0,5,1079,3.0,811.0,811.0
0.005,6,10,2007,5,928,1.0,660.0,660.0,5,1079,1.0,811.0,811.0
0.111,6,10,1506,5,395,26.0,127.0,127.0,5,1111,27.0,843.0,843.0
354.036,6,21,1795,16,1030,23602.0,190.0,190.0,5,765,60002.0,464.0,248.0
0.005,6,10,1989,5,927,1.0,659.0,659.0,5,1062,1.0,794.0,794.0
0.008,17,2,160,1,72,0.0,44.0,44.0,1,88,0.0,60.0,60.0
0.012,6,10,1677,5,827,2.0,559.0,559.0,5,850,3.0,582.0,582.0
240.469,6,37,14529,17,7457,15029.0,1733.0,1092.0,20,7072,12656.0,1656.0,602.0
0.008,17,2,299,1,65,0.0,37.0,37.0,1,234,0.0,206.0,206.0
0.005,6,10,1689,5,839,1.0,571.0,571.0,5,850,1.0,582.0,582.0
0.005,17,2,164,1,74,0.0,46.0,46.0,1,90,0.0,62.0,62.0
0.053,17,2,144,1,64,0.0,36.0,36.0,1,80,0.0,52.0,52.0
0.02,6,10,1989,5,910,5.0,642.0,642.0,5,1079,4.0,811.0,811.0
0.093,6,10,1506,5,395,21.0,127.0,127.0,5,1111,19.0,843.0,843.0
0.004,6,10,2000,5,927,1.0,659.0,659.0,5,1073,1.0,805.0,805.0
0.005,6,10,2000,5,927,1.0,659.0,659.0,5,1073,1.0,805.0,805.0
0.005,17,2,222,1,65,0.0,37.0,37.0,1,157,0.0,129.0,129.0
0.005,6,10,1774,5,923,1.0,655.0,655.0,5,851,1.0,583.0,583.0
65.696,6,27,18412,15,10466,4692.0,2804.0,1613.0,12,7946,5957.0,2317.0,1219.0
0.01,6,6,716,3,458,4.0,302.0,302.0,3,258,4.0,102.0,102.0
0.084,6,10,1506,5,395,18.0,127.0,127.0,5,1111,16.0,843.0,843.0
240.089,6,31,9212,15,6831,17149.0,1955.0,672.0,16,2381,16005.0,580.0,192.0
0.008,6,10,1989,5,910,2.0,642.0,642.0,5,1079,2.0,811.0,811.0
1.514,6,36,6735,19,3451,84.0,1103.0,204.0,17,3284,90.0,1796.0,396.0
10.816,17,28,4419,14,1995,823.0,270.0,114.0,14,2424,823.0,587.0,145.0
0.085,6,10,1506,5,395,20.0,127.0,127.0,5,1111,17.0,843.0,843.0
0.167,17,2,152,1,76,0.0,48.0,48.0,1,76,0.0,48.0,48.0
0.179,6,10,1506,5,395,25.0,127.0,127.0,5,1111,43.0,843.0,843.0
0.005,17,2,140,1,62,0.0,34.0,34.0,1,78,0.0,50.0,50.0
0.005,6,10,1689,5,839,1.0,571.0,571.0,5,850,1.0,582.0,582.0
0.01,6,10,1989,5,910,2.0,642.0,642.0,5,1079,2.0,811.0,811.0
0.012,6,10,1989,5,910,3.0,642.0,642.0,5,1079,2.0,811.0,811.0
0.065,6,10,1972,5,910,16.0,642.0,642.0,5,1062,16.0,794.0,794.0
10.74,17,26,4101,13,1846,886.0,269.0,114.0,13,2255,886.0,586.0,145.0
0.004,6,10,1774,5,923,1.0,655.0,655.0,5,851,1.0,583.0,583.0
0.005,6,10,1989,5,927,1.0,659.0,659.0,5,1062,1.0,794.0,794.0
40.081,17,10,676,5,460,10019.0,104.0,64.0,5,216,10017.0,20.0,15.0
240.025,6,9,787,5,488,60006.0,232.0,232.0,4,299,80007.0,83.0,83.0
0.005,6,10,2006,5,927,1.0,659.0,659.0,5,1079,1.0,811.0,811.0
0.009,6,10,1989,5,910,2.0,642.0,642.0,5,1079,2.0,811.0,811.0
0.004,6,10,2006,5,927,1.0,659.0,659.0,5,1079,1.0,811.0,811.0
0.001,17,2,180,1,66,0.0,38.0,38.0,1,114,0.0,86.0,86.0
0.072,17,4,284,2,120,1.0,32.0,32.0,2,164,69.0,60.0,54.0
0.005,6,10,1779,5,928,1.0,660.0,660.0,5,851,1.0,583.0,583.0
0.09,6,10,1506,5,395,19.0,127.0,127.0,5,1111,22.0,843.0,843.0
0.009,6,10,1990,5,911,2.0,643.0,643.0,5,1079,2.0,811.0,811.0
0.013,6,10,1989,5,910,3.0,642.0,642.0,5,1079,3.0,811.0,811.0
0.016,6,10,1631,5,848,4.0,580.0,580.0,5,783,4.0,515.0,515.0
0.022,17,2,178,1,81,0.0,53.0,53.0,1,97,0.0,69.0,69.0
0.001,17,2,166,1,75,0.0,47.0,47.0,1,91,0.0,63.0,63.0
0.003,17,4,284,2,120,0.0,32.0,32.0,2,164,0.0,60.0,54.0
0.005,6,10,2006,5,927,1.0,659.0,659.0,5,1079,1.0,811.0,811.0
0.005,6,13,3747,7,509,0.0,137.0,137.0,6,3238,0.0,1470.0,1459.0
0.069,17,8,3613,4,1874,23.0,1350.0,440.0,4,1739,11.0,1350.0,406.0
0.014,6,10,1677,5,827,3.0,559.0,559.0,5,850,3.0,582.0,582.0
0.01,6,10,1605,5,388,2.0,120.0,120.0,5,1217,2.0,949.0,949.0
0.111,6,10,1506,5,395,24.0,127.0,127.0,5,1111,25.0,843.0,843.0
0.015,6,10,1989,5,910,3.0,642.0,642.0,5,1079,3.0,811.0,811.0
0.001,17,2,179,1,62,0.0,34.0,34.0,1,117,0.0,89.0,89.0
0.005,17,2,144,1,64,0.0,36.0,36.0,1,80,0.0,52.0,52.0
0.096,6,10,1506,5,395,22.0,127.0,127.0,5,1111,20.0,843.0,843.0
0.004,6,10,2000,5,927,1.0,659.0,659.0,5,1073,1.0,805.0,805.0
0.109,6,10,1506,5,395,24.0,127.0,127.0,5,1111,25.0,843.0,843.0
0.075,6,10,1506,5,395,16.0,127.0,127.0,5,1111,17.0,843.0,843.0
0.046,17,2,148,1,60,0.0,32.0,32.0,1,88,0.0,60.0,60.0
0.005,17,2,213,1,69,0.0,41.0,41.0,1,144,0.0,116.0,116.0
0.01,6,10,1983,5,910,2.0,642.0,642.0,5,1073,2.0,805.0,805.0
0.075,6,10,1506,5,395,16.0,127.0,127.0,5,1111,17.0,843.0,843.0
240.011,6,9,787,5,488,60002.0,232.0,232.0,4,299,80002.0,83.0,83.0
0.014,6,10,1989,5,910,3.0,642.0,642.0,5,1079,3.0,811.0,811.0
0.102,6,10,1506,5,395,22.0,127.0,127.0,5,1111,22.0,843.0,843.0
305.672,17,16,928,8,608,43649.0,48.0,48.0,8,320,43649.0,12.0,12.0
0.01,6,12,1926,6,1189,2.0,659.0,434.0,6,737,1.0,417.0,417.0
174.06,17,76,10856,38,2537,4704.0,44.0,38.0,38,8319,4704.0,239.0,190.0
0.021,6,10,1990,5,911,5.0,643.0,643.0,5,1079,5.0,811.0,811.0
0.005,6,10,1643,5,860,1.0,592.0,592.0,5,783,1.0,515.0,515.0
0.005,6,10,1779,5,928,1.0,660.0,660.0,5,851,1.0,583.0,583.0
0.005,17,2,169,1,62,0.0,34.0,34.0,1,107,0.0,79.0,79.0
42.217,6,40,10527,20,4929,471.0,1360.0,682.0,20,5598,2213.0,2667.0,435.0
0.08,6,10,1506,5,395,16.0,127.0,127.0,5,1111,18.0,843.0,843.0
1779.838,6,238,46250,114,33827,15750.0,2475.0,1033.0,124,12423,14470.0,580.0,62.0
40.076,17,10,676,5,460,10016.0,104.0,64.0,5,216,10018.0,20.0,15.0
0.106,6,10,1506,5,395,24.0,127.0,127.0,5,1111,25.0,843.0,843.0
0.005,17,2,140,1,62,0.0,34.0,34.0,1,78,0.0,50.0,50.0
11.182,17,28,4422,14,1994,847.0,269.0,114.0,14,2428,847.0,587.0,145.0
0.233,6,16,2671,8,1397,33.0,533.0,324.0,8,1274,21.0,529.0,212.0
0.005,6,10,2000,5,927,1.0,659.0,659.0,5,1073,1.0,805.0,805.0
40.055,17,10,676,5,460,10013.0,104.0,64.0,5,216,10013.0,20.0,15.0
0.166,6,10,1506,5,395,36.0,127.0,127.0,5,1111,40.0,843.0,843.0
0.005,6,10,1547,5,764,1.0,496.0,496.0,5,783,1.0,515.0,515.0
354.066,6,21,1795,16,1030,23604.0,190.0,190.0,5,765,60003.0,464.0,248.0
0.004,17,2,170,1,65,0.0,37.0,37.0,1,105,0.0,77.0,77.0
0.008,6,10,1972,5,910,2.0,642.0,642.0,5,1062,2.0,794.0,794.0
300.358,6,16,2170,9,684,37524.0,146.0,146.0,7,1486,50032.0,419.0,398.0
0.015,6,10,1989,5,910,3.0,642.0,642.0,5,1079,3.0,811.0,811.0
0.01,6,10,1972,5,910,2.0,642.0,642.0,5,1062,2.0,794.0,794.0
0.001,17,2,136,1,60,0.0,32.0,32.0,1,76,0.0,48.0,48.0
0.111,6,10,1506,5,395,24.0,127.0,127.0,5,1111,24.0,843.0,843.0
0.108,6,10,1506,5,395,23.0,127.0,127.0,5,1111,20.0,843.0,843.0
0.011,6,10,1990,5,911,2.0,643.0,643.0,5,1079,2.0,811.0,811.0
0.002,17,2,180,1,66,0.0,38.0,38.0,1,114,0.0,86.0,86.0
0.006,6,10,2007,5,928,1.0,660.0,660.0,5,1079,1.0,811.0,811.0
40.055,17,10,676,5,460,10013.0,104.0,64.0,5,216,10011.0,20.0,15.0
0.005,6,10,2006,5,927,1.0,659.0,659.0,5,1079,1.0,811.0,811.0
0.039,17,2,148,1,60,0.0,32.0,32.0,1,88,0.0,60.0,60.0
0.016,6,10,1989,5,910,4.0,642.0,642.0,5,1079,3.0,811.0,811.0
0.022,6,10,1989,5,910,5.0,642.0,642.0,5,1079,5.0,811.0,811.0
0.015,17,2,194,1,59,0.0,31.0,31.0,1,135,0.0,107.0,107.0
0.006,6,10,1643,5,860,1.0,592.0,592.0,5,783,1.0,515.0,515.0
0.01,6,10,1972,5,910,2.0,642.0,642.0,5,1062,2.0,794.0,794.0
0.016,6,10,1989,5,910,3.0,642.0,642.0,5,1079,3.0,811.0,811.0
0.004,6,10,1702,5,863,1.0,595.0,595.0,5,839,1.0,571.0,571.0
0.013,6,10,1972,5,910,3.0,642.0,642.0,5,1062,3.0,794.0,794.0
0.026,6,10,1990,5,911,6.0,643.0,643.0,5,1079,6.0,811.0,811.0
11.162,17,28,4423,14,1994,846.0,269.0,114.0,14,2429,846.0,588.0,145.0
0.016,6,10,1983,5,910,4.0,642.0,642.0,5,1073,3.0,805.0,805.0
0.005,17,4,495,2,132,0.0,38.0,38.0,2,363,2.0,176.0,153.0
0.015,6,10,1972,5,910,3.0,642.0,642.0,5,1062,3.0,794.0,794.0
0.006,6,10,1547,5,764,1.0,496.0,496.0,5,783,1.0,515.0,515.0
0.064,6,10,1506,5,395,14.0,127.0,127.0,5,1111,14.0,843.0,843.0
0.006,17,2,179,1,71,0.0,43.0,43.0,1,108,0.0,80.0,80.0
40.062,17,10,676,5,460,10014.0,104.0,64.0,5,216,10014.0,20.0,15.0
0.114,6,10,1506,5,395,23.0,127.0,127.0,5,1111,25.0,843.0,843.0
0.009,6,10,1779,5,928,2.0,660.0,660.0,5,851,2.0,583.0,583.0
0.125,17,2,170,1,65,0.0,37.0,37.0,1,105,0.0,77.0,77.0
0.009,6,10,1990,5,911,2.0,643.0,643.0,5,1079,2.0,811.0,811.0
0.08,6,10,1506,5,395,18.0,127.0,127.0,5,1111,18.0,843.0,843.0
246.598,6,38,9906,16,6766,16439.0,1837.0,659.0,22,3140,11742.0,580.0,152.0
0.072,6,10,1506,5,395,17.0,127.0,127.0,5,1111,16.0,843.0,843.0
0.11,6,10,1506,5,395,24.0,127.0,127.0,5,1111,22.0,843.0,843.0
0.004,6,10,2007,5,928,1.0,660.0,660.0,5,1079,1.0,811.0,811.0
0.133,6,10,1506,5,395,30.0,127.0,127.0,5,1111,28.0,843.0,843.0
1.067,6,33,13432,18,5893,62.0,2074.0,854.0,15,7539,63.0,2720.0,769.0
0.005,6,10,1779,5,928,1.0,660.0,660.0,5,851,1.0,583.0,583.0
0.011,6,10,1983,5,910,2.0,642.0,642.0,5,1073,2.0,805.0,805.0
0.006,17,2,214,1,75,0.0,47.0,47.0,1,139,0.0,111.0,111.0
0.004,6,10,2007,5,928,1.0,660.0,660.0,5,1079,1.0,811.0,811.0
0.005,6,10,1989,5,927,1.0,659.0,659.0,5,1062,1.0,794.0,794.0
0.006,17,2,225,1,65,0.0,37.0,37.0,1,160,0.0,132.0,132.0
0.005,6,10,2006,5,927,1.0,659.0,659.0,5,1079,1.0,811.0,811.0
0.073,6,10,1506,5,395,17.0,127.0,127.0,5,1111,17.0,843.0,843.0
0.038,17,2,148,1,60,0.0,32.0,32.0,1,88,0.0,60.0,60.0
0.005,17,2,169,1,62,0.0,34.0,34.0,1,107,0.0,79.0,79.0
0.09,6,10,1506,5,395,17.0,127.0,127.0,5,1111,20.0,843.0,843.0
40.064,17,10,676,5,460,10015.0,104.0,64.0,5,216,10015.0,20.0,15.0
0.008,6,10,1990,5,911,2.0,643.0,643.0,5,1079,2.0,811.0,811.0
0.013,6,10,1983,5,910,3.0,642.0,642.0,5,1073,3.0,805.0,805.0
0.005,6,10,1702,5,863,1.0,595.0,595.0,5,839,1.0,571.0,571.0
0.036,6,10,1990,5,911,8.0,643.0,643.0,5,1079,8.0,811.0,811.0
0.104,6,10,1506,5,395,24.0,127.0,127.0,5,1111,25.0,843.0,843.0
0.006,6,10,1547,5,764,1.0,496.0,496.0,5,783,1.0,515.0,515.0
0.015,6,10,1677,5,827,3.0,559.0,559.0,5,850,3.0,582.0,582.0
0.004,6,10,2007,5,928,1.0,660.0,660.0,5,1079,1.0,811.0,811.0
0.001,17,2,179,1,62,0.0,34.0,34.0,1,117,0.0,89.0,89.0
40.065,17,10,676,5,460,10015.0,104.0,64.0,5,216,10015.0,20.0,15.0
0.244,17,40,20231,22,17086,11.0,1350.0,748.0,18,3145,10.0,1350.0,146.0
0.013,6,10,1972,5,910,3.0,642.0,642.0,5,1062,3.0,794.0,794.0
0.008,6,10,1989,5,910,2.0,642.0,642.0,5,1079,1.0,811.0,811.0
0.006,6,10,1643,5,860,1.0,592.0,592.0,5,783,1.0,515.0,515.0
0.001,17,2,180,1,66,0.0,38.0,38.0,1,114,0.0,86.0,86.0
40.057,17,10,676,5,460,10013.0,104.0,64.0,5,216,10013.0,20.0,15.0
0.211,6,16,2778,8,1396,30.0,533.0,324.0,8,1382,19.0,529.0,239.0
40.007,17,10,676,5,460,10000.0,104.0,64.0,5,216,10001.0,20.0,15.0
0.102,6,10,1506,5,395,22.0,127.0,127.0,5,1111,23.0,843.0,843.0
0.003,17,4,284,2,120,0.0,32.0,32.0,2,164,0.0,60.0,54.0
0.005,6,10,2007,5,928,1.0,660.0,660.0,5,1079,1.0,811.0,811.0
0.004,6,10,1702,5,863,1.0,595.0,595.0,5,839,1.0,571.0,571.0
0.019,6,10,1972,5,910,4.0,642.0,642.0,5,1062,4.0,794.0,794.0
0.014,6,10,1972,5,910,3.0,642.0,642.0,5,1062,3.0,794.0,794.0
0.011,6,10,1989,5,910,2.0,642.0,642.0,5,1079,2.0,811.0,811.0
0.081,6,10,1506,5,395,18.0,127.0,127.0,5,1111,18.0,843.0,843.0
40.053,17,10,676,5,460,10012.0,104.0,64.0,5,216,10012.0,20.0,15.0
0.021,6,10,1972,5,910,5.0,642.0,642.0,5,1062,5.0,794.0,794.0
0.019,6,10,1989,5,910,4.0,642.0,642.0,5,1079,4.0,811.0,811.0
15.115,17,18,9734,9,6261,1885.0,1350.0,667.0,9,3473,1885.0,1350.0,357.0
0.12,6,10,1506,5,395,28.0,127.0,127.0,5,1111,28.0,843.0,843.0
1755.984,6,105,6240,60,3510,29761.0,26.0,26.0,45,2730,39907.0,26.0,26.0
0.006,6,10,1989,5,927,1.0,659.0,659.0,5,1062,1.0,794.0,794.0
61.143,6,20,10024,11,3909,6114.0,1579.0,835.0,9,6115,7627.0,2111.0,939.0
0.016,6,10,1990,5,911,3.0,643.0,643.0,5,1079,3.0,811.0,811.0
0.338,17,43,21791,24,18527,14.0,1350.0,743.0,19,3264,15.0,1350.0,143.0
0.079,6,10,1506,5,395,18.0,127.0,127.0,5,1111,17.0,843.0,843.0
0.003,17,2,136,1,60,0.0,32.0,32.0,1,76,0.0,48.0,48.0
0.101,6,10,1506,5,395,22.0,127.0,127.0,5,1111,22.0,843.0,843.0
0.006,6,10,1643,5,860,1.0,592.0,592.0,5,783,1.0,515.0,515.0
0.008,6,10,1762,5,911,1.0,643.0,643.0,5,851,2.0,583.0,583.0
0.008,6,10,1983,5,910,2.0,642.0,642.0,5,1073,2.0,805.0,805.0
0.008,6,10,1989,5,910,2.0,642.0,642.0,5,1079,1.0,811.0,811.0
412.258,6,29,4409,12,3102,10911.0,494.0,494.0,17,1307,25765.0,83.0,83.0
0.005,6,10,2006,5,927,1.0,659.0,659.0,5,1079,1.0,811.0,811.0
240.008,6,9,787,5,488,60002.0,232.0,232.0,4,299,80001.0,83.0,83.0
0.009,6,10,1677,5,827,2.0,559.0,559.0,5,850,2.0,582.0,582.0
0.005,17,2,164,1,74,0.0,46.0,46.0,1,90,0.0,62.0,62.0
0.005,17,2,175,1,65,0.0,37.0,37.0,1,110,0.0,82.0,82.0
0.012,6,10,1677,5,827,2.0,559.0,559.0,5,850,2.0,582.0,582.0
0.012,6,10,1990,5,911,3.0,643.0,643.0,5,1079,3.0,811.0,811.0
0.01,6,10,1983,5,910,2.0,642.0,642.0,5,1073,2.0,805.0,805.0
0.026,6,10,1762,5,911,6.0,643.0,643.0,5,851,6.0,583.0,583.0
294.758,6,378,347289,190,21450,1559.0,2736.0,889.0,188,325839,1576.0,2804.0,1816.0
0.084,6,10,1506,5,395,19.0,127.0,127.0,5,1111,16.0,843.0,843.0
0.099,6,10,1506,5,395,19.0,127.0,127.0,5,1111,21.0,843.0,843.0
0.005,17,2,187,1,74,0.0,46.0,46.0,1,113,0.0,85.0,85.0
0.011,6,10,1989,5,910,2.0,642.0,642.0,5,1079,2.0,811.0,811.0
0.006,6,10,1547,5,764,1.0,496.0,496.0,5,783,1.0,515.0,515.0
0.003,17,2,148,1,60,0.0,32.0,32.0,1,88,0.0,60.0,60.0
0.005,6,10,1854,5,889,1.0,621.0,621.0,5,965,1.0,697.0,697.0
1.154,6,32,12785,18,3352,67.0,1360.0,517.0,14,9433,75.0,2720.0,886.0
0.004,17,2,180,1,66,0.0,38.0,38.0,1,114,0.0,86.0,86.0
300.454,6,32,11638,19,2097,16691.0,538.0,272.0,13,9541,2203.0,2804.0,984.0
0.02,6,10,1990,5,911,5.0,643.0,643.0,5,1079,4.0,811.0,811.0
0.006,6,10,1689,5,839,1.0,571.0,571.0,5,850,1.0,582.0,582.0
0.103,6,10,1506,5,395,25.0,127.0,127.0,5,1111,23.0,843.0,843.0
0.008,6,10,1972,5,910,1.0,642.0,642.0,5,1062,2.0,794.0,794.0
0.01,6,10,1990,5,911,2.0,643.0,643.0,5,1079,2.0,811.0,811.0
0.006,6,10,1643,5,860,1.0,592.0,592.0,5,783,1.0,515.0,515.0
0.065,6,10,1506,5,395,13.0,127.0,127.0,5,1111,14.0,843.0,843.0
0.004,6,10,2006,5,927,1.0,659.0,659.0,5,1079,1.0,811.0,811.0
163.455,17,78,11037,39,2601,4301.0,44.0,38.0,39,8436,4301.0,239.0,188.0
0.071,6,10,1506,5,395,15.0,127.0,127.0,5,1111,17.0,843.0,843.0
0.004,6,10,1989,5,927,1.0,659.0,659.0,5,1062,1.0,794.0,794.0
0.146,6,10,1506,5,395,33.0,127.0,127.0,5,1111,35.0,843.0,843.0
300.396,6,16,2170,9,684,37528.0,146.0,146.0,7,1486,50038.0,419.0,398.0
0.004,17,2,194,1,59,0.0,31.0,31.0,1,135,0.0,107.0,107.0
0.216,6,16,2670,8,1396,30.0,533.0,324.0,8,1274,19.0,529.0,212.0
0.001,17,2,180,1,66,0.0,38.0,38.0,1,114,0.0,86.0,86.0
0.044,17,4,284,2,120,0.0,32.0,32.0,2,164,39.0,60.0,54.0
0.076,6,10,1506,5,395,17.0,127.0,127.0,5,1111,17.0,843.0,843.0
0.161,6,10,1506,5,395,35.0,127.0,127.0,5,1111,36.0,843.0,843.0
0.128,6,10,1506,5,395,29.0,127.0,127.0,5,1111,30.0,843.0,843.0
0.012,6,10,1989,5,910,3.0,642.0,642.0,5,1079,3.0,811.0,811.0
0.003,17,2,136,1,60,0.0,32.0,32.0,1,76,0.0,48.0,48.0
0.004,6,10,2007,5,928,1.0,660.0,660.0,5,1079,1.0,811.0,811.0
0.072,6,10,1506,5,395,16.0,127.0,127.0,5,1111,14.0,843.0,843.0
0.005,17,2,214,1,75,0.0,47.0,47.0,1,139,0.0,111.0,111.0
0.018,17,2,152,1,76,0.0,48.0,48.0,1,76,0.0,48.0,48.0
0.085,6,10,1506,5,395,20.0,127.0,127.0,5,1111,16.0,843.0,843.0
240.013,6,9,787,5,488,60003.0,232.0,232.0,4,299,80003.0,83.0,83.0
0.03,17,2,166,1,75,0.0,47.0,47.0,1,91,0.0,63.0,63.0
0.164,17,2,152,1,76,0.0,48.0,48.0,1,76,0.0,48.0,48.0
0.005,6,10,2006,5,927,1.0,659.0,659.0,5,1079,1.0,811.0,811.0
0.136,6,10,1506,5,395,31.0,127.0,127.0,5,1111,31.0,843.0,843.0
0.036,17,2,148,1,60,0.0,32.0,32.0,1,88,0.0,60.0,60.0
0.009,6,10,1972,5,910,2.0,642.0,642.0,5,1062,2.0,794.0,794.0
0.33,6,16,2777,8,1395,47.0,533.0,323.0,8,1382,31.0,529.0,239.0
0.006,17,2,194,1,59,0.0,31.0,31.0,1,135,0.0,107.0,107.0
0.004,6,10,1702,5,863,0.0,595.0,595.0,5,839,1.0,571.0,571.0
0.022,6,10,1989,5,910,5.0,642.0,642.0,5,1079,5.0,811.0,811.0
0.005,6,10,1989,5,927,1.0,659.0,659.0,5,1062,1.0,794.0,794.0
0.008,6,12,1926,6,1189,1.0,659.0,434.0,6,737,1.0,417.0,417.0
0.011,6,10,1762,5,911,2.0,643.0,643.0,5,851,2.0,583.0,583.0
0.007,17,2,179,1,71,0.0,43.0,43.0,1,108,0.0,80.0,80.0
0.016,6,10,1677,5,827,3.0,559.0,559.0,5,850,3.0,582.0,582.0
0.011,6,10,1990,5,911,2.0,643.0,643.0,5,1079,2.0,811.0,811.0
0.004,17,4,284,2,120,0.0,32.0,32.0,2,164,0.0,60.0,54.0
0.009,6,10,1990,5,911,2.0,643.0,643.0,5,1079,2.0,811.0,811.0
0.007,17,2,179,1,71,0.0,43.0,43.0,1,108,0.0,80.0,80.0
0.005,6,10,2006,5,927,1.0,659.0,659.0,5,1079,1.0,811.0,811.0
0.015,6,20,9974,11,704,1.0,124.0,124.0,9,9270,1.0,2896.0,1758.0
0.006,6,10,1689,5,839,1.0,571.0,571.0,5,850,1.0,582.0,582.0
0.012,6,10,1989,5,910,3.0,642.0,642.0,5,1079,2.0,811.0,811.0
0.005,17,2,170,1,65,0.0,37.0,37.0,1,105,0.0,77.0,77.0
325.845,17,20,1124,10,716,36198.0,48.0,43.0,10,408,36198.0,20.0,12.0
0.021,6,10,1972,5,910,5.0,642.0,642.0,5,1062,5.0,794.0,794.0
0.006,17,2,294,1,64,0.0,36.0,36.0,1,230,0.0,202.0,202.0
0.08,6,10,1506,5,395,15.0,127.0,127.0,5,1111,17.0,843.0,843.0
0.081,6,10,1506,5,395,17.0,127.0,127.0,5,1111,16.0,843.0,843.0
40.069,17,10,676,5,460,10016.0,104.0,64.0,5,216,10016.0,20.0,15.0
0.005,6,10,1774,5,923,1.0,655.0,655.0,5,851,1.0,583.0,583.0
0.011,6,10,1990,5,911,2.0,643.0,643.0,5,1079,2.0,811.0,811.0
0.222,6,16,2777,8,1395,31.0,533.0,323.0,8,1382,20.0,529.0,239.0
0.012,6,10,1762,5,911,3.0,643.0,643.0,5,851,3.0,583.0,583.0
40.137,17,10,676,5,460,10033.0,104.0,64.0,5,216,10033.0,20.0,15.0
0.006,6,10,1643,5,860,1.0,592.0,592.0,5,783,1.0,515.0,515.0
0.001,17,2,180,1,66,0.0,38.0,38.0,1,114,0.0,86.0,86.0
1751.158,6,474,69314,262,35928,6709.0,613.0,192.0,212,33386,8298.0,613.0,153.0
0.006,6,10,1854,5,889,1.0,621.0,621.0,5,965,1.0,697.0,697.0
0.006,6,10,1547,5,764,1.0,496.0,496.0,5,783,1.0,515.0,515.0
0.008,17,2,194,1,59,0.0,31.0,31.0,1,135,0.0,107.0,107.0
0.011,6,10,1989,5,910,2.0,642.0,642.0,5,1079,2.0,811.0,811.0
0.006,6,10,2000,5,927,1.0,659.0,659.0,5,1073,1.0,805.0,805.0
0.006,6,10,2007,5,928,1.0,660.0,660.0,5,1079,1.0,811.0,811.0
0.006,6,10,1689,5,839,1.0,571.0,571.0,5,850,1.0,582.0,582.0
0.041,17,4,284,2,120,0.0,32.0,32.0,2,164,38.0,60.0,54.0
0.004,17,4,284,2,120,0.0,32.0,32.0,2,164,1.0,60.0,54.0
0.042,17,4,284,2,120,0.0,32.0,32.0,2,164,1.0,60.0,54.0
0.025,6,10,1972,5,910,6.0,642.0,642.0,5,1062,6.0,794.0,794.0
0.083,6,10,1506,5,395,16.0,127.0,127.0,5,1111,19.0,843.0,843.0
0.018,6,10,1983,5,910,4.0,642.0,642.0,5,1073,4.0,805.0,805.0
0.01,6,12,1926,6,1189,1.0,659.0,434.0,6,737,1.0,417.0,417.0
0.013,17,2,152,1,56,0.0,28.0,28.0,1,96,0.0,68.0,68.0
0.231,6,16,2669,8,1395,33.0,533.0,323.0,8,1274,21.0,529.0,212.0
0.136,17,2,80,1,32,0.0,4.0,4.0,1,48,0.0,20.0,20.0
0.004,17,2,136,1,60,0.0,32.0,32.0,1,76,0.0,48.0,48.0
0.112,6,10,1506,5,395,24.0,127.0,127.0,5,1111,23.0,843.0,843.0
0.006,6,10,1547,5,764,1.0,496.0,496.0,5,783,1.0,515.0,515.0
0.078,6,10,1506,5,395,16.0,127.0,127.0,5,1111,17.0,843.0,843.0
0.006,17,2,136,1,60,0.0,32.0,32.0,1,76,0.0,48.0,48.0
240.012,6,9,787,5,488,60003.0,232.0,232.0,4,299,80003.0,83.0,83.0
0.015,6,10,1989,5,910,3.0,642.0,642.0,5,1079,3.0,811.0,811.0
40.059,17,10,676,5,460,10013.0,104.0,64.0,5,216,10013.0,20.0,15.0
0.006,17,2,144,1,64,0.0,36.0,36.0,1,80,0.0,52.0,52.0
0.041,17,2,152,1,76,0.0,48.0,48.0,1,76,0.0,48.0,48.0
40.077,17,10,676,5,460,10018.0,104.0,64.0,5,216,10018.0,20.0,15.0
0.005,6,10,1689,5,839,1.0,571.0,571.0,5,850,1.0,582.0,582.0
0.005,6,10,2006,5,927,1.0,659.0,659.0,5,1079,1.0,811.0,811.0
0.009,6,12,1926,6,1189,1.0,659.0,434.0,6,737,1.0,417.0,417.0
0.011,6,10,1631,5,848,2.0,580.0,580.0,5,783,2.0,515.0,515.0
0.006,6,10,1547,5,764,1.0,496.0,496.0,5,783,1.0,515.0,515.0
0.037,17,4,284,2,120,0.0,32.0,32.0,2,164,33.0,60.0,54.0
0.032,6,14,3965,7,495,5.0,123.0,123.0,7,3470,5.0,1448.0,1032.0
0.003,17,2,148,1,60,0.0,32.0,32.0,1,88,0.0,60.0,60.0
0.02,6,10,1990,5,911,4.0,643.0,643.0,5,1079,5.0,811.0,811.0
0.005,6,10,1643,5,860,1.0,592.0,592.0,5,783,1.0,515.0,515.0
15.071,17,15,9238,8,6902,2148.0,1350.0,834.0,7,2336,2506.0,1350.0,305.0
0.29,6,28,8433,15,1897,19.0,490.0,219.0,13,6536,22.0,1397.0,836.0
0.006,6,10,1547,5,764,1.0,496.0,496.0,5,783,1.0,515.0,515.0
0.015,6,10,1631,5,848,3.0,580.0,580.0,5,783,3.0,515.0,515.0
0.007,6,10,1972,5,910,1.0,642.0,642.0,5,1062,1.0,794.0,794.0
0.04,17,2,144,1,64,0.0,36.0,36.0,1,80,0.0,52.0,52.0
0.005,6,10,1689,5,839,1.0,571.0,571.0,5,850,1.0,582.0,582.0
0.013,6,13,3735,7,497,2.0,125.0,125.0,6,3238,2.0,1470.0,1459.0
0.012,6,10,1990,5,911,3.0,643.0,643.0,5,1079,3.0,811.0,811.0
0.005,17,2,179,1,71,0.0,43.0,43.0,1,108,0.0,80.0,80.0
0.009,6,10,1989,5,910,2.0,642.0,642.0,5,1079,2.0,811.0,811.0
0.012,6,10,1972,5,910,2.0,642.0,642.0,5,1062,2.0,794.0,794.0
0.106,6,10,1506,5,395,21.0,127.0,127.0,5,1111,22.0,843.0,843.0
0.003,17,4,284,2,120,0.0,32.0,32.0,2,164,0.0,60.0,54.0
0.005,6,14,3742,8,504,0.0,80.0,80.0,6,3238,0.0,1470.0,1459.0
0.006,17,2,140,1,62,0.0,34.0,34.0,1,78,0.0,50.0,50.0
0.005,6,10,2007,5,928,1.0,660.0,660.0,5,1079,1.0,811.0,811.0
0.005,6,10,1689,5,839,1.0,571.0,571.0,5,850,1.0,582.0,582.0
0.13,6,10,1506,5,395,30.0,127.0,127.0,5,1111,31.0,843.0,843.0
0.008,6,10,1631,5,848,2.0,580.0,580.0,5,783,2.0,515.0,515.0
0.095,6,10,1506,5,395,20.0,127.0,127.0,5,1111,23.0,843.0,843.0
0.006,6,10,1689,5,839,1.0,571.0,571.0,5,850,1.0,582.0,582.0
0.032,6,10,1972,5,910,8.0,642.0,642.0,5,1062,8.0,794.0,794.0
0.004,6,10,1779,5,928,1.0,660.0,660.0,5,851,0.0,583.0,583.0
0.005,6,10,2000,5,927,1.0,659.0,659.0,5,1073,1.0,805.0,805.0
0.006,6,10,1547,5,764,1.0,496.0,496.0,5,783,1.0,515.0,515.0
0.037,17,2,214,1,75,0.0,47.0,47.0,1,139,0.0,111.0,111.0
0.009,6,10,1989,5,910,2.0,642.0,642.0,5,1079,2.0,811.0,811.0
40.053,17,10,676,5,460,10012.0,104.0,64.0,5,216,10012.0,20.0,15.0
0.005,6,10,2007,5,928,1.0,660.0,660.0,5,1079,1.0,811.0,811.0
0.001,17,2,136,1,60,0.0,32.0,32.0,1,76,0.0,48.0,48.0
0.043,17,2,396,1,61,0.0,33.0,33.0,1,335,0.0,307.0,307.0
0.001,17,2,180,1,66,0.0,38.0,38.0,1,114,0.0,86.0,86.0
0.006,6,10,1547,5,764,1.0,496.0,496.0,5,783,1.0,515.0,515.0
11.091,17,28,4397,14,2312,845.0,587.0,137.0,14,2085,845.0,268.0,120.0
0.08,6,10,1506,5,395,18.0,127.0,127.0,5,1111,15.0,843.0,843.0
40.054,17,10,676,5,460,10012.0,104.0,64.0,5,216,10012.0,20.0,15.0
0.014,6,10,1983,5,910,3.0,642.0,642.0,5,1073,3.0,805.0,805.0
0.01,6,10,1989,5,910,2.0,642.0,642.0,5,1079,2.0,811.0,811.0
0.016,6,10,1972,5,910,3.0,642.0,642.0,5,1062,4.0,794.0,794.0
0.006,6,10,1689,5,839,1.0,571.0,571.0,5,850,1.0,582.0,582.0
0.016,6,10,1762,5,911,4.0,643.0,643.0,5,851,3.0,583.0,583.0
0.005,6,10,1989,5,927,1.0,659.0,659.0,5,1062,1.0,794.0,794.0
0.011,6,10,1972,5,910,2.0,642.0,642.0,5,1062,2.0,794.0,794.0
0.004,6,10,2006,5,927,1.0,659.0,659.0,5,1079,1.0,811.0,811.0
15.389,17,42,21640,23,18462,698.0,1350.0,774.0,19,3178,853.0,1350.0,139.0
0.104,6,10,1506,5,395,22.0,127.0,127.0,5,1111,24.0,843.0,843.0
0.005,6,10,1774,5,923,1.0,655.0,655.0,5,851,1.0,583.0,583.0
0.005,6,10,1779,5,928,1.0,660.0,660.0,5,851,1.0,583.0,583.0
0.087,6,10,1506,5,395,18.0,127.0,127.0,5,1111,16.0,843.0,843.0
0.004,6,10,2007,5,928,1.0,660.0,660.0,5,1079,1.0,811.0,811.0
0.013,6,10,1990,5,911,3.0,643.0,643.0,5,1079,3.0,811.0,811.0
0.001,17,2,136,1,60,0.0,32.0,32.0,1,76,0.0,48.0,48.0
0.013,6,10,1990,5,911,3.0,643.0,643.0,5,1079,3.0,811.0,811.0
0.005,6,10,2000,5,927,1.0,659.0,659.0,5,1073,1.0,805.0,805.0
0.006,17,2,231,1,68,0.0,40.0,40.0,1,163,0.0,135.0,135.0
0.005,6,10,1989,5,927,1.0,659.0,659.0,5,1062,1.0,794.0,794.0
0.003,17,2,148,1,60,0.0,32.0,32.0,1,88,0.0,60.0,60.0
0.015,6,10,1972,5,910,3.0,642.0,642.0,5,1062,3.0,794.0,794.0
0.005,6,13,3690,7,452,0.0,80.0,80.0,6,3238,0.0,1470.0,1459.0
0.005,17,2,214,1,75,0.0,47.0,47.0,1,139,0.0,111.0,111.0
0.317,17,41,22964,22,18410,15.0,1350.0,808.0,19,4554,14.0,1350.0,211.0
0.013,6,10,1989,5,910,3.0,642.0,642.0,5,1079,3.0,811.0,811.0
0.009,6,12,1926,6,1189,1.0,659.0,434.0,6,737,1.0,417.0,417.0
0.003,17,2,148,1,60,0.0,32.0,32.0,1,88,0.0,60.0,60.0
0.006,17,2,170,1,65,0.0,37.0,37.0,1,105,0.0,77.0,77.0
0.111,6,38,10471,22,2461,5.0,517.0,146.0,16,8010,6.0,1402.0,651.0
0.006,6,10,2007,5,928,1.0,660.0,660.0,5,1079,1.0,811.0,811.0
0.003,6,10,1702,5,863,0.0,595.0,595.0,5,839,0.0,571.0,571.0
0.006,6,10,1989,5,927,1.0,659.0,659.0,5,1062,1.0,794.0,794.0
0.01,6,10,1989,5,910,2.0,642.0,642.0,5,1079,2.0,811.0,811.0
15.078,17,16,8640,8,6451,2150.0,1350.0,778.0,8,2189,2149.0,1350.0,245.0
0.006,6,10,1774,5,923,1.0,655.0,655.0,5,851,1.0,583.0,583.0
0.005,6,10,1774,5,923,1.0,655.0,655.0,5,851,1.0,583.0,583.0
0.006,17,2,166,1,75,0.0,47.0,47.0,1,91,0.0,63.0,63.0
0.008,17,2,179,1,71,0.0,43.0,43.0,1,108,0.0,80.0,80.0
0.005,6,10,1689,5,839,1.0,571.0,571.0,5,850,1.0,582.0,582.0
0.006,17,2,222,1,65,0.0,37.0,37.0,1,157,0.0,129.0,129.0
0.005,17,2,214,1,75,0.0,47.0,47.0,1,139,0.0,111.0,111.0
0.004,6,10,2006,5,927,1.0,659.0,659.0,5,1079,1.0,811.0,811.0
0.004,17,2,208,1,72,0.0,44.0,44.0,1,136,0.0,108.0,108.0
0.005,6,10,1989,5,927,1.0,659.0,659.0,5,1062,1.0,794.0,794.0
0.01,6,10,1983,5,910,2.0,642.0,642.0,5,1073,2.0,805.0,805.0
1.168,6,32,13392,18,5893,68.0,2720.0,854.0,14,7499,77.0,2720.0,769.0
0.07,17,8,3613,4,1874,23.0,1350.0,440.0,4,1739,12.0,1350.0,406.0
0.141,6,10,1506,5,395,33.0,127.0,127.0,5,1111,33.0,843.0,843.0
0.02,6,10,1989,5,910,4.0,642.0,642.0,5,1079,4.0,811.0,811.0
0.042,17,4,284,2,120,0.0,32.0,32.0,2,164,3.0,60.0,54.0
0.004,6,10,2006,5,927,1.0,659.0,659.0,5,1079,1.0,811.0,811.0
0.005,17,2,179,1,71,0.0,43.0,43.0,1,108,0.0,80.0,80.0
0.06,17,4,596,2,122,20.0,33.0,33.0,2,474,57.0,323.0,209.0
0.009,6,10,1990,5,911,2.0,643.0,643.0,5,1079,2.0,811.0,811.0
0.001,17,2,136,1,60,0.0,32.0,32.0,1,76,0.0,48.0,48.0
0.004,6,10,2007,5,928,1.0,660.0,660.0,5,1079,1.0,811.0,811.0
0.072,17,8,3613,4,1874,24.0,1350.0,440.0,4,1739,12.0,1350.0,406.0
0.006,6,10,1643,5,860,1.0,592.0,592.0,5,783,1.0,515.0,515.0
0.125,6,10,1506,5,395,29.0,127.0,127.0,5,1111,27.0,843.0,843.0
40.077,17,10,676,5,460,10017.0,104.0,64.0,5,216,10018.0,20.0,15.0
68.443,6,37,10002,19,4484,497.0,1360.0,738.0,18,5518,4016.0,2667.0,435.0
1770.615,17,120,11460,60,5460,30010.0,63.0,63.0,60,6000,30010.0,72.0,72.0
0.013,6,10,1990,5,911,3.0,643.0,643.0,5,1079,3.0,811.0,811.0
0.011,6,10,1990,5,911,2.0,643.0,643.0,5,1079,2.0,811.0,811.0
0.005,17,2,170,1,65,0.0,37.0,37.0,1,105,0.0,77.0,77.0
0.005,6,13,3690,7,452,0.0,80.0,80.0,6,3238,0.0,1470.0,1459.0
159.148,17,72,10482,36,2406,4546.0,44.0,38.0,36,8076,4547.0,261.0,196.0
371.488,6,22,2313,16,867,24765.0,195.0,195.0,6,1446,4639.0,419.0,398.0
0.004,6,13,3747,7,509,0.0,137.0,137.0,6,3238,0.0,1470.0,1459.0
285.036,6,25,6337,10,1186,31670.0,267.0,156.0,15,5151,20353.0,1400.0,649.0
0.005,17,2,180,1,66,0.0,38.0,38.0,1,114,0.0,86.0,86.0
0.083,6,10,1506,5,395,18.0,127.0,127.0,5,1111,16.0,843.0,843.0
0.015,17,2,140,1,62,0.0,34.0,34.0,1,78,0.0,50.0,50.0
0.009,6,10,1983,5,910,2.0,642.0,642.0,5,1073,2.0,805.0,805.0
40.052,17,10,676,5,460,10012.0,104.0,64.0,5,216,10012.0,20.0,15.0
240.263,6,41,8667,20,5634,12645.0,2883.0,573.0,21,3033,12013.0,580.0,241.0
0.091,6,10,1506,5,395,20.0,127.0,127.0,5,1111,20.0,843.0,843.0
0.084,6,10,1506,5,395,20.0,127.0,127.0,5,1111,19.0,843.0,843.0
0.012,6,10,1762,5,911,2.0,643.0,643.0,5,851,3.0,583.0,583.0
240.231,6,41,5508,19,2397,13346.0,588.0,196.0,22,3111,11439.0,580.0,217.0
40.071,17,10,676,5,460,10015.0,104.0,64.0,5,216,10016.0,20.0,15.0
0.003,17,4,420,2,122,0.0,33.0,33.0,2,298,0.0,145.0,121.0
0.006,6,10,1989,5,927,1.0,659.0,659.0,5,1062,1.0,794.0,794.0
0.003,17,2,136,1,60,0.0,32.0,32.0,1,76,0.0,48.0,48.0
0.065,6,10,1506,5,395,14.0,127.0,127.0,5,1111,14.0,843.0,843.0
0.107,6,10,1506,5,395,25.0,127.0,127.0,5,1111,21.0,843.0,843.0
0.015,6,14,3787,7,497,2.0,125.0,125.0,7,3290,2.0,1448.0,972.0
0.004,6,10,1774,5,923,1.0,655.0,655.0,5,851,1.0,583.0,583.0
0.008,6,10,2006,5,927,2.0,659.0,659.0,5,1079,2.0,811.0,811.0
0.01,6,10,1631,5,848,2.0,580.0,580.0,5,783,2.0,515.0,515.0
0.005,17,2,140,1,62,0.0,34.0,34.0,1,78,0.0,50.0,50.0
15.072,17,15,9239,8,6902,2149.0,1350.0,834.0,7,2337,2507.0,1350.0,305.0
40.076,17,10,676,5,460,10016.0,104.0,64.0,5,216,10018.0,20.0,15.0
240.017,6,9,787,5,488,60004.0,232.0,232.0,4,299,80004.0,83.0,83.0
0.004,17,2,148,1,60,0.0,32.0,32.0,1,88,0.0,60.0,60.0
0.018,6,10,1972,5,910,4.0,642.0,642.0,5,1062,4.0,794.0,794.0
0.013,6,10,1972,5,910,3.0,642.0,642.0,5,1062,3.0,794.0,794.0
0.004,6,10,2006,5,927,1.0,659.0,659.0,5,1079,1.0,811.0,811.0
0.093,6,10,1506,5,395,21.0,127.0,127.0,5,1111,22.0,843.0,843.0
240.493,6,37,9662,19,2177,13360.0,749.0,236.0,18,7485,14146.0,1402.0,595.0
0.851,6,23,5112,12,1290,66.0,325.0,133.0,11,3822,72.0,1414.0,563.0
0.018,6,10,1983,5,910,4.0,642.0,642.0,5,1073,4.0,805.0,805.0
0.011,17,2,146,1,65,0.0,37.0,37.0,1,81,0.0,53.0,53.0
0.082,6,10,1506,5,395,19.0,127.0,127.0,5,1111,18.0,843.0,843.0
0.005,6,13,3747,7,509,0.0,137.0,137.0,6,3238,1.0,1470.0,1459.0
0.012,6,10,1762,5,911,3.0,643.0,643.0,5,851,2.0,583.0,583.0
0.149,6,10,1506,5,395,35.0,127.0,127.0,5,1111,33.0,843.0,843.0
0.005,17,2,169,1,62,0.0,34.0,34.0,1,107,0.0,79.0,79.0
0.099,6,10,1506,5,395,20.0,127.0,127.0,5,1111,22.0,843.0,843.0
0.009,6,10,1983,5,910,2.0,642.0,642.0,5,1073,2.0,805.0,805.0
0.001,17,2,180,1,66,0.0,38.0,38.0,1,114,0.0,86.0,86.0
0.014,17,2,169,1,62,0.0,34.0,34.0,1,107,0.0,79.0,79.0
0.102,6,10,1506,5,395,22.0,127.0,127.0,5,1111,22.0,843.0,843.0
0.117,6,10,1506,5,395,25.0,127.0,127.0,5,1111,26.0,843.0,843.0
0.008,6,12,1926,6,1189,1.0,659.0,434.0,6,737,1.0,417.0,417.0
0.005,17,2,136,1,60,0.0,32.0,32.0,1,76,0.0,48.0,48.0
0.085,6,10,1506,5,395,16.0,127.0,127.0,5,1111,20.0,843.0,843.0
0.127,6,10,1506,5,395,19.0,127.0,127.0,5,1111,28.0,843.0,843.0
0.081,6,10,1506,5,395,19.0,127.0,127.0,5,1111,19.0,843.0,843.0
0.005,17,2,170,1,65,0.0,37.0,37.0,1,105,0.0,77.0,77.0
1.163,6,31,12745,18,3352,68.0,1360.0,517.0,13,9393,82.0,2720.0,984.0
0.094,6,10,1506,5,395,21.0,127.0,127.0,5,1111,20.0,843.0,843.0
0.013,6,10,1990,5,911,3.0,643.0,643.0,5,1079,3.0,811.0,811.0
0.006,17,2,230,1,68,0.0,40.0,40.0,1,162,0.0,134.0,134.0
0.094,6,10,1506,5,395,20.0,127.0,127.0,5,1111,22.0,843.0,843.0
0.004,6,10,1702,5,863,1.0,595.0,595.0,5,839,0.0,571.0,571.0
0.001,17,2,180,1,66,0.0,38.0,38.0,1,114,0.0,86.0,86.0
0.006,6,10,1689,5,839,1.0,571.0,571.0,5,850,1.0,582.0,582.0
0.101,6,10,1506,5,395,15.0,127.0,127.0,5,1111,22.0,843.0,843.0
0.797,6,10,937,6,427,159.0,107.0,107.0,4,510,177.0,294.0,294.0
0.072,17,2,136,1,60,0.0,32.0,32.0,1,76,0.0,48.0,48.0
0.005,6,10,1854,5,889,1.0,621.0,621.0,5,965,1.0,697.0,697.0
1792.74,6,488,98853,247,87623,7287.0,421.0,368.0,241,11230,7469.0,53.0,53.0
0.011,6,10,1989,5,910,2.0,642.0,642.0,5,1079,2.0,811.0,811.0
300.021,6,12,1782,7,1348,50003.0,494.0,494.0,5,434,75004.0,83.0,83.0
0.006,6,10,2006,5,927,1.0,659.0,659.0,5,1079,1.0,811.0,811.0
423.207,6,54,3632,21,1576,21160.0,46.0,46.0,33,2056,13221.0,46.0,46.0
0.005,6,10,1989,5,927,1.0,659.0,659.0,5,1062,1.0,794.0,794.0
0.004,6,10,2000,5,927,1.0,659.0,659.0,5,1073,1.0,805.0,805.0
0.006,6,10,1547,5,764,1.0,496.0,496.0,5,783,1.0,515.0,515.0
0.005,6,10,2007,5,928,1.0,660.0,660.0,5,1079,1.0,811.0,811.0
0.009,6,10,1989,5,910,2.0,642.0,642.0,5,1079,2.0,811.0,811.0
68.861,6,24,10287,14,4120,5297.0,1591.0,676.0,10,6167,7315.0,2111.0,939.0
0.007,6,10,1547,5,764,1.0,496.0,496.0,5,783,1.0,515.0,515.0
15.072,17,14,9190,8,6902,2148.0,1350.0,834.0,6,2288,3008.0,1350.0,353.0
0.077,6,10,1506,5,395,15.0,127.0,127.0,5,1111,18.0,843.0,843.0
0.007,6,10,1854,5,889,1.0,621.0,621.0,5,965,1.0,697.0,697.0
0.087,6,10,1506,5,395,18.0,127.0,127.0,5,1111,20.0,843.0,843.0
10.888,17,28,4418,14,1995,828.0,270.0,114.0,14,2423,829.0,586.0,145.0
0.005,6,10,2000,5,927,1.0,659.0,659.0,5,1073,1.0,805.0,805.0
40.063,17,10,676,5,460,10012.0,104.0,64.0,5,216,10014.0,20.0,15.0
0.01,6,10,1983,5,910,2.0,642.0,642.0,5,1073,2.0,805.0,805.0
15.073,17,15,9238,8,6902,2149.0,1350.0,834.0,7,2336,2507.0,1350.0,305.0
0.138,6,10,1506,5,395,20.0,127.0,127.0,5,1111,32.0,843.0,843.0
0.013,6,10,1762,5,911,3.0,643.0,643.0,5,851,3.0,583.0,583.0
0.073,6,10,1506,5,395,16.0,127.0,127.0,5,1111,15.0,843.0,843.0
0.004,6,10,2006,5,927,1.0,659.0,659.0,5,1079,1.0,811.0,811.0
0.012,6,10,1989,5,910,3.0,642.0,642.0,5,1079,2.0,811.0,811.0
10.779,17,28,4421,14,1993,820.0,268.0,114.0,14,2428,820.0,587.0,145.0
0.082,6,10,1506,5,395,16.0,127.0,127.0,5,1111,18.0,843.0,843.0
0.104,6,10,1506,5,395,25.0,127.0,127.0,5,1111,24.0,843.0,843.0
0.004,17,4,284,2,120,1.0,32.0,32.0,2,164,1.0,60.0,54.0
0.028,6,14,3787,7,497,4.0,125.0,125.0,7,3290,4.0,1448.0,972.0
0.077,6,10,1506,5,395,17.0,127.0,127.0,5,1111,16.0,843.0,843.0
40.06,17,10,676,5,460,10013.0,104.0,64.0,5,216,10014.0,20.0,15.0
0.012,6,10,1643,5,860,3.0,592.0,592.0,5,783,3.0,515.0,515.0
0.112,6,10,1506,5,395,23.0,127.0,127.0,5,1111,25.0,843.0,843.0
120.799,6,57,19071,34,4929,3660.0,1056.0,210.0,23,14142,5490.0,2804.0,995.0
0.007,17,2,162,1,65,0.0,37.0,37.0,1,97,0.0,69.0,69.0
0.005,17,2,170,1,65,0.0,37.0,37.0,1,105,0.0,77.0,77.0
1787.096,6,150,19350,90,13740,20079.0,302.0,302.0,60,5610,30289.0,83.0,83.0
0.008,6,10,1762,5,911,2.0,643.0,643.0,5,851,1.0,583.0,583.0
0.015,6,10,1972,5,910,3.0,642.0,642.0,5,1062,3.0,794.0,794.0
0.008,6,10,1990,5,911,2.0,643.0,643.0,5,1079,1.0,811.0,811.0
40.071,17,10,676,5,460,10015.0,104.0,64.0,5,216,10016.0,20.0,15.0
0.005,6,10,2007,5,928,1.0,660.0,660.0,5,1079,1.0,811.0,811.0
294.045,6,334,345733,131,18385,2261.0,2736.0,889.0,203,327348,1455.0,2804.0,1685.0
0.137,17,4,284,2,120,8.0,32.0,32.0,2,164,133.0,60.0,54.0
0.006,6,10,1547,5,764,1.0,496.0,496.0,5,783,1.0,515.0,515.0
0.01,6,10,1989,5,910,2.0,642.0,642.0,5,1079,2.0,811.0,811.0
0.013,6,10,1972,5,910,3.0,642.0,642.0,5,1062,3.0,794.0,794.0
0.014,6,10,1989,5,910,3.0,642.0,642.0,5,1079,3.0,811.0,811.0
0.006,6,10,1854,5,889,1.0,621.0,621.0,5,965,1.0,697.0,697.0
308.457,17,20,1124,10,716,34258.0,48.0,43.0,10,408,34258.0,20.0,12.0
0.009,6,10,1779,5,928,2.0,660.0,660.0,5,851,2.0,583.0,583.0
0.015,6,10,1972,5,910,3.0,642.0,642.0,5,1062,3.0,794.0,794.0
0.064,6,10,1506,5,395,15.0,127.0,127.0,5,1111,12.0,843.0,843.0
0.003,17,2,166,1,75,0.0,47.0,47.0,1,91,0.0,63.0,63.0
0.009,6,10,1990,5,911,2.0,643.0,643.0,5,1079,2.0,811.0,811.0
0.023,6,10,1972,5,910,5.0,642.0,642.0,5,1062,5.0,794.0,794.0
0.006,6,10,1779,5,928,1.0,660.0,660.0,5,851,1.0,583.0,583.0
0.006,6,10,1547,5,764,1.0,496.0,496.0,5,783,1.0,515.0,515.0
0.01,6,10,1677,5,827,2.0,559.0,559.0,5,850,2.0,582.0,582.0
0.012,6,10,1990,5,911,3.0,643.0,643.0,5,1079,2.0,811.0,811.0
0.087,6,10,1506,5,395,17.0,127.0,127.0,5,1111,19.0,843.0,843.0
0.003,17,2,148,1,60,0.0,32.0,32.0,1,88,0.0,60.0,60.0
0.112,6,10,1506,5,395,26.0,127.0,127.0,5,1111,20.0,843.0,843.0
0.001,17,2,180,1,66,0.0,38.0,38.0,1,114,0.0,86.0,86.0
0.004,6,10,2006,5,927,1.0,659.0,659.0,5,1079,1.0,811.0,811.0
0.006,6,10,1547,5,764,1.0,496.0,496.0,5,783,1.0,515.0,515.0
0.015,6,10,1972,5,910,3.0,642.0,642.0,5,1062,3.0,794.0,794.0
0.006,6,10,1547,5,764,1.0,496.0,496.0,5,783,1.0,515.0,515.0
0.005,6,10,2006,5,927,1.0,659.0,659.0,5,1079,1.0,811.0,811.0
0.006,6,10,1547,5,764,1.0,496.0,496.0,5,783,1.0,515.0,515.0
0.004,6,10,1774,5,923,1.0,655.0,655.0,5,851,1.0,583.0,583.0
0.006,17,2,169,1,62,0.0,34.0,34.0,1,107,0.0,79.0,79.0
0.01,6,10,1762,5,911,2.0,643.0,643.0,5,851,2.0,583.0,583.0
0.016,6,10,1989,5,910,4.0,642.0,642.0,5,1079,3.0,811.0,811.0
0.005,6,10,1774,5,923,1.0,655.0,655.0,5,851,1.0,583.0,583.0
0.068,6,10,1506,5,395,16.0,127.0,127.0,5,1111,13.0,843.0,843.0
0.095,6,10,1506,5,395,21.0,127.0,127.0,5,1111,19.0,843.0,843.0
0.005,6,10,2006,5,927,1.0,659.0,659.0,5,1079,1.0,811.0,811.0
0.01,6,13,3735,7,497,1.0,125.0,125.0,6,3238,1.0,1470.0,1459.0
0.028,17,2,164,1,74,0.0,46.0,46.0,1,90,0.0,62.0,62.0
0.007,6,10,1643,5,860,1.0,592.0,592.0,5,783,1.0,515.0,515.0
30.058,6,17,6941,9,689,3757.0,209.0,209.0,8,6252,4293.0,1402.0,1165.0
0.084,6,10,1506,5,395,19.0,127.0,127.0,5,1111,18.0,843.0,843.0
40.064,17,10,676,5,460,10013.0,104.0,64.0,5,216,10014.0,20.0,15.0
0.008,17,2,148,1,60,0.0,32.0,32.0,1,88,0.0,60.0,60.0
40.064,17,10,676,5,460,10013.0,104.0,64.0,5,216,10014.0,20.0,15.0
0.006,6,10,1547,5,764,1.0,496.0,496.0,5,783,1.0,515.0,515.0
328.604,17,20,1124,10,716,36497.0,48.0,43.0,10,408,36497.0,20.0,12.0
0.005,17,2,179,1,71,0.0,43.0,43.0,1,108,0.0,80.0,80.0
0.015,6,10,1990,5,911,3.0,643.0,643.0,5,1079,3.0,811.0,811.0
0.004,6,10,1702,5,863,0.0,595.0,595.0,5,839,1.0,571.0,571.0
0.087,6,10,1506,5,395,19.0,127.0,127.0,5,1111,17.0,843.0,843.0
0.011,6,10,1989,5,910,2.0,642.0,642.0,5,1079,2.0,811.0,811.0
0.011,17,2,169,1,62,0.0,34.0,34.0,1,107,0.0,79.0,79.0
300.018,6,12,1782,7,1348,50003.0,494.0,494.0,5,434,75003.0,83.0,83.0
0.054,17,2,152,1,76,0.0,48.0,48.0,1,76,0.0,48.0,48.0
0.212,6,16,2777,8,1395,30.0,533.0,323.0,8,1382,19.0,529.0,239.0
40.06,17,10,676,5,460,10014.0,104.0,64.0,5,216,10014.0,20.0,15.0
0.009,6,13,3735,7,497,1.0,125.0,125.0,6,3238,1.0,1470.0,1459.0
15.075,17,11,4685,5,2265,3761.0,1350.0,425.0,6,2420,3009.0,1350.0,375.0
0.09,6,10,1506,5,395,20.0,127.0,127.0,5,1111,19.0,843.0,843.0
0.013,6,10,1983,5,910,3.0,642.0,642.0,5,1073,3.0,805.0,805.0
0.053,17,2,412,1,61,0.0,33.0,33.0,1,351,0.0,323.0,323.0
0.004,6,10,2007,5,928,1.0,660.0,660.0,5,1079,1.0,811.0,811.0
1777.914,17,144,45504,72,22752,25040.0,288.0,288.0,72,22752,25040.0,288.0,288.0
0.005,6,10,2007,5,928,1.0,660.0,660.0,5,1079,1.0,811.0,811.0
0.082,6,10,1506,5,395,19.0,127.0,127.0,5,1111,18.0,843.0,843.0
0.005,6,10,2007,5,928,1.0,660.0,660.0,5,1079,1.0,811.0,811.0
83.44,58,5,360,4,288,27813.0,24.0,24.0,1,72,0.0,24.0,24.0
352.286,6,20,2210,6,1308,12004.0,494.0,494.0,14,902,27098.0,83.0,83.0
0.005,6,10,2000,5,927,1.0,659.0,659.0,5,1073,1.0,805.0,805.0
300.026,6,12,1782,7,1348,50004.0,494.0,494.0,5,434,75005.0,83.0,83.0
0.007,6,13,3684,7,446,1.0,74.0,74.0,6,3238,1.0,1470.0,1459.0
0.005,6,10,1547,5,764,1.0,496.0,496.0,5,783,1.0,515.0,515.0
0.006,6,14,3799,7,509,1.0,137.0,137.0,7,3290,0.0,1448.0,972.0
0.014,6,10,1990,5,911,3.0,643.0,643.0,5,1079,3.0,811.0,811.0
0.004,6,10,1774,5,923,1.0,655.0,655.0,5,851,1.0,583.0,583.0
0.079,6,10,1506,5,395,15.0,127.0,127.0,5,1111,18.0,843.0,843.0
0.012,6,10,1983,5,910,3.0,642.0,642.0,5,1073,2.0,805.0,805.0
0.013,17,2,152,1,56,0.0,28.0,28.0,1,96,0.0,68.0,68.0
0.01,6,10,1762,5,911,2.0,643.0,643.0,5,851,2.0,583.0,583.0
15.086,17,16,8268,8,6121,2151.0,1350.0,737.0,8,2147,2151.0,1350.0,240.0
0.039,17,2,186,1,61,0.0,33.0,33.0,1,125,0.0,97.0,97.0
0.006,17,2,144,1,64,0.0,36.0,36.0,1,80,0.0,52.0,52.0
0.115,6,10,1506,5,395,26.0,127.0,127.0,5,1111,26.0,843.0,843.0
0.005,6,10,1774,5,923,1.0,655.0,655.0,5,851,1.0,583.0,583.0
0.013,6,10,1990,5,911,3.0,643.0,643.0,5,1079,3.0,811.0,811.0
0.009,6,10,1983,5,910,2.0,642.0,642.0,5,1073,2.0,805.0,805.0
0.005,6,10,1689,5,839,1.0,571.0,571.0,5,850,1.0,582.0,582.0
0.008,6,10,1972,5,910,1.0,642.0,642.0,5,1062,2.0,794.0,794.0
0.009,6,10,1983,5,910,2.0,642.0,642.0,5,1073,2.0,805.0,805.0
0.004,6,10,2000,5,927,1.0,659.0,659.0,5,1073,1.0,805.0,805.0
0.005,6,10,1779,5,928,1.0,660.0,660.0,5,851,1.0,583.0,583.0
240.094,6,30,9210,15,6716,17149.0,1839.0,660.0,15,2494,17149.0,580.0,213.0
0.006,6,10,1547,5,764,1.0,496.0,496.0,5,783,1.0,515.0,515.0
0.005,6,10,1854,5,889,1.0,621.0,621.0,5,965,1.0,697.0,697.0
0.008,6,10,1972,5,910,2.0,642.0,642.0,5,1062,1.0,794.0,794.0
0.083,6,10,1506,5,395,18.0,127.0,127.0,5,1111,19.0,843.0,843.0
11.178,17,28,4422,14,1995,847.0,270.0,114.0,14,2427,847.0,586.0,145.0
174.061,17,74,10413,37,2472,4834.0,44.0,38.0,37,7941,4834.0,239.0,186.0
170.184,17,74,10515,37,2466,4727.0,44.0,38.0,37,8049,4727.0,239.0,189.0
0.081,6,10,1506,5,395,19.0,127.0,127.0,5,1111,15.0,843.0,843.0
0.001,17,2,154,1,69,0.0,41.0,41.0,1,85,0.0,57.0,57.0
0.004,6,10,2007,5,928,1.0,660.0,660.0,5,1079,1.0,811.0,811.0
10.769,17,28,4422,14,1995,819.0,270.0,114.0,14,2427,819.0,586.0,145.0
0.005,17,2,140,1,62,0.0,34.0,34.0,1,78,0.0,50.0,50.0
0.105,6,10,1506,5,395,24.0,127.0,127.0,5,1111,21.0,843.0,843.0
0.005,17,2,179,1,71,0.0,43.0,43.0,1,108,0.0,80.0,80.0
0.013,6,10,1990,5,911,3.0,643.0,643.0,5,1079,3.0,811.0,811.0
0.001,17,2,174,1,72,0.0,44.0,44.0,1,102,0.0,74.0,74.0
0.005,6,10,1547,5,764,1.0,496.0,496.0,5,783,1.0,515.0,515.0
0.001,17,2,136,1,60,0.0,32.0,32.0,1,76,0.0,48.0,48.0
0.013,6,10,1972,5,910,3.0,642.0,642.0,5,1062,3.0,794.0,794.0
0.022,6,10,1983,5,910,5.0,642.0,642.0,5,1073,5.0,805.0,805.0
0.004,17,2,148,1,60,0.0,32.0,32.0,1,88,0.0,60.0,60.0
0.006,17,2,144,1,64,0.0,36.0,36.0,1,80,0.0,52.0,52.0
0.083,6,10,1506,5,395,18.0,127.0,127.0,5,1111,20.0,843.0,843.0
0.008,6,10,1989,5,910,2.0,642.0,642.0,5,1079,2.0,811.0,811.0
300.132,6,44,18282,23,12644,13634.0,4080.0,1461.0,21,5638,14998.0,2667.0,435.0
0.001,17,2,136,1,60,0.0,32.0,32.0,1,76,0.0,48.0,48.0
0.006,6,10,1547,5,764,1.0,496.0,496.0,5,783,1.0,515.0,515.0
0.005,6,10,2006,5,927,1.0,659.0,659.0,5,1079,1.0,811.0,811.0
146.177,6,26,9525,12,1627,82.0,794.0,367.0,14,7898,11234.0,1360.0,732.0
0.009,17,2,179,1,71,0.0,43.0,43.0,1,108,0.0,80.0,80.0
10.859,17,28,4422,14,1994,826.0,269.0,114.0,14,2428,826.0,587.0,145.0
0.015,6,10,1990,5,911,3.0,643.0,643.0,5,1079,3.0,811.0,811.0
0.014,6,10,1762,5,911,3.0,643.0,643.0,5,851,3.0,583.0,583.0
0.011,6,10,1989,5,910,2.0,642.0,642.0,5,1079,2.0,811.0,811.0
0.008,6,10,1990,5,911,2.0,643.0,643.0,5,1079,2.0,811.0,811.0
0.089,6,10,1506,5,395,20.0,127.0,127.0,5,1111,19.0,843.0,843.0
0.012,6,10,1972,5,910,3.0,642.0,642.0,5,1062,3.0,794.0,794.0
308.444,17,20,1124,10,716,34257.0,48.0,43.0,10,408,34257.0,20.0,12.0
0.041,17,2,144,1,64,0.0,36.0,36.0,1,80,0.0,52.0,52.0
300.395,6,16,2170,9,684,37527.0,146.0,146.0,7,1486,50036.0,419.0,398.0
0.004,17,2,208,1,72,0.0,44.0,44.0,1,136,0.0,108.0,108.0
0.14,6,10,1506,5,395,34.0,127.0,127.0,5,1111,33.0,843.0,843.0
0.073,6,10,1506,5,395,14.0,127.0,127.0,5,1111,16.0,843.0,843.0
0.004,6,10,2006,5,927,1.0,659.0,659.0,5,1079,1.0,811.0,811.0
0.004,17,2,148,1,60,0.0,32.0,32.0,1,88,0.0,60.0,60.0
0.005,6,10,1854,5,889,1.0,621.0,621.0,5,965,1.0,697.0,697.0
0.008,6,12,1926,6,1189,1.0,659.0,434.0,6,737,1.0,417.0,417.0
0.186,6,10,1506,5,395,43.0,127.0,127.0,5,1111,43.0,843.0,843.0
0.006,6,10,2006,5,927,1.0,659.0,659.0,5,1079,1.0,811.0,811.0
40.064,17,10,676,5,460,10015.0,104.0,64.0,5,216,10015.0,20.0,15.0
0.102,17,2,148,1,60,0.0,32.0,32.0,1,88,0.0,60.0,60.0
0.016,6,11,2042,6,963,3.0,643.0,643.0,5,1079,4.0,811.0,811.0
0.004,6,10,2000,5,927,1.0,659.0,659.0,5,1073,1.0,805.0,805.0
0.072,17,4,284,2,120,0.0,32.0,32.0,2,164,68.0,60.0,54.0
0.012,6,10,1677,5,827,3.0,559.0,559.0,5,850,2.0,582.0,582.0
0.091,6,10,1506,5,395,18.0,127.0,127.0,5,1111,20.0,843.0,843.0
40.055,17,10,676,5,460,10012.0,104.0,64.0,5,216,10013.0,20.0,15.0
0.006,17,2,166,1,75,0.0,47.0,47.0,1,91,0.0,63.0,63.0
0.081,6,10,1506,5,395,18.0,127.0,127.0,5,1111,18.0,843.0,843.0
0.07,6,10,1506,5,395,14.0,127.0,127.0,5,1111,15.0,843.0,843.0
0.008,6,10,1972,5,910,2.0,642.0,642.0,5,1062,1.0,794.0,794.0
0.012,6,10,1989,5,910,2.0,642.0,642.0,5,1079,2.0,811.0,811.0
0.082,6,10,1506,5,395,19.0,127.0,127.0,5,1111,18.0,843.0,843.0
300.328,6,16,2170,9,684,37519.0,146.0,146.0,7,1486,50026.0,419.0,398.0
0.127,17,2,146,1,65,0.0,37.0,37.0,1,81,0.0,53.0,53.0
9.004,6,39,10487,20,4929,473.0,1360.0,682.0,19,5558,488.0,2667.0,435.0
0.013,6,10,1989,5,910,3.0,642.0,642.0,5,1079,3.0,811.0,811.0
40.057,17,10,676,5,460,10013.0,104.0,64.0,5,216,10013.0,20.0,15.0
0.006,17,2,170,1,65,0.0,37.0,37.0,1,105,0.0,77.0,77.0
166.299,17,68,9673,34,2274,5039.0,44.0,38.0,34,7399,5039.0,261.0,189.0
0.009,6,10,1990,5,911,2.0,643.0,643.0,5,1079,2.0,811.0,811.0
40.064,17,10,676,5,460,10014.0,104.0,64.0,5,216,10015.0,20.0,15.0
0.02,6,10,1972,5,910,5.0,642.0,642.0,5,1062,4.0,794.0,794.0
0.148,6,10,1506,5,395,31.0,127.0,127.0,5,1111,34.0,843.0,843.0
0.006,17,2,164,1,74,0.0,46.0,46.0,1,90,0.0,62.0,62.0
0.023,6,10,1989,5,910,5.0,642.0,642.0,5,1079,5.0,811.0,811.0
0.86,6,22,5168,11,1138,73.0,267.0,115.0,11,4030,73.0,1414.0,597.0
0.08,6,10,1506,5,395,18.0,127.0,127.0,5,1111,14.0,843.0,843.0
0.009,6,10,1989,5,910,2.0,642.0,642.0,5,1079,2.0,811.0,811.0
0.012,6,10,1989,5,910,3.0,642.0,642.0,5,1079,2.0,811.0,811.0
0.001,17,2,136,1,60,0.0,32.0,32.0,1,76,0.0,48.0,48.0
0.069,6,10,1506,5,395,15.0,127.0,127.0,5,1111,15.0,843.0,843.0
10.942,17,28,4422,14,1994,832.0,269.0,114.0,14,2428,832.0,587.0,145.0
0.011,6,13,3735,7,497,1.0,125.0,125.0,6,3238,2.0,1470.0,1459.0
309.009,17,20,1124,10,716,34320.0,48.0,43.0,10,408,34321.0,20.0,12.0
0.006,6,10,1547,5,764,1.0,496.0,496.0,5,783,1.0,515.0,515.0
0.005,17,2,144,1,64,0.0,36.0,36.0,1,80,0.0,52.0,52.0
0.124,6,10,1506,5,395,24.0,127.0,127.0,5,1111,24.0,843.0,843.0
0.006,17,2,170,1,65,0.0,37.0,37.0,1,105,0.0,77.0,77.0
0.001,17,2,294,1,64,0.0,36.0,36.0,1,230,0.0,202.0,202.0
0.003,17,2,148,1,60,0.0,32.0,32.0,1,88,0.0,60.0,60.0
0.013,6,10,1990,5,911,3.0,643.0,643.0,5,1079,3.0,811.0,811.0
0.22,6,16,2782,8,1400,31.0,533.0,325.0,8,1382,19.0,529.0,239.0
377.445,6,22,2313,16,867,25163.0,195.0,195.0,6,1446,4637.0,419.0,398.0
0.087,6,10,1506,5,395,21.0,127.0,127.0,5,1111,19.0,843.0,843.0
0.006,6,10,1989,5,910,1.0,642.0,642.0,5,1079,1.0,811.0,811.0
10.914,17,28,4421,14,1993,830.0,268.0,114.0,14,2428,830.0,587.0,145.0
0.013,6,10,1990,5,911,3.0,643.0,643.0,5,1079,3.0,811.0,811.0
0.006,6,12,1698,6,863,1.0,327.0,271.0,6,835,1.0,515.0,515.0
0.006,6,10,1854,5,889,1.0,621.0,621.0,5,965,1.0,697.0,697.0
240.087,6,16,4482,9,963,30010.0,238.0,166.0,7,3519,40014.0,1402.0,786.0
0.008,6,10,1990,5,911,2.0,643.0,643.0,5,1079,2.0,811.0,811.0
40.086,17,10,676,5,460,10020.0,104.0,64.0,5,216,10020.0,20.0,15.0
10.753,17,28,4422,14,1995,818.0,270.0,114.0,14,2427,818.0,586.0,145.0
0.005,6,10,1989,5,927,1.0,659.0,659.0,5,1062,1.0,794.0,794.0
0.006,6,10,1547,5,764,1.0,496.0,496.0,5,783,1.0,515.0,515.0
0.012,6,10,1989,5,910,3.0,642.0,642.0,5,1079,3.0,811.0,811.0
0.005,6,10,2006,5,927,1.0,659.0,659.0,5,1079,1.0,811.0,811.0
0.041,17,2,152,1,76,0.0,48.0,48.0,1,76,0.0,48.0,48.0
0.006,6,10,1989,5,927,1.0,659.0,659.0,5,1062,1.0,794.0,794.0
0.016,6,10,1989,5,910,3.0,642.0,642.0,5,1079,4.0,811.0,811.0
40.06,17,10,676,5,460,10012.0,104.0,64.0,5,216,10014.0,20.0,15.0
0.005,17,2,180,1,58,0.0,30.0,30.0,1,122,0.0,94.0,94.0
0.01,6,10,1972,5,910,2.0,642.0,642.0,5,1062,2.0,794.0,794.0
0.004,17,2,148,1,60,0.0,32.0,32.0,1,88,0.0,60.0,60.0
40.052,17,10,676,5,460,10012.0,104.0,64.0,5,216,10012.0,20.0,15.0
0.016,6,10,1989,5,910,4.0,642.0,642.0,5,1079,3.0,811.0,811.0
0.005,6,10,2000,5,927,1.0,659.0,659.0,5,1073,1.0,805.0,805.0
0.001,17,2,180,1,66,0.0,38.0,38.0,1,114,0.0,86.0,86.0
0.093,6,10,1506,5,395,22.0,127.0,127.0,5,1111,21.0,843.0,843.0
0.006,6,10,1643,5,860,1.0,592.0,592.0,5,783,1.0,515.0,515.0
0.004,6,10,1702,5,863,1.0,595.0,595.0,5,839,0.0,571.0,571.0
0.011,6,10,1989,5,910,2.0,642.0,642.0,5,1079,2.0,811.0,811.0
280.699,6,23,6075,10,1186,31188.0,267.0,156.0,13,4889,23374.0,1400.0,873.0
0.004,6,10,2007,5,928,1.0,660.0,660.0,5,1079,1.0,811.0,811.0
0.005,6,10,2000,5,927,1.0,659.0,659.0,5,1073,1.0,805.0,805.0
15.309,17,17,9466,8,4356,2183.0,1350.0,516.0,9,5110,1910.0,1350.0,539.0
0.081,6,10,1506,5,395,17.0,127.0,127.0,5,1111,18.0,843.0,843.0
0.014,6,10,1972,5,910,3.0,642.0,642.0,5,1062,3.0,794.0,794.0
0.012,6,10,1989,5,910,3.0,642.0,642.0,5,1079,2.0,811.0,811.0
0.037,17,2,152,1,76,0.0,48.0,48.0,1,76,0.0,48.0,48.0
0.098,6,10,1506,5,395,22.0,127.0,127.0,5,1111,24.0,843.0,843.0
9.037,17,6,376,5,280,2259.0,28.0,28.0,1,96,0.0,68.0,68.0
0.005,6,10,1689,5,839,1.0,571.0,571.0,5,850,1.0,582.0,582.0
0.005,6,10,1689,5,839,1.0,571.0,571.0,5,850,1.0,582.0,582.0
0.021,6,10,1677,5,827,5.0,559.0,559.0,5,850,5.0,582.0,582.0
0.006,17,2,240,1,61,0.0,33.0,33.0,1,179,0.0,151.0,151.0
0.078,6,10,1506,5,395,17.0,127.0,127.0,5,1111,16.0,843.0,843.0
0.157,6,10,1506,5,395,33.0,127.0,127.0,5,1111,37.0,843.0,843.0
0.824,6,25,5555,12,1445,64.0,267.0,136.0,13,4110,58.0,1414.0,597.0
0.012,6,10,1972,5,910,3.0,642.0,642.0,5,1062,2.0,794.0,794.0
0.011,6,10,1989,5,910,2.0,642.0,642.0,5,1079,2.0,811.0,811.0
0.117,6,10,1506,5,395,26.0,127.0,127.0,5,1111,26.0,843.0,843.0
293.085,6,323,344530,123,17954,2402.0,2736.0,889.0,200,326576,1472.0,2804.0,1699.0
40.072,17,10,676,5,460,10015.0,104.0,64.0,5,216,10017.0,20.0,15.0
0.012,6,14,3787,7,497,2.0,125.0,125.0,7,3290,2.0,1448.0,972.0
0.01,6,10,1972,5,910,2.0,642.0,642.0,5,1062,2.0,794.0,794.0
0.004,6,10,2006,5,927,1.0,659.0,659.0,5,1079,1.0,811.0,811.0
0.953,6,25,8339,14,1955,73.0,1020.0,340.0,11,6384,78.0,2720.0,988.0
0.008,6,10,1677,5,827,2.0,559.0,559.0,5,850,1.0,582.0,582.0
0.003,17,2,132,1,58,0.0,30.0,30.0,1,74,0.0,46.0,46.0
0.039,17,2,152,1,76,0.0,48.0,48.0,1,76,0.0,48.0,48.0
0.008,6,10,1983,5,910,2.0,642.0,642.0,5,1073,1.0,805.0,805.0
0.088,6,10,1506,5,395,18.0,127.0,127.0,5,1111,19.0,843.0,843.0
0.071,6,10,1506,5,395,14.0,127.0,127.0,5,1111,17.0,843.0,843.0
0.012,6,13,3735,7,497,2.0,125.0,125.0,6,3238,2.0,1470.0,1459.0
0.017,6,10,1972,5,910,4.0,642.0,642.0,5,1062,4.0,794.0,794.0
0.012,6,13,3735,7,497,2.0,125.0,125.0,6,3238,2.0,1470.0,1459.0
0.009,6,14,3787,7,497,1.0,125.0,125.0,7,3290,1.0,1448.0,972.0
32.362,6,59,28226,31,22034,315.0,2720.0,1482.0,28,6192,1192.0,2667.0,361.0
0.006,6,10,1547,5,764,1.0,496.0,496.0,5,783,1.0,515.0,515.0
0.005,6,13,3690,7,452,0.0,80.0,80.0,6,3238,1.0,1470.0,1459.0
0.066,17,8,3613,4,1874,22.0,1350.0,440.0,4,1739,11.0,1350.0,406.0
0.105,6,10,1506,5,395,24.0,127.0,127.0,5,1111,23.0,843.0,843.0
0.005,6,10,1547,5,764,1.0,496.0,496.0,5,783,1.0,515.0,515.0
0.099,6,10,1506,5,395,20.0,127.0,127.0,5,1111,22.0,843.0,843.0
0.004,6,10,2007,5,928,1.0,660.0,660.0,5,1079,1.0,811.0,811.0
0.059,17,2,152,1,76,0.0,48.0,48.0,1,76,0.0,48.0,48.0
284.166,6,28,6633,13,1573,23680.0,267.0,174.0,15,5060,20296.0,1400.0,742.0
0.005,6,10,1689,5,839,1.0,571.0,571.0,5,850,1.0,582.0,582.0
0.014,6,10,1762,5,911,3.0,643.0,643.0,5,851,3.0,583.0,583.0
0.011,6,10,1990,5,911,2.0,643.0,643.0,5,1079,2.0,811.0,811.0
178.52,17,84,12128,42,2829,4354.0,44.0,39.0,42,9299,4354.0,260.0,193.0
40.098,17,10,676,5,460,10021.0,104.0,64.0,5,216,10023.0,20.0,15.0
1791.256,6,66,7460,44,4585,41657.0,1402.0,103.0,22,2875,85290.0,1111.0,82.0
0.07,17,8,3613,4,1874,23.0,1350.0,440.0,4,1739,12.0,1350.0,406.0
0.006,6,10,1547,5,764,1.0,496.0,496.0,5,783,1.0,515.0,515.0
0.093,6,10,1506,5,395,21.0,127.0,127.0,5,1111,22.0,843.0,843.0
0.005,6,10,2006,5,927,1.0,659.0,659.0,5,1079,1.0,811.0,811.0
1778.372,17,143,41496,72,22752,25047.0,288.0,288.0,71,18744,25405.0,236.0,236.0
0.009,6,10,1990,5,911,2.0,643.0,643.0,5,1079,2.0,811.0,811.0
327.376,17,20,1124,10,716,36360.0,48.0,43.0,10,408,36360.0,20.0,12.0
0.219,6,16,2777,8,1395,31.0,533.0,323.0,8,1382,20.0,529.0,239.0
0.169,17,2,152,1,76,0.0,48.0,48.0,1,76,0.0,48.0,48.0
0.017,6,10,1989,5,910,4.0,642.0,642.0,5,1079,4.0,811.0,811.0
0.016,6,10,1989,5,910,4.0,642.0,642.0,5,1079,3.0,811.0,811.0
171.334,17,82,11680,41,2736,4283.0,44.0,38.0,41,8944,4283.0,261.0,190.0
0.04,17,2,136,1,60,0.0,32.0,32.0,1,76,0.0,48.0,48.0
0.072,6,10,1506,5,395,16.0,127.0,127.0,5,1111,16.0,843.0,843.0
0.004,17,2,148,1,60,0.0,32.0,32.0,1,88,0.0,60.0,60.0
0.003,17,2,136,1,60,0.0,32.0,32.0,1,76,0.0,48.0,48.0
40.06,17,10,676,5,460,10014.0,104.0,64.0,5,216,10014.0,20.0,15.0
0.001,17,2,180,1,66,0.0,38.0,38.0,1,114,0.0,86.0,86.0
0.015,6,10,1989,5,910,3.0,642.0,642.0,5,1079,3.0,811.0,811.0
0.005,6,10,2007,5,928,1.0,660.0,660.0,5,1079,1.0,811.0,811.0
0.04,17,2,234,1,61,0.0,33.0,33.0,1,173,0.0,145.0,145.0
0.168,6,10,1506,5,395,39.0,127.0,127.0,5,1111,40.0,843.0,843.0
0.012,6,10,1983,5,910,3.0,642.0,642.0,5,1073,2.0,805.0,805.0
179.13,17,76,10848,38,2536,4841.0,44.0,38.0,38,8312,4841.0,279.0,190.0
0.1,6,10,1506,5,395,22.0,127.0,127.0,5,1111,22.0,843.0,843.0
0.064,6,10,1506,5,395,13.0,127.0,127.0,5,1111,15.0,843.0,843.0
15.216,17,21,9272,10,6720,1687.0,1350.0,644.0,11,2552,1518.0,1350.0,204.0
364.939,6,27,5001,15,2531,26067.0,676.0,348.0,12,2470,27716.0,821.0,306.0
9.037,17,6,376,5,280,2259.0,28.0,28.0,1,96,0.0,68.0,68.0
377.314,6,22,2313,16,867,25154.0,195.0,195.0,6,1446,4644.0,419.0,398.0
0.016,6,10,1972,5,910,4.0,642.0,642.0,5,1062,4.0,794.0,794.0
0.082,6,10,1506,5,395,15.0,127.0,127.0,5,1111,18.0,843.0,843.0
240.356,6,33,9270,16,1836,16023.0,624.0,199.0,17,7434,15022.0,1402.0,595.0
0.003,17,2,136,1,60,0.0,32.0,32.0,1,76,0.0,48.0,48.0
0.009,6,10,1631,5,848,2.0,580.0,580.0,5,783,2.0,515.0,515.0
0.096,6,10,1506,5,395,20.0,127.0,127.0,5,1111,21.0,843.0,843.0
0.013,6,10,1989,5,910,3.0,642.0,642.0,5,1079,3.0,811.0,811.0
0.006,6,10,1689,5,839,1.0,571.0,571.0,5,850,1.0,582.0,582.0
0.001,17,2,180,1,66,0.0,38.0,38.0,1,114,0.0,86.0,86.0
0.011,6,10,1972,5,910,2.0,642.0,642.0,5,1062,2.0,794.0,794.0
15.352,17,41,20162,22,17085,729.0,1350.0,748.0,19,3077,851.0,1350.0,133.0
240.091,6,31,9002,15,6529,17149.0,1654.0,639.0,16,2473,16005.0,580.0,204.0
0.018,6,10,1762,5,911,4.0,643.0,643.0,5,851,4.0,583.0,583.0
0.077,6,10,1506,5,395,17.0,127.0,127.0,5,1111,18.0,843.0,843.0
0.001,17,2,136,1,60,0.0,32.0,32.0,1,76,0.0,48.0,48.0
0.006,6,10,1547,5,764,1.0,496.0,496.0,5,783,1.0,515.0,515.0
0.013,6,10,1990,5,911,3.0,643.0,643.0,5,1079,3.0,811.0,811.0
0.013,6,10,1989,5,910,3.0,642.0,642.0,5,1079,3.0,811.0,811.0
0.005,17,2,154,1,69,0.0,41.0,41.0,1,85,0.0,57.0,57.0
0.017,6,10,1989,5,910,4.0,642.0,642.0,5,1079,4.0,811.0,811.0
0.007,6,14,3799,7,509,1.0,137.0,137.0,7,3290,1.0,1448.0,972.0
40.063,17,10,676,5,460,10014.0,104.0,64.0,5,216,10014.0,20.0,15.0
0.012,6,10,1989,5,910,2.0,642.0,642.0,5,1079,2.0,811.0,811.0
0.004,17,2,136,1,60,0.0,32.0,32.0,1,76,0.0,48.0,48.0
0.004,17,2,140,1,62,0.0,34.0,34.0,1,78,0.0,50.0,50.0
0.004,6,10,2006,5,927,1.0,659.0,659.0,5,1079,1.0,811.0,811.0
0.111,6,10,1506,5,395,26.0,127.0,127.0,5,1111,25.0,843.0,843.0
0.006,6,10,1989,5,927,1.0,659.0,659.0,5,1062,1.0,794.0,794.0
0.014,6,10,1677,5,827,3.0,559.0,559.0,5,850,3.0,582.0,582.0
0.01,6,12,1926,6,1189,1.0,659.0,434.0,6,737,1.0,417.0,417.0
0.008,17,2,148,1,60,0.0,32.0,32.0,1,88,0.0,60.0,60.0
176.185,17,88,12656,44,2961,4097.0,44.0,39.0,44,9695,4097.0,239.0,192.0
0.146,6,10,1506,5,395,36.0,127.0,127.0,5,1111,33.0,843.0,843.0
0.01,6,10,1990,5,911,2.0,643.0,643.0,5,1079,2.0,811.0,811.0
40.063,17,10,676,5,460,10014.0,104.0,64.0,5,216,10014.0,20.0,15.0
0.004,6,10,1702,5,863,1.0,595.0,595.0,5,839,0.0,571.0,571.0
0.004,6,10,1702,5,863,0.0,595.0,595.0,5,839,1.0,571.0,571.0
0.071,17,2,156,1,64,0.0,36.0,36.0,1,92,0.0,64.0,64.0
0.004,6,10,1989,5,927,1.0,659.0,659.0,5,1062,1.0,794.0,794.0
0.007,6,10,1689,5,839,1.0,571.0,571.0,5,850,1.0,582.0,582.0
0.005,6,10,2006,5,927,1.0,659.0,659.0,5,1079,1.0,811.0,811.0
0.009,6,10,1762,5,911,2.0,643.0,643.0,5,851,2.0,583.0,583.0
0.071,17,2,136,1,60,0.0,32.0,32.0,1,76,0.0,48.0,48.0
0.005,6,13,3690,7,452,0.0,80.0,80.0,6,3238,1.0,1470.0,1459.0
0.007,17,2,179,1,71,0.0,43.0,43.0,1,108,0.0,80.0,80.0
0.038,17,4,284,2,120,0.0,32.0,32.0,2,164,34.0,60.0,54.0
0.01,6,10,1990,5,911,2.0,643.0,643.0,5,1079,2.0,811.0,811.0
0.005,6,13,3747,7,509,0.0,137.0,137.0,6,3238,1.0,1470.0,1459.0
15.071,17,15,9238,8,6902,2149.0,1350.0,834.0,7,2336,2506.0,1350.0,305.0
15.078,17,16,8168,8,6057,2149.0,1350.0,729.0,8,2111,2149.0,1350.0,235.0
0.008,17,2,160,1,72,0.0,44.0,44.0,1,88,0.0,60.0,60.0
0.009,6,10,1972,5,910,2.0,642.0,642.0,5,1062,2.0,794.0,794.0
0.004,6,10,2007,5,928,1.0,660.0,660.0,5,1079,1.0,811.0,811.0
0.001,17,2,180,1,66,0.0,38.0,38.0,1,114,0.0,86.0,86.0
0.022,6,10,1972,5,910,5.0,642.0,642.0,5,1062,5.0,794.0,794.0
0.007,6,10,1547,5,764,1.0,496.0,496.0,5,783,1.0,515.0,515.0
0.003,17,2,148,1,60,0.0,32.0,32.0,1,88,0.0,60.0,60.0
0.006,6,13,3747,7,509,1.0,137.0,137.0,6,3238,1.0,1470.0,1459.0
0.005,6,10,2007,5,928,1.0,660.0,660.0,5,1079,1.0,811.0,811.0
0.038,17,2,184,1,61,0.0,33.0,33.0,1,123,0.0,95.0,95.0
0.005,6,10,1774,5,923,1.0,655.0,655.0,5,851,1.0,583.0,583.0
0.004,17,2,148,1,60,0.0,32.0,32.0,1,88,0.0,60.0,60.0
0.107,6,10,1506,5,395,24.0,127.0,127.0,5,1111,24.0,843.0,843.0
0.006,17,2,170,1,65,0.0,37.0,37.0,1,105,0.0,77.0,77.0
0.011,6,10,2006,5,927,2.0,659.0,659.0,5,1079,2.0,811.0,811.0
0.01,6,10,1972,5,910,2.0,642.0,642.0,5,1062,2.0,794.0,794.0
0.138,6,10,1506,5,395,31.0,127.0,127.0,5,1111,29.0,843.0,843.0
271.856,6,16,4954,8,2045,38831.0,585.0,405.0,8,2909,38831.0,1402.0,832.0
0.004,6,10,2000,5,927,1.0,659.0,659.0,5,1073,1.0,805.0,805.0
300.385,6,16,2170,9,684,37527.0,146.0,146.0,7,1486,50037.0,419.0,398.0
0.006,17,2,179,1,71,0.0,43.0,43.0,1,108,0.0,80.0,80.0
0.006,17,2,169,1,62,0.0,34.0,34.0,1,107,0.0,79.0,79.0
0.072,17,2,412,1,61,0.0,33.0,33.0,1,351,0.0,323.0,323.0
0.113,6,10,1506,5,395,25.0,127.0,127.0,5,1111,24.0,843.0,843.0
1744.231,6,64,7360,42,4484,42542.0,1640.0,109.0,22,2876,83050.0,1112.0,82.0
0.006,6,10,1989,5,927,1.0,659.0,659.0,5,1062,1.0,794.0,794.0
0.015,6,10,1972,5,910,3.0,642.0,642.0,5,1062,3.0,794.0,794.0
0.076,6,10,1506,5,395,17.0,127.0,127.0,5,1111,16.0,843.0,843.0
0.01,6,10,1989,5,910,2.0,642.0,642.0,5,1079,2.0,811.0,811.0
0.07,6,10,1506,5,395,15.0,127.0,127.0,5,1111,13.0,843.0,843.0
0.005,6,14,3799,7,509,0.0,137.0,137.0,7,3290,0.0,1448.0,972.0
0.083,6,10,1506,5,395,19.0,127.0,127.0,5,1111,19.0,843.0,843.0
0.011,6,10,1972,5,910,2.0,642.0,642.0,5,1062,2.0,794.0,794.0
0.006,6,10,1643,5,860,1.0,592.0,592.0,5,783,1.0,515.0,515.0
40.097,17,10,676,5,460,10021.0,104.0,64.0,5,216,10023.0,20.0,15.0
0.005,6,10,1989,5,927,1.0,659.0,659.0,5,1062,1.0,794.0,794.0
0.119,6,10,1506,5,395,26.0,127.0,127.0,5,1111,26.0,843.0,843.0
0.012,6,10,1677,5,827,2.0,559.0,559.0,5,850,3.0,582.0,582.0
0.015,6,10,1990,5,911,3.0,643.0,643.0,5,1079,3.0,811.0,811.0
0.004,6,10,1774,5,923,1.0,655.0,655.0,5,851,1.0,583.0,583.0
0.009,6,10,1972,5,910,2.0,642.0,642.0,5,1062,2.0,794.0,794.0
0.016,6,10,1972,5,910,4.0,642.0,642.0,5,1062,4.0,794.0,794.0
0.001,17,2,180,1,66,0.0,38.0,38.0,1,114,0.0,86.0,86.0
0.005,6,10,1779,5,928,1.0,660.0,660.0,5,851,1.0,583.0,583.0
0.005,6,14,3799,7,509,0.0,137.0,137.0,7,3290,0.0,1448.0,972.0
0.013,6,10,2006,5,927,3.0,659.0,659.0,5,1079,3.0,811.0,811.0
0.001,17,2,180,1,66,0.0,38.0,38.0,1,114,0.0,86.0,86.0
0.023,6,14,3787,7,497,3.0,125.0,125.0,7,3290,3.0,1448.0,972.0
0.016,6,10,1989,5,910,3.0,642.0,642.0,5,1079,3.0,811.0,811.0
0.003,17,2,136,1,60,0.0,32.0,32.0,1,76,0.0,48.0,48.0
11.17,17,28,4424,14,1995,846.0,270.0,114.0,14,2429,846.0,588.0,145.0
164.061,17,74,10507,37,2481,4557.0,44.0,39.0,37,8026,4557.0,239.0,188.0
0.014,6,10,1989,5,910,3.0,642.0,642.0,5,1079,3.0,811.0,811.0
0.013,6,10,1972,5,910,3.0,642.0,642.0,5,1062,3.0,794.0,794.0
0.014,6,10,1989,5,910,3.0,642.0,642.0,5,1079,3.0,811.0,811.0
0.013,6,13,3735,7,497,2.0,125.0,125.0,6,3238,2.0,1470.0,1459.0
0.014,6,10,1990,5,911,3.0,643.0,643.0,5,1079,3.0,811.0,811.0
0.004,6,10,1702,5,863,0.0,595.0,595.0,5,839,1.0,571.0,571.0
0.015,6,10,1762,5,911,3.0,643.0,643.0,5,851,3.0,583.0,583.0
0.009,17,2,179,1,71,0.0,43.0,43.0,1,108,0.0,80.0,80.0
0.003,17,2,148,1,60,0.0,32.0,32.0,1,88,0.0,60.0,60.0
0.076,6,10,1506,5,395,17.0,127.0,127.0,5,1111,17.0,843.0,843.0
0.001,17,2,180,1,66,0.0,38.0,38.0,1,114,0.0,86.0,86.0
0.013,17,2,152,1,56,0.0,28.0,28.0,1,96,0.0,68.0,68.0
0.01,6,10,1989,5,910,2.0,642.0,642.0,5,1079,2.0,811.0,811.0
45.403,6,44,17108,23,11470,409.0,2720.0,1168.0,21,5638,2261.0,2667.0,435.0
0.006,17,2,193,1,71,0.0,43.0,43.0,1,122,0.0,94.0,94.0
0.013,6,10,1983,5,910,3.0,642.0,642.0,5,1073,3.0,805.0,805.0
1770.847,6,81,4266,41,2159,44270.0,27.0,27.0,40,2107,45405.0,27.0,27.0
166.494,17,80,11997,40,2693,4268.0,44.0,39.0,40,9304,4269.0,279.0,204.0
175.463,17,72,9976,36,2388,5013.0,44.0,38.0,36,7588,5013.0,249.0,182.0
0.011,6,10,1762,5,911,2.0,643.0,643.0,5,851,2.0,583.0,583.0
0.017,6,10,1989,5,910,4.0,642.0,642.0,5,1079,4.0,811.0,811.0
0.225,6,16,2668,8,1394,32.0,533.0,323.0,8,1274,21.0,529.0,212.0
0.006,6,10,2007,5,928,1.0,660.0,660.0,5,1079,1.0,811.0,811.0
0.012,6,14,3787,7,497,2.0,125.0,125.0,7,3290,1.0,1448.0,972.0
0.001,17,2,136,1,60,0.0,32.0,32.0,1,76,0.0,48.0,48.0
0.106,6,10,1506,5,395,22.0,127.0,127.0,5,1111,23.0,843.0,843.0
0.068,6,10,1506,5,395,15.0,127.0,127.0,5,1111,14.0,843.0,843.0
0.011,6,10,1972,5,910,2.0,642.0,642.0,5,1062,2.0,794.0,794.0
0.097,6,10,1506,5,395,22.0,127.0,127.0,5,1111,20.0,843.0,843.0
0.013,6,10,1989,5,910,3.0,642.0,642.0,5,1079,3.0,811.0,811.0
0.004,6,10,2007,5,928,1.0,660.0,660.0,5,1079,1.0,811.0,811.0
0.005,6,10,2007,5,928,1.0,660.0,660.0,5,1079,1.0,811.0,811.0
0.129,6,10,1506,5,395,30.0,127.0,127.0,5,1111,29.0,843.0,843.0
0.004,17,2,148,1,60,0.0,32.0,32.0,1,88,0.0,60.0,60.0
280.46,6,23,6075,10,1186,31162.0,267.0,156.0,13,4889,23370.0,1400.0,873.0
0.026,6,10,1989,5,910,6.0,642.0,642.0,5,1079,6.0,811.0,811.0
0.012,6,10,1631,5,848,2.0,580.0,580.0,5,783,2.0,515.0,515.0
240.092,6,16,4481,9,963,30011.0,238.0,166.0,7,3518,40014.0,1402.0,786.0
40.059,17,10,676,5,460,10013.0,104.0,64.0,5,216,10013.0,20.0,15.0
0.005,6,10,2006,5,927,1.0,659.0,659.0,5,1079,1.0,811.0,811.0
0.009,6,10,1989,5,910,2.0,642.0,642.0,5,1079,2.0,811.0,811.0
0.006,6,10,1547,5,764,1.0,496.0,496.0,5,783,1.0,515.0,515.0
0.004,6,10,1989,5,927,1.0,659.0,659.0,5,1062,1.0,794.0,794.0
0.009,6,10,1972,5,910,2.0,642.0,642.0,5,1062,2.0,794.0,794.0
0.005,6,10,2006,5,927,1.0,659.0,659.0,5,1079,1.0,811.0,811.0
0.006,6,10,1689,5,839,1.0,571.0,571.0,5,850,1.0,582.0,582.0
0.011,6,10,1972,5,910,2.0,642.0,642.0,5,1062,2.0,794.0,794.0
0.067,6,10,1506,5,395,15.0,127.0,127.0,5,1111,16.0,843.0,843.0
0.001,17,2,136,1,60,0.0,32.0,32.0,1,76,0.0,48.0,48.0
0.006,6,10,1547,5,764,1.0,496.0,496.0,5,783,1.0,515.0,515.0
0.091,6,10,1506,5,395,21.0,127.0,127.0,5,1111,19.0,843.0,843.0
0.173,6,3,453,2,321,173.0,241.0,241.0,1,132,0.0,92.0,92.0
0.009,6,10,1989,5,910,2.0,642.0,642.0,5,1079,2.0,811.0,811.0
0.01,17,2,194,1,59,0.0,31.0,31.0,1,135,0.0,107.0,107.0
0.004,17,2,136,1,60,0.0,32.0,32.0,1,76,0.0,48.0,48.0
0.009,6,13,3735,7,497,1.0,125.0,125.0,6,3238,1.0,1470.0,1459.0
0.107,6,10,1506,5,395,21.0,127.0,127.0,5,1111,24.0,843.0,843.0
0.011,6,10,1990,5,911,2.0,643.0,643.0,5,1079,2.0,811.0,811.0
40.062,17,10,676,5,460,10014.0,104.0,64.0,5,216,10014.0,20.0,15.0
178.072,17,76,10938,38,2533,4812.0,44.0,38.0,38,8405,4812.0,258.0,193.0
40.061,17,10,676,5,460,10014.0,104.0,64.0,5,216,10014.0,20.0,15.0
0.103,6,10,1506,5,395,22.0,127.0,127.0,5,1111,23.0,843.0,843.0
40.057,17,10,676,5,460,10013.0,104.0,64.0,5,216,10013.0,20.0,15.0
0.023,6,10,1989,5,910,5.0,642.0,642.0,5,1079,5.0,811.0,811.0
0.001,17,2,180,1,66,0.0,38.0,38.0,1,114,0.0,86.0,86.0
0.004,6,10,1774,5,923,1.0,655.0,655.0,5,851,1.0,583.0,583.0
15.073,17,14,9190,8,6902,2149.0,1350.0,834.0,6,2288,3008.0,1350.0,353.0
0.01,6,12,1926,6,1189,2.0,659.0,434.0,6,737,1.0,417.0,417.0
40.056,17,10,676,5,460,10013.0,104.0,64.0,5,216,10013.0,20.0,15.0
0.005,17,2,170,1,65,0.0,37.0,37.0,1,105,0.0,77.0,77.0
0.02,6,11,1683,6,900,4.0,580.0,580.0,5,783,4.0,515.0,515.0
0.021,6,10,1762,5,911,5.0,643.0,643.0,5,851,5.0,583.0,583.0
0.005,6,10,2006,5,927,1.0,659.0,659.0,5,1079,1.0,811.0,811.0
0.11,6,10,1506,5,395,24.0,127.0,127.0,5,1111,21.0,843.0,843.0
0.01,6,10,1689,5,839,2.0,571.0,571.0,5,850,2.0,582.0,582.0
0.006,17,2,170,1,65,0.0,37.0,37.0,1,105,0.0,77.0,77.0
0.006,6,10,1547,5,764,1.0,496.0,496.0,5,783,1.0,515.0,515.0
0.004,17,2,148,1,60,0.0,32.0,32.0,1,88,0.0,60.0,60.0
0.005,6,10,1989,5,927,1.0,659.0,659.0,5,1062,1.0,794.0,794.0
0.104,6,10,1506,5,395,21.0,127.0,127.0,5,1111,24.0,843.0,843.0
0.013,6,10,1989,5,910,3.0,642.0,642.0,5,1079,3.0,811.0,811.0
0.003,17,2,148,1,60,0.0,32.0,32.0,1,88,0.0,60.0,60.0
0.005,6,10,1989,5,927,1.0,659.0,659.0,5,1062,1.0,794.0,794.0
308.258,17,20,1124,10,716,34235.0,48.0,43.0,10,408,34237.0,20.0,12.0
0.008,6,10,1989,5,910,2.0,642.0,642.0,5,1079,2.0,811.0,811.0
0.059,6,10,1506,5,395,13.0,127.0,127.0,5,1111,13.0,843.0,843.0
0.013,6,10,1990,5,911,3.0,643.0,643.0,5,1079,3.0,811.0,811.0
0.005,6,10,1989,5,927,1.0,659.0,659.0,5,1062,1.0,794.0,794.0
0.005,6,10,1989,5,927,1.0,659.0,659.0,5,1062,1.0,794.0,794.0
0.001,17,2,180,1,66,0.0,38.0,38.0,1,114,0.0,86.0,86.0
0.007,17,2,140,1,62,0.0,34.0,34.0,1,78,0.0,50.0,50.0
0.006,6,10,1547,5,764,1.0,496.0,496.0,5,783,1.0,515.0,515.0
0.014,6,10,1989,5,910,3.0,642.0,642.0,5,1079,3.0,811.0,811.0
0.011,6,10,1972,5,910,2.0,642.0,642.0,5,1062,2.0,794.0,794.0
0.035,17,2,152,1,76,0.0,48.0,48.0,1,76,0.0,48.0,48.0
0.095,6,10,1506,5,395,21.0,127.0,127.0,5,1111,23.0,843.0,843.0
0.006,6,10,1547,5,764,1.0,496.0,496.0,5,783,1.0,515.0,515.0
0.01,6,10,1677,5,827,2.0,559.0,559.0,5,850,2.0,582.0,582.0
0.041,17,2,412,1,61,0.0,33.0,33.0,1,351,0.0,323.0,323.0
0.006,6,10,1689,5,839,1.0,571.0,571.0,5,850,1.0,582.0,582.0
0.01,6,10,1677,5,827,2.0,559.0,559.0,5,850,2.0,582.0,582.0
0.011,6,10,1989,5,910,2.0,642.0,642.0,5,1079,2.0,811.0,811.0
0.006,6,10,1547,5,764,1.0,496.0,496.0,5,783,1.0,515.0,515.0
0.009,6,10,1762,5,911,2.0,643.0,643.0,5,851,2.0,583.0,583.0
40.065,17,10,676,5,460,10013.0,104.0,64.0,5,216,10014.0,20.0,15.0
0.01,6,10,1989,5,910,2.0,642.0,642.0,5,1079,2.0,811.0,811.0
176.217,17,70,9914,35,2331,5182.0,44.0,38.0,35,7583,5182.0,261.0,188.0
308.446,17,20,1124,10,716,34257.0,48.0,43.0,10,408,34257.0,20.0,12.0
0.001,17,2,180,1,66,0.0,38.0,38.0,1,114,0.0,86.0,86.0
0.097,6,10,1506,5,395,21.0,127.0,127.0,5,1111,22.0,843.0,843.0
0.005,6,10,1643,5,860,1.0,592.0,592.0,5,783,1.0,515.0,515.0
0.01,6,10,1989,5,910,2.0,642.0,642.0,5,1079,2.0,811.0,811.0
0.011,6,10,1677,5,827,2.0,559.0,559.0,5,850,2.0,582.0,582.0
0.005,6,10,2006,5,927,1.0,659.0,659.0,5,1079,1.0,811.0,811.0
0.101,6,10,1506,5,395,22.0,127.0,127.0,5,1111,19.0,843.0,843.0
0.009,6,10,1972,5,910,2.0,642.0,642.0,5,1062,2.0,794.0,794.0
0.017,6,10,1989,5,910,4.0,642.0,642.0,5,1079,4.0,811.0,811.0
0.005,6,10,1643,5,860,1.0,592.0,592.0,5,783,1.0,515.0,515.0
0.004,17,2,148,1,60,0.0,32.0,32.0,1,88,0.0,60.0,60.0
0.055,6,10,1506,5,395,13.0,127.0,127.0,5,1111,12.0,843.0,843.0
0.009,6,10,1989,5,910,2.0,642.0,642.0,5,1079,2.0,811.0,811.0
0.01,6,10,1983,5,910,2.0,642.0,642.0,5,1073,2.0,805.0,805.0
0.018,6,10,1631,5,848,4.0,580.0,580.0,5,783,4.0,515.0,515.0
0.009,6,10,1989,5,910,2.0,642.0,642.0,5,1079,2.0,811.0,811.0
0.014,6,10,1983,5,910,3.0,642.0,642.0,5,1073,3.0,805.0,805.0
0.015,6,10,1990,5,911,3.0,643.0,643.0,5,1079,3.0,811.0,811.0
0.005,6,10,2006,5,927,1.0,659.0,659.0,5,1079,1.0,811.0,811.0
0.008,6,12,1926,6,1189,1.0,659.0,434.0,6,737,1.0,417.0,417.0
0.125,17,2,136,1,60,0.0,32.0,32.0,1,76,0.0,48.0,48.0
0.005,6,10,2006,5,927,1.0,659.0,659.0,5,1079,1.0,811.0,811.0
0.008,6,10,1762,5,911,2.0,643.0,643.0,5,851,2.0,583.0,583.0
0.084,6,10,1506,5,395,19.0,127.0,127.0,5,1111,18.0,843.0,843.0
0.005,6,10,2000,5,927,1.0,659.0,659.0,5,1073,1.0,805.0,805.0
0.005,6,10,1689,5,839,1.0,571.0,571.0,5,850,1.0,582.0,582.0
0.006,6,10,1547,5,764,1.0,496.0,496.0,5,783,1.0,515.0,515.0
0.174,6,10,1506,5,395,40.0,127.0,127.0,5,1111,38.0,843.0,843.0
172.103,6,24,9399,11,1575,68.0,794.0,367.0,13,7824,14331.0,1360.0,810.0
0.081,6,10,1506,5,395,18.0,127.0,127.0,5,1111,17.0,843.0,843.0
0.004,6,10,2006,5,927,1.0,659.0,659.0,5,1079,1.0,811.0,811.0
0.011,6,10,1989,5,910,2.0,642.0,642.0,5,1079,2.0,811.0,811.0
11.125,17,28,4423,14,1995,843.0,270.0,114.0,14,2428,843.0,587.0,145.0
0.114,6,10,1506,5,395,28.0,127.0,127.0,5,1111,22.0,843.0,843.0
0.006,6,10,1547,5,764,1.0,496.0,496.0,5,783,1.0,515.0,515.0
311.209,17,20,1124,10,716,34572.0,48.0,43.0,10,408,34572.0,20.0,12.0
0.013,6,10,1989,5,910,3.0,642.0,642.0,5,1079,3.0,811.0,811.0
0.012,6,10,1631,5,848,2.0,580.0,580.0,5,783,3.0,515.0,515.0
0.001,17,2,180,1,66,0.0,38.0,38.0,1,114,0.0,86.0,86.0
0.003,17,2,148,1,60,0.0,32.0,32.0,1,88,0.0,60.0,60.0
0.019,6,10,1990,5,911,4.0,643.0,643.0,5,1079,4.0,811.0,811.0
0.043,17,2,148,1,60,0.0,32.0,32.0,1,88,0.0,60.0,60.0
40.068,17,10,676,5,460,10016.0,104.0,64.0,5,216,10016.0,20.0,15.0
0.005,6,10,2006,5,927,1.0,659.0,659.0,5,1079,1.0,811.0,811.0
0.068,17,8,3613,4,1874,22.0,1350.0,440.0,4,1739,11.0,1350.0,406.0
0.016,6,10,1631,5,848,3.0,580.0,580.0,5,783,4.0,515.0,515.0
0.005,6,10,2006,5,927,1.0,659.0,659.0,5,1079,1.0,811.0,811.0
0.005,17,2,136,1,60,0.0,32.0,32.0,1,76,0.0,48.0,48.0
0.007,6,10,1990,5,911,1.0,643.0,643.0,5,1079,1.0,811.0,811.0
0.215,6,16,2777,8,1395,30.0,533.0,323.0,8,1382,19.0,529.0,239.0
0.006,17,2,179,1,71,0.0,43.0,43.0,1,108,0.0,80.0,80.0
0.076,6,10,1506,5,395,17.0,127.0,127.0,5,1111,18.0,843.0,843.0
0.041,17,2,152,1,76,0.0,48.0,48.0,1,76,0.0,48.0,48.0
240.012,6,9,787,5,488,60003.0,232.0,232.0,4,299,80003.0,83.0,83.0
40.057,17,10,676,5,460,10013.0,104.0,64.0,5,216,10013.0,20.0,15.0
0.002,17,2,136,1,60,0.0,32.0,32.0,1,76,0.0,48.0,48.0
0.003,17,4,284,2,120,0.0,32.0,32.0,2,164,0.0,60.0,54.0
0.023,6,14,3787,7,497,3.0,125.0,125.0,7,3290,3.0,1448.0,972.0
342.524,6,24,5244,13,3103,28540.0,676.0,403.0,11,2141,34248.0,692.0,393.0
65.96,6,27,17602,15,9656,4711.0,2804.0,1478.0,12,7946,5980.0,2317.0,1219.0
0.005,6,10,1689,5,839,1.0,571.0,571.0,5,850,1.0,582.0,582.0
0.003,17,4,420,2,122,0.0,33.0,33.0,2,298,0.0,145.0,121.0
0.005,6,10,2006,5,927,1.0,659.0,659.0,5,1079,1.0,811.0,811.0
301.11,6,41,11541,21,5714,15055.0,2535.0,968.0,20,5827,470.0,2667.0,385.0
0.208,6,21,5381,11,1267,19.0,326.0,171.0,10,4114,21.0,1402.0,717.0
0.004,6,10,2006,5,927,1.0,659.0,659.0,5,1079,1.0,811.0,811.0
0.005,6,10,1643,5,860,1.0,592.0,592.0,5,783,1.0,515.0,515.0
0.006,6,10,1989,5,927,1.0,659.0,659.0,5,1062,1.0,794.0,794.0
0.008,6,10,1989,5,910,2.0,642.0,642.0,5,1079,2.0,811.0,811.0
0.023,6,10,1983,5,910,5.0,642.0,642.0,5,1073,5.0,805.0,805.0
0.079,6,10,1506,5,395,18.0,127.0,127.0,5,1111,17.0,843.0,843.0
0.016,6,10,1972,5,910,4.0,642.0,642.0,5,1062,4.0,794.0,794.0
240.101,6,16,4481,9,963,30012.0,238.0,166.0,7,3518,40014.0,1402.0,786.0
0.072,6,10,1506,5,395,16.0,127.0,127.0,5,1111,17.0,843.0,843.0
0.005,17,2,214,1,75,0.0,47.0,47.0,1,139,0.0,111.0,111.0
15.077,17,15,9238,8,6902,2149.0,1350.0,834.0,7,2336,2508.0,1350.0,305.0
0.069,6,10,1506,5,395,14.0,127.0,127.0,5,1111,16.0,843.0,843.0
0.01,6,10,1972,5,910,2.0,642.0,642.0,5,1062,2.0,794.0,794.0
0.009,6,10,1989,5,910,2.0,642.0,642.0,5,1079,2.0,811.0,811.0
0.006,6,10,1854,5,889,1.0,621.0,621.0,5,965,1.0,697.0,697.0
0.005,6,13,3747,7,509,0.0,137.0,137.0,6,3238,1.0,1470.0,1459.0
0.006,6,10,1989,5,927,1.0,659.0,659.0,5,1062,1.0,794.0,794.0
0.014,6,10,1989,5,910,3.0,642.0,642.0,5,1079,3.0,811.0,811.0
0.015,6,10,1631,5,848,3.0,580.0,580.0,5,783,3.0,515.0,515.0
40.055,17,10,676,5,460,10013.0,104.0,64.0,5,216,10012.0,20.0,15.0
40.054,17,10,676,5,460,10012.0,104.0,64.0,5,216,10012.0,20.0,15.0
0.009,6,10,1989,5,910,2.0,642.0,642.0,5,1079,2.0,811.0,811.0
40.05,17,10,676,5,460,10011.0,104.0,64.0,5,216,10011.0,20.0,15.0
354.03,6,21,1795,16,1030,23602.0,190.0,190.0,5,765,60001.0,464.0,248.0
0.006,6,10,1643,5,860,1.0,592.0,592.0,5,783,1.0,515.0,515.0
0.005,6,13,3690,7,452,0.0,80.0,80.0,6,3238,1.0,1470.0,1459.0
61.085,6,15,922,7,418,10180.0,46.0,46.0,8,504,8708.0,46.0,46.0
0.004,17,2,235,1,64,0.0,36.0,36.0,1,171,0.0,143.0,143.0
0.008,6,12,1926,6,1189,1.0,659.0,434.0,6,737,1.0,417.0,417.0
0.003,6,10,1702,5,863,0.0,595.0,595.0,5,839,0.0,571.0,571.0
0.004,17,2,148,1,60,0.0,32.0,32.0,1,88,0.0,60.0,60.0
0.013,6,10,1989,5,910,3.0,642.0,642.0,5,1079,3.0,811.0,811.0
240.11,6,16,4481,9,963,30013.0,238.0,166.0,7,3518,40017.0,1402.0,786.0
0.005,17,2,166,1,75,0.0,47.0,47.0,1,91,0.0,63.0,63.0
369.958,6,22,2313,16,867,24663.0,195.0,195.0,6,1446,4638.0,419.0,398.0
0.141,6,10,1506,5,395,27.0,127.0,127.0,5,1111,31.0,843.0,843.0
40.062,17,10,676,5,460,10014.0,104.0,64.0,5,216,10014.0,20.0,15.0
0.009,6,10,2007,5,928,2.0,660.0,660.0,5,1079,2.0,811.0,811.0
0.018,6,10,1989,5,910,4.0,642.0,642.0,5,1079,4.0,811.0,811.0
178.027,17,88,12492,44,2925,4140.0,44.0,38.0,44,9567,4140.0,239.0,189.0
0.004,6,10,2007,5,928,1.0,660.0,660.0,5,1079,1.0,811.0,811.0
0.005,17,2,240,1,61,0.0,33.0,33.0,1,179,0.0,151.0,151.0
300.243,6,25,7291,14,1305,23095.0,217.0,142.0,11,5986,30024.0,1679.0,903.0
0.005,6,10,1689,5,839,1.0,571.0,571.0,5,850,1.0,582.0,582.0
0.005,6,10,2006,5,927,1.0,659.0,659.0,5,1079,1.0,811.0,811.0
0.008,6,12,1926,6,1189,1.0,659.0,434.0,6,737,1.0,417.0,417.0
0.12,6,10,1506,5,395,27.0,127.0,127.0,5,1111,27.0,843.0,843.0
0.005,6,10,1702,5,863,1.0,595.0,595.0,5,839,1.0,571.0,571.0
40.071,17,10,676,5,460,10014.0,104.0,64.0,5,216,10016.0,20.0,15.0
0.006,6,10,1547,5,764,1.0,496.0,496.0,5,783,1.0,515.0,515.0
40.055,17,10,676,5,460,10012.0,104.0,64.0,5,216,10013.0,20.0,15.0
0.104,6,10,1506,5,395,23.0,127.0,127.0,5,1111,22.0,843.0,843.0
0.016,6,10,1989,5,910,4.0,642.0,642.0,5,1079,4.0,811.0,811.0
0.04,17,2,412,1,61,0.0,33.0,33.0,1,351,0.0,323.0,323.0
0.001,17,2,180,1,65,0.0,37.0,37.0,1,115,0.0,87.0,87.0
0.016,6,10,1677,5,827,4.0,559.0,559.0,5,850,4.0,582.0,582.0
0.004,6,10,1702,5,863,1.0,595.0,595.0,5,839,1.0,571.0,571.0
0.006,6,10,2006,5,927,1.0,659.0,659.0,5,1079,1.0,811.0,811.0
40.066,17,10,676,5,460,10014.0,104.0,64.0,5,216,10015.0,20.0,15.0
0.009,6,10,1972,5,910,2.0,642.0,642.0,5,1062,2.0,794.0,794.0
318.345,17,20,1124,10,716,35357.0,48.0,43.0,10,408,35357.0,20.0,12.0
0.099,6,10,1506,5,395,20.0,127.0,127.0,5,1111,19.0,843.0,843.0
0.011,6,10,1989,5,910,2.0,642.0,642.0,5,1079,2.0,811.0,811.0
0.006,17,2,179,1,71,0.0,43.0,43.0,1,108,0.0,80.0,80.0
0.126,6,10,1506,5,395,28.0,127.0,127.0,5,1111,28.0,843.0,843.0
0.005,6,14,3742,7,452,0.0,80.0,80.0,7,3290,0.0,1448.0,972.0
0.006,17,2,164,1,74,0.0,46.0,46.0,1,90,0.0,62.0,62.0
0.005,6,13,3747,7,509,0.0,137.0,137.0,6,3238,1.0,1470.0,1459.0
0.004,6,10,2006,5,927,1.0,659.0,659.0,5,1079,1.0,811.0,811.0
0.02,17,2,179,1,71,0.0,43.0,43.0,1,108,0.0,80.0,80.0
0.045,17,2,152,1,76,0.0,48.0,48.0,1,76,0.0,48.0,48.0
0.004,6,10,1702,5,863,1.0,595.0,595.0,5,839,0.0,571.0,571.0
0.005,6,10,2007,5,928,1.0,660.0,660.0,5,1079,1.0,811.0,811.0
240.4,6,33,9670,16,1763,16024.0,539.0,184.0,17,7907,15022.0,1402.0,638.0
300.448,6,16,2170,9,684,37534.0,146.0,146.0,7,1486,50045.0,419.0,398.0
0.001,17,2,180,1,66,0.0,38.0,38.0,1,114,0.0,86.0,86.0
176.255,17,74,10537,37,2473,4895.0,44.0,38.0,37,8064,4895.0,239.0,189.0
0.011,6,13,3735,7,497,1.0,125.0,125.0,6,3238,2.0,1470.0,1459.0
0.005,6,13,3690,7,452,0.0,80.0,80.0,6,3238,1.0,1470.0,1459.0
0.008,17,2,194,1,59,0.0,31.0,31.0,1,135,0.0,107.0,107.0
0.092,6,10,1506,5,395,20.0,127.0,127.0,5,1111,20.0,843.0,843.0
0.02,6,10,1990,5,911,5.0,643.0,643.0,5,1079,5.0,811.0,811.0
0.004,17,4,284,2,120,0.0,32.0,32.0,2,164,0.0,60.0,54.0
0.005,6,14,3742,8,504,0.0,80.0,80.0,6,3238,1.0,1470.0,1459.0
0.187,6,46,11695,25,3303,7.0,1020.0,182.0,21,8392,9.0,1402.0,606.0
0.086,6,10,1506,5,395,17.0,127.0,127.0,5,1111,20.0,843.0,843.0
0.006,6,10,1547,5,764,1.0,496.0,496.0,5,783,1.0,515.0,515.0
240.157,6,42,5427,22,2530,11435.0,588.0,196.0,20,2897,12639.0,580.0,231.0
0.001,17,2,180,1,66,0.0,38.0,38.0,1,114,0.0,86.0,86.0
0.005,6,10,1689,5,839,1.0,571.0,571.0,5,850,1.0,582.0,582.0
0.021,6,10,1989,5,910,5.0,642.0,642.0,5,1079,5.0,811.0,811.0
11.28,17,28,4422,14,1994,855.0,269.0,114.0,14,2428,855.0,587.0,145.0
0.005,6,13,3747,7,509,0.0,137.0,137.0,6,3238,0.0,1470.0,1459.0
573.899,6,90,28098,44,15718,13346.0,2736.0,1031.0,46,12380,12753.0,1162.0,344.0
0.004,6,10,1989,5,927,1.0,659.0,659.0,5,1062,1.0,794.0,794.0
0.005,6,10,1989,5,927,1.0,659.0,659.0,5,1062,1.0,794.0,794.0
0.143,6,10,1506,5,395,33.0,127.0,127.0,5,1111,34.0,843.0,843.0
0.004,6,10,2006,5,927,1.0,659.0,659.0,5,1079,1.0,811.0,811.0
0.009,6,10,1989,5,910,2.0,642.0,642.0,5,1079,2.0,811.0,811.0
300.397,6,16,2170,9,684,37528.0,146.0,146.0,7,1486,50037.0,419.0,398.0
0.038,17,2,152,1,76,0.0,48.0,48.0,1,76,0.0,48.0,48.0
0.021,6,10,1990,5,911,5.0,643.0,643.0,5,1079,5.0,811.0,811.0
0.12,6,10,1506,5,395,27.0,127.0,127.0,5,1111,22.0,843.0,843.0
40.051,17,10,676,5,460,10012.0,104.0,64.0,5,216,10012.0,20.0,15.0
0.001,17,2,136,1,60,0.0,32.0,32.0,1,76,0.0,48.0,48.0
40.073,17,10,676,5,460,10017.0,104.0,64.0,5,216,10017.0,20.0,15.0
0.001,17,2,180,1,66,0.0,38.0,38.0,1,114,0.0,86.0,86.0
0.018,6,10,1677,5,827,4.0,559.0,559.0,5,850,4.0,582.0,582.0
0.004,6,10,1702,5,863,1.0,595.0,595.0,5,839,1.0,571.0,571.0
0.005,6,10,2006,5,927,1.0,659.0,659.0,5,1079,1.0,811.0,811.0
0.001,17,2,180,1,66,0.0,38.0,38.0,1,114,0.0,86.0,86.0
0.088,6,10,1506,5,395,20.0,127.0,127.0,5,1111,20.0,843.0,843.0
0.098,6,10,1506,5,395,23.0,127.0,127.0,5,1111,23.0,843.0,843.0
530.276,6,29,7041,16,4157,35351.0,1402.0,473.0,13,2884,39184.0,821.0,440.0
0.001,17,2,166,1,75,0.0,47.0,47.0,1,91,0.0,63.0,63.0
0.065,6,10,1506,5,395,14.0,127.0,127.0,5,1111,15.0,843.0,843.0
0.082,6,10,1506,5,395,15.0,127.0,127.0,5,1111,19.0,843.0,843.0
0.006,6,10,1643,5,860,1.0,592.0,592.0,5,783,1.0,515.0,515.0
0.07,6,10,1506,5,395,15.0,127.0,127.0,5,1111,16.0,843.0,843.0
0.009,6,10,1989,5,910,2.0,642.0,642.0,5,1079,2.0,811.0,811.0
0.102,6,10,1506,5,395,24.0,127.0,127.0,5,1111,20.0,843.0,843.0
0.005,6,10,1689,5,839,1.0,571.0,571.0,5,850,1.0,582.0,582.0
0.007,6,10,1762,5,911,1.0,643.0,643.0,5,851,1.0,583.0,583.0
0.006,17,2,262,1,66,0.0,38.0,38.0,1,196,0.0,168.0,168.0
0.005,6,10,2000,5,927,1.0,659.0,659.0,5,1073,1.0,805.0,805.0
0.001,17,2,180,1,66,0.0,38.0,38.0,1,114,0.0,86.0,86.0
0.014,6,10,1990,5,911,3.0,643.0,643.0,5,1079,3.0,811.0,811.0
0.007,6,10,1972,5,910,1.0,642.0,642.0,5,1062,1.0,794.0,794.0
1727.986,6,47,2913,31,1777,57599.0,35.0,35.0,16,1136,115190.0,31.0,31.0
0.067,6,10,1506,5,395,16.0,127.0,127.0,5,1111,15.0,843.0,843.0
0.005,6,10,2006,5,927,1.0,659.0,659.0,5,1079,1.0,811.0,811.0
0.013,6,10,1972,5,910,3.0,642.0,642.0,5,1062,3.0,794.0,794.0
0.01,6,10,1989,5,910,2.0,642.0,642.0,5,1079,2.0,811.0,811.0
0.073,6,10,1506,5,395,17.0,127.0,127.0,5,1111,15.0,843.0,843.0
0.009,6,10,1989,5,910,2.0,642.0,642.0,5,1079,2.0,811.0,811.0
0.004,17,2,136,1,60,0.0,32.0,32.0,1,76,0.0,48.0,48.0
0.123,17,2,80,1,32,0.0,4.0,4.0,1,48,0.0,20.0,20.0
0.059,17,2,80,1,32,0.0,4.0,4.0,1,48,0.0,20.0,20.0
1216.164,6,193,36742,76,29579,16215.0,2720.0,435.0,117,7163,10482.0,148.0,49.0
0.02,6,10,1990,5,911,5.0,643.0,643.0,5,1079,5.0,811.0,811.0
0.013,6,10,1631,5,848,3.0,580.0,580.0,5,783,3.0,515.0,515.0
0.071,17,4,284,2,120,0.0,32.0,32.0,2,164,68.0,60.0,54.0
0.105,6,10,1506,5,395,24.0,127.0,127.0,5,1111,22.0,843.0,843.0
0.018,6,10,1989,5,910,4.0,642.0,642.0,5,1079,4.0,811.0,811.0
0.004,17,2,136,1,60,0.0,32.0,32.0,1,76,0.0,48.0,48.0
0.008,6,10,1989,5,910,2.0,642.0,642.0,5,1079,1.0,811.0,811.0
0.019,6,10,1972,5,910,4.0,642.0,642.0,5,1062,4.0,794.0,794.0
0.005,17,2,154,1,69,0.0,41.0,41.0,1,85,0.0,57.0,57.0
0.005,17,2,178,1,81,0.0,53.0,53.0,1,97,0.0,69.0,69.0
0.005,6,10,2007,5,928,1.0,660.0,660.0,5,1079,1.0,811.0,811.0
0.006,6,10,1689,5,839,1.0,571.0,571.0,5,850,1.0,582.0,582.0
0.005,17,2,169,1,62,0.0,34.0,34.0,1,107,0.0,79.0,79.0
0.019,6,10,1990,5,911,4.0,643.0,643.0,5,1079,4.0,811.0,811.0
0.133,6,10,1506,5,395,30.0,127.0,127.0,5,1111,29.0,843.0,843.0
11.13,17,28,4392,14,2311,848.0,586.0,137.0,14,2081,848.0,268.0,120.0
0.004,6,10,1989,5,927,1.0,659.0,659.0,5,1062,1.0,794.0,794.0
0.013,6,10,1990,5,911,3.0,643.0,643.0,5,1079,3.0,811.0,811.0
0.004,6,10,2006,5,927,1.0,659.0,659.0,5,1079,1.0,811.0,811.0
0.005,6,10,2007,5,928,1.0,660.0,660.0,5,1079,1.0,811.0,811.0
0.085,6,10,1506,5,395,19.0,127.0,127.0,5,1111,19.0,843.0,843.0
40.061,17,10,676,5,460,10014.0,104.0,64.0,5,216,10014.0,20.0,15.0
1766.629,6,434,65326,258,35614,6874.0,613.0,194.0,176,29712,10094.0,453.0,142.0
0.005,6,10,2006,5,927,1.0,659.0,659.0,5,1079,1.0,811.0,811.0
0.732,6,10,2009,6,1655,146.0,1403.0,1403.0,4,354,165.0,182.0,182.0
0.006,6,10,1547,5,764,1.0,496.0,496.0,5,783,1.0,515.0,515.0
0.019,6,10,1990,5,911,4.0,643.0,643.0,5,1079,4.0,811.0,811.0
0.138,6,10,1506,5,395,32.0,127.0,127.0,5,1111,28.0,843.0,843.0
0.005,6,10,1547,5,764,1.0,496.0,496.0,5,783,1.0,515.0,515.0
0.012,6,10,1989,5,910,2.0,642.0,642.0,5,1079,2.0,811.0,811.0
0.08,6,10,1506,5,395,17.0,127.0,127.0,5,1111,18.0,843.0,843.0
0.013,6,13,3735,7,497,2.0,125.0,125.0,6,3238,2.0,1470.0,1459.0
0.013,6,10,1990,5,911,3.0,643.0,643.0,5,1079,3.0,811.0,811.0
0.013,6,10,1983,5,910,3.0,642.0,642.0,5,1073,3.0,805.0,805.0
0.004,17,2,148,1,60,0.0,32.0,32.0,1,88,0.0,60.0,60.0
0.065,6,10,1506,5,395,13.0,127.0,127.0,5,1111,14.0,843.0,843.0
0.004,17,2,148,1,60,0.0,32.0,32.0,1,88,0.0,60.0,60.0
0.022,6,10,1983,5,910,5.0,642.0,642.0,5,1073,5.0,805.0,805.0
0.014,6,10,1983,5,910,3.0,642.0,642.0,5,1073,3.0,805.0,805.0
0.004,6,10,2006,5,927,1.0,659.0,659.0,5,1079,1.0,811.0,811.0
169.874,6,22,8496,12,2236,78.0,1345.0,574.0,10,6260,18855.0,2720.0,974.0
0.005,17,2,144,1,64,0.0,36.0,36.0,1,80,0.0,52.0,52.0
0.043,17,2,184,1,61,0.0,33.0,33.0,1,123,0.0,95.0,95.0
0.004,6,10,2006,5,927,1.0,659.0,659.0,5,1079,1.0,811.0,811.0
0.013,6,10,1983,5,910,3.0,642.0,642.0,5,1073,3.0,805.0,805.0
0.01,6,10,1983,5,910,2.0,642.0,642.0,5,1073,2.0,805.0,805.0
0.105,6,10,1506,5,395,25.0,127.0,127.0,5,1111,23.0,843.0,843.0
0.001,17,2,154,1,69,0.0,41.0,41.0,1,85,0.0,57.0,57.0
0.014,6,10,1972,5,910,3.0,642.0,642.0,5,1062,3.0,794.0,794.0
0.005,6,13,3747,7,509,0.0,137.0,137.0,6,3238,0.0,1470.0,1459.0
0.009,6,10,1989,5,910,2.0,642.0,642.0,5,1079,2.0,811.0,811.0
0.008,6,10,1989,5,910,2.0,642.0,642.0,5,1079,2.0,811.0,811.0
0.108,6,10,1506,5,395,21.0,127.0,127.0,5,1111,22.0,843.0,843.0
0.071,17,8,3613,4,1874,23.0,1350.0,440.0,4,1739,9.0,1350.0,406.0
0.014,6,10,1972,5,910,3.0,642.0,642.0,5,1062,3.0,794.0,794.0
0.003,17,2,148,1,60,0.0,32.0,32.0,1,88,0.0,60.0,60.0
0.003,17,2,148,1,60,0.0,32.0,32.0,1,88,0.0,60.0,60.0
0.005,6,10,2007,5,928,1.0,660.0,660.0,5,1079,1.0,811.0,811.0
367.211,6,22,2313,16,867,24480.0,195.0,195.0,6,1446,4712.0,419.0,398.0
0.011,6,10,1689,5,839,2.0,571.0,571.0,5,850,2.0,582.0,582.0
309.609,17,20,1124,10,716,34394.0,48.0,43.0,10,408,34394.0,20.0,12.0
0.185,17,2,194,1,59,0.0,31.0,31.0,1,135,0.0,107.0,107.0
0.011,6,10,1762,5,911,2.0,643.0,643.0,5,851,2.0,583.0,583.0
0.009,6,10,1972,5,910,2.0,642.0,642.0,5,1062,2.0,794.0,794.0
0.006,6,10,1547,5,764,1.0,496.0,496.0,5,783,1.0,515.0,515.0
0.003,17,2,148,1,60,0.0,32.0,32.0,1,88,0.0,60.0,60.0
332.866,17,20,1124,10,716,36971.0,48.0,43.0,10,408,36971.0,20.0,12.0
0.061,6,10,1506,5,395,12.0,127.0,127.0,5,1111,14.0,843.0,843.0
0.082,6,10,1506,5,395,19.0,127.0,127.0,5,1111,18.0,843.0,843.0
1778.607,17,142,44872,72,22752,25049.0,288.0,288.0,70,22120,25775.0,288.0,288.0
0.015,6,13,3735,7,497,2.0,125.0,125.0,6,3238,2.0,1470.0,1459.0
0.007,17,2,179,1,71,0.0,43.0,43.0,1,108,0.0,80.0,80.0
0.005,6,10,1989,5,927,1.0,659.0,659.0,5,1062,1.0,794.0,794.0
0.012,6,10,1990,5,911,3.0,643.0,643.0,5,1079,3.0,811.0,811.0
0.087,6,10,1506,5,395,20.0,127.0,127.0,5,1111,19.0,843.0,843.0
0.008,6,10,2006,5,927,2.0,659.0,659.0,5,1079,2.0,811.0,811.0
0.005,6,10,1989,5,927,1.0,659.0,659.0,5,1062,1.0,794.0,794.0
0.122,6,10,1506,5,395,23.0,127.0,127.0,5,1111,28.0,843.0,843.0
0.006,6,10,1547,5,764,1.0,496.0,496.0,5,783,1.0,515.0,515.0
0.004,6,10,1702,5,863,0.0,595.0,595.0,5,839,1.0,571.0,571.0
0.011,6,10,1989,5,910,2.0,642.0,642.0,5,1079,2.0,811.0,811.0
0.012,6,10,1989,5,910,3.0,642.0,642.0,5,1079,3.0,811.0,811.0
40.054,17,10,676,5,460,10012.0,104.0,64.0,5,216,10012.0,20.0,15.0
0.006,6,10,2006,5,927,1.0,659.0,659.0,5,1079,1.0,811.0,811.0
0.108,6,10,1506,5,395,25.0,127.0,127.0,5,1111,22.0,843.0,843.0
0.004,17,2,136,1,60,0.0,32.0,32.0,1,76,0.0,48.0,48.0
0.071,17,4,284,2,120,0.0,32.0,32.0,2,164,68.0,60.0,54.0
40.086,17,10,676,5,460,10019.0,104.0,64.0,5,216,10020.0,20.0,15.0
0.004,6,10,2007,5,928,1.0,660.0,660.0,5,1079,1.0,811.0,811.0
0.006,17,2,166,1,75,0.0,47.0,47.0,1,91,0.0,63.0,63.0
0.017,6,10,1631,5,848,4.0,580.0,580.0,5,783,4.0,515.0,515.0
0.013,6,10,1972,5,910,3.0,642.0,642.0,5,1062,3.0,794.0,794.0
0.006,6,10,1547,5,764,1.0,496.0,496.0,5,783,1.0,515.0,515.0
15.081,17,16,8566,8,6508,2150.0,1350.0,785.0,8,2058,2150.0,1350.0,229.0
0.011,6,10,1989,5,910,2.0,642.0,642.0,5,1079,2.0,811.0,811.0
0.017,6,10,1989,5,910,4.0,642.0,642.0,5,1079,4.0,811.0,811.0
40.06,17,10,676,5,460,10013.0,104.0,64.0,5,216,10014.0,20.0,15.0
289.269,6,402,348653,191,21497,1522.0,2693.0,770.0,211,327156,1377.0,2804.0,1604.0
0.007,6,10,1547,5,764,1.0,496.0,496.0,5,783,1.0,515.0,515.0
0.009,6,10,1989,5,910,2.0,642.0,642.0,5,1079,2.0,811.0,811.0
0.016,6,13,3735,7,497,2.0,125.0,125.0,6,3238,3.0,1470.0,1459.0
0.006,6,10,2006,5,927,1.0,659.0,659.0,5,1079,1.0,811.0,811.0
0.006,17,2,214,1,75,0.0,47.0,47.0,1,139,0.0,111.0,111.0
0.007,6,10,1774,5,923,1.0,655.0,655.0,5,851,1.0,583.0,583.0
0.005,17,2,179,1,71,0.0,43.0,43.0,1,108,0.0,80.0,80.0
0.098,6,10,1506,5,395,18.0,127.0,127.0,5,1111,22.0,843.0,843.0
0.004,6,10,1989,5,927,1.0,659.0,659.0,5,1062,1.0,794.0,794.0
0.018,17,2,198,1,91,0.0,63.0,63.0,1,107,0.0,79.0,79.0
0.003,17,4,284,2,120,0.0,32.0,32.0,2,164,0.0,60.0,54.0
0.005,6,13,3747,7,509,0.0,137.0,137.0,6,3238,1.0,1470.0,1459.0
0.015,6,10,1972,5,910,3.0,642.0,642.0,5,1062,3.0,794.0,794.0
0.005,6,10,2006,5,927,1.0,659.0,659.0,5,1079,1.0,811.0,811.0
354.033,6,21,1795,16,1030,23602.0,190.0,190.0,5,765,60001.0,464.0,248.0
0.083,17,4,284,2,120,0.0,32.0,32.0,2,164,76.0,60.0,54.0
0.005,6,10,2006,5,927,1.0,659.0,659.0,5,1079,1.0,811.0,811.0
240.08,6,16,4481,9,963,30010.0,238.0,166.0,7,3518,40013.0,1402.0,786.0
0.009,6,10,1989,5,910,2.0,642.0,642.0,5,1079,2.0,811.0,811.0
0.021,6,10,1631,5,848,5.0,580.0,580.0,5,783,5.0,515.0,515.0
0.004,6,10,1702,5,863,1.0,595.0,595.0,5,839,0.0,571.0,571.0
0.218,6,16,2674,8,1400,31.0,533.0,325.0,8,1274,20.0,529.0,212.0
0.006,17,2,225,1,65,0.0,37.0,37.0,1,160,0.0,132.0,132.0
0.013,6,10,1990,5,911,3.0,643.0,643.0,5,1079,3.0,811.0,811.0
0.008,6,10,2007,5,928,2.0,660.0,660.0,5,1079,2.0,811.0,811.0
0.005,6,10,1854,5,889,1.0,621.0,621.0,5,965,1.0,697.0,697.0
0.008,6,12,1926,6,1189,1.0,659.0,434.0,6,737,1.0,417.0,417.0
0.005,6,10,2006,5,927,1.0,659.0,659.0,5,1079,1.0,811.0,811.0
0.007,6,10,2006,5,927,1.0,659.0,659.0,5,1079,1.0,811.0,811.0
0.008,6,10,1972,5,910,2.0,642.0,642.0,5,1062,2.0,794.0,794.0
30.963,6,26,5892,15,1928,2211.0,517.0,260.0,11,3964,3095.0,1330.0,702.0
369.395,6,22,2313,16,867,24626.0,195.0,195.0,6,1446,4671.0,419.0,398.0
240.018,6,9,787,5,488,60004.0,232.0,232.0,4,299,80005.0,83.0,83.0
0.007,6,10,1547,5,764,1.0,496.0,496.0,5,783,1.0,515.0,515.0
0.008,6,10,1990,5,911,2.0,643.0,643.0,5,1079,1.0,811.0,811.0
0.013,6,10,1989,5,910,3.0,642.0,642.0,5,1079,3.0,811.0,811.0
0.008,6,10,1972,5,910,2.0,642.0,642.0,5,1062,2.0,794.0,794.0
2.558,6,22,6060,13,1979,213.0,517.0,258.0,9,4081,305.0,1288.0,721.0
240.264,6,25,12241,15,6955,17161.0,2736.0,1029.0,10,5286,26695.0,1672.0,1189.0
0.005,6,10,1547,5,764,1.0,496.0,496.0,5,783,1.0,515.0,515.0
0.004,6,10,1774,5,923,1.0,655.0,655.0,5,851,1.0,583.0,583.0
0.006,6,10,1547,5,764,1.0,496.0,496.0,5,783,1.0,515.0,515.0
0.007,17,4,284,2,120,1.0,32.0,32.0,2,164,0.0,60.0,54.0
0.005,6,10,2000,5,927,1.0,659.0,659.0,5,1073,1.0,805.0,805.0
0.054,17,2,136,1,60,0.0,32.0,32.0,1,76,0.0,48.0,48.0
0.004,6,10,2007,5,928,1.0,660.0,660.0,5,1079,1.0,811.0,811.0
0.001,17,2,154,1,69,0.0,41.0,41.0,1,85,0.0,57.0,57.0
0.006,6,13,3747,7,509,0.0,137.0,137.0,6,3238,1.0,1470.0,1459.0
0.004,6,10,1779,5,928,1.0,660.0,660.0,5,851,1.0,583.0,583.0
0.105,6,10,1506,5,395,24.0,127.0,127.0,5,1111,20.0,843.0,843.0
0.029,6,10,1677,5,827,7.0,559.0,559.0,5,850,7.0,582.0,582.0
0.005,6,14,3799,7,509,0.0,137.0,137.0,7,3290,0.0,1448.0,972.0
0.009,6,10,1989,5,910,2.0,642.0,642.0,5,1079,2.0,811.0,811.0
0.005,6,10,2007,5,928,1.0,660.0,660.0,5,1079,1.0,811.0,811.0
0.006,6,10,1547,5,764,1.0,496.0,496.0,5,783,1.0,515.0,515.0
0.124,6,10,1506,5,395,28.0,127.0,127.0,5,1111,19.0,843.0,843.0
249.519,6,20,3671,11,2323,24951.0,676.0,348.0,9,1348,31189.0,695.0,294.0
0.039,17,2,152,1,76,0.0,48.0,48.0,1,76,0.0,48.0,48.0
0.008,6,12,1926,6,1189,1.0,659.0,434.0,6,737,1.0,417.0,417.0
0.004,6,10,1774,5,923,1.0,655.0,655.0,5,851,1.0,583.0,583.0
240.091,6,16,4481,9,963,30011.0,238.0,166.0,7,3518,40014.0,1402.0,786.0
0.012,6,10,1990,5,911,3.0,643.0,643.0,5,1079,2.0,811.0,811.0
0.095,6,10,1506,5,395,22.0,127.0,127.0,5,1111,21.0,843.0,843.0
0.003,17,4,284,2,120,0.0,32.0,32.0,2,164,0.0,60.0,54.0
0.004,6,10,2007,5,928,1.0,660.0,660.0,5,1079,1.0,811.0,811.0
0.019,6,10,1990,5,911,4.0,643.0,643.0,5,1079,4.0,811.0,811.0
240.026,6,9,787,5,488,60006.0,232.0,232.0,4,299,80007.0,83.0,83.0
0.084,6,10,1506,5,395,19.0,127.0,127.0,5,1111,20.0,843.0,843.0
0.005,6,10,2006,5,927,1.0,659.0,659.0,5,1079,1.0,811.0,811.0
11.31,17,28,4394,14,1994,856.0,269.0,114.0,14,2400,857.0,587.0,143.0
0.224,6,16,2777,8,1395,32.0,533.0,323.0,8,1382,20.0,529.0,239.0
0.006,6,10,1689,5,839,1.0,571.0,571.0,5,850,1.0,582.0,582.0
0.014,6,10,1762,5,911,3.0,643.0,643.0,5,851,3.0,583.0,583.0
1.157,6,30,13239,17,5840,72.0,2720.0,854.0,13,7399,81.0,2565.0,858.0
0.005,17,2,209,1,64,0.0,36.0,36.0,1,145,0.0,117.0,117.0
0.005,6,10,1689,5,839,1.0,571.0,571.0,5,850,1.0,582.0,582.0
0.021,6,10,1989,5,910,5.0,642.0,642.0,5,1079,5.0,811.0,811.0
0.006,6,13,3747,7,509,0.0,137.0,137.0,6,3238,1.0,1470.0,1459.0
0.004,6,10,2000,5,927,1.0,659.0,659.0,5,1073,1.0,805.0,805.0
11.009,17,28,4400,14,2313,838.0,588.0,137.0,14,2087,838.0,270.0,121.0
0.009,6,10,1989,5,910,2.0,642.0,642.0,5,1079,2.0,811.0,811.0
0.011,6,10,1989,5,910,2.0,642.0,642.0,5,1079,2.0,811.0,811.0
0.005,17,2,179,1,71,0.0,43.0,43.0,1,108,0.0,80.0,80.0
0.004,6,10,1774,5,923,1.0,655.0,655.0,5,851,1.0,583.0,583.0
0.035,17,2,152,1,76,0.0,48.0,48.0,1,76,0.0,48.0,48.0
40.081,17,10,676,5,460,10019.0,104.0,64.0,5,216,10019.0,20.0,15.0
0.012,6,10,1631,5,848,3.0,580.0,580.0,5,783,3.0,515.0,515.0
1778.49,17,144,41760,72,22752,25049.0,288.0,288.0,72,19008,25049.0,236.0,236.0
0.006,6,10,1547,5,764,1.0,496.0,496.0,5,783,1.0,515.0,515.0
0.077,6,10,1506,5,395,18.0,127.0,127.0,5,1111,15.0,843.0,843.0
0.071,6,10,1506,5,395,15.0,127.0,127.0,5,1111,16.0,843.0,843.0
0.005,17,2,164,1,74,0.0,46.0,46.0,1,90,0.0,62.0,62.0
0.001,17,2,180,1,66,0.0,38.0,38.0,1,114,0.0,86.0,86.0
0.085,6,10,1506,5,395,19.0,127.0,127.0,5,1111,19.0,843.0,843.0
0.072,17,2,186,1,61,0.0,33.0,33.0,1,125,0.0,97.0,97.0
0.167,17,2,152,1,76,0.0,48.0,48.0,1,76,0.0,48.0,48.0
0.005,6,13,3747,7,509,0.0,137.0,137.0,6,3238,0.0,1470.0,1459.0
0.005,6,10,1643,5,860,1.0,592.0,592.0,5,783,1.0,515.0,515.0
0.019,6,10,1972,5,910,4.0,642.0,642.0,5,1062,4.0,794.0,794.0
241.27,6,383,348134,187,21247,1297.0,2736.0,885.0,196,326887,1237.0,2804.0,1702.0
0.01,6,10,1989,5,910,2.0,642.0,642.0,5,1079,2.0,811.0,811.0
0.09,6,10,1506,5,395,19.0,127.0,127.0,5,1111,21.0,843.0,843.0
0.005,17,2,170,1,65,0.0,37.0,37.0,1,105,0.0,77.0,77.0
0.006,6,10,1547,5,764,1.0,496.0,496.0,5,783,1.0,515.0,515.0
0.005,6,10,1774,5,923,1.0,655.0,655.0,5,851,1.0,583.0,583.0
1778.151,17,143,41496,72,22752,25044.0,288.0,288.0,71,18744,25402.0,236.0,236.0
0.005,6,10,1989,5,927,1.0,659.0,659.0,5,1062,1.0,794.0,794.0
0.005,6,10,2000,5,927,1.0,659.0,659.0,5,1073,1.0,805.0,805.0
0.007,6,10,1689,5,839,1.0,571.0,571.0,5,850,1.0,582.0,582.0
0.008,6,12,1698,6,863,1.0,327.0,271.0,6,835,1.0,515.0,515.0
0.005,6,10,2000,5,927,1.0,659.0,659.0,5,1073,1.0,805.0,805.0
0.009,6,10,1989,5,927,2.0,659.0,659.0,5,1062,2.0,794.0,794.0
0.005,17,2,212,1,74,0.0,46.0,46.0,1,138,0.0,110.0,110.0
0.006,6,10,1547,5,764,1.0,496.0,496.0,5,783,1.0,515.0,515.0
0.005,6,10,1689,5,839,1.0,571.0,571.0,5,850,1.0,582.0,582.0
0.001,17,2,179,1,62,0.0,34.0,34.0,1,117,0.0,89.0,89.0
0.007,6,10,1547,5,764,1.0,496.0,496.0,5,783,1.0,515.0,515.0
0.005,17,2,140,1,62,0.0,34.0,34.0,1,78,0.0,50.0,50.0
361.86,6,19,1689,15,978,25847.0,190.0,190.0,4,711,80015.0,495.0,495.0
0.013,6,10,1983,5,910,3.0,642.0,642.0,5,1073,3.0,805.0,805.0
61.157,6,27,19875,15,11930,4368.0,2804.0,1593.0,12,7945,5548.0,2316.0,1218.0
0.004,6,13,3690,7,452,0.0,80.0,80.0,6,3238,0.0,1470.0,1459.0
21.625,6,43,18748,22,13110,421.0,2720.0,1524.0,21,5638,1072.0,2667.0,435.0
0.006,6,10,1547,5,764,1.0,496.0,496.0,5,783,1.0,515.0,515.0
1786.412,6,154,19574,92,13852,19630.0,302.0,302.0,62,5722,29285.0,83.0,83.0
0.007,6,10,1983,5,910,1.0,642.0,642.0,5,1073,1.0,805.0,805.0
178.524,17,82,11287,41,2735,4462.0,44.0,38.0,41,8552,4463.0,261.0,180.0
0.005,6,10,1989,5,927,1.0,659.0,659.0,5,1062,1.0,794.0,794.0
0.008,6,10,1989,5,910,2.0,642.0,642.0,5,1079,2.0,811.0,811.0
0.005,6,10,1989,5,927,1.0,659.0,659.0,5,1062,1.0,794.0,794.0
0.145,6,10,1506,5,395,34.0,127.0,127.0,5,1111,32.0,843.0,843.0
0.007,17,2,166,1,75,0.0,47.0,47.0,1,91,0.0,63.0,63.0
240.089,6,16,4481,9,963,30011.0,238.0,166.0,7,3518,40014.0,1402.0,786.0
0.005,17,2,180,1,66,0.0,38.0,38.0,1,114,0.0,86.0,86.0
0.014,6,10,1989,5,910,3.0,642.0,642.0,5,1079,3.0,811.0,811.0
0.006,17,2,169,1,62,0.0,34.0,34.0,1,107,0.0,79.0,79.0
0.005,17,2,140,1,62,0.0,34.0,34.0,1,78,0.0,50.0,50.0
0.008,6,10,1972,5,910,2.0,642.0,642.0,5,1062,2.0,794.0,794.0
0.015,6,10,1989,5,910,3.0,642.0,642.0,5,1079,3.0,811.0,811.0
0.12,6,10,1506,5,395,25.0,127.0,127.0,5,1111,28.0,843.0,843.0
0.014,6,10,1990,5,911,3.0,643.0,643.0,5,1079,3.0,811.0,811.0
33.971,6,55,23764,28,17657,341.0,2720.0,1269.0,27,6107,1300.0,2667.0,385.0
0.001,17,2,180,1,66,0.0,38.0,38.0,1,114,0.0,86.0,86.0
0.005,6,10,2006,5,927,1.0,659.0,659.0,5,1079,1.0,811.0,811.0
0.001,17,2,166,1,75,0.0,47.0,47.0,1,91,0.0,63.0,63.0
40.078,17,10,676,5,460,10018.0,104.0,64.0,5,216,10018.0,20.0,15.0
0.219,6,16,2670,8,1396,31.0,533.0,324.0,8,1274,20.0,529.0,212.0
0.007,6,10,1689,5,839,1.0,571.0,571.0,5,850,1.0,582.0,582.0
0.004,6,10,2006,5,927,1.0,659.0,659.0,5,1079,1.0,811.0,811.0
0.009,6,10,1972,5,910,2.0,642.0,642.0,5,1062,2.0,794.0,794.0
300.409,6,16,2170,9,684,37531.0,146.0,146.0,7,1486,50041.0,419.0,398.0
314.268,17,20,1124,10,716,34911.0,48.0,43.0,10,408,34911.0,20.0,12.0
0.09,6,10,1506,5,395,19.0,127.0,127.0,5,1111,22.0,843.0,843.0
15.125,17,19,13436,9,8280,1887.0,1350.0,892.0,10,5156,1677.0,1350.0,487.0
0.003,17,2,148,1,60,0.0,32.0,32.0,1,88,0.0,60.0,60.0
0.006,17,2,140,1,62,0.0,34.0,34.0,1,78,0.0,50.0,50.0
0.004,17,2,148,1,60,0.0,32.0,32.0,1,88,0.0,60.0,60.0
0.005,6,10,1779,5,928,1.0,660.0,660.0,5,851,1.0,583.0,583.0
0.096,6,10,1506,5,395,23.0,127.0,127.0,5,1111,20.0,843.0,843.0
168.05,17,72,10244,36,2394,4801.0,44.0,38.0,36,7850,4801.0,239.0,190.0
0.004,6,10,1702,5,863,1.0,595.0,595.0,5,839,1.0,571.0,571.0
0.085,6,10,1506,5,395,18.0,127.0,127.0,5,1111,18.0,843.0,843.0
1792.328,6,558,190096,278,163600,6470.0,2883.0,1007.0,280,26496,6424.0,380.0,113.0
0.009,6,10,1989,5,910,2.0,642.0,642.0,5,1079,2.0,811.0,811.0
0.081,6,10,1506,5,395,17.0,127.0,127.0,5,1111,18.0,843.0,843.0
0.121,6,10,1506,5,395,28.0,127.0,127.0,5,1111,27.0,843.0,843.0
0.005,6,10,2007,5,928,1.0,660.0,660.0,5,1079,1.0,811.0,811.0
0.004,6,10,1774,5,923,1.0,655.0,655.0,5,851,1.0,583.0,583.0
0.006,6,10,2006,5,927,1.0,659.0,659.0,5,1079,1.0,811.0,811.0
0.006,6,10,1547,5,764,1.0,496.0,496.0,5,783,1.0,515.0,515.0
0.095,6,28,9187,14,6849,7.0,2012.0,679.0,14,2338,7.0,580.0,228.0
0.061,17,2,152,1,76,0.0,48.0,48.0,1,76,0.0,48.0,48.0
0.014,6,10,1990,5,911,3.0,643.0,643.0,5,1079,3.0,811.0,811.0
0.024,17,2,180,1,66,0.0,38.0,38.0,1,114,0.0,86.0,86.0
0.13,17,4,284,2,120,0.0,32.0,32.0,2,164,126.0,60.0,54.0
0.005,6,10,2006,5,927,1.0,659.0,659.0,5,1079,1.0,811.0,811.0
708.645,6,45,15720,24,4335,30810.0,676.0,439.0,21,11385,32430.0,1402.0,791.0
0.009,6,10,1631,5,848,2.0,580.0,580.0,5,783,2.0,515.0,515.0
0.005,6,10,2006,5,927,1.0,659.0,659.0,5,1079,1.0,811.0,811.0
0.001,17,2,180,1,66,0.0,38.0,38.0,1,114,0.0,86.0,86.0
0.08,6,10,1506,5,395,17.0,127.0,127.0,5,1111,18.0,843.0,843.0
0.005,6,10,2006,5,927,1.0,659.0,659.0,5,1079,1.0,811.0,811.0
0.004,6,10,1989,5,927,1.0,659.0,659.0,5,1062,1.0,794.0,794.0
0.005,6,10,2007,5,928,1.0,660.0,660.0,5,1079,1.0,811.0,811.0
0.007,6,10,1774,5,923,1.0,655.0,655.0,5,851,1.0,583.0,583.0
0.139,6,10,1506,5,395,30.0,127.0,127.0,5,1111,21.0,843.0,843.0
308.455,17,20,1124,10,716,34258.0,48.0,43.0,10,408,34258.0,20.0,12.0
40.064,17,10,676,5,460,10015.0,104.0,64.0,5,216,10015.0,20.0,15.0
0.005,6,10,1689,5,839,1.0,571.0,571.0,5,850,1.0,582.0,582.0
0.012,6,13,3735,7,497,2.0,125.0,125.0,6,3238,2.0,1470.0,1459.0
0.01,6,10,1983,5,910,2.0,642.0,642.0,5,1073,2.0,805.0,805.0
0.486,17,59,36572,33,29973,15.0,1350.0,880.0,26,6599,17.0,1350.0,225.0
0.007,17,2,146,1,65,0.0,37.0,37.0,1,81,0.0,53.0,53.0
0.014,6,10,1989,5,910,3.0,642.0,642.0,5,1079,3.0,811.0,811.0
0.007,6,10,1989,5,927,1.0,659.0,659.0,5,1062,1.0,794.0,794.0
0.004,17,4,284,2,120,0.0,32.0,32.0,2,164,0.0,60.0,54.0
0.129,6,10,1506,5,395,28.0,127.0,127.0,5,1111,31.0,843.0,843.0
0.005,6,10,1779,5,928,1.0,660.0,660.0,5,851,1.0,583.0,583.0
0.075,6,10,1506,5,395,17.0,127.0,127.0,5,1111,16.0,843.0,843.0
0.004,17,2,148,1,60,0.0,32.0,32.0,1,88,0.0,60.0,60.0
0.009,6,10,1990,5,911,2.0,643.0,643.0,5,1079,2.0,811.0,811.0
0.004,6,10,2007,5,928,1.0,660.0,660.0,5,1079,1.0,811.0,811.0
0.071,17,4,284,2,120,0.0,32.0,32.0,2,164,68.0,60.0,54.0
0.005,6,10,1989,5,927,1.0,659.0,659.0,5,1062,1.0,794.0,794.0
0.013,17,2,152,1,56,0.0,28.0,28.0,1,96,0.0,68.0,68.0
0.005,6,10,2006,5,927,1.0,659.0,659.0,5,1079,1.0,811.0,811.0
0.004,6,10,1702,5,863,1.0,595.0,595.0,5,839,1.0,571.0,571.0
0.001,17,2,180,1,66,0.0,38.0,38.0,1,114,0.0,86.0,86.0
0.001,17,2,136,1,60,0.0,32.0,32.0,1,76,0.0,48.0,48.0
168.181,17,88,13179,44,2957,3911.0,44.0,39.0,44,10222,3911.0,279.0,204.0
0.008,6,10,1972,5,910,2.0,642.0,642.0,5,1062,1.0,794.0,794.0
0.077,6,10,1506,5,395,17.0,127.0,127.0,5,1111,17.0,843.0,843.0
0.123,6,10,1506,5,395,28.0,127.0,127.0,5,1111,23.0,843.0,843.0
0.015,6,10,1972,5,910,3.0,642.0,642.0,5,1062,3.0,794.0,794.0
0.012,6,6,716,3,458,4.0,302.0,302.0,3,258,4.0,102.0,102.0
0.201,6,3,453,2,321,201.0,241.0,241.0,1,132,0.0,92.0,92.0
0.004,17,2,136,1,60,0.0,32.0,32.0,1,76,0.0,48.0,48.0
0.005,17,2,169,1,62,0.0,34.0,34.0,1,107,0.0,79.0,79.0
168.231,17,84,12082,42,2799,4103.0,44.0,38.0,42,9283,4103.0,239.0,193.0
0.005,6,14,3742,8,504,0.0,80.0,80.0,6,3238,1.0,1470.0,1459.0
0.109,6,10,1506,5,395,23.0,127.0,127.0,5,1111,26.0,843.0,843.0
0.006,6,10,1854,5,889,1.0,621.0,621.0,5,965,1.0,697.0,697.0
0.01,6,10,1990,5,911,2.0,643.0,643.0,5,1079,2.0,811.0,811.0
0.005,6,10,1547,5,764,1.0,496.0,496.0,5,783,1.0,515.0,515.0
0.004,17,2,148,1,60,0.0,32.0,32.0,1,88,0.0,60.0,60.0
0.01,6,10,1989,5,910,2.0,642.0,642.0,5,1079,2.0,811.0,811.0
0.004,6,10,2007,5,928,1.0,660.0,660.0,5,1079,1.0,811.0,811.0
0.005,6,10,2006,5,927,1.0,659.0,659.0,5,1079,1.0,811.0,811.0
0.005,6,10,1774,5,923,1.0,655.0,655.0,5,851,1.0,583.0,583.0
0.108,6,10,1506,5,395,21.0,127.0,127.0,5,1111,24.0,843.0,843.0
0.073,6,10,1506,5,395,17.0,127.0,127.0,5,1111,13.0,843.0,843.0
0.01,6,10,1972,5,910,2.0,642.0,642.0,5,1062,2.0,794.0,794.0
0.005,6,10,1689,5,839,1.0,571.0,571.0,5,850,1.0,582.0,582.0
0.012,17,4,284,2,120,0.0,32.0,32.0,2,164,1.0,60.0,54.0
0.005,6,10,1547,5,764,1.0,496.0,496.0,5,783,1.0,515.0,515.0
0.025,17,2,152,1,56,0.0,28.0,28.0,1,96,0.0,68.0,68.0
0.005,6,10,2006,5,927,1.0,659.0,659.0,5,1079,1.0,811.0,811.0
0.12,6,10,1506,5,395,28.0,127.0,127.0,5,1111,24.0,843.0,843.0
0.006,6,10,1547,5,764,1.0,496.0,496.0,5,783,1.0,515.0,515.0
0.003,17,2,148,1,60,0.0,32.0,32.0,1,88,0.0,60.0,60.0
240.12,6,31,9161,15,6866,17151.0,1989.0,676.0,16,2295,16007.0,580.0,181.0
0.082,6,10,1506,5,395,16.0,127.0,127.0,5,1111,19.0,843.0,843.0
240.151,6,38,4998,19,2363,13341.0,580.0,195.0,19,2635,13341.0,564.0,234.0
0.07,6,10,1506,5,395,14.0,127.0,127.0,5,1111,15.0,843.0,843.0
0.005,6,13,3747,7,509,0.0,137.0,137.0,6,3238,1.0,1470.0,1459.0
40.066,17,10,676,5,460,10014.0,104.0,64.0,5,216,10015.0,20.0,15.0
15.033,17,42,21815,24,18523,652.0,1350.0,743.0,18,3292,882.0,1350.0,154.0
0.013,17,2,152,1,56,0.0,28.0,28.0,1,96,0.0,68.0,68.0
0.21,6,16,2777,8,1395,30.0,533.0,323.0,8,1382,19.0,529.0,239.0
0.012,6,10,1990,5,911,3.0,643.0,643.0,5,1079,3.0,811.0,811.0
0.012,6,10,1762,5,911,2.0,643.0,643.0,5,851,2.0,583.0,583.0
0.012,6,10,1983,5,910,2.0,642.0,642.0,5,1073,2.0,805.0,805.0
0.011,6,10,1762,5,911,2.0,643.0,643.0,5,851,2.0,583.0,583.0
0.005,17,2,214,1,75,0.0,47.0,47.0,1,139,0.0,111.0,111.0
0.01,6,12,1926,6,1189,2.0,659.0,434.0,6,737,1.0,417.0,417.0
40.064,17,10,676,5,460,10015.0,104.0,64.0,5,216,10015.0,20.0,15.0
0.011,6,10,1990,5,911,2.0,643.0,643.0,5,1079,2.0,811.0,811.0
0.016,6,10,1972,5,910,3.0,642.0,642.0,5,1062,4.0,794.0,794.0
0.001,17,2,166,1,75,0.0,47.0,47.0,1,91,0.0,63.0,63.0
0.006,6,10,1547,5,764,1.0,496.0,496.0,5,783,1.0,515.0,515.0
0.005,6,10,2007,5,928,1.0,660.0,660.0,5,1079,1.0,811.0,811.0
40.047,17,10,676,5,460,10010.0,104.0,64.0,5,216,10011.0,20.0,15.0
0.005,17,2,136,1,60,0.0,32.0,32.0,1,76,0.0,48.0,48.0
0.005,6,10,1547,5,764,1.0,496.0,496.0,5,783,1.0,515.0,515.0
0.015,6,10,1677,5,827,3.0,559.0,559.0,5,850,3.0,582.0,582.0
0.004,17,2,194,1,59,0.0,31.0,31.0,1,135,0.0,107.0,107.0
0.006,6,10,1689,5,839,1.0,571.0,571.0,5,850,1.0,582.0,582.0
15.073,17,16,10616,9,8280,1880.0,1350.0,892.0,7,2336,2507.0,1350.0,305.0
0.004,17,2,136,1,60,0.0,32.0,32.0,1,76,0.0,48.0,48.0
0.016,6,10,1989,5,910,4.0,642.0,642.0,5,1079,3.0,811.0,811.0
354.078,6,21,1795,16,1030,23605.0,190.0,190.0,5,765,60003.0,464.0,248.0
0.006,6,10,1547,5,764,1.0,496.0,496.0,5,783,1.0,515.0,515.0
0.016,6,10,1972,5,910,4.0,642.0,642.0,5,1062,4.0,794.0,794.0
40.067,17,10,676,5,460,10016.0,104.0,64.0,5,216,10015.0,20.0,15.0
0.012,6,10,1972,5,910,2.0,642.0,642.0,5,1062,3.0,794.0,794.0
0.003,17,2,148,1,60,0.0,32.0,32.0,1,88,0.0,60.0,60.0
0.003,17,2,152,1,76,0.0,48.0,48.0,1,76,0.0,48.0,48.0
0.248,17,39,20207,21,17041,12.0,1350.0,783.0,18,3166,11.0,1350.0,147.0
300.594,6,34,6335,19,1409,16699.0,267.0,154.0,15,4926,604.0,1823.0,392.0
0.008,6,10,1990,5,911,2.0,643.0,643.0,5,1079,2.0,811.0,811.0
0.009,6,10,1762,5,911,2.0,643.0,643.0,5,851,2.0,583.0,583.0
0.004,17,2,148,1,60,0.0,32.0,32.0,1,88,0.0,60.0,60.0
0.015,6,10,1989,5,910,3.0,642.0,642.0,5,1079,3.0,811.0,811.0
0.004,6,10,2006,5,927,1.0,659.0,659.0,5,1079,1.0,811.0,811.0
0.1,6,10,1506,5,395,22.0,127.0,127.0,5,1111,20.0,843.0,843.0
0.012,6,10,1972,5,910,3.0,642.0,642.0,5,1062,2.0,794.0,794.0
0.076,6,10,1506,5,395,17.0,127.0,127.0,5,1111,18.0,843.0,843.0
40.055,17,10,676,5,460,10012.0,104.0,64.0,5,216,10013.0,20.0,15.0
125.987,6,14,2938,8,2504,17964.0,1414.0,1086.0,6,434,25150.0,182.0,182.0
0.101,6,10,1506,5,395,24.0,127.0,127.0,5,1111,22.0,843.0,843.0
40.065,17,10,676,5,460,10015.0,104.0,64.0,5,216,10015.0,20.0,15.0
0.003,17,2,148,1,60,0.0,32.0,32.0,1,88,0.0,60.0,60.0
0.001,17,2,180,1,66,0.0,38.0,38.0,1,114,0.0,86.0,86.0
300.316,6,16,2170,9,684,37519.0,146.0,146.0,7,1486,50025.0,419.0,398.0
0.005,6,10,2006,5,927,1.0,659.0,659.0,5,1079,1.0,811.0,811.0
0.024,6,10,1989,5,910,6.0,642.0,642.0,5,1079,6.0,811.0,811.0
0.008,6,10,1989,5,910,2.0,642.0,642.0,5,1079,2.0,811.0,811.0
0.128,6,10,1506,5,395,30.0,127.0,127.0,5,1111,25.0,843.0,843.0
290.022,6,354,345284,188,21336,1550.0,2736.0,888.0,166,323948,1757.0,4206.0,2074.0
0.003,17,2,148,1,60,0.0,32.0,32.0,1,88,0.0,60.0,60.0
0.006,17,2,179,1,71,0.0,43.0,43.0,1,108,0.0,80.0,80.0
40.054,17,10,676,5,460,10012.0,104.0,64.0,5,216,10012.0,20.0,15.0
0.069,17,8,3613,4,1874,23.0,1350.0,440.0,4,1739,11.0,1350.0,406.0
0.007,17,2,148,1,60,0.0,32.0,32.0,1,88,0.0,60.0,60.0
0.009,6,10,1989,5,910,2.0,642.0,642.0,5,1079,2.0,811.0,811.0
0.021,17,2,136,1,60,0.0,32.0,32.0,1,76,0.0,48.0,48.0
0.009,6,10,1990,5,911,2.0,643.0,643.0,5,1079,2.0,811.0,811.0
242.362,6,398,347688,195,21662,1249.0,2736.0,959.0,203,326026,1199.0,4206.0,1634.0
0.068,17,8,3613,4,1874,22.0,1350.0,440.0,4,1739,12.0,1350.0,406.0
0.017,6,10,1972,5,910,4.0,642.0,642.0,5,1062,4.0,794.0,794.0
0.281,17,44,24417,25,21216,11.0,1350.0,820.0,19,3201,11.0,1350.0,140.0
0.039,17,4,284,2,120,0.0,32.0,32.0,2,164,36.0,60.0,54.0
0.008,6,10,1983,5,910,1.0,642.0,642.0,5,1073,2.0,805.0,805.0
0.008,17,2,179,1,71,0.0,43.0,43.0,1,108,0.0,80.0,80.0
0.078,6,10,1506,5,395,18.0,127.0,127.0,5,1111,16.0,843.0,843.0
0.19,17,4,352,2,130,150.0,37.0,37.0,2,222,151.0,89.0,83.0
0.013,17,4,284,2,120,0.0,32.0,32.0,2,164,1.0,60.0,54.0
0.015,6,10,1631,5,848,3.0,580.0,580.0,5,783,3.0,515.0,515.0
0.103,6,10,1506,5,395,22.0,127.0,127.0,5,1111,23.0,843.0,843.0
0.005,6,10,1779,5,928,1.0,660.0,660.0,5,851,1.0,583.0,583.0
0.005,6,10,1643,5,860,1.0,592.0,592.0,5,783,1.0,515.0,515.0
0.069,6,10,1506,5,395,16.0,127.0,127.0,5,1111,13.0,843.0,843.0
0.041,17,4,284,2,120,0.0,32.0,32.0,2,164,37.0,60.0,54.0
0.01,6,10,1989,5,910,2.0,642.0,642.0,5,1079,2.0,811.0,811.0
0.115,6,10,1506,5,395,26.0,127.0,127.0,5,1111,21.0,843.0,843.0
0.068,6,13,3816,7,578,11.0,206.0,206.0,6,3238,13.0,1470.0,1459.0
0.005,6,10,2006,5,927,1.0,659.0,659.0,5,1079,1.0,811.0,811.0
0.004,17,2,136,1,60,0.0,32.0,32.0,1,76,0.0,48.0,48.0
0.007,6,10,2006,5,927,1.0,659.0,659.0,5,1079,1.0,811.0,811.0
0.04,17,2,136,1,60,0.0,32.0,32.0,1,76,0.0,48.0,48.0
0.005,6,10,2006,5,927,1.0,659.0,659.0,5,1079,1.0,811.0,811.0
0.011,6,10,1989,5,910,2.0,642.0,642.0,5,1079,2.0,811.0,811.0
0.01,6,10,1990,5,911,2.0,643.0,643.0,5,1079,2.0,811.0,811.0
0.016,6,10,1983,5,910,4.0,642.0,642.0,5,1073,3.0,805.0,805.0
0.006,6,10,1547,5,764,1.0,496.0,496.0,5,783,1.0,515.0,515.0
0.028,6,10,1989,5,910,6.0,642.0,642.0,5,1079,6.0,811.0,811.0
0.003,17,4,284,2,120,0.0,32.0,32.0,2,164,0.0,60.0,54.0
0.072,6,10,1506,5,395,14.0,127.0,127.0,5,1111,16.0,843.0,843.0
0.012,6,10,2007,5,928,3.0,660.0,660.0,5,1079,3.0,811.0,811.0
0.166,6,22,6483,11,2013,15.0,746.0,286.0,11,4470,15.0,1324.0,778.0
0.096,6,10,1506,5,395,21.0,127.0,127.0,5,1111,21.0,843.0,843.0
0.046,6,10,1972,5,910,11.0,642.0,642.0,5,1062,11.0,794.0,794.0
0.114,6,10,1506,5,395,25.0,127.0,127.0,5,1111,24.0,843.0,843.0
0.004,17,2,136,1,60,0.0,32.0,32.0,1,76,0.0,48.0,48.0
0.091,6,10,1506,5,395,20.0,127.0,127.0,5,1111,19.0,843.0,843.0
0.009,6,10,1989,5,910,2.0,642.0,642.0,5,1079,2.0,811.0,811.0
0.012,6,10,1677,5,827,2.0,559.0,559.0,5,850,2.0,582.0,582.0
0.005,17,2,179,1,71,0.0,43.0,43.0,1,108,0.0,80.0,80.0
0.008,6,10,1990,5,911,2.0,643.0,643.0,5,1079,2.0,811.0,811.0
0.128,17,2,80,1,32,0.0,4.0,4.0,1,48,0.0,20.0,20.0
0.003,17,2,148,1,60,0.0,32.0,32.0,1,88,0.0,60.0,60.0
0.075,6,10,1506,5,395,16.0,127.0,127.0,5,1111,16.0,843.0,843.0
0.005,6,10,2000,5,927,1.0,659.0,659.0,5,1073,1.0,805.0,805.0
0.006,6,10,1779,5,928,1.0,660.0,660.0,5,851,1.0,583.0,583.0
0.159,6,48,14712,27,3176,6.0,517.0,177.0,21,11536,7.0,2694.0,801.0
1792.603,6,494,99625,249,88182,7227.0,421.0,365.0,245,11443,7346.0,53.0,53.0
0.006,6,10,1689,5,839,1.0,571.0,571.0,5,850,1.0,582.0,582.0
0.076,6,10,1506,5,395,17.0,127.0,127.0,5,1111,15.0,843.0,843.0
0.006,17,2,214,1,75,0.0,47.0,47.0,1,139,0.0,111.0,111.0
0.008,6,10,1677,5,827,2.0,559.0,559.0,5,850,1.0,582.0,582.0
0.012,6,10,1631,5,848,3.0,580.0,580.0,5,783,3.0,515.0,515.0
0.015,6,10,1983,5,910,3.0,642.0,642.0,5,1073,3.0,805.0,805.0
0.108,6,10,1506,5,395,24.0,127.0,127.0,5,1111,22.0,843.0,843.0
177.369,17,72,10346,36,2402,5067.0,44.0,38.0,36,7944,5067.0,261.0,192.0
300.399,6,29,10780,16,2099,20026.0,585.0,314.0,13,8681,20029.0,1402.0,999.0
40.062,17,10,676,5,460,10014.0,104.0,64.0,5,216,10014.0,20.0,15.0
0.006,6,10,1547,5,764,1.0,496.0,496.0,5,783,1.0,515.0,515.0
0.069,17,8,3613,4,1874,23.0,1350.0,440.0,4,1739,11.0,1350.0,406.0
0.006,17,2,180,1,58,0.0,30.0,30.0,1,122,0.0,94.0,94.0
0.011,6,10,1990,5,911,2.0,643.0,643.0,5,1079,2.0,811.0,811.0
0.084,6,10,1506,5,395,17.0,127.0,127.0,5,1111,18.0,843.0,843.0
10.884,17,28,4421,14,1993,829.0,268.0,114.0,14,2428,829.0,587.0,145.0
0.011,6,10,1989,5,910,2.0,642.0,642.0,5,1079,2.0,811.0,811.0
0.079,6,10,1506,5,395,18.0,127.0,127.0,5,1111,17.0,843.0,843.0
174.485,17,80,11698,40,2681,4473.0,44.0,39.0,40,9017,4473.0,261.0,197.0
0.009,6,10,1972,5,910,2.0,642.0,642.0,5,1062,2.0,794.0,794.0
0.006,6,10,1779,5,928,1.0,660.0,660.0,5,851,1.0,583.0,583.0
0.006,6,10,2006,5,927,1.0,659.0,659.0,5,1079,1.0,811.0,811.0
1770.832,17,120,11460,60,5460,30013.0,63.0,63.0,60,6000,30013.0,72.0,72.0
0.117,6,10,1506,5,395,28.0,127.0,127.0,5,1111,26.0,843.0,843.0
0.004,17,2,186,1,61,0.0,33.0,33.0,1,125,0.0,97.0,97.0
0.012,6,10,1762,5,911,3.0,643.0,643.0,5,851,3.0,583.0,583.0
0.006,6,10,1547,5,764,1.0,496.0,496.0,5,783,1.0,515.0,515.0
0.003,17,2,136,1,60,0.0,32.0,32.0,1,76,0.0,48.0,48.0
0.059,17,2,80,1,32,0.0,4.0,4.0,1,48,0.0,20.0,20.0
0.02,6,10,1983,5,910,4.0,642.0,642.0,5,1073,4.0,805.0,805.0
0.012,6,13,3735,7,497,2.0,125.0,125.0,6,3238,2.0,1470.0,1459.0
10.902,17,28,4423,14,1995,830.0,270.0,114.0,14,2428,830.0,587.0,145.0
0.009,6,13,3735,7,497,1.0,125.0,125.0,6,3238,1.0,1470.0,1459.0
174.103,17,78,10947,39,2599,4581.0,44.0,38.0,39,8348,4581.0,239.0,186.0
0.009,6,10,1972,5,910,2.0,642.0,642.0,5,1062,2.0,794.0,794.0
240.295,6,43,8771,21,5686,12014.0,1515.0,509.0,22,3085,11442.0,580.0,241.0
0.005,6,10,1989,5,927,1.0,659.0,659.0,5,1062,1.0,794.0,794.0
0.016,6,10,1762,5,911,3.0,643.0,643.0,5,851,3.0,583.0,583.0
240.084,6,22,4977,12,993,21825.0,180.0,93.0,10,3984,26675.0,1592.0,576.0
0.005,6,14,3742,7,452,0.0,80.0,80.0,7,3290,0.0,1448.0,972.0
0.006,17,2,169,1,62,0.0,34.0,34.0,1,107,0.0,79.0,79.0
0.009,6,12,1926,6,1189,1.0,659.0,434.0,6,737,1.0,417.0,417.0
0.005,6,10,2006,5,927,1.0,659.0,659.0,5,1079,1.0,811.0,811.0
0.008,6,10,1983,5,910,2.0,642.0,642.0,5,1073,2.0,805.0,805.0
0.005,6,10,2007,5,928,1.0,660.0,660.0,5,1079,1.0,811.0,811.0
0.011,6,10,1989,5,910,2.0,642.0,642.0,5,1079,2.0,811.0,811.0
0.003,17,2,148,1,60,0.0,32.0,32.0,1,88,0.0,60.0,60.0
0.001,17,2,180,1,66,0.0,38.0,38.0,1,114,0.0,86.0,86.0
0.008,6,12,1926,6,1189,1.0,659.0,434.0,6,737,1.0,417.0,417.0
0.005,6,10,2006,5,927,1.0,659.0,659.0,5,1079,1.0,811.0,811.0
40.067,17,10,676,5,460,10015.0,104.0,64.0,5,216,10016.0,20.0,15.0
40.07,17,10,676,5,460,10016.0,104.0,64.0,5,216,10016.0,20.0,15.0
0.081,6,10,1506,5,395,17.0,127.0,127.0,5,1111,19.0,843.0,843.0
0.005,6,10,2007,5,928,1.0,660.0,660.0,5,1079,1.0,811.0,811.0
0.009,6,10,1989,5,910,2.0,642.0,642.0,5,1079,2.0,811.0,811.0
0.003,17,2,148,1,60,0.0,32.0,32.0,1,88,0.0,60.0,60.0
0.001,17,2,154,1,69,0.0,41.0,41.0,1,85,0.0,57.0,57.0
166.117,17,82,12012,41,2752,4152.0,44.0,39.0,41,9260,4152.0,260.0,197.0
0.007,6,10,1547,5,764,1.0,496.0,496.0,5,783,1.0,515.0,515.0
0.012,6,10,1990,5,911,2.0,643.0,643.0,5,1079,3.0,811.0,811.0
0.005,17,2,169,1,62,0.0,34.0,34.0,1,107,0.0,79.0,79.0
240.011,6,9,787,5,488,60002.0,232.0,232.0,4,299,80003.0,83.0,83.0
40.069,17,10,676,5,460,10016.0,104.0,64.0,5,216,10015.0,20.0,15.0
0.039,17,2,148,1,60,0.0,32.0,32.0,1,88,0.0,60.0,60.0
0.011,6,10,1990,5,911,2.0,643.0,643.0,5,1079,2.0,811.0,811.0
0.091,6,10,1506,5,395,21.0,127.0,127.0,5,1111,21.0,843.0,843.0
0.094,6,10,1506,5,395,21.0,127.0,127.0,5,1111,20.0,843.0,843.0
0.074,6,10,1506,5,395,16.0,127.0,127.0,5,1111,16.0,843.0,843.0
353.395,6,20,2210,6,1308,12003.0,494.0,494.0,14,902,27183.0,83.0,83.0
0.045,17,2,148,1,60,0.0,32.0,32.0,1,88,0.0,60.0,60.0
0.006,6,10,2007,5,928,1.0,660.0,660.0,5,1079,1.0,811.0,811.0
0.013,6,10,1972,5,910,3.0,642.0,642.0,5,1062,3.0,794.0,794.0
0.004,17,2,148,1,60,0.0,32.0,32.0,1,88,0.0,60.0,60.0
0.004,6,10,1779,5,928,1.0,660.0,660.0,5,851,1.0,583.0,583.0
0.007,6,10,1547,5,764,1.0,496.0,496.0,5,783,1.0,515.0,515.0
0.03,6,10,1989,5,910,7.0,642.0,642.0,5,1079,7.0,811.0,811.0
0.11,6,10,1506,5,395,21.0,127.0,127.0,5,1111,26.0,843.0,843.0
0.007,6,10,1547,5,764,1.0,496.0,496.0,5,783,1.0,515.0,515.0
0.005,17,2,179,1,71,0.0,43.0,43.0,1,108,0.0,80.0,80.0
0.202,6,16,2670,8,1396,28.0,533.0,324.0,8,1274,18.0,529.0,212.0
0.005,6,13,3747,7,509,0.0,137.0,137.0,6,3238,0.0,1470.0,1459.0
0.103,6,10,1506,5,395,23.0,127.0,127.0,5,1111,20.0,843.0,843.0
10.992,17,28,4398,14,2312,837.0,587.0,137.0,14,2086,837.0,269.0,121.0
0.079,6,10,1506,5,395,16.0,127.0,127.0,5,1111,18.0,843.0,843.0
0.005,6,10,2007,5,928,1.0,660.0,660.0,5,1079,1.0,811.0,811.0
0.004,6,10,1779,5,928,1.0,660.0,660.0,5,851,1.0,583.0,583.0
0.005,6,10,2006,5,927,1.0,659.0,659.0,5,1079,1.0,811.0,811.0
0.014,6,10,1983,5,910,3.0,642.0,642.0,5,1073,3.0,805.0,805.0
0.001,17,2,136,1,60,0.0,32.0,32.0,1,76,0.0,48.0,48.0
0.011,6,10,1990,5,911,2.0,643.0,643.0,5,1079,2.0,811.0,811.0
0.006,6,10,1779,5,928,1.0,660.0,660.0,5,851,1.0,583.0,583.0
15.658,17,19,13436,9,8280,1953.0,1350.0,892.0,10,5156,1736.0,1350.0,487.0
0.013,17,2,152,1,56,0.0,28.0,28.0,1,96,0.0,68.0,68.0
0.018,6,10,1972,5,910,4.0,642.0,642.0,5,1062,4.0,794.0,794.0
240.011,6,9,787,5,488,60002.0,232.0,232.0,4,299,80002.0,83.0,83.0
0.073,6,10,1506,5,395,15.0,127.0,127.0,5,1111,16.0,843.0,843.0
240.426,6,35,8927,18,2073,14142.0,694.0,225.0,17,6854,15026.0,1402.0,597.0
0.009,6,10,1990,5,911,2.0,643.0,643.0,5,1079,2.0,811.0,811.0
0.004,6,10,2006,5,927,1.0,659.0,659.0,5,1079,1.0,811.0,811.0
0.011,6,10,1990,5,911,2.0,643.0,643.0,5,1079,2.0,811.0,811.0
0.041,17,2,152,1,76,0.0,48.0,48.0,1,76,0.0,48.0,48.0
0.011,6,10,1990,5,911,2.0,643.0,643.0,5,1079,2.0,811.0,811.0
0.023,6,10,1983,5,910,5.0,642.0,642.0,5,1073,5.0,805.0,805.0
0.005,6,10,1689,5,839,1.0,571.0,571.0,5,850,1.0,582.0,582.0
15.084,17,15,8093,8,5949,2150.0,1350.0,715.0,7,2144,2509.0,1350.0,278.0
0.007,6,10,1547,5,764,1.0,496.0,496.0,5,783,1.0,515.0,515.0
0.005,17,2,166,1,75,0.0,47.0,47.0,1,91,0.0,63.0,63.0
0.099,6,10,1506,5,395,23.0,127.0,127.0,5,1111,22.0,843.0,843.0
0.004,6,10,1702,5,863,1.0,595.0,595.0,5,839,1.0,571.0,571.0
40.067,17,10,676,5,460,10015.0,104.0,64.0,5,216,10015.0,20.0,15.0
0.007,6,13,3747,7,509,1.0,137.0,137.0,6,3238,1.0,1470.0,1459.0
1792.801,6,569,189554,288,163644,6246.0,2883.0,890.0,281,25910,6402.0,380.0,108.0
0.005,6,10,1643,5,860,1.0,592.0,592.0,5,783,1.0,515.0,515.0
0.011,6,10,1990,5,911,2.0,643.0,643.0,5,1079,2.0,811.0,811.0
0.006,6,10,1547,5,764,1.0,496.0,496.0,5,783,1.0,515.0,515.0
0.005,6,10,1779,5,928,1.0,660.0,660.0,5,851,1.0,583.0,583.0
0.004,6,10,1989,5,927,1.0,659.0,659.0,5,1062,1.0,794.0,794.0
0.005,6,10,2000,5,927,1.0,659.0,659.0,5,1073,1.0,805.0,805.0
0.028,6,10,1990,5,911,7.0,643.0,643.0,5,1079,7.0,811.0,811.0
0.004,6,10,1989,5,927,1.0,659.0,659.0,5,1062,1.0,794.0,794.0
0.048,6,10,1990,5,911,12.0,643.0,643.0,5,1079,11.0,811.0,811.0
0.037,17,2,148,1,60,0.0,32.0,32.0,1,88,0.0,60.0,60.0
0.006,6,10,1643,5,860,1.0,592.0,592.0,5,783,1.0,515.0,515.0
0.005,6,10,1547,5,764,1.0,496.0,496.0,5,783,1.0,515.0,515.0
1781.755,6,274,38226,112,21500,16050.0,2790.0,192.0,162,16726,11066.0,1360.0,129.0
0.004,6,10,2006,5,927,1.0,659.0,659.0,5,1079,1.0,811.0,811.0
1778.147,17,144,45504,72,22752,25044.0,288.0,288.0,72,22752,25044.0,288.0,288.0
0.004,17,2,136,1,60,0.0,32.0,32.0,1,76,0.0,48.0,48.0
0.006,6,10,1854,5,889,1.0,621.0,621.0,5,965,1.0,697.0,697.0
11.121,17,28,4421,14,1994,843.0,269.0,114.0,14,2427,843.0,586.0,145.0
309.96,17,20,1124,10,716,34425.0,48.0,43.0,10,408,34425.0,20.0,12.0
0.006,6,10,1779,5,928,1.0,660.0,660.0,5,851,1.0,583.0,583.0
0.005,17,2,166,1,75,0.0,47.0,47.0,1,91,0.0,63.0,63.0
0.071,17,4,596,2,122,0.0,33.0,33.0,2,474,68.0,323.0,209.0
0.001,17,2,136,1,60,0.0,32.0,32.0,1,76,0.0,48.0,48.0
10.772,17,28,4422,14,1993,819.0,268.0,114.0,14,2429,819.0,588.0,145.0
0.005,6,10,1774,5,923,1.0,655.0,655.0,5,851,1.0,583.0,583.0
40.06,17,10,676,5,460,10012.0,104.0,64.0,5,216,10014.0,20.0,15.0
0.134,17,2,80,1,32,0.0,4.0,4.0,1,48,0.0,20.0,20.0
10.903,17,26,4098,13,1821,899.0,268.0,112.0,13,2277,899.0,588.0,147.0
0.009,6,10,1983,5,910,2.0,642.0,642.0,5,1073,2.0,805.0,805.0
0.006,6,10,1547,5,764,1.0,496.0,496.0,5,783,1.0,515.0,515.0
0.015,6,10,1990,5,911,3.0,643.0,643.0,5,1079,3.0,811.0,811.0
0.006,6,10,1689,5,839,1.0,571.0,571.0,5,850,1.0,582.0,582.0
0.038,17,2,148,1,60,0.0,32.0,32.0,1,88,0.0,60.0,60.0
0.003,6,10,1702,5,863,0.0,595.0,595.0,5,839,0.0,571.0,571.0
0.011,6,13,3735,7,497,1.0,125.0,125.0,6,3238,2.0,1470.0,1459.0
309.183,17,20,1124,10,716,34346.0,48.0,43.0,10,408,34346.0,20.0,12.0
0.003,17,2,136,1,60,0.0,32.0,32.0,1,76,0.0,48.0,48.0
0.006,6,10,1547,5,764,1.0,496.0,496.0,5,783,1.0,515.0,515.0
347.615,6,393,348557,200,21981,276.0,2736.0,889.0,193,326576,1810.0,2804.0,1778.0
0.005,17,2,180,1,66,0.0,38.0,38.0,1,114,0.0,86.0,86.0
0.005,6,10,1689,5,839,1.0,571.0,571.0,5,850,1.0,582.0,582.0
0.005,6,10,2006,5,927,1.0,659.0,659.0,5,1079,1.0,811.0,811.0
0.008,6,10,1990,5,911,2.0,643.0,643.0,5,1079,2.0,811.0,811.0
240.089,6,16,4481,9,963,30011.0,238.0,166.0,7,3518,40014.0,1402.0,786.0
0.001,17,2,166,1,75,0.0,47.0,47.0,1,91,0.0,63.0,63.0
0.725,6,25,5459,12,1557,55.0,325.0,152.0,13,3902,50.0,1414.0,563.0
0.001,17,2,194,1,57,0.0,29.0,29.0,1,137,0.0,109.0,109.0
0.01,6,10,1983,5,910,2.0,642.0,642.0,5,1073,2.0,805.0,805.0
0.02,6,10,1989,5,910,5.0,642.0,642.0,5,1079,4.0,811.0,811.0
0.017,6,10,1983,5,910,4.0,642.0,642.0,5,1073,4.0,805.0,805.0
10.836,17,28,4417,14,1993,824.0,268.0,114.0,14,2424,824.0,587.0,145.0
0.004,6,10,1779,5,928,1.0,660.0,660.0,5,851,0.0,583.0,583.0
40.069,17,10,676,5,460,10014.0,104.0,64.0,5,216,10016.0,20.0,15.0
0.005,6,10,2006,5,927,1.0,659.0,659.0,5,1079,1.0,811.0,811.0
0.135,17,2,80,1,32,0.0,4.0,4.0,1,48,0.0,20.0,20.0
0.001,17,2,180,1,66,0.0,38.0,38.0,1,114,0.0,86.0,86.0
0.017,6,10,1990,5,911,4.0,643.0,643.0,5,1079,4.0,811.0,811.0
0.015,6,13,3735,7,497,2.0,125.0,125.0,6,3238,3.0,1470.0,1459.0
0.009,6,10,1983,5,910,2.0,642.0,642.0,5,1073,2.0,805.0,805.0
0.04,17,2,136,1,60,0.0,32.0,32.0,1,76,0.0,48.0,48.0
0.103,6,10,1506,5,395,23.0,127.0,127.0,5,1111,23.0,843.0,843.0
0.0,17,2,136,1,60,0.0,32.0,32.0,1,76,0.0,48.0,48.0
0.012,6,10,1762,5,911,2.0,643.0,643.0,5,851,2.0,583.0,583.0
0.006,6,10,1547,5,764,1.0,496.0,496.0,5,783,1.0,515.0,515.0
0.005,6,10,2006,5,927,1.0,659.0,659.0,5,1079,1.0,811.0,811.0
0.005,6,10,1989,5,927,1.0,659.0,659.0,5,1062,1.0,794.0,794.0
12.3,17,29,4494,15,2098,866.0,269.0,111.0,14,2396,933.0,587.0,143.0
0.005,6,10,2006,5,927,1.0,659.0,659.0,5,1079,1.0,811.0,811.0
0.074,17,2,184,1,61,0.0,33.0,33.0,1,123,0.0,95.0,95.0
0.007,6,10,1547,5,764,1.0,496.0,496.0,5,783,1.0,515.0,515.0
11.387,17,28,4418,14,1994,863.0,269.0,114.0,14,2424,863.0,587.0,145.0
0.009,6,10,1989,5,910,2.0,642.0,642.0,5,1079,2.0,811.0,811.0
0.014,6,10,1989,5,910,3.0,642.0,642.0,5,1079,3.0,811.0,811.0
270.132,6,37,10581,17,4622,16883.0,1001.0,748.0,20,5959,14217.0,1162.0,377.0
0.006,6,10,1547,5,764,1.0,496.0,496.0,5,783,1.0,515.0,515.0
0.006,6,12,1698,6,863,1.0,327.0,271.0,6,835,1.0,515.0,515.0
0.12,6,10,1506,5,395,25.0,127.0,127.0,5,1111,26.0,843.0,843.0
0.04,17,2,184,1,61,0.0,33.0,33.0,1,123,0.0,95.0,95.0
0.135,6,10,1506,5,395,31.0,127.0,127.0,5,1111,31.0,843.0,843.0
0.013,6,10,1983,5,910,3.0,642.0,642.0,5,1073,3.0,805.0,805.0
0.037,17,2,184,1,61,0.0,33.0,33.0,1,123,0.0,95.0,95.0
0.004,6,10,2000,5,927,1.0,659.0,659.0,5,1073,1.0,805.0,805.0
0.004,17,2,185,1,73,0.0,45.0,45.0,1,112,0.0,84.0,84.0
0.015,6,10,1762,5,911,3.0,643.0,643.0,5,851,3.0,583.0,583.0
0.001,17,2,180,1,66,0.0,38.0,38.0,1,114,0.0,86.0,86.0
0.004,6,10,1702,5,863,1.0,595.0,595.0,5,839,1.0,571.0,571.0
0.017,6,10,1989,5,910,4.0,642.0,642.0,5,1079,4.0,811.0,811.0
0.084,6,10,1506,5,395,17.0,127.0,127.0,5,1111,18.0,843.0,843.0
0.009,6,10,1972,5,910,2.0,642.0,642.0,5,1062,2.0,794.0,794.0
0.004,6,10,2007,5,928,1.0,660.0,660.0,5,1079,1.0,811.0,811.0
0.005,6,10,2000,5,927,1.0,659.0,659.0,5,1073,1.0,805.0,805.0
0.008,6,10,1990,5,911,2.0,643.0,643.0,5,1079,2.0,811.0,811.0
0.004,6,10,1774,5,923,1.0,655.0,655.0,5,851,1.0,583.0,583.0
300.358,6,16,2170,9,684,37524.0,146.0,146.0,7,1486,50031.0,419.0,398.0
0.005,17,2,170,1,65,0.0,37.0,37.0,1,105,0.0,77.0,77.0
0.014,17,4,284,2,120,0.0,32.0,32.0,2,164,0.0,60.0,54.0
0.001,17,2,179,1,62,0.0,34.0,34.0,1,117,0.0,89.0,89.0
0.006,6,10,2007,5,928,1.0,660.0,660.0,5,1079,1.0,811.0,811.0
0.012,6,10,1972,5,910,3.0,642.0,642.0,5,1062,3.0,794.0,794.0
0.013,6,10,1989,5,910,3.0,642.0,642.0,5,1079,3.0,811.0,811.0
0.076,6,10,1506,5,395,17.0,127.0,127.0,5,1111,17.0,843.0,843.0
0.126,17,4,364,2,160,0.0,52.0,52.0,2,204,85.0,80.0,74.0
0.127,6,10,1506,5,395,25.0,127.0,127.0,5,1111,28.0,843.0,843.0
0.017,6,10,1973,5,911,4.0,643.0,643.0,5,1062,4.0,794.0,794.0
0.008,6,10,1972,5,910,2.0,642.0,642.0,5,1062,2.0,794.0,794.0
0.127,17,4,420,2,122,4.0,33.0,33.0,2,298,82.0,145.0,121.0
0.187,6,10,1506,5,395,43.0,127.0,127.0,5,1111,43.0,843.0,843.0
0.013,6,10,1990,5,911,3.0,643.0,643.0,5,1079,3.0,811.0,811.0
0.004,6,10,2006,5,927,1.0,659.0,659.0,5,1079,1.0,811.0,811.0
0.005,6,10,2006,5,927,1.0,659.0,659.0,5,1079,1.0,811.0,811.0
0.088,6,10,1506,5,395,19.0,127.0,127.0,5,1111,19.0,843.0,843.0
0.006,6,13,3747,7,509,0.0,137.0,137.0,6,3238,1.0,1470.0,1459.0
0.009,6,10,1989,5,910,2.0,642.0,642.0,5,1079,2.0,811.0,811.0
0.039,6,10,1989,5,910,9.0,642.0,642.0,5,1079,9.0,811.0,811.0
0.06,6,10,1506,5,395,13.0,127.0,127.0,5,1111,14.0,843.0,843.0
0.005,6,10,2000,5,927,1.0,659.0,659.0,5,1073,1.0,805.0,805.0
0.006,6,10,1854,5,889,1.0,621.0,621.0,5,965,1.0,697.0,697.0
0.005,6,10,2006,5,927,1.0,659.0,659.0,5,1079,1.0,811.0,811.0
0.012,6,10,1972,5,910,3.0,642.0,642.0,5,1062,3.0,794.0,794.0
0.004,6,10,2000,5,927,1.0,659.0,659.0,5,1073,1.0,805.0,805.0
0.004,6,10,2007,5,928,1.0,660.0,660.0,5,1079,1.0,811.0,811.0
1799.552,6,243,35755,151,25972,11997.0,302.0,302.0,92,9783,19775.0,102.0,83.0
0.001,17,2,136,1,60,0.0,32.0,32.0,1,76,0.0,48.0,48.0
0.153,6,10,1506,5,395,36.0,127.0,127.0,5,1111,35.0,843.0,843.0
0.01,6,10,1989,5,910,2.0,642.0,642.0,5,1079,2.0,811.0,811.0
240.012,6,9,787,5,488,60003.0,232.0,232.0,4,299,80003.0,83.0,83.0
0.005,6,10,1989,5,927,1.0,659.0,659.0,5,1062,1.0,794.0,794.0
40.069,17,10,676,5,460,10016.0,104.0,64.0,5,216,10016.0,20.0,15.0
0.004,17,2,169,1,62,0.0,34.0,34.0,1,107,0.0,79.0,79.0
0.074,6,10,1506,5,395,16.0,127.0,127.0,5,1111,17.0,843.0,843.0
0.117,6,10,1506,5,395,25.0,127.0,127.0,5,1111,27.0,843.0,843.0
40.069,17,10,676,5,460,10015.0,104.0,64.0,5,216,10015.0,20.0,15.0
0.042,17,4,284,2,120,0.0,32.0,32.0,2,164,38.0,60.0,54.0
0.131,6,10,1506,5,395,31.0,127.0,127.0,5,1111,28.0,843.0,843.0
177.229,17,90,12857,45,3024,4027.0,44.0,39.0,45,9833,4027.0,261.0,190.0
0.12,6,10,1506,5,395,28.0,127.0,127.0,5,1111,28.0,843.0,843.0
8.826,6,36,9771,18,4253,519.0,1498.0,875.0,18,5518,507.0,1360.0,398.0
0.11,6,10,1506,5,395,16.0,127.0,127.0,5,1111,25.0,843.0,843.0
0.005,6,10,1702,5,863,1.0,595.0,595.0,5,839,1.0,571.0,571.0
174.335,17,80,11574,40,2663,4470.0,44.0,38.0,40,8911,4470.0,239.0,194.0
0.001,17,2,180,1,66,0.0,38.0,38.0,1,114,0.0,86.0,86.0
0.005,6,10,1774,5,923,1.0,655.0,655.0,5,851,1.0,583.0,583.0
40.059,17,10,676,5,460,10013.0,104.0,64.0,5,216,10013.0,20.0,15.0
0.008,6,10,1990,5,911,2.0,643.0,643.0,5,1079,1.0,811.0,811.0
176.216,17,78,11199,39,2605,4637.0,44.0,38.0,39,8594,4636.0,239.0,192.0
0.017,6,10,1990,5,911,4.0,643.0,643.0,5,1079,4.0,811.0,811.0
40.061,17,10,676,5,460,10013.0,104.0,64.0,5,216,10014.0,20.0,15.0
11.238,17,28,4423,14,1994,851.0,269.0,114.0,14,2429,851.0,588.0,145.0
0.006,17,2,230,1,68,0.0,40.0,40.0,1,162,0.0,134.0,134.0
0.012,6,10,1972,5,910,3.0,642.0,642.0,5,1062,3.0,794.0,794.0
0.005,6,10,1989,5,927,1.0,659.0,659.0,5,1062,1.0,794.0,794.0
8.987,6,39,10487,20,4929,473.0,1360.0,682.0,19,5558,488.0,2667.0,435.0
0.006,6,10,2006,5,927,1.0,659.0,659.0,5,1079,1.0,811.0,811.0
0.004,6,10,1779,5,928,1.0,660.0,660.0,5,851,1.0,583.0,583.0
0.017,6,10,1762,5,911,4.0,643.0,643.0,5,851,4.0,583.0,583.0
240.167,6,45,6677,21,3170,12008.0,588.0,230.0,24,3507,10441.0,580.0,204.0
0.005,17,2,168,1,76,0.0,48.0,48.0,1,92,0.0,64.0,64.0
0.019,6,10,1989,5,910,4.0,642.0,642.0,5,1079,4.0,811.0,811.0
0.006,6,10,1689,5,839,1.0,571.0,571.0,5,850,1.0,582.0,582.0
0.006,6,13,3747,7,509,0.0,137.0,137.0,6,3238,1.0,1470.0,1459.0
0.072,6,10,1506,5,395,16.0,127.0,127.0,5,1111,16.0,843.0,843.0
0.013,6,10,1983,5,910,3.0,642.0,642.0,5,1073,3.0,805.0,805.0
0.004,17,2,170,1,65,0.0,37.0,37.0,1,105,0.0,77.0,77.0
0.177,17,2,152,1,76,0.0,48.0,48.0,1,76,0.0,48.0,48.0
0.01,6,10,1990,5,911,2.0,643.0,643.0,5,1079,2.0,811.0,811.0
0.004,6,10,2006,5,927,1.0,659.0,659.0,5,1079,1.0,811.0,811.0
0.101,6,10,1506,5,395,22.0,127.0,127.0,5,1111,24.0,843.0,843.0
0.005,6,10,2006,5,927,1.0,659.0,659.0,5,1079,1.0,811.0,811.0
0.013,6,10,1990,5,911,3.0,643.0,643.0,5,1079,3.0,811.0,811.0
0.014,6,10,1677,5,827,3.0,559.0,559.0,5,850,3.0,582.0,582.0
95.294,6,26,9525,12,1627,83.0,794.0,367.0,14,7898,7320.0,1360.0,732.0
0.004,17,2,136,1,60,0.0,32.0,32.0,1,76,0.0,48.0,48.0
0.005,17,2,166,1,75,0.0,47.0,47.0,1,91,0.0,63.0,63.0
0.012,6,10,1631,5,848,3.0,580.0,580.0,5,783,2.0,515.0,515.0
0.013,6,10,1972,5,910,3.0,642.0,642.0,5,1062,3.0,794.0,794.0
11.106,17,28,4422,14,1994,842.0,269.0,114.0,14,2428,841.0,587.0,145.0
0.012,6,10,1989,5,910,2.0,642.0,642.0,5,1079,3.0,811.0,811.0
0.013,6,10,1990,5,911,3.0,643.0,643.0,5,1079,3.0,811.0,811.0
0.005,6,10,1854,5,889,1.0,621.0,621.0,5,965,1.0,697.0,697.0
0.005,17,2,140,1,62,0.0,34.0,34.0,1,78,0.0,50.0,50.0
0.014,6,10,1989,5,910,3.0,642.0,642.0,5,1079,3.0,811.0,811.0
0.008,6,10,1989,5,927,2.0,659.0,659.0,5,1062,1.0,794.0,794.0
240.131,6,33,10042,16,7587,16008.0,1515.0,674.0,17,2455,15008.0,580.0,195.0
0.008,6,10,1983,5,910,2.0,642.0,642.0,5,1073,1.0,805.0,805.0
15.073,17,15,9238,8,6902,2149.0,1350.0,834.0,7,2336,2507.0,1350.0,305.0
0.018,6,13,3747,7,509,2.0,137.0,137.0,6,3238,3.0,1470.0,1459.0
0.018,6,10,1677,5,827,4.0,559.0,559.0,5,850,4.0,582.0,582.0
0.072,17,2,166,1,75,0.0,47.0,47.0,1,91,0.0,63.0,63.0
0.008,17,4,284,2,120,0.0,32.0,32.0,2,164,0.0,60.0,54.0
0.011,6,10,1989,5,910,2.0,642.0,642.0,5,1079,2.0,811.0,811.0
0.117,17,2,80,1,32,0.0,4.0,4.0,1,48,0.0,20.0,20.0
0.004,17,2,152,1,76,0.0,48.0,48.0,1,76,0.0,48.0,48.0
0.008,6,10,1990,5,911,2.0,643.0,643.0,5,1079,2.0,811.0,811.0
0.005,6,10,2006,5,927,1.0,659.0,659.0,5,1079,1.0,811.0,811.0
0.047,17,2,136,1,60,0.0,32.0,32.0,1,76,0.0,48.0,48.0
0.006,6,10,1547,5,764,1.0,496.0,496.0,5,783,1.0,515.0,515.0
0.008,6,10,1989,5,910,1.0,642.0,642.0,5,1079,2.0,811.0,811.0
0.079,6,10,1506,5,395,17.0,127.0,127.0,5,1111,16.0,843.0,843.0
0.072,6,10,1506,5,395,15.0,127.0,127.0,5,1111,14.0,843.0,843.0
0.005,6,10,1689,5,839,1.0,571.0,571.0,5,850,1.0,582.0,582.0
0.004,6,10,1989,5,927,1.0,659.0,659.0,5,1062,1.0,794.0,794.0
0.008,6,10,1990,5,911,2.0,643.0,643.0,5,1079,2.0,811.0,811.0
10.761,17,28,4424,14,1995,819.0,270.0,114.0,14,2429,818.0,588.0,145.0
0.004,17,2,164,1,74,0.0,46.0,46.0,1,90,0.0,62.0,62.0
0.005,6,10,1854,5,889,1.0,621.0,621.0,5,965,1.0,697.0,697.0
0.01,6,10,1762,5,911,2.0,643.0,643.0,5,851,2.0,583.0,583.0
328.895,17,20,1124,10,716,36529.0,48.0,43.0,10,408,36529.0,20.0,12.0
0.012,6,10,1972,5,910,2.0,642.0,642.0,5,1062,2.0,794.0,794.0
0.009,6,10,1990,5,911,2.0,643.0,643.0,5,1079,2.0,811.0,811.0
0.016,6,10,1990,5,911,4.0,643.0,643.0,5,1079,3.0,811.0,811.0
0.784,6,10,2009,6,1655,156.0,1403.0,1403.0,4,354,181.0,182.0,182.0
0.005,6,13,3690,7,452,0.0,80.0,80.0,6,3238,1.0,1470.0,1459.0
0.01,6,10,1983,5,910,2.0,642.0,642.0,5,1073,2.0,805.0,805.0
0.091,6,10,1506,5,395,21.0,127.0,127.0,5,1111,19.0,843.0,843.0
0.005,6,10,2006,5,927,1.0,659.0,659.0,5,1079,1.0,811.0,811.0
0.005,6,10,2000,5,927,1.0,659.0,659.0,5,1073,1.0,805.0,805.0
0.005,6,10,1643,5,860,1.0,592.0,592.0,5,783,1.0,515.0,515.0
0.17,6,3,453,2,321,170.0,241.0,241.0,1,132,0.0,92.0,92.0
0.068,6,10,1506,5,395,15.0,127.0,127.0,5,1111,16.0,843.0,843.0
0.012,6,10,1677,5,827,2.0,559.0,559.0,5,850,2.0,582.0,582.0
0.012,6,10,1989,5,910,2.0,642.0,642.0,5,1079,3.0,811.0,811.0
0.012,17,2,152,1,76,0.0,48.0,48.0,1,76,0.0,48.0,48.0
0.039,17,2,182,1,65,0.0,37.0,37.0,1,117,0.0,89.0,89.0
0.005,6,13,3747,7,509,0.0,137.0,137.0,6,3238,0.0,1470.0,1459.0
0.039,6,10,1990,5,911,9.0,643.0,643.0,5,1079,9.0,811.0,811.0
1777.535,17,144,45504,72,22752,25035.0,288.0,288.0,72,22752,25035.0,288.0,288.0
291.971,6,389,347982,188,21349,1561.0,2736.0,889.0,201,326633,1459.0,2804.0,1690.0
0.095,6,10,1506,5,395,21.0,127.0,127.0,5,1111,22.0,843.0,843.0
0.005,6,10,2006,5,927,1.0,659.0,659.0,5,1079,1.0,811.0,811.0
0.005,6,10,2006,5,927,1.0,659.0,659.0,5,1079,1.0,811.0,811.0
0.005,6,10,2006,5,927,1.0,659.0,659.0,5,1079,1.0,811.0,811.0
0.005,17,2,140,1,62,0.0,34.0,34.0,1,78,0.0,50.0,50.0
0.003,17,2,152,1,76,0.0,48.0,48.0,1,76,0.0,48.0,48.0
0.076,6,10,1506,5,395,15.0,127.0,127.0,5,1111,16.0,843.0,843.0
0.005,6,10,2006,5,927,1.0,659.0,659.0,5,1079,1.0,811.0,811.0
0.005,17,2,170,1,65,0.0,37.0,37.0,1,105,0.0,77.0,77.0
0.127,17,4,580,2,122,0.0,33.0,33.0,2,458,87.0,307.0,201.0
0.005,6,13,3747,7,509,0.0,137.0,137.0,6,3238,0.0,1470.0,1459.0
0.102,6,10,1506,5,395,20.0,127.0,127.0,5,1111,22.0,843.0,843.0
0.061,6,10,1506,5,395,13.0,127.0,127.0,5,1111,13.0,843.0,843.0
0.012,6,10,1677,5,827,3.0,559.0,559.0,5,850,3.0,582.0,582.0
0.019,6,10,1983,5,910,4.0,642.0,642.0,5,1073,4.0,805.0,805.0
0.007,17,2,194,1,59,0.0,31.0,31.0,1,135,0.0,107.0,107.0
280.493,6,24,6115,11,1226,28049.0,267.0,156.0,13,4889,23365.0,1400.0,873.0
0.009,6,12,1926,6,1189,1.0,659.0,434.0,6,737,1.0,417.0,417.0
1777.731,17,144,41760,72,22752,25038.0,288.0,288.0,72,19008,25038.0,236.0,236.0
0.085,6,10,1506,5,395,20.0,127.0,127.0,5,1111,16.0,843.0,843.0
1.097,6,30,13240,17,5841,68.0,2720.0,854.0,13,7399,77.0,2720.0,858.0
0.163,6,33,8886,17,2013,9.0,490.0,219.0,16,6873,10.0,1368.0,603.0
0.034,17,2,152,1,76,0.0,48.0,48.0,1,76,0.0,48.0,48.0
21.909,6,30,11360,17,1942,1369.0,506.0,350.0,13,9418,1825.0,1488.0,970.0
0.01,6,10,1762,5,911,2.0,643.0,643.0,5,851,2.0,583.0,583.0
0.004,6,10,2006,5,927,1.0,659.0,659.0,5,1079,1.0,811.0,811.0
352.247,6,20,2210,6,1308,12004.0,494.0,494.0,14,902,27095.0,83.0,83.0
0.005,17,2,317,1,71,0.0,43.0,43.0,1,246,0.0,218.0,218.0
0.006,6,10,1547,5,764,1.0,496.0,496.0,5,783,1.0,515.0,515.0
0.014,6,10,1989,5,910,3.0,642.0,642.0,5,1079,3.0,811.0,811.0
40.494,6,67,33552,36,4005,1156.0,801.0,234.0,31,29547,1349.0,3116.0,1214.0
0.08,6,10,1506,5,395,18.0,127.0,127.0,5,1111,16.0,843.0,843.0
40.112,6,39,11267,22,3168,1909.0,1221.0,251.0,17,8099,2506.0,2694.0,656.0
0.005,6,10,1689,5,839,1.0,571.0,571.0,5,850,1.0,582.0,582.0
40.068,17,10,676,5,460,10014.0,104.0,64.0,5,216,10016.0,20.0,15.0
0.004,6,10,2000,5,927,1.0,659.0,659.0,5,1073,1.0,805.0,805.0
0.016,6,10,1989,5,910,4.0,642.0,642.0,5,1079,3.0,811.0,811.0
11.029,17,28,4393,14,1993,835.0,268.0,114.0,14,2400,838.0,587.0,143.0
0.097,6,10,1506,5,395,22.0,127.0,127.0,5,1111,19.0,843.0,843.0
0.005,17,2,136,1,60,0.0,32.0,32.0,1,76,0.0,48.0,48.0
0.004,6,10,1702,5,863,1.0,595.0,595.0,5,839,0.0,571.0,571.0
0.001,17,2,180,1,65,0.0,37.0,37.0,1,115,0.0,87.0,87.0
0.005,6,10,1989,5,927,1.0,659.0,659.0,5,1062,1.0,794.0,794.0
0.006,6,10,1547,5,764,1.0,496.0,496.0,5,783,1.0,515.0,515.0
0.067,6,10,1506,5,395,15.0,127.0,127.0,5,1111,13.0,843.0,843.0
0.013,6,10,1972,5,910,3.0,642.0,642.0,5,1062,3.0,794.0,794.0
0.004,17,2,148,1,60,0.0,32.0,32.0,1,88,0.0,60.0,60.0
64.566,6,42,13468,21,7601,453.0,1935.0,1121.0,21,5867,3220.0,2667.0,385.0
313.814,17,20,1124,10,716,34853.0,48.0,43.0,10,408,34851.0,20.0,12.0
0.028,6,13,3735,7,497,4.0,125.0,125.0,6,3238,5.0,1470.0,1459.0
0.012,6,10,1762,5,911,3.0,643.0,643.0,5,851,2.0,583.0,583.0
0.005,6,10,1702,5,863,1.0,595.0,595.0,5,839,1.0,571.0,571.0
0.059,17,2,152,1,76,0.0,48.0,48.0,1,76,0.0,48.0,48.0
0.011,6,10,1990,5,911,2.0,643.0,643.0,5,1079,2.0,811.0,811.0
0.003,17,4,284,2,120,0.0,32.0,32.0,2,164,0.0,60.0,54.0
0.005,17,2,136,1,60,0.0,32.0,32.0,1,76,0.0,48.0,48.0
40.082,17,10,676,5,460,10017.0,104.0,64.0,5,216,10019.0,20.0,15.0
0.009,6,10,1973,5,911,2.0,643.0,643.0,5,1062,2.0,794.0,794.0
0.005,6,10,1643,5,860,1.0,592.0,592.0,5,783,1.0,515.0,515.0
0.013,17,2,152,1,56,0.0,28.0,28.0,1,96,0.0,68.0,68.0
0.005,6,10,1779,5,928,1.0,660.0,660.0,5,851,1.0,583.0,583.0
0.001,17,2,180,1,66,0.0,38.0,38.0,1,114,0.0,86.0,86.0
351.991,6,20,2210,6,1308,12003.0,494.0,494.0,14,902,27076.0,83.0,83.0
40.057,17,10,676,5,460,10013.0,104.0,64.0,5,216,10013.0,20.0,15.0
0.007,6,10,1989,5,910,1.0,642.0,642.0,5,1079,1.0,811.0,811.0
503.061,6,39,14041,21,3503,25153.0,676.0,400.0,18,10538,26059.0,1402.0,872.0
240.095,6,16,4481,9,963,30011.0,238.0,166.0,7,3518,40015.0,1402.0,786.0
0.017,6,10,1990,5,911,4.0,643.0,643.0,5,1079,4.0,811.0,811.0
15.2,17,46,27071,27,23494,583.0,1350.0,842.0,19,3577,843.0,1350.0,160.0
0.074,6,10,1506,5,395,17.0,127.0,127.0,5,1111,15.0,843.0,843.0
0.007,6,10,2006,5,927,1.0,659.0,659.0,5,1079,1.0,811.0,811.0
0.005,17,2,146,1,65,0.0,37.0,37.0,1,81,0.0,53.0,53.0
0.005,6,10,1774,5,923,1.0,655.0,655.0,5,851,1.0,583.0,583.0
0.007,6,10,1689,5,839,1.0,571.0,571.0,5,850,1.0,582.0,582.0
240.073,6,20,4872,10,889,26674.0,180.0,93.0,10,3983,26674.0,1591.0,575.0
0.006,6,10,1547,5,764,1.0,496.0,496.0,5,783,1.0,515.0,515.0
0.005,17,2,136,1,60,0.0,32.0,32.0,1,76,0.0,48.0,48.0
0.018,6,10,1972,5,910,4.0,642.0,642.0,5,1062,4.0,794.0,794.0
0.061,6,10,1506,5,395,13.0,127.0,127.0,5,1111,13.0,843.0,843.0
0.015,17,2,169,1,62,0.0,34.0,34.0,1,107,0.0,79.0,79.0
0.001,17,2,136,1,60,0.0,32.0,32.0,1,76,0.0,48.0,48.0
0.004,17,2,148,1,60,0.0,32.0,32.0,1,88,0.0,60.0,60.0
0.087,6,10,1506,5,395,18.0,127.0,127.0,5,1111,16.0,843.0,843.0
0.09,6,10,1506,5,395,19.0,127.0,127.0,5,1111,20.0,843.0,843.0
0.151,6,10,1506,5,395,36.0,127.0,127.0,5,1111,35.0,843.0,843.0
0.011,6,10,1972,5,910,2.0,642.0,642.0,5,1062,2.0,794.0,794.0
0.045,6,10,1972,5,910,11.0,642.0,642.0,5,1062,11.0,794.0,794.0
0.005,6,10,2000,5,927,1.0,659.0,659.0,5,1073,1.0,805.0,805.0
0.108,6,10,1506,5,395,23.0,127.0,127.0,5,1111,21.0,843.0,843.0
0.02,6,10,1631,5,848,5.0,580.0,580.0,5,783,5.0,515.0,515.0
0.1,6,10,1506,5,395,23.0,127.0,127.0,5,1111,23.0,843.0,843.0
0.01,6,10,1989,5,910,2.0,642.0,642.0,5,1079,2.0,811.0,811.0
0.004,17,2,148,1,60,0.0,32.0,32.0,1,88,0.0,60.0,60.0
0.005,6,10,2000,5,927,1.0,659.0,659.0,5,1073,1.0,805.0,805.0
0.011,6,10,1990,5,911,2.0,643.0,643.0,5,1079,2.0,811.0,811.0
0.016,17,2,198,1,91,0.0,63.0,63.0,1,107,0.0,79.0,79.0
0.109,6,10,1506,5,395,24.0,127.0,127.0,5,1111,25.0,843.0,843.0
0.098,6,10,1506,5,395,21.0,127.0,127.0,5,1111,20.0,843.0,843.0
321.564,17,20,1124,10,716,35715.0,48.0,43.0,10,408,35715.0,20.0,12.0
0.006,6,10,1854,5,889,1.0,621.0,621.0,5,965,1.0,697.0,697.0
0.004,17,2,148,1,60,0.0,32.0,32.0,1,88,0.0,60.0,60.0
40.072,17,10,676,5,460,10015.0,104.0,64.0,5,216,10017.0,20.0,15.0
0.007,6,10,1547,5,764,1.0,496.0,496.0,5,783,1.0,515.0,515.0
0.007,6,10,1689,5,839,1.0,571.0,571.0,5,850,1.0,582.0,582.0
0.004,6,10,2007,5,928,1.0,660.0,660.0,5,1079,1.0,811.0,811.0
0.132,17,2,80,1,32,0.0,4.0,4.0,1,48,0.0,20.0,20.0
0.004,17,2,184,1,61,0.0,33.0,33.0,1,123,0.0,95.0,95.0
0.016,6,10,1990,5,911,3.0,643.0,643.0,5,1079,4.0,811.0,811.0
0.104,6,10,1506,5,395,23.0,127.0,127.0,5,1111,24.0,843.0,843.0
0.006,6,10,1854,5,889,1.0,621.0,621.0,5,965,1.0,697.0,697.0
0.006,6,10,1547,5,764,1.0,496.0,496.0,5,783,1.0,515.0,515.0
0.005,6,10,1854,5,889,1.0,621.0,621.0,5,965,1.0,697.0,697.0
0.012,6,10,1972,5,910,3.0,642.0,642.0,5,1062,3.0,794.0,794.0
0.07,17,8,3613,4,1874,23.0,1350.0,440.0,4,1739,12.0,1350.0,406.0
0.072,6,10,1506,5,395,15.0,127.0,127.0,5,1111,17.0,843.0,843.0
0.009,6,10,1762,5,911,2.0,643.0,643.0,5,851,2.0,583.0,583.0
0.08,6,10,1506,5,395,17.0,127.0,127.0,5,1111,17.0,843.0,843.0
0.003,17,4,284,2,120,0.0,32.0,32.0,2,164,0.0,60.0,54.0
0.005,17,2,212,1,74,0.0,46.0,46.0,1,138,0.0,110.0,110.0
0.004,6,10,1774,5,923,1.0,655.0,655.0,5,851,1.0,583.0,583.0
0.004,17,4,284,2,120,0.0,32.0,32.0,2,164,0.0,60.0,54.0
0.003,17,2,148,1,60,0.0,32.0,32.0,1,88,0.0,60.0,60.0
0.01,6,10,1989,5,910,2.0,642.0,642.0,5,1079,2.0,811.0,811.0
40.076,17,10,676,5,460,10017.0,104.0,64.0,5,216,10017.0,20.0,15.0
0.004,6,10,2006,5,927,1.0,659.0,659.0,5,1079,1.0,811.0,811.0
40.058,17,10,676,5,460,10013.0,104.0,64.0,5,216,10013.0,20.0,15.0
368.827,6,22,2313,16,867,24588.0,195.0,195.0,6,1446,4653.0,419.0,398.0
0.008,6,10,1989,5,910,1.0,642.0,642.0,5,1079,2.0,811.0,811.0
0.005,6,10,1989,5,927,1.0,659.0,659.0,5,1062,1.0,794.0,794.0
308.205,17,20,1124,10,716,34238.0,48.0,43.0,10,408,34238.0,20.0,12.0
0.1,6,10,1506,5,395,22.0,127.0,127.0,5,1111,22.0,843.0,843.0
0.006,6,10,1854,5,889,1.0,621.0,621.0,5,965,1.0,697.0,697.0
0.014,6,10,1989,5,910,3.0,642.0,642.0,5,1079,3.0,811.0,811.0
0.012,6,10,1983,5,910,3.0,642.0,642.0,5,1073,2.0,805.0,805.0
0.007,17,2,299,1,65,0.0,37.0,37.0,1,234,0.0,206.0,206.0
0.097,6,10,1506,5,395,21.0,127.0,127.0,5,1111,20.0,843.0,843.0
0.006,6,10,1774,5,923,1.0,655.0,655.0,5,851,1.0,583.0,583.0
0.012,6,10,1972,5,910,3.0,642.0,642.0,5,1062,3.0,794.0,794.0
0.04,17,2,152,1,76,0.0,48.0,48.0,1,76,0.0,48.0,48.0
30.223,6,43,16276,24,6430,1306.0,1360.0,679.0,19,9846,1668.0,2720.0,756.0
0.008,6,10,1762,5,911,2.0,643.0,643.0,5,851,2.0,583.0,583.0
0.013,6,10,1983,5,910,3.0,642.0,642.0,5,1073,3.0,805.0,805.0
0.006,6,10,1547,5,764,1.0,496.0,496.0,5,783,1.0,515.0,515.0
0.07,17,8,3613,4,1874,23.0,1350.0,440.0,4,1739,12.0,1350.0,406.0
0.004,17,2,148,1,60,0.0,32.0,32.0,1,88,0.0,60.0,60.0
0.004,6,10,2007,5,928,1.0,660.0,660.0,5,1079,1.0,811.0,811.0
0.014,6,10,1983,5,910,3.0,642.0,642.0,5,1073,3.0,805.0,805.0
0.001,17,2,166,1,75,0.0,47.0,47.0,1,91,0.0,63.0,63.0
40.067,17,10,676,5,460,10016.0,104.0,64.0,5,216,10016.0,20.0,15.0
0.004,6,10,2006,5,927,1.0,659.0,659.0,5,1079,1.0,811.0,811.0
0.009,6,14,3787,7,497,1.0,125.0,125.0,7,3290,1.0,1448.0,972.0
240.295,6,43,8773,21,5686,12014.0,1515.0,509.0,22,3087,11442.0,580.0,241.0
0.003,17,4,284,2,120,0.0,32.0,32.0,2,164,0.0,60.0,54.0
0.005,6,10,1774,5,923,1.0,655.0,655.0,5,851,1.0,583.0,583.0
0.006,6,10,1547,5,764,1.0,496.0,496.0,5,783,1.0,515.0,515.0
0.006,17,2,193,1,71,0.0,43.0,43.0,1,122,0.0,94.0,94.0
40.063,17,10,676,5,460,10013.0,104.0,64.0,5,216,10014.0,20.0,15.0
0.015,6,10,1989,5,910,3.0,642.0,642.0,5,1079,3.0,811.0,811.0
40.057,17,10,676,5,460,10013.0,104.0,64.0,5,216,10013.0,20.0,15.0
0.082,6,10,1506,5,395,16.0,127.0,127.0,5,1111,18.0,843.0,843.0
723.117,17,142,20873,71,4779,10330.0,44.0,39.0,71,16094,10330.0,239.0,198.0
0.101,6,10,1506,5,395,21.0,127.0,127.0,5,1111,21.0,843.0,843.0
0.004,17,4,284,2,120,0.0,32.0,32.0,2,164,1.0,60.0,54.0
0.012,6,10,1762,5,911,3.0,643.0,643.0,5,851,2.0,583.0,583.0
321.315,17,20,1124,10,716,35687.0,48.0,43.0,10,408,35687.0,20.0,12.0
0.016,6,10,1990,5,911,3.0,643.0,643.0,5,1079,4.0,811.0,811.0
0.187,17,16,8876,8,6435,26.0,1350.0,776.0,8,2441,18.0,1350.0,277.0
0.004,6,10,2006,5,927,1.0,659.0,659.0,5,1079,1.0,811.0,811.0
0.012,6,10,1762,5,911,3.0,643.0,643.0,5,851,3.0,583.0,583.0
0.003,17,2,152,1,76,0.0,48.0,48.0,1,76,0.0,48.0,48.0
0.014,6,10,1972,5,910,3.0,642.0,642.0,5,1062,3.0,794.0,794.0
0.069,6,10,1506,5,395,15.0,127.0,127.0,5,1111,15.0,843.0,843.0
0.108,6,10,1506,5,395,23.0,127.0,127.0,5,1111,24.0,843.0,843.0
0.772,6,10,2009,6,1655,154.0,1403.0,1403.0,4,354,179.0,182.0,182.0
0.02,6,10,1989,5,910,4.0,642.0,642.0,5,1079,5.0,811.0,811.0
0.069,17,8,3613,4,1874,23.0,1350.0,440.0,4,1739,12.0,1350.0,406.0
0.012,6,10,1989,5,910,3.0,642.0,642.0,5,1079,2.0,811.0,811.0
0.003,17,4,284,2,120,0.0,32.0,32.0,2,164,0.0,60.0,54.0
0.107,6,10,1506,5,395,24.0,127.0,127.0,5,1111,23.0,843.0,843.0
0.005,17,2,166,1,75,0.0,47.0,47.0,1,91,0.0,63.0,63.0
0.005,6,10,1547,5,764,1.0,496.0,496.0,5,783,1.0,515.0,515.0
0.117,6,10,1506,5,395,25.0,127.0,127.0,5,1111,28.0,843.0,843.0
0.012,6,10,1989,5,910,3.0,642.0,642.0,5,1079,2.0,811.0,811.0
40.065,17,10,676,5,460,10013.0,104.0,64.0,5,216,10015.0,20.0,15.0
0.003,17,2,136,1,60,0.0,32.0,32.0,1,76,0.0,48.0,48.0
0.001,17,2,136,1,60,0.0,32.0,32.0,1,76,0.0,48.0,48.0
0.004,6,10,2006,5,927,1.0,659.0,659.0,5,1079,1.0,811.0,811.0
0.005,17,2,144,1,64,0.0,36.0,36.0,1,80,0.0,52.0,52.0
0.001,17,2,180,1,66,0.0,38.0,38.0,1,114,0.0,86.0,86.0
0.006,17,2,136,1,60,0.0,32.0,32.0,1,76,0.0,48.0,48.0
0.012,6,13,3735,7,497,2.0,125.0,125.0,6,3238,2.0,1470.0,1459.0
0.007,6,10,1983,5,910,1.0,642.0,642.0,5,1073,1.0,805.0,805.0
0.114,6,10,1506,5,395,27.0,127.0,127.0,5,1111,25.0,843.0,843.0
0.099,6,10,1506,5,395,22.0,127.0,127.0,5,1111,23.0,843.0,843.0
0.041,6,10,1989,5,910,10.0,642.0,642.0,5,1079,10.0,811.0,811.0
0.005,6,14,3799,7,509,0.0,137.0,137.0,7,3290,0.0,1448.0,972.0
0.015,6,10,1989,5,910,3.0,642.0,642.0,5,1079,3.0,811.0,811.0
40.051,17,10,676,5,460,10010.0,104.0,64.0,5,216,10011.0,20.0,15.0
0.018,6,10,1631,5,848,4.0,580.0,580.0,5,783,4.0,515.0,515.0
0.192,17,17,9115,8,6567,27.0,1350.0,792.0,9,2548,18.0,1350.0,255.0
0.069,6,10,1506,5,395,15.0,127.0,127.0,5,1111,14.0,843.0,843.0
0.163,17,2,152,1,76,0.0,48.0,48.0,1,76,0.0,48.0,48.0
0.02,6,10,1677,5,827,4.0,559.0,559.0,5,850,4.0,582.0,582.0
0.005,6,10,2006,5,927,1.0,659.0,659.0,5,1079,1.0,811.0,811.0
5.143,58,2,144,1,72,0.0,24.0,24.0,1,72,0.0,24.0,24.0
0.004,6,10,2007,5,928,1.0,660.0,660.0,5,1079,1.0,811.0,811.0
0.011,6,10,1972,5,910,2.0,642.0,642.0,5,1062,2.0,794.0,794.0
1729.241,6,60,4400,40,2740,44339.0,33.0,33.0,20,1660,91003.0,31.0,31.0
0.093,6,10,1506,5,395,20.0,127.0,127.0,5,1111,19.0,843.0,843.0
0.004,17,2,136,1,60,0.0,32.0,32.0,1,76,0.0,48.0,48.0
0.007,6,10,1972,5,910,1.0,642.0,642.0,5,1062,1.0,794.0,794.0
0.008,6,12,1926,6,1189,1.0,659.0,434.0,6,737,1.0,417.0,417.0
10.851,17,28,4418,14,1994,826.0,269.0,114.0,14,2424,826.0,587.0,145.0
0.014,6,10,1972,5,910,3.0,642.0,642.0,5,1062,3.0,794.0,794.0
0.087,6,10,1506,5,395,18.0,127.0,127.0,5,1111,20.0,843.0,843.0
0.014,6,10,1990,5,911,3.0,643.0,643.0,5,1079,3.0,811.0,811.0
0.01,6,10,1762,5,911,2.0,643.0,643.0,5,851,2.0,583.0,583.0
40.055,17,10,676,5,460,10012.0,104.0,64.0,5,216,10013.0,20.0,15.0
0.124,17,2,80,1,32,0.0,4.0,4.0,1,48,0.0,20.0,20.0
0.005,6,10,1779,5,928,1.0,660.0,660.0,5,851,1.0,583.0,583.0
0.011,6,12,1926,6,1189,2.0,659.0,434.0,6,737,2.0,417.0,417.0
0.001,17,2,174,1,72,0.0,44.0,44.0,1,102,0.0,74.0,74.0
40.055,17,10,676,5,460,10012.0,104.0,64.0,5,216,10012.0,20.0,15.0
0.177,6,3,453,2,321,177.0,241.0,241.0,1,132,0.0,92.0,92.0
0.004,6,10,2000,5,927,1.0,659.0,659.0,5,1073,1.0,805.0,805.0
0.005,6,10,1989,5,927,1.0,659.0,659.0,5,1062,1.0,794.0,794.0
0.001,17,2,136,1,60,0.0,32.0,32.0,1,76,0.0,48.0,48.0
301.023,6,44,16491,23,10624,13682.0,3166.0,1381.0,21,5867,442.0,2667.0,385.0
369.934,6,22,2313,16,867,24662.0,195.0,195.0,6,1446,4678.0,419.0,398.0
0.008,6,10,1989,5,910,2.0,642.0,642.0,5,1079,2.0,811.0,811.0
0.005,6,14,3742,8,504,0.0,80.0,80.0,6,3238,0.0,1470.0,1459.0
9.038,17,6,376,5,280,2259.0,28.0,28.0,1,96,0.0,68.0,68.0
0.004,6,10,1779,5,928,1.0,660.0,660.0,5,851,1.0,583.0,583.0
0.078,6,10,1506,5,395,16.0,127.0,127.0,5,1111,17.0,843.0,843.0
0.023,6,10,1990,5,911,5.0,643.0,643.0,5,1079,5.0,811.0,811.0
1778.586,17,143,41496,72,22752,25050.0,288.0,288.0,71,18744,25408.0,236.0,236.0
0.004,17,4,284,2,120,1.0,32.0,32.0,2,164,0.0,60.0,54.0
0.013,6,10,1972,5,910,3.0,642.0,642.0,5,1062,3.0,794.0,794.0
0.015,17,2,198,1,91,0.0,63.0,63.0,1,107,0.0,79.0,79.0
0.034,6,10,1990,5,911,8.0,643.0,643.0,5,1079,8.0,811.0,811.0
40.065,17,10,676,5,460,10014.0,104.0,64.0,5,216,10015.0,20.0,15.0
300.381,6,16,2170,9,684,37527.0,146.0,146.0,7,1486,50035.0,419.0,398.0
8.976,6,40,10527,20,4929,472.0,1360.0,682.0,20,5598,461.0,1360.0,398.0
0.005,6,10,1547,5,764,1.0,496.0,496.0,5,783,1.0,515.0,515.0
173.216,17,78,10995,39,2593,4558.0,44.0,38.0,39,8402,4558.0,261.0,187.0
0.013,6,10,1631,5,848,3.0,580.0,580.0,5,783,3.0,515.0,515.0
0.019,6,10,1989,5,910,4.0,642.0,642.0,5,1079,4.0,811.0,811.0
240.087,6,16,4480,9,963,30010.0,238.0,166.0,7,3517,40014.0,1402.0,786.0
0.078,6,10,1506,5,395,17.0,127.0,127.0,5,1111,15.0,843.0,843.0
0.004,6,10,2006,5,927,1.0,659.0,659.0,5,1079,1.0,811.0,811.0
310.021,17,20,1124,10,716,34431.0,48.0,43.0,10,408,34432.0,20.0,12.0
0.006,17,2,179,1,71,0.0,43.0,43.0,1,108,0.0,80.0,80.0
166.328,17,76,10710,38,2529,4495.0,44.0,38.0,38,8181,4495.0,239.0,187.0
300.023,6,12,1782,7,1348,50003.0,494.0,494.0,5,434,75005.0,83.0,83.0
0.011,6,10,1677,5,827,2.0,559.0,559.0,5,850,2.0,582.0,582.0
0.019,6,10,1972,5,910,4.0,642.0,642.0,5,1062,4.0,794.0,794.0
0.003,17,2,412,1,61,0.0,33.0,33.0,1,351,0.0,323.0,323.0
311.006,17,20,1124,10,716,34542.0,48.0,43.0,10,408,34542.0,20.0,12.0
0.005,6,10,2006,5,927,1.0,659.0,659.0,5,1079,1.0,811.0,811.0
0.071,6,10,1506,5,395,16.0,127.0,127.0,5,1111,16.0,843.0,843.0
40.063,17,10,676,5,460,10014.0,104.0,64.0,5,216,10015.0,20.0,15.0
0.112,6,10,1506,5,395,27.0,127.0,127.0,5,1111,24.0,843.0,843.0
0.014,6,10,1983,5,910,3.0,642.0,642.0,5,1073,3.0,805.0,805.0
40.062,17,10,676,5,460,10014.0,104.0,64.0,5,216,10014.0,20.0,15.0
0.006,17,2,179,1,71,0.0,43.0,43.0,1,108,0.0,80.0,80.0
0.013,6,10,1972,5,910,3.0,642.0,642.0,5,1062,3.0,794.0,794.0
0.013,6,10,1990,5,911,3.0,643.0,643.0,5,1079,3.0,811.0,811.0
0.083,6,10,1506,5,395,18.0,127.0,127.0,5,1111,18.0,843.0,843.0
0.005,6,10,2000,5,927,1.0,659.0,659.0,5,1073,1.0,805.0,805.0
0.006,6,10,1689,5,839,1.0,571.0,571.0,5,850,1.0,582.0,582.0
0.006,6,10,1689,5,839,1.0,571.0,571.0,5,850,1.0,582.0,582.0
0.01,6,10,1972,5,910,2.0,642.0,642.0,5,1062,2.0,794.0,794.0
0.083,6,10,1506,5,395,19.0,127.0,127.0,5,1111,17.0,843.0,843.0
0.099,6,10,1506,5,395,23.0,127.0,127.0,5,1111,20.0,843.0,843.0
0.012,6,10,1631,5,848,3.0,580.0,580.0,5,783,3.0,515.0,515.0
352.242,6,20,2210,6,1308,12003.0,494.0,494.0,14,902,27095.0,83.0,83.0
0.004,17,2,136,1,60,0.0,32.0,32.0,1,76,0.0,48.0,48.0
0.077,6,10,1506,5,395,18.0,127.0,127.0,5,1111,16.0,843.0,843.0
0.008,6,10,1990,5,911,2.0,643.0,643.0,5,1079,2.0,811.0,811.0
0.02,6,13,3735,7,497,3.0,125.0,125.0,6,3238,4.0,1470.0,1459.0
0.001,17,2,180,1,66,0.0,38.0,38.0,1,114,0.0,86.0,86.0
0.137,6,10,1506,5,395,23.0,127.0,127.0,5,1111,30.0,843.0,843.0
0.1,6,10,1506,5,395,20.0,127.0,127.0,5,1111,22.0,843.0,843.0
0.014,6,13,3816,7,578,2.0,206.0,206.0,6,3238,2.0,1470.0,1459.0
0.001,17,2,179,1,62,0.0,34.0,34.0,1,117,0.0,89.0,89.0
0.115,6,10,1506,5,395,18.0,127.0,127.0,5,1111,26.0,843.0,843.0
0.077,6,10,1506,5,395,18.0,127.0,127.0,5,1111,15.0,843.0,843.0
0.161,17,2,152,1,76,0.0,48.0,48.0,1,76,0.0,48.0,48.0
0.041,17,4,284,2,120,0.0,32.0,32.0,2,164,38.0,60.0,54.0
0.017,6,10,1989,5,910,4.0,642.0,642.0,5,1079,4.0,811.0,811.0
0.004,17,4,284,2,120,0.0,32.0,32.0,2,164,1.0,60.0,54.0
0.005,17,2,164,1,74,0.0,46.0,46.0,1,90,0.0,62.0,62.0
0.008,6,10,1989,5,910,2.0,642.0,642.0,5,1079,1.0,811.0,811.0
0.001,17,2,180,1,66,0.0,38.0,38.0,1,114,0.0,86.0,86.0
0.01,6,13,3735,7,497,1.0,125.0,125.0,6,3238,2.0,1470.0,1459.0
0.005,17,2,170,1,65,0.0,37.0,37.0,1,105,0.0,77.0,77.0
0.006,17,2,180,1,66,0.0,38.0,38.0,1,114,0.0,86.0,86.0
0.016,6,10,1990,5,911,4.0,643.0,643.0,5,1079,3.0,811.0,811.0
0.01,6,10,1972,5,910,2.0,642.0,642.0,5,1062,2.0,794.0,794.0
0.126,6,10,1506,5,395,28.0,127.0,127.0,5,1111,27.0,843.0,843.0
164.093,17,74,10640,37,2466,4558.0,44.0,38.0,37,8174,4558.0,261.0,192.0
0.011,6,10,1989,5,910,2.0,642.0,642.0,5,1079,2.0,811.0,811.0
0.004,17,2,140,1,62,0.0,34.0,34.0,1,78,0.0,50.0,50.0
0.006,6,10,1854,5,889,1.0,621.0,621.0,5,965,1.0,697.0,697.0
0.017,6,10,1983,5,910,4.0,642.0,642.0,5,1073,4.0,805.0,805.0
0.009,6,10,1989,5,910,2.0,642.0,642.0,5,1079,2.0,811.0,811.0
0.117,6,10,1506,5,395,27.0,127.0,127.0,5,1111,27.0,843.0,843.0
0.01,6,10,1972,5,910,2.0,642.0,642.0,5,1062,2.0,794.0,794.0
0.079,6,10,1506,5,395,17.0,127.0,127.0,5,1111,18.0,843.0,843.0
0.006,6,10,1547,5,764,1.0,496.0,496.0,5,783,1.0,515.0,515.0
0.005,6,10,1689,5,839,1.0,571.0,571.0,5,850,1.0,582.0,582.0
11.082,17,29,4567,15,2167,783.0,270.0,116.0,14,2400,844.0,587.0,143.0
40.051,17,10,676,5,460,10009.0,104.0,64.0,5,216,10012.0,20.0,15.0
0.137,6,10,1506,5,395,30.0,127.0,127.0,5,1111,29.0,843.0,843.0
300.381,6,16,2170,9,684,37526.0,146.0,146.0,7,1486,50034.0,419.0,398.0
40.066,17,10,676,5,460,10013.0,104.0,64.0,5,216,10015.0,20.0,15.0
0.005,6,10,1989,5,927,1.0,659.0,659.0,5,1062,1.0,794.0,794.0
0.005,6,10,1989,5,927,1.0,659.0,659.0,5,1062,1.0,794.0,794.0
0.004,6,10,2000,5,927,1.0,659.0,659.0,5,1073,1.0,805.0,805.0
0.02,6,10,1972,5,910,5.0,642.0,642.0,5,1062,4.0,794.0,794.0
0.001,17,2,179,1,62,0.0,34.0,34.0,1,117,0.0,89.0,89.0
0.005,6,10,1547,5,764,1.0,496.0,496.0,5,783,1.0,515.0,515.0
0.005,17,2,170,1,65,0.0,37.0,37.0,1,105,0.0,77.0,77.0
0.107,6,10,1506,5,395,25.0,127.0,127.0,5,1111,24.0,843.0,843.0
40.065,17,10,676,5,460,10015.0,104.0,64.0,5,216,10015.0,20.0,15.0
0.005,6,10,1643,5,860,1.0,592.0,592.0,5,783,1.0,515.0,515.0
0.006,17,2,136,1,60,0.0,32.0,32.0,1,76,0.0,48.0,48.0
165.332,6,22,7437,11,1305,102.0,530.0,277.0,11,6132,16516.0,2720.0,946.0
0.013,6,10,1990,5,911,3.0,643.0,643.0,5,1079,3.0,811.0,811.0
0.048,6,10,1989,5,910,11.0,642.0,642.0,5,1079,12.0,811.0,811.0
0.006,6,10,1547,5,764,1.0,496.0,496.0,5,783,1.0,515.0,515.0
0.001,17,2,180,1,66,0.0,38.0,38.0,1,114,0.0,86.0,86.0
0.006,6,10,1989,5,927,1.0,659.0,659.0,5,1062,1.0,794.0,794.0
300.112,6,42,12630,22,6987,14283.0,4080.0,1212.0,20,5643,15786.0,2667.0,402.0
0.009,6,10,1989,5,910,2.0,642.0,642.0,5,1079,2.0,811.0,811.0
0.008,6,10,1989,5,910,2.0,642.0,642.0,5,1079,1.0,811.0,811.0
0.008,6,10,1989,5,910,2.0,642.0,642.0,5,1079,1.0,811.0,811.0
0.004,6,10,2006,5,927,1.0,659.0,659.0,5,1079,1.0,811.0,811.0
0.004,6,10,1702,5,863,1.0,595.0,595.0,5,839,0.0,571.0,571.0
0.005,6,10,1989,5,927,1.0,659.0,659.0,5,1062,1.0,794.0,794.0
0.005,17,2,140,1,62,0.0,34.0,34.0,1,78,0.0,50.0,50.0
40.07,17,10,676,5,460,10014.0,104.0,64.0,5,216,10016.0,20.0,15.0
0.065,6,10,1506,5,395,14.0,127.0,127.0,5,1111,14.0,843.0,843.0
0.011,6,10,1983,5,910,2.0,642.0,642.0,5,1073,2.0,805.0,805.0
0.012,6,13,3735,7,497,2.0,125.0,125.0,6,3238,2.0,1470.0,1459.0
0.001,17,2,180,1,66,0.0,38.0,38.0,1,114,0.0,86.0,86.0
0.004,6,10,2006,5,927,1.0,659.0,659.0,5,1079,1.0,811.0,811.0
40.044,17,10,676,5,460,10009.0,104.0,64.0,5,216,10010.0,20.0,15.0
0.005,6,10,2000,5,927,1.0,659.0,659.0,5,1073,1.0,805.0,805.0
0.079,6,10,1506,5,395,18.0,127.0,127.0,5,1111,16.0,843.0,843.0
0.008,6,10,1989,5,910,2.0,642.0,642.0,5,1079,1.0,811.0,811.0
0.013,6,10,1631,5,848,3.0,580.0,580.0,5,783,3.0,515.0,515.0
0.008,6,10,1643,5,860,1.0,592.0,592.0,5,783,1.0,515.0,515.0
0.005,6,10,1774,5,923,1.0,655.0,655.0,5,851,1.0,583.0,583.0
0.04,17,2,136,1,60,0.0,32.0,32.0,1,76,0.0,48.0,48.0
0.006,6,10,1643,5,860,1.0,592.0,592.0,5,783,1.0,515.0,515.0
0.006,17,2,170,1,65,0.0,37.0,37.0,1,105,0.0,77.0,77.0
455.97,58,8,576,6,432,91194.0,24.0,24.0,2,144,292848.0,24.0,24.0
40.068,17,10,676,5,460,10016.0,104.0,64.0,5,216,10016.0,20.0,15.0
0.009,6,13,3735,7,497,1.0,125.0,125.0,6,3238,1.0,1470.0,1459.0
0.017,6,10,1990,5,911,4.0,643.0,643.0,5,1079,4.0,811.0,811.0
0.009,6,12,1926,6,1189,1.0,659.0,434.0,6,737,1.0,417.0,417.0
0.005,6,10,2006,5,927,1.0,659.0,659.0,5,1079,1.0,811.0,811.0
0.005,6,14,3799,7,509,0.0,137.0,137.0,7,3290,0.0,1448.0,972.0
0.013,6,10,1972,5,910,3.0,642.0,642.0,5,1062,3.0,794.0,794.0
0.01,6,10,1989,5,910,2.0,642.0,642.0,5,1079,2.0,811.0,811.0
0.007,6,10,1547,5,764,1.0,496.0,496.0,5,783,1.0,515.0,515.0
0.042,17,4,352,2,130,1.0,37.0,37.0,2,222,2.0,89.0,83.0
0.127,6,10,1506,5,395,25.0,127.0,127.0,5,1111,26.0,843.0,843.0
0.005,6,10,2000,5,927,1.0,659.0,659.0,5,1073,1.0,805.0,805.0
0.067,6,10,1506,5,395,14.0,127.0,127.0,5,1111,16.0,843.0,843.0
0.102,6,10,1506,5,395,16.0,127.0,127.0,5,1111,24.0,843.0,843.0
0.004,6,10,2000,5,927,1.0,659.0,659.0,5,1073,1.0,805.0,805.0
15.08,17,15,8173,8,5953,2150.0,1350.0,716.0,7,2220,2508.0,1350.0,289.0
0.009,6,12,1926,6,1189,1.0,659.0,434.0,6,737,1.0,417.0,417.0
0.005,6,10,2000,5,927,1.0,659.0,659.0,5,1073,1.0,805.0,805.0
0.004,6,10,2007,5,928,1.0,660.0,660.0,5,1079,1.0,811.0,811.0
0.001,17,2,180,1,66,0.0,38.0,38.0,1,114,0.0,86.0,86.0
0.018,6,10,1972,5,910,4.0,642.0,642.0,5,1062,4.0,794.0,794.0
0.007,17,2,132,1,58,0.0,30.0,30.0,1,74,0.0,46.0,46.0
0.004,17,2,136,1,60,0.0,32.0,32.0,1,76,0.0,48.0,48.0
0.285,17,12,9092,7,6851,47.0,1350.0,950.0,5,2241,64.0,1350.0,420.0
0.037,6,10,1983,5,910,9.0,642.0,642.0,5,1073,9.0,805.0,805.0
0.104,6,10,1506,5,395,22.0,127.0,127.0,5,1111,20.0,843.0,843.0
0.084,6,10,1506,5,395,17.0,127.0,127.0,5,1111,19.0,843.0,843.0
240.674,6,54,38691,29,31361,8595.0,2736.0,1756.0,25,7330,10027.0,1656.0,752.0
0.01,6,10,1677,5,827,2.0,559.0,559.0,5,850,2.0,582.0,582.0
240.068,6,22,4978,12,993,21824.0,180.0,93.0,10,3985,26673.0,1593.0,576.0
0.016,6,10,1762,5,911,3.0,643.0,643.0,5,851,3.0,583.0,583.0
0.095,6,10,1506,5,395,21.0,127.0,127.0,5,1111,22.0,843.0,843.0
0.01,6,10,1989,5,910,2.0,642.0,642.0,5,1079,2.0,811.0,811.0
167.289,17,102,14834,51,3435,3345.0,44.0,39.0,51,11399,3345.0,261.0,195.0
0.007,6,10,1547,5,764,1.0,496.0,496.0,5,783,1.0,515.0,515.0
40.06,17,10,676,5,460,10014.0,104.0,64.0,5,216,10014.0,20.0,15.0
0.003,17,2,136,1,60,0.0,32.0,32.0,1,76,0.0,48.0,48.0
0.005,6,10,2007,5,928,1.0,660.0,660.0,5,1079,1.0,811.0,811.0
0.009,6,10,2006,5,927,2.0,659.0,659.0,5,1079,2.0,811.0,811.0
0.005,6,10,1854,5,889,1.0,621.0,621.0,5,965,1.0,697.0,697.0
0.01,6,10,1983,5,910,2.0,642.0,642.0,5,1073,2.0,805.0,805.0
0.006,6,10,1547,5,764,1.0,496.0,496.0,5,783,1.0,515.0,515.0
0.005,6,13,3690,7,452,0.0,80.0,80.0,6,3238,1.0,1470.0,1459.0
308.67,17,20,1124,10,716,34282.0,48.0,43.0,10,408,34282.0,20.0,12.0
0.077,6,10,1506,5,395,16.0,127.0,127.0,5,1111,15.0,843.0,843.0
0.004,6,10,1702,5,863,0.0,595.0,595.0,5,839,1.0,571.0,571.0
15.075,17,14,9191,8,6902,2148.0,1350.0,834.0,6,2289,3009.0,1350.0,353.0
0.099,6,10,1506,5,395,19.0,127.0,127.0,5,1111,23.0,843.0,843.0
0.316,17,45,27057,24,21169,13.0,1350.0,854.0,21,5888,12.0,1350.0,252.0
0.068,17,8,3613,4,1874,22.0,1350.0,440.0,4,1739,11.0,1350.0,406.0
0.004,17,4,284,2,120,1.0,32.0,32.0,2,164,1.0,60.0,54.0
0.005,6,13,3747,7,509,0.0,137.0,137.0,6,3238,0.0,1470.0,1459.0
0.009,6,10,1972,5,910,2.0,642.0,642.0,5,1062,2.0,794.0,794.0
0.005,17,2,140,1,62,0.0,34.0,34.0,1,78,0.0,50.0,50.0
0.001,17,2,174,1,72,0.0,44.0,44.0,1,102,0.0,74.0,74.0
0.114,6,10,1506,5,395,28.0,127.0,127.0,5,1111,27.0,843.0,843.0
0.017,6,10,1990,5,911,4.0,643.0,643.0,5,1079,4.0,811.0,811.0
0.013,6,10,1972,5,910,3.0,642.0,642.0,5,1062,3.0,794.0,794.0
0.006,6,10,1643,5,860,1.0,592.0,592.0,5,783,1.0,515.0,515.0
0.042,17,4,596,2,122,0.0,33.0,33.0,2,474,5.0,323.0,209.0
240.08,6,21,4925,11,941,24008.0,180.0,93.0,10,3984,26675.0,1592.0,576.0
0.015,6,10,1983,5,910,3.0,642.0,642.0,5,1073,3.0,805.0,805.0
0.026,6,10,1762,5,911,6.0,643.0,643.0,5,851,6.0,583.0,583.0
0.011,6,10,2007,5,928,2.0,660.0,660.0,5,1079,2.0,811.0,811.0
0.095,6,10,1506,5,395,22.0,127.0,127.0,5,1111,21.0,843.0,843.0
0.005,6,10,2006,5,927,1.0,659.0,659.0,5,1079,1.0,811.0,811.0
0.041,17,2,170,1,65,0.0,37.0,37.0,1,105,0.0,77.0,77.0
0.01,6,10,1643,5,860,2.0,592.0,592.0,5,783,2.0,515.0,515.0
0.005,17,2,166,1,75,0.0,47.0,47.0,1,91,0.0,63.0,63.0
0.005,17,2,214,1,75,0.0,47.0,47.0,1,139,0.0,111.0,111.0
0.012,6,10,1990,5,911,3.0,643.0,643.0,5,1079,3.0,811.0,811.0
0.01,6,10,1990,5,911,2.0,643.0,643.0,5,1079,2.0,811.0,811.0
1799.999,6,211,14524,79,6208,22701.0,46.0,46.0,132,8316,13739.0,46.0,46.0
165.07,17,80,11240,40,2672,4232.0,44.0,38.0,40,8568,4232.0,239.0,186.0
120.566,6,20,8105,11,1985,86.0,1174.0,504.0,9,6120,15050.0,2720.0,1149.0
0.005,17,2,175,1,65,0.0,37.0,37.0,1,110,0.0,82.0,82.0
0.006,17,2,230,1,68,0.0,40.0,40.0,1,162,0.0,134.0,134.0
0.091,6,10,1506,5,395,18.0,127.0,127.0,5,1111,19.0,843.0,843.0
0.005,17,2,178,1,65,0.0,37.0,37.0,1,113,0.0,85.0,85.0
0.006,6,10,2006,5,927,1.0,659.0,659.0,5,1079,1.0,811.0,811.0
1781.778,6,267,31660,109,15138,16496.0,1939.0,126.0,158,16522,11348.0,1360.0,130.0
240.464,6,35,8924,18,2071,14144.0,692.0,225.0,17,6853,15028.0,1402.0,597.0
0.006,6,10,1643,5,860,1.0,592.0,592.0,5,783,1.0,515.0,515.0
0.004,17,4,284,2,120,0.0,32.0,32.0,2,164,0.0,60.0,54.0
0.006,6,10,1547,5,764,1.0,496.0,496.0,5,783,1.0,515.0,515.0
0.004,17,2,136,1,60,0.0,32.0,32.0,1,76,0.0,48.0,48.0
40.071,17,10,676,5,460,10015.0,104.0,64.0,5,216,10016.0,20.0,15.0
0.007,6,10,1547,5,764,1.0,496.0,496.0,5,783,1.0,515.0,515.0
0.085,6,10,1506,5,395,19.0,127.0,127.0,5,1111,19.0,843.0,843.0
0.005,17,2,169,1,62,0.0,34.0,34.0,1,107,0.0,79.0,79.0
0.006,17,2,164,1,74,0.0,46.0,46.0,1,90,0.0,62.0,62.0
0.004,6,10,2007,5,928,1.0,660.0,660.0,5,1079,1.0,811.0,811.0
0.012,6,10,1631,5,848,3.0,580.0,580.0,5,783,2.0,515.0,515.0
0.007,17,2,148,1,60,0.0,32.0,32.0,1,88,0.0,60.0,60.0
0.004,6,10,2000,5,927,1.0,659.0,659.0,5,1073,1.0,805.0,805.0
0.006,6,10,2000,5,927,1.0,659.0,659.0,5,1073,1.0,805.0,805.0
0.007,6,10,2006,5,927,1.0,659.0,659.0,5,1079,1.0,811.0,811.0
40.069,17,10,676,5,460,10014.0,104.0,64.0,5,216,10015.0,20.0,15.0
308.436,17,20,1124,10,716,34256.0,48.0,43.0,10,408,34256.0,20.0,12.0
0.005,6,10,2000,5,927,1.0,659.0,659.0,5,1073,1.0,805.0,805.0
0.077,6,10,1506,5,395,18.0,127.0,127.0,5,1111,17.0,843.0,843.0
0.016,6,10,1989,5,910,4.0,642.0,642.0,5,1079,4.0,811.0,811.0
0.073,6,10,1506,5,395,17.0,127.0,127.0,5,1111,14.0,843.0,843.0
0.005,6,10,2006,5,927,1.0,659.0,659.0,5,1079,1.0,811.0,811.0
367.508,6,39,8379,25,6730,15312.0,494.0,494.0,14,1649,28269.0,83.0,83.0
0.004,6,10,2006,5,927,1.0,659.0,659.0,5,1079,1.0,811.0,811.0
0.011,6,10,1983,5,910,2.0,642.0,642.0,5,1073,2.0,805.0,805.0
0.087,6,10,1506,5,395,18.0,127.0,127.0,5,1111,18.0,843.0,843.0
0.09,6,10,1506,5,395,21.0,127.0,127.0,5,1111,17.0,843.0,843.0
0.012,6,14,3787,7,497,2.0,125.0,125.0,7,3290,1.0,1448.0,972.0
0.005,17,2,164,1,74,0.0,46.0,46.0,1,90,0.0,62.0,62.0
0.007,6,12,1698,6,863,1.0,327.0,271.0,6,835,1.0,515.0,515.0
300.321,6,16,2170,9,684,37519.0,146.0,146.0,7,1486,50025.0,419.0,398.0
0.068,6,10,1506,5,395,16.0,127.0,127.0,5,1111,14.0,843.0,843.0
0.009,6,10,1972,5,910,2.0,642.0,642.0,5,1062,2.0,794.0,794.0
0.015,6,10,1983,5,910,3.0,642.0,642.0,5,1073,3.0,805.0,805.0
0.072,6,10,1506,5,395,14.0,127.0,127.0,5,1111,16.0,843.0,843.0
0.116,6,10,1506,5,395,25.0,127.0,127.0,5,1111,27.0,843.0,843.0
11.115,17,28,4389,14,2312,846.0,587.0,137.0,14,2077,846.0,268.0,120.0
240.089,6,16,4482,9,963,30011.0,238.0,166.0,7,3519,40014.0,1402.0,786.0
0.016,6,10,1990,5,911,4.0,643.0,643.0,5,1079,3.0,811.0,811.0
10.948,17,28,4391,14,2313,833.0,588.0,137.0,14,2078,833.0,269.0,120.0
0.005,6,14,3736,7,446,0.0,74.0,74.0,7,3290,0.0,1448.0,972.0
0.006,6,10,2000,5,927,1.0,659.0,659.0,5,1073,1.0,805.0,805.0
0.005,17,2,179,1,71,0.0,43.0,43.0,1,108,0.0,80.0,80.0
0.005,17,2,166,1,75,0.0,47.0,47.0,1,91,0.0,63.0,63.0
0.006,6,14,3742,7,452,1.0,80.0,80.0,7,3290,1.0,1448.0,972.0
40.064,17,10,676,5,460,10012.0,104.0,64.0,5,216,10015.0,20.0,15.0
0.004,6,10,1989,5,927,1.0,659.0,659.0,5,1062,1.0,794.0,794.0
0.011,6,10,1990,5,911,2.0,643.0,643.0,5,1079,2.0,811.0,811.0
0.004,6,10,2007,5,928,1.0,660.0,660.0,5,1079,1.0,811.0,811.0
10.768,17,28,4422,14,1994,820.0,269.0,114.0,14,2428,817.0,587.0,145.0
0.005,6,14,3736,7,446,0.0,74.0,74.0,7,3290,0.0,1448.0,972.0
1771.822,6,103,6166,59,3473,30547.0,27.0,27.0,44,2693,41204.0,27.0,27.0
0.004,6,10,1774,5,923,1.0,655.0,655.0,5,851,1.0,583.0,583.0
0.004,6,10,1774,5,923,1.0,655.0,655.0,5,851,1.0,583.0,583.0
0.005,6,10,1989,5,927,1.0,659.0,659.0,5,1062,1.0,794.0,794.0
0.006,6,10,2006,5,927,1.0,659.0,659.0,5,1079,1.0,811.0,811.0
0.108,6,10,1506,5,395,26.0,127.0,127.0,5,1111,25.0,843.0,843.0
0.013,6,10,1990,5,911,3.0,643.0,643.0,5,1079,3.0,811.0,811.0
0.046,17,2,156,1,64,0.0,36.0,36.0,1,92,0.0,64.0,64.0
0.04,17,4,420,2,122,0.0,33.0,33.0,2,298,37.0,145.0,121.0
0.015,6,10,1972,5,910,3.0,642.0,642.0,5,1062,3.0,794.0,794.0
0.081,6,10,1506,5,395,17.0,127.0,127.0,5,1111,17.0,843.0,843.0
0.027,6,10,1631,5,848,6.0,580.0,580.0,5,783,6.0,515.0,515.0
0.005,6,10,1989,5,927,1.0,659.0,659.0,5,1062,1.0,794.0,794.0
0.112,6,10,1506,5,395,25.0,127.0,127.0,5,1111,26.0,843.0,843.0
0.015,6,10,1989,5,910,3.0,642.0,642.0,5,1079,3.0,811.0,811.0
0.004,6,10,1779,5,928,1.0,660.0,660.0,5,851,1.0,583.0,583.0
0.014,6,10,1762,5,911,3.0,643.0,643.0,5,851,3.0,583.0,583.0
0.007,6,10,1983,5,910,1.0,642.0,642.0,5,1073,1.0,805.0,805.0
0.007,6,10,1689,5,839,1.0,571.0,571.0,5,850,1.0,582.0,582.0
0.111,6,10,1506,5,395,26.0,127.0,127.0,5,1111,23.0,843.0,843.0
0.005,6,10,2006,5,927,1.0,659.0,659.0,5,1079,1.0,811.0,811.0
0.006,6,10,1547,5,764,1.0,496.0,496.0,5,783,1.0,515.0,515.0
0.014,6,10,1972,5,910,3.0,642.0,642.0,5,1062,3.0,794.0,794.0
0.012,6,10,1989,5,910,3.0,642.0,642.0,5,1079,3.0,811.0,811.0
0.005,6,14,3799,7,509,0.0,137.0,137.0,7,3290,0.0,1448.0,972.0
240.758,6,39,9798,20,2225,12669.0,745.0,235.0,19,7573,13373.0,1402.0,549.0
0.008,6,10,1677,5,827,2.0,559.0,559.0,5,850,2.0,582.0,582.0
0.039,17,2,152,1,76,0.0,48.0,48.0,1,76,0.0,48.0,48.0
0.006,17,2,170,1,65,0.0,37.0,37.0,1,105,0.0,77.0,77.0
0.01,6,10,1989,5,910,2.0,642.0,642.0,5,1079,2.0,811.0,811.0
240.098,6,31,9419,15,7141,17149.0,2266.0,707.0,16,2278,16006.0,580.0,179.0
0.012,6,10,1989,5,910,3.0,642.0,642.0,5,1079,2.0,811.0,811.0
0.073,6,10,1506,5,395,13.0,127.0,127.0,5,1111,17.0,843.0,843.0
0.01,6,10,2007,5,928,2.0,660.0,660.0,5,1079,2.0,811.0,811.0
0.006,17,2,179,1,71,0.0,43.0,43.0,1,108,0.0,80.0,80.0
0.096,6,10,1506,5,395,23.0,127.0,127.0,5,1111,21.0,843.0,843.0
0.015,6,13,3735,7,497,2.0,125.0,125.0,6,3238,2.0,1470.0,1459.0
0.17,6,3,453,2,321,170.0,241.0,241.0,1,132,0.0,92.0,92.0
0.108,6,10,1506,5,395,23.0,127.0,127.0,5,1111,21.0,843.0,843.0
40.061,17,10,676,5,460,10014.0,104.0,64.0,5,216,10014.0,20.0,15.0
0.014,6,10,1989,5,910,3.0,642.0,642.0,5,1079,3.0,811.0,811.0
0.001,17,2,166,1,75,0.0,47.0,47.0,1,91,0.0,63.0,63.0
0.023,6,10,1972,5,910,5.0,642.0,642.0,5,1062,5.0,794.0,794.0
0.082,6,10,1506,5,395,18.0,127.0,127.0,5,1111,14.0,843.0,843.0
0.004,17,2,136,1,60,0.0,32.0,32.0,1,76,0.0,48.0,48.0
0.006,6,10,1643,5,860,1.0,592.0,592.0,5,783,1.0,515.0,515.0
0.001,17,2,180,1,65,0.0,37.0,37.0,1,115,0.0,87.0,87.0
0.005,6,10,1989,5,927,1.0,659.0,659.0,5,1062,1.0,794.0,794.0
0.006,6,10,1854,5,889,1.0,621.0,621.0,5,965,1.0,697.0,697.0
0.005,6,10,2000,5,927,1.0,659.0,659.0,5,1073,1.0,805.0,805.0
0.005,6,10,1643,5,860,1.0,592.0,592.0,5,783,1.0,515.0,515.0
0.018,6,10,1989,5,910,4.0,642.0,642.0,5,1079,4.0,811.0,811.0
0.127,17,2,80,1,32,0.0,4.0,4.0,1,48,0.0,20.0,20.0
11.172,17,28,4419,14,1995,847.0,270.0,114.0,14,2424,847.0,587.0,145.0
353.998,6,21,1794,16,1030,23599.0,190.0,190.0,5,764,60003.0,463.0,248.0
0.009,6,10,1989,5,927,2.0,659.0,659.0,5,1062,2.0,794.0,794.0
0.004,17,2,186,1,61,0.0,33.0,33.0,1,125,0.0,97.0,97.0
40.067,17,10,676,5,460,10015.0,104.0,64.0,5,216,10015.0,20.0,15.0
0.001,17,2,179,1,62,0.0,34.0,34.0,1,117,0.0,89.0,89.0
0.036,17,4,284,2,120,0.0,32.0,32.0,2,164,33.0,60.0,54.0
0.091,6,10,1506,5,395,19.0,127.0,127.0,5,1111,19.0,843.0,843.0
52.224,6,24,9313,13,1655,4352.0,794.0,367.0,11,7658,5210.0,1360.0,1029.0
0.219,6,16,2668,8,1394,31.0,533.0,323.0,8,1274,20.0,529.0,212.0
0.006,6,10,1547,5,764,1.0,496.0,496.0,5,783,1.0,515.0,515.0
0.004,6,10,2006,5,927,1.0,659.0,659.0,5,1079,1.0,811.0,811.0
0.008,6,12,1926,6,1189,1.0,659.0,434.0,6,737,1.0,417.0,417.0
0.004,6,10,1989,5,927,1.0,659.0,659.0,5,1062,1.0,794.0,794.0
1756.001,6,103,6166,59,3473,30275.0,27.0,27.0,44,2693,40836.0,27.0,27.0
1799.999,6,211,14558,79,6242,23076.0,46.0,46.0,132,8316,13739.0,46.0,46.0
15.083,17,19,10120,9,6968,1881.0,1350.0,746.0,10,3152,1672.0,1350.0,287.0
0.01,6,13,3735,7,497,1.0,125.0,125.0,6,3238,1.0,1470.0,1459.0
0.094,6,10,1506,5,395,21.0,127.0,127.0,5,1111,21.0,843.0,843.0
0.009,6,10,1972,5,910,2.0,642.0,642.0,5,1062,2.0,794.0,794.0
0.001,17,2,180,1,66,0.0,38.0,38.0,1,114,0.0,86.0,86.0
0.038,6,10,1989,5,910,9.0,642.0,642.0,5,1079,9.0,811.0,811.0
0.013,6,10,1990,5,911,3.0,643.0,643.0,5,1079,3.0,811.0,811.0
0.005,6,10,2006,5,927,1.0,659.0,659.0,5,1079,1.0,811.0,811.0
0.001,17,2,180,1,66,0.0,38.0,38.0,1,114,0.0,86.0,86.0
0.008,6,10,1989,5,910,2.0,642.0,642.0,5,1079,2.0,811.0,811.0
0.029,6,10,1983,5,910,7.0,642.0,642.0,5,1073,7.0,805.0,805.0
0.004,6,10,2006,5,927,1.0,659.0,659.0,5,1079,1.0,811.0,811.0
0.069,17,2,152,1,76,0.0,48.0,48.0,1,76,0.0,48.0,48.0
0.005,17,2,166,1,75,0.0,47.0,47.0,1,91,0.0,63.0,63.0
0.081,6,10,1506,5,395,18.0,127.0,127.0,5,1111,18.0,843.0,843.0
0.004,6,10,1702,5,863,1.0,595.0,595.0,5,839,0.0,571.0,571.0
0.012,6,10,1990,5,911,3.0,643.0,643.0,5,1079,2.0,811.0,811.0
0.011,17,4,284,2,120,7.0,32.0,32.0,2,164,7.0,60.0,54.0
0.042,17,2,148,1,60,0.0,32.0,32.0,1,88,0.0,60.0,60.0
0.115,6,10,1506,5,395,26.0,127.0,127.0,5,1111,25.0,843.0,843.0
0.005,6,10,1643,5,860,1.0,592.0,592.0,5,783,1.0,515.0,515.0
0.069,17,8,3613,4,1874,23.0,1350.0,440.0,4,1739,11.0,1350.0,406.0
1.04,6,22,7922,12,1487,94.0,517.0,287.0,10,6435,18.0,1402.0,843.0
0.066,6,10,1506,5,395,13.0,127.0,127.0,5,1111,14.0,843.0,843.0
0.005,6,10,2000,5,927,1.0,659.0,659.0,5,1073,1.0,805.0,805.0
0.097,6,10,1506,5,395,21.0,127.0,127.0,5,1111,18.0,843.0,843.0
0.01,6,10,1972,5,910,2.0,642.0,642.0,5,1062,2.0,794.0,794.0
40.077,17,10,676,5,460,10016.0,104.0,64.0,5,216,10018.0,20.0,15.0
0.015,6,10,1989,5,910,3.0,642.0,642.0,5,1079,3.0,811.0,811.0
0.013,6,10,1983,5,910,3.0,642.0,642.0,5,1073,3.0,805.0,805.0
0.012,6,14,3787,7,497,1.0,125.0,125.0,7,3290,1.0,1448.0,972.0
0.005,6,10,2006,5,927,1.0,659.0,659.0,5,1079,1.0,811.0,811.0
110.704,6,22,8497,12,2236,75.0,1345.0,574.0,10,6261,12281.0,2720.0,974.0
0.039,17,2,144,1,64,0.0,36.0,36.0,1,80,0.0,52.0,52.0
0.005,6,10,1989,5,927,1.0,659.0,659.0,5,1062,1.0,794.0,794.0
0.008,6,10,1972,5,910,2.0,642.0,642.0,5,1062,2.0,794.0,794.0
0.094,6,10,1506,5,395,20.0,127.0,127.0,5,1111,20.0,843.0,843.0
0.005,17,2,170,1,65,0.0,37.0,37.0,1,105,0.0,77.0,77.0
0.069,6,10,1506,5,395,14.0,127.0,127.0,5,1111,16.0,843.0,843.0
0.005,17,2,144,1,64,0.0,36.0,36.0,1,80,0.0,52.0,52.0
0.005,6,10,1689,5,839,1.0,571.0,571.0,5,850,1.0,582.0,582.0
0.042,17,4,284,2,120,0.0,32.0,32.0,2,164,39.0,60.0,54.0
0.003,17,2,148,1,60,0.0,32.0,32.0,1,88,0.0,60.0,60.0
0.005,17,2,170,1,65,0.0,37.0,37.0,1,105,0.0,77.0,77.0
0.044,6,10,1972,5,910,11.0,642.0,642.0,5,1062,11.0,794.0,794.0
0.005,6,10,2007,5,928,1.0,660.0,660.0,5,1079,1.0,811.0,811.0
0.117,6,10,1506,5,395,25.0,127.0,127.0,5,1111,23.0,843.0,843.0
0.004,6,10,2000,5,927,1.0,659.0,659.0,5,1073,1.0,805.0,805.0
0.018,6,10,1989,5,910,4.0,642.0,642.0,5,1079,4.0,811.0,811.0
40.059,17,10,676,5,460,10013.0,104.0,64.0,5,216,10014.0,20.0,15.0
0.005,6,10,2006,5,927,1.0,659.0,659.0,5,1079,1.0,811.0,811.0
0.004,6,10,1702,5,863,1.0,595.0,595.0,5,839,0.0,571.0,571.0
0.005,6,10,1779,5,928,1.0,660.0,660.0,5,851,1.0,583.0,583.0
0.039,17,2,412,1,61,0.0,33.0,33.0,1,351,0.0,323.0,323.0
242.774,6,315,344480,120,17756,2040.0,2736.0,886.0,195,326724,1251.0,2804.0,1711.0
0.091,6,10,1506,5,395,19.0,127.0,127.0,5,1111,19.0,843.0,843.0
40.055,17,10,676,5,460,10012.0,104.0,64.0,5,216,10012.0,20.0,15.0
0.222,6,16,2669,8,1395,31.0,533.0,323.0,8,1274,20.0,529.0,212.0
0.004,17,4,284,2,120,0.0,32.0,32.0,2,164,1.0,60.0,54.0
1.019,6,29,13688,17,7264,63.0,2720.0,936.0,12,6424,76.0,2749.0,1186.0
0.004,6,10,2006,5,927,1.0,659.0,659.0,5,1079,1.0,811.0,811.0
0.016,6,10,1983,5,910,3.0,642.0,642.0,5,1073,3.0,805.0,805.0
0.005,6,10,1779,5,928,1.0,660.0,660.0,5,851,1.0,583.0,583.0
0.012,6,10,1762,5,911,3.0,643.0,643.0,5,851,3.0,583.0,583.0
0.006,6,10,2007,5,928,1.0,660.0,660.0,5,1079,1.0,811.0,811.0
0.031,6,10,1989,5,910,7.0,642.0,642.0,5,1079,7.0,811.0,811.0
0.011,6,10,1972,5,910,2.0,642.0,642.0,5,1062,2.0,794.0,794.0
0.001,17,2,180,1,66,0.0,38.0,38.0,1,114,0.0,86.0,86.0
0.012,6,10,1990,5,911,3.0,643.0,643.0,5,1079,3.0,811.0,811.0
172.064,17,78,11542,39,2606,4527.0,44.0,38.0,39,8936,4527.0,279.0,201.0
0.004,17,2,184,1,61,0.0,33.0,33.0,1,123,0.0,95.0,95.0
0.043,17,2,136,1,60,0.0,32.0,32.0,1,76,0.0,48.0,48.0
0.003,17,2,136,1,60,0.0,32.0,32.0,1,76,0.0,48.0,48.0
0.006,6,10,1547,5,764,1.0,496.0,496.0,5,783,1.0,515.0,515.0
0.004,6,10,2006,5,927,1.0,659.0,659.0,5,1079,1.0,811.0,811.0
0.003,17,2,136,1,60,0.0,32.0,32.0,1,76,0.0,48.0,48.0
0.005,6,10,2007,5,928,1.0,660.0,660.0,5,1079,1.0,811.0,811.0
0.264,17,46,29289,27,26147,10.0,1350.0,940.0,19,3142,12.0,1350.0,137.0
0.013,6,10,1972,5,910,3.0,642.0,642.0,5,1062,3.0,794.0,794.0
0.022,6,10,1990,5,911,5.0,643.0,643.0,5,1079,5.0,811.0,811.0
0.009,6,10,1631,5,848,2.0,580.0,580.0,5,783,2.0,515.0,515.0
0.012,6,10,1762,5,911,3.0,643.0,643.0,5,851,3.0,583.0,583.0
0.013,6,10,1972,5,910,3.0,642.0,642.0,5,1062,3.0,794.0,794.0
352.822,6,20,2210,6,1308,12003.0,494.0,494.0,14,902,27140.0,83.0,83.0
0.003,17,2,208,1,72,0.0,44.0,44.0,1,136,0.0,108.0,108.0
0.004,6,10,2006,5,927,1.0,659.0,659.0,5,1079,1.0,811.0,811.0
0.004,17,2,136,1,60,0.0,32.0,32.0,1,76,0.0,48.0,48.0
0.009,17,4,284,2,120,0.0,32.0,32.0,2,164,0.0,60.0,54.0
0.004,17,2,148,1,60,0.0,32.0,32.0,1,88,0.0,60.0,60.0
0.013,6,10,1779,5,928,3.0,660.0,660.0,5,851,3.0,583.0,583.0
0.119,6,10,1506,5,395,28.0,127.0,127.0,5,1111,25.0,843.0,843.0
0.001,17,2,180,1,65,0.0,37.0,37.0,1,115,0.0,87.0,87.0
11.157,17,28,4418,14,1994,846.0,269.0,114.0,14,2424,846.0,587.0,145.0
0.008,6,10,1779,5,928,2.0,660.0,660.0,5,851,1.0,583.0,583.0
309.873,17,20,1124,10,716,34415.0,48.0,43.0,10,408,34415.0,20.0,12.0
0.006,6,10,2006,5,927,1.0,659.0,659.0,5,1079,1.0,811.0,811.0
0.087,6,10,1506,5,395,19.0,127.0,127.0,5,1111,18.0,843.0,843.0
0.001,17,2,166,1,75,0.0,47.0,47.0,1,91,0.0,63.0,63.0
0.005,6,10,2006,5,927,1.0,659.0,659.0,5,1079,1.0,811.0,811.0
0.006,6,10,2000,5,927,1.0,659.0,659.0,5,1073,1.0,805.0,805.0
0.012,6,10,1983,5,910,3.0,642.0,642.0,5,1073,3.0,805.0,805.0
0.003,17,2,136,1,60,0.0,32.0,32.0,1,76,0.0,48.0,48.0
0.092,6,10,1506,5,395,21.0,127.0,127.0,5,1111,20.0,843.0,843.0
0.009,6,14,3787,7,497,1.0,125.0,125.0,7,3290,1.0,1448.0,972.0
0.005,6,10,1989,5,927,1.0,659.0,659.0,5,1062,1.0,794.0,794.0
0.115,6,10,1506,5,395,21.0,127.0,127.0,5,1111,26.0,843.0,843.0
0.004,17,2,152,1,76,0.0,48.0,48.0,1,76,0.0,48.0,48.0
0.091,6,10,1506,5,395,20.0,127.0,127.0,5,1111,19.0,843.0,843.0
0.001,17,2,180,1,66,0.0,38.0,38.0,1,114,0.0,86.0,86.0
0.005,6,10,1779,5,928,1.0,660.0,660.0,5,851,1.0,583.0,583.0
0.004,6,10,1702,5,863,1.0,595.0,595.0,5,839,0.0,571.0,571.0
0.006,6,10,2007,5,928,1.0,660.0,660.0,5,1079,1.0,811.0,811.0
0.07,6,10,1506,5,395,16.0,127.0,127.0,5,1111,15.0,843.0,843.0
0.01,6,10,1990,5,911,2.0,643.0,643.0,5,1079,2.0,811.0,811.0
0.038,17,2,136,1,60,0.0,32.0,32.0,1,76,0.0,48.0,48.0
0.011,6,10,1990,5,911,2.0,643.0,643.0,5,1079,2.0,811.0,811.0
300.362,6,16,2170,9,684,37524.0,146.0,146.0,7,1486,50033.0,419.0,398.0
0.005,17,2,164,1,74,0.0,46.0,46.0,1,90,0.0,62.0,62.0
0.004,6,10,2000,5,927,1.0,659.0,659.0,5,1073,1.0,805.0,805.0
171.443,17,78,11169,39,2598,4511.0,44.0,38.0,39,8571,4511.0,239.0,191.0
0.006,6,10,1547,5,764,1.0,496.0,496.0,5,783,1.0,515.0,515.0
0.101,6,10,1506,5,395,22.0,127.0,127.0,5,1111,24.0,843.0,843.0
0.104,6,10,1506,5,395,21.0,127.0,127.0,5,1111,23.0,843.0,843.0
0.082,6,10,1506,5,395,18.0,127.0,127.0,5,1111,18.0,843.0,843.0
0.02,6,10,1989,5,910,5.0,642.0,642.0,5,1079,4.0,811.0,811.0
0.005,6,10,1689,5,839,1.0,571.0,571.0,5,850,1.0,582.0,582.0
0.012,6,14,3787,7,497,2.0,125.0,125.0,7,3290,2.0,1448.0,972.0
0.016,6,10,1762,5,911,4.0,643.0,643.0,5,851,4.0,583.0,583.0
0.005,6,10,2006,5,927,1.0,659.0,659.0,5,1079,1.0,811.0,811.0
0.006,6,14,3799,7,509,0.0,137.0,137.0,7,3290,0.0,1448.0,972.0
0.001,17,2,180,1,66,0.0,38.0,38.0,1,114,0.0,86.0,86.0
0.013,6,10,1762,5,911,3.0,643.0,643.0,5,851,3.0,583.0,583.0
0.004,6,10,1989,5,927,1.0,659.0,659.0,5,1062,1.0,794.0,794.0
0.004,17,2,136,1,60,0.0,32.0,32.0,1,76,0.0,48.0,48.0
0.006,6,10,1643,5,860,1.0,592.0,592.0,5,783,1.0,515.0,515.0
0.011,6,10,1990,5,911,2.0,643.0,643.0,5,1079,2.0,811.0,811.0
0.004,6,10,1702,5,863,1.0,595.0,595.0,5,839,0.0,571.0,571.0
40.18,6,47,11291,27,3315,1545.0,980.0,187.0,20,7976,2114.0,2694.0,577.0
0.134,6,10,1506,5,395,31.0,127.0,127.0,5,1111,28.0,843.0,843.0
0.012,6,10,1631,5,848,3.0,580.0,580.0,5,783,3.0,515.0,515.0
0.005,6,10,1989,5,927,1.0,659.0,659.0,5,1062,1.0,794.0,794.0
0.089,6,10,1506,5,395,20.0,127.0,127.0,5,1111,16.0,843.0,843.0
0.01,6,10,1762,5,911,2.0,643.0,643.0,5,851,2.0,583.0,583.0
240.096,6,16,4482,9,963,30012.0,238.0,166.0,7,3519,40015.0,1402.0,786.0
0.059,6,10,1506,5,395,14.0,127.0,127.0,5,1111,13.0,843.0,843.0
0.005,6,10,2007,5,928,1.0,660.0,660.0,5,1079,1.0,811.0,811.0
0.004,6,10,1989,5,927,1.0,659.0,659.0,5,1062,1.0,794.0,794.0
0.007,17,2,162,1,65,0.0,37.0,37.0,1,97,0.0,69.0,69.0
0.013,6,10,1989,5,910,3.0,642.0,642.0,5,1079,3.0,811.0,811.0
10.958,17,28,4422,14,1994,834.0,269.0,114.0,14,2428,833.0,587.0,145.0
0.015,6,10,1989,5,910,3.0,642.0,642.0,5,1079,3.0,811.0,811.0
0.011,6,10,1989,5,910,2.0,642.0,642.0,5,1079,2.0,811.0,811.0
0.015,6,10,1990,5,911,3.0,643.0,643.0,5,1079,3.0,811.0,811.0
0.004,6,10,2006,5,927,1.0,659.0,659.0,5,1079,1.0,811.0,811.0
0.005,6,10,1854,5,889,1.0,621.0,621.0,5,965,1.0,697.0,697.0
0.004,6,10,2006,5,927,1.0,659.0,659.0,5,1079,1.0,811.0,811.0
0.007,6,10,1990,5,911,1.0,643.0,643.0,5,1079,1.0,811.0,811.0
0.016,6,10,1989,5,910,3.0,642.0,642.0,5,1079,3.0,811.0,811.0
0.091,6,10,1506,5,395,17.0,127.0,127.0,5,1111,19.0,843.0,843.0
15.084,17,16,8781,8,6507,2151.0,1350.0,785.0,8,2274,2150.0,1350.0,256.0
240.01,6,9,787,5,488,60002.0,232.0,232.0,4,299,80002.0,83.0,83.0
0.006,17,2,140,1,62,0.0,34.0,34.0,1,78,0.0,50.0,50.0
0.003,17,2,148,1,60,0.0,32.0,32.0,1,88,0.0,60.0,60.0
0.088,6,10,1506,5,395,18.0,127.0,127.0,5,1111,20.0,843.0,843.0
0.007,6,10,2007,5,928,1.0,660.0,660.0,5,1079,1.0,811.0,811.0
0.006,17,2,166,1,75,0.0,47.0,47.0,1,91,0.0,63.0,63.0
0.002,17,2,160,1,72,0.0,44.0,44.0,1,88,0.0,60.0,60.0
300.3,6,16,2170,9,684,37515.0,146.0,146.0,7,1486,50021.0,419.0,398.0
0.004,6,10,1774,5,923,1.0,655.0,655.0,5,851,1.0,583.0,583.0
40.056,17,10,676,5,460,10013.0,104.0,64.0,5,216,10013.0,20.0,15.0
0.024,6,13,3735,7,497,4.0,125.0,125.0,6,3238,4.0,1470.0,1459.0
0.019,6,13,3913,7,495,3.0,123.0,123.0,6,3418,3.0,1650.0,1549.0
0.116,17,2,80,1,32,0.0,4.0,4.0,1,48,0.0,20.0,20.0
0.006,6,10,1989,5,927,1.0,659.0,659.0,5,1062,1.0,794.0,794.0
0.103,6,10,1506,5,395,23.0,127.0,127.0,5,1111,19.0,843.0,843.0
0.008,6,12,1926,6,1189,1.0,659.0,434.0,6,737,1.0,417.0,417.0
0.004,6,10,1989,5,927,1.0,659.0,659.0,5,1062,1.0,794.0,794.0
0.141,6,10,1506,5,395,32.0,127.0,127.0,5,1111,32.0,843.0,843.0
0.006,6,13,3747,7,509,1.0,137.0,137.0,6,3238,1.0,1470.0,1459.0
40.074,17,10,676,5,460,10015.0,104.0,64.0,5,216,10017.0,20.0,15.0
0.005,6,10,2000,5,927,1.0,659.0,659.0,5,1073,1.0,805.0,805.0
0.083,6,10,1506,5,395,18.0,127.0,127.0,5,1111,16.0,843.0,843.0
0.072,17,4,284,2,120,0.0,32.0,32.0,2,164,69.0,60.0,54.0
0.005,6,11,1831,6,980,1.0,660.0,660.0,5,851,1.0,583.0,583.0
0.005,6,10,2000,5,927,1.0,659.0,659.0,5,1073,1.0,805.0,805.0
0.016,6,14,3787,7,497,2.0,125.0,125.0,7,3290,2.0,1448.0,972.0
40.062,17,10,676,5,460,10014.0,104.0,64.0,5,216,10014.0,20.0,15.0
40.055,17,10,676,5,460,10012.0,104.0,64.0,5,216,10012.0,20.0,15.0
0.005,17,2,140,1,62,0.0,34.0,34.0,1,78,0.0,50.0,50.0
0.127,6,10,1506,5,395,26.0,127.0,127.0,5,1111,26.0,843.0,843.0
0.01,6,10,1631,5,848,2.0,580.0,580.0,5,783,2.0,515.0,515.0
0.011,6,10,1762,5,911,2.0,643.0,643.0,5,851,2.0,583.0,583.0
0.012,6,12,1926,6,1189,2.0,659.0,434.0,6,737,2.0,417.0,417.0
40.06,17,10,676,5,460,10014.0,104.0,64.0,5,216,10014.0,20.0,15.0
40.072,17,10,676,5,460,10016.0,104.0,64.0,5,216,10014.0,20.0,15.0
0.001,17,2,180,1,66,0.0,38.0,38.0,1,114,0.0,86.0,86.0
0.026,6,10,1972,5,910,6.0,642.0,642.0,5,1062,6.0,794.0,794.0
0.003,17,2,148,1,60,0.0,32.0,32.0,1,88,0.0,60.0,60.0
0.001,17,2,136,1,60,0.0,32.0,32.0,1,76,0.0,48.0,48.0
0.005,6,10,1989,5,927,1.0,659.0,659.0,5,1062,1.0,794.0,794.0
0.005,6,10,1989,5,927,1.0,659.0,659.0,5,1062,1.0,794.0,794.0
0.803,6,27,5539,12,1557,67.0,325.0,152.0,15,3982,49.0,1414.0,563.0
0.008,6,10,1972,5,910,2.0,642.0,642.0,5,1062,2.0,794.0,794.0
0.008,6,10,1989,5,910,1.0,642.0,642.0,5,1079,1.0,811.0,811.0
0.004,6,10,2006,5,927,1.0,659.0,659.0,5,1079,1.0,811.0,811.0
40.064,17,10,676,5,460,10015.0,104.0,64.0,5,216,10015.0,20.0,15.0
0.013,6,10,1983,5,910,3.0,642.0,642.0,5,1073,3.0,805.0,805.0
0.016,6,10,1989,5,910,4.0,642.0,642.0,5,1079,4.0,811.0,811.0
0.021,6,10,1762,5,911,5.0,643.0,643.0,5,851,5.0,583.0,583.0
0.029,6,13,3735,7,497,4.0,125.0,125.0,6,3238,5.0,1470.0,1459.0
0.026,6,10,1972,5,910,6.0,642.0,642.0,5,1062,6.0,794.0,794.0
0.006,6,13,3747,7,509,1.0,137.0,137.0,6,3238,1.0,1470.0,1459.0
0.007,6,10,1547,5,764,1.0,496.0,496.0,5,783,1.0,515.0,515.0
241.312,6,299,343234,118,17648,2062.0,2736.0,959.0,181,325586,1340.0,2804.0,1848.0
10.803,17,28,4421,14,1994,822.0,269.0,114.0,14,2427,822.0,586.0,145.0
0.015,6,10,1990,5,911,3.0,643.0,643.0,5,1079,3.0,811.0,811.0
0.003,17,2,148,1,60,0.0,32.0,32.0,1,88,0.0,60.0,60.0
0.004,6,10,2000,5,927,1.0,659.0,659.0,5,1073,1.0,805.0,805.0
0.071,17,8,3613,4,1874,23.0,1350.0,440.0,4,1739,12.0,1350.0,406.0
0.004,17,2,148,1,60,0.0,32.0,32.0,1,88,0.0,60.0,60.0
0.006,17,2,302,1,65,0.0,37.0,37.0,1,237,0.0,209.0,209.0
0.082,6,10,1506,5,395,18.0,127.0,127.0,5,1111,17.0,843.0,843.0
0.013,6,10,1983,5,910,3.0,642.0,642.0,5,1073,3.0,805.0,805.0
0.005,6,10,1643,5,860,1.0,592.0,592.0,5,783,1.0,515.0,515.0
0.005,6,10,1989,5,927,1.0,659.0,659.0,5,1062,1.0,794.0,794.0
0.005,6,10,2000,5,927,1.0,659.0,659.0,5,1073,1.0,805.0,805.0
0.008,6,10,1972,5,910,1.0,642.0,642.0,5,1062,2.0,794.0,794.0
0.012,6,10,1972,5,910,3.0,642.0,642.0,5,1062,2.0,794.0,794.0
0.078,6,10,1506,5,395,18.0,127.0,127.0,5,1111,15.0,843.0,843.0
308.725,17,18,1008,9,640,38575.0,48.0,43.0,9,368,38575.0,20.0,12.0
0.011,6,10,2007,5,928,2.0,660.0,660.0,5,1079,2.0,811.0,811.0
0.06,17,2,148,1,60,0.0,32.0,32.0,1,88,0.0,60.0,60.0
0.016,6,10,1989,5,910,4.0,642.0,642.0,5,1079,4.0,811.0,811.0
0.005,6,10,2007,5,928,1.0,660.0,660.0,5,1079,1.0,811.0,811.0
0.015,6,10,1972,5,910,3.0,642.0,642.0,5,1062,3.0,794.0,794.0
0.005,17,2,148,1,60,0.0,32.0,32.0,1,88,0.0,60.0,60.0
0.005,6,13,3747,7,509,0.0,137.0,137.0,6,3238,0.0,1470.0,1459.0
0.014,6,10,1983,5,910,3.0,642.0,642.0,5,1073,3.0,805.0,805.0
0.003,17,4,284,2,120,0.0,32.0,32.0,2,164,0.0,60.0,54.0
0.009,6,12,1926,6,1189,1.0,659.0,434.0,6,737,1.0,417.0,417.0
0.016,6,10,1989,5,910,4.0,642.0,642.0,5,1079,3.0,811.0,811.0
11.146,17,28,4423,14,1995,849.0,270.0,114.0,14,2428,848.0,587.0,145.0
0.092,6,10,1506,5,395,18.0,127.0,127.0,5,1111,19.0,843.0,843.0
0.13,6,10,1506,5,395,29.0,127.0,127.0,5,1111,27.0,843.0,843.0
0.005,6,10,1854,5,889,1.0,621.0,621.0,5,965,1.0,697.0,697.0
0.111,6,10,1506,5,395,26.0,127.0,127.0,5,1111,22.0,843.0,843.0
0.005,6,14,3799,7,509,0.0,137.0,137.0,7,3290,0.0,1448.0,972.0
240.172,6,17,7292,9,2024,30021.0,1496.0,780.0,8,5268,34309.0,2804.0,1211.0
0.005,6,10,2007,5,928,1.0,660.0,660.0,5,1079,1.0,811.0,811.0
240.109,6,32,9599,16,7154,16007.0,2227.0,702.0,16,2445,16007.0,580.0,200.0
0.007,6,10,2006,5,927,1.0,659.0,659.0,5,1079,1.0,811.0,811.0
0.001,17,2,180,1,66,0.0,38.0,38.0,1,114,0.0,86.0,86.0
0.003,17,2,136,1,60,0.0,32.0,32.0,1,76,0.0,48.0,48.0
0.106,6,10,1506,5,395,22.0,127.0,127.0,5,1111,22.0,843.0,843.0
0.004,6,10,2000,5,927,1.0,659.0,659.0,5,1073,1.0,805.0,805.0
0.016,6,10,1972,5,910,4.0,642.0,642.0,5,1062,4.0,794.0,794.0
15.071,17,15,9238,8,6902,2149.0,1350.0,834.0,7,2336,2507.0,1350.0,305.0
0.01,6,10,1972,5,910,2.0,642.0,642.0,5,1062,2.0,794.0,794.0
0.015,6,10,1983,5,910,3.0,642.0,642.0,5,1073,3.0,805.0,805.0
0.053,6,10,1506,5,395,10.0,127.0,127.0,5,1111,12.0,843.0,843.0
0.078,6,10,1506,5,395,17.0,127.0,127.0,5,1111,16.0,843.0,843.0
0.005,6,13,3747,7,509,0.0,137.0,137.0,6,3238,0.0,1470.0,1459.0
240.07,6,22,4978,12,993,21824.0,180.0,93.0,10,3985,26674.0,1593.0,576.0
0.001,17,2,180,1,66,0.0,38.0,38.0,1,114,0.0,86.0,86.0
0.018,6,10,1983,5,910,4.0,642.0,642.0,5,1073,4.0,805.0,805.0
0.005,6,10,1774,5,923,1.0,655.0,655.0,5,851,1.0,583.0,583.0
0.009,6,10,1983,5,910,2.0,642.0,642.0,5,1073,2.0,805.0,805.0
0.019,6,10,1972,5,910,4.0,642.0,642.0,5,1062,4.0,794.0,794.0
0.003,17,2,148,1,60,0.0,32.0,32.0,1,88,0.0,60.0,60.0
0.075,6,10,1506,5,395,18.0,127.0,127.0,5,1111,17.0,843.0,843.0
0.015,6,10,1989,5,910,3.0,642.0,642.0,5,1079,3.0,811.0,811.0
0.005,17,2,136,1,60,0.0,32.0,32.0,1,76,0.0,48.0,48.0
0.006,6,10,1547,5,764,1.0,496.0,496.0,5,783,1.0,515.0,515.0
0.005,6,10,2007,5,928,1.0,660.0,660.0,5,1079,1.0,811.0,811.0
0.003,17,2,412,1,61,0.0,33.0,33.0,1,351,0.0,323.0,323.0
0.005,17,2,156,1,70,0.0,42.0,42.0,1,86,0.0,58.0,58.0
0.004,6,10,1702,5,863,1.0,595.0,595.0,5,839,1.0,571.0,571.0
0.091,6,10,1506,5,395,18.0,127.0,127.0,5,1111,19.0,843.0,843.0
0.011,6,10,1972,5,910,2.0,642.0,642.0,5,1062,2.0,794.0,794.0
29.87,6,46,15745,23,9753,410.0,4080.0,1464.0,23,5992,1350.0,2667.0,361.0
0.012,6,10,1989,5,910,3.0,642.0,642.0,5,1079,2.0,811.0,811.0
0.006,17,2,194,1,59,0.0,31.0,31.0,1,135,0.0,107.0,107.0
0.005,17,2,148,1,60,0.0,32.0,32.0,1,88,0.0,60.0,60.0
0.007,6,10,1547,5,764,1.0,496.0,496.0,5,783,1.0,515.0,515.0
0.127,6,10,1506,5,395,23.0,127.0,127.0,5,1111,29.0,843.0,843.0
0.009,6,10,1983,5,910,2.0,642.0,642.0,5,1073,2.0,805.0,805.0
0.124,17,2,80,1,32,0.0,4.0,4.0,1,48,0.0,20.0,20.0
0.006,6,10,2000,5,927,1.0,659.0,659.0,5,1073,1.0,805.0,805.0
308.974,17,20,1124,10,716,34316.0,48.0,43.0,10,408,34316.0,20.0,12.0
0.006,6,10,1547,5,764,1.0,496.0,496.0,5,783,1.0,515.0,515.0
0.125,6,10,1506,5,395,26.0,127.0,127.0,5,1111,28.0,843.0,843.0
1777.781,17,144,45504,72,22752,25039.0,288.0,288.0,72,22752,25039.0,288.0,288.0
0.005,6,10,2006,5,927,1.0,659.0,659.0,5,1079,1.0,811.0,811.0
0.284,17,44,24452,24,21168,12.0,1350.0,854.0,20,3284,11.0,1350.0,136.0
0.005,6,10,2007,5,928,1.0,660.0,660.0,5,1079,1.0,811.0,811.0
0.001,17,2,180,1,66,0.0,38.0,38.0,1,114,0.0,86.0,86.0
0.044,6,3,210,2,132,44.0,28.0,28.0,1,78,0.0,26.0,26.0
10.864,17,28,4421,14,1993,827.0,268.0,114.0,14,2428,827.0,587.0,145.0
0.076,6,10,1506,5,395,15.0,127.0,127.0,5,1111,17.0,843.0,843.0
0.006,6,10,1774,5,923,1.0,655.0,655.0,5,851,1.0,583.0,583.0
40.085,17,10,676,5,460,10019.0,104.0,64.0,5,216,10020.0,20.0,15.0
0.003,17,4,284,2,120,0.0,32.0,32.0,2,164,0.0,60.0,54.0
0.092,6,10,1506,5,395,21.0,127.0,127.0,5,1111,22.0,843.0,843.0
0.004,6,10,2007,5,928,1.0,660.0,660.0,5,1079,1.0,811.0,811.0
40.067,17,10,676,5,460,10015.0,104.0,64.0,5,216,10016.0,20.0,15.0
0.012,6,10,1972,5,910,2.0,642.0,642.0,5,1062,2.0,794.0,794.0
0.018,6,10,1990,5,911,4.0,643.0,643.0,5,1079,4.0,811.0,811.0
0.017,6,10,1972,5,910,4.0,642.0,642.0,5,1062,4.0,794.0,794.0
0.109,6,10,1506,5,395,25.0,127.0,127.0,5,1111,24.0,843.0,843.0
0.009,6,10,1989,5,910,2.0,642.0,642.0,5,1079,2.0,811.0,811.0
15.076,17,14,9191,8,6902,2149.0,1350.0,834.0,6,2289,3009.0,1350.0,353.0
368.99,6,22,2313,16,867,24599.0,195.0,195.0,6,1446,4638.0,419.0,398.0
0.016,6,10,1989,5,910,3.0,642.0,642.0,5,1079,3.0,811.0,811.0
0.177,6,3,453,2,321,177.0,241.0,241.0,1,132,0.0,92.0,92.0
0.018,6,10,1983,5,910,4.0,642.0,642.0,5,1073,4.0,805.0,805.0
0.007,6,10,2006,5,927,1.0,659.0,659.0,5,1079,1.0,811.0,811.0
0.001,17,2,136,1,60,0.0,32.0,32.0,1,76,0.0,48.0,48.0
0.012,6,10,1989,5,910,2.0,642.0,642.0,5,1079,3.0,811.0,811.0
0.024,6,10,1983,5,910,5.0,642.0,642.0,5,1073,5.0,805.0,805.0
0.001,17,2,164,1,74,0.0,46.0,46.0,1,90,0.0,62.0,62.0
0.085,6,10,1506,5,395,21.0,127.0,127.0,5,1111,19.0,843.0,843.0
0.076,6,10,1506,5,395,17.0,127.0,127.0,5,1111,14.0,843.0,843.0
0.022,6,10,1983,5,910,5.0,642.0,642.0,5,1073,5.0,805.0,805.0
0.005,6,10,1989,5,927,1.0,659.0,659.0,5,1062,1.0,794.0,794.0
0.004,6,10,2006,5,927,1.0,659.0,659.0,5,1079,1.0,811.0,811.0
0.063,6,10,1506,5,395,13.0,127.0,127.0,5,1111,13.0,843.0,843.0
5.538,6,26,6666,15,1943,395.0,801.0,282.0,11,4723,553.0,1925.0,692.0
300.284,6,16,2170,9,684,37513.0,146.0,146.0,7,1486,50014.0,419.0,398.0
0.124,6,10,1506,5,395,17.0,127.0,127.0,5,1111,28.0,843.0,843.0
0.004,17,2,136,1,60,0.0,32.0,32.0,1,76,0.0,48.0,48.0
0.119,6,10,1506,5,395,28.0,127.0,127.0,5,1111,29.0,843.0,843.0
0.005,17,2,166,1,75,0.0,47.0,47.0,1,91,0.0,63.0,63.0
0.01,6,10,1762,5,911,2.0,643.0,643.0,5,851,2.0,583.0,583.0
0.005,6,10,2007,5,928,1.0,660.0,660.0,5,1079,1.0,811.0,811.0
240.498,6,36,10469,18,2211,14145.0,555.0,253.0,18,8258,14145.0,1402.0,610.0
0.016,6,10,1990,5,911,4.0,643.0,643.0,5,1079,3.0,811.0,811.0
0.004,17,2,148,1,60,0.0,32.0,32.0,1,88,0.0,60.0,60.0
0.125,6,10,1506,5,395,28.0,127.0,127.0,5,1111,29.0,843.0,843.0
1727.877,6,45,2790,30,1725,59581.0,35.0,35.0,15,1065,123414.0,31.0,31.0
0.014,6,14,3787,7,497,2.0,125.0,125.0,7,3290,2.0,1448.0,972.0
0.092,6,10,1506,5,395,21.0,127.0,127.0,5,1111,20.0,843.0,843.0
0.006,6,10,1547,5,764,1.0,496.0,496.0,5,783,1.0,515.0,515.0
11.184,17,28,4419,14,1994,847.0,269.0,114.0,14,2425,847.0,588.0,145.0
0.004,17,2,136,1,60,0.0,32.0,32.0,1,76,0.0,48.0,48.0
0.071,17,4,352,2,130,0.0,37.0,37.0,2,222,31.0,89.0,83.0
11.191,17,28,4422,14,2312,851.0,587.0,137.0,14,2110,851.0,269.0,122.0
0.01,6,10,1983,5,910,2.0,642.0,642.0,5,1073,2.0,805.0,805.0
0.005,17,2,169,1,62,0.0,34.0,34.0,1,107,0.0,79.0,79.0
1727.864,6,45,2790,30,1725,59581.0,35.0,35.0,15,1065,123413.0,31.0,31.0
0.004,17,2,148,1,60,0.0,32.0,32.0,1,88,0.0,60.0,60.0
0.024,6,10,1989,5,910,6.0,642.0,642.0,5,1079,6.0,811.0,811.0
240.11,6,34,9420,17,6972,15006.0,1980.0,675.0,17,2448,15006.0,580.0,172.0
0.005,17,2,144,1,64,0.0,36.0,36.0,1,80,0.0,52.0,52.0
0.09,6,10,1506,5,395,19.0,127.0,127.0,5,1111,21.0,843.0,843.0
0.001,17,2,179,1,62,0.0,34.0,34.0,1,117,0.0,89.0,89.0
0.079,6,10,1506,5,395,17.0,127.0,127.0,5,1111,17.0,843.0,843.0
40.056,17,10,676,5,460,10013.0,104.0,64.0,5,216,10013.0,20.0,15.0
0.018,17,2,152,1,56,0.0,28.0,28.0,1,96,0.0,68.0,68.0
0.005,6,10,2007,5,928,1.0,660.0,660.0,5,1079,1.0,811.0,811.0
0.011,6,10,1989,5,910,2.0,642.0,642.0,5,1079,2.0,811.0,811.0
0.141,17,2,80,1,32,0.0,4.0,4.0,1,48,0.0,20.0,20.0
0.049,17,2,152,1,76,0.0,48.0,48.0,1,76,0.0,48.0,48.0
0.144,6,10,1506,5,395,33.0,127.0,127.0,5,1111,25.0,843.0,843.0
0.225,6,16,2669,8,1395,32.0,533.0,323.0,8,1274,20.0,529.0,212.0
0.005,6,10,1689,5,839,1.0,571.0,571.0,5,850,1.0,582.0,582.0
0.013,6,10,1972,5,910,3.0,642.0,642.0,5,1062,3.0,794.0,794.0
0.005,6,10,2006,5,927,1.0,659.0,659.0,5,1079,1.0,811.0,811.0
0.13,17,4,352,2,130,0.0,37.0,37.0,2,222,92.0,89.0,83.0
0.005,6,10,1854,5,889,1.0,621.0,621.0,5,965,1.0,697.0,697.0
0.128,17,2,80,1,32,0.0,4.0,4.0,1,48,0.0,20.0,20.0
0.005,6,10,2006,5,927,1.0,659.0,659.0,5,1079,1.0,811.0,811.0
0.008,17,2,194,1,59,0.0,31.0,31.0,1,135,0.0,107.0,107.0
40.052,17,10,676,5,460,10012.0,104.0,64.0,5,216,10012.0,20.0,15.0
0.007,17,2,214,1,75,0.0,47.0,47.0,1,139,0.0,111.0,111.0
0.005,6,10,1547,5,764,1.0,496.0,496.0,5,783,1.0,515.0,515.0
1778.105,17,144,41760,72,22752,25043.0,288.0,288.0,72,19008,25043.0,236.0,236.0
0.067,17,8,3613,4,1874,22.0,1350.0,440.0,4,1739,11.0,1350.0,406.0
0.114,6,10,1506,5,395,26.0,127.0,127.0,5,1111,27.0,843.0,843.0
0.167,17,2,152,1,76,0.0,48.0,48.0,1,76,0.0,48.0,48.0
0.004,17,4,284,2,120,0.0,32.0,32.0,2,164,0.0,60.0,54.0
0.095,6,29,9171,15,6797,6.0,1908.0,667.0,14,2374,7.0,580.0,234.0
0.005,6,10,2006,5,927,1.0,659.0,659.0,5,1079,1.0,811.0,811.0
1770.8,17,120,11460,60,5460,30013.0,63.0,63.0,60,6000,30013.0,72.0,72.0
0.019,6,10,1677,5,827,4.0,559.0,559.0,5,850,4.0,582.0,582.0
0.002,17,2,136,1,60,0.0,32.0,32.0,1,76,0.0,48.0,48.0
40.048,17,10,676,5,460,10011.0,104.0,64.0,5,216,10011.0,20.0,15.0
0.012,6,10,1972,5,910,3.0,642.0,642.0,5,1062,2.0,794.0,794.0
15.172,17,42,20321,23,17131,688.0,1350.0,716.0,19,3190,841.0,1350.0,139.0
0.014,6,10,1990,5,911,3.0,643.0,643.0,5,1079,3.0,811.0,811.0
0.069,17,8,3613,4,1874,23.0,1350.0,440.0,4,1739,12.0,1350.0,406.0
40.073,17,10,676,5,460,10016.0,104.0,64.0,5,216,10017.0,20.0,15.0
0.001,17,2,180,1,66,0.0,38.0,38.0,1,114,0.0,86.0,86.0
0.005,6,10,2006,5,927,1.0,659.0,659.0,5,1079,1.0,811.0,811.0
0.005,17,2,170,1,65,0.0,37.0,37.0,1,105,0.0,77.0,77.0
0.093,6,10,1506,5,395,19.0,127.0,127.0,5,1111,19.0,843.0,843.0
0.164,6,10,1506,5,395,38.0,127.0,127.0,5,1111,35.0,843.0,843.0
0.01,6,10,1989,5,910,2.0,642.0,642.0,5,1079,2.0,811.0,811.0
0.005,6,10,2007,5,928,1.0,660.0,660.0,5,1079,1.0,811.0,811.0
0.038,17,4,284,2,120,0.0,32.0,32.0,2,164,35.0,60.0,54.0
0.017,6,14,3787,7,497,2.0,125.0,125.0,7,3290,2.0,1448.0,972.0
0.006,6,10,2007,5,928,1.0,660.0,660.0,5,1079,1.0,811.0,811.0
0.223,6,16,2777,8,1395,31.0,533.0,323.0,8,1382,20.0,529.0,239.0
0.073,6,10,1506,5,395,15.0,127.0,127.0,5,1111,16.0,843.0,843.0
0.004,6,10,2000,5,927,1.0,659.0,659.0,5,1073,1.0,805.0,805.0
0.042,6,10,1989,5,910,10.0,642.0,642.0,5,1079,10.0,811.0,811.0
0.004,6,10,2007,5,928,1.0,660.0,660.0,5,1079,1.0,811.0,811.0
0.008,6,10,1989,5,927,2.0,659.0,659.0,5,1062,2.0,794.0,794.0
0.001,17,2,179,1,62,0.0,34.0,34.0,1,117,0.0,89.0,89.0
0.015,6,10,1989,5,910,3.0,642.0,642.0,5,1079,3.0,811.0,811.0
318.525,17,20,1124,10,716,35376.0,48.0,43.0,10,408,35376.0,20.0,12.0
0.014,6,10,1989,5,910,3.0,642.0,642.0,5,1079,3.0,811.0,811.0
0.004,17,2,136,1,60,0.0,32.0,32.0,1,76,0.0,48.0,48.0
0.005,6,10,1643,5,860,1.0,592.0,592.0,5,783,1.0,515.0,515.0
0.002,17,2,180,1,66,0.0,38.0,38.0,1,114,0.0,86.0,86.0
0.172,17,2,152,1,76,0.0,48.0,48.0,1,76,0.0,48.0,48.0
0.004,6,10,1989,5,927,1.0,659.0,659.0,5,1062,1.0,794.0,794.0
0.088,6,10,1506,5,395,19.0,127.0,127.0,5,1111,18.0,843.0,843.0
0.006,6,10,1547,5,764,1.0,496.0,496.0,5,783,1.0,515.0,515.0
0.012,6,10,1989,5,910,3.0,642.0,642.0,5,1079,3.0,811.0,811.0
0.015,6,10,1989,5,910,3.0,642.0,642.0,5,1079,3.0,811.0,811.0
0.005,6,10,2000,5,927,1.0,659.0,659.0,5,1073,1.0,805.0,805.0
0.006,6,10,1547,5,764,1.0,496.0,496.0,5,783,1.0,515.0,515.0
0.005,6,10,1779,5,928,1.0,660.0,660.0,5,851,1.0,583.0,583.0
0.09,6,10,1506,5,395,16.0,127.0,127.0,5,1111,21.0,843.0,843.0
0.005,6,10,2007,5,928,1.0,660.0,660.0,5,1079,1.0,811.0,811.0
0.008,6,10,1677,5,827,2.0,559.0,559.0,5,850,1.0,582.0,582.0
369.538,6,22,2313,16,867,24635.0,195.0,195.0,6,1446,4638.0,419.0,398.0
0.006,6,10,1547,5,764,1.0,496.0,496.0,5,783,1.0,515.0,515.0
0.005,17,2,170,1,65,0.0,37.0,37.0,1,105,0.0,77.0,77.0
240.046,6,9,787,5,488,60011.0,232.0,232.0,4,299,80009.0,83.0,83.0
0.003,17,2,136,1,60,0.0,32.0,32.0,1,76,0.0,48.0,48.0
0.013,6,13,3735,7,497,2.0,125.0,125.0,6,3238,2.0,1470.0,1459.0
0.005,17,2,136,1,60,0.0,32.0,32.0,1,76,0.0,48.0,48.0
0.01,6,10,1990,5,911,2.0,643.0,643.0,5,1079,2.0,811.0,811.0
0.085,17,2,364,1,61,0.0,33.0,33.0,1,303,0.0,275.0,275.0
0.007,6,10,1547,5,764,1.0,496.0,496.0,5,783,1.0,515.0,515.0
0.005,6,10,2006,5,927,1.0,659.0,659.0,5,1079,1.0,811.0,811.0
161.383,17,80,11142,40,2664,4137.0,44.0,38.0,40,8478,4137.0,249.0,183.0
0.019,6,10,1972,5,910,4.0,642.0,642.0,5,1062,4.0,794.0,794.0
0.067,6,10,1506,5,395,15.0,127.0,127.0,5,1111,13.0,843.0,843.0
0.005,6,10,2007,5,928,1.0,660.0,660.0,5,1079,1.0,811.0,811.0
0.004,17,2,170,1,65,0.0,37.0,37.0,1,105,0.0,77.0,77.0
0.071,17,2,166,1,75,0.0,47.0,47.0,1,91,0.0,63.0,63.0
0.042,6,10,1990,5,911,10.0,643.0,643.0,5,1079,10.0,811.0,811.0
0.004,6,10,2006,5,927,1.0,659.0,659.0,5,1079,1.0,811.0,811.0
308.803,17,20,1124,10,716,34296.0,48.0,43.0,10,408,34297.0,20.0,12.0
0.04,17,2,136,1,60,0.0,32.0,32.0,1,76,0.0,48.0,48.0
0.01,6,10,1989,5,910,2.0,642.0,642.0,5,1079,2.0,811.0,811.0
308.583,17,20,1124,10,716,34272.0,48.0,43.0,10,408,34272.0,20.0,12.0
0.015,6,10,1762,5,911,3.0,643.0,643.0,5,851,3.0,583.0,583.0
0.005,6,12,3695,7,509,0.0,137.0,137.0,5,3186,1.0,2918.0,2918.0
0.011,6,10,1983,5,910,2.0,642.0,642.0,5,1073,2.0,805.0,805.0
40.083,17,10,676,5,460,10019.0,104.0,64.0,5,216,10019.0,20.0,15.0
0.018,6,10,1631,5,848,4.0,580.0,580.0,5,783,4.0,515.0,515.0
0.086,6,10,1506,5,395,20.0,127.0,127.0,5,1111,20.0,843.0,843.0
0.005,6,10,2006,5,927,1.0,659.0,659.0,5,1079,1.0,811.0,811.0
1786.451,6,154,19574,92,13852,19631.0,302.0,302.0,62,5722,29286.0,83.0,83.0
0.005,6,10,1774,5,923,1.0,655.0,655.0,5,851,1.0,583.0,583.0
0.011,6,10,1677,5,827,2.0,559.0,559.0,5,850,2.0,582.0,582.0
0.008,6,10,1989,5,910,2.0,642.0,642.0,5,1079,2.0,811.0,811.0
0.004,6,10,2000,5,927,1.0,659.0,659.0,5,1073,1.0,805.0,805.0
0.076,6,10,1506,5,395,16.0,127.0,127.0,5,1111,16.0,843.0,843.0
0.011,6,10,1972,5,910,2.0,642.0,642.0,5,1062,2.0,794.0,794.0
0.074,6,10,1506,5,395,16.0,127.0,127.0,5,1111,17.0,843.0,843.0
0.004,6,10,2007,5,928,1.0,660.0,660.0,5,1079,1.0,811.0,811.0
0.009,6,10,1989,5,910,2.0,642.0,642.0,5,1079,2.0,811.0,811.0
0.075,6,10,1506,5,395,18.0,127.0,127.0,5,1111,17.0,843.0,843.0
0.007,6,10,1983,5,910,1.0,642.0,642.0,5,1073,1.0,805.0,805.0
0.005,6,10,2006,5,927,1.0,659.0,659.0,5,1079,1.0,811.0,811.0
0.001,17,2,166,1,75,0.0,47.0,47.0,1,91,0.0,63.0,63.0
0.367,17,40,20192,21,17032,18.0,1350.0,783.0,19,3160,18.0,1350.0,138.0
0.08,6,10,1506,5,395,18.0,127.0,127.0,5,1111,17.0,843.0,843.0
0.0,17,2,179,1,62,0.0,34.0,34.0,1,117,0.0,89.0,89.0
373.865,6,22,2313,16,867,24924.0,195.0,195.0,6,1446,4652.0,419.0,398.0
0.009,6,10,1989,5,910,2.0,642.0,642.0,5,1079,2.0,811.0,811.0
0.008,6,10,1547,5,764,2.0,496.0,496.0,5,783,1.0,515.0,515.0
0.04,17,4,284,2,120,0.0,32.0,32.0,2,164,37.0,60.0,54.0
0.114,6,10,1506,5,395,27.0,127.0,127.0,5,1111,23.0,843.0,843.0
0.013,6,10,1762,5,911,3.0,643.0,643.0,5,851,3.0,583.0,583.0
0.04,17,2,170,1,65,0.0,37.0,37.0,1,105,0.0,77.0,77.0
0.016,17,2,198,1,91,0.0,63.0,63.0,1,107,0.0,79.0,79.0
0.009,6,10,1989,5,910,2.0,642.0,642.0,5,1079,2.0,811.0,811.0
0.004,17,2,136,1,60,0.0,32.0,32.0,1,76,0.0,48.0,48.0
0.004,6,10,2007,5,928,1.0,660.0,660.0,5,1079,1.0,811.0,811.0
0.006,17,2,170,1,65,0.0,37.0,37.0,1,105,0.0,77.0,77.0
308.466,17,20,1124,10,716,34257.0,48.0,43.0,10,408,34255.0,20.0,12.0
0.011,6,10,1989,5,910,2.0,642.0,642.0,5,1079,2.0,811.0,811.0
0.067,17,8,3613,4,1874,22.0,1350.0,440.0,4,1739,11.0,1350.0,406.0
0.005,6,10,1689,5,839,1.0,571.0,571.0,5,850,1.0,582.0,582.0
0.008,6,10,1547,5,764,1.0,496.0,496.0,5,783,1.0,515.0,515.0
0.169,17,2,152,1,76,0.0,48.0,48.0,1,76,0.0,48.0,48.0
0.015,6,10,1631,5,848,3.0,580.0,580.0,5,783,3.0,515.0,515.0
0.003,17,2,136,1,60,0.0,32.0,32.0,1,76,0.0,48.0,48.0
0.009,6,10,1762,5,911,2.0,643.0,643.0,5,851,2.0,583.0,583.0
0.008,6,12,1926,6,1189,1.0,659.0,434.0,6,737,1.0,417.0,417.0
0.008,6,10,1972,5,910,1.0,642.0,642.0,5,1062,2.0,794.0,794.0
0.006,17,2,179,1,71,0.0,43.0,43.0,1,108,0.0,80.0,80.0
40.094,17,10,676,5,460,10020.0,104.0,64.0,5,216,10022.0,20.0,15.0
178.35,17,70,10007,35,2330,5245.0,44.0,38.0,35,7677,5245.0,239.0,191.0
0.003,17,2,148,1,60,0.0,32.0,32.0,1,88,0.0,60.0,60.0
0.005,6,13,3747,7,509,0.0,137.0,137.0,6,3238,0.0,1470.0,1459.0
0.004,17,4,284,2,120,0.0,32.0,32.0,2,164,1.0,60.0,54.0
0.004,6,10,2007,5,928,1.0,660.0,660.0,5,1079,1.0,811.0,811.0
301.084,6,49,19492,26,13729,12043.0,4080.0,1405.0,23,5763,404.0,2667.0,402.0
0.04,17,4,420,2,122,0.0,33.0,33.0,2,298,36.0,145.0,121.0
0.014,6,10,1989,5,910,3.0,642.0,642.0,5,1079,3.0,811.0,811.0
0.084,6,10,1506,5,395,20.0,127.0,127.0,5,1111,17.0,843.0,843.0
10.788,17,28,4419,14,1994,821.0,269.0,114.0,14,2425,821.0,588.0,145.0
0.005,6,10,1689,5,839,1.0,571.0,571.0,5,850,1.0,582.0,582.0
0.016,6,10,1983,5,910,3.0,642.0,642.0,5,1073,3.0,805.0,805.0
0.006,17,2,194,1,59,0.0,31.0,31.0,1,135,0.0,107.0,107.0
0.009,6,10,2007,5,928,2.0,660.0,660.0,5,1079,2.0,811.0,811.0
0.13,6,10,1506,5,395,29.0,127.0,127.0,5,1111,28.0,843.0,843.0
0.008,17,2,194,1,59,0.0,31.0,31.0,1,135,0.0,107.0,107.0
0.018,17,2,136,1,60,0.0,32.0,32.0,1,76,0.0,48.0,48.0
0.076,6,10,1506,5,395,16.0,127.0,127.0,5,1111,18.0,843.0,843.0
60.383,6,37,10002,19,4484,499.0,1360.0,738.0,18,5518,3542.0,2667.0,435.0
0.08,6,10,1506,5,395,15.0,127.0,127.0,5,1111,15.0,843.0,843.0
0.039,17,2,136,1,60,0.0,32.0,32.0,1,76,0.0,48.0,48.0
0.004,6,10,2006,5,927,1.0,659.0,659.0,5,1079,1.0,811.0,811.0
412.264,6,29,4409,12,3102,10912.0,494.0,494.0,17,1307,25766.0,83.0,83.0
0.005,17,2,144,1,64,0.0,36.0,36.0,1,80,0.0,52.0,52.0
0.006,6,14,3799,7,509,1.0,137.0,137.0,7,3290,0.0,1448.0,972.0
0.072,6,10,1506,5,395,16.0,127.0,127.0,5,1111,14.0,843.0,843.0
0.004,6,10,2007,5,928,1.0,660.0,660.0,5,1079,1.0,811.0,811.0
0.18,17,4,352,2,130,141.0,37.0,37.0,2,222,143.0,89.0,83.0
10.813,17,28,4423,14,1995,823.0,270.0,114.0,14,2428,823.0,587.0,145.0
0.007,17,2,273,1,66,0.0,38.0,38.0,1,207,0.0,179.0,179.0
300.327,6,16,2170,9,684,37520.0,146.0,146.0,7,1486,50027.0,419.0,398.0
0.127,6,10,1506,5,395,29.0,127.0,127.0,5,1111,24.0,843.0,843.0
0.01,6,10,1631,5,848,2.0,580.0,580.0,5,783,2.0,515.0,515.0
0.093,6,10,1506,5,395,17.0,127.0,127.0,5,1111,21.0,843.0,843.0
0.004,6,10,1989,5,927,1.0,659.0,659.0,5,1062,1.0,794.0,794.0
0.007,6,10,1547,5,764,1.0,496.0,496.0,5,783,1.0,515.0,515.0
241.238,6,305,343989,111,17285,2193.0,2736.0,959.0,194,326704,1249.0,2916.0,1720.0
0.105,6,10,1506,5,395,25.0,127.0,127.0,5,1111,20.0,843.0,843.0
0.308,17,47,28063,27,24825,11.0,1350.0,891.0,20,3238,13.0,1350.0,133.0
0.004,17,4,420,2,122,0.0,33.0,33.0,2,298,1.0,145.0,121.0
0.016,6,10,1677,5,827,3.0,559.0,559.0,5,850,3.0,582.0,582.0
0.007,6,10,1547,5,764,1.0,496.0,496.0,5,783,1.0,515.0,515.0
0.017,6,10,1990,5,911,4.0,643.0,643.0,5,1079,4.0,811.0,811.0
0.018,6,10,1990,5,911,4.0,643.0,643.0,5,1079,4.0,811.0,811.0
0.011,6,10,1989,5,910,2.0,642.0,642.0,5,1079,2.0,811.0,811.0
0.001,17,2,180,1,66,0.0,38.0,38.0,1,114,0.0,86.0,86.0
79.045,58,5,360,4,288,26348.0,24.0,24.0,1,72,0.0,24.0,24.0
0.005,6,10,2006,5,927,1.0,659.0,659.0,5,1079,1.0,811.0,811.0
0.005,6,10,1643,5,860,1.0,592.0,592.0,5,783,1.0,515.0,515.0
0.104,17,2,144,1,64,0.0,36.0,36.0,1,80,0.0,52.0,52.0
0.01,6,10,1983,5,910,2.0,642.0,642.0,5,1073,2.0,805.0,805.0
0.003,17,2,136,1,60,0.0,32.0,32.0,1,76,0.0,48.0,48.0
0.014,6,10,1990,5,911,3.0,643.0,643.0,5,1079,3.0,811.0,811.0
0.012,6,10,1677,5,827,3.0,559.0,559.0,5,850,3.0,582.0,582.0
0.088,6,10,1506,5,395,19.0,127.0,127.0,5,1111,17.0,843.0,843.0
11.136,17,28,4418,14,1994,844.0,269.0,114.0,14,2424,844.0,587.0,145.0
0.067,17,8,3613,4,1874,22.0,1350.0,440.0,4,1739,10.0,1350.0,406.0
0.005,6,10,2000,5,927,1.0,659.0,659.0,5,1073,1.0,805.0,805.0
0.092,6,10,1506,5,395,20.0,127.0,127.0,5,1111,20.0,843.0,843.0
0.013,6,10,1989,5,910,3.0,642.0,642.0,5,1079,3.0,811.0,811.0
240.139,6,30,9340,15,6989,17152.0,2113.0,690.0,15,2351,17152.0,580.0,223.0
0.005,6,10,1989,5,927,1.0,659.0,659.0,5,1062,1.0,794.0,794.0
40.069,17,10,676,5,460,10014.0,104.0,64.0,5,216,10015.0,20.0,15.0
40.065,17,10,676,5,460,10015.0,104.0,64.0,5,216,10015.0,20.0,15.0
0.006,6,10,1547,5,764,1.0,496.0,496.0,5,783,1.0,515.0,515.0
240.097,6,16,4481,9,963,30012.0,238.0,166.0,7,3518,40015.0,1402.0,786.0
0.271,17,36,19955,21,17033,13.0,1350.0,783.0,15,2922,15.0,1350.0,166.0
0.005,17,2,144,1,64,0.0,36.0,36.0,1,80,0.0,52.0,52.0
0.006,17,2,170,1,65,0.0,37.0,37.0,1,105,0.0,77.0,77.0
0.004,17,2,169,1,62,0.0,34.0,34.0,1,107,0.0,79.0,79.0
0.007,17,2,142,1,63,0.0,35.0,35.0,1,79,0.0,51.0,51.0
0.1,6,10,1506,5,395,21.0,127.0,127.0,5,1111,22.0,843.0,843.0
0.076,6,10,1506,5,395,14.0,127.0,127.0,5,1111,18.0,843.0,843.0
0.105,6,10,1506,5,395,23.0,127.0,127.0,5,1111,19.0,843.0,843.0
240.122,6,16,4482,9,963,30015.0,238.0,166.0,7,3519,40019.0,1402.0,786.0
0.111,6,10,1506,5,395,24.0,127.0,127.0,5,1111,25.0,843.0,843.0
0.021,6,10,1989,5,910,5.0,642.0,642.0,5,1079,5.0,811.0,811.0
1745.85,6,304,98281,187,86998,9386.0,2001.0,683.0,117,11283,15050.0,452.0,71.0
0.001,17,2,180,1,66,0.0,38.0,38.0,1,114,0.0,86.0,86.0
0.005,6,10,2000,5,927,1.0,659.0,659.0,5,1073,1.0,805.0,805.0
15.071,17,14,9191,8,6902,2148.0,1350.0,834.0,6,2289,3008.0,1350.0,353.0
0.004,6,10,2007,5,928,1.0,660.0,660.0,5,1079,1.0,811.0,811.0
0.129,6,10,1506,5,395,28.0,127.0,127.0,5,1111,31.0,843.0,843.0
0.004,6,10,2000,5,927,1.0,659.0,659.0,5,1073,1.0,805.0,805.0
167.345,17,82,11793,41,2756,4183.0,44.0,39.0,41,9037,4183.0,239.0,192.0
0.061,6,10,1506,5,395,13.0,127.0,127.0,5,1111,13.0,843.0,843.0
0.013,6,10,1990,5,911,3.0,643.0,643.0,5,1079,3.0,811.0,811.0
240.252,6,43,8771,21,5686,12012.0,1515.0,509.0,22,3085,11440.0,580.0,241.0
0.096,6,10,1506,5,395,17.0,127.0,127.0,5,1111,22.0,843.0,843.0
0.175,17,2,152,1,76,0.0,48.0,48.0,1,76,0.0,48.0,48.0
0.006,6,10,1854,5,889,1.0,621.0,621.0,5,965,1.0,697.0,697.0
0.002,17,2,136,1,60,0.0,32.0,32.0,1,76,0.0,48.0,48.0
0.014,6,10,1989,5,910,3.0,642.0,642.0,5,1079,3.0,811.0,811.0
0.003,17,2,136,1,60,0.0,32.0,32.0,1,76,0.0,48.0,48.0
0.079,6,10,1506,5,395,17.0,127.0,127.0,5,1111,16.0,843.0,843.0
0.108,6,10,1506,5,395,26.0,127.0,127.0,5,1111,21.0,843.0,843.0
0.004,6,10,2000,5,927,1.0,659.0,659.0,5,1073,1.0,805.0,805.0
351.986,6,20,2210,6,1308,12003.0,494.0,494.0,14,902,27075.0,83.0,83.0
0.004,6,10,1702,5,863,1.0,595.0,595.0,5,839,0.0,571.0,571.0
0.072,17,2,136,1,60,0.0,32.0,32.0,1,76,0.0,48.0,48.0
40.056,17,10,676,5,460,10013.0,104.0,64.0,5,216,10013.0,20.0,15.0
0.003,17,2,187,1,74,0.0,46.0,46.0,1,113,0.0,85.0,85.0
0.001,17,2,180,1,66,0.0,38.0,38.0,1,114,0.0,86.0,86.0
0.015,6,10,1990,5,911,3.0,643.0,643.0,5,1079,3.0,811.0,811.0
0.004,6,10,2006,5,927,1.0,659.0,659.0,5,1079,1.0,811.0,811.0
0.005,6,10,2000,5,927,1.0,659.0,659.0,5,1073,1.0,805.0,805.0
177.297,17,80,11462,40,2677,4545.0,44.0,38.0,40,8785,4545.0,239.0,191.0
0.038,17,2,396,1,61,0.0,33.0,33.0,1,335,0.0,307.0,307.0
23.15,6,40,22841,21,1150,1157.0,290.0,290.0,19,21691,1283.0,1493.0,1307.0
0.009,17,2,162,1,65,0.0,37.0,37.0,1,97,0.0,69.0,69.0
0.014,6,10,1762,5,911,3.0,643.0,643.0,5,851,3.0,583.0,583.0
0.005,6,10,2000,5,927,1.0,659.0,659.0,5,1073,1.0,805.0,805.0
0.021,6,10,1989,5,910,5.0,642.0,642.0,5,1079,5.0,811.0,811.0
0.005,17,2,170,1,65,0.0,37.0,37.0,1,105,0.0,77.0,77.0
0.117,6,10,1506,5,395,27.0,127.0,127.0,5,1111,27.0,843.0,843.0
0.005,17,2,214,1,75,0.0,47.0,47.0,1,139,0.0,111.0,111.0
0.009,17,2,164,1,74,0.0,46.0,46.0,1,90,0.0,62.0,62.0
0.012,6,10,1972,5,910,3.0,642.0,642.0,5,1062,3.0,794.0,794.0
0.009,6,10,2006,5,927,2.0,659.0,659.0,5,1079,2.0,811.0,811.0
0.009,6,10,1547,5,764,2.0,496.0,496.0,5,783,2.0,515.0,515.0
0.005,6,10,1643,5,860,1.0,592.0,592.0,5,783,1.0,515.0,515.0
0.013,6,10,1990,5,911,3.0,643.0,643.0,5,1079,3.0,811.0,811.0
40.059,17,10,676,5,460,10013.0,104.0,64.0,5,216,10014.0,20.0,15.0
177.193,17,88,12492,44,2936,4120.0,44.0,38.0,44,9556,4120.0,239.0,189.0
0.005,6,14,3736,7,446,0.0,74.0,74.0,7,3290,0.0,1448.0,972.0
0.004,17,2,164,1,74,0.0,46.0,46.0,1,90,0.0,62.0,62.0
0.019,6,10,1990,5,911,4.0,643.0,643.0,5,1079,4.0,811.0,811.0
1762.25,6,64,7363,42,4485,42981.0,1641.0,109.0,22,2878,83907.0,1114.0,82.0
0.081,6,10,1506,5,395,18.0,127.0,127.0,5,1111,15.0,843.0,843.0
0.071,17,4,284,2,120,0.0,32.0,32.0,2,164,68.0,60.0,54.0
0.007,6,10,1983,5,910,1.0,642.0,642.0,5,1073,1.0,805.0,805.0
0.037,17,2,148,1,60,0.0,32.0,32.0,1,88,0.0,60.0,60.0
0.075,6,10,1506,5,395,16.0,127.0,127.0,5,1111,18.0,843.0,843.0
0.005,6,10,2000,5,927,1.0,659.0,659.0,5,1073,1.0,805.0,805.0
0.015,6,10,1983,5,910,3.0,642.0,642.0,5,1073,3.0,805.0,805.0
0.008,17,2,144,1,64,0.0,36.0,36.0,1,80,0.0,52.0,52.0
40.07,17,10,676,5,460,10015.0,104.0,64.0,5,216,10016.0,20.0,15.0
0.005,6,10,2007,5,928,1.0,660.0,660.0,5,1079,1.0,811.0,811.0
1772.75,6,310,51013,128,30744,13957.0,2720.0,255.0,182,20269,9793.0,1360.0,149.0
0.055,6,10,1506,5,395,12.0,127.0,127.0,5,1111,13.0,843.0,843.0
0.006,6,10,1854,5,889,1.0,621.0,621.0,5,965,1.0,697.0,697.0
0.007,17,2,194,1,59,0.0,31.0,31.0,1,135,0.0,107.0,107.0
0.08,6,10,1506,5,395,17.0,127.0,127.0,5,1111,17.0,843.0,843.0
0.039,17,2,148,1,60,0.0,32.0,32.0,1,88,0.0,60.0,60.0
0.069,6,27,10046,14,8890,5.0,2261.0,1020.0,13,1156,5.0,230.0,80.0
0.014,6,10,1983,5,910,3.0,642.0,642.0,5,1073,3.0,805.0,805.0
0.122,6,10,1506,5,395,28.0,127.0,127.0,5,1111,28.0,843.0,843.0
0.065,6,10,1506,5,395,13.0,127.0,127.0,5,1111,15.0,843.0,843.0
0.004,6,10,2006,5,927,1.0,659.0,659.0,5,1079,1.0,811.0,811.0
308.881,17,20,1124,10,716,34313.0,48.0,43.0,10,408,34313.0,20.0,12.0
0.01,6,10,1990,5,911,2.0,643.0,643.0,5,1079,2.0,811.0,811.0
0.003,17,2,136,1,60,0.0,32.0,32.0,1,76,0.0,48.0,48.0
412.014,6,29,4409,12,3102,10913.0,494.0,494.0,17,1307,25750.0,83.0,83.0
0.005,6,10,1643,5,860,1.0,592.0,592.0,5,783,1.0,515.0,515.0
0.005,6,10,2006,5,927,1.0,659.0,659.0,5,1079,1.0,811.0,811.0
1770.47,6,83,4368,42,2210,43181.0,26.0,26.0,41,2158,44260.0,26.0,26.0
300.02,6,12,1782,7,1348,50003.0,494.0,494.0,5,434,75004.0,83.0,83.0
0.007,6,10,1989,5,927,1.0,659.0,659.0,5,1062,1.0,794.0,794.0
15.072,17,15,9238,8,6902,2149.0,1350.0,834.0,7,2336,2507.0,1350.0,305.0
0.007,6,10,1990,5,911,1.0,643.0,643.0,5,1079,1.0,811.0,811.0
0.01,6,10,1972,5,910,2.0,642.0,642.0,5,1062,2.0,794.0,794.0
0.042,17,2,156,1,64,0.0,36.0,36.0,1,92,0.0,64.0,64.0
0.021,6,10,1983,5,910,5.0,642.0,642.0,5,1073,5.0,805.0,805.0
0.015,6,10,1972,5,910,3.0,642.0,642.0,5,1062,3.0,794.0,794.0
0.038,17,4,284,2,120,1.0,32.0,32.0,2,164,34.0,60.0,54.0
0.011,6,10,1990,5,911,2.0,643.0,643.0,5,1079,2.0,811.0,811.0
0.003,17,4,284,2,120,0.0,32.0,32.0,2,164,0.0,60.0,54.0
0.074,6,10,1506,5,395,17.0,127.0,127.0,5,1111,16.0,843.0,843.0
0.004,6,10,2007,5,928,1.0,660.0,660.0,5,1079,1.0,811.0,811.0
0.038,17,4,284,2,120,0.0,32.0,32.0,2,164,33.0,60.0,54.0
0.062,6,10,1506,5,395,12.0,127.0,127.0,5,1111,12.0,843.0,843.0
240.721,6,39,9746,20,2188,12667.0,708.0,228.0,19,7558,13371.0,1402.0,547.0
0.116,6,10,1506,5,395,25.0,127.0,127.0,5,1111,19.0,843.0,843.0
41.465,6,40,12519,20,6876,467.0,2959.0,1508.0,20,5643,2173.0,2667.0,402.0
0.1,6,10,1506,5,395,20.0,127.0,127.0,5,1111,20.0,843.0,843.0
0.021,6,10,1631,5,848,5.0,580.0,580.0,5,783,5.0,515.0,515.0
40.065,17,10,676,5,460,10014.0,104.0,64.0,5,216,10015.0,20.0,15.0
0.017,6,10,1989,5,910,4.0,642.0,642.0,5,1079,4.0,811.0,811.0
0.013,17,2,152,1,56,0.0,28.0,28.0,1,96,0.0,68.0,68.0
0.094,6,10,1506,5,395,21.0,127.0,127.0,5,1111,21.0,843.0,843.0
0.004,17,2,148,1,60,0.0,32.0,32.0,1,88,0.0,60.0,60.0
0.179,6,10,1506,5,395,42.0,127.0,127.0,5,1111,40.0,843.0,843.0
0.078,6,10,1506,5,395,17.0,127.0,127.0,5,1111,18.0,843.0,843.0
0.011,6,10,1972,5,910,2.0,642.0,642.0,5,1062,2.0,794.0,794.0
0.151,6,10,1506,5,395,32.0,127.0,127.0,5,1111,33.0,843.0,843.0
241.531,6,381,346806,189,21348,1284.0,2736.0,959.0,192,325458,1264.0,2804.0,1733.0
11.162,17,28,4417,14,1992,845.0,267.0,114.0,14,2425,846.0,588.0,145.0
0.089,6,10,1506,5,395,18.0,127.0,127.0,5,1111,18.0,843.0,843.0
15.072,17,15,9239,8,6902,2149.0,1350.0,834.0,7,2337,2507.0,1350.0,305.0
40.061,17,10,676,5,460,10013.0,104.0,64.0,5,216,10014.0,20.0,15.0
0.005,6,10,2006,5,927,1.0,659.0,659.0,5,1079,1.0,811.0,811.0
0.013,6,10,1631,5,848,3.0,580.0,580.0,5,783,3.0,515.0,515.0
353.593,6,20,2210,6,1308,12003.0,494.0,494.0,14,902,27199.0,83.0,83.0
0.005,6,10,1989,5,927,1.0,659.0,659.0,5,1062,1.0,794.0,794.0
0.006,6,10,1689,5,839,1.0,571.0,571.0,5,850,1.0,582.0,582.0
0.006,6,10,1643,5,860,1.0,592.0,592.0,5,783,1.0,515.0,515.0
0.004,17,2,148,1,60,0.0,32.0,32.0,1,88,0.0,60.0,60.0
0.005,6,10,2000,5,927,1.0,659.0,659.0,5,1073,1.0,805.0,805.0
11.077,17,28,4399,14,2312,843.0,587.0,137.0,14,2087,843.0,270.0,121.0
132.467,6,22,8497,12,2236,75.0,1345.0,574.0,10,6261,14699.0,2720.0,974.0
0.004,17,2,148,1,60,0.0,32.0,32.0,1,88,0.0,60.0,60.0
0.01,6,10,1972,5,910,2.0,642.0,642.0,5,1062,2.0,794.0,794.0
1776.6,6,309,98515,189,87177,9450.0,2001.0,696.0,120,11338,14929.0,452.0,68.0
0.005,17,2,179,1,71,0.0,43.0,43.0,1,108,0.0,80.0,80.0
0.005,17,2,180,1,66,0.0,38.0,38.0,1,114,0.0,86.0,86.0
40.057,17,10,676,5,460,10013.0,104.0,64.0,5,216,10013.0,20.0,15.0
0.083,6,10,1506,5,395,20.0,127.0,127.0,5,1111,16.0,843.0,843.0
0.005,17,2,170,1,65,0.0,37.0,37.0,1,105,0.0,77.0,77.0
0.005,6,10,2006,5,927,1.0,659.0,659.0,5,1079,1.0,811.0,811.0
0.119,6,10,1506,5,395,27.0,127.0,127.0,5,1111,25.0,843.0,843.0
0.004,6,10,1774,5,923,1.0,655.0,655.0,5,851,1.0,583.0,583.0
0.011,6,10,1972,5,910,2.0,642.0,642.0,5,1062,2.0,794.0,794.0
0.077,6,10,1506,5,395,17.0,127.0,127.0,5,1111,17.0,843.0,843.0
0.005,6,10,1689,5,839,1.0,571.0,571.0,5,850,1.0,582.0,582.0
0.009,6,10,1983,5,910,2.0,642.0,642.0,5,1073,2.0,805.0,805.0
0.003,17,2,152,1,76,0.0,48.0,48.0,1,76,0.0,48.0,48.0
0.005,6,10,2006,5,927,1.0,659.0,659.0,5,1079,1.0,811.0,811.0
0.005,6,10,1989,5,927,1.0,659.0,659.0,5,1062,1.0,794.0,794.0
15.093,17,16,10622,9,8280,1881.0,1350.0,892.0,7,2342,2508.0,1350.0,306.0
0.005,6,10,1854,5,889,1.0,621.0,621.0,5,965,1.0,697.0,697.0
0.012,6,13,3735,7,497,1.0,125.0,125.0,6,3238,2.0,1470.0,1459.0
0.006,6,10,1854,5,889,1.0,621.0,621.0,5,965,1.0,697.0,697.0
0.001,17,2,180,1,66,0.0,38.0,38.0,1,114,0.0,86.0,86.0
0.015,6,10,1989,5,910,3.0,642.0,642.0,5,1079,3.0,811.0,811.0
0.011,6,10,1762,5,911,2.0,643.0,643.0,5,851,2.0,583.0,583.0
0.006,6,10,1547,5,764,1.0,496.0,496.0,5,783,1.0,515.0,515.0
10.764,17,26,4098,13,1846,887.0,269.0,114.0,13,2252,887.0,587.0,145.0
0.116,6,10,1506,5,395,20.0,127.0,127.0,5,1111,26.0,843.0,843.0
0.01,6,10,1972,5,910,2.0,642.0,642.0,5,1062,2.0,794.0,794.0
0.005,6,10,2000,5,927,1.0,659.0,659.0,5,1073,1.0,805.0,805.0
240.095,6,16,4481,9,963,30011.0,238.0,166.0,7,3518,40015.0,1402.0,786.0
0.096,6,10,1506,5,395,21.0,127.0,127.0,5,1111,20.0,843.0,843.0
0.122,6,10,1506,5,395,28.0,127.0,127.0,5,1111,27.0,843.0,843.0
0.078,6,10,1506,5,395,16.0,127.0,127.0,5,1111,19.0,843.0,843.0
0.005,17,2,136,1,60,0.0,32.0,32.0,1,76,0.0,48.0,48.0
0.004,6,10,2007,5,928,1.0,660.0,660.0,5,1079,1.0,811.0,811.0
0.004,17,4,284,2,120,0.0,32.0,32.0,2,164,0.0,60.0,54.0
0.105,6,10,1506,5,395,23.0,127.0,127.0,5,1111,22.0,843.0,843.0
180.505,6,68,19763,39,5170,4749.0,1054.0,209.0,29,14593,6446.0,2804.0,769.0
0.004,17,2,132,1,58,0.0,30.0,30.0,1,74,0.0,46.0,46.0
0.012,6,10,1989,5,910,2.0,642.0,642.0,5,1079,3.0,811.0,811.0
0.004,17,4,284,2,120,0.0,32.0,32.0,2,164,0.0,60.0,54.0
0.007,6,10,1689,5,839,1.0,571.0,571.0,5,850,1.0,582.0,582.0
0.005,6,10,1989,5,927,1.0,659.0,659.0,5,1062,1.0,794.0,794.0
0.071,17,2,136,1,60,0.0,32.0,32.0,1,76,0.0,48.0,48.0
0.012,6,10,1989,5,910,3.0,642.0,642.0,5,1079,2.0,811.0,811.0
0.089,6,10,1506,5,395,21.0,127.0,127.0,5,1111,21.0,843.0,843.0
0.0,17,2,136,1,60,0.0,32.0,32.0,1,76,0.0,48.0,48.0
0.01,6,10,1990,5,911,2.0,643.0,643.0,5,1079,2.0,811.0,811.0
0.005,6,10,2006,5,927,1.0,659.0,659.0,5,1079,1.0,811.0,811.0
0.105,6,10,1506,5,395,22.0,127.0,127.0,5,1111,23.0,843.0,843.0
0.072,6,10,1506,5,395,15.0,127.0,127.0,5,1111,16.0,843.0,843.0
0.187,17,2,194,1,59,0.0,31.0,31.0,1,135,0.0,107.0,107.0
0.005,6,10,2007,5,928,1.0,660.0,660.0,5,1079,1.0,811.0,811.0
40.068,17,10,676,5,460,10015.0,104.0,64.0,5,216,10016.0,20.0,15.0
0.017,6,10,1983,5,910,4.0,642.0,642.0,5,1073,4.0,805.0,805.0
0.265,6,22,7133,11,1609,26.0,746.0,257.0,11,5524,26.0,2333.0,988.0
0.013,6,10,1677,5,827,3.0,559.0,559.0,5,850,3.0,582.0,582.0
240.072,6,20,4873,11,941,24007.0,180.0,93.0,9,3932,30008.0,1592.0,576.0
40.061,17,10,676,5,460,10013.0,104.0,64.0,5,216,10014.0,20.0,15.0
240.528,6,31,7415,16,2388,16035.0,574.0,221.0,15,5027,17180.0,1665.0,529.0
0.017,6,10,1989,5,910,4.0,642.0,642.0,5,1079,4.0,811.0,811.0
0.014,6,10,1983,5,910,3.0,642.0,642.0,5,1073,3.0,805.0,805.0
0.009,6,10,1990,5,911,2.0,643.0,643.0,5,1079,2.0,811.0,811.0
0.005,6,10,2006,5,927,1.0,659.0,659.0,5,1079,1.0,811.0,811.0
40.067,17,10,676,5,460,10014.0,104.0,64.0,5,216,10016.0,20.0,15.0
0.015,6,10,1989,5,910,3.0,642.0,642.0,5,1079,3.0,811.0,811.0
0.004,6,10,2000,5,927,1.0,659.0,659.0,5,1073,1.0,805.0,805.0
0.006,6,10,2000,5,927,1.0,659.0,659.0,5,1073,1.0,805.0,805.0
0.004,17,2,136,1,60,0.0,32.0,32.0,1,76,0.0,48.0,48.0
0.01,6,10,1989,5,910,2.0,642.0,642.0,5,1079,2.0,811.0,811.0
0.008,17,2,194,1,59,0.0,31.0,31.0,1,135,0.0,107.0,107.0
0.003,17,2,148,1,60,0.0,32.0,32.0,1,88,0.0,60.0,60.0
0.133,6,10,1506,5,395,30.0,127.0,127.0,5,1111,31.0,843.0,843.0
0.084,6,10,1506,5,395,18.0,127.0,127.0,5,1111,17.0,843.0,843.0
40.059,17,10,676,5,460,10013.0,104.0,64.0,5,216,10013.0,20.0,15.0
0.005,17,2,230,1,68,0.0,40.0,40.0,1,162,0.0,134.0,134.0
0.205,6,16,2669,8,1395,29.0,533.0,323.0,8,1274,18.0,529.0,212.0
40.066,17,10,676,5,460,10014.0,104.0,64.0,5,216,10015.0,20.0,15.0
0.004,6,10,2006,5,927,1.0,659.0,659.0,5,1079,1.0,811.0,811.0
0.001,17,2,174,1,72,0.0,44.0,44.0,1,102,0.0,74.0,74.0
0.005,6,10,2006,5,927,1.0,659.0,659.0,5,1079,1.0,811.0,811.0
0.017,6,10,1677,5,827,4.0,559.0,559.0,5,850,4.0,582.0,582.0
0.01,6,10,1990,5,911,2.0,643.0,643.0,5,1079,2.0,811.0,811.0
0.005,17,2,169,1,62,0.0,34.0,34.0,1,107,0.0,79.0,79.0
0.006,6,10,1774,5,923,1.0,655.0,655.0,5,851,1.0,583.0,583.0
0.003,17,4,284,2,120,0.0,32.0,32.0,2,164,0.0,60.0,54.0
0.013,6,10,1983,5,910,3.0,642.0,642.0,5,1073,3.0,805.0,805.0
40.075,17,10,676,5,460,10015.0,104.0,64.0,5,216,10017.0,20.0,15.0
0.012,6,10,1989,5,910,3.0,642.0,642.0,5,1079,3.0,811.0,811.0
300.322,6,16,2170,9,684,37519.0,146.0,146.0,7,1486,50026.0,419.0,398.0
15.072,17,15,9238,8,6902,2149.0,1350.0,834.0,7,2336,2507.0,1350.0,305.0
0.114,6,10,1506,5,395,24.0,127.0,127.0,5,1111,23.0,843.0,843.0
40.065,17,10,676,5,460,10012.0,104.0,64.0,5,216,10013.0,20.0,15.0
0.005,6,10,2006,5,927,1.0,659.0,659.0,5,1079,1.0,811.0,811.0
0.003,17,2,136,1,60,0.0,32.0,32.0,1,76,0.0,48.0,48.0
15.074,17,15,9238,8,6902,2149.0,1350.0,834.0,7,2336,2507.0,1350.0,305.0
0.013,6,10,1990,5,911,3.0,643.0,643.0,5,1079,3.0,811.0,811.0
0.005,6,10,2006,5,927,1.0,659.0,659.0,5,1079,1.0,811.0,811.0
0.006,6,10,1547,5,764,1.0,496.0,496.0,5,783,1.0,515.0,515.0
0.016,6,10,1677,5,827,4.0,559.0,559.0,5,850,4.0,582.0,582.0
0.005,17,2,169,1,62,0.0,34.0,34.0,1,107,0.0,79.0,79.0
0.015,6,10,1989,5,910,3.0,642.0,642.0,5,1079,3.0,811.0,811.0
0.005,6,10,1989,5,927,1.0,659.0,659.0,5,1062,1.0,794.0,794.0
0.004,6,10,1989,5,927,1.0,659.0,659.0,5,1062,1.0,794.0,794.0
0.005,6,10,1689,5,839,1.0,571.0,571.0,5,850,1.0,582.0,582.0
0.006,6,10,1547,5,764,1.0,496.0,496.0,5,783,1.0,515.0,515.0
314.532,17,20,1124,10,716,34933.0,48.0,43.0,10,408,34933.0,20.0,12.0
0.011,6,10,1989,5,910,2.0,642.0,642.0,5,1079,2.0,811.0,811.0
0.089,6,10,1506,5,395,18.0,127.0,127.0,5,1111,21.0,843.0,843.0
0.076,6,10,1506,5,395,17.0,127.0,127.0,5,1111,14.0,843.0,843.0
0.005,6,10,1689,5,839,1.0,571.0,571.0,5,850,1.0,582.0,582.0
0.001,17,2,180,1,66,0.0,38.0,38.0,1,114,0.0,86.0,86.0
0.078,6,10,1506,5,395,17.0,127.0,127.0,5,1111,17.0,843.0,843.0
0.005,6,10,2000,5,927,1.0,659.0,659.0,5,1073,1.0,805.0,805.0
40.063,17,10,676,5,460,10012.0,104.0,64.0,5,216,10015.0,20.0,15.0
0.004,6,10,1779,5,928,1.0,660.0,660.0,5,851,1.0,583.0,583.0
0.014,6,10,1990,5,911,3.0,643.0,643.0,5,1079,3.0,811.0,811.0
0.003,17,2,148,1,60,0.0,32.0,32.0,1,88,0.0,60.0,60.0
0.005,6,10,2006,5,927,1.0,659.0,659.0,5,1079,1.0,811.0,811.0
0.007,6,10,1547,5,764,1.0,496.0,496.0,5,783,1.0,515.0,515.0
0.001,17,2,180,1,66,0.0,38.0,38.0,1,114,0.0,86.0,86.0
0.005,6,10,1779,5,928,1.0,660.0,660.0,5,851,1.0,583.0,583.0
40.067,17,10,676,5,460,10014.0,104.0,64.0,5,216,10015.0,20.0,15.0
0.113,6,10,1506,5,395,26.0,127.0,127.0,5,1111,22.0,843.0,843.0
0.017,17,2,170,1,65,0.0,37.0,37.0,1,105,0.0,77.0,77.0
0.007,6,10,1547,5,764,1.0,496.0,496.0,5,783,1.0,515.0,515.0
15.073,17,15,9238,8,6902,2149.0,1350.0,834.0,7,2336,2507.0,1350.0,305.0
0.011,6,10,1990,5,911,2.0,643.0,643.0,5,1079,2.0,811.0,811.0
0.078,6,10,1506,5,395,17.0,127.0,127.0,5,1111,19.0,843.0,843.0
0.001,17,2,180,1,66,0.0,38.0,38.0,1,114,0.0,86.0,86.0
0.008,17,2,179,1,71,0.0,43.0,43.0,1,108,0.0,80.0,80.0
0.003,17,2,148,1,60,0.0,32.0,32.0,1,88,0.0,60.0,60.0
0.167,6,10,1506,5,395,39.0,127.0,127.0,5,1111,20.0,843.0,843.0
0.008,6,10,1990,5,911,2.0,643.0,643.0,5,1079,1.0,811.0,811.0
11.028,17,28,4419,14,1994,839.0,269.0,114.0,14,2425,839.0,588.0,145.0
0.013,6,10,1972,5,910,3.0,642.0,642.0,5,1062,3.0,794.0,794.0
0.099,6,10,1506,5,395,22.0,127.0,127.0,5,1111,23.0,843.0,843.0
0.018,6,13,3913,7,495,3.0,123.0,123.0,6,3418,3.0,1650.0,1549.0
0.009,6,10,1989,5,910,2.0,642.0,642.0,5,1079,2.0,811.0,811.0
0.074,6,10,1506,5,395,16.0,127.0,127.0,5,1111,17.0,843.0,843.0
0.005,6,10,2007,5,928,1.0,660.0,660.0,5,1079,1.0,811.0,811.0
0.005,17,2,179,1,71,0.0,43.0,43.0,1,108,0.0,80.0,80.0
0.004,17,4,284,2,120,0.0,32.0,32.0,2,164,1.0,60.0,54.0
0.044,6,10,1762,5,911,10.0,643.0,643.0,5,851,11.0,583.0,583.0
0.025,6,10,1989,5,910,6.0,642.0,642.0,5,1079,6.0,811.0,811.0
0.064,6,10,1506,5,395,14.0,127.0,127.0,5,1111,14.0,843.0,843.0
40.056,17,10,676,5,460,10013.0,104.0,64.0,5,216,10010.0,20.0,15.0
0.013,6,10,1990,5,911,3.0,643.0,643.0,5,1079,3.0,811.0,811.0
40.063,17,10,676,5,460,10012.0,104.0,64.0,5,216,10014.0,20.0,15.0
0.004,6,10,1989,5,927,1.0,659.0,659.0,5,1062,1.0,794.0,794.0
0.22,17,2,80,1,32,0.0,4.0,4.0,1,48,0.0,20.0,20.0
0.005,6,10,2000,5,927,1.0,659.0,659.0,5,1073,1.0,805.0,805.0
40.059,17,10,676,5,460,10014.0,104.0,64.0,5,216,10013.0,20.0,15.0
0.061,17,2,148,1,60,0.0,32.0,32.0,1,88,0.0,60.0,60.0
0.005,6,10,1854,5,889,1.0,621.0,621.0,5,965,1.0,697.0,697.0
0.004,6,10,2000,5,927,1.0,659.0,659.0,5,1073,1.0,805.0,805.0
0.616,6,27,8977,15,1639,35.0,517.0,211.0,12,7338,45.0,1288.0,839.0
0.005,6,10,2006,5,927,1.0,659.0,659.0,5,1079,1.0,811.0,811.0
175.254,17,76,10800,38,2537,4736.0,44.0,38.0,38,8263,4736.0,239.0,189.0
2.044,6,23,7757,13,1537,170.0,517.0,287.0,10,6220,17.0,1402.0,813.0
0.005,6,10,1989,5,927,1.0,659.0,659.0,5,1062,1.0,794.0,794.0
0.004,6,13,3690,7,452,0.0,80.0,80.0,6,3238,0.0,1470.0,1459.0
0.005,17,2,170,1,65,0.0,37.0,37.0,1,105,0.0,77.0,77.0
0.005,17,2,318,1,72,0.0,44.0,44.0,1,246,0.0,218.0,218.0
0.011,6,10,1983,5,910,2.0,642.0,642.0,5,1073,2.0,805.0,805.0
0.009,6,12,1926,6,1189,1.0,659.0,434.0,6,737,1.0,417.0,417.0
0.016,6,10,1631,5,848,4.0,580.0,580.0,5,783,3.0,515.0,515.0
0.005,6,10,2007,5,928,1.0,660.0,660.0,5,1079,1.0,811.0,811.0
0.086,17,2,144,1,64,0.0,36.0,36.0,1,80,0.0,52.0,52.0
0.088,6,10,1506,5,395,20.0,127.0,127.0,5,1111,18.0,843.0,843.0
0.011,17,2,144,1,64,0.0,36.0,36.0,1,80,0.0,52.0,52.0
0.004,17,2,148,1,60,0.0,32.0,32.0,1,88,0.0,60.0,60.0
0.07,6,10,1506,5,395,15.0,127.0,127.0,5,1111,14.0,843.0,843.0
0.098,6,10,1506,5,395,22.0,127.0,127.0,5,1111,20.0,843.0,843.0
0.005,6,13,3690,7,452,0.0,80.0,80.0,6,3238,0.0,1470.0,1459.0
0.013,6,10,1983,5,910,3.0,642.0,642.0,5,1073,3.0,805.0,805.0
0.007,6,10,1989,5,910,1.0,642.0,642.0,5,1079,1.0,811.0,811.0
167.028,17,78,11184,39,2601,4395.0,44.0,38.0,39,8583,4395.0,261.0,192.0
0.005,17,2,214,1,75,0.0,47.0,47.0,1,139,0.0,111.0,111.0
0.101,6,10,1506,5,395,21.0,127.0,127.0,5,1111,21.0,843.0,843.0
0.004,6,10,1989,5,927,1.0,659.0,659.0,5,1062,1.0,794.0,794.0
0.009,6,10,1983,5,910,2.0,642.0,642.0,5,1073,2.0,805.0,805.0
0.26,17,38,20174,21,17038,13.0,1350.0,783.0,17,3136,12.0,1350.0,156.0
0.005,6,10,1779,5,928,1.0,660.0,660.0,5,851,1.0,583.0,583.0
0.057,17,2,179,1,71,0.0,43.0,43.0,1,108,0.0,80.0,80.0
0.016,6,10,1972,5,910,4.0,642.0,642.0,5,1062,4.0,794.0,794.0
0.084,6,10,1506,5,395,20.0,127.0,127.0,5,1111,20.0,843.0,843.0
0.08,6,10,1506,5,395,18.0,127.0,127.0,5,1111,16.0,843.0,843.0
0.019,6,10,1989,5,910,4.0,642.0,642.0,5,1079,4.0,811.0,811.0
0.123,6,10,1506,5,395,27.0,127.0,127.0,5,1111,27.0,843.0,843.0
0.108,6,10,1506,5,395,25.0,127.0,127.0,5,1111,24.0,843.0,843.0
0.014,6,10,1972,5,910,3.0,642.0,642.0,5,1062,3.0,794.0,794.0
0.016,6,10,1989,5,910,4.0,642.0,642.0,5,1079,4.0,811.0,811.0
0.006,6,10,1547,5,764,1.0,496.0,496.0,5,783,1.0,515.0,515.0
0.015,6,10,1989,5,910,3.0,642.0,642.0,5,1079,3.0,811.0,811.0
0.141,6,10,1506,5,395,33.0,127.0,127.0,5,1111,30.0,843.0,843.0
1799.664,17,122,11651,61,5551,29994.0,63.0,63.0,61,6100,29994.0,72.0,72.0
1793.831,6,237,46223,114,33852,15874.0,2477.0,1033.0,123,12371,14703.0,580.0,62.0
0.009,6,10,1972,5,910,2.0,642.0,642.0,5,1062,2.0,794.0,794.0
0.038,17,2,182,1,65,0.0,37.0,37.0,1,117,0.0,89.0,89.0
0.018,6,10,1983,5,910,4.0,642.0,642.0,5,1073,4.0,805.0,805.0
0.085,6,10,1506,5,395,18.0,127.0,127.0,5,1111,17.0,843.0,843.0
0.004,6,10,2006,5,927,1.0,659.0,659.0,5,1079,1.0,811.0,811.0
0.015,6,10,1677,5,827,3.0,559.0,559.0,5,850,3.0,582.0,582.0
0.171,6,3,453,2,321,171.0,241.0,241.0,1,132,0.0,92.0,92.0
0.097,6,10,1506,5,395,22.0,127.0,127.0,5,1111,22.0,843.0,843.0
292.501,6,388,347945,206,22281,1426.0,2736.0,825.0,182,325664,1616.0,2804.0,1882.0
0.043,17,4,284,2,120,1.0,32.0,32.0,2,164,39.0,60.0,54.0
40.071,17,10,676,5,460,10015.0,104.0,64.0,5,216,10013.0,20.0,15.0
1772.63,6,100,6049,57,3381,31653.0,27.0,27.0,43,2668,42204.0,27.0,27.0
0.005,6,14,3736,7,446,0.0,74.0,74.0,7,3290,0.0,1448.0,972.0
0.073,6,10,1506,5,395,14.0,127.0,127.0,5,1111,15.0,843.0,843.0
0.006,6,10,1854,5,889,1.0,621.0,621.0,5,965,1.0,697.0,697.0
0.004,6,10,2006,5,927,1.0,659.0,659.0,5,1079,1.0,811.0,811.0
0.211,6,16,2777,8,1395,30.0,533.0,323.0,8,1382,19.0,529.0,239.0
240.031,6,9,787,5,488,60007.0,232.0,232.0,4,299,80009.0,83.0,83.0
0.01,6,10,1990,5,911,2.0,643.0,643.0,5,1079,2.0,811.0,811.0
167.087,17,74,10511,37,2476,4641.0,44.0,38.0,37,8035,4640.0,239.0,189.0
0.042,17,4,364,2,160,0.0,52.0,52.0,2,204,3.0,80.0,74.0
0.006,6,10,1854,5,889,1.0,621.0,621.0,5,965,1.0,697.0,697.0
0.006,6,10,1643,5,860,1.0,592.0,592.0,5,783,1.0,515.0,515.0
0.012,6,10,1983,5,910,2.0,642.0,642.0,5,1073,2.0,805.0,805.0
189.12,58,3,216,2,144,189120.0,24.0,24.0,1,72,0.0,24.0,24.0
0.012,6,10,1972,5,910,3.0,642.0,642.0,5,1062,2.0,794.0,794.0
2.605,6,25,6083,14,2096,200.0,517.0,302.0,11,3987,249.0,1330.0,589.0
174.058,17,80,11555,40,2689,4462.0,44.0,39.0,40,8866,4462.0,261.0,193.0
0.117,6,10,1506,5,395,28.0,127.0,127.0,5,1111,26.0,843.0,843.0
0.019,6,10,1989,5,910,4.0,642.0,642.0,5,1079,4.0,811.0,811.0
171.077,17,78,10921,39,2608,4501.0,44.0,38.0,39,8313,4501.0,239.0,185.0
0.013,6,13,3735,7,497,2.0,125.0,125.0,6,3238,2.0,1470.0,1459.0
0.013,6,10,1983,5,910,3.0,642.0,642.0,5,1073,3.0,805.0,805.0
0.005,6,13,3747,7,509,0.0,137.0,137.0,6,3238,1.0,1470.0,1459.0
0.006,6,10,1643,5,860,1.0,592.0,592.0,5,783,1.0,515.0,515.0
0.004,6,10,1702,5,863,1.0,595.0,595.0,5,839,0.0,571.0,571.0
0.005,6,10,1547,5,764,1.0,496.0,496.0,5,783,1.0,515.0,515.0
0.011,6,10,1762,5,911,2.0,643.0,643.0,5,851,2.0,583.0,583.0
0.004,17,2,136,1,60,0.0,32.0,32.0,1,76,0.0,48.0,48.0
0.006,6,10,1689,5,839,1.0,571.0,571.0,5,850,1.0,582.0,582.0
240.562,6,34,9355,16,1835,16035.0,623.0,199.0,18,7520,14148.0,1402.0,549.0
0.035,6,10,1762,5,911,8.0,643.0,643.0,5,851,8.0,583.0,583.0
10.873,17,28,4423,14,1995,827.0,270.0,114.0,14,2428,827.0,587.0,145.0
0.004,17,2,148,1,60,0.0,32.0,32.0,1,88,0.0,60.0,60.0
0.108,6,10,1506,5,395,24.0,127.0,127.0,5,1111,20.0,843.0,843.0
40.054,17,9,636,5,460,10013.0,104.0,64.0,4,176,1003.0,20.0,16.0
0.009,6,10,1972,5,910,2.0,642.0,642.0,5,1062,2.0,794.0,794.0
0.008,17,4,284,2,120,1.0,32.0,32.0,2,164,0.0,60.0,54.0
0.003,17,2,185,1,73,0.0,45.0,45.0,1,112,0.0,84.0,84.0
10.793,17,28,4423,14,1994,821.0,269.0,114.0,14,2429,821.0,588.0,145.0
0.024,6,10,1989,5,910,6.0,642.0,642.0,5,1079,5.0,811.0,811.0
0.008,6,10,1989,5,910,2.0,642.0,642.0,5,1079,1.0,811.0,811.0
0.005,17,2,170,1,65,0.0,37.0,37.0,1,105,0.0,77.0,77.0
0.064,6,10,1506,5,395,14.0,127.0,127.0,5,1111,15.0,843.0,843.0
0.081,6,10,1506,5,395,17.0,127.0,127.0,5,1111,19.0,843.0,843.0
0.005,6,10,1689,5,839,1.0,571.0,571.0,5,850,1.0,582.0,582.0
0.004,6,10,2006,5,927,1.0,659.0,659.0,5,1079,1.0,811.0,811.0
371.49,6,22,2313,16,867,24766.0,195.0,195.0,6,1446,4639.0,419.0,398.0
0.015,6,10,1989,5,910,3.0,642.0,642.0,5,1079,3.0,811.0,811.0
0.013,6,14,3787,7,497,2.0,125.0,125.0,7,3290,2.0,1448.0,972.0
0.006,6,10,1854,5,889,1.0,621.0,621.0,5,965,1.0,697.0,697.0
0.141,6,10,1506,5,395,30.0,127.0,127.0,5,1111,23.0,843.0,843.0
0.005,17,2,170,1,65,0.0,37.0,37.0,1,105,0.0,77.0,77.0
0.005,17,2,140,1,62,0.0,34.0,34.0,1,78,0.0,50.0,50.0
0.009,6,10,1762,5,911,2.0,643.0,643.0,5,851,2.0,583.0,583.0
246.428,6,38,9913,16,6837,16428.0,1515.0,600.0,22,3076,11734.0,580.0,148.0
0.008,6,10,1972,5,910,2.0,642.0,642.0,5,1062,2.0,794.0,794.0
40.06,17,10,676,5,460,10014.0,104.0,64.0,5,216,10014.0,20.0,15.0
0.004,17,2,136,1,60,0.0,32.0,32.0,1,76,0.0,48.0,48.0
0.11,6,10,1506,5,395,20.0,127.0,127.0,5,1111,21.0,843.0,843.0
0.006,6,10,1643,5,860,1.0,592.0,592.0,5,783,1.0,515.0,515.0
0.045,17,2,170,1,65,0.0,37.0,37.0,1,105,0.0,77.0,77.0
0.004,6,10,2007,5,928,1.0,660.0,660.0,5,1079,1.0,811.0,811.0
0.333,17,45,25877,24,19853,14.0,1350.0,799.0,21,6024,13.0,1350.0,258.0
0.006,6,12,1698,6,863,1.0,327.0,271.0,6,835,1.0,515.0,515.0
308.521,17,18,1008,9,640,38548.0,48.0,43.0,9,368,38548.0,20.0,12.0
11.94,17,32,4975,17,2399,733.0,270.0,113.0,15,2576,839.0,587.0,143.0
0.004,6,10,2006,5,927,1.0,659.0,659.0,5,1079,1.0,811.0,811.0
240.036,6,9,787,5,488,60009.0,232.0,232.0,4,299,80011.0,83.0,83.0
0.009,17,2,148,1,60,0.0,32.0,32.0,1,88,0.0,60.0,60.0
0.005,17,2,144,1,64,0.0,36.0,36.0,1,80,0.0,52.0,52.0
0.019,6,10,1990,5,911,4.0,643.0,643.0,5,1079,4.0,811.0,811.0
40.069,17,10,676,5,460,10014.0,104.0,64.0,5,216,10015.0,20.0,15.0
61.677,6,22,7437,11,1305,144.0,530.0,277.0,11,6132,6151.0,2720.0,946.0
0.081,6,10,1506,5,395,16.0,127.0,127.0,5,1111,15.0,843.0,843.0
0.005,6,10,1689,5,839,1.0,571.0,571.0,5,850,1.0,582.0,582.0
0.005,17,2,136,1,60,0.0,32.0,32.0,1,76,0.0,48.0,48.0
0.008,6,10,1972,5,910,2.0,642.0,642.0,5,1062,1.0,794.0,794.0
40.064,17,10,676,5,460,10014.0,104.0,64.0,5,216,10015.0,20.0,15.0
0.005,6,10,1989,5,927,1.0,659.0,659.0,5,1062,1.0,794.0,794.0
260.845,6,39,9677,20,4119,13719.0,1543.0,657.0,19,5558,14481.0,1360.0,398.0
0.009,6,10,1762,5,911,2.0,643.0,643.0,5,851,2.0,583.0,583.0
0.009,6,12,1926,6,1189,1.0,659.0,434.0,6,737,1.0,417.0,417.0
0.006,6,10,1547,5,764,1.0,496.0,496.0,5,783,1.0,515.0,515.0
40.06,17,10,676,5,460,10012.0,104.0,64.0,5,216,10014.0,20.0,15.0
0.008,6,10,1762,5,911,1.0,643.0,643.0,5,851,2.0,583.0,583.0
0.042,17,2,144,1,64,0.0,36.0,36.0,1,80,0.0,52.0,52.0
0.005,6,14,3742,7,452,0.0,80.0,80.0,7,3290,0.0,1448.0,972.0
0.003,17,2,148,1,60,0.0,32.0,32.0,1,88,0.0,60.0,60.0
0.021,6,10,1989,5,910,5.0,642.0,642.0,5,1079,5.0,811.0,811.0
0.005,6,10,2000,5,927,1.0,659.0,659.0,5,1073,1.0,805.0,805.0
0.07,6,10,1506,5,395,15.0,127.0,127.0,5,1111,16.0,843.0,843.0
40.054,17,10,676,5,460,10012.0,104.0,64.0,5,216,10012.0,20.0,15.0
0.01,17,2,136,1,60,0.0,32.0,32.0,1,76,0.0,48.0,48.0
5.423,6,26,7331,14,2052,416.0,801.0,260.0,12,5279,492.0,1925.0,774.0
0.003,17,2,136,1,60,0.0,32.0,32.0,1,76,0.0,48.0,48.0
0.005,6,10,2006,5,927,1.0,659.0,659.0,5,1079,1.0,811.0,811.0
0.148,6,10,1506,5,395,32.0,127.0,127.0,5,1111,34.0,843.0,843.0
0.097,6,10,1506,5,395,22.0,127.0,127.0,5,1111,20.0,843.0,843.0
0.004,6,10,1702,5,863,0.0,595.0,595.0,5,839,1.0,571.0,571.0
0.072,6,10,1506,5,395,16.0,127.0,127.0,5,1111,15.0,843.0,843.0
0.015,6,10,1762,5,911,3.0,643.0,643.0,5,851,3.0,583.0,583.0
0.097,6,10,1506,5,395,22.0,127.0,127.0,5,1111,22.0,843.0,843.0
11.527,17,28,4398,14,2312,874.0,587.0,137.0,14,2086,874.0,269.0,121.0
40.076,17,10,676,5,460,10018.0,104.0,64.0,5,216,10018.0,20.0,15.0
0.068,6,10,1506,5,395,16.0,127.0,127.0,5,1111,15.0,843.0,843.0
0.004,6,10,2006,5,927,1.0,659.0,659.0,5,1079,1.0,811.0,811.0
40.059,17,10,676,5,460,10014.0,104.0,64.0,5,216,10013.0,20.0,15.0
0.005,6,10,2007,5,928,1.0,660.0,660.0,5,1079,1.0,811.0,811.0
0.07,6,10,1506,5,395,16.0,127.0,127.0,5,1111,16.0,843.0,843.0
0.017,6,10,1990,5,911,4.0,643.0,643.0,5,1079,4.0,811.0,811.0
0.005,6,10,1989,5,927,1.0,659.0,659.0,5,1062,1.0,794.0,794.0
0.006,6,10,1643,5,860,1.0,592.0,592.0,5,783,1.0,515.0,515.0
0.005,17,2,169,1,62,0.0,34.0,34.0,1,107,0.0,79.0,79.0
0.006,6,10,1643,5,860,1.0,592.0,592.0,5,783,1.0,515.0,515.0
0.003,17,2,208,1,72,0.0,44.0,44.0,1,136,0.0,108.0,108.0
0.001,17,2,180,1,66,0.0,38.0,38.0,1,114,0.0,86.0,86.0
0.042,17,4,596,2,122,0.0,33.0,33.0,2,474,2.0,323.0,209.0
0.004,6,10,2006,5,927,1.0,659.0,659.0,5,1079,1.0,811.0,811.0
0.005,6,10,1779,5,928,1.0,660.0,660.0,5,851,1.0,583.0,583.0
240.011,6,9,787,5,488,60002.0,232.0,232.0,4,299,80002.0,83.0,83.0
31.616,6,163,165107,91,154449,350.0,3385.0,1919.0,72,10658,443.0,1402.0,690.0
0.04,17,2,148,1,60,0.0,32.0,32.0,1,88,0.0,60.0,60.0
0.012,6,13,3816,7,578,2.0,206.0,206.0,6,3238,2.0,1470.0,1459.0
0.021,6,10,1990,5,911,5.0,643.0,643.0,5,1079,5.0,811.0,811.0
0.004,6,10,2006,5,927,1.0,659.0,659.0,5,1079,1.0,811.0,811.0
240.012,6,9,787,5,488,60003.0,232.0,232.0,4,299,80003.0,83.0,83.0
0.017,6,10,1972,5,910,4.0,642.0,642.0,5,1062,4.0,794.0,794.0
1770.693,6,135,6510,75,3585,23928.0,39.0,39.0,60,2925,30007.0,35.0,35.0
0.02,6,10,1631,5,848,5.0,580.0,580.0,5,783,4.0,515.0,515.0
0.012,6,10,1990,5,911,3.0,643.0,643.0,5,1079,3.0,811.0,811.0
0.042,17,2,412,1,61,0.0,33.0,33.0,1,351,0.0,323.0,323.0
0.004,6,10,2006,5,927,1.0,659.0,659.0,5,1079,1.0,811.0,811.0
0.004,6,10,2000,5,927,1.0,659.0,659.0,5,1073,1.0,805.0,805.0
0.004,6,13,3690,7,452,0.0,80.0,80.0,6,3238,0.0,1470.0,1459.0
241.608,6,396,347561,193,21562,1258.0,2736.0,959.0,203,325999,1196.0,2804.0,1634.0
0.11,6,10,1506,5,395,27.0,127.0,127.0,5,1111,22.0,843.0,843.0
0.009,17,2,194,1,59,0.0,31.0,31.0,1,135,0.0,107.0,107.0
0.118,6,10,1506,5,395,28.0,127.0,127.0,5,1111,27.0,843.0,843.0
0.013,6,10,1989,5,910,3.0,642.0,642.0,5,1079,3.0,811.0,811.0
0.005,6,10,2007,5,928,1.0,660.0,660.0,5,1079,1.0,811.0,811.0
0.005,17,2,166,1,75,0.0,47.0,47.0,1,91,0.0,63.0,63.0
0.093,6,10,1506,5,395,18.0,127.0,127.0,5,1111,21.0,843.0,843.0
300.313,6,16,2170,9,684,37518.0,146.0,146.0,7,1486,50023.0,419.0,398.0
0.006,6,10,1547,5,764,1.0,496.0,496.0,5,783,1.0,515.0,515.0
308.33,17,20,1124,10,716,34244.0,48.0,43.0,10,408,34244.0,20.0,12.0
0.006,6,10,1989,5,927,1.0,659.0,659.0,5,1062,1.0,794.0,794.0
0.01,6,10,1990,5,911,2.0,643.0,643.0,5,1079,2.0,811.0,811.0
40.087,17,10,676,5,460,10020.0,104.0,64.0,5,216,10021.0,20.0,15.0
0.013,6,10,1677,5,827,3.0,559.0,559.0,5,850,3.0,582.0,582.0
0.013,6,10,1989,5,910,3.0,642.0,642.0,5,1079,3.0,811.0,811.0
0.022,6,10,1983,5,910,5.0,642.0,642.0,5,1073,5.0,805.0,805.0
0.069,17,8,3613,4,1874,23.0,1350.0,440.0,4,1739,10.0,1350.0,406.0
0.043,17,2,152,1,76,0.0,48.0,48.0,1,76,0.0,48.0,48.0
0.012,6,10,1762,5,911,3.0,643.0,643.0,5,851,3.0,583.0,583.0
0.043,17,2,152,1,76,0.0,48.0,48.0,1,76,0.0,48.0,48.0
0.038,17,4,284,2,120,0.0,32.0,32.0,2,164,34.0,60.0,54.0
0.007,6,14,3799,7,509,1.0,137.0,137.0,7,3290,1.0,1448.0,972.0
0.011,6,10,1990,5,911,2.0,643.0,643.0,5,1079,2.0,811.0,811.0
0.005,6,10,2000,5,927,1.0,659.0,659.0,5,1073,1.0,805.0,805.0
0.038,17,2,148,1,60,0.0,32.0,32.0,1,88,0.0,60.0,60.0
0.014,6,10,1972,5,910,3.0,642.0,642.0,5,1062,3.0,794.0,794.0
0.014,6,10,1989,5,910,3.0,642.0,642.0,5,1079,3.0,811.0,811.0
0.006,6,10,1779,5,928,1.0,660.0,660.0,5,851,1.0,583.0,583.0
177.248,17,74,10447,37,2465,4923.0,44.0,38.0,37,7982,4923.0,239.0,187.0
0.133,6,10,1506,5,395,32.0,127.0,127.0,5,1111,31.0,843.0,843.0
0.005,17,2,302,1,65,0.0,37.0,37.0,1,237,0.0,209.0,209.0
40.059,17,10,676,5,460,10013.0,104.0,64.0,5,216,10014.0,20.0,15.0
0.006,6,10,1989,5,927,1.0,659.0,659.0,5,1062,1.0,794.0,794.0
0.139,6,10,1506,5,395,31.0,127.0,127.0,5,1111,31.0,843.0,843.0
40.064,17,10,676,5,460,10014.0,104.0,64.0,5,216,10015.0,20.0,15.0
15.076,17,18,8886,9,6426,1881.0,1350.0,686.0,9,2460,1880.0,1350.0,245.0
0.004,17,2,148,1,60,0.0,32.0,32.0,1,88,0.0,60.0,60.0
0.097,6,10,1506,5,395,22.0,127.0,127.0,5,1111,20.0,843.0,843.0
40.08,17,10,676,5,460,10016.0,104.0,64.0,5,216,10012.0,20.0,15.0
11.216,17,28,4422,14,1994,850.0,269.0,114.0,14,2428,850.0,587.0,145.0
0.106,6,10,1506,5,395,23.0,127.0,127.0,5,1111,24.0,843.0,843.0
0.113,6,10,1506,5,395,21.0,127.0,127.0,5,1111,25.0,843.0,843.0
15.081,17,15,8313,8,6126,2150.0,1350.0,737.0,7,2187,2508.0,1350.0,284.0
0.064,6,10,1506,5,395,15.0,127.0,127.0,5,1111,15.0,843.0,843.0
0.079,6,10,1506,5,395,16.0,127.0,127.0,5,1111,17.0,843.0,843.0
0.017,6,10,1989,5,910,4.0,642.0,642.0,5,1079,4.0,811.0,811.0
0.016,6,10,1972,5,910,4.0,642.0,642.0,5,1062,3.0,794.0,794.0
0.005,6,10,2006,5,927,1.0,659.0,659.0,5,1079,1.0,811.0,811.0
0.003,17,4,284,2,120,0.0,32.0,32.0,2,164,0.0,60.0,54.0
0.145,6,10,1506,5,395,34.0,127.0,127.0,5,1111,33.0,843.0,843.0
0.093,6,10,1506,5,395,20.0,127.0,127.0,5,1111,20.0,843.0,843.0
0.005,6,10,2006,5,927,1.0,659.0,659.0,5,1079,1.0,811.0,811.0
0.013,6,10,1990,5,911,3.0,643.0,643.0,5,1079,3.0,811.0,811.0
0.004,6,10,1779,5,928,1.0,660.0,660.0,5,851,1.0,583.0,583.0
0.004,6,10,1702,5,863,0.0,595.0,595.0,5,839,1.0,571.0,571.0
40.056,17,10,676,5,460,10013.0,104.0,64.0,5,216,10013.0,20.0,15.0
0.014,6,10,1989,5,910,3.0,642.0,642.0,5,1079,3.0,811.0,811.0
0.098,6,10,1506,5,395,24.0,127.0,127.0,5,1111,22.0,843.0,843.0
0.019,6,10,1990,5,911,4.0,643.0,643.0,5,1079,4.0,811.0,811.0
0.025,17,2,164,1,74,0.0,46.0,46.0,1,90,0.0,62.0,62.0
0.011,6,10,1972,5,910,2.0,642.0,642.0,5,1062,2.0,794.0,794.0
0.005,6,10,2006,5,927,1.0,659.0,659.0,5,1079,1.0,811.0,811.0
11.38,17,28,4423,14,1995,862.0,270.0,114.0,14,2428,859.0,587.0,145.0
0.011,6,10,1983,5,910,2.0,642.0,642.0,5,1073,2.0,805.0,805.0
0.005,6,10,2006,5,927,1.0,659.0,659.0,5,1079,1.0,811.0,811.0
0.005,6,10,2006,5,927,1.0,659.0,659.0,5,1079,1.0,811.0,811.0
0.008,6,10,1677,5,827,2.0,559.0,559.0,5,850,2.0,582.0,582.0
0.001,17,2,180,1,66,0.0,38.0,38.0,1,114,0.0,86.0,86.0
0.004,6,10,1702,5,863,0.0,595.0,595.0,5,839,1.0,571.0,571.0
0.003,17,2,148,1,60,0.0,32.0,32.0,1,88,0.0,60.0,60.0
0.005,6,10,2007,5,928,1.0,660.0,660.0,5,1079,1.0,811.0,811.0
0.013,6,10,1631,5,848,3.0,580.0,580.0,5,783,3.0,515.0,515.0
300.804,6,37,9266,20,3788,15831.0,1360.0,591.0,17,5478,538.0,2667.0,435.0
0.005,6,10,1989,5,927,1.0,659.0,659.0,5,1062,1.0,794.0,794.0
0.143,6,10,1506,5,395,28.0,127.0,127.0,5,1111,34.0,843.0,843.0
0.009,6,10,2000,5,927,2.0,659.0,659.0,5,1073,2.0,805.0,805.0
0.005,6,10,1689,5,839,1.0,571.0,571.0,5,850,1.0,582.0,582.0
15.132,17,20,13503,10,8344,1678.0,1350.0,806.0,10,5159,1678.0,1350.0,487.0
0.013,6,10,1989,5,910,3.0,642.0,642.0,5,1079,3.0,811.0,811.0
353.991,6,21,1795,16,1030,23599.0,190.0,190.0,5,765,60002.0,464.0,248.0
0.012,6,10,1990,5,911,2.0,643.0,643.0,5,1079,3.0,811.0,811.0
0.012,6,10,1972,5,910,3.0,642.0,642.0,5,1062,3.0,794.0,794.0
0.006,6,10,1989,5,927,1.0,659.0,659.0,5,1062,1.0,794.0,794.0
0.006,6,12,1698,6,863,1.0,327.0,271.0,6,835,1.0,515.0,515.0
0.007,6,10,1854,5,889,1.0,621.0,621.0,5,965,1.0,697.0,697.0
0.087,6,10,1506,5,395,18.0,127.0,127.0,5,1111,20.0,843.0,843.0
0.005,6,10,2007,5,928,1.0,660.0,660.0,5,1079,1.0,811.0,811.0
0.004,17,2,178,1,81,0.0,53.0,53.0,1,97,0.0,69.0,69.0
0.126,6,10,1506,5,395,28.0,127.0,127.0,5,1111,27.0,843.0,843.0
0.133,17,2,170,1,65,0.0,37.0,37.0,1,105,0.0,77.0,77.0
0.005,6,10,1547,5,764,1.0,496.0,496.0,5,783,1.0,515.0,515.0
301.04,6,37,8261,20,1830,15844.0,651.0,249.0,17,6431,553.0,2126.0,478.0
0.095,6,10,1506,5,395,20.0,127.0,127.0,5,1111,21.0,843.0,843.0
10.721,17,28,4422,14,1994,816.0,269.0,114.0,14,2428,816.0,587.0,145.0
0.009,6,10,1762,5,911,2.0,643.0,643.0,5,851,2.0,583.0,583.0
0.006,6,13,3747,7,509,1.0,137.0,137.0,6,3238,1.0,1470.0,1459.0
11.218,17,28,4419,14,1994,850.0,269.0,114.0,14,2425,850.0,588.0,145.0
40.056,17,10,676,5,460,10013.0,104.0,64.0,5,216,10013.0,20.0,15.0
1761.315,6,476,71047,271,36640,6523.0,613.0,187.0,205,34407,8633.0,613.0,157.0
0.005,17,2,179,1,71,0.0,43.0,43.0,1,108,0.0,80.0,80.0
0.037,17,2,182,1,65,0.0,37.0,37.0,1,117,0.0,89.0,89.0
0.021,6,10,1990,5,911,5.0,643.0,643.0,5,1079,5.0,811.0,811.0
0.066,6,10,1506,5,395,13.0,127.0,127.0,5,1111,14.0,843.0,843.0
0.004,6,10,2007,5,928,1.0,660.0,660.0,5,1079,1.0,811.0,811.0
413.377,6,29,4409,12,3102,10912.0,494.0,494.0,17,1307,25835.0,83.0,83.0
0.088,6,10,1506,5,395,19.0,127.0,127.0,5,1111,17.0,843.0,843.0
0.005,6,10,1774,5,923,1.0,655.0,655.0,5,851,1.0,583.0,583.0
0.006,17,2,136,1,60,0.0,32.0,32.0,1,76,0.0,48.0,48.0
168.229,17,78,10972,39,2605,4426.0,44.0,38.0,39,8367,4427.0,260.0,186.0
0.001,17,2,166,1,75,0.0,47.0,47.0,1,91,0.0,63.0,63.0
0.007,6,10,1547,5,764,1.0,496.0,496.0,5,783,1.0,515.0,515.0
240.093,6,31,9500,15,6963,17149.0,2089.0,687.0,16,2537,16005.0,580.0,212.0
0.005,6,10,2006,5,927,1.0,659.0,659.0,5,1079,1.0,811.0,811.0
0.16,6,10,1506,5,395,38.0,127.0,127.0,5,1111,25.0,843.0,843.0
0.004,17,4,284,2,120,0.0,32.0,32.0,2,164,1.0,60.0,54.0
10.883,17,28,4421,14,1993,828.0,268.0,114.0,14,2428,828.0,587.0,145.0
0.013,6,10,1990,5,911,3.0,643.0,643.0,5,1079,3.0,811.0,811.0
0.005,6,10,2000,5,927,1.0,659.0,659.0,5,1073,1.0,805.0,805.0
0.005,6,10,1689,5,839,1.0,571.0,571.0,5,850,1.0,582.0,582.0
0.006,6,10,1547,5,764,1.0,496.0,496.0,5,783,1.0,515.0,515.0
0.062,6,14,3787,7,497,10.0,125.0,125.0,7,3290,10.0,1448.0,972.0
0.089,6,10,1506,5,395,20.0,127.0,127.0,5,1111,19.0,843.0,843.0
0.003,17,4,284,2,120,0.0,32.0,32.0,2,164,0.0,60.0,54.0
40.069,17,10,676,5,460,10016.0,104.0,64.0,5,216,10016.0,20.0,15.0
0.004,6,10,2006,5,927,1.0,659.0,659.0,5,1079,1.0,811.0,811.0
0.098,6,10,1506,5,395,23.0,127.0,127.0,5,1111,23.0,843.0,843.0
0.015,6,10,1990,5,911,3.0,643.0,643.0,5,1079,3.0,811.0,811.0
0.097,6,10,1506,5,395,20.0,127.0,127.0,5,1111,22.0,843.0,843.0
0.003,17,2,148,1,60,0.0,32.0,32.0,1,88,0.0,60.0,60.0
0.004,6,10,2006,5,927,1.0,659.0,659.0,5,1079,1.0,811.0,811.0
0.006,6,10,1854,5,889,1.0,621.0,621.0,5,965,1.0,697.0,697.0
0.127,17,2,170,1,65,0.0,37.0,37.0,1,105,0.0,77.0,77.0
0.011,6,10,1631,5,848,2.0,580.0,580.0,5,783,2.0,515.0,515.0
18.354,6,24,7517,13,1385,1529.0,530.0,277.0,11,6132,1817.0,2720.0,946.0
9.069,17,6,376,5,280,2267.0,28.0,28.0,1,96,0.0,68.0,68.0
0.016,6,10,1631,5,848,3.0,580.0,580.0,5,783,3.0,515.0,515.0
0.004,6,10,2000,5,927,1.0,659.0,659.0,5,1073,1.0,805.0,805.0
0.009,6,10,1989,5,910,2.0,642.0,642.0,5,1079,2.0,811.0,811.0
0.013,6,10,1990,5,911,3.0,643.0,643.0,5,1079,3.0,811.0,811.0
332.706,17,20,1124,10,716,36953.0,48.0,43.0,10,408,36953.0,20.0,12.0
0.123,17,2,80,1,32,0.0,4.0,4.0,1,48,0.0,20.0,20.0
0.035,17,2,152,1,76,0.0,48.0,48.0,1,76,0.0,48.0,48.0
0.005,6,10,2007,5,928,1.0,660.0,660.0,5,1079,1.0,811.0,811.0
0.01,6,10,1677,5,827,2.0,559.0,559.0,5,850,2.0,582.0,582.0
0.013,6,10,1989,5,910,3.0,642.0,642.0,5,1079,3.0,811.0,811.0
0.006,6,10,1547,5,764,1.0,496.0,496.0,5,783,1.0,515.0,515.0
0.118,6,10,1506,5,395,27.0,127.0,127.0,5,1111,26.0,843.0,843.0
0.005,6,10,2006,5,927,1.0,659.0,659.0,5,1079,1.0,811.0,811.0
0.005,6,10,2006,5,927,1.0,659.0,659.0,5,1079,1.0,811.0,811.0
0.074,6,10,1506,5,395,16.0,127.0,127.0,5,1111,16.0,843.0,843.0
0.137,6,10,1506,5,395,33.0,127.0,127.0,5,1111,30.0,843.0,843.0
15.197,17,20,11790,10,8082,1685.0,1350.0,780.0,10,3708,1685.0,1350.0,342.0
0.119,6,10,1506,5,395,22.0,127.0,127.0,5,1111,24.0,843.0,843.0
0.005,17,2,144,1,64,0.0,36.0,36.0,1,80,0.0,52.0,52.0
0.016,6,10,1989,5,910,4.0,642.0,642.0,5,1079,3.0,811.0,811.0
0.211,6,10,1266,5,775,52.0,519.0,519.0,5,491,42.0,223.0,223.0
0.009,6,10,1762,5,911,2.0,643.0,643.0,5,851,2.0,583.0,583.0
11.045,17,28,4389,14,2312,841.0,587.0,137.0,14,2077,841.0,268.0,120.0
0.023,6,10,1972,5,910,5.0,642.0,642.0,5,1062,5.0,794.0,794.0
0.011,6,10,1983,5,910,2.0,642.0,642.0,5,1073,2.0,805.0,805.0
0.005,6,10,2006,5,927,1.0,659.0,659.0,5,1079,1.0,811.0,811.0
0.009,6,10,1989,5,910,2.0,642.0,642.0,5,1079,2.0,811.0,811.0
0.054,17,2,152,1,76,0.0,48.0,48.0,1,76,0.0,48.0,48.0
40.057,17,10,676,5,460,10013.0,104.0,64.0,5,216,10011.0,20.0,15.0
0.006,17,2,170,1,65,0.0,37.0,37.0,1,105,0.0,77.0,77.0
0.005,6,10,2006,5,927,1.0,659.0,659.0,5,1079,1.0,811.0,811.0
0.149,6,10,1506,5,395,33.0,127.0,127.0,5,1111,34.0,843.0,843.0
0.215,6,16,2777,8,1395,30.0,533.0,323.0,8,1382,19.0,529.0,239.0
0.006,6,10,1689,5,839,1.0,571.0,571.0,5,850,1.0,582.0,582.0
0.007,6,10,1547,5,764,1.0,496.0,496.0,5,783,1.0,515.0,515.0
0.014,6,10,1989,5,910,3.0,642.0,642.0,5,1079,3.0,811.0,811.0
0.004,17,2,136,1,60,0.0,32.0,32.0,1,76,0.0,48.0,48.0
0.015,6,10,1983,5,910,3.0,642.0,642.0,5,1073,3.0,805.0,805.0
40.063,17,10,676,5,460,10013.0,104.0,64.0,5,216,10014.0,20.0,15.0
0.007,6,10,1989,5,910,1.0,642.0,642.0,5,1079,1.0,811.0,811.0
0.004,6,10,1989,5,927,1.0,659.0,659.0,5,1062,1.0,794.0,794.0
0.005,6,10,1989,5,927,1.0,659.0,659.0,5,1062,1.0,794.0,794.0
0.006,6,10,1547,5,764,1.0,496.0,496.0,5,783,1.0,515.0,515.0
0.029,6,10,1983,5,910,7.0,642.0,642.0,5,1073,7.0,805.0,805.0
0.004,17,2,148,1,60,0.0,32.0,32.0,1,88,0.0,60.0,60.0
0.005,6,10,1689,5,839,1.0,571.0,571.0,5,850,1.0,582.0,582.0
0.013,6,10,1989,5,910,3.0,642.0,642.0,5,1079,3.0,811.0,811.0
0.004,17,2,148,1,60,0.0,32.0,32.0,1,88,0.0,60.0,60.0
0.018,6,10,1972,5,910,4.0,642.0,642.0,5,1062,4.0,794.0,794.0
0.005,17,2,194,1,57,0.0,29.0,29.0,1,137,0.0,109.0,109.0
0.144,6,10,1506,5,395,33.0,127.0,127.0,5,1111,33.0,843.0,843.0
0.144,6,10,1506,5,395,31.0,127.0,127.0,5,1111,35.0,843.0,843.0
351.988,6,20,2210,6,1308,12003.0,494.0,494.0,14,902,27075.0,83.0,83.0
0.006,6,10,1689,5,839,1.0,571.0,571.0,5,850,1.0,582.0,582.0
0.001,17,2,180,1,66,0.0,38.0,38.0,1,114,0.0,86.0,86.0
0.08,6,10,1506,5,395,18.0,127.0,127.0,5,1111,19.0,843.0,843.0
0.068,17,8,3613,4,1874,22.0,1350.0,440.0,4,1739,11.0,1350.0,406.0
0.009,6,10,1990,5,911,2.0,643.0,643.0,5,1079,2.0,811.0,811.0
0.095,6,10,1506,5,395,22.0,127.0,127.0,5,1111,19.0,843.0,843.0
0.021,17,2,170,1,65,0.0,37.0,37.0,1,105,0.0,77.0,77.0
0.018,6,10,1762,5,911,4.0,643.0,643.0,5,851,4.0,583.0,583.0
0.005,6,10,2006,5,927,1.0,659.0,659.0,5,1079,1.0,811.0,811.0
0.005,6,10,2006,5,927,1.0,659.0,659.0,5,1079,1.0,811.0,811.0
0.034,6,10,1605,5,388,8.0,120.0,120.0,5,1217,8.0,949.0,949.0
0.761,6,22,5072,11,1250,65.0,325.0,133.0,11,3822,63.0,1414.0,563.0
0.174,17,2,152,1,76,0.0,48.0,48.0,1,76,0.0,48.0,48.0
306.124,6,33,12586,18,2671,18007.0,585.0,345.0,15,9915,17579.0,1402.0,1014.0
0.009,6,10,1989,5,910,2.0,642.0,642.0,5,1079,2.0,811.0,811.0
241.395,6,400,348146,197,21763,1231.0,2736.0,959.0,203,326383,1195.0,2804.0,1636.0
0.011,17,2,214,1,75,0.0,47.0,47.0,1,139,0.0,111.0,111.0
0.109,6,10,1506,5,395,23.0,127.0,127.0,5,1111,25.0,843.0,843.0
0.006,6,10,1547,5,764,1.0,496.0,496.0,5,783,1.0,515.0,515.0
0.008,6,10,1547,5,764,1.0,496.0,496.0,5,783,2.0,515.0,515.0
0.005,6,10,1689,5,839,1.0,571.0,571.0,5,850,1.0,582.0,582.0
0.086,6,10,1506,5,395,19.0,127.0,127.0,5,1111,18.0,843.0,843.0
0.006,6,10,2006,5,927,1.0,659.0,659.0,5,1079,1.0,811.0,811.0
0.008,17,2,148,1,60,0.0,32.0,32.0,1,88,0.0,60.0,60.0
0.005,6,10,1989,5,927,1.0,659.0,659.0,5,1062,1.0,794.0,794.0
0.006,17,2,170,1,65,0.0,37.0,37.0,1,105,0.0,77.0,77.0
0.167,6,10,1506,5,395,39.0,127.0,127.0,5,1111,33.0,843.0,843.0
1770.459,6,83,4368,42,2210,43180.0,26.0,26.0,41,2158,44260.0,26.0,26.0
0.04,17,4,284,2,120,0.0,32.0,32.0,2,164,36.0,60.0,54.0
0.068,6,10,1506,5,395,15.0,127.0,127.0,5,1111,13.0,843.0,843.0
0.016,6,10,1989,5,910,3.0,642.0,642.0,5,1079,4.0,811.0,811.0
40.083,17,10,676,5,460,10019.0,104.0,64.0,5,216,10019.0,20.0,15.0
0.085,6,10,1506,5,395,20.0,127.0,127.0,5,1111,19.0,843.0,843.0
40.081,17,10,676,5,460,10019.0,104.0,64.0,5,216,10019.0,20.0,15.0
240.084,6,20,4874,11,941,24008.0,180.0,93.0,9,3933,30010.0,1593.0,576.0
352.693,6,20,2210,6,1308,12007.0,494.0,494.0,14,902,27130.0,83.0,83.0
0.136,6,10,1506,5,395,29.0,127.0,127.0,5,1111,33.0,843.0,843.0
0.003,17,2,136,1,60,0.0,32.0,32.0,1,76,0.0,48.0,48.0
0.02,6,10,1990,5,911,4.0,643.0,643.0,5,1079,5.0,811.0,811.0
0.004,17,4,284,2,120,1.0,32.0,32.0,2,164,0.0,60.0,54.0
40.075,17,10,676,5,460,10014.0,104.0,64.0,5,216,10016.0,20.0,15.0
0.072,17,2,136,1,60,0.0,32.0,32.0,1,76,0.0,48.0,48.0
0.084,6,10,1506,5,395,18.0,127.0,127.0,5,1111,18.0,843.0,843.0
0.183,6,10,1506,5,395,43.0,127.0,127.0,5,1111,36.0,843.0,843.0
240.562,6,33,8632,17,1834,15032.0,567.0,188.0,16,6798,16035.0,1402.0,597.0
40.046,17,10,676,5,460,10010.0,104.0,64.0,5,216,10010.0,20.0,15.0
0.007,17,2,179,1,71,0.0,43.0,43.0,1,108,0.0,80.0,80.0
300.409,6,16,2170,9,684,37530.0,146.0,146.0,7,1486,50041.0,419.0,398.0
331.636,17,20,1124,10,716,36834.0,48.0,43.0,10,408,36834.0,20.0,12.0
40.057,17,10,676,5,460,10013.0,104.0,64.0,5,216,10010.0,20.0,15.0
0.009,6,10,2006,5,927,2.0,659.0,659.0,5,1079,2.0,811.0,811.0
40.075,17,10,676,5,460,10017.0,104.0,64.0,5,216,10017.0,20.0,15.0
0.005,6,10,2000,5,927,1.0,659.0,659.0,5,1073,1.0,805.0,805.0
0.002,17,2,136,1,60,0.0,32.0,32.0,1,76,0.0,48.0,48.0
0.079,6,10,1506,5,395,16.0,127.0,127.0,5,1111,16.0,843.0,843.0
0.008,6,10,1983,5,910,2.0,642.0,642.0,5,1073,2.0,805.0,805.0
0.088,6,10,1506,5,395,21.0,127.0,127.0,5,1111,21.0,843.0,843.0
0.006,6,10,1854,5,889,1.0,621.0,621.0,5,965,1.0,697.0,697.0
0.01,6,10,1677,5,827,2.0,559.0,559.0,5,850,2.0,582.0,582.0
0.017,17,2,194,1,59,0.0,31.0,31.0,1,135,0.0,107.0,107.0
11.227,17,28,4421,14,1993,851.0,268.0,114.0,14,2428,851.0,587.0,145.0
0.025,6,10,1972,5,910,6.0,642.0,642.0,5,1062,6.0,794.0,794.0
40.055,17,10,676,5,460,10012.0,104.0,64.0,5,216,10012.0,20.0,15.0
0.015,6,10,1990,5,911,3.0,643.0,643.0,5,1079,3.0,811.0,811.0
0.005,6,10,2000,5,927,1.0,659.0,659.0,5,1073,1.0,805.0,805.0
0.119,6,10,1506,5,395,28.0,127.0,127.0,5,1111,27.0,843.0,843.0
0.004,17,2,148,1,60,0.0,32.0,32.0,1,88,0.0,60.0,60.0
165.192,17,74,10563,37,2458,4587.0,44.0,38.0,37,8105,4588.0,239.0,191.0
0.006,6,10,1547,5,764,1.0,496.0,496.0,5,783,1.0,515.0,515.0
0.005,6,10,2000,5,927,1.0,659.0,659.0,5,1073,1.0,805.0,805.0
0.005,17,2,154,1,69,0.0,41.0,41.0,1,85,0.0,57.0,57.0
0.003,17,2,142,1,63,0.0,35.0,35.0,1,79,0.0,51.0,51.0
1770.651,17,120,11460,60,5460,30010.0,63.0,63.0,60,6000,30010.0,72.0,72.0
0.012,6,10,1983,5,910,2.0,642.0,642.0,5,1073,3.0,805.0,805.0
0.003,17,2,148,1,60,0.0,32.0,32.0,1,88,0.0,60.0,60.0
0.007,6,10,1762,5,911,1.0,643.0,643.0,5,851,1.0,583.0,583.0
0.017,6,10,1990,5,911,4.0,643.0,643.0,5,1079,4.0,811.0,811.0
0.008,6,10,1989,5,910,1.0,642.0,642.0,5,1079,1.0,811.0,811.0
0.016,6,13,3735,7,497,2.0,125.0,125.0,6,3238,3.0,1470.0,1459.0
0.011,6,10,1990,5,911,2.0,643.0,643.0,5,1079,2.0,811.0,811.0
0.004,6,10,2006,5,927,1.0,659.0,659.0,5,1079,1.0,811.0,811.0
0.004,6,10,1702,5,863,1.0,595.0,595.0,5,839,1.0,571.0,571.0
0.014,6,10,1972,5,910,3.0,642.0,642.0,5,1062,3.0,794.0,794.0
0.005,6,10,1989,5,927,1.0,659.0,659.0,5,1062,1.0,794.0,794.0
174.104,17,70,9977,35,2338,5120.0,44.0,38.0,35,7639,5120.0,239.0,190.0
0.005,6,10,1643,5,860,1.0,592.0,592.0,5,783,1.0,515.0,515.0
172.1,17,78,11037,39,2601,4528.0,44.0,38.0,39,8436,4528.0,239.0,188.0
308.556,17,20,1124,10,716,34269.0,48.0,43.0,10,408,34269.0,20.0,12.0
0.121,6,10,1506,5,395,29.0,127.0,127.0,5,1111,26.0,843.0,843.0
40.072,17,10,676,5,460,10014.0,104.0,64.0,5,216,10017.0,20.0,15.0
0.015,17,2,154,1,69,0.0,41.0,41.0,1,85,0.0,57.0,57.0
0.005,17,2,166,1,75,0.0,47.0,47.0,1,91,0.0,63.0,63.0
0.005,17,2,136,1,60,0.0,32.0,32.0,1,76,0.0,48.0,48.0
240.013,6,9,787,5,488,60003.0,232.0,232.0,4,299,80003.0,83.0,83.0
0.001,17,2,180,1,66,0.0,38.0,38.0,1,114,0.0,86.0,86.0
11.131,17,28,4421,14,1992,844.0,267.0,114.0,14,2429,843.0,588.0,145.0
0.02,6,10,1983,5,910,4.0,642.0,642.0,5,1073,5.0,805.0,805.0
0.005,6,13,3747,7,509,0.0,137.0,137.0,6,3238,0.0,1470.0,1459.0
0.005,6,13,3690,7,452,0.0,80.0,80.0,6,3238,0.0,1470.0,1459.0
0.008,17,2,194,1,59,0.0,31.0,31.0,1,135,0.0,107.0,107.0
0.098,6,10,1506,5,395,19.0,127.0,127.0,5,1111,22.0,843.0,843.0
0.016,6,10,1631,5,848,3.0,580.0,580.0,5,783,3.0,515.0,515.0
0.226,6,16,2777,8,1395,32.0,533.0,323.0,8,1382,20.0,529.0,239.0
0.009,6,10,1983,5,910,2.0,642.0,642.0,5,1073,2.0,805.0,805.0
240.475,6,35,15249,16,8724,16031.0,1819.0,1128.0,19,6525,13359.0,1657.0,691.0
353.996,6,21,1795,16,1030,23599.0,190.0,190.0,5,765,60001.0,464.0,248.0
0.148,6,10,1506,5,395,34.0,127.0,127.0,5,1111,32.0,843.0,843.0
0.005,6,10,2006,5,927,1.0,659.0,659.0,5,1079,1.0,811.0,811.0
0.087,6,10,1506,5,395,19.0,127.0,127.0,5,1111,17.0,843.0,843.0
0.085,6,10,1506,5,395,20.0,127.0,127.0,5,1111,20.0,843.0,843.0
0.01,6,10,1989,5,927,2.0,659.0,659.0,5,1062,2.0,794.0,794.0
0.026,6,10,1990,5,911,6.0,643.0,643.0,5,1079,6.0,811.0,811.0
40.072,17,10,676,5,460,10014.0,104.0,64.0,5,216,10017.0,20.0,15.0
0.006,6,10,1689,5,839,1.0,571.0,571.0,5,850,1.0,582.0,582.0
0.015,6,10,1983,5,910,3.0,642.0,642.0,5,1073,3.0,805.0,805.0
0.095,6,10,1506,5,395,21.0,127.0,127.0,5,1111,20.0,843.0,843.0
0.066,6,10,1506,5,395,14.0,127.0,127.0,5,1111,14.0,843.0,843.0
0.075,6,10,1506,5,395,16.0,127.0,127.0,5,1111,16.0,843.0,843.0
0.005,6,10,2000,5,927,1.0,659.0,659.0,5,1073,1.0,805.0,805.0
15.07,17,14,9191,8,6902,2148.0,1350.0,834.0,6,2289,3008.0,1350.0,353.0
0.009,6,10,1972,5,910,2.0,642.0,642.0,5,1062,2.0,794.0,794.0
0.04,17,4,284,2,120,0.0,32.0,32.0,2,164,2.0,60.0,54.0
0.004,6,10,2006,5,927,1.0,659.0,659.0,5,1079,1.0,811.0,811.0
15.18,17,20,10978,10,7424,1683.0,1350.0,714.0,10,3554,1683.0,1350.0,327.0
0.13,17,4,284,2,120,0.0,32.0,32.0,2,164,126.0,60.0,54.0
0.034,17,2,152,1,76,0.0,48.0,48.0,1,76,0.0,48.0,48.0
326.004,6,19,2158,6,1308,12003.0,494.0,494.0,13,850,27166.0,83.0,83.0
0.099,6,10,1506,5,395,23.0,127.0,127.0,5,1111,22.0,843.0,843.0
0.005,17,2,230,1,68,0.0,40.0,40.0,1,162,0.0,134.0,134.0
0.008,6,10,1989,5,910,2.0,642.0,642.0,5,1079,2.0,811.0,811.0
0.011,6,10,1972,5,910,2.0,642.0,642.0,5,1062,2.0,794.0,794.0
240.086,6,16,4481,9,963,30010.0,238.0,166.0,7,3518,40013.0,1402.0,786.0
0.128,6,10,1506,5,395,28.0,127.0,127.0,5,1111,29.0,843.0,843.0
0.008,17,2,170,1,65,0.0,37.0,37.0,1,105,0.0,77.0,77.0
0.005,6,13,3684,7,446,0.0,74.0,74.0,6,3238,1.0,1470.0,1459.0
0.011,6,10,1762,5,911,2.0,643.0,643.0,5,851,2.0,583.0,583.0
40.066,17,10,676,5,460,10015.0,104.0,64.0,5,216,10015.0,20.0,15.0
0.005,17,2,222,1,65,0.0,37.0,37.0,1,157,0.0,129.0,129.0
0.004,6,10,2007,5,928,1.0,660.0,660.0,5,1079,1.0,811.0,811.0
0.085,6,10,1506,5,395,18.0,127.0,127.0,5,1111,19.0,843.0,843.0
0.006,6,13,3690,7,452,0.0,80.0,80.0,6,3238,1.0,1470.0,1459.0
0.01,6,10,1989,5,910,2.0,642.0,642.0,5,1079,2.0,811.0,811.0
40.052,17,10,676,5,460,10012.0,104.0,64.0,5,216,10012.0,20.0,15.0
0.01,6,10,1983,5,910,2.0,642.0,642.0,5,1073,2.0,805.0,805.0
0.04,6,10,1972,5,910,9.0,642.0,642.0,5,1062,10.0,794.0,794.0
300.021,6,12,1782,7,1348,50003.0,494.0,494.0,5,434,75004.0,83.0,83.0
241.564,6,380,346734,195,21658,1245.0,2736.0,959.0,185,325076,1312.0,2804.0,1802.0
0.011,6,10,1972,5,910,2.0,642.0,642.0,5,1062,2.0,794.0,794.0
0.003,17,2,136,1,60,0.0,32.0,32.0,1,76,0.0,48.0,48.0
0.014,6,10,1677,5,827,3.0,559.0,559.0,5,850,3.0,582.0,582.0
0.077,6,10,1506,5,395,16.0,127.0,127.0,5,1111,17.0,843.0,843.0
0.014,6,10,1989,5,910,3.0,642.0,642.0,5,1079,3.0,811.0,811.0
0.163,6,10,1506,5,395,37.0,127.0,127.0,5,1111,32.0,843.0,843.0
0.104,6,10,1506,5,395,22.0,127.0,127.0,5,1111,22.0,843.0,843.0
0.008,6,10,1989,5,910,2.0,642.0,642.0,5,1079,1.0,811.0,811.0
0.005,6,10,2006,5,927,1.0,659.0,659.0,5,1079,1.0,811.0,811.0
0.081,6,10,1506,5,395,18.0,127.0,127.0,5,1111,19.0,843.0,843.0
0.005,6,10,1989,5,927,1.0,659.0,659.0,5,1062,1.0,794.0,794.0
0.005,6,10,2000,5,927,1.0,659.0,659.0,5,1073,1.0,805.0,805.0
0.041,17,2,136,1,60,0.0,32.0,32.0,1,76,0.0,48.0,48.0
0.005,6,10,1689,5,839,1.0,571.0,571.0,5,850,1.0,582.0,582.0
0.06,17,2,152,1,76,0.0,48.0,48.0,1,76,0.0,48.0,48.0
0.019,6,10,1990,5,911,4.0,643.0,643.0,5,1079,4.0,811.0,811.0
0.005,6,11,1831,6,980,0.0,660.0,660.0,5,851,1.0,583.0,583.0
0.012,6,10,1631,5,848,2.0,580.0,580.0,5,783,2.0,515.0,515.0
371.544,6,22,2313,16,867,24769.0,195.0,195.0,6,1446,4637.0,419.0,398.0
10.857,17,28,4420,14,1993,826.0,268.0,114.0,14,2427,826.0,586.0,145.0
0.011,6,10,1990,5,911,2.0,643.0,643.0,5,1079,2.0,811.0,811.0
0.004,6,10,1779,5,928,1.0,660.0,660.0,5,851,0.0,583.0,583.0
0.115,6,10,1506,5,395,25.0,127.0,127.0,5,1111,24.0,843.0,843.0
0.005,6,10,2006,5,927,1.0,659.0,659.0,5,1079,1.0,811.0,811.0
0.006,6,10,1989,5,927,1.0,659.0,659.0,5,1062,1.0,794.0,794.0
0.007,6,10,2000,5,927,1.0,659.0,659.0,5,1073,1.0,805.0,805.0
0.001,17,2,180,1,66,0.0,38.0,38.0,1,114,0.0,86.0,86.0
40.077,17,10,676,5,460,10018.0,104.0,64.0,5,216,10018.0,20.0,15.0
0.109,6,10,1506,5,395,24.0,127.0,127.0,5,1111,22.0,843.0,843.0
0.008,6,10,2000,5,927,2.0,659.0,659.0,5,1073,1.0,805.0,805.0
0.03,6,10,1989,5,910,7.0,642.0,642.0,5,1079,7.0,811.0,811.0
0.004,6,10,2000,5,927,1.0,659.0,659.0,5,1073,1.0,805.0,805.0
0.004,17,4,284,2,120,0.0,32.0,32.0,2,164,0.0,60.0,54.0
0.001,17,2,180,1,66,0.0,38.0,38.0,1,114,0.0,86.0,86.0
317.23,17,20,1124,10,716,35241.0,48.0,43.0,10,408,35241.0,20.0,12.0
0.078,6,10,1506,5,395,18.0,127.0,127.0,5,1111,15.0,843.0,843.0
0.386,17,64,44026,40,37806,9.0,1350.0,917.0,24,6220,14.0,1350.0,231.0
40.061,17,10,676,5,460,10014.0,104.0,64.0,5,216,10014.0,20.0,15.0
0.005,6,10,2000,5,927,1.0,659.0,659.0,5,1073,1.0,805.0,805.0
0.01,6,10,1990,5,911,2.0,643.0,643.0,5,1079,2.0,811.0,811.0
0.008,17,2,179,1,71,0.0,43.0,43.0,1,108,0.0,80.0,80.0
0.005,6,10,1774,5,923,1.0,655.0,655.0,5,851,1.0,583.0,583.0
0.005,17,2,214,1,75,0.0,47.0,47.0,1,139,0.0,111.0,111.0
0.006,6,14,3799,7,509,1.0,137.0,137.0,7,3290,0.0,1448.0,972.0
0.006,6,10,1989,5,927,1.0,659.0,659.0,5,1062,1.0,794.0,794.0
0.005,6,10,2000,5,927,1.0,659.0,659.0,5,1073,1.0,805.0,805.0
0.084,6,10,1506,5,395,19.0,127.0,127.0,5,1111,17.0,843.0,843.0
0.019,6,10,1762,5,911,4.0,643.0,643.0,5,851,4.0,583.0,583.0
0.098,6,10,1506,5,395,22.0,127.0,127.0,5,1111,24.0,843.0,843.0
0.004,6,14,3742,7,452,0.0,80.0,80.0,7,3290,0.0,1448.0,972.0
0.091,6,10,1506,5,395,19.0,127.0,127.0,5,1111,20.0,843.0,843.0
0.011,6,10,1631,5,848,2.0,580.0,580.0,5,783,2.0,515.0,515.0
0.005,6,10,2006,5,927,1.0,659.0,659.0,5,1079,1.0,811.0,811.0
164.127,17,82,11695,41,2740,4103.0,44.0,38.0,41,8955,4103.0,239.0,190.0
0.005,6,10,2006,5,927,1.0,659.0,659.0,5,1079,1.0,811.0,811.0
40.071,17,10,676,5,460,10017.0,104.0,64.0,5,216,10017.0,20.0,15.0
0.01,6,10,1989,5,910,2.0,642.0,642.0,5,1079,2.0,811.0,811.0
0.079,6,10,1506,5,395,16.0,127.0,127.0,5,1111,16.0,843.0,843.0
11.189,17,28,4421,14,1993,847.0,268.0,114.0,14,2428,847.0,587.0,145.0
241.305,6,376,347129,190,21404,1276.0,2736.0,959.0,186,325725,1304.0,2804.0,1795.0
0.004,17,2,166,1,75,0.0,47.0,47.0,1,91,0.0,63.0,63.0
0.01,6,12,1926,6,1189,2.0,659.0,434.0,6,737,1.0,417.0,417.0
0.003,17,4,284,2,120,0.0,32.0,32.0,2,164,0.0,60.0,54.0
0.008,6,10,1990,5,911,1.0,643.0,643.0,5,1079,2.0,811.0,811.0
0.021,6,10,1605,5,388,5.0,120.0,120.0,5,1217,5.0,949.0,949.0
0.012,6,10,1989,5,910,3.0,642.0,642.0,5,1079,3.0,811.0,811.0
0.005,17,2,166,1,75,0.0,47.0,47.0,1,91,0.0,63.0,63.0
0.017,6,10,1605,5,388,4.0,120.0,120.0,5,1217,4.0,949.0,949.0
0.016,6,10,1983,5,910,4.0,642.0,642.0,5,1073,3.0,805.0,805.0
0.004,6,10,2006,5,927,1.0,659.0,659.0,5,1079,1.0,811.0,811.0
0.012,6,13,3816,7,578,2.0,206.0,206.0,6,3238,2.0,1470.0,1459.0
0.009,6,10,1972,5,910,2.0,642.0,642.0,5,1062,2.0,794.0,794.0
0.211,6,10,1506,5,395,45.0,127.0,127.0,5,1111,36.0,843.0,843.0
0.015,6,10,1972,5,910,3.0,642.0,642.0,5,1062,3.0,794.0,794.0
40.064,17,10,676,5,460,10013.0,104.0,64.0,5,216,10014.0,20.0,15.0
300.864,6,37,10017,20,4539,15834.0,1963.0,741.0,17,5478,543.0,2667.0,435.0
0.009,6,10,1983,5,910,2.0,642.0,642.0,5,1073,2.0,805.0,805.0
0.009,17,2,148,1,60,0.0,32.0,32.0,1,88,0.0,60.0,60.0
240.089,6,30,9562,15,7039,17149.0,2164.0,695.0,15,2523,17149.0,580.0,216.0
0.006,6,10,1643,5,860,1.0,592.0,592.0,5,783,1.0,515.0,515.0
15.17,17,21,12483,11,8807,1514.0,1350.0,772.0,10,3676,1682.0,1350.0,339.0
0.015,6,10,1989,5,910,3.0,642.0,642.0,5,1079,3.0,811.0,811.0
361.786,6,19,1688,15,978,25841.0,190.0,190.0,4,710,80012.0,494.0,494.0
0.083,6,10,1506,5,395,17.0,127.0,127.0,5,1111,18.0,843.0,843.0
0.003,17,2,148,1,60,0.0,32.0,32.0,1,88,0.0,60.0,60.0
103.24,6,20,3480,10,1537,11466.0,533.0,252.0,10,1943,11466.0,529.0,283.0
0.006,6,10,1547,5,764,1.0,496.0,496.0,5,783,1.0,515.0,515.0
0.004,6,10,1779,5,928,1.0,660.0,660.0,5,851,1.0,583.0,583.0
0.005,6,10,1854,5,889,1.0,621.0,621.0,5,965,1.0,697.0,697.0
0.01,6,10,1972,5,910,2.0,642.0,642.0,5,1062,2.0,794.0,794.0
0.04,17,2,412,1,61,0.0,33.0,33.0,1,351,0.0,323.0,323.0
0.013,6,10,1989,5,910,3.0,642.0,642.0,5,1079,3.0,811.0,811.0
0.099,6,10,1506,5,395,21.0,127.0,127.0,5,1111,20.0,843.0,843.0
0.01,6,13,3735,7,497,1.0,125.0,125.0,6,3238,1.0,1470.0,1459.0
0.014,6,10,1972,5,910,3.0,642.0,642.0,5,1062,3.0,794.0,794.0
0.01,17,2,136,1,60,0.0,32.0,32.0,1,76,0.0,48.0,48.0
0.016,6,14,3787,7,497,2.0,125.0,125.0,7,3290,2.0,1448.0,972.0
0.011,6,10,1990,5,911,2.0,643.0,643.0,5,1079,2.0,811.0,811.0
0.005,17,2,230,1,68,0.0,40.0,40.0,1,162,0.0,134.0,134.0
0.083,6,10,1506,5,395,18.0,127.0,127.0,5,1111,19.0,843.0,843.0
0.004,17,2,136,1,60,0.0,32.0,32.0,1,76,0.0,48.0,48.0
0.013,17,2,152,1,56,0.0,28.0,28.0,1,96,0.0,68.0,68.0
9.039,17,6,376,5,280,2259.0,28.0,28.0,1,96,0.0,68.0,68.0
0.046,6,10,1983,5,910,11.0,642.0,642.0,5,1073,11.0,805.0,805.0
0.004,6,10,2000,5,927,1.0,659.0,659.0,5,1073,1.0,805.0,805.0
0.009,6,10,1989,5,910,2.0,642.0,642.0,5,1079,2.0,811.0,811.0
0.008,6,10,1990,5,911,2.0,643.0,643.0,5,1079,2.0,811.0,811.0
0.008,6,13,3735,7,497,1.0,125.0,125.0,6,3238,1.0,1470.0,1459.0
579.911,6,37,13752,20,3451,30521.0,676.0,400.0,17,10301,32494.0,1402.0,940.0
0.005,6,10,2000,5,927,1.0,659.0,659.0,5,1073,1.0,805.0,805.0
0.005,6,10,2006,5,927,1.0,659.0,659.0,5,1079,1.0,811.0,811.0
0.1,6,10,1506,5,395,21.0,127.0,127.0,5,1111,23.0,843.0,843.0
0.123,6,10,1506,5,395,28.0,127.0,127.0,5,1111,28.0,843.0,843.0
0.014,6,10,1972,5,910,3.0,642.0,642.0,5,1062,3.0,794.0,794.0
0.011,6,10,1762,5,911,2.0,643.0,643.0,5,851,2.0,583.0,583.0
0.005,17,2,230,1,68,0.0,40.0,40.0,1,162,0.0,134.0,134.0
0.005,6,10,1989,5,927,1.0,659.0,659.0,5,1062,1.0,794.0,794.0
240.091,6,16,4481,9,963,30011.0,238.0,166.0,7,3518,40014.0,1402.0,786.0
0.045,6,10,1989,5,910,11.0,642.0,642.0,5,1079,11.0,811.0,811.0
0.005,17,2,170,1,65,0.0,37.0,37.0,1,105,0.0,77.0,77.0
0.004,17,4,284,2,120,0.0,32.0,32.0,2,164,1.0,60.0,54.0
40.06,17,10,676,5,460,10014.0,104.0,64.0,5,216,10014.0,20.0,15.0
0.077,6,10,1506,5,395,16.0,127.0,127.0,5,1111,16.0,843.0,843.0
11.016,17,28,4421,14,1994,838.0,269.0,114.0,14,2427,838.0,586.0,145.0
0.163,17,2,152,1,76,0.0,48.0,48.0,1,76,0.0,48.0,48.0
0.019,6,10,1631,5,848,4.0,580.0,580.0,5,783,4.0,515.0,515.0
0.013,6,10,1972,5,910,3.0,642.0,642.0,5,1062,3.0,794.0,794.0
0.014,6,10,1990,5,911,3.0,643.0,643.0,5,1079,3.0,811.0,811.0
40.057,17,10,676,5,460,10013.0,104.0,64.0,5,216,10013.0,20.0,15.0
0.006,17,2,170,1,65,0.0,37.0,37.0,1,105,0.0,77.0,77.0
0.065,6,10,1506,5,395,15.0,127.0,127.0,5,1111,14.0,843.0,843.0
0.015,6,10,1989,5,910,3.0,642.0,642.0,5,1079,3.0,811.0,811.0
0.04,17,4,284,2,120,0.0,32.0,32.0,2,164,36.0,60.0,54.0
0.01,6,10,1990,5,911,2.0,643.0,643.0,5,1079,2.0,811.0,811.0
10.721,17,28,4423,14,1994,816.0,269.0,114.0,14,2429,816.0,588.0,145.0
0.011,6,10,1677,5,827,2.0,559.0,559.0,5,850,2.0,582.0,582.0
0.123,6,10,1506,5,395,26.0,127.0,127.0,5,1111,24.0,843.0,843.0
0.004,17,2,136,1,60,0.0,32.0,32.0,1,76,0.0,48.0,48.0
1770.47,6,83,4368,42,2210,43181.0,26.0,26.0,41,2158,44260.0,26.0,26.0
0.016,6,10,1989,5,910,3.0,642.0,642.0,5,1079,4.0,811.0,811.0
353.365,6,20,2210,6,1308,12003.0,494.0,494.0,14,902,27181.0,83.0,83.0
0.114,6,10,1506,5,395,24.0,127.0,127.0,5,1111,26.0,843.0,843.0
0.004,6,10,2000,5,927,1.0,659.0,659.0,5,1073,1.0,805.0,805.0
0.008,6,10,1983,5,910,2.0,642.0,642.0,5,1073,1.0,805.0,805.0
0.011,6,10,1972,5,910,2.0,642.0,642.0,5,1062,2.0,794.0,794.0
0.052,17,2,152,1,76,0.0,48.0,48.0,1,76,0.0,48.0,48.0
1778.829,17,143,45188,72,22752,25050.0,288.0,288.0,71,22436,25410.0,288.0,288.0
0.005,6,10,2000,5,927,1.0,659.0,659.0,5,1073,1.0,805.0,805.0
309.857,17,20,1124,10,716,34414.0,48.0,43.0,10,408,34414.0,20.0,12.0
0.013,6,10,1989,5,910,3.0,642.0,642.0,5,1079,3.0,811.0,811.0
0.006,6,10,1689,5,839,1.0,571.0,571.0,5,850,1.0,582.0,582.0
0.005,17,2,166,1,75,0.0,47.0,47.0,1,91,0.0,63.0,63.0
0.001,17,2,180,1,66,0.0,38.0,38.0,1,114,0.0,86.0,86.0
0.004,6,10,2000,5,927,1.0,659.0,659.0,5,1073,1.0,805.0,805.0
0.084,6,10,1506,5,395,19.0,127.0,127.0,5,1111,19.0,843.0,843.0
0.012,6,10,1972,5,910,3.0,642.0,642.0,5,1062,2.0,794.0,794.0
0.009,6,10,1983,5,910,2.0,642.0,642.0,5,1073,2.0,805.0,805.0
0.007,6,10,1762,5,911,1.0,643.0,643.0,5,851,1.0,583.0,583.0
0.005,6,10,2006,5,927,1.0,659.0,659.0,5,1079,1.0,811.0,811.0
0.006,6,10,1854,5,889,1.0,621.0,621.0,5,965,1.0,697.0,697.0
301.335,6,30,11556,16,1451,20088.0,300.0,149.0,14,10105,23179.0,2804.0,1042.0
0.01,6,10,1990,5,911,2.0,643.0,643.0,5,1079,2.0,811.0,811.0
40.085,17,10,676,5,460,10018.0,104.0,64.0,5,216,10020.0,20.0,15.0
40.068,17,10,676,5,460,10016.0,104.0,64.0,5,216,10016.0,20.0,15.0
0.006,6,10,1689,5,839,1.0,571.0,571.0,5,850,1.0,582.0,582.0
0.116,6,10,1506,5,395,26.0,127.0,127.0,5,1111,25.0,843.0,843.0
0.003,17,2,148,1,60,0.0,32.0,32.0,1,88,0.0,60.0,60.0
0.082,6,10,1506,5,395,17.0,127.0,127.0,5,1111,17.0,843.0,843.0
0.005,6,10,2000,5,927,1.0,659.0,659.0,5,1073,1.0,805.0,805.0
280.222,6,22,6035,10,1186,31135.0,267.0,156.0,12,4849,25474.0,1400.0,873.0
0.004,6,10,1989,5,927,1.0,659.0,659.0,5,1062,1.0,794.0,794.0
0.055,6,10,1506,5,395,12.0,127.0,127.0,5,1111,11.0,843.0,843.0
10.76,17,28,4422,14,1994,819.0,269.0,114.0,14,2428,819.0,587.0,145.0
0.025,6,10,1989,5,910,6.0,642.0,642.0,5,1079,6.0,811.0,811.0
0.097,6,10,1506,5,395,21.0,127.0,127.0,5,1111,18.0,843.0,843.0
0.08,6,10,1506,5,395,18.0,127.0,127.0,5,1111,19.0,843.0,843.0
0.072,6,10,1506,5,395,15.0,127.0,127.0,5,1111,15.0,843.0,843.0
0.009,6,13,3735,7,497,1.0,125.0,125.0,6,3238,1.0,1470.0,1459.0
11.03,17,28,4422,14,1995,840.0,270.0,114.0,14,2427,839.0,586.0,145.0
0.004,6,10,2000,5,927,1.0,659.0,659.0,5,1073,1.0,805.0,805.0
0.006,6,10,1547,5,764,1.0,496.0,496.0,5,783,1.0,515.0,515.0
1798.761,17,2890,221714,1435,116328,1254.0,84.0,53.0,1455,105386,1237.0,227.0,44.0
0.016,6,13,3735,7,497,2.0,125.0,125.0,6,3238,3.0,1470.0,1459.0
10.725,17,24,3778,12,1674,965.0,269.0,111.0,12,2104,965.0,587.0,147.0
0.005,6,10,2007,5,928,1.0,660.0,660.0,5,1079,1.0,811.0,811.0
0.004,17,2,148,1,60,0.0,32.0,32.0,1,88,0.0,60.0,60.0
0.015,6,11,1683,6,900,3.0,580.0,580.0,5,783,3.0,515.0,515.0
178.102,17,76,10710,38,2529,4813.0,44.0,38.0,38,8181,4813.0,239.0,187.0
0.006,17,4,284,2,120,0.0,32.0,32.0,2,164,0.0,60.0,54.0
0.019,6,10,1983,5,910,4.0,642.0,642.0,5,1073,4.0,805.0,805.0
0.028,6,10,1989,5,910,6.0,642.0,642.0,5,1079,6.0,811.0,811.0
0.004,6,10,1989,5,927,1.0,659.0,659.0,5,1062,1.0,794.0,794.0
0.004,6,10,2006,5,927,1.0,659.0,659.0,5,1079,1.0,811.0,811.0
0.017,6,10,1972,5,910,4.0,642.0,642.0,5,1062,4.0,794.0,794.0
0.006,6,10,1643,5,860,1.0,592.0,592.0,5,783,1.0,515.0,515.0
40.073,17,10,676,5,460,10015.0,104.0,64.0,5,216,10017.0,20.0,15.0
0.003,17,2,152,1,76,0.0,48.0,48.0,1,76,0.0,48.0,48.0
0.093,6,10,1506,5,395,20.0,127.0,127.0,5,1111,18.0,843.0,843.0
0.015,6,10,1983,5,910,3.0,642.0,642.0,5,1073,3.0,805.0,805.0
0.014,6,10,1983,5,910,3.0,642.0,642.0,5,1073,3.0,805.0,805.0
0.112,6,10,1506,5,395,25.0,127.0,127.0,5,1111,24.0,843.0,843.0
0.01,6,13,3735,7,497,1.0,125.0,125.0,6,3238,1.0,1470.0,1459.0
240.011,6,9,787,5,488,60002.0,232.0,232.0,4,299,80002.0,83.0,83.0
0.017,6,10,1972,5,910,4.0,642.0,642.0,5,1062,4.0,794.0,794.0
0.008,6,10,1983,5,910,1.0,642.0,642.0,5,1073,2.0,805.0,805.0
0.006,6,10,1774,5,923,1.0,655.0,655.0,5,851,1.0,583.0,583.0
0.019,6,10,1990,5,911,4.0,643.0,643.0,5,1079,4.0,811.0,811.0
0.008,6,10,1972,5,910,1.0,642.0,642.0,5,1062,2.0,794.0,794.0
0.07,6,10,1506,5,395,16.0,127.0,127.0,5,1111,15.0,843.0,843.0
368.817,6,22,2313,16,867,24587.0,195.0,195.0,6,1446,4636.0,419.0,398.0
0.094,6,10,1506,5,395,20.0,127.0,127.0,5,1111,22.0,843.0,843.0
0.011,6,13,3735,7,497,1.0,125.0,125.0,6,3238,2.0,1470.0,1459.0
0.012,17,2,194,1,59,0.0,31.0,31.0,1,135,0.0,107.0,107.0
0.011,6,10,1989,5,910,2.0,642.0,642.0,5,1079,2.0,811.0,811.0
0.003,17,2,148,1,60,0.0,32.0,32.0,1,88,0.0,60.0,60.0
240.018,6,9,787,5,488,60004.0,232.0,232.0,4,299,80005.0,83.0,83.0
0.006,6,12,1698,6,863,1.0,327.0,271.0,6,835,1.0,515.0,515.0
0.006,6,10,1547,5,764,1.0,496.0,496.0,5,783,1.0,515.0,515.0
0.005,17,2,231,1,68,0.0,40.0,40.0,1,163,0.0,135.0,135.0
11.095,17,28,4418,14,1994,841.0,269.0,114.0,14,2424,841.0,587.0,145.0
0.076,6,10,1506,5,395,17.0,127.0,127.0,5,1111,17.0,843.0,843.0
0.175,17,2,152,1,76,0.0,48.0,48.0,1,76,0.0,48.0,48.0
0.01,17,2,138,1,61,0.0,33.0,33.0,1,77,0.0,49.0,49.0
240.541,6,33,9265,16,1835,16033.0,623.0,199.0,17,7430,15031.0,1402.0,595.0
5.114,58,2,144,1,72,0.0,24.0,24.0,1,72,0.0,24.0,24.0
0.104,6,10,1506,5,395,22.0,127.0,127.0,5,1111,23.0,843.0,843.0
0.127,6,10,1506,5,395,29.0,127.0,127.0,5,1111,26.0,843.0,843.0
0.131,17,2,412,1,61,0.0,33.0,33.0,1,351,0.0,323.0,323.0
0.02,6,10,1990,5,911,4.0,643.0,643.0,5,1079,4.0,811.0,811.0
0.007,17,2,179,1,71,0.0,43.0,43.0,1,108,0.0,80.0,80.0
0.014,6,10,1762,5,911,3.0,643.0,643.0,5,851,3.0,583.0,583.0
0.041,17,4,596,2,122,1.0,33.0,33.0,2,474,36.0,323.0,209.0
40.068,17,10,676,5,460,10014.0,104.0,64.0,5,216,10016.0,20.0,15.0
0.006,6,10,1547,5,764,1.0,496.0,496.0,5,783,1.0,515.0,515.0
0.066,6,10,1506,5,395,15.0,127.0,127.0,5,1111,16.0,843.0,843.0
0.005,6,10,1774,5,923,1.0,655.0,655.0,5,851,1.0,583.0,583.0
0.03,6,10,1677,5,827,7.0,559.0,559.0,5,850,7.0,582.0,582.0
300.327,6,16,2170,9,684,37520.0,146.0,146.0,7,1486,50023.0,419.0,398.0
0.085,6,10,1506,5,395,20.0,127.0,127.0,5,1111,19.0,843.0,843.0
0.009,6,10,1983,5,910,2.0,642.0,642.0,5,1073,2.0,805.0,805.0
0.009,6,10,1990,5,911,2.0,643.0,643.0,5,1079,2.0,811.0,811.0
0.009,6,10,1989,5,910,2.0,642.0,642.0,5,1079,2.0,811.0,811.0
0.004,6,10,2006,5,927,1.0,659.0,659.0,5,1079,1.0,811.0,811.0
0.005,6,10,2006,5,927,1.0,659.0,659.0,5,1079,1.0,811.0,811.0
0.012,6,10,1983,5,910,3.0,642.0,642.0,5,1073,3.0,805.0,805.0
0.005,6,13,3747,7,509,0.0,137.0,137.0,6,3238,1.0,1470.0,1459.0
0.001,17,2,180,1,66,0.0,38.0,38.0,1,114,0.0,86.0,86.0
176.402,17,80,11178,40,2668,4522.0,44.0,38.0,40,8510,4522.0,252.0,184.0
39.983,17,10,676,5,460,9994.0,104.0,64.0,5,216,9994.0,20.0,15.0
0.09,6,10,1506,5,395,19.0,127.0,127.0,5,1111,21.0,843.0,843.0
0.097,6,10,1506,5,395,19.0,127.0,127.0,5,1111,22.0,843.0,843.0
0.007,6,13,3735,7,497,1.0,125.0,125.0,6,3238,1.0,1470.0,1459.0
241.184,6,37,9345,19,2153,13391.0,690.0,225.0,18,7192,14180.0,1402.0,569.0
0.004,6,10,2006,5,927,1.0,659.0,659.0,5,1079,1.0,811.0,811.0
0.008,17,2,166,1,75,0.0,47.0,47.0,1,91,0.0,63.0,63.0
0.118,6,10,1506,5,395,28.0,127.0,127.0,5,1111,27.0,843.0,843.0
0.07,17,8,3613,4,1874,23.0,1350.0,440.0,4,1739,12.0,1350.0,406.0
240.092,6,16,4481,9,963,30011.0,238.0,166.0,7,3518,40015.0,1402.0,786.0
0.001,17,2,142,1,63,0.0,35.0,35.0,1,79,0.0,51.0,51.0
0.139,17,2,80,1,32,0.0,4.0,4.0,1,48,0.0,20.0,20.0
40.035,17,10,676,5,460,10007.0,104.0,64.0,5,216,10008.0,20.0,15.0
0.11,6,10,1506,5,395,24.0,127.0,127.0,5,1111,23.0,843.0,843.0
240.701,6,37,9657,19,2176,13370.0,748.0,236.0,18,7481,14156.0,1402.0,595.0
0.007,6,10,2000,5,927,1.0,659.0,659.0,5,1073,1.0,805.0,805.0
0.084,6,10,1506,5,395,20.0,127.0,127.0,5,1111,18.0,843.0,843.0
0.004,17,4,284,2,120,1.0,32.0,32.0,2,164,0.0,60.0,54.0
0.011,6,10,1983,5,910,2.0,642.0,642.0,5,1073,2.0,805.0,805.0
10.878,17,28,4421,14,1994,828.0,269.0,114.0,14,2427,828.0,586.0,145.0
0.111,6,10,1506,5,395,26.0,127.0,127.0,5,1111,25.0,843.0,843.0
0.005,6,14,3742,8,504,0.0,80.0,80.0,6,3238,0.0,1470.0,1459.0
0.066,6,10,1506,5,395,15.0,127.0,127.0,5,1111,15.0,843.0,843.0
0.008,6,10,1983,5,910,2.0,642.0,642.0,5,1073,1.0,805.0,805.0
0.015,6,10,1631,5,848,3.0,580.0,580.0,5,783,3.0,515.0,515.0
0.012,6,10,1762,5,911,3.0,643.0,643.0,5,851,3.0,583.0,583.0
0.005,6,10,1989,5,927,1.0,659.0,659.0,5,1062,1.0,794.0,794.0
0.012,6,10,1972,5,910,2.0,642.0,642.0,5,1062,3.0,794.0,794.0
0.016,6,10,1972,5,910,4.0,642.0,642.0,5,1062,4.0,794.0,794.0
0.135,6,10,1506,5,395,30.0,127.0,127.0,5,1111,31.0,843.0,843.0
40.072,17,10,676,5,460,10017.0,104.0,64.0,5,216,10017.0,20.0,15.0
40.087,17,10,676,5,460,10020.0,104.0,64.0,5,216,10019.0,20.0,15.0
0.124,17,4,580,2,122,0.0,33.0,33.0,2,458,85.0,307.0,201.0
0.004,6,10,2006,5,927,1.0,659.0,659.0,5,1079,1.0,811.0,811.0
0.037,6,10,1983,5,910,9.0,642.0,642.0,5,1073,9.0,805.0,805.0
0.005,6,10,1989,5,927,1.0,659.0,659.0,5,1062,1.0,794.0,794.0
0.005,6,10,1689,5,839,1.0,571.0,571.0,5,850,1.0,582.0,582.0
0.005,6,13,3747,7,509,0.0,137.0,137.0,6,3238,1.0,1470.0,1459.0
0.006,6,10,1547,5,764,1.0,496.0,496.0,5,783,1.0,515.0,515.0
0.011,6,10,1989,5,910,2.0,642.0,642.0,5,1079,2.0,811.0,811.0
40.064,17,10,676,5,460,10014.0,104.0,64.0,5,216,10013.0,20.0,15.0
0.118,6,10,1506,5,395,28.0,127.0,127.0,5,1111,28.0,843.0,843.0
40.055,17,10,676,5,460,10012.0,104.0,64.0,5,216,10013.0,20.0,15.0
0.001,17,2,180,1,66,0.0,38.0,38.0,1,114,0.0,86.0,86.0
0.005,6,10,1989,5,927,1.0,659.0,659.0,5,1062,1.0,794.0,794.0
0.01,6,10,1983,5,910,2.0,642.0,642.0,5,1073,2.0,805.0,805.0
0.005,17,2,302,1,65,0.0,37.0,37.0,1,237,0.0,209.0,209.0
0.014,6,10,1972,5,910,3.0,642.0,642.0,5,1062,3.0,794.0,794.0
0.006,6,10,1547,5,764,1.0,496.0,496.0,5,783,1.0,515.0,515.0
0.01,6,10,1989,5,910,2.0,642.0,642.0,5,1079,2.0,811.0,811.0
40.069,17,10,676,5,460,10014.0,104.0,64.0,5,216,10016.0,20.0,15.0
243.108,6,325,344725,128,18167,1914.0,2736.0,959.0,197,326558,1240.0,2769.0,1709.0
0.103,6,10,1506,5,395,21.0,127.0,127.0,5,1111,22.0,843.0,843.0
0.005,6,10,1989,5,927,1.0,659.0,659.0,5,1062,1.0,794.0,794.0
0.004,6,10,2006,5,927,1.0,659.0,659.0,5,1079,1.0,811.0,811.0
0.005,6,10,1989,5,927,1.0,659.0,659.0,5,1062,1.0,794.0,794.0
0.006,6,10,1689,5,839,1.0,571.0,571.0,5,850,1.0,582.0,582.0
0.004,6,10,1989,5,927,1.0,659.0,659.0,5,1062,1.0,794.0,794.0
0.012,6,10,1990,5,911,3.0,643.0,643.0,5,1079,2.0,811.0,811.0
0.019,17,2,136,1,60,0.0,32.0,32.0,1,76,0.0,48.0,48.0
163.62,17,78,10831,39,2601,4305.0,44.0,38.0,39,8230,4305.0,261.0,183.0
0.016,17,2,136,1,60,0.0,32.0,32.0,1,76,0.0,48.0,48.0
0.015,6,10,1972,5,910,3.0,642.0,642.0,5,1062,3.0,794.0,794.0
0.042,17,4,284,2,120,1.0,32.0,32.0,2,164,38.0,60.0,54.0
0.001,17,2,180,1,66,0.0,38.0,38.0,1,114,0.0,86.0,86.0
0.005,6,10,2006,5,927,1.0,659.0,659.0,5,1079,1.0,811.0,811.0
0.078,6,10,1506,5,395,17.0,127.0,127.0,5,1111,16.0,843.0,843.0
0.017,6,13,3735,7,497,2.0,125.0,125.0,6,3238,3.0,1470.0,1459.0
0.008,17,2,194,1,59,0.0,31.0,31.0,1,135,0.0,107.0,107.0
0.01,6,10,1990,5,911,2.0,643.0,643.0,5,1079,2.0,811.0,811.0
0.041,17,2,152,1,76,0.0,48.0,48.0,1,76,0.0,48.0,48.0
0.001,17,2,180,1,66,0.0,38.0,38.0,1,114,0.0,86.0,86.0
1778.581,17,143,45188,72,22752,25049.0,288.0,288.0,71,22436,25408.0,288.0,288.0
0.026,6,10,1972,5,910,6.0,642.0,642.0,5,1062,6.0,794.0,794.0
0.086,6,10,1506,5,395,19.0,127.0,127.0,5,1111,18.0,843.0,843.0
366.971,6,22,2313,16,867,24464.0,195.0,195.0,6,1446,4649.0,419.0,398.0
0.005,6,10,2000,5,927,1.0,659.0,659.0,5,1073,1.0,805.0,805.0
0.005,6,10,2007,5,928,1.0,660.0,660.0,5,1079,1.0,811.0,811.0
308.525,17,20,1124,10,716,34266.0,48.0,43.0,10,408,34266.0,20.0,12.0
0.005,6,10,2007,5,928,1.0,660.0,660.0,5,1079,1.0,811.0,811.0
352.244,6,20,2210,6,1308,12003.0,494.0,494.0,14,902,27095.0,83.0,83.0
5.099,6,21,5923,12,1436,463.0,474.0,201.0,9,4487,637.0,1925.0,804.0
0.006,6,10,1854,5,889,1.0,621.0,621.0,5,965,1.0,697.0,697.0
0.004,6,10,2000,5,927,1.0,659.0,659.0,5,1073,1.0,805.0,805.0
0.004,6,10,2006,5,927,1.0,659.0,659.0,5,1079,1.0,811.0,811.0
0.004,17,2,154,1,69,0.0,41.0,41.0,1,85,0.0,57.0,57.0
0.005,6,10,1689,5,839,1.0,571.0,571.0,5,850,1.0,582.0,582.0
0.004,17,2,136,1,60,0.0,32.0,32.0,1,76,0.0,48.0,48.0
0.007,6,13,3747,7,509,1.0,137.0,137.0,6,3238,1.0,1470.0,1459.0
0.004,17,2,148,1,60,0.0,32.0,32.0,1,88,0.0,60.0,60.0
0.28,17,40,20169,22,17097,13.0,1350.0,749.0,18,3072,13.0,1350.0,142.0
0.083,6,10,1506,5,395,17.0,127.0,127.0,5,1111,19.0,843.0,843.0
0.013,6,10,1989,5,910,3.0,642.0,642.0,5,1079,3.0,811.0,811.0
0.004,17,4,284,2,120,0.0,32.0,32.0,2,164,0.0,60.0,54.0
0.025,17,4,284,2,120,0.0,32.0,32.0,2,164,0.0,60.0,54.0
0.005,17,2,234,1,61,0.0,33.0,33.0,1,173,0.0,145.0,145.0
15.081,17,15,8159,8,6028,2150.0,1350.0,725.0,7,2131,2508.0,1350.0,276.0
0.005,6,10,2006,5,927,1.0,659.0,659.0,5,1079,1.0,811.0,811.0
0.011,6,10,1989,5,910,2.0,642.0,642.0,5,1079,2.0,811.0,811.0
0.009,6,12,1926,6,1189,1.0,659.0,434.0,6,737,1.0,417.0,417.0
0.009,6,10,1990,5,911,2.0,643.0,643.0,5,1079,2.0,811.0,811.0
0.01,6,10,1972,5,910,2.0,642.0,642.0,5,1062,2.0,794.0,794.0
15.073,17,15,9238,8,6902,2149.0,1350.0,834.0,7,2336,2507.0,1350.0,305.0
0.001,17,2,136,1,60,0.0,32.0,32.0,1,76,0.0,48.0,48.0
0.088,6,10,1506,5,395,21.0,127.0,127.0,5,1111,19.0,843.0,843.0
0.016,6,10,1989,5,910,3.0,642.0,642.0,5,1079,3.0,811.0,811.0
0.006,6,10,1689,5,839,1.0,571.0,571.0,5,850,1.0,582.0,582.0
40.073,17,10,676,5,460,10015.0,104.0,64.0,5,216,10017.0,20.0,15.0
0.107,6,10,1506,5,395,23.0,127.0,127.0,5,1111,21.0,843.0,843.0
0.004,6,10,2007,5,928,1.0,660.0,660.0,5,1079,1.0,811.0,811.0
0.005,6,14,3799,7,509,0.0,137.0,137.0,7,3290,0.0,1448.0,972.0
40.055,17,10,676,5,460,10013.0,104.0,64.0,5,216,10013.0,20.0,15.0
0.096,6,10,1506,5,395,21.0,127.0,127.0,5,1111,17.0,843.0,843.0
0.01,6,10,1990,5,911,2.0,643.0,643.0,5,1079,2.0,811.0,811.0
241.468,6,394,348686,190,21399,1277.0,2736.0,959.0,204,327287,1189.0,2804.0,1632.0
0.135,17,2,80,1,32,0.0,4.0,4.0,1,48,0.0,20.0,20.0
0.073,6,10,1506,5,395,16.0,127.0,127.0,5,1111,14.0,843.0,843.0
0.006,6,10,1547,5,764,1.0,496.0,496.0,5,783,1.0,515.0,515.0
0.004,6,10,2007,5,928,1.0,660.0,660.0,5,1079,1.0,811.0,811.0
0.083,6,10,1506,5,395,18.0,127.0,127.0,5,1111,17.0,843.0,843.0
240.555,6,33,8639,17,1840,15032.0,573.0,189.0,16,6799,16034.0,1402.0,597.0
0.109,6,10,1506,5,395,22.0,127.0,127.0,5,1111,23.0,843.0,843.0
0.005,17,2,164,1,74,0.0,46.0,46.0,1,90,0.0,62.0,62.0
0.01,6,10,1989,5,910,2.0,642.0,642.0,5,1079,2.0,811.0,811.0
0.035,6,10,1990,5,911,8.0,643.0,643.0,5,1079,8.0,811.0,811.0
0.005,6,10,2007,5,928,1.0,660.0,660.0,5,1079,1.0,811.0,811.0
15.072,17,15,8874,8,6745,2149.0,1350.0,815.0,7,2129,2507.0,1350.0,276.0
0.005,6,10,2006,5,927,1.0,659.0,659.0,5,1079,1.0,811.0,811.0
0.005,6,10,2006,5,927,1.0,659.0,659.0,5,1079,1.0,811.0,811.0
0.004,6,10,2006,5,927,1.0,659.0,659.0,5,1079,1.0,811.0,811.0
0.004,6,10,2000,5,927,1.0,659.0,659.0,5,1073,1.0,805.0,805.0
0.005,17,2,152,1,68,0.0,40.0,40.0,1,84,0.0,56.0,56.0
0.132,6,10,1506,5,395,29.0,127.0,127.0,5,1111,30.0,843.0,843.0
0.213,6,16,2777,8,1395,30.0,533.0,323.0,8,1382,19.0,529.0,239.0
0.011,6,10,1677,5,827,2.0,559.0,559.0,5,850,2.0,582.0,582.0
0.008,6,10,1972,5,910,2.0,642.0,642.0,5,1062,2.0,794.0,794.0
0.005,17,2,170,1,65,0.0,37.0,37.0,1,105,0.0,77.0,77.0
0.005,6,10,2000,5,927,1.0,659.0,659.0,5,1073,1.0,805.0,805.0
0.084,6,10,1506,5,395,17.0,127.0,127.0,5,1111,18.0,843.0,843.0
0.013,6,10,1983,5,910,3.0,642.0,642.0,5,1073,3.0,805.0,805.0
0.11,6,10,1506,5,395,16.0,127.0,127.0,5,1111,23.0,843.0,843.0
40.056,17,10,676,5,460,10013.0,104.0,64.0,5,216,10013.0,20.0,15.0
15.183,17,20,12168,10,8340,1683.0,1350.0,806.0,10,3828,1683.0,1350.0,354.0
0.004,17,2,148,1,60,0.0,32.0,32.0,1,88,0.0,60.0,60.0
0.011,6,10,1989,5,910,2.0,642.0,642.0,5,1079,2.0,811.0,811.0
0.015,6,10,1972,5,910,3.0,642.0,642.0,5,1062,3.0,794.0,794.0
0.117,6,10,1506,5,395,27.0,127.0,127.0,5,1111,24.0,843.0,843.0
0.005,6,10,1689,5,839,1.0,571.0,571.0,5,850,1.0,582.0,582.0
0.005,6,13,3690,7,452,0.0,80.0,80.0,6,3238,1.0,1470.0,1459.0
0.004,6,10,1989,5,927,1.0,659.0,659.0,5,1062,1.0,794.0,794.0
0.084,6,10,1506,5,395,17.0,127.0,127.0,5,1111,20.0,843.0,843.0
0.005,17,2,164,1,74,0.0,46.0,46.0,1,90,0.0,62.0,62.0
0.005,6,10,1779,5,928,1.0,660.0,660.0,5,851,1.0,583.0,583.0
0.005,6,10,2006,5,927,1.0,659.0,659.0,5,1079,1.0,811.0,811.0
0.006,17,2,194,1,59,0.0,31.0,31.0,1,135,0.0,107.0,107.0
0.01,6,10,1989,5,910,2.0,642.0,642.0,5,1079,2.0,811.0,811.0
0.005,6,10,2000,5,927,1.0,659.0,659.0,5,1073,1.0,805.0,805.0
0.016,17,2,180,1,66,0.0,38.0,38.0,1,114,0.0,86.0,86.0
0.006,6,10,1547,5,764,1.0,496.0,496.0,5,783,1.0,515.0,515.0
0.005,6,13,3747,7,509,0.0,137.0,137.0,6,3238,0.0,1470.0,1459.0
0.018,6,10,1972,5,910,4.0,642.0,642.0,5,1062,4.0,794.0,794.0
0.003,17,2,142,1,63,0.0,35.0,35.0,1,79,0.0,51.0,51.0
0.009,6,10,1983,5,910,2.0,642.0,642.0,5,1073,2.0,805.0,805.0
0.006,6,10,1547,5,764,1.0,496.0,496.0,5,783,1.0,515.0,515.0
0.005,17,2,144,1,64,0.0,36.0,36.0,1,80,0.0,52.0,52.0
240.027,6,9,787,5,488,60006.0,232.0,232.0,4,299,80008.0,83.0,83.0
0.063,6,10,1506,5,395,14.0,127.0,127.0,5,1111,14.0,843.0,843.0
40.056,17,10,676,5,460,10012.0,104.0,64.0,5,216,10013.0,20.0,15.0
0.014,6,10,1989,5,910,3.0,642.0,642.0,5,1079,3.0,811.0,811.0
0.005,6,10,2006,5,927,1.0,659.0,659.0,5,1079,1.0,811.0,811.0
0.006,6,10,1547,5,764,1.0,496.0,496.0,5,783,1.0,515.0,515.0
0.096,6,10,1506,5,395,22.0,127.0,127.0,5,1111,19.0,843.0,843.0
0.012,6,10,1983,5,910,3.0,642.0,642.0,5,1073,2.0,805.0,805.0
0.007,6,13,3690,7,452,1.0,80.0,80.0,6,3238,1.0,1470.0,1459.0
40.056,17,10,676,5,460,10013.0,104.0,64.0,5,216,10013.0,20.0,15.0
0.001,17,2,136,1,60,0.0,32.0,32.0,1,76,0.0,48.0,48.0
0.005,6,10,1774,5,923,1.0,655.0,655.0,5,851,1.0,583.0,583.0
0.005,6,10,2006,5,927,1.0,659.0,659.0,5,1079,1.0,811.0,811.0
0.005,6,10,2000,5,927,1.0,659.0,659.0,5,1073,1.0,805.0,805.0
0.005,6,10,2006,5,927,1.0,659.0,659.0,5,1079,1.0,811.0,811.0
0.131,6,10,1506,5,395,28.0,127.0,127.0,5,1111,26.0,843.0,843.0
40.069,17,10,676,5,460,10015.0,104.0,64.0,5,216,10016.0,20.0,15.0
0.005,6,10,2000,5,927,1.0,659.0,659.0,5,1073,1.0,805.0,805.0
0.144,6,10,1506,5,395,31.0,127.0,127.0,5,1111,33.0,843.0,843.0
0.01,6,10,1762,5,911,2.0,643.0,643.0,5,851,2.0,583.0,583.0
0.021,6,10,1990,5,911,5.0,643.0,643.0,5,1079,5.0,811.0,811.0
0.005,6,10,2006,5,927,1.0,659.0,659.0,5,1079,1.0,811.0,811.0
300.325,6,16,2170,9,684,37519.0,146.0,146.0,7,1486,50026.0,419.0,398.0
0.005,6,10,1689,5,839,1.0,571.0,571.0,5,850,1.0,582.0,582.0
0.004,17,2,136,1,60,0.0,32.0,32.0,1,76,0.0,48.0,48.0
0.034,17,2,152,1,76,0.0,48.0,48.0,1,76,0.0,48.0,48.0
0.183,6,10,1506,5,395,24.0,127.0,127.0,5,1111,43.0,843.0,843.0
0.024,6,10,1990,5,911,6.0,643.0,643.0,5,1079,6.0,811.0,811.0
0.005,6,10,2007,5,928,1.0,660.0,660.0,5,1079,1.0,811.0,811.0
0.005,6,10,1774,5,923,1.0,655.0,655.0,5,851,1.0,583.0,583.0
0.001,17,2,180,1,66,0.0,38.0,38.0,1,114,0.0,86.0,86.0
0.088,6,10,1506,5,395,21.0,127.0,127.0,5,1111,16.0,843.0,843.0
0.021,6,10,1972,5,910,5.0,642.0,642.0,5,1062,5.0,794.0,794.0
40.057,17,10,676,5,460,10012.0,104.0,64.0,5,216,10013.0,20.0,15.0
0.013,17,2,230,1,68,0.0,40.0,40.0,1,162,0.0,134.0,134.0
0.037,17,2,148,1,60,0.0,32.0,32.0,1,88,0.0,60.0,60.0
0.004,17,2,144,1,64,0.0,36.0,36.0,1,80,0.0,52.0,52.0
0.004,17,4,284,2,120,0.0,32.0,32.0,2,164,1.0,60.0,54.0
310.064,17,20,1124,10,716,34438.0,48.0,43.0,10,408,34440.0,20.0,12.0
0.069,17,8,3613,4,1874,23.0,1350.0,440.0,4,1739,11.0,1350.0,406.0
0.005,6,10,2007,5,928,1.0,660.0,660.0,5,1079,1.0,811.0,811.0
0.005,6,10,1989,5,927,1.0,659.0,659.0,5,1062,1.0,794.0,794.0
0.008,6,10,1547,5,764,1.0,496.0,496.0,5,783,1.0,515.0,515.0
40.057,17,10,676,5,460,10013.0,104.0,64.0,5,216,10012.0,20.0,15.0
0.082,17,4,284,2,120,1.0,32.0,32.0,2,164,26.0,60.0,54.0
0.006,17,2,230,1,68,0.0,40.0,40.0,1,162,0.0,134.0,134.0
0.005,6,10,2000,5,927,1.0,659.0,659.0,5,1073,1.0,805.0,805.0
0.003,17,2,152,1,76,0.0,48.0,48.0,1,76,0.0,48.0,48.0
0.008,17,2,179,1,71,0.0,43.0,43.0,1,108,0.0,80.0,80.0
0.104,6,10,1506,5,395,22.0,127.0,127.0,5,1111,22.0,843.0,843.0
0.005,6,10,1774,5,923,1.0,655.0,655.0,5,851,1.0,583.0,583.0
0.006,6,12,1698,6,863,1.0,327.0,271.0,6,835,1.0,515.0,515.0
0.006,6,10,1779,5,928,1.0,660.0,660.0,5,851,1.0,583.0,583.0
0.004,6,10,1774,5,923,1.0,655.0,655.0,5,851,1.0,583.0,583.0
0.13,6,10,1506,5,395,30.0,127.0,127.0,5,1111,28.0,843.0,843.0
300.266,6,27,8059,15,1482,21447.0,384.0,173.0,12,6577,21841.0,1402.0,849.0
1.602,6,39,9527,20,2657,84.0,777.0,456.0,19,6870,82.0,2720.0,435.0
0.086,6,10,1506,5,395,20.0,127.0,127.0,5,1111,19.0,843.0,843.0
0.004,6,10,1989,5,927,1.0,659.0,659.0,5,1062,1.0,794.0,794.0
0.011,6,10,1972,5,910,2.0,642.0,642.0,5,1062,2.0,794.0,794.0
240.011,6,9,787,5,488,60002.0,232.0,232.0,4,299,80003.0,83.0,83.0
0.006,6,10,1854,5,889,1.0,621.0,621.0,5,965,1.0,697.0,697.0
0.005,6,10,2007,5,928,1.0,660.0,660.0,5,1079,1.0,811.0,811.0
240.012,6,9,787,5,488,60003.0,232.0,232.0,4,299,80003.0,83.0,83.0
0.059,6,10,1972,5,910,14.0,642.0,642.0,5,1062,14.0,794.0,794.0
0.017,6,10,1983,5,910,4.0,642.0,642.0,5,1073,4.0,805.0,805.0
0.006,6,10,1547,5,764,1.0,496.0,496.0,5,783,1.0,515.0,515.0
0.006,6,10,1689,5,839,1.0,571.0,571.0,5,850,1.0,582.0,582.0
0.067,6,10,1506,5,395,14.0,127.0,127.0,5,1111,15.0,843.0,843.0
0.134,17,2,80,1,32,0.0,4.0,4.0,1,48,0.0,20.0,20.0
0.005,17,2,214,1,75,0.0,47.0,47.0,1,139,0.0,111.0,111.0
0.005,6,10,2006,5,927,1.0,659.0,659.0,5,1079,1.0,811.0,811.0
0.081,6,10,1506,5,395,17.0,127.0,127.0,5,1111,17.0,843.0,843.0
0.009,6,10,1983,5,910,2.0,642.0,642.0,5,1073,2.0,805.0,805.0
2.577,6,25,6041,14,2100,198.0,517.0,303.0,11,3941,246.0,1360.0,697.0
0.007,6,10,2006,5,927,1.0,659.0,659.0,5,1079,1.0,811.0,811.0
0.104,6,10,1506,5,395,24.0,127.0,127.0,5,1111,24.0,843.0,843.0
0.087,6,10,1506,5,395,18.0,127.0,127.0,5,1111,18.0,843.0,843.0
0.771,6,10,2009,6,1655,154.0,1403.0,1403.0,4,354,178.0,182.0,182.0
0.009,6,10,1989,5,910,2.0,642.0,642.0,5,1079,2.0,811.0,811.0
0.084,6,10,1506,5,395,18.0,127.0,127.0,5,1111,16.0,843.0,843.0
181.402,6,58,19491,33,4811,5668.0,1055.0,237.0,25,14680,7558.0,2804.0,892.0
0.006,6,10,1643,5,860,1.0,592.0,592.0,5,783,1.0,515.0,515.0
0.01,6,10,1983,5,910,2.0,642.0,642.0,5,1073,2.0,805.0,805.0
0.006,6,10,1854,5,889,1.0,621.0,621.0,5,965,1.0,697.0,697.0
0.005,17,2,230,1,68,0.0,40.0,40.0,1,162,0.0,134.0,134.0
0.04,17,2,170,1,65,0.0,37.0,37.0,1,105,0.0,77.0,77.0
0.015,6,10,1631,5,848,3.0,580.0,580.0,5,783,3.0,515.0,515.0
0.004,6,10,1702,5,863,1.0,595.0,595.0,5,839,1.0,571.0,571.0
0.022,6,14,3787,7,497,3.0,125.0,125.0,7,3290,3.0,1448.0,972.0
0.013,6,10,1972,5,910,3.0,642.0,642.0,5,1062,3.0,794.0,794.0
176.075,17,82,11719,41,2761,4401.0,44.0,39.0,41,8958,4401.0,239.0,190.0
310.22,17,19,1084,10,716,34453.0,48.0,43.0,9,368,38761.0,20.0,12.0
0.006,6,10,1547,5,764,1.0,496.0,496.0,5,783,1.0,515.0,515.0
0.011,17,2,212,1,74,0.0,46.0,46.0,1,138,0.0,110.0,110.0
0.003,17,2,162,1,65,0.0,37.0,37.0,1,97,0.0,69.0,69.0
0.007,6,10,1989,5,910,1.0,642.0,642.0,5,1079,1.0,811.0,811.0
506.201,6,47,19464,25,3698,21091.0,663.0,398.0,22,15766,21245.0,1402.0,974.0
0.038,17,2,170,1,65,0.0,37.0,37.0,1,105,0.0,77.0,77.0
0.076,17,2,136,1,60,0.0,32.0,32.0,1,76,0.0,48.0,48.0
0.09,6,10,1506,5,395,19.0,127.0,127.0,5,1111,19.0,843.0,843.0
0.005,6,14,3736,7,446,0.0,74.0,74.0,7,3290,0.0,1448.0,972.0
0.015,6,10,1983,5,910,3.0,642.0,642.0,5,1073,3.0,805.0,805.0
0.015,17,2,198,1,91,0.0,63.0,63.0,1,107,0.0,79.0,79.0
0.001,17,2,180,1,66,0.0,38.0,38.0,1,114,0.0,86.0,86.0
0.019,6,10,1989,5,910,4.0,642.0,642.0,5,1079,4.0,811.0,811.0
0.005,6,10,2007,5,928,1.0,660.0,660.0,5,1079,1.0,811.0,811.0
0.005,6,10,2007,5,928,1.0,660.0,660.0,5,1079,1.0,811.0,811.0
0.091,6,10,1506,5,395,21.0,127.0,127.0,5,1111,21.0,843.0,843.0
0.005,6,10,1989,5,927,1.0,659.0,659.0,5,1062,1.0,794.0,794.0
0.107,6,10,1506,5,395,23.0,127.0,127.0,5,1111,25.0,843.0,843.0
0.086,6,10,1506,5,395,19.0,127.0,127.0,5,1111,16.0,843.0,843.0
0.018,6,10,1990,5,911,4.0,643.0,643.0,5,1079,4.0,811.0,811.0
0.016,6,10,1972,5,910,4.0,642.0,642.0,5,1062,3.0,794.0,794.0
240.129,6,32,9201,16,6821,16008.0,1892.0,665.0,16,2380,16008.0,580.0,192.0
0.004,17,4,284,2,120,0.0,32.0,32.0,2,164,0.0,60.0,54.0
1789.213,6,65,7413,43,4537,42600.0,1402.0,104.0,22,2876,85192.0,1112.0,82.0
0.006,6,10,1547,5,764,1.0,496.0,496.0,5,783,1.0,515.0,515.0
281.284,6,23,6075,10,1186,31253.0,267.0,156.0,13,4889,23439.0,1400.0,873.0
0.004,6,10,2007,5,928,1.0,660.0,660.0,5,1079,1.0,811.0,811.0
0.005,6,10,2006,5,927,1.0,659.0,659.0,5,1079,1.0,811.0,811.0
0.005,6,10,2006,5,927,1.0,659.0,659.0,5,1079,1.0,811.0,811.0
0.011,6,13,3735,7,497,1.0,125.0,125.0,6,3238,2.0,1470.0,1459.0
0.011,6,10,1989,5,910,2.0,642.0,642.0,5,1079,2.0,811.0,811.0
295.42,6,320,344951,124,17993,2401.0,2736.0,824.0,196,326958,1514.0,3036.0,1740.0
0.008,6,10,1989,5,910,2.0,642.0,642.0,5,1079,2.0,811.0,811.0
1772.536,6,108,6426,60,3525,30042.0,27.0,27.0,48,2901,37712.0,27.0,27.0
0.015,6,10,1677,5,827,3.0,559.0,559.0,5,850,3.0,582.0,582.0
0.103,6,10,1506,5,395,24.0,127.0,127.0,5,1111,22.0,843.0,843.0
0.022,6,10,1990,5,911,5.0,643.0,643.0,5,1079,5.0,811.0,811.0
1741.948,6,312,98277,192,86746,9120.0,1402.0,673.0,120,11531,14637.0,452.0,70.0
0.005,17,2,140,1,62,0.0,34.0,34.0,1,78,0.0,50.0,50.0
0.007,6,10,1702,5,863,1.0,595.0,595.0,5,839,1.0,571.0,571.0
0.012,6,10,1990,5,911,3.0,643.0,643.0,5,1079,3.0,811.0,811.0
0.009,6,10,1989,5,910,2.0,642.0,642.0,5,1079,2.0,811.0,811.0
0.014,6,13,3735,7,497,2.0,125.0,125.0,6,3238,2.0,1470.0,1459.0
0.006,6,10,1689,5,839,1.0,571.0,571.0,5,850,1.0,582.0,582.0
0.008,6,10,1990,5,911,2.0,643.0,643.0,5,1079,2.0,811.0,811.0
0.013,6,10,1972,5,910,3.0,642.0,642.0,5,1062,3.0,794.0,794.0
0.005,6,10,1689,5,839,1.0,571.0,571.0,5,850,1.0,582.0,582.0
0.008,6,10,1990,5,911,2.0,643.0,643.0,5,1079,2.0,811.0,811.0
0.004,17,2,148,1,60,0.0,32.0,32.0,1,88,0.0,60.0,60.0
0.005,6,10,2007,5,928,1.0,660.0,660.0,5,1079,1.0,811.0,811.0
0.011,6,12,1926,6,1189,2.0,659.0,434.0,6,737,2.0,417.0,417.0
0.017,6,10,1983,5,910,4.0,642.0,642.0,5,1073,4.0,805.0,805.0
0.007,6,10,1689,5,839,1.0,571.0,571.0,5,850,1.0,582.0,582.0
0.109,6,10,1506,5,395,23.0,127.0,127.0,5,1111,24.0,843.0,843.0
0.005,17,2,164,1,74,0.0,46.0,46.0,1,90,0.0,62.0,62.0
0.004,17,2,186,1,61,0.0,33.0,33.0,1,125,0.0,97.0,97.0
0.003,17,2,136,1,60,0.0,32.0,32.0,1,76,0.0,48.0,48.0
0.005,6,10,1779,5,928,1.0,660.0,660.0,5,851,1.0,583.0,583.0
0.004,6,10,2000,5,927,1.0,659.0,659.0,5,1073,1.0,805.0,805.0
0.22,6,16,2778,8,1396,31.0,533.0,324.0,8,1382,20.0,529.0,239.0
0.067,17,8,3613,4,1874,22.0,1350.0,440.0,4,1739,11.0,1350.0,406.0
0.013,6,10,1762,5,911,3.0,643.0,643.0,5,851,3.0,583.0,583.0
0.005,6,10,1547,5,764,1.0,496.0,496.0,5,783,1.0,515.0,515.0
176.482,17,82,11565,41,2722,4411.0,44.0,38.0,41,8843,4412.0,260.0,187.0
0.001,17,2,179,1,62,0.0,34.0,34.0,1,117,0.0,89.0,89.0
0.166,17,2,152,1,76,0.0,48.0,48.0,1,76,0.0,48.0,48.0
0.018,6,10,1990,5,911,4.0,643.0,643.0,5,1079,4.0,811.0,811.0
240.096,6,16,4482,9,963,30012.0,238.0,166.0,7,3519,40015.0,1402.0,786.0
0.068,6,10,1506,5,395,16.0,127.0,127.0,5,1111,15.0,843.0,843.0
0.004,6,10,1702,5,863,1.0,595.0,595.0,5,839,1.0,571.0,571.0
0.006,6,10,1547,5,764,1.0,496.0,496.0,5,783,1.0,515.0,515.0
0.004,6,10,2007,5,928,1.0,660.0,660.0,5,1079,1.0,811.0,811.0
0.009,6,10,2000,5,927,2.0,659.0,659.0,5,1073,2.0,805.0,805.0
57.121,6,36,9704,18,4186,522.0,1753.0,858.0,18,5518,3350.0,2667.0,435.0
0.14,6,10,1506,5,395,32.0,127.0,127.0,5,1111,32.0,843.0,843.0
0.004,6,10,1774,5,923,1.0,655.0,655.0,5,851,1.0,583.0,583.0
0.006,6,10,1989,5,927,1.0,659.0,659.0,5,1062,1.0,794.0,794.0
0.013,6,10,1972,5,910,3.0,642.0,642.0,5,1062,3.0,794.0,794.0
0.004,6,10,2006,5,927,1.0,659.0,659.0,5,1079,1.0,811.0,811.0
0.014,6,10,1990,5,911,3.0,643.0,643.0,5,1079,3.0,811.0,811.0
0.005,6,10,2000,5,927,1.0,659.0,659.0,5,1073,1.0,805.0,805.0
0.078,6,44,13985,25,2555,3.0,517.0,139.0,19,11430,4.0,1402.0,745.0
0.004,6,10,2000,5,927,1.0,659.0,659.0,5,1073,1.0,805.0,805.0
0.098,6,10,1506,5,395,17.0,127.0,127.0,5,1111,22.0,843.0,843.0
173.069,17,90,13059,45,3026,3933.0,44.0,39.0,45,10033,3933.0,239.0,194.0
0.087,6,10,1506,5,395,18.0,127.0,127.0,5,1111,16.0,843.0,843.0
0.068,6,10,1506,5,395,14.0,127.0,127.0,5,1111,14.0,843.0,843.0
0.006,6,10,2006,5,927,1.0,659.0,659.0,5,1079,1.0,811.0,811.0
0.776,6,25,5459,12,1557,61.0,325.0,152.0,13,3902,55.0,1414.0,563.0
0.002,17,2,180,1,66,0.0,38.0,38.0,1,114,0.0,86.0,86.0
15.08,17,16,8488,8,6223,2150.0,1350.0,749.0,8,2265,2150.0,1350.0,255.0
0.005,6,10,1989,5,927,1.0,659.0,659.0,5,1062,1.0,794.0,794.0
11.118,17,28,4421,14,1993,843.0,268.0,114.0,14,2428,843.0,587.0,145.0
0.096,6,10,1506,5,395,18.0,127.0,127.0,5,1111,22.0,843.0,843.0
0.003,17,2,142,1,63,0.0,35.0,35.0,1,79,0.0,51.0,51.0
0.111,6,10,1506,5,395,22.0,127.0,127.0,5,1111,23.0,843.0,843.0
0.015,6,10,1989,5,910,3.0,642.0,642.0,5,1079,3.0,811.0,811.0
0.01,6,10,1989,5,910,2.0,642.0,642.0,5,1079,2.0,811.0,811.0
0.014,6,10,1990,5,911,3.0,643.0,643.0,5,1079,3.0,811.0,811.0
41.447,17,26,14947,14,12082,3186.0,1350.0,835.0,12,2865,3765.0,1350.0,210.0
0.006,6,10,1547,5,764,1.0,496.0,496.0,5,783,1.0,515.0,515.0
0.081,6,10,1506,5,395,17.0,127.0,127.0,5,1111,17.0,843.0,843.0
0.004,17,2,136,1,60,0.0,32.0,32.0,1,76,0.0,48.0,48.0
0.004,17,4,284,2,120,0.0,32.0,32.0,2,164,0.0,60.0,54.0
0.004,17,2,148,1,60,0.0,32.0,32.0,1,88,0.0,60.0,60.0
0.005,17,2,170,1,65,0.0,37.0,37.0,1,105,0.0,77.0,77.0
0.072,17,2,170,1,65,0.0,37.0,37.0,1,105,0.0,77.0,77.0
40.055,17,10,676,5,460,10013.0,104.0,64.0,5,216,10013.0,20.0,15.0
0.009,6,10,1643,5,860,2.0,592.0,592.0,5,783,2.0,515.0,515.0
309.792,17,20,1124,10,716,34407.0,48.0,43.0,10,408,34407.0,20.0,12.0
0.01,6,10,1990,5,911,2.0,643.0,643.0,5,1079,2.0,811.0,811.0
0.122,6,10,1506,5,395,28.0,127.0,127.0,5,1111,28.0,843.0,843.0
0.009,6,10,1989,5,910,2.0,642.0,642.0,5,1079,2.0,811.0,811.0
0.011,6,10,1677,5,827,2.0,559.0,559.0,5,850,2.0,582.0,582.0
11.174,17,28,4422,14,1994,847.0,269.0,114.0,14,2428,846.0,587.0,145.0
0.015,6,10,1677,5,827,3.0,559.0,559.0,5,850,3.0,582.0,582.0
0.006,6,10,1854,5,889,1.0,621.0,621.0,5,965,1.0,697.0,697.0
0.006,6,10,2006,5,927,1.0,659.0,659.0,5,1079,1.0,811.0,811.0
0.007,6,10,2007,5,928,1.0,660.0,660.0,5,1079,1.0,811.0,811.0
0.005,6,10,1989,5,927,1.0,659.0,659.0,5,1062,1.0,794.0,794.0
15.072,17,15,9239,8,6902,2149.0,1350.0,834.0,7,2337,2507.0,1350.0,305.0
0.005,6,13,3747,7,509,0.0,137.0,137.0,6,3238,1.0,1470.0,1459.0
0.005,6,10,2006,5,927,1.0,659.0,659.0,5,1079,1.0,811.0,811.0
0.006,6,10,1989,5,927,1.0,659.0,659.0,5,1062,1.0,794.0,794.0
0.005,6,10,2007,5,928,1.0,660.0,660.0,5,1079,1.0,811.0,811.0
0.009,6,10,1762,5,911,2.0,643.0,643.0,5,851,2.0,583.0,583.0
0.011,6,10,1972,5,910,2.0,642.0,642.0,5,1062,2.0,794.0,794.0
0.005,6,10,1779,5,928,1.0,660.0,660.0,5,851,1.0,583.0,583.0
0.04,17,4,284,2,120,0.0,32.0,32.0,2,164,36.0,60.0,54.0
0.009,6,10,1983,5,910,2.0,642.0,642.0,5,1073,2.0,805.0,805.0
0.144,6,10,1506,5,395,33.0,127.0,127.0,5,1111,34.0,843.0,843.0
0.069,6,10,1506,5,395,14.0,127.0,127.0,5,1111,16.0,843.0,843.0
0.07,6,10,1506,5,395,16.0,127.0,127.0,5,1111,16.0,843.0,843.0
0.006,6,10,1689,5,839,1.0,571.0,571.0,5,850,1.0,582.0,582.0
0.014,6,10,1983,5,910,3.0,642.0,642.0,5,1073,3.0,805.0,805.0
0.005,6,13,3747,7,509,0.0,137.0,137.0,6,3238,1.0,1470.0,1459.0
0.017,6,10,1677,5,827,4.0,559.0,559.0,5,850,4.0,582.0,582.0
0.009,6,10,1762,5,911,2.0,643.0,643.0,5,851,2.0,583.0,583.0
0.073,17,4,420,2,122,0.0,33.0,33.0,2,298,34.0,145.0,121.0
0.088,6,10,1506,5,395,19.0,127.0,127.0,5,1111,19.0,843.0,843.0
0.014,6,10,1972,5,910,3.0,642.0,642.0,5,1062,3.0,794.0,794.0
40.066,17,10,676,5,460,10014.0,104.0,64.0,5,216,10015.0,20.0,15.0
0.016,6,10,1989,5,910,3.0,642.0,642.0,5,1079,3.0,811.0,811.0
0.005,6,10,2007,5,928,1.0,660.0,660.0,5,1079,1.0,811.0,811.0
0.069,6,10,1506,5,395,15.0,127.0,127.0,5,1111,14.0,843.0,843.0
315.908,17,20,1124,10,716,35086.0,48.0,43.0,10,408,35086.0,20.0,12.0
0.005,6,10,2006,5,927,1.0,659.0,659.0,5,1079,1.0,811.0,811.0
0.008,6,10,1983,5,910,2.0,642.0,642.0,5,1073,1.0,805.0,805.0
0.166,6,10,1506,5,395,38.0,127.0,127.0,5,1111,36.0,843.0,843.0
0.022,6,10,1989,5,910,5.0,642.0,642.0,5,1079,5.0,811.0,811.0
0.005,17,2,166,1,75,0.0,47.0,47.0,1,91,0.0,63.0,63.0
0.005,6,10,2000,5,927,1.0,659.0,659.0,5,1073,1.0,805.0,805.0
0.005,6,10,1989,5,927,1.0,659.0,659.0,5,1062,1.0,794.0,794.0
240.016,6,9,787,5,488,60004.0,232.0,232.0,4,299,80004.0,83.0,83.0
0.022,6,10,1990,5,911,5.0,643.0,643.0,5,1079,5.0,811.0,811.0
0.038,17,4,284,2,120,0.0,32.0,32.0,2,164,35.0,60.0,54.0
0.093,6,10,1506,5,395,19.0,127.0,127.0,5,1111,19.0,843.0,843.0
0.009,6,10,1972,5,910,2.0,642.0,642.0,5,1062,2.0,794.0,794.0
0.003,17,2,664,1,336,0.0,308.0,308.0,1,328,0.0,300.0,300.0
0.103,6,10,1506,5,395,21.0,127.0,127.0,5,1111,23.0,843.0,843.0
0.006,6,10,2006,5,927,1.0,659.0,659.0,5,1079,1.0,811.0,811.0
11.465,17,28,4395,14,2312,869.0,587.0,137.0,14,2083,869.0,270.0,120.0
0.005,6,10,1989,5,927,1.0,659.0,659.0,5,1062,1.0,794.0,794.0
0.009,6,10,1989,5,910,2.0,642.0,642.0,5,1079,2.0,811.0,811.0
0.012,6,10,1631,5,848,2.0,580.0,580.0,5,783,3.0,515.0,515.0
0.005,6,10,2006,5,927,1.0,659.0,659.0,5,1079,1.0,811.0,811.0
0.01,17,2,138,1,61,0.0,33.0,33.0,1,77,0.0,49.0,49.0
0.005,17,4,284,2,120,0.0,32.0,32.0,2,164,1.0,60.0,54.0
15.158,17,18,10724,9,8280,1884.0,1350.0,892.0,9,2444,1887.0,1350.0,243.0
0.004,17,2,168,1,76,0.0,48.0,48.0,1,92,0.0,64.0,64.0
0.004,17,4,284,2,120,1.0,32.0,32.0,2,164,0.0,60.0,54.0
0.005,6,10,2006,5,927,1.0,659.0,659.0,5,1079,1.0,811.0,811.0
0.005,6,14,3799,7,509,0.0,137.0,137.0,7,3290,0.0,1448.0,972.0
0.01,6,10,1989,5,910,2.0,642.0,642.0,5,1079,2.0,811.0,811.0
0.001,17,2,179,1,62,0.0,34.0,34.0,1,117,0.0,89.0,89.0
0.077,6,10,1506,5,395,18.0,127.0,127.0,5,1111,16.0,843.0,843.0
0.005,6,10,1779,5,928,1.0,660.0,660.0,5,851,1.0,583.0,583.0
15.07,17,15,9239,8,6902,2148.0,1350.0,834.0,7,2337,2506.0,1350.0,305.0
0.018,6,13,3735,7,497,3.0,125.0,125.0,6,3238,3.0,1470.0,1459.0
1786.491,6,151,19402,90,13740,20072.0,302.0,302.0,61,5662,29774.0,83.0,83.0
40.076,17,10,676,5,460,10016.0,104.0,64.0,5,216,10018.0,20.0,15.0
353.542,6,20,2210,6,1308,12003.0,494.0,494.0,14,902,27195.0,83.0,83.0
0.004,6,10,1989,5,927,1.0,659.0,659.0,5,1062,1.0,794.0,794.0
0.004,17,2,148,1,60,0.0,32.0,32.0,1,88,0.0,60.0,60.0
0.013,17,2,152,1,76,0.0,48.0,48.0,1,76,0.0,48.0,48.0
0.042,17,2,152,1,76,0.0,48.0,48.0,1,76,0.0,48.0,48.0
0.008,6,10,1983,5,910,2.0,642.0,642.0,5,1073,1.0,805.0,805.0
0.004,6,10,2006,5,927,1.0,659.0,659.0,5,1079,1.0,811.0,811.0
240.097,6,16,4480,9,963,30012.0,238.0,166.0,7,3517,40015.0,1402.0,786.0
0.004,17,2,136,1,60,0.0,32.0,32.0,1,76,0.0,48.0,48.0
0.006,6,12,1698,6,863,1.0,327.0,271.0,6,835,1.0,515.0,515.0
0.039,17,2,186,1,61,0.0,33.0,33.0,1,125,0.0,97.0,97.0
0.053,17,2,148,1,60,0.0,32.0,32.0,1,88,0.0,60.0,60.0
0.004,17,2,136,1,60,0.0,32.0,32.0,1,76,0.0,48.0,48.0
0.006,6,10,1547,5,764,1.0,496.0,496.0,5,783,1.0,515.0,515.0
0.001,17,2,180,1,66,0.0,38.0,38.0,1,114,0.0,86.0,86.0
0.022,6,10,1972,5,910,5.0,642.0,642.0,5,1062,5.0,794.0,794.0
0.014,6,10,1990,5,911,3.0,643.0,643.0,5,1079,3.0,811.0,811.0
0.004,17,2,136,1,60,0.0,32.0,32.0,1,76,0.0,48.0,48.0
0.006,17,2,164,1,74,0.0,46.0,46.0,1,90,0.0,62.0,62.0
0.009,6,10,1989,5,910,2.0,642.0,642.0,5,1079,2.0,811.0,811.0
0.021,6,10,1631,5,848,5.0,580.0,580.0,5,783,5.0,515.0,515.0
0.011,6,10,1990,5,911,2.0,643.0,643.0,5,1079,2.0,811.0,811.0
0.005,6,10,1854,5,889,1.0,621.0,621.0,5,965,1.0,697.0,697.0
0.004,17,4,284,2,120,0.0,32.0,32.0,2,164,1.0,60.0,54.0
1730.417,6,45,2790,30,1725,59669.0,35.0,35.0,15,1065,123596.0,31.0,31.0
0.0,17,2,166,1,75,0.0,47.0,47.0,1,91,0.0,63.0,63.0
0.005,6,10,1854,5,889,1.0,621.0,621.0,5,965,1.0,697.0,697.0
0.081,6,10,1506,5,395,18.0,127.0,127.0,5,1111,17.0,843.0,843.0
0.005,6,10,1989,5,927,1.0,659.0,659.0,5,1062,1.0,794.0,794.0
0.004,6,10,1989,5,927,1.0,659.0,659.0,5,1062,1.0,794.0,794.0
0.013,6,10,1631,5,848,3.0,580.0,580.0,5,783,3.0,515.0,515.0
0.003,17,2,148,1,60,0.0,32.0,32.0,1,88,0.0,60.0,60.0
0.005,17,2,170,1,65,0.0,37.0,37.0,1,105,0.0,77.0,77.0
0.065,6,10,1506,5,395,15.0,127.0,127.0,5,1111,13.0,843.0,843.0
0.014,6,10,1972,5,910,3.0,642.0,642.0,5,1062,3.0,794.0,794.0
0.142,6,10,1506,5,395,31.0,127.0,127.0,5,1111,32.0,843.0,843.0
0.091,6,10,1506,5,395,19.0,127.0,127.0,5,1111,22.0,843.0,843.0
9.042,17,6,376,5,280,2260.0,28.0,28.0,1,96,0.0,68.0,68.0
15.078,17,17,9213,9,7141,1881.0,1350.0,765.0,8,2072,2149.0,1350.0,231.0
0.102,6,10,1506,5,395,24.0,127.0,127.0,5,1111,25.0,843.0,843.0
308.679,17,20,1124,10,716,34284.0,48.0,43.0,10,408,34283.0,20.0,12.0
0.014,6,10,1983,5,910,3.0,642.0,642.0,5,1073,3.0,805.0,805.0
0.085,6,10,1506,5,395,18.0,127.0,127.0,5,1111,20.0,843.0,843.0
40.071,17,10,676,5,460,10014.0,104.0,64.0,5,216,10016.0,20.0,15.0
0.006,6,10,1547,5,764,1.0,496.0,496.0,5,783,1.0,515.0,515.0
0.021,6,10,1972,5,910,5.0,642.0,642.0,5,1062,5.0,794.0,794.0
0.033,6,10,1972,5,910,8.0,642.0,642.0,5,1062,8.0,794.0,794.0
300.15,6,42,10638,22,5040,14284.0,1360.0,589.0,20,5598,15788.0,2667.0,435.0
0.005,6,14,3736,7,446,0.0,74.0,74.0,7,3290,0.0,1448.0,972.0
0.209,6,10,1506,5,395,44.0,127.0,127.0,5,1111,39.0,843.0,843.0
0.005,6,10,1547,5,764,1.0,496.0,496.0,5,783,1.0,515.0,515.0
0.012,6,10,1972,5,910,2.0,642.0,642.0,5,1062,3.0,794.0,794.0
0.13,6,10,1506,5,395,25.0,127.0,127.0,5,1111,28.0,843.0,843.0
0.001,17,2,180,1,66,0.0,38.0,38.0,1,114,0.0,86.0,86.0
40.074,17,10,676,5,460,10016.0,104.0,64.0,5,216,10017.0,20.0,15.0
0.009,6,12,1926,6,1189,1.0,659.0,434.0,6,737,1.0,417.0,417.0
0.067,6,10,1506,5,395,13.0,127.0,127.0,5,1111,15.0,843.0,843.0
0.02,6,10,1972,5,910,4.0,642.0,642.0,5,1062,5.0,794.0,794.0
40.071,17,10,676,5,460,10015.0,104.0,64.0,5,216,10016.0,20.0,15.0
0.058,17,2,152,1,76,0.0,48.0,48.0,1,76,0.0,48.0,48.0
0.019,6,10,1983,5,910,4.0,642.0,642.0,5,1073,4.0,805.0,805.0
0.079,17,4,284,2,120,76.0,32.0,32.0,2,164,8.0,60.0,54.0
0.005,6,10,2006,5,927,1.0,659.0,659.0,5,1079,1.0,811.0,811.0
352.256,6,20,2210,6,1308,12003.0,494.0,494.0,14,902,27096.0,83.0,83.0
0.009,6,10,1983,5,910,2.0,642.0,642.0,5,1073,2.0,805.0,805.0
0.005,6,10,2006,5,927,1.0,659.0,659.0,5,1079,1.0,811.0,811.0
0.004,17,2,136,1,60,0.0,32.0,32.0,1,76,0.0,48.0,48.0
40.06,17,10,676,5,460,10013.0,104.0,64.0,5,216,10014.0,20.0,15.0
0.012,6,13,3735,7,497,2.0,125.0,125.0,6,3238,2.0,1470.0,1459.0
0.017,6,14,3787,7,497,2.0,125.0,125.0,7,3290,2.0,1448.0,972.0
308.432,17,20,1124,10,716,34255.0,48.0,43.0,10,408,34256.0,20.0,12.0
0.003,17,2,152,1,76,0.0,48.0,48.0,1,76,0.0,48.0,48.0
0.009,17,2,170,1,65,0.0,37.0,37.0,1,105,0.0,77.0,77.0
0.005,6,10,1989,5,927,1.0,659.0,659.0,5,1062,1.0,794.0,794.0
0.006,6,10,1547,5,764,1.0,496.0,496.0,5,783,1.0,515.0,515.0
0.041,17,2,136,1,60,0.0,32.0,32.0,1,76,0.0,48.0,48.0
0.005,6,10,2000,5,927,1.0,659.0,659.0,5,1073,1.0,805.0,805.0
352.249,6,20,2210,6,1308,12003.0,494.0,494.0,14,902,27095.0,83.0,83.0
0.001,17,2,166,1,75,0.0,47.0,47.0,1,91,0.0,63.0,63.0
40.061,17,10,676,5,460,10014.0,104.0,64.0,5,216,10014.0,20.0,15.0
0.004,6,10,2006,5,927,1.0,659.0,659.0,5,1079,1.0,811.0,811.0
0.22,17,15,8529,8,6025,31.0,1350.0,725.0,7,2504,24.0,1350.0,329.0
0.022,6,10,1990,5,911,5.0,643.0,643.0,5,1079,5.0,811.0,811.0
0.01,6,10,1989,5,910,2.0,642.0,642.0,5,1079,2.0,811.0,811.0
0.004,6,10,1702,5,863,0.0,595.0,595.0,5,839,1.0,571.0,571.0
0.009,6,13,3735,7,497,1.0,125.0,125.0,6,3238,1.0,1470.0,1459.0
40.068,17,10,676,5,460,10016.0,104.0,64.0,5,216,10016.0,20.0,15.0
0.005,17,2,170,1,65,0.0,37.0,37.0,1,105,0.0,77.0,77.0
40.081,17,10,676,5,460,10019.0,104.0,64.0,5,216,10019.0,20.0,15.0
0.108,6,10,1506,5,395,25.0,127.0,127.0,5,1111,23.0,843.0,843.0
40.062,17,10,676,5,460,10013.0,104.0,64.0,5,216,10014.0,20.0,15.0
0.073,6,10,1506,5,395,16.0,127.0,127.0,5,1111,16.0,843.0,843.0
0.006,6,12,1698,6,863,1.0,327.0,271.0,6,835,1.0,515.0,515.0
0.073,6,10,1506,5,395,16.0,127.0,127.0,5,1111,15.0,843.0,843.0
40.067,17,10,676,5,460,10015.0,104.0,64.0,5,216,10016.0,20.0,15.0
40.061,17,10,676,5,460,10012.0,104.0,64.0,5,216,10014.0,20.0,15.0
0.029,6,10,1972,5,910,7.0,642.0,642.0,5,1062,7.0,794.0,794.0
0.005,6,10,1547,5,764,1.0,496.0,496.0,5,783,1.0,515.0,515.0
0.001,17,2,136,1,60,0.0,32.0,32.0,1,76,0.0,48.0,48.0
40.068,17,10,676,5,460,10016.0,104.0,64.0,5,216,10016.0,20.0,15.0
0.006,6,10,1547,5,764,1.0,496.0,496.0,5,783,1.0,515.0,515.0
0.009,6,12,1926,6,1189,1.0,659.0,434.0,6,737,1.0,417.0,417.0
0.008,17,2,194,1,59,0.0,31.0,31.0,1,135,0.0,107.0,107.0
0.231,17,44,27914,26,24776,9.0,1350.0,924.0,18,3138,10.0,1350.0,146.0
0.006,6,12,1698,6,863,1.0,327.0,271.0,6,835,1.0,515.0,515.0
0.026,6,10,1990,5,911,6.0,643.0,643.0,5,1079,6.0,811.0,811.0
240.093,6,16,4481,9,963,30011.0,238.0,166.0,7,3518,40015.0,1402.0,786.0
0.081,6,10,1506,5,395,17.0,127.0,127.0,5,1111,19.0,843.0,843.0
0.003,17,2,148,1,60,0.0,32.0,32.0,1,88,0.0,60.0,60.0
0.012,6,10,1631,5,848,2.0,580.0,580.0,5,783,3.0,515.0,515.0
0.068,17,8,3613,4,1874,22.0,1350.0,440.0,4,1739,12.0,1350.0,406.0
308.861,17,20,1124,10,716,34303.0,48.0,43.0,10,408,34303.0,20.0,12.0
0.69,6,23,5112,11,1250,60.0,325.0,133.0,12,3862,53.0,1414.0,563.0
332.487,17,20,1124,10,716,36928.0,48.0,43.0,10,408,36928.0,20.0,12.0
0.22,17,4,580,2,122,148.0,33.0,33.0,2,458,180.0,307.0,201.0
0.009,6,10,1983,5,910,2.0,642.0,642.0,5,1073,2.0,805.0,805.0
0.006,6,10,1689,5,839,1.0,571.0,571.0,5,850,1.0,582.0,582.0
0.122,6,10,1506,5,395,28.0,127.0,127.0,5,1111,28.0,843.0,843.0
0.091,6,10,1506,5,395,20.0,127.0,127.0,5,1111,18.0,843.0,843.0
0.199,6,10,1506,5,395,45.0,127.0,127.0,5,1111,45.0,843.0,843.0
10.8,17,28,4419,14,1994,822.0,269.0,114.0,14,2425,822.0,588.0,145.0
0.009,6,12,1926,6,1189,1.0,659.0,434.0,6,737,1.0,417.0,417.0
0.071,6,10,1506,5,395,17.0,127.0,127.0,5,1111,13.0,843.0,843.0
0.061,6,10,1506,5,395,13.0,127.0,127.0,5,1111,14.0,843.0,843.0
0.005,17,2,230,1,68,0.0,40.0,40.0,1,162,0.0,134.0,134.0
0.007,6,10,1689,5,839,1.0,571.0,571.0,5,850,1.0,582.0,582.0
0.009,6,10,2006,5,927,2.0,659.0,659.0,5,1079,2.0,811.0,811.0
0.1,6,10,1506,5,395,21.0,127.0,127.0,5,1111,21.0,843.0,843.0
0.014,6,10,1989,5,910,3.0,642.0,642.0,5,1079,3.0,811.0,811.0
0.005,6,10,2007,5,928,1.0,660.0,660.0,5,1079,1.0,811.0,811.0
0.004,6,10,1774,5,923,1.0,655.0,655.0,5,851,1.0,583.0,583.0
42.501,6,24,7517,13,1385,3541.0,530.0,277.0,11,6132,4232.0,2720.0,946.0
40.063,17,10,676,5,460,10015.0,104.0,64.0,5,216,10014.0,20.0,15.0
0.118,6,10,1506,5,395,26.0,127.0,127.0,5,1111,23.0,843.0,843.0
0.012,6,10,1762,5,911,3.0,643.0,643.0,5,851,3.0,583.0,583.0
0.011,6,10,1989,5,910,2.0,642.0,642.0,5,1079,2.0,811.0,811.0
0.005,6,10,1989,5,927,1.0,659.0,659.0,5,1062,1.0,794.0,794.0
0.007,17,2,194,1,59,0.0,31.0,31.0,1,135,0.0,107.0,107.0
0.023,6,10,1631,5,848,5.0,580.0,580.0,5,783,5.0,515.0,515.0
40.063,17,10,676,5,460,10012.0,104.0,64.0,5,216,10015.0,20.0,15.0
0.005,6,10,1989,5,927,1.0,659.0,659.0,5,1062,1.0,794.0,794.0
290.885,6,393,349948,189,22718,1547.0,2736.0,920.0,204,327230,1432.0,2916.0,1684.0
0.005,6,10,1989,5,927,1.0,659.0,659.0,5,1062,1.0,794.0,794.0
0.023,6,10,1972,5,910,5.0,642.0,642.0,5,1062,5.0,794.0,794.0
0.007,6,10,1547,5,764,1.0,496.0,496.0,5,783,1.0,515.0,515.0
0.012,6,10,1631,5,848,3.0,580.0,580.0,5,783,3.0,515.0,515.0
0.172,6,10,1506,5,395,31.0,127.0,127.0,5,1111,37.0,843.0,843.0
1787.018,6,150,19350,90,13740,20078.0,302.0,302.0,60,5610,30288.0,83.0,83.0
0.009,6,10,1989,5,910,2.0,642.0,642.0,5,1079,2.0,811.0,811.0
0.008,6,10,1972,5,910,2.0,642.0,642.0,5,1062,2.0,794.0,794.0
240.084,6,16,4481,9,963,30010.0,238.0,166.0,7,3518,40013.0,1402.0,786.0
0.007,6,13,3690,7,452,1.0,80.0,80.0,6,3238,1.0,1470.0,1459.0
0.134,6,10,1506,5,395,31.0,127.0,127.0,5,1111,29.0,843.0,843.0
0.005,6,10,1774,5,923,1.0,655.0,655.0,5,851,1.0,583.0,583.0
0.012,6,10,1990,5,911,3.0,643.0,643.0,5,1079,3.0,811.0,811.0
0.011,6,10,1762,5,911,2.0,643.0,643.0,5,851,2.0,583.0,583.0
0.005,17,2,152,1,68,0.0,40.0,40.0,1,84,0.0,56.0,56.0
0.008,6,10,1983,5,910,2.0,642.0,642.0,5,1073,1.0,805.0,805.0
0.005,6,10,1779,5,928,1.0,660.0,660.0,5,851,1.0,583.0,583.0
0.005,6,14,3742,7,452,0.0,80.0,80.0,7,3290,0.0,1448.0,972.0
0.014,6,10,1989,5,910,3.0,642.0,642.0,5,1079,3.0,811.0,811.0
15.074,17,11,4412,5,2359,3761.0,1350.0,443.0,6,2053,3008.0,1350.0,314.0
0.005,6,10,1989,5,927,1.0,659.0,659.0,5,1062,1.0,794.0,794.0
0.007,6,10,1689,5,839,1.0,571.0,571.0,5,850,1.0,582.0,582.0
0.095,6,10,1506,5,395,22.0,127.0,127.0,5,1111,22.0,843.0,843.0
0.016,6,10,1972,5,910,4.0,642.0,642.0,5,1062,4.0,794.0,794.0
1777.066,17,144,45504,72,22752,25029.0,288.0,288.0,72,22752,25029.0,288.0,288.0
0.113,6,10,1506,5,395,26.0,127.0,127.0,5,1111,26.0,843.0,843.0
0.005,6,10,2006,5,927,1.0,659.0,659.0,5,1079,1.0,811.0,811.0
0.005,6,10,2000,5,927,1.0,659.0,659.0,5,1073,1.0,805.0,805.0
0.006,6,10,1689,5,839,1.0,571.0,571.0,5,850,1.0,582.0,582.0
0.004,17,2,136,1,60,0.0,32.0,32.0,1,76,0.0,48.0,48.0
0.006,17,2,164,1,74,0.0,46.0,46.0,1,90,0.0,62.0,62.0
0.089,6,10,1506,5,395,19.0,127.0,127.0,5,1111,18.0,843.0,843.0
0.015,6,10,1677,5,827,3.0,559.0,559.0,5,850,3.0,582.0,582.0
0.02,6,10,1972,5,910,5.0,642.0,642.0,5,1062,4.0,794.0,794.0
0.01,6,10,1989,5,910,2.0,642.0,642.0,5,1079,2.0,811.0,811.0
0.042,17,2,186,1,61,0.0,33.0,33.0,1,125,0.0,97.0,97.0
0.011,6,12,1926,6,1189,2.0,659.0,434.0,6,737,2.0,417.0,417.0
0.004,6,10,1702,5,863,1.0,595.0,595.0,5,839,0.0,571.0,571.0
0.011,6,10,1972,5,910,2.0,642.0,642.0,5,1062,2.0,794.0,794.0
0.086,6,10,1506,5,395,20.0,127.0,127.0,5,1111,17.0,843.0,843.0
0.011,6,10,1762,5,911,2.0,643.0,643.0,5,851,2.0,583.0,583.0
0.009,6,10,1972,5,910,2.0,642.0,642.0,5,1062,2.0,794.0,794.0
0.005,17,2,148,1,60,0.0,32.0,32.0,1,88,0.0,60.0,60.0
0.205,6,16,2778,8,1396,29.0,533.0,324.0,8,1382,19.0,529.0,239.0
0.012,6,10,1983,5,910,3.0,642.0,642.0,5,1073,3.0,805.0,805.0
1730.378,6,45,2790,30,1725,59668.0,35.0,35.0,15,1065,123591.0,31.0,31.0
0.006,6,10,1854,5,889,1.0,621.0,621.0,5,965,1.0,697.0,697.0
0.07,17,8,3613,4,1874,23.0,1350.0,440.0,4,1739,11.0,1350.0,406.0
0.005,6,10,1779,5,928,1.0,660.0,660.0,5,851,1.0,583.0,583.0
0.004,6,10,2006,5,927,1.0,659.0,659.0,5,1079,1.0,811.0,811.0
0.001,17,2,136,1,60,0.0,32.0,32.0,1,76,0.0,48.0,48.0
0.013,6,10,1989,5,910,3.0,642.0,642.0,5,1079,3.0,811.0,811.0
0.01,6,10,1972,5,910,2.0,642.0,642.0,5,1062,2.0,794.0,794.0
0.005,6,10,2000,5,927,1.0,659.0,659.0,5,1073,1.0,805.0,805.0
0.005,6,10,2006,5,927,1.0,659.0,659.0,5,1079,1.0,811.0,811.0
0.081,6,10,1506,5,395,17.0,127.0,127.0,5,1111,15.0,843.0,843.0
40.061,17,10,676,5,460,10013.0,104.0,64.0,5,216,10014.0,20.0,15.0
368.939,6,22,2313,16,867,24595.0,195.0,195.0,6,1446,4639.0,419.0,398.0
0.012,6,10,1762,5,911,3.0,643.0,643.0,5,851,2.0,583.0,583.0
15.071,17,15,9238,8,6902,2149.0,1350.0,834.0,7,2336,2506.0,1350.0,305.0
0.005,17,4,284,2,120,0.0,32.0,32.0,2,164,0.0,60.0,54.0
0.004,17,2,136,1,60,0.0,32.0,32.0,1,76,0.0,48.0,48.0
0.007,6,10,2007,5,928,1.0,660.0,660.0,5,1079,1.0,811.0,811.0
0.011,6,10,1989,5,910,2.0,642.0,642.0,5,1079,2.0,811.0,811.0
0.007,17,2,179,1,71,0.0,43.0,43.0,1,108,0.0,80.0,80.0
0.004,17,2,148,1,60,0.0,32.0,32.0,1,88,0.0,60.0,60.0
300.101,6,19,4659,11,1102,30009.0,238.0,130.0,8,3557,42871.0,1402.0,786.0
0.005,17,2,164,1,74,0.0,46.0,46.0,1,90,0.0,62.0,62.0
0.095,6,10,1506,5,395,20.0,127.0,127.0,5,1111,20.0,843.0,843.0
166.128,17,82,11751,41,2729,4153.0,44.0,38.0,41,9022,4153.0,261.0,192.0
0.005,6,10,2000,5,927,1.0,659.0,659.0,5,1073,1.0,805.0,805.0
0.008,6,10,1990,5,911,2.0,643.0,643.0,5,1079,1.0,811.0,811.0
0.109,6,10,1506,5,395,24.0,127.0,127.0,5,1111,25.0,843.0,843.0
0.004,6,10,2000,5,927,1.0,659.0,659.0,5,1073,1.0,805.0,805.0
0.005,6,10,1779,5,928,1.0,660.0,660.0,5,851,1.0,583.0,583.0
0.005,17,2,169,1,62,0.0,34.0,34.0,1,107,0.0,79.0,79.0
0.015,6,10,1983,5,910,3.0,642.0,642.0,5,1073,3.0,805.0,805.0
0.005,6,10,2006,5,927,1.0,659.0,659.0,5,1079,1.0,811.0,811.0
0.006,6,10,1774,5,923,1.0,655.0,655.0,5,851,1.0,583.0,583.0
0.013,6,10,1972,5,910,3.0,642.0,642.0,5,1062,3.0,794.0,794.0
0.004,6,10,1702,5,863,1.0,595.0,595.0,5,839,0.0,571.0,571.0
0.101,6,10,1506,5,395,23.0,127.0,127.0,5,1111,21.0,843.0,843.0
0.012,6,10,1972,5,910,3.0,642.0,642.0,5,1062,3.0,794.0,794.0
0.008,6,10,1989,5,910,2.0,642.0,642.0,5,1079,2.0,811.0,811.0
0.006,17,2,180,1,66,0.0,38.0,38.0,1,114,0.0,86.0,86.0
0.164,17,2,152,1,76,0.0,48.0,48.0,1,76,0.0,48.0,48.0
0.015,17,2,179,1,71,0.0,43.0,43.0,1,108,0.0,80.0,80.0
240.083,6,16,4481,9,963,30010.0,238.0,166.0,7,3518,40013.0,1402.0,786.0
0.015,6,10,1972,5,910,3.0,642.0,642.0,5,1062,3.0,794.0,794.0
0.011,6,10,1631,5,848,2.0,580.0,580.0,5,783,2.0,515.0,515.0
0.005,17,2,144,1,64,0.0,36.0,36.0,1,80,0.0,52.0,52.0
0.012,6,10,1989,5,910,3.0,642.0,642.0,5,1079,3.0,811.0,811.0
0.005,6,10,1689,5,839,1.0,571.0,571.0,5,850,1.0,582.0,582.0
0.005,6,10,2007,5,928,1.0,660.0,660.0,5,1079,1.0,811.0,811.0
0.006,6,10,2007,5,928,1.0,660.0,660.0,5,1079,1.0,811.0,811.0
0.013,6,10,1983,5,910,3.0,642.0,642.0,5,1073,3.0,805.0,805.0
0.01,6,10,1762,5,911,2.0,643.0,643.0,5,851,2.0,583.0,583.0
0.004,17,2,208,1,72,0.0,44.0,44.0,1,136,0.0,108.0,108.0
0.017,6,10,1762,5,911,4.0,643.0,643.0,5,851,4.0,583.0,583.0
0.124,6,10,1506,5,395,29.0,127.0,127.0,5,1111,26.0,843.0,843.0
0.14,6,10,1506,5,395,31.0,127.0,127.0,5,1111,33.0,843.0,843.0
0.004,17,2,136,1,60,0.0,32.0,32.0,1,76,0.0,48.0,48.0
0.004,17,4,284,2,120,1.0,32.0,32.0,2,164,0.0,60.0,54.0
0.005,6,10,2006,5,927,1.0,659.0,659.0,5,1079,1.0,811.0,811.0
40.072,17,10,676,5,460,10014.0,104.0,64.0,5,216,10017.0,20.0,15.0
0.005,6,10,1989,5,927,1.0,659.0,659.0,5,1062,1.0,794.0,794.0
0.245,17,40,21531,22,18419,11.0,1350.0,809.0,18,3112,10.0,1350.0,144.0
0.006,6,10,1547,5,764,1.0,496.0,496.0,5,783,1.0,515.0,515.0
0.005,6,10,2006,5,927,1.0,659.0,659.0,5,1079,1.0,811.0,811.0
0.183,6,10,1506,5,395,40.0,127.0,127.0,5,1111,42.0,843.0,843.0
0.005,6,15,3794,8,504,0.0,80.0,80.0,7,3290,0.0,1448.0,972.0
0.006,6,10,1547,5,764,1.0,496.0,496.0,5,783,1.0,515.0,515.0
0.006,17,2,179,1,71,0.0,43.0,43.0,1,108,0.0,80.0,80.0
0.009,6,10,1989,5,910,2.0,642.0,642.0,5,1079,2.0,811.0,811.0
126.343,6,29,15723,13,14889,10506.0,2828.0,2051.0,16,834,8406.0,182.0,182.0
0.005,6,10,1989,5,927,1.0,659.0,659.0,5,1062,1.0,794.0,794.0
0.138,6,10,1506,5,395,24.0,127.0,127.0,5,1111,32.0,843.0,843.0
0.005,17,2,194,1,59,0.0,31.0,31.0,1,135,0.0,107.0,107.0
0.005,6,10,2007,5,928,1.0,660.0,660.0,5,1079,1.0,811.0,811.0
0.006,17,2,179,1,71,0.0,43.0,43.0,1,108,0.0,80.0,80.0
0.018,6,10,1989,5,910,4.0,642.0,642.0,5,1079,4.0,811.0,811.0
0.005,6,10,1989,5,927,1.0,659.0,659.0,5,1062,1.0,794.0,794.0
0.012,6,10,1762,5,911,3.0,643.0,643.0,5,851,2.0,583.0,583.0
0.013,6,10,1983,5,910,3.0,642.0,642.0,5,1073,3.0,805.0,805.0
0.079,6,10,1506,5,395,17.0,127.0,127.0,5,1111,18.0,843.0,843.0
0.041,17,2,152,1,76,0.0,48.0,48.0,1,76,0.0,48.0,48.0
0.076,6,10,1506,5,395,18.0,127.0,127.0,5,1111,18.0,843.0,843.0
0.005,6,10,1643,5,860,1.0,592.0,592.0,5,783,1.0,515.0,515.0
0.014,6,13,3735,7,497,2.0,125.0,125.0,6,3238,2.0,1470.0,1459.0
0.004,17,2,148,1,60,0.0,32.0,32.0,1,88,0.0,60.0,60.0
0.019,6,10,1983,5,910,4.0,642.0,642.0,5,1073,4.0,805.0,805.0
0.007,6,10,2000,5,927,1.0,659.0,659.0,5,1073,1.0,805.0,805.0
0.126,6,10,1506,5,395,26.0,127.0,127.0,5,1111,28.0,843.0,843.0
0.016,6,10,1990,5,911,4.0,643.0,643.0,5,1079,3.0,811.0,811.0
171.054,17,80,11366,40,2665,4385.0,44.0,38.0,40,8701,4385.0,239.0,189.0
0.005,6,10,2007,5,928,1.0,660.0,660.0,5,1079,1.0,811.0,811.0
0.005,6,10,1774,5,923,1.0,655.0,655.0,5,851,1.0,583.0,583.0
300.845,6,40,13484,22,7966,14325.0,2720.0,1007.0,18,5518,510.0,2667.0,435.0
0.152,6,10,1506,5,395,35.0,127.0,127.0,5,1111,25.0,843.0,843.0
0.004,17,4,284,2,120,0.0,32.0,32.0,2,164,0.0,60.0,54.0
0.011,6,10,1762,5,911,2.0,643.0,643.0,5,851,2.0,583.0,583.0
0.005,6,10,1854,5,889,1.0,621.0,621.0,5,965,1.0,697.0,697.0
0.005,6,10,1989,5,927,1.0,659.0,659.0,5,1062,1.0,794.0,794.0
0.004,6,10,2006,5,927,1.0,659.0,659.0,5,1079,1.0,811.0,811.0
0.006,6,10,2007,5,928,1.0,660.0,660.0,5,1079,1.0,811.0,811.0
173.056,17,92,13356,46,3097,3845.0,44.0,39.0,46,10259,3845.0,239.0,195.0
0.063,6,10,1506,5,395,13.0,127.0,127.0,5,1111,15.0,843.0,843.0
0.008,6,10,1990,5,911,2.0,643.0,643.0,5,1079,2.0,811.0,811.0
0.11,6,10,1506,5,395,23.0,127.0,127.0,5,1111,25.0,843.0,843.0
40.054,17,10,676,5,460,10012.0,104.0,64.0,5,216,10012.0,20.0,15.0
0.005,6,13,3747,7,509,0.0,137.0,137.0,6,3238,1.0,1470.0,1459.0
240.087,6,16,4480,9,963,30010.0,238.0,166.0,7,3517,40014.0,1402.0,786.0
0.005,6,10,1989,5,927,1.0,659.0,659.0,5,1062,1.0,794.0,794.0
0.004,6,10,1989,5,927,1.0,659.0,659.0,5,1062,1.0,794.0,794.0
66.475,6,25,10408,11,3909,6647.0,1579.0,835.0,14,6499,5103.0,2111.0,576.0
0.018,6,10,1989,5,910,4.0,642.0,642.0,5,1079,4.0,811.0,811.0
0.005,6,10,2006,5,927,1.0,659.0,659.0,5,1079,1.0,811.0,811.0
0.004,6,10,2006,5,927,1.0,659.0,659.0,5,1079,1.0,811.0,811.0
0.008,6,14,3787,7,497,1.0,125.0,125.0,7,3290,1.0,1448.0,972.0
0.039,17,2,148,1,60,0.0,32.0,32.0,1,88,0.0,60.0,60.0
0.011,6,10,1983,5,910,2.0,642.0,642.0,5,1073,2.0,805.0,805.0
0.003,17,2,136,1,60,0.0,32.0,32.0,1,76,0.0,48.0,48.0
0.005,6,10,1989,5,927,1.0,659.0,659.0,5,1062,1.0,794.0,794.0
0.097,6,10,1506,5,395,20.0,127.0,127.0,5,1111,19.0,843.0,843.0
0.012,6,10,1677,5,827,3.0,559.0,559.0,5,850,2.0,582.0,582.0
0.006,17,2,230,1,68,0.0,40.0,40.0,1,162,0.0,134.0,134.0
0.012,6,10,1983,5,910,2.0,642.0,642.0,5,1073,3.0,805.0,805.0
0.005,6,10,2006,5,927,1.0,659.0,659.0,5,1079,1.0,811.0,811.0
0.006,6,10,1689,5,839,1.0,571.0,571.0,5,850,1.0,582.0,582.0
0.005,6,10,1779,5,928,1.0,660.0,660.0,5,851,1.0,583.0,583.0
0.077,6,10,1506,5,395,15.0,127.0,127.0,5,1111,16.0,843.0,843.0
0.119,6,10,1506,5,395,27.0,127.0,127.0,5,1111,26.0,843.0,843.0
0.005,17,2,169,1,62,0.0,34.0,34.0,1,107,0.0,79.0,79.0
0.001,17,2,180,1,66,0.0,38.0,38.0,1,114,0.0,86.0,86.0
0.093,6,10,1506,5,395,21.0,127.0,127.0,5,1111,19.0,843.0,843.0
15.113,17,17,9573,9,6081,1885.0,1350.0,647.0,8,3492,2154.0,1350.0,408.0
0.075,6,10,1506,5,395,16.0,127.0,127.0,5,1111,16.0,843.0,843.0
0.01,6,10,1989,5,910,2.0,642.0,642.0,5,1079,2.0,811.0,811.0
0.006,6,10,1547,5,764,1.0,496.0,496.0,5,783,1.0,515.0,515.0
0.013,6,10,1983,5,910,3.0,642.0,642.0,5,1073,3.0,805.0,805.0
11.006,17,29,4566,15,2165,777.0,268.0,116.0,14,2401,837.0,588.0,143.0
0.006,6,10,1547,5,764,1.0,496.0,496.0,5,783,1.0,515.0,515.0
0.006,17,2,144,1,64,0.0,36.0,36.0,1,80,0.0,52.0,52.0
0.005,6,10,2006,5,927,1.0,659.0,659.0,5,1079,1.0,811.0,811.0
0.04,17,2,234,1,61,0.0,33.0,33.0,1,173,0.0,145.0,145.0
0.005,6,13,3690,7,452,0.0,80.0,80.0,6,3238,1.0,1470.0,1459.0
0.015,6,13,3735,7,497,2.0,125.0,125.0,6,3238,3.0,1470.0,1459.0
0.005,17,2,144,1,64,0.0,36.0,36.0,1,80,0.0,52.0,52.0
0.006,6,10,1547,5,764,1.0,496.0,496.0,5,783,1.0,515.0,515.0
0.015,6,10,1983,5,910,3.0,642.0,642.0,5,1073,3.0,805.0,805.0
0.005,6,10,2007,5,928,1.0,660.0,660.0,5,1079,1.0,811.0,811.0
0.004,6,10,2007,5,928,1.0,660.0,660.0,5,1079,1.0,811.0,811.0
0.004,6,10,2007,5,928,1.0,660.0,660.0,5,1079,1.0,811.0,811.0
68.271,6,44,17055,22,11148,432.0,2720.0,1462.0,22,5907,3243.0,2667.0,385.0
0.005,6,10,2007,5,928,1.0,660.0,660.0,5,1079,1.0,811.0,811.0
0.072,17,2,184,1,61,0.0,33.0,33.0,1,123,0.0,95.0,95.0
0.006,6,10,1547,5,764,1.0,496.0,496.0,5,783,1.0,515.0,515.0
0.007,6,10,1989,5,910,1.0,642.0,642.0,5,1079,1.0,811.0,811.0
0.013,17,2,152,1,56,0.0,28.0,28.0,1,96,0.0,68.0,68.0
0.005,6,10,2006,5,927,1.0,659.0,659.0,5,1079,1.0,811.0,811.0
0.004,6,10,2007,5,928,1.0,660.0,660.0,5,1079,1.0,811.0,811.0
0.004,17,2,136,1,60,0.0,32.0,32.0,1,76,0.0,48.0,48.0
0.005,6,10,1643,5,860,1.0,592.0,592.0,5,783,1.0,515.0,515.0
0.003,17,2,148,1,60,0.0,32.0,32.0,1,88,0.0,60.0,60.0
0.023,6,10,1989,5,910,5.0,642.0,642.0,5,1079,5.0,811.0,811.0
0.005,6,10,2006,5,927,1.0,659.0,659.0,5,1079,1.0,811.0,811.0
0.012,6,10,1989,5,910,3.0,642.0,642.0,5,1079,2.0,811.0,811.0
0.016,6,10,1990,5,911,4.0,643.0,643.0,5,1079,4.0,811.0,811.0
0.085,6,10,1506,5,395,20.0,127.0,127.0,5,1111,19.0,843.0,843.0
0.005,6,13,3690,7,452,0.0,80.0,80.0,6,3238,1.0,1470.0,1459.0
0.008,6,10,1983,5,910,2.0,642.0,642.0,5,1073,1.0,805.0,805.0
0.073,6,10,1506,5,395,14.0,127.0,127.0,5,1111,17.0,843.0,843.0
0.006,6,10,1547,5,764,1.0,496.0,496.0,5,783,1.0,515.0,515.0
0.039,17,2,186,1,61,0.0,33.0,33.0,1,125,0.0,97.0,97.0
0.042,17,2,152,1,76,0.0,48.0,48.0,1,76,0.0,48.0,48.0
0.003,17,2,148,1,60,0.0,32.0,32.0,1,88,0.0,60.0,60.0
0.131,6,10,1506,5,395,29.0,127.0,127.0,5,1111,31.0,843.0,843.0
0.06,17,2,152,1,76,0.0,48.0,48.0,1,76,0.0,48.0,48.0
0.016,6,10,1677,5,827,4.0,559.0,559.0,5,850,3.0,582.0,582.0
0.017,6,10,1990,5,911,4.0,643.0,643.0,5,1079,4.0,811.0,811.0
0.004,17,4,284,2,120,1.0,32.0,32.0,2,164,1.0,60.0,54.0
0.006,6,10,1547,5,764,1.0,496.0,496.0,5,783,1.0,515.0,515.0
0.121,6,10,1506,5,395,28.0,127.0,127.0,5,1111,28.0,843.0,843.0
0.017,6,10,1989,5,910,4.0,642.0,642.0,5,1079,4.0,811.0,811.0
0.004,6,10,1989,5,927,1.0,659.0,659.0,5,1062,1.0,794.0,794.0
0.237,17,45,26755,25,23405,9.0,1350.0,908.0,20,3350,9.0,1350.0,139.0
0.01,6,10,1972,5,910,2.0,642.0,642.0,5,1062,2.0,794.0,794.0
0.006,6,10,2006,5,927,1.0,659.0,659.0,5,1079,1.0,811.0,811.0
40.039,17,10,676,5,460,10009.0,104.0,64.0,5,216,10009.0,20.0,15.0
0.005,6,13,3747,7,509,0.0,137.0,137.0,6,3238,1.0,1470.0,1459.0
0.001,17,2,180,1,66,0.0,38.0,38.0,1,114,0.0,86.0,86.0
0.008,17,2,194,1,59,0.0,31.0,31.0,1,135,0.0,107.0,107.0
1778.447,17,144,45504,72,22752,25048.0,288.0,288.0,72,22752,25048.0,288.0,288.0
0.101,6,10,1506,5,395,21.0,127.0,127.0,5,1111,24.0,843.0,843.0
0.125,6,10,1506,5,395,27.0,127.0,127.0,5,1111,27.0,843.0,843.0
0.011,6,10,1983,5,910,2.0,642.0,642.0,5,1073,2.0,805.0,805.0
0.083,6,10,1506,5,395,17.0,127.0,127.0,5,1111,19.0,843.0,843.0
0.073,6,10,1506,5,395,17.0,127.0,127.0,5,1111,16.0,843.0,843.0
0.003,17,2,136,1,60,0.0,32.0,32.0,1,76,0.0,48.0,48.0
0.009,6,10,1990,5,911,2.0,643.0,643.0,5,1079,2.0,811.0,811.0
1712.237,6,61,7124,40,4332,43903.0,1625.0,112.0,21,2792,85603.0,1111.0,85.0
0.087,6,10,1506,5,395,18.0,127.0,127.0,5,1111,20.0,843.0,843.0
1741.839,6,294,93693,182,83197,9623.0,1402.0,664.0,112,10496,15692.0,93.0,65.0
308.827,17,20,1124,10,716,34299.0,48.0,43.0,10,408,34299.0,20.0,12.0
0.076,6,10,1506,5,395,15.0,127.0,127.0,5,1111,18.0,843.0,843.0
0.008,6,10,1989,5,910,2.0,642.0,642.0,5,1079,2.0,811.0,811.0
0.144,6,10,1506,5,395,32.0,127.0,127.0,5,1111,35.0,843.0,843.0
0.02,6,10,1990,5,911,4.0,643.0,643.0,5,1079,4.0,811.0,811.0
11.004,17,28,4398,14,2312,837.0,587.0,137.0,14,2086,837.0,269.0,121.0
0.005,6,14,3736,7,446,0.0,74.0,74.0,7,3290,0.0,1448.0,972.0
0.018,6,10,1990,5,911,4.0,643.0,643.0,5,1079,4.0,811.0,811.0
0.005,17,2,255,1,82,0.0,54.0,54.0,1,173,0.0,145.0,145.0
0.039,6,10,1989,5,910,9.0,642.0,642.0,5,1079,9.0,811.0,811.0
0.009,6,10,1677,5,827,2.0,559.0,559.0,5,850,2.0,582.0,582.0
0.001,17,2,136,1,60,0.0,32.0,32.0,1,76,0.0,48.0,48.0
0.005,6,10,2007,5,928,1.0,660.0,660.0,5,1079,1.0,811.0,811.0
0.143,6,10,1506,5,395,33.0,127.0,127.0,5,1111,28.0,843.0,843.0
0.015,6,10,1677,5,827,3.0,559.0,559.0,5,850,3.0,582.0,582.0
0.003,17,2,185,1,73,0.0,45.0,45.0,1,112,0.0,84.0,84.0
0.021,17,2,179,1,71,0.0,43.0,43.0,1,108,0.0,80.0,80.0
0.005,6,10,2006,5,927,1.0,659.0,659.0,5,1079,1.0,811.0,811.0
0.005,6,10,2006,5,927,1.0,659.0,659.0,5,1079,1.0,811.0,811.0
10.773,17,28,4423,14,1994,819.0,269.0,114.0,14,2429,819.0,588.0,145.0
0.005,6,10,1989,5,927,1.0,659.0,659.0,5,1062,1.0,794.0,794.0
0.128,6,10,1506,5,395,27.0,127.0,127.0,5,1111,23.0,843.0,843.0
40.068,17,10,676,5,460,10015.0,104.0,64.0,5,216,10016.0,20.0,15.0
0.004,6,10,1779,5,928,1.0,660.0,660.0,5,851,1.0,583.0,583.0
0.001,17,2,180,1,66,0.0,38.0,38.0,1,114,0.0,86.0,86.0
0.009,6,10,1989,5,910,2.0,642.0,642.0,5,1079,2.0,811.0,811.0
0.011,6,10,1990,5,911,2.0,643.0,643.0,5,1079,2.0,811.0,811.0
240.032,6,9,787,5,488,60008.0,232.0,232.0,4,299,80009.0,83.0,83.0
1.032,6,12,3142,6,2099,155.0,1328.0,923.0,6,1043,155.0,791.0,791.0
0.01,6,10,1989,5,910,2.0,642.0,642.0,5,1079,2.0,811.0,811.0
0.009,6,10,1990,5,911,2.0,643.0,643.0,5,1079,2.0,811.0,811.0
0.206,6,16,2777,8,1395,29.0,533.0,323.0,8,1382,18.0,529.0,239.0
0.118,6,10,1506,5,395,28.0,127.0,127.0,5,1111,25.0,843.0,843.0
10.803,17,26,4102,13,1846,891.0,269.0,114.0,13,2256,891.0,587.0,145.0
0.091,6,10,1506,5,395,20.0,127.0,127.0,5,1111,17.0,843.0,843.0
10.934,17,28,4423,14,1995,832.0,270.0,114.0,14,2428,832.0,587.0,145.0
0.005,17,2,230,1,68,0.0,40.0,40.0,1,162,0.0,134.0,134.0
0.018,6,10,1983,5,910,4.0,642.0,642.0,5,1073,4.0,805.0,805.0
0.079,6,10,1506,5,395,19.0,127.0,127.0,5,1111,18.0,843.0,843.0
5.18,6,24,6519,14,1879,398.0,801.0,282.0,10,4640,575.0,1925.0,824.0
1.089,6,32,13391,18,5892,64.0,2720.0,854.0,14,7499,70.0,2720.0,769.0
0.082,6,10,1506,5,395,17.0,127.0,127.0,5,1111,19.0,843.0,843.0
0.005,6,10,2007,5,928,1.0,660.0,660.0,5,1079,1.0,811.0,811.0
0.007,6,10,2006,5,927,1.0,659.0,659.0,5,1079,1.0,811.0,811.0
241.493,6,347,344974,148,19206,1642.0,2736.0,885.0,199,325768,1219.0,2804.0,1660.0
0.011,6,10,1990,5,911,2.0,643.0,643.0,5,1079,2.0,811.0,811.0
0.094,6,10,1506,5,395,21.0,127.0,127.0,5,1111,20.0,843.0,843.0
0.002,17,2,174,1,72,0.0,44.0,44.0,1,102,0.0,74.0,74.0
0.085,6,10,1506,5,395,19.0,127.0,127.0,5,1111,19.0,843.0,843.0
0.145,6,10,1506,5,395,34.0,127.0,127.0,5,1111,33.0,843.0,843.0
0.011,6,10,1990,5,911,2.0,643.0,643.0,5,1079,2.0,811.0,811.0
0.01,6,10,1989,5,910,2.0,642.0,642.0,5,1079,2.0,811.0,811.0
0.011,6,10,1989,5,910,2.0,642.0,642.0,5,1079,2.0,811.0,811.0
0.082,6,10,1506,5,395,18.0,127.0,127.0,5,1111,19.0,843.0,843.0
0.019,17,2,179,1,71,0.0,43.0,43.0,1,108,0.0,80.0,80.0
0.096,6,10,1506,5,395,23.0,127.0,127.0,5,1111,22.0,843.0,843.0
0.005,17,2,170,1,65,0.0,37.0,37.0,1,105,0.0,77.0,77.0
0.011,6,10,1983,5,910,2.0,642.0,642.0,5,1073,2.0,805.0,805.0
0.008,6,10,1989,5,910,2.0,642.0,642.0,5,1079,1.0,811.0,811.0
0.005,6,10,1989,5,927,1.0,659.0,659.0,5,1062,1.0,794.0,794.0
0.851,6,26,5776,13,1666,62.0,267.0,142.0,13,4110,60.0,1414.0,597.0
0.005,6,13,3747,7,509,0.0,137.0,137.0,6,3238,0.0,1470.0,1459.0
0.087,6,10,1506,5,395,20.0,127.0,127.0,5,1111,17.0,843.0,843.0
0.061,6,10,1506,5,395,14.0,127.0,127.0,5,1111,14.0,843.0,843.0
0.172,6,10,1506,5,395,40.0,127.0,127.0,5,1111,40.0,843.0,843.0
412.772,6,29,4409,12,3102,10912.0,494.0,494.0,17,1307,25797.0,83.0,83.0
0.081,6,10,1506,5,395,18.0,127.0,127.0,5,1111,16.0,843.0,843.0
0.006,6,12,1698,6,863,1.0,327.0,271.0,6,835,1.0,515.0,515.0
0.006,6,10,1547,5,764,1.0,496.0,496.0,5,783,1.0,515.0,515.0
0.081,6,10,1506,5,395,18.0,127.0,127.0,5,1111,18.0,843.0,843.0
394.12,6,30,9987,15,2518,28151.0,663.0,346.0,15,7469,23858.0,1402.0,742.0
0.098,6,10,1506,5,395,22.0,127.0,127.0,5,1111,21.0,843.0,843.0
0.009,6,12,1926,6,1189,1.0,659.0,434.0,6,737,1.0,417.0,417.0
324.081,17,20,1124,10,716,35995.0,48.0,43.0,10,408,35995.0,20.0,12.0
0.131,6,10,1506,5,395,31.0,127.0,127.0,5,1111,29.0,843.0,843.0
0.072,17,4,284,2,120,0.0,32.0,32.0,2,164,68.0,60.0,54.0
0.005,6,13,3690,7,452,0.0,80.0,80.0,6,3238,0.0,1470.0,1459.0
40.059,17,10,676,5,460,10013.0,104.0,64.0,5,216,10013.0,20.0,15.0
0.012,6,10,1983,5,910,3.0,642.0,642.0,5,1073,2.0,805.0,805.0
0.009,6,10,1989,5,910,2.0,642.0,642.0,5,1079,2.0,811.0,811.0
0.011,6,10,1762,5,911,2.0,643.0,643.0,5,851,2.0,583.0,583.0
0.01,6,10,1989,5,910,2.0,642.0,642.0,5,1079,2.0,811.0,811.0
0.004,6,10,1779,5,928,1.0,660.0,660.0,5,851,1.0,583.0,583.0
378.867,6,20,2210,6,1308,12003.0,494.0,494.0,14,902,29143.0,83.0,83.0
0.005,6,10,2007,5,928,1.0,660.0,660.0,5,1079,1.0,811.0,811.0
0.102,6,10,1506,5,395,21.0,127.0,127.0,5,1111,20.0,843.0,843.0
0.078,6,10,1506,5,395,16.0,127.0,127.0,5,1111,17.0,843.0,843.0
0.006,6,10,2007,5,928,1.0,660.0,660.0,5,1079,1.0,811.0,811.0
0.005,6,10,2000,5,927,1.0,659.0,659.0,5,1073,1.0,805.0,805.0
0.005,6,10,1643,5,860,1.0,592.0,592.0,5,783,1.0,515.0,515.0
0.175,17,2,152,1,76,0.0,48.0,48.0,1,76,0.0,48.0,48.0
0.001,17,2,180,1,66,0.0,38.0,38.0,1,114,0.0,86.0,86.0
0.013,6,10,1989,5,910,3.0,642.0,642.0,5,1079,3.0,811.0,811.0
0.014,6,10,1631,5,848,3.0,580.0,580.0,5,783,3.0,515.0,515.0
0.005,6,10,2006,5,927,1.0,659.0,659.0,5,1079,1.0,811.0,811.0
0.012,6,10,1989,5,910,3.0,642.0,642.0,5,1079,2.0,811.0,811.0
15.07,17,15,9239,8,6902,2148.0,1350.0,834.0,7,2337,2506.0,1350.0,305.0
0.118,6,10,1506,5,395,26.0,127.0,127.0,5,1111,26.0,843.0,843.0
0.152,17,4,352,2,130,110.0,37.0,37.0,2,222,149.0,89.0,83.0
30.036,6,36,8190,18,1719,522.0,651.0,322.0,18,6471,1759.0,2720.0,478.0
0.004,6,10,2006,5,927,1.0,659.0,659.0,5,1079,1.0,811.0,811.0
0.195,17,4,352,2,130,145.0,37.0,37.0,2,222,155.0,89.0,83.0
40.057,17,10,676,5,460,10013.0,104.0,64.0,5,216,10013.0,20.0,15.0
0.169,6,10,1506,5,395,34.0,127.0,127.0,5,1111,41.0,843.0,843.0
9.035,17,6,376,5,280,2258.0,28.0,28.0,1,96,0.0,68.0,68.0
0.001,17,2,180,1,66,0.0,38.0,38.0,1,114,0.0,86.0,86.0
0.01,6,10,1983,5,910,2.0,642.0,642.0,5,1073,2.0,805.0,805.0
0.015,6,10,1972,5,910,3.0,642.0,642.0,5,1062,3.0,794.0,794.0
0.008,6,10,1989,5,910,2.0,642.0,642.0,5,1079,1.0,811.0,811.0
0.039,17,4,364,2,160,0.0,52.0,52.0,2,204,0.0,80.0,74.0
0.056,6,10,1506,5,395,11.0,127.0,127.0,5,1111,13.0,843.0,843.0
0.001,17,2,154,1,69,0.0,41.0,41.0,1,85,0.0,57.0,57.0
0.02,6,10,1989,5,910,4.0,642.0,642.0,5,1079,5.0,811.0,811.0
0.037,17,2,170,1,65,0.0,37.0,37.0,1,105,0.0,77.0,77.0
352.948,6,20,2210,6,1308,12004.0,494.0,494.0,14,902,27149.0,83.0,83.0
15.072,17,15,9239,8,6902,2149.0,1350.0,834.0,7,2337,2507.0,1350.0,305.0
366.979,6,21,1793,16,1030,24465.0,190.0,190.0,5,763,60016.0,462.0,247.0
0.084,6,10,1506,5,395,18.0,127.0,127.0,5,1111,17.0,843.0,843.0
0.019,6,10,1989,5,910,4.0,642.0,642.0,5,1079,4.0,811.0,811.0
0.004,6,10,1779,5,928,1.0,660.0,660.0,5,851,1.0,583.0,583.0
0.013,6,10,1990,5,911,3.0,643.0,643.0,5,1079,3.0,811.0,811.0
0.003,17,2,152,1,76,0.0,48.0,48.0,1,76,0.0,48.0,48.0
0.004,17,2,213,1,69,0.0,41.0,41.0,1,144,0.0,116.0,116.0
0.013,6,10,1990,5,911,3.0,643.0,643.0,5,1079,3.0,811.0,811.0
15.099,17,16,10616,9,8280,1881.0,1350.0,892.0,7,2336,2510.0,1350.0,305.0
0.005,6,10,1689,5,839,1.0,571.0,571.0,5,850,1.0,582.0,582.0
0.072,17,2,170,1,65,0.0,37.0,37.0,1,105,0.0,77.0,77.0
0.075,6,10,1506,5,395,17.0,127.0,127.0,5,1111,14.0,843.0,843.0
0.005,6,10,2006,5,927,1.0,659.0,659.0,5,1079,1.0,811.0,811.0
0.11,6,10,1506,5,395,26.0,127.0,127.0,5,1111,25.0,843.0,843.0
0.005,6,10,2000,5,927,1.0,659.0,659.0,5,1073,1.0,805.0,805.0
0.005,6,10,2000,5,927,1.0,659.0,659.0,5,1073,1.0,805.0,805.0
0.111,6,10,1506,5,395,24.0,127.0,127.0,5,1111,22.0,843.0,843.0
0.021,6,10,1990,5,911,5.0,643.0,643.0,5,1079,5.0,811.0,811.0
15.122,17,19,12122,10,8344,1677.0,1350.0,806.0,9,3778,1886.0,1350.0,391.0
0.014,6,10,1762,5,911,3.0,643.0,643.0,5,851,3.0,583.0,583.0
0.004,6,10,1989,5,927,1.0,659.0,659.0,5,1062,1.0,794.0,794.0
0.094,6,10,1506,5,395,17.0,127.0,127.0,5,1111,20.0,843.0,843.0
240.017,6,9,787,5,488,60004.0,232.0,232.0,4,299,80005.0,83.0,83.0
0.04,17,4,284,2,120,2.0,32.0,32.0,2,164,37.0,60.0,54.0
0.011,6,10,1972,5,910,2.0,642.0,642.0,5,1062,2.0,794.0,794.0
0.04,17,2,225,1,65,0.0,37.0,37.0,1,160,0.0,132.0,132.0
0.005,17,2,170,1,65,0.0,37.0,37.0,1,105,0.0,77.0,77.0
0.139,6,10,1506,5,395,31.0,127.0,127.0,5,1111,30.0,843.0,843.0
0.011,6,13,3735,7,497,1.0,125.0,125.0,6,3238,2.0,1470.0,1459.0
0.004,6,10,2006,5,927,1.0,659.0,659.0,5,1079,1.0,811.0,811.0
0.006,6,10,1547,5,764,1.0,496.0,496.0,5,783,1.0,515.0,515.0
309.226,17,20,1124,10,716,34347.0,48.0,43.0,10,408,34351.0,20.0,12.0
10.888,17,28,4423,14,1994,829.0,269.0,114.0,14,2429,829.0,588.0,145.0
0.015,6,10,1989,5,910,3.0,642.0,642.0,5,1079,3.0,811.0,811.0
0.006,6,10,2007,5,928,1.0,660.0,660.0,5,1079,1.0,811.0,811.0
0.004,17,2,136,1,60,0.0,32.0,32.0,1,76,0.0,48.0,48.0
0.04,17,2,234,1,61,0.0,33.0,33.0,1,173,0.0,145.0,145.0
0.005,6,10,2007,5,928,1.0,660.0,660.0,5,1079,1.0,811.0,811.0
0.004,6,10,2006,5,927,1.0,659.0,659.0,5,1079,1.0,811.0,811.0
11.139,17,28,4423,14,1994,844.0,269.0,114.0,14,2429,844.0,588.0,145.0
0.039,17,2,148,1,60,0.0,32.0,32.0,1,88,0.0,60.0,60.0
0.004,6,10,2006,5,927,1.0,659.0,659.0,5,1079,1.0,811.0,811.0
0.006,6,10,1689,5,839,1.0,571.0,571.0,5,850,1.0,582.0,582.0
0.007,6,10,2006,5,927,1.0,659.0,659.0,5,1079,1.0,811.0,811.0
0.001,17,2,164,1,74,0.0,46.0,46.0,1,90,0.0,62.0,62.0
0.011,6,10,1990,5,911,2.0,643.0,643.0,5,1079,2.0,811.0,811.0
0.011,17,4,284,2,120,0.0,32.0,32.0,2,164,0.0,60.0,54.0
15.077,17,14,9191,8,6902,2149.0,1350.0,834.0,6,2289,3009.0,1350.0,353.0
0.005,6,10,1702,5,863,1.0,595.0,595.0,5,839,1.0,571.0,571.0
0.012,6,10,1983,5,910,3.0,642.0,642.0,5,1073,3.0,805.0,805.0
15.076,17,15,9238,8,6902,2149.0,1350.0,834.0,7,2336,2507.0,1350.0,305.0
0.008,6,10,1990,5,911,2.0,643.0,643.0,5,1079,1.0,811.0,811.0
0.093,6,10,1506,5,395,20.0,127.0,127.0,5,1111,20.0,843.0,843.0
0.005,6,10,1854,5,889,1.0,621.0,621.0,5,965,1.0,697.0,697.0
0.011,6,10,1990,5,911,2.0,643.0,643.0,5,1079,2.0,811.0,811.0
0.005,6,10,2007,5,928,1.0,660.0,660.0,5,1079,1.0,811.0,811.0
0.011,6,10,1762,5,911,2.0,643.0,643.0,5,851,2.0,583.0,583.0
0.008,6,10,1983,5,910,2.0,642.0,642.0,5,1073,2.0,805.0,805.0
0.005,17,2,230,1,68,0.0,40.0,40.0,1,162,0.0,134.0,134.0
0.158,6,10,1506,5,395,36.0,127.0,127.0,5,1111,35.0,843.0,843.0
0.004,6,15,3794,8,504,0.0,80.0,80.0,7,3290,0.0,1448.0,972.0
0.005,6,10,2007,5,928,1.0,660.0,660.0,5,1079,1.0,811.0,811.0
0.007,17,2,299,1,65,0.0,37.0,37.0,1,234,0.0,206.0,206.0
0.04,17,2,186,1,61,0.0,33.0,33.0,1,125,0.0,97.0,97.0
0.001,17,2,140,1,62,0.0,34.0,34.0,1,78,0.0,50.0,50.0
0.013,6,10,1983,5,910,3.0,642.0,642.0,5,1073,3.0,805.0,805.0
300.312,6,16,2170,9,684,37518.0,146.0,146.0,7,1486,50024.0,419.0,398.0
0.001,17,2,180,1,66,0.0,38.0,38.0,1,114,0.0,86.0,86.0
0.005,6,10,2006,5,927,1.0,659.0,659.0,5,1079,1.0,811.0,811.0
1.021,6,13,3922,7,2139,128.0,1328.0,923.0,6,1783,153.0,1539.0,1539.0
0.001,17,2,180,1,66,0.0,38.0,38.0,1,114,0.0,86.0,86.0
0.004,6,10,2006,5,927,1.0,659.0,659.0,5,1079,1.0,811.0,811.0
1755.986,6,105,6240,60,3510,29761.0,26.0,26.0,45,2730,39907.0,26.0,26.0
1786.49,6,244,35804,152,26032,11831.0,302.0,302.0,92,9772,19631.0,83.0,83.0
0.005,6,13,3747,7,509,0.0,137.0,137.0,6,3238,0.0,1470.0,1459.0
353.577,6,11,1742,6,1308,12003.0,494.0,494.0,5,434,88393.0,83.0,83.0
0.015,6,10,1990,5,911,3.0,643.0,643.0,5,1079,3.0,811.0,811.0
0.006,17,2,178,1,81,0.0,53.0,53.0,1,97,0.0,69.0,69.0
40.054,17,10,676,5,460,10012.0,104.0,64.0,5,216,10012.0,20.0,15.0
40.073,17,10,676,5,460,10009.0,104.0,64.0,5,216,10014.0,20.0,15.0
240.095,6,30,9301,15,6914,17149.0,2036.0,682.0,15,2387,17149.0,580.0,199.0
300.98,6,50,20633,27,14686,11576.0,2720.0,1234.0,23,5947,401.0,2667.0,385.0
0.013,6,10,1972,5,910,3.0,642.0,642.0,5,1062,3.0,794.0,794.0
10.839,17,28,4418,14,1994,825.0,269.0,114.0,14,2424,825.0,587.0,145.0
0.177,6,3,453,2,321,177.0,241.0,241.0,1,132,0.0,92.0,92.0
0.141,6,10,1506,5,395,32.0,127.0,127.0,5,1111,32.0,843.0,843.0
0.006,6,12,1698,6,863,1.0,327.0,271.0,6,835,1.0,515.0,515.0
0.001,17,2,180,1,66,0.0,38.0,38.0,1,114,0.0,86.0,86.0
0.021,6,10,1990,5,911,5.0,643.0,643.0,5,1079,5.0,811.0,811.0
369.559,6,22,2313,16,867,24637.0,195.0,195.0,6,1446,4638.0,419.0,398.0
0.008,17,2,247,1,72,0.0,44.0,44.0,1,175,0.0,147.0,147.0
40.084,17,10,676,5,460,10020.0,104.0,64.0,5,216,10020.0,20.0,15.0
0.015,6,10,1983,5,910,3.0,642.0,642.0,5,1073,3.0,805.0,805.0
0.007,6,10,1774,5,923,1.0,655.0,655.0,5,851,1.0,583.0,583.0
0.006,6,10,2006,5,927,1.0,659.0,659.0,5,1079,1.0,811.0,811.0
0.075,6,10,1506,5,395,18.0,127.0,127.0,5,1111,14.0,843.0,843.0
0.009,6,10,1990,5,911,2.0,643.0,643.0,5,1079,2.0,811.0,811.0
40.081,17,10,676,5,460,10017.0,104.0,64.0,5,216,10019.0,20.0,15.0
10.906,17,28,4423,14,1995,830.0,270.0,114.0,14,2428,830.0,587.0,145.0
40.059,17,10,676,5,460,10013.0,104.0,64.0,5,216,10013.0,20.0,15.0
411.994,6,29,4409,12,3102,10911.0,494.0,494.0,17,1307,25749.0,83.0,83.0
0.13,17,2,182,1,65,0.0,37.0,37.0,1,117,0.0,89.0,89.0
0.053,6,10,1506,5,395,12.0,127.0,127.0,5,1111,11.0,843.0,843.0
0.001,17,2,136,1,60,0.0,32.0,32.0,1,76,0.0,48.0,48.0
0.006,6,10,2007,5,928,1.0,660.0,660.0,5,1079,1.0,811.0,811.0
0.004,17,2,136,1,60,0.0,32.0,32.0,1,76,0.0,48.0,48.0
242.53,6,393,348547,208,22325,1171.0,2736.0,959.0,185,326222,1318.0,2769.0,1809.0
0.013,6,10,1989,5,910,3.0,642.0,642.0,5,1079,3.0,811.0,811.0
0.001,17,2,180,1,66,0.0,38.0,38.0,1,114,0.0,86.0,86.0
0.015,6,10,1972,5,910,3.0,642.0,642.0,5,1062,3.0,794.0,794.0
0.004,6,10,1989,5,927,1.0,659.0,659.0,5,1062,1.0,794.0,794.0
0.005,6,10,2006,5,927,1.0,659.0,659.0,5,1079,1.0,811.0,811.0
0.006,6,10,1547,5,764,1.0,496.0,496.0,5,783,1.0,515.0,515.0
0.007,6,14,3799,7,509,1.0,137.0,137.0,7,3290,1.0,1448.0,972.0
0.006,17,2,148,1,60,0.0,32.0,32.0,1,88,0.0,60.0,60.0
40.076,17,10,676,5,460,10012.0,104.0,64.0,5,216,10010.0,20.0,15.0
0.044,17,2,152,1,76,0.0,48.0,48.0,1,76,0.0,48.0,48.0
0.001,17,2,180,1,66,0.0,38.0,38.0,1,114,0.0,86.0,86.0
0.126,6,10,1506,5,395,30.0,127.0,127.0,5,1111,28.0,843.0,843.0
40.074,17,10,676,5,460,10015.0,104.0,64.0,5,216,10017.0,20.0,15.0
0.013,6,10,1972,5,910,3.0,642.0,642.0,5,1062,3.0,794.0,794.0
0.006,6,10,1547,5,764,1.0,496.0,496.0,5,783,1.0,515.0,515.0
0.088,6,10,1506,5,395,20.0,127.0,127.0,5,1111,20.0,843.0,843.0
0.086,6,10,1506,5,395,19.0,127.0,127.0,5,1111,20.0,843.0,843.0
0.005,6,10,1643,5,860,1.0,592.0,592.0,5,783,1.0,515.0,515.0
0.006,6,10,1989,5,927,1.0,659.0,659.0,5,1062,1.0,794.0,794.0
309.926,17,20,1124,10,716,34421.0,48.0,43.0,10,408,34421.0,20.0,12.0
0.078,6,10,1506,5,395,18.0,127.0,127.0,5,1111,14.0,843.0,843.0
0.128,17,2,80,1,32,0.0,4.0,4.0,1,48,0.0,20.0,20.0
40.062,17,10,676,5,460,10014.0,104.0,64.0,5,216,10014.0,20.0,15.0
0.129,17,4,284,2,120,0.0,32.0,32.0,2,164,125.0,60.0,54.0
0.005,6,10,1854,5,889,1.0,621.0,621.0,5,965,1.0,697.0,697.0
0.23,6,16,2670,8,1396,32.0,533.0,324.0,8,1274,21.0,529.0,212.0
0.017,6,10,1989,5,910,4.0,642.0,642.0,5,1079,4.0,811.0,811.0
0.076,6,10,1506,5,395,17.0,127.0,127.0,5,1111,16.0,843.0,843.0
0.015,6,10,1990,5,911,3.0,643.0,643.0,5,1079,3.0,811.0,811.0
0.02,6,10,1990,5,911,4.0,643.0,643.0,5,1079,4.0,811.0,811.0
0.01,6,10,1972,5,910,2.0,642.0,642.0,5,1062,2.0,794.0,794.0
1772.024,6,307,97881,189,86514,9425.0,2001.0,678.0,118,11367,15145.0,452.0,70.0
40.04,17,10,676,5,460,10007.0,104.0,64.0,5,216,10006.0,20.0,15.0
0.148,6,10,1506,5,395,31.0,127.0,127.0,5,1111,31.0,843.0,843.0
0.005,6,10,2006,5,927,1.0,659.0,659.0,5,1079,1.0,811.0,811.0
0.004,6,10,2000,5,927,1.0,659.0,659.0,5,1073,1.0,805.0,805.0
0.013,6,10,1990,5,911,3.0,643.0,643.0,5,1079,3.0,811.0,811.0
0.071,17,2,148,1,60,0.0,32.0,32.0,1,88,0.0,60.0,60.0
0.006,6,10,1547,5,764,1.0,496.0,496.0,5,783,1.0,515.0,515.0
0.013,6,10,1990,5,911,3.0,643.0,643.0,5,1079,3.0,811.0,811.0
0.005,6,10,1854,5,889,1.0,621.0,621.0,5,965,1.0,697.0,697.0
0.004,6,10,1989,5,927,1.0,659.0,659.0,5,1062,1.0,794.0,794.0
0.013,6,10,1989,5,910,3.0,642.0,642.0,5,1079,3.0,811.0,811.0
0.005,6,10,1774,5,923,1.0,655.0,655.0,5,851,1.0,583.0,583.0
0.172,6,3,453,2,321,172.0,241.0,241.0,1,132,0.0,92.0,92.0
0.009,6,10,1854,5,889,2.0,621.0,621.0,5,965,2.0,697.0,697.0
0.019,6,10,1990,5,911,4.0,643.0,643.0,5,1079,4.0,811.0,811.0
0.006,6,10,1547,5,764,1.0,496.0,496.0,5,783,1.0,515.0,515.0
290.921,6,395,347850,198,21863,1476.0,2692.0,889.0,197,325987,1484.0,2804.0,1725.0
0.001,17,2,152,1,68,0.0,40.0,40.0,1,84,0.0,56.0,56.0
0.016,6,10,1631,5,848,4.0,580.0,580.0,5,783,3.0,515.0,515.0
0.098,6,10,1506,5,395,19.0,127.0,127.0,5,1111,23.0,843.0,843.0
0.273,17,4,352,2,130,221.0,37.0,37.0,2,222,233.0,89.0,83.0
0.005,6,10,1689,5,839,1.0,571.0,571.0,5,850,1.0,582.0,582.0
0.002,17,2,180,1,66,0.0,38.0,38.0,1,114,0.0,86.0,86.0
40.071,17,10,676,5,460,10016.0,104.0,64.0,5,216,10016.0,20.0,15.0
0.003,17,2,136,1,60,0.0,32.0,32.0,1,76,0.0,48.0,48.0
0.011,6,10,1631,5,848,2.0,580.0,580.0,5,783,2.0,515.0,515.0
0.105,6,10,1506,5,395,20.0,127.0,127.0,5,1111,23.0,843.0,843.0
0.003,17,2,148,1,60,0.0,32.0,32.0,1,88,0.0,60.0,60.0
0.006,6,10,1547,5,764,1.0,496.0,496.0,5,783,1.0,515.0,515.0
0.005,17,2,152,1,68,0.0,40.0,40.0,1,84,0.0,56.0,56.0
0.006,6,10,1547,5,764,1.0,496.0,496.0,5,783,1.0,515.0,515.0
0.001,17,2,180,1,66,0.0,38.0,38.0,1,114,0.0,86.0,86.0
15.073,17,14,9190,8,6902,2149.0,1350.0,834.0,6,2288,3008.0,1350.0,353.0
0.074,17,4,580,2,122,1.0,33.0,33.0,2,458,32.0,307.0,201.0
0.04,17,2,170,1,65,0.0,37.0,37.0,1,105,0.0,77.0,77.0
0.008,6,10,1631,5,848,2.0,580.0,580.0,5,783,1.0,515.0,515.0
353.464,6,20,2210,6,1308,12005.0,494.0,494.0,14,902,27189.0,83.0,83.0
0.006,6,10,1547,5,764,1.0,496.0,496.0,5,783,1.0,515.0,515.0
0.008,6,10,1990,5,911,1.0,643.0,643.0,5,1079,1.0,811.0,811.0
0.016,6,10,1983,5,910,3.0,642.0,642.0,5,1073,4.0,805.0,805.0
0.124,6,14,4388,8,923,17.0,238.0,166.0,6,3465,16.0,1402.0,786.0
0.005,6,10,1779,5,928,1.0,660.0,660.0,5,851,1.0,583.0,583.0
240.091,6,32,9716,16,7083,16006.0,2155.0,695.0,16,2633,16005.0,580.0,224.0
0.016,6,10,1990,5,911,4.0,643.0,643.0,5,1079,4.0,811.0,811.0
0.016,6,10,1990,5,911,4.0,643.0,643.0,5,1079,4.0,811.0,811.0
0.009,6,10,1989,5,910,2.0,642.0,642.0,5,1079,2.0,811.0,811.0
240.073,6,21,4925,11,941,24007.0,180.0,93.0,10,3984,26674.0,1592.0,576.0
0.005,6,13,3690,7,452,0.0,80.0,80.0,6,3238,0.0,1470.0,1459.0
0.004,6,10,1779,5,928,1.0,660.0,660.0,5,851,1.0,583.0,583.0
0.013,6,10,1983,5,910,3.0,642.0,642.0,5,1073,3.0,805.0,805.0
0.004,6,10,2007,5,928,1.0,660.0,660.0,5,1079,1.0,811.0,811.0
0.004,6,10,1702,5,863,1.0,595.0,595.0,5,839,0.0,571.0,571.0
0.071,6,10,1506,5,395,15.0,127.0,127.0,5,1111,17.0,843.0,843.0
0.004,6,10,2006,5,927,1.0,659.0,659.0,5,1079,1.0,811.0,811.0
364.384,6,21,1793,16,1030,24292.0,190.0,190.0,5,763,60009.0,462.0,247.0
0.005,17,2,180,1,66,0.0,38.0,38.0,1,114,0.0,86.0,86.0
0.008,6,10,1990,5,911,2.0,643.0,643.0,5,1079,2.0,811.0,811.0
0.013,6,10,1989,5,910,3.0,642.0,642.0,5,1079,3.0,811.0,811.0
0.005,17,2,230,1,68,0.0,40.0,40.0,1,162,0.0,134.0,134.0
0.068,17,8,3613,4,1874,22.0,1350.0,440.0,4,1739,11.0,1350.0,406.0
0.007,6,10,1643,5,860,1.0,592.0,592.0,5,783,1.0,515.0,515.0
0.014,6,10,1972,5,910,3.0,642.0,642.0,5,1062,3.0,794.0,794.0
0.005,6,10,2000,5,927,1.0,659.0,659.0,5,1073,1.0,805.0,805.0
0.014,6,10,1989,5,910,3.0,642.0,642.0,5,1079,3.0,811.0,811.0
0.002,17,2,180,1,66,0.0,38.0,38.0,1,114,0.0,86.0,86.0
0.003,17,2,136,1,60,0.0,32.0,32.0,1,76,0.0,48.0,48.0
0.037,17,2,148,1,60,0.0,32.0,32.0,1,88,0.0,60.0,60.0
0.122,17,2,80,1,32,0.0,4.0,4.0,1,48,0.0,20.0,20.0
300.391,6,15,2130,9,684,37528.0,146.0,146.0,6,1446,60045.0,419.0,398.0
0.005,6,10,2007,5,928,1.0,660.0,660.0,5,1079,1.0,811.0,811.0
0.138,6,10,1506,5,395,30.0,127.0,127.0,5,1111,31.0,843.0,843.0
0.005,6,10,2006,5,927,1.0,659.0,659.0,5,1079,1.0,811.0,811.0
0.133,6,10,1506,5,395,32.0,127.0,127.0,5,1111,28.0,843.0,843.0
0.111,6,10,1506,5,395,24.0,127.0,127.0,5,1111,22.0,843.0,843.0
171.165,17,86,12099,43,2892,4075.0,44.0,39.0,43,9207,4075.0,239.0,186.0
15.072,17,15,9238,8,6902,2149.0,1350.0,834.0,7,2336,2507.0,1350.0,305.0
0.011,6,10,1989,5,910,2.0,642.0,642.0,5,1079,2.0,811.0,811.0
0.005,6,13,3747,7,509,0.0,137.0,137.0,6,3238,1.0,1470.0,1459.0
40.068,17,10,676,5,460,10016.0,104.0,64.0,5,216,10016.0,20.0,15.0
367.482,6,24,4137,13,3142,30623.0,494.0,494.0,11,995,36747.0,83.0,83.0
40.059,17,10,676,5,460,10013.0,104.0,64.0,5,216,10013.0,20.0,15.0
0.005,6,10,1689,5,839,1.0,571.0,571.0,5,850,1.0,582.0,582.0
0.005,6,14,3799,7,509,0.0,137.0,137.0,7,3290,0.0,1448.0,972.0
0.015,6,10,1990,5,911,3.0,643.0,643.0,5,1079,3.0,811.0,811.0
0.006,6,10,1547,5,764,1.0,496.0,496.0,5,783,1.0,515.0,515.0
0.005,17,2,169,1,62,0.0,34.0,34.0,1,107,0.0,79.0,79.0
0.104,6,10,1506,5,395,22.0,127.0,127.0,5,1111,25.0,843.0,843.0
0.009,6,10,1972,5,910,2.0,642.0,642.0,5,1062,2.0,794.0,794.0
10.731,17,28,4418,14,1993,817.0,268.0,114.0,14,2425,817.0,588.0,145.0
0.096,6,10,1506,5,395,19.0,127.0,127.0,5,1111,21.0,843.0,843.0
0.013,6,10,1972,5,910,3.0,642.0,642.0,5,1062,3.0,794.0,794.0
0.013,17,2,152,1,56,0.0,28.0,28.0,1,96,0.0,68.0,68.0
0.014,6,10,1983,5,910,3.0,642.0,642.0,5,1073,3.0,805.0,805.0
0.001,17,2,179,1,62,0.0,34.0,34.0,1,117,0.0,89.0,89.0
0.003,17,2,148,1,60,0.0,32.0,32.0,1,88,0.0,60.0,60.0
0.102,6,10,1506,5,395,23.0,127.0,127.0,5,1111,22.0,843.0,843.0
0.009,6,10,1762,5,911,2.0,643.0,643.0,5,851,2.0,583.0,583.0
0.012,6,10,1989,5,910,3.0,642.0,642.0,5,1079,2.0,811.0,811.0
0.021,6,12,1698,6,863,4.0,327.0,271.0,6,835,4.0,515.0,515.0
0.015,6,13,3735,7,497,2.0,125.0,125.0,6,3238,3.0,1470.0,1459.0
256.285,6,25,6984,13,3012,21356.0,676.0,388.0,12,3972,23298.0,1402.0,670.0
0.005,6,10,2006,5,927,1.0,659.0,659.0,5,1079,1.0,811.0,811.0
0.012,6,10,1677,5,827,3.0,559.0,559.0,5,850,3.0,582.0,582.0
40.049,17,10,676,5,460,10011.0,104.0,64.0,5,216,10011.0,20.0,15.0
0.113,6,10,1506,5,395,21.0,127.0,127.0,5,1111,25.0,843.0,843.0
0.003,17,2,148,1,60,0.0,32.0,32.0,1,88,0.0,60.0,60.0
0.008,6,10,1989,5,910,1.0,642.0,642.0,5,1079,2.0,811.0,811.0
0.012,6,10,1989,5,910,3.0,642.0,642.0,5,1079,2.0,811.0,811.0
40.097,17,10,676,5,460,10020.0,104.0,64.0,5,216,10023.0,20.0,15.0
0.011,6,10,1989,5,910,2.0,642.0,642.0,5,1079,2.0,811.0,811.0
0.006,6,10,1547,5,764,1.0,496.0,496.0,5,783,1.0,515.0,515.0
0.012,6,10,1989,5,910,2.0,642.0,642.0,5,1079,3.0,811.0,811.0
0.01,6,10,1990,5,911,2.0,643.0,643.0,5,1079,2.0,811.0,811.0
0.008,6,12,1926,6,1189,1.0,659.0,434.0,6,737,1.0,417.0,417.0
0.01,6,10,1762,5,911,2.0,643.0,643.0,5,851,2.0,583.0,583.0
0.012,6,10,1989,5,910,2.0,642.0,642.0,5,1079,2.0,811.0,811.0
0.005,17,2,179,1,71,0.0,43.0,43.0,1,108,0.0,80.0,80.0
0.011,6,10,1989,5,910,2.0,642.0,642.0,5,1079,2.0,811.0,811.0
0.005,6,14,3742,7,452,0.0,80.0,80.0,7,3290,0.0,1448.0,972.0
0.027,6,10,1605,5,388,6.0,120.0,120.0,5,1217,6.0,949.0,949.0
0.005,17,2,180,1,66,0.0,38.0,38.0,1,114,0.0,86.0,86.0
0.006,6,10,1547,5,764,1.0,496.0,496.0,5,783,1.0,515.0,515.0
354.014,6,19,1691,15,978,25286.0,190.0,190.0,4,713,80004.0,497.0,497.0
0.004,17,2,170,1,65,0.0,37.0,37.0,1,105,0.0,77.0,77.0
0.006,17,2,179,1,71,0.0,43.0,43.0,1,108,0.0,80.0,80.0
0.005,6,13,3747,7,509,0.0,137.0,137.0,6,3238,0.0,1470.0,1459.0
0.114,6,10,1506,5,395,13.0,127.0,127.0,5,1111,28.0,843.0,843.0
0.011,6,10,1990,5,911,2.0,643.0,643.0,5,1079,2.0,811.0,811.0
0.011,6,10,1989,5,910,2.0,642.0,642.0,5,1079,2.0,811.0,811.0
0.02,6,10,1989,5,910,5.0,642.0,642.0,5,1079,4.0,811.0,811.0
0.011,6,10,1990,5,911,2.0,643.0,643.0,5,1079,2.0,811.0,811.0
0.082,6,10,1506,5,395,16.0,127.0,127.0,5,1111,19.0,843.0,843.0
0.324,17,42,20755,23,17157,14.0,1350.0,717.0,19,3598,13.0,1350.0,161.0
0.006,6,10,1689,5,839,1.0,571.0,571.0,5,850,1.0,582.0,582.0
0.005,17,2,146,1,65,0.0,37.0,37.0,1,81,0.0,53.0,53.0
0.08,6,10,1506,5,395,19.0,127.0,127.0,5,1111,17.0,843.0,843.0
0.04,17,2,144,1,64,0.0,36.0,36.0,1,80,0.0,52.0,52.0
0.017,6,10,1983,5,910,4.0,642.0,642.0,5,1073,4.0,805.0,805.0
0.011,6,10,1989,5,910,2.0,642.0,642.0,5,1079,2.0,811.0,811.0
0.005,6,13,3747,7,509,0.0,137.0,137.0,6,3238,1.0,1470.0,1459.0
0.037,17,2,144,1,64,0.0,36.0,36.0,1,80,0.0,52.0,52.0
0.015,6,10,1989,5,910,3.0,642.0,642.0,5,1079,3.0,811.0,811.0
0.016,6,10,1990,5,911,4.0,643.0,643.0,5,1079,4.0,811.0,811.0
0.086,6,10,1506,5,395,18.0,127.0,127.0,5,1111,19.0,843.0,843.0
0.088,6,10,1506,5,395,18.0,127.0,127.0,5,1111,19.0,843.0,843.0
0.005,6,10,1689,5,839,1.0,571.0,571.0,5,850,1.0,582.0,582.0
0.015,6,10,1989,5,910,3.0,642.0,642.0,5,1079,3.0,811.0,811.0
0.005,17,2,180,1,58,0.0,30.0,30.0,1,122,0.0,94.0,94.0
0.118,6,10,1506,5,395,28.0,127.0,127.0,5,1111,28.0,843.0,843.0
0.011,6,10,1972,5,910,2.0,642.0,642.0,5,1062,2.0,794.0,794.0
0.032,6,10,1762,5,911,7.0,643.0,643.0,5,851,8.0,583.0,583.0
0.006,6,14,3742,7,452,0.0,80.0,80.0,7,3290,0.0,1448.0,972.0
15.074,17,15,9238,8,6902,2149.0,1350.0,834.0,7,2336,2507.0,1350.0,305.0
0.008,6,10,2000,5,927,2.0,659.0,659.0,5,1073,2.0,805.0,805.0
0.009,6,12,1926,6,1189,1.0,659.0,434.0,6,737,1.0,417.0,417.0
0.009,6,10,1989,5,910,2.0,642.0,642.0,5,1079,2.0,811.0,811.0
0.005,6,10,2006,5,927,1.0,659.0,659.0,5,1079,1.0,811.0,811.0
0.126,17,4,284,2,120,0.0,32.0,32.0,2,164,123.0,60.0,54.0
40.06,17,10,676,5,460,10014.0,104.0,64.0,5,216,10014.0,20.0,15.0
0.008,6,12,1926,6,1189,1.0,659.0,434.0,6,737,1.0,417.0,417.0
0.136,6,10,1506,5,395,31.0,127.0,127.0,5,1111,31.0,843.0,843.0
15.076,17,16,8844,8,6605,2149.0,1350.0,797.0,8,2239,2149.0,1350.0,251.0
0.005,6,13,3747,7,509,0.0,137.0,137.0,6,3238,0.0,1470.0,1459.0
0.014,6,10,1990,5,911,3.0,643.0,643.0,5,1079,3.0,811.0,811.0
0.014,6,10,1990,5,911,3.0,643.0,643.0,5,1079,3.0,811.0,811.0
0.005,6,14,3742,7,452,0.0,80.0,80.0,7,3290,0.0,1448.0,972.0
0.003,17,4,284,2,120,0.0,32.0,32.0,2,164,0.0,60.0,54.0
0.08,6,10,1506,5,395,18.0,127.0,127.0,5,1111,17.0,843.0,843.0
0.149,6,10,1506,5,395,16.0,127.0,127.0,5,1111,34.0,843.0,843.0
0.012,6,10,1990,5,911,3.0,643.0,643.0,5,1079,3.0,811.0,811.0
0.005,6,10,2006,5,927,1.0,659.0,659.0,5,1079,1.0,811.0,811.0
0.005,6,10,2000,5,927,1.0,659.0,659.0,5,1073,1.0,805.0,805.0
240.032,6,9,787,5,488,60008.0,232.0,232.0,4,299,80010.0,83.0,83.0
312.769,17,20,1124,10,716,34739.0,48.0,43.0,10,408,34738.0,20.0,12.0
0.001,17,2,180,1,66,0.0,38.0,38.0,1,114,0.0,86.0,86.0
40.069,17,10,676,5,460,10016.0,104.0,64.0,5,216,10016.0,20.0,15.0
0.007,17,2,166,1,75,0.0,47.0,47.0,1,91,0.0,63.0,63.0
0.017,6,10,1972,5,910,4.0,642.0,642.0,5,1062,4.0,794.0,794.0
65.997,6,25,10430,11,3931,6599.0,1601.0,840.0,14,6499,5066.0,2111.0,576.0
0.014,6,10,1631,5,848,3.0,580.0,580.0,5,783,3.0,515.0,515.0
0.01,6,10,1989,5,927,2.0,659.0,659.0,5,1062,2.0,794.0,794.0
0.011,17,2,148,1,60,0.0,32.0,32.0,1,88,0.0,60.0,60.0
0.006,6,10,1854,5,889,1.0,621.0,621.0,5,965,1.0,697.0,697.0
0.013,6,10,1983,5,910,3.0,642.0,642.0,5,1073,3.0,805.0,805.0
300.349,6,16,2170,9,684,37522.0,146.0,146.0,7,1486,50031.0,419.0,398.0
0.003,17,2,148,1,60,0.0,32.0,32.0,1,88,0.0,60.0,60.0
40.077,17,10,676,5,460,10016.0,104.0,64.0,5,216,10018.0,20.0,15.0
0.097,6,10,1506,5,395,19.0,127.0,127.0,5,1111,20.0,843.0,843.0
0.071,17,2,396,1,61,0.0,33.0,33.0,1,335,0.0,307.0,307.0
0.001,17,2,178,1,81,0.0,53.0,53.0,1,97,0.0,69.0,69.0
0.005,6,10,1854,5,889,1.0,621.0,621.0,5,965,1.0,697.0,697.0
0.001,17,2,136,1,60,0.0,32.0,32.0,1,76,0.0,48.0,48.0
1770.698,17,120,11460,60,5460,30011.0,63.0,63.0,60,6000,30011.0,72.0,72.0
300.312,6,16,2170,9,684,37518.0,146.0,146.0,7,1486,50024.0,419.0,398.0
0.016,6,10,1972,5,910,4.0,642.0,642.0,5,1062,4.0,794.0,794.0
0.009,6,10,1989,5,910,2.0,642.0,642.0,5,1079,2.0,811.0,811.0
0.07,6,10,1506,5,395,14.0,127.0,127.0,5,1111,14.0,843.0,843.0
0.012,6,10,1989,5,910,3.0,642.0,642.0,5,1079,2.0,811.0,811.0
0.004,6,10,2007,5,928,1.0,660.0,660.0,5,1079,1.0,811.0,811.0
0.007,6,10,1689,5,839,1.0,571.0,571.0,5,850,1.0,582.0,582.0
0.071,6,10,1506,5,395,15.0,127.0,127.0,5,1111,16.0,843.0,843.0
0.001,17,2,180,1,65,0.0,37.0,37.0,1,115,0.0,87.0,87.0
1799.396,17,2980,228153,1480,119986,1216.0,84.0,53.0,1500,108167,1200.0,227.0,44.0
0.085,6,10,1506,5,395,17.0,127.0,127.0,5,1111,19.0,843.0,843.0
0.009,6,10,1989,5,910,2.0,642.0,642.0,5,1079,2.0,811.0,811.0
0.005,6,10,1702,5,863,1.0,595.0,595.0,5,839,1.0,571.0,571.0
0.02,6,10,1989,5,910,5.0,642.0,642.0,5,1079,5.0,811.0,811.0
0.005,6,10,1989,5,927,1.0,659.0,659.0,5,1062,1.0,794.0,794.0
0.042,17,2,136,1,60,0.0,32.0,32.0,1,76,0.0,48.0,48.0
0.004,6,10,2000,5,927,1.0,659.0,659.0,5,1073,1.0,805.0,805.0
40.066,17,10,676,5,460,10015.0,104.0,64.0,5,216,10015.0,20.0,15.0
40.058,17,10,676,5,460,10013.0,104.0,64.0,5,216,10013.0,20.0,15.0
0.003,17,2,136,1,60,0.0,32.0,32.0,1,76,0.0,48.0,48.0
0.024,6,13,3735,7,497,4.0,125.0,125.0,6,3238,4.0,1470.0,1459.0
0.013,6,10,1972,5,910,3.0,642.0,642.0,5,1062,3.0,794.0,794.0
1756.412,6,462,66036,252,35168,6997.0,613.0,197.0,210,30868,8403.0,453.0,142.0
0.072,6,10,1506,5,395,14.0,127.0,127.0,5,1111,16.0,843.0,843.0
0.006,6,10,2006,5,927,1.0,659.0,659.0,5,1079,1.0,811.0,811.0
0.099,6,10,1506,5,395,22.0,127.0,127.0,5,1111,21.0,843.0,843.0
0.107,6,10,1506,5,395,24.0,127.0,127.0,5,1111,23.0,843.0,843.0
0.011,6,10,1989,5,910,2.0,642.0,642.0,5,1079,2.0,811.0,811.0
0.001,17,2,179,1,62,0.0,34.0,34.0,1,117,0.0,89.0,89.0
32.361,6,36,8190,19,1759,1797.0,651.0,322.0,17,6431,555.0,2126.0,478.0
11.137,17,34,6373,17,2658,688.0,270.0,128.0,17,3715,688.0,1145.0,190.0
0.001,17,2,136,1,60,0.0,32.0,32.0,1,76,0.0,48.0,48.0
0.005,6,10,2007,5,928,1.0,660.0,660.0,5,1079,1.0,811.0,811.0
0.08,6,10,1506,5,395,17.0,127.0,127.0,5,1111,17.0,843.0,843.0
0.009,6,12,1926,6,1189,1.0,659.0,434.0,6,737,1.0,417.0,417.0
0.008,6,10,1989,5,910,2.0,642.0,642.0,5,1079,1.0,811.0,811.0
0.065,6,10,1506,5,395,14.0,127.0,127.0,5,1111,15.0,843.0,843.0
0.038,17,2,412,1,61,0.0,33.0,33.0,1,351,0.0,323.0,323.0
0.007,6,10,1547,5,764,1.0,496.0,496.0,5,783,1.0,515.0,515.0
0.004,6,10,2007,5,928,1.0,660.0,660.0,5,1079,1.0,811.0,811.0
5.081,58,2,144,1,72,0.0,24.0,24.0,1,72,0.0,24.0,24.0
0.01,6,13,3735,7,497,1.0,125.0,125.0,6,3238,2.0,1470.0,1459.0
10.941,17,28,4417,14,1994,833.0,269.0,114.0,14,2423,833.0,586.0,145.0
0.005,6,10,2006,5,927,1.0,659.0,659.0,5,1079,1.0,811.0,811.0
0.039,17,2,182,1,65,0.0,37.0,37.0,1,117,0.0,89.0,89.0
0.065,17,8,3613,4,1874,21.0,1350.0,440.0,4,1739,11.0,1350.0,406.0
174.092,17,80,11527,40,2682,4463.0,44.0,39.0,40,8845,4463.0,261.0,193.0
0.037,17,4,284,2,120,1.0,32.0,32.0,2,164,34.0,60.0,54.0
0.005,6,10,2006,5,927,1.0,659.0,659.0,5,1079,1.0,811.0,811.0
1770.715,6,82,4318,41,2159,44266.0,27.0,27.0,41,2159,44266.0,27.0,27.0
0.005,6,13,3747,7,509,0.0,137.0,137.0,6,3238,0.0,1470.0,1459.0
0.058,6,10,1506,5,395,14.0,127.0,127.0,5,1111,12.0,843.0,843.0
0.005,6,10,2006,5,927,1.0,659.0,659.0,5,1079,1.0,811.0,811.0
10.928,17,28,4423,14,1994,831.0,269.0,114.0,14,2429,830.0,588.0,145.0
0.001,17,2,180,1,66,0.0,38.0,38.0,1,114,0.0,86.0,86.0
0.004,17,4,284,2,120,1.0,32.0,32.0,2,164,0.0,60.0,54.0
0.014,17,2,152,1,56,0.0,28.0,28.0,1,96,0.0,68.0,68.0
0.005,6,10,2000,5,927,1.0,659.0,659.0,5,1073,1.0,805.0,805.0
0.173,6,10,1506,5,395,33.0,127.0,127.0,5,1111,41.0,843.0,843.0
0.072,17,4,352,2,130,0.0,37.0,37.0,2,222,69.0,89.0,83.0
40.055,17,10,676,5,460,10012.0,104.0,64.0,5,216,10012.0,20.0,15.0
0.005,6,10,2000,5,927,1.0,659.0,659.0,5,1073,1.0,805.0,805.0
0.008,6,12,1926,6,1189,1.0,659.0,434.0,6,737,1.0,417.0,417.0
0.018,6,10,1983,5,910,4.0,642.0,642.0,5,1073,4.0,805.0,805.0
0.004,6,10,1779,5,928,1.0,660.0,660.0,5,851,1.0,583.0,583.0
0.005,6,10,1989,5,927,1.0,659.0,659.0,5,1062,1.0,794.0,794.0
0.005,17,2,179,1,71,0.0,43.0,43.0,1,108,0.0,80.0,80.0
0.097,6,10,1506,5,395,18.0,127.0,127.0,5,1111,21.0,843.0,843.0
0.011,6,10,1972,5,910,2.0,642.0,642.0,5,1062,2.0,794.0,794.0
240.075,6,20,4872,11,941,24007.0,180.0,93.0,9,3931,30009.0,1591.0,575.0
0.004,6,10,2000,5,927,1.0,659.0,659.0,5,1073,1.0,805.0,805.0
0.007,6,10,1547,5,764,1.0,496.0,496.0,5,783,1.0,515.0,515.0
0.005,17,2,169,1,62,0.0,34.0,34.0,1,107,0.0,79.0,79.0
0.005,6,10,1689,5,839,1.0,571.0,571.0,5,850,1.0,582.0,582.0
0.014,6,10,1990,5,911,3.0,643.0,643.0,5,1079,3.0,811.0,811.0
0.005,6,10,1774,5,923,1.0,655.0,655.0,5,851,1.0,583.0,583.0
0.005,17,2,140,1,62,0.0,34.0,34.0,1,78,0.0,50.0,50.0
308.374,17,20,1124,10,716,34249.0,48.0,43.0,10,408,34248.0,20.0,12.0
0.111,6,10,1506,5,395,26.0,127.0,127.0,5,1111,24.0,843.0,843.0
0.013,6,10,1972,5,910,3.0,642.0,642.0,5,1062,3.0,794.0,794.0
308.633,17,20,1124,10,716,34278.0,48.0,43.0,10,408,34278.0,20.0,12.0
0.011,6,10,1972,5,910,2.0,642.0,642.0,5,1062,2.0,794.0,794.0
0.001,17,2,136,1,60,0.0,32.0,32.0,1,76,0.0,48.0,48.0
40.068,17,10,676,5,460,10015.0,104.0,64.0,5,216,10016.0,20.0,15.0
240.014,6,9,787,5,488,60003.0,232.0,232.0,4,299,80004.0,83.0,83.0
0.006,6,10,1547,5,764,1.0,496.0,496.0,5,783,1.0,515.0,515.0
0.012,6,10,1983,5,910,2.0,642.0,642.0,5,1073,3.0,805.0,805.0
0.004,6,10,2006,5,927,1.0,659.0,659.0,5,1079,1.0,811.0,811.0
0.007,6,10,1989,5,910,1.0,642.0,642.0,5,1079,1.0,811.0,811.0
0.013,6,10,1989,5,910,3.0,642.0,642.0,5,1079,3.0,811.0,811.0
0.039,17,2,156,1,64,0.0,36.0,36.0,1,92,0.0,64.0,64.0
0.073,6,10,1506,5,395,14.0,127.0,127.0,5,1111,16.0,843.0,843.0
0.041,17,2,152,1,76,0.0,48.0,48.0,1,76,0.0,48.0,48.0
40.072,17,10,676,5,460,10015.0,104.0,64.0,5,216,10015.0,20.0,15.0
0.131,17,2,80,1,32,0.0,4.0,4.0,1,48,0.0,20.0,20.0
65.867,6,22,10140,12,3973,5987.0,1579.0,835.0,10,6167,7300.0,2111.0,939.0
0.115,6,10,1506,5,395,24.0,127.0,127.0,5,1111,24.0,843.0,843.0
11.216,17,28,4395,14,1995,850.0,270.0,114.0,14,2400,850.0,587.0,143.0
0.016,6,10,1990,5,911,4.0,643.0,643.0,5,1079,3.0,811.0,811.0
0.006,6,10,2006,5,927,1.0,659.0,659.0,5,1079,1.0,811.0,811.0
0.003,17,2,148,1,60,0.0,32.0,32.0,1,88,0.0,60.0,60.0
0.007,6,10,1762,5,911,1.0,643.0,643.0,5,851,1.0,583.0,583.0
0.007,17,2,179,1,71,0.0,43.0,43.0,1,108,0.0,80.0,80.0
0.003,17,4,284,2,120,0.0,32.0,32.0,2,164,0.0,60.0,54.0
0.005,6,10,2000,5,927,1.0,659.0,659.0,5,1073,1.0,805.0,805.0
0.004,6,10,2006,5,927,1.0,659.0,659.0,5,1079,1.0,811.0,811.0
0.11,6,10,1506,5,395,25.0,127.0,127.0,5,1111,23.0,843.0,843.0
0.098,6,10,1506,5,395,22.0,127.0,127.0,5,1111,23.0,843.0,843.0
0.005,6,10,1989,5,927,1.0,659.0,659.0,5,1062,1.0,794.0,794.0
0.017,6,10,1972,5,910,4.0,642.0,642.0,5,1062,4.0,794.0,794.0
0.005,17,2,166,1,75,0.0,47.0,47.0,1,91,0.0,63.0,63.0
0.103,6,10,1506,5,395,23.0,127.0,127.0,5,1111,22.0,843.0,843.0
0.134,6,10,1266,5,775,33.0,519.0,519.0,5,491,30.0,223.0,223.0
0.116,6,10,1506,5,395,26.0,127.0,127.0,5,1111,26.0,843.0,843.0
0.005,6,10,1689,5,839,1.0,571.0,571.0,5,850,1.0,582.0,582.0
0.114,6,10,1506,5,395,24.0,127.0,127.0,5,1111,23.0,843.0,843.0
0.064,6,10,1506,5,395,15.0,127.0,127.0,5,1111,15.0,843.0,843.0
0.014,6,10,1762,5,911,3.0,643.0,643.0,5,851,3.0,583.0,583.0
0.015,6,10,1677,5,827,3.0,559.0,559.0,5,850,3.0,582.0,582.0
0.006,6,10,1854,5,889,1.0,621.0,621.0,5,965,1.0,697.0,697.0
176.118,17,74,10553,37,2464,4892.0,44.0,38.0,37,8089,4892.0,261.0,190.0
40.064,17,10,676,5,460,10013.0,104.0,64.0,5,216,10015.0,20.0,15.0
0.129,17,2,80,1,32,0.0,4.0,4.0,1,48,0.0,20.0,20.0
0.017,6,10,1631,5,848,4.0,580.0,580.0,5,783,4.0,515.0,515.0
40.07,17,10,676,5,460,10015.0,104.0,64.0,5,216,10016.0,20.0,15.0
0.016,6,10,1983,5,910,4.0,642.0,642.0,5,1073,3.0,805.0,805.0
0.006,6,10,1547,5,764,1.0,496.0,496.0,5,783,1.0,515.0,515.0
0.001,17,2,152,1,68,0.0,40.0,40.0,1,84,0.0,56.0,56.0
0.004,6,10,1774,5,923,1.0,655.0,655.0,5,851,0.0,583.0,583.0
0.004,17,2,148,1,60,0.0,32.0,32.0,1,88,0.0,60.0,60.0
241.833,6,44,5565,22,2540,11515.0,588.0,196.0,22,3025,11515.0,580.0,234.0
0.131,6,10,1506,5,395,30.0,127.0,127.0,5,1111,30.0,843.0,843.0
0.01,6,10,1972,5,910,2.0,642.0,642.0,5,1062,2.0,794.0,794.0
0.073,6,10,1506,5,395,17.0,127.0,127.0,5,1111,15.0,843.0,843.0
0.079,6,10,1506,5,395,15.0,127.0,127.0,5,1111,19.0,843.0,843.0
0.004,6,10,2000,5,927,1.0,659.0,659.0,5,1073,1.0,805.0,805.0
0.01,6,10,1983,5,910,2.0,642.0,642.0,5,1073,2.0,805.0,805.0
0.123,6,10,1506,5,395,28.0,127.0,127.0,5,1111,27.0,843.0,843.0
0.128,6,10,1506,5,395,26.0,127.0,127.0,5,1111,26.0,843.0,843.0
0.006,6,12,1698,6,863,1.0,327.0,271.0,6,835,1.0,515.0,515.0
0.006,6,10,1547,5,764,1.0,496.0,496.0,5,783,1.0,515.0,515.0
0.004,17,2,164,1,74,0.0,46.0,46.0,1,90,0.0,62.0,62.0
0.062,6,10,1990,5,911,15.0,643.0,643.0,5,1079,15.0,811.0,811.0
0.135,6,10,1506,5,395,32.0,127.0,127.0,5,1111,29.0,843.0,843.0
0.016,17,2,198,1,91,0.0,63.0,63.0,1,107,0.0,79.0,79.0
0.004,6,10,1779,5,928,1.0,660.0,660.0,5,851,1.0,583.0,583.0
0.007,17,2,179,1,71,0.0,43.0,43.0,1,108,0.0,80.0,80.0
0.016,6,10,1989,5,910,4.0,642.0,642.0,5,1079,4.0,811.0,811.0
0.094,6,10,1506,5,395,22.0,127.0,127.0,5,1111,23.0,843.0,843.0
0.004,6,10,1702,5,863,1.0,595.0,595.0,5,839,1.0,571.0,571.0
0.006,6,10,1547,5,764,1.0,496.0,496.0,5,783,1.0,515.0,515.0
0.006,17,2,168,1,76,0.0,48.0,48.0,1,92,0.0,64.0,64.0
0.006,17,2,230,1,68,0.0,40.0,40.0,1,162,0.0,134.0,134.0
0.014,6,10,1972,5,910,3.0,642.0,642.0,5,1062,3.0,794.0,794.0
0.011,6,10,1989,5,910,2.0,642.0,642.0,5,1079,2.0,811.0,811.0
0.01,6,10,1631,5,848,2.0,580.0,580.0,5,783,2.0,515.0,515.0
0.004,17,2,136,1,60,0.0,32.0,32.0,1,76,0.0,48.0,48.0
0.002,17,2,180,1,66,0.0,38.0,38.0,1,114,0.0,86.0,86.0
0.007,6,10,1547,5,764,1.0,496.0,496.0,5,783,1.0,515.0,515.0
66.02,6,22,8547,12,2328,6001.0,1002.0,424.0,10,6219,7316.0,2355.0,948.0
0.014,6,10,1762,5,911,3.0,643.0,643.0,5,851,3.0,583.0,583.0
0.069,6,10,1506,5,395,15.0,127.0,127.0,5,1111,13.0,843.0,843.0
15.073,17,15,9238,8,6902,2149.0,1350.0,834.0,7,2336,2507.0,1350.0,305.0
0.137,6,10,1506,5,395,31.0,127.0,127.0,5,1111,29.0,843.0,843.0
40.064,17,10,676,5,460,10014.0,104.0,64.0,5,216,10015.0,20.0,15.0
0.119,6,10,1506,5,395,25.0,127.0,127.0,5,1111,27.0,843.0,843.0
0.01,6,10,1989,5,910,2.0,642.0,642.0,5,1079,2.0,811.0,811.0
0.118,6,10,1506,5,395,27.0,127.0,127.0,5,1111,26.0,843.0,843.0
10.863,17,28,4422,14,1994,826.0,269.0,114.0,14,2428,826.0,587.0,145.0
0.004,17,2,148,1,60,0.0,32.0,32.0,1,88,0.0,60.0,60.0
0.073,6,10,1506,5,395,16.0,127.0,127.0,5,1111,16.0,843.0,843.0
0.005,17,2,230,1,68,0.0,40.0,40.0,1,162,0.0,134.0,134.0
0.018,6,10,1972,5,910,4.0,642.0,642.0,5,1062,4.0,794.0,794.0
0.117,17,2,412,1,61,0.0,33.0,33.0,1,351,0.0,323.0,323.0
352.757,6,20,2210,6,1308,12003.0,494.0,494.0,14,902,27134.0,83.0,83.0
0.114,6,10,1506,5,395,25.0,127.0,127.0,5,1111,27.0,843.0,843.0
0.066,17,8,3613,4,1874,22.0,1350.0,440.0,4,1739,11.0,1350.0,406.0
0.003,17,2,148,1,60,0.0,32.0,32.0,1,88,0.0,60.0,60.0
1778.3,17,141,44556,72,22752,25045.0,288.0,288.0,69,21804,26147.0,288.0,288.0
10.822,17,28,4417,14,1994,824.0,269.0,114.0,14,2423,824.0,586.0,145.0
0.001,17,2,136,1,60,0.0,32.0,32.0,1,76,0.0,48.0,48.0
0.003,17,2,136,1,60,0.0,32.0,32.0,1,76,0.0,48.0,48.0
0.011,6,10,1990,5,911,2.0,643.0,643.0,5,1079,2.0,811.0,811.0
0.016,6,10,1983,5,910,4.0,642.0,642.0,5,1073,3.0,805.0,805.0
0.013,6,10,1631,5,848,3.0,580.0,580.0,5,783,3.0,515.0,515.0
1772.477,6,101,6062,58,3421,31095.0,27.0,27.0,43,2641,42200.0,27.0,27.0
0.005,17,2,146,1,65,0.0,37.0,37.0,1,81,0.0,53.0,53.0
0.083,6,10,1506,5,395,17.0,127.0,127.0,5,1111,17.0,843.0,843.0
0.2,6,3,453,2,321,200.0,241.0,241.0,1,132,0.0,92.0,92.0
40.048,17,10,676,5,460,10005.0,104.0,64.0,5,216,10009.0,20.0,15.0
0.266,17,40,21457,22,18426,12.0,1350.0,809.0,18,3031,12.0,1350.0,140.0
0.004,6,10,2000,5,927,1.0,659.0,659.0,5,1073,1.0,805.0,805.0
0.005,6,13,3747,7,509,0.0,137.0,137.0,6,3238,0.0,1470.0,1459.0
0.009,6,10,1983,5,910,2.0,642.0,642.0,5,1073,2.0,805.0,805.0
0.005,6,10,2007,5,928,1.0,660.0,660.0,5,1079,1.0,811.0,811.0
0.254,6,16,2783,8,1401,36.0,533.0,325.0,8,1382,24.0,529.0,239.0
0.005,6,13,3747,7,509,0.0,137.0,137.0,6,3238,0.0,1470.0,1459.0
0.143,6,10,1506,5,395,32.0,127.0,127.0,5,1111,33.0,843.0,843.0
240.099,6,16,4481,9,963,30012.0,238.0,166.0,7,3518,40016.0,1402.0,786.0
10.94,17,26,4100,13,1847,902.0,270.0,114.0,13,2253,902.0,588.0,145.0
0.009,6,13,3735,7,497,1.0,125.0,125.0,6,3238,1.0,1470.0,1459.0
0.004,6,10,2006,5,927,1.0,659.0,659.0,5,1079,1.0,811.0,811.0
0.016,6,10,1989,5,910,4.0,642.0,642.0,5,1079,4.0,811.0,811.0
0.012,6,14,3787,7,497,2.0,125.0,125.0,7,3290,2.0,1448.0,972.0
0.006,6,10,1547,5,764,1.0,496.0,496.0,5,783,1.0,515.0,515.0
0.011,6,10,1972,5,910,2.0,642.0,642.0,5,1062,2.0,794.0,794.0
0.005,17,2,164,1,74,0.0,46.0,46.0,1,90,0.0,62.0,62.0
0.108,6,10,1506,5,395,24.0,127.0,127.0,5,1111,19.0,843.0,843.0
0.004,6,10,2006,5,927,1.0,659.0,659.0,5,1079,1.0,811.0,811.0
0.014,6,10,1989,5,910,3.0,642.0,642.0,5,1079,3.0,811.0,811.0
0.006,6,10,1689,5,839,1.0,571.0,571.0,5,850,1.0,582.0,582.0
0.083,6,10,1506,5,395,19.0,127.0,127.0,5,1111,18.0,843.0,843.0
11.033,17,28,4389,14,2311,840.0,586.0,137.0,14,2078,840.0,269.0,120.0
0.005,6,10,1854,5,889,1.0,621.0,621.0,5,965,1.0,697.0,697.0
0.002,17,2,136,1,60,0.0,32.0,32.0,1,76,0.0,48.0,48.0
166.309,17,76,11082,38,2555,4494.0,44.0,39.0,38,8527,4494.0,239.0,196.0
0.004,6,10,2006,5,927,1.0,659.0,659.0,5,1079,1.0,811.0,811.0
0.007,17,2,179,1,71,0.0,43.0,43.0,1,108,0.0,80.0,80.0
0.009,6,10,1983,5,910,2.0,642.0,642.0,5,1073,2.0,805.0,805.0
0.015,6,13,3735,7,497,2.0,125.0,125.0,6,3238,2.0,1470.0,1459.0
0.106,6,10,1506,5,395,21.0,127.0,127.0,5,1111,23.0,843.0,843.0
0.006,6,10,1854,5,889,1.0,621.0,621.0,5,965,1.0,697.0,697.0
0.005,6,13,3747,7,509,0.0,137.0,137.0,6,3238,0.0,1470.0,1459.0
0.01,6,10,1643,5,860,2.0,592.0,592.0,5,783,2.0,515.0,515.0
0.005,6,10,2006,5,927,1.0,659.0,659.0,5,1079,1.0,811.0,811.0
0.005,6,10,2007,5,928,1.0,660.0,660.0,5,1079,1.0,811.0,811.0
0.005,6,13,3747,7,509,0.0,137.0,137.0,6,3238,1.0,1470.0,1459.0
9.038,17,6,376,5,280,2259.0,28.0,28.0,1,96,0.0,68.0,68.0
0.065,6,10,1506,5,395,15.0,127.0,127.0,5,1111,15.0,843.0,843.0
294.871,6,339,345461,127,18152,2340.0,2736.0,888.0,212,327309,1397.0,2804.0,1597.0
0.005,6,10,1689,5,839,1.0,571.0,571.0,5,850,1.0,582.0,582.0
0.187,6,25,6043,14,1573,13.0,326.0,165.0,11,4470,17.0,1324.0,778.0
0.009,6,10,1990,5,911,2.0,643.0,643.0,5,1079,2.0,811.0,811.0
0.004,6,10,2006,5,927,1.0,659.0,659.0,5,1079,1.0,811.0,811.0
27.231,6,25,7988,14,1822,2094.0,815.0,362.0,11,6166,2722.0,1402.0,798.0
173.28,17,84,11830,42,2799,4226.0,44.0,38.0,42,9031,4226.0,239.0,187.0
0.006,6,10,1547,5,764,1.0,496.0,496.0,5,783,1.0,515.0,515.0
0.1,6,10,1506,5,395,23.0,127.0,127.0,5,1111,23.0,843.0,843.0
0.017,6,10,1762,5,911,4.0,643.0,643.0,5,851,4.0,583.0,583.0
0.013,6,10,1990,5,911,3.0,643.0,643.0,5,1079,3.0,811.0,811.0
0.009,6,10,1983,5,910,2.0,642.0,642.0,5,1073,2.0,805.0,805.0
0.012,6,10,1989,5,910,2.0,642.0,642.0,5,1079,3.0,811.0,811.0
0.018,6,10,1989,5,910,4.0,642.0,642.0,5,1079,4.0,811.0,811.0
0.015,6,13,3735,7,497,2.0,125.0,125.0,6,3238,3.0,1470.0,1459.0
0.129,6,10,1506,5,395,29.0,127.0,127.0,5,1111,30.0,843.0,843.0
0.013,6,10,1989,5,910,3.0,642.0,642.0,5,1079,3.0,811.0,811.0
0.1,6,10,1506,5,395,21.0,127.0,127.0,5,1111,20.0,843.0,843.0
300.29,6,16,2170,9,684,37515.0,146.0,146.0,7,1486,50020.0,419.0,398.0
0.169,17,2,152,1,76,0.0,48.0,48.0,1,76,0.0,48.0,48.0
0.006,6,10,1854,5,889,1.0,621.0,621.0,5,965,1.0,697.0,697.0
0.062,6,10,1506,5,395,13.0,127.0,127.0,5,1111,14.0,843.0,843.0
361.833,6,19,1689,15,978,25845.0,190.0,190.0,4,711,80014.0,495.0,495.0
0.005,6,10,2007,5,928,1.0,660.0,660.0,5,1079,1.0,811.0,811.0
0.005,6,10,1854,5,889,1.0,621.0,621.0,5,965,1.0,697.0,697.0
40.123,17,10,676,5,460,10030.0,104.0,64.0,5,216,10030.0,20.0,15.0
0.006,6,10,1689,5,839,1.0,571.0,571.0,5,850,1.0,582.0,582.0
0.025,6,10,1972,5,910,6.0,642.0,642.0,5,1062,6.0,794.0,794.0
0.029,6,13,3735,7,497,4.0,125.0,125.0,6,3238,5.0,1470.0,1459.0
0.009,6,10,1983,5,910,2.0,642.0,642.0,5,1073,2.0,805.0,805.0
0.099,6,10,1506,5,395,21.0,127.0,127.0,5,1111,21.0,843.0,843.0
0.003,17,4,284,2,120,0.0,32.0,32.0,2,164,0.0,60.0,54.0
0.08,6,10,1506,5,395,17.0,127.0,127.0,5,1111,16.0,843.0,843.0
0.084,6,10,1506,5,395,18.0,127.0,127.0,5,1111,19.0,843.0,843.0
40.046,17,10,676,5,460,10008.0,104.0,64.0,5,216,10010.0,20.0,15.0
0.012,6,10,1990,5,911,2.0,643.0,643.0,5,1079,3.0,811.0,811.0
0.004,6,10,2006,5,927,1.0,659.0,659.0,5,1079,1.0,811.0,811.0
0.001,17,2,180,1,66,0.0,38.0,38.0,1,114,0.0,86.0,86.0
0.001,17,2,136,1,60,0.0,32.0,32.0,1,76,0.0,48.0,48.0
0.105,6,10,1506,5,395,24.0,127.0,127.0,5,1111,21.0,843.0,843.0
0.019,6,10,1762,5,911,4.0,643.0,643.0,5,851,4.0,583.0,583.0
0.045,17,2,152,1,76,0.0,48.0,48.0,1,76,0.0,48.0,48.0
0.005,6,10,2006,5,927,1.0,659.0,659.0,5,1079,1.0,811.0,811.0
40.073,17,10,676,5,460,10015.0,104.0,64.0,5,216,10017.0,20.0,15.0
0.005,17,2,200,1,68,0.0,40.0,40.0,1,132,0.0,104.0,104.0
0.105,6,10,1506,5,395,25.0,127.0,127.0,5,1111,24.0,843.0,843.0
0.129,17,2,80,1,32,0.0,4.0,4.0,1,48,0.0,20.0,20.0
0.013,6,10,1989,5,910,3.0,642.0,642.0,5,1079,3.0,811.0,811.0
1770.309,6,84,4420,42,2210,43177.0,26.0,26.0,42,2210,43177.0,26.0,26.0
0.004,17,2,136,1,60,0.0,32.0,32.0,1,76,0.0,48.0,48.0
0.006,6,10,1547,5,764,1.0,496.0,496.0,5,783,1.0,515.0,515.0
0.005,6,10,2006,5,927,1.0,659.0,659.0,5,1079,1.0,811.0,811.0
0.005,6,10,2000,5,927,1.0,659.0,659.0,5,1073,1.0,805.0,805.0
0.006,17,2,255,1,82,0.0,54.0,54.0,1,173,0.0,145.0,145.0
0.005,6,10,1989,5,927,1.0,659.0,659.0,5,1062,1.0,794.0,794.0
40.054,17,10,676,5,460,10012.0,104.0,64.0,5,216,10012.0,20.0,15.0
0.123,17,2,136,1,60,0.0,32.0,32.0,1,76,0.0,48.0,48.0
0.099,6,10,1506,5,395,20.0,127.0,127.0,5,1111,22.0,843.0,843.0
0.005,6,14,3799,7,509,0.0,137.0,137.0,7,3290,0.0,1448.0,972.0
0.005,6,10,2007,5,928,1.0,660.0,660.0,5,1079,1.0,811.0,811.0
0.005,6,10,1547,5,764,1.0,496.0,496.0,5,783,1.0,515.0,515.0
0.077,6,10,1506,5,395,18.0,127.0,127.0,5,1111,16.0,843.0,843.0
0.012,6,10,1972,5,910,3.0,642.0,642.0,5,1062,2.0,794.0,794.0
0.004,6,10,2006,5,927,1.0,659.0,659.0,5,1079,1.0,811.0,811.0
0.001,17,2,136,1,60,0.0,32.0,32.0,1,76,0.0,48.0,48.0
0.004,6,10,2007,5,928,1.0,660.0,660.0,5,1079,1.0,811.0,811.0
0.007,17,2,194,1,59,0.0,31.0,31.0,1,135,0.0,107.0,107.0
0.007,6,10,1990,5,911,1.0,643.0,643.0,5,1079,1.0,811.0,811.0
0.016,6,13,3735,7,497,2.0,125.0,125.0,6,3238,3.0,1470.0,1459.0
84.859,6,24,5611,14,3029,6527.0,517.0,382.0,10,2582,9428.0,477.0,410.0
0.164,6,10,1506,5,395,38.0,127.0,127.0,5,1111,36.0,843.0,843.0
40.076,17,10,676,5,460,10014.0,104.0,64.0,5,216,10011.0,20.0,15.0
0.006,17,2,214,1,75,0.0,47.0,47.0,1,139,0.0,111.0,111.0
0.108,6,10,1506,5,395,22.0,127.0,127.0,5,1111,20.0,843.0,843.0
0.005,6,10,1779,5,928,1.0,660.0,660.0,5,851,1.0,583.0,583.0
0.009,6,12,1926,6,1189,1.0,659.0,434.0,6,737,1.0,417.0,417.0
240.096,6,16,4481,9,963,30012.0,238.0,166.0,7,3518,40015.0,1402.0,786.0
0.085,6,10,1506,5,395,19.0,127.0,127.0,5,1111,16.0,843.0,843.0
0.071,17,4,352,2,130,1.0,37.0,37.0,2,222,31.0,89.0,83.0
0.005,6,13,3747,7,509,0.0,137.0,137.0,6,3238,0.0,1470.0,1459.0
0.013,6,10,1972,5,910,3.0,642.0,642.0,5,1062,3.0,794.0,794.0
0.012,6,13,3735,7,497,2.0,125.0,125.0,6,3238,2.0,1470.0,1459.0
0.005,17,2,180,1,58,0.0,30.0,30.0,1,122,0.0,94.0,94.0
173.168,17,80,11642,40,2690,4440.0,44.0,39.0,40,8952,4440.0,239.0,195.0
0.005,6,10,2006,5,927,1.0,659.0,659.0,5,1079,1.0,811.0,811.0
0.154,6,10,1506,5,395,34.0,127.0,127.0,5,1111,35.0,843.0,843.0
40.088,17,10,676,5,460,10020.0,104.0,64.0,5,216,10021.0,20.0,15.0
0.073,17,2,412,1,61,0.0,33.0,33.0,1,351,0.0,323.0,323.0
300.324,6,16,2170,9,684,37520.0,146.0,146.0,7,1486,50026.0,419.0,398.0
0.095,6,10,1506,5,395,20.0,127.0,127.0,5,1111,20.0,843.0,843.0
0.009,6,10,2007,5,928,2.0,660.0,660.0,5,1079,2.0,811.0,811.0
0.134,6,10,1506,5,395,29.0,127.0,127.0,5,1111,29.0,843.0,843.0
300.973,6,47,15480,25,9528,12540.0,2720.0,1212.0,22,5952,419.0,2667.0,361.0
0.005,6,10,1989,5,927,1.0,659.0,659.0,5,1062,1.0,794.0,794.0
0.004,6,10,1989,5,927,1.0,659.0,659.0,5,1062,1.0,794.0,794.0
0.016,6,10,1972,5,910,4.0,642.0,642.0,5,1062,3.0,794.0,794.0
40.068,17,10,676,5,460,10016.0,104.0,64.0,5,216,10016.0,20.0,15.0
0.115,6,10,1506,5,395,26.0,127.0,127.0,5,1111,26.0,843.0,843.0
0.098,6,10,1506,5,395,22.0,127.0,127.0,5,1111,22.0,843.0,843.0
0.248,17,4,352,2,130,175.0,37.0,37.0,2,222,176.0,89.0,83.0
0.001,17,2,180,1,66,0.0,38.0,38.0,1,114,0.0,86.0,86.0
0.005,17,2,169,1,62,0.0,34.0,34.0,1,107,0.0,79.0,79.0
0.087,6,10,1506,5,395,20.0,127.0,127.0,5,1111,19.0,843.0,843.0
0.072,17,2,150,1,61,0.0,33.0,33.0,1,89,0.0,61.0,61.0
300.377,6,16,2170,9,684,37525.0,146.0,146.0,7,1486,50035.0,419.0,398.0
0.006,6,10,1547,5,764,1.0,496.0,496.0,5,783,1.0,515.0,515.0
0.012,6,10,1677,5,827,3.0,559.0,559.0,5,850,2.0,582.0,582.0
168.323,17,82,11499,41,2750,4207.0,44.0,39.0,41,8749,4208.0,261.0,185.0
15.069,17,15,9239,8,6902,2148.0,1350.0,834.0,7,2337,2506.0,1350.0,305.0
0.168,17,2,152,1,76,0.0,48.0,48.0,1,76,0.0,48.0,48.0
0.006,6,12,1698,6,863,1.0,327.0,271.0,6,835,1.0,515.0,515.0
0.005,17,2,164,1,74,0.0,46.0,46.0,1,90,0.0,62.0,62.0
0.005,6,10,2006,5,927,1.0,659.0,659.0,5,1079,1.0,811.0,811.0
309.441,17,20,1124,10,716,34368.0,48.0,43.0,10,408,34368.0,20.0,12.0
40.065,17,10,676,5,460,10015.0,104.0,64.0,5,216,10015.0,20.0,15.0
0.014,17,2,180,1,66,0.0,38.0,38.0,1,114,0.0,86.0,86.0
0.006,6,10,1547,5,764,1.0,496.0,496.0,5,783,1.0,515.0,515.0
0.014,6,10,1989,5,910,3.0,642.0,642.0,5,1079,3.0,811.0,811.0
0.006,17,2,169,1,62,0.0,34.0,34.0,1,107,0.0,79.0,79.0
0.005,6,14,3742,8,504,0.0,80.0,80.0,6,3238,0.0,1470.0,1459.0
0.705,6,22,5072,11,1250,59.0,325.0,133.0,11,3822,59.0,1414.0,563.0
10.816,17,28,4421,14,1995,823.0,270.0,114.0,14,2426,823.0,585.0,145.0
0.005,17,2,170,1,65,0.0,37.0,37.0,1,105,0.0,77.0,77.0
0.073,17,2,148,1,60,0.0,32.0,32.0,1,88,0.0,60.0,60.0
0.005,17,2,164,1,74,0.0,46.0,46.0,1,90,0.0,62.0,62.0
0.004,6,10,2006,5,927,1.0,659.0,659.0,5,1079,1.0,811.0,811.0
0.004,6,10,2007,5,928,1.0,660.0,660.0,5,1079,1.0,811.0,811.0
0.005,6,10,1643,5,860,1.0,592.0,592.0,5,783,1.0,515.0,515.0
0.07,6,10,1506,5,395,15.0,127.0,127.0,5,1111,14.0,843.0,843.0
40.067,17,10,676,5,460,10014.0,104.0,64.0,5,216,10015.0,20.0,15.0
0.009,6,10,1990,5,911,2.0,643.0,643.0,5,1079,2.0,811.0,811.0
1770.791,6,87,4629,44,2342,41180.0,27.0,27.0,43,2287,42160.0,27.0,25.0
0.126,6,10,1506,5,395,29.0,127.0,127.0,5,1111,29.0,843.0,843.0
0.074,6,10,1506,5,395,17.0,127.0,127.0,5,1111,16.0,843.0,843.0
0.011,6,10,1989,5,910,2.0,642.0,642.0,5,1079,2.0,811.0,811.0
308.607,17,20,1124,10,716,34275.0,48.0,43.0,10,408,34275.0,20.0,12.0
0.003,6,10,1702,5,863,0.0,595.0,595.0,5,839,0.0,571.0,571.0
0.016,17,2,198,1,91,0.0,63.0,63.0,1,107,0.0,79.0,79.0
0.005,6,10,2006,5,927,1.0,659.0,659.0,5,1079,1.0,811.0,811.0
240.187,6,30,11485,15,5640,17156.0,1368.0,808.0,15,5845,17155.0,1656.0,722.0
0.004,17,2,136,1,60,0.0,32.0,32.0,1,76,0.0,48.0,48.0
0.01,6,10,1631,5,848,2.0,580.0,580.0,5,783,2.0,515.0,515.0
0.005,6,10,2006,5,927,1.0,659.0,659.0,5,1079,1.0,811.0,811.0
0.001,17,2,136,1,60,0.0,32.0,32.0,1,76,0.0,48.0,48.0
0.006,6,10,1689,5,839,1.0,571.0,571.0,5,850,1.0,582.0,582.0
0.012,6,10,1762,5,911,3.0,643.0,643.0,5,851,3.0,583.0,583.0
0.102,6,10,1506,5,395,23.0,127.0,127.0,5,1111,20.0,843.0,843.0
0.014,6,10,1990,5,911,3.0,643.0,643.0,5,1079,3.0,811.0,811.0
0.006,6,10,1547,5,764,1.0,496.0,496.0,5,783,1.0,515.0,515.0
0.006,6,10,1547,5,764,1.0,496.0,496.0,5,783,1.0,515.0,515.0
0.011,6,10,1972,5,910,2.0,642.0,642.0,5,1062,2.0,794.0,794.0
0.029,6,10,1972,5,910,7.0,642.0,642.0,5,1062,7.0,794.0,794.0
0.088,6,10,1506,5,395,19.0,127.0,127.0,5,1111,19.0,843.0,843.0
0.006,6,10,1854,5,889,1.0,621.0,621.0,5,965,1.0,697.0,697.0
0.015,6,13,3735,7,497,2.0,125.0,125.0,6,3238,2.0,1470.0,1459.0
0.005,17,2,170,1,65,0.0,37.0,37.0,1,105,0.0,77.0,77.0
266.06,58,3,216,2,144,266060.0,24.0,24.0,1,72,0.0,24.0,24.0
0.006,6,10,1547,5,764,1.0,496.0,496.0,5,783,1.0,515.0,515.0
0.008,17,2,140,1,62,0.0,34.0,34.0,1,78,0.0,50.0,50.0
240.138,6,33,10473,16,8080,16009.0,2883.0,725.0,17,2393,15008.0,580.0,187.0
0.005,6,10,2007,5,928,1.0,660.0,660.0,5,1079,1.0,811.0,811.0
0.016,17,2,180,1,66,0.0,38.0,38.0,1,114,0.0,86.0,86.0
0.093,6,10,1506,5,395,22.0,127.0,127.0,5,1111,20.0,843.0,843.0
0.01,6,10,1989,5,910,2.0,642.0,642.0,5,1079,2.0,811.0,811.0
0.009,6,10,1989,5,910,2.0,642.0,642.0,5,1079,2.0,811.0,811.0
0.005,17,2,154,1,69,0.0,41.0,41.0,1,85,0.0,57.0,57.0
0.221,17,4,596,2,122,182.0,33.0,33.0,2,474,149.0,323.0,209.0
0.011,6,10,1990,5,911,2.0,643.0,643.0,5,1079,2.0,811.0,811.0
1769.053,17,92,8096,46,4048,39312.0,60.0,60.0,46,4048,39312.0,60.0,60.0
41.879,6,36,9195,18,3677,518.0,1360.0,731.0,18,5518,2453.0,2667.0,435.0
0.071,6,10,1506,5,395,14.0,127.0,127.0,5,1111,16.0,843.0,843.0
0.008,6,10,1989,5,927,1.0,659.0,659.0,5,1062,2.0,794.0,794.0
0.009,6,10,1972,5,910,2.0,642.0,642.0,5,1062,2.0,794.0,794.0
0.005,17,2,170,1,65,0.0,37.0,37.0,1,105,0.0,77.0,77.0
165.347,17,78,10801,39,2600,4351.0,44.0,38.0,39,8201,4351.0,239.0,182.0
0.005,17,2,170,1,65,0.0,37.0,37.0,1,105,0.0,77.0,77.0
0.005,6,10,1643,5,860,1.0,592.0,592.0,5,783,1.0,515.0,515.0
0.005,6,10,2006,5,927,1.0,659.0,659.0,5,1079,1.0,811.0,811.0
0.04,17,4,596,2,122,1.0,33.0,33.0,2,474,36.0,323.0,209.0
0.001,17,2,180,1,66,0.0,38.0,38.0,1,114,0.0,86.0,86.0
0.25,6,12,2996,7,549,41.0,177.0,177.0,5,2447,34.0,1402.0,1089.0
0.005,6,10,1989,5,927,1.0,659.0,659.0,5,1062,1.0,794.0,794.0
178.485,17,88,12596,44,2960,4150.0,44.0,39.0,44,9636,4150.0,249.0,191.0
40.07,17,10,676,5,460,10016.0,104.0,64.0,5,216,10016.0,20.0,15.0
0.08,6,10,1506,5,395,18.0,127.0,127.0,5,1111,17.0,843.0,843.0
0.101,6,10,1506,5,395,23.0,127.0,127.0,5,1111,22.0,843.0,843.0
0.006,6,10,1547,5,764,1.0,496.0,496.0,5,783,1.0,515.0,515.0
0.091,6,10,1506,5,395,20.0,127.0,127.0,5,1111,20.0,843.0,843.0
0.066,17,8,3613,4,1874,22.0,1350.0,440.0,4,1739,11.0,1350.0,406.0
0.003,17,4,284,2,120,0.0,32.0,32.0,2,164,0.0,60.0,54.0
40.063,17,10,676,5,460,10012.0,104.0,64.0,5,216,10015.0,20.0,15.0
0.014,17,2,138,1,61,0.0,33.0,33.0,1,77,0.0,49.0,49.0
0.011,6,10,1990,5,911,2.0,643.0,643.0,5,1079,2.0,811.0,811.0
0.002,17,2,180,1,66,0.0,38.0,38.0,1,114,0.0,86.0,86.0
0.081,6,10,1506,5,395,16.0,127.0,127.0,5,1111,19.0,843.0,843.0
0.008,6,12,1926,6,1189,1.0,659.0,434.0,6,737,1.0,417.0,417.0
364.417,6,19,1691,15,978,26029.0,190.0,190.0,4,713,80016.0,497.0,497.0
0.208,6,16,2668,8,1394,29.0,533.0,323.0,8,1274,19.0,529.0,212.0
0.019,17,2,136,1,60,0.0,32.0,32.0,1,76,0.0,48.0,48.0
0.005,6,10,2007,5,928,1.0,660.0,660.0,5,1079,1.0,811.0,811.0
0.004,6,10,1779,5,928,1.0,660.0,660.0,5,851,1.0,583.0,583.0
0.006,6,10,1547,5,764,1.0,496.0,496.0,5,783,1.0,515.0,515.0
0.028,6,13,3735,7,497,4.0,125.0,125.0,6,3238,5.0,1470.0,1459.0
0.006,6,10,1643,5,860,1.0,592.0,592.0,5,783,1.0,515.0,515.0
0.009,6,10,1989,5,910,2.0,642.0,642.0,5,1079,2.0,811.0,811.0
0.055,6,10,1506,5,395,12.0,127.0,127.0,5,1111,12.0,843.0,843.0
0.103,6,10,1506,5,395,21.0,127.0,127.0,5,1111,21.0,843.0,843.0
40.057,17,10,676,5,460,10011.0,104.0,64.0,5,216,10013.0,20.0,15.0
0.004,17,2,136,1,60,0.0,32.0,32.0,1,76,0.0,48.0,48.0
0.013,6,10,1972,5,910,3.0,642.0,642.0,5,1062,3.0,794.0,794.0
0.105,6,10,1506,5,395,23.0,127.0,127.0,5,1111,24.0,843.0,843.0
0.006,6,10,2007,5,928,1.0,660.0,660.0,5,1079,1.0,811.0,811.0
0.015,6,10,1990,5,911,3.0,643.0,643.0,5,1079,3.0,811.0,811.0
0.015,6,10,1972,5,910,3.0,642.0,642.0,5,1062,3.0,794.0,794.0
40.076,17,10,676,5,460,10018.0,104.0,64.0,5,216,10018.0,20.0,15.0
0.005,6,10,1689,5,839,1.0,571.0,571.0,5,850,1.0,582.0,582.0
0.014,6,10,1989,5,910,3.0,642.0,642.0,5,1079,3.0,811.0,811.0
0.004,17,4,284,2,120,0.0,32.0,32.0,2,164,0.0,60.0,54.0
10.933,17,28,4422,14,1995,832.0,270.0,114.0,14,2427,832.0,586.0,145.0
300.384,6,27,8925,15,1930,21456.0,517.0,285.0,12,6995,21849.0,1402.0,909.0
0.003,17,2,136,1,60,0.0,32.0,32.0,1,76,0.0,48.0,48.0
0.011,6,10,1990,5,911,2.0,643.0,643.0,5,1079,2.0,811.0,811.0
0.136,17,4,420,2,122,0.0,33.0,33.0,2,298,128.0,145.0,121.0
0.001,17,2,180,1,66,0.0,38.0,38.0,1,114,0.0,86.0,86.0
0.006,17,2,186,1,60,0.0,32.0,32.0,1,126,0.0,98.0,98.0
0.084,6,10,1506,5,395,18.0,127.0,127.0,5,1111,18.0,843.0,843.0
0.072,6,10,1506,5,395,15.0,127.0,127.0,5,1111,16.0,843.0,843.0
0.005,6,10,2007,5,928,1.0,660.0,660.0,5,1079,1.0,811.0,811.0
0.105,6,10,1506,5,395,23.0,127.0,127.0,5,1111,21.0,843.0,843.0
0.005,6,10,2006,5,927,1.0,659.0,659.0,5,1079,1.0,811.0,811.0
0.006,17,2,140,1,62,0.0,34.0,34.0,1,78,0.0,50.0,50.0
0.013,6,10,1989,5,910,3.0,642.0,642.0,5,1079,3.0,811.0,811.0
0.01,6,10,1989,5,910,2.0,642.0,642.0,5,1079,2.0,811.0,811.0
293.332,6,385,347405,196,21750,1504.0,2736.0,888.0,189,325655,1560.0,4206.0,1804.0
0.016,6,10,1972,5,910,3.0,642.0,642.0,5,1062,4.0,794.0,794.0
0.005,17,2,169,1,62,0.0,34.0,34.0,1,107,0.0,79.0,79.0
0.039,17,2,144,1,64,0.0,36.0,36.0,1,80,0.0,52.0,52.0
240.22,6,33,10018,16,2091,16014.0,539.0,250.0,17,7927,15013.0,1402.0,640.0
0.006,6,10,1689,5,839,1.0,571.0,571.0,5,850,1.0,582.0,582.0
0.009,6,10,1990,5,911,2.0,643.0,643.0,5,1079,2.0,811.0,811.0
40.064,17,10,676,5,460,10014.0,104.0,64.0,5,216,10015.0,20.0,15.0
1.018,6,13,3930,7,2139,127.0,1328.0,923.0,6,1791,153.0,1539.0,1539.0
0.042,17,2,148,1,60,0.0,32.0,32.0,1,88,0.0,60.0,60.0
0.009,6,10,1983,5,910,2.0,642.0,642.0,5,1073,2.0,805.0,805.0
0.004,6,10,1989,5,927,1.0,659.0,659.0,5,1062,1.0,794.0,794.0
0.003,17,2,136,1,60,0.0,32.0,32.0,1,76,0.0,48.0,48.0
0.077,6,10,1506,5,395,17.0,127.0,127.0,5,1111,17.0,843.0,843.0
0.005,17,2,214,1,75,0.0,47.0,47.0,1,139,0.0,111.0,111.0
0.005,17,2,230,1,68,0.0,40.0,40.0,1,162,0.0,134.0,134.0
0.004,6,10,1774,5,923,1.0,655.0,655.0,5,851,1.0,583.0,583.0
0.001,17,2,136,1,60,0.0,32.0,32.0,1,76,0.0,48.0,48.0
0.361,17,43,21762,23,18466,16.0,1350.0,774.0,20,3296,15.0,1350.0,136.0
0.074,6,10,1506,5,395,14.0,127.0,127.0,5,1111,17.0,843.0,843.0
0.011,6,10,1983,5,910,2.0,642.0,642.0,5,1073,2.0,805.0,805.0
0.004,17,2,136,1,60,0.0,32.0,32.0,1,76,0.0,48.0,48.0
0.006,6,10,1547,5,764,1.0,496.0,496.0,5,783,1.0,515.0,515.0
0.007,6,10,1547,5,764,1.0,496.0,496.0,5,783,1.0,515.0,515.0
0.001,17,2,180,1,66,0.0,38.0,38.0,1,114,0.0,86.0,86.0
0.005,6,10,2007,5,928,1.0,660.0,660.0,5,1079,1.0,811.0,811.0
300.383,6,16,2170,9,684,37526.0,146.0,146.0,7,1486,50035.0,419.0,398.0
0.017,6,10,1990,5,911,4.0,643.0,643.0,5,1079,4.0,811.0,811.0
0.105,6,10,1506,5,395,25.0,127.0,127.0,5,1111,23.0,843.0,843.0
240.096,6,16,4482,9,963,30012.0,238.0,166.0,7,3519,40015.0,1402.0,786.0
0.004,17,4,284,2,120,0.0,32.0,32.0,2,164,0.0,60.0,54.0
0.072,6,10,1506,5,395,15.0,127.0,127.0,5,1111,15.0,843.0,843.0
0.005,17,2,166,1,75,0.0,47.0,47.0,1,91,0.0,63.0,63.0
40.05,17,10,676,5,460,10011.0,104.0,64.0,5,216,10011.0,20.0,15.0
240.113,6,17,7648,8,6879,34301.0,2736.0,1616.0,9,769,30013.0,293.0,293.0
0.006,17,2,228,1,82,0.0,54.0,54.0,1,146,0.0,118.0,118.0
0.015,6,10,1989,5,910,3.0,642.0,642.0,5,1079,3.0,811.0,811.0
10.902,17,28,4422,14,1995,830.0,270.0,114.0,14,2427,830.0,586.0,145.0
0.014,6,10,1762,5,911,3.0,643.0,643.0,5,851,3.0,583.0,583.0
0.165,6,10,1506,5,395,34.0,127.0,127.0,5,1111,38.0,843.0,843.0
0.013,6,10,1989,5,927,3.0,659.0,659.0,5,1062,3.0,794.0,794.0
0.014,6,10,1989,5,910,3.0,642.0,642.0,5,1079,3.0,811.0,811.0
0.005,6,13,3747,7,509,0.0,137.0,137.0,6,3238,1.0,1470.0,1459.0
40.06,17,10,676,5,460,10014.0,104.0,64.0,5,216,10014.0,20.0,15.0
0.111,6,10,1506,5,395,26.0,127.0,127.0,5,1111,21.0,843.0,843.0
0.012,6,10,1972,5,910,3.0,642.0,642.0,5,1062,2.0,794.0,794.0
308.434,17,20,1124,10,716,34255.0,48.0,43.0,10,408,34255.0,20.0,12.0
0.016,6,10,1972,5,910,3.0,642.0,642.0,5,1062,3.0,794.0,794.0
0.006,6,10,1547,5,764,1.0,496.0,496.0,5,783,1.0,515.0,515.0
0.004,6,10,1989,5,927,1.0,659.0,659.0,5,1062,1.0,794.0,794.0
40.058,17,10,676,5,460,10012.0,104.0,64.0,5,216,10013.0,20.0,15.0
0.134,17,2,80,1,32,0.0,4.0,4.0,1,48,0.0,20.0,20.0
0.001,17,2,136,1,60,0.0,32.0,32.0,1,76,0.0,48.0,48.0
0.077,6,10,1506,5,395,18.0,127.0,127.0,5,1111,14.0,843.0,843.0
15.079,17,14,9190,8,6902,2149.0,1350.0,834.0,6,2288,3009.0,1350.0,353.0
0.001,17,2,179,1,62,0.0,34.0,34.0,1,117,0.0,89.0,89.0
309.174,17,20,1124,10,716,34344.0,48.0,43.0,10,408,34343.0,20.0,12.0
0.001,17,2,180,1,66,0.0,38.0,38.0,1,114,0.0,86.0,86.0
0.053,17,2,152,1,76,0.0,48.0,48.0,1,76,0.0,48.0,48.0
0.111,6,10,1506,5,395,24.0,127.0,127.0,5,1111,25.0,843.0,843.0
0.04,17,2,152,1,76,0.0,48.0,48.0,1,76,0.0,48.0,48.0
10.93,17,28,4417,14,1994,831.0,269.0,114.0,14,2423,830.0,586.0,145.0
40.063,17,10,676,5,460,10012.0,104.0,64.0,5,216,10015.0,20.0,15.0
0.005,6,10,1989,5,927,1.0,659.0,659.0,5,1062,1.0,794.0,794.0
0.06,17,2,152,1,76,0.0,48.0,48.0,1,76,0.0,48.0,48.0
0.001,17,2,180,1,66,0.0,38.0,38.0,1,114,0.0,86.0,86.0
0.105,6,10,1506,5,395,23.0,127.0,127.0,5,1111,25.0,843.0,843.0
240.116,6,31,9552,15,7021,17151.0,2144.0,693.0,16,2531,16007.0,580.0,211.0
0.004,17,2,136,1,60,0.0,32.0,32.0,1,76,0.0,48.0,48.0
0.016,6,10,1983,5,910,3.0,642.0,642.0,5,1073,4.0,805.0,805.0
0.003,17,2,136,1,60,0.0,32.0,32.0,1,76,0.0,48.0,48.0
0.042,17,2,184,1,61,0.0,33.0,33.0,1,123,0.0,95.0,95.0
0.016,6,10,1989,5,910,3.0,642.0,642.0,5,1079,4.0,811.0,811.0
0.109,6,10,1506,5,395,19.0,127.0,127.0,5,1111,23.0,843.0,843.0
0.006,6,10,1689,5,839,1.0,571.0,571.0,5,850,1.0,582.0,582.0
1774.444,6,240,46333,115,33878,15565.0,2470.0,995.0,125,12455,14309.0,580.0,61.0
0.012,6,10,1990,5,911,2.0,643.0,643.0,5,1079,3.0,811.0,811.0
0.012,17,2,179,1,71,0.0,43.0,43.0,1,108,0.0,80.0,80.0
0.011,6,10,1983,5,910,2.0,642.0,642.0,5,1073,2.0,805.0,805.0
334.598,17,20,1124,10,716,37163.0,48.0,43.0,10,408,37163.0,20.0,12.0
0.126,17,2,80,1,32,0.0,4.0,4.0,1,48,0.0,20.0,20.0
0.001,17,2,180,1,66,0.0,38.0,38.0,1,114,0.0,86.0,86.0
309.825,17,20,1124,10,716,34412.0,48.0,43.0,10,408,34412.0,20.0,12.0
172.729,6,22,8499,12,2236,71.0,1345.0,574.0,10,6263,19173.0,2720.0,975.0
40.059,17,10,676,5,460,10014.0,104.0,64.0,5,216,10012.0,20.0,15.0
0.016,6,10,1989,5,910,4.0,642.0,642.0,5,1079,3.0,811.0,811.0
0.005,17,2,214,1,75,0.0,47.0,47.0,1,139,0.0,111.0,111.0
161.374,6,22,7437,11,1305,114.0,530.0,277.0,11,6132,16120.0,1823.0,946.0
0.004,6,10,2006,5,927,1.0,659.0,659.0,5,1079,1.0,811.0,811.0
366.006,6,22,2313,16,867,24400.0,195.0,195.0,6,1446,4642.0,419.0,398.0
0.001,17,2,136,1,60,0.0,32.0,32.0,1,76,0.0,48.0,48.0
0.013,17,2,152,1,56,0.0,28.0,28.0,1,96,0.0,68.0,68.0
0.165,6,10,1506,5,395,25.0,127.0,127.0,5,1111,34.0,843.0,843.0
10.86,17,28,4423,14,1995,826.0,270.0,114.0,14,2428,826.0,587.0,145.0
0.234,17,42,24310,24,21168,10.0,1350.0,854.0,18,3142,10.0,1350.0,146.0
0.082,6,10,1506,5,395,18.0,127.0,127.0,5,1111,14.0,843.0,843.0
0.005,6,10,2006,5,927,1.0,659.0,659.0,5,1079,1.0,811.0,811.0
0.01,6,10,1989,5,910,2.0,642.0,642.0,5,1079,2.0,811.0,811.0
0.013,6,10,1972,5,910,3.0,642.0,642.0,5,1062,3.0,794.0,794.0
0.006,17,2,194,1,59,0.0,31.0,31.0,1,135,0.0,107.0,107.0
0.005,6,10,2007,5,928,1.0,660.0,660.0,5,1079,1.0,811.0,811.0
0.071,17,8,3613,4,1874,23.0,1350.0,440.0,4,1739,11.0,1350.0,406.0
0.005,6,10,1989,5,927,1.0,659.0,659.0,5,1062,1.0,794.0,794.0
356.58,6,21,1795,16,1030,23772.0,190.0,190.0,5,765,60001.0,464.0,248.0
0.005,6,10,2000,5,927,1.0,659.0,659.0,5,1073,1.0,805.0,805.0
0.038,17,2,182,1,65,0.0,37.0,37.0,1,117,0.0,89.0,89.0
40.052,17,10,676,5,460,10012.0,104.0,64.0,5,216,10012.0,20.0,15.0
0.042,17,4,352,2,130,0.0,37.0,37.0,2,222,5.0,89.0,83.0
0.004,6,10,1989,5,927,1.0,659.0,659.0,5,1062,1.0,794.0,794.0
0.006,6,13,3747,7,509,1.0,137.0,137.0,6,3238,1.0,1470.0,1459.0
0.102,6,10,1506,5,395,21.0,127.0,127.0,5,1111,24.0,843.0,843.0
0.005,6,10,1689,5,839,1.0,571.0,571.0,5,850,1.0,582.0,582.0
9.037,17,6,376,5,280,2259.0,28.0,28.0,1,96,0.0,68.0,68.0
0.006,6,10,1547,5,764,1.0,496.0,496.0,5,783,1.0,515.0,515.0
0.075,6,10,1506,5,395,15.0,127.0,127.0,5,1111,18.0,843.0,843.0
0.082,6,10,1506,5,395,18.0,127.0,127.0,5,1111,18.0,843.0,843.0
309.341,17,20,1124,10,716,34356.0,48.0,43.0,10,408,34357.0,20.0,12.0
0.005,6,10,2007,5,928,1.0,660.0,660.0,5,1079,1.0,811.0,811.0
0.005,6,10,2007,5,928,1.0,660.0,660.0,5,1079,1.0,811.0,811.0
0.011,6,10,1990,5,911,2.0,643.0,643.0,5,1079,2.0,811.0,811.0
0.185,17,2,152,1,76,0.0,48.0,48.0,1,76,0.0,48.0,48.0
0.006,6,10,1854,5,889,1.0,621.0,621.0,5,965,1.0,697.0,697.0
0.01,6,10,1990,5,911,2.0,643.0,643.0,5,1079,2.0,811.0,811.0
0.001,17,2,136,1,60,0.0,32.0,32.0,1,76,0.0,48.0,48.0
0.003,17,4,284,2,120,0.0,32.0,32.0,2,164,0.0,60.0,54.0
0.004,6,10,2006,5,927,1.0,659.0,659.0,5,1079,1.0,811.0,811.0
11.162,17,28,4418,14,1994,846.0,269.0,114.0,14,2424,846.0,587.0,145.0
0.105,6,10,1506,5,395,24.0,127.0,127.0,5,1111,23.0,843.0,843.0
0.011,6,10,1989,5,910,2.0,642.0,642.0,5,1079,2.0,811.0,811.0
0.113,6,10,1506,5,395,26.0,127.0,127.0,5,1111,25.0,843.0,843.0
1756.001,6,105,6240,60,3510,29761.0,26.0,26.0,45,2730,39908.0,26.0,26.0
0.005,17,2,302,1,65,0.0,37.0,37.0,1,237,0.0,209.0,209.0
240.1,6,16,4480,9,963,30012.0,238.0,166.0,7,3517,40016.0,1402.0,786.0
0.004,6,10,1702,5,863,1.0,595.0,595.0,5,839,1.0,571.0,571.0
0.005,17,2,282,1,69,0.0,41.0,41.0,1,213,0.0,185.0,185.0
0.007,17,2,194,1,59,0.0,31.0,31.0,1,135,0.0,107.0,107.0
0.01,6,10,1989,5,910,2.0,642.0,642.0,5,1079,2.0,811.0,811.0
0.007,6,10,1547,5,764,1.0,496.0,496.0,5,783,1.0,515.0,515.0
0.01,6,10,1989,5,910,2.0,642.0,642.0,5,1079,2.0,811.0,811.0
0.005,6,10,1779,5,928,1.0,660.0,660.0,5,851,1.0,583.0,583.0
1772.21,6,103,6166,59,3473,30554.0,27.0,27.0,44,2693,41213.0,27.0,27.0
0.019,6,10,1989,5,910,4.0,642.0,642.0,5,1079,4.0,811.0,811.0
0.006,6,10,1547,5,764,1.0,496.0,496.0,5,783,1.0,515.0,515.0
0.007,17,2,132,1,58,0.0,30.0,30.0,1,74,0.0,46.0,46.0
0.037,17,2,148,1,60,0.0,32.0,32.0,1,88,0.0,60.0,60.0
0.005,6,10,2006,5,927,1.0,659.0,659.0,5,1079,1.0,811.0,811.0
0.004,6,10,2006,5,927,1.0,659.0,659.0,5,1079,1.0,811.0,811.0
1772.375,17,92,8096,46,4048,39385.0,60.0,60.0,46,4048,39385.0,60.0,60.0
0.014,6,10,1677,5,827,3.0,559.0,559.0,5,850,3.0,582.0,582.0
0.01,6,10,1989,5,910,2.0,642.0,642.0,5,1079,2.0,811.0,811.0
0.012,6,10,1677,5,827,3.0,559.0,559.0,5,850,2.0,582.0,582.0
0.005,6,10,1689,5,839,1.0,571.0,571.0,5,850,1.0,582.0,582.0
0.126,17,2,136,1,60,0.0,32.0,32.0,1,76,0.0,48.0,48.0
0.11,6,10,1506,5,395,24.0,127.0,127.0,5,1111,26.0,843.0,843.0
0.005,6,10,2006,5,927,1.0,659.0,659.0,5,1079,1.0,811.0,811.0
0.054,17,2,152,1,76,0.0,48.0,48.0,1,76,0.0,48.0,48.0
0.006,17,2,140,1,62,0.0,34.0,34.0,1,78,0.0,50.0,50.0
0.005,6,10,2007,5,928,1.0,660.0,660.0,5,1079,1.0,811.0,811.0
40.103,17,10,676,5,460,10022.0,104.0,64.0,5,216,10024.0,20.0,15.0
0.139,6,10,1506,5,395,33.0,127.0,127.0,5,1111,26.0,843.0,843.0
0.006,6,10,1689,5,839,1.0,571.0,571.0,5,850,1.0,582.0,582.0
0.004,6,10,2000,5,927,1.0,659.0,659.0,5,1073,1.0,805.0,805.0
0.015,6,13,3735,7,497,2.0,125.0,125.0,6,3238,2.0,1470.0,1459.0
0.01,6,10,1989,5,910,2.0,642.0,642.0,5,1079,2.0,811.0,811.0
0.008,6,12,1926,6,1189,1.0,659.0,434.0,6,737,1.0,417.0,417.0
0.009,6,10,1989,5,910,2.0,642.0,642.0,5,1079,2.0,811.0,811.0
0.006,17,2,230,1,68,0.0,40.0,40.0,1,162,0.0,134.0,134.0
0.005,6,13,3690,7,452,0.0,80.0,80.0,6,3238,0.0,1470.0,1459.0
0.01,6,10,1989,5,910,2.0,642.0,642.0,5,1079,2.0,811.0,811.0
0.02,6,10,1983,5,910,4.0,642.0,642.0,5,1073,5.0,805.0,805.0
0.005,6,10,2000,5,927,1.0,659.0,659.0,5,1073,1.0,805.0,805.0
0.215,6,16,2777,8,1395,30.0,533.0,323.0,8,1382,19.0,529.0,239.0
0.07,6,10,1506,5,395,16.0,127.0,127.0,5,1111,16.0,843.0,843.0
0.018,6,10,1972,5,910,4.0,642.0,642.0,5,1062,4.0,794.0,794.0
40.055,17,10,676,5,460,10012.0,104.0,64.0,5,216,10013.0,20.0,15.0
0.011,6,10,1983,5,910,2.0,642.0,642.0,5,1073,2.0,805.0,805.0
0.01,17,2,148,1,60,0.0,32.0,32.0,1,88,0.0,60.0,60.0
300.712,6,37,8261,20,1830,15826.0,651.0,249.0,17,6431,535.0,2126.0,478.0
0.005,17,2,169,1,62,0.0,34.0,34.0,1,107,0.0,79.0,79.0
10.835,17,28,4423,14,1995,825.0,270.0,114.0,14,2428,824.0,587.0,145.0
0.006,6,10,1689,5,839,1.0,571.0,571.0,5,850,1.0,582.0,582.0
28.049,6,53,21389,27,15322,353.0,2720.0,1184.0,26,6067,1115.0,2667.0,385.0
0.004,6,10,1702,5,863,1.0,595.0,595.0,5,839,1.0,571.0,571.0
1778.617,17,144,45504,72,22752,25050.0,288.0,288.0,72,22752,25050.0,288.0,288.0
0.013,6,10,1990,5,911,3.0,643.0,643.0,5,1079,3.0,811.0,811.0
0.004,17,2,136,1,60,0.0,32.0,32.0,1,76,0.0,48.0,48.0
0.005,6,10,2006,5,927,1.0,659.0,659.0,5,1079,1.0,811.0,811.0
240.724,6,33,8637,17,1838,15043.0,571.0,189.0,16,6799,16045.0,1402.0,597.0
0.005,6,10,1643,5,860,1.0,592.0,592.0,5,783,1.0,515.0,515.0
0.039,17,2,136,1,60,0.0,32.0,32.0,1,76,0.0,48.0,48.0
0.006,6,10,1989,5,927,1.0,659.0,659.0,5,1062,1.0,794.0,794.0
0.005,6,10,1989,5,927,1.0,659.0,659.0,5,1062,1.0,794.0,794.0
0.072,6,10,1506,5,395,15.0,127.0,127.0,5,1111,15.0,843.0,843.0
0.023,6,10,1762,5,911,5.0,643.0,643.0,5,851,5.0,583.0,583.0
0.005,6,10,2007,5,928,1.0,660.0,660.0,5,1079,1.0,811.0,811.0
0.42,17,53,37163,32,29904,13.0,1350.0,906.0,21,7259,17.0,1350.0,317.0
0.012,6,13,3735,7,497,2.0,125.0,125.0,6,3238,2.0,1470.0,1459.0
0.016,6,10,1983,5,910,4.0,642.0,642.0,5,1073,4.0,805.0,805.0
240.122,6,33,10209,17,7922,15007.0,1515.0,640.0,16,2287,16007.0,580.0,206.0
0.008,6,10,1547,5,764,2.0,496.0,496.0,5,783,1.0,515.0,515.0
0.005,6,10,1689,5,839,1.0,571.0,571.0,5,850,1.0,582.0,582.0
0.012,6,10,1989,5,910,3.0,642.0,642.0,5,1079,3.0,811.0,811.0
1756.149,6,105,6270,60,3525,29764.0,27.0,27.0,45,2745,39911.0,27.0,27.0
0.001,17,2,136,1,60,0.0,32.0,32.0,1,76,0.0,48.0,48.0
0.008,6,12,1926,6,1189,1.0,659.0,434.0,6,737,1.0,417.0,417.0
0.094,6,10,1506,5,395,22.0,127.0,127.0,5,1111,20.0,843.0,843.0
0.086,6,10,1506,5,395,19.0,127.0,127.0,5,1111,17.0,843.0,843.0
0.01,6,12,1926,6,1189,2.0,659.0,434.0,6,737,1.0,417.0,417.0
0.009,6,10,1983,5,910,2.0,642.0,642.0,5,1073,2.0,805.0,805.0
0.077,6,10,1506,5,395,16.0,127.0,127.0,5,1111,17.0,843.0,843.0
0.009,6,10,1990,5,911,2.0,643.0,643.0,5,1079,2.0,811.0,811.0
0.002,17,2,180,1,66,0.0,38.0,38.0,1,114,0.0,86.0,86.0
0.013,6,10,1990,5,911,3.0,643.0,643.0,5,1079,3.0,811.0,811.0
0.005,6,10,2007,5,928,1.0,660.0,660.0,5,1079,1.0,811.0,811.0
0.079,6,10,1506,5,395,17.0,127.0,127.0,5,1111,18.0,843.0,843.0
10.96,17,28,4391,14,2313,834.0,588.0,137.0,14,2078,834.0,269.0,120.0
0.012,6,10,1762,5,911,2.0,643.0,643.0,5,851,3.0,583.0,583.0
0.088,6,10,1506,5,395,21.0,127.0,127.0,5,1111,18.0,843.0,843.0
0.075,17,2,234,1,61,0.0,33.0,33.0,1,173,0.0,145.0,145.0
0.015,6,10,1972,5,910,3.0,642.0,642.0,5,1062,3.0,794.0,794.0
0.003,17,4,284,2,120,0.0,32.0,32.0,2,164,0.0,60.0,54.0
0.005,6,10,2006,5,927,1.0,659.0,659.0,5,1079,1.0,811.0,811.0
0.009,6,12,1926,6,1189,1.0,659.0,434.0,6,737,1.0,417.0,417.0
0.013,6,10,1989,5,910,3.0,642.0,642.0,5,1079,3.0,811.0,811.0
0.039,17,2,148,1,60,0.0,32.0,32.0,1,88,0.0,60.0,60.0
126.022,6,14,2938,8,2504,17968.0,1414.0,1086.0,6,434,25156.0,182.0,182.0
0.004,6,10,1702,5,863,1.0,595.0,595.0,5,839,0.0,571.0,571.0
0.007,6,10,1689,5,839,1.0,571.0,571.0,5,850,1.0,582.0,582.0
0.008,6,10,1989,5,910,2.0,642.0,642.0,5,1079,2.0,811.0,811.0
0.041,17,2,136,1,60,0.0,32.0,32.0,1,76,0.0,48.0,48.0
0.008,6,10,1990,5,911,1.0,643.0,643.0,5,1079,2.0,811.0,811.0
0.013,6,10,1990,5,911,3.0,643.0,643.0,5,1079,3.0,811.0,811.0
0.148,6,10,1506,5,395,33.0,127.0,127.0,5,1111,32.0,843.0,843.0
40.062,17,10,676,5,460,10012.0,104.0,64.0,5,216,10014.0,20.0,15.0
0.066,6,10,1506,5,395,14.0,127.0,127.0,5,1111,16.0,843.0,843.0
0.149,6,10,1506,5,395,32.0,127.0,127.0,5,1111,34.0,843.0,843.0
0.006,6,10,1702,5,863,1.0,595.0,595.0,5,839,1.0,571.0,571.0
1799.997,6,259,31879,104,22004,17184.0,2720.0,209.0,155,9875,11687.0,225.0,51.0
0.011,6,10,1677,5,827,2.0,559.0,559.0,5,850,2.0,582.0,582.0
0.106,6,10,1506,5,395,22.0,127.0,127.0,5,1111,26.0,843.0,843.0
0.016,6,13,3735,7,497,2.0,125.0,125.0,6,3238,3.0,1470.0,1459.0
0.005,6,10,2007,5,928,1.0,660.0,660.0,5,1079,1.0,811.0,811.0
0.005,6,10,1689,5,839,1.0,571.0,571.0,5,850,1.0,582.0,582.0
0.014,6,6,716,3,458,5.0,302.0,302.0,3,258,5.0,102.0,102.0
0.014,6,10,1972,5,910,3.0,642.0,642.0,5,1062,3.0,794.0,794.0
240.345,6,33,8637,17,1838,15021.0,571.0,189.0,16,6799,16022.0,1402.0,597.0
0.004,6,10,1702,5,863,1.0,595.0,595.0,5,839,1.0,571.0,571.0
0.013,6,10,1762,5,911,3.0,643.0,643.0,5,851,3.0,583.0,583.0
0.128,6,10,1506,5,395,27.0,127.0,127.0,5,1111,29.0,843.0,843.0
0.014,6,10,1972,5,910,3.0,642.0,642.0,5,1062,3.0,794.0,794.0
178.069,17,72,10304,36,2410,5087.0,44.0,38.0,36,7894,5087.0,239.0,191.0
309.659,17,19,1084,10,716,34392.0,48.0,43.0,9,368,38692.0,20.0,12.0
0.02,6,10,1990,5,911,5.0,643.0,643.0,5,1079,4.0,811.0,811.0
15.074,17,15,9238,8,6902,2149.0,1350.0,834.0,7,2336,2507.0,1350.0,305.0
0.006,17,2,140,1,62,0.0,34.0,34.0,1,78,0.0,50.0,50.0
0.041,17,2,156,1,64,0.0,36.0,36.0,1,92,0.0,64.0,64.0
0.011,6,10,1989,5,910,2.0,642.0,642.0,5,1079,2.0,811.0,811.0
300.406,6,16,2170,9,684,37529.0,146.0,146.0,7,1486,50039.0,419.0,398.0
0.012,6,10,1989,5,910,3.0,642.0,642.0,5,1079,3.0,811.0,811.0
0.068,17,8,3613,4,1874,22.0,1350.0,440.0,4,1739,11.0,1350.0,406.0
0.005,6,10,2007,5,928,1.0,660.0,660.0,5,1079,1.0,811.0,811.0
0.004,6,10,1989,5,927,1.0,659.0,659.0,5,1062,1.0,794.0,794.0
0.086,6,10,1506,5,395,18.0,127.0,127.0,5,1111,20.0,843.0,843.0
0.097,6,10,1506,5,395,22.0,127.0,127.0,5,1111,21.0,843.0,843.0
11.183,17,28,4422,14,1994,847.0,269.0,114.0,14,2428,846.0,587.0,145.0
0.003,17,2,185,1,73,0.0,45.0,45.0,1,112,0.0,84.0,84.0
0.004,6,10,2000,5,927,1.0,659.0,659.0,5,1073,1.0,805.0,805.0
0.004,6,10,1702,5,863,1.0,595.0,595.0,5,839,0.0,571.0,571.0
0.006,17,2,169,1,62,0.0,34.0,34.0,1,107,0.0,79.0,79.0
0.005,6,10,1779,5,928,1.0,660.0,660.0,5,851,1.0,583.0,583.0
0.004,6,14,3742,8,504,0.0,80.0,80.0,6,3238,0.0,1470.0,1459.0
0.01,6,10,1989,5,910,2.0,642.0,642.0,5,1079,2.0,811.0,811.0
0.053,17,2,152,1,76,0.0,48.0,48.0,1,76,0.0,48.0,48.0
40.058,17,10,676,5,460,10013.0,104.0,64.0,5,216,10013.0,20.0,15.0
0.005,6,10,1643,5,860,1.0,592.0,592.0,5,783,1.0,515.0,515.0
0.005,17,2,144,1,64,0.0,36.0,36.0,1,80,0.0,52.0,52.0
0.017,6,10,1762,5,911,4.0,643.0,643.0,5,851,4.0,583.0,583.0
0.005,6,10,1547,5,764,1.0,496.0,496.0,5,783,1.0,515.0,515.0
177.408,17,86,12595,43,2883,4223.0,44.0,39.0,43,9712,4223.0,279.0,197.0
15.07,17,15,9239,8,6902,2149.0,1350.0,834.0,7,2337,2506.0,1350.0,305.0
0.007,6,10,1547,5,764,1.0,496.0,496.0,5,783,1.0,515.0,515.0
0.074,6,10,1506,5,395,16.0,127.0,127.0,5,1111,15.0,843.0,843.0
1786.396,6,154,19574,92,13852,19630.0,302.0,302.0,62,5722,29285.0,83.0,83.0
0.005,6,10,1779,5,928,1.0,660.0,660.0,5,851,1.0,583.0,583.0
0.849,6,10,2009,6,1655,169.0,1403.0,1403.0,4,354,205.0,182.0,182.0
0.01,6,10,1989,5,910,2.0,642.0,642.0,5,1079,2.0,811.0,811.0
0.006,6,10,1547,5,764,1.0,496.0,496.0,5,783,1.0,515.0,515.0
0.116,6,10,1506,5,395,26.0,127.0,127.0,5,1111,25.0,843.0,843.0
0.02,6,10,1990,5,911,4.0,643.0,643.0,5,1079,5.0,811.0,811.0
0.003,17,2,148,1,60,0.0,32.0,32.0,1,88,0.0,60.0,60.0
0.094,6,10,1506,5,395,18.0,127.0,127.0,5,1111,21.0,843.0,843.0
0.017,6,10,1989,5,910,4.0,642.0,642.0,5,1079,4.0,811.0,811.0
1800.0,6,137,6590,76,3625,23996.0,39.0,39.0,61,2965,29995.0,35.0,35.0
0.017,6,10,1990,5,911,4.0,643.0,643.0,5,1079,4.0,811.0,811.0
0.08,6,10,1506,5,395,17.0,127.0,127.0,5,1111,18.0,843.0,843.0
0.006,6,10,1547,5,764,1.0,496.0,496.0,5,783,1.0,515.0,515.0
0.017,6,10,1989,5,910,4.0,642.0,642.0,5,1079,4.0,811.0,811.0
0.004,6,10,1702,5,863,0.0,595.0,595.0,5,839,1.0,571.0,571.0
0.009,6,10,1762,5,911,2.0,643.0,643.0,5,851,2.0,583.0,583.0
0.005,6,10,1774,5,923,1.0,655.0,655.0,5,851,1.0,583.0,583.0
9.037,17,6,376,5,280,2259.0,28.0,28.0,1,96,0.0,68.0,68.0
293.069,6,356,345729,123,17946,2402.0,2736.0,888.0,233,327783,1263.0,2804.0,1447.0
0.006,6,10,1689,5,839,1.0,571.0,571.0,5,850,1.0,582.0,582.0
0.011,6,10,1983,5,910,2.0,642.0,642.0,5,1073,2.0,805.0,805.0
240.1,6,16,4480,9,963,30012.0,238.0,166.0,7,3517,40016.0,1402.0,786.0
0.005,6,10,2006,5,927,1.0,659.0,659.0,5,1079,1.0,811.0,811.0
0.005,6,10,1689,5,839,1.0,571.0,571.0,5,850,1.0,582.0,582.0
412.177,6,37,12289,20,3542,21693.0,676.0,415.0,17,8747,22010.0,1402.0,785.0
0.013,6,10,1989,5,910,3.0,642.0,642.0,5,1079,3.0,811.0,811.0
0.004,6,10,2007,5,928,1.0,660.0,660.0,5,1079,1.0,811.0,811.0
0.004,6,10,2000,5,927,1.0,659.0,659.0,5,1073,1.0,805.0,805.0
0.001,17,2,142,1,63,0.0,35.0,35.0,1,79,0.0,51.0,51.0
0.009,6,10,1989,5,910,2.0,642.0,642.0,5,1079,2.0,811.0,811.0
0.003,17,2,136,1,60,0.0,32.0,32.0,1,76,0.0,48.0,48.0
0.001,17,2,180,1,66,0.0,38.0,38.0,1,114,0.0,86.0,86.0
0.013,6,10,1631,5,848,3.0,580.0,580.0,5,783,3.0,515.0,515.0
0.004,6,10,2006,5,927,1.0,659.0,659.0,5,1079,1.0,811.0,811.0
0.006,6,10,2006,5,927,1.0,659.0,659.0,5,1079,1.0,811.0,811.0
0.089,6,10,1506,5,395,20.0,127.0,127.0,5,1111,16.0,843.0,843.0
40.062,17,10,676,5,460,10014.0,104.0,64.0,5,216,10014.0,20.0,15.0
0.068,6,10,1506,5,395,15.0,127.0,127.0,5,1111,15.0,843.0,843.0
0.005,17,2,179,1,71,0.0,43.0,43.0,1,108,0.0,80.0,80.0
0.071,17,8,3613,4,1874,23.0,1350.0,440.0,4,1739,12.0,1350.0,406.0
0.005,6,10,1989,5,927,1.0,659.0,659.0,5,1062,1.0,794.0,794.0
11.226,17,28,4423,14,1995,850.0,270.0,114.0,14,2428,850.0,587.0,145.0
0.006,6,10,2000,5,927,1.0,659.0,659.0,5,1073,1.0,805.0,805.0
0.073,17,2,412,1,61,0.0,33.0,33.0,1,351,0.0,323.0,323.0
0.005,6,10,1989,5,927,1.0,659.0,659.0,5,1062,1.0,794.0,794.0
0.104,6,10,1506,5,395,22.0,127.0,127.0,5,1111,24.0,843.0,843.0
0.005,6,10,2000,5,927,1.0,659.0,659.0,5,1073,1.0,805.0,805.0
0.006,6,10,1547,5,764,1.0,496.0,496.0,5,783,1.0,515.0,515.0
0.072,17,2,412,1,61,0.0,33.0,33.0,1,351,0.0,323.0,323.0
0.004,6,10,2007,5,928,1.0,660.0,660.0,5,1079,1.0,811.0,811.0
240.013,6,9,787,5,488,60003.0,232.0,232.0,4,299,80003.0,83.0,83.0
0.005,6,10,2007,5,928,1.0,660.0,660.0,5,1079,1.0,811.0,811.0
0.003,17,2,148,1,60,0.0,32.0,32.0,1,88,0.0,60.0,60.0
0.005,17,2,230,1,68,0.0,40.0,40.0,1,162,0.0,134.0,134.0
0.006,6,10,1689,5,839,1.0,571.0,571.0,5,850,1.0,582.0,582.0
0.004,6,10,1989,5,927,1.0,659.0,659.0,5,1062,1.0,794.0,794.0
0.003,6,10,1702,5,863,0.0,595.0,595.0,5,839,0.0,571.0,571.0
0.006,6,10,1854,5,889,1.0,621.0,621.0,5,965,1.0,697.0,697.0
0.07,17,8,3613,4,1874,23.0,1350.0,440.0,4,1739,12.0,1350.0,406.0
0.004,6,10,1989,5,927,1.0,659.0,659.0,5,1062,1.0,794.0,794.0
0.013,6,10,1972,5,910,3.0,642.0,642.0,5,1062,3.0,794.0,794.0
0.011,6,10,1972,5,910,2.0,642.0,642.0,5,1062,2.0,794.0,794.0
1790.819,6,276,34242,115,15426,15707.0,2059.0,127.0,161,18816,11191.0,1360.0,150.0
0.089,6,10,1506,5,395,18.0,127.0,127.0,5,1111,19.0,843.0,843.0
0.007,17,2,179,1,71,0.0,43.0,43.0,1,108,0.0,80.0,80.0
0.009,6,10,1990,5,911,2.0,643.0,643.0,5,1079,2.0,811.0,811.0
0.005,17,2,169,1,62,0.0,34.0,34.0,1,107,0.0,79.0,79.0
0.113,6,10,1506,5,395,27.0,127.0,127.0,5,1111,23.0,843.0,843.0
0.005,17,2,170,1,65,0.0,37.0,37.0,1,105,0.0,77.0,77.0
0.009,6,10,1983,5,910,2.0,642.0,642.0,5,1073,2.0,805.0,805.0
0.01,6,10,1989,5,910,2.0,642.0,642.0,5,1079,2.0,811.0,811.0
15.074,17,15,9238,8,6902,2149.0,1350.0,834.0,7,2336,2507.0,1350.0,305.0
0.038,17,4,284,2,120,0.0,32.0,32.0,2,164,35.0,60.0,54.0
0.005,17,2,214,1,75,0.0,47.0,47.0,1,139,0.0,111.0,111.0
0.0,17,2,154,1,69,0.0,41.0,41.0,1,85,0.0,57.0,57.0
0.004,6,10,1702,5,863,1.0,595.0,595.0,5,839,0.0,571.0,571.0
0.008,6,12,1926,6,1189,1.0,659.0,434.0,6,737,1.0,417.0,417.0
0.006,6,10,1854,5,889,1.0,621.0,621.0,5,965,1.0,697.0,697.0
0.006,6,10,1989,5,927,1.0,659.0,659.0,5,1062,1.0,794.0,794.0
0.041,17,2,136,1,60,0.0,32.0,32.0,1,76,0.0,48.0,48.0
0.01,6,10,1989,5,910,2.0,642.0,642.0,5,1079,2.0,811.0,811.0
107.435,6,22,7437,11,1305,127.0,530.0,277.0,11,6132,10727.0,1823.0,946.0
0.083,6,10,1506,5,395,18.0,127.0,127.0,5,1111,19.0,843.0,843.0
40.069,17,10,676,5,460,10015.0,104.0,64.0,5,216,10016.0,20.0,15.0
0.004,17,2,136,1,60,0.0,32.0,32.0,1,76,0.0,48.0,48.0
15.07,17,15,9239,8,6902,2148.0,1350.0,834.0,7,2337,2506.0,1350.0,305.0
0.083,6,10,1506,5,395,17.0,127.0,127.0,5,1111,18.0,843.0,843.0
0.008,6,10,1762,5,911,2.0,643.0,643.0,5,851,1.0,583.0,583.0
0.013,6,10,1989,5,910,3.0,642.0,642.0,5,1079,3.0,811.0,811.0
0.016,6,10,1990,5,911,4.0,643.0,643.0,5,1079,3.0,811.0,811.0
10.882,17,28,4421,14,1994,828.0,269.0,114.0,14,2427,828.0,586.0,145.0
0.006,6,10,1643,5,860,1.0,592.0,592.0,5,783,1.0,515.0,515.0
0.132,17,2,136,1,60,0.0,32.0,32.0,1,76,0.0,48.0,48.0
40.091,17,10,676,5,460,10021.0,104.0,64.0,5,216,10022.0,20.0,15.0
0.102,6,10,1506,5,395,22.0,127.0,127.0,5,1111,21.0,843.0,843.0
0.015,6,10,1990,5,911,3.0,643.0,643.0,5,1079,3.0,811.0,811.0
0.072,17,2,148,1,60,0.0,32.0,32.0,1,88,0.0,60.0,60.0
0.093,6,10,1506,5,395,22.0,127.0,127.0,5,1111,18.0,843.0,843.0
0.077,6,10,1506,5,395,18.0,127.0,127.0,5,1111,18.0,843.0,843.0
0.005,6,14,3799,7,509,0.0,137.0,137.0,7,3290,0.0,1448.0,972.0
0.004,6,13,3690,7,452,0.0,80.0,80.0,6,3238,0.0,1470.0,1459.0
0.005,6,10,1689,5,839,1.0,571.0,571.0,5,850,1.0,582.0,582.0
0.004,17,2,148,1,60,0.0,32.0,32.0,1,88,0.0,60.0,60.0
0.015,6,10,1990,5,911,3.0,643.0,643.0,5,1079,3.0,811.0,811.0
0.01,6,10,1989,5,910,2.0,642.0,642.0,5,1079,2.0,811.0,811.0
0.005,6,10,2006,5,927,1.0,659.0,659.0,5,1079,1.0,811.0,811.0
0.019,6,10,1983,5,910,4.0,642.0,642.0,5,1073,4.0,805.0,805.0
0.001,17,2,180,1,66,0.0,38.0,38.0,1,114,0.0,86.0,86.0
0.005,6,10,2007,5,928,1.0,660.0,660.0,5,1079,1.0,811.0,811.0
0.079,6,10,1506,5,395,16.0,127.0,127.0,5,1111,18.0,843.0,843.0
0.087,6,10,1506,5,395,20.0,127.0,127.0,5,1111,19.0,843.0,843.0
0.093,6,10,1506,5,395,20.0,127.0,127.0,5,1111,19.0,843.0,843.0
0.217,6,16,2669,8,1395,31.0,533.0,323.0,8,1274,19.0,529.0,212.0
0.013,6,10,1631,5,848,3.0,580.0,580.0,5,783,3.0,515.0,515.0
0.011,6,10,1990,5,911,2.0,643.0,643.0,5,1079,2.0,811.0,811.0
0.005,6,10,1689,5,839,1.0,571.0,571.0,5,850,1.0,582.0,582.0
0.014,6,10,1762,5,911,3.0,643.0,643.0,5,851,3.0,583.0,583.0
0.042,17,2,186,1,61,0.0,33.0,33.0,1,125,0.0,97.0,97.0
0.005,6,10,2006,5,927,1.0,659.0,659.0,5,1079,1.0,811.0,811.0
0.001,17,2,166,1,75,0.0,47.0,47.0,1,91,0.0,63.0,63.0
0.009,6,10,1972,5,910,2.0,642.0,642.0,5,1062,2.0,794.0,794.0
0.007,6,10,1779,5,928,1.0,660.0,660.0,5,851,1.0,583.0,583.0
1792.728,6,485,98733,244,87503,7376.0,421.0,368.0,241,11230,7469.0,53.0,53.0
0.005,6,10,2007,5,928,1.0,660.0,660.0,5,1079,1.0,811.0,811.0
0.082,6,10,1506,5,395,18.0,127.0,127.0,5,1111,15.0,843.0,843.0
0.011,6,10,1989,5,910,2.0,642.0,642.0,5,1079,2.0,811.0,811.0
0.214,17,4,596,2,122,176.0,33.0,33.0,2,474,142.0,323.0,209.0
0.072,17,2,182,1,65,0.0,37.0,37.0,1,117,0.0,89.0,89.0
0.007,6,10,1677,5,827,1.0,559.0,559.0,5,850,1.0,582.0,582.0
0.015,6,10,1972,5,910,3.0,642.0,642.0,5,1062,3.0,794.0,794.0
0.091,6,10,1506,5,395,20.0,127.0,127.0,5,1111,19.0,843.0,843.0
0.001,17,2,180,1,66,0.0,38.0,38.0,1,114,0.0,86.0,86.0
0.104,6,10,1506,5,395,24.0,127.0,127.0,5,1111,24.0,843.0,843.0
0.125,6,10,1506,5,395,24.0,127.0,127.0,5,1111,26.0,843.0,843.0
0.006,6,10,1774,5,923,1.0,655.0,655.0,5,851,1.0,583.0,583.0
0.079,6,10,1506,5,395,17.0,127.0,127.0,5,1111,18.0,843.0,843.0
0.006,6,10,2000,5,927,1.0,659.0,659.0,5,1073,1.0,805.0,805.0
0.005,6,10,2007,5,928,1.0,660.0,660.0,5,1079,1.0,811.0,811.0
0.018,17,2,140,1,62,0.0,34.0,34.0,1,78,0.0,50.0,50.0
0.004,6,10,2007,5,928,1.0,660.0,660.0,5,1079,1.0,811.0,811.0
0.004,6,10,1989,5,927,1.0,659.0,659.0,5,1062,1.0,794.0,794.0
0.04,17,2,186,1,61,0.0,33.0,33.0,1,125,0.0,97.0,97.0
0.007,6,10,2000,5,927,1.0,659.0,659.0,5,1073,1.0,805.0,805.0
0.0,17,2,136,1,60,0.0,32.0,32.0,1,76,0.0,48.0,48.0
0.006,17,2,169,1,62,0.0,34.0,34.0,1,107,0.0,79.0,79.0
0.017,6,10,1989,5,910,4.0,642.0,642.0,5,1079,4.0,811.0,811.0
0.004,17,2,170,1,65,0.0,37.0,37.0,1,105,0.0,77.0,77.0
0.005,6,10,1779,5,928,1.0,660.0,660.0,5,851,1.0,583.0,583.0
0.009,6,10,1983,5,910,2.0,642.0,642.0,5,1073,2.0,805.0,805.0
0.041,17,2,170,1,65,0.0,37.0,37.0,1,105,0.0,77.0,77.0
0.003,17,2,136,1,60,0.0,32.0,32.0,1,76,0.0,48.0,48.0
0.044,17,2,152,1,76,0.0,48.0,48.0,1,76,0.0,48.0,48.0
0.006,6,10,1854,5,889,1.0,621.0,621.0,5,965,1.0,697.0,697.0
0.073,6,10,1506,5,395,15.0,127.0,127.0,5,1111,15.0,843.0,843.0
0.13,17,2,170,1,65,0.0,37.0,37.0,1,105,0.0,77.0,77.0
10.894,17,28,4423,14,1994,829.0,269.0,114.0,14,2429,828.0,588.0,145.0
0.007,17,2,307,1,61,0.0,33.0,33.0,1,246,0.0,218.0,218.0
0.013,6,10,1677,5,827,3.0,559.0,559.0,5,850,3.0,582.0,582.0
0.239,6,16,2777,8,1395,34.0,533.0,323.0,8,1382,22.0,529.0,239.0
30.205,6,17,7175,10,753,3356.0,209.0,209.0,7,6422,5033.0,2804.0,1512.0
0.005,17,2,214,1,75,0.0,47.0,47.0,1,139,0.0,111.0,111.0
0.003,17,4,284,2,120,0.0,32.0,32.0,2,164,0.0,60.0,54.0
0.098,6,10,1506,5,395,21.0,127.0,127.0,5,1111,21.0,843.0,843.0
0.163,6,10,1506,5,395,25.0,127.0,127.0,5,1111,37.0,843.0,843.0
301.003,6,37,8261,20,1830,15842.0,651.0,249.0,17,6431,554.0,2720.0,478.0
0.005,6,10,1779,5,928,1.0,660.0,660.0,5,851,1.0,583.0,583.0
0.007,6,10,1972,5,910,1.0,642.0,642.0,5,1062,1.0,794.0,794.0
0.124,17,2,186,1,61,0.0,33.0,33.0,1,125,0.0,97.0,97.0
0.136,6,10,1506,5,395,30.0,127.0,127.0,5,1111,31.0,843.0,843.0
0.004,6,10,2006,5,927,1.0,659.0,659.0,5,1079,1.0,811.0,811.0
0.004,6,10,2007,5,928,1.0,660.0,660.0,5,1079,1.0,811.0,811.0
0.119,6,10,1506,5,395,25.0,127.0,127.0,5,1111,27.0,843.0,843.0
0.005,6,10,1989,5,927,1.0,659.0,659.0,5,1062,1.0,794.0,794.0
0.071,6,10,1506,5,395,15.0,127.0,127.0,5,1111,16.0,843.0,843.0
11.349,17,30,5330,15,2289,799.0,268.0,124.0,15,3041,799.0,1143.0,174.0
0.005,6,14,3742,7,452,0.0,80.0,80.0,7,3290,0.0,1448.0,972.0
0.009,6,10,1972,5,910,2.0,642.0,642.0,5,1062,2.0,794.0,794.0
15.073,17,16,9302,8,6912,2149.0,1350.0,836.0,8,2390,2149.0,1350.0,270.0
0.005,17,2,170,1,65,0.0,37.0,37.0,1,105,0.0,77.0,77.0
0.005,6,10,2007,5,928,1.0,660.0,660.0,5,1079,1.0,811.0,811.0
0.004,6,10,2007,5,928,1.0,660.0,660.0,5,1079,1.0,811.0,811.0
0.007,6,10,1643,5,860,1.0,592.0,592.0,5,783,1.0,515.0,515.0
0.024,6,10,1990,5,911,6.0,643.0,643.0,5,1079,6.0,811.0,811.0
0.011,6,10,1972,5,910,2.0,642.0,642.0,5,1062,2.0,794.0,794.0
0.105,6,10,1506,5,395,26.0,127.0,127.0,5,1111,24.0,843.0,843.0
0.255,17,2,152,1,76,0.0,48.0,48.0,1,76,0.0,48.0,48.0
0.077,6,10,1506,5,395,17.0,127.0,127.0,5,1111,16.0,843.0,843.0
0.08,6,10,1506,5,395,18.0,127.0,127.0,5,1111,15.0,843.0,843.0
0.008,6,10,1677,5,827,2.0,559.0,559.0,5,850,1.0,582.0,582.0
40.073,17,10,676,5,460,10017.0,104.0,64.0,5,216,10017.0,20.0,15.0
240.073,6,21,4925,11,941,24007.0,180.0,93.0,10,3984,26674.0,1592.0,576.0
0.004,17,2,132,1,58,0.0,30.0,30.0,1,74,0.0,46.0,46.0
0.004,17,2,214,1,75,0.0,47.0,47.0,1,139,0.0,111.0,111.0
0.07,6,10,1506,5,395,16.0,127.0,127.0,5,1111,15.0,843.0,843.0
0.005,6,10,2006,5,927,1.0,659.0,659.0,5,1079,1.0,811.0,811.0
0.007,17,2,136,1,60,0.0,32.0,32.0,1,76,0.0,48.0,48.0
0.005,6,10,2007,5,928,1.0,660.0,660.0,5,1079,1.0,811.0,811.0
0.01,17,4,284,2,120,6.0,32.0,32.0,2,164,6.0,60.0,54.0
178.487,17,80,11164,40,2659,4576.0,44.0,38.0,40,8505,4576.0,261.0,184.0
0.012,6,10,1983,5,910,3.0,642.0,642.0,5,1073,3.0,805.0,805.0
0.009,6,10,1990,5,911,2.0,643.0,643.0,5,1079,2.0,811.0,811.0
0.006,17,2,294,1,64,0.0,36.0,36.0,1,230,0.0,202.0,202.0
0.005,6,10,1689,5,839,1.0,571.0,571.0,5,850,1.0,582.0,582.0
0.005,6,10,1689,5,839,1.0,571.0,571.0,5,850,1.0,582.0,582.0
0.009,6,12,1926,6,1189,1.0,659.0,434.0,6,737,1.0,417.0,417.0
0.014,6,10,1989,5,910,3.0,642.0,642.0,5,1079,3.0,811.0,811.0
0.075,6,10,1506,5,395,17.0,127.0,127.0,5,1111,16.0,843.0,843.0
0.014,6,13,3735,7,497,2.0,125.0,125.0,6,3238,2.0,1470.0,1459.0
0.003,17,2,136,1,60,0.0,32.0,32.0,1,76,0.0,48.0,48.0
0.005,6,10,2006,5,927,1.0,659.0,659.0,5,1079,1.0,811.0,811.0
0.052,17,2,152,1,76,0.0,48.0,48.0,1,76,0.0,48.0,48.0
0.005,17,2,157,1,59,0.0,31.0,31.0,1,98,0.0,70.0,70.0
0.005,6,10,1774,5,923,1.0,655.0,655.0,5,851,1.0,583.0,583.0
0.005,6,10,2006,5,927,1.0,659.0,659.0,5,1079,1.0,811.0,811.0
0.087,6,10,1506,5,395,21.0,127.0,127.0,5,1111,17.0,843.0,843.0
40.078,17,10,676,5,460,10018.0,104.0,64.0,5,216,10018.0,20.0,15.0
0.01,6,10,1989,5,910,2.0,642.0,642.0,5,1079,2.0,811.0,811.0
0.005,6,10,2000,5,927,1.0,659.0,659.0,5,1073,1.0,805.0,805.0
0.012,6,10,1631,5,848,2.0,580.0,580.0,5,783,2.0,515.0,515.0
11.137,17,28,4422,14,1994,844.0,269.0,114.0,14,2428,844.0,587.0,145.0
0.006,17,2,179,1,71,0.0,43.0,43.0,1,108,0.0,80.0,80.0
309.924,17,20,1124,10,716,34421.0,48.0,43.0,10,408,34421.0,20.0,12.0
40.068,17,10,676,5,460,10016.0,104.0,64.0,5,216,10016.0,20.0,15.0
0.019,6,14,3787,7,497,3.0,125.0,125.0,7,3290,3.0,1448.0,972.0
0.006,6,10,1547,5,764,1.0,496.0,496.0,5,783,1.0,515.0,515.0
0.08,6,10,1506,5,395,17.0,127.0,127.0,5,1111,18.0,843.0,843.0
1753.223,6,64,7344,42,4469,42761.0,1625.0,108.0,22,2875,83478.0,1111.0,82.0
0.008,6,10,1972,5,910,1.0,642.0,642.0,5,1062,1.0,794.0,794.0
0.102,6,10,1506,5,395,22.0,127.0,127.0,5,1111,23.0,843.0,843.0
0.008,6,10,1990,5,911,2.0,643.0,643.0,5,1079,2.0,811.0,811.0
0.012,6,10,1972,5,910,3.0,642.0,642.0,5,1062,3.0,794.0,794.0
244.166,6,311,343907,114,17448,2160.0,2736.0,886.0,197,326459,1245.0,2804.0,1690.0
0.056,17,2,179,1,71,0.0,43.0,43.0,1,108,0.0,80.0,80.0
0.014,6,10,1972,5,910,3.0,642.0,642.0,5,1062,3.0,794.0,794.0
0.009,6,10,1989,5,910,2.0,642.0,642.0,5,1079,2.0,811.0,811.0
0.037,17,4,284,2,120,0.0,32.0,32.0,2,164,32.0,60.0,54.0
0.006,17,2,140,1,62,0.0,34.0,34.0,1,78,0.0,50.0,50.0
0.003,17,4,284,2,120,0.0,32.0,32.0,2,164,0.0,60.0,54.0
0.016,6,10,1983,5,910,4.0,642.0,642.0,5,1073,3.0,805.0,805.0
0.005,6,10,2000,5,927,1.0,659.0,659.0,5,1073,1.0,805.0,805.0
0.005,6,10,2000,5,927,1.0,659.0,659.0,5,1073,1.0,805.0,805.0
0.005,6,10,1779,5,928,1.0,660.0,660.0,5,851,1.0,583.0,583.0
0.003,17,2,148,1,60,0.0,32.0,32.0,1,88,0.0,60.0,60.0
1776.763,6,276,38221,111,21375,16151.0,2720.0,196.0,165,16846,10833.0,1360.0,129.0
169.166,17,80,11364,40,2673,4337.0,44.0,38.0,40,8691,4337.0,239.0,189.0
0.075,17,8,3613,4,1874,25.0,1350.0,440.0,4,1739,10.0,1350.0,406.0
0.01,6,10,1989,5,910,2.0,642.0,642.0,5,1079,2.0,811.0,811.0
0.085,6,10,1506,5,395,17.0,127.0,127.0,5,1111,18.0,843.0,843.0
40.065,17,10,676,5,460,10014.0,104.0,64.0,5,216,10014.0,20.0,15.0
0.008,6,10,1983,5,910,2.0,642.0,642.0,5,1073,2.0,805.0,805.0
300.222,6,27,7436,16,1409,20014.0,217.0,142.0,11,6027,24020.0,1679.0,778.0
0.097,6,10,1506,5,395,19.0,127.0,127.0,5,1111,23.0,843.0,843.0
0.006,6,10,1547,5,764,1.0,496.0,496.0,5,783,1.0,515.0,515.0
0.006,17,2,170,1,65,0.0,37.0,37.0,1,105,0.0,77.0,77.0
0.017,6,10,1983,5,910,4.0,642.0,642.0,5,1073,4.0,805.0,805.0
0.006,6,10,1547,5,764,1.0,496.0,496.0,5,783,1.0,515.0,515.0
240.017,6,9,787,5,488,60004.0,232.0,232.0,4,299,80004.0,83.0,83.0
0.005,6,10,2007,5,928,1.0,660.0,660.0,5,1079,1.0,811.0,811.0
0.131,6,10,1506,5,395,25.0,127.0,127.0,5,1111,29.0,843.0,843.0
0.014,6,10,1972,5,910,3.0,642.0,642.0,5,1062,3.0,794.0,794.0
0.164,17,2,152,1,76,0.0,48.0,48.0,1,76,0.0,48.0,48.0
0.08,6,10,1506,5,395,17.0,127.0,127.0,5,1111,17.0,843.0,843.0
0.019,6,10,1990,5,911,4.0,643.0,643.0,5,1079,4.0,811.0,811.0
0.005,6,10,1779,5,928,1.0,660.0,660.0,5,851,1.0,583.0,583.0
0.998,6,25,8489,14,2105,76.0,1138.0,378.0,11,6384,82.0,2720.0,988.0
0.013,6,10,1972,5,910,3.0,642.0,642.0,5,1062,3.0,794.0,794.0
0.005,6,10,1989,5,927,1.0,659.0,659.0,5,1062,1.0,794.0,794.0
0.01,6,10,1990,5,911,2.0,643.0,643.0,5,1079,2.0,811.0,811.0
0.096,6,10,1506,5,395,22.0,127.0,127.0,5,1111,18.0,843.0,843.0
0.004,6,10,2006,5,927,1.0,659.0,659.0,5,1079,1.0,811.0,811.0
0.013,6,10,1989,5,910,3.0,642.0,642.0,5,1079,3.0,811.0,811.0
308.703,17,20,1124,10,716,34286.0,48.0,43.0,10,408,34286.0,20.0,12.0
0.018,6,10,1989,5,910,4.0,642.0,642.0,5,1079,4.0,811.0,811.0
0.006,6,10,1689,5,839,1.0,571.0,571.0,5,850,1.0,582.0,582.0
170.089,17,78,11114,39,2601,4475.0,44.0,38.0,39,8513,4475.0,261.0,190.0
0.003,17,2,148,1,60,0.0,32.0,32.0,1,88,0.0,60.0,60.0
0.101,6,10,1506,5,395,22.0,127.0,127.0,5,1111,23.0,843.0,843.0
15.073,17,15,9239,8,6902,2149.0,1350.0,834.0,7,2337,2507.0,1350.0,305.0
40.07,17,10,676,5,460,10015.0,104.0,64.0,5,216,10016.0,20.0,15.0
0.038,17,2,170,1,65,0.0,37.0,37.0,1,105,0.0,77.0,77.0
0.005,6,10,2000,5,927,1.0,659.0,659.0,5,1073,1.0,805.0,805.0
0.125,6,10,1506,5,395,27.0,127.0,127.0,5,1111,30.0,843.0,843.0
0.004,6,10,1989,5,927,1.0,659.0,659.0,5,1062,1.0,794.0,794.0
0.005,17,2,166,1,75,0.0,47.0,47.0,1,91,0.0,63.0,63.0
174.23,17,102,11351,73,4899,2419.0,44.0,39.0,29,6452,4933.0,239.0,194.0
173.467,17,80,11244,40,2679,4447.0,44.0,38.0,40,8565,4447.0,239.0,186.0
0.144,17,4,284,2,120,0.0,32.0,32.0,2,164,83.0,60.0,54.0
0.006,6,10,1547,5,764,1.0,496.0,496.0,5,783,1.0,515.0,515.0
0.005,6,10,1774,5,923,1.0,655.0,655.0,5,851,1.0,583.0,583.0
11.288,17,28,4422,14,1993,855.0,268.0,114.0,14,2429,855.0,588.0,145.0
0.124,17,4,596,2,122,1.0,33.0,33.0,2,474,52.0,323.0,209.0
0.006,17,2,179,1,71,0.0,43.0,43.0,1,108,0.0,80.0,80.0
0.108,6,10,1506,5,395,23.0,127.0,127.0,5,1111,22.0,843.0,843.0
0.005,17,2,179,1,71,0.0,43.0,43.0,1,108,0.0,80.0,80.0
0.005,6,10,2000,5,927,1.0,659.0,659.0,5,1073,1.0,805.0,805.0
0.005,6,10,1643,5,860,1.0,592.0,592.0,5,783,1.0,515.0,515.0
0.014,6,10,1972,5,910,3.0,642.0,642.0,5,1062,3.0,794.0,794.0
0.017,6,10,1989,5,910,4.0,642.0,642.0,5,1079,4.0,811.0,811.0
0.001,17,2,180,1,66,0.0,38.0,38.0,1,114,0.0,86.0,86.0
0.004,17,2,136,1,60,0.0,32.0,32.0,1,76,0.0,48.0,48.0
0.005,17,4,284,2,120,0.0,32.0,32.0,2,164,1.0,60.0,54.0
0.016,6,14,3799,7,509,2.0,137.0,137.0,7,3290,2.0,1448.0,972.0
0.289,17,4,352,2,130,166.0,37.0,37.0,2,222,165.0,89.0,83.0
0.011,6,10,1989,5,910,2.0,642.0,642.0,5,1079,2.0,811.0,811.0
15.231,17,17,8600,9,6340,1899.0,1350.0,676.0,8,2260,2171.0,1350.0,254.0
0.025,17,4,284,2,120,0.0,32.0,32.0,2,164,1.0,60.0,54.0
0.005,6,10,2006,5,927,1.0,659.0,659.0,5,1079,1.0,811.0,811.0
0.014,6,10,1989,5,910,3.0,642.0,642.0,5,1079,3.0,811.0,811.0
0.006,6,10,1547,5,764,1.0,496.0,496.0,5,783,1.0,515.0,515.0
0.013,6,10,1762,5,911,3.0,643.0,643.0,5,851,3.0,583.0,583.0
0.015,6,10,1989,5,910,3.0,642.0,642.0,5,1079,3.0,811.0,811.0
0.01,17,2,193,1,71,0.0,43.0,43.0,1,122,0.0,94.0,94.0
40.074,17,10,676,5,460,10013.0,104.0,64.0,5,216,10012.0,20.0,15.0
0.012,6,10,1990,5,911,3.0,643.0,643.0,5,1079,3.0,811.0,811.0
0.005,17,2,294,1,64,0.0,36.0,36.0,1,230,0.0,202.0,202.0
0.006,6,10,1547,5,764,1.0,496.0,496.0,5,783,1.0,515.0,515.0
40.054,17,10,676,5,460,10012.0,104.0,64.0,5,216,10012.0,20.0,15.0
0.004,6,10,2007,5,928,1.0,660.0,660.0,5,1079,1.0,811.0,811.0
0.008,6,10,1854,5,889,2.0,621.0,621.0,5,965,1.0,697.0,697.0
289.779,6,412,349547,197,21807,1478.0,2736.0,888.0,215,327740,1354.0,2804.0,1574.0
0.011,6,10,1677,5,827,2.0,559.0,559.0,5,850,2.0,582.0,582.0
240.095,6,32,9168,16,6636,16006.0,1707.0,645.0,16,2532,16006.0,580.0,211.0
0.001,17,2,180,1,66,0.0,38.0,38.0,1,114,0.0,86.0,86.0
11.393,17,28,4392,14,2313,863.0,588.0,137.0,14,2079,863.0,270.0,120.0
0.016,6,10,1677,5,827,3.0,559.0,559.0,5,850,3.0,582.0,582.0
0.006,17,2,187,1,71,0.0,43.0,43.0,1,116,0.0,88.0,88.0
1799.917,6,137,6590,76,3625,23995.0,39.0,39.0,61,2965,29994.0,35.0,35.0
0.103,6,10,1506,5,395,22.0,127.0,127.0,5,1111,24.0,843.0,843.0
0.006,6,10,1689,5,839,1.0,571.0,571.0,5,850,1.0,582.0,582.0
0.106,6,10,1506,5,395,23.0,127.0,127.0,5,1111,23.0,843.0,843.0
0.005,6,10,1779,5,928,1.0,660.0,660.0,5,851,1.0,583.0,583.0
11.188,17,28,4422,14,1994,848.0,269.0,114.0,14,2428,848.0,587.0,145.0
0.008,17,2,194,1,59,0.0,31.0,31.0,1,135,0.0,107.0,107.0
0.001,17,2,180,1,66,0.0,38.0,38.0,1,114,0.0,86.0,86.0
0.005,17,2,170,1,65,0.0,37.0,37.0,1,105,0.0,77.0,77.0
0.012,6,10,1989,5,910,2.0,642.0,642.0,5,1079,2.0,811.0,811.0
0.066,6,10,1506,5,395,14.0,127.0,127.0,5,1111,14.0,843.0,843.0
0.076,6,10,1506,5,395,15.0,127.0,127.0,5,1111,15.0,843.0,843.0
65.823,6,20,8231,11,1898,6582.0,986.0,439.0,9,6333,8204.0,2111.0,976.0
1729.209,6,60,4400,40,2740,44338.0,33.0,33.0,20,1660,91002.0,31.0,31.0
0.005,17,2,170,1,65,0.0,37.0,37.0,1,105,0.0,77.0,77.0
0.07,6,10,1506,5,395,15.0,127.0,127.0,5,1111,14.0,843.0,843.0
0.005,6,10,2006,5,927,1.0,659.0,659.0,5,1079,1.0,811.0,811.0
0.013,6,10,1983,5,910,3.0,642.0,642.0,5,1073,3.0,805.0,805.0
0.012,6,10,1983,5,910,3.0,642.0,642.0,5,1073,2.0,805.0,805.0
0.122,6,10,1506,5,395,27.0,127.0,127.0,5,1111,27.0,843.0,843.0
0.123,17,2,80,1,32,0.0,4.0,4.0,1,48,0.0,20.0,20.0
0.004,17,2,136,1,60,0.0,32.0,32.0,1,76,0.0,48.0,48.0
11.104,17,28,4421,14,1994,842.0,269.0,114.0,14,2427,842.0,586.0,145.0
0.001,17,2,180,1,66,0.0,38.0,38.0,1,114,0.0,86.0,86.0
0.004,17,2,136,1,60,0.0,32.0,32.0,1,76,0.0,48.0,48.0
0.006,6,10,1689,5,839,1.0,571.0,571.0,5,850,1.0,582.0,582.0
0.011,6,10,1972,5,910,2.0,642.0,642.0,5,1062,2.0,794.0,794.0
0.037,6,13,3735,7,497,6.0,125.0,125.0,6,3238,7.0,1470.0,1459.0
0.091,6,10,1506,5,395,19.0,127.0,127.0,5,1111,20.0,843.0,843.0
0.106,6,10,1506,5,395,21.0,127.0,127.0,5,1111,23.0,843.0,843.0
0.009,6,10,1972,5,910,2.0,642.0,642.0,5,1062,2.0,794.0,794.0
0.01,6,10,1972,5,910,2.0,642.0,642.0,5,1062,2.0,794.0,794.0
0.004,6,10,2006,5,927,1.0,659.0,659.0,5,1079,1.0,811.0,811.0
0.005,6,10,2006,5,927,1.0,659.0,659.0,5,1079,1.0,811.0,811.0
0.005,6,10,2006,5,927,1.0,659.0,659.0,5,1079,1.0,811.0,811.0
300.377,6,16,2170,9,684,37526.0,146.0,146.0,7,1486,50035.0,419.0,398.0
0.087,6,10,1506,5,395,17.0,127.0,127.0,5,1111,17.0,843.0,843.0
0.005,17,2,140,1,62,0.0,34.0,34.0,1,78,0.0,50.0,50.0
0.006,6,12,1698,6,863,1.0,327.0,271.0,6,835,1.0,515.0,515.0
0.111,6,10,1506,5,395,24.0,127.0,127.0,5,1111,23.0,843.0,843.0
0.005,6,10,1774,5,923,1.0,655.0,655.0,5,851,1.0,583.0,583.0
0.015,6,10,1989,5,910,3.0,642.0,642.0,5,1079,3.0,811.0,811.0
0.005,6,10,2006,5,927,1.0,659.0,659.0,5,1079,1.0,811.0,811.0
0.006,17,2,180,1,66,0.0,38.0,38.0,1,114,0.0,86.0,86.0
0.015,6,10,1989,5,910,3.0,642.0,642.0,5,1079,3.0,811.0,811.0
0.005,6,10,1989,5,927,1.0,659.0,659.0,5,1062,1.0,794.0,794.0
0.005,6,10,2006,5,927,1.0,659.0,659.0,5,1079,1.0,811.0,811.0
0.005,6,10,2006,5,927,1.0,659.0,659.0,5,1079,1.0,811.0,811.0
0.003,17,2,148,1,60,0.0,32.0,32.0,1,88,0.0,60.0,60.0
0.004,17,2,144,1,64,0.0,36.0,36.0,1,80,0.0,52.0,52.0
0.017,6,13,3735,7,497,2.0,125.0,125.0,6,3238,3.0,1470.0,1459.0
0.039,17,4,284,2,120,0.0,32.0,32.0,2,164,2.0,60.0,54.0
0.004,17,2,142,1,63,0.0,35.0,35.0,1,79,0.0,51.0,51.0
0.009,6,10,1990,5,911,2.0,643.0,643.0,5,1079,2.0,811.0,811.0
0.017,6,10,1989,5,910,4.0,642.0,642.0,5,1079,4.0,811.0,811.0
366.951,6,22,2313,16,867,24463.0,195.0,195.0,6,1446,4637.0,419.0,398.0
0.005,6,10,2007,5,928,1.0,660.0,660.0,5,1079,1.0,811.0,811.0
0.065,6,10,1506,5,395,13.0,127.0,127.0,5,1111,13.0,843.0,843.0
0.007,17,2,179,1,71,0.0,43.0,43.0,1,108,0.0,80.0,80.0
0.124,17,2,80,1,32,0.0,4.0,4.0,1,48,0.0,20.0,20.0
0.004,6,10,2006,5,927,1.0,659.0,659.0,5,1079,1.0,811.0,811.0
0.009,6,10,1989,5,910,2.0,642.0,642.0,5,1079,2.0,811.0,811.0
0.004,17,2,132,1,58,0.0,30.0,30.0,1,74,0.0,46.0,46.0
0.011,6,10,1989,5,910,2.0,642.0,642.0,5,1079,2.0,811.0,811.0
0.016,6,10,1989,5,910,4.0,642.0,642.0,5,1079,3.0,811.0,811.0
0.081,6,10,1506,5,395,17.0,127.0,127.0,5,1111,18.0,843.0,843.0
0.005,6,13,3747,7,509,0.0,137.0,137.0,6,3238,0.0,1470.0,1459.0
0.016,6,14,3787,7,497,2.0,125.0,125.0,7,3290,2.0,1448.0,972.0
240.099,6,16,4482,9,963,30012.0,238.0,166.0,7,3519,40016.0,1402.0,786.0
0.005,6,10,2007,5,928,1.0,660.0,660.0,5,1079,1.0,811.0,811.0
0.006,6,10,1689,5,839,1.0,571.0,571.0,5,850,1.0,582.0,582.0
0.005,6,13,3747,7,509,0.0,137.0,137.0,6,3238,1.0,1470.0,1459.0
0.014,6,10,1989,5,910,3.0,642.0,642.0,5,1079,3.0,811.0,811.0
0.006,6,10,1854,5,889,1.0,621.0,621.0,5,965,1.0,697.0,697.0
0.007,17,2,194,1,59,0.0,31.0,31.0,1,135,0.0,107.0,107.0
0.021,6,10,1972,5,910,5.0,642.0,642.0,5,1062,5.0,794.0,794.0
0.089,6,10,1506,5,395,20.0,127.0,127.0,5,1111,20.0,843.0,843.0
0.106,6,10,1506,5,395,26.0,127.0,127.0,5,1111,22.0,843.0,843.0
0.012,6,10,1972,5,910,2.0,642.0,642.0,5,1062,2.0,794.0,794.0
0.003,17,4,284,2,120,0.0,32.0,32.0,2,164,0.0,60.0,54.0
0.012,6,10,1990,5,911,2.0,643.0,643.0,5,1079,2.0,811.0,811.0
240.077,6,21,4925,11,941,24007.0,180.0,93.0,10,3984,26674.0,1592.0,576.0
0.004,6,10,2006,5,927,1.0,659.0,659.0,5,1079,1.0,811.0,811.0
0.01,6,10,1972,5,910,2.0,642.0,642.0,5,1062,2.0,794.0,794.0
0.01,6,10,1989,5,910,2.0,642.0,642.0,5,1079,2.0,811.0,811.0
0.005,6,10,2007,5,928,1.0,660.0,660.0,5,1079,1.0,811.0,811.0
0.02,6,10,1972,5,910,5.0,642.0,642.0,5,1062,5.0,794.0,794.0
0.011,6,10,1762,5,911,2.0,643.0,643.0,5,851,2.0,583.0,583.0
0.086,6,10,1506,5,395,20.0,127.0,127.0,5,1111,17.0,843.0,843.0
0.089,6,10,1506,5,395,20.0,127.0,127.0,5,1111,20.0,843.0,843.0
0.164,17,2,152,1,76,0.0,48.0,48.0,1,76,0.0,48.0,48.0
0.118,6,10,1506,5,395,25.0,127.0,127.0,5,1111,25.0,843.0,843.0
0.004,6,10,2000,5,927,1.0,659.0,659.0,5,1073,1.0,805.0,805.0
0.003,17,4,284,2,120,0.0,32.0,32.0,2,164,0.0,60.0,54.0
0.001,17,2,179,1,62,0.0,34.0,34.0,1,117,0.0,89.0,89.0
0.005,6,10,1989,5,927,1.0,659.0,659.0,5,1062,1.0,794.0,794.0
0.006,6,10,1547,5,764,1.0,496.0,496.0,5,783,1.0,515.0,515.0
0.005,6,10,1854,5,889,1.0,621.0,621.0,5,965,1.0,697.0,697.0
0.072,6,10,1506,5,395,15.0,127.0,127.0,5,1111,15.0,843.0,843.0
0.089,6,10,1506,5,395,20.0,127.0,127.0,5,1111,18.0,843.0,843.0
40.059,17,10,676,5,460,10013.0,104.0,64.0,5,216,10013.0,20.0,15.0
106.022,6,22,8497,12,2236,69.0,1345.0,574.0,10,6261,11762.0,1776.0,974.0
0.089,6,10,1506,5,395,20.0,127.0,127.0,5,1111,17.0,843.0,843.0
0.005,17,2,168,1,76,0.0,48.0,48.0,1,92,0.0,64.0,64.0
0.04,17,4,352,2,130,0.0,37.0,37.0,2,222,3.0,89.0,83.0
0.004,6,10,2006,5,927,1.0,659.0,659.0,5,1079,1.0,811.0,811.0
0.031,6,10,1762,5,911,7.0,643.0,643.0,5,851,7.0,583.0,583.0
0.005,6,10,2006,5,927,1.0,659.0,659.0,5,1079,1.0,811.0,811.0
0.023,6,10,1983,5,910,5.0,642.0,642.0,5,1073,5.0,805.0,805.0
0.006,6,10,1643,5,860,1.0,592.0,592.0,5,783,1.0,515.0,515.0
0.12,6,10,1506,5,395,27.0,127.0,127.0,5,1111,27.0,843.0,843.0
240.094,6,33,9457,17,6975,15005.0,1368.0,554.0,16,2482,16006.0,580.0,205.0
0.004,17,2,136,1,60,0.0,32.0,32.0,1,76,0.0,48.0,48.0
0.04,17,2,148,1,60,0.0,32.0,32.0,1,88,0.0,60.0,60.0
0.015,6,10,1990,5,911,3.0,643.0,643.0,5,1079,3.0,811.0,811.0
0.126,6,10,1506,5,395,27.0,127.0,127.0,5,1111,28.0,843.0,843.0
0.005,6,10,2007,5,928,1.0,660.0,660.0,5,1079,1.0,811.0,811.0
0.004,17,2,136,1,60,0.0,32.0,32.0,1,76,0.0,48.0,48.0
0.018,6,13,3735,7,497,3.0,125.0,125.0,6,3238,3.0,1470.0,1459.0
40.073,17,10,676,5,460,10017.0,104.0,64.0,5,216,10015.0,20.0,15.0
240.525,6,33,8637,17,1838,15030.0,571.0,189.0,16,6799,16032.0,1402.0,597.0
0.011,6,10,1989,5,910,2.0,642.0,642.0,5,1079,2.0,811.0,811.0
0.005,6,10,2006,5,927,1.0,659.0,659.0,5,1079,1.0,811.0,811.0
0.007,6,10,1983,5,910,1.0,642.0,642.0,5,1073,1.0,805.0,805.0
0.125,6,10,1506,5,395,28.0,127.0,127.0,5,1111,30.0,843.0,843.0
0.021,6,10,1631,5,848,5.0,580.0,580.0,5,783,5.0,515.0,515.0
0.005,17,2,144,1,64,0.0,36.0,36.0,1,80,0.0,52.0,52.0
0.007,6,6,362,3,175,3.0,31.0,31.0,3,187,0.0,31.0,31.0
0.005,6,10,1989,5,927,1.0,659.0,659.0,5,1062,1.0,794.0,794.0
0.124,6,10,1506,5,395,29.0,127.0,127.0,5,1111,25.0,843.0,843.0
40.059,17,10,676,5,460,10013.0,104.0,64.0,5,216,10013.0,20.0,15.0
0.005,6,10,1547,5,764,1.0,496.0,496.0,5,783,1.0,515.0,515.0
0.013,6,10,1990,5,911,3.0,643.0,643.0,5,1079,3.0,811.0,811.0
0.013,6,10,1972,5,910,3.0,642.0,642.0,5,1062,3.0,794.0,794.0
40.068,17,10,676,5,460,10014.0,104.0,64.0,5,216,10016.0,20.0,15.0
0.012,6,10,1972,5,910,3.0,642.0,642.0,5,1062,3.0,794.0,794.0
308.923,17,18,1008,9,640,38599.0,48.0,43.0,9,368,38599.0,20.0,12.0
0.005,6,10,1547,5,764,1.0,496.0,496.0,5,783,1.0,515.0,515.0
0.005,6,10,2007,5,928,1.0,660.0,660.0,5,1079,1.0,811.0,811.0
0.008,6,10,1774,5,923,1.0,655.0,655.0,5,851,2.0,583.0,583.0
174.225,17,76,10770,38,2536,4708.0,44.0,38.0,38,8234,4708.0,239.0,188.0
0.008,6,10,1972,5,910,1.0,642.0,642.0,5,1062,1.0,794.0,794.0
0.004,6,10,2007,5,928,1.0,660.0,660.0,5,1079,1.0,811.0,811.0
40.062,17,10,676,5,460,10014.0,104.0,64.0,5,216,10014.0,20.0,15.0
1777.109,17,144,41760,72,22752,25029.0,288.0,288.0,72,19008,25029.0,236.0,236.0
0.114,6,10,1506,5,395,25.0,127.0,127.0,5,1111,25.0,843.0,843.0
0.04,17,2,170,1,65,0.0,37.0,37.0,1,105,0.0,77.0,77.0
0.134,6,10,1506,5,395,31.0,127.0,127.0,5,1111,26.0,843.0,843.0
0.084,6,10,1506,5,395,17.0,127.0,127.0,5,1111,17.0,843.0,843.0
0.009,6,10,1643,5,860,2.0,592.0,592.0,5,783,2.0,515.0,515.0
0.013,6,10,1972,5,910,3.0,642.0,642.0,5,1062,3.0,794.0,794.0
15.08,17,15,9238,8,6902,2150.0,1350.0,834.0,7,2336,2507.0,1350.0,305.0
0.004,6,10,2006,5,927,1.0,659.0,659.0,5,1079,1.0,811.0,811.0
0.004,6,10,2006,5,927,1.0,659.0,659.0,5,1079,1.0,811.0,811.0
0.085,6,10,1506,5,395,19.0,127.0,127.0,5,1111,19.0,843.0,843.0
0.14,6,10,1506,5,395,32.0,127.0,127.0,5,1111,30.0,843.0,843.0
369.043,6,22,2313,16,867,24602.0,195.0,195.0,6,1446,4653.0,419.0,398.0
0.009,6,10,1762,5,911,2.0,643.0,643.0,5,851,2.0,583.0,583.0
0.004,17,2,136,1,60,0.0,32.0,32.0,1,76,0.0,48.0,48.0
289.253,6,401,347858,192,21551,1514.0,2692.0,889.0,209,326307,1390.0,2804.0,1617.0
0.001,17,2,180,1,66,0.0,38.0,38.0,1,114,0.0,86.0,86.0
0.012,17,2,166,1,75,0.0,47.0,47.0,1,91,0.0,63.0,63.0
0.011,6,10,1983,5,910,2.0,642.0,642.0,5,1073,2.0,805.0,805.0
0.021,6,13,3735,7,497,3.0,125.0,125.0,6,3238,4.0,1470.0,1459.0
15.074,17,15,9238,8,6902,2149.0,1350.0,834.0,7,2336,2507.0,1350.0,305.0
0.005,17,2,169,1,62,0.0,34.0,34.0,1,107,0.0,79.0,79.0
0.001,17,2,180,1,65,0.0,37.0,37.0,1,115,0.0,87.0,87.0
11.221,17,26,4097,13,1845,925.0,268.0,113.0,13,2252,925.0,587.0,145.0
0.004,6,10,2006,5,927,1.0,659.0,659.0,5,1079,1.0,811.0,811.0
240.266,6,41,5326,19,2402,13347.0,581.0,175.0,22,2924,11441.0,566.0,217.0
0.098,6,10,1506,5,395,18.0,127.0,127.0,5,1111,18.0,843.0,843.0
0.04,17,2,136,1,60,0.0,32.0,32.0,1,76,0.0,48.0,48.0
0.086,6,10,1506,5,395,21.0,127.0,127.0,5,1111,19.0,843.0,843.0
308.559,17,20,1124,10,716,34277.0,48.0,43.0,10,408,34277.0,20.0,12.0
240.277,6,44,8847,22,5738,11441.0,1368.0,458.0,22,3109,11441.0,580.0,241.0
0.008,6,10,1547,5,764,1.0,496.0,496.0,5,783,1.0,515.0,515.0
240.087,6,16,4481,9,963,30010.0,238.0,166.0,7,3518,40013.0,1402.0,786.0
0.117,6,10,1506,5,395,24.0,127.0,127.0,5,1111,28.0,843.0,843.0
0.012,6,10,1762,5,911,3.0,643.0,643.0,5,851,2.0,583.0,583.0
0.063,6,10,1506,5,395,14.0,127.0,127.0,5,1111,14.0,843.0,843.0
0.021,6,10,1989,5,910,5.0,642.0,642.0,5,1079,5.0,811.0,811.0
0.001,17,2,179,1,62,0.0,34.0,34.0,1,117,0.0,89.0,89.0
0.006,6,10,1547,5,764,1.0,496.0,496.0,5,783,1.0,515.0,515.0
351.991,6,20,2210,6,1308,12004.0,494.0,494.0,14,902,27076.0,83.0,83.0
0.104,6,10,1506,5,395,25.0,127.0,127.0,5,1111,25.0,843.0,843.0
0.007,6,13,3735,7,497,1.0,125.0,125.0,6,3238,1.0,1470.0,1459.0
0.005,6,10,2007,5,928,1.0,660.0,660.0,5,1079,1.0,811.0,811.0
59.323,6,45,18709,23,13031,408.0,2720.0,1342.0,22,5678,2816.0,1360.0,398.0
0.005,6,10,1989,5,927,1.0,659.0,659.0,5,1062,1.0,794.0,794.0
0.006,6,10,2007,5,928,1.0,660.0,660.0,5,1079,1.0,811.0,811.0
0.094,6,10,1506,5,395,19.0,127.0,127.0,5,1111,21.0,843.0,843.0
10.73,17,28,4418,14,1995,817.0,270.0,114.0,14,2423,817.0,586.0,145.0
0.008,6,10,1989,5,910,1.0,642.0,642.0,5,1079,2.0,811.0,811.0
0.091,6,10,1506,5,395,20.0,127.0,127.0,5,1111,21.0,843.0,843.0
0.042,17,2,170,1,65,0.0,37.0,37.0,1,105,0.0,77.0,77.0
0.082,6,10,1506,5,395,15.0,127.0,127.0,5,1111,18.0,843.0,843.0
0.016,17,2,198,1,91,0.0,63.0,63.0,1,107,0.0,79.0,79.0
240.025,6,9,787,5,488,60006.0,232.0,232.0,4,299,80004.0,83.0,83.0
0.007,17,2,194,1,59,0.0,31.0,31.0,1,135,0.0,107.0,107.0
0.001,17,2,136,1,60,0.0,32.0,32.0,1,76,0.0,48.0,48.0
0.014,6,10,1989,5,910,3.0,642.0,642.0,5,1079,3.0,811.0,811.0
0.017,6,10,1989,5,927,4.0,659.0,659.0,5,1062,4.0,794.0,794.0
0.005,17,2,214,1,75,0.0,47.0,47.0,1,139,0.0,111.0,111.0
0.059,6,10,1506,5,395,14.0,127.0,127.0,5,1111,13.0,843.0,843.0
0.005,6,10,1689,5,839,1.0,571.0,571.0,5,850,1.0,582.0,582.0
0.076,6,10,1506,5,395,17.0,127.0,127.0,5,1111,17.0,843.0,843.0
0.108,6,10,1506,5,395,22.0,127.0,127.0,5,1111,23.0,843.0,843.0
240.017,6,9,787,5,488,60004.0,232.0,232.0,4,299,80004.0,83.0,83.0
0.005,6,10,2000,5,927,1.0,659.0,659.0,5,1073,1.0,805.0,805.0
308.514,17,20,1124,10,716,34265.0,48.0,43.0,10,408,34268.0,20.0,12.0
40.066,17,10,676,5,460,10015.0,104.0,64.0,5,216,10015.0,20.0,15.0
61.533,6,25,17424,14,9539,4733.0,2804.0,1469.0,11,7885,6140.0,2308.0,1217.0
0.004,6,10,2007,5,928,1.0,660.0,660.0,5,1079,1.0,811.0,811.0
0.006,17,2,230,1,68,0.0,40.0,40.0,1,162,0.0,134.0,134.0
0.007,6,10,1547,5,764,1.0,496.0,496.0,5,783,1.0,515.0,515.0
0.005,17,2,180,1,66,0.0,38.0,38.0,1,114,0.0,86.0,86.0
0.114,6,10,1506,5,395,22.0,127.0,127.0,5,1111,25.0,843.0,843.0
0.032,6,10,1972,5,910,7.0,642.0,642.0,5,1062,7.0,794.0,794.0
0.003,17,2,148,1,60,0.0,32.0,32.0,1,88,0.0,60.0,60.0
11.127,17,28,4421,14,1994,843.0,269.0,114.0,14,2427,843.0,586.0,145.0
0.118,6,10,1506,5,395,28.0,127.0,127.0,5,1111,26.0,843.0,843.0
0.006,17,2,225,1,65,0.0,37.0,37.0,1,160,0.0,132.0,132.0
0.005,6,10,1689,5,839,1.0,571.0,571.0,5,850,1.0,582.0,582.0
0.018,17,2,214,1,75,0.0,47.0,47.0,1,139,0.0,111.0,111.0
0.005,6,10,2007,5,928,1.0,660.0,660.0,5,1079,1.0,811.0,811.0
0.007,6,14,3799,7,509,1.0,137.0,137.0,7,3290,1.0,1448.0,972.0
0.011,6,10,1762,5,911,2.0,643.0,643.0,5,851,2.0,583.0,583.0
0.005,17,2,180,1,66,0.0,38.0,38.0,1,114,0.0,86.0,86.0
0.004,6,10,2006,5,927,1.0,659.0,659.0,5,1079,1.0,811.0,811.0
0.003,17,2,132,1,58,0.0,30.0,30.0,1,74,0.0,46.0,46.0
0.015,6,10,1972,5,910,3.0,642.0,642.0,5,1062,3.0,794.0,794.0
11.497,17,28,4399,14,2312,871.0,587.0,137.0,14,2087,871.0,270.0,121.0
0.004,6,10,1702,5,863,1.0,595.0,595.0,5,839,1.0,571.0,571.0
0.004,17,2,136,1,60,0.0,32.0,32.0,1,76,0.0,48.0,48.0
0.004,6,10,2006,5,927,1.0,659.0,659.0,5,1079,1.0,811.0,811.0
40.083,17,10,676,5,460,10019.0,104.0,64.0,5,216,10019.0,20.0,15.0
0.005,6,10,2007,5,928,1.0,660.0,660.0,5,1079,1.0,811.0,811.0
0.068,6,10,1506,5,395,16.0,127.0,127.0,5,1111,13.0,843.0,843.0
0.121,6,10,1506,5,395,23.0,127.0,127.0,5,1111,28.0,843.0,843.0
0.005,6,10,2006,5,927,1.0,659.0,659.0,5,1079,1.0,811.0,811.0
0.166,6,10,1506,5,395,39.0,127.0,127.0,5,1111,35.0,843.0,843.0
0.006,6,10,1547,5,764,1.0,496.0,496.0,5,783,1.0,515.0,515.0
40.066,17,10,676,5,460,10014.0,104.0,64.0,5,216,10015.0,20.0,15.0
0.004,6,10,2006,5,927,1.0,659.0,659.0,5,1079,1.0,811.0,811.0
0.001,17,2,180,1,66,0.0,38.0,38.0,1,114,0.0,86.0,86.0
0.012,6,10,1972,5,910,3.0,642.0,642.0,5,1062,2.0,794.0,794.0
0.005,6,10,2007,5,928,1.0,660.0,660.0,5,1079,1.0,811.0,811.0
0.006,6,13,3690,7,452,1.0,80.0,80.0,6,3238,1.0,1470.0,1459.0
0.009,6,12,1926,6,1189,1.0,659.0,434.0,6,737,1.0,417.0,417.0
0.037,17,2,136,1,60,0.0,32.0,32.0,1,76,0.0,48.0,48.0
0.009,6,10,1989,5,910,2.0,642.0,642.0,5,1079,2.0,811.0,811.0
0.15,6,10,1506,5,395,36.0,127.0,127.0,5,1111,34.0,843.0,843.0
0.009,6,10,1989,5,910,2.0,642.0,642.0,5,1079,2.0,811.0,811.0
40.071,17,10,676,5,460,10012.0,104.0,64.0,5,216,10016.0,20.0,15.0
0.005,6,10,2006,5,927,1.0,659.0,659.0,5,1079,1.0,811.0,811.0
0.123,6,10,1506,5,395,25.0,127.0,127.0,5,1111,28.0,843.0,843.0
361.798,6,21,1793,16,1030,24119.0,190.0,190.0,5,763,60009.0,462.0,247.0
0.005,17,2,179,1,71,0.0,43.0,43.0,1,108,0.0,80.0,80.0
10.92,17,28,4422,14,1994,831.0,269.0,114.0,14,2428,831.0,587.0,145.0
0.005,6,10,2006,5,927,1.0,659.0,659.0,5,1079,1.0,811.0,811.0
0.007,17,2,179,1,71,0.0,43.0,43.0,1,108,0.0,80.0,80.0
0.006,17,2,194,1,59,0.0,31.0,31.0,1,135,0.0,107.0,107.0
289.688,6,387,347839,190,21459,1532.0,2736.0,890.0,197,326380,1477.0,2916.0,1727.0
0.012,17,2,152,1,56,0.0,28.0,28.0,1,96,0.0,68.0,68.0
0.013,6,14,3868,7,578,2.0,206.0,206.0,7,3290,2.0,1448.0,972.0
0.001,17,2,166,1,75,0.0,47.0,47.0,1,91,0.0,63.0,63.0
15.071,17,15,9238,8,6902,2149.0,1350.0,834.0,7,2336,2506.0,1350.0,305.0
0.009,6,10,1762,5,911,2.0,643.0,643.0,5,851,2.0,583.0,583.0
0.004,6,10,2000,5,927,1.0,659.0,659.0,5,1073,1.0,805.0,805.0
0.068,17,8,3613,4,1874,22.0,1350.0,440.0,4,1739,11.0,1350.0,406.0
170.453,17,74,10043,37,2456,4734.0,44.0,38.0,37,7587,4734.0,239.0,177.0
0.001,17,2,180,1,66,0.0,38.0,38.0,1,114,0.0,86.0,86.0
290.521,6,309,343353,115,17530,2548.0,2736.0,888.0,194,325823,1505.0,2804.0,1754.0
0.088,17,2,144,1,64,0.0,36.0,36.0,1,80,0.0,52.0,52.0
0.005,6,13,3684,7,446,0.0,74.0,74.0,6,3238,0.0,1470.0,1459.0
372.137,6,22,2313,16,867,24809.0,195.0,195.0,6,1446,4635.0,419.0,398.0
0.001,17,2,174,1,72,0.0,44.0,44.0,1,102,0.0,74.0,74.0
0.012,6,10,1972,5,910,2.0,642.0,642.0,5,1062,3.0,794.0,794.0
0.013,6,10,1972,5,910,3.0,642.0,642.0,5,1062,3.0,794.0,794.0
300.941,6,44,18489,24,12891,13084.0,2720.0,1322.0,20,5598,461.0,2667.0,435.0
0.005,6,10,1989,5,927,1.0,659.0,659.0,5,1062,1.0,794.0,794.0
0.069,17,8,3613,4,1874,23.0,1350.0,440.0,4,1739,12.0,1350.0,406.0
0.004,6,10,1702,5,863,1.0,595.0,595.0,5,839,1.0,571.0,571.0
0.123,17,2,80,1,32,0.0,4.0,4.0,1,48,0.0,20.0,20.0
40.073,17,10,676,5,460,10015.0,104.0,64.0,5,216,10017.0,20.0,15.0
0.089,6,10,1506,5,395,21.0,127.0,127.0,5,1111,20.0,843.0,843.0
0.08,6,10,1506,5,395,19.0,127.0,127.0,5,1111,18.0,843.0,843.0
0.016,6,13,3735,7,497,2.0,125.0,125.0,6,3238,3.0,1470.0,1459.0
0.005,6,10,2007,5,928,1.0,660.0,660.0,5,1079,1.0,811.0,811.0
0.003,17,2,148,1,60,0.0,32.0,32.0,1,88,0.0,60.0,60.0
15.075,17,15,9238,8,6902,2149.0,1350.0,834.0,7,2336,2507.0,1350.0,305.0
0.004,17,2,136,1,60,0.0,32.0,32.0,1,76,0.0,48.0,48.0
40.053,17,10,676,5,460,10012.0,104.0,64.0,5,216,10012.0,20.0,15.0
0.004,17,4,284,2,120,0.0,32.0,32.0,2,164,0.0,60.0,54.0
0.004,6,10,1774,5,923,1.0,655.0,655.0,5,851,1.0,583.0,583.0
0.004,6,10,2000,5,927,1.0,659.0,659.0,5,1073,1.0,805.0,805.0
354.019,6,22,1847,17,1082,22126.0,190.0,190.0,5,765,60002.0,464.0,248.0
0.004,17,2,148,1,60,0.0,32.0,32.0,1,88,0.0,60.0,60.0
15.083,17,15,8134,8,5953,2150.0,1350.0,716.0,7,2181,2509.0,1350.0,283.0
0.009,6,14,3787,7,497,1.0,125.0,125.0,7,3290,1.0,1448.0,972.0
0.007,17,4,284,2,120,0.0,32.0,32.0,2,164,1.0,60.0,54.0
0.029,6,10,1989,5,910,7.0,642.0,642.0,5,1079,7.0,811.0,811.0
0.014,6,10,1631,5,848,3.0,580.0,580.0,5,783,3.0,515.0,515.0
11.132,17,28,4421,14,1994,844.0,269.0,114.0,14,2427,843.0,586.0,145.0
0.013,17,2,152,1,76,0.0,48.0,48.0,1,76,0.0,48.0,48.0
0.004,6,10,2007,5,928,1.0,660.0,660.0,5,1079,1.0,811.0,811.0
0.006,6,10,1854,5,889,1.0,621.0,621.0,5,965,1.0,697.0,697.0
0.02,6,10,1990,5,911,5.0,643.0,643.0,5,1079,5.0,811.0,811.0
0.051,17,2,152,1,76,0.0,48.0,48.0,1,76,0.0,48.0,48.0
0.007,6,10,1762,5,911,1.0,643.0,643.0,5,851,1.0,583.0,583.0
0.103,6,10,1506,5,395,21.0,127.0,127.0,5,1111,21.0,843.0,843.0
0.083,6,10,1506,5,395,19.0,127.0,127.0,5,1111,18.0,843.0,843.0
0.024,17,2,140,1,62,0.0,34.0,34.0,1,78,0.0,50.0,50.0
300.401,6,16,2170,9,684,37529.0,146.0,146.0,7,1486,50039.0,419.0,398.0
0.005,6,10,1989,5,927,1.0,659.0,659.0,5,1062,1.0,794.0,794.0
0.008,6,10,1631,5,848,2.0,580.0,580.0,5,783,2.0,515.0,515.0
0.006,6,10,1547,5,764,1.0,496.0,496.0,5,783,1.0,515.0,515.0
0.006,6,10,2007,5,928,1.0,660.0,660.0,5,1079,1.0,811.0,811.0
0.005,6,10,1689,5,839,1.0,571.0,571.0,5,850,1.0,582.0,582.0
0.005,6,10,2007,5,928,1.0,660.0,660.0,5,1079,1.0,811.0,811.0
0.113,6,10,1506,5,395,24.0,127.0,127.0,5,1111,24.0,843.0,843.0
0.107,6,10,1972,5,910,26.0,642.0,642.0,5,1062,26.0,794.0,794.0
9.037,17,6,376,5,280,2259.0,28.0,28.0,1,96,0.0,68.0,68.0
0.005,6,10,2000,5,927,1.0,659.0,659.0,5,1073,1.0,805.0,805.0
0.009,6,10,1989,5,910,2.0,642.0,642.0,5,1079,2.0,811.0,811.0
0.126,6,10,1506,5,395,30.0,127.0,127.0,5,1111,29.0,843.0,843.0
0.005,17,2,136,1,60,0.0,32.0,32.0,1,76,0.0,48.0,48.0
0.011,6,10,1972,5,910,2.0,642.0,642.0,5,1062,2.0,794.0,794.0
0.016,6,10,1989,5,910,4.0,642.0,642.0,5,1079,3.0,811.0,811.0
0.013,6,10,1990,5,911,3.0,643.0,643.0,5,1079,3.0,811.0,811.0
0.013,17,2,152,1,76,0.0,48.0,48.0,1,76,0.0,48.0,48.0
0.01,6,10,1989,5,910,2.0,642.0,642.0,5,1079,2.0,811.0,811.0
0.039,17,2,152,1,76,0.0,48.0,48.0,1,76,0.0,48.0,48.0
0.005,6,10,1643,5,860,1.0,592.0,592.0,5,783,1.0,515.0,515.0
0.098,6,10,1506,5,395,22.0,127.0,127.0,5,1111,20.0,843.0,843.0
0.016,6,10,1677,5,827,4.0,559.0,559.0,5,850,4.0,582.0,582.0
0.005,6,10,2006,5,927,1.0,659.0,659.0,5,1079,1.0,811.0,811.0
0.042,17,4,580,2,122,0.0,33.0,33.0,2,458,2.0,307.0,201.0
0.004,6,10,2006,5,927,1.0,659.0,659.0,5,1079,1.0,811.0,811.0
0.005,17,2,240,1,61,0.0,33.0,33.0,1,179,0.0,151.0,151.0
0.005,6,10,1989,5,927,1.0,659.0,659.0,5,1062,1.0,794.0,794.0
0.005,6,10,1989,5,927,1.0,659.0,659.0,5,1062,1.0,794.0,794.0
0.005,6,10,2006,5,927,1.0,659.0,659.0,5,1079,1.0,811.0,811.0
0.009,6,10,1762,5,911,2.0,643.0,643.0,5,851,2.0,583.0,583.0
0.005,6,10,2000,5,927,1.0,659.0,659.0,5,1073,1.0,805.0,805.0
0.012,6,10,1989,5,910,3.0,642.0,642.0,5,1079,2.0,811.0,811.0
30.473,6,28,9670,15,2569,2176.0,1168.0,447.0,13,7101,2538.0,1402.0,802.0
9.037,17,6,376,5,280,2259.0,28.0,28.0,1,96,0.0,68.0,68.0
0.09,6,10,1506,5,395,17.0,127.0,127.0,5,1111,17.0,843.0,843.0
177.212,17,80,11595,40,2671,4543.0,44.0,38.0,40,8924,4543.0,260.0,195.0
0.087,6,10,1506,5,395,19.0,127.0,127.0,5,1111,17.0,843.0,843.0
0.022,6,10,1989,5,910,5.0,642.0,642.0,5,1079,5.0,811.0,811.0
0.006,6,10,1547,5,764,1.0,496.0,496.0,5,783,1.0,515.0,515.0
0.006,6,10,1689,5,839,1.0,571.0,571.0,5,850,1.0,582.0,582.0
40.054,17,10,676,5,460,10012.0,104.0,64.0,5,216,10010.0,20.0,15.0
0.094,6,10,1506,5,395,22.0,127.0,127.0,5,1111,21.0,843.0,843.0
0.005,6,10,2006,5,927,1.0,659.0,659.0,5,1079,1.0,811.0,811.0
0.001,17,2,180,1,66,0.0,38.0,38.0,1,114,0.0,86.0,86.0
0.012,6,10,1631,5,848,3.0,580.0,580.0,5,783,2.0,515.0,515.0
0.0,17,2,179,1,62,0.0,34.0,34.0,1,117,0.0,89.0,89.0
0.019,6,10,1972,5,910,4.0,642.0,642.0,5,1062,4.0,794.0,794.0
0.095,6,10,1506,5,395,23.0,127.0,127.0,5,1111,18.0,843.0,843.0
0.018,6,10,1983,5,910,4.0,642.0,642.0,5,1073,4.0,805.0,805.0
310.067,17,18,1044,10,716,34451.0,48.0,43.0,8,328,37954.0,20.0,13.0
0.005,6,10,1989,5,927,1.0,659.0,659.0,5,1062,1.0,794.0,794.0
0.01,6,10,1972,5,910,2.0,642.0,642.0,5,1062,2.0,794.0,794.0
0.007,6,10,1989,5,910,1.0,642.0,642.0,5,1079,1.0,811.0,811.0
0.006,17,2,144,1,64,0.0,36.0,36.0,1,80,0.0,52.0,52.0
0.01,6,10,1972,5,910,2.0,642.0,642.0,5,1062,2.0,794.0,794.0
0.006,6,10,1689,5,839,1.0,571.0,571.0,5,850,1.0,582.0,582.0
240.096,6,16,4482,9,963,30012.0,238.0,166.0,7,3519,40015.0,1402.0,786.0
0.004,6,10,2000,5,927,1.0,659.0,659.0,5,1073,1.0,805.0,805.0
0.005,6,10,2000,5,927,1.0,659.0,659.0,5,1073,1.0,805.0,805.0
0.015,6,10,1990,5,911,3.0,643.0,643.0,5,1079,3.0,811.0,811.0
0.012,6,10,1989,5,910,2.0,642.0,642.0,5,1079,3.0,811.0,811.0
0.005,6,10,2006,5,927,1.0,659.0,659.0,5,1079,1.0,811.0,811.0
0.004,6,10,1702,5,863,1.0,595.0,595.0,5,839,0.0,571.0,571.0
40.058,17,10,676,5,460,10013.0,104.0,64.0,5,216,10013.0,20.0,15.0
15.071,17,15,9239,8,6902,2149.0,1350.0,834.0,7,2337,2507.0,1350.0,305.0
0.004,6,10,2007,5,928,1.0,660.0,660.0,5,1079,1.0,811.0,811.0
0.004,17,2,132,1,58,0.0,30.0,30.0,1,74,0.0,46.0,46.0
0.005,6,10,2006,5,927,1.0,659.0,659.0,5,1079,1.0,811.0,811.0
0.013,6,10,1989,5,910,3.0,642.0,642.0,5,1079,3.0,811.0,811.0
85.57,6,25,17427,14,9539,6582.0,2847.0,1469.0,11,7888,8543.0,2311.0,1218.0
0.009,6,10,1989,5,910,2.0,642.0,642.0,5,1079,2.0,811.0,811.0
361.891,6,19,1689,15,978,25849.0,190.0,190.0,4,711,80016.0,495.0,495.0
0.006,6,10,1547,5,764,1.0,496.0,496.0,5,783,1.0,515.0,515.0
0.005,6,10,1689,5,839,1.0,571.0,571.0,5,850,1.0,582.0,582.0
0.005,6,10,1989,5,927,1.0,659.0,659.0,5,1062,1.0,794.0,794.0
0.087,6,10,1506,5,395,19.0,127.0,127.0,5,1111,20.0,843.0,843.0
0.075,6,10,1506,5,395,15.0,127.0,127.0,5,1111,15.0,843.0,843.0
0.093,6,10,1506,5,395,21.0,127.0,127.0,5,1111,22.0,843.0,843.0
0.015,6,13,3735,7,497,2.0,125.0,125.0,6,3238,2.0,1470.0,1459.0
40.093,17,10,676,5,460,10021.0,104.0,64.0,5,216,10022.0,20.0,15.0
1793.85,6,64,7344,42,4469,43752.0,1625.0,108.0,22,2875,85413.0,1111.0,82.0
0.075,6,10,1506,5,395,17.0,127.0,127.0,5,1111,15.0,843.0,843.0
369.942,6,22,2313,16,867,24662.0,195.0,195.0,6,1446,4636.0,419.0,398.0
0.095,6,10,1506,5,395,21.0,127.0,127.0,5,1111,22.0,843.0,843.0
0.015,6,10,1677,5,827,3.0,559.0,559.0,5,850,3.0,582.0,582.0
0.008,6,10,1689,5,839,2.0,571.0,571.0,5,850,2.0,582.0,582.0
0.01,6,10,1989,5,910,2.0,642.0,642.0,5,1079,2.0,811.0,811.0
0.042,17,2,182,1,65,0.0,37.0,37.0,1,117,0.0,89.0,89.0
0.075,6,10,1506,5,395,16.0,127.0,127.0,5,1111,16.0,843.0,843.0
0.068,6,10,1506,5,395,15.0,127.0,127.0,5,1111,14.0,843.0,843.0
0.005,17,2,144,1,64,0.0,36.0,36.0,1,80,0.0,52.0,52.0
11.173,17,28,4422,14,1994,847.0,269.0,114.0,14,2428,847.0,587.0,145.0
0.012,6,10,1972,5,910,3.0,642.0,642.0,5,1062,2.0,794.0,794.0
0.006,6,10,1989,5,927,1.0,659.0,659.0,5,1062,1.0,794.0,794.0
0.014,6,10,1631,5,848,3.0,580.0,580.0,5,783,3.0,515.0,515.0
0.169,17,2,152,1,76,0.0,48.0,48.0,1,76,0.0,48.0,48.0
0.02,6,10,1677,5,827,4.0,559.0,559.0,5,850,4.0,582.0,582.0
0.062,6,10,1506,5,395,14.0,127.0,127.0,5,1111,13.0,843.0,843.0
0.009,6,10,1990,5,911,2.0,643.0,643.0,5,1079,2.0,811.0,811.0
0.075,6,10,1506,5,395,18.0,127.0,127.0,5,1111,15.0,843.0,843.0
0.012,6,10,1983,5,910,2.0,642.0,642.0,5,1073,2.0,805.0,805.0
40.059,17,10,676,5,460,10014.0,104.0,64.0,5,216,10014.0,20.0,15.0
0.005,6,10,2000,5,927,1.0,659.0,659.0,5,1073,1.0,805.0,805.0
0.088,6,10,1506,5,395,17.0,127.0,127.0,5,1111,17.0,843.0,843.0
0.005,6,10,2006,5,927,1.0,659.0,659.0,5,1079,1.0,811.0,811.0
0.013,6,10,1972,5,910,3.0,642.0,642.0,5,1062,3.0,794.0,794.0
240.085,6,16,4482,9,963,30010.0,238.0,166.0,7,3519,40013.0,1402.0,786.0
40.073,17,10,676,5,460,10017.0,104.0,64.0,5,216,10017.0,20.0,15.0
0.006,6,10,1547,5,764,1.0,496.0,496.0,5,783,1.0,515.0,515.0
0.007,17,2,148,1,60,0.0,32.0,32.0,1,88,0.0,60.0,60.0
0.004,6,10,2000,5,927,1.0,659.0,659.0,5,1073,1.0,805.0,805.0
0.004,17,2,170,1,65,0.0,37.0,37.0,1,105,0.0,77.0,77.0
0.095,6,10,1506,5,395,20.0,127.0,127.0,5,1111,21.0,843.0,843.0
0.007,6,10,1762,5,911,1.0,643.0,643.0,5,851,1.0,583.0,583.0
241.781,6,384,348053,188,21290,1292.0,2736.0,958.0,196,326763,1239.0,2916.0,1701.0
0.003,17,4,284,2,120,0.0,32.0,32.0,2,164,0.0,60.0,54.0
0.005,17,2,136,1,60,0.0,32.0,32.0,1,76,0.0,48.0,48.0
0.016,6,10,1677,5,827,4.0,559.0,559.0,5,850,3.0,582.0,582.0
0.009,6,10,1989,5,910,2.0,642.0,642.0,5,1079,2.0,811.0,811.0
0.01,6,13,3735,7,497,1.0,125.0,125.0,6,3238,2.0,1470.0,1459.0
0.005,6,10,1689,5,839,1.0,571.0,571.0,5,850,1.0,582.0,582.0
0.001,17,2,180,1,66,0.0,38.0,38.0,1,114,0.0,86.0,86.0
178.278,17,84,12052,42,2791,4348.0,44.0,38.0,42,9261,4348.0,261.0,192.0
0.005,17,2,249,1,64,0.0,36.0,36.0,1,185,0.0,157.0,157.0
0.011,6,10,1983,5,910,2.0,642.0,642.0,5,1073,2.0,805.0,805.0
0.02,6,10,1972,5,910,5.0,642.0,642.0,5,1062,4.0,794.0,794.0
0.004,6,10,2006,5,927,1.0,659.0,659.0,5,1079,1.0,811.0,811.0
368.057,6,31,10176,17,2382,23003.0,676.0,298.0,14,7794,23695.0,1402.0,882.0
0.07,6,10,1506,5,395,16.0,127.0,127.0,5,1111,12.0,843.0,843.0
0.167,17,2,152,1,76,0.0,48.0,48.0,1,76,0.0,48.0,48.0
0.003,17,2,208,1,72,0.0,44.0,44.0,1,136,0.0,108.0,108.0
40.056,17,10,676,5,460,10012.0,104.0,64.0,5,216,10013.0,20.0,15.0
0.005,6,10,1774,5,923,1.0,655.0,655.0,5,851,1.0,583.0,583.0
0.005,6,10,2007,5,928,1.0,660.0,660.0,5,1079,1.0,811.0,811.0
0.001,17,2,180,1,66,0.0,38.0,38.0,1,114,0.0,86.0,86.0
354.059,6,19,1691,15,978,25289.0,190.0,190.0,4,713,80003.0,497.0,497.0
0.004,17,2,138,1,61,0.0,33.0,33.0,1,77,0.0,49.0,49.0
0.005,6,10,2006,5,927,1.0,659.0,659.0,5,1079,1.0,811.0,811.0
0.012,6,10,1990,5,911,3.0,643.0,643.0,5,1079,2.0,811.0,811.0
1727.914,6,46,2830,30,1725,59583.0,35.0,35.0,16,1105,115189.0,31.0,31.0
0.006,17,2,166,1,75,0.0,47.0,47.0,1,91,0.0,63.0,63.0
0.005,17,2,169,1,62,0.0,34.0,34.0,1,107,0.0,79.0,79.0
0.066,6,10,1506,5,395,14.0,127.0,127.0,5,1111,15.0,843.0,843.0
0.006,6,10,1547,5,764,1.0,496.0,496.0,5,783,1.0,515.0,515.0
0.086,6,10,1506,5,395,19.0,127.0,127.0,5,1111,21.0,843.0,843.0
0.011,17,2,148,1,60,0.0,32.0,32.0,1,88,0.0,60.0,60.0
0.005,6,10,2006,5,927,1.0,659.0,659.0,5,1079,1.0,811.0,811.0
0.001,17,2,136,1,60,0.0,32.0,32.0,1,76,0.0,48.0,48.0
0.009,6,12,1926,6,1189,1.0,659.0,434.0,6,737,1.0,417.0,417.0
0.007,6,10,1547,5,764,1.0,496.0,496.0,5,783,1.0,515.0,515.0
0.218,6,10,1506,5,395,46.0,127.0,127.0,5,1111,34.0,843.0,843.0
0.109,6,10,1506,5,395,25.0,127.0,127.0,5,1111,26.0,843.0,843.0
0.131,6,10,1506,5,395,30.0,127.0,127.0,5,1111,27.0,843.0,843.0
0.008,17,2,194,1,59,0.0,31.0,31.0,1,135,0.0,107.0,107.0
0.007,6,10,2007,5,928,1.0,660.0,660.0,5,1079,1.0,811.0,811.0
0.012,6,10,1990,5,911,2.0,643.0,643.0,5,1079,2.0,811.0,811.0
0.001,17,2,166,1,75,0.0,47.0,47.0,1,91,0.0,63.0,63.0
40.068,17,10,676,5,460,10016.0,104.0,64.0,5,216,10016.0,20.0,15.0
0.111,17,2,230,1,68,0.0,40.0,40.0,1,162,0.0,134.0,134.0
0.001,17,2,179,1,62,0.0,34.0,34.0,1,117,0.0,89.0,89.0
0.013,6,10,1972,5,910,3.0,642.0,642.0,5,1062,3.0,794.0,794.0
0.005,17,2,180,1,58,0.0,30.0,30.0,1,122,0.0,94.0,94.0
0.012,6,10,1762,5,911,2.0,643.0,643.0,5,851,3.0,583.0,583.0
0.005,6,10,2000,5,927,1.0,659.0,659.0,5,1073,1.0,805.0,805.0
40.197,6,43,10292,25,3106,1674.0,979.0,199.0,18,7186,2364.0,1402.0,568.0
0.005,6,10,2006,5,927,1.0,659.0,659.0,5,1079,1.0,811.0,811.0
0.021,6,10,1990,5,911,5.0,643.0,643.0,5,1079,5.0,811.0,811.0
0.004,6,10,2000,5,927,1.0,659.0,659.0,5,1073,1.0,805.0,805.0
0.111,6,10,1506,5,395,27.0,127.0,127.0,5,1111,25.0,843.0,843.0
300.543,6,31,10172,17,2173,18783.0,468.0,256.0,14,7999,18502.0,1402.0,907.0
354.069,6,21,1795,16,1030,23604.0,190.0,190.0,5,765,60002.0,464.0,248.0
0.005,6,13,3747,7,509,0.0,137.0,137.0,6,3238,0.0,1470.0,1459.0
0.138,6,10,1506,5,395,22.0,127.0,127.0,5,1111,30.0,843.0,843.0
0.005,6,10,2000,5,927,1.0,659.0,659.0,5,1073,1.0,805.0,805.0
0.004,6,10,1774,5,923,1.0,655.0,655.0,5,851,1.0,583.0,583.0
0.072,17,8,3613,4,1874,24.0,1350.0,440.0,4,1739,12.0,1350.0,406.0
0.002,17,2,180,1,66,0.0,38.0,38.0,1,114,0.0,86.0,86.0
0.009,6,10,1983,5,910,2.0,642.0,642.0,5,1073,2.0,805.0,805.0
0.011,6,10,1989,5,927,2.0,659.0,659.0,5,1062,2.0,794.0,794.0
0.007,17,2,144,1,64,0.0,36.0,36.0,1,80,0.0,52.0,52.0
0.006,17,2,282,1,69,0.0,41.0,41.0,1,213,0.0,185.0,185.0
15.071,17,15,9239,8,6902,2149.0,1350.0,834.0,7,2337,2506.0,1350.0,305.0
0.006,17,2,170,1,65,0.0,37.0,37.0,1,105,0.0,77.0,77.0
0.11,6,10,1506,5,395,24.0,127.0,127.0,5,1111,25.0,843.0,843.0
0.172,17,2,152,1,76,0.0,48.0,48.0,1,76,0.0,48.0,48.0
0.005,6,10,1643,5,860,1.0,592.0,592.0,5,783,1.0,515.0,515.0
0.016,6,10,1990,5,911,4.0,643.0,643.0,5,1079,4.0,811.0,811.0
0.019,6,10,1983,5,910,4.0,642.0,642.0,5,1073,4.0,805.0,805.0
0.006,17,2,164,1,74,0.0,46.0,46.0,1,90,0.0,62.0,62.0
0.018,6,10,1989,5,910,4.0,642.0,642.0,5,1079,4.0,811.0,811.0
0.134,17,2,80,1,32,0.0,4.0,4.0,1,48,0.0,20.0,20.0
0.008,6,10,1989,5,910,2.0,642.0,642.0,5,1079,2.0,811.0,811.0
0.011,6,10,1983,5,910,2.0,642.0,642.0,5,1073,2.0,805.0,805.0
0.005,6,10,1774,5,923,1.0,655.0,655.0,5,851,1.0,583.0,583.0
0.111,6,10,1506,5,395,23.0,127.0,127.0,5,1111,25.0,843.0,843.0
0.005,6,10,1547,5,764,1.0,496.0,496.0,5,783,1.0,515.0,515.0
0.003,17,2,136,1,60,0.0,32.0,32.0,1,76,0.0,48.0,48.0
0.009,6,10,1983,5,910,2.0,642.0,642.0,5,1073,2.0,805.0,805.0
0.008,6,10,1989,5,910,2.0,642.0,642.0,5,1079,1.0,811.0,811.0
0.003,17,2,136,1,60,0.0,32.0,32.0,1,76,0.0,48.0,48.0
0.001,17,2,180,1,66,0.0,38.0,38.0,1,114,0.0,86.0,86.0
0.085,6,10,1506,5,395,18.0,127.0,127.0,5,1111,18.0,843.0,843.0
0.004,6,10,2006,5,927,1.0,659.0,659.0,5,1079,1.0,811.0,811.0
0.113,6,10,1506,5,395,25.0,127.0,127.0,5,1111,22.0,843.0,843.0
0.005,6,10,2006,5,927,1.0,659.0,659.0,5,1079,1.0,811.0,811.0
295.057,6,326,345865,120,18434,2479.0,2736.0,871.0,206,327431,1439.0,2804.0,1658.0
0.012,6,10,1631,5,848,2.0,580.0,580.0,5,783,3.0,515.0,515.0
0.005,6,10,2007,5,928,1.0,660.0,660.0,5,1079,1.0,811.0,811.0
0.004,17,2,136,1,60,0.0,32.0,32.0,1,76,0.0,48.0,48.0
0.042,17,2,152,1,76,0.0,48.0,48.0,1,76,0.0,48.0,48.0
0.005,6,10,1854,5,889,1.0,621.0,621.0,5,965,1.0,697.0,697.0
0.04,17,2,166,1,75,0.0,47.0,47.0,1,91,0.0,63.0,63.0
0.009,6,10,1983,5,910,2.0,642.0,642.0,5,1073,2.0,805.0,805.0
0.006,6,10,1547,5,764,1.0,496.0,496.0,5,783,1.0,515.0,515.0
0.072,17,2,156,1,64,0.0,36.0,36.0,1,92,0.0,64.0,64.0
0.011,6,10,1989,5,910,2.0,642.0,642.0,5,1079,2.0,811.0,811.0
0.013,6,10,2000,5,927,3.0,659.0,659.0,5,1073,3.0,805.0,805.0
0.005,6,10,2000,5,927,1.0,659.0,659.0,5,1073,1.0,805.0,805.0
366.952,6,21,1795,16,1030,24463.0,190.0,190.0,5,765,60003.0,464.0,248.0
0.012,6,10,1989,5,910,2.0,642.0,642.0,5,1079,3.0,811.0,811.0
0.005,6,10,2006,5,927,1.0,659.0,659.0,5,1079,1.0,811.0,811.0
1770.383,17,92,8096,46,4048,39341.0,60.0,60.0,46,4048,39341.0,60.0,60.0
0.004,6,10,1989,5,927,1.0,659.0,659.0,5,1062,1.0,794.0,794.0
0.049,17,2,182,1,65,0.0,37.0,37.0,1,117,0.0,89.0,89.0
0.001,17,2,179,1,62,0.0,34.0,34.0,1,117,0.0,89.0,89.0
40.089,17,10,676,5,460,10019.0,104.0,64.0,5,216,10021.0,20.0,15.0
0.005,6,10,1643,5,860,1.0,592.0,592.0,5,783,1.0,515.0,515.0
0.003,17,2,132,1,58,0.0,30.0,30.0,1,74,0.0,46.0,46.0
0.004,17,2,136,1,60,0.0,32.0,32.0,1,76,0.0,48.0,48.0
0.015,6,10,1989,5,910,3.0,642.0,642.0,5,1079,3.0,811.0,811.0
0.005,17,2,168,1,76,0.0,48.0,48.0,1,92,0.0,64.0,64.0
308.378,17,20,1124,10,716,34250.0,48.0,43.0,10,408,34249.0,20.0,12.0
0.005,17,2,166,1,75,0.0,47.0,47.0,1,91,0.0,63.0,63.0
0.016,6,10,1631,5,848,3.0,580.0,580.0,5,783,3.0,515.0,515.0
0.011,6,10,1990,5,911,2.0,643.0,643.0,5,1079,2.0,811.0,811.0
0.145,6,10,1506,5,395,34.0,127.0,127.0,5,1111,33.0,843.0,843.0
0.1,6,10,1506,5,395,22.0,127.0,127.0,5,1111,19.0,843.0,843.0
0.01,6,10,1972,5,910,2.0,642.0,642.0,5,1062,2.0,794.0,794.0
0.006,6,10,1643,5,860,1.0,592.0,592.0,5,783,1.0,515.0,515.0
0.073,6,10,1506,5,395,15.0,127.0,127.0,5,1111,17.0,843.0,843.0
0.006,17,2,184,1,68,0.0,40.0,40.0,1,116,0.0,88.0,88.0
40.063,17,10,676,5,460,10012.0,104.0,64.0,5,216,10013.0,20.0,15.0
0.075,6,10,1506,5,395,18.0,127.0,127.0,5,1111,15.0,843.0,843.0
0.006,17,2,140,1,62,0.0,34.0,34.0,1,78,0.0,50.0,50.0
0.008,6,12,1926,6,1189,1.0,659.0,434.0,6,737,1.0,417.0,417.0
40.085,17,10,676,5,460,10015.0,104.0,64.0,5,216,10020.0,20.0,15.0
0.074,6,10,1506,5,395,16.0,127.0,127.0,5,1111,17.0,843.0,843.0
0.125,6,10,1506,5,395,28.0,127.0,127.0,5,1111,27.0,843.0,843.0
0.014,6,10,1631,5,848,3.0,580.0,580.0,5,783,3.0,515.0,515.0
0.013,6,10,2006,5,927,3.0,659.0,659.0,5,1079,3.0,811.0,811.0
1799.951,17,2782,212668,1383,112072,1302.0,84.0,53.0,1399,100596,1287.0,227.0,43.0
0.006,6,10,1547,5,764,1.0,496.0,496.0,5,783,1.0,515.0,515.0
0.107,6,10,1506,5,395,23.0,127.0,127.0,5,1111,25.0,843.0,843.0
0.008,6,10,1983,5,910,2.0,642.0,642.0,5,1073,2.0,805.0,805.0
309.149,17,18,1008,9,640,38626.0,48.0,43.0,9,368,38626.0,20.0,12.0
240.02,6,9,787,5,488,60005.0,232.0,232.0,4,299,80005.0,83.0,83.0
0.005,17,2,293,1,73,0.0,45.0,45.0,1,220,0.0,192.0,192.0
0.005,6,10,2000,5,927,1.0,659.0,659.0,5,1073,1.0,805.0,805.0
0.011,6,13,3735,7,497,1.0,125.0,125.0,6,3238,2.0,1470.0,1459.0
240.092,6,16,4481,9,963,30011.0,238.0,166.0,7,3518,40014.0,1402.0,786.0
0.041,17,2,412,1,61,0.0,33.0,33.0,1,351,0.0,323.0,323.0
0.005,6,10,2007,5,928,1.0,660.0,660.0,5,1079,1.0,811.0,811.0
0.121,6,10,1506,5,395,27.0,127.0,127.0,5,1111,25.0,843.0,843.0
0.003,17,4,284,2,120,0.0,32.0,32.0,2,164,0.0,60.0,54.0
0.008,6,12,1926,6,1189,1.0,659.0,434.0,6,737,1.0,417.0,417.0
0.006,6,10,1643,5,860,1.0,592.0,592.0,5,783,1.0,515.0,515.0
0.01,6,10,1631,5,848,2.0,580.0,580.0,5,783,2.0,515.0,515.0
0.01,6,10,1989,5,910,2.0,642.0,642.0,5,1079,2.0,811.0,811.0
0.08,6,10,1506,5,395,19.0,127.0,127.0,5,1111,17.0,843.0,843.0
0.227,6,16,2777,8,1395,32.0,533.0,323.0,8,1382,20.0,529.0,239.0
0.006,6,10,1547,5,764,1.0,496.0,496.0,5,783,1.0,515.0,515.0
0.006,6,10,1547,5,764,1.0,496.0,496.0,5,783,1.0,515.0,515.0
40.065,17,10,676,5,460,10014.0,104.0,64.0,5,216,10015.0,20.0,15.0
0.005,6,10,2007,5,928,1.0,660.0,660.0,5,1079,1.0,811.0,811.0
280.612,6,24,6440,11,1226,28061.0,267.0,156.0,13,5214,23383.0,1400.0,781.0
308.45,17,20,1124,10,716,34257.0,48.0,43.0,10,408,34257.0,20.0,12.0
0.125,17,2,179,1,71,0.0,43.0,43.0,1,108,0.0,80.0,80.0
0.121,6,10,1506,5,395,27.0,127.0,127.0,5,1111,18.0,843.0,843.0
0.004,6,10,2006,5,927,1.0,659.0,659.0,5,1079,1.0,811.0,811.0
0.004,6,10,1989,5,927,1.0,659.0,659.0,5,1062,1.0,794.0,794.0
0.001,17,2,180,1,66,0.0,38.0,38.0,1,114,0.0,86.0,86.0
0.094,6,10,1506,5,395,18.0,127.0,127.0,5,1111,19.0,843.0,843.0
0.007,6,10,1689,5,839,1.0,571.0,571.0,5,850,1.0,582.0,582.0
0.008,6,10,1547,5,764,2.0,496.0,496.0,5,783,1.0,515.0,515.0
0.006,6,10,1643,5,860,1.0,592.0,592.0,5,783,1.0,515.0,515.0
0.003,17,2,148,1,60,0.0,32.0,32.0,1,88,0.0,60.0,60.0
0.018,6,10,1983,5,910,4.0,642.0,642.0,5,1073,4.0,805.0,805.0
0.004,6,10,1989,5,927,1.0,659.0,659.0,5,1062,1.0,794.0,794.0
10.808,17,28,4421,14,1993,823.0,268.0,114.0,14,2428,822.0,587.0,145.0
0.013,6,10,2006,5,927,3.0,659.0,659.0,5,1079,3.0,811.0,811.0
0.018,6,10,1989,5,910,4.0,642.0,642.0,5,1079,4.0,811.0,811.0
1770.586,17,92,8096,46,4048,39346.0,60.0,60.0,46,4048,39346.0,60.0,60.0
0.005,6,10,1779,5,928,1.0,660.0,660.0,5,851,1.0,583.0,583.0
0.013,6,10,1972,5,910,3.0,642.0,642.0,5,1062,3.0,794.0,794.0
15.072,17,15,9238,8,6902,2149.0,1350.0,834.0,7,2336,2507.0,1350.0,305.0
0.011,6,10,1983,5,910,2.0,642.0,642.0,5,1073,2.0,805.0,805.0
1769.241,17,92,8096,46,4048,39316.0,60.0,60.0,46,4048,39316.0,60.0,60.0
0.038,17,4,284,2,120,0.0,32.0,32.0,2,164,35.0,60.0,54.0
0.014,6,10,1989,5,910,3.0,642.0,642.0,5,1079,3.0,811.0,811.0
0.005,17,2,140,1,62,0.0,34.0,34.0,1,78,0.0,50.0,50.0
0.006,6,10,1547,5,764,1.0,496.0,496.0,5,783,1.0,515.0,515.0
0.006,17,2,212,1,74,0.0,46.0,46.0,1,138,0.0,110.0,110.0
0.005,6,10,2007,5,928,1.0,660.0,660.0,5,1079,1.0,811.0,811.0
0.221,6,16,2778,8,1396,31.0,533.0,324.0,8,1382,20.0,529.0,239.0
0.006,6,10,1689,5,839,1.0,571.0,571.0,5,850,1.0,582.0,582.0
0.001,17,2,136,1,60,0.0,32.0,32.0,1,76,0.0,48.0,48.0
0.009,6,10,1762,5,911,2.0,643.0,643.0,5,851,2.0,583.0,583.0
0.012,6,10,1990,5,911,3.0,643.0,643.0,5,1079,3.0,811.0,811.0
0.1,6,10,1506,5,395,22.0,127.0,127.0,5,1111,21.0,843.0,843.0
0.114,6,10,1506,5,395,25.0,127.0,127.0,5,1111,27.0,843.0,843.0
0.088,6,10,1506,5,395,19.0,127.0,127.0,5,1111,18.0,843.0,843.0
0.006,6,10,1854,5,889,1.0,621.0,621.0,5,965,1.0,697.0,697.0
0.005,17,2,144,1,64,0.0,36.0,36.0,1,80,0.0,52.0,52.0
0.134,6,10,1506,5,395,31.0,127.0,127.0,5,1111,28.0,843.0,843.0
0.063,6,10,1506,5,395,15.0,127.0,127.0,5,1111,14.0,843.0,843.0
0.014,6,10,1762,5,911,3.0,643.0,643.0,5,851,3.0,583.0,583.0
0.015,6,10,1990,5,911,3.0,643.0,643.0,5,1079,3.0,811.0,811.0
294.451,6,395,348725,205,22223,1443.0,2006.0,825.0,190,326502,1557.0,2804.0,1798.0
0.022,6,10,1983,5,910,5.0,642.0,642.0,5,1073,5.0,805.0,805.0
289.298,6,404,348612,199,21908,1461.0,2736.0,888.0,205,326704,1418.0,2804.0,1654.0
0.018,6,14,3787,7,497,2.0,125.0,125.0,7,3290,3.0,1448.0,972.0
0.005,17,2,214,1,75,0.0,47.0,47.0,1,139,0.0,111.0,111.0
0.088,6,10,1506,5,395,18.0,127.0,127.0,5,1111,20.0,843.0,843.0
0.042,17,2,136,1,60,0.0,32.0,32.0,1,76,0.0,48.0,48.0
10.823,17,28,4419,14,1994,824.0,269.0,114.0,14,2425,824.0,588.0,145.0
0.11,6,10,1506,5,395,26.0,127.0,127.0,5,1111,25.0,843.0,843.0
0.005,6,10,1689,5,839,1.0,571.0,571.0,5,850,1.0,582.0,582.0
24.324,6,37,9566,18,4008,521.0,1543.0,814.0,19,5558,1341.0,1360.0,398.0
0.04,17,2,170,1,65,0.0,37.0,37.0,1,105,0.0,77.0,77.0
0.114,6,10,1506,5,395,26.0,127.0,127.0,5,1111,24.0,843.0,843.0
0.015,6,10,1989,5,910,3.0,642.0,642.0,5,1079,3.0,811.0,811.0
0.073,6,10,1506,5,395,16.0,127.0,127.0,5,1111,15.0,843.0,843.0
335.49,17,20,1124,10,716,37261.0,48.0,43.0,10,408,37261.0,20.0,12.0
301.186,6,50,21481,27,15534,11584.0,3638.0,1311.0,23,5947,411.0,2667.0,385.0
0.186,17,4,596,2,122,144.0,33.0,33.0,2,474,145.0,323.0,209.0
0.015,6,10,1631,5,848,3.0,580.0,580.0,5,783,3.0,515.0,515.0
0.005,6,10,2006,5,927,1.0,659.0,659.0,5,1079,1.0,811.0,811.0
0.121,6,10,1506,5,395,29.0,127.0,127.0,5,1111,26.0,843.0,843.0
0.004,6,10,2000,5,927,1.0,659.0,659.0,5,1073,1.0,805.0,805.0
0.011,6,10,1989,5,910,2.0,642.0,642.0,5,1079,2.0,811.0,811.0
0.135,6,10,1506,5,395,32.0,127.0,127.0,5,1111,33.0,843.0,843.0
0.005,17,2,170,1,65,0.0,37.0,37.0,1,105,0.0,77.0,77.0
0.011,6,10,1989,5,910,2.0,642.0,642.0,5,1079,2.0,811.0,811.0
0.005,6,10,2006,5,927,1.0,659.0,659.0,5,1079,1.0,811.0,811.0
0.01,6,10,1677,5,827,2.0,559.0,559.0,5,850,2.0,582.0,582.0
0.012,6,10,1989,5,910,2.0,642.0,642.0,5,1079,2.0,811.0,811.0
0.005,6,10,1547,5,764,1.0,496.0,496.0,5,783,1.0,515.0,515.0
0.005,6,10,1689,5,839,1.0,571.0,571.0,5,850,1.0,582.0,582.0
0.005,6,10,2007,5,928,1.0,660.0,660.0,5,1079,1.0,811.0,811.0
354.004,6,19,1691,15,978,25286.0,190.0,190.0,4,713,80005.0,497.0,497.0
0.008,6,10,1989,5,910,2.0,642.0,642.0,5,1079,1.0,811.0,811.0
0.016,6,10,1989,5,910,4.0,642.0,642.0,5,1079,4.0,811.0,811.0
0.093,6,10,1506,5,395,21.0,127.0,127.0,5,1111,15.0,843.0,843.0
0.012,6,10,1990,5,911,3.0,643.0,643.0,5,1079,3.0,811.0,811.0
1773.757,6,299,51939,123,34468,14537.0,2720.0,307.0,176,17471,10135.0,1360.0,128.0
0.091,6,10,1506,5,395,19.0,127.0,127.0,5,1111,17.0,843.0,843.0
308.5,17,20,1124,10,716,34263.0,48.0,43.0,10,408,34263.0,20.0,12.0
0.102,6,10,1506,5,395,19.0,127.0,127.0,5,1111,21.0,843.0,843.0
40.067,17,10,676,5,460,10013.0,104.0,64.0,5,216,10014.0,20.0,15.0
0.006,6,10,1547,5,764,1.0,496.0,496.0,5,783,1.0,515.0,515.0
0.004,6,10,1989,5,927,1.0,659.0,659.0,5,1062,1.0,794.0,794.0
0.006,6,10,1689,5,839,1.0,571.0,571.0,5,850,1.0,582.0,582.0
40.055,17,10,676,5,460,10012.0,104.0,64.0,5,216,10012.0,20.0,15.0
0.001,17,2,180,1,66,0.0,38.0,38.0,1,114,0.0,86.0,86.0
0.156,6,10,1506,5,395,32.0,127.0,127.0,5,1111,37.0,843.0,843.0
27.678,17,24,14849,13,12031,2304.0,1350.0,897.0,11,2818,2764.0,1350.0,228.0
0.021,6,10,1972,5,910,5.0,642.0,642.0,5,1062,5.0,794.0,794.0
0.001,17,2,180,1,66,0.0,38.0,38.0,1,114,0.0,86.0,86.0
40.046,17,10,676,5,460,10009.0,104.0,64.0,5,216,10010.0,20.0,15.0
0.012,6,10,1983,5,910,3.0,642.0,642.0,5,1073,2.0,805.0,805.0
0.08,6,10,1506,5,395,18.0,127.0,127.0,5,1111,16.0,843.0,843.0
0.01,6,10,1990,5,911,2.0,643.0,643.0,5,1079,2.0,811.0,811.0
0.125,6,10,1506,5,395,30.0,127.0,127.0,5,1111,27.0,843.0,843.0
40.063,17,10,676,5,460,10014.0,104.0,64.0,5,216,10014.0,20.0,15.0
0.186,6,10,1506,5,395,40.0,127.0,127.0,5,1111,43.0,843.0,843.0
0.039,17,2,152,1,76,0.0,48.0,48.0,1,76,0.0,48.0,48.0
0.005,6,10,1547,5,764,1.0,496.0,496.0,5,783,1.0,515.0,515.0
0.015,6,10,1989,5,910,3.0,642.0,642.0,5,1079,3.0,811.0,811.0
0.003,17,2,148,1,60,0.0,32.0,32.0,1,88,0.0,60.0,60.0
0.006,6,10,1547,5,764,1.0,496.0,496.0,5,783,1.0,515.0,515.0
0.072,17,2,148,1,60,0.0,32.0,32.0,1,88,0.0,60.0,60.0
0.005,17,2,179,1,71,0.0,43.0,43.0,1,108,0.0,80.0,80.0
0.011,6,10,1989,5,910,2.0,642.0,642.0,5,1079,2.0,811.0,811.0
0.014,6,10,1983,5,910,3.0,642.0,642.0,5,1073,3.0,805.0,805.0
0.133,6,10,1506,5,395,29.0,127.0,127.0,5,1111,29.0,843.0,843.0
0.046,17,2,152,1,76,0.0,48.0,48.0,1,76,0.0,48.0,48.0
0.073,17,2,148,1,60,0.0,32.0,32.0,1,88,0.0,60.0,60.0
0.005,6,10,1689,5,839,1.0,571.0,571.0,5,850,1.0,582.0,582.0
0.115,6,10,1506,5,395,27.0,127.0,127.0,5,1111,26.0,843.0,843.0
300.384,6,16,2170,9,684,37527.0,146.0,146.0,7,1486,50036.0,419.0,398.0
0.005,6,10,1854,5,889,1.0,621.0,621.0,5,965,1.0,697.0,697.0
0.02,6,10,1989,5,910,4.0,642.0,642.0,5,1079,4.0,811.0,811.0
170.353,17,92,13292,46,3096,3785.0,44.0,39.0,46,10196,3785.0,252.0,193.0
0.006,6,10,1547,5,764,1.0,496.0,496.0,5,783,1.0,515.0,515.0
0.013,6,10,1990,5,911,3.0,643.0,643.0,5,1079,3.0,811.0,811.0
0.013,6,10,1983,5,910,3.0,642.0,642.0,5,1073,3.0,805.0,805.0
0.008,6,10,1989,5,910,1.0,642.0,642.0,5,1079,1.0,811.0,811.0
0.004,6,10,2007,5,928,1.0,660.0,660.0,5,1079,1.0,811.0,811.0
0.006,6,10,1689,5,839,1.0,571.0,571.0,5,850,1.0,582.0,582.0
0.005,6,10,1779,5,928,1.0,660.0,660.0,5,851,1.0,583.0,583.0
0.005,6,10,2006,5,927,1.0,659.0,659.0,5,1079,1.0,811.0,811.0
0.015,6,10,1989,5,910,3.0,642.0,642.0,5,1079,3.0,811.0,811.0
361.844,6,21,1795,16,1030,24122.0,190.0,190.0,5,765,60009.0,464.0,248.0
40.071,17,10,676,5,460,10015.0,104.0,64.0,5,216,10017.0,20.0,15.0
0.005,6,10,2007,5,928,1.0,660.0,660.0,5,1079,1.0,811.0,811.0
0.009,6,10,1972,5,910,2.0,642.0,642.0,5,1062,2.0,794.0,794.0
0.079,6,10,1506,5,395,17.0,127.0,127.0,5,1111,18.0,843.0,843.0
0.005,6,10,2006,5,927,1.0,659.0,659.0,5,1079,1.0,811.0,811.0
0.01,6,10,1631,5,848,2.0,580.0,580.0,5,783,2.0,515.0,515.0
0.094,6,10,1506,5,395,19.0,127.0,127.0,5,1111,19.0,843.0,843.0
15.075,17,15,9238,8,6902,2149.0,1350.0,834.0,7,2336,2507.0,1350.0,305.0
0.075,6,10,1506,5,395,16.0,127.0,127.0,5,1111,17.0,843.0,843.0
11.041,17,28,4391,14,2313,841.0,588.0,137.0,14,2078,841.0,269.0,120.0
0.007,17,2,194,1,59,0.0,31.0,31.0,1,135,0.0,107.0,107.0
0.004,6,10,2006,5,927,1.0,659.0,659.0,5,1079,1.0,811.0,811.0
0.005,6,10,1989,5,927,1.0,659.0,659.0,5,1062,1.0,794.0,794.0
0.017,6,10,1989,5,910,4.0,642.0,642.0,5,1079,4.0,811.0,811.0
0.005,6,10,1989,5,927,1.0,659.0,659.0,5,1062,1.0,794.0,794.0
0.042,17,2,182,1,65,0.0,37.0,37.0,1,117,0.0,89.0,89.0
0.057,6,10,1506,5,395,11.0,127.0,127.0,5,1111,13.0,843.0,843.0
0.021,6,10,1972,5,910,5.0,642.0,642.0,5,1062,5.0,794.0,794.0
353.505,6,20,2210,6,1308,12004.0,494.0,494.0,14,902,27192.0,83.0,83.0
0.005,6,10,2006,5,927,1.0,659.0,659.0,5,1079,1.0,811.0,811.0
176.064,17,74,10649,37,2473,4890.0,44.0,38.0,37,8176,4890.0,260.0,192.0
0.013,6,10,1762,5,911,3.0,643.0,643.0,5,851,3.0,583.0,583.0
25.298,6,48,19653,23,13626,411.0,2720.0,1408.0,25,6027,1047.0,1360.0,358.0
0.005,6,10,1989,5,927,1.0,659.0,659.0,5,1062,1.0,794.0,794.0
0.005,6,10,2006,5,927,1.0,659.0,659.0,5,1079,1.0,811.0,811.0
0.005,6,10,1989,5,927,1.0,659.0,659.0,5,1062,1.0,794.0,794.0
0.039,17,2,136,1,60,0.0,32.0,32.0,1,76,0.0,48.0,48.0
0.006,6,10,1689,5,839,1.0,571.0,571.0,5,850,1.0,582.0,582.0
0.006,6,10,1547,5,764,1.0,496.0,496.0,5,783,1.0,515.0,515.0
0.049,6,13,3816,7,578,8.0,206.0,206.0,6,3238,9.0,1470.0,1459.0
0.004,6,10,2000,5,927,1.0,659.0,659.0,5,1073,1.0,805.0,805.0
1732.241,6,65,7402,43,4522,41243.0,1402.0,103.0,22,2880,82479.0,1116.0,82.0
0.066,6,10,1506,5,395,15.0,127.0,127.0,5,1111,14.0,843.0,843.0
0.112,6,10,1506,5,395,27.0,127.0,127.0,5,1111,25.0,843.0,843.0
88.877,6,23,8549,13,2288,67.0,1345.0,574.0,10,6261,9856.0,2720.0,974.0
0.068,6,10,1506,5,395,14.0,127.0,127.0,5,1111,15.0,843.0,843.0
0.072,17,4,352,2,130,1.0,37.0,37.0,2,222,35.0,89.0,83.0
0.065,6,10,1506,5,395,15.0,127.0,127.0,5,1111,13.0,843.0,843.0
0.009,6,13,3735,7,497,1.0,125.0,125.0,6,3238,1.0,1470.0,1459.0
0.011,6,10,1990,5,911,2.0,643.0,643.0,5,1079,2.0,811.0,811.0
0.001,17,2,180,1,66,0.0,38.0,38.0,1,114,0.0,86.0,86.0
0.004,17,4,284,2,120,0.0,32.0,32.0,2,164,1.0,60.0,54.0
0.016,6,10,1605,5,388,4.0,120.0,120.0,5,1217,3.0,949.0,949.0
0.006,6,10,1689,5,839,1.0,571.0,571.0,5,850,1.0,582.0,582.0
0.014,6,10,1990,5,911,3.0,643.0,643.0,5,1079,3.0,811.0,811.0
0.012,6,10,1983,5,910,3.0,642.0,642.0,5,1073,2.0,805.0,805.0
0.005,17,2,164,1,74,0.0,46.0,46.0,1,90,0.0,62.0,62.0
0.012,6,10,1990,5,911,2.0,643.0,643.0,5,1079,3.0,811.0,811.0
0.322,17,49,32174,28,26210,11.0,1350.0,908.0,21,5964,13.0,1350.0,256.0
0.01,6,10,1631,5,848,2.0,580.0,580.0,5,783,2.0,515.0,515.0
0.004,6,10,2006,5,927,1.0,659.0,659.0,5,1079,1.0,811.0,811.0
0.005,6,10,2006,5,927,1.0,659.0,659.0,5,1079,1.0,811.0,811.0
0.005,6,10,2007,5,928,1.0,660.0,660.0,5,1079,1.0,811.0,811.0
0.006,17,2,179,1,71,0.0,43.0,43.0,1,108,0.0,80.0,80.0
0.142,6,10,1506,5,395,30.0,127.0,127.0,5,1111,32.0,843.0,843.0
0.015,6,10,1989,5,910,3.0,642.0,642.0,5,1079,3.0,811.0,811.0
0.04,17,4,420,2,122,0.0,33.0,33.0,2,298,35.0,145.0,121.0
240.221,6,16,4480,9,963,30027.0,238.0,166.0,7,3517,40029.0,1402.0,786.0
316.001,17,20,1124,10,716,35097.0,48.0,43.0,10,408,35097.0,20.0,12.0
177.095,17,80,11559,40,2664,4540.0,44.0,38.0,40,8895,4540.0,261.0,194.0
0.003,17,2,136,1,60,0.0,32.0,32.0,1,76,0.0,48.0,48.0
0.009,6,13,3735,7,497,1.0,125.0,125.0,6,3238,1.0,1470.0,1459.0
0.095,6,10,1506,5,395,19.0,127.0,127.0,5,1111,22.0,843.0,843.0
0.03,6,10,1972,5,910,7.0,642.0,642.0,5,1062,7.0,794.0,794.0
178.517,17,98,14456,49,3310,3718.0,44.0,39.0,49,11146,3719.0,261.0,199.0
0.004,6,10,1989,5,927,1.0,659.0,659.0,5,1062,1.0,794.0,794.0
0.004,6,10,2000,5,927,1.0,659.0,659.0,5,1073,1.0,805.0,805.0
0.006,6,10,1547,5,764,1.0,496.0,496.0,5,783,1.0,515.0,515.0
0.072,17,4,284,2,120,1.0,32.0,32.0,2,164,69.0,60.0,54.0
40.065,17,10,676,5,460,10015.0,104.0,64.0,5,216,10015.0,20.0,15.0
0.014,6,10,1990,5,911,3.0,643.0,643.0,5,1079,3.0,811.0,811.0
0.008,6,10,2006,5,927,2.0,659.0,659.0,5,1079,1.0,811.0,811.0
40.078,17,10,676,5,460,10013.0,104.0,64.0,5,216,10018.0,20.0,15.0
0.005,6,10,2006,5,927,1.0,659.0,659.0,5,1079,1.0,811.0,811.0
10.877,17,28,4393,14,1994,826.0,269.0,114.0,14,2399,828.0,586.0,143.0
0.005,6,10,2006,5,927,1.0,659.0,659.0,5,1079,1.0,811.0,811.0
40.055,17,10,676,5,460,10012.0,104.0,64.0,5,216,10012.0,20.0,15.0
0.005,6,10,1989,5,927,1.0,659.0,659.0,5,1062,1.0,794.0,794.0
0.004,6,10,2006,5,927,1.0,659.0,659.0,5,1079,1.0,811.0,811.0
0.005,6,13,3747,7,509,0.0,137.0,137.0,6,3238,1.0,1470.0,1459.0
0.125,6,10,1506,5,395,29.0,127.0,127.0,5,1111,26.0,843.0,843.0
0.011,6,10,1989,5,910,2.0,642.0,642.0,5,1079,2.0,811.0,811.0
0.033,17,2,170,1,65,0.0,37.0,37.0,1,105,0.0,77.0,77.0
0.009,6,10,1762,5,911,2.0,643.0,643.0,5,851,2.0,583.0,583.0
0.009,6,10,1972,5,910,2.0,642.0,642.0,5,1062,2.0,794.0,794.0
0.103,6,10,1506,5,395,24.0,127.0,127.0,5,1111,24.0,843.0,843.0
0.006,17,2,169,1,62,0.0,34.0,34.0,1,107,0.0,79.0,79.0
1.057,6,32,13391,17,5852,66.0,2073.0,854.0,15,7539,61.0,1360.0,692.0
0.012,6,10,1677,5,827,2.0,559.0,559.0,5,850,2.0,582.0,582.0
1778.472,17,144,41760,72,22752,25048.0,288.0,288.0,72,19008,25048.0,236.0,236.0
0.005,6,10,2007,5,928,1.0,660.0,660.0,5,1079,1.0,811.0,811.0
0.133,17,2,412,1,61,0.0,33.0,33.0,1,351,0.0,323.0,323.0
0.013,6,10,1972,5,910,3.0,642.0,642.0,5,1062,3.0,794.0,794.0
10.841,17,28,4421,14,1994,824.0,269.0,114.0,14,2427,825.0,586.0,145.0
0.007,6,10,2006,5,927,1.0,659.0,659.0,5,1079,1.0,811.0,811.0
0.004,17,2,136,1,60,0.0,32.0,32.0,1,76,0.0,48.0,48.0
0.014,6,10,1972,5,910,3.0,642.0,642.0,5,1062,3.0,794.0,794.0
0.013,6,10,1983,5,910,3.0,642.0,642.0,5,1073,3.0,805.0,805.0
0.005,6,13,3747,7,509,0.0,137.0,137.0,6,3238,1.0,1470.0,1459.0
0.007,6,10,1779,5,928,1.0,660.0,660.0,5,851,1.0,583.0,583.0
0.009,6,10,1989,5,910,2.0,642.0,642.0,5,1079,2.0,811.0,811.0
0.095,6,10,1506,5,395,19.0,127.0,127.0,5,1111,20.0,843.0,843.0
0.008,6,10,1989,5,910,2.0,642.0,642.0,5,1079,2.0,811.0,811.0
40.072,17,10,676,5,460,10017.0,104.0,64.0,5,216,10017.0,20.0,15.0
0.005,17,2,170,1,65,0.0,37.0,37.0,1,105,0.0,77.0,77.0
0.005,6,10,2006,5,927,1.0,659.0,659.0,5,1079,1.0,811.0,811.0
0.006,17,2,179,1,71,0.0,43.0,43.0,1,108,0.0,80.0,80.0
0.005,17,2,138,1,61,0.0,33.0,33.0,1,77,0.0,49.0,49.0
0.001,17,2,179,1,62,0.0,34.0,34.0,1,117,0.0,89.0,89.0
0.005,6,10,1689,5,839,1.0,571.0,571.0,5,850,1.0,582.0,582.0
0.005,6,10,2007,5,928,1.0,660.0,660.0,5,1079,1.0,811.0,811.0
0.038,17,4,284,2,120,0.0,32.0,32.0,2,164,35.0,60.0,54.0
0.001,17,2,136,1,60,0.0,32.0,32.0,1,76,0.0,48.0,48.0
0.084,6,10,1506,5,395,18.0,127.0,127.0,5,1111,18.0,843.0,843.0
0.006,6,10,1547,5,764,1.0,496.0,496.0,5,783,1.0,515.0,515.0
12.42,17,42,9392,21,5103,613.0,1337.0,215.0,21,4289,613.0,862.0,176.0
0.013,6,10,1989,5,910,3.0,642.0,642.0,5,1079,3.0,811.0,811.0
0.006,6,10,1989,5,927,1.0,659.0,659.0,5,1062,1.0,794.0,794.0
0.005,6,10,2006,5,927,1.0,659.0,659.0,5,1079,1.0,811.0,811.0
40.108,17,10,676,5,460,10026.0,104.0,64.0,5,216,10026.0,20.0,15.0
0.009,6,13,3735,7,497,1.0,125.0,125.0,6,3238,1.0,1470.0,1459.0
0.006,6,10,1547,5,764,1.0,496.0,496.0,5,783,1.0,515.0,515.0
0.005,6,10,2000,5,927,1.0,659.0,659.0,5,1073,1.0,805.0,805.0
0.133,6,10,1506,5,395,31.0,127.0,127.0,5,1111,27.0,843.0,843.0
353.404,6,20,2210,6,1308,12003.0,494.0,494.0,14,902,27184.0,83.0,83.0
0.01,6,10,1989,5,910,2.0,642.0,642.0,5,1079,2.0,811.0,811.0
11.174,17,28,4418,14,1994,846.0,269.0,114.0,14,2424,846.0,587.0,145.0
0.039,17,2,152,1,76,0.0,48.0,48.0,1,76,0.0,48.0,48.0
15.075,17,14,9190,8,6902,2149.0,1350.0,834.0,6,2288,3009.0,1350.0,353.0
0.011,6,10,1989,5,910,2.0,642.0,642.0,5,1079,2.0,811.0,811.0
174.272,17,102,15055,51,3441,3485.0,44.0,39.0,51,11614,3485.0,261.0,199.0
0.005,6,13,3747,7,509,0.0,137.0,137.0,6,3238,0.0,1470.0,1459.0
0.007,6,10,1689,5,839,1.0,571.0,571.0,5,850,1.0,582.0,582.0
300.407,6,16,2170,9,684,37529.0,146.0,146.0,7,1486,50039.0,419.0,398.0
0.123,6,10,1506,5,395,28.0,127.0,127.0,5,1111,28.0,843.0,843.0
0.019,6,10,1989,5,910,4.0,642.0,642.0,5,1079,4.0,811.0,811.0
0.133,6,10,1506,5,395,26.0,127.0,127.0,5,1111,27.0,843.0,843.0
15.203,17,15,8977,8,6757,2171.0,1350.0,816.0,7,2220,2529.0,1350.0,289.0
0.157,17,2,412,1,61,0.0,33.0,33.0,1,351,0.0,323.0,323.0
0.044,17,2,182,1,65,0.0,37.0,37.0,1,117,0.0,89.0,89.0
240.093,6,16,4482,9,963,30011.0,238.0,166.0,7,3519,40014.0,1402.0,786.0
361.783,6,22,1857,17,1094,22611.0,190.0,190.0,5,763,60011.0,462.0,247.0
0.092,6,10,1506,5,395,19.0,127.0,127.0,5,1111,21.0,843.0,843.0
0.11,6,10,1506,5,395,23.0,127.0,127.0,5,1111,25.0,843.0,843.0
0.005,17,2,230,1,68,0.0,40.0,40.0,1,162,0.0,134.0,134.0
354.032,6,21,1795,16,1030,23602.0,190.0,190.0,5,765,60003.0,464.0,248.0
0.005,6,10,2007,5,928,1.0,660.0,660.0,5,1079,1.0,811.0,811.0
0.001,17,2,174,1,72,0.0,44.0,44.0,1,102,0.0,74.0,74.0
0.083,6,10,1506,5,395,18.0,127.0,127.0,5,1111,17.0,843.0,843.0
0.005,6,10,2000,5,927,1.0,659.0,659.0,5,1073,1.0,805.0,805.0
0.013,6,10,1990,5,911,3.0,643.0,643.0,5,1079,3.0,811.0,811.0
40.058,17,10,676,5,460,10013.0,104.0,64.0,5,216,10013.0,20.0,15.0
0.127,6,10,1506,5,395,20.0,127.0,127.0,5,1111,28.0,843.0,843.0
0.01,6,10,1689,5,839,2.0,571.0,571.0,5,850,2.0,582.0,582.0
0.005,6,10,1779,5,928,1.0,660.0,660.0,5,851,1.0,583.0,583.0
311.255,17,20,1124,10,716,34569.0,48.0,43.0,10,408,34569.0,20.0,12.0
0.007,6,10,1989,5,927,1.0,659.0,659.0,5,1062,1.0,794.0,794.0
0.004,6,10,1702,5,863,0.0,595.0,595.0,5,839,1.0,571.0,571.0
9.036,17,6,376,5,280,2259.0,28.0,28.0,1,96,0.0,68.0,68.0
0.007,6,10,2000,5,927,1.0,659.0,659.0,5,1073,1.0,805.0,805.0
0.005,6,10,1689,5,839,1.0,571.0,571.0,5,850,1.0,582.0,582.0
0.005,17,4,284,2,120,0.0,32.0,32.0,2,164,1.0,60.0,54.0
0.166,6,10,1506,5,395,36.0,127.0,127.0,5,1111,36.0,843.0,843.0
0.01,6,10,1762,5,911,2.0,643.0,643.0,5,851,2.0,583.0,583.0
0.094,6,10,1506,5,395,22.0,127.0,127.0,5,1111,21.0,843.0,843.0
11.019,17,28,4418,14,1993,839.0,268.0,114.0,14,2425,839.0,588.0,145.0
0.013,6,10,1989,5,910,3.0,642.0,642.0,5,1079,3.0,811.0,811.0
15.072,17,15,9238,8,6902,2149.0,1350.0,834.0,7,2336,2507.0,1350.0,305.0
0.013,6,13,3735,7,497,2.0,125.0,125.0,6,3238,2.0,1470.0,1459.0
10.943,17,28,4390,14,2312,833.0,587.0,137.0,14,2078,833.0,269.0,120.0
0.01,6,10,1972,5,910,2.0,642.0,642.0,5,1062,2.0,794.0,794.0
300.382,6,16,2170,9,684,37527.0,146.0,146.0,7,1486,50036.0,419.0,398.0
0.004,6,10,2007,5,928,1.0,660.0,660.0,5,1079,1.0,811.0,811.0
0.001,17,2,180,1,66,0.0,38.0,38.0,1,114,0.0,86.0,86.0
0.011,6,10,1990,5,911,2.0,643.0,643.0,5,1079,2.0,811.0,811.0
0.006,6,10,1547,5,764,1.0,496.0,496.0,5,783,1.0,515.0,515.0
0.012,6,10,1989,5,910,3.0,642.0,642.0,5,1079,2.0,811.0,811.0
0.006,6,10,1547,5,764,1.0,496.0,496.0,5,783,1.0,515.0,515.0
0.038,17,4,420,2,122,0.0,33.0,33.0,2,298,33.0,145.0,121.0
0.005,17,2,136,1,60,0.0,32.0,32.0,1,76,0.0,48.0,48.0
0.005,6,10,1547,5,764,1.0,496.0,496.0,5,783,1.0,515.0,515.0
0.096,6,10,1506,5,395,22.0,127.0,127.0,5,1111,20.0,843.0,843.0
0.007,6,10,1689,5,839,1.0,571.0,571.0,5,850,1.0,582.0,582.0
10.821,17,28,4418,14,1994,823.0,269.0,114.0,14,2424,823.0,587.0,145.0
0.041,17,2,152,1,76,0.0,48.0,48.0,1,76,0.0,48.0,48.0
0.003,17,2,136,1,60,0.0,32.0,32.0,1,76,0.0,48.0,48.0
0.01,17,2,179,1,71,0.0,43.0,43.0,1,108,0.0,80.0,80.0
0.01,6,10,1677,5,827,2.0,559.0,559.0,5,850,2.0,582.0,582.0
0.149,17,4,596,2,122,110.0,33.0,33.0,2,474,145.0,323.0,209.0
0.01,6,10,1972,5,910,2.0,642.0,642.0,5,1062,2.0,794.0,794.0
0.079,6,10,1506,5,395,16.0,127.0,127.0,5,1111,17.0,843.0,843.0
0.004,6,10,1989,5,927,1.0,659.0,659.0,5,1062,1.0,794.0,794.0
0.015,6,10,1677,5,827,3.0,559.0,559.0,5,850,3.0,582.0,582.0
240.102,6,16,4481,9,963,30012.0,238.0,166.0,7,3518,40016.0,1402.0,786.0
174.277,17,76,10887,38,2536,4710.0,44.0,38.0,38,8351,4710.0,261.0,191.0
0.012,6,10,1677,5,827,3.0,559.0,559.0,5,850,2.0,582.0,582.0
0.04,17,2,136,1,60,0.0,32.0,32.0,1,76,0.0,48.0,48.0
0.004,17,2,136,1,60,0.0,32.0,32.0,1,76,0.0,48.0,48.0
0.004,17,2,136,1,60,0.0,32.0,32.0,1,76,0.0,48.0,48.0
0.005,6,10,2007,5,928,1.0,660.0,660.0,5,1079,1.0,811.0,811.0
0.01,6,10,1990,5,911,2.0,643.0,643.0,5,1079,2.0,811.0,811.0
0.076,6,10,1506,5,395,17.0,127.0,127.0,5,1111,16.0,843.0,843.0
0.003,17,2,136,1,60,0.0,32.0,32.0,1,76,0.0,48.0,48.0
0.014,6,10,1983,5,910,3.0,642.0,642.0,5,1073,3.0,805.0,805.0
0.016,6,10,1989,5,910,3.0,642.0,642.0,5,1079,4.0,811.0,811.0
0.027,6,10,1990,5,911,6.0,643.0,643.0,5,1079,6.0,811.0,811.0
310.267,17,18,1008,9,640,38767.0,48.0,43.0,9,368,38768.0,20.0,12.0
0.117,17,2,194,1,59,0.0,31.0,31.0,1,135,0.0,107.0,107.0
0.005,6,10,2000,5,927,1.0,659.0,659.0,5,1073,1.0,805.0,805.0
0.005,6,10,1989,5,927,1.0,659.0,659.0,5,1062,1.0,794.0,794.0
0.004,6,10,1779,5,928,1.0,660.0,660.0,5,851,1.0,583.0,583.0
0.012,6,10,1990,5,911,3.0,643.0,643.0,5,1079,2.0,811.0,811.0
172.416,17,92,13194,46,3070,3831.0,44.0,38.0,46,10124,3831.0,279.0,192.0
0.01,6,10,1989,5,910,2.0,642.0,642.0,5,1079,2.0,811.0,811.0
0.015,6,10,1972,5,910,3.0,642.0,642.0,5,1062,3.0,794.0,794.0
40.062,17,10,676,5,460,10014.0,104.0,64.0,5,216,10014.0,20.0,15.0
0.006,6,13,3747,7,509,1.0,137.0,137.0,6,3238,1.0,1470.0,1459.0
0.005,6,10,1779,5,928,1.0,660.0,660.0,5,851,1.0,583.0,583.0
0.004,17,2,136,1,60,0.0,32.0,32.0,1,76,0.0,48.0,48.0
0.012,6,10,1972,5,910,2.0,642.0,642.0,5,1062,3.0,794.0,794.0
240.092,6,31,9173,15,6822,17149.0,1945.0,671.0,16,2351,16006.0,580.0,188.0
0.004,17,4,284,2,120,0.0,32.0,32.0,2,164,1.0,60.0,54.0
0.092,6,10,1506,5,395,20.0,127.0,127.0,5,1111,20.0,843.0,843.0
0.065,6,10,1506,5,395,14.0,127.0,127.0,5,1111,14.0,843.0,843.0
0.001,17,2,180,1,66,0.0,38.0,38.0,1,114,0.0,86.0,86.0
0.004,17,4,284,2,120,0.0,32.0,32.0,2,164,0.0,60.0,54.0
0.005,6,10,2007,5,928,1.0,660.0,660.0,5,1079,1.0,811.0,811.0
0.001,17,2,180,1,66,0.0,38.0,38.0,1,114,0.0,86.0,86.0
0.002,17,2,148,1,60,0.0,32.0,32.0,1,88,0.0,60.0,60.0
292.016,6,382,346693,198,21858,1482.0,2736.0,888.0,184,324835,1595.0,2804.0,1854.0
0.13,17,2,80,1,32,0.0,4.0,4.0,1,48,0.0,20.0,20.0
0.081,6,10,1506,5,395,17.0,127.0,127.0,5,1111,17.0,843.0,843.0
0.011,6,10,1990,5,911,2.0,643.0,643.0,5,1079,2.0,811.0,811.0
0.037,17,2,152,1,76,0.0,48.0,48.0,1,76,0.0,48.0,48.0
0.004,6,10,1702,5,863,1.0,595.0,595.0,5,839,1.0,571.0,571.0
0.004,6,10,1702,5,863,1.0,595.0,595.0,5,839,1.0,571.0,571.0
1799.977,6,138,6704,77,3704,23683.0,39.0,39.0,61,3000,29995.0,35.0,35.0
60.985,6,20,10046,11,3931,6098.0,1601.0,840.0,9,6115,7607.0,2111.0,939.0
0.078,6,10,1506,5,395,17.0,127.0,127.0,5,1111,17.0,843.0,843.0
0.042,17,4,352,2,130,1.0,37.0,37.0,2,222,38.0,89.0,83.0
0.018,6,10,1989,5,910,4.0,642.0,642.0,5,1079,4.0,811.0,811.0
0.013,6,10,2006,5,927,3.0,659.0,659.0,5,1079,3.0,811.0,811.0
0.006,17,2,169,1,62,0.0,34.0,34.0,1,107,0.0,79.0,79.0
0.005,6,10,1989,5,927,1.0,659.0,659.0,5,1062,1.0,794.0,794.0
177.161,17,68,9586,34,2261,5368.0,44.0,38.0,34,7325,5368.0,239.0,187.0
0.005,6,10,1989,5,927,1.0,659.0,659.0,5,1062,1.0,794.0,794.0
0.004,6,10,2007,5,928,1.0,660.0,660.0,5,1079,1.0,811.0,811.0
0.004,17,2,148,1,60,0.0,32.0,32.0,1,88,0.0,60.0,60.0
0.01,6,10,1762,5,911,2.0,643.0,643.0,5,851,2.0,583.0,583.0
40.057,17,10,676,5,460,10013.0,104.0,64.0,5,216,10013.0,20.0,15.0
0.004,17,4,284,2,120,0.0,32.0,32.0,2,164,0.0,60.0,54.0
0.215,6,16,2670,8,1396,30.0,533.0,324.0,8,1274,19.0,529.0,212.0
0.089,6,10,1506,5,395,20.0,127.0,127.0,5,1111,19.0,843.0,843.0
0.011,6,10,1677,5,827,2.0,559.0,559.0,5,850,2.0,582.0,582.0
0.067,6,10,1506,5,395,15.0,127.0,127.0,5,1111,15.0,843.0,843.0
0.009,6,10,1989,5,910,2.0,642.0,642.0,5,1079,2.0,811.0,811.0
0.295,17,39,20142,21,17041,14.0,1350.0,783.0,18,3101,13.0,1350.0,144.0
0.072,17,2,148,1,60,0.0,32.0,32.0,1,88,0.0,60.0,60.0
40.058,17,10,676,5,460,10013.0,104.0,64.0,5,216,10013.0,20.0,15.0
0.004,6,10,2006,5,927,1.0,659.0,659.0,5,1079,1.0,811.0,811.0
0.013,6,10,1631,5,848,3.0,580.0,580.0,5,783,3.0,515.0,515.0
0.039,17,2,170,1,65,0.0,37.0,37.0,1,105,0.0,77.0,77.0
0.005,6,10,1774,5,923,1.0,655.0,655.0,5,851,1.0,583.0,583.0
0.146,6,10,1506,5,395,33.0,127.0,127.0,5,1111,24.0,843.0,843.0
0.14,6,10,1506,5,395,33.0,127.0,127.0,5,1111,30.0,843.0,843.0
0.013,6,10,1990,5,911,3.0,643.0,643.0,5,1079,3.0,811.0,811.0
0.006,6,10,1547,5,764,1.0,496.0,496.0,5,783,1.0,515.0,515.0
0.059,17,2,80,1,32,0.0,4.0,4.0,1,48,0.0,20.0,20.0
0.01,6,10,1972,5,910,2.0,642.0,642.0,5,1062,2.0,794.0,794.0
0.009,6,10,1989,5,910,2.0,642.0,642.0,5,1079,2.0,811.0,811.0
40.056,17,10,676,5,460,10013.0,104.0,64.0,5,216,10013.0,20.0,15.0
0.001,17,2,136,1,60,0.0,32.0,32.0,1,76,0.0,48.0,48.0
0.006,6,10,1643,5,860,1.0,592.0,592.0,5,783,1.0,515.0,515.0
0.005,6,13,3690,7,452,0.0,80.0,80.0,6,3238,1.0,1470.0,1459.0
0.006,6,10,1547,5,764,1.0,496.0,496.0,5,783,1.0,515.0,515.0
0.01,6,10,1989,5,910,2.0,642.0,642.0,5,1079,2.0,811.0,811.0
0.004,6,10,1989,5,927,1.0,659.0,659.0,5,1062,1.0,794.0,794.0
0.213,6,10,1506,5,395,51.0,127.0,127.0,5,1111,50.0,843.0,843.0
0.005,6,10,2006,5,927,1.0,659.0,659.0,5,1079,1.0,811.0,811.0
0.008,6,12,1926,6,1189,1.0,659.0,434.0,6,737,1.0,417.0,417.0
0.005,6,10,2007,5,928,1.0,660.0,660.0,5,1079,1.0,811.0,811.0
240.084,6,16,4481,9,963,30010.0,238.0,166.0,7,3518,40013.0,1402.0,786.0
0.004,17,2,136,1,60,0.0,32.0,32.0,1,76,0.0,48.0,48.0
0.01,6,10,1983,5,910,2.0,642.0,642.0,5,1073,2.0,805.0,805.0
0.093,6,10,1506,5,395,20.0,127.0,127.0,5,1111,22.0,843.0,843.0
32.861,6,31,18995,16,9212,2190.0,2804.0,1396.0,15,9783,36.0,1402.0,999.0
0.005,6,10,1854,5,889,1.0,621.0,621.0,5,965,1.0,697.0,697.0
0.097,6,10,1506,5,395,22.0,127.0,127.0,5,1111,21.0,843.0,843.0
0.006,6,10,1547,5,764,1.0,496.0,496.0,5,783,1.0,515.0,515.0
11.177,17,28,4418,14,1995,847.0,270.0,114.0,14,2423,847.0,586.0,145.0
0.001,17,2,180,1,66,0.0,38.0,38.0,1,114,0.0,86.0,86.0
0.001,17,2,180,1,66,0.0,38.0,38.0,1,114,0.0,86.0,86.0
0.014,6,10,1983,5,910,3.0,642.0,642.0,5,1073,3.0,805.0,805.0
0.005,6,10,1989,5,927,1.0,659.0,659.0,5,1062,1.0,794.0,794.0
0.006,6,10,1547,5,764,1.0,496.0,496.0,5,783,1.0,515.0,515.0
0.139,6,10,1506,5,395,32.0,127.0,127.0,5,1111,27.0,843.0,843.0
70.072,6,22,7437,11,1305,129.0,530.0,277.0,11,6132,6990.0,2720.0,946.0
0.11,6,10,1506,5,395,22.0,127.0,127.0,5,1111,24.0,843.0,843.0
0.005,6,10,2007,5,928,1.0,660.0,660.0,5,1079,1.0,811.0,811.0
0.011,6,10,1990,5,911,2.0,643.0,643.0,5,1079,2.0,811.0,811.0
0.015,6,10,1989,5,910,3.0,642.0,642.0,5,1079,3.0,811.0,811.0
300.024,6,12,1782,7,1348,50004.0,494.0,494.0,5,434,75005.0,83.0,83.0
0.115,6,10,1506,5,395,26.0,127.0,127.0,5,1111,26.0,843.0,843.0
0.01,6,10,1989,5,910,2.0,642.0,642.0,5,1079,2.0,811.0,811.0
0.029,6,10,1989,5,910,7.0,642.0,642.0,5,1079,7.0,811.0,811.0
0.012,6,10,1989,5,910,3.0,642.0,642.0,5,1079,3.0,811.0,811.0
40.072,17,10,676,5,460,10017.0,104.0,64.0,5,216,10017.0,20.0,15.0
0.01,6,10,1677,5,827,2.0,559.0,559.0,5,850,2.0,582.0,582.0
0.004,6,10,1989,5,927,1.0,659.0,659.0,5,1062,1.0,794.0,794.0
0.007,6,10,1643,5,860,1.0,592.0,592.0,5,783,1.0,515.0,515.0
40.057,17,10,676,5,460,10013.0,104.0,64.0,5,216,10013.0,20.0,15.0
388.155,6,24,2405,17,919,24259.0,195.0,195.0,7,1486,3910.0,419.0,398.0
0.016,6,10,1990,5,911,4.0,643.0,643.0,5,1079,4.0,811.0,811.0
0.014,6,10,1983,5,910,3.0,642.0,642.0,5,1073,3.0,805.0,805.0
9.038,17,6,376,5,280,2259.0,28.0,28.0,1,96,0.0,68.0,68.0
0.005,6,10,2006,5,927,1.0,659.0,659.0,5,1079,1.0,811.0,811.0
40.078,17,10,676,5,460,10018.0,104.0,64.0,5,216,10018.0,20.0,15.0
0.13,17,2,166,1,75,0.0,47.0,47.0,1,91,0.0,63.0,63.0
0.005,6,10,1854,5,889,1.0,621.0,621.0,5,965,1.0,697.0,697.0
0.126,17,2,156,1,64,0.0,36.0,36.0,1,92,0.0,64.0,64.0
0.018,6,10,1990,5,911,4.0,643.0,643.0,5,1079,4.0,811.0,811.0
0.008,6,10,1989,5,910,2.0,642.0,642.0,5,1079,2.0,811.0,811.0
0.749,6,10,2009,6,1655,149.0,1403.0,1403.0,4,354,172.0,182.0,182.0
0.005,6,10,2007,5,928,1.0,660.0,660.0,5,1079,1.0,811.0,811.0
0.009,6,12,1926,6,1189,1.0,659.0,434.0,6,737,1.0,417.0,417.0
0.124,6,10,1506,5,395,26.0,127.0,127.0,5,1111,26.0,843.0,843.0
0.005,6,10,2000,5,927,1.0,659.0,659.0,5,1073,1.0,805.0,805.0
0.001,17,2,136,1,60,0.0,32.0,32.0,1,76,0.0,48.0,48.0
0.008,6,12,1926,6,1189,1.0,659.0,434.0,6,737,1.0,417.0,417.0
0.001,17,2,180,1,66,0.0,38.0,38.0,1,114,0.0,86.0,86.0
0.006,6,10,2007,5,928,1.0,660.0,660.0,5,1079,1.0,811.0,811.0
0.004,17,2,136,1,60,0.0,32.0,32.0,1,76,0.0,48.0,48.0
0.012,6,14,3787,7,497,2.0,125.0,125.0,7,3290,1.0,1448.0,972.0
300.301,6,16,2170,9,684,37516.0,146.0,146.0,7,1486,50022.0,419.0,398.0
0.004,17,2,148,1,60,0.0,32.0,32.0,1,88,0.0,60.0,60.0
0.069,6,43,13995,24,2565,3.0,517.0,146.0,19,11430,3.0,1402.0,802.0
0.005,6,10,1689,5,839,1.0,571.0,571.0,5,850,1.0,582.0,582.0
0.005,17,2,179,1,71,0.0,43.0,43.0,1,108,0.0,80.0,80.0
0.004,6,10,2007,5,928,1.0,660.0,660.0,5,1079,1.0,811.0,811.0
0.01,6,10,1990,5,911,2.0,643.0,643.0,5,1079,2.0,811.0,811.0
0.005,6,10,2007,5,928,1.0,660.0,660.0,5,1079,1.0,811.0,811.0
172.555,17,80,11398,40,2660,4424.0,44.0,38.0,40,8738,4423.0,239.0,190.0
0.004,6,10,2006,5,927,1.0,659.0,659.0,5,1079,1.0,811.0,811.0
0.005,6,10,1989,5,927,1.0,659.0,659.0,5,1062,1.0,794.0,794.0
0.004,6,10,1989,5,927,1.0,659.0,659.0,5,1062,1.0,794.0,794.0
0.186,17,2,152,1,76,0.0,48.0,48.0,1,76,0.0,48.0,48.0
178.301,17,78,11013,39,2608,4692.0,44.0,38.0,39,8405,4692.0,261.0,187.0
0.127,6,10,1506,5,395,29.0,127.0,127.0,5,1111,28.0,843.0,843.0
0.025,17,2,299,1,65,0.0,37.0,37.0,1,234,0.0,206.0,206.0
0.012,6,10,1989,5,910,3.0,642.0,642.0,5,1079,3.0,811.0,811.0
308.573,17,18,1008,9,640,38555.0,48.0,43.0,9,368,38555.0,20.0,12.0
0.006,6,14,3799,7,509,1.0,137.0,137.0,7,3290,0.0,1448.0,972.0
0.015,17,2,152,1,56,0.0,28.0,28.0,1,96,0.0,68.0,68.0
0.096,6,10,1506,5,395,17.0,127.0,127.0,5,1111,23.0,843.0,843.0
0.005,6,10,1547,5,764,1.0,496.0,496.0,5,783,1.0,515.0,515.0
0.069,6,44,13974,24,2503,3.0,517.0,139.0,20,11471,3.0,1402.0,744.0
0.004,6,10,1702,5,863,0.0,595.0,595.0,5,839,1.0,571.0,571.0
0.005,17,2,166,1,75,0.0,47.0,47.0,1,91,0.0,63.0,63.0
0.194,17,2,144,1,64,0.0,36.0,36.0,1,80,0.0,52.0,52.0
0.005,6,10,1989,5,927,1.0,659.0,659.0,5,1062,1.0,794.0,794.0
126.048,6,14,2938,8,2504,17973.0,1414.0,1086.0,6,434,25163.0,182.0,182.0
0.005,6,10,1854,5,889,1.0,621.0,621.0,5,965,1.0,697.0,697.0
0.007,6,10,1547,5,764,1.0,496.0,496.0,5,783,1.0,515.0,515.0
0.004,6,10,2007,5,928,1.0,660.0,660.0,5,1079,1.0,811.0,811.0
0.117,6,10,1506,5,395,22.0,127.0,127.0,5,1111,26.0,843.0,843.0
0.01,6,10,1972,5,910,2.0,642.0,642.0,5,1062,2.0,794.0,794.0
40.059,17,10,676,5,460,10014.0,104.0,64.0,5,216,10013.0,20.0,15.0
0.039,17,2,186,1,61,0.0,33.0,33.0,1,125,0.0,97.0,97.0
0.004,17,2,148,1,60,0.0,32.0,32.0,1,88,0.0,60.0,60.0
15.245,17,18,9401,9,6963,1901.0,1350.0,745.0,9,2438,1901.0,1350.0,242.0
0.019,6,13,3735,7,497,3.0,125.0,125.0,6,3238,3.0,1470.0,1459.0
0.008,6,10,1983,5,910,1.0,642.0,642.0,5,1073,2.0,805.0,805.0
0.004,17,2,148,1,60,0.0,32.0,32.0,1,88,0.0,60.0,60.0
0.004,6,10,2007,5,928,1.0,660.0,660.0,5,1079,1.0,811.0,811.0
0.004,6,10,1702,5,863,1.0,595.0,595.0,5,839,0.0,571.0,571.0
0.009,6,10,1989,5,910,2.0,642.0,642.0,5,1079,2.0,811.0,811.0
10.953,17,28,4395,14,2312,834.0,587.0,137.0,14,2083,834.0,270.0,120.0
0.139,6,10,1506,5,395,31.0,127.0,127.0,5,1111,27.0,843.0,843.0
0.001,17,2,166,1,75,0.0,47.0,47.0,1,91,0.0,63.0,63.0
0.006,6,10,1989,5,927,1.0,659.0,659.0,5,1062,1.0,794.0,794.0
10.733,6,24,7517,13,1385,894.0,530.0,277.0,11,6132,1054.0,2720.0,946.0
0.007,17,2,179,1,71,0.0,43.0,43.0,1,108,0.0,80.0,80.0
40.062,17,10,676,5,460,10014.0,104.0,64.0,5,216,10014.0,20.0,15.0
0.008,6,10,1972,5,910,2.0,642.0,642.0,5,1062,2.0,794.0,794.0
0.001,17,2,180,1,66,0.0,38.0,38.0,1,114,0.0,86.0,86.0
0.006,6,10,2007,5,928,1.0,660.0,660.0,5,1079,1.0,811.0,811.0
0.005,6,10,1779,5,928,1.0,660.0,660.0,5,851,1.0,583.0,583.0
0.009,6,10,1990,5,911,2.0,643.0,643.0,5,1079,2.0,811.0,811.0
0.005,6,10,2006,5,927,1.0,659.0,659.0,5,1079,1.0,811.0,811.0
0.011,6,10,1989,5,910,2.0,642.0,642.0,5,1079,2.0,811.0,811.0
240.105,6,21,4924,11,941,24010.0,180.0,93.0,10,3983,26678.0,1591.0,575.0
0.02,6,10,1990,5,911,5.0,643.0,643.0,5,1079,4.0,811.0,811.0
0.08,6,10,1506,5,395,16.0,127.0,127.0,5,1111,16.0,843.0,843.0
1793.636,6,532,185958,266,162230,6768.0,2883.0,995.0,266,23728,6768.0,351.0,98.0
9.036,17,6,376,5,280,2259.0,28.0,28.0,1,96,0.0,68.0,68.0
0.005,6,10,2007,5,928,1.0,660.0,660.0,5,1079,1.0,811.0,811.0
0.004,6,10,2006,5,927,1.0,659.0,659.0,5,1079,1.0,811.0,811.0
0.122,6,10,1506,5,395,27.0,127.0,127.0,5,1111,27.0,843.0,843.0
0.035,6,10,1983,5,910,8.0,642.0,642.0,5,1073,8.0,805.0,805.0
0.005,6,10,2006,5,927,1.0,659.0,659.0,5,1079,1.0,811.0,811.0
0.005,6,10,2006,5,927,1.0,659.0,659.0,5,1079,1.0,811.0,811.0
0.02,6,10,1990,5,911,5.0,643.0,643.0,5,1079,5.0,811.0,811.0
0.005,17,2,168,1,76,0.0,48.0,48.0,1,92,0.0,64.0,64.0
0.016,6,10,1983,5,910,4.0,642.0,642.0,5,1073,4.0,805.0,805.0
0.015,6,10,1972,5,910,3.0,642.0,642.0,5,1062,3.0,794.0,794.0
0.254,17,44,26662,25,23411,10.0,1350.0,908.0,19,3251,10.0,1350.0,143.0
0.004,6,10,1989,5,927,1.0,659.0,659.0,5,1062,1.0,794.0,794.0
0.006,6,10,1547,5,764,1.0,496.0,496.0,5,783,1.0,515.0,515.0
0.004,17,2,136,1,60,0.0,32.0,32.0,1,76,0.0,48.0,48.0
0.005,6,10,2006,5,927,1.0,659.0,659.0,5,1079,1.0,811.0,811.0
0.005,6,10,2000,5,927,1.0,659.0,659.0,5,1073,1.0,805.0,805.0
0.209,6,16,2674,8,1400,29.0,533.0,325.0,8,1274,18.0,529.0,212.0
0.012,6,10,1989,5,910,3.0,642.0,642.0,5,1079,3.0,811.0,811.0
0.084,6,10,1631,5,848,21.0,580.0,580.0,5,783,21.0,515.0,515.0
0.039,17,2,412,1,61,0.0,33.0,33.0,1,351,0.0,323.0,323.0
0.013,6,10,1762,5,911,3.0,643.0,643.0,5,851,3.0,583.0,583.0
0.015,6,10,1983,5,910,3.0,642.0,642.0,5,1073,3.0,805.0,805.0
0.006,6,10,1689,5,839,1.0,571.0,571.0,5,850,1.0,582.0,582.0
0.009,6,10,1972,5,910,2.0,642.0,642.0,5,1062,2.0,794.0,794.0
0.017,6,10,1990,5,911,4.0,643.0,643.0,5,1079,4.0,811.0,811.0
0.011,6,10,1631,5,848,2.0,580.0,580.0,5,783,2.0,515.0,515.0
0.004,6,13,3690,7,452,0.0,80.0,80.0,6,3238,0.0,1470.0,1459.0
359.195,6,21,1795,16,1030,23946.0,190.0,190.0,5,765,60003.0,464.0,248.0
0.011,6,10,1989,5,910,2.0,642.0,642.0,5,1079,2.0,811.0,811.0
0.005,17,2,164,1,74,0.0,46.0,46.0,1,90,0.0,62.0,62.0
0.081,6,10,1506,5,395,16.0,127.0,127.0,5,1111,19.0,843.0,843.0
0.128,6,10,1506,5,395,28.0,127.0,127.0,5,1111,28.0,843.0,843.0
1770.597,17,92,8096,46,4048,39346.0,60.0,60.0,46,4048,39346.0,60.0,60.0
0.066,6,10,1506,5,395,15.0,127.0,127.0,5,1111,14.0,843.0,843.0
0.009,6,12,1926,6,1189,1.0,659.0,434.0,6,737,1.0,417.0,417.0
0.006,6,10,1643,5,860,1.0,592.0,592.0,5,783,1.0,515.0,515.0
0.005,17,2,170,1,65,0.0,37.0,37.0,1,105,0.0,77.0,77.0
8.561,6,33,10728,19,9331,475.0,1515.0,834.0,14,1397,658.0,264.0,111.0
0.0,17,2,166,1,75,0.0,47.0,47.0,1,91,0.0,63.0,63.0
0.009,6,10,1631,5,848,2.0,580.0,580.0,5,783,2.0,515.0,515.0
0.01,6,10,1989,5,910,2.0,642.0,642.0,5,1079,2.0,811.0,811.0
0.004,6,10,2006,5,927,1.0,659.0,659.0,5,1079,1.0,811.0,811.0
0.012,6,10,1972,5,910,3.0,642.0,642.0,5,1062,3.0,794.0,794.0
10.987,17,28,4422,14,1994,836.0,269.0,114.0,14,2428,835.0,587.0,145.0
0.004,6,10,2007,5,928,1.0,660.0,660.0,5,1079,1.0,811.0,811.0
0.006,6,10,1547,5,764,1.0,496.0,496.0,5,783,1.0,515.0,515.0
0.005,6,10,2000,5,927,1.0,659.0,659.0,5,1073,1.0,805.0,805.0
0.066,17,2,152,1,76,0.0,48.0,48.0,1,76,0.0,48.0,48.0
0.004,17,2,148,1,60,0.0,32.0,32.0,1,88,0.0,60.0,60.0
0.004,6,13,3690,7,452,0.0,80.0,80.0,6,3238,0.0,1470.0,1459.0
240.019,6,9,787,5,488,60004.0,232.0,232.0,4,299,80005.0,83.0,83.0
0.092,6,10,1506,5,395,19.0,127.0,127.0,5,1111,17.0,843.0,843.0
0.012,6,10,1972,5,910,2.0,642.0,642.0,5,1062,3.0,794.0,794.0
0.086,6,10,1506,5,395,15.0,127.0,127.0,5,1111,17.0,843.0,843.0
0.005,6,10,2007,5,928,1.0,660.0,660.0,5,1079,1.0,811.0,811.0
0.012,6,10,1762,5,911,2.0,643.0,643.0,5,851,3.0,583.0,583.0
40.06,17,10,676,5,460,10014.0,104.0,64.0,5,216,10013.0,20.0,15.0
0.001,17,2,166,1,75,0.0,47.0,47.0,1,91,0.0,63.0,63.0
0.005,17,2,170,1,65,0.0,37.0,37.0,1,105,0.0,77.0,77.0
0.009,6,10,1989,5,910,2.0,642.0,642.0,5,1079,2.0,811.0,811.0
0.004,17,2,136,1,60,0.0,32.0,32.0,1,76,0.0,48.0,48.0
0.088,6,10,1506,5,395,20.0,127.0,127.0,5,1111,21.0,843.0,843.0
0.099,6,10,1506,5,395,22.0,127.0,127.0,5,1111,21.0,843.0,843.0
0.227,6,16,2675,8,1401,32.0,533.0,325.0,8,1274,20.0,529.0,212.0
0.007,17,2,299,1,65,0.0,37.0,37.0,1,234,0.0,206.0,206.0
354.065,6,21,1795,16,1030,23604.0,190.0,190.0,5,765,60002.0,464.0,248.0
0.005,6,10,1547,5,764,1.0,496.0,496.0,5,783,1.0,515.0,515.0
53.052,6,36,8277,18,1806,511.0,698.0,351.0,18,6471,3113.0,2126.0,478.0
0.004,6,10,2000,5,927,1.0,659.0,659.0,5,1073,1.0,805.0,805.0
0.005,6,10,2006,5,927,1.0,659.0,659.0,5,1079,1.0,811.0,811.0
0.01,6,10,1983,5,910,2.0,642.0,642.0,5,1073,2.0,805.0,805.0
10.73,17,26,4102,13,1822,885.0,269.0,112.0,13,2280,885.0,587.0,147.0
0.005,6,10,2007,5,928,1.0,660.0,660.0,5,1079,1.0,811.0,811.0
0.057,6,10,1506,5,395,11.0,127.0,127.0,5,1111,14.0,843.0,843.0
61.22,6,26,11203,13,1748,5101.0,538.0,350.0,13,9455,5101.0,2804.0,1096.0
0.129,17,2,148,1,60,0.0,32.0,32.0,1,88,0.0,60.0,60.0
40.079,17,10,676,5,460,10019.0,104.0,64.0,5,216,10018.0,20.0,15.0
0.006,6,10,1547,5,764,1.0,496.0,496.0,5,783,1.0,515.0,515.0
10.939,17,28,4398,14,2312,832.0,587.0,137.0,14,2086,833.0,269.0,121.0
0.005,17,2,164,1,74,0.0,46.0,46.0,1,90,0.0,62.0,62.0
308.603,17,20,1124,10,716,34274.0,48.0,43.0,10,408,34274.0,20.0,12.0
0.01,6,10,1989,5,910,2.0,642.0,642.0,5,1079,2.0,811.0,811.0
0.204,6,16,2670,8,1396,29.0,533.0,324.0,8,1274,18.0,529.0,212.0
0.111,6,10,1506,5,395,25.0,127.0,127.0,5,1111,24.0,843.0,843.0
0.021,6,10,1989,5,910,5.0,642.0,642.0,5,1079,5.0,811.0,811.0
0.274,17,43,20332,23,17156,12.0,1350.0,717.0,20,3176,11.0,1350.0,130.0
0.005,6,10,2006,5,927,1.0,659.0,659.0,5,1079,1.0,811.0,811.0
0.006,6,10,1547,5,764,1.0,496.0,496.0,5,783,1.0,515.0,515.0
0.039,17,2,148,1,60,0.0,32.0,32.0,1,88,0.0,60.0,60.0
0.081,6,10,1506,5,395,18.0,127.0,127.0,5,1111,15.0,843.0,843.0
0.092,6,10,1506,5,395,20.0,127.0,127.0,5,1111,21.0,843.0,843.0
0.037,17,2,186,1,61,0.0,33.0,33.0,1,125,0.0,97.0,97.0
0.113,6,10,1506,5,395,26.0,127.0,127.0,5,1111,27.0,843.0,843.0
0.003,17,2,148,1,60,0.0,32.0,32.0,1,88,0.0,60.0,60.0
0.075,6,10,1506,5,395,16.0,127.0,127.0,5,1111,17.0,843.0,843.0
0.009,6,10,1989,5,910,2.0,642.0,642.0,5,1079,2.0,811.0,811.0
0.003,17,2,162,1,65,0.0,37.0,37.0,1,97,0.0,69.0,69.0
0.04,17,2,146,1,65,0.0,37.0,37.0,1,81,0.0,53.0,53.0
0.014,6,10,1972,5,910,3.0,642.0,642.0,5,1062,3.0,794.0,794.0
11.171,17,28,4423,14,1995,846.0,270.0,114.0,14,2428,846.0,587.0,145.0
0.096,6,10,1506,5,395,21.0,127.0,127.0,5,1111,22.0,843.0,843.0
0.092,6,10,1506,5,395,21.0,127.0,127.0,5,1111,15.0,843.0,843.0
0.005,6,10,2000,5,927,1.0,659.0,659.0,5,1073,1.0,805.0,805.0
0.001,17,2,180,1,66,0.0,38.0,38.0,1,114,0.0,86.0,86.0
0.258,17,15,8641,8,4076,36.0,1350.0,481.0,7,4565,33.0,1350.0,624.0
0.813,6,10,937,6,427,162.0,107.0,107.0,4,510,181.0,294.0,294.0
0.082,6,10,1506,5,395,18.0,127.0,127.0,5,1111,15.0,843.0,843.0
0.003,17,2,148,1,60,0.0,32.0,32.0,1,88,0.0,60.0,60.0
0.007,6,10,1989,5,910,1.0,642.0,642.0,5,1079,1.0,811.0,811.0
40.083,17,10,676,5,460,10013.0,104.0,64.0,5,216,10019.0,20.0,15.0
0.036,17,2,136,1,60,0.0,32.0,32.0,1,76,0.0,48.0,48.0
0.001,17,2,180,1,66,0.0,38.0,38.0,1,114,0.0,86.0,86.0
0.006,6,10,1854,5,889,1.0,621.0,621.0,5,965,1.0,697.0,697.0
0.012,6,10,1983,5,910,2.0,642.0,642.0,5,1073,2.0,805.0,805.0
0.004,17,2,148,1,60,0.0,32.0,32.0,1,88,0.0,60.0,60.0
0.001,17,2,154,1,69,0.0,41.0,41.0,1,85,0.0,57.0,57.0
0.01,6,10,1972,5,910,2.0,642.0,642.0,5,1062,2.0,794.0,794.0
0.014,6,10,1989,5,910,3.0,642.0,642.0,5,1079,3.0,811.0,811.0
0.004,6,10,2007,5,928,1.0,660.0,660.0,5,1079,1.0,811.0,811.0
0.019,6,13,3735,7,497,3.0,125.0,125.0,6,3238,3.0,1470.0,1459.0
0.004,17,2,136,1,60,0.0,32.0,32.0,1,76,0.0,48.0,48.0
240.125,6,25,9347,13,4324,20010.0,1368.0,728.0,12,5023,21829.0,1657.0,878.0
0.011,6,10,1972,5,910,2.0,642.0,642.0,5,1062,2.0,794.0,794.0
0.005,6,10,2006,5,927,1.0,659.0,659.0,5,1079,1.0,811.0,811.0
1755.982,6,105,6270,60,3525,29761.0,27.0,27.0,45,2745,39907.0,27.0,27.0
0.168,6,10,1506,5,395,38.0,127.0,127.0,5,1111,37.0,843.0,843.0
0.005,6,10,2007,5,928,1.0,660.0,660.0,5,1079,1.0,811.0,811.0
0.005,6,10,2006,5,927,1.0,659.0,659.0,5,1079,1.0,811.0,811.0
0.005,6,13,3747,7,509,0.0,137.0,137.0,6,3238,1.0,1470.0,1459.0
0.004,17,4,284,2,120,0.0,32.0,32.0,2,164,0.0,60.0,54.0
0.01,6,10,1631,5,848,2.0,580.0,580.0,5,783,2.0,515.0,515.0
0.098,6,10,1506,5,395,20.0,127.0,127.0,5,1111,23.0,843.0,843.0
0.02,6,10,1990,5,911,5.0,643.0,643.0,5,1079,5.0,811.0,811.0
0.004,17,2,148,1,60,0.0,32.0,32.0,1,88,0.0,60.0,60.0
0.003,17,2,136,1,60,0.0,32.0,32.0,1,76,0.0,48.0,48.0
0.012,6,10,1989,5,910,2.0,642.0,642.0,5,1079,3.0,811.0,811.0
0.005,6,10,1779,5,928,1.0,660.0,660.0,5,851,1.0,583.0,583.0
0.006,17,2,225,1,65,0.0,37.0,37.0,1,160,0.0,132.0,132.0
177.127,17,72,10188,36,2394,5060.0,44.0,38.0,36,7794,5060.0,239.0,188.0
0.006,17,2,132,1,58,0.0,30.0,30.0,1,74,0.0,46.0,46.0
0.008,6,10,1972,5,910,2.0,642.0,642.0,5,1062,1.0,794.0,794.0
0.006,6,10,1990,5,911,1.0,643.0,643.0,5,1079,1.0,811.0,811.0
0.126,6,10,1506,5,395,28.0,127.0,127.0,5,1111,28.0,843.0,843.0
0.005,6,10,1774,5,923,1.0,655.0,655.0,5,851,1.0,583.0,583.0
0.083,6,10,1506,5,395,17.0,127.0,127.0,5,1111,19.0,843.0,843.0
0.007,17,2,179,1,71,0.0,43.0,43.0,1,108,0.0,80.0,80.0
0.005,6,10,1689,5,839,1.0,571.0,571.0,5,850,1.0,582.0,582.0
0.009,6,12,1926,6,1189,1.0,659.0,434.0,6,737,1.0,417.0,417.0
0.003,17,2,136,1,60,0.0,32.0,32.0,1,76,0.0,48.0,48.0
0.057,17,2,160,1,72,0.0,44.0,44.0,1,88,0.0,60.0,60.0
0.01,6,10,1972,5,910,2.0,642.0,642.0,5,1062,2.0,794.0,794.0
0.001,17,2,166,1,75,0.0,47.0,47.0,1,91,0.0,63.0,63.0
240.303,6,28,10492,14,4880,18484.0,1368.0,692.0,14,5612,18484.0,1497.0,812.0
0.005,6,10,1989,5,927,1.0,659.0,659.0,5,1062,1.0,794.0,794.0
0.006,6,10,1547,5,764,1.0,496.0,496.0,5,783,1.0,515.0,515.0
0.005,6,10,1989,5,927,1.0,659.0,659.0,5,1062,1.0,794.0,794.0
0.015,6,10,1983,5,910,3.0,642.0,642.0,5,1073,3.0,805.0,805.0
0.005,6,10,2007,5,928,1.0,660.0,660.0,5,1079,1.0,811.0,811.0
40.066,17,10,676,5,460,10015.0,104.0,64.0,5,216,10014.0,20.0,15.0
0.005,17,2,166,1,75,0.0,47.0,47.0,1,91,0.0,63.0,63.0
308.623,17,20,1124,10,716,34277.0,48.0,43.0,10,408,34277.0,20.0,12.0
0.071,6,10,1506,5,395,15.0,127.0,127.0,5,1111,16.0,843.0,843.0
0.003,17,2,136,1,60,0.0,32.0,32.0,1,76,0.0,48.0,48.0
0.001,17,2,180,1,66,0.0,38.0,38.0,1,114,0.0,86.0,86.0
0.009,6,10,1990,5,911,2.0,643.0,643.0,5,1079,2.0,811.0,811.0
0.006,6,10,1689,5,839,1.0,571.0,571.0,5,850,1.0,582.0,582.0
0.013,6,10,1972,5,910,3.0,642.0,642.0,5,1062,3.0,794.0,794.0
0.123,17,4,284,2,120,0.0,32.0,32.0,2,164,106.0,60.0,54.0
0.004,6,10,2007,5,928,1.0,660.0,660.0,5,1079,1.0,811.0,811.0
240.012,6,9,787,5,488,60003.0,232.0,232.0,4,299,80002.0,83.0,83.0
0.009,6,10,1989,5,910,2.0,642.0,642.0,5,1079,2.0,811.0,811.0
0.107,6,10,1506,5,395,22.0,127.0,127.0,5,1111,21.0,843.0,843.0
0.078,6,10,1506,5,395,16.0,127.0,127.0,5,1111,18.0,843.0,843.0
0.015,6,10,1989,5,910,3.0,642.0,642.0,5,1079,3.0,811.0,811.0
0.005,6,14,3736,7,446,0.0,74.0,74.0,7,3290,0.0,1448.0,972.0
0.011,6,10,1972,5,910,2.0,642.0,642.0,5,1062,2.0,794.0,794.0
0.011,6,10,1990,5,911,2.0,643.0,643.0,5,1079,2.0,811.0,811.0
0.005,17,2,169,1,62,0.0,34.0,34.0,1,107,0.0,79.0,79.0
0.116,6,10,1506,5,395,24.0,127.0,127.0,5,1111,24.0,843.0,843.0
0.085,6,10,1506,5,395,19.0,127.0,127.0,5,1111,19.0,843.0,843.0
0.084,6,10,1506,5,395,18.0,127.0,127.0,5,1111,19.0,843.0,843.0
0.015,6,10,2006,5,927,3.0,659.0,659.0,5,1079,3.0,811.0,811.0
0.119,6,10,1506,5,395,27.0,127.0,127.0,5,1111,24.0,843.0,843.0
0.008,6,10,1547,5,764,1.0,496.0,496.0,5,783,1.0,515.0,515.0
0.043,17,2,152,1,76,0.0,48.0,48.0,1,76,0.0,48.0,48.0
0.005,17,2,214,1,75,0.0,47.0,47.0,1,139,0.0,111.0,111.0
0.014,17,2,148,1,60,0.0,32.0,32.0,1,88,0.0,60.0,60.0
0.101,6,10,1506,5,395,23.0,127.0,127.0,5,1111,23.0,843.0,843.0
0.004,17,2,148,1,60,0.0,32.0,32.0,1,88,0.0,60.0,60.0
0.024,6,10,1983,5,910,6.0,642.0,642.0,5,1073,5.0,805.0,805.0
0.006,6,10,1854,5,889,1.0,621.0,621.0,5,965,1.0,697.0,697.0
11.15,17,28,4421,14,1994,845.0,269.0,114.0,14,2427,845.0,586.0,145.0
361.872,6,19,1688,15,978,25848.0,190.0,190.0,4,710,80017.0,494.0,494.0
0.011,6,10,1972,5,910,2.0,642.0,642.0,5,1062,2.0,794.0,794.0
0.009,6,10,1989,5,910,2.0,642.0,642.0,5,1079,2.0,811.0,811.0
0.006,6,10,1854,5,889,1.0,621.0,621.0,5,965,1.0,697.0,697.0
1799.997,6,137,6590,76,3625,23996.0,39.0,39.0,61,2965,29996.0,35.0,35.0
0.006,6,10,1689,5,839,1.0,571.0,571.0,5,850,1.0,582.0,582.0
0.013,6,10,1677,5,827,3.0,559.0,559.0,5,850,3.0,582.0,582.0
0.001,17,2,136,1,60,0.0,32.0,32.0,1,76,0.0,48.0,48.0
0.004,6,10,2007,5,928,1.0,660.0,660.0,5,1079,1.0,811.0,811.0
0.005,6,10,2007,5,928,1.0,660.0,660.0,5,1079,1.0,811.0,811.0
0.001,17,2,180,1,66,0.0,38.0,38.0,1,114,0.0,86.0,86.0
0.039,17,4,284,2,120,0.0,32.0,32.0,2,164,36.0,60.0,54.0
0.004,6,10,2007,5,928,1.0,660.0,660.0,5,1079,1.0,811.0,811.0
0.012,6,10,1983,5,910,3.0,642.0,642.0,5,1073,2.0,805.0,805.0
240.018,6,9,787,5,488,60004.0,232.0,232.0,4,299,80004.0,83.0,83.0
0.041,17,2,148,1,60,0.0,32.0,32.0,1,88,0.0,60.0,60.0
0.005,6,13,3690,7,452,0.0,80.0,80.0,6,3238,0.0,1470.0,1459.0
0.016,17,2,198,1,91,0.0,63.0,63.0,1,107,0.0,79.0,79.0
0.009,6,10,1989,5,927,2.0,659.0,659.0,5,1062,2.0,794.0,794.0
0.099,6,10,1506,5,395,19.0,127.0,127.0,5,1111,20.0,843.0,843.0
0.005,6,10,2007,5,928,1.0,660.0,660.0,5,1079,1.0,811.0,811.0
0.012,6,10,1989,5,910,3.0,642.0,642.0,5,1079,3.0,811.0,811.0
0.005,6,10,1989,5,927,1.0,659.0,659.0,5,1062,1.0,794.0,794.0
0.005,6,10,1547,5,764,1.0,496.0,496.0,5,783,1.0,515.0,515.0
0.004,6,10,2007,5,928,1.0,660.0,660.0,5,1079,1.0,811.0,811.0
0.088,6,10,1506,5,395,19.0,127.0,127.0,5,1111,20.0,843.0,843.0
0.005,6,10,1989,5,927,1.0,659.0,659.0,5,1062,1.0,794.0,794.0
0.005,6,10,1689,5,839,1.0,571.0,571.0,5,850,1.0,582.0,582.0
0.09,6,10,1506,5,395,19.0,127.0,127.0,5,1111,20.0,843.0,843.0
284.31,6,24,6115,11,1226,28430.0,267.0,156.0,13,4889,23692.0,1400.0,873.0
0.037,17,4,284,2,120,0.0,32.0,32.0,2,164,33.0,60.0,54.0
0.005,17,4,284,2,120,0.0,32.0,32.0,2,164,1.0,60.0,54.0
0.005,6,10,2006,5,927,1.0,659.0,659.0,5,1079,1.0,811.0,811.0
0.006,6,10,1547,5,764,1.0,496.0,496.0,5,783,1.0,515.0,515.0
0.003,17,2,152,1,76,0.0,48.0,48.0,1,76,0.0,48.0,48.0
40.073,17,10,676,5,460,10016.0,104.0,64.0,5,216,10017.0,20.0,15.0
0.011,6,10,1989,5,910,2.0,642.0,642.0,5,1079,2.0,811.0,811.0
0.125,6,10,1506,5,395,29.0,127.0,127.0,5,1111,29.0,843.0,843.0
0.005,17,2,140,1,62,0.0,34.0,34.0,1,78,0.0,50.0,50.0
0.04,17,4,284,2,120,0.0,32.0,32.0,2,164,1.0,60.0,54.0
0.005,6,10,2007,5,928,1.0,660.0,660.0,5,1079,1.0,811.0,811.0
0.009,6,10,2007,5,928,2.0,660.0,660.0,5,1079,2.0,811.0,811.0
0.109,6,10,1506,5,395,22.0,127.0,127.0,5,1111,25.0,843.0,843.0
0.004,6,10,2007,5,928,1.0,660.0,660.0,5,1079,1.0,811.0,811.0
0.008,6,10,1989,5,910,2.0,642.0,642.0,5,1079,2.0,811.0,811.0
0.005,17,2,170,1,65,0.0,37.0,37.0,1,105,0.0,77.0,77.0
0.005,6,10,2000,5,927,1.0,659.0,659.0,5,1073,1.0,805.0,805.0
0.003,17,2,136,1,60,0.0,32.0,32.0,1,76,0.0,48.0,48.0
0.016,6,10,1990,5,911,4.0,643.0,643.0,5,1079,3.0,811.0,811.0
0.004,6,10,2006,5,927,1.0,659.0,659.0,5,1079,1.0,811.0,811.0
0.006,6,10,1689,5,839,1.0,571.0,571.0,5,850,1.0,582.0,582.0
0.065,6,26,10144,14,8890,5.0,2883.0,1166.0,12,1254,5.0,245.0,105.0
1755.904,6,105,6240,60,3510,29760.0,26.0,26.0,45,2730,39906.0,26.0,26.0
0.006,6,10,1689,5,839,1.0,571.0,571.0,5,850,1.0,582.0,582.0
0.004,6,10,2000,5,927,1.0,659.0,659.0,5,1073,1.0,805.0,805.0
125.987,6,14,2938,8,2504,17965.0,1414.0,1086.0,6,434,25151.0,182.0,182.0
0.005,6,10,1854,5,889,1.0,621.0,621.0,5,965,1.0,697.0,697.0
316.71,17,20,1124,10,716,35175.0,48.0,43.0,10,408,35175.0,20.0,12.0
0.013,6,10,1762,5,911,3.0,643.0,643.0,5,851,3.0,583.0,583.0
0.001,17,2,180,1,66,0.0,38.0,38.0,1,114,0.0,86.0,86.0
0.004,17,2,148,1,60,0.0,32.0,32.0,1,88,0.0,60.0,60.0
293.662,6,400,348984,193,21596,1529.0,2736.0,888.0,207,327388,1425.0,2804.0,1640.0
0.005,6,10,1547,5,764,1.0,496.0,496.0,5,783,1.0,515.0,515.0
325.632,17,20,1124,10,716,36173.0,48.0,43.0,10,408,36172.0,20.0,12.0
0.072,6,10,1506,5,395,15.0,127.0,127.0,5,1111,15.0,843.0,843.0
0.012,6,10,1972,5,910,3.0,642.0,642.0,5,1062,3.0,794.0,794.0
0.01,6,10,1972,5,910,2.0,642.0,642.0,5,1062,2.0,794.0,794.0
1772.496,6,102,6114,59,3473,30559.0,27.0,27.0,43,2641,42201.0,27.0,27.0
15.343,17,47,25991,26,21266,612.0,1350.0,789.0,21,4725,765.0,1350.0,197.0
0.01,6,10,1989,5,910,2.0,642.0,642.0,5,1079,2.0,811.0,811.0
0.114,6,10,1506,5,395,25.0,127.0,127.0,5,1111,27.0,843.0,843.0
0.008,6,10,1972,5,910,1.0,642.0,642.0,5,1062,2.0,794.0,794.0
0.056,17,2,179,1,71,0.0,43.0,43.0,1,108,0.0,80.0,80.0
10.795,17,28,4421,14,1994,822.0,269.0,114.0,14,2427,822.0,586.0,145.0
35.401,6,51,23438,26,17411,369.0,2720.0,1485.0,25,6027,1467.0,2667.0,385.0
240.016,6,9,787,5,488,60004.0,232.0,232.0,4,299,80004.0,83.0,83.0
309.634,17,20,1124,10,716,34390.0,48.0,43.0,10,408,34390.0,20.0,12.0
0.039,17,2,166,1,75,0.0,47.0,47.0,1,91,0.0,63.0,63.0
1681.027,6,129,16337,77,11550,22118.0,302.0,302.0,52,4787,32961.0,83.0,83.0
0.003,17,2,136,1,60,0.0,32.0,32.0,1,76,0.0,48.0,48.0
0.005,6,10,1854,5,889,1.0,621.0,621.0,5,965,1.0,697.0,697.0
0.011,6,10,1762,5,911,2.0,643.0,643.0,5,851,2.0,583.0,583.0
0.016,6,10,1631,5,848,4.0,580.0,580.0,5,783,4.0,515.0,515.0
0.115,6,10,1506,5,395,28.0,127.0,127.0,5,1111,24.0,843.0,843.0
0.004,6,10,2000,5,927,1.0,659.0,659.0,5,1073,1.0,805.0,805.0
0.004,6,10,1702,5,863,1.0,595.0,595.0,5,839,0.0,571.0,571.0
40.061,17,10,676,5,460,10012.0,104.0,64.0,5,216,10014.0,20.0,15.0
0.004,6,10,2006,5,927,1.0,659.0,659.0,5,1079,1.0,811.0,811.0
0.994,6,29,12612,16,6148,66.0,2720.0,912.0,13,6464,68.0,2720.0,988.0
0.012,6,10,1972,5,910,3.0,642.0,642.0,5,1062,3.0,794.0,794.0
0.005,6,10,1989,5,927,1.0,659.0,659.0,5,1062,1.0,794.0,794.0
0.001,17,2,180,1,66,0.0,38.0,38.0,1,114,0.0,86.0,86.0
0.068,17,8,3613,4,1874,22.0,1350.0,440.0,4,1739,12.0,1350.0,406.0
0.006,6,10,1547,5,764,1.0,496.0,496.0,5,783,1.0,515.0,515.0
0.122,6,10,1506,5,395,28.0,127.0,127.0,5,1111,22.0,843.0,843.0
0.004,6,10,2006,5,927,1.0,659.0,659.0,5,1079,1.0,811.0,811.0
2.125,6,53,33272,27,2861,81.0,517.0,289.0,26,30411,84.0,2428.0,1263.0
0.005,6,10,1989,5,927,1.0,659.0,659.0,5,1062,1.0,794.0,794.0
0.14,6,10,1506,5,395,32.0,127.0,127.0,5,1111,31.0,843.0,843.0
0.01,6,10,1989,5,910,2.0,642.0,642.0,5,1079,2.0,811.0,811.0
0.008,6,10,1989,5,910,2.0,642.0,642.0,5,1079,2.0,811.0,811.0
0.072,17,2,170,1,65,0.0,37.0,37.0,1,105,0.0,77.0,77.0
0.008,6,12,1698,6,863,1.0,327.0,271.0,6,835,1.0,515.0,515.0
0.006,6,10,1547,5,764,1.0,496.0,496.0,5,783,1.0,515.0,515.0
0.217,6,16,2777,8,1395,31.0,533.0,323.0,8,1382,20.0,529.0,239.0
0.014,6,10,1989,5,910,3.0,642.0,642.0,5,1079,3.0,811.0,811.0
0.011,17,2,230,1,68,0.0,40.0,40.0,1,162,0.0,134.0,134.0
354.067,6,21,1795,16,1030,23604.0,190.0,190.0,5,765,60004.0,464.0,248.0
371.487,6,22,2313,16,867,24765.0,195.0,195.0,6,1446,4637.0,419.0,398.0
0.006,6,10,1547,5,764,1.0,496.0,496.0,5,783,1.0,515.0,515.0
0.005,17,2,222,1,65,0.0,37.0,37.0,1,157,0.0,129.0,129.0
0.005,6,10,2007,5,928,1.0,660.0,660.0,5,1079,1.0,811.0,811.0
0.005,6,10,1854,5,889,1.0,621.0,621.0,5,965,1.0,697.0,697.0
301.032,6,45,13099,24,7187,13088.0,3264.0,1030.0,21,5912,441.0,2667.0,361.0
0.008,6,12,1926,6,1189,1.0,659.0,434.0,6,737,1.0,417.0,417.0
0.025,6,10,1989,5,910,6.0,642.0,642.0,5,1079,6.0,811.0,811.0
0.071,6,10,1506,5,395,16.0,127.0,127.0,5,1111,15.0,843.0,843.0
412.7,6,23,2943,8,1906,17153.0,494.0,494.0,15,1037,29478.0,83.0,83.0
0.022,6,13,3735,7,497,3.0,125.0,125.0,6,3238,4.0,1470.0,1459.0
0.005,6,13,3747,7,509,0.0,137.0,137.0,6,3238,1.0,1470.0,1459.0
40.06,17,10,676,5,460,10013.0,104.0,64.0,5,216,10014.0,20.0,15.0
0.003,17,2,148,1,60,0.0,32.0,32.0,1,88,0.0,60.0,60.0
0.015,6,10,1677,5,827,3.0,559.0,559.0,5,850,3.0,582.0,582.0
0.004,17,4,284,2,120,0.0,32.0,32.0,2,164,1.0,60.0,54.0
0.005,6,10,2006,5,927,1.0,659.0,659.0,5,1079,1.0,811.0,811.0
0.004,17,4,284,2,120,0.0,32.0,32.0,2,164,0.0,60.0,54.0
0.001,17,2,180,1,66,0.0,38.0,38.0,1,114,0.0,86.0,86.0
0.005,17,2,178,1,65,0.0,37.0,37.0,1,113,0.0,85.0,85.0
0.004,17,2,164,1,74,0.0,46.0,46.0,1,90,0.0,62.0,62.0
0.004,6,10,1989,5,927,1.0,659.0,659.0,5,1062,1.0,794.0,794.0
308.441,17,20,1124,10,716,34257.0,48.0,43.0,10,408,34257.0,20.0,12.0
0.009,6,10,1972,5,910,2.0,642.0,642.0,5,1062,2.0,794.0,794.0
0.016,6,10,1972,5,910,4.0,642.0,642.0,5,1062,3.0,794.0,794.0
0.012,6,10,1989,5,910,2.0,642.0,642.0,5,1079,3.0,811.0,811.0
40.053,17,10,676,5,460,10012.0,104.0,64.0,5,216,10012.0,20.0,15.0
0.028,6,10,1990,5,911,6.0,643.0,643.0,5,1079,6.0,811.0,811.0
0.071,6,10,1506,5,395,14.0,127.0,127.0,5,1111,16.0,843.0,843.0
0.012,6,10,1989,5,910,2.0,642.0,642.0,5,1079,3.0,811.0,811.0
0.004,17,4,284,2,120,0.0,32.0,32.0,2,164,0.0,60.0,54.0
0.016,6,10,1989,5,910,4.0,642.0,642.0,5,1079,3.0,811.0,811.0
33.14,6,26,9479,13,1655,2761.0,794.0,367.0,13,7824,2749.0,1360.0,810.0
376.267,6,22,2313,16,867,25084.0,195.0,195.0,6,1446,4646.0,419.0,398.0
0.023,17,2,198,1,91,0.0,63.0,63.0,1,107,0.0,79.0,79.0
0.007,6,10,1547,5,764,1.0,496.0,496.0,5,783,1.0,515.0,515.0
0.013,6,10,1983,5,910,3.0,642.0,642.0,5,1073,3.0,805.0,805.0
0.008,6,10,1989,5,910,2.0,642.0,642.0,5,1079,2.0,811.0,811.0
0.009,17,2,136,1,60,0.0,32.0,32.0,1,76,0.0,48.0,48.0
0.015,6,10,1990,5,911,3.0,643.0,643.0,5,1079,3.0,811.0,811.0
0.005,17,2,230,1,68,0.0,40.0,40.0,1,162,0.0,134.0,134.0
0.005,6,13,3747,7,509,0.0,137.0,137.0,6,3238,0.0,1470.0,1459.0
0.006,6,10,1547,5,764,1.0,496.0,496.0,5,783,1.0,515.0,515.0
0.015,6,10,1989,5,910,3.0,642.0,642.0,5,1079,3.0,811.0,811.0
0.014,6,10,1983,5,910,3.0,642.0,642.0,5,1073,3.0,805.0,805.0
0.005,6,10,2006,5,927,1.0,659.0,659.0,5,1079,1.0,811.0,811.0
0.128,17,2,80,1,32,0.0,4.0,4.0,1,48,0.0,20.0,20.0
0.001,17,2,180,1,66,0.0,38.0,38.0,1,114,0.0,86.0,86.0
0.006,6,10,1643,5,860,1.0,592.0,592.0,5,783,1.0,515.0,515.0
0.008,6,10,1990,5,911,2.0,643.0,643.0,5,1079,2.0,811.0,811.0
0.01,17,2,140,1,62,0.0,34.0,34.0,1,78,0.0,50.0,50.0
0.17,6,3,453,2,321,170.0,241.0,241.0,1,132,0.0,92.0,92.0
0.01,6,10,1983,5,910,2.0,642.0,642.0,5,1073,2.0,805.0,805.0
0.007,6,10,1547,5,764,1.0,496.0,496.0,5,783,1.0,515.0,515.0
0.006,6,10,1547,5,764,1.0,496.0,496.0,5,783,1.0,515.0,515.0
0.006,17,2,179,1,71,0.0,43.0,43.0,1,108,0.0,80.0,80.0
0.006,6,10,1547,5,764,1.0,496.0,496.0,5,783,1.0,515.0,515.0
0.119,6,10,1506,5,395,18.0,127.0,127.0,5,1111,28.0,843.0,843.0
40.049,17,10,676,5,460,10011.0,104.0,64.0,5,216,10011.0,20.0,15.0
0.088,6,11,1022,6,385,15.0,65.0,65.0,5,637,19.0,369.0,369.0
0.003,17,2,136,1,60,0.0,32.0,32.0,1,76,0.0,48.0,48.0
0.015,6,10,1989,5,910,3.0,642.0,642.0,5,1079,3.0,811.0,811.0
0.015,6,10,1631,5,848,3.0,580.0,580.0,5,783,3.0,515.0,515.0
0.041,17,4,364,2,160,0.0,52.0,52.0,2,204,1.0,80.0,74.0
0.008,6,12,1926,6,1189,1.0,659.0,434.0,6,737,1.0,417.0,417.0
240.676,6,37,9662,19,2178,13368.0,750.0,236.0,18,7484,14155.0,1402.0,595.0
0.014,6,10,1990,5,911,3.0,643.0,643.0,5,1079,3.0,811.0,811.0
0.003,17,2,162,1,65,0.0,37.0,37.0,1,97,0.0,69.0,69.0
0.075,6,10,1506,5,395,17.0,127.0,127.0,5,1111,16.0,843.0,843.0
0.005,6,10,2006,5,927,1.0,659.0,659.0,5,1079,1.0,811.0,811.0
0.069,6,10,1506,5,395,15.0,127.0,127.0,5,1111,15.0,843.0,843.0
0.005,6,10,1989,5,927,1.0,659.0,659.0,5,1062,1.0,794.0,794.0
0.024,6,10,1677,5,827,5.0,559.0,559.0,5,850,6.0,582.0,582.0
0.018,6,10,1972,5,910,4.0,642.0,642.0,5,1062,4.0,794.0,794.0
0.004,6,10,1702,5,863,0.0,595.0,595.0,5,839,1.0,571.0,571.0
0.093,6,10,1506,5,395,21.0,127.0,127.0,5,1111,21.0,843.0,843.0
0.124,6,10,1506,5,395,28.0,127.0,127.0,5,1111,26.0,843.0,843.0
0.011,6,10,1989,5,910,2.0,642.0,642.0,5,1079,2.0,811.0,811.0
0.104,6,10,1506,5,395,24.0,127.0,127.0,5,1111,24.0,843.0,843.0
0.127,6,10,1506,5,395,27.0,127.0,127.0,5,1111,28.0,843.0,843.0
0.001,17,2,180,1,66,0.0,38.0,38.0,1,114,0.0,86.0,86.0
0.013,6,10,1972,5,910,3.0,642.0,642.0,5,1062,3.0,794.0,794.0
0.013,6,10,1631,5,848,3.0,580.0,580.0,5,783,3.0,515.0,515.0
0.004,6,10,1702,5,863,1.0,595.0,595.0,5,839,1.0,571.0,571.0
0.005,6,14,3742,7,452,0.0,80.0,80.0,7,3290,0.0,1448.0,972.0
0.01,6,10,1989,5,910,2.0,642.0,642.0,5,1079,2.0,811.0,811.0
0.094,6,10,1506,5,395,18.0,127.0,127.0,5,1111,22.0,843.0,843.0
0.006,17,2,144,1,64,0.0,36.0,36.0,1,80,0.0,52.0,52.0
0.004,6,10,1989,5,927,1.0,659.0,659.0,5,1062,1.0,794.0,794.0
82.778,6,22,8496,12,2236,72.0,1345.0,574.0,10,6260,9178.0,1776.0,974.0
0.004,6,10,1702,5,863,1.0,595.0,595.0,5,839,0.0,571.0,571.0
0.147,17,4,352,2,130,107.0,37.0,37.0,2,222,143.0,89.0,83.0
0.011,6,10,1989,5,910,2.0,642.0,642.0,5,1079,2.0,811.0,811.0
11.622,17,28,4398,14,2312,879.0,587.0,137.0,14,2086,881.0,269.0,121.0
0.058,6,10,1506,5,395,12.0,127.0,127.0,5,1111,13.0,843.0,843.0
0.005,6,10,2007,5,928,1.0,660.0,660.0,5,1079,1.0,811.0,811.0
0.012,6,10,1972,5,910,3.0,642.0,642.0,5,1062,3.0,794.0,794.0
0.008,17,2,148,1,60,0.0,32.0,32.0,1,88,0.0,60.0,60.0
0.021,6,10,1677,5,827,5.0,559.0,559.0,5,850,5.0,582.0,582.0
0.005,6,10,2006,5,927,1.0,659.0,659.0,5,1079,1.0,811.0,811.0
0.004,17,2,136,1,60,0.0,32.0,32.0,1,76,0.0,48.0,48.0
0.006,6,10,2007,5,928,1.0,660.0,660.0,5,1079,1.0,811.0,811.0
0.006,17,2,180,1,66,0.0,38.0,38.0,1,114,0.0,86.0,86.0
0.006,6,10,1547,5,764,1.0,496.0,496.0,5,783,1.0,515.0,515.0
0.013,6,10,1990,5,911,3.0,643.0,643.0,5,1079,3.0,811.0,811.0
0.01,6,10,1989,5,927,2.0,659.0,659.0,5,1062,2.0,794.0,794.0
0.004,6,10,1779,5,928,1.0,660.0,660.0,5,851,1.0,583.0,583.0
40.061,17,10,676,5,460,10013.0,104.0,64.0,5,216,10014.0,20.0,15.0
0.004,6,10,1702,5,863,1.0,595.0,595.0,5,839,0.0,571.0,571.0
0.008,6,10,1762,5,911,2.0,643.0,643.0,5,851,2.0,583.0,583.0
0.005,6,10,1989,5,927,1.0,659.0,659.0,5,1062,1.0,794.0,794.0
0.006,6,10,2006,5,927,1.0,659.0,659.0,5,1079,1.0,811.0,811.0
0.017,6,10,1972,5,910,4.0,642.0,642.0,5,1062,4.0,794.0,794.0
0.078,6,10,1506,5,395,16.0,127.0,127.0,5,1111,16.0,843.0,843.0
172.515,17,80,11084,40,2658,4423.0,44.0,38.0,40,8426,4423.0,249.0,182.0
0.005,6,13,3747,7,509,0.0,137.0,137.0,6,3238,0.0,1470.0,1459.0
0.015,6,10,1989,5,910,3.0,642.0,642.0,5,1079,3.0,811.0,811.0
0.039,17,2,186,1,61,0.0,33.0,33.0,1,125,0.0,97.0,97.0
240.013,6,9,787,5,488,60003.0,232.0,232.0,4,299,80003.0,83.0,83.0
40.055,17,10,676,5,460,10012.0,104.0,64.0,5,216,10012.0,20.0,15.0
0.005,6,10,2006,5,927,1.0,659.0,659.0,5,1079,1.0,811.0,811.0
0.001,17,2,136,1,60,0.0,32.0,32.0,1,76,0.0,48.0,48.0
1.156,6,31,13351,17,5852,72.0,2720.0,854.0,14,7499,75.0,2720.0,769.0
0.017,6,10,1972,5,910,4.0,642.0,642.0,5,1062,4.0,794.0,794.0
0.004,6,10,2007,5,928,1.0,660.0,660.0,5,1079,1.0,811.0,811.0
0.003,17,2,136,1,60,0.0,32.0,32.0,1,76,0.0,48.0,48.0
0.008,6,10,1762,5,911,2.0,643.0,643.0,5,851,2.0,583.0,583.0
0.003,17,4,284,2,120,0.0,32.0,32.0,2,164,0.0,60.0,54.0
0.005,6,10,2007,5,928,1.0,660.0,660.0,5,1079,1.0,811.0,811.0
0.004,6,10,2006,5,927,1.0,659.0,659.0,5,1079,1.0,811.0,811.0
173.033,6,21,8145,11,1985,86.0,1174.0,504.0,10,6160,19207.0,2720.0,958.0
0.013,6,10,1972,5,910,3.0,642.0,642.0,5,1062,3.0,794.0,794.0
1792.689,6,485,98733,244,87503,7376.0,421.0,368.0,241,11230,7469.0,53.0,53.0
300.998,6,49,17383,26,11436,12039.0,2720.0,1036.0,23,5947,402.0,1360.0,358.0
0.017,6,10,1972,5,910,4.0,642.0,642.0,5,1062,4.0,794.0,794.0
0.006,6,14,3742,8,504,0.0,80.0,80.0,6,3238,1.0,1470.0,1459.0
0.008,6,10,1989,5,910,1.0,642.0,642.0,5,1079,1.0,811.0,811.0
0.113,6,10,1506,5,395,26.0,127.0,127.0,5,1111,26.0,843.0,843.0
0.004,6,10,2006,5,927,1.0,659.0,659.0,5,1079,1.0,811.0,811.0
0.006,6,10,1547,5,764,1.0,496.0,496.0,5,783,1.0,515.0,515.0
0.013,6,13,3735,7,497,2.0,125.0,125.0,6,3238,2.0,1470.0,1459.0
0.006,6,10,1547,5,764,1.0,496.0,496.0,5,783,1.0,515.0,515.0
0.111,6,10,1506,5,395,23.0,127.0,127.0,5,1111,25.0,843.0,843.0
0.005,6,10,1779,5,928,1.0,660.0,660.0,5,851,1.0,583.0,583.0
40.063,17,10,676,5,460,10012.0,104.0,64.0,5,216,10014.0,20.0,15.0
15.074,17,15,9239,8,6902,2149.0,1350.0,834.0,7,2337,2507.0,1350.0,305.0
0.011,6,10,1631,5,848,2.0,580.0,580.0,5,783,2.0,515.0,515.0
0.006,6,13,3690,7,452,1.0,80.0,80.0,6,3238,1.0,1470.0,1459.0
72.206,6,25,5160,14,1186,5554.0,180.0,75.0,11,3974,7220.0,1593.0,678.0
0.006,6,10,1689,5,839,1.0,571.0,571.0,5,850,1.0,582.0,582.0
0.019,6,10,1989,5,910,4.0,642.0,642.0,5,1079,4.0,811.0,811.0
0.211,6,16,2778,8,1396,30.0,533.0,324.0,8,1382,18.0,529.0,239.0
0.014,6,10,1990,5,911,3.0,643.0,643.0,5,1079,3.0,811.0,811.0
0.012,6,10,1989,5,910,3.0,642.0,642.0,5,1079,2.0,811.0,811.0
15.071,17,15,9239,8,6902,2149.0,1350.0,834.0,7,2337,2506.0,1350.0,305.0
0.088,6,10,1506,5,395,20.0,127.0,127.0,5,1111,21.0,843.0,843.0
0.005,6,10,2000,5,927,1.0,659.0,659.0,5,1073,1.0,805.0,805.0
0.089,6,10,1506,5,395,18.0,127.0,127.0,5,1111,20.0,843.0,843.0
0.001,17,2,136,1,60,0.0,32.0,32.0,1,76,0.0,48.0,48.0
0.142,6,10,1506,5,395,32.0,127.0,127.0,5,1111,26.0,843.0,843.0
0.014,6,10,1972,5,910,3.0,642.0,642.0,5,1062,3.0,794.0,794.0
40.056,17,10,676,5,460,10012.0,104.0,64.0,5,216,10012.0,20.0,15.0
0.013,6,10,1983,5,910,3.0,642.0,642.0,5,1073,3.0,805.0,805.0
0.007,6,10,1547,5,764,1.0,496.0,496.0,5,783,1.0,515.0,515.0
0.06,17,2,80,1,32,0.0,4.0,4.0,1,48,0.0,20.0,20.0
0.004,6,10,1989,5,927,1.0,659.0,659.0,5,1062,1.0,794.0,794.0
0.01,6,10,1990,5,911,2.0,643.0,643.0,5,1079,2.0,811.0,811.0
0.005,6,10,1774,5,923,1.0,655.0,655.0,5,851,1.0,583.0,583.0
0.004,6,10,1779,5,928,1.0,660.0,660.0,5,851,1.0,583.0,583.0
0.005,6,14,3799,7,509,0.0,137.0,137.0,7,3290,0.0,1448.0,972.0
308.754,17,20,1124,10,716,34291.0,48.0,43.0,10,408,34291.0,20.0,12.0
1778.489,17,144,45504,72,22752,25049.0,288.0,288.0,72,22752,25049.0,288.0,288.0
0.004,6,10,2006,5,927,1.0,659.0,659.0,5,1079,1.0,811.0,811.0
0.164,6,10,1506,5,395,37.0,127.0,127.0,5,1111,38.0,843.0,843.0
0.003,17,2,148,1,60,0.0,32.0,32.0,1,88,0.0,60.0,60.0
0.006,6,10,1547,5,764,1.0,496.0,496.0,5,783,1.0,515.0,515.0
0.015,6,10,1972,5,910,3.0,642.0,642.0,5,1062,3.0,794.0,794.0
40.062,17,10,676,5,460,10012.0,104.0,64.0,5,216,10014.0,20.0,15.0
0.009,6,10,1631,5,848,2.0,580.0,580.0,5,783,2.0,515.0,515.0
0.006,6,10,1547,5,764,1.0,496.0,496.0,5,783,1.0,515.0,515.0
0.012,6,10,1983,5,910,3.0,642.0,642.0,5,1073,3.0,805.0,805.0
29.953,6,10,1206,6,505,5990.0,185.0,185.0,4,701,9967.0,485.0,485.0
0.004,6,10,2007,5,928,1.0,660.0,660.0,5,1079,1.0,811.0,811.0
0.018,6,10,1972,5,910,4.0,642.0,642.0,5,1062,4.0,794.0,794.0
0.217,17,4,596,2,122,175.0,33.0,33.0,2,474,145.0,323.0,209.0
0.005,6,10,2000,5,927,1.0,659.0,659.0,5,1073,1.0,805.0,805.0
330.945,17,20,1124,10,716,36757.0,48.0,43.0,10,408,36757.0,20.0,12.0
0.005,6,10,2006,5,927,1.0,659.0,659.0,5,1079,1.0,811.0,811.0
0.011,6,13,3735,7,497,1.0,125.0,125.0,6,3238,2.0,1470.0,1459.0
10.884,17,28,4424,14,1995,827.0,270.0,114.0,14,2429,828.0,588.0,145.0
0.004,6,10,2007,5,928,1.0,660.0,660.0,5,1079,1.0,811.0,811.0
0.026,6,10,1983,5,910,6.0,642.0,642.0,5,1073,6.0,805.0,805.0
0.007,17,2,212,1,74,0.0,46.0,46.0,1,138,0.0,110.0,110.0
0.013,6,13,3735,7,497,2.0,125.0,125.0,6,3238,2.0,1470.0,1459.0
0.005,17,2,170,1,65,0.0,37.0,37.0,1,105,0.0,77.0,77.0
0.011,6,10,1677,5,827,2.0,559.0,559.0,5,850,2.0,582.0,582.0
322.777,17,20,1124,10,716,35849.0,48.0,43.0,10,408,35850.0,20.0,12.0
240.013,6,9,787,5,488,60003.0,232.0,232.0,4,299,80003.0,83.0,83.0
0.02,6,10,1983,5,910,5.0,642.0,642.0,5,1073,5.0,805.0,805.0
0.01,6,10,1989,5,910,2.0,642.0,642.0,5,1079,2.0,811.0,811.0
0.006,6,10,1547,5,764,1.0,496.0,496.0,5,783,1.0,515.0,515.0
40.057,17,10,676,5,460,10013.0,104.0,64.0,5,216,10013.0,20.0,15.0
0.016,6,10,1990,5,911,4.0,643.0,643.0,5,1079,3.0,811.0,811.0
0.005,6,10,1989,5,927,1.0,659.0,659.0,5,1062,1.0,794.0,794.0
276.014,6,39,10125,16,6778,18400.0,1850.0,661.0,23,3347,12546.0,580.0,153.0
0.131,6,10,1506,5,395,30.0,127.0,127.0,5,1111,31.0,843.0,843.0
0.02,6,10,1631,5,848,4.0,580.0,580.0,5,783,5.0,515.0,515.0
0.006,6,10,1643,5,860,1.0,592.0,592.0,5,783,1.0,515.0,515.0
0.013,6,10,1989,5,910,3.0,642.0,642.0,5,1079,3.0,811.0,811.0
0.071,17,8,3613,4,1874,23.0,1350.0,440.0,4,1739,12.0,1350.0,406.0
0.1,6,10,1506,5,395,23.0,127.0,127.0,5,1111,18.0,843.0,843.0
0.005,6,10,2006,5,927,1.0,659.0,659.0,5,1079,1.0,811.0,811.0
0.156,6,10,1506,5,395,35.0,127.0,127.0,5,1111,35.0,843.0,843.0
0.006,6,10,1547,5,764,1.0,496.0,496.0,5,783,1.0,515.0,515.0
0.012,6,10,1989,5,910,3.0,642.0,642.0,5,1079,2.0,811.0,811.0
0.004,6,10,1989,5,927,1.0,659.0,659.0,5,1062,1.0,794.0,794.0
0.005,6,10,1643,5,860,1.0,592.0,592.0,5,783,1.0,515.0,515.0
367.319,6,22,2313,16,867,24487.0,195.0,195.0,6,1446,4634.0,419.0,398.0
1769.702,6,81,4266,41,2159,44241.0,27.0,27.0,40,2107,45375.0,27.0,27.0
0.081,6,10,1506,5,395,16.0,127.0,127.0,5,1111,19.0,843.0,843.0
0.006,6,10,1989,5,927,1.0,659.0,659.0,5,1062,1.0,794.0,794.0
0.005,6,10,1643,5,860,1.0,592.0,592.0,5,783,1.0,515.0,515.0
0.01,6,10,1762,5,911,2.0,643.0,643.0,5,851,2.0,583.0,583.0
0.009,6,10,1983,5,910,2.0,642.0,642.0,5,1073,2.0,805.0,805.0
0.013,6,10,1989,5,910,3.0,642.0,642.0,5,1079,3.0,811.0,811.0
0.04,17,2,184,1,61,0.0,33.0,33.0,1,123,0.0,95.0,95.0
0.085,6,10,1506,5,395,18.0,127.0,127.0,5,1111,17.0,843.0,843.0
40.069,17,10,676,5,460,10015.0,104.0,64.0,5,216,10016.0,20.0,15.0
0.121,6,10,1506,5,395,29.0,127.0,127.0,5,1111,28.0,843.0,843.0
0.096,6,10,1506,5,395,22.0,127.0,127.0,5,1111,23.0,843.0,843.0
40.057,17,10,676,5,460,10013.0,104.0,64.0,5,216,10013.0,20.0,15.0
0.005,6,10,1643,5,860,1.0,592.0,592.0,5,783,1.0,515.0,515.0
0.073,17,4,284,2,120,0.0,32.0,32.0,2,164,0.0,60.0,54.0
5.094,58,2,128,1,64,0.0,16.0,16.0,1,64,0.0,16.0,16.0
0.005,6,10,1854,5,889,1.0,621.0,621.0,5,965,1.0,697.0,697.0
10.809,17,28,4419,14,1995,822.0,270.0,114.0,14,2424,822.0,587.0,145.0
0.069,6,10,1506,5,395,14.0,127.0,127.0,5,1111,14.0,843.0,843.0
0.004,6,10,1702,5,863,1.0,595.0,595.0,5,839,1.0,571.0,571.0
0.08,6,10,1506,5,395,17.0,127.0,127.0,5,1111,18.0,843.0,843.0
0.006,6,10,1643,5,860,1.0,592.0,592.0,5,783,1.0,515.0,515.0
0.009,6,10,1983,5,910,2.0,642.0,642.0,5,1073,2.0,805.0,805.0
300.327,6,16,2170,9,684,37520.0,146.0,146.0,7,1486,50026.0,419.0,398.0
0.005,6,10,1643,5,860,1.0,592.0,592.0,5,783,1.0,515.0,515.0
0.013,6,10,1990,5,911,3.0,643.0,643.0,5,1079,3.0,811.0,811.0
0.005,6,10,1779,5,928,1.0,660.0,660.0,5,851,1.0,583.0,583.0
0.02,6,10,1990,5,911,5.0,643.0,643.0,5,1079,5.0,811.0,811.0
11.129,17,28,4424,14,1995,847.0,270.0,114.0,14,2429,847.0,588.0,145.0
0.078,17,2,396,1,61,0.0,33.0,33.0,1,335,0.0,307.0,307.0
0.001,17,2,154,1,69,0.0,41.0,41.0,1,85,0.0,57.0,57.0
0.005,6,10,2000,5,927,1.0,659.0,659.0,5,1073,1.0,805.0,805.0
0.004,6,10,2006,5,927,1.0,659.0,659.0,5,1079,1.0,811.0,811.0
0.006,17,2,136,1,60,0.0,32.0,32.0,1,76,0.0,48.0,48.0
0.009,6,10,1989,5,910,2.0,642.0,642.0,5,1079,2.0,811.0,811.0
0.006,17,2,234,1,61,0.0,33.0,33.0,1,173,0.0,145.0,145.0
0.004,17,2,148,1,60,0.0,32.0,32.0,1,88,0.0,60.0,60.0
0.006,6,10,1547,5,764,1.0,496.0,496.0,5,783,1.0,515.0,515.0
0.005,6,10,2007,5,928,1.0,660.0,660.0,5,1079,1.0,811.0,811.0
0.011,6,10,1989,5,910,2.0,642.0,642.0,5,1079,2.0,811.0,811.0
0.005,17,2,180,1,66,0.0,38.0,38.0,1,114,0.0,86.0,86.0
0.011,6,10,1990,5,911,2.0,643.0,643.0,5,1079,2.0,811.0,811.0
0.017,6,10,1990,5,911,4.0,643.0,643.0,5,1079,4.0,811.0,811.0
0.004,6,10,2007,5,928,1.0,660.0,660.0,5,1079,1.0,811.0,811.0
0.012,6,10,1972,5,910,2.0,642.0,642.0,5,1062,3.0,794.0,794.0
0.009,6,10,1989,5,910,2.0,642.0,642.0,5,1079,2.0,811.0,811.0
0.004,6,10,2006,5,927,1.0,659.0,659.0,5,1079,1.0,811.0,811.0
0.003,17,2,148,1,60,0.0,32.0,32.0,1,88,0.0,60.0,60.0
0.012,6,13,3735,7,497,1.0,125.0,125.0,6,3238,2.0,1470.0,1459.0
0.065,17,8,3613,4,1874,21.0,1350.0,440.0,4,1739,10.0,1350.0,406.0
240.191,6,29,13930,14,8716,18476.0,2736.0,1330.0,15,5214,17156.0,1656.0,885.0
300.442,6,29,8844,14,2477,23110.0,1225.0,348.0,15,6367,21459.0,1591.0,621.0
0.114,6,10,1506,5,395,26.0,127.0,127.0,5,1111,25.0,843.0,843.0
0.009,6,10,1989,5,910,2.0,642.0,642.0,5,1079,2.0,811.0,811.0
0.148,6,10,1506,5,395,17.0,127.0,127.0,5,1111,34.0,843.0,843.0
0.007,6,10,1547,5,764,1.0,496.0,496.0,5,783,1.0,515.0,515.0
0.009,6,10,1989,5,910,2.0,642.0,642.0,5,1079,2.0,811.0,811.0
0.005,6,10,1989,5,927,1.0,659.0,659.0,5,1062,1.0,794.0,794.0
0.007,6,10,1547,5,764,1.0,496.0,496.0,5,783,1.0,515.0,515.0
0.006,17,2,225,1,65,0.0,37.0,37.0,1,160,0.0,132.0,132.0
0.008,6,10,1989,5,910,1.0,642.0,642.0,5,1079,2.0,811.0,811.0
0.018,6,10,1631,5,848,4.0,580.0,580.0,5,783,4.0,515.0,515.0
0.006,6,10,1689,5,839,1.0,571.0,571.0,5,850,1.0,582.0,582.0
0.187,17,4,352,2,130,150.0,37.0,37.0,2,222,147.0,89.0,83.0
0.005,17,2,213,1,69,0.0,41.0,41.0,1,144,0.0,116.0,116.0
0.005,6,10,1774,5,923,1.0,655.0,655.0,5,851,1.0,583.0,583.0
289.656,6,386,347091,190,21439,1532.0,2736.0,888.0,196,325652,1485.0,2804.0,1733.0
40.058,17,10,676,5,460,10012.0,104.0,64.0,5,216,10013.0,20.0,15.0
0.105,6,10,1506,5,395,20.0,127.0,127.0,5,1111,25.0,843.0,843.0
0.016,6,10,1631,5,848,3.0,580.0,580.0,5,783,3.0,515.0,515.0
0.005,17,2,170,1,65,0.0,37.0,37.0,1,105,0.0,77.0,77.0
300.346,6,16,2170,9,684,37523.0,146.0,146.0,7,1486,50030.0,419.0,398.0
0.121,6,10,1506,5,395,27.0,127.0,127.0,5,1111,28.0,843.0,843.0
0.038,17,4,284,2,120,0.0,32.0,32.0,2,164,35.0,60.0,54.0
0.001,17,2,180,1,66,0.0,38.0,38.0,1,114,0.0,86.0,86.0
0.005,6,10,2000,5,927,1.0,659.0,659.0,5,1073,1.0,805.0,805.0
0.005,17,2,180,1,58,0.0,30.0,30.0,1,122,0.0,94.0,94.0
0.304,6,10,1242,5,751,76.0,495.0,495.0,5,491,73.0,223.0,223.0
0.004,17,2,203,1,61,0.0,33.0,33.0,1,142,0.0,114.0,114.0
0.008,6,10,1989,5,910,1.0,642.0,642.0,5,1079,1.0,811.0,811.0
0.007,6,10,1547,5,764,1.0,496.0,496.0,5,783,1.0,515.0,515.0
0.099,6,10,1506,5,395,22.0,127.0,127.0,5,1111,20.0,843.0,843.0
0.014,6,10,1989,5,910,3.0,642.0,642.0,5,1079,3.0,811.0,811.0
0.082,6,10,1506,5,395,18.0,127.0,127.0,5,1111,16.0,843.0,843.0
0.005,6,10,1547,5,764,1.0,496.0,496.0,5,783,1.0,515.0,515.0
0.005,6,10,1779,5,928,1.0,660.0,660.0,5,851,1.0,583.0,583.0
0.005,6,10,1989,5,927,1.0,659.0,659.0,5,1062,1.0,794.0,794.0
0.005,6,10,1547,5,764,1.0,496.0,496.0,5,783,1.0,515.0,515.0
0.007,6,10,2000,5,927,1.0,659.0,659.0,5,1073,1.0,805.0,805.0
0.024,6,10,1972,5,910,5.0,642.0,642.0,5,1062,6.0,794.0,794.0
167.039,17,68,9652,34,2267,5061.0,44.0,38.0,34,7385,5061.0,252.0,189.0
0.001,17,2,180,1,65,0.0,37.0,37.0,1,115,0.0,87.0,87.0
0.005,6,10,1989,5,927,1.0,659.0,659.0,5,1062,1.0,794.0,794.0
0.081,6,10,1506,5,395,19.0,127.0,127.0,5,1111,16.0,843.0,843.0
40.065,17,10,676,5,460,10015.0,104.0,64.0,5,216,10015.0,20.0,15.0
0.016,17,2,198,1,91,0.0,63.0,63.0,1,107,0.0,79.0,79.0
0.001,17,2,180,1,66,0.0,38.0,38.0,1,114,0.0,86.0,86.0
0.228,6,16,2777,8,1395,32.0,533.0,323.0,8,1382,21.0,529.0,239.0
0.004,6,10,2007,5,928,1.0,660.0,660.0,5,1079,1.0,811.0,811.0
0.146,6,10,1506,5,395,30.0,127.0,127.0,5,1111,34.0,843.0,843.0
0.005,6,10,1774,5,923,1.0,655.0,655.0,5,851,1.0,583.0,583.0
0.037,17,2,170,1,65,0.0,37.0,37.0,1,105,0.0,77.0,77.0
240.116,6,32,9490,16,6945,16007.0,2017.0,679.0,16,2545,16007.0,580.0,213.0
0.015,6,10,1989,5,910,3.0,642.0,642.0,5,1079,3.0,811.0,811.0
295.287,6,320,344045,122,17892,2440.0,2736.0,888.0,198,326153,1498.0,2804.0,1716.0
240.167,6,45,7127,22,3221,11436.0,588.0,229.0,23,3906,10916.0,580.0,245.0
0.009,6,10,1972,5,910,2.0,642.0,642.0,5,1062,2.0,794.0,794.0
273.717,6,85,41379,35,5594,8050.0,944.0,314.0,50,35785,5585.0,2804.0,873.0
0.208,17,4,352,2,130,76.0,37.0,37.0,2,222,136.0,89.0,83.0
0.006,6,10,1547,5,764,1.0,496.0,496.0,5,783,1.0,515.0,515.0
10.864,17,28,4422,14,1995,826.0,270.0,114.0,14,2427,826.0,586.0,145.0
0.011,6,10,1677,5,827,2.0,559.0,559.0,5,850,2.0,582.0,582.0
0.009,6,10,1677,5,827,2.0,559.0,559.0,5,850,2.0,582.0,582.0
0.004,17,2,136,1,60,0.0,32.0,32.0,1,76,0.0,48.0,48.0
0.004,6,10,2000,5,927,1.0,659.0,659.0,5,1073,1.0,805.0,805.0
0.004,6,10,2006,5,927,1.0,659.0,659.0,5,1079,1.0,811.0,811.0
0.105,6,10,1506,5,395,23.0,127.0,127.0,5,1111,25.0,843.0,843.0
0.078,6,10,1506,5,395,13.0,127.0,127.0,5,1111,18.0,843.0,843.0
0.001,17,2,180,1,66,0.0,38.0,38.0,1,114,0.0,86.0,86.0
0.007,17,2,194,1,59,0.0,31.0,31.0,1,135,0.0,107.0,107.0
1786.144,6,150,19350,90,13740,20069.0,302.0,302.0,60,5610,30273.0,83.0,83.0
0.108,6,10,1506,5,395,23.0,127.0,127.0,5,1111,23.0,843.0,843.0
0.041,17,2,170,1,65,0.0,37.0,37.0,1,105,0.0,77.0,77.0
0.077,6,10,1506,5,395,16.0,127.0,127.0,5,1111,16.0,843.0,843.0
0.005,6,10,1989,5,927,1.0,659.0,659.0,5,1062,1.0,794.0,794.0
0.012,6,10,1989,5,910,2.0,642.0,642.0,5,1079,2.0,811.0,811.0
0.004,17,2,136,1,60,0.0,32.0,32.0,1,76,0.0,48.0,48.0
0.014,6,10,1972,5,910,3.0,642.0,642.0,5,1062,3.0,794.0,794.0
1772.718,17,120,11460,60,5460,30045.0,63.0,63.0,60,6000,30045.0,72.0,72.0
0.006,6,10,1643,5,860,1.0,592.0,592.0,5,783,1.0,515.0,515.0
0.015,6,10,1631,5,848,3.0,580.0,580.0,5,783,3.0,515.0,515.0
0.006,6,13,3747,7,509,1.0,137.0,137.0,6,3238,1.0,1470.0,1459.0
240.071,6,21,4924,11,941,24007.0,180.0,93.0,10,3983,26674.0,1591.0,575.0
0.008,6,10,1762,5,911,1.0,643.0,643.0,5,851,1.0,583.0,583.0
0.005,6,10,2006,5,927,1.0,659.0,659.0,5,1079,1.0,811.0,811.0
0.04,17,2,152,1,76,0.0,48.0,48.0,1,76,0.0,48.0,48.0
0.005,17,2,154,1,69,0.0,41.0,41.0,1,85,0.0,57.0,57.0
0.005,6,10,2000,5,927,1.0,659.0,659.0,5,1073,1.0,805.0,805.0
0.004,17,2,148,1,60,0.0,32.0,32.0,1,88,0.0,60.0,60.0
0.004,6,10,1989,5,927,1.0,659.0,659.0,5,1062,1.0,794.0,794.0
0.004,6,10,2006,5,927,1.0,659.0,659.0,5,1079,1.0,811.0,811.0
0.112,6,10,1506,5,395,27.0,127.0,127.0,5,1111,25.0,843.0,843.0
0.005,6,10,1989,5,927,1.0,659.0,659.0,5,1062,1.0,794.0,794.0
0.007,6,13,3684,7,446,1.0,74.0,74.0,6,3238,1.0,1470.0,1459.0
0.005,6,10,2007,5,928,1.0,660.0,660.0,5,1079,1.0,811.0,811.0
0.012,6,10,1989,5,910,3.0,642.0,642.0,5,1079,3.0,811.0,811.0
0.009,6,10,1989,5,910,2.0,642.0,642.0,5,1079,2.0,811.0,811.0
0.004,6,10,1989,5,927,1.0,659.0,659.0,5,1062,1.0,794.0,794.0
60.174,6,82,77770,37,4708,1671.0,1402.0,694.0,45,73062,1366.0,2804.0,1724.0
0.004,6,10,1774,5,923,1.0,655.0,655.0,5,851,1.0,583.0,583.0
0.004,17,2,136,1,60,0.0,32.0,32.0,1,76,0.0,48.0,48.0
0.008,6,10,1989,5,910,2.0,642.0,642.0,5,1079,2.0,811.0,811.0
0.01,17,2,136,1,60,0.0,32.0,32.0,1,76,0.0,48.0,48.0
0.006,6,10,1643,5,860,1.0,592.0,592.0,5,783,1.0,515.0,515.0
0.003,17,2,136,1,60,0.0,32.0,32.0,1,76,0.0,48.0,48.0
0.001,17,2,180,1,66,0.0,38.0,38.0,1,114,0.0,86.0,86.0
40.108,17,10,676,5,460,10025.0,104.0,64.0,5,216,10026.0,20.0,15.0
0.005,6,10,2006,5,927,1.0,659.0,659.0,5,1079,1.0,811.0,811.0
0.005,6,10,2007,5,928,1.0,660.0,660.0,5,1079,1.0,811.0,811.0
0.02,6,10,1990,5,911,5.0,643.0,643.0,5,1079,5.0,811.0,811.0
0.004,6,10,2006,5,927,1.0,659.0,659.0,5,1079,1.0,811.0,811.0
0.008,6,10,1990,5,911,1.0,643.0,643.0,5,1079,1.0,811.0,811.0
0.077,6,10,1506,5,395,17.0,127.0,127.0,5,1111,17.0,843.0,843.0
40.068,17,10,676,5,460,10016.0,104.0,64.0,5,216,10016.0,20.0,15.0
0.004,17,4,420,2,122,0.0,33.0,33.0,2,298,0.0,145.0,121.0
0.001,17,2,180,1,66,0.0,38.0,38.0,1,114,0.0,86.0,86.0
0.005,6,13,3690,7,452,0.0,80.0,80.0,6,3238,0.0,1470.0,1459.0
0.006,6,10,1547,5,764,1.0,496.0,496.0,5,783,1.0,515.0,515.0
0.01,6,10,1989,5,910,2.0,642.0,642.0,5,1079,2.0,811.0,811.0
0.005,6,10,2007,5,928,1.0,660.0,660.0,5,1079,1.0,811.0,811.0
0.008,6,10,1990,5,911,2.0,643.0,643.0,5,1079,1.0,811.0,811.0
0.005,6,10,2006,5,927,1.0,659.0,659.0,5,1079,1.0,811.0,811.0
0.005,17,2,164,1,74,0.0,46.0,46.0,1,90,0.0,62.0,62.0
0.004,6,10,2006,5,927,1.0,659.0,659.0,5,1079,1.0,811.0,811.0
0.011,6,10,1983,5,910,2.0,642.0,642.0,5,1073,2.0,805.0,805.0
0.023,6,10,1990,5,911,5.0,643.0,643.0,5,1079,5.0,811.0,811.0
328.183,17,20,1124,10,716,36451.0,48.0,43.0,10,408,36451.0,20.0,12.0
0.004,6,5,310,3,175,2.0,31.0,31.0,2,135,0.0,31.0,31.0
0.007,6,10,1972,5,910,1.0,642.0,642.0,5,1062,1.0,794.0,794.0
0.015,6,10,1990,5,911,3.0,643.0,643.0,5,1079,3.0,811.0,811.0
61.534,6,27,19944,15,11990,4395.0,2804.0,1602.0,12,7954,5582.0,2325.0,1220.0
0.075,6,10,1506,5,395,16.0,127.0,127.0,5,1111,17.0,843.0,843.0
0.016,6,10,1762,5,911,3.0,643.0,643.0,5,851,4.0,583.0,583.0
40.056,17,10,676,5,460,10013.0,104.0,64.0,5,216,10013.0,20.0,15.0
0.008,6,12,1926,6,1189,1.0,659.0,434.0,6,737,1.0,417.0,417.0
0.059,6,13,3735,7,497,9.0,125.0,125.0,6,3238,11.0,1470.0,1459.0
0.086,6,10,1506,5,395,19.0,127.0,127.0,5,1111,16.0,843.0,843.0
0.014,6,10,1983,5,910,3.0,642.0,642.0,5,1073,3.0,805.0,805.0
0.12,6,10,1506,5,395,28.0,127.0,127.0,5,1111,29.0,843.0,843.0
0.005,6,10,1779,5,928,1.0,660.0,660.0,5,851,1.0,583.0,583.0
0.012,6,10,1989,5,910,3.0,642.0,642.0,5,1079,2.0,811.0,811.0
0.009,6,10,1989,5,910,2.0,642.0,642.0,5,1079,2.0,811.0,811.0
0.005,6,10,1989,5,927,1.0,659.0,659.0,5,1062,1.0,794.0,794.0
240.272,6,42,8719,21,5686,12013.0,1515.0,509.0,21,3033,12013.0,580.0,241.0
0.006,6,10,1547,5,764,1.0,496.0,496.0,5,783,1.0,515.0,515.0
40.06,17,10,676,5,460,10014.0,104.0,64.0,5,216,10014.0,20.0,15.0
0.077,6,10,1506,5,395,17.0,127.0,127.0,5,1111,17.0,843.0,843.0
0.001,17,2,180,1,66,0.0,38.0,38.0,1,114,0.0,86.0,86.0
0.001,17,2,180,1,66,0.0,38.0,38.0,1,114,0.0,86.0,86.0
0.005,17,2,170,1,65,0.0,37.0,37.0,1,105,0.0,77.0,77.0
0.558,6,22,7185,11,1635,55.0,748.0,263.0,11,5550,55.0,2333.0,994.0
0.084,6,10,1506,5,395,19.0,127.0,127.0,5,1111,19.0,843.0,843.0
0.016,6,10,1990,5,911,4.0,643.0,643.0,5,1079,3.0,811.0,811.0
0.001,17,2,180,1,66,0.0,38.0,38.0,1,114,0.0,86.0,86.0
0.005,6,10,2000,5,927,1.0,659.0,659.0,5,1073,1.0,805.0,805.0
369.487,6,22,2313,16,867,24632.0,195.0,195.0,6,1446,4671.0,419.0,398.0
0.007,6,10,1989,5,910,1.0,642.0,642.0,5,1079,1.0,811.0,811.0
0.075,6,10,1506,5,395,16.0,127.0,127.0,5,1111,16.0,843.0,843.0
0.005,17,2,170,1,65,0.0,37.0,37.0,1,105,0.0,77.0,77.0
1791.543,6,486,99194,244,87924,7371.0,421.0,368.0,242,11270,7433.0,53.0,53.0
0.005,6,10,1989,5,927,1.0,659.0,659.0,5,1062,1.0,794.0,794.0
0.011,6,13,3735,7,497,1.0,125.0,125.0,6,3238,2.0,1470.0,1459.0
0.005,6,10,1547,5,764,1.0,496.0,496.0,5,783,1.0,515.0,515.0
0.011,6,10,1972,5,910,2.0,642.0,642.0,5,1062,2.0,794.0,794.0
0.163,6,10,1506,5,395,38.0,127.0,127.0,5,1111,36.0,843.0,843.0
0.013,17,2,152,1,56,0.0,28.0,28.0,1,96,0.0,68.0,68.0
0.008,6,10,1989,5,910,1.0,642.0,642.0,5,1079,1.0,811.0,811.0
1787.586,6,150,19350,90,13740,20085.0,302.0,302.0,60,5610,30297.0,83.0,83.0
0.006,17,2,214,1,75,0.0,47.0,47.0,1,139,0.0,111.0,111.0
0.004,17,2,136,1,60,0.0,32.0,32.0,1,76,0.0,48.0,48.0
0.012,17,2,136,1,60,0.0,32.0,32.0,1,76,0.0,48.0,48.0
0.005,6,10,2007,5,928,1.0,660.0,660.0,5,1079,1.0,811.0,811.0
0.213,6,10,1506,5,395,50.0,127.0,127.0,5,1111,43.0,843.0,843.0
0.004,6,10,2000,5,927,1.0,659.0,659.0,5,1073,1.0,805.0,805.0
0.076,6,10,1506,5,395,17.0,127.0,127.0,5,1111,16.0,843.0,843.0
0.009,6,10,1972,5,910,2.0,642.0,642.0,5,1062,2.0,794.0,794.0
0.108,6,10,1506,5,395,24.0,127.0,127.0,5,1111,26.0,843.0,843.0
0.004,6,10,2006,5,927,1.0,659.0,659.0,5,1079,1.0,811.0,811.0
0.106,6,10,1506,5,395,23.0,127.0,127.0,5,1111,24.0,843.0,843.0
0.068,6,10,1506,5,395,15.0,127.0,127.0,5,1111,15.0,843.0,843.0
0.099,6,10,1506,5,395,16.0,127.0,127.0,5,1111,24.0,843.0,843.0
240.092,6,32,9801,16,7227,16006.0,2299.0,711.0,16,2574,16005.0,580.0,216.0
0.092,6,10,1506,5,395,21.0,127.0,127.0,5,1111,21.0,843.0,843.0
0.017,6,10,1983,5,910,4.0,642.0,642.0,5,1073,4.0,805.0,805.0
0.014,6,10,1677,5,827,3.0,559.0,559.0,5,850,3.0,582.0,582.0
0.004,17,2,170,1,65,0.0,37.0,37.0,1,105,0.0,77.0,77.0
0.01,6,10,1989,5,910,2.0,642.0,642.0,5,1079,2.0,811.0,811.0
0.012,6,10,1989,5,910,3.0,642.0,642.0,5,1079,2.0,811.0,811.0
0.005,6,10,2000,5,927,1.0,659.0,659.0,5,1073,1.0,805.0,805.0
0.081,6,10,1506,5,395,17.0,127.0,127.0,5,1111,17.0,843.0,843.0
0.135,6,10,1506,5,395,28.0,127.0,127.0,5,1111,32.0,843.0,843.0
0.131,6,10,1506,5,395,31.0,127.0,127.0,5,1111,31.0,843.0,843.0
10.877,17,28,4394,14,1994,827.0,269.0,114.0,14,2400,827.0,587.0,143.0
0.005,17,2,304,1,77,0.0,49.0,49.0,1,227,0.0,199.0,199.0
0.017,6,10,1989,5,910,4.0,642.0,642.0,5,1079,4.0,811.0,811.0
0.004,17,2,152,1,76,0.0,48.0,48.0,1,76,0.0,48.0,48.0
0.025,6,10,1677,5,827,6.0,559.0,559.0,5,850,6.0,582.0,582.0
0.005,6,14,3742,7,452,0.0,80.0,80.0,7,3290,0.0,1448.0,972.0
0.007,6,10,1989,5,910,1.0,642.0,642.0,5,1079,1.0,811.0,811.0
0.005,17,2,170,1,65,0.0,37.0,37.0,1,105,0.0,77.0,77.0
0.005,6,10,1689,5,839,1.0,571.0,571.0,5,850,1.0,582.0,582.0
0.006,17,2,136,1,60,0.0,32.0,32.0,1,76,0.0,48.0,48.0
0.013,6,10,1989,5,910,3.0,642.0,642.0,5,1079,3.0,811.0,811.0
0.168,17,2,152,1,76,0.0,48.0,48.0,1,76,0.0,48.0,48.0
0.001,17,2,180,1,66,0.0,38.0,38.0,1,114,0.0,86.0,86.0
0.095,6,10,1506,5,395,21.0,127.0,127.0,5,1111,20.0,843.0,843.0
0.005,17,2,148,1,60,0.0,32.0,32.0,1,88,0.0,60.0,60.0
0.005,6,10,2006,5,927,1.0,659.0,659.0,5,1079,1.0,811.0,811.0
0.078,6,10,1506,5,395,17.0,127.0,127.0,5,1111,17.0,843.0,843.0
0.004,6,10,2007,5,928,1.0,660.0,660.0,5,1079,1.0,811.0,811.0
0.006,6,10,1989,5,910,1.0,642.0,642.0,5,1079,1.0,811.0,811.0
293.666,6,337,349695,129,22898,2294.0,2736.0,952.0,208,326797,1418.0,2804.0,1662.0
0.005,6,13,3747,7,509,0.0,137.0,137.0,6,3238,0.0,1470.0,1459.0
0.022,6,10,1989,5,910,5.0,642.0,642.0,5,1079,5.0,811.0,811.0
0.004,17,4,284,2,120,0.0,32.0,32.0,2,164,1.0,60.0,54.0
0.081,6,10,1506,5,395,19.0,127.0,127.0,5,1111,15.0,843.0,843.0
0.006,17,2,166,1,75,0.0,47.0,47.0,1,91,0.0,63.0,63.0
0.02,6,10,1983,5,910,5.0,642.0,642.0,5,1073,4.0,805.0,805.0
33.673,6,75,40499,34,33832,287.0,4080.0,1707.0,41,6667,837.0,2667.0,385.0
169.066,17,86,12347,43,2901,4025.0,44.0,39.0,43,9446,4025.0,252.0,191.0
0.005,6,10,1689,5,839,1.0,571.0,571.0,5,850,1.0,582.0,582.0
0.004,17,2,148,1,60,0.0,32.0,32.0,1,88,0.0,60.0,60.0
0.01,6,10,1990,5,911,2.0,643.0,643.0,5,1079,2.0,811.0,811.0
40.061,17,10,676,5,460,10014.0,104.0,64.0,5,216,10014.0,20.0,15.0
0.084,6,10,1506,5,395,16.0,127.0,127.0,5,1111,19.0,843.0,843.0
0.114,6,10,1506,5,395,24.0,127.0,127.0,5,1111,24.0,843.0,843.0
40.058,17,10,676,5,460,10013.0,104.0,64.0,5,216,10013.0,20.0,15.0
0.004,6,10,2000,5,927,1.0,659.0,659.0,5,1073,1.0,805.0,805.0
0.005,6,10,2000,5,927,1.0,659.0,659.0,5,1073,1.0,805.0,805.0
0.005,17,2,194,1,59,0.0,31.0,31.0,1,135,0.0,107.0,107.0
0.009,6,10,1762,5,911,2.0,643.0,643.0,5,851,2.0,583.0,583.0
0.013,6,13,3735,7,497,2.0,125.0,125.0,6,3238,2.0,1470.0,1459.0
0.013,6,11,2041,6,962,2.0,642.0,642.0,5,1079,3.0,811.0,811.0
0.129,17,2,80,1,32,0.0,4.0,4.0,1,48,0.0,20.0,20.0
1786.553,6,150,19350,90,13740,20073.0,302.0,302.0,60,5610,30280.0,83.0,83.0
0.013,6,10,1972,5,910,3.0,642.0,642.0,5,1062,3.0,794.0,794.0
0.041,17,4,284,2,120,0.0,32.0,32.0,2,164,1.0,60.0,54.0
0.007,17,2,162,1,65,0.0,37.0,37.0,1,97,0.0,69.0,69.0
0.171,6,3,453,2,321,171.0,241.0,241.0,1,132,0.0,92.0,92.0
0.187,6,10,1506,5,395,34.0,127.0,127.0,5,1111,40.0,843.0,843.0
0.005,17,2,164,1,74,0.0,46.0,46.0,1,90,0.0,62.0,62.0
0.004,6,10,1989,5,927,1.0,659.0,659.0,5,1062,1.0,794.0,794.0
0.001,17,2,179,1,62,0.0,34.0,34.0,1,117,0.0,89.0,89.0
0.014,6,10,1631,5,848,3.0,580.0,580.0,5,783,3.0,515.0,515.0
0.02,6,10,1631,5,848,5.0,580.0,580.0,5,783,4.0,515.0,515.0
0.371,17,16,9973,8,6917,53.0,1350.0,836.0,8,3056,41.0,1350.0,354.0
0.006,6,10,1689,5,839,1.0,571.0,571.0,5,850,1.0,582.0,582.0
0.012,6,10,1983,5,910,2.0,642.0,642.0,5,1073,3.0,805.0,805.0
0.008,6,10,1990,5,911,2.0,643.0,643.0,5,1079,2.0,811.0,811.0
1777.344,17,144,41760,72,22752,25032.0,288.0,288.0,72,19008,25032.0,236.0,236.0
0.009,6,10,1989,5,910,2.0,642.0,642.0,5,1079,2.0,811.0,811.0
0.006,17,2,140,1,62,0.0,34.0,34.0,1,78,0.0,50.0,50.0
0.006,6,10,1547,5,764,1.0,496.0,496.0,5,783,1.0,515.0,515.0
0.003,17,2,136,1,60,0.0,32.0,32.0,1,76,0.0,48.0,48.0
0.005,17,2,179,1,71,0.0,43.0,43.0,1,108,0.0,80.0,80.0
0.005,17,2,170,1,65,0.0,37.0,37.0,1,105,0.0,77.0,77.0
0.014,6,10,1989,5,910,3.0,642.0,642.0,5,1079,3.0,811.0,811.0
0.017,6,10,1989,5,910,4.0,642.0,642.0,5,1079,4.0,811.0,811.0
0.006,6,10,1547,5,764,1.0,496.0,496.0,5,783,1.0,515.0,515.0
0.011,6,10,1972,5,910,2.0,642.0,642.0,5,1062,2.0,794.0,794.0
0.001,17,2,180,1,66,0.0,38.0,38.0,1,114,0.0,86.0,86.0
0.214,6,16,2669,8,1395,30.0,533.0,323.0,8,1274,19.0,529.0,212.0
0.008,6,10,1983,5,910,2.0,642.0,642.0,5,1073,2.0,805.0,805.0
0.004,6,10,2000,5,927,1.0,659.0,659.0,5,1073,1.0,805.0,805.0
0.005,17,2,166,1,75,0.0,47.0,47.0,1,91,0.0,63.0,63.0
0.004,6,10,1702,5,863,1.0,595.0,595.0,5,839,0.0,571.0,571.0
0.006,6,10,1547,5,764,1.0,496.0,496.0,5,783,1.0,515.0,515.0
0.217,6,16,2778,8,1396,31.0,533.0,324.0,8,1382,20.0,529.0,239.0
0.012,6,10,1989,5,910,3.0,642.0,642.0,5,1079,3.0,811.0,811.0
0.059,6,10,1506,5,395,12.0,127.0,127.0,5,1111,14.0,843.0,843.0
0.011,6,10,1989,5,910,2.0,642.0,642.0,5,1079,2.0,811.0,811.0
0.049,17,2,164,1,74,0.0,46.0,46.0,1,90,0.0,62.0,62.0
0.1,6,10,1506,5,395,20.0,127.0,127.0,5,1111,21.0,843.0,843.0
0.079,6,10,1506,5,395,18.0,127.0,127.0,5,1111,16.0,843.0,843.0
0.06,17,2,152,1,76,0.0,48.0,48.0,1,76,0.0,48.0,48.0
0.01,6,10,1972,5,910,2.0,642.0,642.0,5,1062,2.0,794.0,794.0
0.004,17,2,396,1,61,0.0,33.0,33.0,1,335,0.0,307.0,307.0
0.007,17,2,194,1,59,0.0,31.0,31.0,1,135,0.0,107.0,107.0
0.006,6,10,2000,5,927,1.0,659.0,659.0,5,1073,1.0,805.0,805.0
0.092,6,10,1506,5,395,22.0,127.0,127.0,5,1111,19.0,843.0,843.0
0.005,6,10,2006,5,927,1.0,659.0,659.0,5,1079,1.0,811.0,811.0
0.009,6,10,1677,5,827,2.0,559.0,559.0,5,850,2.0,582.0,582.0
0.005,6,13,3747,7,509,0.0,137.0,137.0,6,3238,0.0,1470.0,1459.0
0.005,6,10,2000,5,927,1.0,659.0,659.0,5,1073,1.0,805.0,805.0
335.953,17,20,1124,10,716,37314.0,48.0,43.0,10,408,37314.0,20.0,12.0
0.006,6,10,1547,5,764,1.0,496.0,496.0,5,783,1.0,515.0,515.0
0.005,6,10,2006,5,927,1.0,659.0,659.0,5,1079,1.0,811.0,811.0
0.005,6,10,1989,5,927,1.0,659.0,659.0,5,1062,1.0,794.0,794.0
0.013,6,10,1983,5,910,3.0,642.0,642.0,5,1073,3.0,805.0,805.0
0.005,6,10,1779,5,928,1.0,660.0,660.0,5,851,1.0,583.0,583.0
0.005,6,10,2006,5,927,1.0,659.0,659.0,5,1079,1.0,811.0,811.0
0.017,6,10,1989,5,910,4.0,642.0,642.0,5,1079,4.0,811.0,811.0
0.005,6,10,2006,5,927,1.0,659.0,659.0,5,1079,1.0,811.0,811.0
40.065,17,10,676,5,460,10014.0,104.0,64.0,5,216,10015.0,20.0,15.0
0.004,6,10,2000,5,927,1.0,659.0,659.0,5,1073,1.0,805.0,805.0
0.001,17,2,180,1,66,0.0,38.0,38.0,1,114,0.0,86.0,86.0
0.01,6,10,1990,5,911,2.0,643.0,643.0,5,1079,2.0,811.0,811.0
0.013,6,10,1972,5,910,3.0,642.0,642.0,5,1062,3.0,794.0,794.0
0.03,17,2,140,1,62,0.0,34.0,34.0,1,78,0.0,50.0,50.0
1795.829,6,547,189991,275,163948,6554.0,2883.0,971.0,272,26043,6626.0,580.0,117.0
0.003,17,2,185,1,73,0.0,45.0,45.0,1,112,0.0,84.0,84.0
0.005,17,2,152,1,68,0.0,40.0,40.0,1,84,0.0,56.0,56.0
0.006,6,10,1547,5,764,1.0,496.0,496.0,5,783,1.0,515.0,515.0
0.018,6,10,1989,5,910,4.0,642.0,642.0,5,1079,4.0,811.0,811.0
0.005,6,10,1854,5,889,1.0,621.0,621.0,5,965,1.0,697.0,697.0
0.005,17,2,179,1,71,0.0,43.0,43.0,1,108,0.0,80.0,80.0
0.006,6,10,1854,5,889,1.0,621.0,621.0,5,965,1.0,697.0,697.0
0.939,6,34,18647,19,12103,52.0,2720.0,1256.0,15,6544,55.0,2720.0,988.0
0.043,17,4,352,2,130,3.0,37.0,37.0,2,222,5.0,89.0,83.0
0.006,6,12,1698,6,863,1.0,327.0,271.0,6,835,1.0,515.0,515.0
0.003,17,2,136,1,60,0.0,32.0,32.0,1,76,0.0,48.0,48.0
0.08,6,10,1506,5,395,18.0,127.0,127.0,5,1111,18.0,843.0,843.0
1.049,6,30,13239,17,5840,65.0,2720.0,854.0,13,7399,73.0,2720.0,858.0
0.006,17,2,179,1,71,0.0,43.0,43.0,1,108,0.0,80.0,80.0
0.004,17,2,179,1,71,0.0,43.0,43.0,1,108,0.0,80.0,80.0
0.007,17,2,144,1,64,0.0,36.0,36.0,1,80,0.0,52.0,52.0
0.016,6,10,1972,5,910,4.0,642.0,642.0,5,1062,3.0,794.0,794.0
11.212,17,28,4418,14,1994,849.0,269.0,114.0,14,2424,848.0,587.0,145.0
0.808,6,10,2009,6,1655,161.0,1403.0,1403.0,4,354,191.0,182.0,182.0
0.086,6,10,1506,5,395,20.0,127.0,127.0,5,1111,19.0,843.0,843.0
15.07,17,14,9191,8,6902,2148.0,1350.0,834.0,6,2289,3008.0,1350.0,353.0
0.011,6,10,1989,5,910,2.0,642.0,642.0,5,1079,2.0,811.0,811.0
0.039,17,2,182,1,65,0.0,37.0,37.0,1,117,0.0,89.0,89.0
40.068,17,10,676,5,460,10016.0,104.0,64.0,5,216,10016.0,20.0,15.0
0.015,6,10,1989,5,910,3.0,642.0,642.0,5,1079,3.0,811.0,811.0
0.005,17,2,179,1,71,0.0,43.0,43.0,1,108,0.0,80.0,80.0
241.383,6,290,342249,110,17243,2214.0,2736.0,960.0,180,325006,1348.0,4206.0,1856.0
0.001,17,2,179,1,62,0.0,34.0,34.0,1,117,0.0,89.0,89.0
0.005,17,2,213,1,69,0.0,41.0,41.0,1,144,0.0,116.0,116.0
0.009,6,12,1926,6,1189,1.0,659.0,434.0,6,737,1.0,417.0,417.0
0.015,6,10,1762,5,911,3.0,643.0,643.0,5,851,3.0,583.0,583.0
180.496,6,65,30108,37,5137,5013.0,994.0,247.0,28,24971,6684.0,2804.0,1237.0
0.005,6,10,1689,5,839,1.0,571.0,571.0,5,850,1.0,582.0,582.0
0.11,6,10,1506,5,395,21.0,127.0,127.0,5,1111,24.0,843.0,843.0
0.005,6,10,2007,5,928,1.0,660.0,660.0,5,1079,1.0,811.0,811.0
0.004,17,2,148,1,60,0.0,32.0,32.0,1,88,0.0,60.0,60.0
0.003,17,4,284,2,120,0.0,32.0,32.0,2,164,0.0,60.0,54.0
240.018,6,9,787,5,488,60004.0,232.0,232.0,4,299,80001.0,83.0,83.0
0.011,6,10,1989,5,910,2.0,642.0,642.0,5,1079,2.0,811.0,811.0
1777.861,17,144,41760,72,22752,25040.0,288.0,288.0,72,19008,25040.0,236.0,236.0
241.166,6,315,344391,119,17694,2043.0,2687.0,885.0,196,326697,1236.0,2972.0,1701.0
0.005,17,2,140,1,62,0.0,34.0,34.0,1,78,0.0,50.0,50.0
0.005,6,13,3747,7,509,0.0,137.0,137.0,6,3238,0.0,1470.0,1459.0
293.14,6,399,348834,206,22914,1429.0,2736.0,871.0,193,325920,1526.0,2804.0,1774.0
11.179,17,28,4418,14,1993,847.0,268.0,114.0,14,2425,847.0,588.0,145.0
0.003,17,2,152,1,76,0.0,48.0,48.0,1,76,0.0,48.0,48.0
0.005,6,10,2006,5,927,1.0,659.0,659.0,5,1079,1.0,811.0,811.0
0.142,6,10,1506,5,395,34.0,127.0,127.0,5,1111,33.0,843.0,843.0
0.015,6,13,3735,7,497,2.0,125.0,125.0,6,3238,3.0,1470.0,1459.0
178.391,17,94,13409,47,3135,3877.0,44.0,38.0,47,10274,3877.0,239.0,190.0
0.067,6,10,1972,5,910,16.0,642.0,642.0,5,1062,16.0,794.0,794.0
0.007,6,10,1547,5,764,1.0,496.0,496.0,5,783,1.0,515.0,515.0
0.012,6,13,3735,7,497,1.0,125.0,125.0,6,3238,2.0,1470.0,1459.0
0.005,17,2,214,1,75,0.0,47.0,47.0,1,139,0.0,111.0,111.0
0.111,6,10,1506,5,395,26.0,127.0,127.0,5,1111,20.0,843.0,843.0
0.005,6,10,2000,5,927,1.0,659.0,659.0,5,1073,1.0,805.0,805.0
0.07,6,10,1506,5,395,13.0,127.0,127.0,5,1111,13.0,843.0,843.0
0.005,6,10,1689,5,839,1.0,571.0,571.0,5,850,1.0,582.0,582.0
0.005,6,10,2006,5,927,1.0,659.0,659.0,5,1079,1.0,811.0,811.0
0.001,17,2,166,1,75,0.0,47.0,47.0,1,91,0.0,63.0,63.0
0.006,17,2,170,1,65,0.0,37.0,37.0,1,105,0.0,77.0,77.0
0.021,6,10,1983,5,910,5.0,642.0,642.0,5,1073,5.0,805.0,805.0
0.012,6,10,1989,5,910,3.0,642.0,642.0,5,1079,3.0,811.0,811.0
0.072,17,4,420,2,122,0.0,33.0,33.0,2,298,32.0,145.0,121.0
0.107,6,10,1506,5,395,25.0,127.0,127.0,5,1111,22.0,843.0,843.0
0.011,6,10,1762,5,911,2.0,643.0,643.0,5,851,2.0,583.0,583.0
0.005,6,10,1989,5,927,1.0,659.0,659.0,5,1062,1.0,794.0,794.0
0.002,17,2,136,1,60,0.0,32.0,32.0,1,76,0.0,48.0,48.0
0.006,6,10,1547,5,764,1.0,496.0,496.0,5,783,1.0,515.0,515.0
0.005,6,10,2006,5,927,1.0,659.0,659.0,5,1079,1.0,811.0,811.0
0.221,6,16,2675,8,1401,31.0,533.0,325.0,8,1274,20.0,529.0,212.0
308.264,17,20,1124,10,716,34239.0,48.0,43.0,10,408,34238.0,20.0,12.0
11.071,17,26,4101,13,1846,913.0,269.0,114.0,13,2255,913.0,586.0,145.0
0.008,6,10,1990,5,911,2.0,643.0,643.0,5,1079,2.0,811.0,811.0
0.124,6,10,1506,5,395,26.0,127.0,127.0,5,1111,26.0,843.0,843.0
0.011,6,10,1972,5,910,2.0,642.0,642.0,5,1062,2.0,794.0,794.0
0.012,6,10,1972,5,910,3.0,642.0,642.0,5,1062,2.0,794.0,794.0
0.217,6,16,2669,8,1395,31.0,533.0,323.0,8,1274,20.0,529.0,212.0
0.016,6,10,1990,5,911,4.0,643.0,643.0,5,1079,3.0,811.0,811.0
0.006,6,10,1547,5,764,1.0,496.0,496.0,5,783,1.0,515.0,515.0
0.009,6,10,1677,5,827,2.0,559.0,559.0,5,850,2.0,582.0,582.0
0.006,6,10,1689,5,839,1.0,571.0,571.0,5,850,1.0,582.0,582.0
0.005,17,2,170,1,65,0.0,37.0,37.0,1,105,0.0,77.0,77.0
0.004,6,10,1779,5,928,1.0,660.0,660.0,5,851,1.0,583.0,583.0
0.04,17,2,184,1,61,0.0,33.0,33.0,1,123,0.0,95.0,95.0
300.835,6,39,11825,21,6307,15041.0,2720.0,905.0,18,5518,509.0,2667.0,435.0
0.116,6,10,1506,5,395,26.0,127.0,127.0,5,1111,25.0,843.0,843.0
308.613,17,20,1124,10,716,34276.0,48.0,43.0,10,408,34276.0,20.0,12.0
0.001,17,2,180,1,66,0.0,38.0,38.0,1,114,0.0,86.0,86.0
0.08,6,10,1506,5,395,17.0,127.0,127.0,5,1111,18.0,843.0,843.0
0.066,6,10,1506,5,395,14.0,127.0,127.0,5,1111,14.0,843.0,843.0
0.004,17,2,152,1,76,0.0,48.0,48.0,1,76,0.0,48.0,48.0
0.128,17,2,80,1,32,0.0,4.0,4.0,1,48,0.0,20.0,20.0
0.176,17,2,194,1,59,0.0,31.0,31.0,1,135,0.0,107.0,107.0
0.068,17,8,3613,4,1874,22.0,1350.0,440.0,4,1739,11.0,1350.0,406.0
0.064,6,10,1506,5,395,15.0,127.0,127.0,5,1111,14.0,843.0,843.0
0.01,6,10,1990,5,911,2.0,643.0,643.0,5,1079,2.0,811.0,811.0
0.302,17,4,352,2,130,178.0,37.0,37.0,2,222,230.0,89.0,83.0
0.113,6,10,1506,5,395,24.0,127.0,127.0,5,1111,22.0,843.0,843.0
0.002,17,2,136,1,60,0.0,32.0,32.0,1,76,0.0,48.0,48.0
0.068,6,10,1506,5,395,16.0,127.0,127.0,5,1111,14.0,843.0,843.0
0.004,6,10,1989,5,927,1.0,659.0,659.0,5,1062,1.0,794.0,794.0
0.001,17,2,180,1,66,0.0,38.0,38.0,1,114,0.0,86.0,86.0
0.005,17,4,284,2,120,0.0,32.0,32.0,2,164,0.0,60.0,54.0
0.005,6,10,1989,5,927,1.0,659.0,659.0,5,1062,1.0,794.0,794.0
0.005,17,2,178,1,65,0.0,37.0,37.0,1,113,0.0,85.0,85.0
0.006,6,10,1779,5,928,1.0,660.0,660.0,5,851,1.0,583.0,583.0
0.004,6,10,1702,5,863,1.0,595.0,595.0,5,839,0.0,571.0,571.0
0.067,6,10,1506,5,395,14.0,127.0,127.0,5,1111,15.0,843.0,843.0
0.012,6,10,1631,5,848,3.0,580.0,580.0,5,783,3.0,515.0,515.0
0.006,6,10,1547,5,764,1.0,496.0,496.0,5,783,1.0,515.0,515.0
308.908,17,20,1124,10,716,34309.0,48.0,43.0,10,408,34309.0,20.0,12.0
0.005,17,2,179,1,71,0.0,43.0,43.0,1,108,0.0,80.0,80.0
166.35,17,88,12772,44,2948,3868.0,44.0,39.0,44,9824,3868.0,261.0,195.0
89.938,6,21,8145,11,1985,89.0,1174.0,504.0,10,6160,9973.0,2720.0,958.0
0.104,6,10,1506,5,395,23.0,127.0,127.0,5,1111,20.0,843.0,843.0
0.085,6,10,1506,5,395,19.0,127.0,127.0,5,1111,18.0,843.0,843.0
0.005,17,2,230,1,68,0.0,40.0,40.0,1,162,0.0,134.0,134.0
0.062,17,2,164,1,74,0.0,46.0,46.0,1,90,0.0,62.0,62.0
0.004,6,10,1702,5,863,1.0,595.0,595.0,5,839,0.0,571.0,571.0
40.073,17,10,676,5,460,10017.0,104.0,64.0,5,216,10017.0,20.0,15.0
0.009,6,10,1990,5,911,2.0,643.0,643.0,5,1079,2.0,811.0,811.0
0.095,6,10,1506,5,395,20.0,127.0,127.0,5,1111,20.0,843.0,843.0
0.011,6,10,1983,5,910,2.0,642.0,642.0,5,1073,2.0,805.0,805.0
178.487,17,80,11008,40,2663,4576.0,44.0,38.0,40,8345,4576.0,239.0,180.0
0.133,6,10,1506,5,395,30.0,127.0,127.0,5,1111,30.0,843.0,843.0
40.055,17,10,676,5,460,10012.0,104.0,64.0,5,216,10013.0,20.0,15.0
0.005,17,2,140,1,62,0.0,34.0,34.0,1,78,0.0,50.0,50.0
0.063,6,10,1506,5,395,14.0,127.0,127.0,5,1111,13.0,843.0,843.0
0.006,6,10,1854,5,889,1.0,621.0,621.0,5,965,1.0,697.0,697.0
0.003,17,2,148,1,60,0.0,32.0,32.0,1,88,0.0,60.0,60.0
0.014,6,10,1972,5,910,3.0,642.0,642.0,5,1062,3.0,794.0,794.0
0.006,6,10,1989,5,927,1.0,659.0,659.0,5,1062,1.0,794.0,794.0
0.005,6,10,1989,5,927,1.0,659.0,659.0,5,1062,1.0,794.0,794.0
0.005,6,10,2007,5,928,1.0,660.0,660.0,5,1079,1.0,811.0,811.0
240.105,6,16,4481,9,963,30013.0,238.0,166.0,7,3518,40017.0,1402.0,786.0
0.133,6,10,1506,5,395,30.0,127.0,127.0,5,1111,29.0,843.0,843.0
0.006,6,10,1547,5,764,1.0,496.0,496.0,5,783,1.0,515.0,515.0
0.013,6,10,1631,5,848,3.0,580.0,580.0,5,783,3.0,515.0,515.0
1787.373,6,154,19574,92,13852,19641.0,302.0,302.0,62,5722,29301.0,83.0,83.0
0.006,6,10,1547,5,764,1.0,496.0,496.0,5,783,1.0,515.0,515.0
0.001,17,2,180,1,66,0.0,38.0,38.0,1,114,0.0,86.0,86.0
10.846,17,28,4423,14,1994,825.0,269.0,114.0,14,2429,825.0,588.0,145.0
0.004,6,10,1774,5,923,1.0,655.0,655.0,5,851,1.0,583.0,583.0
0.004,6,10,2006,5,927,1.0,659.0,659.0,5,1079,1.0,811.0,811.0
0.008,17,2,179,1,71,0.0,43.0,43.0,1,108,0.0,80.0,80.0
300.29,6,28,7485,16,1409,20019.0,217.0,142.0,12,6076,21840.0,1402.0,680.0
0.156,6,10,1506,5,395,37.0,127.0,127.0,5,1111,21.0,843.0,843.0
40.063,17,10,676,5,460,10014.0,104.0,64.0,5,216,10014.0,20.0,15.0
280.805,6,25,6480,11,1226,28080.0,267.0,156.0,14,5254,21597.0,1400.0,781.0
0.011,6,10,1989,5,910,2.0,642.0,642.0,5,1079,2.0,811.0,811.0
0.005,6,10,2007,5,928,1.0,660.0,660.0,5,1079,1.0,811.0,811.0
0.005,6,10,2000,5,927,1.0,659.0,659.0,5,1073,1.0,805.0,805.0
40.071,17,10,676,5,460,10012.0,104.0,64.0,5,216,10013.0,20.0,15.0
0.128,6,10,1506,5,395,25.0,127.0,127.0,5,1111,25.0,843.0,843.0
0.005,6,10,1689,5,839,1.0,571.0,571.0,5,850,1.0,582.0,582.0
0.014,6,10,1631,5,848,3.0,580.0,580.0,5,783,3.0,515.0,515.0
0.005,6,10,2006,5,927,1.0,659.0,659.0,5,1079,1.0,811.0,811.0
11.185,17,28,4422,14,1993,848.0,268.0,114.0,14,2429,848.0,588.0,145.0
40.067,17,10,676,5,460,10014.0,104.0,64.0,5,216,10016.0,20.0,15.0
0.004,6,10,2006,5,927,1.0,659.0,659.0,5,1079,1.0,811.0,811.0
0.225,6,16,2778,8,1396,32.0,533.0,324.0,8,1382,21.0,529.0,239.0
0.005,17,2,214,1,75,0.0,47.0,47.0,1,139,0.0,111.0,111.0
0.071,17,2,136,1,60,0.0,32.0,32.0,1,76,0.0,48.0,48.0
0.008,6,12,1926,6,1189,1.0,659.0,434.0,6,737,1.0,417.0,417.0
354.021,6,21,1795,16,1030,23601.0,190.0,190.0,5,765,60001.0,464.0,248.0
0.016,6,10,1983,5,910,4.0,642.0,642.0,5,1073,4.0,805.0,805.0
0.001,17,2,180,1,66,0.0,38.0,38.0,1,114,0.0,86.0,86.0
0.007,17,2,179,1,71,0.0,43.0,43.0,1,108,0.0,80.0,80.0
1.119,17,6,534,3,195,557.0,37.0,37.0,3,339,541.0,89.0,85.0
351.988,6,20,2210,6,1308,12003.0,494.0,494.0,14,902,27075.0,83.0,83.0
240.092,6,16,4482,9,963,30011.0,238.0,166.0,7,3519,40014.0,1402.0,786.0
0.006,6,14,3799,7,509,1.0,137.0,137.0,7,3290,0.0,1448.0,972.0
0.212,6,16,2674,8,1400,30.0,533.0,325.0,8,1274,19.0,529.0,212.0
0.133,6,10,1506,5,395,30.0,127.0,127.0,5,1111,29.0,843.0,843.0
0.006,6,10,1547,5,764,1.0,496.0,496.0,5,783,1.0,515.0,515.0
0.042,17,2,136,1,60,0.0,32.0,32.0,1,76,0.0,48.0,48.0
0.076,6,10,1506,5,395,16.0,127.0,127.0,5,1111,18.0,843.0,843.0
0.013,6,13,3735,7,497,2.0,125.0,125.0,6,3238,2.0,1470.0,1459.0
40.082,17,10,676,5,460,10017.0,104.0,64.0,5,216,10019.0,20.0,15.0
0.008,6,10,1990,5,911,2.0,643.0,643.0,5,1079,2.0,811.0,811.0
0.019,6,13,3735,7,497,3.0,125.0,125.0,6,3238,3.0,1470.0,1459.0
0.014,6,10,1677,5,827,3.0,559.0,559.0,5,850,3.0,582.0,582.0
0.005,6,10,2006,5,927,1.0,659.0,659.0,5,1079,1.0,811.0,811.0
165.071,6,26,9525,12,1627,77.0,794.0,367.0,14,7898,12688.0,1360.0,732.0
0.009,6,10,1990,5,911,2.0,643.0,643.0,5,1079,2.0,811.0,811.0
0.005,6,10,2007,5,928,1.0,660.0,660.0,5,1079,1.0,811.0,811.0
0.006,17,2,273,1,66,0.0,38.0,38.0,1,207,0.0,179.0,179.0
0.004,6,10,1989,5,927,1.0,659.0,659.0,5,1062,1.0,794.0,794.0
0.004,6,10,2000,5,927,1.0,659.0,659.0,5,1073,1.0,805.0,805.0
364.372,6,21,1793,16,1030,24291.0,190.0,190.0,5,763,60012.0,462.0,247.0
0.015,6,10,1989,5,910,3.0,642.0,642.0,5,1079,3.0,811.0,811.0
0.006,6,10,2000,5,927,1.0,659.0,659.0,5,1073,1.0,805.0,805.0
361.839,6,19,1689,15,978,25845.0,190.0,190.0,4,711,80015.0,495.0,495.0
0.006,6,10,1547,5,764,1.0,496.0,496.0,5,783,1.0,515.0,515.0
0.005,6,10,1854,5,889,1.0,621.0,621.0,5,965,1.0,697.0,697.0
0.069,6,10,1506,5,395,14.0,127.0,127.0,5,1111,15.0,843.0,843.0
0.018,6,10,1972,5,910,4.0,642.0,642.0,5,1062,4.0,794.0,794.0
0.005,6,13,3747,7,509,0.0,137.0,137.0,6,3238,0.0,1470.0,1459.0
1799.877,17,2808,215195,1394,113117,1292.0,84.0,53.0,1414,102078,1273.0,227.0,44.0
0.005,17,2,293,1,73,0.0,45.0,45.0,1,220,0.0,192.0,192.0
0.007,17,2,230,1,68,0.0,40.0,40.0,1,162,0.0,134.0,134.0
0.005,6,10,2006,5,927,1.0,659.0,659.0,5,1079,1.0,811.0,811.0
0.005,6,10,2007,5,928,1.0,660.0,660.0,5,1079,1.0,811.0,811.0
0.005,6,13,3747,7,509,0.0,137.0,137.0,6,3238,0.0,1470.0,1459.0
0.083,6,10,1506,5,395,20.0,127.0,127.0,5,1111,18.0,843.0,843.0
0.005,6,10,2007,5,928,1.0,660.0,660.0,5,1079,1.0,811.0,811.0
0.004,17,2,234,1,61,0.0,33.0,33.0,1,173,0.0,145.0,145.0
0.061,6,10,1506,5,395,13.0,127.0,127.0,5,1111,14.0,843.0,843.0
1770.602,17,92,8096,46,4048,39346.0,60.0,60.0,46,4048,39346.0,60.0,60.0
0.005,6,10,2006,5,927,1.0,659.0,659.0,5,1079,1.0,811.0,811.0
10.987,17,28,4398,14,2312,836.0,587.0,137.0,14,2086,836.0,269.0,121.0
0.166,17,2,152,1,76,0.0,48.0,48.0,1,76,0.0,48.0,48.0
0.016,17,2,198,1,91,0.0,63.0,63.0,1,107,0.0,79.0,79.0
430.862,6,47,8807,24,6690,6038.0,494.0,494.0,23,2117,19584.0,83.0,83.0
141.503,6,22,7437,11,1305,118.0,530.0,277.0,11,6132,14134.0,2720.0,946.0
0.004,17,2,148,1,60,0.0,32.0,32.0,1,88,0.0,60.0,60.0
176.714,17,82,11587,41,2734,4417.0,44.0,38.0,41,8853,4417.0,261.0,187.0
0.005,6,10,2006,5,927,1.0,659.0,659.0,5,1079,1.0,811.0,811.0
0.135,6,10,1506,5,395,31.0,127.0,127.0,5,1111,32.0,843.0,843.0
15.07,17,15,9238,8,6902,2148.0,1350.0,834.0,7,2336,2506.0,1350.0,305.0
0.005,6,10,1854,5,889,1.0,621.0,621.0,5,965,1.0,697.0,697.0
0.001,17,2,180,1,66,0.0,38.0,38.0,1,114,0.0,86.0,86.0
0.005,6,10,2000,5,927,1.0,659.0,659.0,5,1073,1.0,805.0,805.0
0.138,6,10,1506,5,395,27.0,127.0,127.0,5,1111,34.0,843.0,843.0
0.004,6,10,1702,5,863,1.0,595.0,595.0,5,839,1.0,571.0,571.0
0.004,6,10,2006,5,927,1.0,659.0,659.0,5,1079,1.0,811.0,811.0
0.004,6,10,1702,5,863,1.0,595.0,595.0,5,839,1.0,571.0,571.0
0.005,6,10,1779,5,928,1.0,660.0,660.0,5,851,1.0,583.0,583.0
0.116,6,23,6535,11,2013,10.0,746.0,286.0,12,4522,9.0,1324.0,778.0
0.005,6,10,2006,5,927,1.0,659.0,659.0,5,1079,1.0,811.0,811.0
0.083,6,10,1506,5,395,18.0,127.0,127.0,5,1111,19.0,843.0,843.0
0.055,17,2,152,1,76,0.0,48.0,48.0,1,76,0.0,48.0,48.0
0.011,6,10,1989,5,910,2.0,642.0,642.0,5,1079,2.0,811.0,811.0
0.087,6,10,1506,5,395,17.0,127.0,127.0,5,1111,20.0,843.0,843.0
0.015,6,10,1989,5,910,3.0,642.0,642.0,5,1079,3.0,811.0,811.0
373.595,6,28,4345,13,3142,31132.0,494.0,494.0,15,1203,26685.0,83.0,83.0
0.005,6,10,1702,5,863,1.0,595.0,595.0,5,839,1.0,571.0,571.0
0.016,6,10,1972,5,910,4.0,642.0,642.0,5,1062,4.0,794.0,794.0
0.005,6,10,2006,5,927,1.0,659.0,659.0,5,1079,1.0,811.0,811.0
0.007,17,2,230,1,68,0.0,40.0,40.0,1,162,0.0,134.0,134.0
0.007,6,10,1972,5,910,1.0,642.0,642.0,5,1062,1.0,794.0,794.0
0.093,6,10,1506,5,395,21.0,127.0,127.0,5,1111,22.0,843.0,843.0
0.004,6,10,1702,5,863,1.0,595.0,595.0,5,839,1.0,571.0,571.0
0.001,17,2,180,1,66,0.0,38.0,38.0,1,114,0.0,86.0,86.0
0.013,6,10,1989,5,910,3.0,642.0,642.0,5,1079,3.0,811.0,811.0
0.079,6,10,1506,5,395,19.0,127.0,127.0,5,1111,17.0,843.0,843.0
0.008,6,10,1762,5,911,2.0,643.0,643.0,5,851,1.0,583.0,583.0
0.107,6,10,1506,5,395,23.0,127.0,127.0,5,1111,24.0,843.0,843.0
0.006,6,10,1643,5,860,1.0,592.0,592.0,5,783,1.0,515.0,515.0
0.005,6,10,2007,5,928,1.0,660.0,660.0,5,1079,1.0,811.0,811.0
0.015,6,10,1972,5,910,3.0,642.0,642.0,5,1062,3.0,794.0,794.0
0.013,6,10,1972,5,910,3.0,642.0,642.0,5,1062,3.0,794.0,794.0
40.089,17,10,676,5,460,10019.0,104.0,64.0,5,216,10021.0,20.0,15.0
0.019,6,10,1989,5,910,4.0,642.0,642.0,5,1079,4.0,811.0,811.0
0.01,6,14,3787,7,497,1.0,125.0,125.0,7,3290,1.0,1448.0,972.0
0.071,6,10,1506,5,395,15.0,127.0,127.0,5,1111,15.0,843.0,843.0
0.007,6,10,1643,5,860,1.0,592.0,592.0,5,783,1.0,515.0,515.0
0.004,6,10,2006,5,927,1.0,659.0,659.0,5,1079,1.0,811.0,811.0
0.001,17,2,180,1,66,0.0,38.0,38.0,1,114,0.0,86.0,86.0
0.007,6,10,1689,5,839,1.0,571.0,571.0,5,850,1.0,582.0,582.0
0.009,6,10,1990,5,911,2.0,643.0,643.0,5,1079,2.0,811.0,811.0
240.107,6,16,4480,9,963,30013.0,238.0,166.0,7,3517,40017.0,1402.0,786.0
0.013,6,10,1983,5,910,3.0,642.0,642.0,5,1073,3.0,805.0,805.0
0.096,6,10,1506,5,395,22.0,127.0,127.0,5,1111,21.0,843.0,843.0
0.005,6,10,2006,5,927,1.0,659.0,659.0,5,1079,1.0,811.0,811.0
292.863,6,390,348359,194,22272,1517.0,2736.0,870.0,196,326087,1501.0,2804.0,1735.0
65.636,6,30,17814,14,9539,5048.0,2804.0,1469.0,16,8275,4367.0,2314.0,743.0
0.007,17,2,194,1,59,0.0,31.0,31.0,1,135,0.0,107.0,107.0
0.009,6,10,1989,5,910,2.0,642.0,642.0,5,1079,2.0,811.0,811.0
0.009,6,10,1677,5,827,2.0,559.0,559.0,5,850,2.0,582.0,582.0
0.004,6,10,2006,5,927,1.0,659.0,659.0,5,1079,1.0,811.0,811.0
0.015,6,13,3735,7,497,2.0,125.0,125.0,6,3238,3.0,1470.0,1459.0
240.096,6,16,4482,9,963,30012.0,238.0,166.0,7,3519,40013.0,1402.0,786.0
10.753,17,28,4417,14,1993,819.0,268.0,114.0,14,2424,819.0,587.0,145.0
0.006,6,10,1547,5,764,1.0,496.0,496.0,5,783,1.0,515.0,515.0
0.011,6,10,1631,5,848,2.0,580.0,580.0,5,783,2.0,515.0,515.0
178.124,17,88,12940,44,2966,4142.0,44.0,39.0,44,9974,4142.0,261.0,198.0
361.833,6,19,1689,15,978,25845.0,190.0,190.0,4,711,80013.0,495.0,495.0
0.013,6,10,1989,5,910,3.0,642.0,642.0,5,1079,3.0,811.0,811.0
0.012,6,10,1762,5,911,3.0,643.0,643.0,5,851,2.0,583.0,583.0
0.004,6,10,1702,5,863,1.0,595.0,595.0,5,839,0.0,571.0,571.0
0.005,6,10,2006,5,927,1.0,659.0,659.0,5,1079,1.0,811.0,811.0
252.83,58,3,216,2,144,252830.0,24.0,24.0,1,72,0.0,24.0,24.0
240.09,6,16,4481,9,963,30011.0,238.0,166.0,7,3518,40014.0,1402.0,786.0
0.011,6,10,1990,5,911,2.0,643.0,643.0,5,1079,2.0,811.0,811.0
0.004,6,10,2006,5,927,1.0,659.0,659.0,5,1079,1.0,811.0,811.0
9.037,17,6,376,5,280,2259.0,28.0,28.0,1,96,0.0,68.0,68.0
0.005,6,10,2007,5,928,1.0,660.0,660.0,5,1079,1.0,811.0,811.0
0.004,6,10,2006,5,927,1.0,659.0,659.0,5,1079,1.0,811.0,811.0
0.01,6,10,1989,5,910,2.0,642.0,642.0,5,1079,2.0,811.0,811.0
0.072,17,2,170,1,65,0.0,37.0,37.0,1,105,0.0,77.0,77.0
0.061,6,10,1506,5,395,11.0,127.0,127.0,5,1111,14.0,843.0,843.0
0.04,17,2,152,1,76,0.0,48.0,48.0,1,76,0.0,48.0,48.0
0.133,6,10,1506,5,395,32.0,127.0,127.0,5,1111,29.0,843.0,843.0
0.009,6,10,1983,5,910,2.0,642.0,642.0,5,1073,2.0,805.0,805.0
0.003,17,2,136,1,60,0.0,32.0,32.0,1,76,0.0,48.0,48.0
0.005,17,2,136,1,60,0.0,32.0,32.0,1,76,0.0,48.0,48.0
0.013,6,10,1972,5,910,3.0,642.0,642.0,5,1062,3.0,794.0,794.0
0.013,6,10,1990,5,911,3.0,643.0,643.0,5,1079,3.0,811.0,811.0
0.005,6,10,1989,5,927,1.0,659.0,659.0,5,1062,1.0,794.0,794.0
0.01,6,10,1989,5,910,2.0,642.0,642.0,5,1079,2.0,811.0,811.0
0.006,6,10,1689,5,839,1.0,571.0,571.0,5,850,1.0,582.0,582.0
0.006,6,13,3690,7,452,1.0,80.0,80.0,6,3238,1.0,1470.0,1459.0
0.009,17,4,284,2,120,0.0,32.0,32.0,2,164,0.0,60.0,54.0
0.006,17,2,164,1,74,0.0,46.0,46.0,1,90,0.0,62.0,62.0
40.056,17,10,676,5,460,10013.0,104.0,64.0,5,216,10013.0,20.0,15.0
0.005,6,10,2006,5,927,1.0,659.0,659.0,5,1079,1.0,811.0,811.0
0.129,6,10,1506,5,395,30.0,127.0,127.0,5,1111,28.0,843.0,843.0
0.005,6,13,3747,7,509,0.0,137.0,137.0,6,3238,0.0,1470.0,1459.0
0.009,6,10,1983,5,910,2.0,642.0,642.0,5,1073,2.0,805.0,805.0
1779.204,17,144,45504,72,22752,25052.0,288.0,288.0,72,22752,25058.0,288.0,288.0
0.006,6,10,1547,5,764,1.0,496.0,496.0,5,783,1.0,515.0,515.0
0.104,6,10,1506,5,395,25.0,127.0,127.0,5,1111,23.0,843.0,843.0
0.104,6,10,1506,5,395,21.0,127.0,127.0,5,1111,24.0,843.0,843.0
0.108,6,10,1506,5,395,23.0,127.0,127.0,5,1111,20.0,843.0,843.0
0.005,6,10,2006,5,927,1.0,659.0,659.0,5,1079,1.0,811.0,811.0
0.013,6,10,1972,5,910,3.0,642.0,642.0,5,1062,3.0,794.0,794.0
0.008,6,10,1990,5,911,2.0,643.0,643.0,5,1079,2.0,811.0,811.0
0.021,6,10,1990,5,911,5.0,643.0,643.0,5,1079,5.0,811.0,811.0
0.121,6,10,1506,5,395,25.0,127.0,127.0,5,1111,26.0,843.0,843.0
308.653,17,20,1124,10,716,34281.0,48.0,43.0,10,408,34283.0,20.0,12.0
0.015,6,10,1972,5,910,3.0,642.0,642.0,5,1062,3.0,794.0,794.0
0.022,6,10,1983,5,910,5.0,642.0,642.0,5,1073,5.0,805.0,805.0
0.001,17,2,180,1,66,0.0,38.0,38.0,1,114,0.0,86.0,86.0
413.668,6,29,4409,12,3102,10912.0,494.0,494.0,17,1307,25854.0,83.0,83.0
0.002,17,2,180,1,66,0.0,38.0,38.0,1,114,0.0,86.0,86.0
0.103,6,10,1506,5,395,22.0,127.0,127.0,5,1111,21.0,843.0,843.0
0.005,6,10,1989,5,927,1.0,659.0,659.0,5,1062,1.0,794.0,794.0
0.009,6,10,1762,5,911,2.0,643.0,643.0,5,851,2.0,583.0,583.0
0.02,17,2,170,1,65,0.0,37.0,37.0,1,105,0.0,77.0,77.0
0.009,6,10,1989,5,910,2.0,642.0,642.0,5,1079,2.0,811.0,811.0
0.005,6,10,2000,5,927,1.0,659.0,659.0,5,1073,1.0,805.0,805.0
10.714,17,26,4098,13,1846,884.0,269.0,114.0,13,2252,884.0,587.0,145.0
0.009,6,10,1972,5,910,2.0,642.0,642.0,5,1062,2.0,794.0,794.0
855.125,6,73,31830,38,7519,23111.0,676.0,503.0,35,24311,25150.0,1934.0,978.0
0.005,6,10,1989,5,927,1.0,659.0,659.0,5,1062,1.0,794.0,794.0
10.716,17,28,4421,14,1994,815.0,269.0,114.0,14,2427,815.0,586.0,145.0
11.351,17,28,4420,14,1995,860.0,270.0,114.0,14,2425,860.0,588.0,145.0
0.068,17,8,3613,4,1874,22.0,1350.0,440.0,4,1739,12.0,1350.0,406.0
0.005,17,2,249,1,64,0.0,36.0,36.0,1,185,0.0,157.0,157.0
0.003,17,2,136,1,60,0.0,32.0,32.0,1,76,0.0,48.0,48.0
0.006,6,13,3690,7,452,0.0,80.0,80.0,6,3238,1.0,1470.0,1459.0
0.125,6,10,1506,5,395,26.0,127.0,127.0,5,1111,24.0,843.0,843.0
0.008,6,10,1972,5,910,2.0,642.0,642.0,5,1062,2.0,794.0,794.0
0.005,6,10,1854,5,889,1.0,621.0,621.0,5,965,1.0,697.0,697.0
1770.639,17,120,11460,60,5460,30010.0,63.0,63.0,60,6000,30010.0,72.0,72.0
0.014,6,10,1677,5,827,3.0,559.0,559.0,5,850,3.0,582.0,582.0
10.858,17,28,4421,14,1993,826.0,268.0,114.0,14,2428,826.0,587.0,145.0
0.005,6,10,1643,5,860,1.0,592.0,592.0,5,783,1.0,515.0,515.0
0.012,6,10,1762,5,911,3.0,643.0,643.0,5,851,2.0,583.0,583.0
0.005,17,2,166,1,75,0.0,47.0,47.0,1,91,0.0,63.0,63.0
40.073,17,10,676,5,460,10015.0,104.0,64.0,5,216,10017.0,20.0,15.0
0.004,17,2,148,1,60,0.0,32.0,32.0,1,88,0.0,60.0,60.0
0.005,6,10,2006,5,927,1.0,659.0,659.0,5,1079,1.0,811.0,811.0
0.017,6,10,1972,5,910,4.0,642.0,642.0,5,1062,4.0,794.0,794.0
0.005,17,2,273,1,66,0.0,38.0,38.0,1,207,0.0,179.0,179.0
0.005,17,2,136,1,60,0.0,32.0,32.0,1,76,0.0,48.0,48.0
0.096,6,10,1506,5,395,20.0,127.0,127.0,5,1111,20.0,843.0,843.0
0.096,6,10,1506,5,395,22.0,127.0,127.0,5,1111,20.0,843.0,843.0
300.753,6,36,8309,19,2831,16708.0,1687.0,509.0,17,5478,536.0,2667.0,435.0
0.012,6,10,1990,5,911,3.0,643.0,643.0,5,1079,3.0,811.0,811.0
0.004,6,10,2006,5,927,1.0,659.0,659.0,5,1079,1.0,811.0,811.0
0.134,6,10,1506,5,395,29.0,127.0,127.0,5,1111,28.0,843.0,843.0
40.056,17,10,676,5,460,10013.0,104.0,64.0,5,216,10010.0,20.0,15.0
0.123,6,10,1506,5,395,28.0,127.0,127.0,5,1111,29.0,843.0,843.0
0.058,6,10,1506,5,395,11.0,127.0,127.0,5,1111,13.0,843.0,843.0
0.005,17,2,170,1,65,0.0,37.0,37.0,1,105,0.0,77.0,77.0
407.613,6,41,12177,22,5730,19410.0,1402.0,508.0,19,6447,19312.0,1402.0,605.0
0.079,6,10,1506,5,395,17.0,127.0,127.0,5,1111,19.0,843.0,843.0
0.008,17,2,194,1,59,0.0,31.0,31.0,1,135,0.0,107.0,107.0
0.13,17,2,170,1,65,0.0,37.0,37.0,1,105,0.0,77.0,77.0
0.095,6,10,1506,5,395,19.0,127.0,127.0,5,1111,21.0,843.0,843.0
0.005,6,10,2006,5,927,1.0,659.0,659.0,5,1079,1.0,811.0,811.0
0.007,6,10,1989,5,910,1.0,642.0,642.0,5,1079,1.0,811.0,811.0
0.005,6,10,2006,5,927,1.0,659.0,659.0,5,1079,1.0,811.0,811.0
0.005,6,10,2006,5,927,1.0,659.0,659.0,5,1079,1.0,811.0,811.0
0.167,17,2,152,1,76,0.0,48.0,48.0,1,76,0.0,48.0,48.0
0.005,17,2,194,1,59,0.0,31.0,31.0,1,135,0.0,107.0,107.0
0.013,6,10,1972,5,910,3.0,642.0,642.0,5,1062,3.0,794.0,794.0
0.005,6,10,1689,5,839,1.0,571.0,571.0,5,850,1.0,582.0,582.0
0.018,6,10,1762,5,911,4.0,643.0,643.0,5,851,4.0,583.0,583.0
0.008,6,12,1926,6,1189,1.0,659.0,434.0,6,737,1.0,417.0,417.0
0.003,17,2,136,1,60,0.0,32.0,32.0,1,76,0.0,48.0,48.0
0.054,6,10,1506,5,395,11.0,127.0,127.0,5,1111,13.0,843.0,843.0
1770.724,6,135,6510,75,3585,23925.0,39.0,39.0,60,2925,30008.0,35.0,35.0
0.039,17,4,284,2,120,0.0,32.0,32.0,2,164,36.0,60.0,54.0
0.076,6,10,1506,5,395,16.0,127.0,127.0,5,1111,16.0,843.0,843.0
0.083,6,10,1506,5,395,19.0,127.0,127.0,5,1111,17.0,843.0,843.0
0.007,17,2,194,1,59,0.0,31.0,31.0,1,135,0.0,107.0,107.0
0.006,6,10,1689,5,839,1.0,571.0,571.0,5,850,1.0,582.0,582.0
0.001,17,2,180,1,66,0.0,38.0,38.0,1,114,0.0,86.0,86.0
0.008,6,10,1990,5,911,2.0,643.0,643.0,5,1079,2.0,811.0,811.0
1.074,17,2,144,1,64,0.0,36.0,36.0,1,80,0.0,52.0,52.0
0.098,6,10,1506,5,395,21.0,127.0,127.0,5,1111,20.0,843.0,843.0
0.129,6,10,1506,5,395,29.0,127.0,127.0,5,1111,28.0,843.0,843.0
0.004,17,2,168,1,76,0.0,48.0,48.0,1,92,0.0,64.0,64.0
0.006,6,10,1547,5,764,1.0,496.0,496.0,5,783,1.0,515.0,515.0
0.092,6,10,1506,5,395,18.0,127.0,127.0,5,1111,19.0,843.0,843.0
0.005,6,10,2007,5,928,1.0,660.0,660.0,5,1079,1.0,811.0,811.0
0.006,6,10,1854,5,889,1.0,621.0,621.0,5,965,1.0,697.0,697.0
0.102,6,10,1506,5,395,18.0,127.0,127.0,5,1111,22.0,843.0,843.0
0.006,17,2,424,1,72,0.0,44.0,44.0,1,352,0.0,324.0,324.0
10.76,17,28,4422,14,1994,818.0,269.0,114.0,14,2428,818.0,587.0,145.0
0.086,6,10,1506,5,395,20.0,127.0,127.0,5,1111,16.0,843.0,843.0
0.022,6,10,1989,5,910,5.0,642.0,642.0,5,1079,5.0,811.0,811.0
0.005,6,10,2006,5,927,1.0,659.0,659.0,5,1079,1.0,811.0,811.0
0.005,6,10,2007,5,928,1.0,660.0,660.0,5,1079,1.0,811.0,811.0
0.004,6,10,1779,5,928,1.0,660.0,660.0,5,851,1.0,583.0,583.0
0.011,17,2,154,1,69,0.0,41.0,41.0,1,85,0.0,57.0,57.0
0.004,6,10,1702,5,863,0.0,595.0,595.0,5,839,1.0,571.0,571.0
0.005,17,2,170,1,65,0.0,37.0,37.0,1,105,0.0,77.0,77.0
0.005,6,10,2007,5,928,1.0,660.0,660.0,5,1079,1.0,811.0,811.0
10.762,17,28,4421,14,1993,819.0,268.0,114.0,14,2428,819.0,587.0,145.0
0.005,6,10,1689,5,839,1.0,571.0,571.0,5,850,1.0,582.0,582.0
0.114,6,10,1989,5,910,28.0,642.0,642.0,5,1079,28.0,811.0,811.0
0.079,6,10,1506,5,395,17.0,127.0,127.0,5,1111,16.0,843.0,843.0
11.126,17,28,4417,14,1993,843.0,268.0,114.0,14,2424,843.0,587.0,145.0
0.005,6,10,1989,5,927,1.0,659.0,659.0,5,1062,1.0,794.0,794.0
0.005,17,2,180,1,58,0.0,30.0,30.0,1,122,0.0,94.0,94.0
0.005,6,10,1779,5,928,1.0,660.0,660.0,5,851,1.0,583.0,583.0
11.375,17,28,4395,14,1995,862.0,270.0,114.0,14,2400,862.0,587.0,143.0
0.004,17,4,284,2,120,1.0,32.0,32.0,2,164,1.0,60.0,54.0
0.005,6,10,2006,5,927,1.0,659.0,659.0,5,1079,1.0,811.0,811.0
87.118,6,21,8146,11,1985,84.0,1174.0,504.0,10,6161,9660.0,2720.0,958.0
0.004,17,2,136,1,60,0.0,32.0,32.0,1,76,0.0,48.0,48.0
0.038,17,2,184,1,61,0.0,33.0,33.0,1,123,0.0,95.0,95.0
0.004,17,2,136,1,60,0.0,32.0,32.0,1,76,0.0,48.0,48.0
0.006,6,10,1854,5,889,1.0,621.0,621.0,5,965,1.0,697.0,697.0
0.005,17,2,164,1,74,0.0,46.0,46.0,1,90,0.0,62.0,62.0
0.004,6,10,1702,5,863,1.0,595.0,595.0,5,839,0.0,571.0,571.0
0.006,17,2,134,1,59,0.0,31.0,31.0,1,75,0.0,47.0,47.0
0.006,6,10,1689,5,839,1.0,571.0,571.0,5,850,1.0,582.0,582.0
0.001,17,2,180,1,66,0.0,38.0,38.0,1,114,0.0,86.0,86.0
0.076,6,10,1506,5,395,16.0,127.0,127.0,5,1111,14.0,843.0,843.0
0.006,6,10,1547,5,764,1.0,496.0,496.0,5,783,1.0,515.0,515.0
0.015,6,10,1983,5,910,3.0,642.0,642.0,5,1073,3.0,805.0,805.0
0.039,17,2,144,1,64,0.0,36.0,36.0,1,80,0.0,52.0,52.0
0.015,6,10,1989,5,910,3.0,642.0,642.0,5,1079,3.0,811.0,811.0
0.005,6,10,1989,5,927,1.0,659.0,659.0,5,1062,1.0,794.0,794.0
0.009,6,10,1990,5,911,2.0,643.0,643.0,5,1079,2.0,811.0,811.0
0.014,6,10,1631,5,848,3.0,580.0,580.0,5,783,3.0,515.0,515.0
0.114,6,10,1506,5,395,23.0,127.0,127.0,5,1111,28.0,843.0,843.0
0.007,6,12,1698,6,863,1.0,327.0,271.0,6,835,1.0,515.0,515.0
0.124,6,10,1506,5,395,24.0,127.0,127.0,5,1111,27.0,843.0,843.0
0.0,17,2,166,1,75,0.0,47.0,47.0,1,91,0.0,63.0,63.0
308.213,17,20,1124,10,716,34235.0,48.0,43.0,10,408,34238.0,20.0,12.0
0.024,6,10,1989,5,910,6.0,642.0,642.0,5,1079,6.0,811.0,811.0
0.005,6,10,1547,5,764,1.0,496.0,496.0,5,783,1.0,515.0,515.0
15.069,17,15,9239,8,6902,2148.0,1350.0,834.0,7,2337,2506.0,1350.0,305.0
0.001,17,2,136,1,60,0.0,32.0,32.0,1,76,0.0,48.0,48.0
0.01,6,10,1972,5,910,2.0,642.0,642.0,5,1062,2.0,794.0,794.0
0.004,6,10,2006,5,927,1.0,659.0,659.0,5,1079,1.0,811.0,811.0
0.005,17,2,180,1,58,0.0,30.0,30.0,1,122,0.0,94.0,94.0
0.094,6,10,1506,5,395,20.0,127.0,127.0,5,1111,18.0,843.0,843.0
0.017,6,10,1989,5,910,4.0,642.0,642.0,5,1079,4.0,811.0,811.0
0.012,6,10,1990,5,911,3.0,643.0,643.0,5,1079,3.0,811.0,811.0
1.119,6,33,13432,19,5933,62.0,1360.0,732.0,14,7499,72.0,2565.0,769.0
0.015,6,10,1972,5,910,3.0,642.0,642.0,5,1062,3.0,794.0,794.0
0.168,17,2,152,1,76,0.0,48.0,48.0,1,76,0.0,48.0,48.0
0.004,6,10,1702,5,863,1.0,595.0,595.0,5,839,1.0,571.0,571.0
15.078,17,15,9238,8,6902,2149.0,1350.0,834.0,7,2336,2508.0,1350.0,305.0
0.0,17,2,154,1,69,0.0,41.0,41.0,1,85,0.0,57.0,57.0
0.011,6,13,3735,7,497,1.0,125.0,125.0,6,3238,2.0,1470.0,1459.0
308.454,17,20,1124,10,716,34265.0,48.0,43.0,10,408,34265.0,20.0,12.0
0.004,6,10,1702,5,863,1.0,595.0,595.0,5,839,0.0,571.0,571.0
0.053,6,14,3787,7,497,8.0,125.0,125.0,7,3290,8.0,1448.0,972.0
0.005,6,10,2006,5,927,1.0,659.0,659.0,5,1079,1.0,811.0,811.0
0.089,6,10,1506,5,395,19.0,127.0,127.0,5,1111,19.0,843.0,843.0
0.005,6,10,2000,5,927,1.0,659.0,659.0,5,1073,1.0,805.0,805.0
0.38,17,44,22068,23,18475,17.0,1350.0,775.0,21,3593,17.0,1350.0,143.0
0.003,17,2,152,1,76,0.0,48.0,48.0,1,76,0.0,48.0,48.0
0.01,6,10,1972,5,910,2.0,642.0,642.0,5,1062,2.0,794.0,794.0
0.009,6,10,1990,5,911,2.0,643.0,643.0,5,1079,2.0,811.0,811.0
0.109,6,10,1506,5,395,20.0,127.0,127.0,5,1111,23.0,843.0,843.0
0.013,17,2,152,1,56,0.0,28.0,28.0,1,96,0.0,68.0,68.0
0.053,6,10,1506,5,395,12.0,127.0,127.0,5,1111,12.0,843.0,843.0
0.009,6,10,1677,5,827,2.0,559.0,559.0,5,850,2.0,582.0,582.0
0.005,17,2,144,1,64,0.0,36.0,36.0,1,80,0.0,52.0,52.0
1135.819,6,63,22767,33,8309,35494.0,1402.0,548.0,30,14458,37095.0,1402.0,758.0
0.072,17,4,420,2,122,1.0,33.0,33.0,2,298,69.0,145.0,121.0
0.014,6,10,1762,5,911,3.0,643.0,643.0,5,851,3.0,583.0,583.0
0.006,6,10,1689,5,839,1.0,571.0,571.0,5,850,1.0,582.0,582.0
0.006,17,2,140,1,62,0.0,34.0,34.0,1,78,0.0,50.0,50.0
0.097,6,10,1506,5,395,18.0,127.0,127.0,5,1111,22.0,843.0,843.0
1.124,6,32,13391,18,5892,66.0,2720.0,854.0,14,7499,73.0,2720.0,769.0
0.006,6,10,1547,5,764,1.0,496.0,496.0,5,783,1.0,515.0,515.0
0.005,6,10,1689,5,839,1.0,571.0,571.0,5,850,1.0,582.0,582.0
0.004,6,10,1702,5,863,1.0,595.0,595.0,5,839,1.0,571.0,571.0
0.008,17,2,170,1,65,0.0,37.0,37.0,1,105,0.0,77.0,77.0
0.004,17,2,136,1,60,0.0,32.0,32.0,1,76,0.0,48.0,48.0
0.01,6,10,1989,5,910,2.0,642.0,642.0,5,1079,2.0,811.0,811.0
0.005,17,2,152,1,68,0.0,40.0,40.0,1,84,0.0,56.0,56.0
0.075,6,14,3787,7,497,12.0,125.0,125.0,7,3290,12.0,1448.0,972.0
0.032,6,13,3735,7,497,5.0,125.0,125.0,6,3238,6.0,1470.0,1459.0
0.004,6,10,2006,5,927,1.0,659.0,659.0,5,1079,1.0,811.0,811.0
0.017,6,10,1972,5,910,4.0,642.0,642.0,5,1062,4.0,794.0,794.0
0.041,17,4,352,2,130,1.0,37.0,37.0,2,222,0.0,89.0,83.0
0.005,6,10,2006,5,927,1.0,659.0,659.0,5,1079,1.0,811.0,811.0
0.005,6,10,1643,5,860,1.0,592.0,592.0,5,783,1.0,515.0,515.0
10.828,17,28,4421,14,1994,824.0,269.0,114.0,14,2427,824.0,586.0,145.0
0.006,17,2,144,1,64,0.0,36.0,36.0,1,80,0.0,52.0,52.0
0.015,6,10,1677,5,827,3.0,559.0,559.0,5,850,3.0,582.0,582.0
0.01,6,10,1989,5,910,2.0,642.0,642.0,5,1079,2.0,811.0,811.0
0.003,17,2,136,1,60,0.0,32.0,32.0,1,76,0.0,48.0,48.0
1768.455,17,92,8096,46,4048,39298.0,60.0,60.0,46,4048,39298.0,60.0,60.0
15.071,17,15,9239,8,6902,2149.0,1350.0,834.0,7,2337,2507.0,1350.0,305.0
0.119,6,10,1506,5,395,24.0,127.0,127.0,5,1111,25.0,843.0,843.0
0.015,6,10,1990,5,911,3.0,643.0,643.0,5,1079,3.0,811.0,811.0
0.005,6,10,2007,5,928,1.0,660.0,660.0,5,1079,1.0,811.0,811.0
0.006,6,10,1547,5,764,1.0,496.0,496.0,5,783,1.0,515.0,515.0
0.323,17,42,21569,23,18461,14.0,1350.0,774.0,19,3108,14.0,1350.0,135.0
0.004,17,2,136,1,60,0.0,32.0,32.0,1,76,0.0,48.0,48.0
0.018,6,10,1972,5,910,4.0,642.0,642.0,5,1062,4.0,794.0,794.0
0.009,6,14,3742,7,452,1.0,80.0,80.0,7,3290,1.0,1448.0,972.0
0.006,17,2,152,1,68,0.0,40.0,40.0,1,84,0.0,56.0,56.0
0.004,6,10,2006,5,927,1.0,659.0,659.0,5,1079,1.0,811.0,811.0
0.006,6,10,1547,5,764,1.0,496.0,496.0,5,783,1.0,515.0,515.0
0.01,6,10,1990,5,911,2.0,643.0,643.0,5,1079,2.0,811.0,811.0
0.004,17,2,136,1,60,0.0,32.0,32.0,1,76,0.0,48.0,48.0
0.005,17,2,138,1,61,0.0,33.0,33.0,1,77,0.0,49.0,49.0
0.154,6,22,5875,11,1405,14.0,326.0,165.0,11,4470,14.0,1324.0,778.0
0.018,6,10,1762,5,911,4.0,643.0,643.0,5,851,4.0,583.0,583.0
0.01,6,10,1677,5,827,2.0,559.0,559.0,5,850,2.0,582.0,582.0
0.012,6,10,1989,5,910,2.0,642.0,642.0,5,1079,2.0,811.0,811.0
0.009,6,10,1972,5,910,2.0,642.0,642.0,5,1062,2.0,794.0,794.0
331.958,6,19,2158,6,1308,12025.0,494.0,494.0,13,850,27659.0,83.0,83.0
0.006,6,10,1689,5,839,1.0,571.0,571.0,5,850,1.0,582.0,582.0
0.005,6,10,2006,5,927,1.0,659.0,659.0,5,1079,1.0,811.0,811.0
0.006,17,2,193,1,71,0.0,43.0,43.0,1,122,0.0,94.0,94.0
0.004,6,10,2000,5,927,1.0,659.0,659.0,5,1073,1.0,805.0,805.0
0.09,6,10,1506,5,395,20.0,127.0,127.0,5,1111,17.0,843.0,843.0
0.071,6,10,1506,5,395,16.0,127.0,127.0,5,1111,16.0,843.0,843.0
0.011,6,10,1762,5,911,2.0,643.0,643.0,5,851,2.0,583.0,583.0
40.053,17,10,676,5,460,10012.0,104.0,64.0,5,216,10012.0,20.0,15.0
0.005,6,10,1774,5,923,1.0,655.0,655.0,5,851,1.0,583.0,583.0
0.017,6,10,1990,5,911,4.0,643.0,643.0,5,1079,4.0,811.0,811.0
0.005,6,10,1689,5,839,1.0,571.0,571.0,5,850,1.0,582.0,582.0
0.001,17,2,180,1,66,0.0,38.0,38.0,1,114,0.0,86.0,86.0
240.089,6,31,9182,15,6648,17149.0,1770.0,652.0,16,2534,16005.0,580.0,211.0
40.054,17,10,676,5,460,10012.0,104.0,64.0,5,216,10012.0,20.0,15.0
0.006,6,13,3747,7,509,0.0,137.0,137.0,6,3238,1.0,1470.0,1459.0
0.007,6,10,1547,5,764,1.0,496.0,496.0,5,783,1.0,515.0,515.0
0.009,6,10,1677,5,827,2.0,559.0,559.0,5,850,2.0,582.0,582.0
1.128,6,32,13391,18,5892,66.0,2720.0,854.0,14,7499,73.0,2720.0,769.0
0.08,6,10,1506,5,395,17.0,127.0,127.0,5,1111,18.0,843.0,843.0
0.063,6,10,1506,5,395,13.0,127.0,127.0,5,1111,12.0,843.0,843.0
0.011,6,10,1983,5,910,2.0,642.0,642.0,5,1073,2.0,805.0,805.0
0.006,17,2,180,1,66,0.0,38.0,38.0,1,114,0.0,86.0,86.0
180.712,17,70,10106,35,2330,5314.0,44.0,38.0,35,7776,5315.0,261.0,194.0
40.073,17,10,676,5,460,10017.0,104.0,64.0,5,216,10017.0,20.0,15.0
0.006,6,10,1547,5,764,1.0,496.0,496.0,5,783,1.0,515.0,515.0
0.014,6,10,1677,5,827,3.0,559.0,559.0,5,850,3.0,582.0,582.0
0.074,6,10,1506,5,395,15.0,127.0,127.0,5,1111,17.0,843.0,843.0
0.001,17,2,180,1,66,0.0,38.0,38.0,1,114,0.0,86.0,86.0
354.059,6,21,1795,16,1030,23603.0,190.0,190.0,5,765,60001.0,464.0,248.0
240.721,6,39,9797,20,2224,12667.0,744.0,235.0,19,7573,13371.0,1402.0,549.0
0.06,17,2,152,1,76,0.0,48.0,48.0,1,76,0.0,48.0,48.0
10.817,17,28,4421,14,1993,823.0,268.0,114.0,14,2428,823.0,587.0,145.0
0.01,6,10,2006,5,927,2.0,659.0,659.0,5,1079,2.0,811.0,811.0
0.177,6,3,453,2,321,177.0,241.0,241.0,1,132,0.0,92.0,92.0
0.039,17,2,182,1,65,0.0,37.0,37.0,1,117,0.0,89.0,89.0
0.006,17,2,164,1,74,0.0,46.0,46.0,1,90,0.0,62.0,62.0
0.038,17,2,146,1,65,0.0,37.0,37.0,1,81,0.0,53.0,53.0
0.014,6,10,1972,5,910,3.0,642.0,642.0,5,1062,3.0,794.0,794.0
0.005,17,2,144,1,64,0.0,36.0,36.0,1,80,0.0,52.0,52.0
0.013,6,10,1983,5,910,3.0,642.0,642.0,5,1073,3.0,805.0,805.0
309.631,17,20,1124,10,716,34389.0,48.0,43.0,10,408,34389.0,20.0,12.0
0.005,6,10,1689,5,839,1.0,571.0,571.0,5,850,1.0,582.0,582.0
0.008,6,10,1990,5,911,2.0,643.0,643.0,5,1079,2.0,811.0,811.0
0.009,6,10,1983,5,910,2.0,642.0,642.0,5,1073,2.0,805.0,805.0
0.006,6,10,1689,5,839,1.0,571.0,571.0,5,850,1.0,582.0,582.0
0.005,6,10,1689,5,839,1.0,571.0,571.0,5,850,1.0,582.0,582.0
0.009,6,10,1972,5,910,2.0,642.0,642.0,5,1062,2.0,794.0,794.0
0.004,17,2,179,1,71,0.0,43.0,43.0,1,108,0.0,80.0,80.0
0.006,6,10,1547,5,764,1.0,496.0,496.0,5,783,1.0,515.0,515.0
0.001,17,2,180,1,66,0.0,38.0,38.0,1,114,0.0,86.0,86.0
0.223,6,16,2670,8,1396,31.0,533.0,324.0,8,1274,20.0,529.0,212.0
301.112,6,44,16741,23,10874,13686.0,3266.0,1417.0,21,5867,442.0,2667.0,385.0
0.075,6,10,1506,5,395,16.0,127.0,127.0,5,1111,16.0,843.0,843.0
0.104,6,10,1506,5,395,23.0,127.0,127.0,5,1111,23.0,843.0,843.0
0.066,6,10,1506,5,395,14.0,127.0,127.0,5,1111,12.0,843.0,843.0
308.137,17,20,1124,10,716,34229.0,48.0,43.0,10,408,34230.0,20.0,12.0
0.005,6,10,2006,5,927,1.0,659.0,659.0,5,1079,1.0,811.0,811.0
0.005,6,13,3747,7,509,0.0,137.0,137.0,6,3238,1.0,1470.0,1459.0
0.006,6,10,1689,5,839,1.0,571.0,571.0,5,850,1.0,582.0,582.0
0.003,17,2,185,1,73,0.0,45.0,45.0,1,112,0.0,84.0,84.0
0.099,6,10,1506,5,395,22.0,127.0,127.0,5,1111,19.0,843.0,843.0
0.005,6,10,1774,5,923,1.0,655.0,655.0,5,851,1.0,583.0,583.0
1778.094,17,144,45504,72,22752,25043.0,288.0,288.0,72,22752,25043.0,288.0,288.0
0.158,6,10,1506,5,395,33.0,127.0,127.0,5,1111,37.0,843.0,843.0
0.005,17,2,178,1,81,0.0,53.0,53.0,1,97,0.0,69.0,69.0
0.011,6,13,3735,7,497,1.0,125.0,125.0,6,3238,2.0,1470.0,1459.0
0.005,6,10,2006,5,927,1.0,659.0,659.0,5,1079,1.0,811.0,811.0
0.006,6,10,2006,5,927,1.0,659.0,659.0,5,1079,1.0,811.0,811.0
0.005,17,2,170,1,65,0.0,37.0,37.0,1,105,0.0,77.0,77.0
240.088,6,16,4482,9,963,30011.0,238.0,166.0,7,3519,40014.0,1402.0,786.0
0.004,17,2,148,1,60,0.0,32.0,32.0,1,88,0.0,60.0,60.0
240.01,6,9,787,5,488,60002.0,232.0,232.0,4,299,80002.0,83.0,83.0
0.01,6,10,1972,5,910,2.0,642.0,642.0,5,1062,2.0,794.0,794.0
0.006,6,10,1989,5,927,1.0,659.0,659.0,5,1062,1.0,794.0,794.0
0.005,6,10,1989,5,927,1.0,659.0,659.0,5,1062,1.0,794.0,794.0
0.005,6,10,2000,5,927,1.0,659.0,659.0,5,1073,1.0,805.0,805.0
0.011,6,10,1990,5,911,2.0,643.0,643.0,5,1079,2.0,811.0,811.0
0.014,6,10,1989,5,910,3.0,642.0,642.0,5,1079,3.0,811.0,811.0
0.008,6,12,1926,6,1189,1.0,659.0,434.0,6,737,1.0,417.0,417.0
0.005,17,2,230,1,68,0.0,40.0,40.0,1,162,0.0,134.0,134.0
0.005,17,2,166,1,75,0.0,47.0,47.0,1,91,0.0,63.0,63.0
0.005,6,10,1989,5,927,1.0,659.0,659.0,5,1062,1.0,794.0,794.0
0.015,6,14,3787,7,497,2.0,125.0,125.0,7,3290,2.0,1448.0,972.0
10.789,17,28,4423,14,1994,821.0,269.0,114.0,14,2429,821.0,588.0,145.0
0.005,6,10,2006,5,927,1.0,659.0,659.0,5,1079,1.0,811.0,811.0
0.005,6,10,1989,5,927,1.0,659.0,659.0,5,1062,1.0,794.0,794.0
177.331,17,68,9336,34,2256,5373.0,44.0,38.0,34,7080,5373.0,239.0,180.0
0.001,17,2,166,1,75,0.0,47.0,47.0,1,91,0.0,63.0,63.0
0.008,6,10,1774,5,923,1.0,655.0,655.0,5,851,1.0,583.0,583.0
0.069,6,10,1506,5,395,15.0,127.0,127.0,5,1111,14.0,843.0,843.0
60.958,6,25,17480,14,9592,4689.0,2804.0,1478.0,11,7888,6082.0,2311.0,1218.0
0.131,6,10,1506,5,395,26.0,127.0,127.0,5,1111,27.0,843.0,843.0
0.015,6,10,1989,5,910,3.0,642.0,642.0,5,1079,3.0,811.0,811.0
0.004,6,10,2007,5,928,1.0,660.0,660.0,5,1079,1.0,811.0,811.0
0.007,6,10,1547,5,764,1.0,496.0,496.0,5,783,1.0,515.0,515.0
0.08,6,10,1506,5,395,18.0,127.0,127.0,5,1111,19.0,843.0,843.0
0.005,17,2,170,1,65,0.0,37.0,37.0,1,105,0.0,77.0,77.0
0.004,17,2,136,1,60,0.0,32.0,32.0,1,76,0.0,48.0,48.0
0.073,6,10,1506,5,395,17.0,127.0,127.0,5,1111,14.0,843.0,843.0
0.328,17,47,27297,25,21228,13.0,1350.0,821.0,22,6069,12.0,1350.0,247.0
0.009,6,10,1774,5,923,2.0,655.0,655.0,5,851,2.0,583.0,583.0
0.077,6,10,1506,5,395,16.0,127.0,127.0,5,1111,15.0,843.0,843.0
40.08,17,10,676,5,460,10016.0,104.0,64.0,5,216,10019.0,20.0,15.0
309.804,17,20,1124,10,716,34409.0,48.0,43.0,10,408,34409.0,20.0,12.0
240.656,6,37,9543,19,2122,13367.0,691.0,225.0,18,7421,14154.0,1402.0,589.0
0.013,6,10,1989,5,910,3.0,642.0,642.0,5,1079,3.0,811.0,811.0
0.006,6,10,1854,5,889,1.0,621.0,621.0,5,965,1.0,697.0,697.0
0.08,6,10,1506,5,395,17.0,127.0,127.0,5,1111,17.0,843.0,843.0
0.257,17,40,21452,22,18407,12.0,1350.0,808.0,18,3045,11.0,1350.0,141.0
0.02,6,10,1972,5,910,5.0,642.0,642.0,5,1062,5.0,794.0,794.0
0.005,6,10,2000,5,927,1.0,659.0,659.0,5,1073,1.0,805.0,805.0
0.005,6,10,2006,5,927,1.0,659.0,659.0,5,1079,1.0,811.0,811.0
1783.221,6,65,7414,43,4534,42457.0,1626.0,108.0,22,2880,84907.0,1116.0,82.0
40.07,17,10,676,5,460,10015.0,104.0,64.0,5,216,10016.0,20.0,15.0
0.011,6,10,1989,5,910,2.0,642.0,642.0,5,1079,2.0,811.0,811.0
0.004,17,2,136,1,60,0.0,32.0,32.0,1,76,0.0,48.0,48.0
0.002,17,2,166,1,75,0.0,47.0,47.0,1,91,0.0,63.0,63.0
0.004,17,2,136,1,60,0.0,32.0,32.0,1,76,0.0,48.0,48.0
0.002,17,2,166,1,75,0.0,47.0,47.0,1,91,0.0,63.0,63.0
0.009,6,10,1989,5,910,2.0,642.0,642.0,5,1079,2.0,811.0,811.0
0.003,17,4,284,2,120,0.0,32.0,32.0,2,164,1.0,60.0,54.0
289.621,6,388,348236,194,21649,1500.0,2689.0,888.0,194,326587,1500.0,2804.0,1758.0
0.004,17,4,284,2,120,0.0,32.0,32.0,2,164,1.0,60.0,54.0
0.125,6,10,1506,5,395,28.0,127.0,127.0,5,1111,25.0,843.0,843.0
40.059,17,10,676,5,460,10012.0,104.0,64.0,5,216,10011.0,20.0,15.0
0.207,6,16,2778,8,1396,29.0,533.0,324.0,8,1382,18.0,529.0,239.0
240.081,6,19,4915,9,2224,30010.0,1021.0,586.0,10,2691,26675.0,1162.0,432.0
0.334,17,40,20105,22,17080,15.0,1350.0,748.0,18,3025,15.0,1350.0,140.0
0.008,17,2,169,1,62,0.0,34.0,34.0,1,107,0.0,79.0,79.0
337.34,6,28,7444,17,1950,21083.0,253.0,176.0,11,5494,33733.0,1402.0,703.0
0.168,6,3,453,2,321,168.0,241.0,241.0,1,132,0.0,92.0,92.0
0.018,6,10,1762,5,911,4.0,643.0,643.0,5,851,4.0,583.0,583.0
0.008,6,12,1698,6,863,1.0,327.0,271.0,6,835,1.0,515.0,515.0
0.004,17,2,148,1,60,0.0,32.0,32.0,1,88,0.0,60.0,60.0
0.004,6,10,1702,5,863,1.0,595.0,595.0,5,839,0.0,571.0,571.0
0.042,17,2,148,1,60,0.0,32.0,32.0,1,88,0.0,60.0,60.0
0.011,6,10,1989,5,910,2.0,642.0,642.0,5,1079,2.0,811.0,811.0
0.007,6,10,1547,5,764,1.0,496.0,496.0,5,783,1.0,515.0,515.0
0.004,17,2,136,1,60,0.0,32.0,32.0,1,76,0.0,48.0,48.0
40.073,17,10,676,5,460,10016.0,104.0,64.0,5,216,10017.0,20.0,15.0
0.005,6,10,2006,5,927,1.0,659.0,659.0,5,1079,1.0,811.0,811.0
0.001,17,2,179,1,62,0.0,34.0,34.0,1,117,0.0,89.0,89.0
0.004,6,10,2006,5,927,1.0,659.0,659.0,5,1079,1.0,811.0,811.0
0.004,17,2,136,1,60,0.0,32.0,32.0,1,76,0.0,48.0,48.0
0.084,6,10,1506,5,395,18.0,127.0,127.0,5,1111,18.0,843.0,843.0
0.034,17,2,152,1,76,0.0,48.0,48.0,1,76,0.0,48.0,48.0
0.004,6,10,2007,5,928,1.0,660.0,660.0,5,1079,1.0,811.0,811.0
0.086,6,10,1506,5,395,18.0,127.0,127.0,5,1111,17.0,843.0,843.0
0.005,6,10,2006,5,927,1.0,659.0,659.0,5,1079,1.0,811.0,811.0
40.051,17,10,676,5,460,10012.0,104.0,64.0,5,216,10012.0,20.0,15.0
176.096,17,76,11167,38,2548,4759.0,44.0,39.0,38,8619,4759.0,279.0,198.0
0.111,6,10,1506,5,395,25.0,127.0,127.0,5,1111,25.0,843.0,843.0
0.011,6,10,1989,5,910,2.0,642.0,642.0,5,1079,2.0,811.0,811.0
1787.157,6,150,19350,90,13740,20080.0,302.0,302.0,60,5610,30290.0,83.0,83.0
0.016,17,2,198,1,91,0.0,63.0,63.0,1,107,0.0,79.0,79.0
0.13,6,10,1506,5,395,30.0,127.0,127.0,5,1111,28.0,843.0,843.0
0.258,17,2,152,1,76,0.0,48.0,48.0,1,76,0.0,48.0,48.0
0.004,17,2,148,1,60,0.0,32.0,32.0,1,88,0.0,60.0,60.0
0.008,17,4,284,2,120,5.0,32.0,32.0,2,164,5.0,60.0,54.0
0.071,6,10,1506,5,395,14.0,127.0,127.0,5,1111,14.0,843.0,843.0
11.125,17,28,4417,14,1993,843.0,268.0,114.0,14,2424,843.0,587.0,145.0
0.006,6,10,1547,5,764,1.0,496.0,496.0,5,783,1.0,515.0,515.0
0.017,17,2,179,1,71,0.0,43.0,43.0,1,108,0.0,80.0,80.0
0.121,6,10,1506,5,395,25.0,127.0,127.0,5,1111,26.0,843.0,843.0
0.006,6,10,1547,5,764,1.0,496.0,496.0,5,783,1.0,515.0,515.0
0.006,6,10,1547,5,764,1.0,496.0,496.0,5,783,1.0,515.0,515.0
0.009,6,10,1677,5,827,2.0,559.0,559.0,5,850,2.0,582.0,582.0
0.006,6,10,2006,5,927,1.0,659.0,659.0,5,1079,1.0,811.0,811.0
0.07,6,10,1506,5,395,15.0,127.0,127.0,5,1111,13.0,843.0,843.0
0.005,6,10,2006,5,927,1.0,659.0,659.0,5,1079,1.0,811.0,811.0
0.02,6,10,1989,5,910,4.0,642.0,642.0,5,1079,5.0,811.0,811.0
0.005,6,13,3747,7,509,0.0,137.0,137.0,6,3238,0.0,1470.0,1459.0
0.012,6,10,1972,5,910,2.0,642.0,642.0,5,1062,2.0,794.0,794.0
0.001,17,2,180,1,66,0.0,38.0,38.0,1,114,0.0,86.0,86.0
0.007,6,10,1547,5,764,1.0,496.0,496.0,5,783,1.0,515.0,515.0
0.01,6,13,3735,7,497,1.0,125.0,125.0,6,3238,2.0,1470.0,1459.0
0.016,6,19,9922,11,704,1.0,124.0,124.0,8,9218,2.0,2896.0,2198.0
40.061,17,10,676,5,460,10013.0,104.0,64.0,5,216,10014.0,20.0,15.0
0.013,6,10,1989,5,910,3.0,642.0,642.0,5,1079,3.0,811.0,811.0
0.005,6,10,2007,5,928,1.0,660.0,660.0,5,1079,1.0,811.0,811.0
0.215,6,10,1506,5,395,49.0,127.0,127.0,5,1111,40.0,843.0,843.0
1777.838,6,304,97703,188,86516,9507.0,2001.0,679.0,116,11187,15459.0,452.0,70.0
40.065,17,10,676,5,460,10015.0,104.0,64.0,5,216,10013.0,20.0,15.0
0.005,6,10,2006,5,927,1.0,659.0,659.0,5,1079,1.0,811.0,811.0
0.013,6,10,1631,5,848,3.0,580.0,580.0,5,783,3.0,515.0,515.0
0.006,17,2,178,1,65,0.0,37.0,37.0,1,113,0.0,85.0,85.0
11.142,17,28,4424,14,1995,845.0,270.0,114.0,14,2429,844.0,588.0,145.0
0.006,6,10,1854,5,889,1.0,621.0,621.0,5,965,1.0,697.0,697.0
242.022,6,388,348277,194,21608,1254.0,2736.0,885.0,194,326669,1253.0,2864.0,1720.0
0.004,17,2,234,1,61,0.0,33.0,33.0,1,173,0.0,145.0,145.0
0.007,6,10,2007,5,928,1.0,660.0,660.0,5,1079,1.0,811.0,811.0
0.126,17,2,182,1,65,0.0,37.0,37.0,1,117,0.0,89.0,89.0
0.016,6,10,1631,5,848,3.0,580.0,580.0,5,783,3.0,515.0,515.0
0.013,6,10,1990,5,911,3.0,643.0,643.0,5,1079,3.0,811.0,811.0
0.005,6,10,1779,5,928,1.0,660.0,660.0,5,851,1.0,583.0,583.0
0.119,6,10,1506,5,395,23.0,127.0,127.0,5,1111,27.0,843.0,843.0
0.084,6,10,1506,5,395,18.0,127.0,127.0,5,1111,20.0,843.0,843.0
0.004,6,10,2007,5,928,1.0,660.0,660.0,5,1079,1.0,811.0,811.0
0.005,6,10,1989,5,927,1.0,659.0,659.0,5,1062,1.0,794.0,794.0
0.004,6,10,1779,5,928,1.0,660.0,660.0,5,851,1.0,583.0,583.0
0.015,6,10,1989,5,910,3.0,642.0,642.0,5,1079,3.0,811.0,811.0
0.007,6,10,1547,5,764,1.0,496.0,496.0,5,783,1.0,515.0,515.0
0.005,6,10,1989,5,927,1.0,659.0,659.0,5,1062,1.0,794.0,794.0
0.107,6,10,1506,5,395,23.0,127.0,127.0,5,1111,25.0,843.0,843.0
0.006,6,10,1547,5,764,1.0,496.0,496.0,5,783,1.0,515.0,515.0
0.005,17,2,194,1,59,0.0,31.0,31.0,1,135,0.0,107.0,107.0
0.014,6,10,1989,5,910,3.0,642.0,642.0,5,1079,3.0,811.0,811.0
0.006,6,10,1547,5,764,1.0,496.0,496.0,5,783,1.0,515.0,515.0
0.005,6,10,2006,5,927,1.0,659.0,659.0,5,1079,1.0,811.0,811.0
0.005,6,10,1774,5,923,1.0,655.0,655.0,5,851,1.0,583.0,583.0
0.011,6,10,1989,5,910,2.0,642.0,642.0,5,1079,2.0,811.0,811.0
0.005,6,10,2000,5,927,1.0,659.0,659.0,5,1073,1.0,805.0,805.0
0.008,6,10,1989,5,910,1.0,642.0,642.0,5,1079,1.0,811.0,811.0
40.059,17,10,676,5,460,10012.0,104.0,64.0,5,216,10014.0,20.0,15.0
0.096,6,10,1506,5,395,21.0,127.0,127.0,5,1111,21.0,843.0,843.0
0.004,6,10,2006,5,927,1.0,659.0,659.0,5,1079,1.0,811.0,811.0
0.008,6,12,1926,6,1189,1.0,659.0,434.0,6,737,1.0,417.0,417.0
0.764,6,10,2009,6,1655,152.0,1403.0,1403.0,4,354,175.0,182.0,182.0
240.085,6,16,4481,9,963,30010.0,238.0,166.0,7,3518,40013.0,1402.0,786.0
11.359,17,28,4423,14,1995,860.0,270.0,114.0,14,2428,861.0,587.0,145.0
0.01,6,10,1983,5,910,2.0,642.0,642.0,5,1073,2.0,805.0,805.0
0.085,6,10,1506,5,395,20.0,127.0,127.0,5,1111,17.0,843.0,843.0
0.109,6,10,1506,5,395,23.0,127.0,127.0,5,1111,23.0,843.0,843.0
0.01,6,10,1972,5,910,2.0,642.0,642.0,5,1062,2.0,794.0,794.0
0.005,6,10,1990,5,928,1.0,660.0,660.0,5,1062,1.0,794.0,794.0
369.774,6,22,2313,16,867,24651.0,195.0,195.0,6,1446,4680.0,419.0,398.0
0.004,6,10,1989,5,927,1.0,659.0,659.0,5,1062,1.0,794.0,794.0
0.004,6,10,1774,5,923,1.0,655.0,655.0,5,851,1.0,583.0,583.0
0.004,17,2,152,1,76,0.0,48.0,48.0,1,76,0.0,48.0,48.0
0.234,17,38,20060,21,17033,11.0,1350.0,783.0,17,3027,10.0,1350.0,150.0
0.005,6,13,3747,7,509,0.0,137.0,137.0,6,3238,1.0,1470.0,1459.0
0.006,6,10,1779,5,928,1.0,660.0,660.0,5,851,1.0,583.0,583.0
352.761,6,20,2210,6,1308,12004.0,494.0,494.0,14,902,27135.0,83.0,83.0
0.005,6,10,1689,5,839,1.0,571.0,571.0,5,850,1.0,582.0,582.0
0.012,6,10,1989,5,910,2.0,642.0,642.0,5,1079,3.0,811.0,811.0
0.004,6,10,1774,5,923,1.0,655.0,655.0,5,851,1.0,583.0,583.0
0.224,6,10,1506,5,395,52.0,127.0,127.0,5,1111,55.0,843.0,843.0
0.023,6,10,1631,5,848,5.0,580.0,580.0,5,783,5.0,515.0,515.0
0.011,6,10,1972,5,910,2.0,642.0,642.0,5,1062,2.0,794.0,794.0
0.012,6,10,1972,5,910,3.0,642.0,642.0,5,1062,3.0,794.0,794.0
0.007,6,10,1989,5,927,1.0,659.0,659.0,5,1062,1.0,794.0,794.0
0.094,6,10,1506,5,395,20.0,127.0,127.0,5,1111,22.0,843.0,843.0
240.113,6,16,4482,9,963,30014.0,238.0,166.0,7,3519,40015.0,1402.0,786.0
0.013,6,10,1972,5,910,3.0,642.0,642.0,5,1062,3.0,794.0,794.0
0.005,17,2,140,1,62,0.0,34.0,34.0,1,78,0.0,50.0,50.0
0.01,6,10,1990,5,911,2.0,643.0,643.0,5,1079,2.0,811.0,811.0
240.089,6,16,4481,9,963,30011.0,238.0,166.0,7,3518,40014.0,1402.0,786.0
0.094,6,10,1506,5,395,21.0,127.0,127.0,5,1111,21.0,843.0,843.0
0.048,17,2,136,1,60,0.0,32.0,32.0,1,76,0.0,48.0,48.0
0.005,6,10,2006,5,927,1.0,659.0,659.0,5,1079,1.0,811.0,811.0
0.071,17,2,156,1,64,0.0,36.0,36.0,1,92,0.0,64.0,64.0
162.292,17,72,10164,36,2402,4636.0,44.0,38.0,36,7762,4636.0,239.0,187.0
0.061,17,2,152,1,76,0.0,48.0,48.0,1,76,0.0,48.0,48.0
0.003,17,2,152,1,76,0.0,48.0,48.0,1,76,0.0,48.0,48.0
0.079,6,10,1506,5,395,19.0,127.0,127.0,5,1111,15.0,843.0,843.0
0.004,17,4,420,2,122,0.0,33.0,33.0,2,298,0.0,145.0,121.0
0.182,17,4,596,2,122,143.0,33.0,33.0,2,474,142.0,323.0,209.0
0.004,6,10,2006,5,927,1.0,659.0,659.0,5,1079,1.0,811.0,811.0
0.019,6,10,1972,5,910,4.0,642.0,642.0,5,1062,4.0,794.0,794.0
0.115,6,10,1506,5,395,22.0,127.0,127.0,5,1111,25.0,843.0,843.0
0.074,6,10,1506,5,395,15.0,127.0,127.0,5,1111,17.0,843.0,843.0
0.019,6,10,1972,5,910,4.0,642.0,642.0,5,1062,4.0,794.0,794.0
0.005,17,2,164,1,74,0.0,46.0,46.0,1,90,0.0,62.0,62.0
0.013,6,10,1989,5,910,3.0,642.0,642.0,5,1079,3.0,811.0,811.0
0.012,6,10,1990,5,911,3.0,643.0,643.0,5,1079,3.0,811.0,811.0
0.004,6,10,1779,5,928,1.0,660.0,660.0,5,851,1.0,583.0,583.0
0.009,6,10,1990,5,911,2.0,643.0,643.0,5,1079,2.0,811.0,811.0
0.012,6,10,1989,5,910,2.0,642.0,642.0,5,1079,2.0,811.0,811.0
371.389,6,22,2313,16,867,24759.0,195.0,195.0,6,1446,4637.0,419.0,398.0
0.005,17,2,140,1,62,0.0,34.0,34.0,1,78,0.0,50.0,50.0
0.005,6,10,2006,5,927,1.0,659.0,659.0,5,1079,1.0,811.0,811.0
176.09,17,98,14642,49,3308,3668.0,44.0,39.0,49,11334,3668.0,279.0,203.0
0.014,6,10,1990,5,911,3.0,643.0,643.0,5,1079,3.0,811.0,811.0
0.016,6,10,1972,5,910,4.0,642.0,642.0,5,1062,3.0,794.0,794.0
0.006,6,10,1547,5,764,1.0,496.0,496.0,5,783,1.0,515.0,515.0
0.06,17,2,184,1,61,0.0,33.0,33.0,1,123,0.0,95.0,95.0
0.014,6,10,1989,5,910,3.0,642.0,642.0,5,1079,3.0,811.0,811.0
0.015,6,10,1989,5,910,3.0,642.0,642.0,5,1079,3.0,811.0,811.0
0.004,6,10,2006,5,927,1.0,659.0,659.0,5,1079,1.0,811.0,811.0
0.005,6,10,2007,5,928,1.0,660.0,660.0,5,1079,1.0,811.0,811.0
0.005,17,2,284,1,69,0.0,41.0,41.0,1,215,0.0,187.0,187.0
0.004,6,10,1774,5,923,1.0,655.0,655.0,5,851,1.0,583.0,583.0
0.046,17,2,152,1,76,0.0,48.0,48.0,1,76,0.0,48.0,48.0
292.281,6,398,349080,210,22492,1398.0,2736.0,889.0,188,326588,1562.0,2804.0,1820.0
300.018,6,12,1782,7,1348,50003.0,494.0,494.0,5,434,75004.0,83.0,83.0
0.021,6,10,1972,5,910,5.0,642.0,642.0,5,1062,5.0,794.0,794.0
0.089,6,10,1506,5,395,19.0,127.0,127.0,5,1111,14.0,843.0,843.0
0.091,6,10,1506,5,395,20.0,127.0,127.0,5,1111,21.0,843.0,843.0
170.158,17,92,13202,46,3104,3781.0,44.0,39.0,46,10098,3781.0,239.0,191.0
0.007,17,2,148,1,60,0.0,32.0,32.0,1,88,0.0,60.0,60.0
295.772,17,118,16709,59,3920,5099.0,44.0,38.0,59,12789,5099.0,239.0,188.0
482.777,6,33,9458,18,3948,28398.0,676.0,429.0,15,5510,30194.0,1402.0,674.0
82.27,6,22,9233,11,1575,78.0,794.0,367.0,11,7658,8213.0,1360.0,1029.0
0.004,6,10,1989,5,927,1.0,659.0,659.0,5,1062,1.0,794.0,794.0
40.057,17,10,676,5,460,10013.0,104.0,64.0,5,216,10013.0,20.0,15.0
0.091,6,10,1506,5,395,22.0,127.0,127.0,5,1111,22.0,843.0,843.0
162.386,17,92,13441,46,3105,3608.0,44.0,39.0,46,10336,3608.0,261.0,196.0
0.009,6,10,1972,5,910,2.0,642.0,642.0,5,1062,2.0,794.0,794.0
0.014,6,10,1677,5,827,3.0,559.0,559.0,5,850,3.0,582.0,582.0
0.1,6,10,1506,5,395,21.0,127.0,127.0,5,1111,22.0,843.0,843.0
0.008,6,10,1989,5,910,2.0,642.0,642.0,5,1079,2.0,811.0,811.0
0.005,6,10,2007,5,928,1.0,660.0,660.0,5,1079,1.0,811.0,811.0
300.406,6,16,2170,9,684,37529.0,146.0,146.0,7,1486,50039.0,419.0,398.0
40.059,17,10,676,5,460,10014.0,104.0,64.0,5,216,10014.0,20.0,15.0
0.109,6,10,1506,5,395,25.0,127.0,127.0,5,1111,25.0,843.0,843.0
11.82,17,30,4654,16,2225,780.0,268.0,111.0,14,2429,900.0,588.0,145.0
0.109,6,10,1506,5,395,24.0,127.0,127.0,5,1111,23.0,843.0,843.0
0.005,6,10,1547,5,764,1.0,496.0,496.0,5,783,1.0,515.0,515.0
240.35,6,27,11804,13,5853,20029.0,1881.0,1036.0,14,5951,18488.0,1656.0,869.0
0.005,6,10,2000,5,927,1.0,659.0,659.0,5,1073,1.0,805.0,805.0
0.105,6,10,1506,5,395,24.0,127.0,127.0,5,1111,24.0,843.0,843.0
0.083,6,10,1506,5,395,18.0,127.0,127.0,5,1111,17.0,843.0,843.0
240.292,6,37,10850,18,2057,14134.0,606.0,160.0,19,8793,13349.0,2093.0,708.0
0.006,6,10,1689,5,839,1.0,571.0,571.0,5,850,1.0,582.0,582.0
0.117,6,10,1506,5,395,26.0,127.0,127.0,5,1111,27.0,843.0,843.0
0.017,6,10,1990,5,911,4.0,643.0,643.0,5,1079,4.0,811.0,811.0
0.004,6,10,1774,5,923,1.0,655.0,655.0,5,851,1.0,583.0,583.0
174.102,17,82,11549,41,2749,4352.0,44.0,39.0,41,8800,4352.0,239.0,186.0
0.012,6,10,1972,5,910,2.0,642.0,642.0,5,1062,3.0,794.0,794.0
0.006,6,10,1547,5,764,1.0,496.0,496.0,5,783,1.0,515.0,515.0
0.151,6,10,1506,5,395,26.0,127.0,127.0,5,1111,34.0,843.0,843.0
0.086,6,10,1506,5,395,19.0,127.0,127.0,5,1111,19.0,843.0,843.0
240.093,6,16,4481,9,963,30011.0,238.0,166.0,7,3518,40014.0,1402.0,786.0
164.341,17,88,12668,44,2960,3821.0,44.0,39.0,44,9708,3821.0,239.0,192.0
0.175,6,3,453,2,321,175.0,241.0,241.0,1,132,0.0,92.0,92.0
0.005,6,10,2000,5,927,1.0,659.0,659.0,5,1073,1.0,805.0,805.0
0.004,17,2,136,1,60,0.0,32.0,32.0,1,76,0.0,48.0,48.0
0.006,17,2,169,1,62,0.0,34.0,34.0,1,107,0.0,79.0,79.0
0.028,6,10,1677,5,827,7.0,559.0,559.0,5,850,7.0,582.0,582.0
0.004,17,4,284,2,120,0.0,32.0,32.0,2,164,0.0,60.0,54.0
0.005,6,10,2006,5,927,1.0,659.0,659.0,5,1079,1.0,811.0,811.0
0.005,6,13,3747,7,509,0.0,137.0,137.0,6,3238,0.0,1470.0,1459.0
0.019,6,10,1972,5,910,4.0,642.0,642.0,5,1062,4.0,794.0,794.0
0.006,6,10,1547,5,764,1.0,496.0,496.0,5,783,1.0,515.0,515.0
0.004,17,4,284,2,120,0.0,32.0,32.0,2,164,1.0,60.0,54.0
310.099,17,19,1076,10,716,34442.0,48.0,43.0,9,360,38747.0,12.0,12.0
40.058,17,10,676,5,460,10013.0,104.0,64.0,5,216,10013.0,20.0,15.0
0.013,6,10,1990,5,911,3.0,643.0,643.0,5,1079,3.0,811.0,811.0
333.483,17,20,1124,10,716,37038.0,48.0,43.0,10,408,37039.0,20.0,12.0
0.005,6,10,1643,5,860,1.0,592.0,592.0,5,783,1.0,515.0,515.0
0.096,17,2,144,1,64,0.0,36.0,36.0,1,80,0.0,52.0,52.0
0.051,6,13,3816,7,578,8.0,206.0,206.0,6,3238,10.0,1470.0,1459.0
0.009,6,10,1989,5,910,2.0,642.0,642.0,5,1079,2.0,811.0,811.0
0.005,6,10,2006,5,927,1.0,659.0,659.0,5,1079,1.0,811.0,811.0
0.015,6,10,1990,5,911,3.0,643.0,643.0,5,1079,3.0,811.0,811.0
0.079,6,10,1506,5,395,17.0,127.0,127.0,5,1111,16.0,843.0,843.0
1730.405,6,50,3084,32,1875,55819.0,35.0,35.0,18,1209,101784.0,31.0,31.0
0.009,6,10,1989,5,910,2.0,642.0,642.0,5,1079,2.0,811.0,811.0
0.011,6,10,1989,5,910,2.0,642.0,642.0,5,1079,2.0,811.0,811.0
0.017,6,10,1972,5,910,4.0,642.0,642.0,5,1062,4.0,794.0,794.0
0.042,17,4,352,2,130,2.0,37.0,37.0,2,222,3.0,89.0,83.0
0.005,6,10,1689,5,839,1.0,571.0,571.0,5,850,1.0,582.0,582.0
0.012,6,10,1972,5,910,3.0,642.0,642.0,5,1062,3.0,794.0,794.0
10.74,17,28,4422,14,1994,818.0,269.0,114.0,14,2428,818.0,587.0,145.0
0.037,17,2,182,1,65,0.0,37.0,37.0,1,117,0.0,89.0,89.0
0.011,6,10,1983,5,910,2.0,642.0,642.0,5,1073,2.0,805.0,805.0
0.01,6,10,1989,5,910,2.0,642.0,642.0,5,1079,2.0,811.0,811.0
0.006,6,10,1854,5,889,1.0,621.0,621.0,5,965,1.0,697.0,697.0
40.068,17,10,676,5,460,10016.0,104.0,64.0,5,216,10016.0,20.0,15.0
0.005,6,10,2000,5,927,1.0,659.0,659.0,5,1073,1.0,805.0,805.0
0.086,6,10,1506,5,395,19.0,127.0,127.0,5,1111,18.0,843.0,843.0
0.167,17,2,152,1,76,0.0,48.0,48.0,1,76,0.0,48.0,48.0
40.066,17,10,676,5,460,10013.0,104.0,64.0,5,216,10015.0,20.0,15.0
0.004,6,10,1779,5,928,1.0,660.0,660.0,5,851,1.0,583.0,583.0
0.022,6,10,1983,5,910,5.0,642.0,642.0,5,1073,5.0,805.0,805.0
0.04,17,2,170,1,65,0.0,37.0,37.0,1,105,0.0,77.0,77.0
40.067,17,10,676,5,460,10015.0,104.0,64.0,5,216,10015.0,20.0,15.0
0.005,6,10,1689,5,839,1.0,571.0,571.0,5,850,1.0,582.0,582.0
0.019,6,14,3787,7,497,3.0,125.0,125.0,7,3290,3.0,1448.0,972.0
0.004,6,10,1774,5,923,1.0,655.0,655.0,5,851,1.0,583.0,583.0
0.095,6,10,1506,5,395,19.0,127.0,127.0,5,1111,21.0,843.0,843.0
0.005,17,2,164,1,74,0.0,46.0,46.0,1,90,0.0,62.0,62.0
0.013,6,10,1972,5,910,3.0,642.0,642.0,5,1062,3.0,794.0,794.0
0.106,6,10,1506,5,395,23.0,127.0,127.0,5,1111,24.0,843.0,843.0
40.056,17,10,676,5,460,10012.0,104.0,64.0,5,216,10013.0,20.0,15.0
0.005,6,10,1779,5,928,1.0,660.0,660.0,5,851,1.0,583.0,583.0
0.069,6,10,1506,5,395,14.0,127.0,127.0,5,1111,14.0,843.0,843.0
366.045,6,22,2313,16,867,24403.0,195.0,195.0,6,1446,4642.0,419.0,398.0
0.006,6,10,1689,5,839,1.0,571.0,571.0,5,850,1.0,582.0,582.0
0.015,6,10,1989,5,910,3.0,642.0,642.0,5,1079,3.0,811.0,811.0
27.211,58,2,144,1,72,0.0,24.0,24.0,1,72,0.0,24.0,24.0
0.004,17,2,136,1,60,0.0,32.0,32.0,1,76,0.0,48.0,48.0
1769.838,6,87,4651,43,2290,42137.0,27.0,27.0,44,2361,41158.0,26.0,24.0
0.006,6,10,1547,5,764,1.0,496.0,496.0,5,783,1.0,515.0,515.0
0.079,6,10,1506,5,395,17.0,127.0,127.0,5,1111,16.0,843.0,843.0
0.006,6,10,1547,5,764,1.0,496.0,496.0,5,783,1.0,515.0,515.0
0.004,17,2,148,1,60,0.0,32.0,32.0,1,88,0.0,60.0,60.0
0.011,6,10,1990,5,911,2.0,643.0,643.0,5,1079,2.0,811.0,811.0
10.716,17,28,4422,14,1993,816.0,268.0,114.0,14,2429,815.0,588.0,145.0
1758.221,6,66,7464,42,4484,42883.0,1640.0,109.0,24,2980,76437.0,1112.0,82.0
10.501,6,31,10313,17,9046,656.0,2261.0,1020.0,14,1267,807.0,213.0,89.0
0.001,17,2,179,1,62,0.0,34.0,34.0,1,117,0.0,89.0,89.0
0.009,6,13,3735,7,497,1.0,125.0,125.0,6,3238,1.0,1470.0,1459.0
0.004,6,10,2000,5,927,1.0,659.0,659.0,5,1073,1.0,805.0,805.0
0.085,6,10,1506,5,395,19.0,127.0,127.0,5,1111,17.0,843.0,843.0
657.965,6,63,24382,33,6140,20561.0,676.0,490.0,30,18242,20617.0,1402.0,833.0
0.094,6,10,1506,5,395,21.0,127.0,127.0,5,1111,23.0,843.0,843.0
0.006,17,2,170,1,65,0.0,37.0,37.0,1,105,0.0,77.0,77.0
0.005,17,2,214,1,75,0.0,47.0,47.0,1,139,0.0,111.0,111.0
0.06,17,2,152,1,76,0.0,48.0,48.0,1,76,0.0,48.0,48.0
0.052,6,10,1989,5,910,13.0,642.0,642.0,5,1079,13.0,811.0,811.0
0.087,6,10,1506,5,395,20.0,127.0,127.0,5,1111,19.0,843.0,843.0
0.004,6,10,1989,5,927,1.0,659.0,659.0,5,1062,1.0,794.0,794.0
40.075,17,10,676,5,460,10015.0,104.0,64.0,5,216,10017.0,20.0,15.0
0.005,6,10,1547,5,764,1.0,496.0,496.0,5,783,1.0,515.0,515.0
0.006,6,10,1547,5,764,1.0,496.0,496.0,5,783,1.0,515.0,515.0
0.006,6,10,1989,5,927,1.0,659.0,659.0,5,1062,1.0,794.0,794.0
0.005,6,10,2007,5,928,1.0,660.0,660.0,5,1079,1.0,811.0,811.0
66.622,6,22,10140,12,3973,6056.0,1579.0,835.0,10,6167,7383.0,2111.0,939.0
0.001,17,2,180,1,66,0.0,38.0,38.0,1,114,0.0,86.0,86.0
0.009,6,10,1989,5,910,2.0,642.0,642.0,5,1079,2.0,811.0,811.0
0.011,6,10,1989,5,910,2.0,642.0,642.0,5,1079,2.0,811.0,811.0
9.037,17,6,376,5,280,2259.0,28.0,28.0,1,96,0.0,68.0,68.0
0.136,6,10,1506,5,395,30.0,127.0,127.0,5,1111,29.0,843.0,843.0
0.005,6,10,2006,5,927,1.0,659.0,659.0,5,1079,1.0,811.0,811.0
0.017,6,10,1983,5,910,4.0,642.0,642.0,5,1073,4.0,805.0,805.0
0.004,6,10,2007,5,928,1.0,660.0,660.0,5,1079,1.0,811.0,811.0
1747.5,6,424,64076,252,35168,6962.0,613.0,197.0,172,28908,10218.0,453.0,142.0
0.012,6,10,1990,5,911,3.0,643.0,643.0,5,1079,3.0,811.0,811.0
170.219,17,68,9774,34,2267,5157.0,44.0,38.0,34,7507,5158.0,239.0,192.0
0.009,6,10,1989,5,910,2.0,642.0,642.0,5,1079,2.0,811.0,811.0
0.008,17,2,194,1,59,0.0,31.0,31.0,1,135,0.0,107.0,107.0
0.006,6,10,1689,5,839,1.0,571.0,571.0,5,850,1.0,582.0,582.0
0.005,6,10,1702,5,863,1.0,595.0,595.0,5,839,1.0,571.0,571.0
0.009,6,12,1926,6,1189,1.0,659.0,434.0,6,737,1.0,417.0,417.0
0.003,17,2,148,1,60,0.0,32.0,32.0,1,88,0.0,60.0,60.0
0.006,6,10,1989,5,927,1.0,659.0,659.0,5,1062,1.0,794.0,794.0
0.067,6,10,1506,5,395,14.0,127.0,127.0,5,1111,16.0,843.0,843.0
0.031,6,10,1990,5,911,7.0,643.0,643.0,5,1079,7.0,811.0,811.0
0.009,17,2,164,1,74,0.0,46.0,46.0,1,90,0.0,62.0,62.0
0.04,17,4,284,2,120,0.0,32.0,32.0,2,164,36.0,60.0,54.0
0.004,6,10,1779,5,928,1.0,660.0,660.0,5,851,1.0,583.0,583.0
0.023,6,13,3735,7,497,3.0,125.0,125.0,6,3238,4.0,1470.0,1459.0
0.005,6,10,1779,5,928,1.0,660.0,660.0,5,851,1.0,583.0,583.0
0.101,6,10,1506,5,395,23.0,127.0,127.0,5,1111,22.0,843.0,843.0
0.005,6,10,1643,5,860,1.0,592.0,592.0,5,783,1.0,515.0,515.0
0.136,17,4,284,2,120,7.0,32.0,32.0,2,164,133.0,60.0,54.0
0.006,6,10,1547,5,764,1.0,496.0,496.0,5,783,1.0,515.0,515.0
0.077,6,10,1506,5,395,15.0,127.0,127.0,5,1111,17.0,843.0,843.0
0.016,6,10,1631,5,848,3.0,580.0,580.0,5,783,3.0,515.0,515.0
0.003,17,2,136,1,60,0.0,32.0,32.0,1,76,0.0,48.0,48.0
0.02,6,10,1762,5,911,5.0,643.0,643.0,5,851,5.0,583.0,583.0
0.001,17,2,180,1,66,0.0,38.0,38.0,1,114,0.0,86.0,86.0
0.007,6,10,1547,5,764,1.0,496.0,496.0,5,783,1.0,515.0,515.0
0.006,17,2,157,1,59,0.0,31.0,31.0,1,98,0.0,70.0,70.0
0.005,6,10,1689,5,839,1.0,571.0,571.0,5,850,1.0,582.0,582.0
0.226,6,16,2669,8,1395,32.0,533.0,323.0,8,1274,20.0,529.0,212.0
0.012,6,10,1983,5,910,3.0,642.0,642.0,5,1073,3.0,805.0,805.0
0.009,6,10,1972,5,910,2.0,642.0,642.0,5,1062,2.0,794.0,794.0
0.017,6,10,1990,5,911,4.0,643.0,643.0,5,1079,4.0,811.0,811.0
0.012,6,10,1989,5,910,3.0,642.0,642.0,5,1079,2.0,811.0,811.0
0.103,6,10,1506,5,395,22.0,127.0,127.0,5,1111,24.0,843.0,843.0
0.106,6,10,1506,5,395,21.0,127.0,127.0,5,1111,22.0,843.0,843.0
0.005,6,10,1989,5,927,1.0,659.0,659.0,5,1062,1.0,794.0,794.0
0.006,6,10,1774,5,923,1.0,655.0,655.0,5,851,1.0,583.0,583.0
0.005,17,2,214,1,75,0.0,47.0,47.0,1,139,0.0,111.0,111.0
300.328,6,27,8925,15,1930,21452.0,517.0,285.0,12,6995,21847.0,1402.0,909.0
0.001,17,2,180,1,66,0.0,38.0,38.0,1,114,0.0,86.0,86.0
0.004,17,2,148,1,60,0.0,32.0,32.0,1,88,0.0,60.0,60.0
0.063,6,10,1506,5,395,13.0,127.0,127.0,5,1111,14.0,843.0,843.0
40.07,17,10,676,5,460,10014.0,104.0,64.0,5,216,10016.0,20.0,15.0
0.087,6,10,1506,5,395,19.0,127.0,127.0,5,1111,21.0,843.0,843.0
0.078,6,10,1506,5,395,17.0,127.0,127.0,5,1111,15.0,843.0,843.0
240.693,6,37,9658,19,2174,13370.0,746.0,235.0,18,7484,14156.0,1402.0,595.0
0.006,17,2,144,1,64,0.0,36.0,36.0,1,80,0.0,52.0,52.0
240.551,6,27,7887,12,3525,21868.0,1211.0,726.0,15,4362,17182.0,1162.0,397.0
1792.767,6,481,98467,242,87370,7438.0,421.0,369.0,239,11097,7531.0,53.0,53.0
0.012,6,10,1989,5,910,2.0,642.0,642.0,5,1079,3.0,811.0,811.0
1.026,6,12,3142,6,2099,154.0,1328.0,923.0,6,1043,154.0,791.0,791.0
0.005,6,10,2000,5,927,1.0,659.0,659.0,5,1073,1.0,805.0,805.0
0.006,6,10,1547,5,764,1.0,496.0,496.0,5,783,1.0,515.0,515.0
0.204,6,11,1558,6,447,35.0,127.0,127.0,5,1111,45.0,843.0,843.0
0.016,6,10,1762,5,911,3.0,643.0,643.0,5,851,4.0,583.0,583.0
0.018,6,10,1631,5,848,4.0,580.0,580.0,5,783,4.0,515.0,515.0
0.003,17,2,148,1,60,0.0,32.0,32.0,1,88,0.0,60.0,60.0
0.011,6,10,1990,5,911,2.0,643.0,643.0,5,1079,2.0,811.0,811.0
0.039,17,2,152,1,76,0.0,48.0,48.0,1,76,0.0,48.0,48.0
0.001,17,2,166,1,75,0.0,47.0,47.0,1,91,0.0,63.0,63.0
0.089,6,10,1506,5,395,19.0,127.0,127.0,5,1111,20.0,843.0,843.0
0.004,6,10,1779,5,928,1.0,660.0,660.0,5,851,1.0,583.0,583.0
0.031,6,10,1983,5,910,7.0,642.0,642.0,5,1073,7.0,805.0,805.0
0.005,6,10,1779,5,928,1.0,660.0,660.0,5,851,1.0,583.0,583.0
0.115,6,10,1506,5,395,23.0,127.0,127.0,5,1111,18.0,843.0,843.0
0.083,6,10,1506,5,395,17.0,127.0,127.0,5,1111,19.0,843.0,843.0
0.005,6,10,1689,5,839,1.0,571.0,571.0,5,850,1.0,582.0,582.0
1756.142,6,105,6270,60,3525,29764.0,27.0,27.0,45,2745,39911.0,27.0,27.0
0.019,6,10,1972,5,910,4.0,642.0,642.0,5,1062,4.0,794.0,794.0
0.004,6,14,3742,8,504,0.0,80.0,80.0,6,3238,0.0,1470.0,1459.0
15.078,17,15,9238,8,6902,2149.0,1350.0,834.0,7,2336,2508.0,1350.0,305.0
0.006,6,10,1547,5,764,1.0,496.0,496.0,5,783,1.0,515.0,515.0
0.005,6,10,2006,5,927,1.0,659.0,659.0,5,1079,1.0,811.0,811.0
0.084,6,10,1506,5,395,20.0,127.0,127.0,5,1111,18.0,843.0,843.0
0.011,6,13,3735,7,497,1.0,125.0,125.0,6,3238,2.0,1470.0,1459.0
0.004,6,10,2007,5,928,1.0,660.0,660.0,5,1079,1.0,811.0,811.0
0.014,6,10,1989,5,910,3.0,642.0,642.0,5,1079,3.0,811.0,811.0
0.093,6,10,1506,5,395,21.0,127.0,127.0,5,1111,20.0,843.0,843.0
0.077,6,10,1506,5,395,17.0,127.0,127.0,5,1111,17.0,843.0,843.0
0.005,6,10,2000,5,927,1.0,659.0,659.0,5,1073,1.0,805.0,805.0
0.015,6,10,1677,5,827,3.0,559.0,559.0,5,850,3.0,582.0,582.0
0.005,6,10,2006,5,927,1.0,659.0,659.0,5,1079,1.0,811.0,811.0
0.011,6,10,1983,5,910,2.0,642.0,642.0,5,1073,2.0,805.0,805.0
1782.727,6,261,31962,103,21994,17476.0,1938.0,205.0,158,9968,11354.0,242.0,51.0
0.006,6,10,1689,5,839,1.0,571.0,571.0,5,850,1.0,582.0,582.0
171.43,17,94,13563,47,3157,3726.0,44.0,39.0,47,10406,3726.0,239.0,193.0
0.003,17,2,136,1,60,0.0,32.0,32.0,1,76,0.0,48.0,48.0
40.059,17,10,676,5,460,10014.0,104.0,64.0,5,216,10014.0,20.0,15.0
0.006,6,10,1547,5,764,1.0,496.0,496.0,5,783,1.0,515.0,515.0
0.164,17,2,152,1,76,0.0,48.0,48.0,1,76,0.0,48.0,48.0
240.126,6,34,9578,18,7007,14125.0,1976.0,675.0,16,2571,16008.0,580.0,216.0
0.008,6,10,1990,5,911,2.0,643.0,643.0,5,1079,1.0,811.0,811.0
0.018,6,13,3913,7,495,2.0,123.0,123.0,6,3418,3.0,1650.0,1549.0
40.058,17,10,676,5,460,10012.0,104.0,64.0,5,216,10013.0,20.0,15.0
0.066,17,8,3613,4,1874,22.0,1350.0,440.0,4,1739,11.0,1350.0,406.0
0.011,6,10,1990,5,911,2.0,643.0,643.0,5,1079,2.0,811.0,811.0
0.072,17,2,148,1,60,0.0,32.0,32.0,1,88,0.0,60.0,60.0
0.003,6,10,1702,5,863,0.0,595.0,595.0,5,839,0.0,571.0,571.0
0.009,6,10,1631,5,848,2.0,580.0,580.0,5,783,2.0,515.0,515.0
0.042,17,2,136,1,60,0.0,32.0,32.0,1,76,0.0,48.0,48.0
0.004,6,10,1774,5,923,1.0,655.0,655.0,5,851,1.0,583.0,583.0
40.065,17,10,676,5,460,10011.0,104.0,64.0,5,216,10014.0,20.0,15.0
0.115,17,4,352,2,130,76.0,37.0,37.0,2,222,44.0,89.0,83.0
0.006,6,10,1547,5,764,1.0,496.0,496.0,5,783,1.0,515.0,515.0
0.033,6,10,1983,5,910,8.0,642.0,642.0,5,1073,8.0,805.0,805.0
0.007,6,10,1774,5,923,1.0,655.0,655.0,5,851,1.0,583.0,583.0
0.006,6,10,1643,5,860,1.0,592.0,592.0,5,783,1.0,515.0,515.0
0.001,17,2,179,1,62,0.0,34.0,34.0,1,117,0.0,89.0,89.0
300.115,6,39,10113,21,4595,14997.0,1360.0,620.0,18,5518,17643.0,2667.0,435.0
0.017,6,10,1989,5,910,4.0,642.0,642.0,5,1079,4.0,811.0,811.0
300.094,6,19,4660,11,1102,30008.0,238.0,130.0,8,3558,42870.0,1402.0,786.0
0.004,6,10,2000,5,927,1.0,659.0,659.0,5,1073,1.0,805.0,805.0
0.004,6,10,1702,5,863,0.0,595.0,595.0,5,839,1.0,571.0,571.0
0.004,6,10,1989,5,927,1.0,659.0,659.0,5,1062,1.0,794.0,794.0
0.063,6,10,1506,5,395,13.0,127.0,127.0,5,1111,13.0,843.0,843.0
0.012,6,10,1972,5,910,3.0,642.0,642.0,5,1062,2.0,794.0,794.0
0.115,6,10,1506,5,395,27.0,127.0,127.0,5,1111,24.0,843.0,843.0
0.014,6,10,1989,5,910,3.0,642.0,642.0,5,1079,3.0,811.0,811.0
0.009,6,10,1677,5,827,2.0,559.0,559.0,5,850,2.0,582.0,582.0
0.095,6,10,1506,5,395,21.0,127.0,127.0,5,1111,17.0,843.0,843.0
0.097,6,10,1506,5,395,22.0,127.0,127.0,5,1111,22.0,843.0,843.0
0.007,17,2,179,1,71,0.0,43.0,43.0,1,108,0.0,80.0,80.0
0.006,6,10,1547,5,764,1.0,496.0,496.0,5,783,1.0,515.0,515.0
0.005,6,14,3742,8,504,0.0,80.0,80.0,6,3238,0.0,1470.0,1459.0
240.095,6,21,4924,11,941,24009.0,180.0,93.0,10,3983,26675.0,1591.0,575.0
0.006,17,2,169,1,62,0.0,34.0,34.0,1,107,0.0,79.0,79.0
0.012,6,10,1990,5,911,3.0,643.0,643.0,5,1079,3.0,811.0,811.0
240.097,6,16,4481,9,963,30012.0,238.0,166.0,7,3518,40015.0,1402.0,786.0
0.005,6,13,3690,7,452,0.0,80.0,80.0,6,3238,1.0,1470.0,1459.0
0.091,6,10,1506,5,395,19.0,127.0,127.0,5,1111,20.0,843.0,843.0
0.007,6,10,1990,5,911,1.0,643.0,643.0,5,1079,1.0,811.0,811.0
0.005,6,10,2007,5,928,1.0,660.0,660.0,5,1079,1.0,811.0,811.0
0.005,6,10,1702,5,863,1.0,595.0,595.0,5,839,1.0,571.0,571.0
0.157,6,10,1506,5,395,31.0,127.0,127.0,5,1111,34.0,843.0,843.0
0.046,17,2,154,1,69,0.0,41.0,41.0,1,85,0.0,57.0,57.0
0.005,17,2,225,1,65,0.0,37.0,37.0,1,160,0.0,132.0,132.0
10.938,17,28,4370,14,2312,832.0,587.0,137.0,14,2058,832.0,269.0,119.0
289.282,6,381,348096,191,21503,1522.0,2736.0,889.0,190,326593,1530.0,4171.0,1799.0
0.115,6,10,1506,5,395,25.0,127.0,127.0,5,1111,25.0,843.0,843.0
0.01,6,10,1989,5,910,2.0,642.0,642.0,5,1079,2.0,811.0,811.0
0.001,17,2,136,1,60,0.0,32.0,32.0,1,76,0.0,48.0,48.0
0.006,6,10,1854,5,889,1.0,621.0,621.0,5,965,1.0,697.0,697.0
0.006,17,2,225,1,65,0.0,37.0,37.0,1,160,0.0,132.0,132.0
0.011,6,13,3735,7,497,1.0,125.0,125.0,6,3238,2.0,1470.0,1459.0
0.005,17,2,157,1,59,0.0,31.0,31.0,1,98,0.0,70.0,70.0
0.006,6,10,1689,5,839,1.0,571.0,571.0,5,850,1.0,582.0,582.0
0.005,6,10,1702,5,863,1.0,595.0,595.0,5,839,1.0,571.0,571.0
282.216,6,27,6560,11,1226,28220.0,267.0,156.0,16,5334,18813.0,1400.0,781.0
0.015,6,13,3735,7,497,2.0,125.0,125.0,6,3238,2.0,1470.0,1459.0
0.006,6,10,1547,5,764,1.0,496.0,496.0,5,783,1.0,515.0,515.0
0.009,17,4,284,2,120,0.0,32.0,32.0,2,164,6.0,60.0,54.0
0.006,6,10,2007,5,928,1.0,660.0,660.0,5,1079,1.0,811.0,811.0
0.012,6,10,1989,5,910,3.0,642.0,642.0,5,1079,3.0,811.0,811.0
177.247,17,84,11658,42,2806,4323.0,44.0,38.0,42,8852,4323.0,239.0,182.0
0.054,17,2,152,1,76,0.0,48.0,48.0,1,76,0.0,48.0,48.0
0.005,6,10,2007,5,928,1.0,660.0,660.0,5,1079,1.0,811.0,811.0
0.003,17,2,136,1,60,0.0,32.0,32.0,1,76,0.0,48.0,48.0
0.137,6,10,1506,5,395,32.0,127.0,127.0,5,1111,31.0,843.0,843.0
0.001,17,2,136,1,60,0.0,32.0,32.0,1,76,0.0,48.0,48.0
0.001,17,2,180,1,66,0.0,38.0,38.0,1,114,0.0,86.0,86.0
0.005,6,13,3747,7,509,0.0,137.0,137.0,6,3238,1.0,1470.0,1459.0
0.006,6,10,2000,5,927,1.0,659.0,659.0,5,1073,1.0,805.0,805.0
66.318,6,28,17627,15,9638,4737.0,2804.0,1475.0,13,7989,5512.0,2308.0,1043.0
0.267,6,16,2670,8,1396,38.0,533.0,324.0,8,1274,24.0,529.0,212.0
0.005,6,10,2007,5,928,1.0,660.0,660.0,5,1079,1.0,811.0,811.0
0.104,6,10,1506,5,395,23.0,127.0,127.0,5,1111,24.0,843.0,843.0
282.769,17,108,15080,54,3591,5335.0,44.0,38.0,54,11489,5335.0,252.0,184.0
40.068,17,10,676,5,460,10013.0,104.0,64.0,5,216,10016.0,20.0,15.0
308.926,17,20,1124,10,716,34311.0,48.0,43.0,10,408,34311.0,20.0,12.0
0.119,6,10,1506,5,395,26.0,127.0,127.0,5,1111,28.0,843.0,843.0
0.006,6,10,2006,5,927,1.0,659.0,659.0,5,1079,1.0,811.0,811.0
1778.401,17,144,45504,72,22752,25047.0,288.0,288.0,72,22752,25047.0,288.0,288.0
0.007,17,2,179,1,71,0.0,43.0,43.0,1,108,0.0,80.0,80.0
0.038,17,4,352,2,130,0.0,37.0,37.0,2,222,35.0,89.0,83.0
0.006,6,10,1547,5,764,1.0,496.0,496.0,5,783,1.0,515.0,515.0
0.022,6,10,1983,5,910,5.0,642.0,642.0,5,1073,5.0,805.0,805.0
0.086,6,10,1506,5,395,20.0,127.0,127.0,5,1111,17.0,843.0,843.0
0.074,6,10,1506,5,395,15.0,127.0,127.0,5,1111,16.0,843.0,843.0
0.09,6,10,1506,5,395,19.0,127.0,127.0,5,1111,18.0,843.0,843.0
0.005,6,10,1989,5,927,1.0,659.0,659.0,5,1062,1.0,794.0,794.0
0.006,6,10,1643,5,860,1.0,592.0,592.0,5,783,1.0,515.0,515.0
308.32,17,20,1124,10,716,34246.0,48.0,43.0,10,408,34244.0,20.0,12.0
15.093,17,15,10569,9,8280,1883.0,1350.0,892.0,6,2289,3009.0,1350.0,353.0
40.058,17,10,676,5,460,10013.0,104.0,64.0,5,216,10013.0,20.0,15.0
300.292,6,16,2170,9,684,37516.0,146.0,146.0,7,1486,50020.0,419.0,398.0
0.083,6,10,1506,5,395,16.0,127.0,127.0,5,1111,16.0,843.0,843.0
1794.272,6,555,189414,284,163553,6340.0,2883.0,918.0,271,25861,6645.0,580.0,121.0
0.004,6,10,1774,5,923,1.0,655.0,655.0,5,851,1.0,583.0,583.0
15.074,17,16,9303,8,6912,2149.0,1350.0,836.0,8,2391,2149.0,1350.0,270.0
0.093,6,10,1506,5,395,18.0,127.0,127.0,5,1111,19.0,843.0,843.0
0.005,17,2,179,1,71,0.0,43.0,43.0,1,108,0.0,80.0,80.0
0.005,6,10,2007,5,928,1.0,660.0,660.0,5,1079,1.0,811.0,811.0
0.006,6,10,1547,5,764,1.0,496.0,496.0,5,783,1.0,515.0,515.0
0.001,17,2,180,1,66,0.0,38.0,38.0,1,114,0.0,86.0,86.0
0.004,17,2,148,1,60,0.0,32.0,32.0,1,88,0.0,60.0,60.0
240.008,6,9,787,5,488,60002.0,232.0,232.0,4,299,80002.0,83.0,83.0
0.014,17,2,136,1,60,0.0,32.0,32.0,1,76,0.0,48.0,48.0
0.012,6,10,1989,5,910,3.0,642.0,642.0,5,1079,2.0,811.0,811.0
0.005,6,10,2006,5,927,1.0,659.0,659.0,5,1079,1.0,811.0,811.0
0.005,6,10,1643,5,860,1.0,592.0,592.0,5,783,1.0,515.0,515.0
0.052,17,2,144,1,64,0.0,36.0,36.0,1,80,0.0,52.0,52.0
0.011,6,10,1990,5,911,2.0,643.0,643.0,5,1079,2.0,811.0,811.0
0.017,6,10,1989,5,910,4.0,642.0,642.0,5,1079,4.0,811.0,811.0
0.007,6,10,1983,5,910,1.0,642.0,642.0,5,1073,1.0,805.0,805.0
0.005,6,10,2007,5,928,1.0,660.0,660.0,5,1079,1.0,811.0,811.0
0.089,6,10,1506,5,395,21.0,127.0,127.0,5,1111,19.0,843.0,843.0
0.005,6,10,1779,5,928,1.0,660.0,660.0,5,851,1.0,583.0,583.0
0.094,6,10,1506,5,395,23.0,127.0,127.0,5,1111,21.0,843.0,843.0
0.003,17,2,148,1,60,0.0,32.0,32.0,1,88,0.0,60.0,60.0
0.084,6,10,1506,5,395,20.0,127.0,127.0,5,1111,16.0,843.0,843.0
0.032,6,14,3787,7,497,5.0,125.0,125.0,7,3290,5.0,1448.0,972.0
240.702,6,35,8927,18,2074,14156.0,695.0,226.0,17,6853,15041.0,1402.0,597.0
0.173,6,12,2996,7,549,28.0,177.0,177.0,5,2447,34.0,1402.0,1089.0
0.011,6,10,1677,5,827,2.0,559.0,559.0,5,850,2.0,582.0,582.0
15.056,17,38,20168,22,17086,714.0,1350.0,748.0,16,3082,999.0,1350.0,164.0
240.528,6,33,9261,16,1834,16033.0,622.0,198.0,17,7427,15030.0,1402.0,595.0
0.004,6,14,3742,7,452,0.0,80.0,80.0,7,3290,0.0,1448.0,972.0
176.151,17,96,13638,48,3232,3747.0,44.0,39.0,48,10406,3747.0,249.0,188.0
0.008,6,10,1989,5,910,2.0,642.0,642.0,5,1079,2.0,811.0,811.0
0.001,17,2,180,1,66,0.0,38.0,38.0,1,114,0.0,86.0,86.0
0.005,6,10,2006,5,927,1.0,659.0,659.0,5,1079,1.0,811.0,811.0
0.006,6,10,1547,5,764,1.0,496.0,496.0,5,783,1.0,515.0,515.0
0.086,6,10,1506,5,395,21.0,127.0,127.0,5,1111,15.0,843.0,843.0
0.006,6,10,1689,5,839,1.0,571.0,571.0,5,850,1.0,582.0,582.0
0.104,6,10,1506,5,395,23.0,127.0,127.0,5,1111,22.0,843.0,843.0
0.13,17,4,420,2,122,1.0,33.0,33.0,2,298,57.0,145.0,121.0
300.473,6,29,8649,14,2477,23113.0,1225.0,348.0,15,6172,21462.0,1592.0,599.0
0.005,6,10,2000,5,927,1.0,659.0,659.0,5,1073,1.0,805.0,805.0
0.012,6,10,1972,5,910,2.0,642.0,642.0,5,1062,2.0,794.0,794.0
0.013,6,10,1972,5,910,3.0,642.0,642.0,5,1062,3.0,794.0,794.0
166.276,17,78,11062,39,2593,4375.0,44.0,38.0,39,8469,4375.0,260.0,189.0
0.078,6,10,1506,5,395,17.0,127.0,127.0,5,1111,17.0,843.0,843.0
40.062,17,10,676,5,460,10014.0,104.0,64.0,5,216,10014.0,20.0,15.0
0.07,6,10,1506,5,395,15.0,127.0,127.0,5,1111,17.0,843.0,843.0
0.01,6,10,1972,5,910,2.0,642.0,642.0,5,1062,2.0,794.0,794.0
300.782,6,37,8261,20,1830,15830.0,651.0,249.0,17,6431,539.0,2126.0,478.0
0.111,6,10,1506,5,395,24.0,127.0,127.0,5,1111,22.0,843.0,843.0
0.01,6,10,1989,5,910,2.0,642.0,642.0,5,1079,2.0,811.0,811.0
0.004,17,4,284,2,120,0.0,32.0,32.0,2,164,1.0,60.0,54.0
15.091,17,16,8406,8,6142,2151.0,1350.0,739.0,8,2264,2151.0,1350.0,255.0
0.01,6,10,1989,5,910,2.0,642.0,642.0,5,1079,2.0,811.0,811.0
0.006,6,10,1854,5,889,1.0,621.0,621.0,5,965,1.0,697.0,697.0
15.072,17,15,9238,8,6902,2149.0,1350.0,834.0,7,2336,2507.0,1350.0,305.0
0.191,6,44,11611,24,3282,8.0,1082.0,203.0,20,8329,9.0,1402.0,606.0
0.006,6,10,1547,5,764,1.0,496.0,496.0,5,783,1.0,515.0,515.0
0.005,17,2,179,1,71,0.0,43.0,43.0,1,108,0.0,80.0,80.0
0.01,6,10,1990,5,911,2.0,643.0,643.0,5,1079,2.0,811.0,811.0
0.004,17,2,148,1,60,0.0,32.0,32.0,1,88,0.0,60.0,60.0
0.03,6,10,1983,5,910,7.0,642.0,642.0,5,1073,7.0,805.0,805.0
0.014,6,10,1989,5,910,3.0,642.0,642.0,5,1079,3.0,811.0,811.0
0.006,17,2,230,1,68,0.0,40.0,40.0,1,162,0.0,134.0,134.0
0.02,6,10,1989,5,910,5.0,642.0,642.0,5,1079,4.0,811.0,811.0
0.085,6,10,1506,5,395,19.0,127.0,127.0,5,1111,18.0,843.0,843.0
0.005,17,2,144,1,64,0.0,36.0,36.0,1,80,0.0,52.0,52.0
0.014,6,10,1631,5,848,3.0,580.0,580.0,5,783,3.0,515.0,515.0
0.004,6,10,2006,5,927,1.0,659.0,659.0,5,1079,1.0,811.0,811.0
0.005,17,2,180,1,66,0.0,38.0,38.0,1,114,0.0,86.0,86.0
0.001,17,2,179,1,62,0.0,34.0,34.0,1,117,0.0,89.0,89.0
0.005,6,10,1643,5,860,1.0,592.0,592.0,5,783,1.0,515.0,515.0
0.024,6,10,1983,5,910,5.0,642.0,642.0,5,1073,5.0,805.0,805.0
0.001,17,2,180,1,66,0.0,38.0,38.0,1,114,0.0,86.0,86.0
0.005,6,10,1989,5,927,1.0,659.0,659.0,5,1062,1.0,794.0,794.0
40.06,17,10,676,5,460,10014.0,104.0,64.0,5,216,10014.0,20.0,15.0
0.179,17,4,596,2,122,141.0,33.0,33.0,2,474,141.0,323.0,209.0
40.062,17,10,676,5,460,10014.0,104.0,64.0,5,216,10014.0,20.0,15.0
240.091,6,22,13775,12,1811,21826.0,913.0,397.0,10,11964,26676.0,2804.0,1633.0
0.006,6,10,1854,5,889,1.0,621.0,621.0,5,965,1.0,697.0,697.0
0.096,6,10,1506,5,395,22.0,127.0,127.0,5,1111,18.0,843.0,843.0
0.026,6,10,1983,5,910,6.0,642.0,642.0,5,1073,6.0,805.0,805.0
0.07,17,8,3613,4,1874,23.0,1350.0,440.0,4,1739,11.0,1350.0,406.0
0.005,6,10,1989,5,927,1.0,659.0,659.0,5,1062,1.0,794.0,794.0
0.012,6,10,1990,5,911,3.0,643.0,643.0,5,1079,2.0,811.0,811.0
0.018,6,10,1989,5,910,4.0,642.0,642.0,5,1079,4.0,811.0,811.0
0.005,17,2,225,1,65,0.0,37.0,37.0,1,160,0.0,132.0,132.0
308.511,17,18,1008,9,640,38548.0,48.0,43.0,9,368,38552.0,20.0,12.0
0.008,6,12,1926,6,1189,1.0,659.0,434.0,6,737,1.0,417.0,417.0
352.743,6,20,2210,6,1308,12006.0,494.0,494.0,14,902,27133.0,83.0,83.0
0.195,6,10,1506,5,395,44.0,127.0,127.0,5,1111,46.0,843.0,843.0
0.005,6,10,1779,5,928,1.0,660.0,660.0,5,851,1.0,583.0,583.0
0.005,6,13,3690,7,452,0.0,80.0,80.0,6,3238,0.0,1470.0,1459.0
0.006,17,2,169,1,62,0.0,34.0,34.0,1,107,0.0,79.0,79.0
0.006,17,2,294,1,64,0.0,36.0,36.0,1,230,0.0,202.0,202.0
0.014,6,10,1989,5,910,3.0,642.0,642.0,5,1079,3.0,811.0,811.0
0.114,6,10,1506,5,395,14.0,127.0,127.0,5,1111,27.0,843.0,843.0
0.014,6,10,1989,5,910,3.0,642.0,642.0,5,1079,3.0,811.0,811.0
0.137,6,10,1506,5,395,32.0,127.0,127.0,5,1111,23.0,843.0,843.0
0.013,17,2,152,1,56,0.0,28.0,28.0,1,96,0.0,68.0,68.0
0.17,17,2,152,1,76,0.0,48.0,48.0,1,76,0.0,48.0,48.0
0.001,17,2,180,1,66,0.0,38.0,38.0,1,114,0.0,86.0,86.0
300.78,6,37,9401,20,3923,15830.0,1360.0,618.0,17,5478,538.0,2667.0,435.0
11.24,17,28,4395,14,2312,856.0,587.0,137.0,14,2083,856.0,270.0,120.0
0.009,6,10,2006,5,927,2.0,659.0,659.0,5,1079,2.0,811.0,811.0
0.005,6,10,1989,5,927,1.0,659.0,659.0,5,1062,1.0,794.0,794.0
0.004,17,4,284,2,120,0.0,32.0,32.0,2,164,0.0,60.0,54.0
0.011,6,10,1631,5,848,2.0,580.0,580.0,5,783,2.0,515.0,515.0
0.061,17,2,80,1,32,0.0,4.0,4.0,1,48,0.0,20.0,20.0
240.031,6,9,787,5,488,60007.0,232.0,232.0,4,299,80009.0,83.0,83.0
9.041,17,6,376,5,280,2260.0,28.0,28.0,1,96,0.0,68.0,68.0
0.096,6,10,1506,5,395,21.0,127.0,127.0,5,1111,19.0,843.0,843.0
1767.189,6,552,188797,277,162739,6402.0,2883.0,944.0,275,26058,6449.0,365.0,118.0
0.088,6,10,1506,5,395,20.0,127.0,127.0,5,1111,18.0,843.0,843.0
300.345,6,27,8925,15,1930,21453.0,517.0,285.0,12,6995,21848.0,1402.0,909.0
0.004,6,10,1989,5,927,1.0,659.0,659.0,5,1062,1.0,794.0,794.0
0.117,6,10,1506,5,395,27.0,127.0,127.0,5,1111,27.0,843.0,843.0
0.007,6,10,1972,5,910,1.0,642.0,642.0,5,1062,1.0,794.0,794.0
0.039,17,2,184,1,61,0.0,33.0,33.0,1,123,0.0,95.0,95.0
1770.038,6,87,4626,44,2340,41162.0,26.0,26.0,43,2286,42142.0,26.0,25.0
0.017,6,10,1989,5,910,4.0,642.0,642.0,5,1079,4.0,811.0,811.0
40.069,17,10,676,5,460,10016.0,104.0,64.0,5,216,10016.0,20.0,15.0
240.011,6,9,787,5,488,60002.0,232.0,232.0,4,299,80002.0,83.0,83.0
0.016,6,10,1990,5,911,3.0,643.0,643.0,5,1079,3.0,811.0,811.0
300.334,6,16,2170,9,684,37521.0,146.0,146.0,7,1486,50028.0,419.0,398.0
0.135,6,10,1506,5,395,32.0,127.0,127.0,5,1111,31.0,843.0,843.0
0.004,6,10,2006,5,927,1.0,659.0,659.0,5,1079,1.0,811.0,811.0
0.011,6,10,1972,5,910,2.0,642.0,642.0,5,1062,2.0,794.0,794.0
0.114,6,10,1506,5,395,24.0,127.0,127.0,5,1111,25.0,843.0,843.0
40.069,17,10,676,5,460,10014.0,104.0,64.0,5,216,10014.0,20.0,15.0
0.185,6,10,1506,5,395,44.0,127.0,127.0,5,1111,45.0,843.0,843.0
0.117,6,10,1506,5,395,25.0,127.0,127.0,5,1111,24.0,843.0,843.0
0.004,17,2,136,1,60,0.0,32.0,32.0,1,76,0.0,48.0,48.0
0.011,6,10,1972,5,910,2.0,642.0,642.0,5,1062,2.0,794.0,794.0
0.005,17,2,140,1,62,0.0,34.0,34.0,1,78,0.0,50.0,50.0
171.178,17,72,10184,36,2401,4890.0,44.0,38.0,36,7783,4890.0,261.0,188.0
0.007,6,10,1547,5,764,1.0,496.0,496.0,5,783,1.0,515.0,515.0
0.004,6,10,2000,5,927,1.0,659.0,659.0,5,1073,1.0,805.0,805.0
0.004,17,2,136,1,60,0.0,32.0,32.0,1,76,0.0,48.0,48.0
0.073,17,2,136,1,60,0.0,32.0,32.0,1,76,0.0,48.0,48.0
0.006,6,10,2006,5,927,1.0,659.0,659.0,5,1079,1.0,811.0,811.0
0.001,17,2,180,1,66,0.0,38.0,38.0,1,114,0.0,86.0,86.0
40.079,17,10,676,5,460,10016.0,104.0,64.0,5,216,10018.0,20.0,15.0
0.004,17,2,148,1,60,0.0,32.0,32.0,1,88,0.0,60.0,60.0
0.209,6,16,2778,8,1396,29.0,533.0,324.0,8,1382,18.0,529.0,239.0
0.088,6,10,1506,5,395,19.0,127.0,127.0,5,1111,18.0,843.0,843.0
164.063,17,74,10654,37,2481,4557.0,44.0,39.0,37,8173,4557.0,261.0,192.0
0.07,6,10,1506,5,395,15.0,127.0,127.0,5,1111,15.0,843.0,843.0
40.071,17,10,676,5,460,10017.0,104.0,64.0,5,216,10016.0,20.0,15.0
66.778,6,37,10002,19,4484,500.0,1360.0,738.0,18,5518,3917.0,2667.0,435.0
0.006,6,10,2006,5,927,1.0,659.0,659.0,5,1079,1.0,811.0,811.0
0.008,17,2,230,1,68,0.0,40.0,40.0,1,162,0.0,134.0,134.0
0.053,17,2,152,1,76,0.0,48.0,48.0,1,76,0.0,48.0,48.0
0.004,6,10,2000,5,927,1.0,659.0,659.0,5,1073,1.0,805.0,805.0
0.039,17,2,148,1,60,0.0,32.0,32.0,1,88,0.0,60.0,60.0
0.012,6,10,1990,5,911,3.0,643.0,643.0,5,1079,3.0,811.0,811.0
0.013,6,10,1990,5,911,3.0,643.0,643.0,5,1079,3.0,811.0,811.0
0.01,6,10,1762,5,911,2.0,643.0,643.0,5,851,2.0,583.0,583.0
0.037,17,2,234,1,61,0.0,33.0,33.0,1,173,0.0,145.0,145.0
0.005,6,10,2006,5,927,1.0,659.0,659.0,5,1079,1.0,811.0,811.0
0.008,6,10,1702,5,863,2.0,595.0,595.0,5,839,2.0,571.0,571.0
0.005,6,10,1643,5,860,1.0,592.0,592.0,5,783,1.0,515.0,515.0
1777.324,17,144,41760,72,22752,25032.0,288.0,288.0,72,19008,25032.0,236.0,236.0
0.005,6,10,1689,5,839,1.0,571.0,571.0,5,850,1.0,582.0,582.0
0.01,6,10,1989,5,910,2.0,642.0,642.0,5,1079,2.0,811.0,811.0
0.117,6,10,1506,5,395,23.0,127.0,127.0,5,1111,27.0,843.0,843.0
0.072,17,2,234,1,61,0.0,33.0,33.0,1,173,0.0,145.0,145.0
0.071,17,4,364,2,160,0.0,52.0,52.0,2,204,33.0,80.0,74.0
0.006,6,10,1547,5,764,1.0,496.0,496.0,5,783,1.0,515.0,515.0
0.015,6,10,1631,5,848,3.0,580.0,580.0,5,783,3.0,515.0,515.0
0.019,6,13,3735,7,497,3.0,125.0,125.0,6,3238,3.0,1470.0,1459.0
0.01,6,10,1972,5,910,2.0,642.0,642.0,5,1062,2.0,794.0,794.0
0.004,6,10,2006,5,927,1.0,659.0,659.0,5,1079,1.0,811.0,811.0
300.293,6,16,2170,9,684,37516.0,146.0,146.0,7,1486,50021.0,419.0,398.0
0.005,17,2,170,1,65,0.0,37.0,37.0,1,105,0.0,77.0,77.0
0.037,17,2,136,1,60,0.0,32.0,32.0,1,76,0.0,48.0,48.0
0.006,6,10,1547,5,764,1.0,496.0,496.0,5,783,1.0,515.0,515.0
0.226,6,16,2674,8,1400,32.0,533.0,325.0,8,1274,20.0,529.0,212.0
40.064,17,10,676,5,460,10015.0,104.0,64.0,5,216,10015.0,20.0,15.0
0.015,6,10,1989,5,910,3.0,642.0,642.0,5,1079,3.0,811.0,811.0
0.005,6,10,2006,5,927,1.0,659.0,659.0,5,1079,1.0,811.0,811.0
0.004,6,10,1989,5,927,1.0,659.0,659.0,5,1062,1.0,794.0,794.0
0.008,6,10,1989,5,910,2.0,642.0,642.0,5,1079,2.0,811.0,811.0
0.004,17,2,148,1,60,0.0,32.0,32.0,1,88,0.0,60.0,60.0
0.006,17,2,169,1,62,0.0,34.0,34.0,1,107,0.0,79.0,79.0
308.276,17,18,1008,9,640,38527.0,48.0,43.0,9,368,38526.0,20.0,12.0
0.002,17,2,152,1,76,0.0,48.0,48.0,1,76,0.0,48.0,48.0
0.003,17,2,184,1,61,0.0,33.0,33.0,1,123,0.0,95.0,95.0
0.133,6,10,1506,5,395,26.0,127.0,127.0,5,1111,31.0,843.0,843.0
0.006,17,2,164,1,74,0.0,46.0,46.0,1,90,0.0,62.0,62.0
0.005,17,2,168,1,76,0.0,48.0,48.0,1,92,0.0,64.0,64.0
0.006,17,4,284,2,120,0.0,32.0,32.0,2,164,0.0,60.0,54.0
0.014,6,10,1989,5,910,3.0,642.0,642.0,5,1079,3.0,811.0,811.0
0.014,6,10,1972,5,910,3.0,642.0,642.0,5,1062,3.0,794.0,794.0
0.006,6,10,1547,5,764,1.0,496.0,496.0,5,783,1.0,515.0,515.0
40.063,17,10,676,5,460,10013.0,104.0,64.0,5,216,10014.0,20.0,15.0
176.24,17,76,10588,38,2528,4760.0,44.0,38.0,38,8060,4763.0,261.0,184.0
0.008,6,10,1983,5,910,1.0,642.0,642.0,5,1073,1.0,805.0,805.0
0.013,6,10,1972,5,910,3.0,642.0,642.0,5,1062,3.0,794.0,794.0
0.004,17,4,284,2,120,1.0,32.0,32.0,2,164,0.0,60.0,54.0
0.06,6,10,1506,5,395,14.0,127.0,127.0,5,1111,11.0,843.0,843.0
0.004,6,10,2007,5,928,1.0,660.0,660.0,5,1079,1.0,811.0,811.0
0.067,6,10,1506,5,395,15.0,127.0,127.0,5,1111,14.0,843.0,843.0
0.09,6,10,1506,5,395,20.0,127.0,127.0,5,1111,17.0,843.0,843.0
0.005,6,10,1989,5,927,1.0,659.0,659.0,5,1062,1.0,794.0,794.0
0.006,17,2,169,1,62,0.0,34.0,34.0,1,107,0.0,79.0,79.0
40.053,17,10,676,5,460,10012.0,104.0,64.0,5,216,10012.0,20.0,15.0
40.06,17,10,676,5,460,10013.0,104.0,64.0,5,216,10014.0,20.0,15.0
40.062,17,10,676,5,460,10013.0,104.0,64.0,5,216,10014.0,20.0,15.0
0.019,6,10,1972,5,910,4.0,642.0,642.0,5,1062,4.0,794.0,794.0
0.004,6,15,3794,8,504,0.0,80.0,80.0,7,3290,0.0,1448.0,972.0
0.124,6,10,1506,5,395,28.0,127.0,127.0,5,1111,26.0,843.0,843.0
0.222,17,16,9231,8,6614,31.0,1350.0,798.0,8,2617,20.0,1350.0,299.0
0.004,6,10,1989,5,927,1.0,659.0,659.0,5,1062,1.0,794.0,794.0
0.037,17,2,148,1,60,0.0,32.0,32.0,1,88,0.0,60.0,60.0
0.005,6,10,1547,5,764,1.0,496.0,496.0,5,783,1.0,515.0,515.0
0.005,6,10,2006,5,927,1.0,659.0,659.0,5,1079,1.0,811.0,811.0
0.005,6,10,1854,5,889,1.0,621.0,621.0,5,965,1.0,697.0,697.0
0.005,6,10,1689,5,839,1.0,571.0,571.0,5,850,1.0,582.0,582.0
0.01,6,10,1989,5,910,2.0,642.0,642.0,5,1079,2.0,811.0,811.0
0.006,6,10,1689,5,839,1.0,571.0,571.0,5,850,1.0,582.0,582.0
0.039,17,2,169,1,62,0.0,34.0,34.0,1,107,0.0,79.0,79.0
0.246,6,16,2669,8,1395,35.0,533.0,323.0,8,1274,22.0,529.0,212.0
0.005,6,10,2006,5,927,1.0,659.0,659.0,5,1079,1.0,811.0,811.0
0.009,6,10,1677,5,827,2.0,559.0,559.0,5,850,2.0,582.0,582.0
0.018,6,10,1983,5,910,4.0,642.0,642.0,5,1073,4.0,805.0,805.0
0.008,6,10,1989,5,910,2.0,642.0,642.0,5,1079,1.0,811.0,811.0
0.004,17,2,148,1,60,0.0,32.0,32.0,1,88,0.0,60.0,60.0
0.005,6,10,2000,5,927,1.0,659.0,659.0,5,1073,1.0,805.0,805.0
0.006,6,13,3747,7,509,1.0,137.0,137.0,6,3238,1.0,1470.0,1459.0
0.006,6,10,1547,5,764,1.0,496.0,496.0,5,783,1.0,515.0,515.0
0.083,6,10,1506,5,395,17.0,127.0,127.0,5,1111,16.0,843.0,843.0
0.018,6,10,1972,5,910,4.0,642.0,642.0,5,1062,4.0,794.0,794.0
0.071,17,8,3613,4,1874,23.0,1350.0,440.0,4,1739,12.0,1350.0,406.0
40.145,17,10,676,5,460,10033.0,104.0,64.0,5,216,10035.0,20.0,15.0
361.837,6,19,1688,15,978,25845.0,190.0,190.0,4,710,80016.0,494.0,494.0
0.011,6,10,1989,5,910,2.0,642.0,642.0,5,1079,2.0,811.0,811.0
0.077,6,10,1506,5,395,17.0,127.0,127.0,5,1111,17.0,843.0,843.0
0.016,6,10,1990,5,911,4.0,643.0,643.0,5,1079,4.0,811.0,811.0
0.013,6,10,1990,5,911,3.0,643.0,643.0,5,1079,3.0,811.0,811.0
0.07,6,10,1506,5,395,16.0,127.0,127.0,5,1111,15.0,843.0,843.0
40.087,17,10,676,5,460,10020.0,104.0,64.0,5,216,10020.0,20.0,15.0
0.015,6,10,1990,5,911,3.0,643.0,643.0,5,1079,3.0,811.0,811.0
0.005,6,10,1547,5,764,1.0,496.0,496.0,5,783,1.0,515.0,515.0
0.056,17,2,299,1,65,0.0,37.0,37.0,1,234,0.0,206.0,206.0
0.041,17,2,182,1,65,0.0,37.0,37.0,1,117,0.0,89.0,89.0
0.001,17,2,180,1,66,0.0,38.0,38.0,1,114,0.0,86.0,86.0
0.011,6,10,1989,5,910,2.0,642.0,642.0,5,1079,2.0,811.0,811.0
0.007,6,10,2006,5,927,1.0,659.0,659.0,5,1079,1.0,811.0,811.0
0.072,6,10,1506,5,395,17.0,127.0,127.0,5,1111,14.0,843.0,843.0
0.005,6,10,1779,5,928,1.0,660.0,660.0,5,851,1.0,583.0,583.0
0.005,6,10,1989,5,927,1.0,659.0,659.0,5,1062,1.0,794.0,794.0
0.078,6,10,1506,5,395,17.0,127.0,127.0,5,1111,18.0,843.0,843.0
0.016,6,10,1990,5,911,3.0,643.0,643.0,5,1079,4.0,811.0,811.0
0.089,6,10,1506,5,395,21.0,127.0,127.0,5,1111,20.0,843.0,843.0
0.124,17,4,364,2,160,0.0,52.0,52.0,2,204,85.0,80.0,74.0
308.376,17,20,1124,10,716,34257.0,48.0,43.0,10,408,34257.0,20.0,12.0
0.015,6,10,1989,5,910,3.0,642.0,642.0,5,1079,3.0,811.0,811.0
0.038,6,10,1989,5,910,9.0,642.0,642.0,5,1079,9.0,811.0,811.0
0.005,6,10,2007,5,928,1.0,660.0,660.0,5,1079,1.0,811.0,811.0
0.014,6,13,3735,7,497,2.0,125.0,125.0,6,3238,2.0,1470.0,1459.0
0.014,6,10,1990,5,911,3.0,643.0,643.0,5,1079,3.0,811.0,811.0
15.071,17,15,9238,8,6902,2149.0,1350.0,834.0,7,2336,2506.0,1350.0,305.0
0.078,6,10,1506,5,395,17.0,127.0,127.0,5,1111,16.0,843.0,843.0
178.485,17,76,10616,38,2543,4823.0,44.0,38.0,38,8073,4823.0,239.0,184.0
0.005,6,10,1774,5,923,1.0,655.0,655.0,5,851,1.0,583.0,583.0
0.112,6,10,1506,5,395,16.0,127.0,127.0,5,1111,25.0,843.0,843.0
0.105,6,10,1506,5,395,26.0,127.0,127.0,5,1111,17.0,843.0,843.0
0.005,6,10,2006,5,927,1.0,659.0,659.0,5,1079,1.0,811.0,811.0
0.041,17,4,284,2,120,0.0,32.0,32.0,2,164,38.0,60.0,54.0
0.012,6,10,1762,5,911,2.0,643.0,643.0,5,851,2.0,583.0,583.0
0.005,6,10,1643,5,860,1.0,592.0,592.0,5,783,1.0,515.0,515.0
0.015,6,10,1989,5,910,3.0,642.0,642.0,5,1079,3.0,811.0,811.0
0.005,6,10,1779,5,928,1.0,660.0,660.0,5,851,1.0,583.0,583.0
0.011,6,10,1989,5,910,2.0,642.0,642.0,5,1079,2.0,811.0,811.0
0.008,6,10,1989,5,910,2.0,642.0,642.0,5,1079,2.0,811.0,811.0
240.014,6,9,787,5,488,60003.0,232.0,232.0,4,299,80003.0,83.0,83.0
0.004,17,4,284,2,120,0.0,32.0,32.0,2,164,0.0,60.0,54.0
0.005,6,10,2000,5,927,1.0,659.0,659.0,5,1073,1.0,805.0,805.0
0.005,6,10,2006,5,927,1.0,659.0,659.0,5,1079,1.0,811.0,811.0
0.006,17,2,293,1,73,0.0,45.0,45.0,1,220,0.0,192.0,192.0
0.006,6,10,1547,5,764,1.0,496.0,496.0,5,783,1.0,515.0,515.0
0.121,6,10,1506,5,395,24.0,127.0,127.0,5,1111,25.0,843.0,843.0
40.061,17,10,676,5,460,10012.0,104.0,64.0,5,216,10014.0,20.0,15.0
0.168,6,3,453,2,321,168.0,241.0,241.0,1,132,0.0,92.0,92.0
0.129,6,10,1506,5,395,28.0,127.0,127.0,5,1111,28.0,843.0,843.0
0.005,17,2,166,1,75,0.0,47.0,47.0,1,91,0.0,63.0,63.0
0.006,6,10,1774,5,923,1.0,655.0,655.0,5,851,1.0,583.0,583.0
0.094,6,10,1506,5,395,21.0,127.0,127.0,5,1111,18.0,843.0,843.0
0.005,6,13,3747,7,509,0.0,137.0,137.0,6,3238,1.0,1470.0,1459.0
0.087,6,10,1506,5,395,20.0,127.0,127.0,5,1111,18.0,843.0,843.0
0.005,17,2,170,1,65,0.0,37.0,37.0,1,105,0.0,77.0,77.0
0.005,6,10,2000,5,927,1.0,659.0,659.0,5,1073,1.0,805.0,805.0
0.005,6,10,1989,5,927,1.0,659.0,659.0,5,1062,1.0,794.0,794.0
0.005,6,10,1989,5,927,1.0,659.0,659.0,5,1062,1.0,794.0,794.0
0.018,6,10,1631,5,848,4.0,580.0,580.0,5,783,4.0,515.0,515.0
0.005,6,10,2007,5,928,1.0,660.0,660.0,5,1079,1.0,811.0,811.0
0.072,6,10,1506,5,395,15.0,127.0,127.0,5,1111,14.0,843.0,843.0
1768.205,17,92,8096,46,4048,39293.0,60.0,60.0,46,4048,39293.0,60.0,60.0
0.001,17,2,180,1,66,0.0,38.0,38.0,1,114,0.0,86.0,86.0
0.004,6,10,2006,5,927,1.0,659.0,659.0,5,1079,1.0,811.0,811.0
0.066,6,10,1506,5,395,13.0,127.0,127.0,5,1111,14.0,843.0,843.0
0.005,6,10,1689,5,839,1.0,571.0,571.0,5,850,1.0,582.0,582.0
0.018,6,10,1983,5,910,4.0,642.0,642.0,5,1073,4.0,805.0,805.0
0.004,6,10,1774,5,923,1.0,655.0,655.0,5,851,1.0,583.0,583.0
40.063,17,10,676,5,460,10014.0,104.0,64.0,5,216,10014.0,20.0,15.0
0.085,6,10,1506,5,395,19.0,127.0,127.0,5,1111,17.0,843.0,843.0
0.073,6,10,1506,5,395,17.0,127.0,127.0,5,1111,16.0,843.0,843.0
0.01,6,14,3787,7,497,1.0,125.0,125.0,7,3290,1.0,1448.0,972.0
356.608,6,21,1795,16,1030,23773.0,190.0,190.0,5,765,60003.0,464.0,248.0
240.357,6,44,8823,22,5738,11445.0,1368.0,458.0,22,3085,11445.0,580.0,241.0
0.007,6,10,1989,5,910,1.0,642.0,642.0,5,1079,1.0,811.0,811.0
0.223,6,16,2777,8,1395,31.0,533.0,323.0,8,1382,20.0,529.0,239.0
0.1,6,10,1506,5,395,24.0,127.0,127.0,5,1111,23.0,843.0,843.0
0.005,6,10,1989,5,927,1.0,659.0,659.0,5,1062,1.0,794.0,794.0
40.073,17,10,676,5,460,10016.0,104.0,64.0,5,216,10017.0,20.0,15.0
0.019,6,10,1989,5,910,4.0,642.0,642.0,5,1079,4.0,811.0,811.0
0.005,6,10,1989,5,927,1.0,659.0,659.0,5,1062,1.0,794.0,794.0
0.094,6,10,1506,5,395,19.0,127.0,127.0,5,1111,21.0,843.0,843.0
0.001,17,2,174,1,72,0.0,44.0,44.0,1,102,0.0,74.0,74.0
0.004,6,10,2006,5,927,1.0,659.0,659.0,5,1079,1.0,811.0,811.0
40.056,17,10,676,5,460,10013.0,104.0,64.0,5,216,10013.0,20.0,15.0
353.516,6,20,2210,6,1308,12004.0,494.0,494.0,14,902,27193.0,83.0,83.0
0.071,17,2,184,1,61,0.0,33.0,33.0,1,123,0.0,95.0,95.0
0.006,6,10,1547,5,764,1.0,496.0,496.0,5,783,1.0,515.0,515.0
96.284,6,25,5158,14,1186,7406.0,180.0,75.0,11,3972,9628.0,1591.0,678.0
0.006,17,2,170,1,65,0.0,37.0,37.0,1,105,0.0,77.0,77.0
0.086,6,10,1506,5,395,20.0,127.0,127.0,5,1111,18.0,843.0,843.0
0.005,6,10,2000,5,927,1.0,659.0,659.0,5,1073,1.0,805.0,805.0
0.005,6,10,1854,5,889,1.0,621.0,621.0,5,965,1.0,697.0,697.0
0.004,17,2,148,1,60,0.0,32.0,32.0,1,88,0.0,60.0,60.0
0.007,6,10,1983,5,910,1.0,642.0,642.0,5,1073,1.0,805.0,805.0
0.006,17,2,170,1,65,0.0,37.0,37.0,1,105,0.0,77.0,77.0
0.006,6,10,1774,5,923,1.0,655.0,655.0,5,851,1.0,583.0,583.0
0.015,17,2,148,1,60,0.0,32.0,32.0,1,88,0.0,60.0,60.0
40.065,17,10,676,5,460,10015.0,104.0,64.0,5,216,10015.0,20.0,15.0
0.005,6,10,2007,5,928,1.0,660.0,660.0,5,1079,1.0,811.0,811.0
10.797,17,26,4102,13,1822,891.0,269.0,112.0,13,2280,890.0,587.0,147.0
0.007,17,2,179,1,71,0.0,43.0,43.0,1,108,0.0,80.0,80.0
0.013,6,13,3735,7,497,2.0,125.0,125.0,6,3238,2.0,1470.0,1459.0
1.109,6,32,12791,18,3352,65.0,1360.0,517.0,14,9439,70.0,2720.0,985.0
0.004,6,10,1989,5,927,1.0,659.0,659.0,5,1062,1.0,794.0,794.0
240.096,6,16,4480,9,963,30012.0,238.0,166.0,7,3517,40015.0,1402.0,786.0
40.076,17,10,676,5,460,10015.0,104.0,64.0,5,216,10017.0,20.0,15.0
0.006,6,10,1547,5,764,1.0,496.0,496.0,5,783,1.0,515.0,515.0
0.071,17,2,234,1,61,0.0,33.0,33.0,1,173,0.0,145.0,145.0
0.012,6,10,1972,5,910,2.0,642.0,642.0,5,1062,2.0,794.0,794.0
0.086,6,10,1506,5,395,18.0,127.0,127.0,5,1111,18.0,843.0,843.0
0.003,17,2,148,1,60,0.0,32.0,32.0,1,88,0.0,60.0,60.0
0.006,17,2,170,1,65,0.0,37.0,37.0,1,105,0.0,77.0,77.0
0.106,6,10,1506,5,395,19.0,127.0,127.0,5,1111,24.0,843.0,843.0
0.005,6,10,2000,5,927,1.0,659.0,659.0,5,1073,1.0,805.0,805.0
0.113,6,10,1506,5,395,26.0,127.0,127.0,5,1111,23.0,843.0,843.0
0.084,6,10,1506,5,395,19.0,127.0,127.0,5,1111,15.0,843.0,843.0
0.005,6,10,2006,5,927,1.0,659.0,659.0,5,1079,1.0,811.0,811.0
240.078,6,16,4481,9,963,30009.0,238.0,166.0,7,3518,40012.0,1402.0,786.0
40.056,17,10,676,5,460,10013.0,104.0,64.0,5,216,10013.0,20.0,15.0
0.003,17,2,148,1,60,0.0,32.0,32.0,1,88,0.0,60.0,60.0
0.008,6,10,1972,5,910,2.0,642.0,642.0,5,1062,1.0,794.0,794.0
0.009,6,10,1989,5,910,2.0,642.0,642.0,5,1079,2.0,811.0,811.0
0.005,6,10,2000,5,927,1.0,659.0,659.0,5,1073,1.0,805.0,805.0
0.005,6,10,2006,5,927,1.0,659.0,659.0,5,1079,1.0,811.0,811.0
308.361,17,20,1124,10,716,34255.0,48.0,43.0,10,408,34255.0,20.0,12.0
0.005,6,10,2006,5,927,1.0,659.0,659.0,5,1079,1.0,811.0,811.0
0.001,17,2,180,1,66,0.0,38.0,38.0,1,114,0.0,86.0,86.0
0.118,6,10,1506,5,395,25.0,127.0,127.0,5,1111,24.0,843.0,843.0
0.005,6,14,3799,7,509,0.0,137.0,137.0,7,3290,0.0,1448.0,972.0
0.104,6,10,1506,5,395,22.0,127.0,127.0,5,1111,22.0,843.0,843.0
0.005,6,10,2006,5,927,1.0,659.0,659.0,5,1079,1.0,811.0,811.0
0.011,6,10,1972,5,910,2.0,642.0,642.0,5,1062,2.0,794.0,794.0
40.066,17,10,676,5,460,10014.0,104.0,64.0,5,216,10015.0,20.0,15.0
0.006,6,10,2000,5,927,1.0,659.0,659.0,5,1073,1.0,805.0,805.0
0.01,6,10,1989,5,910,2.0,642.0,642.0,5,1079,2.0,811.0,811.0
0.087,6,10,1506,5,395,17.0,127.0,127.0,5,1111,19.0,843.0,843.0
0.005,6,10,1774,5,923,1.0,655.0,655.0,5,851,1.0,583.0,583.0
0.32,17,38,20188,21,17050,16.0,1350.0,783.0,17,3138,12.0,1350.0,156.0
0.141,6,10,1506,5,395,31.0,127.0,127.0,5,1111,31.0,843.0,843.0
0.011,6,10,1990,5,911,2.0,643.0,643.0,5,1079,2.0,811.0,811.0
0.072,17,2,412,1,61,0.0,33.0,33.0,1,351,0.0,323.0,323.0
0.113,6,10,1506,5,395,27.0,127.0,127.0,5,1111,24.0,843.0,843.0
40.068,17,10,676,5,460,10013.0,104.0,64.0,5,216,10016.0,20.0,15.0
0.008,6,10,1677,5,827,2.0,559.0,559.0,5,850,1.0,582.0,582.0
0.013,6,13,3735,7,497,2.0,125.0,125.0,6,3238,2.0,1470.0,1459.0
0.005,17,2,169,1,62,0.0,34.0,34.0,1,107,0.0,79.0,79.0
0.001,17,2,180,1,66,0.0,38.0,38.0,1,114,0.0,86.0,86.0
0.013,6,10,1990,5,911,3.0,643.0,643.0,5,1079,3.0,811.0,811.0
0.088,6,10,1506,5,395,19.0,127.0,127.0,5,1111,21.0,843.0,843.0
0.01,6,10,1990,5,911,2.0,643.0,643.0,5,1079,2.0,811.0,811.0
164.481,17,82,11601,41,2731,4111.0,44.0,38.0,41,8870,4111.0,239.0,188.0
0.014,6,10,1972,5,910,3.0,642.0,642.0,5,1062,3.0,794.0,794.0
0.011,6,10,1989,5,910,2.0,642.0,642.0,5,1079,2.0,811.0,811.0
0.034,6,10,1990,5,911,8.0,643.0,643.0,5,1079,8.0,811.0,811.0
0.011,6,10,1983,5,910,2.0,642.0,642.0,5,1073,2.0,805.0,805.0
0.005,6,10,2006,5,927,1.0,659.0,659.0,5,1079,1.0,811.0,811.0
0.008,6,10,1989,5,910,1.0,642.0,642.0,5,1079,2.0,811.0,811.0
0.005,6,10,1989,5,927,1.0,659.0,659.0,5,1062,1.0,794.0,794.0
0.004,6,10,1702,5,863,1.0,595.0,595.0,5,839,0.0,571.0,571.0
0.005,6,10,2006,5,927,1.0,659.0,659.0,5,1079,1.0,811.0,811.0
0.123,6,10,1506,5,395,27.0,127.0,127.0,5,1111,27.0,843.0,843.0
0.011,6,10,1983,5,910,2.0,642.0,642.0,5,1073,2.0,805.0,805.0
40.057,17,10,676,5,460,10012.0,104.0,64.0,5,216,10013.0,20.0,15.0
0.014,6,10,1989,5,910,3.0,642.0,642.0,5,1079,3.0,811.0,811.0
0.005,17,2,179,1,71,0.0,43.0,43.0,1,108,0.0,80.0,80.0
11.178,17,28,4422,14,1994,847.0,269.0,114.0,14,2428,847.0,587.0,145.0
0.005,6,10,2006,5,927,1.0,659.0,659.0,5,1079,1.0,811.0,811.0
0.006,6,10,1689,5,839,1.0,571.0,571.0,5,850,1.0,582.0,582.0
0.005,6,10,2006,5,927,1.0,659.0,659.0,5,1079,1.0,811.0,811.0
0.011,6,10,1972,5,910,2.0,642.0,642.0,5,1062,2.0,794.0,794.0
0.004,17,2,136,1,60,0.0,32.0,32.0,1,76,0.0,48.0,48.0
0.008,6,10,1990,5,911,2.0,643.0,643.0,5,1079,2.0,811.0,811.0
0.139,6,10,1506,5,395,32.0,127.0,127.0,5,1111,19.0,843.0,843.0
0.008,6,10,1989,5,910,2.0,642.0,642.0,5,1079,2.0,811.0,811.0
0.016,6,10,1990,5,911,4.0,643.0,643.0,5,1079,4.0,811.0,811.0
0.02,6,10,1990,5,911,4.0,643.0,643.0,5,1079,5.0,811.0,811.0
0.005,6,10,2006,5,927,1.0,659.0,659.0,5,1079,1.0,811.0,811.0
0.011,6,10,1677,5,827,2.0,559.0,559.0,5,850,2.0,582.0,582.0
40.068,17,10,676,5,460,10016.0,104.0,64.0,5,216,10016.0,20.0,15.0
0.005,6,13,3690,7,452,0.0,80.0,80.0,6,3238,0.0,1470.0,1459.0
0.009,6,10,1677,5,827,2.0,559.0,559.0,5,850,2.0,582.0,582.0
0.041,17,2,136,1,60,0.0,32.0,32.0,1,76,0.0,48.0,48.0
0.137,6,10,1506,5,395,30.0,127.0,127.0,5,1111,30.0,843.0,843.0
0.005,6,10,2006,5,927,1.0,659.0,659.0,5,1079,1.0,811.0,811.0
0.009,6,10,1631,5,848,2.0,580.0,580.0,5,783,2.0,515.0,515.0
0.037,17,2,170,1,65,0.0,37.0,37.0,1,105,0.0,77.0,77.0
0.006,6,10,1689,5,839,1.0,571.0,571.0,5,850,1.0,582.0,582.0
0.004,6,10,1989,5,927,1.0,659.0,659.0,5,1062,1.0,794.0,794.0
0.039,6,10,1677,5,827,9.0,559.0,559.0,5,850,9.0,582.0,582.0
0.006,6,10,1689,5,839,1.0,571.0,571.0,5,850,1.0,582.0,582.0
294.358,6,403,349742,201,23345,1471.0,2736.0,859.0,202,326397,1464.0,2804.0,1698.0
15.073,17,14,9190,8,6902,2149.0,1350.0,834.0,6,2288,3008.0,1350.0,353.0
0.005,6,10,2007,5,928,1.0,660.0,660.0,5,1079,1.0,811.0,811.0
0.006,6,10,1689,5,839,1.0,571.0,571.0,5,850,1.0,582.0,582.0
0.014,6,10,1989,5,910,3.0,642.0,642.0,5,1079,3.0,811.0,811.0
0.004,6,10,1779,5,928,1.0,660.0,660.0,5,851,1.0,583.0,583.0
0.006,6,10,1547,5,764,1.0,496.0,496.0,5,783,1.0,515.0,515.0
0.004,6,10,2007,5,928,1.0,660.0,660.0,5,1079,1.0,811.0,811.0
0.017,6,10,1631,5,848,4.0,580.0,580.0,5,783,4.0,515.0,515.0
109.635,6,26,5210,14,1186,8433.0,180.0,75.0,12,4024,9966.0,1591.0,678.0
0.005,6,10,1989,5,927,1.0,659.0,659.0,5,1062,1.0,794.0,794.0
0.005,6,10,1854,5,889,1.0,621.0,621.0,5,965,1.0,697.0,697.0
0.009,6,12,1926,6,1189,1.0,659.0,434.0,6,737,1.0,417.0,417.0
0.008,6,10,1972,5,910,2.0,642.0,642.0,5,1062,2.0,794.0,794.0
0.004,6,10,2006,5,927,1.0,659.0,659.0,5,1079,1.0,811.0,811.0
0.07,6,10,1506,5,395,14.0,127.0,127.0,5,1111,15.0,843.0,843.0
0.016,6,10,1631,5,848,3.0,580.0,580.0,5,783,4.0,515.0,515.0
11.094,17,28,4396,14,2311,844.0,586.0,137.0,14,2085,844.0,268.0,120.0
0.237,6,16,2674,8,1400,33.0,533.0,325.0,8,1274,22.0,529.0,212.0
0.039,17,4,420,2,122,0.0,33.0,33.0,2,298,36.0,145.0,121.0
40.057,17,10,676,5,460,10013.0,104.0,64.0,5,216,10013.0,20.0,15.0
241.347,6,399,348878,180,20876,1348.0,2736.0,886.0,219,328002,1107.0,2804.0,1514.0
0.003,17,4,284,2,120,0.0,32.0,32.0,2,164,0.0,60.0,54.0
240.274,6,41,5240,22,2529,11441.0,588.0,196.0,19,2711,13348.0,580.0,214.0
0.12,6,10,1506,5,395,24.0,127.0,127.0,5,1111,25.0,843.0,843.0
178.017,17,94,13567,47,3164,3869.0,44.0,39.0,47,10403,3869.0,239.0,193.0
0.072,17,8,3613,4,1874,24.0,1350.0,440.0,4,1739,12.0,1350.0,406.0
0.072,17,4,596,2,122,1.0,33.0,33.0,2,474,32.0,323.0,209.0
0.078,6,10,1506,5,395,18.0,127.0,127.0,5,1111,19.0,843.0,843.0
0.006,17,2,179,1,71,0.0,43.0,43.0,1,108,0.0,80.0,80.0
0.005,17,2,140,1,62,0.0,34.0,34.0,1,78,0.0,50.0,50.0
1769.468,6,99,6183,50,2701,36110.0,37.0,33.0,49,3482,36862.0,280.0,116.0
0.006,6,10,2000,5,927,1.0,659.0,659.0,5,1073,1.0,805.0,805.0
0.014,6,10,1990,5,911,3.0,643.0,643.0,5,1079,3.0,811.0,811.0
0.008,6,10,1983,5,910,2.0,642.0,642.0,5,1073,1.0,805.0,805.0
0.007,6,10,1547,5,764,1.0,496.0,496.0,5,783,1.0,515.0,515.0
0.012,6,10,1631,5,848,3.0,580.0,580.0,5,783,3.0,515.0,515.0
0.001,17,2,166,1,75,0.0,47.0,47.0,1,91,0.0,63.0,63.0
0.074,6,10,1506,5,395,15.0,127.0,127.0,5,1111,17.0,843.0,843.0
0.04,17,2,152,1,76,0.0,48.0,48.0,1,76,0.0,48.0,48.0
0.005,17,2,157,1,59,0.0,31.0,31.0,1,98,0.0,70.0,70.0
0.005,6,10,1854,5,889,1.0,621.0,621.0,5,965,1.0,697.0,697.0
15.079,17,15,8081,8,5939,2150.0,1350.0,714.0,7,2142,2508.0,1350.0,278.0
0.009,6,10,1972,5,910,2.0,642.0,642.0,5,1062,2.0,794.0,794.0
0.006,17,2,424,1,72,0.0,44.0,44.0,1,352,0.0,324.0,324.0
0.001,17,2,180,1,66,0.0,38.0,38.0,1,114,0.0,86.0,86.0
0.018,6,10,1989,5,910,4.0,642.0,642.0,5,1079,4.0,811.0,811.0
0.014,6,10,1989,5,910,3.0,642.0,642.0,5,1079,3.0,811.0,811.0
0.004,17,2,132,1,58,0.0,30.0,30.0,1,74,0.0,46.0,46.0
10.774,17,28,4421,14,1993,820.0,268.0,114.0,14,2428,820.0,587.0,145.0
0.043,17,2,152,1,76,0.0,48.0,48.0,1,76,0.0,48.0,48.0
0.004,17,2,136,1,60,0.0,32.0,32.0,1,76,0.0,48.0,48.0
0.067,17,8,3613,4,1874,22.0,1350.0,440.0,4,1739,11.0,1350.0,406.0
0.01,6,10,1989,5,910,2.0,642.0,642.0,5,1079,2.0,811.0,811.0
0.005,17,2,194,1,59,0.0,31.0,31.0,1,135,0.0,107.0,107.0
0.001,17,2,180,1,66,0.0,38.0,38.0,1,114,0.0,86.0,86.0
0.075,6,10,1506,5,395,17.0,127.0,127.0,5,1111,16.0,843.0,843.0
300.023,6,12,1782,7,1348,50003.0,494.0,494.0,5,434,75005.0,83.0,83.0
15.106,17,15,8297,8,6146,2153.0,1350.0,740.0,7,2151,2512.0,1350.0,279.0
0.019,6,10,1677,5,827,4.0,559.0,559.0,5,850,4.0,582.0,582.0
1799.998,6,224,20415,84,11593,21325.0,2720.0,115.0,140,8822,12948.0,148.0,47.0
0.01,6,10,1779,5,928,2.0,660.0,660.0,5,851,2.0,583.0,583.0
0.224,6,16,2777,8,1395,32.0,533.0,323.0,8,1382,20.0,529.0,239.0
0.005,6,10,2007,5,928,1.0,660.0,660.0,5,1079,1.0,811.0,811.0
1770.467,6,83,4368,42,2210,43181.0,26.0,26.0,41,2158,44260.0,26.0,26.0
311.921,17,20,1124,10,716,34643.0,48.0,43.0,10,408,34643.0,20.0,12.0
0.005,17,2,178,1,81,0.0,53.0,53.0,1,97,0.0,69.0,69.0
0.1,6,10,1506,5,395,24.0,127.0,127.0,5,1111,22.0,843.0,843.0
300.367,6,16,2170,9,684,37524.0,146.0,146.0,7,1486,50033.0,419.0,398.0
0.184,17,15,8822,8,6407,26.0,1350.0,772.0,7,2415,19.0,1350.0,317.0
0.004,6,10,2006,5,927,1.0,659.0,659.0,5,1079,1.0,811.0,811.0
0.006,6,10,1547,5,764,1.0,496.0,496.0,5,783,1.0,515.0,515.0
0.013,6,10,1989,5,910,3.0,642.0,642.0,5,1079,3.0,811.0,811.0
0.014,6,10,1989,5,910,3.0,642.0,642.0,5,1079,3.0,811.0,811.0
0.004,17,2,144,1,64,0.0,36.0,36.0,1,80,0.0,52.0,52.0
369.604,6,22,2313,16,867,24640.0,195.0,195.0,6,1446,4668.0,419.0,398.0
11.171,17,28,4423,14,1995,847.0,270.0,114.0,14,2428,847.0,587.0,145.0
0.043,17,2,152,1,76,0.0,48.0,48.0,1,76,0.0,48.0,48.0
0.011,6,10,1762,5,911,2.0,643.0,643.0,5,851,2.0,583.0,583.0
0.095,6,10,1506,5,395,22.0,127.0,127.0,5,1111,23.0,843.0,843.0
0.014,6,10,1972,5,910,3.0,642.0,642.0,5,1062,3.0,794.0,794.0
0.072,17,8,3613,4,1874,24.0,1350.0,440.0,4,1739,12.0,1350.0,406.0
0.006,17,2,304,1,77,0.0,49.0,49.0,1,227,0.0,199.0,199.0
0.016,6,10,1990,5,911,3.0,643.0,643.0,5,1079,3.0,811.0,811.0
0.004,6,10,2000,5,927,1.0,659.0,659.0,5,1073,1.0,805.0,805.0
0.005,6,14,3742,7,452,0.0,80.0,80.0,7,3290,0.0,1448.0,972.0
0.006,6,10,2006,5,927,1.0,659.0,659.0,5,1079,1.0,811.0,811.0
9.044,17,6,376,5,280,2261.0,28.0,28.0,1,96,0.0,68.0,68.0
0.004,6,10,2006,5,927,1.0,659.0,659.0,5,1079,1.0,811.0,811.0
0.014,6,10,1989,5,910,3.0,642.0,642.0,5,1079,3.0,811.0,811.0
0.016,6,10,1677,5,827,4.0,559.0,559.0,5,850,4.0,582.0,582.0
0.004,6,10,1774,5,923,1.0,655.0,655.0,5,851,1.0,583.0,583.0
0.012,6,10,1972,5,910,2.0,642.0,642.0,5,1062,3.0,794.0,794.0
0.009,6,12,1926,6,1189,1.0,659.0,434.0,6,737,1.0,417.0,417.0
0.173,6,10,1506,5,395,42.0,127.0,127.0,5,1111,35.0,843.0,843.0
0.005,6,10,1643,5,860,1.0,592.0,592.0,5,783,1.0,515.0,515.0
0.005,6,10,1547,5,764,1.0,496.0,496.0,5,783,1.0,515.0,515.0
0.078,6,10,1506,5,395,17.0,127.0,127.0,5,1111,18.0,843.0,843.0
0.005,6,10,2006,5,927,1.0,659.0,659.0,5,1079,1.0,811.0,811.0
0.011,6,10,1983,5,910,2.0,642.0,642.0,5,1073,2.0,805.0,805.0
0.005,6,10,2006,5,927,1.0,659.0,659.0,5,1079,1.0,811.0,811.0
0.003,17,2,136,1,60,0.0,32.0,32.0,1,76,0.0,48.0,48.0
0.074,6,10,1506,5,395,16.0,127.0,127.0,5,1111,16.0,843.0,843.0
309.408,17,20,1124,10,716,34364.0,48.0,43.0,10,408,34364.0,20.0,12.0
0.004,17,2,148,1,60,0.0,32.0,32.0,1,88,0.0,60.0,60.0
0.127,17,4,420,2,122,0.0,33.0,33.0,2,298,123.0,145.0,121.0
165.187,17,98,13462,49,3322,3441.0,44.0,39.0,49,10140,3441.0,252.0,178.0
328.002,17,20,1124,10,716,36430.0,48.0,43.0,10,408,36430.0,20.0,12.0
0.013,6,13,3735,7,497,2.0,125.0,125.0,6,3238,2.0,1470.0,1459.0
294.282,6,411,348411,199,21910,1486.0,2690.0,825.0,212,326501,1394.0,4136.0,1593.0
0.118,6,10,1506,5,395,27.0,127.0,127.0,5,1111,27.0,843.0,843.0
0.005,6,10,1989,5,927,1.0,659.0,659.0,5,1062,1.0,794.0,794.0
0.023,6,10,1990,5,911,5.0,643.0,643.0,5,1079,5.0,811.0,811.0
0.041,17,2,136,1,60,0.0,32.0,32.0,1,76,0.0,48.0,48.0
0.005,6,14,3799,7,509,0.0,137.0,137.0,7,3290,0.0,1448.0,972.0
171.44,17,78,11274,39,2589,4511.0,44.0,38.0,39,8685,4511.0,261.0,194.0
0.006,6,12,1698,6,863,1.0,327.0,271.0,6,835,1.0,515.0,515.0
40.059,17,10,676,5,460,10011.0,104.0,64.0,5,216,10014.0,20.0,15.0
0.015,6,10,1990,5,911,3.0,643.0,643.0,5,1079,3.0,811.0,811.0
1778.24,17,141,44556,72,22752,25045.0,288.0,288.0,69,21804,26146.0,288.0,288.0
0.005,6,10,2007,5,928,1.0,660.0,660.0,5,1079,1.0,811.0,811.0
0.01,6,10,1990,5,911,2.0,643.0,643.0,5,1079,2.0,811.0,811.0
0.005,17,2,148,1,60,0.0,32.0,32.0,1,88,0.0,60.0,60.0
0.224,6,16,2778,8,1396,32.0,533.0,324.0,8,1382,20.0,529.0,239.0
0.005,6,10,2006,5,927,1.0,659.0,659.0,5,1079,1.0,811.0,811.0
0.089,6,10,1506,5,395,21.0,127.0,127.0,5,1111,19.0,843.0,843.0
0.005,6,10,2007,5,928,1.0,660.0,660.0,5,1079,1.0,811.0,811.0
0.093,6,10,1506,5,395,20.0,127.0,127.0,5,1111,21.0,843.0,843.0
0.235,6,16,2778,8,1396,33.0,533.0,324.0,8,1382,21.0,529.0,239.0
0.09,6,10,1506,5,395,19.0,127.0,127.0,5,1111,21.0,843.0,843.0
0.005,6,13,3684,7,446,0.0,74.0,74.0,6,3238,0.0,1470.0,1459.0
0.014,6,10,1983,5,910,3.0,642.0,642.0,5,1073,3.0,805.0,805.0
0.077,6,10,1506,5,395,17.0,127.0,127.0,5,1111,17.0,843.0,843.0
0.126,6,10,1506,5,395,29.0,127.0,127.0,5,1111,28.0,843.0,843.0
0.037,17,2,148,1,60,0.0,32.0,32.0,1,88,0.0,60.0,60.0
0.042,17,2,152,1,76,0.0,48.0,48.0,1,76,0.0,48.0,48.0
0.003,17,2,136,1,60,0.0,32.0,32.0,1,76,0.0,48.0,48.0
0.005,6,10,2007,5,928,1.0,660.0,660.0,5,1079,1.0,811.0,811.0
0.072,17,2,148,1,60,0.0,32.0,32.0,1,88,0.0,60.0,60.0
15.092,17,15,8140,8,6002,2150.0,1350.0,722.0,7,2138,2510.0,1350.0,277.0
0.003,17,4,284,2,120,0.0,32.0,32.0,2,164,0.0,60.0,54.0
320.668,17,20,1124,10,716,35615.0,48.0,43.0,10,408,35615.0,20.0,12.0
0.006,6,10,1547,5,764,1.0,496.0,496.0,5,783,1.0,515.0,515.0
0.04,17,4,352,2,130,1.0,37.0,37.0,2,222,1.0,89.0,83.0
0.012,6,10,1983,5,910,2.0,642.0,642.0,5,1073,3.0,805.0,805.0
0.017,6,10,1677,5,827,4.0,559.0,559.0,5,850,4.0,582.0,582.0
0.005,6,10,1689,5,839,1.0,571.0,571.0,5,850,1.0,582.0,582.0
0.014,6,10,1989,5,910,3.0,642.0,642.0,5,1079,3.0,811.0,811.0
0.005,6,10,2007,5,928,1.0,660.0,660.0,5,1079,1.0,811.0,811.0
310.0,17,20,1124,10,716,34429.0,48.0,43.0,10,408,34429.0,20.0,12.0
0.038,17,2,170,1,65,0.0,37.0,37.0,1,105,0.0,77.0,77.0
0.111,6,10,1506,5,395,25.0,127.0,127.0,5,1111,21.0,843.0,843.0
0.017,6,10,1762,5,911,4.0,643.0,643.0,5,851,4.0,583.0,583.0
0.006,6,10,1989,5,927,1.0,659.0,659.0,5,1062,1.0,794.0,794.0
0.022,6,10,1631,5,848,5.0,580.0,580.0,5,783,5.0,515.0,515.0
10.764,17,28,4416,14,1993,819.0,268.0,114.0,14,2423,819.0,586.0,145.0
0.004,6,10,2000,5,927,1.0,659.0,659.0,5,1073,1.0,805.0,805.0
0.01,6,10,1762,5,911,2.0,643.0,643.0,5,851,2.0,583.0,583.0
0.006,17,2,214,1,75,0.0,47.0,47.0,1,139,0.0,111.0,111.0
0.007,6,10,1854,5,889,1.0,621.0,621.0,5,965,1.0,697.0,697.0
0.004,6,10,2007,5,928,1.0,660.0,660.0,5,1079,1.0,811.0,811.0
177.181,17,86,12381,43,2897,4218.0,44.0,39.0,43,9484,4218.0,261.0,192.0
0.041,17,2,182,1,65,0.0,37.0,37.0,1,117,0.0,89.0,89.0
0.089,6,10,1506,5,395,18.0,127.0,127.0,5,1111,16.0,843.0,843.0
0.038,17,2,170,1,65,0.0,37.0,37.0,1,105,0.0,77.0,77.0
0.005,6,10,1779,5,928,1.0,660.0,660.0,5,851,1.0,583.0,583.0
0.021,6,10,1989,5,910,5.0,642.0,642.0,5,1079,5.0,811.0,811.0
351.992,6,20,2210,6,1308,12003.0,494.0,494.0,14,902,27076.0,83.0,83.0
40.065,17,10,676,5,460,10013.0,104.0,64.0,5,216,10015.0,20.0,15.0
0.016,6,10,1972,5,910,4.0,642.0,642.0,5,1062,4.0,794.0,794.0
294.835,6,374,347586,179,20868,1656.0,2736.0,889.0,195,326718,1519.0,2887.0,1758.0
0.072,17,4,596,2,122,0.0,33.0,33.0,2,474,32.0,323.0,209.0
65.781,6,27,17582,15,9638,4698.0,2804.0,1475.0,12,7944,5965.0,2315.0,1218.0
0.022,6,10,1989,5,910,5.0,642.0,642.0,5,1079,5.0,811.0,811.0
0.005,17,2,170,1,65,0.0,37.0,37.0,1,105,0.0,77.0,77.0
1730.369,6,45,2790,30,1725,59667.0,35.0,35.0,15,1065,123592.0,31.0,31.0
0.02,6,10,1983,5,910,4.0,642.0,642.0,5,1073,5.0,805.0,805.0
308.405,17,20,1124,10,716,34258.0,48.0,43.0,10,408,34259.0,20.0,12.0
295.262,6,385,348823,191,22136,1554.0,2736.0,871.0,194,326687,1529.0,4122.0,1768.0
0.162,6,10,1506,5,395,29.0,127.0,127.0,5,1111,33.0,843.0,843.0
0.003,17,2,148,1,60,0.0,32.0,32.0,1,88,0.0,60.0,60.0
1799.96,6,138,6704,77,3704,23683.0,39.0,39.0,61,3000,29995.0,35.0,35.0
0.005,17,2,180,1,66,0.0,38.0,38.0,1,114,0.0,86.0,86.0
0.004,6,10,2000,5,927,1.0,659.0,659.0,5,1073,1.0,805.0,805.0
0.005,6,10,1989,5,927,1.0,659.0,659.0,5,1062,1.0,794.0,794.0
0.004,6,10,2006,5,927,1.0,659.0,659.0,5,1079,1.0,811.0,811.0
0.251,17,13,9140,7,6851,41.0,1350.0,950.0,6,2289,44.0,1350.0,353.0
10.931,17,28,4398,14,2312,832.0,587.0,137.0,14,2086,832.0,269.0,121.0
0.006,6,10,1774,5,923,1.0,655.0,655.0,5,851,1.0,583.0,583.0
0.006,6,10,1547,5,764,1.0,496.0,496.0,5,783,1.0,515.0,515.0
0.04,17,2,186,1,61,0.0,33.0,33.0,1,125,0.0,97.0,97.0
0.084,6,10,1506,5,395,20.0,127.0,127.0,5,1111,16.0,843.0,843.0
0.008,6,10,1972,5,910,2.0,642.0,642.0,5,1062,2.0,794.0,794.0
0.005,6,10,1689,5,839,1.0,571.0,571.0,5,850,1.0,582.0,582.0
0.009,6,10,1972,5,910,2.0,642.0,642.0,5,1062,2.0,794.0,794.0
0.073,6,10,1506,5,395,17.0,127.0,127.0,5,1111,16.0,843.0,843.0
0.04,17,4,284,2,120,0.0,32.0,32.0,2,164,37.0,60.0,54.0
0.004,6,10,2000,5,927,1.0,659.0,659.0,5,1073,1.0,805.0,805.0
0.04,17,4,284,2,120,0.0,32.0,32.0,2,164,37.0,60.0,54.0
0.005,6,10,1689,5,839,1.0,571.0,571.0,5,850,1.0,582.0,582.0
0.006,6,10,1689,5,839,1.0,571.0,571.0,5,850,1.0,582.0,582.0
0.001,17,2,180,1,66,0.0,38.0,38.0,1,114,0.0,86.0,86.0
0.006,6,10,1547,5,764,1.0,496.0,496.0,5,783,1.0,515.0,515.0
0.005,6,10,1989,5,927,1.0,659.0,659.0,5,1062,1.0,794.0,794.0
0.004,17,2,148,1,60,0.0,32.0,32.0,1,88,0.0,60.0,60.0
0.01,6,13,3735,7,497,1.0,125.0,125.0,6,3238,1.0,1470.0,1459.0
0.005,17,2,136,1,60,0.0,32.0,32.0,1,76,0.0,48.0,48.0
0.009,6,10,1972,5,910,2.0,642.0,642.0,5,1062,2.0,794.0,794.0
9.038,6,36,9771,19,4293,502.0,1360.0,700.0,17,5478,552.0,2720.0,435.0
15.081,17,16,8167,8,6060,2150.0,1350.0,729.0,8,2107,2150.0,1350.0,235.0
1756.73,6,103,6166,59,3473,30287.0,27.0,27.0,44,2693,40852.0,27.0,27.0
0.066,6,10,1506,5,395,14.0,127.0,127.0,5,1111,14.0,843.0,843.0
0.004,6,10,1702,5,863,0.0,595.0,595.0,5,839,1.0,571.0,571.0
0.005,17,2,169,1,62,0.0,34.0,34.0,1,107,0.0,79.0,79.0
0.022,6,10,1989,5,910,5.0,642.0,642.0,5,1079,5.0,811.0,811.0
0.009,6,10,1972,5,910,2.0,642.0,642.0,5,1062,2.0,794.0,794.0
0.005,6,10,1989,5,927,1.0,659.0,659.0,5,1062,1.0,794.0,794.0
241.063,6,26,9286,14,1515,18543.0,417.0,255.0,12,7771,21908.0,2804.0,1019.0
0.004,6,10,1989,5,927,1.0,659.0,659.0,5,1062,1.0,794.0,794.0
0.005,6,10,1989,5,927,1.0,659.0,659.0,5,1062,1.0,794.0,794.0
0.013,6,10,1983,5,910,3.0,642.0,642.0,5,1073,3.0,805.0,805.0
0.018,6,14,3787,7,497,3.0,125.0,125.0,7,3290,3.0,1448.0,972.0
0.008,6,10,1989,5,910,2.0,642.0,642.0,5,1079,1.0,811.0,811.0
0.002,17,2,208,1,72,0.0,44.0,44.0,1,136,0.0,108.0,108.0
0.005,6,10,2007,5,928,1.0,660.0,660.0,5,1079,1.0,811.0,811.0
0.005,6,10,2006,5,927,1.0,659.0,659.0,5,1079,1.0,811.0,811.0
0.005,6,10,2006,5,927,1.0,659.0,659.0,5,1079,1.0,811.0,811.0
0.088,6,10,1506,5,395,20.0,127.0,127.0,5,1111,16.0,843.0,843.0
0.086,6,10,1506,5,395,19.0,127.0,127.0,5,1111,20.0,843.0,843.0
0.005,6,10,2000,5,927,1.0,659.0,659.0,5,1073,1.0,805.0,805.0
0.01,6,10,1983,5,910,2.0,642.0,642.0,5,1073,2.0,805.0,805.0
0.006,6,10,1689,5,839,1.0,571.0,571.0,5,850,1.0,582.0,582.0
0.012,6,10,1989,5,910,2.0,642.0,642.0,5,1079,2.0,811.0,811.0
0.005,6,10,2006,5,927,1.0,659.0,659.0,5,1079,1.0,811.0,811.0
0.004,17,2,148,1,60,0.0,32.0,32.0,1,88,0.0,60.0,60.0
0.007,17,2,194,1,59,0.0,31.0,31.0,1,135,0.0,107.0,107.0
11.169,17,28,4418,14,1994,846.0,269.0,114.0,14,2424,846.0,587.0,145.0
0.005,6,10,1989,5,927,1.0,659.0,659.0,5,1062,1.0,794.0,794.0
0.006,6,10,1547,5,764,1.0,496.0,496.0,5,783,1.0,515.0,515.0
0.008,6,10,1989,5,910,2.0,642.0,642.0,5,1079,2.0,811.0,811.0
0.004,17,2,136,1,60,0.0,32.0,32.0,1,76,0.0,48.0,48.0
0.005,6,10,1989,5,927,1.0,659.0,659.0,5,1062,1.0,794.0,794.0
0.041,17,2,170,1,65,0.0,37.0,37.0,1,105,0.0,77.0,77.0
0.015,6,10,1983,5,910,3.0,642.0,642.0,5,1073,3.0,805.0,805.0
0.01,6,11,2042,6,963,2.0,643.0,643.0,5,1079,2.0,811.0,811.0
0.005,6,10,2007,5,928,1.0,660.0,660.0,5,1079,1.0,811.0,811.0
0.006,6,10,1989,5,927,1.0,659.0,659.0,5,1062,1.0,794.0,794.0
0.005,17,2,256,1,64,0.0,36.0,36.0,1,192,0.0,164.0,164.0
40.072,17,10,676,5,460,10015.0,104.0,64.0,5,216,10017.0,20.0,15.0
0.006,6,10,1547,5,764,1.0,496.0,496.0,5,783,1.0,515.0,515.0
0.078,6,10,1506,5,395,17.0,127.0,127.0,5,1111,18.0,843.0,843.0
15.156,17,41,20186,23,17130,687.0,1350.0,716.0,18,3056,889.0,1350.0,141.0
0.103,6,10,1506,5,395,23.0,127.0,127.0,5,1111,21.0,843.0,843.0
0.127,17,2,148,1,60,0.0,32.0,32.0,1,88,0.0,60.0,60.0
0.12,6,10,1506,5,395,27.0,127.0,127.0,5,1111,27.0,843.0,843.0
0.202,6,16,2669,8,1395,28.0,533.0,323.0,8,1274,18.0,529.0,212.0
0.004,6,10,1702,5,863,1.0,595.0,595.0,5,839,1.0,571.0,571.0
0.018,6,10,1631,5,848,4.0,580.0,580.0,5,783,4.0,515.0,515.0
40.061,17,10,676,5,460,10012.0,104.0,64.0,5,216,10014.0,20.0,15.0
0.006,6,10,1547,5,764,1.0,496.0,496.0,5,783,1.0,515.0,515.0
0.117,6,10,1506,5,395,25.0,127.0,127.0,5,1111,24.0,843.0,843.0
40.061,17,10,676,5,460,10013.0,104.0,64.0,5,216,10014.0,20.0,15.0
0.004,6,10,1702,5,863,1.0,595.0,595.0,5,839,1.0,571.0,571.0
0.043,17,4,336,2,124,0.0,34.0,34.0,2,212,3.0,84.0,78.0
0.013,6,10,1989,5,910,3.0,642.0,642.0,5,1079,3.0,811.0,811.0
0.008,6,10,1972,5,910,2.0,642.0,642.0,5,1062,1.0,794.0,794.0
0.005,6,13,3747,7,509,0.0,137.0,137.0,6,3238,1.0,1470.0,1459.0
0.041,17,2,166,1,75,0.0,47.0,47.0,1,91,0.0,63.0,63.0
0.014,6,10,1983,5,910,3.0,642.0,642.0,5,1073,3.0,805.0,805.0
40.059,17,10,676,5,460,10014.0,104.0,64.0,5,216,10014.0,20.0,15.0
9.077,17,6,376,5,280,2269.0,28.0,28.0,1,96,0.0,68.0,68.0
0.016,17,2,198,1,91,0.0,63.0,63.0,1,107,0.0,79.0,79.0
0.018,6,13,3735,7,497,2.0,125.0,125.0,6,3238,3.0,1470.0,1459.0
0.008,6,12,1926,6,1189,1.0,659.0,434.0,6,737,1.0,417.0,417.0
0.042,17,4,284,2,120,0.0,32.0,32.0,2,164,39.0,60.0,54.0
0.006,6,10,1547,5,764,1.0,496.0,496.0,5,783,1.0,515.0,515.0
0.005,17,2,168,1,76,0.0,48.0,48.0,1,92,0.0,64.0,64.0
0.058,6,10,1506,5,395,12.0,127.0,127.0,5,1111,14.0,843.0,843.0
0.228,17,15,8722,8,6284,32.0,1350.0,757.0,7,2438,25.0,1350.0,320.0
0.0,17,2,154,1,69,0.0,41.0,41.0,1,85,0.0,57.0,57.0
0.004,6,10,1774,5,923,1.0,655.0,655.0,5,851,1.0,583.0,583.0
0.005,6,10,1779,5,928,1.0,660.0,660.0,5,851,1.0,583.0,583.0
0.06,17,2,80,1,32,0.0,4.0,4.0,1,48,0.0,20.0,20.0
0.008,6,10,1677,5,827,1.0,559.0,559.0,5,850,1.0,582.0,582.0
0.004,6,10,2006,5,927,1.0,659.0,659.0,5,1079,1.0,811.0,811.0
0.07,6,10,1506,5,395,17.0,127.0,127.0,5,1111,15.0,843.0,843.0
0.384,17,41,20596,22,17089,18.0,1350.0,748.0,19,3507,17.0,1350.0,156.0
0.004,6,10,2007,5,928,1.0,660.0,660.0,5,1079,1.0,811.0,811.0
0.006,6,10,1689,5,839,1.0,571.0,571.0,5,850,1.0,582.0,582.0
0.092,6,10,1506,5,395,21.0,127.0,127.0,5,1111,22.0,843.0,843.0
0.005,6,10,2006,5,927,1.0,659.0,659.0,5,1079,1.0,811.0,811.0
11.765,17,32,5082,18,2682,685.0,269.0,121.0,14,2400,896.0,587.0,143.0
0.005,6,13,3747,7,509,0.0,137.0,137.0,6,3238,0.0,1470.0,1459.0
0.109,6,10,1506,5,395,24.0,127.0,127.0,5,1111,25.0,843.0,843.0
0.004,17,2,186,1,61,0.0,33.0,33.0,1,125,0.0,97.0,97.0
0.205,6,10,1506,5,395,49.0,127.0,127.0,5,1111,49.0,843.0,843.0
0.009,17,2,144,1,64,0.0,36.0,36.0,1,80,0.0,52.0,52.0
0.058,6,10,1506,5,395,11.0,127.0,127.0,5,1111,13.0,843.0,843.0
0.002,17,2,136,1,60,0.0,32.0,32.0,1,76,0.0,48.0,48.0
0.069,6,10,1506,5,395,15.0,127.0,127.0,5,1111,14.0,843.0,843.0
0.072,6,10,1506,5,395,17.0,127.0,127.0,5,1111,14.0,843.0,843.0
1778.687,17,144,45504,72,22752,25051.0,288.0,288.0,72,22752,25051.0,288.0,288.0
0.006,6,5,310,3,175,3.0,31.0,31.0,2,135,0.0,31.0,31.0
0.005,17,2,180,1,66,0.0,38.0,38.0,1,114,0.0,86.0,86.0
292.974,6,310,344189,121,17850,2441.0,2736.0,889.0,189,326339,1558.0,2804.0,1808.0
309.465,17,20,1124,10,716,34378.0,48.0,43.0,10,408,34374.0,20.0,12.0
15.168,17,20,11737,10,8027,1682.0,1350.0,774.0,10,3710,1682.0,1350.0,343.0
40.059,17,10,676,5,460,10014.0,104.0,64.0,5,216,10014.0,20.0,15.0
0.006,6,13,3690,7,452,0.0,80.0,80.0,6,3238,1.0,1470.0,1459.0
0.006,6,10,2000,5,927,1.0,659.0,659.0,5,1073,1.0,805.0,805.0
40.066,17,10,676,5,460,10013.0,104.0,64.0,5,216,10015.0,20.0,15.0
0.174,17,2,152,1,76,0.0,48.0,48.0,1,76,0.0,48.0,48.0
84.815,6,22,8185,11,1985,83.0,1174.0,504.0,11,6200,8464.0,2720.0,958.0
0.013,6,10,1989,5,910,3.0,642.0,642.0,5,1079,3.0,811.0,811.0
0.014,6,10,1989,5,910,3.0,642.0,642.0,5,1079,3.0,811.0,811.0
0.006,6,10,1643,5,860,1.0,592.0,592.0,5,783,1.0,515.0,515.0
0.006,6,10,1547,5,764,1.0,496.0,496.0,5,783,1.0,515.0,515.0
0.12,6,10,1506,5,395,28.0,127.0,127.0,5,1111,28.0,843.0,843.0
0.005,17,2,186,1,60,0.0,32.0,32.0,1,126,0.0,98.0,98.0
0.095,6,10,1506,5,395,20.0,127.0,127.0,5,1111,20.0,843.0,843.0
0.005,17,2,180,1,58,0.0,30.0,30.0,1,122,0.0,94.0,94.0
0.016,6,10,1972,5,910,4.0,642.0,642.0,5,1062,3.0,794.0,794.0
0.072,6,10,1506,5,395,15.0,127.0,127.0,5,1111,14.0,843.0,843.0
0.006,6,10,1689,5,839,1.0,571.0,571.0,5,850,1.0,582.0,582.0
0.134,6,10,1506,5,395,31.0,127.0,127.0,5,1111,26.0,843.0,843.0
0.006,6,13,3747,7,509,1.0,137.0,137.0,6,3238,1.0,1470.0,1459.0
0.012,6,10,1983,5,910,3.0,642.0,642.0,5,1073,3.0,805.0,805.0
15.072,17,15,9238,8,6902,2149.0,1350.0,834.0,7,2336,2507.0,1350.0,305.0
0.076,6,10,1506,5,395,17.0,127.0,127.0,5,1111,17.0,843.0,843.0
0.005,6,10,1774,5,923,1.0,655.0,655.0,5,851,1.0,583.0,583.0
0.012,6,10,1631,5,848,3.0,580.0,580.0,5,783,3.0,515.0,515.0
0.005,6,10,2000,5,927,1.0,659.0,659.0,5,1073,1.0,805.0,805.0
0.063,6,10,1506,5,395,15.0,127.0,127.0,5,1111,14.0,843.0,843.0
0.004,17,4,284,2,120,0.0,32.0,32.0,2,164,0.0,60.0,54.0
40.073,17,10,676,5,460,10016.0,104.0,64.0,5,216,10017.0,20.0,15.0
0.011,6,10,1762,5,911,2.0,643.0,643.0,5,851,2.0,583.0,583.0
0.071,17,4,336,2,124,0.0,34.0,34.0,2,212,33.0,84.0,78.0
0.005,6,10,2006,5,927,1.0,659.0,659.0,5,1079,1.0,811.0,811.0
0.013,6,13,3735,7,497,2.0,125.0,125.0,6,3238,2.0,1470.0,1459.0
0.011,6,10,1989,5,910,2.0,642.0,642.0,5,1079,2.0,811.0,811.0
0.001,17,2,142,1,63,0.0,35.0,35.0,1,79,0.0,51.0,51.0
0.009,6,10,1989,5,910,2.0,642.0,642.0,5,1079,2.0,811.0,811.0
0.019,6,10,1631,5,848,4.0,580.0,580.0,5,783,4.0,515.0,515.0
0.043,6,13,3735,7,497,7.0,125.0,125.0,6,3238,8.0,1470.0,1459.0
0.007,6,10,2000,5,927,1.0,659.0,659.0,5,1073,1.0,805.0,805.0
0.017,6,10,1989,5,910,4.0,642.0,642.0,5,1079,4.0,811.0,811.0
40.071,17,10,676,5,460,10014.0,104.0,64.0,5,216,10017.0,20.0,15.0
0.004,6,10,2000,5,927,1.0,659.0,659.0,5,1073,1.0,805.0,805.0
0.005,17,4,284,2,120,2.0,32.0,32.0,2,164,1.0,60.0,54.0
0.004,6,10,1989,5,927,1.0,659.0,659.0,5,1062,1.0,794.0,794.0
0.006,6,10,1643,5,860,1.0,592.0,592.0,5,783,1.0,515.0,515.0
0.004,6,10,2006,5,927,1.0,659.0,659.0,5,1079,1.0,811.0,811.0
300.363,6,16,2170,9,684,37524.0,146.0,146.0,7,1486,50032.0,419.0,398.0
0.015,6,13,3735,7,497,2.0,125.0,125.0,6,3238,3.0,1470.0,1459.0
0.008,6,10,1779,5,928,2.0,660.0,660.0,5,851,2.0,583.0,583.0
0.005,6,10,1689,5,839,1.0,571.0,571.0,5,850,1.0,582.0,582.0
0.122,6,10,1506,5,395,29.0,127.0,127.0,5,1111,28.0,843.0,843.0
0.011,6,10,1990,5,911,2.0,643.0,643.0,5,1079,2.0,811.0,811.0
0.018,6,10,1990,5,911,4.0,643.0,643.0,5,1079,4.0,811.0,811.0
0.012,6,10,1990,5,911,3.0,643.0,643.0,5,1079,3.0,811.0,811.0
0.003,17,2,136,1,60,0.0,32.0,32.0,1,76,0.0,48.0,48.0
0.071,17,4,284,2,120,0.0,32.0,32.0,2,164,33.0,60.0,54.0
136.635,6,21,8147,11,1985,81.0,1174.0,504.0,10,6162,15162.0,2720.0,958.0
0.007,6,10,1547,5,764,1.0,496.0,496.0,5,783,1.0,515.0,515.0
0.012,6,10,1972,5,910,3.0,642.0,642.0,5,1062,2.0,794.0,794.0
0.01,6,10,2006,5,927,2.0,659.0,659.0,5,1079,2.0,811.0,811.0
0.005,6,10,2006,5,927,1.0,659.0,659.0,5,1079,1.0,811.0,811.0
0.009,6,10,1983,5,910,2.0,642.0,642.0,5,1073,2.0,805.0,805.0
0.005,17,2,154,1,69,0.0,41.0,41.0,1,85,0.0,57.0,57.0
0.004,17,4,284,2,120,0.0,32.0,32.0,2,164,1.0,60.0,54.0
0.151,6,10,1506,5,395,37.0,127.0,127.0,5,1111,35.0,843.0,843.0
0.011,6,10,1990,5,911,2.0,643.0,643.0,5,1079,2.0,811.0,811.0
0.004,6,10,1774,5,923,1.0,655.0,655.0,5,851,1.0,583.0,583.0
0.106,6,10,1506,5,395,20.0,127.0,127.0,5,1111,23.0,843.0,843.0
0.011,6,10,1989,5,910,2.0,642.0,642.0,5,1079,2.0,811.0,811.0
0.096,6,10,1506,5,395,22.0,127.0,127.0,5,1111,19.0,843.0,843.0
0.003,17,2,148,1,60,0.0,32.0,32.0,1,88,0.0,60.0,60.0
0.11,6,10,1506,5,395,26.0,127.0,127.0,5,1111,20.0,843.0,843.0
0.14,6,10,1506,5,395,33.0,127.0,127.0,5,1111,33.0,843.0,843.0
0.012,17,2,136,1,60,0.0,32.0,32.0,1,76,0.0,48.0,48.0
40.058,17,10,676,5,460,10013.0,104.0,64.0,5,216,10013.0,20.0,15.0
0.025,6,10,1762,5,911,6.0,643.0,643.0,5,851,6.0,583.0,583.0
0.009,6,12,1926,6,1189,1.0,659.0,434.0,6,737,1.0,417.0,417.0
0.01,6,10,1972,5,910,2.0,642.0,642.0,5,1062,2.0,794.0,794.0
240.077,6,16,4480,9,963,30009.0,238.0,166.0,7,3517,40012.0,1402.0,786.0
0.114,6,10,1506,5,395,26.0,127.0,127.0,5,1111,25.0,843.0,843.0
0.005,17,2,164,1,74,0.0,46.0,46.0,1,90,0.0,62.0,62.0
0.006,6,10,1547,5,764,1.0,496.0,496.0,5,783,1.0,515.0,515.0
0.158,6,10,1506,5,395,37.0,127.0,127.0,5,1111,35.0,843.0,843.0
40.04,17,10,676,5,460,10007.0,104.0,64.0,5,216,10009.0,20.0,15.0
0.009,6,13,3735,7,497,1.0,125.0,125.0,6,3238,1.0,1470.0,1459.0
0.089,6,10,1506,5,395,20.0,127.0,127.0,5,1111,19.0,843.0,843.0
0.006,6,10,1547,5,764,1.0,496.0,496.0,5,783,1.0,515.0,515.0
0.001,17,2,180,1,66,0.0,38.0,38.0,1,114,0.0,86.0,86.0
11.189,17,28,4424,14,1995,847.0,270.0,114.0,14,2429,847.0,588.0,145.0
0.01,6,10,1972,5,910,2.0,642.0,642.0,5,1062,2.0,794.0,794.0
0.111,6,10,1506,5,395,25.0,127.0,127.0,5,1111,26.0,843.0,843.0
0.009,6,10,1972,5,910,2.0,642.0,642.0,5,1062,2.0,794.0,794.0
0.006,6,10,1547,5,764,1.0,496.0,496.0,5,783,1.0,515.0,515.0
0.071,17,2,144,1,64,0.0,36.0,36.0,1,80,0.0,52.0,52.0
0.138,6,10,1506,5,395,29.0,127.0,127.0,5,1111,30.0,843.0,843.0
240.118,6,16,4481,9,963,30014.0,238.0,166.0,7,3518,40016.0,1402.0,786.0
0.013,6,10,1989,5,910,3.0,642.0,642.0,5,1079,3.0,811.0,811.0
0.043,17,2,152,1,76,0.0,48.0,48.0,1,76,0.0,48.0,48.0
0.005,17,2,140,1,62,0.0,34.0,34.0,1,78,0.0,50.0,50.0
0.005,6,10,1774,5,923,1.0,655.0,655.0,5,851,1.0,583.0,583.0
0.07,6,10,1506,5,395,14.0,127.0,127.0,5,1111,14.0,843.0,843.0
0.016,6,10,1631,5,848,4.0,580.0,580.0,5,783,4.0,515.0,515.0
0.005,6,10,2006,5,927,1.0,659.0,659.0,5,1079,1.0,811.0,811.0
0.011,6,10,1990,5,911,2.0,643.0,643.0,5,1079,2.0,811.0,811.0
15.194,17,39,20097,21,17030,758.0,1350.0,782.0,18,3067,892.0,1350.0,142.0
366.543,6,26,4253,12,3102,10913.0,494.0,494.0,14,1151,28195.0,83.0,83.0
0.221,6,16,2669,8,1395,31.0,533.0,323.0,8,1274,20.0,529.0,212.0
240.033,6,9,787,5,488,60008.0,232.0,232.0,4,299,80010.0,83.0,83.0
0.001,17,2,180,1,66,0.0,38.0,38.0,1,114,0.0,86.0,86.0
0.012,17,2,152,1,56,0.0,28.0,28.0,1,96,0.0,68.0,68.0
0.017,6,10,1631,5,848,4.0,580.0,580.0,5,783,4.0,515.0,515.0
0.001,17,2,180,1,66,0.0,38.0,38.0,1,114,0.0,86.0,86.0
0.003,17,2,136,1,60,0.0,32.0,32.0,1,76,0.0,48.0,48.0
0.001,17,2,136,1,60,0.0,32.0,32.0,1,76,0.0,48.0,48.0
10.811,17,28,4421,14,1993,823.0,268.0,114.0,14,2428,823.0,587.0,145.0
242.277,6,395,348054,192,21493,1268.0,2736.0,959.0,203,326561,1199.0,2804.0,1628.0
0.007,17,2,140,1,62,0.0,34.0,34.0,1,78,0.0,50.0,50.0
0.102,6,10,1506,5,395,22.0,127.0,127.0,5,1111,24.0,843.0,843.0
0.014,6,10,1990,5,911,3.0,643.0,643.0,5,1079,3.0,811.0,811.0
0.022,6,10,1989,5,910,5.0,642.0,642.0,5,1079,5.0,811.0,811.0
0.079,6,10,1506,5,395,17.0,127.0,127.0,5,1111,17.0,843.0,843.0
0.003,17,2,136,1,60,0.0,32.0,32.0,1,76,0.0,48.0,48.0
0.009,6,10,1989,5,910,2.0,642.0,642.0,5,1079,2.0,811.0,811.0
0.093,6,10,1506,5,395,21.0,127.0,127.0,5,1111,19.0,843.0,843.0
0.009,6,10,1990,5,911,2.0,643.0,643.0,5,1079,2.0,811.0,811.0
240.114,6,33,9663,16,7129,16007.0,2189.0,698.0,17,2534,15006.0,580.0,205.0
0.013,6,10,1989,5,910,3.0,642.0,642.0,5,1079,3.0,811.0,811.0
0.011,6,10,1989,5,910,2.0,642.0,642.0,5,1079,2.0,811.0,811.0
0.071,6,10,1506,5,395,16.0,127.0,127.0,5,1111,15.0,843.0,843.0
0.01,6,10,1989,5,910,2.0,642.0,642.0,5,1079,2.0,811.0,811.0
0.006,6,10,2006,5,927,1.0,659.0,659.0,5,1079,1.0,811.0,811.0
300.024,6,12,1782,7,1348,50004.0,494.0,494.0,5,434,75005.0,83.0,83.0
0.03,6,19,9922,11,704,3.0,124.0,124.0,8,9218,4.0,2896.0,2198.0
240.059,6,9,787,5,488,60014.0,232.0,232.0,4,299,80010.0,83.0,83.0
0.167,17,2,152,1,76,0.0,48.0,48.0,1,76,0.0,48.0,48.0
0.004,6,10,2006,5,927,1.0,659.0,659.0,5,1079,1.0,811.0,811.0
0.004,6,10,2000,5,927,1.0,659.0,659.0,5,1073,1.0,805.0,805.0
0.011,6,10,1989,5,910,2.0,642.0,642.0,5,1079,2.0,811.0,811.0
0.001,17,2,132,1,58,0.0,30.0,30.0,1,74,0.0,46.0,46.0
0.075,6,10,1506,5,395,16.0,127.0,127.0,5,1111,16.0,843.0,843.0
0.009,6,10,1631,5,848,2.0,580.0,580.0,5,783,2.0,515.0,515.0
0.005,17,2,178,1,65,0.0,37.0,37.0,1,113,0.0,85.0,85.0
0.015,6,10,1972,5,910,3.0,642.0,642.0,5,1062,3.0,794.0,794.0
0.102,6,10,1506,5,395,21.0,127.0,127.0,5,1111,20.0,843.0,843.0
0.006,17,2,166,1,75,0.0,47.0,47.0,1,91,0.0,63.0,63.0
0.014,6,10,1990,5,911,3.0,643.0,643.0,5,1079,3.0,811.0,811.0
0.012,6,10,1989,5,910,2.0,642.0,642.0,5,1079,2.0,811.0,811.0
0.005,17,2,170,1,65,0.0,37.0,37.0,1,105,0.0,77.0,77.0
0.087,6,10,1506,5,395,18.0,127.0,127.0,5,1111,16.0,843.0,843.0
300.198,6,29,10050,17,1491,18762.0,260.0,149.0,12,8559,21833.0,1561.0,990.0
0.008,6,10,1989,5,910,1.0,642.0,642.0,5,1079,1.0,811.0,811.0
0.168,6,10,1506,5,395,40.0,127.0,127.0,5,1111,39.0,843.0,843.0
177.259,17,82,11683,41,2737,4431.0,44.0,38.0,41,8946,4431.0,239.0,190.0
0.095,6,10,1506,5,395,20.0,127.0,127.0,5,1111,21.0,843.0,843.0
0.005,6,10,2007,5,928,1.0,660.0,660.0,5,1079,1.0,811.0,811.0
0.016,6,13,3735,7,497,2.0,125.0,125.0,6,3238,3.0,1470.0,1459.0
73.521,6,22,8496,12,2236,74.0,1345.0,574.0,10,6260,8150.0,1776.0,974.0
0.006,6,10,1854,5,889,1.0,621.0,621.0,5,965,1.0,697.0,697.0
0.014,6,10,1631,5,848,3.0,580.0,580.0,5,783,3.0,515.0,515.0
0.053,17,2,152,1,76,0.0,48.0,48.0,1,76,0.0,48.0,48.0
0.014,6,10,1989,5,910,3.0,642.0,642.0,5,1079,3.0,811.0,811.0
0.004,6,10,2007,5,928,1.0,660.0,660.0,5,1079,1.0,811.0,811.0
40.058,17,10,676,5,460,10013.0,104.0,64.0,5,216,10013.0,20.0,15.0
0.005,17,2,214,1,75,0.0,47.0,47.0,1,139,0.0,111.0,111.0
0.018,6,10,1989,5,910,4.0,642.0,642.0,5,1079,4.0,811.0,811.0
0.129,6,10,1506,5,395,29.0,127.0,127.0,5,1111,31.0,843.0,843.0
0.004,17,2,148,1,60,0.0,32.0,32.0,1,88,0.0,60.0,60.0
0.022,6,10,1972,5,910,5.0,642.0,642.0,5,1062,5.0,794.0,794.0
0.005,6,10,1774,5,923,1.0,655.0,655.0,5,851,1.0,583.0,583.0
0.015,6,10,1989,5,910,3.0,642.0,642.0,5,1079,3.0,811.0,811.0
0.005,6,10,1989,5,927,1.0,659.0,659.0,5,1062,1.0,794.0,794.0
0.005,6,10,1774,5,923,1.0,655.0,655.0,5,851,1.0,583.0,583.0
333.441,17,20,1124,10,716,37037.0,48.0,43.0,10,408,37038.0,20.0,12.0
0.005,17,2,144,1,64,0.0,36.0,36.0,1,80,0.0,52.0,52.0
0.004,17,2,136,1,60,0.0,32.0,32.0,1,76,0.0,48.0,48.0
0.014,6,10,1631,5,848,3.0,580.0,580.0,5,783,3.0,515.0,515.0
1756.064,6,105,6240,60,3510,29763.0,26.0,26.0,45,2730,39909.0,26.0,26.0
0.017,6,10,1762,5,911,4.0,643.0,643.0,5,851,4.0,583.0,583.0
0.004,17,2,144,1,64,0.0,36.0,36.0,1,80,0.0,52.0,52.0
0.126,17,2,166,1,75,0.0,47.0,47.0,1,91,0.0,63.0,63.0
0.005,6,14,3799,7,509,0.0,137.0,137.0,7,3290,0.0,1448.0,972.0
0.005,6,10,1702,5,863,1.0,595.0,595.0,5,839,1.0,571.0,571.0
0.072,17,2,412,1,61,0.0,33.0,33.0,1,351,0.0,323.0,323.0
0.006,6,10,1547,5,764,1.0,496.0,496.0,5,783,1.0,515.0,515.0
0.161,6,10,1506,5,395,38.0,127.0,127.0,5,1111,37.0,843.0,843.0
0.006,6,10,1689,5,839,1.0,571.0,571.0,5,850,1.0,582.0,582.0
0.004,6,10,1702,5,863,1.0,595.0,595.0,5,839,0.0,571.0,571.0
0.007,17,2,194,1,59,0.0,31.0,31.0,1,135,0.0,107.0,107.0
0.005,6,13,3747,7,509,0.0,137.0,137.0,6,3238,0.0,1470.0,1459.0
0.015,6,14,3787,7,497,2.0,125.0,125.0,7,3290,2.0,1448.0,972.0
0.011,6,10,1762,5,911,2.0,643.0,643.0,5,851,2.0,583.0,583.0
0.013,6,10,1989,5,910,3.0,642.0,642.0,5,1079,3.0,811.0,811.0
0.005,6,10,1689,5,839,1.0,571.0,571.0,5,850,1.0,582.0,582.0
0.006,6,10,1643,5,860,1.0,592.0,592.0,5,783,1.0,515.0,515.0
0.006,6,10,2006,5,927,1.0,659.0,659.0,5,1079,1.0,811.0,811.0
172.348,17,80,11394,40,2665,4419.0,44.0,38.0,40,8729,4419.0,239.0,190.0
0.121,6,10,1506,5,395,26.0,127.0,127.0,5,1111,24.0,843.0,843.0
0.011,6,10,1990,5,911,2.0,643.0,643.0,5,1079,2.0,811.0,811.0
0.04,17,2,136,1,60,0.0,32.0,32.0,1,76,0.0,48.0,48.0
0.019,6,10,1983,5,910,4.0,642.0,642.0,5,1073,4.0,805.0,805.0
170.228,17,76,10723,38,2529,4600.0,44.0,38.0,38,8194,4600.0,261.0,187.0
0.007,17,2,132,1,58,0.0,30.0,30.0,1,74,0.0,46.0,46.0
40.079,17,10,676,5,460,10019.0,104.0,64.0,5,216,10018.0,20.0,15.0
0.011,6,10,1983,5,910,2.0,642.0,642.0,5,1073,2.0,805.0,805.0
0.006,17,2,214,1,75,0.0,47.0,47.0,1,139,0.0,111.0,111.0
10.817,17,28,4419,14,1994,823.0,269.0,114.0,14,2425,823.0,588.0,145.0
0.004,17,2,136,1,60,0.0,32.0,32.0,1,76,0.0,48.0,48.0
0.08,6,10,1506,5,395,17.0,127.0,127.0,5,1111,17.0,843.0,843.0
0.041,17,2,136,1,60,0.0,32.0,32.0,1,76,0.0,48.0,48.0
241.34,6,312,344256,120,17745,2028.0,2736.0,885.0,192,326511,1263.0,2804.0,1739.0
0.005,6,10,1689,5,839,1.0,571.0,571.0,5,850,1.0,582.0,582.0
0.013,6,10,1972,5,910,3.0,642.0,642.0,5,1062,3.0,794.0,794.0
0.005,6,10,2006,5,927,1.0,659.0,659.0,5,1079,1.0,811.0,811.0
0.007,6,10,1547,5,764,1.0,496.0,496.0,5,783,1.0,515.0,515.0
0.013,6,10,1972,5,910,3.0,642.0,642.0,5,1062,3.0,794.0,794.0
0.004,6,10,2006,5,927,1.0,659.0,659.0,5,1079,1.0,811.0,811.0
0.003,17,2,136,1,60,0.0,32.0,32.0,1,76,0.0,48.0,48.0
0.012,6,10,1989,5,910,3.0,642.0,642.0,5,1079,3.0,811.0,811.0
0.014,6,10,1972,5,910,3.0,642.0,642.0,5,1062,3.0,794.0,794.0
0.082,6,10,1506,5,395,17.0,127.0,127.0,5,1111,19.0,843.0,843.0
0.085,6,10,1506,5,395,18.0,127.0,127.0,5,1111,17.0,843.0,843.0
40.065,17,10,676,5,460,10015.0,104.0,64.0,5,216,10015.0,20.0,15.0
0.006,6,10,1854,5,1169,1.0,901.0,901.0,5,685,1.0,417.0,417.0
40.084,17,10,676,5,460,10020.0,104.0,64.0,5,216,10020.0,20.0,15.0
0.015,6,10,1989,5,910,3.0,642.0,642.0,5,1079,3.0,811.0,811.0
1770.473,6,83,4368,42,2210,43181.0,26.0,26.0,41,2158,44260.0,26.0,26.0
0.13,17,2,148,1,60,0.0,32.0,32.0,1,88,0.0,60.0,60.0
0.099,6,10,1506,5,395,21.0,127.0,127.0,5,1111,19.0,843.0,843.0
0.006,6,10,1547,5,764,1.0,496.0,496.0,5,783,1.0,515.0,515.0
1770.931,17,120,11460,60,5460,30015.0,63.0,63.0,60,6000,30015.0,72.0,72.0
0.189,6,10,1506,5,395,45.0,127.0,127.0,5,1111,36.0,843.0,843.0
0.17,6,10,1506,5,395,41.0,127.0,127.0,5,1111,35.0,843.0,843.0
10.825,17,28,4422,14,1995,824.0,270.0,114.0,14,2427,824.0,586.0,145.0
0.005,17,2,164,1,74,0.0,46.0,46.0,1,90,0.0,62.0,62.0
0.014,6,10,1972,5,910,3.0,642.0,642.0,5,1062,3.0,794.0,794.0
0.025,6,13,3735,7,497,4.0,125.0,125.0,6,3238,4.0,1470.0,1459.0
0.016,6,10,1972,5,910,4.0,642.0,642.0,5,1062,4.0,794.0,794.0
0.005,6,10,1774,5,923,1.0,655.0,655.0,5,851,1.0,583.0,583.0
240.088,6,16,4481,9,963,30011.0,238.0,166.0,7,3518,40014.0,1402.0,786.0
0.013,6,10,1762,5,911,3.0,643.0,643.0,5,851,3.0,583.0,583.0
0.016,6,10,1983,5,910,3.0,642.0,642.0,5,1073,3.0,805.0,805.0
0.094,6,10,1506,5,395,22.0,127.0,127.0,5,1111,19.0,843.0,843.0
0.089,6,10,1506,5,395,20.0,127.0,127.0,5,1111,19.0,843.0,843.0
40.067,17,10,676,5,460,10013.0,104.0,64.0,5,216,10015.0,20.0,15.0
0.005,6,10,2000,5,927,1.0,659.0,659.0,5,1073,1.0,805.0,805.0
0.001,17,2,268,1,70,0.0,42.0,42.0,1,198,0.0,170.0,170.0
0.005,6,10,1854,5,889,1.0,621.0,621.0,5,965,1.0,697.0,697.0
15.144,17,18,9619,9,7404,1886.0,1350.0,794.0,9,2215,1884.0,1350.0,218.0
0.009,6,10,1972,5,910,2.0,642.0,642.0,5,1062,2.0,794.0,794.0
0.013,6,10,1972,5,910,3.0,642.0,642.0,5,1062,3.0,794.0,794.0
0.101,6,10,1506,5,395,21.0,127.0,127.0,5,1111,24.0,843.0,843.0
0.005,6,10,1854,5,889,1.0,621.0,621.0,5,965,1.0,697.0,697.0
364.374,6,19,1689,15,978,26026.0,190.0,190.0,4,711,80013.0,495.0,495.0
0.012,6,10,1989,5,910,3.0,642.0,642.0,5,1079,3.0,811.0,811.0
0.005,6,10,2006,5,927,1.0,659.0,659.0,5,1079,1.0,811.0,811.0
361.841,6,21,1793,16,1030,24122.0,190.0,190.0,5,763,60009.0,462.0,247.0
0.001,17,2,180,1,66,0.0,38.0,38.0,1,114,0.0,86.0,86.0
0.003,17,2,148,1,60,0.0,32.0,32.0,1,88,0.0,60.0,60.0
0.005,6,10,2006,5,927,1.0,659.0,659.0,5,1079,1.0,811.0,811.0
0.004,17,2,148,1,60,0.0,32.0,32.0,1,88,0.0,60.0,60.0
0.02,6,10,1983,5,910,4.0,642.0,642.0,5,1073,4.0,805.0,805.0
0.005,6,10,2006,5,927,1.0,659.0,659.0,5,1079,1.0,811.0,811.0
0.009,6,10,1983,5,910,2.0,642.0,642.0,5,1073,2.0,805.0,805.0
18.803,6,24,7517,13,1385,1566.0,530.0,277.0,11,6132,1864.0,2720.0,946.0
0.008,6,14,3787,7,497,1.0,125.0,125.0,7,3290,1.0,1448.0,972.0
0.013,6,10,1989,5,910,3.0,642.0,642.0,5,1079,3.0,811.0,811.0
15.079,17,19,8787,9,6293,1881.0,1350.0,671.0,10,2494,1672.0,1350.0,221.0
0.016,6,10,1972,5,910,4.0,642.0,642.0,5,1062,4.0,794.0,794.0
0.001,17,2,140,1,62,0.0,34.0,34.0,1,78,0.0,50.0,50.0
0.02,6,10,1990,5,911,5.0,643.0,643.0,5,1079,4.0,811.0,811.0
0.037,17,2,136,1,60,0.0,32.0,32.0,1,76,0.0,48.0,48.0
175.293,17,68,9774,34,2267,5311.0,44.0,38.0,34,7507,5311.0,239.0,192.0
0.04,17,4,284,2,120,0.0,32.0,32.0,2,164,36.0,60.0,54.0
0.116,6,10,1506,5,395,26.0,127.0,127.0,5,1111,25.0,843.0,843.0
173.094,17,80,11548,40,2681,4437.0,44.0,39.0,40,8867,4438.0,239.0,193.0
0.001,17,2,179,1,62,0.0,34.0,34.0,1,117,0.0,89.0,89.0
0.08,6,10,1506,5,395,16.0,127.0,127.0,5,1111,19.0,843.0,843.0
0.034,6,19,9922,11,704,3.0,124.0,124.0,8,9218,4.0,2896.0,2198.0
0.023,6,10,1989,5,910,5.0,642.0,642.0,5,1079,5.0,811.0,811.0
0.037,17,2,136,1,60,0.0,32.0,32.0,1,76,0.0,48.0,48.0
0.001,17,2,180,1,66,0.0,38.0,38.0,1,114,0.0,86.0,86.0
0.009,6,10,1631,5,848,2.0,580.0,580.0,5,783,2.0,515.0,515.0
0.054,17,2,152,1,76,0.0,48.0,48.0,1,76,0.0,48.0,48.0
0.123,17,2,136,1,60,0.0,32.0,32.0,1,76,0.0,48.0,48.0
0.005,6,10,2007,5,928,1.0,660.0,660.0,5,1079,1.0,811.0,811.0
0.12,6,10,1506,5,395,27.0,127.0,127.0,5,1111,27.0,843.0,843.0
0.005,6,10,2006,5,927,1.0,659.0,659.0,5,1079,1.0,811.0,811.0
10.774,17,28,4422,14,1995,819.0,270.0,114.0,14,2427,819.0,586.0,145.0
0.001,17,2,180,1,66,0.0,38.0,38.0,1,114,0.0,86.0,86.0
240.092,6,16,4480,9,963,30011.0,238.0,166.0,7,3517,40014.0,1402.0,786.0
0.102,6,10,1506,5,395,24.0,127.0,127.0,5,1111,23.0,843.0,843.0
354.05,6,21,1795,16,1030,23603.0,190.0,190.0,5,765,60003.0,464.0,248.0
0.132,17,4,352,2,130,0.0,37.0,37.0,2,222,95.0,89.0,83.0
0.04,17,2,152,1,76,0.0,48.0,48.0,1,76,0.0,48.0,48.0
0.014,6,10,1983,5,910,3.0,642.0,642.0,5,1073,3.0,805.0,805.0
0.005,6,10,2006,5,927,1.0,659.0,659.0,5,1079,1.0,811.0,811.0
0.005,6,10,1643,5,860,1.0,592.0,592.0,5,783,1.0,515.0,515.0
0.005,6,10,2006,5,927,1.0,659.0,659.0,5,1079,1.0,811.0,811.0
0.078,17,2,80,1,32,0.0,4.0,4.0,1,48,0.0,20.0,20.0
0.006,6,10,1689,5,839,1.0,571.0,571.0,5,850,1.0,582.0,582.0
0.005,6,10,2006,5,927,1.0,659.0,659.0,5,1079,1.0,811.0,811.0
0.004,17,2,148,1,60,0.0,32.0,32.0,1,88,0.0,60.0,60.0
240.852,6,27,7601,12,3361,21895.0,1001.0,685.0,15,4240,17203.0,1162.0,383.0
0.128,6,10,1506,5,395,25.0,127.0,127.0,5,1111,26.0,843.0,843.0
15.139,17,16,8631,8,6325,2158.0,1350.0,762.0,8,2306,2150.0,1350.0,260.0
0.06,6,10,1506,5,395,14.0,127.0,127.0,5,1111,12.0,843.0,843.0
0.016,6,10,1990,5,911,4.0,643.0,643.0,5,1079,4.0,811.0,811.0
126.062,6,14,2938,8,2504,17975.0,1414.0,1086.0,6,434,25165.0,182.0,182.0
0.008,6,10,1989,5,910,1.0,642.0,642.0,5,1079,2.0,811.0,811.0
0.07,17,8,3613,4,1874,23.0,1350.0,440.0,4,1739,12.0,1350.0,406.0
0.112,6,10,1506,5,395,24.0,127.0,127.0,5,1111,25.0,843.0,843.0
0.01,6,10,1677,5,827,2.0,559.0,559.0,5,850,2.0,582.0,582.0
0.067,6,10,1506,5,395,15.0,127.0,127.0,5,1111,15.0,843.0,843.0
0.013,6,10,1983,5,910,3.0,642.0,642.0,5,1073,3.0,805.0,805.0
0.005,6,10,1689,5,839,1.0,571.0,571.0,5,850,1.0,582.0,582.0
0.011,6,10,1972,5,910,2.0,642.0,642.0,5,1062,2.0,794.0,794.0
240.087,6,16,4480,9,963,30010.0,238.0,166.0,7,3517,40014.0,1402.0,786.0
0.055,6,10,1506,5,395,13.0,127.0,127.0,5,1111,12.0,843.0,843.0
300.761,6,41,14174,22,8616,14321.0,2720.0,1100.0,19,5558,477.0,2667.0,435.0
0.011,6,10,1989,5,910,2.0,642.0,642.0,5,1079,2.0,811.0,811.0
300.885,6,41,11786,22,6183,14327.0,4080.0,1051.0,19,5603,482.0,2667.0,402.0
0.099,6,10,1506,5,395,22.0,127.0,127.0,5,1111,21.0,843.0,843.0
0.005,17,2,164,1,74,0.0,46.0,46.0,1,90,0.0,62.0,62.0
40.065,17,10,676,5,460,10015.0,104.0,64.0,5,216,10015.0,20.0,15.0
0.103,6,10,1506,5,395,24.0,127.0,127.0,5,1111,22.0,843.0,843.0
0.001,17,2,180,1,66,0.0,38.0,38.0,1,114,0.0,86.0,86.0
0.015,6,10,1631,5,848,3.0,580.0,580.0,5,783,3.0,515.0,515.0
15.075,17,16,9035,8,6771,2149.0,1350.0,818.0,8,2264,2149.0,1350.0,255.0
0.018,6,10,1972,5,910,4.0,642.0,642.0,5,1062,4.0,794.0,794.0
0.08,6,10,1506,5,395,17.0,127.0,127.0,5,1111,15.0,843.0,843.0
0.013,6,10,1990,5,911,3.0,643.0,643.0,5,1079,3.0,811.0,811.0
0.01,6,10,1989,5,910,2.0,642.0,642.0,5,1079,2.0,811.0,811.0
0.006,6,10,1854,5,889,1.0,621.0,621.0,5,965,1.0,697.0,697.0
369.472,6,22,2313,16,867,24631.0,195.0,195.0,6,1446,4645.0,419.0,398.0
0.011,6,10,1983,5,910,2.0,642.0,642.0,5,1073,2.0,805.0,805.0
0.224,6,16,2777,8,1395,32.0,533.0,323.0,8,1382,20.0,529.0,239.0
0.006,6,10,1689,5,839,1.0,571.0,571.0,5,850,1.0,582.0,582.0
0.006,6,10,2006,5,927,1.0,659.0,659.0,5,1079,1.0,811.0,811.0
0.008,6,13,3747,7,509,1.0,137.0,137.0,6,3238,1.0,1470.0,1459.0
15.073,17,15,9238,8,6902,2149.0,1350.0,834.0,7,2336,2507.0,1350.0,305.0
0.014,6,10,1677,5,827,3.0,559.0,559.0,5,850,3.0,582.0,582.0
0.01,6,10,1989,5,910,2.0,642.0,642.0,5,1079,2.0,811.0,811.0
0.001,17,2,180,1,66,0.0,38.0,38.0,1,114,0.0,86.0,86.0
0.004,6,10,2006,5,927,1.0,659.0,659.0,5,1079,1.0,811.0,811.0
0.006,6,10,1547,5,764,1.0,496.0,496.0,5,783,1.0,515.0,515.0
0.006,6,14,3799,7,509,0.0,137.0,137.0,7,3290,0.0,1448.0,972.0
11.439,17,28,4390,14,2312,867.0,587.0,137.0,14,2078,867.0,269.0,120.0
0.234,17,16,8767,8,6276,33.0,1350.0,756.0,8,2491,21.0,1350.0,283.0
0.006,6,10,1854,5,889,1.0,621.0,621.0,5,965,1.0,697.0,697.0
0.005,6,10,1689,5,839,1.0,571.0,571.0,5,850,1.0,582.0,582.0
0.011,6,10,1989,5,910,2.0,642.0,642.0,5,1079,2.0,811.0,811.0
0.171,17,2,152,1,76,0.0,48.0,48.0,1,76,0.0,48.0,48.0
0.016,17,2,198,1,91,0.0,63.0,63.0,1,107,0.0,79.0,79.0
1797.229,6,64,7344,42,4469,43834.0,1625.0,108.0,22,2875,85574.0,1111.0,82.0
309.239,17,20,1124,10,716,34345.0,48.0,43.0,10,408,34345.0,20.0,12.0
0.041,17,2,148,1,60,0.0,32.0,32.0,1,88,0.0,60.0,60.0
0.039,17,4,284,2,120,0.0,32.0,32.0,2,164,36.0,60.0,54.0
0.004,17,2,136,1,60,0.0,32.0,32.0,1,76,0.0,48.0,48.0
0.005,6,13,3747,7,509,0.0,137.0,137.0,6,3238,0.0,1470.0,1459.0
0.005,17,2,170,1,65,0.0,37.0,37.0,1,105,0.0,77.0,77.0
0.02,6,10,1989,5,910,4.0,642.0,642.0,5,1079,5.0,811.0,811.0
0.019,6,10,1989,5,910,4.0,642.0,642.0,5,1079,4.0,811.0,811.0
0.014,17,2,136,1,60,0.0,32.0,32.0,1,76,0.0,48.0,48.0
0.004,6,10,2000,5,927,1.0,659.0,659.0,5,1073,1.0,805.0,805.0
0.01,6,10,1854,5,889,2.0,621.0,621.0,5,965,2.0,697.0,697.0
0.004,6,10,2000,5,927,1.0,659.0,659.0,5,1073,1.0,805.0,805.0
0.017,6,10,1972,5,910,4.0,642.0,642.0,5,1062,4.0,794.0,794.0
0.084,6,10,1506,5,395,19.0,127.0,127.0,5,1111,17.0,843.0,843.0
0.006,6,10,1779,5,928,1.0,660.0,660.0,5,851,1.0,583.0,583.0
0.066,17,8,3613,4,1874,22.0,1350.0,440.0,4,1739,11.0,1350.0,406.0
0.112,6,10,1506,5,395,24.0,127.0,127.0,5,1111,25.0,843.0,843.0
0.018,6,10,1990,5,911,4.0,643.0,643.0,5,1079,4.0,811.0,811.0
540.575,17,134,19383,67,4464,8190.0,44.0,38.0,67,14919,8190.0,252.0,194.0
0.009,6,12,1926,6,1189,1.0,659.0,434.0,6,737,1.0,417.0,417.0
300.229,6,40,12493,21,6935,15003.0,2720.0,1010.0,19,5558,16669.0,2667.0,435.0
0.083,6,10,1506,5,395,17.0,127.0,127.0,5,1111,15.0,843.0,843.0
0.128,17,2,182,1,65,0.0,37.0,37.0,1,117,0.0,89.0,89.0
40.062,17,10,676,5,460,10014.0,104.0,64.0,5,216,10014.0,20.0,15.0
332.633,17,20,1124,10,716,36952.0,48.0,43.0,10,408,36952.0,20.0,12.0
0.004,17,2,148,1,60,0.0,32.0,32.0,1,88,0.0,60.0,60.0
0.005,6,10,1989,5,927,1.0,659.0,659.0,5,1062,1.0,794.0,794.0
0.004,6,10,1702,5,863,1.0,595.0,595.0,5,839,1.0,571.0,571.0
0.03,6,10,1989,5,910,7.0,642.0,642.0,5,1079,7.0,811.0,811.0
174.099,17,82,11577,41,2736,4352.0,44.0,38.0,41,8841,4352.0,252.0,187.0
0.012,6,10,1989,5,910,3.0,642.0,642.0,5,1079,3.0,811.0,811.0
0.006,6,10,1547,5,764,1.0,496.0,496.0,5,783,1.0,515.0,515.0
1770.32,6,83,4368,42,2210,43177.0,26.0,26.0,41,2158,44256.0,26.0,26.0
0.003,17,2,136,1,60,0.0,32.0,32.0,1,76,0.0,48.0,48.0
0.017,6,10,1677,5,827,4.0,559.0,559.0,5,850,4.0,582.0,582.0
0.005,6,10,1854,5,889,1.0,621.0,621.0,5,965,1.0,697.0,697.0
300.39,6,16,2170,9,684,37528.0,146.0,146.0,7,1486,50036.0,419.0,398.0
0.006,6,10,2006,5,927,1.0,659.0,659.0,5,1079,1.0,811.0,811.0
0.005,6,10,1643,5,860,1.0,592.0,592.0,5,783,1.0,515.0,515.0
0.007,17,2,179,1,71,0.0,43.0,43.0,1,108,0.0,80.0,80.0
0.005,6,10,2007,5,928,1.0,660.0,660.0,5,1079,1.0,811.0,811.0
0.006,17,2,140,1,62,0.0,34.0,34.0,1,78,0.0,50.0,50.0
0.016,6,10,1631,5,848,3.0,580.0,580.0,5,783,4.0,515.0,515.0
310.219,17,20,1124,10,716,34455.0,48.0,43.0,10,408,34454.0,20.0,12.0
0.006,6,10,1547,5,764,1.0,496.0,496.0,5,783,1.0,515.0,515.0
1770.231,6,80,4211,40,2107,45389.0,27.0,27.0,40,2104,45389.0,24.0,24.0
40.055,17,10,676,5,460,10013.0,104.0,64.0,5,216,10012.0,20.0,15.0
0.016,6,10,1983,5,910,4.0,642.0,642.0,5,1073,3.0,805.0,805.0
0.006,6,10,1547,5,764,1.0,496.0,496.0,5,783,1.0,515.0,515.0
0.071,17,2,170,1,65,0.0,37.0,37.0,1,105,0.0,77.0,77.0
0.004,17,2,175,1,65,0.0,37.0,37.0,1,110,0.0,82.0,82.0
0.007,17,2,179,1,71,0.0,43.0,43.0,1,108,0.0,80.0,80.0
0.001,17,2,166,1,75,0.0,47.0,47.0,1,91,0.0,63.0,63.0
0.005,6,10,2006,5,927,1.0,659.0,659.0,5,1079,1.0,811.0,811.0
0.061,6,10,1506,5,395,14.0,127.0,127.0,5,1111,12.0,843.0,843.0
0.015,6,10,1990,5,911,3.0,643.0,643.0,5,1079,3.0,811.0,811.0
0.269,17,40,20332,22,17088,12.0,1350.0,748.0,18,3244,12.0,1350.0,152.0
0.005,17,2,164,1,74,0.0,46.0,46.0,1,90,0.0,62.0,62.0
240.013,6,9,787,5,488,60003.0,232.0,232.0,4,299,80003.0,83.0,83.0
0.005,6,10,1689,5,839,1.0,571.0,571.0,5,850,1.0,582.0,582.0
40.049,17,10,676,5,460,10011.0,104.0,64.0,5,216,10011.0,20.0,15.0
0.109,6,10,1506,5,395,24.0,127.0,127.0,5,1111,23.0,843.0,843.0
0.103,6,10,1506,5,395,21.0,127.0,127.0,5,1111,24.0,843.0,843.0
0.01,6,10,1677,5,827,2.0,559.0,559.0,5,850,2.0,582.0,582.0
0.005,17,2,170,1,65,0.0,37.0,37.0,1,105,0.0,77.0,77.0
0.004,6,10,2007,5,928,1.0,660.0,660.0,5,1079,1.0,811.0,811.0
0.166,17,2,152,1,76,0.0,48.0,48.0,1,76,0.0,48.0,48.0
288.958,6,315,344460,120,17787,2428.0,2736.0,888.0,195,326673,1489.0,4066.0,1748.0
291.141,6,409,348558,207,22316,1413.0,2736.0,888.0,202,326242,1448.0,2804.0,1679.0
1771.604,17,120,11460,60,5460,30026.0,63.0,63.0,60,6000,30026.0,72.0,72.0
0.01,6,10,1990,5,911,2.0,643.0,643.0,5,1079,2.0,811.0,811.0
1787.381,6,150,19350,90,13740,20082.0,302.0,302.0,60,5610,30294.0,83.0,83.0
0.042,17,2,136,1,60,0.0,32.0,32.0,1,76,0.0,48.0,48.0
0.077,6,10,1506,5,395,18.0,127.0,127.0,5,1111,15.0,843.0,843.0
0.095,6,10,1506,5,395,18.0,127.0,127.0,5,1111,21.0,843.0,843.0
0.04,17,4,420,2,122,0.0,33.0,33.0,2,298,2.0,145.0,121.0
0.017,6,10,1990,5,911,4.0,643.0,643.0,5,1079,4.0,811.0,811.0
0.009,6,10,1989,5,910,2.0,642.0,642.0,5,1079,2.0,811.0,811.0
0.1,6,10,1506,5,395,22.0,127.0,127.0,5,1111,21.0,843.0,843.0
291.261,6,390,348603,192,21546,1524.0,2736.0,888.0,198,327057,1478.0,3160.0,1721.0
0.013,6,10,1972,5,910,3.0,642.0,642.0,5,1062,3.0,794.0,794.0
0.007,6,10,1989,5,910,1.0,642.0,642.0,5,1079,1.0,811.0,811.0
0.013,6,10,1972,5,910,3.0,642.0,642.0,5,1062,3.0,794.0,794.0
0.005,6,10,2006,5,927,1.0,659.0,659.0,5,1079,1.0,811.0,811.0
0.01,6,10,1989,5,910,2.0,642.0,642.0,5,1079,2.0,811.0,811.0
40.06,17,10,676,5,460,10014.0,104.0,64.0,5,216,10014.0,20.0,15.0
0.013,6,10,1983,5,910,3.0,642.0,642.0,5,1073,3.0,805.0,805.0
0.004,6,10,1702,5,863,1.0,595.0,595.0,5,839,0.0,571.0,571.0
168.147,17,78,11151,39,2603,4424.0,44.0,38.0,39,8548,4424.0,239.0,191.0
0.075,6,10,1506,5,395,16.0,127.0,127.0,5,1111,16.0,843.0,843.0
0.02,6,10,1989,5,910,5.0,642.0,642.0,5,1079,4.0,811.0,811.0
240.088,6,16,4480,9,963,30011.0,238.0,166.0,7,3517,40014.0,1402.0,786.0
310.135,17,18,1008,9,640,38750.0,48.0,43.0,9,368,38750.0,20.0,12.0
0.012,6,10,1989,5,910,3.0,642.0,642.0,5,1079,2.0,811.0,811.0
0.001,17,2,180,1,65,0.0,37.0,37.0,1,115,0.0,87.0,87.0
55.833,6,28,8284,16,2900,3722.0,1038.0,515.0,12,5384,5073.0,1591.0,678.0
0.001,17,2,136,1,60,0.0,32.0,32.0,1,76,0.0,48.0,48.0
0.828,6,25,5555,12,1445,63.0,267.0,136.0,13,4110,58.0,1414.0,597.0
40.074,17,10,676,5,460,10015.0,104.0,64.0,5,216,10017.0,20.0,15.0
10.981,17,28,4398,14,2312,836.0,587.0,137.0,14,2086,836.0,269.0,121.0
0.014,6,10,1989,5,910,3.0,642.0,642.0,5,1079,3.0,811.0,811.0
361.839,6,21,1792,16,1030,24122.0,190.0,190.0,5,762,60009.0,461.0,247.0
0.007,6,12,1698,6,863,1.0,327.0,271.0,6,835,1.0,515.0,515.0
0.006,6,10,1774,5,923,1.0,655.0,655.0,5,851,1.0,583.0,583.0
0.01,6,10,1677,5,827,2.0,559.0,559.0,5,850,2.0,582.0,582.0
0.005,6,10,2007,5,928,1.0,660.0,660.0,5,1079,1.0,811.0,811.0
0.017,6,10,1762,5,911,4.0,643.0,643.0,5,851,4.0,583.0,583.0
0.105,6,10,1506,5,395,24.0,127.0,127.0,5,1111,25.0,843.0,843.0
0.29,6,11,1685,6,574,56.0,127.0,127.0,5,1111,70.0,843.0,843.0
40.074,17,10,676,5,460,10016.0,104.0,64.0,5,216,10017.0,20.0,15.0
0.003,17,2,136,1,60,0.0,32.0,32.0,1,76,0.0,48.0,48.0
0.152,6,10,1506,5,395,29.0,127.0,127.0,5,1111,36.0,843.0,843.0
0.006,17,2,164,1,74,0.0,46.0,46.0,1,90,0.0,62.0,62.0
0.006,6,10,1989,5,927,1.0,659.0,659.0,5,1062,1.0,794.0,794.0
15.306,17,26,17580,11,4326,1527.0,1350.0,365.0,15,13254,1091.0,1350.0,855.0
0.011,6,10,1990,5,911,2.0,643.0,643.0,5,1079,2.0,811.0,811.0
0.012,6,10,1631,5,848,2.0,580.0,580.0,5,783,2.0,515.0,515.0
173.03,17,84,12288,42,2826,4220.0,44.0,39.0,42,9462,4220.0,239.0,197.0
0.004,17,4,284,2,120,0.0,32.0,32.0,2,164,0.0,60.0,54.0
0.009,6,10,2007,5,928,2.0,660.0,660.0,5,1079,2.0,811.0,811.0
0.008,6,12,1926,6,1189,1.0,659.0,434.0,6,737,1.0,417.0,417.0
0.007,17,2,179,1,71,0.0,43.0,43.0,1,108,0.0,80.0,80.0
0.088,6,10,1506,5,395,17.0,127.0,127.0,5,1111,19.0,843.0,843.0
15.071,17,15,9238,8,6902,2148.0,1350.0,834.0,7,2336,2506.0,1350.0,305.0
0.006,6,10,1643,5,860,1.0,592.0,592.0,5,783,1.0,515.0,515.0
0.004,6,10,2007,5,928,1.0,660.0,660.0,5,1079,1.0,811.0,811.0
173.473,17,84,11849,42,2797,4230.0,44.0,38.0,42,9052,4231.0,261.0,187.0
133.809,6,26,9525,12,1627,74.0,794.0,367.0,14,7898,10283.0,1360.0,732.0
0.005,6,10,2006,5,927,1.0,659.0,659.0,5,1079,1.0,811.0,811.0
0.004,6,10,1779,5,928,1.0,660.0,660.0,5,851,1.0,583.0,583.0
0.004,17,4,284,2,120,0.0,32.0,32.0,2,164,1.0,60.0,54.0
0.04,17,2,152,1,76,0.0,48.0,48.0,1,76,0.0,48.0,48.0
0.038,17,2,152,1,76,0.0,48.0,48.0,1,76,0.0,48.0,48.0
0.066,6,10,1506,5,395,13.0,127.0,127.0,5,1111,15.0,843.0,843.0
0.011,6,10,1762,5,911,2.0,643.0,643.0,5,851,2.0,583.0,583.0
0.005,6,10,2006,5,927,1.0,659.0,659.0,5,1079,1.0,811.0,811.0
0.073,6,10,1506,5,395,13.0,127.0,127.0,5,1111,17.0,843.0,843.0
0.005,17,2,180,1,58,0.0,30.0,30.0,1,122,0.0,94.0,94.0
0.101,6,10,1506,5,395,20.0,127.0,127.0,5,1111,23.0,843.0,843.0
0.007,6,13,3747,7,509,1.0,137.0,137.0,6,3238,1.0,1470.0,1459.0
240.345,6,32,9214,15,1784,17167.0,624.0,199.0,17,7430,15021.0,1402.0,595.0
0.03,17,2,144,1,64,0.0,36.0,36.0,1,80,0.0,52.0,52.0
0.008,6,10,1972,5,910,2.0,642.0,642.0,5,1062,1.0,794.0,794.0
0.006,6,10,1854,5,889,1.0,621.0,621.0,5,965,1.0,697.0,697.0
0.005,17,2,213,1,69,0.0,41.0,41.0,1,144,0.0,116.0,116.0
0.091,6,10,1506,5,395,19.0,127.0,127.0,5,1111,17.0,843.0,843.0
240.094,6,16,4481,9,963,30011.0,238.0,166.0,7,3518,40015.0,1402.0,786.0
0.011,6,10,1989,5,910,2.0,642.0,642.0,5,1079,2.0,811.0,811.0
0.037,17,2,184,1,61,0.0,33.0,33.0,1,123,0.0,95.0,95.0
0.02,6,10,1631,5,848,4.0,580.0,580.0,5,783,5.0,515.0,515.0
0.129,6,10,1506,5,395,30.0,127.0,127.0,5,1111,26.0,843.0,843.0
0.05,17,2,180,1,66,0.0,38.0,38.0,1,114,0.0,86.0,86.0
240.091,6,16,4481,9,963,30011.0,238.0,166.0,7,3518,40014.0,1402.0,786.0
0.018,6,10,1972,5,910,4.0,642.0,642.0,5,1062,4.0,794.0,794.0
0.141,6,10,1506,5,395,32.0,127.0,127.0,5,1111,32.0,843.0,843.0
179.12,6,22,8186,11,1985,85.0,1174.0,504.0,11,6201,17895.0,1791.0,958.0
0.016,6,13,3735,7,497,2.0,125.0,125.0,6,3238,3.0,1470.0,1459.0
0.037,17,2,136,1,60,0.0,32.0,32.0,1,76,0.0,48.0,48.0
0.01,6,10,1990,5,911,2.0,643.0,643.0,5,1079,2.0,811.0,811.0
300.321,6,16,2170,9,684,37519.0,146.0,146.0,7,1486,50025.0,419.0,398.0
0.005,6,10,1989,5,927,1.0,659.0,659.0,5,1062,1.0,794.0,794.0
0.005,6,10,2000,5,927,1.0,659.0,659.0,5,1073,1.0,805.0,805.0
0.097,6,10,1506,5,395,22.0,127.0,127.0,5,1111,22.0,843.0,843.0
0.072,6,10,1506,5,395,15.0,127.0,127.0,5,1111,15.0,843.0,843.0
0.037,17,2,170,1,65,0.0,37.0,37.0,1,105,0.0,77.0,77.0
0.006,6,10,1547,5,764,1.0,496.0,496.0,5,783,1.0,515.0,515.0
0.021,6,10,1990,5,911,5.0,643.0,643.0,5,1079,5.0,811.0,811.0
0.11,6,10,1506,5,395,24.0,127.0,127.0,5,1111,20.0,843.0,843.0
0.017,6,10,1631,5,848,4.0,580.0,580.0,5,783,4.0,515.0,515.0
0.01,6,10,1990,5,911,2.0,643.0,643.0,5,1079,2.0,811.0,811.0
0.005,6,10,2006,5,927,1.0,659.0,659.0,5,1079,1.0,811.0,811.0
0.006,6,10,1854,5,889,1.0,621.0,621.0,5,965,1.0,697.0,697.0
0.004,17,2,148,1,60,0.0,32.0,32.0,1,88,0.0,60.0,60.0
0.012,6,10,1762,5,911,3.0,643.0,643.0,5,851,2.0,583.0,583.0
0.005,6,10,1643,5,860,1.0,592.0,592.0,5,783,1.0,515.0,515.0
0.008,6,10,1972,5,910,2.0,642.0,642.0,5,1062,2.0,794.0,794.0
0.005,6,13,3747,7,509,0.0,137.0,137.0,6,3238,0.0,1470.0,1459.0
0.002,17,2,136,1,60,0.0,32.0,32.0,1,76,0.0,48.0,48.0
0.104,6,10,1506,5,395,21.0,127.0,127.0,5,1111,24.0,843.0,843.0
0.039,17,2,152,1,76,0.0,48.0,48.0,1,76,0.0,48.0,48.0
0.012,6,10,1989,5,910,2.0,642.0,642.0,5,1079,2.0,811.0,811.0
0.071,17,4,596,2,122,3.0,33.0,33.0,2,474,31.0,323.0,209.0
0.097,6,10,1506,5,395,22.0,127.0,127.0,5,1111,20.0,843.0,843.0
0.007,6,13,3747,7,509,1.0,137.0,137.0,6,3238,1.0,1470.0,1459.0
0.076,6,10,1506,5,395,18.0,127.0,127.0,5,1111,16.0,843.0,843.0
0.078,17,2,170,1,65,0.0,37.0,37.0,1,105,0.0,77.0,77.0
0.177,17,4,596,2,122,45.0,33.0,33.0,2,474,139.0,323.0,209.0
0.161,6,10,1506,5,395,39.0,127.0,127.0,5,1111,36.0,843.0,843.0
0.004,6,10,2007,5,928,1.0,660.0,660.0,5,1079,1.0,811.0,811.0
0.042,17,2,152,1,76,0.0,48.0,48.0,1,76,0.0,48.0,48.0
0.107,6,10,1506,5,395,24.0,127.0,127.0,5,1111,25.0,843.0,843.0
40.052,17,10,676,5,460,10012.0,104.0,64.0,5,216,10012.0,20.0,15.0
0.128,6,10,1506,5,395,28.0,127.0,127.0,5,1111,29.0,843.0,843.0
0.012,6,10,1631,5,848,3.0,580.0,580.0,5,783,3.0,515.0,515.0
40.067,17,10,676,5,460,10015.0,104.0,64.0,5,216,10015.0,20.0,15.0
0.099,6,10,1506,5,395,21.0,127.0,127.0,5,1111,22.0,843.0,843.0
0.001,17,2,154,1,69,0.0,41.0,41.0,1,85,0.0,57.0,57.0
0.072,17,2,136,1,60,0.0,32.0,32.0,1,76,0.0,48.0,48.0
0.001,17,2,180,1,66,0.0,38.0,38.0,1,114,0.0,86.0,86.0
0.003,17,4,284,2,120,0.0,32.0,32.0,2,164,0.0,60.0,54.0
0.003,17,2,132,1,58,0.0,30.0,30.0,1,74,0.0,46.0,46.0
0.004,17,2,136,1,60,0.0,32.0,32.0,1,76,0.0,48.0,48.0
0.005,17,2,166,1,75,0.0,47.0,47.0,1,91,0.0,63.0,63.0
0.001,17,2,180,1,66,0.0,38.0,38.0,1,114,0.0,86.0,86.0
0.004,6,10,2006,5,927,1.0,659.0,659.0,5,1079,1.0,811.0,811.0
240.01,6,9,787,5,488,60002.0,232.0,232.0,4,299,80002.0,83.0,83.0
0.004,6,10,1702,5,863,1.0,595.0,595.0,5,839,0.0,571.0,571.0
0.724,6,22,5072,11,1250,62.0,325.0,133.0,11,3822,61.0,1414.0,563.0
0.006,6,10,1547,5,764,1.0,496.0,496.0,5,783,1.0,515.0,515.0
0.005,6,10,1702,5,863,1.0,595.0,595.0,5,839,1.0,571.0,571.0
0.129,6,10,1506,5,395,31.0,127.0,127.0,5,1111,29.0,843.0,843.0
0.016,6,10,1972,5,910,4.0,642.0,642.0,5,1062,3.0,794.0,794.0
0.004,6,10,2006,5,927,1.0,659.0,659.0,5,1079,1.0,811.0,811.0
0.013,6,10,1677,5,827,3.0,559.0,559.0,5,850,3.0,582.0,582.0
0.005,17,2,194,1,59,0.0,31.0,31.0,1,135,0.0,107.0,107.0
40.075,17,10,676,5,460,10016.0,104.0,64.0,5,216,10017.0,20.0,15.0
0.172,17,2,152,1,76,0.0,48.0,48.0,1,76,0.0,48.0,48.0
0.001,17,2,180,1,66,0.0,38.0,38.0,1,114,0.0,86.0,86.0
0.009,6,10,1989,5,910,2.0,642.0,642.0,5,1079,2.0,811.0,811.0
0.001,17,2,248,1,68,0.0,40.0,40.0,1,180,0.0,152.0,152.0
0.125,6,10,1506,5,395,29.0,127.0,127.0,5,1111,19.0,843.0,843.0
0.085,6,10,1506,5,395,19.0,127.0,127.0,5,1111,17.0,843.0,843.0
0.117,6,10,1506,5,395,28.0,127.0,127.0,5,1111,25.0,843.0,843.0
0.146,6,10,1506,5,395,32.0,127.0,127.0,5,1111,32.0,843.0,843.0
0.003,17,4,284,2,120,0.0,32.0,32.0,2,164,0.0,60.0,54.0
0.069,6,10,1506,5,395,14.0,127.0,127.0,5,1111,16.0,843.0,843.0
0.103,6,10,1506,5,395,23.0,127.0,127.0,5,1111,23.0,843.0,843.0
40.068,17,10,676,5,460,10016.0,104.0,64.0,5,216,10016.0,20.0,15.0
0.109,6,10,1506,5,395,24.0,127.0,127.0,5,1111,23.0,843.0,843.0
0.015,6,10,1983,5,910,3.0,642.0,642.0,5,1073,3.0,805.0,805.0
0.005,17,2,214,1,75,0.0,47.0,47.0,1,139,0.0,111.0,111.0
0.01,6,10,1677,5,827,2.0,559.0,559.0,5,850,2.0,582.0,582.0
0.004,6,10,1702,5,863,1.0,595.0,595.0,5,839,1.0,571.0,571.0
0.003,17,2,136,1,60,0.0,32.0,32.0,1,76,0.0,48.0,48.0
0.164,17,2,152,1,76,0.0,48.0,48.0,1,76,0.0,48.0,48.0
27.766,6,38,10042,19,4484,499.0,1360.0,738.0,19,5558,1532.0,1360.0,398.0
0.067,17,8,3613,4,1874,22.0,1350.0,440.0,4,1739,11.0,1350.0,406.0
0.005,6,10,1689,5,839,1.0,571.0,571.0,5,850,1.0,582.0,582.0
0.006,6,10,1989,5,927,1.0,659.0,659.0,5,1062,1.0,794.0,794.0
0.005,6,10,2006,5,927,1.0,659.0,659.0,5,1079,1.0,811.0,811.0
36.715,6,44,15990,22,10312,432.0,2720.0,1175.0,22,5678,1740.0,2667.0,435.0
0.008,6,13,3735,7,497,1.0,125.0,125.0,6,3238,1.0,1470.0,1459.0
0.004,17,2,142,1,63,0.0,35.0,35.0,1,79,0.0,51.0,51.0
0.012,6,10,1989,5,910,3.0,642.0,642.0,5,1079,2.0,811.0,811.0
0.003,17,2,148,1,60,0.0,32.0,32.0,1,88,0.0,60.0,60.0
0.006,6,10,1643,5,860,1.0,592.0,592.0,5,783,1.0,515.0,515.0
0.006,6,12,1698,6,863,1.0,327.0,271.0,6,835,1.0,515.0,515.0
0.082,6,10,1506,5,395,20.0,127.0,127.0,5,1111,18.0,843.0,843.0
0.009,17,2,136,1,60,0.0,32.0,32.0,1,76,0.0,48.0,48.0
0.092,6,10,1506,5,395,17.0,127.0,127.0,5,1111,22.0,843.0,843.0
0.005,17,2,164,1,74,0.0,46.0,46.0,1,90,0.0,62.0,62.0
0.008,6,14,3742,7,452,1.0,80.0,80.0,7,3290,1.0,1448.0,972.0
0.021,6,10,1989,5,910,5.0,642.0,642.0,5,1079,5.0,811.0,811.0
0.01,6,10,1989,5,910,2.0,642.0,642.0,5,1079,2.0,811.0,811.0
0.009,6,10,1983,5,910,2.0,642.0,642.0,5,1073,2.0,805.0,805.0
0.013,6,10,1983,5,910,3.0,642.0,642.0,5,1073,3.0,805.0,805.0
0.012,6,10,1989,5,910,2.0,642.0,642.0,5,1079,2.0,811.0,811.0
240.603,6,22,7540,12,1875,21873.0,990.0,418.0,10,5665,26733.0,1592.0,856.0
0.005,17,2,169,1,62,0.0,34.0,34.0,1,107,0.0,79.0,79.0
0.094,6,10,1506,5,395,22.0,127.0,127.0,5,1111,22.0,843.0,843.0
0.005,6,10,1989,5,927,1.0,659.0,659.0,5,1062,1.0,794.0,794.0
0.011,6,10,1972,5,910,2.0,642.0,642.0,5,1062,2.0,794.0,794.0
0.005,6,10,2006,5,927,1.0,659.0,659.0,5,1079,1.0,811.0,811.0
0.01,6,10,1990,5,911,2.0,643.0,643.0,5,1079,2.0,811.0,811.0
40.074,17,10,676,5,460,10016.0,104.0,64.0,5,216,10017.0,20.0,15.0
0.004,17,4,284,2,120,0.0,32.0,32.0,2,164,0.0,60.0,54.0
0.037,17,4,284,2,120,1.0,32.0,32.0,2,164,33.0,60.0,54.0
164.142,17,88,12832,44,2970,3817.0,44.0,39.0,44,9862,3817.0,261.0,196.0
354.021,6,19,1691,15,978,25287.0,190.0,190.0,4,713,80003.0,497.0,497.0
40.069,17,10,676,5,460,10015.0,104.0,64.0,5,216,10016.0,20.0,15.0
0.009,6,10,1972,5,910,2.0,642.0,642.0,5,1062,2.0,794.0,794.0
0.222,6,16,2669,8,1395,31.0,533.0,323.0,8,1274,20.0,529.0,212.0
0.038,17,2,152,1,76,0.0,48.0,48.0,1,76,0.0,48.0,48.0
0.005,6,10,1774,5,923,1.0,655.0,655.0,5,851,1.0,583.0,583.0
0.166,17,2,152,1,76,0.0,48.0,48.0,1,76,0.0,48.0,48.0
0.005,6,10,1643,5,860,1.0,592.0,592.0,5,783,1.0,515.0,515.0
154.742,6,26,9525,12,1627,73.0,794.0,367.0,14,7898,11893.0,1360.0,732.0
0.12,6,10,1506,5,395,23.0,127.0,127.0,5,1111,25.0,843.0,843.0
0.008,6,10,1989,5,910,2.0,642.0,642.0,5,1079,2.0,811.0,811.0
0.006,6,10,2006,5,927,1.0,659.0,659.0,5,1079,1.0,811.0,811.0
0.133,17,2,80,1,32,0.0,4.0,4.0,1,48,0.0,20.0,20.0
0.07,6,10,1506,5,395,15.0,127.0,127.0,5,1111,12.0,843.0,843.0
40.055,17,10,676,5,460,10012.0,104.0,64.0,5,216,10012.0,20.0,15.0
0.005,6,10,1989,5,927,1.0,659.0,659.0,5,1062,1.0,794.0,794.0
177.33,17,78,11089,39,2600,4666.0,44.0,38.0,39,8489,4666.0,239.0,189.0
15.072,17,15,9238,8,6902,2149.0,1350.0,834.0,7,2336,2507.0,1350.0,305.0
0.009,6,10,1983,5,910,2.0,642.0,642.0,5,1073,2.0,805.0,805.0
0.001,17,2,180,1,66,0.0,38.0,38.0,1,114,0.0,86.0,86.0
0.015,6,10,1972,5,910,3.0,642.0,642.0,5,1062,3.0,794.0,794.0
0.003,17,2,208,1,72,0.0,44.0,44.0,1,136,0.0,108.0,108.0
0.012,6,10,1972,5,910,3.0,642.0,642.0,5,1062,3.0,794.0,794.0
0.005,6,10,1643,5,860,1.0,592.0,592.0,5,783,1.0,515.0,515.0
240.097,6,16,4480,9,963,30012.0,238.0,166.0,7,3517,40015.0,1402.0,786.0
0.005,17,2,144,1,64,0.0,36.0,36.0,1,80,0.0,52.0,52.0
0.005,6,10,2006,5,927,1.0,659.0,659.0,5,1079,1.0,811.0,811.0
0.044,17,4,284,2,120,0.0,32.0,32.0,2,164,39.0,60.0,54.0
0.012,6,10,1989,5,910,3.0,642.0,642.0,5,1079,3.0,811.0,811.0
0.006,6,10,1643,5,860,1.0,592.0,592.0,5,783,1.0,515.0,515.0
0.004,17,2,170,1,65,0.0,37.0,37.0,1,105,0.0,77.0,77.0
0.011,6,10,1762,5,911,2.0,643.0,643.0,5,851,2.0,583.0,583.0
170.245,17,80,11246,40,2680,4365.0,44.0,39.0,40,8566,4365.0,261.0,186.0
0.089,6,10,1506,5,395,19.0,127.0,127.0,5,1111,17.0,843.0,843.0
0.004,17,2,148,1,60,0.0,32.0,32.0,1,88,0.0,60.0,60.0
0.016,6,10,1972,5,910,3.0,642.0,642.0,5,1062,3.0,794.0,794.0
0.005,6,10,1989,5,927,1.0,659.0,659.0,5,1062,1.0,794.0,794.0
0.01,6,10,1972,5,910,2.0,642.0,642.0,5,1062,2.0,794.0,794.0
0.008,17,2,170,1,65,0.0,37.0,37.0,1,105,0.0,77.0,77.0
0.139,6,10,1506,5,395,31.0,127.0,127.0,5,1111,31.0,843.0,843.0
0.013,6,10,1762,5,911,3.0,643.0,643.0,5,851,3.0,583.0,583.0
0.009,6,10,1990,5,911,2.0,643.0,643.0,5,1079,2.0,811.0,811.0
40.062,17,10,676,5,460,10014.0,104.0,64.0,5,216,10014.0,20.0,15.0
0.004,17,2,148,1,60,0.0,32.0,32.0,1,88,0.0,60.0,60.0
0.103,6,10,1506,5,395,22.0,127.0,127.0,5,1111,22.0,843.0,843.0
300.395,6,16,2170,9,684,37528.0,146.0,146.0,7,1486,50037.0,419.0,398.0
15.076,17,15,9239,8,6902,2149.0,1350.0,834.0,7,2337,2507.0,1350.0,305.0
0.013,17,2,152,1,56,0.0,28.0,28.0,1,96,0.0,68.0,68.0
0.061,6,10,1506,5,395,13.0,127.0,127.0,5,1111,14.0,843.0,843.0
0.004,17,2,136,1,60,0.0,32.0,32.0,1,76,0.0,48.0,48.0
0.004,17,4,284,2,120,0.0,32.0,32.0,2,164,0.0,60.0,54.0
0.007,17,2,179,1,71,0.0,43.0,43.0,1,108,0.0,80.0,80.0
0.003,17,2,184,1,61,0.0,33.0,33.0,1,123,0.0,95.0,95.0
0.096,6,10,1506,5,395,22.0,127.0,127.0,5,1111,22.0,843.0,843.0
0.009,6,10,1762,5,911,2.0,643.0,643.0,5,851,2.0,583.0,583.0
0.014,6,10,1990,5,911,3.0,643.0,643.0,5,1079,3.0,811.0,811.0
0.076,6,10,1506,5,395,16.0,127.0,127.0,5,1111,16.0,843.0,843.0
1777.068,17,144,45504,72,22752,25029.0,288.0,288.0,72,22752,25029.0,288.0,288.0
0.019,6,10,1631,5,848,4.0,580.0,580.0,5,783,4.0,515.0,515.0
0.04,17,2,182,1,65,0.0,37.0,37.0,1,117,0.0,89.0,89.0
173.434,17,82,12021,41,2749,4335.0,44.0,39.0,41,9272,4335.0,239.0,198.0
0.006,6,10,1854,5,889,1.0,621.0,621.0,5,965,1.0,697.0,697.0
0.004,6,10,1779,5,928,1.0,660.0,660.0,5,851,1.0,583.0,583.0
0.011,6,13,3735,7,497,1.0,125.0,125.0,6,3238,2.0,1470.0,1459.0
9.039,17,6,376,5,280,2259.0,28.0,28.0,1,96,0.0,68.0,68.0
43.33,6,43,16524,21,10846,449.0,2720.0,1424.0,22,5678,2055.0,2667.0,435.0
9.037,17,6,376,5,280,2259.0,28.0,28.0,1,96,0.0,68.0,68.0
0.005,6,10,1689,5,839,1.0,571.0,571.0,5,850,1.0,582.0,582.0
0.012,6,10,1990,5,911,3.0,643.0,643.0,5,1079,3.0,811.0,811.0
0.005,17,2,180,1,58,0.0,30.0,30.0,1,122,0.0,94.0,94.0
0.004,6,10,1989,5,927,1.0,659.0,659.0,5,1062,1.0,794.0,794.0
0.001,17,2,136,1,60,0.0,32.0,32.0,1,76,0.0,48.0,48.0
0.004,17,2,148,1,60,0.0,32.0,32.0,1,88,0.0,60.0,60.0
0.005,6,10,1989,5,927,1.0,659.0,659.0,5,1062,1.0,794.0,794.0
0.068,17,8,3613,4,1874,22.0,1350.0,440.0,4,1739,11.0,1350.0,406.0
0.005,6,10,1689,5,839,1.0,571.0,571.0,5,850,1.0,582.0,582.0
0.008,6,10,1972,5,910,2.0,642.0,642.0,5,1062,2.0,794.0,794.0
0.218,6,16,2778,8,1396,31.0,533.0,324.0,8,1382,20.0,529.0,239.0
0.148,6,10,1506,5,395,29.0,127.0,127.0,5,1111,30.0,843.0,843.0
0.001,17,2,180,1,66,0.0,38.0,38.0,1,114,0.0,86.0,86.0
0.141,6,10,1506,5,395,23.0,127.0,127.0,5,1111,33.0,843.0,843.0
0.006,17,2,179,1,71,0.0,43.0,43.0,1,108,0.0,80.0,80.0
0.045,6,10,1605,5,388,11.0,120.0,120.0,5,1217,11.0,949.0,949.0
52.512,6,44,10723,23,5085,414.0,1360.0,682.0,21,5638,2614.0,1360.0,398.0
0.006,6,10,1689,5,839,1.0,571.0,571.0,5,850,1.0,582.0,582.0
0.071,17,2,136,1,60,0.0,32.0,32.0,1,76,0.0,48.0,48.0
0.011,6,10,1990,5,911,2.0,643.0,643.0,5,1079,2.0,811.0,811.0
0.005,6,10,2007,5,928,1.0,660.0,660.0,5,1079,1.0,811.0,811.0
0.042,17,2,152,1,76,0.0,48.0,48.0,1,76,0.0,48.0,48.0
40.063,17,10,676,5,460,10014.0,104.0,64.0,5,216,10015.0,20.0,15.0
0.162,17,2,152,1,76,0.0,48.0,48.0,1,76,0.0,48.0,48.0
1756.848,6,569,191265,292,164900,6037.0,2883.0,918.0,277,26365,6365.0,580.0,117.0
0.006,6,10,2006,5,927,1.0,659.0,659.0,5,1079,1.0,811.0,811.0
0.129,6,10,1506,5,395,28.0,127.0,127.0,5,1111,24.0,843.0,843.0
0.011,6,10,1972,5,910,2.0,642.0,642.0,5,1062,2.0,794.0,794.0
0.148,17,4,352,2,130,109.0,37.0,37.0,2,222,144.0,89.0,83.0
0.004,6,10,2006,5,927,1.0,659.0,659.0,5,1079,1.0,811.0,811.0
177.067,17,74,10633,37,2473,4918.0,44.0,38.0,37,8160,4918.0,260.0,192.0
0.084,6,10,1506,5,395,20.0,127.0,127.0,5,1111,19.0,843.0,843.0
40.071,17,10,676,5,460,10017.0,104.0,64.0,5,216,10017.0,20.0,15.0
0.009,6,10,1972,5,910,2.0,642.0,642.0,5,1062,2.0,794.0,794.0
40.07,17,10,676,5,460,10014.0,104.0,64.0,5,216,10016.0,20.0,15.0
0.001,17,2,136,1,60,0.0,32.0,32.0,1,76,0.0,48.0,48.0
40.053,17,10,676,5,460,10012.0,104.0,64.0,5,216,10012.0,20.0,15.0
0.001,17,2,180,1,66,0.0,38.0,38.0,1,114,0.0,86.0,86.0
0.006,6,10,1689,5,839,1.0,571.0,571.0,5,850,1.0,582.0,582.0
0.072,6,10,1506,5,395,16.0,127.0,127.0,5,1111,15.0,843.0,843.0
0.02,6,10,1990,5,911,5.0,643.0,643.0,5,1079,4.0,811.0,811.0
0.004,6,10,1702,5,863,1.0,595.0,595.0,5,839,1.0,571.0,571.0
0.005,6,10,2006,5,927,1.0,659.0,659.0,5,1079,1.0,811.0,811.0
0.005,6,10,1989,5,927,1.0,659.0,659.0,5,1062,1.0,794.0,794.0
0.004,17,2,136,1,60,0.0,32.0,32.0,1,76,0.0,48.0,48.0
0.124,6,10,1506,5,395,29.0,127.0,127.0,5,1111,26.0,843.0,843.0
0.005,6,14,3742,7,452,0.0,80.0,80.0,7,3290,0.0,1448.0,972.0
40.066,17,10,676,5,460,10015.0,104.0,64.0,5,216,10015.0,20.0,15.0
0.005,17,2,214,1,75,0.0,47.0,47.0,1,139,0.0,111.0,111.0
0.07,17,8,3613,4,1874,23.0,1350.0,440.0,4,1739,12.0,1350.0,406.0
1792.691,6,93,6847,45,2488,40742.0,37.0,37.0,48,4359,38141.0,493.0,266.0
0.028,6,14,3868,7,578,4.0,206.0,206.0,7,3290,4.0,1448.0,972.0
0.12,6,10,1506,5,395,25.0,127.0,127.0,5,1111,26.0,843.0,843.0
0.21,6,16,2777,8,1395,30.0,533.0,323.0,8,1382,19.0,529.0,239.0
0.036,6,10,1972,5,910,9.0,642.0,642.0,5,1062,8.0,794.0,794.0
0.005,17,2,140,1,62,0.0,34.0,34.0,1,78,0.0,50.0,50.0
40.061,17,10,676,5,460,10014.0,104.0,64.0,5,216,10014.0,20.0,15.0
0.006,17,2,166,1,75,0.0,47.0,47.0,1,91,0.0,63.0,63.0
0.005,6,10,1989,5,927,1.0,659.0,659.0,5,1062,1.0,794.0,794.0
0.006,17,2,148,1,60,0.0,32.0,32.0,1,88,0.0,60.0,60.0
0.011,6,10,1972,5,910,2.0,642.0,642.0,5,1062,2.0,794.0,794.0
0.006,17,2,294,1,64,0.0,36.0,36.0,1,230,0.0,202.0,202.0
0.001,17,2,136,1,60,0.0,32.0,32.0,1,76,0.0,48.0,48.0
0.005,6,10,2006,5,927,1.0,659.0,659.0,5,1079,1.0,811.0,811.0
0.004,17,2,148,1,60,0.0,32.0,32.0,1,88,0.0,60.0,60.0
0.012,6,10,1989,5,910,3.0,642.0,642.0,5,1079,2.0,811.0,811.0
0.084,6,10,1506,5,395,17.0,127.0,127.0,5,1111,19.0,843.0,843.0
0.005,6,10,2006,5,927,1.0,659.0,659.0,5,1079,1.0,811.0,811.0
0.017,6,10,1631,5,848,4.0,580.0,580.0,5,783,4.0,515.0,515.0
0.094,6,10,1506,5,395,20.0,127.0,127.0,5,1111,22.0,843.0,843.0
0.028,6,10,1989,5,910,7.0,642.0,642.0,5,1079,7.0,811.0,811.0
40.066,17,10,676,5,460,10014.0,104.0,64.0,5,216,10015.0,20.0,15.0
0.013,6,10,1972,5,910,3.0,642.0,642.0,5,1062,3.0,794.0,794.0
0.005,6,10,1643,5,860,1.0,592.0,592.0,5,783,1.0,515.0,515.0
0.008,6,10,1990,5,911,1.0,643.0,643.0,5,1079,2.0,811.0,811.0
0.013,6,10,1989,5,910,3.0,642.0,642.0,5,1079,3.0,811.0,811.0
0.005,6,10,2007,5,928,1.0,660.0,660.0,5,1079,1.0,811.0,811.0
0.089,6,10,1506,5,395,17.0,127.0,127.0,5,1111,20.0,843.0,843.0
0.005,6,10,2006,5,927,1.0,659.0,659.0,5,1079,1.0,811.0,811.0
0.012,6,10,1631,5,848,3.0,580.0,580.0,5,783,2.0,515.0,515.0
0.001,17,2,180,1,66,0.0,38.0,38.0,1,114,0.0,86.0,86.0
0.016,6,10,1989,5,910,3.0,642.0,642.0,5,1079,3.0,811.0,811.0
0.003,17,2,136,1,60,0.0,32.0,32.0,1,76,0.0,48.0,48.0
0.008,6,10,2007,5,928,2.0,660.0,660.0,5,1079,2.0,811.0,811.0
0.013,6,13,3735,7,497,2.0,125.0,125.0,6,3238,2.0,1470.0,1459.0
0.037,17,2,186,1,61,0.0,33.0,33.0,1,125,0.0,97.0,97.0
0.173,6,10,1506,5,395,36.0,127.0,127.0,5,1111,41.0,843.0,843.0
240.065,6,12,1315,6,510,48012.0,190.0,190.0,6,805,48012.0,464.0,248.0
0.073,6,10,1506,5,395,16.0,127.0,127.0,5,1111,16.0,843.0,843.0
0.086,6,10,1506,5,395,20.0,127.0,127.0,5,1111,18.0,843.0,843.0
0.004,6,10,1989,5,927,1.0,659.0,659.0,5,1062,1.0,794.0,794.0
0.111,6,10,1506,5,395,26.0,127.0,127.0,5,1111,24.0,843.0,843.0
120.882,6,60,19200,34,4860,3663.0,1055.0,221.0,26,14340,4835.0,2804.0,927.0
0.021,6,10,1990,5,911,5.0,643.0,643.0,5,1079,5.0,811.0,811.0
292.364,6,380,346739,192,21544,1530.0,2736.0,888.0,188,325195,1563.0,4127.0,1812.0
0.008,6,10,1983,5,910,2.0,642.0,642.0,5,1073,1.0,805.0,805.0
0.008,6,10,1989,5,910,2.0,642.0,642.0,5,1079,2.0,811.0,811.0
55.72,6,43,12702,22,6835,430.0,1360.0,846.0,21,5867,2777.0,2667.0,385.0
360.041,6,21,3981,13,3142,30003.0,494.0,494.0,8,839,51434.0,83.0,83.0
0.064,6,10,1506,5,395,15.0,127.0,127.0,5,1111,12.0,843.0,843.0
0.006,6,10,1989,5,927,1.0,659.0,659.0,5,1062,1.0,794.0,794.0
0.083,6,10,1506,5,395,18.0,127.0,127.0,5,1111,17.0,843.0,843.0
0.005,6,10,1854,5,889,1.0,621.0,621.0,5,965,1.0,697.0,697.0
1778.461,17,144,41760,72,22752,25048.0,288.0,288.0,72,19008,25048.0,236.0,236.0
0.004,17,4,284,2,120,0.0,32.0,32.0,2,164,0.0,60.0,54.0
0.005,6,10,2006,5,927,1.0,659.0,659.0,5,1079,1.0,811.0,811.0
0.001,17,2,180,1,66,0.0,38.0,38.0,1,114,0.0,86.0,86.0
0.129,6,10,1506,5,395,27.0,127.0,127.0,5,1111,28.0,843.0,843.0
240.496,6,33,8637,17,1840,15028.0,573.0,189.0,16,6797,16030.0,1402.0,596.0
0.013,17,2,152,1,56,0.0,28.0,28.0,1,96,0.0,68.0,68.0
0.006,6,10,2007,5,928,1.0,660.0,660.0,5,1079,1.0,811.0,811.0
0.008,6,10,1983,5,910,2.0,642.0,642.0,5,1073,2.0,805.0,805.0
0.013,6,10,1990,5,911,3.0,643.0,643.0,5,1079,3.0,811.0,811.0
291.405,6,402,348738,193,21594,1517.0,2736.0,825.0,209,327144,1400.0,2914.0,1621.0
0.006,6,10,2000,5,927,1.0,659.0,659.0,5,1073,1.0,805.0,805.0
300.296,6,27,7433,16,1409,20019.0,217.0,142.0,11,6024,24025.0,1679.0,777.0
0.004,17,2,148,1,60,0.0,32.0,32.0,1,88,0.0,60.0,60.0
0.13,6,10,1506,5,395,30.0,127.0,127.0,5,1111,29.0,843.0,843.0
65.987,6,23,8499,10,1834,7331.0,986.0,439.0,13,6665,5487.0,2111.0,598.0
0.014,6,10,1677,5,827,3.0,559.0,559.0,5,850,3.0,582.0,582.0
0.081,6,10,1506,5,395,18.0,127.0,127.0,5,1111,19.0,843.0,843.0
286.807,6,23,7631,8,1037,30.0,267.0,178.0,15,6594,20485.0,1400.0,599.0
0.005,6,10,2007,5,928,1.0,660.0,660.0,5,1079,1.0,811.0,811.0
40.079,17,10,676,5,460,10017.0,104.0,64.0,5,216,10018.0,20.0,15.0
240.083,6,16,4481,9,963,30010.0,238.0,166.0,7,3518,40013.0,1402.0,786.0
0.017,6,10,1989,5,910,4.0,642.0,642.0,5,1079,4.0,811.0,811.0
0.06,6,10,1506,5,395,12.0,127.0,127.0,5,1111,14.0,843.0,843.0
0.014,6,10,1989,5,910,3.0,642.0,642.0,5,1079,3.0,811.0,811.0
0.026,6,10,1989,5,910,6.0,642.0,642.0,5,1079,6.0,811.0,811.0
0.006,6,10,1689,5,839,1.0,571.0,571.0,5,850,1.0,582.0,582.0
0.005,6,10,2000,5,927,1.0,659.0,659.0,5,1073,1.0,805.0,805.0
0.006,17,2,170,1,65,0.0,37.0,37.0,1,105,0.0,77.0,77.0
354.082,6,21,1795,16,1030,23605.0,190.0,190.0,5,765,60003.0,464.0,248.0
0.011,6,10,1972,5,910,2.0,642.0,642.0,5,1062,2.0,794.0,794.0
0.116,6,10,1506,5,395,25.0,127.0,127.0,5,1111,23.0,843.0,843.0
0.005,6,10,2007,5,928,1.0,660.0,660.0,5,1079,1.0,811.0,811.0
368.59,6,22,2313,16,867,24572.0,195.0,195.0,6,1446,4648.0,419.0,398.0
0.003,17,2,148,1,60,0.0,32.0,32.0,1,88,0.0,60.0,60.0
0.005,6,10,1774,5,923,1.0,655.0,655.0,5,851,1.0,583.0,583.0
0.005,6,10,2000,5,927,1.0,659.0,659.0,5,1073,1.0,805.0,805.0
1770.304,6,84,4418,42,2210,43177.0,26.0,26.0,42,2208,43177.0,24.0,24.0
0.004,6,14,3736,7,446,0.0,74.0,74.0,7,3290,0.0,1448.0,972.0
0.004,6,10,2006,5,927,1.0,659.0,659.0,5,1079,1.0,811.0,811.0
0.013,6,13,3735,7,497,2.0,125.0,125.0,6,3238,2.0,1470.0,1459.0
0.004,6,10,1779,5,928,1.0,660.0,660.0,5,851,1.0,583.0,583.0
0.119,6,10,1506,5,395,28.0,127.0,127.0,5,1111,22.0,843.0,843.0
0.004,6,10,2000,5,927,1.0,659.0,659.0,5,1073,1.0,805.0,805.0
0.006,6,10,2007,5,928,1.0,660.0,660.0,5,1079,1.0,811.0,811.0
0.004,6,10,2006,5,927,1.0,659.0,659.0,5,1079,1.0,811.0,811.0
0.135,17,2,170,1,65,0.0,37.0,37.0,1,105,0.0,77.0,77.0
294.444,6,395,347823,205,22205,1443.0,2736.0,888.0,190,325618,1557.0,3339.0,1783.0
0.083,6,10,1506,5,395,19.0,127.0,127.0,5,1111,16.0,843.0,843.0
10.76,17,28,4419,14,1995,819.0,270.0,114.0,14,2424,819.0,587.0,145.0
0.005,6,10,2007,5,928,1.0,660.0,660.0,5,1079,1.0,811.0,811.0
65.896,6,27,17521,15,9579,4706.0,2804.0,1465.0,12,7942,5975.0,2313.0,1218.0
0.006,17,2,230,1,68,0.0,40.0,40.0,1,162,0.0,134.0,134.0
0.227,6,16,2778,8,1396,32.0,533.0,324.0,8,1382,21.0,529.0,239.0
0.114,6,10,1506,5,395,21.0,127.0,127.0,5,1111,25.0,843.0,843.0
0.466,17,55,38585,33,31291,14.0,1350.0,920.0,22,7294,18.0,1350.0,303.0
0.038,17,2,152,1,76,0.0,48.0,48.0,1,76,0.0,48.0,48.0
0.151,6,10,1506,5,395,35.0,127.0,127.0,5,1111,33.0,843.0,843.0
0.006,6,10,1547,5,764,1.0,496.0,496.0,5,783,1.0,515.0,515.0
0.016,6,10,1989,5,910,3.0,642.0,642.0,5,1079,4.0,811.0,811.0
0.108,6,10,1506,5,395,25.0,127.0,127.0,5,1111,25.0,843.0,843.0
0.34,17,40,20136,22,17085,16.0,1350.0,748.0,18,3051,15.0,1350.0,141.0
0.011,6,10,1972,5,910,2.0,642.0,642.0,5,1062,2.0,794.0,794.0
0.006,6,10,1547,5,764,1.0,496.0,496.0,5,783,1.0,515.0,515.0
0.083,6,45,14097,25,2617,3.0,517.0,146.0,20,11480,4.0,1402.0,745.0
0.011,6,10,1631,5,848,2.0,580.0,580.0,5,783,2.0,515.0,515.0
1779.111,6,310,98151,191,86621,9363.0,1402.0,672.0,119,11530,15077.0,452.0,71.0
0.011,6,10,1989,5,910,2.0,642.0,642.0,5,1079,2.0,811.0,811.0
0.084,6,10,1506,5,395,17.0,127.0,127.0,5,1111,17.0,843.0,843.0
0.006,17,2,170,1,65,0.0,37.0,37.0,1,105,0.0,77.0,77.0
0.005,6,10,1689,5,839,1.0,571.0,571.0,5,850,1.0,582.0,582.0
0.013,17,2,212,1,74,0.0,46.0,46.0,1,138,0.0,110.0,110.0
0.008,6,10,2007,5,928,2.0,660.0,660.0,5,1079,1.0,811.0,811.0
0.005,6,10,2006,5,927,1.0,659.0,659.0,5,1079,1.0,811.0,811.0
0.028,6,10,1989,5,910,7.0,642.0,642.0,5,1079,7.0,811.0,811.0
0.005,6,10,2007,5,928,1.0,660.0,660.0,5,1079,1.0,811.0,811.0
1778.45,17,144,41760,72,22752,25048.0,288.0,288.0,72,19008,25048.0,236.0,236.0
0.009,6,10,1972,5,910,2.0,642.0,642.0,5,1062,2.0,794.0,794.0
0.003,17,2,148,1,60,0.0,32.0,32.0,1,88,0.0,60.0,60.0
0.016,6,10,1990,5,911,3.0,643.0,643.0,5,1079,3.0,811.0,811.0
1778.123,17,142,44872,72,22752,25042.0,288.0,288.0,70,22120,25768.0,288.0,288.0
0.039,17,2,136,1,60,0.0,32.0,32.0,1,76,0.0,48.0,48.0
10.819,17,28,4422,14,1993,824.0,268.0,114.0,14,2429,824.0,588.0,145.0
0.013,6,10,1989,5,910,3.0,642.0,642.0,5,1079,3.0,811.0,811.0
0.012,6,10,1972,5,910,3.0,642.0,642.0,5,1062,2.0,794.0,794.0
0.006,6,10,1779,5,928,1.0,660.0,660.0,5,851,1.0,583.0,583.0
10.812,17,28,4418,14,1993,822.0,268.0,114.0,14,2425,822.0,588.0,145.0
0.008,6,10,1762,5,911,1.0,643.0,643.0,5,851,1.0,583.0,583.0
0.005,6,10,1779,5,928,1.0,660.0,660.0,5,851,1.0,583.0,583.0
0.085,6,10,1506,5,395,20.0,127.0,127.0,5,1111,18.0,843.0,843.0
170.195,17,72,10372,36,2411,4862.0,44.0,38.0,36,7961,4862.0,239.0,193.0
0.005,17,2,179,1,71,0.0,43.0,43.0,1,108,0.0,80.0,80.0
0.072,17,4,420,2,122,0.0,33.0,33.0,2,298,33.0,145.0,121.0
0.008,6,13,3735,7,497,1.0,125.0,125.0,6,3238,1.0,1470.0,1459.0
426.11,6,29,4409,12,3102,10912.0,494.0,494.0,17,1307,26631.0,83.0,83.0
0.164,6,10,1506,5,395,38.0,127.0,127.0,5,1111,35.0,843.0,843.0
40.055,17,10,676,5,460,10011.0,104.0,64.0,5,216,10013.0,20.0,15.0
0.005,6,10,1643,5,860,1.0,592.0,592.0,5,783,1.0,515.0,515.0
40.066,17,10,676,5,460,10015.0,104.0,64.0,5,216,10015.0,20.0,15.0
0.004,17,2,148,1,60,0.0,32.0,32.0,1,88,0.0,60.0,60.0
0.006,6,10,1547,5,764,1.0,496.0,496.0,5,783,1.0,515.0,515.0
0.009,6,10,1989,5,910,2.0,642.0,642.0,5,1079,2.0,811.0,811.0
0.014,6,10,1983,5,910,3.0,642.0,642.0,5,1073,3.0,805.0,805.0
0.009,6,10,1989,5,910,2.0,642.0,642.0,5,1079,2.0,811.0,811.0
0.009,6,10,1989,5,910,2.0,642.0,642.0,5,1079,2.0,811.0,811.0
1770.471,6,83,4368,42,2210,43181.0,26.0,26.0,41,2158,44260.0,26.0,26.0
0.06,17,2,152,1,76,0.0,48.0,48.0,1,76,0.0,48.0,48.0
0.016,6,10,1972,5,910,4.0,642.0,642.0,5,1062,4.0,794.0,794.0
40.078,17,10,676,5,460,10017.0,104.0,64.0,5,216,10018.0,20.0,15.0
0.065,6,10,1506,5,395,15.0,127.0,127.0,5,1111,14.0,843.0,843.0
0.042,17,2,169,1,62,0.0,34.0,34.0,1,107,0.0,79.0,79.0
0.004,17,4,284,2,120,0.0,32.0,32.0,2,164,1.0,60.0,54.0
0.005,6,10,1854,5,889,1.0,621.0,621.0,5,965,1.0,697.0,697.0
0.001,17,2,174,1,72,0.0,44.0,44.0,1,102,0.0,74.0,74.0
0.006,17,2,170,1,65,0.0,37.0,37.0,1,105,0.0,77.0,77.0
0.07,17,8,3613,4,1874,23.0,1350.0,440.0,4,1739,12.0,1350.0,406.0
0.216,6,16,2669,8,1395,30.0,533.0,323.0,8,1274,19.0,529.0,212.0
0.113,6,10,1506,5,395,20.0,127.0,127.0,5,1111,27.0,843.0,843.0
0.015,17,2,198,1,91,0.0,63.0,63.0,1,107,0.0,79.0,79.0
0.013,6,10,1631,5,848,3.0,580.0,580.0,5,783,3.0,515.0,515.0
0.081,6,10,1506,5,395,18.0,127.0,127.0,5,1111,16.0,843.0,843.0
1730.237,6,66,7454,42,4470,42200.0,1626.0,108.0,24,2984,75220.0,1116.0,82.0
0.087,6,10,1506,5,395,18.0,127.0,127.0,5,1111,18.0,843.0,843.0
0.005,6,10,1779,5,928,1.0,660.0,660.0,5,851,1.0,583.0,583.0
11.353,17,28,4394,14,2312,864.0,587.0,137.0,14,2082,864.0,269.0,120.0
0.008,6,10,1989,5,910,2.0,642.0,642.0,5,1079,1.0,811.0,811.0
0.182,6,10,1506,5,395,38.0,127.0,127.0,5,1111,40.0,843.0,843.0
10.885,17,28,4422,14,1994,828.0,269.0,114.0,14,2428,828.0,587.0,145.0
0.001,17,2,180,1,66,0.0,38.0,38.0,1,114,0.0,86.0,86.0
0.001,17,2,136,1,60,0.0,32.0,32.0,1,76,0.0,48.0,48.0
0.115,6,10,1506,5,395,23.0,127.0,127.0,5,1111,21.0,843.0,843.0
10.992,17,28,4423,14,1994,835.0,269.0,114.0,14,2429,835.0,588.0,145.0
0.009,6,12,1926,6,1189,1.0,659.0,434.0,6,737,1.0,417.0,417.0
0.004,17,2,170,1,65,0.0,37.0,37.0,1,105,0.0,77.0,77.0
368.836,6,22,2313,16,867,24589.0,195.0,195.0,6,1446,4635.0,419.0,398.0
0.085,6,10,1506,5,395,19.0,127.0,127.0,5,1111,17.0,843.0,843.0
0.009,17,2,164,1,74,0.0,46.0,46.0,1,90,0.0,62.0,62.0
0.001,17,2,166,1,75,0.0,47.0,47.0,1,91,0.0,63.0,63.0
0.081,6,10,1506,5,395,16.0,127.0,127.0,5,1111,17.0,843.0,843.0
312.181,17,20,1124,10,716,34677.0,48.0,43.0,10,408,34675.0,20.0,12.0
0.006,6,10,1547,5,764,1.0,496.0,496.0,5,783,1.0,515.0,515.0
0.008,6,10,1990,5,911,2.0,643.0,643.0,5,1079,1.0,811.0,811.0
0.004,17,2,148,1,60,0.0,32.0,32.0,1,88,0.0,60.0,60.0
0.007,6,10,2000,5,927,1.0,659.0,659.0,5,1073,1.0,805.0,805.0
0.137,17,2,152,1,76,0.0,48.0,48.0,1,76,0.0,48.0,48.0
0.065,6,10,1506,5,395,14.0,127.0,127.0,5,1111,15.0,843.0,843.0
0.004,17,2,136,1,60,0.0,32.0,32.0,1,76,0.0,48.0,48.0
0.004,17,2,148,1,60,0.0,32.0,32.0,1,88,0.0,60.0,60.0
0.006,6,10,1547,5,764,1.0,496.0,496.0,5,783,1.0,515.0,515.0
0.007,17,2,230,1,68,0.0,40.0,40.0,1,162,0.0,134.0,134.0
0.006,6,10,1547,5,764,1.0,496.0,496.0,5,783,1.0,515.0,515.0
0.005,6,10,1689,5,839,1.0,571.0,571.0,5,850,1.0,582.0,582.0
0.016,6,10,1972,5,910,3.0,642.0,642.0,5,1062,4.0,794.0,794.0
460.308,6,22,3088,12,1658,41846.0,533.0,205.0,10,1430,51140.0,529.0,150.0
0.003,17,2,152,1,76,0.0,48.0,48.0,1,76,0.0,48.0,48.0
0.012,6,10,1972,5,910,3.0,642.0,642.0,5,1062,2.0,794.0,794.0
0.005,6,10,2000,5,927,1.0,659.0,659.0,5,1073,1.0,805.0,805.0
0.086,6,10,1506,5,395,18.0,127.0,127.0,5,1111,17.0,843.0,843.0
0.005,6,10,1989,5,927,1.0,659.0,659.0,5,1062,1.0,794.0,794.0
0.095,6,10,1506,5,395,21.0,127.0,127.0,5,1111,21.0,843.0,843.0
240.132,6,34,8265,18,5696,14124.0,1515.0,528.0,16,2569,16008.0,580.0,216.0
40.069,17,10,676,5,460,10014.0,104.0,64.0,5,216,10016.0,20.0,15.0
0.057,17,2,132,1,58,0.0,30.0,30.0,1,74,0.0,46.0,46.0
0.019,6,10,1989,5,910,4.0,642.0,642.0,5,1079,4.0,811.0,811.0
10.911,17,28,4423,14,1995,830.0,270.0,114.0,14,2428,830.0,587.0,145.0
0.001,17,2,180,1,65,0.0,37.0,37.0,1,115,0.0,87.0,87.0
0.003,17,2,136,1,60,0.0,32.0,32.0,1,76,0.0,48.0,48.0
0.099,6,10,1506,5,395,23.0,127.0,127.0,5,1111,21.0,843.0,843.0
0.011,6,10,1990,5,911,2.0,643.0,643.0,5,1079,2.0,811.0,811.0
0.019,6,10,1677,5,827,4.0,559.0,559.0,5,850,4.0,582.0,582.0
0.073,6,10,1506,5,395,16.0,127.0,127.0,5,1111,16.0,843.0,843.0
0.005,17,2,144,1,64,0.0,36.0,36.0,1,80,0.0,52.0,52.0
1786.976,6,150,19350,90,13740,20078.0,302.0,302.0,60,5610,30287.0,83.0,83.0
15.076,17,15,9239,8,6902,2149.0,1350.0,834.0,7,2337,2507.0,1350.0,305.0
1792.908,6,277,25765,140,9133,12898.0,747.0,263.0,137,16632,13183.0,1625.0,72.0
0.001,17,2,166,1,75,0.0,47.0,47.0,1,91,0.0,63.0,63.0
308.681,17,18,1008,9,640,38568.0,48.0,43.0,9,368,38568.0,20.0,12.0
0.127,6,10,1506,5,395,29.0,127.0,127.0,5,1111,27.0,843.0,843.0
0.005,6,10,2007,5,928,1.0,660.0,660.0,5,1079,1.0,811.0,811.0
0.005,6,10,2006,5,927,1.0,659.0,659.0,5,1079,1.0,811.0,811.0
0.009,6,10,1989,5,910,2.0,642.0,642.0,5,1079,2.0,811.0,811.0
0.038,17,2,152,1,76,0.0,48.0,48.0,1,76,0.0,48.0,48.0
0.005,6,10,2007,5,928,1.0,660.0,660.0,5,1079,1.0,811.0,811.0
0.005,17,2,186,1,61,0.0,33.0,33.0,1,125,0.0,97.0,97.0
175.437,17,86,12665,43,2877,4175.0,44.0,38.0,43,9788,4177.0,279.0,199.0
407.712,6,46,8755,24,6690,6124.0,494.0,494.0,22,2065,19414.0,83.0,83.0
0.005,6,13,3690,7,452,0.0,80.0,80.0,6,3238,1.0,1470.0,1459.0
0.005,17,2,230,1,68,0.0,40.0,40.0,1,162,0.0,134.0,134.0
240.018,6,9,787,5,488,60004.0,232.0,232.0,4,299,80004.0,83.0,83.0
0.005,17,2,230,1,68,0.0,40.0,40.0,1,162,0.0,134.0,134.0
0.004,17,2,136,1,60,0.0,32.0,32.0,1,76,0.0,48.0,48.0
0.004,17,2,152,1,76,0.0,48.0,48.0,1,76,0.0,48.0,48.0
0.005,6,10,2006,5,927,1.0,659.0,659.0,5,1079,1.0,811.0,811.0
0.005,6,10,1774,5,923,1.0,655.0,655.0,5,851,1.0,583.0,583.0
0.014,6,10,1983,5,910,3.0,642.0,642.0,5,1073,3.0,805.0,805.0
0.078,6,10,1506,5,395,16.0,127.0,127.0,5,1111,17.0,843.0,843.0
0.007,6,10,1547,5,764,1.0,496.0,496.0,5,783,1.0,515.0,515.0
0.008,6,10,1989,5,910,2.0,642.0,642.0,5,1079,2.0,811.0,811.0
291.203,6,397,348771,199,21919,1470.0,2736.0,889.0,198,326852,1478.0,2914.0,1720.0
0.01,6,10,1990,5,911,2.0,643.0,643.0,5,1079,2.0,811.0,811.0
0.111,6,10,1506,5,395,24.0,127.0,127.0,5,1111,23.0,843.0,843.0
0.005,6,10,2007,5,928,1.0,660.0,660.0,5,1079,1.0,811.0,811.0
0.021,6,10,1972,5,910,5.0,642.0,642.0,5,1062,5.0,794.0,794.0
0.005,6,10,1774,5,923,1.0,655.0,655.0,5,851,1.0,583.0,583.0
0.006,17,2,230,1,68,0.0,40.0,40.0,1,162,0.0,134.0,134.0
0.005,6,10,1989,5,927,1.0,659.0,659.0,5,1062,1.0,794.0,794.0
0.017,6,10,1990,5,911,4.0,643.0,643.0,5,1079,4.0,811.0,811.0
0.055,17,2,144,1,64,0.0,36.0,36.0,1,80,0.0,52.0,52.0
0.017,6,10,1972,5,910,4.0,642.0,642.0,5,1062,4.0,794.0,794.0
352.248,6,20,2210,6,1308,12004.0,494.0,494.0,14,902,27095.0,83.0,83.0
0.099,6,10,1506,5,395,23.0,127.0,127.0,5,1111,22.0,843.0,843.0
0.103,6,10,1506,5,395,22.0,127.0,127.0,5,1111,23.0,843.0,843.0
0.144,6,10,1506,5,395,32.0,127.0,127.0,5,1111,25.0,843.0,843.0
0.005,6,10,1689,5,839,1.0,571.0,571.0,5,850,1.0,582.0,582.0
0.005,6,10,2006,5,927,1.0,659.0,659.0,5,1079,1.0,811.0,811.0
0.005,6,10,2000,5,927,1.0,659.0,659.0,5,1073,1.0,805.0,805.0
0.005,6,10,2006,5,927,1.0,659.0,659.0,5,1079,1.0,811.0,811.0
0.004,6,10,2006,5,927,1.0,659.0,659.0,5,1079,1.0,811.0,811.0
0.018,6,10,1983,5,910,4.0,642.0,642.0,5,1073,4.0,805.0,805.0
0.005,6,10,1702,5,863,1.0,595.0,595.0,5,839,1.0,571.0,571.0
309.184,17,20,1124,10,716,34338.0,48.0,43.0,10,408,34338.0,20.0,12.0
0.014,6,10,1631,5,848,3.0,580.0,580.0,5,783,3.0,515.0,515.0
240.216,6,32,12222,16,6228,16014.0,1760.0,898.0,16,5994,16014.0,1657.0,736.0
0.112,6,10,1506,5,395,25.0,127.0,127.0,5,1111,24.0,843.0,843.0
0.012,6,13,3735,7,497,2.0,125.0,125.0,6,3238,2.0,1470.0,1459.0
10.8,17,26,4103,13,1847,891.0,270.0,114.0,13,2256,891.0,587.0,145.0
0.005,17,2,170,1,65,0.0,37.0,37.0,1,105,0.0,77.0,77.0
0.007,6,10,1547,5,764,1.0,496.0,496.0,5,783,1.0,515.0,515.0
240.714,6,22,7487,12,1875,21883.0,990.0,418.0,10,5612,26745.0,1593.0,847.0
0.005,17,2,144,1,64,0.0,36.0,36.0,1,80,0.0,52.0,52.0
0.013,6,10,1990,5,911,3.0,643.0,643.0,5,1079,3.0,811.0,811.0
0.082,6,10,1506,5,395,16.0,127.0,127.0,5,1111,18.0,843.0,843.0
0.011,6,10,1983,5,910,2.0,642.0,642.0,5,1073,2.0,805.0,805.0
0.005,17,2,180,1,66,0.0,38.0,38.0,1,114,0.0,86.0,86.0
0.004,17,4,284,2,120,1.0,32.0,32.0,2,164,0.0,60.0,54.0
0.004,6,10,1779,5,928,1.0,660.0,660.0,5,851,1.0,583.0,583.0
240.346,6,33,9309,16,1836,16022.0,624.0,199.0,17,7473,15021.0,1402.0,599.0
0.014,6,10,1989,5,910,3.0,642.0,642.0,5,1079,3.0,811.0,811.0
0.005,6,14,3799,7,509,0.0,137.0,137.0,7,3290,0.0,1448.0,972.0
0.134,6,10,1506,5,395,33.0,127.0,127.0,5,1111,30.0,843.0,843.0
0.004,6,10,2007,5,928,1.0,660.0,660.0,5,1079,1.0,811.0,811.0
40.066,17,10,676,5,460,10015.0,104.0,64.0,5,216,10015.0,20.0,15.0
0.022,17,2,148,1,60,0.0,32.0,32.0,1,88,0.0,60.0,60.0
0.012,6,10,1983,5,910,3.0,642.0,642.0,5,1073,2.0,805.0,805.0
0.004,17,2,148,1,60,0.0,32.0,32.0,1,88,0.0,60.0,60.0
0.07,6,10,1506,5,395,16.0,127.0,127.0,5,1111,15.0,843.0,843.0
0.111,6,10,1506,5,395,25.0,127.0,127.0,5,1111,24.0,843.0,843.0
0.103,6,10,1506,5,395,23.0,127.0,127.0,5,1111,25.0,843.0,843.0
0.134,6,10,1506,5,395,27.0,127.0,127.0,5,1111,31.0,843.0,843.0
40.056,17,10,676,5,460,10012.0,104.0,64.0,5,216,10013.0,20.0,15.0
0.081,6,10,1506,5,395,15.0,127.0,127.0,5,1111,19.0,843.0,843.0
0.076,6,10,1506,5,395,16.0,127.0,127.0,5,1111,18.0,843.0,843.0
0.174,6,3,453,2,321,174.0,241.0,241.0,1,132,0.0,92.0,92.0
0.037,17,2,148,1,60,0.0,32.0,32.0,1,88,0.0,60.0,60.0
0.004,6,10,1774,5,923,1.0,655.0,655.0,5,851,1.0,583.0,583.0
168.324,17,92,13311,46,3073,3740.0,44.0,38.0,46,10238,3740.0,239.0,194.0
0.001,17,2,180,1,66,0.0,38.0,38.0,1,114,0.0,86.0,86.0
0.006,6,10,1547,5,764,1.0,496.0,496.0,5,783,1.0,515.0,515.0
175.298,17,88,12432,44,2947,4076.0,44.0,38.0,44,9485,4076.0,239.0,187.0
0.017,6,10,1972,5,910,4.0,642.0,642.0,5,1062,4.0,794.0,794.0
0.013,6,10,1990,5,911,3.0,643.0,643.0,5,1079,3.0,811.0,811.0
0.006,6,10,1547,5,764,1.0,496.0,496.0,5,783,1.0,515.0,515.0
0.005,6,10,2006,5,927,1.0,659.0,659.0,5,1079,1.0,811.0,811.0
0.074,6,10,1506,5,395,16.0,127.0,127.0,5,1111,16.0,843.0,843.0
0.004,17,2,148,1,60,0.0,32.0,32.0,1,88,0.0,60.0,60.0
40.067,17,10,676,5,460,10016.0,104.0,64.0,5,216,10015.0,20.0,15.0
0.009,6,12,1926,6,1189,1.0,659.0,434.0,6,737,1.0,417.0,417.0
240.085,6,16,4481,9,963,30010.0,238.0,166.0,7,3518,40013.0,1402.0,786.0
0.123,6,10,1506,5,395,24.0,127.0,127.0,5,1111,27.0,843.0,843.0
0.067,6,10,1506,5,395,14.0,127.0,127.0,5,1111,13.0,843.0,843.0
0.039,17,2,166,1,75,0.0,47.0,47.0,1,91,0.0,63.0,63.0
0.004,6,10,1779,5,928,1.0,660.0,660.0,5,851,1.0,583.0,583.0
0.006,6,10,1983,5,910,1.0,642.0,642.0,5,1073,1.0,805.0,805.0
0.013,6,10,1983,5,910,3.0,642.0,642.0,5,1073,3.0,805.0,805.0
0.011,6,10,1983,5,910,2.0,642.0,642.0,5,1073,2.0,805.0,805.0
0.073,6,10,1506,5,395,17.0,127.0,127.0,5,1111,14.0,843.0,843.0
0.012,6,13,3735,7,497,2.0,125.0,125.0,6,3238,2.0,1470.0,1459.0
0.014,6,10,1989,5,910,3.0,642.0,642.0,5,1079,3.0,811.0,811.0
0.007,6,10,1547,5,764,1.0,496.0,496.0,5,783,1.0,515.0,515.0
0.047,6,13,3735,7,497,7.0,125.0,125.0,6,3238,9.0,1470.0,1459.0
0.021,6,10,1972,5,910,5.0,642.0,642.0,5,1062,5.0,794.0,794.0
0.006,6,10,1689,5,839,1.0,571.0,571.0,5,850,1.0,582.0,582.0
0.009,17,2,169,1,62,0.0,34.0,34.0,1,107,0.0,79.0,79.0
15.099,17,19,10791,9,8290,1881.0,1350.0,893.0,10,2501,1674.0,1350.0,222.0
0.006,6,10,1643,5,860,1.0,592.0,592.0,5,783,1.0,515.0,515.0
0.01,6,10,1989,5,910,2.0,642.0,642.0,5,1079,2.0,811.0,811.0
0.009,6,12,1926,6,1189,1.0,659.0,434.0,6,737,1.0,417.0,417.0
0.012,6,10,1990,5,911,3.0,643.0,643.0,5,1079,3.0,811.0,811.0
0.013,6,10,1677,5,827,3.0,559.0,559.0,5,850,3.0,582.0,582.0
40.062,17,10,676,5,460,10013.0,104.0,64.0,5,216,10013.0,20.0,15.0
0.012,6,10,1989,5,910,3.0,642.0,642.0,5,1079,2.0,811.0,811.0
0.089,6,10,1506,5,395,18.0,127.0,127.0,5,1111,20.0,843.0,843.0
0.003,17,4,284,2,120,0.0,32.0,32.0,2,164,0.0,60.0,54.0
0.004,6,10,2007,5,928,1.0,660.0,660.0,5,1079,1.0,811.0,811.0
0.008,6,10,1990,5,911,2.0,643.0,643.0,5,1079,1.0,811.0,811.0
0.005,6,10,2006,5,927,1.0,659.0,659.0,5,1079,1.0,811.0,811.0
0.005,6,10,2006,5,927,1.0,659.0,659.0,5,1079,1.0,811.0,811.0
0.001,17,2,166,1,75,0.0,47.0,47.0,1,91,0.0,63.0,63.0
0.005,6,10,1989,5,927,1.0,659.0,659.0,5,1062,1.0,794.0,794.0
0.091,6,10,1506,5,395,18.0,127.0,127.0,5,1111,21.0,843.0,843.0
0.078,6,10,1506,5,395,17.0,127.0,127.0,5,1111,19.0,843.0,843.0
0.016,6,10,1990,5,911,3.0,643.0,643.0,5,1079,3.0,811.0,811.0
8.962,6,37,10002,19,4484,497.0,1360.0,738.0,18,5518,515.0,1360.0,398.0
0.007,6,10,1547,5,764,1.0,496.0,496.0,5,783,1.0,515.0,515.0
0.118,6,10,1506,5,395,28.0,127.0,127.0,5,1111,25.0,843.0,843.0
0.005,17,2,160,1,72,0.0,44.0,44.0,1,88,0.0,60.0,60.0
0.01,6,10,1989,5,910,2.0,642.0,642.0,5,1079,2.0,811.0,811.0
38.256,6,38,9663,19,4060,494.0,2903.0,1085.0,19,5603,2115.0,2667.0,402.0
0.005,6,13,3747,7,509,0.0,137.0,137.0,6,3238,0.0,1470.0,1459.0
0.003,17,2,185,1,73,0.0,45.0,45.0,1,112,0.0,84.0,84.0
0.011,6,10,1677,5,827,2.0,559.0,559.0,5,850,2.0,582.0,582.0
1730.379,6,45,2790,30,1725,59668.0,35.0,35.0,15,1065,123593.0,31.0,31.0
0.006,6,10,1547,5,764,1.0,496.0,496.0,5,783,1.0,515.0,515.0
1770.975,6,85,4525,43,2290,42165.0,27.0,27.0,42,2235,43193.0,27.0,25.0
0.001,17,2,180,1,66,0.0,38.0,38.0,1,114,0.0,86.0,86.0
0.008,17,2,179,1,71,0.0,43.0,43.0,1,108,0.0,80.0,80.0
0.006,6,10,1547,5,764,1.0,496.0,496.0,5,783,1.0,515.0,515.0
0.038,17,2,186,1,61,0.0,33.0,33.0,1,125,0.0,97.0,97.0
0.018,6,10,1989,5,910,4.0,642.0,642.0,5,1079,4.0,811.0,811.0
0.004,6,10,1774,5,923,1.0,655.0,655.0,5,851,1.0,583.0,583.0
0.005,6,10,1989,5,927,1.0,659.0,659.0,5,1062,1.0,794.0,794.0
0.015,17,2,140,1,62,0.0,34.0,34.0,1,78,0.0,50.0,50.0
0.005,6,10,1774,5,923,1.0,655.0,655.0,5,851,1.0,583.0,583.0
0.02,6,10,1989,5,910,4.0,642.0,642.0,5,1079,5.0,811.0,811.0
0.005,6,10,1643,5,860,1.0,592.0,592.0,5,783,1.0,515.0,515.0
315.106,17,20,1124,10,716,35005.0,48.0,43.0,10,408,35005.0,20.0,12.0
0.006,6,14,3799,7,509,1.0,137.0,137.0,7,3290,0.0,1448.0,972.0
0.006,17,2,148,1,60,0.0,32.0,32.0,1,88,0.0,60.0,60.0
0.004,6,10,2006,5,927,1.0,659.0,659.0,5,1079,1.0,811.0,811.0
0.041,17,2,152,1,76,0.0,48.0,48.0,1,76,0.0,48.0,48.0
0.022,6,10,1972,5,910,5.0,642.0,642.0,5,1062,5.0,794.0,794.0
0.037,17,4,352,2,130,0.0,37.0,37.0,2,222,34.0,89.0,83.0
0.008,6,12,1926,6,1189,1.0,659.0,434.0,6,737,1.0,417.0,417.0
0.003,17,4,284,2,120,0.0,32.0,32.0,2,164,0.0,60.0,54.0
1799.999,6,279,40199,110,27448,16238.0,2720.0,253.0,169,12751,10713.0,1062.0,77.0
0.005,6,14,3742,8,504,0.0,80.0,80.0,6,3238,0.0,1470.0,1459.0
300.409,6,16,2170,9,684,37529.0,146.0,146.0,7,1486,50039.0,419.0,398.0
0.005,17,2,222,1,65,0.0,37.0,37.0,1,157,0.0,129.0,129.0
0.015,6,10,1972,5,910,3.0,642.0,642.0,5,1062,3.0,794.0,794.0
40.057,17,10,676,5,460,10013.0,104.0,64.0,5,216,10013.0,20.0,15.0
0.005,6,10,2006,5,927,1.0,659.0,659.0,5,1079,1.0,811.0,811.0
0.003,17,2,234,1,61,0.0,33.0,33.0,1,173,0.0,145.0,145.0
0.004,17,2,186,1,61,0.0,33.0,33.0,1,125,0.0,97.0,97.0
0.005,6,10,2006,5,927,1.0,659.0,659.0,5,1079,1.0,811.0,811.0
0.012,6,10,1990,5,911,3.0,643.0,643.0,5,1079,2.0,811.0,811.0
0.11,6,10,1506,5,395,22.0,127.0,127.0,5,1111,23.0,843.0,843.0
0.005,6,10,2006,5,927,1.0,659.0,659.0,5,1079,1.0,811.0,811.0
0.006,17,2,179,1,71,0.0,43.0,43.0,1,108,0.0,80.0,80.0
0.006,6,10,1643,5,860,1.0,592.0,592.0,5,783,1.0,515.0,515.0
0.004,17,4,284,2,120,0.0,32.0,32.0,2,164,1.0,60.0,54.0
0.004,6,10,1774,5,923,1.0,655.0,655.0,5,851,1.0,583.0,583.0
0.009,6,10,1972,5,910,2.0,642.0,642.0,5,1062,2.0,794.0,794.0
0.071,17,2,166,1,75,0.0,47.0,47.0,1,91,0.0,63.0,63.0
0.006,6,10,1547,5,764,1.0,496.0,496.0,5,783,1.0,515.0,515.0
0.072,17,2,136,1,60,0.0,32.0,32.0,1,76,0.0,48.0,48.0
0.006,6,10,2006,5,927,1.0,659.0,659.0,5,1079,1.0,811.0,811.0
0.012,6,10,1990,5,911,2.0,643.0,643.0,5,1079,3.0,811.0,811.0
0.006,6,10,1547,5,764,1.0,496.0,496.0,5,783,1.0,515.0,515.0
0.006,6,10,1547,5,764,1.0,496.0,496.0,5,783,1.0,515.0,515.0
0.006,6,10,1689,5,839,1.0,571.0,571.0,5,850,1.0,582.0,582.0
0.005,6,13,3747,7,509,0.0,137.0,137.0,6,3238,0.0,1470.0,1459.0
0.007,17,2,164,1,74,0.0,46.0,46.0,1,90,0.0,62.0,62.0
0.016,17,2,198,1,91,0.0,63.0,63.0,1,107,0.0,79.0,79.0
0.005,17,2,146,1,65,0.0,37.0,37.0,1,81,0.0,53.0,53.0
0.005,6,10,1689,5,839,1.0,571.0,571.0,5,850,1.0,582.0,582.0
0.005,6,10,2006,5,927,1.0,659.0,659.0,5,1079,1.0,811.0,811.0
164.306,17,82,11845,41,2761,4107.0,44.0,39.0,41,9084,4107.0,239.0,193.0
15.212,17,18,9226,9,6881,1898.0,1350.0,736.0,9,2345,1897.0,1350.0,232.0
0.09,6,10,1506,5,395,18.0,127.0,127.0,5,1111,21.0,843.0,843.0
240.009,6,9,787,5,488,60002.0,232.0,232.0,4,299,80002.0,83.0,83.0
0.005,6,13,3747,7,509,0.0,137.0,137.0,6,3238,1.0,1470.0,1459.0
0.007,17,2,170,1,65,0.0,37.0,37.0,1,105,0.0,77.0,77.0
0.005,6,10,2006,5,927,1.0,659.0,659.0,5,1079,1.0,811.0,811.0
40.1,17,10,676,5,460,10020.0,104.0,64.0,5,216,10024.0,20.0,15.0
0.009,6,10,1983,5,910,2.0,642.0,642.0,5,1073,2.0,805.0,805.0
0.089,6,10,1506,5,395,19.0,127.0,127.0,5,1111,18.0,843.0,843.0
0.001,17,2,136,1,60,0.0,32.0,32.0,1,76,0.0,48.0,48.0
0.001,17,2,180,1,65,0.0,37.0,37.0,1,115,0.0,87.0,87.0
0.009,6,10,1972,5,910,2.0,642.0,642.0,5,1062,2.0,794.0,794.0
0.065,6,10,1506,5,395,15.0,127.0,127.0,5,1111,14.0,843.0,843.0
0.018,6,10,1677,5,827,4.0,559.0,559.0,5,850,4.0,582.0,582.0
0.081,6,10,1506,5,395,16.0,127.0,127.0,5,1111,19.0,843.0,843.0
0.02,6,10,1677,5,827,5.0,559.0,559.0,5,850,4.0,582.0,582.0
0.075,6,10,1506,5,395,17.0,127.0,127.0,5,1111,15.0,843.0,843.0
0.082,6,10,1506,5,395,18.0,127.0,127.0,5,1111,17.0,843.0,843.0
0.017,6,10,1677,5,827,4.0,559.0,559.0,5,850,4.0,582.0,582.0
0.005,6,10,2007,5,928,1.0,660.0,660.0,5,1079,1.0,811.0,811.0
0.1,6,10,1506,5,395,21.0,127.0,127.0,5,1111,22.0,843.0,843.0
40.078,17,10,676,5,460,10016.0,104.0,64.0,5,216,10018.0,20.0,15.0
0.008,6,10,1990,5,911,2.0,643.0,643.0,5,1079,2.0,811.0,811.0
40.06,17,10,676,5,460,10014.0,104.0,64.0,5,216,10014.0,20.0,15.0
0.001,17,2,174,1,72,0.0,44.0,44.0,1,102,0.0,74.0,74.0
0.006,6,10,1547,5,764,1.0,496.0,496.0,5,783,1.0,515.0,515.0
0.005,17,2,179,1,71,0.0,43.0,43.0,1,108,0.0,80.0,80.0
0.004,6,10,1779,5,928,1.0,660.0,660.0,5,851,1.0,583.0,583.0
301.402,6,64,38287,33,32020,9418.0,4080.0,1804.0,31,6267,307.0,2667.0,385.0
0.01,6,10,1762,5,911,2.0,643.0,643.0,5,851,2.0,583.0,583.0
0.005,6,10,2007,5,928,1.0,660.0,660.0,5,1079,1.0,811.0,811.0
40.082,17,10,676,5,460,10018.0,104.0,64.0,5,216,10019.0,20.0,15.0
0.004,6,10,1779,5,928,1.0,660.0,660.0,5,851,1.0,583.0,583.0
0.006,17,2,132,1,58,0.0,30.0,30.0,1,74,0.0,46.0,46.0
0.004,6,10,1989,5,927,1.0,659.0,659.0,5,1062,1.0,794.0,794.0
0.013,17,2,152,1,56,0.0,28.0,28.0,1,96,0.0,68.0,68.0
0.011,6,10,1972,5,910,2.0,642.0,642.0,5,1062,2.0,794.0,794.0
0.007,17,2,179,1,71,0.0,43.0,43.0,1,108,0.0,80.0,80.0
0.012,6,10,1631,5,848,3.0,580.0,580.0,5,783,3.0,515.0,515.0
0.005,17,2,164,1,74,0.0,46.0,46.0,1,90,0.0,62.0,62.0
0.005,6,10,1989,5,927,1.0,659.0,659.0,5,1062,1.0,794.0,794.0
1.011,6,12,3142,6,2099,152.0,1328.0,923.0,6,1043,152.0,791.0,791.0
0.005,6,10,2006,5,927,1.0,659.0,659.0,5,1079,1.0,811.0,811.0
0.005,6,10,1689,5,839,1.0,571.0,571.0,5,850,1.0,582.0,582.0
0.005,6,10,2007,5,928,1.0,660.0,660.0,5,1079,1.0,811.0,811.0
40.053,17,10,676,5,460,10012.0,104.0,64.0,5,216,10012.0,20.0,15.0
0.004,6,10,1779,5,928,1.0,660.0,660.0,5,851,1.0,583.0,583.0
240.274,6,35,10107,18,1887,14133.0,559.0,188.0,17,8220,15016.0,1616.0,667.0
0.006,6,10,1547,5,764,1.0,496.0,496.0,5,783,1.0,515.0,515.0
11.155,17,28,4422,14,1993,845.0,268.0,114.0,14,2429,845.0,588.0,145.0
0.006,6,10,1689,5,839,1.0,571.0,571.0,5,850,1.0,582.0,582.0
0.006,6,10,1547,5,764,1.0,496.0,496.0,5,783,1.0,515.0,515.0
0.005,6,10,2006,5,927,1.0,659.0,659.0,5,1079,1.0,811.0,811.0
0.004,6,10,1702,5,863,0.0,595.0,595.0,5,839,1.0,571.0,571.0
0.005,6,10,1989,5,927,1.0,659.0,659.0,5,1062,1.0,794.0,794.0
0.005,6,10,2007,5,928,1.0,660.0,660.0,5,1079,1.0,811.0,811.0
0.013,17,4,284,2,120,10.0,32.0,32.0,2,164,10.0,60.0,54.0
0.009,6,10,1972,5,910,2.0,642.0,642.0,5,1062,2.0,794.0,794.0
0.01,17,2,230,1,68,0.0,40.0,40.0,1,162,0.0,134.0,134.0
0.119,6,10,1506,5,395,23.0,127.0,127.0,5,1111,24.0,843.0,843.0
0.012,6,10,1989,5,910,2.0,642.0,642.0,5,1079,2.0,811.0,811.0
0.001,17,2,180,1,66,0.0,38.0,38.0,1,114,0.0,86.0,86.0
0.019,6,6,716,3,458,6.0,302.0,302.0,3,258,6.0,102.0,102.0
0.005,6,13,3747,7,509,0.0,137.0,137.0,6,3238,1.0,1470.0,1459.0
0.005,6,10,1547,5,764,1.0,496.0,496.0,5,783,1.0,515.0,515.0
0.014,6,10,1631,5,848,3.0,580.0,580.0,5,783,3.0,515.0,515.0
0.005,6,10,1689,5,839,1.0,571.0,571.0,5,850,1.0,582.0,582.0
0.008,17,2,179,1,71,0.0,43.0,43.0,1,108,0.0,80.0,80.0
0.287,17,16,9588,8,6964,41.0,1350.0,842.0,8,2624,17.0,1350.0,300.0
0.023,6,10,1762,5,911,5.0,643.0,643.0,5,851,5.0,583.0,583.0
240.014,6,9,787,5,488,60003.0,232.0,232.0,4,299,80003.0,83.0,83.0
0.004,6,14,3799,7,509,0.0,137.0,137.0,7,3290,0.0,1448.0,972.0
0.01,6,10,1972,5,910,2.0,642.0,642.0,5,1062,2.0,794.0,794.0
0.005,6,10,1779,5,928,1.0,660.0,660.0,5,851,1.0,583.0,583.0
0.003,17,2,136,1,60,0.0,32.0,32.0,1,76,0.0,48.0,48.0
15.184,17,19,11053,10,7499,1684.0,1350.0,721.0,9,3554,1894.0,1350.0,366.0
0.003,17,2,148,1,60,0.0,32.0,32.0,1,88,0.0,60.0,60.0
0.171,6,3,453,2,321,171.0,241.0,241.0,1,132,0.0,92.0,92.0
11.129,17,28,4421,14,1994,843.0,269.0,114.0,14,2427,843.0,586.0,145.0
0.004,6,10,2000,5,927,1.0,659.0,659.0,5,1073,1.0,805.0,805.0
0.075,6,10,1506,5,395,16.0,127.0,127.0,5,1111,15.0,843.0,843.0
0.011,6,10,1972,5,910,2.0,642.0,642.0,5,1062,2.0,794.0,794.0
0.014,6,10,1989,5,910,3.0,642.0,642.0,5,1079,3.0,811.0,811.0
0.071,17,2,166,1,75,0.0,47.0,47.0,1,91,0.0,63.0,63.0
0.218,17,14,8577,7,4012,36.0,1350.0,545.0,7,4565,27.0,1350.0,624.0
0.001,17,2,140,1,62,0.0,34.0,34.0,1,78,0.0,50.0,50.0
0.008,6,10,1990,5,911,2.0,643.0,643.0,5,1079,2.0,811.0,811.0
0.01,6,12,1926,6,1189,1.0,659.0,434.0,6,737,2.0,417.0,417.0
0.013,6,10,1989,5,910,3.0,642.0,642.0,5,1079,3.0,811.0,811.0
300.351,6,16,2170,9,684,37523.0,146.0,146.0,7,1486,50030.0,419.0,398.0
0.425,17,43,23138,24,19838,18.0,1350.0,798.0,19,3300,19.0,1350.0,145.0
0.024,6,10,1631,5,848,5.0,580.0,580.0,5,783,5.0,515.0,515.0
0.005,6,10,1774,5,923,1.0,655.0,655.0,5,851,1.0,583.0,583.0
40.065,17,10,676,5,460,10015.0,104.0,64.0,5,216,10015.0,20.0,15.0
0.008,6,10,1989,5,910,1.0,642.0,642.0,5,1079,2.0,811.0,811.0
0.005,6,10,2007,5,928,1.0,660.0,660.0,5,1079,1.0,811.0,811.0
0.005,17,2,170,1,65,0.0,37.0,37.0,1,105,0.0,77.0,77.0
352.251,6,20,2210,6,1308,12004.0,494.0,494.0,14,902,27096.0,83.0,83.0
40.072,17,10,676,5,460,10012.0,104.0,64.0,5,216,10017.0,20.0,15.0
0.013,6,10,1989,5,910,3.0,642.0,642.0,5,1079,3.0,811.0,811.0
0.017,6,10,1972,5,910,4.0,642.0,642.0,5,1062,4.0,794.0,794.0
0.017,6,10,1972,5,910,4.0,642.0,642.0,5,1062,4.0,794.0,794.0
0.06,6,10,1506,5,395,12.0,127.0,127.0,5,1111,14.0,843.0,843.0
0.005,17,2,186,1,60,0.0,32.0,32.0,1,126,0.0,98.0,98.0
300.399,6,16,2170,9,684,37529.0,146.0,146.0,7,1486,50037.0,419.0,398.0
0.01,6,10,1983,5,910,2.0,642.0,642.0,5,1073,2.0,805.0,805.0
0.005,17,2,169,1,62,0.0,34.0,34.0,1,107,0.0,79.0,79.0
0.072,17,2,182,1,65,0.0,37.0,37.0,1,117,0.0,89.0,89.0
166.348,17,78,11024,39,2601,4377.0,44.0,38.0,39,8423,4377.0,261.0,187.0
0.007,17,2,162,1,65,0.0,37.0,37.0,1,97,0.0,69.0,69.0
0.005,6,10,2006,5,927,1.0,659.0,659.0,5,1079,1.0,811.0,811.0
0.086,6,10,1506,5,395,19.0,127.0,127.0,5,1111,16.0,843.0,843.0
0.006,17,2,294,1,64,0.0,36.0,36.0,1,230,0.0,202.0,202.0
0.006,17,2,230,1,68,0.0,40.0,40.0,1,162,0.0,134.0,134.0
0.032,6,10,1631,5,848,8.0,580.0,580.0,5,783,8.0,515.0,515.0
0.074,6,10,1506,5,395,16.0,127.0,127.0,5,1111,15.0,843.0,843.0
0.004,17,4,284,2,120,0.0,32.0,32.0,2,164,0.0,60.0,54.0
172.21,17,74,10515,37,2466,4783.0,44.0,38.0,37,8049,4783.0,239.0,189.0
308.872,17,20,1124,10,716,34305.0,48.0,43.0,10,408,34305.0,20.0,12.0
0.005,17,2,230,1,68,0.0,40.0,40.0,1,162,0.0,134.0,134.0
0.006,6,10,1689,5,839,1.0,571.0,571.0,5,850,1.0,582.0,582.0
0.004,17,2,148,1,60,0.0,32.0,32.0,1,88,0.0,60.0,60.0
0.006,17,2,170,1,65,0.0,37.0,37.0,1,105,0.0,77.0,77.0
0.01,6,10,1677,5,827,2.0,559.0,559.0,5,850,2.0,582.0,582.0
0.011,6,10,1983,5,910,2.0,642.0,642.0,5,1073,2.0,805.0,805.0
0.005,6,10,2000,5,927,1.0,659.0,659.0,5,1073,1.0,805.0,805.0
0.001,17,2,180,1,66,0.0,38.0,38.0,1,114,0.0,86.0,86.0
0.039,17,2,148,1,60,0.0,32.0,32.0,1,88,0.0,60.0,60.0
40.082,17,10,676,5,460,10015.0,104.0,64.0,5,216,10019.0,20.0,15.0
0.01,6,10,1989,5,910,2.0,642.0,642.0,5,1079,2.0,811.0,811.0
0.861,6,10,1941,6,1587,172.0,1335.0,1335.0,4,354,205.0,182.0,182.0
0.075,6,10,1506,5,395,16.0,127.0,127.0,5,1111,16.0,843.0,843.0
0.005,17,2,214,1,75,0.0,47.0,47.0,1,139,0.0,111.0,111.0
0.006,6,10,1547,5,764,1.0,496.0,496.0,5,783,1.0,515.0,515.0
0.359,17,43,21677,24,18529,15.0,1350.0,744.0,19,3148,16.0,1350.0,137.0
0.015,6,10,1990,5,911,3.0,643.0,643.0,5,1079,3.0,811.0,811.0
0.067,17,8,3613,4,1874,22.0,1350.0,440.0,4,1739,11.0,1350.0,406.0
0.042,17,4,284,2,120,0.0,32.0,32.0,2,164,39.0,60.0,54.0
0.0,17,2,180,1,58,0.0,30.0,30.0,1,122,0.0,94.0,94.0
0.01,6,10,1989,5,910,2.0,642.0,642.0,5,1079,2.0,811.0,811.0
0.005,6,13,3747,7,509,0.0,137.0,137.0,6,3238,1.0,1470.0,1459.0
0.004,17,2,148,1,60,0.0,32.0,32.0,1,88,0.0,60.0,60.0
0.077,6,10,1506,5,395,16.0,127.0,127.0,5,1111,16.0,843.0,843.0
0.019,6,10,1989,5,910,4.0,642.0,642.0,5,1079,4.0,811.0,811.0
0.013,6,10,1762,5,911,3.0,643.0,643.0,5,851,3.0,583.0,583.0
0.013,6,10,1989,5,910,3.0,642.0,642.0,5,1079,3.0,811.0,811.0
0.043,17,2,179,1,71,0.0,43.0,43.0,1,108,0.0,80.0,80.0
0.005,6,10,2006,5,927,1.0,659.0,659.0,5,1079,1.0,811.0,811.0
0.021,6,10,1989,5,910,5.0,642.0,642.0,5,1079,5.0,811.0,811.0
0.003,17,2,148,1,60,0.0,32.0,32.0,1,88,0.0,60.0,60.0
0.008,6,10,1983,5,910,1.0,642.0,642.0,5,1073,1.0,805.0,805.0
0.007,6,10,1547,5,764,1.0,496.0,496.0,5,783,1.0,515.0,515.0
0.009,6,10,1990,5,911,2.0,643.0,643.0,5,1079,2.0,811.0,811.0
0.212,6,16,2670,8,1396,30.0,533.0,324.0,8,1274,19.0,529.0,212.0
0.003,6,10,1702,5,863,0.0,595.0,595.0,5,839,0.0,571.0,571.0
353.04,6,20,2210,6,1308,12003.0,494.0,494.0,14,902,27156.0,83.0,83.0
0.004,17,2,208,1,72,0.0,44.0,44.0,1,136,0.0,108.0,108.0
0.046,17,2,170,1,65,0.0,37.0,37.0,1,105,0.0,77.0,77.0
0.004,6,10,2006,5,927,1.0,659.0,659.0,5,1079,1.0,811.0,811.0
40.075,17,10,676,5,460,10017.0,104.0,64.0,5,216,10018.0,20.0,15.0
0.079,6,10,1506,5,395,17.0,127.0,127.0,5,1111,18.0,843.0,843.0
0.011,6,10,1989,5,910,2.0,642.0,642.0,5,1079,2.0,811.0,811.0
0.013,6,10,1677,5,827,3.0,559.0,559.0,5,850,3.0,582.0,582.0
0.008,6,12,1926,6,1189,1.0,659.0,434.0,6,737,1.0,417.0,417.0
0.016,6,10,1990,5,911,4.0,643.0,643.0,5,1079,4.0,811.0,811.0
0.004,17,4,284,2,120,0.0,32.0,32.0,2,164,0.0,60.0,54.0
0.023,6,13,3735,7,497,3.0,125.0,125.0,6,3238,4.0,1470.0,1459.0
0.005,17,2,168,1,76,0.0,48.0,48.0,1,92,0.0,64.0,64.0
0.021,6,10,1989,5,910,5.0,642.0,642.0,5,1079,5.0,811.0,811.0
0.127,17,2,182,1,65,0.0,37.0,37.0,1,117,0.0,89.0,89.0
0.085,6,10,1506,5,395,20.0,127.0,127.0,5,1111,15.0,843.0,843.0
0.005,6,10,1689,5,839,1.0,571.0,571.0,5,850,1.0,582.0,582.0
0.004,6,10,2007,5,928,1.0,660.0,660.0,5,1079,1.0,811.0,811.0
0.005,6,10,1689,5,839,1.0,571.0,571.0,5,850,1.0,582.0,582.0
0.004,6,10,2007,5,928,1.0,660.0,660.0,5,1079,1.0,811.0,811.0
0.112,6,10,1506,5,395,19.0,127.0,127.0,5,1111,24.0,843.0,843.0
0.004,6,10,2007,5,928,1.0,660.0,660.0,5,1079,1.0,811.0,811.0
0.039,17,2,412,1,61,0.0,33.0,33.0,1,351,0.0,323.0,323.0
0.013,6,10,1990,5,911,3.0,643.0,643.0,5,1079,3.0,811.0,811.0
0.006,6,10,1547,5,764,1.0,496.0,496.0,5,783,1.0,515.0,515.0
0.004,6,10,2006,5,927,1.0,659.0,659.0,5,1079,1.0,811.0,811.0
240.466,6,35,8925,18,2072,14144.0,693.0,225.0,17,6853,15028.0,1402.0,597.0
366.546,6,26,4253,12,3102,10913.0,494.0,494.0,14,1151,28195.0,83.0,83.0
66.027,6,27,17854,15,9912,4716.0,2804.0,1520.0,12,7942,5987.0,2313.0,1218.0
0.071,17,4,352,2,130,0.0,37.0,37.0,2,222,33.0,89.0,83.0
0.005,6,10,1643,5,860,1.0,592.0,592.0,5,783,1.0,515.0,515.0
0.005,6,10,2006,5,927,1.0,659.0,659.0,5,1079,1.0,811.0,811.0
64.832,6,56,23863,28,17671,346.0,2720.0,1500.0,28,6192,2394.0,2667.0,361.0
300.303,6,16,2170,9,684,37517.0,146.0,146.0,7,1486,50022.0,419.0,398.0
0.115,6,10,1506,5,395,26.0,127.0,127.0,5,1111,25.0,843.0,843.0
0.005,6,10,1989,5,927,1.0,659.0,659.0,5,1062,1.0,794.0,794.0
11.068,17,28,4422,14,1994,839.0,269.0,114.0,14,2428,839.0,587.0,145.0
0.086,6,10,1506,5,395,18.0,127.0,127.0,5,1111,19.0,843.0,843.0
0.017,6,10,1972,5,910,4.0,642.0,642.0,5,1062,4.0,794.0,794.0
0.005,6,10,2006,5,927,1.0,659.0,659.0,5,1079,1.0,811.0,811.0
0.014,6,10,1631,5,848,3.0,580.0,580.0,5,783,3.0,515.0,515.0
0.067,6,10,1506,5,395,13.0,127.0,127.0,5,1111,14.0,843.0,843.0
0.006,6,10,1547,5,764,1.0,496.0,496.0,5,783,1.0,515.0,515.0
0.006,6,10,1547,5,764,1.0,496.0,496.0,5,783,1.0,515.0,515.0
0.257,6,16,2778,8,1396,36.0,533.0,324.0,8,1382,24.0,529.0,239.0
40.061,17,10,676,5,460,10012.0,104.0,64.0,5,216,10014.0,20.0,15.0
0.064,6,10,1506,5,395,15.0,127.0,127.0,5,1111,13.0,843.0,843.0
300.398,6,17,2222,10,736,33359.0,146.0,146.0,7,1486,50039.0,419.0,398.0
0.012,6,10,1972,5,910,2.0,642.0,642.0,5,1062,2.0,794.0,794.0
0.008,17,2,194,1,59,0.0,31.0,31.0,1,135,0.0,107.0,107.0
0.005,6,10,1547,5,764,1.0,496.0,496.0,5,783,1.0,515.0,515.0
0.009,6,10,1854,5,889,2.0,621.0,621.0,5,965,2.0,697.0,697.0
0.127,6,10,1506,5,395,26.0,127.0,127.0,5,1111,29.0,843.0,843.0
0.006,6,10,1854,5,889,1.0,621.0,621.0,5,965,1.0,697.0,697.0
0.004,17,2,148,1,60,0.0,32.0,32.0,1,88,0.0,60.0,60.0
0.005,6,10,2007,5,928,1.0,660.0,660.0,5,1079,1.0,811.0,811.0
0.001,17,2,180,1,66,0.0,38.0,38.0,1,114,0.0,86.0,86.0
0.015,6,10,1631,5,848,3.0,580.0,580.0,5,783,3.0,515.0,515.0
0.011,6,10,1972,5,910,2.0,642.0,642.0,5,1062,2.0,794.0,794.0
0.009,6,10,1990,5,911,2.0,643.0,643.0,5,1079,2.0,811.0,811.0
0.004,17,2,166,1,75,0.0,47.0,47.0,1,91,0.0,63.0,63.0
0.003,17,2,136,1,60,0.0,32.0,32.0,1,76,0.0,48.0,48.0
10.74,17,28,4418,14,1993,817.0,268.0,114.0,14,2425,818.0,588.0,145.0
0.116,6,10,1506,5,395,26.0,127.0,127.0,5,1111,25.0,843.0,843.0
0.007,6,10,1547,5,764,1.0,496.0,496.0,5,783,1.0,515.0,515.0
40.055,17,10,676,5,460,10013.0,104.0,64.0,5,216,10013.0,20.0,15.0
0.004,6,10,2006,5,927,1.0,659.0,659.0,5,1079,1.0,811.0,811.0
0.018,6,10,1983,5,910,4.0,642.0,642.0,5,1073,4.0,805.0,805.0
0.004,6,10,1702,5,863,1.0,595.0,595.0,5,839,0.0,571.0,571.0
240.101,6,16,4481,9,963,30012.0,238.0,166.0,7,3518,40016.0,1402.0,786.0
0.005,6,10,2006,5,927,1.0,659.0,659.0,5,1079,1.0,811.0,811.0
0.001,17,2,164,1,74,0.0,46.0,46.0,1,90,0.0,62.0,62.0
0.005,6,10,1689,5,839,1.0,571.0,571.0,5,850,1.0,582.0,582.0
0.11,6,10,1506,5,395,22.0,127.0,127.0,5,1111,21.0,843.0,843.0
300.282,6,27,7436,16,1409,20018.0,217.0,142.0,11,6027,24025.0,1679.0,778.0
0.006,17,2,230,1,68,0.0,40.0,40.0,1,162,0.0,134.0,134.0
0.007,17,2,299,1,65,0.0,37.0,37.0,1,234,0.0,206.0,206.0
0.004,17,2,148,1,60,0.0,32.0,32.0,1,88,0.0,60.0,60.0
0.005,17,2,148,1,60,0.0,32.0,32.0,1,88,0.0,60.0,60.0
0.006,6,10,1689,5,839,1.0,571.0,571.0,5,850,1.0,582.0,582.0
0.004,17,2,208,1,72,0.0,44.0,44.0,1,136,0.0,108.0,108.0
0.091,6,10,1506,5,395,20.0,127.0,127.0,5,1111,19.0,843.0,843.0
1792.778,6,484,98693,243,87463,7407.0,421.0,368.0,241,11230,7469.0,53.0,53.0
287.749,6,25,7304,11,1226,28774.0,267.0,156.0,14,6078,22133.0,1400.0,919.0
300.414,6,16,2170,9,684,37531.0,146.0,146.0,7,1486,50041.0,419.0,398.0
40.069,17,10,676,5,460,10013.0,104.0,64.0,5,216,10011.0,20.0,15.0
0.006,17,2,144,1,64,0.0,36.0,36.0,1,80,0.0,52.0,52.0
0.008,6,10,1989,5,910,2.0,642.0,642.0,5,1079,2.0,811.0,811.0
0.004,6,10,2006,5,927,1.0,659.0,659.0,5,1079,1.0,811.0,811.0
0.001,17,2,180,1,66,0.0,38.0,38.0,1,114,0.0,86.0,86.0
0.038,17,2,136,1,60,0.0,32.0,32.0,1,76,0.0,48.0,48.0
0.006,6,10,1547,5,764,1.0,496.0,496.0,5,783,1.0,515.0,515.0
40.068,17,10,676,5,460,10016.0,104.0,64.0,5,216,10016.0,20.0,15.0
0.01,6,10,1983,5,910,2.0,642.0,642.0,5,1073,2.0,805.0,805.0
0.086,6,10,1506,5,395,19.0,127.0,127.0,5,1111,20.0,843.0,843.0
0.006,6,10,2007,5,928,1.0,660.0,660.0,5,1079,1.0,811.0,811.0
15.072,17,14,9190,8,6902,2149.0,1350.0,834.0,6,2288,3008.0,1350.0,353.0
0.003,17,2,136,1,60,0.0,32.0,32.0,1,76,0.0,48.0,48.0
0.174,17,2,152,1,76,0.0,48.0,48.0,1,76,0.0,48.0,48.0
0.086,6,10,1506,5,395,20.0,127.0,127.0,5,1111,18.0,843.0,843.0
0.003,17,2,148,1,60,0.0,32.0,32.0,1,88,0.0,60.0,60.0
0.014,6,10,1677,5,827,3.0,559.0,559.0,5,850,3.0,582.0,582.0
0.005,6,10,1854,5,889,1.0,621.0,621.0,5,965,1.0,697.0,697.0
0.006,17,2,140,1,62,0.0,34.0,34.0,1,78,0.0,50.0,50.0
0.004,6,10,1989,5,927,1.0,659.0,659.0,5,1062,1.0,794.0,794.0
0.006,6,10,1689,5,839,1.0,571.0,571.0,5,850,1.0,582.0,582.0
0.004,6,10,2006,5,927,1.0,659.0,659.0,5,1079,1.0,811.0,811.0
0.006,17,2,230,1,68,0.0,40.0,40.0,1,162,0.0,134.0,134.0
0.009,6,11,2042,6,963,1.0,643.0,643.0,5,1079,2.0,811.0,811.0
0.006,6,10,1547,5,764,1.0,496.0,496.0,5,783,1.0,515.0,515.0
0.006,6,10,1689,5,839,1.0,571.0,571.0,5,850,1.0,582.0,582.0
0.01,6,10,1989,5,910,2.0,642.0,642.0,5,1079,2.0,811.0,811.0
0.005,6,10,1779,5,928,1.0,660.0,660.0,5,851,1.0,583.0,583.0
240.096,6,31,9274,15,7010,17149.0,2133.0,692.0,16,2264,16006.0,580.0,178.0
0.005,6,10,1779,5,928,1.0,660.0,660.0,5,851,1.0,583.0,583.0
0.005,6,10,1854,5,889,1.0,621.0,621.0,5,965,1.0,697.0,697.0
0.005,6,14,3742,7,452,0.0,80.0,80.0,7,3290,0.0,1448.0,972.0
0.001,17,2,180,1,66,0.0,38.0,38.0,1,114,0.0,86.0,86.0
240.663,6,39,9797,20,2227,12664.0,747.0,235.0,19,7570,13368.0,1402.0,548.0
0.006,6,12,1698,6,863,1.0,327.0,271.0,6,835,1.0,515.0,515.0
0.014,6,10,1990,5,911,3.0,643.0,643.0,5,1079,3.0,811.0,811.0
361.795,6,21,1792,16,1030,24119.0,190.0,190.0,5,762,60010.0,461.0,247.0
0.001,17,2,179,1,62,0.0,34.0,34.0,1,117,0.0,89.0,89.0
0.005,17,2,144,1,64,0.0,36.0,36.0,1,80,0.0,52.0,52.0
0.003,17,2,136,1,60,0.0,32.0,32.0,1,76,0.0,48.0,48.0
0.012,6,10,1983,5,910,3.0,642.0,642.0,5,1073,3.0,805.0,805.0
0.006,6,10,1547,5,764,1.0,496.0,496.0,5,783,1.0,515.0,515.0
0.041,17,2,148,1,60,0.0,32.0,32.0,1,88,0.0,60.0,60.0
0.004,6,10,1702,5,863,1.0,595.0,595.0,5,839,1.0,571.0,571.0
0.148,6,10,1506,5,395,32.0,127.0,127.0,5,1111,32.0,843.0,843.0
0.01,6,10,1989,5,910,2.0,642.0,642.0,5,1079,2.0,811.0,811.0
0.006,17,2,230,1,68,0.0,40.0,40.0,1,162,0.0,134.0,134.0
0.014,6,10,1983,5,910,3.0,642.0,642.0,5,1073,3.0,805.0,805.0
40.062,17,10,676,5,460,10013.0,104.0,64.0,5,216,10014.0,20.0,15.0
0.014,6,10,1989,5,910,3.0,642.0,642.0,5,1079,3.0,811.0,811.0
10.839,17,28,4417,14,1993,825.0,268.0,114.0,14,2424,825.0,587.0,145.0
0.01,6,10,1989,5,910,2.0,642.0,642.0,5,1079,2.0,811.0,811.0
0.007,6,10,2006,5,927,1.0,659.0,659.0,5,1079,1.0,811.0,811.0
0.009,6,10,1972,5,910,2.0,642.0,642.0,5,1062,2.0,794.0,794.0
0.015,6,10,1989,5,910,3.0,642.0,642.0,5,1079,3.0,811.0,811.0
0.009,6,10,1989,5,910,2.0,642.0,642.0,5,1079,2.0,811.0,811.0
0.005,6,10,1854,5,889,1.0,621.0,621.0,5,965,1.0,697.0,697.0
0.005,17,2,170,1,65,0.0,37.0,37.0,1,105,0.0,77.0,77.0
0.073,6,10,1506,5,395,15.0,127.0,127.0,5,1111,16.0,843.0,843.0
40.071,17,10,676,5,460,10016.0,104.0,64.0,5,216,10016.0,20.0,15.0
0.012,6,10,1972,5,910,3.0,642.0,642.0,5,1062,3.0,794.0,794.0
0.005,6,10,2006,5,927,1.0,659.0,659.0,5,1079,1.0,811.0,811.0
0.005,6,10,2006,5,927,1.0,659.0,659.0,5,1079,1.0,811.0,811.0
0.11,6,10,1506,5,395,18.0,127.0,127.0,5,1111,22.0,843.0,843.0
0.014,6,10,1983,5,910,3.0,642.0,642.0,5,1073,3.0,805.0,805.0
0.005,6,10,2000,5,927,1.0,659.0,659.0,5,1073,1.0,805.0,805.0
0.013,6,10,1972,5,910,3.0,642.0,642.0,5,1062,3.0,794.0,794.0
0.004,6,10,1774,5,923,1.0,655.0,655.0,5,851,1.0,583.0,583.0
0.008,6,10,1547,5,764,2.0,496.0,496.0,5,783,1.0,515.0,515.0
0.005,6,10,1689,5,839,1.0,571.0,571.0,5,850,1.0,582.0,582.0
0.004,17,4,284,2,120,1.0,32.0,32.0,2,164,0.0,60.0,54.0
0.005,6,10,2000,5,927,1.0,659.0,659.0,5,1073,1.0,805.0,805.0
0.014,6,10,1631,5,848,3.0,580.0,580.0,5,783,3.0,515.0,515.0
0.005,6,10,1989,5,927,1.0,659.0,659.0,5,1062,1.0,794.0,794.0
0.169,17,2,152,1,76,0.0,48.0,48.0,1,76,0.0,48.0,48.0
0.006,17,2,164,1,74,0.0,46.0,46.0,1,90,0.0,62.0,62.0
0.003,17,2,148,1,60,0.0,32.0,32.0,1,88,0.0,60.0,60.0
1730.481,6,50,3084,32,1875,55821.0,35.0,35.0,18,1209,101786.0,31.0,31.0
0.007,17,2,194,1,59,0.0,31.0,31.0,1,135,0.0,107.0,107.0
0.068,6,10,1506,5,395,15.0,127.0,127.0,5,1111,15.0,843.0,843.0
40.057,17,10,676,5,460,10012.0,104.0,64.0,5,216,10013.0,20.0,15.0
0.01,6,14,3787,7,497,1.0,125.0,125.0,7,3290,1.0,1448.0,972.0
240.091,6,31,10080,15,7528,17149.0,2653.0,750.0,16,2552,16005.0,580.0,214.0
0.006,6,10,2007,5,928,1.0,660.0,660.0,5,1079,1.0,811.0,811.0
0.004,17,2,148,1,60,0.0,32.0,32.0,1,88,0.0,60.0,60.0
0.016,6,10,1631,5,848,4.0,580.0,580.0,5,783,4.0,515.0,515.0
240.086,6,16,4482,9,963,30010.0,238.0,166.0,7,3519,40013.0,1402.0,786.0
0.005,6,10,1689,5,839,1.0,571.0,571.0,5,850,1.0,582.0,582.0
0.005,6,10,1989,5,927,1.0,659.0,659.0,5,1062,1.0,794.0,794.0
0.087,6,10,1506,5,395,17.0,127.0,127.0,5,1111,19.0,843.0,843.0
0.004,17,2,136,1,60,0.0,32.0,32.0,1,76,0.0,48.0,48.0
0.008,6,10,2000,5,927,1.0,659.0,659.0,5,1073,2.0,805.0,805.0
0.227,6,16,2668,8,1394,32.0,533.0,323.0,8,1274,20.0,529.0,212.0
0.056,17,2,179,1,71,0.0,43.0,43.0,1,108,0.0,80.0,80.0
0.005,17,2,140,1,62,0.0,34.0,34.0,1,78,0.0,50.0,50.0
0.01,6,10,1990,5,911,2.0,643.0,643.0,5,1079,2.0,811.0,811.0
0.003,17,2,152,1,76,0.0,48.0,48.0,1,76,0.0,48.0,48.0
0.012,6,10,1972,5,910,2.0,642.0,642.0,5,1062,3.0,794.0,794.0
0.041,17,2,184,1,61,0.0,33.0,33.0,1,123,0.0,95.0,95.0
0.101,6,10,1506,5,395,22.0,127.0,127.0,5,1111,20.0,843.0,843.0
0.011,6,10,1983,5,910,2.0,642.0,642.0,5,1073,2.0,805.0,805.0
0.005,6,10,2006,5,927,1.0,659.0,659.0,5,1079,1.0,811.0,811.0
0.039,17,2,144,1,64,0.0,36.0,36.0,1,80,0.0,52.0,52.0
0.169,17,2,152,1,76,0.0,48.0,48.0,1,76,0.0,48.0,48.0
0.005,6,10,2000,5,927,1.0,659.0,659.0,5,1073,1.0,805.0,805.0
0.075,6,10,1506,5,395,16.0,127.0,127.0,5,1111,12.0,843.0,843.0
0.068,6,10,1506,5,395,13.0,127.0,127.0,5,1111,16.0,843.0,843.0
0.005,6,13,3747,7,509,0.0,137.0,137.0,6,3238,0.0,1470.0,1459.0
0.005,6,10,1779,5,928,1.0,660.0,660.0,5,851,1.0,583.0,583.0
0.071,6,10,1506,5,395,16.0,127.0,127.0,5,1111,14.0,843.0,843.0
0.008,6,10,1631,5,848,2.0,580.0,580.0,5,783,2.0,515.0,515.0
0.005,6,13,3747,7,509,0.0,137.0,137.0,6,3238,0.0,1470.0,1459.0
0.006,6,10,1547,5,764,1.0,496.0,496.0,5,783,1.0,515.0,515.0
0.006,6,10,1547,5,764,1.0,496.0,496.0,5,783,1.0,515.0,515.0
0.006,6,10,1689,5,839,1.0,571.0,571.0,5,850,1.0,582.0,582.0
0.005,6,10,2007,5,928,1.0,660.0,660.0,5,1079,1.0,811.0,811.0
0.003,17,2,136,1,60,0.0,32.0,32.0,1,76,0.0,48.0,48.0
0.004,6,10,2007,5,928,1.0,660.0,660.0,5,1079,1.0,811.0,811.0
0.005,6,10,1689,5,839,1.0,571.0,571.0,5,850,1.0,582.0,582.0
0.013,6,6,716,3,458,5.0,302.0,302.0,3,258,4.0,102.0,102.0
0.005,6,10,1643,5,860,1.0,592.0,592.0,5,783,1.0,515.0,515.0
0.006,6,10,1547,5,764,1.0,496.0,496.0,5,783,1.0,515.0,515.0
0.081,6,10,1506,5,395,17.0,127.0,127.0,5,1111,17.0,843.0,843.0
0.001,17,2,136,1,60,0.0,32.0,32.0,1,76,0.0,48.0,48.0
0.06,6,10,1506,5,395,13.0,127.0,127.0,5,1111,14.0,843.0,843.0
0.165,17,2,152,1,76,0.0,48.0,48.0,1,76,0.0,48.0,48.0
0.42,17,48,24871,26,21276,16.0,1350.0,790.0,22,3595,18.0,1350.0,135.0
0.004,6,10,2007,5,928,1.0,660.0,660.0,5,1079,1.0,811.0,811.0
0.004,6,10,2000,5,927,1.0,659.0,659.0,5,1073,1.0,805.0,805.0
0.263,17,38,20003,21,17035,13.0,1350.0,783.0,17,2968,12.0,1350.0,146.0
308.693,17,20,1124,10,716,34284.0,48.0,43.0,10,408,34284.0,20.0,12.0
0.004,17,2,170,1,65,0.0,37.0,37.0,1,105,0.0,77.0,77.0
308.401,17,20,1124,10,716,34252.0,48.0,43.0,10,408,34252.0,20.0,12.0
15.009,17,405,350253,143,24499,105.0,1350.0,143.0,262,325754,57.0,1350.0,1215.0
0.065,6,10,1506,5,395,15.0,127.0,127.0,5,1111,15.0,843.0,843.0
0.001,17,2,179,1,62,0.0,34.0,34.0,1,117,0.0,89.0,89.0
0.001,17,2,180,1,66,0.0,38.0,38.0,1,114,0.0,86.0,86.0
162.032,17,68,9777,34,2267,4909.0,44.0,38.0,34,7510,4910.0,261.0,192.0
0.008,6,12,1926,6,1189,1.0,659.0,434.0,6,737,1.0,417.0,417.0
0.012,6,10,1972,5,910,3.0,642.0,642.0,5,1062,3.0,794.0,794.0
0.02,6,10,1990,5,911,5.0,643.0,643.0,5,1079,5.0,811.0,811.0
10.827,17,28,4419,14,1995,823.0,270.0,114.0,14,2424,823.0,587.0,145.0
0.004,6,10,2006,5,927,1.0,659.0,659.0,5,1079,1.0,811.0,811.0
40.066,17,10,676,5,460,10013.0,104.0,64.0,5,216,10014.0,20.0,15.0
0.005,6,10,2000,5,927,1.0,659.0,659.0,5,1073,1.0,805.0,805.0
11.175,17,28,4423,14,1995,847.0,270.0,114.0,14,2428,846.0,587.0,145.0
0.024,6,10,1605,5,388,6.0,120.0,120.0,5,1217,5.0,949.0,949.0
0.013,6,10,1989,5,910,3.0,642.0,642.0,5,1079,3.0,811.0,811.0
0.095,6,10,1506,5,395,20.0,127.0,127.0,5,1111,20.0,843.0,843.0
0.005,6,10,1547,5,764,1.0,496.0,496.0,5,783,1.0,515.0,515.0
0.072,6,10,1506,5,395,16.0,127.0,127.0,5,1111,16.0,843.0,843.0
0.133,6,10,1506,5,395,32.0,127.0,127.0,5,1111,31.0,843.0,843.0
0.006,6,10,1547,5,764,1.0,496.0,496.0,5,783,1.0,515.0,515.0
0.018,6,10,1972,5,910,4.0,642.0,642.0,5,1062,4.0,794.0,794.0
0.011,6,10,1989,5,910,2.0,642.0,642.0,5,1079,2.0,811.0,811.0
15.069,17,15,9239,8,6902,2148.0,1350.0,834.0,7,2337,2506.0,1350.0,305.0
241.432,6,317,343902,124,17957,1962.0,2736.0,885.0,193,325945,1257.0,2769.0,1726.0
0.004,6,10,2006,5,927,1.0,659.0,659.0,5,1079,1.0,811.0,811.0
0.008,6,10,1989,5,910,2.0,642.0,642.0,5,1079,2.0,811.0,811.0
0.009,6,10,1972,5,910,2.0,642.0,642.0,5,1062,2.0,794.0,794.0
0.127,6,10,1506,5,395,27.0,127.0,127.0,5,1111,31.0,843.0,843.0
240.097,6,16,4482,9,963,30012.0,238.0,166.0,7,3519,40015.0,1402.0,786.0
0.006,6,10,1547,5,764,1.0,496.0,496.0,5,783,1.0,515.0,515.0
0.001,17,2,140,1,62,0.0,34.0,34.0,1,78,0.0,50.0,50.0
0.083,6,10,1506,5,395,18.0,127.0,127.0,5,1111,16.0,843.0,843.0
0.138,6,10,1506,5,395,24.0,127.0,127.0,5,1111,32.0,843.0,843.0
361.877,6,21,1793,16,1030,24125.0,190.0,190.0,5,763,60009.0,462.0,247.0
0.004,17,2,136,1,60,0.0,32.0,32.0,1,76,0.0,48.0,48.0
240.086,6,16,4482,9,963,30010.0,238.0,166.0,7,3519,40013.0,1402.0,786.0
44.147,6,28,9605,14,1707,3395.0,794.0,367.0,14,7898,3383.0,1360.0,732.0
0.013,6,10,1983,5,910,3.0,642.0,642.0,5,1073,3.0,805.0,805.0
0.009,6,10,1989,5,910,2.0,642.0,642.0,5,1079,2.0,811.0,811.0
0.122,17,2,80,1,32,0.0,4.0,4.0,1,48,0.0,20.0,20.0
0.04,17,2,412,1,61,0.0,33.0,33.0,1,351,0.0,323.0,323.0
0.037,17,2,136,1,60,0.0,32.0,32.0,1,76,0.0,48.0,48.0
0.01,6,10,1989,5,910,2.0,642.0,642.0,5,1079,2.0,811.0,811.0
0.004,6,10,2000,5,927,1.0,659.0,659.0,5,1073,1.0,805.0,805.0
0.016,6,13,3735,7,497,2.0,125.0,125.0,6,3238,3.0,1470.0,1459.0
0.11,17,2,179,1,71,0.0,43.0,43.0,1,108,0.0,80.0,80.0
0.133,6,10,1506,5,395,30.0,127.0,127.0,5,1111,29.0,843.0,843.0
11.184,17,28,4399,14,2312,851.0,587.0,137.0,14,2087,851.0,270.0,121.0
0.038,17,4,284,2,120,0.0,32.0,32.0,2,164,35.0,60.0,54.0
0.005,6,10,1779,5,928,1.0,660.0,660.0,5,851,1.0,583.0,583.0
0.011,6,10,1989,5,910,2.0,642.0,642.0,5,1079,2.0,811.0,811.0
0.015,6,10,1989,5,910,3.0,642.0,642.0,5,1079,3.0,811.0,811.0
1777.961,17,144,41760,72,22752,25041.0,288.0,288.0,72,19008,25041.0,236.0,236.0
0.016,6,10,1762,5,911,3.0,643.0,643.0,5,851,4.0,583.0,583.0
0.374,17,49,27215,27,23976,14.0,1350.0,860.0,22,3239,14.0,1350.0,119.0
0.005,17,2,214,1,75,0.0,47.0,47.0,1,139,0.0,111.0,111.0
0.016,6,10,1990,5,911,3.0,643.0,643.0,5,1079,4.0,811.0,811.0
0.001,17,2,180,1,66,0.0,38.0,38.0,1,114,0.0,86.0,86.0
0.041,17,2,152,1,76,0.0,48.0,48.0,1,76,0.0,48.0,48.0
0.024,6,10,1989,5,910,5.0,642.0,642.0,5,1079,6.0,811.0,811.0
0.006,6,10,1989,5,927,1.0,659.0,659.0,5,1062,1.0,794.0,794.0
0.013,6,10,1972,5,910,3.0,642.0,642.0,5,1062,3.0,794.0,794.0
0.005,6,10,2006,5,927,1.0,659.0,659.0,5,1079,1.0,811.0,811.0
0.004,6,10,2006,5,927,1.0,659.0,659.0,5,1079,1.0,811.0,811.0
0.153,6,10,1506,5,395,30.0,127.0,127.0,5,1111,34.0,843.0,843.0
0.07,6,10,1506,5,395,16.0,127.0,127.0,5,1111,14.0,843.0,843.0
0.001,17,2,180,1,66,0.0,38.0,38.0,1,114,0.0,86.0,86.0
1758.448,6,466,66709,253,35232,6977.0,613.0,197.0,213,31477,8294.0,453.0,144.0
0.123,17,2,80,1,32,0.0,4.0,4.0,1,48,0.0,20.0,20.0
0.005,6,10,1779,5,928,1.0,660.0,660.0,5,851,1.0,583.0,583.0
0.005,6,10,1779,5,928,1.0,660.0,660.0,5,851,1.0,583.0,583.0
0.015,6,13,3735,7,497,2.0,125.0,125.0,6,3238,3.0,1470.0,1459.0
0.013,6,10,1677,5,827,3.0,559.0,559.0,5,850,3.0,582.0,582.0
0.042,17,2,182,1,65,0.0,37.0,37.0,1,117,0.0,89.0,89.0
0.011,6,10,1972,5,910,2.0,642.0,642.0,5,1062,2.0,794.0,794.0
0.004,17,2,152,1,76,0.0,48.0,48.0,1,76,0.0,48.0,48.0
0.009,6,10,1990,5,911,2.0,643.0,643.0,5,1079,2.0,811.0,811.0
0.004,6,10,1989,5,927,1.0,659.0,659.0,5,1062,1.0,794.0,794.0
0.015,6,10,1990,5,911,3.0,643.0,643.0,5,1079,3.0,811.0,811.0
0.006,17,2,214,1,75,0.0,47.0,47.0,1,139,0.0,111.0,111.0
172.08,17,76,10864,38,2533,4650.0,44.0,38.0,38,8331,4650.0,239.0,191.0
0.092,6,10,1506,5,395,20.0,127.0,127.0,5,1111,19.0,843.0,843.0
0.006,6,10,1547,5,764,1.0,496.0,496.0,5,783,1.0,515.0,515.0
0.003,17,2,136,1,60,0.0,32.0,32.0,1,76,0.0,48.0,48.0
308.477,17,20,1124,10,716,34267.0,48.0,43.0,10,408,34264.0,20.0,12.0
0.001,17,2,180,1,66,0.0,38.0,38.0,1,114,0.0,86.0,86.0
0.005,6,10,1689,5,839,1.0,571.0,571.0,5,850,1.0,582.0,582.0
0.009,6,10,1989,5,910,2.0,642.0,642.0,5,1079,2.0,811.0,811.0
0.011,6,10,1983,5,910,2.0,642.0,642.0,5,1073,2.0,805.0,805.0
0.005,6,10,1989,5,927,1.0,659.0,659.0,5,1062,1.0,794.0,794.0
0.006,17,2,168,1,76,0.0,48.0,48.0,1,92,0.0,64.0,64.0
0.099,6,10,1506,5,395,21.0,127.0,127.0,5,1111,20.0,843.0,843.0
300.343,6,16,2170,9,684,37521.0,146.0,146.0,7,1486,50028.0,419.0,398.0
0.005,6,13,3690,7,452,0.0,80.0,80.0,6,3238,0.0,1470.0,1459.0
0.01,6,10,1989,5,910,2.0,642.0,642.0,5,1079,2.0,811.0,811.0
40.083,17,10,676,5,460,10019.0,104.0,64.0,5,216,10019.0,20.0,15.0
0.004,17,2,148,1,60,0.0,32.0,32.0,1,88,0.0,60.0,60.0
40.073,17,10,676,5,460,10017.0,104.0,64.0,5,216,10017.0,20.0,15.0
11.139,17,28,4388,14,2311,848.0,586.0,137.0,14,2077,848.0,268.0,120.0
0.005,6,10,2006,5,927,1.0,659.0,659.0,5,1079,1.0,811.0,811.0
0.009,6,10,1983,5,910,2.0,642.0,642.0,5,1073,2.0,805.0,805.0
0.012,6,10,1677,5,827,2.0,559.0,559.0,5,850,3.0,582.0,582.0
0.015,6,14,3787,7,497,2.0,125.0,125.0,7,3290,2.0,1448.0,972.0
0.002,17,2,136,1,60,0.0,32.0,32.0,1,76,0.0,48.0,48.0
0.008,17,2,170,1,65,0.0,37.0,37.0,1,105,0.0,77.0,77.0
0.049,6,10,1762,5,911,12.0,643.0,643.0,5,851,12.0,583.0,583.0
0.001,17,2,180,1,66,0.0,38.0,38.0,1,114,0.0,86.0,86.0
0.01,6,10,1989,5,910,2.0,642.0,642.0,5,1079,2.0,811.0,811.0
0.167,6,10,1506,5,395,32.0,127.0,127.0,5,1111,39.0,843.0,843.0
0.008,6,12,1926,6,1189,1.0,659.0,434.0,6,737,1.0,417.0,417.0
0.006,6,10,2006,5,927,1.0,659.0,659.0,5,1079,1.0,811.0,811.0
0.015,6,10,1989,5,910,3.0,642.0,642.0,5,1079,3.0,811.0,811.0
0.014,6,10,1972,5,910,3.0,642.0,642.0,5,1062,3.0,794.0,794.0
1793.522,6,548,188050,277,162803,6498.0,2883.0,1016.0,271,25247,6642.0,388.0,111.0
40.054,17,10,676,5,460,10012.0,104.0,64.0,5,216,10012.0,20.0,15.0
0.007,6,10,1854,5,889,1.0,621.0,621.0,5,965,1.0,697.0,697.0
40.061,17,10,676,5,460,10014.0,104.0,64.0,5,216,10012.0,20.0,15.0
0.17,6,3,453,2,321,170.0,241.0,241.0,1,132,0.0,92.0,92.0
0.007,17,4,284,2,120,4.0,32.0,32.0,2,164,4.0,60.0,54.0
0.014,6,10,1990,5,911,3.0,643.0,643.0,5,1079,3.0,811.0,811.0
0.137,17,2,152,1,76,0.0,48.0,48.0,1,76,0.0,48.0,48.0
0.005,17,2,180,1,58,0.0,30.0,30.0,1,122,0.0,94.0,94.0
0.03,6,10,1989,5,910,7.0,642.0,642.0,5,1079,7.0,811.0,811.0
0.005,17,2,179,1,71,0.0,43.0,43.0,1,108,0.0,80.0,80.0
0.084,6,10,1506,5,395,18.0,127.0,127.0,5,1111,20.0,843.0,843.0
0.009,17,2,136,1,60,0.0,32.0,32.0,1,76,0.0,48.0,48.0
1799.724,17,2987,224751,1487,119043,1211.0,82.0,52.0,1500,105708,1200.0,226.0,42.0
0.071,6,10,1506,5,395,15.0,127.0,127.0,5,1111,16.0,843.0,843.0
0.003,17,2,152,1,76,0.0,48.0,48.0,1,76,0.0,48.0,48.0
0.004,6,10,2007,5,928,1.0,660.0,660.0,5,1079,1.0,811.0,811.0
0.004,17,2,136,1,60,0.0,32.0,32.0,1,76,0.0,48.0,48.0
0.006,6,10,1547,5,764,1.0,496.0,496.0,5,783,1.0,515.0,515.0
0.039,17,4,284,2,120,0.0,32.0,32.0,2,164,35.0,60.0,54.0
0.005,6,14,3799,7,509,0.0,137.0,137.0,7,3290,0.0,1448.0,972.0
354.064,6,19,1691,15,978,25290.0,190.0,190.0,4,713,80003.0,497.0,497.0
0.053,17,2,152,1,76,0.0,48.0,48.0,1,76,0.0,48.0,48.0
0.005,6,10,2006,5,927,1.0,659.0,659.0,5,1079,1.0,811.0,811.0
0.004,6,10,1989,5,927,1.0,659.0,659.0,5,1062,1.0,794.0,794.0
0.009,6,10,1677,5,827,2.0,559.0,559.0,5,850,2.0,582.0,582.0
0.166,6,10,1506,5,395,37.0,127.0,127.0,5,1111,40.0,843.0,843.0
0.004,17,2,148,1,60,0.0,32.0,32.0,1,88,0.0,60.0,60.0
0.001,17,2,136,1,60,0.0,32.0,32.0,1,76,0.0,48.0,48.0
0.07,6,10,1506,5,395,15.0,127.0,127.0,5,1111,15.0,843.0,843.0
1792.048,6,579,193457,295,165618,6095.0,2883.0,899.0,284,27839,6332.0,580.0,122.0
0.008,6,10,1762,5,911,2.0,643.0,643.0,5,851,1.0,583.0,583.0
15.075,17,15,9239,8,6902,2149.0,1350.0,834.0,7,2337,2507.0,1350.0,305.0
0.005,17,2,230,1,68,0.0,40.0,40.0,1,162,0.0,134.0,134.0
0.005,6,10,1643,5,860,1.0,592.0,592.0,5,783,1.0,515.0,515.0
0.006,6,10,1547,5,764,1.0,496.0,496.0,5,783,1.0,515.0,515.0
36.842,17,25,15195,14,12087,2834.0,1350.0,835.0,11,3108,3678.0,1350.0,254.0
0.077,6,10,1506,5,395,17.0,127.0,127.0,5,1111,16.0,843.0,843.0
300.357,6,33,11191,17,5429,18772.0,1368.0,646.0,16,5762,20023.0,1656.0,704.0
0.005,6,10,2000,5,927,1.0,659.0,659.0,5,1073,1.0,805.0,805.0
0.003,17,2,148,1,60,0.0,32.0,32.0,1,88,0.0,60.0,60.0
0.068,6,10,1506,5,395,14.0,127.0,127.0,5,1111,15.0,843.0,843.0
0.009,6,10,1990,5,911,2.0,643.0,643.0,5,1079,2.0,811.0,811.0
40.074,17,10,676,5,460,10016.0,104.0,64.0,5,216,10017.0,20.0,15.0
0.076,6,10,1506,5,395,18.0,127.0,127.0,5,1111,16.0,843.0,843.0
0.005,17,2,170,1,65,0.0,37.0,37.0,1,105,0.0,77.0,77.0
0.006,6,10,1689,5,839,1.0,571.0,571.0,5,850,1.0,582.0,582.0
0.006,6,10,1547,5,764,1.0,496.0,496.0,5,783,1.0,515.0,515.0
0.005,6,10,1689,5,839,1.0,571.0,571.0,5,850,1.0,582.0,582.0
0.009,17,2,162,1,65,0.0,37.0,37.0,1,97,0.0,69.0,69.0
310.269,17,19,1084,10,716,34453.0,48.0,43.0,9,368,38757.0,20.0,12.0
0.005,6,10,1774,5,923,1.0,655.0,655.0,5,851,1.0,583.0,583.0
0.171,17,2,152,1,76,0.0,48.0,48.0,1,76,0.0,48.0,48.0
0.009,6,10,1989,5,910,2.0,642.0,642.0,5,1079,2.0,811.0,811.0
0.13,6,10,1506,5,395,29.0,127.0,127.0,5,1111,32.0,843.0,843.0
0.009,6,10,1677,5,827,2.0,559.0,559.0,5,850,2.0,582.0,582.0
0.1,6,10,1506,5,395,15.0,127.0,127.0,5,1111,22.0,843.0,843.0
10.793,17,28,4422,14,1994,821.0,269.0,114.0,14,2428,821.0,587.0,145.0
0.005,6,10,1689,5,839,1.0,571.0,571.0,5,850,1.0,582.0,582.0
366.79,6,22,2879,9,1946,45848.0,494.0,494.0,13,933,30565.0,83.0,83.0
0.003,17,2,136,1,60,0.0,32.0,32.0,1,76,0.0,48.0,48.0
0.013,6,10,1972,5,910,3.0,642.0,642.0,5,1062,3.0,794.0,794.0
0.17,6,3,453,2,321,170.0,241.0,241.0,1,132,0.0,92.0,92.0
0.005,6,10,2000,5,927,1.0,659.0,659.0,5,1073,1.0,805.0,805.0
0.004,6,10,2006,5,927,1.0,659.0,659.0,5,1079,1.0,811.0,811.0
0.005,6,10,2007,5,928,1.0,660.0,660.0,5,1079,1.0,811.0,811.0
0.011,6,10,1983,5,910,2.0,642.0,642.0,5,1073,2.0,805.0,805.0
0.006,6,10,1547,5,764,1.0,496.0,496.0,5,783,1.0,515.0,515.0
0.126,6,10,1506,5,395,29.0,127.0,127.0,5,1111,25.0,843.0,843.0
0.005,6,14,3742,7,452,0.0,80.0,80.0,7,3290,0.0,1448.0,972.0
0.014,6,10,1983,5,910,3.0,642.0,642.0,5,1073,3.0,805.0,805.0
0.001,17,2,136,1,60,0.0,32.0,32.0,1,76,0.0,48.0,48.0
15.071,17,15,9239,8,6902,2148.0,1350.0,834.0,7,2337,2507.0,1350.0,305.0
371.072,6,22,2313,16,867,24738.0,195.0,195.0,6,1446,4636.0,419.0,398.0
0.006,6,10,1854,5,889,1.0,621.0,621.0,5,965,1.0,697.0,697.0
0.005,6,10,1989,5,927,1.0,659.0,659.0,5,1062,1.0,794.0,794.0
0.02,6,10,1702,5,863,5.0,595.0,595.0,5,839,5.0,571.0,571.0
0.019,6,10,1983,5,910,4.0,642.0,642.0,5,1073,4.0,805.0,805.0
0.077,6,10,1506,5,395,15.0,127.0,127.0,5,1111,18.0,843.0,843.0
0.004,17,2,148,1,60,0.0,32.0,32.0,1,88,0.0,60.0,60.0
0.084,6,10,1506,5,395,17.0,127.0,127.0,5,1111,17.0,843.0,843.0
0.005,6,10,2006,5,927,1.0,659.0,659.0,5,1079,1.0,811.0,811.0
0.004,6,10,1989,5,927,1.0,659.0,659.0,5,1062,1.0,794.0,794.0
0.221,6,16,2777,8,1395,31.0,533.0,323.0,8,1382,20.0,529.0,239.0
0.002,17,2,180,1,66,0.0,38.0,38.0,1,114,0.0,86.0,86.0
0.067,6,10,1506,5,395,14.0,127.0,127.0,5,1111,16.0,843.0,843.0
0.118,6,10,1506,5,395,27.0,127.0,127.0,5,1111,25.0,843.0,843.0
0.21,6,16,2777,8,1395,30.0,533.0,323.0,8,1382,19.0,529.0,239.0
0.005,6,10,2006,5,927,1.0,659.0,659.0,5,1079,1.0,811.0,811.0
0.012,6,10,1762,5,911,3.0,643.0,643.0,5,851,2.0,583.0,583.0
300.947,6,45,18737,24,13099,13084.0,2720.0,1345.0,21,5638,439.0,1360.0,398.0
0.09,6,10,1506,5,395,20.0,127.0,127.0,5,1111,19.0,843.0,843.0
0.067,17,8,3613,4,1874,22.0,1350.0,440.0,4,1739,11.0,1350.0,406.0
0.08,6,10,1506,5,395,19.0,127.0,127.0,5,1111,18.0,843.0,843.0
0.039,17,2,182,1,65,0.0,37.0,37.0,1,117,0.0,89.0,89.0
0.004,6,10,1774,5,923,1.0,655.0,655.0,5,851,1.0,583.0,583.0
0.004,17,2,148,1,60,0.0,32.0,32.0,1,88,0.0,60.0,60.0
0.016,6,10,1989,5,910,4.0,642.0,642.0,5,1079,3.0,811.0,811.0
0.001,17,2,180,1,66,0.0,38.0,38.0,1,114,0.0,86.0,86.0
0.006,17,2,169,1,62,0.0,34.0,34.0,1,107,0.0,79.0,79.0
0.169,17,2,152,1,76,0.0,48.0,48.0,1,76,0.0,48.0,48.0
0.017,6,10,1972,5,910,4.0,642.0,642.0,5,1062,4.0,794.0,794.0
0.127,6,10,1506,5,395,30.0,127.0,127.0,5,1111,31.0,843.0,843.0
0.005,6,10,1989,5,927,1.0,659.0,659.0,5,1062,1.0,794.0,794.0
0.086,6,10,1506,5,395,20.0,127.0,127.0,5,1111,19.0,843.0,843.0
40.075,17,10,676,5,460,10013.0,104.0,64.0,5,216,10015.0,20.0,15.0
0.134,17,2,80,1,32,0.0,4.0,4.0,1,48,0.0,20.0,20.0
0.005,6,10,1854,5,889,1.0,621.0,621.0,5,965,1.0,697.0,697.0
0.01,6,10,1983,5,910,2.0,642.0,642.0,5,1073,2.0,805.0,805.0
1786.535,6,154,19574,92,13852,19632.0,302.0,302.0,62,5722,29287.0,83.0,83.0
0.015,6,10,1972,5,910,3.0,642.0,642.0,5,1062,3.0,794.0,794.0
0.006,6,10,2006,5,927,1.0,659.0,659.0,5,1079,1.0,811.0,811.0
0.012,6,10,1990,5,911,3.0,643.0,643.0,5,1079,2.0,811.0,811.0
0.037,17,4,284,2,120,0.0,32.0,32.0,2,164,34.0,60.0,54.0
0.006,6,10,1547,5,764,1.0,496.0,496.0,5,783,1.0,515.0,515.0
0.005,6,10,2006,5,927,1.0,659.0,659.0,5,1079,1.0,811.0,811.0
0.099,6,10,1506,5,395,19.0,127.0,127.0,5,1111,24.0,843.0,843.0
0.012,6,10,1989,5,910,2.0,642.0,642.0,5,1079,2.0,811.0,811.0
0.005,6,10,2006,5,927,1.0,659.0,659.0,5,1079,1.0,811.0,811.0
0.001,17,2,180,1,66,0.0,38.0,38.0,1,114,0.0,86.0,86.0
0.072,6,10,1506,5,395,16.0,127.0,127.0,5,1111,14.0,843.0,843.0
0.017,6,10,1983,5,910,4.0,642.0,642.0,5,1073,4.0,805.0,805.0
0.004,6,10,2006,5,927,1.0,659.0,659.0,5,1079,1.0,811.0,811.0
0.013,6,10,1631,5,848,3.0,580.0,580.0,5,783,3.0,515.0,515.0
0.012,6,10,1762,5,911,2.0,643.0,643.0,5,851,2.0,583.0,583.0
0.001,17,2,180,1,66,0.0,38.0,38.0,1,114,0.0,86.0,86.0
0.005,17,2,170,1,65,0.0,37.0,37.0,1,105,0.0,77.0,77.0
0.006,6,10,1547,5,764,1.0,496.0,496.0,5,783,1.0,515.0,515.0
0.005,6,10,2006,5,927,1.0,659.0,659.0,5,1079,1.0,811.0,811.0
361.84,6,19,1688,15,978,25845.0,190.0,190.0,4,710,80015.0,494.0,494.0
0.006,6,10,1689,5,839,1.0,571.0,571.0,5,850,1.0,582.0,582.0
0.009,6,10,1989,5,910,2.0,642.0,642.0,5,1079,2.0,811.0,811.0
0.087,6,10,1506,5,395,19.0,127.0,127.0,5,1111,18.0,843.0,843.0
240.092,6,16,4480,9,963,30011.0,238.0,166.0,7,3517,40014.0,1402.0,786.0
0.026,17,2,230,1,68,0.0,40.0,40.0,1,162,0.0,134.0,134.0
0.006,6,10,1547,5,764,1.0,496.0,496.0,5,783,1.0,515.0,515.0
0.02,6,10,1972,5,910,4.0,642.0,642.0,5,1062,5.0,794.0,794.0
0.008,6,10,1972,5,910,1.0,642.0,642.0,5,1062,2.0,794.0,794.0
300.378,6,16,2170,9,684,37526.0,146.0,146.0,7,1486,50036.0,419.0,398.0
0.096,6,10,1506,5,395,21.0,127.0,127.0,5,1111,22.0,843.0,843.0
0.008,6,10,2006,5,927,2.0,659.0,659.0,5,1079,1.0,811.0,811.0
0.005,6,10,1643,5,860,1.0,592.0,592.0,5,783,1.0,515.0,515.0
0.008,6,10,1989,5,910,2.0,642.0,642.0,5,1079,2.0,811.0,811.0
0.124,17,4,284,2,120,0.0,32.0,32.0,2,164,86.0,60.0,54.0
0.006,6,10,1547,5,764,1.0,496.0,496.0,5,783,1.0,515.0,515.0
0.076,6,10,1506,5,395,17.0,127.0,127.0,5,1111,17.0,843.0,843.0
0.217,6,16,2777,8,1395,31.0,533.0,323.0,8,1382,19.0,529.0,239.0
10.957,17,28,4393,14,2312,834.0,587.0,137.0,14,2081,834.0,268.0,120.0
0.007,6,12,1698,6,863,1.0,327.0,271.0,6,835,1.0,515.0,515.0
0.008,17,2,179,1,71,0.0,43.0,43.0,1,108,0.0,80.0,80.0
0.005,6,10,1547,5,764,1.0,496.0,496.0,5,783,1.0,515.0,515.0
40.058,17,10,676,5,460,10012.0,104.0,64.0,5,216,10013.0,20.0,15.0
0.017,6,10,1631,5,848,4.0,580.0,580.0,5,783,4.0,515.0,515.0
9.039,17,6,376,5,280,2259.0,28.0,28.0,1,96,0.0,68.0,68.0
0.005,6,10,1989,5,927,1.0,659.0,659.0,5,1062,1.0,794.0,794.0
15.076,17,16,8517,8,6224,2149.0,1350.0,750.0,8,2293,2149.0,1350.0,258.0
0.001,17,2,180,1,66,0.0,38.0,38.0,1,114,0.0,86.0,86.0
0.015,17,2,152,1,56,0.0,28.0,28.0,1,96,0.0,68.0,68.0
0.005,6,10,2000,5,927,1.0,659.0,659.0,5,1073,1.0,805.0,805.0
0.005,17,2,170,1,65,0.0,37.0,37.0,1,105,0.0,77.0,77.0
0.219,6,16,2670,8,1396,31.0,533.0,324.0,8,1274,19.0,529.0,212.0
0.004,6,10,2000,5,927,1.0,659.0,659.0,5,1073,1.0,805.0,805.0
354.069,6,21,1795,16,1030,23604.0,190.0,190.0,5,765,60003.0,464.0,248.0
0.079,6,10,1506,5,395,17.0,127.0,127.0,5,1111,17.0,843.0,843.0
0.005,6,10,1989,5,927,1.0,659.0,659.0,5,1062,1.0,794.0,794.0
0.006,6,14,3799,7,509,1.0,137.0,137.0,7,3290,0.0,1448.0,972.0
0.096,6,10,1506,5,395,18.0,127.0,127.0,5,1111,22.0,843.0,843.0
0.007,6,10,1547,5,764,1.0,496.0,496.0,5,783,1.0,515.0,515.0
40.06,17,10,676,5,460,10013.0,104.0,64.0,5,216,10013.0,20.0,15.0
0.009,6,12,1926,6,1189,1.0,659.0,434.0,6,737,1.0,417.0,417.0
0.005,6,13,3747,7,509,0.0,137.0,137.0,6,3238,1.0,1470.0,1459.0
0.143,6,10,1506,5,395,33.0,127.0,127.0,5,1111,35.0,843.0,843.0
0.006,17,2,140,1,62,0.0,34.0,34.0,1,78,0.0,50.0,50.0
0.014,6,10,1989,5,910,3.0,642.0,642.0,5,1079,3.0,811.0,811.0
0.111,6,10,1506,5,395,27.0,127.0,127.0,5,1111,26.0,843.0,843.0
0.008,6,10,1972,5,910,2.0,642.0,642.0,5,1062,2.0,794.0,794.0
0.126,6,10,1506,5,395,28.0,127.0,127.0,5,1111,29.0,843.0,843.0
0.008,6,12,1926,6,1189,1.0,659.0,434.0,6,737,1.0,417.0,417.0
0.006,17,2,169,1,62,0.0,34.0,34.0,1,107,0.0,79.0,79.0
0.009,6,13,3735,7,497,1.0,125.0,125.0,6,3238,1.0,1470.0,1459.0
0.012,6,10,1990,5,911,3.0,643.0,643.0,5,1079,2.0,811.0,811.0
0.005,6,10,2000,5,927,1.0,659.0,659.0,5,1073,1.0,805.0,805.0
0.005,6,10,2006,5,927,1.0,659.0,659.0,5,1079,1.0,811.0,811.0
0.006,17,2,140,1,62,0.0,34.0,34.0,1,78,0.0,50.0,50.0
0.004,17,4,284,2,120,0.0,32.0,32.0,2,164,0.0,60.0,54.0
0.005,6,10,1689,5,839,1.0,571.0,571.0,5,850,1.0,582.0,582.0
240.09,6,16,4481,9,963,30011.0,238.0,166.0,7,3518,40014.0,1402.0,786.0
0.168,17,2,152,1,76,0.0,48.0,48.0,1,76,0.0,48.0,48.0
0.037,17,4,284,2,120,0.0,32.0,32.0,2,164,34.0,60.0,54.0
0.006,6,10,1643,5,860,1.0,592.0,592.0,5,783,1.0,515.0,515.0
0.171,6,3,453,2,321,171.0,241.0,241.0,1,132,0.0,92.0,92.0
0.005,6,13,3747,7,509,0.0,137.0,137.0,6,3238,1.0,1470.0,1459.0
40.106,17,10,676,5,460,10025.0,104.0,64.0,5,216,10025.0,20.0,15.0
0.004,6,10,1779,5,928,1.0,660.0,660.0,5,851,1.0,583.0,583.0
0.007,17,2,146,1,65,0.0,37.0,37.0,1,81,0.0,53.0,53.0
0.005,17,2,170,1,65,0.0,37.0,37.0,1,105,0.0,77.0,77.0
0.004,17,2,208,1,72,0.0,44.0,44.0,1,136,0.0,108.0,108.0
0.004,17,4,284,2,120,0.0,32.0,32.0,2,164,0.0,60.0,54.0
0.006,6,10,1547,5,764,1.0,496.0,496.0,5,783,1.0,515.0,515.0
0.137,6,10,1506,5,395,29.0,127.0,127.0,5,1111,30.0,843.0,843.0
0.038,17,2,136,1,60,0.0,32.0,32.0,1,76,0.0,48.0,48.0
0.004,6,10,2006,5,927,1.0,659.0,659.0,5,1079,1.0,811.0,811.0
240.024,6,9,787,5,488,60006.0,232.0,232.0,4,299,80006.0,83.0,83.0
0.007,17,2,179,1,71,0.0,43.0,43.0,1,108,0.0,80.0,80.0
0.008,17,2,170,1,65,0.0,37.0,37.0,1,105,0.0,77.0,77.0
300.185,6,27,7436,16,1409,20012.0,217.0,142.0,11,6027,24017.0,1679.0,778.0
0.006,17,2,180,1,66,0.0,38.0,38.0,1,114,0.0,86.0,86.0
293.457,6,378,347908,192,21556,1536.0,2736.0,889.0,186,326352,1586.0,4171.0,1841.0
0.006,6,10,1547,5,764,1.0,496.0,496.0,5,783,1.0,515.0,515.0
0.004,17,2,136,1,60,0.0,32.0,32.0,1,76,0.0,48.0,48.0
293.138,6,408,349024,202,22067,1458.0,2736.0,888.0,206,326957,1429.0,2804.0,1647.0
0.007,17,2,179,1,71,0.0,43.0,43.0,1,108,0.0,80.0,80.0
0.006,6,10,1547,5,764,1.0,496.0,496.0,5,783,1.0,515.0,515.0
0.096,6,10,1506,5,395,22.0,127.0,127.0,5,1111,23.0,843.0,843.0
0.024,6,10,1989,5,910,6.0,642.0,642.0,5,1079,5.0,811.0,811.0
0.148,6,10,1506,5,395,34.0,127.0,127.0,5,1111,36.0,843.0,843.0
0.011,6,10,1990,5,911,2.0,643.0,643.0,5,1079,2.0,811.0,811.0
0.025,6,10,1972,5,910,6.0,642.0,642.0,5,1062,6.0,794.0,794.0
0.005,6,14,3742,8,504,0.0,80.0,80.0,6,3238,0.0,1470.0,1459.0
0.005,17,2,169,1,62,0.0,34.0,34.0,1,107,0.0,79.0,79.0
0.005,6,10,1989,5,927,1.0,659.0,659.0,5,1062,1.0,794.0,794.0
0.006,6,10,1854,5,889,1.0,621.0,621.0,5,965,1.0,697.0,697.0
0.007,17,2,179,1,71,0.0,43.0,43.0,1,108,0.0,80.0,80.0
0.005,6,10,1854,5,889,1.0,621.0,621.0,5,965,1.0,697.0,697.0
0.005,6,10,1854,5,889,1.0,621.0,621.0,5,965,1.0,697.0,697.0
0.006,6,10,2007,5,928,1.0,660.0,660.0,5,1079,1.0,811.0,811.0
0.012,6,10,1989,5,910,3.0,642.0,642.0,5,1079,2.0,811.0,811.0
0.113,6,10,1506,5,395,25.0,127.0,127.0,5,1111,24.0,843.0,843.0
0.005,17,2,164,1,74,0.0,46.0,46.0,1,90,0.0,62.0,62.0
0.102,6,10,1506,5,395,22.0,127.0,127.0,5,1111,24.0,843.0,843.0
0.005,6,10,1779,5,928,1.0,660.0,660.0,5,851,1.0,583.0,583.0
0.005,6,10,2000,5,927,1.0,659.0,659.0,5,1073,1.0,805.0,805.0
0.09,6,10,1506,5,395,20.0,127.0,127.0,5,1111,20.0,843.0,843.0
0.019,6,10,1989,5,910,4.0,642.0,642.0,5,1079,4.0,811.0,811.0
0.082,6,10,1506,5,395,18.0,127.0,127.0,5,1111,19.0,843.0,843.0
0.009,6,10,1677,5,827,2.0,559.0,559.0,5,850,2.0,582.0,582.0
0.009,6,10,1989,5,910,2.0,642.0,642.0,5,1079,2.0,811.0,811.0
300.436,6,31,10172,17,2173,18777.0,468.0,256.0,14,7999,18494.0,1402.0,907.0
0.001,17,2,179,1,62,0.0,34.0,34.0,1,117,0.0,89.0,89.0
0.005,17,2,214,1,75,0.0,47.0,47.0,1,139,0.0,111.0,111.0
15.072,17,15,9238,8,6902,2149.0,1350.0,834.0,7,2336,2507.0,1350.0,305.0
0.163,6,10,1506,5,395,38.0,127.0,127.0,5,1111,35.0,843.0,843.0
0.01,6,10,1990,5,911,2.0,643.0,643.0,5,1079,2.0,811.0,811.0
0.005,17,2,169,1,62,0.0,34.0,34.0,1,107,0.0,79.0,79.0
0.003,17,2,136,1,60,0.0,32.0,32.0,1,76,0.0,48.0,48.0
40.068,17,10,676,5,460,10015.0,104.0,64.0,5,216,10016.0,20.0,15.0
0.006,6,10,1547,5,764,1.0,496.0,496.0,5,783,1.0,515.0,515.0
354.079,6,21,1795,16,1030,23605.0,190.0,190.0,5,765,60004.0,464.0,248.0
0.013,6,10,1631,5,848,3.0,580.0,580.0,5,783,3.0,515.0,515.0
0.013,6,14,3787,7,497,2.0,125.0,125.0,7,3290,2.0,1448.0,972.0
0.099,6,10,1506,5,395,21.0,127.0,127.0,5,1111,21.0,843.0,843.0
0.005,17,2,136,1,60,0.0,32.0,32.0,1,76,0.0,48.0,48.0
0.04,17,2,184,1,61,0.0,33.0,33.0,1,123,0.0,95.0,95.0
0.007,6,10,2007,5,928,1.0,660.0,660.0,5,1079,1.0,811.0,811.0
308.938,17,18,1008,9,640,38601.0,48.0,43.0,9,368,38601.0,20.0,12.0
0.004,17,2,136,1,60,0.0,32.0,32.0,1,76,0.0,48.0,48.0
0.024,6,10,1990,5,911,6.0,643.0,643.0,5,1079,5.0,811.0,811.0
0.011,6,10,1983,5,910,2.0,642.0,642.0,5,1073,2.0,805.0,805.0
0.005,6,10,2006,5,927,1.0,659.0,659.0,5,1079,1.0,811.0,811.0
484.249,6,41,15411,22,4231,23059.0,676.0,439.0,19,11180,23564.0,1402.0,925.0
15.339,17,48,25869,26,21269,612.0,1350.0,790.0,22,4600,729.0,1350.0,181.0
0.013,6,10,1989,5,910,3.0,642.0,642.0,5,1079,3.0,811.0,811.0
0.005,6,10,2006,5,927,1.0,659.0,659.0,5,1079,1.0,811.0,811.0
0.005,17,2,166,1,75,0.0,47.0,47.0,1,91,0.0,63.0,63.0
0.005,17,2,140,1,62,0.0,34.0,34.0,1,78,0.0,50.0,50.0
0.004,6,10,1779,5,928,1.0,660.0,660.0,5,851,1.0,583.0,583.0
0.005,6,10,1779,5,928,1.0,660.0,660.0,5,851,1.0,583.0,583.0
0.004,6,10,2006,5,927,1.0,659.0,659.0,5,1079,1.0,811.0,811.0
0.005,6,10,1989,5,927,1.0,659.0,659.0,5,1062,1.0,794.0,794.0
0.007,6,13,3735,7,497,1.0,125.0,125.0,6,3238,1.0,1470.0,1459.0
0.014,6,10,1989,5,910,3.0,642.0,642.0,5,1079,3.0,811.0,811.0
0.01,6,10,1989,5,910,2.0,642.0,642.0,5,1079,2.0,811.0,811.0
0.005,6,10,1989,5,927,1.0,659.0,659.0,5,1062,1.0,794.0,794.0
0.024,6,10,1990,5,911,6.0,643.0,643.0,5,1079,6.0,811.0,811.0
15.076,17,16,8826,8,6543,2149.0,1350.0,789.0,8,2283,2149.0,1350.0,257.0
11.133,17,28,4421,14,1994,844.0,269.0,114.0,14,2427,843.0,586.0,145.0
40.056,17,10,676,5,460,10013.0,104.0,64.0,5,216,10013.0,20.0,15.0
0.097,6,10,1506,5,395,22.0,127.0,127.0,5,1111,22.0,843.0,843.0
172.036,17,76,10980,38,2538,4649.0,44.0,38.0,38,8442,4649.0,239.0,194.0
0.004,17,2,148,1,60,0.0,32.0,32.0,1,88,0.0,60.0,60.0
0.112,6,10,1506,5,395,24.0,127.0,127.0,5,1111,23.0,843.0,843.0
0.014,6,10,1990,5,911,3.0,643.0,643.0,5,1079,3.0,811.0,811.0
0.011,6,10,1990,5,911,2.0,643.0,643.0,5,1079,2.0,811.0,811.0
40.057,17,10,676,5,460,10013.0,104.0,64.0,5,216,10013.0,20.0,15.0
0.015,6,10,1677,5,827,3.0,559.0,559.0,5,850,3.0,582.0,582.0
15.073,17,15,9238,8,6902,2149.0,1350.0,834.0,7,2336,2507.0,1350.0,305.0
0.005,6,10,1689,5,839,1.0,571.0,571.0,5,850,1.0,582.0,582.0
0.004,17,4,284,2,120,0.0,32.0,32.0,2,164,0.0,60.0,54.0
0.012,6,10,1972,5,910,3.0,642.0,642.0,5,1062,2.0,794.0,794.0
0.006,6,10,2007,5,928,1.0,660.0,660.0,5,1079,1.0,811.0,811.0
0.012,6,10,1972,5,910,3.0,642.0,642.0,5,1062,2.0,794.0,794.0
0.006,17,2,193,1,71,0.0,43.0,43.0,1,122,0.0,94.0,94.0
0.005,17,2,214,1,75,0.0,47.0,47.0,1,139,0.0,111.0,111.0
360.032,6,21,3981,13,3142,30002.0,494.0,494.0,8,839,51432.0,83.0,83.0
0.006,6,10,1854,5,889,1.0,621.0,621.0,5,965,1.0,697.0,697.0
0.019,6,10,1990,5,911,4.0,643.0,643.0,5,1079,4.0,811.0,811.0
0.005,6,13,3747,7,509,0.0,137.0,137.0,6,3238,0.0,1470.0,1459.0
0.004,6,10,1779,5,928,1.0,660.0,660.0,5,851,1.0,583.0,583.0
0.009,6,10,1983,5,910,2.0,642.0,642.0,5,1073,2.0,805.0,805.0
240.138,6,44,6758,21,3173,12006.0,588.0,230.0,23,3585,10915.0,580.0,238.0
0.005,6,10,2007,5,928,1.0,660.0,660.0,5,1079,1.0,811.0,811.0
0.052,17,2,152,1,76,0.0,48.0,48.0,1,76,0.0,48.0,48.0
0.004,17,4,284,2,120,0.0,32.0,32.0,2,164,0.0,60.0,54.0
0.01,6,13,3735,7,497,1.0,125.0,125.0,6,3238,1.0,1470.0,1459.0
0.018,6,10,1990,5,911,4.0,643.0,643.0,5,1079,4.0,811.0,811.0
0.001,17,2,142,1,63,0.0,35.0,35.0,1,79,0.0,51.0,51.0
1778.248,17,144,45504,72,22752,25045.0,288.0,288.0,72,22752,25045.0,288.0,288.0
0.021,6,10,1989,5,910,5.0,642.0,642.0,5,1079,5.0,811.0,811.0
0.012,6,10,1989,5,910,3.0,642.0,642.0,5,1079,2.0,811.0,811.0
0.006,6,10,1547,5,764,1.0,496.0,496.0,5,783,1.0,515.0,515.0
0.006,6,10,2006,5,927,1.0,659.0,659.0,5,1079,1.0,811.0,811.0
40.053,17,10,676,5,460,10012.0,104.0,64.0,5,216,10011.0,20.0,15.0
59.192,6,42,11502,21,5635,452.0,1360.0,793.0,21,5867,2951.0,2667.0,385.0
0.066,6,10,1506,5,395,13.0,127.0,127.0,5,1111,15.0,843.0,843.0
0.013,6,10,1677,5,827,3.0,559.0,559.0,5,850,3.0,582.0,582.0
0.077,6,10,1506,5,395,15.0,127.0,127.0,5,1111,15.0,843.0,843.0
0.098,6,10,1506,5,395,21.0,127.0,127.0,5,1111,21.0,843.0,843.0
1794.841,6,556,171263,283,144262,6364.0,2883.0,841.0,273,27001,6598.0,580.0,125.0
0.009,6,10,1989,5,910,2.0,642.0,642.0,5,1079,2.0,811.0,811.0
240.011,6,9,787,5,488,60002.0,232.0,232.0,4,299,80002.0,83.0,83.0
0.082,6,10,1506,5,395,18.0,127.0,127.0,5,1111,19.0,843.0,843.0
0.069,6,10,1506,5,395,14.0,127.0,127.0,5,1111,14.0,843.0,843.0
0.007,17,2,140,1,62,0.0,34.0,34.0,1,78,0.0,50.0,50.0
0.012,6,10,1972,5,910,3.0,642.0,642.0,5,1062,2.0,794.0,794.0
371.416,6,22,2313,16,867,24761.0,195.0,195.0,6,1446,4635.0,419.0,398.0
0.041,17,2,152,1,76,0.0,48.0,48.0,1,76,0.0,48.0,48.0
0.004,6,10,1989,5,927,1.0,659.0,659.0,5,1062,1.0,794.0,794.0
15.208,17,17,9628,9,6105,1897.0,1350.0,650.0,8,3523,2168.0,1350.0,412.0
0.038,17,4,284,2,120,1.0,32.0,32.0,2,164,34.0,60.0,54.0
0.012,6,10,1631,5,848,3.0,580.0,580.0,5,783,3.0,515.0,515.0
0.16,6,10,1506,5,395,33.0,127.0,127.0,5,1111,38.0,843.0,843.0
0.074,17,2,184,1,61,0.0,33.0,33.0,1,123,0.0,95.0,95.0
0.018,17,2,164,1,74,0.0,46.0,46.0,1,90,0.0,62.0,62.0
0.003,17,2,148,1,60,0.0,32.0,32.0,1,88,0.0,60.0,60.0
0.005,6,10,1989,5,927,1.0,659.0,659.0,5,1062,1.0,794.0,794.0
0.013,6,10,1989,5,910,3.0,642.0,642.0,5,1079,3.0,811.0,811.0
371.209,6,24,2405,17,919,23200.0,195.0,195.0,7,1486,3907.0,419.0,398.0
1797.664,17,2846,218025,1418,114858,1268.0,75.0,53.0,1428,103167,1259.0,227.0,44.0
0.072,17,4,364,2,160,0.0,52.0,52.0,2,204,0.0,80.0,74.0
0.004,17,2,164,1,74,0.0,46.0,46.0,1,90,0.0,62.0,62.0
0.008,17,2,136,1,60,0.0,32.0,32.0,1,76,0.0,48.0,48.0
0.111,6,10,1506,5,395,27.0,127.0,127.0,5,1111,24.0,843.0,843.0
0.093,6,10,1506,5,395,21.0,127.0,127.0,5,1111,22.0,843.0,843.0
40.058,17,10,676,5,460,10013.0,104.0,64.0,5,216,10013.0,20.0,15.0
0.008,6,10,1989,5,910,1.0,642.0,642.0,5,1079,2.0,811.0,811.0
0.01,6,10,1972,5,910,2.0,642.0,642.0,5,1062,2.0,794.0,794.0
0.024,6,10,1989,5,910,6.0,642.0,642.0,5,1079,5.0,811.0,811.0
0.004,6,10,2007,5,928,1.0,660.0,660.0,5,1079,1.0,811.0,811.0
0.001,17,2,180,1,66,0.0,38.0,38.0,1,114,0.0,86.0,86.0
0.004,6,10,2007,5,928,1.0,660.0,660.0,5,1079,1.0,811.0,811.0
0.003,6,10,1702,5,863,0.0,595.0,595.0,5,839,0.0,571.0,571.0
0.076,6,10,1506,5,395,14.0,127.0,127.0,5,1111,18.0,843.0,843.0
0.014,6,10,1972,5,910,3.0,642.0,642.0,5,1062,3.0,794.0,794.0
0.103,6,10,1506,5,395,23.0,127.0,127.0,5,1111,22.0,843.0,843.0
40.066,17,10,676,5,460,10014.0,104.0,64.0,5,216,10015.0,20.0,15.0
240.07,6,20,4874,11,941,24007.0,180.0,93.0,9,3933,30008.0,1593.0,576.0
0.002,17,2,180,1,66,0.0,38.0,38.0,1,114,0.0,86.0,86.0
40.079,17,10,676,5,460,10019.0,104.0,64.0,5,216,10019.0,20.0,15.0
0.022,6,10,1631,5,848,5.0,580.0,580.0,5,783,5.0,515.0,515.0
0.011,6,10,1972,5,910,2.0,642.0,642.0,5,1062,2.0,794.0,794.0
0.017,6,13,3735,7,497,2.0,125.0,125.0,6,3238,3.0,1470.0,1459.0
0.006,6,10,1547,5,764,1.0,496.0,496.0,5,783,1.0,515.0,515.0
0.008,6,10,1989,5,910,1.0,642.0,642.0,5,1079,2.0,811.0,811.0
0.482,17,2,144,1,64,0.0,36.0,36.0,1,80,0.0,52.0,52.0
0.081,6,10,1506,5,395,19.0,127.0,127.0,5,1111,19.0,843.0,843.0
0.004,6,10,2000,5,927,1.0,659.0,659.0,5,1073,1.0,805.0,805.0
0.01,17,2,148,1,60,0.0,32.0,32.0,1,88,0.0,60.0,60.0
0.003,17,2,136,1,60,0.0,32.0,32.0,1,76,0.0,48.0,48.0
0.012,6,10,1989,5,910,3.0,642.0,642.0,5,1079,3.0,811.0,811.0
0.001,17,2,136,1,60,0.0,32.0,32.0,1,76,0.0,48.0,48.0
0.012,6,10,1677,5,827,3.0,559.0,559.0,5,850,3.0,582.0,582.0
0.04,17,2,148,1,60,0.0,32.0,32.0,1,88,0.0,60.0,60.0
0.004,6,10,1702,5,863,0.0,595.0,595.0,5,839,1.0,571.0,571.0
0.066,17,8,3613,4,1874,22.0,1350.0,440.0,4,1739,11.0,1350.0,406.0
0.013,6,10,1631,5,848,3.0,580.0,580.0,5,783,3.0,515.0,515.0
0.076,6,10,1506,5,395,16.0,127.0,127.0,5,1111,15.0,843.0,843.0
0.014,6,10,1990,5,911,3.0,643.0,643.0,5,1079,3.0,811.0,811.0
0.006,6,10,1643,5,860,1.0,592.0,592.0,5,783,1.0,515.0,515.0
0.012,6,10,1990,5,911,2.0,643.0,643.0,5,1079,3.0,811.0,811.0
0.119,6,10,1506,5,395,20.0,127.0,127.0,5,1111,26.0,843.0,843.0
0.094,6,10,1506,5,395,21.0,127.0,127.0,5,1111,20.0,843.0,843.0
0.005,6,13,3747,7,509,0.0,137.0,137.0,6,3238,1.0,1470.0,1459.0
15.071,17,15,9238,8,6902,2149.0,1350.0,834.0,7,2336,2507.0,1350.0,305.0
40.085,17,10,676,5,460,10019.0,104.0,64.0,5,216,10020.0,20.0,15.0
0.005,6,13,3690,7,452,0.0,80.0,80.0,6,3238,1.0,1470.0,1459.0
308.706,17,20,1124,10,716,34286.0,48.0,43.0,10,408,34286.0,20.0,12.0
0.013,6,10,1989,5,927,3.0,659.0,659.0,5,1062,3.0,794.0,794.0
0.005,6,13,3747,7,509,0.0,137.0,137.0,6,3238,1.0,1470.0,1459.0
361.869,6,19,1689,15,978,25847.0,190.0,190.0,4,711,80014.0,495.0,495.0
0.003,17,2,152,1,76,0.0,48.0,48.0,1,76,0.0,48.0,48.0
0.005,6,10,1989,5,927,1.0,659.0,659.0,5,1062,1.0,794.0,794.0
0.006,6,10,1547,5,764,1.0,496.0,496.0,5,783,1.0,515.0,515.0
0.001,17,2,136,1,60,0.0,32.0,32.0,1,76,0.0,48.0,48.0
0.004,17,2,136,1,60,0.0,32.0,32.0,1,76,0.0,48.0,48.0
0.015,6,10,1990,5,911,3.0,643.0,643.0,5,1079,3.0,811.0,811.0
0.007,6,10,1689,5,839,1.0,571.0,571.0,5,850,1.0,582.0,582.0
11.099,17,28,4422,14,1994,841.0,269.0,114.0,14,2428,841.0,587.0,145.0
0.071,6,10,1506,5,395,16.0,127.0,127.0,5,1111,17.0,843.0,843.0
40.053,17,10,676,5,460,10012.0,104.0,64.0,5,216,10012.0,20.0,15.0
0.051,17,2,152,1,76,0.0,48.0,48.0,1,76,0.0,48.0,48.0
240.122,6,32,9620,16,7115,16008.0,2186.0,698.0,16,2505,16007.0,580.0,208.0
0.001,17,2,180,1,66,0.0,38.0,38.0,1,114,0.0,86.0,86.0
0.005,6,10,2007,5,928,1.0,660.0,660.0,5,1079,1.0,811.0,811.0
0.006,6,10,1547,5,764,1.0,496.0,496.0,5,783,1.0,515.0,515.0
0.023,6,10,1631,5,848,5.0,580.0,580.0,5,783,5.0,515.0,515.0
0.005,17,2,178,1,81,0.0,53.0,53.0,1,97,0.0,69.0,69.0
0.005,6,10,1779,5,928,1.0,660.0,660.0,5,851,1.0,583.0,583.0
0.013,6,10,1677,5,827,3.0,559.0,559.0,5,850,3.0,582.0,582.0
0.218,6,16,2670,8,1396,31.0,533.0,324.0,8,1274,19.0,529.0,212.0
40.064,17,10,676,5,460,10013.0,104.0,64.0,5,216,10015.0,20.0,15.0
0.005,6,10,2006,5,927,1.0,659.0,659.0,5,1079,1.0,811.0,811.0
0.005,6,10,1689,5,839,1.0,571.0,571.0,5,850,1.0,582.0,582.0
0.782,6,25,5459,12,1557,61.0,325.0,152.0,13,3902,55.0,1414.0,563.0
0.006,6,10,1547,5,764,1.0,496.0,496.0,5,783,1.0,515.0,515.0
0.004,6,10,2000,5,927,1.0,659.0,659.0,5,1073,1.0,805.0,805.0
11.157,17,28,4417,14,1993,845.0,268.0,114.0,14,2424,845.0,587.0,145.0
0.003,17,2,148,1,60,0.0,32.0,32.0,1,88,0.0,60.0,60.0
353.712,6,20,2210,6,1308,12007.0,494.0,494.0,14,902,27208.0,83.0,83.0
0.015,6,10,1990,5,911,3.0,643.0,643.0,5,1079,3.0,811.0,811.0
0.008,6,10,1689,5,839,2.0,571.0,571.0,5,850,2.0,582.0,582.0
0.004,17,2,148,1,60,0.0,32.0,32.0,1,88,0.0,60.0,60.0
0.005,17,2,164,1,74,0.0,46.0,46.0,1,90,0.0,62.0,62.0
0.017,6,10,1983,5,910,4.0,642.0,642.0,5,1073,4.0,805.0,805.0
280.233,6,23,6075,10,1186,31137.0,267.0,156.0,13,4889,23352.0,1400.0,873.0
1730.361,6,45,2790,30,1725,59667.0,35.0,35.0,15,1065,123588.0,31.0,31.0
0.015,6,10,1989,5,910,3.0,642.0,642.0,5,1079,3.0,811.0,811.0
0.005,6,10,2006,5,927,1.0,659.0,659.0,5,1079,1.0,811.0,811.0
0.005,6,10,2006,5,927,1.0,659.0,659.0,5,1079,1.0,811.0,811.0
0.004,17,2,148,1,60,0.0,32.0,32.0,1,88,0.0,60.0,60.0
178.068,17,80,11450,40,2659,4565.0,44.0,38.0,40,8791,4565.0,239.0,191.0
0.097,6,10,1506,5,395,23.0,127.0,127.0,5,1111,21.0,843.0,843.0
0.022,6,10,1989,5,910,5.0,642.0,642.0,5,1079,5.0,811.0,811.0
0.04,17,4,352,2,130,0.0,37.0,37.0,2,222,36.0,89.0,83.0
0.119,6,10,1506,5,395,26.0,127.0,127.0,5,1111,24.0,843.0,843.0
0.013,6,10,1990,5,911,3.0,643.0,643.0,5,1079,3.0,811.0,811.0
0.003,17,2,136,1,60,0.0,32.0,32.0,1,76,0.0,48.0,48.0
0.006,17,2,166,1,75,0.0,47.0,47.0,1,91,0.0,63.0,63.0
0.013,6,10,1631,5,848,3.0,580.0,580.0,5,783,3.0,515.0,515.0
0.006,6,10,2007,5,928,1.0,660.0,660.0,5,1079,1.0,811.0,811.0
0.005,6,10,2006,5,927,1.0,659.0,659.0,5,1079,1.0,811.0,811.0
0.008,6,10,1989,5,910,2.0,642.0,642.0,5,1079,2.0,811.0,811.0
0.005,6,10,2000,5,927,1.0,659.0,659.0,5,1073,1.0,805.0,805.0
0.017,6,10,1990,5,911,4.0,643.0,643.0,5,1079,4.0,811.0,811.0
0.012,6,10,1762,5,911,3.0,643.0,643.0,5,851,3.0,583.0,583.0
0.017,6,10,1983,5,910,4.0,642.0,642.0,5,1073,4.0,805.0,805.0
0.007,17,2,164,1,74,0.0,46.0,46.0,1,90,0.0,62.0,62.0
40.061,17,10,676,5,460,10013.0,104.0,64.0,5,216,10014.0,20.0,15.0
0.005,6,10,2007,5,928,1.0,660.0,660.0,5,1079,1.0,811.0,811.0
0.109,6,10,1506,5,395,24.0,127.0,127.0,5,1111,23.0,843.0,843.0
11.155,17,28,4416,14,1993,845.0,268.0,114.0,14,2423,845.0,586.0,145.0
0.197,6,10,1506,5,395,38.0,127.0,127.0,5,1111,47.0,843.0,843.0
0.005,6,10,2006,5,927,1.0,659.0,659.0,5,1079,1.0,811.0,811.0
0.014,6,10,1990,5,911,3.0,643.0,643.0,5,1079,3.0,811.0,811.0
0.005,6,10,1989,5,927,1.0,659.0,659.0,5,1062,1.0,794.0,794.0
0.071,17,2,170,1,65,0.0,37.0,37.0,1,105,0.0,77.0,77.0
0.014,6,10,1990,5,911,3.0,643.0,643.0,5,1079,3.0,811.0,811.0
0.001,17,2,178,1,81,0.0,53.0,53.0,1,97,0.0,69.0,69.0
308.522,17,20,1124,10,716,34265.0,48.0,43.0,10,408,34265.0,20.0,12.0
0.086,6,10,1506,5,395,19.0,127.0,127.0,5,1111,18.0,843.0,843.0
0.102,6,10,1506,5,395,23.0,127.0,127.0,5,1111,25.0,843.0,843.0
0.019,6,10,1990,5,911,4.0,643.0,643.0,5,1079,4.0,811.0,811.0
40.95,6,54,17529,29,11228,1462.0,1935.0,1253.0,25,6301,384.0,1360.0,311.0
0.034,6,10,1989,5,910,8.0,642.0,642.0,5,1079,8.0,811.0,811.0
40.058,17,10,676,5,460,10013.0,104.0,64.0,5,216,10013.0,20.0,15.0
0.008,6,12,1926,6,1189,1.0,659.0,434.0,6,737,1.0,417.0,417.0
0.184,17,4,596,2,122,144.0,33.0,33.0,2,474,144.0,323.0,209.0
40.061,17,10,676,5,460,10014.0,104.0,64.0,5,216,10014.0,20.0,15.0
0.007,6,10,1989,5,927,1.0,659.0,659.0,5,1062,1.0,794.0,794.0
0.004,17,2,152,1,76,0.0,48.0,48.0,1,76,0.0,48.0,48.0
0.011,6,10,1990,5,911,2.0,643.0,643.0,5,1079,2.0,811.0,811.0
0.006,6,12,1698,6,863,1.0,327.0,271.0,6,835,1.0,515.0,515.0
0.001,17,2,180,1,66,0.0,38.0,38.0,1,114,0.0,86.0,86.0
0.005,6,10,1689,5,839,1.0,571.0,571.0,5,850,1.0,582.0,582.0
0.006,6,10,1547,5,764,1.0,496.0,496.0,5,783,1.0,515.0,515.0
0.012,6,10,1989,5,910,2.0,642.0,642.0,5,1079,3.0,811.0,811.0
0.004,6,10,2006,5,927,1.0,659.0,659.0,5,1079,1.0,811.0,811.0
0.005,6,10,2000,5,927,1.0,659.0,659.0,5,1073,1.0,805.0,805.0
0.434,17,51,28768,27,22665,16.0,1350.0,811.0,24,6103,16.0,1350.0,226.0
0.004,6,10,2007,5,928,1.0,660.0,660.0,5,1079,1.0,811.0,811.0
0.005,6,10,2007,5,928,1.0,660.0,660.0,5,1079,1.0,811.0,811.0
1770.416,17,92,8096,46,4048,39342.0,60.0,60.0,46,4048,39342.0,60.0,60.0
0.065,6,10,1506,5,395,15.0,127.0,127.0,5,1111,14.0,843.0,843.0
0.039,17,2,412,1,61,0.0,33.0,33.0,1,351,0.0,323.0,323.0
0.01,6,12,1926,6,1189,2.0,659.0,434.0,6,737,2.0,417.0,417.0
0.006,6,10,1547,5,764,1.0,496.0,496.0,5,783,1.0,515.0,515.0
0.004,17,2,148,1,60,0.0,32.0,32.0,1,88,0.0,60.0,60.0
0.104,17,2,179,1,71,0.0,43.0,43.0,1,108,0.0,80.0,80.0
0.005,6,10,2006,5,927,1.0,659.0,659.0,5,1079,1.0,811.0,811.0
0.005,6,10,2007,5,928,1.0,660.0,660.0,5,1079,1.0,811.0,811.0
177.453,17,80,11270,40,2664,4549.0,44.0,38.0,40,8606,4550.0,239.0,187.0
0.011,6,10,1983,5,910,2.0,642.0,642.0,5,1073,2.0,805.0,805.0
0.004,6,10,2006,5,927,1.0,659.0,659.0,5,1079,1.0,811.0,811.0
0.016,6,10,1989,5,910,4.0,642.0,642.0,5,1079,4.0,811.0,811.0
0.013,6,10,1989,5,910,3.0,642.0,642.0,5,1079,3.0,811.0,811.0
361.77,6,21,1792,16,1030,24118.0,190.0,190.0,5,762,60010.0,461.0,247.0
0.005,17,2,180,1,58,0.0,30.0,30.0,1,122,0.0,94.0,94.0
0.082,6,10,1506,5,395,19.0,127.0,127.0,5,1111,19.0,843.0,843.0
0.012,6,10,1990,5,911,3.0,643.0,643.0,5,1079,3.0,811.0,811.0
240.273,6,45,8926,23,5802,10921.0,1515.0,509.0,22,3124,11441.0,580.0,219.0
0.091,6,10,1506,5,395,20.0,127.0,127.0,5,1111,21.0,843.0,843.0
0.004,17,2,136,1,60,0.0,32.0,32.0,1,76,0.0,48.0,48.0
40.06,17,10,676,5,460,10014.0,104.0,64.0,5,216,10014.0,20.0,15.0
0.001,17,2,180,1,66,0.0,38.0,38.0,1,114,0.0,86.0,86.0
0.004,6,10,2000,5,927,1.0,659.0,659.0,5,1073,1.0,805.0,805.0
0.038,17,4,420,2,122,0.0,33.0,33.0,2,298,34.0,145.0,121.0
0.003,17,2,148,1,60,0.0,32.0,32.0,1,88,0.0,60.0,60.0
40.073,17,10,676,5,460,10017.0,104.0,64.0,5,216,10017.0,20.0,15.0
0.012,6,10,1989,5,910,3.0,642.0,642.0,5,1079,2.0,811.0,811.0
0.121,6,10,1506,5,395,24.0,127.0,127.0,5,1111,28.0,843.0,843.0
0.018,6,10,1983,5,910,4.0,642.0,642.0,5,1073,4.0,805.0,805.0
0.004,6,10,2006,5,927,1.0,659.0,659.0,5,1079,1.0,811.0,811.0
0.009,6,10,1983,5,910,2.0,642.0,642.0,5,1073,2.0,805.0,805.0
15.203,17,37,20133,21,17034,758.0,1350.0,783.0,16,3099,1011.0,1350.0,165.0
0.009,6,12,1926,6,1189,1.0,659.0,434.0,6,737,1.0,417.0,417.0
0.097,6,10,1506,5,395,23.0,127.0,127.0,5,1111,18.0,843.0,843.0
0.165,17,2,152,1,76,0.0,48.0,48.0,1,76,0.0,48.0,48.0
0.005,6,10,1774,5,923,1.0,655.0,655.0,5,851,1.0,583.0,583.0
0.006,6,10,1547,5,764,1.0,496.0,496.0,5,783,1.0,515.0,515.0
0.015,17,2,198,1,91,0.0,63.0,63.0,1,107,0.0,79.0,79.0
0.038,17,2,166,1,75,0.0,47.0,47.0,1,91,0.0,63.0,63.0
0.16,6,10,1506,5,395,23.0,127.0,127.0,5,1111,37.0,843.0,843.0
0.009,6,10,1989,5,910,2.0,642.0,642.0,5,1079,2.0,811.0,811.0
0.006,17,2,144,1,64,0.0,36.0,36.0,1,80,0.0,52.0,52.0
0.004,17,2,148,1,60,0.0,32.0,32.0,1,88,0.0,60.0,60.0
0.005,6,10,2007,5,928,1.0,660.0,660.0,5,1079,1.0,811.0,811.0
0.005,6,10,1689,5,839,1.0,571.0,571.0,5,850,1.0,582.0,582.0
0.053,17,2,170,1,65,0.0,37.0,37.0,1,105,0.0,77.0,77.0
40.057,17,10,676,5,460,10013.0,104.0,64.0,5,216,10013.0,20.0,15.0
0.169,17,2,152,1,76,0.0,48.0,48.0,1,76,0.0,48.0,48.0
0.005,17,2,180,1,58,0.0,30.0,30.0,1,122,0.0,94.0,94.0
0.097,6,10,1506,5,395,21.0,127.0,127.0,5,1111,20.0,843.0,843.0
0.09,6,10,1506,5,395,21.0,127.0,127.0,5,1111,18.0,843.0,843.0
0.005,6,10,2006,5,927,1.0,659.0,659.0,5,1079,1.0,811.0,811.0
0.052,17,2,152,1,76,0.0,48.0,48.0,1,76,0.0,48.0,48.0
0.024,6,10,1989,5,910,5.0,642.0,642.0,5,1079,5.0,811.0,811.0
0.005,6,10,2007,5,928,1.0,660.0,660.0,5,1079,1.0,811.0,811.0
0.105,6,10,1506,5,395,25.0,127.0,127.0,5,1111,21.0,843.0,843.0
10.856,17,28,4423,14,1995,827.0,270.0,114.0,14,2428,826.0,587.0,145.0
0.066,6,10,1506,5,395,14.0,127.0,127.0,5,1111,15.0,843.0,843.0
0.012,6,10,1989,5,910,2.0,642.0,642.0,5,1079,3.0,811.0,811.0
0.005,6,10,2007,5,928,1.0,660.0,660.0,5,1079,1.0,811.0,811.0
0.116,6,10,1506,5,395,25.0,127.0,127.0,5,1111,25.0,843.0,843.0
0.005,17,2,214,1,75,0.0,47.0,47.0,1,139,0.0,111.0,111.0
0.134,17,2,136,1,60,0.0,32.0,32.0,1,76,0.0,48.0,48.0
0.006,17,2,230,1,68,0.0,40.0,40.0,1,162,0.0,134.0,134.0
0.019,6,10,1972,5,910,4.0,642.0,642.0,5,1062,4.0,794.0,794.0
300.296,6,113,79855,62,18411,4922.0,2736.0,1517.0,51,61444,6005.0,3119.0,1729.0
0.107,6,10,1506,5,395,24.0,127.0,127.0,5,1111,22.0,843.0,843.0
300.392,6,78,66955,40,2508,7702.0,507.0,219.0,38,64447,226.0,3304.0,1850.0
40.054,17,10,676,5,460,10012.0,104.0,64.0,5,216,10012.0,20.0,15.0
0.005,6,10,2000,5,927,1.0,659.0,659.0,5,1073,1.0,805.0,805.0
0.011,6,10,1972,5,910,2.0,642.0,642.0,5,1062,2.0,794.0,794.0
240.093,6,16,4480,9,963,30011.0,238.0,166.0,7,3517,40015.0,1402.0,786.0
0.006,6,10,2006,5,927,1.0,659.0,659.0,5,1079,1.0,811.0,811.0
0.013,6,10,1983,5,910,3.0,642.0,642.0,5,1073,3.0,805.0,805.0
40.086,17,10,676,5,460,10020.0,104.0,64.0,5,216,10020.0,20.0,15.0
0.008,6,10,1983,5,910,1.0,642.0,642.0,5,1073,2.0,805.0,805.0
0.01,6,10,1631,5,848,2.0,580.0,580.0,5,783,2.0,515.0,515.0
240.19,6,31,9467,15,7026,17156.0,2150.0,694.0,16,2441,16010.0,580.0,200.0
0.005,17,2,164,1,74,0.0,46.0,46.0,1,90,0.0,62.0,62.0
0.005,6,10,2007,5,928,1.0,660.0,660.0,5,1079,1.0,811.0,811.0
0.006,6,10,1547,5,764,1.0,496.0,496.0,5,783,1.0,515.0,515.0
0.017,6,13,3735,7,497,2.0,125.0,125.0,6,3238,3.0,1470.0,1459.0
0.013,6,10,1990,5,911,3.0,643.0,643.0,5,1079,3.0,811.0,811.0
0.008,6,10,1983,5,910,2.0,642.0,642.0,5,1073,2.0,805.0,805.0
0.005,6,10,1989,5,927,1.0,659.0,659.0,5,1062,1.0,794.0,794.0
1758.465,6,488,69577,261,35864,6763.0,613.0,192.0,227,33713,7780.0,613.0,151.0
0.007,17,2,170,1,65,0.0,37.0,37.0,1,105,0.0,77.0,77.0
40.098,17,10,676,5,460,10018.0,104.0,64.0,5,216,10022.0,20.0,15.0
40.057,17,10,676,5,460,10013.0,104.0,64.0,5,216,10013.0,20.0,15.0
0.102,6,10,1506,5,395,21.0,127.0,127.0,5,1111,19.0,843.0,843.0
0.006,6,14,3799,7,509,0.0,137.0,137.0,7,3290,0.0,1448.0,972.0
0.053,17,2,152,1,76,0.0,48.0,48.0,1,76,0.0,48.0,48.0
240.087,6,16,4481,9,963,30010.0,238.0,166.0,7,3518,40014.0,1402.0,786.0
773.691,6,41,7341,20,5494,25279.0,494.0,494.0,21,1847,38684.0,83.0,83.0
0.006,6,10,1689,5,839,1.0,571.0,571.0,5,850,1.0,582.0,582.0
0.001,17,2,180,1,66,0.0,38.0,38.0,1,114,0.0,86.0,86.0
0.124,6,10,1506,5,395,29.0,127.0,127.0,5,1111,26.0,843.0,843.0
0.005,6,10,1989,5,927,1.0,659.0,659.0,5,1062,1.0,794.0,794.0
371.566,6,22,2313,16,867,24771.0,195.0,195.0,6,1446,4643.0,419.0,398.0
0.001,17,2,180,1,66,0.0,38.0,38.0,1,114,0.0,86.0,86.0
0.081,6,10,1506,5,395,18.0,127.0,127.0,5,1111,18.0,843.0,843.0
0.165,17,2,152,1,76,0.0,48.0,48.0,1,76,0.0,48.0,48.0
308.373,17,20,1124,10,716,34250.0,48.0,43.0,10,408,34250.0,20.0,12.0
0.09,6,10,1506,5,395,21.0,127.0,127.0,5,1111,20.0,843.0,843.0
0.009,6,10,1972,5,910,2.0,642.0,642.0,5,1062,2.0,794.0,794.0
285.164,6,29,6508,16,1421,19010.0,517.0,290.0,13,5087,23763.0,2377.0,1103.0
40.058,17,10,676,5,460,10013.0,104.0,64.0,5,216,10013.0,20.0,15.0
0.005,17,2,160,1,72,0.0,44.0,44.0,1,88,0.0,60.0,60.0
0.008,6,10,1972,5,910,2.0,642.0,642.0,5,1062,2.0,794.0,794.0
0.005,6,10,2000,5,927,1.0,659.0,659.0,5,1073,1.0,805.0,805.0
0.005,6,10,2007,5,928,1.0,660.0,660.0,5,1079,1.0,811.0,811.0
0.014,6,10,1972,5,910,3.0,642.0,642.0,5,1062,3.0,794.0,794.0
0.009,6,10,1989,5,910,2.0,642.0,642.0,5,1079,2.0,811.0,811.0
0.006,6,13,3747,7,509,1.0,137.0,137.0,6,3238,1.0,1470.0,1459.0
0.001,17,2,180,1,66,0.0,38.0,38.0,1,114,0.0,86.0,86.0
0.015,6,10,1972,5,910,3.0,642.0,642.0,5,1062,3.0,794.0,794.0
240.107,6,16,4482,9,963,30013.0,238.0,166.0,7,3519,40017.0,1402.0,786.0
0.08,6,10,1506,5,395,15.0,127.0,127.0,5,1111,16.0,843.0,843.0
352.266,6,20,2210,6,1308,12004.0,494.0,494.0,14,902,27097.0,83.0,83.0
0.004,6,10,1702,5,863,0.0,595.0,595.0,5,839,1.0,571.0,571.0
0.006,6,10,2007,5,928,1.0,660.0,660.0,5,1079,1.0,811.0,811.0
0.005,6,10,1547,5,764,1.0,496.0,496.0,5,783,1.0,515.0,515.0
0.072,17,4,420,2,122,0.0,33.0,33.0,2,298,32.0,145.0,121.0
0.004,6,10,2006,5,927,1.0,659.0,659.0,5,1079,1.0,811.0,811.0
0.005,17,2,166,1,75,0.0,47.0,47.0,1,91,0.0,63.0,63.0
300.423,6,16,2170,9,684,37531.0,146.0,146.0,7,1486,50041.0,419.0,398.0
0.278,17,45,25705,25,21220,11.0,1350.0,820.0,20,4485,11.0,1350.0,196.0
0.013,6,11,1729,6,879,2.0,559.0,559.0,5,850,3.0,582.0,582.0
0.005,17,2,144,1,64,0.0,36.0,36.0,1,80,0.0,52.0,52.0
0.04,17,2,170,1,65,0.0,37.0,37.0,1,105,0.0,77.0,77.0
0.023,6,10,1989,5,910,5.0,642.0,642.0,5,1079,5.0,811.0,811.0
0.017,6,10,1989,5,910,4.0,642.0,642.0,5,1079,4.0,811.0,811.0
0.068,6,10,1506,5,395,15.0,127.0,127.0,5,1111,14.0,843.0,843.0
0.003,6,10,1702,5,863,0.0,595.0,595.0,5,839,0.0,571.0,571.0
0.008,6,10,1854,5,889,2.0,621.0,621.0,5,965,1.0,697.0,697.0
0.006,6,10,1774,5,923,1.0,655.0,655.0,5,851,1.0,583.0,583.0
40.056,17,10,676,5,460,10011.0,104.0,64.0,5,216,10013.0,20.0,15.0
0.021,6,10,1989,5,910,5.0,642.0,642.0,5,1079,5.0,811.0,811.0
0.005,6,10,2007,5,928,1.0,660.0,660.0,5,1079,1.0,811.0,811.0
0.103,6,10,1506,5,395,24.0,127.0,127.0,5,1111,22.0,843.0,843.0
0.004,17,2,166,1,75,0.0,47.0,47.0,1,91,0.0,63.0,63.0
697.544,6,43,14060,23,4895,31706.0,1273.0,525.0,20,9165,33552.0,1926.0,676.0
0.004,6,10,1702,5,863,1.0,595.0,595.0,5,839,0.0,571.0,571.0
0.004,17,2,136,1,60,0.0,32.0,32.0,1,76,0.0,48.0,48.0
172.412,17,68,9552,34,2268,5224.0,44.0,38.0,34,7284,5224.0,239.0,186.0
0.095,6,10,1506,5,395,20.0,127.0,127.0,5,1111,18.0,843.0,843.0
0.039,17,2,148,1,60,0.0,32.0,32.0,1,88,0.0,60.0,60.0
0.006,6,10,1854,5,889,1.0,621.0,621.0,5,965,1.0,697.0,697.0
0.005,6,10,1702,5,863,1.0,595.0,595.0,5,839,1.0,571.0,571.0
0.01,6,10,1689,5,839,2.0,571.0,571.0,5,850,2.0,582.0,582.0
0.004,17,4,284,2,120,0.0,32.0,32.0,2,164,1.0,60.0,54.0
240.395,6,44,8823,22,5738,11447.0,1368.0,458.0,22,3085,11447.0,580.0,241.0
0.005,17,2,140,1,62,0.0,34.0,34.0,1,78,0.0,50.0,50.0
0.005,6,10,1774,5,923,1.0,655.0,655.0,5,851,1.0,583.0,583.0
0.015,6,10,1972,5,910,3.0,642.0,642.0,5,1062,3.0,794.0,794.0
0.02,6,10,1677,5,827,5.0,559.0,559.0,5,850,4.0,582.0,582.0
0.005,6,10,1774,5,923,1.0,655.0,655.0,5,851,1.0,583.0,583.0
0.006,17,2,427,1,129,0.0,101.0,101.0,1,298,0.0,270.0,270.0
10.796,17,28,4418,14,1994,822.0,269.0,114.0,14,2424,822.0,587.0,145.0
0.01,6,10,1677,5,827,2.0,559.0,559.0,5,850,2.0,582.0,582.0
0.007,6,10,1989,5,910,1.0,642.0,642.0,5,1079,1.0,811.0,811.0
0.005,6,10,2006,5,927,1.0,659.0,659.0,5,1079,1.0,811.0,811.0
0.1,6,10,1506,5,395,22.0,127.0,127.0,5,1111,17.0,843.0,843.0
40.054,17,10,676,5,460,10012.0,104.0,64.0,5,216,10012.0,20.0,15.0
0.04,17,2,154,1,69,0.0,41.0,41.0,1,85,0.0,57.0,57.0
11.274,17,28,4422,14,1995,854.0,270.0,114.0,14,2427,854.0,586.0,145.0
1773.085,6,551,187131,282,163027,6309.0,2883.0,951.0,269,24104,6615.0,332.0,101.0
0.008,6,10,1989,5,910,2.0,642.0,642.0,5,1079,1.0,811.0,811.0
1.138,6,32,13391,18,5892,66.0,2720.0,854.0,14,7499,72.0,2720.0,769.0
21.842,6,46,18081,23,12134,410.0,2720.0,1397.0,23,5947,985.0,2667.0,385.0
312.464,17,18,1008,9,640,39042.0,48.0,43.0,9,368,39042.0,20.0,12.0
0.008,6,10,1972,5,910,2.0,642.0,642.0,5,1062,2.0,794.0,794.0
0.001,17,2,136,1,60,0.0,32.0,32.0,1,76,0.0,48.0,48.0
0.006,6,10,2007,5,928,1.0,660.0,660.0,5,1079,1.0,811.0,811.0
0.006,6,12,1698,6,863,1.0,327.0,271.0,6,835,1.0,515.0,515.0
0.007,6,10,1990,5,911,1.0,643.0,643.0,5,1079,1.0,811.0,811.0
0.122,6,10,1506,5,395,27.0,127.0,127.0,5,1111,29.0,843.0,843.0
1727.922,6,45,2790,30,1725,59583.0,35.0,35.0,15,1065,123417.0,31.0,31.0
0.011,6,10,1989,5,910,2.0,642.0,642.0,5,1079,2.0,811.0,811.0
0.005,17,2,144,1,64,0.0,36.0,36.0,1,80,0.0,52.0,52.0
0.088,6,10,1506,5,395,19.0,127.0,127.0,5,1111,19.0,843.0,843.0
0.006,6,10,2006,5,927,1.0,659.0,659.0,5,1079,1.0,811.0,811.0
574.19,6,61,26100,32,4723,18522.0,663.0,435.0,29,21377,18362.0,1402.0,945.0
0.004,6,10,2000,5,927,1.0,659.0,659.0,5,1073,1.0,805.0,805.0
0.04,17,2,148,1,60,0.0,32.0,32.0,1,88,0.0,60.0,60.0
300.324,6,16,2170,9,684,37519.0,146.0,146.0,7,1486,50026.0,419.0,398.0
0.085,6,10,1506,5,395,19.0,127.0,127.0,5,1111,19.0,843.0,843.0
0.003,17,4,284,2,120,0.0,32.0,32.0,2,164,0.0,60.0,54.0
0.008,6,12,1926,6,1189,1.0,659.0,434.0,6,737,1.0,417.0,417.0
0.005,17,2,148,1,60,0.0,32.0,32.0,1,88,0.0,60.0,60.0
0.006,6,10,1689,5,839,1.0,571.0,571.0,5,850,1.0,582.0,582.0
0.001,17,2,179,1,62,0.0,34.0,34.0,1,117,0.0,89.0,89.0
125.664,6,26,9525,12,1627,77.0,794.0,367.0,14,7898,9656.0,1360.0,732.0
0.007,6,10,1547,5,764,1.0,496.0,496.0,5,783,1.0,515.0,515.0
0.094,6,10,1506,5,395,16.0,127.0,127.0,5,1111,20.0,843.0,843.0
0.109,6,10,1506,5,395,23.0,127.0,127.0,5,1111,22.0,843.0,843.0
0.005,17,2,214,1,75,0.0,47.0,47.0,1,139,0.0,111.0,111.0
0.006,17,2,170,1,65,0.0,37.0,37.0,1,105,0.0,77.0,77.0
0.001,17,2,166,1,75,0.0,47.0,47.0,1,91,0.0,63.0,63.0
0.005,6,10,2006,5,927,1.0,659.0,659.0,5,1079,1.0,811.0,811.0
0.016,6,10,1989,5,910,4.0,642.0,642.0,5,1079,3.0,811.0,811.0
0.005,6,10,2000,5,927,1.0,659.0,659.0,5,1073,1.0,805.0,805.0
0.014,6,10,1989,5,910,3.0,642.0,642.0,5,1079,3.0,811.0,811.0
0.046,6,13,3816,7,578,7.0,206.0,206.0,6,3238,9.0,1470.0,1459.0
0.085,6,10,1506,5,395,19.0,127.0,127.0,5,1111,17.0,843.0,843.0
0.004,17,2,166,1,75,0.0,47.0,47.0,1,91,0.0,63.0,63.0
0.005,6,10,2000,5,927,1.0,659.0,659.0,5,1073,1.0,805.0,805.0
0.053,17,2,152,1,76,0.0,48.0,48.0,1,76,0.0,48.0,48.0
0.074,6,10,1506,5,395,15.0,127.0,127.0,5,1111,16.0,843.0,843.0
0.005,17,2,169,1,62,0.0,34.0,34.0,1,107,0.0,79.0,79.0
331.805,17,20,1124,10,716,36852.0,48.0,43.0,10,408,36853.0,20.0,12.0
0.005,6,10,2007,5,928,1.0,660.0,660.0,5,1079,1.0,811.0,811.0
0.005,6,10,1989,5,927,1.0,659.0,659.0,5,1062,1.0,794.0,794.0
0.005,6,10,2006,5,927,1.0,659.0,659.0,5,1079,1.0,811.0,811.0
0.009,6,10,1990,5,911,2.0,643.0,643.0,5,1079,2.0,811.0,811.0
40.079,17,10,676,5,460,10017.0,104.0,64.0,5,216,10018.0,20.0,15.0
0.005,17,2,248,1,58,0.0,30.0,30.0,1,190,0.0,162.0,162.0
0.004,6,10,1779,5,928,1.0,660.0,660.0,5,851,1.0,583.0,583.0
0.005,6,10,1854,5,889,1.0,621.0,621.0,5,965,1.0,697.0,697.0
0.008,6,10,1677,5,827,2.0,559.0,559.0,5,850,2.0,582.0,582.0
0.004,6,10,1774,5,923,1.0,655.0,655.0,5,851,1.0,583.0,583.0
40.094,17,10,676,5,460,10020.0,104.0,64.0,5,216,10022.0,20.0,15.0
0.012,6,10,1990,5,911,3.0,643.0,643.0,5,1079,2.0,811.0,811.0
52.373,6,36,8190,18,1719,538.0,651.0,322.0,18,6471,3072.0,2720.0,478.0
0.107,6,10,1506,5,395,22.0,127.0,127.0,5,1111,25.0,843.0,843.0
0.052,17,2,152,1,76,0.0,48.0,48.0,1,76,0.0,48.0,48.0
0.059,17,2,80,1,32,0.0,4.0,4.0,1,48,0.0,20.0,20.0
0.039,17,2,170,1,65,0.0,37.0,37.0,1,105,0.0,77.0,77.0
0.005,6,10,1779,5,928,1.0,660.0,660.0,5,851,1.0,583.0,583.0
0.008,6,12,1926,6,1189,1.0,659.0,434.0,6,737,1.0,417.0,417.0
0.02,6,10,1972,5,910,4.0,642.0,642.0,5,1062,4.0,794.0,794.0
0.011,17,2,146,1,65,0.0,37.0,37.0,1,81,0.0,53.0,53.0
0.175,17,2,152,1,76,0.0,48.0,48.0,1,76,0.0,48.0,48.0
0.012,6,14,3787,7,497,2.0,125.0,125.0,7,3290,1.0,1448.0,972.0
0.004,6,10,2006,5,927,1.0,659.0,659.0,5,1079,1.0,811.0,811.0
0.003,17,2,136,1,60,0.0,32.0,32.0,1,76,0.0,48.0,48.0
0.01,6,12,1926,6,1189,2.0,659.0,434.0,6,737,2.0,417.0,417.0
0.011,6,10,1631,5,848,2.0,580.0,580.0,5,783,2.0,515.0,515.0
0.013,6,10,1983,5,910,3.0,642.0,642.0,5,1073,3.0,805.0,805.0
0.006,6,10,1547,5,764,1.0,496.0,496.0,5,783,1.0,515.0,515.0
0.011,6,10,1989,5,910,2.0,642.0,642.0,5,1079,2.0,811.0,811.0
0.091,6,10,1506,5,395,18.0,127.0,127.0,5,1111,21.0,843.0,843.0
40.077,17,10,676,5,460,10018.0,104.0,64.0,5,216,10018.0,20.0,15.0
300.34,6,16,2170,9,684,37521.0,146.0,146.0,7,1486,50028.0,419.0,398.0
0.015,6,10,1972,5,910,3.0,642.0,642.0,5,1062,3.0,794.0,794.0
0.015,6,10,1989,5,910,3.0,642.0,642.0,5,1079,3.0,811.0,811.0
0.015,6,10,1989,5,910,3.0,642.0,642.0,5,1079,3.0,811.0,811.0
0.005,6,10,1547,5,764,1.0,496.0,496.0,5,783,1.0,515.0,515.0
0.012,6,10,1972,5,910,3.0,642.0,642.0,5,1062,2.0,794.0,794.0
0.008,6,12,1926,6,1189,1.0,659.0,434.0,6,737,1.0,417.0,417.0
0.011,6,10,1989,5,910,2.0,642.0,642.0,5,1079,2.0,811.0,811.0
0.088,6,10,1506,5,395,17.0,127.0,127.0,5,1111,20.0,843.0,843.0
0.096,6,10,1506,5,395,21.0,127.0,127.0,5,1111,19.0,843.0,843.0
0.086,6,10,1506,5,395,19.0,127.0,127.0,5,1111,18.0,843.0,843.0
0.005,17,2,193,1,71,0.0,43.0,43.0,1,122,0.0,94.0,94.0
0.011,6,10,1762,5,911,2.0,643.0,643.0,5,851,2.0,583.0,583.0
368.448,6,22,2313,16,867,24563.0,195.0,195.0,6,1446,4644.0,419.0,398.0
0.001,17,2,166,1,75,0.0,47.0,47.0,1,91,0.0,63.0,63.0
0.005,6,13,3747,7,509,0.0,137.0,137.0,6,3238,1.0,1470.0,1459.0
0.12,6,10,1506,5,395,28.0,127.0,127.0,5,1111,26.0,843.0,843.0
0.022,6,13,3735,7,497,3.0,125.0,125.0,6,3238,4.0,1470.0,1459.0
0.005,6,10,1774,5,923,1.0,655.0,655.0,5,851,1.0,583.0,583.0
0.004,6,10,2006,5,927,1.0,659.0,659.0,5,1079,1.0,811.0,811.0
9.037,17,6,376,5,280,2259.0,28.0,28.0,1,96,0.0,68.0,68.0
240.075,6,21,4925,11,941,24007.0,180.0,93.0,10,3984,26674.0,1592.0,576.0
149.616,6,22,8496,12,2236,73.0,1345.0,574.0,10,6260,16605.0,2720.0,974.0
0.006,17,2,179,1,71,0.0,43.0,43.0,1,108,0.0,80.0,80.0
0.013,17,2,152,1,56,0.0,28.0,28.0,1,96,0.0,68.0,68.0
0.004,17,2,144,1,64,0.0,36.0,36.0,1,80,0.0,52.0,52.0
0.108,6,10,1506,5,395,23.0,127.0,127.0,5,1111,17.0,843.0,843.0
240.361,6,29,12010,15,5987,17168.0,1908.0,1042.0,14,6023,18489.0,1656.0,881.0
0.016,6,10,1989,5,910,3.0,642.0,642.0,5,1079,3.0,811.0,811.0
0.01,6,10,1677,5,827,2.0,559.0,559.0,5,850,2.0,582.0,582.0
0.018,6,10,1989,5,910,4.0,642.0,642.0,5,1079,4.0,811.0,811.0
0.071,6,10,1506,5,395,15.0,127.0,127.0,5,1111,17.0,843.0,843.0
40.063,17,10,676,5,460,10012.0,104.0,64.0,5,216,10015.0,20.0,15.0
0.01,6,10,1989,5,910,2.0,642.0,642.0,5,1079,2.0,811.0,811.0
57.395,6,35,16385,19,8144,3188.0,2720.0,1050.0,16,8241,3814.0,2720.0,948.0
301.216,6,56,28101,30,22034,10386.0,2720.0,1485.0,26,6067,361.0,2667.0,385.0
0.005,6,10,1989,5,927,1.0,659.0,659.0,5,1062,1.0,794.0,794.0
0.009,6,10,1990,5,911,2.0,643.0,643.0,5,1079,2.0,811.0,811.0
0.005,17,2,179,1,71,0.0,43.0,43.0,1,108,0.0,80.0,80.0
40.055,17,10,676,5,460,10012.0,104.0,64.0,5,216,10013.0,20.0,15.0
0.006,6,10,1547,5,764,1.0,496.0,496.0,5,783,1.0,515.0,515.0
0.013,6,10,1972,5,910,3.0,642.0,642.0,5,1062,3.0,794.0,794.0
0.011,6,10,1983,5,910,2.0,642.0,642.0,5,1073,2.0,805.0,805.0
0.107,6,10,1506,5,395,23.0,127.0,127.0,5,1111,20.0,843.0,843.0
0.038,17,2,136,1,60,0.0,32.0,32.0,1,76,0.0,48.0,48.0
0.004,17,2,136,1,60,0.0,32.0,32.0,1,76,0.0,48.0,48.0
0.005,6,10,1643,5,860,1.0,592.0,592.0,5,783,1.0,515.0,515.0
240.035,6,9,787,5,488,60008.0,232.0,232.0,4,299,80010.0,83.0,83.0
0.009,6,10,1972,5,910,2.0,642.0,642.0,5,1062,2.0,794.0,794.0
10.929,17,28,4423,14,1994,831.0,269.0,114.0,14,2429,831.0,588.0,145.0
240.244,6,39,5255,19,2377,13346.0,580.0,195.0,20,2878,12644.0,564.0,261.0
0.005,6,10,2006,5,927,1.0,659.0,659.0,5,1079,1.0,811.0,811.0
0.005,6,10,1547,5,764,1.0,496.0,496.0,5,783,1.0,515.0,515.0
0.013,17,4,350,2,124,8.0,34.0,34.0,2,226,8.0,91.0,85.0
0.004,6,10,2000,5,927,1.0,659.0,659.0,5,1073,1.0,805.0,805.0
0.039,17,4,284,2,120,0.0,32.0,32.0,2,164,0.0,60.0,54.0
0.007,17,2,179,1,71,0.0,43.0,43.0,1,108,0.0,80.0,80.0
0.003,17,2,148,1,60,0.0,32.0,32.0,1,88,0.0,60.0,60.0
0.008,6,10,1677,5,827,2.0,559.0,559.0,5,850,2.0,582.0,582.0
0.005,6,10,2006,5,927,1.0,659.0,659.0,5,1079,1.0,811.0,811.0
0.146,6,10,1506,5,395,34.0,127.0,127.0,5,1111,34.0,843.0,843.0
1798.831,6,238,46263,114,33840,15918.0,2479.0,996.0,124,12423,14624.0,580.0,62.0
167.05,17,68,9710,34,2267,5062.0,44.0,38.0,34,7443,5062.0,239.0,190.0
0.72,6,25,5459,12,1557,57.0,325.0,152.0,13,3902,51.0,1414.0,563.0
0.005,17,2,144,1,64,0.0,36.0,36.0,1,80,0.0,52.0,52.0
0.038,17,2,136,1,60,0.0,32.0,32.0,1,76,0.0,48.0,48.0
0.005,17,2,170,1,65,0.0,37.0,37.0,1,105,0.0,77.0,77.0
0.074,6,10,1506,5,395,16.0,127.0,127.0,5,1111,17.0,843.0,843.0
40.09,17,10,676,5,460,10019.0,104.0,64.0,5,216,10021.0,20.0,15.0
0.009,6,12,1926,6,1189,1.0,659.0,434.0,6,737,1.0,417.0,417.0
0.01,6,10,1990,5,911,2.0,643.0,643.0,5,1079,2.0,811.0,811.0
0.039,17,2,412,1,61,0.0,33.0,33.0,1,351,0.0,323.0,323.0
0.006,6,10,1643,5,860,1.0,592.0,592.0,5,783,1.0,515.0,515.0
0.103,6,10,1506,5,395,23.0,127.0,127.0,5,1111,23.0,843.0,843.0
0.001,17,2,180,1,66,0.0,38.0,38.0,1,114,0.0,86.0,86.0
0.009,6,10,1972,5,910,2.0,642.0,642.0,5,1062,2.0,794.0,794.0
0.009,6,10,1989,5,910,2.0,642.0,642.0,5,1079,2.0,811.0,811.0
0.011,6,10,1989,5,910,2.0,642.0,642.0,5,1079,2.0,811.0,811.0
0.004,17,4,284,2,120,0.0,32.0,32.0,2,164,1.0,60.0,54.0
0.067,6,10,1506,5,395,14.0,127.0,127.0,5,1111,15.0,843.0,843.0
0.083,17,2,144,1,64,0.0,36.0,36.0,1,80,0.0,52.0,52.0
0.001,17,2,180,1,66,0.0,38.0,38.0,1,114,0.0,86.0,86.0
0.004,6,10,2006,5,927,1.0,659.0,659.0,5,1079,1.0,811.0,811.0
0.005,17,2,144,1,64,0.0,36.0,36.0,1,80,0.0,52.0,52.0
0.012,6,13,3735,7,497,1.0,125.0,125.0,6,3238,2.0,1470.0,1459.0
10.744,17,26,4168,13,1867,886.0,270.0,115.0,13,2301,886.0,588.0,149.0
0.004,6,10,2007,5,928,1.0,660.0,660.0,5,1079,1.0,811.0,811.0
0.005,17,2,180,1,58,0.0,30.0,30.0,1,122,0.0,94.0,94.0
0.009,6,10,1972,5,910,2.0,642.0,642.0,5,1062,2.0,794.0,794.0
0.005,6,10,1989,5,927,1.0,659.0,659.0,5,1062,1.0,794.0,794.0
173.357,17,80,11278,40,2660,4444.0,44.0,38.0,40,8618,4444.0,239.0,187.0
0.012,6,10,1990,5,911,3.0,643.0,643.0,5,1079,2.0,811.0,811.0
0.068,17,8,3613,4,1874,22.0,1350.0,440.0,4,1739,12.0,1350.0,406.0
0.009,6,10,1989,5,910,2.0,642.0,642.0,5,1079,2.0,811.0,811.0
0.139,6,10,1506,5,395,33.0,127.0,127.0,5,1111,31.0,843.0,843.0
10.955,17,28,4390,14,2312,834.0,587.0,137.0,14,2078,834.0,269.0,120.0
0.019,6,14,3787,7,497,3.0,125.0,125.0,7,3290,3.0,1448.0,972.0
0.091,17,2,144,1,64,0.0,36.0,36.0,1,80,0.0,52.0,52.0
0.005,6,10,2000,5,927,1.0,659.0,659.0,5,1073,1.0,805.0,805.0
0.006,17,2,230,1,68,0.0,40.0,40.0,1,162,0.0,134.0,134.0
0.004,6,10,2007,5,928,1.0,660.0,660.0,5,1079,1.0,811.0,811.0
40.056,17,10,676,5,460,10012.0,104.0,64.0,5,216,10013.0,20.0,15.0
0.013,6,10,1990,5,911,3.0,643.0,643.0,5,1079,3.0,811.0,811.0
0.012,6,10,1989,5,910,3.0,642.0,642.0,5,1079,3.0,811.0,811.0
0.007,6,10,2006,5,927,1.0,659.0,659.0,5,1079,1.0,811.0,811.0
40.068,17,10,676,5,460,10014.0,104.0,64.0,5,216,10016.0,20.0,15.0
40.076,17,10,676,5,460,10015.0,104.0,64.0,5,216,10017.0,20.0,15.0
0.006,6,10,1547,5,764,1.0,496.0,496.0,5,783,1.0,515.0,515.0
0.005,17,2,144,1,64,0.0,36.0,36.0,1,80,0.0,52.0,52.0
0.01,6,10,1990,5,911,2.0,643.0,643.0,5,1079,2.0,811.0,811.0
11.392,17,28,4395,14,2312,863.0,587.0,137.0,14,2083,863.0,270.0,120.0
0.005,17,2,140,1,62,0.0,34.0,34.0,1,78,0.0,50.0,50.0
0.076,17,4,364,2,160,1.0,52.0,52.0,2,204,29.0,80.0,74.0
0.012,6,10,1983,5,910,3.0,642.0,642.0,5,1073,2.0,805.0,805.0
0.013,17,2,152,1,56,0.0,28.0,28.0,1,96,0.0,68.0,68.0
0.006,6,10,1547,5,764,1.0,496.0,496.0,5,783,1.0,515.0,515.0
65.986,6,27,17543,15,9603,4713.0,2804.0,1469.0,12,7940,5983.0,2311.0,1218.0
0.087,6,10,1506,5,395,19.0,127.0,127.0,5,1111,19.0,843.0,843.0
0.088,6,10,1506,5,395,18.0,127.0,127.0,5,1111,21.0,843.0,843.0
0.079,6,10,1506,5,395,17.0,127.0,127.0,5,1111,18.0,843.0,843.0
0.006,6,10,1547,5,764,1.0,496.0,496.0,5,783,1.0,515.0,515.0
0.055,6,10,1506,5,395,12.0,127.0,127.0,5,1111,13.0,843.0,843.0
0.224,6,10,1506,5,395,55.0,127.0,127.0,5,1111,50.0,843.0,843.0
0.006,6,10,1547,5,764,1.0,496.0,496.0,5,783,1.0,515.0,515.0
1777.97,17,144,45504,72,22752,25041.0,288.0,288.0,72,22752,25041.0,288.0,288.0
1.77,6,35,6671,19,3451,98.0,1103.0,204.0,16,3220,110.0,1796.0,396.0
0.006,6,10,1643,5,860,1.0,592.0,592.0,5,783,1.0,515.0,515.0
0.017,6,10,1990,5,911,4.0,643.0,643.0,5,1079,4.0,811.0,811.0
0.002,17,2,180,1,66,0.0,38.0,38.0,1,114,0.0,86.0,86.0
0.107,6,10,1506,5,395,25.0,127.0,127.0,5,1111,25.0,843.0,843.0
0.012,6,10,1989,5,910,3.0,642.0,642.0,5,1079,3.0,811.0,811.0
0.006,17,2,214,1,75,0.0,47.0,47.0,1,139,0.0,111.0,111.0
240.027,6,9,787,5,488,60006.0,232.0,232.0,4,299,80007.0,83.0,83.0
0.003,17,2,148,1,60,0.0,32.0,32.0,1,88,0.0,60.0,60.0
0.006,6,10,1547,5,764,1.0,496.0,496.0,5,783,1.0,515.0,515.0
0.001,17,2,180,1,66,0.0,38.0,38.0,1,114,0.0,86.0,86.0
0.116,6,10,1506,5,395,26.0,127.0,127.0,5,1111,27.0,843.0,843.0
361.825,6,21,1793,16,1030,24121.0,190.0,190.0,5,763,60010.0,462.0,247.0
0.087,6,10,1506,5,395,19.0,127.0,127.0,5,1111,20.0,843.0,843.0
0.11,6,10,1506,5,395,25.0,127.0,127.0,5,1111,26.0,843.0,843.0
0.006,6,13,3747,7,509,1.0,137.0,137.0,6,3238,1.0,1470.0,1459.0
360.045,6,21,3981,13,3142,30003.0,494.0,494.0,8,839,51434.0,83.0,83.0
0.003,17,2,132,1,58,0.0,30.0,30.0,1,74,0.0,46.0,46.0
0.005,17,2,168,1,76,0.0,48.0,48.0,1,92,0.0,64.0,64.0
0.006,6,10,1547,5,764,1.0,496.0,496.0,5,783,1.0,515.0,515.0
0.082,6,10,1506,5,395,18.0,127.0,127.0,5,1111,16.0,843.0,843.0
0.005,17,2,166,1,75,0.0,47.0,47.0,1,91,0.0,63.0,63.0
40.089,17,10,676,5,460,10018.0,104.0,64.0,5,216,10021.0,20.0,15.0
0.077,6,10,1506,5,395,14.0,127.0,127.0,5,1111,17.0,843.0,843.0
174.137,17,74,10699,37,2466,4836.0,44.0,38.0,37,8233,4837.0,261.0,194.0
0.09,6,10,1506,5,395,20.0,127.0,127.0,5,1111,17.0,843.0,843.0
0.071,17,4,284,2,120,0.0,32.0,32.0,2,164,30.0,60.0,54.0
0.009,6,10,1762,5,911,2.0,643.0,643.0,5,851,2.0,583.0,583.0
0.042,17,4,284,2,120,0.0,32.0,32.0,2,164,39.0,60.0,54.0
0.014,6,10,1990,5,911,3.0,643.0,643.0,5,1079,3.0,811.0,811.0
0.005,6,10,2007,5,928,1.0,660.0,660.0,5,1079,1.0,811.0,811.0
0.345,17,43,20872,22,17091,16.0,1350.0,748.0,21,3781,15.0,1350.0,152.0
0.009,6,10,1989,5,910,2.0,642.0,642.0,5,1079,2.0,811.0,811.0
0.111,6,10,1506,5,395,24.0,127.0,127.0,5,1111,24.0,843.0,843.0
0.001,17,2,180,1,66,0.0,38.0,38.0,1,114,0.0,86.0,86.0
0.01,6,10,1990,5,911,2.0,643.0,643.0,5,1079,2.0,811.0,811.0
0.133,6,10,1506,5,395,31.0,127.0,127.0,5,1111,27.0,843.0,843.0
0.006,6,10,2000,5,927,1.0,659.0,659.0,5,1073,1.0,805.0,805.0
0.004,17,4,284,2,120,0.0,32.0,32.0,2,164,0.0,60.0,54.0
0.038,17,2,152,1,76,0.0,48.0,48.0,1,76,0.0,48.0,48.0
0.013,6,10,1990,5,911,3.0,643.0,643.0,5,1079,3.0,811.0,811.0
40.053,17,10,676,5,460,10012.0,104.0,64.0,5,216,10012.0,20.0,15.0
0.011,6,10,1990,5,911,2.0,643.0,643.0,5,1079,2.0,811.0,811.0
0.014,6,10,1972,5,910,3.0,642.0,642.0,5,1062,3.0,794.0,794.0
0.074,6,10,1506,5,395,17.0,127.0,127.0,5,1111,15.0,843.0,843.0
0.01,6,10,1972,5,910,2.0,642.0,642.0,5,1062,2.0,794.0,794.0
0.005,17,2,170,1,65,0.0,37.0,37.0,1,105,0.0,77.0,77.0
0.035,17,2,152,1,76,0.0,48.0,48.0,1,76,0.0,48.0,48.0
0.005,6,10,2000,5,927,1.0,659.0,659.0,5,1073,1.0,805.0,805.0
0.072,6,10,1506,5,395,15.0,127.0,127.0,5,1111,16.0,843.0,843.0
0.026,6,10,1983,5,910,6.0,642.0,642.0,5,1073,6.0,805.0,805.0
1.071,6,10,1690,6,1336,214.0,1084.0,1084.0,4,354,277.0,182.0,182.0
0.137,6,10,1506,5,395,32.0,127.0,127.0,5,1111,18.0,843.0,843.0
0.012,6,10,1989,5,910,3.0,642.0,642.0,5,1079,3.0,811.0,811.0
0.014,6,10,1972,5,910,3.0,642.0,642.0,5,1062,3.0,794.0,794.0
0.019,6,10,1983,5,910,4.0,642.0,642.0,5,1073,4.0,805.0,805.0
1729.207,6,60,4400,40,2740,44338.0,33.0,33.0,20,1660,91002.0,31.0,31.0
0.125,6,10,1506,5,395,24.0,127.0,127.0,5,1111,28.0,843.0,843.0
0.005,6,13,3684,7,446,0.0,74.0,74.0,6,3238,0.0,1470.0,1459.0
0.009,6,10,1989,5,910,2.0,642.0,642.0,5,1079,2.0,811.0,811.0
0.161,6,177,234884,73,4972,2.0,525.0,389.0,104,229912,1.0,4206.0,2200.0
0.005,6,10,2006,5,927,1.0,659.0,659.0,5,1079,1.0,811.0,811.0
0.172,6,10,1506,5,395,36.0,127.0,127.0,5,1111,41.0,843.0,843.0
0.04,17,2,148,1,60,0.0,32.0,32.0,1,88,0.0,60.0,60.0
0.01,6,10,1972,5,910,2.0,642.0,642.0,5,1062,2.0,794.0,794.0
0.001,17,2,180,1,66,0.0,38.0,38.0,1,114,0.0,86.0,86.0
40.063,17,10,676,5,460,10012.0,104.0,64.0,5,216,10014.0,20.0,15.0
0.005,6,10,2000,5,927,1.0,659.0,659.0,5,1073,1.0,805.0,805.0
0.146,6,10,1506,5,395,35.0,127.0,127.0,5,1111,35.0,843.0,843.0
0.072,6,10,1506,5,395,15.0,127.0,127.0,5,1111,16.0,843.0,843.0
0.005,6,10,2006,5,927,1.0,659.0,659.0,5,1079,1.0,811.0,811.0
0.015,6,10,1983,5,910,3.0,642.0,642.0,5,1073,3.0,805.0,805.0
1780.263,6,64,7361,42,4485,43421.0,1641.0,109.0,22,2876,84766.0,1112.0,82.0
0.004,6,10,1702,5,863,1.0,595.0,595.0,5,839,1.0,571.0,571.0
0.012,6,10,1990,5,911,3.0,643.0,643.0,5,1079,3.0,811.0,811.0
0.013,17,2,152,1,56,0.0,28.0,28.0,1,96,0.0,68.0,68.0
0.016,6,10,1762,5,911,4.0,643.0,643.0,5,851,3.0,583.0,583.0
0.005,6,10,2000,5,927,1.0,659.0,659.0,5,1073,1.0,805.0,805.0
0.001,17,2,140,1,62,0.0,34.0,34.0,1,78,0.0,50.0,50.0
0.015,6,10,1989,5,910,3.0,642.0,642.0,5,1079,3.0,811.0,811.0
0.009,6,12,1926,6,1189,1.0,659.0,434.0,6,737,1.0,417.0,417.0
240.268,6,44,8823,22,5738,11441.0,1368.0,458.0,22,3085,11441.0,580.0,241.0
240.098,6,16,4481,9,963,30012.0,238.0,166.0,7,3518,40015.0,1402.0,786.0
0.015,6,14,3787,7,497,2.0,125.0,125.0,7,3290,2.0,1448.0,972.0
0.01,6,10,1989,5,910,2.0,642.0,642.0,5,1079,2.0,811.0,811.0
15.078,17,15,8122,8,6062,2150.0,1350.0,729.0,7,2060,2508.0,1350.0,266.0
0.005,6,10,2000,5,927,1.0,659.0,659.0,5,1073,1.0,805.0,805.0
0.013,6,10,1989,5,910,3.0,642.0,642.0,5,1079,3.0,811.0,811.0
0.119,6,10,1506,5,395,23.0,127.0,127.0,5,1111,25.0,843.0,843.0
0.004,17,2,136,1,60,0.0,32.0,32.0,1,76,0.0,48.0,48.0
0.038,17,2,182,1,65,0.0,37.0,37.0,1,117,0.0,89.0,89.0
0.004,6,10,2006,5,927,1.0,659.0,659.0,5,1079,1.0,811.0,811.0
0.008,6,10,1774,5,923,2.0,655.0,655.0,5,851,2.0,583.0,583.0
11.201,17,28,4421,14,1993,849.0,268.0,114.0,14,2428,849.0,587.0,145.0
40.052,17,10,676,5,460,10012.0,104.0,64.0,5,216,10012.0,20.0,15.0
0.089,6,10,1506,5,395,19.0,127.0,127.0,5,1111,20.0,843.0,843.0
0.001,17,2,180,1,66,0.0,38.0,38.0,1,114,0.0,86.0,86.0
0.005,6,10,2006,5,927,1.0,659.0,659.0,5,1079,1.0,811.0,811.0
0.013,6,10,1990,5,911,3.0,643.0,643.0,5,1079,3.0,811.0,811.0
0.005,6,10,1989,5,927,1.0,659.0,659.0,5,1062,1.0,794.0,794.0
300.417,6,16,2170,9,684,37531.0,146.0,146.0,7,1486,50041.0,419.0,398.0
0.087,6,10,1506,5,395,21.0,127.0,127.0,5,1111,15.0,843.0,843.0
0.006,6,10,1547,5,764,1.0,496.0,496.0,5,783,1.0,515.0,515.0
0.005,6,10,1689,5,839,1.0,571.0,571.0,5,850,1.0,582.0,582.0
0.005,6,10,1547,5,764,1.0,496.0,496.0,5,783,1.0,515.0,515.0
0.754,6,10,2009,6,1655,150.0,1403.0,1403.0,4,354,173.0,182.0,182.0
10.894,17,28,4418,14,1994,829.0,269.0,114.0,14,2424,829.0,587.0,145.0
0.0,17,2,136,1,60,0.0,32.0,32.0,1,76,0.0,48.0,48.0
0.008,17,2,140,1,62,0.0,34.0,34.0,1,78,0.0,50.0,50.0
10.359,6,21,6206,12,1229,941.0,517.0,201.0,9,4977,1293.0,1402.0,750.0
1756.117,6,105,6270,60,3525,29764.0,27.0,27.0,45,2745,39910.0,27.0,27.0
1777.745,17,144,45504,72,22752,25036.0,288.0,288.0,72,22752,25037.0,288.0,288.0
308.758,17,20,1124,10,716,34292.0,48.0,43.0,10,408,34292.0,20.0,12.0
15.22,17,47,24609,25,21211,633.0,1350.0,820.0,22,3398,723.0,1350.0,126.0
0.011,6,10,1990,5,911,2.0,643.0,643.0,5,1079,2.0,811.0,811.0
0.006,17,2,179,1,71,0.0,43.0,43.0,1,108,0.0,80.0,80.0
0.005,6,10,2000,5,927,1.0,659.0,659.0,5,1073,1.0,805.0,805.0
308.539,17,20,1124,10,716,34267.0,48.0,43.0,10,408,34267.0,20.0,12.0
0.004,17,2,136,1,60,0.0,32.0,32.0,1,76,0.0,48.0,48.0
0.039,17,2,144,1,64,0.0,36.0,36.0,1,80,0.0,52.0,52.0
0.003,17,2,148,1,60,0.0,32.0,32.0,1,88,0.0,60.0,60.0
0.005,6,10,2006,5,927,1.0,659.0,659.0,5,1079,1.0,811.0,811.0
0.011,6,10,1989,5,910,2.0,642.0,642.0,5,1079,2.0,811.0,811.0
0.039,17,2,148,1,60,0.0,32.0,32.0,1,88,0.0,60.0,60.0
0.005,6,10,2007,5,928,1.0,660.0,660.0,5,1079,1.0,811.0,811.0
0.1,6,10,1506,5,395,23.0,127.0,127.0,5,1111,19.0,843.0,843.0
0.101,6,10,1506,5,395,21.0,127.0,127.0,5,1111,20.0,843.0,843.0
0.004,6,10,2007,5,928,1.0,660.0,660.0,5,1079,0.0,811.0,811.0
0.014,6,10,1631,5,848,3.0,580.0,580.0,5,783,3.0,515.0,515.0
0.009,6,12,1926,6,1189,1.0,659.0,434.0,6,737,1.0,417.0,417.0
0.001,17,2,136,1,60,0.0,32.0,32.0,1,76,0.0,48.0,48.0
40.075,17,10,676,5,460,10017.0,104.0,64.0,5,216,10018.0,20.0,15.0
0.013,6,10,1677,5,827,3.0,559.0,559.0,5,850,3.0,582.0,582.0
0.006,6,10,1547,5,764,1.0,496.0,496.0,5,783,1.0,515.0,515.0
0.016,6,10,1989,5,910,4.0,642.0,642.0,5,1079,3.0,811.0,811.0
0.005,17,2,170,1,65,0.0,37.0,37.0,1,105,0.0,77.0,77.0
0.078,6,10,1506,5,395,18.0,127.0,127.0,5,1111,17.0,843.0,843.0
0.009,6,10,1990,5,911,2.0,643.0,643.0,5,1079,2.0,811.0,811.0
0.01,6,10,1990,5,911,2.0,643.0,643.0,5,1079,2.0,811.0,811.0
0.086,6,10,1506,5,395,20.0,127.0,127.0,5,1111,19.0,843.0,843.0
10.742,17,28,4424,14,1995,817.0,270.0,114.0,14,2429,817.0,588.0,145.0
15.071,17,14,9191,8,6902,2149.0,1350.0,834.0,6,2289,3008.0,1350.0,353.0
0.096,6,10,1506,5,395,20.0,127.0,127.0,5,1111,20.0,843.0,843.0
0.015,6,10,1677,5,827,3.0,559.0,559.0,5,850,3.0,582.0,582.0
0.091,6,10,1506,5,395,20.0,127.0,127.0,5,1111,19.0,843.0,843.0
0.001,17,2,180,1,66,0.0,38.0,38.0,1,114,0.0,86.0,86.0
0.009,6,10,1989,5,910,2.0,642.0,642.0,5,1079,2.0,811.0,811.0
60.035,6,10,1690,6,1308,12007.0,494.0,494.0,4,382,20010.0,83.0,83.0
0.004,6,10,2006,5,927,1.0,659.0,659.0,5,1079,1.0,811.0,811.0
240.008,6,9,787,5,488,60002.0,232.0,232.0,4,299,80002.0,83.0,83.0
0.151,6,10,1506,5,395,30.0,127.0,127.0,5,1111,33.0,843.0,843.0
0.128,17,2,80,1,32,0.0,4.0,4.0,1,48,0.0,20.0,20.0
0.006,6,10,1989,5,927,1.0,659.0,659.0,5,1062,1.0,794.0,794.0
0.006,6,10,1689,5,839,1.0,571.0,571.0,5,850,1.0,582.0,582.0
0.017,6,10,1972,5,910,4.0,642.0,642.0,5,1062,4.0,794.0,794.0
1756.142,6,107,6344,60,3510,29764.0,26.0,26.0,47,2834,38176.0,26.0,26.0
0.005,6,10,2007,5,928,1.0,660.0,660.0,5,1079,1.0,811.0,811.0
0.001,17,2,180,1,66,0.0,38.0,38.0,1,114,0.0,86.0,86.0
300.033,6,12,1782,7,1348,50005.0,494.0,494.0,5,434,75007.0,83.0,83.0
0.009,6,13,3735,7,497,1.0,125.0,125.0,6,3238,1.0,1470.0,1459.0
0.069,17,8,3613,4,1874,23.0,1350.0,440.0,4,1739,12.0,1350.0,406.0
0.054,17,2,152,1,76,0.0,48.0,48.0,1,76,0.0,48.0,48.0
0.009,6,10,1989,5,910,2.0,642.0,642.0,5,1079,2.0,811.0,811.0
0.084,6,10,1506,5,395,18.0,127.0,127.0,5,1111,17.0,843.0,843.0
0.004,6,10,1774,5,923,1.0,655.0,655.0,5,851,1.0,583.0,583.0
0.005,6,10,1779,5,928,1.0,660.0,660.0,5,851,1.0,583.0,583.0
0.007,17,2,179,1,71,0.0,43.0,43.0,1,108,0.0,80.0,80.0
40.063,17,10,676,5,460,10014.0,104.0,64.0,5,216,10014.0,20.0,15.0
0.034,6,10,1989,5,910,8.0,642.0,642.0,5,1079,8.0,811.0,811.0
309.452,17,20,1124,10,716,34368.0,48.0,43.0,10,408,34368.0,20.0,12.0
354.002,6,21,1795,16,1030,23600.0,190.0,190.0,5,765,60003.0,464.0,248.0
0.069,6,10,1506,5,395,16.0,127.0,127.0,5,1111,14.0,843.0,843.0
0.021,6,10,1989,5,910,5.0,642.0,642.0,5,1079,5.0,811.0,811.0
0.013,6,10,1989,5,910,3.0,642.0,642.0,5,1079,3.0,811.0,811.0
0.068,17,8,3613,4,1874,22.0,1350.0,440.0,4,1739,11.0,1350.0,406.0
240.087,6,16,4482,9,963,30010.0,238.0,166.0,7,3519,40014.0,1402.0,786.0
0.004,17,2,136,1,60,0.0,32.0,32.0,1,76,0.0,48.0,48.0
0.003,17,2,136,1,60,0.0,32.0,32.0,1,76,0.0,48.0,48.0
0.005,6,10,1547,5,764,1.0,496.0,496.0,5,783,1.0,515.0,515.0
0.005,6,13,3747,7,509,0.0,137.0,137.0,6,3238,0.0,1470.0,1459.0
0.015,6,10,1972,5,910,3.0,642.0,642.0,5,1062,3.0,794.0,794.0
0.005,17,2,166,1,75,0.0,47.0,47.0,1,91,0.0,63.0,63.0
0.004,6,10,1989,5,927,1.0,659.0,659.0,5,1062,1.0,794.0,794.0
0.004,6,10,1774,5,923,1.0,655.0,655.0,5,851,1.0,583.0,583.0
0.012,6,10,1990,5,911,2.0,643.0,643.0,5,1079,2.0,811.0,811.0
1787.223,6,154,19574,92,13852,19639.0,302.0,302.0,62,5722,29298.0,83.0,83.0
10.785,17,28,4422,14,1993,821.0,268.0,114.0,14,2429,821.0,588.0,145.0
0.014,6,14,3787,7,497,2.0,125.0,125.0,7,3290,2.0,1448.0,972.0
0.001,17,2,180,1,66,0.0,38.0,38.0,1,114,0.0,86.0,86.0
0.012,6,10,1677,5,827,3.0,559.0,559.0,5,850,3.0,582.0,582.0
0.005,6,10,1779,5,928,1.0,660.0,660.0,5,851,1.0,583.0,583.0
0.014,6,10,1972,5,910,3.0,642.0,642.0,5,1062,3.0,794.0,794.0
0.008,6,12,1926,6,1189,1.0,659.0,434.0,6,737,1.0,417.0,417.0
0.09,6,10,1506,5,395,20.0,127.0,127.0,5,1111,18.0,843.0,843.0
0.019,6,10,1972,5,910,4.0,642.0,642.0,5,1062,4.0,794.0,794.0
0.097,6,10,1506,5,395,21.0,127.0,127.0,5,1111,15.0,843.0,843.0
0.001,17,2,136,1,60,0.0,32.0,32.0,1,76,0.0,48.0,48.0
0.004,17,2,148,1,60,0.0,32.0,32.0,1,88,0.0,60.0,60.0
0.01,6,10,1972,5,910,2.0,642.0,642.0,5,1062,2.0,794.0,794.0
0.004,17,2,136,1,60,0.0,32.0,32.0,1,76,0.0,48.0,48.0
0.005,6,10,2006,5,927,1.0,659.0,659.0,5,1079,1.0,811.0,811.0
0.005,6,10,1989,5,927,1.0,659.0,659.0,5,1062,1.0,794.0,794.0
0.016,17,2,170,1,65,0.0,37.0,37.0,1,105,0.0,77.0,77.0
40.088,17,10,676,5,460,10019.0,104.0,64.0,5,216,10021.0,20.0,15.0
0.012,6,10,1972,5,910,3.0,642.0,642.0,5,1062,3.0,794.0,794.0
0.005,17,2,178,1,65,0.0,37.0,37.0,1,113,0.0,85.0,85.0
0.005,6,14,3799,7,509,0.0,137.0,137.0,7,3290,0.0,1448.0,972.0
0.014,17,2,164,1,74,0.0,46.0,46.0,1,90,0.0,62.0,62.0
0.009,6,12,1926,6,1189,1.0,659.0,434.0,6,737,1.0,417.0,417.0
0.005,6,10,2006,5,927,1.0,659.0,659.0,5,1079,1.0,811.0,811.0
0.014,6,10,1990,5,911,3.0,643.0,643.0,5,1079,3.0,811.0,811.0
0.004,17,2,148,1,60,0.0,32.0,32.0,1,88,0.0,60.0,60.0
0.005,6,13,3747,7,509,0.0,137.0,137.0,6,3238,1.0,1470.0,1459.0
0.163,17,2,152,1,76,0.0,48.0,48.0,1,76,0.0,48.0,48.0
0.041,17,2,152,1,76,0.0,48.0,48.0,1,76,0.0,48.0,48.0
0.004,6,10,2006,5,927,1.0,659.0,659.0,5,1079,1.0,811.0,811.0
0.004,6,10,1779,5,928,1.0,660.0,660.0,5,851,1.0,583.0,583.0
0.011,6,10,1972,5,910,2.0,642.0,642.0,5,1062,2.0,794.0,794.0
120.7,6,58,19101,33,4817,3771.0,1053.0,221.0,25,14284,5028.0,2804.0,998.0
0.026,6,10,1990,5,911,6.0,643.0,643.0,5,1079,6.0,811.0,811.0
0.009,6,12,1926,6,1189,1.0,659.0,434.0,6,737,1.0,417.0,417.0
15.072,17,15,9238,8,6902,2149.0,1350.0,834.0,7,2336,2507.0,1350.0,305.0
0.001,17,2,180,1,66,0.0,38.0,38.0,1,114,0.0,86.0,86.0
40.057,17,10,676,5,460,10011.0,104.0,64.0,5,216,10013.0,20.0,15.0
0.012,6,13,3735,7,497,1.0,125.0,125.0,6,3238,2.0,1470.0,1459.0
0.012,6,10,1762,5,911,3.0,643.0,643.0,5,851,2.0,583.0,583.0
0.01,6,10,1990,5,911,2.0,643.0,643.0,5,1079,2.0,811.0,811.0
0.006,6,10,1547,5,764,1.0,496.0,496.0,5,783,1.0,515.0,515.0
0.004,6,10,1989,5,927,1.0,659.0,659.0,5,1062,1.0,794.0,794.0
88.068,6,787,948594,420,925910,103.0,4080.0,2319.0,367,22684,240.0,2667.0,204.0
0.091,6,10,1506,5,395,20.0,127.0,127.0,5,1111,16.0,843.0,843.0
0.004,6,10,1989,5,927,1.0,659.0,659.0,5,1062,1.0,794.0,794.0
0.099,6,10,1506,5,395,22.0,127.0,127.0,5,1111,21.0,843.0,843.0
0.161,17,2,152,1,76,0.0,48.0,48.0,1,76,0.0,48.0,48.0
0.04,17,4,420,2,122,0.0,33.0,33.0,2,298,0.0,145.0,121.0
0.121,6,10,1506,5,395,28.0,127.0,127.0,5,1111,27.0,843.0,843.0
0.08,6,10,1506,5,395,19.0,127.0,127.0,5,1111,17.0,843.0,843.0
0.005,17,2,166,1,75,0.0,47.0,47.0,1,91,0.0,63.0,63.0
240.094,6,31,9311,15,6788,17149.0,1912.0,668.0,16,2523,16006.0,580.0,210.0
0.005,6,10,2007,5,928,1.0,660.0,660.0,5,1079,1.0,811.0,811.0
0.072,6,10,1506,5,395,15.0,127.0,127.0,5,1111,15.0,843.0,843.0
0.005,6,10,2006,5,927,1.0,659.0,659.0,5,1079,1.0,811.0,811.0
0.013,6,10,1762,5,911,3.0,643.0,643.0,5,851,3.0,583.0,583.0
0.005,6,10,1774,5,923,1.0,655.0,655.0,5,851,1.0,583.0,583.0
0.069,6,10,1506,5,395,16.0,127.0,127.0,5,1111,13.0,843.0,843.0
0.007,6,10,1972,5,910,1.0,642.0,642.0,5,1062,1.0,794.0,794.0
0.014,6,10,1762,5,911,3.0,643.0,643.0,5,851,3.0,583.0,583.0
0.007,6,10,1989,5,910,1.0,642.0,642.0,5,1079,1.0,811.0,811.0
0.005,17,2,170,1,65,0.0,37.0,37.0,1,105,0.0,77.0,77.0
0.069,17,8,3613,4,1874,23.0,1350.0,440.0,4,1739,11.0,1350.0,406.0
0.079,6,10,1506,5,395,19.0,127.0,127.0,5,1111,15.0,843.0,843.0
0.005,17,2,160,1,72,0.0,44.0,44.0,1,88,0.0,60.0,60.0
0.086,6,10,1506,5,395,18.0,127.0,127.0,5,1111,20.0,843.0,843.0
10.874,17,28,4422,14,1994,828.0,269.0,114.0,14,2428,827.0,587.0,145.0
0.012,6,10,1983,5,910,2.0,642.0,642.0,5,1073,2.0,805.0,805.0
0.005,6,10,2006,5,927,1.0,659.0,659.0,5,1079,1.0,811.0,811.0
0.015,6,10,1983,5,910,3.0,642.0,642.0,5,1073,3.0,805.0,805.0
0.003,17,2,136,1,60,0.0,32.0,32.0,1,76,0.0,48.0,48.0
0.118,6,10,1506,5,395,24.0,127.0,127.0,5,1111,25.0,843.0,843.0
0.012,6,10,1677,5,827,2.0,559.0,559.0,5,850,2.0,582.0,582.0
293.367,6,384,348116,189,21387,1560.0,2736.0,888.0,195,326729,1512.0,2804.0,1749.0
0.081,6,10,1506,5,395,19.0,127.0,127.0,5,1111,16.0,843.0,843.0
0.004,17,4,284,2,120,0.0,32.0,32.0,2,164,0.0,60.0,54.0
0.163,17,2,152,1,76,0.0,48.0,48.0,1,76,0.0,48.0,48.0
0.011,6,10,1990,5,911,2.0,643.0,643.0,5,1079,2.0,811.0,811.0
25.255,6,36,8343,18,1871,508.0,763.0,373.0,18,6472,1478.0,2720.0,478.0
0.005,6,14,3736,7,446,0.0,74.0,74.0,7,3290,0.0,1448.0,972.0
0.118,6,10,1506,5,395,27.0,127.0,127.0,5,1111,27.0,843.0,843.0
0.046,6,10,1506,5,395,11.0,127.0,127.0,5,1111,11.0,843.0,843.0
294.219,6,385,349566,199,21916,1485.0,2736.0,888.0,186,327650,1590.0,2804.0,1848.0
0.004,6,10,1989,5,927,1.0,659.0,659.0,5,1062,1.0,794.0,794.0
0.009,6,10,1990,5,911,2.0,643.0,643.0,5,1079,2.0,811.0,811.0
11.525,17,28,4393,14,2311,874.0,586.0,137.0,14,2082,874.0,269.0,120.0
0.218,6,10,1506,5,395,39.0,127.0,127.0,5,1111,50.0,843.0,843.0
0.008,6,12,1926,6,1189,1.0,659.0,434.0,6,737,1.0,417.0,417.0
0.005,6,14,3742,7,452,0.0,80.0,80.0,7,3290,0.0,1448.0,972.0
0.133,6,10,1506,5,395,29.0,127.0,127.0,5,1111,23.0,843.0,843.0
0.012,6,10,1990,5,911,3.0,643.0,643.0,5,1079,2.0,811.0,811.0
0.001,17,2,136,1,60,0.0,32.0,32.0,1,76,0.0,48.0,48.0
0.004,6,10,2007,5,928,1.0,660.0,660.0,5,1079,1.0,811.0,811.0
0.005,6,10,1547,5,764,1.0,496.0,496.0,5,783,1.0,515.0,515.0
0.006,17,2,294,1,67,0.0,39.0,39.0,1,227,0.0,199.0,199.0
0.005,6,10,2006,5,927,1.0,659.0,659.0,5,1079,1.0,811.0,811.0
240.265,6,29,15987,15,6976,17161.0,2736.0,1033.0,14,9011,18481.0,1908.0,1182.0
0.014,6,10,1972,5,910,3.0,642.0,642.0,5,1062,3.0,794.0,794.0
0.063,6,10,1506,5,395,14.0,127.0,127.0,5,1111,13.0,843.0,843.0
0.027,6,9,1190,5,751,6.0,495.0,495.0,4,439,6.0,223.0,223.0
0.066,17,8,3613,4,1874,22.0,1350.0,440.0,4,1739,10.0,1350.0,406.0
0.072,17,4,596,2,122,0.0,33.0,33.0,2,474,32.0,323.0,209.0
0.072,17,4,284,2,120,1.0,32.0,32.0,2,164,68.0,60.0,54.0
0.006,6,10,1547,5,764,1.0,496.0,496.0,5,783,1.0,515.0,515.0
0.006,17,4,495,2,132,0.0,38.0,38.0,2,363,3.0,176.0,153.0
0.004,6,10,2006,5,927,1.0,659.0,659.0,5,1079,1.0,811.0,811.0
0.005,6,10,2007,5,928,1.0,660.0,660.0,5,1079,1.0,811.0,811.0
300.278,6,21,5952,12,1184,27297.0,253.0,138.0,9,4768,37534.0,1402.0,860.0
0.106,6,10,1506,5,395,22.0,127.0,127.0,5,1111,23.0,843.0,843.0
0.005,6,10,1989,5,927,1.0,659.0,659.0,5,1062,1.0,794.0,794.0
0.079,6,10,1506,5,395,18.0,127.0,127.0,5,1111,17.0,843.0,843.0
0.006,6,10,2000,5,927,1.0,659.0,659.0,5,1073,1.0,805.0,805.0
0.792,6,10,2009,6,1655,158.0,1403.0,1403.0,4,354,185.0,182.0,182.0
0.01,6,10,1983,5,910,2.0,642.0,642.0,5,1073,2.0,805.0,805.0
0.011,6,10,1631,5,848,2.0,580.0,580.0,5,783,2.0,515.0,515.0
240.142,6,45,6826,21,3171,12007.0,588.0,230.0,24,3655,10440.0,580.0,218.0
0.011,6,10,1972,5,910,2.0,642.0,642.0,5,1062,2.0,794.0,794.0
0.011,6,10,1972,5,910,2.0,642.0,642.0,5,1062,2.0,794.0,794.0
0.004,17,4,284,2,120,0.0,32.0,32.0,2,164,0.0,60.0,54.0
0.169,17,2,152,1,76,0.0,48.0,48.0,1,76,0.0,48.0,48.0
0.004,6,10,2006,5,927,1.0,659.0,659.0,5,1079,1.0,811.0,811.0
0.008,6,12,1926,6,1189,1.0,659.0,434.0,6,737,1.0,417.0,417.0
0.005,6,10,1989,5,927,1.0,659.0,659.0,5,1062,1.0,794.0,794.0
0.1,6,10,1506,5,395,22.0,127.0,127.0,5,1111,16.0,843.0,843.0
0.004,6,10,1774,5,923,1.0,655.0,655.0,5,851,1.0,583.0,583.0
0.106,6,10,1506,5,395,24.0,127.0,127.0,5,1111,25.0,843.0,843.0
0.005,17,2,170,1,65,0.0,37.0,37.0,1,105,0.0,77.0,77.0
0.007,6,10,1547,5,764,1.0,496.0,496.0,5,783,1.0,515.0,515.0
0.009,6,10,2006,5,927,2.0,659.0,659.0,5,1079,2.0,811.0,811.0
0.006,6,10,1547,5,764,1.0,496.0,496.0,5,783,1.0,515.0,515.0
0.086,6,10,1506,5,395,19.0,127.0,127.0,5,1111,18.0,843.0,843.0
0.013,6,10,1677,5,827,3.0,559.0,559.0,5,850,3.0,582.0,582.0
0.214,6,16,2669,8,1395,30.0,533.0,323.0,8,1274,19.0,529.0,212.0
300.398,6,16,2170,9,684,37529.0,146.0,146.0,7,1486,50039.0,419.0,398.0
0.016,6,10,1989,5,910,4.0,642.0,642.0,5,1079,3.0,811.0,811.0
0.005,6,10,2000,5,927,1.0,659.0,659.0,5,1073,1.0,805.0,805.0
0.011,6,13,3735,7,497,1.0,125.0,125.0,6,3238,2.0,1470.0,1459.0
0.075,6,10,1506,5,395,17.0,127.0,127.0,5,1111,15.0,843.0,843.0
308.525,17,20,1124,10,716,34266.0,48.0,43.0,10,408,34266.0,20.0,12.0
0.006,6,10,1547,5,764,1.0,496.0,496.0,5,783,1.0,515.0,515.0
0.068,6,10,1605,5,388,17.0,120.0,120.0,5,1217,17.0,949.0,949.0
292.053,6,312,344529,112,17381,2631.0,2736.0,825.0,200,327148,1467.0,3036.0,1702.0
0.068,17,8,3613,4,1874,22.0,1350.0,440.0,4,1739,11.0,1350.0,406.0
0.016,6,13,3735,7,497,2.0,125.0,125.0,6,3238,3.0,1470.0,1459.0
40.079,17,10,676,5,460,10016.0,104.0,64.0,5,216,10019.0,20.0,15.0
0.005,6,10,2000,5,927,1.0,659.0,659.0,5,1073,1.0,805.0,805.0
0.001,17,2,180,1,66,0.0,38.0,38.0,1,114,0.0,86.0,86.0
0.013,6,10,1990,5,911,3.0,643.0,643.0,5,1079,3.0,811.0,811.0
0.071,6,10,1506,5,395,17.0,127.0,127.0,5,1111,14.0,843.0,843.0
0.004,17,4,284,2,120,0.0,32.0,32.0,2,164,1.0,60.0,54.0
0.001,17,2,166,1,75,0.0,47.0,47.0,1,91,0.0,63.0,63.0
0.009,6,10,1677,5,827,2.0,559.0,559.0,5,850,2.0,582.0,582.0
0.003,17,2,136,1,60,0.0,32.0,32.0,1,76,0.0,48.0,48.0
0.04,17,4,352,2,130,0.0,37.0,37.0,2,222,0.0,89.0,83.0
0.003,17,2,136,1,60,0.0,32.0,32.0,1,76,0.0,48.0,48.0
0.012,6,10,1989,5,910,3.0,642.0,642.0,5,1079,3.0,811.0,811.0
0.005,6,10,1774,5,923,1.0,655.0,655.0,5,851,1.0,583.0,583.0
0.003,17,2,148,1,60,0.0,32.0,32.0,1,88,0.0,60.0,60.0
0.115,6,10,1506,5,395,25.0,127.0,127.0,5,1111,26.0,843.0,843.0
15.198,17,39,20245,21,17033,758.0,1350.0,783.0,18,3212,892.0,1350.0,150.0
0.005,6,10,2006,5,927,1.0,659.0,659.0,5,1079,1.0,811.0,811.0
170.422,17,80,11440,40,2678,4369.0,44.0,38.0,40,8762,4369.0,260.0,191.0
0.013,6,10,1990,5,911,3.0,643.0,643.0,5,1079,3.0,811.0,811.0
173.328,17,86,12087,43,2895,4126.0,44.0,39.0,43,9192,4126.0,239.0,185.0
0.006,6,10,2000,5,927,1.0,659.0,659.0,5,1073,1.0,805.0,805.0
240.086,6,16,4480,9,963,30010.0,238.0,166.0,7,3517,40013.0,1402.0,786.0
0.001,17,2,166,1,75,0.0,47.0,47.0,1,91,0.0,63.0,63.0
0.105,6,10,1506,5,395,23.0,127.0,127.0,5,1111,24.0,843.0,843.0
0.004,6,10,1702,5,863,1.0,595.0,595.0,5,839,1.0,571.0,571.0
0.015,6,10,1989,5,910,3.0,642.0,642.0,5,1079,3.0,811.0,811.0
0.092,6,10,1506,5,395,22.0,127.0,127.0,5,1111,19.0,843.0,843.0
0.006,6,10,1643,5,860,1.0,592.0,592.0,5,783,1.0,515.0,515.0
0.067,6,10,1506,5,395,14.0,127.0,127.0,5,1111,14.0,843.0,843.0
0.09,6,10,1506,5,395,19.0,127.0,127.0,5,1111,20.0,843.0,843.0
0.005,6,10,2006,5,927,1.0,659.0,659.0,5,1079,1.0,811.0,811.0
0.005,6,10,1689,5,839,1.0,571.0,571.0,5,850,1.0,582.0,582.0
0.224,6,16,2777,8,1395,32.0,533.0,323.0,8,1382,20.0,529.0,239.0
0.005,6,10,2006,5,927,1.0,659.0,659.0,5,1079,1.0,811.0,811.0
360.031,6,21,3981,13,3142,30002.0,494.0,494.0,8,839,51432.0,83.0,83.0
40.079,17,10,676,5,460,10017.0,104.0,64.0,5,216,10018.0,20.0,15.0
0.019,6,14,3787,7,497,3.0,125.0,125.0,7,3290,3.0,1448.0,972.0
0.004,17,4,284,2,120,0.0,32.0,32.0,2,164,0.0,60.0,54.0
0.037,17,2,182,1,65,0.0,37.0,37.0,1,117,0.0,89.0,89.0
0.006,6,10,1547,5,764,1.0,496.0,496.0,5,783,1.0,515.0,515.0
0.004,17,2,148,1,60,0.0,32.0,32.0,1,88,0.0,60.0,60.0
0.006,6,10,1547,5,764,1.0,496.0,496.0,5,783,1.0,515.0,515.0
0.007,6,10,1989,5,910,1.0,642.0,642.0,5,1079,1.0,811.0,811.0
0.007,6,10,1989,5,927,1.0,659.0,659.0,5,1062,1.0,794.0,794.0
0.005,6,10,2007,5,928,1.0,660.0,660.0,5,1079,1.0,811.0,811.0
0.005,17,2,152,1,68,0.0,40.0,40.0,1,84,0.0,56.0,56.0
0.014,6,10,1677,5,827,3.0,559.0,559.0,5,850,3.0,582.0,582.0
0.004,17,2,164,1,74,0.0,46.0,46.0,1,90,0.0,62.0,62.0
0.006,6,10,1547,5,764,1.0,496.0,496.0,5,783,1.0,515.0,515.0
0.005,6,10,2006,5,927,1.0,659.0,659.0,5,1079,1.0,811.0,811.0
0.001,17,2,180,1,66,0.0,38.0,38.0,1,114,0.0,86.0,86.0
0.135,6,10,1506,5,395,30.0,127.0,127.0,5,1111,32.0,843.0,843.0
0.071,17,2,184,1,61,0.0,33.0,33.0,1,123,0.0,95.0,95.0
0.012,6,10,1677,5,827,3.0,559.0,559.0,5,850,2.0,582.0,582.0
0.003,17,2,148,1,60,0.0,32.0,32.0,1,88,0.0,60.0,60.0
366.871,6,22,2313,16,867,24458.0,195.0,195.0,6,1446,4642.0,419.0,398.0
0.008,6,12,1926,6,1189,1.0,659.0,434.0,6,737,1.0,417.0,417.0
308.716,17,20,1124,10,716,34286.0,48.0,43.0,10,408,34286.0,20.0,12.0
0.003,17,2,160,1,72,0.0,44.0,44.0,1,88,0.0,60.0,60.0
0.005,6,10,1989,5,927,1.0,659.0,659.0,5,1062,1.0,794.0,794.0
0.009,6,10,1972,5,910,2.0,642.0,642.0,5,1062,2.0,794.0,794.0
0.025,6,10,1990,5,911,6.0,643.0,643.0,5,1079,6.0,811.0,811.0
0.005,6,10,2007,5,928,1.0,660.0,660.0,5,1079,1.0,811.0,811.0
0.006,6,10,1689,5,839,1.0,571.0,571.0,5,850,1.0,582.0,582.0
0.01,6,10,1990,5,911,2.0,643.0,643.0,5,1079,2.0,811.0,811.0
0.005,6,10,2007,5,928,1.0,660.0,660.0,5,1079,1.0,811.0,811.0
0.004,6,10,1989,5,927,1.0,659.0,659.0,5,1062,1.0,794.0,794.0
0.005,6,10,2007,5,928,1.0,660.0,660.0,5,1079,1.0,811.0,811.0
0.031,17,2,136,1,60,0.0,32.0,32.0,1,76,0.0,48.0,48.0
0.017,6,10,1677,5,827,4.0,559.0,559.0,5,850,4.0,582.0,582.0
0.005,6,14,3736,7,446,0.0,74.0,74.0,7,3290,0.0,1448.0,972.0
0.077,6,10,1506,5,395,18.0,127.0,127.0,5,1111,17.0,843.0,843.0
40.064,17,10,676,5,460,10015.0,104.0,64.0,5,216,10015.0,20.0,15.0
0.078,6,10,1506,5,395,18.0,127.0,127.0,5,1111,15.0,843.0,843.0
0.014,6,10,1972,5,910,3.0,642.0,642.0,5,1062,3.0,794.0,794.0
0.037,17,2,182,1,65,0.0,37.0,37.0,1,117,0.0,89.0,89.0
0.132,6,10,1506,5,395,26.0,127.0,127.0,5,1111,30.0,843.0,843.0
40.061,17,10,676,5,460,10013.0,104.0,64.0,5,216,10014.0,20.0,15.0
1778.352,17,143,41496,72,22752,25047.0,288.0,288.0,71,18744,25404.0,236.0,236.0
0.023,6,10,1762,5,911,5.0,643.0,643.0,5,851,5.0,583.0,583.0
0.005,6,10,1643,5,860,1.0,592.0,592.0,5,783,1.0,515.0,515.0
0.014,6,10,1983,5,910,3.0,642.0,642.0,5,1073,3.0,805.0,805.0
0.181,6,10,1506,5,395,42.0,127.0,127.0,5,1111,42.0,843.0,843.0
0.005,6,10,2006,5,927,1.0,659.0,659.0,5,1079,1.0,811.0,811.0
338.434,6,33,10376,18,2434,19907.0,676.0,298.0,15,7942,19883.0,1402.0,794.0
0.005,6,10,1689,5,839,1.0,571.0,571.0,5,850,1.0,582.0,582.0
40.065,17,10,676,5,460,10015.0,104.0,64.0,5,216,10015.0,20.0,15.0
240.021,6,9,787,5,488,60005.0,232.0,232.0,4,299,80006.0,83.0,83.0
0.145,6,10,1506,5,395,32.0,127.0,127.0,5,1111,33.0,843.0,843.0
0.072,6,10,1506,5,395,16.0,127.0,127.0,5,1111,16.0,843.0,843.0
0.004,6,10,1989,5,927,1.0,659.0,659.0,5,1062,1.0,794.0,794.0
0.008,17,2,299,1,65,0.0,37.0,37.0,1,234,0.0,206.0,206.0
0.008,6,10,1689,5,839,2.0,571.0,571.0,5,850,2.0,582.0,582.0
0.005,6,10,2007,5,928,1.0,660.0,660.0,5,1079,1.0,811.0,811.0
0.006,6,10,1547,5,764,1.0,496.0,496.0,5,783,1.0,515.0,515.0
0.005,6,10,2000,5,927,1.0,659.0,659.0,5,1073,1.0,805.0,805.0
361.83,6,19,1688,15,978,25845.0,190.0,190.0,4,710,80013.0,494.0,494.0
361.875,6,21,1792,16,1030,24125.0,190.0,190.0,5,762,60010.0,461.0,247.0
0.004,17,2,136,1,60,0.0,32.0,32.0,1,76,0.0,48.0,48.0
0.044,17,4,596,2,122,2.0,33.0,33.0,2,474,2.0,323.0,209.0
0.006,17,2,212,1,74,0.0,46.0,46.0,1,138,0.0,110.0,110.0
0.004,6,10,2007,5,928,1.0,660.0,660.0,5,1079,1.0,811.0,811.0
40.061,17,10,676,5,460,10013.0,104.0,64.0,5,216,10014.0,20.0,15.0
0.008,6,10,1989,5,910,2.0,642.0,642.0,5,1079,2.0,811.0,811.0
0.006,6,10,1689,5,839,1.0,571.0,571.0,5,850,1.0,582.0,582.0
0.001,17,2,136,1,60,0.0,32.0,32.0,1,76,0.0,48.0,48.0
0.019,6,10,1989,5,910,4.0,642.0,642.0,5,1079,4.0,811.0,811.0
0.814,6,22,5072,11,1250,70.0,325.0,133.0,11,3822,70.0,1414.0,563.0
0.004,17,2,179,1,71,0.0,43.0,43.0,1,108,0.0,80.0,80.0
0.01,6,10,1989,5,910,2.0,642.0,642.0,5,1079,2.0,811.0,811.0
0.001,17,2,180,1,66,0.0,38.0,38.0,1,114,0.0,86.0,86.0
0.005,6,10,1689,5,839,1.0,571.0,571.0,5,850,1.0,582.0,582.0
243.106,6,21,6492,12,1402,22100.0,253.0,195.0,9,5090,30387.0,1402.0,769.0
0.005,17,2,170,1,65,0.0,37.0,37.0,1,105,0.0,77.0,77.0
0.014,6,10,1990,5,911,3.0,643.0,643.0,5,1079,3.0,811.0,811.0
0.017,6,10,1983,5,910,4.0,642.0,642.0,5,1073,4.0,805.0,805.0
0.015,6,10,1972,5,910,3.0,642.0,642.0,5,1062,3.0,794.0,794.0
0.13,17,2,136,1,60,0.0,32.0,32.0,1,76,0.0,48.0,48.0
0.105,6,10,1506,5,395,25.0,127.0,127.0,5,1111,23.0,843.0,843.0
0.005,6,10,1854,5,889,1.0,621.0,621.0,5,965,1.0,697.0,697.0
0.006,6,14,3736,7,446,0.0,74.0,74.0,7,3290,0.0,1448.0,972.0
0.007,6,10,1989,5,927,1.0,659.0,659.0,5,1062,1.0,794.0,794.0
0.072,17,4,284,2,120,0.0,32.0,32.0,2,164,68.0,60.0,54.0
0.107,6,10,1506,5,395,25.0,127.0,127.0,5,1111,23.0,843.0,843.0
240.093,6,32,9408,16,6744,16006.0,1817.0,657.0,16,2664,16006.0,580.0,228.0
0.005,6,14,3736,7,446,0.0,74.0,74.0,7,3290,0.0,1448.0,972.0
354.033,6,21,1795,16,1030,23602.0,190.0,190.0,5,765,60001.0,464.0,248.0
15.069,17,15,9238,8,6902,2148.0,1350.0,834.0,7,2336,2506.0,1350.0,305.0
0.174,6,3,453,2,321,174.0,241.0,241.0,1,132,0.0,92.0,92.0
0.006,17,2,213,1,69,0.0,41.0,41.0,1,144,0.0,116.0,116.0
0.087,6,10,1506,5,395,21.0,127.0,127.0,5,1111,17.0,843.0,843.0
0.103,6,10,1506,5,395,24.0,127.0,127.0,5,1111,21.0,843.0,843.0
0.052,17,2,152,1,76,0.0,48.0,48.0,1,76,0.0,48.0,48.0
0.106,6,10,1506,5,395,22.0,127.0,127.0,5,1111,24.0,843.0,843.0
0.005,6,10,1989,5,927,1.0,659.0,659.0,5,1062,1.0,794.0,794.0
0.005,6,10,1989,5,927,1.0,659.0,659.0,5,1062,1.0,794.0,794.0
0.067,17,8,3613,4,1874,22.0,1350.0,440.0,4,1739,10.0,1350.0,406.0
10.788,17,28,4423,14,1994,821.0,269.0,114.0,14,2429,820.0,588.0,145.0
0.005,6,10,1854,5,889,1.0,621.0,621.0,5,965,1.0,697.0,697.0
0.005,6,13,3747,7,509,0.0,137.0,137.0,6,3238,0.0,1470.0,1459.0
0.1,6,10,1506,5,395,18.0,127.0,127.0,5,1111,24.0,843.0,843.0
0.005,6,10,2007,5,928,1.0,660.0,660.0,5,1079,1.0,811.0,811.0
0.038,17,2,152,1,76,0.0,48.0,48.0,1,76,0.0,48.0,48.0
0.015,6,14,3787,7,497,2.0,125.0,125.0,7,3290,2.0,1448.0,972.0
15.075,17,15,9238,8,6902,2149.0,1350.0,834.0,7,2336,2507.0,1350.0,305.0
0.006,6,10,1547,5,764,1.0,496.0,496.0,5,783,1.0,515.0,515.0
0.005,6,10,2006,5,927,1.0,659.0,659.0,5,1079,1.0,811.0,811.0
0.005,6,10,1989,5,927,1.0,659.0,659.0,5,1062,1.0,794.0,794.0
0.006,6,10,1643,5,860,1.0,592.0,592.0,5,783,1.0,515.0,515.0
0.077,6,10,1506,5,395,15.0,127.0,127.0,5,1111,17.0,843.0,843.0
0.082,6,10,1506,5,395,20.0,127.0,127.0,5,1111,16.0,843.0,843.0
0.028,6,10,1983,5,910,6.0,642.0,642.0,5,1073,6.0,805.0,805.0
0.102,6,10,1506,5,395,24.0,127.0,127.0,5,1111,24.0,843.0,843.0
0.095,6,10,1506,5,395,22.0,127.0,127.0,5,1111,22.0,843.0,843.0
0.008,6,10,1677,5,827,1.0,559.0,559.0,5,850,2.0,582.0,582.0
0.04,17,4,284,2,120,0.0,32.0,32.0,2,164,36.0,60.0,54.0
1792.552,6,492,100228,248,88931,7256.0,421.0,367.0,244,11297,7376.0,53.0,53.0
0.004,6,10,2007,5,928,1.0,660.0,660.0,5,1079,1.0,811.0,811.0
0.013,6,10,1990,5,911,3.0,643.0,643.0,5,1079,3.0,811.0,811.0
0.005,6,10,1854,5,889,1.0,621.0,621.0,5,965,1.0,697.0,697.0
0.061,17,2,80,1,32,0.0,4.0,4.0,1,48,0.0,20.0,20.0
0.079,6,10,1506,5,395,17.0,127.0,127.0,5,1111,17.0,843.0,843.0
0.77,6,11,3166,6,1415,103.0,1163.0,1163.0,5,1751,129.0,1539.0,1539.0
0.005,6,10,1547,5,764,1.0,496.0,496.0,5,783,1.0,515.0,515.0
0.005,6,10,2006,5,927,1.0,659.0,659.0,5,1079,1.0,811.0,811.0
0.004,6,10,2006,5,927,1.0,659.0,659.0,5,1079,1.0,811.0,811.0
0.008,6,12,1926,6,1189,1.0,659.0,434.0,6,737,1.0,417.0,417.0
0.096,6,10,1506,5,395,21.0,127.0,127.0,5,1111,20.0,843.0,843.0
0.005,17,2,144,1,64,0.0,36.0,36.0,1,80,0.0,52.0,52.0
40.064,17,10,676,5,460,10015.0,104.0,64.0,5,216,10015.0,20.0,15.0
0.005,6,13,3747,7,509,0.0,137.0,137.0,6,3238,0.0,1470.0,1459.0
0.005,6,10,2000,5,927,1.0,659.0,659.0,5,1073,1.0,805.0,805.0
0.097,6,10,1506,5,395,18.0,127.0,127.0,5,1111,22.0,843.0,843.0
0.095,6,10,1506,5,395,21.0,127.0,127.0,5,1111,19.0,843.0,843.0
11.281,17,28,4423,14,1995,855.0,270.0,114.0,14,2428,853.0,587.0,145.0
0.009,6,10,1972,5,910,2.0,642.0,642.0,5,1062,2.0,794.0,794.0
0.004,6,10,1702,5,863,1.0,595.0,595.0,5,839,0.0,571.0,571.0
0.008,6,13,3747,7,509,1.0,137.0,137.0,6,3238,1.0,1470.0,1459.0
0.005,6,10,1779,5,928,1.0,660.0,660.0,5,851,1.0,583.0,583.0
0.016,6,10,1972,5,910,3.0,642.0,642.0,5,1062,3.0,794.0,794.0
0.022,6,10,1989,5,910,5.0,642.0,642.0,5,1079,5.0,811.0,811.0
0.005,6,10,1689,5,839,1.0,571.0,571.0,5,850,1.0,582.0,582.0
0.005,17,2,179,1,71,0.0,43.0,43.0,1,108,0.0,80.0,80.0
0.072,6,10,1506,5,395,14.0,127.0,127.0,5,1111,17.0,843.0,843.0
0.089,6,10,1506,5,395,21.0,127.0,127.0,5,1111,18.0,843.0,843.0
300.806,6,31,10089,17,2834,18800.0,798.0,388.0,14,7255,18522.0,1402.0,814.0
0.005,6,10,2006,5,927,1.0,659.0,659.0,5,1079,1.0,811.0,811.0
0.005,6,10,1689,5,839,1.0,571.0,571.0,5,850,1.0,582.0,582.0
0.003,17,2,148,1,60,0.0,32.0,32.0,1,88,0.0,60.0,60.0
0.004,17,2,136,1,60,0.0,32.0,32.0,1,76,0.0,48.0,48.0
0.006,6,10,2006,5,927,1.0,659.0,659.0,5,1079,1.0,811.0,811.0
0.004,17,2,234,1,61,0.0,33.0,33.0,1,173,0.0,145.0,145.0
0.006,6,10,2006,5,927,1.0,659.0,659.0,5,1079,1.0,811.0,811.0
0.006,17,2,170,1,65,0.0,37.0,37.0,1,105,0.0,77.0,77.0
0.089,6,10,1506,5,395,17.0,127.0,127.0,5,1111,21.0,843.0,843.0
0.078,6,10,1506,5,395,17.0,127.0,127.0,5,1111,17.0,843.0,843.0
0.04,17,2,152,1,76,0.0,48.0,48.0,1,76,0.0,48.0,48.0
0.059,6,10,1506,5,395,14.0,127.0,127.0,5,1111,12.0,843.0,843.0
0.009,6,10,1972,5,910,2.0,642.0,642.0,5,1062,2.0,794.0,794.0
0.001,17,2,180,1,66,0.0,38.0,38.0,1,114,0.0,86.0,86.0
0.013,6,10,1972,5,910,3.0,642.0,642.0,5,1062,3.0,794.0,794.0
0.006,6,10,1689,5,839,1.0,571.0,571.0,5,850,1.0,582.0,582.0
0.014,6,10,1631,5,848,3.0,580.0,580.0,5,783,3.0,515.0,515.0
1794.26,6,284,26831,143,9804,12635.0,747.0,295.0,141,17027,12815.0,1625.0,72.0
0.009,6,10,1677,5,827,2.0,559.0,559.0,5,850,2.0,582.0,582.0
0.01,6,10,1989,5,910,2.0,642.0,642.0,5,1079,2.0,811.0,811.0
0.008,6,10,1989,5,910,2.0,642.0,642.0,5,1079,2.0,811.0,811.0
0.006,6,10,2006,5,927,1.0,659.0,659.0,5,1079,1.0,811.0,811.0
0.017,6,10,1990,5,911,4.0,643.0,643.0,5,1079,4.0,811.0,811.0
300.993,6,46,17667,24,11760,13086.0,2720.0,1346.0,22,5907,420.0,2667.0,385.0
0.093,6,10,1506,5,395,22.0,127.0,127.0,5,1111,17.0,843.0,843.0
0.004,17,2,148,1,60,0.0,32.0,32.0,1,88,0.0,60.0,60.0
0.005,6,10,2006,5,927,1.0,659.0,659.0,5,1079,1.0,811.0,811.0
352.512,6,20,2210,6,1308,12004.0,494.0,494.0,14,902,27115.0,83.0,83.0
369.647,6,22,2313,16,867,24643.0,195.0,195.0,6,1446,4640.0,419.0,398.0
0.117,6,10,1506,5,395,25.0,127.0,127.0,5,1111,23.0,843.0,843.0
0.005,17,2,166,1,75,0.0,47.0,47.0,1,91,0.0,63.0,63.0
0.005,6,10,2000,5,927,1.0,659.0,659.0,5,1073,1.0,805.0,805.0
0.004,6,10,2006,5,927,1.0,659.0,659.0,5,1079,1.0,811.0,811.0
40.063,17,10,676,5,460,10014.0,104.0,64.0,5,216,10015.0,20.0,15.0
0.077,6,10,1506,5,395,14.0,127.0,127.0,5,1111,17.0,843.0,843.0
0.004,6,10,1774,5,923,1.0,655.0,655.0,5,851,1.0,583.0,583.0
0.013,6,10,1983,5,910,3.0,642.0,642.0,5,1073,3.0,805.0,805.0
0.08,6,10,1506,5,395,17.0,127.0,127.0,5,1111,18.0,843.0,843.0
0.001,17,2,166,1,75,0.0,47.0,47.0,1,91,0.0,63.0,63.0
0.076,6,10,1506,5,395,17.0,127.0,127.0,5,1111,16.0,843.0,843.0
40.057,17,10,676,5,460,10013.0,104.0,64.0,5,216,10013.0,20.0,15.0
0.005,6,10,1854,5,889,1.0,621.0,621.0,5,965,1.0,697.0,697.0
0.004,6,10,2000,5,927,1.0,659.0,659.0,5,1073,1.0,805.0,805.0
0.009,6,12,1926,6,1189,1.0,659.0,434.0,6,737,1.0,417.0,417.0
0.005,6,14,3742,8,504,0.0,80.0,80.0,6,3238,0.0,1470.0,1459.0
240.313,6,22,11451,13,6873,20026.0,2736.0,1033.0,9,4578,30038.0,1656.0,1367.0
0.127,17,4,364,2,160,0.0,52.0,52.0,2,204,54.0,80.0,74.0
0.009,6,10,1677,5,827,2.0,559.0,559.0,5,850,2.0,582.0,582.0
0.005,6,10,2007,5,928,1.0,660.0,660.0,5,1079,1.0,811.0,811.0
0.092,6,10,1506,5,395,20.0,127.0,127.0,5,1111,21.0,843.0,843.0
0.005,6,10,1854,5,889,1.0,621.0,621.0,5,965,1.0,697.0,697.0
0.013,6,10,1631,5,848,3.0,580.0,580.0,5,783,3.0,515.0,515.0
0.005,6,10,1989,5,927,1.0,659.0,659.0,5,1062,1.0,794.0,794.0
0.066,6,10,1506,5,395,15.0,127.0,127.0,5,1111,14.0,843.0,843.0
0.04,17,2,152,1,76,0.0,48.0,48.0,1,76,0.0,48.0,48.0
0.055,17,2,184,1,61,0.0,33.0,33.0,1,123,0.0,95.0,95.0
0.012,6,10,1983,5,910,2.0,642.0,642.0,5,1073,3.0,805.0,805.0
240.08,6,16,4481,9,963,30010.0,238.0,166.0,7,3518,40012.0,1402.0,786.0
0.07,17,8,3613,4,1874,23.0,1350.0,440.0,4,1739,12.0,1350.0,406.0
0.004,6,10,2006,5,927,1.0,659.0,659.0,5,1079,1.0,811.0,811.0
0.005,17,2,214,1,75,0.0,47.0,47.0,1,139,0.0,111.0,111.0
0.009,6,12,1926,6,1189,1.0,659.0,434.0,6,737,1.0,417.0,417.0
0.1,6,10,1506,5,395,19.0,127.0,127.0,5,1111,20.0,843.0,843.0
0.005,6,10,2006,5,927,1.0,659.0,659.0,5,1079,1.0,811.0,811.0
15.233,17,55,31288,29,27178,543.0,1350.0,909.0,26,4110,608.0,1350.0,130.0
0.009,6,10,1983,5,910,2.0,642.0,642.0,5,1073,2.0,805.0,805.0
0.011,6,10,1989,5,910,2.0,642.0,642.0,5,1079,2.0,811.0,811.0
308.423,17,20,1124,10,716,34262.0,48.0,43.0,10,408,34260.0,20.0,12.0
1769.571,6,82,4318,41,2159,44238.0,27.0,27.0,41,2159,44238.0,27.0,27.0
0.018,6,10,1990,5,911,4.0,643.0,643.0,5,1079,4.0,811.0,811.0
0.116,6,10,1506,5,395,24.0,127.0,127.0,5,1111,26.0,843.0,843.0
0.094,6,10,1506,5,395,20.0,127.0,127.0,5,1111,22.0,843.0,843.0
0.04,17,2,136,1,60,0.0,32.0,32.0,1,76,0.0,48.0,48.0
0.069,6,10,1506,5,395,13.0,127.0,127.0,5,1111,16.0,843.0,843.0
0.005,6,10,2007,5,928,1.0,660.0,660.0,5,1079,1.0,811.0,811.0
0.011,6,10,1972,5,910,2.0,642.0,642.0,5,1062,2.0,794.0,794.0
0.118,6,10,1506,5,395,25.0,127.0,127.0,5,1111,27.0,843.0,843.0
0.015,6,10,1989,5,910,3.0,642.0,642.0,5,1079,3.0,811.0,811.0
0.019,6,10,1990,5,911,4.0,643.0,643.0,5,1079,4.0,811.0,811.0
0.098,6,10,1506,5,395,21.0,127.0,127.0,5,1111,20.0,843.0,843.0
0.005,6,10,2007,5,928,1.0,660.0,660.0,5,1079,1.0,811.0,811.0
15.069,17,15,9239,8,6902,2148.0,1350.0,834.0,7,2337,2506.0,1350.0,305.0
0.004,6,10,1779,5,928,1.0,660.0,660.0,5,851,1.0,583.0,583.0
0.005,6,10,2007,5,928,1.0,660.0,660.0,5,1079,1.0,811.0,811.0
40.057,17,10,676,5,460,10012.0,104.0,64.0,5,216,10013.0,20.0,15.0
0.082,6,10,1506,5,395,19.0,127.0,127.0,5,1111,18.0,843.0,843.0
0.003,17,2,148,1,60,0.0,32.0,32.0,1,88,0.0,60.0,60.0
0.103,6,10,1506,5,395,22.0,127.0,127.0,5,1111,23.0,843.0,843.0
0.006,6,10,1547,5,764,1.0,496.0,496.0,5,783,1.0,515.0,515.0
0.004,6,10,1774,5,923,1.0,655.0,655.0,5,851,1.0,583.0,583.0
0.004,6,10,1774,5,923,1.0,655.0,655.0,5,851,1.0,583.0,583.0
40.05,17,10,676,5,460,10011.0,104.0,64.0,5,216,10009.0,20.0,15.0
0.009,6,10,1989,5,910,2.0,642.0,642.0,5,1079,2.0,811.0,811.0
40.061,17,10,676,5,460,10013.0,104.0,64.0,5,216,10014.0,20.0,15.0
0.013,6,10,1972,5,910,3.0,642.0,642.0,5,1062,3.0,794.0,794.0
0.011,6,10,1989,5,910,2.0,642.0,642.0,5,1079,2.0,811.0,811.0
0.005,6,10,1643,5,860,1.0,592.0,592.0,5,783,1.0,515.0,515.0
0.118,6,10,1506,5,395,26.0,127.0,127.0,5,1111,25.0,843.0,843.0
0.246,17,16,8531,8,5974,35.0,1350.0,718.0,8,2557,22.0,1350.0,291.0
0.125,6,10,1506,5,395,28.0,127.0,127.0,5,1111,29.0,843.0,843.0
0.005,6,10,2007,5,928,1.0,660.0,660.0,5,1079,1.0,811.0,811.0
0.005,6,10,2006,5,927,1.0,659.0,659.0,5,1079,1.0,811.0,811.0
0.133,6,10,1506,5,395,30.0,127.0,127.0,5,1111,27.0,843.0,843.0
0.016,6,13,3735,7,497,2.0,125.0,125.0,6,3238,3.0,1470.0,1459.0
40.078,17,10,676,5,460,10018.0,104.0,64.0,5,216,10018.0,20.0,15.0
0.005,6,10,2007,5,928,1.0,660.0,660.0,5,1079,1.0,811.0,811.0
0.104,6,10,1506,5,395,20.0,127.0,127.0,5,1111,23.0,843.0,843.0
0.023,6,10,1990,5,911,5.0,643.0,643.0,5,1079,5.0,811.0,811.0
0.005,17,2,214,1,75,0.0,47.0,47.0,1,139,0.0,111.0,111.0
0.004,6,10,1989,5,927,1.0,659.0,659.0,5,1062,1.0,794.0,794.0
0.014,6,10,1631,5,848,3.0,580.0,580.0,5,783,3.0,515.0,515.0
0.012,6,10,1990,5,911,2.0,643.0,643.0,5,1079,3.0,811.0,811.0
0.012,6,10,1677,5,827,3.0,559.0,559.0,5,850,2.0,582.0,582.0
0.001,17,2,180,1,66,0.0,38.0,38.0,1,114,0.0,86.0,86.0
0.014,6,10,1983,5,910,3.0,642.0,642.0,5,1073,3.0,805.0,805.0
15.079,17,15,8429,8,6298,2150.0,1350.0,759.0,7,2131,2508.0,1350.0,276.0
0.009,6,12,1926,6,1189,1.0,659.0,434.0,6,737,1.0,417.0,417.0
0.004,6,10,2000,5,927,1.0,659.0,659.0,5,1073,1.0,805.0,805.0
0.023,6,10,1990,5,911,5.0,643.0,643.0,5,1079,5.0,811.0,811.0
40.062,17,10,676,5,460,10014.0,104.0,64.0,5,216,10014.0,20.0,15.0
177.331,17,74,10509,37,2473,4925.0,44.0,38.0,37,8036,4925.0,261.0,189.0
0.114,6,10,1506,5,395,26.0,127.0,127.0,5,1111,26.0,843.0,843.0
0.005,6,10,2006,5,927,1.0,659.0,659.0,5,1079,1.0,811.0,811.0
0.01,17,2,136,1,60,0.0,32.0,32.0,1,76,0.0,48.0,48.0
0.005,6,10,2006,5,927,1.0,659.0,659.0,5,1079,1.0,811.0,811.0
0.004,6,10,2000,5,927,1.0,659.0,659.0,5,1073,1.0,805.0,805.0
0.005,6,10,2007,5,928,1.0,660.0,660.0,5,1079,1.0,811.0,811.0
0.139,6,10,1506,5,395,32.0,127.0,127.0,5,1111,29.0,843.0,843.0
0.078,6,10,1506,5,395,18.0,127.0,127.0,5,1111,15.0,843.0,843.0
0.017,6,10,1983,5,910,4.0,642.0,642.0,5,1073,4.0,805.0,805.0
0.012,6,10,1972,5,910,3.0,642.0,642.0,5,1062,3.0,794.0,794.0
0.179,6,10,1506,5,395,25.0,127.0,127.0,5,1111,41.0,843.0,843.0
1741.883,6,302,97572,186,86408,9415.0,2001.0,685.0,116,11164,15146.0,452.0,70.0
0.004,17,2,214,1,75,0.0,47.0,47.0,1,139,0.0,111.0,111.0
0.011,6,10,1989,5,910,2.0,642.0,642.0,5,1079,2.0,811.0,811.0
0.008,6,10,1990,5,911,2.0,643.0,643.0,5,1079,2.0,811.0,811.0
0.005,6,10,2007,5,928,1.0,660.0,660.0,5,1079,1.0,811.0,811.0
15.077,17,16,8287,8,6043,2149.0,1350.0,727.0,8,2244,2149.0,1350.0,252.0
0.006,6,10,1547,5,764,1.0,496.0,496.0,5,783,1.0,515.0,515.0
0.008,6,10,1989,5,910,2.0,642.0,642.0,5,1079,1.0,811.0,811.0
0.007,17,2,214,1,75,0.0,47.0,47.0,1,139,0.0,111.0,111.0
40.106,17,10,676,5,460,10023.0,104.0,64.0,5,216,10025.0,20.0,15.0
15.12,17,15,7570,7,3708,2515.0,1350.0,501.0,8,3862,2155.0,1350.0,454.0
0.077,6,10,1506,5,395,18.0,127.0,127.0,5,1111,16.0,843.0,843.0
0.005,6,10,1989,5,927,1.0,659.0,659.0,5,1062,1.0,794.0,794.0
0.004,17,2,136,1,60,0.0,32.0,32.0,1,76,0.0,48.0,48.0
0.019,6,10,1990,5,911,4.0,643.0,643.0,5,1079,4.0,811.0,811.0
0.001,17,2,179,1,62,0.0,34.0,34.0,1,117,0.0,89.0,89.0
0.006,6,10,1547,5,764,1.0,496.0,496.0,5,783,1.0,515.0,515.0
0.209,6,16,2782,8,1400,29.0,533.0,325.0,8,1382,19.0,529.0,239.0
0.009,6,10,1972,5,910,2.0,642.0,642.0,5,1062,2.0,794.0,794.0
0.117,6,10,1506,5,395,27.0,127.0,127.0,5,1111,25.0,843.0,843.0
0.005,6,10,1547,5,764,1.0,496.0,496.0,5,783,1.0,515.0,515.0
0.006,6,12,1698,6,863,1.0,327.0,271.0,6,835,1.0,515.0,515.0
0.006,6,10,1689,5,839,1.0,571.0,571.0,5,850,1.0,582.0,582.0
0.005,17,2,164,1,74,0.0,46.0,46.0,1,90,0.0,62.0,62.0
40.053,17,10,676,5,460,10011.0,104.0,64.0,5,216,10012.0,20.0,15.0
0.023,6,10,1990,5,911,5.0,643.0,643.0,5,1079,5.0,811.0,811.0
0.007,6,10,1989,5,927,1.0,659.0,659.0,5,1062,1.0,794.0,794.0
0.073,6,10,1506,5,395,17.0,127.0,127.0,5,1111,17.0,843.0,843.0
10.993,17,28,4418,14,1993,836.0,268.0,114.0,14,2425,836.0,588.0,145.0
0.075,6,10,1506,5,395,16.0,127.0,127.0,5,1111,16.0,843.0,843.0
0.001,17,2,180,1,66,0.0,38.0,38.0,1,114,0.0,86.0,86.0
0.005,6,11,1695,6,912,1.0,592.0,592.0,5,783,1.0,515.0,515.0
0.006,6,10,1854,5,1169,1.0,901.0,901.0,5,685,1.0,417.0,417.0
0.005,6,10,2006,5,927,1.0,659.0,659.0,5,1079,1.0,811.0,811.0
0.075,6,10,1506,5,395,17.0,127.0,127.0,5,1111,17.0,843.0,843.0
0.005,6,10,1989,5,927,1.0,659.0,659.0,5,1062,1.0,794.0,794.0
10.814,17,28,4423,14,1994,823.0,269.0,114.0,14,2429,823.0,588.0,145.0
0.005,6,14,3742,7,452,0.0,80.0,80.0,7,3290,0.0,1448.0,972.0
0.005,6,10,2007,5,928,1.0,660.0,660.0,5,1079,1.0,811.0,811.0
0.016,6,10,1990,5,911,3.0,643.0,643.0,5,1079,4.0,811.0,811.0
11.157,17,28,4423,14,1995,845.0,270.0,114.0,14,2428,845.0,587.0,145.0
0.003,17,2,136,1,60,0.0,32.0,32.0,1,76,0.0,48.0,48.0
0.011,6,10,1762,5,911,2.0,643.0,643.0,5,851,2.0,583.0,583.0
0.103,6,10,1506,5,395,23.0,127.0,127.0,5,1111,23.0,843.0,843.0
0.005,6,10,2006,5,927,1.0,659.0,659.0,5,1079,1.0,811.0,811.0
293.275,6,393,348064,196,21757,1503.0,2736.0,889.0,197,326307,1496.0,2804.0,1727.0
0.207,6,16,2777,8,1395,29.0,533.0,323.0,8,1382,19.0,529.0,239.0
0.009,6,10,1989,5,910,2.0,642.0,642.0,5,1079,2.0,811.0,811.0
0.006,6,10,1547,5,764,1.0,496.0,496.0,5,783,1.0,515.0,515.0
0.012,6,10,1677,5,827,3.0,559.0,559.0,5,850,3.0,582.0,582.0
0.129,17,2,148,1,60,0.0,32.0,32.0,1,88,0.0,60.0,60.0
0.006,6,10,1689,5,839,1.0,571.0,571.0,5,850,1.0,582.0,582.0
0.001,17,2,142,1,63,0.0,35.0,35.0,1,79,0.0,51.0,51.0
0.003,17,2,160,1,72,0.0,44.0,44.0,1,88,0.0,60.0,60.0
0.099,6,10,1506,5,395,21.0,127.0,127.0,5,1111,22.0,843.0,843.0
0.003,17,2,148,1,60,0.0,32.0,32.0,1,88,0.0,60.0,60.0
0.002,17,2,180,1,66,0.0,38.0,38.0,1,114,0.0,86.0,86.0
0.004,17,4,284,2,120,0.0,32.0,32.0,2,164,0.0,60.0,54.0
0.038,17,2,136,1,60,0.0,32.0,32.0,1,76,0.0,48.0,48.0
0.153,6,10,1242,5,751,38.0,495.0,495.0,5,491,35.0,223.0,223.0
0.006,6,10,2006,5,927,1.0,659.0,659.0,5,1079,1.0,811.0,811.0
0.072,6,10,1506,5,395,15.0,127.0,127.0,5,1111,16.0,843.0,843.0
0.004,6,10,1774,5,923,1.0,655.0,655.0,5,851,1.0,583.0,583.0
0.09,6,10,1506,5,395,20.0,127.0,127.0,5,1111,20.0,843.0,843.0
0.004,17,2,412,1,61,0.0,33.0,33.0,1,351,0.0,323.0,323.0
0.004,6,10,1989,5,927,1.0,659.0,659.0,5,1062,1.0,794.0,794.0
0.008,6,10,2000,5,927,1.0,659.0,659.0,5,1073,1.0,805.0,805.0
0.004,6,10,2007,5,928,1.0,660.0,660.0,5,1079,1.0,811.0,811.0
0.083,6,10,1506,5,395,18.0,127.0,127.0,5,1111,16.0,843.0,843.0
0.015,6,10,1989,5,910,3.0,642.0,642.0,5,1079,3.0,811.0,811.0
0.007,6,10,1990,5,911,1.0,643.0,643.0,5,1079,1.0,811.0,811.0
0.006,6,10,1689,5,839,1.0,571.0,571.0,5,850,1.0,582.0,582.0
0.005,6,10,1689,5,839,1.0,571.0,571.0,5,850,1.0,582.0,582.0
170.666,6,22,9246,11,1575,68.0,794.0,367.0,11,7671,17053.0,1360.0,1031.0
300.78,6,36,8439,19,2961,16710.0,1817.0,542.0,17,5478,539.0,2667.0,435.0
0.01,6,10,1989,5,910,2.0,642.0,642.0,5,1079,2.0,811.0,811.0
0.015,6,10,1983,5,910,3.0,642.0,642.0,5,1073,3.0,805.0,805.0
0.006,6,10,1779,5,928,1.0,660.0,660.0,5,851,1.0,583.0,583.0
0.005,17,2,146,1,65,0.0,37.0,37.0,1,81,0.0,53.0,53.0
0.061,6,10,1506,5,395,13.0,127.0,127.0,5,1111,14.0,843.0,843.0
0.066,6,10,1506,5,395,13.0,127.0,127.0,5,1111,15.0,843.0,843.0
0.004,17,2,148,1,60,0.0,32.0,32.0,1,88,0.0,60.0,60.0
0.006,6,10,1989,5,927,1.0,659.0,659.0,5,1062,1.0,794.0,794.0
15.071,17,15,9239,8,6902,2149.0,1350.0,834.0,7,2337,2507.0,1350.0,305.0
0.114,6,10,1506,5,395,27.0,127.0,127.0,5,1111,24.0,843.0,843.0
0.018,6,10,1972,5,910,4.0,642.0,642.0,5,1062,4.0,794.0,794.0
0.004,17,2,170,1,65,0.0,37.0,37.0,1,105,0.0,77.0,77.0
0.005,6,10,1547,5,764,1.0,496.0,496.0,5,783,1.0,515.0,515.0
0.004,6,10,1989,5,927,1.0,659.0,659.0,5,1062,1.0,794.0,794.0
0.08,6,10,1506,5,395,16.0,127.0,127.0,5,1111,16.0,843.0,843.0
0.005,6,10,2000,5,927,1.0,659.0,659.0,5,1073,1.0,805.0,805.0
0.004,6,10,1779,5,928,1.0,660.0,660.0,5,851,0.0,583.0,583.0
0.011,6,10,1989,5,910,2.0,642.0,642.0,5,1079,2.0,811.0,811.0
0.014,6,13,3735,7,497,2.0,125.0,125.0,6,3238,2.0,1470.0,1459.0
0.012,6,14,3787,7,497,1.0,125.0,125.0,7,3290,1.0,1448.0,972.0
0.005,6,10,2007,5,928,1.0,660.0,660.0,5,1079,1.0,811.0,811.0
40.054,17,10,676,5,460,10012.0,104.0,64.0,5,216,10012.0,20.0,15.0
0.037,17,2,148,1,60,0.0,32.0,32.0,1,88,0.0,60.0,60.0
0.005,6,10,1854,5,889,1.0,621.0,621.0,5,965,1.0,697.0,697.0
177.373,17,82,11512,41,2728,4434.0,44.0,38.0,41,8784,4434.0,261.0,186.0
0.009,6,10,1989,5,910,2.0,642.0,642.0,5,1079,2.0,811.0,811.0
240.129,6,31,9217,16,7001,16008.0,1515.0,617.0,15,2216,17151.0,580.0,204.0
0.01,17,2,136,1,60,0.0,32.0,32.0,1,76,0.0,48.0,48.0
40.072,17,10,676,5,460,10015.0,104.0,64.0,5,216,10017.0,20.0,15.0
0.005,6,10,1547,5,764,1.0,496.0,496.0,5,783,1.0,515.0,515.0
0.113,6,10,1506,5,395,24.0,127.0,127.0,5,1111,25.0,843.0,843.0
0.005,6,10,2000,5,927,1.0,659.0,659.0,5,1073,1.0,805.0,805.0
0.09,6,10,1506,5,395,19.0,127.0,127.0,5,1111,17.0,843.0,843.0
33.628,6,37,25429,20,17179,1769.0,2804.0,1467.0,17,8250,383.0,1402.0,1051.0
0.079,6,10,1506,5,395,16.0,127.0,127.0,5,1111,18.0,843.0,843.0
39.361,6,37,9595,18,4037,519.0,1572.0,821.0,19,5558,2177.0,1360.0,398.0
0.016,6,10,1983,5,910,3.0,642.0,642.0,5,1073,4.0,805.0,805.0
0.005,6,10,1643,5,860,1.0,592.0,592.0,5,783,1.0,515.0,515.0
10.844,17,28,4417,14,1994,825.0,269.0,114.0,14,2423,825.0,586.0,145.0
309.16,17,20,1124,10,716,34328.0,48.0,43.0,10,408,34328.0,20.0,12.0
0.071,17,2,182,1,65,0.0,37.0,37.0,1,117,0.0,89.0,89.0
0.001,17,2,179,1,62,0.0,34.0,34.0,1,117,0.0,89.0,89.0
0.012,6,10,1983,5,910,3.0,642.0,642.0,5,1073,3.0,805.0,805.0
0.001,17,2,164,1,74,0.0,46.0,46.0,1,90,0.0,62.0,62.0
11.105,17,28,4421,14,1993,844.0,268.0,114.0,14,2428,841.0,587.0,145.0
15.077,17,16,8696,8,6601,2149.0,1350.0,797.0,8,2095,2149.0,1350.0,233.0
0.057,6,10,1989,5,910,14.0,642.0,642.0,5,1079,14.0,811.0,811.0
0.079,6,10,1506,5,395,17.0,127.0,127.0,5,1111,16.0,843.0,843.0
0.072,17,8,3613,4,1874,24.0,1350.0,440.0,4,1739,12.0,1350.0,406.0
0.001,17,2,180,1,66,0.0,38.0,38.0,1,114,0.0,86.0,86.0
0.004,6,10,2007,5,928,1.0,660.0,660.0,5,1079,1.0,811.0,811.0
0.013,6,10,1990,5,911,3.0,643.0,643.0,5,1079,3.0,811.0,811.0
0.006,6,10,1547,5,764,1.0,496.0,496.0,5,783,1.0,515.0,515.0
0.127,17,4,284,2,120,0.0,32.0,32.0,2,164,123.0,60.0,54.0
0.005,6,10,2007,5,928,1.0,660.0,660.0,5,1079,1.0,811.0,811.0
0.006,6,10,1643,5,860,1.0,592.0,592.0,5,783,1.0,515.0,515.0
0.09,6,10,1506,5,395,18.0,127.0,127.0,5,1111,21.0,843.0,843.0
0.009,6,12,1926,6,1189,1.0,659.0,434.0,6,737,1.0,417.0,417.0
0.006,6,10,2000,5,927,1.0,659.0,659.0,5,1073,1.0,805.0,805.0
0.005,6,10,2007,5,928,1.0,660.0,660.0,5,1079,1.0,811.0,811.0
0.008,17,2,194,1,59,0.0,31.0,31.0,1,135,0.0,107.0,107.0
0.001,17,2,180,1,66,0.0,38.0,38.0,1,114,0.0,86.0,86.0
0.004,17,2,136,1,60,0.0,32.0,32.0,1,76,0.0,48.0,48.0
0.001,17,2,136,1,60,0.0,32.0,32.0,1,76,0.0,48.0,48.0
0.0,17,2,166,1,75,0.0,47.0,47.0,1,91,0.0,63.0,63.0
0.012,6,10,1983,5,910,3.0,642.0,642.0,5,1073,2.0,805.0,805.0
0.119,6,10,1506,5,395,27.0,127.0,127.0,5,1111,25.0,843.0,843.0
0.082,6,10,1506,5,395,19.0,127.0,127.0,5,1111,14.0,843.0,843.0
0.004,6,10,1989,5,927,1.0,659.0,659.0,5,1062,1.0,794.0,794.0
0.004,17,2,148,1,60,0.0,32.0,32.0,1,88,0.0,60.0,60.0
0.005,6,10,2006,5,927,1.0,659.0,659.0,5,1079,1.0,811.0,811.0
20.082,6,37,10002,19,4484,497.0,1360.0,738.0,18,5518,1171.0,2667.0,435.0
10.773,17,28,4423,14,1995,820.0,270.0,114.0,14,2428,820.0,587.0,145.0
178.57,17,78,10947,39,2591,4698.0,44.0,38.0,39,8356,4699.0,239.0,186.0
0.005,6,10,1547,5,764,1.0,496.0,496.0,5,783,1.0,515.0,515.0
0.005,17,2,170,1,65,0.0,37.0,37.0,1,105,0.0,77.0,77.0
0.037,6,13,3735,7,497,6.0,125.0,125.0,6,3238,7.0,1470.0,1459.0
0.042,17,4,420,2,122,0.0,33.0,33.0,2,298,39.0,145.0,121.0
40.064,17,10,676,5,460,10015.0,104.0,64.0,5,216,10015.0,20.0,15.0
0.04,17,2,152,1,76,0.0,48.0,48.0,1,76,0.0,48.0,48.0
0.005,17,4,284,2,120,0.0,32.0,32.0,2,164,1.0,60.0,54.0
0.08,6,10,1506,5,395,18.0,127.0,127.0,5,1111,17.0,843.0,843.0
0.088,6,10,1506,5,395,19.0,127.0,127.0,5,1111,20.0,843.0,843.0
0.091,6,10,1506,5,395,20.0,127.0,127.0,5,1111,21.0,843.0,843.0
0.005,6,10,2007,5,928,1.0,660.0,660.0,5,1079,1.0,811.0,811.0
10.815,17,28,4422,14,1994,823.0,269.0,114.0,14,2428,823.0,587.0,145.0
0.006,6,10,1547,5,764,1.0,496.0,496.0,5,783,1.0,515.0,515.0
0.037,17,4,284,2,120,0.0,32.0,32.0,2,164,34.0,60.0,54.0
0.005,6,10,1989,5,927,1.0,659.0,659.0,5,1062,1.0,794.0,794.0
0.078,6,10,1506,5,395,18.0,127.0,127.0,5,1111,16.0,843.0,843.0
0.001,17,2,180,1,66,0.0,38.0,38.0,1,114,0.0,86.0,86.0
0.006,6,10,1689,5,839,1.0,571.0,571.0,5,850,1.0,582.0,582.0
0.0,17,2,136,1,60,0.0,32.0,32.0,1,76,0.0,48.0,48.0
0.008,17,2,194,1,59,0.0,31.0,31.0,1,135,0.0,107.0,107.0
0.015,6,10,1989,5,910,3.0,642.0,642.0,5,1079,3.0,811.0,811.0
0.006,6,10,1547,5,764,1.0,496.0,496.0,5,783,1.0,515.0,515.0
0.01,6,10,1677,5,827,2.0,559.0,559.0,5,850,2.0,582.0,582.0
0.085,6,10,1506,5,395,18.0,127.0,127.0,5,1111,19.0,843.0,843.0
240.014,6,9,787,5,488,60003.0,232.0,232.0,4,299,80004.0,83.0,83.0
0.004,6,10,2007,5,928,1.0,660.0,660.0,5,1079,1.0,811.0,811.0
0.08,6,10,1506,5,395,17.0,127.0,127.0,5,1111,15.0,843.0,843.0
0.119,6,10,1506,5,395,24.0,127.0,127.0,5,1111,24.0,843.0,843.0
0.011,6,10,1762,5,911,2.0,643.0,643.0,5,851,2.0,583.0,583.0
0.127,6,10,1506,5,395,29.0,127.0,127.0,5,1111,25.0,843.0,843.0
0.074,6,10,1506,5,395,17.0,127.0,127.0,5,1111,15.0,843.0,843.0
40.059,17,10,676,5,460,10013.0,104.0,64.0,5,216,10014.0,20.0,15.0
0.01,6,10,1972,5,910,2.0,642.0,642.0,5,1062,2.0,794.0,794.0
0.004,17,2,136,1,60,0.0,32.0,32.0,1,76,0.0,48.0,48.0
0.072,6,10,1506,5,395,17.0,127.0,127.0,5,1111,17.0,843.0,843.0
240.476,6,81,79683,37,3243,6679.0,1046.0,437.0,44,76440,5592.0,2953.0,1853.0
0.006,6,10,1854,5,889,1.0,621.0,621.0,5,965,1.0,697.0,697.0
0.005,17,2,169,1,62,0.0,34.0,34.0,1,107,0.0,79.0,79.0
0.001,17,2,180,1,66,0.0,38.0,38.0,1,114,0.0,86.0,86.0
40.056,17,10,676,5,460,10013.0,104.0,64.0,5,216,10013.0,20.0,15.0
0.004,6,10,1989,5,927,1.0,659.0,659.0,5,1062,1.0,794.0,794.0
40.069,17,10,676,5,460,10013.0,104.0,64.0,5,216,10015.0,20.0,15.0
0.071,6,10,1506,5,395,14.0,127.0,127.0,5,1111,15.0,843.0,843.0
0.103,6,10,1506,5,395,20.0,127.0,127.0,5,1111,22.0,843.0,843.0
0.005,6,13,3747,7,509,0.0,137.0,137.0,6,3238,0.0,1470.0,1459.0
0.01,6,10,1990,5,911,2.0,643.0,643.0,5,1079,2.0,811.0,811.0
0.117,6,10,1506,5,395,22.0,127.0,127.0,5,1111,25.0,843.0,843.0
0.125,6,10,1506,5,395,28.0,127.0,127.0,5,1111,25.0,843.0,843.0
0.01,6,10,1983,5,910,2.0,642.0,642.0,5,1073,2.0,805.0,805.0
0.012,6,10,1972,5,910,3.0,642.0,642.0,5,1062,2.0,794.0,794.0
0.001,17,2,180,1,66,0.0,38.0,38.0,1,114,0.0,86.0,86.0
0.017,6,10,1990,5,911,4.0,643.0,643.0,5,1079,4.0,811.0,811.0
0.083,6,10,1506,5,395,18.0,127.0,127.0,5,1111,19.0,843.0,843.0
171.146,17,86,12396,43,2871,4074.0,44.0,38.0,43,9525,4074.0,261.0,193.0
0.018,6,10,1762,5,911,4.0,643.0,643.0,5,851,4.0,583.0,583.0
0.009,6,10,1972,5,910,2.0,642.0,642.0,5,1062,2.0,794.0,794.0
0.008,6,10,1989,5,910,2.0,642.0,642.0,5,1079,2.0,811.0,811.0
0.067,6,10,1506,5,395,14.0,127.0,127.0,5,1111,14.0,843.0,843.0
0.102,6,10,1506,5,395,24.0,127.0,127.0,5,1111,22.0,843.0,843.0
0.005,6,10,1643,5,860,1.0,592.0,592.0,5,783,1.0,515.0,515.0
0.009,6,12,1926,6,1189,1.0,659.0,434.0,6,737,1.0,417.0,417.0
0.007,6,10,1762,5,911,1.0,643.0,643.0,5,851,1.0,583.0,583.0
0.003,17,2,136,1,60,0.0,32.0,32.0,1,76,0.0,48.0,48.0
0.22,6,16,2669,8,1395,31.0,533.0,323.0,8,1274,20.0,529.0,212.0
0.088,6,10,1506,5,395,19.0,127.0,127.0,5,1111,17.0,843.0,843.0
0.003,17,2,148,1,60,0.0,32.0,32.0,1,88,0.0,60.0,60.0
40.055,17,10,676,5,460,10013.0,104.0,64.0,5,216,10013.0,20.0,15.0
173.108,17,84,11676,42,2806,4222.0,44.0,38.0,42,8870,4222.0,239.0,183.0
0.006,6,10,1689,5,839,1.0,571.0,571.0,5,850,1.0,582.0,582.0
11.107,17,28,4417,14,1994,842.0,269.0,114.0,14,2423,842.0,586.0,145.0
0.004,6,10,2006,5,927,1.0,659.0,659.0,5,1079,1.0,811.0,811.0
0.013,6,10,1972,5,910,3.0,642.0,642.0,5,1062,3.0,794.0,794.0
0.038,17,2,170,1,65,0.0,37.0,37.0,1,105,0.0,77.0,77.0
0.005,6,10,2007,5,928,1.0,660.0,660.0,5,1079,1.0,811.0,811.0
0.011,6,10,1983,5,910,2.0,642.0,642.0,5,1073,2.0,805.0,805.0
0.166,6,10,1506,5,395,37.0,127.0,127.0,5,1111,38.0,843.0,843.0
10.926,17,28,4418,14,1993,831.0,268.0,114.0,14,2425,831.0,588.0,145.0
0.041,17,2,144,1,64,0.0,36.0,36.0,1,80,0.0,52.0,52.0
0.015,6,10,1972,5,910,3.0,642.0,642.0,5,1062,3.0,794.0,794.0
0.06,17,2,152,1,76,0.0,48.0,48.0,1,76,0.0,48.0,48.0
0.012,6,10,1972,5,910,3.0,642.0,642.0,5,1062,2.0,794.0,794.0
0.005,6,10,2006,5,927,1.0,659.0,659.0,5,1079,1.0,811.0,811.0
0.012,6,10,1677,5,827,3.0,559.0,559.0,5,850,2.0,582.0,582.0
0.001,17,2,180,1,66,0.0,38.0,38.0,1,114,0.0,86.0,86.0
0.009,6,10,1989,5,910,2.0,642.0,642.0,5,1079,2.0,811.0,811.0
0.008,6,10,1989,5,910,2.0,642.0,642.0,5,1079,1.0,811.0,811.0
0.005,6,10,1854,5,889,1.0,621.0,621.0,5,965,1.0,697.0,697.0
0.003,17,2,162,1,65,0.0,37.0,37.0,1,97,0.0,69.0,69.0
11.04,17,28,4391,14,2313,840.0,588.0,137.0,14,2078,840.0,269.0,120.0
0.016,6,10,1972,5,910,4.0,642.0,642.0,5,1062,4.0,794.0,794.0
0.004,6,10,1989,5,927,1.0,659.0,659.0,5,1062,1.0,794.0,794.0
0.011,6,10,1983,5,910,2.0,642.0,642.0,5,1073,2.0,805.0,805.0
53.485,6,36,9526,18,4008,521.0,1543.0,814.0,18,5518,3136.0,2667.0,435.0
10.818,17,28,4420,14,1993,823.0,268.0,114.0,14,2427,823.0,586.0,145.0
0.082,6,10,1506,5,395,19.0,127.0,127.0,5,1111,14.0,843.0,843.0
0.004,6,10,2007,5,928,1.0,660.0,660.0,5,1079,1.0,811.0,811.0
0.005,6,10,1547,5,764,1.0,496.0,496.0,5,783,1.0,515.0,515.0
170.031,17,74,10575,37,2482,4723.0,44.0,39.0,37,8093,4723.0,239.0,190.0
0.089,6,10,1506,5,395,20.0,127.0,127.0,5,1111,19.0,843.0,843.0
0.038,17,2,179,1,71,0.0,43.0,43.0,1,108,0.0,80.0,80.0
1756.042,6,477,70745,272,36787,6479.0,613.0,189.0,205,33958,8607.0,538.0,152.0
0.137,6,10,1506,5,395,32.0,127.0,127.0,5,1111,33.0,843.0,843.0
0.005,6,10,1643,5,860,1.0,592.0,592.0,5,783,1.0,515.0,515.0
0.11,6,10,1506,5,395,24.0,127.0,127.0,5,1111,23.0,843.0,843.0
0.005,6,10,1547,5,764,1.0,496.0,496.0,5,783,1.0,515.0,515.0
0.004,6,10,2006,5,927,1.0,659.0,659.0,5,1079,1.0,811.0,811.0
0.042,17,2,184,1,61,0.0,33.0,33.0,1,123,0.0,95.0,95.0
0.005,6,10,2006,5,927,1.0,659.0,659.0,5,1079,1.0,811.0,811.0
165.123,17,76,10714,38,2536,4462.0,44.0,38.0,38,8178,4462.0,239.0,187.0
0.009,6,10,1631,5,848,2.0,580.0,580.0,5,783,2.0,515.0,515.0
0.098,6,10,1506,5,395,22.0,127.0,127.0,5,1111,20.0,843.0,843.0
40.061,17,10,676,5,460,10014.0,104.0,64.0,5,216,10014.0,20.0,15.0
0.007,6,10,1547,5,764,1.0,496.0,496.0,5,783,1.0,515.0,515.0
0.066,17,8,3613,4,1874,22.0,1350.0,440.0,4,1739,10.0,1350.0,406.0
0.091,6,10,1506,5,395,20.0,127.0,127.0,5,1111,20.0,843.0,843.0
0.017,6,10,1972,5,910,4.0,642.0,642.0,5,1062,4.0,794.0,794.0
0.014,6,10,1990,5,911,3.0,643.0,643.0,5,1079,3.0,811.0,811.0
0.006,6,10,1547,5,764,1.0,496.0,496.0,5,783,1.0,515.0,515.0
0.005,6,10,2006,5,927,1.0,659.0,659.0,5,1079,1.0,811.0,811.0
0.004,6,10,1702,5,863,1.0,595.0,595.0,5,839,0.0,571.0,571.0
0.005,6,10,1989,5,927,1.0,659.0,659.0,5,1062,1.0,794.0,794.0
0.23,17,16,8799,8,6373,32.0,1350.0,768.0,8,2426,24.0,1350.0,275.0
0.087,6,10,1506,5,395,19.0,127.0,127.0,5,1111,18.0,843.0,843.0
0.006,17,2,225,1,65,0.0,37.0,37.0,1,160,0.0,132.0,132.0
0.082,6,10,1506,5,395,17.0,127.0,127.0,5,1111,17.0,843.0,843.0
0.008,6,10,1990,5,911,2.0,643.0,643.0,5,1079,2.0,811.0,811.0
0.03,6,10,1989,5,910,7.0,642.0,642.0,5,1079,7.0,811.0,811.0
0.014,6,10,1989,5,910,3.0,642.0,642.0,5,1079,3.0,811.0,811.0
0.008,6,10,1972,5,910,2.0,642.0,642.0,5,1062,2.0,794.0,794.0
493.113,6,46,15327,24,3739,21439.0,676.0,413.0,22,11588,23481.0,1402.0,696.0
300.4,6,16,2170,9,684,37528.0,146.0,146.0,7,1486,50037.0,419.0,398.0
1799.841,6,142,6790,76,3625,23997.0,39.0,39.0,66,3165,27223.0,35.0,35.0
0.005,6,14,3799,7,509,0.0,137.0,137.0,7,3290,0.0,1448.0,972.0
0.016,17,2,136,1,60,0.0,32.0,32.0,1,76,0.0,48.0,48.0
0.014,6,10,1989,5,910,3.0,642.0,642.0,5,1079,3.0,811.0,811.0
0.147,6,10,1506,5,395,33.0,127.0,127.0,5,1111,35.0,843.0,843.0
0.004,17,2,136,1,60,0.0,32.0,32.0,1,76,0.0,48.0,48.0
0.004,17,2,148,1,60,0.0,32.0,32.0,1,88,0.0,60.0,60.0
240.02,6,9,787,5,488,60005.0,232.0,232.0,4,299,80005.0,83.0,83.0
0.148,6,10,1506,5,395,35.0,127.0,127.0,5,1111,31.0,843.0,843.0
0.006,6,10,1643,5,860,1.0,592.0,592.0,5,783,1.0,515.0,515.0
40.077,17,10,676,5,460,10016.0,104.0,64.0,5,216,10018.0,20.0,15.0
0.012,6,10,1972,5,910,2.0,642.0,642.0,5,1062,2.0,794.0,794.0
0.006,17,2,140,1,62,0.0,34.0,34.0,1,78,0.0,50.0,50.0
0.003,17,2,136,1,60,0.0,32.0,32.0,1,76,0.0,48.0,48.0
15.074,17,14,9190,8,6902,2149.0,1350.0,834.0,6,2288,3009.0,1350.0,353.0
0.003,17,2,148,1,60,0.0,32.0,32.0,1,88,0.0,60.0,60.0
0.004,17,2,136,1,60,0.0,32.0,32.0,1,76,0.0,48.0,48.0
0.004,6,10,1702,5,863,1.0,595.0,595.0,5,839,0.0,571.0,571.0
0.013,6,10,1989,5,910,3.0,642.0,642.0,5,1079,3.0,811.0,811.0
0.006,17,2,179,1,71,0.0,43.0,43.0,1,108,0.0,80.0,80.0
0.021,6,13,3735,7,497,3.0,125.0,125.0,6,3238,4.0,1470.0,1459.0
0.018,6,10,1989,5,910,4.0,642.0,642.0,5,1079,4.0,811.0,811.0
0.005,17,4,284,2,120,0.0,32.0,32.0,2,164,0.0,60.0,54.0
0.006,6,10,1547,5,764,1.0,496.0,496.0,5,783,1.0,515.0,515.0
0.004,6,10,1774,5,923,1.0,655.0,655.0,5,851,1.0,583.0,583.0
0.005,6,10,2007,5,928,1.0,660.0,660.0,5,1079,1.0,811.0,811.0
0.101,6,10,1506,5,395,22.0,127.0,127.0,5,1111,20.0,843.0,843.0
0.007,6,13,3690,7,452,1.0,80.0,80.0,6,3238,1.0,1470.0,1459.0
0.127,6,10,1506,5,395,29.0,127.0,127.0,5,1111,24.0,843.0,843.0
170.421,17,80,11138,40,2678,4369.0,44.0,38.0,40,8460,4369.0,239.0,183.0
0.009,6,10,1677,5,827,2.0,559.0,559.0,5,850,2.0,582.0,582.0
0.016,6,10,1762,5,911,3.0,643.0,643.0,5,851,3.0,583.0,583.0
0.007,6,10,1547,5,764,1.0,496.0,496.0,5,783,1.0,515.0,515.0
0.005,6,10,2006,5,927,1.0,659.0,659.0,5,1079,1.0,811.0,811.0
0.021,6,10,1990,5,911,5.0,643.0,643.0,5,1079,5.0,811.0,811.0
0.01,6,10,1677,5,827,2.0,559.0,559.0,5,850,2.0,582.0,582.0
0.005,6,10,1854,5,889,1.0,621.0,621.0,5,965,1.0,697.0,697.0
0.013,17,2,152,1,56,0.0,28.0,28.0,1,96,0.0,68.0,68.0
0.01,6,12,1926,6,1189,1.0,659.0,434.0,6,737,2.0,417.0,417.0
40.06,17,10,676,5,460,10014.0,104.0,64.0,5,216,10014.0,20.0,15.0
0.006,6,10,1547,5,764,1.0,496.0,496.0,5,783,1.0,515.0,515.0
240.248,6,44,5485,23,2593,10920.0,588.0,196.0,21,2892,12012.0,580.0,224.0
0.006,17,2,144,1,64,0.0,36.0,36.0,1,80,0.0,52.0,52.0
40.086,17,10,676,5,460,10015.0,104.0,64.0,5,216,10020.0,20.0,15.0
0.015,6,10,1989,5,910,3.0,642.0,642.0,5,1079,3.0,811.0,811.0
0.016,6,10,1990,5,911,4.0,643.0,643.0,5,1079,4.0,811.0,811.0
0.012,6,13,3735,7,497,1.0,125.0,125.0,6,3238,2.0,1470.0,1459.0
10.98,17,28,4397,14,2311,836.0,586.0,137.0,14,2086,836.0,269.0,121.0
294.819,6,436,351148,225,24267,1316.0,2736.0,870.0,211,326881,1403.0,2804.0,1611.0
40.059,17,10,676,5,460,10013.0,104.0,64.0,5,216,10013.0,20.0,15.0
0.102,6,10,1506,5,395,19.0,127.0,127.0,5,1111,22.0,843.0,843.0
0.185,6,10,1506,5,395,33.0,127.0,127.0,5,1111,41.0,843.0,843.0
0.112,6,10,1506,5,395,24.0,127.0,127.0,5,1111,24.0,843.0,843.0
0.012,6,10,1990,5,911,3.0,643.0,643.0,5,1079,2.0,811.0,811.0
0.004,17,4,284,2,120,1.0,32.0,32.0,2,164,1.0,60.0,54.0
0.012,6,10,1972,5,910,3.0,642.0,642.0,5,1062,3.0,794.0,794.0
0.117,6,10,1506,5,395,24.0,127.0,127.0,5,1111,23.0,843.0,843.0
0.014,6,10,1631,5,848,3.0,580.0,580.0,5,783,3.0,515.0,515.0
900.383,6,75,17175,49,13906,18757.0,494.0,494.0,26,3269,36015.0,83.0,83.0
0.084,6,10,1506,5,395,18.0,127.0,127.0,5,1111,16.0,843.0,843.0
0.082,6,10,1506,5,395,18.0,127.0,127.0,5,1111,15.0,843.0,843.0
0.005,6,14,3742,8,504,0.0,80.0,80.0,6,3238,1.0,1470.0,1459.0
0.014,6,10,1989,5,910,3.0,642.0,642.0,5,1079,3.0,811.0,811.0
0.001,17,2,136,1,60,0.0,32.0,32.0,1,76,0.0,48.0,48.0
0.006,6,10,1547,5,764,1.0,496.0,496.0,5,783,1.0,515.0,515.0
40.056,17,10,676,5,460,10013.0,104.0,64.0,5,216,10012.0,20.0,15.0
40.062,17,10,676,5,460,10014.0,104.0,64.0,5,216,10014.0,20.0,15.0
0.009,6,10,1989,5,910,2.0,642.0,642.0,5,1079,2.0,811.0,811.0
0.004,6,10,2007,5,928,1.0,660.0,660.0,5,1079,1.0,811.0,811.0
0.007,6,10,1854,5,889,1.0,621.0,621.0,5,965,1.0,697.0,697.0
240.085,6,31,9075,15,6823,17148.0,1949.0,671.0,16,2252,16005.0,580.0,176.0
0.012,6,10,1990,5,911,3.0,643.0,643.0,5,1079,2.0,811.0,811.0
0.103,6,10,1506,5,395,22.0,127.0,127.0,5,1111,21.0,843.0,843.0
0.001,17,2,136,1,60,0.0,32.0,32.0,1,76,0.0,48.0,48.0
0.008,6,14,3787,7,497,1.0,125.0,125.0,7,3290,1.0,1448.0,972.0
0.009,6,10,1762,5,911,2.0,643.0,643.0,5,851,2.0,583.0,583.0
0.004,17,2,136,1,60,0.0,32.0,32.0,1,76,0.0,48.0,48.0
0.136,6,10,1506,5,395,31.0,127.0,127.0,5,1111,31.0,843.0,843.0
0.016,6,10,1989,5,910,3.0,642.0,642.0,5,1079,4.0,811.0,811.0
0.005,6,10,1854,5,889,1.0,621.0,621.0,5,965,1.0,697.0,697.0
0.005,6,10,1989,5,927,1.0,659.0,659.0,5,1062,1.0,794.0,794.0
0.008,6,12,1926,6,1189,1.0,659.0,434.0,6,737,1.0,417.0,417.0
240.084,6,16,4481,9,963,30010.0,238.0,166.0,7,3518,40012.0,1402.0,786.0
0.004,17,2,170,1,65,0.0,37.0,37.0,1,105,0.0,77.0,77.0
0.01,6,10,1677,5,827,2.0,559.0,559.0,5,850,2.0,582.0,582.0
0.037,17,2,182,1,65,0.0,37.0,37.0,1,117,0.0,89.0,89.0
0.005,6,10,1689,5,839,1.0,571.0,571.0,5,850,1.0,582.0,582.0
0.012,6,10,1983,5,910,3.0,642.0,642.0,5,1073,2.0,805.0,805.0
0.005,6,10,2006,5,927,1.0,659.0,659.0,5,1079,1.0,811.0,811.0
177.312,17,78,11084,39,2588,4665.0,44.0,38.0,39,8496,4666.0,261.0,189.0
0.006,6,10,1854,5,889,1.0,621.0,621.0,5,965,1.0,697.0,697.0
0.09,6,10,1506,5,395,18.0,127.0,127.0,5,1111,20.0,843.0,843.0
0.005,6,10,2007,5,928,1.0,660.0,660.0,5,1079,1.0,811.0,811.0
0.083,6,10,1506,5,395,19.0,127.0,127.0,5,1111,18.0,843.0,843.0
0.016,6,10,1990,5,911,4.0,643.0,643.0,5,1079,4.0,811.0,811.0
0.001,17,2,132,1,58,0.0,30.0,30.0,1,74,0.0,46.0,46.0
0.004,17,4,284,2,120,0.0,32.0,32.0,2,164,0.0,60.0,54.0
0.005,6,10,1643,5,860,1.0,592.0,592.0,5,783,1.0,515.0,515.0
0.012,6,10,1972,5,910,3.0,642.0,642.0,5,1062,2.0,794.0,794.0
0.008,6,10,1631,5,848,2.0,580.0,580.0,5,783,2.0,515.0,515.0
0.071,6,10,1506,5,395,17.0,127.0,127.0,5,1111,13.0,843.0,843.0
0.004,6,10,2006,5,927,1.0,659.0,659.0,5,1079,1.0,811.0,811.0
0.01,6,10,1990,5,911,2.0,643.0,643.0,5,1079,2.0,811.0,811.0
0.004,17,2,184,1,61,0.0,33.0,33.0,1,123,0.0,95.0,95.0
377.516,6,22,2313,16,867,25167.0,195.0,195.0,6,1446,4638.0,419.0,398.0
0.005,17,2,179,1,71,0.0,43.0,43.0,1,108,0.0,80.0,80.0
0.122,6,14,4388,8,923,17.0,238.0,166.0,6,3465,16.0,1402.0,786.0
0.019,6,10,1990,5,911,4.0,643.0,643.0,5,1079,4.0,811.0,811.0
0.08,6,10,1506,5,395,17.0,127.0,127.0,5,1111,18.0,843.0,843.0
0.022,6,10,1989,5,910,5.0,642.0,642.0,5,1079,5.0,811.0,811.0
0.006,6,10,2006,5,927,1.0,659.0,659.0,5,1079,1.0,811.0,811.0
0.004,17,2,148,1,60,0.0,32.0,32.0,1,88,0.0,60.0,60.0
40.067,17,10,676,5,460,10016.0,104.0,64.0,5,216,10015.0,20.0,15.0
0.005,6,10,1989,5,927,1.0,659.0,659.0,5,1062,1.0,794.0,794.0
0.083,6,10,1506,5,395,17.0,127.0,127.0,5,1111,17.0,843.0,843.0
0.004,6,10,1779,5,928,1.0,660.0,660.0,5,851,1.0,583.0,583.0
1.007,6,37,21589,19,14925,55.0,2720.0,1570.0,18,6664,47.0,2720.0,988.0
15.071,17,15,9238,8,6902,2149.0,1350.0,834.0,7,2336,2506.0,1350.0,305.0
241.67,6,309,344287,124,17954,1964.0,2736.0,885.0,185,326333,1313.0,2804.0,1809.0
0.018,6,10,1990,5,911,4.0,643.0,643.0,5,1079,4.0,811.0,811.0
0.005,6,10,2006,5,927,1.0,659.0,659.0,5,1079,1.0,811.0,811.0
0.107,6,10,1506,5,395,24.0,127.0,127.0,5,1111,24.0,843.0,843.0
0.005,17,2,170,1,65,0.0,37.0,37.0,1,105,0.0,77.0,77.0
0.003,17,2,136,1,60,0.0,32.0,32.0,1,76,0.0,48.0,48.0
0.006,6,10,1854,5,889,1.0,621.0,621.0,5,965,1.0,697.0,697.0
1777.651,17,144,45504,72,22752,25036.0,288.0,288.0,72,22752,25036.0,288.0,288.0
0.006,6,10,1989,5,927,1.0,659.0,659.0,5,1062,1.0,794.0,794.0
0.006,6,10,1547,5,764,1.0,496.0,496.0,5,783,1.0,515.0,515.0
0.023,6,10,1989,5,910,5.0,642.0,642.0,5,1079,5.0,811.0,811.0
0.135,17,2,80,1,32,0.0,4.0,4.0,1,48,0.0,20.0,20.0
0.01,6,11,2024,6,962,2.0,642.0,642.0,5,1062,2.0,794.0,794.0
0.0,17,2,166,1,75,0.0,47.0,47.0,1,91,0.0,63.0,63.0
413.299,6,29,4409,12,3102,10913.0,494.0,494.0,17,1307,25830.0,83.0,83.0
0.134,17,2,182,1,65,0.0,37.0,37.0,1,117,0.0,89.0,89.0
0.005,17,2,136,1,60,0.0,32.0,32.0,1,76,0.0,48.0,48.0
0.006,17,2,273,1,66,0.0,38.0,38.0,1,207,0.0,179.0,179.0
0.111,6,10,1506,5,395,25.0,127.0,127.0,5,1111,26.0,843.0,843.0
0.006,6,10,1989,5,927,1.0,659.0,659.0,5,1062,1.0,794.0,794.0
0.092,6,10,1506,5,395,20.0,127.0,127.0,5,1111,18.0,843.0,843.0
0.014,6,10,1990,5,911,3.0,643.0,643.0,5,1079,3.0,811.0,811.0
0.004,6,10,1989,5,927,1.0,659.0,659.0,5,1062,1.0,794.0,794.0
0.005,6,10,2006,5,927,1.0,659.0,659.0,5,1079,1.0,811.0,811.0
0.004,6,10,2006,5,927,1.0,659.0,659.0,5,1079,1.0,811.0,811.0
0.085,6,10,1506,5,395,19.0,127.0,127.0,5,1111,20.0,843.0,843.0
0.004,17,2,136,1,60,0.0,32.0,32.0,1,76,0.0,48.0,48.0
0.004,17,2,148,1,60,0.0,32.0,32.0,1,88,0.0,60.0,60.0
0.006,6,10,1547,5,764,1.0,496.0,496.0,5,783,1.0,515.0,515.0
0.005,17,2,169,1,62,0.0,34.0,34.0,1,107,0.0,79.0,79.0
0.005,6,10,2000,5,927,1.0,659.0,659.0,5,1073,1.0,805.0,805.0
0.009,6,14,3787,7,497,1.0,125.0,125.0,7,3290,1.0,1448.0,972.0
0.105,6,10,1506,5,395,22.0,127.0,127.0,5,1111,20.0,843.0,843.0
240.089,6,16,4481,9,963,30011.0,238.0,166.0,7,3518,40014.0,1402.0,786.0
40.079,17,10,676,5,460,10016.0,104.0,64.0,5,216,10017.0,20.0,15.0
0.004,6,10,2006,5,927,1.0,659.0,659.0,5,1079,1.0,811.0,811.0
0.006,6,10,1547,5,764,1.0,496.0,496.0,5,783,1.0,515.0,515.0
0.007,17,2,194,1,59,0.0,31.0,31.0,1,135,0.0,107.0,107.0
0.008,6,10,1989,5,910,2.0,642.0,642.0,5,1079,2.0,811.0,811.0
0.009,6,10,2006,5,927,2.0,659.0,659.0,5,1079,2.0,811.0,811.0
0.021,6,10,1990,5,911,5.0,643.0,643.0,5,1079,5.0,811.0,811.0
0.005,6,10,2000,5,927,1.0,659.0,659.0,5,1073,1.0,805.0,805.0
0.004,6,10,2006,5,927,1.0,659.0,659.0,5,1079,1.0,811.0,811.0
0.004,17,2,148,1,60,0.0,32.0,32.0,1,88,0.0,60.0,60.0
1788.982,6,240,46388,115,33880,15692.0,2471.0,995.0,125,12508,14427.0,580.0,61.0
0.111,6,10,1506,5,395,25.0,127.0,127.0,5,1111,24.0,843.0,843.0
0.012,6,10,1989,5,910,3.0,642.0,642.0,5,1079,2.0,811.0,811.0
0.037,17,2,148,1,60,0.0,32.0,32.0,1,88,0.0,60.0,60.0
1798.235,17,2609,199858,1303,105574,1381.0,84.0,53.0,1306,94284,1377.0,225.0,44.0
0.001,17,2,179,1,62,0.0,34.0,34.0,1,117,0.0,89.0,89.0
0.01,17,2,194,1,59,0.0,31.0,31.0,1,135,0.0,107.0,107.0
0.012,6,10,1983,5,910,3.0,642.0,642.0,5,1073,3.0,805.0,805.0
0.004,6,10,1989,5,927,1.0,659.0,659.0,5,1062,1.0,794.0,794.0
0.096,6,10,1506,5,395,22.0,127.0,127.0,5,1111,21.0,843.0,843.0
40.078,17,10,676,5,460,10017.0,104.0,64.0,5,216,10018.0,20.0,15.0
0.009,6,10,1989,5,910,2.0,642.0,642.0,5,1079,2.0,811.0,811.0
0.004,6,10,1702,5,863,1.0,595.0,595.0,5,839,0.0,571.0,571.0
0.003,17,2,136,1,60,0.0,32.0,32.0,1,76,0.0,48.0,48.0
300.345,6,16,2170,9,684,37522.0,146.0,146.0,7,1486,50030.0,419.0,398.0
0.013,6,10,1972,5,910,3.0,642.0,642.0,5,1062,3.0,794.0,794.0
0.014,6,10,1983,5,910,3.0,642.0,642.0,5,1073,3.0,805.0,805.0
0.074,6,10,1983,5,910,18.0,642.0,642.0,5,1073,18.0,805.0,805.0
10.821,17,28,4417,14,1994,823.0,269.0,114.0,14,2423,823.0,586.0,145.0
0.004,17,2,148,1,60,0.0,32.0,32.0,1,88,0.0,60.0,60.0
0.005,6,10,2006,5,927,1.0,659.0,659.0,5,1079,1.0,811.0,811.0
11.023,17,28,4394,14,2313,839.0,588.0,137.0,14,2081,839.0,268.0,120.0
0.009,6,10,1989,5,910,2.0,642.0,642.0,5,1079,2.0,811.0,811.0
0.005,6,13,3747,7,509,0.0,137.0,137.0,6,3238,1.0,1470.0,1459.0
40.053,17,10,676,5,460,10012.0,104.0,64.0,5,216,10012.0,20.0,15.0
0.003,17,2,136,1,60,0.0,32.0,32.0,1,76,0.0,48.0,48.0
0.108,6,10,1506,5,395,25.0,127.0,127.0,5,1111,23.0,843.0,843.0
0.011,6,10,1989,5,910,2.0,642.0,642.0,5,1079,2.0,811.0,811.0
0.017,6,10,1983,5,910,4.0,642.0,642.0,5,1073,4.0,805.0,805.0
0.04,6,10,1983,5,910,10.0,642.0,642.0,5,1073,9.0,805.0,805.0
240.091,6,16,4480,9,963,30011.0,238.0,166.0,7,3517,40014.0,1402.0,786.0
15.157,17,21,13557,10,8346,1680.0,1350.0,806.0,11,5211,1512.0,1350.0,445.0
0.005,6,10,2006,5,927,1.0,659.0,659.0,5,1079,1.0,811.0,811.0
0.004,6,10,2006,5,927,1.0,659.0,659.0,5,1079,1.0,811.0,811.0
0.005,6,10,2006,5,927,1.0,659.0,659.0,5,1079,1.0,811.0,811.0
0.016,6,10,1989,5,910,4.0,642.0,642.0,5,1079,3.0,811.0,811.0
0.088,6,10,1506,5,395,19.0,127.0,127.0,5,1111,21.0,843.0,843.0
0.012,6,10,1990,5,911,3.0,643.0,643.0,5,1079,2.0,811.0,811.0
1730.367,6,45,2790,30,1725,59667.0,35.0,35.0,15,1065,123592.0,31.0,31.0
0.001,17,2,178,1,81,0.0,53.0,53.0,1,97,0.0,69.0,69.0
0.005,6,13,3690,7,452,0.0,80.0,80.0,6,3238,1.0,1470.0,1459.0
240.078,6,9,787,5,488,60019.0,232.0,232.0,4,299,80010.0,83.0,83.0
0.018,17,2,150,1,67,0.0,39.0,39.0,1,83,0.0,55.0,55.0
0.005,17,2,168,1,76,0.0,48.0,48.0,1,92,0.0,64.0,64.0
0.093,6,10,1506,5,395,21.0,127.0,127.0,5,1111,21.0,843.0,843.0
0.005,6,10,2007,5,928,1.0,660.0,660.0,5,1079,1.0,811.0,811.0
0.017,6,10,1762,5,911,4.0,643.0,643.0,5,851,4.0,583.0,583.0
40.059,17,10,676,5,460,10013.0,104.0,64.0,5,216,10014.0,20.0,15.0
0.103,6,10,1506,5,395,21.0,127.0,127.0,5,1111,23.0,843.0,843.0
1770.609,17,92,8096,46,4048,39346.0,60.0,60.0,46,4048,39346.0,60.0,60.0
0.019,6,10,1989,5,910,4.0,642.0,642.0,5,1079,4.0,811.0,811.0
0.017,6,10,1989,5,910,4.0,642.0,642.0,5,1079,4.0,811.0,811.0
0.001,17,2,180,1,66,0.0,38.0,38.0,1,114,0.0,86.0,86.0
0.003,17,2,132,1,58,0.0,30.0,30.0,1,74,0.0,46.0,46.0
40.054,17,10,676,5,460,10012.0,104.0,64.0,5,216,10012.0,20.0,15.0
0.013,17,2,152,1,56,0.0,28.0,28.0,1,96,0.0,68.0,68.0
0.021,6,10,1989,5,910,5.0,642.0,642.0,5,1079,5.0,811.0,811.0
0.092,6,10,1506,5,395,19.0,127.0,127.0,5,1111,22.0,843.0,843.0
0.015,6,10,1677,5,827,3.0,559.0,559.0,5,850,3.0,582.0,582.0
0.005,6,14,3742,7,452,0.0,80.0,80.0,7,3290,0.0,1448.0,972.0
240.012,6,9,787,5,488,60003.0,232.0,232.0,4,299,80003.0,83.0,83.0
0.004,17,2,234,1,61,0.0,33.0,33.0,1,173,0.0,145.0,145.0
0.006,17,2,154,1,69,0.0,41.0,41.0,1,85,0.0,57.0,57.0
0.006,6,10,1689,5,839,1.0,571.0,571.0,5,850,1.0,582.0,582.0
0.018,6,12,1926,6,1189,3.0,659.0,434.0,6,737,3.0,417.0,417.0
0.084,17,2,184,1,61,0.0,33.0,33.0,1,123,0.0,95.0,95.0
0.014,6,10,1983,5,910,3.0,642.0,642.0,5,1073,3.0,805.0,805.0
0.005,6,13,3747,7,509,0.0,137.0,137.0,6,3238,1.0,1470.0,1459.0
1770.698,17,120,11460,60,5460,30011.0,63.0,63.0,60,6000,30011.0,72.0,72.0
0.004,6,10,1779,5,928,1.0,660.0,660.0,5,851,1.0,583.0,583.0
0.013,6,10,1990,5,911,3.0,643.0,643.0,5,1079,3.0,811.0,811.0
0.001,17,2,136,1,60,0.0,32.0,32.0,1,76,0.0,48.0,48.0
175.354,17,82,11511,41,2721,4383.0,44.0,38.0,41,8790,4383.0,239.0,186.0
0.005,6,10,2006,5,927,1.0,659.0,659.0,5,1079,1.0,811.0,811.0
0.085,6,10,1506,5,395,19.0,127.0,127.0,5,1111,17.0,843.0,843.0
0.008,17,2,148,1,60,0.0,32.0,32.0,1,88,0.0,60.0,60.0
0.017,6,10,1972,5,910,4.0,642.0,642.0,5,1062,4.0,794.0,794.0
0.043,17,2,152,1,76,0.0,48.0,48.0,1,76,0.0,48.0,48.0
0.011,6,10,1989,5,910,2.0,642.0,642.0,5,1079,2.0,811.0,811.0
0.007,6,10,1547,5,764,1.0,496.0,496.0,5,783,1.0,515.0,515.0
0.008,6,10,1983,5,910,2.0,642.0,642.0,5,1073,2.0,805.0,805.0
0.008,6,12,1926,6,1189,1.0,659.0,434.0,6,737,1.0,417.0,417.0
0.041,17,2,152,1,76,0.0,48.0,48.0,1,76,0.0,48.0,48.0
171.25,17,82,11845,41,2761,4281.0,44.0,39.0,41,9084,4280.0,239.0,193.0
0.006,6,10,1854,5,889,1.0,621.0,621.0,5,965,1.0,697.0,697.0
0.006,6,10,1547,5,764,1.0,496.0,496.0,5,783,1.0,515.0,515.0
0.001,17,2,166,1,75,0.0,47.0,47.0,1,91,0.0,63.0,63.0
10.886,17,26,4103,13,1823,898.0,270.0,112.0,13,2280,898.0,587.0,147.0
0.005,6,10,1774,5,923,1.0,655.0,655.0,5,851,1.0,583.0,583.0
0.005,17,2,166,1,75,0.0,47.0,47.0,1,91,0.0,63.0,63.0
0.004,6,10,2000,5,927,1.0,659.0,659.0,5,1073,1.0,805.0,805.0
0.006,6,10,1547,5,764,1.0,496.0,496.0,5,783,1.0,515.0,515.0
40.073,17,10,676,5,460,10016.0,104.0,64.0,5,216,10017.0,20.0,15.0
0.072,17,2,128,1,56,0.0,28.0,28.0,1,72,0.0,44.0,44.0
0.012,6,10,1972,5,910,2.0,642.0,642.0,5,1062,3.0,794.0,794.0
0.006,17,2,213,1,69,0.0,41.0,41.0,1,144,0.0,116.0,116.0
0.019,6,10,1762,5,911,4.0,643.0,643.0,5,851,4.0,583.0,583.0
0.094,6,10,1506,5,395,21.0,127.0,127.0,5,1111,18.0,843.0,843.0
0.163,17,2,152,1,76,0.0,48.0,48.0,1,76,0.0,48.0,48.0
0.016,6,10,1989,5,910,4.0,642.0,642.0,5,1079,3.0,811.0,811.0
0.004,6,10,1702,5,863,1.0,595.0,595.0,5,839,0.0,571.0,571.0
0.006,6,10,1643,5,860,1.0,592.0,592.0,5,783,1.0,515.0,515.0
0.004,17,2,148,1,60,0.0,32.0,32.0,1,88,0.0,60.0,60.0
0.004,6,10,1774,5,923,1.0,655.0,655.0,5,851,0.0,583.0,583.0
0.008,17,2,194,1,59,0.0,31.0,31.0,1,135,0.0,107.0,107.0
10.822,17,28,4422,14,1995,824.0,270.0,114.0,14,2427,824.0,586.0,145.0
0.005,6,10,1689,5,839,1.0,571.0,571.0,5,850,1.0,582.0,582.0
0.012,6,10,1972,5,910,3.0,642.0,642.0,5,1062,2.0,794.0,794.0
0.123,6,10,1506,5,395,27.0,127.0,127.0,5,1111,24.0,843.0,843.0
0.072,17,2,148,1,60,0.0,32.0,32.0,1,88,0.0,60.0,60.0
0.038,17,2,182,1,65,0.0,37.0,37.0,1,117,0.0,89.0,89.0
0.005,6,13,3747,7,509,0.0,137.0,137.0,6,3238,1.0,1470.0,1459.0
0.006,6,10,2007,5,928,1.0,660.0,660.0,5,1079,1.0,811.0,811.0
0.039,17,4,352,2,130,1.0,37.0,37.0,2,222,35.0,89.0,83.0
0.006,6,13,3747,7,509,0.0,137.0,137.0,6,3238,1.0,1470.0,1459.0
40.069,17,10,676,5,460,10016.0,104.0,64.0,5,216,10015.0,20.0,15.0
0.006,6,10,1689,5,839,1.0,571.0,571.0,5,850,1.0,582.0,582.0
0.011,6,10,1990,5,911,2.0,643.0,643.0,5,1079,2.0,811.0,811.0
300.302,6,26,7352,15,1357,21450.0,217.0,142.0,11,5995,24025.0,1402.0,773.0
15.076,17,15,9238,8,6902,2149.0,1350.0,834.0,7,2336,2507.0,1350.0,305.0
0.165,17,2,152,1,76,0.0,48.0,48.0,1,76,0.0,48.0,48.0
0.006,6,10,2006,5,927,1.0,659.0,659.0,5,1079,1.0,811.0,811.0
0.004,6,10,2007,5,928,1.0,660.0,660.0,5,1079,1.0,811.0,811.0
0.007,17,2,148,1,60,0.0,32.0,32.0,1,88,0.0,60.0,60.0
300.376,6,16,2170,9,684,37525.0,146.0,146.0,7,1486,50035.0,419.0,398.0
0.011,6,10,1990,5,911,2.0,643.0,643.0,5,1079,2.0,811.0,811.0
0.18,6,10,1506,5,395,39.0,127.0,127.0,5,1111,40.0,843.0,843.0
264.367,17,18,1008,9,640,33030.0,48.0,43.0,9,368,33030.0,20.0,12.0
0.138,6,10,1506,5,395,30.0,127.0,127.0,5,1111,32.0,843.0,843.0
363.249,6,23,2316,17,870,22703.0,146.0,146.0,6,1446,4662.0,419.0,398.0
0.003,17,2,148,1,60,0.0,32.0,32.0,1,88,0.0,60.0,60.0
0.003,17,2,148,1,60,0.0,32.0,32.0,1,88,0.0,60.0,60.0
0.015,6,10,1989,5,910,3.0,642.0,642.0,5,1079,3.0,811.0,811.0
0.008,6,10,1983,5,910,2.0,642.0,642.0,5,1073,2.0,805.0,805.0
0.005,6,10,2006,5,927,1.0,659.0,659.0,5,1079,1.0,811.0,811.0
1794.301,6,567,190690,293,164039,6144.0,2883.0,947.0,274,26651,6572.0,384.0,118.0
0.004,17,4,284,2,120,0.0,32.0,32.0,2,164,1.0,60.0,54.0
0.005,6,10,2000,5,927,1.0,659.0,659.0,5,1073,1.0,805.0,805.0
0.074,6,10,1506,5,395,15.0,127.0,127.0,5,1111,15.0,843.0,843.0
353.518,6,20,2210,6,1308,12004.0,494.0,494.0,14,902,27193.0,83.0,83.0
0.005,6,13,3747,7,509,0.0,137.0,137.0,6,3238,0.0,1470.0,1459.0
40.071,17,10,676,5,460,10016.0,104.0,64.0,5,216,10017.0,20.0,15.0
0.005,6,10,2007,5,928,1.0,660.0,660.0,5,1079,1.0,811.0,811.0
0.104,6,10,1506,5,395,22.0,127.0,127.0,5,1111,23.0,843.0,843.0
0.006,6,10,1643,5,860,1.0,592.0,592.0,5,783,1.0,515.0,515.0
0.001,17,2,180,1,66,0.0,38.0,38.0,1,114,0.0,86.0,86.0
0.004,17,2,136,1,60,0.0,32.0,32.0,1,76,0.0,48.0,48.0
0.004,6,10,1702,5,863,0.0,595.0,595.0,5,839,1.0,571.0,571.0
15.072,17,15,9238,8,6902,2149.0,1350.0,834.0,7,2336,2507.0,1350.0,305.0
0.018,6,10,1983,5,910,4.0,642.0,642.0,5,1073,4.0,805.0,805.0
0.005,6,10,1854,5,889,1.0,621.0,621.0,5,965,1.0,697.0,697.0
0.005,6,10,1854,5,889,1.0,621.0,621.0,5,965,1.0,697.0,697.0
0.07,6,10,1506,5,395,14.0,127.0,127.0,5,1111,15.0,843.0,843.0
0.008,6,10,1762,5,911,2.0,643.0,643.0,5,851,2.0,583.0,583.0
0.108,17,2,80,1,32,0.0,4.0,4.0,1,48,0.0,20.0,20.0
0.001,17,2,180,1,66,0.0,38.0,38.0,1,114,0.0,86.0,86.0
0.008,6,10,1989,5,927,1.0,659.0,659.0,5,1062,1.0,794.0,794.0
292.142,6,380,347923,189,21385,1553.0,2736.0,888.0,191,326538,1537.0,2804.0,1788.0
0.007,6,10,1762,5,911,1.0,643.0,643.0,5,851,1.0,583.0,583.0
0.005,6,10,1547,5,764,1.0,496.0,496.0,5,783,1.0,515.0,515.0
0.005,6,10,2006,5,927,1.0,659.0,659.0,5,1079,1.0,811.0,811.0
0.013,6,10,1990,5,911,3.0,643.0,643.0,5,1079,3.0,811.0,811.0
0.028,6,10,1989,5,910,7.0,642.0,642.0,5,1079,7.0,811.0,811.0
0.053,17,2,152,1,76,0.0,48.0,48.0,1,76,0.0,48.0,48.0
0.012,6,10,1989,5,910,3.0,642.0,642.0,5,1079,3.0,811.0,811.0
0.017,6,10,1972,5,910,4.0,642.0,642.0,5,1062,4.0,794.0,794.0
0.012,6,10,1989,5,910,3.0,642.0,642.0,5,1079,2.0,811.0,811.0
0.015,6,10,1972,5,910,3.0,642.0,642.0,5,1062,3.0,794.0,794.0
0.013,6,10,1631,5,848,3.0,580.0,580.0,5,783,3.0,515.0,515.0
0.005,6,10,1854,5,889,1.0,621.0,621.0,5,965,1.0,697.0,697.0
0.001,17,2,180,1,66,0.0,38.0,38.0,1,114,0.0,86.0,86.0
0.005,6,10,1989,5,927,1.0,659.0,659.0,5,1062,1.0,794.0,794.0
0.167,6,28,8650,15,2371,11.0,660.0,318.0,13,6279,13.0,1402.0,699.0
0.007,6,14,3742,8,504,0.0,80.0,80.0,6,3238,1.0,1470.0,1459.0
0.005,6,10,1989,5,927,1.0,659.0,659.0,5,1062,1.0,794.0,794.0
0.118,6,10,1506,5,395,29.0,127.0,127.0,5,1111,27.0,843.0,843.0
0.001,17,2,180,1,66,0.0,38.0,38.0,1,114,0.0,86.0,86.0
0.005,6,10,1689,5,839,1.0,571.0,571.0,5,850,1.0,582.0,582.0
0.004,17,2,162,1,65,0.0,37.0,37.0,1,97,0.0,69.0,69.0
0.006,17,2,170,1,65,0.0,37.0,37.0,1,105,0.0,77.0,77.0
0.085,6,10,1506,5,395,19.0,127.0,127.0,5,1111,18.0,843.0,843.0
0.004,6,10,2007,5,928,1.0,660.0,660.0,5,1079,1.0,811.0,811.0
0.019,6,10,1990,5,911,4.0,643.0,643.0,5,1079,4.0,811.0,811.0
0.006,17,2,214,1,75,0.0,47.0,47.0,1,139,0.0,111.0,111.0
0.105,6,10,1506,5,395,22.0,127.0,127.0,5,1111,24.0,843.0,843.0
10.817,17,28,4421,14,1993,823.0,268.0,114.0,14,2428,823.0,587.0,145.0
0.016,6,10,1972,5,910,4.0,642.0,642.0,5,1062,3.0,794.0,794.0
0.009,6,10,1983,5,910,2.0,642.0,642.0,5,1073,2.0,805.0,805.0
0.005,6,10,1989,5,927,1.0,659.0,659.0,5,1062,1.0,794.0,794.0
10.844,17,28,4423,14,1994,825.0,269.0,114.0,14,2429,825.0,588.0,145.0
0.005,6,10,2007,5,928,1.0,660.0,660.0,5,1079,1.0,811.0,811.0
0.005,6,10,1689,5,839,1.0,571.0,571.0,5,850,1.0,582.0,582.0
0.01,6,10,1677,5,827,2.0,559.0,559.0,5,850,2.0,582.0,582.0
0.107,6,10,1506,5,395,19.0,127.0,127.0,5,1111,23.0,843.0,843.0
40.07,17,10,676,5,460,10014.0,104.0,64.0,5,216,10015.0,20.0,15.0
0.055,17,2,179,1,71,0.0,43.0,43.0,1,108,0.0,80.0,80.0
0.121,6,10,1506,5,395,29.0,127.0,127.0,5,1111,23.0,843.0,843.0
0.105,6,10,1506,5,395,22.0,127.0,127.0,5,1111,18.0,843.0,843.0
0.078,6,10,1506,5,395,15.0,127.0,127.0,5,1111,17.0,843.0,843.0
0.08,6,10,1506,5,395,18.0,127.0,127.0,5,1111,17.0,843.0,843.0
0.003,17,2,148,1,60,0.0,32.0,32.0,1,88,0.0,60.0,60.0
0.01,6,10,1989,5,910,2.0,642.0,642.0,5,1079,2.0,811.0,811.0
0.004,6,10,2006,5,927,1.0,659.0,659.0,5,1079,1.0,811.0,811.0
0.003,17,2,148,1,60,0.0,32.0,32.0,1,88,0.0,60.0,60.0
0.005,6,10,2007,5,928,1.0,660.0,660.0,5,1079,1.0,811.0,811.0
0.034,17,2,152,1,76,0.0,48.0,48.0,1,76,0.0,48.0,48.0
0.01,6,10,1990,5,911,2.0,643.0,643.0,5,1079,2.0,811.0,811.0
0.009,6,10,1762,5,911,2.0,643.0,643.0,5,851,2.0,583.0,583.0
0.006,6,10,1689,5,839,1.0,571.0,571.0,5,850,1.0,582.0,582.0
0.086,6,10,1506,5,395,19.0,127.0,127.0,5,1111,17.0,843.0,843.0
0.019,6,10,1989,5,910,4.0,642.0,642.0,5,1079,4.0,811.0,811.0
0.112,6,10,1506,5,395,24.0,127.0,127.0,5,1111,22.0,843.0,843.0
40.043,17,10,676,5,460,10009.0,104.0,64.0,5,216,10009.0,20.0,15.0
0.021,6,10,1972,5,910,5.0,642.0,642.0,5,1062,5.0,794.0,794.0
0.005,6,10,1989,5,927,1.0,659.0,659.0,5,1062,1.0,794.0,794.0
0.013,6,10,1972,5,910,3.0,642.0,642.0,5,1062,3.0,794.0,794.0
0.073,6,10,1506,5,395,15.0,127.0,127.0,5,1111,17.0,843.0,843.0
0.126,6,10,1506,5,395,27.0,127.0,127.0,5,1111,29.0,843.0,843.0
0.062,6,10,1506,5,395,13.0,127.0,127.0,5,1111,12.0,843.0,843.0
0.005,6,10,1989,5,927,1.0,659.0,659.0,5,1062,1.0,794.0,794.0
0.01,6,10,1983,5,910,2.0,642.0,642.0,5,1073,2.0,805.0,805.0
0.085,6,10,1506,5,395,18.0,127.0,127.0,5,1111,17.0,843.0,843.0
0.005,6,10,1854,5,889,1.0,621.0,621.0,5,965,1.0,697.0,697.0
0.006,17,2,144,1,64,0.0,36.0,36.0,1,80,0.0,52.0,52.0
0.005,6,10,2006,5,927,1.0,659.0,659.0,5,1079,1.0,811.0,811.0
0.149,6,10,1506,5,395,36.0,127.0,127.0,5,1111,33.0,843.0,843.0
0.006,6,10,1989,5,927,1.0,659.0,659.0,5,1062,1.0,794.0,794.0
0.027,6,10,1989,5,910,6.0,642.0,642.0,5,1079,6.0,811.0,811.0
0.038,17,2,170,1,65,0.0,37.0,37.0,1,105,0.0,77.0,77.0
0.012,6,10,1972,5,910,3.0,642.0,642.0,5,1062,2.0,794.0,794.0
0.097,6,10,1506,5,395,20.0,127.0,127.0,5,1111,20.0,843.0,843.0
0.126,6,10,1506,5,395,29.0,127.0,127.0,5,1111,27.0,843.0,843.0
0.013,17,2,152,1,56,0.0,28.0,28.0,1,96,0.0,68.0,68.0
0.005,6,10,1547,5,764,1.0,496.0,496.0,5,783,1.0,515.0,515.0
0.004,6,10,2006,5,927,1.0,659.0,659.0,5,1079,1.0,811.0,811.0
40.067,17,10,676,5,460,10015.0,104.0,64.0,5,216,10015.0,20.0,15.0
0.005,6,10,1989,5,927,1.0,659.0,659.0,5,1062,1.0,794.0,794.0
0.004,17,4,284,2,120,0.0,32.0,32.0,2,164,1.0,60.0,54.0
0.007,6,10,1547,5,764,1.0,496.0,496.0,5,783,1.0,515.0,515.0
0.076,6,10,1506,5,395,16.0,127.0,127.0,5,1111,17.0,843.0,843.0
11.082,17,28,4424,14,1995,840.0,270.0,114.0,14,2429,840.0,588.0,145.0
0.272,17,13,9139,7,6851,45.0,1350.0,950.0,6,2288,48.0,1350.0,353.0
40.062,17,10,676,5,460,10014.0,104.0,64.0,5,216,10014.0,20.0,15.0
0.005,6,10,1989,5,927,1.0,659.0,659.0,5,1062,1.0,794.0,794.0
0.001,17,2,180,1,66,0.0,38.0,38.0,1,114,0.0,86.0,86.0
0.103,6,10,1506,5,395,22.0,127.0,127.0,5,1111,24.0,843.0,843.0
0.011,6,10,1972,5,910,2.0,642.0,642.0,5,1062,2.0,794.0,794.0
0.065,6,10,1506,5,395,13.0,127.0,127.0,5,1111,15.0,843.0,843.0
0.069,17,8,3613,4,1874,23.0,1350.0,440.0,4,1739,12.0,1350.0,406.0
0.565,17,4,596,2,122,486.0,33.0,33.0,2,474,185.0,323.0,209.0
0.003,17,2,136,1,60,0.0,32.0,32.0,1,76,0.0,48.0,48.0
0.001,17,2,180,1,66,0.0,38.0,38.0,1,114,0.0,86.0,86.0
0.011,6,10,1677,5,827,2.0,559.0,559.0,5,850,2.0,582.0,582.0
0.009,6,12,1926,6,1189,1.0,659.0,434.0,6,737,1.0,417.0,417.0
0.08,6,10,1506,5,395,15.0,127.0,127.0,5,1111,17.0,843.0,843.0
0.004,6,10,2007,5,928,1.0,660.0,660.0,5,1079,1.0,811.0,811.0
0.013,17,2,152,1,56,0.0,28.0,28.0,1,96,0.0,68.0,68.0
0.003,6,10,1702,5,863,0.0,595.0,595.0,5,839,0.0,571.0,571.0
0.004,6,10,1989,5,927,1.0,659.0,659.0,5,1062,1.0,794.0,794.0
0.014,6,13,3735,7,497,2.0,125.0,125.0,6,3238,2.0,1470.0,1459.0
0.01,6,10,1762,5,911,2.0,643.0,643.0,5,851,2.0,583.0,583.0
0.004,17,2,148,1,60,0.0,32.0,32.0,1,88,0.0,60.0,60.0
40.062,17,10,676,5,460,10012.0,104.0,64.0,5,216,10014.0,20.0,15.0
40.058,17,10,676,5,460,10013.0,104.0,64.0,5,216,10013.0,20.0,15.0
0.006,17,2,144,1,64,0.0,36.0,36.0,1,80,0.0,52.0,52.0
0.005,6,10,2000,5,927,1.0,659.0,659.0,5,1073,1.0,805.0,805.0
0.131,6,10,1506,5,395,29.0,127.0,127.0,5,1111,29.0,843.0,843.0
0.012,6,10,1989,5,910,3.0,642.0,642.0,5,1079,3.0,811.0,811.0
300.331,6,16,2170,9,684,37520.0,146.0,146.0,7,1486,50027.0,419.0,398.0
0.016,6,10,1989,5,910,3.0,642.0,642.0,5,1079,4.0,811.0,811.0
0.005,6,10,2000,5,927,1.0,659.0,659.0,5,1073,1.0,805.0,805.0
0.004,17,2,144,1,64,0.0,36.0,36.0,1,80,0.0,52.0,52.0
0.004,17,2,136,1,60,0.0,32.0,32.0,1,76,0.0,48.0,48.0
0.005,17,2,166,1,75,0.0,47.0,47.0,1,91,0.0,63.0,63.0
0.01,6,10,1989,5,910,2.0,642.0,642.0,5,1079,2.0,811.0,811.0
15.071,17,14,9191,8,6902,2149.0,1350.0,834.0,6,2289,3008.0,1350.0,353.0
0.015,6,10,1989,5,910,3.0,642.0,642.0,5,1079,3.0,811.0,811.0
0.014,6,10,1989,5,910,3.0,642.0,642.0,5,1079,3.0,811.0,811.0
0.015,6,12,1926,6,1189,3.0,659.0,434.0,6,737,2.0,417.0,417.0
126.077,6,14,2938,8,2504,17977.0,1414.0,1086.0,6,434,25168.0,182.0,182.0
0.001,17,2,132,1,58,0.0,30.0,30.0,1,74,0.0,46.0,46.0
0.019,17,2,164,1,74,0.0,46.0,46.0,1,90,0.0,62.0,62.0
0.006,17,2,170,1,65,0.0,37.0,37.0,1,105,0.0,77.0,77.0
0.009,6,10,1989,5,910,2.0,642.0,642.0,5,1079,2.0,811.0,811.0
0.011,17,2,136,1,60,0.0,32.0,32.0,1,76,0.0,48.0,48.0
0.005,17,2,238,1,66,0.0,38.0,38.0,1,172,0.0,144.0,144.0
0.013,6,10,1989,5,910,3.0,642.0,642.0,5,1079,3.0,811.0,811.0
40.07,17,10,676,5,460,10014.0,104.0,64.0,5,216,10016.0,20.0,15.0
0.018,6,10,1972,5,910,4.0,642.0,642.0,5,1062,4.0,794.0,794.0
0.001,17,2,180,1,66,0.0,38.0,38.0,1,114,0.0,86.0,86.0
0.005,17,2,164,1,74,0.0,46.0,46.0,1,90,0.0,62.0,62.0
0.006,6,10,1547,5,764,1.0,496.0,496.0,5,783,1.0,515.0,515.0
0.006,6,10,1547,5,764,1.0,496.0,496.0,5,783,1.0,515.0,515.0
0.116,6,10,1506,5,395,26.0,127.0,127.0,5,1111,27.0,843.0,843.0
0.071,17,2,170,1,65,0.0,37.0,37.0,1,105,0.0,77.0,77.0
0.093,6,10,1506,5,395,19.0,127.0,127.0,5,1111,22.0,843.0,843.0
0.017,6,10,1989,5,910,4.0,642.0,642.0,5,1079,4.0,811.0,811.0
0.004,17,2,136,1,60,0.0,32.0,32.0,1,76,0.0,48.0,48.0
0.005,6,10,2007,5,928,1.0,660.0,660.0,5,1079,1.0,811.0,811.0
40.069,17,10,676,5,460,10015.0,104.0,64.0,5,216,10016.0,20.0,15.0
0.008,6,10,1677,5,827,2.0,559.0,559.0,5,850,1.0,582.0,582.0
0.135,6,10,1506,5,395,27.0,127.0,127.0,5,1111,29.0,843.0,843.0
0.012,6,10,1990,5,911,2.0,643.0,643.0,5,1079,3.0,811.0,811.0
354.02,6,21,1795,16,1030,23601.0,190.0,190.0,5,765,60005.0,464.0,248.0
1730.507,6,54,3291,33,1950,54078.0,35.0,35.0,21,1341,86521.0,31.0,31.0
0.038,17,2,148,1,60,0.0,32.0,32.0,1,88,0.0,60.0,60.0
0.005,6,10,2006,5,927,1.0,659.0,659.0,5,1079,1.0,811.0,811.0
240.009,6,9,787,5,488,60002.0,232.0,232.0,4,299,80002.0,83.0,83.0
0.004,6,10,2000,5,927,1.0,659.0,659.0,5,1073,1.0,805.0,805.0
0.014,6,10,1983,5,910,3.0,642.0,642.0,5,1073,3.0,805.0,805.0
0.003,17,2,148,1,60,0.0,32.0,32.0,1,88,0.0,60.0,60.0
0.004,17,2,136,1,60,0.0,32.0,32.0,1,76,0.0,48.0,48.0
0.126,6,10,1506,5,395,29.0,127.0,127.0,5,1111,29.0,843.0,843.0
0.097,6,10,1506,5,395,21.0,127.0,127.0,5,1111,20.0,843.0,843.0
40.06,17,10,676,5,460,10014.0,104.0,64.0,5,216,10014.0,20.0,15.0
0.012,6,10,1989,5,910,3.0,642.0,642.0,5,1079,3.0,811.0,811.0
0.125,6,10,1506,5,395,27.0,127.0,127.0,5,1111,27.0,843.0,843.0
0.224,6,16,2777,8,1395,32.0,533.0,323.0,8,1382,20.0,529.0,239.0
352.818,6,20,2210,6,1308,12004.0,494.0,494.0,14,902,27139.0,83.0,83.0
0.009,6,10,1989,5,910,2.0,642.0,642.0,5,1079,2.0,811.0,811.0
0.097,6,10,1506,5,395,22.0,127.0,127.0,5,1111,19.0,843.0,843.0
0.229,6,16,2777,8,1395,32.0,533.0,323.0,8,1382,21.0,529.0,239.0
168.13,17,92,13421,46,3107,3736.0,44.0,39.0,46,10314,3736.0,252.0,196.0
11.01,17,26,4101,13,1822,908.0,269.0,112.0,13,2279,908.0,586.0,147.0
0.011,6,10,1989,5,910,2.0,642.0,642.0,5,1079,2.0,811.0,811.0
0.069,6,10,1506,5,395,16.0,127.0,127.0,5,1111,14.0,843.0,843.0
0.005,17,2,169,1,62,0.0,34.0,34.0,1,107,0.0,79.0,79.0
0.009,6,10,1990,5,911,2.0,643.0,643.0,5,1079,2.0,811.0,811.0
240.356,6,43,8771,21,5686,12016.0,1515.0,509.0,22,3085,11445.0,580.0,241.0
0.012,6,10,1990,5,911,3.0,643.0,643.0,5,1079,3.0,811.0,811.0
0.006,6,10,1547,5,764,1.0,496.0,496.0,5,783,1.0,515.0,515.0
0.01,17,2,136,1,60,0.0,32.0,32.0,1,76,0.0,48.0,48.0
0.076,17,2,136,1,60,0.0,32.0,32.0,1,76,0.0,48.0,48.0
0.083,6,10,1506,5,395,17.0,127.0,127.0,5,1111,18.0,843.0,843.0
0.115,6,10,1506,5,395,25.0,127.0,127.0,5,1111,24.0,843.0,843.0
0.041,17,2,148,1,60,0.0,32.0,32.0,1,88,0.0,60.0,60.0
0.013,6,10,1983,5,910,3.0,642.0,642.0,5,1073,3.0,805.0,805.0
0.014,6,10,1990,5,911,3.0,643.0,643.0,5,1079,3.0,811.0,811.0
0.001,17,2,166,1,75,0.0,47.0,47.0,1,91,0.0,63.0,63.0
0.01,6,10,1762,5,911,2.0,643.0,643.0,5,851,2.0,583.0,583.0
0.006,17,2,170,1,65,0.0,37.0,37.0,1,105,0.0,77.0,77.0
0.012,6,13,3735,7,497,1.0,125.0,125.0,6,3238,2.0,1470.0,1459.0
0.001,17,2,180,1,66,0.0,38.0,38.0,1,114,0.0,86.0,86.0
0.006,17,2,170,1,65,0.0,37.0,37.0,1,105,0.0,77.0,77.0
354.005,6,21,1795,16,1030,23600.0,190.0,190.0,5,765,60002.0,464.0,248.0
0.006,6,10,1689,5,839,1.0,571.0,571.0,5,850,1.0,582.0,582.0
0.072,17,2,184,1,61,0.0,33.0,33.0,1,123,0.0,95.0,95.0
0.099,6,10,1506,5,395,21.0,127.0,127.0,5,1111,21.0,843.0,843.0
0.006,6,10,1547,5,764,1.0,496.0,496.0,5,783,1.0,515.0,515.0
0.005,6,10,2006,5,927,1.0,659.0,659.0,5,1079,1.0,811.0,811.0
0.133,17,4,420,2,122,0.0,33.0,33.0,2,298,95.0,145.0,121.0
0.068,6,10,1506,5,395,15.0,127.0,127.0,5,1111,14.0,843.0,843.0
0.012,6,10,1983,5,910,3.0,642.0,642.0,5,1073,3.0,805.0,805.0
0.004,6,10,2006,5,927,1.0,659.0,659.0,5,1079,1.0,811.0,811.0
0.001,17,2,180,1,66,0.0,38.0,38.0,1,114,0.0,86.0,86.0
0.01,6,10,1972,5,910,2.0,642.0,642.0,5,1062,2.0,794.0,794.0
0.005,6,10,2007,5,928,1.0,660.0,660.0,5,1079,1.0,811.0,811.0
0.039,17,4,352,2,130,3.0,37.0,37.0,2,222,2.0,89.0,83.0
0.003,17,2,148,1,60,0.0,32.0,32.0,1,88,0.0,60.0,60.0
0.006,6,10,1547,5,764,1.0,496.0,496.0,5,783,1.0,515.0,515.0
0.004,6,10,1989,5,927,1.0,659.0,659.0,5,1062,1.0,794.0,794.0
0.005,6,10,2006,5,927,1.0,659.0,659.0,5,1079,1.0,811.0,811.0
9.036,17,6,376,5,280,2259.0,28.0,28.0,1,96,0.0,68.0,68.0
0.012,6,12,1926,6,1189,2.0,659.0,434.0,6,737,2.0,417.0,417.0
0.004,6,10,2006,5,927,1.0,659.0,659.0,5,1079,1.0,811.0,811.0
0.004,17,2,148,1,60,0.0,32.0,32.0,1,88,0.0,60.0,60.0
0.019,6,10,1983,5,910,4.0,642.0,642.0,5,1073,4.0,805.0,805.0
0.022,6,10,1631,5,848,5.0,580.0,580.0,5,783,5.0,515.0,515.0
0.013,6,10,1972,5,910,3.0,642.0,642.0,5,1062,3.0,794.0,794.0
0.006,6,10,1547,5,764,1.0,496.0,496.0,5,783,1.0,515.0,515.0
0.004,6,10,2006,5,927,1.0,659.0,659.0,5,1079,1.0,811.0,811.0
0.006,17,2,144,1,64,0.0,36.0,36.0,1,80,0.0,52.0,52.0
0.089,6,10,1506,5,395,18.0,127.0,127.0,5,1111,21.0,843.0,843.0
0.004,6,10,2006,5,927,1.0,659.0,659.0,5,1079,1.0,811.0,811.0
0.014,6,10,1990,5,911,3.0,643.0,643.0,5,1079,3.0,811.0,811.0
252.999,6,38,9720,15,6748,18071.0,1872.0,663.0,23,2972,11499.0,580.0,126.0
0.001,17,2,180,1,66,0.0,38.0,38.0,1,114,0.0,86.0,86.0
0.115,6,10,1506,5,395,27.0,127.0,127.0,5,1111,24.0,843.0,843.0
0.102,6,10,1506,5,395,24.0,127.0,127.0,5,1111,23.0,843.0,843.0
0.011,6,10,1989,5,910,2.0,642.0,642.0,5,1079,2.0,811.0,811.0
0.072,17,4,284,2,120,0.0,32.0,32.0,2,164,68.0,60.0,54.0
0.008,6,10,1972,5,910,2.0,642.0,642.0,5,1062,1.0,794.0,794.0
0.006,17,2,170,1,65,0.0,37.0,37.0,1,105,0.0,77.0,77.0
0.056,17,2,179,1,71,0.0,43.0,43.0,1,108,0.0,80.0,80.0
0.072,6,10,1506,5,395,16.0,127.0,127.0,5,1111,16.0,843.0,843.0
729.857,17,130,18870,65,4338,11403.0,44.0,38.0,65,14532,11404.0,260.0,195.0
0.039,17,4,284,2,120,0.0,32.0,32.0,2,164,36.0,60.0,54.0
0.134,6,10,1506,5,395,28.0,127.0,127.0,5,1111,29.0,843.0,843.0
0.012,6,10,1631,5,848,2.0,580.0,580.0,5,783,2.0,515.0,515.0
0.008,6,10,1762,5,911,1.0,643.0,643.0,5,851,2.0,583.0,583.0
40.062,17,10,676,5,460,10014.0,104.0,64.0,5,216,10005.0,20.0,15.0
240.778,6,34,9342,16,1820,16049.0,608.0,196.0,18,7522,14161.0,1402.0,549.0
0.014,6,10,1989,5,910,3.0,642.0,642.0,5,1079,3.0,811.0,811.0
0.104,6,10,1506,5,395,23.0,127.0,127.0,5,1111,22.0,843.0,843.0
0.016,6,10,1972,5,910,4.0,642.0,642.0,5,1062,3.0,794.0,794.0
0.005,6,10,2007,5,928,1.0,660.0,660.0,5,1079,1.0,811.0,811.0
0.01,6,10,1990,5,911,2.0,643.0,643.0,5,1079,2.0,811.0,811.0
0.005,17,2,170,1,65,0.0,37.0,37.0,1,105,0.0,77.0,77.0
0.086,6,10,1506,5,395,17.0,127.0,127.0,5,1111,19.0,843.0,843.0
0.124,17,2,80,1,32,0.0,4.0,4.0,1,48,0.0,20.0,20.0
9.039,17,6,376,5,280,2259.0,28.0,28.0,1,96,0.0,68.0,68.0
0.006,6,10,1547,5,764,1.0,496.0,496.0,5,783,1.0,515.0,515.0
0.237,6,10,1506,5,395,55.0,127.0,127.0,5,1111,39.0,843.0,843.0
0.004,17,2,136,1,60,0.0,32.0,32.0,1,76,0.0,48.0,48.0
0.013,6,10,1989,5,910,3.0,642.0,642.0,5,1079,3.0,811.0,811.0
0.17,17,2,152,1,76,0.0,48.0,48.0,1,76,0.0,48.0,48.0
0.005,6,10,1643,5,860,1.0,592.0,592.0,5,783,1.0,515.0,515.0
0.005,6,10,2006,5,927,1.0,659.0,659.0,5,1079,1.0,811.0,811.0
0.005,6,10,1689,5,839,1.0,571.0,571.0,5,850,1.0,582.0,582.0
0.014,6,10,1762,5,911,3.0,643.0,643.0,5,851,3.0,583.0,583.0
0.005,6,10,1989,5,927,1.0,659.0,659.0,5,1062,1.0,794.0,794.0
9.043,17,6,376,5,280,2260.0,28.0,28.0,1,96,0.0,68.0,68.0
0.004,6,10,2006,5,927,1.0,659.0,659.0,5,1079,1.0,811.0,811.0
1779.072,17,146,46136,74,23384,24360.0,288.0,288.0,72,22752,25052.0,288.0,288.0
0.005,6,10,1689,5,839,1.0,571.0,571.0,5,850,1.0,582.0,582.0
15.168,17,20,11094,10,7407,1682.0,1350.0,712.0,10,3687,1682.0,1350.0,340.0
159.079,17,76,10981,38,2530,4299.0,44.0,38.0,38,8451,4299.0,261.0,194.0
0.005,6,10,1989,5,927,1.0,659.0,659.0,5,1062,1.0,794.0,794.0
0.037,17,2,152,1,76,0.0,48.0,48.0,1,76,0.0,48.0,48.0
0.014,6,10,1989,5,910,3.0,642.0,642.0,5,1079,3.0,811.0,811.0
0.005,17,2,166,1,75,0.0,47.0,47.0,1,91,0.0,63.0,63.0
0.008,17,4,284,2,120,0.0,32.0,32.0,2,164,0.0,60.0,54.0
240.019,6,9,787,5,488,60004.0,232.0,232.0,4,299,80005.0,83.0,83.0
0.005,6,10,1702,5,863,1.0,595.0,595.0,5,839,1.0,571.0,571.0
0.008,6,10,1990,5,911,2.0,643.0,643.0,5,1079,1.0,811.0,811.0
0.006,6,10,1689,5,839,1.0,571.0,571.0,5,850,1.0,582.0,582.0
0.015,6,10,1990,5,911,3.0,643.0,643.0,5,1079,3.0,811.0,811.0
0.014,6,10,1972,5,910,3.0,642.0,642.0,5,1062,3.0,794.0,794.0
0.015,6,10,1983,5,910,3.0,642.0,642.0,5,1073,3.0,805.0,805.0
0.008,6,10,1990,5,911,2.0,643.0,643.0,5,1079,2.0,811.0,811.0
0.005,6,10,2007,5,928,1.0,660.0,660.0,5,1079,1.0,811.0,811.0
0.0,17,2,166,1,75,0.0,47.0,47.0,1,91,0.0,63.0,63.0
0.098,6,10,1506,5,395,23.0,127.0,127.0,5,1111,23.0,843.0,843.0
0.007,6,10,1547,5,764,1.0,496.0,496.0,5,783,1.0,515.0,515.0
0.068,6,10,1506,5,395,16.0,127.0,127.0,5,1111,15.0,843.0,843.0
0.012,6,10,1972,5,910,3.0,642.0,642.0,5,1062,2.0,794.0,794.0
0.06,6,10,1506,5,395,14.0,127.0,127.0,5,1111,12.0,843.0,843.0
0.003,17,2,136,1,60,0.0,32.0,32.0,1,76,0.0,48.0,48.0
0.042,17,2,152,1,76,0.0,48.0,48.0,1,76,0.0,48.0,48.0
9.039,17,6,376,5,280,2259.0,28.0,28.0,1,96,0.0,68.0,68.0
0.016,6,10,1989,5,910,4.0,642.0,642.0,5,1079,4.0,811.0,811.0
5.148,58,2,144,1,72,0.0,24.0,24.0,1,72,0.0,24.0,24.0
0.005,17,2,169,1,62,0.0,34.0,34.0,1,107,0.0,79.0,79.0
0.018,6,10,1631,5,848,4.0,580.0,580.0,5,783,4.0,515.0,515.0
0.01,6,10,1989,5,910,2.0,642.0,642.0,5,1079,2.0,811.0,811.0
0.004,6,10,2006,5,927,1.0,659.0,659.0,5,1079,1.0,811.0,811.0
0.103,6,10,1506,5,395,25.0,127.0,127.0,5,1111,23.0,843.0,843.0
0.005,6,10,1689,5,839,1.0,571.0,571.0,5,850,1.0,582.0,582.0
0.094,6,10,1506,5,395,21.0,127.0,127.0,5,1111,21.0,843.0,843.0
0.086,6,10,1506,5,395,19.0,127.0,127.0,5,1111,20.0,843.0,843.0
0.001,17,2,192,1,71,0.0,43.0,43.0,1,121,0.0,93.0,93.0
0.004,17,4,284,2,120,0.0,32.0,32.0,2,164,0.0,60.0,54.0
40.059,17,10,676,5,460,10012.0,104.0,64.0,5,216,10013.0,20.0,15.0
0.094,6,10,1506,5,395,20.0,127.0,127.0,5,1111,22.0,843.0,843.0
174.223,17,86,11977,43,2864,4148.0,44.0,38.0,43,9113,4148.0,239.0,183.0
0.013,17,2,152,1,56,0.0,28.0,28.0,1,96,0.0,68.0,68.0
0.115,6,10,1506,5,395,27.0,127.0,127.0,5,1111,27.0,843.0,843.0
0.206,6,10,1506,5,395,35.0,127.0,127.0,5,1111,47.0,843.0,843.0
0.091,6,10,1506,5,395,20.0,127.0,127.0,5,1111,18.0,843.0,843.0
0.013,6,10,1972,5,910,3.0,642.0,642.0,5,1062,3.0,794.0,794.0
0.008,6,10,1989,5,910,2.0,642.0,642.0,5,1079,1.0,811.0,811.0
0.006,6,10,1689,5,839,1.0,571.0,571.0,5,850,1.0,582.0,582.0
0.001,17,2,166,1,75,0.0,47.0,47.0,1,91,0.0,63.0,63.0
309.115,17,20,1124,10,716,34332.0,48.0,43.0,10,408,34332.0,20.0,12.0
0.005,6,10,2000,5,927,1.0,659.0,659.0,5,1073,1.0,805.0,805.0
0.014,6,10,1989,5,910,3.0,642.0,642.0,5,1079,3.0,811.0,811.0
0.017,6,10,1677,5,827,4.0,559.0,559.0,5,850,4.0,582.0,582.0
178.187,17,80,11255,40,2665,4568.0,44.0,38.0,40,8590,4568.0,260.0,186.0
0.014,6,13,3735,7,497,2.0,125.0,125.0,6,3238,2.0,1470.0,1459.0
0.005,17,2,180,1,66,0.0,38.0,38.0,1,114,0.0,86.0,86.0
0.016,17,2,198,1,91,0.0,63.0,63.0,1,107,0.0,79.0,79.0
300.273,6,16,2170,9,684,37514.0,146.0,146.0,7,1486,50017.0,419.0,398.0
0.005,6,10,1774,5,923,1.0,655.0,655.0,5,851,1.0,583.0,583.0
377.252,6,22,2313,16,867,25150.0,195.0,195.0,6,1446,4637.0,419.0,398.0
0.071,17,2,136,1,60,0.0,32.0,32.0,1,76,0.0,48.0,48.0
15.077,17,16,8843,8,6639,2149.0,1350.0,801.0,8,2204,2149.0,1350.0,247.0
0.003,17,2,136,1,60,0.0,32.0,32.0,1,76,0.0,48.0,48.0
0.093,6,10,1506,5,395,19.0,127.0,127.0,5,1111,19.0,843.0,843.0
0.01,6,10,1990,5,911,2.0,643.0,643.0,5,1079,2.0,811.0,811.0
0.024,6,10,1990,5,911,6.0,643.0,643.0,5,1079,6.0,811.0,811.0
0.003,17,2,148,1,60,0.0,32.0,32.0,1,88,0.0,60.0,60.0
300.062,6,12,1782,7,1348,50010.0,494.0,494.0,5,434,75011.0,83.0,83.0
0.004,6,10,2000,5,927,1.0,659.0,659.0,5,1073,1.0,805.0,805.0
0.065,17,8,3613,4,1874,21.0,1350.0,440.0,4,1739,11.0,1350.0,406.0
240.09,6,16,4480,9,963,30011.0,238.0,166.0,7,3517,40014.0,1402.0,786.0
0.13,17,4,352,2,130,2.0,37.0,37.0,2,222,91.0,89.0,83.0
0.006,6,10,1643,5,860,1.0,592.0,592.0,5,783,1.0,515.0,515.0
0.074,6,10,1506,5,395,16.0,127.0,127.0,5,1111,14.0,843.0,843.0
0.06,17,2,152,1,76,0.0,48.0,48.0,1,76,0.0,48.0,48.0
240.12,6,32,7973,16,5558,16007.0,1515.0,524.0,16,2415,16007.0,580.0,196.0
0.081,6,10,1506,5,395,17.0,127.0,127.0,5,1111,19.0,843.0,843.0
0.004,6,10,2007,5,928,1.0,660.0,660.0,5,1079,1.0,811.0,811.0
0.004,6,10,1779,5,928,1.0,660.0,660.0,5,851,1.0,583.0,583.0
40.058,17,10,676,5,460,10013.0,104.0,64.0,5,216,10012.0,20.0,15.0
0.001,17,2,180,1,66,0.0,38.0,38.0,1,114,0.0,86.0,86.0
0.008,6,10,1972,5,910,2.0,642.0,642.0,5,1062,1.0,794.0,794.0
356.513,6,21,1794,16,1030,23767.0,190.0,190.0,5,764,60003.0,463.0,248.0
0.006,6,10,1774,5,923,1.0,655.0,655.0,5,851,1.0,583.0,583.0
0.006,6,10,1689,5,839,1.0,571.0,571.0,5,850,1.0,582.0,582.0
0.11,6,10,1506,5,395,19.0,127.0,127.0,5,1111,25.0,843.0,843.0
0.004,6,10,2007,5,928,1.0,660.0,660.0,5,1079,1.0,811.0,811.0
10.962,17,28,4423,14,1994,834.0,269.0,114.0,14,2429,833.0,588.0,145.0
0.009,6,10,1990,5,911,2.0,643.0,643.0,5,1079,2.0,811.0,811.0
1771.738,6,298,97230,184,86236,9681.0,2001.0,690.0,114,10994,15678.0,452.0,69.0
0.137,6,10,1506,5,395,23.0,127.0,127.0,5,1111,34.0,843.0,843.0
0.011,6,10,1989,5,910,2.0,642.0,642.0,5,1079,2.0,811.0,811.0
0.003,17,4,284,2,120,0.0,32.0,32.0,2,164,0.0,60.0,54.0
0.067,6,10,1506,5,395,15.0,127.0,127.0,5,1111,15.0,843.0,843.0
0.01,6,10,1605,5,388,2.0,120.0,120.0,5,1217,2.0,949.0,949.0
0.087,6,10,1506,5,395,18.0,127.0,127.0,5,1111,20.0,843.0,843.0
0.128,17,2,80,1,32,0.0,4.0,4.0,1,48,0.0,20.0,20.0
0.089,6,10,1506,5,395,18.0,127.0,127.0,5,1111,17.0,843.0,843.0
0.124,6,10,1506,5,395,29.0,127.0,127.0,5,1111,18.0,843.0,843.0
0.004,6,10,1779,5,928,1.0,660.0,660.0,5,851,1.0,583.0,583.0
0.071,6,10,1506,5,395,16.0,127.0,127.0,5,1111,15.0,843.0,843.0
0.003,17,2,148,1,60,0.0,32.0,32.0,1,88,0.0,60.0,60.0
0.11,17,2,80,1,32,0.0,4.0,4.0,1,48,0.0,20.0,20.0
0.019,6,10,1989,5,910,4.0,642.0,642.0,5,1079,4.0,811.0,811.0
0.016,6,10,1989,5,910,4.0,642.0,642.0,5,1079,4.0,811.0,811.0
0.009,6,10,1972,5,910,2.0,642.0,642.0,5,1062,2.0,794.0,794.0
0.021,6,10,1990,5,911,5.0,643.0,643.0,5,1079,5.0,811.0,811.0
300.407,6,16,2170,9,684,37529.0,146.0,146.0,7,1486,50039.0,419.0,398.0
0.117,6,10,1506,5,395,26.0,127.0,127.0,5,1111,25.0,843.0,843.0
0.006,6,10,1643,5,860,1.0,592.0,592.0,5,783,1.0,515.0,515.0
240.019,6,9,787,5,488,60004.0,232.0,232.0,4,299,80003.0,83.0,83.0
0.015,6,10,1989,5,910,3.0,642.0,642.0,5,1079,3.0,811.0,811.0
0.011,6,10,1972,5,910,2.0,642.0,642.0,5,1062,2.0,794.0,794.0
0.091,6,10,1506,5,395,18.0,127.0,127.0,5,1111,19.0,843.0,843.0
0.011,6,10,1989,5,910,2.0,642.0,642.0,5,1079,2.0,811.0,811.0
0.005,6,10,2007,5,928,1.0,660.0,660.0,5,1079,1.0,811.0,811.0
40.065,17,10,676,5,460,10014.0,104.0,64.0,5,216,10015.0,20.0,15.0
0.004,6,10,1702,5,863,1.0,595.0,595.0,5,839,1.0,571.0,571.0
0.31,17,4,352,2,130,179.0,37.0,37.0,2,222,239.0,89.0,83.0
0.816,6,22,5072,11,1250,70.0,325.0,133.0,11,3822,68.0,1414.0,563.0
0.088,6,10,1506,5,395,19.0,127.0,127.0,5,1111,20.0,843.0,843.0
40.058,17,10,676,5,460,10011.0,104.0,64.0,5,216,10013.0,20.0,15.0
0.006,6,10,1547,5,764,1.0,496.0,496.0,5,783,1.0,515.0,515.0
0.008,6,10,2007,5,928,2.0,660.0,660.0,5,1079,2.0,811.0,811.0
0.104,6,10,1506,5,395,23.0,127.0,127.0,5,1111,24.0,843.0,843.0
0.006,6,10,1547,5,764,1.0,496.0,496.0,5,783,1.0,515.0,515.0
0.005,17,2,136,1,60,0.0,32.0,32.0,1,76,0.0,48.0,48.0
367.048,6,22,2313,16,867,24469.0,195.0,195.0,6,1446,4635.0,419.0,398.0
0.003,17,4,284,2,120,0.0,32.0,32.0,2,164,0.0,60.0,54.0
0.008,6,10,1989,5,910,1.0,642.0,642.0,5,1079,2.0,811.0,811.0
40.051,17,10,676,5,460,10012.0,104.0,64.0,5,216,10011.0,20.0,15.0
15.088,17,16,9249,8,7021,2151.0,1350.0,849.0,8,2228,2151.0,1350.0,250.0
0.015,6,10,1972,5,910,3.0,642.0,642.0,5,1062,3.0,794.0,794.0
1787.677,6,150,19350,90,13740,20086.0,302.0,302.0,60,5610,30299.0,83.0,83.0
0.002,17,2,180,1,66,0.0,38.0,38.0,1,114,0.0,86.0,86.0
40.087,17,10,676,5,460,10021.0,104.0,64.0,5,216,10021.0,20.0,15.0
0.006,6,10,1779,5,928,1.0,660.0,660.0,5,851,1.0,583.0,583.0
0.008,6,10,1989,5,910,1.0,642.0,642.0,5,1079,2.0,811.0,811.0
9.038,17,6,376,5,280,2259.0,28.0,28.0,1,96,0.0,68.0,68.0
0.005,6,10,2006,5,927,1.0,659.0,659.0,5,1079,1.0,811.0,811.0
0.017,6,10,1972,5,910,4.0,642.0,642.0,5,1062,4.0,794.0,794.0
0.014,6,10,1989,5,910,3.0,642.0,642.0,5,1079,3.0,811.0,811.0
0.09,6,10,1506,5,395,20.0,127.0,127.0,5,1111,21.0,843.0,843.0
0.014,6,10,1989,5,910,3.0,642.0,642.0,5,1079,3.0,811.0,811.0
0.007,6,10,1547,5,764,1.0,496.0,496.0,5,783,1.0,515.0,515.0
0.028,6,10,1972,5,910,7.0,642.0,642.0,5,1062,6.0,794.0,794.0
0.016,6,10,1989,5,910,4.0,642.0,642.0,5,1079,3.0,811.0,811.0
0.006,6,10,1854,5,889,1.0,621.0,621.0,5,965,1.0,697.0,697.0
240.085,6,16,4482,9,963,30010.0,238.0,166.0,7,3519,40013.0,1402.0,786.0
0.006,6,10,2007,5,928,1.0,660.0,660.0,5,1079,1.0,811.0,811.0
0.008,6,12,1926,6,1189,1.0,659.0,434.0,6,737,1.0,417.0,417.0
0.029,6,10,1631,5,848,7.0,580.0,580.0,5,783,7.0,515.0,515.0
0.011,6,13,3735,7,497,1.0,125.0,125.0,6,3238,2.0,1470.0,1459.0
0.004,6,10,2006,5,927,1.0,659.0,659.0,5,1079,1.0,811.0,811.0
0.005,6,10,2006,5,927,1.0,659.0,659.0,5,1079,1.0,811.0,811.0
0.005,17,2,169,1,62,0.0,34.0,34.0,1,107,0.0,79.0,79.0
0.01,6,10,1983,5,910,2.0,642.0,642.0,5,1073,2.0,805.0,805.0
0.224,6,16,2671,8,1397,32.0,533.0,324.0,8,1274,20.0,529.0,212.0
0.072,6,10,1506,5,395,15.0,127.0,127.0,5,1111,16.0,843.0,843.0
0.02,6,10,1990,5,911,5.0,643.0,643.0,5,1079,4.0,811.0,811.0
0.012,6,10,1972,5,910,3.0,642.0,642.0,5,1062,2.0,794.0,794.0
1768.684,6,540,188684,270,162437,6575.0,2883.0,951.0,270,26247,6575.0,379.0,122.0
40.053,17,10,676,5,460,10012.0,104.0,64.0,5,216,10012.0,20.0,15.0
0.008,17,2,162,1,65,0.0,37.0,37.0,1,97,0.0,69.0,69.0
0.006,6,10,1547,5,764,1.0,496.0,496.0,5,783,1.0,515.0,515.0
0.004,6,10,1702,5,863,1.0,595.0,595.0,5,839,1.0,571.0,571.0
0.115,6,10,1506,5,395,25.0,127.0,127.0,5,1111,24.0,843.0,843.0
40.088,17,10,676,5,460,10015.0,104.0,64.0,5,216,10015.0,20.0,15.0
0.009,6,10,1972,5,910,2.0,642.0,642.0,5,1062,2.0,794.0,794.0
0.013,6,10,1990,5,911,3.0,643.0,643.0,5,1079,3.0,811.0,811.0
0.005,6,10,2000,5,927,1.0,659.0,659.0,5,1073,1.0,805.0,805.0
0.132,17,2,80,1,32,0.0,4.0,4.0,1,48,0.0,20.0,20.0
0.088,6,10,1506,5,395,18.0,127.0,127.0,5,1111,19.0,843.0,843.0
0.004,17,2,136,1,60,0.0,32.0,32.0,1,76,0.0,48.0,48.0
0.005,6,10,1989,5,927,1.0,659.0,659.0,5,1062,1.0,794.0,794.0
0.008,6,10,2000,5,927,2.0,659.0,659.0,5,1073,2.0,805.0,805.0
40.053,17,10,676,5,460,10012.0,104.0,64.0,5,216,10012.0,20.0,15.0
300.275,6,16,2170,9,684,37514.0,146.0,146.0,7,1486,50018.0,419.0,398.0
0.04,17,4,420,2,122,0.0,33.0,33.0,2,298,1.0,145.0,121.0
40.089,17,10,676,5,460,10014.0,104.0,64.0,5,216,10019.0,20.0,15.0
0.008,6,10,1989,5,910,2.0,642.0,642.0,5,1079,2.0,811.0,811.0
0.097,6,10,1506,5,395,23.0,127.0,127.0,5,1111,21.0,843.0,843.0
0.111,6,10,1506,5,395,23.0,127.0,127.0,5,1111,21.0,843.0,843.0
0.038,17,2,144,1,64,0.0,36.0,36.0,1,80,0.0,52.0,52.0
0.015,6,10,1631,5,848,3.0,580.0,580.0,5,783,3.0,515.0,515.0
0.216,6,16,2778,8,1396,30.0,533.0,324.0,8,1382,19.0,529.0,239.0
0.008,6,10,1989,5,927,2.0,659.0,659.0,5,1062,1.0,794.0,794.0
0.004,6,10,1989,5,927,1.0,659.0,659.0,5,1062,1.0,794.0,794.0
177.196,17,70,9933,35,2322,5211.0,44.0,38.0,35,7611,5211.0,239.0,189.0
176.149,17,76,10726,38,2532,4760.0,44.0,38.0,38,8194,4760.0,239.0,187.0
40.062,17,10,676,5,460,10014.0,104.0,64.0,5,216,10014.0,20.0,15.0
0.108,6,10,1506,5,395,23.0,127.0,127.0,5,1111,23.0,843.0,843.0
0.093,6,10,1506,5,395,20.0,127.0,127.0,5,1111,22.0,843.0,843.0
0.077,6,10,1506,5,395,17.0,127.0,127.0,5,1111,18.0,843.0,843.0
240.013,6,9,787,5,488,60003.0,232.0,232.0,4,299,80003.0,83.0,83.0
0.005,6,10,2006,5,927,1.0,659.0,659.0,5,1079,1.0,811.0,811.0
0.016,6,10,1990,5,911,3.0,643.0,643.0,5,1079,3.0,811.0,811.0
0.107,6,10,1506,5,395,24.0,127.0,127.0,5,1111,25.0,843.0,843.0
0.004,6,10,2000,5,927,1.0,659.0,659.0,5,1073,1.0,805.0,805.0
0.008,17,2,162,1,65,0.0,37.0,37.0,1,97,0.0,69.0,69.0
0.004,6,10,1702,5,863,1.0,595.0,595.0,5,839,0.0,571.0,571.0
0.004,6,10,2006,5,927,1.0,659.0,659.0,5,1079,1.0,811.0,811.0
40.069,17,10,676,5,460,10016.0,104.0,64.0,5,216,10016.0,20.0,15.0
0.031,6,10,1989,5,910,7.0,642.0,642.0,5,1079,7.0,811.0,811.0
0.005,6,10,1643,5,860,1.0,592.0,592.0,5,783,1.0,515.0,515.0
0.302,17,4,352,2,130,251.0,37.0,37.0,2,222,156.0,89.0,83.0
0.001,17,2,180,1,66,0.0,38.0,38.0,1,114,0.0,86.0,86.0
0.009,6,13,3735,7,497,1.0,125.0,125.0,6,3238,1.0,1470.0,1459.0
356.564,6,21,1795,16,1030,23770.0,190.0,190.0,5,765,60002.0,464.0,248.0
0.109,6,10,1506,5,395,21.0,127.0,127.0,5,1111,26.0,843.0,843.0
1768.383,6,92,5749,46,2490,39296.0,36.0,32.0,46,3259,39296.0,280.0,173.0
0.005,6,10,1779,5,928,1.0,660.0,660.0,5,851,1.0,583.0,583.0
0.005,17,2,169,1,62,0.0,34.0,34.0,1,107,0.0,79.0,79.0
0.005,17,2,170,1,65,0.0,37.0,37.0,1,105,0.0,77.0,77.0
0.009,6,10,1989,5,927,2.0,659.0,659.0,5,1062,2.0,794.0,794.0
308.573,17,20,1124,10,716,34271.0,48.0,43.0,10,408,34271.0,20.0,12.0
0.015,6,10,1762,5,911,3.0,643.0,643.0,5,851,3.0,583.0,583.0
0.006,6,10,1643,5,860,1.0,592.0,592.0,5,783,1.0,515.0,515.0
0.005,6,10,2006,5,927,1.0,659.0,659.0,5,1079,1.0,811.0,811.0
0.005,6,10,1643,5,860,1.0,592.0,592.0,5,783,1.0,515.0,515.0
0.004,6,10,1779,5,928,1.0,660.0,660.0,5,851,1.0,583.0,583.0
0.015,6,10,1989,5,910,3.0,642.0,642.0,5,1079,3.0,811.0,811.0
0.081,6,10,1506,5,395,17.0,127.0,127.0,5,1111,16.0,843.0,843.0
0.041,17,2,186,1,61,0.0,33.0,33.0,1,125,0.0,97.0,97.0
0.134,17,2,80,1,32,0.0,4.0,4.0,1,48,0.0,20.0,20.0
300.388,6,16,2170,9,684,37527.0,146.0,146.0,7,1486,50036.0,419.0,398.0
0.008,6,12,1926,6,1189,1.0,659.0,434.0,6,737,1.0,417.0,417.0
300.389,6,16,2170,9,684,37528.0,146.0,146.0,7,1486,50037.0,419.0,398.0
0.005,6,10,1547,5,764,1.0,496.0,496.0,5,783,1.0,515.0,515.0
0.015,6,10,1972,5,910,3.0,642.0,642.0,5,1062,3.0,794.0,794.0
0.001,17,2,136,1,60,0.0,32.0,32.0,1,76,0.0,48.0,48.0
0.041,17,4,284,2,120,0.0,32.0,32.0,2,164,38.0,60.0,54.0
0.184,17,2,152,1,76,0.0,48.0,48.0,1,76,0.0,48.0,48.0
0.005,6,10,1547,5,764,1.0,496.0,496.0,5,783,1.0,515.0,515.0
0.005,6,10,2007,5,928,1.0,660.0,660.0,5,1079,1.0,811.0,811.0
40.082,17,10,676,5,460,10017.0,104.0,64.0,5,216,10019.0,20.0,15.0
0.006,6,10,1689,5,839,1.0,571.0,571.0,5,850,1.0,582.0,582.0
0.005,6,10,1854,5,889,1.0,621.0,621.0,5,965,1.0,697.0,697.0
0.005,6,10,1854,5,889,1.0,621.0,621.0,5,965,1.0,697.0,697.0
281.028,6,32,9853,17,2710,17562.0,676.0,363.0,15,7143,20070.0,1402.0,707.0
40.064,17,10,676,5,460,10013.0,104.0,64.0,5,216,10015.0,20.0,15.0
0.081,6,10,1506,5,395,18.0,127.0,127.0,5,1111,15.0,843.0,843.0
0.114,6,10,1506,5,395,27.0,127.0,127.0,5,1111,24.0,843.0,843.0
300.208,6,40,10153,21,4595,15001.0,1360.0,620.0,19,5558,16668.0,1360.0,398.0
0.005,6,10,1689,5,839,1.0,571.0,571.0,5,850,1.0,582.0,582.0
0.001,17,2,180,1,66,0.0,38.0,38.0,1,114,0.0,86.0,86.0
0.018,6,10,1990,5,911,4.0,643.0,643.0,5,1079,4.0,811.0,811.0
0.075,6,10,1506,5,395,17.0,127.0,127.0,5,1111,17.0,843.0,843.0
0.092,6,10,1506,5,395,19.0,127.0,127.0,5,1111,15.0,843.0,843.0
40.063,17,10,676,5,460,10012.0,104.0,64.0,5,216,10014.0,20.0,15.0
0.039,17,2,166,1,75,0.0,47.0,47.0,1,91,0.0,63.0,63.0
0.005,6,10,1779,5,928,1.0,660.0,660.0,5,851,1.0,583.0,583.0
0.009,6,10,1989,5,910,2.0,642.0,642.0,5,1079,2.0,811.0,811.0
0.02,17,2,169,1,62,0.0,34.0,34.0,1,107,0.0,79.0,79.0
0.009,6,10,1989,5,910,2.0,642.0,642.0,5,1079,2.0,811.0,811.0
0.006,6,10,1989,5,927,1.0,659.0,659.0,5,1062,1.0,794.0,794.0
0.005,6,10,2007,5,928,1.0,660.0,660.0,5,1079,1.0,811.0,811.0
66.363,6,22,8499,12,2236,71.0,1345.0,574.0,10,6263,7355.0,2720.0,975.0
0.007,6,10,1689,5,839,1.0,571.0,571.0,5,850,1.0,582.0,582.0
0.006,17,2,170,1,65,0.0,37.0,37.0,1,105,0.0,77.0,77.0
0.097,6,10,1506,5,395,24.0,127.0,127.0,5,1111,21.0,843.0,843.0
0.014,6,10,1762,5,911,3.0,643.0,643.0,5,851,3.0,583.0,583.0
240.224,6,28,15735,15,6948,17158.0,2736.0,1028.0,13,8787,20018.0,1908.0,1157.0
0.005,6,10,1547,5,764,1.0,496.0,496.0,5,783,1.0,515.0,515.0
0.006,6,10,1547,5,764,1.0,496.0,496.0,5,783,1.0,515.0,515.0
0.004,6,10,1989,5,927,1.0,659.0,659.0,5,1062,1.0,794.0,794.0
280.682,6,25,6480,12,1266,25516.0,267.0,156.0,13,5214,23387.0,1400.0,781.0
0.005,6,10,1547,5,764,1.0,496.0,496.0,5,783,1.0,515.0,515.0
0.002,17,2,180,1,66,0.0,38.0,38.0,1,114,0.0,86.0,86.0
0.004,6,10,1779,5,928,1.0,660.0,660.0,5,851,1.0,583.0,583.0
300.335,6,16,2170,9,684,37520.0,146.0,146.0,7,1486,50026.0,419.0,398.0
0.068,6,10,1506,5,395,13.0,127.0,127.0,5,1111,14.0,843.0,843.0
0.11,6,10,1506,5,395,24.0,127.0,127.0,5,1111,24.0,843.0,843.0
0.023,6,10,1989,5,910,5.0,642.0,642.0,5,1079,5.0,811.0,811.0
0.074,6,10,1506,5,395,17.0,127.0,127.0,5,1111,15.0,843.0,843.0
0.012,6,10,1989,5,910,3.0,642.0,642.0,5,1079,3.0,811.0,811.0
0.001,17,2,180,1,66,0.0,38.0,38.0,1,114,0.0,86.0,86.0
386.773,6,29,4397,13,3142,32231.0,494.0,494.0,16,1255,25784.0,83.0,83.0
0.012,6,10,1989,5,910,3.0,642.0,642.0,5,1079,3.0,811.0,811.0
0.005,17,2,214,1,75,0.0,47.0,47.0,1,139,0.0,111.0,111.0
0.025,6,10,1989,5,910,6.0,642.0,642.0,5,1079,6.0,811.0,811.0
0.006,6,10,1547,5,764,1.0,496.0,496.0,5,783,1.0,515.0,515.0
0.23,6,16,2779,8,1397,32.0,533.0,324.0,8,1382,21.0,529.0,239.0
40.061,17,10,676,5,460,10012.0,104.0,64.0,5,216,10014.0,20.0,15.0
0.006,6,10,1854,5,889,1.0,621.0,621.0,5,965,1.0,697.0,697.0
0.009,6,10,1972,5,910,2.0,642.0,642.0,5,1062,2.0,794.0,794.0
0.017,6,10,1990,5,911,4.0,643.0,643.0,5,1079,4.0,811.0,811.0
0.065,6,10,1506,5,395,13.0,127.0,127.0,5,1111,15.0,843.0,843.0
0.005,6,10,2000,5,927,1.0,659.0,659.0,5,1073,1.0,805.0,805.0
0.004,17,4,284,2,120,0.0,32.0,32.0,2,164,0.0,60.0,54.0
40.069,17,10,676,5,460,10016.0,104.0,64.0,5,216,10016.0,20.0,15.0
0.004,6,10,2000,5,927,1.0,659.0,659.0,5,1073,1.0,805.0,805.0
0.124,17,2,136,1,60,0.0,32.0,32.0,1,76,0.0,48.0,48.0
240.032,6,9,787,5,488,60008.0,232.0,232.0,4,299,80006.0,83.0,83.0
0.005,6,10,2007,5,928,1.0,660.0,660.0,5,1079,1.0,811.0,811.0
0.005,6,10,2007,5,928,1.0,660.0,660.0,5,1079,1.0,811.0,811.0
0.001,17,2,180,1,66,0.0,38.0,38.0,1,114,0.0,86.0,86.0
0.123,6,10,1506,5,395,27.0,127.0,127.0,5,1111,28.0,843.0,843.0
0.071,6,10,1506,5,395,16.0,127.0,127.0,5,1111,15.0,843.0,843.0
9.037,17,6,376,5,280,2259.0,28.0,28.0,1,96,0.0,68.0,68.0
0.005,6,14,3799,7,509,0.0,137.0,137.0,7,3290,0.0,1448.0,972.0
0.008,17,2,179,1,71,0.0,43.0,43.0,1,108,0.0,80.0,80.0
300.326,6,27,7436,16,1409,20021.0,217.0,142.0,11,6027,24030.0,1679.0,778.0
0.101,6,10,1506,5,395,21.0,127.0,127.0,5,1111,19.0,843.0,843.0
0.08,6,10,1506,5,395,15.0,127.0,127.0,5,1111,18.0,843.0,843.0
0.004,6,10,1702,5,863,1.0,595.0,595.0,5,839,0.0,571.0,571.0
0.008,6,10,1983,5,910,2.0,642.0,642.0,5,1073,2.0,805.0,805.0
0.005,6,10,2006,5,927,1.0,659.0,659.0,5,1079,1.0,811.0,811.0
40.054,17,10,676,5,460,10012.0,104.0,64.0,5,216,10012.0,20.0,15.0
0.008,6,10,1989,5,910,2.0,642.0,642.0,5,1079,1.0,811.0,811.0
0.106,6,10,1506,5,395,23.0,127.0,127.0,5,1111,24.0,843.0,843.0
0.005,6,10,1989,5,927,1.0,659.0,659.0,5,1062,1.0,794.0,794.0
0.094,6,10,1506,5,395,19.0,127.0,127.0,5,1111,20.0,843.0,843.0
0.005,6,10,1779,5,928,1.0,660.0,660.0,5,851,1.0,583.0,583.0
0.111,6,10,1506,5,395,23.0,127.0,127.0,5,1111,26.0,843.0,843.0
0.096,6,10,1506,5,395,22.0,127.0,127.0,5,1111,22.0,843.0,843.0
0.015,6,10,1983,5,910,3.0,642.0,642.0,5,1073,3.0,805.0,805.0
0.009,6,10,1631,5,848,2.0,580.0,580.0,5,783,2.0,515.0,515.0
0.005,6,10,1989,5,927,1.0,659.0,659.0,5,1062,1.0,794.0,794.0
0.006,6,10,1689,5,839,1.0,571.0,571.0,5,850,1.0,582.0,582.0
0.009,6,10,1677,5,827,2.0,559.0,559.0,5,850,2.0,582.0,582.0
0.105,6,10,1506,5,395,22.0,127.0,127.0,5,1111,23.0,843.0,843.0
0.013,6,10,1989,5,910,3.0,642.0,642.0,5,1079,3.0,811.0,811.0
0.001,17,2,140,1,62,0.0,34.0,34.0,1,78,0.0,50.0,50.0
0.009,6,10,1990,5,911,2.0,643.0,643.0,5,1079,2.0,811.0,811.0
0.223,6,16,2669,8,1395,31.0,533.0,323.0,8,1274,20.0,529.0,212.0
0.004,6,10,1774,5,923,1.0,655.0,655.0,5,851,1.0,583.0,583.0
0.011,6,10,1990,5,911,2.0,643.0,643.0,5,1079,2.0,811.0,811.0
240.164,6,17,7292,9,2024,30020.0,1496.0,780.0,8,5268,34308.0,2804.0,1211.0
0.01,6,10,1990,5,911,2.0,643.0,643.0,5,1079,2.0,811.0,811.0
0.006,17,2,191,1,70,0.0,42.0,42.0,1,121,0.0,93.0,93.0
0.037,6,10,1677,5,827,9.0,559.0,559.0,5,850,9.0,582.0,582.0
354.03,6,21,1795,16,1030,23602.0,190.0,190.0,5,765,60002.0,464.0,248.0
0.1,6,10,1506,5,395,18.0,127.0,127.0,5,1111,24.0,843.0,843.0
0.016,6,20,9974,11,704,1.0,124.0,124.0,9,9270,2.0,2896.0,1758.0
0.103,6,10,1506,5,395,24.0,127.0,127.0,5,1111,22.0,843.0,843.0
0.005,17,2,166,1,75,0.0,47.0,47.0,1,91,0.0,63.0,63.0
0.114,6,10,1506,5,395,27.0,127.0,127.0,5,1111,25.0,843.0,843.0
0.007,6,10,1989,5,910,1.0,642.0,642.0,5,1079,1.0,811.0,811.0
0.083,6,10,1506,5,395,20.0,127.0,127.0,5,1111,17.0,843.0,843.0
0.005,6,10,2006,5,927,1.0,659.0,659.0,5,1079,1.0,811.0,811.0
0.132,17,4,352,2,130,1.0,37.0,37.0,2,222,93.0,89.0,83.0
0.005,17,2,170,1,65,0.0,37.0,37.0,1,105,0.0,77.0,77.0
0.013,6,10,1989,5,910,3.0,642.0,642.0,5,1079,3.0,811.0,811.0
0.001,17,2,179,1,62,0.0,34.0,34.0,1,117,0.0,89.0,89.0
0.005,17,2,230,1,68,0.0,40.0,40.0,1,162,0.0,134.0,134.0
0.003,17,2,148,1,60,0.0,32.0,32.0,1,88,0.0,60.0,60.0
0.012,17,2,136,1,60,0.0,32.0,32.0,1,76,0.0,48.0,48.0
0.006,6,10,1547,5,764,1.0,496.0,496.0,5,783,1.0,515.0,515.0
240.544,6,33,9265,16,1836,16034.0,624.0,199.0,17,7429,15031.0,1402.0,595.0
0.072,17,8,3613,4,1874,24.0,1350.0,440.0,4,1739,12.0,1350.0,406.0
0.014,6,10,1990,5,911,3.0,643.0,643.0,5,1079,3.0,811.0,811.0
0.08,6,10,1506,5,395,18.0,127.0,127.0,5,1111,16.0,843.0,843.0
0.115,6,10,1506,5,395,25.0,127.0,127.0,5,1111,25.0,843.0,843.0
0.005,6,13,3747,7,509,0.0,137.0,137.0,6,3238,0.0,1470.0,1459.0
0.005,6,10,2007,5,928,1.0,660.0,660.0,5,1079,1.0,811.0,811.0
0.109,6,10,1506,5,395,25.0,127.0,127.0,5,1111,24.0,843.0,843.0
0.041,17,2,152,1,76,0.0,48.0,48.0,1,76,0.0,48.0,48.0
0.005,6,10,1689,5,839,1.0,571.0,571.0,5,850,1.0,582.0,582.0
371.261,6,22,2313,16,867,24750.0,195.0,195.0,6,1446,4638.0,419.0,398.0
0.005,6,10,2000,5,927,1.0,659.0,659.0,5,1073,1.0,805.0,805.0
15.08,17,14,9190,8,6902,2149.0,1350.0,834.0,6,2288,3010.0,1350.0,353.0
0.001,17,2,180,1,66,0.0,38.0,38.0,1,114,0.0,86.0,86.0
0.005,17,2,179,1,71,0.0,43.0,43.0,1,108,0.0,80.0,80.0
1772.519,6,105,6270,60,3525,30042.0,27.0,27.0,45,2745,40283.0,27.0,27.0
15.079,17,15,7979,8,5919,2150.0,1350.0,711.0,7,2060,2508.0,1350.0,266.0
0.017,6,10,2000,5,927,4.0,659.0,659.0,5,1073,4.0,805.0,805.0
0.005,6,10,2000,5,927,1.0,659.0,659.0,5,1073,1.0,805.0,805.0
0.001,17,2,136,1,60,0.0,32.0,32.0,1,76,0.0,48.0,48.0
0.005,6,10,1689,5,839,1.0,571.0,571.0,5,850,1.0,582.0,582.0
0.013,6,10,1989,5,910,3.0,642.0,642.0,5,1079,3.0,811.0,811.0
11.992,17,29,4494,15,2416,849.0,587.0,133.0,14,2078,914.0,269.0,120.0
0.004,6,10,2007,5,928,1.0,660.0,660.0,5,1079,0.0,811.0,811.0
0.014,6,10,1972,5,910,3.0,642.0,642.0,5,1062,3.0,794.0,794.0
0.005,6,10,1989,5,927,1.0,659.0,659.0,5,1062,1.0,794.0,794.0
0.069,17,8,3613,4,1874,23.0,1350.0,440.0,4,1739,12.0,1350.0,406.0
1770.461,6,84,4422,42,2211,43180.0,27.0,27.0,42,2211,43180.0,27.0,27.0
0.006,6,10,2006,5,927,1.0,659.0,659.0,5,1079,1.0,811.0,811.0
0.104,6,10,1506,5,395,21.0,127.0,127.0,5,1111,22.0,843.0,843.0
0.003,17,2,136,1,60,0.0,32.0,32.0,1,76,0.0,48.0,48.0
240.128,6,31,9394,15,6876,17152.0,1999.0,677.0,16,2518,16008.0,580.0,209.0
0.005,6,10,2007,5,928,1.0,660.0,660.0,5,1079,1.0,811.0,811.0
0.008,6,12,1926,6,1189,1.0,659.0,434.0,6,737,1.0,417.0,417.0
0.132,6,10,1506,5,395,30.0,127.0,127.0,5,1111,31.0,843.0,843.0
0.01,6,10,1989,5,910,2.0,642.0,642.0,5,1079,2.0,811.0,811.0
0.004,6,10,2006,5,927,1.0,659.0,659.0,5,1079,1.0,811.0,811.0
0.094,6,10,1506,5,395,21.0,127.0,127.0,5,1111,20.0,843.0,843.0
0.005,6,10,2006,5,927,1.0,659.0,659.0,5,1079,1.0,811.0,811.0
292.388,6,322,344226,123,17948,2396.0,2736.0,888.0,199,326278,1476.0,2804.0,1707.0
0.01,6,10,1990,5,911,2.0,643.0,643.0,5,1079,2.0,811.0,811.0
0.006,6,10,1779,5,928,1.0,660.0,660.0,5,851,1.0,583.0,583.0
40.091,17,10,676,5,460,10021.0,104.0,64.0,5,216,10022.0,20.0,15.0
0.011,6,10,1989,5,910,2.0,642.0,642.0,5,1079,2.0,811.0,811.0
0.015,6,10,1990,5,911,3.0,643.0,643.0,5,1079,3.0,811.0,811.0
0.037,6,10,1989,5,910,9.0,642.0,642.0,5,1079,9.0,811.0,811.0
0.004,17,2,136,1,60,0.0,32.0,32.0,1,76,0.0,48.0,48.0
0.005,6,10,1989,5,927,1.0,659.0,659.0,5,1062,1.0,794.0,794.0
0.173,6,3,453,2,321,173.0,241.0,241.0,1,132,0.0,92.0,92.0
241.617,6,402,348642,196,21715,1239.0,2736.0,959.0,206,326927,1178.0,2804.0,1613.0
0.095,6,10,1506,5,395,19.0,127.0,127.0,5,1111,22.0,843.0,843.0
0.005,17,2,170,1,65,0.0,37.0,37.0,1,105,0.0,77.0,77.0
0.039,17,2,148,1,60,0.0,32.0,32.0,1,88,0.0,60.0,60.0
312.76,17,20,1124,10,716,34737.0,48.0,43.0,10,408,34737.0,20.0,12.0
0.07,17,8,3613,4,1874,23.0,1350.0,440.0,4,1739,12.0,1350.0,406.0
0.013,6,10,1990,5,911,3.0,643.0,643.0,5,1079,3.0,811.0,811.0
0.081,6,10,1506,5,395,17.0,127.0,127.0,5,1111,17.0,843.0,843.0
0.121,6,10,1506,5,395,25.0,127.0,127.0,5,1111,25.0,843.0,843.0
0.003,17,2,136,1,60,0.0,32.0,32.0,1,76,0.0,48.0,48.0
0.087,6,10,1506,5,395,20.0,127.0,127.0,5,1111,20.0,843.0,843.0
0.019,6,10,1989,5,910,4.0,642.0,642.0,5,1079,4.0,811.0,811.0
40.065,17,10,676,5,460,10015.0,104.0,64.0,5,216,10015.0,20.0,15.0
0.001,17,2,180,1,66,0.0,38.0,38.0,1,114,0.0,86.0,86.0
0.073,6,10,1506,5,395,17.0,127.0,127.0,5,1111,16.0,843.0,843.0
0.194,6,3,453,2,321,194.0,241.0,241.0,1,132,0.0,92.0,92.0
0.017,6,10,1762,5,911,4.0,643.0,643.0,5,851,4.0,583.0,583.0
0.117,17,2,179,1,71,0.0,43.0,43.0,1,108,0.0,80.0,80.0
0.005,6,10,1643,5,860,1.0,592.0,592.0,5,783,1.0,515.0,515.0
0.015,6,10,1972,5,910,3.0,642.0,642.0,5,1062,3.0,794.0,794.0
0.005,17,2,170,1,65,0.0,37.0,37.0,1,105,0.0,77.0,77.0
0.005,6,10,2000,5,927,1.0,659.0,659.0,5,1073,1.0,805.0,805.0
0.03,6,14,3787,7,497,5.0,125.0,125.0,7,3290,5.0,1448.0,972.0
0.005,6,15,3794,8,504,0.0,80.0,80.0,7,3290,0.0,1448.0,972.0
0.004,17,2,152,1,76,0.0,48.0,48.0,1,76,0.0,48.0,48.0
0.003,17,4,284,2,120,0.0,32.0,32.0,2,164,0.0,60.0,54.0
0.12,6,10,1506,5,395,24.0,127.0,127.0,5,1111,25.0,843.0,843.0
0.005,6,10,1989,5,927,1.0,659.0,659.0,5,1062,1.0,794.0,794.0
0.013,6,10,1989,5,910,3.0,642.0,642.0,5,1079,3.0,811.0,811.0
0.096,6,10,1506,5,395,18.0,127.0,127.0,5,1111,22.0,843.0,843.0
0.082,6,10,1506,5,395,19.0,127.0,127.0,5,1111,16.0,843.0,843.0
8.978,6,36,9962,19,4484,498.0,1360.0,738.0,17,5478,548.0,2667.0,435.0
0.007,6,10,1689,5,839,1.0,571.0,571.0,5,850,1.0,582.0,582.0
0.006,6,10,1547,5,764,1.0,496.0,496.0,5,783,1.0,515.0,515.0
15.073,17,15,9238,8,6902,2149.0,1350.0,834.0,7,2336,2507.0,1350.0,305.0
40.068,17,10,676,5,460,10014.0,104.0,64.0,5,216,10016.0,20.0,15.0
0.007,6,14,3742,7,452,1.0,80.0,80.0,7,3290,1.0,1448.0,972.0
0.015,6,10,1972,5,910,3.0,642.0,642.0,5,1062,3.0,794.0,794.0
0.013,6,10,1990,5,911,3.0,643.0,643.0,5,1079,3.0,811.0,811.0
0.006,6,10,2000,5,927,1.0,659.0,659.0,5,1073,1.0,805.0,805.0
0.135,17,2,80,1,32,0.0,4.0,4.0,1,48,0.0,20.0,20.0
0.005,6,10,2007,5,928,1.0,660.0,660.0,5,1079,1.0,811.0,811.0
0.006,6,13,3684,7,446,1.0,74.0,74.0,6,3238,1.0,1470.0,1459.0
0.005,17,2,213,1,69,0.0,41.0,41.0,1,144,0.0,116.0,116.0
0.006,6,12,1698,6,863,1.0,327.0,271.0,6,835,1.0,515.0,515.0
40.058,17,10,676,5,460,10013.0,104.0,64.0,5,216,10013.0,20.0,15.0
0.071,6,10,1506,5,395,17.0,127.0,127.0,5,1111,16.0,843.0,843.0
0.006,6,10,1689,5,839,1.0,571.0,571.0,5,850,1.0,582.0,582.0
0.098,6,10,1506,5,395,21.0,127.0,127.0,5,1111,21.0,843.0,843.0
0.089,6,10,1506,5,395,20.0,127.0,127.0,5,1111,20.0,843.0,843.0
0.039,17,2,136,1,60,0.0,32.0,32.0,1,76,0.0,48.0,48.0
0.005,6,10,1779,5,928,1.0,660.0,660.0,5,851,1.0,583.0,583.0
0.006,17,2,170,1,65,0.0,37.0,37.0,1,105,0.0,77.0,77.0
1794.066,6,557,190780,286,164215,6294.0,2883.0,910.0,271,26565,6644.0,580.0,122.0
0.015,6,10,1989,5,910,3.0,642.0,642.0,5,1079,3.0,811.0,811.0
0.01,17,2,138,1,61,0.0,33.0,33.0,1,77,0.0,49.0,49.0
0.005,6,10,2006,5,927,1.0,659.0,659.0,5,1079,1.0,811.0,811.0
240.104,6,16,4481,9,963,30013.0,238.0,166.0,7,3518,40016.0,1402.0,786.0
0.011,6,10,1989,5,910,2.0,642.0,642.0,5,1079,2.0,811.0,811.0
0.005,6,10,1643,5,860,1.0,592.0,592.0,5,783,1.0,515.0,515.0
15.257,17,17,8648,9,6476,1903.0,1350.0,691.0,8,2172,2175.0,1350.0,243.0
0.014,6,10,1990,5,911,3.0,643.0,643.0,5,1079,3.0,811.0,811.0
0.152,6,10,1506,5,395,34.0,127.0,127.0,5,1111,22.0,843.0,843.0
314.21,17,20,1124,10,716,34900.0,48.0,43.0,10,408,34903.0,20.0,12.0
0.103,6,10,1506,5,395,22.0,127.0,127.0,5,1111,21.0,843.0,843.0
0.069,17,2,152,1,76,0.0,48.0,48.0,1,76,0.0,48.0,48.0
0.006,6,10,1689,5,839,1.0,571.0,571.0,5,850,1.0,582.0,582.0
0.005,6,10,2007,5,928,1.0,660.0,660.0,5,1079,1.0,811.0,811.0
0.004,17,2,136,1,60,0.0,32.0,32.0,1,76,0.0,48.0,48.0
0.005,6,10,1989,5,927,1.0,659.0,659.0,5,1062,1.0,794.0,794.0
0.043,17,2,184,1,61,0.0,33.0,33.0,1,123,0.0,95.0,95.0
0.006,6,10,1854,5,889,1.0,621.0,621.0,5,965,1.0,697.0,697.0
0.005,6,13,3747,7,509,0.0,137.0,137.0,6,3238,0.0,1470.0,1459.0
240.073,6,20,4873,11,941,24007.0,180.0,93.0,9,3932,30008.0,1592.0,576.0
0.005,6,10,2007,5,928,1.0,660.0,660.0,5,1079,1.0,811.0,811.0
0.01,6,10,1972,5,910,2.0,642.0,642.0,5,1062,2.0,794.0,794.0
0.009,6,10,1989,5,910,2.0,642.0,642.0,5,1079,2.0,811.0,811.0
0.007,6,10,1547,5,764,1.0,496.0,496.0,5,783,1.0,515.0,515.0
0.005,6,13,3747,7,509,0.0,137.0,137.0,6,3238,0.0,1470.0,1459.0
361.838,6,21,1793,16,1030,24122.0,190.0,190.0,5,763,60010.0,462.0,247.0
0.009,6,10,1990,5,911,2.0,643.0,643.0,5,1079,2.0,811.0,811.0
0.091,6,10,1506,5,395,18.0,127.0,127.0,5,1111,17.0,843.0,843.0
1797.353,17,2950,226009,1466,118805,1226.0,84.0,53.0,1484,107204,1211.0,227.0,44.0
0.169,6,10,1506,5,395,30.0,127.0,127.0,5,1111,40.0,843.0,843.0
0.009,6,12,1698,6,863,1.0,327.0,271.0,6,835,1.0,515.0,515.0
0.006,6,10,1989,5,927,1.0,659.0,659.0,5,1062,1.0,794.0,794.0
176.29,17,90,13268,45,3031,4006.0,44.0,39.0,45,10237,4006.0,279.0,199.0
0.017,6,10,1972,5,910,4.0,642.0,642.0,5,1062,4.0,794.0,794.0
0.006,6,10,1547,5,764,1.0,496.0,496.0,5,783,1.0,515.0,515.0
0.005,6,13,3747,7,509,0.0,137.0,137.0,6,3238,0.0,1470.0,1459.0
240.268,6,36,10343,18,1862,14133.0,534.0,183.0,18,8481,14133.0,1402.0,629.0
0.005,6,10,2000,5,927,1.0,659.0,659.0,5,1073,1.0,805.0,805.0
0.004,6,10,2006,5,927,1.0,659.0,659.0,5,1079,1.0,811.0,811.0
262.782,6,20,3797,11,2323,26274.0,676.0,348.0,9,1474,32843.0,821.0,336.0
0.005,6,10,1547,5,764,1.0,496.0,496.0,5,783,1.0,515.0,515.0
0.011,6,12,1698,6,863,2.0,327.0,271.0,6,835,2.0,515.0,515.0
40.061,17,10,676,5,460,10012.0,104.0,64.0,5,216,10014.0,20.0,15.0
0.013,6,10,1605,5,388,3.0,120.0,120.0,5,1217,3.0,949.0,949.0
0.005,6,10,1779,5,928,1.0,660.0,660.0,5,851,1.0,583.0,583.0
0.039,17,2,156,1,64,0.0,36.0,36.0,1,92,0.0,64.0,64.0
11.003,17,28,4399,14,2312,837.0,587.0,137.0,14,2087,837.0,270.0,121.0
0.004,17,2,170,1,65,0.0,37.0,37.0,1,105,0.0,77.0,77.0
40.045,17,10,676,5,460,10010.0,104.0,64.0,5,216,10010.0,20.0,15.0
40.081,17,10,676,5,460,10019.0,104.0,64.0,5,216,10019.0,20.0,15.0
455.407,6,36,12930,20,4540,23968.0,1402.0,498.0,16,8390,26357.0,1402.0,838.0
240.279,6,42,8772,20,5646,12646.0,2883.0,573.0,22,3126,11441.0,580.0,219.0
0.018,6,10,1972,5,910,4.0,642.0,642.0,5,1062,4.0,794.0,794.0
309.368,17,20,1124,10,716,34361.0,48.0,43.0,10,408,34362.0,20.0,12.0
0.006,6,10,1547,5,764,1.0,496.0,496.0,5,783,1.0,515.0,515.0
0.005,6,10,2006,5,927,1.0,659.0,659.0,5,1079,1.0,811.0,811.0
0.006,6,10,1643,5,860,1.0,592.0,592.0,5,783,1.0,515.0,515.0
0.005,6,10,2007,5,928,1.0,660.0,660.0,5,1079,1.0,811.0,811.0
0.008,17,2,144,1,64,0.0,36.0,36.0,1,80,0.0,52.0,52.0
0.005,17,2,180,1,58,0.0,30.0,30.0,1,122,0.0,94.0,94.0
0.004,6,10,1774,5,923,1.0,655.0,655.0,5,851,1.0,583.0,583.0
0.082,6,10,1506,5,395,17.0,127.0,127.0,5,1111,16.0,843.0,843.0
0.004,6,10,1702,5,863,1.0,595.0,595.0,5,839,1.0,571.0,571.0
0.093,6,10,1506,5,395,21.0,127.0,127.0,5,1111,21.0,843.0,843.0
0.071,6,10,1506,5,395,15.0,127.0,127.0,5,1111,17.0,843.0,843.0
0.018,6,10,1989,5,910,4.0,642.0,642.0,5,1079,4.0,811.0,811.0
240.09,6,30,8915,15,6549,17149.0,1674.0,641.0,15,2366,17149.0,580.0,225.0
1729.224,6,60,4400,40,2740,44339.0,33.0,33.0,20,1660,91003.0,31.0,31.0
0.116,6,10,1506,5,395,26.0,127.0,127.0,5,1111,23.0,843.0,843.0
0.006,17,2,214,1,75,0.0,47.0,47.0,1,139,0.0,111.0,111.0
0.091,6,10,1506,5,395,21.0,127.0,127.0,5,1111,21.0,843.0,843.0
40.064,17,10,676,5,460,10015.0,104.0,64.0,5,216,10015.0,20.0,15.0
0.006,6,10,1547,5,764,1.0,496.0,496.0,5,783,1.0,515.0,515.0
0.01,6,12,1926,6,1189,1.0,659.0,434.0,6,737,1.0,417.0,417.0
232.1,6,1172,1215850,527,1181588,440.0,5440.0,2339.0,645,34262,360.0,2667.0,196.0
0.013,6,10,1972,5,910,3.0,642.0,642.0,5,1062,3.0,794.0,794.0
0.007,6,10,1989,5,910,1.0,642.0,642.0,5,1079,1.0,811.0,811.0
0.006,17,2,213,1,69,0.0,41.0,41.0,1,144,0.0,116.0,116.0
40.065,17,10,676,5,460,10013.0,104.0,64.0,5,216,10015.0,20.0,15.0
0.004,6,10,2006,5,927,1.0,659.0,659.0,5,1079,1.0,811.0,811.0
0.1,6,10,1506,5,395,22.0,127.0,127.0,5,1111,23.0,843.0,843.0
0.008,6,10,1989,5,910,2.0,642.0,642.0,5,1079,2.0,811.0,811.0
0.004,6,10,2006,5,927,1.0,659.0,659.0,5,1079,1.0,811.0,811.0
0.019,6,10,1677,5,827,4.0,559.0,559.0,5,850,4.0,582.0,582.0
300.243,6,16,2170,9,684,37509.0,146.0,146.0,7,1486,50012.0,419.0,398.0
0.005,6,10,2000,5,927,1.0,659.0,659.0,5,1073,1.0,805.0,805.0
181.379,17,84,11932,42,2804,4423.0,44.0,38.0,42,9128,4422.0,239.0,189.0
0.007,17,2,179,1,71,0.0,43.0,43.0,1,108,0.0,80.0,80.0
0.01,6,10,1972,5,910,2.0,642.0,642.0,5,1062,2.0,794.0,794.0
0.039,17,2,166,1,75,0.0,47.0,47.0,1,91,0.0,63.0,63.0
0.102,6,10,1506,5,395,19.0,127.0,127.0,5,1111,25.0,843.0,843.0
40.077,17,10,676,5,460,10016.0,104.0,64.0,5,216,10018.0,20.0,15.0
0.006,6,10,1547,5,764,1.0,496.0,496.0,5,783,1.0,515.0,515.0
0.006,6,10,1702,5,863,1.0,595.0,595.0,5,839,1.0,571.0,571.0
0.001,17,2,136,1,60,0.0,32.0,32.0,1,76,0.0,48.0,48.0
0.066,6,10,1506,5,395,15.0,127.0,127.0,5,1111,13.0,843.0,843.0
0.005,6,10,2007,5,928,1.0,660.0,660.0,5,1079,1.0,811.0,811.0
0.005,6,10,1547,5,764,1.0,496.0,496.0,5,783,1.0,515.0,515.0
0.004,6,10,1702,5,863,1.0,595.0,595.0,5,839,1.0,571.0,571.0
0.118,6,10,1506,5,395,22.0,127.0,127.0,5,1111,25.0,843.0,843.0
15.182,17,17,9492,9,5960,1894.0,1350.0,634.0,8,3532,2164.0,1350.0,413.0
0.007,6,10,1643,5,860,1.0,592.0,592.0,5,783,1.0,515.0,515.0
0.127,6,10,1506,5,395,29.0,127.0,127.0,5,1111,26.0,843.0,843.0
0.004,17,2,148,1,60,0.0,32.0,32.0,1,88,0.0,60.0,60.0
0.006,17,2,179,1,71,0.0,43.0,43.0,1,108,0.0,80.0,80.0
0.096,6,10,1506,5,395,19.0,127.0,127.0,5,1111,20.0,843.0,843.0
0.008,17,2,213,1,69,0.0,41.0,41.0,1,144,0.0,116.0,116.0
0.005,6,10,1774,5,923,1.0,655.0,655.0,5,851,1.0,583.0,583.0
0.115,6,10,1506,5,395,26.0,127.0,127.0,5,1111,26.0,843.0,843.0
0.005,6,10,2007,5,928,1.0,660.0,660.0,5,1079,1.0,811.0,811.0
0.005,6,10,2006,5,927,1.0,659.0,659.0,5,1079,1.0,811.0,811.0
291.09,6,310,343506,117,17628,2509.0,2736.0,888.0,193,325878,1516.0,2804.0,1764.0
0.047,17,2,209,1,64,0.0,36.0,36.0,1,145,0.0,117.0,117.0
0.021,6,10,1989,5,910,5.0,642.0,642.0,5,1079,5.0,811.0,811.0
0.098,6,10,1506,5,395,22.0,127.0,127.0,5,1111,20.0,843.0,843.0
0.004,17,2,148,1,60,0.0,32.0,32.0,1,88,0.0,60.0,60.0
0.039,6,10,1972,5,910,9.0,642.0,642.0,5,1062,9.0,794.0,794.0
0.01,6,10,1983,5,910,2.0,642.0,642.0,5,1073,2.0,805.0,805.0
0.11,6,10,1506,5,395,23.0,127.0,127.0,5,1111,17.0,843.0,843.0
0.01,6,10,1983,5,910,2.0,642.0,642.0,5,1073,2.0,805.0,805.0
0.01,6,10,1972,5,910,2.0,642.0,642.0,5,1062,2.0,794.0,794.0
0.004,6,10,2007,5,928,1.0,660.0,660.0,5,1079,1.0,811.0,811.0
0.064,17,4,596,2,122,0.0,33.0,33.0,2,474,0.0,323.0,209.0
0.016,6,10,1983,5,910,4.0,642.0,642.0,5,1073,4.0,805.0,805.0
0.005,6,10,1547,5,764,1.0,496.0,496.0,5,783,1.0,515.0,515.0
0.068,6,10,1506,5,395,14.0,127.0,127.0,5,1111,16.0,843.0,843.0
0.013,6,10,1983,5,910,3.0,642.0,642.0,5,1073,3.0,805.0,805.0
0.005,6,10,1989,5,927,1.0,659.0,659.0,5,1062,1.0,794.0,794.0
15.081,17,16,8622,8,6556,2150.0,1350.0,791.0,8,2066,2150.0,1350.0,230.0
0.082,6,10,1506,5,395,17.0,127.0,127.0,5,1111,18.0,843.0,843.0
0.104,6,10,1506,5,395,21.0,127.0,127.0,5,1111,22.0,843.0,843.0
0.02,6,10,1989,5,910,5.0,642.0,642.0,5,1079,5.0,811.0,811.0
300.017,6,11,891,6,552,60003.0,232.0,232.0,5,339,75003.0,83.0,83.0
0.008,6,10,1643,5,860,1.0,592.0,592.0,5,783,1.0,515.0,515.0
0.01,6,10,1677,5,827,2.0,559.0,559.0,5,850,2.0,582.0,582.0
0.02,6,10,1972,5,910,5.0,642.0,642.0,5,1062,5.0,794.0,794.0
0.045,17,2,182,1,65,0.0,37.0,37.0,1,117,0.0,89.0,89.0
0.005,6,10,2006,5,927,1.0,659.0,659.0,5,1079,1.0,811.0,811.0
240.11,6,16,4482,9,963,30013.0,238.0,166.0,7,3519,40017.0,1402.0,786.0
40.078,17,10,676,5,460,10018.0,104.0,64.0,5,216,10018.0,20.0,15.0
0.005,6,10,2006,5,927,1.0,659.0,659.0,5,1079,1.0,811.0,811.0
0.149,6,10,1506,5,395,34.0,127.0,127.0,5,1111,35.0,843.0,843.0
0.113,6,10,1506,5,395,25.0,127.0,127.0,5,1111,25.0,843.0,843.0
0.042,17,2,138,1,61,0.0,33.0,33.0,1,77,0.0,49.0,49.0
0.005,6,10,1702,5,863,1.0,595.0,595.0,5,839,1.0,571.0,571.0
0.004,6,10,1702,5,863,1.0,595.0,595.0,5,839,0.0,571.0,571.0
0.005,6,10,2006,5,927,1.0,659.0,659.0,5,1079,1.0,811.0,811.0
161.478,17,78,11333,39,2612,4249.0,44.0,38.0,39,8721,4249.0,261.0,195.0
0.004,17,4,284,2,120,0.0,32.0,32.0,2,164,0.0,60.0,54.0
0.001,17,2,136,1,60,0.0,32.0,32.0,1,76,0.0,48.0,48.0
0.065,6,10,1506,5,395,14.0,127.0,127.0,5,1111,14.0,843.0,843.0
40.073,17,10,676,5,460,10015.0,104.0,64.0,5,216,10017.0,20.0,15.0
0.111,6,10,1506,5,395,21.0,127.0,127.0,5,1111,22.0,843.0,843.0
0.004,6,10,1702,5,863,1.0,595.0,595.0,5,839,1.0,571.0,571.0
0.027,17,2,198,1,91,0.0,63.0,63.0,1,107,0.0,79.0,79.0
0.004,6,10,1989,5,927,1.0,659.0,659.0,5,1062,1.0,794.0,794.0
0.089,6,10,1506,5,395,20.0,127.0,127.0,5,1111,15.0,843.0,843.0
0.012,6,10,1972,5,910,2.0,642.0,642.0,5,1062,3.0,794.0,794.0
0.011,6,10,1972,5,910,2.0,642.0,642.0,5,1062,2.0,794.0,794.0
0.018,6,10,1631,5,848,4.0,580.0,580.0,5,783,4.0,515.0,515.0
0.015,6,10,1677,5,827,3.0,559.0,559.0,5,850,3.0,582.0,582.0
240.294,6,35,10763,17,2159,15018.0,555.0,253.0,18,8604,14134.0,1510.0,639.0
0.264,6,10,1506,5,395,64.0,127.0,127.0,5,1111,26.0,843.0,843.0
0.01,6,10,1983,5,910,2.0,642.0,642.0,5,1073,2.0,805.0,805.0
0.007,17,2,299,1,65,0.0,37.0,37.0,1,234,0.0,206.0,206.0
0.193,6,10,1506,5,395,45.0,127.0,127.0,5,1111,38.0,843.0,843.0
40.082,17,10,676,5,460,10017.0,104.0,64.0,5,216,10019.0,20.0,15.0
40.055,17,10,676,5,460,10011.0,104.0,64.0,5,216,10013.0,20.0,15.0
0.038,17,4,284,2,120,0.0,32.0,32.0,2,164,34.0,60.0,54.0
0.01,6,10,1983,5,910,2.0,642.0,642.0,5,1073,2.0,805.0,805.0
0.018,17,2,136,1,60,0.0,32.0,32.0,1,76,0.0,48.0,48.0
300.021,6,12,1782,7,1348,50003.0,494.0,494.0,5,434,75004.0,83.0,83.0
0.003,17,4,284,2,120,0.0,32.0,32.0,2,164,0.0,60.0,54.0
0.005,6,10,1643,5,860,1.0,592.0,592.0,5,783,1.0,515.0,515.0
0.016,6,10,1972,5,910,4.0,642.0,642.0,5,1062,3.0,794.0,794.0
1757.408,6,105,6270,60,3525,29785.0,27.0,27.0,45,2745,39939.0,27.0,27.0
40.063,17,10,676,5,460,10014.0,104.0,64.0,5,216,10014.0,20.0,15.0
0.017,6,10,1972,5,910,4.0,642.0,642.0,5,1062,4.0,794.0,794.0
167.204,17,88,12705,44,2955,3888.0,44.0,39.0,44,9750,3888.0,279.0,193.0
0.009,6,10,1983,5,910,2.0,642.0,642.0,5,1073,2.0,805.0,805.0
240.115,6,16,4481,9,963,30014.0,238.0,166.0,7,3518,40017.0,1402.0,786.0
0.069,6,10,1506,5,395,14.0,127.0,127.0,5,1111,14.0,843.0,843.0
0.009,6,10,1989,5,910,2.0,642.0,642.0,5,1079,2.0,811.0,811.0
0.016,6,10,1989,5,910,4.0,642.0,642.0,5,1079,4.0,811.0,811.0
0.15,6,10,1506,5,395,33.0,127.0,127.0,5,1111,35.0,843.0,843.0
0.007,17,2,154,1,69,0.0,41.0,41.0,1,85,0.0,57.0,57.0
0.005,6,10,2006,5,927,1.0,659.0,659.0,5,1079,1.0,811.0,811.0
0.007,17,2,179,1,71,0.0,43.0,43.0,1,108,0.0,80.0,80.0
0.072,17,8,3613,4,1874,24.0,1350.0,440.0,4,1739,12.0,1350.0,406.0
0.004,6,11,2041,6,979,0.0,659.0,659.0,5,1062,1.0,794.0,794.0
0.001,17,2,180,1,66,0.0,38.0,38.0,1,114,0.0,86.0,86.0
10.79,17,28,4421,14,1993,821.0,268.0,114.0,14,2428,821.0,587.0,145.0
0.004,6,10,1702,5,863,1.0,595.0,595.0,5,839,0.0,571.0,571.0
0.068,17,8,3613,4,1874,22.0,1350.0,440.0,4,1739,11.0,1350.0,406.0
0.009,6,10,1983,5,910,2.0,642.0,642.0,5,1073,2.0,805.0,805.0
0.005,6,10,1689,5,839,1.0,571.0,571.0,5,850,1.0,582.0,582.0
40.069,17,10,676,5,460,10015.0,104.0,64.0,5,216,10016.0,20.0,15.0
0.004,17,4,284,2,120,0.0,32.0,32.0,2,164,1.0,60.0,54.0
0.015,6,10,1990,5,911,3.0,643.0,643.0,5,1079,3.0,811.0,811.0
0.0,17,2,154,1,69,0.0,41.0,41.0,1,85,0.0,57.0,57.0
10.834,17,28,4421,14,1994,825.0,269.0,114.0,14,2427,824.0,586.0,145.0
0.004,6,10,2007,5,928,1.0,660.0,660.0,5,1079,1.0,811.0,811.0
0.111,6,10,1506,5,395,19.0,127.0,127.0,5,1111,26.0,843.0,843.0
0.005,6,10,2007,5,928,1.0,660.0,660.0,5,1079,1.0,811.0,811.0
0.001,17,2,180,1,66,0.0,38.0,38.0,1,114,0.0,86.0,86.0
0.006,6,10,1689,5,839,1.0,571.0,571.0,5,850,1.0,582.0,582.0
0.012,6,10,1990,5,911,2.0,643.0,643.0,5,1079,2.0,811.0,811.0
0.014,6,10,1989,5,910,3.0,642.0,642.0,5,1079,3.0,811.0,811.0
0.011,6,10,1762,5,911,2.0,643.0,643.0,5,851,2.0,583.0,583.0
0.037,17,2,184,1,61,0.0,33.0,33.0,1,123,0.0,95.0,95.0
0.094,6,10,1506,5,395,21.0,127.0,127.0,5,1111,19.0,843.0,843.0
0.013,6,10,1762,5,911,3.0,643.0,643.0,5,851,3.0,583.0,583.0
0.004,6,10,1774,5,923,1.0,655.0,655.0,5,851,1.0,583.0,583.0
322.147,17,20,1124,10,716,35779.0,48.0,43.0,10,408,35779.0,20.0,12.0
10.885,17,28,4422,14,1995,828.0,270.0,114.0,14,2427,827.0,586.0,145.0
0.004,17,2,148,1,60,0.0,32.0,32.0,1,88,0.0,60.0,60.0
0.012,6,10,1677,5,827,3.0,559.0,559.0,5,850,2.0,582.0,582.0
0.082,6,10,1506,5,395,18.0,127.0,127.0,5,1111,16.0,843.0,843.0
0.008,6,10,1983,5,910,1.0,642.0,642.0,5,1073,2.0,805.0,805.0
0.015,6,10,1983,5,910,3.0,642.0,642.0,5,1073,3.0,805.0,805.0
0.007,6,10,1547,5,764,1.0,496.0,496.0,5,783,1.0,515.0,515.0
11.178,17,28,4422,14,1995,847.0,270.0,114.0,14,2427,847.0,586.0,145.0
0.014,6,14,3787,7,497,2.0,125.0,125.0,7,3290,2.0,1448.0,972.0
0.005,6,10,2007,5,928,1.0,660.0,660.0,5,1079,1.0,811.0,811.0
0.005,6,10,2007,5,928,1.0,660.0,660.0,5,1079,1.0,811.0,811.0
40.059,17,10,676,5,460,10013.0,104.0,64.0,5,216,10014.0,20.0,15.0
0.156,6,10,1506,5,395,36.0,127.0,127.0,5,1111,33.0,843.0,843.0
0.017,6,10,1762,5,911,4.0,643.0,643.0,5,851,4.0,583.0,583.0
0.037,17,2,170,1,65,0.0,37.0,37.0,1,105,0.0,77.0,77.0
0.005,6,10,2006,5,927,1.0,659.0,659.0,5,1079,1.0,811.0,811.0
0.004,17,2,136,1,60,0.0,32.0,32.0,1,76,0.0,48.0,48.0
0.006,6,10,1989,5,927,1.0,659.0,659.0,5,1062,1.0,794.0,794.0
0.01,6,10,1989,5,910,2.0,642.0,642.0,5,1079,2.0,811.0,811.0
0.005,6,10,2000,5,927,1.0,659.0,659.0,5,1073,1.0,805.0,805.0
0.013,6,10,1990,5,911,3.0,643.0,643.0,5,1079,3.0,811.0,811.0
0.071,6,10,1506,5,395,17.0,127.0,127.0,5,1111,15.0,843.0,843.0
0.004,17,2,144,1,64,0.0,36.0,36.0,1,80,0.0,52.0,52.0
0.137,6,10,1506,5,395,31.0,127.0,127.0,5,1111,31.0,843.0,843.0
0.008,6,10,1990,5,911,2.0,643.0,643.0,5,1079,2.0,811.0,811.0
0.008,6,10,1990,5,911,1.0,643.0,643.0,5,1079,2.0,811.0,811.0
15.078,17,15,8411,8,6400,2150.0,1350.0,772.0,7,2011,2508.0,1350.0,259.0
0.017,6,10,1989,5,910,4.0,642.0,642.0,5,1079,4.0,811.0,811.0
0.014,6,10,1677,5,827,3.0,559.0,559.0,5,850,3.0,582.0,582.0
0.07,6,10,1506,5,395,16.0,127.0,127.0,5,1111,13.0,843.0,843.0
0.117,6,10,1506,5,395,24.0,127.0,127.0,5,1111,23.0,843.0,843.0
0.004,6,10,1702,5,863,1.0,595.0,595.0,5,839,0.0,571.0,571.0
0.005,6,10,2006,5,927,1.0,659.0,659.0,5,1079,1.0,811.0,811.0
0.005,6,10,1989,5,927,1.0,659.0,659.0,5,1062,1.0,794.0,794.0
0.021,6,19,9922,11,704,2.0,124.0,124.0,8,9218,3.0,2896.0,2198.0
0.079,6,10,1506,5,395,16.0,127.0,127.0,5,1111,17.0,843.0,843.0
0.005,6,10,1774,5,923,1.0,655.0,655.0,5,851,1.0,583.0,583.0
0.005,17,2,179,1,71,0.0,43.0,43.0,1,108,0.0,80.0,80.0
0.112,6,10,1506,5,395,26.0,127.0,127.0,5,1111,19.0,843.0,843.0
0.009,6,12,1926,6,1189,1.0,659.0,434.0,6,737,1.0,417.0,417.0
0.012,6,10,1989,5,910,3.0,642.0,642.0,5,1079,3.0,811.0,811.0
0.005,6,10,1643,5,860,1.0,592.0,592.0,5,783,1.0,515.0,515.0
0.077,6,10,1506,5,395,17.0,127.0,127.0,5,1111,16.0,843.0,843.0
0.045,6,10,1762,5,911,11.0,643.0,643.0,5,851,11.0,583.0,583.0
0.121,6,10,1506,5,395,29.0,127.0,127.0,5,1111,29.0,843.0,843.0
0.005,6,10,1643,5,860,1.0,592.0,592.0,5,783,1.0,515.0,515.0
0.005,17,2,136,1,60,0.0,32.0,32.0,1,76,0.0,48.0,48.0
0.222,6,16,2777,8,1395,31.0,533.0,323.0,8,1382,20.0,529.0,239.0
0.054,17,2,152,1,76,0.0,48.0,48.0,1,76,0.0,48.0,48.0
240.118,6,16,4482,9,963,30014.0,238.0,166.0,7,3519,40019.0,1402.0,786.0
0.102,6,10,1506,5,395,22.0,127.0,127.0,5,1111,23.0,843.0,843.0
1770.584,6,79,4162,40,2107,45398.0,27.0,27.0,39,2055,46593.0,27.0,27.0
0.012,6,14,3787,7,497,2.0,125.0,125.0,7,3290,2.0,1448.0,972.0
0.014,6,10,1989,5,910,3.0,642.0,642.0,5,1079,3.0,811.0,811.0
0.226,17,4,352,2,130,1.0,37.0,37.0,2,222,0.0,89.0,83.0
0.006,6,10,1689,5,839,1.0,571.0,571.0,5,850,1.0,582.0,582.0
0.005,17,2,136,1,60,0.0,32.0,32.0,1,76,0.0,48.0,48.0
0.067,17,8,3613,4,1874,22.0,1350.0,440.0,4,1739,11.0,1350.0,406.0
0.005,6,10,1547,5,764,1.0,496.0,496.0,5,783,1.0,515.0,515.0
0.006,17,4,284,2,120,0.0,32.0,32.0,2,164,1.0,60.0,54.0
0.024,6,10,1677,5,827,5.0,559.0,559.0,5,850,5.0,582.0,582.0
240.087,6,16,4481,9,963,30010.0,238.0,166.0,7,3518,40014.0,1402.0,786.0
0.017,6,10,1989,5,910,4.0,642.0,642.0,5,1079,4.0,811.0,811.0
0.088,6,10,1506,5,395,19.0,127.0,127.0,5,1111,21.0,843.0,843.0
0.077,6,10,1506,5,395,18.0,127.0,127.0,5,1111,15.0,843.0,843.0
0.212,6,16,2669,8,1395,30.0,533.0,323.0,8,1274,19.0,529.0,212.0
0.004,6,10,2007,5,928,1.0,660.0,660.0,5,1079,0.0,811.0,811.0
0.019,6,10,1989,5,910,4.0,642.0,642.0,5,1079,4.0,811.0,811.0
0.093,6,10,1506,5,395,20.0,127.0,127.0,5,1111,21.0,843.0,843.0
0.018,6,10,1972,5,910,4.0,642.0,642.0,5,1062,4.0,794.0,794.0
0.137,17,2,182,1,65,0.0,37.0,37.0,1,117,0.0,89.0,89.0
0.005,6,10,1643,5,860,1.0,592.0,592.0,5,783,1.0,515.0,515.0
11.753,17,28,4391,14,2312,891.0,587.0,137.0,14,2079,891.0,270.0,120.0
0.068,17,8,3613,4,1874,22.0,1350.0,440.0,4,1739,11.0,1350.0,406.0
8.943,6,39,10487,20,4929,470.0,1360.0,682.0,19,5558,485.0,2667.0,435.0
0.005,17,2,168,1,76,0.0,48.0,48.0,1,92,0.0,64.0,64.0
176.446,17,86,12521,43,2889,4200.0,44.0,39.0,43,9632,4201.0,239.0,196.0
0.014,17,2,154,1,69,0.0,41.0,41.0,1,85,0.0,57.0,57.0
0.019,6,13,3735,7,497,3.0,125.0,125.0,6,3238,3.0,1470.0,1459.0
10.885,17,28,4422,14,1994,829.0,269.0,114.0,14,2428,828.0,587.0,145.0
0.004,17,4,284,2,120,0.0,32.0,32.0,2,164,0.0,60.0,54.0
0.001,17,2,180,1,66,0.0,38.0,38.0,1,114,0.0,86.0,86.0
0.006,6,10,1689,5,839,1.0,571.0,571.0,5,850,1.0,582.0,582.0
0.005,6,13,3747,7,509,0.0,137.0,137.0,6,3238,0.0,1470.0,1459.0
0.005,6,10,1989,5,927,1.0,659.0,659.0,5,1062,1.0,794.0,794.0
0.004,17,2,148,1,60,0.0,32.0,32.0,1,88,0.0,60.0,60.0
0.062,6,10,1506,5,395,13.0,127.0,127.0,5,1111,14.0,843.0,843.0
0.09,6,10,1506,5,395,18.0,127.0,127.0,5,1111,18.0,843.0,843.0
240.013,6,9,787,5,488,60003.0,232.0,232.0,4,299,80003.0,83.0,83.0
0.005,6,10,2006,5,927,1.0,659.0,659.0,5,1079,1.0,811.0,811.0
0.005,6,10,1989,5,927,1.0,659.0,659.0,5,1062,1.0,794.0,794.0
0.103,6,10,1506,5,395,23.0,127.0,127.0,5,1111,23.0,843.0,843.0
0.111,6,10,1506,5,395,25.0,127.0,127.0,5,1111,25.0,843.0,843.0
361.804,6,21,1792,16,1030,24120.0,190.0,190.0,5,762,60010.0,461.0,247.0
0.08,6,10,1506,5,395,16.0,127.0,127.0,5,1111,15.0,843.0,843.0
0.005,6,10,2000,5,927,1.0,659.0,659.0,5,1073,1.0,805.0,805.0
177.22,17,76,10841,38,2530,4789.0,44.0,38.0,38,8311,4789.0,260.0,190.0
15.088,17,15,8593,8,6404,2151.0,1350.0,772.0,7,2189,2508.0,1350.0,284.0
0.004,6,10,2000,5,927,1.0,659.0,659.0,5,1073,1.0,805.0,805.0
0.009,6,10,1972,5,910,2.0,642.0,642.0,5,1062,2.0,794.0,794.0
0.009,6,10,1990,5,911,2.0,643.0,643.0,5,1079,2.0,811.0,811.0
0.005,17,2,136,1,60,0.0,32.0,32.0,1,76,0.0,48.0,48.0
0.005,6,10,2006,5,927,1.0,659.0,659.0,5,1079,1.0,811.0,811.0
0.16,6,10,1506,5,395,37.0,127.0,127.0,5,1111,26.0,843.0,843.0
0.005,6,10,2000,5,927,1.0,659.0,659.0,5,1073,1.0,805.0,805.0
0.008,6,10,1972,5,910,1.0,642.0,642.0,5,1062,2.0,794.0,794.0
0.005,6,10,2000,5,927,1.0,659.0,659.0,5,1073,1.0,805.0,805.0
0.01,6,10,1990,5,911,2.0,643.0,643.0,5,1079,2.0,811.0,811.0
0.009,6,12,1926,6,1189,1.0,659.0,434.0,6,737,1.0,417.0,417.0
0.124,6,10,1506,5,395,28.0,127.0,127.0,5,1111,29.0,843.0,843.0
0.051,6,10,1989,5,910,12.0,642.0,642.0,5,1079,12.0,811.0,811.0
0.006,17,2,166,1,75,0.0,47.0,47.0,1,91,0.0,63.0,63.0
0.209,6,16,2675,8,1401,29.0,533.0,325.0,8,1274,18.0,529.0,212.0
0.114,6,10,1506,5,395,23.0,127.0,127.0,5,1111,25.0,843.0,843.0
0.089,6,10,1506,5,395,19.0,127.0,127.0,5,1111,18.0,843.0,843.0
0.066,6,10,1506,5,395,16.0,127.0,127.0,5,1111,15.0,843.0,843.0
0.006,17,2,179,1,71,0.0,43.0,43.0,1,108,0.0,80.0,80.0
0.004,6,10,1702,5,863,0.0,595.0,595.0,5,839,1.0,571.0,571.0
300.345,6,19,3084,11,1647,30034.0,517.0,266.0,8,1437,34328.0,824.0,337.0
0.117,17,2,80,1,32,0.0,4.0,4.0,1,48,0.0,20.0,20.0
0.072,6,10,1506,5,395,15.0,127.0,127.0,5,1111,15.0,843.0,843.0
1035.525,6,64,3838,36,2115,29585.0,27.0,27.0,28,1723,38351.0,27.0,26.0
15.072,17,14,9190,8,6902,2149.0,1350.0,834.0,6,2288,3008.0,1350.0,353.0
0.01,6,10,1990,5,911,2.0,643.0,643.0,5,1079,2.0,811.0,811.0
0.005,17,2,230,1,68,0.0,40.0,40.0,1,162,0.0,134.0,134.0
0.082,6,10,1506,5,395,17.0,127.0,127.0,5,1111,18.0,843.0,843.0
0.004,6,10,1774,5,923,1.0,655.0,655.0,5,851,1.0,583.0,583.0
0.014,6,10,1631,5,848,3.0,580.0,580.0,5,783,3.0,515.0,515.0
0.008,6,12,1926,6,1189,1.0,659.0,434.0,6,737,1.0,417.0,417.0
0.005,17,2,164,1,74,0.0,46.0,46.0,1,90,0.0,62.0,62.0
40.068,17,10,676,5,460,10014.0,104.0,64.0,5,216,10015.0,20.0,15.0
0.005,6,10,1774,5,923,1.0,655.0,655.0,5,851,1.0,583.0,583.0
0.1,6,10,1506,5,395,22.0,127.0,127.0,5,1111,22.0,843.0,843.0
352.765,6,20,2210,6,1308,12004.0,494.0,494.0,14,902,27135.0,83.0,83.0
0.107,6,10,1506,5,395,22.0,127.0,127.0,5,1111,25.0,843.0,843.0
0.01,17,2,230,1,68,0.0,40.0,40.0,1,162,0.0,134.0,134.0
0.003,17,2,136,1,60,0.0,32.0,32.0,1,76,0.0,48.0,48.0
0.005,17,2,164,1,74,0.0,46.0,46.0,1,90,0.0,62.0,62.0
0.005,6,10,2006,5,927,1.0,659.0,659.0,5,1079,1.0,811.0,811.0
0.014,6,10,1631,5,848,3.0,580.0,580.0,5,783,3.0,515.0,515.0
0.005,17,2,230,1,68,0.0,40.0,40.0,1,162,0.0,134.0,134.0
0.078,6,10,1506,5,395,17.0,127.0,127.0,5,1111,18.0,843.0,843.0
171.086,17,76,10766,38,2529,4623.0,44.0,38.0,38,8237,4623.0,239.0,188.0
0.005,6,10,1989,5,927,1.0,659.0,659.0,5,1062,1.0,794.0,794.0
0.012,6,10,1989,5,910,3.0,642.0,642.0,5,1079,3.0,811.0,811.0
0.212,6,16,2777,8,1395,30.0,533.0,323.0,8,1382,19.0,529.0,239.0
0.017,6,10,1762,5,911,4.0,643.0,643.0,5,851,4.0,583.0,583.0
0.082,6,10,1506,5,395,17.0,127.0,127.0,5,1111,18.0,843.0,843.0
0.008,6,10,1972,5,910,2.0,642.0,642.0,5,1062,1.0,794.0,794.0
0.005,6,10,2007,5,928,1.0,660.0,660.0,5,1079,1.0,811.0,811.0
0.013,6,10,1989,5,910,3.0,642.0,642.0,5,1079,3.0,811.0,811.0
0.006,6,10,1547,5,764,1.0,496.0,496.0,5,783,1.0,515.0,515.0
0.005,6,10,2006,5,927,1.0,659.0,659.0,5,1079,1.0,811.0,811.0
0.004,6,10,2006,5,927,1.0,659.0,659.0,5,1079,1.0,811.0,811.0
0.005,6,10,2006,5,927,1.0,659.0,659.0,5,1079,1.0,811.0,811.0
0.008,6,10,1983,5,910,2.0,642.0,642.0,5,1073,1.0,805.0,805.0
0.02,6,10,1972,5,910,4.0,642.0,642.0,5,1062,4.0,794.0,794.0
0.005,6,10,2006,5,927,1.0,659.0,659.0,5,1079,1.0,811.0,811.0
0.158,6,10,1506,5,395,36.0,127.0,127.0,5,1111,35.0,843.0,843.0
1771.974,6,105,6270,60,3525,30032.0,27.0,27.0,45,2745,40271.0,27.0,27.0
0.003,17,2,136,1,60,0.0,32.0,32.0,1,76,0.0,48.0,48.0
0.073,6,10,1506,5,395,16.0,127.0,127.0,5,1111,17.0,843.0,843.0
0.006,6,10,1547,5,764,1.0,496.0,496.0,5,783,1.0,515.0,515.0
175.148,17,88,12560,44,2955,4073.0,44.0,39.0,44,9605,4073.0,239.0,190.0
0.003,17,2,148,1,60,0.0,32.0,32.0,1,88,0.0,60.0,60.0
0.005,6,10,2006,5,927,1.0,659.0,659.0,5,1079,1.0,811.0,811.0
0.001,17,2,179,1,62,0.0,34.0,34.0,1,117,0.0,89.0,89.0
0.011,6,10,1631,5,848,2.0,580.0,580.0,5,783,2.0,515.0,515.0
0.011,6,10,1677,5,827,2.0,559.0,559.0,5,850,2.0,582.0,582.0
0.011,6,10,1631,5,848,2.0,580.0,580.0,5,783,2.0,515.0,515.0
0.021,6,10,1677,5,827,5.0,559.0,559.0,5,850,5.0,582.0,582.0
240.094,6,19,4975,9,2305,30011.0,1102.0,613.0,10,2670,26676.0,1162.0,428.0
0.009,6,10,1983,5,910,2.0,642.0,642.0,5,1073,2.0,805.0,805.0
0.012,6,10,1989,5,910,3.0,642.0,642.0,5,1079,2.0,811.0,811.0
0.016,6,10,1972,5,910,4.0,642.0,642.0,5,1062,4.0,794.0,794.0
240.096,6,16,4481,9,963,30012.0,238.0,166.0,7,3518,40015.0,1402.0,786.0
0.014,6,10,1990,5,911,3.0,643.0,643.0,5,1079,3.0,811.0,811.0
0.004,6,10,1945,5,981,1.0,713.0,713.0,5,964,1.0,696.0,696.0
0.071,6,45,14036,25,2555,2.0,517.0,139.0,20,11481,3.0,1402.0,745.0
0.005,6,13,3747,7,509,0.0,137.0,137.0,6,3238,1.0,1470.0,1459.0
0.005,6,10,2000,5,927,1.0,659.0,659.0,5,1073,1.0,805.0,805.0
0.005,6,10,2007,5,928,1.0,660.0,660.0,5,1079,1.0,811.0,811.0
0.012,6,10,1631,5,848,2.0,580.0,580.0,5,783,3.0,515.0,515.0
15.061,17,40,20230,22,17081,714.0,1350.0,748.0,18,3149,884.0,1350.0,146.0
40.051,17,10,676,5,460,10012.0,104.0,64.0,5,216,10011.0,20.0,15.0
0.005,17,2,164,1,74,0.0,46.0,46.0,1,90,0.0,62.0,62.0
0.001,17,2,166,1,75,0.0,47.0,47.0,1,91,0.0,63.0,63.0
308.314,17,20,1124,10,716,34243.0,48.0,43.0,10,408,34243.0,20.0,12.0
0.075,6,10,1506,5,395,15.0,127.0,127.0,5,1111,17.0,843.0,843.0
0.012,6,10,1762,5,911,3.0,643.0,643.0,5,851,2.0,583.0,583.0
0.04,17,2,148,1,60,0.0,32.0,32.0,1,88,0.0,60.0,60.0
0.017,6,10,1972,5,910,4.0,642.0,642.0,5,1062,4.0,794.0,794.0
0.165,17,2,152,1,76,0.0,48.0,48.0,1,76,0.0,48.0,48.0
0.039,17,2,136,1,60,0.0,32.0,32.0,1,76,0.0,48.0,48.0
0.005,6,13,3690,7,452,0.0,80.0,80.0,6,3238,1.0,1470.0,1459.0
0.013,6,10,1990,5,911,3.0,643.0,643.0,5,1079,3.0,811.0,811.0
0.005,6,10,1779,5,928,1.0,660.0,660.0,5,851,1.0,583.0,583.0
0.098,6,10,1506,5,395,22.0,127.0,127.0,5,1111,21.0,843.0,843.0
0.006,17,2,170,1,65,0.0,37.0,37.0,1,105,0.0,77.0,77.0
0.006,6,10,1854,5,889,1.0,621.0,621.0,5,965,1.0,697.0,697.0
0.003,17,2,148,1,60,0.0,32.0,32.0,1,88,0.0,60.0,60.0
0.008,6,12,1926,6,1189,1.0,659.0,434.0,6,737,1.0,417.0,417.0
0.01,6,10,1983,5,910,2.0,642.0,642.0,5,1073,2.0,805.0,805.0
0.013,6,10,1677,5,827,3.0,559.0,559.0,5,850,3.0,582.0,582.0
0.079,6,10,1506,5,395,18.0,127.0,127.0,5,1111,17.0,843.0,843.0
0.005,6,10,2006,5,927,1.0,659.0,659.0,5,1079,1.0,811.0,811.0
0.094,6,10,1506,5,395,21.0,127.0,127.0,5,1111,20.0,843.0,843.0
0.02,6,10,1989,5,910,5.0,642.0,642.0,5,1079,4.0,811.0,811.0
0.074,6,10,1506,5,395,15.0,127.0,127.0,5,1111,17.0,843.0,843.0
240.562,6,37,9658,19,2174,13364.0,746.0,235.0,18,7484,14149.0,1402.0,595.0
0.005,6,13,3747,7,509,0.0,137.0,137.0,6,3238,1.0,1470.0,1459.0
15.039,17,50,26167,27,22655,577.0,1350.0,811.0,23,3512,682.0,1350.0,124.0
0.01,6,13,3735,7,497,1.0,125.0,125.0,6,3238,2.0,1470.0,1459.0
294.17,6,321,343941,116,17587,2558.0,2736.0,889.0,205,326354,1442.0,2804.0,1644.0
0.001,17,2,179,1,62,0.0,34.0,34.0,1,117,0.0,89.0,89.0
0.15,6,10,1506,5,395,31.0,127.0,127.0,5,1111,29.0,843.0,843.0
1754.997,6,95,5991,46,2520,38999.0,37.0,32.0,49,3471,36561.0,280.0,115.0
0.004,17,2,144,1,64,0.0,36.0,36.0,1,80,0.0,52.0,52.0
0.008,6,14,3787,7,497,1.0,125.0,125.0,7,3290,1.0,1448.0,972.0
300.014,6,11,891,6,552,60002.0,232.0,232.0,5,339,75002.0,83.0,83.0
0.005,6,10,2006,5,927,1.0,659.0,659.0,5,1079,1.0,811.0,811.0
0.01,6,10,1983,5,910,2.0,642.0,642.0,5,1073,2.0,805.0,805.0
0.012,6,10,1989,5,910,2.0,642.0,642.0,5,1079,2.0,811.0,811.0
0.007,17,2,194,1,59,0.0,31.0,31.0,1,135,0.0,107.0,107.0
0.004,17,2,213,1,69,0.0,41.0,41.0,1,144,0.0,116.0,116.0
0.005,17,2,225,1,65,0.0,37.0,37.0,1,160,0.0,132.0,132.0
0.006,17,2,179,1,71,0.0,43.0,43.0,1,108,0.0,80.0,80.0
0.04,17,2,182,1,65,0.0,37.0,37.0,1,117,0.0,89.0,89.0
0.004,17,4,284,2,120,0.0,32.0,32.0,2,164,0.0,60.0,54.0
0.149,6,10,1506,5,395,27.0,127.0,127.0,5,1111,34.0,843.0,843.0
40.056,17,10,676,5,460,10013.0,104.0,64.0,5,216,10013.0,20.0,15.0
0.014,6,10,1972,5,910,3.0,642.0,642.0,5,1062,3.0,794.0,794.0
0.076,6,10,1506,5,395,17.0,127.0,127.0,5,1111,16.0,843.0,843.0
0.021,6,10,1990,5,911,5.0,643.0,643.0,5,1079,5.0,811.0,811.0
0.005,6,10,2007,5,928,1.0,660.0,660.0,5,1079,1.0,811.0,811.0
0.005,6,10,2000,5,927,1.0,659.0,659.0,5,1073,1.0,805.0,805.0
0.003,17,2,152,1,76,0.0,48.0,48.0,1,76,0.0,48.0,48.0
0.005,6,10,2000,5,927,1.0,659.0,659.0,5,1073,1.0,805.0,805.0
0.016,6,10,1677,5,827,3.0,559.0,559.0,5,850,3.0,582.0,582.0
0.004,6,10,1779,5,928,1.0,660.0,660.0,5,851,1.0,583.0,583.0
0.005,6,10,1643,5,860,1.0,592.0,592.0,5,783,1.0,515.0,515.0
354.029,6,21,1795,16,1030,23601.0,190.0,190.0,5,765,60002.0,464.0,248.0
0.015,6,10,1983,5,910,3.0,642.0,642.0,5,1073,3.0,805.0,805.0
0.104,6,10,1506,5,395,22.0,127.0,127.0,5,1111,20.0,843.0,843.0
0.003,17,2,136,1,60,0.0,32.0,32.0,1,76,0.0,48.0,48.0
0.005,6,10,2006,5,927,1.0,659.0,659.0,5,1079,1.0,811.0,811.0
0.06,17,2,80,1,32,0.0,4.0,4.0,1,48,0.0,20.0,20.0
0.013,6,19,9922,11,704,1.0,124.0,124.0,8,9218,1.0,2896.0,2198.0
40.056,17,10,676,5,460,10012.0,104.0,64.0,5,216,10013.0,20.0,15.0
0.005,6,14,3742,7,452,0.0,80.0,80.0,7,3290,0.0,1448.0,972.0
0.094,6,10,1506,5,395,21.0,127.0,127.0,5,1111,22.0,843.0,843.0
0.018,6,10,1677,5,827,4.0,559.0,559.0,5,850,4.0,582.0,582.0
0.015,6,10,1989,5,910,3.0,642.0,642.0,5,1079,3.0,811.0,811.0
0.012,6,10,1762,5,911,3.0,643.0,643.0,5,851,2.0,583.0,583.0
0.004,6,10,2000,5,927,1.0,659.0,659.0,5,1073,1.0,805.0,805.0
40.065,17,10,676,5,460,10015.0,104.0,64.0,5,216,10015.0,20.0,15.0
0.005,6,10,1774,5,923,1.0,655.0,655.0,5,851,1.0,583.0,583.0
0.011,6,10,1972,5,910,2.0,642.0,642.0,5,1062,2.0,794.0,794.0
0.005,17,2,169,1,62,0.0,34.0,34.0,1,107,0.0,79.0,79.0
351.986,6,20,2210,6,1308,12003.0,494.0,494.0,14,902,27075.0,83.0,83.0
0.077,6,10,1506,5,395,17.0,127.0,127.0,5,1111,17.0,843.0,843.0
0.098,6,10,1506,5,395,23.0,127.0,127.0,5,1111,21.0,843.0,843.0
0.006,6,10,1854,5,889,1.0,621.0,621.0,5,965,1.0,697.0,697.0
0.093,17,2,80,1,32,0.0,4.0,4.0,1,48,0.0,20.0,20.0
0.042,17,2,146,1,65,0.0,37.0,37.0,1,81,0.0,53.0,53.0
0.011,6,10,1677,5,827,2.0,559.0,559.0,5,850,2.0,582.0,582.0
317.027,17,18,1008,9,640,39613.0,48.0,43.0,9,368,39613.0,20.0,12.0
0.001,17,2,180,1,66,0.0,38.0,38.0,1,114,0.0,86.0,86.0
300.36,6,16,2170,9,684,37524.0,146.0,146.0,7,1486,50032.0,419.0,398.0
117.532,6,41,29642,19,23275,59.0,3124.0,2043.0,22,6367,5588.0,2720.0,912.0
0.005,6,10,1989,5,927,1.0,659.0,659.0,5,1062,1.0,794.0,794.0
0.006,17,2,164,1,74,0.0,46.0,46.0,1,90,0.0,62.0,62.0
0.1,6,10,1506,5,395,23.0,127.0,127.0,5,1111,23.0,843.0,843.0
0.213,6,16,2777,8,1395,30.0,533.0,323.0,8,1382,19.0,529.0,239.0
0.006,6,10,1547,5,764,1.0,496.0,496.0,5,783,1.0,515.0,515.0
0.007,6,10,1547,5,764,1.0,496.0,496.0,5,783,1.0,515.0,515.0
10.79,17,28,4419,14,1994,822.0,269.0,114.0,14,2425,821.0,588.0,145.0
0.005,6,10,1989,5,927,1.0,659.0,659.0,5,1062,1.0,794.0,794.0
0.004,6,10,1989,5,927,1.0,659.0,659.0,5,1062,1.0,794.0,794.0
368.934,6,22,2313,16,867,24595.0,195.0,195.0,6,1446,4671.0,419.0,398.0
0.003,17,2,136,1,60,0.0,32.0,32.0,1,76,0.0,48.0,48.0
0.008,6,10,1989,5,910,2.0,642.0,642.0,5,1079,2.0,811.0,811.0
0.013,6,10,1762,5,911,3.0,643.0,643.0,5,851,3.0,583.0,583.0
0.011,6,10,1989,5,910,2.0,642.0,642.0,5,1079,2.0,811.0,811.0
0.001,17,2,166,1,75,0.0,47.0,47.0,1,91,0.0,63.0,63.0
0.003,17,2,136,1,60,0.0,32.0,32.0,1,76,0.0,48.0,48.0
0.078,6,10,1506,5,395,18.0,127.0,127.0,5,1111,16.0,843.0,843.0
0.022,6,10,1989,5,910,5.0,642.0,642.0,5,1079,5.0,811.0,811.0
300.253,6,52,44185,27,7601,11548.0,2736.0,884.0,25,36584,12510.0,2804.0,1960.0
368.741,6,22,2313,16,867,24582.0,195.0,195.0,6,1446,4635.0,419.0,398.0
0.168,6,10,1506,5,395,26.0,127.0,127.0,5,1111,38.0,843.0,843.0
0.016,6,10,1983,5,910,4.0,642.0,642.0,5,1073,4.0,805.0,805.0
40.058,17,10,676,5,460,10013.0,104.0,64.0,5,216,10013.0,20.0,15.0
0.219,6,10,1506,5,395,32.0,127.0,127.0,5,1111,53.0,843.0,843.0
0.038,17,2,412,1,61,0.0,33.0,33.0,1,351,0.0,323.0,323.0
0.014,6,13,3735,7,497,2.0,125.0,125.0,6,3238,2.0,1470.0,1459.0
0.005,6,10,2000,5,927,1.0,659.0,659.0,5,1073,1.0,805.0,805.0
15.075,17,15,9238,8,6902,2149.0,1350.0,834.0,7,2336,2507.0,1350.0,305.0
0.009,6,10,1989,5,910,2.0,642.0,642.0,5,1079,2.0,811.0,811.0
0.014,6,10,1989,5,910,3.0,642.0,642.0,5,1079,3.0,811.0,811.0
0.015,6,10,1972,5,910,3.0,642.0,642.0,5,1062,3.0,794.0,794.0
0.02,6,10,1605,5,388,4.0,120.0,120.0,5,1217,4.0,949.0,949.0
0.009,6,12,1926,6,1189,1.0,659.0,434.0,6,737,1.0,417.0,417.0
40.097,17,10,676,5,460,10022.0,104.0,64.0,5,216,10023.0,20.0,15.0
0.02,6,10,1989,5,910,5.0,642.0,642.0,5,1079,5.0,811.0,811.0
0.006,6,10,1643,5,860,1.0,592.0,592.0,5,783,1.0,515.0,515.0
0.103,6,10,1506,5,395,23.0,127.0,127.0,5,1111,23.0,843.0,843.0
0.004,6,10,2007,5,928,1.0,660.0,660.0,5,1079,1.0,811.0,811.0
0.066,6,10,1506,5,395,14.0,127.0,127.0,5,1111,14.0,843.0,843.0
0.012,6,10,1989,5,910,3.0,642.0,642.0,5,1079,3.0,811.0,811.0
240.417,6,36,10192,18,1887,14140.0,559.0,188.0,18,8305,14140.0,1402.0,614.0
0.008,17,2,148,1,60,0.0,32.0,32.0,1,88,0.0,60.0,60.0
0.004,17,2,148,1,60,0.0,32.0,32.0,1,88,0.0,60.0,60.0
240.477,6,28,4644,15,1980,17174.0,555.0,238.0,13,2664,20036.0,1618.0,284.0
0.01,6,10,1989,5,910,2.0,642.0,642.0,5,1079,2.0,811.0,811.0
0.005,17,2,230,1,68,0.0,40.0,40.0,1,162,0.0,134.0,134.0
0.006,6,10,1547,5,764,1.0,496.0,496.0,5,783,1.0,515.0,515.0
0.005,6,10,2006,5,927,1.0,659.0,659.0,5,1079,1.0,811.0,811.0
0.005,6,10,2007,5,928,1.0,660.0,660.0,5,1079,1.0,811.0,811.0
0.084,6,10,1506,5,395,18.0,127.0,127.0,5,1111,18.0,843.0,843.0
0.013,6,10,1989,5,910,3.0,642.0,642.0,5,1079,3.0,811.0,811.0
0.005,6,10,2006,5,927,1.0,659.0,659.0,5,1079,1.0,811.0,811.0
0.134,6,10,1506,5,395,31.0,127.0,127.0,5,1111,24.0,843.0,843.0
0.004,6,10,2007,5,928,1.0,660.0,660.0,5,1079,1.0,811.0,811.0
0.012,6,10,1990,5,911,3.0,643.0,643.0,5,1079,2.0,811.0,811.0
0.005,6,10,2006,5,927,1.0,659.0,659.0,5,1079,1.0,811.0,811.0
0.006,6,10,1547,5,764,1.0,496.0,496.0,5,783,1.0,515.0,515.0
0.006,6,10,2006,5,927,1.0,659.0,659.0,5,1079,1.0,811.0,811.0
0.004,6,10,2000,5,927,1.0,659.0,659.0,5,1073,1.0,805.0,805.0
0.036,17,2,144,1,64,0.0,36.0,36.0,1,80,0.0,52.0,52.0
291.599,6,412,348728,195,21693,1503.0,2736.0,888.0,217,327035,1349.0,2804.0,1555.0
0.001,17,2,166,1,75,0.0,47.0,47.0,1,91,0.0,63.0,63.0
0.073,17,4,580,2,122,0.0,33.0,33.0,2,458,35.0,307.0,201.0
0.016,6,10,1990,5,911,4.0,643.0,643.0,5,1079,3.0,811.0,811.0
0.007,6,10,1989,5,910,1.0,642.0,642.0,5,1079,1.0,811.0,811.0
0.006,6,10,1547,5,764,1.0,496.0,496.0,5,783,1.0,515.0,515.0
0.005,6,10,2000,5,927,1.0,659.0,659.0,5,1073,1.0,805.0,805.0
0.004,6,10,2007,5,928,1.0,660.0,660.0,5,1079,1.0,811.0,811.0
1730.358,6,45,2790,30,1725,59667.0,35.0,35.0,15,1065,123591.0,31.0,31.0
0.001,17,2,174,1,72,0.0,44.0,44.0,1,102,0.0,74.0,74.0
0.005,6,10,1689,5,839,1.0,571.0,571.0,5,850,1.0,582.0,582.0
0.003,17,4,284,2,120,0.0,32.0,32.0,2,164,0.0,60.0,54.0
0.004,17,2,148,1,60,0.0,32.0,32.0,1,88,0.0,60.0,60.0
240.013,6,9,787,5,488,60003.0,232.0,232.0,4,299,80003.0,83.0,83.0
0.006,6,10,1689,5,839,1.0,571.0,571.0,5,850,1.0,582.0,582.0
0.005,6,10,2000,5,927,1.0,659.0,659.0,5,1073,1.0,805.0,805.0
178.668,17,84,11602,42,2792,4357.0,44.0,38.0,42,8810,4357.0,252.0,181.0
0.099,6,10,1506,5,395,22.0,127.0,127.0,5,1111,23.0,843.0,843.0
240.017,6,9,787,5,488,60004.0,232.0,232.0,4,299,80004.0,83.0,83.0
0.004,6,10,1989,5,927,1.0,659.0,659.0,5,1062,1.0,794.0,794.0
0.006,6,10,1547,5,764,1.0,496.0,496.0,5,783,1.0,515.0,515.0
0.045,17,2,184,1,61,0.0,33.0,33.0,1,123,0.0,95.0,95.0
0.007,6,10,1990,5,911,1.0,643.0,643.0,5,1079,1.0,811.0,811.0
0.013,6,10,1989,5,910,3.0,642.0,642.0,5,1079,3.0,811.0,811.0
0.009,6,10,1989,5,910,2.0,642.0,642.0,5,1079,2.0,811.0,811.0
0.078,17,8,3613,4,1874,26.0,1350.0,440.0,4,1739,10.0,1350.0,406.0
240.041,6,22,3474,12,1820,21821.0,599.0,171.0,10,1654,26671.0,580.0,225.0
0.032,17,2,136,1,60,0.0,32.0,32.0,1,76,0.0,48.0,48.0
15.072,17,15,9239,8,6902,2149.0,1350.0,834.0,7,2337,2507.0,1350.0,305.0
0.005,6,10,1643,5,860,1.0,592.0,592.0,5,783,1.0,515.0,515.0
11.165,17,28,4418,14,1994,846.0,269.0,114.0,14,2424,846.0,587.0,145.0
0.012,6,10,1990,5,911,3.0,643.0,643.0,5,1079,2.0,811.0,811.0
0.015,6,10,1989,5,910,3.0,642.0,642.0,5,1079,3.0,811.0,811.0
40.068,17,10,676,5,460,10014.0,104.0,64.0,5,216,10016.0,20.0,15.0
0.08,6,10,1506,5,395,16.0,127.0,127.0,5,1111,17.0,843.0,843.0
42.257,6,46,16400,23,10453,409.0,2720.0,1187.0,23,5947,1913.0,2667.0,385.0
0.009,6,12,1926,6,1189,1.0,659.0,434.0,6,737,1.0,417.0,417.0
0.069,17,2,80,1,32,0.0,4.0,4.0,1,48,0.0,20.0,20.0
0.022,6,10,1983,5,910,5.0,642.0,642.0,5,1073,5.0,805.0,805.0
0.004,6,10,1989,5,927,1.0,659.0,659.0,5,1062,1.0,794.0,794.0
0.107,6,10,1506,5,395,23.0,127.0,127.0,5,1111,23.0,843.0,843.0
0.102,6,10,1506,5,395,21.0,127.0,127.0,5,1111,24.0,843.0,843.0
0.006,6,10,1547,5,764,1.0,496.0,496.0,5,783,1.0,515.0,515.0
0.004,6,10,1989,5,927,1.0,659.0,659.0,5,1062,1.0,794.0,794.0
0.009,6,10,1631,5,848,2.0,580.0,580.0,5,783,2.0,515.0,515.0
0.005,6,10,1774,5,923,1.0,655.0,655.0,5,851,1.0,583.0,583.0
0.013,6,13,3735,7,497,2.0,125.0,125.0,6,3238,2.0,1470.0,1459.0
0.005,6,10,1989,5,927,1.0,659.0,659.0,5,1062,1.0,794.0,794.0
40.057,17,10,676,5,460,10013.0,104.0,64.0,5,216,10013.0,20.0,15.0
0.01,6,10,1972,5,910,2.0,642.0,642.0,5,1062,2.0,794.0,794.0
0.004,6,10,2007,5,928,1.0,660.0,660.0,5,1079,1.0,811.0,811.0
0.007,6,10,1547,5,764,1.0,496.0,496.0,5,783,1.0,515.0,515.0
0.041,17,4,352,2,130,0.0,37.0,37.0,2,222,3.0,89.0,83.0
0.302,17,38,20118,22,17095,14.0,1350.0,749.0,16,3023,14.0,1350.0,160.0
0.169,17,2,152,1,76,0.0,48.0,48.0,1,76,0.0,48.0,48.0
0.005,17,2,164,1,74,0.0,46.0,46.0,1,90,0.0,62.0,62.0
177.273,17,76,10804,38,2538,4791.0,44.0,38.0,38,8266,4790.0,239.0,189.0
0.006,17,2,304,1,77,0.0,49.0,49.0,1,227,0.0,199.0,199.0
0.01,6,10,1990,5,911,2.0,643.0,643.0,5,1079,2.0,811.0,811.0
0.004,6,10,1702,5,863,1.0,595.0,595.0,5,839,1.0,571.0,571.0
0.005,6,10,1774,5,923,1.0,655.0,655.0,5,851,1.0,583.0,583.0
0.009,6,10,1990,5,911,2.0,643.0,643.0,5,1079,2.0,811.0,811.0
0.005,6,10,1643,5,860,1.0,592.0,592.0,5,783,1.0,515.0,515.0
0.016,6,10,1631,5,848,3.0,580.0,580.0,5,783,4.0,515.0,515.0
40.065,17,10,676,5,460,10014.0,104.0,64.0,5,216,10015.0,20.0,15.0
0.068,17,8,3613,4,1874,22.0,1350.0,440.0,4,1739,11.0,1350.0,406.0
300.356,6,16,2170,9,684,37523.0,146.0,146.0,7,1486,50032.0,419.0,398.0
0.005,6,10,1702,5,863,1.0,595.0,595.0,5,839,1.0,571.0,571.0
0.005,6,10,1989,5,927,1.0,659.0,659.0,5,1062,1.0,794.0,794.0
0.012,6,10,1983,5,910,3.0,642.0,642.0,5,1073,3.0,805.0,805.0
10.815,17,28,4423,14,1995,823.0,270.0,114.0,14,2428,823.0,587.0,145.0
40.056,17,10,676,5,460,10013.0,104.0,64.0,5,216,10013.0,20.0,15.0
0.005,6,13,3747,7,509,0.0,137.0,137.0,6,3238,0.0,1470.0,1459.0
40.063,17,10,676,5,460,10014.0,104.0,64.0,5,216,10015.0,20.0,15.0
0.119,6,10,1506,5,395,28.0,127.0,127.0,5,1111,26.0,843.0,843.0
0.001,17,2,180,1,66,0.0,38.0,38.0,1,114,0.0,86.0,86.0
0.156,6,10,1506,5,395,34.0,127.0,127.0,5,1111,36.0,843.0,843.0
319.972,17,20,1124,10,716,35538.0,48.0,43.0,10,408,35537.0,20.0,12.0
178.213,17,70,10036,35,2337,5241.0,44.0,38.0,35,7699,5241.0,261.0,191.0
240.095,6,30,9279,15,6824,17149.0,1948.0,672.0,15,2455,17149.0,580.0,238.0
0.006,6,10,1643,5,860,1.0,592.0,592.0,5,783,1.0,515.0,515.0
1773.708,6,86,5319,43,2286,42229.0,50.0,50.0,43,3033,42230.0,440.0,398.0
0.013,6,10,1989,5,910,3.0,642.0,642.0,5,1079,3.0,811.0,811.0
0.067,6,10,1506,5,395,14.0,127.0,127.0,5,1111,15.0,843.0,843.0
0.005,6,10,2006,5,927,1.0,659.0,659.0,5,1079,1.0,811.0,811.0
0.084,6,10,1506,5,395,19.0,127.0,127.0,5,1111,20.0,843.0,843.0
0.005,6,10,1547,5,764,1.0,496.0,496.0,5,783,1.0,515.0,515.0
0.014,6,10,1989,5,910,3.0,642.0,642.0,5,1079,3.0,811.0,811.0
240.089,6,16,4480,9,963,30011.0,238.0,166.0,7,3517,40014.0,1402.0,786.0
0.016,17,2,198,1,91,0.0,63.0,63.0,1,107,0.0,79.0,79.0
1777.339,17,144,45504,72,22752,25032.0,288.0,288.0,72,22752,25032.0,288.0,288.0
0.061,6,10,1506,5,395,13.0,127.0,127.0,5,1111,14.0,843.0,843.0
0.008,6,10,1989,5,910,2.0,642.0,642.0,5,1079,2.0,811.0,811.0
0.001,17,2,180,1,66,0.0,38.0,38.0,1,114,0.0,86.0,86.0
0.109,6,10,1506,5,395,24.0,127.0,127.0,5,1111,22.0,843.0,843.0
0.013,6,10,1983,5,910,3.0,642.0,642.0,5,1073,3.0,805.0,805.0
0.01,6,10,1972,5,910,2.0,642.0,642.0,5,1062,2.0,794.0,794.0
0.089,6,10,1506,5,395,21.0,127.0,127.0,5,1111,20.0,843.0,843.0
300.974,6,49,20723,26,14776,12038.0,2967.0,1370.0,23,5947,400.0,2667.0,385.0
0.005,6,10,2006,5,927,1.0,659.0,659.0,5,1079,1.0,811.0,811.0
0.007,6,10,1689,5,839,1.0,571.0,571.0,5,850,1.0,582.0,582.0
1799.711,17,122,11651,61,5551,29994.0,63.0,63.0,61,6100,29994.0,72.0,72.0
0.008,6,12,1926,6,1189,1.0,659.0,434.0,6,737,1.0,417.0,417.0
0.113,6,10,1506,5,395,22.0,127.0,127.0,5,1111,23.0,843.0,843.0
240.046,6,9,787,5,488,60011.0,232.0,232.0,4,299,80011.0,83.0,83.0
0.093,6,10,1506,5,395,22.0,127.0,127.0,5,1111,18.0,843.0,843.0
0.005,6,10,2006,5,927,1.0,659.0,659.0,5,1079,1.0,811.0,811.0
0.014,6,10,1990,5,911,3.0,643.0,643.0,5,1079,3.0,811.0,811.0
0.006,6,10,1547,5,764,1.0,496.0,496.0,5,783,1.0,515.0,515.0
0.006,6,10,1779,5,928,1.0,660.0,660.0,5,851,1.0,583.0,583.0
0.117,6,10,1506,5,395,23.0,127.0,127.0,5,1111,26.0,843.0,843.0
0.008,6,10,1989,5,910,2.0,642.0,642.0,5,1079,1.0,811.0,811.0
0.01,6,10,1989,5,910,2.0,642.0,642.0,5,1079,2.0,811.0,811.0
0.083,6,10,1506,5,395,16.0,127.0,127.0,5,1111,17.0,843.0,843.0
0.013,6,10,1989,5,910,3.0,642.0,642.0,5,1079,3.0,811.0,811.0
0.005,17,2,169,1,62,0.0,34.0,34.0,1,107,0.0,79.0,79.0
0.068,6,8,3114,4,2314,22.0,1124.0,1053.0,4,800,21.0,296.0,296.0
165.158,17,68,9766,34,2271,5004.0,44.0,38.0,34,7495,5004.0,239.0,192.0
0.152,6,10,1506,5,395,33.0,127.0,127.0,5,1111,34.0,843.0,843.0
0.007,6,12,1698,6,863,1.0,327.0,271.0,6,835,1.0,515.0,515.0
0.005,6,10,1779,5,928,1.0,660.0,660.0,5,851,1.0,583.0,583.0
0.017,6,10,1989,5,910,4.0,642.0,642.0,5,1079,4.0,811.0,811.0
0.009,6,10,1677,5,827,2.0,559.0,559.0,5,850,2.0,582.0,582.0
0.008,6,10,1990,5,911,2.0,643.0,643.0,5,1079,1.0,811.0,811.0
0.007,6,10,1762,5,911,1.0,643.0,643.0,5,851,1.0,583.0,583.0
0.004,17,2,148,1,60,0.0,32.0,32.0,1,88,0.0,60.0,60.0
0.025,6,10,1631,5,848,6.0,580.0,580.0,5,783,6.0,515.0,515.0
176.079,17,74,10497,37,2465,4890.0,44.0,38.0,37,8032,4891.0,260.0,189.0
0.006,6,10,1547,5,764,1.0,496.0,496.0,5,783,1.0,515.0,515.0
0.007,6,10,1547,5,764,1.0,496.0,496.0,5,783,1.0,515.0,515.0
40.066,17,10,676,5,460,10015.0,104.0,64.0,5,216,10015.0,20.0,15.0
0.004,17,2,136,1,60,0.0,32.0,32.0,1,76,0.0,48.0,48.0
0.018,6,10,1989,5,910,4.0,642.0,642.0,5,1079,4.0,811.0,811.0
40.083,17,10,676,5,460,10018.0,104.0,64.0,5,216,10019.0,20.0,15.0
0.005,6,10,2000,5,927,1.0,659.0,659.0,5,1073,1.0,805.0,805.0
11.173,17,28,4422,14,1995,847.0,270.0,114.0,14,2427,846.0,586.0,145.0
0.011,6,10,1972,5,910,2.0,642.0,642.0,5,1062,2.0,794.0,794.0
0.102,6,10,1506,5,395,23.0,127.0,127.0,5,1111,17.0,843.0,843.0
0.004,6,10,2006,5,927,1.0,659.0,659.0,5,1079,1.0,811.0,811.0
0.009,6,12,1926,6,1189,1.0,659.0,434.0,6,737,1.0,417.0,417.0
40.059,17,10,676,5,460,10014.0,104.0,64.0,5,216,10014.0,20.0,15.0
240.095,6,19,5025,9,2305,30011.0,1102.0,613.0,10,2720,26676.0,1162.0,438.0
0.099,6,10,1506,5,395,21.0,127.0,127.0,5,1111,20.0,843.0,843.0
1786.357,6,154,19574,92,13852,19630.0,302.0,302.0,62,5722,29284.0,83.0,83.0
0.001,17,2,178,1,81,0.0,53.0,53.0,1,97,0.0,69.0,69.0
300.786,6,37,9626,20,4148,15830.0,1572.0,663.0,17,5478,537.0,2667.0,435.0
0.005,6,10,2006,5,927,1.0,659.0,659.0,5,1079,1.0,811.0,811.0
0.011,6,10,1972,5,910,2.0,642.0,642.0,5,1062,2.0,794.0,794.0
0.072,17,2,182,1,65,0.0,37.0,37.0,1,117,0.0,89.0,89.0
0.141,6,10,1506,5,395,33.0,127.0,127.0,5,1111,30.0,843.0,843.0
0.005,6,10,1854,5,889,1.0,621.0,621.0,5,965,1.0,697.0,697.0
0.019,6,10,1972,5,910,4.0,642.0,642.0,5,1062,4.0,794.0,794.0
0.005,6,10,1854,5,889,1.0,621.0,621.0,5,965,1.0,697.0,697.0
0.008,6,10,2000,5,927,2.0,659.0,659.0,5,1073,2.0,805.0,805.0
0.114,6,10,1506,5,395,23.0,127.0,127.0,5,1111,23.0,843.0,843.0
0.004,6,10,2007,5,928,1.0,660.0,660.0,5,1079,1.0,811.0,811.0
10.807,17,28,4422,14,1993,822.0,268.0,114.0,14,2429,822.0,588.0,145.0
0.005,6,15,3794,8,504,0.0,80.0,80.0,7,3290,0.0,1448.0,972.0
0.004,17,2,136,1,60,0.0,32.0,32.0,1,76,0.0,48.0,48.0
0.007,6,10,1989,5,910,1.0,642.0,642.0,5,1079,1.0,811.0,811.0
0.005,6,10,2006,5,927,1.0,659.0,659.0,5,1079,1.0,811.0,811.0
0.088,17,4,596,2,122,51.0,33.0,33.0,2,474,48.0,323.0,209.0
0.008,6,12,1926,6,1189,1.0,659.0,434.0,6,737,1.0,417.0,417.0
0.004,6,10,1989,5,927,1.0,659.0,659.0,5,1062,1.0,794.0,794.0
0.129,6,10,1506,5,395,29.0,127.0,127.0,5,1111,26.0,843.0,843.0
0.144,17,2,144,1,64,0.0,36.0,36.0,1,80,0.0,52.0,52.0
0.01,6,10,1990,5,911,2.0,643.0,643.0,5,1079,2.0,811.0,811.0
0.005,6,10,1547,5,764,1.0,496.0,496.0,5,783,1.0,515.0,515.0
0.091,6,10,1506,5,395,21.0,127.0,127.0,5,1111,19.0,843.0,843.0
0.005,17,2,178,1,65,0.0,37.0,37.0,1,113,0.0,85.0,85.0
10.924,17,28,4423,14,1994,832.0,269.0,114.0,14,2429,832.0,588.0,145.0
0.081,6,10,1506,5,395,19.0,127.0,127.0,5,1111,17.0,843.0,843.0
0.032,6,10,1990,5,911,7.0,643.0,643.0,5,1079,8.0,811.0,811.0
0.005,6,10,1854,5,889,1.0,621.0,621.0,5,965,1.0,697.0,697.0
0.108,6,10,1506,5,395,26.0,127.0,127.0,5,1111,23.0,843.0,843.0
0.013,6,10,1990,5,911,3.0,643.0,643.0,5,1079,3.0,811.0,811.0
68.623,6,28,12890,15,3855,4901.0,1002.0,511.0,13,9035,5704.0,2355.0,1043.0
0.011,6,10,1990,5,911,2.0,643.0,643.0,5,1079,2.0,811.0,811.0
0.009,6,13,3735,7,497,1.0,125.0,125.0,6,3238,1.0,1470.0,1459.0
300.409,6,16,2170,9,684,37529.0,146.0,146.0,7,1486,50039.0,419.0,398.0
0.006,6,10,1689,5,839,1.0,571.0,571.0,5,850,1.0,582.0,582.0
0.003,17,2,148,1,60,0.0,32.0,32.0,1,88,0.0,60.0,60.0
0.169,17,2,152,1,76,0.0,48.0,48.0,1,76,0.0,48.0,48.0
118.961,6,21,8148,11,1985,80.0,1174.0,504.0,10,6163,13199.0,2720.0,958.0
1799.995,6,137,6590,76,3625,23996.0,39.0,39.0,61,2965,29995.0,35.0,35.0
292.065,6,410,349837,206,23590,1424.0,2736.0,919.0,204,326247,1438.0,2999.0,1678.0
0.005,17,2,140,1,62,0.0,34.0,34.0,1,78,0.0,50.0,50.0
0.005,17,2,140,1,62,0.0,34.0,34.0,1,78,0.0,50.0,50.0
40.059,17,10,676,5,460,10014.0,104.0,64.0,5,216,10014.0,20.0,15.0
0.036,6,13,3913,7,495,5.0,123.0,123.0,6,3418,7.0,1650.0,1549.0
300.838,6,37,9979,20,4501,15833.0,1925.0,733.0,17,5478,542.0,2667.0,435.0
0.006,6,10,1689,5,839,1.0,571.0,571.0,5,850,1.0,582.0,582.0
0.005,6,10,2007,5,928,1.0,660.0,660.0,5,1079,1.0,811.0,811.0
0.006,6,10,1547,5,764,1.0,496.0,496.0,5,783,1.0,515.0,515.0
240.141,6,16,4481,9,963,30017.0,238.0,166.0,7,3518,40022.0,1402.0,786.0
0.008,6,10,1989,5,910,2.0,642.0,642.0,5,1079,2.0,811.0,811.0
0.006,17,2,166,1,75,0.0,47.0,47.0,1,91,0.0,63.0,63.0
0.113,6,10,1506,5,395,25.0,127.0,127.0,5,1111,24.0,843.0,843.0
0.038,17,4,284,2,120,0.0,32.0,32.0,2,164,34.0,60.0,54.0
0.008,6,10,1972,5,910,2.0,642.0,642.0,5,1062,1.0,794.0,794.0
0.005,6,14,3799,7,509,0.0,137.0,137.0,7,3290,0.0,1448.0,972.0
0.008,6,13,3690,7,452,1.0,80.0,80.0,6,3238,1.0,1470.0,1459.0
0.003,17,2,148,1,60,0.0,32.0,32.0,1,88,0.0,60.0,60.0
0.004,17,2,136,1,60,0.0,32.0,32.0,1,76,0.0,48.0,48.0
0.005,6,10,2000,5,927,1.0,659.0,659.0,5,1073,1.0,805.0,805.0
0.008,6,10,1983,5,910,2.0,642.0,642.0,5,1073,1.0,805.0,805.0
0.105,6,10,1506,5,395,24.0,127.0,127.0,5,1111,23.0,843.0,843.0
0.013,17,2,152,1,56,0.0,28.0,28.0,1,96,0.0,68.0,68.0
0.009,6,10,1972,5,910,2.0,642.0,642.0,5,1062,2.0,794.0,794.0
300.341,6,16,2170,9,684,37521.0,146.0,146.0,7,1486,50028.0,419.0,398.0
0.007,6,10,1643,5,860,1.0,592.0,592.0,5,783,1.0,515.0,515.0
0.009,6,10,1972,5,910,2.0,642.0,642.0,5,1062,2.0,794.0,794.0
0.096,6,10,1506,5,395,21.0,127.0,127.0,5,1111,16.0,843.0,843.0
0.013,6,10,1989,5,910,3.0,642.0,642.0,5,1079,3.0,811.0,811.0
0.153,6,10,1506,5,395,36.0,127.0,127.0,5,1111,33.0,843.0,843.0
0.005,6,10,2007,5,928,1.0,660.0,660.0,5,1079,1.0,811.0,811.0
0.003,17,2,148,1,60,0.0,32.0,32.0,1,88,0.0,60.0,60.0
0.003,17,2,148,1,60,0.0,32.0,32.0,1,88,0.0,60.0,60.0
40.062,17,10,676,5,460,10013.0,104.0,64.0,5,216,10014.0,20.0,15.0
0.006,6,10,1854,5,889,1.0,621.0,621.0,5,965,1.0,697.0,697.0
0.118,6,10,1506,5,395,24.0,127.0,127.0,5,1111,25.0,843.0,843.0
0.177,6,11,2944,6,497,35.0,177.0,177.0,5,2447,43.0,1402.0,1089.0
15.077,17,15,9238,8,6902,2149.0,1350.0,834.0,7,2336,2507.0,1350.0,305.0
0.005,6,10,1989,5,927,1.0,659.0,659.0,5,1062,1.0,794.0,794.0
0.004,17,4,284,2,120,0.0,32.0,32.0,2,164,1.0,60.0,54.0
0.021,6,10,1972,5,910,5.0,642.0,642.0,5,1062,5.0,794.0,794.0
0.005,6,10,1689,5,839,1.0,571.0,571.0,5,850,1.0,582.0,582.0
1799.997,17,3166,242349,1575,127606,1143.0,84.0,53.0,1591,114743,1131.0,227.0,44.0
0.005,6,10,1774,5,923,1.0,655.0,655.0,5,851,1.0,583.0,583.0
0.008,6,10,1990,5,911,2.0,643.0,643.0,5,1079,1.0,811.0,811.0
0.008,6,10,1983,5,910,1.0,642.0,642.0,5,1073,2.0,805.0,805.0
0.008,6,13,3735,7,497,1.0,125.0,125.0,6,3238,1.0,1470.0,1459.0
300.765,6,38,9925,21,4447,15038.0,1360.0,595.0,17,5478,536.0,2667.0,435.0
0.01,6,10,1989,5,910,2.0,642.0,642.0,5,1079,2.0,811.0,811.0
0.009,6,14,3787,7,497,1.0,125.0,125.0,7,3290,1.0,1448.0,972.0
0.042,17,4,284,2,120,0.0,32.0,32.0,2,164,38.0,60.0,54.0
0.121,6,10,1506,5,395,27.0,127.0,127.0,5,1111,28.0,843.0,843.0
0.014,6,10,1631,5,848,3.0,580.0,580.0,5,783,3.0,515.0,515.0
0.001,17,2,180,1,66,0.0,38.0,38.0,1,114,0.0,86.0,86.0
0.06,6,10,1506,5,395,14.0,127.0,127.0,5,1111,13.0,843.0,843.0
0.005,6,10,1989,5,927,1.0,659.0,659.0,5,1062,1.0,794.0,794.0
0.17,6,3,453,2,321,170.0,241.0,241.0,1,132,0.0,92.0,92.0
308.418,17,20,1124,10,716,34250.0,48.0,43.0,10,408,34248.0,20.0,12.0
0.005,6,10,2000,5,927,1.0,659.0,659.0,5,1073,1.0,805.0,805.0
0.039,17,2,186,1,61,0.0,33.0,33.0,1,125,0.0,97.0,97.0
0.003,17,2,136,1,60,0.0,32.0,32.0,1,76,0.0,48.0,48.0
0.005,6,10,1689,5,839,1.0,571.0,571.0,5,850,1.0,582.0,582.0
0.102,6,10,1989,5,910,25.0,642.0,642.0,5,1079,25.0,811.0,811.0
0.013,6,10,1762,5,911,3.0,643.0,643.0,5,851,3.0,583.0,583.0
0.098,6,10,1506,5,395,22.0,127.0,127.0,5,1111,16.0,843.0,843.0
0.005,6,10,2000,5,927,1.0,659.0,659.0,5,1073,1.0,805.0,805.0
0.004,6,10,2000,5,927,1.0,659.0,659.0,5,1073,1.0,805.0,805.0
0.004,6,10,1989,5,927,1.0,659.0,659.0,5,1062,1.0,794.0,794.0
0.009,6,10,1989,5,910,2.0,642.0,642.0,5,1079,2.0,811.0,811.0
0.005,17,2,166,1,75,0.0,47.0,47.0,1,91,0.0,63.0,63.0
0.004,6,10,1779,5,928,1.0,660.0,660.0,5,851,1.0,583.0,583.0
0.013,6,10,1983,5,910,3.0,642.0,642.0,5,1073,3.0,805.0,805.0
0.005,17,2,144,1,64,0.0,36.0,36.0,1,80,0.0,52.0,52.0
0.005,17,2,169,1,62,0.0,34.0,34.0,1,107,0.0,79.0,79.0
0.111,6,10,1506,5,395,24.0,127.0,127.0,5,1111,23.0,843.0,843.0
0.012,6,10,1989,5,910,2.0,642.0,642.0,5,1079,3.0,811.0,811.0
0.062,6,10,1506,5,395,14.0,127.0,127.0,5,1111,14.0,843.0,843.0
0.005,6,10,1989,5,927,1.0,659.0,659.0,5,1062,1.0,794.0,794.0
0.082,6,10,1506,5,395,16.0,127.0,127.0,5,1111,18.0,843.0,843.0
15.082,17,15,7929,8,5905,2150.0,1350.0,710.0,7,2024,2508.0,1350.0,261.0
0.008,6,12,1926,6,1189,1.0,659.0,434.0,6,737,1.0,417.0,417.0
0.001,17,2,180,1,66,0.0,38.0,38.0,1,114,0.0,86.0,86.0
0.005,6,10,1989,5,927,1.0,659.0,659.0,5,1062,1.0,794.0,794.0
0.068,17,8,3613,4,1874,22.0,1350.0,440.0,4,1739,11.0,1350.0,406.0
0.039,17,4,284,2,120,0.0,32.0,32.0,2,164,35.0,60.0,54.0
0.039,17,2,148,1,60,0.0,32.0,32.0,1,88,0.0,60.0,60.0
0.093,6,10,1506,5,395,20.0,127.0,127.0,5,1111,19.0,843.0,843.0
0.221,17,4,596,2,122,146.0,33.0,33.0,2,474,181.0,323.0,209.0
0.006,17,2,179,1,71,0.0,43.0,43.0,1,108,0.0,80.0,80.0
0.167,17,2,152,1,76,0.0,48.0,48.0,1,76,0.0,48.0,48.0
0.004,6,10,1989,5,927,1.0,659.0,659.0,5,1062,1.0,794.0,794.0
0.005,6,10,2000,5,927,1.0,659.0,659.0,5,1073,1.0,805.0,805.0
1756.124,6,105,6258,60,3519,29764.0,27.0,26.0,45,2739,39910.0,27.0,26.0
0.072,17,8,3613,4,1874,24.0,1350.0,440.0,4,1739,12.0,1350.0,406.0
0.091,6,10,1506,5,395,19.0,127.0,127.0,5,1111,21.0,843.0,843.0
300.038,6,12,1782,7,1348,50006.0,494.0,494.0,5,434,75008.0,83.0,83.0
0.007,6,10,1972,5,910,1.0,642.0,642.0,5,1062,1.0,794.0,794.0
0.004,17,4,284,2,120,0.0,32.0,32.0,2,164,0.0,60.0,54.0
0.005,6,10,2000,5,927,1.0,659.0,659.0,5,1073,1.0,805.0,805.0
0.005,6,10,1689,5,839,1.0,571.0,571.0,5,850,1.0,582.0,582.0
65.996,6,27,17540,15,9603,4714.0,2804.0,1469.0,12,7937,5984.0,2308.0,1217.0
0.019,6,10,1990,5,911,4.0,643.0,643.0,5,1079,4.0,811.0,811.0
0.072,6,10,1506,5,395,16.0,127.0,127.0,5,1111,17.0,843.0,843.0
0.099,6,10,1506,5,395,19.0,127.0,127.0,5,1111,20.0,843.0,843.0
0.005,6,10,1989,5,927,1.0,659.0,659.0,5,1062,1.0,794.0,794.0
0.004,17,2,148,1,60,0.0,32.0,32.0,1,88,0.0,60.0,60.0
0.004,6,10,2006,5,927,1.0,659.0,659.0,5,1079,1.0,811.0,811.0
40.061,17,10,676,5,460,10014.0,104.0,64.0,5,216,10013.0,20.0,15.0
40.052,17,10,676,5,460,10010.0,104.0,64.0,5,216,10012.0,20.0,15.0
0.004,17,2,148,1,60,0.0,32.0,32.0,1,88,0.0,60.0,60.0
0.005,6,10,2006,5,927,1.0,659.0,659.0,5,1079,1.0,811.0,811.0
0.006,6,10,1702,5,863,1.0,595.0,595.0,5,839,1.0,571.0,571.0
0.016,6,10,1990,5,911,4.0,643.0,643.0,5,1079,3.0,811.0,811.0
0.011,6,10,1989,5,910,2.0,642.0,642.0,5,1079,2.0,811.0,811.0
0.165,6,10,1506,5,395,36.0,127.0,127.0,5,1111,38.0,843.0,843.0
172.481,17,74,10673,37,2468,4791.0,44.0,38.0,37,8205,4790.0,252.0,193.0
40.065,17,10,676,5,460,10013.0,104.0,64.0,5,216,10015.0,20.0,15.0
0.005,17,2,180,1,58,0.0,30.0,30.0,1,122,0.0,94.0,94.0
0.008,6,10,1972,5,910,2.0,642.0,642.0,5,1062,2.0,794.0,794.0
0.009,6,10,1983,5,910,2.0,642.0,642.0,5,1073,2.0,805.0,805.0
40.066,17,10,676,5,460,10015.0,104.0,64.0,5,216,10014.0,20.0,15.0
0.005,6,10,2006,5,927,1.0,659.0,659.0,5,1079,1.0,811.0,811.0
0.006,17,2,230,1,68,0.0,40.0,40.0,1,162,0.0,134.0,134.0
0.01,6,10,1972,5,910,2.0,642.0,642.0,5,1062,2.0,794.0,794.0
0.039,17,2,148,1,60,0.0,32.0,32.0,1,88,0.0,60.0,60.0
0.018,6,10,1989,5,910,4.0,642.0,642.0,5,1079,4.0,811.0,811.0
0.009,6,10,1547,5,764,2.0,496.0,496.0,5,783,2.0,515.0,515.0
0.067,17,8,3613,4,1874,22.0,1350.0,440.0,4,1739,10.0,1350.0,406.0
0.109,6,10,1506,5,395,24.0,127.0,127.0,5,1111,24.0,843.0,843.0
0.004,17,2,136,1,60,0.0,32.0,32.0,1,76,0.0,48.0,48.0
0.004,6,10,2006,5,927,1.0,659.0,659.0,5,1079,1.0,811.0,811.0
0.765,6,23,8407,13,2034,63.0,1139.0,370.0,10,6373,65.0,2720.0,851.0
40.069,17,10,676,5,460,10012.0,104.0,64.0,5,216,10016.0,20.0,15.0
0.011,6,10,1990,5,911,2.0,643.0,643.0,5,1079,2.0,811.0,811.0
0.012,6,10,1990,5,911,2.0,643.0,643.0,5,1079,2.0,811.0,811.0
0.014,6,10,1631,5,848,3.0,580.0,580.0,5,783,3.0,515.0,515.0
0.096,6,10,1506,5,395,21.0,127.0,127.0,5,1111,22.0,843.0,843.0
40.063,17,10,676,5,460,10014.0,104.0,64.0,5,216,10015.0,20.0,15.0
40.071,17,10,676,5,460,10014.0,104.0,64.0,5,216,10016.0,20.0,15.0
0.006,6,10,1689,5,839,1.0,571.0,571.0,5,850,1.0,582.0,582.0
0.091,6,10,1506,5,395,20.0,127.0,127.0,5,1111,16.0,843.0,843.0
0.015,6,10,1983,5,910,3.0,642.0,642.0,5,1073,3.0,805.0,805.0
0.005,6,10,1774,5,923,1.0,655.0,655.0,5,851,1.0,583.0,583.0
0.021,6,10,1989,5,910,5.0,642.0,642.0,5,1079,5.0,811.0,811.0
0.007,6,10,1989,5,910,1.0,642.0,642.0,5,1079,1.0,811.0,811.0
0.08,6,10,1506,5,395,17.0,127.0,127.0,5,1111,19.0,843.0,843.0
0.017,6,10,1762,5,911,4.0,643.0,643.0,5,851,4.0,583.0,583.0
40.059,17,10,676,5,460,10014.0,104.0,64.0,5,216,10013.0,20.0,15.0
0.047,6,10,1983,5,910,11.0,642.0,642.0,5,1073,11.0,805.0,805.0
0.038,6,10,1983,5,910,9.0,642.0,642.0,5,1073,9.0,805.0,805.0
0.006,6,10,1547,5,764,1.0,496.0,496.0,5,783,1.0,515.0,515.0
0.02,6,10,1989,5,910,4.0,642.0,642.0,5,1079,4.0,811.0,811.0
0.022,6,10,1983,5,910,5.0,642.0,642.0,5,1073,5.0,805.0,805.0
0.005,6,10,2000,5,927,1.0,659.0,659.0,5,1073,1.0,805.0,805.0
0.004,6,10,2007,5,928,1.0,660.0,660.0,5,1079,1.0,811.0,811.0
0.067,17,8,3613,4,1874,22.0,1350.0,440.0,4,1739,10.0,1350.0,406.0
0.191,6,10,1506,5,395,45.0,127.0,127.0,5,1111,42.0,843.0,843.0
0.01,6,10,1983,5,910,2.0,642.0,642.0,5,1073,2.0,805.0,805.0
0.004,17,2,148,1,60,0.0,32.0,32.0,1,88,0.0,60.0,60.0
0.01,6,10,1972,5,910,2.0,642.0,642.0,5,1062,2.0,794.0,794.0
0.096,6,10,1506,5,395,19.0,127.0,127.0,5,1111,18.0,843.0,843.0
172.041,17,80,11431,40,2672,4411.0,44.0,38.0,40,8759,4411.0,239.0,190.0
0.006,6,10,1779,5,928,1.0,660.0,660.0,5,851,1.0,583.0,583.0
0.004,17,2,148,1,60,0.0,32.0,32.0,1,88,0.0,60.0,60.0
0.123,6,10,1506,5,395,27.0,127.0,127.0,5,1111,26.0,843.0,843.0
0.112,6,10,1506,5,395,25.0,127.0,127.0,5,1111,25.0,843.0,843.0
0.102,6,10,1506,5,395,21.0,127.0,127.0,5,1111,24.0,843.0,843.0
0.005,6,10,2006,5,927,1.0,659.0,659.0,5,1079,1.0,811.0,811.0
0.011,6,10,1990,5,911,2.0,643.0,643.0,5,1079,2.0,811.0,811.0
0.005,17,2,144,1,64,0.0,36.0,36.0,1,80,0.0,52.0,52.0
0.006,6,10,1547,5,764,1.0,496.0,496.0,5,783,1.0,515.0,515.0
300.838,6,37,9740,20,4262,15833.0,1686.0,686.0,17,5478,540.0,2667.0,435.0
308.324,17,20,1124,10,716,34251.0,48.0,43.0,10,408,34251.0,20.0,12.0
0.059,6,10,1506,5,395,14.0,127.0,127.0,5,1111,12.0,843.0,843.0
0.005,6,10,2006,5,927,1.0,659.0,659.0,5,1079,1.0,811.0,811.0
40.063,17,10,676,5,460,10012.0,104.0,64.0,5,216,10015.0,20.0,15.0
0.069,6,10,1506,5,395,14.0,127.0,127.0,5,1111,15.0,843.0,843.0
0.126,6,10,1506,5,395,28.0,127.0,127.0,5,1111,26.0,843.0,843.0
0.013,6,10,1983,5,910,3.0,642.0,642.0,5,1073,3.0,805.0,805.0
0.116,6,10,1506,5,395,27.0,127.0,127.0,5,1111,25.0,843.0,843.0
0.004,6,10,2000,5,927,1.0,659.0,659.0,5,1073,1.0,805.0,805.0
1770.714,17,120,11460,60,5460,30011.0,63.0,63.0,60,6000,30011.0,72.0,72.0
0.088,6,10,1506,5,395,20.0,127.0,127.0,5,1111,18.0,843.0,843.0
0.012,6,10,1989,5,910,3.0,642.0,642.0,5,1079,3.0,811.0,811.0
0.004,6,13,3690,7,452,0.0,80.0,80.0,6,3238,0.0,1470.0,1459.0
0.006,6,11,2041,6,979,1.0,659.0,659.0,5,1062,1.0,794.0,794.0
0.004,6,10,2006,5,927,1.0,659.0,659.0,5,1079,1.0,811.0,811.0
0.005,6,10,2007,5,928,1.0,660.0,660.0,5,1079,1.0,811.0,811.0
0.11,6,10,1506,5,395,25.0,127.0,127.0,5,1111,26.0,843.0,843.0
354.072,6,21,1795,16,1030,23604.0,190.0,190.0,5,765,60002.0,464.0,248.0
0.014,6,10,1972,5,910,3.0,642.0,642.0,5,1062,3.0,794.0,794.0
0.11,6,10,1506,5,395,24.0,127.0,127.0,5,1111,25.0,843.0,843.0
0.089,6,10,1506,5,395,19.0,127.0,127.0,5,1111,20.0,843.0,843.0
0.026,6,10,1972,5,910,6.0,642.0,642.0,5,1062,6.0,794.0,794.0
0.001,17,2,136,1,60,0.0,32.0,32.0,1,76,0.0,48.0,48.0
0.094,6,10,1506,5,395,22.0,127.0,127.0,5,1111,19.0,843.0,843.0
0.004,17,2,148,1,60,0.0,32.0,32.0,1,88,0.0,60.0,60.0
0.006,6,10,1547,5,764,1.0,496.0,496.0,5,783,1.0,515.0,515.0
0.011,6,10,1972,5,910,2.0,642.0,642.0,5,1062,2.0,794.0,794.0
0.003,17,2,136,1,60,0.0,32.0,32.0,1,76,0.0,48.0,48.0
0.005,6,10,2006,5,927,1.0,659.0,659.0,5,1079,1.0,811.0,811.0
0.006,6,10,1854,5,889,1.0,621.0,621.0,5,965,1.0,697.0,697.0
0.023,6,10,1631,5,848,5.0,580.0,580.0,5,783,5.0,515.0,515.0
0.005,6,10,2006,5,927,1.0,659.0,659.0,5,1079,1.0,811.0,811.0
0.004,6,10,2006,5,927,1.0,659.0,659.0,5,1079,1.0,811.0,811.0
10.727,17,28,4421,14,1993,816.0,268.0,114.0,14,2428,816.0,587.0,145.0
1756.062,6,105,6258,60,3519,29763.0,27.0,26.0,45,2739,39909.0,27.0,26.0
40.059,17,10,676,5,460,10012.0,104.0,64.0,5,216,10013.0,20.0,15.0
0.014,6,10,1990,5,911,3.0,643.0,643.0,5,1079,3.0,811.0,811.0
0.091,6,10,1506,5,395,15.0,127.0,127.0,5,1111,20.0,843.0,843.0
0.005,17,2,140,1,62,0.0,34.0,34.0,1,78,0.0,50.0,50.0
0.005,6,10,1989,5,927,1.0,659.0,659.0,5,1062,1.0,794.0,794.0
0.005,17,2,136,1,60,0.0,32.0,32.0,1,76,0.0,48.0,48.0
0.115,6,10,1506,5,395,25.0,127.0,127.0,5,1111,22.0,843.0,843.0
0.098,6,10,1506,5,395,20.0,127.0,127.0,5,1111,20.0,843.0,843.0
0.005,6,10,2007,5,928,1.0,660.0,660.0,5,1079,1.0,811.0,811.0
0.001,17,2,180,1,66,0.0,38.0,38.0,1,114,0.0,86.0,86.0
1787.802,6,238,46375,113,33972,15962.0,2500.0,1123.0,125,12403,14417.0,580.0,61.0
0.016,17,2,198,1,91,0.0,63.0,63.0,1,107,0.0,79.0,79.0
0.103,6,10,1506,5,395,23.0,127.0,127.0,5,1111,15.0,843.0,843.0
0.072,17,2,170,1,65,0.0,37.0,37.0,1,105,0.0,77.0,77.0
0.012,6,10,1989,5,910,3.0,642.0,642.0,5,1079,3.0,811.0,811.0
0.075,6,10,1506,5,395,15.0,127.0,127.0,5,1111,17.0,843.0,843.0
0.011,6,13,3735,7,497,1.0,125.0,125.0,6,3238,2.0,1470.0,1459.0
0.099,6,10,1506,5,395,21.0,127.0,127.0,5,1111,22.0,843.0,843.0
11.162,17,28,4423,14,1995,846.0,270.0,114.0,14,2428,846.0,587.0,145.0
0.092,6,10,1506,5,395,21.0,127.0,127.0,5,1111,18.0,843.0,843.0
0.133,17,4,420,2,122,1.0,33.0,33.0,2,298,61.0,145.0,121.0
0.016,6,10,1990,5,911,4.0,643.0,643.0,5,1079,3.0,811.0,811.0
0.191,6,10,1506,5,395,43.0,127.0,127.0,5,1111,38.0,843.0,843.0
0.004,6,10,1702,5,863,1.0,595.0,595.0,5,839,1.0,571.0,571.0
0.004,17,4,284,2,120,0.0,32.0,32.0,2,164,0.0,60.0,54.0
300.115,6,11,1270,6,609,60016.0,289.0,289.0,5,661,75020.0,393.0,393.0
0.122,6,10,1506,5,395,29.0,127.0,127.0,5,1111,26.0,843.0,843.0
0.02,6,13,3735,7,497,3.0,125.0,125.0,6,3238,3.0,1470.0,1459.0
0.011,6,10,1972,5,910,2.0,642.0,642.0,5,1062,2.0,794.0,794.0
40.07,17,10,676,5,460,10016.0,104.0,64.0,5,216,10016.0,20.0,15.0
0.022,6,10,1989,5,910,5.0,642.0,642.0,5,1079,5.0,811.0,811.0
0.005,6,10,2000,5,927,1.0,659.0,659.0,5,1073,1.0,805.0,805.0
0.091,6,10,1506,5,395,19.0,127.0,127.0,5,1111,18.0,843.0,843.0
141.777,6,26,9525,12,1627,76.0,794.0,367.0,14,7898,10896.0,1360.0,732.0
0.087,6,10,1506,5,395,19.0,127.0,127.0,5,1111,19.0,843.0,843.0
0.022,6,10,1983,5,910,5.0,642.0,642.0,5,1073,5.0,805.0,805.0
0.001,17,2,180,1,65,0.0,37.0,37.0,1,115,0.0,87.0,87.0
0.006,6,10,1689,5,839,1.0,571.0,571.0,5,850,1.0,582.0,582.0
0.001,17,2,180,1,66,0.0,38.0,38.0,1,114,0.0,86.0,86.0
300.47,6,16,2170,9,684,37537.0,146.0,146.0,7,1486,50050.0,419.0,398.0
0.013,6,10,1983,5,910,3.0,642.0,642.0,5,1073,3.0,805.0,805.0
0.005,17,2,170,1,65,0.0,37.0,37.0,1,105,0.0,77.0,77.0
0.021,6,10,1762,5,911,5.0,643.0,643.0,5,851,5.0,583.0,583.0
40.056,17,10,676,5,460,10013.0,104.0,64.0,5,216,10013.0,20.0,15.0
0.011,6,10,1762,5,911,2.0,643.0,643.0,5,851,2.0,583.0,583.0
0.013,6,10,1631,5,848,3.0,580.0,580.0,5,783,3.0,515.0,515.0
0.005,17,2,180,1,66,0.0,38.0,38.0,1,114,0.0,86.0,86.0
0.072,6,10,1506,5,395,16.0,127.0,127.0,5,1111,14.0,843.0,843.0
360.036,6,21,3981,13,3142,30003.0,494.0,494.0,8,839,51433.0,83.0,83.0
308.795,17,20,1124,10,716,34295.0,48.0,43.0,10,408,34295.0,20.0,12.0
40.049,17,10,676,5,460,10011.0,104.0,64.0,5,216,10011.0,20.0,15.0
0.005,6,10,1547,5,764,1.0,496.0,496.0,5,783,1.0,515.0,515.0
0.014,6,10,1983,5,910,3.0,642.0,642.0,5,1073,3.0,805.0,805.0
0.009,6,10,1972,5,910,2.0,642.0,642.0,5,1062,2.0,794.0,794.0
175.561,17,70,10074,35,2330,5163.0,44.0,38.0,35,7744,5163.0,261.0,193.0
0.022,6,10,1989,5,910,5.0,642.0,642.0,5,1079,5.0,811.0,811.0
0.005,6,10,1774,5,923,1.0,655.0,655.0,5,851,1.0,583.0,583.0
0.369,17,48,26894,26,23456,14.0,1350.0,874.0,22,3438,14.0,1350.0,128.0
0.186,17,2,194,1,59,0.0,31.0,31.0,1,135,0.0,107.0,107.0
0.003,17,2,148,1,60,0.0,32.0,32.0,1,88,0.0,60.0,60.0
15.078,17,15,8050,8,5975,2150.0,1350.0,718.0,7,2075,2508.0,1350.0,268.0
0.049,17,2,152,1,76,0.0,48.0,48.0,1,76,0.0,48.0,48.0
300.871,6,37,9957,20,4479,15835.0,1935.0,729.0,17,5478,540.0,2667.0,435.0
240.031,6,9,787,5,488,60007.0,232.0,232.0,4,299,80009.0,83.0,83.0
0.006,6,10,1547,5,764,1.0,496.0,496.0,5,783,1.0,515.0,515.0
0.004,17,4,284,2,120,0.0,32.0,32.0,2,164,1.0,60.0,54.0
0.015,6,10,1989,5,910,3.0,642.0,642.0,5,1079,3.0,811.0,811.0
0.039,17,2,152,1,76,0.0,48.0,48.0,1,76,0.0,48.0,48.0
0.108,6,10,1506,5,395,25.0,127.0,127.0,5,1111,25.0,843.0,843.0
0.009,6,13,3735,7,497,1.0,125.0,125.0,6,3238,1.0,1470.0,1459.0
0.114,6,10,1506,5,395,26.0,127.0,127.0,5,1111,26.0,843.0,843.0
0.088,6,10,1506,5,395,16.0,127.0,127.0,5,1111,20.0,843.0,843.0
0.005,6,10,2007,5,928,1.0,660.0,660.0,5,1079,1.0,811.0,811.0
0.005,6,10,1989,5,927,1.0,659.0,659.0,5,1062,1.0,794.0,794.0
0.008,6,10,1989,5,910,2.0,642.0,642.0,5,1079,2.0,811.0,811.0
0.01,6,10,1990,5,911,2.0,643.0,643.0,5,1079,2.0,811.0,811.0
0.722,6,22,8516,12,1649,65.0,517.0,257.0,10,6867,66.0,1402.0,905.0
0.105,6,10,1506,5,395,24.0,127.0,127.0,5,1111,23.0,843.0,843.0
0.005,17,2,166,1,75,0.0,47.0,47.0,1,91,0.0,63.0,63.0
0.066,6,10,1506,5,395,15.0,127.0,127.0,5,1111,15.0,843.0,843.0
0.094,6,10,1506,5,395,20.0,127.0,127.0,5,1111,21.0,843.0,843.0
0.005,6,10,1854,5,889,1.0,621.0,621.0,5,965,1.0,697.0,697.0
0.027,6,10,1762,5,911,6.0,643.0,643.0,5,851,6.0,583.0,583.0
0.006,6,10,1547,5,764,1.0,496.0,496.0,5,783,1.0,515.0,515.0
10.912,17,28,4420,14,1993,829.0,268.0,114.0,14,2427,830.0,586.0,145.0
0.012,6,10,1989,5,910,3.0,642.0,642.0,5,1079,2.0,811.0,811.0
0.226,6,16,2670,8,1396,32.0,533.0,324.0,8,1274,20.0,529.0,212.0
0.005,6,10,2007,5,928,1.0,660.0,660.0,5,1079,1.0,811.0,811.0
0.004,17,2,148,1,60,0.0,32.0,32.0,1,88,0.0,60.0,60.0
0.004,17,2,136,1,60,0.0,32.0,32.0,1,76,0.0,48.0,48.0
0.012,6,10,1990,5,911,2.0,643.0,643.0,5,1079,3.0,811.0,811.0
0.014,6,10,1677,5,827,3.0,559.0,559.0,5,850,3.0,582.0,582.0
15.071,17,15,9238,8,6902,2148.0,1350.0,834.0,7,2336,2506.0,1350.0,305.0
0.008,6,10,1990,5,911,2.0,643.0,643.0,5,1079,1.0,811.0,811.0
0.006,17,2,164,1,74,0.0,46.0,46.0,1,90,0.0,62.0,62.0
175.146,17,82,11537,41,2752,4378.0,44.0,39.0,41,8785,4378.0,239.0,186.0
0.002,17,2,180,1,66,0.0,38.0,38.0,1,114,0.0,86.0,86.0
40.051,17,10,676,5,460,10012.0,104.0,64.0,5,216,10012.0,20.0,15.0
0.001,17,2,180,1,66,0.0,38.0,38.0,1,114,0.0,86.0,86.0
0.004,17,2,148,1,60,0.0,32.0,32.0,1,88,0.0,60.0,60.0
0.001,17,2,180,1,66,0.0,38.0,38.0,1,114,0.0,86.0,86.0
0.041,17,4,352,2,130,1.0,37.0,37.0,2,222,3.0,89.0,83.0
0.006,6,10,2007,5,928,1.0,660.0,660.0,5,1079,1.0,811.0,811.0
0.109,6,10,1506,5,395,26.0,127.0,127.0,5,1111,21.0,843.0,843.0
0.005,17,2,170,1,65,0.0,37.0,37.0,1,105,0.0,77.0,77.0
0.004,6,10,2006,5,927,1.0,659.0,659.0,5,1079,1.0,811.0,811.0
0.013,6,10,1677,5,827,3.0,559.0,559.0,5,850,3.0,582.0,582.0
0.001,17,2,180,1,66,0.0,38.0,38.0,1,114,0.0,86.0,86.0
0.139,6,10,1506,5,395,32.0,127.0,127.0,5,1111,30.0,843.0,843.0
0.005,6,10,1689,5,839,1.0,571.0,571.0,5,850,1.0,582.0,582.0
0.001,17,2,180,1,66,0.0,38.0,38.0,1,114,0.0,86.0,86.0
0.005,6,10,2007,5,928,1.0,660.0,660.0,5,1079,1.0,811.0,811.0
0.004,6,10,1702,5,863,1.0,595.0,595.0,5,839,0.0,571.0,571.0
0.075,6,10,1506,5,395,17.0,127.0,127.0,5,1111,15.0,843.0,843.0
40.066,17,10,676,5,460,10015.0,104.0,64.0,5,216,10015.0,20.0,15.0
176.421,17,76,10598,38,2529,4768.0,44.0,38.0,38,8069,4768.0,252.0,184.0
0.009,6,10,1972,5,910,2.0,642.0,642.0,5,1062,2.0,794.0,794.0
0.016,6,10,1989,5,910,4.0,642.0,642.0,5,1079,4.0,811.0,811.0
240.014,6,9,787,5,488,60003.0,232.0,232.0,4,299,80004.0,83.0,83.0
240.092,6,31,9435,15,6995,17149.0,2119.0,691.0,16,2440,16005.0,580.0,200.0
0.003,17,2,136,1,60,0.0,32.0,32.0,1,76,0.0,48.0,48.0
40.082,17,10,676,5,460,10019.0,104.0,64.0,5,216,10019.0,20.0,15.0
0.005,6,10,2006,5,927,1.0,659.0,659.0,5,1079,1.0,811.0,811.0
0.012,6,13,3735,7,497,2.0,125.0,125.0,6,3238,2.0,1470.0,1459.0
0.005,6,10,2006,5,927,1.0,659.0,659.0,5,1079,1.0,811.0,811.0
0.001,17,2,180,1,66,0.0,38.0,38.0,1,114,0.0,86.0,86.0
0.005,17,2,222,1,65,0.0,37.0,37.0,1,157,0.0,129.0,129.0
0.004,17,2,148,1,60,0.0,32.0,32.0,1,88,0.0,60.0,60.0
0.087,6,10,1506,5,395,19.0,127.0,127.0,5,1111,16.0,843.0,843.0
0.004,6,10,2000,5,927,1.0,659.0,659.0,5,1073,1.0,805.0,805.0
0.008,6,10,1989,5,910,2.0,642.0,642.0,5,1079,2.0,811.0,811.0
0.005,6,10,1774,5,923,1.0,655.0,655.0,5,851,1.0,583.0,583.0
0.005,6,10,1547,5,764,1.0,496.0,496.0,5,783,1.0,515.0,515.0
0.115,6,10,1506,5,395,25.0,127.0,127.0,5,1111,25.0,843.0,843.0
0.008,6,10,1990,5,911,2.0,643.0,643.0,5,1079,1.0,811.0,811.0
0.013,6,10,1989,5,910,3.0,642.0,642.0,5,1079,3.0,811.0,811.0
0.012,6,11,1683,6,900,2.0,580.0,580.0,5,783,2.0,515.0,515.0
141.054,6,23,8984,11,1295,79.0,514.0,274.0,12,7689,12812.0,1360.0,1028.0
0.004,17,2,148,1,60,0.0,32.0,32.0,1,88,0.0,60.0,60.0
0.006,17,2,275,1,67,0.0,39.0,39.0,1,208,0.0,180.0,180.0
300.234,6,16,2170,9,684,37508.0,146.0,146.0,7,1486,50010.0,419.0,398.0
40.063,17,10,676,5,460,10014.0,104.0,64.0,5,216,10014.0,20.0,15.0
1756.237,6,105,6270,60,3525,29766.0,27.0,27.0,45,2745,39913.0,27.0,27.0
0.004,6,10,2006,5,927,1.0,659.0,659.0,5,1079,1.0,811.0,811.0
0.009,6,10,1989,5,927,2.0,659.0,659.0,5,1062,2.0,794.0,794.0
0.053,17,2,152,1,76,0.0,48.0,48.0,1,76,0.0,48.0,48.0
300.308,6,16,2170,9,684,37517.0,146.0,146.0,7,1486,50023.0,419.0,398.0
0.007,6,10,1854,5,889,1.0,621.0,621.0,5,965,1.0,697.0,697.0
0.015,6,10,1989,5,910,3.0,642.0,642.0,5,1079,3.0,811.0,811.0
0.193,6,3,453,2,321,193.0,241.0,241.0,1,132,0.0,92.0,92.0
0.006,17,2,424,1,72,0.0,44.0,44.0,1,352,0.0,324.0,324.0
0.006,6,10,1547,5,764,1.0,496.0,496.0,5,783,1.0,515.0,515.0
0.165,6,10,1506,5,395,39.0,127.0,127.0,5,1111,39.0,843.0,843.0
11.455,17,28,4367,14,2313,868.0,588.0,137.0,14,2054,868.0,269.0,118.0
0.039,17,2,144,1,64,0.0,36.0,36.0,1,80,0.0,52.0,52.0
241.414,6,380,347257,191,21459,1270.0,2736.0,959.0,189,325798,1284.0,4171.0,1765.0
0.078,6,10,1506,5,395,16.0,127.0,127.0,5,1111,16.0,843.0,843.0
0.006,6,10,1689,5,839,1.0,571.0,571.0,5,850,1.0,582.0,582.0
0.078,6,10,1506,5,395,17.0,127.0,127.0,5,1111,18.0,843.0,843.0
15.073,17,15,9238,8,6902,2149.0,1350.0,834.0,7,2336,2507.0,1350.0,305.0
0.005,17,2,169,1,62,0.0,34.0,34.0,1,107,0.0,79.0,79.0
0.005,6,10,2000,5,927,1.0,659.0,659.0,5,1073,1.0,805.0,805.0
0.079,6,10,1506,5,395,17.0,127.0,127.0,5,1111,18.0,843.0,843.0
0.014,6,10,1989,5,910,3.0,642.0,642.0,5,1079,3.0,811.0,811.0
0.007,6,10,1989,5,927,1.0,659.0,659.0,5,1062,1.0,794.0,794.0
0.006,6,10,1689,5,839,1.0,571.0,571.0,5,850,1.0,582.0,582.0
0.01,6,10,1990,5,911,2.0,643.0,643.0,5,1079,2.0,811.0,811.0
0.001,17,2,180,1,66,0.0,38.0,38.0,1,114,0.0,86.0,86.0
0.004,6,13,3747,7,509,0.0,137.0,137.0,6,3238,0.0,1470.0,1459.0
351.988,6,20,2210,6,1308,12003.0,494.0,494.0,14,902,27075.0,83.0,83.0
0.042,17,2,182,1,65,0.0,37.0,37.0,1,117,0.0,89.0,89.0
0.004,6,10,2006,5,927,1.0,659.0,659.0,5,1079,1.0,811.0,811.0
0.007,6,12,1698,6,863,1.0,327.0,271.0,6,835,1.0,515.0,515.0
0.004,17,2,136,1,60,0.0,32.0,32.0,1,76,0.0,48.0,48.0
0.004,17,4,284,2,120,0.0,32.0,32.0,2,164,1.0,60.0,54.0
0.006,6,10,1547,5,764,1.0,496.0,496.0,5,783,1.0,515.0,515.0
0.013,6,10,1677,5,827,3.0,559.0,559.0,5,850,3.0,582.0,582.0
0.019,6,10,1989,5,910,4.0,642.0,642.0,5,1079,4.0,811.0,811.0
0.006,17,2,170,1,65,0.0,37.0,37.0,1,105,0.0,77.0,77.0
0.011,6,10,1983,5,910,2.0,642.0,642.0,5,1073,2.0,805.0,805.0
0.005,6,10,2006,5,927,1.0,659.0,659.0,5,1079,1.0,811.0,811.0
0.005,6,10,1779,5,928,1.0,660.0,660.0,5,851,1.0,583.0,583.0
0.009,6,10,1990,5,911,2.0,643.0,643.0,5,1079,2.0,811.0,811.0
0.093,6,10,1506,5,395,21.0,127.0,127.0,5,1111,19.0,843.0,843.0
0.005,17,2,231,1,68,0.0,40.0,40.0,1,163,0.0,135.0,135.0
0.001,17,2,180,1,66,0.0,38.0,38.0,1,114,0.0,86.0,86.0
0.004,17,2,136,1,60,0.0,32.0,32.0,1,76,0.0,48.0,48.0
0.036,6,10,1972,5,910,8.0,642.0,642.0,5,1062,9.0,794.0,794.0
0.094,6,10,1506,5,395,23.0,127.0,127.0,5,1111,22.0,843.0,843.0
240.164,6,38,5309,19,2374,13342.0,588.0,196.0,19,2935,13342.0,607.0,277.0
168.13,17,78,11213,39,2601,4424.0,44.0,38.0,39,8612,4424.0,239.0,192.0
40.055,17,10,676,5,460,10013.0,104.0,64.0,5,216,10013.0,20.0,15.0
40.09,17,10,676,5,460,10019.0,104.0,64.0,5,216,10021.0,20.0,15.0
300.385,6,16,2170,9,684,37526.0,146.0,146.0,7,1486,50035.0,419.0,398.0
0.073,6,10,1506,5,395,17.0,127.0,127.0,5,1111,15.0,843.0,843.0
0.004,17,4,284,2,120,1.0,32.0,32.0,2,164,0.0,60.0,54.0
0.039,17,4,284,2,120,0.0,32.0,32.0,2,164,36.0,60.0,54.0
0.006,6,10,1547,5,764,1.0,496.0,496.0,5,783,1.0,515.0,515.0
10.817,17,28,4421,14,1994,823.0,269.0,114.0,14,2427,823.0,586.0,145.0
15.07,17,14,9190,8,6902,2148.0,1350.0,834.0,6,2288,3008.0,1350.0,353.0
0.01,6,10,1989,5,910,2.0,642.0,642.0,5,1079,2.0,811.0,811.0
0.006,17,2,166,1,75,0.0,47.0,47.0,1,91,0.0,63.0,63.0
0.005,6,10,2006,5,927,1.0,659.0,659.0,5,1079,1.0,811.0,811.0
0.004,6,10,2000,5,927,1.0,659.0,659.0,5,1073,1.0,805.0,805.0
0.01,6,10,1983,5,910,2.0,642.0,642.0,5,1073,2.0,805.0,805.0
0.113,6,10,1506,5,395,24.0,127.0,127.0,5,1111,20.0,843.0,843.0
0.003,17,2,148,1,60,0.0,32.0,32.0,1,88,0.0,60.0,60.0
0.005,6,10,2000,5,927,1.0,659.0,659.0,5,1073,1.0,805.0,805.0
0.005,17,2,178,1,81,0.0,53.0,53.0,1,97,0.0,69.0,69.0
0.004,6,10,1989,5,927,1.0,659.0,659.0,5,1062,1.0,794.0,794.0
0.005,6,10,2006,5,927,1.0,659.0,659.0,5,1079,1.0,811.0,811.0
15.074,17,15,9238,8,6902,2149.0,1350.0,834.0,7,2336,2507.0,1350.0,305.0
15.087,17,16,8505,8,6336,2151.0,1350.0,764.0,8,2169,2151.0,1350.0,243.0
240.039,6,9,787,5,488,60009.0,232.0,232.0,4,299,80002.0,83.0,83.0
0.071,6,10,1506,5,395,17.0,127.0,127.0,5,1111,16.0,843.0,843.0
0.138,6,10,1506,5,395,32.0,127.0,127.0,5,1111,31.0,843.0,843.0
0.084,6,10,1506,5,395,20.0,127.0,127.0,5,1111,16.0,843.0,843.0
0.005,6,10,2006,5,927,1.0,659.0,659.0,5,1079,1.0,811.0,811.0
0.005,6,10,1989,5,927,1.0,659.0,659.0,5,1062,1.0,794.0,794.0
0.009,6,10,1972,5,910,2.0,642.0,642.0,5,1062,2.0,794.0,794.0
0.016,6,10,1983,5,910,3.0,642.0,642.0,5,1073,4.0,805.0,805.0
0.005,17,2,169,1,62,0.0,34.0,34.0,1,107,0.0,79.0,79.0
0.004,6,10,2000,5,927,1.0,659.0,659.0,5,1073,1.0,805.0,805.0
15.083,17,15,8114,8,6032,2150.0,1350.0,726.0,7,2082,2508.0,1350.0,269.0
0.07,6,10,1506,5,395,15.0,127.0,127.0,5,1111,16.0,843.0,843.0
0.005,6,10,2006,5,927,1.0,659.0,659.0,5,1079,1.0,811.0,811.0
0.004,17,2,148,1,60,0.0,32.0,32.0,1,88,0.0,60.0,60.0
0.006,17,2,144,1,64,0.0,36.0,36.0,1,80,0.0,52.0,52.0
240.125,6,30,9238,15,6965,17151.0,2086.0,687.0,15,2273,17151.0,580.0,212.0
40.091,17,10,676,5,460,10019.0,104.0,64.0,5,216,10021.0,20.0,15.0
0.003,17,2,148,1,60,0.0,32.0,32.0,1,88,0.0,60.0,60.0
280.365,6,24,6115,11,1226,28036.0,267.0,156.0,13,4889,23354.0,1400.0,873.0
0.016,6,10,1983,5,910,3.0,642.0,642.0,5,1073,4.0,805.0,805.0
0.012,6,13,3735,7,497,1.0,125.0,125.0,6,3238,2.0,1470.0,1459.0
0.13,17,2,234,1,61,0.0,33.0,33.0,1,173,0.0,145.0,145.0
0.038,17,2,152,1,76,0.0,48.0,48.0,1,76,0.0,48.0,48.0
0.012,6,10,1677,5,827,3.0,559.0,559.0,5,850,3.0,582.0,582.0
0.005,17,2,152,1,68,0.0,40.0,40.0,1,84,0.0,56.0,56.0
1777.877,17,144,45504,72,22752,25040.0,288.0,288.0,72,22752,25040.0,288.0,288.0
0.011,6,10,1972,5,910,2.0,642.0,642.0,5,1062,2.0,794.0,794.0
0.005,17,2,175,1,65,0.0,37.0,37.0,1,110,0.0,82.0,82.0
0.004,17,4,284,2,120,0.0,32.0,32.0,2,164,0.0,60.0,54.0
392.696,6,29,4397,13,3142,32724.0,494.0,494.0,16,1255,26179.0,83.0,83.0
0.005,17,2,170,1,65,0.0,37.0,37.0,1,105,0.0,77.0,77.0
310.701,17,20,1124,10,716,34508.0,48.0,43.0,10,408,34508.0,20.0,12.0
0.005,17,2,194,1,59,0.0,31.0,31.0,1,135,0.0,107.0,107.0
351.99,6,20,2210,6,1308,12003.0,494.0,494.0,14,902,27075.0,83.0,83.0
0.003,17,2,136,1,60,0.0,32.0,32.0,1,76,0.0,48.0,48.0
0.008,6,10,1989,5,910,1.0,642.0,642.0,5,1079,2.0,811.0,811.0
0.083,6,10,1506,5,395,19.0,127.0,127.0,5,1111,17.0,843.0,843.0
15.323,17,26,17443,11,4330,1529.0,1350.0,365.0,15,13113,1092.0,1350.0,846.0
0.108,6,10,1506,5,395,25.0,127.0,127.0,5,1111,23.0,843.0,843.0
0.013,6,10,1677,5,827,3.0,559.0,559.0,5,850,3.0,582.0,582.0
0.006,6,10,1547,5,764,1.0,496.0,496.0,5,783,1.0,515.0,515.0
0.008,17,2,179,1,71,0.0,43.0,43.0,1,108,0.0,80.0,80.0
0.018,6,10,1762,5,911,4.0,643.0,643.0,5,851,4.0,583.0,583.0
0.021,6,10,1972,5,910,5.0,642.0,642.0,5,1062,5.0,794.0,794.0
0.006,6,10,1689,5,839,1.0,571.0,571.0,5,850,1.0,582.0,582.0
240.084,6,16,4481,9,963,30010.0,238.0,166.0,7,3518,40013.0,1402.0,786.0
0.005,6,10,1989,5,927,1.0,659.0,659.0,5,1062,1.0,794.0,794.0
0.005,17,2,179,1,71,0.0,43.0,43.0,1,108,0.0,80.0,80.0
0.011,6,10,1972,5,910,2.0,642.0,642.0,5,1062,2.0,794.0,794.0
39.684,6,45,19031,22,13313,428.0,2720.0,1377.0,23,5718,1796.0,2667.0,435.0
0.015,6,10,1989,5,910,3.0,642.0,642.0,5,1079,3.0,811.0,811.0
0.006,6,10,1689,5,839,1.0,571.0,571.0,5,850,1.0,582.0,582.0
180.582,6,59,19239,34,4891,5472.0,1056.0,223.0,25,14348,7524.0,2804.0,870.0
1770.587,17,120,11460,60,5460,30009.0,63.0,63.0,60,6000,30009.0,72.0,72.0
0.08,6,10,1506,5,395,17.0,127.0,127.0,5,1111,17.0,843.0,843.0
0.012,6,10,1989,5,910,3.0,642.0,642.0,5,1079,3.0,811.0,811.0
1799.973,17,2632,201755,1307,106013,1378.0,84.0,53.0,1325,95742,1359.0,227.0,44.0
0.005,17,2,214,1,75,0.0,47.0,47.0,1,139,0.0,111.0,111.0
0.004,17,2,136,1,60,0.0,32.0,32.0,1,76,0.0,48.0,48.0
0.007,17,2,214,1,75,0.0,47.0,47.0,1,139,0.0,111.0,111.0
0.006,6,10,1689,5,839,1.0,571.0,571.0,5,850,1.0,582.0,582.0
0.004,6,13,3690,7,452,0.0,80.0,80.0,6,3238,0.0,1470.0,1459.0
0.078,6,10,1506,5,395,17.0,127.0,127.0,5,1111,17.0,843.0,843.0
0.084,6,10,1506,5,395,16.0,127.0,127.0,5,1111,20.0,843.0,843.0
0.005,6,10,2006,5,927,1.0,659.0,659.0,5,1079,1.0,811.0,811.0
0.005,6,10,1643,5,860,1.0,592.0,592.0,5,783,1.0,515.0,515.0
0.015,6,10,1990,5,911,3.0,643.0,643.0,5,1079,3.0,811.0,811.0
0.001,17,2,136,1,60,0.0,32.0,32.0,1,76,0.0,48.0,48.0
0.005,17,2,222,1,65,0.0,37.0,37.0,1,157,0.0,129.0,129.0
0.01,6,10,1762,5,911,2.0,643.0,643.0,5,851,2.0,583.0,583.0
0.004,6,10,1702,5,863,1.0,595.0,595.0,5,839,1.0,571.0,571.0
10.868,17,30,5335,15,2292,768.0,270.0,124.0,15,3043,768.0,1145.0,174.0
40.071,17,10,676,5,460,10014.0,104.0,64.0,5,216,10016.0,20.0,15.0
0.005,6,10,1779,5,928,1.0,660.0,660.0,5,851,1.0,583.0,583.0
0.013,6,10,1989,5,910,3.0,642.0,642.0,5,1079,3.0,811.0,811.0
0.004,6,10,2007,5,928,1.0,660.0,660.0,5,1079,1.0,811.0,811.0
0.008,17,2,140,1,62,0.0,34.0,34.0,1,78,0.0,50.0,50.0
0.005,6,10,1989,5,927,1.0,659.0,659.0,5,1062,1.0,794.0,794.0
15.33,17,47,25923,26,21257,612.0,1350.0,789.0,21,4666,765.0,1350.0,194.0
0.016,6,10,1989,5,910,3.0,642.0,642.0,5,1079,3.0,811.0,811.0
40.075,17,10,676,5,460,10016.0,104.0,64.0,5,216,10017.0,20.0,15.0
0.006,17,2,225,1,65,0.0,37.0,37.0,1,160,0.0,132.0,132.0
1797.747,17,2915,219751,1444,115767,1245.0,82.0,52.0,1471,103984,1222.0,226.0,42.0
11.176,17,28,4423,14,1995,847.0,270.0,114.0,14,2428,847.0,587.0,145.0
0.008,6,12,1926,6,1189,1.0,659.0,434.0,6,737,1.0,417.0,417.0
0.005,6,10,1774,5,923,1.0,655.0,655.0,5,851,1.0,583.0,583.0
0.008,6,12,1926,6,1189,1.0,659.0,434.0,6,737,1.0,417.0,417.0
240.04,6,9,787,5,488,60010.0,232.0,232.0,4,299,80012.0,83.0,83.0
0.021,6,10,1989,5,910,5.0,642.0,642.0,5,1079,5.0,811.0,811.0
0.005,6,14,3736,7,446,0.0,74.0,74.0,7,3290,0.0,1448.0,972.0
0.017,6,13,3735,7,497,2.0,125.0,125.0,6,3238,3.0,1470.0,1459.0
0.005,6,10,2000,5,927,1.0,659.0,659.0,5,1073,1.0,805.0,805.0
0.074,6,10,1506,5,395,15.0,127.0,127.0,5,1111,16.0,843.0,843.0
0.011,6,10,1989,5,910,2.0,642.0,642.0,5,1079,2.0,811.0,811.0
308.511,17,20,1124,10,716,34272.0,48.0,43.0,10,408,34272.0,20.0,12.0
0.006,6,10,1547,5,764,1.0,496.0,496.0,5,783,1.0,515.0,515.0
0.004,6,10,2006,5,927,1.0,659.0,659.0,5,1079,1.0,811.0,811.0
0.01,6,10,1972,5,910,2.0,642.0,642.0,5,1062,2.0,794.0,794.0
0.018,6,9,1214,5,775,4.0,519.0,519.0,4,439,4.0,223.0,223.0
0.005,6,10,2007,5,928,1.0,660.0,660.0,5,1079,1.0,811.0,811.0
292.621,6,383,348710,192,22187,1532.0,2736.0,871.0,191,326523,1540.0,2804.0,1798.0
40.069,17,10,676,5,460,10016.0,104.0,64.0,5,216,10016.0,20.0,15.0
0.076,17,2,184,1,61,0.0,33.0,33.0,1,123,0.0,95.0,95.0
0.028,17,2,162,1,65,0.0,37.0,37.0,1,97,0.0,69.0,69.0
0.011,6,10,1989,5,910,2.0,642.0,642.0,5,1079,2.0,811.0,811.0
0.009,6,10,1762,5,911,2.0,643.0,643.0,5,851,2.0,583.0,583.0
0.005,6,10,2006,5,927,1.0,659.0,659.0,5,1079,1.0,811.0,811.0
0.006,6,10,1547,5,764,1.0,496.0,496.0,5,783,1.0,515.0,515.0
241.149,6,33,10838,17,3637,15071.0,990.0,551.0,16,7201,16076.0,1593.0,636.0
0.086,6,10,1506,5,395,19.0,127.0,127.0,5,1111,20.0,843.0,843.0
0.005,6,10,1989,5,927,1.0,659.0,659.0,5,1062,1.0,794.0,794.0
0.005,6,10,2006,5,927,1.0,659.0,659.0,5,1079,1.0,811.0,811.0
0.077,6,10,1506,5,395,15.0,127.0,127.0,5,1111,17.0,843.0,843.0
15.073,17,15,9238,8,6902,2149.0,1350.0,834.0,7,2336,2507.0,1350.0,305.0
0.006,6,12,1698,6,863,1.0,327.0,271.0,6,835,1.0,515.0,515.0
0.014,6,10,1677,5,827,3.0,559.0,559.0,5,850,3.0,582.0,582.0
0.023,6,10,1990,5,911,5.0,643.0,643.0,5,1079,5.0,811.0,811.0
0.112,6,10,1506,5,395,22.0,127.0,127.0,5,1111,23.0,843.0,843.0
0.005,17,2,230,1,68,0.0,40.0,40.0,1,162,0.0,134.0,134.0
0.008,6,10,1989,5,910,2.0,642.0,642.0,5,1079,1.0,811.0,811.0
0.001,17,2,179,1,62,0.0,34.0,34.0,1,117,0.0,89.0,89.0
0.071,17,2,156,1,64,0.0,36.0,36.0,1,92,0.0,64.0,64.0
0.006,6,10,1643,5,860,1.0,592.0,592.0,5,783,1.0,515.0,515.0
0.097,6,10,1506,5,395,22.0,127.0,127.0,5,1111,21.0,843.0,843.0
0.037,17,2,152,1,76,0.0,48.0,48.0,1,76,0.0,48.0,48.0
40.083,17,10,676,5,460,10019.0,104.0,64.0,5,216,10019.0,20.0,15.0
0.037,17,2,144,1,64,0.0,36.0,36.0,1,80,0.0,52.0,52.0
0.004,17,2,148,1,60,0.0,32.0,32.0,1,88,0.0,60.0,60.0
0.007,6,10,1689,5,839,1.0,571.0,571.0,5,850,1.0,582.0,582.0
970.694,6,77,29392,39,6819,25544.0,676.0,478.0,38,22573,24612.0,1428.0,762.0
0.007,6,10,1854,5,889,1.0,621.0,621.0,5,965,1.0,697.0,697.0
0.1,6,10,1506,5,395,24.0,127.0,127.0,5,1111,21.0,843.0,843.0
0.081,6,10,1506,5,395,17.0,127.0,127.0,5,1111,19.0,843.0,843.0
0.008,6,12,1926,6,1189,1.0,659.0,434.0,6,737,1.0,417.0,417.0
0.011,6,10,1983,5,910,2.0,642.0,642.0,5,1073,2.0,805.0,805.0
0.106,6,10,1506,5,395,23.0,127.0,127.0,5,1111,22.0,843.0,843.0
0.004,17,2,136,1,60,0.0,32.0,32.0,1,76,0.0,48.0,48.0
0.006,6,10,1689,5,839,1.0,571.0,571.0,5,850,1.0,582.0,582.0
0.008,6,10,1989,5,910,2.0,642.0,642.0,5,1079,2.0,811.0,811.0
0.014,6,10,1989,5,910,3.0,642.0,642.0,5,1079,3.0,811.0,811.0
0.005,6,14,3736,7,446,0.0,74.0,74.0,7,3290,0.0,1448.0,972.0
0.004,6,10,1779,5,928,1.0,660.0,660.0,5,851,0.0,583.0,583.0
0.075,6,10,1506,5,395,17.0,127.0,127.0,5,1111,16.0,843.0,843.0
0.016,6,10,1972,5,910,4.0,642.0,642.0,5,1062,4.0,794.0,794.0
0.001,17,2,180,1,66,0.0,38.0,38.0,1,114,0.0,86.0,86.0
40.067,17,10,676,5,460,10016.0,104.0,64.0,5,216,10016.0,20.0,15.0
0.005,17,2,170,1,65,0.0,37.0,37.0,1,105,0.0,77.0,77.0
0.011,6,10,1989,5,910,2.0,642.0,642.0,5,1079,2.0,811.0,811.0
170.179,17,94,13835,47,3150,3699.0,44.0,39.0,47,10685,3699.0,279.0,199.0
0.005,6,10,2000,5,927,1.0,659.0,659.0,5,1073,1.0,805.0,805.0
0.019,6,10,1972,5,910,4.0,642.0,642.0,5,1062,4.0,794.0,794.0
0.005,6,10,2007,5,928,1.0,660.0,660.0,5,1079,1.0,811.0,811.0
40.064,17,10,676,5,460,10015.0,104.0,64.0,5,216,10014.0,20.0,15.0
0.009,6,10,1972,5,910,2.0,642.0,642.0,5,1062,2.0,794.0,794.0
0.005,6,10,2006,5,927,1.0,659.0,659.0,5,1079,1.0,811.0,811.0
0.016,6,10,1989,5,910,4.0,642.0,642.0,5,1079,3.0,811.0,811.0
0.177,6,3,453,2,321,177.0,241.0,241.0,1,132,0.0,92.0,92.0
0.005,6,10,1774,5,923,1.0,655.0,655.0,5,851,1.0,583.0,583.0
0.061,17,2,152,1,76,0.0,48.0,48.0,1,76,0.0,48.0,48.0
0.016,6,10,1990,5,911,4.0,643.0,643.0,5,1079,4.0,811.0,811.0
0.014,6,10,1990,5,911,3.0,643.0,643.0,5,1079,3.0,811.0,811.0
300.949,6,49,21015,26,15068,12037.0,2766.0,1399.0,23,5947,399.0,2667.0,385.0
0.008,6,10,1983,5,910,2.0,642.0,642.0,5,1073,2.0,805.0,805.0
0.148,6,10,1506,5,395,33.0,127.0,127.0,5,1111,33.0,843.0,843.0
0.001,17,2,180,1,66,0.0,38.0,38.0,1,114,0.0,86.0,86.0
0.01,6,10,1990,5,911,2.0,643.0,643.0,5,1079,2.0,811.0,811.0
0.007,17,2,222,1,65,0.0,37.0,37.0,1,157,0.0,129.0,129.0
0.005,6,10,1989,5,927,1.0,659.0,659.0,5,1062,1.0,794.0,794.0
0.001,17,2,180,1,66,0.0,38.0,38.0,1,114,0.0,86.0,86.0
0.005,6,10,2000,5,927,1.0,659.0,659.0,5,1073,1.0,805.0,805.0
0.007,6,10,1547,5,764,1.0,496.0,496.0,5,783,1.0,515.0,515.0
0.006,17,2,263,1,60,0.0,32.0,32.0,1,203,0.0,175.0,175.0
0.068,6,10,1506,5,395,15.0,127.0,127.0,5,1111,15.0,843.0,843.0
0.104,6,10,1506,5,395,21.0,127.0,127.0,5,1111,23.0,843.0,843.0
0.004,17,4,284,2,120,0.0,32.0,32.0,2,164,0.0,60.0,54.0
0.008,6,10,1677,5,827,2.0,559.0,559.0,5,850,2.0,582.0,582.0
0.006,6,10,1689,5,839,1.0,571.0,571.0,5,850,1.0,582.0,582.0
0.019,6,13,3735,7,497,3.0,125.0,125.0,6,3238,3.0,1470.0,1459.0
0.011,6,10,1677,5,827,2.0,559.0,559.0,5,850,2.0,582.0,582.0
40.057,17,10,676,5,460,10012.0,104.0,64.0,5,216,10013.0,20.0,15.0
0.013,6,10,1972,5,910,3.0,642.0,642.0,5,1062,3.0,794.0,794.0
0.006,17,2,212,1,74,0.0,46.0,46.0,1,138,0.0,110.0,110.0
0.104,6,10,1506,5,395,25.0,127.0,127.0,5,1111,21.0,843.0,843.0
0.009,6,10,1547,5,764,2.0,496.0,496.0,5,783,2.0,515.0,515.0
0.005,6,10,2006,5,927,1.0,659.0,659.0,5,1079,1.0,811.0,811.0
0.061,6,10,1506,5,395,13.0,127.0,127.0,5,1111,13.0,843.0,843.0
0.006,6,10,1547,5,764,1.0,496.0,496.0,5,783,1.0,515.0,515.0
0.011,6,10,1989,5,910,2.0,642.0,642.0,5,1079,2.0,811.0,811.0
0.005,6,10,2007,5,928,1.0,660.0,660.0,5,1079,1.0,811.0,811.0
0.006,6,10,1547,5,764,1.0,496.0,496.0,5,783,1.0,515.0,515.0
11.375,17,28,4422,14,1994,862.0,269.0,114.0,14,2428,862.0,587.0,145.0
0.067,6,10,1506,5,395,15.0,127.0,127.0,5,1111,15.0,843.0,843.0
0.016,6,10,1983,5,910,4.0,642.0,642.0,5,1073,4.0,805.0,805.0
0.006,6,10,1547,5,764,1.0,496.0,496.0,5,783,1.0,515.0,515.0
0.018,6,10,1990,5,911,4.0,643.0,643.0,5,1079,4.0,811.0,811.0
11.143,17,28,4422,14,1995,844.0,270.0,114.0,14,2427,844.0,586.0,145.0
0.093,6,10,1506,5,395,21.0,127.0,127.0,5,1111,19.0,843.0,843.0
0.021,6,10,1983,5,910,5.0,642.0,642.0,5,1073,5.0,805.0,805.0
0.008,6,13,3735,7,497,1.0,125.0,125.0,6,3238,1.0,1470.0,1459.0
1778.483,17,140,44240,72,22752,25048.0,288.0,288.0,68,21488,26539.0,288.0,288.0
0.001,17,2,180,1,66,0.0,38.0,38.0,1,114,0.0,86.0,86.0
0.122,6,10,1506,5,395,28.0,127.0,127.0,5,1111,28.0,843.0,843.0
1799.499,17,3133,237248,1557,125328,1156.0,84.0,52.0,1576,111920,1142.0,226.0,43.0
10.833,17,28,4416,14,1993,824.0,268.0,114.0,14,2423,824.0,586.0,145.0
0.013,6,10,1989,5,910,3.0,642.0,642.0,5,1079,3.0,811.0,811.0
0.02,6,10,1990,5,911,5.0,643.0,643.0,5,1079,4.0,811.0,811.0
0.041,17,2,186,1,61,0.0,33.0,33.0,1,125,0.0,97.0,97.0
0.012,6,10,1989,5,910,2.0,642.0,642.0,5,1079,2.0,811.0,811.0
0.007,6,10,2007,5,928,1.0,660.0,660.0,5,1079,1.0,811.0,811.0
0.006,6,10,2007,5,928,1.0,660.0,660.0,5,1079,1.0,811.0,811.0
40.078,17,10,676,5,460,10015.0,104.0,64.0,5,216,10018.0,20.0,15.0
0.068,6,10,1506,5,395,16.0,127.0,127.0,5,1111,15.0,843.0,843.0
0.007,6,10,1547,5,764,1.0,496.0,496.0,5,783,1.0,515.0,515.0
0.005,6,10,2007,5,928,1.0,660.0,660.0,5,1079,1.0,811.0,811.0
0.09,6,10,1506,5,395,21.0,127.0,127.0,5,1111,20.0,843.0,843.0
0.007,6,10,1989,5,910,1.0,642.0,642.0,5,1079,1.0,811.0,811.0
0.005,6,10,2006,5,927,1.0,659.0,659.0,5,1079,1.0,811.0,811.0
0.004,6,10,1779,5,928,1.0,660.0,660.0,5,851,1.0,583.0,583.0
0.005,17,2,180,1,66,0.0,38.0,38.0,1,114,0.0,86.0,86.0
0.004,17,2,148,1,60,0.0,32.0,32.0,1,88,0.0,60.0,60.0
0.005,6,10,1547,5,764,1.0,496.0,496.0,5,783,1.0,515.0,515.0
0.117,6,10,1506,5,395,26.0,127.0,127.0,5,1111,23.0,843.0,843.0
40.068,17,10,676,5,460,10016.0,104.0,64.0,5,216,10016.0,20.0,15.0
0.016,6,10,1762,5,911,3.0,643.0,643.0,5,851,3.0,583.0,583.0
0.006,6,10,1547,5,764,1.0,496.0,496.0,5,783,1.0,515.0,515.0
0.004,6,10,2006,5,927,1.0,659.0,659.0,5,1079,1.0,811.0,811.0
15.078,17,16,8180,8,5926,2150.0,1350.0,712.0,8,2254,2149.0,1350.0,253.0
0.011,6,10,1983,5,910,2.0,642.0,642.0,5,1073,2.0,805.0,805.0
0.009,6,12,1926,6,1189,1.0,659.0,434.0,6,737,1.0,417.0,417.0
0.005,17,2,144,1,64,0.0,36.0,36.0,1,80,0.0,52.0,52.0
0.006,6,10,1547,5,764,1.0,496.0,496.0,5,783,1.0,515.0,515.0
0.007,6,10,1689,5,839,1.0,571.0,571.0,5,850,1.0,582.0,582.0
0.012,6,10,1989,5,910,3.0,642.0,642.0,5,1079,3.0,811.0,811.0
0.005,6,10,1989,5,927,1.0,659.0,659.0,5,1062,1.0,794.0,794.0
0.006,17,2,180,1,66,0.0,38.0,38.0,1,114,0.0,86.0,86.0
0.015,6,10,1990,5,911,3.0,643.0,643.0,5,1079,3.0,811.0,811.0
0.072,17,4,284,2,120,0.0,32.0,32.0,2,164,66.0,60.0,54.0
0.005,17,2,144,1,64,0.0,36.0,36.0,1,80,0.0,52.0,52.0
0.008,6,10,1677,5,827,1.0,559.0,559.0,5,850,2.0,582.0,582.0
0.006,6,10,1547,5,764,1.0,496.0,496.0,5,783,1.0,515.0,515.0
240.269,6,41,8667,20,5634,12645.0,2883.0,573.0,21,3033,12013.0,580.0,241.0
0.005,6,14,3736,7,446,0.0,74.0,74.0,7,3290,0.0,1448.0,972.0
0.006,17,2,179,1,71,0.0,43.0,43.0,1,108,0.0,80.0,80.0
0.005,6,10,2007,5,928,1.0,660.0,660.0,5,1079,1.0,811.0,811.0
11.137,17,28,4395,14,2312,848.0,587.0,137.0,14,2083,848.0,270.0,120.0
0.089,6,10,1506,5,395,21.0,127.0,127.0,5,1111,17.0,843.0,843.0
0.002,17,2,136,1,60,0.0,32.0,32.0,1,76,0.0,48.0,48.0
0.001,17,2,142,1,63,0.0,35.0,35.0,1,79,0.0,51.0,51.0
0.001,17,2,180,1,66,0.0,38.0,38.0,1,114,0.0,86.0,86.0
168.199,17,76,10804,38,2538,4545.0,44.0,38.0,38,8266,4545.0,239.0,189.0
0.005,17,2,170,1,65,0.0,37.0,37.0,1,105,0.0,77.0,77.0
0.021,6,10,1990,5,911,5.0,643.0,643.0,5,1079,5.0,811.0,811.0
0.004,17,2,148,1,60,0.0,32.0,32.0,1,88,0.0,60.0,60.0
0.079,6,10,1506,5,395,18.0,127.0,127.0,5,1111,15.0,843.0,843.0
0.005,6,10,2007,5,928,1.0,660.0,660.0,5,1079,1.0,811.0,811.0
0.017,6,10,1631,5,848,4.0,580.0,580.0,5,783,4.0,515.0,515.0
15.076,17,16,8338,8,6154,2149.0,1350.0,741.0,8,2184,2149.0,1350.0,245.0
0.011,6,10,1990,5,911,2.0,643.0,643.0,5,1079,2.0,811.0,811.0
0.001,17,2,180,1,65,0.0,37.0,37.0,1,115,0.0,87.0,87.0
0.001,17,2,142,1,63,0.0,35.0,35.0,1,79,0.0,51.0,51.0
11.31,17,28,4423,14,1995,856.0,270.0,114.0,14,2428,856.0,587.0,145.0
0.105,6,10,1506,5,395,23.0,127.0,127.0,5,1111,23.0,843.0,843.0
0.012,6,10,1762,5,911,3.0,643.0,643.0,5,851,3.0,583.0,583.0
0.006,6,10,1779,5,928,1.0,660.0,660.0,5,851,1.0,583.0,583.0
0.112,6,10,1506,5,395,25.0,127.0,127.0,5,1111,23.0,843.0,843.0
0.011,6,10,1990,5,911,2.0,643.0,643.0,5,1079,2.0,811.0,811.0
0.015,6,10,1972,5,910,3.0,642.0,642.0,5,1062,3.0,794.0,794.0
0.08,6,10,1506,5,395,18.0,127.0,127.0,5,1111,16.0,843.0,843.0
0.001,17,2,180,1,66,0.0,38.0,38.0,1,114,0.0,86.0,86.0
0.005,6,10,1854,5,889,1.0,621.0,621.0,5,965,1.0,697.0,697.0
0.008,6,12,1926,6,1189,1.0,659.0,434.0,6,737,1.0,417.0,417.0
11.08,17,28,4398,14,2312,843.0,587.0,137.0,14,2086,843.0,269.0,121.0
0.01,6,10,1989,5,910,2.0,642.0,642.0,5,1079,2.0,811.0,811.0
0.077,6,10,1506,5,395,18.0,127.0,127.0,5,1111,16.0,843.0,843.0
0.153,6,10,1506,5,395,35.0,127.0,127.0,5,1111,35.0,843.0,843.0
0.004,6,10,2006,5,927,1.0,659.0,659.0,5,1079,1.0,811.0,811.0
0.008,6,10,1990,5,911,1.0,643.0,643.0,5,1079,2.0,811.0,811.0
0.146,6,10,1506,5,395,27.0,127.0,127.0,5,1111,30.0,843.0,843.0
0.114,6,10,1506,5,395,25.0,127.0,127.0,5,1111,24.0,843.0,843.0
0.005,17,2,214,1,75,0.0,47.0,47.0,1,139,0.0,111.0,111.0
0.005,6,10,1702,5,863,1.0,595.0,595.0,5,839,1.0,571.0,571.0
0.01,17,2,247,1,68,0.0,40.0,40.0,1,179,0.0,151.0,151.0
0.071,17,4,284,2,120,0.0,32.0,32.0,2,164,68.0,60.0,54.0
0.004,6,10,1989,5,927,1.0,659.0,659.0,5,1062,1.0,794.0,794.0
11.218,17,28,4396,14,1995,850.0,270.0,114.0,14,2401,850.0,588.0,143.0
0.01,6,10,1989,5,910,2.0,642.0,642.0,5,1079,2.0,811.0,811.0
0.184,6,10,1506,5,395,41.0,127.0,127.0,5,1111,34.0,843.0,843.0
0.008,6,14,3799,7,509,1.0,137.0,137.0,7,3290,1.0,1448.0,972.0
0.011,6,10,1990,5,911,2.0,643.0,643.0,5,1079,2.0,811.0,811.0
0.274,17,40,20542,20,16985,14.0,1350.0,821.0,20,3557,11.0,1350.0,149.0
10.916,17,28,4417,14,1994,830.0,269.0,114.0,14,2423,830.0,586.0,145.0
10.817,17,28,4421,14,1994,823.0,269.0,114.0,14,2427,823.0,586.0,145.0
0.005,6,10,1854,5,889,1.0,621.0,621.0,5,965,1.0,697.0,697.0
0.011,6,10,1989,5,910,2.0,642.0,642.0,5,1079,2.0,811.0,811.0
0.012,6,13,3735,7,497,2.0,125.0,125.0,6,3238,2.0,1470.0,1459.0
0.006,17,2,170,1,65,0.0,37.0,37.0,1,105,0.0,77.0,77.0
0.001,17,2,140,1,62,0.0,34.0,34.0,1,78,0.0,50.0,50.0
0.017,6,10,1989,5,910,4.0,642.0,642.0,5,1079,4.0,811.0,811.0
0.128,17,2,80,1,32,0.0,4.0,4.0,1,48,0.0,20.0,20.0
0.012,6,10,1989,5,910,3.0,642.0,642.0,5,1079,3.0,811.0,811.0
0.014,6,10,1972,5,910,3.0,642.0,642.0,5,1062,3.0,794.0,794.0
0.018,6,10,1972,5,910,4.0,642.0,642.0,5,1062,4.0,794.0,794.0
0.005,17,2,230,1,68,0.0,40.0,40.0,1,162,0.0,134.0,134.0
0.005,6,10,1989,5,927,1.0,659.0,659.0,5,1062,1.0,794.0,794.0
0.008,6,10,1989,5,910,2.0,642.0,642.0,5,1079,2.0,811.0,811.0
0.005,6,10,2006,5,927,1.0,659.0,659.0,5,1079,1.0,811.0,811.0
0.006,6,10,1547,5,764,1.0,496.0,496.0,5,783,1.0,515.0,515.0
40.055,17,10,676,5,460,10013.0,104.0,64.0,5,216,10013.0,20.0,15.0
0.016,17,2,170,1,65,0.0,37.0,37.0,1,105,0.0,77.0,77.0
0.05,6,20,9974,11,704,5.0,124.0,124.0,9,9270,6.0,2896.0,1758.0
40.073,17,10,676,5,460,10017.0,104.0,64.0,5,216,10017.0,20.0,15.0
1798.229,6,64,7344,42,4469,43859.0,1625.0,108.0,22,2875,85622.0,1111.0,82.0
0.012,6,10,1989,5,910,3.0,642.0,642.0,5,1079,2.0,811.0,811.0
0.071,17,2,146,1,65,0.0,37.0,37.0,1,81,0.0,53.0,53.0
40.064,17,10,676,5,460,10014.0,104.0,64.0,5,216,10015.0,20.0,15.0
0.005,17,2,424,1,72,0.0,44.0,44.0,1,352,0.0,324.0,324.0
0.006,6,10,1547,5,764,1.0,496.0,496.0,5,783,1.0,515.0,515.0
0.079,6,10,1506,5,395,16.0,127.0,127.0,5,1111,17.0,843.0,843.0
0.071,17,2,182,1,65,0.0,37.0,37.0,1,117,0.0,89.0,89.0
0.127,6,10,1506,5,395,28.0,127.0,127.0,5,1111,29.0,843.0,843.0
177.446,17,92,13066,46,3091,3943.0,44.0,39.0,46,9975,3943.0,260.0,188.0
0.011,6,10,1631,5,848,2.0,580.0,580.0,5,783,2.0,515.0,515.0
0.004,6,10,1779,5,928,1.0,660.0,660.0,5,851,1.0,583.0,583.0
0.006,6,10,1643,5,860,1.0,592.0,592.0,5,783,1.0,515.0,515.0
10.992,17,28,4421,14,1994,836.0,269.0,114.0,14,2427,836.0,586.0,145.0
0.005,6,13,3690,7,452,0.0,80.0,80.0,6,3238,0.0,1470.0,1459.0
40.062,17,10,676,5,460,10012.0,104.0,64.0,5,216,10014.0,20.0,15.0
0.086,6,10,1506,5,395,18.0,127.0,127.0,5,1111,18.0,843.0,843.0
0.039,17,2,412,1,61,0.0,33.0,33.0,1,351,0.0,323.0,323.0
0.012,6,10,1989,5,910,3.0,642.0,642.0,5,1079,3.0,811.0,811.0
0.009,6,10,2006,5,927,2.0,659.0,659.0,5,1079,2.0,811.0,811.0
0.082,6,10,1506,5,395,16.0,127.0,127.0,5,1111,17.0,843.0,843.0
0.074,6,10,1506,5,395,14.0,127.0,127.0,5,1111,16.0,843.0,843.0
0.005,6,10,1774,5,923,1.0,655.0,655.0,5,851,1.0,583.0,583.0
0.041,6,10,1983,5,910,10.0,642.0,642.0,5,1073,10.0,805.0,805.0
0.005,17,2,166,1,75,0.0,47.0,47.0,1,91,0.0,63.0,63.0
240.008,6,9,787,5,488,60002.0,232.0,232.0,4,299,80002.0,83.0,83.0
0.005,6,10,2006,5,927,1.0,659.0,659.0,5,1079,1.0,811.0,811.0
0.004,17,2,148,1,60,0.0,32.0,32.0,1,88,0.0,60.0,60.0
0.028,6,10,1989,5,910,7.0,642.0,642.0,5,1079,6.0,811.0,811.0
0.143,6,10,1506,5,395,33.0,127.0,127.0,5,1111,32.0,843.0,843.0
0.005,17,2,203,1,61,0.0,33.0,33.0,1,142,0.0,114.0,114.0
0.004,6,10,1989,5,927,1.0,659.0,659.0,5,1062,1.0,794.0,794.0
0.083,6,10,1506,5,395,19.0,127.0,127.0,5,1111,18.0,843.0,843.0
300.283,6,16,2170,9,684,37514.0,146.0,146.0,7,1486,50018.0,419.0,398.0
0.004,6,10,1989,5,927,1.0,659.0,659.0,5,1062,1.0,794.0,794.0
0.015,6,14,3787,7,497,2.0,125.0,125.0,7,3290,2.0,1448.0,972.0
0.065,6,10,1506,5,395,13.0,127.0,127.0,5,1111,14.0,843.0,843.0
40.079,17,10,676,5,460,10016.0,104.0,64.0,5,216,10017.0,20.0,15.0
15.081,17,18,9103,9,6460,1881.0,1350.0,689.0,9,2643,1881.0,1350.0,265.0
0.01,6,10,1989,5,910,2.0,642.0,642.0,5,1079,2.0,811.0,811.0
0.012,6,10,1989,5,910,3.0,642.0,642.0,5,1079,2.0,811.0,811.0
15.073,17,15,8187,8,6119,2149.0,1350.0,736.0,7,2068,2507.0,1350.0,267.0
240.1,6,16,4482,9,963,30012.0,238.0,166.0,7,3519,40016.0,1402.0,786.0
0.021,6,10,1990,5,911,5.0,643.0,643.0,5,1079,5.0,811.0,811.0
40.054,17,10,676,5,460,10012.0,104.0,64.0,5,216,10012.0,20.0,15.0
40.059,17,10,676,5,460,10013.0,104.0,64.0,5,216,10013.0,20.0,15.0
0.006,6,10,1547,5,764,1.0,496.0,496.0,5,783,1.0,515.0,515.0
15.068,17,15,9238,8,6902,2148.0,1350.0,834.0,7,2336,2506.0,1350.0,305.0
0.004,6,10,2000,5,927,1.0,659.0,659.0,5,1073,1.0,805.0,805.0
240.091,6,16,4481,9,963,30011.0,238.0,166.0,7,3518,40014.0,1402.0,786.0
0.01,6,10,1972,5,910,2.0,642.0,642.0,5,1062,2.0,794.0,794.0
0.008,6,12,1926,6,1189,1.0,659.0,434.0,6,737,1.0,417.0,417.0
0.012,6,10,1972,5,910,3.0,642.0,642.0,5,1062,3.0,794.0,794.0
15.071,17,15,9238,8,6902,2149.0,1350.0,834.0,7,2336,2507.0,1350.0,305.0
0.004,17,4,284,2,120,1.0,32.0,32.0,2,164,1.0,60.0,54.0
0.016,6,14,3787,7,497,2.0,125.0,125.0,7,3290,2.0,1448.0,972.0
0.002,17,2,148,1,60,0.0,32.0,32.0,1,88,0.0,60.0,60.0
170.021,17,82,11589,41,2728,4250.0,44.0,38.0,41,8861,4250.0,239.0,188.0
0.126,17,2,182,1,65,0.0,37.0,37.0,1,117,0.0,89.0,89.0
0.008,6,10,1989,5,910,2.0,642.0,642.0,5,1079,2.0,811.0,811.0
242.295,6,368,347225,184,21088,1324.0,2736.0,959.0,184,326137,1324.0,2804.0,1819.0
0.009,6,10,1983,5,910,2.0,642.0,642.0,5,1073,2.0,805.0,805.0
0.014,6,10,1989,5,910,3.0,642.0,642.0,5,1079,3.0,811.0,811.0
0.004,6,10,1774,5,923,1.0,655.0,655.0,5,851,1.0,583.0,583.0
0.162,6,10,1506,5,395,21.0,127.0,127.0,5,1111,37.0,843.0,843.0
240.089,6,31,9111,15,6620,17149.0,1744.0,649.0,16,2491,16005.0,580.0,206.0
376.253,6,22,2313,16,867,25083.0,195.0,195.0,6,1446,4639.0,419.0,398.0
0.006,17,2,179,1,71,0.0,43.0,43.0,1,108,0.0,80.0,80.0
0.101,6,10,1506,5,395,22.0,127.0,127.0,5,1111,19.0,843.0,843.0
10.811,17,28,4418,14,1995,822.0,270.0,114.0,14,2423,822.0,586.0,145.0
0.009,6,10,1989,5,910,2.0,642.0,642.0,5,1079,2.0,811.0,811.0
0.158,6,10,1506,5,395,35.0,127.0,127.0,5,1111,30.0,843.0,843.0
0.003,17,2,148,1,60,0.0,32.0,32.0,1,88,0.0,60.0,60.0
0.006,6,10,1547,5,764,1.0,496.0,496.0,5,783,1.0,515.0,515.0
0.097,6,10,1506,5,395,21.0,127.0,127.0,5,1111,21.0,843.0,843.0
0.011,6,10,1762,5,911,2.0,643.0,643.0,5,851,2.0,583.0,583.0
0.018,6,10,1762,5,911,4.0,643.0,643.0,5,851,4.0,583.0,583.0
1777.839,17,144,45504,72,22752,25039.0,288.0,288.0,72,22752,25039.0,288.0,288.0
0.07,6,10,1506,5,395,14.0,127.0,127.0,5,1111,16.0,843.0,843.0
0.007,17,2,194,1,59,0.0,31.0,31.0,1,135,0.0,107.0,107.0
0.021,6,10,1677,5,827,5.0,559.0,559.0,5,850,5.0,582.0,582.0
0.098,6,10,1506,5,395,21.0,127.0,127.0,5,1111,17.0,843.0,843.0
0.009,6,13,3735,7,497,1.0,125.0,125.0,6,3238,1.0,1470.0,1459.0
0.795,6,10,2009,6,1655,159.0,1403.0,1403.0,4,354,188.0,182.0,182.0
0.01,6,14,3787,7,497,1.0,125.0,125.0,7,3290,1.0,1448.0,972.0
0.009,6,10,1983,5,910,2.0,642.0,642.0,5,1073,2.0,805.0,805.0
0.04,17,2,136,1,60,0.0,32.0,32.0,1,76,0.0,48.0,48.0
0.001,17,2,180,1,66,0.0,38.0,38.0,1,114,0.0,86.0,86.0
0.004,6,10,2000,5,927,1.0,659.0,659.0,5,1073,1.0,805.0,805.0
0.013,6,10,1990,5,911,3.0,643.0,643.0,5,1079,3.0,811.0,811.0
0.088,6,10,1990,5,911,22.0,643.0,643.0,5,1079,21.0,811.0,811.0
0.006,6,13,3747,7,509,0.0,137.0,137.0,6,3238,1.0,1470.0,1459.0
0.013,6,10,1983,5,910,3.0,642.0,642.0,5,1073,3.0,805.0,805.0
0.006,6,10,1547,5,764,1.0,496.0,496.0,5,783,1.0,515.0,515.0
40.067,17,10,676,5,460,10014.0,104.0,64.0,5,216,10016.0,20.0,15.0
0.134,6,10,1506,5,395,32.0,127.0,127.0,5,1111,32.0,843.0,843.0
0.101,6,10,1506,5,395,23.0,127.0,127.0,5,1111,18.0,843.0,843.0
0.015,6,10,1762,5,911,3.0,643.0,643.0,5,851,3.0,583.0,583.0
0.102,6,10,1506,5,395,20.0,127.0,127.0,5,1111,24.0,843.0,843.0
10.8,17,28,4422,14,1995,822.0,270.0,114.0,14,2427,822.0,586.0,145.0
0.009,6,10,1972,5,910,2.0,642.0,642.0,5,1062,2.0,794.0,794.0
0.004,6,10,1989,5,927,1.0,659.0,659.0,5,1062,1.0,794.0,794.0
308.773,17,20,1124,10,716,34293.0,48.0,43.0,10,408,34293.0,20.0,12.0
0.006,6,10,1854,5,889,1.0,621.0,621.0,5,965,1.0,697.0,697.0
40.08,17,10,676,5,460,10015.0,104.0,64.0,5,216,10017.0,20.0,15.0
0.084,6,10,1506,5,395,18.0,127.0,127.0,5,1111,18.0,843.0,843.0
0.134,17,2,80,1,32,0.0,4.0,4.0,1,48,0.0,20.0,20.0
11.095,17,28,4422,14,1994,841.0,269.0,114.0,14,2428,841.0,587.0,145.0
40.099,17,10,676,5,460,10018.0,104.0,64.0,5,216,10020.0,20.0,15.0
0.011,6,10,1990,5,911,2.0,643.0,643.0,5,1079,2.0,811.0,811.0
0.005,6,10,2006,5,927,1.0,659.0,659.0,5,1079,1.0,811.0,811.0
0.005,6,10,1547,5,764,1.0,496.0,496.0,5,783,1.0,515.0,515.0
0.004,17,4,284,2,120,0.0,32.0,32.0,2,164,0.0,60.0,54.0
0.053,17,2,152,1,76,0.0,48.0,48.0,1,76,0.0,48.0,48.0
0.008,17,2,194,1,59,0.0,31.0,31.0,1,135,0.0,107.0,107.0
0.053,17,2,152,1,76,0.0,48.0,48.0,1,76,0.0,48.0,48.0
0.01,6,10,1983,5,910,2.0,642.0,642.0,5,1073,2.0,805.0,805.0
240.093,6,33,9352,17,6987,15005.0,1368.0,555.0,16,2365,16006.0,580.0,190.0
300.347,6,16,2170,9,684,37522.0,146.0,146.0,7,1486,50030.0,419.0,398.0
0.082,6,10,1506,5,395,17.0,127.0,127.0,5,1111,18.0,843.0,843.0
0.041,17,4,284,2,120,1.0,32.0,32.0,2,164,35.0,60.0,54.0
0.069,6,10,1506,5,395,14.0,127.0,127.0,5,1111,15.0,843.0,843.0
0.006,6,10,1854,5,889,1.0,621.0,621.0,5,965,1.0,697.0,697.0
0.005,17,2,170,1,65,0.0,37.0,37.0,1,105,0.0,77.0,77.0
0.039,17,2,169,1,62,0.0,34.0,34.0,1,107,0.0,79.0,79.0
0.085,6,10,1506,5,395,18.0,127.0,127.0,5,1111,20.0,843.0,843.0
0.005,6,10,1989,5,927,1.0,659.0,659.0,5,1062,1.0,794.0,794.0
0.005,6,10,2006,5,927,1.0,659.0,659.0,5,1079,1.0,811.0,811.0
0.022,6,10,1989,5,910,5.0,642.0,642.0,5,1079,5.0,811.0,811.0
0.005,17,2,225,1,65,0.0,37.0,37.0,1,160,0.0,132.0,132.0
0.015,17,4,284,2,120,0.0,32.0,32.0,2,164,0.0,60.0,54.0
0.005,6,10,1774,5,923,1.0,655.0,655.0,5,851,1.0,583.0,583.0
0.091,6,10,1506,5,395,20.0,127.0,127.0,5,1111,19.0,843.0,843.0
0.01,17,2,170,1,65,0.0,37.0,37.0,1,105,0.0,77.0,77.0
0.116,6,10,1506,5,395,26.0,127.0,127.0,5,1111,25.0,843.0,843.0
0.012,6,10,1972,5,910,3.0,642.0,642.0,5,1062,2.0,794.0,794.0
0.124,6,10,1506,5,395,26.0,127.0,127.0,5,1111,27.0,843.0,843.0
0.017,6,10,1972,5,910,4.0,642.0,642.0,5,1062,4.0,794.0,794.0
0.111,6,10,1506,5,395,20.0,127.0,127.0,5,1111,27.0,843.0,843.0
369.048,6,22,2313,16,867,24603.0,195.0,195.0,6,1446,4643.0,419.0,398.0
0.03,6,10,1972,5,910,7.0,642.0,642.0,5,1062,7.0,794.0,794.0
356.619,6,21,1795,16,1030,23774.0,190.0,190.0,5,765,60003.0,464.0,248.0
0.005,17,2,230,1,68,0.0,40.0,40.0,1,162,0.0,134.0,134.0
308.491,17,20,1124,10,716,34263.0,48.0,43.0,10,408,34263.0,20.0,12.0
0.005,6,10,1989,5,927,1.0,659.0,659.0,5,1062,1.0,794.0,794.0
0.131,6,10,1506,5,395,31.0,127.0,127.0,5,1111,29.0,843.0,843.0
0.021,6,10,1990,5,911,5.0,643.0,643.0,5,1079,5.0,811.0,811.0
11.198,17,28,4422,14,1994,849.0,269.0,114.0,14,2428,849.0,587.0,145.0
0.255,17,45,24556,24,21172,11.0,1350.0,854.0,21,3384,10.0,1350.0,133.0
0.006,6,10,1547,5,764,1.0,496.0,496.0,5,783,1.0,515.0,515.0
0.024,6,10,1972,5,910,5.0,642.0,642.0,5,1062,6.0,794.0,794.0
0.006,6,10,1547,5,764,1.0,496.0,496.0,5,783,1.0,515.0,515.0
0.004,6,10,1989,5,927,1.0,659.0,659.0,5,1062,1.0,794.0,794.0
0.005,6,10,1547,5,764,1.0,496.0,496.0,5,783,1.0,515.0,515.0
0.006,6,10,1547,5,764,1.0,496.0,496.0,5,783,1.0,515.0,515.0
10.997,17,28,4418,14,1993,837.0,268.0,114.0,14,2425,837.0,588.0,145.0
0.013,6,10,1990,5,911,3.0,643.0,643.0,5,1079,3.0,811.0,811.0
0.098,6,10,1506,5,395,22.0,127.0,127.0,5,1111,22.0,843.0,843.0
15.129,17,19,9474,9,7305,1886.0,1350.0,783.0,10,2169,1677.0,1350.0,188.0
0.004,6,10,1989,5,927,1.0,659.0,659.0,5,1062,1.0,794.0,794.0
0.016,6,10,1989,5,910,4.0,642.0,642.0,5,1079,4.0,811.0,811.0
0.005,6,10,1689,5,839,1.0,571.0,571.0,5,850,1.0,582.0,582.0
0.006,6,10,1689,5,839,1.0,571.0,571.0,5,850,1.0,582.0,582.0
0.001,17,2,180,1,66,0.0,38.0,38.0,1,114,0.0,86.0,86.0
0.06,17,2,80,1,32,0.0,4.0,4.0,1,48,0.0,20.0,20.0
0.004,17,2,170,1,65,0.0,37.0,37.0,1,105,0.0,77.0,77.0
0.017,6,10,1989,5,910,4.0,642.0,642.0,5,1079,4.0,811.0,811.0
0.001,17,2,180,1,66,0.0,38.0,38.0,1,114,0.0,86.0,86.0
0.008,6,10,1989,5,910,1.0,642.0,642.0,5,1079,2.0,811.0,811.0
0.081,6,10,1506,5,395,17.0,127.0,127.0,5,1111,16.0,843.0,843.0
0.01,6,10,1990,5,911,2.0,643.0,643.0,5,1079,2.0,811.0,811.0
0.005,6,10,1854,5,889,1.0,621.0,621.0,5,965,1.0,697.0,697.0
300.396,6,16,2170,9,684,37528.0,146.0,146.0,7,1486,50037.0,419.0,398.0
0.005,6,10,1989,5,927,1.0,659.0,659.0,5,1062,1.0,794.0,794.0
0.015,6,10,1631,5,848,3.0,580.0,580.0,5,783,3.0,515.0,515.0
0.011,6,10,1972,5,910,2.0,642.0,642.0,5,1062,2.0,794.0,794.0
0.183,6,10,1506,5,395,38.0,127.0,127.0,5,1111,29.0,843.0,843.0
0.079,6,10,1506,5,395,15.0,127.0,127.0,5,1111,19.0,843.0,843.0
0.084,6,10,1506,5,395,19.0,127.0,127.0,5,1111,19.0,843.0,843.0
0.005,6,10,1779,5,928,1.0,660.0,660.0,5,851,1.0,583.0,583.0
240.097,6,16,4481,9,963,30012.0,238.0,166.0,7,3518,40015.0,1402.0,786.0
0.005,6,10,1779,5,928,1.0,660.0,660.0,5,851,1.0,583.0,583.0
0.004,17,2,170,1,65,0.0,37.0,37.0,1,105,0.0,77.0,77.0
0.009,6,10,1983,5,910,2.0,642.0,642.0,5,1073,2.0,805.0,805.0
0.005,6,14,3799,7,509,0.0,137.0,137.0,7,3290,0.0,1448.0,972.0
80.423,6,30,14649,15,6772,81.0,2720.0,1021.0,15,7877,5732.0,2596.0,908.0
0.131,17,2,412,1,61,0.0,33.0,33.0,1,351,0.0,323.0,323.0
0.005,6,10,2000,5,927,1.0,659.0,659.0,5,1073,1.0,805.0,805.0
0.078,6,10,1506,5,395,17.0,127.0,127.0,5,1111,18.0,843.0,843.0
293.415,6,40,10443,15,7063,20958.0,2188.0,698.0,25,3380,12225.0,580.0,129.0
0.005,17,2,170,1,65,0.0,37.0,37.0,1,105,0.0,77.0,77.0
0.006,17,2,179,1,71,0.0,43.0,43.0,1,108,0.0,80.0,80.0
0.006,6,10,2000,5,927,1.0,659.0,659.0,5,1073,1.0,805.0,805.0
0.17,17,2,152,1,76,0.0,48.0,48.0,1,76,0.0,48.0,48.0
0.005,6,10,2006,5,927,1.0,659.0,659.0,5,1079,1.0,811.0,811.0
0.128,6,10,1506,5,395,29.0,127.0,127.0,5,1111,29.0,843.0,843.0
0.006,6,10,1547,5,764,1.0,496.0,496.0,5,783,1.0,515.0,515.0
0.042,17,4,420,2,122,0.0,33.0,33.0,2,298,38.0,145.0,121.0
0.066,6,10,1506,5,395,14.0,127.0,127.0,5,1111,15.0,843.0,843.0
0.096,6,10,1506,5,395,20.0,127.0,127.0,5,1111,21.0,843.0,843.0
0.006,6,10,1689,5,839,1.0,571.0,571.0,5,850,1.0,582.0,582.0
0.006,6,10,1547,5,764,1.0,496.0,496.0,5,783,1.0,515.0,515.0
0.005,6,10,2006,5,927,1.0,659.0,659.0,5,1079,1.0,811.0,811.0
0.017,6,10,1989,5,910,4.0,642.0,642.0,5,1079,4.0,811.0,811.0
0.074,6,10,1506,5,395,16.0,127.0,127.0,5,1111,16.0,843.0,843.0
0.008,6,12,1926,6,1189,1.0,659.0,434.0,6,737,1.0,417.0,417.0
0.005,17,2,214,1,75,0.0,47.0,47.0,1,139,0.0,111.0,111.0
0.006,17,2,180,1,66,0.0,38.0,38.0,1,114,0.0,86.0,86.0
0.013,6,10,1677,5,827,3.0,559.0,559.0,5,850,3.0,582.0,582.0
0.01,6,10,1631,5,848,2.0,580.0,580.0,5,783,2.0,515.0,515.0
0.004,6,10,1702,5,863,1.0,595.0,595.0,5,839,0.0,571.0,571.0
0.085,6,10,1506,5,395,18.0,127.0,127.0,5,1111,18.0,843.0,843.0
0.01,6,10,1631,5,848,2.0,580.0,580.0,5,783,2.0,515.0,515.0
0.005,6,14,3742,7,452,0.0,80.0,80.0,7,3290,0.0,1448.0,972.0
0.047,17,4,596,2,122,1.0,33.0,33.0,2,474,3.0,323.0,209.0
0.005,17,2,169,1,62,0.0,34.0,34.0,1,107,0.0,79.0,79.0
0.099,6,10,1506,5,395,19.0,127.0,127.0,5,1111,23.0,843.0,843.0
0.018,6,10,1990,5,911,4.0,643.0,643.0,5,1079,4.0,811.0,811.0
0.006,6,10,2006,5,927,1.0,659.0,659.0,5,1079,1.0,811.0,811.0
0.007,6,10,1983,5,910,1.0,642.0,642.0,5,1073,1.0,805.0,805.0
289.531,6,410,349637,194,21644,1500.0,2736.0,888.0,216,327993,1346.0,2804.0,1568.0
0.006,6,10,2000,5,927,1.0,659.0,659.0,5,1073,1.0,805.0,805.0
0.009,6,10,1677,5,827,2.0,559.0,559.0,5,850,2.0,582.0,582.0
0.008,6,10,1989,5,910,2.0,642.0,642.0,5,1079,2.0,811.0,811.0
10.904,17,28,4422,14,1995,829.0,270.0,114.0,14,2427,829.0,586.0,145.0
0.077,6,10,1506,5,395,17.0,127.0,127.0,5,1111,16.0,843.0,843.0
0.125,6,10,1506,5,395,27.0,127.0,127.0,5,1111,26.0,843.0,843.0
0.006,6,10,1643,5,860,1.0,592.0,592.0,5,783,1.0,515.0,515.0
0.15,6,10,1506,5,395,33.0,127.0,127.0,5,1111,33.0,843.0,843.0
0.001,17,2,180,1,66,0.0,38.0,38.0,1,114,0.0,86.0,86.0
40.061,17,10,676,5,460,10013.0,104.0,64.0,5,216,10014.0,20.0,15.0
11.178,17,28,4423,14,1995,847.0,270.0,114.0,14,2428,847.0,587.0,145.0
0.094,6,10,1506,5,395,20.0,127.0,127.0,5,1111,19.0,843.0,843.0
0.002,17,2,434,1,72,0.0,44.0,44.0,1,362,0.0,334.0,334.0
290.021,6,387,347607,204,22174,1428.0,2736.0,889.0,183,325433,1593.0,2804.0,1880.0
40.06,17,10,676,5,460,10012.0,104.0,64.0,5,216,10014.0,20.0,15.0
0.016,6,10,1990,5,911,4.0,643.0,643.0,5,1079,3.0,811.0,811.0
0.072,6,10,1506,5,395,14.0,127.0,127.0,5,1111,16.0,843.0,843.0
0.004,17,2,136,1,60,0.0,32.0,32.0,1,76,0.0,48.0,48.0
0.109,6,10,1506,5,395,24.0,127.0,127.0,5,1111,23.0,843.0,843.0
0.001,17,2,136,1,60,0.0,32.0,32.0,1,76,0.0,48.0,48.0
0.005,6,10,2007,5,928,1.0,660.0,660.0,5,1079,1.0,811.0,811.0
0.004,6,10,2006,5,927,1.0,659.0,659.0,5,1079,1.0,811.0,811.0
0.201,17,17,8444,9,6034,25.0,1350.0,642.0,8,2410,19.0,1350.0,273.0
0.005,6,10,1702,5,863,1.0,595.0,595.0,5,839,1.0,571.0,571.0
0.162,6,10,1506,5,395,39.0,127.0,127.0,5,1111,37.0,843.0,843.0
0.005,6,14,3799,7,509,0.0,137.0,137.0,7,3290,0.0,1448.0,972.0
0.009,6,10,1989,5,910,2.0,642.0,642.0,5,1079,2.0,811.0,811.0
0.166,17,2,152,1,76,0.0,48.0,48.0,1,76,0.0,48.0,48.0
0.013,6,10,1990,5,911,3.0,643.0,643.0,5,1079,3.0,811.0,811.0
0.079,6,10,1506,5,395,16.0,127.0,127.0,5,1111,15.0,843.0,843.0
168.313,17,96,13300,48,3214,3581.0,44.0,38.0,48,10086,3581.0,239.0,182.0
0.006,6,10,2007,5,928,1.0,660.0,660.0,5,1079,1.0,811.0,811.0
240.024,6,9,787,5,488,60006.0,232.0,232.0,4,299,80007.0,83.0,83.0
0.008,6,10,1990,5,911,2.0,643.0,643.0,5,1079,2.0,811.0,811.0
0.004,6,10,2006,5,927,1.0,659.0,659.0,5,1079,1.0,811.0,811.0
0.006,6,13,3690,7,452,0.0,80.0,80.0,6,3238,1.0,1470.0,1459.0
0.005,6,10,1989,5,927,1.0,659.0,659.0,5,1062,1.0,794.0,794.0
0.014,6,10,1983,5,910,3.0,642.0,642.0,5,1073,3.0,805.0,805.0
0.008,6,10,1972,5,910,1.0,642.0,642.0,5,1062,2.0,794.0,794.0
0.018,6,10,1972,5,910,4.0,642.0,642.0,5,1062,4.0,794.0,794.0
0.013,6,10,1989,5,910,3.0,642.0,642.0,5,1079,3.0,811.0,811.0
0.009,6,10,1983,5,910,2.0,642.0,642.0,5,1073,2.0,805.0,805.0
0.013,6,10,1989,5,910,3.0,642.0,642.0,5,1079,3.0,811.0,811.0
40.058,17,10,676,5,460,10013.0,104.0,64.0,5,216,10013.0,20.0,15.0
0.014,6,10,1983,5,910,3.0,642.0,642.0,5,1073,3.0,805.0,805.0
0.004,6,10,1702,5,863,1.0,595.0,595.0,5,839,1.0,571.0,571.0
312.879,17,20,1124,10,716,34750.0,48.0,43.0,10,408,34750.0,20.0,12.0
0.004,6,10,2006,5,927,1.0,659.0,659.0,5,1079,1.0,811.0,811.0
0.107,6,10,1506,5,395,25.0,127.0,127.0,5,1111,23.0,843.0,843.0
0.012,6,10,1631,5,848,3.0,580.0,580.0,5,783,2.0,515.0,515.0
0.042,17,4,284,2,120,0.0,32.0,32.0,2,164,33.0,60.0,54.0
0.174,6,29,8702,16,2423,11.0,660.0,318.0,13,6279,14.0,1402.0,699.0
0.108,6,10,1506,5,395,23.0,127.0,127.0,5,1111,21.0,843.0,843.0
0.006,17,2,164,1,74,0.0,46.0,46.0,1,90,0.0,62.0,62.0
0.013,6,10,1983,5,910,3.0,642.0,642.0,5,1073,3.0,805.0,805.0
40.056,17,10,676,5,460,10012.0,104.0,64.0,5,216,10013.0,20.0,15.0
0.091,6,10,1506,5,395,21.0,127.0,127.0,5,1111,20.0,843.0,843.0
0.036,6,20,9974,11,704,3.0,124.0,124.0,9,9270,4.0,2896.0,1758.0
40.064,17,10,676,5,460,10013.0,104.0,64.0,5,216,10015.0,20.0,15.0
0.129,17,2,80,1,32,0.0,4.0,4.0,1,48,0.0,20.0,20.0
361.801,6,21,1793,16,1030,24120.0,190.0,190.0,5,763,60010.0,462.0,247.0
0.005,6,10,1643,5,860,1.0,592.0,592.0,5,783,1.0,515.0,515.0
10.949,17,28,4422,14,1994,833.0,269.0,114.0,14,2428,833.0,587.0,145.0
0.004,6,10,2006,5,927,1.0,659.0,659.0,5,1079,1.0,811.0,811.0
0.016,6,10,1983,5,910,3.0,642.0,642.0,5,1073,3.0,805.0,805.0
159.524,17,82,11759,41,2734,3987.0,44.0,38.0,41,9025,3988.0,239.0,192.0
0.006,6,10,1689,5,839,1.0,571.0,571.0,5,850,1.0,582.0,582.0
0.015,6,10,1989,5,910,3.0,642.0,642.0,5,1079,3.0,811.0,811.0
0.008,17,2,148,1,60,0.0,32.0,32.0,1,88,0.0,60.0,60.0
0.139,6,10,1506,5,395,31.0,127.0,127.0,5,1111,28.0,843.0,843.0
0.06,6,10,1506,5,395,13.0,127.0,127.0,5,1111,12.0,843.0,843.0
0.025,17,2,179,1,71,0.0,43.0,43.0,1,108,0.0,80.0,80.0
0.033,6,13,3735,7,497,5.0,125.0,125.0,6,3238,6.0,1470.0,1459.0
0.007,17,2,194,1,59,0.0,31.0,31.0,1,135,0.0,107.0,107.0
0.003,17,2,148,1,60,0.0,32.0,32.0,1,88,0.0,60.0,60.0
0.014,6,10,1989,5,910,3.0,642.0,642.0,5,1079,3.0,811.0,811.0
0.001,17,2,166,1,75,0.0,47.0,47.0,1,91,0.0,63.0,63.0
40.067,17,10,676,5,460,10015.0,104.0,64.0,5,216,10015.0,20.0,15.0
0.004,17,4,284,2,120,0.0,32.0,32.0,2,164,0.0,60.0,54.0
0.051,6,19,9922,11,704,5.0,124.0,124.0,8,9218,7.0,2896.0,2198.0
0.003,17,2,136,1,60,0.0,32.0,32.0,1,76,0.0,48.0,48.0
1757.239,6,553,188313,274,162575,6436.0,2883.0,927.0,279,25738,6320.0,381.0,113.0
0.085,6,10,1506,5,395,19.0,127.0,127.0,5,1111,17.0,843.0,843.0
0.02,6,10,1989,5,910,4.0,642.0,642.0,5,1079,4.0,811.0,811.0
240.096,6,16,4481,9,963,30012.0,238.0,166.0,7,3518,40015.0,1402.0,786.0
0.004,6,10,2006,5,927,1.0,659.0,659.0,5,1079,1.0,811.0,811.0
0.006,6,13,3684,7,446,0.0,74.0,74.0,6,3238,1.0,1470.0,1459.0
203.194,6,37,17749,21,9538,1969.0,1360.0,866.0,16,8211,13534.0,2720.0,944.0
0.006,17,2,179,1,71,0.0,43.0,43.0,1,108,0.0,80.0,80.0
0.014,6,10,1547,5,764,3.0,496.0,496.0,5,783,3.0,515.0,515.0
0.098,6,10,1506,5,395,22.0,127.0,127.0,5,1111,19.0,843.0,843.0
0.006,6,10,1547,5,764,1.0,496.0,496.0,5,783,1.0,515.0,515.0
0.008,6,10,1983,5,910,2.0,642.0,642.0,5,1073,2.0,805.0,805.0
0.001,17,2,136,1,60,0.0,32.0,32.0,1,76,0.0,48.0,48.0
0.158,6,10,1506,5,395,30.0,127.0,127.0,5,1111,28.0,843.0,843.0
0.005,6,10,2007,5,928,1.0,660.0,660.0,5,1079,1.0,811.0,811.0
0.007,6,10,1547,5,764,1.0,496.0,496.0,5,783,1.0,515.0,515.0
0.006,6,10,1547,5,764,1.0,496.0,496.0,5,783,1.0,515.0,515.0
0.082,6,10,1506,5,395,18.0,127.0,127.0,5,1111,19.0,843.0,843.0
0.119,6,10,1506,5,395,27.0,127.0,127.0,5,1111,25.0,843.0,843.0
0.005,6,10,1689,5,839,1.0,571.0,571.0,5,850,1.0,582.0,582.0
0.001,17,2,142,1,63,0.0,35.0,35.0,1,79,0.0,51.0,51.0
0.005,17,2,140,1,62,0.0,34.0,34.0,1,78,0.0,50.0,50.0
240.089,6,16,4481,9,963,30011.0,238.0,166.0,7,3518,40014.0,1402.0,786.0
0.062,6,10,1506,5,395,13.0,127.0,127.0,5,1111,15.0,843.0,843.0
9.037,17,6,376,5,280,2259.0,28.0,28.0,1,96,0.0,68.0,68.0
361.807,6,19,1689,15,978,25843.0,190.0,190.0,4,711,80014.0,495.0,495.0
0.006,6,10,1643,5,860,1.0,592.0,592.0,5,783,1.0,515.0,515.0
0.005,6,10,2006,5,927,1.0,659.0,659.0,5,1079,1.0,811.0,811.0
0.109,6,10,1506,5,395,22.0,127.0,127.0,5,1111,25.0,843.0,843.0
0.003,17,2,136,1,60,0.0,32.0,32.0,1,76,0.0,48.0,48.0
0.037,17,2,148,1,60,0.0,32.0,32.0,1,88,0.0,60.0,60.0
40.068,17,10,676,5,460,10015.0,104.0,64.0,5,216,10016.0,20.0,15.0
1772.021,6,105,6270,60,3525,30033.0,27.0,27.0,45,2745,40272.0,27.0,27.0
1729.218,6,60,4400,40,2740,44338.0,33.0,33.0,20,1660,91002.0,31.0,31.0
0.005,6,10,1774,5,923,1.0,655.0,655.0,5,851,1.0,583.0,583.0
0.005,6,10,1689,5,839,1.0,571.0,571.0,5,850,1.0,582.0,582.0
0.217,6,16,2777,8,1395,31.0,533.0,323.0,8,1382,20.0,529.0,239.0
0.862,6,10,2009,6,1655,172.0,1403.0,1403.0,4,354,208.0,182.0,182.0
10.813,17,28,4417,14,1993,823.0,268.0,114.0,14,2424,823.0,587.0,145.0
0.005,6,14,3736,7,446,0.0,74.0,74.0,7,3290,0.0,1448.0,972.0
0.005,6,14,3742,7,452,0.0,80.0,80.0,7,3290,0.0,1448.0,972.0
312.218,17,20,1124,10,716,34676.0,48.0,43.0,10,408,34676.0,20.0,12.0
264.329,6,36,9604,15,6680,18880.0,1805.0,656.0,21,2924,13216.0,580.0,152.0
0.004,6,10,2007,5,928,1.0,660.0,660.0,5,1079,1.0,811.0,811.0
0.054,17,2,152,1,76,0.0,48.0,48.0,1,76,0.0,48.0,48.0
0.012,6,10,1762,5,911,3.0,643.0,643.0,5,851,3.0,583.0,583.0
0.004,6,10,1702,5,863,1.0,595.0,595.0,5,839,0.0,571.0,571.0
0.006,17,2,230,1,68,0.0,40.0,40.0,1,162,0.0,134.0,134.0
0.006,6,10,1547,5,764,1.0,496.0,496.0,5,783,1.0,515.0,515.0
40.073,17,10,676,5,460,10015.0,104.0,64.0,5,216,10017.0,20.0,15.0
0.042,17,2,184,1,61,0.0,33.0,33.0,1,123,0.0,95.0,95.0
0.008,6,10,1972,5,910,2.0,642.0,642.0,5,1062,2.0,794.0,794.0
0.009,6,10,1989,5,910,2.0,642.0,642.0,5,1079,2.0,811.0,811.0
0.129,6,10,1506,5,395,29.0,127.0,127.0,5,1111,27.0,843.0,843.0
0.006,6,10,1547,5,764,1.0,496.0,496.0,5,783,1.0,515.0,515.0
0.004,6,10,2006,5,927,1.0,659.0,659.0,5,1079,1.0,811.0,811.0
0.009,6,12,1926,6,1189,1.0,659.0,434.0,6,737,1.0,417.0,417.0
0.005,6,10,2006,5,927,1.0,659.0,659.0,5,1079,1.0,811.0,811.0
0.133,6,10,1506,5,395,30.0,127.0,127.0,5,1111,30.0,843.0,843.0
0.012,6,13,3735,7,497,1.0,125.0,125.0,6,3238,2.0,1470.0,1459.0
0.018,6,10,1762,5,911,4.0,643.0,643.0,5,851,4.0,583.0,583.0
0.004,6,10,2006,5,927,1.0,659.0,659.0,5,1079,1.0,811.0,811.0
0.022,6,10,1762,5,911,5.0,643.0,643.0,5,851,5.0,583.0,583.0
0.006,6,10,1547,5,764,1.0,496.0,496.0,5,783,1.0,515.0,515.0
240.094,6,32,9325,16,6885,16006.0,1956.0,673.0,16,2440,16006.0,580.0,200.0
0.001,17,2,180,1,66,0.0,38.0,38.0,1,114,0.0,86.0,86.0
0.005,6,10,2007,5,928,1.0,660.0,660.0,5,1079,1.0,811.0,811.0
0.06,6,10,1506,5,395,13.0,127.0,127.0,5,1111,12.0,843.0,843.0
0.021,6,10,1983,5,910,5.0,642.0,642.0,5,1073,5.0,805.0,805.0
0.01,6,10,1677,5,827,2.0,559.0,559.0,5,850,2.0,582.0,582.0
0.019,6,10,1972,5,910,4.0,642.0,642.0,5,1062,4.0,794.0,794.0
0.01,6,10,1983,5,910,2.0,642.0,642.0,5,1073,2.0,805.0,805.0
40.06,17,10,676,5,460,10014.0,104.0,64.0,5,216,10014.0,20.0,15.0
0.005,6,10,1643,5,860,1.0,592.0,592.0,5,783,1.0,515.0,515.0
0.013,6,10,1989,5,910,3.0,642.0,642.0,5,1079,3.0,811.0,811.0
0.0,17,2,179,1,62,0.0,34.0,34.0,1,117,0.0,89.0,89.0
0.003,17,2,166,1,75,0.0,47.0,47.0,1,91,0.0,63.0,63.0
0.006,17,2,293,1,73,0.0,45.0,45.0,1,220,0.0,192.0,192.0
0.072,6,10,1506,5,395,16.0,127.0,127.0,5,1111,14.0,843.0,843.0
178.029,17,80,11416,40,2672,4564.0,44.0,38.0,40,8744,4564.0,239.0,190.0
0.005,6,10,2000,5,927,1.0,659.0,659.0,5,1073,1.0,805.0,805.0
0.005,17,2,144,1,64,0.0,36.0,36.0,1,80,0.0,52.0,52.0
0.059,6,10,1506,5,395,12.0,127.0,127.0,5,1111,14.0,843.0,843.0
15.078,17,16,8325,8,6177,2149.0,1350.0,744.0,8,2148,2149.0,1350.0,240.0
0.01,6,10,1989,5,910,2.0,642.0,642.0,5,1079,2.0,811.0,811.0
0.005,6,10,2006,5,927,1.0,659.0,659.0,5,1079,1.0,811.0,811.0
240.519,6,33,8635,17,1838,15030.0,571.0,189.0,16,6797,16032.0,1402.0,596.0
0.108,6,10,1506,5,395,23.0,127.0,127.0,5,1111,25.0,843.0,843.0
0.011,6,10,1989,5,910,2.0,642.0,642.0,5,1079,2.0,811.0,811.0
0.09,6,10,1506,5,395,18.0,127.0,127.0,5,1111,21.0,843.0,843.0
0.009,6,10,1990,5,911,2.0,643.0,643.0,5,1079,2.0,811.0,811.0
0.087,6,10,1506,5,395,20.0,127.0,127.0,5,1111,21.0,843.0,843.0
40.061,17,10,676,5,460,10014.0,104.0,64.0,5,216,10014.0,20.0,15.0
0.019,6,10,1983,5,910,4.0,642.0,642.0,5,1073,4.0,805.0,805.0
0.006,17,2,230,1,68,0.0,40.0,40.0,1,162,0.0,134.0,134.0
0.017,6,10,1677,5,827,4.0,559.0,559.0,5,850,4.0,582.0,582.0
0.015,6,10,1762,5,911,3.0,643.0,643.0,5,851,3.0,583.0,583.0
11.043,17,28,4390,14,2312,841.0,587.0,137.0,14,2078,840.0,269.0,120.0
0.021,6,10,1989,5,910,5.0,642.0,642.0,5,1079,5.0,811.0,811.0
0.067,17,8,3613,4,1874,22.0,1350.0,440.0,4,1739,11.0,1350.0,406.0
0.021,6,10,1990,5,911,5.0,643.0,643.0,5,1079,5.0,811.0,811.0
0.011,6,10,1631,5,848,2.0,580.0,580.0,5,783,2.0,515.0,515.0
0.005,6,13,3747,7,509,0.0,137.0,137.0,6,3238,0.0,1470.0,1459.0
0.005,6,10,1989,5,927,1.0,659.0,659.0,5,1062,1.0,794.0,794.0
0.01,6,10,1972,5,910,2.0,642.0,642.0,5,1062,2.0,794.0,794.0
0.08,6,10,1506,5,395,16.0,127.0,127.0,5,1111,18.0,843.0,843.0
0.012,6,10,1990,5,911,2.0,643.0,643.0,5,1079,3.0,811.0,811.0
0.012,6,10,1989,5,910,3.0,642.0,642.0,5,1079,2.0,811.0,811.0
0.003,17,2,185,1,73,0.0,45.0,45.0,1,112,0.0,84.0,84.0
0.013,6,10,1643,5,860,3.0,592.0,592.0,5,783,3.0,515.0,515.0
11.456,17,28,4399,14,2312,868.0,587.0,137.0,14,2087,868.0,270.0,121.0
0.01,6,14,3787,7,497,1.0,125.0,125.0,7,3290,1.0,1448.0,972.0
0.005,6,13,3747,7,509,0.0,137.0,137.0,6,3238,1.0,1470.0,1459.0
0.004,17,2,148,1,60,0.0,32.0,32.0,1,88,0.0,60.0,60.0
0.04,17,2,152,1,76,0.0,48.0,48.0,1,76,0.0,48.0,48.0
0.012,6,10,1983,5,910,3.0,642.0,642.0,5,1073,3.0,805.0,805.0
0.005,6,10,2007,5,928,1.0,660.0,660.0,5,1079,1.0,811.0,811.0
240.114,6,16,4481,9,963,30014.0,238.0,166.0,7,3518,40018.0,1402.0,786.0
0.083,6,10,1506,5,395,18.0,127.0,127.0,5,1111,19.0,843.0,843.0
0.017,6,10,1989,5,910,4.0,642.0,642.0,5,1079,4.0,811.0,811.0
241.22,6,306,344063,128,18174,1899.0,2736.0,960.0,178,325889,1362.0,2769.0,1884.0
0.005,6,10,1643,5,860,1.0,592.0,592.0,5,783,1.0,515.0,515.0
0.113,6,10,1506,5,395,23.0,127.0,127.0,5,1111,25.0,843.0,843.0
0.014,6,10,1989,5,910,3.0,642.0,642.0,5,1079,3.0,811.0,811.0
0.11,6,10,1506,5,395,25.0,127.0,127.0,5,1111,23.0,843.0,843.0
0.018,6,10,1677,5,827,4.0,559.0,559.0,5,850,4.0,582.0,582.0
0.006,6,10,2006,5,927,1.0,659.0,659.0,5,1079,1.0,811.0,811.0
0.005,6,10,2006,5,927,1.0,659.0,659.0,5,1079,1.0,811.0,811.0
0.003,17,4,284,2,120,0.0,32.0,32.0,2,164,0.0,60.0,54.0
0.005,6,10,2007,5,928,1.0,660.0,660.0,5,1079,1.0,811.0,811.0
0.004,6,10,1989,5,927,1.0,659.0,659.0,5,1062,1.0,794.0,794.0
0.006,17,4,284,2,120,3.0,32.0,32.0,2,164,3.0,60.0,54.0
0.005,6,10,1779,5,928,1.0,660.0,660.0,5,851,1.0,583.0,583.0
0.008,6,10,1989,5,910,2.0,642.0,642.0,5,1079,2.0,811.0,811.0
40.055,17,10,676,5,460,10012.0,104.0,64.0,5,216,10012.0,20.0,15.0
0.004,6,10,1989,5,927,1.0,659.0,659.0,5,1062,1.0,794.0,794.0
0.01,6,14,3787,7,497,1.0,125.0,125.0,7,3290,1.0,1448.0,972.0
0.063,6,10,1506,5,395,15.0,127.0,127.0,5,1111,13.0,843.0,843.0
0.005,6,10,1989,5,927,1.0,659.0,659.0,5,1062,1.0,794.0,794.0
0.006,6,10,1689,5,839,1.0,571.0,571.0,5,850,1.0,582.0,582.0
0.005,6,10,2007,5,928,1.0,660.0,660.0,5,1079,1.0,811.0,811.0
0.004,6,10,2006,5,927,1.0,659.0,659.0,5,1079,1.0,811.0,811.0
0.146,6,10,1506,5,395,35.0,127.0,127.0,5,1111,33.0,843.0,843.0
0.07,17,8,3613,4,1874,23.0,1350.0,440.0,4,1739,11.0,1350.0,406.0
0.081,6,10,1506,5,395,16.0,127.0,127.0,5,1111,18.0,843.0,843.0
0.008,17,2,136,1,60,0.0,32.0,32.0,1,76,0.0,48.0,48.0
0.016,6,10,1983,5,910,3.0,642.0,642.0,5,1073,3.0,805.0,805.0
0.005,17,2,144,1,64,0.0,36.0,36.0,1,80,0.0,52.0,52.0
0.006,6,10,1547,5,764,1.0,496.0,496.0,5,783,1.0,515.0,515.0
0.107,6,10,1506,5,395,24.0,127.0,127.0,5,1111,24.0,843.0,843.0
0.074,6,10,1506,5,395,14.0,127.0,127.0,5,1111,17.0,843.0,843.0
0.006,17,2,166,1,75,0.0,47.0,47.0,1,91,0.0,63.0,63.0
0.019,6,10,1677,5,827,4.0,559.0,559.0,5,850,4.0,582.0,582.0
0.005,6,13,3747,7,509,0.0,137.0,137.0,6,3238,0.0,1470.0,1459.0
0.012,6,10,1989,5,910,2.0,642.0,642.0,5,1079,2.0,811.0,811.0
0.087,6,10,1506,5,395,19.0,127.0,127.0,5,1111,19.0,843.0,843.0
0.01,6,10,1989,5,910,2.0,642.0,642.0,5,1079,2.0,811.0,811.0
0.076,6,10,1506,5,395,15.0,127.0,127.0,5,1111,17.0,843.0,843.0
0.073,6,10,1506,5,395,17.0,127.0,127.0,5,1111,16.0,843.0,843.0
0.009,6,10,1972,5,910,2.0,642.0,642.0,5,1062,2.0,794.0,794.0
368.926,6,22,2313,16,867,24595.0,195.0,195.0,6,1446,4636.0,419.0,398.0
293.307,6,398,348911,202,22060,1459.0,2736.0,825.0,196,326851,1504.0,2914.0,1730.0
0.083,6,10,1506,5,395,18.0,127.0,127.0,5,1111,19.0,843.0,843.0
0.006,6,10,1547,5,764,1.0,496.0,496.0,5,783,1.0,515.0,515.0
0.005,6,10,2000,5,927,1.0,659.0,659.0,5,1073,1.0,805.0,805.0
0.014,6,10,1677,5,827,3.0,559.0,559.0,5,850,3.0,582.0,582.0
0.004,6,10,1989,5,927,1.0,659.0,659.0,5,1062,1.0,794.0,794.0
0.012,6,10,1989,5,910,3.0,642.0,642.0,5,1079,2.0,811.0,811.0
0.005,17,4,284,2,120,2.0,32.0,32.0,2,164,1.0,60.0,54.0
0.008,6,10,1972,5,910,2.0,642.0,642.0,5,1062,2.0,794.0,794.0
0.004,6,10,1989,5,927,1.0,659.0,659.0,5,1062,1.0,794.0,794.0
0.003,17,2,136,1,60,0.0,32.0,32.0,1,76,0.0,48.0,48.0
0.016,6,10,1989,5,910,3.0,642.0,642.0,5,1079,3.0,811.0,811.0
0.011,6,10,1989,5,910,2.0,642.0,642.0,5,1079,2.0,811.0,811.0
0.012,6,10,1762,5,911,3.0,643.0,643.0,5,851,3.0,583.0,583.0
0.008,6,10,1972,5,910,1.0,642.0,642.0,5,1062,2.0,794.0,794.0
0.072,17,2,136,1,60,0.0,32.0,32.0,1,76,0.0,48.0,48.0
0.007,6,13,3690,7,452,1.0,80.0,80.0,6,3238,1.0,1470.0,1459.0
0.011,6,10,1677,5,827,2.0,559.0,559.0,5,850,2.0,582.0,582.0
0.011,6,10,1972,5,910,2.0,642.0,642.0,5,1062,2.0,794.0,794.0
0.004,17,2,136,1,60,0.0,32.0,32.0,1,76,0.0,48.0,48.0
1.124,6,29,12310,17,3300,70.0,1360.0,517.0,12,9010,86.0,2720.0,1064.0
0.017,6,10,1989,5,910,4.0,642.0,642.0,5,1079,4.0,811.0,811.0
0.003,17,2,208,1,72,0.0,44.0,44.0,1,136,0.0,108.0,108.0
0.005,17,2,169,1,62,0.0,34.0,34.0,1,107,0.0,79.0,79.0
0.004,17,2,148,1,60,0.0,32.0,32.0,1,88,0.0,60.0,60.0
0.006,17,2,175,1,65,0.0,37.0,37.0,1,110,0.0,82.0,82.0
0.004,6,10,1989,5,927,1.0,659.0,659.0,5,1062,1.0,794.0,794.0
0.006,17,2,187,1,71,0.0,43.0,43.0,1,116,0.0,88.0,88.0
0.138,6,10,1506,5,395,30.0,127.0,127.0,5,1111,33.0,843.0,843.0
40.07,17,10,676,5,460,10014.0,104.0,64.0,5,216,10016.0,20.0,15.0
0.005,6,10,2006,5,927,1.0,659.0,659.0,5,1079,1.0,811.0,811.0
0.012,6,10,1989,5,910,3.0,642.0,642.0,5,1079,3.0,811.0,811.0
0.083,6,10,1506,5,395,17.0,127.0,127.0,5,1111,20.0,843.0,843.0
300.15,6,29,10051,17,1491,18759.0,260.0,149.0,12,8560,21830.0,1561.0,991.0
0.014,6,10,2007,5,928,3.0,660.0,660.0,5,1079,3.0,811.0,811.0
0.005,6,10,1779,5,928,1.0,660.0,660.0,5,851,1.0,583.0,583.0
0.012,6,10,1989,5,910,3.0,642.0,642.0,5,1079,2.0,811.0,811.0
0.005,6,10,1547,5,764,1.0,496.0,496.0,5,783,1.0,515.0,515.0
165.529,17,72,10294,36,2395,4729.0,44.0,38.0,36,7899,4729.0,261.0,191.0
0.052,6,10,1990,5,911,12.0,643.0,643.0,5,1079,12.0,811.0,811.0
240.386,6,37,10208,17,7308,15024.0,1728.0,641.0,20,2900,12651.0,580.0,204.0
0.077,6,10,1506,5,395,17.0,127.0,127.0,5,1111,17.0,843.0,843.0
0.068,6,10,1506,5,395,13.0,127.0,127.0,5,1111,15.0,843.0,843.0
0.005,6,10,1689,5,839,1.0,571.0,571.0,5,850,1.0,582.0,582.0
309.341,17,20,1124,10,716,34364.0,48.0,43.0,10,408,34364.0,20.0,12.0
0.077,6,10,1506,5,395,16.0,127.0,127.0,5,1111,16.0,843.0,843.0
0.005,17,2,144,1,64,0.0,36.0,36.0,1,80,0.0,52.0,52.0
0.117,6,10,1506,5,395,26.0,127.0,127.0,5,1111,28.0,843.0,843.0
0.014,6,10,1990,5,911,3.0,643.0,643.0,5,1079,3.0,811.0,811.0
0.027,6,10,1989,5,910,6.0,642.0,642.0,5,1079,6.0,811.0,811.0
15.08,17,16,8433,8,6345,2150.0,1350.0,765.0,8,2088,2150.0,1350.0,233.0
0.005,6,10,1689,5,839,1.0,571.0,571.0,5,850,1.0,582.0,582.0
0.005,17,2,164,1,74,0.0,46.0,46.0,1,90,0.0,62.0,62.0
0.016,6,10,1990,5,911,3.0,643.0,643.0,5,1079,4.0,811.0,811.0
0.085,6,10,1506,5,395,20.0,127.0,127.0,5,1111,19.0,843.0,843.0
0.039,17,2,182,1,65,0.0,37.0,37.0,1,117,0.0,89.0,89.0
0.006,6,10,1547,5,764,1.0,496.0,496.0,5,783,1.0,515.0,515.0
0.005,6,10,2006,5,927,1.0,659.0,659.0,5,1079,1.0,811.0,811.0
0.085,6,10,1506,5,395,16.0,127.0,127.0,5,1111,19.0,843.0,843.0
0.005,6,10,2007,5,928,1.0,660.0,660.0,5,1079,1.0,811.0,811.0
0.013,17,2,152,1,56,0.0,28.0,28.0,1,96,0.0,68.0,68.0
0.004,6,10,1774,5,923,1.0,655.0,655.0,5,851,1.0,583.0,583.0
0.004,6,10,2000,5,927,1.0,659.0,659.0,5,1073,1.0,805.0,805.0
0.006,6,10,1774,5,923,1.0,655.0,655.0,5,851,1.0,583.0,583.0
0.001,17,2,180,1,66,0.0,38.0,38.0,1,114,0.0,86.0,86.0
0.091,6,10,1506,5,395,19.0,127.0,127.0,5,1111,21.0,843.0,843.0
0.147,6,10,1506,5,395,30.0,127.0,127.0,5,1111,27.0,843.0,843.0
0.039,17,2,136,1,60,0.0,32.0,32.0,1,76,0.0,48.0,48.0
0.005,17,2,144,1,64,0.0,36.0,36.0,1,80,0.0,52.0,52.0
9.037,17,6,376,5,280,2259.0,28.0,28.0,1,96,0.0,68.0,68.0
0.012,6,10,1989,5,910,3.0,642.0,642.0,5,1079,2.0,811.0,811.0
0.008,6,10,1989,5,910,1.0,642.0,642.0,5,1079,2.0,811.0,811.0
0.005,6,10,1689,5,839,1.0,571.0,571.0,5,850,1.0,582.0,582.0
0.005,6,10,1779,5,928,1.0,660.0,660.0,5,851,1.0,583.0,583.0
0.014,6,10,1677,5,827,3.0,559.0,559.0,5,850,3.0,582.0,582.0
300.022,6,12,1782,7,1348,50003.0,494.0,494.0,5,434,75004.0,83.0,83.0
300.46,6,16,2170,9,684,37537.0,146.0,146.0,7,1486,50049.0,419.0,398.0
0.006,17,2,212,1,74,0.0,46.0,46.0,1,138,0.0,110.0,110.0
40.073,17,10,676,5,460,10017.0,104.0,64.0,5,216,10017.0,20.0,15.0
0.006,6,10,1854,5,889,1.0,621.0,621.0,5,965,1.0,697.0,697.0
0.003,17,2,136,1,60,0.0,32.0,32.0,1,76,0.0,48.0,48.0
167.224,17,76,10576,38,2529,4519.0,44.0,38.0,38,8047,4519.0,239.0,183.0
0.005,6,14,3736,7,446,0.0,74.0,74.0,7,3290,0.0,1448.0,972.0
0.018,6,10,1983,5,910,4.0,642.0,642.0,5,1073,4.0,805.0,805.0
240.095,6,34,9406,18,6904,14123.0,1872.0,663.0,16,2502,16006.0,580.0,207.0
240.094,6,16,4479,9,963,30011.0,238.0,166.0,7,3516,40015.0,1402.0,786.0
0.005,17,2,164,1,74,0.0,46.0,46.0,1,90,0.0,62.0,62.0
0.007,6,10,1854,5,889,1.0,621.0,621.0,5,965,1.0,697.0,697.0
0.037,17,4,284,2,120,0.0,32.0,32.0,2,164,33.0,60.0,54.0
0.006,17,2,230,1,68,0.0,40.0,40.0,1,162,0.0,134.0,134.0
0.004,6,10,2006,5,927,1.0,659.0,659.0,5,1079,1.0,811.0,811.0
0.005,6,10,1989,5,927,1.0,659.0,659.0,5,1062,1.0,794.0,794.0
308.509,17,20,1124,10,716,34263.0,48.0,43.0,10,408,34264.0,20.0,12.0
0.007,6,10,2006,5,927,1.0,659.0,659.0,5,1079,1.0,811.0,811.0
0.172,17,2,152,1,76,0.0,48.0,48.0,1,76,0.0,48.0,48.0
0.026,6,10,1990,5,911,6.0,643.0,643.0,5,1079,6.0,811.0,811.0
1799.65,17,2879,217041,1435,114876,1254.0,82.0,52.0,1444,102165,1247.0,226.0,42.0
0.001,17,2,180,1,66,0.0,38.0,38.0,1,114,0.0,86.0,86.0
0.004,17,2,148,1,60,0.0,32.0,32.0,1,88,0.0,60.0,60.0
0.037,6,10,1762,5,911,9.0,643.0,643.0,5,851,9.0,583.0,583.0
0.005,6,10,1774,5,923,1.0,655.0,655.0,5,851,1.0,583.0,583.0
0.015,6,10,1990,5,911,3.0,643.0,643.0,5,1079,3.0,811.0,811.0
0.004,6,10,2007,5,928,1.0,660.0,660.0,5,1079,1.0,811.0,811.0
0.005,6,10,2000,5,927,1.0,659.0,659.0,5,1073,1.0,805.0,805.0
178.118,17,88,12342,44,2976,4142.0,44.0,39.0,44,9366,4142.0,239.0,184.0
0.084,6,10,1506,5,395,19.0,127.0,127.0,5,1111,17.0,843.0,843.0
280.661,6,24,6440,11,1226,28066.0,267.0,156.0,13,5214,23387.0,1400.0,781.0
40.068,17,10,676,5,460,10015.0,104.0,64.0,5,216,10016.0,20.0,15.0
0.094,6,10,1506,5,395,19.0,127.0,127.0,5,1111,20.0,843.0,843.0
178.575,17,74,10447,37,2471,4960.0,44.0,38.0,37,7976,4960.0,239.0,187.0
0.016,17,2,198,1,91,0.0,63.0,63.0,1,107,0.0,79.0,79.0
172.314,17,88,12650,44,2954,4007.0,44.0,39.0,44,9696,4007.0,239.0,192.0
0.001,17,2,180,1,66,0.0,38.0,38.0,1,114,0.0,86.0,86.0
0.005,17,2,164,1,74,0.0,46.0,46.0,1,90,0.0,62.0,62.0
0.005,6,10,1702,5,863,1.0,595.0,595.0,5,839,1.0,571.0,571.0
0.206,6,10,1506,5,395,49.0,127.0,127.0,5,1111,47.0,843.0,843.0
0.004,6,10,1702,5,863,1.0,595.0,595.0,5,839,1.0,571.0,571.0
0.008,6,10,1990,5,911,2.0,643.0,643.0,5,1079,2.0,811.0,811.0
0.013,6,10,1989,5,910,3.0,642.0,642.0,5,1079,3.0,811.0,811.0
0.005,6,10,2007,5,928,1.0,660.0,660.0,5,1079,1.0,811.0,811.0
0.005,6,10,1779,5,928,1.0,660.0,660.0,5,851,1.0,583.0,583.0
0.192,6,10,1506,5,395,46.0,127.0,127.0,5,1111,22.0,843.0,843.0
0.061,17,2,152,1,76,0.0,48.0,48.0,1,76,0.0,48.0,48.0
0.096,6,10,1506,5,395,21.0,127.0,127.0,5,1111,21.0,843.0,843.0
40.063,17,10,676,5,460,10014.0,104.0,64.0,5,216,10014.0,20.0,15.0
0.017,6,10,1989,5,910,4.0,642.0,642.0,5,1079,4.0,811.0,811.0
0.003,17,2,148,1,60,0.0,32.0,32.0,1,88,0.0,60.0,60.0
0.008,6,12,1926,6,1189,1.0,659.0,434.0,6,737,1.0,417.0,417.0
0.003,17,2,152,1,76,0.0,48.0,48.0,1,76,0.0,48.0,48.0
0.001,17,2,294,1,64,0.0,36.0,36.0,1,230,0.0,202.0,202.0
0.161,6,10,1506,5,395,36.0,127.0,127.0,5,1111,29.0,843.0,843.0
0.001,17,2,180,1,66,0.0,38.0,38.0,1,114,0.0,86.0,86.0
0.005,6,10,2000,5,927,1.0,659.0,659.0,5,1073,1.0,805.0,805.0
0.014,6,10,1972,5,910,3.0,642.0,642.0,5,1062,3.0,794.0,794.0
0.005,17,2,209,1,64,0.0,36.0,36.0,1,145,0.0,117.0,117.0
0.008,6,12,1926,6,1189,1.0,659.0,434.0,6,737,1.0,417.0,417.0
0.006,17,2,179,1,71,0.0,43.0,43.0,1,108,0.0,80.0,80.0
0.003,17,4,284,2,120,0.0,32.0,32.0,2,164,0.0,60.0,54.0
0.013,6,10,1631,5,848,3.0,580.0,580.0,5,783,3.0,515.0,515.0
0.006,6,10,1547,5,764,1.0,496.0,496.0,5,783,1.0,515.0,515.0
0.006,6,10,1547,5,764,1.0,496.0,496.0,5,783,1.0,515.0,515.0
0.006,6,13,3747,7,509,0.0,137.0,137.0,6,3238,1.0,1470.0,1459.0
0.002,17,2,166,1,75,0.0,47.0,47.0,1,91,0.0,63.0,63.0
308.548,17,20,1124,10,716,34268.0,48.0,43.0,10,408,34268.0,20.0,12.0
0.13,6,10,1506,5,395,21.0,127.0,127.0,5,1111,27.0,843.0,843.0
0.038,17,2,148,1,60,0.0,32.0,32.0,1,88,0.0,60.0,60.0
0.013,6,10,1762,5,911,3.0,643.0,643.0,5,851,3.0,583.0,583.0
0.012,6,10,1990,5,911,3.0,643.0,643.0,5,1079,3.0,811.0,811.0
40.071,17,10,676,5,460,10016.0,104.0,64.0,5,216,10016.0,20.0,15.0
0.096,6,10,1506,5,395,21.0,127.0,127.0,5,1111,21.0,843.0,843.0
0.014,6,10,1762,5,911,3.0,643.0,643.0,5,851,3.0,583.0,583.0
243.248,6,37,9602,16,6692,16216.0,1765.0,651.0,21,2910,12162.0,580.0,150.0
0.073,6,10,1506,5,395,18.0,127.0,127.0,5,1111,16.0,843.0,843.0
0.012,6,10,1989,5,910,3.0,642.0,642.0,5,1079,3.0,811.0,811.0
0.004,6,10,1989,5,927,1.0,659.0,659.0,5,1062,1.0,794.0,794.0
0.003,17,2,148,1,60,0.0,32.0,32.0,1,88,0.0,60.0,60.0
15.084,17,16,8518,8,6320,2150.0,1350.0,762.0,8,2198,2150.0,1350.0,246.0
0.005,17,2,180,1,58,0.0,30.0,30.0,1,122,0.0,94.0,94.0
0.073,6,10,1506,5,395,15.0,127.0,127.0,5,1111,16.0,843.0,843.0
0.006,6,10,1689,5,839,1.0,571.0,571.0,5,850,1.0,582.0,582.0
0.04,17,2,152,1,76,0.0,48.0,48.0,1,76,0.0,48.0,48.0
0.005,6,10,2006,5,927,1.0,659.0,659.0,5,1079,1.0,811.0,811.0
0.005,17,2,170,1,65,0.0,37.0,37.0,1,105,0.0,77.0,77.0
0.019,6,13,3735,7,497,3.0,125.0,125.0,6,3238,3.0,1470.0,1459.0
0.005,6,10,1689,5,839,1.0,571.0,571.0,5,850,1.0,582.0,582.0
0.01,17,2,169,1,62,0.0,34.0,34.0,1,107,0.0,79.0,79.0
0.01,6,10,1990,5,911,2.0,643.0,643.0,5,1079,2.0,811.0,811.0
0.009,6,13,3735,7,497,1.0,125.0,125.0,6,3238,1.0,1470.0,1459.0
0.01,6,12,1926,6,1189,1.0,659.0,434.0,6,737,1.0,417.0,417.0
0.005,17,2,178,1,81,0.0,53.0,53.0,1,97,0.0,69.0,69.0
166.31,17,98,13985,49,3301,3464.0,44.0,39.0,49,10684,3464.0,239.0,190.0
0.057,6,10,1506,5,395,12.0,127.0,127.0,5,1111,12.0,843.0,843.0
0.085,6,10,1506,5,395,17.0,127.0,127.0,5,1111,16.0,843.0,843.0
10.818,17,28,4424,14,1995,823.0,270.0,114.0,14,2429,823.0,588.0,145.0
0.011,6,10,1762,5,911,2.0,643.0,643.0,5,851,2.0,583.0,583.0
1792.226,6,64,7344,42,4469,43712.0,1625.0,108.0,22,2875,85336.0,1111.0,82.0
0.013,6,10,1972,5,910,3.0,642.0,642.0,5,1062,3.0,794.0,794.0
1799.918,6,137,6590,76,3625,23995.0,39.0,39.0,61,2965,29994.0,35.0,35.0
240.017,6,9,787,5,488,60004.0,232.0,232.0,4,299,80005.0,83.0,83.0
0.006,6,10,2006,5,927,1.0,659.0,659.0,5,1079,1.0,811.0,811.0
40.062,17,10,676,5,460,10014.0,104.0,64.0,5,216,10014.0,20.0,15.0
40.064,17,10,676,5,460,10015.0,104.0,64.0,5,216,10014.0,20.0,15.0
0.076,6,10,1506,5,395,17.0,127.0,127.0,5,1111,18.0,843.0,843.0
1770.344,6,84,4419,42,2211,43178.0,27.0,27.0,42,2208,43178.0,24.0,24.0
0.109,6,10,1506,5,395,22.0,127.0,127.0,5,1111,26.0,843.0,843.0
0.015,6,10,1989,5,910,3.0,642.0,642.0,5,1079,3.0,811.0,811.0
0.114,6,10,1506,5,395,26.0,127.0,127.0,5,1111,26.0,843.0,843.0
300.791,6,37,9740,20,4262,15831.0,1686.0,686.0,17,5478,538.0,2667.0,435.0
0.144,6,10,1506,5,395,33.0,127.0,127.0,5,1111,32.0,843.0,843.0
0.041,17,2,184,1,61,0.0,33.0,33.0,1,123,0.0,95.0,95.0
39.336,6,35,9486,17,3968,553.0,2903.0,1085.0,18,5518,2304.0,2667.0,435.0
10.947,17,28,4416,14,1993,833.0,268.0,114.0,14,2423,833.0,586.0,145.0
0.005,6,10,1547,5,764,1.0,496.0,496.0,5,783,1.0,515.0,515.0
283.318,6,26,6520,12,1266,25756.0,267.0,156.0,14,5254,21788.0,1400.0,781.0
0.016,6,10,1990,5,911,3.0,643.0,643.0,5,1079,3.0,811.0,811.0
40.058,17,10,676,5,460,10013.0,104.0,64.0,5,216,10013.0,20.0,15.0
0.005,6,10,1643,5,860,1.0,592.0,592.0,5,783,1.0,515.0,515.0
10.907,17,28,4394,14,1995,830.0,270.0,114.0,14,2399,830.0,586.0,143.0
0.003,17,2,132,1,58,0.0,30.0,30.0,1,74,0.0,46.0,46.0
0.039,17,2,136,1,60,0.0,32.0,32.0,1,76,0.0,48.0,48.0
0.103,6,10,1506,5,395,22.0,127.0,127.0,5,1111,24.0,843.0,843.0
0.005,6,10,1989,5,927,1.0,659.0,659.0,5,1062,1.0,794.0,794.0
15.074,17,15,8131,8,6104,2149.0,1350.0,735.0,7,2027,2507.0,1350.0,261.0
0.084,6,10,1506,5,395,19.0,127.0,127.0,5,1111,20.0,843.0,843.0
369.795,6,22,2313,16,867,24653.0,195.0,195.0,6,1446,4636.0,419.0,398.0
0.007,6,10,1989,5,927,1.0,659.0,659.0,5,1062,1.0,794.0,794.0
0.004,17,4,284,2,120,0.0,32.0,32.0,2,164,0.0,60.0,54.0
0.006,6,10,1547,5,764,1.0,496.0,496.0,5,783,1.0,515.0,515.0
0.221,6,16,2669,8,1395,31.0,533.0,323.0,8,1274,20.0,529.0,212.0
0.01,6,10,1983,5,910,2.0,642.0,642.0,5,1073,2.0,805.0,805.0
0.013,17,2,152,1,56,0.0,28.0,28.0,1,96,0.0,68.0,68.0
0.003,17,2,136,1,60,0.0,32.0,32.0,1,76,0.0,48.0,48.0
0.009,6,10,1972,5,910,2.0,642.0,642.0,5,1062,2.0,794.0,794.0
0.005,6,10,1774,5,923,1.0,655.0,655.0,5,851,1.0,583.0,583.0
0.132,6,10,1506,5,395,31.0,127.0,127.0,5,1111,31.0,843.0,843.0
240.015,6,9,787,5,488,60003.0,232.0,232.0,4,299,80004.0,83.0,83.0
0.087,6,10,1506,5,395,20.0,127.0,127.0,5,1111,16.0,843.0,843.0
0.005,6,10,2006,5,927,1.0,659.0,659.0,5,1079,1.0,811.0,811.0
0.011,6,10,1989,5,910,2.0,642.0,642.0,5,1079,2.0,811.0,811.0
0.069,6,10,1506,5,395,16.0,127.0,127.0,5,1111,15.0,843.0,843.0
0.015,6,10,1989,5,910,3.0,642.0,642.0,5,1079,3.0,811.0,811.0
0.006,6,10,2007,5,928,1.0,660.0,660.0,5,1079,1.0,811.0,811.0
308.614,17,20,1124,10,716,34276.0,48.0,43.0,10,408,34276.0,20.0,12.0
0.013,6,10,1983,5,910,3.0,642.0,642.0,5,1073,3.0,805.0,805.0
0.038,17,2,148,1,60,0.0,32.0,32.0,1,88,0.0,60.0,60.0
0.006,6,10,1547,5,764,1.0,496.0,496.0,5,783,1.0,515.0,515.0
0.01,6,10,1983,5,910,2.0,642.0,642.0,5,1073,2.0,805.0,805.0
0.001,17,2,180,1,66,0.0,38.0,38.0,1,114,0.0,86.0,86.0
0.086,6,10,1506,5,395,18.0,127.0,127.0,5,1111,20.0,843.0,843.0
0.005,6,10,1547,5,764,1.0,496.0,496.0,5,783,1.0,515.0,515.0
351.988,6,20,2210,6,1308,12003.0,494.0,494.0,14,902,27075.0,83.0,83.0
240.065,6,9,787,5,488,60016.0,232.0,232.0,4,299,80007.0,83.0,83.0
0.004,6,10,2006,5,927,1.0,659.0,659.0,5,1079,1.0,811.0,811.0
0.091,6,10,1506,5,395,22.0,127.0,127.0,5,1111,20.0,843.0,843.0
0.005,17,2,180,1,66,0.0,38.0,38.0,1,114,0.0,86.0,86.0
0.005,17,2,136,1,60,0.0,32.0,32.0,1,76,0.0,48.0,48.0
0.005,17,2,169,1,62,0.0,34.0,34.0,1,107,0.0,79.0,79.0
1765.17,6,301,97513,186,86346,9541.0,1402.0,678.0,115,11167,15483.0,452.0,71.0
40.06,17,10,676,5,460,10012.0,104.0,64.0,5,216,10014.0,20.0,15.0
0.008,6,12,1926,6,1189,1.0,659.0,434.0,6,737,1.0,417.0,417.0
0.121,6,10,1506,5,395,23.0,127.0,127.0,5,1111,26.0,843.0,843.0
0.081,6,10,1506,5,395,18.0,127.0,127.0,5,1111,13.0,843.0,843.0
0.006,17,2,179,1,71,0.0,43.0,43.0,1,108,0.0,80.0,80.0
0.008,6,10,1989,5,910,1.0,642.0,642.0,5,1079,2.0,811.0,811.0
0.015,6,10,1631,5,848,3.0,580.0,580.0,5,783,3.0,515.0,515.0
0.019,6,10,1972,5,910,4.0,642.0,642.0,5,1062,4.0,794.0,794.0
0.12,6,10,1506,5,395,25.0,127.0,127.0,5,1111,27.0,843.0,843.0
0.006,17,2,136,1,60,0.0,32.0,32.0,1,76,0.0,48.0,48.0
0.037,17,2,152,1,76,0.0,48.0,48.0,1,76,0.0,48.0,48.0
0.004,17,4,284,2,120,0.0,32.0,32.0,2,164,1.0,60.0,54.0
0.007,17,2,299,1,65,0.0,37.0,37.0,1,234,0.0,206.0,206.0
0.121,6,10,1506,5,395,25.0,127.0,127.0,5,1111,25.0,843.0,843.0
0.041,17,2,148,1,60,0.0,32.0,32.0,1,88,0.0,60.0,60.0
0.008,6,13,3735,7,497,1.0,125.0,125.0,6,3238,1.0,1470.0,1459.0
0.059,6,10,1506,5,395,12.0,127.0,127.0,5,1111,12.0,843.0,843.0
0.083,6,10,1506,5,395,16.0,127.0,127.0,5,1111,18.0,843.0,843.0
0.016,6,10,1983,5,910,4.0,642.0,642.0,5,1073,4.0,805.0,805.0
0.005,6,14,3799,7,509,0.0,137.0,137.0,7,3290,0.0,1448.0,972.0
0.006,6,10,1547,5,764,1.0,496.0,496.0,5,783,1.0,515.0,515.0
240.019,6,9,787,5,488,60004.0,232.0,232.0,4,299,80005.0,83.0,83.0
0.015,6,10,1972,5,910,3.0,642.0,642.0,5,1062,3.0,794.0,794.0
0.112,6,10,1506,5,395,23.0,127.0,127.0,5,1111,22.0,843.0,843.0
0.013,6,10,1972,5,910,3.0,642.0,642.0,5,1062,3.0,794.0,794.0
0.006,6,10,1547,5,764,1.0,496.0,496.0,5,783,1.0,515.0,515.0
0.001,17,2,166,1,75,0.0,47.0,47.0,1,91,0.0,63.0,63.0
0.004,6,10,1989,5,927,1.0,659.0,659.0,5,1062,1.0,794.0,794.0
0.005,6,10,1547,5,764,1.0,496.0,496.0,5,783,1.0,515.0,515.0
0.004,17,2,234,1,61,0.0,33.0,33.0,1,173,0.0,145.0,145.0
40.058,17,10,676,5,460,10012.0,104.0,64.0,5,216,10013.0,20.0,15.0
0.005,6,10,2006,5,927,1.0,659.0,659.0,5,1079,1.0,811.0,811.0
1755.986,6,105,6270,60,3525,29761.0,27.0,27.0,45,2745,39907.0,27.0,27.0
40.065,17,10,676,5,460,10013.0,104.0,64.0,5,216,10014.0,20.0,15.0
40.075,17,10,676,5,460,10017.0,104.0,64.0,5,216,10018.0,20.0,15.0
0.067,17,8,3613,4,1874,22.0,1350.0,440.0,4,1739,11.0,1350.0,406.0
0.01,6,10,1677,5,827,2.0,559.0,559.0,5,850,2.0,582.0,582.0
0.009,6,10,1983,5,910,2.0,642.0,642.0,5,1073,2.0,805.0,805.0
0.015,6,10,1972,5,910,3.0,642.0,642.0,5,1062,3.0,794.0,794.0
0.004,6,10,1779,5,928,1.0,660.0,660.0,5,851,1.0,583.0,583.0
0.012,6,10,1972,5,910,3.0,642.0,642.0,5,1062,2.0,794.0,794.0
0.006,6,10,1689,5,839,1.0,571.0,571.0,5,850,1.0,582.0,582.0
0.135,6,10,1506,5,395,30.0,127.0,127.0,5,1111,31.0,843.0,843.0
0.006,17,2,170,1,65,0.0,37.0,37.0,1,105,0.0,77.0,77.0
175.103,17,72,10214,36,2402,5002.0,44.0,38.0,36,7812,5002.0,239.0,189.0
0.037,17,2,148,1,60,0.0,32.0,32.0,1,88,0.0,60.0,60.0
0.024,6,13,3735,7,497,4.0,125.0,125.0,6,3238,4.0,1470.0,1459.0
0.006,6,10,1547,5,764,1.0,496.0,496.0,5,783,1.0,515.0,515.0
0.014,6,10,1983,5,910,3.0,642.0,642.0,5,1073,3.0,805.0,805.0
0.013,6,10,1990,5,911,3.0,643.0,643.0,5,1079,3.0,811.0,811.0
0.009,6,10,1972,5,910,2.0,642.0,642.0,5,1062,2.0,794.0,794.0
0.013,6,10,1677,5,827,3.0,559.0,559.0,5,850,3.0,582.0,582.0
40.054,17,10,676,5,460,10012.0,104.0,64.0,5,216,10012.0,20.0,15.0
0.066,17,8,3613,4,1874,22.0,1350.0,440.0,4,1739,11.0,1350.0,406.0
0.095,6,10,1506,5,395,21.0,127.0,127.0,5,1111,18.0,843.0,843.0
0.009,6,10,2007,5,928,2.0,660.0,660.0,5,1079,2.0,811.0,811.0
40.063,17,10,676,5,460,10014.0,104.0,64.0,5,216,10014.0,20.0,15.0
0.004,6,10,2007,5,928,1.0,660.0,660.0,5,1079,1.0,811.0,811.0
40.071,17,10,676,5,460,10015.0,104.0,64.0,5,216,10017.0,20.0,15.0
0.022,6,10,1989,5,910,5.0,642.0,642.0,5,1079,5.0,811.0,811.0
0.01,6,10,1989,5,910,2.0,642.0,642.0,5,1079,2.0,811.0,811.0
0.006,6,10,1547,5,764,1.0,496.0,496.0,5,783,1.0,515.0,515.0
0.101,6,10,1506,5,395,23.0,127.0,127.0,5,1111,21.0,843.0,843.0
0.012,6,10,1990,5,911,3.0,643.0,643.0,5,1079,2.0,811.0,811.0
0.005,6,10,2006,5,927,1.0,659.0,659.0,5,1079,1.0,811.0,811.0
240.128,6,29,9581,15,7300,17152.0,2423.0,724.0,14,2281,18471.0,580.0,220.0
0.08,6,10,1506,5,395,18.0,127.0,127.0,5,1111,18.0,843.0,843.0
0.006,6,10,1547,5,764,1.0,496.0,496.0,5,783,1.0,515.0,515.0
0.118,6,10,1506,5,395,24.0,127.0,127.0,5,1111,26.0,843.0,843.0
0.111,6,10,1506,5,395,25.0,127.0,127.0,5,1111,25.0,843.0,843.0
0.006,6,10,2006,5,927,1.0,659.0,659.0,5,1079,1.0,811.0,811.0
0.024,6,10,1989,5,910,6.0,642.0,642.0,5,1079,5.0,811.0,811.0
0.005,17,2,140,1,62,0.0,34.0,34.0,1,78,0.0,50.0,50.0
0.004,17,2,136,1,60,0.0,32.0,32.0,1,76,0.0,48.0,48.0
0.011,6,10,1631,5,848,2.0,580.0,580.0,5,783,2.0,515.0,515.0
0.015,6,10,1972,5,910,3.0,642.0,642.0,5,1062,3.0,794.0,794.0
0.004,17,2,136,1,60,0.0,32.0,32.0,1,76,0.0,48.0,48.0
0.001,17,2,180,1,66,0.0,38.0,38.0,1,114,0.0,86.0,86.0
0.004,6,10,2006,5,927,1.0,659.0,659.0,5,1079,1.0,811.0,811.0
0.006,6,10,1989,5,927,1.0,659.0,659.0,5,1062,1.0,794.0,794.0
0.078,6,10,1506,5,395,18.0,127.0,127.0,5,1111,16.0,843.0,843.0
0.025,6,8,832,4,522,7.0,302.0,302.0,4,310,7.0,102.0,102.0
40.064,17,10,676,5,460,10015.0,104.0,64.0,5,216,10015.0,20.0,15.0
0.006,6,10,1689,5,839,1.0,571.0,571.0,5,850,1.0,582.0,582.0
0.084,6,10,1506,5,395,20.0,127.0,127.0,5,1111,19.0,843.0,843.0
240.313,6,33,21080,17,7080,15019.0,2736.0,1033.0,16,14000,16020.0,1908.0,1316.0
0.086,6,10,1506,5,395,19.0,127.0,127.0,5,1111,18.0,843.0,843.0
0.005,6,10,1547,5,764,1.0,496.0,496.0,5,783,1.0,515.0,515.0
167.148,17,76,10845,38,2533,4517.0,44.0,38.0,38,8312,4517.0,261.0,190.0
0.121,6,10,1506,5,395,27.0,127.0,127.0,5,1111,22.0,843.0,843.0
0.13,17,2,182,1,65,0.0,37.0,37.0,1,117,0.0,89.0,89.0
0.011,6,10,1989,5,910,2.0,642.0,642.0,5,1079,2.0,811.0,811.0
0.042,17,2,184,1,61,0.0,33.0,33.0,1,123,0.0,95.0,95.0
0.017,6,10,1677,5,827,4.0,559.0,559.0,5,850,4.0,582.0,582.0
21.201,6,37,10002,19,4484,497.0,1360.0,738.0,18,5518,1237.0,2667.0,435.0
0.014,6,10,1989,5,910,3.0,642.0,642.0,5,1079,3.0,811.0,811.0
0.013,6,10,1989,5,910,3.0,642.0,642.0,5,1079,3.0,811.0,811.0
366.449,6,22,2313,16,867,24429.0,195.0,195.0,6,1446,4636.0,419.0,398.0
0.009,6,10,1631,5,848,2.0,580.0,580.0,5,783,2.0,515.0,515.0
0.116,6,10,1506,5,395,22.0,127.0,127.0,5,1111,24.0,843.0,843.0
0.073,6,10,1506,5,395,15.0,127.0,127.0,5,1111,16.0,843.0,843.0
0.081,6,10,1506,5,395,16.0,127.0,127.0,5,1111,18.0,843.0,843.0
0.011,6,10,1631,5,848,2.0,580.0,580.0,5,783,2.0,515.0,515.0
0.008,6,13,3735,7,497,1.0,125.0,125.0,6,3238,1.0,1470.0,1459.0
0.13,6,10,1506,5,395,27.0,127.0,127.0,5,1111,30.0,843.0,843.0
0.004,17,2,148,1,60,0.0,32.0,32.0,1,88,0.0,60.0,60.0
0.005,17,4,284,2,120,0.0,32.0,32.0,2,164,0.0,60.0,54.0
0.003,17,2,136,1,60,0.0,32.0,32.0,1,76,0.0,48.0,48.0
0.012,6,10,1990,5,911,2.0,643.0,643.0,5,1079,2.0,811.0,811.0
0.004,6,14,3742,7,452,0.0,80.0,80.0,7,3290,0.0,1448.0,972.0
0.01,6,10,1989,5,910,2.0,642.0,642.0,5,1079,2.0,811.0,811.0
0.004,6,10,1779,5,928,1.0,660.0,660.0,5,851,1.0,583.0,583.0
0.013,6,13,3735,7,497,2.0,125.0,125.0,6,3238,2.0,1470.0,1459.0
0.01,17,2,170,1,65,0.0,37.0,37.0,1,105,0.0,77.0,77.0
0.169,17,2,152,1,76,0.0,48.0,48.0,1,76,0.0,48.0,48.0
15.141,17,23,8263,10,3781,1679.0,1350.0,350.0,13,4482,1259.0,1350.0,316.0
0.039,17,2,148,1,60,0.0,32.0,32.0,1,88,0.0,60.0,60.0
0.08,6,10,1506,5,395,16.0,127.0,127.0,5,1111,17.0,843.0,843.0
0.011,6,10,1983,5,910,2.0,642.0,642.0,5,1073,2.0,805.0,805.0
0.004,6,10,2007,5,928,1.0,660.0,660.0,5,1079,1.0,811.0,811.0
0.01,6,11,1729,6,879,1.0,559.0,559.0,5,850,2.0,582.0,582.0
0.003,17,2,148,1,60,0.0,32.0,32.0,1,88,0.0,60.0,60.0
0.077,6,10,1506,5,395,17.0,127.0,127.0,5,1111,17.0,843.0,843.0
0.005,6,10,2007,5,928,1.0,660.0,660.0,5,1079,1.0,811.0,811.0
0.004,6,10,2000,5,927,1.0,659.0,659.0,5,1073,1.0,805.0,805.0
40.081,17,10,676,5,460,10017.0,104.0,64.0,5,216,10019.0,20.0,15.0
0.006,6,10,1547,5,764,1.0,496.0,496.0,5,783,1.0,515.0,515.0
0.069,6,10,1506,5,395,16.0,127.0,127.0,5,1111,15.0,843.0,843.0
0.118,6,10,1506,5,395,21.0,127.0,127.0,5,1111,28.0,843.0,843.0
300.373,6,16,2170,9,684,37526.0,146.0,146.0,7,1486,50034.0,419.0,398.0
170.45,17,74,10177,37,2456,4734.0,44.0,38.0,37,7721,4734.0,239.0,180.0
0.006,6,13,3747,7,509,1.0,137.0,137.0,6,3238,1.0,1470.0,1459.0
0.01,6,10,1989,5,910,2.0,642.0,642.0,5,1079,2.0,811.0,811.0
0.006,6,10,2006,5,927,1.0,659.0,659.0,5,1079,1.0,811.0,811.0
175.524,17,72,10194,36,2397,5014.0,44.0,38.0,36,7797,5014.0,239.0,188.0
240.091,6,16,4481,9,963,30011.0,238.0,166.0,7,3518,40014.0,1402.0,786.0
0.039,17,4,284,2,120,0.0,32.0,32.0,2,164,35.0,60.0,54.0
0.114,6,10,1506,5,395,23.0,127.0,127.0,5,1111,25.0,843.0,843.0
312.904,17,20,1124,10,716,34752.0,48.0,43.0,10,408,34752.0,20.0,12.0
0.005,17,2,170,1,65,0.0,37.0,37.0,1,105,0.0,77.0,77.0
0.005,6,10,2006,5,927,1.0,659.0,659.0,5,1079,1.0,811.0,811.0
242.186,6,310,343501,123,17902,1985.0,2736.0,959.0,187,325599,1302.0,2804.0,1784.0
0.01,6,10,1989,5,910,2.0,642.0,642.0,5,1079,2.0,811.0,811.0
0.128,17,2,80,1,32,0.0,4.0,4.0,1,48,0.0,20.0,20.0
0.002,17,2,136,1,60,0.0,32.0,32.0,1,76,0.0,48.0,48.0
0.005,6,10,2000,5,927,1.0,659.0,659.0,5,1073,1.0,805.0,805.0
0.078,6,10,1506,5,395,18.0,127.0,127.0,5,1111,17.0,843.0,843.0
240.298,6,33,9999,16,2091,16019.0,539.0,250.0,17,7908,15018.0,1402.0,638.0
0.013,6,10,1989,5,910,3.0,642.0,642.0,5,1079,3.0,811.0,811.0
0.341,17,48,27209,26,23461,13.0,1350.0,874.0,22,3748,14.0,1350.0,142.0
0.003,17,4,284,2,120,0.0,32.0,32.0,2,164,0.0,60.0,54.0
0.114,17,2,193,1,71,0.0,43.0,43.0,1,122,0.0,94.0,94.0
0.125,6,10,1506,5,395,28.0,127.0,127.0,5,1111,29.0,843.0,843.0
0.008,6,10,1854,5,889,2.0,621.0,621.0,5,965,2.0,697.0,697.0
0.007,6,10,2006,5,927,1.0,659.0,659.0,5,1079,1.0,811.0,811.0
40.052,17,10,676,5,460,10012.0,104.0,64.0,5,216,10012.0,20.0,15.0
0.006,6,10,1547,5,764,1.0,496.0,496.0,5,783,1.0,515.0,515.0
0.06,17,2,152,1,76,0.0,48.0,48.0,1,76,0.0,48.0,48.0
0.17,6,3,453,2,321,170.0,241.0,241.0,1,132,0.0,92.0,92.0
0.005,6,13,3747,7,509,0.0,137.0,137.0,6,3238,0.0,1470.0,1459.0
0.011,6,10,1989,5,910,2.0,642.0,642.0,5,1079,2.0,811.0,811.0
0.009,6,10,1762,5,911,2.0,643.0,643.0,5,851,2.0,583.0,583.0
0.015,6,10,1989,5,910,3.0,642.0,642.0,5,1079,3.0,811.0,811.0
0.07,6,10,1506,5,395,15.0,127.0,127.0,5,1111,13.0,843.0,843.0
0.017,6,10,1989,5,910,4.0,642.0,642.0,5,1079,4.0,811.0,811.0
0.005,6,10,2000,5,927,1.0,659.0,659.0,5,1073,1.0,805.0,805.0
0.128,6,10,1506,5,395,29.0,127.0,127.0,5,1111,29.0,843.0,843.0
0.005,6,10,2007,5,928,1.0,660.0,660.0,5,1079,1.0,811.0,811.0
0.166,17,2,152,1,76,0.0,48.0,48.0,1,76,0.0,48.0,48.0
40.08,17,10,676,5,460,10018.0,104.0,64.0,5,216,10019.0,20.0,15.0
0.001,17,2,180,1,66,0.0,38.0,38.0,1,114,0.0,86.0,86.0
0.09,6,10,1506,5,395,20.0,127.0,127.0,5,1111,19.0,843.0,843.0
51.193,6,58,28565,29,22378,336.0,2720.0,1513.0,29,6187,1822.0,1360.0,358.0
308.965,17,20,1124,10,716,34322.0,48.0,43.0,10,408,34319.0,20.0,12.0
0.005,6,10,1774,5,923,1.0,655.0,655.0,5,851,1.0,583.0,583.0
0.006,6,10,1989,5,927,1.0,659.0,659.0,5,1062,1.0,794.0,794.0
0.011,6,10,1989,5,910,2.0,642.0,642.0,5,1079,2.0,811.0,811.0
0.011,6,10,1989,5,910,2.0,642.0,642.0,5,1079,2.0,811.0,811.0
240.078,6,20,4874,11,941,24007.0,180.0,93.0,9,3933,30008.0,1593.0,576.0
0.007,17,2,179,1,71,0.0,43.0,43.0,1,108,0.0,80.0,80.0
0.005,6,10,2000,5,927,1.0,659.0,659.0,5,1073,1.0,805.0,805.0
0.021,6,10,1983,5,910,5.0,642.0,642.0,5,1073,5.0,805.0,805.0
0.08,6,10,1506,5,395,15.0,127.0,127.0,5,1111,16.0,843.0,843.0
0.015,6,10,1990,5,911,3.0,643.0,643.0,5,1079,3.0,811.0,811.0
0.131,6,10,1506,5,395,31.0,127.0,127.0,5,1111,23.0,843.0,843.0
0.007,17,2,154,1,69,0.0,41.0,41.0,1,85,0.0,57.0,57.0
0.011,6,10,1990,5,911,2.0,643.0,643.0,5,1079,2.0,811.0,811.0
0.175,17,2,152,1,76,0.0,48.0,48.0,1,76,0.0,48.0,48.0
0.004,6,11,2059,6,980,0.0,660.0,660.0,5,1079,1.0,811.0,811.0
0.109,6,20,9244,11,860,10.0,280.0,280.0,9,8384,13.0,1402.0,1318.0
308.717,17,20,1124,10,716,34285.0,48.0,43.0,10,408,34286.0,20.0,12.0
0.014,6,10,1990,5,911,3.0,643.0,643.0,5,1079,3.0,811.0,811.0
0.008,6,11,2024,6,962,1.0,642.0,642.0,5,1062,2.0,794.0,794.0
0.006,6,10,1689,5,839,1.0,571.0,571.0,5,850,1.0,582.0,582.0
0.004,17,2,132,1,58,0.0,30.0,30.0,1,74,0.0,46.0,46.0
0.095,6,10,1506,5,395,19.0,127.0,127.0,5,1111,23.0,843.0,843.0
0.006,6,10,1547,5,764,1.0,496.0,496.0,5,783,1.0,515.0,515.0
40.06,17,10,676,5,460,10012.0,104.0,64.0,5,216,10014.0,20.0,15.0
120.466,6,57,19083,33,4856,3764.0,1054.0,209.0,24,14227,5237.0,2804.0,926.0
0.004,17,2,148,1,60,0.0,32.0,32.0,1,88,0.0,60.0,60.0
0.009,6,10,1989,5,910,2.0,642.0,642.0,5,1079,2.0,811.0,811.0
0.009,6,10,1989,5,910,2.0,642.0,642.0,5,1079,2.0,811.0,811.0
0.005,6,10,2006,5,927,1.0,659.0,659.0,5,1079,1.0,811.0,811.0
0.015,6,10,1972,5,910,3.0,642.0,642.0,5,1062,3.0,794.0,794.0
1770.468,6,83,4368,42,2210,43181.0,26.0,26.0,41,2158,44260.0,26.0,26.0
0.17,6,3,453,2,321,170.0,241.0,241.0,1,132,0.0,92.0,92.0
0.092,6,10,1506,5,395,19.0,127.0,127.0,5,1111,20.0,843.0,843.0
0.042,6,11,2035,6,962,8.0,642.0,642.0,5,1073,10.0,805.0,805.0
0.01,6,10,1972,5,910,2.0,642.0,642.0,5,1062,2.0,794.0,794.0
0.092,6,10,1506,5,395,18.0,127.0,127.0,5,1111,22.0,843.0,843.0
0.004,17,2,187,1,71,0.0,43.0,43.0,1,116,0.0,88.0,88.0
0.004,6,10,2006,5,927,1.0,659.0,659.0,5,1079,1.0,811.0,811.0
0.005,6,10,2007,5,928,1.0,660.0,660.0,5,1079,1.0,811.0,811.0
0.009,6,13,3735,7,497,1.0,125.0,125.0,6,3238,1.0,1470.0,1459.0
0.005,6,10,2006,5,927,1.0,659.0,659.0,5,1079,1.0,811.0,811.0
11.148,17,28,4419,14,1995,844.0,270.0,114.0,14,2424,844.0,587.0,145.0
0.013,6,13,3735,7,497,2.0,125.0,125.0,6,3238,2.0,1470.0,1459.0
0.004,6,10,1702,5,863,1.0,595.0,595.0,5,839,0.0,571.0,571.0
0.012,6,10,1762,5,911,2.0,643.0,643.0,5,851,3.0,583.0,583.0
0.015,6,10,1972,5,910,3.0,642.0,642.0,5,1062,3.0,794.0,794.0
0.005,6,10,2000,5,927,1.0,659.0,659.0,5,1073,1.0,805.0,805.0
0.02,6,10,1677,5,827,4.0,559.0,559.0,5,850,4.0,582.0,582.0
0.041,6,10,1631,5,848,10.0,580.0,580.0,5,783,10.0,515.0,515.0
0.006,6,10,2007,5,928,1.0,660.0,660.0,5,1079,1.0,811.0,811.0
0.015,6,10,1989,5,910,3.0,642.0,642.0,5,1079,3.0,811.0,811.0
0.534,6,10,1210,6,443,106.0,123.0,123.0,4,767,133.0,551.0,551.0
0.006,6,10,1547,5,764,1.0,496.0,496.0,5,783,1.0,515.0,515.0
0.073,6,10,1506,5,395,14.0,127.0,127.0,5,1111,15.0,843.0,843.0
0.213,6,16,2777,8,1395,30.0,533.0,323.0,8,1382,19.0,529.0,239.0
0.011,6,10,1983,5,910,2.0,642.0,642.0,5,1073,2.0,805.0,805.0
240.238,6,39,7003,19,3330,13346.0,880.0,333.0,20,3673,12641.0,1306.0,328.0
0.083,6,10,1506,5,395,18.0,127.0,127.0,5,1111,20.0,843.0,843.0
0.008,6,10,1989,5,910,2.0,642.0,642.0,5,1079,2.0,811.0,811.0
0.003,17,2,412,1,61,0.0,33.0,33.0,1,351,0.0,323.0,323.0
0.008,6,10,1689,5,839,1.0,571.0,571.0,5,850,1.0,582.0,582.0
0.009,6,10,1989,5,910,2.0,642.0,642.0,5,1079,2.0,811.0,811.0
0.005,6,13,3747,7,509,0.0,137.0,137.0,6,3238,0.0,1470.0,1459.0
0.004,6,10,2007,5,928,1.0,660.0,660.0,5,1079,1.0,811.0,811.0
0.022,6,10,1989,5,910,5.0,642.0,642.0,5,1079,5.0,811.0,811.0
0.013,6,10,1989,5,910,3.0,642.0,642.0,5,1079,3.0,811.0,811.0
167.101,17,72,10334,36,2402,4774.0,44.0,38.0,36,7932,4774.0,239.0,192.0
0.009,6,12,1926,6,1189,1.0,659.0,434.0,6,737,1.0,417.0,417.0
0.005,6,10,1989,5,927,1.0,659.0,659.0,5,1062,1.0,794.0,794.0
0.089,6,10,1506,5,395,16.0,127.0,127.0,5,1111,21.0,843.0,843.0
0.009,6,12,1926,6,1189,1.0,659.0,434.0,6,737,1.0,417.0,417.0
40.065,17,10,676,5,460,10013.0,104.0,64.0,5,216,10015.0,20.0,15.0
0.004,17,2,396,1,61,0.0,33.0,33.0,1,335,0.0,307.0,307.0
40.07,17,10,676,5,460,10016.0,104.0,64.0,5,216,10016.0,20.0,15.0
0.006,17,2,140,1,62,0.0,34.0,34.0,1,78,0.0,50.0,50.0
40.067,17,10,676,5,460,10014.0,104.0,64.0,5,216,10015.0,20.0,15.0
0.013,6,10,1631,5,848,3.0,580.0,580.0,5,783,3.0,515.0,515.0
0.016,17,2,198,1,91,0.0,63.0,63.0,1,107,0.0,79.0,79.0
0.005,6,13,3747,7,509,0.0,137.0,137.0,6,3238,0.0,1470.0,1459.0
0.002,17,2,152,1,76,0.0,48.0,48.0,1,76,0.0,48.0,48.0
0.015,6,10,1972,5,910,3.0,642.0,642.0,5,1062,3.0,794.0,794.0
360.034,6,21,3981,13,3142,30002.0,494.0,494.0,8,839,51432.0,83.0,83.0
0.005,6,10,1854,5,889,1.0,621.0,621.0,5,965,1.0,697.0,697.0
0.006,6,10,1643,5,860,1.0,592.0,592.0,5,783,1.0,515.0,515.0
308.415,17,20,1124,10,716,34261.0,48.0,43.0,10,408,34261.0,20.0,12.0
0.006,6,10,2000,5,927,1.0,659.0,659.0,5,1073,1.0,805.0,805.0
0.102,6,10,1506,5,395,17.0,127.0,127.0,5,1111,23.0,843.0,843.0
0.111,6,10,1506,5,395,24.0,127.0,127.0,5,1111,21.0,843.0,843.0
0.11,6,10,1506,5,395,24.0,127.0,127.0,5,1111,24.0,843.0,843.0
0.005,6,10,1989,5,927,1.0,659.0,659.0,5,1062,1.0,794.0,794.0
0.028,6,10,1990,5,911,6.0,643.0,643.0,5,1079,7.0,811.0,811.0
0.006,6,10,1547,5,764,1.0,496.0,496.0,5,783,1.0,515.0,515.0
0.004,6,10,2007,5,928,1.0,660.0,660.0,5,1079,1.0,811.0,811.0
40.069,17,10,676,5,460,10016.0,104.0,64.0,5,216,10016.0,20.0,15.0
0.005,6,10,2006,5,927,1.0,659.0,659.0,5,1079,1.0,811.0,811.0
0.006,6,10,1689,5,839,1.0,571.0,571.0,5,850,1.0,582.0,582.0
0.018,6,13,3735,7,497,3.0,125.0,125.0,6,3238,3.0,1470.0,1459.0
0.108,6,10,1506,5,395,25.0,127.0,127.0,5,1111,22.0,843.0,843.0
0.167,6,10,1506,5,395,33.0,127.0,127.0,5,1111,38.0,843.0,843.0
0.013,6,10,1989,5,910,3.0,642.0,642.0,5,1079,3.0,811.0,811.0
0.113,6,10,1506,5,395,25.0,127.0,127.0,5,1111,23.0,843.0,843.0
169.494,6,42,13468,22,7641,8071.0,1935.0,1121.0,20,5827,464.0,2667.0,385.0
0.004,17,2,148,1,60,0.0,32.0,32.0,1,88,0.0,60.0,60.0
0.108,6,10,1506,5,395,22.0,127.0,127.0,5,1111,21.0,843.0,843.0
0.011,6,10,1990,5,911,2.0,643.0,643.0,5,1079,2.0,811.0,811.0
40.085,17,10,676,5,460,10017.0,104.0,64.0,5,216,10019.0,20.0,15.0
308.378,17,18,1008,9,640,38531.0,48.0,43.0,9,368,38531.0,20.0,12.0
0.005,6,10,1779,5,928,1.0,660.0,660.0,5,851,1.0,583.0,583.0
0.008,6,10,1989,5,910,2.0,642.0,642.0,5,1079,1.0,811.0,811.0
0.005,6,10,2007,5,928,1.0,660.0,660.0,5,1079,1.0,811.0,811.0
0.097,6,10,1506,5,395,21.0,127.0,127.0,5,1111,22.0,843.0,843.0
0.004,17,2,148,1,60,0.0,32.0,32.0,1,88,0.0,60.0,60.0
15.082,17,15,8288,8,6030,2150.0,1350.0,725.0,7,2258,2508.0,1350.0,294.0
0.009,6,10,1990,5,911,2.0,643.0,643.0,5,1079,2.0,811.0,811.0
240.015,6,9,787,5,488,60003.0,232.0,232.0,4,299,80004.0,83.0,83.0
0.005,6,10,2000,5,927,1.0,659.0,659.0,5,1073,1.0,805.0,805.0
0.014,6,10,1677,5,827,3.0,559.0,559.0,5,850,3.0,582.0,582.0
0.004,6,10,2000,5,927,1.0,659.0,659.0,5,1073,1.0,805.0,805.0
0.076,6,10,1506,5,395,15.0,127.0,127.0,5,1111,17.0,843.0,843.0
0.1,6,10,1506,5,395,20.0,127.0,127.0,5,1111,22.0,843.0,843.0
0.069,6,10,1506,5,395,15.0,127.0,127.0,5,1111,14.0,843.0,843.0
0.013,6,10,1972,5,910,3.0,642.0,642.0,5,1062,3.0,794.0,794.0
40.069,17,10,676,5,460,10016.0,104.0,64.0,5,216,10016.0,20.0,15.0
0.068,6,10,1506,5,395,15.0,127.0,127.0,5,1111,15.0,843.0,843.0
0.006,6,10,2007,5,928,1.0,660.0,660.0,5,1079,1.0,811.0,811.0
15.123,17,19,13437,9,8280,1886.0,1350.0,892.0,10,5157,1677.0,1350.0,487.0
0.155,6,126,122803,64,4975,2.0,517.0,327.0,62,117828,2.0,2804.0,2046.0
0.005,17,2,293,1,73,0.0,45.0,45.0,1,220,0.0,192.0,192.0
0.094,6,10,1506,5,395,22.0,127.0,127.0,5,1111,22.0,843.0,843.0
0.129,6,11,1558,6,447,23.0,127.0,127.0,5,1111,30.0,843.0,843.0
0.008,6,10,1547,5,764,2.0,496.0,496.0,5,783,1.0,515.0,515.0
0.006,6,10,1689,5,839,1.0,571.0,571.0,5,850,1.0,582.0,582.0
0.078,6,10,1506,5,395,16.0,127.0,127.0,5,1111,16.0,843.0,843.0
0.011,6,10,1762,5,911,2.0,643.0,643.0,5,851,2.0,583.0,583.0
0.006,6,10,1643,5,860,1.0,592.0,592.0,5,783,1.0,515.0,515.0
40.078,17,10,676,5,460,10016.0,104.0,64.0,5,216,10018.0,20.0,15.0
0.177,6,10,1506,5,395,41.0,127.0,127.0,5,1111,40.0,843.0,843.0
0.076,6,10,1506,5,395,16.0,127.0,127.0,5,1111,14.0,843.0,843.0
0.004,6,10,2007,5,928,1.0,660.0,660.0,5,1079,1.0,811.0,811.0
0.276,17,44,28006,26,24786,11.0,1350.0,925.0,18,3220,13.0,1350.0,150.0
0.012,6,10,1972,5,910,2.0,642.0,642.0,5,1062,3.0,794.0,794.0
0.004,17,2,185,1,73,0.0,45.0,45.0,1,112,0.0,84.0,84.0
0.001,17,2,180,1,66,0.0,38.0,38.0,1,114,0.0,86.0,86.0
0.005,6,13,3747,7,509,0.0,137.0,137.0,6,3238,1.0,1470.0,1459.0
0.004,6,10,1702,5,863,1.0,595.0,595.0,5,839,1.0,571.0,571.0
0.016,6,10,1990,5,911,4.0,643.0,643.0,5,1079,3.0,811.0,811.0
0.209,6,16,2777,8,1395,29.0,533.0,323.0,8,1382,18.0,529.0,239.0
0.005,6,10,1643,5,860,1.0,592.0,592.0,5,783,1.0,515.0,515.0
0.01,6,10,1983,5,910,2.0,642.0,642.0,5,1073,2.0,805.0,805.0
0.005,6,10,2006,5,927,1.0,659.0,659.0,5,1079,1.0,811.0,811.0
0.009,6,10,1990,5,911,2.0,643.0,643.0,5,1079,2.0,811.0,811.0
0.009,6,10,1854,5,889,2.0,621.0,621.0,5,965,2.0,697.0,697.0
0.006,6,10,1547,5,764,1.0,496.0,496.0,5,783,1.0,515.0,515.0
0.004,6,13,3690,7,452,0.0,80.0,80.0,6,3238,0.0,1470.0,1459.0
0.016,6,14,3787,7,497,2.0,125.0,125.0,7,3290,2.0,1448.0,972.0
0.019,6,10,1972,5,910,4.0,642.0,642.0,5,1062,4.0,794.0,794.0
0.021,6,10,1631,5,848,5.0,580.0,580.0,5,783,5.0,515.0,515.0
0.039,17,2,182,1,65,0.0,37.0,37.0,1,117,0.0,89.0,89.0
0.014,6,10,1631,5,848,3.0,580.0,580.0,5,783,3.0,515.0,515.0
0.006,6,10,1689,5,839,1.0,571.0,571.0,5,850,1.0,582.0,582.0
0.066,17,8,3613,4,1874,22.0,1350.0,440.0,4,1739,11.0,1350.0,406.0
0.098,6,10,1506,5,395,20.0,127.0,127.0,5,1111,21.0,843.0,843.0
0.004,6,10,2006,5,927,1.0,659.0,659.0,5,1079,1.0,811.0,811.0
0.004,17,4,284,2,120,1.0,32.0,32.0,2,164,0.0,60.0,54.0
0.113,6,10,1506,5,395,21.0,127.0,127.0,5,1111,25.0,843.0,843.0
0.001,17,2,180,1,66,0.0,38.0,38.0,1,114,0.0,86.0,86.0
1756.068,6,105,6270,60,3525,29763.0,27.0,27.0,45,2745,39909.0,27.0,27.0
0.036,6,10,1972,5,910,9.0,642.0,642.0,5,1062,8.0,794.0,794.0
0.039,17,4,284,2,120,1.0,32.0,32.0,2,164,35.0,60.0,54.0
0.063,6,10,1506,5,395,14.0,127.0,127.0,5,1111,14.0,843.0,843.0
308.543,17,20,1124,10,716,34268.0,48.0,43.0,10,408,34268.0,20.0,12.0
0.054,17,2,152,1,76,0.0,48.0,48.0,1,76,0.0,48.0,48.0
0.015,6,10,1989,5,910,3.0,642.0,642.0,5,1079,3.0,811.0,811.0
0.081,6,10,1506,5,395,17.0,127.0,127.0,5,1111,18.0,843.0,843.0
0.001,17,2,180,1,65,0.0,37.0,37.0,1,115,0.0,87.0,87.0
0.014,6,10,1989,5,910,3.0,642.0,642.0,5,1079,3.0,811.0,811.0
0.073,6,10,1506,5,395,14.0,127.0,127.0,5,1111,16.0,843.0,843.0
0.006,17,2,140,1,62,0.0,34.0,34.0,1,78,0.0,50.0,50.0
15.073,17,15,9238,8,6902,2149.0,1350.0,834.0,7,2336,2507.0,1350.0,305.0
0.005,6,10,1547,5,764,1.0,496.0,496.0,5,783,1.0,515.0,515.0
0.012,6,10,1990,5,911,3.0,643.0,643.0,5,1079,3.0,811.0,811.0
0.005,6,10,2000,5,927,1.0,659.0,659.0,5,1073,1.0,805.0,805.0
0.004,6,10,1989,5,927,1.0,659.0,659.0,5,1062,1.0,794.0,794.0
0.005,6,10,2000,5,927,1.0,659.0,659.0,5,1073,1.0,805.0,805.0
0.077,6,10,1506,5,395,16.0,127.0,127.0,5,1111,18.0,843.0,843.0
0.012,6,10,1972,5,910,2.0,642.0,642.0,5,1062,3.0,794.0,794.0
0.005,17,2,164,1,74,0.0,46.0,46.0,1,90,0.0,62.0,62.0
0.043,17,2,152,1,76,0.0,48.0,48.0,1,76,0.0,48.0,48.0
0.005,6,13,3690,7,452,0.0,80.0,80.0,6,3238,1.0,1470.0,1459.0
0.005,6,10,2006,5,927,1.0,659.0,659.0,5,1079,1.0,811.0,811.0
0.008,6,10,1989,5,910,2.0,642.0,642.0,5,1079,1.0,811.0,811.0
0.079,6,10,1506,5,395,18.0,127.0,127.0,5,1111,18.0,843.0,843.0
0.173,6,10,1506,5,395,41.0,127.0,127.0,5,1111,39.0,843.0,843.0
0.011,6,12,1926,6,1189,2.0,659.0,434.0,6,737,2.0,417.0,417.0
10.892,17,28,4423,14,1994,829.0,269.0,114.0,14,2429,828.0,588.0,145.0
0.001,17,2,144,1,64,0.0,36.0,36.0,1,80,0.0,52.0,52.0
0.011,6,10,1972,5,910,2.0,642.0,642.0,5,1062,2.0,794.0,794.0
300.315,6,16,2170,9,684,37518.0,146.0,146.0,7,1486,50024.0,419.0,398.0
0.005,17,2,170,1,65,0.0,37.0,37.0,1,105,0.0,77.0,77.0
0.068,6,10,1506,5,395,15.0,127.0,127.0,5,1111,14.0,843.0,843.0
0.014,6,10,1972,5,910,3.0,642.0,642.0,5,1062,3.0,794.0,794.0
0.082,6,10,1506,5,395,19.0,127.0,127.0,5,1111,19.0,843.0,843.0
0.134,6,10,1506,5,395,29.0,127.0,127.0,5,1111,32.0,843.0,843.0
0.042,6,10,1972,5,910,10.0,642.0,642.0,5,1062,10.0,794.0,794.0
0.072,17,2,234,1,61,0.0,33.0,33.0,1,173,0.0,145.0,145.0
0.003,17,2,148,1,60,0.0,32.0,32.0,1,88,0.0,60.0,60.0
0.005,17,2,164,1,74,0.0,46.0,46.0,1,90,0.0,62.0,62.0
0.004,6,10,2006,5,927,1.0,659.0,659.0,5,1079,1.0,811.0,811.0
0.006,6,10,1547,5,764,1.0,496.0,496.0,5,783,1.0,515.0,515.0
0.009,6,10,1989,5,910,2.0,642.0,642.0,5,1079,2.0,811.0,811.0
0.007,6,10,1972,5,910,1.0,642.0,642.0,5,1062,1.0,794.0,794.0
10.807,17,28,4420,14,1993,822.0,268.0,114.0,14,2427,822.0,586.0,145.0
0.128,6,10,1506,5,395,27.0,127.0,127.0,5,1111,30.0,843.0,843.0
0.084,6,10,1506,5,395,19.0,127.0,127.0,5,1111,18.0,843.0,843.0
0.019,6,14,3787,7,497,3.0,125.0,125.0,7,3290,3.0,1448.0,972.0
0.006,6,10,1643,5,860,1.0,592.0,592.0,5,783,1.0,515.0,515.0
0.066,17,8,3613,4,1874,22.0,1350.0,440.0,4,1739,11.0,1350.0,406.0
1770.307,17,92,8096,46,4048,39340.0,60.0,60.0,46,4048,39340.0,60.0,60.0
0.115,6,10,1506,5,395,25.0,127.0,127.0,5,1111,23.0,843.0,843.0
294.786,6,315,344257,120,17800,2477.0,2736.0,889.0,195,326457,1519.0,2804.0,1757.0
0.287,17,39,20136,21,17032,14.0,1350.0,783.0,18,3104,12.0,1350.0,144.0
329.677,17,20,1124,10,716,36616.0,48.0,43.0,10,408,36616.0,20.0,12.0
0.005,17,2,169,1,62,0.0,34.0,34.0,1,107,0.0,79.0,79.0
15.076,17,15,9238,8,6902,2149.0,1350.0,834.0,7,2336,2507.0,1350.0,305.0
0.004,6,10,2006,5,927,1.0,659.0,659.0,5,1079,1.0,811.0,811.0
0.01,6,10,1983,5,910,2.0,642.0,642.0,5,1073,2.0,805.0,805.0
0.005,6,13,3747,7,509,0.0,137.0,137.0,6,3238,1.0,1470.0,1459.0
0.009,6,13,3735,7,497,1.0,125.0,125.0,6,3238,1.0,1470.0,1459.0
0.098,6,10,1506,5,395,21.0,127.0,127.0,5,1111,23.0,843.0,843.0
0.006,17,2,230,1,68,0.0,40.0,40.0,1,162,0.0,134.0,134.0
40.054,17,10,676,5,460,10012.0,104.0,64.0,5,216,10012.0,20.0,15.0
0.009,6,10,1990,5,911,2.0,643.0,643.0,5,1079,2.0,811.0,811.0
300.323,6,16,2170,9,684,37519.0,146.0,146.0,7,1486,50024.0,419.0,398.0
0.813,6,25,5555,12,1445,62.0,267.0,136.0,13,4110,57.0,1414.0,597.0
1760.875,6,455,67260,260,35771,6798.0,613.0,193.0,195,31489,9076.0,613.0,147.0
0.085,6,10,1506,5,395,17.0,127.0,127.0,5,1111,19.0,843.0,843.0
0.005,17,2,179,1,71,0.0,43.0,43.0,1,108,0.0,80.0,80.0
0.044,6,10,1631,5,848,10.0,580.0,580.0,5,783,10.0,515.0,515.0
0.004,17,4,284,2,120,0.0,32.0,32.0,2,164,0.0,60.0,54.0
175.372,17,78,11084,39,2593,4614.0,44.0,38.0,39,8491,4615.0,260.0,189.0
0.006,6,10,1689,5,839,1.0,571.0,571.0,5,850,1.0,582.0,582.0
361.8,6,19,1689,15,978,25842.0,190.0,190.0,4,711,80015.0,495.0,495.0
0.012,17,2,148,1,60,0.0,32.0,32.0,1,88,0.0,60.0,60.0
0.011,6,10,1989,5,910,2.0,642.0,642.0,5,1079,2.0,811.0,811.0
0.015,6,10,1990,5,911,3.0,643.0,643.0,5,1079,3.0,811.0,811.0
0.005,6,10,2006,5,927,1.0,659.0,659.0,5,1079,1.0,811.0,811.0
0.004,17,2,136,1,60,0.0,32.0,32.0,1,76,0.0,48.0,48.0
240.088,6,16,4480,9,963,30011.0,238.0,166.0,7,3517,40014.0,1402.0,786.0
0.004,17,2,170,1,65,0.0,37.0,37.0,1,105,0.0,77.0,77.0
0.078,6,10,1506,5,395,17.0,127.0,127.0,5,1111,15.0,843.0,843.0
0.005,6,10,1989,5,927,1.0,659.0,659.0,5,1062,1.0,794.0,794.0
0.008,6,10,1677,5,827,2.0,559.0,559.0,5,850,2.0,582.0,582.0
0.016,6,10,1990,5,911,4.0,643.0,643.0,5,1079,3.0,811.0,811.0
0.012,6,10,1972,5,910,3.0,642.0,642.0,5,1062,3.0,794.0,794.0
240.085,6,16,4481,9,963,30010.0,238.0,166.0,7,3518,40013.0,1402.0,786.0
0.014,6,10,1972,5,910,3.0,642.0,642.0,5,1062,3.0,794.0,794.0
0.006,6,10,1547,5,764,1.0,496.0,496.0,5,783,1.0,515.0,515.0
0.006,6,13,3747,7,509,0.0,137.0,137.0,6,3238,1.0,1470.0,1459.0
0.005,6,10,1689,5,839,1.0,571.0,571.0,5,850,1.0,582.0,582.0
40.059,17,10,676,5,460,10013.0,104.0,64.0,5,216,10014.0,20.0,15.0
40.061,17,10,676,5,460,10013.0,104.0,64.0,5,216,10014.0,20.0,15.0
40.055,17,10,676,5,460,10011.0,104.0,64.0,5,216,10013.0,20.0,15.0
0.005,17,2,170,1,65,0.0,37.0,37.0,1,105,0.0,77.0,77.0
0.112,6,10,1506,5,395,25.0,127.0,127.0,5,1111,26.0,843.0,843.0
0.006,6,10,1547,5,764,1.0,496.0,496.0,5,783,1.0,515.0,515.0
0.001,17,2,180,1,66,0.0,38.0,38.0,1,114,0.0,86.0,86.0
0.005,17,2,170,1,65,0.0,37.0,37.0,1,105,0.0,77.0,77.0
0.003,17,2,142,1,63,0.0,35.0,35.0,1,79,0.0,51.0,51.0
0.058,6,10,1506,5,395,13.0,127.0,127.0,5,1111,13.0,843.0,843.0
0.011,17,2,185,1,73,0.0,45.0,45.0,1,112,0.0,84.0,84.0
299.952,6,39,12453,20,6895,15778.0,4080.0,1212.0,19,5558,16654.0,2667.0,435.0
0.008,17,2,194,1,59,0.0,31.0,31.0,1,135,0.0,107.0,107.0
0.006,6,10,1547,5,764,1.0,496.0,496.0,5,783,1.0,515.0,515.0
0.005,17,2,152,1,68,0.0,40.0,40.0,1,84,0.0,56.0,56.0
0.06,6,10,1506,5,395,14.0,127.0,127.0,5,1111,13.0,843.0,843.0
0.083,6,10,1506,5,395,18.0,127.0,127.0,5,1111,18.0,843.0,843.0
0.007,17,2,299,1,65,0.0,37.0,37.0,1,234,0.0,206.0,206.0
0.001,17,2,166,1,75,0.0,47.0,47.0,1,91,0.0,63.0,63.0
0.071,6,10,1506,5,395,14.0,127.0,127.0,5,1111,16.0,843.0,843.0
0.006,6,10,1547,5,764,1.0,496.0,496.0,5,783,1.0,515.0,515.0
240.673,6,35,8926,18,2073,14155.0,694.0,225.0,17,6853,15039.0,1402.0,597.0
0.005,6,10,2006,5,927,1.0,659.0,659.0,5,1079,1.0,811.0,811.0
0.01,6,10,1990,5,911,2.0,643.0,643.0,5,1079,2.0,811.0,811.0
0.006,6,10,2006,5,927,1.0,659.0,659.0,5,1079,1.0,811.0,811.0
0.133,6,10,1506,5,395,23.0,127.0,127.0,5,1111,29.0,843.0,843.0
0.008,6,10,1762,5,911,2.0,643.0,643.0,5,851,1.0,583.0,583.0
0.005,17,2,169,1,62,0.0,34.0,34.0,1,107,0.0,79.0,79.0
0.01,6,10,1989,5,910,2.0,642.0,642.0,5,1079,2.0,811.0,811.0
0.005,6,14,3799,7,509,0.0,137.0,137.0,7,3290,0.0,1448.0,972.0
0.008,17,2,194,1,59,0.0,31.0,31.0,1,135,0.0,107.0,107.0
0.1,6,10,1506,5,395,23.0,127.0,127.0,5,1111,23.0,843.0,843.0
40.053,17,10,676,5,460,10012.0,104.0,64.0,5,216,10012.0,20.0,15.0
0.008,6,10,1990,5,911,2.0,643.0,643.0,5,1079,2.0,811.0,811.0
0.037,17,4,284,2,120,0.0,32.0,32.0,2,164,34.0,60.0,54.0
0.008,6,10,1989,5,910,2.0,642.0,642.0,5,1079,2.0,811.0,811.0
0.089,6,10,1506,5,395,20.0,127.0,127.0,5,1111,20.0,843.0,843.0
0.011,6,10,1677,5,827,2.0,559.0,559.0,5,850,2.0,582.0,582.0
0.01,6,10,1990,5,911,2.0,643.0,643.0,5,1079,2.0,811.0,811.0
0.092,6,10,1506,5,395,21.0,127.0,127.0,5,1111,17.0,843.0,843.0
0.166,6,10,1506,5,395,39.0,127.0,127.0,5,1111,40.0,843.0,843.0
0.007,6,10,1989,5,927,1.0,659.0,659.0,5,1062,1.0,794.0,794.0
40.055,17,10,676,5,460,10012.0,104.0,64.0,5,216,10012.0,20.0,15.0
0.005,17,2,194,1,59,0.0,31.0,31.0,1,135,0.0,107.0,107.0
0.004,17,4,284,2,120,0.0,32.0,32.0,2,164,0.0,60.0,54.0
0.003,17,4,284,2,120,0.0,32.0,32.0,2,164,0.0,60.0,54.0
0.005,17,2,166,1,75,0.0,47.0,47.0,1,91,0.0,63.0,63.0
0.007,6,10,1547,5,764,1.0,496.0,496.0,5,783,1.0,515.0,515.0
0.133,6,10,1506,5,395,29.0,127.0,127.0,5,1111,32.0,843.0,843.0
0.015,6,10,1972,5,910,3.0,642.0,642.0,5,1062,3.0,794.0,794.0
40.055,17,10,676,5,460,10013.0,104.0,64.0,5,216,10013.0,20.0,15.0
0.005,17,2,230,1,68,0.0,40.0,40.0,1,162,0.0,134.0,134.0
0.005,6,10,1547,5,764,1.0,496.0,496.0,5,783,1.0,515.0,515.0
0.018,6,6,716,3,458,7.0,302.0,302.0,3,258,7.0,102.0,102.0
0.004,6,10,2006,5,927,1.0,659.0,659.0,5,1079,1.0,811.0,811.0
0.01,17,2,136,1,60,0.0,32.0,32.0,1,76,0.0,48.0,48.0
0.018,6,10,1990,5,911,4.0,643.0,643.0,5,1079,4.0,811.0,811.0
0.012,6,10,1631,5,848,3.0,580.0,580.0,5,783,2.0,515.0,515.0
10.776,17,28,4420,14,1993,820.0,268.0,114.0,14,2427,820.0,586.0,145.0
40.067,17,10,676,5,460,10014.0,104.0,64.0,5,216,10014.0,20.0,15.0
0.015,6,10,1677,5,827,3.0,559.0,559.0,5,850,3.0,582.0,582.0
0.006,6,10,1854,5,889,1.0,621.0,621.0,5,965,1.0,697.0,697.0
0.012,6,10,1972,5,910,2.0,642.0,642.0,5,1062,3.0,794.0,794.0
0.005,6,10,1689,5,839,1.0,571.0,571.0,5,850,1.0,582.0,582.0
0.006,6,10,1547,5,764,1.0,496.0,496.0,5,783,1.0,515.0,515.0
40.031,17,10,676,5,460,10006.0,104.0,64.0,5,216,10006.0,20.0,15.0
0.005,6,10,1854,5,889,1.0,621.0,621.0,5,965,1.0,697.0,697.0
0.005,6,10,2006,5,927,1.0,659.0,659.0,5,1079,1.0,811.0,811.0
0.005,6,10,1989,5,927,1.0,659.0,659.0,5,1062,1.0,794.0,794.0
0.008,6,10,1972,5,910,1.0,642.0,642.0,5,1062,2.0,794.0,794.0
0.128,17,2,80,1,32,0.0,4.0,4.0,1,48,0.0,20.0,20.0
0.019,6,10,1989,5,910,4.0,642.0,642.0,5,1079,4.0,811.0,811.0
0.005,6,10,2006,5,927,1.0,659.0,659.0,5,1079,1.0,811.0,811.0
0.016,6,10,1972,5,910,3.0,642.0,642.0,5,1062,4.0,794.0,794.0
0.013,6,10,1972,5,910,3.0,642.0,642.0,5,1062,3.0,794.0,794.0
11.494,17,28,4394,14,2312,872.0,587.0,137.0,14,2082,872.0,269.0,120.0
0.003,17,2,148,1,60,0.0,32.0,32.0,1,88,0.0,60.0,60.0
0.005,17,2,164,1,74,0.0,46.0,46.0,1,90,0.0,62.0,62.0
0.008,6,10,1989,5,910,2.0,642.0,642.0,5,1079,2.0,811.0,811.0
0.004,6,10,1774,5,923,1.0,655.0,655.0,5,851,1.0,583.0,583.0
0.044,17,2,184,1,61,0.0,33.0,33.0,1,123,0.0,95.0,95.0
0.009,6,10,1983,5,910,2.0,642.0,642.0,5,1073,2.0,805.0,805.0
0.055,17,2,152,1,76,0.0,48.0,48.0,1,76,0.0,48.0,48.0
0.041,17,2,152,1,76,0.0,48.0,48.0,1,76,0.0,48.0,48.0
0.093,6,10,1506,5,395,20.0,127.0,127.0,5,1111,21.0,843.0,843.0
9.039,17,6,376,5,280,2259.0,28.0,28.0,1,96,0.0,68.0,68.0
0.003,6,10,1702,5,863,0.0,595.0,595.0,5,839,0.0,571.0,571.0
1729.232,6,60,4400,40,2740,44339.0,33.0,33.0,20,1660,91002.0,31.0,31.0
40.059,17,10,676,5,460,10014.0,104.0,64.0,5,216,10013.0,20.0,15.0
0.002,17,2,132,1,58,0.0,30.0,30.0,1,74,0.0,46.0,46.0
0.097,6,10,1506,5,395,22.0,127.0,127.0,5,1111,23.0,843.0,843.0
0.121,6,10,1506,5,395,27.0,127.0,127.0,5,1111,25.0,843.0,843.0
0.059,6,10,1506,5,395,13.0,127.0,127.0,5,1111,12.0,843.0,843.0
0.005,6,10,1774,5,923,1.0,655.0,655.0,5,851,1.0,583.0,583.0
0.005,6,10,1779,5,928,1.0,660.0,660.0,5,851,1.0,583.0,583.0
0.087,6,10,1506,5,395,18.0,127.0,127.0,5,1111,18.0,843.0,843.0
0.008,17,4,284,2,120,5.0,32.0,32.0,2,164,5.0,60.0,54.0
0.084,6,10,1506,5,395,18.0,127.0,127.0,5,1111,19.0,843.0,843.0
0.004,6,10,2006,5,927,1.0,659.0,659.0,5,1079,1.0,811.0,811.0
0.006,6,10,2006,5,927,1.0,659.0,659.0,5,1079,1.0,811.0,811.0
0.003,17,2,148,1,60,0.0,32.0,32.0,1,88,0.0,60.0,60.0
0.09,6,10,1506,5,395,20.0,127.0,127.0,5,1111,20.0,843.0,843.0
0.112,6,10,1506,5,395,25.0,127.0,127.0,5,1111,25.0,843.0,843.0
0.008,17,2,166,1,75,0.0,47.0,47.0,1,91,0.0,63.0,63.0
0.001,17,2,180,1,66,0.0,38.0,38.0,1,114,0.0,86.0,86.0
0.023,6,10,1631,5,848,5.0,580.0,580.0,5,783,5.0,515.0,515.0
0.007,17,2,194,1,59,0.0,31.0,31.0,1,135,0.0,107.0,107.0
0.011,6,10,1983,5,910,2.0,642.0,642.0,5,1073,2.0,805.0,805.0
0.084,6,10,1506,5,395,20.0,127.0,127.0,5,1111,17.0,843.0,843.0
0.266,17,39,20079,21,17036,13.0,1350.0,783.0,18,3043,11.0,1350.0,141.0
0.013,6,10,1989,5,910,3.0,642.0,642.0,5,1079,3.0,811.0,811.0
0.007,17,2,179,1,71,0.0,43.0,43.0,1,108,0.0,80.0,80.0
0.008,17,2,148,1,66,0.0,38.0,38.0,1,82,0.0,54.0,54.0
40.05,17,10,676,5,460,10011.0,104.0,64.0,5,216,10011.0,20.0,15.0
240.208,6,39,4505,19,2068,13344.0,589.0,176.0,20,2437,12642.0,580.0,173.0
0.005,6,10,2007,5,928,1.0,660.0,660.0,5,1079,1.0,811.0,811.0
11.094,17,28,4419,14,1995,841.0,270.0,114.0,14,2424,841.0,587.0,145.0
0.008,6,10,1989,5,910,2.0,642.0,642.0,5,1079,2.0,811.0,811.0
0.001,17,2,136,1,60,0.0,32.0,32.0,1,76,0.0,48.0,48.0
40.057,17,10,676,5,460,10012.0,104.0,64.0,5,216,10013.0,20.0,15.0
0.001,17,2,136,1,60,0.0,32.0,32.0,1,76,0.0,48.0,48.0
40.092,17,10,676,5,460,10020.0,104.0,64.0,5,216,10022.0,20.0,15.0
0.079,6,10,1506,5,395,18.0,127.0,127.0,5,1111,18.0,843.0,843.0
0.004,6,10,1989,5,927,1.0,659.0,659.0,5,1062,1.0,794.0,794.0
0.004,6,10,2007,5,928,1.0,660.0,660.0,5,1079,1.0,811.0,811.0
0.017,6,5,310,3,175,8.0,31.0,31.0,2,135,0.0,31.0,31.0
0.012,6,10,1989,5,910,2.0,642.0,642.0,5,1079,2.0,811.0,811.0
0.152,6,10,1506,5,395,35.0,127.0,127.0,5,1111,33.0,843.0,843.0
0.06,17,2,152,1,76,0.0,48.0,48.0,1,76,0.0,48.0,48.0
0.008,6,10,1762,5,911,2.0,643.0,643.0,5,851,1.0,583.0,583.0
0.013,6,10,1989,5,910,3.0,642.0,642.0,5,1079,3.0,811.0,811.0
0.118,6,10,1506,5,395,27.0,127.0,127.0,5,1111,26.0,843.0,843.0
40.062,17,10,676,5,460,10013.0,104.0,64.0,5,216,10014.0,20.0,15.0
0.041,17,4,284,2,120,0.0,32.0,32.0,2,164,38.0,60.0,54.0
240.66,6,37,10824,18,2127,14156.0,622.0,195.0,19,8697,13369.0,2804.0,641.0
0.224,6,10,1506,5,395,54.0,127.0,127.0,5,1111,52.0,843.0,843.0
0.069,6,10,1506,5,395,16.0,127.0,127.0,5,1111,15.0,843.0,843.0
0.005,6,10,2006,5,927,1.0,659.0,659.0,5,1079,1.0,811.0,811.0
1799.84,6,244,46673,119,34105,15252.0,2475.0,961.0,125,12568,14514.0,580.0,62.0
0.005,17,2,179,1,71,0.0,43.0,43.0,1,108,0.0,80.0,80.0
0.013,17,2,152,1,56,0.0,28.0,28.0,1,96,0.0,68.0,68.0
0.005,6,10,2000,5,927,1.0,659.0,659.0,5,1073,1.0,805.0,805.0
0.009,6,10,1989,5,910,2.0,642.0,642.0,5,1079,2.0,811.0,811.0
0.005,6,10,2006,5,927,1.0,659.0,659.0,5,1079,1.0,811.0,811.0
0.099,6,10,1506,5,395,23.0,127.0,127.0,5,1111,23.0,843.0,843.0
0.004,17,2,170,1,65,0.0,37.0,37.0,1,105,0.0,77.0,77.0
0.003,17,4,284,2,120,0.0,32.0,32.0,2,164,0.0,60.0,54.0
170.078,17,80,11240,40,2672,4360.0,44.0,38.0,40,8568,4360.0,239.0,186.0
0.01,6,10,1990,5,911,2.0,643.0,643.0,5,1079,2.0,811.0,811.0
0.165,17,2,152,1,76,0.0,48.0,48.0,1,76,0.0,48.0,48.0
353.993,6,21,1794,16,1030,23599.0,190.0,190.0,5,764,60002.0,463.0,248.0
0.024,6,10,1762,5,911,5.0,643.0,643.0,5,851,5.0,583.0,583.0
0.011,6,10,1983,5,910,2.0,642.0,642.0,5,1073,2.0,805.0,805.0
0.015,6,10,1990,5,911,3.0,643.0,643.0,5,1079,3.0,811.0,811.0
0.005,17,2,179,1,71,0.0,43.0,43.0,1,108,0.0,80.0,80.0
0.019,6,10,1972,5,910,4.0,642.0,642.0,5,1062,4.0,794.0,794.0
240.292,6,45,8875,21,5686,12014.0,1515.0,509.0,24,3189,10447.0,580.0,241.0
0.001,17,2,180,1,66,0.0,38.0,38.0,1,114,0.0,86.0,86.0
361.849,6,21,1793,16,1030,24123.0,190.0,190.0,5,763,60010.0,462.0,247.0
10.92,17,28,4421,14,1993,831.0,268.0,114.0,14,2428,831.0,587.0,145.0
0.018,6,10,1989,5,910,4.0,642.0,642.0,5,1079,4.0,811.0,811.0
0.005,6,10,2007,5,928,1.0,660.0,660.0,5,1079,1.0,811.0,811.0
0.106,6,10,1506,5,395,22.0,127.0,127.0,5,1111,23.0,843.0,843.0
0.098,6,10,1506,5,395,22.0,127.0,127.0,5,1111,19.0,843.0,843.0
0.058,17,2,136,1,60,0.0,32.0,32.0,1,76,0.0,48.0,48.0
300.391,6,16,2170,9,684,37528.0,146.0,146.0,7,1486,50037.0,419.0,398.0
0.007,6,13,3690,7,452,1.0,80.0,80.0,6,3238,1.0,1470.0,1459.0
0.011,6,10,1677,5,827,2.0,559.0,559.0,5,850,2.0,582.0,582.0
0.005,6,10,2006,5,927,1.0,659.0,659.0,5,1079,1.0,811.0,811.0
0.006,6,12,1698,6,863,1.0,327.0,271.0,6,835,1.0,515.0,515.0
138.773,6,21,8145,11,1985,86.0,1174.0,504.0,10,6160,15400.0,2720.0,958.0
0.138,6,10,1506,5,395,32.0,127.0,127.0,5,1111,31.0,843.0,843.0
0.007,17,2,194,1,59,0.0,31.0,31.0,1,135,0.0,107.0,107.0
0.003,17,2,148,1,60,0.0,32.0,32.0,1,88,0.0,60.0,60.0
0.015,6,10,1762,5,911,3.0,643.0,643.0,5,851,3.0,583.0,583.0
0.077,6,10,1506,5,395,17.0,127.0,127.0,5,1111,16.0,843.0,843.0
0.008,17,2,194,1,59,0.0,31.0,31.0,1,135,0.0,107.0,107.0
0.077,6,10,1506,5,395,17.0,127.0,127.0,5,1111,17.0,843.0,843.0
0.007,6,10,1762,5,911,1.0,643.0,643.0,5,851,1.0,583.0,583.0
0.016,6,10,1990,5,911,4.0,643.0,643.0,5,1079,3.0,811.0,811.0
0.015,6,10,1990,5,911,3.0,643.0,643.0,5,1079,3.0,811.0,811.0
0.006,6,13,3747,7,509,1.0,137.0,137.0,6,3238,1.0,1470.0,1459.0
0.012,6,13,3735,7,497,2.0,125.0,125.0,6,3238,2.0,1470.0,1459.0
0.003,17,2,148,1,60,0.0,32.0,32.0,1,88,0.0,60.0,60.0
40.065,17,10,676,5,460,10014.0,104.0,64.0,5,216,10015.0,20.0,15.0
0.219,6,16,2669,8,1395,31.0,533.0,323.0,8,1274,20.0,529.0,212.0
0.006,6,10,1547,5,764,1.0,496.0,496.0,5,783,1.0,515.0,515.0
0.005,6,10,1854,5,889,1.0,621.0,621.0,5,965,1.0,697.0,697.0
0.005,6,10,1989,5,927,1.0,659.0,659.0,5,1062,1.0,794.0,794.0
0.781,6,22,5168,11,1138,64.0,267.0,115.0,11,4030,65.0,1414.0,597.0
0.016,6,14,3965,7,495,2.0,123.0,123.0,7,3470,2.0,1448.0,1032.0
240.017,6,9,787,5,488,60004.0,232.0,232.0,4,299,80004.0,83.0,83.0
0.091,6,10,1506,5,395,20.0,127.0,127.0,5,1111,19.0,843.0,843.0
0.072,17,4,284,2,120,1.0,32.0,32.0,2,164,68.0,60.0,54.0
0.41,6,21,7133,10,1583,45.0,748.0,263.0,11,5550,40.0,2335.0,994.0
11.207,17,28,4422,14,1994,849.0,269.0,114.0,14,2428,849.0,587.0,145.0
0.005,17,2,170,1,65,0.0,37.0,37.0,1,105,0.0,77.0,77.0
0.01,6,10,1990,5,911,2.0,643.0,643.0,5,1079,2.0,811.0,811.0
0.006,6,10,1643,5,860,1.0,592.0,592.0,5,783,1.0,515.0,515.0
0.005,6,13,3747,7,509,0.0,137.0,137.0,6,3238,1.0,1470.0,1459.0
0.092,6,10,1506,5,395,21.0,127.0,127.0,5,1111,20.0,843.0,843.0
0.006,17,2,194,1,59,0.0,31.0,31.0,1,135,0.0,107.0,107.0
0.129,17,4,352,2,130,0.0,37.0,37.0,2,222,88.0,89.0,83.0
0.013,17,2,213,1,69,0.0,41.0,41.0,1,144,0.0,116.0,116.0
0.003,17,2,136,1,60,0.0,32.0,32.0,1,76,0.0,48.0,48.0
0.003,17,2,185,1,73,0.0,45.0,45.0,1,112,0.0,84.0,84.0
0.005,6,10,1854,5,889,1.0,621.0,621.0,5,965,1.0,697.0,697.0
0.005,6,13,3747,7,509,0.0,137.0,137.0,6,3238,0.0,1470.0,1459.0
0.012,6,10,1989,5,910,3.0,642.0,642.0,5,1079,3.0,811.0,811.0
0.246,17,39,20159,21,17044,12.0,1350.0,783.0,18,3115,11.0,1350.0,145.0
0.005,6,10,1774,5,923,1.0,655.0,655.0,5,851,1.0,583.0,583.0
0.015,6,10,1631,5,848,3.0,580.0,580.0,5,783,3.0,515.0,515.0
40.05,17,10,676,5,460,10011.0,104.0,64.0,5,216,10011.0,20.0,15.0
240.483,6,39,9800,20,2226,12656.0,746.0,235.0,19,7574,13359.0,1402.0,549.0
40.074,17,10,676,5,460,10017.0,104.0,64.0,5,216,10017.0,20.0,15.0
15.072,17,15,9238,8,6902,2149.0,1350.0,834.0,7,2336,2507.0,1350.0,305.0
240.088,6,31,9500,15,7025,17149.0,2150.0,694.0,16,2475,16005.0,580.0,204.0
0.005,6,10,1989,5,927,1.0,659.0,659.0,5,1062,1.0,794.0,794.0
0.08,6,10,1506,5,395,19.0,127.0,127.0,5,1111,17.0,843.0,843.0
0.005,6,10,1989,5,927,1.0,659.0,659.0,5,1062,1.0,794.0,794.0
0.003,17,2,148,1,60,0.0,32.0,32.0,1,88,0.0,60.0,60.0
0.113,6,10,1506,5,395,24.0,127.0,127.0,5,1111,26.0,843.0,843.0
0.119,6,10,1506,5,395,16.0,127.0,127.0,5,1111,26.0,843.0,843.0
240.013,6,9,787,5,488,60003.0,232.0,232.0,4,299,80003.0,83.0,83.0
0.012,17,2,148,1,60,0.0,32.0,32.0,1,88,0.0,60.0,60.0
40.077,17,10,676,5,460,10018.0,104.0,64.0,5,216,10018.0,20.0,15.0
120.765,6,39,12305,23,3796,5489.0,1056.0,260.0,16,8509,8050.0,2694.0,958.0
0.006,6,10,1854,5,889,1.0,621.0,621.0,5,965,1.0,697.0,697.0
0.011,6,10,1631,5,848,2.0,580.0,580.0,5,783,2.0,515.0,515.0
11.026,17,28,4416,14,1993,839.0,268.0,114.0,14,2423,839.0,586.0,145.0
0.006,17,2,164,1,74,0.0,46.0,46.0,1,90,0.0,62.0,62.0
0.005,6,10,2007,5,928,1.0,660.0,660.0,5,1079,1.0,811.0,811.0
0.004,6,10,1989,5,927,1.0,659.0,659.0,5,1062,1.0,794.0,794.0
0.005,6,10,1547,5,764,1.0,496.0,496.0,5,783,1.0,515.0,515.0
0.005,6,10,2007,5,928,1.0,660.0,660.0,5,1079,1.0,811.0,811.0
10.887,17,28,4422,14,1995,829.0,270.0,114.0,14,2427,829.0,586.0,145.0
0.072,6,10,1506,5,395,15.0,127.0,127.0,5,1111,16.0,843.0,843.0
0.005,17,2,214,1,75,0.0,47.0,47.0,1,139,0.0,111.0,111.0
0.005,17,2,214,1,75,0.0,47.0,47.0,1,139,0.0,111.0,111.0
367.104,6,22,2313,16,867,24473.0,195.0,195.0,6,1446,4639.0,419.0,398.0
240.098,6,32,9523,16,7031,16006.0,2102.0,689.0,16,2492,16006.0,580.0,206.0
0.003,6,10,1702,5,863,0.0,595.0,595.0,5,839,0.0,571.0,571.0
0.09,6,10,1506,5,395,17.0,127.0,127.0,5,1111,20.0,843.0,843.0
0.005,6,10,2006,5,927,1.0,659.0,659.0,5,1079,1.0,811.0,811.0
0.005,6,10,2007,5,928,1.0,660.0,660.0,5,1079,1.0,811.0,811.0
0.003,17,2,136,1,60,0.0,32.0,32.0,1,76,0.0,48.0,48.0
0.069,6,10,1506,5,395,15.0,127.0,127.0,5,1111,14.0,843.0,843.0
0.072,6,10,1506,5,395,14.0,127.0,127.0,5,1111,14.0,843.0,843.0
0.225,6,16,2669,8,1395,32.0,533.0,323.0,8,1274,20.0,529.0,212.0
0.008,6,10,1989,5,910,2.0,642.0,642.0,5,1079,1.0,811.0,811.0
0.096,6,10,1506,5,395,23.0,127.0,127.0,5,1111,21.0,843.0,843.0
10.946,17,28,4422,14,1994,833.0,269.0,114.0,14,2428,833.0,587.0,145.0
240.096,6,31,8990,15,6617,17149.0,1740.0,649.0,16,2373,16006.0,580.0,191.0
0.005,6,10,1779,5,928,1.0,660.0,660.0,5,851,1.0,583.0,583.0
0.005,17,2,144,1,64,0.0,36.0,36.0,1,80,0.0,52.0,52.0
0.125,6,10,1506,5,395,26.0,127.0,127.0,5,1111,24.0,843.0,843.0
0.008,17,2,194,1,59,0.0,31.0,31.0,1,135,0.0,107.0,107.0
0.0,17,2,142,1,63,0.0,35.0,35.0,1,79,0.0,51.0,51.0
10.712,17,28,4421,14,1993,815.0,268.0,114.0,14,2428,815.0,587.0,145.0
0.041,17,2,170,1,65,0.0,37.0,37.0,1,105,0.0,77.0,77.0
0.014,6,14,3965,7,495,2.0,123.0,123.0,7,3470,2.0,1448.0,1032.0
0.005,17,2,180,1,58,0.0,30.0,30.0,1,122,0.0,94.0,94.0
0.107,6,10,1506,5,395,23.0,127.0,127.0,5,1111,22.0,843.0,843.0
0.005,6,10,2007,5,928,1.0,660.0,660.0,5,1079,1.0,811.0,811.0
0.01,6,10,1989,5,910,2.0,642.0,642.0,5,1079,2.0,811.0,811.0
0.005,6,10,1547,5,764,1.0,496.0,496.0,5,783,1.0,515.0,515.0
0.007,6,10,1547,5,764,1.0,496.0,496.0,5,783,1.0,515.0,515.0
0.004,6,10,1774,5,923,1.0,655.0,655.0,5,851,1.0,583.0,583.0
0.074,6,10,1506,5,395,16.0,127.0,127.0,5,1111,15.0,843.0,843.0
309.707,17,20,1124,10,716,34395.0,48.0,43.0,10,408,34394.0,20.0,12.0
1800.0,17,2689,206017,1337,108434,1347.0,84.0,53.0,1352,97583,1327.0,227.0,44.0
0.1,6,10,1506,5,395,22.0,127.0,127.0,5,1111,22.0,843.0,843.0
0.022,6,14,3965,7,495,3.0,123.0,123.0,7,3470,3.0,1448.0,1032.0
0.005,6,10,1547,5,764,1.0,496.0,496.0,5,783,1.0,515.0,515.0
1729.236,6,60,4400,40,2740,44339.0,33.0,33.0,20,1660,91003.0,31.0,31.0
0.071,6,10,1506,5,395,16.0,127.0,127.0,5,1111,14.0,843.0,843.0
0.06,17,2,152,1,76,0.0,48.0,48.0,1,76,0.0,48.0,48.0
0.005,6,10,1774,5,923,1.0,655.0,655.0,5,851,1.0,583.0,583.0
0.171,6,10,1506,5,395,26.0,127.0,127.0,5,1111,39.0,843.0,843.0
0.006,6,10,1547,5,764,1.0,496.0,496.0,5,783,1.0,515.0,515.0
0.08,6,10,1506,5,395,17.0,127.0,127.0,5,1111,16.0,843.0,843.0
10.811,17,28,4422,14,1995,823.0,270.0,114.0,14,2427,823.0,586.0,145.0
0.005,17,2,142,1,63,0.0,35.0,35.0,1,79,0.0,51.0,51.0
0.015,6,10,1677,5,827,3.0,559.0,559.0,5,850,3.0,582.0,582.0
0.004,6,10,2006,5,927,1.0,659.0,659.0,5,1079,1.0,811.0,811.0
0.004,6,10,2000,5,927,1.0,659.0,659.0,5,1073,1.0,805.0,805.0
0.004,6,10,1702,5,863,1.0,595.0,595.0,5,839,0.0,571.0,571.0
15.076,17,15,9239,8,6902,2149.0,1350.0,834.0,7,2337,2507.0,1350.0,305.0
0.006,6,10,1702,5,863,1.0,595.0,595.0,5,839,1.0,571.0,571.0
40.062,17,10,676,5,460,10014.0,104.0,64.0,5,216,10014.0,20.0,15.0
0.134,6,10,1506,5,395,30.0,127.0,127.0,5,1111,31.0,843.0,843.0
0.083,6,10,1506,5,395,17.0,127.0,127.0,5,1111,19.0,843.0,843.0
15.134,17,20,13503,10,8344,1678.0,1350.0,806.0,10,5159,1678.0,1350.0,487.0
0.003,17,2,148,1,60,0.0,32.0,32.0,1,88,0.0,60.0,60.0
0.068,17,8,3613,4,1874,22.0,1350.0,440.0,4,1739,12.0,1350.0,406.0
0.262,17,46,25857,26,21296,10.0,1350.0,791.0,20,4561,10.0,1350.0,200.0
0.012,6,10,1989,5,910,3.0,642.0,642.0,5,1079,3.0,811.0,811.0
0.005,6,10,1989,5,927,1.0,659.0,659.0,5,1062,1.0,794.0,794.0
0.01,6,10,1990,5,911,2.0,643.0,643.0,5,1079,2.0,811.0,811.0
0.058,17,2,144,1,64,0.0,36.0,36.0,1,80,0.0,52.0,52.0
308.417,17,20,1124,10,716,34261.0,48.0,43.0,10,408,34261.0,20.0,12.0
0.023,6,10,1762,5,911,5.0,643.0,643.0,5,851,5.0,583.0,583.0
10.852,17,26,4098,13,1846,895.0,269.0,114.0,13,2252,895.0,587.0,145.0
0.005,6,10,1689,5,839,1.0,571.0,571.0,5,850,1.0,582.0,582.0
308.59,17,20,1124,10,716,34273.0,48.0,43.0,10,408,34276.0,20.0,12.0
0.014,6,10,1989,5,910,3.0,642.0,642.0,5,1079,3.0,811.0,811.0
0.005,6,10,2000,5,927,1.0,659.0,659.0,5,1073,1.0,805.0,805.0
40.07,17,10,676,5,460,10014.0,104.0,64.0,5,216,10016.0,20.0,15.0
240.084,6,16,4480,9,963,30010.0,238.0,166.0,7,3517,40013.0,1402.0,786.0
0.005,6,10,2006,5,927,1.0,659.0,659.0,5,1079,1.0,811.0,811.0
0.005,6,10,1854,5,889,1.0,621.0,621.0,5,965,1.0,697.0,697.0
0.003,17,2,148,1,60,0.0,32.0,32.0,1,88,0.0,60.0,60.0
0.006,6,12,1698,6,863,1.0,327.0,271.0,6,835,1.0,515.0,515.0
368.602,6,22,2313,16,867,24573.0,195.0,195.0,6,1446,4645.0,419.0,398.0
308.342,17,18,1008,9,640,38526.0,48.0,43.0,9,368,38526.0,20.0,12.0
0.089,6,10,1506,5,395,19.0,127.0,127.0,5,1111,20.0,843.0,843.0
240.232,6,29,15785,15,6973,17159.0,2736.0,1032.0,14,8812,18478.0,1908.0,1153.0
0.004,17,2,136,1,60,0.0,32.0,32.0,1,76,0.0,48.0,48.0
0.004,17,2,136,1,60,0.0,32.0,32.0,1,76,0.0,48.0,48.0
0.002,17,2,152,1,76,0.0,48.0,48.0,1,76,0.0,48.0,48.0
0.004,17,4,284,2,120,1.0,32.0,32.0,2,164,0.0,60.0,54.0
0.015,6,10,1972,5,910,3.0,642.0,642.0,5,1062,3.0,794.0,794.0
0.083,6,10,1506,5,395,18.0,127.0,127.0,5,1111,19.0,843.0,843.0
240.094,6,16,4482,9,963,30011.0,238.0,166.0,7,3519,40014.0,1402.0,786.0
0.015,6,10,1983,5,910,3.0,642.0,642.0,5,1073,3.0,805.0,805.0
0.005,6,10,1989,5,927,1.0,659.0,659.0,5,1062,1.0,794.0,794.0
0.096,6,10,1506,5,395,22.0,127.0,127.0,5,1111,21.0,843.0,843.0
240.019,6,17,1882,9,1132,30002.0,517.0,167.0,8,750,34287.0,156.0,81.0
11.023,17,28,4421,14,1993,839.0,268.0,114.0,14,2428,839.0,587.0,145.0
10.79,17,28,4422,14,1994,821.0,269.0,114.0,14,2428,821.0,587.0,145.0
0.012,6,10,1972,5,910,2.0,642.0,642.0,5,1062,3.0,794.0,794.0
0.015,6,10,1972,5,910,3.0,642.0,642.0,5,1062,3.0,794.0,794.0
0.006,6,13,3747,7,509,1.0,137.0,137.0,6,3238,1.0,1470.0,1459.0
0.001,17,2,180,1,66,0.0,38.0,38.0,1,114,0.0,86.0,86.0
40.067,17,10,676,5,460,10014.0,104.0,64.0,5,216,10015.0,20.0,15.0
0.004,6,10,2006,5,927,1.0,659.0,659.0,5,1079,1.0,811.0,811.0
0.001,17,2,180,1,66,0.0,38.0,38.0,1,114,0.0,86.0,86.0
0.028,6,10,1677,5,827,7.0,559.0,559.0,5,850,7.0,582.0,582.0
0.001,17,2,180,1,66,0.0,38.0,38.0,1,114,0.0,86.0,86.0
0.009,6,10,1983,5,910,2.0,642.0,642.0,5,1073,2.0,805.0,805.0
170.421,17,76,10886,38,2529,4605.0,44.0,38.0,38,8357,4605.0,239.0,191.0
0.064,6,10,943,5,395,10.0,127.0,127.0,5,548,12.0,280.0,280.0
0.003,17,2,160,1,72,0.0,44.0,44.0,1,88,0.0,60.0,60.0
0.003,17,2,148,1,60,0.0,32.0,32.0,1,88,0.0,60.0,60.0
40.077,17,10,676,5,460,10015.0,104.0,64.0,5,216,10018.0,20.0,15.0
0.114,6,10,1506,5,395,24.0,127.0,127.0,5,1111,24.0,843.0,843.0
0.005,6,10,1689,5,839,1.0,571.0,571.0,5,850,1.0,582.0,582.0
0.102,6,10,1506,5,395,24.0,127.0,127.0,5,1111,23.0,843.0,843.0
0.034,17,2,166,1,75,0.0,47.0,47.0,1,91,0.0,63.0,63.0
0.001,17,2,180,1,66,0.0,38.0,38.0,1,114,0.0,86.0,86.0
0.054,6,13,3735,7,497,8.0,125.0,125.0,6,3238,10.0,1470.0,1459.0
0.005,6,10,1989,5,927,1.0,659.0,659.0,5,1062,1.0,794.0,794.0
0.015,6,10,1989,5,910,3.0,642.0,642.0,5,1079,3.0,811.0,811.0
0.008,6,10,1762,5,911,1.0,643.0,643.0,5,851,2.0,583.0,583.0
0.264,17,38,20153,21,17043,13.0,1350.0,783.0,17,3110,12.0,1350.0,154.0
0.017,6,10,1989,5,910,4.0,642.0,642.0,5,1079,4.0,811.0,811.0
409.286,6,42,16174,23,3008,18603.0,662.0,360.0,19,13166,19403.0,1423.0,936.0
0.009,6,10,1989,5,910,2.0,642.0,642.0,5,1079,2.0,811.0,811.0
57.558,6,38,11195,19,5637,495.0,2720.0,969.0,19,5558,3188.0,2667.0,435.0
0.019,6,10,1990,5,911,4.0,643.0,643.0,5,1079,4.0,811.0,811.0
0.293,17,2,152,1,76,0.0,48.0,48.0,1,76,0.0,48.0,48.0
1777.27,17,144,45504,72,22752,25031.0,288.0,288.0,72,22752,25027.0,288.0,288.0
308.757,17,20,1124,10,716,34296.0,48.0,43.0,10,408,34299.0,20.0,12.0
1778.283,17,144,45504,72,22752,25046.0,288.0,288.0,72,22752,25046.0,288.0,288.0
0.004,6,10,2006,5,927,1.0,659.0,659.0,5,1079,1.0,811.0,811.0
0.005,6,10,1643,5,860,1.0,592.0,592.0,5,783,1.0,515.0,515.0
0.011,6,10,1989,5,910,2.0,642.0,642.0,5,1079,2.0,811.0,811.0
15.073,17,15,9238,8,6902,2149.0,1350.0,834.0,7,2336,2507.0,1350.0,305.0
0.007,17,2,194,1,59,0.0,31.0,31.0,1,135,0.0,107.0,107.0
0.17,6,3,453,2,321,170.0,241.0,241.0,1,132,0.0,92.0,92.0
0.003,17,2,148,1,60,0.0,32.0,32.0,1,88,0.0,60.0,60.0
0.089,6,10,1506,5,395,20.0,127.0,127.0,5,1111,19.0,843.0,843.0
0.012,6,10,1983,5,910,3.0,642.0,642.0,5,1073,3.0,805.0,805.0
0.004,17,2,148,1,60,0.0,32.0,32.0,1,88,0.0,60.0,60.0
0.005,6,10,2006,5,927,1.0,659.0,659.0,5,1079,1.0,811.0,811.0
0.086,6,10,1506,5,395,19.0,127.0,127.0,5,1111,18.0,843.0,843.0
0.093,6,10,1506,5,395,20.0,127.0,127.0,5,1111,20.0,843.0,843.0
0.005,6,10,1689,5,839,1.0,571.0,571.0,5,850,1.0,582.0,582.0
15.071,17,15,9239,8,6902,2148.0,1350.0,834.0,7,2337,2507.0,1350.0,305.0
0.011,6,10,1989,5,910,2.0,642.0,642.0,5,1079,2.0,811.0,811.0
0.007,17,2,194,1,59,0.0,31.0,31.0,1,135,0.0,107.0,107.0
0.058,6,10,1506,5,395,13.0,127.0,127.0,5,1111,12.0,843.0,843.0
0.1,6,10,1506,5,395,22.0,127.0,127.0,5,1111,22.0,843.0,843.0
327.922,17,20,1124,10,716,36424.0,48.0,43.0,10,408,36422.0,20.0,12.0
1756.854,6,103,6166,59,3473,30289.0,27.0,27.0,44,2693,40856.0,27.0,27.0
0.013,6,10,1989,5,910,3.0,642.0,642.0,5,1079,3.0,811.0,811.0
0.013,6,10,1990,5,911,3.0,643.0,643.0,5,1079,3.0,811.0,811.0
0.012,6,10,1972,5,910,2.0,642.0,642.0,5,1062,2.0,794.0,794.0
1795.771,6,545,188239,281,162831,6413.0,2883.0,975.0,264,25408,6828.0,374.0,116.0
0.006,6,10,1547,5,764,1.0,496.0,496.0,5,783,1.0,515.0,515.0
9.039,17,6,376,5,280,2259.0,28.0,28.0,1,96,0.0,68.0,68.0
0.078,6,10,1506,5,395,17.0,127.0,127.0,5,1111,14.0,843.0,843.0
0.092,6,10,1506,5,395,22.0,127.0,127.0,5,1111,20.0,843.0,843.0
0.007,6,10,2000,5,927,1.0,659.0,659.0,5,1073,1.0,805.0,805.0
0.001,17,2,180,1,66,0.0,38.0,38.0,1,114,0.0,86.0,86.0
0.083,6,10,1506,5,395,18.0,127.0,127.0,5,1111,16.0,843.0,843.0
0.075,6,10,1506,5,395,16.0,127.0,127.0,5,1111,16.0,843.0,843.0
0.007,6,10,1547,5,764,1.0,496.0,496.0,5,783,1.0,515.0,515.0
0.005,6,10,1989,5,927,1.0,659.0,659.0,5,1062,1.0,794.0,794.0
0.018,6,10,1677,5,827,4.0,559.0,559.0,5,850,4.0,582.0,582.0
172.057,17,72,10286,36,2398,4915.0,44.0,38.0,36,7888,4915.0,239.0,191.0
0.101,6,10,1506,5,395,23.0,127.0,127.0,5,1111,20.0,843.0,843.0
0.004,17,4,284,2,120,0.0,32.0,32.0,2,164,0.0,60.0,54.0
0.006,6,10,1689,5,839,1.0,571.0,571.0,5,850,1.0,582.0,582.0
0.005,6,10,1643,5,860,1.0,592.0,592.0,5,783,1.0,515.0,515.0
0.092,6,10,1506,5,395,21.0,127.0,127.0,5,1111,18.0,843.0,843.0
0.005,17,2,222,1,65,0.0,37.0,37.0,1,157,0.0,129.0,129.0
0.005,6,10,1689,5,839,1.0,571.0,571.0,5,850,1.0,582.0,582.0
0.008,6,12,1926,6,1189,1.0,659.0,434.0,6,737,1.0,417.0,417.0
0.1,6,10,1506,5,395,22.0,127.0,127.0,5,1111,23.0,843.0,843.0
0.06,6,10,1506,5,395,14.0,127.0,127.0,5,1111,14.0,843.0,843.0
0.003,17,4,284,2,120,0.0,32.0,32.0,2,164,0.0,60.0,54.0
0.012,6,10,1972,5,910,3.0,642.0,642.0,5,1062,3.0,794.0,794.0
0.213,6,16,2777,8,1395,30.0,533.0,323.0,8,1382,19.0,529.0,239.0
11.494,17,28,4422,14,1994,871.0,269.0,114.0,14,2428,871.0,587.0,145.0
0.005,17,2,169,1,62,0.0,34.0,34.0,1,107,0.0,79.0,79.0
0.004,6,10,1779,5,928,1.0,660.0,660.0,5,851,1.0,583.0,583.0
0.009,6,10,1990,5,911,2.0,643.0,643.0,5,1079,2.0,811.0,811.0
10.867,17,28,4417,14,1994,827.0,269.0,114.0,14,2423,827.0,586.0,145.0
0.006,6,10,1547,5,764,1.0,496.0,496.0,5,783,1.0,515.0,515.0
0.006,17,2,166,1,75,0.0,47.0,47.0,1,91,0.0,63.0,63.0
310.062,17,18,1008,9,640,38750.0,48.0,43.0,9,368,38750.0,20.0,12.0
0.088,6,10,1506,5,395,20.0,127.0,127.0,5,1111,17.0,843.0,843.0
0.012,6,10,1983,5,910,2.0,642.0,642.0,5,1073,3.0,805.0,805.0
0.009,6,10,1989,5,910,2.0,642.0,642.0,5,1079,2.0,811.0,811.0
0.091,6,10,1506,5,395,21.0,127.0,127.0,5,1111,22.0,843.0,843.0
0.006,17,2,164,1,74,0.0,46.0,46.0,1,90,0.0,62.0,62.0
0.005,6,10,1774,5,923,1.0,655.0,655.0,5,851,1.0,583.0,583.0
0.005,6,10,1989,5,927,1.0,659.0,659.0,5,1062,1.0,794.0,794.0
308.661,17,20,1124,10,716,34280.0,48.0,43.0,10,408,34277.0,20.0,12.0
0.072,6,10,1506,5,395,15.0,127.0,127.0,5,1111,15.0,843.0,843.0
40.1,17,10,676,5,460,10023.0,104.0,64.0,5,216,10024.0,20.0,15.0
0.005,6,13,3747,7,509,0.0,137.0,137.0,6,3238,1.0,1470.0,1459.0
0.056,6,10,1506,5,395,12.0,127.0,127.0,5,1111,13.0,843.0,843.0
0.037,6,10,1989,5,910,9.0,642.0,642.0,5,1079,9.0,811.0,811.0
240.026,6,9,787,5,488,60006.0,232.0,232.0,4,299,80007.0,83.0,83.0
0.06,17,2,80,1,32,0.0,4.0,4.0,1,48,0.0,20.0,20.0
0.006,6,10,1779,5,928,1.0,660.0,660.0,5,851,1.0,583.0,583.0
0.017,6,10,1972,5,910,4.0,642.0,642.0,5,1062,4.0,794.0,794.0
0.006,6,10,1779,5,928,1.0,660.0,660.0,5,851,1.0,583.0,583.0
0.1,6,10,1506,5,395,21.0,127.0,127.0,5,1111,21.0,843.0,843.0
0.004,17,4,284,2,120,0.0,32.0,32.0,2,164,0.0,60.0,54.0
9.043,17,6,376,5,280,2260.0,28.0,28.0,1,96,0.0,68.0,68.0
0.004,6,10,1774,5,923,1.0,655.0,655.0,5,851,1.0,583.0,583.0
0.006,6,10,1689,5,839,1.0,571.0,571.0,5,850,1.0,582.0,582.0
0.009,6,10,1972,5,910,2.0,642.0,642.0,5,1062,2.0,794.0,794.0
0.01,17,2,230,1,68,0.0,40.0,40.0,1,162,0.0,134.0,134.0
0.004,17,2,148,1,60,0.0,32.0,32.0,1,88,0.0,60.0,60.0
0.007,6,10,1547,5,764,1.0,496.0,496.0,5,783,1.0,515.0,515.0
369.359,6,24,2405,17,919,23084.0,195.0,195.0,7,1486,3905.0,419.0,398.0
0.091,6,10,1506,5,395,20.0,127.0,127.0,5,1111,19.0,843.0,843.0
11.273,17,28,4422,14,1993,854.0,268.0,114.0,14,2429,854.0,588.0,145.0
0.005,17,2,170,1,65,0.0,37.0,37.0,1,105,0.0,77.0,77.0
0.109,6,10,1506,5,395,23.0,127.0,127.0,5,1111,25.0,843.0,843.0
0.005,6,10,1689,5,839,1.0,571.0,571.0,5,850,1.0,582.0,582.0
0.01,6,14,3787,7,497,1.0,125.0,125.0,7,3290,1.0,1448.0,972.0
1799.917,6,137,6590,76,3625,23995.0,39.0,39.0,61,2965,29994.0,35.0,35.0
0.006,17,2,170,1,65,0.0,37.0,37.0,1,105,0.0,77.0,77.0
0.012,6,10,1989,5,910,3.0,642.0,642.0,5,1079,2.0,811.0,811.0
0.142,6,10,1506,5,395,27.0,127.0,127.0,5,1111,31.0,843.0,843.0
0.011,6,10,1990,5,911,2.0,643.0,643.0,5,1079,2.0,811.0,811.0
11.441,17,28,4392,14,2311,867.0,586.0,137.0,14,2081,867.0,268.0,120.0
0.008,17,2,427,1,129,0.0,101.0,101.0,1,298,0.0,270.0,270.0
0.076,6,10,1506,5,395,15.0,127.0,127.0,5,1111,18.0,843.0,843.0
0.006,17,2,166,1,75,0.0,47.0,47.0,1,91,0.0,63.0,63.0
0.004,6,10,1702,5,863,0.0,595.0,595.0,5,839,1.0,571.0,571.0
0.006,17,2,168,1,76,0.0,48.0,48.0,1,92,0.0,64.0,64.0
0.07,6,10,1506,5,395,14.0,127.0,127.0,5,1111,16.0,843.0,843.0
0.006,6,10,1854,5,889,1.0,621.0,621.0,5,965,1.0,697.0,697.0
0.073,6,10,1506,5,395,16.0,127.0,127.0,5,1111,15.0,843.0,843.0
0.005,6,14,3742,8,504,0.0,80.0,80.0,6,3238,0.0,1470.0,1459.0
0.005,6,10,1989,5,927,1.0,659.0,659.0,5,1062,1.0,794.0,794.0
0.005,6,10,1989,5,927,1.0,659.0,659.0,5,1062,1.0,794.0,794.0
0.009,6,10,1762,5,911,2.0,643.0,643.0,5,851,2.0,583.0,583.0
0.004,6,10,2006,5,927,1.0,659.0,659.0,5,1079,1.0,811.0,811.0
0.011,6,10,1990,5,911,2.0,643.0,643.0,5,1079,2.0,811.0,811.0
40.076,17,10,676,5,460,10018.0,104.0,64.0,5,216,10017.0,20.0,15.0
0.007,6,10,1547,5,764,1.0,496.0,496.0,5,783,1.0,515.0,515.0
0.004,6,10,1989,5,927,1.0,659.0,659.0,5,1062,1.0,794.0,794.0
0.004,6,10,2007,5,928,1.0,660.0,660.0,5,1079,1.0,811.0,811.0
0.089,6,10,1506,5,395,21.0,127.0,127.0,5,1111,20.0,843.0,843.0
0.076,6,10,1506,5,395,17.0,127.0,127.0,5,1111,16.0,843.0,843.0
0.062,6,10,1506,5,395,14.0,127.0,127.0,5,1111,14.0,843.0,843.0
0.005,6,10,2006,5,927,1.0,659.0,659.0,5,1079,1.0,811.0,811.0
361.832,6,19,1688,15,978,25845.0,190.0,190.0,4,710,80013.0,494.0,494.0
0.001,17,2,132,1,58,0.0,30.0,30.0,1,74,0.0,46.0,46.0
0.005,17,2,136,1,60,0.0,32.0,32.0,1,76,0.0,48.0,48.0
0.014,6,10,1989,5,910,3.0,642.0,642.0,5,1079,3.0,811.0,811.0
0.005,6,10,1689,5,839,1.0,571.0,571.0,5,850,1.0,582.0,582.0
0.005,17,2,168,1,76,0.0,48.0,48.0,1,92,0.0,64.0,64.0
0.223,6,16,2669,8,1395,31.0,533.0,323.0,8,1274,20.0,529.0,212.0
0.066,17,8,3613,4,1874,22.0,1350.0,440.0,4,1739,11.0,1350.0,406.0
0.001,17,2,180,1,66,0.0,38.0,38.0,1,114,0.0,86.0,86.0
0.004,6,10,2000,5,927,1.0,659.0,659.0,5,1073,1.0,805.0,805.0
0.005,6,14,3799,7,509,0.0,137.0,137.0,7,3290,0.0,1448.0,972.0
0.005,6,10,2006,5,927,1.0,659.0,659.0,5,1079,1.0,811.0,811.0
0.011,6,10,1631,5,848,2.0,580.0,580.0,5,783,2.0,515.0,515.0
0.011,6,10,1631,5,848,2.0,580.0,580.0,5,783,2.0,515.0,515.0
0.01,6,10,1989,5,910,2.0,642.0,642.0,5,1079,2.0,811.0,811.0
0.011,6,10,1983,5,910,2.0,642.0,642.0,5,1073,2.0,805.0,805.0
0.005,6,10,2006,5,927,1.0,659.0,659.0,5,1079,1.0,811.0,811.0
0.005,6,14,3742,8,504,0.0,80.0,80.0,6,3238,0.0,1470.0,1459.0
0.039,17,2,136,1,60,0.0,32.0,32.0,1,76,0.0,48.0,48.0
0.005,17,2,144,1,64,0.0,36.0,36.0,1,80,0.0,52.0,52.0
0.004,17,4,284,2,120,0.0,32.0,32.0,2,164,1.0,60.0,54.0
0.005,6,10,1689,5,839,1.0,571.0,571.0,5,850,1.0,582.0,582.0
0.012,6,10,1990,5,911,3.0,643.0,643.0,5,1079,3.0,811.0,811.0
300.017,6,12,1782,7,1348,50002.0,494.0,494.0,5,434,75003.0,83.0,83.0
0.006,6,10,1547,5,764,1.0,496.0,496.0,5,783,1.0,515.0,515.0
0.04,17,2,184,1,61,0.0,33.0,33.0,1,123,0.0,95.0,95.0
0.125,6,10,1506,5,395,27.0,127.0,127.0,5,1111,24.0,843.0,843.0
0.098,6,10,1506,5,395,20.0,127.0,127.0,5,1111,20.0,843.0,843.0
0.001,17,2,144,1,64,0.0,36.0,36.0,1,80,0.0,52.0,52.0
0.013,17,2,152,1,56,0.0,28.0,28.0,1,96,0.0,68.0,68.0
0.005,17,2,170,1,65,0.0,37.0,37.0,1,105,0.0,77.0,77.0
0.004,6,10,1989,5,927,1.0,659.0,659.0,5,1062,1.0,794.0,794.0
0.039,17,2,152,1,76,0.0,48.0,48.0,1,76,0.0,48.0,48.0
0.004,17,4,284,2,120,0.0,32.0,32.0,2,164,1.0,60.0,54.0
0.09,6,10,1506,5,395,17.0,127.0,127.0,5,1111,17.0,843.0,843.0
0.089,6,10,1506,5,395,20.0,127.0,127.0,5,1111,20.0,843.0,843.0
0.005,6,10,1547,5,764,1.0,496.0,496.0,5,783,1.0,515.0,515.0
0.019,6,10,1989,5,910,4.0,642.0,642.0,5,1079,4.0,811.0,811.0
0.004,17,2,148,1,60,0.0,32.0,32.0,1,88,0.0,60.0,60.0
0.075,6,10,1506,5,395,15.0,127.0,127.0,5,1111,17.0,843.0,843.0
0.016,6,10,1990,5,911,3.0,643.0,643.0,5,1079,4.0,811.0,811.0
0.003,17,2,136,1,60,0.0,32.0,32.0,1,76,0.0,48.0,48.0
40.053,17,10,676,5,460,10012.0,104.0,64.0,5,216,10012.0,20.0,15.0
0.172,6,10,1506,5,395,41.0,127.0,127.0,5,1111,38.0,843.0,843.0
0.115,6,10,1506,5,395,25.0,127.0,127.0,5,1111,25.0,843.0,843.0
15.074,17,14,9190,8,6902,2149.0,1350.0,834.0,6,2288,3008.0,1350.0,353.0
161.398,17,74,10371,37,2465,4483.0,44.0,38.0,37,7906,4483.0,261.0,185.0
0.008,6,12,1926,6,1189,1.0,659.0,434.0,6,737,1.0,417.0,417.0
0.005,6,10,1702,5,863,1.0,595.0,595.0,5,839,1.0,571.0,571.0
177.205,17,84,12112,42,2817,4321.0,44.0,39.0,42,9295,4322.0,239.0,193.0
351.983,6,20,2210,6,1308,12003.0,494.0,494.0,14,902,27075.0,83.0,83.0
0.07,6,10,1506,5,395,15.0,127.0,127.0,5,1111,15.0,843.0,843.0
0.007,6,10,1643,5,860,1.0,592.0,592.0,5,783,1.0,515.0,515.0
0.122,17,2,80,1,32,0.0,4.0,4.0,1,48,0.0,20.0,20.0
0.005,17,2,170,1,65,0.0,37.0,37.0,1,105,0.0,77.0,77.0
0.022,6,10,1762,5,911,5.0,643.0,643.0,5,851,5.0,583.0,583.0
40.065,17,10,676,5,460,10015.0,104.0,64.0,5,216,10015.0,20.0,15.0
40.055,17,10,676,5,460,10013.0,104.0,64.0,5,216,10011.0,20.0,15.0
0.006,6,10,1547,5,764,1.0,496.0,496.0,5,783,1.0,515.0,515.0
0.005,6,10,1643,5,860,1.0,592.0,592.0,5,783,1.0,515.0,515.0
15.233,17,17,8143,9,6030,1899.0,1350.0,642.0,8,2113,2172.0,1350.0,236.0
0.005,17,2,154,1,69,0.0,41.0,41.0,1,85,0.0,57.0,57.0
0.008,6,10,1989,5,910,2.0,642.0,642.0,5,1079,1.0,811.0,811.0
0.002,17,2,152,1,76,0.0,48.0,48.0,1,76,0.0,48.0,48.0
0.017,6,10,1762,5,911,4.0,643.0,643.0,5,851,4.0,583.0,583.0
0.011,6,10,1989,5,910,2.0,642.0,642.0,5,1079,2.0,811.0,811.0
162.383,17,92,13326,46,3105,3608.0,44.0,39.0,46,10221,3608.0,239.0,194.0
0.278,6,12,2996,7,549,46.0,177.0,177.0,5,2447,43.0,1402.0,1089.0
175.092,17,82,11832,41,2744,4377.0,44.0,38.0,41,9088,4377.0,239.0,193.0
0.011,6,13,3735,7,497,1.0,125.0,125.0,6,3238,2.0,1470.0,1459.0
0.003,6,10,1702,5,863,0.0,595.0,595.0,5,839,0.0,571.0,571.0
0.115,6,10,1506,5,395,25.0,127.0,127.0,5,1111,26.0,843.0,843.0
0.004,17,2,148,1,60,0.0,32.0,32.0,1,88,0.0,60.0,60.0
0.731,6,25,5459,12,1557,56.0,325.0,152.0,13,3902,51.0,1414.0,563.0
0.005,6,10,1689,5,839,1.0,571.0,571.0,5,850,1.0,582.0,582.0
0.103,6,10,1506,5,395,20.0,127.0,127.0,5,1111,23.0,843.0,843.0
15.081,17,15,8220,8,6056,2150.0,1350.0,729.0,7,2164,2508.0,1350.0,281.0
0.005,6,13,3684,7,446,0.0,74.0,74.0,6,3238,1.0,1470.0,1459.0
0.01,6,10,1762,5,911,2.0,643.0,643.0,5,851,2.0,583.0,583.0
0.006,6,10,1689,5,839,1.0,571.0,571.0,5,850,1.0,582.0,582.0
0.004,6,10,2007,5,928,1.0,660.0,660.0,5,1079,1.0,811.0,811.0
0.163,17,2,152,1,76,0.0,48.0,48.0,1,76,0.0,48.0,48.0
0.013,6,10,1972,5,910,3.0,642.0,642.0,5,1062,3.0,794.0,794.0
0.004,6,10,2006,5,927,1.0,659.0,659.0,5,1079,1.0,811.0,811.0
0.008,6,12,1926,6,1189,1.0,659.0,434.0,6,737,1.0,417.0,417.0
0.004,6,10,1702,5,863,1.0,595.0,595.0,5,839,1.0,571.0,571.0
1525.146,6,199,18495,76,10813,20335.0,1939.0,123.0,123,7682,12500.0,148.0,47.0
0.004,17,2,136,1,60,0.0,32.0,32.0,1,76,0.0,48.0,48.0
0.012,6,13,3735,7,497,1.0,125.0,125.0,6,3238,2.0,1470.0,1459.0
0.004,17,4,284,2,120,0.0,32.0,32.0,2,164,0.0,60.0,54.0
0.01,6,12,1926,6,1189,2.0,659.0,434.0,6,737,1.0,417.0,417.0
0.008,6,10,1990,5,911,2.0,643.0,643.0,5,1079,1.0,811.0,811.0
0.005,6,10,1854,5,889,1.0,621.0,621.0,5,965,1.0,697.0,697.0
0.015,6,10,1631,5,848,3.0,580.0,580.0,5,783,3.0,515.0,515.0
0.016,6,10,1972,5,910,4.0,642.0,642.0,5,1062,4.0,794.0,794.0
0.008,6,12,1926,6,1189,1.0,659.0,434.0,6,737,1.0,417.0,417.0
0.01,6,6,716,3,458,3.0,302.0,302.0,3,258,3.0,102.0,102.0
0.003,17,2,136,1,60,0.0,32.0,32.0,1,76,0.0,48.0,48.0
0.011,6,10,1677,5,827,2.0,559.0,559.0,5,850,2.0,582.0,582.0
0.006,6,10,1643,5,860,1.0,592.0,592.0,5,783,1.0,515.0,515.0
0.006,6,10,1547,5,764,1.0,496.0,496.0,5,783,1.0,515.0,515.0
0.005,17,2,164,1,74,0.0,46.0,46.0,1,90,0.0,62.0,62.0
0.008,6,10,1989,5,910,2.0,642.0,642.0,5,1079,2.0,811.0,811.0
0.005,17,2,209,1,64,0.0,36.0,36.0,1,145,0.0,117.0,117.0
1.46,6,32,6224,17,1298,91.0,267.0,195.0,15,4926,94.0,1823.0,392.0
0.06,17,2,152,1,76,0.0,48.0,48.0,1,76,0.0,48.0,48.0
0.005,17,2,144,1,64,0.0,36.0,36.0,1,80,0.0,52.0,52.0
0.005,6,10,1779,5,928,1.0,660.0,660.0,5,851,1.0,583.0,583.0
0.013,17,2,152,1,56,0.0,28.0,28.0,1,96,0.0,68.0,68.0
1772.516,17,92,8096,46,4048,39389.0,60.0,60.0,46,4048,39389.0,60.0,60.0
0.001,17,2,180,1,66,0.0,38.0,38.0,1,114,0.0,86.0,86.0
0.036,6,10,1989,5,910,9.0,642.0,642.0,5,1079,9.0,811.0,811.0
40.053,17,10,676,5,460,10012.0,104.0,64.0,5,216,10012.0,20.0,15.0
0.085,6,10,1506,5,395,19.0,127.0,127.0,5,1111,17.0,843.0,843.0
0.075,6,10,1506,5,395,15.0,127.0,127.0,5,1111,17.0,843.0,843.0
0.018,6,10,1989,5,910,4.0,642.0,642.0,5,1079,4.0,811.0,811.0
0.002,17,2,180,1,66,0.0,38.0,38.0,1,114,0.0,86.0,86.0
40.06,17,10,676,5,460,10014.0,104.0,64.0,5,216,10014.0,20.0,15.0
354.071,6,21,1795,16,1030,23604.0,190.0,190.0,5,765,60001.0,464.0,248.0
0.099,6,10,1506,5,395,18.0,127.0,127.0,5,1111,23.0,843.0,843.0
0.139,6,10,1506,5,395,29.0,127.0,127.0,5,1111,30.0,843.0,843.0
0.011,6,10,1989,5,910,2.0,642.0,642.0,5,1079,2.0,811.0,811.0
0.005,6,13,3690,7,452,0.0,80.0,80.0,6,3238,1.0,1470.0,1459.0
0.004,6,10,2006,5,927,1.0,659.0,659.0,5,1079,1.0,811.0,811.0
0.012,6,10,1631,5,848,3.0,580.0,580.0,5,783,3.0,515.0,515.0
0.001,17,2,130,1,65,0.0,37.0,37.0,1,65,0.0,37.0,37.0
0.038,17,2,412,1,61,0.0,33.0,33.0,1,351,0.0,323.0,323.0
0.005,6,10,1989,5,927,1.0,659.0,659.0,5,1062,1.0,794.0,794.0
0.138,6,10,1506,5,395,32.0,127.0,127.0,5,1111,32.0,843.0,843.0
0.157,6,10,1506,5,395,29.0,127.0,127.0,5,1111,35.0,843.0,843.0
1.167,6,32,13392,18,5893,68.0,2720.0,854.0,14,7499,76.0,2720.0,769.0
9.036,17,6,376,5,280,2259.0,28.0,28.0,1,96,0.0,68.0,68.0
309.935,17,20,1124,10,716,34422.0,48.0,43.0,10,408,34426.0,20.0,12.0
0.005,6,10,1774,5,923,1.0,655.0,655.0,5,851,1.0,583.0,583.0
0.001,17,2,166,1,75,0.0,47.0,47.0,1,91,0.0,63.0,63.0
0.005,6,10,1547,5,764,1.0,496.0,496.0,5,783,1.0,515.0,515.0
0.092,6,10,1506,5,395,22.0,127.0,127.0,5,1111,21.0,843.0,843.0
0.011,6,10,1989,5,910,2.0,642.0,642.0,5,1079,2.0,811.0,811.0
0.006,17,2,170,1,65,0.0,37.0,37.0,1,105,0.0,77.0,77.0
0.079,6,10,1506,5,395,18.0,127.0,127.0,5,1111,17.0,843.0,843.0
0.006,6,10,2007,5,928,1.0,660.0,660.0,5,1079,1.0,811.0,811.0
15.074,17,15,9239,8,6902,2149.0,1350.0,834.0,7,2337,2507.0,1350.0,305.0
0.011,6,13,3735,7,497,1.0,125.0,125.0,6,3238,2.0,1470.0,1459.0
0.064,6,10,1506,5,395,14.0,127.0,127.0,5,1111,13.0,843.0,843.0
0.015,6,10,1989,5,910,3.0,642.0,642.0,5,1079,3.0,811.0,811.0
0.011,6,10,1631,5,848,2.0,580.0,580.0,5,783,2.0,515.0,515.0
0.005,17,2,164,1,74,0.0,46.0,46.0,1,90,0.0,62.0,62.0
0.013,6,10,1983,5,910,3.0,642.0,642.0,5,1073,3.0,805.0,805.0
0.011,6,10,1990,5,911,2.0,643.0,643.0,5,1079,2.0,811.0,811.0
0.004,6,10,1774,5,923,1.0,655.0,655.0,5,851,1.0,583.0,583.0
0.015,6,10,1677,5,827,3.0,559.0,559.0,5,850,3.0,582.0,582.0
0.127,6,10,1506,5,395,29.0,127.0,127.0,5,1111,29.0,843.0,843.0
0.009,6,10,1989,5,910,2.0,642.0,642.0,5,1079,2.0,811.0,811.0
0.005,17,2,144,1,64,0.0,36.0,36.0,1,80,0.0,52.0,52.0
0.006,6,14,3799,7,509,1.0,137.0,137.0,7,3290,0.0,1448.0,972.0
0.079,6,10,1506,5,395,17.0,127.0,127.0,5,1111,14.0,843.0,843.0
0.003,17,2,136,1,60,0.0,32.0,32.0,1,76,0.0,48.0,48.0
0.01,6,10,1972,5,910,2.0,642.0,642.0,5,1062,2.0,794.0,794.0
0.084,6,10,1506,5,395,17.0,127.0,127.0,5,1111,20.0,843.0,843.0
0.006,6,10,1547,5,764,1.0,496.0,496.0,5,783,1.0,515.0,515.0
0.099,6,10,1506,5,395,22.0,127.0,127.0,5,1111,22.0,843.0,843.0
15.081,17,16,8686,8,6439,2150.0,1350.0,776.0,8,2247,2149.0,1350.0,252.0
0.006,6,10,2006,5,927,1.0,659.0,659.0,5,1079,1.0,811.0,811.0
40.063,17,10,676,5,460,10014.0,104.0,64.0,5,216,10015.0,20.0,15.0
0.005,6,10,2007,5,928,1.0,660.0,660.0,5,1079,1.0,811.0,811.0
0.016,6,10,1972,5,910,3.0,642.0,642.0,5,1062,3.0,794.0,794.0
0.076,6,10,1506,5,395,16.0,127.0,127.0,5,1111,14.0,843.0,843.0
0.005,17,2,178,1,81,0.0,53.0,53.0,1,97,0.0,69.0,69.0
631.379,6,39,13924,21,3503,31568.0,676.0,400.0,18,10421,33609.0,1402.0,861.0
300.97,6,46,19436,26,13838,12038.0,2720.0,1160.0,20,5598,463.0,2667.0,435.0
40.046,17,10,676,5,460,10010.0,104.0,64.0,5,216,10010.0,20.0,15.0
0.001,17,2,136,1,60,0.0,32.0,32.0,1,76,0.0,48.0,48.0
0.006,6,10,1547,5,764,1.0,496.0,496.0,5,783,1.0,515.0,515.0
0.007,6,10,1547,5,764,1.0,496.0,496.0,5,783,1.0,515.0,515.0
0.02,6,10,1990,5,911,5.0,643.0,643.0,5,1079,5.0,811.0,811.0
0.004,17,2,136,1,60,0.0,32.0,32.0,1,76,0.0,48.0,48.0
0.147,6,10,1506,5,395,34.0,127.0,127.0,5,1111,34.0,843.0,843.0
0.007,17,2,170,1,65,0.0,37.0,37.0,1,105,0.0,77.0,77.0
0.015,6,13,3735,7,497,2.0,125.0,125.0,6,3238,2.0,1470.0,1459.0
0.004,17,2,136,1,60,0.0,32.0,32.0,1,76,0.0,48.0,48.0
0.041,17,2,148,1,60,0.0,32.0,32.0,1,88,0.0,60.0,60.0
0.004,6,10,2007,5,928,1.0,660.0,660.0,5,1079,1.0,811.0,811.0
0.006,17,2,170,1,65,0.0,37.0,37.0,1,105,0.0,77.0,77.0
0.072,6,10,1506,5,395,17.0,127.0,127.0,5,1111,16.0,843.0,843.0
0.005,6,10,2006,5,927,1.0,659.0,659.0,5,1079,1.0,811.0,811.0
0.005,6,10,2006,5,927,1.0,659.0,659.0,5,1079,1.0,811.0,811.0
0.006,6,10,2007,5,928,1.0,660.0,660.0,5,1079,1.0,811.0,811.0
40.08,17,10,676,5,460,10017.0,104.0,64.0,5,216,10019.0,20.0,15.0
0.005,6,10,2006,5,927,1.0,659.0,659.0,5,1079,1.0,811.0,811.0
0.007,6,10,1989,5,927,1.0,659.0,659.0,5,1062,1.0,794.0,794.0
0.005,6,13,3747,7,509,0.0,137.0,137.0,6,3238,1.0,1470.0,1459.0
300.784,6,37,9597,20,4119,15830.0,1543.0,657.0,17,5478,539.0,2667.0,435.0
0.005,6,13,3747,7,509,0.0,137.0,137.0,6,3238,1.0,1470.0,1459.0
0.008,6,10,1990,5,911,2.0,643.0,643.0,5,1079,2.0,811.0,811.0
0.006,17,2,140,1,62,0.0,34.0,34.0,1,78,0.0,50.0,50.0
0.011,6,10,1990,5,911,2.0,643.0,643.0,5,1079,2.0,811.0,811.0
8.981,6,39,10487,20,4929,472.0,1360.0,682.0,19,5558,487.0,2667.0,435.0
31.656,6,25,11167,12,1696,2877.0,538.0,350.0,13,9471,2637.0,2624.0,1098.0
0.004,17,2,136,1,60,0.0,32.0,32.0,1,76,0.0,48.0,48.0
0.005,6,13,3747,7,509,0.0,137.0,137.0,6,3238,1.0,1470.0,1459.0
0.009,6,10,1631,5,848,2.0,580.0,580.0,5,783,2.0,515.0,515.0
0.072,17,4,364,2,160,0.0,52.0,52.0,2,204,33.0,80.0,74.0
309.477,17,20,1124,10,716,34371.0,48.0,43.0,10,408,34371.0,20.0,12.0
0.006,6,10,1689,5,839,1.0,571.0,571.0,5,850,1.0,582.0,582.0
40.064,17,10,676,5,460,10012.0,104.0,64.0,5,216,10015.0,20.0,15.0
0.074,6,10,1506,5,395,16.0,127.0,127.0,5,1111,17.0,843.0,843.0
0.004,17,2,148,1,60,0.0,32.0,32.0,1,88,0.0,60.0,60.0
40.061,17,10,676,5,460,10012.0,104.0,64.0,5,216,10014.0,20.0,15.0
0.004,17,2,136,1,60,0.0,32.0,32.0,1,76,0.0,48.0,48.0
0.001,17,2,180,1,66,0.0,38.0,38.0,1,114,0.0,86.0,86.0
0.083,6,10,1506,5,395,15.0,127.0,127.0,5,1111,17.0,843.0,843.0
0.006,6,10,1547,5,764,1.0,496.0,496.0,5,783,1.0,515.0,515.0
0.116,6,10,1506,5,395,25.0,127.0,127.0,5,1111,25.0,843.0,843.0
0.089,6,10,1506,5,395,17.0,127.0,127.0,5,1111,20.0,843.0,843.0
0.085,6,10,1506,5,395,19.0,127.0,127.0,5,1111,18.0,843.0,843.0
0.006,6,10,1689,5,839,1.0,571.0,571.0,5,850,1.0,582.0,582.0
71.912,6,32,17830,15,9626,5136.0,2804.0,1475.0,17,8204,4485.0,2315.0,1218.0
0.725,6,25,5459,12,1557,60.0,325.0,152.0,13,3902,51.0,1414.0,563.0
309.243,17,20,1124,10,716,34349.0,48.0,43.0,10,408,34349.0,20.0,12.0
0.005,6,10,1989,5,927,1.0,659.0,659.0,5,1062,1.0,794.0,794.0
0.017,6,10,1990,5,911,4.0,643.0,643.0,5,1079,4.0,811.0,811.0
0.004,6,10,2000,5,927,1.0,659.0,659.0,5,1073,1.0,805.0,805.0
0.072,6,10,1506,5,395,15.0,127.0,127.0,5,1111,17.0,843.0,843.0
0.004,17,4,284,2,120,0.0,32.0,32.0,2,164,0.0,60.0,54.0
0.02,6,10,1972,5,910,5.0,642.0,642.0,5,1062,5.0,794.0,794.0
0.005,6,10,1779,5,928,1.0,660.0,660.0,5,851,1.0,583.0,583.0
240.085,6,16,4481,9,963,30010.0,238.0,166.0,7,3518,40013.0,1402.0,786.0
173.259,17,94,13575,47,3167,3766.0,44.0,39.0,47,10408,3766.0,261.0,193.0
300.405,6,16,2170,9,684,37529.0,146.0,146.0,7,1486,50039.0,419.0,398.0
0.01,6,10,1989,5,910,2.0,642.0,642.0,5,1079,2.0,811.0,811.0
0.005,6,10,1643,5,860,1.0,592.0,592.0,5,783,1.0,515.0,515.0
0.005,6,14,3742,7,452,0.0,80.0,80.0,7,3290,0.0,1448.0,972.0
0.19,17,4,352,2,130,120.0,37.0,37.0,2,222,175.0,89.0,83.0
0.005,17,2,144,1,64,0.0,36.0,36.0,1,80,0.0,52.0,52.0
0.028,17,2,136,1,60,0.0,32.0,32.0,1,76,0.0,48.0,48.0
0.006,6,10,1547,5,764,1.0,496.0,496.0,5,783,1.0,515.0,515.0
0.01,6,10,1989,5,910,2.0,642.0,642.0,5,1079,2.0,811.0,811.0
0.02,17,2,170,1,65,0.0,37.0,37.0,1,105,0.0,77.0,77.0
0.724,6,25,5459,12,1557,55.0,325.0,152.0,13,3902,50.0,1414.0,563.0
15.069,17,15,9238,8,6902,2148.0,1350.0,834.0,7,2336,2506.0,1350.0,305.0
0.005,6,10,1989,5,927,1.0,659.0,659.0,5,1062,1.0,794.0,794.0
0.021,6,10,1989,5,910,5.0,642.0,642.0,5,1079,5.0,811.0,811.0
0.019,6,10,1972,5,910,4.0,642.0,642.0,5,1062,4.0,794.0,794.0
0.01,6,10,1989,5,910,2.0,642.0,642.0,5,1079,2.0,811.0,811.0
0.004,6,10,2006,5,927,1.0,659.0,659.0,5,1079,1.0,811.0,811.0
0.005,6,10,2007,5,928,1.0,660.0,660.0,5,1079,1.0,811.0,811.0
0.013,6,10,1989,5,910,3.0,642.0,642.0,5,1079,3.0,811.0,811.0
0.004,17,2,179,1,71,0.0,43.0,43.0,1,108,0.0,80.0,80.0
0.022,6,13,3816,7,578,3.0,206.0,206.0,6,3238,4.0,1470.0,1459.0
0.103,6,10,1506,5,395,21.0,127.0,127.0,5,1111,21.0,843.0,843.0
0.004,6,10,2000,5,927,1.0,659.0,659.0,5,1073,1.0,805.0,805.0
0.01,6,10,1983,5,910,2.0,642.0,642.0,5,1073,2.0,805.0,805.0
0.006,6,10,1643,5,860,1.0,592.0,592.0,5,783,1.0,515.0,515.0
0.005,6,10,2007,5,928,1.0,660.0,660.0,5,1079,1.0,811.0,811.0
0.003,17,2,136,1,60,0.0,32.0,32.0,1,76,0.0,48.0,48.0
0.007,17,2,194,1,59,0.0,31.0,31.0,1,135,0.0,107.0,107.0
0.004,17,2,148,1,60,0.0,32.0,32.0,1,88,0.0,60.0,60.0
0.012,6,10,1762,5,911,2.0,643.0,643.0,5,851,3.0,583.0,583.0
0.01,6,10,1983,5,910,2.0,642.0,642.0,5,1073,2.0,805.0,805.0
0.005,6,10,1774,5,923,1.0,655.0,655.0,5,851,1.0,583.0,583.0
0.005,17,2,214,1,75,0.0,47.0,47.0,1,139,0.0,111.0,111.0
0.174,6,3,453,2,321,174.0,241.0,241.0,1,132,0.0,92.0,92.0
0.129,17,2,148,1,60,0.0,32.0,32.0,1,88,0.0,60.0,60.0
0.082,6,10,1506,5,395,16.0,127.0,127.0,5,1111,16.0,843.0,843.0
0.005,6,10,1989,5,927,1.0,659.0,659.0,5,1062,1.0,794.0,794.0
0.083,6,10,1506,5,395,19.0,127.0,127.0,5,1111,18.0,843.0,843.0
0.003,17,2,148,1,60,0.0,32.0,32.0,1,88,0.0,60.0,60.0
11.454,17,28,4393,14,2312,868.0,587.0,137.0,14,2081,868.0,268.0,120.0
0.012,6,10,1983,5,910,3.0,642.0,642.0,5,1073,3.0,805.0,805.0
0.07,6,10,1506,5,395,15.0,127.0,127.0,5,1111,15.0,843.0,843.0
0.005,6,10,2006,5,927,1.0,659.0,659.0,5,1079,1.0,811.0,811.0
0.005,6,10,2000,5,927,1.0,659.0,659.0,5,1073,1.0,805.0,805.0
0.005,6,10,2006,5,927,1.0,659.0,659.0,5,1079,1.0,811.0,811.0
0.004,17,2,148,1,60,0.0,32.0,32.0,1,88,0.0,60.0,60.0
0.083,6,10,1506,5,395,19.0,127.0,127.0,5,1111,18.0,843.0,843.0
0.005,6,10,1643,5,860,1.0,592.0,592.0,5,783,1.0,515.0,515.0
0.01,6,10,1989,5,910,2.0,642.0,642.0,5,1079,2.0,811.0,811.0
0.005,17,2,144,1,64,0.0,36.0,36.0,1,80,0.0,52.0,52.0
0.129,17,2,80,1,32,0.0,4.0,4.0,1,48,0.0,20.0,20.0
0.001,17,2,179,1,62,0.0,34.0,34.0,1,117,0.0,89.0,89.0
0.005,6,10,1989,5,927,1.0,659.0,659.0,5,1062,1.0,794.0,794.0
300.378,6,16,2170,9,684,37525.0,146.0,146.0,7,1486,50034.0,419.0,398.0
0.08,6,10,1506,5,395,19.0,127.0,127.0,5,1111,15.0,843.0,843.0
0.072,17,4,284,2,120,0.0,32.0,32.0,2,164,68.0,60.0,54.0
0.004,6,10,2007,5,928,1.0,660.0,660.0,5,1079,1.0,811.0,811.0
0.076,6,10,1506,5,395,16.0,127.0,127.0,5,1111,16.0,843.0,843.0
0.11,6,10,1506,5,395,25.0,127.0,127.0,5,1111,22.0,843.0,843.0
0.008,6,10,1983,5,910,1.0,642.0,642.0,5,1073,2.0,805.0,805.0
0.005,17,2,170,1,65,0.0,37.0,37.0,1,105,0.0,77.0,77.0
0.1,6,10,1506,5,395,21.0,127.0,127.0,5,1111,22.0,843.0,843.0
0.001,17,2,166,1,75,0.0,47.0,47.0,1,91,0.0,63.0,63.0
0.004,6,10,2006,5,927,1.0,659.0,659.0,5,1079,1.0,811.0,811.0
0.001,17,2,294,1,64,0.0,36.0,36.0,1,230,0.0,202.0,202.0
0.144,6,12,2996,7,549,24.0,177.0,177.0,5,2447,34.0,1402.0,1089.0
0.03,6,10,1631,5,848,7.0,580.0,580.0,5,783,7.0,515.0,515.0
0.004,6,10,1774,5,923,1.0,655.0,655.0,5,851,1.0,583.0,583.0
174.082,17,80,11424,40,2677,4463.0,44.0,38.0,40,8747,4463.0,239.0,190.0
0.003,17,2,148,1,60,0.0,32.0,32.0,1,88,0.0,60.0,60.0
40.082,17,10,676,5,460,10018.0,104.0,64.0,5,216,10019.0,20.0,15.0
0.114,6,10,1506,5,395,25.0,127.0,127.0,5,1111,25.0,843.0,843.0
40.058,17,10,676,5,460,10012.0,104.0,64.0,5,216,10013.0,20.0,15.0
0.004,6,10,1989,5,927,1.0,659.0,659.0,5,1062,1.0,794.0,794.0
0.005,6,10,2006,5,927,1.0,659.0,659.0,5,1079,1.0,811.0,811.0
0.106,6,10,1506,5,395,23.0,127.0,127.0,5,1111,23.0,843.0,843.0
0.009,17,2,230,1,68,0.0,40.0,40.0,1,162,0.0,134.0,134.0
0.017,6,10,1972,5,910,4.0,642.0,642.0,5,1062,4.0,794.0,794.0
0.095,17,2,148,1,60,0.0,32.0,32.0,1,88,0.0,60.0,60.0
40.059,17,10,676,5,460,10012.0,104.0,64.0,5,216,10013.0,20.0,15.0
0.019,6,10,1990,5,911,4.0,643.0,643.0,5,1079,4.0,811.0,811.0
0.02,6,10,1990,5,911,4.0,643.0,643.0,5,1079,4.0,811.0,811.0
0.005,6,10,1774,5,923,1.0,655.0,655.0,5,851,1.0,583.0,583.0
0.004,6,10,2007,5,928,1.0,660.0,660.0,5,1079,1.0,811.0,811.0
0.005,17,2,164,1,74,0.0,46.0,46.0,1,90,0.0,62.0,62.0
0.371,17,42,20211,22,17091,17.0,1350.0,748.0,20,3120,16.0,1350.0,128.0
0.024,6,10,1989,5,910,6.0,642.0,642.0,5,1079,5.0,811.0,811.0
0.078,6,10,1506,5,395,18.0,127.0,127.0,5,1111,17.0,843.0,843.0
0.04,17,2,152,1,76,0.0,48.0,48.0,1,76,0.0,48.0,48.0
0.008,6,10,1972,5,910,2.0,642.0,642.0,5,1062,2.0,794.0,794.0
0.01,6,10,1983,5,910,2.0,642.0,642.0,5,1073,2.0,805.0,805.0
0.006,6,14,3799,7,509,0.0,137.0,137.0,7,3290,0.0,1448.0,972.0
0.08,6,10,1506,5,395,12.0,127.0,127.0,5,1111,18.0,843.0,843.0
0.118,6,10,1506,5,395,25.0,127.0,127.0,5,1111,25.0,843.0,843.0
40.06,17,10,676,5,460,10012.0,104.0,64.0,5,216,10014.0,20.0,15.0
0.004,6,10,2006,5,927,1.0,659.0,659.0,5,1079,1.0,811.0,811.0
0.006,6,10,1547,5,764,1.0,496.0,496.0,5,783,1.0,515.0,515.0
0.018,6,10,1989,5,910,4.0,642.0,642.0,5,1079,4.0,811.0,811.0
0.103,6,10,1506,5,395,20.0,127.0,127.0,5,1111,21.0,843.0,843.0
0.015,17,2,193,1,71,0.0,43.0,43.0,1,122,0.0,94.0,94.0
0.007,6,10,1547,5,764,1.0,496.0,496.0,5,783,1.0,515.0,515.0
0.005,6,10,1989,5,927,1.0,659.0,659.0,5,1062,1.0,794.0,794.0
240.091,6,16,4480,9,963,30011.0,238.0,166.0,7,3517,40014.0,1402.0,786.0
0.003,17,2,136,1,60,0.0,32.0,32.0,1,76,0.0,48.0,48.0
0.078,6,10,1506,5,395,17.0,127.0,127.0,5,1111,15.0,843.0,843.0
0.006,6,10,2007,5,928,1.0,660.0,660.0,5,1079,1.0,811.0,811.0
0.005,6,13,3690,7,452,0.0,80.0,80.0,6,3238,0.0,1470.0,1459.0
0.005,6,10,2006,5,927,1.0,659.0,659.0,5,1079,1.0,811.0,811.0
0.005,6,10,2006,5,927,1.0,659.0,659.0,5,1079,1.0,811.0,811.0
240.104,6,16,4482,9,963,30013.0,238.0,166.0,7,3519,40017.0,1402.0,786.0
0.011,6,10,1989,5,910,2.0,642.0,642.0,5,1079,2.0,811.0,811.0
40.065,17,10,676,5,460,10013.0,104.0,64.0,5,216,10015.0,20.0,15.0
0.011,6,6,716,3,458,4.0,302.0,302.0,3,258,4.0,102.0,102.0
0.004,6,10,2007,5,928,1.0,660.0,660.0,5,1079,1.0,811.0,811.0
0.005,6,14,3736,7,446,0.0,74.0,74.0,7,3290,0.0,1448.0,972.0
0.059,17,2,152,1,76,0.0,48.0,48.0,1,76,0.0,48.0,48.0
0.018,6,10,1989,5,910,4.0,642.0,642.0,5,1079,4.0,811.0,811.0
0.01,6,10,1989,5,910,2.0,642.0,642.0,5,1079,2.0,811.0,811.0
0.012,6,10,1983,5,910,2.0,642.0,642.0,5,1073,2.0,805.0,805.0
0.012,6,10,1989,5,910,3.0,642.0,642.0,5,1079,3.0,811.0,811.0
0.009,6,10,1983,5,910,2.0,642.0,642.0,5,1073,2.0,805.0,805.0
0.005,6,10,1854,5,889,1.0,621.0,621.0,5,965,1.0,697.0,697.0
0.006,17,2,164,1,74,0.0,46.0,46.0,1,90,0.0,62.0,62.0
0.005,6,13,3690,7,452,0.0,80.0,80.0,6,3238,1.0,1470.0,1459.0
0.005,6,14,3742,7,452,0.0,80.0,80.0,7,3290,0.0,1448.0,972.0
0.04,17,2,148,1,60,0.0,32.0,32.0,1,88,0.0,60.0,60.0
0.009,6,10,1989,5,910,2.0,642.0,642.0,5,1079,2.0,811.0,811.0
0.104,6,10,1506,5,395,22.0,127.0,127.0,5,1111,24.0,843.0,843.0
0.004,6,10,1989,5,927,1.0,659.0,659.0,5,1062,1.0,794.0,794.0
0.012,6,10,1989,5,910,2.0,642.0,642.0,5,1079,2.0,811.0,811.0
313.27,17,20,1124,10,716,34801.0,48.0,43.0,10,408,34801.0,20.0,12.0
15.071,17,15,9238,8,6902,2149.0,1350.0,834.0,7,2336,2507.0,1350.0,305.0
0.013,6,10,1990,5,911,3.0,643.0,643.0,5,1079,3.0,811.0,811.0
0.074,6,10,1506,5,395,15.0,127.0,127.0,5,1111,15.0,843.0,843.0
0.005,17,2,214,1,75,0.0,47.0,47.0,1,139,0.0,111.0,111.0
0.009,6,10,1972,5,910,2.0,642.0,642.0,5,1062,2.0,794.0,794.0
0.005,6,10,1854,5,889,1.0,621.0,621.0,5,965,1.0,697.0,697.0
40.088,17,10,676,5,460,10016.0,104.0,64.0,5,216,10020.0,20.0,15.0
0.012,6,10,1631,5,848,2.0,580.0,580.0,5,783,2.0,515.0,515.0
0.02,6,10,1990,5,911,5.0,643.0,643.0,5,1079,4.0,811.0,811.0
0.015,6,10,1983,5,910,3.0,642.0,642.0,5,1073,3.0,805.0,805.0
0.011,6,10,1983,5,910,2.0,642.0,642.0,5,1073,2.0,805.0,805.0
0.759,6,22,5072,11,1250,67.0,325.0,133.0,11,3822,64.0,1414.0,563.0
0.005,6,10,1989,5,927,1.0,659.0,659.0,5,1062,1.0,794.0,794.0
0.082,6,10,1506,5,395,18.0,127.0,127.0,5,1111,20.0,843.0,843.0
0.022,6,10,1972,5,910,5.0,642.0,642.0,5,1062,5.0,794.0,794.0
0.005,17,2,140,1,62,0.0,34.0,34.0,1,78,0.0,50.0,50.0
353.395,6,20,2210,6,1308,12003.0,494.0,494.0,14,902,27184.0,83.0,83.0
0.017,6,10,1989,5,910,4.0,642.0,642.0,5,1079,4.0,811.0,811.0
0.008,6,10,1990,5,911,2.0,643.0,643.0,5,1079,1.0,811.0,811.0
0.005,6,10,1779,5,928,1.0,660.0,660.0,5,851,1.0,583.0,583.0
0.006,17,2,166,1,75,0.0,47.0,47.0,1,91,0.0,63.0,63.0
0.005,17,2,164,1,74,0.0,46.0,46.0,1,90,0.0,62.0,62.0
0.005,17,2,164,1,74,0.0,46.0,46.0,1,90,0.0,62.0,62.0
0.005,6,10,1989,5,927,1.0,659.0,659.0,5,1062,1.0,794.0,794.0
0.005,17,2,170,1,65,0.0,37.0,37.0,1,105,0.0,77.0,77.0
0.057,6,10,1506,5,395,11.0,127.0,127.0,5,1111,13.0,843.0,843.0
0.012,6,10,1990,5,911,3.0,643.0,643.0,5,1079,3.0,811.0,811.0
0.001,17,2,136,1,60,0.0,32.0,32.0,1,76,0.0,48.0,48.0
172.13,17,86,12463,43,2879,4098.0,44.0,38.0,43,9584,4098.0,261.0,194.0
0.005,6,10,2006,5,927,1.0,659.0,659.0,5,1079,1.0,811.0,811.0
0.006,6,10,1547,5,764,1.0,496.0,496.0,5,783,1.0,515.0,515.0
1798.4,6,239,46365,115,33888,15775.0,2475.0,1073.0,124,12477,14620.0,580.0,62.0
0.005,6,10,1547,5,764,1.0,496.0,496.0,5,783,1.0,515.0,515.0
0.089,6,10,1506,5,395,19.0,127.0,127.0,5,1111,18.0,843.0,843.0
0.006,17,2,193,1,71,0.0,43.0,43.0,1,122,0.0,94.0,94.0
0.005,6,10,1547,5,764,1.0,496.0,496.0,5,783,1.0,515.0,515.0
40.054,17,10,676,5,460,10012.0,104.0,64.0,5,216,10012.0,20.0,15.0
0.003,17,2,148,1,60,0.0,32.0,32.0,1,88,0.0,60.0,60.0
240.022,6,9,787,5,488,60005.0,232.0,232.0,4,299,80005.0,83.0,83.0
10.806,17,28,4422,14,1994,822.0,269.0,114.0,14,2428,822.0,587.0,145.0
1710.902,6,103,6166,59,3473,29498.0,27.0,27.0,44,2693,39787.0,27.0,27.0
0.007,17,2,179,1,71,0.0,43.0,43.0,1,108,0.0,80.0,80.0
0.017,6,10,1989,5,910,4.0,642.0,642.0,5,1079,4.0,811.0,811.0
0.103,6,10,1506,5,395,22.0,127.0,127.0,5,1111,24.0,843.0,843.0
0.005,6,10,1689,5,839,1.0,571.0,571.0,5,850,1.0,582.0,582.0
0.112,6,10,1506,5,395,21.0,127.0,127.0,5,1111,25.0,843.0,843.0
0.017,6,10,1989,5,910,4.0,642.0,642.0,5,1079,4.0,811.0,811.0
0.001,17,2,180,1,66,0.0,38.0,38.0,1,114,0.0,86.0,86.0
0.006,6,10,1774,5,923,1.0,655.0,655.0,5,851,1.0,583.0,583.0
241.361,6,404,349228,192,21504,1263.0,2736.0,885.0,212,327724,1143.0,2804.0,1567.0
40.065,17,10,676,5,460,10015.0,104.0,64.0,5,216,10015.0,20.0,15.0
0.009,6,10,1989,5,910,2.0,642.0,642.0,5,1079,2.0,811.0,811.0
0.142,6,10,1506,5,395,31.0,127.0,127.0,5,1111,34.0,843.0,843.0
0.01,6,10,1972,5,910,2.0,642.0,642.0,5,1062,2.0,794.0,794.0
0.012,6,10,1989,5,910,3.0,642.0,642.0,5,1079,3.0,811.0,811.0
240.011,6,9,787,5,488,60002.0,232.0,232.0,4,299,80002.0,83.0,83.0
0.009,6,10,1989,5,910,2.0,642.0,642.0,5,1079,2.0,811.0,811.0
0.004,17,2,148,1,60,0.0,32.0,32.0,1,88,0.0,60.0,60.0
0.004,17,2,148,1,60,0.0,32.0,32.0,1,88,0.0,60.0,60.0
1.105,6,30,12717,17,3312,69.0,1360.0,517.0,13,9405,77.0,2720.0,985.0
0.006,6,10,1689,5,839,1.0,571.0,571.0,5,850,1.0,582.0,582.0
0.014,6,10,1983,5,910,3.0,642.0,642.0,5,1073,3.0,805.0,805.0
0.166,17,2,152,1,76,0.0,48.0,48.0,1,76,0.0,48.0,48.0
40.072,17,10,676,5,460,10015.0,104.0,64.0,5,216,10013.0,20.0,15.0
0.004,6,10,1702,5,863,1.0,595.0,595.0,5,839,1.0,571.0,571.0
15.075,17,15,9239,8,6902,2149.0,1350.0,834.0,7,2337,2507.0,1350.0,305.0
40.057,17,10,676,5,460,10012.0,104.0,64.0,5,216,10012.0,20.0,15.0
0.005,6,13,3690,7,452,0.0,80.0,80.0,6,3238,1.0,1470.0,1459.0
0.007,6,10,2007,5,928,1.0,660.0,660.0,5,1079,1.0,811.0,811.0
10.712,17,28,4422,14,1994,815.0,269.0,114.0,14,2428,815.0,587.0,145.0
0.011,17,2,138,1,61,0.0,33.0,33.0,1,77,0.0,49.0,49.0
0.091,6,10,1506,5,395,20.0,127.0,127.0,5,1111,18.0,843.0,843.0
361.812,6,21,1792,16,1030,24120.0,190.0,190.0,5,762,60010.0,461.0,247.0
0.005,17,2,169,1,62,0.0,34.0,34.0,1,107,0.0,79.0,79.0
10.824,17,28,4423,14,1994,824.0,269.0,114.0,14,2429,824.0,588.0,145.0
0.004,17,2,148,1,60,0.0,32.0,32.0,1,88,0.0,60.0,60.0
0.228,17,2,142,1,63,0.0,35.0,35.0,1,79,0.0,51.0,51.0
0.077,6,10,1506,5,395,17.0,127.0,127.0,5,1111,14.0,843.0,843.0
0.008,17,2,162,1,65,0.0,37.0,37.0,1,97,0.0,69.0,69.0
0.039,17,2,182,1,65,0.0,37.0,37.0,1,117,0.0,89.0,89.0
0.166,17,2,152,1,76,0.0,48.0,48.0,1,76,0.0,48.0,48.0
0.004,17,4,284,2,120,0.0,32.0,32.0,2,164,0.0,60.0,54.0
0.012,6,10,1989,5,910,3.0,642.0,642.0,5,1079,3.0,811.0,811.0
0.018,6,10,1990,5,911,4.0,643.0,643.0,5,1079,4.0,811.0,811.0
0.013,6,10,1990,5,911,3.0,643.0,643.0,5,1079,3.0,811.0,811.0
290.665,6,387,347813,207,22325,1410.0,2736.0,888.0,180,325488,1623.0,4171.0,1904.0
40.061,17,10,676,5,460,10014.0,104.0,64.0,5,216,10014.0,20.0,15.0
0.005,6,10,1643,5,860,1.0,592.0,592.0,5,783,1.0,515.0,515.0
158.511,17,78,11201,39,2601,4171.0,44.0,38.0,39,8600,4171.0,239.0,192.0
0.072,17,2,170,1,65,0.0,37.0,37.0,1,105,0.0,77.0,77.0
0.057,6,10,1506,5,395,13.0,127.0,127.0,5,1111,12.0,843.0,843.0
0.034,6,10,1983,5,910,8.0,642.0,642.0,5,1073,8.0,805.0,805.0
0.005,6,10,1989,5,927,1.0,659.0,659.0,5,1062,1.0,794.0,794.0
0.012,6,10,1990,5,911,3.0,643.0,643.0,5,1079,3.0,811.0,811.0
0.012,6,10,1983,5,910,3.0,642.0,642.0,5,1073,3.0,805.0,805.0
0.003,17,2,185,1,73,0.0,45.0,45.0,1,112,0.0,84.0,84.0
0.003,17,4,284,2,120,0.0,32.0,32.0,2,164,0.0,60.0,54.0
0.172,6,3,453,2,321,172.0,241.0,241.0,1,132,0.0,92.0,92.0
15.073,17,15,9238,8,6902,2149.0,1350.0,834.0,7,2336,2507.0,1350.0,305.0
240.081,6,57,48021,27,3201,9233.0,1229.0,596.0,30,44820,8278.0,2804.0,1730.0
0.259,17,44,24383,24,21168,11.0,1350.0,854.0,20,3215,10.0,1350.0,132.0
0.008,17,2,136,1,60,0.0,32.0,32.0,1,76,0.0,48.0,48.0
0.013,6,10,1983,5,910,3.0,642.0,642.0,5,1073,3.0,805.0,805.0
0.012,6,13,3735,7,497,2.0,125.0,125.0,6,3238,2.0,1470.0,1459.0
0.005,6,10,1643,5,860,1.0,592.0,592.0,5,783,1.0,515.0,515.0
0.006,6,10,1547,5,764,1.0,496.0,496.0,5,783,1.0,515.0,515.0
0.013,6,10,1972,5,910,3.0,642.0,642.0,5,1062,3.0,794.0,794.0
0.013,6,10,1990,5,911,3.0,643.0,643.0,5,1079,3.0,811.0,811.0
0.139,6,10,1506,5,395,30.0,127.0,127.0,5,1111,23.0,843.0,843.0
0.005,6,10,2007,5,928,1.0,660.0,660.0,5,1079,1.0,811.0,811.0
0.005,6,10,2000,5,927,1.0,659.0,659.0,5,1073,1.0,805.0,805.0
0.005,6,13,3747,7,509,0.0,137.0,137.0,6,3238,0.0,1470.0,1459.0
0.018,6,13,3735,7,497,3.0,125.0,125.0,6,3238,3.0,1470.0,1459.0
0.005,17,2,164,1,74,0.0,46.0,46.0,1,90,0.0,62.0,62.0
0.008,17,2,170,1,65,0.0,37.0,37.0,1,105,0.0,77.0,77.0
0.223,17,14,7703,7,5293,37.0,1350.0,728.0,7,2410,24.0,1350.0,316.0
0.025,6,10,1989,5,910,6.0,642.0,642.0,5,1079,6.0,811.0,811.0
0.003,17,2,187,1,74,0.0,46.0,46.0,1,113,0.0,85.0,85.0
0.019,6,10,1631,5,848,4.0,580.0,580.0,5,783,4.0,515.0,515.0
0.083,6,10,1506,5,395,18.0,127.0,127.0,5,1111,16.0,843.0,843.0
0.07,6,10,1506,5,395,13.0,127.0,127.0,5,1111,14.0,843.0,843.0
0.091,6,10,1506,5,395,20.0,127.0,127.0,5,1111,19.0,843.0,843.0
0.008,6,10,1989,5,910,2.0,642.0,642.0,5,1079,2.0,811.0,811.0
0.135,17,2,80,1,32,0.0,4.0,4.0,1,48,0.0,20.0,20.0
0.008,6,10,1989,5,910,2.0,642.0,642.0,5,1079,2.0,811.0,811.0
0.014,6,10,1990,5,911,3.0,643.0,643.0,5,1079,3.0,811.0,811.0
0.081,6,10,1506,5,395,17.0,127.0,127.0,5,1111,16.0,843.0,843.0
0.095,6,10,1506,5,395,20.0,127.0,127.0,5,1111,21.0,843.0,843.0
0.013,6,10,1677,5,827,3.0,559.0,559.0,5,850,3.0,582.0,582.0
0.001,17,2,174,1,72,0.0,44.0,44.0,1,102,0.0,74.0,74.0
0.093,6,10,1506,5,395,22.0,127.0,127.0,5,1111,22.0,843.0,843.0
0.004,6,10,2000,5,927,1.0,659.0,659.0,5,1073,1.0,805.0,805.0
40.067,17,10,676,5,460,10013.0,104.0,64.0,5,216,10015.0,20.0,15.0
240.014,6,9,787,5,488,60003.0,232.0,232.0,4,299,80003.0,83.0,83.0
0.582,6,26,8927,14,1587,36.0,517.0,211.0,12,7340,43.0,1288.0,840.0
0.031,6,10,1631,5,848,7.0,580.0,580.0,5,783,7.0,515.0,515.0
0.005,6,10,2006,5,927,1.0,659.0,659.0,5,1079,1.0,811.0,811.0
0.015,6,13,3735,7,497,2.0,125.0,125.0,6,3238,2.0,1470.0,1459.0
0.008,17,2,132,1,58,0.0,30.0,30.0,1,74,0.0,46.0,46.0
0.011,6,10,1990,5,911,2.0,643.0,643.0,5,1079,2.0,811.0,811.0
0.112,6,10,1506,5,395,24.0,127.0,127.0,5,1111,24.0,843.0,843.0
240.087,6,16,4480,9,963,30010.0,238.0,166.0,7,3517,40014.0,1402.0,786.0
0.021,6,13,3735,7,497,3.0,125.0,125.0,6,3238,4.0,1470.0,1459.0
352.875,6,20,2210,6,1308,12003.0,494.0,494.0,14,902,27144.0,83.0,83.0
0.005,6,13,3690,7,452,0.0,80.0,80.0,6,3238,0.0,1470.0,1459.0
0.005,6,10,2006,5,927,1.0,659.0,659.0,5,1079,1.0,811.0,811.0
0.003,17,2,148,1,60,0.0,32.0,32.0,1,88,0.0,60.0,60.0
0.005,6,10,1779,5,928,1.0,660.0,660.0,5,851,1.0,583.0,583.0
0.014,6,10,1983,5,910,3.0,642.0,642.0,5,1073,3.0,805.0,805.0
0.018,6,10,1677,5,827,4.0,559.0,559.0,5,850,4.0,582.0,582.0
0.005,6,10,1547,5,764,1.0,496.0,496.0,5,783,1.0,515.0,515.0
0.009,6,12,1926,6,1189,1.0,659.0,434.0,6,737,1.0,417.0,417.0
15.075,17,15,8302,8,6254,2149.0,1350.0,753.0,7,2048,2507.0,1350.0,264.0
0.015,6,10,1989,5,910,3.0,642.0,642.0,5,1079,3.0,811.0,811.0
0.004,17,2,136,1,60,0.0,32.0,32.0,1,76,0.0,48.0,48.0
0.005,6,14,3799,7,509,0.0,137.0,137.0,7,3290,0.0,1448.0,972.0
0.087,6,10,1506,5,395,18.0,127.0,127.0,5,1111,16.0,843.0,843.0
0.097,6,10,1506,5,395,22.0,127.0,127.0,5,1111,19.0,843.0,843.0
0.012,6,10,1972,5,910,3.0,642.0,642.0,5,1062,3.0,794.0,794.0
0.01,6,10,1983,5,910,2.0,642.0,642.0,5,1073,2.0,805.0,805.0
0.008,6,10,1989,5,927,2.0,659.0,659.0,5,1062,1.0,794.0,794.0
0.083,6,10,1506,5,395,18.0,127.0,127.0,5,1111,16.0,843.0,843.0
240.084,6,16,4480,9,963,30010.0,238.0,166.0,7,3517,40013.0,1402.0,786.0
0.012,6,10,1972,5,910,3.0,642.0,642.0,5,1062,3.0,794.0,794.0
240.131,6,31,9299,15,6905,17152.0,2028.0,681.0,16,2394,16008.0,580.0,194.0
0.004,17,2,136,1,60,0.0,32.0,32.0,1,76,0.0,48.0,48.0
0.008,6,12,1698,6,863,1.0,327.0,271.0,6,835,1.0,515.0,515.0
0.237,6,16,2782,8,1400,33.0,533.0,325.0,8,1382,22.0,529.0,239.0
0.015,6,10,1989,5,910,3.0,642.0,642.0,5,1079,3.0,811.0,811.0
0.071,17,2,412,1,61,0.0,33.0,33.0,1,351,0.0,323.0,323.0
0.073,6,10,1506,5,395,16.0,127.0,127.0,5,1111,17.0,843.0,843.0
0.006,6,10,1547,5,764,1.0,496.0,496.0,5,783,1.0,515.0,515.0
0.134,6,10,1506,5,395,29.0,127.0,127.0,5,1111,31.0,843.0,843.0
0.005,17,2,164,1,74,0.0,46.0,46.0,1,90,0.0,62.0,62.0
0.147,6,10,1506,5,395,35.0,127.0,127.0,5,1111,32.0,843.0,843.0
240.199,6,84,78187,38,17414,6491.0,2736.0,1403.0,46,60773,5337.0,2959.0,1945.0
0.013,6,10,1983,5,910,3.0,642.0,642.0,5,1073,3.0,805.0,805.0
0.005,6,14,3799,7,509,0.0,137.0,137.0,7,3290,0.0,1448.0,972.0
0.018,6,10,1983,5,910,4.0,642.0,642.0,5,1073,4.0,805.0,805.0
40.083,17,10,676,5,460,10019.0,104.0,64.0,5,216,10019.0,20.0,15.0
0.005,6,10,1779,5,928,1.0,660.0,660.0,5,851,1.0,583.0,583.0
0.004,6,10,2006,5,927,1.0,659.0,659.0,5,1079,1.0,811.0,811.0
0.008,6,10,1990,5,911,1.0,643.0,643.0,5,1079,2.0,811.0,811.0
0.074,6,10,1972,5,910,18.0,642.0,642.0,5,1062,18.0,794.0,794.0
0.007,17,2,170,1,65,0.0,37.0,37.0,1,105,0.0,77.0,77.0
0.01,6,10,1989,5,910,2.0,642.0,642.0,5,1079,2.0,811.0,811.0
0.004,6,10,2006,5,927,1.0,659.0,659.0,5,1079,1.0,811.0,811.0
0.026,6,12,4064,7,675,4.0,299.0,299.0,5,3389,5.0,1719.0,1560.0
0.004,6,10,2006,5,927,1.0,659.0,659.0,5,1079,1.0,811.0,811.0
0.006,6,10,1547,5,764,1.0,496.0,496.0,5,783,1.0,515.0,515.0
0.011,6,10,1989,5,910,2.0,642.0,642.0,5,1079,2.0,811.0,811.0
1778.252,17,143,45188,72,22752,25045.0,288.0,288.0,71,22436,25402.0,288.0,288.0
0.011,6,10,1972,5,910,2.0,642.0,642.0,5,1062,2.0,794.0,794.0
0.003,17,2,148,1,60,0.0,32.0,32.0,1,88,0.0,60.0,60.0
0.001,17,2,180,1,66,0.0,38.0,38.0,1,114,0.0,86.0,86.0
0.005,17,2,170,1,65,0.0,37.0,37.0,1,105,0.0,77.0,77.0
0.004,17,2,170,1,65,0.0,37.0,37.0,1,105,0.0,77.0,77.0
0.004,6,10,2006,5,927,1.0,659.0,659.0,5,1079,1.0,811.0,811.0
0.001,17,2,180,1,66,0.0,38.0,38.0,1,114,0.0,86.0,86.0
0.005,6,10,1989,5,927,1.0,659.0,659.0,5,1062,1.0,794.0,794.0
0.011,6,10,1990,5,911,2.0,643.0,643.0,5,1079,2.0,811.0,811.0
0.13,17,2,182,1,65,0.0,37.0,37.0,1,117,0.0,89.0,89.0
0.007,6,10,1990,5,911,1.0,643.0,643.0,5,1079,1.0,811.0,811.0
0.004,17,4,284,2,120,0.0,32.0,32.0,2,164,0.0,60.0,54.0
0.084,6,10,1506,5,395,17.0,127.0,127.0,5,1111,19.0,843.0,843.0
0.003,17,2,148,1,60,0.0,32.0,32.0,1,88,0.0,60.0,60.0
0.088,6,10,1506,5,395,15.0,127.0,127.0,5,1111,20.0,843.0,843.0
0.072,17,8,3613,4,1874,24.0,1350.0,440.0,4,1739,12.0,1350.0,406.0
0.006,6,13,3747,7,509,0.0,137.0,137.0,6,3238,1.0,1470.0,1459.0
0.005,6,10,2006,5,927,1.0,659.0,659.0,5,1079,1.0,811.0,811.0
0.004,6,10,1779,5,928,1.0,660.0,660.0,5,851,1.0,583.0,583.0
301.341,6,31,10175,17,2838,18833.0,801.0,389.0,14,7337,18561.0,1402.0,825.0
0.005,6,13,3747,7,509,0.0,137.0,137.0,6,3238,1.0,1470.0,1459.0
0.006,6,10,1547,5,764,1.0,496.0,496.0,5,783,1.0,515.0,515.0
0.017,6,10,1631,5,848,4.0,580.0,580.0,5,783,4.0,515.0,515.0
309.663,17,20,1124,10,716,34392.0,48.0,43.0,10,408,34392.0,20.0,12.0
0.004,6,10,2000,5,927,1.0,659.0,659.0,5,1073,1.0,805.0,805.0
0.02,6,10,1677,5,827,5.0,559.0,559.0,5,850,4.0,582.0,582.0
0.005,6,10,1547,5,764,1.0,496.0,496.0,5,783,1.0,515.0,515.0
0.006,6,10,1854,5,889,1.0,621.0,621.0,5,965,1.0,697.0,697.0
0.008,6,10,1989,5,910,2.0,642.0,642.0,5,1079,1.0,811.0,811.0
0.001,17,2,180,1,66,0.0,38.0,38.0,1,114,0.0,86.0,86.0
0.01,17,2,179,1,71,0.0,43.0,43.0,1,108,0.0,80.0,80.0
0.014,6,10,1762,5,911,3.0,643.0,643.0,5,851,3.0,583.0,583.0
0.118,6,10,1506,5,395,25.0,127.0,127.0,5,1111,26.0,843.0,843.0
0.005,6,10,1989,5,927,1.0,659.0,659.0,5,1062,1.0,794.0,794.0
0.005,6,10,2000,5,927,1.0,659.0,659.0,5,1073,1.0,805.0,805.0
0.278,17,39,20249,21,17046,13.0,1350.0,783.0,18,3203,12.0,1350.0,149.0
0.018,6,10,1989,5,910,4.0,642.0,642.0,5,1079,4.0,811.0,811.0
0.018,6,10,1677,5,827,4.0,559.0,559.0,5,850,4.0,582.0,582.0
240.027,6,9,787,5,488,60006.0,232.0,232.0,4,299,80008.0,83.0,83.0
0.011,6,10,1983,5,910,2.0,642.0,642.0,5,1073,2.0,805.0,805.0
15.072,17,14,9191,8,6902,2149.0,1350.0,834.0,6,2289,3008.0,1350.0,353.0
300.775,6,36,9933,19,4455,16709.0,3279.0,915.0,17,5478,537.0,2667.0,435.0
0.121,6,10,1506,5,395,25.0,127.0,127.0,5,1111,28.0,843.0,843.0
0.092,6,10,1506,5,395,19.0,127.0,127.0,5,1111,19.0,843.0,843.0
0.011,6,10,1989,5,910,2.0,642.0,642.0,5,1079,2.0,811.0,811.0
0.004,17,2,162,1,65,0.0,37.0,37.0,1,97,0.0,69.0,69.0
0.014,6,10,1677,5,827,3.0,559.0,559.0,5,850,3.0,582.0,582.0
0.005,6,10,1989,5,927,1.0,659.0,659.0,5,1062,1.0,794.0,794.0
0.12,6,10,1506,5,395,25.0,127.0,127.0,5,1111,27.0,843.0,843.0
0.086,6,10,1506,5,395,18.0,127.0,127.0,5,1111,19.0,843.0,843.0
363.636,6,42,16072,23,3009,16528.0,663.0,361.0,19,13063,16867.0,1410.0,928.0
0.091,6,10,1506,5,395,20.0,127.0,127.0,5,1111,21.0,843.0,843.0
0.08,6,10,1506,5,395,18.0,127.0,127.0,5,1111,15.0,843.0,843.0
0.005,6,10,1547,5,764,1.0,496.0,496.0,5,783,1.0,515.0,515.0
0.107,6,10,1506,5,395,25.0,127.0,127.0,5,1111,22.0,843.0,843.0
0.017,6,10,1972,5,910,4.0,642.0,642.0,5,1062,4.0,794.0,794.0
0.011,6,10,1972,5,910,2.0,642.0,642.0,5,1062,2.0,794.0,794.0
0.014,17,2,152,1,56,0.0,28.0,28.0,1,96,0.0,68.0,68.0
0.009,6,10,1677,5,827,2.0,559.0,559.0,5,850,2.0,582.0,582.0
0.004,17,4,284,2,120,0.0,32.0,32.0,2,164,0.0,60.0,54.0
0.006,6,10,1689,5,839,1.0,571.0,571.0,5,850,1.0,582.0,582.0
0.009,6,10,1972,5,910,2.0,642.0,642.0,5,1062,2.0,794.0,794.0
0.121,6,14,4389,8,923,17.0,238.0,166.0,6,3466,16.0,1402.0,786.0
0.014,6,10,1972,5,910,3.0,642.0,642.0,5,1062,3.0,794.0,794.0
0.121,6,10,1506,5,395,29.0,127.0,127.0,5,1111,26.0,843.0,843.0
0.004,17,2,136,1,60,0.0,32.0,32.0,1,76,0.0,48.0,48.0
0.005,6,13,3747,7,509,0.0,137.0,137.0,6,3238,0.0,1470.0,1459.0
0.005,17,2,136,1,60,0.0,32.0,32.0,1,76,0.0,48.0,48.0
0.013,6,10,1972,5,910,3.0,642.0,642.0,5,1062,3.0,794.0,794.0
0.015,6,10,1972,5,910,3.0,642.0,642.0,5,1062,3.0,794.0,794.0
0.026,6,10,1762,5,911,6.0,643.0,643.0,5,851,6.0,583.0,583.0
0.008,6,10,1983,5,910,2.0,642.0,642.0,5,1073,2.0,805.0,805.0
0.003,17,2,152,1,76,0.0,48.0,48.0,1,76,0.0,48.0,48.0
0.005,6,10,2006,5,927,1.0,659.0,659.0,5,1079,1.0,811.0,811.0
0.014,6,10,1762,5,911,3.0,643.0,643.0,5,851,3.0,583.0,583.0
40.057,17,10,676,5,460,10013.0,104.0,64.0,5,216,10013.0,20.0,15.0
0.001,17,2,180,1,66,0.0,38.0,38.0,1,114,0.0,86.0,86.0
0.129,17,2,80,1,32,0.0,4.0,4.0,1,48,0.0,20.0,20.0
0.021,6,10,1972,5,910,5.0,642.0,642.0,5,1062,5.0,794.0,794.0
0.085,6,10,1506,5,395,16.0,127.0,127.0,5,1111,20.0,843.0,843.0
0.005,6,10,2007,5,928,1.0,660.0,660.0,5,1079,1.0,811.0,811.0
0.076,6,10,1506,5,395,15.0,127.0,127.0,5,1111,16.0,843.0,843.0
0.014,6,10,1990,5,911,3.0,643.0,643.0,5,1079,3.0,811.0,811.0
0.042,17,4,352,2,130,1.0,37.0,37.0,2,222,3.0,89.0,83.0
0.122,6,10,1506,5,395,25.0,127.0,127.0,5,1111,29.0,843.0,843.0
0.013,6,10,1972,5,910,3.0,642.0,642.0,5,1062,3.0,794.0,794.0
0.005,17,2,213,1,69,0.0,41.0,41.0,1,144,0.0,116.0,116.0
0.005,6,10,1774,5,923,1.0,655.0,655.0,5,851,1.0,583.0,583.0
0.771,6,25,5459,12,1557,59.0,325.0,152.0,13,3902,54.0,1414.0,563.0
100.396,6,22,8465,12,2204,75.0,1345.0,564.0,10,6261,11135.0,1776.0,974.0
0.007,6,10,1972,5,910,1.0,642.0,642.0,5,1062,1.0,794.0,794.0
0.097,6,10,1506,5,395,21.0,127.0,127.0,5,1111,21.0,843.0,843.0
240.511,6,37,9697,19,2173,13361.0,745.0,235.0,18,7524,14147.0,1402.0,599.0
21.599,6,37,13136,18,7578,520.0,4080.0,1706.0,19,5558,1190.0,2667.0,435.0
0.006,6,10,1547,5,764,1.0,496.0,496.0,5,783,1.0,515.0,515.0
0.078,6,10,1506,5,395,15.0,127.0,127.0,5,1111,16.0,843.0,843.0
0.014,6,10,1762,5,911,3.0,643.0,643.0,5,851,3.0,583.0,583.0
176.107,17,86,12345,43,2871,4192.0,44.0,38.0,43,9474,4192.0,239.0,192.0
0.016,6,10,1990,5,911,4.0,643.0,643.0,5,1079,3.0,811.0,811.0
0.005,17,2,225,1,65,0.0,37.0,37.0,1,160,0.0,132.0,132.0
0.182,17,4,352,2,130,145.0,37.0,37.0,2,222,142.0,89.0,83.0
0.232,6,44,11549,24,3221,10.0,1021.0,197.0,20,8328,12.0,1402.0,606.0
240.085,6,16,4482,9,963,30010.0,238.0,166.0,7,3519,40013.0,1402.0,786.0
0.069,6,10,1506,5,395,15.0,127.0,127.0,5,1111,14.0,843.0,843.0
0.012,6,13,3735,7,497,2.0,125.0,125.0,6,3238,2.0,1470.0,1459.0
0.008,6,10,2006,5,927,2.0,659.0,659.0,5,1079,2.0,811.0,811.0
0.013,6,10,1983,5,910,3.0,642.0,642.0,5,1073,3.0,805.0,805.0
0.004,17,4,284,2,120,0.0,32.0,32.0,2,164,1.0,60.0,54.0
0.005,6,10,2007,5,928,1.0,660.0,660.0,5,1079,1.0,811.0,811.0
0.123,17,2,146,1,65,0.0,37.0,37.0,1,81,0.0,53.0,53.0
0.094,17,2,80,1,32,0.0,4.0,4.0,1,48,0.0,20.0,20.0
0.006,6,10,1643,5,860,1.0,592.0,592.0,5,783,1.0,515.0,515.0
0.005,6,10,2000,5,927,1.0,659.0,659.0,5,1073,1.0,805.0,805.0
0.004,17,2,148,1,60,0.0,32.0,32.0,1,88,0.0,60.0,60.0
0.015,6,10,1989,5,910,3.0,642.0,642.0,5,1079,3.0,811.0,811.0
0.013,6,10,1762,5,911,3.0,643.0,643.0,5,851,3.0,583.0,583.0
0.005,6,10,1854,5,889,1.0,621.0,621.0,5,965,1.0,697.0,697.0
0.006,6,10,2006,5,927,1.0,659.0,659.0,5,1079,1.0,811.0,811.0
170.137,17,88,12771,44,2961,3956.0,44.0,39.0,44,9810,3956.0,261.0,194.0
0.006,6,10,1547,5,764,1.0,496.0,496.0,5,783,1.0,515.0,515.0
0.018,6,13,3735,7,497,3.0,125.0,125.0,6,3238,3.0,1470.0,1459.0
0.009,6,12,1926,6,1189,1.0,659.0,434.0,6,737,1.0,417.0,417.0
0.005,6,10,1989,5,927,1.0,659.0,659.0,5,1062,1.0,794.0,794.0
0.015,6,10,1989,5,910,3.0,642.0,642.0,5,1079,3.0,811.0,811.0
0.003,17,2,136,1,60,0.0,32.0,32.0,1,76,0.0,48.0,48.0
240.083,6,16,4482,9,963,30010.0,238.0,166.0,7,3519,40013.0,1402.0,786.0
0.001,17,2,136,1,60,0.0,32.0,32.0,1,76,0.0,48.0,48.0
0.007,6,10,1989,5,927,1.0,659.0,659.0,5,1062,1.0,794.0,794.0
0.093,6,10,1506,5,395,20.0,127.0,127.0,5,1111,21.0,843.0,843.0
0.116,6,10,1506,5,395,21.0,127.0,127.0,5,1111,24.0,843.0,843.0
0.106,6,10,1506,5,395,24.0,127.0,127.0,5,1111,22.0,843.0,843.0
0.004,6,10,1989,5,927,1.0,659.0,659.0,5,1062,1.0,794.0,794.0
3.465,17,6,312,3,184,1665.0,48.0,33.0,3,128,1665.0,20.0,14.0
0.169,17,2,152,1,76,0.0,48.0,48.0,1,76,0.0,48.0,48.0
0.005,6,14,3799,7,509,0.0,137.0,137.0,7,3290,0.0,1448.0,972.0
0.006,6,10,1547,5,764,1.0,496.0,496.0,5,783,1.0,515.0,515.0
0.01,6,10,1631,5,848,2.0,580.0,580.0,5,783,2.0,515.0,515.0
0.005,6,10,2006,5,927,1.0,659.0,659.0,5,1079,1.0,811.0,811.0
9.04,17,6,376,5,280,2260.0,28.0,28.0,1,96,0.0,68.0,68.0
0.005,6,10,1643,5,860,1.0,592.0,592.0,5,783,1.0,515.0,515.0
0.004,6,10,1779,5,928,1.0,660.0,660.0,5,851,1.0,583.0,583.0
0.005,6,10,2006,5,927,1.0,659.0,659.0,5,1079,1.0,811.0,811.0
0.008,17,2,237,1,65,0.0,37.0,37.0,1,172,0.0,144.0,144.0
0.005,6,10,1702,5,863,1.0,595.0,595.0,5,839,1.0,571.0,571.0
0.041,17,2,152,1,76,0.0,48.0,48.0,1,76,0.0,48.0,48.0
0.018,17,2,198,1,91,0.0,63.0,63.0,1,107,0.0,79.0,79.0
0.001,17,2,180,1,66,0.0,38.0,38.0,1,114,0.0,86.0,86.0
0.005,6,10,2006,5,927,1.0,659.0,659.0,5,1079,1.0,811.0,811.0
0.007,6,10,2007,5,928,1.0,660.0,660.0,5,1079,1.0,811.0,811.0
0.006,17,2,170,1,65,0.0,37.0,37.0,1,105,0.0,77.0,77.0
0.004,17,4,284,2,120,0.0,32.0,32.0,2,164,1.0,60.0,54.0
0.001,17,2,180,1,66,0.0,38.0,38.0,1,114,0.0,86.0,86.0
0.125,17,4,284,2,120,0.0,32.0,32.0,2,164,121.0,60.0,54.0
0.005,6,10,2006,5,927,1.0,659.0,659.0,5,1079,1.0,811.0,811.0
0.01,6,10,1990,5,911,2.0,643.0,643.0,5,1079,2.0,811.0,811.0
0.005,6,10,1989,5,927,1.0,659.0,659.0,5,1062,1.0,794.0,794.0
0.004,6,10,1779,5,928,1.0,660.0,660.0,5,851,1.0,583.0,583.0
0.006,17,2,170,1,65,0.0,37.0,37.0,1,105,0.0,77.0,77.0
11.177,17,28,4422,14,1995,847.0,270.0,114.0,14,2427,846.0,586.0,145.0
0.011,6,10,1631,5,848,2.0,580.0,580.0,5,783,2.0,515.0,515.0
0.008,6,10,1983,5,910,1.0,642.0,642.0,5,1073,1.0,805.0,805.0
360.037,6,21,3981,13,3142,30003.0,494.0,494.0,8,839,51433.0,83.0,83.0
0.006,6,10,1547,5,764,1.0,496.0,496.0,5,783,1.0,515.0,515.0
0.229,6,16,2670,8,1396,32.0,533.0,324.0,8,1274,21.0,529.0,212.0
0.021,6,10,1972,5,910,5.0,642.0,642.0,5,1062,5.0,794.0,794.0
0.005,17,2,140,1,62,0.0,34.0,34.0,1,78,0.0,50.0,50.0
40.067,17,10,676,5,460,10015.0,104.0,64.0,5,216,10016.0,20.0,15.0
0.019,6,10,1631,5,848,4.0,580.0,580.0,5,783,4.0,515.0,515.0
0.005,6,10,1643,5,860,1.0,592.0,592.0,5,783,1.0,515.0,515.0
0.014,6,10,1989,5,910,3.0,642.0,642.0,5,1079,3.0,811.0,811.0
0.005,6,10,2006,5,927,1.0,659.0,659.0,5,1079,1.0,811.0,811.0
15.099,17,15,8265,8,6007,2153.0,1350.0,722.0,7,2258,2511.0,1350.0,294.0
0.006,6,10,1547,5,764,1.0,496.0,496.0,5,783,1.0,515.0,515.0
240.118,6,32,9365,15,6739,17151.0,1850.0,661.0,17,2626,15007.0,580.0,216.0
0.005,6,10,1989,5,927,1.0,659.0,659.0,5,1062,1.0,794.0,794.0
0.01,6,10,1983,5,910,2.0,642.0,642.0,5,1073,2.0,805.0,805.0
0.003,17,4,284,2,120,0.0,32.0,32.0,2,164,0.0,60.0,54.0
0.012,6,10,1972,5,910,3.0,642.0,642.0,5,1062,3.0,794.0,794.0
292.103,6,407,349796,199,21920,1475.0,2736.0,888.0,208,327876,1411.0,2804.0,1634.0
0.062,6,10,1506,5,395,14.0,127.0,127.0,5,1111,14.0,843.0,843.0
0.005,6,10,2000,5,927,1.0,659.0,659.0,5,1073,1.0,805.0,805.0
0.004,6,10,1702,5,863,1.0,595.0,595.0,5,839,1.0,571.0,571.0
0.005,6,10,2006,5,927,1.0,659.0,659.0,5,1079,1.0,811.0,811.0
0.067,6,10,1506,5,395,14.0,127.0,127.0,5,1111,15.0,843.0,843.0
0.132,6,10,1506,5,395,30.0,127.0,127.0,5,1111,29.0,843.0,843.0
0.004,17,2,234,1,61,0.0,33.0,33.0,1,173,0.0,145.0,145.0
0.012,6,10,1983,5,910,3.0,642.0,642.0,5,1073,2.0,805.0,805.0
0.016,6,10,1972,5,910,4.0,642.0,642.0,5,1062,3.0,794.0,794.0
0.013,6,10,1990,5,911,3.0,643.0,643.0,5,1079,3.0,811.0,811.0
0.005,17,2,152,1,68,0.0,40.0,40.0,1,84,0.0,56.0,56.0
0.005,6,10,2007,5,928,1.0,660.0,660.0,5,1079,1.0,811.0,811.0
1744.237,6,64,7361,42,4485,42542.0,1641.0,109.0,22,2876,83050.0,1112.0,82.0
40.072,17,10,676,5,460,10014.0,104.0,64.0,5,216,10017.0,20.0,15.0
0.033,6,10,1972,5,910,8.0,642.0,642.0,5,1062,8.0,794.0,794.0
0.08,6,10,1506,5,395,16.0,127.0,127.0,5,1111,17.0,843.0,843.0
15.076,17,15,9238,8,6902,2149.0,1350.0,834.0,7,2336,2507.0,1350.0,305.0
0.001,17,2,180,1,66,0.0,38.0,38.0,1,114,0.0,86.0,86.0
1.169,6,33,13431,19,5932,64.0,1360.0,732.0,14,7499,76.0,2565.0,769.0
0.012,6,10,1990,5,911,3.0,643.0,643.0,5,1079,2.0,811.0,811.0
0.003,17,2,136,1,60,0.0,32.0,32.0,1,76,0.0,48.0,48.0
0.005,6,10,1854,5,889,1.0,621.0,621.0,5,965,1.0,697.0,697.0
0.006,17,2,293,1,73,0.0,45.0,45.0,1,220,0.0,192.0,192.0
0.013,6,10,1990,5,911,3.0,643.0,643.0,5,1079,3.0,811.0,811.0
0.039,17,2,148,1,60,0.0,32.0,32.0,1,88,0.0,60.0,60.0
167.302,17,74,10736,37,2466,4647.0,44.0,38.0,37,8270,4647.0,261.0,195.0
40.063,17,10,676,5,460,10014.0,104.0,64.0,5,216,10014.0,20.0,15.0
0.112,6,10,1506,5,395,25.0,127.0,127.0,5,1111,24.0,843.0,843.0
0.004,6,10,2007,5,928,1.0,660.0,660.0,5,1079,1.0,811.0,811.0
0.005,6,14,3742,8,504,0.0,80.0,80.0,6,3238,1.0,1470.0,1459.0
0.005,17,2,169,1,62,0.0,34.0,34.0,1,107,0.0,79.0,79.0
40.076,17,10,676,5,460,10016.0,104.0,64.0,5,216,10018.0,20.0,15.0
0.028,6,10,1989,5,910,6.0,642.0,642.0,5,1079,7.0,811.0,811.0
300.404,6,16,2170,9,684,37529.0,146.0,146.0,7,1486,50039.0,419.0,398.0
0.009,6,10,1972,5,910,2.0,642.0,642.0,5,1062,2.0,794.0,794.0
0.006,6,10,1643,5,860,1.0,592.0,592.0,5,783,1.0,515.0,515.0
0.384,17,43,20637,23,17146,17.0,1350.0,717.0,20,3491,17.0,1350.0,146.0
0.005,17,2,214,1,75,0.0,47.0,47.0,1,139,0.0,111.0,111.0
0.006,6,10,1547,5,764,1.0,496.0,496.0,5,783,1.0,515.0,515.0
0.014,6,10,1989,5,910,3.0,642.0,642.0,5,1079,3.0,811.0,811.0
0.061,6,10,1506,5,395,13.0,127.0,127.0,5,1111,14.0,843.0,843.0
300.339,6,16,2170,9,684,37521.0,146.0,146.0,7,1486,50028.0,419.0,398.0
0.013,6,13,3735,7,497,2.0,125.0,125.0,6,3238,2.0,1470.0,1459.0
0.005,6,10,2006,5,927,1.0,659.0,659.0,5,1079,1.0,811.0,811.0
0.01,6,10,1972,5,910,2.0,642.0,642.0,5,1062,2.0,794.0,794.0
0.202,6,16,2778,8,1396,28.0,533.0,324.0,8,1382,18.0,529.0,239.0
0.052,17,2,144,1,64,0.0,36.0,36.0,1,80,0.0,52.0,52.0
0.005,6,10,2007,5,928,1.0,660.0,660.0,5,1079,1.0,811.0,811.0
40.068,17,10,676,5,460,10014.0,104.0,64.0,5,216,10016.0,20.0,15.0
0.005,6,10,2006,5,927,1.0,659.0,659.0,5,1079,1.0,811.0,811.0
0.066,6,10,1506,5,395,14.0,127.0,127.0,5,1111,15.0,843.0,843.0
0.127,17,2,170,1,65,0.0,37.0,37.0,1,105,0.0,77.0,77.0
0.005,6,10,2007,5,928,1.0,660.0,660.0,5,1079,1.0,811.0,811.0
0.005,6,10,2006,5,927,1.0,659.0,659.0,5,1079,1.0,811.0,811.0
0.005,6,10,2006,5,927,1.0,659.0,659.0,5,1079,1.0,811.0,811.0
0.106,6,10,1506,5,395,24.0,127.0,127.0,5,1111,24.0,843.0,843.0
0.008,6,10,1762,5,911,2.0,643.0,643.0,5,851,1.0,583.0,583.0
40.066,17,10,676,5,460,10014.0,104.0,64.0,5,216,10015.0,20.0,15.0
0.005,6,10,2007,5,928,1.0,660.0,660.0,5,1079,1.0,811.0,811.0
0.014,6,13,3735,7,497,2.0,125.0,125.0,6,3238,2.0,1470.0,1459.0
1778.643,17,144,45504,72,22752,25047.0,288.0,288.0,72,22752,25051.0,288.0,288.0
0.1,6,10,1506,5,395,23.0,127.0,127.0,5,1111,23.0,843.0,843.0
0.094,6,10,1506,5,395,20.0,127.0,127.0,5,1111,22.0,843.0,843.0
15.078,17,15,8409,8,6297,2150.0,1350.0,759.0,7,2112,2508.0,1350.0,273.0
0.017,6,13,3735,7,497,2.0,125.0,125.0,6,3238,3.0,1470.0,1459.0
0.783,6,25,5459,12,1557,62.0,325.0,152.0,13,3902,55.0,1414.0,563.0
308.445,17,20,1124,10,716,34258.0,48.0,43.0,10,408,34258.0,20.0,12.0
0.007,6,10,1989,5,910,1.0,642.0,642.0,5,1079,1.0,811.0,811.0
0.001,17,2,180,1,66,0.0,38.0,38.0,1,114,0.0,86.0,86.0
0.011,6,10,1762,5,911,2.0,643.0,643.0,5,851,2.0,583.0,583.0
1792.458,6,486,99194,244,87924,7375.0,421.0,368.0,242,11270,7437.0,53.0,53.0
0.089,6,10,1506,5,395,18.0,127.0,127.0,5,1111,18.0,843.0,843.0
309.139,17,20,1124,10,716,34333.0,48.0,43.0,10,408,34333.0,20.0,12.0
0.013,17,2,194,1,59,0.0,31.0,31.0,1,135,0.0,107.0,107.0
125.992,6,14,2938,8,2504,17964.0,1414.0,1086.0,6,434,25149.0,182.0,182.0
40.062,17,10,676,5,460,10013.0,104.0,64.0,5,216,10014.0,20.0,15.0
0.005,17,2,185,1,73,0.0,45.0,45.0,1,112,0.0,84.0,84.0
0.005,6,10,2000,5,927,1.0,659.0,659.0,5,1073,1.0,805.0,805.0
0.005,17,2,230,1,68,0.0,40.0,40.0,1,162,0.0,134.0,134.0
0.004,6,10,2006,5,927,1.0,659.0,659.0,5,1079,1.0,811.0,811.0
167.394,17,84,11718,42,2816,4082.0,44.0,39.0,42,8902,4082.0,239.0,183.0
0.068,6,10,1506,5,395,15.0,127.0,127.0,5,1111,13.0,843.0,843.0
0.005,6,10,1643,5,860,1.0,592.0,592.0,5,783,1.0,515.0,515.0
0.104,6,10,1506,5,395,25.0,127.0,127.0,5,1111,19.0,843.0,843.0
0.04,17,2,412,1,61,0.0,33.0,33.0,1,351,0.0,323.0,323.0
0.006,17,2,170,1,65,0.0,37.0,37.0,1,105,0.0,77.0,77.0
0.006,6,10,1989,5,927,1.0,659.0,659.0,5,1062,1.0,794.0,794.0
0.005,17,2,170,1,65,0.0,37.0,37.0,1,105,0.0,77.0,77.0
0.006,17,2,144,1,64,0.0,36.0,36.0,1,80,0.0,52.0,52.0
0.041,17,4,284,2,120,0.0,32.0,32.0,2,164,38.0,60.0,54.0
0.006,6,10,1689,5,839,1.0,571.0,571.0,5,850,1.0,582.0,582.0
371.175,6,22,2313,16,867,24745.0,195.0,195.0,6,1446,4642.0,419.0,398.0
0.009,17,4,284,2,120,6.0,32.0,32.0,2,164,6.0,60.0,54.0
10.891,17,28,4394,14,1993,828.0,268.0,114.0,14,2401,828.0,588.0,143.0
0.001,17,2,180,1,66,0.0,38.0,38.0,1,114,0.0,86.0,86.0
0.015,6,10,1631,5,848,3.0,580.0,580.0,5,783,3.0,515.0,515.0
0.004,6,10,2006,5,927,1.0,659.0,659.0,5,1079,1.0,811.0,811.0
0.021,6,10,1989,5,910,5.0,642.0,642.0,5,1079,5.0,811.0,811.0
0.01,6,10,1989,5,910,2.0,642.0,642.0,5,1079,2.0,811.0,811.0
0.01,6,10,1990,5,911,2.0,643.0,643.0,5,1079,2.0,811.0,811.0
0.005,6,14,3799,7,509,0.0,137.0,137.0,7,3290,0.0,1448.0,972.0
0.003,17,2,148,1,60,0.0,32.0,32.0,1,88,0.0,60.0,60.0
0.005,17,2,169,1,62,0.0,34.0,34.0,1,107,0.0,79.0,79.0
0.004,6,10,1774,5,923,1.0,655.0,655.0,5,851,1.0,583.0,583.0
240.266,6,45,8928,24,5854,10446.0,1368.0,458.0,21,3074,12013.0,580.0,219.0
0.004,6,10,1702,5,863,1.0,595.0,595.0,5,839,1.0,571.0,571.0
60.649,6,35,9313,17,3795,554.0,2730.0,1027.0,18,5518,3557.0,2667.0,435.0
0.004,6,10,2000,5,927,1.0,659.0,659.0,5,1073,1.0,805.0,805.0
0.005,17,2,214,1,75,0.0,47.0,47.0,1,139,0.0,111.0,111.0
0.106,6,10,1506,5,395,25.0,127.0,127.0,5,1111,21.0,843.0,843.0
11.116,17,28,4422,14,1994,842.0,269.0,114.0,14,2428,842.0,587.0,145.0
0.004,6,10,1989,5,927,1.0,659.0,659.0,5,1062,1.0,794.0,794.0
0.005,6,10,2007,5,928,1.0,660.0,660.0,5,1079,1.0,811.0,811.0
0.084,6,10,1506,5,395,18.0,127.0,127.0,5,1111,16.0,843.0,843.0
0.014,6,13,3735,7,497,2.0,125.0,125.0,6,3238,2.0,1470.0,1459.0
0.004,6,10,2006,5,927,1.0,659.0,659.0,5,1079,1.0,811.0,811.0
0.092,6,10,1506,5,395,19.0,127.0,127.0,5,1111,17.0,843.0,843.0
0.166,17,2,152,1,76,0.0,48.0,48.0,1,76,0.0,48.0,48.0
0.007,6,10,1774,5,923,1.0,655.0,655.0,5,851,1.0,583.0,583.0
0.005,6,10,2006,5,927,1.0,659.0,659.0,5,1079,1.0,811.0,811.0
0.04,17,4,284,2,120,0.0,32.0,32.0,2,164,37.0,60.0,54.0
0.072,6,10,1506,5,395,15.0,127.0,127.0,5,1111,15.0,843.0,843.0
0.004,6,10,1702,5,863,1.0,595.0,595.0,5,839,0.0,571.0,571.0
1116.402,6,85,32372,45,8497,25372.0,676.0,512.0,40,23875,27085.0,1941.0,806.0
0.009,6,13,3735,7,497,1.0,125.0,125.0,6,3238,1.0,1470.0,1459.0
0.008,6,10,1989,5,910,2.0,642.0,642.0,5,1079,1.0,811.0,811.0
0.005,6,10,1779,5,928,1.0,660.0,660.0,5,851,1.0,583.0,583.0
0.013,6,10,1972,5,910,3.0,642.0,642.0,5,1062,3.0,794.0,794.0
0.006,17,2,179,1,71,0.0,43.0,43.0,1,108,0.0,80.0,80.0
300.023,6,12,1782,7,1348,50003.0,494.0,494.0,5,434,75005.0,83.0,83.0
40.075,17,10,676,5,460,10018.0,104.0,64.0,5,216,10018.0,20.0,15.0
0.013,6,10,1989,5,910,3.0,642.0,642.0,5,1079,3.0,811.0,811.0
0.005,6,10,1854,5,889,1.0,621.0,621.0,5,965,1.0,697.0,697.0
0.019,6,10,1990,5,911,4.0,643.0,643.0,5,1079,4.0,811.0,811.0
0.012,6,10,1631,5,848,3.0,580.0,580.0,5,783,2.0,515.0,515.0
0.004,17,4,284,2,120,0.0,32.0,32.0,2,164,0.0,60.0,54.0
0.022,6,10,1989,5,910,5.0,642.0,642.0,5,1079,5.0,811.0,811.0
0.004,6,10,2007,5,928,1.0,660.0,660.0,5,1079,1.0,811.0,811.0
0.171,6,3,453,2,321,171.0,241.0,241.0,1,132,0.0,92.0,92.0
0.005,6,13,3747,7,509,0.0,137.0,137.0,6,3238,1.0,1470.0,1459.0
0.085,6,10,1506,5,395,19.0,127.0,127.0,5,1111,20.0,843.0,843.0
0.138,17,2,142,1,63,0.0,35.0,35.0,1,79,0.0,51.0,51.0
0.008,6,12,1926,6,1189,1.0,659.0,434.0,6,737,1.0,417.0,417.0
0.095,6,10,1506,5,395,21.0,127.0,127.0,5,1111,21.0,843.0,843.0
0.069,17,8,3613,4,1874,23.0,1350.0,440.0,4,1739,12.0,1350.0,406.0
0.013,6,10,1779,5,928,3.0,660.0,660.0,5,851,3.0,583.0,583.0
0.097,6,10,1506,5,395,23.0,127.0,127.0,5,1111,18.0,843.0,843.0
0.12,6,10,1506,5,395,28.0,127.0,127.0,5,1111,25.0,843.0,843.0
0.052,6,20,9974,11,704,5.0,124.0,124.0,9,9270,6.0,2896.0,1758.0
0.037,17,2,170,1,65,0.0,37.0,37.0,1,105,0.0,77.0,77.0
0.005,6,10,1989,5,927,1.0,659.0,659.0,5,1062,1.0,794.0,794.0
0.098,6,10,1506,5,395,23.0,127.0,127.0,5,1111,23.0,843.0,843.0
40.089,17,10,676,5,460,10018.0,104.0,64.0,5,216,10021.0,20.0,15.0
0.181,17,4,352,2,130,142.0,37.0,37.0,2,222,142.0,89.0,83.0
0.039,17,4,420,2,122,0.0,33.0,33.0,2,298,36.0,145.0,121.0
0.013,6,10,1972,5,910,3.0,642.0,642.0,5,1062,3.0,794.0,794.0
0.012,6,10,1990,5,911,3.0,643.0,643.0,5,1079,3.0,811.0,811.0
0.01,6,10,1990,5,911,2.0,643.0,643.0,5,1079,2.0,811.0,811.0
0.135,6,10,1506,5,395,30.0,127.0,127.0,5,1111,31.0,843.0,843.0
0.079,6,10,1506,5,395,17.0,127.0,127.0,5,1111,16.0,843.0,843.0
0.006,6,10,1643,5,860,1.0,592.0,592.0,5,783,1.0,515.0,515.0
0.01,6,10,1989,5,910,2.0,642.0,642.0,5,1079,2.0,811.0,811.0
0.006,6,12,1698,6,863,1.0,327.0,271.0,6,835,1.0,515.0,515.0
0.011,6,14,3787,7,497,1.0,125.0,125.0,7,3290,1.0,1448.0,972.0
0.006,17,2,148,1,60,0.0,32.0,32.0,1,88,0.0,60.0,60.0
0.088,6,10,1506,5,395,20.0,127.0,127.0,5,1111,20.0,843.0,843.0
0.009,6,10,1631,5,848,2.0,580.0,580.0,5,783,2.0,515.0,515.0
0.449,17,62,45216,37,36330,12.0,1350.0,953.0,25,8886,16.0,1350.0,327.0
0.005,17,2,213,1,69,0.0,41.0,41.0,1,144,0.0,116.0,116.0
0.006,17,2,214,1,75,0.0,47.0,47.0,1,139,0.0,111.0,111.0
0.005,6,10,2000,5,927,1.0,659.0,659.0,5,1073,1.0,805.0,805.0
0.005,17,2,175,1,65,0.0,37.0,37.0,1,110,0.0,82.0,82.0
0.094,6,10,1506,5,395,21.0,127.0,127.0,5,1111,19.0,843.0,843.0
0.012,6,10,1989,5,910,2.0,642.0,642.0,5,1079,3.0,811.0,811.0
0.112,6,10,1506,5,395,24.0,127.0,127.0,5,1111,22.0,843.0,843.0
0.017,6,13,3735,7,497,2.0,125.0,125.0,6,3238,3.0,1470.0,1459.0
0.005,6,10,1643,5,860,1.0,592.0,592.0,5,783,1.0,515.0,515.0
0.115,6,10,1506,5,395,26.0,127.0,127.0,5,1111,28.0,843.0,843.0
308.633,17,20,1124,10,716,34278.0,48.0,43.0,10,408,34278.0,20.0,12.0
311.152,17,18,1008,9,640,38877.0,48.0,43.0,9,368,38877.0,20.0,12.0
0.003,17,2,136,1,60,0.0,32.0,32.0,1,76,0.0,48.0,48.0
0.005,6,14,3799,7,509,0.0,137.0,137.0,7,3290,0.0,1448.0,972.0
0.072,17,2,412,1,61,0.0,33.0,33.0,1,351,0.0,323.0,323.0
308.772,17,18,1008,9,640,38589.0,48.0,43.0,9,368,38589.0,20.0,12.0
0.034,6,10,1990,5,911,8.0,643.0,643.0,5,1079,8.0,811.0,811.0
0.005,6,10,1854,5,889,1.0,621.0,621.0,5,965,1.0,697.0,697.0
0.22,17,14,8577,7,4012,36.0,1350.0,545.0,7,4565,27.0,1350.0,624.0
0.129,17,2,80,1,32,0.0,4.0,4.0,1,48,0.0,20.0,20.0
0.008,6,14,3787,7,497,1.0,125.0,125.0,7,3290,1.0,1448.0,972.0
0.071,17,2,148,1,60,0.0,32.0,32.0,1,88,0.0,60.0,60.0
0.059,6,10,1506,5,395,12.0,127.0,127.0,5,1111,14.0,843.0,843.0
0.038,17,2,396,1,61,0.0,33.0,33.0,1,335,0.0,307.0,307.0
0.013,6,10,1989,5,910,3.0,642.0,642.0,5,1079,3.0,811.0,811.0
0.005,6,10,1989,5,927,1.0,659.0,659.0,5,1062,1.0,794.0,794.0
0.085,6,10,1506,5,395,19.0,127.0,127.0,5,1111,20.0,843.0,843.0
0.216,6,16,2783,8,1401,30.0,533.0,325.0,8,1382,19.0,529.0,239.0
40.073,17,10,676,5,460,10017.0,104.0,64.0,5,216,10017.0,20.0,15.0
0.005,6,10,1547,5,764,1.0,496.0,496.0,5,783,1.0,515.0,515.0
143.233,6,22,9233,11,1575,73.0,794.0,367.0,11,7658,14310.0,1360.0,1029.0
66.214,6,22,10152,12,3985,6019.0,1591.0,838.0,10,6167,7339.0,2111.0,939.0
0.08,6,10,1506,5,395,18.0,127.0,127.0,5,1111,15.0,843.0,843.0
0.008,6,10,1972,5,910,2.0,642.0,642.0,5,1062,2.0,794.0,794.0
0.171,6,10,1506,5,395,37.0,127.0,127.0,5,1111,38.0,843.0,843.0
11.207,17,28,4422,14,1994,849.0,269.0,114.0,14,2428,849.0,587.0,145.0
0.135,6,10,1506,5,395,32.0,127.0,127.0,5,1111,27.0,843.0,843.0
300.42,6,19,3081,11,1647,30042.0,517.0,266.0,8,1434,34340.0,821.0,336.0
0.005,6,13,3690,7,452,0.0,80.0,80.0,6,3238,1.0,1470.0,1459.0
0.406,6,22,7187,11,1635,40.0,748.0,263.0,11,5552,40.0,2335.0,994.0
0.005,17,2,140,1,62,0.0,34.0,34.0,1,78,0.0,50.0,50.0
15.289,17,41,21680,23,18467,693.0,1350.0,774.0,18,3213,897.0,1350.0,150.0
0.005,6,10,2000,5,927,1.0,659.0,659.0,5,1073,1.0,805.0,805.0
0.13,17,2,80,1,32,0.0,4.0,4.0,1,48,0.0,20.0,20.0
0.268,17,12,4360,6,2000,53.0,1350.0,305.0,6,2360,38.0,1350.0,365.0
0.005,6,14,3736,7,446,0.0,74.0,74.0,7,3290,0.0,1448.0,972.0
0.008,6,12,1926,6,1189,1.0,659.0,434.0,6,737,1.0,417.0,417.0
1784.113,6,306,98449,189,87105,9489.0,1402.0,671.0,117,11344,15380.0,452.0,70.0
0.083,6,10,1506,5,395,19.0,127.0,127.0,5,1111,16.0,843.0,843.0
0.005,17,2,164,1,74,0.0,46.0,46.0,1,90,0.0,62.0,62.0
0.003,17,2,136,1,60,0.0,32.0,32.0,1,76,0.0,48.0,48.0
373.907,6,24,5467,13,3385,31158.0,973.0,450.0,11,2082,37390.0,824.0,378.0
1771.045,6,304,97610,189,86498,9420.0,1402.0,666.0,115,11112,15535.0,452.0,70.0
0.011,6,10,1989,5,910,2.0,642.0,642.0,5,1079,2.0,811.0,811.0
0.005,6,10,2007,5,928,1.0,660.0,660.0,5,1079,1.0,811.0,811.0
308.596,17,20,1124,10,716,34274.0,48.0,43.0,10,408,34274.0,20.0,12.0
0.124,6,10,1506,5,395,28.0,127.0,127.0,5,1111,16.0,843.0,843.0
0.994,17,23,16287,10,4280,110.0,1350.0,400.0,13,12007,78.0,1350.0,895.0
0.088,6,10,1506,5,395,18.0,127.0,127.0,5,1111,20.0,843.0,843.0
0.013,6,10,1972,5,910,3.0,642.0,642.0,5,1062,3.0,794.0,794.0
0.005,6,10,2006,5,927,1.0,659.0,659.0,5,1079,1.0,811.0,811.0
0.126,6,10,1506,5,395,21.0,127.0,127.0,5,1111,29.0,843.0,843.0
0.037,17,2,166,1,75,0.0,47.0,47.0,1,91,0.0,63.0,63.0
0.005,6,10,1854,5,889,1.0,621.0,621.0,5,965,1.0,697.0,697.0
0.011,6,10,1989,5,910,2.0,642.0,642.0,5,1079,2.0,811.0,811.0
0.004,6,10,2006,5,927,1.0,659.0,659.0,5,1079,1.0,811.0,811.0
0.012,6,10,1631,5,848,2.0,580.0,580.0,5,783,3.0,515.0,515.0
0.004,17,2,148,1,60,0.0,32.0,32.0,1,88,0.0,60.0,60.0
0.011,6,14,3787,7,497,1.0,125.0,125.0,7,3290,1.0,1448.0,972.0
0.073,6,10,1506,5,395,16.0,127.0,127.0,5,1111,14.0,843.0,843.0
0.005,17,2,212,1,74,0.0,46.0,46.0,1,138,0.0,110.0,110.0
0.01,6,10,1972,5,910,2.0,642.0,642.0,5,1062,2.0,794.0,794.0
0.005,6,10,2006,5,927,1.0,659.0,659.0,5,1079,1.0,811.0,811.0
0.005,6,10,2007,5,928,1.0,660.0,660.0,5,1079,1.0,811.0,811.0
0.007,17,2,299,1,65,0.0,37.0,37.0,1,234,0.0,206.0,206.0
0.011,6,10,1989,5,910,2.0,642.0,642.0,5,1079,2.0,811.0,811.0
55.829,6,23,6416,13,1706,4652.0,745.0,336.0,10,4710,6201.0,1591.0,697.0
65.622,6,45,15028,22,9081,434.0,2720.0,1167.0,23,5947,2975.0,1360.0,358.0
0.006,6,10,1547,5,764,1.0,496.0,496.0,5,783,1.0,515.0,515.0
0.111,6,10,1506,5,395,25.0,127.0,127.0,5,1111,22.0,843.0,843.0
0.011,6,10,1990,5,911,2.0,643.0,643.0,5,1079,2.0,811.0,811.0
0.004,17,2,136,1,60,0.0,32.0,32.0,1,76,0.0,48.0,48.0
0.012,6,10,1989,5,910,3.0,642.0,642.0,5,1079,2.0,811.0,811.0
0.004,17,2,160,1,72,0.0,44.0,44.0,1,88,0.0,60.0,60.0
40.069,17,10,676,5,460,10016.0,104.0,64.0,5,216,10016.0,20.0,15.0
0.005,6,10,2007,5,928,1.0,660.0,660.0,5,1079,1.0,811.0,811.0
367.179,6,22,2313,16,867,24478.0,195.0,195.0,6,1446,4638.0,419.0,398.0
0.006,6,10,1689,5,839,1.0,571.0,571.0,5,850,1.0,582.0,582.0
0.009,6,13,3735,7,497,1.0,125.0,125.0,6,3238,1.0,1470.0,1459.0
0.079,6,10,1506,5,395,16.0,127.0,127.0,5,1111,18.0,843.0,843.0
0.02,6,10,1983,5,910,5.0,642.0,642.0,5,1073,4.0,805.0,805.0
0.006,6,10,1547,5,764,1.0,496.0,496.0,5,783,1.0,515.0,515.0
240.012,6,9,787,5,488,60003.0,232.0,232.0,4,299,80002.0,83.0,83.0
0.004,6,10,1702,5,863,1.0,595.0,595.0,5,839,0.0,571.0,571.0
0.006,6,10,1547,5,764,1.0,496.0,496.0,5,783,1.0,515.0,515.0
15.19,17,20,11392,10,7824,1684.0,1350.0,754.0,10,3568,1684.0,1350.0,328.0
0.004,6,10,1779,5,928,1.0,660.0,660.0,5,851,1.0,583.0,583.0
0.007,17,2,194,1,59,0.0,31.0,31.0,1,135,0.0,107.0,107.0
0.008,6,10,1762,5,911,1.0,643.0,643.0,5,851,1.0,583.0,583.0
0.01,6,10,1989,5,910,2.0,642.0,642.0,5,1079,2.0,811.0,811.0
0.082,6,10,1506,5,395,16.0,127.0,127.0,5,1111,16.0,843.0,843.0
10.919,17,28,4418,14,1994,831.0,269.0,114.0,14,2424,831.0,587.0,145.0
0.012,6,10,1631,5,848,2.0,580.0,580.0,5,783,2.0,515.0,515.0
300.019,6,12,1782,7,1348,50003.0,494.0,494.0,5,434,75004.0,83.0,83.0
0.006,6,10,1854,5,889,1.0,621.0,621.0,5,965,1.0,697.0,697.0
0.013,6,10,1983,5,910,3.0,642.0,642.0,5,1073,3.0,805.0,805.0
0.02,6,10,1762,5,911,5.0,643.0,643.0,5,851,4.0,583.0,583.0
0.011,6,10,1983,5,910,2.0,642.0,642.0,5,1073,2.0,805.0,805.0
9.043,17,6,376,5,280,2260.0,28.0,28.0,1,96,0.0,68.0,68.0
240.251,6,27,8456,13,2333,20020.0,1172.0,415.0,14,6123,18480.0,1591.0,598.0
8.772,6,35,9615,18,3485,516.0,1360.0,683.0,17,6130,535.0,2658.0,494.0
0.094,6,10,1506,5,395,21.0,127.0,127.0,5,1111,23.0,843.0,843.0
0.005,6,10,2006,5,927,1.0,659.0,659.0,5,1079,1.0,811.0,811.0
0.013,6,10,1990,5,911,3.0,643.0,643.0,5,1079,3.0,811.0,811.0
0.005,6,14,3799,7,509,0.0,137.0,137.0,7,3290,0.0,1448.0,972.0
0.169,17,2,152,1,76,0.0,48.0,48.0,1,76,0.0,48.0,48.0
0.118,6,10,1506,5,395,27.0,127.0,127.0,5,1111,28.0,843.0,843.0
0.007,6,10,1854,5,889,1.0,621.0,621.0,5,965,1.0,697.0,697.0
0.018,6,10,1990,5,911,4.0,643.0,643.0,5,1079,4.0,811.0,811.0
0.137,6,10,1506,5,395,23.0,127.0,127.0,5,1111,31.0,843.0,843.0
0.109,6,10,1506,5,395,25.0,127.0,127.0,5,1111,23.0,843.0,843.0
0.005,6,10,1989,5,927,1.0,659.0,659.0,5,1062,1.0,794.0,794.0
0.007,17,2,132,1,58,0.0,30.0,30.0,1,74,0.0,46.0,46.0
0.083,6,10,1506,5,395,20.0,127.0,127.0,5,1111,16.0,843.0,843.0
0.021,6,10,1990,5,911,5.0,643.0,643.0,5,1079,5.0,811.0,811.0
0.094,6,10,1506,5,395,19.0,127.0,127.0,5,1111,20.0,843.0,843.0
40.071,17,10,676,5,460,10016.0,104.0,64.0,5,216,10016.0,20.0,15.0
0.005,6,10,2006,5,927,1.0,659.0,659.0,5,1079,1.0,811.0,811.0
0.005,6,10,1779,5,928,1.0,660.0,660.0,5,851,1.0,583.0,583.0
308.59,17,19,1084,10,716,34273.0,48.0,43.0,9,368,38559.0,20.0,12.0
0.014,6,10,1983,5,910,3.0,642.0,642.0,5,1073,3.0,805.0,805.0
240.015,6,9,787,5,488,60003.0,232.0,232.0,4,299,80003.0,83.0,83.0
0.005,6,10,1774,5,923,1.0,655.0,655.0,5,851,1.0,583.0,583.0
0.004,6,10,1779,5,928,1.0,660.0,660.0,5,851,1.0,583.0,583.0
0.005,17,2,164,1,74,0.0,46.0,46.0,1,90,0.0,62.0,62.0
0.04,17,2,152,1,76,0.0,48.0,48.0,1,76,0.0,48.0,48.0
15.072,17,14,9190,8,6902,2149.0,1350.0,834.0,6,2288,3008.0,1350.0,353.0
0.074,6,10,1506,5,395,16.0,127.0,127.0,5,1111,16.0,843.0,843.0
0.012,6,10,1990,5,911,3.0,643.0,643.0,5,1079,3.0,811.0,811.0
40.079,17,10,676,5,460,10018.0,104.0,64.0,5,216,10018.0,20.0,15.0
0.014,6,10,2006,5,927,3.0,659.0,659.0,5,1079,3.0,811.0,811.0
0.01,6,10,1989,5,910,2.0,642.0,642.0,5,1079,2.0,811.0,811.0
0.383,17,42,20674,23,17147,17.0,1350.0,717.0,19,3527,15.0,1350.0,157.0
0.013,17,2,152,1,56,0.0,28.0,28.0,1,96,0.0,68.0,68.0
0.003,17,2,136,1,60,0.0,32.0,32.0,1,76,0.0,48.0,48.0
0.009,6,10,1990,5,911,2.0,643.0,643.0,5,1079,2.0,811.0,811.0
40.078,17,10,676,5,460,10018.0,104.0,64.0,5,216,10018.0,20.0,15.0
0.067,6,10,1506,5,395,13.0,127.0,127.0,5,1111,16.0,843.0,843.0
0.004,17,2,136,1,60,0.0,32.0,32.0,1,76,0.0,48.0,48.0
0.118,6,10,1506,5,395,27.0,127.0,127.0,5,1111,25.0,843.0,843.0
0.016,6,14,3787,7,497,2.0,125.0,125.0,7,3290,2.0,1448.0,972.0
0.018,6,10,1983,5,910,4.0,642.0,642.0,5,1073,4.0,805.0,805.0
0.005,6,10,2000,5,927,1.0,659.0,659.0,5,1073,1.0,805.0,805.0
0.122,17,2,80,1,32,0.0,4.0,4.0,1,48,0.0,20.0,20.0
0.005,6,10,1989,5,927,1.0,659.0,659.0,5,1062,1.0,794.0,794.0
0.04,17,2,170,1,65,0.0,37.0,37.0,1,105,0.0,77.0,77.0
0.004,6,10,1702,5,863,1.0,595.0,595.0,5,839,1.0,571.0,571.0
0.011,6,10,1989,5,910,2.0,642.0,642.0,5,1079,2.0,811.0,811.0
0.175,17,2,152,1,76,0.0,48.0,48.0,1,76,0.0,48.0,48.0
0.071,17,4,284,2,120,0.0,32.0,32.0,2,164,66.0,60.0,54.0
30.641,6,25,8066,14,2988,2348.0,1191.0,449.0,11,5078,3053.0,1402.0,751.0
0.074,17,8,3613,4,1874,24.0,1350.0,440.0,4,1739,10.0,1350.0,406.0
0.007,6,10,1972,5,910,1.0,642.0,642.0,5,1062,1.0,794.0,794.0
0.005,6,10,2007,5,928,1.0,660.0,660.0,5,1079,1.0,811.0,811.0
0.005,6,10,1989,5,927,1.0,659.0,659.0,5,1062,1.0,794.0,794.0
0.072,6,10,1506,5,395,17.0,127.0,127.0,5,1111,16.0,843.0,843.0
0.061,6,10,1631,5,848,15.0,580.0,580.0,5,783,15.0,515.0,515.0
0.008,6,10,1983,5,910,2.0,642.0,642.0,5,1073,2.0,805.0,805.0
15.075,17,15,9238,8,6902,2149.0,1350.0,834.0,7,2336,2507.0,1350.0,305.0
0.073,6,10,1506,5,395,17.0,127.0,127.0,5,1111,16.0,843.0,843.0
0.005,17,2,170,1,65,0.0,37.0,37.0,1,105,0.0,77.0,77.0
0.004,17,2,412,1,61,0.0,33.0,33.0,1,351,0.0,323.0,323.0
0.005,6,10,1689,5,839,1.0,571.0,571.0,5,850,1.0,582.0,582.0
0.073,6,10,1506,5,395,16.0,127.0,127.0,5,1111,17.0,843.0,843.0
0.004,17,4,596,2,122,0.0,33.0,33.0,2,474,0.0,323.0,209.0
0.094,6,10,1506,5,395,20.0,127.0,127.0,5,1111,17.0,843.0,843.0
0.005,17,2,164,1,74,0.0,46.0,46.0,1,90,0.0,62.0,62.0
0.004,6,10,1989,5,927,1.0,659.0,659.0,5,1062,1.0,794.0,794.0
0.086,6,10,1506,5,395,18.0,127.0,127.0,5,1111,19.0,843.0,843.0
0.006,17,2,144,1,64,0.0,36.0,36.0,1,80,0.0,52.0,52.0
310.052,17,20,1124,10,716,34436.0,48.0,43.0,10,408,34436.0,20.0,12.0
0.005,17,2,170,1,65,0.0,37.0,37.0,1,105,0.0,77.0,77.0
0.013,6,10,1631,5,848,3.0,580.0,580.0,5,783,3.0,515.0,515.0
0.004,6,10,1774,5,923,1.0,655.0,655.0,5,851,1.0,583.0,583.0
0.072,17,4,420,2,122,0.0,33.0,33.0,2,298,68.0,145.0,121.0
0.077,6,10,1506,5,395,16.0,127.0,127.0,5,1111,16.0,843.0,843.0
10.861,17,28,4423,14,1994,826.0,269.0,114.0,14,2429,826.0,588.0,145.0
0.004,6,14,3799,7,509,0.0,137.0,137.0,7,3290,0.0,1448.0,972.0
0.006,6,10,1689,5,839,1.0,571.0,571.0,5,850,1.0,582.0,582.0
0.022,6,10,1983,5,910,5.0,642.0,642.0,5,1073,5.0,805.0,805.0
0.0,17,2,166,1,75,0.0,47.0,47.0,1,91,0.0,63.0,63.0
0.058,6,14,3868,7,578,9.0,206.0,206.0,7,3290,9.0,1448.0,972.0
0.003,17,2,148,1,60,0.0,32.0,32.0,1,88,0.0,60.0,60.0
0.008,6,10,1972,5,910,2.0,642.0,642.0,5,1062,2.0,794.0,794.0
0.001,17,2,179,1,62,0.0,34.0,34.0,1,117,0.0,89.0,89.0
0.004,17,4,420,2,122,1.0,33.0,33.0,2,298,0.0,145.0,121.0
0.028,6,13,3735,7,497,4.0,125.0,125.0,6,3238,5.0,1470.0,1459.0
0.042,17,4,352,2,130,2.0,37.0,37.0,2,222,38.0,89.0,83.0
0.013,6,10,1983,5,910,3.0,642.0,642.0,5,1073,3.0,805.0,805.0
0.009,6,12,1926,6,1189,1.0,659.0,434.0,6,737,1.0,417.0,417.0
0.78,6,10,1816,6,1462,156.0,1210.0,1210.0,4,354,180.0,182.0,182.0
240.093,6,32,9103,16,6775,16006.0,1847.0,660.0,16,2328,16006.0,580.0,186.0
0.105,6,10,1506,5,395,22.0,127.0,127.0,5,1111,18.0,843.0,843.0
10.977,17,28,4394,14,1994,835.0,269.0,114.0,14,2400,835.0,587.0,143.0
1770.469,6,83,4368,42,2210,43181.0,26.0,26.0,41,2158,44260.0,26.0,26.0
0.006,6,12,1698,6,863,1.0,327.0,271.0,6,835,1.0,515.0,515.0
0.011,6,10,1983,5,910,2.0,642.0,642.0,5,1073,2.0,805.0,805.0
0.008,6,12,1926,6,1189,1.0,659.0,434.0,6,737,1.0,417.0,417.0
0.006,6,10,1547,5,764,1.0,496.0,496.0,5,783,1.0,515.0,515.0
240.088,6,16,4481,9,963,30011.0,238.0,166.0,7,3518,40014.0,1402.0,786.0
240.011,6,9,787,5,488,60002.0,232.0,232.0,4,299,80002.0,83.0,83.0
0.009,6,10,1983,5,910,2.0,642.0,642.0,5,1073,2.0,805.0,805.0
0.008,6,10,1989,5,910,2.0,642.0,642.0,5,1079,1.0,811.0,811.0
0.021,6,13,3735,7,497,3.0,125.0,125.0,6,3238,4.0,1470.0,1459.0
0.009,6,10,1983,5,910,2.0,642.0,642.0,5,1073,2.0,805.0,805.0
0.003,17,4,284,2,120,0.0,32.0,32.0,2,164,0.0,60.0,54.0
0.021,6,10,1983,5,910,5.0,642.0,642.0,5,1073,5.0,805.0,805.0
0.004,17,2,136,1,60,0.0,32.0,32.0,1,76,0.0,48.0,48.0
0.005,6,10,2006,5,927,1.0,659.0,659.0,5,1079,1.0,811.0,811.0
154.402,6,24,9399,11,1575,76.0,794.0,367.0,13,7824,12856.0,1360.0,810.0
0.005,6,14,3799,7,509,0.0,137.0,137.0,7,3290,0.0,1448.0,972.0
0.006,6,10,1547,5,764,1.0,496.0,496.0,5,783,1.0,515.0,515.0
0.004,6,10,1702,5,863,1.0,595.0,595.0,5,839,0.0,571.0,571.0
1784.923,6,302,97525,187,86389,9596.0,1402.0,672.0,115,11136,15656.0,452.0,70.0
0.069,6,10,1506,5,395,14.0,127.0,127.0,5,1111,13.0,843.0,843.0
0.005,6,10,1689,5,839,1.0,571.0,571.0,5,850,1.0,582.0,582.0
30.134,6,12,1314,7,546,5022.0,174.0,174.0,5,768,7525.0,473.0,250.0
0.014,6,10,1983,5,910,3.0,642.0,642.0,5,1073,3.0,805.0,805.0
40.061,17,10,676,5,460,10014.0,104.0,64.0,5,216,10010.0,20.0,15.0
0.027,6,10,1983,5,910,6.0,642.0,642.0,5,1073,6.0,805.0,805.0
0.005,6,10,2006,5,927,1.0,659.0,659.0,5,1079,1.0,811.0,811.0
292.742,6,394,347609,196,21756,1501.0,2736.0,888.0,198,325853,1485.0,2804.0,1714.0
0.003,17,2,148,1,60,0.0,32.0,32.0,1,88,0.0,60.0,60.0
40.064,17,10,676,5,460,10015.0,104.0,64.0,5,216,10015.0,20.0,15.0
0.094,6,10,1506,5,395,20.0,127.0,127.0,5,1111,20.0,843.0,843.0
0.014,6,10,1762,5,911,3.0,643.0,643.0,5,851,3.0,583.0,583.0
0.004,6,10,2006,5,927,1.0,659.0,659.0,5,1079,1.0,811.0,811.0
0.009,6,10,1972,5,910,2.0,642.0,642.0,5,1062,2.0,794.0,794.0
0.005,6,14,3736,7,446,0.0,74.0,74.0,7,3290,0.0,1448.0,972.0
0.004,6,10,2006,5,927,1.0,659.0,659.0,5,1079,1.0,811.0,811.0
0.004,17,2,148,1,60,0.0,32.0,32.0,1,88,0.0,60.0,60.0
0.005,17,2,222,1,65,0.0,37.0,37.0,1,157,0.0,129.0,129.0
0.038,17,2,148,1,60,0.0,32.0,32.0,1,88,0.0,60.0,60.0
0.009,6,10,1989,5,910,2.0,642.0,642.0,5,1079,2.0,811.0,811.0
0.002,17,2,185,1,73,0.0,45.0,45.0,1,112,0.0,84.0,84.0
0.082,6,10,1506,5,395,18.0,127.0,127.0,5,1111,17.0,843.0,843.0
0.006,6,10,1854,5,889,1.0,621.0,621.0,5,965,1.0,697.0,697.0
0.004,17,2,170,1,65,0.0,37.0,37.0,1,105,0.0,77.0,77.0
0.008,6,10,1989,5,910,1.0,642.0,642.0,5,1079,1.0,811.0,811.0
0.001,17,2,180,1,66,0.0,38.0,38.0,1,114,0.0,86.0,86.0
0.091,6,10,1506,5,395,19.0,127.0,127.0,5,1111,21.0,843.0,843.0
0.164,17,2,152,1,76,0.0,48.0,48.0,1,76,0.0,48.0,48.0
0.004,6,10,2007,5,928,1.0,660.0,660.0,5,1079,1.0,811.0,811.0
0.005,6,10,2006,5,927,1.0,659.0,659.0,5,1079,1.0,811.0,811.0
0.001,17,2,136,1,60,0.0,32.0,32.0,1,76,0.0,48.0,48.0
0.004,6,10,1702,5,863,1.0,595.0,595.0,5,839,0.0,571.0,571.0
0.005,6,10,1989,5,927,1.0,659.0,659.0,5,1062,1.0,794.0,794.0
0.005,6,10,1547,5,764,1.0,496.0,496.0,5,783,1.0,515.0,515.0
0.011,6,10,1631,5,848,2.0,580.0,580.0,5,783,2.0,515.0,515.0
0.085,6,10,1983,5,910,21.0,642.0,642.0,5,1073,21.0,805.0,805.0
0.072,17,2,234,1,61,0.0,33.0,33.0,1,173,0.0,145.0,145.0
0.015,17,2,198,1,91,0.0,63.0,63.0,1,107,0.0,79.0,79.0
0.218,17,4,352,2,130,176.0,37.0,37.0,2,222,146.0,89.0,83.0
0.079,6,10,1506,5,395,17.0,127.0,127.0,5,1111,16.0,843.0,843.0
0.006,6,10,1547,5,764,1.0,496.0,496.0,5,783,1.0,515.0,515.0
0.004,6,10,2006,5,927,1.0,659.0,659.0,5,1079,1.0,811.0,811.0
0.004,6,10,2007,5,928,1.0,660.0,660.0,5,1079,1.0,811.0,811.0
0.015,6,10,1762,5,911,3.0,643.0,643.0,5,851,3.0,583.0,583.0
0.132,6,10,1506,5,395,30.0,127.0,127.0,5,1111,29.0,843.0,843.0
1.228,6,32,13392,18,5893,72.0,2074.0,854.0,14,7499,80.0,2720.0,769.0
0.083,6,10,1506,5,395,20.0,127.0,127.0,5,1111,19.0,843.0,843.0
0.001,17,2,180,1,66,0.0,38.0,38.0,1,114,0.0,86.0,86.0
0.005,6,14,3736,7,446,0.0,74.0,74.0,7,3290,0.0,1448.0,972.0
0.006,6,10,2006,5,927,1.0,659.0,659.0,5,1079,1.0,811.0,811.0
0.021,6,10,1972,5,910,5.0,642.0,642.0,5,1062,5.0,794.0,794.0
0.01,6,10,1983,5,910,2.0,642.0,642.0,5,1073,2.0,805.0,805.0
0.005,6,10,1854,5,889,1.0,621.0,621.0,5,965,1.0,697.0,697.0
0.001,17,2,180,1,66,0.0,38.0,38.0,1,114,0.0,86.0,86.0
0.005,6,10,2007,5,928,1.0,660.0,660.0,5,1079,1.0,811.0,811.0
0.005,17,2,144,1,64,0.0,36.0,36.0,1,80,0.0,52.0,52.0
0.004,17,2,170,1,65,0.0,37.0,37.0,1,105,0.0,77.0,77.0
0.008,6,10,1972,5,910,1.0,642.0,642.0,5,1062,1.0,794.0,794.0
10.899,17,28,4420,14,1993,829.0,268.0,114.0,14,2427,829.0,586.0,145.0
9.037,17,6,376,5,280,2259.0,28.0,28.0,1,96,0.0,68.0,68.0
0.006,6,10,1547,5,764,1.0,496.0,496.0,5,783,1.0,515.0,515.0
0.818,6,10,2009,6,1655,163.0,1403.0,1403.0,4,354,192.0,182.0,182.0
0.043,17,2,152,1,76,0.0,48.0,48.0,1,76,0.0,48.0,48.0
0.072,17,4,284,2,120,0.0,32.0,32.0,2,164,69.0,60.0,54.0
0.007,17,2,299,1,65,0.0,37.0,37.0,1,234,0.0,206.0,206.0
0.118,6,10,1506,5,395,26.0,127.0,127.0,5,1111,25.0,843.0,843.0
1.035,6,13,3930,7,2139,129.0,1328.0,923.0,6,1791,155.0,1539.0,1539.0
0.012,6,10,1972,5,910,3.0,642.0,642.0,5,1062,3.0,794.0,794.0
0.148,6,10,1506,5,395,33.0,127.0,127.0,5,1111,34.0,843.0,843.0
0.014,6,10,1989,5,910,3.0,642.0,642.0,5,1079,3.0,811.0,811.0
0.006,17,2,169,1,62,0.0,34.0,34.0,1,107,0.0,79.0,79.0
0.038,17,2,170,1,65,0.0,37.0,37.0,1,105,0.0,77.0,77.0
0.052,17,2,152,1,76,0.0,48.0,48.0,1,76,0.0,48.0,48.0
0.015,6,10,1972,5,910,3.0,642.0,642.0,5,1062,3.0,794.0,794.0
0.005,6,13,3747,7,509,0.0,137.0,137.0,6,3238,0.0,1470.0,1459.0
1773.219,6,64,7344,42,4469,43249.0,1625.0,108.0,22,2875,84430.0,1111.0,82.0
0.008,17,2,136,1,60,0.0,32.0,32.0,1,76,0.0,48.0,48.0
0.083,6,10,1506,5,395,19.0,127.0,127.0,5,1111,17.0,843.0,843.0
0.006,6,10,1547,5,764,1.0,496.0,496.0,5,783,1.0,515.0,515.0
0.004,6,10,1989,5,927,1.0,659.0,659.0,5,1062,1.0,794.0,794.0
0.038,17,2,152,1,76,0.0,48.0,48.0,1,76,0.0,48.0,48.0
0.004,6,10,1702,5,863,1.0,595.0,595.0,5,839,0.0,571.0,571.0
0.011,6,10,1631,5,848,2.0,580.0,580.0,5,783,2.0,515.0,515.0
0.008,6,10,1972,5,910,1.0,642.0,642.0,5,1062,2.0,794.0,794.0
0.011,6,10,1762,5,911,2.0,643.0,643.0,5,851,2.0,583.0,583.0
0.004,17,4,284,2,120,0.0,32.0,32.0,2,164,0.0,60.0,54.0
10.918,17,28,4422,14,1994,831.0,269.0,114.0,14,2428,831.0,587.0,145.0
0.122,17,2,80,1,32,0.0,4.0,4.0,1,48,0.0,20.0,20.0
300.299,6,16,2170,9,684,37517.0,146.0,146.0,7,1486,50022.0,419.0,398.0
0.071,6,10,1506,5,395,17.0,127.0,127.0,5,1111,16.0,843.0,843.0
9.028,6,36,9771,19,4293,501.0,1360.0,700.0,17,5478,550.0,2667.0,435.0
170.222,17,76,10788,38,2537,4600.0,44.0,38.0,38,8251,4600.0,261.0,189.0
0.015,6,10,1990,5,911,3.0,643.0,643.0,5,1079,3.0,811.0,811.0
0.007,6,10,1689,5,839,1.0,571.0,571.0,5,850,1.0,582.0,582.0
0.005,6,13,3690,7,452,0.0,80.0,80.0,6,3238,0.0,1470.0,1459.0
0.004,17,2,136,1,60,0.0,32.0,32.0,1,76,0.0,48.0,48.0
0.001,17,2,180,1,66,0.0,38.0,38.0,1,114,0.0,86.0,86.0
0.004,6,10,1989,5,927,1.0,659.0,659.0,5,1062,1.0,794.0,794.0
0.039,17,2,152,1,76,0.0,48.0,48.0,1,76,0.0,48.0,48.0
0.005,17,2,214,1,75,0.0,47.0,47.0,1,139,0.0,111.0,111.0
240.261,6,42,8721,21,5686,12012.0,1515.0,509.0,21,3035,12012.0,580.0,241.0
0.001,17,2,180,1,66,0.0,38.0,38.0,1,114,0.0,86.0,86.0
0.017,6,10,1989,5,910,4.0,642.0,642.0,5,1079,4.0,811.0,811.0
0.076,6,10,1506,5,395,18.0,127.0,127.0,5,1111,15.0,843.0,843.0
0.012,6,10,1983,5,910,3.0,642.0,642.0,5,1073,3.0,805.0,805.0
0.01,6,10,1989,5,910,2.0,642.0,642.0,5,1079,2.0,811.0,811.0
0.006,6,10,1854,5,889,1.0,621.0,621.0,5,965,1.0,697.0,697.0
0.009,6,10,1989,5,910,2.0,642.0,642.0,5,1079,2.0,811.0,811.0
0.007,6,10,1983,5,910,1.0,642.0,642.0,5,1073,1.0,805.0,805.0
0.004,6,10,2006,5,927,1.0,659.0,659.0,5,1079,1.0,811.0,811.0
0.008,6,10,1972,5,910,1.0,642.0,642.0,5,1062,1.0,794.0,794.0
0.004,6,10,2000,5,927,1.0,659.0,659.0,5,1073,1.0,805.0,805.0
0.068,6,10,1506,5,395,15.0,127.0,127.0,5,1111,15.0,843.0,843.0
0.004,17,2,148,1,60,0.0,32.0,32.0,1,88,0.0,60.0,60.0
9.036,17,6,376,5,280,2259.0,28.0,28.0,1,96,0.0,68.0,68.0
40.086,17,10,676,5,460,10015.0,104.0,64.0,5,216,10020.0,20.0,15.0
0.051,6,10,1506,5,395,12.0,127.0,127.0,5,1111,11.0,843.0,843.0
0.003,17,2,234,1,61,0.0,33.0,33.0,1,173,0.0,145.0,145.0
0.013,17,2,152,1,56,0.0,28.0,28.0,1,96,0.0,68.0,68.0
240.086,6,16,4481,9,963,30010.0,238.0,166.0,7,3518,40013.0,1402.0,786.0
0.005,17,2,148,1,60,0.0,32.0,32.0,1,88,0.0,60.0,60.0
0.015,6,13,3735,7,497,2.0,125.0,125.0,6,3238,2.0,1470.0,1459.0
0.005,6,10,1774,5,923,1.0,655.0,655.0,5,851,1.0,583.0,583.0
0.004,6,10,1702,5,863,0.0,595.0,595.0,5,839,1.0,571.0,571.0
240.119,6,31,9290,15,7020,17151.0,2145.0,693.0,16,2270,16007.0,580.0,178.0
0.006,6,13,3747,7,509,0.0,137.0,137.0,6,3238,1.0,1470.0,1459.0
0.151,6,10,1506,5,395,35.0,127.0,127.0,5,1111,34.0,843.0,843.0
0.008,17,2,132,1,58,0.0,30.0,30.0,1,74,0.0,46.0,46.0
40.07,17,10,676,5,460,10016.0,104.0,64.0,5,216,10016.0,20.0,15.0
0.021,6,10,1990,5,911,5.0,643.0,643.0,5,1079,5.0,811.0,811.0
0.006,6,10,1643,5,860,1.0,592.0,592.0,5,783,1.0,515.0,515.0
0.006,17,2,164,1,74,0.0,46.0,46.0,1,90,0.0,62.0,62.0
0.001,17,2,180,1,66,0.0,38.0,38.0,1,114,0.0,86.0,86.0
0.003,17,2,148,1,60,0.0,32.0,32.0,1,88,0.0,60.0,60.0
40.064,17,10,676,5,460,10015.0,104.0,64.0,5,216,10015.0,20.0,15.0
0.019,6,10,1677,5,827,4.0,559.0,559.0,5,850,4.0,582.0,582.0
40.061,17,10,676,5,460,10014.0,104.0,64.0,5,216,10014.0,20.0,15.0
0.049,17,2,148,1,60,0.0,32.0,32.0,1,88,0.0,60.0,60.0
0.005,6,10,2006,5,927,1.0,659.0,659.0,5,1079,1.0,811.0,811.0
0.016,6,10,1990,5,911,4.0,643.0,643.0,5,1079,4.0,811.0,811.0
0.079,6,10,1506,5,395,18.0,127.0,127.0,5,1111,18.0,843.0,843.0
0.001,17,2,180,1,65,0.0,37.0,37.0,1,115,0.0,87.0,87.0
0.011,6,10,1990,5,911,2.0,643.0,643.0,5,1079,2.0,811.0,811.0
0.001,17,2,136,1,60,0.0,32.0,32.0,1,76,0.0,48.0,48.0
0.005,6,10,2006,5,927,1.0,659.0,659.0,5,1079,1.0,811.0,811.0
0.039,17,2,148,1,60,0.0,32.0,32.0,1,88,0.0,60.0,60.0
0.094,6,10,1506,5,395,19.0,127.0,127.0,5,1111,22.0,843.0,843.0
368.692,6,24,2405,17,919,23043.0,195.0,195.0,7,1486,3905.0,419.0,398.0
9.036,17,6,376,5,280,2259.0,28.0,28.0,1,96,0.0,68.0,68.0
0.093,6,10,1506,5,395,19.0,127.0,127.0,5,1111,21.0,843.0,843.0
0.005,6,10,2006,5,927,1.0,659.0,659.0,5,1079,1.0,811.0,811.0
0.011,6,10,1972,5,910,2.0,642.0,642.0,5,1062,2.0,794.0,794.0
0.001,17,2,180,1,65,0.0,37.0,37.0,1,115,0.0,87.0,87.0
0.086,6,10,1506,5,395,19.0,127.0,127.0,5,1111,19.0,843.0,843.0
0.006,6,10,1547,5,764,1.0,496.0,496.0,5,783,1.0,515.0,515.0
0.01,6,10,1972,5,910,2.0,642.0,642.0,5,1062,2.0,794.0,794.0
0.02,6,10,1677,5,827,5.0,559.0,559.0,5,850,4.0,582.0,582.0
0.018,6,10,1972,5,910,4.0,642.0,642.0,5,1062,4.0,794.0,794.0
0.005,6,10,1774,5,923,1.0,655.0,655.0,5,851,1.0,583.0,583.0
0.125,6,10,1506,5,395,25.0,127.0,127.0,5,1111,27.0,843.0,843.0
0.006,6,10,1689,5,839,1.0,571.0,571.0,5,850,1.0,582.0,582.0
0.023,6,10,1990,5,911,5.0,643.0,643.0,5,1079,5.0,811.0,811.0
0.005,6,10,1779,5,928,1.0,660.0,660.0,5,851,1.0,583.0,583.0
0.006,17,2,170,1,65,0.0,37.0,37.0,1,105,0.0,77.0,77.0
0.124,17,2,80,1,32,0.0,4.0,4.0,1,48,0.0,20.0,20.0
0.094,6,10,1506,5,395,18.0,127.0,127.0,5,1111,21.0,843.0,843.0
240.256,6,33,9413,16,1763,16016.0,539.0,184.0,17,7650,15015.0,1402.0,615.0
15.077,17,15,9239,8,6902,2149.0,1350.0,834.0,7,2337,2507.0,1350.0,305.0
0.005,6,10,2006,5,927,1.0,659.0,659.0,5,1079,1.0,811.0,811.0
15.077,17,15,9238,8,6902,2149.0,1350.0,834.0,7,2336,2507.0,1350.0,305.0
0.053,17,2,152,1,76,0.0,48.0,48.0,1,76,0.0,48.0,48.0
40.053,17,10,676,5,460,10010.0,104.0,64.0,5,216,10012.0,20.0,15.0
0.004,6,10,1989,5,927,1.0,659.0,659.0,5,1062,1.0,794.0,794.0
0.004,6,10,2006,5,927,1.0,659.0,659.0,5,1079,1.0,811.0,811.0
0.009,6,10,1972,5,910,2.0,642.0,642.0,5,1062,2.0,794.0,794.0
40.068,17,10,676,5,460,10014.0,104.0,64.0,5,216,10016.0,20.0,15.0
0.014,6,10,1990,5,911,3.0,643.0,643.0,5,1079,3.0,811.0,811.0
0.005,17,2,144,1,64,0.0,36.0,36.0,1,80,0.0,52.0,52.0
0.14,6,10,1506,5,395,31.0,127.0,127.0,5,1111,33.0,843.0,843.0
0.005,17,2,213,1,69,0.0,41.0,41.0,1,144,0.0,116.0,116.0
0.004,6,10,2006,5,927,1.0,659.0,659.0,5,1079,1.0,811.0,811.0
0.064,6,10,1506,5,395,14.0,127.0,127.0,5,1111,15.0,843.0,843.0
0.005,6,10,2006,5,927,1.0,659.0,659.0,5,1079,1.0,811.0,811.0
366.905,6,22,2313,16,867,24460.0,195.0,195.0,6,1446,4649.0,419.0,398.0
0.013,17,2,152,1,56,0.0,28.0,28.0,1,96,0.0,68.0,68.0
10.836,17,28,4420,14,1993,825.0,268.0,114.0,14,2427,825.0,586.0,145.0
0.003,17,2,148,1,60,0.0,32.0,32.0,1,88,0.0,60.0,60.0
0.042,17,2,152,1,76,0.0,48.0,48.0,1,76,0.0,48.0,48.0
0.121,6,10,1506,5,395,28.0,127.0,127.0,5,1111,24.0,843.0,843.0
0.013,6,14,3868,7,578,2.0,206.0,206.0,7,3290,2.0,1448.0,972.0
0.125,6,28,8433,14,1845,8.0,490.0,219.0,14,6588,8.0,1397.0,836.0
0.005,17,2,146,1,65,0.0,37.0,37.0,1,81,0.0,53.0,53.0
0.005,6,10,2006,5,927,1.0,659.0,659.0,5,1079,1.0,811.0,811.0
0.07,6,10,1506,5,395,17.0,127.0,127.0,5,1111,16.0,843.0,843.0
10.808,17,28,4422,14,1994,823.0,269.0,114.0,14,2428,822.0,587.0,145.0
0.039,17,2,136,1,60,0.0,32.0,32.0,1,76,0.0,48.0,48.0
0.067,17,8,3613,4,1874,22.0,1350.0,440.0,4,1739,11.0,1350.0,406.0
40.06,17,10,676,5,460,10013.0,104.0,64.0,5,216,10014.0,20.0,15.0
0.004,6,10,2000,5,927,1.0,659.0,659.0,5,1073,1.0,805.0,805.0
240.086,6,16,4481,9,963,30010.0,238.0,166.0,7,3518,40013.0,1402.0,786.0
0.005,17,2,180,1,58,0.0,30.0,30.0,1,122,0.0,94.0,94.0
174.657,17,74,10644,37,2468,4850.0,44.0,38.0,37,8176,4851.0,260.0,192.0
0.021,6,10,1762,5,911,5.0,643.0,643.0,5,851,5.0,583.0,583.0
0.017,6,10,1983,5,910,4.0,642.0,642.0,5,1073,4.0,805.0,805.0
0.006,6,10,1547,5,764,1.0,496.0,496.0,5,783,1.0,515.0,515.0
0.015,6,10,1989,5,910,3.0,642.0,642.0,5,1079,3.0,811.0,811.0
1771.317,6,83,4368,42,2210,43201.0,26.0,26.0,41,2158,44281.0,26.0,26.0
0.011,6,10,1989,5,910,2.0,642.0,642.0,5,1079,2.0,811.0,811.0
0.01,6,13,3735,7,497,1.0,125.0,125.0,6,3238,2.0,1470.0,1459.0
0.006,6,10,1547,5,764,1.0,496.0,496.0,5,783,1.0,515.0,515.0
0.005,6,10,2006,5,927,1.0,659.0,659.0,5,1079,1.0,811.0,811.0
0.006,17,2,230,1,68,0.0,40.0,40.0,1,162,0.0,134.0,134.0
0.038,17,2,152,1,76,0.0,48.0,48.0,1,76,0.0,48.0,48.0
331.837,17,20,1124,10,716,36856.0,48.0,43.0,10,408,36856.0,20.0,12.0
0.095,6,10,1506,5,395,20.0,127.0,127.0,5,1111,19.0,843.0,843.0
0.01,6,10,1989,5,910,2.0,642.0,642.0,5,1079,2.0,811.0,811.0
310.992,17,20,1124,10,716,34542.0,48.0,43.0,10,408,34544.0,20.0,12.0
0.001,17,2,180,1,66,0.0,38.0,38.0,1,114,0.0,86.0,86.0
0.01,6,10,1989,5,910,2.0,642.0,642.0,5,1079,2.0,811.0,811.0
0.009,6,10,1989,5,910,2.0,642.0,642.0,5,1079,2.0,811.0,811.0
0.012,6,10,1990,5,911,3.0,643.0,643.0,5,1079,3.0,811.0,811.0
10.931,17,28,4423,14,1994,832.0,269.0,114.0,14,2429,832.0,588.0,145.0
0.014,6,10,1972,5,910,3.0,642.0,642.0,5,1062,3.0,794.0,794.0
9.038,17,6,376,5,280,2259.0,28.0,28.0,1,96,0.0,68.0,68.0
0.007,6,10,1547,5,764,1.0,496.0,496.0,5,783,1.0,515.0,515.0
0.015,6,10,1989,5,910,3.0,642.0,642.0,5,1079,3.0,811.0,811.0
0.006,6,10,1547,5,764,1.0,496.0,496.0,5,783,1.0,515.0,515.0
0.004,6,10,1989,5,927,1.0,659.0,659.0,5,1062,1.0,794.0,794.0
0.005,6,10,1547,5,764,1.0,496.0,496.0,5,783,1.0,515.0,515.0
0.037,17,2,152,1,76,0.0,48.0,48.0,1,76,0.0,48.0,48.0
0.002,17,2,136,1,60,0.0,32.0,32.0,1,76,0.0,48.0,48.0
40.061,17,10,676,5,460,10012.0,104.0,64.0,5,216,10014.0,20.0,15.0
0.125,6,10,1506,5,395,28.0,127.0,127.0,5,1111,27.0,843.0,843.0
0.006,6,10,2000,5,927,1.0,659.0,659.0,5,1073,1.0,805.0,805.0
0.124,17,4,284,2,120,0.0,32.0,32.0,2,164,85.0,60.0,54.0
0.004,6,10,2006,5,927,1.0,659.0,659.0,5,1079,1.0,811.0,811.0
40.066,17,10,676,5,460,10015.0,104.0,64.0,5,216,10015.0,20.0,15.0
40.062,17,10,676,5,460,10013.0,104.0,64.0,5,216,10014.0,20.0,15.0
0.12,6,10,1506,5,395,26.0,127.0,127.0,5,1111,28.0,843.0,843.0
240.083,6,16,4481,9,963,30010.0,238.0,166.0,7,3518,40013.0,1402.0,786.0
0.009,6,10,1989,5,910,2.0,642.0,642.0,5,1079,2.0,811.0,811.0
0.006,6,10,1547,5,764,1.0,496.0,496.0,5,783,1.0,515.0,515.0
40.055,17,10,676,5,460,10012.0,104.0,64.0,5,216,10013.0,20.0,15.0
0.004,6,10,2006,5,927,1.0,659.0,659.0,5,1079,1.0,811.0,811.0
240.745,6,35,8926,18,2074,14159.0,695.0,226.0,17,6852,15044.0,1402.0,597.0
0.008,17,2,212,1,74,0.0,46.0,46.0,1,138,0.0,110.0,110.0
0.012,6,10,1972,5,910,3.0,642.0,642.0,5,1062,3.0,794.0,794.0
0.136,6,10,1506,5,395,30.0,127.0,127.0,5,1111,21.0,843.0,843.0
0.063,6,10,1506,5,395,14.0,127.0,127.0,5,1111,14.0,843.0,843.0
0.006,6,10,1547,5,764,1.0,496.0,496.0,5,783,1.0,515.0,515.0
0.005,6,10,1989,5,927,1.0,659.0,659.0,5,1062,1.0,794.0,794.0
0.001,17,2,180,1,66,0.0,38.0,38.0,1,114,0.0,86.0,86.0
0.005,6,10,1989,5,927,1.0,659.0,659.0,5,1062,1.0,794.0,794.0
0.06,6,10,1506,5,395,14.0,127.0,127.0,5,1111,13.0,843.0,843.0
0.039,17,4,284,2,120,1.0,32.0,32.0,2,164,36.0,60.0,54.0
240.092,6,16,4481,9,963,30011.0,238.0,166.0,7,3518,40014.0,1402.0,786.0
40.099,17,10,676,5,460,10024.0,104.0,64.0,5,216,10024.0,20.0,15.0
0.014,6,10,1990,5,911,3.0,643.0,643.0,5,1079,3.0,811.0,811.0
0.005,17,2,164,1,74,0.0,46.0,46.0,1,90,0.0,62.0,62.0
0.003,17,2,136,1,60,0.0,32.0,32.0,1,76,0.0,48.0,48.0
11.503,17,28,4393,14,2311,872.0,586.0,137.0,14,2082,872.0,269.0,120.0
0.005,6,10,2006,5,927,1.0,659.0,659.0,5,1079,1.0,811.0,811.0
0.005,6,10,2000,5,927,1.0,659.0,659.0,5,1073,1.0,805.0,805.0
0.006,6,10,1689,5,839,1.0,571.0,571.0,5,850,1.0,582.0,582.0
1729.233,6,60,4400,40,2740,44339.0,33.0,33.0,20,1660,91003.0,31.0,31.0
0.005,17,2,170,1,65,0.0,37.0,37.0,1,105,0.0,77.0,77.0
0.015,17,2,180,1,66,0.0,38.0,38.0,1,114,0.0,86.0,86.0
0.179,17,2,194,1,59,0.0,31.0,31.0,1,135,0.0,107.0,107.0
0.016,6,10,1631,5,848,4.0,580.0,580.0,5,783,4.0,515.0,515.0
0.009,6,10,1972,5,910,2.0,642.0,642.0,5,1062,2.0,794.0,794.0
0.062,6,10,1506,5,395,14.0,127.0,127.0,5,1111,14.0,843.0,843.0
0.005,17,2,170,1,65,0.0,37.0,37.0,1,105,0.0,77.0,77.0
0.012,6,10,1972,5,910,3.0,642.0,642.0,5,1062,2.0,794.0,794.0
0.26,17,44,27961,26,24783,10.0,1350.0,925.0,18,3178,12.0,1350.0,148.0
0.017,6,10,1989,5,910,4.0,642.0,642.0,5,1079,4.0,811.0,811.0
0.005,6,10,1989,5,927,1.0,659.0,659.0,5,1062,1.0,794.0,794.0
0.012,6,10,1990,5,911,2.0,643.0,643.0,5,1079,3.0,811.0,811.0
0.004,6,10,1989,5,927,1.0,659.0,659.0,5,1062,1.0,794.0,794.0
0.005,6,10,2007,5,928,1.0,660.0,660.0,5,1079,1.0,811.0,811.0
0.006,6,10,1547,5,764,1.0,496.0,496.0,5,783,1.0,515.0,515.0
0.129,6,10,1506,5,395,27.0,127.0,127.0,5,1111,26.0,843.0,843.0
0.126,17,4,284,2,120,0.0,32.0,32.0,2,164,123.0,60.0,54.0
0.006,6,10,1547,5,764,1.0,496.0,496.0,5,783,1.0,515.0,515.0
0.005,6,13,3747,7,509,0.0,137.0,137.0,6,3238,0.0,1470.0,1459.0
0.092,6,10,1506,5,395,21.0,127.0,127.0,5,1111,20.0,843.0,843.0
0.004,6,10,1989,5,927,1.0,659.0,659.0,5,1062,1.0,794.0,794.0
0.006,17,2,140,1,62,0.0,34.0,34.0,1,78,0.0,50.0,50.0
0.005,6,10,2006,5,927,1.0,659.0,659.0,5,1079,1.0,811.0,811.0
0.005,6,10,2006,5,927,1.0,659.0,659.0,5,1079,1.0,811.0,811.0
1770.624,17,120,11460,60,5460,30010.0,63.0,63.0,60,6000,30010.0,72.0,72.0
0.004,6,10,2006,5,927,1.0,659.0,659.0,5,1079,1.0,811.0,811.0
40.068,17,10,676,5,460,10014.0,104.0,64.0,5,216,10016.0,20.0,15.0
0.018,17,2,198,1,91,0.0,63.0,63.0,1,107,0.0,79.0,79.0
0.006,17,2,164,1,74,0.0,46.0,46.0,1,90,0.0,62.0,62.0
0.046,17,2,182,1,65,0.0,37.0,37.0,1,117,0.0,89.0,89.0
0.009,6,10,1983,5,910,2.0,642.0,642.0,5,1073,2.0,805.0,805.0
0.013,6,13,3735,7,497,2.0,125.0,125.0,6,3238,2.0,1470.0,1459.0
0.561,6,27,8977,15,1639,32.0,517.0,211.0,12,7338,41.0,1288.0,839.0
0.005,6,10,2007,5,928,1.0,660.0,660.0,5,1079,1.0,811.0,811.0
127.336,6,21,8146,11,1985,84.0,1174.0,504.0,10,6161,14129.0,2720.0,958.0
0.004,6,10,1779,5,928,1.0,660.0,660.0,5,851,1.0,583.0,583.0
0.079,6,10,1506,5,395,17.0,127.0,127.0,5,1111,17.0,843.0,843.0
0.01,6,10,1989,5,910,2.0,642.0,642.0,5,1079,2.0,811.0,811.0
0.107,6,10,1506,5,395,20.0,127.0,127.0,5,1111,24.0,843.0,843.0
0.042,17,4,352,2,130,0.0,37.0,37.0,2,222,2.0,89.0,83.0
0.079,6,10,1506,5,395,15.0,127.0,127.0,5,1111,16.0,843.0,843.0
0.098,6,10,1506,5,395,22.0,127.0,127.0,5,1111,23.0,843.0,843.0
0.019,6,10,1762,5,911,4.0,643.0,643.0,5,851,4.0,583.0,583.0
0.005,6,10,2000,5,927,1.0,659.0,659.0,5,1073,1.0,805.0,805.0
0.043,17,2,152,1,76,0.0,48.0,48.0,1,76,0.0,48.0,48.0
0.111,6,10,1506,5,395,25.0,127.0,127.0,5,1111,24.0,843.0,843.0
178.76,17,78,11057,39,2602,4703.0,44.0,38.0,39,8455,4704.0,261.0,188.0
0.004,6,10,1702,5,863,1.0,595.0,595.0,5,839,0.0,571.0,571.0
0.039,17,2,136,1,60,0.0,32.0,32.0,1,76,0.0,48.0,48.0
0.132,6,10,1506,5,395,30.0,127.0,127.0,5,1111,28.0,843.0,843.0
240.02,6,9,787,5,488,60005.0,232.0,232.0,4,299,80005.0,83.0,83.0
0.007,17,2,179,1,71,0.0,43.0,43.0,1,108,0.0,80.0,80.0
356.626,6,21,1795,16,1030,23775.0,190.0,190.0,5,765,60002.0,464.0,248.0
0.07,6,45,14026,25,2555,2.0,517.0,139.0,20,11471,3.0,1402.0,744.0
0.004,17,2,136,1,60,0.0,32.0,32.0,1,76,0.0,48.0,48.0
0.005,6,10,1702,5,863,1.0,595.0,595.0,5,839,1.0,571.0,571.0
0.037,17,2,136,1,60,0.0,32.0,32.0,1,76,0.0,48.0,48.0
10.738,17,28,4422,14,1994,817.0,269.0,114.0,14,2428,817.0,587.0,145.0
298.253,17,114,16255,57,3803,5325.0,44.0,38.0,57,12452,5325.0,239.0,190.0
0.013,6,10,1983,5,910,3.0,642.0,642.0,5,1073,3.0,805.0,805.0
0.006,6,10,1689,5,839,1.0,571.0,571.0,5,850,1.0,582.0,582.0
0.003,17,2,148,1,60,0.0,32.0,32.0,1,88,0.0,60.0,60.0
0.009,6,10,1990,5,911,2.0,643.0,643.0,5,1079,2.0,811.0,811.0
0.004,6,10,2007,5,928,1.0,660.0,660.0,5,1079,1.0,811.0,811.0
0.004,6,10,2007,5,928,1.0,660.0,660.0,5,1079,1.0,811.0,811.0
240.016,6,9,787,5,488,60004.0,232.0,232.0,4,299,80004.0,83.0,83.0
0.007,17,2,179,1,71,0.0,43.0,43.0,1,108,0.0,80.0,80.0
0.013,6,10,1972,5,910,3.0,642.0,642.0,5,1062,3.0,794.0,794.0
0.006,6,10,1547,5,764,1.0,496.0,496.0,5,783,1.0,515.0,515.0
0.005,17,2,168,1,76,0.0,48.0,48.0,1,92,0.0,64.0,64.0
9.039,17,6,376,5,280,2259.0,28.0,28.0,1,96,0.0,68.0,68.0
0.005,6,10,1547,5,764,1.0,496.0,496.0,5,783,1.0,515.0,515.0
0.005,6,10,1689,5,839,1.0,571.0,571.0,5,850,1.0,582.0,582.0
0.015,6,10,1989,5,910,3.0,642.0,642.0,5,1079,3.0,811.0,811.0
40.072,17,10,676,5,460,10017.0,104.0,64.0,5,216,10016.0,20.0,15.0
0.009,6,10,1762,5,911,2.0,643.0,643.0,5,851,2.0,583.0,583.0
0.006,6,10,2006,5,927,1.0,659.0,659.0,5,1079,1.0,811.0,811.0
0.039,17,2,182,1,65,0.0,37.0,37.0,1,117,0.0,89.0,89.0
10.779,17,28,4423,14,1995,821.0,270.0,114.0,14,2428,820.0,587.0,145.0
0.079,17,8,3613,4,1874,24.0,1350.0,440.0,4,1739,16.0,1350.0,406.0
175.084,17,70,9988,35,2338,5149.0,44.0,38.0,35,7650,5149.0,261.0,190.0
0.014,6,10,1762,5,911,3.0,643.0,643.0,5,851,3.0,583.0,583.0
10.855,17,28,4420,14,1995,826.0,270.0,114.0,14,2425,826.0,588.0,145.0
0.008,6,10,2000,5,927,2.0,659.0,659.0,5,1073,2.0,805.0,805.0
0.014,6,10,1677,5,827,3.0,559.0,559.0,5,850,3.0,582.0,582.0
0.172,6,10,1506,5,395,42.0,127.0,127.0,5,1111,39.0,843.0,843.0
0.106,6,10,1506,5,395,25.0,127.0,127.0,5,1111,25.0,843.0,843.0
0.007,6,10,1989,5,910,1.0,642.0,642.0,5,1079,1.0,811.0,811.0
0.014,6,13,3816,7,578,2.0,206.0,206.0,6,3238,2.0,1470.0,1459.0
0.048,17,2,412,1,61,0.0,33.0,33.0,1,351,0.0,323.0,323.0
0.012,6,10,1990,5,911,2.0,643.0,643.0,5,1079,3.0,811.0,811.0
0.014,6,10,1972,5,910,3.0,642.0,642.0,5,1062,3.0,794.0,794.0
40.046,17,10,676,5,460,10010.0,104.0,64.0,5,216,10010.0,20.0,15.0
0.014,6,10,1983,5,910,3.0,642.0,642.0,5,1073,3.0,805.0,805.0
0.012,6,10,1983,5,910,3.0,642.0,642.0,5,1073,2.0,805.0,805.0
0.015,6,10,1989,5,910,3.0,642.0,642.0,5,1079,3.0,811.0,811.0
0.006,6,10,1547,5,764,1.0,496.0,496.0,5,783,1.0,515.0,515.0
0.004,17,2,148,1,60,0.0,32.0,32.0,1,88,0.0,60.0,60.0
0.006,17,2,144,1,64,0.0,36.0,36.0,1,80,0.0,52.0,52.0
0.005,17,2,225,1,65,0.0,37.0,37.0,1,160,0.0,132.0,132.0
0.005,17,2,154,1,69,0.0,41.0,41.0,1,85,0.0,57.0,57.0
0.215,6,16,2777,8,1395,30.0,533.0,323.0,8,1382,19.0,529.0,239.0
241.156,6,304,342968,117,17586,2078.0,2736.0,885.0,187,325382,1296.0,2804.0,1783.0
0.005,6,10,1643,5,860,1.0,592.0,592.0,5,783,1.0,515.0,515.0
0.191,17,2,152,1,76,0.0,48.0,48.0,1,76,0.0,48.0,48.0
65.853,6,22,10152,12,3985,5986.0,1591.0,838.0,10,6167,7298.0,2111.0,939.0
0.001,17,2,154,1,69,0.0,41.0,41.0,1,85,0.0,57.0,57.0
0.005,6,10,2007,5,928,1.0,660.0,660.0,5,1079,1.0,811.0,811.0
0.006,17,2,179,1,71,0.0,43.0,43.0,1,108,0.0,80.0,80.0
0.092,6,10,1506,5,395,17.0,127.0,127.0,5,1111,21.0,843.0,843.0
0.005,17,2,166,1,75,0.0,47.0,47.0,1,91,0.0,63.0,63.0
0.005,6,10,1989,5,927,1.0,659.0,659.0,5,1062,1.0,794.0,794.0
0.097,6,10,1506,5,395,23.0,127.0,127.0,5,1111,22.0,843.0,843.0
40.067,17,10,676,5,460,10014.0,104.0,64.0,5,216,10015.0,20.0,15.0
0.005,6,10,2007,5,928,1.0,660.0,660.0,5,1079,1.0,811.0,811.0
0.008,6,10,1983,5,910,2.0,642.0,642.0,5,1073,2.0,805.0,805.0
177.218,17,100,14912,50,3373,3616.0,44.0,39.0,50,11539,3616.0,261.0,202.0
40.058,17,10,676,5,460,10013.0,104.0,64.0,5,216,10013.0,20.0,15.0
1.0,6,13,3930,7,2139,125.0,1328.0,923.0,6,1791,150.0,1539.0,1539.0
0.114,6,10,1506,5,395,26.0,127.0,127.0,5,1111,26.0,843.0,843.0
40.06,17,10,676,5,460,10014.0,104.0,64.0,5,216,10014.0,20.0,15.0
0.008,6,10,1990,5,911,2.0,643.0,643.0,5,1079,2.0,811.0,811.0
0.006,6,13,3747,7,509,0.0,137.0,137.0,6,3238,1.0,1470.0,1459.0
0.215,6,16,2777,8,1395,30.0,533.0,323.0,8,1382,19.0,529.0,239.0
0.007,17,2,170,1,65,0.0,37.0,37.0,1,105,0.0,77.0,77.0
0.004,17,2,136,1,60,0.0,32.0,32.0,1,76,0.0,48.0,48.0
0.081,6,10,1506,5,395,17.0,127.0,127.0,5,1111,19.0,843.0,843.0
10.742,17,28,4422,14,1994,817.0,269.0,114.0,14,2428,817.0,587.0,145.0
0.121,6,10,1506,5,395,28.0,127.0,127.0,5,1111,28.0,843.0,843.0
40.082,17,10,676,5,460,10017.0,104.0,64.0,5,216,10019.0,20.0,15.0
0.404,6,22,7136,11,1609,40.0,746.0,257.0,11,5527,40.0,2334.0,989.0
0.01,6,10,1983,5,910,2.0,642.0,642.0,5,1073,2.0,805.0,805.0
0.007,6,10,1989,5,910,1.0,642.0,642.0,5,1079,1.0,811.0,811.0
0.018,6,10,1972,5,910,4.0,642.0,642.0,5,1062,4.0,794.0,794.0
0.006,6,10,1547,5,764,1.0,496.0,496.0,5,783,1.0,515.0,515.0
0.009,6,12,1926,6,1189,1.0,659.0,434.0,6,737,1.0,417.0,417.0
0.004,6,10,1702,5,863,1.0,595.0,595.0,5,839,0.0,571.0,571.0
0.006,6,10,1689,5,839,1.0,571.0,571.0,5,850,1.0,582.0,582.0
0.004,6,10,1702,5,863,1.0,595.0,595.0,5,839,0.0,571.0,571.0
0.036,17,2,136,1,60,0.0,32.0,32.0,1,76,0.0,48.0,48.0
40.054,17,10,676,5,460,10012.0,104.0,64.0,5,216,10003.0,20.0,15.0
0.083,6,10,1506,5,395,18.0,127.0,127.0,5,1111,18.0,843.0,843.0
0.097,6,10,1506,5,395,20.0,127.0,127.0,5,1111,23.0,843.0,843.0
0.001,17,2,180,1,66,0.0,38.0,38.0,1,114,0.0,86.0,86.0
0.005,17,2,170,1,65,0.0,37.0,37.0,1,105,0.0,77.0,77.0
0.012,6,12,1926,6,1189,2.0,659.0,434.0,6,737,2.0,417.0,417.0
0.104,6,10,1506,5,395,23.0,127.0,127.0,5,1111,22.0,843.0,843.0
0.018,17,2,180,1,66,0.0,38.0,38.0,1,114,0.0,86.0,86.0
0.009,6,10,1983,5,910,2.0,642.0,642.0,5,1073,2.0,805.0,805.0
0.013,6,10,1989,5,910,3.0,642.0,642.0,5,1079,3.0,811.0,811.0
0.089,6,10,1506,5,395,20.0,127.0,127.0,5,1111,21.0,843.0,843.0
0.041,17,4,352,2,130,1.0,37.0,37.0,2,222,2.0,89.0,83.0
0.004,6,10,2007,5,928,1.0,660.0,660.0,5,1079,1.0,811.0,811.0
308.607,17,20,1124,10,716,34276.0,48.0,43.0,10,408,34277.0,20.0,12.0
0.009,6,10,1990,5,911,2.0,643.0,643.0,5,1079,2.0,811.0,811.0
0.004,6,10,2000,5,927,1.0,659.0,659.0,5,1073,1.0,805.0,805.0
0.01,6,10,1631,5,848,2.0,580.0,580.0,5,783,2.0,515.0,515.0
293.619,6,409,349495,193,21605,1529.0,2736.0,889.0,216,327890,1365.0,2804.0,1575.0
0.129,6,10,1506,5,395,24.0,127.0,127.0,5,1111,28.0,843.0,843.0
0.118,6,10,1506,5,395,26.0,127.0,127.0,5,1111,26.0,843.0,843.0
0.004,17,2,136,1,60,0.0,32.0,32.0,1,76,0.0,48.0,48.0
0.137,17,2,152,1,76,0.0,48.0,48.0,1,76,0.0,48.0,48.0
40.097,17,10,676,5,460,10019.0,104.0,64.0,5,216,10023.0,20.0,15.0
0.013,6,10,1990,5,911,3.0,643.0,643.0,5,1079,3.0,811.0,811.0
240.1,6,16,4482,9,963,30012.0,238.0,166.0,7,3519,40016.0,1402.0,786.0
0.006,6,10,1854,5,889,1.0,621.0,621.0,5,965,1.0,697.0,697.0
0.005,6,10,1989,5,927,1.0,659.0,659.0,5,1062,1.0,794.0,794.0
0.009,6,12,1926,6,1189,1.0,659.0,434.0,6,737,1.0,417.0,417.0
1778.537,17,148,46240,74,23112,24362.0,288.0,284.0,74,23128,24362.0,288.0,284.0
0.001,17,2,180,1,66,0.0,38.0,38.0,1,114,0.0,86.0,86.0
0.015,6,10,1972,5,910,3.0,642.0,642.0,5,1062,3.0,794.0,794.0
0.029,6,10,1762,5,911,7.0,643.0,643.0,5,851,7.0,583.0,583.0
0.024,6,6,716,3,458,8.0,302.0,302.0,3,258,9.0,102.0,102.0
0.012,6,10,1989,5,910,2.0,642.0,642.0,5,1079,2.0,811.0,811.0
0.004,6,10,2000,5,927,1.0,659.0,659.0,5,1073,1.0,805.0,805.0
40.069,17,10,676,5,460,10015.0,104.0,64.0,5,216,10016.0,20.0,15.0
0.006,17,2,164,1,74,0.0,46.0,46.0,1,90,0.0,62.0,62.0
0.011,6,10,1972,5,910,2.0,642.0,642.0,5,1062,2.0,794.0,794.0
0.109,6,10,1506,5,395,24.0,127.0,127.0,5,1111,23.0,843.0,843.0
0.013,6,10,1990,5,911,3.0,643.0,643.0,5,1079,3.0,811.0,811.0
0.006,6,10,1643,5,860,1.0,592.0,592.0,5,783,1.0,515.0,515.0
0.076,6,10,1506,5,395,17.0,127.0,127.0,5,1111,18.0,843.0,843.0
0.005,6,10,1854,5,889,1.0,621.0,621.0,5,965,1.0,697.0,697.0
15.075,17,15,9239,8,6902,2149.0,1350.0,834.0,7,2337,2507.0,1350.0,305.0
0.12,6,10,1506,5,395,26.0,127.0,127.0,5,1111,27.0,843.0,843.0
0.015,6,10,1989,5,910,3.0,642.0,642.0,5,1079,3.0,811.0,811.0
0.006,17,2,179,1,71,0.0,43.0,43.0,1,108,0.0,80.0,80.0
169.111,17,84,12374,42,2827,4124.0,44.0,39.0,42,9547,4124.0,239.0,199.0
0.012,6,10,1983,5,910,2.0,642.0,642.0,5,1073,2.0,805.0,805.0
0.006,6,10,1547,5,764,1.0,496.0,496.0,5,783,1.0,515.0,515.0
0.005,6,14,3742,8,504,0.0,80.0,80.0,6,3238,0.0,1470.0,1459.0
0.004,6,10,2007,5,928,1.0,660.0,660.0,5,1079,1.0,811.0,811.0
0.005,6,10,1547,5,764,1.0,496.0,496.0,5,783,1.0,515.0,515.0
0.175,17,2,152,1,76,0.0,48.0,48.0,1,76,0.0,48.0,48.0
0.013,6,11,2042,6,963,2.0,643.0,643.0,5,1079,3.0,811.0,811.0
0.085,6,10,1506,5,395,18.0,127.0,127.0,5,1111,18.0,843.0,843.0
664.956,17,146,21139,73,4914,9235.0,44.0,39.0,73,16225,9235.0,260.0,194.0
0.014,6,10,1989,5,910,3.0,642.0,642.0,5,1079,3.0,811.0,811.0
0.19,6,10,1506,5,395,44.0,127.0,127.0,5,1111,43.0,843.0,843.0
0.004,6,10,1702,5,863,0.0,595.0,595.0,5,839,1.0,571.0,571.0
0.102,6,10,1506,5,395,21.0,127.0,127.0,5,1111,23.0,843.0,843.0
0.005,6,10,2007,5,928,1.0,660.0,660.0,5,1079,1.0,811.0,811.0
0.013,6,13,3735,7,497,2.0,125.0,125.0,6,3238,2.0,1470.0,1459.0
0.006,6,10,2007,5,928,1.0,660.0,660.0,5,1079,1.0,811.0,811.0
0.005,6,10,1689,5,839,1.0,571.0,571.0,5,850,1.0,582.0,582.0
0.009,6,10,1677,5,827,2.0,559.0,559.0,5,850,2.0,582.0,582.0
40.057,17,10,676,5,460,10013.0,104.0,64.0,5,216,10013.0,20.0,15.0
0.011,6,10,1972,5,910,2.0,642.0,642.0,5,1062,2.0,794.0,794.0
0.005,6,10,1854,5,889,1.0,621.0,621.0,5,965,1.0,697.0,697.0
0.004,17,2,412,1,61,0.0,33.0,33.0,1,351,0.0,323.0,323.0
0.075,6,10,1506,5,395,17.0,127.0,127.0,5,1111,16.0,843.0,843.0
0.005,6,10,2006,5,927,1.0,659.0,659.0,5,1079,1.0,811.0,811.0
0.091,6,10,1506,5,395,19.0,127.0,127.0,5,1111,20.0,843.0,843.0
0.005,6,10,2007,5,928,1.0,660.0,660.0,5,1079,1.0,811.0,811.0
0.004,6,10,1989,5,927,1.0,659.0,659.0,5,1062,1.0,794.0,794.0
10.742,17,28,4420,14,1995,817.0,270.0,114.0,14,2425,817.0,588.0,145.0
0.005,6,14,3742,7,452,0.0,80.0,80.0,7,3290,0.0,1448.0,972.0
40.053,17,10,676,5,460,10012.0,104.0,64.0,5,216,10012.0,20.0,15.0
0.006,6,10,1547,5,764,1.0,496.0,496.0,5,783,1.0,515.0,515.0
0.016,6,10,1983,5,910,3.0,642.0,642.0,5,1073,4.0,805.0,805.0
0.001,17,2,180,1,66,0.0,38.0,38.0,1,114,0.0,86.0,86.0
0.019,6,10,1762,5,911,4.0,643.0,643.0,5,851,4.0,583.0,583.0
0.005,6,10,1989,5,927,1.0,659.0,659.0,5,1062,1.0,794.0,794.0
0.001,17,2,136,1,60,0.0,32.0,32.0,1,76,0.0,48.0,48.0
0.006,17,2,170,1,65,0.0,37.0,37.0,1,105,0.0,77.0,77.0
0.005,6,13,3747,7,509,0.0,137.0,137.0,6,3238,1.0,1470.0,1459.0
308.6,17,20,1124,10,716,34282.0,48.0,43.0,10,408,34282.0,20.0,12.0
0.114,17,2,80,1,32,0.0,4.0,4.0,1,48,0.0,20.0,20.0
31.194,6,42,20427,25,7273,1299.0,1127.0,594.0,17,13154,1949.0,2804.0,1361.0
412.709,6,29,4409,12,3102,10912.0,494.0,494.0,17,1307,25794.0,83.0,83.0
0.005,6,13,3747,7,509,0.0,137.0,137.0,6,3238,0.0,1470.0,1459.0
0.005,6,10,2000,5,927,1.0,659.0,659.0,5,1073,1.0,805.0,805.0
0.112,6,10,1506,5,395,26.0,127.0,127.0,5,1111,27.0,843.0,843.0
0.006,6,10,1547,5,764,1.0,496.0,496.0,5,783,1.0,515.0,515.0
0.129,17,2,80,1,32,0.0,4.0,4.0,1,48,0.0,20.0,20.0
309.801,17,20,1124,10,716,34413.0,48.0,43.0,10,408,34410.0,20.0,12.0
0.009,6,10,1972,5,910,2.0,642.0,642.0,5,1062,2.0,794.0,794.0
0.004,6,10,2006,5,927,1.0,659.0,659.0,5,1079,1.0,811.0,811.0
0.005,6,10,2000,5,927,1.0,659.0,659.0,5,1073,1.0,805.0,805.0
308.573,17,18,1008,9,640,38555.0,48.0,43.0,9,368,38555.0,20.0,12.0
0.095,6,10,1506,5,395,20.0,127.0,127.0,5,1111,21.0,843.0,843.0
0.004,6,10,2006,5,927,1.0,659.0,659.0,5,1079,1.0,811.0,811.0
0.008,6,10,1677,5,827,1.0,559.0,559.0,5,850,2.0,582.0,582.0
0.012,6,10,2006,5,927,3.0,659.0,659.0,5,1079,3.0,811.0,811.0
0.005,6,10,2007,5,928,1.0,660.0,660.0,5,1079,1.0,811.0,811.0
0.004,6,10,1989,5,927,1.0,659.0,659.0,5,1062,1.0,794.0,794.0
0.009,17,2,148,1,60,0.0,32.0,32.0,1,88,0.0,60.0,60.0
0.001,17,2,166,1,75,0.0,47.0,47.0,1,91,0.0,63.0,63.0
0.037,17,2,148,1,60,0.0,32.0,32.0,1,88,0.0,60.0,60.0
0.011,6,10,1972,5,910,2.0,642.0,642.0,5,1062,2.0,794.0,794.0
0.059,6,10,1506,5,395,14.0,127.0,127.0,5,1111,13.0,843.0,843.0
0.013,6,10,1631,5,848,3.0,580.0,580.0,5,783,3.0,515.0,515.0
0.009,6,10,1677,5,827,2.0,559.0,559.0,5,850,2.0,582.0,582.0
0.006,6,14,3742,7,452,0.0,80.0,80.0,7,3290,0.0,1448.0,972.0
0.014,6,10,1983,5,910,3.0,642.0,642.0,5,1073,3.0,805.0,805.0
0.009,6,10,1989,5,927,2.0,659.0,659.0,5,1062,2.0,794.0,794.0
0.007,17,2,179,1,71,0.0,43.0,43.0,1,108,0.0,80.0,80.0
0.003,17,2,186,1,61,0.0,33.0,33.0,1,125,0.0,97.0,97.0
0.006,6,10,1547,5,764,1.0,496.0,496.0,5,783,1.0,515.0,515.0
0.018,6,10,1972,5,910,4.0,642.0,642.0,5,1062,4.0,794.0,794.0
0.006,6,10,1547,5,764,1.0,496.0,496.0,5,783,1.0,515.0,515.0
0.003,17,2,136,1,60,0.0,32.0,32.0,1,76,0.0,48.0,48.0
40.071,17,10,676,5,460,10014.0,104.0,64.0,5,216,10017.0,20.0,15.0
175.544,17,78,11271,39,2615,4619.0,44.0,39.0,39,8656,4619.0,239.0,193.0
0.013,6,10,1983,5,910,3.0,642.0,642.0,5,1073,3.0,805.0,805.0
1022.133,6,145,14770,57,9270,18252.0,1938.0,151.0,88,5500,11747.0,148.0,48.0
0.017,6,10,1990,5,911,4.0,643.0,643.0,5,1079,4.0,811.0,811.0
0.003,17,2,148,1,60,0.0,32.0,32.0,1,88,0.0,60.0,60.0
40.045,17,10,676,5,460,10009.0,104.0,64.0,5,216,10010.0,20.0,15.0
0.005,6,10,2000,5,927,1.0,659.0,659.0,5,1073,1.0,805.0,805.0
0.128,6,10,1506,5,395,30.0,127.0,127.0,5,1111,29.0,843.0,843.0
0.292,17,40,21435,22,18415,13.0,1350.0,809.0,18,3020,13.0,1350.0,139.0
0.014,6,10,1983,5,910,3.0,642.0,642.0,5,1073,3.0,805.0,805.0
0.005,6,10,2007,5,928,1.0,660.0,660.0,5,1079,1.0,811.0,811.0
0.006,6,10,1547,5,764,1.0,496.0,496.0,5,783,1.0,515.0,515.0
0.071,17,4,284,2,120,1.0,32.0,32.0,2,164,67.0,60.0,54.0
0.009,6,10,1972,5,910,2.0,642.0,642.0,5,1062,2.0,794.0,794.0
0.005,6,10,1774,5,923,1.0,655.0,655.0,5,851,1.0,583.0,583.0
0.006,6,10,1689,5,839,1.0,571.0,571.0,5,850,1.0,582.0,582.0
0.005,6,10,2000,5,927,1.0,659.0,659.0,5,1073,1.0,805.0,805.0
0.04,17,4,284,2,120,0.0,32.0,32.0,2,164,3.0,60.0,54.0
1781.724,6,301,43133,126,25460,14252.0,1938.0,207.0,175,17673,10239.0,1360.0,130.0
0.008,6,12,1926,6,1189,1.0,659.0,434.0,6,737,1.0,417.0,417.0
293.73,6,328,344130,134,18517,2208.0,2736.0,888.0,194,325613,1521.0,2804.0,1752.0
0.009,6,10,1983,5,910,2.0,642.0,642.0,5,1073,2.0,805.0,805.0
0.011,6,10,1972,5,910,2.0,642.0,642.0,5,1062,2.0,794.0,794.0
0.004,6,10,2000,5,927,1.0,659.0,659.0,5,1073,1.0,805.0,805.0
0.005,6,10,1547,5,764,1.0,496.0,496.0,5,783,1.0,515.0,515.0
0.004,6,10,1779,5,928,1.0,660.0,660.0,5,851,1.0,583.0,583.0
10.807,17,28,4421,14,1993,822.0,268.0,114.0,14,2428,822.0,587.0,145.0
0.011,6,10,1762,5,911,2.0,643.0,643.0,5,851,2.0,583.0,583.0
240.096,6,32,8877,15,6361,17149.0,1515.0,619.0,17,2516,15005.0,580.0,203.0
0.005,6,10,2006,5,927,1.0,659.0,659.0,5,1079,1.0,811.0,811.0
0.004,17,2,148,1,60,0.0,32.0,32.0,1,88,0.0,60.0,60.0
0.006,6,10,1547,5,764,1.0,496.0,496.0,5,783,1.0,515.0,515.0
240.096,6,16,4481,9,963,30012.0,238.0,166.0,7,3518,40015.0,1402.0,786.0
240.089,6,31,9470,15,7106,17149.0,2229.0,703.0,16,2364,16005.0,580.0,190.0
0.097,6,10,1506,5,395,21.0,127.0,127.0,5,1111,19.0,843.0,843.0
0.014,6,10,1989,5,910,3.0,642.0,642.0,5,1079,3.0,811.0,811.0
0.001,17,2,179,1,62,0.0,34.0,34.0,1,117,0.0,89.0,89.0
0.071,17,2,136,1,60,0.0,32.0,32.0,1,76,0.0,48.0,48.0
0.072,6,10,1506,5,395,17.0,127.0,127.0,5,1111,16.0,843.0,843.0
40.059,17,10,676,5,460,10013.0,104.0,64.0,5,216,10013.0,20.0,15.0
0.006,6,11,2059,6,980,1.0,660.0,660.0,5,1079,1.0,811.0,811.0
0.057,6,10,1506,5,395,13.0,127.0,127.0,5,1111,12.0,843.0,843.0
0.012,6,10,1972,5,910,3.0,642.0,642.0,5,1062,2.0,794.0,794.0
0.138,6,10,1506,5,395,30.0,127.0,127.0,5,1111,30.0,843.0,843.0
300.342,6,16,2170,9,684,37522.0,146.0,146.0,7,1486,50029.0,419.0,398.0
0.004,6,10,1779,5,928,1.0,660.0,660.0,5,851,1.0,583.0,583.0
0.006,6,10,2006,5,927,1.0,659.0,659.0,5,1079,1.0,811.0,811.0
0.006,6,10,1643,5,860,1.0,592.0,592.0,5,783,1.0,515.0,515.0
0.006,17,2,170,1,65,0.0,37.0,37.0,1,105,0.0,77.0,77.0
0.102,6,10,1506,5,395,23.0,127.0,127.0,5,1111,20.0,843.0,843.0
0.01,6,10,1989,5,910,2.0,642.0,642.0,5,1079,2.0,811.0,811.0
0.094,6,10,1506,5,395,21.0,127.0,127.0,5,1111,20.0,843.0,843.0
0.106,6,10,1506,5,395,20.0,127.0,127.0,5,1111,22.0,843.0,843.0
0.009,6,10,1689,5,839,2.0,571.0,571.0,5,850,2.0,582.0,582.0
0.009,6,10,1989,5,927,2.0,659.0,659.0,5,1062,2.0,794.0,794.0
0.005,6,10,2007,5,928,1.0,660.0,660.0,5,1079,1.0,811.0,811.0
354.04,6,21,1795,16,1030,23602.0,190.0,190.0,5,765,60002.0,464.0,248.0
0.222,6,16,2777,8,1395,31.0,533.0,323.0,8,1382,20.0,529.0,239.0
1772.81,6,303,98157,187,86998,9531.0,1402.0,677.0,116,11159,15415.0,452.0,70.0
0.003,17,2,152,1,76,0.0,48.0,48.0,1,76,0.0,48.0,48.0
0.006,6,10,1547,5,764,1.0,496.0,496.0,5,783,1.0,515.0,515.0
0.005,6,10,1689,5,839,1.0,571.0,571.0,5,850,1.0,582.0,582.0
240.082,6,16,4480,9,963,30010.0,238.0,166.0,7,3517,40013.0,1402.0,786.0
0.006,6,10,1547,5,764,1.0,496.0,496.0,5,783,1.0,515.0,515.0
0.012,6,10,1972,5,910,2.0,642.0,642.0,5,1062,3.0,794.0,794.0
0.005,6,10,2000,5,927,1.0,659.0,659.0,5,1073,1.0,805.0,805.0
0.12,6,10,1506,5,395,24.0,127.0,127.0,5,1111,27.0,843.0,843.0
0.005,6,10,2006,5,927,1.0,659.0,659.0,5,1079,1.0,811.0,811.0
0.024,6,10,1972,5,910,5.0,642.0,642.0,5,1062,6.0,794.0,794.0
0.006,6,10,2007,5,928,1.0,660.0,660.0,5,1079,1.0,811.0,811.0
0.005,17,2,164,1,74,0.0,46.0,46.0,1,90,0.0,62.0,62.0
0.01,6,10,1677,5,827,2.0,559.0,559.0,5,850,2.0,582.0,582.0
240.376,6,43,8771,21,5686,12018.0,1515.0,509.0,22,3085,11446.0,580.0,241.0
0.11,6,10,1506,5,395,24.0,127.0,127.0,5,1111,24.0,843.0,843.0
0.01,6,10,1989,5,910,2.0,642.0,642.0,5,1079,2.0,811.0,811.0
0.009,6,10,1677,5,827,2.0,559.0,559.0,5,850,2.0,582.0,582.0
0.272,17,4,352,2,130,232.0,37.0,37.0,2,222,146.0,89.0,83.0
40.076,17,10,676,5,460,10016.0,104.0,64.0,5,216,10016.0,20.0,15.0
32.559,6,36,9526,18,4008,520.0,1543.0,814.0,18,5518,1905.0,2667.0,435.0
0.005,17,2,179,1,71,0.0,43.0,43.0,1,108,0.0,80.0,80.0
0.005,6,10,1989,5,927,1.0,659.0,659.0,5,1062,1.0,794.0,794.0
366.013,6,22,2313,16,867,24400.0,195.0,195.0,6,1446,4654.0,419.0,398.0
0.089,6,10,1506,5,395,20.0,127.0,127.0,5,1111,18.0,843.0,843.0
0.011,6,10,1972,5,910,2.0,642.0,642.0,5,1062,2.0,794.0,794.0
0.006,6,10,1989,5,927,1.0,659.0,659.0,5,1062,1.0,794.0,794.0
0.005,6,10,1854,5,889,1.0,621.0,621.0,5,965,1.0,697.0,697.0
0.005,6,10,2000,5,927,1.0,659.0,659.0,5,1073,1.0,805.0,805.0
0.073,17,2,182,1,65,0.0,37.0,37.0,1,117,0.0,89.0,89.0
0.009,6,12,1926,6,1189,1.0,659.0,434.0,6,737,1.0,417.0,417.0
0.001,17,2,180,1,66,0.0,38.0,38.0,1,114,0.0,86.0,86.0
0.001,17,2,136,1,60,0.0,32.0,32.0,1,76,0.0,48.0,48.0
0.005,17,2,144,1,64,0.0,36.0,36.0,1,80,0.0,52.0,52.0
0.112,6,10,1506,5,395,23.0,127.0,127.0,5,1111,23.0,843.0,843.0
0.009,6,10,1990,5,911,2.0,643.0,643.0,5,1079,2.0,811.0,811.0
0.005,6,10,1989,5,927,1.0,659.0,659.0,5,1062,1.0,794.0,794.0
0.042,17,2,148,1,60,0.0,32.0,32.0,1,88,0.0,60.0,60.0
0.05,6,13,3735,7,497,8.0,125.0,125.0,6,3238,9.0,1470.0,1459.0
5.008,6,38,9841,20,4278,263.0,1753.0,858.0,18,5563,283.0,2667.0,402.0
0.004,17,2,148,1,60,0.0,32.0,32.0,1,88,0.0,60.0,60.0
0.013,6,10,1631,5,848,3.0,580.0,580.0,5,783,3.0,515.0,515.0
0.126,17,2,166,1,75,0.0,47.0,47.0,1,91,0.0,63.0,63.0
0.006,6,10,1547,5,764,1.0,496.0,496.0,5,783,1.0,515.0,515.0
0.038,17,2,152,1,76,0.0,48.0,48.0,1,76,0.0,48.0,48.0
0.078,6,10,1506,5,395,15.0,127.0,127.0,5,1111,17.0,843.0,843.0
308.711,17,20,1124,10,716,34287.0,48.0,43.0,10,408,34287.0,20.0,12.0
40.065,17,10,676,5,460,10015.0,104.0,64.0,5,216,10015.0,20.0,15.0
0.009,6,10,1989,5,910,2.0,642.0,642.0,5,1079,2.0,811.0,811.0
0.005,6,13,3747,7,509,0.0,137.0,137.0,6,3238,1.0,1470.0,1459.0
40.06,17,10,676,5,460,10014.0,104.0,64.0,5,216,10012.0,20.0,15.0
0.008,6,10,1989,5,910,2.0,642.0,642.0,5,1079,2.0,811.0,811.0
0.013,6,10,1762,5,911,3.0,643.0,643.0,5,851,3.0,583.0,583.0
0.086,6,10,1506,5,395,19.0,127.0,127.0,5,1111,16.0,843.0,843.0
0.016,6,10,1989,5,910,4.0,642.0,642.0,5,1079,3.0,811.0,811.0
0.068,17,8,3613,4,1874,22.0,1350.0,440.0,4,1739,11.0,1350.0,406.0
0.007,6,10,1547,5,764,1.0,496.0,496.0,5,783,1.0,515.0,515.0
40.05,17,10,676,5,460,10011.0,104.0,64.0,5,216,10010.0,20.0,15.0
0.014,17,2,180,1,66,0.0,38.0,38.0,1,114,0.0,86.0,86.0
0.211,6,16,2668,8,1394,30.0,533.0,323.0,8,1274,18.0,529.0,212.0
0.003,17,4,284,2,120,0.0,32.0,32.0,2,164,0.0,60.0,54.0
0.003,17,2,152,1,76,0.0,48.0,48.0,1,76,0.0,48.0,48.0
0.093,6,10,1506,5,395,22.0,127.0,127.0,5,1111,20.0,843.0,843.0
986.35,6,54,17498,28,8462,36531.0,1402.0,583.0,26,9036,37051.0,1402.0,590.0
0.007,17,2,194,1,59,0.0,31.0,31.0,1,135,0.0,107.0,107.0
0.005,17,2,170,1,65,0.0,37.0,37.0,1,105,0.0,77.0,77.0
0.005,6,10,1774,5,923,1.0,655.0,655.0,5,851,1.0,583.0,583.0
0.003,17,4,284,2,120,0.0,32.0,32.0,2,164,0.0,60.0,54.0
40.054,17,10,676,5,460,10012.0,104.0,64.0,5,216,10012.0,20.0,15.0
0.089,6,10,1506,5,395,19.0,127.0,127.0,5,1111,20.0,843.0,843.0
0.001,17,2,180,1,66,0.0,38.0,38.0,1,114,0.0,86.0,86.0
0.005,6,10,1547,5,764,1.0,496.0,496.0,5,783,1.0,515.0,515.0
0.004,6,10,2007,5,928,1.0,660.0,660.0,5,1079,1.0,811.0,811.0
40.057,17,10,676,5,460,10011.0,104.0,64.0,5,216,10013.0,20.0,15.0
0.117,6,10,1506,5,395,27.0,127.0,127.0,5,1111,23.0,843.0,843.0
0.029,6,10,1989,5,910,7.0,642.0,642.0,5,1079,7.0,811.0,811.0
0.006,6,10,1689,5,839,1.0,571.0,571.0,5,850,1.0,582.0,582.0
0.089,6,10,1506,5,395,17.0,127.0,127.0,5,1111,20.0,843.0,843.0
0.004,6,10,1702,5,863,1.0,595.0,595.0,5,839,0.0,571.0,571.0
0.005,6,10,1989,5,927,1.0,659.0,659.0,5,1062,1.0,794.0,794.0
0.005,6,10,2000,5,927,1.0,659.0,659.0,5,1073,1.0,805.0,805.0
0.026,6,10,1990,5,911,6.0,643.0,643.0,5,1079,6.0,811.0,811.0
0.005,6,13,3690,7,452,0.0,80.0,80.0,6,3238,0.0,1470.0,1459.0
0.011,6,10,1989,5,910,2.0,642.0,642.0,5,1079,2.0,811.0,811.0
0.003,17,2,656,1,328,0.0,300.0,300.0,1,328,0.0,300.0,300.0
0.005,6,13,3747,7,509,0.0,137.0,137.0,6,3238,1.0,1470.0,1459.0
40.061,17,10,676,5,460,10013.0,104.0,64.0,5,216,10014.0,20.0,15.0
0.004,6,10,1702,5,863,1.0,595.0,595.0,5,839,1.0,571.0,571.0
0.005,6,10,2006,5,927,1.0,659.0,659.0,5,1079,1.0,811.0,811.0
10.814,17,28,4418,14,1994,823.0,269.0,114.0,14,2424,823.0,587.0,145.0
0.005,6,10,1643,5,860,1.0,592.0,592.0,5,783,1.0,515.0,515.0
0.124,17,2,170,1,65,0.0,37.0,37.0,1,105,0.0,77.0,77.0
0.012,6,10,1989,5,910,3.0,642.0,642.0,5,1079,2.0,811.0,811.0
0.096,6,10,1506,5,395,21.0,127.0,127.0,5,1111,21.0,843.0,843.0
0.093,6,10,1506,5,395,20.0,127.0,127.0,5,1111,21.0,843.0,843.0
0.011,6,10,1989,5,910,2.0,642.0,642.0,5,1079,2.0,811.0,811.0
0.005,6,10,2007,5,928,1.0,660.0,660.0,5,1079,1.0,811.0,811.0
0.005,6,10,2006,5,927,1.0,659.0,659.0,5,1079,1.0,811.0,811.0
0.095,6,10,1506,5,395,21.0,127.0,127.0,5,1111,20.0,843.0,843.0
40.076,6,70,31832,36,3501,1145.0,802.0,179.0,34,28331,1214.0,1736.0,983.0
40.061,17,10,676,5,460,10013.0,104.0,64.0,5,216,10014.0,20.0,15.0
0.09,6,10,1506,5,395,20.0,127.0,127.0,5,1111,19.0,843.0,843.0
0.04,6,10,1972,5,910,9.0,642.0,642.0,5,1062,10.0,794.0,794.0
0.004,6,10,1702,5,863,1.0,595.0,595.0,5,839,0.0,571.0,571.0
0.006,6,10,1689,5,839,1.0,571.0,571.0,5,850,1.0,582.0,582.0
0.087,6,10,1506,5,395,19.0,127.0,127.0,5,1111,18.0,843.0,843.0
0.076,6,10,1506,5,395,17.0,127.0,127.0,5,1111,14.0,843.0,843.0
0.004,17,2,214,1,75,0.0,47.0,47.0,1,139,0.0,111.0,111.0
40.073,17,10,676,5,460,10017.0,104.0,64.0,5,216,10017.0,20.0,15.0
0.004,6,10,1989,5,927,1.0,659.0,659.0,5,1062,1.0,794.0,794.0
0.005,6,10,1689,5,839,1.0,571.0,571.0,5,850,1.0,582.0,582.0
0.067,6,10,1506,5,395,14.0,127.0,127.0,5,1111,14.0,843.0,843.0
0.005,17,2,166,1,75,0.0,47.0,47.0,1,91,0.0,63.0,63.0
0.082,17,2,144,1,64,0.0,36.0,36.0,1,80,0.0,52.0,52.0
0.009,6,10,1631,5,848,2.0,580.0,580.0,5,783,2.0,515.0,515.0
0.014,6,10,1989,5,910,3.0,642.0,642.0,5,1079,3.0,811.0,811.0
0.001,17,2,166,1,75,0.0,47.0,47.0,1,91,0.0,63.0,63.0
0.007,6,10,1547,5,764,1.0,496.0,496.0,5,783,1.0,515.0,515.0
0.004,6,10,2006,5,927,1.0,659.0,659.0,5,1079,1.0,811.0,811.0
0.013,6,10,1677,5,827,3.0,559.0,559.0,5,850,3.0,582.0,582.0
0.068,6,10,1506,5,395,15.0,127.0,127.0,5,1111,13.0,843.0,843.0
0.204,6,46,11757,25,3365,8.0,1082.0,187.0,21,8392,9.0,1402.0,606.0
0.023,6,13,3913,7,495,3.0,123.0,123.0,6,3418,4.0,1650.0,1549.0
0.005,6,10,2006,5,927,1.0,659.0,659.0,5,1079,1.0,811.0,811.0
0.121,6,10,1506,5,395,28.0,127.0,127.0,5,1111,27.0,843.0,843.0
0.012,6,10,1989,5,910,3.0,642.0,642.0,5,1079,3.0,811.0,811.0
0.004,17,2,148,1,60,0.0,32.0,32.0,1,88,0.0,60.0,60.0
0.014,6,13,3735,7,497,2.0,125.0,125.0,6,3238,2.0,1470.0,1459.0
0.006,6,10,1547,5,764,1.0,496.0,496.0,5,783,1.0,515.0,515.0
240.009,6,9,787,5,488,60002.0,232.0,232.0,4,299,80002.0,83.0,83.0
0.006,6,10,1547,5,764,1.0,496.0,496.0,5,783,1.0,515.0,515.0
0.005,6,10,2006,5,927,1.0,659.0,659.0,5,1079,1.0,811.0,811.0
300.344,6,16,2170,9,684,37522.0,146.0,146.0,7,1486,50029.0,419.0,398.0
0.072,17,2,184,1,61,0.0,33.0,33.0,1,123,0.0,95.0,95.0
0.015,6,10,1983,5,910,3.0,642.0,642.0,5,1073,3.0,805.0,805.0
0.018,6,10,1989,5,910,4.0,642.0,642.0,5,1079,4.0,811.0,811.0
0.09,6,10,1506,5,395,19.0,127.0,127.0,5,1111,22.0,843.0,843.0
0.01,6,13,3735,7,497,1.0,125.0,125.0,6,3238,2.0,1470.0,1459.0
0.008,6,12,1926,6,1189,1.0,659.0,434.0,6,737,1.0,417.0,417.0
0.029,6,10,1677,5,827,7.0,559.0,559.0,5,850,7.0,582.0,582.0
0.004,6,10,2006,5,927,1.0,659.0,659.0,5,1079,1.0,811.0,811.0
0.014,17,2,164,1,74,0.0,46.0,46.0,1,90,0.0,62.0,62.0
0.005,6,13,3747,7,509,0.0,137.0,137.0,6,3238,0.0,1470.0,1459.0
0.001,17,2,180,1,66,0.0,38.0,38.0,1,114,0.0,86.0,86.0
0.006,6,10,1547,5,764,1.0,496.0,496.0,5,783,1.0,515.0,515.0
40.052,17,10,676,5,460,10012.0,104.0,64.0,5,216,10012.0,20.0,15.0
0.005,6,10,1547,5,764,1.0,496.0,496.0,5,783,1.0,515.0,515.0
0.014,6,10,1989,5,910,3.0,642.0,642.0,5,1079,3.0,811.0,811.0
0.087,6,10,1506,5,395,18.0,127.0,127.0,5,1111,17.0,843.0,843.0
0.006,6,14,3736,7,446,0.0,74.0,74.0,7,3290,0.0,1448.0,972.0
0.006,17,2,166,1,75,0.0,47.0,47.0,1,91,0.0,63.0,63.0
240.293,6,28,9955,14,1292,18484.0,260.0,189.0,14,8663,18481.0,1402.0,792.0
0.082,6,10,1506,5,395,19.0,127.0,127.0,5,1111,17.0,843.0,843.0
15.074,17,16,8571,8,6293,2149.0,1350.0,758.0,8,2278,2149.0,1350.0,256.0
0.001,17,2,166,1,75,0.0,47.0,47.0,1,91,0.0,63.0,63.0
327.688,17,20,1124,10,716,36395.0,48.0,43.0,10,408,36395.0,20.0,12.0
40.058,17,10,676,5,460,10012.0,104.0,64.0,5,216,10013.0,20.0,15.0
0.005,17,2,230,1,68,0.0,40.0,40.0,1,162,0.0,134.0,134.0
0.004,6,10,2006,5,927,1.0,659.0,659.0,5,1079,1.0,811.0,811.0
0.008,6,10,1989,5,910,2.0,642.0,642.0,5,1079,1.0,811.0,811.0
0.019,6,10,1972,5,910,4.0,642.0,642.0,5,1062,4.0,794.0,794.0
308.627,17,20,1124,10,716,34277.0,48.0,43.0,10,408,34277.0,20.0,12.0
0.015,6,13,3735,7,497,2.0,125.0,125.0,6,3238,2.0,1470.0,1459.0
0.005,6,10,2007,5,928,1.0,660.0,660.0,5,1079,1.0,811.0,811.0
10.924,17,28,4423,14,1994,831.0,269.0,114.0,14,2429,831.0,588.0,145.0
351.988,6,20,2210,6,1308,12003.0,494.0,494.0,14,902,27075.0,83.0,83.0
0.13,6,10,1506,5,395,26.0,127.0,127.0,5,1111,27.0,843.0,843.0
15.071,17,15,9238,8,6902,2148.0,1350.0,834.0,7,2336,2507.0,1350.0,305.0
0.097,6,10,1506,5,395,20.0,127.0,127.0,5,1111,22.0,843.0,843.0
0.068,6,10,1506,5,395,16.0,127.0,127.0,5,1111,14.0,843.0,843.0
40.051,17,10,676,5,460,10011.0,104.0,64.0,5,216,10011.0,20.0,15.0
1792.799,6,484,98693,243,87463,7407.0,421.0,368.0,241,11230,7469.0,53.0,53.0
0.006,6,10,1547,5,764,1.0,496.0,496.0,5,783,1.0,515.0,515.0
0.08,6,10,1506,5,395,17.0,127.0,127.0,5,1111,19.0,843.0,843.0
0.004,17,2,193,1,71,0.0,43.0,43.0,1,122,0.0,94.0,94.0
0.005,6,10,2006,5,927,1.0,659.0,659.0,5,1079,1.0,811.0,811.0
0.257,6,16,2777,8,1395,36.0,533.0,323.0,8,1382,24.0,529.0,239.0
300.384,6,16,2170,9,684,37526.0,146.0,146.0,7,1486,50036.0,419.0,398.0
0.006,17,2,209,1,64,0.0,36.0,36.0,1,145,0.0,117.0,117.0
0.008,17,2,169,1,62,0.0,34.0,34.0,1,107,0.0,79.0,79.0
0.001,17,2,180,1,66,0.0,38.0,38.0,1,114,0.0,86.0,86.0
0.005,6,10,1779,5,928,1.0,660.0,660.0,5,851,1.0,583.0,583.0
0.004,17,2,148,1,60,0.0,32.0,32.0,1,88,0.0,60.0,60.0
0.012,6,10,1983,5,910,3.0,642.0,642.0,5,1073,3.0,805.0,805.0
0.005,6,14,3799,7,509,0.0,137.0,137.0,7,3290,0.0,1448.0,972.0
1799.998,6,137,6590,76,3625,23996.0,39.0,39.0,61,2965,29996.0,35.0,35.0
0.004,17,2,136,1,60,0.0,32.0,32.0,1,76,0.0,48.0,48.0
0.006,17,2,136,1,60,0.0,32.0,32.0,1,76,0.0,48.0,48.0
0.037,17,2,184,1,61,0.0,33.0,33.0,1,123,0.0,95.0,95.0
0.004,6,10,2006,5,927,1.0,659.0,659.0,5,1079,1.0,811.0,811.0
0.004,17,2,180,1,66,0.0,38.0,38.0,1,114,0.0,86.0,86.0
0.082,6,10,1506,5,395,18.0,127.0,127.0,5,1111,16.0,843.0,843.0
0.073,17,2,186,1,61,0.0,33.0,33.0,1,125,0.0,97.0,97.0
0.006,17,2,166,1,75,0.0,47.0,47.0,1,91,0.0,63.0,63.0
0.005,17,2,214,1,75,0.0,47.0,47.0,1,139,0.0,111.0,111.0
0.119,6,10,1506,5,395,22.0,127.0,127.0,5,1111,25.0,843.0,843.0
0.004,6,10,2000,5,927,1.0,659.0,659.0,5,1073,1.0,805.0,805.0
0.071,6,10,1506,5,395,14.0,127.0,127.0,5,1111,16.0,843.0,843.0
0.009,6,10,1677,5,827,2.0,559.0,559.0,5,850,2.0,582.0,582.0
0.064,17,2,80,1,32,0.0,4.0,4.0,1,48,0.0,20.0,20.0
0.019,6,13,3913,7,495,3.0,123.0,123.0,6,3418,3.0,1650.0,1549.0
0.004,6,10,1779,5,928,1.0,660.0,660.0,5,851,1.0,583.0,583.0
40.081,17,10,676,5,460,10016.0,104.0,64.0,5,216,10019.0,20.0,15.0
0.012,6,10,1990,5,911,2.0,643.0,643.0,5,1079,3.0,811.0,811.0
40.068,17,10,676,5,460,10016.0,104.0,64.0,5,216,10014.0,20.0,15.0
0.004,6,10,2007,5,928,1.0,660.0,660.0,5,1079,1.0,811.0,811.0
0.005,6,10,2007,5,928,1.0,660.0,660.0,5,1079,1.0,811.0,811.0
0.004,6,10,1779,5,928,1.0,660.0,660.0,5,851,1.0,583.0,583.0
0.178,6,10,1506,5,395,38.0,127.0,127.0,5,1111,40.0,843.0,843.0
0.025,6,10,1990,5,911,6.0,643.0,643.0,5,1079,6.0,811.0,811.0
0.004,17,2,170,1,65,0.0,37.0,37.0,1,105,0.0,77.0,77.0
0.011,17,2,138,1,61,0.0,33.0,33.0,1,77,0.0,49.0,49.0
0.017,6,10,1989,5,910,4.0,642.0,642.0,5,1079,4.0,811.0,811.0
0.013,6,10,1989,5,910,3.0,642.0,642.0,5,1079,3.0,811.0,811.0
0.042,17,4,284,2,120,0.0,32.0,32.0,2,164,38.0,60.0,54.0
40.063,17,10,676,5,460,10013.0,104.0,64.0,5,216,10014.0,20.0,15.0
0.232,17,14,8687,7,6272,38.0,1350.0,868.0,7,2415,27.0,1350.0,317.0
0.261,17,44,25772,24,21175,11.0,1350.0,854.0,20,4597,10.0,1350.0,201.0
0.004,6,10,2006,5,927,1.0,659.0,659.0,5,1079,1.0,811.0,811.0
40.056,17,10,676,5,460,10012.0,104.0,64.0,5,216,10011.0,20.0,15.0
0.014,6,10,1990,5,911,3.0,643.0,643.0,5,1079,3.0,811.0,811.0
0.078,6,10,1506,5,395,18.0,127.0,127.0,5,1111,17.0,843.0,843.0
0.007,6,10,1989,5,910,1.0,642.0,642.0,5,1079,1.0,811.0,811.0
0.005,6,10,1689,5,839,1.0,571.0,571.0,5,850,1.0,582.0,582.0
40.082,17,10,676,5,460,10017.0,104.0,64.0,5,216,10019.0,20.0,15.0
0.01,6,10,1983,5,910,2.0,642.0,642.0,5,1073,2.0,805.0,805.0
0.007,17,2,164,1,74,0.0,46.0,46.0,1,90,0.0,62.0,62.0
0.082,6,10,1506,5,395,18.0,127.0,127.0,5,1111,15.0,843.0,843.0
0.005,6,10,2000,5,927,1.0,659.0,659.0,5,1073,1.0,805.0,805.0
0.005,17,2,166,1,75,0.0,47.0,47.0,1,91,0.0,63.0,63.0
0.073,6,10,1506,5,395,15.0,127.0,127.0,5,1111,17.0,843.0,843.0
0.005,6,10,1689,5,839,1.0,571.0,571.0,5,850,1.0,582.0,582.0
0.707,6,22,5072,11,1250,60.0,325.0,133.0,11,3822,60.0,1414.0,563.0
0.005,6,10,1689,5,839,1.0,571.0,571.0,5,850,1.0,582.0,582.0
0.004,6,10,2006,5,927,1.0,659.0,659.0,5,1079,1.0,811.0,811.0
0.006,6,10,1689,5,839,1.0,571.0,571.0,5,850,1.0,582.0,582.0
0.006,6,10,1547,5,764,1.0,496.0,496.0,5,783,1.0,515.0,515.0
1770.307,6,77,4056,39,2054,46585.0,26.0,26.0,38,2002,47845.0,26.0,26.0
15.075,17,16,8463,8,6377,2149.0,1350.0,769.0,8,2086,2149.0,1350.0,232.0
364.403,6,21,1792,16,1030,24293.0,190.0,190.0,5,762,60009.0,461.0,247.0
1788.177,6,302,29069,153,11057,11764.0,748.0,257.0,149,18012,12082.0,1625.0,73.0
0.152,6,10,1506,5,395,35.0,127.0,127.0,5,1111,32.0,843.0,843.0
0.015,6,10,2006,5,927,3.0,659.0,659.0,5,1079,3.0,811.0,811.0
0.005,6,10,2006,5,927,1.0,659.0,659.0,5,1079,1.0,811.0,811.0
0.167,17,2,152,1,76,0.0,48.0,48.0,1,76,0.0,48.0,48.0
0.012,6,10,1983,5,910,3.0,642.0,642.0,5,1073,3.0,805.0,805.0
0.005,6,10,2006,5,927,1.0,659.0,659.0,5,1079,1.0,811.0,811.0
40.059,17,10,676,5,460,10014.0,104.0,64.0,5,216,10013.0,20.0,15.0
0.001,17,2,180,1,66,0.0,38.0,38.0,1,114,0.0,86.0,86.0
0.005,17,2,180,1,66,0.0,38.0,38.0,1,114,0.0,86.0,86.0
0.006,17,2,169,1,62,0.0,34.0,34.0,1,107,0.0,79.0,79.0
0.034,17,2,152,1,76,0.0,48.0,48.0,1,76,0.0,48.0,48.0
0.005,6,10,2007,5,928,1.0,660.0,660.0,5,1079,1.0,811.0,811.0
0.006,6,10,1689,5,839,1.0,571.0,571.0,5,850,1.0,582.0,582.0
0.011,6,10,1989,5,910,2.0,642.0,642.0,5,1079,2.0,811.0,811.0
0.091,6,10,1506,5,395,20.0,127.0,127.0,5,1111,17.0,843.0,843.0
0.006,6,12,1698,6,863,1.0,327.0,271.0,6,835,1.0,515.0,515.0
0.068,17,8,3613,4,1874,22.0,1350.0,440.0,4,1739,11.0,1350.0,406.0
0.115,6,10,1506,5,395,22.0,127.0,127.0,5,1111,25.0,843.0,843.0
0.123,6,10,1506,5,395,27.0,127.0,127.0,5,1111,23.0,843.0,843.0
0.008,6,10,1989,5,910,2.0,642.0,642.0,5,1079,1.0,811.0,811.0
0.041,17,4,352,2,130,2.0,37.0,37.0,2,222,4.0,89.0,83.0
308.974,17,18,1008,9,640,38614.0,48.0,43.0,9,368,38614.0,20.0,12.0
0.039,17,4,420,2,122,0.0,33.0,33.0,2,298,0.0,145.0,121.0
0.001,17,2,140,1,62,0.0,34.0,34.0,1,78,0.0,50.0,50.0
0.005,6,10,2007,5,928,1.0,660.0,660.0,5,1079,1.0,811.0,811.0
0.075,6,10,1506,5,395,16.0,127.0,127.0,5,1111,15.0,843.0,843.0
0.008,6,10,1983,5,910,2.0,642.0,642.0,5,1073,1.0,805.0,805.0
0.013,6,10,1989,5,910,3.0,642.0,642.0,5,1079,3.0,811.0,811.0
0.258,17,41,26372,25,23389,10.0,1350.0,907.0,16,2983,13.0,1350.0,158.0
176.032,17,74,10301,37,2465,4889.0,44.0,38.0,37,7836,4889.0,261.0,183.0
171.161,17,72,10308,36,2405,4890.0,44.0,38.0,36,7903,4890.0,239.0,191.0
0.005,6,10,1989,5,927,1.0,659.0,659.0,5,1062,1.0,794.0,794.0
0.01,6,10,1990,5,911,2.0,643.0,643.0,5,1079,2.0,811.0,811.0
0.066,17,8,3613,4,1874,22.0,1350.0,440.0,4,1739,10.0,1350.0,406.0
0.005,6,10,2006,5,927,1.0,659.0,659.0,5,1079,1.0,811.0,811.0
0.005,6,10,2006,5,927,1.0,659.0,659.0,5,1079,1.0,811.0,811.0
0.014,6,10,1990,5,911,3.0,643.0,643.0,5,1079,3.0,811.0,811.0
0.001,17,2,180,1,66,0.0,38.0,38.0,1,114,0.0,86.0,86.0
0.003,17,2,148,1,60,0.0,32.0,32.0,1,88,0.0,60.0,60.0
0.003,17,2,148,1,60,0.0,32.0,32.0,1,88,0.0,60.0,60.0
0.005,6,10,2006,5,927,1.0,659.0,659.0,5,1079,1.0,811.0,811.0
0.012,6,10,1983,5,910,3.0,642.0,642.0,5,1073,2.0,805.0,805.0
0.071,17,4,420,2,122,1.0,33.0,33.0,2,298,67.0,145.0,121.0
0.265,17,39,20193,21,17037,13.0,1350.0,783.0,18,3156,12.0,1350.0,147.0
0.02,6,10,1972,5,910,4.0,642.0,642.0,5,1062,4.0,794.0,794.0
40.088,17,10,676,5,460,10021.0,104.0,64.0,5,216,10021.0,20.0,15.0
0.005,6,14,3736,7,446,0.0,74.0,74.0,7,3290,0.0,1448.0,972.0
0.005,17,2,213,1,69,0.0,41.0,41.0,1,144,0.0,116.0,116.0
0.005,6,10,1989,5,927,1.0,659.0,659.0,5,1062,1.0,794.0,794.0
0.078,6,10,1506,5,395,18.0,127.0,127.0,5,1111,18.0,843.0,843.0
0.004,6,10,1989,5,927,1.0,659.0,659.0,5,1062,1.0,794.0,794.0
0.005,17,2,136,1,60,0.0,32.0,32.0,1,76,0.0,48.0,48.0
0.004,6,10,1702,5,863,1.0,595.0,595.0,5,839,1.0,571.0,571.0
64.443,6,36,9669,18,4151,516.0,1360.0,679.0,18,5518,3780.0,2667.0,435.0
0.014,6,10,1972,5,910,3.0,642.0,642.0,5,1062,3.0,794.0,794.0
0.011,6,10,1972,5,910,2.0,642.0,642.0,5,1062,2.0,794.0,794.0
0.015,6,10,1989,5,910,3.0,642.0,642.0,5,1079,3.0,811.0,811.0
0.105,6,10,1506,5,395,25.0,127.0,127.0,5,1111,25.0,843.0,843.0
0.001,17,2,180,1,66,0.0,38.0,38.0,1,114,0.0,86.0,86.0
0.006,6,10,1689,5,839,1.0,571.0,571.0,5,850,1.0,582.0,582.0
1786.763,6,324,51573,134,30984,13433.0,2801.0,243.0,190,20589,9453.0,1360.0,149.0
0.009,6,10,1989,5,910,2.0,642.0,642.0,5,1079,2.0,811.0,811.0
0.007,6,10,1702,5,863,1.0,595.0,595.0,5,839,1.0,571.0,571.0
0.06,17,2,152,1,76,0.0,48.0,48.0,1,76,0.0,48.0,48.0
0.006,6,10,2007,5,928,1.0,660.0,660.0,5,1079,1.0,811.0,811.0
0.014,6,10,1972,5,910,3.0,642.0,642.0,5,1062,3.0,794.0,794.0
0.005,6,10,1989,5,927,1.0,659.0,659.0,5,1062,1.0,794.0,794.0
0.015,6,10,1990,5,911,3.0,643.0,643.0,5,1079,3.0,811.0,811.0
0.001,17,2,180,1,66,0.0,38.0,38.0,1,114,0.0,86.0,86.0
0.003,6,10,1702,5,863,0.0,595.0,595.0,5,839,0.0,571.0,571.0
0.143,17,2,184,1,61,0.0,33.0,33.0,1,123,0.0,95.0,95.0
0.142,6,10,1506,5,395,35.0,127.0,127.0,5,1111,33.0,843.0,843.0
0.133,6,10,1506,5,395,30.0,127.0,127.0,5,1111,29.0,843.0,843.0
0.064,17,2,184,1,61,0.0,33.0,33.0,1,123,0.0,95.0,95.0
0.092,6,10,1506,5,395,21.0,127.0,127.0,5,1111,20.0,843.0,843.0
0.004,6,10,1989,5,927,1.0,659.0,659.0,5,1062,1.0,794.0,794.0
0.005,6,10,2006,5,927,1.0,659.0,659.0,5,1079,1.0,811.0,811.0
0.325,17,16,9975,8,6917,46.0,1350.0,836.0,8,3058,37.0,1350.0,354.0
0.005,6,10,2006,5,927,1.0,659.0,659.0,5,1079,1.0,811.0,811.0
0.004,6,10,1779,5,928,1.0,660.0,660.0,5,851,1.0,583.0,583.0
0.004,6,10,1989,5,927,1.0,659.0,659.0,5,1062,1.0,794.0,794.0
40.052,17,10,676,5,460,10011.0,104.0,64.0,5,216,10012.0,20.0,15.0
1771.668,6,105,6270,60,3525,30027.0,27.0,27.0,45,2745,40264.0,27.0,27.0
0.005,6,10,2006,5,927,1.0,659.0,659.0,5,1079,1.0,811.0,811.0
0.007,6,10,1547,5,764,1.0,496.0,496.0,5,783,1.0,515.0,515.0
0.01,6,10,1990,5,911,2.0,643.0,643.0,5,1079,2.0,811.0,811.0
0.007,6,10,1547,5,764,1.0,496.0,496.0,5,783,1.0,515.0,515.0
0.01,6,10,1989,5,910,2.0,642.0,642.0,5,1079,2.0,811.0,811.0
0.001,17,2,180,1,66,0.0,38.0,38.0,1,114,0.0,86.0,86.0
0.077,6,10,1506,5,395,15.0,127.0,127.0,5,1111,17.0,843.0,843.0
0.089,6,10,1506,5,395,20.0,127.0,127.0,5,1111,17.0,843.0,843.0
0.014,17,2,136,1,60,0.0,32.0,32.0,1,76,0.0,48.0,48.0
0.043,17,2,152,1,76,0.0,48.0,48.0,1,76,0.0,48.0,48.0
0.02,6,10,1983,5,910,5.0,642.0,642.0,5,1073,4.0,805.0,805.0
0.007,6,10,1989,5,927,1.0,659.0,659.0,5,1062,1.0,794.0,794.0
0.003,17,2,234,1,61,0.0,33.0,33.0,1,173,0.0,145.0,145.0
10.996,17,28,4396,14,2313,837.0,588.0,137.0,14,2083,836.0,270.0,120.0
0.094,6,10,1506,5,395,21.0,127.0,127.0,5,1111,22.0,843.0,843.0
0.005,17,2,169,1,62,0.0,34.0,34.0,1,107,0.0,79.0,79.0
0.005,17,2,170,1,65,0.0,37.0,37.0,1,105,0.0,77.0,77.0
0.085,6,10,1506,5,395,17.0,127.0,127.0,5,1111,18.0,843.0,843.0
0.006,6,10,1689,5,839,1.0,571.0,571.0,5,850,1.0,582.0,582.0
0.115,6,10,1506,5,395,21.0,127.0,127.0,5,1111,25.0,843.0,843.0
0.008,6,10,1990,5,911,1.0,643.0,643.0,5,1079,2.0,811.0,811.0
300.36,6,16,2170,9,684,37522.0,146.0,146.0,7,1486,50031.0,419.0,398.0
0.005,6,10,1989,5,927,1.0,659.0,659.0,5,1062,1.0,794.0,794.0
40.059,17,10,676,5,460,10011.0,104.0,64.0,5,216,10014.0,20.0,15.0
40.061,17,10,676,5,460,10014.0,104.0,64.0,5,216,10014.0,20.0,15.0
0.005,6,10,1989,5,927,1.0,659.0,659.0,5,1062,1.0,794.0,794.0
0.01,6,10,1983,5,910,2.0,642.0,642.0,5,1073,2.0,805.0,805.0
0.207,6,16,2777,8,1395,29.0,533.0,323.0,8,1382,19.0,529.0,239.0
0.005,17,2,154,1,69,0.0,41.0,41.0,1,85,0.0,57.0,57.0
0.006,6,10,1989,5,927,1.0,659.0,659.0,5,1062,1.0,794.0,794.0
0.009,6,10,1989,5,910,2.0,642.0,642.0,5,1079,2.0,811.0,811.0
66.103,6,27,18189,15,10237,4721.0,2804.0,1574.0,12,7952,5994.0,2323.0,1220.0
0.007,6,10,1762,5,911,1.0,643.0,643.0,5,851,1.0,583.0,583.0
0.012,6,10,1677,5,827,3.0,559.0,559.0,5,850,2.0,582.0,582.0
0.015,6,10,1990,5,911,3.0,643.0,643.0,5,1079,3.0,811.0,811.0
0.005,17,2,214,1,75,0.0,47.0,47.0,1,139,0.0,111.0,111.0
0.003,17,2,152,1,76,0.0,48.0,48.0,1,76,0.0,48.0,48.0
292.341,6,323,344025,122,17892,2416.0,2736.0,825.0,201,326133,1461.0,2804.0,1688.0
0.006,6,10,1689,5,839,1.0,571.0,571.0,5,850,1.0,582.0,582.0
0.003,17,2,132,1,58,0.0,30.0,30.0,1,74,0.0,46.0,46.0
0.009,6,10,1989,5,910,2.0,642.0,642.0,5,1079,2.0,811.0,811.0
40.072,17,10,676,5,460,10016.0,104.0,64.0,5,216,10016.0,20.0,15.0
0.04,17,2,136,1,60,0.0,32.0,32.0,1,76,0.0,48.0,48.0
0.004,6,10,1779,5,928,1.0,660.0,660.0,5,851,1.0,583.0,583.0
0.093,6,10,1506,5,395,21.0,127.0,127.0,5,1111,19.0,843.0,843.0
9.038,17,6,376,5,280,2259.0,28.0,28.0,1,96,0.0,68.0,68.0
0.02,6,10,1972,5,910,4.0,642.0,642.0,5,1062,4.0,794.0,794.0
0.01,6,10,1989,5,910,2.0,642.0,642.0,5,1079,2.0,811.0,811.0
0.001,17,2,180,1,66,0.0,38.0,38.0,1,114,0.0,86.0,86.0
0.005,17,2,179,1,71,0.0,43.0,43.0,1,108,0.0,80.0,80.0
0.016,6,10,1972,5,910,3.0,642.0,642.0,5,1062,4.0,794.0,794.0
0.005,17,2,187,1,71,0.0,43.0,43.0,1,116,0.0,88.0,88.0
0.006,6,10,1547,5,764,1.0,496.0,496.0,5,783,1.0,515.0,515.0
0.011,6,10,1677,5,827,2.0,559.0,559.0,5,850,2.0,582.0,582.0
0.081,6,10,1506,5,395,17.0,127.0,127.0,5,1111,19.0,843.0,843.0
1778.305,17,143,41496,72,22752,25046.0,288.0,288.0,71,18744,25404.0,236.0,236.0
40.08,17,10,676,5,460,10018.0,104.0,64.0,5,216,10019.0,20.0,15.0
0.016,6,10,1631,5,848,3.0,580.0,580.0,5,783,4.0,515.0,515.0
0.186,6,9,1214,5,775,46.0,519.0,519.0,4,439,60.0,223.0,223.0
0.138,6,10,1506,5,395,32.0,127.0,127.0,5,1111,33.0,843.0,843.0
40.059,17,10,676,5,460,10012.0,104.0,64.0,5,216,10014.0,20.0,15.0
0.006,6,10,1854,5,889,1.0,621.0,621.0,5,965,1.0,697.0,697.0
0.014,6,10,1972,5,910,3.0,642.0,642.0,5,1062,3.0,794.0,794.0
0.166,17,2,152,1,76,0.0,48.0,48.0,1,76,0.0,48.0,48.0
0.012,6,14,3787,7,497,1.0,125.0,125.0,7,3290,1.0,1448.0,972.0
11.209,17,28,4395,14,1995,849.0,270.0,114.0,14,2400,849.0,587.0,143.0
0.039,17,2,166,1,75,0.0,47.0,47.0,1,91,0.0,63.0,63.0
0.006,6,10,1854,5,889,1.0,621.0,621.0,5,965,1.0,697.0,697.0
0.005,6,10,2000,5,927,1.0,659.0,659.0,5,1073,1.0,805.0,805.0
0.01,6,10,1972,5,910,2.0,642.0,642.0,5,1062,2.0,794.0,794.0
0.124,17,2,166,1,75,0.0,47.0,47.0,1,91,0.0,63.0,63.0
0.004,6,10,2000,5,927,1.0,659.0,659.0,5,1073,1.0,805.0,805.0
1727.82,6,48,2957,31,1800,57594.0,35.0,35.0,17,1157,107984.0,31.0,31.0
0.008,6,10,2006,5,927,2.0,659.0,659.0,5,1079,2.0,811.0,811.0
0.011,6,10,1989,5,910,2.0,642.0,642.0,5,1079,2.0,811.0,811.0
0.012,6,10,1989,5,910,3.0,642.0,642.0,5,1079,3.0,811.0,811.0
0.016,6,13,3735,7,497,2.0,125.0,125.0,6,3238,3.0,1470.0,1459.0
0.005,17,2,170,1,65,0.0,37.0,37.0,1,105,0.0,77.0,77.0
0.005,6,13,3747,7,509,0.0,137.0,137.0,6,3238,1.0,1470.0,1459.0
1758.041,6,446,65220,252,35168,7004.0,613.0,197.0,194,30052,9108.0,453.0,142.0
0.008,6,10,1989,5,927,2.0,659.0,659.0,5,1062,2.0,794.0,794.0
0.004,6,10,1702,5,863,1.0,595.0,595.0,5,839,1.0,571.0,571.0
40.078,17,10,676,5,460,10018.0,104.0,64.0,5,216,10018.0,20.0,15.0
0.005,6,10,2000,5,927,1.0,659.0,659.0,5,1073,1.0,805.0,805.0
0.005,6,13,3747,7,509,0.0,137.0,137.0,6,3238,0.0,1470.0,1459.0
0.006,6,10,1689,5,839,1.0,571.0,571.0,5,850,1.0,582.0,582.0
0.005,6,10,2006,5,927,1.0,659.0,659.0,5,1079,1.0,811.0,811.0
0.069,6,10,1506,5,395,16.0,127.0,127.0,5,1111,15.0,843.0,843.0
0.005,6,10,2006,5,927,1.0,659.0,659.0,5,1079,1.0,811.0,811.0
0.004,6,10,2000,5,927,1.0,659.0,659.0,5,1073,1.0,805.0,805.0
300.297,6,25,7300,15,1357,21449.0,217.0,142.0,10,5943,26695.0,1679.0,902.0
309.141,17,20,1124,10,716,34334.0,48.0,43.0,10,408,34334.0,20.0,12.0
0.039,17,2,184,1,61,0.0,33.0,33.0,1,123,0.0,95.0,95.0
0.001,17,2,154,1,69,0.0,41.0,41.0,1,85,0.0,57.0,57.0
0.011,6,10,1677,5,827,2.0,559.0,559.0,5,850,2.0,582.0,582.0
0.084,6,10,1506,5,395,18.0,127.0,127.0,5,1111,18.0,843.0,843.0
368.673,6,22,2313,16,867,24578.0,195.0,195.0,6,1446,4636.0,419.0,398.0
40.073,17,10,676,5,460,10016.0,104.0,64.0,5,216,10017.0,20.0,15.0
40.075,17,10,676,5,460,10017.0,104.0,64.0,5,216,10017.0,20.0,15.0
0.006,17,2,252,1,62,0.0,34.0,34.0,1,190,0.0,162.0,162.0
0.001,17,2,180,1,66,0.0,38.0,38.0,1,114,0.0,86.0,86.0
40.063,17,10,676,5,460,10012.0,104.0,64.0,5,216,10014.0,20.0,15.0
0.005,6,10,1989,5,927,1.0,659.0,659.0,5,1062,1.0,794.0,794.0
0.123,6,10,1506,5,395,25.0,127.0,127.0,5,1111,27.0,843.0,843.0
0.006,17,2,214,1,75,0.0,47.0,47.0,1,139,0.0,111.0,111.0
40.07,17,10,676,5,460,10015.0,104.0,64.0,5,216,10015.0,20.0,15.0
0.005,6,10,2000,5,927,1.0,659.0,659.0,5,1073,1.0,805.0,805.0
0.005,17,2,148,1,60,0.0,32.0,32.0,1,88,0.0,60.0,60.0
0.022,6,10,1631,5,848,5.0,580.0,580.0,5,783,5.0,515.0,515.0
0.013,6,10,1990,5,911,3.0,643.0,643.0,5,1079,3.0,811.0,811.0
0.053,6,10,1506,5,395,12.0,127.0,127.0,5,1111,12.0,843.0,843.0
0.016,17,2,194,1,59,0.0,31.0,31.0,1,135,0.0,107.0,107.0
0.006,6,10,1547,5,764,1.0,496.0,496.0,5,783,1.0,515.0,515.0
0.068,6,10,1506,5,395,14.0,127.0,127.0,5,1111,15.0,843.0,843.0
15.034,17,40,20275,22,17085,714.0,1350.0,748.0,18,3190,882.0,1350.0,149.0
74.465,6,86,68974,41,43384,1861.0,2804.0,1718.0,45,25590,1688.0,2820.0,1291.0
0.039,17,2,170,1,65,0.0,37.0,37.0,1,105,0.0,77.0,77.0
0.006,6,10,1689,5,839,1.0,571.0,571.0,5,850,1.0,582.0,582.0
173.217,17,80,11466,40,2673,4441.0,44.0,38.0,40,8793,4441.0,261.0,191.0
40.059,17,10,676,5,460,10012.0,104.0,64.0,5,216,10013.0,20.0,15.0
15.073,17,15,9238,8,6902,2149.0,1350.0,834.0,7,2336,2507.0,1350.0,305.0
0.011,6,10,1972,5,910,2.0,642.0,642.0,5,1062,2.0,794.0,794.0
0.069,6,10,1506,5,395,13.0,127.0,127.0,5,1111,15.0,843.0,843.0
40.054,17,10,676,5,460,10012.0,104.0,64.0,5,216,10012.0,20.0,15.0
0.001,17,2,180,1,66,0.0,38.0,38.0,1,114,0.0,86.0,86.0
0.039,17,4,284,2,120,0.0,32.0,32.0,2,164,36.0,60.0,54.0
323.417,17,20,1124,10,716,35920.0,48.0,43.0,10,408,35920.0,20.0,12.0
0.016,6,10,1702,5,863,4.0,595.0,595.0,5,839,3.0,571.0,571.0
0.013,6,10,1990,5,911,3.0,643.0,643.0,5,1079,3.0,811.0,811.0
0.114,6,10,1506,5,395,19.0,127.0,127.0,5,1111,21.0,843.0,843.0
0.017,6,10,1989,5,910,4.0,642.0,642.0,5,1079,4.0,811.0,811.0
0.013,6,10,1990,5,911,3.0,643.0,643.0,5,1079,3.0,811.0,811.0
0.005,6,10,2007,5,928,1.0,660.0,660.0,5,1079,1.0,811.0,811.0
300.136,6,30,10104,17,1491,18758.0,260.0,149.0,13,8613,20011.0,1436.0,881.0
0.005,17,2,136,1,60,0.0,32.0,32.0,1,76,0.0,48.0,48.0
0.141,6,10,1506,5,395,26.0,127.0,127.0,5,1111,31.0,843.0,843.0
0.007,17,2,156,1,70,0.0,42.0,42.0,1,86,0.0,58.0,58.0
1778.557,17,139,43924,72,22752,25044.0,288.0,288.0,67,21172,26946.0,288.0,288.0
0.005,6,10,2006,5,927,1.0,659.0,659.0,5,1079,1.0,811.0,811.0
0.018,6,10,1989,5,910,4.0,642.0,642.0,5,1079,4.0,811.0,811.0
240.027,6,9,787,5,488,60006.0,232.0,232.0,4,299,80007.0,83.0,83.0
0.804,6,25,5459,12,1557,66.0,325.0,152.0,13,3902,58.0,1414.0,563.0
0.07,6,10,1506,5,395,15.0,127.0,127.0,5,1111,16.0,843.0,843.0
0.08,6,10,1506,5,395,18.0,127.0,127.0,5,1111,17.0,843.0,843.0
0.001,17,2,180,1,66,0.0,38.0,38.0,1,114,0.0,86.0,86.0
0.007,17,2,214,1,75,0.0,47.0,47.0,1,139,0.0,111.0,111.0
0.013,6,10,1972,5,910,3.0,642.0,642.0,5,1062,3.0,794.0,794.0
300.291,6,18,2262,10,736,33346.0,146.0,146.0,8,1526,42869.0,419.0,398.0
0.032,6,10,1989,5,910,7.0,642.0,642.0,5,1079,7.0,811.0,811.0
0.001,17,2,179,1,62,0.0,34.0,34.0,1,117,0.0,89.0,89.0
0.009,6,10,1779,5,928,2.0,660.0,660.0,5,851,2.0,583.0,583.0
0.009,6,10,1983,5,910,2.0,642.0,642.0,5,1073,2.0,805.0,805.0
240.112,6,31,9371,15,6877,17150.0,2002.0,677.0,16,2494,16007.0,580.0,206.0
0.001,17,2,180,1,66,0.0,38.0,38.0,1,114,0.0,86.0,86.0
0.006,6,10,1547,5,764,1.0,496.0,496.0,5,783,1.0,515.0,515.0
40.097,17,10,676,5,460,10019.0,104.0,64.0,5,216,10023.0,20.0,15.0
0.015,6,10,1989,5,910,3.0,642.0,642.0,5,1079,3.0,811.0,811.0
0.122,6,10,1506,5,395,29.0,127.0,127.0,5,1111,28.0,843.0,843.0
0.005,6,13,3747,7,509,0.0,137.0,137.0,6,3238,1.0,1470.0,1459.0
0.004,6,10,1989,5,927,1.0,659.0,659.0,5,1062,1.0,794.0,794.0
0.099,6,10,1506,5,395,21.0,127.0,127.0,5,1111,23.0,843.0,843.0
10.923,17,28,4422,14,1994,831.0,269.0,114.0,14,2428,831.0,587.0,145.0
0.012,6,10,1631,5,848,3.0,580.0,580.0,5,783,2.0,515.0,515.0
0.014,6,10,1972,5,910,3.0,642.0,642.0,5,1062,3.0,794.0,794.0
0.028,6,10,1983,5,910,6.0,642.0,642.0,5,1073,6.0,805.0,805.0
0.003,17,4,284,2,120,0.0,32.0,32.0,2,164,0.0,60.0,54.0
0.01,6,10,1972,5,910,2.0,642.0,642.0,5,1062,2.0,794.0,794.0
0.142,6,10,1506,5,395,33.0,127.0,127.0,5,1111,30.0,843.0,843.0
0.111,6,10,1506,5,395,20.0,127.0,127.0,5,1111,23.0,843.0,843.0
0.006,17,2,214,1,75,0.0,47.0,47.0,1,139,0.0,111.0,111.0
0.017,6,10,1989,5,910,4.0,642.0,642.0,5,1079,4.0,811.0,811.0
0.006,6,10,1547,5,764,1.0,496.0,496.0,5,783,1.0,515.0,515.0
0.005,6,10,2006,5,927,1.0,659.0,659.0,5,1079,1.0,811.0,811.0
0.005,17,2,302,1,65,0.0,37.0,37.0,1,237,0.0,209.0,209.0
0.133,6,10,1506,5,395,30.0,127.0,127.0,5,1111,30.0,843.0,843.0
0.003,17,2,148,1,60,0.0,32.0,32.0,1,88,0.0,60.0,60.0
0.106,6,10,1506,5,395,24.0,127.0,127.0,5,1111,23.0,843.0,843.0
0.005,6,10,2006,5,927,1.0,659.0,659.0,5,1079,1.0,811.0,811.0
0.009,6,10,1989,5,910,2.0,642.0,642.0,5,1079,2.0,811.0,811.0
0.011,6,10,1983,5,910,2.0,642.0,642.0,5,1073,2.0,805.0,805.0
0.017,6,10,1989,5,910,4.0,642.0,642.0,5,1079,4.0,811.0,811.0
1.041,6,12,3134,6,2099,156.0,1328.0,923.0,6,1035,157.0,791.0,791.0
0.004,17,2,186,1,61,0.0,33.0,33.0,1,125,0.0,97.0,97.0
0.08,6,10,1506,5,395,17.0,127.0,127.0,5,1111,16.0,843.0,843.0
0.185,17,4,352,2,130,146.0,37.0,37.0,2,222,145.0,89.0,83.0
40.06,17,10,676,5,460,10014.0,104.0,64.0,5,216,10014.0,20.0,15.0
0.013,6,10,1989,5,910,3.0,642.0,642.0,5,1079,3.0,811.0,811.0
0.006,6,10,1689,5,839,1.0,571.0,571.0,5,850,1.0,582.0,582.0
0.073,6,10,1506,5,395,16.0,127.0,127.0,5,1111,15.0,843.0,843.0
0.059,17,2,136,1,60,0.0,32.0,32.0,1,76,0.0,48.0,48.0
0.082,6,10,1506,5,395,16.0,127.0,127.0,5,1111,18.0,843.0,843.0
0.021,6,10,1972,5,910,5.0,642.0,642.0,5,1062,5.0,794.0,794.0
0.001,17,2,180,1,66,0.0,38.0,38.0,1,114,0.0,86.0,86.0
0.005,6,10,2000,5,927,1.0,659.0,659.0,5,1073,1.0,805.0,805.0
0.004,17,2,136,1,60,0.0,32.0,32.0,1,76,0.0,48.0,48.0
0.011,6,10,1989,5,910,2.0,642.0,642.0,5,1079,2.0,811.0,811.0
172.337,17,90,12691,45,3001,3916.0,44.0,38.0,45,9690,3916.0,239.0,187.0
0.005,6,10,2006,5,927,1.0,659.0,659.0,5,1079,1.0,811.0,811.0
0.082,6,10,1506,5,395,18.0,127.0,127.0,5,1111,17.0,843.0,843.0
0.005,6,10,1854,5,889,1.0,621.0,621.0,5,965,1.0,697.0,697.0
0.003,6,10,1702,5,863,0.0,595.0,595.0,5,839,0.0,571.0,571.0
0.006,17,2,136,1,60,0.0,32.0,32.0,1,76,0.0,48.0,48.0
0.005,17,2,178,1,81,0.0,53.0,53.0,1,97,0.0,69.0,69.0
0.065,17,2,152,1,76,0.0,48.0,48.0,1,76,0.0,48.0,48.0
0.009,6,10,1643,5,860,2.0,592.0,592.0,5,783,2.0,515.0,515.0
0.001,17,2,180,1,66,0.0,38.0,38.0,1,114,0.0,86.0,86.0
0.005,6,10,2007,5,928,1.0,660.0,660.0,5,1079,1.0,811.0,811.0
0.013,6,10,1990,5,911,3.0,643.0,643.0,5,1079,3.0,811.0,811.0
1729.236,6,60,4400,40,2740,44339.0,33.0,33.0,20,1660,91003.0,31.0,31.0
0.013,6,10,1989,5,910,3.0,642.0,642.0,5,1079,3.0,811.0,811.0
58.448,6,37,10002,19,4484,502.0,1360.0,738.0,18,5518,3427.0,2667.0,435.0
0.001,17,2,142,1,63,0.0,35.0,35.0,1,79,0.0,51.0,51.0
0.008,6,10,1689,5,839,2.0,571.0,571.0,5,850,2.0,582.0,582.0
15.07,17,14,9190,8,6902,2148.0,1350.0,834.0,6,2288,3008.0,1350.0,353.0
0.13,6,10,1506,5,395,30.0,127.0,127.0,5,1111,22.0,843.0,843.0
0.096,6,10,1506,5,395,17.0,127.0,127.0,5,1111,18.0,843.0,843.0
0.039,17,2,170,1,65,0.0,37.0,37.0,1,105,0.0,77.0,77.0
40.093,17,10,676,5,460,10019.0,104.0,64.0,5,216,10022.0,20.0,15.0
0.004,6,10,2006,5,927,1.0,659.0,659.0,5,1079,1.0,811.0,811.0
0.005,17,4,284,2,120,1.0,32.0,32.0,2,164,1.0,60.0,54.0
0.005,6,10,2006,5,927,1.0,659.0,659.0,5,1079,1.0,811.0,811.0
308.39,17,20,1124,10,716,34250.0,48.0,43.0,10,408,34250.0,20.0,12.0
0.005,6,14,3736,7,446,0.0,74.0,74.0,7,3290,0.0,1448.0,972.0
0.004,6,10,1989,5,927,1.0,659.0,659.0,5,1062,1.0,794.0,794.0
0.005,6,10,2000,5,927,1.0,659.0,659.0,5,1073,1.0,805.0,805.0
0.026,17,2,186,1,61,0.0,33.0,33.0,1,125,0.0,97.0,97.0
0.005,6,10,2006,5,927,1.0,659.0,659.0,5,1079,1.0,811.0,811.0
0.01,6,10,1972,5,910,2.0,642.0,642.0,5,1062,2.0,794.0,794.0
0.127,6,10,1506,5,395,28.0,127.0,127.0,5,1111,27.0,843.0,843.0
308.331,17,20,1124,10,716,34245.0,48.0,43.0,10,408,34245.0,20.0,12.0
0.074,6,10,1506,5,395,16.0,127.0,127.0,5,1111,16.0,843.0,843.0
0.005,6,10,2006,5,927,1.0,659.0,659.0,5,1079,1.0,811.0,811.0
0.006,6,10,1547,5,764,1.0,496.0,496.0,5,783,1.0,515.0,515.0
0.021,6,10,1972,5,910,5.0,642.0,642.0,5,1062,5.0,794.0,794.0
0.014,6,10,1983,5,910,3.0,642.0,642.0,5,1073,3.0,805.0,805.0
0.004,6,10,2007,5,928,1.0,660.0,660.0,5,1079,1.0,811.0,811.0
0.005,17,2,180,1,66,0.0,38.0,38.0,1,114,0.0,86.0,86.0
0.04,17,2,412,1,61,0.0,33.0,33.0,1,351,0.0,323.0,323.0
0.045,6,10,1983,5,910,11.0,642.0,642.0,5,1073,11.0,805.0,805.0
0.005,6,10,1689,5,839,1.0,571.0,571.0,5,850,1.0,582.0,582.0
0.009,6,10,1989,5,910,2.0,642.0,642.0,5,1079,2.0,811.0,811.0
0.039,17,2,152,1,76,0.0,48.0,48.0,1,76,0.0,48.0,48.0
0.074,6,10,1506,5,395,16.0,127.0,127.0,5,1111,14.0,843.0,843.0
0.015,6,10,1990,5,911,3.0,643.0,643.0,5,1079,3.0,811.0,811.0
0.003,17,2,136,1,60,0.0,32.0,32.0,1,76,0.0,48.0,48.0
0.012,6,10,1989,5,910,2.0,642.0,642.0,5,1079,2.0,811.0,811.0
0.009,6,10,1983,5,910,2.0,642.0,642.0,5,1073,2.0,805.0,805.0
0.006,17,2,144,1,64,0.0,36.0,36.0,1,80,0.0,52.0,52.0
0.067,17,8,3613,4,1874,22.0,1350.0,440.0,4,1739,11.0,1350.0,406.0
0.005,17,2,169,1,62,0.0,34.0,34.0,1,107,0.0,79.0,79.0
356.574,6,21,1795,16,1030,23771.0,190.0,190.0,5,765,60003.0,464.0,248.0
120.12,58,5,360,4,288,40040.0,24.0,24.0,1,72,0.0,24.0,24.0
10.781,17,28,4419,14,1995,820.0,270.0,114.0,14,2424,820.0,587.0,145.0
0.003,17,2,148,1,60,0.0,32.0,32.0,1,88,0.0,60.0,60.0
0.004,6,10,1779,5,928,1.0,660.0,660.0,5,851,1.0,583.0,583.0
0.678,6,22,5072,11,1250,58.0,325.0,133.0,11,3822,57.0,1414.0,563.0
0.007,17,2,299,1,65,0.0,37.0,37.0,1,234,0.0,206.0,206.0
0.003,17,2,136,1,60,0.0,32.0,32.0,1,76,0.0,48.0,48.0
0.005,6,10,2007,5,928,1.0,660.0,660.0,5,1079,1.0,811.0,811.0
0.004,6,10,2000,5,927,1.0,659.0,659.0,5,1073,1.0,805.0,805.0
0.011,6,10,1972,5,910,2.0,642.0,642.0,5,1062,2.0,794.0,794.0
0.001,17,2,180,1,66,0.0,38.0,38.0,1,114,0.0,86.0,86.0
0.013,6,10,1972,5,910,3.0,642.0,642.0,5,1062,3.0,794.0,794.0
0.004,6,10,1702,5,863,1.0,595.0,595.0,5,839,1.0,571.0,571.0
0.001,17,2,180,1,66,0.0,38.0,38.0,1,114,0.0,86.0,86.0
0.101,6,10,1506,5,395,22.0,127.0,127.0,5,1111,25.0,843.0,843.0
0.007,6,10,1989,5,910,1.0,642.0,642.0,5,1079,1.0,811.0,811.0
0.005,6,10,1689,5,839,1.0,571.0,571.0,5,850,1.0,582.0,582.0
0.02,6,10,1990,5,911,5.0,643.0,643.0,5,1079,5.0,811.0,811.0
0.005,6,10,2006,5,927,1.0,659.0,659.0,5,1079,1.0,811.0,811.0
0.006,6,10,1547,5,764,1.0,496.0,496.0,5,783,1.0,515.0,515.0
0.001,17,2,268,1,70,0.0,42.0,42.0,1,198,0.0,170.0,170.0
0.012,6,10,1972,5,910,2.0,642.0,642.0,5,1062,3.0,794.0,794.0
0.072,17,4,364,2,160,0.0,52.0,52.0,2,204,0.0,80.0,74.0
0.005,17,2,136,1,60,0.0,32.0,32.0,1,76,0.0,48.0,48.0
0.214,6,4,493,2,321,214.0,241.0,241.0,2,172,0.0,92.0,92.0
0.13,6,10,1506,5,395,28.0,127.0,127.0,5,1111,27.0,843.0,843.0
40.066,17,10,676,5,460,10015.0,104.0,64.0,5,216,10015.0,20.0,15.0
0.014,6,10,1990,5,911,3.0,643.0,643.0,5,1079,3.0,811.0,811.0
0.012,6,10,1990,5,911,3.0,643.0,643.0,5,1079,2.0,811.0,811.0
0.116,6,10,1506,5,395,28.0,127.0,127.0,5,1111,27.0,843.0,843.0
0.004,6,10,1779,5,928,1.0,660.0,660.0,5,851,1.0,583.0,583.0
60.017,6,10,1690,6,1308,12003.0,494.0,494.0,4,382,20004.0,83.0,83.0
0.006,6,10,1643,5,860,1.0,592.0,592.0,5,783,1.0,515.0,515.0
0.006,6,10,1547,5,764,1.0,496.0,496.0,5,783,1.0,515.0,515.0
0.009,6,10,1972,5,910,2.0,642.0,642.0,5,1062,2.0,794.0,794.0
0.015,6,10,1990,5,911,3.0,643.0,643.0,5,1079,3.0,811.0,811.0
0.005,6,10,1547,5,764,1.0,496.0,496.0,5,783,1.0,515.0,515.0
0.092,6,10,1506,5,395,22.0,127.0,127.0,5,1111,20.0,843.0,843.0
0.001,17,2,136,1,60,0.0,32.0,32.0,1,76,0.0,48.0,48.0
0.006,6,10,1547,5,764,1.0,496.0,496.0,5,783,1.0,515.0,515.0
0.003,17,2,136,1,60,0.0,32.0,32.0,1,76,0.0,48.0,48.0
0.07,6,10,1506,5,395,15.0,127.0,127.0,5,1111,13.0,843.0,843.0
0.005,6,13,3690,7,452,0.0,80.0,80.0,6,3238,1.0,1470.0,1459.0
0.004,17,2,136,1,60,0.0,32.0,32.0,1,76,0.0,48.0,48.0
0.004,6,10,1989,5,927,1.0,659.0,659.0,5,1062,1.0,794.0,794.0
0.009,6,14,3787,7,497,1.0,125.0,125.0,7,3290,1.0,1448.0,972.0
351.987,6,20,2210,6,1308,12003.0,494.0,494.0,14,902,27075.0,83.0,83.0
57.895,6,49,18669,25,12866,377.0,2720.0,1313.0,24,5803,2509.0,2667.0,402.0
0.004,6,10,1702,5,863,1.0,595.0,595.0,5,839,0.0,571.0,571.0
0.006,6,10,1547,5,764,1.0,496.0,496.0,5,783,1.0,515.0,515.0
0.001,17,2,180,1,66,0.0,38.0,38.0,1,114,0.0,86.0,86.0
0.016,6,10,1983,5,910,4.0,642.0,642.0,5,1073,3.0,805.0,805.0
309.102,17,20,1124,10,716,34330.0,48.0,43.0,10,408,34330.0,20.0,12.0
171.365,17,90,12913,45,3033,3894.0,44.0,39.0,45,9880,3894.0,239.0,191.0
309.205,17,20,1124,10,716,34343.0,48.0,43.0,10,408,34344.0,20.0,12.0
0.018,6,10,1989,5,910,4.0,642.0,642.0,5,1079,4.0,811.0,811.0
0.04,17,2,152,1,76,0.0,48.0,48.0,1,76,0.0,48.0,48.0
0.012,6,10,1762,5,911,2.0,643.0,643.0,5,851,3.0,583.0,583.0
0.114,6,10,1506,5,395,24.0,127.0,127.0,5,1111,24.0,843.0,843.0
0.013,6,10,1983,5,910,3.0,642.0,642.0,5,1073,3.0,805.0,805.0
0.01,6,14,3787,7,497,1.0,125.0,125.0,7,3290,1.0,1448.0,972.0
240.09,6,31,8821,15,6527,17149.0,1650.0,639.0,16,2294,16005.0,580.0,181.0
0.009,6,10,1972,5,910,2.0,642.0,642.0,5,1062,2.0,794.0,794.0
0.005,6,10,2006,5,927,1.0,659.0,659.0,5,1079,1.0,811.0,811.0
0.005,6,10,1689,5,839,1.0,571.0,571.0,5,850,1.0,582.0,582.0
0.005,17,2,169,1,62,0.0,34.0,34.0,1,107,0.0,79.0,79.0
0.005,6,10,2000,5,927,1.0,659.0,659.0,5,1073,1.0,805.0,805.0
40.068,17,10,676,5,460,10016.0,104.0,64.0,5,216,10016.0,20.0,15.0
0.005,6,10,1989,5,927,1.0,659.0,659.0,5,1062,1.0,794.0,794.0
0.009,6,10,1989,5,910,2.0,642.0,642.0,5,1079,2.0,811.0,811.0
0.007,6,10,1972,5,910,1.0,642.0,642.0,5,1062,1.0,794.0,794.0
240.023,6,9,787,5,488,60005.0,232.0,232.0,4,299,80006.0,83.0,83.0
0.039,6,10,1990,5,911,9.0,643.0,643.0,5,1079,9.0,811.0,811.0
0.005,6,10,2006,5,927,1.0,659.0,659.0,5,1079,1.0,811.0,811.0
0.004,17,4,284,2,120,0.0,32.0,32.0,2,164,0.0,60.0,54.0
15.08,17,15,9238,8,6902,2149.0,1350.0,834.0,7,2336,2507.0,1350.0,305.0
0.005,6,13,3747,7,509,0.0,137.0,137.0,6,3238,0.0,1470.0,1459.0
40.061,17,10,676,5,460,10014.0,104.0,64.0,5,216,10014.0,20.0,15.0
0.099,6,10,1506,5,395,21.0,127.0,127.0,5,1111,22.0,843.0,843.0
0.085,6,10,1506,5,395,17.0,127.0,127.0,5,1111,20.0,843.0,843.0
0.005,6,10,1779,5,928,1.0,660.0,660.0,5,851,1.0,583.0,583.0
0.008,6,10,2006,5,927,1.0,659.0,659.0,5,1079,2.0,811.0,811.0
0.011,6,10,1972,5,910,2.0,642.0,642.0,5,1062,2.0,794.0,794.0
40.071,17,10,676,5,460,10014.0,104.0,64.0,5,216,10016.0,20.0,15.0
0.007,6,10,1983,5,910,1.0,642.0,642.0,5,1073,1.0,805.0,805.0
0.005,6,10,1643,5,860,1.0,592.0,592.0,5,783,1.0,515.0,515.0
10.908,17,26,4099,13,1823,900.0,270.0,112.0,13,2276,900.0,587.0,147.0
0.001,17,2,166,1,75,0.0,47.0,47.0,1,91,0.0,63.0,63.0
0.013,6,10,1631,5,848,3.0,580.0,580.0,5,783,3.0,515.0,515.0
0.087,6,10,1506,5,395,20.0,127.0,127.0,5,1111,17.0,843.0,843.0
0.015,17,2,198,1,91,0.0,63.0,63.0,1,107,0.0,79.0,79.0
0.006,6,10,1547,5,764,1.0,496.0,496.0,5,783,1.0,515.0,515.0
0.005,6,10,2007,5,928,1.0,660.0,660.0,5,1079,1.0,811.0,811.0
308.775,17,18,1044,9,684,38582.0,48.0,48.0,9,360,38584.0,12.0,12.0
40.062,17,10,676,5,460,10014.0,104.0,64.0,5,216,10014.0,20.0,15.0
0.014,6,10,1972,5,910,3.0,642.0,642.0,5,1062,3.0,794.0,794.0
0.01,6,10,1677,5,827,2.0,559.0,559.0,5,850,2.0,582.0,582.0
0.09,6,10,1506,5,395,20.0,127.0,127.0,5,1111,20.0,843.0,843.0
0.004,17,2,160,1,72,0.0,44.0,44.0,1,88,0.0,60.0,60.0
0.082,6,10,1506,5,395,18.0,127.0,127.0,5,1111,16.0,843.0,843.0
0.005,6,10,2000,5,927,1.0,659.0,659.0,5,1073,1.0,805.0,805.0
0.004,17,2,136,1,60,0.0,32.0,32.0,1,76,0.0,48.0,48.0
0.004,6,10,2006,5,927,1.0,659.0,659.0,5,1079,1.0,811.0,811.0
0.005,6,10,2007,5,928,1.0,660.0,660.0,5,1079,1.0,811.0,811.0
0.118,6,10,1506,5,395,24.0,127.0,127.0,5,1111,26.0,843.0,843.0
240.094,6,16,4482,9,963,30011.0,238.0,166.0,7,3519,40015.0,1402.0,786.0
0.005,6,10,1989,5,927,1.0,659.0,659.0,5,1062,1.0,794.0,794.0
0.013,6,10,1989,5,910,3.0,642.0,642.0,5,1079,3.0,811.0,811.0
0.006,17,2,164,1,74,0.0,46.0,46.0,1,90,0.0,62.0,62.0
0.005,17,2,140,1,62,0.0,34.0,34.0,1,78,0.0,50.0,50.0
0.107,6,10,1506,5,395,23.0,127.0,127.0,5,1111,24.0,843.0,843.0
0.058,6,10,1990,5,911,14.0,643.0,643.0,5,1079,14.0,811.0,811.0
271.18,6,22,4899,11,2310,27117.0,967.0,432.0,11,2589,27117.0,1162.0,404.0
0.005,6,10,1643,5,860,1.0,592.0,592.0,5,783,1.0,515.0,515.0
0.362,17,42,20244,22,17093,17.0,1350.0,748.0,20,3151,15.0,1350.0,129.0
0.004,17,2,136,1,60,0.0,32.0,32.0,1,76,0.0,48.0,48.0
0.009,6,10,1983,5,910,2.0,642.0,642.0,5,1073,2.0,805.0,805.0
0.275,17,46,29368,27,26155,10.0,1350.0,940.0,19,3213,12.0,1350.0,141.0
0.073,6,10,1506,5,395,15.0,127.0,127.0,5,1111,16.0,843.0,843.0
0.001,17,2,180,1,66,0.0,38.0,38.0,1,114,0.0,86.0,86.0
0.006,6,10,1854,5,889,1.0,621.0,621.0,5,965,1.0,697.0,697.0
10.754,17,28,4423,14,1994,818.0,269.0,114.0,14,2429,818.0,588.0,145.0
0.01,6,10,1983,5,910,2.0,642.0,642.0,5,1073,2.0,805.0,805.0
0.087,6,10,1506,5,395,21.0,127.0,127.0,5,1111,19.0,843.0,843.0
0.011,6,10,1989,5,910,2.0,642.0,642.0,5,1079,2.0,811.0,811.0
0.07,17,8,3613,4,1874,23.0,1350.0,440.0,4,1739,12.0,1350.0,406.0
40.056,17,10,676,5,460,10013.0,104.0,64.0,5,216,10013.0,20.0,15.0
0.124,6,10,1506,5,395,28.0,127.0,127.0,5,1111,17.0,843.0,843.0
0.01,6,10,1989,5,910,2.0,642.0,642.0,5,1079,2.0,811.0,811.0
0.005,6,13,3747,7,509,0.0,137.0,137.0,6,3238,0.0,1470.0,1459.0
0.074,6,45,14097,25,2617,3.0,517.0,146.0,20,11480,3.0,1402.0,745.0
1792.561,6,485,98685,244,87508,7376.0,421.0,366.0,241,11177,7468.0,53.0,53.0
0.005,6,10,1774,5,923,1.0,655.0,655.0,5,851,1.0,583.0,583.0
0.232,17,43,24424,24,21182,10.0,1350.0,854.0,19,3242,9.0,1350.0,142.0
1772.62,17,120,11460,60,5460,30044.0,63.0,63.0,60,6000,30044.0,72.0,72.0
0.013,6,10,1631,5,848,3.0,580.0,580.0,5,783,3.0,515.0,515.0
31.396,6,72,29091,39,21783,826.0,2023.0,1187.0,33,7308,300.0,2667.0,271.0
0.005,6,10,2006,5,927,1.0,659.0,659.0,5,1079,1.0,811.0,811.0
0.004,17,2,136,1,60,0.0,32.0,32.0,1,76,0.0,48.0,48.0
0.004,6,10,2006,5,927,1.0,659.0,659.0,5,1079,1.0,811.0,811.0
0.004,17,4,284,2,120,0.0,32.0,32.0,2,164,1.0,60.0,54.0
0.012,6,10,1989,5,910,2.0,642.0,642.0,5,1079,3.0,811.0,811.0
0.097,6,10,1506,5,395,21.0,127.0,127.0,5,1111,21.0,843.0,843.0
0.038,17,2,182,1,65,0.0,37.0,37.0,1,117,0.0,89.0,89.0
0.013,6,10,1989,5,910,3.0,642.0,642.0,5,1079,3.0,811.0,811.0
0.001,17,2,180,1,66,0.0,38.0,38.0,1,114,0.0,86.0,86.0
0.069,6,10,1506,5,395,16.0,127.0,127.0,5,1111,14.0,843.0,843.0
0.065,6,10,1990,5,911,16.0,643.0,643.0,5,1079,16.0,811.0,811.0
0.003,17,2,136,1,60,0.0,32.0,32.0,1,76,0.0,48.0,48.0
0.001,17,2,180,1,65,0.0,37.0,37.0,1,115,0.0,87.0,87.0
0.004,6,10,1774,5,923,1.0,655.0,655.0,5,851,1.0,583.0,583.0
0.004,6,10,2006,5,927,1.0,659.0,659.0,5,1079,1.0,811.0,811.0
0.02,6,10,1762,5,911,5.0,643.0,643.0,5,851,5.0,583.0,583.0
40.06,17,10,676,5,460,10013.0,104.0,64.0,5,216,10014.0,20.0,15.0
0.012,6,10,1677,5,827,3.0,559.0,559.0,5,850,2.0,582.0,582.0
0.004,6,10,1702,5,863,1.0,595.0,595.0,5,839,0.0,571.0,571.0
0.092,6,10,1506,5,395,20.0,127.0,127.0,5,1111,19.0,843.0,843.0
33.889,6,35,9629,17,4111,553.0,1686.0,849.0,18,5518,1983.0,2667.0,435.0
0.09,6,10,1506,5,395,20.0,127.0,127.0,5,1111,19.0,843.0,843.0
0.011,6,10,1972,5,910,2.0,642.0,642.0,5,1062,2.0,794.0,794.0
0.071,17,2,166,1,75,0.0,47.0,47.0,1,91,0.0,63.0,63.0
61.153,6,22,9233,11,1575,74.0,794.0,367.0,11,7658,6102.0,1360.0,1029.0
0.006,6,10,1547,5,764,1.0,496.0,496.0,5,783,1.0,515.0,515.0
0.015,6,10,1983,5,910,3.0,642.0,642.0,5,1073,3.0,805.0,805.0
0.001,17,2,180,1,66,0.0,38.0,38.0,1,114,0.0,86.0,86.0
0.083,6,10,1506,5,395,18.0,127.0,127.0,5,1111,17.0,843.0,843.0
0.006,6,10,1689,5,839,1.0,571.0,571.0,5,850,1.0,582.0,582.0
0.013,6,10,1990,5,911,3.0,643.0,643.0,5,1079,3.0,811.0,811.0
0.011,6,10,1972,5,910,2.0,642.0,642.0,5,1062,2.0,794.0,794.0
0.013,6,10,1989,5,910,3.0,642.0,642.0,5,1079,3.0,811.0,811.0
0.006,17,2,170,1,65,0.0,37.0,37.0,1,105,0.0,77.0,77.0
0.005,6,10,2006,5,927,1.0,659.0,659.0,5,1079,1.0,811.0,811.0
0.009,6,10,1779,5,928,2.0,660.0,660.0,5,851,2.0,583.0,583.0
0.013,6,10,1983,5,910,3.0,642.0,642.0,5,1073,3.0,805.0,805.0
0.005,6,10,2006,5,927,1.0,659.0,659.0,5,1079,1.0,811.0,811.0
240.086,6,31,9230,15,6759,17149.0,1885.0,664.0,16,2471,16005.0,580.0,203.0
0.002,17,2,180,1,66,0.0,38.0,38.0,1,114,0.0,86.0,86.0
0.091,6,10,1506,5,395,19.0,127.0,127.0,5,1111,21.0,843.0,843.0
0.097,6,10,1506,5,395,20.0,127.0,127.0,5,1111,23.0,843.0,843.0
168.122,17,72,10180,36,2386,4803.0,44.0,38.0,36,7794,4803.0,239.0,188.0
0.006,6,10,2000,5,927,1.0,659.0,659.0,5,1073,1.0,805.0,805.0
0.006,6,10,1547,5,764,1.0,496.0,496.0,5,783,1.0,515.0,515.0
0.009,6,10,1989,5,910,2.0,642.0,642.0,5,1079,2.0,811.0,811.0
0.014,6,10,1972,5,910,3.0,642.0,642.0,5,1062,3.0,794.0,794.0
0.016,6,10,1972,5,910,4.0,642.0,642.0,5,1062,3.0,794.0,794.0
0.005,6,10,2006,5,927,1.0,659.0,659.0,5,1079,1.0,811.0,811.0
0.004,6,10,2007,5,928,1.0,660.0,660.0,5,1079,1.0,811.0,811.0
0.004,17,2,136,1,60,0.0,32.0,32.0,1,76,0.0,48.0,48.0
0.001,17,2,180,1,66,0.0,38.0,38.0,1,114,0.0,86.0,86.0
40.069,17,10,676,5,460,10016.0,104.0,64.0,5,216,10016.0,20.0,15.0
0.106,6,10,1506,5,395,25.0,127.0,127.0,5,1111,22.0,843.0,843.0
0.012,6,14,3787,7,497,2.0,125.0,125.0,7,3290,1.0,1448.0,972.0
0.004,6,10,2006,5,927,1.0,659.0,659.0,5,1079,1.0,811.0,811.0
0.005,6,10,1689,5,839,1.0,571.0,571.0,5,850,1.0,582.0,582.0
0.005,17,2,144,1,64,0.0,36.0,36.0,1,80,0.0,52.0,52.0
0.005,6,10,1989,5,927,1.0,659.0,659.0,5,1062,1.0,794.0,794.0
0.008,6,10,1983,5,910,2.0,642.0,642.0,5,1073,2.0,805.0,805.0
0.053,17,2,152,1,76,0.0,48.0,48.0,1,76,0.0,48.0,48.0
0.005,6,10,2000,5,927,1.0,659.0,659.0,5,1073,1.0,805.0,805.0
0.004,17,2,136,1,60,0.0,32.0,32.0,1,76,0.0,48.0,48.0
0.005,17,2,157,1,59,0.0,31.0,31.0,1,98,0.0,70.0,70.0
0.001,17,2,180,1,66,0.0,38.0,38.0,1,114,0.0,86.0,86.0
0.007,6,10,1547,5,764,1.0,496.0,496.0,5,783,1.0,515.0,515.0
40.062,17,10,676,5,460,10014.0,104.0,64.0,5,216,10014.0,20.0,15.0
0.005,6,10,1989,5,927,1.0,659.0,659.0,5,1062,1.0,794.0,794.0
0.11,6,10,1506,5,395,24.0,127.0,127.0,5,1111,21.0,843.0,843.0
0.082,6,10,1506,5,395,16.0,127.0,127.0,5,1111,18.0,843.0,843.0
0.006,17,2,179,1,71,0.0,43.0,43.0,1,108,0.0,80.0,80.0
0.013,6,10,1972,5,910,3.0,642.0,642.0,5,1062,3.0,794.0,794.0
0.004,17,2,136,1,60,0.0,32.0,32.0,1,76,0.0,48.0,48.0
0.01,6,10,1983,5,910,2.0,642.0,642.0,5,1073,2.0,805.0,805.0
0.07,6,10,1506,5,395,16.0,127.0,127.0,5,1111,15.0,843.0,843.0
0.151,6,10,1506,5,395,34.0,127.0,127.0,5,1111,31.0,843.0,843.0
0.012,6,10,1990,5,911,3.0,643.0,643.0,5,1079,3.0,811.0,811.0
0.009,6,10,1677,5,827,2.0,559.0,559.0,5,850,2.0,582.0,582.0
0.07,6,10,1506,5,395,14.0,127.0,127.0,5,1111,15.0,843.0,843.0
0.038,17,2,170,1,65,0.0,37.0,37.0,1,105,0.0,77.0,77.0
0.086,6,10,1506,5,395,17.0,127.0,127.0,5,1111,18.0,843.0,843.0
0.006,17,4,284,2,120,1.0,32.0,32.0,2,164,1.0,60.0,54.0
0.014,6,10,1989,5,910,3.0,642.0,642.0,5,1079,3.0,811.0,811.0
0.006,6,10,1547,5,764,1.0,496.0,496.0,5,783,1.0,515.0,515.0
0.006,6,10,1643,5,860,1.0,592.0,592.0,5,783,1.0,515.0,515.0
0.006,6,10,1689,5,839,1.0,571.0,571.0,5,850,1.0,582.0,582.0
0.01,6,13,3735,7,497,1.0,125.0,125.0,6,3238,1.0,1470.0,1459.0
0.123,6,10,1506,5,395,26.0,127.0,127.0,5,1111,25.0,843.0,843.0
0.017,6,10,1983,5,910,4.0,642.0,642.0,5,1073,4.0,805.0,805.0
1.016,6,13,3930,7,2139,127.0,1328.0,923.0,6,1791,152.0,1539.0,1539.0
0.005,6,10,1689,5,839,1.0,571.0,571.0,5,850,1.0,582.0,582.0
0.118,6,10,1506,5,395,26.0,127.0,127.0,5,1111,27.0,843.0,843.0
0.011,6,10,1983,5,910,2.0,642.0,642.0,5,1073,2.0,805.0,805.0
0.013,6,10,1989,5,910,3.0,642.0,642.0,5,1079,3.0,811.0,811.0
0.01,6,10,1989,5,910,2.0,642.0,642.0,5,1079,2.0,811.0,811.0
0.039,17,2,136,1,60,0.0,32.0,32.0,1,76,0.0,48.0,48.0
1730.415,6,48,2957,31,1800,57680.0,35.0,35.0,17,1157,108146.0,31.0,31.0
308.435,17,20,1124,10,716,34256.0,48.0,43.0,10,408,34256.0,20.0,12.0
0.072,17,2,412,1,61,0.0,33.0,33.0,1,351,0.0,323.0,323.0
0.006,6,10,1547,5,764,1.0,496.0,496.0,5,783,1.0,515.0,515.0
0.004,17,2,148,1,60,0.0,32.0,32.0,1,88,0.0,60.0,60.0
0.009,6,10,1762,5,911,2.0,643.0,643.0,5,851,2.0,583.0,583.0
0.006,17,2,209,1,64,0.0,36.0,36.0,1,145,0.0,117.0,117.0
0.005,6,10,1643,5,860,1.0,592.0,592.0,5,783,1.0,515.0,515.0
0.001,17,2,179,1,62,0.0,34.0,34.0,1,117,0.0,89.0,89.0
0.024,6,10,1972,5,910,5.0,642.0,642.0,5,1062,6.0,794.0,794.0
0.009,17,2,170,1,65,0.0,37.0,37.0,1,105,0.0,77.0,77.0
0.013,17,2,152,1,56,0.0,28.0,28.0,1,96,0.0,68.0,68.0
0.004,6,10,2007,5,928,1.0,660.0,660.0,5,1079,1.0,811.0,811.0
0.078,6,10,1506,5,395,17.0,127.0,127.0,5,1111,17.0,843.0,843.0
0.005,6,10,2006,5,927,1.0,659.0,659.0,5,1079,1.0,811.0,811.0
40.08,17,10,676,5,460,10017.0,104.0,64.0,5,216,10019.0,20.0,15.0
15.071,17,14,9190,8,6902,2149.0,1350.0,834.0,6,2288,3008.0,1350.0,353.0
0.001,17,2,180,1,66,0.0,38.0,38.0,1,114,0.0,86.0,86.0
0.005,6,10,2000,5,927,1.0,659.0,659.0,5,1073,1.0,805.0,805.0
123.357,6,27,6001,13,4636,10279.0,494.0,494.0,14,1365,9467.0,83.0,83.0
0.073,6,10,1506,5,395,16.0,127.0,127.0,5,1111,14.0,843.0,843.0
0.009,6,10,1631,5,848,2.0,580.0,580.0,5,783,2.0,515.0,515.0
0.005,6,10,1989,5,927,1.0,659.0,659.0,5,1062,1.0,794.0,794.0
0.004,6,10,1702,5,863,1.0,595.0,595.0,5,839,0.0,571.0,571.0
0.005,17,2,230,1,68,0.0,40.0,40.0,1,162,0.0,134.0,134.0
15.075,17,15,9238,8,6902,2149.0,1350.0,834.0,7,2336,2507.0,1350.0,305.0
0.009,6,13,3735,7,497,1.0,125.0,125.0,6,3238,1.0,1470.0,1459.0
15.074,17,15,9239,8,6902,2149.0,1350.0,834.0,7,2337,2507.0,1350.0,305.0
0.003,17,2,136,1,60,0.0,32.0,32.0,1,76,0.0,48.0,48.0
40.054,17,10,676,5,460,10012.0,104.0,64.0,5,216,10012.0,20.0,15.0
40.054,17,10,676,5,460,10012.0,104.0,64.0,5,216,10012.0,20.0,15.0
0.004,17,2,169,1,62,0.0,34.0,34.0,1,107,0.0,79.0,79.0
0.009,6,12,1926,6,1189,1.0,659.0,434.0,6,737,1.0,417.0,417.0
0.005,6,14,3742,7,452,0.0,80.0,80.0,7,3290,0.0,1448.0,972.0
0.005,6,10,2006,5,927,1.0,659.0,659.0,5,1079,1.0,811.0,811.0
0.134,6,10,1506,5,395,31.0,127.0,127.0,5,1111,28.0,843.0,843.0
0.039,17,4,420,2,122,0.0,33.0,33.0,2,298,2.0,145.0,121.0
0.005,6,10,2007,5,928,1.0,660.0,660.0,5,1079,1.0,811.0,811.0
175.552,17,72,10200,36,2402,5015.0,44.0,38.0,36,7798,5015.0,239.0,188.0
40.064,17,10,676,5,460,10015.0,104.0,64.0,5,216,10015.0,20.0,15.0
0.004,6,10,1774,5,923,1.0,655.0,655.0,5,851,1.0,583.0,583.0
0.074,6,10,1506,5,395,17.0,127.0,127.0,5,1111,16.0,843.0,843.0
0.016,6,10,1972,5,910,4.0,642.0,642.0,5,1062,4.0,794.0,794.0
80.757,6,21,8145,11,1985,84.0,1174.0,504.0,10,6160,8954.0,2720.0,958.0
0.012,6,14,3787,7,497,2.0,125.0,125.0,7,3290,2.0,1448.0,972.0
40.062,17,10,676,5,460,10013.0,104.0,64.0,5,216,10014.0,20.0,15.0
0.005,17,2,248,1,58,0.0,30.0,30.0,1,190,0.0,162.0,162.0
0.085,6,10,1506,5,395,20.0,127.0,127.0,5,1111,19.0,843.0,843.0
15.073,17,15,9238,8,6902,2149.0,1350.0,834.0,7,2336,2507.0,1350.0,305.0
0.012,6,10,1972,5,910,2.0,642.0,642.0,5,1062,3.0,794.0,794.0
0.005,6,10,2007,5,928,1.0,660.0,660.0,5,1079,1.0,811.0,811.0
0.006,6,10,1547,5,764,1.0,496.0,496.0,5,783,1.0,515.0,515.0
0.013,17,2,152,1,56,0.0,28.0,28.0,1,96,0.0,68.0,68.0
0.012,6,10,1631,5,848,3.0,580.0,580.0,5,783,3.0,515.0,515.0
0.005,17,2,164,1,74,0.0,46.0,46.0,1,90,0.0,62.0,62.0
0.005,6,10,2006,5,927,1.0,659.0,659.0,5,1079,1.0,811.0,811.0
0.006,6,10,1854,5,889,1.0,621.0,621.0,5,965,1.0,697.0,697.0
0.013,6,10,1989,5,910,3.0,642.0,642.0,5,1079,3.0,811.0,811.0
0.005,6,10,2006,5,927,1.0,659.0,659.0,5,1079,1.0,811.0,811.0
0.735,6,22,5072,11,1250,62.0,325.0,133.0,11,3822,62.0,1414.0,563.0
0.789,6,10,2009,6,1655,157.0,1403.0,1403.0,4,354,185.0,182.0,182.0
0.004,6,10,2006,5,927,1.0,659.0,659.0,5,1079,1.0,811.0,811.0
0.016,6,10,1972,5,910,4.0,642.0,642.0,5,1062,4.0,794.0,794.0
0.004,6,10,2007,5,928,1.0,660.0,660.0,5,1079,1.0,811.0,811.0
0.001,17,2,180,1,66,0.0,38.0,38.0,1,114,0.0,86.0,86.0
0.007,6,10,1972,5,910,1.0,642.0,642.0,5,1062,1.0,794.0,794.0
0.012,6,10,1990,5,911,3.0,643.0,643.0,5,1079,2.0,811.0,811.0
40.071,17,10,676,5,460,10012.0,104.0,64.0,5,216,10013.0,20.0,15.0
40.056,17,10,676,5,460,10013.0,104.0,64.0,5,216,10013.0,20.0,15.0
0.01,6,10,2006,5,927,2.0,659.0,659.0,5,1079,2.0,811.0,811.0
10.856,17,28,4421,14,1993,826.0,268.0,114.0,14,2428,826.0,587.0,145.0
0.084,6,10,1506,5,395,20.0,127.0,127.0,5,1111,19.0,843.0,843.0
0.08,6,10,1506,5,395,16.0,127.0,127.0,5,1111,17.0,843.0,843.0
0.006,17,2,144,1,64,0.0,36.0,36.0,1,80,0.0,52.0,52.0
0.015,6,10,1989,5,910,3.0,642.0,642.0,5,1079,3.0,811.0,811.0
0.006,17,2,240,1,61,0.0,33.0,33.0,1,179,0.0,151.0,151.0
0.011,6,10,1990,5,911,2.0,643.0,643.0,5,1079,2.0,811.0,811.0
0.006,6,10,1547,5,764,1.0,496.0,496.0,5,783,1.0,515.0,515.0
0.005,17,2,169,1,62,0.0,34.0,34.0,1,107,0.0,79.0,79.0
0.084,6,10,1506,5,395,19.0,127.0,127.0,5,1111,19.0,843.0,843.0
0.004,6,10,1774,5,923,1.0,655.0,655.0,5,851,1.0,583.0,583.0
0.006,6,10,1547,5,764,1.0,496.0,496.0,5,783,1.0,515.0,515.0
0.014,6,10,1989,5,910,3.0,642.0,642.0,5,1079,3.0,811.0,811.0
0.008,6,10,1762,5,911,1.0,643.0,643.0,5,851,2.0,583.0,583.0
0.019,6,10,1989,5,910,4.0,642.0,642.0,5,1079,4.0,811.0,811.0
0.018,6,10,1989,5,910,4.0,642.0,642.0,5,1079,4.0,811.0,811.0
0.005,6,14,3736,7,446,0.0,74.0,74.0,7,3290,0.0,1448.0,972.0
0.004,6,10,1774,5,923,1.0,655.0,655.0,5,851,1.0,583.0,583.0
0.006,17,2,164,1,74,0.0,46.0,46.0,1,90,0.0,62.0,62.0
15.073,17,16,10616,9,8280,1880.0,1350.0,892.0,7,2336,2508.0,1350.0,305.0
308.384,17,20,1124,10,716,34256.0,48.0,43.0,10,408,34252.0,20.0,12.0
0.004,17,4,284,2,120,0.0,32.0,32.0,2,164,0.0,60.0,54.0
0.003,17,2,148,1,60,0.0,32.0,32.0,1,88,0.0,60.0,60.0
0.005,6,10,2007,5,928,1.0,660.0,660.0,5,1079,1.0,811.0,811.0
0.005,17,2,136,1,60,0.0,32.0,32.0,1,76,0.0,48.0,48.0
0.009,6,10,1989,5,910,2.0,642.0,642.0,5,1079,2.0,811.0,811.0
125.994,6,13,1909,7,1475,20960.0,1183.0,1183.0,6,434,25153.0,182.0,182.0
0.075,17,4,284,2,120,0.0,32.0,32.0,2,164,71.0,60.0,54.0
0.009,6,10,1989,5,910,2.0,642.0,642.0,5,1079,2.0,811.0,811.0
30.841,6,43,18623,22,12985,430.0,2720.0,1509.0,21,5638,1533.0,2667.0,435.0
0.004,6,10,1774,5,923,1.0,655.0,655.0,5,851,1.0,583.0,583.0
0.096,6,10,1506,5,395,20.0,127.0,127.0,5,1111,20.0,843.0,843.0
0.014,6,10,1989,5,910,3.0,642.0,642.0,5,1079,3.0,811.0,811.0
0.005,6,10,2006,5,927,1.0,659.0,659.0,5,1079,1.0,811.0,811.0
176.22,17,78,11161,39,2602,4637.0,44.0,38.0,39,8559,4637.0,239.0,191.0
1777.854,17,144,41760,72,22752,25040.0,288.0,288.0,72,19008,25040.0,236.0,236.0
0.052,17,2,152,1,76,0.0,48.0,48.0,1,76,0.0,48.0,48.0
0.039,17,2,148,1,60,0.0,32.0,32.0,1,88,0.0,60.0,60.0
0.004,6,10,2006,5,927,1.0,659.0,659.0,5,1079,1.0,811.0,811.0
0.038,17,2,156,1,64,0.0,36.0,36.0,1,92,0.0,64.0,64.0
352.244,6,20,2210,6,1308,12003.0,494.0,494.0,14,902,27095.0,83.0,83.0
0.017,6,10,1989,5,910,4.0,642.0,642.0,5,1079,4.0,811.0,811.0
0.006,6,10,1547,5,764,1.0,496.0,496.0,5,783,1.0,515.0,515.0
0.006,6,10,2000,5,927,1.0,659.0,659.0,5,1073,1.0,805.0,805.0
0.074,6,10,1506,5,395,16.0,127.0,127.0,5,1111,14.0,843.0,843.0
0.018,6,14,3868,7,578,3.0,206.0,206.0,7,3290,3.0,1448.0,972.0
0.091,6,10,1506,5,395,21.0,127.0,127.0,5,1111,18.0,843.0,843.0
308.347,17,20,1124,10,716,34245.0,48.0,43.0,10,408,34245.0,20.0,12.0
0.005,6,10,2000,5,927,1.0,659.0,659.0,5,1073,1.0,805.0,805.0
0.004,6,10,2006,5,927,1.0,659.0,659.0,5,1079,1.0,811.0,811.0
0.068,6,10,1506,5,395,14.0,127.0,127.0,5,1111,15.0,843.0,843.0
310.051,17,20,1124,10,716,34442.0,48.0,43.0,10,408,34443.0,20.0,12.0
0.005,17,2,214,1,75,0.0,47.0,47.0,1,139,0.0,111.0,111.0
0.005,17,2,166,1,75,0.0,47.0,47.0,1,91,0.0,63.0,63.0
0.009,6,10,1677,5,827,2.0,559.0,559.0,5,850,2.0,582.0,582.0
40.058,17,10,676,5,460,10013.0,104.0,64.0,5,216,10013.0,20.0,15.0
0.005,6,10,1854,5,889,1.0,621.0,621.0,5,965,1.0,697.0,697.0
0.02,6,10,1989,5,910,5.0,642.0,642.0,5,1079,5.0,811.0,811.0
0.103,6,10,1506,5,395,23.0,127.0,127.0,5,1111,22.0,843.0,843.0
0.106,6,10,1506,5,395,21.0,127.0,127.0,5,1111,21.0,843.0,843.0
0.011,17,2,144,1,64,0.0,36.0,36.0,1,80,0.0,52.0,52.0
0.022,6,10,1972,5,910,5.0,642.0,642.0,5,1062,5.0,794.0,794.0
0.001,17,2,180,1,66,0.0,38.0,38.0,1,114,0.0,86.0,86.0
0.005,6,10,1702,5,863,1.0,595.0,595.0,5,839,1.0,571.0,571.0
0.006,6,12,1698,6,863,1.0,327.0,271.0,6,835,1.0,515.0,515.0
0.004,6,10,1989,5,927,1.0,659.0,659.0,5,1062,1.0,794.0,794.0
0.005,6,10,1989,5,927,1.0,659.0,659.0,5,1062,1.0,794.0,794.0
0.014,6,10,1677,5,827,3.0,559.0,559.0,5,850,3.0,582.0,582.0
0.001,17,2,180,1,66,0.0,38.0,38.0,1,114,0.0,86.0,86.0
0.006,6,10,1547,5,764,1.0,496.0,496.0,5,783,1.0,515.0,515.0
0.017,6,10,1972,5,910,4.0,642.0,642.0,5,1062,4.0,794.0,794.0
300.333,6,16,2170,9,684,37519.0,146.0,146.0,7,1486,50026.0,419.0,398.0
301.151,6,52,20320,28,14288,11153.0,4080.0,1458.0,24,6032,389.0,2667.0,361.0
0.011,6,10,1989,5,910,2.0,642.0,642.0,5,1079,2.0,811.0,811.0
0.013,6,10,1990,5,911,3.0,643.0,643.0,5,1079,3.0,811.0,811.0
0.025,6,10,1631,5,848,6.0,580.0,580.0,5,783,6.0,515.0,515.0
0.006,6,10,1547,5,764,1.0,496.0,496.0,5,783,1.0,515.0,515.0
0.138,6,10,1506,5,395,33.0,127.0,127.0,5,1111,34.0,843.0,843.0
11.014,17,26,4102,13,1822,909.0,269.0,112.0,13,2280,909.0,587.0,147.0
66.455,6,83,23705,44,15832,1545.0,2660.0,638.0,39,7873,1748.0,1330.0,350.0
0.003,17,2,148,1,60,0.0,32.0,32.0,1,88,0.0,60.0,60.0
0.01,6,10,1989,5,910,2.0,642.0,642.0,5,1079,2.0,811.0,811.0
0.012,6,10,1990,5,911,3.0,643.0,643.0,5,1079,3.0,811.0,811.0
0.005,6,10,2000,5,927,1.0,659.0,659.0,5,1073,1.0,805.0,805.0
0.006,6,10,1547,5,764,1.0,496.0,496.0,5,783,1.0,515.0,515.0
0.005,6,10,1989,5,927,1.0,659.0,659.0,5,1062,1.0,794.0,794.0
0.01,6,10,1972,5,910,2.0,642.0,642.0,5,1062,2.0,794.0,794.0
0.01,6,10,1631,5,848,2.0,580.0,580.0,5,783,2.0,515.0,515.0
0.005,6,10,1779,5,928,1.0,660.0,660.0,5,851,1.0,583.0,583.0
0.001,17,2,180,1,66,0.0,38.0,38.0,1,114,0.0,86.0,86.0
0.015,6,10,1989,5,910,3.0,642.0,642.0,5,1079,3.0,811.0,811.0
0.005,6,10,1643,5,860,1.0,592.0,592.0,5,783,1.0,515.0,515.0
0.012,6,10,1983,5,910,3.0,642.0,642.0,5,1073,2.0,805.0,805.0
40.083,17,10,676,5,460,10019.0,104.0,64.0,5,216,10019.0,20.0,15.0
11.362,17,28,4421,14,1994,865.0,269.0,114.0,14,2427,865.0,586.0,145.0
0.004,17,4,284,2,120,0.0,32.0,32.0,2,164,0.0,60.0,54.0
0.006,6,10,1689,5,839,1.0,571.0,571.0,5,850,1.0,582.0,582.0
0.004,17,2,184,1,61,0.0,33.0,33.0,1,123,0.0,95.0,95.0
0.005,6,10,2000,5,927,1.0,659.0,659.0,5,1073,1.0,805.0,805.0
0.12,6,10,1506,5,395,28.0,127.0,127.0,5,1111,25.0,843.0,843.0
0.064,6,10,1506,5,395,15.0,127.0,127.0,5,1111,15.0,843.0,843.0
0.005,6,10,1854,5,889,1.0,621.0,621.0,5,965,1.0,697.0,697.0
0.004,6,10,2006,5,927,1.0,659.0,659.0,5,1079,1.0,811.0,811.0
0.012,6,13,3735,7,497,2.0,125.0,125.0,6,3238,2.0,1470.0,1459.0
15.083,17,18,9522,10,7211,1672.0,1350.0,693.0,8,2311,2150.0,1350.0,260.0
0.079,6,10,1506,5,395,17.0,127.0,127.0,5,1111,17.0,843.0,843.0
0.004,6,10,2007,5,928,1.0,660.0,660.0,5,1079,1.0,811.0,811.0
0.004,17,2,136,1,60,0.0,32.0,32.0,1,76,0.0,48.0,48.0
40.062,17,10,676,5,460,10014.0,104.0,64.0,5,216,10014.0,20.0,15.0
0.012,6,10,1990,5,911,3.0,643.0,643.0,5,1079,2.0,811.0,811.0
40.061,17,10,676,5,460,10014.0,104.0,64.0,5,216,10014.0,20.0,15.0
0.001,17,2,180,1,66,0.0,38.0,38.0,1,114,0.0,86.0,86.0
0.083,6,10,1506,5,395,19.0,127.0,127.0,5,1111,19.0,843.0,843.0
0.005,6,10,1854,5,889,1.0,621.0,621.0,5,965,1.0,697.0,697.0
0.005,6,10,1989,5,927,1.0,659.0,659.0,5,1062,1.0,794.0,794.0
0.006,17,2,193,1,71,0.0,43.0,43.0,1,122,0.0,94.0,94.0
0.09,6,10,1506,5,395,19.0,127.0,127.0,5,1111,21.0,843.0,843.0
353.439,6,20,2210,6,1308,12004.0,494.0,494.0,14,902,27187.0,83.0,83.0
542.879,6,46,13558,24,4248,23603.0,676.0,427.0,22,9310,22990.0,1402.0,582.0
9.042,17,6,376,5,280,2260.0,28.0,28.0,1,96,0.0,68.0,68.0
0.013,6,10,1989,5,910,3.0,642.0,642.0,5,1079,3.0,811.0,811.0
0.003,17,2,148,1,60,0.0,32.0,32.0,1,88,0.0,60.0,60.0
0.012,6,7,695,4,448,4.0,232.0,232.0,3,247,4.0,83.0,83.0
0.04,17,2,234,1,61,0.0,33.0,33.0,1,173,0.0,145.0,145.0
0.005,17,2,144,1,64,0.0,36.0,36.0,1,80,0.0,52.0,52.0
0.007,17,2,160,1,72,0.0,44.0,44.0,1,88,0.0,60.0,60.0
243.215,6,17,4532,9,963,30401.0,238.0,166.0,8,3569,34744.0,1402.0,786.0
0.005,6,10,1989,5,927,1.0,659.0,659.0,5,1062,1.0,794.0,794.0
40.069,17,10,676,5,460,10012.0,104.0,64.0,5,216,10016.0,20.0,15.0
369.942,6,22,2313,16,867,24662.0,195.0,195.0,6,1446,4636.0,419.0,398.0
0.08,6,10,1506,5,395,16.0,127.0,127.0,5,1111,18.0,843.0,843.0
0.006,6,10,1689,5,839,1.0,571.0,571.0,5,850,1.0,582.0,582.0
0.012,6,10,1989,5,910,3.0,642.0,642.0,5,1079,2.0,811.0,811.0
15.078,17,16,8717,8,6480,2150.0,1350.0,782.0,8,2237,2149.0,1350.0,251.0
0.079,17,8,3613,4,1874,26.0,1350.0,440.0,4,1739,13.0,1350.0,406.0
0.006,6,10,1854,5,889,1.0,621.0,621.0,5,965,1.0,697.0,697.0
0.072,17,2,234,1,61,0.0,33.0,33.0,1,173,0.0,145.0,145.0
0.068,6,10,1506,5,395,14.0,127.0,127.0,5,1111,14.0,843.0,843.0
0.097,6,10,1506,5,395,21.0,127.0,127.0,5,1111,21.0,843.0,843.0
0.108,6,10,1506,5,395,23.0,127.0,127.0,5,1111,26.0,843.0,843.0
0.007,17,2,194,1,59,0.0,31.0,31.0,1,135,0.0,107.0,107.0
368.762,6,22,2313,16,867,24584.0,195.0,195.0,6,1446,4641.0,419.0,398.0
0.07,17,2,136,1,60,0.0,32.0,32.0,1,76,0.0,48.0,48.0
0.012,6,10,1677,5,827,3.0,559.0,559.0,5,850,2.0,582.0,582.0
0.112,6,10,1506,5,395,24.0,127.0,127.0,5,1111,23.0,843.0,843.0
171.513,17,80,11318,40,2664,4397.0,44.0,38.0,40,8654,4397.0,261.0,188.0
0.011,6,10,1762,5,911,2.0,643.0,643.0,5,851,2.0,583.0,583.0
0.006,6,13,3747,7,509,1.0,137.0,137.0,6,3238,1.0,1470.0,1459.0
0.076,6,10,1506,5,395,18.0,127.0,127.0,5,1111,15.0,843.0,843.0
0.019,6,10,1972,5,910,4.0,642.0,642.0,5,1062,4.0,794.0,794.0
0.016,6,10,1989,5,910,3.0,642.0,642.0,5,1079,4.0,811.0,811.0
0.067,6,10,1506,5,395,15.0,127.0,127.0,5,1111,14.0,843.0,843.0
0.107,6,10,1506,5,395,21.0,127.0,127.0,5,1111,23.0,843.0,843.0
0.005,6,10,1779,5,928,1.0,660.0,660.0,5,851,1.0,583.0,583.0
0.006,17,2,179,1,71,0.0,43.0,43.0,1,108,0.0,80.0,80.0
0.006,6,12,1698,6,863,1.0,327.0,271.0,6,835,1.0,515.0,515.0
0.005,6,13,3747,7,509,0.0,137.0,137.0,6,3238,0.0,1470.0,1459.0
0.054,17,2,152,1,76,0.0,48.0,48.0,1,76,0.0,48.0,48.0
0.076,6,10,1506,5,395,16.0,127.0,127.0,5,1111,16.0,843.0,843.0
116.754,6,22,8495,12,2236,71.0,1345.0,574.0,10,6259,12954.0,2720.0,974.0
0.077,6,10,1506,5,395,18.0,127.0,127.0,5,1111,12.0,843.0,843.0
10.759,17,28,4423,14,1994,819.0,269.0,114.0,14,2429,818.0,588.0,145.0
0.006,17,2,169,1,62,0.0,34.0,34.0,1,107,0.0,79.0,79.0
0.001,17,2,180,1,66,0.0,38.0,38.0,1,114,0.0,86.0,86.0
0.083,6,10,1506,5,395,16.0,127.0,127.0,5,1111,17.0,843.0,843.0
0.002,17,2,180,1,66,0.0,38.0,38.0,1,114,0.0,86.0,86.0
0.006,6,10,1689,5,839,1.0,571.0,571.0,5,850,1.0,582.0,582.0
0.005,6,13,3747,7,509,0.0,137.0,137.0,6,3238,0.0,1470.0,1459.0
0.031,6,10,1972,5,910,7.0,642.0,642.0,5,1062,7.0,794.0,794.0
0.005,6,10,1547,5,764,1.0,496.0,496.0,5,783,1.0,515.0,515.0
0.013,6,10,1989,5,910,3.0,642.0,642.0,5,1079,3.0,811.0,811.0
0.005,6,13,3747,7,509,0.0,137.0,137.0,6,3238,1.0,1470.0,1459.0
240.105,6,31,9151,15,6732,17150.0,1858.0,661.0,16,2419,16006.0,580.0,197.0
15.079,17,16,9302,8,6912,2150.0,1350.0,836.0,8,2390,2149.0,1350.0,270.0
0.011,6,10,1631,5,848,2.0,580.0,580.0,5,783,2.0,515.0,515.0
0.005,6,10,2006,5,927,1.0,659.0,659.0,5,1079,1.0,811.0,811.0
170.107,17,68,9678,34,2267,5154.0,44.0,38.0,34,7411,5154.0,239.0,189.0
0.076,6,10,1506,5,395,17.0,127.0,127.0,5,1111,14.0,843.0,843.0
0.005,17,2,169,1,62,0.0,34.0,34.0,1,107,0.0,79.0,79.0
0.004,6,10,2006,5,927,1.0,659.0,659.0,5,1079,1.0,811.0,811.0
0.074,6,10,1506,5,395,14.0,127.0,127.0,5,1111,16.0,843.0,843.0
0.134,17,2,80,1,32,0.0,4.0,4.0,1,48,0.0,20.0,20.0
0.152,6,10,1506,5,395,35.0,127.0,127.0,5,1111,37.0,843.0,843.0
0.005,6,10,1774,5,923,1.0,655.0,655.0,5,851,1.0,583.0,583.0
367.151,6,22,2313,16,867,24476.0,195.0,195.0,6,1446,4649.0,419.0,398.0
0.001,17,2,180,1,66,0.0,38.0,38.0,1,114,0.0,86.0,86.0
0.011,6,10,1990,5,911,2.0,643.0,643.0,5,1079,2.0,811.0,811.0
0.005,6,10,1854,5,889,1.0,621.0,621.0,5,965,1.0,697.0,697.0
0.015,6,13,3735,7,497,2.0,125.0,125.0,6,3238,2.0,1470.0,1459.0
40.075,17,10,676,5,460,10015.0,104.0,64.0,5,216,10018.0,20.0,15.0
0.016,6,10,1631,5,848,4.0,580.0,580.0,5,783,3.0,515.0,515.0
0.005,6,10,1989,5,927,1.0,659.0,659.0,5,1062,1.0,794.0,794.0
0.011,6,10,1972,5,910,2.0,642.0,642.0,5,1062,2.0,794.0,794.0
0.011,6,10,1631,5,848,2.0,580.0,580.0,5,783,2.0,515.0,515.0
0.005,6,10,2007,5,928,1.0,660.0,660.0,5,1079,1.0,811.0,811.0
0.02,6,10,1989,5,910,5.0,642.0,642.0,5,1079,4.0,811.0,811.0
0.023,6,10,1990,5,911,5.0,643.0,643.0,5,1079,5.0,811.0,811.0
0.009,6,10,1989,5,910,2.0,642.0,642.0,5,1079,2.0,811.0,811.0
0.122,6,10,1506,5,395,27.0,127.0,127.0,5,1111,23.0,843.0,843.0
0.052,6,10,1972,5,910,13.0,642.0,642.0,5,1062,12.0,794.0,794.0
0.014,6,10,1677,5,827,3.0,559.0,559.0,5,850,3.0,582.0,582.0
0.02,6,10,1762,5,911,5.0,643.0,643.0,5,851,4.0,583.0,583.0
0.006,17,2,282,1,69,0.0,41.0,41.0,1,213,0.0,185.0,185.0
0.006,6,10,1774,5,923,1.0,655.0,655.0,5,851,1.0,583.0,583.0
40.092,17,10,676,5,460,10019.0,104.0,64.0,5,216,10022.0,20.0,15.0
0.011,6,10,1677,5,827,2.0,559.0,559.0,5,850,2.0,582.0,582.0
1786.423,6,154,19574,92,13852,19631.0,302.0,302.0,62,5722,29285.0,83.0,83.0
0.005,6,13,3747,7,509,0.0,137.0,137.0,6,3238,1.0,1470.0,1459.0
0.013,6,10,1762,5,911,3.0,643.0,643.0,5,851,3.0,583.0,583.0
10.858,17,28,4423,14,1995,826.0,270.0,114.0,14,2428,826.0,587.0,145.0
0.005,6,10,2006,5,927,1.0,659.0,659.0,5,1079,1.0,811.0,811.0
240.091,6,16,4482,9,963,30011.0,238.0,166.0,7,3519,40014.0,1402.0,786.0
0.095,6,10,1506,5,395,18.0,127.0,127.0,5,1111,20.0,843.0,843.0
240.106,6,16,4481,9,963,30013.0,238.0,166.0,7,3518,40017.0,1402.0,786.0
0.016,6,10,1989,5,910,4.0,642.0,642.0,5,1079,4.0,811.0,811.0
0.09,6,10,1506,5,395,17.0,127.0,127.0,5,1111,19.0,843.0,843.0
0.013,6,10,1990,5,911,3.0,643.0,643.0,5,1079,3.0,811.0,811.0
0.039,17,4,284,2,120,0.0,32.0,32.0,2,164,36.0,60.0,54.0
0.004,6,10,1779,5,928,1.0,660.0,660.0,5,851,1.0,583.0,583.0
0.012,6,10,1983,5,910,3.0,642.0,642.0,5,1073,3.0,805.0,805.0
0.006,17,2,179,1,71,0.0,43.0,43.0,1,108,0.0,80.0,80.0
0.005,6,10,2006,5,927,1.0,659.0,659.0,5,1079,1.0,811.0,811.0
0.003,17,2,148,1,60,0.0,32.0,32.0,1,88,0.0,60.0,60.0
0.005,6,10,1989,5,927,1.0,659.0,659.0,5,1062,1.0,794.0,794.0
0.103,6,10,1506,5,395,24.0,127.0,127.0,5,1111,23.0,843.0,843.0
0.082,6,10,1506,5,395,18.0,127.0,127.0,5,1111,19.0,843.0,843.0
0.018,6,13,3735,7,497,3.0,125.0,125.0,6,3238,3.0,1470.0,1459.0
0.017,6,10,1677,5,827,4.0,559.0,559.0,5,850,4.0,582.0,582.0
0.004,17,4,284,2,120,0.0,32.0,32.0,2,164,1.0,60.0,54.0
0.005,6,10,1854,5,889,1.0,621.0,621.0,5,965,1.0,697.0,697.0
10.792,17,28,4424,14,1995,821.0,270.0,114.0,14,2429,821.0,588.0,145.0
0.01,6,10,1983,5,910,2.0,642.0,642.0,5,1073,2.0,805.0,805.0
240.104,6,16,4481,9,963,30013.0,238.0,166.0,7,3518,40016.0,1402.0,786.0
0.01,17,2,170,1,65,0.0,37.0,37.0,1,105,0.0,77.0,77.0
0.081,17,2,152,1,76,0.0,48.0,48.0,1,76,0.0,48.0,48.0
0.014,6,10,1989,5,910,3.0,642.0,642.0,5,1079,3.0,811.0,811.0
0.006,6,10,1547,5,764,1.0,496.0,496.0,5,783,1.0,515.0,515.0
308.963,17,20,1124,10,716,34316.0,48.0,43.0,10,408,34316.0,20.0,12.0
300.08,6,22,5063,11,2369,30007.0,1026.0,447.0,11,2694,30007.0,1162.0,425.0
0.081,6,10,1506,5,395,19.0,127.0,127.0,5,1111,17.0,843.0,843.0
0.003,17,2,136,1,60,0.0,32.0,32.0,1,76,0.0,48.0,48.0
0.004,17,4,284,2,120,0.0,32.0,32.0,2,164,0.0,60.0,54.0
0.081,6,10,1506,5,395,18.0,127.0,127.0,5,1111,15.0,843.0,843.0
0.01,6,13,3735,7,497,1.0,125.0,125.0,6,3238,2.0,1470.0,1459.0
0.004,6,10,2006,5,927,1.0,659.0,659.0,5,1079,1.0,811.0,811.0
0.022,6,10,1989,5,910,5.0,642.0,642.0,5,1079,5.0,811.0,811.0
0.005,6,14,3736,7,446,0.0,74.0,74.0,7,3290,0.0,1448.0,972.0
0.211,6,16,2669,8,1395,30.0,533.0,323.0,8,1274,19.0,529.0,212.0
0.005,6,10,2006,5,927,1.0,659.0,659.0,5,1079,1.0,811.0,811.0
0.001,17,2,179,1,62,0.0,34.0,34.0,1,117,0.0,89.0,89.0
0.083,6,10,1506,5,395,19.0,127.0,127.0,5,1111,14.0,843.0,843.0
0.137,6,10,1506,5,395,31.0,127.0,127.0,5,1111,31.0,843.0,843.0
0.01,6,10,1989,5,910,2.0,642.0,642.0,5,1079,2.0,811.0,811.0
11.137,17,28,4418,14,1993,844.0,268.0,114.0,14,2425,844.0,588.0,145.0
0.005,6,10,1854,5,889,1.0,621.0,621.0,5,965,1.0,697.0,697.0
170.198,17,92,13082,46,3063,3782.0,44.0,38.0,46,10019,3782.0,239.0,189.0
240.09,6,16,4481,9,963,30011.0,238.0,166.0,7,3518,40014.0,1402.0,786.0
0.018,6,10,1990,5,911,4.0,643.0,643.0,5,1079,4.0,811.0,811.0
0.005,6,10,1854,5,889,1.0,621.0,621.0,5,965,1.0,697.0,697.0
0.003,17,2,136,1,60,0.0,32.0,32.0,1,76,0.0,48.0,48.0
0.013,6,10,1983,5,910,3.0,642.0,642.0,5,1073,3.0,805.0,805.0
0.04,17,2,186,1,61,0.0,33.0,33.0,1,125,0.0,97.0,97.0
0.017,17,2,198,1,91,0.0,63.0,63.0,1,107,0.0,79.0,79.0
0.005,6,10,1689,5,839,1.0,571.0,571.0,5,850,1.0,582.0,582.0
0.005,6,10,2006,5,927,1.0,659.0,659.0,5,1079,1.0,811.0,811.0
0.033,6,10,1983,5,910,8.0,642.0,642.0,5,1073,8.0,805.0,805.0
0.071,17,2,148,1,60,0.0,32.0,32.0,1,88,0.0,60.0,60.0
0.009,6,10,1762,5,911,2.0,643.0,643.0,5,851,2.0,583.0,583.0
312.726,17,20,1124,10,716,34734.0,48.0,43.0,10,408,34736.0,20.0,12.0
0.047,6,10,1983,5,910,11.0,642.0,642.0,5,1073,11.0,805.0,805.0
0.009,17,2,194,1,59,0.0,31.0,31.0,1,135,0.0,107.0,107.0
0.083,6,10,1506,5,395,18.0,127.0,127.0,5,1111,19.0,843.0,843.0
0.081,6,10,1506,5,395,17.0,127.0,127.0,5,1111,16.0,843.0,843.0
0.009,6,10,1989,5,910,2.0,642.0,642.0,5,1079,2.0,811.0,811.0
0.004,6,10,2000,5,927,1.0,659.0,659.0,5,1073,1.0,805.0,805.0
0.103,6,10,1506,5,395,22.0,127.0,127.0,5,1111,24.0,843.0,843.0
0.003,17,2,148,1,60,0.0,32.0,32.0,1,88,0.0,60.0,60.0
0.005,6,10,1774,5,923,1.0,655.0,655.0,5,851,1.0,583.0,583.0
0.005,6,13,3690,7,452,0.0,80.0,80.0,6,3238,0.0,1470.0,1459.0
0.096,6,10,1506,5,395,22.0,127.0,127.0,5,1111,19.0,843.0,843.0
302.011,6,38,8321,21,1890,15100.0,651.0,249.0,17,6431,550.0,2720.0,478.0
0.009,6,12,1926,6,1189,1.0,659.0,434.0,6,737,1.0,417.0,417.0
0.005,6,14,3742,8,504,0.0,80.0,80.0,6,3238,0.0,1470.0,1459.0
0.012,6,10,1989,5,910,3.0,642.0,642.0,5,1079,2.0,811.0,811.0
0.104,6,10,1506,5,395,23.0,127.0,127.0,5,1111,19.0,843.0,843.0
0.114,6,10,1506,5,395,26.0,127.0,127.0,5,1111,20.0,843.0,843.0
0.091,6,10,1506,5,395,20.0,127.0,127.0,5,1111,21.0,843.0,843.0
0.053,17,2,152,1,76,0.0,48.0,48.0,1,76,0.0,48.0,48.0
0.015,6,10,1983,5,910,3.0,642.0,642.0,5,1073,3.0,805.0,805.0
0.062,6,10,1506,5,395,13.0,127.0,127.0,5,1111,14.0,843.0,843.0
0.003,17,2,148,1,60,0.0,32.0,32.0,1,88,0.0,60.0,60.0
0.015,6,10,1989,5,910,3.0,642.0,642.0,5,1079,3.0,811.0,811.0
0.014,6,10,1989,5,910,3.0,642.0,642.0,5,1079,3.0,811.0,811.0
0.003,17,2,148,1,60,0.0,32.0,32.0,1,88,0.0,60.0,60.0
0.096,6,10,1506,5,395,19.0,127.0,127.0,5,1111,20.0,843.0,843.0
300.771,6,39,9734,21,4171,15038.0,2903.0,821.0,18,5563,505.0,2667.0,402.0
0.004,6,10,2006,5,927,1.0,659.0,659.0,5,1079,1.0,811.0,811.0
0.743,6,25,5459,12,1557,57.0,325.0,152.0,13,3902,52.0,1414.0,563.0
0.069,6,10,1506,5,395,15.0,127.0,127.0,5,1111,13.0,843.0,843.0
0.012,6,10,1990,5,911,2.0,643.0,643.0,5,1079,3.0,811.0,811.0
0.005,17,4,495,2,132,0.0,38.0,38.0,2,363,2.0,176.0,153.0
0.013,17,2,152,1,56,0.0,28.0,28.0,1,96,0.0,68.0,68.0
0.01,6,10,1989,5,910,2.0,642.0,642.0,5,1079,2.0,811.0,811.0
0.07,17,8,3613,4,1874,23.0,1350.0,440.0,4,1739,12.0,1350.0,406.0
0.005,6,10,1774,5,923,1.0,655.0,655.0,5,851,1.0,583.0,583.0
67.939,58,5,360,4,288,22646.0,24.0,24.0,1,72,0.0,24.0,24.0
368.692,6,22,2313,16,867,24579.0,195.0,195.0,6,1446,4635.0,419.0,398.0
0.16,17,2,152,1,76,0.0,48.0,48.0,1,76,0.0,48.0,48.0
0.096,6,10,1506,5,395,19.0,127.0,127.0,5,1111,22.0,843.0,843.0
0.01,6,10,1972,5,910,2.0,642.0,642.0,5,1062,2.0,794.0,794.0
0.038,17,4,284,2,120,1.0,32.0,32.0,2,164,33.0,60.0,54.0
0.107,6,10,1506,5,395,24.0,127.0,127.0,5,1111,24.0,843.0,843.0
0.009,6,10,1972,5,910,2.0,642.0,642.0,5,1062,2.0,794.0,794.0
0.292,17,40,21424,22,18422,13.0,1350.0,809.0,18,3002,12.0,1350.0,138.0
0.039,17,2,152,1,76,0.0,48.0,48.0,1,76,0.0,48.0,48.0
240.729,6,35,9504,16,6791,16048.0,1864.0,662.0,19,2713,13373.0,580.0,171.0
0.113,6,10,1506,5,395,24.0,127.0,127.0,5,1111,26.0,843.0,843.0
0.01,6,10,1677,5,827,2.0,559.0,559.0,5,850,2.0,582.0,582.0
0.005,6,10,1643,5,860,1.0,592.0,592.0,5,783,1.0,515.0,515.0
0.017,17,2,180,1,66,0.0,38.0,38.0,1,114,0.0,86.0,86.0
0.003,17,2,148,1,60,0.0,32.0,32.0,1,88,0.0,60.0,60.0
0.006,6,10,1547,5,764,1.0,496.0,496.0,5,783,1.0,515.0,515.0
0.013,6,10,1983,5,910,3.0,642.0,642.0,5,1073,3.0,805.0,805.0
0.113,6,10,1506,5,395,24.0,127.0,127.0,5,1111,25.0,843.0,843.0
0.008,6,10,1983,5,910,2.0,642.0,642.0,5,1073,2.0,805.0,805.0
0.013,17,2,148,1,60,0.0,32.0,32.0,1,88,0.0,60.0,60.0
0.008,17,2,164,1,74,0.0,46.0,46.0,1,90,0.0,62.0,62.0
0.007,6,10,1990,5,911,1.0,643.0,643.0,5,1079,1.0,811.0,811.0
0.011,6,10,1762,5,911,2.0,643.0,643.0,5,851,2.0,583.0,583.0
11.382,17,28,4421,14,1994,862.0,269.0,114.0,14,2427,862.0,586.0,145.0
0.013,6,10,1983,5,910,3.0,642.0,642.0,5,1073,3.0,805.0,805.0
0.005,6,10,2000,5,927,1.0,659.0,659.0,5,1073,1.0,805.0,805.0
0.017,6,10,1990,5,911,4.0,643.0,643.0,5,1079,4.0,811.0,811.0
0.001,17,2,136,1,60,0.0,32.0,32.0,1,76,0.0,48.0,48.0
0.005,17,2,154,1,69,0.0,41.0,41.0,1,85,0.0,57.0,57.0
0.001,17,2,136,1,60,0.0,32.0,32.0,1,76,0.0,48.0,48.0
0.121,6,10,1506,5,395,24.0,127.0,127.0,5,1111,28.0,843.0,843.0
1.165,6,31,12741,18,3352,68.0,1360.0,517.0,13,9389,81.0,2720.0,984.0
0.093,6,10,1506,5,395,19.0,127.0,127.0,5,1111,20.0,843.0,843.0
0.005,6,10,2007,5,928,1.0,660.0,660.0,5,1079,1.0,811.0,811.0
0.004,6,10,2006,5,927,1.0,659.0,659.0,5,1079,1.0,811.0,811.0
0.005,6,10,1854,5,889,1.0,621.0,621.0,5,965,1.0,697.0,697.0
0.078,6,10,1506,5,395,17.0,127.0,127.0,5,1111,16.0,843.0,843.0
0.04,17,2,148,1,60,0.0,32.0,32.0,1,88,0.0,60.0,60.0
56.325,6,37,8230,19,1759,519.0,651.0,322.0,18,6471,3305.0,2126.0,478.0
0.073,6,10,1506,5,395,16.0,127.0,127.0,5,1111,14.0,843.0,843.0
0.006,6,10,1547,5,764,1.0,496.0,496.0,5,783,1.0,515.0,515.0
40.049,17,10,676,5,460,10011.0,104.0,64.0,5,216,10011.0,20.0,15.0
0.004,17,4,284,2,120,0.0,32.0,32.0,2,164,0.0,60.0,54.0
15.102,17,17,10673,9,8280,1883.0,1350.0,892.0,8,2393,2150.0,1350.0,271.0
0.003,17,2,148,1,60,0.0,32.0,32.0,1,88,0.0,60.0,60.0
40.064,17,10,676,5,460,10015.0,104.0,64.0,5,216,10015.0,20.0,15.0
0.005,6,10,1547,5,764,1.0,496.0,496.0,5,783,1.0,515.0,515.0
0.002,17,2,180,1,66,0.0,38.0,38.0,1,114,0.0,86.0,86.0
0.127,6,10,1506,5,395,31.0,127.0,127.0,5,1111,28.0,843.0,843.0
125.951,6,14,2938,8,2504,17959.0,1414.0,1086.0,6,434,25143.0,182.0,182.0
0.019,6,10,1972,5,910,4.0,642.0,642.0,5,1062,4.0,794.0,794.0
0.053,17,2,152,1,76,0.0,48.0,48.0,1,76,0.0,48.0,48.0
0.005,6,10,2006,5,927,1.0,659.0,659.0,5,1079,1.0,811.0,811.0
0.094,6,10,1506,5,395,19.0,127.0,127.0,5,1111,22.0,843.0,843.0
177.234,17,80,11208,40,2672,4543.0,44.0,38.0,40,8536,4544.0,239.0,185.0
0.091,6,10,1506,5,395,20.0,127.0,127.0,5,1111,19.0,843.0,843.0
169.253,6,21,8145,11,1985,85.0,1174.0,504.0,10,6160,18786.0,2720.0,958.0
0.005,6,10,2006,5,927,1.0,659.0,659.0,5,1079,1.0,811.0,811.0
0.004,6,10,2000,5,927,1.0,659.0,659.0,5,1073,1.0,805.0,805.0
0.013,6,10,1990,5,911,3.0,643.0,643.0,5,1079,3.0,811.0,811.0
0.078,6,10,1506,5,395,17.0,127.0,127.0,5,1111,17.0,843.0,843.0
0.005,6,10,2007,5,928,1.0,660.0,660.0,5,1079,1.0,811.0,811.0
0.067,17,8,3613,4,1874,22.0,1350.0,440.0,4,1739,11.0,1350.0,406.0
0.011,6,10,1990,5,911,2.0,643.0,643.0,5,1079,2.0,811.0,811.0
0.005,6,10,2000,5,927,1.0,659.0,659.0,5,1073,1.0,805.0,805.0
0.017,6,10,1972,5,910,4.0,642.0,642.0,5,1062,4.0,794.0,794.0
0.013,6,10,1631,5,848,3.0,580.0,580.0,5,783,3.0,515.0,515.0
0.009,6,12,1926,6,1189,1.0,659.0,434.0,6,737,1.0,417.0,417.0
0.005,6,10,1547,5,764,1.0,496.0,496.0,5,783,1.0,515.0,515.0
0.116,6,10,1506,5,395,24.0,127.0,127.0,5,1111,24.0,843.0,843.0
0.011,6,10,1989,5,910,2.0,642.0,642.0,5,1079,2.0,811.0,811.0
0.007,17,2,164,1,74,0.0,46.0,46.0,1,90,0.0,62.0,62.0
0.007,6,10,1547,5,764,1.0,496.0,496.0,5,783,1.0,515.0,515.0
0.067,6,10,1506,5,395,14.0,127.0,127.0,5,1111,13.0,843.0,843.0
0.018,6,10,1989,5,910,4.0,642.0,642.0,5,1079,4.0,811.0,811.0
0.039,17,4,284,2,120,0.0,32.0,32.0,2,164,35.0,60.0,54.0
0.09,6,10,1506,5,395,20.0,127.0,127.0,5,1111,21.0,843.0,843.0
0.005,6,10,2007,5,928,1.0,660.0,660.0,5,1079,1.0,811.0,811.0
0.008,6,12,1926,6,1189,1.0,659.0,434.0,6,737,1.0,417.0,417.0
0.006,6,10,2006,5,927,1.0,659.0,659.0,5,1079,1.0,811.0,811.0
0.006,6,10,1547,5,764,1.0,496.0,496.0,5,783,1.0,515.0,515.0
2.476,6,32,6224,17,1298,154.0,267.0,195.0,15,4926,166.0,1823.0,392.0
0.006,17,2,144,1,64,0.0,36.0,36.0,1,80,0.0,52.0,52.0
33.31,6,44,15813,22,10135,435.0,2720.0,1152.0,22,5678,1578.0,2667.0,435.0
0.005,6,10,2007,5,928,1.0,660.0,660.0,5,1079,1.0,811.0,811.0
0.01,6,10,1989,5,910,2.0,642.0,642.0,5,1079,2.0,811.0,811.0
0.098,6,10,1506,5,395,22.0,127.0,127.0,5,1111,22.0,843.0,843.0
0.003,17,2,148,1,60,0.0,32.0,32.0,1,88,0.0,60.0,60.0
0.004,6,10,1702,5,863,1.0,595.0,595.0,5,839,0.0,571.0,571.0
0.006,6,10,2000,5,927,1.0,659.0,659.0,5,1073,1.0,805.0,805.0
0.005,17,2,170,1,65,0.0,37.0,37.0,1,105,0.0,77.0,77.0
0.099,6,10,1506,5,395,21.0,127.0,127.0,5,1111,24.0,843.0,843.0
0.016,6,10,1983,5,910,4.0,642.0,642.0,5,1073,4.0,805.0,805.0
0.005,6,10,2007,5,928,1.0,660.0,660.0,5,1079,1.0,811.0,811.0
0.005,6,10,1774,5,923,1.0,655.0,655.0,5,851,1.0,583.0,583.0
0.006,6,10,2006,5,927,1.0,659.0,659.0,5,1079,1.0,811.0,811.0
0.016,6,10,1989,5,910,4.0,642.0,642.0,5,1079,4.0,811.0,811.0
175.184,17,72,10275,36,2400,5004.0,44.0,38.0,36,7875,5005.0,261.0,190.0
0.113,6,10,1506,5,395,26.0,127.0,127.0,5,1111,24.0,843.0,843.0
0.004,6,10,2006,5,927,1.0,659.0,659.0,5,1079,1.0,811.0,811.0
0.127,6,10,1506,5,395,29.0,127.0,127.0,5,1111,28.0,843.0,843.0
0.004,6,10,2007,5,928,1.0,660.0,660.0,5,1079,1.0,811.0,811.0
0.006,6,10,1547,5,764,1.0,496.0,496.0,5,783,1.0,515.0,515.0
0.013,6,10,1983,5,910,3.0,642.0,642.0,5,1073,3.0,805.0,805.0
0.093,6,10,1506,5,395,16.0,127.0,127.0,5,1111,21.0,843.0,843.0
0.005,6,10,1989,5,927,1.0,659.0,659.0,5,1062,1.0,794.0,794.0
0.014,6,10,1990,5,911,3.0,643.0,643.0,5,1079,3.0,811.0,811.0
0.003,17,2,148,1,60,0.0,32.0,32.0,1,88,0.0,60.0,60.0
0.089,6,10,1506,5,395,20.0,127.0,127.0,5,1111,19.0,843.0,843.0
0.022,6,9,1190,5,751,5.0,495.0,495.0,4,439,4.0,223.0,223.0
0.014,6,10,1972,5,910,3.0,642.0,642.0,5,1062,3.0,794.0,794.0
0.051,6,13,3816,7,578,8.0,206.0,206.0,6,3238,10.0,1470.0,1459.0
0.007,6,10,1547,5,764,1.0,496.0,496.0,5,783,1.0,515.0,515.0
0.005,6,10,2000,5,927,1.0,659.0,659.0,5,1073,1.0,805.0,805.0
0.17,17,2,152,1,76,0.0,48.0,48.0,1,76,0.0,48.0,48.0
7.029,58,2,144,1,72,0.0,24.0,24.0,1,72,0.0,24.0,24.0
0.006,6,10,1547,5,764,1.0,496.0,496.0,5,783,1.0,515.0,515.0
0.282,17,41,21721,23,18466,12.0,1350.0,774.0,18,3255,12.0,1350.0,152.0
0.013,6,10,1990,5,911,3.0,643.0,643.0,5,1079,3.0,811.0,811.0
0.004,6,10,1774,5,923,1.0,655.0,655.0,5,851,1.0,583.0,583.0
0.005,6,10,1989,5,927,1.0,659.0,659.0,5,1062,1.0,794.0,794.0
0.206,6,16,2778,8,1396,29.0,533.0,324.0,8,1382,18.0,529.0,239.0
0.01,6,10,1631,5,848,2.0,580.0,580.0,5,783,2.0,515.0,515.0
0.007,6,10,1990,5,911,1.0,643.0,643.0,5,1079,1.0,811.0,811.0
0.182,17,2,194,1,59,0.0,31.0,31.0,1,135,0.0,107.0,107.0
0.015,6,10,1990,5,911,3.0,643.0,643.0,5,1079,3.0,811.0,811.0
0.064,6,10,1506,5,395,14.0,127.0,127.0,5,1111,13.0,843.0,843.0
0.006,17,2,194,1,59,0.0,31.0,31.0,1,135,0.0,107.0,107.0
0.005,6,10,1989,5,927,1.0,659.0,659.0,5,1062,1.0,794.0,794.0
0.113,6,10,1506,5,395,26.0,127.0,127.0,5,1111,25.0,843.0,843.0
0.004,6,10,2006,5,927,1.0,659.0,659.0,5,1079,1.0,811.0,811.0
0.006,6,10,1689,5,839,1.0,571.0,571.0,5,850,1.0,582.0,582.0
0.042,17,2,152,1,76,0.0,48.0,48.0,1,76,0.0,48.0,48.0
0.043,17,2,152,1,76,0.0,48.0,48.0,1,76,0.0,48.0,48.0
0.054,17,2,152,1,76,0.0,48.0,48.0,1,76,0.0,48.0,48.0
0.139,6,10,1506,5,395,33.0,127.0,127.0,5,1111,29.0,843.0,843.0
323.095,17,16,892,8,564,46138.0,48.0,42.0,8,328,46138.0,20.0,13.0
0.012,6,13,3735,7,497,2.0,125.0,125.0,6,3238,2.0,1470.0,1459.0
0.004,17,2,136,1,60,0.0,32.0,32.0,1,76,0.0,48.0,48.0
0.005,6,10,1689,5,839,1.0,571.0,571.0,5,850,1.0,582.0,582.0
0.093,6,10,1506,5,395,20.0,127.0,127.0,5,1111,21.0,843.0,843.0
0.014,6,10,1989,5,910,3.0,642.0,642.0,5,1079,3.0,811.0,811.0
0.004,17,2,136,1,60,0.0,32.0,32.0,1,76,0.0,48.0,48.0
1770.469,6,83,4368,42,2210,43181.0,26.0,26.0,41,2158,44260.0,26.0,26.0
0.013,6,10,1989,5,910,3.0,642.0,642.0,5,1079,3.0,811.0,811.0
0.003,6,10,1702,5,863,0.0,595.0,595.0,5,839,0.0,571.0,571.0
0.169,17,2,152,1,76,0.0,48.0,48.0,1,76,0.0,48.0,48.0
0.007,6,10,1547,5,764,1.0,496.0,496.0,5,783,1.0,515.0,515.0
0.011,6,10,1983,5,910,2.0,642.0,642.0,5,1073,2.0,805.0,805.0
0.009,6,10,1989,5,910,2.0,642.0,642.0,5,1079,2.0,811.0,811.0
309.481,17,20,1124,10,716,34373.0,48.0,43.0,10,408,34373.0,20.0,12.0
0.078,6,10,1506,5,395,17.0,127.0,127.0,5,1111,18.0,843.0,843.0
0.001,17,2,180,1,66,0.0,38.0,38.0,1,114,0.0,86.0,86.0
0.012,6,13,3735,7,497,1.0,125.0,125.0,6,3238,2.0,1470.0,1459.0
0.004,6,10,2006,5,927,1.0,659.0,659.0,5,1079,1.0,811.0,811.0
0.014,6,14,3787,7,497,2.0,125.0,125.0,7,3290,2.0,1448.0,972.0
0.004,6,10,2006,5,927,1.0,659.0,659.0,5,1079,1.0,811.0,811.0
0.006,17,2,170,1,65,0.0,37.0,37.0,1,105,0.0,77.0,77.0
0.006,6,10,2006,5,927,1.0,659.0,659.0,5,1079,1.0,811.0,811.0
0.005,6,10,1989,5,927,1.0,659.0,659.0,5,1062,1.0,794.0,794.0
240.107,6,16,4481,9,963,30013.0,238.0,166.0,7,3518,40017.0,1402.0,786.0
0.004,17,2,136,1,60,0.0,32.0,32.0,1,76,0.0,48.0,48.0
0.073,17,2,148,1,60,0.0,32.0,32.0,1,88,0.0,60.0,60.0
0.026,6,10,1972,5,910,6.0,642.0,642.0,5,1062,6.0,794.0,794.0
0.013,6,10,1990,5,911,3.0,643.0,643.0,5,1079,3.0,811.0,811.0
0.004,17,4,284,2,120,0.0,32.0,32.0,2,164,1.0,60.0,54.0
0.005,6,13,3747,7,509,0.0,137.0,137.0,6,3238,1.0,1470.0,1459.0
0.01,6,10,1990,5,911,2.0,643.0,643.0,5,1079,2.0,811.0,811.0
0.012,6,10,1983,5,910,2.0,642.0,642.0,5,1073,2.0,805.0,805.0
0.004,17,2,166,1,75,0.0,47.0,47.0,1,91,0.0,63.0,63.0
0.006,6,10,1547,5,764,1.0,496.0,496.0,5,783,1.0,515.0,515.0
0.001,17,2,180,1,66,0.0,38.0,38.0,1,114,0.0,86.0,86.0
0.005,6,10,1689,5,839,1.0,571.0,571.0,5,850,1.0,582.0,582.0
0.003,17,2,184,1,61,0.0,33.0,33.0,1,123,0.0,95.0,95.0
0.007,17,2,179,1,71,0.0,43.0,43.0,1,108,0.0,80.0,80.0
0.11,6,10,1506,5,395,25.0,127.0,127.0,5,1111,24.0,843.0,843.0
0.083,6,10,1506,5,395,16.0,127.0,127.0,5,1111,19.0,843.0,843.0
0.006,6,10,1989,5,927,1.0,659.0,659.0,5,1062,1.0,794.0,794.0
1730.358,6,45,2790,30,1725,59667.0,35.0,35.0,15,1065,123591.0,31.0,31.0
0.005,6,10,2007,5,928,1.0,660.0,660.0,5,1079,1.0,811.0,811.0
240.087,6,16,4481,9,963,30010.0,238.0,166.0,7,3518,40014.0,1402.0,786.0
0.005,6,10,2006,5,927,1.0,659.0,659.0,5,1079,1.0,811.0,811.0
0.006,6,10,1689,5,839,1.0,571.0,571.0,5,850,1.0,582.0,582.0
0.042,17,2,152,1,76,0.0,48.0,48.0,1,76,0.0,48.0,48.0
0.016,6,10,1983,5,910,3.0,642.0,642.0,5,1073,3.0,805.0,805.0
0.004,17,2,148,1,60,0.0,32.0,32.0,1,88,0.0,60.0,60.0
0.013,6,10,1972,5,910,3.0,642.0,642.0,5,1062,3.0,794.0,794.0
0.005,6,10,2006,5,927,1.0,659.0,659.0,5,1079,1.0,811.0,811.0
0.2,6,3,453,2,321,200.0,241.0,241.0,1,132,0.0,92.0,92.0
292.51,6,387,348328,183,21083,1607.0,2736.0,889.0,204,327245,1440.0,4171.0,1666.0
0.003,17,2,234,1,61,0.0,33.0,33.0,1,173,0.0,145.0,145.0
0.009,6,14,3787,7,497,1.0,125.0,125.0,7,3290,1.0,1448.0,972.0
8.659,6,34,8292,18,1901,509.0,793.0,383.0,16,6391,566.0,3486.0,521.0
308.452,17,20,1124,10,716,34258.0,48.0,43.0,10,408,34258.0,20.0,12.0
0.112,6,10,1506,5,395,23.0,127.0,127.0,5,1111,24.0,843.0,843.0
0.009,6,10,1972,5,910,2.0,642.0,642.0,5,1062,2.0,794.0,794.0
0.012,6,13,3735,7,497,1.0,125.0,125.0,6,3238,2.0,1470.0,1459.0
0.101,6,10,1506,5,395,23.0,127.0,127.0,5,1111,23.0,843.0,843.0
0.004,17,4,284,2,120,0.0,32.0,32.0,2,164,1.0,60.0,54.0
11.276,17,28,4424,14,1995,854.0,270.0,114.0,14,2429,853.0,588.0,145.0
0.079,6,10,1506,5,395,17.0,127.0,127.0,5,1111,15.0,843.0,843.0
0.006,6,10,2006,5,927,1.0,659.0,659.0,5,1079,1.0,811.0,811.0
0.041,17,2,170,1,65,0.0,37.0,37.0,1,105,0.0,77.0,77.0
0.005,6,10,2006,5,927,1.0,659.0,659.0,5,1079,1.0,811.0,811.0
0.005,6,10,1989,5,927,1.0,659.0,659.0,5,1062,1.0,794.0,794.0
0.004,17,2,186,1,61,0.0,33.0,33.0,1,125,0.0,97.0,97.0
0.005,17,2,209,1,64,0.0,36.0,36.0,1,145,0.0,117.0,117.0
240.503,6,33,8638,17,1838,15029.0,571.0,189.0,16,6800,16031.0,1402.0,597.0
0.055,6,10,1506,5,395,12.0,127.0,127.0,5,1111,13.0,843.0,843.0
0.004,6,10,2006,5,927,1.0,659.0,659.0,5,1079,1.0,811.0,811.0
0.005,6,13,3690,7,452,0.0,80.0,80.0,6,3238,1.0,1470.0,1459.0
0.005,17,2,247,1,72,0.0,44.0,44.0,1,175,0.0,147.0,147.0
0.005,6,10,1989,5,927,1.0,659.0,659.0,5,1062,1.0,794.0,794.0
0.01,17,2,169,1,62,0.0,34.0,34.0,1,107,0.0,79.0,79.0
0.005,17,2,144,1,64,0.0,36.0,36.0,1,80,0.0,52.0,52.0
0.009,6,12,1926,6,1189,1.0,659.0,434.0,6,737,1.0,417.0,417.0
0.007,6,10,2007,5,928,1.0,660.0,660.0,5,1079,1.0,811.0,811.0
0.014,6,10,1677,5,827,3.0,559.0,559.0,5,850,3.0,582.0,582.0
0.229,6,16,2811,8,1429,32.0,533.0,335.0,8,1382,21.0,529.0,239.0
0.005,17,2,170,1,65,0.0,37.0,37.0,1,105,0.0,77.0,77.0
0.013,6,13,3735,7,497,2.0,125.0,125.0,6,3238,2.0,1470.0,1459.0
0.013,6,10,1972,5,910,3.0,642.0,642.0,5,1062,3.0,794.0,794.0
0.01,6,10,1631,5,848,2.0,580.0,580.0,5,783,2.0,515.0,515.0
1770.659,17,120,11460,60,5460,30010.0,63.0,63.0,60,6000,30010.0,72.0,72.0
240.111,6,16,4480,9,963,30013.0,238.0,166.0,7,3517,40018.0,1402.0,786.0
0.012,6,10,1983,5,910,3.0,642.0,642.0,5,1073,2.0,805.0,805.0
65.782,6,27,18206,15,10262,4698.0,2804.0,1579.0,12,7944,5965.0,2315.0,1218.0
0.008,6,10,1989,5,910,2.0,642.0,642.0,5,1079,2.0,811.0,811.0
40.078,17,10,676,5,460,10018.0,104.0,64.0,5,216,10018.0,20.0,15.0
0.011,6,10,1972,5,910,2.0,642.0,642.0,5,1062,2.0,794.0,794.0
11.033,17,28,4399,14,2313,840.0,588.0,137.0,14,2086,840.0,269.0,121.0
0.007,6,10,1989,5,927,1.0,659.0,659.0,5,1062,1.0,794.0,794.0
0.013,6,10,1972,5,910,3.0,642.0,642.0,5,1062,3.0,794.0,794.0
0.004,6,10,2007,5,928,1.0,660.0,660.0,5,1079,1.0,811.0,811.0
0.28,17,38,20153,21,17030,14.0,1350.0,782.0,17,3123,13.0,1350.0,155.0
0.027,6,14,3787,7,497,4.0,125.0,125.0,7,3290,4.0,1448.0,972.0
0.012,6,10,1972,5,910,3.0,642.0,642.0,5,1062,3.0,794.0,794.0
0.009,6,10,1972,5,910,2.0,642.0,642.0,5,1062,2.0,794.0,794.0
0.005,6,10,1643,5,860,1.0,592.0,592.0,5,783,1.0,515.0,515.0
292.263,6,396,347960,202,22057,1454.0,2736.0,888.0,194,325903,1514.0,2804.0,1764.0
0.007,17,2,179,1,71,0.0,43.0,43.0,1,108,0.0,80.0,80.0
0.005,17,2,170,1,65,0.0,37.0,37.0,1,105,0.0,77.0,77.0
0.15,6,10,1506,5,395,36.0,127.0,127.0,5,1111,33.0,843.0,843.0
0.001,17,2,142,1,63,0.0,35.0,35.0,1,79,0.0,51.0,51.0
0.003,6,10,1702,5,863,0.0,595.0,595.0,5,839,0.0,571.0,571.0
0.066,17,8,3613,4,1874,22.0,1350.0,440.0,4,1739,10.0,1350.0,406.0
0.001,17,2,180,1,66,0.0,38.0,38.0,1,114,0.0,86.0,86.0
160.76,58,5,360,4,288,53586.0,24.0,24.0,1,72,0.0,24.0,24.0
0.083,6,10,1506,5,395,19.0,127.0,127.0,5,1111,18.0,843.0,843.0
0.011,6,10,1983,5,910,2.0,642.0,642.0,5,1073,2.0,805.0,805.0
40.053,17,10,676,5,460,10012.0,104.0,64.0,5,216,10012.0,20.0,15.0
173.269,17,86,12487,43,2890,4125.0,44.0,39.0,43,9597,4125.0,239.0,195.0
0.004,6,10,1989,5,927,1.0,659.0,659.0,5,1062,1.0,794.0,794.0
0.005,6,12,1698,6,863,1.0,327.0,271.0,6,835,1.0,515.0,515.0
0.005,6,10,2006,5,927,1.0,659.0,659.0,5,1079,1.0,811.0,811.0
0.119,6,10,1506,5,395,27.0,127.0,127.0,5,1111,25.0,843.0,843.0
0.008,6,10,1972,5,910,2.0,642.0,642.0,5,1062,2.0,794.0,794.0
0.006,17,2,170,1,65,0.0,37.0,37.0,1,105,0.0,77.0,77.0
0.005,6,10,1689,5,839,1.0,571.0,571.0,5,850,1.0,582.0,582.0
0.059,6,10,1506,5,395,12.0,127.0,127.0,5,1111,13.0,843.0,843.0
40.055,17,10,676,5,460,10011.0,104.0,64.0,5,216,10012.0,20.0,15.0
0.005,17,2,180,1,66,0.0,38.0,38.0,1,114,0.0,86.0,86.0
0.001,17,2,136,1,60,0.0,32.0,32.0,1,76,0.0,48.0,48.0
0.005,17,2,193,1,71,0.0,43.0,43.0,1,122,0.0,94.0,94.0
0.005,6,10,2006,5,927,1.0,659.0,659.0,5,1079,1.0,811.0,811.0
0.009,6,10,1990,5,911,2.0,643.0,643.0,5,1079,2.0,811.0,811.0
0.01,6,12,1926,6,1189,1.0,659.0,434.0,6,737,1.0,417.0,417.0
0.006,6,10,1689,5,839,1.0,571.0,571.0,5,850,1.0,582.0,582.0
0.008,17,2,194,1,59,0.0,31.0,31.0,1,135,0.0,107.0,107.0
0.006,6,10,2006,5,927,1.0,659.0,659.0,5,1079,1.0,811.0,811.0
0.006,6,10,1547,5,764,1.0,496.0,496.0,5,783,1.0,515.0,515.0
0.007,6,10,1972,5,910,1.0,642.0,642.0,5,1062,1.0,794.0,794.0
0.006,17,2,144,1,64,0.0,36.0,36.0,1,80,0.0,52.0,52.0
0.004,6,10,2007,5,928,1.0,660.0,660.0,5,1079,1.0,811.0,811.0
40.062,17,10,676,5,460,10014.0,104.0,64.0,5,216,10014.0,20.0,15.0
0.012,6,10,1989,5,910,3.0,642.0,642.0,5,1079,3.0,811.0,811.0
0.07,6,10,1506,5,395,16.0,127.0,127.0,5,1111,14.0,843.0,843.0
1787.652,6,309,98065,190,86633,9458.0,2001.0,685.0,119,11432,15149.0,452.0,70.0
175.447,17,72,10102,36,2393,5012.0,44.0,38.0,36,7709,5012.0,239.0,186.0
240.314,6,22,11452,13,6874,20026.0,2736.0,1033.0,9,4578,30038.0,1656.0,1367.0
0.005,6,10,1854,5,889,1.0,621.0,621.0,5,965,1.0,697.0,697.0
0.096,6,10,1506,5,395,20.0,127.0,127.0,5,1111,22.0,843.0,843.0
503.649,6,29,9278,16,4466,33576.0,1402.0,518.0,13,4812,36966.0,1402.0,688.0
240.113,6,32,9383,16,6898,16007.0,1970.0,674.0,16,2485,16007.0,580.0,205.0
0.014,6,10,1983,5,910,3.0,642.0,642.0,5,1073,3.0,805.0,805.0
0.041,17,2,148,1,60,0.0,32.0,32.0,1,88,0.0,60.0,60.0
0.115,6,10,1506,5,395,27.0,127.0,127.0,5,1111,26.0,843.0,843.0
0.096,6,10,1506,5,395,21.0,127.0,127.0,5,1111,21.0,843.0,843.0
0.016,6,10,1762,5,911,4.0,643.0,643.0,5,851,4.0,583.0,583.0
10.919,17,28,4422,14,1995,831.0,270.0,114.0,14,2427,831.0,586.0,145.0
0.14,6,10,1506,5,395,30.0,127.0,127.0,5,1111,32.0,843.0,843.0
0.005,6,10,1779,5,928,1.0,660.0,660.0,5,851,1.0,583.0,583.0
300.313,6,16,2170,9,684,37519.0,146.0,146.0,7,1486,50025.0,419.0,398.0
361.77,6,21,1792,16,1030,24118.0,190.0,190.0,5,762,60009.0,461.0,247.0
367.282,6,22,2313,16,867,24485.0,195.0,195.0,6,1446,4666.0,419.0,398.0
0.053,6,10,1990,5,911,13.0,643.0,643.0,5,1079,13.0,811.0,811.0
0.007,17,2,179,1,71,0.0,43.0,43.0,1,108,0.0,80.0,80.0
0.13,6,10,1506,5,395,29.0,127.0,127.0,5,1111,25.0,843.0,843.0
0.004,6,10,1989,5,927,1.0,659.0,659.0,5,1062,1.0,794.0,794.0
0.005,6,10,2000,5,927,1.0,659.0,659.0,5,1073,1.0,805.0,805.0
0.005,17,2,170,1,65,0.0,37.0,37.0,1,105,0.0,77.0,77.0
0.112,6,10,1506,5,395,22.0,127.0,127.0,5,1111,23.0,843.0,843.0
0.052,17,4,420,2,122,0.0,33.0,33.0,2,298,34.0,145.0,121.0
0.005,6,10,2006,5,927,1.0,659.0,659.0,5,1079,1.0,811.0,811.0
0.014,6,10,1989,5,910,3.0,642.0,642.0,5,1079,3.0,811.0,811.0
0.092,6,10,1506,5,395,15.0,127.0,127.0,5,1111,21.0,843.0,843.0
0.014,6,10,1762,5,911,3.0,643.0,643.0,5,851,3.0,583.0,583.0
0.013,6,10,1989,5,910,3.0,642.0,642.0,5,1079,3.0,811.0,811.0
0.005,17,2,144,1,64,0.0,36.0,36.0,1,80,0.0,52.0,52.0
0.009,6,10,1989,5,910,2.0,642.0,642.0,5,1079,2.0,811.0,811.0
240.419,6,35,8921,18,2070,14142.0,691.0,225.0,17,6851,15025.0,1402.0,597.0
0.001,17,2,268,1,70,0.0,42.0,42.0,1,198,0.0,170.0,170.0
0.004,6,10,1989,5,927,1.0,659.0,659.0,5,1062,1.0,794.0,794.0
0.004,6,10,1989,5,927,1.0,659.0,659.0,5,1062,1.0,794.0,794.0
0.013,6,10,1762,5,911,3.0,643.0,643.0,5,851,3.0,583.0,583.0
0.005,6,10,2000,5,927,1.0,659.0,659.0,5,1073,1.0,805.0,805.0
0.037,6,14,3868,7,578,6.0,206.0,206.0,7,3290,6.0,1448.0,972.0
0.011,6,10,1990,5,911,2.0,643.0,643.0,5,1079,2.0,811.0,811.0
0.024,6,10,1983,5,910,5.0,642.0,642.0,5,1073,5.0,805.0,805.0
0.039,17,4,284,2,120,0.0,32.0,32.0,2,164,33.0,60.0,54.0
0.096,6,10,1506,5,395,18.0,127.0,127.0,5,1111,21.0,843.0,843.0
0.005,6,10,2006,5,927,1.0,659.0,659.0,5,1079,1.0,811.0,811.0
0.008,17,4,284,2,120,0.0,32.0,32.0,2,164,1.0,60.0,54.0
1777.321,6,230,45781,108,33516,16610.0,2474.0,996.0,122,12265,14688.0,580.0,62.0
0.004,6,10,2000,5,927,1.0,659.0,659.0,5,1073,1.0,805.0,805.0
0.004,6,10,1702,5,863,1.0,595.0,595.0,5,839,0.0,571.0,571.0
0.112,6,10,1506,5,395,23.0,127.0,127.0,5,1111,25.0,843.0,843.0
0.006,6,10,1547,5,764,1.0,496.0,496.0,5,783,1.0,515.0,515.0
0.039,17,2,182,1,65,0.0,37.0,37.0,1,117,0.0,89.0,89.0
0.011,6,10,1990,5,911,2.0,643.0,643.0,5,1079,2.0,811.0,811.0
0.012,6,10,1972,5,910,2.0,642.0,642.0,5,1062,3.0,794.0,794.0
0.006,6,10,2006,5,927,1.0,659.0,659.0,5,1079,1.0,811.0,811.0
0.076,6,10,1506,5,395,12.0,127.0,127.0,5,1111,18.0,843.0,843.0
0.013,6,10,1983,5,910,3.0,642.0,642.0,5,1073,3.0,805.0,805.0
0.005,6,10,2007,5,928,1.0,660.0,660.0,5,1079,1.0,811.0,811.0
0.006,6,10,1854,5,889,1.0,621.0,621.0,5,965,1.0,697.0,697.0
0.092,6,10,1506,5,395,22.0,127.0,127.0,5,1111,18.0,843.0,843.0
47.566,6,24,5106,13,1134,3963.0,180.0,75.0,11,3972,4756.0,1591.0,678.0
0.09,6,10,1506,5,395,15.0,127.0,127.0,5,1111,19.0,843.0,843.0
0.006,6,10,1547,5,764,1.0,496.0,496.0,5,783,1.0,515.0,515.0
0.006,17,2,170,1,65,0.0,37.0,37.0,1,105,0.0,77.0,77.0
0.006,6,10,1854,5,889,1.0,621.0,621.0,5,965,1.0,697.0,697.0
0.109,6,10,1506,5,395,24.0,127.0,127.0,5,1111,25.0,843.0,843.0
0.006,6,12,1698,6,863,1.0,327.0,271.0,6,835,1.0,515.0,515.0
0.015,6,10,1989,5,910,3.0,642.0,642.0,5,1079,3.0,811.0,811.0
0.003,17,2,144,1,64,0.0,36.0,36.0,1,80,0.0,52.0,52.0
0.005,6,10,1689,5,839,1.0,571.0,571.0,5,850,1.0,582.0,582.0
15.216,17,38,20045,21,17039,759.0,1350.0,783.0,17,3006,948.0,1350.0,148.0
0.087,6,10,1506,5,395,19.0,127.0,127.0,5,1111,20.0,843.0,843.0
0.01,6,10,1677,5,827,2.0,559.0,559.0,5,850,2.0,582.0,582.0
0.005,17,2,148,1,60,0.0,32.0,32.0,1,88,0.0,60.0,60.0
0.022,6,10,1983,5,910,5.0,642.0,642.0,5,1073,5.0,805.0,805.0
0.009,6,10,1983,5,910,2.0,642.0,642.0,5,1073,2.0,805.0,805.0
0.005,6,10,2006,5,927,1.0,659.0,659.0,5,1079,1.0,811.0,811.0
0.119,6,14,4389,8,923,17.0,238.0,166.0,6,3466,15.0,1402.0,786.0
0.014,6,10,1990,5,911,3.0,643.0,643.0,5,1079,3.0,811.0,811.0
0.082,6,10,1506,5,395,18.0,127.0,127.0,5,1111,16.0,843.0,843.0
0.004,17,2,148,1,60,0.0,32.0,32.0,1,88,0.0,60.0,60.0
0.005,6,10,2007,5,928,1.0,660.0,660.0,5,1079,1.0,811.0,811.0
0.008,6,10,2006,5,927,2.0,659.0,659.0,5,1079,2.0,811.0,811.0
0.004,6,10,2007,5,928,1.0,660.0,660.0,5,1079,1.0,811.0,811.0
0.006,17,2,179,1,71,0.0,43.0,43.0,1,108,0.0,80.0,80.0
0.001,17,2,180,1,66,0.0,38.0,38.0,1,114,0.0,86.0,86.0
0.008,17,2,140,1,62,0.0,34.0,34.0,1,78,0.0,50.0,50.0
0.001,17,2,180,1,66,0.0,38.0,38.0,1,114,0.0,86.0,86.0
0.081,6,10,1506,5,395,17.0,127.0,127.0,5,1111,18.0,843.0,843.0
0.005,6,10,2007,5,928,1.0,660.0,660.0,5,1079,1.0,811.0,811.0
0.104,6,10,1506,5,395,25.0,127.0,127.0,5,1111,25.0,843.0,843.0
0.005,6,10,1779,5,928,1.0,660.0,660.0,5,851,1.0,583.0,583.0
0.006,6,10,2000,5,927,1.0,659.0,659.0,5,1073,1.0,805.0,805.0
0.005,17,2,144,1,64,0.0,36.0,36.0,1,80,0.0,52.0,52.0
0.001,17,2,180,1,66,0.0,38.0,38.0,1,114,0.0,86.0,86.0
0.01,6,10,1983,5,910,2.0,642.0,642.0,5,1073,2.0,805.0,805.0
0.016,6,10,1972,5,910,4.0,642.0,642.0,5,1062,3.0,794.0,794.0
0.015,6,10,1989,5,910,3.0,642.0,642.0,5,1079,3.0,811.0,811.0
0.006,6,10,1689,5,839,1.0,571.0,571.0,5,850,1.0,582.0,582.0
503.749,6,27,5019,15,2543,35982.0,676.0,348.0,12,2476,40339.0,824.0,307.0
0.144,6,10,1506,5,395,32.0,127.0,127.0,5,1111,31.0,843.0,843.0
0.005,6,13,3747,7,509,0.0,137.0,137.0,6,3238,0.0,1470.0,1459.0
0.022,6,10,1983,5,910,5.0,642.0,642.0,5,1073,5.0,805.0,805.0
0.013,6,10,1989,5,910,3.0,642.0,642.0,5,1079,3.0,811.0,811.0
0.005,6,10,1989,5,927,1.0,659.0,659.0,5,1062,1.0,794.0,794.0
0.012,6,10,1762,5,911,3.0,643.0,643.0,5,851,2.0,583.0,583.0
0.005,6,10,2006,5,927,1.0,659.0,659.0,5,1079,1.0,811.0,811.0
0.013,6,10,1990,5,911,3.0,643.0,643.0,5,1079,3.0,811.0,811.0
10.871,17,28,4423,14,1994,827.0,269.0,114.0,14,2429,827.0,588.0,145.0
0.006,6,10,2006,5,927,1.0,659.0,659.0,5,1079,1.0,811.0,811.0
0.005,17,2,230,1,68,0.0,40.0,40.0,1,162,0.0,134.0,134.0
0.009,6,10,1990,5,911,2.0,643.0,643.0,5,1079,2.0,811.0,811.0
0.067,17,8,3613,4,1874,22.0,1350.0,440.0,4,1739,11.0,1350.0,406.0
0.064,6,10,1506,5,395,15.0,127.0,127.0,5,1111,14.0,843.0,843.0
0.174,17,2,152,1,76,0.0,48.0,48.0,1,76,0.0,48.0,48.0
0.082,6,10,1506,5,395,17.0,127.0,127.0,5,1111,18.0,843.0,843.0
0.01,17,2,170,1,65,0.0,37.0,37.0,1,105,0.0,77.0,77.0
0.027,6,10,1972,5,910,6.0,642.0,642.0,5,1062,6.0,794.0,794.0
0.008,6,10,1983,5,910,1.0,642.0,642.0,5,1073,2.0,805.0,805.0
0.003,17,2,136,1,60,0.0,32.0,32.0,1,76,0.0,48.0,48.0
0.066,6,10,1506,5,395,14.0,127.0,127.0,5,1111,14.0,843.0,843.0
240.024,6,9,787,5,488,60006.0,232.0,232.0,4,299,80007.0,83.0,83.0
0.01,6,10,1989,5,910,2.0,642.0,642.0,5,1079,2.0,811.0,811.0
0.006,17,2,179,1,71,0.0,43.0,43.0,1,108,0.0,80.0,80.0
0.008,6,10,1989,5,910,1.0,642.0,642.0,5,1079,2.0,811.0,811.0
0.016,6,10,1972,5,910,4.0,642.0,642.0,5,1062,4.0,794.0,794.0
0.017,6,10,1989,5,910,4.0,642.0,642.0,5,1079,4.0,811.0,811.0
0.006,6,10,1854,5,889,1.0,621.0,621.0,5,965,1.0,697.0,697.0
0.012,6,10,1989,5,910,3.0,642.0,642.0,5,1079,3.0,811.0,811.0
40.067,17,10,676,5,460,10014.0,104.0,64.0,5,216,10015.0,20.0,15.0
240.135,6,41,5252,20,2438,12638.0,588.0,196.0,21,2814,12006.0,580.0,190.0
0.007,17,2,194,1,59,0.0,31.0,31.0,1,135,0.0,107.0,107.0
0.007,6,10,1547,5,764,1.0,496.0,496.0,5,783,1.0,515.0,515.0
0.011,6,10,1989,5,910,2.0,642.0,642.0,5,1079,2.0,811.0,811.0
0.014,6,10,1989,5,910,3.0,642.0,642.0,5,1079,3.0,811.0,811.0
0.005,6,10,2006,5,927,1.0,659.0,659.0,5,1079,1.0,811.0,811.0
0.041,17,2,412,1,61,0.0,33.0,33.0,1,351,0.0,323.0,323.0
0.012,6,10,1989,5,910,3.0,642.0,642.0,5,1079,3.0,811.0,811.0
0.102,6,10,1506,5,395,22.0,127.0,127.0,5,1111,21.0,843.0,843.0
0.01,6,10,1989,5,910,2.0,642.0,642.0,5,1079,2.0,811.0,811.0
0.001,17,2,180,1,66,0.0,38.0,38.0,1,114,0.0,86.0,86.0
0.082,6,10,1506,5,395,20.0,127.0,127.0,5,1111,16.0,843.0,843.0
0.006,6,10,1547,5,764,1.0,496.0,496.0,5,783,1.0,515.0,515.0
0.006,6,10,1547,5,764,1.0,496.0,496.0,5,783,1.0,515.0,515.0
1756.243,6,449,65969,253,34688,6969.0,613.0,192.0,196,31281,9005.0,613.0,149.0
0.007,6,10,1972,5,910,1.0,642.0,642.0,5,1062,1.0,794.0,794.0
15.089,17,16,10616,9,8280,1882.0,1350.0,892.0,7,2336,2508.0,1350.0,305.0
0.071,17,8,3613,4,1874,23.0,1350.0,440.0,4,1739,12.0,1350.0,406.0
0.045,6,13,3816,7,578,7.0,206.0,206.0,6,3238,8.0,1470.0,1459.0
0.006,6,10,1547,5,764,1.0,496.0,496.0,5,783,1.0,515.0,515.0
0.004,6,10,1702,5,863,1.0,595.0,595.0,5,839,0.0,571.0,571.0
240.09,6,31,9135,15,6850,17149.0,1975.0,674.0,16,2285,16005.0,580.0,180.0
0.005,6,10,2006,5,927,1.0,659.0,659.0,5,1079,1.0,811.0,811.0
0.018,6,10,1631,5,848,4.0,580.0,580.0,5,783,4.0,515.0,515.0
0.114,6,10,1506,5,395,21.0,127.0,127.0,5,1111,24.0,843.0,843.0
13.144,6,100,43067,53,34786,249.0,1360.0,1052.0,47,8281,282.0,2667.0,255.0
0.113,6,10,1506,5,395,25.0,127.0,127.0,5,1111,25.0,843.0,843.0
0.094,6,10,1506,5,395,22.0,127.0,127.0,5,1111,22.0,843.0,843.0
0.005,6,10,2006,5,927,1.0,659.0,659.0,5,1079,1.0,811.0,811.0
0.014,6,10,1631,5,848,3.0,580.0,580.0,5,783,3.0,515.0,515.0
0.005,6,13,3747,7,509,0.0,137.0,137.0,6,3238,1.0,1470.0,1459.0
0.054,17,2,152,1,76,0.0,48.0,48.0,1,76,0.0,48.0,48.0
0.003,17,2,148,1,60,0.0,32.0,32.0,1,88,0.0,60.0,60.0
0.001,17,2,180,1,66,0.0,38.0,38.0,1,114,0.0,86.0,86.0
11.025,17,28,4421,14,1994,839.0,269.0,114.0,14,2427,839.0,586.0,145.0
0.004,6,10,2007,5,928,1.0,660.0,660.0,5,1079,1.0,811.0,811.0
15.099,17,15,8610,8,6406,2151.0,1350.0,772.0,7,2204,2509.0,1350.0,286.0
0.004,17,4,284,2,120,0.0,32.0,32.0,2,164,1.0,60.0,54.0
425.323,6,29,4409,12,3102,10911.0,494.0,494.0,17,1307,26582.0,83.0,83.0
40.075,17,10,676,5,460,10018.0,104.0,64.0,5,216,10018.0,20.0,15.0
0.071,17,8,3613,4,1874,23.0,1350.0,440.0,4,1739,12.0,1350.0,406.0
0.083,6,10,1506,5,395,16.0,127.0,127.0,5,1111,19.0,843.0,843.0
0.014,6,10,1990,5,911,3.0,643.0,643.0,5,1079,3.0,811.0,811.0
0.004,17,2,136,1,60,0.0,32.0,32.0,1,76,0.0,48.0,48.0
0.013,6,10,2000,5,927,3.0,659.0,659.0,5,1073,3.0,805.0,805.0
0.011,6,10,1989,5,910,2.0,642.0,642.0,5,1079,2.0,811.0,811.0
0.005,17,2,166,1,75,0.0,47.0,47.0,1,91,0.0,63.0,63.0
0.06,6,10,1677,5,827,15.0,559.0,559.0,5,850,14.0,582.0,582.0
0.004,6,10,1774,5,923,1.0,655.0,655.0,5,851,1.0,583.0,583.0
0.005,6,10,2000,5,927,1.0,659.0,659.0,5,1073,1.0,805.0,805.0
0.005,6,10,2006,5,927,1.0,659.0,659.0,5,1079,1.0,811.0,811.0
0.003,17,2,148,1,60,0.0,32.0,32.0,1,88,0.0,60.0,60.0
0.005,6,10,1547,5,764,1.0,496.0,496.0,5,783,1.0,515.0,515.0
0.005,17,2,214,1,75,0.0,47.0,47.0,1,139,0.0,111.0,111.0
369.435,6,22,2313,16,867,24629.0,195.0,195.0,6,1446,4641.0,419.0,398.0
124.63,58,5,360,4,288,41543.0,24.0,24.0,1,72,0.0,24.0,24.0
0.008,6,10,1989,5,910,2.0,642.0,642.0,5,1079,2.0,811.0,811.0
0.005,6,10,1989,5,927,1.0,659.0,659.0,5,1062,1.0,794.0,794.0
0.085,6,10,1506,5,395,20.0,127.0,127.0,5,1111,16.0,843.0,843.0
0.006,6,10,1547,5,764,1.0,496.0,496.0,5,783,1.0,515.0,515.0
0.004,6,10,2006,5,927,1.0,659.0,659.0,5,1079,1.0,811.0,811.0
10.877,17,28,4422,14,1994,828.0,269.0,114.0,14,2428,828.0,587.0,145.0
412.286,6,29,4409,12,3102,10914.0,494.0,494.0,17,1307,25767.0,83.0,83.0
0.012,6,10,1989,5,910,3.0,642.0,642.0,5,1079,3.0,811.0,811.0
0.072,6,10,1506,5,395,15.0,127.0,127.0,5,1111,16.0,843.0,843.0
0.018,6,10,1762,5,911,4.0,643.0,643.0,5,851,4.0,583.0,583.0
0.005,17,2,170,1,65,0.0,37.0,37.0,1,105,0.0,77.0,77.0
0.011,6,10,1677,5,827,2.0,559.0,559.0,5,850,2.0,582.0,582.0
0.032,6,13,3816,7,578,5.0,206.0,206.0,6,3238,6.0,1470.0,1459.0
0.1,6,10,1506,5,395,21.0,127.0,127.0,5,1111,20.0,843.0,843.0
0.007,6,10,1989,5,910,1.0,642.0,642.0,5,1079,1.0,811.0,811.0
0.04,17,2,148,1,60,0.0,32.0,32.0,1,88,0.0,60.0,60.0
0.006,17,2,179,1,71,0.0,43.0,43.0,1,108,0.0,80.0,80.0
1772.826,17,120,11460,60,5460,30047.0,63.0,63.0,60,6000,30047.0,72.0,72.0
0.005,6,14,3736,7,446,0.0,74.0,74.0,7,3290,0.0,1448.0,972.0
40.072,17,10,676,5,460,10017.0,104.0,64.0,5,216,10017.0,20.0,15.0
0.01,6,10,1972,5,910,2.0,642.0,642.0,5,1062,2.0,794.0,794.0
0.001,17,2,180,1,65,0.0,37.0,37.0,1,115,0.0,87.0,87.0
0.004,6,10,1779,5,928,1.0,660.0,660.0,5,851,0.0,583.0,583.0
0.093,6,10,1506,5,395,20.0,127.0,127.0,5,1111,19.0,843.0,843.0
0.009,6,10,1972,5,910,2.0,642.0,642.0,5,1062,2.0,794.0,794.0
0.005,17,2,166,1,75,0.0,47.0,47.0,1,91,0.0,63.0,63.0
0.014,6,10,1990,5,911,3.0,643.0,643.0,5,1079,3.0,811.0,811.0
0.109,6,10,1506,5,395,25.0,127.0,127.0,5,1111,22.0,843.0,843.0
0.007,6,12,1698,6,863,1.0,327.0,271.0,6,835,1.0,515.0,515.0
0.01,6,10,1983,5,910,2.0,642.0,642.0,5,1073,2.0,805.0,805.0
0.003,17,2,136,1,60,0.0,32.0,32.0,1,76,0.0,48.0,48.0
11.141,17,28,4423,14,1994,844.0,269.0,114.0,14,2429,844.0,588.0,145.0
1787.315,6,151,19402,90,13740,20081.0,302.0,302.0,61,5662,29788.0,83.0,83.0
0.005,6,10,2006,5,927,1.0,659.0,659.0,5,1079,1.0,811.0,811.0
0.043,6,10,1989,5,910,10.0,642.0,642.0,5,1079,10.0,811.0,811.0
0.014,6,10,1989,5,910,3.0,642.0,642.0,5,1079,3.0,811.0,811.0
0.024,6,10,1972,5,910,5.0,642.0,642.0,5,1062,6.0,794.0,794.0
0.005,17,2,164,1,74,0.0,46.0,46.0,1,90,0.0,62.0,62.0
0.011,6,10,1677,5,827,2.0,559.0,559.0,5,850,2.0,582.0,582.0
0.102,6,10,1506,5,395,23.0,127.0,127.0,5,1111,24.0,843.0,843.0
0.005,6,10,2006,5,927,1.0,659.0,659.0,5,1079,1.0,811.0,811.0
0.094,6,10,1506,5,395,20.0,127.0,127.0,5,1111,19.0,843.0,843.0
0.006,6,12,1698,6,863,1.0,327.0,271.0,6,835,1.0,515.0,515.0
0.042,17,2,152,1,76,0.0,48.0,48.0,1,76,0.0,48.0,48.0
0.01,6,10,1989,5,910,2.0,642.0,642.0,5,1079,2.0,811.0,811.0
0.202,6,16,2777,8,1395,28.0,533.0,323.0,8,1382,18.0,529.0,239.0
0.019,6,10,1972,5,910,4.0,642.0,642.0,5,1062,4.0,794.0,794.0
15.07,17,15,9238,8,6902,2148.0,1350.0,834.0,7,2336,2506.0,1350.0,305.0
0.088,6,10,1506,5,395,19.0,127.0,127.0,5,1111,19.0,843.0,843.0
0.01,6,10,1983,5,910,2.0,642.0,642.0,5,1073,2.0,805.0,805.0
0.014,6,10,1677,5,827,3.0,559.0,559.0,5,850,3.0,582.0,582.0
0.006,6,10,1547,5,764,1.0,496.0,496.0,5,783,1.0,515.0,515.0
0.069,6,10,1506,5,395,14.0,127.0,127.0,5,1111,14.0,843.0,843.0
40.055,17,10,676,5,460,10012.0,104.0,64.0,5,216,10011.0,20.0,15.0
0.005,6,10,2007,5,928,1.0,660.0,660.0,5,1079,1.0,811.0,811.0
0.008,17,2,194,1,59,0.0,31.0,31.0,1,135,0.0,107.0,107.0
0.006,6,10,1689,5,839,1.0,571.0,571.0,5,850,1.0,582.0,582.0
0.004,6,10,1989,5,927,1.0,659.0,659.0,5,1062,1.0,794.0,794.0
0.013,6,10,1972,5,910,3.0,642.0,642.0,5,1062,3.0,794.0,794.0
0.034,6,10,1677,5,827,8.0,559.0,559.0,5,850,8.0,582.0,582.0
0.013,6,10,1990,5,911,3.0,643.0,643.0,5,1079,3.0,811.0,811.0
0.086,6,10,1506,5,395,18.0,127.0,127.0,5,1111,19.0,843.0,843.0
0.004,6,10,1779,5,928,1.0,660.0,660.0,5,851,1.0,583.0,583.0
0.038,17,2,136,1,60,0.0,32.0,32.0,1,76,0.0,48.0,48.0
0.005,6,10,2007,5,928,1.0,660.0,660.0,5,1079,1.0,811.0,811.0
0.121,6,10,1506,5,395,24.0,127.0,127.0,5,1111,25.0,843.0,843.0
0.135,6,10,1506,5,395,30.0,127.0,127.0,5,1111,32.0,843.0,843.0
0.006,6,10,1547,5,764,1.0,496.0,496.0,5,783,1.0,515.0,515.0
0.021,6,10,1989,5,910,5.0,642.0,642.0,5,1079,5.0,811.0,811.0
0.006,6,10,2006,5,927,1.0,659.0,659.0,5,1079,1.0,811.0,811.0
0.008,6,10,2000,5,927,2.0,659.0,659.0,5,1073,2.0,805.0,805.0
0.005,6,10,2006,5,927,1.0,659.0,659.0,5,1079,1.0,811.0,811.0
11.188,17,28,4420,14,1993,848.0,268.0,114.0,14,2427,848.0,586.0,145.0
11.177,17,28,4419,14,1994,847.0,269.0,114.0,14,2425,847.0,588.0,145.0
0.005,6,10,1989,5,927,1.0,659.0,659.0,5,1062,1.0,794.0,794.0
0.005,6,10,2006,5,927,1.0,659.0,659.0,5,1079,1.0,811.0,811.0
0.006,17,2,164,1,74,0.0,46.0,46.0,1,90,0.0,62.0,62.0
0.005,17,2,170,1,65,0.0,37.0,37.0,1,105,0.0,77.0,77.0
309.432,17,19,1084,10,716,34368.0,48.0,43.0,9,368,38663.0,20.0,12.0
0.005,6,10,2007,5,928,1.0,660.0,660.0,5,1079,1.0,811.0,811.0
0.022,6,14,3787,7,497,3.0,125.0,125.0,7,3290,3.0,1448.0,972.0
40.056,17,10,676,5,460,10010.0,104.0,64.0,5,216,10013.0,20.0,15.0
0.015,6,10,1762,5,911,3.0,643.0,643.0,5,851,3.0,583.0,583.0
0.001,17,2,180,1,66,0.0,38.0,38.0,1,114,0.0,86.0,86.0
0.013,6,10,1989,5,910,3.0,642.0,642.0,5,1079,3.0,811.0,811.0
0.083,6,10,1506,5,395,17.0,127.0,127.0,5,1111,18.0,843.0,843.0
1799.149,6,488,99332,244,87982,7403.0,421.0,365.0,244,11350,7402.0,53.0,53.0
40.072,17,10,676,5,460,10015.0,104.0,64.0,5,216,10016.0,20.0,15.0
0.082,6,10,1506,5,395,16.0,127.0,127.0,5,1111,16.0,843.0,843.0
0.004,6,10,1774,5,923,1.0,655.0,655.0,5,851,1.0,583.0,583.0
0.129,17,2,80,1,32,0.0,4.0,4.0,1,48,0.0,20.0,20.0
0.099,6,10,1506,5,395,19.0,127.0,127.0,5,1111,20.0,843.0,843.0
308.451,17,20,1124,10,716,34257.0,48.0,43.0,10,408,34257.0,20.0,12.0
0.005,6,10,1989,5,927,1.0,659.0,659.0,5,1062,1.0,794.0,794.0
0.122,6,10,1506,5,395,27.0,127.0,127.0,5,1111,26.0,843.0,843.0
0.005,6,10,2006,5,927,1.0,659.0,659.0,5,1079,1.0,811.0,811.0
0.005,6,10,2006,5,927,1.0,659.0,659.0,5,1079,1.0,811.0,811.0
0.006,17,2,136,1,60,0.0,32.0,32.0,1,76,0.0,48.0,48.0
0.087,6,10,1506,5,395,18.0,127.0,127.0,5,1111,17.0,843.0,843.0
0.012,6,10,1989,5,910,3.0,642.0,642.0,5,1079,2.0,811.0,811.0
0.085,6,10,1506,5,395,18.0,127.0,127.0,5,1111,14.0,843.0,843.0
0.017,6,10,1972,5,910,4.0,642.0,642.0,5,1062,4.0,794.0,794.0
0.001,17,2,180,1,66,0.0,38.0,38.0,1,114,0.0,86.0,86.0
0.004,6,10,2000,5,927,1.0,659.0,659.0,5,1073,1.0,805.0,805.0
240.078,6,16,4482,9,963,30009.0,238.0,166.0,7,3519,40012.0,1402.0,786.0
0.006,17,2,169,1,62,0.0,34.0,34.0,1,107,0.0,79.0,79.0
300.359,6,16,2170,9,684,37524.0,146.0,146.0,7,1486,50031.0,419.0,398.0
1169.7,6,196,19841,96,6762,12312.0,748.0,295.0,100,13079,11814.0,1625.0,82.0
40.073,17,10,676,5,460,10017.0,104.0,64.0,5,216,10017.0,20.0,15.0
0.121,6,10,1506,5,395,28.0,127.0,127.0,5,1111,28.0,843.0,843.0
0.004,6,10,1989,5,927,1.0,659.0,659.0,5,1062,1.0,794.0,794.0
0.008,6,10,1990,5,911,1.0,643.0,643.0,5,1079,2.0,811.0,811.0
0.001,17,2,140,1,62,0.0,34.0,34.0,1,78,0.0,50.0,50.0
0.006,6,10,1854,5,889,1.0,621.0,621.0,5,965,1.0,697.0,697.0
0.005,6,10,1689,5,839,1.0,571.0,571.0,5,850,1.0,582.0,582.0
0.005,6,10,2000,5,927,1.0,659.0,659.0,5,1073,1.0,805.0,805.0
0.011,6,10,1989,5,910,2.0,642.0,642.0,5,1079,2.0,811.0,811.0
0.006,6,10,1547,5,764,1.0,496.0,496.0,5,783,1.0,515.0,515.0
0.005,6,14,3736,7,446,0.0,74.0,74.0,7,3290,0.0,1448.0,972.0
0.046,17,2,156,1,64,0.0,36.0,36.0,1,92,0.0,64.0,64.0
0.087,6,10,1506,5,395,19.0,127.0,127.0,5,1111,18.0,843.0,843.0
0.123,6,10,1506,5,395,29.0,127.0,127.0,5,1111,27.0,843.0,843.0
0.057,6,10,1506,5,395,13.0,127.0,127.0,5,1111,12.0,843.0,843.0
0.009,6,10,1990,5,911,2.0,643.0,643.0,5,1079,2.0,811.0,811.0
0.024,6,10,1762,5,911,6.0,643.0,643.0,5,851,5.0,583.0,583.0
0.008,6,10,1990,5,911,1.0,643.0,643.0,5,1079,2.0,811.0,811.0
0.009,6,10,1990,5,911,2.0,643.0,643.0,5,1079,2.0,811.0,811.0
0.009,6,10,1990,5,911,2.0,643.0,643.0,5,1079,2.0,811.0,811.0
0.005,17,2,179,1,71,0.0,43.0,43.0,1,108,0.0,80.0,80.0
463.446,6,25,4869,14,2479,35649.0,676.0,348.0,11,2390,40341.0,824.0,362.0
0.122,6,10,1506,5,395,20.0,127.0,127.0,5,1111,27.0,843.0,843.0
252.977,6,38,9728,15,6609,18069.0,1733.0,648.0,23,3119,11498.0,580.0,136.0
0.014,6,10,1972,5,910,3.0,642.0,642.0,5,1062,3.0,794.0,794.0
0.017,17,2,198,1,91,0.0,63.0,63.0,1,107,0.0,79.0,79.0
0.079,6,10,1506,5,395,16.0,127.0,127.0,5,1111,19.0,843.0,843.0
0.005,6,14,3799,7,509,0.0,137.0,137.0,7,3290,0.0,1448.0,972.0
0.005,6,10,1779,5,928,1.0,660.0,660.0,5,851,1.0,583.0,583.0
0.009,6,10,1989,5,910,2.0,642.0,642.0,5,1079,2.0,811.0,811.0
0.005,6,10,2007,5,928,1.0,660.0,660.0,5,1079,1.0,811.0,811.0
240.018,6,9,787,5,488,60004.0,232.0,232.0,4,299,80004.0,83.0,83.0
0.005,6,10,1989,5,927,1.0,659.0,659.0,5,1062,1.0,794.0,794.0
0.006,6,10,1643,5,860,1.0,592.0,592.0,5,783,1.0,515.0,515.0
0.005,6,10,2006,5,927,1.0,659.0,659.0,5,1079,1.0,811.0,811.0
240.008,6,9,787,5,488,60002.0,232.0,232.0,4,299,80001.0,83.0,83.0
0.062,6,10,1506,5,395,13.0,127.0,127.0,5,1111,13.0,843.0,843.0
0.005,6,10,2006,5,927,1.0,659.0,659.0,5,1079,1.0,811.0,811.0
310.02,17,20,1124,10,716,34432.0,48.0,43.0,10,408,34431.0,20.0,12.0
0.012,6,10,1989,5,910,2.0,642.0,642.0,5,1079,3.0,811.0,811.0
0.04,17,4,284,2,120,0.0,32.0,32.0,2,164,37.0,60.0,54.0
0.005,17,2,169,1,62,0.0,34.0,34.0,1,107,0.0,79.0,79.0
0.099,6,10,1506,5,395,23.0,127.0,127.0,5,1111,21.0,843.0,843.0
0.006,6,14,3799,7,509,0.0,137.0,137.0,7,3290,0.0,1448.0,972.0
308.485,17,20,1124,10,716,34261.0,48.0,43.0,10,408,34261.0,20.0,12.0
0.071,17,2,136,1,60,0.0,32.0,32.0,1,76,0.0,48.0,48.0
40.056,17,10,676,5,460,10012.0,104.0,64.0,5,216,10013.0,20.0,15.0
1772.26,6,103,6166,59,3473,30555.0,27.0,27.0,44,2693,41214.0,27.0,27.0
0.005,6,10,1779,5,928,1.0,660.0,660.0,5,851,1.0,583.0,583.0
0.007,6,10,1547,5,764,1.0,496.0,496.0,5,783,1.0,515.0,515.0
0.005,6,10,2006,5,927,1.0,659.0,659.0,5,1079,1.0,811.0,811.0
0.164,6,10,1506,5,395,37.0,127.0,127.0,5,1111,36.0,843.0,843.0
0.01,6,10,1677,5,827,2.0,559.0,559.0,5,850,2.0,582.0,582.0
0.016,6,10,1990,5,911,3.0,643.0,643.0,5,1079,4.0,811.0,811.0
0.104,6,10,1506,5,395,22.0,127.0,127.0,5,1111,23.0,843.0,843.0
0.005,17,2,148,1,60,0.0,32.0,32.0,1,88,0.0,60.0,60.0
0.001,17,2,166,1,75,0.0,47.0,47.0,1,91,0.0,63.0,63.0
0.008,6,10,1989,5,910,1.0,642.0,642.0,5,1079,2.0,811.0,811.0
0.004,17,2,136,1,60,0.0,32.0,32.0,1,76,0.0,48.0,48.0
0.005,6,10,2007,5,928,1.0,660.0,660.0,5,1079,1.0,811.0,811.0
40.052,17,10,676,5,460,10012.0,104.0,64.0,5,216,10012.0,20.0,15.0
0.004,6,10,2007,5,928,1.0,660.0,660.0,5,1079,1.0,811.0,811.0
0.004,6,10,1779,5,928,1.0,660.0,660.0,5,851,1.0,583.0,583.0
0.006,6,10,1689,5,839,1.0,571.0,571.0,5,850,1.0,582.0,582.0
0.01,6,10,1989,5,910,2.0,642.0,642.0,5,1079,2.0,811.0,811.0
0.024,6,10,1989,5,910,6.0,642.0,642.0,5,1079,6.0,811.0,811.0
0.108,6,10,1506,5,395,24.0,127.0,127.0,5,1111,20.0,843.0,843.0
1778.01,17,144,45504,72,22752,25039.0,288.0,288.0,72,22752,25041.0,288.0,288.0
0.009,6,12,1926,6,1189,1.0,659.0,434.0,6,737,1.0,417.0,417.0
40.066,17,10,676,5,460,10015.0,104.0,64.0,5,216,10015.0,20.0,15.0
0.003,17,2,148,1,60,0.0,32.0,32.0,1,88,0.0,60.0,60.0
0.109,6,10,1506,5,395,16.0,127.0,127.0,5,1111,23.0,843.0,843.0
0.013,6,10,1972,5,910,3.0,642.0,642.0,5,1062,3.0,794.0,794.0
0.097,6,10,1506,5,395,21.0,127.0,127.0,5,1111,22.0,843.0,843.0
0.103,6,10,1506,5,395,24.0,127.0,127.0,5,1111,24.0,843.0,843.0
0.043,6,10,1983,5,910,10.0,642.0,642.0,5,1073,10.0,805.0,805.0
300.272,6,16,2170,9,684,37513.0,146.0,146.0,7,1486,50018.0,419.0,398.0
0.003,17,4,284,2,120,0.0,32.0,32.0,2,164,0.0,60.0,54.0
0.001,17,2,166,1,75,0.0,47.0,47.0,1,91,0.0,63.0,63.0
0.004,17,2,148,1,60,0.0,32.0,32.0,1,88,0.0,60.0,60.0
0.015,6,13,3913,7,495,2.0,123.0,123.0,6,3418,3.0,1650.0,1549.0
0.015,6,10,1631,5,848,3.0,580.0,580.0,5,783,3.0,515.0,515.0
40.053,17,10,676,5,460,10012.0,104.0,64.0,5,216,10012.0,20.0,15.0
15.182,17,20,11982,10,8288,1683.0,1350.0,800.0,10,3694,1683.0,1350.0,341.0
0.038,17,2,152,1,76,0.0,48.0,48.0,1,76,0.0,48.0,48.0
0.004,6,10,2006,5,927,1.0,659.0,659.0,5,1079,1.0,811.0,811.0
0.553,6,20,3480,10,1537,55.0,533.0,252.0,10,1943,56.0,529.0,283.0
0.012,6,10,1989,5,910,2.0,642.0,642.0,5,1079,3.0,811.0,811.0
0.016,6,10,1989,5,910,4.0,642.0,642.0,5,1079,3.0,811.0,811.0
0.074,6,10,1506,5,395,15.0,127.0,127.0,5,1111,18.0,843.0,843.0
0.004,17,4,284,2,120,0.0,32.0,32.0,2,164,0.0,60.0,54.0
0.004,6,10,1702,5,863,1.0,595.0,595.0,5,839,0.0,571.0,571.0
0.005,6,10,1854,5,889,1.0,621.0,621.0,5,965,1.0,697.0,697.0
0.093,6,10,1506,5,395,20.0,127.0,127.0,5,1111,20.0,843.0,843.0
9.049,17,6,376,5,280,2262.0,28.0,28.0,1,96,0.0,68.0,68.0
0.125,6,10,1506,5,395,28.0,127.0,127.0,5,1111,26.0,843.0,843.0
0.008,17,2,194,1,59,0.0,31.0,31.0,1,135,0.0,107.0,107.0
0.017,6,14,3787,7,497,2.0,125.0,125.0,7,3290,2.0,1448.0,972.0
0.005,6,13,3747,7,509,0.0,137.0,137.0,6,3238,1.0,1470.0,1459.0
0.098,6,10,1506,5,395,22.0,127.0,127.0,5,1111,19.0,843.0,843.0
1787.445,6,151,19402,90,13740,20083.0,302.0,302.0,61,5662,29790.0,83.0,83.0
0.005,6,10,1779,5,928,1.0,660.0,660.0,5,851,1.0,583.0,583.0
0.004,6,10,2007,5,928,1.0,660.0,660.0,5,1079,1.0,811.0,811.0
0.005,6,13,3747,7,509,0.0,137.0,137.0,6,3238,0.0,1470.0,1459.0
0.092,6,10,1506,5,395,18.0,127.0,127.0,5,1111,17.0,843.0,843.0
0.037,17,2,136,1,60,0.0,32.0,32.0,1,76,0.0,48.0,48.0
0.008,6,10,1990,5,911,2.0,643.0,643.0,5,1079,2.0,811.0,811.0
0.009,6,14,3736,7,446,1.0,74.0,74.0,7,3290,1.0,1448.0,972.0
0.011,6,10,1631,5,848,2.0,580.0,580.0,5,783,2.0,515.0,515.0
0.006,6,10,1547,5,764,1.0,496.0,496.0,5,783,1.0,515.0,515.0
0.004,6,10,2000,5,927,1.0,659.0,659.0,5,1073,1.0,805.0,805.0
0.009,6,12,1926,6,1189,1.0,659.0,434.0,6,737,1.0,417.0,417.0
0.017,6,10,1990,5,911,4.0,643.0,643.0,5,1079,4.0,811.0,811.0
0.018,6,10,1989,5,910,4.0,642.0,642.0,5,1079,4.0,811.0,811.0
10.866,17,28,4423,14,1995,827.0,270.0,114.0,14,2428,827.0,587.0,145.0
29.911,6,12,1313,7,557,4985.0,185.0,185.0,5,756,7476.0,476.0,244.0
0.011,6,10,1989,5,910,2.0,642.0,642.0,5,1079,2.0,811.0,811.0
0.01,6,10,1983,5,910,2.0,642.0,642.0,5,1073,2.0,805.0,805.0
0.077,6,10,1506,5,395,18.0,127.0,127.0,5,1111,17.0,843.0,843.0
0.005,6,10,2007,5,928,1.0,660.0,660.0,5,1079,1.0,811.0,811.0
0.004,6,10,1702,5,863,1.0,595.0,595.0,5,839,1.0,571.0,571.0
0.126,17,2,136,1,60,0.0,32.0,32.0,1,76,0.0,48.0,48.0
0.11,6,10,1506,5,395,24.0,127.0,127.0,5,1111,24.0,843.0,843.0
0.009,6,10,1983,5,910,2.0,642.0,642.0,5,1073,2.0,805.0,805.0
0.005,17,2,209,1,64,0.0,36.0,36.0,1,145,0.0,117.0,117.0
0.012,6,10,1989,5,910,3.0,642.0,642.0,5,1079,2.0,811.0,811.0
0.168,6,3,453,2,321,168.0,241.0,241.0,1,132,0.0,92.0,92.0
0.097,6,10,1506,5,395,22.0,127.0,127.0,5,1111,18.0,843.0,843.0
0.13,6,10,1506,5,395,27.0,127.0,127.0,5,1111,28.0,843.0,843.0
0.004,6,10,1779,5,928,1.0,660.0,660.0,5,851,1.0,583.0,583.0
0.005,6,10,1689,5,839,1.0,571.0,571.0,5,850,1.0,582.0,582.0
1770.714,6,135,6510,75,3585,23928.0,39.0,39.0,60,2925,30008.0,35.0,35.0
40.07,17,10,676,5,460,10016.0,104.0,64.0,5,216,10015.0,20.0,15.0
0.005,6,10,1779,5,928,1.0,660.0,660.0,5,851,1.0,583.0,583.0
0.004,17,2,136,1,60,0.0,32.0,32.0,1,76,0.0,48.0,48.0
240.013,6,9,787,5,488,60003.0,232.0,232.0,4,299,80003.0,83.0,83.0
0.013,17,2,152,1,56,0.0,28.0,28.0,1,96,0.0,68.0,68.0
0.042,17,4,284,2,120,0.0,32.0,32.0,2,164,38.0,60.0,54.0
0.005,6,10,2007,5,928,1.0,660.0,660.0,5,1079,1.0,811.0,811.0
0.013,6,10,1989,5,910,3.0,642.0,642.0,5,1079,3.0,811.0,811.0
0.041,17,2,144,1,64,0.0,36.0,36.0,1,80,0.0,52.0,52.0
0.005,6,10,2006,5,927,1.0,659.0,659.0,5,1079,1.0,811.0,811.0
0.015,17,2,136,1,60,0.0,32.0,32.0,1,76,0.0,48.0,48.0
0.004,17,2,136,1,60,0.0,32.0,32.0,1,76,0.0,48.0,48.0
0.013,6,10,1631,5,848,3.0,580.0,580.0,5,783,3.0,515.0,515.0
0.005,6,10,1989,5,927,1.0,659.0,659.0,5,1062,1.0,794.0,794.0
0.005,6,10,2000,5,927,1.0,659.0,659.0,5,1073,1.0,805.0,805.0
0.006,17,2,170,1,65,0.0,37.0,37.0,1,105,0.0,77.0,77.0
0.039,17,2,184,1,61,0.0,33.0,33.0,1,123,0.0,95.0,95.0
0.038,17,4,516,2,122,0.0,33.0,33.0,2,394,0.0,243.0,169.0
0.004,6,14,3736,7,446,0.0,74.0,74.0,7,3290,0.0,1448.0,972.0
316.211,17,20,1124,10,716,35124.0,48.0,43.0,10,408,35123.0,20.0,12.0
0.008,6,12,1926,6,1189,1.0,659.0,434.0,6,737,1.0,417.0,417.0
0.169,17,2,152,1,76,0.0,48.0,48.0,1,76,0.0,48.0,48.0
0.208,6,16,2670,8,1396,29.0,533.0,324.0,8,1274,19.0,529.0,212.0
0.005,6,13,3747,7,509,0.0,137.0,137.0,6,3238,1.0,1470.0,1459.0
0.004,17,2,136,1,60,0.0,32.0,32.0,1,76,0.0,48.0,48.0
0.015,6,10,1990,5,911,3.0,643.0,643.0,5,1079,3.0,811.0,811.0
0.005,17,2,169,1,62,0.0,34.0,34.0,1,107,0.0,79.0,79.0
0.008,6,10,1989,5,927,1.0,659.0,659.0,5,1062,2.0,794.0,794.0
0.006,6,10,1547,5,764,1.0,496.0,496.0,5,783,1.0,515.0,515.0
0.015,17,2,152,1,76,0.0,48.0,48.0,1,76,0.0,48.0,48.0
0.004,17,2,148,1,60,0.0,32.0,32.0,1,88,0.0,60.0,60.0
0.001,17,2,140,1,62,0.0,34.0,34.0,1,78,0.0,50.0,50.0
0.079,6,10,1506,5,395,17.0,127.0,127.0,5,1111,16.0,843.0,843.0
0.017,6,10,1989,5,910,4.0,642.0,642.0,5,1079,4.0,811.0,811.0
0.015,6,10,1972,5,910,3.0,642.0,642.0,5,1062,3.0,794.0,794.0
0.005,17,2,170,1,65,0.0,37.0,37.0,1,105,0.0,77.0,77.0
67.636,6,24,9037,12,3129,99.0,1360.0,654.0,12,5908,6133.0,2720.0,902.0
0.088,6,10,1506,5,395,19.0,127.0,127.0,5,1111,20.0,843.0,843.0
0.011,6,10,1990,5,911,2.0,643.0,643.0,5,1079,2.0,811.0,811.0
0.006,6,10,1547,5,764,1.0,496.0,496.0,5,783,1.0,515.0,515.0
0.015,6,10,1989,5,910,3.0,642.0,642.0,5,1079,3.0,811.0,811.0
0.005,6,10,2006,5,927,1.0,659.0,659.0,5,1079,1.0,811.0,811.0
40.069,17,10,676,5,460,10014.0,104.0,64.0,5,216,10016.0,20.0,15.0
0.01,6,10,1972,5,910,2.0,642.0,642.0,5,1062,2.0,794.0,794.0
0.005,6,14,3799,7,509,0.0,137.0,137.0,7,3290,0.0,1448.0,972.0
0.006,6,10,1547,5,764,1.0,496.0,496.0,5,783,1.0,515.0,515.0
0.012,6,13,3735,7,497,1.0,125.0,125.0,6,3238,2.0,1470.0,1459.0
0.005,6,10,2007,5,928,1.0,660.0,660.0,5,1079,1.0,811.0,811.0
0.146,6,10,1506,5,395,35.0,127.0,127.0,5,1111,33.0,843.0,843.0
40.067,17,10,676,5,460,10016.0,104.0,64.0,5,216,10016.0,20.0,15.0
0.092,6,10,1506,5,395,20.0,127.0,127.0,5,1111,21.0,843.0,843.0
0.083,6,10,1506,5,395,19.0,127.0,127.0,5,1111,17.0,843.0,843.0
0.085,6,10,1506,5,395,20.0,127.0,127.0,5,1111,19.0,843.0,843.0
0.006,6,10,1547,5,764,1.0,496.0,496.0,5,783,1.0,515.0,515.0
0.005,6,10,1689,5,839,1.0,571.0,571.0,5,850,1.0,582.0,582.0
354.041,6,21,1795,16,1030,23602.0,190.0,190.0,5,765,60001.0,464.0,248.0
0.106,6,10,1506,5,395,26.0,127.0,127.0,5,1111,25.0,843.0,843.0
0.005,6,13,3690,7,452,0.0,80.0,80.0,6,3238,0.0,1470.0,1459.0
0.004,6,10,2007,5,928,1.0,660.0,660.0,5,1079,1.0,811.0,811.0
361.859,6,19,1689,15,978,25847.0,190.0,190.0,4,711,80013.0,495.0,495.0
0.006,17,2,154,1,69,0.0,41.0,41.0,1,85,0.0,57.0,57.0
0.001,17,2,136,1,60,0.0,32.0,32.0,1,76,0.0,48.0,48.0
0.085,6,10,1506,5,395,16.0,127.0,127.0,5,1111,20.0,843.0,843.0
0.022,17,2,136,1,60,0.0,32.0,32.0,1,76,0.0,48.0,48.0
0.005,6,10,2000,5,927,1.0,659.0,659.0,5,1073,1.0,805.0,805.0
0.018,6,10,1677,5,827,4.0,559.0,559.0,5,850,4.0,582.0,582.0
0.01,6,10,1983,5,910,2.0,642.0,642.0,5,1073,2.0,805.0,805.0
0.135,17,4,284,2,120,0.0,32.0,32.0,2,164,131.0,60.0,54.0
0.009,6,10,1990,5,911,2.0,643.0,643.0,5,1079,2.0,811.0,811.0
0.06,6,10,1989,5,910,15.0,642.0,642.0,5,1079,14.0,811.0,811.0
0.006,6,10,1547,5,764,1.0,496.0,496.0,5,783,1.0,515.0,515.0
0.004,6,10,2000,5,927,1.0,659.0,659.0,5,1073,1.0,805.0,805.0
0.006,6,10,1689,5,839,1.0,571.0,571.0,5,850,1.0,582.0,582.0
0.003,17,4,284,2,120,0.0,32.0,32.0,2,164,0.0,60.0,54.0
0.006,17,2,179,1,71,0.0,43.0,43.0,1,108,0.0,80.0,80.0
0.008,6,10,1762,5,911,2.0,643.0,643.0,5,851,1.0,583.0,583.0
292.688,6,399,347803,191,21496,1540.0,2736.0,888.0,208,326307,1413.0,2804.0,1626.0
1778.58,17,144,45504,72,22752,25050.0,288.0,288.0,72,22752,25050.0,288.0,288.0
0.101,6,10,1506,5,395,23.0,127.0,127.0,5,1111,19.0,843.0,843.0
0.01,6,10,1989,5,910,2.0,642.0,642.0,5,1079,2.0,811.0,811.0
0.115,6,10,1506,5,395,24.0,127.0,127.0,5,1111,26.0,843.0,843.0
0.067,6,10,1506,5,395,15.0,127.0,127.0,5,1111,13.0,843.0,843.0
0.016,6,10,1989,5,910,4.0,642.0,642.0,5,1079,3.0,811.0,811.0
0.009,6,10,1990,5,911,2.0,643.0,643.0,5,1079,2.0,811.0,811.0
0.038,17,2,186,1,61,0.0,33.0,33.0,1,125,0.0,97.0,97.0
0.124,6,10,1506,5,395,24.0,127.0,127.0,5,1111,29.0,843.0,843.0
0.013,6,10,1983,5,910,3.0,642.0,642.0,5,1073,3.0,805.0,805.0
0.011,6,10,1989,5,910,2.0,642.0,642.0,5,1079,2.0,811.0,811.0
0.005,6,10,2007,5,928,1.0,660.0,660.0,5,1079,1.0,811.0,811.0
0.076,6,10,1506,5,395,16.0,127.0,127.0,5,1111,17.0,843.0,843.0
0.004,17,2,136,1,60,0.0,32.0,32.0,1,76,0.0,48.0,48.0
0.097,6,10,1506,5,395,21.0,127.0,127.0,5,1111,22.0,843.0,843.0
0.086,6,10,1506,5,395,19.0,127.0,127.0,5,1111,18.0,843.0,843.0
0.004,17,2,148,1,60,0.0,32.0,32.0,1,88,0.0,60.0,60.0
0.163,17,2,152,1,76,0.0,48.0,48.0,1,76,0.0,48.0,48.0
0.007,17,2,209,1,64,0.0,36.0,36.0,1,145,0.0,117.0,117.0
0.005,6,13,3747,7,509,0.0,137.0,137.0,6,3238,1.0,1470.0,1459.0
40.076,17,10,676,5,460,10016.0,104.0,64.0,5,216,10018.0,20.0,15.0
0.006,17,2,169,1,62,0.0,34.0,34.0,1,107,0.0,79.0,79.0
0.013,6,10,1972,5,910,3.0,642.0,642.0,5,1062,3.0,794.0,794.0
0.004,17,2,136,1,60,0.0,32.0,32.0,1,76,0.0,48.0,48.0
0.001,17,2,136,1,60,0.0,32.0,32.0,1,76,0.0,48.0,48.0
0.005,17,2,166,1,75,0.0,47.0,47.0,1,91,0.0,63.0,63.0
0.072,6,10,1506,5,395,16.0,127.0,127.0,5,1111,15.0,843.0,843.0
0.005,6,10,2000,5,927,1.0,659.0,659.0,5,1073,1.0,805.0,805.0
0.005,6,10,2006,5,927,1.0,659.0,659.0,5,1079,1.0,811.0,811.0
0.004,6,10,1774,5,923,1.0,655.0,655.0,5,851,1.0,583.0,583.0
0.005,6,10,2006,5,927,1.0,659.0,659.0,5,1079,1.0,811.0,811.0
0.133,6,10,1506,5,395,32.0,127.0,127.0,5,1111,22.0,843.0,843.0
0.004,17,4,284,2,120,0.0,32.0,32.0,2,164,0.0,60.0,54.0
0.08,6,10,1506,5,395,18.0,127.0,127.0,5,1111,17.0,843.0,843.0
0.003,17,2,136,1,60,0.0,32.0,32.0,1,76,0.0,48.0,48.0
0.005,6,10,1689,5,839,1.0,571.0,571.0,5,850,1.0,582.0,582.0
0.006,6,10,1689,5,839,1.0,571.0,571.0,5,850,1.0,582.0,582.0
0.088,6,10,1506,5,395,19.0,127.0,127.0,5,1111,21.0,843.0,843.0
0.007,6,10,1972,5,910,1.0,642.0,642.0,5,1062,1.0,794.0,794.0
308.501,17,20,1124,10,716,34271.0,48.0,43.0,10,408,34271.0,20.0,12.0
0.017,6,10,1631,5,848,4.0,580.0,580.0,5,783,4.0,515.0,515.0
0.076,6,10,1506,5,395,17.0,127.0,127.0,5,1111,14.0,843.0,843.0
0.006,17,2,214,1,75,0.0,47.0,47.0,1,139,0.0,111.0,111.0
0.016,6,10,1990,5,911,4.0,643.0,643.0,5,1079,4.0,811.0,811.0
308.593,17,19,1084,10,716,34275.0,48.0,43.0,9,368,38559.0,20.0,12.0
0.009,6,12,1926,6,1189,1.0,659.0,434.0,6,737,1.0,417.0,417.0
0.021,6,10,1989,5,910,5.0,642.0,642.0,5,1079,5.0,811.0,811.0
0.004,17,2,148,1,60,0.0,32.0,32.0,1,88,0.0,60.0,60.0
0.006,6,10,1547,5,764,1.0,496.0,496.0,5,783,1.0,515.0,515.0
0.005,6,10,1989,5,927,1.0,659.0,659.0,5,1062,1.0,794.0,794.0
0.014,6,10,1972,5,910,3.0,642.0,642.0,5,1062,3.0,794.0,794.0
0.008,6,10,1990,5,911,2.0,643.0,643.0,5,1079,1.0,811.0,811.0
0.006,6,10,1779,5,928,1.0,660.0,660.0,5,851,1.0,583.0,583.0
0.01,6,10,1989,5,910,2.0,642.0,642.0,5,1079,2.0,811.0,811.0
0.039,17,4,364,2,160,1.0,52.0,52.0,2,204,0.0,80.0,74.0
0.005,17,2,252,1,62,0.0,34.0,34.0,1,190,0.0,162.0,162.0
0.022,6,13,3735,7,497,3.0,125.0,125.0,6,3238,4.0,1470.0,1459.0
0.018,6,10,1983,5,910,4.0,642.0,642.0,5,1073,4.0,805.0,805.0
0.016,6,10,1972,5,910,4.0,642.0,642.0,5,1062,4.0,794.0,794.0
40.061,17,10,676,5,460,10014.0,104.0,64.0,5,216,10014.0,20.0,15.0
1771.921,6,105,6270,60,3525,30031.0,27.0,27.0,45,2745,40270.0,27.0,27.0
0.004,6,10,2007,5,928,1.0,660.0,660.0,5,1079,1.0,811.0,811.0
0.015,6,10,1631,5,848,3.0,580.0,580.0,5,783,3.0,515.0,515.0
0.12,6,10,1506,5,395,29.0,127.0,127.0,5,1111,25.0,843.0,843.0
0.07,6,10,1506,5,395,16.0,127.0,127.0,5,1111,15.0,843.0,843.0
0.006,6,10,1547,5,764,1.0,496.0,496.0,5,783,1.0,515.0,515.0
308.549,17,20,1124,10,716,34268.0,48.0,43.0,10,408,34268.0,20.0,12.0
173.15,17,76,10710,38,2552,4679.0,44.0,39.0,38,8158,4679.0,239.0,186.0
0.008,17,2,194,1,59,0.0,31.0,31.0,1,135,0.0,107.0,107.0
0.005,6,10,1779,5,928,1.0,660.0,660.0,5,851,1.0,583.0,583.0
0.004,6,10,2007,5,928,1.0,660.0,660.0,5,1079,1.0,811.0,811.0
0.015,6,10,1983,5,910,3.0,642.0,642.0,5,1073,3.0,805.0,805.0
240.012,6,9,787,5,488,60003.0,232.0,232.0,4,299,80003.0,83.0,83.0
15.071,17,14,9190,8,6902,2148.0,1350.0,834.0,6,2288,3008.0,1350.0,353.0
0.005,17,2,180,1,66,0.0,38.0,38.0,1,114,0.0,86.0,86.0
0.019,6,10,1983,5,910,4.0,642.0,642.0,5,1073,4.0,805.0,805.0
0.095,6,10,1506,5,395,20.0,127.0,127.0,5,1111,23.0,843.0,843.0
0.04,17,2,146,1,65,0.0,37.0,37.0,1,81,0.0,53.0,53.0
0.041,17,2,170,1,65,0.0,37.0,37.0,1,105,0.0,77.0,77.0
0.006,6,10,1854,5,889,1.0,621.0,621.0,5,965,1.0,697.0,697.0
240.07,6,22,4977,12,993,21824.0,180.0,93.0,10,3984,26674.0,1592.0,576.0
0.013,6,10,1989,5,910,3.0,642.0,642.0,5,1079,3.0,811.0,811.0
0.004,17,2,136,1,60,0.0,32.0,32.0,1,76,0.0,48.0,48.0
0.002,17,2,166,1,75,0.0,47.0,47.0,1,91,0.0,63.0,63.0
40.069,17,10,676,5,460,10014.0,104.0,64.0,5,216,10016.0,20.0,15.0
0.022,6,10,1983,5,910,5.0,642.0,642.0,5,1073,5.0,805.0,805.0
0.008,17,2,194,1,59,0.0,31.0,31.0,1,135,0.0,107.0,107.0
0.005,6,10,1989,5,927,1.0,659.0,659.0,5,1062,1.0,794.0,794.0
0.013,6,10,1631,5,848,3.0,580.0,580.0,5,783,3.0,515.0,515.0
0.017,6,10,1990,5,911,4.0,643.0,643.0,5,1079,4.0,811.0,811.0
0.011,6,10,1990,5,911,2.0,643.0,643.0,5,1079,2.0,811.0,811.0
0.021,6,12,1926,6,1189,4.0,659.0,434.0,6,737,4.0,417.0,417.0
0.004,6,10,1989,5,927,1.0,659.0,659.0,5,1062,1.0,794.0,794.0
0.005,6,13,3747,7,509,0.0,137.0,137.0,6,3238,0.0,1470.0,1459.0
0.064,17,2,144,1,64,0.0,36.0,36.0,1,80,0.0,52.0,52.0
0.005,6,10,1989,5,927,1.0,659.0,659.0,5,1062,1.0,794.0,794.0
0.006,6,10,1989,5,927,1.0,659.0,659.0,5,1062,1.0,794.0,794.0
0.019,6,10,1972,5,910,4.0,642.0,642.0,5,1062,4.0,794.0,794.0
0.125,6,10,1506,5,395,25.0,127.0,127.0,5,1111,25.0,843.0,843.0
0.006,6,10,1989,5,927,1.0,659.0,659.0,5,1062,1.0,794.0,794.0
0.005,6,10,2007,5,928,1.0,660.0,660.0,5,1079,1.0,811.0,811.0
0.005,6,10,2007,5,928,1.0,660.0,660.0,5,1079,1.0,811.0,811.0
1772.315,6,103,6166,59,3473,30556.0,27.0,27.0,44,2693,41215.0,27.0,27.0
40.062,17,10,676,5,460,10014.0,104.0,64.0,5,216,10014.0,20.0,15.0
0.012,6,10,1989,5,910,2.0,642.0,642.0,5,1079,3.0,811.0,811.0
0.011,6,10,1990,5,911,2.0,643.0,643.0,5,1079,2.0,811.0,811.0
0.005,6,10,1547,5,764,1.0,496.0,496.0,5,783,1.0,515.0,515.0
40.055,17,10,676,5,460,10012.0,104.0,64.0,5,216,10013.0,20.0,15.0
0.099,6,10,1506,5,395,24.0,127.0,127.0,5,1111,16.0,843.0,843.0
0.007,6,10,1689,5,839,1.0,571.0,571.0,5,850,1.0,582.0,582.0
178.495,17,74,10457,37,2465,4958.0,44.0,38.0,37,7992,4958.0,260.0,188.0
0.004,6,10,1989,5,927,1.0,659.0,659.0,5,1062,1.0,794.0,794.0
0.176,17,2,152,1,76,0.0,48.0,48.0,1,76,0.0,48.0,48.0
0.005,6,10,2000,5,927,1.0,659.0,659.0,5,1073,1.0,805.0,805.0
368.867,6,22,2313,16,867,24591.0,195.0,195.0,6,1446,4686.0,419.0,398.0
0.116,6,10,1506,5,395,27.0,127.0,127.0,5,1111,25.0,843.0,843.0
0.004,6,10,2006,5,927,1.0,659.0,659.0,5,1079,1.0,811.0,811.0
0.073,6,10,1506,5,395,16.0,127.0,127.0,5,1111,16.0,843.0,843.0
0.099,6,10,1506,5,395,21.0,127.0,127.0,5,1111,21.0,843.0,843.0
0.009,6,10,1779,5,928,2.0,660.0,660.0,5,851,2.0,583.0,583.0
295.413,6,392,348729,190,21442,1563.0,2689.0,888.0,202,327287,1469.0,3053.0,1684.0
0.078,6,10,1506,5,395,18.0,127.0,127.0,5,1111,16.0,843.0,843.0
0.005,6,10,1854,5,889,1.0,621.0,621.0,5,965,1.0,697.0,697.0
0.004,17,2,136,1,60,0.0,32.0,32.0,1,76,0.0,48.0,48.0
0.019,6,10,1983,5,910,4.0,642.0,642.0,5,1073,4.0,805.0,805.0
0.007,6,10,1989,5,910,1.0,642.0,642.0,5,1079,1.0,811.0,811.0
40.054,17,10,676,5,460,10012.0,104.0,64.0,5,216,10012.0,20.0,15.0
0.005,6,15,3794,8,504,0.0,80.0,80.0,7,3290,0.0,1448.0,972.0
0.003,17,2,148,1,60,0.0,32.0,32.0,1,88,0.0,60.0,60.0
11.141,17,28,4422,14,1993,844.0,268.0,114.0,14,2429,844.0,588.0,145.0
0.003,17,2,148,1,60,0.0,32.0,32.0,1,88,0.0,60.0,60.0
0.039,17,4,284,2,120,0.0,32.0,32.0,2,164,35.0,60.0,54.0
1771.779,17,120,11460,60,5460,30029.0,63.0,63.0,60,6000,30029.0,72.0,72.0
0.018,6,10,1972,5,910,4.0,642.0,642.0,5,1062,4.0,794.0,794.0
0.065,6,10,1506,5,395,14.0,127.0,127.0,5,1111,13.0,843.0,843.0
0.108,6,10,1506,5,395,24.0,127.0,127.0,5,1111,24.0,843.0,843.0
0.006,17,2,193,1,71,0.0,43.0,43.0,1,122,0.0,94.0,94.0
147.793,6,26,9525,12,1627,75.0,794.0,367.0,14,7898,11359.0,1360.0,732.0
0.005,6,10,1989,5,927,1.0,659.0,659.0,5,1062,1.0,794.0,794.0
0.014,6,10,1631,5,848,3.0,580.0,580.0,5,783,3.0,515.0,515.0
241.408,6,314,344073,109,17173,2235.0,2736.0,885.0,205,326900,1183.0,2804.0,1621.0
0.018,6,10,1972,5,910,4.0,642.0,642.0,5,1062,4.0,794.0,794.0
0.011,17,2,212,1,74,0.0,46.0,46.0,1,138,0.0,110.0,110.0
0.111,17,2,144,1,64,0.0,36.0,36.0,1,80,0.0,52.0,52.0
0.007,17,2,170,1,65,0.0,37.0,37.0,1,105,0.0,77.0,77.0
0.081,6,10,1506,5,395,17.0,127.0,127.0,5,1111,17.0,843.0,843.0
0.077,6,10,1506,5,395,16.0,127.0,127.0,5,1111,18.0,843.0,843.0
0.005,6,10,2006,5,927,1.0,659.0,659.0,5,1079,1.0,811.0,811.0
0.035,17,2,140,1,62,0.0,34.0,34.0,1,78,0.0,50.0,50.0
0.013,6,10,1990,5,911,3.0,643.0,643.0,5,1079,3.0,811.0,811.0
40.062,17,10,676,5,460,10014.0,104.0,64.0,5,216,10014.0,20.0,15.0
0.019,6,10,1990,5,911,4.0,643.0,643.0,5,1079,4.0,811.0,811.0
240.073,6,21,4924,11,941,24007.0,180.0,93.0,10,3983,26674.0,1591.0,575.0
11.134,17,28,4423,14,1995,844.0,270.0,114.0,14,2428,844.0,587.0,145.0
15.071,17,15,9239,8,6902,2148.0,1350.0,834.0,7,2337,2506.0,1350.0,305.0
0.073,6,10,1506,5,395,13.0,127.0,127.0,5,1111,16.0,843.0,843.0
50.874,6,400,348974,187,21299,273.0,2736.0,888.0,213,327675,239.0,2804.0,1582.0
0.073,6,10,1506,5,395,15.0,127.0,127.0,5,1111,16.0,843.0,843.0
0.006,17,2,230,1,68,0.0,40.0,40.0,1,162,0.0,134.0,134.0
15.226,17,17,8407,9,6136,1899.0,1350.0,653.0,8,2271,2171.0,1350.0,255.0
15.036,17,40,20199,22,17086,714.0,1350.0,748.0,18,3113,881.0,1350.0,144.0
0.007,6,10,1779,5,928,1.0,660.0,660.0,5,851,1.0,583.0,583.0
0.004,6,10,2006,5,927,1.0,659.0,659.0,5,1079,1.0,811.0,811.0
0.004,6,10,2007,5,928,1.0,660.0,660.0,5,1079,1.0,811.0,811.0
11.076,17,26,4077,13,2164,914.0,587.0,138.0,13,1913,914.0,268.0,119.0
0.214,6,16,2888,8,1506,30.0,533.0,360.0,8,1382,19.0,529.0,239.0
0.08,6,10,1506,5,395,18.0,127.0,127.0,5,1111,18.0,843.0,843.0
0.107,6,10,1506,5,395,25.0,127.0,127.0,5,1111,25.0,843.0,843.0
0.127,6,10,1506,5,395,31.0,127.0,127.0,5,1111,29.0,843.0,843.0
0.092,6,10,1506,5,395,18.0,127.0,127.0,5,1111,22.0,843.0,843.0
0.006,6,10,1547,5,764,1.0,496.0,496.0,5,783,1.0,515.0,515.0
0.01,6,10,1989,5,910,2.0,642.0,642.0,5,1079,2.0,811.0,811.0
0.014,6,10,1983,5,910,3.0,642.0,642.0,5,1073,3.0,805.0,805.0
0.005,17,2,214,1,75,0.0,47.0,47.0,1,139,0.0,111.0,111.0
0.007,17,2,194,1,59,0.0,31.0,31.0,1,135,0.0,107.0,107.0
0.008,6,10,1972,5,910,2.0,642.0,642.0,5,1062,2.0,794.0,794.0
0.013,6,13,3735,7,497,2.0,125.0,125.0,6,3238,2.0,1470.0,1459.0
0.004,6,10,2000,5,927,1.0,659.0,659.0,5,1073,1.0,805.0,805.0
0.005,17,2,140,1,62,0.0,34.0,34.0,1,78,0.0,50.0,50.0
0.011,6,10,1990,5,911,2.0,643.0,643.0,5,1079,2.0,811.0,811.0
173.12,17,88,12578,44,2952,4025.0,44.0,39.0,44,9626,4025.0,239.0,190.0
0.167,6,10,1506,5,395,30.0,127.0,127.0,5,1111,35.0,843.0,843.0
0.005,6,13,3747,7,509,0.0,137.0,137.0,6,3238,0.0,1470.0,1459.0
0.127,17,2,182,1,65,0.0,37.0,37.0,1,117,0.0,89.0,89.0
0.005,17,2,166,1,75,0.0,47.0,47.0,1,91,0.0,63.0,63.0
0.006,6,10,2006,5,927,1.0,659.0,659.0,5,1079,1.0,811.0,811.0
0.009,17,2,209,1,64,0.0,36.0,36.0,1,145,0.0,117.0,117.0
0.1,6,10,1506,5,395,22.0,127.0,127.0,5,1111,14.0,843.0,843.0
0.004,17,2,136,1,60,0.0,32.0,32.0,1,76,0.0,48.0,48.0
10.918,17,28,4422,14,1995,831.0,270.0,114.0,14,2427,831.0,586.0,145.0
0.068,17,8,3613,4,1874,22.0,1350.0,440.0,4,1739,11.0,1350.0,406.0
15.071,17,15,9238,8,6902,2148.0,1350.0,834.0,7,2336,2507.0,1350.0,305.0
1.031,6,12,3142,6,2099,155.0,1328.0,923.0,6,1043,155.0,791.0,791.0
0.014,6,10,1972,5,910,3.0,642.0,642.0,5,1062,3.0,794.0,794.0
168.116,17,88,12372,44,2954,3909.0,44.0,39.0,44,9418,3909.0,239.0,186.0
0.004,6,10,2006,5,927,1.0,659.0,659.0,5,1079,1.0,811.0,811.0
0.218,6,16,2669,8,1395,31.0,533.0,323.0,8,1274,19.0,529.0,212.0
0.007,6,14,3799,7,509,1.0,137.0,137.0,7,3290,1.0,1448.0,972.0
0.062,6,10,1506,5,395,14.0,127.0,127.0,5,1111,14.0,843.0,843.0
0.005,6,10,1643,5,860,1.0,592.0,592.0,5,783,1.0,515.0,515.0
0.113,6,10,1506,5,395,23.0,127.0,127.0,5,1111,23.0,843.0,843.0
0.001,17,2,136,1,60,0.0,32.0,32.0,1,76,0.0,48.0,48.0
0.003,17,2,148,1,60,0.0,32.0,32.0,1,88,0.0,60.0,60.0
0.01,6,10,1762,5,911,2.0,643.0,643.0,5,851,2.0,583.0,583.0
0.022,6,10,1989,5,910,5.0,642.0,642.0,5,1079,5.0,811.0,811.0
0.079,6,10,1506,5,395,17.0,127.0,127.0,5,1111,18.0,843.0,843.0
0.005,6,10,1854,5,889,1.0,621.0,621.0,5,965,1.0,697.0,697.0
0.041,6,14,3787,7,497,6.0,125.0,125.0,7,3290,6.0,1448.0,972.0
0.285,17,15,8779,7,6266,47.0,1350.0,867.0,8,2513,25.0,1350.0,286.0
9.037,17,6,376,5,280,2259.0,28.0,28.0,1,96,0.0,68.0,68.0
0.007,17,2,215,1,68,0.0,40.0,40.0,1,147,0.0,119.0,119.0
40.061,17,10,676,5,460,10013.0,104.0,64.0,5,216,10013.0,20.0,15.0
0.016,17,2,194,1,59,0.0,31.0,31.0,1,135,0.0,107.0,107.0
0.006,6,10,1547,5,764,1.0,496.0,496.0,5,783,1.0,515.0,515.0
0.098,6,10,1506,5,395,20.0,127.0,127.0,5,1111,24.0,843.0,843.0
0.004,6,10,2006,5,927,1.0,659.0,659.0,5,1079,1.0,811.0,811.0
0.001,17,2,180,1,66,0.0,38.0,38.0,1,114,0.0,86.0,86.0
0.003,17,2,136,1,60,0.0,32.0,32.0,1,76,0.0,48.0,48.0
0.005,6,10,1779,5,928,1.0,660.0,660.0,5,851,1.0,583.0,583.0
323.15,17,20,1124,10,716,35891.0,48.0,43.0,10,408,35891.0,20.0,12.0
0.018,6,10,1972,5,910,4.0,642.0,642.0,5,1062,4.0,794.0,794.0
0.004,6,10,1989,5,927,1.0,659.0,659.0,5,1062,1.0,794.0,794.0
0.004,17,2,148,1,60,0.0,32.0,32.0,1,88,0.0,60.0,60.0
15.221,17,17,8203,9,5991,1899.0,1350.0,637.0,8,2212,2170.0,1350.0,248.0
0.005,6,10,1643,5,860,1.0,592.0,592.0,5,783,1.0,515.0,515.0
0.022,6,10,1990,5,911,5.0,643.0,643.0,5,1079,5.0,811.0,811.0
0.006,6,10,1547,5,764,1.0,496.0,496.0,5,783,1.0,515.0,515.0
0.004,6,10,1779,5,928,1.0,660.0,660.0,5,851,1.0,583.0,583.0
0.001,17,2,136,1,60,0.0,32.0,32.0,1,76,0.0,48.0,48.0
0.108,6,10,1506,5,395,16.0,127.0,127.0,5,1111,26.0,843.0,843.0
0.014,6,10,1989,5,910,3.0,642.0,642.0,5,1079,3.0,811.0,811.0
0.005,6,10,2000,5,927,1.0,659.0,659.0,5,1073,1.0,805.0,805.0
0.01,6,10,1989,5,910,2.0,642.0,642.0,5,1079,2.0,811.0,811.0
0.006,17,2,179,1,71,0.0,43.0,43.0,1,108,0.0,80.0,80.0
0.021,6,10,1677,5,827,5.0,559.0,559.0,5,850,5.0,582.0,582.0
0.006,17,2,170,1,65,0.0,37.0,37.0,1,105,0.0,77.0,77.0
0.013,6,10,1990,5,911,3.0,643.0,643.0,5,1079,3.0,811.0,811.0
0.015,6,10,1762,5,911,3.0,643.0,643.0,5,851,3.0,583.0,583.0
0.038,17,2,152,1,76,0.0,48.0,48.0,1,76,0.0,48.0,48.0
178.428,17,80,11390,40,2673,4574.0,44.0,38.0,40,8717,4574.0,239.0,189.0
0.005,6,10,2006,5,927,1.0,659.0,659.0,5,1079,1.0,811.0,811.0
40.055,17,10,676,5,460,10012.0,104.0,64.0,5,216,10012.0,20.0,15.0
0.171,6,3,453,2,321,171.0,241.0,241.0,1,132,0.0,92.0,92.0
0.135,6,10,1506,5,395,33.0,127.0,127.0,5,1111,31.0,843.0,843.0
0.019,6,10,1989,5,910,4.0,642.0,642.0,5,1079,4.0,811.0,811.0
0.017,6,10,1990,5,911,4.0,643.0,643.0,5,1079,4.0,811.0,811.0
0.129,6,10,1506,5,395,30.0,127.0,127.0,5,1111,28.0,843.0,843.0
0.084,6,10,1506,5,395,20.0,127.0,127.0,5,1111,19.0,843.0,843.0
0.013,17,2,140,1,62,0.0,34.0,34.0,1,78,0.0,50.0,50.0
0.005,6,10,2006,5,927,1.0,659.0,659.0,5,1079,1.0,811.0,811.0
352.622,6,20,2210,6,1308,12004.0,494.0,494.0,14,902,27124.0,83.0,83.0
0.011,6,10,1989,5,910,2.0,642.0,642.0,5,1079,2.0,811.0,811.0
0.005,6,10,1702,5,863,1.0,595.0,595.0,5,839,1.0,571.0,571.0
0.105,6,10,1506,5,395,23.0,127.0,127.0,5,1111,20.0,843.0,843.0
0.068,6,10,1506,5,395,14.0,127.0,127.0,5,1111,16.0,843.0,843.0
0.001,17,2,180,1,66,0.0,38.0,38.0,1,114,0.0,86.0,86.0
0.009,6,10,1990,5,911,2.0,643.0,643.0,5,1079,2.0,811.0,811.0
0.005,6,10,1854,5,889,1.0,621.0,621.0,5,965,1.0,697.0,697.0
240.096,6,16,4480,9,963,30012.0,238.0,166.0,7,3517,40015.0,1402.0,786.0
0.005,6,10,1774,5,923,1.0,655.0,655.0,5,851,1.0,583.0,583.0
0.098,6,10,1506,5,395,23.0,127.0,127.0,5,1111,22.0,843.0,843.0
11.167,17,28,4422,14,1995,846.0,270.0,114.0,14,2427,846.0,586.0,145.0
0.011,6,10,1972,5,910,2.0,642.0,642.0,5,1062,2.0,794.0,794.0
0.012,6,10,1762,5,911,2.0,643.0,643.0,5,851,2.0,583.0,583.0
0.075,6,10,1605,5,388,18.0,120.0,120.0,5,1217,18.0,949.0,949.0
1787.457,6,150,19350,90,13740,20083.0,302.0,302.0,60,5610,30295.0,83.0,83.0
0.005,6,10,2006,5,927,1.0,659.0,659.0,5,1079,1.0,811.0,811.0
0.012,6,10,1989,5,910,3.0,642.0,642.0,5,1079,3.0,811.0,811.0
0.012,6,10,1972,5,910,3.0,642.0,642.0,5,1062,3.0,794.0,794.0
0.108,6,10,1506,5,395,22.0,127.0,127.0,5,1111,25.0,843.0,843.0
0.005,6,10,2007,5,928,1.0,660.0,660.0,5,1079,1.0,811.0,811.0
0.005,17,2,179,1,71,0.0,43.0,43.0,1,108,0.0,80.0,80.0
0.004,17,4,284,2,120,0.0,32.0,32.0,2,164,1.0,60.0,54.0
0.016,6,10,1990,5,911,4.0,643.0,643.0,5,1079,3.0,811.0,811.0
0.054,17,2,144,1,64,0.0,36.0,36.0,1,80,0.0,52.0,52.0
0.165,17,2,213,1,69,0.0,41.0,41.0,1,144,0.0,116.0,116.0
0.077,6,10,1506,5,395,16.0,127.0,127.0,5,1111,17.0,843.0,843.0
0.12,6,10,1506,5,395,27.0,127.0,127.0,5,1111,25.0,843.0,843.0
0.104,6,10,1506,5,395,22.0,127.0,127.0,5,1111,24.0,843.0,843.0
40.07,17,10,676,5,460,10015.0,104.0,64.0,5,216,10016.0,20.0,15.0
0.091,6,10,1506,5,395,21.0,127.0,127.0,5,1111,20.0,843.0,843.0
0.01,6,12,1926,6,1189,2.0,659.0,434.0,6,737,1.0,417.0,417.0
1755.917,6,452,66197,257,35550,6859.0,613.0,194.0,195,30647,9050.0,453.0,143.0
240.024,6,9,787,5,488,60006.0,232.0,232.0,4,299,80007.0,83.0,83.0
10.733,17,26,4102,13,1846,885.0,269.0,114.0,13,2256,885.0,587.0,145.0
0.01,6,13,3735,7,497,1.0,125.0,125.0,6,3238,1.0,1470.0,1459.0
0.066,17,8,3613,4,1874,22.0,1350.0,440.0,4,1739,11.0,1350.0,406.0
0.004,6,10,2007,5,928,1.0,660.0,660.0,5,1079,1.0,811.0,811.0
0.019,6,13,3735,7,497,3.0,125.0,125.0,6,3238,3.0,1470.0,1459.0
0.006,6,13,3747,7,509,0.0,137.0,137.0,6,3238,1.0,1470.0,1459.0
0.004,6,10,1702,5,863,1.0,595.0,595.0,5,839,1.0,571.0,571.0
0.008,6,12,1926,6,1189,1.0,659.0,434.0,6,737,1.0,417.0,417.0
0.03,6,10,1990,5,911,7.0,643.0,643.0,5,1079,7.0,811.0,811.0
0.019,6,10,1972,5,910,4.0,642.0,642.0,5,1062,4.0,794.0,794.0
0.114,6,10,1506,5,395,24.0,127.0,127.0,5,1111,23.0,843.0,843.0
0.073,6,10,1506,5,395,15.0,127.0,127.0,5,1111,15.0,843.0,843.0
0.073,6,10,1506,5,395,16.0,127.0,127.0,5,1111,17.0,843.0,843.0
0.005,6,10,1547,5,764,1.0,496.0,496.0,5,783,1.0,515.0,515.0
0.022,6,10,1983,5,910,5.0,642.0,642.0,5,1073,5.0,805.0,805.0
0.133,6,10,1506,5,395,31.0,127.0,127.0,5,1111,28.0,843.0,843.0
0.005,6,10,1989,5,927,1.0,659.0,659.0,5,1062,1.0,794.0,794.0
0.012,6,10,1990,5,911,3.0,643.0,643.0,5,1079,3.0,811.0,811.0
0.017,6,10,1989,5,910,4.0,642.0,642.0,5,1079,4.0,811.0,811.0
0.006,6,10,1547,5,764,1.0,496.0,496.0,5,783,1.0,515.0,515.0
10.895,17,28,4421,14,1994,829.0,269.0,114.0,14,2427,829.0,586.0,145.0
0.151,6,10,1506,5,395,33.0,127.0,127.0,5,1111,33.0,843.0,843.0
0.02,6,10,1972,5,910,4.0,642.0,642.0,5,1062,5.0,794.0,794.0
0.069,17,8,3613,4,1874,23.0,1350.0,440.0,4,1739,12.0,1350.0,406.0
0.095,6,10,1506,5,395,19.0,127.0,127.0,5,1111,20.0,843.0,843.0
40.055,17,10,676,5,460,10012.0,104.0,64.0,5,216,10011.0,20.0,15.0
0.004,6,10,2007,5,928,1.0,660.0,660.0,5,1079,1.0,811.0,811.0
0.018,6,10,1990,5,911,4.0,643.0,643.0,5,1079,4.0,811.0,811.0
0.096,6,10,1506,5,395,20.0,127.0,127.0,5,1111,21.0,843.0,843.0
0.004,17,2,152,1,76,0.0,48.0,48.0,1,76,0.0,48.0,48.0
0.005,6,10,1989,5,927,1.0,659.0,659.0,5,1062,1.0,794.0,794.0
0.081,6,10,1506,5,395,16.0,127.0,127.0,5,1111,17.0,843.0,843.0
0.006,6,10,1854,5,889,1.0,621.0,621.0,5,965,1.0,697.0,697.0
0.013,6,10,1989,5,910,3.0,642.0,642.0,5,1079,3.0,811.0,811.0
0.037,6,10,1989,5,910,9.0,642.0,642.0,5,1079,9.0,811.0,811.0
0.12,6,10,1506,5,395,27.0,127.0,127.0,5,1111,23.0,843.0,843.0
0.01,6,10,1972,5,910,2.0,642.0,642.0,5,1062,2.0,794.0,794.0
40.067,17,10,676,5,460,10014.0,104.0,64.0,5,216,10016.0,20.0,15.0
0.004,6,10,2000,5,927,1.0,659.0,659.0,5,1073,1.0,805.0,805.0
0.127,17,2,148,1,60,0.0,32.0,32.0,1,88,0.0,60.0,60.0
0.005,6,10,1643,5,860,1.0,592.0,592.0,5,783,1.0,515.0,515.0
308.826,17,20,1124,10,716,34303.0,48.0,43.0,10,408,34301.0,20.0,12.0
0.001,17,2,180,1,66,0.0,38.0,38.0,1,114,0.0,86.0,86.0
0.016,6,10,1990,5,911,3.0,643.0,643.0,5,1079,4.0,811.0,811.0
0.012,6,10,1990,5,911,3.0,643.0,643.0,5,1079,2.0,811.0,811.0
0.083,6,10,1506,5,395,17.0,127.0,127.0,5,1111,19.0,843.0,843.0
0.005,6,10,2006,5,927,1.0,659.0,659.0,5,1079,1.0,811.0,811.0
0.001,17,2,180,1,66,0.0,38.0,38.0,1,114,0.0,86.0,86.0
0.004,6,10,1779,5,928,1.0,660.0,660.0,5,851,1.0,583.0,583.0
0.013,6,10,1631,5,848,3.0,580.0,580.0,5,783,3.0,515.0,515.0
0.005,6,10,1547,5,764,1.0,496.0,496.0,5,783,1.0,515.0,515.0
0.001,17,2,180,1,66,0.0,38.0,38.0,1,114,0.0,86.0,86.0
308.606,17,20,1124,10,716,34275.0,48.0,43.0,10,408,34275.0,20.0,12.0
0.079,6,45,14088,25,2617,3.0,517.0,146.0,20,11471,3.0,1402.0,744.0
0.022,17,2,152,1,76,0.0,48.0,48.0,1,76,0.0,48.0,48.0
0.021,6,10,1983,5,910,5.0,642.0,642.0,5,1073,5.0,805.0,805.0
0.005,6,13,3747,7,509,0.0,137.0,137.0,6,3238,1.0,1470.0,1459.0
0.012,6,10,1989,5,910,3.0,642.0,642.0,5,1079,3.0,811.0,811.0
0.009,6,10,1989,5,910,2.0,642.0,642.0,5,1079,2.0,811.0,811.0
0.069,17,8,3613,4,1874,23.0,1350.0,440.0,4,1739,12.0,1350.0,406.0
0.012,6,10,1990,5,911,3.0,643.0,643.0,5,1079,3.0,811.0,811.0
0.027,6,10,1972,5,910,6.0,642.0,642.0,5,1062,6.0,794.0,794.0
0.005,6,10,1989,5,927,1.0,659.0,659.0,5,1062,1.0,794.0,794.0
0.041,17,2,152,1,76,0.0,48.0,48.0,1,76,0.0,48.0,48.0
0.005,6,10,2000,5,927,1.0,659.0,659.0,5,1073,1.0,805.0,805.0
0.01,6,12,1926,6,1189,1.0,659.0,434.0,6,737,2.0,417.0,417.0
0.005,6,10,1854,5,889,1.0,621.0,621.0,5,965,1.0,697.0,697.0
0.105,6,10,1506,5,395,23.0,127.0,127.0,5,1111,20.0,843.0,843.0
0.005,17,2,194,1,59,0.0,31.0,31.0,1,135,0.0,107.0,107.0
0.006,6,10,2006,5,927,1.0,659.0,659.0,5,1079,1.0,811.0,811.0
240.081,6,16,4482,9,963,30010.0,238.0,166.0,7,3519,40013.0,1402.0,786.0
1.093,6,33,13432,18,5893,64.0,2074.0,854.0,15,7539,65.0,2720.0,769.0
0.004,6,10,1774,5,923,1.0,655.0,655.0,5,851,1.0,583.0,583.0
0.005,6,10,2007,5,928,1.0,660.0,660.0,5,1079,1.0,811.0,811.0
0.009,17,2,194,1,59,0.0,31.0,31.0,1,135,0.0,107.0,107.0
0.006,6,10,1643,5,860,1.0,592.0,592.0,5,783,1.0,515.0,515.0
0.378,17,39,20152,21,17027,18.0,1350.0,782.0,18,3125,20.0,1350.0,145.0
0.144,6,10,1506,5,395,33.0,127.0,127.0,5,1111,31.0,843.0,843.0
0.005,6,10,2006,5,927,1.0,659.0,659.0,5,1079,1.0,811.0,811.0
0.006,6,10,1854,5,889,1.0,621.0,621.0,5,965,1.0,697.0,697.0
0.013,6,10,1972,5,910,3.0,642.0,642.0,5,1062,3.0,794.0,794.0
0.143,6,10,1506,5,395,31.0,127.0,127.0,5,1111,33.0,843.0,843.0
0.041,17,2,170,1,65,0.0,37.0,37.0,1,105,0.0,77.0,77.0
0.102,6,10,1506,5,395,19.0,127.0,127.0,5,1111,23.0,843.0,843.0
0.083,6,10,1506,5,395,18.0,127.0,127.0,5,1111,16.0,843.0,843.0
1778.781,17,143,45188,72,22752,25052.0,288.0,288.0,71,22436,25410.0,288.0,288.0
0.007,17,2,194,1,59,0.0,31.0,31.0,1,135,0.0,107.0,107.0
0.065,6,10,1506,5,395,14.0,127.0,127.0,5,1111,15.0,843.0,843.0
0.039,17,4,352,2,130,1.0,37.0,37.0,2,222,1.0,89.0,83.0
0.01,6,10,1989,5,910,2.0,642.0,642.0,5,1079,2.0,811.0,811.0
0.013,6,10,1983,5,910,3.0,642.0,642.0,5,1073,3.0,805.0,805.0
0.006,6,10,2007,5,928,1.0,660.0,660.0,5,1079,1.0,811.0,811.0
11.495,17,28,4399,14,2313,871.0,588.0,137.0,14,2086,871.0,269.0,121.0
0.001,17,2,180,1,66,0.0,38.0,38.0,1,114,0.0,86.0,86.0
0.093,6,10,1506,5,395,19.0,127.0,127.0,5,1111,20.0,843.0,843.0
0.005,17,2,209,1,64,0.0,36.0,36.0,1,145,0.0,117.0,117.0
0.1,6,10,1506,5,395,22.0,127.0,127.0,5,1111,24.0,843.0,843.0
40.077,17,10,676,5,460,10016.0,104.0,64.0,5,216,10018.0,20.0,15.0
0.012,6,10,1990,5,911,3.0,643.0,643.0,5,1079,2.0,811.0,811.0
0.006,17,2,164,1,74,0.0,46.0,46.0,1,90,0.0,62.0,62.0
0.001,17,2,180,1,66,0.0,38.0,38.0,1,114,0.0,86.0,86.0
0.012,6,10,1989,5,910,3.0,642.0,642.0,5,1079,3.0,811.0,811.0
0.01,6,10,2006,5,927,2.0,659.0,659.0,5,1079,2.0,811.0,811.0
0.006,6,10,1689,5,839,1.0,571.0,571.0,5,850,1.0,582.0,582.0
0.004,17,2,136,1,60,0.0,32.0,32.0,1,76,0.0,48.0,48.0
0.132,6,10,1506,5,395,28.0,127.0,127.0,5,1111,30.0,843.0,843.0
0.154,6,10,1506,5,395,36.0,127.0,127.0,5,1111,32.0,843.0,843.0
10.818,17,28,4422,14,1995,823.0,270.0,114.0,14,2427,823.0,586.0,145.0
0.006,6,10,1547,5,764,1.0,496.0,496.0,5,783,1.0,515.0,515.0
0.222,17,4,352,2,130,179.0,37.0,37.0,2,222,150.0,89.0,83.0
0.015,6,14,3787,7,497,2.0,125.0,125.0,7,3290,2.0,1448.0,972.0
0.072,6,10,1506,5,395,15.0,127.0,127.0,5,1111,16.0,843.0,843.0
0.158,6,10,1506,5,395,37.0,127.0,127.0,5,1111,28.0,843.0,843.0
0.011,6,10,1990,5,911,2.0,643.0,643.0,5,1079,2.0,811.0,811.0
0.004,17,2,136,1,60,0.0,32.0,32.0,1,76,0.0,48.0,48.0
366.978,6,22,2313,16,867,24465.0,195.0,195.0,6,1446,4662.0,419.0,398.0
0.039,17,4,420,2,122,0.0,33.0,33.0,2,298,36.0,145.0,121.0
0.005,17,2,169,1,62,0.0,34.0,34.0,1,107,0.0,79.0,79.0
15.232,17,17,8088,9,5953,1900.0,1350.0,633.0,8,2135,2171.0,1350.0,238.0
0.019,6,10,1677,5,827,4.0,559.0,559.0,5,850,4.0,582.0,582.0
0.008,6,12,1698,6,863,1.0,327.0,271.0,6,835,1.0,515.0,515.0
0.015,6,10,1989,5,910,3.0,642.0,642.0,5,1079,3.0,811.0,811.0
0.079,6,10,1506,5,395,19.0,127.0,127.0,5,1111,17.0,843.0,843.0
0.015,6,10,1989,5,910,3.0,642.0,642.0,5,1079,3.0,811.0,811.0
0.155,6,10,1506,5,395,36.0,127.0,127.0,5,1111,37.0,843.0,843.0
0.145,6,10,1506,5,395,29.0,127.0,127.0,5,1111,33.0,843.0,843.0
0.089,6,10,1506,5,395,20.0,127.0,127.0,5,1111,17.0,843.0,843.0
0.07,6,10,1506,5,395,16.0,127.0,127.0,5,1111,17.0,843.0,843.0
0.022,6,10,1972,5,910,5.0,642.0,642.0,5,1062,5.0,794.0,794.0
310.569,17,20,1124,10,716,34493.0,48.0,43.0,10,408,34493.0,20.0,12.0
40.057,17,10,676,5,460,10012.0,104.0,64.0,5,216,10012.0,20.0,15.0
0.012,6,10,1990,5,911,3.0,643.0,643.0,5,1079,3.0,811.0,811.0
0.012,6,14,3787,7,497,2.0,125.0,125.0,7,3290,1.0,1448.0,972.0
0.005,17,2,170,1,65,0.0,37.0,37.0,1,105,0.0,77.0,77.0
0.131,6,10,1506,5,395,32.0,127.0,127.0,5,1111,27.0,843.0,843.0
0.059,17,2,152,1,76,0.0,48.0,48.0,1,76,0.0,48.0,48.0
0.004,17,2,136,1,60,0.0,32.0,32.0,1,76,0.0,48.0,48.0
0.005,6,10,2006,5,927,1.0,659.0,659.0,5,1079,1.0,811.0,811.0
0.006,17,2,179,1,71,0.0,43.0,43.0,1,108,0.0,80.0,80.0
0.09,6,10,1506,5,395,18.0,127.0,127.0,5,1111,21.0,843.0,843.0
0.067,17,8,3613,4,1874,22.0,1350.0,440.0,4,1739,11.0,1350.0,406.0
0.008,6,10,1972,5,910,1.0,642.0,642.0,5,1062,1.0,794.0,794.0
0.005,6,10,2000,5,927,1.0,659.0,659.0,5,1073,1.0,805.0,805.0
0.024,6,20,9974,11,704,2.0,124.0,124.0,9,9270,2.0,2896.0,1758.0
0.016,6,10,1989,5,910,3.0,642.0,642.0,5,1079,4.0,811.0,811.0
0.003,17,2,148,1,60,0.0,32.0,32.0,1,88,0.0,60.0,60.0
0.004,6,10,2006,5,927,1.0,659.0,659.0,5,1079,1.0,811.0,811.0
0.012,6,10,1989,5,910,3.0,642.0,642.0,5,1079,2.0,811.0,811.0
0.037,17,2,136,1,60,0.0,32.0,32.0,1,76,0.0,48.0,48.0
0.004,17,2,148,1,60,0.0,32.0,32.0,1,88,0.0,60.0,60.0
0.01,6,10,1762,5,911,2.0,643.0,643.0,5,851,2.0,583.0,583.0
0.003,17,2,148,1,60,0.0,32.0,32.0,1,88,0.0,60.0,60.0
0.004,6,10,2007,5,928,1.0,660.0,660.0,5,1079,1.0,811.0,811.0
1.012,6,12,3142,6,2099,152.0,1328.0,923.0,6,1043,152.0,791.0,791.0
10.889,17,28,4422,14,1994,828.0,269.0,114.0,14,2428,828.0,587.0,145.0
0.004,6,10,2007,5,928,1.0,660.0,660.0,5,1079,1.0,811.0,811.0
0.042,6,14,3787,8,549,6.0,125.0,125.0,6,3238,8.0,1470.0,1459.0
0.005,6,10,2006,5,927,1.0,659.0,659.0,5,1079,1.0,811.0,811.0
0.133,6,10,1506,5,395,31.0,127.0,127.0,5,1111,32.0,843.0,843.0
0.004,6,10,1989,5,927,1.0,659.0,659.0,5,1062,1.0,794.0,794.0
0.062,17,2,152,1,76,0.0,48.0,48.0,1,76,0.0,48.0,48.0
0.005,6,10,1779,5,928,1.0,660.0,660.0,5,851,1.0,583.0,583.0
0.01,17,2,152,1,76,0.0,48.0,48.0,1,76,0.0,48.0,48.0
40.063,17,10,676,5,460,10013.0,104.0,64.0,5,216,10015.0,20.0,15.0
0.018,6,10,1989,5,910,4.0,642.0,642.0,5,1079,4.0,811.0,811.0
0.005,6,10,1989,5,927,1.0,659.0,659.0,5,1062,1.0,794.0,794.0
11.17,17,28,4424,14,1995,846.0,270.0,114.0,14,2429,846.0,588.0,145.0
167.346,17,82,11804,41,2756,4183.0,44.0,39.0,41,9048,4183.0,261.0,192.0
0.004,6,10,2007,5,928,1.0,660.0,660.0,5,1079,1.0,811.0,811.0
1778.465,17,143,45188,72,22752,25048.0,288.0,288.0,71,22436,25399.0,288.0,288.0
0.014,6,10,1983,5,910,3.0,642.0,642.0,5,1073,3.0,805.0,805.0
0.012,6,10,1983,5,910,3.0,642.0,642.0,5,1073,2.0,805.0,805.0
0.011,6,10,1989,5,910,2.0,642.0,642.0,5,1079,2.0,811.0,811.0
0.005,6,10,2007,5,928,1.0,660.0,660.0,5,1079,1.0,811.0,811.0
0.128,17,2,148,1,60,0.0,32.0,32.0,1,88,0.0,60.0,60.0
0.014,6,10,1990,5,911,3.0,643.0,643.0,5,1079,3.0,811.0,811.0
0.016,6,10,1989,5,910,4.0,642.0,642.0,5,1079,3.0,811.0,811.0
0.004,6,10,1989,5,927,1.0,659.0,659.0,5,1062,1.0,794.0,794.0
0.005,6,10,1854,5,889,1.0,621.0,621.0,5,965,1.0,697.0,697.0
240.866,6,43,13740,18,6097,14168.0,1241.0,858.0,25,7643,10034.0,1162.0,372.0
9.045,17,6,376,5,280,2261.0,28.0,28.0,1,96,0.0,68.0,68.0
0.006,6,10,1547,5,764,1.0,496.0,496.0,5,783,1.0,515.0,515.0
1778.024,17,143,45188,72,22752,25041.0,288.0,288.0,71,22436,25399.0,288.0,288.0
0.006,6,10,2007,5,928,1.0,660.0,660.0,5,1079,1.0,811.0,811.0
0.005,6,10,2000,5,927,1.0,659.0,659.0,5,1073,1.0,805.0,805.0
40.062,17,10,676,5,460,10014.0,104.0,64.0,5,216,10014.0,20.0,15.0
0.215,17,4,352,2,130,176.0,37.0,37.0,2,222,176.0,89.0,83.0
0.072,6,10,1506,5,395,17.0,127.0,127.0,5,1111,16.0,843.0,843.0
0.035,17,2,152,1,76,0.0,48.0,48.0,1,76,0.0,48.0,48.0
0.025,6,10,1989,5,927,6.0,659.0,659.0,5,1062,6.0,794.0,794.0
0.008,6,10,2007,5,928,2.0,660.0,660.0,5,1079,1.0,811.0,811.0
0.006,6,10,1547,5,764,1.0,496.0,496.0,5,783,1.0,515.0,515.0
0.155,6,10,1506,5,395,36.0,127.0,127.0,5,1111,31.0,843.0,843.0
0.004,6,10,2006,5,927,1.0,659.0,659.0,5,1079,1.0,811.0,811.0
0.005,17,2,170,1,65,0.0,37.0,37.0,1,105,0.0,77.0,77.0
0.001,17,2,140,1,62,0.0,34.0,34.0,1,78,0.0,50.0,50.0
0.006,6,13,3747,7,509,0.0,137.0,137.0,6,3238,1.0,1470.0,1459.0
1777.819,17,144,45504,72,22752,25039.0,288.0,288.0,72,22752,25039.0,288.0,288.0
0.016,6,10,1989,5,910,4.0,642.0,642.0,5,1079,4.0,811.0,811.0
0.012,6,10,1983,5,910,3.0,642.0,642.0,5,1073,2.0,805.0,805.0
0.014,6,10,1990,5,911,3.0,643.0,643.0,5,1079,3.0,811.0,811.0
0.005,6,10,1989,5,927,1.0,659.0,659.0,5,1062,1.0,794.0,794.0
0.005,6,10,1989,5,927,1.0,659.0,659.0,5,1062,1.0,794.0,794.0
11.116,17,28,4423,14,1994,842.0,269.0,114.0,14,2429,842.0,588.0,145.0
0.003,17,2,132,1,58,0.0,30.0,30.0,1,74,0.0,46.0,46.0
0.011,6,10,1631,5,848,2.0,580.0,580.0,5,783,2.0,515.0,515.0
0.012,6,10,2006,5,927,3.0,659.0,659.0,5,1079,3.0,811.0,811.0
0.012,6,10,1989,5,910,3.0,642.0,642.0,5,1079,3.0,811.0,811.0
0.01,6,10,1990,5,911,2.0,643.0,643.0,5,1079,2.0,811.0,811.0
0.003,17,2,186,1,61,0.0,33.0,33.0,1,125,0.0,97.0,97.0
0.01,6,10,1983,5,910,2.0,642.0,642.0,5,1073,2.0,805.0,805.0
40.059,17,10,676,5,460,10013.0,104.0,64.0,5,216,10013.0,20.0,15.0
0.139,6,10,1506,5,395,33.0,127.0,127.0,5,1111,31.0,843.0,843.0
40.086,17,10,676,5,460,10018.0,104.0,64.0,5,216,10020.0,20.0,15.0
0.012,6,10,1990,5,911,3.0,643.0,643.0,5,1079,2.0,811.0,811.0
0.08,6,10,1506,5,395,18.0,127.0,127.0,5,1111,14.0,843.0,843.0
1778.699,17,140,44240,72,22752,25051.0,288.0,288.0,68,21488,26547.0,288.0,288.0
0.005,6,10,2006,5,927,1.0,659.0,659.0,5,1079,1.0,811.0,811.0
0.012,6,10,1972,5,910,2.0,642.0,642.0,5,1062,3.0,794.0,794.0
0.005,6,10,2006,5,927,1.0,659.0,659.0,5,1079,1.0,811.0,811.0
172.124,17,86,12448,43,2870,4098.0,44.0,38.0,43,9578,4098.0,261.0,194.0
0.004,6,10,1702,5,863,1.0,595.0,595.0,5,839,0.0,571.0,571.0
0.007,6,14,3799,7,509,1.0,137.0,137.0,7,3290,1.0,1448.0,972.0
0.001,17,2,136,1,60,0.0,32.0,32.0,1,76,0.0,48.0,48.0
0.079,6,10,1506,5,395,17.0,127.0,127.0,5,1111,16.0,843.0,843.0
0.076,6,10,1506,5,395,16.0,127.0,127.0,5,1111,15.0,843.0,843.0
0.003,17,2,148,1,60,0.0,32.0,32.0,1,88,0.0,60.0,60.0
0.004,6,10,1702,5,863,0.0,595.0,595.0,5,839,1.0,571.0,571.0
0.005,6,10,2006,5,927,1.0,659.0,659.0,5,1079,1.0,811.0,811.0
40.065,17,10,676,5,460,10015.0,104.0,64.0,5,216,10015.0,20.0,15.0
0.011,6,10,1990,5,911,2.0,643.0,643.0,5,1079,2.0,811.0,811.0
40.067,17,10,676,5,460,10015.0,104.0,64.0,5,216,10012.0,20.0,15.0
0.006,17,2,169,1,62,0.0,34.0,34.0,1,107,0.0,79.0,79.0
0.016,6,10,1990,5,911,3.0,643.0,643.0,5,1079,3.0,811.0,811.0
0.015,6,10,1972,5,910,3.0,642.0,642.0,5,1062,3.0,794.0,794.0
0.004,17,2,136,1,60,0.0,32.0,32.0,1,76,0.0,48.0,48.0
0.008,6,10,1547,5,764,2.0,496.0,496.0,5,783,2.0,515.0,515.0
0.006,6,10,1689,5,839,1.0,571.0,571.0,5,850,1.0,582.0,582.0
0.001,17,2,136,1,60,0.0,32.0,32.0,1,76,0.0,48.0,48.0
0.002,17,2,180,1,66,0.0,38.0,38.0,1,114,0.0,86.0,86.0
0.043,17,2,152,1,76,0.0,48.0,48.0,1,76,0.0,48.0,48.0
0.085,17,2,144,1,64,0.0,36.0,36.0,1,80,0.0,52.0,52.0
368.432,6,22,2313,16,867,24562.0,195.0,195.0,6,1446,4642.0,419.0,398.0
0.22,6,16,2778,8,1396,31.0,533.0,324.0,8,1382,20.0,529.0,239.0
1.134,6,30,12705,17,3312,70.0,1360.0,517.0,13,9393,80.0,2720.0,984.0
0.175,6,3,453,2,321,175.0,241.0,241.0,1,132,0.0,92.0,92.0
1.088,6,34,9806,17,4328,68.0,3295.0,1205.0,17,5478,57.0,2667.0,435.0
40.067,17,10,676,5,460,10013.0,104.0,64.0,5,216,10015.0,20.0,15.0
1778.831,17,143,45188,72,22752,25052.0,288.0,288.0,71,22436,25409.0,288.0,288.0
0.008,6,10,1990,5,911,2.0,643.0,643.0,5,1079,2.0,811.0,811.0
0.006,6,10,1547,5,764,1.0,496.0,496.0,5,783,1.0,515.0,515.0
0.005,6,10,2006,5,927,1.0,659.0,659.0,5,1079,1.0,811.0,811.0
0.005,6,10,1989,5,927,1.0,659.0,659.0,5,1062,1.0,794.0,794.0
0.012,17,2,164,1,74,0.0,46.0,46.0,1,90,0.0,62.0,62.0
0.008,6,10,2000,5,927,1.0,659.0,659.0,5,1073,1.0,805.0,805.0
0.005,6,10,1689,5,839,1.0,571.0,571.0,5,850,1.0,582.0,582.0
0.005,6,10,1779,5,928,1.0,660.0,660.0,5,851,1.0,583.0,583.0
0.01,6,10,1762,5,911,2.0,643.0,643.0,5,851,2.0,583.0,583.0
0.098,6,10,1506,5,395,22.0,127.0,127.0,5,1111,18.0,843.0,843.0
0.001,17,2,180,1,66,0.0,38.0,38.0,1,114,0.0,86.0,86.0
1.129,6,32,13393,18,5893,66.0,1360.0,732.0,14,7500,73.0,2720.0,769.0
0.127,17,2,182,1,65,0.0,37.0,37.0,1,117,0.0,89.0,89.0
0.005,6,10,1643,5,860,1.0,592.0,592.0,5,783,1.0,515.0,515.0
0.004,6,10,1702,5,863,1.0,595.0,595.0,5,839,1.0,571.0,571.0
0.086,6,10,1506,5,395,19.0,127.0,127.0,5,1111,19.0,843.0,843.0
0.005,6,10,1689,5,839,1.0,571.0,571.0,5,850,1.0,582.0,582.0
40.06,17,10,676,5,460,10013.0,104.0,64.0,5,216,10014.0,20.0,15.0
40.07,17,10,676,5,460,10012.0,104.0,64.0,5,216,10016.0,20.0,15.0
0.001,17,2,180,1,66,0.0,38.0,38.0,1,114,0.0,86.0,86.0
0.075,6,10,1506,5,395,15.0,127.0,127.0,5,1111,15.0,843.0,843.0
0.004,6,10,1779,5,928,1.0,660.0,660.0,5,851,1.0,583.0,583.0
0.006,6,10,1689,5,839,1.0,571.0,571.0,5,850,1.0,582.0,582.0
0.014,6,10,1989,5,910,3.0,642.0,642.0,5,1079,3.0,811.0,811.0
0.004,17,2,136,1,60,0.0,32.0,32.0,1,76,0.0,48.0,48.0
0.005,6,10,2006,5,927,1.0,659.0,659.0,5,1079,1.0,811.0,811.0
0.075,6,10,1506,5,395,17.0,127.0,127.0,5,1111,18.0,843.0,843.0
15.085,17,16,8313,8,6034,2151.0,1350.0,726.0,8,2279,2150.0,1350.0,256.0
0.005,17,2,169,1,62,0.0,34.0,34.0,1,107,0.0,79.0,79.0
0.109,6,10,1506,5,395,25.0,127.0,127.0,5,1111,22.0,843.0,843.0
0.012,6,10,1677,5,827,3.0,559.0,559.0,5,850,3.0,582.0,582.0
0.005,6,10,1689,5,839,1.0,571.0,571.0,5,850,1.0,582.0,582.0
0.996,6,13,3930,7,2139,124.0,1328.0,923.0,6,1791,149.0,1539.0,1539.0
0.06,6,10,1506,5,395,12.0,127.0,127.0,5,1111,13.0,843.0,843.0
0.098,6,10,1506,5,395,18.0,127.0,127.0,5,1111,23.0,843.0,843.0
314.524,17,20,1124,10,716,34933.0,48.0,43.0,10,408,34933.0,20.0,12.0
0.004,6,10,1702,5,863,1.0,595.0,595.0,5,839,1.0,571.0,571.0
0.016,6,10,1989,5,910,4.0,642.0,642.0,5,1079,3.0,811.0,811.0
0.013,6,10,1990,5,911,3.0,643.0,643.0,5,1079,3.0,811.0,811.0
0.003,17,4,284,2,120,0.0,32.0,32.0,2,164,0.0,60.0,54.0
0.095,6,10,1506,5,395,21.0,127.0,127.0,5,1111,21.0,843.0,843.0
0.369,17,16,8571,8,5991,52.0,1350.0,720.0,8,2580,37.0,1350.0,294.0
280.297,6,22,6035,9,1146,35036.0,267.0,156.0,13,4889,23357.0,1400.0,873.0
0.015,6,10,1972,5,910,3.0,642.0,642.0,5,1062,3.0,794.0,794.0
0.005,6,10,1774,5,923,1.0,655.0,655.0,5,851,1.0,583.0,583.0
0.042,17,4,336,2,124,0.0,34.0,34.0,2,212,1.0,84.0,78.0
0.005,17,2,179,1,71,0.0,43.0,43.0,1,108,0.0,80.0,80.0
0.081,6,10,1506,5,395,19.0,127.0,127.0,5,1111,17.0,843.0,843.0
0.019,6,10,1989,5,910,4.0,642.0,642.0,5,1079,4.0,811.0,811.0
0.005,17,2,170,1,65,0.0,37.0,37.0,1,105,0.0,77.0,77.0
0.009,6,10,1990,5,911,2.0,643.0,643.0,5,1079,2.0,811.0,811.0
0.005,6,10,2006,5,927,1.0,659.0,659.0,5,1079,1.0,811.0,811.0
0.018,6,10,1990,5,911,4.0,643.0,643.0,5,1079,4.0,811.0,811.0
0.013,6,10,1989,5,910,3.0,642.0,642.0,5,1079,3.0,811.0,811.0
0.007,6,10,1854,5,889,1.0,621.0,621.0,5,965,1.0,697.0,697.0
0.025,6,10,1989,5,910,6.0,642.0,642.0,5,1079,6.0,811.0,811.0
0.005,6,10,2006,5,927,1.0,659.0,659.0,5,1079,1.0,811.0,811.0
0.005,6,10,2000,5,927,1.0,659.0,659.0,5,1073,1.0,805.0,805.0
0.006,6,10,1779,5,928,1.0,660.0,660.0,5,851,1.0,583.0,583.0
0.004,6,10,1702,5,863,1.0,595.0,595.0,5,839,0.0,571.0,571.0
0.004,6,10,1989,5,927,1.0,659.0,659.0,5,1062,1.0,794.0,794.0
0.009,6,10,1972,5,910,2.0,642.0,642.0,5,1062,2.0,794.0,794.0
0.041,17,4,596,2,122,0.0,33.0,33.0,2,474,0.0,323.0,209.0
0.013,6,10,1989,5,910,3.0,642.0,642.0,5,1079,3.0,811.0,811.0
0.012,6,10,1989,5,910,3.0,642.0,642.0,5,1079,3.0,811.0,811.0
11.369,17,28,4423,14,1994,860.0,269.0,114.0,14,2429,862.0,588.0,145.0
0.009,6,12,1926,6,1189,1.0,659.0,434.0,6,737,1.0,417.0,417.0
0.095,6,10,1506,5,395,21.0,127.0,127.0,5,1111,22.0,843.0,843.0
0.01,6,10,1990,5,911,2.0,643.0,643.0,5,1079,2.0,811.0,811.0
0.098,6,10,1506,5,395,22.0,127.0,127.0,5,1111,21.0,843.0,843.0
0.106,6,10,1506,5,395,25.0,127.0,127.0,5,1111,24.0,843.0,843.0
0.006,17,2,170,1,65,0.0,37.0,37.0,1,105,0.0,77.0,77.0
0.001,17,2,180,1,66,0.0,38.0,38.0,1,114,0.0,86.0,86.0
0.01,6,10,1983,5,910,2.0,642.0,642.0,5,1073,2.0,805.0,805.0
0.019,6,10,1989,5,910,4.0,642.0,642.0,5,1079,4.0,811.0,811.0
10.877,17,26,4100,13,1821,897.0,268.0,112.0,13,2279,897.0,586.0,147.0
0.004,17,2,152,1,76,0.0,48.0,48.0,1,76,0.0,48.0,48.0
240.099,6,16,4480,9,963,30012.0,238.0,166.0,7,3517,40016.0,1402.0,786.0
0.083,6,10,1506,5,395,18.0,127.0,127.0,5,1111,20.0,843.0,843.0
0.016,6,10,1677,5,827,4.0,559.0,559.0,5,850,4.0,582.0,582.0
10.82,17,28,4417,14,1994,823.0,269.0,114.0,14,2423,823.0,586.0,145.0
0.012,6,10,1990,5,911,3.0,643.0,643.0,5,1079,3.0,811.0,811.0
0.114,6,10,1506,5,395,27.0,127.0,127.0,5,1111,24.0,843.0,843.0
177.273,17,88,12777,44,2951,4122.0,44.0,39.0,44,9826,4122.0,261.0,195.0
1768.867,17,92,8096,46,4048,39308.0,60.0,60.0,46,4048,39307.0,60.0,60.0
0.011,6,10,1989,5,910,2.0,642.0,642.0,5,1079,2.0,811.0,811.0
40.068,17,10,676,5,460,10015.0,104.0,64.0,5,216,10016.0,20.0,15.0
0.004,17,2,132,1,58,0.0,30.0,30.0,1,74,0.0,46.0,46.0
0.006,6,10,1854,5,889,1.0,621.0,621.0,5,965,1.0,697.0,697.0
313.39,17,20,1124,10,716,34807.0,48.0,43.0,10,408,34807.0,20.0,12.0
0.005,6,10,2006,5,927,1.0,659.0,659.0,5,1079,1.0,811.0,811.0
0.012,6,10,1990,5,911,3.0,643.0,643.0,5,1079,3.0,811.0,811.0
0.17,6,10,1506,5,395,41.0,127.0,127.0,5,1111,40.0,843.0,843.0
0.008,6,10,1989,5,910,1.0,642.0,642.0,5,1079,1.0,811.0,811.0
0.015,6,13,3735,7,497,2.0,125.0,125.0,6,3238,2.0,1470.0,1459.0
0.001,17,2,180,1,66,0.0,38.0,38.0,1,114,0.0,86.0,86.0
0.012,6,10,1989,5,910,3.0,642.0,642.0,5,1079,2.0,811.0,811.0
0.008,6,10,1990,5,911,2.0,643.0,643.0,5,1079,2.0,811.0,811.0
0.009,6,13,3735,7,497,1.0,125.0,125.0,6,3238,1.0,1470.0,1459.0
308.831,17,20,1124,10,716,34300.0,48.0,43.0,10,408,34300.0,20.0,12.0
0.005,6,10,1779,5,928,1.0,660.0,660.0,5,851,1.0,583.0,583.0
0.008,6,10,1677,5,827,2.0,559.0,559.0,5,850,2.0,582.0,582.0
0.01,6,10,1983,5,910,2.0,642.0,642.0,5,1073,2.0,805.0,805.0
0.013,6,10,1677,5,827,3.0,559.0,559.0,5,850,3.0,582.0,582.0
0.005,6,10,1989,5,927,1.0,659.0,659.0,5,1062,1.0,794.0,794.0
0.217,6,16,2777,8,1395,31.0,533.0,323.0,8,1382,19.0,529.0,239.0
0.068,17,8,3613,4,1874,22.0,1350.0,440.0,4,1739,11.0,1350.0,406.0
0.008,6,10,1989,5,910,2.0,642.0,642.0,5,1079,2.0,811.0,811.0
0.021,6,10,1989,5,910,5.0,642.0,642.0,5,1079,5.0,811.0,811.0
0.005,6,10,2007,5,928,1.0,660.0,660.0,5,1079,1.0,811.0,811.0
0.015,6,10,1972,5,910,3.0,642.0,642.0,5,1062,3.0,794.0,794.0
0.005,6,10,2006,5,927,1.0,659.0,659.0,5,1079,1.0,811.0,811.0
0.005,17,2,164,1,74,0.0,46.0,46.0,1,90,0.0,62.0,62.0
0.011,6,10,1989,5,910,2.0,642.0,642.0,5,1079,2.0,811.0,811.0
0.008,17,2,162,1,65,0.0,37.0,37.0,1,97,0.0,69.0,69.0
0.005,6,10,2006,5,927,1.0,659.0,659.0,5,1079,1.0,811.0,811.0
0.134,6,10,1506,5,395,28.0,127.0,127.0,5,1111,25.0,843.0,843.0
0.014,6,10,1677,5,827,3.0,559.0,559.0,5,850,3.0,582.0,582.0
1770.482,6,87,4629,44,2342,41173.0,27.0,27.0,43,2287,42153.0,27.0,25.0
0.01,6,10,1990,5,911,2.0,643.0,643.0,5,1079,2.0,811.0,811.0
0.004,6,10,2007,5,928,1.0,660.0,660.0,5,1079,1.0,811.0,811.0
0.005,6,10,2006,5,927,1.0,659.0,659.0,5,1079,1.0,811.0,811.0
0.005,6,10,2007,5,928,1.0,660.0,660.0,5,1079,1.0,811.0,811.0
41.417,6,36,8230,18,1758,566.0,690.0,335.0,18,6472,2428.0,2720.0,478.0
0.005,6,10,2007,5,928,1.0,660.0,660.0,5,1079,1.0,811.0,811.0
0.104,6,10,1506,5,395,23.0,127.0,127.0,5,1111,21.0,843.0,843.0
300.273,6,19,3084,11,1647,30027.0,517.0,266.0,8,1437,34323.0,824.0,337.0
0.009,6,10,1990,5,911,2.0,643.0,643.0,5,1079,2.0,811.0,811.0
0.004,6,10,1779,5,928,1.0,660.0,660.0,5,851,1.0,583.0,583.0
0.004,6,10,2006,5,927,1.0,659.0,659.0,5,1079,1.0,811.0,811.0
0.128,17,2,80,1,32,0.0,4.0,4.0,1,48,0.0,20.0,20.0
0.005,6,10,1854,5,889,1.0,621.0,621.0,5,965,1.0,697.0,697.0
0.01,6,10,1631,5,848,2.0,580.0,580.0,5,783,2.0,515.0,515.0
0.011,6,10,1989,5,910,2.0,642.0,642.0,5,1079,2.0,811.0,811.0
0.001,17,2,180,1,66,0.0,38.0,38.0,1,114,0.0,86.0,86.0
0.011,6,12,1926,6,1189,2.0,659.0,434.0,6,737,2.0,417.0,417.0
0.004,6,10,1989,5,927,1.0,659.0,659.0,5,1062,1.0,794.0,794.0
308.483,17,20,1124,10,716,34262.0,48.0,43.0,10,408,34261.0,20.0,12.0
0.005,6,13,3747,7,509,0.0,137.0,137.0,6,3238,1.0,1470.0,1459.0
241.278,6,27,9174,14,2736,18559.0,990.0,503.0,13,6438,20106.0,1592.0,719.0
0.109,6,10,1506,5,395,26.0,127.0,127.0,5,1111,25.0,843.0,843.0
62.372,17,57,37778,34,32339,1889.0,1350.0,923.0,23,5439,2833.0,1350.0,208.0
0.005,6,10,2006,5,927,1.0,659.0,659.0,5,1079,1.0,811.0,811.0
0.093,6,10,1506,5,395,20.0,127.0,127.0,5,1111,19.0,843.0,843.0
0.009,17,4,284,2,120,6.0,32.0,32.0,2,164,6.0,60.0,54.0
0.004,17,2,136,1,60,0.0,32.0,32.0,1,76,0.0,48.0,48.0
0.012,6,10,1989,5,910,2.0,642.0,642.0,5,1079,2.0,811.0,811.0
0.006,6,10,1547,5,764,1.0,496.0,496.0,5,783,1.0,515.0,515.0
0.08,6,10,1989,5,910,20.0,642.0,642.0,5,1079,20.0,811.0,811.0
0.004,6,10,1779,5,928,1.0,660.0,660.0,5,851,1.0,583.0,583.0
10.634,6,29,10335,15,8942,759.0,2736.0,1020.0,14,1393,817.0,349.0,110.0
176.162,17,94,13157,47,3138,3828.0,44.0,38.0,47,10019,3829.0,239.0,185.0
0.003,17,4,284,2,120,0.0,32.0,32.0,2,164,0.0,60.0,54.0
40.064,17,10,676,5,460,10013.0,104.0,64.0,5,216,10015.0,20.0,15.0
0.066,6,10,1506,5,395,14.0,127.0,127.0,5,1111,14.0,843.0,843.0
30.147,6,18,9394,9,720,3768.0,240.0,240.0,9,8674,3766.0,1402.0,1366.0
0.081,6,10,1506,5,395,16.0,127.0,127.0,5,1111,15.0,843.0,843.0
0.005,6,10,2007,5,928,1.0,660.0,660.0,5,1079,1.0,811.0,811.0
0.009,6,10,1989,5,910,2.0,642.0,642.0,5,1079,2.0,811.0,811.0
0.003,6,10,1702,5,863,0.0,595.0,595.0,5,839,0.0,571.0,571.0
240.012,6,9,787,5,488,60003.0,232.0,232.0,4,299,80003.0,83.0,83.0
0.043,17,2,152,1,76,0.0,48.0,48.0,1,76,0.0,48.0,48.0
0.072,6,10,1506,5,395,16.0,127.0,127.0,5,1111,15.0,843.0,843.0
0.005,6,10,2006,5,927,1.0,659.0,659.0,5,1079,1.0,811.0,811.0
0.005,6,10,2000,5,927,1.0,659.0,659.0,5,1073,1.0,805.0,805.0
0.004,17,2,164,1,74,0.0,46.0,46.0,1,90,0.0,62.0,62.0
40.065,17,10,676,5,460,10013.0,104.0,64.0,5,216,10015.0,20.0,15.0
40.113,17,10,676,5,460,10026.0,104.0,64.0,5,216,10027.0,20.0,15.0
40.075,17,10,676,5,460,10016.0,104.0,64.0,5,216,10017.0,20.0,15.0
1786.404,6,150,19350,90,13740,20071.0,302.0,302.0,60,5610,30277.0,83.0,83.0
0.004,17,4,284,2,120,1.0,32.0,32.0,2,164,0.0,60.0,54.0
361.835,6,19,1689,15,978,25845.0,190.0,190.0,4,711,80015.0,495.0,495.0
0.039,17,2,136,1,60,0.0,32.0,32.0,1,76,0.0,48.0,48.0
0.015,6,10,1631,5,848,3.0,580.0,580.0,5,783,3.0,515.0,515.0
0.006,6,10,1547,5,764,1.0,496.0,496.0,5,783,1.0,515.0,515.0
0.013,6,10,1677,5,827,3.0,559.0,559.0,5,850,3.0,582.0,582.0
0.008,17,2,179,1,71,0.0,43.0,43.0,1,108,0.0,80.0,80.0
0.085,6,10,1506,5,395,19.0,127.0,127.0,5,1111,17.0,843.0,843.0
0.006,6,10,1689,5,839,1.0,571.0,571.0,5,850,1.0,582.0,582.0
0.005,6,10,2000,5,927,1.0,659.0,659.0,5,1073,1.0,805.0,805.0
0.004,6,10,2000,5,927,1.0,659.0,659.0,5,1073,1.0,805.0,805.0
0.005,17,2,170,1,65,0.0,37.0,37.0,1,105,0.0,77.0,77.0
0.038,17,2,182,1,65,0.0,37.0,37.0,1,117,0.0,89.0,89.0
0.278,17,43,24375,24,21165,12.0,1350.0,853.0,19,3210,12.0,1350.0,140.0
0.005,17,2,164,1,74,0.0,46.0,46.0,1,90,0.0,62.0,62.0
0.005,17,2,214,1,75,0.0,47.0,47.0,1,139,0.0,111.0,111.0
0.013,6,10,1972,5,910,3.0,642.0,642.0,5,1062,3.0,794.0,794.0
0.009,6,10,1972,5,910,2.0,642.0,642.0,5,1062,2.0,794.0,794.0
0.006,6,10,1854,5,889,1.0,621.0,621.0,5,965,1.0,697.0,697.0
0.003,17,2,148,1,60,0.0,32.0,32.0,1,88,0.0,60.0,60.0
0.094,6,10,1506,5,395,22.0,127.0,127.0,5,1111,22.0,843.0,843.0
0.004,6,10,1702,5,863,1.0,595.0,595.0,5,839,0.0,571.0,571.0
0.005,6,10,1989,5,927,1.0,659.0,659.0,5,1062,1.0,794.0,794.0
0.053,17,2,152,1,76,0.0,48.0,48.0,1,76,0.0,48.0,48.0
40.059,17,10,676,5,460,10011.0,104.0,64.0,5,216,10014.0,20.0,15.0
0.008,6,12,1926,6,1189,1.0,659.0,434.0,6,737,1.0,417.0,417.0
0.007,6,10,1547,5,764,1.0,496.0,496.0,5,783,1.0,515.0,515.0
10.882,17,28,4421,14,1994,828.0,269.0,114.0,14,2427,828.0,586.0,145.0
0.018,6,10,1989,5,910,4.0,642.0,642.0,5,1079,4.0,811.0,811.0
0.005,6,10,2006,5,927,1.0,659.0,659.0,5,1079,1.0,811.0,811.0
0.004,6,10,1989,5,927,1.0,659.0,659.0,5,1062,1.0,794.0,794.0
240.189,6,28,11124,14,5385,18476.0,1368.0,776.0,14,5739,18475.0,1655.0,833.0
0.005,6,10,1989,5,927,1.0,659.0,659.0,5,1062,1.0,794.0,794.0
0.006,6,12,1698,6,863,1.0,327.0,271.0,6,835,1.0,515.0,515.0
369.476,6,22,2313,16,867,24631.0,195.0,195.0,6,1446,4635.0,419.0,398.0
0.005,6,13,3747,7,509,0.0,137.0,137.0,6,3238,1.0,1470.0,1459.0
0.004,6,10,2006,5,927,1.0,659.0,659.0,5,1079,1.0,811.0,811.0
0.016,6,10,1989,5,910,4.0,642.0,642.0,5,1079,3.0,811.0,811.0
0.013,6,10,1989,5,910,3.0,642.0,642.0,5,1079,3.0,811.0,811.0
0.095,6,10,1506,5,395,21.0,127.0,127.0,5,1111,19.0,843.0,843.0
0.008,6,10,1972,5,910,2.0,642.0,642.0,5,1062,2.0,794.0,794.0
0.086,6,10,1506,5,395,19.0,127.0,127.0,5,1111,17.0,843.0,843.0
0.009,6,10,1762,5,911,2.0,643.0,643.0,5,851,2.0,583.0,583.0
0.006,6,10,1643,5,860,1.0,592.0,592.0,5,783,1.0,515.0,515.0
0.101,6,10,1506,5,395,23.0,127.0,127.0,5,1111,22.0,843.0,843.0
0.134,17,2,148,1,60,0.0,32.0,32.0,1,88,0.0,60.0,60.0
0.013,6,10,1990,5,911,3.0,643.0,643.0,5,1079,3.0,811.0,811.0
0.073,17,4,420,2,122,1.0,33.0,33.0,2,298,69.0,145.0,121.0
0.013,6,10,1983,5,910,3.0,642.0,642.0,5,1073,3.0,805.0,805.0
0.012,6,10,1762,5,911,3.0,643.0,643.0,5,851,3.0,583.0,583.0
0.006,6,10,1854,5,889,1.0,621.0,621.0,5,965,1.0,697.0,697.0
0.084,6,10,1506,5,395,17.0,127.0,127.0,5,1111,19.0,843.0,843.0
0.006,6,10,1547,5,764,1.0,496.0,496.0,5,783,1.0,515.0,515.0
0.006,6,10,1689,5,839,1.0,571.0,571.0,5,850,1.0,582.0,582.0
0.084,6,10,1506,5,395,18.0,127.0,127.0,5,1111,18.0,843.0,843.0
40.092,17,10,676,5,460,10020.0,104.0,64.0,5,216,10022.0,20.0,15.0
0.082,6,10,1506,5,395,18.0,127.0,127.0,5,1111,19.0,843.0,843.0
0.006,6,10,1689,5,839,1.0,571.0,571.0,5,850,1.0,582.0,582.0
0.01,6,10,1983,5,910,2.0,642.0,642.0,5,1073,2.0,805.0,805.0
10.849,17,28,4423,14,1995,825.0,270.0,114.0,14,2428,825.0,587.0,145.0
0.015,6,10,1762,5,911,3.0,643.0,643.0,5,851,3.0,583.0,583.0
0.127,17,2,80,1,32,0.0,4.0,4.0,1,48,0.0,20.0,20.0
10.757,17,28,4418,14,1993,819.0,268.0,114.0,14,2425,819.0,588.0,145.0
0.012,6,10,1762,5,911,2.0,643.0,643.0,5,851,2.0,583.0,583.0
0.006,6,10,1547,5,764,1.0,496.0,496.0,5,783,1.0,515.0,515.0
0.099,6,10,1506,5,395,22.0,127.0,127.0,5,1111,21.0,843.0,843.0
0.006,6,10,1689,5,839,1.0,571.0,571.0,5,850,1.0,582.0,582.0
0.006,17,2,170,1,65,0.0,37.0,37.0,1,105,0.0,77.0,77.0
0.063,6,10,1506,5,395,14.0,127.0,127.0,5,1111,14.0,843.0,843.0
0.009,6,10,1972,5,910,2.0,642.0,642.0,5,1062,2.0,794.0,794.0
0.018,6,10,1990,5,911,4.0,643.0,643.0,5,1079,4.0,811.0,811.0
0.009,6,10,1989,5,910,2.0,642.0,642.0,5,1079,2.0,811.0,811.0
0.251,17,38,20014,21,17046,12.0,1350.0,783.0,17,2968,11.0,1350.0,146.0
0.01,6,10,1989,5,910,2.0,642.0,642.0,5,1079,2.0,811.0,811.0
0.017,6,10,1972,5,910,4.0,642.0,642.0,5,1062,4.0,794.0,794.0
0.069,6,10,1506,5,395,15.0,127.0,127.0,5,1111,15.0,843.0,843.0
0.007,6,10,1762,5,911,1.0,643.0,643.0,5,851,1.0,583.0,583.0
0.038,17,4,284,2,120,0.0,32.0,32.0,2,164,35.0,60.0,54.0
0.092,6,10,1506,5,395,19.0,127.0,127.0,5,1111,22.0,843.0,843.0
0.009,6,10,1990,5,911,2.0,643.0,643.0,5,1079,2.0,811.0,811.0
0.006,6,10,1689,5,839,1.0,571.0,571.0,5,850,1.0,582.0,582.0
0.005,6,10,1989,5,927,1.0,659.0,659.0,5,1062,1.0,794.0,794.0
0.03,17,2,169,1,62,0.0,34.0,34.0,1,107,0.0,79.0,79.0
0.021,6,10,1983,5,910,5.0,642.0,642.0,5,1073,5.0,805.0,805.0
0.018,6,10,1989,5,910,4.0,642.0,642.0,5,1079,4.0,811.0,811.0
0.006,6,10,1547,5,764,1.0,496.0,496.0,5,783,1.0,515.0,515.0
0.012,6,14,3787,7,497,1.0,125.0,125.0,7,3290,2.0,1448.0,972.0
15.079,17,15,8134,8,5993,2150.0,1350.0,721.0,7,2141,2508.0,1350.0,277.0
0.038,17,4,284,2,120,0.0,32.0,32.0,2,164,34.0,60.0,54.0
0.079,17,2,136,1,60,0.0,32.0,32.0,1,76,0.0,48.0,48.0
0.011,6,10,1990,5,911,2.0,643.0,643.0,5,1079,2.0,811.0,811.0
334.953,17,20,1124,10,716,37210.0,48.0,43.0,10,408,37207.0,20.0,12.0
203.34,6,478,406969,231,389302,883.0,4080.0,1872.0,247,17667,825.0,2667.0,209.0
45.9,6,236,191592,131,180304,146.0,2741.0,1635.0,105,11288,439.0,2667.0,228.0
0.005,6,10,2006,5,927,1.0,659.0,659.0,5,1079,1.0,811.0,811.0
0.006,6,10,1989,5,927,1.0,659.0,659.0,5,1062,1.0,794.0,794.0
40.08,17,10,676,5,460,10014.0,104.0,64.0,5,216,10019.0,20.0,15.0
10.853,17,28,4423,14,1994,826.0,269.0,114.0,14,2429,826.0,588.0,145.0
0.011,6,10,1989,5,910,2.0,642.0,642.0,5,1079,2.0,811.0,811.0
0.039,17,4,284,2,120,0.0,32.0,32.0,2,164,35.0,60.0,54.0
0.074,6,10,1506,5,395,16.0,127.0,127.0,5,1111,15.0,843.0,843.0
0.001,17,2,179,1,62,0.0,34.0,34.0,1,117,0.0,89.0,89.0
0.01,6,10,1989,5,910,2.0,642.0,642.0,5,1079,2.0,811.0,811.0
0.005,6,10,1643,5,860,1.0,592.0,592.0,5,783,1.0,515.0,515.0
0.04,17,4,284,2,120,0.0,32.0,32.0,2,164,36.0,60.0,54.0
0.016,6,10,1972,5,910,3.0,642.0,642.0,5,1062,3.0,794.0,794.0
241.303,6,313,344062,117,17590,2080.0,2736.0,959.0,196,326472,1237.0,2804.0,1700.0
0.005,17,2,169,1,62,0.0,34.0,34.0,1,107,0.0,79.0,79.0
0.01,6,10,1631,5,848,2.0,580.0,580.0,5,783,2.0,515.0,515.0
0.004,17,2,148,1,60,0.0,32.0,32.0,1,88,0.0,60.0,60.0
0.069,6,10,1506,5,395,15.0,127.0,127.0,5,1111,15.0,843.0,843.0
0.037,17,4,284,2,120,0.0,32.0,32.0,2,164,34.0,60.0,54.0
0.005,6,10,2006,5,927,1.0,659.0,659.0,5,1079,1.0,811.0,811.0
0.003,17,2,234,1,61,0.0,33.0,33.0,1,173,0.0,145.0,145.0
0.017,6,10,1989,5,910,4.0,642.0,642.0,5,1079,4.0,811.0,811.0
0.003,17,4,284,2,120,0.0,32.0,32.0,2,164,0.0,60.0,54.0
0.004,17,2,148,1,60,0.0,32.0,32.0,1,88,0.0,60.0,60.0
0.009,17,2,225,1,65,0.0,37.0,37.0,1,160,0.0,132.0,132.0
311.351,17,20,1124,10,716,34581.0,48.0,43.0,10,408,34580.0,20.0,12.0
0.745,6,25,5459,12,1557,57.0,325.0,152.0,13,3902,52.0,1414.0,563.0
0.005,17,2,148,1,60,0.0,32.0,32.0,1,88,0.0,60.0,60.0
40.063,17,10,676,5,460,10014.0,104.0,64.0,5,216,10014.0,20.0,15.0
353.987,6,21,1795,16,1030,23599.0,190.0,190.0,5,765,60003.0,464.0,248.0
0.105,6,10,1506,5,395,24.0,127.0,127.0,5,1111,23.0,843.0,843.0
0.001,17,2,180,1,66,0.0,38.0,38.0,1,114,0.0,86.0,86.0
0.11,6,10,1506,5,395,24.0,127.0,127.0,5,1111,24.0,843.0,843.0
0.096,6,10,1506,5,395,21.0,127.0,127.0,5,1111,17.0,843.0,843.0
0.071,17,4,364,2,160,0.0,52.0,52.0,2,204,32.0,80.0,74.0
0.005,6,10,2000,5,927,1.0,659.0,659.0,5,1073,1.0,805.0,805.0
0.004,6,10,2006,5,927,1.0,659.0,659.0,5,1079,1.0,811.0,811.0
0.1,6,10,1506,5,395,24.0,127.0,127.0,5,1111,23.0,843.0,843.0
0.093,6,10,1506,5,395,20.0,127.0,127.0,5,1111,20.0,843.0,843.0
0.006,6,10,1689,5,839,1.0,571.0,571.0,5,850,1.0,582.0,582.0
0.004,6,10,1989,5,927,1.0,659.0,659.0,5,1062,1.0,794.0,794.0
0.004,6,10,2006,5,927,1.0,659.0,659.0,5,1079,1.0,811.0,811.0
0.081,6,10,1506,5,395,17.0,127.0,127.0,5,1111,19.0,843.0,843.0
0.013,6,10,1990,5,911,3.0,643.0,643.0,5,1079,3.0,811.0,811.0
1793.052,6,538,186568,272,161765,6616.0,2883.0,971.0,266,24803,6766.0,377.0,116.0
0.007,6,10,1972,5,910,1.0,642.0,642.0,5,1062,1.0,794.0,794.0
0.004,6,10,1702,5,863,1.0,595.0,595.0,5,839,1.0,571.0,571.0
0.003,17,2,148,1,60,0.0,32.0,32.0,1,88,0.0,60.0,60.0
0.008,6,10,1643,5,860,1.0,592.0,592.0,5,783,1.0,515.0,515.0
0.005,6,10,1547,5,764,1.0,496.0,496.0,5,783,1.0,515.0,515.0
126.042,6,14,2938,8,2504,17973.0,1414.0,1086.0,6,434,25162.0,182.0,182.0
0.012,6,10,1990,5,911,2.0,643.0,643.0,5,1079,3.0,811.0,811.0
0.005,6,10,2007,5,928,1.0,660.0,660.0,5,1079,1.0,811.0,811.0
10.887,17,28,4417,14,1994,828.0,269.0,114.0,14,2423,828.0,586.0,145.0
0.075,6,10,1506,5,395,17.0,127.0,127.0,5,1111,16.0,843.0,843.0
0.009,6,12,1926,6,1189,1.0,659.0,434.0,6,737,1.0,417.0,417.0
0.005,6,10,1774,5,923,1.0,655.0,655.0,5,851,1.0,583.0,583.0
0.003,17,2,136,1,60,0.0,32.0,32.0,1,76,0.0,48.0,48.0
0.025,17,2,152,1,56,0.0,28.0,28.0,1,96,0.0,68.0,68.0
0.004,17,4,284,2,120,0.0,32.0,32.0,2,164,0.0,60.0,54.0
379.879,6,31,10498,17,2710,23742.0,676.0,363.0,14,7788,24603.0,1402.0,881.0
0.039,17,2,412,1,61,0.0,33.0,33.0,1,351,0.0,323.0,323.0
0.004,17,4,284,2,120,0.0,32.0,32.0,2,164,1.0,60.0,54.0
0.004,6,10,2000,5,927,1.0,659.0,659.0,5,1073,1.0,805.0,805.0
0.005,6,10,2007,5,928,1.0,660.0,660.0,5,1079,1.0,811.0,811.0
0.005,6,10,2006,5,927,1.0,659.0,659.0,5,1079,1.0,811.0,811.0
0.001,17,2,179,1,62,0.0,34.0,34.0,1,117,0.0,89.0,89.0
0.005,17,2,179,1,71,0.0,43.0,43.0,1,108,0.0,80.0,80.0
10.878,17,26,4101,13,1822,897.0,269.0,112.0,13,2279,897.0,586.0,147.0
0.16,6,10,1506,5,395,35.0,127.0,127.0,5,1111,35.0,843.0,843.0
0.112,6,10,1506,5,395,20.0,127.0,127.0,5,1111,21.0,843.0,843.0
0.014,6,10,1989,5,910,3.0,642.0,642.0,5,1079,3.0,811.0,811.0
369.559,6,22,2313,16,867,24637.0,195.0,195.0,6,1446,4639.0,419.0,398.0
0.004,6,14,3799,7,509,0.0,137.0,137.0,7,3290,0.0,1448.0,972.0
0.102,6,10,1506,5,395,25.0,127.0,127.0,5,1111,22.0,843.0,843.0
0.012,6,10,1989,5,910,3.0,642.0,642.0,5,1079,3.0,811.0,811.0
0.004,6,10,1989,5,927,1.0,659.0,659.0,5,1062,1.0,794.0,794.0
0.096,6,10,1506,5,395,20.0,127.0,127.0,5,1111,18.0,843.0,843.0
0.004,17,2,194,1,59,0.0,31.0,31.0,1,135,0.0,107.0,107.0
0.005,6,10,2006,5,927,1.0,659.0,659.0,5,1079,1.0,811.0,811.0
0.072,17,2,136,1,60,0.0,32.0,32.0,1,76,0.0,48.0,48.0
0.005,17,2,179,1,71,0.0,43.0,43.0,1,108,0.0,80.0,80.0
0.046,17,4,596,2,122,3.0,33.0,33.0,2,474,6.0,323.0,209.0
0.014,6,10,1762,5,911,3.0,643.0,643.0,5,851,3.0,583.0,583.0
0.071,6,10,1506,5,395,12.0,127.0,127.0,5,1111,17.0,843.0,843.0
0.218,6,16,2669,8,1395,31.0,533.0,323.0,8,1274,20.0,529.0,212.0
0.022,6,10,1990,5,911,5.0,643.0,643.0,5,1079,5.0,811.0,811.0
0.003,17,2,136,1,60,0.0,32.0,32.0,1,76,0.0,48.0,48.0
0.005,6,10,1547,5,764,1.0,496.0,496.0,5,783,1.0,515.0,515.0
0.008,6,10,1972,5,910,2.0,642.0,642.0,5,1062,1.0,794.0,794.0
0.018,6,10,1972,5,910,4.0,642.0,642.0,5,1062,4.0,794.0,794.0
0.071,17,2,148,1,60,0.0,32.0,32.0,1,88,0.0,60.0,60.0
0.163,17,2,152,1,76,0.0,48.0,48.0,1,76,0.0,48.0,48.0
0.006,6,10,1643,5,860,1.0,592.0,592.0,5,783,1.0,515.0,515.0
0.003,17,2,136,1,60,0.0,32.0,32.0,1,76,0.0,48.0,48.0
0.01,6,10,1677,5,827,2.0,559.0,559.0,5,850,2.0,582.0,582.0
0.005,6,10,2000,5,927,1.0,659.0,659.0,5,1073,1.0,805.0,805.0
0.001,17,2,180,1,66,0.0,38.0,38.0,1,114,0.0,86.0,86.0
0.004,17,2,225,1,65,0.0,37.0,37.0,1,160,0.0,132.0,132.0
0.016,6,10,1990,5,911,4.0,643.0,643.0,5,1079,4.0,811.0,811.0
0.015,6,10,1989,5,910,3.0,642.0,642.0,5,1079,3.0,811.0,811.0
0.072,17,4,420,2,122,0.0,33.0,33.0,2,298,33.0,145.0,121.0
0.005,6,10,1689,5,839,1.0,571.0,571.0,5,850,1.0,582.0,582.0
0.004,6,10,1989,5,927,1.0,659.0,659.0,5,1062,1.0,794.0,794.0
0.009,6,10,1990,5,911,2.0,643.0,643.0,5,1079,2.0,811.0,811.0
40.069,17,10,676,5,460,10014.0,104.0,64.0,5,216,10016.0,20.0,15.0
0.005,6,13,3690,7,452,0.0,80.0,80.0,6,3238,1.0,1470.0,1459.0
0.083,6,10,1506,5,395,18.0,127.0,127.0,5,1111,19.0,843.0,843.0
0.011,6,10,1990,5,911,2.0,643.0,643.0,5,1079,2.0,811.0,811.0
0.015,6,10,1972,5,910,3.0,642.0,642.0,5,1062,3.0,794.0,794.0
0.113,6,10,1506,5,395,24.0,127.0,127.0,5,1111,24.0,843.0,843.0
0.087,6,10,1506,5,395,20.0,127.0,127.0,5,1111,17.0,843.0,843.0
0.005,17,2,244,1,74,0.0,46.0,46.0,1,170,0.0,142.0,142.0
10.997,17,28,4364,14,2311,836.0,586.0,137.0,14,2053,837.0,268.0,118.0
0.018,6,10,1989,5,910,4.0,642.0,642.0,5,1079,4.0,811.0,811.0
0.005,6,10,2006,5,927,1.0,659.0,659.0,5,1079,1.0,811.0,811.0
0.037,17,2,166,1,75,0.0,47.0,47.0,1,91,0.0,63.0,63.0
0.01,6,14,3787,7,497,1.0,125.0,125.0,7,3290,1.0,1448.0,972.0
0.005,6,10,2006,5,927,1.0,659.0,659.0,5,1079,1.0,811.0,811.0
0.005,6,10,2000,5,927,1.0,659.0,659.0,5,1073,1.0,805.0,805.0
0.005,6,13,3747,7,509,0.0,137.0,137.0,6,3238,1.0,1470.0,1459.0
0.019,17,2,169,1,62,0.0,34.0,34.0,1,107,0.0,79.0,79.0
308.667,17,20,1124,10,716,34281.0,48.0,43.0,10,408,34281.0,20.0,12.0
0.004,6,10,2000,5,927,1.0,659.0,659.0,5,1073,1.0,805.0,805.0
0.009,6,10,1677,5,827,2.0,559.0,559.0,5,850,2.0,582.0,582.0
0.005,6,10,2006,5,927,1.0,659.0,659.0,5,1079,1.0,811.0,811.0
0.001,17,2,136,1,60,0.0,32.0,32.0,1,76,0.0,48.0,48.0
0.113,6,10,1506,5,395,23.0,127.0,127.0,5,1111,25.0,843.0,843.0
240.617,6,33,8638,17,1838,15035.0,571.0,189.0,16,6800,16038.0,1402.0,597.0
0.01,6,10,1989,5,910,2.0,642.0,642.0,5,1079,2.0,811.0,811.0
0.006,6,10,2006,5,927,1.0,659.0,659.0,5,1079,1.0,811.0,811.0
0.005,6,10,2006,5,927,1.0,659.0,659.0,5,1079,1.0,811.0,811.0
0.007,6,10,2000,5,927,1.0,659.0,659.0,5,1073,1.0,805.0,805.0
0.005,6,10,2007,5,928,1.0,660.0,660.0,5,1079,1.0,811.0,811.0
0.006,6,10,1547,5,764,1.0,496.0,496.0,5,783,1.0,515.0,515.0
0.102,6,10,1506,5,395,21.0,127.0,127.0,5,1111,22.0,843.0,843.0
0.009,17,2,333,1,71,0.0,43.0,43.0,1,262,0.0,234.0,234.0
40.071,17,10,676,5,460,10016.0,104.0,64.0,5,216,10015.0,20.0,15.0
0.013,6,10,1989,5,910,3.0,642.0,642.0,5,1079,3.0,811.0,811.0
0.013,6,10,1762,5,911,3.0,643.0,643.0,5,851,3.0,583.0,583.0
0.088,6,10,1506,5,395,20.0,127.0,127.0,5,1111,20.0,843.0,843.0
0.008,6,10,1689,5,839,2.0,571.0,571.0,5,850,2.0,582.0,582.0
0.008,6,10,1989,5,910,2.0,642.0,642.0,5,1079,1.0,811.0,811.0
0.008,6,10,1989,5,910,1.0,642.0,642.0,5,1079,2.0,811.0,811.0
0.114,6,10,1506,5,395,26.0,127.0,127.0,5,1111,24.0,843.0,843.0
0.012,6,10,1631,5,848,3.0,580.0,580.0,5,783,3.0,515.0,515.0
0.039,17,2,182,1,65,0.0,37.0,37.0,1,117,0.0,89.0,89.0
0.004,6,10,2007,5,928,1.0,660.0,660.0,5,1079,1.0,811.0,811.0
0.006,17,2,146,1,65,0.0,37.0,37.0,1,81,0.0,53.0,53.0
0.007,17,2,179,1,71,0.0,43.0,43.0,1,108,0.0,80.0,80.0
0.005,17,2,179,1,71,0.0,43.0,43.0,1,108,0.0,80.0,80.0
0.007,17,2,162,1,65,0.0,37.0,37.0,1,97,0.0,69.0,69.0
0.006,6,10,1547,5,764,1.0,496.0,496.0,5,783,1.0,515.0,515.0
0.001,17,2,142,1,63,0.0,35.0,35.0,1,79,0.0,51.0,51.0
0.006,17,2,235,1,64,0.0,36.0,36.0,1,171,0.0,143.0,143.0
0.027,6,10,1989,5,910,6.0,642.0,642.0,5,1079,6.0,811.0,811.0
40.067,17,10,676,5,460,10015.0,104.0,64.0,5,216,10015.0,20.0,15.0
0.012,6,10,1989,5,910,3.0,642.0,642.0,5,1079,3.0,811.0,811.0
0.088,6,10,1506,5,395,17.0,127.0,127.0,5,1111,20.0,843.0,843.0
0.011,6,10,1990,5,911,2.0,643.0,643.0,5,1079,2.0,811.0,811.0
0.217,6,16,2782,8,1400,31.0,533.0,325.0,8,1382,19.0,529.0,239.0
0.081,6,10,1506,5,395,18.0,127.0,127.0,5,1111,18.0,843.0,843.0
0.006,6,10,1547,5,764,1.0,496.0,496.0,5,783,1.0,515.0,515.0
1770.59,17,120,11460,60,5460,30009.0,63.0,63.0,60,6000,30009.0,72.0,72.0
0.017,6,10,1989,5,910,4.0,642.0,642.0,5,1079,4.0,811.0,811.0
0.005,6,10,1689,5,839,1.0,571.0,571.0,5,850,1.0,582.0,582.0
0.117,6,14,4388,8,923,16.0,238.0,166.0,6,3465,15.0,1402.0,786.0
0.002,17,2,180,1,66,0.0,38.0,38.0,1,114,0.0,86.0,86.0
300.339,6,16,2170,9,684,37521.0,146.0,146.0,7,1486,50028.0,419.0,398.0
0.103,6,10,1506,5,395,20.0,127.0,127.0,5,1111,24.0,843.0,843.0
0.01,6,10,1762,5,911,2.0,643.0,643.0,5,851,2.0,583.0,583.0
0.008,6,10,1972,5,910,2.0,642.0,642.0,5,1062,1.0,794.0,794.0
0.005,6,10,1774,5,923,1.0,655.0,655.0,5,851,1.0,583.0,583.0
0.005,17,2,212,1,74,0.0,46.0,46.0,1,138,0.0,110.0,110.0
0.012,6,10,1989,5,910,3.0,642.0,642.0,5,1079,2.0,811.0,811.0
0.001,17,2,180,1,66,0.0,38.0,38.0,1,114,0.0,86.0,86.0
0.076,6,10,1506,5,395,16.0,127.0,127.0,5,1111,16.0,843.0,843.0
0.001,17,2,180,1,66,0.0,38.0,38.0,1,114,0.0,86.0,86.0
0.082,6,10,1506,5,395,18.0,127.0,127.0,5,1111,18.0,843.0,843.0
0.082,6,10,1506,5,395,16.0,127.0,127.0,5,1111,18.0,843.0,843.0
0.012,6,10,1983,5,910,3.0,642.0,642.0,5,1073,2.0,805.0,805.0
0.099,6,10,1506,5,395,22.0,127.0,127.0,5,1111,21.0,843.0,843.0
0.026,6,10,1677,5,827,6.0,559.0,559.0,5,850,6.0,582.0,582.0
0.005,6,10,2000,5,927,1.0,659.0,659.0,5,1073,1.0,805.0,805.0
0.005,6,10,1774,5,923,1.0,655.0,655.0,5,851,1.0,583.0,583.0
0.006,6,10,2000,5,927,1.0,659.0,659.0,5,1073,1.0,805.0,805.0
0.037,17,4,352,2,130,0.0,37.0,37.0,2,222,34.0,89.0,83.0
0.004,17,2,136,1,60,0.0,32.0,32.0,1,76,0.0,48.0,48.0
0.019,6,10,1972,5,910,4.0,642.0,642.0,5,1062,4.0,794.0,794.0
0.005,17,2,214,1,75,0.0,47.0,47.0,1,139,0.0,111.0,111.0
0.005,17,2,164,1,74,0.0,46.0,46.0,1,90,0.0,62.0,62.0
40.094,17,10,676,5,460,10021.0,104.0,64.0,5,216,10022.0,20.0,15.0
15.071,17,15,9239,8,6902,2149.0,1350.0,834.0,7,2337,2507.0,1350.0,305.0
0.012,6,10,1983,5,910,3.0,642.0,642.0,5,1073,3.0,805.0,805.0
152.862,6,21,8143,11,1985,81.0,1174.0,504.0,10,6158,16966.0,1791.0,957.0
0.006,17,2,164,1,74,0.0,46.0,46.0,1,90,0.0,62.0,62.0
0.005,6,10,2000,5,927,1.0,659.0,659.0,5,1073,1.0,805.0,805.0
0.006,6,10,1689,5,839,1.0,571.0,571.0,5,850,1.0,582.0,582.0
0.072,17,2,184,1,61,0.0,33.0,33.0,1,123,0.0,95.0,95.0
0.004,17,4,284,2,120,0.0,32.0,32.0,2,164,1.0,60.0,54.0
0.086,6,10,1506,5,395,20.0,127.0,127.0,5,1111,18.0,843.0,843.0
0.003,6,10,1702,5,863,0.0,595.0,595.0,5,839,0.0,571.0,571.0
120.913,6,53,18801,31,4715,4030.0,1053.0,221.0,22,14086,5757.0,2804.0,994.0
0.006,17,2,214,1,75,0.0,47.0,47.0,1,139,0.0,111.0,111.0
0.003,17,2,162,1,65,0.0,37.0,37.0,1,97,0.0,69.0,69.0
0.005,17,2,166,1,75,0.0,47.0,47.0,1,91,0.0,63.0,63.0
0.021,6,10,1990,5,911,5.0,643.0,643.0,5,1079,5.0,811.0,811.0
0.005,17,2,184,1,68,0.0,40.0,40.0,1,116,0.0,88.0,88.0
40.043,17,10,676,5,460,10009.0,104.0,64.0,5,216,10009.0,20.0,15.0
0.006,6,10,1547,5,764,1.0,496.0,496.0,5,783,1.0,515.0,515.0
0.012,6,10,1990,5,911,3.0,643.0,643.0,5,1079,3.0,811.0,811.0
0.004,17,2,208,1,72,0.0,44.0,44.0,1,136,0.0,108.0,108.0
11.019,17,28,4418,14,1994,839.0,269.0,114.0,14,2424,839.0,587.0,145.0
0.005,6,10,2006,5,927,1.0,659.0,659.0,5,1079,1.0,811.0,811.0
313.79,17,20,1124,10,716,34858.0,48.0,43.0,10,408,34857.0,20.0,12.0
0.008,6,10,1989,5,910,2.0,642.0,642.0,5,1079,1.0,811.0,811.0
0.005,6,10,2006,5,927,1.0,659.0,659.0,5,1079,1.0,811.0,811.0
0.005,6,10,1989,5,927,1.0,659.0,659.0,5,1062,1.0,794.0,794.0
0.005,6,10,1990,5,928,1.0,660.0,660.0,5,1062,1.0,794.0,794.0
0.004,6,10,2000,5,927,1.0,659.0,659.0,5,1073,1.0,805.0,805.0
0.005,6,13,3747,7,509,0.0,137.0,137.0,6,3238,1.0,1470.0,1459.0
0.104,6,10,1506,5,395,23.0,127.0,127.0,5,1111,23.0,843.0,843.0
0.01,6,10,1989,5,910,2.0,642.0,642.0,5,1079,2.0,811.0,811.0
0.027,6,10,1989,5,910,6.0,642.0,642.0,5,1079,6.0,811.0,811.0
0.004,6,10,1779,5,928,1.0,660.0,660.0,5,851,1.0,583.0,583.0
651.656,6,34,9593,18,3948,38332.0,676.0,429.0,16,5645,39443.0,1402.0,600.0
0.015,6,10,1677,5,827,3.0,559.0,559.0,5,850,3.0,582.0,582.0
40.07,17,10,676,5,460,10014.0,104.0,64.0,5,216,10016.0,20.0,15.0
0.004,6,10,2006,5,927,1.0,659.0,659.0,5,1079,1.0,811.0,811.0
0.006,6,10,1989,5,927,1.0,659.0,659.0,5,1062,1.0,794.0,794.0
310.095,17,20,1124,10,716,34440.0,48.0,43.0,10,408,34440.0,20.0,12.0
0.014,6,10,1972,5,910,3.0,642.0,642.0,5,1062,3.0,794.0,794.0
0.011,6,10,1989,5,910,2.0,642.0,642.0,5,1079,2.0,811.0,811.0
0.004,6,10,1779,5,928,1.0,660.0,660.0,5,851,1.0,583.0,583.0
30.84,6,25,5852,14,1888,2372.0,517.0,260.0,11,3964,3083.0,1330.0,702.0
0.005,6,10,1643,5,860,1.0,592.0,592.0,5,783,1.0,515.0,515.0
0.024,6,10,1983,5,910,6.0,642.0,642.0,5,1073,5.0,805.0,805.0
0.04,17,4,284,2,120,0.0,32.0,32.0,2,164,37.0,60.0,54.0
0.001,17,2,166,1,75,0.0,47.0,47.0,1,91,0.0,63.0,63.0
0.005,6,10,1689,5,839,1.0,571.0,571.0,5,850,1.0,582.0,582.0
0.001,17,2,180,1,66,0.0,38.0,38.0,1,114,0.0,86.0,86.0
0.003,17,4,284,2,120,0.0,32.0,32.0,2,164,0.0,60.0,54.0
0.008,6,10,1989,5,910,2.0,642.0,642.0,5,1079,1.0,811.0,811.0
0.001,17,2,136,1,60,0.0,32.0,32.0,1,76,0.0,48.0,48.0
0.005,6,10,2007,5,928,1.0,660.0,660.0,5,1079,1.0,811.0,811.0
0.006,6,10,1689,5,839,1.0,571.0,571.0,5,850,1.0,582.0,582.0
0.004,6,10,2006,5,927,1.0,659.0,659.0,5,1079,1.0,811.0,811.0
10.916,17,28,4423,14,1994,831.0,269.0,114.0,14,2429,831.0,588.0,145.0
0.006,6,14,3799,7,509,1.0,137.0,137.0,7,3290,0.0,1448.0,972.0
0.004,6,10,2006,5,927,1.0,659.0,659.0,5,1079,1.0,811.0,811.0
0.017,6,11,1814,6,963,3.0,643.0,643.0,5,851,4.0,583.0,583.0
0.086,6,10,1506,5,395,21.0,127.0,127.0,5,1111,18.0,843.0,843.0
0.108,6,10,1506,5,395,26.0,127.0,127.0,5,1111,25.0,843.0,843.0
0.007,17,2,179,1,71,0.0,43.0,43.0,1,108,0.0,80.0,80.0
0.014,6,10,1972,5,910,3.0,642.0,642.0,5,1062,3.0,794.0,794.0
0.009,6,10,1983,5,910,2.0,642.0,642.0,5,1073,2.0,805.0,805.0
240.557,6,34,9316,17,1886,15032.0,622.0,198.0,17,7430,15032.0,1402.0,595.0
0.005,17,2,194,1,59,0.0,31.0,31.0,1,135,0.0,107.0,107.0
0.004,6,10,1774,5,923,1.0,655.0,655.0,5,851,1.0,583.0,583.0
0.011,6,10,1677,5,827,2.0,559.0,559.0,5,850,2.0,582.0,582.0
0.016,6,10,1631,5,848,4.0,580.0,580.0,5,783,4.0,515.0,515.0
15.302,17,17,9361,8,4348,2182.0,1350.0,515.0,9,5013,1909.0,1350.0,529.0
175.231,17,86,12264,43,2877,4172.0,44.0,38.0,43,9387,4172.0,261.0,190.0
0.138,17,2,152,1,76,0.0,48.0,48.0,1,76,0.0,48.0,48.0
0.0,17,2,166,1,75,0.0,47.0,47.0,1,91,0.0,63.0,63.0
0.011,6,10,1989,5,910,2.0,642.0,642.0,5,1079,2.0,811.0,811.0
0.005,17,2,166,1,75,0.0,47.0,47.0,1,91,0.0,63.0,63.0
0.004,6,10,1989,5,927,1.0,659.0,659.0,5,1062,1.0,794.0,794.0
0.006,6,10,1547,5,764,1.0,496.0,496.0,5,783,1.0,515.0,515.0
0.137,6,10,1506,5,395,31.0,127.0,127.0,5,1111,32.0,843.0,843.0
0.005,6,10,2006,5,927,1.0,659.0,659.0,5,1079,1.0,811.0,811.0
0.009,17,2,194,1,59,0.0,31.0,31.0,1,135,0.0,107.0,107.0
240.019,6,9,787,5,488,60004.0,232.0,232.0,4,299,80005.0,83.0,83.0
0.098,6,10,1506,5,395,21.0,127.0,127.0,5,1111,20.0,843.0,843.0
40.061,17,10,676,5,460,10012.0,104.0,64.0,5,216,10014.0,20.0,15.0
0.005,6,10,1989,5,927,1.0,659.0,659.0,5,1062,1.0,794.0,794.0
0.004,17,2,148,1,60,0.0,32.0,32.0,1,88,0.0,60.0,60.0
0.013,6,10,1631,5,848,3.0,580.0,580.0,5,783,3.0,515.0,515.0
0.205,6,16,2669,8,1395,29.0,533.0,323.0,8,1274,18.0,529.0,212.0
0.006,6,10,1547,5,764,1.0,496.0,496.0,5,783,1.0,515.0,515.0
15.077,17,15,8185,8,5997,2149.0,1350.0,721.0,7,2188,2508.0,1350.0,284.0
0.102,6,10,1506,5,395,23.0,127.0,127.0,5,1111,23.0,843.0,843.0
0.112,6,10,1506,5,395,23.0,127.0,127.0,5,1111,24.0,843.0,843.0
0.007,6,10,1989,5,910,1.0,642.0,642.0,5,1079,1.0,811.0,811.0
0.087,6,10,1506,5,395,20.0,127.0,127.0,5,1111,20.0,843.0,843.0
0.001,17,2,180,1,66,0.0,38.0,38.0,1,114,0.0,86.0,86.0
0.066,17,8,3613,4,1874,22.0,1350.0,440.0,4,1739,11.0,1350.0,406.0
0.004,6,10,1989,5,927,1.0,659.0,659.0,5,1062,1.0,794.0,794.0
0.042,17,2,152,1,76,0.0,48.0,48.0,1,76,0.0,48.0,48.0
0.012,6,10,1990,5,911,3.0,643.0,643.0,5,1079,2.0,811.0,811.0
0.067,6,10,1506,5,395,12.0,127.0,127.0,5,1111,16.0,843.0,843.0
0.041,17,4,284,2,120,0.0,32.0,32.0,2,164,38.0,60.0,54.0
0.008,17,2,148,1,60,0.0,32.0,32.0,1,88,0.0,60.0,60.0
0.013,6,10,2006,5,927,3.0,659.0,659.0,5,1079,3.0,811.0,811.0
300.02,6,12,1782,7,1348,50003.0,494.0,494.0,5,434,75004.0,83.0,83.0
15.03,17,52,26430,28,21380,555.0,1350.0,735.0,24,5050,652.0,1350.0,182.0
0.005,17,2,164,1,74,0.0,46.0,46.0,1,90,0.0,62.0,62.0
1770.465,6,83,4368,42,2210,43181.0,26.0,26.0,41,2158,44260.0,26.0,26.0
0.004,6,10,2006,5,927,1.0,659.0,659.0,5,1079,1.0,811.0,811.0
0.041,17,2,136,1,60,0.0,32.0,32.0,1,76,0.0,48.0,48.0
0.006,6,10,1689,5,839,1.0,571.0,571.0,5,850,1.0,582.0,582.0
0.099,6,10,1506,5,395,22.0,127.0,127.0,5,1111,22.0,843.0,843.0
0.132,6,10,1506,5,395,30.0,127.0,127.0,5,1111,30.0,843.0,843.0
0.005,6,10,2006,5,927,1.0,659.0,659.0,5,1079,1.0,811.0,811.0
0.003,17,4,284,2,120,0.0,32.0,32.0,2,164,0.0,60.0,54.0
1799.799,6,136,6589,76,3664,23997.0,39.0,39.0,60,2925,30022.0,35.0,35.0
0.014,6,10,1989,5,910,3.0,642.0,642.0,5,1079,3.0,811.0,811.0
0.084,6,10,1506,5,395,19.0,127.0,127.0,5,1111,18.0,843.0,843.0
240.094,6,16,4481,9,963,30011.0,238.0,166.0,7,3518,40015.0,1402.0,786.0
0.113,6,10,1506,5,395,24.0,127.0,127.0,5,1111,27.0,843.0,843.0
0.022,6,10,1990,5,911,5.0,643.0,643.0,5,1079,5.0,811.0,811.0
0.008,6,10,1990,5,911,2.0,643.0,643.0,5,1079,2.0,811.0,811.0
0.01,6,10,1989,5,910,2.0,642.0,642.0,5,1079,2.0,811.0,811.0
0.006,6,10,1547,5,764,1.0,496.0,496.0,5,783,1.0,515.0,515.0
0.031,6,10,1677,5,827,7.0,559.0,559.0,5,850,7.0,582.0,582.0
0.128,17,2,136,1,60,0.0,32.0,32.0,1,76,0.0,48.0,48.0
0.005,6,10,1989,5,927,1.0,659.0,659.0,5,1062,1.0,794.0,794.0
0.005,6,10,2000,5,927,1.0,659.0,659.0,5,1073,1.0,805.0,805.0
0.013,6,10,1972,5,910,3.0,642.0,642.0,5,1062,3.0,794.0,794.0
0.095,6,10,1506,5,395,20.0,127.0,127.0,5,1111,21.0,843.0,843.0
0.09,6,10,1506,5,395,21.0,127.0,127.0,5,1111,16.0,843.0,843.0
0.004,17,2,136,1,60,0.0,32.0,32.0,1,76,0.0,48.0,48.0
0.014,6,10,1762,5,911,3.0,643.0,643.0,5,851,3.0,583.0,583.0
0.006,6,10,1547,5,764,1.0,496.0,496.0,5,783,1.0,515.0,515.0
0.005,6,10,1643,5,860,1.0,592.0,592.0,5,783,1.0,515.0,515.0
0.013,6,10,1677,5,827,3.0,559.0,559.0,5,850,3.0,582.0,582.0
40.065,17,10,676,5,460,10015.0,104.0,64.0,5,216,10015.0,20.0,15.0
0.004,6,10,1989,5,927,1.0,659.0,659.0,5,1062,1.0,794.0,794.0
0.005,6,10,2006,5,927,1.0,659.0,659.0,5,1079,1.0,811.0,811.0
0.038,6,14,3787,7,497,6.0,125.0,125.0,7,3290,6.0,1448.0,972.0
0.039,17,2,184,1,61,0.0,33.0,33.0,1,123,0.0,95.0,95.0
0.056,6,13,3816,7,578,9.0,206.0,206.0,6,3238,11.0,1470.0,1459.0
0.065,6,10,1506,5,395,14.0,127.0,127.0,5,1111,15.0,843.0,843.0
0.005,17,2,179,1,71,0.0,43.0,43.0,1,108,0.0,80.0,80.0
0.042,17,4,596,2,122,0.0,33.0,33.0,2,474,1.0,323.0,209.0
0.005,17,2,273,1,66,0.0,38.0,38.0,1,207,0.0,179.0,179.0
0.019,6,10,1983,5,910,4.0,642.0,642.0,5,1073,4.0,805.0,805.0
0.005,6,10,2006,5,927,1.0,659.0,659.0,5,1079,1.0,811.0,811.0
0.006,17,2,186,1,61,0.0,33.0,33.0,1,125,0.0,97.0,97.0
360.057,6,21,3981,13,3142,30004.0,494.0,494.0,8,839,51436.0,83.0,83.0
0.009,6,10,1990,5,911,2.0,643.0,643.0,5,1079,2.0,811.0,811.0
0.121,6,10,1506,5,395,25.0,127.0,127.0,5,1111,25.0,843.0,843.0
0.007,6,12,1698,6,863,1.0,327.0,271.0,6,835,1.0,515.0,515.0
0.009,6,10,1983,5,910,2.0,642.0,642.0,5,1073,2.0,805.0,805.0
0.009,6,10,1989,5,910,2.0,642.0,642.0,5,1079,2.0,811.0,811.0
0.005,6,10,2006,5,927,1.0,659.0,659.0,5,1079,1.0,811.0,811.0
40.056,17,10,676,5,460,10012.0,104.0,64.0,5,216,10013.0,20.0,15.0
15.083,17,15,8286,8,6063,2150.0,1350.0,729.0,7,2223,2508.0,1350.0,289.0
0.01,6,10,1605,5,388,2.0,120.0,120.0,5,1217,2.0,949.0,949.0
0.005,6,10,2006,5,927,1.0,659.0,659.0,5,1079,1.0,811.0,811.0
11.162,17,28,4422,14,1994,846.0,269.0,114.0,14,2428,846.0,587.0,145.0
40.052,17,10,676,5,460,10012.0,104.0,64.0,5,216,10012.0,20.0,15.0
0.004,17,2,136,1,60,0.0,32.0,32.0,1,76,0.0,48.0,48.0
0.021,6,13,3735,7,497,3.0,125.0,125.0,6,3238,4.0,1470.0,1459.0
0.006,6,10,2006,5,927,1.0,659.0,659.0,5,1079,1.0,811.0,811.0
0.071,17,2,148,1,60,0.0,32.0,32.0,1,88,0.0,60.0,60.0
0.005,17,2,136,1,60,0.0,32.0,32.0,1,76,0.0,48.0,48.0
0.009,6,10,1989,5,910,2.0,642.0,642.0,5,1079,2.0,811.0,811.0
0.077,6,10,1506,5,395,18.0,127.0,127.0,5,1111,16.0,843.0,843.0
168.338,17,88,12724,44,2967,3914.0,44.0,39.0,44,9757,3914.0,239.0,193.0
0.004,6,10,1702,5,863,1.0,595.0,595.0,5,839,1.0,571.0,571.0
0.008,6,10,1989,5,910,2.0,642.0,642.0,5,1079,2.0,811.0,811.0
40.066,17,10,676,5,460,10014.0,104.0,64.0,5,216,10015.0,20.0,15.0
40.06,17,10,676,5,460,10012.0,104.0,64.0,5,216,10014.0,20.0,15.0
0.001,17,2,179,1,62,0.0,34.0,34.0,1,117,0.0,89.0,89.0
66.763,6,37,9811,19,4293,501.0,1360.0,700.0,18,5518,3917.0,2667.0,435.0
0.011,6,10,1972,5,910,2.0,642.0,642.0,5,1062,2.0,794.0,794.0
0.015,6,10,1989,5,910,3.0,642.0,642.0,5,1079,3.0,811.0,811.0
0.041,17,2,412,1,61,0.0,33.0,33.0,1,351,0.0,323.0,323.0
0.148,6,10,1506,5,395,33.0,127.0,127.0,5,1111,25.0,843.0,843.0
0.01,6,10,1990,5,911,2.0,643.0,643.0,5,1079,2.0,811.0,811.0
0.001,17,2,180,1,66,0.0,38.0,38.0,1,114,0.0,86.0,86.0
0.004,6,10,1989,5,927,1.0,659.0,659.0,5,1062,1.0,794.0,794.0
0.016,6,10,1990,5,911,4.0,643.0,643.0,5,1079,4.0,811.0,811.0
0.014,6,10,1989,5,910,3.0,642.0,642.0,5,1079,3.0,811.0,811.0
0.066,6,10,1506,5,395,16.0,127.0,127.0,5,1111,12.0,843.0,843.0
0.004,6,10,2000,5,927,1.0,659.0,659.0,5,1073,1.0,805.0,805.0
0.017,6,12,1926,6,1189,3.0,659.0,434.0,6,737,3.0,417.0,417.0
0.006,17,2,213,1,69,0.0,41.0,41.0,1,144,0.0,116.0,116.0
1.114,6,11,1566,6,455,218.0,127.0,127.0,5,1111,21.0,843.0,843.0
0.004,6,10,2007,5,928,1.0,660.0,660.0,5,1079,1.0,811.0,811.0
0.092,6,10,1506,5,395,20.0,127.0,127.0,5,1111,21.0,843.0,843.0
0.006,17,2,179,1,71,0.0,43.0,43.0,1,108,0.0,80.0,80.0
176.075,17,74,10567,37,2465,4890.0,44.0,38.0,37,8102,4890.0,239.0,190.0
0.006,6,10,1547,5,764,1.0,496.0,496.0,5,783,1.0,515.0,515.0
0.286,6,11,2944,6,497,57.0,177.0,177.0,5,2447,44.0,1402.0,1089.0
0.078,6,10,1506,5,395,15.0,127.0,127.0,5,1111,17.0,843.0,843.0
0.004,6,10,1702,5,863,0.0,595.0,595.0,5,839,1.0,571.0,571.0
15.077,17,16,9153,8,6940,2149.0,1350.0,839.0,8,2213,2149.0,1350.0,248.0
0.005,6,10,1989,5,927,1.0,659.0,659.0,5,1062,1.0,794.0,794.0
0.005,6,10,1989,5,927,1.0,659.0,659.0,5,1062,1.0,794.0,794.0
0.041,17,2,148,1,60,0.0,32.0,32.0,1,88,0.0,60.0,60.0
0.005,6,10,1774,5,923,1.0,655.0,655.0,5,851,1.0,583.0,583.0
0.009,6,10,1989,5,910,2.0,642.0,642.0,5,1079,2.0,811.0,811.0
0.005,6,10,2007,5,928,1.0,660.0,660.0,5,1079,1.0,811.0,811.0
40.061,17,10,676,5,460,10011.0,104.0,64.0,5,216,10014.0,20.0,15.0
0.08,6,10,1506,5,395,18.0,127.0,127.0,5,1111,18.0,843.0,843.0
0.005,6,10,1643,5,860,1.0,592.0,592.0,5,783,1.0,515.0,515.0
0.015,6,10,1990,5,911,3.0,643.0,643.0,5,1079,3.0,811.0,811.0
0.091,6,10,1506,5,395,20.0,127.0,127.0,5,1111,15.0,843.0,843.0
0.004,6,10,1989,5,927,1.0,659.0,659.0,5,1062,1.0,794.0,794.0
0.004,6,10,1774,5,923,1.0,655.0,655.0,5,851,1.0,583.0,583.0
0.08,6,10,1506,5,395,15.0,127.0,127.0,5,1111,19.0,843.0,843.0
0.116,6,10,1506,5,395,25.0,127.0,127.0,5,1111,27.0,843.0,843.0
0.007,6,10,1547,5,764,1.0,496.0,496.0,5,783,1.0,515.0,515.0
0.006,17,2,302,1,65,0.0,37.0,37.0,1,237,0.0,209.0,209.0
0.017,6,10,1762,5,911,4.0,643.0,643.0,5,851,4.0,583.0,583.0
0.005,17,2,179,1,71,0.0,43.0,43.0,1,108,0.0,80.0,80.0
0.005,6,14,3742,7,452,0.0,80.0,80.0,7,3290,0.0,1448.0,972.0
140.018,6,28,9605,14,1707,10770.0,794.0,367.0,14,7898,10760.0,1360.0,732.0
0.01,6,10,1972,5,910,2.0,642.0,642.0,5,1062,2.0,794.0,794.0
0.005,17,2,170,1,65,0.0,37.0,37.0,1,105,0.0,77.0,77.0
0.004,17,2,148,1,60,0.0,32.0,32.0,1,88,0.0,60.0,60.0
0.004,6,10,2006,5,927,1.0,659.0,659.0,5,1079,1.0,811.0,811.0
0.095,6,10,1506,5,395,20.0,127.0,127.0,5,1111,19.0,843.0,843.0
0.005,6,10,2006,5,927,1.0,659.0,659.0,5,1079,1.0,811.0,811.0
0.117,6,10,1506,5,395,25.0,127.0,127.0,5,1111,26.0,843.0,843.0
0.006,6,10,1854,5,889,1.0,621.0,621.0,5,965,1.0,697.0,697.0
0.005,6,10,2000,5,927,1.0,659.0,659.0,5,1073,1.0,805.0,805.0
40.07,17,10,676,5,460,10016.0,104.0,64.0,5,216,10016.0,20.0,15.0
0.009,6,10,1972,5,910,2.0,642.0,642.0,5,1062,2.0,794.0,794.0
0.096,6,10,1506,5,395,19.0,127.0,127.0,5,1111,22.0,843.0,843.0
0.001,17,2,136,1,60,0.0,32.0,32.0,1,76,0.0,48.0,48.0
226.812,6,32,7298,17,2370,2.0,567.0,333.0,15,4928,16200.0,1330.0,479.0
0.07,17,8,3613,4,1874,23.0,1350.0,440.0,4,1739,11.0,1350.0,406.0
0.001,17,2,180,1,66,0.0,38.0,38.0,1,114,0.0,86.0,86.0
0.015,6,10,1990,5,911,3.0,643.0,643.0,5,1079,3.0,811.0,811.0
0.005,17,2,169,1,62,0.0,34.0,34.0,1,107,0.0,79.0,79.0
352.246,6,20,2210,6,1308,12003.0,494.0,494.0,14,902,27095.0,83.0,83.0
240.218,6,21,8225,12,2191,21838.0,1368.0,519.0,9,6034,30022.0,2804.0,1111.0
0.005,6,10,1547,5,764,1.0,496.0,496.0,5,783,1.0,515.0,515.0
0.004,6,10,1989,5,927,1.0,659.0,659.0,5,1062,1.0,794.0,794.0
0.169,6,3,453,2,321,169.0,241.0,241.0,1,132,0.0,92.0,92.0
0.02,6,10,1990,5,911,5.0,643.0,643.0,5,1079,5.0,811.0,811.0
0.007,6,10,2007,5,928,1.0,660.0,660.0,5,1079,1.0,811.0,811.0
308.69,17,18,1008,9,640,38570.0,48.0,43.0,9,368,38570.0,20.0,12.0
0.017,6,10,1677,5,827,4.0,559.0,559.0,5,850,4.0,582.0,582.0
0.006,6,10,1643,5,860,1.0,592.0,592.0,5,783,1.0,515.0,515.0
0.1,6,10,1506,5,395,21.0,127.0,127.0,5,1111,20.0,843.0,843.0
1779.241,17,144,45504,72,22752,25059.0,288.0,288.0,72,22752,25059.0,288.0,288.0
0.003,17,2,136,1,60,0.0,32.0,32.0,1,76,0.0,48.0,48.0
0.111,6,10,1506,5,395,24.0,127.0,127.0,5,1111,23.0,843.0,843.0
0.011,6,10,1983,5,910,2.0,642.0,642.0,5,1073,2.0,805.0,805.0
15.072,17,15,9239,8,6902,2149.0,1350.0,834.0,7,2337,2507.0,1350.0,305.0
0.053,17,2,152,1,76,0.0,48.0,48.0,1,76,0.0,48.0,48.0
40.071,17,10,676,5,460,10016.0,104.0,64.0,5,216,10016.0,20.0,15.0
0.125,6,10,1506,5,395,29.0,127.0,127.0,5,1111,30.0,843.0,843.0
0.005,6,10,1702,5,863,1.0,595.0,595.0,5,839,1.0,571.0,571.0
0.005,17,2,179,1,71,0.0,43.0,43.0,1,108,0.0,80.0,80.0
0.003,17,2,148,1,60,0.0,32.0,32.0,1,88,0.0,60.0,60.0
308.478,17,20,1124,10,716,34261.0,48.0,43.0,10,408,34261.0,20.0,12.0
0.015,6,10,1989,5,910,3.0,642.0,642.0,5,1079,3.0,811.0,811.0
0.131,6,10,1506,5,395,30.0,127.0,127.0,5,1111,30.0,843.0,843.0
0.006,6,10,1547,5,764,1.0,496.0,496.0,5,783,1.0,515.0,515.0
0.003,17,2,148,1,60,0.0,32.0,32.0,1,88,0.0,60.0,60.0
0.005,6,10,2006,5,927,1.0,659.0,659.0,5,1079,1.0,811.0,811.0
0.006,6,13,3747,7,509,0.0,137.0,137.0,6,3238,1.0,1470.0,1459.0
0.005,6,10,1547,5,764,1.0,496.0,496.0,5,783,1.0,515.0,515.0
0.009,6,10,1983,5,910,2.0,642.0,642.0,5,1073,2.0,805.0,805.0
0.086,6,10,1506,5,395,19.0,127.0,127.0,5,1111,17.0,843.0,843.0
0.017,6,13,3735,7,497,2.0,125.0,125.0,6,3238,3.0,1470.0,1459.0
0.006,17,2,166,1,75,0.0,47.0,47.0,1,91,0.0,63.0,63.0
0.005,6,14,3736,7,446,0.0,74.0,74.0,7,3290,0.0,1448.0,972.0
0.015,6,10,1677,5,827,3.0,559.0,559.0,5,850,3.0,582.0,582.0
0.006,6,10,1547,5,764,1.0,496.0,496.0,5,783,1.0,515.0,515.0
0.108,6,10,1506,5,395,23.0,127.0,127.0,5,1111,19.0,843.0,843.0
48.365,6,36,8190,18,1719,522.0,651.0,322.0,18,6471,2837.0,2126.0,478.0
0.008,6,10,1989,5,910,2.0,642.0,642.0,5,1079,2.0,811.0,811.0
0.005,6,10,1854,5,889,1.0,621.0,621.0,5,965,1.0,697.0,697.0
40.069,17,10,676,5,460,10014.0,104.0,64.0,5,216,10016.0,20.0,15.0
10.802,17,28,4418,14,1995,822.0,270.0,114.0,14,2423,822.0,586.0,145.0
361.814,6,21,1793,16,1030,24120.0,190.0,190.0,5,763,60009.0,462.0,247.0
0.009,6,10,1762,5,911,2.0,643.0,643.0,5,851,2.0,583.0,583.0
0.003,17,2,136,1,60,0.0,32.0,32.0,1,76,0.0,48.0,48.0
0.006,6,10,1854,5,889,1.0,621.0,621.0,5,965,1.0,697.0,697.0
0.005,6,10,2000,5,927,1.0,659.0,659.0,5,1073,1.0,805.0,805.0
0.056,6,10,1506,5,395,13.0,127.0,127.0,5,1111,12.0,843.0,843.0
0.009,6,12,1926,6,1189,1.0,659.0,434.0,6,737,1.0,417.0,417.0
0.003,17,2,136,1,60,0.0,32.0,32.0,1,76,0.0,48.0,48.0
0.006,6,10,1643,5,860,1.0,592.0,592.0,5,783,1.0,515.0,515.0
0.007,6,10,1989,5,910,1.0,642.0,642.0,5,1079,1.0,811.0,811.0
0.042,17,2,152,1,76,0.0,48.0,48.0,1,76,0.0,48.0,48.0
0.006,6,10,1643,5,860,1.0,592.0,592.0,5,783,1.0,515.0,515.0
0.005,6,10,1689,5,839,1.0,571.0,571.0,5,850,1.0,582.0,582.0
0.006,6,12,1698,6,863,1.0,327.0,271.0,6,835,1.0,515.0,515.0
0.005,6,10,1989,5,927,1.0,659.0,659.0,5,1062,1.0,794.0,794.0
0.005,6,10,1989,5,927,1.0,659.0,659.0,5,1062,1.0,794.0,794.0
0.005,17,4,284,2,120,0.0,32.0,32.0,2,164,1.0,60.0,54.0
0.006,17,2,187,1,71,0.0,43.0,43.0,1,116,0.0,88.0,88.0
0.013,6,10,1983,5,910,3.0,642.0,642.0,5,1073,3.0,805.0,805.0
0.006,6,10,2007,5,928,1.0,660.0,660.0,5,1079,1.0,811.0,811.0
0.013,6,10,1990,5,911,3.0,643.0,643.0,5,1079,3.0,811.0,811.0
0.005,6,13,3690,7,452,0.0,80.0,80.0,6,3238,0.0,1470.0,1459.0
0.003,17,2,148,1,60,0.0,32.0,32.0,1,88,0.0,60.0,60.0
0.006,6,10,1643,5,860,1.0,592.0,592.0,5,783,1.0,515.0,515.0
369.35,6,24,2405,17,919,23084.0,195.0,195.0,7,1486,3922.0,419.0,398.0
0.005,17,2,170,1,65,0.0,37.0,37.0,1,105,0.0,77.0,77.0
0.004,6,10,1989,5,927,1.0,659.0,659.0,5,1062,1.0,794.0,794.0
0.004,6,10,2006,5,927,1.0,659.0,659.0,5,1079,1.0,811.0,811.0
0.021,6,10,1983,5,910,5.0,642.0,642.0,5,1073,5.0,805.0,805.0
374.736,6,21,1796,16,1030,24982.0,190.0,190.0,5,766,60020.0,465.0,249.0
308.913,17,20,1124,10,716,34309.0,48.0,43.0,10,408,34309.0,20.0,12.0
0.001,17,2,180,1,66,0.0,38.0,38.0,1,114,0.0,86.0,86.0
40.072,17,10,676,5,460,10016.0,104.0,64.0,5,216,10017.0,20.0,15.0
0.005,6,10,1779,5,928,1.0,660.0,660.0,5,851,1.0,583.0,583.0
0.008,6,10,1972,5,910,2.0,642.0,642.0,5,1062,2.0,794.0,794.0
0.009,6,10,1989,5,910,2.0,642.0,642.0,5,1079,2.0,811.0,811.0
0.005,6,10,1989,5,927,1.0,659.0,659.0,5,1062,1.0,794.0,794.0
40.079,17,10,676,5,460,10019.0,104.0,64.0,5,216,10019.0,20.0,15.0
0.131,6,10,1506,5,395,30.0,127.0,127.0,5,1111,30.0,843.0,843.0
0.006,6,10,1689,5,839,1.0,571.0,571.0,5,850,1.0,582.0,582.0
0.004,6,10,2000,5,927,1.0,659.0,659.0,5,1073,1.0,805.0,805.0
352.699,6,20,2210,6,1308,12004.0,494.0,494.0,14,902,27130.0,83.0,83.0
0.004,17,4,284,2,120,0.0,32.0,32.0,2,164,0.0,60.0,54.0
0.003,17,2,234,1,61,0.0,33.0,33.0,1,173,0.0,145.0,145.0
0.005,6,10,2006,5,927,1.0,659.0,659.0,5,1079,1.0,811.0,811.0
0.005,17,2,164,1,74,0.0,46.0,46.0,1,90,0.0,62.0,62.0
0.005,6,13,3747,7,509,0.0,137.0,137.0,6,3238,0.0,1470.0,1459.0
280.284,6,23,6075,10,1186,31142.0,267.0,156.0,13,4889,23355.0,1400.0,873.0
0.141,17,2,80,1,32,0.0,4.0,4.0,1,48,0.0,20.0,20.0
0.003,17,2,148,1,60,0.0,32.0,32.0,1,88,0.0,60.0,60.0
0.007,17,2,152,1,68,0.0,40.0,40.0,1,84,0.0,56.0,56.0
0.009,6,10,1989,5,910,2.0,642.0,642.0,5,1079,2.0,811.0,811.0
40.077,17,10,676,5,460,10015.0,104.0,64.0,5,216,10018.0,20.0,15.0
0.005,6,10,2007,5,928,1.0,660.0,660.0,5,1079,1.0,811.0,811.0
0.01,6,10,1989,5,910,2.0,642.0,642.0,5,1079,2.0,811.0,811.0
0.005,6,10,2000,5,927,1.0,659.0,659.0,5,1073,1.0,805.0,805.0
0.111,6,10,1506,5,395,25.0,127.0,127.0,5,1111,25.0,843.0,843.0
0.105,6,10,1506,5,395,21.0,127.0,127.0,5,1111,23.0,843.0,843.0
40.055,17,10,676,5,460,10012.0,104.0,64.0,5,216,10012.0,20.0,15.0
0.113,6,10,1506,5,395,27.0,127.0,127.0,5,1111,23.0,843.0,843.0
40.063,17,10,676,5,460,10015.0,104.0,64.0,5,216,10014.0,20.0,15.0
0.005,6,10,2007,5,928,1.0,660.0,660.0,5,1079,1.0,811.0,811.0
0.005,17,2,154,1,69,0.0,41.0,41.0,1,85,0.0,57.0,57.0
0.005,6,10,2007,5,928,1.0,660.0,660.0,5,1079,1.0,811.0,811.0
0.005,6,10,1989,5,927,1.0,659.0,659.0,5,1062,1.0,794.0,794.0
0.028,6,10,1972,5,910,7.0,642.0,642.0,5,1062,6.0,794.0,794.0
166.394,17,84,12158,42,2813,4058.0,44.0,38.0,42,9345,4058.0,239.0,194.0
0.0,17,2,136,1,60,0.0,32.0,32.0,1,76,0.0,48.0,48.0
0.004,17,2,144,1,64,0.0,36.0,36.0,1,80,0.0,52.0,52.0
0.004,6,10,1989,5,927,1.0,659.0,659.0,5,1062,1.0,794.0,794.0
0.072,17,2,182,1,65,0.0,37.0,37.0,1,117,0.0,89.0,89.0
0.097,6,10,1506,5,395,19.0,127.0,127.0,5,1111,22.0,843.0,843.0
10.789,17,28,4417,14,1994,821.0,269.0,114.0,14,2423,821.0,586.0,145.0
300.334,6,16,2170,9,684,37520.0,146.0,146.0,7,1486,50024.0,419.0,398.0
0.002,17,2,152,1,76,0.0,48.0,48.0,1,76,0.0,48.0,48.0
0.009,6,10,1989,5,910,2.0,642.0,642.0,5,1079,2.0,811.0,811.0
0.787,6,10,937,6,427,157.0,107.0,107.0,4,510,175.0,294.0,294.0
0.005,6,14,3736,7,446,0.0,74.0,74.0,7,3290,0.0,1448.0,972.0
0.005,6,10,2000,5,927,1.0,659.0,659.0,5,1073,1.0,805.0,805.0
0.005,6,10,1989,5,927,1.0,659.0,659.0,5,1062,1.0,794.0,794.0
0.012,6,10,1983,5,910,3.0,642.0,642.0,5,1073,3.0,805.0,805.0
0.003,17,2,136,1,60,0.0,32.0,32.0,1,76,0.0,48.0,48.0
0.005,6,10,1643,5,860,1.0,592.0,592.0,5,783,1.0,515.0,515.0
0.012,6,10,1972,5,910,3.0,642.0,642.0,5,1062,3.0,794.0,794.0
0.007,6,10,1774,5,923,1.0,655.0,655.0,5,851,1.0,583.0,583.0
0.023,6,10,1989,5,910,5.0,642.0,642.0,5,1079,5.0,811.0,811.0
0.006,6,10,1547,5,764,1.0,496.0,496.0,5,783,1.0,515.0,515.0
0.07,6,10,1506,5,395,15.0,127.0,127.0,5,1111,16.0,843.0,843.0
0.004,17,2,148,1,60,0.0,32.0,32.0,1,88,0.0,60.0,60.0
0.005,6,10,1689,5,839,1.0,571.0,571.0,5,850,1.0,582.0,582.0
0.004,17,2,136,1,60,0.0,32.0,32.0,1,76,0.0,48.0,48.0
0.003,17,2,136,1,60,0.0,32.0,32.0,1,76,0.0,48.0,48.0
0.005,6,10,2006,5,927,1.0,659.0,659.0,5,1079,1.0,811.0,811.0
310.219,17,18,1044,10,716,34455.0,48.0,43.0,8,328,44298.0,20.0,13.0
0.004,6,10,1774,5,923,1.0,655.0,655.0,5,851,1.0,583.0,583.0
0.004,6,10,2006,5,927,1.0,659.0,659.0,5,1079,1.0,811.0,811.0
0.013,6,10,1990,5,911,3.0,643.0,643.0,5,1079,3.0,811.0,811.0
0.005,6,10,2000,5,927,1.0,659.0,659.0,5,1073,1.0,805.0,805.0
0.003,17,2,160,1,72,0.0,44.0,44.0,1,88,0.0,60.0,60.0
0.214,6,16,2668,8,1394,30.0,533.0,323.0,8,1274,19.0,529.0,212.0
300.327,6,29,10622,16,2099,20021.0,585.0,314.0,13,8523,20026.0,1402.0,979.0
0.108,6,10,1506,5,395,22.0,127.0,127.0,5,1111,24.0,843.0,843.0
0.066,6,10,1506,5,395,13.0,127.0,127.0,5,1111,14.0,843.0,843.0
0.014,6,10,1989,5,910,3.0,642.0,642.0,5,1079,3.0,811.0,811.0
11.058,17,28,4420,14,1993,842.0,268.0,114.0,14,2427,842.0,586.0,145.0
0.006,6,10,1854,5,889,1.0,621.0,621.0,5,965,1.0,697.0,697.0
0.038,17,2,136,1,60,0.0,32.0,32.0,1,76,0.0,48.0,48.0
0.072,17,2,136,1,60,0.0,32.0,32.0,1,76,0.0,48.0,48.0
0.005,6,10,2007,5,928,1.0,660.0,660.0,5,1079,1.0,811.0,811.0
0.067,6,10,1506,5,395,13.0,127.0,127.0,5,1111,14.0,843.0,843.0
0.01,6,12,1926,6,1189,1.0,659.0,434.0,6,737,2.0,417.0,417.0
0.013,6,10,1989,5,910,3.0,642.0,642.0,5,1079,3.0,811.0,811.0
0.009,6,10,1989,5,910,2.0,642.0,642.0,5,1079,2.0,811.0,811.0
0.005,6,10,1643,5,860,1.0,592.0,592.0,5,783,1.0,515.0,515.0
11.163,17,28,4421,14,1994,846.0,269.0,114.0,14,2427,846.0,586.0,145.0
0.066,6,10,1506,5,395,14.0,127.0,127.0,5,1111,15.0,843.0,843.0
0.072,6,10,1506,5,395,14.0,127.0,127.0,5,1111,16.0,843.0,843.0
0.038,17,2,152,1,76,0.0,48.0,48.0,1,76,0.0,48.0,48.0
0.011,6,10,1989,5,910,2.0,642.0,642.0,5,1079,2.0,811.0,811.0
0.006,17,2,170,1,65,0.0,37.0,37.0,1,105,0.0,77.0,77.0
0.086,6,10,1506,5,395,19.0,127.0,127.0,5,1111,16.0,843.0,843.0
0.005,6,13,3690,7,452,0.0,80.0,80.0,6,3238,1.0,1470.0,1459.0
0.005,6,10,2007,5,928,1.0,660.0,660.0,5,1079,1.0,811.0,811.0
0.004,6,10,1989,5,927,1.0,659.0,659.0,5,1062,1.0,794.0,794.0
0.097,6,10,1506,5,395,22.0,127.0,127.0,5,1111,23.0,843.0,843.0
0.006,6,10,1547,5,764,1.0,496.0,496.0,5,783,1.0,515.0,515.0
0.007,6,10,1643,5,860,1.0,592.0,592.0,5,783,1.0,515.0,515.0
0.015,6,10,1989,5,910,3.0,642.0,642.0,5,1079,3.0,811.0,811.0
0.107,6,10,1506,5,395,24.0,127.0,127.0,5,1111,25.0,843.0,843.0
0.005,6,10,1779,5,928,1.0,660.0,660.0,5,851,1.0,583.0,583.0
0.004,17,2,148,1,60,0.0,32.0,32.0,1,88,0.0,60.0,60.0
0.016,6,10,1990,5,911,4.0,643.0,643.0,5,1079,4.0,811.0,811.0
0.206,6,16,2777,8,1395,29.0,533.0,323.0,8,1382,18.0,529.0,239.0
241.936,6,389,348059,187,21259,1300.0,2736.0,960.0,202,326800,1203.0,2804.0,1647.0
0.001,17,2,180,1,66,0.0,38.0,38.0,1,114,0.0,86.0,86.0
0.006,6,13,3747,7,509,0.0,137.0,137.0,6,3238,1.0,1470.0,1459.0
0.004,17,4,284,2,120,1.0,32.0,32.0,2,164,1.0,60.0,54.0
0.011,6,10,1989,5,910,2.0,642.0,642.0,5,1079,2.0,811.0,811.0
0.214,6,16,2777,8,1395,30.0,533.0,323.0,8,1382,19.0,529.0,239.0
0.094,6,10,1506,5,395,21.0,127.0,127.0,5,1111,19.0,843.0,843.0
0.093,6,10,1506,5,395,20.0,127.0,127.0,5,1111,21.0,843.0,843.0
40.062,17,10,676,5,460,10014.0,104.0,64.0,5,216,10014.0,20.0,15.0
0.082,6,10,1506,5,395,18.0,127.0,127.0,5,1111,17.0,843.0,843.0
11.036,17,28,4390,14,2312,840.0,587.0,137.0,14,2078,840.0,269.0,120.0
173.307,17,80,11616,40,2671,4443.0,44.0,38.0,40,8945,4443.0,261.0,195.0
9.051,17,6,376,5,280,2262.0,28.0,28.0,1,96,0.0,68.0,68.0
0.005,6,10,1854,5,889,1.0,621.0,621.0,5,965,1.0,697.0,697.0
334.601,17,20,1124,10,716,37169.0,48.0,43.0,10,408,37169.0,20.0,12.0
40.052,17,10,676,5,460,10012.0,104.0,64.0,5,216,10012.0,20.0,15.0
0.059,17,2,136,1,60,0.0,32.0,32.0,1,76,0.0,48.0,48.0
11.159,17,28,4423,14,1994,846.0,269.0,114.0,14,2429,846.0,588.0,145.0
0.54,6,22,7187,11,1635,53.0,748.0,263.0,11,5552,53.0,2335.0,994.0
309.919,17,20,1124,10,716,34421.0,48.0,43.0,10,408,34421.0,20.0,12.0
0.003,17,2,148,1,60,0.0,32.0,32.0,1,88,0.0,60.0,60.0
0.053,6,10,1990,5,911,13.0,643.0,643.0,5,1079,13.0,811.0,811.0
0.091,6,10,1506,5,395,21.0,127.0,127.0,5,1111,22.0,843.0,843.0
0.011,6,10,1972,5,910,2.0,642.0,642.0,5,1062,2.0,794.0,794.0
0.012,6,10,1983,5,910,3.0,642.0,642.0,5,1073,2.0,805.0,805.0
0.006,6,10,1854,5,889,1.0,621.0,621.0,5,965,1.0,697.0,697.0
0.001,17,2,180,1,66,0.0,38.0,38.0,1,114,0.0,86.0,86.0
0.085,6,10,1506,5,395,20.0,127.0,127.0,5,1111,19.0,843.0,843.0
0.139,6,10,1506,5,395,32.0,127.0,127.0,5,1111,33.0,843.0,843.0
0.004,6,10,2006,5,927,1.0,659.0,659.0,5,1079,1.0,811.0,811.0
0.009,6,10,1990,5,911,2.0,643.0,643.0,5,1079,2.0,811.0,811.0
0.005,6,10,2006,5,927,1.0,659.0,659.0,5,1079,1.0,811.0,811.0
0.005,17,2,214,1,75,0.0,47.0,47.0,1,139,0.0,111.0,111.0
0.02,6,10,1990,5,911,4.0,643.0,643.0,5,1079,5.0,811.0,811.0
0.001,17,2,180,1,66,0.0,38.0,38.0,1,114,0.0,86.0,86.0
172.132,17,78,11029,39,2605,4529.0,44.0,38.0,39,8424,4529.0,239.0,188.0
0.21,6,16,2670,8,1396,30.0,533.0,324.0,8,1274,18.0,529.0,212.0
0.009,6,14,3736,7,446,1.0,74.0,74.0,7,3290,1.0,1448.0,972.0
0.064,6,10,1506,5,395,15.0,127.0,127.0,5,1111,13.0,843.0,843.0
0.005,17,2,148,1,60,0.0,32.0,32.0,1,88,0.0,60.0,60.0
0.052,6,10,1506,5,395,11.0,127.0,127.0,5,1111,12.0,843.0,843.0
40.083,17,10,676,5,460,10019.0,104.0,64.0,5,216,10019.0,20.0,15.0
0.066,6,10,1506,5,395,15.0,127.0,127.0,5,1111,14.0,843.0,843.0
0.007,6,10,1547,5,764,1.0,496.0,496.0,5,783,1.0,515.0,515.0
0.008,6,12,1926,6,1189,1.0,659.0,434.0,6,737,1.0,417.0,417.0
0.007,6,10,1989,5,927,1.0,659.0,659.0,5,1062,1.0,794.0,794.0
0.014,6,10,1989,5,910,3.0,642.0,642.0,5,1079,3.0,811.0,811.0
0.004,6,10,2006,5,927,1.0,659.0,659.0,5,1079,1.0,811.0,811.0
0.006,6,10,2006,5,927,1.0,659.0,659.0,5,1079,1.0,811.0,811.0
0.028,6,10,1989,5,910,7.0,642.0,642.0,5,1079,7.0,811.0,811.0
0.003,17,2,148,1,60,0.0,32.0,32.0,1,88,0.0,60.0,60.0
0.165,6,10,1506,5,395,36.0,127.0,127.0,5,1111,38.0,843.0,843.0
0.016,6,10,1972,5,910,4.0,642.0,642.0,5,1062,4.0,794.0,794.0
40.068,17,10,676,5,460,10015.0,104.0,64.0,5,216,10016.0,20.0,15.0
0.004,17,2,148,1,60,0.0,32.0,32.0,1,88,0.0,60.0,60.0
0.015,6,10,1990,5,911,3.0,643.0,643.0,5,1079,3.0,811.0,811.0
0.038,17,2,170,1,65,0.0,37.0,37.0,1,105,0.0,77.0,77.0
0.086,6,10,1506,5,395,19.0,127.0,127.0,5,1111,16.0,843.0,843.0
0.016,6,10,1989,5,910,3.0,642.0,642.0,5,1079,4.0,811.0,811.0
240.013,6,9,787,5,488,60003.0,232.0,232.0,4,299,80003.0,83.0,83.0
0.102,6,10,1506,5,395,23.0,127.0,127.0,5,1111,22.0,843.0,843.0
0.006,6,10,1547,5,764,1.0,496.0,496.0,5,783,1.0,515.0,515.0
0.063,6,10,1506,5,395,13.0,127.0,127.0,5,1111,15.0,843.0,843.0
0.005,6,10,2006,5,927,1.0,659.0,659.0,5,1079,1.0,811.0,811.0
0.017,6,10,1983,5,910,4.0,642.0,642.0,5,1073,4.0,805.0,805.0
0.012,6,10,1989,5,910,3.0,642.0,642.0,5,1079,2.0,811.0,811.0
0.005,6,10,2007,5,928,1.0,660.0,660.0,5,1079,1.0,811.0,811.0
0.119,6,10,1506,5,395,28.0,127.0,127.0,5,1111,28.0,843.0,843.0
0.006,6,10,1689,5,839,1.0,571.0,571.0,5,850,1.0,582.0,582.0
0.058,6,10,1506,5,395,13.0,127.0,127.0,5,1111,13.0,843.0,843.0
0.086,6,10,1506,5,395,19.0,127.0,127.0,5,1111,17.0,843.0,843.0
10.757,17,28,4422,14,1994,818.0,269.0,114.0,14,2428,818.0,587.0,145.0
0.064,6,10,1506,5,395,13.0,127.0,127.0,5,1111,14.0,843.0,843.0
0.001,17,2,180,1,66,0.0,38.0,38.0,1,114,0.0,86.0,86.0
0.004,17,2,148,1,60,0.0,32.0,32.0,1,88,0.0,60.0,60.0
0.015,6,10,1972,5,910,3.0,642.0,642.0,5,1062,3.0,794.0,794.0
0.11,6,10,1506,5,395,23.0,127.0,127.0,5,1111,23.0,843.0,843.0
0.005,6,10,2007,5,928,1.0,660.0,660.0,5,1079,1.0,811.0,811.0
0.005,6,14,3742,7,452,0.0,80.0,80.0,7,3290,0.0,1448.0,972.0
0.011,6,10,1762,5,911,2.0,643.0,643.0,5,851,2.0,583.0,583.0
0.005,17,2,144,1,64,0.0,36.0,36.0,1,80,0.0,52.0,52.0
369.188,6,22,2264,16,818,24612.0,146.0,146.0,6,1446,4635.0,419.0,398.0
0.014,6,10,1762,5,911,3.0,643.0,643.0,5,851,3.0,583.0,583.0
0.095,6,10,1506,5,395,20.0,127.0,127.0,5,1111,17.0,843.0,843.0
62.085,6,44,14423,22,8516,430.0,2720.0,1086.0,22,5907,2948.0,2667.0,385.0
0.004,6,10,2006,5,927,1.0,659.0,659.0,5,1079,1.0,811.0,811.0
0.084,6,10,1506,5,395,20.0,127.0,127.0,5,1111,20.0,843.0,843.0
0.016,6,10,1990,5,911,4.0,643.0,643.0,5,1079,3.0,811.0,811.0
0.005,6,10,2000,5,927,1.0,659.0,659.0,5,1073,1.0,805.0,805.0
0.005,6,10,2000,5,927,1.0,659.0,659.0,5,1073,1.0,805.0,805.0
0.006,6,10,2007,5,928,1.0,660.0,660.0,5,1079,1.0,811.0,811.0
1730.446,6,48,2957,31,1800,57681.0,35.0,35.0,17,1157,108147.0,31.0,31.0
0.014,6,10,1677,5,827,3.0,559.0,559.0,5,850,3.0,582.0,582.0
0.102,6,10,1506,5,395,18.0,127.0,127.0,5,1111,22.0,843.0,843.0
0.005,17,2,164,1,74,0.0,46.0,46.0,1,90,0.0,62.0,62.0
0.004,6,10,1774,5,923,1.0,655.0,655.0,5,851,1.0,583.0,583.0
0.005,17,2,168,1,76,0.0,48.0,48.0,1,92,0.0,64.0,64.0
0.11,6,10,1506,5,395,24.0,127.0,127.0,5,1111,21.0,843.0,843.0
0.005,6,13,3747,7,509,0.0,137.0,137.0,6,3238,0.0,1470.0,1459.0
0.113,6,10,1506,5,395,26.0,127.0,127.0,5,1111,21.0,843.0,843.0
0.043,17,2,380,1,61,0.0,33.0,33.0,1,319,0.0,291.0,291.0
0.004,6,10,2006,5,927,1.0,659.0,659.0,5,1079,1.0,811.0,811.0
10.743,17,28,4418,14,1994,818.0,269.0,114.0,14,2424,817.0,587.0,145.0
0.006,6,10,1547,5,764,1.0,496.0,496.0,5,783,1.0,515.0,515.0
0.012,6,10,1762,5,911,3.0,643.0,643.0,5,851,2.0,583.0,583.0
0.006,6,10,1547,5,764,1.0,496.0,496.0,5,783,1.0,515.0,515.0
175.09,17,84,12135,42,2806,4270.0,44.0,38.0,42,9329,4270.0,261.0,194.0
1772.458,6,105,6270,60,3525,30040.0,27.0,27.0,45,2745,40282.0,27.0,27.0
0.004,6,10,2000,5,927,1.0,659.0,659.0,5,1073,1.0,805.0,805.0
0.145,6,10,1506,5,395,34.0,127.0,127.0,5,1111,32.0,843.0,843.0
0.003,6,10,1702,5,863,0.0,595.0,595.0,5,839,0.0,571.0,571.0
0.174,17,2,152,1,76,0.0,48.0,48.0,1,76,0.0,48.0,48.0
0.005,6,10,1643,5,860,1.0,592.0,592.0,5,783,1.0,515.0,515.0
0.001,17,2,179,1,62,0.0,34.0,34.0,1,117,0.0,89.0,89.0
0.007,6,10,1689,5,839,1.0,571.0,571.0,5,850,1.0,582.0,582.0
240.015,6,9,787,5,488,60003.0,232.0,232.0,4,299,80004.0,83.0,83.0
0.013,6,10,1631,5,848,3.0,580.0,580.0,5,783,3.0,515.0,515.0
0.015,6,10,1990,5,911,3.0,643.0,643.0,5,1079,3.0,811.0,811.0
0.006,17,2,152,1,76,0.0,48.0,48.0,1,76,0.0,48.0,48.0
0.005,6,10,1643,5,860,1.0,592.0,592.0,5,783,1.0,515.0,515.0
0.02,6,14,3787,7,497,3.0,125.0,125.0,7,3290,3.0,1448.0,972.0
15.072,17,15,9238,8,6902,2149.0,1350.0,834.0,7,2336,2507.0,1350.0,305.0
0.014,6,10,1990,5,911,3.0,643.0,643.0,5,1079,3.0,811.0,811.0
0.014,6,10,1989,5,910,3.0,642.0,642.0,5,1079,3.0,811.0,811.0
0.004,17,4,284,2,120,0.0,32.0,32.0,2,164,0.0,60.0,54.0
0.008,6,10,1990,5,911,2.0,643.0,643.0,5,1079,1.0,811.0,811.0
0.167,17,2,152,1,76,0.0,48.0,48.0,1,76,0.0,48.0,48.0
0.005,6,10,1689,5,839,1.0,571.0,571.0,5,850,1.0,582.0,582.0
0.005,6,13,3747,7,509,0.0,137.0,137.0,6,3238,0.0,1470.0,1459.0
0.018,6,14,3787,7,497,2.0,125.0,125.0,7,3290,2.0,1448.0,972.0
0.037,17,2,148,1,60,0.0,32.0,32.0,1,88,0.0,60.0,60.0
0.083,6,10,1506,5,395,19.0,127.0,127.0,5,1111,18.0,843.0,843.0
0.07,6,10,1506,5,395,14.0,127.0,127.0,5,1111,14.0,843.0,843.0
0.015,6,10,1990,5,911,3.0,643.0,643.0,5,1079,3.0,811.0,811.0
0.006,17,2,170,1,65,0.0,37.0,37.0,1,105,0.0,77.0,77.0
0.008,6,12,1926,6,1189,1.0,659.0,434.0,6,737,1.0,417.0,417.0
0.009,6,10,1631,5,848,2.0,580.0,580.0,5,783,2.0,515.0,515.0
0.008,6,10,1677,5,827,2.0,559.0,559.0,5,850,1.0,582.0,582.0
0.009,17,2,180,1,66,0.0,38.0,38.0,1,114,0.0,86.0,86.0
0.006,6,10,1689,5,839,1.0,571.0,571.0,5,850,1.0,582.0,582.0
0.012,6,10,1972,5,910,3.0,642.0,642.0,5,1062,3.0,794.0,794.0
0.001,17,2,180,1,66,0.0,38.0,38.0,1,114,0.0,86.0,86.0
0.098,6,10,1506,5,395,21.0,127.0,127.0,5,1111,19.0,843.0,843.0
0.004,6,10,1989,5,927,1.0,659.0,659.0,5,1062,1.0,794.0,794.0
15.122,17,15,7294,7,3798,2515.0,1350.0,514.0,8,3496,2156.0,1350.0,409.0
0.078,6,10,1506,5,395,15.0,127.0,127.0,5,1111,17.0,843.0,843.0
0.004,6,10,2000,5,927,1.0,659.0,659.0,5,1073,1.0,805.0,805.0
0.009,6,10,1631,5,848,2.0,580.0,580.0,5,783,2.0,515.0,515.0
0.005,6,10,1989,5,927,1.0,659.0,659.0,5,1062,1.0,794.0,794.0
0.041,17,2,136,1,60,0.0,32.0,32.0,1,76,0.0,48.0,48.0
0.001,17,2,180,1,66,0.0,38.0,38.0,1,114,0.0,86.0,86.0
0.003,17,2,148,1,60,0.0,32.0,32.0,1,88,0.0,60.0,60.0
240.092,6,31,9337,15,6907,17149.0,2029.0,681.0,16,2430,16006.0,580.0,198.0
0.06,17,2,152,1,76,0.0,48.0,48.0,1,76,0.0,48.0,48.0
0.001,17,2,180,1,66,0.0,38.0,38.0,1,114,0.0,86.0,86.0
0.005,17,2,170,1,65,0.0,37.0,37.0,1,105,0.0,77.0,77.0
0.107,6,10,1506,5,395,24.0,127.0,127.0,5,1111,21.0,843.0,843.0
0.013,6,10,2007,5,928,3.0,660.0,660.0,5,1079,3.0,811.0,811.0
0.008,17,2,162,1,65,0.0,37.0,37.0,1,97,0.0,69.0,69.0
173.194,17,76,10932,38,2547,4680.0,44.0,39.0,38,8385,4680.0,261.0,192.0
0.061,6,10,1506,5,395,14.0,127.0,127.0,5,1111,13.0,843.0,843.0
0.004,6,10,1774,5,923,1.0,655.0,655.0,5,851,1.0,583.0,583.0
0.088,6,10,1506,5,395,18.0,127.0,127.0,5,1111,19.0,843.0,843.0
0.008,6,10,1983,5,910,2.0,642.0,642.0,5,1073,1.0,805.0,805.0
0.009,6,10,1990,5,911,2.0,643.0,643.0,5,1079,2.0,811.0,811.0
0.003,17,2,136,1,60,0.0,32.0,32.0,1,76,0.0,48.0,48.0
0.013,6,10,1677,5,827,3.0,559.0,559.0,5,850,3.0,582.0,582.0
0.005,6,10,2006,5,927,1.0,659.0,659.0,5,1079,1.0,811.0,811.0
0.007,6,10,1983,5,910,1.0,642.0,642.0,5,1073,1.0,805.0,805.0
0.062,17,2,152,1,76,0.0,48.0,48.0,1,76,0.0,48.0,48.0
9.048,17,6,376,5,280,2262.0,28.0,28.0,1,96,0.0,68.0,68.0
0.008,6,10,2007,5,928,2.0,660.0,660.0,5,1079,1.0,811.0,811.0
301.303,6,31,10095,17,2840,18831.0,801.0,389.0,14,7255,18561.0,1402.0,814.0
0.098,6,10,1506,5,395,22.0,127.0,127.0,5,1111,19.0,843.0,843.0
0.013,6,10,1990,5,911,3.0,643.0,643.0,5,1079,3.0,811.0,811.0
0.017,6,10,1990,5,911,4.0,643.0,643.0,5,1079,4.0,811.0,811.0
0.018,6,10,1989,5,910,4.0,642.0,642.0,5,1079,4.0,811.0,811.0
0.005,6,10,1989,5,927,1.0,659.0,659.0,5,1062,1.0,794.0,794.0
0.041,17,2,152,1,76,0.0,48.0,48.0,1,76,0.0,48.0,48.0
300.289,6,16,2170,9,684,37515.0,146.0,146.0,7,1486,50021.0,419.0,398.0
0.013,6,10,1972,5,910,3.0,642.0,642.0,5,1062,3.0,794.0,794.0
0.005,17,2,187,1,71,0.0,43.0,43.0,1,116,0.0,88.0,88.0
0.005,6,10,2006,5,927,1.0,659.0,659.0,5,1079,1.0,811.0,811.0
0.012,6,10,1989,5,910,3.0,642.0,642.0,5,1079,3.0,811.0,811.0
0.071,6,10,1506,5,395,15.0,127.0,127.0,5,1111,15.0,843.0,843.0
0.007,17,2,179,1,71,0.0,43.0,43.0,1,108,0.0,80.0,80.0
0.004,6,10,2006,5,927,1.0,659.0,659.0,5,1079,1.0,811.0,811.0
0.004,17,4,284,2,120,0.0,32.0,32.0,2,164,1.0,60.0,54.0
0.006,6,10,1989,5,927,1.0,659.0,659.0,5,1062,1.0,794.0,794.0
0.005,17,2,164,1,74,0.0,46.0,46.0,1,90,0.0,62.0,62.0
0.005,6,10,1989,5,927,1.0,659.0,659.0,5,1062,1.0,794.0,794.0
0.013,6,10,1990,5,911,3.0,643.0,643.0,5,1079,3.0,811.0,811.0
0.013,6,10,1983,5,910,3.0,642.0,642.0,5,1073,3.0,805.0,805.0
0.04,17,4,352,2,130,1.0,37.0,37.0,2,222,0.0,89.0,83.0
0.006,6,10,2007,5,928,1.0,660.0,660.0,5,1079,1.0,811.0,811.0
68.565,6,28,12204,15,3855,4897.0,1002.0,511.0,13,8349,5699.0,2355.0,958.0
40.063,17,10,676,5,460,10014.0,104.0,64.0,5,216,10015.0,20.0,15.0
0.005,6,10,2006,5,927,1.0,659.0,659.0,5,1079,1.0,811.0,811.0
0.015,17,2,198,1,91,0.0,63.0,63.0,1,107,0.0,79.0,79.0
0.005,6,10,2007,5,928,1.0,660.0,660.0,5,1079,1.0,811.0,811.0
40.053,17,10,676,5,460,10012.0,104.0,64.0,5,216,10012.0,20.0,15.0
0.082,6,10,1506,5,395,19.0,127.0,127.0,5,1111,17.0,843.0,843.0
240.133,6,33,9741,17,7274,15008.0,1515.0,639.0,16,2467,16007.0,580.0,203.0
0.086,6,10,1989,5,910,21.0,642.0,642.0,5,1079,21.0,811.0,811.0
0.037,17,2,152,1,76,0.0,48.0,48.0,1,76,0.0,48.0,48.0
0.015,6,10,1990,5,911,3.0,643.0,643.0,5,1079,3.0,811.0,811.0
0.012,17,2,179,1,71,0.0,43.0,43.0,1,108,0.0,80.0,80.0
1711.409,6,103,6166,59,3473,29507.0,27.0,27.0,44,2693,39796.0,27.0,27.0
0.094,6,10,1506,5,395,20.0,127.0,127.0,5,1111,21.0,843.0,843.0
176.418,17,74,10289,37,2460,4900.0,44.0,38.0,37,7829,4900.0,239.0,183.0
0.01,6,10,1990,5,911,2.0,643.0,643.0,5,1079,2.0,811.0,811.0
0.004,6,10,2007,5,928,1.0,660.0,660.0,5,1079,1.0,811.0,811.0
0.007,6,10,2000,5,927,1.0,659.0,659.0,5,1073,1.0,805.0,805.0
0.086,6,10,1506,5,395,19.0,127.0,127.0,5,1111,18.0,843.0,843.0
0.092,6,10,1506,5,395,22.0,127.0,127.0,5,1111,21.0,843.0,843.0
0.007,6,10,1547,5,764,1.0,496.0,496.0,5,783,1.0,515.0,515.0
40.057,17,10,676,5,460,10012.0,104.0,64.0,5,216,10013.0,20.0,15.0
0.005,6,13,3690,7,452,0.0,80.0,80.0,6,3238,0.0,1470.0,1459.0
0.005,6,10,2006,5,927,1.0,659.0,659.0,5,1079,1.0,811.0,811.0
0.022,6,10,1983,5,910,5.0,642.0,642.0,5,1073,5.0,805.0,805.0
0.014,6,10,1989,5,910,3.0,642.0,642.0,5,1079,3.0,811.0,811.0
0.013,6,10,1631,5,848,3.0,580.0,580.0,5,783,3.0,515.0,515.0
0.105,6,10,1506,5,395,24.0,127.0,127.0,5,1111,19.0,843.0,843.0
0.246,6,10,1506,5,395,23.0,127.0,127.0,5,1111,56.0,843.0,843.0
0.008,6,10,1990,5,911,2.0,643.0,643.0,5,1079,2.0,811.0,811.0
240.084,6,16,4480,9,963,30010.0,238.0,166.0,7,3517,40013.0,1402.0,786.0
0.006,6,10,1547,5,764,1.0,496.0,496.0,5,783,1.0,515.0,515.0
0.009,6,10,1989,5,910,2.0,642.0,642.0,5,1079,2.0,811.0,811.0
0.004,6,15,3794,8,504,0.0,80.0,80.0,7,3290,0.0,1448.0,972.0
241.437,6,297,343552,116,17548,2099.0,2736.0,886.0,181,326004,1341.0,2804.0,1851.0
0.004,6,10,1702,5,863,1.0,595.0,595.0,5,839,0.0,571.0,571.0
0.082,6,10,1506,5,395,18.0,127.0,127.0,5,1111,17.0,843.0,843.0
10.755,17,28,4417,14,1994,819.0,269.0,114.0,14,2423,819.0,586.0,145.0
0.016,6,10,1989,5,910,4.0,642.0,642.0,5,1079,4.0,811.0,811.0
0.039,17,2,182,1,65,0.0,37.0,37.0,1,117,0.0,89.0,89.0
0.012,6,10,1989,5,910,3.0,642.0,642.0,5,1079,2.0,811.0,811.0
0.014,6,10,1989,5,910,3.0,642.0,642.0,5,1079,3.0,811.0,811.0
0.139,6,10,1506,5,395,29.0,127.0,127.0,5,1111,31.0,843.0,843.0
0.004,6,10,2006,5,927,1.0,659.0,659.0,5,1079,1.0,811.0,811.0
0.005,17,2,170,1,65,0.0,37.0,37.0,1,105,0.0,77.0,77.0
0.107,6,10,1506,5,395,24.0,127.0,127.0,5,1111,20.0,843.0,843.0
0.017,6,10,1990,5,911,4.0,643.0,643.0,5,1079,4.0,811.0,811.0
240.011,6,9,787,5,488,60002.0,232.0,232.0,4,299,80002.0,83.0,83.0
0.044,6,10,1605,5,388,10.0,120.0,120.0,5,1217,11.0,949.0,949.0
120.525,6,11,1742,7,1360,20087.0,494.0,494.0,4,382,20007.0,83.0,83.0
0.004,6,10,1774,5,923,1.0,655.0,655.0,5,851,0.0,583.0,583.0
15.106,17,15,9239,8,6902,2150.0,1350.0,834.0,7,2337,2511.0,1350.0,305.0
0.005,6,10,1774,5,923,1.0,655.0,655.0,5,851,1.0,583.0,583.0
0.004,17,4,420,2,122,0.0,33.0,33.0,2,298,1.0,145.0,121.0
0.01,6,10,1989,5,910,2.0,642.0,642.0,5,1079,2.0,811.0,811.0
0.005,6,10,1854,5,889,1.0,621.0,621.0,5,965,1.0,697.0,697.0
0.005,6,10,1689,5,839,1.0,571.0,571.0,5,850,1.0,582.0,582.0
0.008,6,12,1926,6,1189,1.0,659.0,434.0,6,737,1.0,417.0,417.0
0.009,6,10,1983,5,910,2.0,642.0,642.0,5,1073,2.0,805.0,805.0
0.005,17,2,146,1,65,0.0,37.0,37.0,1,81,0.0,53.0,53.0
0.123,17,2,80,1,32,0.0,4.0,4.0,1,48,0.0,20.0,20.0
0.008,6,12,1926,6,1189,1.0,659.0,434.0,6,737,1.0,417.0,417.0
240.091,6,16,4481,9,963,30011.0,238.0,166.0,7,3518,40014.0,1402.0,786.0
0.004,17,2,148,1,60,0.0,32.0,32.0,1,88,0.0,60.0,60.0
0.045,6,10,1983,5,910,11.0,642.0,642.0,5,1073,11.0,805.0,805.0
0.084,6,10,1506,5,395,17.0,127.0,127.0,5,1111,19.0,843.0,843.0
126.027,6,14,2938,8,2504,17969.0,1414.0,1086.0,6,434,25158.0,182.0,182.0
0.068,6,10,1506,5,395,16.0,127.0,127.0,5,1111,16.0,843.0,843.0
0.006,17,2,179,1,71,0.0,43.0,43.0,1,108,0.0,80.0,80.0
0.006,6,10,1643,5,860,1.0,592.0,592.0,5,783,1.0,515.0,515.0
40.057,17,10,676,5,460,10012.0,104.0,64.0,5,216,10013.0,20.0,15.0
0.084,6,10,1506,5,395,18.0,127.0,127.0,5,1111,18.0,843.0,843.0
0.032,6,14,3787,7,497,5.0,125.0,125.0,7,3290,5.0,1448.0,972.0
0.072,6,10,1506,5,395,16.0,127.0,127.0,5,1111,13.0,843.0,843.0
40.062,17,10,676,5,460,10014.0,104.0,64.0,5,216,10012.0,20.0,15.0
40.047,17,10,676,5,460,10011.0,104.0,64.0,5,216,10011.0,20.0,15.0
0.004,6,10,2007,5,928,1.0,660.0,660.0,5,1079,1.0,811.0,811.0
360.062,6,21,3981,13,3142,30005.0,494.0,494.0,8,839,51436.0,83.0,83.0
0.361,17,44,20861,23,17142,16.0,1350.0,717.0,21,3719,15.0,1350.0,149.0
11.09,17,28,4420,14,1993,841.0,268.0,114.0,14,2427,840.0,586.0,145.0
0.005,17,2,144,1,64,0.0,36.0,36.0,1,80,0.0,52.0,52.0
0.115,6,10,1506,5,395,27.0,127.0,127.0,5,1111,27.0,843.0,843.0
0.005,6,10,2006,5,927,1.0,659.0,659.0,5,1079,1.0,811.0,811.0
0.005,6,10,2006,5,927,1.0,659.0,659.0,5,1079,1.0,811.0,811.0
0.006,17,2,170,1,65,0.0,37.0,37.0,1,105,0.0,77.0,77.0
0.01,6,10,1990,5,911,2.0,643.0,643.0,5,1079,2.0,811.0,811.0
0.006,6,10,1854,5,889,1.0,621.0,621.0,5,965,1.0,697.0,697.0
0.004,17,2,136,1,60,0.0,32.0,32.0,1,76,0.0,48.0,48.0
0.005,6,10,1689,5,839,1.0,571.0,571.0,5,850,1.0,582.0,582.0
0.016,6,10,1983,5,910,3.0,642.0,642.0,5,1073,3.0,805.0,805.0
0.008,6,10,1990,5,911,2.0,643.0,643.0,5,1079,2.0,811.0,811.0
0.008,6,14,3742,7,452,1.0,80.0,80.0,7,3290,1.0,1448.0,972.0
0.0,17,2,136,1,60,0.0,32.0,32.0,1,76,0.0,48.0,48.0
0.101,6,10,1506,5,395,22.0,127.0,127.0,5,1111,19.0,843.0,843.0
0.138,6,10,1506,5,395,32.0,127.0,127.0,5,1111,32.0,843.0,843.0
0.129,6,10,1506,5,395,30.0,127.0,127.0,5,1111,31.0,843.0,843.0
40.071,17,10,676,5,460,10014.0,104.0,64.0,5,216,10016.0,20.0,15.0
0.013,6,10,1989,5,910,3.0,642.0,642.0,5,1079,3.0,811.0,811.0
0.006,6,10,1547,5,764,1.0,496.0,496.0,5,783,1.0,515.0,515.0
0.012,6,10,1990,5,911,3.0,643.0,643.0,5,1079,2.0,811.0,811.0
0.088,6,10,1506,5,395,18.0,127.0,127.0,5,1111,19.0,843.0,843.0
354.055,6,19,1691,15,978,25289.0,190.0,190.0,4,713,80002.0,497.0,497.0
0.004,17,2,132,1,58,0.0,30.0,30.0,1,74,0.0,46.0,46.0
0.005,17,2,148,1,60,0.0,32.0,32.0,1,88,0.0,60.0,60.0
0.107,6,10,1506,5,395,24.0,127.0,127.0,5,1111,23.0,843.0,843.0
0.072,17,2,136,1,60,0.0,32.0,32.0,1,76,0.0,48.0,48.0
240.082,6,16,4482,9,963,30010.0,238.0,166.0,7,3519,40013.0,1402.0,786.0
0.005,6,10,2006,5,927,1.0,659.0,659.0,5,1079,1.0,811.0,811.0
109.349,6,22,8186,11,1985,95.0,1174.0,504.0,11,6201,10917.0,2720.0,958.0
40.06,17,10,676,5,460,10014.0,104.0,64.0,5,216,10014.0,20.0,15.0
0.01,6,12,1926,6,1189,2.0,659.0,434.0,6,737,1.0,417.0,417.0
0.089,6,10,1506,5,395,20.0,127.0,127.0,5,1111,20.0,843.0,843.0
0.005,17,2,136,1,60,0.0,32.0,32.0,1,76,0.0,48.0,48.0
0.039,17,2,170,1,65,0.0,37.0,37.0,1,105,0.0,77.0,77.0
0.005,6,10,1774,5,923,1.0,655.0,655.0,5,851,1.0,583.0,583.0
1777.653,17,142,44872,72,22752,25036.0,288.0,288.0,70,22120,25762.0,288.0,288.0
0.003,17,2,148,1,60,0.0,32.0,32.0,1,88,0.0,60.0,60.0
0.005,17,2,140,1,62,0.0,34.0,34.0,1,78,0.0,50.0,50.0
0.006,6,10,1547,5,764,1.0,496.0,496.0,5,783,1.0,515.0,515.0
11.0,17,28,4391,14,2312,837.0,587.0,137.0,14,2079,837.0,270.0,120.0
0.101,6,10,1506,5,395,21.0,127.0,127.0,5,1111,24.0,843.0,843.0
0.005,17,2,144,1,64,0.0,36.0,36.0,1,80,0.0,52.0,52.0
29.653,6,36,8190,18,1719,565.0,651.0,322.0,18,6471,1737.0,2720.0,478.0
0.001,17,2,136,1,60,0.0,32.0,32.0,1,76,0.0,48.0,48.0
0.005,6,10,1989,5,927,1.0,659.0,659.0,5,1062,1.0,794.0,794.0
0.004,17,2,234,1,61,0.0,33.0,33.0,1,173,0.0,145.0,145.0
0.076,6,10,1506,5,395,16.0,127.0,127.0,5,1111,16.0,843.0,843.0
10.916,17,28,4420,14,1995,830.0,270.0,114.0,14,2425,830.0,588.0,145.0
0.005,6,10,2006,5,927,1.0,659.0,659.0,5,1079,1.0,811.0,811.0
0.001,17,2,180,1,66,0.0,38.0,38.0,1,114,0.0,86.0,86.0
0.224,6,16,2669,8,1395,32.0,533.0,323.0,8,1274,21.0,529.0,212.0
0.005,17,2,144,1,64,0.0,36.0,36.0,1,80,0.0,52.0,52.0
0.084,6,10,1506,5,395,18.0,127.0,127.0,5,1111,19.0,843.0,843.0
0.005,6,10,2006,5,927,1.0,659.0,659.0,5,1079,1.0,811.0,811.0
0.013,6,10,1972,5,910,3.0,642.0,642.0,5,1062,3.0,794.0,794.0
240.08,6,21,4925,11,941,24008.0,180.0,93.0,10,3984,26675.0,1592.0,576.0
0.003,6,10,1702,5,863,0.0,595.0,595.0,5,839,0.0,571.0,571.0
0.016,17,2,198,1,91,0.0,63.0,63.0,1,107,0.0,79.0,79.0
0.009,6,10,1972,5,910,2.0,642.0,642.0,5,1062,2.0,794.0,794.0
0.003,17,2,136,1,60,0.0,32.0,32.0,1,76,0.0,48.0,48.0
15.078,17,15,9255,8,6912,2150.0,1350.0,836.0,7,2343,2508.0,1350.0,306.0
0.004,17,2,148,1,60,0.0,32.0,32.0,1,88,0.0,60.0,60.0
0.005,6,10,1989,5,927,1.0,659.0,659.0,5,1062,1.0,794.0,794.0
0.001,17,2,136,1,60,0.0,32.0,32.0,1,76,0.0,48.0,48.0
0.004,17,2,148,1,60,0.0,32.0,32.0,1,88,0.0,60.0,60.0
0.111,6,10,1506,5,395,25.0,127.0,127.0,5,1111,26.0,843.0,843.0
0.165,17,2,80,1,32,0.0,4.0,4.0,1,48,0.0,20.0,20.0
0.001,17,2,136,1,60,0.0,32.0,32.0,1,76,0.0,48.0,48.0
0.098,6,10,1506,5,395,22.0,127.0,127.0,5,1111,23.0,843.0,843.0
15.074,17,15,9238,8,6902,2149.0,1350.0,834.0,7,2336,2507.0,1350.0,305.0
0.006,6,10,1689,5,839,1.0,571.0,571.0,5,850,1.0,582.0,582.0
0.104,6,10,1506,5,395,22.0,127.0,127.0,5,1111,22.0,843.0,843.0
0.006,6,10,1990,5,911,1.0,643.0,643.0,5,1079,1.0,811.0,811.0
0.013,6,10,1989,5,910,3.0,642.0,642.0,5,1079,3.0,811.0,811.0
0.001,17,2,136,1,60,0.0,32.0,32.0,1,76,0.0,48.0,48.0
0.004,6,10,1989,5,927,1.0,659.0,659.0,5,1062,1.0,794.0,794.0
0.019,6,10,1989,5,910,4.0,642.0,642.0,5,1079,4.0,811.0,811.0
40.053,17,10,676,5,460,10012.0,104.0,64.0,5,216,10012.0,20.0,15.0
0.126,6,10,1506,5,395,29.0,127.0,127.0,5,1111,25.0,843.0,843.0
11.0,17,28,4392,14,2311,837.0,586.0,137.0,14,2081,837.0,268.0,120.0
0.174,6,3,453,2,321,174.0,241.0,241.0,1,132,0.0,92.0,92.0
0.171,6,3,453,2,321,171.0,241.0,241.0,1,132,0.0,92.0,92.0
0.012,6,10,1983,5,910,3.0,642.0,642.0,5,1073,3.0,805.0,805.0
0.006,17,2,180,1,66,0.0,38.0,38.0,1,114,0.0,86.0,86.0
1671.153,6,257,43442,102,31848,16546.0,2720.0,347.0,155,11594,10850.0,1062.0,77.0
0.018,6,10,1631,5,848,4.0,580.0,580.0,5,783,4.0,515.0,515.0
291.18,6,314,344466,118,17696,2488.0,2689.0,888.0,196,326770,1493.0,2848.0,1739.0
15.079,17,15,9238,8,6902,2149.0,1350.0,834.0,7,2336,2507.0,1350.0,305.0
15.074,17,15,8397,8,6306,2149.0,1350.0,760.0,7,2091,2507.0,1350.0,270.0
0.005,6,10,1854,5,889,1.0,621.0,621.0,5,965,1.0,697.0,697.0
0.127,6,10,1506,5,395,29.0,127.0,127.0,5,1111,28.0,843.0,843.0
0.001,17,2,179,1,62,0.0,34.0,34.0,1,117,0.0,89.0,89.0
0.008,6,10,1989,5,910,1.0,642.0,642.0,5,1079,2.0,811.0,811.0
0.029,6,10,1677,5,827,7.0,559.0,559.0,5,850,7.0,582.0,582.0
40.058,17,10,676,5,460,10013.0,104.0,64.0,5,216,10013.0,20.0,15.0
0.004,6,10,2007,5,928,1.0,660.0,660.0,5,1079,1.0,811.0,811.0
0.127,6,10,1506,5,395,28.0,127.0,127.0,5,1111,30.0,843.0,843.0
0.041,17,4,284,2,120,0.0,32.0,32.0,2,164,0.0,60.0,54.0
0.116,6,10,1506,5,395,22.0,127.0,127.0,5,1111,26.0,843.0,843.0
0.124,17,2,80,1,32,0.0,4.0,4.0,1,48,0.0,20.0,20.0
0.013,6,10,1972,5,910,3.0,642.0,642.0,5,1062,3.0,794.0,794.0
0.009,6,10,2006,5,927,2.0,659.0,659.0,5,1079,2.0,811.0,811.0
0.006,6,10,1643,5,860,1.0,592.0,592.0,5,783,1.0,515.0,515.0
0.073,17,4,596,2,122,0.0,33.0,33.0,2,474,0.0,323.0,209.0
0.012,6,10,1989,5,910,3.0,642.0,642.0,5,1079,2.0,811.0,811.0
0.006,6,10,1854,5,889,1.0,621.0,621.0,5,965,1.0,697.0,697.0
29.994,6,12,1317,7,546,4999.0,174.0,174.0,5,771,7497.0,476.0,251.0
40.048,17,10,676,5,460,10011.0,104.0,64.0,5,216,10011.0,20.0,15.0
0.001,17,2,180,1,66,0.0,38.0,38.0,1,114,0.0,86.0,86.0
0.012,6,10,1990,5,911,3.0,643.0,643.0,5,1079,2.0,811.0,811.0
0.005,6,10,2006,5,927,1.0,659.0,659.0,5,1079,1.0,811.0,811.0
0.005,6,14,3799,7,509,0.0,137.0,137.0,7,3290,0.0,1448.0,972.0
0.016,6,10,1990,5,911,4.0,643.0,643.0,5,1079,3.0,811.0,811.0
0.006,6,10,1547,5,764,1.0,496.0,496.0,5,783,1.0,515.0,515.0
0.004,17,4,284,2,120,0.0,32.0,32.0,2,164,1.0,60.0,54.0
0.013,6,10,1989,5,910,3.0,642.0,642.0,5,1079,3.0,811.0,811.0
0.06,17,2,152,1,76,0.0,48.0,48.0,1,76,0.0,48.0,48.0
11.151,17,28,4423,14,1995,845.0,270.0,114.0,14,2428,845.0,587.0,145.0
0.215,6,10,1506,5,395,52.0,127.0,127.0,5,1111,22.0,843.0,843.0
0.005,6,10,2007,5,928,1.0,660.0,660.0,5,1079,1.0,811.0,811.0
0.091,6,10,1506,5,395,20.0,127.0,127.0,5,1111,17.0,843.0,843.0
0.017,6,10,1989,5,910,4.0,642.0,642.0,5,1079,4.0,811.0,811.0
0.835,6,22,5168,11,1138,73.0,267.0,115.0,11,4030,70.0,1414.0,597.0
0.008,6,10,1989,5,910,2.0,642.0,642.0,5,1079,1.0,811.0,811.0
0.038,17,2,148,1,60,0.0,32.0,32.0,1,88,0.0,60.0,60.0
0.009,6,10,1989,5,910,2.0,642.0,642.0,5,1079,2.0,811.0,811.0
0.016,6,10,1990,5,911,3.0,643.0,643.0,5,1079,3.0,811.0,811.0
0.01,17,2,140,1,62,0.0,34.0,34.0,1,78,0.0,50.0,50.0
0.001,17,2,136,1,60,0.0,32.0,32.0,1,76,0.0,48.0,48.0
0.084,6,10,1506,5,395,16.0,127.0,127.0,5,1111,19.0,843.0,843.0
5.185,6,23,6467,13,1827,431.0,801.0,282.0,10,4640,575.0,1925.0,824.0
0.008,6,10,1547,5,764,2.0,496.0,496.0,5,783,1.0,515.0,515.0
40.065,17,10,676,5,460,10014.0,104.0,64.0,5,216,10015.0,20.0,15.0
9.037,17,6,376,5,280,2259.0,28.0,28.0,1,96,0.0,68.0,68.0
0.016,6,10,1631,5,848,4.0,580.0,580.0,5,783,4.0,515.0,515.0
0.015,6,10,1631,5,848,3.0,580.0,580.0,5,783,3.0,515.0,515.0
0.001,17,2,180,1,66,0.0,38.0,38.0,1,114,0.0,86.0,86.0
0.011,17,2,170,1,65,0.0,37.0,37.0,1,105,0.0,77.0,77.0
0.006,6,10,1989,5,927,1.0,659.0,659.0,5,1062,1.0,794.0,794.0
10.843,17,28,4423,14,1994,825.0,269.0,114.0,14,2429,825.0,588.0,145.0
0.009,6,10,1989,5,910,2.0,642.0,642.0,5,1079,2.0,811.0,811.0
0.009,6,10,1983,5,910,2.0,642.0,642.0,5,1073,2.0,805.0,805.0
0.009,6,10,1972,5,910,2.0,642.0,642.0,5,1062,2.0,794.0,794.0
0.005,6,10,1689,5,839,1.0,571.0,571.0,5,850,1.0,582.0,582.0
0.006,6,10,1547,5,764,1.0,496.0,496.0,5,783,1.0,515.0,515.0
0.005,6,10,2006,5,927,1.0,659.0,659.0,5,1079,1.0,811.0,811.0
0.005,6,10,2000,5,927,1.0,659.0,659.0,5,1073,1.0,805.0,805.0
0.006,6,10,2006,5,927,1.0,659.0,659.0,5,1079,1.0,811.0,811.0
0.074,6,10,1506,5,395,16.0,127.0,127.0,5,1111,13.0,843.0,843.0
0.005,6,10,1774,5,923,1.0,655.0,655.0,5,851,1.0,583.0,583.0
0.014,6,10,1990,5,911,3.0,643.0,643.0,5,1079,3.0,811.0,811.0
0.015,17,2,136,1,60,0.0,32.0,32.0,1,76,0.0,48.0,48.0
356.603,6,21,1795,16,1030,23773.0,190.0,190.0,5,765,60002.0,464.0,248.0
0.005,6,10,2007,5,928,1.0,660.0,660.0,5,1079,1.0,811.0,811.0
361.903,6,21,1793,16,1030,24126.0,190.0,190.0,5,763,60010.0,462.0,247.0
0.111,6,10,1506,5,395,25.0,127.0,127.0,5,1111,23.0,843.0,843.0
0.066,17,8,3613,4,1874,22.0,1350.0,440.0,4,1739,11.0,1350.0,406.0
145.147,6,22,7437,11,1305,130.0,530.0,277.0,11,6132,14498.0,2720.0,946.0
0.013,6,10,1990,5,911,3.0,643.0,643.0,5,1079,3.0,811.0,811.0
0.007,6,10,2007,5,928,1.0,660.0,660.0,5,1079,1.0,811.0,811.0
240.095,6,31,9121,15,6571,17149.0,1694.0,643.0,16,2550,16006.0,580.0,213.0
0.014,6,10,1990,5,911,3.0,643.0,643.0,5,1079,3.0,811.0,811.0
0.152,17,4,352,2,130,111.0,37.0,37.0,2,222,148.0,89.0,83.0
40.065,17,10,676,5,460,10012.0,104.0,64.0,5,216,10015.0,20.0,15.0
0.01,6,10,1972,5,910,2.0,642.0,642.0,5,1062,2.0,794.0,794.0
300.341,6,16,2170,9,684,37522.0,146.0,146.0,7,1486,50029.0,419.0,398.0
0.004,17,4,284,2,120,0.0,32.0,32.0,2,164,1.0,60.0,54.0
0.014,6,10,1972,5,910,3.0,642.0,642.0,5,1062,3.0,794.0,794.0
308.533,17,20,1124,10,716,34267.0,48.0,43.0,10,408,34267.0,20.0,12.0
308.353,17,20,1124,10,716,34254.0,48.0,43.0,10,408,34254.0,20.0,12.0
0.069,6,10,1506,5,395,14.0,127.0,127.0,5,1111,15.0,843.0,843.0
0.005,17,2,222,1,65,0.0,37.0,37.0,1,157,0.0,129.0,129.0
0.006,6,10,1547,5,764,1.0,496.0,496.0,5,783,1.0,515.0,515.0
11.279,17,28,4422,14,1995,855.0,270.0,114.0,14,2427,855.0,586.0,145.0
0.012,6,10,1989,5,910,3.0,642.0,642.0,5,1079,3.0,811.0,811.0
0.005,17,2,144,1,64,0.0,36.0,36.0,1,80,0.0,52.0,52.0
0.004,17,2,136,1,60,0.0,32.0,32.0,1,76,0.0,48.0,48.0
0.01,6,10,1983,5,910,2.0,642.0,642.0,5,1073,2.0,805.0,805.0
0.004,6,10,1702,5,863,0.0,595.0,595.0,5,839,1.0,571.0,571.0
0.095,6,10,1506,5,395,21.0,127.0,127.0,5,1111,20.0,843.0,843.0
0.176,6,10,1506,5,395,37.0,127.0,127.0,5,1111,32.0,843.0,843.0
0.009,6,14,3868,7,578,1.0,206.0,206.0,7,3290,1.0,1448.0,972.0
0.005,6,10,1774,5,923,1.0,655.0,655.0,5,851,1.0,583.0,583.0
0.04,17,4,420,2,122,0.0,33.0,33.0,2,298,37.0,145.0,121.0
308.516,17,20,1124,10,716,34265.0,48.0,43.0,10,408,34265.0,20.0,12.0
2.53,6,23,6110,13,1978,210.0,517.0,258.0,10,4132,268.0,1288.0,720.0
0.004,6,10,1989,5,927,1.0,659.0,659.0,5,1062,1.0,794.0,794.0
177.114,17,98,14649,49,3316,3689.0,44.0,39.0,49,11333,3689.0,279.0,203.0
0.013,6,10,1989,5,910,3.0,642.0,642.0,5,1079,3.0,811.0,811.0
0.005,17,2,144,1,64,0.0,36.0,36.0,1,80,0.0,52.0,52.0
40.056,17,10,676,5,460,10013.0,104.0,64.0,5,216,10013.0,20.0,15.0
0.006,6,12,1698,6,863,1.0,327.0,271.0,6,835,1.0,515.0,515.0
0.001,17,2,180,1,66,0.0,38.0,38.0,1,114,0.0,86.0,86.0
270.087,6,29,9595,16,2689,18004.0,676.0,308.0,13,6906,22506.0,1402.0,890.0
0.005,17,2,170,1,65,0.0,37.0,37.0,1,105,0.0,77.0,77.0
0.065,6,10,1506,5,395,12.0,127.0,127.0,5,1111,15.0,843.0,843.0
40.071,17,10,676,5,460,10014.0,104.0,64.0,5,216,10016.0,20.0,15.0
0.006,6,10,1547,5,764,1.0,496.0,496.0,5,783,1.0,515.0,515.0
0.005,6,10,2006,5,927,1.0,659.0,659.0,5,1079,1.0,811.0,811.0
308.635,17,20,1124,10,716,34279.0,48.0,43.0,10,408,34279.0,20.0,12.0
0.005,6,10,2006,5,927,1.0,659.0,659.0,5,1079,1.0,811.0,811.0
0.006,6,10,1854,5,889,1.0,621.0,621.0,5,965,1.0,697.0,697.0
0.074,6,10,1506,5,395,17.0,127.0,127.0,5,1111,14.0,843.0,843.0
0.006,17,2,230,1,68,0.0,40.0,40.0,1,162,0.0,134.0,134.0
40.062,17,10,676,5,460,10014.0,104.0,64.0,5,216,10014.0,20.0,15.0
0.17,6,3,453,2,321,170.0,241.0,241.0,1,132,0.0,92.0,92.0
0.011,6,10,1989,5,910,2.0,642.0,642.0,5,1079,2.0,811.0,811.0
0.004,6,10,1779,5,928,1.0,660.0,660.0,5,851,1.0,583.0,583.0
240.022,6,9,787,5,488,60005.0,232.0,232.0,4,299,80006.0,83.0,83.0
0.013,6,10,1972,5,910,3.0,642.0,642.0,5,1062,3.0,794.0,794.0
0.001,17,2,180,1,66,0.0,38.0,38.0,1,114,0.0,86.0,86.0
0.005,6,10,2006,5,927,1.0,659.0,659.0,5,1079,1.0,811.0,811.0
0.068,6,10,1506,5,395,14.0,127.0,127.0,5,1111,14.0,843.0,843.0
0.004,6,10,2007,5,928,1.0,660.0,660.0,5,1079,1.0,811.0,811.0
40.057,17,10,676,5,460,10013.0,104.0,64.0,5,216,10013.0,20.0,15.0
0.011,6,10,1990,5,911,2.0,643.0,643.0,5,1079,2.0,811.0,811.0
40.069,17,10,676,5,460,10015.0,104.0,64.0,5,216,10016.0,20.0,15.0
0.015,6,10,1990,5,911,3.0,643.0,643.0,5,1079,3.0,811.0,811.0
0.115,6,10,1506,5,395,24.0,127.0,127.0,5,1111,27.0,843.0,843.0
0.002,17,2,180,1,66,0.0,38.0,38.0,1,114,0.0,86.0,86.0
0.004,6,10,2000,5,927,1.0,659.0,659.0,5,1073,1.0,805.0,805.0
240.094,6,16,4481,9,963,30011.0,238.0,166.0,7,3518,40015.0,1402.0,786.0
0.103,6,10,1506,5,395,23.0,127.0,127.0,5,1111,23.0,843.0,843.0
0.027,6,10,1972,5,910,6.0,642.0,642.0,5,1062,6.0,794.0,794.0
0.078,6,10,1506,5,395,18.0,127.0,127.0,5,1111,18.0,843.0,843.0
0.01,6,10,1989,5,910,2.0,642.0,642.0,5,1079,2.0,811.0,811.0
57.359,6,44,18232,23,12594,413.0,2720.0,1293.0,21,5638,2859.0,2667.0,435.0
0.005,6,10,1989,5,927,1.0,659.0,659.0,5,1062,1.0,794.0,794.0
0.004,6,10,1774,5,923,1.0,655.0,655.0,5,851,1.0,583.0,583.0
0.015,6,10,1983,5,910,3.0,642.0,642.0,5,1073,3.0,805.0,805.0
1778.496,17,142,44872,72,22752,25045.0,288.0,288.0,70,22120,25774.0,288.0,288.0
0.008,6,10,1989,5,910,2.0,642.0,642.0,5,1079,2.0,811.0,811.0
0.175,17,2,152,1,76,0.0,48.0,48.0,1,76,0.0,48.0,48.0
0.005,6,10,1989,5,927,1.0,659.0,659.0,5,1062,1.0,794.0,794.0
10.994,17,28,4421,14,1993,835.0,268.0,114.0,14,2428,834.0,587.0,145.0
15.071,17,15,9239,8,6902,2148.0,1350.0,834.0,7,2337,2506.0,1350.0,305.0
0.008,17,2,136,1,60,0.0,32.0,32.0,1,76,0.0,48.0,48.0
240.015,6,9,787,5,488,60003.0,232.0,232.0,4,299,80003.0,83.0,83.0
240.257,6,26,8186,13,2311,20021.0,1150.0,409.0,13,5875,20021.0,1592.0,648.0
0.09,6,10,1506,5,395,17.0,127.0,127.0,5,1111,19.0,843.0,843.0
0.005,6,10,2006,5,927,1.0,659.0,659.0,5,1079,1.0,811.0,811.0
0.141,6,10,1506,5,395,30.0,127.0,127.0,5,1111,30.0,843.0,843.0
0.005,6,10,2006,5,927,1.0,659.0,659.0,5,1079,1.0,811.0,811.0
0.166,17,2,152,1,76,0.0,48.0,48.0,1,76,0.0,48.0,48.0
0.006,6,10,1643,5,860,1.0,592.0,592.0,5,783,1.0,515.0,515.0
0.006,17,2,164,1,74,0.0,46.0,46.0,1,90,0.0,62.0,62.0
0.001,17,2,180,1,66,0.0,38.0,38.0,1,114,0.0,86.0,86.0
0.005,6,10,1643,5,860,1.0,592.0,592.0,5,783,1.0,515.0,515.0
0.143,6,10,1506,5,395,33.0,127.0,127.0,5,1111,33.0,843.0,843.0
0.006,6,10,1547,5,764,1.0,496.0,496.0,5,783,1.0,515.0,515.0
0.009,6,10,1990,5,911,2.0,643.0,643.0,5,1079,2.0,811.0,811.0
0.006,6,10,1547,5,764,1.0,496.0,496.0,5,783,1.0,515.0,515.0
40.078,17,10,676,5,460,10017.0,104.0,64.0,5,216,10018.0,20.0,15.0
0.011,6,10,1990,5,911,2.0,643.0,643.0,5,1079,2.0,811.0,811.0
0.006,6,10,2000,5,927,1.0,659.0,659.0,5,1073,1.0,805.0,805.0
0.077,6,10,1506,5,395,16.0,127.0,127.0,5,1111,17.0,843.0,843.0
0.01,6,10,1972,5,910,2.0,642.0,642.0,5,1062,2.0,794.0,794.0
0.004,6,10,2007,5,928,1.0,660.0,660.0,5,1079,1.0,811.0,811.0
0.015,6,10,1983,5,910,3.0,642.0,642.0,5,1073,3.0,805.0,805.0
10.72,17,28,4416,14,1993,816.0,268.0,114.0,14,2423,816.0,586.0,145.0
0.004,6,10,2000,5,927,1.0,659.0,659.0,5,1073,1.0,805.0,805.0
0.011,6,10,1677,5,827,2.0,559.0,559.0,5,850,2.0,582.0,582.0
0.106,6,10,1506,5,395,24.0,127.0,127.0,5,1111,23.0,843.0,843.0
0.072,17,2,148,1,60,0.0,32.0,32.0,1,88,0.0,60.0,60.0
361.843,6,21,1792,16,1030,24122.0,190.0,190.0,5,762,60013.0,461.0,247.0
0.005,17,2,136,1,60,0.0,32.0,32.0,1,76,0.0,48.0,48.0
0.005,6,10,2000,5,927,1.0,659.0,659.0,5,1073,1.0,805.0,805.0
0.079,6,10,1506,5,395,17.0,127.0,127.0,5,1111,19.0,843.0,843.0
0.013,6,10,1989,5,910,3.0,642.0,642.0,5,1079,3.0,811.0,811.0
1771.582,17,120,11460,60,5460,30026.0,63.0,63.0,60,6000,30026.0,72.0,72.0
40.054,17,10,676,5,460,10012.0,104.0,64.0,5,216,10012.0,20.0,15.0
0.008,6,10,1989,5,910,2.0,642.0,642.0,5,1079,1.0,811.0,811.0
308.294,17,20,1124,10,716,34240.0,48.0,43.0,10,408,34240.0,20.0,12.0
40.073,17,10,676,5,460,10017.0,104.0,64.0,5,216,10017.0,20.0,15.0
0.005,6,10,1989,5,927,1.0,659.0,659.0,5,1062,1.0,794.0,794.0
0.004,6,10,2007,5,928,1.0,660.0,660.0,5,1079,1.0,811.0,811.0
0.016,6,10,1972,5,910,4.0,642.0,642.0,5,1062,4.0,794.0,794.0
176.038,17,84,12336,42,2817,4293.0,44.0,39.0,42,9519,4293.0,279.0,198.0
0.005,6,10,1689,5,839,1.0,571.0,571.0,5,850,1.0,582.0,582.0
0.103,6,10,1506,5,395,22.0,127.0,127.0,5,1111,23.0,843.0,843.0
40.063,17,10,676,5,460,10014.0,104.0,64.0,5,216,10014.0,20.0,15.0
0.016,6,10,1989,5,910,3.0,642.0,642.0,5,1079,4.0,811.0,811.0
0.006,6,10,1854,5,889,1.0,621.0,621.0,5,965,1.0,697.0,697.0
0.006,6,10,2007,5,928,1.0,660.0,660.0,5,1079,1.0,811.0,811.0
10.741,17,28,4416,14,1993,817.0,268.0,114.0,14,2423,817.0,586.0,145.0
0.004,6,10,1989,5,927,1.0,659.0,659.0,5,1062,1.0,794.0,794.0
0.008,6,10,2000,5,927,1.0,659.0,659.0,5,1073,1.0,805.0,805.0
0.005,17,2,136,1,60,0.0,32.0,32.0,1,76,0.0,48.0,48.0
0.127,6,10,1506,5,395,30.0,127.0,127.0,5,1111,30.0,843.0,843.0
40.057,17,10,676,5,460,10013.0,104.0,64.0,5,216,10013.0,20.0,15.0
0.015,6,13,3735,7,497,2.0,125.0,125.0,6,3238,2.0,1470.0,1459.0
300.284,6,16,2170,9,684,37514.0,146.0,146.0,7,1486,50019.0,419.0,398.0
0.012,6,10,1983,5,910,3.0,642.0,642.0,5,1073,2.0,805.0,805.0
0.004,6,10,1774,5,923,1.0,655.0,655.0,5,851,1.0,583.0,583.0
0.009,17,2,185,1,73,0.0,45.0,45.0,1,112,0.0,84.0,84.0
0.005,17,2,166,1,75,0.0,47.0,47.0,1,91,0.0,63.0,63.0
0.006,6,10,1547,5,764,1.0,496.0,496.0,5,783,1.0,515.0,515.0
0.017,6,10,1983,5,910,4.0,642.0,642.0,5,1073,4.0,805.0,805.0
0.007,6,10,1762,5,911,1.0,643.0,643.0,5,851,1.0,583.0,583.0
40.051,17,10,676,5,460,10012.0,104.0,64.0,5,216,10011.0,20.0,15.0
0.005,6,10,1547,5,764,1.0,496.0,496.0,5,783,1.0,515.0,515.0
300.328,6,16,2170,9,684,37520.0,146.0,146.0,7,1486,50027.0,419.0,398.0
0.004,6,10,2007,5,928,1.0,660.0,660.0,5,1079,1.0,811.0,811.0
0.005,6,10,2006,5,927,1.0,659.0,659.0,5,1079,1.0,811.0,811.0
0.005,6,10,2007,5,928,1.0,660.0,660.0,5,1079,1.0,811.0,811.0
356.578,6,21,1795,16,1030,23771.0,190.0,190.0,5,765,60003.0,464.0,248.0
1778.172,17,143,41496,72,22752,25044.0,288.0,288.0,71,18744,25402.0,236.0,236.0
0.007,6,10,2006,5,927,1.0,659.0,659.0,5,1079,1.0,811.0,811.0
0.151,6,10,1506,5,395,35.0,127.0,127.0,5,1111,33.0,843.0,843.0
0.024,17,2,136,1,60,0.0,32.0,32.0,1,76,0.0,48.0,48.0
0.006,6,10,2006,5,927,1.0,659.0,659.0,5,1079,1.0,811.0,811.0
0.005,6,13,3690,7,452,0.0,80.0,80.0,6,3238,0.0,1470.0,1459.0
0.006,6,10,2000,5,927,1.0,659.0,659.0,5,1073,1.0,805.0,805.0
0.013,6,10,1989,5,910,3.0,642.0,642.0,5,1079,3.0,811.0,811.0
0.001,17,2,180,1,66,0.0,38.0,38.0,1,114,0.0,86.0,86.0
0.073,6,10,1506,5,395,16.0,127.0,127.0,5,1111,14.0,843.0,843.0
0.005,17,2,214,1,75,0.0,47.0,47.0,1,139,0.0,111.0,111.0
0.001,17,2,180,1,66,0.0,38.0,38.0,1,114,0.0,86.0,86.0
40.048,17,10,676,5,460,10011.0,104.0,64.0,5,216,10008.0,20.0,15.0
0.129,6,10,1506,5,395,31.0,127.0,127.0,5,1111,30.0,843.0,843.0
40.053,17,10,676,5,460,10012.0,104.0,64.0,5,216,10012.0,20.0,15.0
0.125,6,10,1506,5,395,29.0,127.0,127.0,5,1111,22.0,843.0,843.0
176.094,17,70,10101,35,2339,5179.0,44.0,38.0,35,7762,5179.0,239.0,193.0
0.041,17,4,284,2,120,1.0,32.0,32.0,2,164,38.0,60.0,54.0
0.003,17,4,284,2,120,0.0,32.0,32.0,2,164,0.0,60.0,54.0
0.012,6,10,1983,5,910,3.0,642.0,642.0,5,1073,2.0,805.0,805.0
0.001,17,2,179,1,62,0.0,34.0,34.0,1,117,0.0,89.0,89.0
0.013,6,10,1972,5,910,3.0,642.0,642.0,5,1062,3.0,794.0,794.0
0.116,6,10,1506,5,395,27.0,127.0,127.0,5,1111,22.0,843.0,843.0
0.005,6,10,1989,5,927,1.0,659.0,659.0,5,1062,1.0,794.0,794.0
0.001,17,2,180,1,66,0.0,38.0,38.0,1,114,0.0,86.0,86.0
0.089,6,10,1506,5,395,21.0,127.0,127.0,5,1111,16.0,843.0,843.0
0.008,6,13,3735,7,497,1.0,125.0,125.0,6,3238,1.0,1470.0,1459.0
0.019,6,10,1990,5,911,4.0,643.0,643.0,5,1079,4.0,811.0,811.0
0.011,6,10,1989,5,910,2.0,642.0,642.0,5,1079,2.0,811.0,811.0
0.015,6,10,1990,5,911,3.0,643.0,643.0,5,1079,3.0,811.0,811.0
0.01,6,10,1677,5,827,2.0,559.0,559.0,5,850,2.0,582.0,582.0
0.005,6,10,1774,5,923,1.0,655.0,655.0,5,851,1.0,583.0,583.0
0.018,6,10,1677,5,827,4.0,559.0,559.0,5,850,4.0,582.0,582.0
0.08,6,10,1506,5,395,16.0,127.0,127.0,5,1111,18.0,843.0,843.0
0.005,6,10,2000,5,927,1.0,659.0,659.0,5,1073,1.0,805.0,805.0
0.041,17,2,170,1,65,0.0,37.0,37.0,1,105,0.0,77.0,77.0
0.057,6,10,1506,5,395,13.0,127.0,127.0,5,1111,13.0,843.0,843.0
11.009,17,28,4422,14,1994,838.0,269.0,114.0,14,2428,838.0,587.0,145.0
0.005,6,14,3736,7,446,0.0,74.0,74.0,7,3290,0.0,1448.0,972.0
240.156,6,34,13108,17,7102,15009.0,2123.0,691.0,17,6006,15009.0,2379.0,568.0
0.005,6,10,1989,5,927,1.0,659.0,659.0,5,1062,1.0,794.0,794.0
0.154,6,10,1506,5,395,32.0,127.0,127.0,5,1111,38.0,843.0,843.0
0.011,6,10,1989,5,910,2.0,642.0,642.0,5,1079,2.0,811.0,811.0
40.066,17,10,676,5,460,10014.0,104.0,64.0,5,216,10014.0,20.0,15.0
0.005,17,2,136,1,60,0.0,32.0,32.0,1,76,0.0,48.0,48.0
165.526,6,26,9525,12,1627,83.0,794.0,367.0,14,7898,12723.0,1360.0,732.0
10.815,17,26,4103,13,1846,892.0,269.0,114.0,13,2257,892.0,588.0,145.0
0.005,6,10,2007,5,928,1.0,660.0,660.0,5,1079,1.0,811.0,811.0
0.016,17,2,198,1,91,0.0,63.0,63.0,1,107,0.0,79.0,79.0
0.074,6,10,1506,5,395,18.0,127.0,127.0,5,1111,13.0,843.0,843.0
0.001,17,2,180,1,66,0.0,38.0,38.0,1,114,0.0,86.0,86.0
305.421,17,16,928,8,608,43613.0,48.0,48.0,8,320,43613.0,12.0,12.0
0.095,6,10,1506,5,395,20.0,127.0,127.0,5,1111,21.0,843.0,843.0
291.252,6,416,348849,194,21654,1509.0,2736.0,889.0,222,327195,1317.0,2804.0,1517.0
11.458,17,28,4366,14,2312,868.0,587.0,137.0,14,2054,868.0,269.0,118.0
61.18,58,3,216,2,144,61180.0,24.0,24.0,1,72,0.0,24.0,24.0
0.006,6,10,1547,5,764,1.0,496.0,496.0,5,783,1.0,515.0,515.0
0.008,6,10,1989,5,910,2.0,642.0,642.0,5,1079,2.0,811.0,811.0
0.005,6,10,2006,5,927,1.0,659.0,659.0,5,1079,1.0,811.0,811.0
0.005,6,10,2007,5,928,1.0,660.0,660.0,5,1079,1.0,811.0,811.0
0.114,6,10,1506,5,395,26.0,127.0,127.0,5,1111,26.0,843.0,843.0
0.096,6,10,1506,5,395,20.0,127.0,127.0,5,1111,23.0,843.0,843.0
40.062,17,10,676,5,460,10012.0,104.0,64.0,5,216,10009.0,20.0,15.0
0.005,6,10,2006,5,927,1.0,659.0,659.0,5,1079,1.0,811.0,811.0
0.07,6,10,1506,5,395,15.0,127.0,127.0,5,1111,16.0,843.0,843.0
0.126,17,4,284,2,120,0.0,32.0,32.0,2,164,122.0,60.0,54.0
0.014,6,10,2006,5,927,3.0,659.0,659.0,5,1079,3.0,811.0,811.0
0.097,6,10,1506,5,395,23.0,127.0,127.0,5,1111,23.0,843.0,843.0
0.018,6,10,1989,5,910,4.0,642.0,642.0,5,1079,4.0,811.0,811.0
0.008,6,10,1989,5,910,2.0,642.0,642.0,5,1079,1.0,811.0,811.0
0.001,17,2,180,1,66,0.0,38.0,38.0,1,114,0.0,86.0,86.0
66.396,6,25,10408,11,3909,6639.0,1579.0,835.0,14,6499,5097.0,2111.0,576.0
0.006,17,2,169,1,62,0.0,34.0,34.0,1,107,0.0,79.0,79.0
300.016,6,11,891,6,552,60002.0,232.0,232.0,5,339,75003.0,83.0,83.0
0.106,6,10,1506,5,395,23.0,127.0,127.0,5,1111,25.0,843.0,843.0
0.012,6,10,1989,5,910,3.0,642.0,642.0,5,1079,3.0,811.0,811.0
0.005,17,2,144,1,64,0.0,36.0,36.0,1,80,0.0,52.0,52.0
0.004,17,2,148,1,60,0.0,32.0,32.0,1,88,0.0,60.0,60.0
0.004,6,10,2000,5,927,1.0,659.0,659.0,5,1073,1.0,805.0,805.0
126.064,6,14,2938,8,2504,17975.0,1414.0,1086.0,6,434,25165.0,182.0,182.0
0.015,17,2,198,1,91,0.0,63.0,63.0,1,107,0.0,79.0,79.0
0.081,6,10,1506,5,395,17.0,127.0,127.0,5,1111,19.0,843.0,843.0
0.106,6,10,1506,5,395,25.0,127.0,127.0,5,1111,24.0,843.0,843.0
0.013,6,10,1972,5,910,3.0,642.0,642.0,5,1062,3.0,794.0,794.0
0.004,17,2,148,1,60,0.0,32.0,32.0,1,88,0.0,60.0,60.0
175.138,17,84,11711,43,2876,4169.0,44.0,38.0,41,8835,4378.0,239.0,187.0
242.207,6,384,348316,196,22305,1242.0,2736.0,931.0,188,326011,1295.0,3723.0,1796.0
0.005,6,14,3799,7,509,0.0,137.0,137.0,7,3290,0.0,1448.0,972.0
0.006,17,2,194,1,57,0.0,29.0,29.0,1,137,0.0,109.0,109.0
1.176,6,31,12745,18,3352,69.0,1360.0,517.0,13,9393,83.0,2720.0,984.0
0.016,17,2,144,1,64,0.0,36.0,36.0,1,80,0.0,52.0,52.0
0.005,6,10,2007,5,928,1.0,660.0,660.0,5,1079,1.0,811.0,811.0
1750.534,6,470,67679,259,35678,6785.0,613.0,194.0,211,32001,8335.0,453.0,145.0
0.011,6,10,1989,5,910,2.0,642.0,642.0,5,1079,2.0,811.0,811.0
0.005,6,10,1989,5,927,1.0,659.0,659.0,5,1062,1.0,794.0,794.0
0.014,6,10,1990,5,911,3.0,643.0,643.0,5,1079,3.0,811.0,811.0
0.005,6,10,1989,5,927,1.0,659.0,659.0,5,1062,1.0,794.0,794.0
0.004,6,10,1774,5,923,1.0,655.0,655.0,5,851,1.0,583.0,583.0
308.536,17,20,1124,10,716,34267.0,48.0,43.0,10,408,34267.0,20.0,12.0
0.005,6,10,2007,5,928,1.0,660.0,660.0,5,1079,1.0,811.0,811.0
0.012,6,10,1990,5,911,3.0,643.0,643.0,5,1079,3.0,811.0,811.0
0.005,6,10,1547,5,764,1.0,496.0,496.0,5,783,1.0,515.0,515.0
0.012,6,10,1972,5,910,3.0,642.0,642.0,5,1062,3.0,794.0,794.0
0.093,6,10,1506,5,395,20.0,127.0,127.0,5,1111,20.0,843.0,843.0
15.208,17,21,12514,11,8995,1517.0,1350.0,789.0,10,3519,1683.0,1350.0,323.0
0.01,6,10,1989,5,910,2.0,642.0,642.0,5,1079,2.0,811.0,811.0
0.002,17,2,294,1,64,0.0,36.0,36.0,1,230,0.0,202.0,202.0
10.822,17,28,4423,14,1994,824.0,269.0,114.0,14,2429,824.0,588.0,145.0
0.01,6,10,1990,5,911,2.0,643.0,643.0,5,1079,2.0,811.0,811.0
0.008,6,10,1989,5,910,2.0,642.0,642.0,5,1079,1.0,811.0,811.0
0.014,6,10,1989,5,910,3.0,642.0,642.0,5,1079,3.0,811.0,811.0
178.07,17,90,12875,45,3032,4046.0,44.0,39.0,45,9843,4046.0,239.0,190.0
0.123,6,10,1506,5,395,28.0,127.0,127.0,5,1111,28.0,843.0,843.0
0.001,17,2,180,1,66,0.0,38.0,38.0,1,114,0.0,86.0,86.0
1730.459,6,54,3291,33,1950,54076.0,35.0,35.0,21,1341,86519.0,31.0,31.0
0.005,6,10,1643,5,860,1.0,592.0,592.0,5,783,1.0,515.0,515.0
15.072,17,15,9238,8,6902,2149.0,1350.0,834.0,7,2336,2507.0,1350.0,305.0
308.313,17,19,1084,10,716,34244.0,48.0,43.0,9,368,38526.0,20.0,12.0
0.068,6,10,1506,5,395,15.0,127.0,127.0,5,1111,15.0,843.0,843.0
0.005,17,2,144,1,64,0.0,36.0,36.0,1,80,0.0,52.0,52.0
0.076,6,10,1506,5,395,18.0,127.0,127.0,5,1111,16.0,843.0,843.0
0.005,6,10,2006,5,927,1.0,659.0,659.0,5,1079,1.0,811.0,811.0
40.081,17,10,676,5,460,10014.0,104.0,64.0,5,216,10018.0,20.0,15.0
0.016,6,10,1990,5,911,4.0,643.0,643.0,5,1079,4.0,811.0,811.0
0.006,6,10,1547,5,764,1.0,496.0,496.0,5,783,1.0,515.0,515.0
0.084,6,10,1506,5,395,15.0,127.0,127.0,5,1111,19.0,843.0,843.0
40.109,17,10,676,5,460,10026.0,104.0,64.0,5,216,10026.0,20.0,15.0
40.06,17,10,676,5,460,10011.0,104.0,64.0,5,216,10014.0,20.0,15.0
0.006,6,10,1547,5,764,1.0,496.0,496.0,5,783,1.0,515.0,515.0
40.069,17,10,676,5,460,10015.0,104.0,64.0,5,216,10015.0,20.0,15.0
240.009,6,9,787,5,488,60002.0,232.0,232.0,4,299,80002.0,83.0,83.0
0.014,6,10,1631,5,848,3.0,580.0,580.0,5,783,3.0,515.0,515.0
0.006,17,2,214,1,75,0.0,47.0,47.0,1,139,0.0,111.0,111.0
0.001,17,2,180,1,66,0.0,38.0,38.0,1,114,0.0,86.0,86.0
0.007,17,2,179,1,71,0.0,43.0,43.0,1,108,0.0,80.0,80.0
15.417,17,51,30452,30,27156,530.0,1350.0,877.0,21,3296,769.0,1350.0,128.0
0.005,6,10,1989,5,927,1.0,659.0,659.0,5,1062,1.0,794.0,794.0
240.163,6,41,5444,18,2316,14127.0,581.0,196.0,23,3128,10916.0,566.0,236.0
241.277,6,380,347452,195,21662,1243.0,2736.0,959.0,185,325790,1311.0,2804.0,1806.0
0.005,6,10,1854,5,889,1.0,621.0,621.0,5,965,1.0,697.0,697.0
9.037,17,6,376,5,280,2259.0,28.0,28.0,1,96,0.0,68.0,68.0
0.234,6,10,1506,5,395,49.0,127.0,127.0,5,1111,51.0,843.0,843.0
0.013,17,2,136,1,60,0.0,32.0,32.0,1,76,0.0,48.0,48.0
0.006,17,2,194,1,59,0.0,31.0,31.0,1,135,0.0,107.0,107.0
0.009,6,13,3735,7,497,1.0,125.0,125.0,6,3238,1.0,1470.0,1459.0
40.061,17,10,676,5,460,10012.0,104.0,64.0,5,216,10014.0,20.0,15.0
0.083,6,10,1506,5,395,19.0,127.0,127.0,5,1111,17.0,843.0,843.0
0.007,6,10,1689,5,839,1.0,571.0,571.0,5,850,1.0,582.0,582.0
0.003,17,2,132,1,58,0.0,30.0,30.0,1,74,0.0,46.0,46.0
0.01,6,13,3735,7,497,1.0,125.0,125.0,6,3238,1.0,1470.0,1459.0
0.013,6,10,1989,5,910,3.0,642.0,642.0,5,1079,3.0,811.0,811.0
0.005,6,10,1989,5,927,1.0,659.0,659.0,5,1062,1.0,794.0,794.0
0.004,6,13,3747,7,509,0.0,137.0,137.0,6,3238,0.0,1470.0,1459.0
0.004,6,10,1774,5,923,1.0,655.0,655.0,5,851,1.0,583.0,583.0
0.005,6,10,2006,5,927,1.0,659.0,659.0,5,1079,1.0,811.0,811.0
1729.279,6,60,4400,40,2740,44340.0,33.0,33.0,20,1660,91006.0,31.0,31.0
0.005,6,10,2000,5,927,1.0,659.0,659.0,5,1073,1.0,805.0,805.0
0.068,6,10,1506,5,395,15.0,127.0,127.0,5,1111,15.0,843.0,843.0
0.005,6,10,2007,5,928,1.0,660.0,660.0,5,1079,1.0,811.0,811.0
0.012,6,10,1762,5,911,3.0,643.0,643.0,5,851,3.0,583.0,583.0
0.085,6,10,1506,5,395,19.0,127.0,127.0,5,1111,17.0,843.0,843.0
0.005,6,10,1689,5,839,1.0,571.0,571.0,5,850,1.0,582.0,582.0
0.004,6,10,2006,5,927,1.0,659.0,659.0,5,1079,1.0,811.0,811.0
0.077,6,10,1506,5,395,17.0,127.0,127.0,5,1111,17.0,843.0,843.0
0.005,6,13,3747,7,509,0.0,137.0,137.0,6,3238,1.0,1470.0,1459.0
0.088,6,10,1506,5,395,19.0,127.0,127.0,5,1111,19.0,843.0,843.0
0.005,6,10,1547,5,764,1.0,496.0,496.0,5,783,1.0,515.0,515.0
0.004,17,2,136,1,60,0.0,32.0,32.0,1,76,0.0,48.0,48.0
0.002,17,2,166,1,75,0.0,47.0,47.0,1,91,0.0,63.0,63.0
0.006,6,10,2000,5,927,1.0,659.0,659.0,5,1073,1.0,805.0,805.0
40.069,17,10,676,5,460,10015.0,104.0,64.0,5,216,10016.0,20.0,15.0
0.006,6,10,1854,5,889,1.0,621.0,621.0,5,965,1.0,697.0,697.0
0.008,6,10,1972,5,910,2.0,642.0,642.0,5,1062,1.0,794.0,794.0
0.075,6,10,1506,5,395,16.0,127.0,127.0,5,1111,15.0,843.0,843.0
0.008,17,2,194,1,59,0.0,31.0,31.0,1,135,0.0,107.0,107.0
0.006,6,10,1689,5,839,1.0,571.0,571.0,5,850,1.0,582.0,582.0
240.423,6,35,8927,18,2074,14142.0,695.0,226.0,17,6853,15026.0,1402.0,597.0
0.14,6,10,1506,5,395,34.0,127.0,127.0,5,1111,32.0,843.0,843.0
40.062,17,10,676,5,460,10014.0,104.0,64.0,5,216,10014.0,20.0,15.0
1.09,6,33,13431,19,5932,60.0,1360.0,732.0,14,7499,70.0,2720.0,769.0
0.005,17,2,214,1,75,0.0,47.0,47.0,1,139,0.0,111.0,111.0
0.005,6,10,1989,5,927,1.0,659.0,659.0,5,1062,1.0,794.0,794.0
0.116,6,10,1506,5,395,26.0,127.0,127.0,5,1111,25.0,843.0,843.0
0.005,6,10,1854,5,889,1.0,621.0,621.0,5,965,1.0,697.0,697.0
0.005,6,13,3747,7,509,0.0,137.0,137.0,6,3238,1.0,1470.0,1459.0
354.077,6,21,1795,16,1030,23605.0,190.0,190.0,5,765,60002.0,464.0,248.0
0.138,6,10,1506,5,395,33.0,127.0,127.0,5,1111,28.0,843.0,843.0
0.13,6,10,1506,5,395,29.0,127.0,127.0,5,1111,31.0,843.0,843.0
0.015,6,10,1989,5,910,3.0,642.0,642.0,5,1079,3.0,811.0,811.0
1756.769,6,105,6270,60,3525,29775.0,27.0,27.0,45,2745,39925.0,27.0,27.0
351.983,6,20,2210,6,1308,12003.0,494.0,494.0,14,902,27075.0,83.0,83.0
0.064,6,10,1506,5,395,15.0,127.0,127.0,5,1111,12.0,843.0,843.0
40.079,17,10,676,5,460,10016.0,104.0,64.0,5,216,10018.0,20.0,15.0
0.009,6,10,1989,5,910,2.0,642.0,642.0,5,1079,2.0,811.0,811.0
0.13,6,10,1506,5,395,26.0,127.0,127.0,5,1111,26.0,843.0,843.0
0.053,17,2,152,1,76,0.0,48.0,48.0,1,76,0.0,48.0,48.0
0.009,6,10,1762,5,911,2.0,643.0,643.0,5,851,2.0,583.0,583.0
40.065,17,10,676,5,460,10013.0,104.0,64.0,5,216,10015.0,20.0,15.0
240.013,6,9,787,5,488,60003.0,232.0,232.0,4,299,80003.0,83.0,83.0
0.124,17,2,412,1,61,0.0,33.0,33.0,1,351,0.0,323.0,323.0
0.104,6,10,1506,5,395,21.0,127.0,127.0,5,1111,21.0,843.0,843.0
0.007,17,2,299,1,65,0.0,37.0,37.0,1,234,0.0,206.0,206.0
308.35,17,20,1124,10,716,34254.0,48.0,43.0,10,408,34254.0,20.0,12.0
0.008,6,12,1926,6,1189,1.0,659.0,434.0,6,737,1.0,417.0,417.0
0.005,6,10,2000,5,927,1.0,659.0,659.0,5,1073,1.0,805.0,805.0
0.005,6,10,2007,5,928,1.0,660.0,660.0,5,1079,1.0,811.0,811.0
0.004,17,2,148,1,60,0.0,32.0,32.0,1,88,0.0,60.0,60.0
0.037,17,2,182,1,65,0.0,37.0,37.0,1,117,0.0,89.0,89.0
0.001,17,2,180,1,66,0.0,38.0,38.0,1,114,0.0,86.0,86.0
0.005,17,2,170,1,65,0.0,37.0,37.0,1,105,0.0,77.0,77.0
0.006,6,10,1547,5,764,1.0,496.0,496.0,5,783,1.0,515.0,515.0
0.008,17,2,194,1,59,0.0,31.0,31.0,1,135,0.0,107.0,107.0
0.005,6,10,2007,5,928,1.0,660.0,660.0,5,1079,1.0,811.0,811.0
0.09,6,10,1506,5,395,18.0,127.0,127.0,5,1111,21.0,843.0,843.0
0.004,17,2,148,1,60,0.0,32.0,32.0,1,88,0.0,60.0,60.0
0.004,17,4,284,2,120,0.0,32.0,32.0,2,164,0.0,60.0,54.0
40.054,17,10,676,5,460,10012.0,104.0,64.0,5,216,10012.0,20.0,15.0
0.013,6,10,1631,5,848,3.0,580.0,580.0,5,783,3.0,515.0,515.0
0.005,6,14,3799,7,509,0.0,137.0,137.0,7,3290,0.0,1448.0,972.0
0.001,17,2,142,1,63,0.0,35.0,35.0,1,79,0.0,51.0,51.0
0.096,6,10,1506,5,395,21.0,127.0,127.0,5,1111,22.0,843.0,843.0
0.013,17,2,152,1,56,0.0,28.0,28.0,1,96,0.0,68.0,68.0
0.009,6,10,1989,5,910,2.0,642.0,642.0,5,1079,2.0,811.0,811.0
0.004,6,10,2007,5,928,1.0,660.0,660.0,5,1079,1.0,811.0,811.0
0.101,6,10,1506,5,395,21.0,127.0,127.0,5,1111,20.0,843.0,843.0
0.005,6,10,2006,5,927,1.0,659.0,659.0,5,1079,1.0,811.0,811.0
40.057,17,10,676,5,460,10013.0,104.0,64.0,5,216,10013.0,20.0,15.0
0.013,6,10,1983,5,910,3.0,642.0,642.0,5,1073,3.0,805.0,805.0
0.005,17,2,169,1,62,0.0,34.0,34.0,1,107,0.0,79.0,79.0
172.371,17,70,10030,35,2330,5069.0,44.0,38.0,35,7700,5069.0,260.0,192.0
0.005,6,10,2000,5,927,1.0,659.0,659.0,5,1073,1.0,805.0,805.0
0.102,6,10,1506,5,395,22.0,127.0,127.0,5,1111,22.0,843.0,843.0
0.041,17,4,284,2,120,0.0,32.0,32.0,2,164,38.0,60.0,54.0
0.017,6,10,1972,5,910,4.0,642.0,642.0,5,1062,4.0,794.0,794.0
0.006,17,2,170,1,65,0.0,37.0,37.0,1,105,0.0,77.0,77.0
86.966,6,25,9452,12,1627,78.0,794.0,367.0,13,7825,7236.0,1360.0,810.0
0.005,6,10,2007,5,928,1.0,660.0,660.0,5,1079,1.0,811.0,811.0
0.005,6,10,1989,5,927,1.0,659.0,659.0,5,1062,1.0,794.0,794.0
0.021,6,13,3735,7,497,3.0,125.0,125.0,6,3238,4.0,1470.0,1459.0
0.005,6,10,2006,5,927,1.0,659.0,659.0,5,1079,1.0,811.0,811.0
0.006,6,10,1547,5,764,1.0,496.0,496.0,5,783,1.0,515.0,515.0
1.154,6,30,13240,17,5841,72.0,2074.0,854.0,13,7399,81.0,2720.0,858.0
371.533,6,22,2313,16,867,24768.0,195.0,195.0,6,1446,4636.0,419.0,398.0
0.009,6,10,1677,5,827,2.0,559.0,559.0,5,850,2.0,582.0,582.0
0.005,17,2,230,1,68,0.0,40.0,40.0,1,162,0.0,134.0,134.0
0.096,6,10,1506,5,395,21.0,127.0,127.0,5,1111,22.0,843.0,843.0
40.064,17,10,676,5,460,10014.0,104.0,64.0,5,216,10015.0,20.0,15.0
40.057,17,10,676,5,460,10013.0,104.0,64.0,5,216,10013.0,20.0,15.0
0.008,17,2,186,1,60,0.0,32.0,32.0,1,126,0.0,98.0,98.0
0.115,6,10,1506,5,395,26.0,127.0,127.0,5,1111,26.0,843.0,843.0
0.008,17,2,136,1,60,0.0,32.0,32.0,1,76,0.0,48.0,48.0
0.008,6,10,1972,5,910,1.0,642.0,642.0,5,1062,1.0,794.0,794.0
0.129,6,10,1506,5,395,30.0,127.0,127.0,5,1111,26.0,843.0,843.0
0.015,6,10,1762,5,911,3.0,643.0,643.0,5,851,3.0,583.0,583.0
0.02,6,10,1990,5,911,5.0,643.0,643.0,5,1079,4.0,811.0,811.0
0.005,6,10,2006,5,927,1.0,659.0,659.0,5,1079,1.0,811.0,811.0
0.005,6,10,2006,5,927,1.0,659.0,659.0,5,1079,1.0,811.0,811.0
0.008,6,10,1989,5,910,2.0,642.0,642.0,5,1079,2.0,811.0,811.0
0.01,6,10,1990,5,911,2.0,643.0,643.0,5,1079,2.0,811.0,811.0
0.062,17,2,80,1,32,0.0,4.0,4.0,1,48,0.0,20.0,20.0
0.005,6,10,2007,5,928,1.0,660.0,660.0,5,1079,1.0,811.0,811.0
0.005,6,10,2007,5,928,1.0,660.0,660.0,5,1079,1.0,811.0,811.0
0.005,17,2,164,1,74,0.0,46.0,46.0,1,90,0.0,62.0,62.0
1799.788,17,122,11651,61,5551,29996.0,63.0,63.0,61,6100,29996.0,72.0,72.0
0.005,6,13,3690,7,452,0.0,80.0,80.0,6,3238,0.0,1470.0,1459.0
0.005,6,10,1989,5,927,1.0,659.0,659.0,5,1062,1.0,794.0,794.0
0.005,6,10,1854,5,889,1.0,621.0,621.0,5,965,1.0,697.0,697.0
0.004,6,10,2006,5,927,1.0,659.0,659.0,5,1079,1.0,811.0,811.0
0.006,6,13,3747,7,509,1.0,137.0,137.0,6,3238,1.0,1470.0,1459.0
0.037,6,10,1677,5,827,9.0,559.0,559.0,5,850,9.0,582.0,582.0
0.266,6,10,1506,5,395,60.0,127.0,127.0,5,1111,47.0,843.0,843.0
0.004,6,10,2006,5,927,1.0,659.0,659.0,5,1079,1.0,811.0,811.0
308.68,17,20,1124,10,716,34283.0,48.0,43.0,10,408,34283.0,20.0,12.0
0.037,17,2,136,1,60,0.0,32.0,32.0,1,76,0.0,48.0,48.0
368.662,6,22,2313,16,867,24577.0,195.0,195.0,6,1446,4638.0,419.0,398.0
1770.465,6,83,4368,42,2210,43181.0,26.0,26.0,41,2158,44260.0,26.0,26.0
0.016,6,10,1983,5,910,4.0,642.0,642.0,5,1073,4.0,805.0,805.0
0.063,6,10,1506,5,395,15.0,127.0,127.0,5,1111,12.0,843.0,843.0
0.123,17,2,182,1,65,0.0,37.0,37.0,1,117,0.0,89.0,89.0
0.107,6,10,1506,5,395,23.0,127.0,127.0,5,1111,24.0,843.0,843.0
0.1,17,2,144,1,64,0.0,36.0,36.0,1,80,0.0,52.0,52.0
0.005,6,10,1643,5,860,1.0,592.0,592.0,5,783,1.0,515.0,515.0
0.013,17,2,152,1,56,0.0,28.0,28.0,1,96,0.0,68.0,68.0
0.008,17,2,148,1,60,0.0,32.0,32.0,1,88,0.0,60.0,60.0
300.372,6,16,2170,9,684,37526.0,146.0,146.0,7,1486,50034.0,419.0,398.0
0.039,17,2,184,1,61,0.0,33.0,33.0,1,123,0.0,95.0,95.0
0.169,17,2,152,1,76,0.0,48.0,48.0,1,76,0.0,48.0,48.0
0.073,6,10,1506,5,395,17.0,127.0,127.0,5,1111,15.0,843.0,843.0
175.514,17,76,10860,38,2529,4743.0,44.0,38.0,38,8331,4743.0,261.0,191.0
240.609,6,27,4630,13,1880,20047.0,559.0,239.0,14,2750,18505.0,1215.0,253.0
40.051,17,10,676,5,460,10011.0,104.0,64.0,5,216,10011.0,20.0,15.0
0.01,6,10,1677,5,827,2.0,559.0,559.0,5,850,2.0,582.0,582.0
0.006,6,10,1547,5,764,1.0,496.0,496.0,5,783,1.0,515.0,515.0
0.006,6,10,1689,5,839,1.0,571.0,571.0,5,850,1.0,582.0,582.0
0.005,6,10,2006,5,927,1.0,659.0,659.0,5,1079,1.0,811.0,811.0
0.011,6,10,1983,5,910,2.0,642.0,642.0,5,1073,2.0,805.0,805.0
40.058,17,10,676,5,460,10013.0,104.0,64.0,5,216,10013.0,20.0,15.0
0.001,17,2,180,1,66,0.0,38.0,38.0,1,114,0.0,86.0,86.0
15.077,17,15,8186,8,6126,2149.0,1350.0,737.0,7,2060,2508.0,1350.0,266.0
0.005,6,10,1779,5,928,1.0,660.0,660.0,5,851,1.0,583.0,583.0
10.998,17,29,4565,15,2165,778.0,268.0,116.0,14,2400,837.0,587.0,143.0
0.014,6,10,1990,5,911,3.0,643.0,643.0,5,1079,3.0,811.0,811.0
50.34,6,44,18668,23,13030,411.0,2720.0,1342.0,21,5638,2508.0,2667.0,435.0
0.006,6,10,2000,5,927,1.0,659.0,659.0,5,1073,1.0,805.0,805.0
0.005,6,10,1730,5,513,1.0,245.0,245.0,5,1217,1.0,949.0,949.0
0.163,17,2,152,1,76,0.0,48.0,48.0,1,76,0.0,48.0,48.0
0.009,6,10,1779,5,928,2.0,660.0,660.0,5,851,2.0,583.0,583.0
0.006,6,10,1689,5,839,1.0,571.0,571.0,5,850,1.0,582.0,582.0
0.005,6,14,3742,7,452,0.0,80.0,80.0,7,3290,0.0,1448.0,972.0
0.008,6,10,1547,5,764,1.0,496.0,496.0,5,783,1.0,515.0,515.0
0.006,6,10,1547,5,764,1.0,496.0,496.0,5,783,1.0,515.0,515.0
0.005,6,10,2006,5,927,1.0,659.0,659.0,5,1079,1.0,811.0,811.0
0.11,6,10,1506,5,395,24.0,127.0,127.0,5,1111,22.0,843.0,843.0
356.608,6,21,1795,16,1030,23773.0,190.0,190.0,5,765,60004.0,464.0,248.0
0.004,17,2,148,1,60,0.0,32.0,32.0,1,88,0.0,60.0,60.0
0.006,6,10,1547,5,764,1.0,496.0,496.0,5,783,1.0,515.0,515.0
361.842,6,21,1792,16,1030,24122.0,190.0,190.0,5,762,60009.0,461.0,247.0
0.015,17,4,284,2,120,0.0,32.0,32.0,2,164,0.0,60.0,54.0
0.065,6,10,1506,5,395,12.0,127.0,127.0,5,1111,15.0,843.0,843.0
354.044,6,21,1795,16,1030,23602.0,190.0,190.0,5,765,60003.0,464.0,248.0
15.075,17,15,9238,8,6902,2149.0,1350.0,834.0,7,2336,2507.0,1350.0,305.0
0.003,17,2,148,1,60,0.0,32.0,32.0,1,88,0.0,60.0,60.0
240.09,6,16,4481,9,963,30011.0,238.0,166.0,7,3518,40014.0,1402.0,786.0
0.009,6,10,1983,5,910,2.0,642.0,642.0,5,1073,2.0,805.0,805.0
0.004,6,10,1989,5,927,1.0,659.0,659.0,5,1062,1.0,794.0,794.0
0.005,17,2,140,1,62,0.0,34.0,34.0,1,78,0.0,50.0,50.0
0.073,17,2,412,1,61,0.0,33.0,33.0,1,351,0.0,323.0,323.0
0.01,17,2,230,1,68,0.0,40.0,40.0,1,162,0.0,134.0,134.0
0.098,6,10,1506,5,395,20.0,127.0,127.0,5,1111,20.0,843.0,843.0
0.005,6,10,2007,5,928,1.0,660.0,660.0,5,1079,1.0,811.0,811.0
292.102,6,403,347998,208,22383,1411.0,2736.0,889.0,195,325615,1505.0,2769.0,1742.0
0.008,6,10,1989,5,910,1.0,642.0,642.0,5,1079,1.0,811.0,811.0
0.005,6,10,1989,5,927,1.0,659.0,659.0,5,1062,1.0,794.0,794.0
0.006,6,10,1854,5,889,1.0,621.0,621.0,5,965,1.0,697.0,697.0
0.004,17,2,148,1,60,0.0,32.0,32.0,1,88,0.0,60.0,60.0
0.005,17,2,170,1,65,0.0,37.0,37.0,1,105,0.0,77.0,77.0
0.202,6,10,1506,5,395,49.0,127.0,127.0,5,1111,29.0,843.0,843.0
0.005,17,2,179,1,71,0.0,43.0,43.0,1,108,0.0,80.0,80.0
292.095,6,546,679762,206,32672,1424.0,2736.0,1128.0,340,647090,861.0,4206.0,1942.0
0.04,17,4,596,2,122,0.0,33.0,33.0,2,474,0.0,323.0,209.0
0.015,6,10,1972,5,910,3.0,642.0,642.0,5,1062,3.0,794.0,794.0
0.068,17,8,3613,4,1874,22.0,1350.0,440.0,4,1739,11.0,1350.0,406.0
0.005,6,10,1689,5,839,1.0,571.0,571.0,5,850,1.0,582.0,582.0
0.01,17,4,284,2,120,1.0,32.0,32.0,2,164,1.0,60.0,54.0
0.01,6,10,1989,5,910,2.0,642.0,642.0,5,1079,2.0,811.0,811.0
0.008,6,10,1989,5,910,2.0,642.0,642.0,5,1079,2.0,811.0,811.0
0.088,6,10,1506,5,395,20.0,127.0,127.0,5,1111,19.0,843.0,843.0
0.004,6,10,1989,5,927,1.0,659.0,659.0,5,1062,1.0,794.0,794.0
0.005,6,10,2006,5,927,1.0,659.0,659.0,5,1079,1.0,811.0,811.0
0.013,6,10,1983,5,910,3.0,642.0,642.0,5,1073,3.0,805.0,805.0
0.005,6,14,3799,7,509,0.0,137.0,137.0,7,3290,0.0,1448.0,972.0
325.736,17,20,1124,10,716,36179.0,48.0,43.0,10,408,36179.0,20.0,12.0
0.005,6,10,2007,5,928,1.0,660.0,660.0,5,1079,1.0,811.0,811.0
178.047,17,90,12625,45,3006,4046.0,44.0,38.0,45,9619,4046.0,239.0,185.0
40.061,17,10,676,5,460,10013.0,104.0,64.0,5,216,10014.0,20.0,15.0
0.003,17,4,284,2,120,0.0,32.0,32.0,2,164,0.0,60.0,54.0
0.112,6,10,1506,5,395,26.0,127.0,127.0,5,1111,27.0,843.0,843.0
40.058,17,10,676,5,460,10013.0,104.0,64.0,5,216,10013.0,20.0,15.0
0.004,17,2,234,1,61,0.0,33.0,33.0,1,173,0.0,145.0,145.0
0.012,6,10,1972,5,910,3.0,642.0,642.0,5,1062,2.0,794.0,794.0
240.205,6,18,7197,10,2088,26689.0,1496.0,780.0,8,5109,34309.0,2645.0,1171.0
0.018,6,10,1983,5,910,4.0,642.0,642.0,5,1073,4.0,805.0,805.0
0.08,6,10,1506,5,395,18.0,127.0,127.0,5,1111,19.0,843.0,843.0
0.004,17,2,136,1,60,0.0,32.0,32.0,1,76,0.0,48.0,48.0
308.708,17,20,1124,10,716,34286.0,48.0,43.0,10,408,34286.0,20.0,12.0
0.004,6,10,1989,5,927,1.0,659.0,659.0,5,1062,1.0,794.0,794.0
0.006,6,10,2006,5,927,1.0,659.0,659.0,5,1079,1.0,811.0,811.0
308.299,17,20,1124,10,716,34241.0,48.0,43.0,10,408,34241.0,20.0,12.0
0.013,6,10,1989,5,910,3.0,642.0,642.0,5,1079,3.0,811.0,811.0
0.004,6,10,2000,5,927,1.0,659.0,659.0,5,1073,1.0,805.0,805.0
0.023,6,10,1983,5,910,5.0,642.0,642.0,5,1073,5.0,805.0,805.0
0.004,17,2,412,1,61,0.0,33.0,33.0,1,351,0.0,323.0,323.0
0.013,6,10,1989,5,910,3.0,642.0,642.0,5,1079,3.0,811.0,811.0
0.005,17,2,169,1,62,0.0,34.0,34.0,1,107,0.0,79.0,79.0
0.039,17,2,412,1,61,0.0,33.0,33.0,1,351,0.0,323.0,323.0
0.005,6,10,2000,5,927,1.0,659.0,659.0,5,1073,1.0,805.0,805.0
0.042,17,2,179,1,71,0.0,43.0,43.0,1,108,0.0,80.0,80.0
0.009,6,10,1972,5,910,2.0,642.0,642.0,5,1062,2.0,794.0,794.0
0.003,17,2,152,1,76,0.0,48.0,48.0,1,76,0.0,48.0,48.0
0.012,6,10,1989,5,927,2.0,659.0,659.0,5,1062,2.0,794.0,794.0
0.006,6,10,1854,5,889,1.0,621.0,621.0,5,965,1.0,697.0,697.0
240.096,6,16,4481,9,963,30012.0,238.0,166.0,7,3518,40015.0,1402.0,786.0
0.004,6,10,2006,5,927,1.0,659.0,659.0,5,1079,1.0,811.0,811.0
0.004,6,10,2006,5,927,1.0,659.0,659.0,5,1079,1.0,811.0,811.0
0.013,6,10,1972,5,910,3.0,642.0,642.0,5,1062,3.0,794.0,794.0
0.004,6,10,1702,5,863,1.0,595.0,595.0,5,839,0.0,571.0,571.0
0.005,17,2,180,1,66,0.0,38.0,38.0,1,114,0.0,86.0,86.0
5.722,6,38,25524,18,15988,336.0,2804.0,2149.0,20,9536,294.0,1288.0,1212.0
0.019,6,10,1631,5,848,4.0,580.0,580.0,5,783,4.0,515.0,515.0
0.012,6,10,1631,5,848,2.0,580.0,580.0,5,783,2.0,515.0,515.0
0.006,17,2,179,1,71,0.0,43.0,43.0,1,108,0.0,80.0,80.0
0.012,6,10,1762,5,911,2.0,643.0,643.0,5,851,3.0,583.0,583.0
0.005,17,2,179,1,71,0.0,43.0,43.0,1,108,0.0,80.0,80.0
0.005,6,10,2000,5,927,1.0,659.0,659.0,5,1073,1.0,805.0,805.0
0.005,6,14,3736,7,446,0.0,74.0,74.0,7,3290,0.0,1448.0,972.0
0.053,17,2,152,1,76,0.0,48.0,48.0,1,76,0.0,48.0,48.0
0.004,6,10,2007,5,928,1.0,660.0,660.0,5,1079,1.0,811.0,811.0
0.005,17,2,170,1,65,0.0,37.0,37.0,1,105,0.0,77.0,77.0
0.069,6,10,1506,5,395,16.0,127.0,127.0,5,1111,15.0,843.0,843.0
0.005,17,2,214,1,75,0.0,47.0,47.0,1,139,0.0,111.0,111.0
0.005,6,10,2007,5,928,1.0,660.0,660.0,5,1079,1.0,811.0,811.0
413.47,6,29,4409,12,3102,10914.0,494.0,494.0,17,1307,25841.0,83.0,83.0
0.156,6,23,6428,11,2285,14.0,746.0,341.0,12,4143,13.0,1324.0,585.0
0.027,6,6,716,3,458,12.0,302.0,302.0,3,258,11.0,102.0,102.0
0.011,6,10,1983,5,910,2.0,642.0,642.0,5,1073,2.0,805.0,805.0
0.006,6,10,1689,5,839,1.0,571.0,571.0,5,850,1.0,582.0,582.0
0.003,17,2,148,1,60,0.0,32.0,32.0,1,88,0.0,60.0,60.0
0.006,6,10,1854,5,889,1.0,621.0,621.0,5,965,1.0,697.0,697.0
309.87,17,20,1124,10,716,34423.0,48.0,43.0,10,408,34423.0,20.0,12.0
0.005,6,10,1854,5,889,1.0,621.0,621.0,5,965,1.0,697.0,697.0
15.077,17,14,9206,8,6912,2149.0,1350.0,836.0,6,2294,3009.0,1350.0,354.0
0.135,6,10,1506,5,395,26.0,127.0,127.0,5,1111,29.0,843.0,843.0
0.122,6,10,1506,5,395,28.0,127.0,127.0,5,1111,15.0,843.0,843.0
0.011,6,10,1631,5,848,2.0,580.0,580.0,5,783,2.0,515.0,515.0
0.004,6,10,2007,5,928,1.0,660.0,660.0,5,1079,1.0,811.0,811.0
0.013,6,10,1643,5,860,3.0,592.0,592.0,5,783,3.0,515.0,515.0
0.108,6,10,1506,5,395,22.0,127.0,127.0,5,1111,23.0,843.0,843.0
0.006,6,12,1698,6,863,1.0,327.0,271.0,6,835,1.0,515.0,515.0
0.005,6,10,1689,5,839,1.0,571.0,571.0,5,850,1.0,582.0,582.0
0.004,6,10,2007,5,928,1.0,660.0,660.0,5,1079,1.0,811.0,811.0
0.009,6,10,1989,5,910,2.0,642.0,642.0,5,1079,2.0,811.0,811.0
10.914,17,26,4075,13,2140,900.0,587.0,136.0,13,1935,900.0,270.0,120.0
0.072,17,2,234,1,61,0.0,33.0,33.0,1,173,0.0,145.0,145.0
386.14,6,28,4357,12,3102,10911.0,494.0,494.0,16,1255,25742.0,83.0,83.0
0.021,6,10,1677,5,827,5.0,559.0,559.0,5,850,5.0,582.0,582.0
0.012,6,10,1989,5,910,3.0,642.0,642.0,5,1079,3.0,811.0,811.0
0.159,6,10,1506,5,395,39.0,127.0,127.0,5,1111,35.0,843.0,843.0
15.096,17,16,10623,9,8280,1883.0,1350.0,892.0,7,2343,2507.0,1350.0,306.0
0.005,6,10,2007,5,928,1.0,660.0,660.0,5,1079,1.0,811.0,811.0
0.004,6,10,1779,5,928,1.0,660.0,660.0,5,851,1.0,583.0,583.0
0.005,17,2,170,1,65,0.0,37.0,37.0,1,105,0.0,77.0,77.0
0.005,6,10,2000,5,927,1.0,659.0,659.0,5,1073,1.0,805.0,805.0
0.005,6,10,1689,5,839,1.0,571.0,571.0,5,850,1.0,582.0,582.0
0.013,6,10,1677,5,827,3.0,559.0,559.0,5,850,3.0,582.0,582.0
0.004,6,10,2007,5,928,1.0,660.0,660.0,5,1079,1.0,811.0,811.0
0.011,6,10,1677,5,827,2.0,559.0,559.0,5,850,2.0,582.0,582.0
0.01,6,10,1989,5,910,2.0,642.0,642.0,5,1079,2.0,811.0,811.0
40.06,17,10,676,5,460,10012.0,104.0,64.0,5,216,10009.0,20.0,15.0
0.007,17,2,194,1,59,0.0,31.0,31.0,1,135,0.0,107.0,107.0
0.089,6,10,1506,5,395,19.0,127.0,127.0,5,1111,19.0,843.0,843.0
0.001,17,2,180,1,66,0.0,38.0,38.0,1,114,0.0,86.0,86.0
0.001,17,2,136,1,60,0.0,32.0,32.0,1,76,0.0,48.0,48.0
178.012,17,82,11619,41,2730,4450.0,44.0,38.0,41,8889,4450.0,252.0,188.0
0.005,6,10,1774,5,923,1.0,655.0,655.0,5,851,1.0,583.0,583.0
0.005,17,2,144,1,64,0.0,36.0,36.0,1,80,0.0,52.0,52.0
0.02,6,10,1990,5,911,4.0,643.0,643.0,5,1079,5.0,811.0,811.0
0.124,6,10,1506,5,395,28.0,127.0,127.0,5,1111,27.0,843.0,843.0
0.103,6,10,1506,5,395,23.0,127.0,127.0,5,1111,24.0,843.0,843.0
0.005,6,14,3799,7,509,0.0,137.0,137.0,7,3290,0.0,1448.0,972.0
0.004,6,10,2000,5,927,1.0,659.0,659.0,5,1073,1.0,805.0,805.0
0.01,6,10,1762,5,911,2.0,643.0,643.0,5,851,2.0,583.0,583.0
0.008,6,10,1983,5,910,2.0,642.0,642.0,5,1073,2.0,805.0,805.0
0.005,6,10,2006,5,927,1.0,659.0,659.0,5,1079,1.0,811.0,811.0
0.015,6,10,1990,5,911,3.0,643.0,643.0,5,1079,3.0,811.0,811.0
0.005,6,10,2007,5,928,1.0,660.0,660.0,5,1079,1.0,811.0,811.0
0.005,6,13,3747,7,509,0.0,137.0,137.0,6,3238,0.0,1470.0,1459.0
0.077,6,10,1506,5,395,16.0,127.0,127.0,5,1111,17.0,843.0,843.0
0.005,6,10,2007,5,928,1.0,660.0,660.0,5,1079,1.0,811.0,811.0
356.567,6,21,1795,16,1030,23771.0,190.0,190.0,5,765,60004.0,464.0,248.0
0.012,6,10,1972,5,910,2.0,642.0,642.0,5,1062,3.0,794.0,794.0
0.071,6,10,1506,5,395,15.0,127.0,127.0,5,1111,14.0,843.0,843.0
352.242,6,20,2210,6,1308,12003.0,494.0,494.0,14,902,27095.0,83.0,83.0
0.027,6,10,1631,5,848,6.0,580.0,580.0,5,783,6.0,515.0,515.0
0.004,6,10,2000,5,927,1.0,659.0,659.0,5,1073,1.0,805.0,805.0
0.004,6,10,2006,5,927,1.0,659.0,659.0,5,1079,1.0,811.0,811.0
0.006,6,10,1547,5,764,1.0,496.0,496.0,5,783,1.0,515.0,515.0
0.005,6,10,1779,5,928,1.0,660.0,660.0,5,851,1.0,583.0,583.0
0.006,6,10,1547,5,764,1.0,496.0,496.0,5,783,1.0,515.0,515.0
0.096,6,10,1506,5,395,19.0,127.0,127.0,5,1111,20.0,843.0,843.0
0.005,6,10,2000,5,927,1.0,659.0,659.0,5,1073,1.0,805.0,805.0
0.016,17,2,164,1,74,0.0,46.0,46.0,1,90,0.0,62.0,62.0
240.784,6,22,9050,11,1717,24078.0,568.0,383.0,11,7333,24078.0,2369.0,1125.0
0.104,6,10,1506,5,395,24.0,127.0,127.0,5,1111,24.0,843.0,843.0
0.01,6,10,1762,5,911,2.0,643.0,643.0,5,851,2.0,583.0,583.0
240.008,6,9,787,5,488,60002.0,232.0,232.0,4,299,80002.0,83.0,83.0
0.004,6,10,2000,5,927,1.0,659.0,659.0,5,1073,1.0,805.0,805.0
0.112,6,10,1506,5,395,23.0,127.0,127.0,5,1111,24.0,843.0,843.0
280.664,6,24,6440,11,1226,28066.0,267.0,156.0,13,5214,23387.0,1400.0,781.0
0.005,17,2,180,1,58,0.0,30.0,30.0,1,122,0.0,94.0,94.0
0.006,6,10,1547,5,764,1.0,496.0,496.0,5,783,1.0,515.0,515.0
40.078,17,10,676,5,460,10018.0,104.0,64.0,5,216,10018.0,20.0,15.0
0.023,6,10,1989,5,910,5.0,642.0,642.0,5,1079,5.0,811.0,811.0
0.001,17,2,180,1,66,0.0,38.0,38.0,1,114,0.0,86.0,86.0
0.006,17,2,214,1,75,0.0,47.0,47.0,1,139,0.0,111.0,111.0
291.961,6,391,348662,199,21917,1474.0,2736.0,889.0,192,326745,1528.0,2804.0,1779.0
0.006,17,2,199,1,68,0.0,40.0,40.0,1,131,0.0,103.0,103.0
0.01,6,10,1677,5,827,2.0,559.0,559.0,5,850,2.0,582.0,582.0
0.006,6,10,2006,5,927,1.0,659.0,659.0,5,1079,1.0,811.0,811.0
308.755,17,20,1124,10,716,34291.0,48.0,43.0,10,408,34291.0,20.0,12.0
0.302,17,47,28506,26,22605,12.0,1350.0,841.0,21,5901,12.0,1350.0,253.0
240.1,6,16,4482,9,963,30012.0,238.0,166.0,7,3519,40016.0,1402.0,786.0
0.022,6,10,1983,5,910,5.0,642.0,642.0,5,1073,5.0,805.0,805.0
40.071,17,10,676,5,460,10015.0,104.0,64.0,5,216,10017.0,20.0,15.0
0.003,17,4,284,2,120,0.0,32.0,32.0,2,164,0.0,60.0,54.0
240.013,6,9,787,5,488,60003.0,232.0,232.0,4,299,80003.0,83.0,83.0
40.056,17,10,676,5,460,10013.0,104.0,64.0,5,216,10013.0,20.0,15.0
0.005,6,14,3736,7,446,0.0,74.0,74.0,7,3290,0.0,1448.0,972.0
0.001,17,2,180,1,66,0.0,38.0,38.0,1,114,0.0,86.0,86.0
0.005,17,2,136,1,60,0.0,32.0,32.0,1,76,0.0,48.0,48.0
0.084,6,10,1506,5,395,19.0,127.0,127.0,5,1111,19.0,843.0,843.0
0.004,6,10,2006,5,927,1.0,659.0,659.0,5,1079,1.0,811.0,811.0
0.179,17,4,596,2,122,108.0,33.0,33.0,2,474,175.0,323.0,209.0
0.014,6,10,1990,5,911,3.0,643.0,643.0,5,1079,3.0,811.0,811.0
0.041,17,2,148,1,60,0.0,32.0,32.0,1,88,0.0,60.0,60.0
0.113,6,10,1506,5,395,21.0,127.0,127.0,5,1111,24.0,843.0,843.0
0.121,6,10,1506,5,395,28.0,127.0,127.0,5,1111,28.0,843.0,843.0
0.005,6,10,2006,5,927,1.0,659.0,659.0,5,1079,1.0,811.0,811.0
0.01,6,10,1972,5,910,2.0,642.0,642.0,5,1062,2.0,794.0,794.0
0.008,6,10,1983,5,910,2.0,642.0,642.0,5,1073,2.0,805.0,805.0
0.012,6,10,1989,5,910,3.0,642.0,642.0,5,1079,3.0,811.0,811.0
0.005,6,10,2007,5,928,1.0,660.0,660.0,5,1079,1.0,811.0,811.0
0.112,6,10,1506,5,395,22.0,127.0,127.0,5,1111,24.0,843.0,843.0
0.015,6,10,1989,5,910,3.0,642.0,642.0,5,1079,3.0,811.0,811.0
11.399,17,28,4371,14,2312,864.0,587.0,137.0,14,2059,864.0,270.0,119.0
0.005,17,2,154,1,69,0.0,41.0,41.0,1,85,0.0,57.0,57.0
0.14,6,10,1506,5,395,32.0,127.0,127.0,5,1111,34.0,843.0,843.0
0.006,6,10,1547,5,764,1.0,496.0,496.0,5,783,1.0,515.0,515.0
0.003,17,4,284,2,120,0.0,32.0,32.0,2,164,0.0,60.0,54.0
0.092,6,10,1506,5,395,20.0,127.0,127.0,5,1111,21.0,843.0,843.0
0.007,17,2,179,1,71,0.0,43.0,43.0,1,108,0.0,80.0,80.0
0.004,17,2,148,1,60,0.0,32.0,32.0,1,88,0.0,60.0,60.0
0.013,6,7,695,4,448,4.0,232.0,232.0,3,247,4.0,83.0,83.0
0.038,17,2,152,1,76,0.0,48.0,48.0,1,76,0.0,48.0,48.0
0.123,6,10,1506,5,395,24.0,127.0,127.0,5,1111,26.0,843.0,843.0
0.02,6,10,1972,5,910,5.0,642.0,642.0,5,1062,4.0,794.0,794.0
0.0,17,2,154,1,69,0.0,41.0,41.0,1,85,0.0,57.0,57.0
0.011,6,13,3735,7,497,1.0,125.0,125.0,6,3238,2.0,1470.0,1459.0
0.011,6,10,1983,5,910,2.0,642.0,642.0,5,1073,2.0,805.0,805.0
0.006,17,4,284,2,120,3.0,32.0,32.0,2,164,3.0,60.0,54.0
426.921,6,29,4409,12,3102,10911.0,494.0,494.0,17,1307,26682.0,83.0,83.0
0.001,17,2,180,1,66,0.0,38.0,38.0,1,114,0.0,86.0,86.0
0.005,6,10,2006,5,927,1.0,659.0,659.0,5,1079,1.0,811.0,811.0
0.083,6,10,1506,5,395,16.0,127.0,127.0,5,1111,18.0,843.0,843.0
0.004,6,10,1702,5,863,0.0,595.0,595.0,5,839,1.0,571.0,571.0
0.007,6,10,1547,5,764,1.0,496.0,496.0,5,783,1.0,515.0,515.0
0.013,17,2,152,1,56,0.0,28.0,28.0,1,96,0.0,68.0,68.0
0.004,6,10,2000,5,927,1.0,659.0,659.0,5,1073,1.0,805.0,805.0
0.122,17,2,80,1,32,0.0,4.0,4.0,1,48,0.0,20.0,20.0
0.005,6,13,3690,7,452,0.0,80.0,80.0,6,3238,1.0,1470.0,1459.0
0.096,6,10,1506,5,395,21.0,127.0,127.0,5,1111,22.0,843.0,843.0
0.001,17,2,140,1,62,0.0,34.0,34.0,1,78,0.0,50.0,50.0
0.05,6,10,1972,5,910,12.0,642.0,642.0,5,1062,12.0,794.0,794.0
0.096,6,10,1506,5,395,21.0,127.0,127.0,5,1111,18.0,843.0,843.0
0.004,17,2,170,1,65,0.0,37.0,37.0,1,105,0.0,77.0,77.0
0.009,6,10,1990,5,911,2.0,643.0,643.0,5,1079,2.0,811.0,811.0
59.56,58,5,360,4,288,19853.0,24.0,24.0,1,72,0.0,24.0,24.0
0.004,6,10,1702,5,863,1.0,595.0,595.0,5,839,0.0,571.0,571.0
0.011,6,10,1989,5,910,2.0,642.0,642.0,5,1079,2.0,811.0,811.0
316.346,6,33,12148,18,2629,18608.0,564.0,337.0,15,9519,18309.0,1402.0,970.0
0.005,6,10,1989,5,927,1.0,659.0,659.0,5,1062,1.0,794.0,794.0
0.006,6,10,1689,5,839,1.0,571.0,571.0,5,850,1.0,582.0,582.0
0.004,6,10,2007,5,928,1.0,660.0,660.0,5,1079,1.0,811.0,811.0
40.072,17,10,676,5,460,10017.0,104.0,64.0,5,216,10017.0,20.0,15.0
0.001,17,2,164,1,74,0.0,46.0,46.0,1,90,0.0,62.0,62.0
0.005,17,2,214,1,75,0.0,47.0,47.0,1,139,0.0,111.0,111.0
0.062,6,10,1972,5,910,15.0,642.0,642.0,5,1062,15.0,794.0,794.0
0.111,6,10,1506,5,395,23.0,127.0,127.0,5,1111,24.0,843.0,843.0
0.165,17,2,152,1,76,0.0,48.0,48.0,1,76,0.0,48.0,48.0
1792.605,6,493,99532,249,88182,7227.0,421.0,365.0,244,11350,7376.0,53.0,53.0
0.013,6,10,1989,5,910,3.0,642.0,642.0,5,1079,3.0,811.0,811.0
0.006,6,10,1689,5,839,1.0,571.0,571.0,5,850,1.0,582.0,582.0
0.018,6,10,1983,5,910,4.0,642.0,642.0,5,1073,4.0,805.0,805.0
0.115,6,10,1506,5,395,24.0,127.0,127.0,5,1111,27.0,843.0,843.0
176.148,17,84,12172,42,2808,4296.0,44.0,38.0,42,9364,4296.0,261.0,194.0
361.889,6,21,1793,16,1030,24125.0,190.0,190.0,5,763,60011.0,462.0,247.0
0.006,6,10,1547,5,764,1.0,496.0,496.0,5,783,1.0,515.0,515.0
0.078,6,10,1506,5,395,17.0,127.0,127.0,5,1111,17.0,843.0,843.0
353.64,6,20,2210,6,1308,12003.0,494.0,494.0,14,902,27202.0,83.0,83.0
0.011,6,10,1990,5,911,2.0,643.0,643.0,5,1079,2.0,811.0,811.0
0.006,17,2,169,1,62,0.0,34.0,34.0,1,107,0.0,79.0,79.0
0.006,6,10,1547,5,764,1.0,496.0,496.0,5,783,1.0,515.0,515.0
0.114,6,10,1506,5,395,22.0,127.0,127.0,5,1111,24.0,843.0,843.0
0.005,17,2,170,1,65,0.0,37.0,37.0,1,105,0.0,77.0,77.0
1798.866,17,3283,251345,1634,132469,1101.0,84.0,53.0,1649,118876,1091.0,227.0,44.0
0.006,6,10,1689,5,839,1.0,571.0,571.0,5,850,1.0,582.0,582.0
10.796,17,28,4418,14,1994,822.0,269.0,114.0,14,2424,821.0,587.0,145.0
0.017,6,10,1677,5,827,4.0,559.0,559.0,5,850,4.0,582.0,582.0
0.01,6,14,3787,7,497,1.0,125.0,125.0,7,3290,1.0,1448.0,972.0
240.114,6,31,9222,15,6752,17151.0,1876.0,664.0,16,2470,16007.0,580.0,203.0
0.009,6,10,1972,5,910,2.0,642.0,642.0,5,1062,2.0,794.0,794.0
0.036,17,4,284,2,120,0.0,32.0,32.0,2,164,33.0,60.0,54.0
40.057,17,10,676,5,460,10012.0,104.0,64.0,5,216,10013.0,20.0,15.0
40.08,17,10,676,5,460,10019.0,104.0,64.0,5,216,10019.0,20.0,15.0
0.005,6,10,2006,5,927,1.0,659.0,659.0,5,1079,1.0,811.0,811.0
0.012,6,10,1990,5,911,3.0,643.0,643.0,5,1079,2.0,811.0,811.0
0.004,17,4,284,2,120,0.0,32.0,32.0,2,164,1.0,60.0,54.0
0.066,17,8,3613,4,1874,22.0,1350.0,440.0,4,1739,10.0,1350.0,406.0
0.006,6,10,1547,5,764,1.0,496.0,496.0,5,783,1.0,515.0,515.0
0.041,17,2,144,1,64,0.0,36.0,36.0,1,80,0.0,52.0,52.0
0.005,6,10,1854,5,889,1.0,621.0,621.0,5,965,1.0,697.0,697.0
291.466,6,372,346644,190,21434,1542.0,2736.0,888.0,182,325210,1610.0,4171.0,1879.0
0.005,6,10,1989,5,927,1.0,659.0,659.0,5,1062,1.0,794.0,794.0
177.11,17,82,11665,41,2725,4427.0,44.0,38.0,41,8940,4427.0,239.0,190.0
0.005,17,2,144,1,64,0.0,36.0,36.0,1,80,0.0,52.0,52.0
0.005,6,10,1989,5,927,1.0,659.0,659.0,5,1062,1.0,794.0,794.0
0.041,17,4,284,2,120,0.0,32.0,32.0,2,164,1.0,60.0,54.0
0.089,6,10,1506,5,395,20.0,127.0,127.0,5,1111,20.0,843.0,843.0
11.07,17,28,4423,14,1995,839.0,270.0,114.0,14,2428,839.0,587.0,145.0
0.004,17,2,136,1,60,0.0,32.0,32.0,1,76,0.0,48.0,48.0
0.005,6,10,2007,5,928,1.0,660.0,660.0,5,1079,1.0,811.0,811.0
0.005,6,10,2006,5,927,1.0,659.0,659.0,5,1079,1.0,811.0,811.0
0.005,6,10,1643,5,860,1.0,592.0,592.0,5,783,1.0,515.0,515.0
0.037,17,4,420,2,122,0.0,33.0,33.0,2,298,34.0,145.0,121.0
0.009,6,10,1989,5,910,2.0,642.0,642.0,5,1079,2.0,811.0,811.0
0.005,6,14,3736,7,446,0.0,74.0,74.0,7,3290,0.0,1448.0,972.0
0.006,6,10,2006,5,927,1.0,659.0,659.0,5,1079,1.0,811.0,811.0
0.01,6,10,1989,5,910,2.0,642.0,642.0,5,1079,2.0,811.0,811.0
0.005,6,10,1689,5,839,1.0,571.0,571.0,5,850,1.0,582.0,582.0
0.005,17,2,170,1,65,0.0,37.0,37.0,1,105,0.0,77.0,77.0
15.189,17,39,20201,21,17033,758.0,1350.0,783.0,18,3168,891.0,1350.0,148.0
0.001,17,2,180,1,66,0.0,38.0,38.0,1,114,0.0,86.0,86.0
0.005,6,10,1854,5,889,1.0,621.0,621.0,5,965,1.0,697.0,697.0
0.009,6,10,1983,5,910,2.0,642.0,642.0,5,1073,2.0,805.0,805.0
174.183,17,76,10856,38,2537,4707.0,44.0,38.0,38,8319,4707.0,239.0,190.0
0.004,17,2,136,1,60,0.0,32.0,32.0,1,76,0.0,48.0,48.0
308.612,17,20,1124,10,716,34276.0,48.0,43.0,10,408,34276.0,20.0,12.0
0.004,6,10,1774,5,923,1.0,655.0,655.0,5,851,1.0,583.0,583.0
0.014,6,10,1989,5,910,3.0,642.0,642.0,5,1079,3.0,811.0,811.0
174.291,17,76,10834,38,2530,4710.0,44.0,38.0,38,8304,4710.0,239.0,190.0
0.005,6,10,1779,5,928,1.0,660.0,660.0,5,851,1.0,583.0,583.0
0.009,6,10,1990,5,911,2.0,643.0,643.0,5,1079,2.0,811.0,811.0
0.071,6,10,1506,5,395,16.0,127.0,127.0,5,1111,14.0,843.0,843.0
0.105,6,10,1506,5,395,23.0,127.0,127.0,5,1111,22.0,843.0,843.0
272.534,6,24,7211,14,1759,20964.0,253.0,207.0,10,5452,30281.0,1402.0,703.0
0.004,17,4,284,2,120,0.0,32.0,32.0,2,164,0.0,60.0,54.0
0.09,6,10,1506,5,395,20.0,127.0,127.0,5,1111,20.0,843.0,843.0
0.093,6,10,1506,5,395,20.0,127.0,127.0,5,1111,20.0,843.0,843.0
0.081,6,10,1506,5,395,18.0,127.0,127.0,5,1111,16.0,843.0,843.0
0.005,6,10,2007,5,928,1.0,660.0,660.0,5,1079,1.0,811.0,811.0
0.017,17,2,180,1,66,0.0,38.0,38.0,1,114,0.0,86.0,86.0
0.01,6,10,1990,5,911,2.0,643.0,643.0,5,1079,2.0,811.0,811.0
0.021,6,10,1990,5,911,5.0,643.0,643.0,5,1079,5.0,811.0,811.0
0.008,6,10,1989,5,910,1.0,642.0,642.0,5,1079,2.0,811.0,811.0
0.043,17,2,182,1,65,0.0,37.0,37.0,1,117,0.0,89.0,89.0
0.007,6,10,2006,5,927,1.0,659.0,659.0,5,1079,1.0,811.0,811.0
297.328,6,402,348686,197,21808,1516.0,2691.0,888.0,205,326878,1457.0,2804.0,1655.0
0.003,17,2,185,1,73,0.0,45.0,45.0,1,112,0.0,84.0,84.0
0.237,17,17,8615,8,5989,33.0,1350.0,720.0,9,2626,18.0,1350.0,263.0
0.005,6,10,2006,5,927,1.0,659.0,659.0,5,1079,1.0,811.0,811.0
309.252,17,18,1008,9,640,38640.0,48.0,43.0,9,368,38640.0,20.0,12.0
0.006,6,10,2007,5,928,1.0,660.0,660.0,5,1079,1.0,811.0,811.0
0.006,6,10,1547,5,764,1.0,496.0,496.0,5,783,1.0,515.0,515.0
0.005,6,10,2006,5,927,1.0,659.0,659.0,5,1079,1.0,811.0,811.0
0.001,17,2,180,1,66,0.0,38.0,38.0,1,114,0.0,86.0,86.0
0.024,6,10,1972,5,910,6.0,642.0,642.0,5,1062,6.0,794.0,794.0
1742.948,6,306,97852,189,86500,9271.0,1963.0,678.0,117,11352,15025.0,452.0,70.0
40.06,17,10,676,5,460,10013.0,104.0,64.0,5,216,10014.0,20.0,15.0
0.066,6,10,1506,5,395,15.0,127.0,127.0,5,1111,14.0,843.0,843.0
11.176,17,28,4422,14,1995,847.0,270.0,114.0,14,2427,847.0,586.0,145.0
0.005,17,2,166,1,75,0.0,47.0,47.0,1,91,0.0,63.0,63.0
0.02,6,10,1972,5,910,5.0,642.0,642.0,5,1062,5.0,794.0,794.0
0.001,17,2,180,1,66,0.0,38.0,38.0,1,114,0.0,86.0,86.0
0.041,17,2,144,1,64,0.0,36.0,36.0,1,80,0.0,52.0,52.0
0.102,6,10,1506,5,395,22.0,127.0,127.0,5,1111,23.0,843.0,843.0
0.012,6,10,1972,5,910,3.0,642.0,642.0,5,1062,2.0,794.0,794.0
0.213,17,4,596,2,122,141.0,33.0,33.0,2,474,176.0,323.0,209.0
0.009,17,2,170,1,65,0.0,37.0,37.0,1,105,0.0,77.0,77.0
0.053,17,2,152,1,76,0.0,48.0,48.0,1,76,0.0,48.0,48.0
1.142,6,33,13432,19,5933,63.0,1360.0,732.0,14,7499,73.0,2720.0,769.0
175.314,17,74,10729,37,2473,4869.0,44.0,38.0,37,8256,4869.0,279.0,195.0
0.004,6,10,2006,5,927,1.0,659.0,659.0,5,1079,1.0,811.0,811.0
0.004,6,15,3794,8,504,0.0,80.0,80.0,7,3290,0.0,1448.0,972.0
0.005,17,2,169,1,62,0.0,34.0,34.0,1,107,0.0,79.0,79.0
0.001,17,2,136,1,60,0.0,32.0,32.0,1,76,0.0,48.0,48.0
0.006,6,10,1547,5,764,1.0,496.0,496.0,5,783,1.0,515.0,515.0
0.014,6,10,1989,5,910,3.0,642.0,642.0,5,1079,3.0,811.0,811.0
0.081,6,10,1506,5,395,17.0,127.0,127.0,5,1111,19.0,843.0,843.0
0.006,6,14,3799,7,509,0.0,137.0,137.0,7,3290,0.0,1448.0,972.0
0.081,6,10,1506,5,395,18.0,127.0,127.0,5,1111,15.0,843.0,843.0
172.096,17,78,11037,39,2601,4528.0,44.0,38.0,39,8436,4528.0,239.0,188.0
0.004,17,2,184,1,61,0.0,33.0,33.0,1,123,0.0,95.0,95.0
0.027,6,10,1972,5,910,6.0,642.0,642.0,5,1062,6.0,794.0,794.0
0.01,6,10,1689,5,839,2.0,571.0,571.0,5,850,2.0,582.0,582.0
0.003,17,2,148,1,60,0.0,32.0,32.0,1,88,0.0,60.0,60.0
0.004,6,10,1989,5,927,1.0,659.0,659.0,5,1062,1.0,794.0,794.0
0.005,6,10,1989,5,927,1.0,659.0,659.0,5,1062,1.0,794.0,794.0
0.015,6,13,3735,7,497,2.0,125.0,125.0,6,3238,2.0,1470.0,1459.0
0.089,6,10,1506,5,395,21.0,127.0,127.0,5,1111,19.0,843.0,843.0
0.004,6,10,1702,5,863,0.0,595.0,595.0,5,839,1.0,571.0,571.0
0.055,17,4,352,2,130,1.0,37.0,37.0,2,222,3.0,89.0,83.0
0.006,6,10,2006,5,927,1.0,659.0,659.0,5,1079,1.0,811.0,811.0
0.005,6,10,1989,5,927,1.0,659.0,659.0,5,1062,1.0,794.0,794.0
0.013,6,10,1972,5,910,3.0,642.0,642.0,5,1062,3.0,794.0,794.0
0.005,6,10,2006,5,927,1.0,659.0,659.0,5,1079,1.0,811.0,811.0
0.005,6,10,1854,5,889,1.0,621.0,621.0,5,965,1.0,697.0,697.0
0.006,17,2,179,1,71,0.0,43.0,43.0,1,108,0.0,80.0,80.0
20.598,6,35,9846,17,4328,553.0,3295.0,1205.0,18,5518,1201.0,2667.0,435.0
0.012,6,10,1989,5,910,3.0,642.0,642.0,5,1079,3.0,811.0,811.0
0.021,6,10,1990,5,911,5.0,643.0,643.0,5,1079,5.0,811.0,811.0
240.089,6,16,4482,9,963,30011.0,238.0,166.0,7,3519,40014.0,1402.0,786.0
1769.261,17,92,8096,46,4048,39316.0,60.0,60.0,46,4048,39316.0,60.0,60.0
0.077,6,10,1506,5,395,16.0,127.0,127.0,5,1111,17.0,843.0,843.0
0.005,6,10,1547,5,764,1.0,496.0,496.0,5,783,1.0,515.0,515.0
0.009,6,10,1983,5,910,2.0,642.0,642.0,5,1073,2.0,805.0,805.0
0.005,17,2,230,1,68,0.0,40.0,40.0,1,162,0.0,134.0,134.0
0.006,6,10,1779,5,928,1.0,660.0,660.0,5,851,1.0,583.0,583.0
0.006,6,10,1547,5,764,1.0,496.0,496.0,5,783,1.0,515.0,515.0
0.004,6,10,1702,5,863,1.0,595.0,595.0,5,839,0.0,571.0,571.0
15.079,17,15,8353,8,6345,2149.0,1350.0,765.0,7,2008,2508.0,1350.0,258.0
997.076,6,79,26695,41,8412,24926.0,1402.0,522.0,38,18283,25323.0,1402.0,651.0
0.015,6,10,1677,5,827,3.0,559.0,559.0,5,850,3.0,582.0,582.0
352.252,6,20,2210,6,1308,12003.0,494.0,494.0,14,902,27096.0,83.0,83.0
0.005,17,2,238,1,66,0.0,38.0,38.0,1,172,0.0,144.0,144.0
0.007,6,10,1972,5,910,1.0,642.0,642.0,5,1062,1.0,794.0,794.0
177.391,17,72,10072,36,2401,5068.0,44.0,38.0,36,7671,5068.0,239.0,185.0
0.001,17,2,136,1,60,0.0,32.0,32.0,1,76,0.0,48.0,48.0
0.005,6,10,2007,5,928,1.0,660.0,660.0,5,1079,1.0,811.0,811.0
0.005,6,10,2006,5,927,1.0,659.0,659.0,5,1079,1.0,811.0,811.0
15.075,17,16,9182,8,6935,2149.0,1350.0,838.0,8,2247,2149.0,1350.0,252.0
15.273,17,44,24790,24,19850,662.0,1350.0,799.0,20,4940,802.0,1350.0,219.0
0.125,6,10,1506,5,395,29.0,127.0,127.0,5,1111,28.0,843.0,843.0
0.072,17,2,186,1,61,0.0,33.0,33.0,1,125,0.0,97.0,97.0
0.08,6,10,1506,5,395,17.0,127.0,127.0,5,1111,18.0,843.0,843.0
1770.621,17,120,11460,60,5460,30010.0,63.0,63.0,60,6000,30010.0,72.0,72.0
0.006,6,10,1547,5,764,1.0,496.0,496.0,5,783,1.0,515.0,515.0
1799.955,17,3007,226215,1495,119775,1204.0,82.0,52.0,1512,106440,1191.0,226.0,42.0
0.01,6,10,1972,5,910,2.0,642.0,642.0,5,1062,2.0,794.0,794.0
0.005,6,10,1779,5,928,1.0,660.0,660.0,5,851,1.0,583.0,583.0
0.015,17,2,198,1,91,0.0,63.0,63.0,1,107,0.0,79.0,79.0
0.012,6,10,1983,5,910,3.0,642.0,642.0,5,1073,2.0,805.0,805.0
0.013,6,10,1762,5,911,3.0,643.0,643.0,5,851,3.0,583.0,583.0
0.001,17,2,179,1,62,0.0,34.0,34.0,1,117,0.0,89.0,89.0
0.001,17,2,174,1,72,0.0,44.0,44.0,1,102,0.0,74.0,74.0
0.168,17,2,152,1,76,0.0,48.0,48.0,1,76,0.0,48.0,48.0
0.005,6,10,1774,5,923,1.0,655.0,655.0,5,851,1.0,583.0,583.0
0.005,6,10,2006,5,927,1.0,659.0,659.0,5,1079,1.0,811.0,811.0
0.009,6,11,2041,6,962,1.0,642.0,642.0,5,1079,2.0,811.0,811.0
0.11,6,10,1506,5,395,25.0,127.0,127.0,5,1111,26.0,843.0,843.0
0.012,6,10,1990,5,911,2.0,643.0,643.0,5,1079,2.0,811.0,811.0
0.001,17,2,136,1,60,0.0,32.0,32.0,1,76,0.0,48.0,48.0
0.005,17,2,179,1,71,0.0,43.0,43.0,1,108,0.0,80.0,80.0
0.013,6,10,1989,5,910,3.0,642.0,642.0,5,1079,3.0,811.0,811.0
0.001,17,2,136,1,60,0.0,32.0,32.0,1,76,0.0,48.0,48.0
0.005,17,2,140,1,62,0.0,34.0,34.0,1,78,0.0,50.0,50.0
300.11,6,16,2170,9,684,37492.0,146.0,146.0,7,1486,49988.0,419.0,398.0
0.004,6,10,1779,5,928,1.0,660.0,660.0,5,851,1.0,583.0,583.0
0.008,6,10,1983,5,910,2.0,642.0,642.0,5,1073,2.0,805.0,805.0
0.102,6,10,1506,5,395,23.0,127.0,127.0,5,1111,24.0,843.0,843.0
0.005,6,10,2006,5,927,1.0,659.0,659.0,5,1079,1.0,811.0,811.0
0.123,6,10,1506,5,395,26.0,127.0,127.0,5,1111,26.0,843.0,843.0
0.0,17,2,140,1,62,0.0,34.0,34.0,1,78,0.0,50.0,50.0
300.395,6,16,2170,9,684,37527.0,146.0,146.0,7,1486,50037.0,419.0,398.0
0.152,6,10,1506,5,395,34.0,127.0,127.0,5,1111,36.0,843.0,843.0
0.006,6,10,1547,5,764,1.0,496.0,496.0,5,783,1.0,515.0,515.0
0.003,17,2,148,1,60,0.0,32.0,32.0,1,88,0.0,60.0,60.0
0.07,17,8,3613,4,1874,23.0,1350.0,440.0,4,1739,12.0,1350.0,406.0
0.005,6,10,2006,5,927,1.0,659.0,659.0,5,1079,1.0,811.0,811.0
1787.134,6,150,19350,90,13740,20080.0,302.0,302.0,60,5610,30290.0,83.0,83.0
40.061,17,10,676,5,460,10014.0,104.0,64.0,5,216,10014.0,20.0,15.0
0.006,6,10,1547,5,764,1.0,496.0,496.0,5,783,1.0,515.0,515.0
41.967,6,57,29081,29,22934,334.0,2720.0,1553.0,28,6147,1548.0,1360.0,358.0
0.119,6,10,1506,5,395,28.0,127.0,127.0,5,1111,27.0,843.0,843.0
0.013,17,2,152,1,56,0.0,28.0,28.0,1,96,0.0,68.0,68.0
0.005,6,10,2007,5,928,1.0,660.0,660.0,5,1079,1.0,811.0,811.0
0.005,6,10,2007,5,928,1.0,660.0,660.0,5,1079,1.0,811.0,811.0
372.307,6,22,2313,16,867,24820.0,195.0,195.0,6,1446,4636.0,419.0,398.0
0.005,6,10,1689,5,839,1.0,571.0,571.0,5,850,1.0,582.0,582.0
0.008,6,10,1983,5,910,2.0,642.0,642.0,5,1073,1.0,805.0,805.0
0.091,6,10,1506,5,395,20.0,127.0,127.0,5,1111,17.0,843.0,843.0
0.004,17,2,148,1,60,0.0,32.0,32.0,1,88,0.0,60.0,60.0
0.039,17,2,148,1,60,0.0,32.0,32.0,1,88,0.0,60.0,60.0
335.587,17,20,1124,10,716,37273.0,48.0,43.0,10,408,37273.0,20.0,12.0
0.01,6,10,1762,5,911,2.0,643.0,643.0,5,851,2.0,583.0,583.0
0.008,6,10,1990,5,911,2.0,643.0,643.0,5,1079,2.0,811.0,811.0
0.005,6,10,2000,5,927,1.0,659.0,659.0,5,1073,1.0,805.0,805.0
0.004,6,10,1989,5,927,1.0,659.0,659.0,5,1062,1.0,794.0,794.0
40.061,17,10,676,5,460,10014.0,104.0,64.0,5,216,10014.0,20.0,15.0
240.104,6,32,9238,16,6715,16006.0,1789.0,654.0,16,2523,16006.0,580.0,210.0
11.397,17,26,4138,13,2185,936.0,588.0,140.0,13,1953,936.0,268.0,122.0
40.051,17,10,676,5,460,10011.0,104.0,64.0,5,216,10011.0,20.0,15.0
0.012,6,10,1983,5,910,3.0,642.0,642.0,5,1073,3.0,805.0,805.0
0.008,6,10,1762,5,911,2.0,643.0,643.0,5,851,2.0,583.0,583.0
0.106,6,10,1506,5,395,23.0,127.0,127.0,5,1111,24.0,843.0,843.0
0.164,17,2,152,1,76,0.0,48.0,48.0,1,76,0.0,48.0,48.0
0.005,6,10,1689,5,839,1.0,571.0,571.0,5,850,1.0,582.0,582.0
0.008,6,10,1990,5,911,2.0,643.0,643.0,5,1079,2.0,811.0,811.0
0.013,6,10,1762,5,911,3.0,643.0,643.0,5,851,3.0,583.0,583.0
0.005,6,10,2006,5,927,1.0,659.0,659.0,5,1079,1.0,811.0,811.0
0.005,6,10,2006,5,927,1.0,659.0,659.0,5,1079,1.0,811.0,811.0
0.004,6,10,1989,5,927,1.0,659.0,659.0,5,1062,1.0,794.0,794.0
0.005,17,2,230,1,68,0.0,40.0,40.0,1,162,0.0,134.0,134.0
0.004,6,10,1702,5,863,0.0,595.0,595.0,5,839,1.0,571.0,571.0
0.005,6,10,1547,5,764,1.0,496.0,496.0,5,783,1.0,515.0,515.0
0.005,6,10,2006,5,927,1.0,659.0,659.0,5,1079,1.0,811.0,811.0
0.013,6,10,1631,5,848,3.0,580.0,580.0,5,783,3.0,515.0,515.0
0.017,6,10,1990,5,911,4.0,643.0,643.0,5,1079,4.0,811.0,811.0
0.007,6,10,1547,5,764,1.0,496.0,496.0,5,783,1.0,515.0,515.0
300.222,6,27,7436,16,1409,20014.0,217.0,142.0,11,6027,24021.0,1679.0,778.0
0.041,17,2,148,1,60,0.0,32.0,32.0,1,88,0.0,60.0,60.0
0.005,17,2,230,1,68,0.0,40.0,40.0,1,162,0.0,134.0,134.0
0.004,6,10,2006,5,927,1.0,659.0,659.0,5,1079,1.0,811.0,811.0
0.012,6,10,1989,5,910,3.0,642.0,642.0,5,1079,3.0,811.0,811.0
0.004,17,2,148,1,60,0.0,32.0,32.0,1,88,0.0,60.0,60.0
0.019,6,10,1989,5,910,4.0,642.0,642.0,5,1079,4.0,811.0,811.0
0.016,6,10,1989,5,910,3.0,642.0,642.0,5,1079,3.0,811.0,811.0
0.004,6,10,2006,5,927,1.0,659.0,659.0,5,1079,1.0,811.0,811.0
0.004,6,10,1774,5,923,1.0,655.0,655.0,5,851,1.0,583.0,583.0
0.02,6,10,1983,5,910,4.0,642.0,642.0,5,1073,4.0,805.0,805.0
0.008,6,10,1983,5,910,2.0,642.0,642.0,5,1073,2.0,805.0,805.0
0.001,17,2,180,1,66,0.0,38.0,38.0,1,114,0.0,86.0,86.0
0.096,6,10,1506,5,395,19.0,127.0,127.0,5,1111,20.0,843.0,843.0
0.001,17,2,166,1,75,0.0,47.0,47.0,1,91,0.0,63.0,63.0
0.004,6,10,2007,5,928,1.0,660.0,660.0,5,1079,1.0,811.0,811.0
0.008,6,10,1990,5,911,2.0,643.0,643.0,5,1079,2.0,811.0,811.0
0.076,6,10,1506,5,395,16.0,127.0,127.0,5,1111,16.0,843.0,843.0
40.069,17,10,676,5,460,10015.0,104.0,64.0,5,216,10015.0,20.0,15.0
0.006,6,12,1698,6,863,1.0,327.0,271.0,6,835,1.0,515.0,515.0
246.84,6,175,40147,71,25478,3526.0,2883.0,544.0,104,14669,2396.0,1402.0,156.0
0.006,6,10,2000,5,927,1.0,659.0,659.0,5,1073,1.0,805.0,805.0
309.342,17,20,1124,10,716,34364.0,48.0,43.0,10,408,34364.0,20.0,12.0
0.105,6,10,1506,5,395,24.0,127.0,127.0,5,1111,24.0,843.0,843.0
0.004,17,4,284,2,120,0.0,32.0,32.0,2,164,0.0,60.0,54.0
0.005,17,2,169,1,62,0.0,34.0,34.0,1,107,0.0,79.0,79.0
0.082,6,10,1506,5,395,16.0,127.0,127.0,5,1111,19.0,843.0,843.0
0.031,17,2,225,1,65,0.0,37.0,37.0,1,160,0.0,132.0,132.0
0.085,6,10,1506,5,395,19.0,127.0,127.0,5,1111,19.0,843.0,843.0
0.005,6,10,1643,5,860,1.0,592.0,592.0,5,783,1.0,515.0,515.0
0.016,6,10,1762,5,911,4.0,643.0,643.0,5,851,3.0,583.0,583.0
0.006,6,10,1689,5,839,1.0,571.0,571.0,5,850,1.0,582.0,582.0
243.201,6,24,8592,10,2075,27022.0,1495.0,779.0,14,6517,18707.0,2804.0,642.0
0.004,17,2,136,1,60,0.0,32.0,32.0,1,76,0.0,48.0,48.0
0.001,17,2,180,1,66,0.0,38.0,38.0,1,114,0.0,86.0,86.0
0.007,6,10,1989,5,910,1.0,642.0,642.0,5,1079,1.0,811.0,811.0
0.004,6,10,1779,5,928,1.0,660.0,660.0,5,851,1.0,583.0,583.0
0.112,6,10,1506,5,395,26.0,127.0,127.0,5,1111,26.0,843.0,843.0
0.012,6,10,1989,5,910,2.0,642.0,642.0,5,1079,3.0,811.0,811.0
0.007,17,2,140,1,62,0.0,34.0,34.0,1,78,0.0,50.0,50.0
1796.243,6,243,35755,151,25972,11974.0,302.0,302.0,92,9783,19738.0,102.0,83.0
309.232,17,19,1084,10,716,34346.0,48.0,43.0,9,368,38638.0,20.0,12.0
0.005,17,2,230,1,68,0.0,40.0,40.0,1,162,0.0,134.0,134.0
0.005,6,10,1989,5,927,1.0,659.0,659.0,5,1062,1.0,794.0,794.0
0.005,6,10,2006,5,927,1.0,659.0,659.0,5,1079,1.0,811.0,811.0
0.013,6,10,1989,5,910,3.0,642.0,642.0,5,1079,3.0,811.0,811.0
0.005,6,10,1689,5,839,1.0,571.0,571.0,5,850,1.0,582.0,582.0
0.004,6,10,1779,5,928,1.0,660.0,660.0,5,851,1.0,583.0,583.0
0.037,17,4,284,2,120,0.0,32.0,32.0,2,164,33.0,60.0,54.0
0.004,6,10,1779,5,928,1.0,660.0,660.0,5,851,1.0,583.0,583.0
0.005,17,2,144,1,64,0.0,36.0,36.0,1,80,0.0,52.0,52.0
0.012,6,10,1983,5,910,2.0,642.0,642.0,5,1073,3.0,805.0,805.0
0.211,6,16,2669,8,1395,30.0,533.0,323.0,8,1274,19.0,529.0,212.0
0.006,17,2,170,1,65,0.0,37.0,37.0,1,105,0.0,77.0,77.0
0.001,17,2,180,1,66,0.0,38.0,38.0,1,114,0.0,86.0,86.0
0.012,6,10,1989,5,910,3.0,642.0,642.0,5,1079,2.0,811.0,811.0
0.106,6,10,1506,5,395,25.0,127.0,127.0,5,1111,24.0,843.0,843.0
0.005,17,2,169,1,62,0.0,34.0,34.0,1,107,0.0,79.0,79.0
0.007,6,13,3747,7,509,1.0,137.0,137.0,6,3238,1.0,1470.0,1459.0
0.004,6,10,2006,5,927,1.0,659.0,659.0,5,1079,1.0,811.0,811.0
0.011,6,10,1990,5,911,2.0,643.0,643.0,5,1079,2.0,811.0,811.0
1798.536,6,241,46459,115,33878,15776.0,2472.0,961.0,126,12581,14388.0,580.0,62.0
0.005,6,14,3799,7,509,0.0,137.0,137.0,7,3290,0.0,1448.0,972.0
300.022,6,12,1782,7,1348,50003.0,494.0,494.0,5,434,75004.0,83.0,83.0
0.004,6,10,2006,5,927,1.0,659.0,659.0,5,1079,1.0,811.0,811.0
0.011,6,10,1989,5,910,2.0,642.0,642.0,5,1079,2.0,811.0,811.0
0.005,6,14,3742,7,452,0.0,80.0,80.0,7,3290,0.0,1448.0,972.0
0.105,6,10,1506,5,395,20.0,127.0,127.0,5,1111,23.0,843.0,843.0
0.129,6,10,1506,5,395,28.0,127.0,127.0,5,1111,28.0,843.0,843.0
0.006,17,2,148,1,60,0.0,32.0,32.0,1,88,0.0,60.0,60.0
0.006,6,10,1547,5,764,1.0,496.0,496.0,5,783,1.0,515.0,515.0
0.09,6,10,1506,5,395,20.0,127.0,127.0,5,1111,19.0,843.0,843.0
0.006,6,10,1689,5,839,1.0,571.0,571.0,5,850,1.0,582.0,582.0
0.02,6,10,1972,5,910,5.0,642.0,642.0,5,1062,5.0,794.0,794.0
0.005,6,10,1689,5,839,1.0,571.0,571.0,5,850,1.0,582.0,582.0
0.016,6,10,1989,5,910,4.0,642.0,642.0,5,1079,3.0,811.0,811.0
0.005,17,2,166,1,75,0.0,47.0,47.0,1,91,0.0,63.0,63.0
0.01,6,10,1631,5,848,2.0,580.0,580.0,5,783,2.0,515.0,515.0
0.012,6,10,1990,5,911,3.0,643.0,643.0,5,1079,3.0,811.0,811.0
0.068,17,8,3613,4,1874,22.0,1350.0,440.0,4,1739,11.0,1350.0,406.0
0.006,6,10,1989,5,927,1.0,659.0,659.0,5,1062,1.0,794.0,794.0
0.013,6,10,1631,5,848,3.0,580.0,580.0,5,783,3.0,515.0,515.0
11.17,17,28,4423,14,1995,846.0,270.0,114.0,14,2428,846.0,587.0,145.0
0.186,17,4,352,2,130,144.0,37.0,37.0,2,222,148.0,89.0,83.0
0.013,6,10,1989,5,910,3.0,642.0,642.0,5,1079,3.0,811.0,811.0
0.007,6,10,1547,5,764,1.0,496.0,496.0,5,783,1.0,515.0,515.0
0.127,17,2,80,1,32,0.0,4.0,4.0,1,48,0.0,20.0,20.0
0.004,6,10,2007,5,928,1.0,660.0,660.0,5,1079,1.0,811.0,811.0
0.005,6,10,1854,5,889,1.0,621.0,621.0,5,965,1.0,697.0,697.0
15.073,17,14,9190,8,6902,2149.0,1350.0,834.0,6,2288,3008.0,1350.0,353.0
327.989,17,19,1084,10,716,36430.0,48.0,43.0,9,368,40983.0,20.0,12.0
0.012,6,10,1983,5,910,2.0,642.0,642.0,5,1073,3.0,805.0,805.0
0.014,6,10,1989,5,910,3.0,642.0,642.0,5,1079,3.0,811.0,811.0
0.001,17,2,136,1,60,0.0,32.0,32.0,1,76,0.0,48.0,48.0
0.005,17,2,170,1,65,0.0,37.0,37.0,1,105,0.0,77.0,77.0
0.005,6,10,2006,5,927,1.0,659.0,659.0,5,1079,1.0,811.0,811.0
0.005,17,2,212,1,74,0.0,46.0,46.0,1,138,0.0,110.0,110.0
1792.725,6,483,98653,242,87423,7438.0,421.0,368.0,241,11230,7469.0,53.0,53.0
0.004,17,2,148,1,60,0.0,32.0,32.0,1,88,0.0,60.0,60.0
0.004,17,2,148,1,60,0.0,32.0,32.0,1,88,0.0,60.0,60.0
0.005,6,14,3742,7,452,0.0,80.0,80.0,7,3290,0.0,1448.0,972.0
0.079,6,10,1506,5,395,17.0,127.0,127.0,5,1111,15.0,843.0,843.0
0.01,6,10,1989,5,910,2.0,642.0,642.0,5,1079,2.0,811.0,811.0
0.043,6,10,1989,5,910,10.0,642.0,642.0,5,1079,10.0,811.0,811.0
0.016,6,10,1631,5,848,4.0,580.0,580.0,5,783,4.0,515.0,515.0
0.007,6,10,1643,5,860,1.0,592.0,592.0,5,783,1.0,515.0,515.0
0.009,6,10,2000,5,927,2.0,659.0,659.0,5,1073,2.0,805.0,805.0
0.005,17,2,170,1,65,0.0,37.0,37.0,1,105,0.0,77.0,77.0
0.003,17,4,284,2,120,0.0,32.0,32.0,2,164,0.0,60.0,54.0
0.013,17,2,152,1,56,0.0,28.0,28.0,1,96,0.0,68.0,68.0
6.11,6,38,25524,18,15988,359.0,2804.0,2149.0,20,9536,314.0,1402.0,1212.0
40.06,17,10,676,5,460,10014.0,104.0,64.0,5,216,10014.0,20.0,15.0
0.004,6,10,1989,5,927,1.0,659.0,659.0,5,1062,1.0,794.0,794.0
0.006,17,2,180,1,66,0.0,38.0,38.0,1,114,0.0,86.0,86.0
240.439,6,36,10038,18,1883,14141.0,555.0,187.0,18,8155,14141.0,1402.0,601.0
0.08,6,10,1506,5,395,16.0,127.0,127.0,5,1111,16.0,843.0,843.0
0.009,6,10,1989,5,910,2.0,642.0,642.0,5,1079,2.0,811.0,811.0
40.089,17,10,676,5,460,10020.0,104.0,64.0,5,216,10017.0,20.0,15.0
0.013,6,10,1990,5,911,3.0,643.0,643.0,5,1079,3.0,811.0,811.0
0.037,17,2,234,1,61,0.0,33.0,33.0,1,173,0.0,145.0,145.0
40.076,17,10,676,5,460,10018.0,104.0,64.0,5,216,10018.0,20.0,15.0
0.004,6,10,1779,5,928,1.0,660.0,660.0,5,851,1.0,583.0,583.0
0.011,6,10,1983,5,910,2.0,642.0,642.0,5,1073,2.0,805.0,805.0
0.014,6,10,1983,5,910,3.0,642.0,642.0,5,1073,3.0,805.0,805.0
0.003,17,2,136,1,60,0.0,32.0,32.0,1,76,0.0,48.0,48.0
308.254,17,20,1124,10,716,34243.0,48.0,43.0,10,408,34241.0,20.0,12.0
40.057,17,10,676,5,460,10012.0,104.0,64.0,5,216,10013.0,20.0,15.0
0.072,17,4,352,2,130,0.0,37.0,37.0,2,222,32.0,89.0,83.0
0.016,6,10,1989,5,910,3.0,642.0,642.0,5,1079,4.0,811.0,811.0
0.006,6,10,1547,5,764,1.0,496.0,496.0,5,783,1.0,515.0,515.0
0.101,6,10,1506,5,395,22.0,127.0,127.0,5,1111,22.0,843.0,843.0
0.014,6,10,2006,5,927,3.0,659.0,659.0,5,1079,3.0,811.0,811.0
0.005,6,10,2006,5,927,1.0,659.0,659.0,5,1079,1.0,811.0,811.0
0.011,6,10,1983,5,910,2.0,642.0,642.0,5,1073,2.0,805.0,805.0
0.071,17,2,144,1,64,0.0,36.0,36.0,1,80,0.0,52.0,52.0
0.012,6,10,1972,5,910,2.0,642.0,642.0,5,1062,2.0,794.0,794.0
0.005,6,10,2006,5,927,1.0,659.0,659.0,5,1079,1.0,811.0,811.0
0.014,6,10,1972,5,910,3.0,642.0,642.0,5,1062,3.0,794.0,794.0
0.076,6,10,1506,5,395,17.0,127.0,127.0,5,1111,17.0,843.0,843.0
0.001,17,2,136,1,60,0.0,32.0,32.0,1,76,0.0,48.0,48.0
0.087,6,10,1506,5,395,20.0,127.0,127.0,5,1111,20.0,843.0,843.0
0.005,6,10,2006,5,927,1.0,659.0,659.0,5,1079,1.0,811.0,811.0
0.002,17,2,174,1,72,0.0,44.0,44.0,1,102,0.0,74.0,74.0
0.005,6,13,3747,7,509,0.0,137.0,137.0,6,3238,1.0,1470.0,1459.0
0.004,17,2,194,1,59,0.0,31.0,31.0,1,135,0.0,107.0,107.0
0.014,6,10,1989,5,910,3.0,642.0,642.0,5,1079,3.0,811.0,811.0
0.044,17,2,148,1,60,0.0,32.0,32.0,1,88,0.0,60.0,60.0
0.052,17,2,152,1,76,0.0,48.0,48.0,1,76,0.0,48.0,48.0
0.005,17,2,214,1,75,0.0,47.0,47.0,1,139,0.0,111.0,111.0
0.132,6,10,1506,5,395,29.0,127.0,127.0,5,1111,28.0,843.0,843.0
0.012,6,10,1989,5,910,3.0,642.0,642.0,5,1079,2.0,811.0,811.0
0.013,6,10,1983,5,910,3.0,642.0,642.0,5,1073,3.0,805.0,805.0
0.125,6,10,1506,5,395,29.0,127.0,127.0,5,1111,30.0,843.0,843.0
0.066,6,10,1506,5,395,15.0,127.0,127.0,5,1111,14.0,843.0,843.0
0.017,6,10,1989,5,910,4.0,642.0,642.0,5,1079,4.0,811.0,811.0
0.015,6,10,1762,5,911,3.0,643.0,643.0,5,851,3.0,583.0,583.0
0.081,6,10,1506,5,395,17.0,127.0,127.0,5,1111,18.0,843.0,843.0
0.006,6,10,1774,5,923,1.0,655.0,655.0,5,851,1.0,583.0,583.0
0.014,6,10,1990,5,911,3.0,643.0,643.0,5,1079,3.0,811.0,811.0
40.057,17,10,676,5,460,10013.0,104.0,64.0,5,216,10013.0,20.0,15.0
0.017,6,10,1990,5,911,4.0,643.0,643.0,5,1079,4.0,811.0,811.0
1774.763,6,303,53784,124,34065,14427.0,2720.0,296.0,179,19719,9969.0,1360.0,149.0
40.055,17,10,676,5,460,10012.0,104.0,64.0,5,216,10013.0,20.0,15.0
0.105,6,10,1506,5,395,25.0,127.0,127.0,5,1111,24.0,843.0,843.0
0.005,6,10,1689,5,839,1.0,571.0,571.0,5,850,1.0,582.0,582.0
0.005,6,10,2007,5,928,1.0,660.0,660.0,5,1079,1.0,811.0,811.0
0.02,6,19,9922,11,704,1.0,124.0,124.0,8,9218,2.0,3002.0,2198.0
0.004,17,2,148,1,60,0.0,32.0,32.0,1,88,0.0,60.0,60.0
0.006,17,2,179,1,71,0.0,43.0,43.0,1,108,0.0,80.0,80.0
0.005,6,10,1689,5,839,1.0,571.0,571.0,5,850,1.0,582.0,582.0
0.004,6,10,2007,5,928,1.0,660.0,660.0,5,1079,1.0,811.0,811.0
0.121,6,10,1506,5,395,25.0,127.0,127.0,5,1111,28.0,843.0,843.0
0.024,6,10,1762,5,911,5.0,643.0,643.0,5,851,6.0,583.0,583.0
0.018,6,10,1972,5,910,4.0,642.0,642.0,5,1062,4.0,794.0,794.0
0.005,6,10,2006,5,927,1.0,659.0,659.0,5,1079,1.0,811.0,811.0
40.057,17,10,676,5,460,10013.0,104.0,64.0,5,216,10013.0,20.0,15.0
0.001,17,2,136,1,60,0.0,32.0,32.0,1,76,0.0,48.0,48.0
0.01,6,10,1989,5,910,2.0,642.0,642.0,5,1079,2.0,811.0,811.0
0.061,6,10,1506,5,395,13.0,127.0,127.0,5,1111,13.0,843.0,843.0
0.006,17,2,140,1,62,0.0,34.0,34.0,1,78,0.0,50.0,50.0
0.037,17,2,136,1,60,0.0,32.0,32.0,1,76,0.0,48.0,48.0
0.015,6,10,1631,5,848,3.0,580.0,580.0,5,783,3.0,515.0,515.0
0.006,6,10,2006,5,927,1.0,659.0,659.0,5,1079,1.0,811.0,811.0
0.004,6,10,2006,5,927,1.0,659.0,659.0,5,1079,1.0,811.0,811.0
0.004,17,2,136,1,60,0.0,32.0,32.0,1,76,0.0,48.0,48.0
0.005,6,10,2006,5,927,1.0,659.0,659.0,5,1079,1.0,811.0,811.0
0.069,6,10,1506,5,395,14.0,127.0,127.0,5,1111,15.0,843.0,843.0
0.131,17,4,352,2,130,1.0,37.0,37.0,2,222,59.0,89.0,83.0
0.054,17,2,152,1,76,0.0,48.0,48.0,1,76,0.0,48.0,48.0
0.012,6,10,1990,5,911,3.0,643.0,643.0,5,1079,2.0,811.0,811.0
1777.619,17,144,45504,72,22752,25036.0,288.0,288.0,72,22752,25036.0,288.0,288.0
0.005,17,2,170,1,65,0.0,37.0,37.0,1,105,0.0,77.0,77.0
0.026,6,10,1989,5,910,6.0,642.0,642.0,5,1079,6.0,811.0,811.0
1756.743,6,567,191523,285,164535,6185.0,2883.0,941.0,282,26988,6251.0,580.0,120.0
0.013,6,10,1989,5,910,3.0,642.0,642.0,5,1079,3.0,811.0,811.0
0.008,6,10,1989,5,910,2.0,642.0,642.0,5,1079,2.0,811.0,811.0
0.011,6,10,1972,5,910,2.0,642.0,642.0,5,1062,2.0,794.0,794.0
0.008,6,10,1990,5,911,2.0,643.0,643.0,5,1079,2.0,811.0,811.0
0.004,17,2,148,1,60,0.0,32.0,32.0,1,88,0.0,60.0,60.0
0.005,17,2,178,1,81,0.0,53.0,53.0,1,97,0.0,69.0,69.0
0.074,6,10,1506,5,395,17.0,127.0,127.0,5,1111,15.0,843.0,843.0
40.057,17,10,676,5,460,10013.0,104.0,64.0,5,216,10012.0,20.0,15.0
0.121,17,2,179,1,71,0.0,43.0,43.0,1,108,0.0,80.0,80.0
173.111,17,84,12061,42,2806,4222.0,44.0,38.0,42,9255,4222.0,279.0,192.0
40.072,17,10,676,5,460,10017.0,104.0,64.0,5,216,10017.0,20.0,15.0
0.016,17,2,138,1,61,0.0,33.0,33.0,1,77,0.0,49.0,49.0
0.014,6,10,1972,5,910,3.0,642.0,642.0,5,1062,3.0,794.0,794.0
0.006,17,2,214,1,75,0.0,47.0,47.0,1,139,0.0,111.0,111.0
369.528,6,22,2313,16,867,24635.0,195.0,195.0,6,1446,4677.0,419.0,398.0
40.064,17,10,676,5,460,10013.0,104.0,64.0,5,216,10014.0,20.0,15.0
0.006,17,2,222,1,65,0.0,37.0,37.0,1,157,0.0,129.0,129.0
0.103,6,10,1506,5,395,21.0,127.0,127.0,5,1111,21.0,843.0,843.0
0.013,6,10,1983,5,910,3.0,642.0,642.0,5,1073,3.0,805.0,805.0
0.071,17,2,136,1,60,0.0,32.0,32.0,1,76,0.0,48.0,48.0
0.005,6,10,2007,5,928,1.0,660.0,660.0,5,1079,1.0,811.0,811.0
0.004,6,10,1989,5,927,1.0,659.0,659.0,5,1062,1.0,794.0,794.0
0.009,6,10,1762,5,911,2.0,643.0,643.0,5,851,2.0,583.0,583.0
0.019,6,10,1972,5,910,4.0,642.0,642.0,5,1062,4.0,794.0,794.0
0.028,6,10,1989,5,910,6.0,642.0,642.0,5,1079,7.0,811.0,811.0
40.048,17,10,676,5,460,10008.0,104.0,64.0,5,216,10010.0,20.0,15.0
0.005,6,10,1989,5,927,1.0,659.0,659.0,5,1062,1.0,794.0,794.0
0.001,17,2,142,1,63,0.0,35.0,35.0,1,79,0.0,51.0,51.0
0.004,6,10,2007,5,928,1.0,660.0,660.0,5,1079,1.0,811.0,811.0
0.107,6,10,1506,5,395,22.0,127.0,127.0,5,1111,24.0,843.0,843.0
0.014,6,10,1631,5,848,3.0,580.0,580.0,5,783,3.0,515.0,515.0
0.005,6,10,2007,5,928,1.0,660.0,660.0,5,1079,1.0,811.0,811.0
0.012,6,10,1631,5,848,3.0,580.0,580.0,5,783,3.0,515.0,515.0
0.005,6,10,2006,5,927,1.0,659.0,659.0,5,1079,1.0,811.0,811.0
258.835,6,10,839,5,488,64708.0,232.0,232.0,5,351,64708.0,83.0,83.0
0.005,6,10,2000,5,927,1.0,659.0,659.0,5,1073,1.0,805.0,805.0
0.019,6,10,1989,5,910,4.0,642.0,642.0,5,1079,4.0,811.0,811.0
0.004,6,10,1774,5,923,1.0,655.0,655.0,5,851,1.0,583.0,583.0
0.029,6,10,1972,5,910,7.0,642.0,642.0,5,1062,7.0,794.0,794.0
0.004,6,10,2007,5,928,1.0,660.0,660.0,5,1079,1.0,811.0,811.0
0.005,6,10,1774,5,923,1.0,655.0,655.0,5,851,1.0,583.0,583.0
0.006,17,2,275,1,67,0.0,39.0,39.0,1,208,0.0,180.0,180.0
0.005,17,2,179,1,71,0.0,43.0,43.0,1,108,0.0,80.0,80.0
0.064,17,2,152,1,76,0.0,48.0,48.0,1,76,0.0,48.0,48.0
0.005,6,10,2006,5,927,1.0,659.0,659.0,5,1079,1.0,811.0,811.0
0.164,17,2,152,1,76,0.0,48.0,48.0,1,76,0.0,48.0,48.0
0.005,6,10,2007,5,928,1.0,660.0,660.0,5,1079,1.0,811.0,811.0
0.08,6,10,1506,5,395,17.0,127.0,127.0,5,1111,17.0,843.0,843.0
0.004,6,10,1702,5,863,1.0,595.0,595.0,5,839,1.0,571.0,571.0
0.007,6,10,1547,5,764,1.0,496.0,496.0,5,783,1.0,515.0,515.0
0.012,6,10,1972,5,910,3.0,642.0,642.0,5,1062,3.0,794.0,794.0
0.005,6,10,1989,5,927,1.0,659.0,659.0,5,1062,1.0,794.0,794.0
0.012,6,10,1990,5,911,3.0,643.0,643.0,5,1079,3.0,811.0,811.0
0.072,6,10,1506,5,395,16.0,127.0,127.0,5,1111,15.0,843.0,843.0
0.004,17,4,284,2,120,1.0,32.0,32.0,2,164,0.0,60.0,54.0
0.006,6,10,1547,5,764,1.0,496.0,496.0,5,783,1.0,515.0,515.0
0.008,6,10,1989,5,910,2.0,642.0,642.0,5,1079,2.0,811.0,811.0
0.089,6,10,1506,5,395,19.0,127.0,127.0,5,1111,20.0,843.0,843.0
0.008,6,10,2006,5,927,1.0,659.0,659.0,5,1079,2.0,811.0,811.0
0.092,6,10,1506,5,395,20.0,127.0,127.0,5,1111,21.0,843.0,843.0
0.007,6,10,1547,5,764,1.0,496.0,496.0,5,783,1.0,515.0,515.0
0.005,6,10,1702,5,863,1.0,595.0,595.0,5,839,1.0,571.0,571.0
0.011,6,13,3735,7,497,1.0,125.0,125.0,6,3238,2.0,1470.0,1459.0
0.011,6,10,1983,5,910,2.0,642.0,642.0,5,1073,2.0,805.0,805.0
0.009,6,10,1972,5,910,2.0,642.0,642.0,5,1062,2.0,794.0,794.0
0.011,6,10,1677,5,827,2.0,559.0,559.0,5,850,2.0,582.0,582.0
0.009,6,10,1989,5,910,2.0,642.0,642.0,5,1079,2.0,811.0,811.0
0.004,17,2,148,1,60,0.0,32.0,32.0,1,88,0.0,60.0,60.0
0.012,6,10,1989,5,910,3.0,642.0,642.0,5,1079,2.0,811.0,811.0
11.419,17,29,4564,15,2165,804.0,268.0,116.0,14,2399,866.0,586.0,143.0
0.1,6,10,1506,5,395,24.0,127.0,127.0,5,1111,24.0,843.0,843.0
0.012,6,10,1989,5,910,3.0,642.0,642.0,5,1079,3.0,811.0,811.0
0.021,6,10,1983,5,910,5.0,642.0,642.0,5,1073,5.0,805.0,805.0
173.281,17,78,11041,39,2608,4559.0,44.0,38.0,39,8433,4559.0,239.0,188.0
0.04,17,2,152,1,76,0.0,48.0,48.0,1,76,0.0,48.0,48.0
0.073,6,10,1506,5,395,16.0,127.0,127.0,5,1111,17.0,843.0,843.0
0.005,6,10,2006,5,927,1.0,659.0,659.0,5,1079,1.0,811.0,811.0
0.005,6,10,1643,5,860,1.0,592.0,592.0,5,783,1.0,515.0,515.0
44.227,6,47,17888,24,11941,393.0,2720.0,1216.0,23,5947,2002.0,2667.0,385.0
0.003,17,2,148,1,60,0.0,32.0,32.0,1,88,0.0,60.0,60.0
0.04,17,2,186,1,61,0.0,33.0,33.0,1,125,0.0,97.0,97.0
0.005,6,10,1989,5,927,1.0,659.0,659.0,5,1062,1.0,794.0,794.0
0.006,6,10,1643,5,860,1.0,592.0,592.0,5,783,1.0,515.0,515.0
0.012,6,10,1989,5,910,2.0,642.0,642.0,5,1079,3.0,811.0,811.0
0.012,6,10,1631,5,848,2.0,580.0,580.0,5,783,3.0,515.0,515.0
0.004,17,2,136,1,60,0.0,32.0,32.0,1,76,0.0,48.0,48.0
0.089,6,10,1506,5,395,19.0,127.0,127.0,5,1111,20.0,843.0,843.0
0.005,6,10,2006,5,927,1.0,659.0,659.0,5,1079,1.0,811.0,811.0
181.069,6,32,18644,18,12627,54.0,2720.0,1319.0,14,6017,13915.0,2720.0,907.0
361.758,6,21,1792,16,1030,24117.0,190.0,190.0,5,762,60009.0,461.0,247.0
0.017,6,10,1631,5,848,4.0,580.0,580.0,5,783,4.0,515.0,515.0
0.126,17,4,596,2,122,0.0,33.0,33.0,2,474,87.0,323.0,209.0
0.089,6,10,1506,5,395,19.0,127.0,127.0,5,1111,20.0,843.0,843.0
0.005,6,10,2000,5,927,1.0,659.0,659.0,5,1073,1.0,805.0,805.0
0.118,6,10,1506,5,395,24.0,127.0,127.0,5,1111,24.0,843.0,843.0
0.015,6,10,1762,5,911,3.0,643.0,643.0,5,851,3.0,583.0,583.0
0.093,6,10,1506,5,395,20.0,127.0,127.0,5,1111,20.0,843.0,843.0
0.005,17,2,170,1,65,0.0,37.0,37.0,1,105,0.0,77.0,77.0
0.005,6,10,2006,5,927,1.0,659.0,659.0,5,1079,1.0,811.0,811.0
0.006,6,10,1547,5,764,1.0,496.0,496.0,5,783,1.0,515.0,515.0
0.007,17,2,194,1,59,0.0,31.0,31.0,1,135,0.0,107.0,107.0
0.229,6,10,1506,5,395,55.0,127.0,127.0,5,1111,41.0,843.0,843.0
1729.244,6,60,4400,40,2740,44339.0,33.0,33.0,20,1660,91003.0,31.0,31.0
0.009,6,10,1762,5,911,2.0,643.0,643.0,5,851,2.0,583.0,583.0
40.059,17,10,676,5,460,10012.0,104.0,64.0,5,216,10013.0,20.0,15.0
0.012,6,10,1972,5,910,3.0,642.0,642.0,5,1062,2.0,794.0,794.0
0.021,6,10,1972,5,910,5.0,642.0,642.0,5,1062,5.0,794.0,794.0
0.149,6,10,1506,5,395,32.0,127.0,127.0,5,1111,32.0,843.0,843.0
0.004,6,10,2006,5,927,1.0,659.0,659.0,5,1079,1.0,811.0,811.0
0.014,6,10,1983,5,910,3.0,642.0,642.0,5,1073,3.0,805.0,805.0
0.006,6,14,3736,7,446,1.0,74.0,74.0,7,3290,0.0,1448.0,972.0
0.006,6,10,1547,5,764,1.0,496.0,496.0,5,783,1.0,515.0,515.0
0.009,6,10,1762,5,911,2.0,643.0,643.0,5,851,2.0,583.0,583.0
0.116,6,10,1506,5,395,26.0,127.0,127.0,5,1111,18.0,843.0,843.0
0.003,17,2,136,1,60,0.0,32.0,32.0,1,76,0.0,48.0,48.0
0.005,6,10,1989,5,927,1.0,659.0,659.0,5,1062,1.0,794.0,794.0
0.005,6,10,2006,5,927,1.0,659.0,659.0,5,1079,1.0,811.0,811.0
0.01,6,10,1989,5,910,2.0,642.0,642.0,5,1079,2.0,811.0,811.0
0.814,6,10,2009,6,1655,162.0,1403.0,1403.0,4,354,194.0,182.0,182.0
0.005,6,14,3912,7,622,0.0,250.0,250.0,7,3290,0.0,1448.0,972.0
0.004,6,10,1989,5,927,1.0,659.0,659.0,5,1062,1.0,794.0,794.0
0.006,6,10,2006,5,927,1.0,659.0,659.0,5,1079,1.0,811.0,811.0
0.005,6,10,1989,5,927,1.0,659.0,659.0,5,1062,1.0,794.0,794.0
152.317,6,26,9525,12,1627,82.0,794.0,367.0,14,7898,11706.0,1360.0,732.0
0.004,17,2,154,1,69,0.0,41.0,41.0,1,85,0.0,57.0,57.0
0.004,17,2,148,1,60,0.0,32.0,32.0,1,88,0.0,60.0,60.0
15.081,17,15,8464,8,6410,2150.0,1350.0,773.0,7,2054,2508.0,1350.0,265.0
0.005,17,2,170,1,65,0.0,37.0,37.0,1,105,0.0,77.0,77.0
0.003,17,2,186,1,61,0.0,33.0,33.0,1,125,0.0,97.0,97.0
0.009,6,10,1762,5,911,2.0,643.0,643.0,5,851,2.0,583.0,583.0
0.041,17,2,182,1,65,0.0,37.0,37.0,1,117,0.0,89.0,89.0
240.019,6,9,787,5,488,60004.0,232.0,232.0,4,299,80005.0,83.0,83.0
0.007,17,2,179,1,71,0.0,43.0,43.0,1,108,0.0,80.0,80.0
0.005,6,10,2007,5,928,1.0,660.0,660.0,5,1079,1.0,811.0,811.0
0.005,6,10,1989,5,927,1.0,659.0,659.0,5,1062,1.0,794.0,794.0
0.005,6,10,1989,5,927,1.0,659.0,659.0,5,1062,1.0,794.0,794.0
0.15,6,10,1506,5,395,36.0,127.0,127.0,5,1111,31.0,843.0,843.0
0.005,17,2,180,1,66,0.0,38.0,38.0,1,114,0.0,86.0,86.0
0.079,6,10,1506,5,395,18.0,127.0,127.0,5,1111,18.0,843.0,843.0
0.015,6,10,1677,5,827,3.0,559.0,559.0,5,850,3.0,582.0,582.0
0.017,6,10,1989,5,910,4.0,642.0,642.0,5,1079,4.0,811.0,811.0
0.006,6,10,1547,5,764,1.0,496.0,496.0,5,783,1.0,515.0,515.0
0.005,6,10,1989,5,927,1.0,659.0,659.0,5,1062,1.0,794.0,794.0
0.008,6,10,1631,5,848,2.0,580.0,580.0,5,783,1.0,515.0,515.0
0.008,6,10,2006,5,927,2.0,659.0,659.0,5,1079,1.0,811.0,811.0
240.09,6,16,4481,9,963,30011.0,238.0,166.0,7,3518,40014.0,1402.0,786.0
0.075,17,8,3613,4,1874,25.0,1350.0,440.0,4,1739,12.0,1350.0,406.0
0.016,6,10,1989,5,910,3.0,642.0,642.0,5,1079,4.0,811.0,811.0
0.09,6,10,1506,5,395,19.0,127.0,127.0,5,1111,19.0,843.0,843.0
0.005,17,2,170,1,65,0.0,37.0,37.0,1,105,0.0,77.0,77.0
172.068,17,70,9991,35,2344,5060.0,44.0,38.0,35,7647,5060.0,261.0,190.0
0.014,6,10,1990,5,911,3.0,643.0,643.0,5,1079,3.0,811.0,811.0
0.005,6,14,3799,7,509,0.0,137.0,137.0,7,3290,0.0,1448.0,972.0
0.004,6,10,2007,5,928,1.0,660.0,660.0,5,1079,1.0,811.0,811.0
0.011,6,10,1983,5,910,2.0,642.0,642.0,5,1073,2.0,805.0,805.0
0.114,6,10,1506,5,395,23.0,127.0,127.0,5,1111,24.0,843.0,843.0
0.067,6,8,3114,4,2314,22.0,1124.0,1053.0,4,800,20.0,296.0,296.0
0.117,6,10,1506,5,395,27.0,127.0,127.0,5,1111,26.0,843.0,843.0
0.009,6,10,1983,5,910,2.0,642.0,642.0,5,1073,2.0,805.0,805.0
0.013,6,10,1990,5,911,3.0,643.0,643.0,5,1079,3.0,811.0,811.0
0.004,6,10,1702,5,863,1.0,595.0,595.0,5,839,0.0,571.0,571.0
0.114,6,10,1506,5,395,27.0,127.0,127.0,5,1111,26.0,843.0,843.0
0.012,6,13,3735,7,497,2.0,125.0,125.0,6,3238,2.0,1470.0,1459.0
0.006,6,10,1547,5,764,1.0,496.0,496.0,5,783,1.0,515.0,515.0
10.748,17,28,4421,14,1994,818.0,269.0,114.0,14,2427,818.0,586.0,145.0
292.638,6,335,345685,124,18006,2379.0,2736.0,889.0,211,327679,1393.0,2804.0,1615.0
0.006,17,2,164,1,74,0.0,46.0,46.0,1,90,0.0,62.0,62.0
0.008,6,10,1989,5,910,1.0,642.0,642.0,5,1079,1.0,811.0,811.0
0.114,6,10,1506,5,395,24.0,127.0,127.0,5,1111,24.0,843.0,843.0
0.025,6,10,1631,5,848,6.0,580.0,580.0,5,783,6.0,515.0,515.0
0.006,6,10,1547,5,764,1.0,496.0,496.0,5,783,1.0,515.0,515.0
0.165,6,10,1506,5,395,36.0,127.0,127.0,5,1111,39.0,843.0,843.0
0.01,17,4,284,2,120,1.0,32.0,32.0,2,164,0.0,60.0,54.0
0.01,6,14,3787,7,497,1.0,125.0,125.0,7,3290,1.0,1448.0,972.0
0.007,6,10,1989,5,927,1.0,659.0,659.0,5,1062,1.0,794.0,794.0
15.483,17,21,8260,11,6103,1545.0,1350.0,526.0,10,2157,1717.0,1350.0,187.0
0.001,17,2,180,1,66,0.0,38.0,38.0,1,114,0.0,86.0,86.0
0.087,6,10,1506,5,395,18.0,127.0,127.0,5,1111,19.0,843.0,843.0
0.084,6,10,1506,5,395,19.0,127.0,127.0,5,1111,17.0,843.0,843.0
11.082,17,28,4420,14,1994,843.0,269.0,114.0,14,2426,843.0,585.0,145.0
0.001,17,2,136,1,60,0.0,32.0,32.0,1,76,0.0,48.0,48.0
0.004,17,2,148,1,60,0.0,32.0,32.0,1,88,0.0,60.0,60.0
0.006,6,10,1547,5,764,1.0,496.0,496.0,5,783,1.0,515.0,515.0
0.014,6,10,1762,5,911,3.0,643.0,643.0,5,851,3.0,583.0,583.0
0.052,17,2,152,1,76,0.0,48.0,48.0,1,76,0.0,48.0,48.0
240.014,6,9,787,5,488,60003.0,232.0,232.0,4,299,80003.0,83.0,83.0
0.006,6,10,1854,5,889,1.0,621.0,621.0,5,965,1.0,697.0,697.0
0.025,6,10,1983,5,910,6.0,642.0,642.0,5,1073,6.0,805.0,805.0
61.291,6,24,7517,13,1385,5107.0,530.0,277.0,11,6132,6111.0,2720.0,946.0
0.088,6,10,1506,5,395,18.0,127.0,127.0,5,1111,19.0,843.0,843.0
0.009,17,2,294,1,64,0.0,36.0,36.0,1,230,0.0,202.0,202.0
0.004,17,2,136,1,60,0.0,32.0,32.0,1,76,0.0,48.0,48.0
0.008,6,12,1926,6,1189,1.0,659.0,434.0,6,737,1.0,417.0,417.0
0.011,6,10,1631,5,848,2.0,580.0,580.0,5,783,2.0,515.0,515.0
0.011,17,2,169,1,62,0.0,34.0,34.0,1,107,0.0,79.0,79.0
0.001,17,2,180,1,66,0.0,38.0,38.0,1,114,0.0,86.0,86.0
0.016,6,10,1990,5,911,3.0,643.0,643.0,5,1079,3.0,811.0,811.0
0.01,6,10,1762,5,911,2.0,643.0,643.0,5,851,2.0,583.0,583.0
0.004,6,10,2006,5,927,1.0,659.0,659.0,5,1079,1.0,811.0,811.0
240.311,6,41,8667,20,5634,12647.0,2883.0,573.0,21,3033,12015.0,580.0,241.0
0.006,17,2,214,1,75,0.0,47.0,47.0,1,139,0.0,111.0,111.0
15.173,17,42,20318,23,17132,688.0,1350.0,716.0,19,3186,841.0,1350.0,139.0
0.004,6,13,3747,7,509,0.0,137.0,137.0,6,3238,0.0,1470.0,1459.0
0.003,17,2,152,1,76,0.0,48.0,48.0,1,76,0.0,48.0,48.0
0.049,17,2,170,1,65,0.0,37.0,37.0,1,105,0.0,77.0,77.0
0.082,6,10,1506,5,395,19.0,127.0,127.0,5,1111,18.0,843.0,843.0
178.165,17,66,9393,33,2186,5563.0,44.0,38.0,33,7207,5567.0,261.0,190.0
10.914,17,28,4418,14,1994,830.0,269.0,114.0,14,2424,830.0,587.0,145.0
0.004,17,2,136,1,60,0.0,32.0,32.0,1,76,0.0,48.0,48.0
0.013,6,10,1983,5,910,3.0,642.0,642.0,5,1073,3.0,805.0,805.0
0.101,6,10,1506,5,395,23.0,127.0,127.0,5,1111,24.0,843.0,843.0
0.019,6,10,1990,5,911,4.0,643.0,643.0,5,1079,4.0,811.0,811.0
0.001,17,2,180,1,66,0.0,38.0,38.0,1,114,0.0,86.0,86.0
0.012,6,13,3735,7,497,1.0,125.0,125.0,6,3238,2.0,1470.0,1459.0
0.056,17,2,182,1,65,0.0,37.0,37.0,1,117,0.0,89.0,89.0
0.052,17,2,152,1,76,0.0,48.0,48.0,1,76,0.0,48.0,48.0
0.005,6,10,2006,5,927,1.0,659.0,659.0,5,1079,1.0,811.0,811.0
0.006,17,2,140,1,62,0.0,34.0,34.0,1,78,0.0,50.0,50.0
0.004,6,10,1779,5,928,1.0,660.0,660.0,5,851,1.0,583.0,583.0
0.004,6,10,1989,5,927,1.0,659.0,659.0,5,1062,1.0,794.0,794.0
0.011,6,10,1989,5,910,2.0,642.0,642.0,5,1079,2.0,811.0,811.0
0.015,6,10,1972,5,910,3.0,642.0,642.0,5,1062,3.0,794.0,794.0
0.008,6,10,1990,5,911,2.0,643.0,643.0,5,1079,1.0,811.0,811.0
0.013,6,10,1989,5,910,3.0,642.0,642.0,5,1079,3.0,811.0,811.0
300.319,6,16,2170,9,684,37519.0,146.0,146.0,7,1486,50026.0,419.0,398.0
40.065,17,10,676,5,460,10015.0,104.0,64.0,5,216,10015.0,20.0,15.0
0.015,6,10,1972,5,910,3.0,642.0,642.0,5,1062,3.0,794.0,794.0
0.005,6,10,2007,5,928,1.0,660.0,660.0,5,1079,1.0,811.0,811.0
0.004,6,10,2006,5,927,1.0,659.0,659.0,5,1079,1.0,811.0,811.0
0.016,6,10,1989,5,910,3.0,642.0,642.0,5,1079,3.0,811.0,811.0
0.01,6,10,1989,5,910,2.0,642.0,642.0,5,1079,2.0,811.0,811.0
0.018,6,10,1983,5,910,4.0,642.0,642.0,5,1073,4.0,805.0,805.0
0.074,6,10,1506,5,395,16.0,127.0,127.0,5,1111,17.0,843.0,843.0
0.007,17,2,179,1,71,0.0,43.0,43.0,1,108,0.0,80.0,80.0
0.004,17,4,596,2,122,0.0,33.0,33.0,2,474,0.0,323.0,209.0
0.128,6,10,1506,5,395,29.0,127.0,127.0,5,1111,30.0,843.0,843.0
320.601,17,20,1124,10,716,35608.0,48.0,43.0,10,408,35608.0,20.0,12.0
0.005,17,2,214,1,75,0.0,47.0,47.0,1,139,0.0,111.0,111.0
240.089,6,16,4481,9,963,30011.0,238.0,166.0,7,3518,40014.0,1402.0,786.0
0.012,6,10,1677,5,827,3.0,559.0,559.0,5,850,3.0,582.0,582.0
0.094,6,10,1506,5,395,21.0,127.0,127.0,5,1111,18.0,843.0,843.0
0.076,6,10,1506,5,395,16.0,127.0,127.0,5,1111,14.0,843.0,843.0
0.005,6,10,2007,5,928,1.0,660.0,660.0,5,1079,1.0,811.0,811.0
0.083,6,10,1506,5,395,19.0,127.0,127.0,5,1111,18.0,843.0,843.0
0.005,6,10,2006,5,927,1.0,659.0,659.0,5,1079,1.0,811.0,811.0
0.0,17,2,136,1,60,0.0,32.0,32.0,1,76,0.0,48.0,48.0
120.664,6,55,18942,32,4804,3892.0,1053.0,209.0,23,14138,5484.0,2804.0,994.0
0.005,17,2,170,1,65,0.0,37.0,37.0,1,105,0.0,77.0,77.0
0.015,6,10,1990,5,911,3.0,643.0,643.0,5,1079,3.0,811.0,811.0
0.007,6,10,1989,5,910,1.0,642.0,642.0,5,1079,1.0,811.0,811.0
0.04,6,10,1989,5,910,10.0,642.0,642.0,5,1079,10.0,811.0,811.0
0.015,6,10,1990,5,911,3.0,643.0,643.0,5,1079,3.0,811.0,811.0
0.006,6,10,1774,5,923,1.0,655.0,655.0,5,851,1.0,583.0,583.0
0.005,6,10,1774,5,923,1.0,655.0,655.0,5,851,1.0,583.0,583.0
0.013,6,10,1989,5,910,3.0,642.0,642.0,5,1079,3.0,811.0,811.0
300.02,6,12,1782,7,1348,50003.0,494.0,494.0,5,434,75004.0,83.0,83.0
0.096,6,10,1506,5,395,21.0,127.0,127.0,5,1111,21.0,843.0,843.0
0.006,6,10,1547,5,764,1.0,496.0,496.0,5,783,1.0,515.0,515.0
0.005,6,10,1547,5,764,1.0,496.0,496.0,5,783,1.0,515.0,515.0
0.004,17,4,284,2,120,0.0,32.0,32.0,2,164,0.0,60.0,54.0
0.035,17,2,132,1,58,0.0,30.0,30.0,1,74,0.0,46.0,46.0
0.059,17,2,152,1,76,0.0,48.0,48.0,1,76,0.0,48.0,48.0
0.007,6,10,1854,5,889,1.0,621.0,621.0,5,965,1.0,697.0,697.0
0.005,6,10,2007,5,928,1.0,660.0,660.0,5,1079,1.0,811.0,811.0
0.148,6,10,1506,5,395,35.0,127.0,127.0,5,1111,27.0,843.0,843.0
0.09,6,10,1506,5,395,20.0,127.0,127.0,5,1111,20.0,843.0,843.0
368.661,6,22,2313,16,867,24577.0,195.0,195.0,6,1446,4638.0,419.0,398.0
0.006,6,10,1547,5,764,1.0,496.0,496.0,5,783,1.0,515.0,515.0
0.004,6,10,2000,5,927,1.0,659.0,659.0,5,1073,1.0,805.0,805.0
0.003,17,2,136,1,60,0.0,32.0,32.0,1,76,0.0,48.0,48.0
21.986,6,40,14383,20,8785,465.0,2720.0,1325.0,20,5598,1148.0,2667.0,435.0
0.016,6,10,1990,5,911,3.0,643.0,643.0,5,1079,4.0,811.0,811.0
0.005,6,10,1774,5,923,1.0,655.0,655.0,5,851,1.0,583.0,583.0
0.004,6,10,2006,5,927,1.0,659.0,659.0,5,1079,1.0,811.0,811.0
0.017,6,10,1990,5,911,4.0,643.0,643.0,5,1079,4.0,811.0,811.0
0.152,6,10,1506,5,395,31.0,127.0,127.0,5,1111,37.0,843.0,843.0
10.91,17,28,4420,14,1993,831.0,268.0,114.0,14,2427,831.0,586.0,145.0
0.069,6,10,1506,5,395,15.0,127.0,127.0,5,1111,16.0,843.0,843.0
0.005,6,10,1854,5,889,1.0,621.0,621.0,5,965,1.0,697.0,697.0
0.011,6,10,1631,5,848,2.0,580.0,580.0,5,783,2.0,515.0,515.0
0.006,6,10,2007,5,928,1.0,660.0,660.0,5,1079,1.0,811.0,811.0
0.211,17,4,352,2,130,140.0,37.0,37.0,2,222,84.0,89.0,83.0
1792.512,6,484,98587,245,87490,7345.0,421.0,369.0,239,11097,7530.0,53.0,53.0
0.005,6,10,1643,5,860,1.0,592.0,592.0,5,783,1.0,515.0,515.0
0.007,6,10,1983,5,910,1.0,642.0,642.0,5,1073,1.0,805.0,805.0
0.008,6,10,1762,5,911,2.0,643.0,643.0,5,851,2.0,583.0,583.0
0.016,6,10,1983,5,910,4.0,642.0,642.0,5,1073,3.0,805.0,805.0
0.005,6,10,2006,5,927,1.0,659.0,659.0,5,1079,1.0,811.0,811.0
1772.645,17,120,11460,60,5460,30044.0,63.0,63.0,60,6000,30044.0,72.0,72.0
0.226,6,16,2779,8,1397,32.0,533.0,324.0,8,1382,21.0,529.0,239.0
0.009,6,10,1983,5,910,2.0,642.0,642.0,5,1073,2.0,805.0,805.0
0.124,6,10,1506,5,395,29.0,127.0,127.0,5,1111,21.0,843.0,843.0
0.115,6,10,1506,5,395,22.0,127.0,127.0,5,1111,26.0,843.0,843.0
0.014,6,10,1990,5,911,3.0,643.0,643.0,5,1079,3.0,811.0,811.0
0.006,6,10,1643,5,860,1.0,592.0,592.0,5,783,1.0,515.0,515.0
177.185,17,76,10834,38,2530,4788.0,44.0,38.0,38,8304,4788.0,239.0,190.0
293.044,6,319,343949,126,18115,2344.0,2736.0,888.0,193,325834,1526.0,2804.0,1774.0
64.157,6,17,1048,8,504,9165.0,46.0,46.0,9,544,8002.0,46.0,46.0
240.019,6,9,787,5,488,60004.0,232.0,232.0,4,299,80005.0,83.0,83.0
0.01,6,10,1989,5,910,2.0,642.0,642.0,5,1079,2.0,811.0,811.0
366.377,6,22,2313,16,867,24425.0,195.0,195.0,6,1446,4633.0,419.0,398.0
0.007,17,2,299,1,65,0.0,37.0,37.0,1,234,0.0,206.0,206.0
0.005,6,10,2006,5,927,1.0,659.0,659.0,5,1079,1.0,811.0,811.0
0.003,17,2,148,1,60,0.0,32.0,32.0,1,88,0.0,60.0,60.0
0.012,6,10,1989,5,910,2.0,642.0,642.0,5,1079,3.0,811.0,811.0
0.206,6,16,2669,8,1395,29.0,533.0,323.0,8,1274,18.0,529.0,212.0
0.004,17,2,136,1,60,0.0,32.0,32.0,1,76,0.0,48.0,48.0
0.164,6,10,1242,5,751,41.0,495.0,495.0,5,491,36.0,223.0,223.0
0.006,6,10,1689,5,839,1.0,571.0,571.0,5,850,1.0,582.0,582.0
0.011,6,10,1989,5,910,2.0,642.0,642.0,5,1079,2.0,811.0,811.0
0.101,6,10,1506,5,395,21.0,127.0,127.0,5,1111,23.0,843.0,843.0
0.005,6,10,2000,5,927,1.0,659.0,659.0,5,1073,1.0,805.0,805.0
0.004,6,10,2007,5,928,1.0,660.0,660.0,5,1079,1.0,811.0,811.0
0.076,6,10,1506,5,395,16.0,127.0,127.0,5,1111,15.0,843.0,843.0
0.005,17,2,144,1,64,0.0,36.0,36.0,1,80,0.0,52.0,52.0
0.013,6,10,1762,5,911,3.0,643.0,643.0,5,851,3.0,583.0,583.0
10.881,17,28,4423,14,1994,828.0,269.0,114.0,14,2429,828.0,588.0,145.0
0.011,6,10,1989,5,910,2.0,642.0,642.0,5,1079,2.0,811.0,811.0
0.017,17,2,170,1,65,0.0,37.0,37.0,1,105,0.0,77.0,77.0
0.009,6,12,1926,6,1189,1.0,659.0,434.0,6,737,1.0,417.0,417.0
0.005,6,10,2007,5,928,1.0,660.0,660.0,5,1079,1.0,811.0,811.0
15.283,17,17,9518,8,4357,2179.0,1350.0,516.0,9,5161,1906.0,1350.0,545.0
0.008,6,10,1989,5,910,2.0,642.0,642.0,5,1079,1.0,811.0,811.0
0.085,6,10,1506,5,395,19.0,127.0,127.0,5,1111,20.0,843.0,843.0
0.003,6,10,1702,5,863,0.0,595.0,595.0,5,839,0.0,571.0,571.0
0.02,6,10,1989,5,910,4.0,642.0,642.0,5,1079,5.0,811.0,811.0
40.069,17,10,676,5,460,10016.0,104.0,64.0,5,216,10016.0,20.0,15.0
0.011,6,10,1990,5,911,2.0,643.0,643.0,5,1079,2.0,811.0,811.0
0.016,6,10,1983,5,910,4.0,642.0,642.0,5,1073,4.0,805.0,805.0
0.073,6,10,1506,5,395,16.0,127.0,127.0,5,1111,16.0,843.0,843.0
0.011,6,10,1989,5,910,2.0,642.0,642.0,5,1079,2.0,811.0,811.0
0.043,6,10,1633,6,618,8.0,294.0,294.0,4,1015,9.0,799.0,799.0
0.004,17,2,148,1,60,0.0,32.0,32.0,1,88,0.0,60.0,60.0
0.012,6,10,1989,5,910,2.0,642.0,642.0,5,1079,2.0,811.0,811.0
0.006,6,10,1689,5,839,1.0,571.0,571.0,5,850,1.0,582.0,582.0
0.002,17,2,180,1,66,0.0,38.0,38.0,1,114,0.0,86.0,86.0
10.771,17,28,4422,14,1994,820.0,269.0,114.0,14,2428,820.0,587.0,145.0
0.004,17,4,284,2,120,0.0,32.0,32.0,2,164,0.0,60.0,54.0
0.003,17,2,136,1,60,0.0,32.0,32.0,1,76,0.0,48.0,48.0
0.041,17,4,596,2,122,0.0,33.0,33.0,2,474,4.0,323.0,209.0
378.355,6,20,2210,6,1308,12004.0,494.0,494.0,14,902,29104.0,83.0,83.0
0.005,6,10,2006,5,927,1.0,659.0,659.0,5,1079,1.0,811.0,811.0
0.04,17,2,182,1,65,0.0,37.0,37.0,1,117,0.0,89.0,89.0
0.006,6,10,2000,5,927,1.0,659.0,659.0,5,1073,1.0,805.0,805.0
0.005,6,10,1702,5,863,1.0,595.0,595.0,5,839,1.0,571.0,571.0
37.312,6,24,9313,13,1655,3109.0,794.0,367.0,11,7658,3716.0,1360.0,1029.0
10.996,17,28,4391,14,2312,837.0,587.0,137.0,14,2079,837.0,270.0,120.0
0.005,6,10,1989,5,927,1.0,659.0,659.0,5,1062,1.0,794.0,794.0
0.172,6,3,453,2,321,172.0,241.0,241.0,1,132,0.0,92.0,92.0
0.001,17,2,180,1,66,0.0,38.0,38.0,1,114,0.0,86.0,86.0
0.004,17,2,136,1,60,0.0,32.0,32.0,1,76,0.0,48.0,48.0
300.205,6,16,2170,9,684,37504.0,146.0,146.0,7,1486,50007.0,419.0,398.0
0.004,6,10,1702,5,863,1.0,595.0,595.0,5,839,1.0,571.0,571.0
10.871,17,28,4421,14,1994,827.0,269.0,114.0,14,2427,827.0,586.0,145.0
0.063,17,2,152,1,76,0.0,48.0,48.0,1,76,0.0,48.0,48.0
0.005,17,2,170,1,65,0.0,37.0,37.0,1,105,0.0,77.0,77.0
0.013,6,10,1983,5,910,3.0,642.0,642.0,5,1073,3.0,805.0,805.0
0.001,17,2,166,1,75,0.0,47.0,47.0,1,91,0.0,63.0,63.0
0.001,17,2,180,1,66,0.0,38.0,38.0,1,114,0.0,86.0,86.0
0.006,6,10,1854,5,889,1.0,621.0,621.0,5,965,1.0,697.0,697.0
0.005,17,2,166,1,75,0.0,47.0,47.0,1,91,0.0,63.0,63.0
0.004,17,2,170,1,65,0.0,37.0,37.0,1,105,0.0,77.0,77.0
0.015,6,10,1990,5,911,3.0,643.0,643.0,5,1079,3.0,811.0,811.0
0.005,6,10,2006,5,927,1.0,659.0,659.0,5,1079,1.0,811.0,811.0
0.008,6,10,1972,5,910,2.0,642.0,642.0,5,1062,2.0,794.0,794.0
0.064,6,10,1506,5,395,14.0,127.0,127.0,5,1111,12.0,843.0,843.0
40.082,17,10,676,5,460,10019.0,104.0,64.0,5,216,10019.0,20.0,15.0
0.019,6,10,1972,5,910,4.0,642.0,642.0,5,1062,4.0,794.0,794.0
368.856,6,22,2313,16,867,24590.0,195.0,195.0,6,1446,4638.0,419.0,398.0
0.006,6,10,1854,5,889,1.0,621.0,621.0,5,965,1.0,697.0,697.0
0.112,6,10,1506,5,395,25.0,127.0,127.0,5,1111,26.0,843.0,843.0
0.129,17,2,166,1,75,0.0,47.0,47.0,1,91,0.0,63.0,63.0
0.04,17,2,148,1,60,0.0,32.0,32.0,1,88,0.0,60.0,60.0
0.003,17,2,136,1,60,0.0,32.0,32.0,1,76,0.0,48.0,48.0
40.048,17,10,676,5,460,10011.0,104.0,64.0,5,216,10011.0,20.0,15.0
0.071,17,8,3613,4,1874,23.0,1350.0,440.0,4,1739,12.0,1350.0,406.0
0.001,17,2,136,1,60,0.0,32.0,32.0,1,76,0.0,48.0,48.0
0.008,6,10,1989,5,910,2.0,642.0,642.0,5,1079,1.0,811.0,811.0
0.1,6,10,1506,5,395,21.0,127.0,127.0,5,1111,22.0,843.0,843.0
0.005,6,10,2007,5,928,1.0,660.0,660.0,5,1079,1.0,811.0,811.0
240.105,6,31,9692,15,7223,17150.0,2348.0,716.0,16,2469,16006.0,580.0,203.0
0.032,6,10,1631,5,848,8.0,580.0,580.0,5,783,8.0,515.0,515.0
10.823,17,28,4423,14,1995,823.0,270.0,114.0,14,2428,823.0,587.0,145.0
0.006,6,10,1689,5,839,1.0,571.0,571.0,5,850,1.0,582.0,582.0
0.141,6,10,1506,5,395,32.0,127.0,127.0,5,1111,31.0,843.0,843.0
0.005,6,10,1689,5,839,1.0,571.0,571.0,5,850,1.0,582.0,582.0
0.081,6,10,1506,5,395,19.0,127.0,127.0,5,1111,16.0,843.0,843.0
0.022,6,10,2006,5,927,5.0,659.0,659.0,5,1079,5.0,811.0,811.0
0.005,6,10,1689,5,839,1.0,571.0,571.0,5,850,1.0,582.0,582.0
0.005,6,10,1989,5,927,1.0,659.0,659.0,5,1062,1.0,794.0,794.0
0.005,6,10,1989,5,927,1.0,659.0,659.0,5,1062,1.0,794.0,794.0
0.229,6,10,1506,5,395,28.0,127.0,127.0,5,1111,54.0,843.0,843.0
0.019,6,10,2006,5,927,4.0,659.0,659.0,5,1079,4.0,811.0,811.0
0.136,6,10,1506,5,395,33.0,127.0,127.0,5,1111,32.0,843.0,843.0
0.007,17,2,148,1,60,0.0,32.0,32.0,1,88,0.0,60.0,60.0
0.001,17,2,166,1,75,0.0,47.0,47.0,1,91,0.0,63.0,63.0
10.79,17,28,4421,14,1993,821.0,268.0,114.0,14,2428,821.0,587.0,145.0
0.095,6,10,1506,5,395,21.0,127.0,127.0,5,1111,18.0,843.0,843.0
178.162,17,82,11653,41,2728,4453.0,44.0,38.0,41,8925,4453.0,239.0,189.0
0.005,6,10,2007,5,928,1.0,660.0,660.0,5,1079,1.0,811.0,811.0
0.001,17,2,180,1,66,0.0,38.0,38.0,1,114,0.0,86.0,86.0
0.006,6,10,1689,5,839,1.0,571.0,571.0,5,850,1.0,582.0,582.0
0.003,17,2,148,1,60,0.0,32.0,32.0,1,88,0.0,60.0,60.0
0.081,6,10,1506,5,395,16.0,127.0,127.0,5,1111,17.0,843.0,843.0
0.017,17,2,136,1,60,0.0,32.0,32.0,1,76,0.0,48.0,48.0
0.096,6,10,1506,5,395,22.0,127.0,127.0,5,1111,21.0,843.0,843.0
0.007,6,12,1698,6,863,1.0,327.0,271.0,6,835,1.0,515.0,515.0
0.005,6,10,2000,5,927,1.0,659.0,659.0,5,1073,1.0,805.0,805.0
0.005,6,10,2006,5,927,1.0,659.0,659.0,5,1079,1.0,811.0,811.0
0.018,6,13,3735,7,497,3.0,125.0,125.0,6,3238,3.0,1470.0,1459.0
40.054,17,10,676,5,460,10012.0,104.0,64.0,5,216,10012.0,20.0,15.0
0.041,17,2,148,1,60,0.0,32.0,32.0,1,88,0.0,60.0,60.0
0.006,17,2,180,1,66,0.0,38.0,38.0,1,114,0.0,86.0,86.0
0.006,6,10,1547,5,764,1.0,496.0,496.0,5,783,1.0,515.0,515.0
0.008,6,10,1990,5,911,1.0,643.0,643.0,5,1079,2.0,811.0,811.0
0.006,6,10,1547,5,764,1.0,496.0,496.0,5,783,1.0,515.0,515.0
0.006,6,10,1547,5,764,1.0,496.0,496.0,5,783,1.0,515.0,515.0
0.006,6,10,1643,5,860,1.0,592.0,592.0,5,783,1.0,515.0,515.0
0.005,6,10,1989,5,927,1.0,659.0,659.0,5,1062,1.0,794.0,794.0
0.009,6,13,3735,7,497,1.0,125.0,125.0,6,3238,1.0,1470.0,1459.0
0.005,6,10,2000,5,927,1.0,659.0,659.0,5,1073,1.0,805.0,805.0
0.013,6,10,1989,5,910,3.0,642.0,642.0,5,1079,3.0,811.0,811.0
0.01,6,10,1972,5,910,2.0,642.0,642.0,5,1062,2.0,794.0,794.0
0.014,6,19,9922,11,704,1.0,124.0,124.0,8,9218,2.0,2896.0,2198.0
0.005,6,10,2006,5,927,1.0,659.0,659.0,5,1079,1.0,811.0,811.0
0.005,6,10,2006,5,927,1.0,659.0,659.0,5,1079,1.0,811.0,811.0
0.003,17,2,148,1,60,0.0,32.0,32.0,1,88,0.0,60.0,60.0
0.004,6,10,1989,5,927,1.0,659.0,659.0,5,1062,1.0,794.0,794.0
166.374,17,76,11097,38,2543,4496.0,44.0,38.0,38,8554,4496.0,279.0,197.0
0.011,6,10,1631,5,848,2.0,580.0,580.0,5,783,2.0,515.0,515.0
0.001,17,2,180,1,65,0.0,37.0,37.0,1,115,0.0,87.0,87.0
0.005,6,10,2000,5,927,1.0,659.0,659.0,5,1073,1.0,805.0,805.0
0.121,6,10,1506,5,395,27.0,127.0,127.0,5,1111,24.0,843.0,843.0
0.004,6,10,2006,5,927,1.0,659.0,659.0,5,1079,1.0,811.0,811.0
0.081,6,10,1506,5,395,18.0,127.0,127.0,5,1111,19.0,843.0,843.0
0.005,6,10,1989,5,927,1.0,659.0,659.0,5,1062,1.0,794.0,794.0
0.012,6,6,716,3,458,4.0,302.0,302.0,3,258,4.0,102.0,102.0
0.003,17,2,148,1,60,0.0,32.0,32.0,1,88,0.0,60.0,60.0
0.005,6,10,2006,5,927,1.0,659.0,659.0,5,1079,1.0,811.0,811.0
1759.904,6,535,81760,287,42938,6153.0,1781.0,218.0,248,38822,7125.0,1627.0,163.0
0.009,6,10,1989,5,910,2.0,642.0,642.0,5,1079,2.0,811.0,811.0
0.004,17,2,144,1,64,0.0,36.0,36.0,1,80,0.0,52.0,52.0
0.006,6,10,1547,5,764,1.0,496.0,496.0,5,783,1.0,515.0,515.0
51.055,6,38,9663,19,4060,491.0,2903.0,1085.0,19,5603,2826.0,2667.0,402.0
40.066,17,10,676,5,460,10014.0,104.0,64.0,5,216,10015.0,20.0,15.0
0.005,6,10,2007,5,928,1.0,660.0,660.0,5,1079,1.0,811.0,811.0
0.005,17,2,185,1,73,0.0,45.0,45.0,1,112,0.0,84.0,84.0
0.004,17,2,214,1,75,0.0,47.0,47.0,1,139,0.0,111.0,111.0
0.004,17,2,136,1,60,0.0,32.0,32.0,1,76,0.0,48.0,48.0
0.005,6,10,2006,5,927,1.0,659.0,659.0,5,1079,1.0,811.0,811.0
0.005,6,10,1989,5,927,1.0,659.0,659.0,5,1062,1.0,794.0,794.0
0.022,6,10,1990,5,911,5.0,643.0,643.0,5,1079,5.0,811.0,811.0
0.007,6,10,1983,5,910,1.0,642.0,642.0,5,1073,1.0,805.0,805.0
0.008,6,10,1990,5,911,1.0,643.0,643.0,5,1079,2.0,811.0,811.0
1778.485,17,144,45504,72,22752,25049.0,288.0,288.0,72,22752,25049.0,288.0,288.0
0.004,6,10,1702,5,863,1.0,595.0,595.0,5,839,0.0,571.0,571.0
0.04,17,2,152,1,76,0.0,48.0,48.0,1,76,0.0,48.0,48.0
0.075,6,10,1506,5,395,16.0,127.0,127.0,5,1111,16.0,843.0,843.0
0.132,17,4,596,2,122,2.0,33.0,33.0,2,474,60.0,323.0,209.0
0.039,17,2,152,1,76,0.0,48.0,48.0,1,76,0.0,48.0,48.0
0.006,6,13,3690,7,452,0.0,80.0,80.0,6,3238,1.0,1470.0,1459.0
0.015,6,10,1972,5,910,3.0,642.0,642.0,5,1062,3.0,794.0,794.0
0.005,17,4,284,2,120,0.0,32.0,32.0,2,164,1.0,60.0,54.0
0.004,17,2,136,1,60,0.0,32.0,32.0,1,76,0.0,48.0,48.0
0.008,6,10,1989,5,910,2.0,642.0,642.0,5,1079,2.0,811.0,811.0
0.004,6,10,1774,5,923,1.0,655.0,655.0,5,851,1.0,583.0,583.0
0.068,17,8,3613,4,1874,22.0,1350.0,440.0,4,1739,11.0,1350.0,406.0
0.001,17,2,180,1,66,0.0,38.0,38.0,1,114,0.0,86.0,86.0
177.287,17,70,10005,35,2339,5214.0,44.0,38.0,35,7666,5214.0,249.0,191.0
0.14,6,10,1506,5,395,33.0,127.0,127.0,5,1111,25.0,843.0,843.0
0.04,17,2,148,1,60,0.0,32.0,32.0,1,88,0.0,60.0,60.0
0.015,6,10,1989,5,910,3.0,642.0,642.0,5,1079,3.0,811.0,811.0
0.018,6,10,1989,5,910,4.0,642.0,642.0,5,1079,4.0,811.0,811.0
311.363,17,20,1124,10,716,34581.0,48.0,43.0,10,408,34582.0,20.0,12.0
0.012,6,10,1990,5,911,3.0,643.0,643.0,5,1079,3.0,811.0,811.0
0.004,6,10,1774,5,923,1.0,655.0,655.0,5,851,1.0,583.0,583.0
0.01,6,10,1762,5,911,2.0,643.0,643.0,5,851,2.0,583.0,583.0
15.079,17,15,8298,8,6120,2150.0,1350.0,737.0,7,2178,2508.0,1350.0,283.0
0.003,17,2,148,1,60,0.0,32.0,32.0,1,88,0.0,60.0,60.0
0.041,17,2,182,1,65,0.0,37.0,37.0,1,117,0.0,89.0,89.0
0.005,6,10,1689,5,839,1.0,571.0,571.0,5,850,1.0,582.0,582.0
0.004,6,10,2006,5,927,1.0,659.0,659.0,5,1079,1.0,811.0,811.0
1772.975,6,106,6361,60,3537,30049.0,27.0,27.0,46,2824,39398.0,27.0,27.0
240.269,6,44,8823,22,5738,11441.0,1368.0,458.0,22,3085,11441.0,580.0,241.0
0.012,6,10,1990,5,911,3.0,643.0,643.0,5,1079,3.0,811.0,811.0
0.006,17,2,180,1,66,0.0,38.0,38.0,1,114,0.0,86.0,86.0
0.005,17,2,142,1,63,0.0,35.0,35.0,1,79,0.0,51.0,51.0
0.004,6,10,1989,5,927,1.0,659.0,659.0,5,1062,1.0,794.0,794.0
0.004,6,10,1779,5,928,1.0,660.0,660.0,5,851,1.0,583.0,583.0
0.005,6,10,2007,5,928,1.0,660.0,660.0,5,1079,1.0,811.0,811.0
0.012,17,2,170,1,65,0.0,37.0,37.0,1,105,0.0,77.0,77.0
0.106,6,10,1506,5,395,22.0,127.0,127.0,5,1111,23.0,843.0,843.0
0.018,6,10,1989,5,910,4.0,642.0,642.0,5,1079,4.0,811.0,811.0
0.003,6,10,1702,5,863,0.0,595.0,595.0,5,839,0.0,571.0,571.0
0.005,6,10,2006,5,927,1.0,659.0,659.0,5,1079,1.0,811.0,811.0
0.011,6,10,1989,5,910,2.0,642.0,642.0,5,1079,2.0,811.0,811.0
0.245,17,43,26605,26,23444,9.0,1350.0,873.0,17,3161,11.0,1350.0,157.0
0.001,17,2,166,1,75,0.0,47.0,47.0,1,91,0.0,63.0,63.0
0.073,6,10,1506,5,395,15.0,127.0,127.0,5,1111,16.0,843.0,843.0
0.006,6,10,1547,5,764,1.0,496.0,496.0,5,783,1.0,515.0,515.0
0.684,6,26,9368,15,1639,41.0,517.0,211.0,11,7729,57.0,2074.0,1023.0
0.06,6,10,1506,5,395,14.0,127.0,127.0,5,1111,14.0,843.0,843.0
0.005,17,2,169,1,62,0.0,34.0,34.0,1,107,0.0,79.0,79.0
0.07,6,10,1506,5,395,16.0,127.0,127.0,5,1111,16.0,843.0,843.0
0.104,6,10,1506,5,395,22.0,127.0,127.0,5,1111,23.0,843.0,843.0
0.064,6,10,1506,5,395,14.0,127.0,127.0,5,1111,14.0,843.0,843.0
240.009,6,9,787,5,488,60002.0,232.0,232.0,4,299,80002.0,83.0,83.0
0.02,6,10,1677,5,827,5.0,559.0,559.0,5,850,5.0,582.0,582.0
0.009,6,10,1983,5,910,2.0,642.0,642.0,5,1073,2.0,805.0,805.0
0.089,6,10,1506,5,395,19.0,127.0,127.0,5,1111,18.0,843.0,843.0
0.012,6,13,3735,7,497,2.0,125.0,125.0,6,3238,2.0,1470.0,1459.0
0.089,6,10,1506,5,395,17.0,127.0,127.0,5,1111,19.0,843.0,843.0
0.01,6,10,1989,5,910,2.0,642.0,642.0,5,1079,2.0,811.0,811.0
0.072,17,2,80,1,32,0.0,4.0,4.0,1,48,0.0,20.0,20.0
0.072,6,46,14078,26,2607,2.0,517.0,139.0,20,11471,3.0,1402.0,744.0
0.006,6,10,1547,5,764,1.0,496.0,496.0,5,783,1.0,515.0,515.0
0.229,17,14,8577,7,4012,38.0,1350.0,545.0,7,4565,27.0,1350.0,624.0
0.012,6,10,1990,5,911,2.0,643.0,643.0,5,1079,3.0,811.0,811.0
0.003,17,2,186,1,61,0.0,33.0,33.0,1,125,0.0,97.0,97.0
0.005,6,10,2007,5,928,1.0,660.0,660.0,5,1079,1.0,811.0,811.0
0.005,6,10,1779,5,928,1.0,660.0,660.0,5,851,1.0,583.0,583.0
0.088,6,10,1506,5,395,19.0,127.0,127.0,5,1111,21.0,843.0,843.0
0.027,6,10,1983,5,910,6.0,642.0,642.0,5,1073,6.0,805.0,805.0
0.001,17,2,166,1,75,0.0,47.0,47.0,1,91,0.0,63.0,63.0
0.009,6,12,1926,6,1189,1.0,659.0,434.0,6,737,1.0,417.0,417.0
0.005,6,13,3747,7,509,0.0,137.0,137.0,6,3238,1.0,1470.0,1459.0
0.095,6,10,1506,5,395,21.0,127.0,127.0,5,1111,19.0,843.0,843.0
0.001,17,2,180,1,65,0.0,37.0,37.0,1,115,0.0,87.0,87.0
0.016,6,10,1677,5,827,3.0,559.0,559.0,5,850,4.0,582.0,582.0
0.162,6,10,1506,5,395,34.0,127.0,127.0,5,1111,39.0,843.0,843.0
0.001,17,2,179,1,62,0.0,34.0,34.0,1,117,0.0,89.0,89.0
0.097,6,10,1506,5,395,22.0,127.0,127.0,5,1111,20.0,843.0,843.0
0.004,6,10,2006,5,927,1.0,659.0,659.0,5,1079,1.0,811.0,811.0
0.116,6,10,1506,5,395,24.0,127.0,127.0,5,1111,25.0,843.0,843.0
0.015,6,10,1972,5,910,3.0,642.0,642.0,5,1062,3.0,794.0,794.0
0.001,17,2,180,1,66,0.0,38.0,38.0,1,114,0.0,86.0,86.0
0.011,6,10,1989,5,910,2.0,642.0,642.0,5,1079,2.0,811.0,811.0
0.016,6,10,1989,5,910,3.0,642.0,642.0,5,1079,3.0,811.0,811.0
0.017,6,10,1631,5,848,4.0,580.0,580.0,5,783,4.0,515.0,515.0
0.104,6,10,1506,5,395,21.0,127.0,127.0,5,1111,23.0,843.0,843.0
40.054,17,10,676,5,460,10012.0,104.0,64.0,5,216,10012.0,20.0,15.0
0.006,6,10,1774,5,923,1.0,655.0,655.0,5,851,1.0,583.0,583.0
0.019,17,2,170,1,65,0.0,37.0,37.0,1,105,0.0,77.0,77.0
0.07,17,8,3613,4,1874,23.0,1350.0,440.0,4,1739,12.0,1350.0,406.0
0.015,6,10,1990,5,911,3.0,643.0,643.0,5,1079,3.0,811.0,811.0
0.005,17,2,170,1,65,0.0,37.0,37.0,1,105,0.0,77.0,77.0
0.004,6,10,2007,5,928,1.0,660.0,660.0,5,1079,1.0,811.0,811.0
1792.833,6,574,192393,299,165264,6016.0,2883.0,896.0,275,27129,6543.0,580.0,125.0
0.005,6,10,1547,5,764,1.0,496.0,496.0,5,783,1.0,515.0,515.0
1753.909,6,301,97334,185,86211,9532.0,1402.0,677.0,116,11123,15251.0,452.0,70.0
0.005,6,10,1989,5,927,1.0,659.0,659.0,5,1062,1.0,794.0,794.0
0.015,6,10,1762,5,911,3.0,643.0,643.0,5,851,3.0,583.0,583.0
0.005,6,10,2007,5,928,1.0,660.0,660.0,5,1079,1.0,811.0,811.0
0.005,6,10,1689,5,839,1.0,571.0,571.0,5,850,1.0,582.0,582.0
0.005,6,10,1774,5,923,1.0,655.0,655.0,5,851,1.0,583.0,583.0
0.008,6,10,1989,5,910,1.0,642.0,642.0,5,1079,2.0,811.0,811.0
0.042,17,2,152,1,76,0.0,48.0,48.0,1,76,0.0,48.0,48.0
0.005,6,10,1689,5,839,1.0,571.0,571.0,5,850,1.0,582.0,582.0
0.012,6,10,1762,5,911,3.0,643.0,643.0,5,851,2.0,583.0,583.0
308.676,17,20,1124,10,716,34290.0,48.0,43.0,10,408,34290.0,20.0,12.0
11.129,17,28,4422,14,1994,843.0,269.0,114.0,14,2428,843.0,587.0,145.0
0.011,6,10,1972,5,910,2.0,642.0,642.0,5,1062,2.0,794.0,794.0
0.114,6,10,1506,5,395,26.0,127.0,127.0,5,1111,27.0,843.0,843.0
0.005,6,10,1779,5,928,1.0,660.0,660.0,5,851,1.0,583.0,583.0
0.08,6,10,1506,5,395,17.0,127.0,127.0,5,1111,18.0,843.0,843.0
0.067,17,8,3613,4,1874,22.0,1350.0,440.0,4,1739,11.0,1350.0,406.0
0.011,17,2,194,1,59,0.0,31.0,31.0,1,135,0.0,107.0,107.0
0.005,6,10,2007,5,928,1.0,660.0,660.0,5,1079,1.0,811.0,811.0
1.071,6,32,13392,18,5893,63.0,2074.0,854.0,14,7499,69.0,2720.0,769.0
0.005,6,10,2007,5,928,1.0,660.0,660.0,5,1079,1.0,811.0,811.0
0.077,6,10,1506,5,395,17.0,127.0,127.0,5,1111,18.0,843.0,843.0
0.004,17,4,284,2,120,0.0,32.0,32.0,2,164,1.0,60.0,54.0
0.101,6,10,1506,5,395,22.0,127.0,127.0,5,1111,22.0,843.0,843.0
0.04,17,4,284,2,120,1.0,32.0,32.0,2,164,36.0,60.0,54.0
0.078,6,10,1506,5,395,17.0,127.0,127.0,5,1111,18.0,843.0,843.0
0.005,6,10,1774,5,923,1.0,655.0,655.0,5,851,1.0,583.0,583.0
0.124,6,10,1506,5,395,25.0,127.0,127.0,5,1111,28.0,843.0,843.0
0.016,6,10,1972,5,910,4.0,642.0,642.0,5,1062,4.0,794.0,794.0
15.081,17,15,8068,8,5960,2150.0,1350.0,717.0,7,2108,2508.0,1350.0,273.0
0.012,6,10,1983,5,910,2.0,642.0,642.0,5,1073,3.0,805.0,805.0
0.005,6,10,1989,5,927,1.0,659.0,659.0,5,1062,1.0,794.0,794.0
0.004,17,4,284,2,120,0.0,32.0,32.0,2,164,1.0,60.0,54.0
0.007,6,10,1547,5,764,1.0,496.0,496.0,5,783,1.0,515.0,515.0
0.004,17,2,148,1,60,0.0,32.0,32.0,1,88,0.0,60.0,60.0
0.008,17,2,194,1,59,0.0,31.0,31.0,1,135,0.0,107.0,107.0
0.115,6,10,1506,5,395,24.0,127.0,127.0,5,1111,25.0,843.0,843.0
0.005,17,2,166,1,75,0.0,47.0,47.0,1,91,0.0,63.0,63.0
0.009,6,10,1677,5,827,2.0,559.0,559.0,5,850,2.0,582.0,582.0
15.086,17,16,9295,8,7028,2151.0,1350.0,850.0,8,2267,2150.0,1350.0,255.0
177.501,17,80,11626,40,2686,4551.0,44.0,39.0,40,8940,4551.0,239.0,195.0
0.02,6,10,1972,5,910,4.0,642.0,642.0,5,1062,4.0,794.0,794.0
0.007,6,10,1972,5,910,1.0,642.0,642.0,5,1062,1.0,794.0,794.0
0.074,6,10,1506,5,395,16.0,127.0,127.0,5,1111,17.0,843.0,843.0
0.01,6,14,3787,7,497,1.0,125.0,125.0,7,3290,1.0,1448.0,972.0
0.089,6,10,1506,5,395,20.0,127.0,127.0,5,1111,21.0,843.0,843.0
0.072,17,2,182,1,65,0.0,37.0,37.0,1,117,0.0,89.0,89.0
0.094,6,10,1506,5,395,22.0,127.0,127.0,5,1111,20.0,843.0,843.0
0.004,6,10,1774,5,923,1.0,655.0,655.0,5,851,1.0,583.0,583.0
0.037,17,4,284,2,120,0.0,32.0,32.0,2,164,34.0,60.0,54.0
0.079,6,10,1506,5,395,17.0,127.0,127.0,5,1111,17.0,843.0,843.0
0.012,6,13,3735,7,497,2.0,125.0,125.0,6,3238,2.0,1470.0,1459.0
0.089,6,10,1506,5,395,21.0,127.0,127.0,5,1111,18.0,843.0,843.0
0.11,6,10,1506,5,395,22.0,127.0,127.0,5,1111,23.0,843.0,843.0
0.012,6,10,1989,5,910,3.0,642.0,642.0,5,1079,3.0,811.0,811.0
0.112,6,10,1506,5,395,25.0,127.0,127.0,5,1111,24.0,843.0,843.0
0.006,17,2,148,1,60,0.0,32.0,32.0,1,88,0.0,60.0,60.0
15.074,17,15,9238,8,6902,2149.0,1350.0,834.0,7,2336,2507.0,1350.0,305.0
0.004,6,10,1779,5,928,1.0,660.0,660.0,5,851,1.0,583.0,583.0
0.126,17,2,234,1,61,0.0,33.0,33.0,1,173,0.0,145.0,145.0
308.645,17,19,1084,10,716,34279.0,48.0,43.0,9,368,38564.0,20.0,12.0
0.005,6,10,1989,5,927,1.0,659.0,659.0,5,1062,1.0,794.0,794.0
300.998,6,46,16661,25,11023,12541.0,2720.0,999.0,21,5638,441.0,2667.0,435.0
0.007,6,10,1547,5,764,1.0,496.0,496.0,5,783,1.0,515.0,515.0
0.003,6,10,1702,5,863,0.0,595.0,595.0,5,839,0.0,571.0,571.0
0.13,6,10,1506,5,395,29.0,127.0,127.0,5,1111,25.0,843.0,843.0
0.016,6,10,1762,5,911,4.0,643.0,643.0,5,851,4.0,583.0,583.0
0.016,6,10,1989,5,910,4.0,642.0,642.0,5,1079,4.0,811.0,811.0
0.009,6,10,1989,5,910,2.0,642.0,642.0,5,1079,2.0,811.0,811.0
0.005,6,14,3799,7,509,0.0,137.0,137.0,7,3290,0.0,1448.0,972.0
0.678,6,28,6699,16,2025,38.0,517.0,272.0,12,4674,51.0,1330.0,597.0
0.013,6,10,1989,5,910,3.0,642.0,642.0,5,1079,3.0,811.0,811.0
0.004,17,2,185,1,73,0.0,45.0,45.0,1,112,0.0,84.0,84.0
0.09,6,10,1506,5,395,17.0,127.0,127.0,5,1111,21.0,843.0,843.0
0.006,6,10,1547,5,764,1.0,496.0,496.0,5,783,1.0,515.0,515.0
0.003,17,2,148,1,60,0.0,32.0,32.0,1,88,0.0,60.0,60.0
0.004,6,10,2006,5,927,1.0,659.0,659.0,5,1079,1.0,811.0,811.0
0.01,6,10,1990,5,911,2.0,643.0,643.0,5,1079,2.0,811.0,811.0
11.046,17,28,4398,14,2313,840.0,588.0,137.0,14,2085,840.0,268.0,120.0
372.13,6,22,2313,16,867,24808.0,195.0,195.0,6,1446,4648.0,419.0,398.0
0.118,6,10,1506,5,395,23.0,127.0,127.0,5,1111,27.0,843.0,843.0
0.005,6,10,1989,5,927,1.0,659.0,659.0,5,1062,1.0,794.0,794.0
0.006,6,10,1774,5,923,1.0,655.0,655.0,5,851,1.0,583.0,583.0
0.124,6,10,1506,5,395,28.0,127.0,127.0,5,1111,29.0,843.0,843.0
0.004,6,10,2006,5,927,1.0,659.0,659.0,5,1079,1.0,811.0,811.0
0.098,6,10,1506,5,395,21.0,127.0,127.0,5,1111,22.0,843.0,843.0
0.089,6,10,1506,5,395,21.0,127.0,127.0,5,1111,20.0,843.0,843.0
1786.42,6,154,19574,92,13852,19630.0,302.0,302.0,62,5722,29285.0,83.0,83.0
0.184,6,10,1506,5,395,45.0,127.0,127.0,5,1111,45.0,843.0,843.0
0.016,6,10,1989,5,910,4.0,642.0,642.0,5,1079,4.0,811.0,811.0
0.004,6,10,2006,5,927,1.0,659.0,659.0,5,1079,1.0,811.0,811.0
0.015,6,10,1989,5,910,3.0,642.0,642.0,5,1079,3.0,811.0,811.0
0.004,6,10,2006,5,927,1.0,659.0,659.0,5,1079,1.0,811.0,811.0
0.005,6,10,2006,5,927,1.0,659.0,659.0,5,1079,1.0,811.0,811.0
126.038,6,13,1909,7,1475,20964.0,1183.0,1183.0,6,434,25160.0,182.0,182.0
0.069,17,8,3613,4,1874,23.0,1350.0,440.0,4,1739,12.0,1350.0,406.0
0.072,17,2,148,1,60,0.0,32.0,32.0,1,88,0.0,60.0,60.0
309.028,17,20,1124,10,716,34328.0,48.0,43.0,10,408,34327.0,20.0,12.0
0.001,17,2,180,1,66,0.0,38.0,38.0,1,114,0.0,86.0,86.0
0.075,6,10,1506,5,395,15.0,127.0,127.0,5,1111,18.0,843.0,843.0
0.017,6,10,1989,5,910,4.0,642.0,642.0,5,1079,4.0,811.0,811.0
0.575,6,26,9368,14,1587,36.0,517.0,211.0,12,7781,42.0,1288.0,895.0
0.003,17,2,136,1,60,0.0,32.0,32.0,1,76,0.0,48.0,48.0
0.029,6,10,1989,5,910,7.0,642.0,642.0,5,1079,7.0,811.0,811.0
0.013,17,2,152,1,56,0.0,28.0,28.0,1,96,0.0,68.0,68.0
0.006,17,2,144,1,64,0.0,36.0,36.0,1,80,0.0,52.0,52.0
0.011,6,10,1989,5,910,2.0,642.0,642.0,5,1079,2.0,811.0,811.0
0.012,6,10,1989,5,910,3.0,642.0,642.0,5,1079,2.0,811.0,811.0
0.149,6,10,1506,5,395,33.0,127.0,127.0,5,1111,35.0,843.0,843.0
0.005,6,10,2006,5,927,1.0,659.0,659.0,5,1079,1.0,811.0,811.0
0.015,6,10,1972,5,910,3.0,642.0,642.0,5,1062,3.0,794.0,794.0
0.006,6,10,1643,5,860,1.0,592.0,592.0,5,783,1.0,515.0,515.0
0.006,17,2,140,1,62,0.0,34.0,34.0,1,78,0.0,50.0,50.0
0.005,17,2,169,1,62,0.0,34.0,34.0,1,107,0.0,79.0,79.0
0.004,6,10,2000,5,927,1.0,659.0,659.0,5,1073,1.0,805.0,805.0
0.055,6,14,3787,7,497,9.0,125.0,125.0,7,3290,9.0,1448.0,972.0
0.006,6,10,1547,5,764,1.0,496.0,496.0,5,783,1.0,515.0,515.0
0.012,6,13,3735,7,497,2.0,125.0,125.0,6,3238,2.0,1470.0,1459.0
0.001,17,2,166,1,75,0.0,47.0,47.0,1,91,0.0,63.0,63.0
353.994,6,21,1795,16,1030,23599.0,190.0,190.0,5,765,60001.0,464.0,248.0
0.007,6,10,1547,5,764,1.0,496.0,496.0,5,783,1.0,515.0,515.0
0.004,6,10,2007,5,928,1.0,660.0,660.0,5,1079,1.0,811.0,811.0
0.009,6,10,1972,5,910,2.0,642.0,642.0,5,1062,2.0,794.0,794.0
0.004,17,4,284,2,120,0.0,32.0,32.0,2,164,1.0,60.0,54.0
0.018,6,10,1990,5,911,4.0,643.0,643.0,5,1079,4.0,811.0,811.0
0.005,6,10,2000,5,927,1.0,659.0,659.0,5,1073,1.0,805.0,805.0
0.005,6,10,1774,5,923,1.0,655.0,655.0,5,851,1.0,583.0,583.0
0.07,17,8,3613,4,1874,23.0,1350.0,440.0,4,1739,12.0,1350.0,406.0
0.015,6,10,1989,5,910,3.0,642.0,642.0,5,1079,3.0,811.0,811.0
0.004,6,10,2000,5,927,1.0,659.0,659.0,5,1073,1.0,805.0,805.0
0.006,17,2,148,1,60,0.0,32.0,32.0,1,88,0.0,60.0,60.0
0.053,17,2,152,1,76,0.0,48.0,48.0,1,76,0.0,48.0,48.0
0.019,6,10,1972,5,910,4.0,642.0,642.0,5,1062,4.0,794.0,794.0
300.186,6,40,10153,21,4595,15000.0,1360.0,620.0,19,5558,16667.0,1360.0,398.0
0.005,6,10,2000,5,927,1.0,659.0,659.0,5,1073,1.0,805.0,805.0
0.044,17,2,186,1,61,0.0,33.0,33.0,1,125,0.0,97.0,97.0
40.069,17,10,676,5,460,10015.0,104.0,64.0,5,216,10016.0,20.0,15.0
0.007,17,2,179,1,71,0.0,43.0,43.0,1,108,0.0,80.0,80.0
280.245,6,23,6075,10,1186,31137.0,267.0,156.0,13,4889,23353.0,1400.0,873.0
240.013,6,9,787,5,488,60003.0,232.0,232.0,4,299,80003.0,83.0,83.0
0.004,6,10,1989,5,927,1.0,659.0,659.0,5,1062,1.0,794.0,794.0
0.004,6,10,2000,5,927,1.0,659.0,659.0,5,1073,1.0,805.0,805.0
40.063,17,10,676,5,460,10015.0,104.0,64.0,5,216,10014.0,20.0,15.0
0.005,17,2,140,1,62,0.0,34.0,34.0,1,78,0.0,50.0,50.0
0.005,6,10,2006,5,927,1.0,659.0,659.0,5,1079,1.0,811.0,811.0
0.005,6,10,2007,5,928,1.0,660.0,660.0,5,1079,1.0,811.0,811.0
0.016,6,10,1972,5,910,3.0,642.0,642.0,5,1062,3.0,794.0,794.0
0.005,6,10,2000,5,927,1.0,659.0,659.0,5,1073,1.0,805.0,805.0
0.085,6,10,1506,5,395,19.0,127.0,127.0,5,1111,19.0,843.0,843.0
0.023,17,2,198,1,91,0.0,63.0,63.0,1,107,0.0,79.0,79.0
0.005,6,10,2006,5,927,1.0,659.0,659.0,5,1079,1.0,811.0,811.0
0.005,6,10,1779,5,928,1.0,660.0,660.0,5,851,1.0,583.0,583.0
0.013,6,10,1972,5,910,3.0,642.0,642.0,5,1062,3.0,794.0,794.0
0.004,17,2,136,1,60,0.0,32.0,32.0,1,76,0.0,48.0,48.0
0.071,6,10,1506,5,395,15.0,127.0,127.0,5,1111,15.0,843.0,843.0
0.079,6,10,1506,5,395,19.0,127.0,127.0,5,1111,18.0,843.0,843.0
0.004,17,2,148,1,60,0.0,32.0,32.0,1,88,0.0,60.0,60.0
0.008,6,10,1989,5,910,2.0,642.0,642.0,5,1079,1.0,811.0,811.0
0.004,17,2,136,1,60,0.0,32.0,32.0,1,76,0.0,48.0,48.0
0.038,17,2,170,1,65,0.0,37.0,37.0,1,105,0.0,77.0,77.0
0.005,6,10,1643,5,860,1.0,592.0,592.0,5,783,1.0,515.0,515.0
53.654,6,38,12687,19,7129,489.0,2720.0,1267.0,19,5558,2971.0,2667.0,435.0
0.007,6,10,1547,5,764,1.0,496.0,496.0,5,783,1.0,515.0,515.0
0.005,6,10,2006,5,927,1.0,659.0,659.0,5,1079,1.0,811.0,811.0
0.005,6,10,1774,5,923,1.0,655.0,655.0,5,851,1.0,583.0,583.0
0.007,6,10,1702,5,863,1.0,595.0,595.0,5,839,1.0,571.0,571.0
0.001,17,2,179,1,62,0.0,34.0,34.0,1,117,0.0,89.0,89.0
242.197,6,45,14350,22,4434,11533.0,847.0,547.0,23,9916,11008.0,1593.0,544.0
240.111,6,32,9504,16,7143,16007.0,2216.0,701.0,16,2361,16007.0,580.0,190.0
0.008,6,10,1989,5,910,2.0,642.0,642.0,5,1079,1.0,811.0,811.0
0.006,6,10,1689,5,839,1.0,571.0,571.0,5,850,1.0,582.0,582.0
0.019,6,10,1989,5,910,4.0,642.0,642.0,5,1079,4.0,811.0,811.0
0.172,17,2,152,1,76,0.0,48.0,48.0,1,76,0.0,48.0,48.0
0.011,6,10,1631,5,848,2.0,580.0,580.0,5,783,2.0,515.0,515.0
0.005,6,10,1547,5,764,1.0,496.0,496.0,5,783,1.0,515.0,515.0
0.013,6,10,1989,5,910,3.0,642.0,642.0,5,1079,3.0,811.0,811.0
0.001,17,2,180,1,66,0.0,38.0,38.0,1,114,0.0,86.0,86.0
10.831,17,28,4423,14,1995,825.0,270.0,114.0,14,2428,825.0,587.0,145.0
0.11,6,10,1506,5,395,24.0,127.0,127.0,5,1111,22.0,843.0,843.0
0.011,6,10,1989,5,910,2.0,642.0,642.0,5,1079,2.0,811.0,811.0
1770.554,17,92,8096,46,4048,39345.0,60.0,60.0,46,4048,39345.0,60.0,60.0
40.062,17,10,676,5,460,10012.0,104.0,64.0,5,216,10014.0,20.0,15.0
0.058,6,10,1506,5,395,13.0,127.0,127.0,5,1111,12.0,843.0,843.0
0.098,6,10,1506,5,395,19.0,127.0,127.0,5,1111,23.0,843.0,843.0
38.218,6,38,9851,19,4293,498.0,1360.0,700.0,19,5558,2114.0,1360.0,398.0
0.005,6,13,3690,7,452,0.0,80.0,80.0,6,3238,1.0,1470.0,1459.0
0.013,6,13,3735,7,497,2.0,125.0,125.0,6,3238,2.0,1470.0,1459.0
240.021,6,9,787,5,488,60005.0,232.0,232.0,4,299,80006.0,83.0,83.0
0.008,6,12,1926,6,1189,1.0,659.0,434.0,6,737,1.0,417.0,417.0
0.007,6,10,1547,5,764,1.0,496.0,496.0,5,783,1.0,515.0,515.0
0.009,6,10,1762,5,911,2.0,643.0,643.0,5,851,2.0,583.0,583.0
0.003,17,2,148,1,60,0.0,32.0,32.0,1,88,0.0,60.0,60.0
0.006,6,10,1547,5,764,1.0,496.0,496.0,5,783,1.0,515.0,515.0
0.007,6,14,3799,7,509,1.0,137.0,137.0,7,3290,1.0,1448.0,972.0
0.006,6,10,1547,5,764,1.0,496.0,496.0,5,783,1.0,515.0,515.0
0.008,6,10,1983,5,910,2.0,642.0,642.0,5,1073,1.0,805.0,805.0
0.006,6,10,1547,5,764,1.0,496.0,496.0,5,783,1.0,515.0,515.0
0.004,17,2,136,1,60,0.0,32.0,32.0,1,76,0.0,48.0,48.0
0.086,6,10,1506,5,395,19.0,127.0,127.0,5,1111,20.0,843.0,843.0
0.006,6,10,2007,5,928,1.0,660.0,660.0,5,1079,1.0,811.0,811.0
40.063,17,10,676,5,460,10014.0,104.0,64.0,5,216,10014.0,20.0,15.0
0.087,6,10,1506,5,395,19.0,127.0,127.0,5,1111,20.0,843.0,843.0
0.126,6,10,1506,5,395,28.0,127.0,127.0,5,1111,18.0,843.0,843.0
0.005,6,10,1774,5,923,1.0,655.0,655.0,5,851,1.0,583.0,583.0
0.003,17,2,148,1,60,0.0,32.0,32.0,1,88,0.0,60.0,60.0
0.004,17,4,284,2,120,0.0,32.0,32.0,2,164,1.0,60.0,54.0
0.005,6,10,2000,5,927,1.0,659.0,659.0,5,1073,1.0,805.0,805.0
0.005,6,10,1774,5,923,1.0,655.0,655.0,5,851,1.0,583.0,583.0
0.005,6,10,2000,5,927,1.0,659.0,659.0,5,1073,1.0,805.0,805.0
66.037,6,22,10152,12,3985,6003.0,1591.0,838.0,10,6167,7318.0,2111.0,939.0
0.005,17,2,140,1,62,0.0,34.0,34.0,1,78,0.0,50.0,50.0
0.003,17,2,148,1,60,0.0,32.0,32.0,1,88,0.0,60.0,60.0
0.016,6,13,3735,7,497,2.0,125.0,125.0,6,3238,3.0,1470.0,1459.0
11.175,17,28,4422,14,1995,847.0,270.0,114.0,14,2427,846.0,586.0,145.0
0.092,6,10,1506,5,395,21.0,127.0,127.0,5,1111,20.0,843.0,843.0
0.093,6,10,1506,5,395,20.0,127.0,127.0,5,1111,22.0,843.0,843.0
0.015,6,10,1762,5,911,3.0,643.0,643.0,5,851,3.0,583.0,583.0
15.021,17,42,21611,23,18458,681.0,1350.0,774.0,19,3153,832.0,1350.0,137.0
0.004,6,10,2006,5,927,1.0,659.0,659.0,5,1079,1.0,811.0,811.0
0.082,6,10,1506,5,395,19.0,127.0,127.0,5,1111,17.0,843.0,843.0
300.333,6,27,7432,16,1409,20022.0,217.0,142.0,11,6023,24027.0,1679.0,777.0
180.104,17,80,11544,40,2688,4617.0,44.0,39.0,40,8856,4617.0,261.0,193.0
0.105,6,10,1506,5,395,21.0,127.0,127.0,5,1111,25.0,843.0,843.0
240.151,6,16,4482,9,963,30018.0,238.0,166.0,7,3519,40023.0,1402.0,786.0
0.141,6,10,1506,5,395,32.0,127.0,127.0,5,1111,27.0,843.0,843.0
0.009,6,10,1989,5,910,2.0,642.0,642.0,5,1079,2.0,811.0,811.0
0.006,6,10,2007,5,928,1.0,660.0,660.0,5,1079,1.0,811.0,811.0
40.076,17,10,676,5,460,10018.0,104.0,64.0,5,216,10018.0,20.0,15.0
40.074,17,10,676,5,460,10016.0,104.0,64.0,5,216,10017.0,20.0,15.0
0.011,6,10,1989,5,910,2.0,642.0,642.0,5,1079,2.0,811.0,811.0
0.085,6,10,1506,5,395,19.0,127.0,127.0,5,1111,19.0,843.0,843.0
1770.378,17,92,8096,46,4048,39341.0,60.0,60.0,46,4048,39341.0,60.0,60.0
0.006,6,10,1689,5,839,1.0,571.0,571.0,5,850,1.0,582.0,582.0
0.13,17,4,596,2,122,1.0,33.0,33.0,2,474,58.0,323.0,209.0
0.004,17,2,136,1,60,0.0,32.0,32.0,1,76,0.0,48.0,48.0
0.014,6,13,3735,7,497,2.0,125.0,125.0,6,3238,2.0,1470.0,1459.0
0.015,6,10,1989,5,910,3.0,642.0,642.0,5,1079,3.0,811.0,811.0
0.012,6,10,1989,5,910,2.0,642.0,642.0,5,1079,2.0,811.0,811.0
0.078,6,10,1506,5,395,18.0,127.0,127.0,5,1111,16.0,843.0,843.0
0.076,6,10,1506,5,395,18.0,127.0,127.0,5,1111,18.0,843.0,843.0
0.21,17,4,352,2,130,171.0,37.0,37.0,2,222,171.0,89.0,83.0
0.072,17,2,184,1,61,0.0,33.0,33.0,1,123,0.0,95.0,95.0
0.005,17,2,261,1,74,0.0,46.0,46.0,1,187,0.0,159.0,159.0
0.008,6,10,2000,5,927,2.0,659.0,659.0,5,1073,1.0,805.0,805.0
0.006,6,10,2000,5,927,1.0,659.0,659.0,5,1073,1.0,805.0,805.0
0.051,17,2,152,1,76,0.0,48.0,48.0,1,76,0.0,48.0,48.0
0.014,6,10,1983,5,910,3.0,642.0,642.0,5,1073,3.0,805.0,805.0
0.005,6,10,2006,5,927,1.0,659.0,659.0,5,1079,1.0,811.0,811.0
0.009,6,10,1989,5,910,2.0,642.0,642.0,5,1079,2.0,811.0,811.0
0.003,17,2,152,1,76,0.0,48.0,48.0,1,76,0.0,48.0,48.0
0.094,6,10,1506,5,395,17.0,127.0,127.0,5,1111,20.0,843.0,843.0
0.002,17,2,152,1,76,0.0,48.0,48.0,1,76,0.0,48.0,48.0
0.132,17,2,194,1,59,0.0,31.0,31.0,1,135,0.0,107.0,107.0
300.355,6,16,2170,9,684,37523.0,146.0,146.0,7,1486,50030.0,419.0,398.0
0.011,6,13,3735,7,497,1.0,125.0,125.0,6,3238,2.0,1470.0,1459.0
0.011,6,10,1989,5,910,2.0,642.0,642.0,5,1079,2.0,811.0,811.0
0.04,17,2,144,1,64,0.0,36.0,36.0,1,80,0.0,52.0,52.0
0.007,17,4,284,2,120,0.0,32.0,32.0,2,164,0.0,60.0,54.0
0.071,6,10,1506,5,395,15.0,127.0,127.0,5,1111,15.0,843.0,843.0
1769.232,17,92,8096,46,4048,39316.0,60.0,60.0,46,4048,39316.0,60.0,60.0
0.005,17,2,144,1,64,0.0,36.0,36.0,1,80,0.0,52.0,52.0
0.005,6,10,2007,5,928,1.0,660.0,660.0,5,1079,1.0,811.0,811.0
0.086,6,10,1506,5,395,18.0,127.0,127.0,5,1111,17.0,843.0,843.0
0.219,6,16,2670,8,1396,31.0,533.0,324.0,8,1274,20.0,529.0,212.0
0.078,6,13,3816,7,578,13.0,206.0,206.0,6,3238,15.0,1470.0,1459.0
0.004,6,10,2007,5,928,1.0,660.0,660.0,5,1079,1.0,811.0,811.0
1799.428,17,3040,232921,1510,122354,1192.0,75.0,53.0,1530,110567,1176.0,227.0,44.0
0.007,17,2,179,1,71,0.0,43.0,43.0,1,108,0.0,80.0,80.0
0.005,17,2,222,1,65,0.0,37.0,37.0,1,157,0.0,129.0,129.0
0.079,6,10,1506,5,395,17.0,127.0,127.0,5,1111,18.0,843.0,843.0
40.088,17,10,676,5,460,10021.0,104.0,64.0,5,216,10021.0,20.0,15.0
0.005,6,10,1989,5,927,1.0,659.0,659.0,5,1062,1.0,794.0,794.0
1756.063,6,105,6270,60,3525,29763.0,27.0,27.0,45,2745,39909.0,27.0,27.0
0.132,17,2,170,1,65,0.0,37.0,37.0,1,105,0.0,77.0,77.0
0.005,17,2,212,1,74,0.0,46.0,46.0,1,138,0.0,110.0,110.0
0.004,6,10,2006,5,927,1.0,659.0,659.0,5,1079,1.0,811.0,811.0
294.947,6,312,344375,120,17794,2478.0,2736.0,825.0,192,326581,1544.0,4171.0,1778.0
0.018,6,10,1990,5,911,4.0,643.0,643.0,5,1079,4.0,811.0,811.0
0.008,6,10,1989,5,927,2.0,659.0,659.0,5,1062,2.0,794.0,794.0
0.028,6,10,1989,5,910,7.0,642.0,642.0,5,1079,7.0,811.0,811.0
0.214,6,10,1506,5,395,27.0,127.0,127.0,5,1111,49.0,843.0,843.0
0.005,6,10,1854,5,889,1.0,621.0,621.0,5,965,1.0,697.0,697.0
0.005,17,2,169,1,62,0.0,34.0,34.0,1,107,0.0,79.0,79.0
0.011,6,10,1989,5,910,2.0,642.0,642.0,5,1079,2.0,811.0,811.0
0.008,6,10,1989,5,910,2.0,642.0,642.0,5,1079,1.0,811.0,811.0
0.086,6,10,1506,5,395,18.0,127.0,127.0,5,1111,18.0,843.0,843.0
0.005,6,10,1854,5,889,1.0,621.0,621.0,5,965,1.0,697.0,697.0
40.073,17,10,676,5,460,10016.0,104.0,64.0,5,216,10017.0,20.0,15.0
0.005,6,10,2000,5,927,1.0,659.0,659.0,5,1073,1.0,805.0,805.0
300.765,6,40,12798,22,7280,14322.0,2720.0,909.0,18,5518,505.0,2667.0,435.0
0.005,6,10,1643,5,860,1.0,592.0,592.0,5,783,1.0,515.0,515.0
240.137,6,34,13132,17,6958,15008.0,1977.0,675.0,17,6174,15008.0,2378.0,586.0
0.004,6,10,1702,5,863,1.0,595.0,595.0,5,839,1.0,571.0,571.0
0.08,6,10,1506,5,395,17.0,127.0,127.0,5,1111,18.0,843.0,843.0
0.02,6,10,1972,5,910,5.0,642.0,642.0,5,1062,5.0,794.0,794.0
0.011,6,10,1972,5,910,2.0,642.0,642.0,5,1062,2.0,794.0,794.0
0.025,17,2,148,1,60,0.0,32.0,32.0,1,88,0.0,60.0,60.0
0.006,6,10,1643,5,860,1.0,592.0,592.0,5,783,1.0,515.0,515.0
0.041,17,2,170,1,65,0.0,37.0,37.0,1,105,0.0,77.0,77.0
0.129,17,2,136,1,60,0.0,32.0,32.0,1,76,0.0,48.0,48.0
40.063,17,10,676,5,460,10013.0,104.0,64.0,5,216,10011.0,20.0,15.0
0.016,6,10,1631,5,848,4.0,580.0,580.0,5,783,3.0,515.0,515.0
0.005,17,2,169,1,62,0.0,34.0,34.0,1,107,0.0,79.0,79.0
0.007,17,2,179,1,71,0.0,43.0,43.0,1,108,0.0,80.0,80.0
0.004,6,10,2000,5,927,1.0,659.0,659.0,5,1073,1.0,805.0,805.0
0.013,6,10,1990,5,911,3.0,643.0,643.0,5,1079,3.0,811.0,811.0
0.006,17,2,238,1,66,0.0,38.0,38.0,1,172,0.0,144.0,144.0
40.071,17,10,676,5,460,10016.0,104.0,64.0,5,216,10016.0,20.0,15.0
0.004,6,10,1774,5,923,1.0,655.0,655.0,5,851,1.0,583.0,583.0
0.01,6,10,1989,5,910,2.0,642.0,642.0,5,1079,2.0,811.0,811.0
0.012,6,10,1972,5,910,2.0,642.0,642.0,5,1062,3.0,794.0,794.0
1756.063,6,105,6270,60,3525,29763.0,27.0,27.0,45,2745,39909.0,27.0,27.0
361.809,6,21,1793,16,1030,24120.0,190.0,190.0,5,763,60010.0,462.0,247.0
0.01,6,10,1631,5,848,2.0,580.0,580.0,5,783,2.0,515.0,515.0
0.005,6,10,1989,5,927,1.0,659.0,659.0,5,1062,1.0,794.0,794.0
0.121,6,10,1506,5,395,28.0,127.0,127.0,5,1111,28.0,843.0,843.0
0.006,6,10,2007,5,928,1.0,660.0,660.0,5,1079,1.0,811.0,811.0
0.037,17,2,166,1,75,0.0,47.0,47.0,1,91,0.0,63.0,63.0
0.006,6,10,1547,5,764,1.0,496.0,496.0,5,783,1.0,515.0,515.0
15.069,17,15,9238,8,6902,2148.0,1350.0,834.0,7,2336,2506.0,1350.0,305.0
0.041,17,4,284,2,120,0.0,32.0,32.0,2,164,37.0,60.0,54.0
0.191,6,10,1506,5,395,46.0,127.0,127.0,5,1111,45.0,843.0,843.0
11.109,17,28,4389,14,2312,845.0,587.0,137.0,14,2077,845.0,268.0,120.0
0.003,6,10,1702,5,863,0.0,595.0,595.0,5,839,0.0,571.0,571.0
0.017,6,10,1989,5,910,4.0,642.0,642.0,5,1079,4.0,811.0,811.0
0.013,6,10,1762,5,911,3.0,643.0,643.0,5,851,3.0,583.0,583.0
0.006,6,10,1689,5,839,1.0,571.0,571.0,5,850,1.0,582.0,582.0
0.008,6,10,1677,5,827,2.0,559.0,559.0,5,850,1.0,582.0,582.0
0.074,6,10,1506,5,395,16.0,127.0,127.0,5,1111,17.0,843.0,843.0
0.008,6,10,1631,5,848,1.0,580.0,580.0,5,783,2.0,515.0,515.0
0.016,6,10,1989,5,910,3.0,642.0,642.0,5,1079,3.0,811.0,811.0
0.009,6,10,1989,5,910,2.0,642.0,642.0,5,1079,2.0,811.0,811.0
0.005,6,10,2006,5,927,1.0,659.0,659.0,5,1079,1.0,811.0,811.0
0.005,6,15,3794,8,504,0.0,80.0,80.0,7,3290,0.0,1448.0,972.0
1797.589,17,3358,257561,1664,134852,1080.0,84.0,53.0,1694,122709,1061.0,227.0,44.0
0.007,6,10,2000,5,927,1.0,659.0,659.0,5,1073,1.0,805.0,805.0
0.005,6,10,2007,5,928,1.0,660.0,660.0,5,1079,1.0,811.0,811.0
0.006,6,10,1547,5,764,1.0,496.0,496.0,5,783,1.0,515.0,515.0
0.092,6,10,1506,5,395,21.0,127.0,127.0,5,1111,21.0,843.0,843.0
300.147,6,39,9820,20,4262,15788.0,1686.0,686.0,19,5558,16665.0,1360.0,398.0
1.877,6,36,6735,19,3451,104.0,1103.0,204.0,17,3284,109.0,1796.0,396.0
0.004,6,10,1774,5,923,1.0,655.0,655.0,5,851,1.0,583.0,583.0
0.005,6,10,2007,5,928,1.0,660.0,660.0,5,1079,1.0,811.0,811.0
0.005,6,10,1643,5,860,1.0,592.0,592.0,5,783,1.0,515.0,515.0
40.068,17,10,676,5,460,10016.0,104.0,64.0,5,216,10016.0,20.0,15.0
0.003,17,2,148,1,60,0.0,32.0,32.0,1,88,0.0,60.0,60.0
0.121,6,10,1506,5,395,28.0,127.0,127.0,5,1111,27.0,843.0,843.0
0.039,17,4,284,2,120,0.0,32.0,32.0,2,164,36.0,60.0,54.0
0.004,6,10,2000,5,927,1.0,659.0,659.0,5,1073,1.0,805.0,805.0
0.084,6,10,1506,5,395,16.0,127.0,127.0,5,1111,18.0,843.0,843.0
0.004,6,10,2006,5,927,1.0,659.0,659.0,5,1079,1.0,811.0,811.0
0.01,6,13,3735,7,497,1.0,125.0,125.0,6,3238,2.0,1470.0,1459.0
0.072,17,2,396,1,61,0.0,33.0,33.0,1,335,0.0,307.0,307.0
0.017,6,10,1972,5,910,4.0,642.0,642.0,5,1062,4.0,794.0,794.0
0.006,6,10,1547,5,764,1.0,496.0,496.0,5,783,1.0,515.0,515.0
0.011,6,10,1972,5,910,2.0,642.0,642.0,5,1062,2.0,794.0,794.0
0.004,6,10,1989,5,927,1.0,659.0,659.0,5,1062,1.0,794.0,794.0
40.057,17,10,676,5,460,10013.0,104.0,64.0,5,216,10013.0,20.0,15.0
0.007,6,10,2006,5,927,1.0,659.0,659.0,5,1079,1.0,811.0,811.0
40.062,17,10,676,5,460,10014.0,104.0,64.0,5,216,10014.0,20.0,15.0
0.031,17,2,136,1,60,0.0,32.0,32.0,1,76,0.0,48.0,48.0
0.016,6,10,1990,5,911,4.0,643.0,643.0,5,1079,4.0,811.0,811.0
0.006,6,10,1689,5,839,1.0,571.0,571.0,5,850,1.0,582.0,582.0
309.781,17,20,1124,10,716,34406.0,48.0,43.0,10,408,34406.0,20.0,12.0
0.011,6,10,1989,5,910,2.0,642.0,642.0,5,1079,2.0,811.0,811.0
0.005,17,2,170,1,65,0.0,37.0,37.0,1,105,0.0,77.0,77.0
0.004,6,10,1989,5,927,1.0,659.0,659.0,5,1062,1.0,794.0,794.0
0.005,17,2,170,1,65,0.0,37.0,37.0,1,105,0.0,77.0,77.0
0.007,6,10,1854,5,889,1.0,621.0,621.0,5,965,1.0,697.0,697.0
0.011,6,10,1989,5,910,2.0,642.0,642.0,5,1079,2.0,811.0,811.0
0.09,6,10,1506,5,395,20.0,127.0,127.0,5,1111,19.0,843.0,843.0
0.077,6,10,1506,5,395,17.0,127.0,127.0,5,1111,15.0,843.0,843.0
0.112,6,10,1506,5,395,24.0,127.0,127.0,5,1111,26.0,843.0,843.0
309.082,17,20,1124,10,716,34328.0,48.0,43.0,10,408,34328.0,20.0,12.0
0.004,6,10,2006,5,927,1.0,659.0,659.0,5,1079,1.0,811.0,811.0
0.12,6,10,1506,5,395,25.0,127.0,127.0,5,1111,26.0,843.0,843.0
0.299,17,50,26571,27,22673,11.0,1350.0,811.0,23,3898,12.0,1350.0,141.0
11.179,17,28,4419,14,1994,847.0,269.0,114.0,14,2425,847.0,588.0,145.0
0.013,6,10,1990,5,911,3.0,643.0,643.0,5,1079,3.0,811.0,811.0
0.016,6,10,1989,5,910,3.0,642.0,642.0,5,1079,3.0,811.0,811.0
0.065,6,13,3735,7,497,10.0,125.0,125.0,6,3238,13.0,1470.0,1459.0
0.072,6,10,1506,5,395,16.0,127.0,127.0,5,1111,15.0,843.0,843.0
0.004,17,4,420,2,122,0.0,33.0,33.0,2,298,0.0,145.0,121.0
0.01,6,10,1631,5,848,2.0,580.0,580.0,5,783,2.0,515.0,515.0
240.092,6,32,9276,16,6942,16006.0,1515.0,611.0,16,2334,16005.0,580.0,186.0
0.025,6,10,2006,5,927,6.0,659.0,659.0,5,1079,6.0,811.0,811.0
5.128,6,25,7106,14,1891,394.0,801.0,282.0,11,5215,512.0,1925.0,774.0
0.001,17,2,179,1,62,0.0,34.0,34.0,1,117,0.0,89.0,89.0
312.146,17,20,1124,10,716,34668.0,48.0,43.0,10,408,34668.0,20.0,12.0
0.083,6,10,1506,5,395,18.0,127.0,127.0,5,1111,16.0,843.0,843.0
0.003,17,2,148,1,60,0.0,32.0,32.0,1,88,0.0,60.0,60.0
0.14,6,10,1506,5,395,30.0,127.0,127.0,5,1111,23.0,843.0,843.0
368.609,6,22,2313,16,867,24573.0,195.0,195.0,6,1446,4636.0,419.0,398.0
0.004,17,2,148,1,60,0.0,32.0,32.0,1,88,0.0,60.0,60.0
0.185,6,10,1506,5,395,43.0,127.0,127.0,5,1111,40.0,843.0,843.0
0.006,6,10,1547,5,764,1.0,496.0,496.0,5,783,1.0,515.0,515.0
0.007,6,10,1547,5,764,1.0,496.0,496.0,5,783,1.0,515.0,515.0
0.115,6,10,1506,5,395,27.0,127.0,127.0,5,1111,24.0,843.0,843.0
0.001,17,2,180,1,65,0.0,37.0,37.0,1,115,0.0,87.0,87.0
0.009,6,10,1983,5,910,2.0,642.0,642.0,5,1073,2.0,805.0,805.0
0.039,17,2,170,1,65,0.0,37.0,37.0,1,105,0.0,77.0,77.0
354.03,6,21,1795,16,1030,23602.0,190.0,190.0,5,765,60004.0,464.0,248.0
0.005,6,10,2000,5,927,1.0,659.0,659.0,5,1073,1.0,805.0,805.0
0.008,6,12,1926,6,1189,1.0,659.0,434.0,6,737,1.0,417.0,417.0
0.005,17,2,136,1,60,0.0,32.0,32.0,1,76,0.0,48.0,48.0
0.014,6,10,1989,5,910,3.0,642.0,642.0,5,1079,3.0,811.0,811.0
0.018,17,4,284,2,120,4.0,32.0,32.0,2,164,3.0,60.0,54.0
0.005,6,10,1689,5,839,1.0,571.0,571.0,5,850,1.0,582.0,582.0
308.608,17,18,1008,9,640,38568.0,48.0,43.0,9,368,38568.0,20.0,12.0
0.005,6,10,1547,5,764,1.0,496.0,496.0,5,783,1.0,515.0,515.0
0.02,6,10,1762,5,911,5.0,643.0,643.0,5,851,4.0,583.0,583.0
0.023,6,10,1631,5,848,5.0,580.0,580.0,5,783,5.0,515.0,515.0
40.075,17,10,676,5,460,10015.0,104.0,64.0,5,216,10017.0,20.0,15.0
15.072,17,16,10617,9,8280,1880.0,1350.0,892.0,7,2337,2508.0,1350.0,305.0
0.001,17,2,136,1,60,0.0,32.0,32.0,1,76,0.0,48.0,48.0
0.022,17,2,166,1,75,0.0,47.0,47.0,1,91,0.0,63.0,63.0
0.005,17,2,169,1,62,0.0,34.0,34.0,1,107,0.0,79.0,79.0
240.013,6,9,787,5,488,60003.0,232.0,232.0,4,299,80003.0,83.0,83.0
0.018,6,10,1989,5,910,4.0,642.0,642.0,5,1079,4.0,811.0,811.0
0.01,6,10,1989,5,910,2.0,642.0,642.0,5,1079,2.0,811.0,811.0
0.011,6,10,1983,5,910,2.0,642.0,642.0,5,1073,2.0,805.0,805.0
0.041,17,4,284,2,120,0.0,32.0,32.0,2,164,37.0,60.0,54.0
0.001,17,2,180,1,66,0.0,38.0,38.0,1,114,0.0,86.0,86.0
40.08,17,10,676,5,460,10019.0,104.0,64.0,5,216,10019.0,20.0,15.0
40.067,17,10,676,5,460,10014.0,104.0,64.0,5,216,10016.0,20.0,15.0
1786.912,6,160,20366,93,14206,19422.0,302.0,302.0,67,6160,27074.0,83.0,83.0
0.012,6,10,1990,5,911,3.0,643.0,643.0,5,1079,3.0,811.0,811.0
0.101,6,10,1506,5,395,21.0,127.0,127.0,5,1111,22.0,843.0,843.0
0.018,6,10,1677,5,827,4.0,559.0,559.0,5,850,4.0,582.0,582.0
0.163,17,2,152,1,76,0.0,48.0,48.0,1,76,0.0,48.0,48.0
0.001,17,2,180,1,66,0.0,38.0,38.0,1,114,0.0,86.0,86.0
11.18,17,28,4422,14,1994,847.0,269.0,114.0,14,2428,847.0,587.0,145.0
0.006,6,10,1547,5,764,1.0,496.0,496.0,5,783,1.0,515.0,515.0
40.059,17,10,676,5,460,10013.0,104.0,64.0,5,216,10013.0,20.0,15.0
0.006,6,10,1547,5,764,1.0,496.0,496.0,5,783,1.0,515.0,515.0
0.004,17,2,136,1,60,0.0,32.0,32.0,1,76,0.0,48.0,48.0
0.005,17,2,144,1,64,0.0,36.0,36.0,1,80,0.0,52.0,52.0
0.064,6,10,1506,5,395,15.0,127.0,127.0,5,1111,12.0,843.0,843.0
0.011,6,10,1989,5,910,2.0,642.0,642.0,5,1079,2.0,811.0,811.0
0.024,6,10,1990,5,911,5.0,643.0,643.0,5,1079,5.0,811.0,811.0
1770.671,6,309,98706,189,87116,9418.0,2001.0,683.0,120,11590,14879.0,452.0,71.0
361.856,6,21,1793,16,1030,24123.0,190.0,190.0,5,763,60011.0,462.0,247.0
0.005,17,2,140,1,62,0.0,34.0,34.0,1,78,0.0,50.0,50.0
0.005,6,10,2006,5,927,1.0,659.0,659.0,5,1079,1.0,811.0,811.0
40.06,17,10,676,5,460,10014.0,104.0,64.0,5,216,10014.0,20.0,15.0
0.012,6,13,3735,7,497,1.0,125.0,125.0,6,3238,2.0,1470.0,1459.0
1773.015,6,303,97487,186,86334,9583.0,2001.0,690.0,117,11153,15284.0,452.0,70.0
0.005,17,2,169,1,62,0.0,34.0,34.0,1,107,0.0,79.0,79.0
0.005,6,10,1989,5,927,1.0,659.0,659.0,5,1062,1.0,794.0,794.0
240.1,6,16,4481,9,963,30012.0,238.0,166.0,7,3518,40016.0,1402.0,786.0
0.016,6,10,1989,5,910,4.0,642.0,642.0,5,1079,4.0,811.0,811.0
0.006,6,10,1547,5,764,1.0,496.0,496.0,5,783,1.0,515.0,515.0
0.119,17,2,412,1,61,0.0,33.0,33.0,1,351,0.0,323.0,323.0
0.001,17,2,180,1,66,0.0,38.0,38.0,1,114,0.0,86.0,86.0
0.041,17,2,148,1,60,0.0,32.0,32.0,1,88,0.0,60.0,60.0
0.006,6,10,2007,5,928,1.0,660.0,660.0,5,1079,1.0,811.0,811.0
0.005,6,10,2007,5,928,1.0,660.0,660.0,5,1079,1.0,811.0,811.0
241.557,6,314,344001,115,17490,2118.0,2736.0,959.0,199,326511,1219.0,2804.0,1672.0
0.012,6,10,1972,5,910,2.0,642.0,642.0,5,1062,3.0,794.0,794.0
1799.841,6,136,6550,76,3625,23997.0,39.0,39.0,60,2925,29993.0,35.0,35.0
309.767,17,20,1124,10,716,34405.0,48.0,43.0,10,408,34404.0,20.0,12.0
0.012,6,10,1972,5,910,3.0,642.0,642.0,5,1062,2.0,794.0,794.0
0.004,6,10,1702,5,863,1.0,595.0,595.0,5,839,1.0,571.0,571.0
0.073,6,10,1506,5,395,17.0,127.0,127.0,5,1111,17.0,843.0,843.0
0.004,6,10,1774,5,923,1.0,655.0,655.0,5,851,1.0,583.0,583.0
0.008,6,10,1989,5,910,2.0,642.0,642.0,5,1079,2.0,811.0,811.0
0.003,17,2,160,1,72,0.0,44.0,44.0,1,88,0.0,60.0,60.0
0.018,6,10,1989,5,910,4.0,642.0,642.0,5,1079,4.0,811.0,811.0
0.212,6,16,2669,8,1395,30.0,533.0,323.0,8,1274,19.0,529.0,212.0
0.004,6,10,1989,5,927,1.0,659.0,659.0,5,1062,1.0,794.0,794.0
15.078,17,18,8665,9,6109,1881.0,1350.0,650.0,9,2556,1881.0,1350.0,256.0
0.001,17,2,180,1,66,0.0,38.0,38.0,1,114,0.0,86.0,86.0
0.008,6,12,1926,6,1189,1.0,659.0,434.0,6,737,1.0,417.0,417.0
0.122,6,10,1506,5,395,26.0,127.0,127.0,5,1111,29.0,843.0,843.0
0.004,6,10,1779,5,928,1.0,660.0,660.0,5,851,1.0,583.0,583.0
0.006,6,13,3690,7,452,1.0,80.0,80.0,6,3238,1.0,1470.0,1459.0
0.014,6,10,1677,5,827,3.0,559.0,559.0,5,850,3.0,582.0,582.0
369.451,6,22,2313,16,867,24630.0,195.0,195.0,6,1446,4638.0,419.0,398.0
240.287,6,42,8719,21,5686,12014.0,1515.0,509.0,21,3033,12014.0,580.0,241.0
0.085,6,10,1506,5,395,20.0,127.0,127.0,5,1111,18.0,843.0,843.0
0.105,6,10,1506,5,395,23.0,127.0,127.0,5,1111,20.0,843.0,843.0
353.2,6,20,2210,6,1308,12003.0,494.0,494.0,14,902,27169.0,83.0,83.0
15.073,17,15,9238,8,6902,2149.0,1350.0,834.0,7,2336,2506.0,1350.0,305.0
0.008,6,10,1989,5,910,2.0,642.0,642.0,5,1079,1.0,811.0,811.0
0.082,6,10,1506,5,395,18.0,127.0,127.0,5,1111,18.0,843.0,843.0
0.001,17,2,180,1,66,0.0,38.0,38.0,1,114,0.0,86.0,86.0
0.004,6,10,1702,5,863,0.0,595.0,595.0,5,839,1.0,571.0,571.0
0.005,6,10,1989,5,927,1.0,659.0,659.0,5,1062,1.0,794.0,794.0
0.004,6,10,2000,5,927,1.0,659.0,659.0,5,1073,1.0,805.0,805.0
0.027,6,10,1989,5,910,6.0,642.0,642.0,5,1079,6.0,811.0,811.0
0.006,6,10,1547,5,764,1.0,496.0,496.0,5,783,1.0,515.0,515.0
0.013,6,10,1972,5,910,3.0,642.0,642.0,5,1062,3.0,794.0,794.0
0.005,6,10,2006,5,927,1.0,659.0,659.0,5,1079,1.0,811.0,811.0
0.221,6,16,2777,8,1395,31.0,533.0,323.0,8,1382,20.0,529.0,239.0
151.169,6,22,7437,11,1305,126.0,530.0,277.0,11,6132,15100.0,1823.0,946.0
0.006,6,10,1547,5,764,1.0,496.0,496.0,5,783,1.0,515.0,515.0
42.836,6,36,9704,18,4186,520.0,1753.0,858.0,18,5518,2509.0,2667.0,435.0
0.008,6,10,1989,5,910,2.0,642.0,642.0,5,1079,1.0,811.0,811.0
300.336,6,16,2170,9,684,37522.0,146.0,146.0,7,1486,50029.0,419.0,398.0
0.147,6,10,1506,5,395,31.0,127.0,127.0,5,1111,34.0,843.0,843.0
0.013,6,10,1677,5,827,3.0,559.0,559.0,5,850,3.0,582.0,582.0
0.012,6,10,1989,5,910,3.0,642.0,642.0,5,1079,3.0,811.0,811.0
0.005,6,10,1774,5,923,1.0,655.0,655.0,5,851,1.0,583.0,583.0
0.115,6,10,1506,5,395,25.0,127.0,127.0,5,1111,22.0,843.0,843.0
0.005,6,10,2007,5,928,1.0,660.0,660.0,5,1079,1.0,811.0,811.0
0.103,6,10,1506,5,395,21.0,127.0,127.0,5,1111,22.0,843.0,843.0
0.003,17,2,412,1,61,0.0,33.0,33.0,1,351,0.0,323.0,323.0
0.005,6,10,2006,5,927,1.0,659.0,659.0,5,1079,1.0,811.0,811.0
0.005,6,10,2006,5,927,1.0,659.0,659.0,5,1079,1.0,811.0,811.0
0.166,6,3,453,2,321,166.0,241.0,241.0,1,132,0.0,92.0,92.0
0.108,6,10,1506,5,395,24.0,127.0,127.0,5,1111,21.0,843.0,843.0
178.152,17,92,13168,46,3105,3958.0,44.0,39.0,46,10063,3958.0,239.0,190.0
0.129,17,2,80,1,32,0.0,4.0,4.0,1,48,0.0,20.0,20.0
0.006,6,10,1547,5,764,1.0,496.0,496.0,5,783,1.0,515.0,515.0
0.014,6,10,1631,5,848,3.0,580.0,580.0,5,783,3.0,515.0,515.0
1730.419,6,45,2790,30,1725,59669.0,35.0,35.0,15,1065,123596.0,31.0,31.0
0.004,6,10,2007,5,928,1.0,660.0,660.0,5,1079,1.0,811.0,811.0
0.005,6,10,1689,5,839,1.0,571.0,571.0,5,850,1.0,582.0,582.0
0.005,6,10,1989,5,927,1.0,659.0,659.0,5,1062,1.0,794.0,794.0
0.005,6,10,1774,5,923,1.0,655.0,655.0,5,851,1.0,583.0,583.0
0.014,6,10,1989,5,910,3.0,642.0,642.0,5,1079,3.0,811.0,811.0
309.441,17,20,1124,10,716,34368.0,48.0,43.0,10,408,34368.0,20.0,12.0
0.108,6,10,1506,5,395,26.0,127.0,127.0,5,1111,25.0,843.0,843.0
0.009,6,10,1677,5,827,2.0,559.0,559.0,5,850,2.0,582.0,582.0
0.006,6,10,1547,5,764,1.0,496.0,496.0,5,783,1.0,515.0,515.0
10.862,17,28,4421,14,1993,827.0,268.0,114.0,14,2428,827.0,587.0,145.0
10.955,17,28,4390,14,2312,834.0,587.0,137.0,14,2078,834.0,269.0,120.0
0.116,6,10,1506,5,395,27.0,127.0,127.0,5,1111,24.0,843.0,843.0
0.005,6,10,1643,5,860,1.0,592.0,592.0,5,783,1.0,515.0,515.0
280.597,6,25,6155,11,1226,28059.0,267.0,156.0,14,4929,21582.0,1400.0,873.0
0.005,17,2,230,1,68,0.0,40.0,40.0,1,162,0.0,134.0,134.0
0.138,6,10,1506,5,395,31.0,127.0,127.0,5,1111,30.0,843.0,843.0
0.011,6,10,1990,5,911,2.0,643.0,643.0,5,1079,2.0,811.0,811.0
0.163,6,10,1506,5,395,29.0,127.0,127.0,5,1111,34.0,843.0,843.0
0.004,6,10,2006,5,927,1.0,659.0,659.0,5,1079,1.0,811.0,811.0
0.004,6,10,2000,5,927,1.0,659.0,659.0,5,1073,1.0,805.0,805.0
240.087,6,28,6889,14,4533,18468.0,1368.0,476.0,14,2356,18468.0,580.0,202.0
0.005,17,2,136,1,60,0.0,32.0,32.0,1,76,0.0,48.0,48.0
0.005,6,10,2007,5,928,1.0,660.0,660.0,5,1079,1.0,811.0,811.0
0.07,17,8,3613,4,1874,23.0,1350.0,440.0,4,1739,12.0,1350.0,406.0
333.587,17,20,1124,10,716,37050.0,48.0,43.0,10,408,37050.0,20.0,12.0
0.005,6,10,2006,5,927,1.0,659.0,659.0,5,1079,1.0,811.0,811.0
0.018,6,10,2006,5,927,4.0,659.0,659.0,5,1079,4.0,811.0,811.0
0.114,6,10,1506,5,395,25.0,127.0,127.0,5,1111,23.0,843.0,843.0
0.004,6,10,1989,5,927,1.0,659.0,659.0,5,1062,1.0,794.0,794.0
0.14,6,10,1506,5,395,32.0,127.0,127.0,5,1111,31.0,843.0,843.0
0.005,6,10,2006,5,927,1.0,659.0,659.0,5,1079,1.0,811.0,811.0
0.005,6,10,2006,5,927,1.0,659.0,659.0,5,1079,1.0,811.0,811.0
0.113,6,10,1506,5,395,25.0,127.0,127.0,5,1111,17.0,843.0,843.0
15.071,17,15,9238,8,6902,2148.0,1350.0,834.0,7,2336,2507.0,1350.0,305.0
0.004,6,10,1702,5,863,0.0,595.0,595.0,5,839,1.0,571.0,571.0
1756.079,6,105,6270,60,3525,29763.0,27.0,27.0,45,2745,39909.0,27.0,27.0
0.003,17,2,136,1,60,0.0,32.0,32.0,1,76,0.0,48.0,48.0
0.121,6,10,1506,5,395,24.0,127.0,127.0,5,1111,22.0,843.0,843.0
0.006,6,10,2006,5,927,1.0,659.0,659.0,5,1079,1.0,811.0,811.0
10.896,17,28,4423,14,1994,830.0,269.0,114.0,14,2429,830.0,588.0,145.0
293.341,6,392,347311,200,21959,1474.0,2736.0,888.0,192,325352,1535.0,2804.0,1771.0
0.124,6,10,1506,5,395,27.0,127.0,127.0,5,1111,25.0,843.0,843.0
0.117,6,10,1506,5,395,24.0,127.0,127.0,5,1111,22.0,843.0,843.0
0.005,17,2,164,1,74,0.0,46.0,46.0,1,90,0.0,62.0,62.0
0.001,17,2,180,1,66,0.0,38.0,38.0,1,114,0.0,86.0,86.0
240.11,6,19,8108,10,2075,26678.0,1495.0,779.0,9,6033,30013.0,2804.0,1111.0
0.01,6,13,3735,7,497,1.0,125.0,125.0,6,3238,2.0,1470.0,1459.0
0.041,17,2,182,1,65,0.0,37.0,37.0,1,117,0.0,89.0,89.0
0.009,6,10,1631,5,848,2.0,580.0,580.0,5,783,2.0,515.0,515.0
0.011,6,10,1972,5,910,2.0,642.0,642.0,5,1062,2.0,794.0,794.0
0.011,6,10,1989,5,910,2.0,642.0,642.0,5,1079,2.0,811.0,811.0
0.011,6,10,1677,5,827,2.0,559.0,559.0,5,850,2.0,582.0,582.0
331.764,6,20,7073,10,2811,36862.0,662.0,456.0,10,4262,36862.0,1402.0,936.0
0.005,6,10,2006,5,927,1.0,659.0,659.0,5,1079,1.0,811.0,811.0
0.009,6,10,1983,5,910,2.0,642.0,642.0,5,1073,2.0,805.0,805.0
40.071,17,10,676,5,460,10016.0,104.0,64.0,5,216,10016.0,20.0,15.0
0.123,17,4,284,2,120,0.0,32.0,32.0,2,164,86.0,60.0,54.0
15.071,17,14,9191,8,6902,2149.0,1350.0,834.0,6,2289,3008.0,1350.0,353.0
0.004,17,4,420,2,122,0.0,33.0,33.0,2,298,0.0,145.0,121.0
0.001,17,2,180,1,66,0.0,38.0,38.0,1,114,0.0,86.0,86.0
0.067,17,8,3613,4,1874,22.0,1350.0,440.0,4,1739,11.0,1350.0,406.0
0.126,17,2,412,1,61,0.0,33.0,33.0,1,351,0.0,323.0,323.0
0.006,6,10,1643,5,860,1.0,592.0,592.0,5,783,1.0,515.0,515.0
0.009,6,10,1990,5,911,2.0,643.0,643.0,5,1079,2.0,811.0,811.0
0.117,6,10,1506,5,395,26.0,127.0,127.0,5,1111,24.0,843.0,843.0
0.005,6,10,1779,5,928,1.0,660.0,660.0,5,851,1.0,583.0,583.0
0.008,6,10,1989,5,910,2.0,642.0,642.0,5,1079,2.0,811.0,811.0
0.003,17,4,284,2,120,0.0,32.0,32.0,2,164,0.0,60.0,54.0
0.098,6,10,1506,5,395,22.0,127.0,127.0,5,1111,22.0,843.0,843.0
0.814,6,25,5555,12,1445,64.0,267.0,136.0,13,4110,57.0,1414.0,597.0
0.016,6,10,1983,5,910,4.0,642.0,642.0,5,1073,4.0,805.0,805.0
0.012,6,10,1989,5,910,2.0,642.0,642.0,5,1079,2.0,811.0,811.0
0.013,6,10,1989,5,910,3.0,642.0,642.0,5,1079,3.0,811.0,811.0
240.292,6,42,8719,21,5686,12014.0,1515.0,509.0,21,3033,12014.0,580.0,241.0
0.016,6,10,1983,5,910,4.0,642.0,642.0,5,1073,3.0,805.0,805.0
0.004,6,10,1702,5,863,1.0,595.0,595.0,5,839,0.0,571.0,571.0
0.01,6,10,1989,5,910,2.0,642.0,642.0,5,1079,2.0,811.0,811.0
0.012,6,10,1983,5,910,2.0,642.0,642.0,5,1073,2.0,805.0,805.0
0.004,17,4,352,2,130,0.0,37.0,37.0,2,222,0.0,89.0,83.0
0.065,6,10,1506,5,395,15.0,127.0,127.0,5,1111,14.0,843.0,843.0
0.016,6,10,1983,5,910,4.0,642.0,642.0,5,1073,4.0,805.0,805.0
0.005,6,10,2000,5,927,1.0,659.0,659.0,5,1073,1.0,805.0,805.0
0.004,6,10,2006,5,927,1.0,659.0,659.0,5,1079,1.0,811.0,811.0
0.012,6,10,1631,5,848,3.0,580.0,580.0,5,783,3.0,515.0,515.0
0.005,17,2,140,1,62,0.0,34.0,34.0,1,78,0.0,50.0,50.0
0.005,6,10,1989,5,927,1.0,659.0,659.0,5,1062,1.0,794.0,794.0
0.004,6,10,2006,5,927,1.0,659.0,659.0,5,1079,1.0,811.0,811.0
0.04,17,2,170,1,65,0.0,37.0,37.0,1,105,0.0,77.0,77.0
0.018,6,10,1631,5,848,4.0,580.0,580.0,5,783,4.0,515.0,515.0
0.009,6,10,1972,5,910,2.0,642.0,642.0,5,1062,2.0,794.0,794.0
0.005,6,10,1774,5,923,1.0,655.0,655.0,5,851,1.0,583.0,583.0
0.004,17,2,136,1,60,0.0,32.0,32.0,1,76,0.0,48.0,48.0
0.004,6,10,2007,5,928,1.0,660.0,660.0,5,1079,1.0,811.0,811.0
0.004,6,10,1989,5,927,1.0,659.0,659.0,5,1062,1.0,794.0,794.0
0.011,6,10,1989,5,910,2.0,642.0,642.0,5,1079,2.0,811.0,811.0
0.168,17,2,152,1,76,0.0,48.0,48.0,1,76,0.0,48.0,48.0
0.02,6,10,1990,5,911,4.0,643.0,643.0,5,1079,5.0,811.0,811.0
240.157,6,45,6457,21,3170,12007.0,588.0,230.0,24,3287,10441.0,580.0,184.0
0.002,17,2,148,1,60,0.0,32.0,32.0,1,88,0.0,60.0,60.0
0.007,17,2,162,1,65,0.0,37.0,37.0,1,97,0.0,69.0,69.0
0.005,17,2,166,1,75,0.0,47.0,47.0,1,91,0.0,63.0,63.0
0.01,6,10,1989,5,910,2.0,642.0,642.0,5,1079,2.0,811.0,811.0
0.087,6,10,1506,5,395,18.0,127.0,127.0,5,1111,21.0,843.0,843.0
0.0,17,2,154,1,69,0.0,41.0,41.0,1,85,0.0,57.0,57.0
0.045,17,2,214,1,75,0.0,47.0,47.0,1,139,0.0,111.0,111.0
0.006,6,10,1689,5,839,1.0,571.0,571.0,5,850,1.0,582.0,582.0
10.822,17,28,4422,14,1994,824.0,269.0,114.0,14,2428,823.0,587.0,145.0
0.005,17,2,140,1,62,0.0,34.0,34.0,1,78,0.0,50.0,50.0
0.086,6,10,1506,5,395,17.0,127.0,127.0,5,1111,20.0,843.0,843.0
0.013,6,10,1983,5,910,3.0,642.0,642.0,5,1073,3.0,805.0,805.0
0.006,17,2,194,1,57,0.0,29.0,29.0,1,137,0.0,109.0,109.0
0.084,6,10,1506,5,395,19.0,127.0,127.0,5,1111,18.0,843.0,843.0
0.005,17,2,166,1,75,0.0,47.0,47.0,1,91,0.0,63.0,63.0
0.007,6,10,1643,5,860,1.0,592.0,592.0,5,783,1.0,515.0,515.0
0.013,6,10,1762,5,911,3.0,643.0,643.0,5,851,3.0,583.0,583.0
0.008,6,10,1989,5,910,2.0,642.0,642.0,5,1079,2.0,811.0,811.0
1730.483,6,45,2790,30,1725,59671.0,35.0,35.0,15,1065,123599.0,31.0,31.0
0.059,6,10,1506,5,395,12.0,127.0,127.0,5,1111,13.0,843.0,843.0
0.016,17,2,198,1,91,0.0,63.0,63.0,1,107,0.0,79.0,79.0
0.016,6,10,1989,5,910,4.0,642.0,642.0,5,1079,3.0,811.0,811.0
415.095,6,29,4409,12,3102,10916.0,494.0,494.0,17,1307,25942.0,83.0,83.0
0.01,6,10,1983,5,910,2.0,642.0,642.0,5,1073,2.0,805.0,805.0
0.006,6,10,1989,5,927,1.0,659.0,659.0,5,1062,1.0,794.0,794.0
40.067,17,10,676,5,460,10015.0,104.0,64.0,5,216,10015.0,20.0,15.0
308.757,17,20,1124,10,716,34292.0,48.0,43.0,10,408,34291.0,20.0,12.0
0.085,6,10,1506,5,395,18.0,127.0,127.0,5,1111,18.0,843.0,843.0
0.071,17,8,3613,4,1874,23.0,1350.0,440.0,4,1739,12.0,1350.0,406.0
40.068,17,10,676,5,460,10015.0,104.0,64.0,5,216,10010.0,20.0,15.0
40.083,17,10,676,5,460,10017.0,104.0,64.0,5,216,10019.0,20.0,15.0
0.009,6,10,1990,5,911,2.0,643.0,643.0,5,1079,2.0,811.0,811.0
0.018,6,10,1677,5,827,4.0,559.0,559.0,5,850,4.0,582.0,582.0
9.036,17,6,376,5,280,2259.0,28.0,28.0,1,96,0.0,68.0,68.0
308.689,17,20,1124,10,716,34285.0,48.0,43.0,10,408,34276.0,20.0,12.0
0.176,6,10,1506,5,395,42.0,127.0,127.0,5,1111,41.0,843.0,843.0
0.005,6,10,2006,5,927,1.0,659.0,659.0,5,1079,1.0,811.0,811.0
0.004,6,10,2006,5,927,1.0,659.0,659.0,5,1079,1.0,811.0,811.0
368.923,6,24,2405,17,919,23057.0,195.0,195.0,7,1486,3910.0,419.0,398.0
0.004,6,10,2007,5,928,1.0,660.0,660.0,5,1079,1.0,811.0,811.0
0.005,6,10,1774,5,923,1.0,655.0,655.0,5,851,1.0,583.0,583.0
0.119,6,14,4389,8,923,17.0,238.0,166.0,6,3466,15.0,1402.0,786.0
0.004,17,2,148,1,60,0.0,32.0,32.0,1,88,0.0,60.0,60.0
40.055,17,10,676,5,460,10012.0,104.0,64.0,5,216,10012.0,20.0,15.0
0.005,6,10,1779,5,928,1.0,660.0,660.0,5,851,1.0,583.0,583.0
0.039,17,4,352,2,130,0.0,37.0,37.0,2,222,2.0,89.0,83.0
0.005,6,10,2000,5,927,1.0,659.0,659.0,5,1073,1.0,805.0,805.0
0.016,6,10,1677,5,827,3.0,559.0,559.0,5,850,4.0,582.0,582.0
0.005,6,10,1643,5,860,1.0,592.0,592.0,5,783,1.0,515.0,515.0
0.095,6,10,1506,5,395,20.0,127.0,127.0,5,1111,23.0,843.0,843.0
0.005,6,10,1689,5,839,1.0,571.0,571.0,5,850,1.0,582.0,582.0
0.011,6,10,1990,5,911,2.0,643.0,643.0,5,1079,2.0,811.0,811.0
0.004,17,2,144,1,64,0.0,36.0,36.0,1,80,0.0,52.0,52.0
0.009,6,10,1989,5,910,2.0,642.0,642.0,5,1079,2.0,811.0,811.0
1799.622,17,122,11651,61,5551,29993.0,63.0,63.0,61,6100,29993.0,72.0,72.0
177.033,17,96,14140,48,3238,3766.0,44.0,39.0,48,10902,3766.0,279.0,199.0
0.019,6,10,1677,5,827,4.0,559.0,559.0,5,850,4.0,582.0,582.0
0.004,17,4,284,2,120,0.0,32.0,32.0,2,164,1.0,60.0,54.0
0.004,6,10,2007,5,928,1.0,660.0,660.0,5,1079,1.0,811.0,811.0
0.19,17,4,596,2,122,147.0,33.0,33.0,2,474,149.0,323.0,209.0
0.005,6,10,2007,5,928,1.0,660.0,660.0,5,1079,1.0,811.0,811.0
0.003,17,2,208,1,72,0.0,44.0,44.0,1,136,0.0,108.0,108.0
0.012,6,10,1990,5,911,3.0,643.0,643.0,5,1079,2.0,811.0,811.0
0.017,6,10,1989,5,910,4.0,642.0,642.0,5,1079,4.0,811.0,811.0
0.006,6,10,1547,5,764,1.0,496.0,496.0,5,783,1.0,515.0,515.0
0.006,6,10,1547,5,764,1.0,496.0,496.0,5,783,1.0,515.0,515.0
0.129,17,2,80,1,32,0.0,4.0,4.0,1,48,0.0,20.0,20.0
0.004,6,10,1989,5,927,1.0,659.0,659.0,5,1062,1.0,794.0,794.0
40.057,17,10,676,5,460,10013.0,104.0,64.0,5,216,10013.0,20.0,15.0
0.005,6,10,1989,5,927,1.0,659.0,659.0,5,1062,1.0,794.0,794.0
0.01,6,10,1631,5,848,2.0,580.0,580.0,5,783,2.0,515.0,515.0
0.005,6,10,1854,5,889,1.0,621.0,621.0,5,965,1.0,697.0,697.0
0.005,6,10,2007,5,928,1.0,660.0,660.0,5,1079,1.0,811.0,811.0
173.406,17,74,10406,37,2465,4816.0,44.0,38.0,37,7941,4816.0,239.0,186.0
0.076,6,10,1506,5,395,16.0,127.0,127.0,5,1111,16.0,843.0,843.0
0.093,6,10,1506,5,395,21.0,127.0,127.0,5,1111,18.0,843.0,843.0
0.042,17,2,412,1,61,0.0,33.0,33.0,1,351,0.0,323.0,323.0
0.016,17,2,136,1,60,0.0,32.0,32.0,1,76,0.0,48.0,48.0
1760.381,6,444,65116,252,35168,7013.0,613.0,197.0,192,29948,9216.0,453.0,142.0
168.385,17,92,13116,46,3091,3741.0,44.0,39.0,46,10025,3741.0,239.0,189.0
0.22,6,16,2674,8,1400,31.0,533.0,325.0,8,1274,20.0,529.0,212.0
0.01,6,10,1990,5,911,2.0,643.0,643.0,5,1079,2.0,811.0,811.0
0.004,6,10,2006,5,927,1.0,659.0,659.0,5,1079,1.0,811.0,811.0
0.005,6,10,2006,5,927,1.0,659.0,659.0,5,1079,1.0,811.0,811.0
0.013,6,10,1989,5,910,3.0,642.0,642.0,5,1079,3.0,811.0,811.0
0.096,6,10,1506,5,395,20.0,127.0,127.0,5,1111,20.0,843.0,843.0
0.01,17,2,179,1,71,0.0,43.0,43.0,1,108,0.0,80.0,80.0
0.006,17,2,166,1,75,0.0,47.0,47.0,1,91,0.0,63.0,63.0
40.074,17,10,676,5,460,10016.0,104.0,64.0,5,216,10017.0,20.0,15.0
0.004,17,2,136,1,60,0.0,32.0,32.0,1,76,0.0,48.0,48.0
172.155,17,78,11022,39,2601,4530.0,44.0,38.0,39,8421,4530.0,260.0,187.0
0.005,6,10,1989,5,927,1.0,659.0,659.0,5,1062,1.0,794.0,794.0
0.0,17,2,132,1,58,0.0,30.0,30.0,1,74,0.0,46.0,46.0
0.005,17,2,140,1,62,0.0,34.0,34.0,1,78,0.0,50.0,50.0
0.004,17,4,284,2,120,0.0,32.0,32.0,2,164,0.0,60.0,54.0
0.013,6,10,1983,5,910,3.0,642.0,642.0,5,1073,3.0,805.0,805.0
1799.839,6,136,6550,76,3625,23997.0,39.0,39.0,60,2925,29993.0,35.0,35.0
0.08,6,10,1506,5,395,15.0,127.0,127.0,5,1111,16.0,843.0,843.0
0.084,6,10,1506,5,395,17.0,127.0,127.0,5,1111,18.0,843.0,843.0
0.087,6,10,1506,5,395,20.0,127.0,127.0,5,1111,19.0,843.0,843.0
0.089,6,10,1506,5,395,20.0,127.0,127.0,5,1111,17.0,843.0,843.0
0.006,6,10,2006,5,927,1.0,659.0,659.0,5,1079,1.0,811.0,811.0
0.007,17,2,170,1,65,0.0,37.0,37.0,1,105,0.0,77.0,77.0
0.013,6,10,1972,5,910,3.0,642.0,642.0,5,1062,3.0,794.0,794.0
0.344,17,16,9977,8,6917,49.0,1350.0,836.0,8,3060,38.0,1350.0,354.0
0.006,6,10,1643,5,860,1.0,592.0,592.0,5,783,1.0,515.0,515.0
0.001,17,2,136,1,60,0.0,32.0,32.0,1,76,0.0,48.0,48.0
0.005,17,2,157,1,59,0.0,31.0,31.0,1,98,0.0,70.0,70.0
0.018,6,10,1989,5,910,4.0,642.0,642.0,5,1079,4.0,811.0,811.0
40.066,17,10,676,5,460,10014.0,104.0,64.0,5,216,10014.0,20.0,15.0
0.091,6,10,1506,5,395,20.0,127.0,127.0,5,1111,18.0,843.0,843.0
368.509,6,22,2313,16,867,24567.0,195.0,195.0,6,1446,4642.0,419.0,398.0
0.005,6,10,2007,5,928,1.0,660.0,660.0,5,1079,1.0,811.0,811.0
0.005,6,10,2006,5,927,1.0,659.0,659.0,5,1079,1.0,811.0,811.0
0.019,6,10,1989,5,910,4.0,642.0,642.0,5,1079,4.0,811.0,811.0
0.094,6,10,1506,5,395,22.0,127.0,127.0,5,1111,20.0,843.0,843.0
0.021,6,10,1990,5,911,5.0,643.0,643.0,5,1079,5.0,811.0,811.0
0.143,6,10,1506,5,395,35.0,127.0,127.0,5,1111,31.0,843.0,843.0
0.075,6,10,1506,5,395,17.0,127.0,127.0,5,1111,15.0,843.0,843.0
0.004,17,2,148,1,60,0.0,32.0,32.0,1,88,0.0,60.0,60.0
40.065,17,10,676,5,460,10013.0,104.0,64.0,5,216,10015.0,20.0,15.0
0.012,6,10,1989,5,910,3.0,642.0,642.0,5,1079,2.0,811.0,811.0
0.119,6,10,1506,5,395,25.0,127.0,127.0,5,1111,24.0,843.0,843.0
0.005,17,2,170,1,65,0.0,37.0,37.0,1,105,0.0,77.0,77.0
0.006,6,10,1547,5,764,1.0,496.0,496.0,5,783,1.0,515.0,515.0
0.006,6,10,1547,5,764,1.0,496.0,496.0,5,783,1.0,515.0,515.0
0.004,6,10,1779,5,928,1.0,660.0,660.0,5,851,1.0,583.0,583.0
0.008,6,10,1762,5,911,2.0,643.0,643.0,5,851,1.0,583.0,583.0
0.005,6,10,2007,5,928,1.0,660.0,660.0,5,1079,1.0,811.0,811.0
0.005,6,10,1779,5,928,1.0,660.0,660.0,5,851,1.0,583.0,583.0
0.039,17,2,144,1,64,0.0,36.0,36.0,1,80,0.0,52.0,52.0
0.002,17,2,185,1,73,0.0,45.0,45.0,1,112,0.0,84.0,84.0
0.013,6,10,1972,5,910,3.0,642.0,642.0,5,1062,3.0,794.0,794.0
0.004,6,10,1702,5,863,1.0,595.0,595.0,5,839,0.0,571.0,571.0
0.108,6,10,1506,5,395,25.0,127.0,127.0,5,1111,18.0,843.0,843.0
352.784,6,20,2210,6,1308,12003.0,494.0,494.0,14,902,27137.0,83.0,83.0
0.004,6,10,2000,5,927,1.0,659.0,659.0,5,1073,1.0,805.0,805.0
0.015,6,10,1762,5,911,3.0,643.0,643.0,5,851,3.0,583.0,583.0
0.003,17,4,284,2,120,0.0,32.0,32.0,2,164,0.0,60.0,54.0
0.092,6,10,1506,5,395,19.0,127.0,127.0,5,1111,21.0,843.0,843.0
0.011,6,10,1990,5,911,2.0,643.0,643.0,5,1079,2.0,811.0,811.0
0.005,17,2,212,1,74,0.0,46.0,46.0,1,138,0.0,110.0,110.0
0.005,6,10,2007,5,928,1.0,660.0,660.0,5,1079,1.0,811.0,811.0
0.005,6,10,2000,5,927,1.0,659.0,659.0,5,1073,1.0,805.0,805.0
0.108,6,10,1506,5,395,24.0,127.0,127.0,5,1111,23.0,843.0,843.0
0.004,17,2,148,1,60,0.0,32.0,32.0,1,88,0.0,60.0,60.0
0.014,6,10,1990,5,911,3.0,643.0,643.0,5,1079,3.0,811.0,811.0
0.006,6,10,1689,5,839,1.0,571.0,571.0,5,850,1.0,582.0,582.0
0.022,6,10,1983,5,910,5.0,642.0,642.0,5,1073,5.0,805.0,805.0
0.081,17,2,152,1,76,0.0,48.0,48.0,1,76,0.0,48.0,48.0
128.65,6,26,5211,14,1186,9896.0,180.0,75.0,12,4025,11695.0,1592.0,678.0
0.107,6,10,1506,5,395,25.0,127.0,127.0,5,1111,25.0,843.0,843.0
0.014,6,10,1989,5,910,3.0,642.0,642.0,5,1079,3.0,811.0,811.0
0.115,6,10,1506,5,395,24.0,127.0,127.0,5,1111,25.0,843.0,843.0
361.846,6,21,1793,16,1030,24123.0,190.0,190.0,5,763,60009.0,462.0,247.0
0.005,6,10,1774,5,923,1.0,655.0,655.0,5,851,1.0,583.0,583.0
0.002,17,2,136,1,60,0.0,32.0,32.0,1,76,0.0,48.0,48.0
0.04,17,2,182,1,65,0.0,37.0,37.0,1,117,0.0,89.0,89.0
0.006,17,2,179,1,71,0.0,43.0,43.0,1,108,0.0,80.0,80.0
40.066,17,10,676,5,460,10015.0,104.0,64.0,5,216,10015.0,20.0,15.0
0.004,6,10,1702,5,863,1.0,595.0,595.0,5,839,0.0,571.0,571.0
0.038,17,2,144,1,64,0.0,36.0,36.0,1,80,0.0,52.0,52.0
0.006,6,13,3747,7,509,0.0,137.0,137.0,6,3238,1.0,1470.0,1459.0
354.015,6,19,1691,15,978,25286.0,190.0,190.0,4,713,80002.0,497.0,497.0
0.007,17,2,194,1,59,0.0,31.0,31.0,1,135,0.0,107.0,107.0
308.513,17,20,1124,10,716,34261.0,48.0,43.0,10,408,34263.0,20.0,12.0
40.067,17,10,676,5,460,10016.0,104.0,64.0,5,216,10016.0,20.0,15.0
0.022,6,10,1972,5,910,5.0,642.0,642.0,5,1062,5.0,794.0,794.0
0.082,6,10,1506,5,395,18.0,127.0,127.0,5,1111,18.0,843.0,843.0
0.006,6,10,1547,5,764,1.0,496.0,496.0,5,783,1.0,515.0,515.0
0.005,6,10,2006,5,927,1.0,659.0,659.0,5,1079,1.0,811.0,811.0
0.012,6,13,3735,7,497,2.0,125.0,125.0,6,3238,2.0,1470.0,1459.0
0.021,6,10,1972,5,910,5.0,642.0,642.0,5,1062,5.0,794.0,794.0
240.02,6,9,787,5,488,60005.0,232.0,232.0,4,299,80004.0,83.0,83.0
0.087,6,10,1506,5,395,16.0,127.0,127.0,5,1111,19.0,843.0,843.0
0.006,6,10,1854,5,889,1.0,621.0,621.0,5,965,1.0,697.0,697.0
0.01,6,10,1989,5,910,2.0,642.0,642.0,5,1079,2.0,811.0,811.0
0.016,6,10,1989,5,910,3.0,642.0,642.0,5,1079,3.0,811.0,811.0
0.019,6,13,3735,7,497,3.0,125.0,125.0,6,3238,3.0,1470.0,1459.0
0.004,6,10,1702,5,863,1.0,595.0,595.0,5,839,0.0,571.0,571.0
0.004,6,10,1774,5,923,1.0,655.0,655.0,5,851,1.0,583.0,583.0
0.005,6,10,2006,5,927,1.0,659.0,659.0,5,1079,1.0,811.0,811.0
0.005,6,10,1689,5,839,1.0,571.0,571.0,5,850,1.0,582.0,582.0
1756.066,6,105,6270,60,3525,29763.0,27.0,27.0,45,2745,39909.0,27.0,27.0
0.306,17,2,152,1,76,0.0,48.0,48.0,1,76,0.0,48.0,48.0
0.005,17,2,166,1,75,0.0,47.0,47.0,1,91,0.0,63.0,63.0
178.295,17,72,10233,36,2402,5094.0,44.0,38.0,36,7831,5094.0,261.0,189.0
0.109,6,10,1506,5,395,25.0,127.0,127.0,5,1111,25.0,843.0,843.0
11.055,17,28,4399,14,2313,841.0,588.0,137.0,14,2086,841.0,269.0,121.0
0.001,17,2,166,1,75,0.0,47.0,47.0,1,91,0.0,63.0,63.0
1792.181,6,550,188639,278,162777,6469.0,2883.0,909.0,272,25862,6613.0,375.0,119.0
0.005,17,2,170,1,65,0.0,37.0,37.0,1,105,0.0,77.0,77.0
0.004,6,10,2006,5,927,1.0,659.0,659.0,5,1079,1.0,811.0,811.0
0.009,6,10,1762,5,911,2.0,643.0,643.0,5,851,2.0,583.0,583.0
0.101,6,10,1506,5,395,23.0,127.0,127.0,5,1111,24.0,843.0,843.0
300.292,6,16,2170,9,684,37515.0,146.0,146.0,7,1486,50020.0,419.0,398.0
0.004,17,4,284,2,120,0.0,32.0,32.0,2,164,1.0,60.0,54.0
0.027,6,10,1989,5,910,6.0,642.0,642.0,5,1079,6.0,811.0,811.0
0.038,17,2,136,1,60,0.0,32.0,32.0,1,76,0.0,48.0,48.0
0.005,17,2,140,1,62,0.0,34.0,34.0,1,78,0.0,50.0,50.0
0.004,6,10,1989,5,927,1.0,659.0,659.0,5,1062,1.0,794.0,794.0
0.004,6,10,2006,5,927,1.0,659.0,659.0,5,1079,1.0,811.0,811.0
166.026,17,80,11364,40,2673,4256.0,44.0,38.0,40,8691,4257.0,239.0,189.0
0.093,6,10,1506,5,395,20.0,127.0,127.0,5,1111,22.0,843.0,843.0
1789.795,6,312,98356,192,86685,9370.0,1402.0,672.0,120,11671,15040.0,452.0,71.0
0.002,17,2,136,1,60,0.0,32.0,32.0,1,76,0.0,48.0,48.0
0.004,17,4,284,2,120,0.0,32.0,32.0,2,164,1.0,60.0,54.0
0.052,6,10,1506,5,395,11.0,127.0,127.0,5,1111,12.0,843.0,843.0
0.009,6,10,1677,5,827,2.0,559.0,559.0,5,850,2.0,582.0,582.0
0.057,6,10,1506,5,395,13.0,127.0,127.0,5,1111,13.0,843.0,843.0
0.013,6,10,1631,5,848,3.0,580.0,580.0,5,783,3.0,515.0,515.0
0.009,6,10,1972,5,910,2.0,642.0,642.0,5,1062,2.0,794.0,794.0
0.01,6,10,1631,5,848,2.0,580.0,580.0,5,783,2.0,515.0,515.0
0.005,6,10,2006,5,927,1.0,659.0,659.0,5,1079,1.0,811.0,811.0
240.086,6,16,4482,9,963,30010.0,238.0,166.0,7,3519,40014.0,1402.0,786.0
0.008,6,10,1631,5,848,2.0,580.0,580.0,5,783,1.0,515.0,515.0
0.001,17,2,180,1,66,0.0,38.0,38.0,1,114,0.0,86.0,86.0
0.001,17,2,136,1,60,0.0,32.0,32.0,1,76,0.0,48.0,48.0
0.068,6,10,1506,5,395,13.0,127.0,127.0,5,1111,15.0,843.0,843.0
0.004,6,10,1774,5,923,1.0,655.0,655.0,5,851,1.0,583.0,583.0
40.053,17,10,676,5,460,10012.0,104.0,64.0,5,216,10012.0,20.0,15.0
0.005,6,10,1643,5,860,1.0,592.0,592.0,5,783,1.0,515.0,515.0
40.066,17,10,676,5,460,10014.0,104.0,64.0,5,216,10015.0,20.0,15.0
0.005,17,2,144,1,64,0.0,36.0,36.0,1,80,0.0,52.0,52.0
0.005,6,10,2006,5,927,1.0,659.0,659.0,5,1079,1.0,811.0,811.0
240.095,6,30,9066,15,6846,17149.0,1971.0,674.0,15,2220,17149.0,580.0,204.0
0.218,6,16,2669,8,1395,31.0,533.0,323.0,8,1274,19.0,529.0,212.0
0.024,6,10,1677,5,827,6.0,559.0,559.0,5,850,5.0,582.0,582.0
0.041,17,2,152,1,76,0.0,48.0,48.0,1,76,0.0,48.0,48.0
0.076,6,10,1506,5,395,16.0,127.0,127.0,5,1111,17.0,843.0,843.0
0.011,6,10,1989,5,910,2.0,642.0,642.0,5,1079,2.0,811.0,811.0
0.009,6,10,1762,5,911,2.0,643.0,643.0,5,851,2.0,583.0,583.0
0.092,6,10,1506,5,395,19.0,127.0,127.0,5,1111,21.0,843.0,843.0
0.09,6,10,1506,5,395,20.0,127.0,127.0,5,1111,19.0,843.0,843.0
300.78,6,34,6335,19,1409,16710.0,267.0,154.0,15,4926,616.0,1823.0,392.0
11.392,17,28,4396,14,2311,864.0,586.0,137.0,14,2085,864.0,268.0,120.0
123.424,6,24,9313,13,1655,10285.0,794.0,367.0,11,7658,12329.0,1360.0,1029.0
0.076,6,10,1506,5,395,17.0,127.0,127.0,5,1111,15.0,843.0,843.0
0.107,6,10,1506,5,395,24.0,127.0,127.0,5,1111,22.0,843.0,843.0
0.008,6,12,1926,6,1189,1.0,659.0,434.0,6,737,1.0,417.0,417.0
0.005,17,2,170,1,65,0.0,37.0,37.0,1,105,0.0,77.0,77.0
0.056,6,10,1506,5,395,13.0,127.0,127.0,5,1111,12.0,843.0,843.0
0.004,17,2,148,1,60,0.0,32.0,32.0,1,88,0.0,60.0,60.0
15.077,17,16,8155,8,6085,2149.0,1350.0,732.0,8,2070,2149.0,1350.0,230.0
0.015,17,2,198,1,91,0.0,63.0,63.0,1,107,0.0,79.0,79.0
0.209,6,16,2669,8,1395,29.0,533.0,323.0,8,1274,19.0,529.0,212.0
0.001,17,2,180,1,66,0.0,38.0,38.0,1,114,0.0,86.0,86.0
0.012,6,10,1989,5,910,2.0,642.0,642.0,5,1079,3.0,811.0,811.0
0.009,6,10,1989,5,910,2.0,642.0,642.0,5,1079,2.0,811.0,811.0
0.003,17,4,284,2,120,0.0,32.0,32.0,2,164,0.0,60.0,54.0
0.014,6,10,1972,5,910,3.0,642.0,642.0,5,1062,3.0,794.0,794.0
0.005,6,10,2007,5,928,1.0,660.0,660.0,5,1079,1.0,811.0,811.0
280.291,6,23,6075,10,1186,31142.0,267.0,156.0,13,4889,23357.0,1400.0,873.0
0.009,6,10,1989,5,910,2.0,642.0,642.0,5,1079,2.0,811.0,811.0
0.005,6,10,2006,5,927,1.0,659.0,659.0,5,1079,1.0,811.0,811.0
0.004,17,2,148,1,60,0.0,32.0,32.0,1,88,0.0,60.0,60.0
0.001,17,2,180,1,66,0.0,38.0,38.0,1,114,0.0,86.0,86.0
0.004,6,10,2000,5,927,1.0,659.0,659.0,5,1073,1.0,805.0,805.0
0.005,17,2,230,1,68,0.0,40.0,40.0,1,162,0.0,134.0,134.0
0.005,6,10,2006,5,927,1.0,659.0,659.0,5,1079,1.0,811.0,811.0
0.005,6,10,1779,5,928,1.0,660.0,660.0,5,851,1.0,583.0,583.0
0.017,6,10,1989,5,910,4.0,642.0,642.0,5,1079,4.0,811.0,811.0
300.03,6,12,1782,7,1348,50005.0,494.0,494.0,5,434,75006.0,83.0,83.0
0.005,6,10,2006,5,927,1.0,659.0,659.0,5,1079,1.0,811.0,811.0
0.009,6,10,1989,5,910,2.0,642.0,642.0,5,1079,2.0,811.0,811.0
0.041,17,2,136,1,60,0.0,32.0,32.0,1,76,0.0,48.0,48.0
0.004,6,10,1702,5,863,1.0,595.0,595.0,5,839,0.0,571.0,571.0
1792.278,6,551,188079,276,162753,6517.0,2883.0,939.0,275,25326,6541.0,379.0,110.0
0.07,6,10,1506,5,395,16.0,127.0,127.0,5,1111,14.0,843.0,843.0
178.321,17,74,10601,37,2467,4953.0,44.0,38.0,37,8134,4953.0,239.0,191.0
40.057,17,10,676,5,460,10013.0,104.0,64.0,5,216,10013.0,20.0,15.0
240.092,6,16,4481,9,963,30011.0,238.0,166.0,7,3518,40014.0,1402.0,786.0
0.066,6,10,1506,5,395,14.0,127.0,127.0,5,1111,15.0,843.0,843.0
0.007,6,12,1698,6,863,1.0,327.0,271.0,6,835,1.0,515.0,515.0
0.005,6,10,2006,5,927,1.0,659.0,659.0,5,1079,1.0,811.0,811.0
0.01,6,10,1631,5,848,2.0,580.0,580.0,5,783,2.0,515.0,515.0
0.006,17,2,136,1,60,0.0,32.0,32.0,1,76,0.0,48.0,48.0
0.006,17,2,148,1,60,0.0,32.0,32.0,1,88,0.0,60.0,60.0
0.005,6,13,3690,7,452,0.0,80.0,80.0,6,3238,1.0,1470.0,1459.0
0.004,17,2,148,1,60,0.0,32.0,32.0,1,88,0.0,60.0,60.0
40.087,17,10,676,5,460,10021.0,104.0,64.0,5,216,10021.0,20.0,15.0
11.444,17,28,4396,14,2311,867.0,586.0,137.0,14,2085,867.0,268.0,120.0
0.004,6,10,2006,5,927,1.0,659.0,659.0,5,1079,1.0,811.0,811.0
0.018,6,10,1989,5,910,4.0,642.0,642.0,5,1079,4.0,811.0,811.0
0.006,17,2,214,1,75,0.0,47.0,47.0,1,139,0.0,111.0,111.0
0.005,6,10,2006,5,927,1.0,659.0,659.0,5,1079,1.0,811.0,811.0
0.004,6,10,1702,5,863,1.0,595.0,595.0,5,839,0.0,571.0,571.0
0.005,17,2,144,1,64,0.0,36.0,36.0,1,80,0.0,52.0,52.0
36.988,6,19,9953,11,3921,3698.0,1579.0,835.0,8,6032,67.0,2111.0,1121.0
40.073,17,10,676,5,460,10016.0,104.0,64.0,5,216,10016.0,20.0,15.0
0.063,6,10,1506,5,395,15.0,127.0,127.0,5,1111,13.0,843.0,843.0
0.093,6,10,1506,5,395,20.0,127.0,127.0,5,1111,23.0,843.0,843.0
0.155,6,10,1506,5,395,36.0,127.0,127.0,5,1111,33.0,843.0,843.0
0.117,6,10,1506,5,395,26.0,127.0,127.0,5,1111,27.0,843.0,843.0
0.003,17,2,148,1,60,0.0,32.0,32.0,1,88,0.0,60.0,60.0
0.009,6,10,1989,5,910,2.0,642.0,642.0,5,1079,2.0,811.0,811.0
0.011,6,10,1989,5,910,2.0,642.0,642.0,5,1079,2.0,811.0,811.0
11.041,17,28,4398,14,2313,840.0,588.0,137.0,14,2085,840.0,268.0,120.0
0.004,6,10,1702,5,863,1.0,595.0,595.0,5,839,0.0,571.0,571.0
0.009,6,12,1926,6,1189,1.0,659.0,434.0,6,737,1.0,417.0,417.0
40.055,17,10,676,5,460,10013.0,104.0,64.0,5,216,10013.0,20.0,15.0
0.004,17,2,148,1,60,0.0,32.0,32.0,1,88,0.0,60.0,60.0
0.005,6,10,1702,5,863,1.0,595.0,595.0,5,839,1.0,571.0,571.0
0.004,6,14,3742,8,504,0.0,80.0,80.0,6,3238,0.0,1470.0,1459.0
300.342,6,16,2170,9,684,37521.0,146.0,146.0,7,1486,50028.0,419.0,398.0
0.006,6,10,1547,5,764,1.0,496.0,496.0,5,783,1.0,515.0,515.0
0.006,6,10,1689,5,839,1.0,571.0,571.0,5,850,1.0,582.0,582.0
174.111,17,74,10511,37,2476,4836.0,44.0,38.0,37,8035,4836.0,239.0,189.0
240.091,6,16,4480,9,963,30011.0,238.0,166.0,7,3517,40014.0,1402.0,786.0
0.098,6,10,1506,5,395,21.0,127.0,127.0,5,1111,23.0,843.0,843.0
30.173,6,41,13355,17,5635,1885.0,1001.0,790.0,24,7720,1311.0,1162.0,380.0
0.005,6,10,2000,5,927,1.0,659.0,659.0,5,1073,1.0,805.0,805.0
0.005,6,10,2007,5,928,1.0,660.0,660.0,5,1079,1.0,811.0,811.0
0.008,6,10,1972,5,910,1.0,642.0,642.0,5,1062,1.0,794.0,794.0
0.009,6,10,1779,5,928,2.0,660.0,660.0,5,851,2.0,583.0,583.0
0.0,17,2,166,1,75,0.0,47.0,47.0,1,91,0.0,63.0,63.0
0.04,17,2,152,1,76,0.0,48.0,48.0,1,76,0.0,48.0,48.0
0.012,6,10,1990,5,911,2.0,643.0,643.0,5,1079,3.0,811.0,811.0
1782.691,6,280,36873,116,19869,15500.0,2720.0,168.0,164,17004,10936.0,1360.0,132.0
0.015,6,10,1989,5,910,3.0,642.0,642.0,5,1079,3.0,811.0,811.0
0.003,17,2,148,1,60,0.0,32.0,32.0,1,88,0.0,60.0,60.0
40.133,17,10,676,5,460,10030.0,104.0,64.0,5,216,10032.0,20.0,15.0
0.012,6,10,1989,5,910,3.0,642.0,642.0,5,1079,3.0,811.0,811.0
0.004,17,2,136,1,60,0.0,32.0,32.0,1,76,0.0,48.0,48.0
0.008,6,10,2006,5,927,1.0,659.0,659.0,5,1079,2.0,811.0,811.0
82.284,6,33,14369,17,6925,112.0,1360.0,776.0,16,7444,5474.0,2720.0,970.0
0.125,17,2,184,1,61,0.0,33.0,33.0,1,123,0.0,95.0,95.0
0.008,6,10,2000,5,927,1.0,659.0,659.0,5,1073,2.0,805.0,805.0
0.0,17,2,140,1,62,0.0,34.0,34.0,1,78,0.0,50.0,50.0
0.108,6,10,1506,5,395,22.0,127.0,127.0,5,1111,23.0,843.0,843.0
0.005,6,10,1689,5,839,1.0,571.0,571.0,5,850,1.0,582.0,582.0
0.011,6,10,1989,5,910,2.0,642.0,642.0,5,1079,2.0,811.0,811.0
0.013,6,10,1989,5,910,3.0,642.0,642.0,5,1079,3.0,811.0,811.0
0.015,6,10,1972,5,910,3.0,642.0,642.0,5,1062,3.0,794.0,794.0
0.089,6,10,1506,5,395,19.0,127.0,127.0,5,1111,18.0,843.0,843.0
0.09,6,10,1506,5,395,21.0,127.0,127.0,5,1111,19.0,843.0,843.0
0.005,6,10,2006,5,927,1.0,659.0,659.0,5,1079,1.0,811.0,811.0
0.004,17,2,148,1,60,0.0,32.0,32.0,1,88,0.0,60.0,60.0
0.011,6,10,1990,5,911,2.0,643.0,643.0,5,1079,2.0,811.0,811.0
0.001,17,2,180,1,66,0.0,38.0,38.0,1,114,0.0,86.0,86.0
0.011,6,10,1989,5,910,2.0,642.0,642.0,5,1079,2.0,811.0,811.0
0.005,6,10,1989,5,927,1.0,659.0,659.0,5,1062,1.0,794.0,794.0
0.083,6,10,1506,5,395,17.0,127.0,127.0,5,1111,17.0,843.0,843.0
0.008,17,2,237,1,65,0.0,37.0,37.0,1,172,0.0,144.0,144.0
0.04,17,2,152,1,76,0.0,48.0,48.0,1,76,0.0,48.0,48.0
0.005,6,10,1547,5,764,1.0,496.0,496.0,5,783,1.0,515.0,515.0
0.005,6,10,2007,5,928,1.0,660.0,660.0,5,1079,1.0,811.0,811.0
0.008,6,10,1990,5,911,1.0,643.0,643.0,5,1079,2.0,811.0,811.0
40.056,17,10,676,5,460,10012.0,104.0,64.0,5,216,10013.0,20.0,15.0
0.158,17,4,352,2,130,121.0,37.0,37.0,2,222,118.0,89.0,83.0
0.104,6,10,1506,5,395,22.0,127.0,127.0,5,1111,24.0,843.0,843.0
0.04,17,2,182,1,65,0.0,37.0,37.0,1,117,0.0,89.0,89.0
240.098,6,16,4481,9,963,30012.0,238.0,166.0,7,3518,40015.0,1402.0,786.0
0.015,6,10,1631,5,848,3.0,580.0,580.0,5,783,3.0,515.0,515.0
0.065,6,10,1506,5,395,13.0,127.0,127.0,5,1111,14.0,843.0,843.0
0.004,17,2,148,1,60,0.0,32.0,32.0,1,88,0.0,60.0,60.0
0.01,6,10,1989,5,910,2.0,642.0,642.0,5,1079,2.0,811.0,811.0
0.005,17,2,136,1,60,0.0,32.0,32.0,1,76,0.0,48.0,48.0
0.005,6,10,1779,5,928,1.0,660.0,660.0,5,851,1.0,583.0,583.0
350.415,6,38,14431,20,4115,18441.0,676.0,438.0,18,10316,20610.0,1402.0,938.0
0.072,6,10,1506,5,395,15.0,127.0,127.0,5,1111,16.0,843.0,843.0
0.063,6,10,1506,5,395,13.0,127.0,127.0,5,1111,13.0,843.0,843.0
0.004,17,2,136,1,60,0.0,32.0,32.0,1,76,0.0,48.0,48.0
0.014,6,10,1972,5,910,3.0,642.0,642.0,5,1062,3.0,794.0,794.0
0.001,17,2,179,1,62,0.0,34.0,34.0,1,117,0.0,89.0,89.0
0.003,17,2,136,1,60,0.0,32.0,32.0,1,76,0.0,48.0,48.0
0.088,6,10,1506,5,395,18.0,127.0,127.0,5,1111,18.0,843.0,843.0
0.005,6,10,2000,5,927,1.0,659.0,659.0,5,1073,1.0,805.0,805.0
0.004,6,10,1779,5,928,1.0,660.0,660.0,5,851,1.0,583.0,583.0
0.005,6,13,3747,7,509,0.0,137.0,137.0,6,3238,0.0,1470.0,1459.0
0.005,6,10,2006,5,927,1.0,659.0,659.0,5,1079,1.0,811.0,811.0
0.005,17,2,170,1,65,0.0,37.0,37.0,1,105,0.0,77.0,77.0
0.006,17,2,169,1,62,0.0,34.0,34.0,1,107,0.0,79.0,79.0
308.641,17,20,1124,10,716,34278.0,48.0,43.0,10,408,34279.0,20.0,12.0
0.002,17,2,152,1,76,0.0,48.0,48.0,1,76,0.0,48.0,48.0
0.008,6,10,1972,5,910,2.0,642.0,642.0,5,1062,2.0,794.0,794.0
0.011,6,10,1989,5,910,2.0,642.0,642.0,5,1079,2.0,811.0,811.0
0.013,6,10,1990,5,911,3.0,643.0,643.0,5,1079,3.0,811.0,811.0
0.004,6,10,2007,5,928,1.0,660.0,660.0,5,1079,1.0,811.0,811.0
0.008,6,10,1989,5,910,2.0,642.0,642.0,5,1079,2.0,811.0,811.0
301.187,6,51,21577,27,15590,11584.0,2720.0,1316.0,24,5987,392.0,1360.0,358.0
178.22,17,72,10206,36,2394,5091.0,44.0,38.0,36,7812,5091.0,239.0,189.0
283.469,6,10,839,5,488,70867.0,232.0,232.0,5,351,70866.0,83.0,83.0
0.101,6,10,1506,5,395,22.0,127.0,127.0,5,1111,22.0,843.0,843.0
0.005,17,2,157,1,59,0.0,31.0,31.0,1,98,0.0,70.0,70.0
0.088,6,10,1506,5,395,18.0,127.0,127.0,5,1111,20.0,843.0,843.0
0.081,6,10,1506,5,395,18.0,127.0,127.0,5,1111,18.0,843.0,843.0
0.008,6,10,1989,5,910,2.0,642.0,642.0,5,1079,2.0,811.0,811.0
0.005,6,10,1774,5,923,1.0,655.0,655.0,5,851,1.0,583.0,583.0
0.002,17,2,180,1,66,0.0,38.0,38.0,1,114,0.0,86.0,86.0
0.012,17,2,148,1,60,0.0,32.0,32.0,1,88,0.0,60.0,60.0
0.209,6,16,2777,8,1395,29.0,533.0,323.0,8,1382,19.0,529.0,239.0
0.018,6,10,1762,5,911,4.0,643.0,643.0,5,851,4.0,583.0,583.0
40.079,17,10,676,5,460,10016.0,104.0,64.0,5,216,10018.0,20.0,15.0
0.109,6,10,1506,5,395,25.0,127.0,127.0,5,1111,22.0,843.0,843.0
0.001,17,2,180,1,66,0.0,38.0,38.0,1,114,0.0,86.0,86.0
0.014,6,10,1983,5,910,3.0,642.0,642.0,5,1073,3.0,805.0,805.0
11.507,17,28,4391,14,2312,872.0,587.0,137.0,14,2079,872.0,270.0,120.0
0.016,17,2,198,1,91,0.0,63.0,63.0,1,107,0.0,79.0,79.0
0.009,6,10,2007,5,928,2.0,660.0,660.0,5,1079,2.0,811.0,811.0
0.11,6,10,1506,5,395,27.0,127.0,127.0,5,1111,23.0,843.0,843.0
0.005,17,2,214,1,75,0.0,47.0,47.0,1,139,0.0,111.0,111.0
0.005,6,10,1854,5,889,1.0,621.0,621.0,5,965,1.0,697.0,697.0
0.009,6,10,1989,5,910,2.0,642.0,642.0,5,1079,2.0,811.0,811.0
0.011,6,10,1983,5,910,2.0,642.0,642.0,5,1073,2.0,805.0,805.0
0.214,6,16,2778,8,1396,30.0,533.0,324.0,8,1382,19.0,529.0,239.0
0.015,6,10,1989,5,910,3.0,642.0,642.0,5,1079,3.0,811.0,811.0
0.018,6,10,1989,5,910,4.0,642.0,642.0,5,1079,4.0,811.0,811.0
0.019,6,10,1990,5,911,4.0,643.0,643.0,5,1079,4.0,811.0,811.0
0.011,6,10,1983,5,910,2.0,642.0,642.0,5,1073,2.0,805.0,805.0
0.1,6,10,1506,5,395,20.0,127.0,127.0,5,1111,21.0,843.0,843.0
0.01,6,10,1631,5,848,2.0,580.0,580.0,5,783,2.0,515.0,515.0
0.008,6,10,1990,5,911,2.0,643.0,643.0,5,1079,1.0,811.0,811.0
22.183,17,23,14800,13,12031,1846.0,1350.0,897.0,10,2769,2461.0,1350.0,248.0
0.041,17,2,152,1,76,0.0,48.0,48.0,1,76,0.0,48.0,48.0
0.011,6,10,1989,5,910,2.0,642.0,642.0,5,1079,2.0,811.0,811.0
15.183,6,35,9333,18,1725,893.0,329.0,99.0,17,7608,948.0,1402.0,559.0
0.008,6,10,1983,5,910,2.0,642.0,642.0,5,1073,1.0,805.0,805.0
0.004,6,10,1702,5,863,1.0,595.0,595.0,5,839,0.0,571.0,571.0
1779.244,17,144,45504,72,22752,25050.0,288.0,288.0,72,22752,25059.0,288.0,288.0
0.006,6,10,1547,5,764,1.0,496.0,496.0,5,783,1.0,515.0,515.0
0.009,6,10,1779,5,928,2.0,660.0,660.0,5,851,2.0,583.0,583.0
0.004,6,10,1989,5,927,1.0,659.0,659.0,5,1062,1.0,794.0,794.0
0.008,17,2,166,1,75,0.0,47.0,47.0,1,91,0.0,63.0,63.0
292.283,6,320,343830,118,17681,2498.0,2736.0,824.0,202,326149,1454.0,2804.0,1678.0
0.076,6,10,1506,5,395,17.0,127.0,127.0,5,1111,16.0,843.0,843.0
0.004,6,10,1989,5,927,1.0,659.0,659.0,5,1062,1.0,794.0,794.0
40.059,17,10,676,5,460,10013.0,104.0,64.0,5,216,10014.0,20.0,15.0
240.401,6,33,9306,16,1836,16026.0,624.0,199.0,17,7470,15024.0,1402.0,599.0
0.016,6,10,1972,5,910,4.0,642.0,642.0,5,1062,3.0,794.0,794.0
308.781,17,20,1124,10,716,34295.0,48.0,43.0,10,408,34295.0,20.0,12.0
0.006,17,2,212,1,74,0.0,46.0,46.0,1,138,0.0,110.0,110.0
0.014,6,10,1990,5,911,3.0,643.0,643.0,5,1079,3.0,811.0,811.0
0.01,6,10,1989,5,910,2.0,642.0,642.0,5,1079,2.0,811.0,811.0
0.092,6,10,1506,5,395,19.0,127.0,127.0,5,1111,21.0,843.0,843.0
0.006,6,10,1689,5,839,1.0,571.0,571.0,5,850,1.0,582.0,582.0
0.005,17,2,164,1,74,0.0,46.0,46.0,1,90,0.0,62.0,62.0
0.155,6,10,1506,5,395,18.0,127.0,127.0,5,1111,37.0,843.0,843.0
0.011,6,14,3787,7,497,1.0,125.0,125.0,7,3290,1.0,1448.0,972.0
0.089,6,10,1506,5,395,21.0,127.0,127.0,5,1111,21.0,843.0,843.0
0.084,6,10,1506,5,395,18.0,127.0,127.0,5,1111,18.0,843.0,843.0
0.006,17,2,144,1,64,0.0,36.0,36.0,1,80,0.0,52.0,52.0
11.138,17,28,4422,14,1994,844.0,269.0,114.0,14,2428,844.0,587.0,145.0
309.641,17,20,1124,10,716,34390.0,48.0,43.0,10,408,34390.0,20.0,12.0
0.074,6,10,1506,5,395,16.0,127.0,127.0,5,1111,15.0,843.0,843.0
11.159,17,28,4417,14,1994,845.0,269.0,114.0,14,2423,845.0,586.0,145.0
0.025,6,10,1972,5,910,6.0,642.0,642.0,5,1062,6.0,794.0,794.0
0.01,6,10,1983,5,910,2.0,642.0,642.0,5,1073,2.0,805.0,805.0
0.091,6,10,1506,5,395,19.0,127.0,127.0,5,1111,19.0,843.0,843.0
240.098,6,32,9200,16,6935,16006.0,1515.0,610.0,16,2265,16006.0,580.0,178.0
0.103,6,10,1506,5,395,25.0,127.0,127.0,5,1111,21.0,843.0,843.0
300.322,6,16,2170,9,684,37520.0,146.0,146.0,7,1486,50026.0,419.0,398.0
0.017,6,10,1989,5,910,4.0,642.0,642.0,5,1079,4.0,811.0,811.0
0.019,6,10,1989,5,910,4.0,642.0,642.0,5,1079,4.0,811.0,811.0
0.074,6,10,1506,5,395,16.0,127.0,127.0,5,1111,14.0,843.0,843.0
0.011,6,10,1990,5,911,2.0,643.0,643.0,5,1079,2.0,811.0,811.0
354.083,6,19,1691,15,978,25291.0,190.0,190.0,4,713,80002.0,497.0,497.0
0.011,6,10,1972,5,910,2.0,642.0,642.0,5,1062,2.0,794.0,794.0
0.018,6,10,1990,5,911,4.0,643.0,643.0,5,1079,4.0,811.0,811.0
40.079,17,10,676,5,460,10016.0,104.0,64.0,5,216,10019.0,20.0,15.0
0.01,6,10,1989,5,910,2.0,642.0,642.0,5,1079,2.0,811.0,811.0
0.004,17,2,148,1,60,0.0,32.0,32.0,1,88,0.0,60.0,60.0
0.004,6,10,1989,5,927,1.0,659.0,659.0,5,1062,1.0,794.0,794.0
0.005,6,10,2006,5,927,1.0,659.0,659.0,5,1079,1.0,811.0,811.0
0.005,6,10,1989,5,927,1.0,659.0,659.0,5,1062,1.0,794.0,794.0
0.004,17,2,148,1,60,0.0,32.0,32.0,1,88,0.0,60.0,60.0
0.013,6,10,1631,5,848,3.0,580.0,580.0,5,783,3.0,515.0,515.0
0.009,6,10,1983,5,910,2.0,642.0,642.0,5,1073,2.0,805.0,805.0
0.004,6,10,2007,5,928,1.0,660.0,660.0,5,1079,1.0,811.0,811.0
0.013,6,10,1677,5,827,3.0,559.0,559.0,5,850,3.0,582.0,582.0
0.012,6,10,1989,5,910,3.0,642.0,642.0,5,1079,2.0,811.0,811.0
0.005,6,10,2006,5,927,1.0,659.0,659.0,5,1079,1.0,811.0,811.0
0.01,6,10,1989,5,910,2.0,642.0,642.0,5,1079,2.0,811.0,811.0
0.012,6,10,1990,5,911,2.0,643.0,643.0,5,1079,3.0,811.0,811.0
0.007,6,10,1689,5,839,1.0,571.0,571.0,5,850,1.0,582.0,582.0
0.015,6,10,1677,5,827,3.0,559.0,559.0,5,850,3.0,582.0,582.0
0.008,6,10,1677,5,827,2.0,559.0,559.0,5,850,1.0,582.0,582.0
0.006,17,2,214,1,75,0.0,47.0,47.0,1,139,0.0,111.0,111.0
0.104,6,10,1506,5,395,24.0,127.0,127.0,5,1111,22.0,843.0,843.0
0.001,17,2,180,1,66,0.0,38.0,38.0,1,114,0.0,86.0,86.0
0.005,6,10,2007,5,928,1.0,660.0,660.0,5,1079,1.0,811.0,811.0
40.059,17,10,676,5,460,10014.0,104.0,64.0,5,216,10013.0,20.0,15.0
0.005,6,10,2007,5,928,1.0,660.0,660.0,5,1079,1.0,811.0,811.0
0.006,6,12,1698,6,863,1.0,327.0,271.0,6,835,1.0,515.0,515.0
0.101,6,10,1506,5,395,23.0,127.0,127.0,5,1111,24.0,843.0,843.0
0.004,6,10,1702,5,863,1.0,595.0,595.0,5,839,1.0,571.0,571.0
0.008,6,10,1983,5,910,2.0,642.0,642.0,5,1073,1.0,805.0,805.0
1756.884,6,107,6374,60,3525,29777.0,27.0,27.0,47,2849,38192.0,27.0,27.0
240.081,6,16,4481,9,963,30010.0,238.0,166.0,7,3518,40013.0,1402.0,786.0
0.012,6,10,1677,5,827,3.0,559.0,559.0,5,850,3.0,582.0,582.0
0.02,6,10,1677,5,827,5.0,559.0,559.0,5,850,4.0,582.0,582.0
0.005,6,10,1702,5,863,1.0,595.0,595.0,5,839,1.0,571.0,571.0
0.067,6,10,1506,5,395,14.0,127.0,127.0,5,1111,14.0,843.0,843.0
0.005,6,10,1989,5,927,1.0,659.0,659.0,5,1062,1.0,794.0,794.0
54.792,6,49,19270,25,13283,378.0,2720.0,1225.0,24,5987,2375.0,2667.0,385.0
0.03,17,2,222,1,65,0.0,37.0,37.0,1,157,0.0,129.0,129.0
40.056,17,10,676,5,460,10013.0,104.0,64.0,5,216,10008.0,20.0,15.0
0.003,17,2,136,1,60,0.0,32.0,32.0,1,76,0.0,48.0,48.0
0.003,17,2,136,1,60,0.0,32.0,32.0,1,76,0.0,48.0,48.0
0.079,6,10,1506,5,395,16.0,127.0,127.0,5,1111,15.0,843.0,843.0
0.005,6,10,1774,5,923,1.0,655.0,655.0,5,851,1.0,583.0,583.0
0.12,6,10,1506,5,395,28.0,127.0,127.0,5,1111,27.0,843.0,843.0
0.005,6,10,2006,5,927,1.0,659.0,659.0,5,1079,1.0,811.0,811.0
0.005,6,10,2000,5,927,1.0,659.0,659.0,5,1073,1.0,805.0,805.0
0.006,6,10,1547,5,764,1.0,496.0,496.0,5,783,1.0,515.0,515.0
0.038,17,4,284,2,120,0.0,32.0,32.0,2,164,35.0,60.0,54.0
0.199,6,3,453,2,321,199.0,241.0,241.0,1,132,0.0,92.0,92.0
40.055,17,10,676,5,460,10012.0,104.0,64.0,5,216,10013.0,20.0,15.0
0.011,6,10,1989,5,910,2.0,642.0,642.0,5,1079,2.0,811.0,811.0
0.074,6,10,1506,5,395,16.0,127.0,127.0,5,1111,15.0,843.0,843.0
240.117,6,32,9416,16,6827,16007.0,1897.0,666.0,16,2589,16007.0,580.0,218.0
0.014,6,10,1972,5,910,3.0,642.0,642.0,5,1062,3.0,794.0,794.0
0.008,6,10,1631,5,848,2.0,580.0,580.0,5,783,2.0,515.0,515.0
0.005,17,2,140,1,62,0.0,34.0,34.0,1,78,0.0,50.0,50.0
0.006,6,10,2006,5,927,1.0,659.0,659.0,5,1079,1.0,811.0,811.0
0.004,17,2,136,1,60,0.0,32.0,32.0,1,76,0.0,48.0,48.0
0.005,6,13,3747,7,509,0.0,137.0,137.0,6,3238,0.0,1470.0,1459.0
0.007,6,10,2006,5,927,1.0,659.0,659.0,5,1079,1.0,811.0,811.0
0.071,17,4,420,2,122,0.0,33.0,33.0,2,298,0.0,145.0,121.0
0.004,17,2,148,1,60,0.0,32.0,32.0,1,88,0.0,60.0,60.0
0.016,6,10,1990,5,911,4.0,643.0,643.0,5,1079,4.0,811.0,811.0
0.118,6,10,1506,5,395,27.0,127.0,127.0,5,1111,26.0,843.0,843.0
0.001,17,2,180,1,66,0.0,38.0,38.0,1,114,0.0,86.0,86.0
0.015,6,10,1989,5,910,3.0,642.0,642.0,5,1079,3.0,811.0,811.0
0.005,6,10,1989,5,927,1.0,659.0,659.0,5,1062,1.0,794.0,794.0
11.191,17,28,4421,14,1994,848.0,269.0,114.0,14,2427,848.0,586.0,145.0
0.001,17,2,166,1,75,0.0,47.0,47.0,1,91,0.0,63.0,63.0
240.009,6,9,787,5,488,60002.0,232.0,232.0,4,299,80002.0,83.0,83.0
0.01,17,2,225,1,65,0.0,37.0,37.0,1,160,0.0,132.0,132.0
0.087,6,10,1506,5,395,17.0,127.0,127.0,5,1111,18.0,843.0,843.0
0.009,6,10,1990,5,911,2.0,643.0,643.0,5,1079,2.0,811.0,811.0
0.042,17,2,170,1,65,0.0,37.0,37.0,1,105,0.0,77.0,77.0
0.072,17,2,136,1,60,0.0,32.0,32.0,1,76,0.0,48.0,48.0
0.006,6,10,1547,5,764,1.0,496.0,496.0,5,783,1.0,515.0,515.0
0.005,6,10,2006,5,927,1.0,659.0,659.0,5,1079,1.0,811.0,811.0
0.007,6,10,2007,5,928,1.0,660.0,660.0,5,1079,1.0,811.0,811.0
0.001,17,2,180,1,66,0.0,38.0,38.0,1,114,0.0,86.0,86.0
0.004,6,10,2000,5,927,1.0,659.0,659.0,5,1073,1.0,805.0,805.0
368.417,6,22,2313,16,867,24561.0,195.0,195.0,6,1446,4641.0,419.0,398.0
88.927,6,24,4177,12,1679,8080.0,533.0,209.0,12,2498,8080.0,529.0,311.0
0.033,6,10,1990,5,911,8.0,643.0,643.0,5,1079,8.0,811.0,811.0
0.006,6,10,1689,5,839,1.0,571.0,571.0,5,850,1.0,582.0,582.0
0.041,6,14,3787,7,497,6.0,125.0,125.0,7,3290,6.0,1448.0,972.0
0.084,6,10,1506,5,395,17.0,127.0,127.0,5,1111,17.0,843.0,843.0
0.004,6,10,1702,5,863,1.0,595.0,595.0,5,839,0.0,571.0,571.0
309.477,17,20,1124,10,716,34372.0,48.0,43.0,10,408,34372.0,20.0,12.0
0.005,17,2,170,1,65,0.0,37.0,37.0,1,105,0.0,77.0,77.0
0.058,6,10,1506,5,395,13.0,127.0,127.0,5,1111,13.0,843.0,843.0
0.07,6,10,1506,5,395,15.0,127.0,127.0,5,1111,16.0,843.0,843.0
40.069,17,10,676,5,460,10016.0,104.0,64.0,5,216,10016.0,20.0,15.0
40.055,17,10,676,5,460,10012.0,104.0,64.0,5,216,10012.0,20.0,15.0
0.005,17,2,144,1,64,0.0,36.0,36.0,1,80,0.0,52.0,52.0
0.011,6,10,1990,5,911,2.0,643.0,643.0,5,1079,2.0,811.0,811.0
0.005,6,10,2006,5,927,1.0,659.0,659.0,5,1079,1.0,811.0,811.0
0.005,6,10,2000,5,927,1.0,659.0,659.0,5,1073,1.0,805.0,805.0
240.012,6,9,787,5,488,60003.0,232.0,232.0,4,299,80003.0,83.0,83.0
0.262,17,43,27971,26,24774,10.0,1350.0,924.0,17,3197,14.0,1350.0,160.0
369.86,6,22,2313,16,867,24657.0,195.0,195.0,6,1446,4643.0,419.0,398.0
368.403,6,22,2313,16,867,24560.0,195.0,195.0,6,1446,4645.0,419.0,398.0
0.005,6,10,1989,5,927,1.0,659.0,659.0,5,1062,1.0,794.0,794.0
40.083,17,10,676,5,460,10019.0,104.0,64.0,5,216,10019.0,20.0,15.0
0.116,6,10,1506,5,395,23.0,127.0,127.0,5,1111,24.0,843.0,843.0
0.005,6,10,1989,5,927,1.0,659.0,659.0,5,1062,1.0,794.0,794.0
221.782,17,16,892,8,564,31664.0,48.0,42.0,8,328,31663.0,20.0,13.0
0.003,17,2,148,1,60,0.0,32.0,32.0,1,88,0.0,60.0,60.0
0.005,6,10,2007,5,928,1.0,660.0,660.0,5,1079,1.0,811.0,811.0
0.017,6,10,1677,5,827,4.0,559.0,559.0,5,850,4.0,582.0,582.0
0.004,6,10,2000,5,927,1.0,659.0,659.0,5,1073,1.0,805.0,805.0
0.005,17,2,140,1,62,0.0,34.0,34.0,1,78,0.0,50.0,50.0
0.005,6,10,2006,5,927,1.0,659.0,659.0,5,1079,1.0,811.0,811.0
0.005,6,10,1989,5,927,1.0,659.0,659.0,5,1062,1.0,794.0,794.0
0.004,17,2,148,1,60,0.0,32.0,32.0,1,88,0.0,60.0,60.0
15.074,17,11,4409,5,2356,3761.0,1350.0,443.0,6,2053,3008.0,1350.0,314.0
0.005,6,10,1547,5,764,1.0,496.0,496.0,5,783,1.0,515.0,515.0
0.086,6,10,1506,5,395,19.0,127.0,127.0,5,1111,17.0,843.0,843.0
0.003,17,2,136,1,60,0.0,32.0,32.0,1,76,0.0,48.0,48.0
0.004,6,10,1779,5,928,1.0,660.0,660.0,5,851,1.0,583.0,583.0
0.004,17,2,162,1,65,0.0,37.0,37.0,1,97,0.0,69.0,69.0
0.006,6,10,1689,5,839,1.0,571.0,571.0,5,850,1.0,582.0,582.0
0.001,17,2,180,1,66,0.0,38.0,38.0,1,114,0.0,86.0,86.0
0.014,6,10,1972,5,910,3.0,642.0,642.0,5,1062,3.0,794.0,794.0
0.005,6,10,1547,5,764,1.0,496.0,496.0,5,783,1.0,515.0,515.0
0.005,6,10,2000,5,927,1.0,659.0,659.0,5,1073,1.0,805.0,805.0
0.004,6,5,310,3,175,2.0,31.0,31.0,2,135,0.0,31.0,31.0
40.066,17,10,676,5,460,10014.0,104.0,64.0,5,216,10015.0,20.0,15.0
0.019,6,10,1990,5,911,4.0,643.0,643.0,5,1079,4.0,811.0,811.0
0.005,6,10,1989,5,927,1.0,659.0,659.0,5,1062,1.0,794.0,794.0
0.018,6,10,1990,5,911,4.0,643.0,643.0,5,1079,4.0,811.0,811.0
0.005,6,10,2007,5,928,1.0,660.0,660.0,5,1079,1.0,811.0,811.0
0.005,6,10,2000,5,927,1.0,659.0,659.0,5,1073,1.0,805.0,805.0
0.005,6,10,1689,5,839,1.0,571.0,571.0,5,850,1.0,582.0,582.0
0.01,6,10,1989,5,910,2.0,642.0,642.0,5,1079,2.0,811.0,811.0
294.694,6,320,344428,121,17845,2455.0,2690.0,889.0,199,326583,1488.0,2917.0,1709.0
0.006,17,2,214,1,75,0.0,47.0,47.0,1,139,0.0,111.0,111.0
1.027,6,13,3929,7,2138,129.0,1328.0,923.0,6,1791,154.0,1539.0,1539.0
0.004,17,2,136,1,60,0.0,32.0,32.0,1,76,0.0,48.0,48.0
0.004,17,2,148,1,60,0.0,32.0,32.0,1,88,0.0,60.0,60.0
0.038,17,2,412,1,61,0.0,33.0,33.0,1,351,0.0,323.0,323.0
0.081,6,10,1506,5,395,18.0,127.0,127.0,5,1111,18.0,843.0,843.0
0.004,6,10,2007,5,928,1.0,660.0,660.0,5,1079,1.0,811.0,811.0
0.005,6,10,2006,5,927,1.0,659.0,659.0,5,1079,1.0,811.0,811.0
170.062,17,76,11095,38,2561,4596.0,44.0,39.0,38,8534,4596.0,261.0,196.0
0.009,6,12,1926,6,1189,1.0,659.0,434.0,6,737,1.0,417.0,417.0
240.083,6,16,4482,9,963,30010.0,238.0,166.0,7,3519,40013.0,1402.0,786.0
0.003,17,2,148,1,60,0.0,32.0,32.0,1,88,0.0,60.0,60.0
0.084,6,10,1506,5,395,17.0,127.0,127.0,5,1111,19.0,843.0,843.0
0.006,6,10,1547,5,764,1.0,496.0,496.0,5,783,1.0,515.0,515.0
0.118,6,10,1506,5,395,28.0,127.0,127.0,5,1111,24.0,843.0,843.0
0.006,6,10,1854,5,889,1.0,621.0,621.0,5,965,1.0,697.0,697.0
240.084,6,20,4874,10,889,26676.0,180.0,93.0,10,3985,26675.0,1593.0,576.0
0.009,6,10,1677,5,827,2.0,559.0,559.0,5,850,2.0,582.0,582.0
0.009,6,13,3735,7,497,1.0,125.0,125.0,6,3238,1.0,1470.0,1459.0
0.012,6,10,1972,5,910,3.0,642.0,642.0,5,1062,3.0,794.0,794.0
0.005,6,10,1547,5,764,1.0,496.0,496.0,5,783,1.0,515.0,515.0
0.005,6,10,2000,5,927,1.0,659.0,659.0,5,1073,1.0,805.0,805.0
0.016,6,10,1989,5,910,4.0,642.0,642.0,5,1079,4.0,811.0,811.0
11.498,17,28,4392,14,2313,872.0,588.0,137.0,14,2079,872.0,270.0,120.0
105.015,6,26,9525,12,1627,76.0,794.0,367.0,14,7898,8068.0,1360.0,732.0
0.014,6,10,1972,5,910,3.0,642.0,642.0,5,1062,3.0,794.0,794.0
0.01,6,10,1990,5,911,2.0,643.0,643.0,5,1079,2.0,811.0,811.0
0.006,6,10,1854,5,889,1.0,621.0,621.0,5,965,1.0,697.0,697.0
0.074,6,10,1506,5,395,17.0,127.0,127.0,5,1111,14.0,843.0,843.0
0.005,17,2,170,1,65,0.0,37.0,37.0,1,105,0.0,77.0,77.0
0.014,6,10,1972,5,910,3.0,642.0,642.0,5,1062,3.0,794.0,794.0
0.011,6,10,1677,5,827,2.0,559.0,559.0,5,850,2.0,582.0,582.0
300.323,6,16,2170,9,684,37519.0,146.0,146.0,7,1486,50025.0,419.0,398.0
0.004,17,2,194,1,59,0.0,31.0,31.0,1,135,0.0,107.0,107.0
0.005,17,2,164,1,74,0.0,46.0,46.0,1,90,0.0,62.0,62.0
0.072,17,4,284,2,120,0.0,32.0,32.0,2,164,68.0,60.0,54.0
0.006,6,10,1689,5,839,1.0,571.0,571.0,5,850,1.0,582.0,582.0
0.004,17,2,170,1,65,0.0,37.0,37.0,1,105,0.0,77.0,77.0
0.009,6,12,1926,6,1189,1.0,659.0,434.0,6,737,1.0,417.0,417.0
352.243,6,20,2210,6,1308,12003.0,494.0,494.0,14,902,27095.0,83.0,83.0
0.001,17,2,180,1,66,0.0,38.0,38.0,1,114,0.0,86.0,86.0
0.009,6,10,1989,5,910,2.0,642.0,642.0,5,1079,2.0,811.0,811.0
0.005,6,13,3747,7,509,0.0,137.0,137.0,6,3238,0.0,1470.0,1459.0
0.017,6,10,1762,5,911,4.0,643.0,643.0,5,851,4.0,583.0,583.0
0.005,6,10,2000,5,927,1.0,659.0,659.0,5,1073,1.0,805.0,805.0
0.004,6,10,2000,5,927,1.0,659.0,659.0,5,1073,1.0,805.0,805.0
0.068,6,10,1677,5,827,17.0,559.0,559.0,5,850,16.0,582.0,582.0
1749.067,6,431,65370,254,35296,6913.0,613.0,197.0,177,30074,9937.0,453.0,146.0
0.004,17,2,184,1,61,0.0,33.0,33.0,1,123,0.0,95.0,95.0
0.018,6,10,1989,5,910,4.0,642.0,642.0,5,1079,4.0,811.0,811.0
0.012,6,13,3735,7,497,2.0,125.0,125.0,6,3238,2.0,1470.0,1459.0
0.104,6,10,1506,5,395,23.0,127.0,127.0,5,1111,23.0,843.0,843.0
289.367,6,408,349491,200,21968,1454.0,2693.0,889.0,208,327523,1397.0,2968.0,1632.0
0.02,6,10,1983,5,910,5.0,642.0,642.0,5,1073,4.0,805.0,805.0
0.005,6,10,1779,5,928,1.0,660.0,660.0,5,851,1.0,583.0,583.0
0.008,6,10,1972,5,910,1.0,642.0,642.0,5,1062,2.0,794.0,794.0
0.038,17,2,148,1,60,0.0,32.0,32.0,1,88,0.0,60.0,60.0
0.007,17,2,194,1,59,0.0,31.0,31.0,1,135,0.0,107.0,107.0
0.01,6,12,1698,6,863,2.0,327.0,271.0,6,835,1.0,515.0,515.0
0.008,17,2,299,1,65,0.0,37.0,37.0,1,234,0.0,206.0,206.0
240.09,6,32,9651,16,7117,16006.0,2189.0,698.0,16,2534,16005.0,580.0,211.0
0.011,6,10,1989,5,910,2.0,642.0,642.0,5,1079,2.0,811.0,811.0
0.006,6,10,1547,5,764,1.0,496.0,496.0,5,783,1.0,515.0,515.0
0.012,6,10,1989,5,910,3.0,642.0,642.0,5,1079,3.0,811.0,811.0
0.008,6,10,1854,5,889,2.0,621.0,621.0,5,965,2.0,697.0,697.0
0.01,6,10,1989,5,910,2.0,642.0,642.0,5,1079,2.0,811.0,811.0
0.005,6,10,1643,5,860,1.0,592.0,592.0,5,783,1.0,515.0,515.0
0.097,6,10,1506,5,395,20.0,127.0,127.0,5,1111,19.0,843.0,843.0
40.065,17,10,676,5,460,10015.0,104.0,64.0,5,216,10015.0,20.0,15.0
0.015,6,10,1631,5,848,3.0,580.0,580.0,5,783,3.0,515.0,515.0
0.005,6,10,2006,5,927,1.0,659.0,659.0,5,1079,1.0,811.0,811.0
0.009,6,10,1677,5,827,2.0,559.0,559.0,5,850,2.0,582.0,582.0
0.005,6,10,2006,5,927,1.0,659.0,659.0,5,1079,1.0,811.0,811.0
0.063,6,10,1506,5,395,15.0,127.0,127.0,5,1111,14.0,843.0,843.0
0.005,6,10,2006,5,927,1.0,659.0,659.0,5,1079,1.0,811.0,811.0
0.038,17,2,412,1,61,0.0,33.0,33.0,1,351,0.0,323.0,323.0
0.072,17,2,182,1,65,0.0,37.0,37.0,1,117,0.0,89.0,89.0
0.005,6,10,2000,5,927,1.0,659.0,659.0,5,1073,1.0,805.0,805.0
0.101,6,10,1506,5,395,22.0,127.0,127.0,5,1111,19.0,843.0,843.0
0.007,6,10,1547,5,764,1.0,496.0,496.0,5,783,1.0,515.0,515.0
11.206,17,28,4423,14,1994,849.0,269.0,114.0,14,2429,849.0,588.0,145.0
0.005,6,10,2007,5,928,1.0,660.0,660.0,5,1079,1.0,811.0,811.0
0.099,6,10,1506,5,395,22.0,127.0,127.0,5,1111,22.0,843.0,843.0
0.017,6,10,1989,5,910,4.0,642.0,642.0,5,1079,4.0,811.0,811.0
0.006,6,10,1854,5,889,1.0,621.0,621.0,5,965,1.0,697.0,697.0
240.323,6,33,8637,17,1838,15020.0,571.0,189.0,16,6799,16021.0,1402.0,597.0
300.744,6,37,8261,20,1830,15828.0,651.0,249.0,17,6431,538.0,2720.0,478.0
10.901,17,28,4422,14,1994,829.0,269.0,114.0,14,2428,829.0,587.0,145.0
0.006,6,10,1689,5,839,1.0,571.0,571.0,5,850,1.0,582.0,582.0
0.001,17,2,180,1,66,0.0,38.0,38.0,1,114,0.0,86.0,86.0
0.01,6,10,1989,5,910,2.0,642.0,642.0,5,1079,2.0,811.0,811.0
0.005,6,10,1689,5,839,1.0,571.0,571.0,5,850,1.0,582.0,582.0
0.004,6,10,1989,5,927,1.0,659.0,659.0,5,1062,1.0,794.0,794.0
242.216,6,370,346289,193,21569,1261.0,2736.0,886.0,177,324720,1376.0,2804.0,1889.0
0.004,17,4,596,2,122,1.0,33.0,33.0,2,474,0.0,323.0,209.0
0.005,6,10,2000,5,927,1.0,659.0,659.0,5,1073,1.0,805.0,805.0
0.087,6,10,1506,5,395,20.0,127.0,127.0,5,1111,17.0,843.0,843.0
0.006,6,10,1547,5,764,1.0,496.0,496.0,5,783,1.0,515.0,515.0
0.008,6,10,1631,5,848,2.0,580.0,580.0,5,783,2.0,515.0,515.0
0.004,6,10,1779,5,928,1.0,660.0,660.0,5,851,1.0,583.0,583.0
0.005,17,2,169,1,62,0.0,34.0,34.0,1,107,0.0,79.0,79.0
0.005,17,2,148,1,60,0.0,32.0,32.0,1,88,0.0,60.0,60.0
266.923,6,40,10083,16,6866,17794.0,1938.0,670.0,24,3217,11605.0,580.0,130.0
0.106,6,10,1506,5,395,24.0,127.0,127.0,5,1111,26.0,843.0,843.0
0.008,17,2,179,1,71,0.0,43.0,43.0,1,108,0.0,80.0,80.0
309.011,17,20,1124,10,716,34320.0,48.0,43.0,10,408,34320.0,20.0,12.0
171.239,17,76,10842,38,2538,4627.0,44.0,38.0,38,8304,4628.0,239.0,190.0
0.007,6,10,1547,5,764,1.0,496.0,496.0,5,783,1.0,515.0,515.0
300.366,6,16,2170,9,684,37524.0,146.0,146.0,7,1486,50032.0,419.0,398.0
361.825,6,19,1688,15,978,25844.0,190.0,190.0,4,710,80012.0,494.0,494.0
0.005,6,15,3794,8,504,0.0,80.0,80.0,7,3290,0.0,1448.0,972.0
0.083,6,10,1506,5,395,17.0,127.0,127.0,5,1111,19.0,843.0,843.0
0.001,17,2,288,1,69,0.0,41.0,41.0,1,219,0.0,191.0,191.0
352.567,6,20,2210,6,1308,12003.0,494.0,494.0,14,902,27120.0,83.0,83.0
0.004,6,10,1702,5,863,1.0,595.0,595.0,5,839,0.0,571.0,571.0
0.063,6,10,1506,5,395,13.0,127.0,127.0,5,1111,14.0,843.0,843.0
0.016,6,10,1631,5,848,4.0,580.0,580.0,5,783,4.0,515.0,515.0
0.012,6,10,1989,5,910,3.0,642.0,642.0,5,1079,3.0,811.0,811.0
0.009,6,10,1677,5,827,2.0,559.0,559.0,5,850,2.0,582.0,582.0
0.039,17,2,148,1,60,0.0,32.0,32.0,1,88,0.0,60.0,60.0
0.006,6,10,1854,5,889,1.0,621.0,621.0,5,965,1.0,697.0,697.0
0.001,17,2,179,1,62,0.0,34.0,34.0,1,117,0.0,89.0,89.0
0.006,6,10,1547,5,764,1.0,496.0,496.0,5,783,1.0,515.0,515.0
0.004,17,2,166,1,75,0.0,47.0,47.0,1,91,0.0,63.0,63.0
240.014,6,9,787,5,488,60003.0,232.0,232.0,4,299,80003.0,83.0,83.0
0.004,6,10,2007,5,928,1.0,660.0,660.0,5,1079,1.0,811.0,811.0
0.011,6,12,1926,6,1189,2.0,659.0,434.0,6,737,2.0,417.0,417.0
1777.453,17,143,41496,72,22752,25034.0,288.0,288.0,71,18744,25392.0,236.0,236.0
0.013,6,10,1989,5,910,3.0,642.0,642.0,5,1079,3.0,811.0,811.0
0.016,6,10,1989,5,910,4.0,642.0,642.0,5,1079,4.0,811.0,811.0
1792.788,6,253,25546,103,9485,17575.0,586.0,66.0,150,16061,12031.0,1360.0,130.0
0.061,6,10,1506,5,395,13.0,127.0,127.0,5,1111,14.0,843.0,843.0
309.643,17,20,1124,10,716,34395.0,48.0,43.0,10,408,34394.0,20.0,12.0
0.07,17,2,148,1,60,0.0,32.0,32.0,1,88,0.0,60.0,60.0
300.815,6,41,14180,22,8622,14324.0,2720.0,1101.0,19,5558,481.0,2667.0,435.0
0.005,6,13,3747,7,509,0.0,137.0,137.0,6,3238,0.0,1470.0,1459.0
0.009,6,10,1762,5,911,2.0,643.0,643.0,5,851,2.0,583.0,583.0
0.006,6,10,1547,5,764,1.0,496.0,496.0,5,783,1.0,515.0,515.0
0.01,6,10,1989,5,910,2.0,642.0,642.0,5,1079,2.0,811.0,811.0
0.114,6,10,1506,5,395,26.0,127.0,127.0,5,1111,20.0,843.0,843.0
0.005,17,2,214,1,75,0.0,47.0,47.0,1,139,0.0,111.0,111.0
0.009,6,12,1926,6,1189,1.0,659.0,434.0,6,737,1.0,417.0,417.0
0.043,17,2,184,1,61,0.0,33.0,33.0,1,123,0.0,95.0,95.0
0.018,6,13,3735,7,497,3.0,125.0,125.0,6,3238,3.0,1470.0,1459.0
0.001,17,2,194,1,57,0.0,29.0,29.0,1,137,0.0,109.0,109.0
0.016,6,10,1989,5,910,4.0,642.0,642.0,5,1079,3.0,811.0,811.0
0.127,6,10,1506,5,395,21.0,127.0,127.0,5,1111,29.0,843.0,843.0
0.007,6,10,1989,5,927,1.0,659.0,659.0,5,1062,1.0,794.0,794.0
11.189,17,28,4416,14,1993,848.0,268.0,114.0,14,2423,848.0,586.0,145.0
0.013,6,10,1990,5,911,3.0,643.0,643.0,5,1079,3.0,811.0,811.0
0.012,6,10,1762,5,911,3.0,643.0,643.0,5,851,3.0,583.0,583.0
0.039,17,2,148,1,60,0.0,32.0,32.0,1,88,0.0,60.0,60.0
0.023,6,10,1631,5,848,5.0,580.0,580.0,5,783,5.0,515.0,515.0
0.001,17,2,164,1,74,0.0,46.0,46.0,1,90,0.0,62.0,62.0
0.006,17,2,194,1,59,0.0,31.0,31.0,1,135,0.0,107.0,107.0
0.003,6,10,1702,5,863,0.0,595.0,595.0,5,839,0.0,571.0,571.0
0.005,6,10,1689,5,839,1.0,571.0,571.0,5,850,1.0,582.0,582.0
0.005,6,14,3736,7,446,0.0,74.0,74.0,7,3290,0.0,1448.0,972.0
0.006,6,10,1547,5,764,1.0,496.0,496.0,5,783,1.0,515.0,515.0
228.211,17,94,13425,47,3136,4960.0,44.0,38.0,47,10289,4961.0,261.0,190.0
40.062,17,10,676,5,460,10014.0,104.0,64.0,5,216,10014.0,20.0,15.0
0.004,6,10,1702,5,863,1.0,595.0,595.0,5,839,1.0,571.0,571.0
0.112,6,10,1506,5,395,25.0,127.0,127.0,5,1111,25.0,843.0,843.0
0.084,6,10,1506,5,395,19.0,127.0,127.0,5,1111,19.0,843.0,843.0
0.004,17,2,148,1,60,0.0,32.0,32.0,1,88,0.0,60.0,60.0
0.083,6,10,1506,5,395,18.0,127.0,127.0,5,1111,19.0,843.0,843.0
0.044,17,2,152,1,76,0.0,48.0,48.0,1,76,0.0,48.0,48.0
0.117,6,10,1506,5,395,26.0,127.0,127.0,5,1111,26.0,843.0,843.0
0.005,6,10,2000,5,927,1.0,659.0,659.0,5,1073,1.0,805.0,805.0
0.17,6,3,453,2,321,170.0,241.0,241.0,1,132,0.0,92.0,92.0
0.015,6,10,1989,5,910,3.0,642.0,642.0,5,1079,3.0,811.0,811.0
354.09,6,21,1795,16,1030,23606.0,190.0,190.0,5,765,60002.0,464.0,248.0
0.006,17,2,180,1,66,0.0,38.0,38.0,1,114,0.0,86.0,86.0
0.169,17,2,152,1,76,0.0,48.0,48.0,1,76,0.0,48.0,48.0
0.011,6,10,1677,5,827,2.0,559.0,559.0,5,850,2.0,582.0,582.0
0.004,6,10,1989,5,927,1.0,659.0,659.0,5,1062,1.0,794.0,794.0
0.005,17,2,140,1,62,0.0,34.0,34.0,1,78,0.0,50.0,50.0
0.004,17,4,284,2,120,1.0,32.0,32.0,2,164,0.0,60.0,54.0
0.004,17,2,136,1,60,0.0,32.0,32.0,1,76,0.0,48.0,48.0
0.014,6,10,1972,5,910,3.0,642.0,642.0,5,1062,3.0,794.0,794.0
0.005,6,10,1989,5,927,1.0,659.0,659.0,5,1062,1.0,794.0,794.0
0.08,6,10,1506,5,395,17.0,127.0,127.0,5,1111,14.0,843.0,843.0
65.745,6,23,8537,12,2236,79.0,1345.0,574.0,11,6301,6558.0,2720.0,974.0
309.84,17,20,1124,10,716,34414.0,48.0,43.0,10,408,34413.0,20.0,12.0
0.086,6,10,1506,5,395,18.0,127.0,127.0,5,1111,17.0,843.0,843.0
0.005,6,10,1689,5,839,1.0,571.0,571.0,5,850,1.0,582.0,582.0
0.055,6,10,1506,5,395,13.0,127.0,127.0,5,1111,12.0,843.0,843.0
0.006,17,2,166,1,75,0.0,47.0,47.0,1,91,0.0,63.0,63.0
0.005,6,10,2006,5,927,1.0,659.0,659.0,5,1079,1.0,811.0,811.0
0.005,6,10,1989,5,927,1.0,659.0,659.0,5,1062,1.0,794.0,794.0
0.169,17,2,152,1,76,0.0,48.0,48.0,1,76,0.0,48.0,48.0
0.092,6,10,1506,5,395,17.0,127.0,127.0,5,1111,22.0,843.0,843.0
0.008,6,10,1990,5,911,2.0,643.0,643.0,5,1079,2.0,811.0,811.0
0.005,6,10,1989,5,927,1.0,659.0,659.0,5,1062,1.0,794.0,794.0
176.248,17,76,10766,38,2529,4763.0,44.0,38.0,38,8237,4763.0,239.0,188.0
0.01,6,10,1972,5,910,2.0,642.0,642.0,5,1062,2.0,794.0,794.0
0.003,17,2,148,1,60,0.0,32.0,32.0,1,88,0.0,60.0,60.0
0.125,6,10,1506,5,395,29.0,127.0,127.0,5,1111,17.0,843.0,843.0
0.005,17,2,170,1,65,0.0,37.0,37.0,1,105,0.0,77.0,77.0
0.004,17,2,148,1,60,0.0,32.0,32.0,1,88,0.0,60.0,60.0
0.006,6,10,1547,5,764,1.0,496.0,496.0,5,783,1.0,515.0,515.0
0.005,17,2,179,1,71,0.0,43.0,43.0,1,108,0.0,80.0,80.0
0.004,6,10,2000,5,927,1.0,659.0,659.0,5,1073,1.0,805.0,805.0
240.079,6,16,4481,9,963,30009.0,238.0,166.0,7,3518,40012.0,1402.0,786.0
0.011,6,10,1990,5,911,2.0,643.0,643.0,5,1079,2.0,811.0,811.0
0.008,6,12,1926,6,1189,1.0,659.0,434.0,6,737,1.0,417.0,417.0
0.009,6,10,1774,5,923,2.0,655.0,655.0,5,851,2.0,583.0,583.0
240.561,6,33,9265,16,1836,16035.0,624.0,199.0,17,7429,15033.0,1402.0,595.0
240.09,6,16,4480,9,963,30011.0,238.0,166.0,7,3517,40014.0,1402.0,786.0
0.072,6,10,1506,5,395,14.0,127.0,127.0,5,1111,16.0,843.0,843.0
0.012,6,10,1990,5,911,2.0,643.0,643.0,5,1079,2.0,811.0,811.0
0.016,6,10,1762,5,911,4.0,643.0,643.0,5,851,3.0,583.0,583.0
0.005,6,10,2006,5,927,1.0,659.0,659.0,5,1079,1.0,811.0,811.0
0.069,6,10,1506,5,395,15.0,127.0,127.0,5,1111,15.0,843.0,843.0
40.06,17,10,676,5,460,10014.0,104.0,64.0,5,216,10014.0,20.0,15.0
32.129,6,38,9820,20,4257,1691.0,3092.0,1137.0,18,5563,510.0,2667.0,402.0
0.043,17,2,166,1,75,0.0,47.0,47.0,1,91,0.0,63.0,63.0
0.115,6,10,1506,5,395,26.0,127.0,127.0,5,1111,22.0,843.0,843.0
0.005,6,10,1547,5,764,1.0,496.0,496.0,5,783,1.0,515.0,515.0
0.005,6,10,2007,5,928,1.0,660.0,660.0,5,1079,1.0,811.0,811.0
0.012,6,10,1990,5,911,2.0,643.0,643.0,5,1079,3.0,811.0,811.0
1786.732,6,256,25895,105,9794,17178.0,758.0,69.0,151,16101,11910.0,1360.0,130.0
0.132,17,2,186,1,61,0.0,33.0,33.0,1,125,0.0,97.0,97.0
0.006,6,10,1547,5,764,1.0,496.0,496.0,5,783,1.0,515.0,515.0
0.004,6,10,2007,5,928,1.0,660.0,660.0,5,1079,1.0,811.0,811.0
1.082,6,27,10462,14,1575,83.0,517.0,211.0,13,8887,89.0,1402.0,911.0
0.014,6,10,1989,5,910,3.0,642.0,642.0,5,1079,3.0,811.0,811.0
0.012,6,10,1983,5,910,3.0,642.0,642.0,5,1073,2.0,805.0,805.0
0.005,17,2,230,1,68,0.0,40.0,40.0,1,162,0.0,134.0,134.0
300.026,6,12,1782,7,1348,50004.0,494.0,494.0,5,434,75006.0,83.0,83.0
0.006,6,10,1689,5,839,1.0,571.0,571.0,5,850,1.0,582.0,582.0
0.519,17,60,41572,35,35385,15.0,1350.0,983.0,25,6187,19.0,1350.0,219.0
0.013,6,10,1972,5,910,3.0,642.0,642.0,5,1062,3.0,794.0,794.0
0.077,6,10,1506,5,395,16.0,127.0,127.0,5,1111,18.0,843.0,843.0
0.041,17,2,170,1,65,0.0,37.0,37.0,1,105,0.0,77.0,77.0
0.017,6,10,1774,5,923,4.0,655.0,655.0,5,851,4.0,583.0,583.0
0.012,6,10,1972,5,910,3.0,642.0,642.0,5,1062,3.0,794.0,794.0
0.013,6,10,1989,5,910,3.0,642.0,642.0,5,1079,3.0,811.0,811.0
10.969,17,28,4394,14,2312,835.0,587.0,137.0,14,2082,835.0,269.0,120.0
0.079,6,10,1506,5,395,18.0,127.0,127.0,5,1111,19.0,843.0,843.0
0.083,6,10,1506,5,395,18.0,127.0,127.0,5,1111,18.0,843.0,843.0
0.015,6,10,1762,5,911,3.0,643.0,643.0,5,851,3.0,583.0,583.0
0.018,6,10,1677,5,827,4.0,559.0,559.0,5,850,4.0,582.0,582.0
178.077,17,74,10429,37,2474,4946.0,44.0,38.0,37,7955,4946.0,239.0,187.0
176.569,17,82,11744,41,2736,4414.0,44.0,38.0,41,9008,4414.0,261.0,191.0
0.005,17,2,222,1,65,0.0,37.0,37.0,1,157,0.0,129.0,129.0
300.332,6,16,2170,9,684,37520.0,146.0,146.0,7,1486,50026.0,419.0,398.0
0.005,6,10,1643,5,860,1.0,592.0,592.0,5,783,1.0,515.0,515.0
0.204,6,16,2778,8,1396,29.0,533.0,324.0,8,1382,18.0,529.0,239.0
40.148,17,10,676,5,460,10036.0,104.0,64.0,5,216,10036.0,20.0,15.0
0.013,6,10,1990,5,911,3.0,643.0,643.0,5,1079,3.0,811.0,811.0
0.005,6,13,3747,7,509,0.0,137.0,137.0,6,3238,1.0,1470.0,1459.0
40.078,17,10,676,5,460,10018.0,104.0,64.0,5,216,10018.0,20.0,15.0
0.004,6,10,1989,5,927,1.0,659.0,659.0,5,1062,1.0,794.0,794.0
0.237,6,10,1506,5,395,51.0,127.0,127.0,5,1111,42.0,843.0,843.0
0.098,6,10,1506,5,395,21.0,127.0,127.0,5,1111,19.0,843.0,843.0
0.013,17,2,152,1,56,0.0,28.0,28.0,1,96,0.0,68.0,68.0
0.005,6,10,2006,5,927,1.0,659.0,659.0,5,1079,1.0,811.0,811.0
0.008,6,10,1989,5,910,1.0,642.0,642.0,5,1079,1.0,811.0,811.0
0.008,6,10,2007,5,928,1.0,660.0,660.0,5,1079,2.0,811.0,811.0
0.005,6,10,1989,5,927,1.0,659.0,659.0,5,1062,1.0,794.0,794.0
0.01,6,10,1989,5,910,2.0,642.0,642.0,5,1079,2.0,811.0,811.0
0.016,17,4,284,2,120,12.0,32.0,32.0,2,164,12.0,60.0,54.0
0.016,6,10,1989,5,910,3.0,642.0,642.0,5,1079,4.0,811.0,811.0
0.081,6,10,1506,5,395,19.0,127.0,127.0,5,1111,16.0,843.0,843.0
0.13,6,10,1506,5,395,29.0,127.0,127.0,5,1111,30.0,843.0,843.0
0.041,17,4,420,2,122,0.0,33.0,33.0,2,298,37.0,145.0,121.0
368.801,6,22,2313,16,867,24586.0,195.0,195.0,6,1446,4637.0,419.0,398.0
0.016,6,10,1990,5,911,3.0,643.0,643.0,5,1079,4.0,811.0,811.0
0.126,6,10,1506,5,395,29.0,127.0,127.0,5,1111,22.0,843.0,843.0
0.006,6,10,2007,5,928,1.0,660.0,660.0,5,1079,1.0,811.0,811.0
0.006,6,13,3690,7,452,1.0,80.0,80.0,6,3238,1.0,1470.0,1459.0
0.005,6,10,2000,5,927,1.0,659.0,659.0,5,1073,1.0,805.0,805.0
0.005,6,10,2007,5,928,1.0,660.0,660.0,5,1079,1.0,811.0,811.0
0.005,6,10,1779,5,928,1.0,660.0,660.0,5,851,1.0,583.0,583.0
0.005,6,10,2006,5,927,1.0,659.0,659.0,5,1079,1.0,811.0,811.0
0.005,6,10,1854,5,889,1.0,621.0,621.0,5,965,1.0,697.0,697.0
0.006,17,2,214,1,75,0.0,47.0,47.0,1,139,0.0,111.0,111.0
0.005,6,14,3799,7,509,0.0,137.0,137.0,7,3290,0.0,1448.0,972.0
0.022,17,2,198,1,91,0.0,63.0,63.0,1,107,0.0,79.0,79.0
0.005,6,10,2006,5,927,1.0,659.0,659.0,5,1079,1.0,811.0,811.0
0.011,6,10,1989,5,910,2.0,642.0,642.0,5,1079,2.0,811.0,811.0
0.001,17,2,132,1,58,0.0,30.0,30.0,1,74,0.0,46.0,46.0
0.006,6,10,1547,5,764,1.0,496.0,496.0,5,783,1.0,515.0,515.0
0.004,6,10,1774,5,923,1.0,655.0,655.0,5,851,1.0,583.0,583.0
240.081,6,16,4481,9,963,30010.0,238.0,166.0,7,3518,40013.0,1402.0,786.0
0.007,6,10,1854,5,889,1.0,621.0,621.0,5,965,1.0,697.0,697.0
0.01,6,10,1762,5,911,2.0,643.0,643.0,5,851,2.0,583.0,583.0
0.005,6,10,1854,5,889,1.0,621.0,621.0,5,965,1.0,697.0,697.0
0.996,6,13,3930,7,2139,124.0,1328.0,923.0,6,1791,149.0,1539.0,1539.0
0.097,6,10,1506,5,395,21.0,127.0,127.0,5,1111,20.0,843.0,843.0
0.006,6,10,2000,5,927,1.0,659.0,659.0,5,1073,1.0,805.0,805.0
0.007,6,10,1547,5,764,1.0,496.0,496.0,5,783,1.0,515.0,515.0
0.005,17,2,214,1,75,0.0,47.0,47.0,1,139,0.0,111.0,111.0
0.003,17,2,136,1,60,0.0,32.0,32.0,1,76,0.0,48.0,48.0
0.005,17,2,154,1,69,0.0,41.0,41.0,1,85,0.0,57.0,57.0
0.004,6,10,2007,5,928,1.0,660.0,660.0,5,1079,1.0,811.0,811.0
0.012,6,10,1983,5,910,3.0,642.0,642.0,5,1073,2.0,805.0,805.0
0.007,6,10,1689,5,839,1.0,571.0,571.0,5,850,1.0,582.0,582.0
0.005,6,13,3747,7,509,0.0,137.0,137.0,6,3238,1.0,1470.0,1459.0
0.005,6,10,1989,5,927,1.0,659.0,659.0,5,1062,1.0,794.0,794.0
11.173,17,28,4423,14,1994,846.0,269.0,114.0,14,2429,846.0,588.0,145.0
0.071,6,10,1506,5,395,15.0,127.0,127.0,5,1111,17.0,843.0,843.0
0.005,6,10,1547,5,764,1.0,496.0,496.0,5,783,1.0,515.0,515.0
0.011,6,10,1972,5,910,2.0,642.0,642.0,5,1062,2.0,794.0,794.0
0.005,6,10,2000,5,927,1.0,659.0,659.0,5,1073,1.0,805.0,805.0
0.001,17,2,180,1,66,0.0,38.0,38.0,1,114,0.0,86.0,86.0
0.004,6,10,1702,5,863,1.0,595.0,595.0,5,839,1.0,571.0,571.0
0.015,6,10,1989,5,910,3.0,642.0,642.0,5,1079,3.0,811.0,811.0
0.01,6,10,1990,5,911,2.0,643.0,643.0,5,1079,2.0,811.0,811.0
0.039,17,2,170,1,65,0.0,37.0,37.0,1,105,0.0,77.0,77.0
308.512,17,20,1124,10,716,34266.0,48.0,43.0,10,408,34269.0,20.0,12.0
0.005,6,13,3747,7,509,0.0,137.0,137.0,6,3238,0.0,1470.0,1459.0
15.072,17,14,9190,8,6902,2149.0,1350.0,834.0,6,2288,3008.0,1350.0,353.0
20.082,6,55,24738,27,18591,357.0,2720.0,1456.0,28,6147,737.0,2667.0,385.0
0.01,6,12,1926,6,1189,1.0,659.0,434.0,6,737,1.0,417.0,417.0
0.008,17,2,194,1,59,0.0,31.0,31.0,1,135,0.0,107.0,107.0
240.104,6,16,4480,9,963,30013.0,238.0,166.0,7,3517,40016.0,1402.0,786.0
0.009,6,10,1983,5,910,2.0,642.0,642.0,5,1073,2.0,805.0,805.0
0.021,6,10,1990,5,911,5.0,643.0,643.0,5,1079,5.0,811.0,811.0
0.009,6,10,2006,5,927,2.0,659.0,659.0,5,1079,2.0,811.0,811.0
0.01,6,10,1972,5,910,2.0,642.0,642.0,5,1062,2.0,794.0,794.0
0.134,17,2,80,1,32,0.0,4.0,4.0,1,48,0.0,20.0,20.0
0.029,6,10,1989,5,910,7.0,642.0,642.0,5,1079,7.0,811.0,811.0
0.005,6,10,1643,5,860,1.0,592.0,592.0,5,783,1.0,515.0,515.0
0.068,17,8,3613,4,1874,22.0,1350.0,440.0,4,1739,11.0,1350.0,406.0
0.015,6,10,1990,5,911,3.0,643.0,643.0,5,1079,3.0,811.0,811.0
240.259,6,40,5197,19,2375,13347.0,588.0,197.0,21,2822,12012.0,580.0,215.0
0.148,6,10,1506,5,395,32.0,127.0,127.0,5,1111,34.0,843.0,843.0
0.001,17,2,180,1,66,0.0,38.0,38.0,1,114,0.0,86.0,86.0
0.07,6,10,1506,5,395,16.0,127.0,127.0,5,1111,13.0,843.0,843.0
0.004,6,10,2006,5,927,1.0,659.0,659.0,5,1079,1.0,811.0,811.0
9.059,17,6,376,5,280,2264.0,28.0,28.0,1,96,0.0,68.0,68.0
0.005,17,2,170,1,65,0.0,37.0,37.0,1,105,0.0,77.0,77.0
314.761,17,20,1124,10,716,34958.0,48.0,43.0,10,408,34958.0,20.0,12.0
0.105,6,10,1506,5,395,23.0,127.0,127.0,5,1111,22.0,843.0,843.0
0.014,6,10,1677,5,827,3.0,559.0,559.0,5,850,3.0,582.0,582.0
0.001,17,2,180,1,66,0.0,38.0,38.0,1,114,0.0,86.0,86.0
0.007,6,10,1989,5,910,1.0,642.0,642.0,5,1079,1.0,811.0,811.0
309.222,17,20,1124,10,716,34343.0,48.0,43.0,10,408,34342.0,20.0,12.0
240.081,6,16,4482,9,963,30010.0,238.0,166.0,7,3519,40013.0,1402.0,786.0
1788.218,6,65,7396,43,4521,42576.0,1402.0,103.0,22,2875,85145.0,1111.0,82.0
1772.27,6,300,97413,184,86240,9684.0,2001.0,690.0,116,11173,15410.0,452.0,70.0
40.053,17,10,676,5,460,10012.0,104.0,64.0,5,216,10012.0,20.0,15.0
0.005,17,2,170,1,65,0.0,37.0,37.0,1,105,0.0,77.0,77.0
173.343,17,76,10748,38,2529,4684.0,44.0,38.0,38,8219,4684.0,239.0,188.0
0.011,6,10,1972,5,910,2.0,642.0,642.0,5,1062,2.0,794.0,794.0
0.013,6,11,2041,6,962,2.0,642.0,642.0,5,1079,3.0,811.0,811.0
0.004,6,10,2006,5,927,1.0,659.0,659.0,5,1079,1.0,811.0,811.0
0.011,6,10,1989,5,910,2.0,642.0,642.0,5,1079,2.0,811.0,811.0
0.004,6,10,1779,5,928,1.0,660.0,660.0,5,851,1.0,583.0,583.0
0.006,6,10,2006,5,927,1.0,659.0,659.0,5,1079,1.0,811.0,811.0
0.018,6,10,1989,5,910,4.0,642.0,642.0,5,1079,4.0,811.0,811.0
0.014,6,10,1990,5,911,3.0,643.0,643.0,5,1079,3.0,811.0,811.0
0.02,6,10,1990,5,911,5.0,643.0,643.0,5,1079,4.0,811.0,811.0
0.082,6,10,1506,5,395,16.0,127.0,127.0,5,1111,19.0,843.0,843.0
0.005,6,10,1689,5,839,1.0,571.0,571.0,5,850,1.0,582.0,582.0
15.074,17,15,9238,8,6902,2149.0,1350.0,834.0,7,2336,2507.0,1350.0,305.0
0.006,6,10,1689,5,839,1.0,571.0,571.0,5,850,1.0,582.0,582.0
351.993,6,20,2210,6,1308,12003.0,494.0,494.0,14,902,27076.0,83.0,83.0
0.094,6,10,1506,5,395,20.0,127.0,127.0,5,1111,20.0,843.0,843.0
1.165,6,31,12751,18,3352,68.0,1360.0,517.0,13,9399,80.0,2720.0,985.0
0.04,17,4,284,2,120,0.0,32.0,32.0,2,164,36.0,60.0,54.0
0.006,6,10,1643,5,860,1.0,592.0,592.0,5,783,1.0,515.0,515.0
0.128,17,2,80,1,32,0.0,4.0,4.0,1,48,0.0,20.0,20.0
0.006,6,10,1547,5,764,1.0,496.0,496.0,5,783,1.0,515.0,515.0
0.005,6,10,1989,5,927,1.0,659.0,659.0,5,1062,1.0,794.0,794.0
0.127,6,10,1506,5,395,29.0,127.0,127.0,5,1111,28.0,843.0,843.0
0.001,17,2,136,1,60,0.0,32.0,32.0,1,76,0.0,48.0,48.0
1.076,6,31,13352,17,5853,67.0,2720.0,854.0,14,7499,68.0,2720.0,769.0
1778.014,17,144,45504,72,22752,25042.0,288.0,288.0,72,22752,25042.0,288.0,288.0
0.006,6,10,2006,5,927,1.0,659.0,659.0,5,1079,1.0,811.0,811.0
0.003,17,2,148,1,60,0.0,32.0,32.0,1,88,0.0,60.0,60.0
0.009,6,10,1989,5,910,2.0,642.0,642.0,5,1079,2.0,811.0,811.0
0.006,6,10,1547,5,764,1.0,496.0,496.0,5,783,1.0,515.0,515.0
0.146,6,10,1506,5,395,25.0,127.0,127.0,5,1111,34.0,843.0,843.0
0.005,6,10,1989,5,927,1.0,659.0,659.0,5,1062,1.0,794.0,794.0
0.091,6,10,1506,5,395,20.0,127.0,127.0,5,1111,17.0,843.0,843.0
0.005,6,10,1547,5,764,1.0,496.0,496.0,5,783,1.0,515.0,515.0
0.081,6,10,1506,5,395,19.0,127.0,127.0,5,1111,15.0,843.0,843.0
0.017,6,10,1762,5,911,4.0,643.0,643.0,5,851,4.0,583.0,583.0
0.107,6,10,1506,5,395,24.0,127.0,127.0,5,1111,26.0,843.0,843.0
0.004,17,2,148,1,60,0.0,32.0,32.0,1,88,0.0,60.0,60.0
0.014,6,10,1990,5,911,3.0,643.0,643.0,5,1079,3.0,811.0,811.0
0.094,6,10,1506,5,395,22.0,127.0,127.0,5,1111,20.0,843.0,843.0
0.007,6,10,1547,5,764,1.0,496.0,496.0,5,783,1.0,515.0,515.0
309.921,17,20,1124,10,716,34422.0,48.0,43.0,10,408,34422.0,20.0,12.0
0.005,6,10,1643,5,860,1.0,592.0,592.0,5,783,1.0,515.0,515.0
0.107,6,10,1506,5,395,21.0,127.0,127.0,5,1111,24.0,843.0,843.0
40.072,17,10,676,5,460,10015.0,104.0,64.0,5,216,10017.0,20.0,15.0
10.774,17,28,4422,14,1994,820.0,269.0,114.0,14,2428,820.0,587.0,145.0
61.51,6,40,10527,19,4889,496.0,1360.0,682.0,21,5638,3067.0,1360.0,398.0
170.406,17,86,12550,43,2889,4057.0,44.0,39.0,43,9661,4057.0,261.0,196.0
0.091,6,10,1506,5,395,18.0,127.0,127.0,5,1111,21.0,843.0,843.0
0.156,6,10,1506,5,395,28.0,127.0,127.0,5,1111,36.0,843.0,843.0
0.013,6,6,716,3,458,5.0,302.0,302.0,3,258,4.0,102.0,102.0
0.069,6,10,1506,5,395,15.0,127.0,127.0,5,1111,16.0,843.0,843.0
0.005,6,10,1989,5,927,1.0,659.0,659.0,5,1062,1.0,794.0,794.0
0.012,6,10,1989,5,910,3.0,642.0,642.0,5,1079,3.0,811.0,811.0
0.005,6,13,3690,7,452,0.0,80.0,80.0,6,3238,1.0,1470.0,1459.0
0.118,6,10,1506,5,395,25.0,127.0,127.0,5,1111,26.0,843.0,843.0
0.005,6,10,1689,5,839,1.0,571.0,571.0,5,850,1.0,582.0,582.0
15.071,17,15,9238,8,6902,2148.0,1350.0,834.0,7,2336,2507.0,1350.0,305.0
0.097,6,10,1506,5,395,21.0,127.0,127.0,5,1111,21.0,843.0,843.0
0.15,6,10,1506,5,395,34.0,127.0,127.0,5,1111,34.0,843.0,843.0
0.009,17,2,261,1,74,0.0,46.0,46.0,1,187,0.0,159.0,159.0
0.005,17,2,144,1,64,0.0,36.0,36.0,1,80,0.0,52.0,52.0
0.005,6,10,2006,5,927,1.0,659.0,659.0,5,1079,1.0,811.0,811.0
0.108,6,10,1506,5,395,22.0,127.0,127.0,5,1111,23.0,843.0,843.0
0.005,6,10,2006,5,927,1.0,659.0,659.0,5,1079,1.0,811.0,811.0
0.085,6,10,1506,5,395,19.0,127.0,127.0,5,1111,17.0,843.0,843.0
0.005,6,10,2007,5,928,1.0,660.0,660.0,5,1079,1.0,811.0,811.0
300.21,6,39,10113,21,4595,15002.0,1360.0,620.0,18,5518,17649.0,2667.0,435.0
0.087,6,10,1506,5,395,19.0,127.0,127.0,5,1111,19.0,843.0,843.0
0.01,6,10,1972,5,910,2.0,642.0,642.0,5,1062,2.0,794.0,794.0
0.006,6,10,2000,5,927,1.0,659.0,659.0,5,1073,1.0,805.0,805.0
10.794,17,28,4422,14,1994,822.0,269.0,114.0,14,2428,822.0,587.0,145.0
0.007,17,2,307,1,61,0.0,33.0,33.0,1,246,0.0,218.0,218.0
1777.571,17,142,44872,72,22752,25036.0,288.0,288.0,70,22120,25749.0,288.0,288.0
0.043,17,2,152,1,76,0.0,48.0,48.0,1,76,0.0,48.0,48.0
315.471,17,20,1124,10,716,35045.0,48.0,43.0,10,408,35045.0,20.0,12.0
0.089,6,10,1506,5,395,19.0,127.0,127.0,5,1111,21.0,843.0,843.0
0.011,6,10,1989,5,910,2.0,642.0,642.0,5,1079,2.0,811.0,811.0
0.014,6,10,1972,5,910,3.0,642.0,642.0,5,1062,3.0,794.0,794.0
0.004,17,2,148,1,60,0.0,32.0,32.0,1,88,0.0,60.0,60.0
0.079,6,10,1506,5,395,18.0,127.0,127.0,5,1111,19.0,843.0,843.0
1787.466,6,150,19350,90,13740,20083.0,302.0,302.0,60,5610,30295.0,83.0,83.0
0.001,17,2,180,1,66,0.0,38.0,38.0,1,114,0.0,86.0,86.0
0.009,6,10,1972,5,910,2.0,642.0,642.0,5,1062,2.0,794.0,794.0
40.015,17,10,676,5,460,10002.0,104.0,64.0,5,216,10002.0,20.0,15.0
0.014,17,2,299,1,65,0.0,37.0,37.0,1,234,0.0,206.0,206.0
0.069,6,10,1506,5,395,15.0,127.0,127.0,5,1111,14.0,843.0,843.0
0.072,17,2,136,1,60,0.0,32.0,32.0,1,76,0.0,48.0,48.0
0.133,6,10,1506,5,395,30.0,127.0,127.0,5,1111,29.0,843.0,843.0
0.012,6,10,1972,5,910,2.0,642.0,642.0,5,1062,3.0,794.0,794.0
0.004,17,2,148,1,60,0.0,32.0,32.0,1,88,0.0,60.0,60.0
0.005,6,10,1989,5,927,1.0,659.0,659.0,5,1062,1.0,794.0,794.0
0.021,17,2,168,1,76,0.0,48.0,48.0,1,92,0.0,64.0,64.0
0.093,6,10,1506,5,395,21.0,127.0,127.0,5,1111,19.0,843.0,843.0
0.006,6,10,1547,5,764,1.0,496.0,496.0,5,783,1.0,515.0,515.0
0.01,6,10,1990,5,911,2.0,643.0,643.0,5,1079,2.0,811.0,811.0
0.006,17,2,213,1,69,0.0,41.0,41.0,1,144,0.0,116.0,116.0
240.013,6,9,787,5,488,60003.0,232.0,232.0,4,299,80003.0,83.0,83.0
0.07,6,10,1506,5,395,14.0,127.0,127.0,5,1111,15.0,843.0,843.0
351.993,6,20,2210,6,1308,12003.0,494.0,494.0,14,902,27076.0,83.0,83.0
0.015,6,10,1762,5,911,3.0,643.0,643.0,5,851,3.0,583.0,583.0
0.004,17,2,136,1,60,0.0,32.0,32.0,1,76,0.0,48.0,48.0
0.01,6,10,1989,5,910,2.0,642.0,642.0,5,1079,2.0,811.0,811.0
0.001,17,2,180,1,66,0.0,38.0,38.0,1,114,0.0,86.0,86.0
0.177,17,2,194,1,59,0.0,31.0,31.0,1,135,0.0,107.0,107.0
0.009,6,10,1989,5,910,2.0,642.0,642.0,5,1079,2.0,811.0,811.0
40.06,17,10,676,5,460,10012.0,104.0,64.0,5,216,10014.0,20.0,15.0
0.071,17,4,284,2,120,0.0,32.0,32.0,2,164,68.0,60.0,54.0
0.01,6,10,1989,5,910,2.0,642.0,642.0,5,1079,2.0,811.0,811.0
0.003,17,2,148,1,60,0.0,32.0,32.0,1,88,0.0,60.0,60.0
0.006,17,2,169,1,62,0.0,34.0,34.0,1,107,0.0,79.0,79.0
0.04,17,4,564,2,122,1.0,33.0,33.0,2,442,36.0,291.0,193.0
61.48,58,3,216,2,144,61480.0,24.0,24.0,1,72,0.0,24.0,24.0
0.004,6,10,2006,5,927,1.0,659.0,659.0,5,1079,1.0,811.0,811.0
40.061,17,10,676,5,460,10014.0,104.0,64.0,5,216,10011.0,20.0,15.0
0.006,6,10,1547,5,764,1.0,496.0,496.0,5,783,1.0,515.0,515.0
0.081,6,10,1506,5,395,18.0,127.0,127.0,5,1111,17.0,843.0,843.0
0.012,6,10,1990,5,911,3.0,643.0,643.0,5,1079,3.0,811.0,811.0
0.005,6,13,3690,7,452,0.0,80.0,80.0,6,3238,1.0,1470.0,1459.0
30.893,6,17,6878,9,689,3861.0,209.0,209.0,8,6189,4411.0,1402.0,1153.0
0.116,6,10,1506,5,395,28.0,127.0,127.0,5,1111,24.0,843.0,843.0
0.005,6,10,2006,5,927,1.0,659.0,659.0,5,1079,1.0,811.0,811.0
0.015,6,10,1990,5,911,3.0,643.0,643.0,5,1079,3.0,811.0,811.0
0.005,6,10,2006,5,927,1.0,659.0,659.0,5,1079,1.0,811.0,811.0
0.065,6,10,1506,5,395,14.0,127.0,127.0,5,1111,14.0,843.0,843.0
12.574,17,42,9434,21,5172,620.0,1337.0,218.0,21,4262,620.0,863.0,174.0
0.074,6,10,1506,5,395,17.0,127.0,127.0,5,1111,15.0,843.0,843.0
0.006,6,10,1547,5,764,1.0,496.0,496.0,5,783,1.0,515.0,515.0
0.129,17,2,80,1,32,0.0,4.0,4.0,1,48,0.0,20.0,20.0
40.068,17,10,676,5,460,10015.0,104.0,64.0,5,216,10016.0,20.0,15.0
0.004,6,10,1989,5,927,1.0,659.0,659.0,5,1062,1.0,794.0,794.0
0.003,17,4,284,2,120,0.0,32.0,32.0,2,164,0.0,60.0,54.0
0.051,17,2,136,1,60,0.0,32.0,32.0,1,76,0.0,48.0,48.0
0.006,6,10,1643,5,860,1.0,592.0,592.0,5,783,1.0,515.0,515.0
0.005,6,10,1547,5,764,1.0,496.0,496.0,5,783,1.0,515.0,515.0
15.071,17,14,9191,8,6902,2149.0,1350.0,834.0,6,2289,3008.0,1350.0,353.0
0.014,6,10,1631,5,848,3.0,580.0,580.0,5,783,3.0,515.0,515.0
369.377,6,22,2313,16,867,24625.0,195.0,195.0,6,1446,4647.0,419.0,398.0
0.006,17,2,146,1,65,0.0,37.0,37.0,1,81,0.0,53.0,53.0
0.004,6,10,1989,5,927,1.0,659.0,659.0,5,1062,1.0,794.0,794.0
15.076,17,16,8695,8,6559,2149.0,1350.0,791.0,8,2136,2149.0,1350.0,239.0
0.006,6,10,1689,5,839,1.0,571.0,571.0,5,850,1.0,582.0,582.0
0.006,17,2,179,1,71,0.0,43.0,43.0,1,108,0.0,80.0,80.0
0.094,6,10,1506,5,395,22.0,127.0,127.0,5,1111,20.0,843.0,843.0
0.006,6,10,1547,5,764,1.0,496.0,496.0,5,783,1.0,515.0,515.0
0.012,6,10,1989,5,910,3.0,642.0,642.0,5,1079,3.0,811.0,811.0
0.006,17,2,160,1,72,0.0,44.0,44.0,1,88,0.0,60.0,60.0
0.008,6,12,1926,6,1189,1.0,659.0,434.0,6,737,1.0,417.0,417.0
0.009,6,14,3787,7,497,1.0,125.0,125.0,7,3290,1.0,1448.0,972.0
0.005,6,10,2006,5,927,1.0,659.0,659.0,5,1079,1.0,811.0,811.0
0.006,6,10,1547,5,764,1.0,496.0,496.0,5,783,1.0,515.0,515.0
0.005,6,10,1989,5,927,1.0,659.0,659.0,5,1062,1.0,794.0,794.0
15.075,17,15,8379,8,6231,2149.0,1350.0,750.0,7,2148,2507.0,1350.0,278.0
0.01,6,10,1983,5,910,2.0,642.0,642.0,5,1073,2.0,805.0,805.0
0.008,6,10,1972,5,910,1.0,642.0,642.0,5,1062,1.0,794.0,794.0
0.011,6,10,1762,5,911,2.0,643.0,643.0,5,851,2.0,583.0,583.0
0.008,6,10,1990,5,911,2.0,643.0,643.0,5,1079,1.0,811.0,811.0
0.043,17,2,136,1,60,0.0,32.0,32.0,1,76,0.0,48.0,48.0
0.004,6,10,2000,5,927,1.0,659.0,659.0,5,1073,1.0,805.0,805.0
0.088,6,10,1506,5,395,20.0,127.0,127.0,5,1111,17.0,843.0,843.0
1771.187,6,307,97894,190,86561,9371.0,1402.0,672.0,117,11333,15268.0,452.0,70.0
40.057,17,10,676,5,460,10013.0,104.0,64.0,5,216,10013.0,20.0,15.0
0.017,6,10,1989,5,910,4.0,642.0,642.0,5,1079,4.0,811.0,811.0
0.008,6,10,1972,5,910,2.0,642.0,642.0,5,1062,2.0,794.0,794.0
0.114,6,10,1506,5,395,25.0,127.0,127.0,5,1111,27.0,843.0,843.0
0.005,17,2,230,1,68,0.0,40.0,40.0,1,162,0.0,134.0,134.0
171.451,6,22,7437,11,1305,118.0,530.0,277.0,11,6132,17128.0,2720.0,946.0
0.007,6,10,1547,5,764,1.0,496.0,496.0,5,783,1.0,515.0,515.0
0.012,6,10,1677,5,827,3.0,559.0,559.0,5,850,2.0,582.0,582.0
0.017,6,10,1983,5,910,4.0,642.0,642.0,5,1073,4.0,805.0,805.0
0.039,17,2,152,1,76,0.0,48.0,48.0,1,76,0.0,48.0,48.0
0.005,6,13,3747,7,509,0.0,137.0,137.0,6,3238,0.0,1470.0,1459.0
0.005,6,10,1989,5,927,1.0,659.0,659.0,5,1062,1.0,794.0,794.0
240.101,6,16,4482,9,963,30012.0,238.0,166.0,7,3519,40016.0,1402.0,786.0
0.013,6,10,1972,5,910,3.0,642.0,642.0,5,1062,3.0,794.0,794.0
0.072,17,2,184,1,61,0.0,33.0,33.0,1,123,0.0,95.0,95.0
0.183,6,10,1506,5,395,42.0,127.0,127.0,5,1111,29.0,843.0,843.0
240.202,6,24,4126,11,1756,24019.0,539.0,235.0,13,2370,20016.0,1324.0,242.0
0.01,6,10,1989,5,910,2.0,642.0,642.0,5,1079,2.0,811.0,811.0
0.005,17,2,144,1,64,0.0,36.0,36.0,1,80,0.0,52.0,52.0
0.004,6,10,2006,5,927,1.0,659.0,659.0,5,1079,1.0,811.0,811.0
0.013,6,10,1989,5,910,3.0,642.0,642.0,5,1079,3.0,811.0,811.0
0.025,6,10,1972,5,910,6.0,642.0,642.0,5,1062,6.0,794.0,794.0
0.123,6,10,1506,5,395,30.0,127.0,127.0,5,1111,28.0,843.0,843.0
0.006,6,10,2000,5,927,1.0,659.0,659.0,5,1073,1.0,805.0,805.0
0.013,6,10,1677,5,827,3.0,559.0,559.0,5,850,3.0,582.0,582.0
0.004,6,10,2000,5,927,1.0,659.0,659.0,5,1073,1.0,805.0,805.0
0.006,6,10,1547,5,764,1.0,496.0,496.0,5,783,1.0,515.0,515.0
0.005,6,10,1989,5,927,1.0,659.0,659.0,5,1062,1.0,794.0,794.0
10.901,17,28,4421,14,1993,830.0,268.0,114.0,14,2428,830.0,587.0,145.0
0.065,17,8,3613,4,1874,21.0,1350.0,440.0,4,1739,11.0,1350.0,406.0
0.079,6,10,1506,5,395,17.0,127.0,127.0,5,1111,19.0,843.0,843.0
0.013,6,10,1972,5,910,3.0,642.0,642.0,5,1062,3.0,794.0,794.0
0.098,6,10,1506,5,395,24.0,127.0,127.0,5,1111,23.0,843.0,843.0
0.004,6,15,3794,8,504,0.0,80.0,80.0,7,3290,0.0,1448.0,972.0
285.267,6,30,6573,16,1433,19017.0,517.0,290.0,14,5140,21943.0,2378.0,1104.0
0.002,17,2,180,1,66,0.0,38.0,38.0,1,114,0.0,86.0,86.0
0.001,17,2,180,1,65,0.0,37.0,37.0,1,115,0.0,87.0,87.0
0.006,17,2,302,1,65,0.0,37.0,37.0,1,237,0.0,209.0,209.0
240.094,6,16,4481,9,963,30011.0,238.0,166.0,7,3518,40015.0,1402.0,786.0
0.005,6,10,1643,5,860,1.0,592.0,592.0,5,783,1.0,515.0,515.0
0.011,6,10,1989,5,910,2.0,642.0,642.0,5,1079,2.0,811.0,811.0
0.004,6,10,2006,5,927,1.0,659.0,659.0,5,1079,1.0,811.0,811.0
0.006,6,10,1854,5,889,1.0,621.0,621.0,5,965,1.0,697.0,697.0
0.005,6,10,2007,5,928,1.0,660.0,660.0,5,1079,1.0,811.0,811.0
0.009,6,10,1990,5,911,2.0,643.0,643.0,5,1079,2.0,811.0,811.0
40.057,17,10,676,5,460,10012.0,104.0,64.0,5,216,10013.0,20.0,15.0
66.301,6,22,10140,12,3973,6027.0,1579.0,835.0,10,6167,7348.0,2111.0,939.0
0.095,6,10,1506,5,395,21.0,127.0,127.0,5,1111,21.0,843.0,843.0
0.004,17,4,284,2,120,0.0,32.0,32.0,2,164,1.0,60.0,54.0
0.005,6,10,1547,5,764,1.0,496.0,496.0,5,783,1.0,515.0,515.0
175.684,6,22,7437,11,1305,104.0,530.0,277.0,11,6132,17552.0,2720.0,946.0
0.013,17,2,152,1,76,0.0,48.0,48.0,1,76,0.0,48.0,48.0
0.038,17,2,152,1,76,0.0,48.0,48.0,1,76,0.0,48.0,48.0
0.007,17,2,299,1,65,0.0,37.0,37.0,1,234,0.0,206.0,206.0
0.004,6,10,2006,5,927,1.0,659.0,659.0,5,1079,1.0,811.0,811.0
11.285,17,28,4423,14,1995,855.0,270.0,114.0,14,2428,854.0,587.0,145.0
0.006,6,10,1547,5,764,1.0,496.0,496.0,5,783,1.0,515.0,515.0
15.086,17,15,8355,8,6205,2150.0,1350.0,747.0,7,2150,2509.0,1350.0,279.0
0.021,6,10,1989,5,910,5.0,642.0,642.0,5,1079,5.0,811.0,811.0
0.001,17,2,180,1,66,0.0,38.0,38.0,1,114,0.0,86.0,86.0
0.006,6,10,1547,5,764,1.0,496.0,496.0,5,783,1.0,515.0,515.0
0.016,17,2,198,1,91,0.0,63.0,63.0,1,107,0.0,79.0,79.0
0.005,17,2,169,1,62,0.0,34.0,34.0,1,107,0.0,79.0,79.0
0.001,17,2,166,1,75,0.0,47.0,47.0,1,91,0.0,63.0,63.0
0.015,6,13,3735,7,497,2.0,125.0,125.0,6,3238,3.0,1470.0,1459.0
0.008,6,10,1972,5,910,1.0,642.0,642.0,5,1062,2.0,794.0,794.0
0.005,6,10,1779,5,928,1.0,660.0,660.0,5,851,1.0,583.0,583.0
0.114,6,10,1506,5,395,25.0,127.0,127.0,5,1111,25.0,843.0,843.0
0.004,17,2,144,1,64,0.0,36.0,36.0,1,80,0.0,52.0,52.0
0.077,6,10,1506,5,395,16.0,127.0,127.0,5,1111,17.0,843.0,843.0
0.039,17,4,284,2,120,0.0,32.0,32.0,2,164,35.0,60.0,54.0
0.015,6,10,1972,5,910,3.0,642.0,642.0,5,1062,3.0,794.0,794.0
332.457,17,20,1124,10,716,36925.0,48.0,43.0,10,408,36925.0,20.0,12.0
0.005,6,10,2000,5,927,1.0,659.0,659.0,5,1073,1.0,805.0,805.0
0.005,6,10,2007,5,928,1.0,660.0,660.0,5,1079,1.0,811.0,811.0
0.009,6,10,1972,5,910,2.0,642.0,642.0,5,1062,2.0,794.0,794.0
0.038,17,4,420,2,122,0.0,33.0,33.0,2,298,34.0,145.0,121.0
0.206,6,16,2778,8,1396,29.0,533.0,324.0,8,1382,18.0,529.0,239.0
0.006,6,10,1547,5,764,1.0,496.0,496.0,5,783,1.0,515.0,515.0
0.005,6,10,2006,5,927,1.0,659.0,659.0,5,1079,1.0,811.0,811.0
0.078,6,10,1506,5,395,18.0,127.0,127.0,5,1111,15.0,843.0,843.0
0.011,6,10,1989,5,910,2.0,642.0,642.0,5,1079,2.0,811.0,811.0
0.084,6,10,1506,5,395,17.0,127.0,127.0,5,1111,19.0,843.0,843.0
0.009,6,10,1990,5,911,2.0,643.0,643.0,5,1079,2.0,811.0,811.0
0.01,6,10,1989,5,910,2.0,642.0,642.0,5,1079,2.0,811.0,811.0
0.013,6,10,1631,5,848,3.0,580.0,580.0,5,783,3.0,515.0,515.0
0.112,6,10,1506,5,395,22.0,127.0,127.0,5,1111,26.0,843.0,843.0
0.018,6,10,1989,5,910,4.0,642.0,642.0,5,1079,4.0,811.0,811.0
61.169,6,25,17957,14,10062,4705.0,2804.0,1556.0,11,7895,6104.0,2318.0,1219.0
0.005,6,10,1643,5,860,1.0,592.0,592.0,5,783,1.0,515.0,515.0
15.069,17,15,9239,8,6902,2148.0,1350.0,834.0,7,2337,2506.0,1350.0,305.0
0.008,6,12,1926,6,1189,1.0,659.0,434.0,6,737,1.0,417.0,417.0
0.011,6,10,1983,5,910,2.0,642.0,642.0,5,1073,2.0,805.0,805.0
0.008,6,10,1990,5,911,2.0,643.0,643.0,5,1079,1.0,811.0,811.0
300.314,6,16,2170,9,684,37519.0,146.0,146.0,7,1486,50025.0,419.0,398.0
0.004,17,4,284,2,120,0.0,32.0,32.0,2,164,0.0,60.0,54.0
0.005,6,10,2007,5,928,1.0,660.0,660.0,5,1079,1.0,811.0,811.0
0.012,6,10,1972,5,910,3.0,642.0,642.0,5,1062,2.0,794.0,794.0
0.012,6,10,1990,5,911,3.0,643.0,643.0,5,1079,2.0,811.0,811.0
0.006,6,10,2000,5,927,1.0,659.0,659.0,5,1073,1.0,805.0,805.0
0.005,6,10,1989,5,927,1.0,659.0,659.0,5,1062,1.0,794.0,794.0
0.041,17,4,284,2,120,1.0,32.0,32.0,2,164,37.0,60.0,54.0
177.314,17,78,11037,39,2601,4666.0,44.0,38.0,39,8436,4665.0,239.0,188.0
1770.486,6,83,4368,42,2210,43181.0,26.0,26.0,41,2158,44261.0,26.0,26.0
0.101,6,10,1506,5,395,23.0,127.0,127.0,5,1111,21.0,843.0,843.0
0.012,6,10,1990,5,911,2.0,643.0,643.0,5,1079,3.0,811.0,811.0
0.006,6,13,3690,7,452,1.0,80.0,80.0,6,3238,1.0,1470.0,1459.0
0.009,6,10,1972,5,910,2.0,642.0,642.0,5,1062,2.0,794.0,794.0
0.066,6,10,1506,5,395,15.0,127.0,127.0,5,1111,15.0,843.0,843.0
0.004,6,10,2000,5,927,1.0,659.0,659.0,5,1073,1.0,805.0,805.0
0.008,6,10,1989,5,910,2.0,642.0,642.0,5,1079,2.0,811.0,811.0
0.005,6,10,1779,5,928,1.0,660.0,660.0,5,851,1.0,583.0,583.0
0.007,6,10,1689,5,839,1.0,571.0,571.0,5,850,1.0,582.0,582.0
0.008,6,10,1989,5,910,2.0,642.0,642.0,5,1079,2.0,811.0,811.0
10.795,17,28,4421,14,1993,821.0,268.0,114.0,14,2428,821.0,587.0,145.0
0.005,6,10,2006,5,927,1.0,659.0,659.0,5,1079,1.0,811.0,811.0
0.007,6,10,1547,5,764,1.0,496.0,496.0,5,783,1.0,515.0,515.0
11.042,17,28,4418,14,1994,839.0,269.0,114.0,14,2424,840.0,587.0,145.0
15.312,17,39,21466,22,18414,727.0,1350.0,809.0,17,3052,955.0,1350.0,151.0
0.005,6,10,1854,5,889,1.0,621.0,621.0,5,965,1.0,697.0,697.0
0.01,6,10,1631,5,848,2.0,580.0,580.0,5,783,2.0,515.0,515.0
0.089,6,10,1506,5,395,19.0,127.0,127.0,5,1111,19.0,843.0,843.0
0.009,6,10,1762,5,911,2.0,643.0,643.0,5,851,2.0,583.0,583.0
0.002,17,2,148,1,60,0.0,32.0,32.0,1,88,0.0,60.0,60.0
0.005,6,10,2007,5,928,1.0,660.0,660.0,5,1079,1.0,811.0,811.0
0.011,6,10,1989,5,910,2.0,642.0,642.0,5,1079,2.0,811.0,811.0
0.006,17,2,170,1,65,0.0,37.0,37.0,1,105,0.0,77.0,77.0
0.008,6,10,1762,5,911,2.0,643.0,643.0,5,851,2.0,583.0,583.0
0.077,6,10,1506,5,395,16.0,127.0,127.0,5,1111,17.0,843.0,843.0
0.018,6,10,1972,5,910,4.0,642.0,642.0,5,1062,4.0,794.0,794.0
0.015,6,10,1972,5,910,3.0,642.0,642.0,5,1062,3.0,794.0,794.0
0.005,6,10,2006,5,927,1.0,659.0,659.0,5,1079,1.0,811.0,811.0
0.01,6,10,1631,5,848,2.0,580.0,580.0,5,783,2.0,515.0,515.0
0.095,6,10,1506,5,395,21.0,127.0,127.0,5,1111,20.0,843.0,843.0
0.002,17,2,148,1,60,0.0,32.0,32.0,1,88,0.0,60.0,60.0
0.006,6,10,2007,5,928,1.0,660.0,660.0,5,1079,1.0,811.0,811.0
0.031,17,2,152,1,68,0.0,40.0,40.0,1,84,0.0,56.0,56.0
0.001,17,2,166,1,75,0.0,47.0,47.0,1,91,0.0,63.0,63.0
0.004,6,10,1989,5,927,1.0,659.0,659.0,5,1062,1.0,794.0,794.0
0.011,6,10,1989,5,910,2.0,642.0,642.0,5,1079,2.0,811.0,811.0
0.009,6,12,1926,6,1189,1.0,659.0,434.0,6,737,1.0,417.0,417.0
0.022,6,10,1990,5,911,5.0,643.0,643.0,5,1079,5.0,811.0,811.0
0.091,6,10,1506,5,395,20.0,127.0,127.0,5,1111,20.0,843.0,843.0
11.111,17,28,4421,14,1993,842.0,268.0,114.0,14,2428,841.0,587.0,145.0
361.762,6,21,1792,16,1030,24117.0,190.0,190.0,5,762,60011.0,461.0,247.0
0.009,6,10,1972,5,910,2.0,642.0,642.0,5,1062,2.0,794.0,794.0
0.087,6,10,1506,5,395,18.0,127.0,127.0,5,1111,17.0,843.0,843.0
0.012,6,10,1990,5,911,3.0,643.0,643.0,5,1079,3.0,811.0,811.0
0.001,17,2,180,1,66,0.0,38.0,38.0,1,114,0.0,86.0,86.0
0.001,17,2,180,1,66,0.0,38.0,38.0,1,114,0.0,86.0,86.0
0.013,6,10,1989,5,910,3.0,642.0,642.0,5,1079,3.0,811.0,811.0
0.054,17,2,152,1,76,0.0,48.0,48.0,1,76,0.0,48.0,48.0
412.568,6,23,2943,8,1906,17146.0,494.0,494.0,15,1037,29468.0,83.0,83.0
15.087,17,16,8311,8,6038,2151.0,1350.0,726.0,8,2273,2151.0,1350.0,256.0
0.072,6,10,1506,5,395,16.0,127.0,127.0,5,1111,15.0,843.0,843.0
40.069,17,10,676,5,460,10014.0,104.0,64.0,5,216,10016.0,20.0,15.0
0.004,6,10,2006,5,927,1.0,659.0,659.0,5,1079,1.0,811.0,811.0
0.006,17,2,230,1,68,0.0,40.0,40.0,1,162,0.0,134.0,134.0
0.009,6,10,1989,5,910,2.0,642.0,642.0,5,1079,2.0,811.0,811.0
40.077,17,10,676,5,460,10017.0,104.0,64.0,5,216,10018.0,20.0,15.0
125.976,6,13,2150,7,1716,20957.0,1424.0,1424.0,6,434,25148.0,182.0,182.0
0.005,17,2,164,1,74,0.0,46.0,46.0,1,90,0.0,62.0,62.0
0.038,17,2,152,1,76,0.0,48.0,48.0,1,76,0.0,48.0,48.0
0.074,6,10,1506,5,395,15.0,127.0,127.0,5,1111,15.0,843.0,843.0
300.317,6,16,2170,9,684,37519.0,146.0,146.0,7,1486,50025.0,419.0,398.0
0.004,6,10,2007,5,928,1.0,660.0,660.0,5,1079,1.0,811.0,811.0
0.1,6,10,1506,5,395,21.0,127.0,127.0,5,1111,23.0,843.0,843.0
0.008,6,10,1547,5,764,1.0,496.0,496.0,5,783,1.0,515.0,515.0
0.005,6,10,1989,5,927,1.0,659.0,659.0,5,1062,1.0,794.0,794.0
308.299,17,20,1124,10,716,34241.0,48.0,43.0,10,408,34241.0,20.0,12.0
0.005,6,10,2000,5,927,1.0,659.0,659.0,5,1073,1.0,805.0,805.0
0.006,17,2,170,1,65,0.0,37.0,37.0,1,105,0.0,77.0,77.0
0.006,6,10,1547,5,764,1.0,496.0,496.0,5,783,1.0,515.0,515.0
176.132,17,74,10722,37,2466,4892.0,44.0,38.0,37,8256,4892.0,261.0,195.0
0.009,6,12,1926,6,1189,1.0,659.0,434.0,6,737,1.0,417.0,417.0
0.019,6,10,1983,5,910,4.0,642.0,642.0,5,1073,4.0,805.0,805.0
0.118,6,10,1506,5,395,28.0,127.0,127.0,5,1111,27.0,843.0,843.0
10.79,17,28,4420,14,1993,821.0,268.0,114.0,14,2427,821.0,586.0,145.0
0.129,17,4,352,2,130,1.0,37.0,37.0,2,222,125.0,89.0,83.0
0.006,17,2,230,1,68,0.0,40.0,40.0,1,162,0.0,134.0,134.0
0.015,6,10,1989,5,910,3.0,642.0,642.0,5,1079,3.0,811.0,811.0
0.014,6,10,1972,5,910,3.0,642.0,642.0,5,1062,3.0,794.0,794.0
40.078,17,10,676,5,460,10018.0,104.0,64.0,5,216,10018.0,20.0,15.0
0.017,6,10,1983,5,910,4.0,642.0,642.0,5,1073,4.0,805.0,805.0
0.04,17,2,182,1,65,0.0,37.0,37.0,1,117,0.0,89.0,89.0
0.004,17,2,148,1,60,0.0,32.0,32.0,1,88,0.0,60.0,60.0
0.002,17,2,180,1,66,0.0,38.0,38.0,1,114,0.0,86.0,86.0
0.01,6,10,1779,5,928,2.0,660.0,660.0,5,851,2.0,583.0,583.0
0.038,17,2,148,1,60,0.0,32.0,32.0,1,88,0.0,60.0,60.0
0.017,6,10,1972,5,910,4.0,642.0,642.0,5,1062,4.0,794.0,794.0
40.066,17,10,676,5,460,10013.0,104.0,64.0,5,216,10013.0,20.0,15.0
0.073,17,4,352,2,130,1.0,37.0,37.0,2,222,69.0,89.0,83.0
0.096,6,10,1506,5,395,20.0,127.0,127.0,5,1111,22.0,843.0,843.0
0.003,17,2,234,1,61,0.0,33.0,33.0,1,173,0.0,145.0,145.0
0.072,6,46,14149,26,2669,2.0,517.0,146.0,20,11480,3.0,1402.0,745.0
0.005,6,10,2006,5,927,1.0,659.0,659.0,5,1079,1.0,811.0,811.0
0.006,6,10,1547,5,764,1.0,496.0,496.0,5,783,1.0,515.0,515.0
0.02,6,10,1762,5,911,4.0,643.0,643.0,5,851,4.0,583.0,583.0
0.086,6,10,1506,5,395,19.0,127.0,127.0,5,1111,16.0,843.0,843.0
0.006,6,10,1547,5,764,1.0,496.0,496.0,5,783,1.0,515.0,515.0
240.691,6,39,9801,20,2228,12666.0,748.0,236.0,19,7573,13369.0,1402.0,549.0
0.106,6,10,1506,5,395,24.0,127.0,127.0,5,1111,22.0,843.0,843.0
15.073,17,15,9238,8,6902,2149.0,1350.0,834.0,7,2336,2507.0,1350.0,305.0
0.012,6,10,1990,5,911,3.0,643.0,643.0,5,1079,3.0,811.0,811.0
0.086,6,10,1506,5,395,18.0,127.0,127.0,5,1111,17.0,843.0,843.0
0.005,6,10,1854,5,889,1.0,621.0,621.0,5,965,1.0,697.0,697.0
1770.622,17,120,11460,60,5460,30010.0,63.0,63.0,60,6000,30010.0,72.0,72.0
0.006,17,2,214,1,75,0.0,47.0,47.0,1,139,0.0,111.0,111.0
0.011,6,10,1989,5,910,2.0,642.0,642.0,5,1079,2.0,811.0,811.0
0.009,6,10,1989,5,910,2.0,642.0,642.0,5,1079,2.0,811.0,811.0
0.004,6,10,1989,5,927,1.0,659.0,659.0,5,1062,1.0,794.0,794.0
0.006,6,10,1547,5,764,1.0,496.0,496.0,5,783,1.0,515.0,515.0
0.004,6,10,2006,5,927,1.0,659.0,659.0,5,1079,1.0,811.0,811.0
0.004,6,10,2007,5,928,1.0,660.0,660.0,5,1079,1.0,811.0,811.0
15.107,17,15,8256,8,6020,2150.0,1350.0,724.0,7,2236,2512.0,1350.0,291.0
0.001,17,2,180,1,66,0.0,38.0,38.0,1,114,0.0,86.0,86.0
0.015,17,2,148,1,60,0.0,32.0,32.0,1,88,0.0,60.0,60.0
0.001,17,2,180,1,66,0.0,38.0,38.0,1,114,0.0,86.0,86.0
0.005,6,10,1989,5,927,1.0,659.0,659.0,5,1062,1.0,794.0,794.0
300.223,6,35,12611,18,6462,17660.0,1790.0,786.0,17,6149,18763.0,1656.0,752.0
0.074,6,10,1506,5,395,16.0,127.0,127.0,5,1111,15.0,843.0,843.0
0.073,6,10,1506,5,395,16.0,127.0,127.0,5,1111,15.0,843.0,843.0
0.095,6,10,1506,5,395,21.0,127.0,127.0,5,1111,19.0,843.0,843.0
0.011,6,10,1631,5,848,2.0,580.0,580.0,5,783,2.0,515.0,515.0
0.005,6,10,1547,5,764,1.0,496.0,496.0,5,783,1.0,515.0,515.0
0.004,17,2,136,1,60,0.0,32.0,32.0,1,76,0.0,48.0,48.0
0.105,6,10,1506,5,395,24.0,127.0,127.0,5,1111,23.0,843.0,843.0
0.005,6,10,2007,5,928,1.0,660.0,660.0,5,1079,1.0,811.0,811.0
335.433,17,20,1124,10,716,37256.0,48.0,43.0,10,408,37256.0,20.0,12.0
0.128,6,10,1506,5,395,30.0,127.0,127.0,5,1111,31.0,843.0,843.0
0.012,6,10,1989,5,910,3.0,642.0,642.0,5,1079,3.0,811.0,811.0
0.07,6,10,1506,5,395,16.0,127.0,127.0,5,1111,14.0,843.0,843.0
0.001,17,2,180,1,66,0.0,38.0,38.0,1,114,0.0,86.0,86.0
0.048,17,2,148,1,60,0.0,32.0,32.0,1,88,0.0,60.0,60.0
0.003,17,4,284,2,120,0.0,32.0,32.0,2,164,0.0,60.0,54.0
0.094,6,10,1506,5,395,20.0,127.0,127.0,5,1111,20.0,843.0,843.0
0.01,6,10,1631,5,848,2.0,580.0,580.0,5,783,2.0,515.0,515.0
0.009,6,10,1762,5,911,2.0,643.0,643.0,5,851,2.0,583.0,583.0
0.103,6,10,1506,5,395,18.0,127.0,127.0,5,1111,23.0,843.0,843.0
0.01,6,10,1631,5,848,2.0,580.0,580.0,5,783,2.0,515.0,515.0
0.005,6,10,2000,5,927,1.0,659.0,659.0,5,1073,1.0,805.0,805.0
0.005,6,10,1989,5,927,1.0,659.0,659.0,5,1062,1.0,794.0,794.0
0.063,6,10,1506,5,395,15.0,127.0,127.0,5,1111,14.0,843.0,843.0
0.067,6,10,1506,5,395,16.0,127.0,127.0,5,1111,14.0,843.0,843.0
0.004,6,10,2000,5,927,1.0,659.0,659.0,5,1073,1.0,805.0,805.0
0.012,6,10,1762,5,911,2.0,643.0,643.0,5,851,2.0,583.0,583.0
0.008,17,2,136,1,60,0.0,32.0,32.0,1,76,0.0,48.0,48.0
0.019,6,10,1989,5,910,4.0,642.0,642.0,5,1079,4.0,811.0,811.0
0.072,6,10,1506,5,395,16.0,127.0,127.0,5,1111,13.0,843.0,843.0
0.019,6,10,1972,5,910,4.0,642.0,642.0,5,1062,4.0,794.0,794.0
0.003,17,4,284,2,120,0.0,32.0,32.0,2,164,0.0,60.0,54.0
0.061,6,10,1506,5,395,12.0,127.0,127.0,5,1111,14.0,843.0,843.0
0.016,6,10,1989,5,910,4.0,642.0,642.0,5,1079,3.0,811.0,811.0
0.007,17,2,179,1,71,0.0,43.0,43.0,1,108,0.0,80.0,80.0
0.019,6,10,1631,5,848,4.0,580.0,580.0,5,783,4.0,515.0,515.0
0.014,6,10,1990,5,911,3.0,643.0,643.0,5,1079,3.0,811.0,811.0
0.025,6,12,4064,7,675,4.0,299.0,299.0,5,3389,4.0,1719.0,1560.0
0.006,6,10,1643,5,860,1.0,592.0,592.0,5,783,1.0,515.0,515.0
0.009,17,2,144,1,64,0.0,36.0,36.0,1,80,0.0,52.0,52.0
1729.213,6,60,4400,40,2740,44338.0,33.0,33.0,20,1660,91002.0,31.0,31.0
281.399,6,24,6115,11,1226,28139.0,267.0,156.0,13,4889,23449.0,1400.0,873.0
308.437,17,20,1124,10,716,34256.0,48.0,43.0,10,408,34256.0,20.0,12.0
0.075,6,10,1506,5,395,16.0,127.0,127.0,5,1111,16.0,843.0,843.0
372.342,6,22,2313,16,867,24822.0,195.0,195.0,6,1446,4638.0,419.0,398.0
0.006,17,2,179,1,71,0.0,43.0,43.0,1,108,0.0,80.0,80.0
0.006,17,2,136,1,60,0.0,32.0,32.0,1,76,0.0,48.0,48.0
0.004,17,2,136,1,60,0.0,32.0,32.0,1,76,0.0,48.0,48.0
0.005,6,10,2007,5,928,1.0,660.0,660.0,5,1079,1.0,811.0,811.0
0.016,6,10,1990,5,911,4.0,643.0,643.0,5,1079,4.0,811.0,811.0
0.005,6,10,1774,5,923,1.0,655.0,655.0,5,851,1.0,583.0,583.0
0.006,6,10,2000,5,927,1.0,659.0,659.0,5,1073,1.0,805.0,805.0
0.004,17,2,148,1,60,0.0,32.0,32.0,1,88,0.0,60.0,60.0
0.114,6,10,1506,5,395,24.0,127.0,127.0,5,1111,22.0,843.0,843.0
0.003,17,2,136,1,60,0.0,32.0,32.0,1,76,0.0,48.0,48.0
0.006,6,10,1547,5,764,1.0,496.0,496.0,5,783,1.0,515.0,515.0
49.773,6,46,21514,23,15796,410.0,2720.0,1649.0,23,5718,2255.0,2667.0,435.0
0.025,17,2,194,1,59,0.0,31.0,31.0,1,135,0.0,107.0,107.0
0.124,6,10,1506,5,395,28.0,127.0,127.0,5,1111,28.0,843.0,843.0
0.084,6,10,1506,5,395,18.0,127.0,127.0,5,1111,17.0,843.0,843.0
9.037,17,6,376,5,280,2259.0,28.0,28.0,1,96,0.0,68.0,68.0
0.011,6,10,1989,5,910,2.0,642.0,642.0,5,1079,2.0,811.0,811.0
0.014,6,10,1677,5,827,3.0,559.0,559.0,5,850,3.0,582.0,582.0
0.007,6,10,1643,5,860,1.0,592.0,592.0,5,783,1.0,515.0,515.0
10.757,17,28,4417,14,1994,819.0,269.0,114.0,14,2423,819.0,586.0,145.0
0.008,6,10,1989,5,910,2.0,642.0,642.0,5,1079,1.0,811.0,811.0
0.003,17,2,148,1,60,0.0,32.0,32.0,1,88,0.0,60.0,60.0
0.004,17,4,284,2,120,0.0,32.0,32.0,2,164,0.0,60.0,54.0
0.004,17,2,136,1,60,0.0,32.0,32.0,1,76,0.0,48.0,48.0
0.005,17,2,179,1,71,0.0,43.0,43.0,1,108,0.0,80.0,80.0
0.006,6,10,1547,5,764,1.0,496.0,496.0,5,783,1.0,515.0,515.0
0.008,6,10,1989,5,910,2.0,642.0,642.0,5,1079,1.0,811.0,811.0
240.714,6,39,9798,20,2227,12667.0,747.0,235.0,19,7571,13371.0,1402.0,548.0
354.006,6,19,1691,15,978,25286.0,190.0,190.0,4,713,80002.0,497.0,497.0
0.004,17,2,136,1,60,0.0,32.0,32.0,1,76,0.0,48.0,48.0
0.006,6,10,1689,5,839,1.0,571.0,571.0,5,850,1.0,582.0,582.0
0.006,6,10,1989,5,927,1.0,659.0,659.0,5,1062,1.0,794.0,794.0
0.093,6,10,1506,5,395,21.0,127.0,127.0,5,1111,20.0,843.0,843.0
0.069,17,8,3613,4,1874,23.0,1350.0,440.0,4,1739,11.0,1350.0,406.0
0.003,17,4,284,2,120,0.0,32.0,32.0,2,164,0.0,60.0,54.0
0.005,6,10,2000,5,927,1.0,659.0,659.0,5,1073,1.0,805.0,805.0
0.005,6,10,1643,5,860,1.0,592.0,592.0,5,783,1.0,515.0,515.0
0.053,6,10,1506,5,395,11.0,127.0,127.0,5,1111,12.0,843.0,843.0
1.044,6,31,12749,17,3312,65.0,1360.0,517.0,14,9437,67.0,2720.0,985.0
0.019,6,10,1631,5,848,4.0,580.0,580.0,5,783,4.0,515.0,515.0
0.004,6,10,1989,5,927,1.0,659.0,659.0,5,1062,1.0,794.0,794.0
0.004,6,13,3690,7,452,0.0,80.0,80.0,6,3238,0.0,1470.0,1459.0
0.01,6,10,1983,5,910,2.0,642.0,642.0,5,1073,2.0,805.0,805.0
240.479,6,43,8771,22,5738,11451.0,2883.0,573.0,21,3033,12023.0,580.0,241.0
0.016,6,10,1677,5,827,3.0,559.0,559.0,5,850,3.0,582.0,582.0
0.015,6,10,1631,5,848,3.0,580.0,580.0,5,783,3.0,515.0,515.0
0.07,17,8,3613,4,1874,23.0,1350.0,440.0,4,1739,12.0,1350.0,406.0
0.003,17,2,136,1,60,0.0,32.0,32.0,1,76,0.0,48.0,48.0
10.786,17,28,4423,14,1994,821.0,269.0,114.0,14,2429,821.0,588.0,145.0
0.006,6,10,1989,5,927,1.0,659.0,659.0,5,1062,1.0,794.0,794.0
0.071,17,8,3613,4,1874,23.0,1350.0,440.0,4,1739,11.0,1350.0,406.0
0.123,17,4,284,2,120,0.0,32.0,32.0,2,164,52.0,60.0,54.0
0.101,6,10,1506,5,395,18.0,127.0,127.0,5,1111,24.0,843.0,843.0
0.014,6,10,1989,5,910,3.0,642.0,642.0,5,1079,3.0,811.0,811.0
0.005,6,10,1774,5,923,1.0,655.0,655.0,5,851,1.0,583.0,583.0
0.005,6,13,3747,7,509,0.0,137.0,137.0,6,3238,0.0,1470.0,1459.0
0.006,6,10,1547,5,764,1.0,496.0,496.0,5,783,1.0,515.0,515.0
40.058,17,10,676,5,460,10012.0,104.0,64.0,5,216,10012.0,20.0,15.0
0.007,6,10,1989,5,910,1.0,642.0,642.0,5,1079,1.0,811.0,811.0
40.06,17,10,676,5,460,10011.0,104.0,64.0,5,216,10014.0,20.0,15.0
0.01,6,12,1926,6,1189,2.0,659.0,434.0,6,737,2.0,417.0,417.0
40.054,17,10,676,5,460,10010.0,104.0,64.0,5,216,10012.0,20.0,15.0
40.085,17,10,676,5,460,10017.0,104.0,64.0,5,216,10020.0,20.0,15.0
0.077,6,10,1506,5,395,14.0,127.0,127.0,5,1111,16.0,843.0,843.0
0.011,6,10,1677,5,827,2.0,559.0,559.0,5,850,2.0,582.0,582.0
40.06,17,10,676,5,460,10014.0,104.0,64.0,5,216,10014.0,20.0,15.0
0.006,6,10,2006,5,927,1.0,659.0,659.0,5,1079,1.0,811.0,811.0
292.051,6,23,6947,6,5762,16.0,3165.0,1814.0,17,1185,18253.0,293.0,293.0
40.063,17,10,676,5,460,10014.0,104.0,64.0,5,216,10015.0,20.0,15.0
0.01,6,10,1983,5,910,2.0,642.0,642.0,5,1073,2.0,805.0,805.0
0.138,6,10,1506,5,395,32.0,127.0,127.0,5,1111,31.0,843.0,843.0
1799.746,6,276,25830,139,9022,13041.0,748.0,295.0,137,16808,13233.0,1625.0,73.0
308.589,17,20,1124,10,716,34273.0,48.0,43.0,10,408,34273.0,20.0,12.0
0.111,6,10,1506,5,395,22.0,127.0,127.0,5,1111,27.0,843.0,843.0
0.005,6,10,2007,5,928,1.0,660.0,660.0,5,1079,1.0,811.0,811.0
0.115,6,10,1506,5,395,21.0,127.0,127.0,5,1111,26.0,843.0,843.0
0.012,6,10,1983,5,910,3.0,642.0,642.0,5,1073,3.0,805.0,805.0
0.008,6,10,1972,5,910,2.0,642.0,642.0,5,1062,2.0,794.0,794.0
0.014,6,10,1989,5,910,3.0,642.0,642.0,5,1079,3.0,811.0,811.0
0.005,17,2,148,1,60,0.0,32.0,32.0,1,88,0.0,60.0,60.0
0.011,6,10,1677,5,827,2.0,559.0,559.0,5,850,2.0,582.0,582.0
10.78,17,28,4423,14,1994,819.0,269.0,114.0,14,2429,820.0,588.0,145.0
0.006,6,10,2007,5,928,1.0,660.0,660.0,5,1079,1.0,811.0,811.0
0.006,6,10,1643,5,860,1.0,592.0,592.0,5,783,1.0,515.0,515.0
0.005,17,2,225,1,65,0.0,37.0,37.0,1,160,0.0,132.0,132.0
0.006,6,10,1547,5,764,1.0,496.0,496.0,5,783,1.0,515.0,515.0
0.005,6,10,1989,5,927,1.0,659.0,659.0,5,1062,1.0,794.0,794.0
0.005,17,2,166,1,75,0.0,47.0,47.0,1,91,0.0,63.0,63.0
0.005,6,10,2006,5,927,1.0,659.0,659.0,5,1079,1.0,811.0,811.0
40.07,17,10,676,5,460,10016.0,104.0,64.0,5,216,10016.0,20.0,15.0
0.088,6,10,1506,5,395,19.0,127.0,127.0,5,1111,18.0,843.0,843.0
0.01,6,10,1762,5,911,2.0,643.0,643.0,5,851,2.0,583.0,583.0
240.273,6,44,8823,22,5738,11441.0,1368.0,458.0,22,3085,11441.0,580.0,241.0
0.01,6,10,1972,5,910,2.0,642.0,642.0,5,1062,2.0,794.0,794.0
0.005,6,10,2007,5,928,1.0,660.0,660.0,5,1079,1.0,811.0,811.0
40.076,17,10,676,5,460,10018.0,104.0,64.0,5,216,10018.0,20.0,15.0
0.015,6,10,1972,5,910,3.0,642.0,642.0,5,1062,3.0,794.0,794.0
0.005,17,2,230,1,68,0.0,40.0,40.0,1,162,0.0,134.0,134.0
0.004,17,2,136,1,60,0.0,32.0,32.0,1,76,0.0,48.0,48.0
0.015,6,10,1989,5,910,3.0,642.0,642.0,5,1079,3.0,811.0,811.0
0.013,6,14,3787,7,497,2.0,125.0,125.0,7,3290,2.0,1448.0,972.0
0.038,17,2,412,1,61,0.0,33.0,33.0,1,351,0.0,323.0,323.0
0.005,17,2,166,1,75,0.0,47.0,47.0,1,91,0.0,63.0,63.0
0.007,6,10,1547,5,764,1.0,496.0,496.0,5,783,1.0,515.0,515.0
0.008,6,12,1926,6,1189,1.0,659.0,434.0,6,737,1.0,417.0,417.0
0.14,6,10,1506,5,395,32.0,127.0,127.0,5,1111,24.0,843.0,843.0
0.042,17,2,182,1,65,0.0,37.0,37.0,1,117,0.0,89.0,89.0
0.012,6,10,1631,5,848,3.0,580.0,580.0,5,783,2.0,515.0,515.0
0.005,6,10,1854,5,889,1.0,621.0,621.0,5,965,1.0,697.0,697.0
0.005,17,2,140,1,62,0.0,34.0,34.0,1,78,0.0,50.0,50.0
0.011,6,10,1631,5,848,2.0,580.0,580.0,5,783,2.0,515.0,515.0
10.937,17,28,4420,14,1995,832.0,270.0,114.0,14,2425,832.0,588.0,145.0
0.012,6,10,1983,5,910,3.0,642.0,642.0,5,1073,2.0,805.0,805.0
0.012,6,10,1762,5,911,3.0,643.0,643.0,5,851,3.0,583.0,583.0
0.011,6,10,1779,5,928,2.0,660.0,660.0,5,851,2.0,583.0,583.0
900.644,6,58,24008,31,5828,30021.0,676.0,467.0,27,18180,32332.0,1937.0,986.0
0.016,6,13,3735,7,497,2.0,125.0,125.0,6,3238,3.0,1470.0,1459.0
0.039,17,2,148,1,60,0.0,32.0,32.0,1,88,0.0,60.0,60.0
0.005,6,10,2006,5,927,1.0,659.0,659.0,5,1079,1.0,811.0,811.0
0.079,6,10,1506,5,395,17.0,127.0,127.0,5,1111,18.0,843.0,843.0
0.005,6,10,2006,5,927,1.0,659.0,659.0,5,1079,1.0,811.0,811.0
240.108,6,33,9537,16,7014,16007.0,2076.0,686.0,17,2523,15006.0,580.0,181.0
0.008,6,10,1677,5,827,1.0,559.0,559.0,5,850,2.0,582.0,582.0
0.006,6,10,1547,5,764,1.0,496.0,496.0,5,783,1.0,515.0,515.0
0.04,17,2,136,1,60,0.0,32.0,32.0,1,76,0.0,48.0,48.0
0.001,17,2,166,1,75,0.0,47.0,47.0,1,91,0.0,63.0,63.0
0.039,17,4,548,2,122,0.0,33.0,33.0,2,426,1.0,275.0,185.0
1778.379,17,144,45504,72,22752,25047.0,288.0,288.0,72,22752,25047.0,288.0,288.0
0.081,6,10,1506,5,395,17.0,127.0,127.0,5,1111,19.0,843.0,843.0
1770.325,6,82,4316,41,2158,44257.0,26.0,26.0,41,2158,44257.0,26.0,26.0
382.659,6,24,2405,17,919,23916.0,195.0,195.0,7,1486,3901.0,419.0,398.0
0.085,6,10,1506,5,395,18.0,127.0,127.0,5,1111,19.0,843.0,843.0
15.115,17,15,8250,8,6075,2153.0,1350.0,731.0,7,2175,2511.0,1350.0,282.0
0.079,6,10,1506,5,395,17.0,127.0,127.0,5,1111,18.0,843.0,843.0
0.001,17,2,136,1,60,0.0,32.0,32.0,1,76,0.0,48.0,48.0
10.908,17,28,4419,14,1995,831.0,270.0,114.0,14,2424,831.0,587.0,145.0
0.048,17,2,170,1,65,0.0,37.0,37.0,1,105,0.0,77.0,77.0
15.07,17,15,9239,8,6902,2148.0,1350.0,834.0,7,2337,2506.0,1350.0,305.0
0.005,6,10,2006,5,927,1.0,659.0,659.0,5,1079,1.0,811.0,811.0
0.013,6,10,1762,5,911,3.0,643.0,643.0,5,851,3.0,583.0,583.0
1799.966,6,237,30443,89,19173,20454.0,2720.0,210.0,148,11270,12243.0,1062.0,75.0
0.135,17,2,80,1,32,0.0,4.0,4.0,1,48,0.0,20.0,20.0
0.091,6,10,1506,5,395,19.0,127.0,127.0,5,1111,20.0,843.0,843.0
0.005,17,2,180,1,66,0.0,38.0,38.0,1,114,0.0,86.0,86.0
0.009,6,10,1990,5,911,2.0,643.0,643.0,5,1079,2.0,811.0,811.0
0.011,6,10,1631,5,848,2.0,580.0,580.0,5,783,2.0,515.0,515.0
0.004,17,2,148,1,60,0.0,32.0,32.0,1,88,0.0,60.0,60.0
0.005,6,10,2006,5,927,1.0,659.0,659.0,5,1079,1.0,811.0,811.0
0.091,6,10,1506,5,395,19.0,127.0,127.0,5,1111,20.0,843.0,843.0
0.009,6,12,1926,6,1189,1.0,659.0,434.0,6,737,1.0,417.0,417.0
0.114,6,10,1506,5,395,26.0,127.0,127.0,5,1111,25.0,843.0,843.0
0.006,17,2,170,1,65,0.0,37.0,37.0,1,105,0.0,77.0,77.0
0.008,17,2,214,1,75,0.0,47.0,47.0,1,139,0.0,111.0,111.0
0.004,6,10,2006,5,927,1.0,659.0,659.0,5,1079,1.0,811.0,811.0
0.005,6,10,2006,5,927,1.0,659.0,659.0,5,1079,1.0,811.0,811.0
0.003,17,2,136,1,60,0.0,32.0,32.0,1,76,0.0,48.0,48.0
0.004,6,10,2007,5,928,1.0,660.0,660.0,5,1079,1.0,811.0,811.0
0.159,17,2,152,1,76,0.0,48.0,48.0,1,76,0.0,48.0,48.0
0.003,6,10,1702,5,863,0.0,595.0,595.0,5,839,0.0,571.0,571.0
0.019,6,10,1983,5,910,4.0,642.0,642.0,5,1073,4.0,805.0,805.0
0.259,17,2,152,1,76,0.0,48.0,48.0,1,76,0.0,48.0,48.0
0.005,6,10,1989,5,927,1.0,659.0,659.0,5,1062,1.0,794.0,794.0
10.735,17,28,4422,14,1994,817.0,269.0,114.0,14,2428,817.0,587.0,145.0
40.064,17,10,676,5,460,10014.0,104.0,64.0,5,216,10014.0,20.0,15.0
0.04,17,4,284,2,120,0.0,32.0,32.0,2,164,37.0,60.0,54.0
0.097,6,10,1506,5,395,21.0,127.0,127.0,5,1111,23.0,843.0,843.0
0.005,17,2,166,1,75,0.0,47.0,47.0,1,91,0.0,63.0,63.0
0.012,6,10,1972,5,910,3.0,642.0,642.0,5,1062,2.0,794.0,794.0
0.011,6,10,1989,5,910,2.0,642.0,642.0,5,1079,2.0,811.0,811.0
0.006,6,10,1547,5,764,1.0,496.0,496.0,5,783,1.0,515.0,515.0
0.142,6,10,1506,5,395,31.0,127.0,127.0,5,1111,24.0,843.0,843.0
0.101,6,10,1506,5,395,22.0,127.0,127.0,5,1111,21.0,843.0,843.0
40.067,17,10,676,5,460,10016.0,104.0,64.0,5,216,10016.0,20.0,15.0
0.005,6,13,3747,7,509,0.0,137.0,137.0,6,3238,0.0,1470.0,1459.0
0.005,6,10,1989,5,927,1.0,659.0,659.0,5,1062,1.0,794.0,794.0
0.04,17,4,420,2,122,0.0,33.0,33.0,2,298,1.0,145.0,121.0
0.068,17,8,3613,4,1874,22.0,1350.0,440.0,4,1739,11.0,1350.0,406.0
0.127,17,4,352,2,130,1.0,37.0,37.0,2,222,122.0,89.0,83.0
0.005,17,2,140,1,62,0.0,34.0,34.0,1,78,0.0,50.0,50.0
0.006,6,10,1854,5,889,1.0,621.0,621.0,5,965,1.0,697.0,697.0
0.005,6,10,1547,5,764,1.0,496.0,496.0,5,783,1.0,515.0,515.0
724.24,6,42,16604,22,5296,34487.0,1273.0,518.0,20,11308,38117.0,1402.0,933.0
0.102,6,10,1506,5,395,23.0,127.0,127.0,5,1111,22.0,843.0,843.0
0.017,6,10,1990,5,911,4.0,643.0,643.0,5,1079,4.0,811.0,811.0
0.006,6,10,1643,5,860,1.0,592.0,592.0,5,783,1.0,515.0,515.0
0.005,6,10,2006,5,927,1.0,659.0,659.0,5,1079,1.0,811.0,811.0
0.058,17,2,80,1,32,0.0,4.0,4.0,1,48,0.0,20.0,20.0
0.047,17,2,152,1,76,0.0,48.0,48.0,1,76,0.0,48.0,48.0
0.007,17,2,179,1,71,0.0,43.0,43.0,1,108,0.0,80.0,80.0
0.06,17,2,80,1,32,0.0,4.0,4.0,1,48,0.0,20.0,20.0
0.004,6,10,1774,5,923,1.0,655.0,655.0,5,851,1.0,583.0,583.0
1769.182,17,92,8096,46,4048,39315.0,60.0,60.0,46,4048,39315.0,60.0,60.0
0.011,6,10,1989,5,910,2.0,642.0,642.0,5,1079,2.0,811.0,811.0
0.041,17,4,284,2,120,0.0,32.0,32.0,2,164,37.0,60.0,54.0
40.062,17,10,676,5,460,10014.0,104.0,64.0,5,216,10014.0,20.0,15.0
0.011,6,10,1989,5,910,2.0,642.0,642.0,5,1079,2.0,811.0,811.0
0.005,17,2,144,1,64,0.0,36.0,36.0,1,80,0.0,52.0,52.0
0.003,17,2,148,1,60,0.0,32.0,32.0,1,88,0.0,60.0,60.0
0.054,6,10,1506,5,395,12.0,127.0,127.0,5,1111,11.0,843.0,843.0
0.006,6,10,1854,5,889,1.0,621.0,621.0,5,965,1.0,697.0,697.0
177.438,17,84,11748,42,2808,4327.0,44.0,38.0,42,8940,4327.0,239.0,184.0
40.062,17,10,676,5,460,10014.0,104.0,64.0,5,216,10014.0,20.0,15.0
0.007,6,10,1972,5,910,1.0,642.0,642.0,5,1062,1.0,794.0,794.0
0.01,17,2,136,1,60,0.0,32.0,32.0,1,76,0.0,48.0,48.0
0.005,6,10,1689,5,839,1.0,571.0,571.0,5,850,1.0,582.0,582.0
166.227,17,88,12102,44,2945,3865.0,44.0,38.0,44,9157,3865.0,239.0,180.0
0.169,17,2,152,1,76,0.0,48.0,48.0,1,76,0.0,48.0,48.0
240.097,6,30,9465,15,7015,17149.0,2139.0,693.0,15,2450,17149.0,580.0,237.0
354.001,6,21,1795,16,1030,23600.0,190.0,190.0,5,765,60003.0,464.0,248.0
0.015,6,10,1989,5,910,3.0,642.0,642.0,5,1079,3.0,811.0,811.0
0.005,6,10,1989,5,927,1.0,659.0,659.0,5,1062,1.0,794.0,794.0
0.004,6,10,2006,5,927,1.0,659.0,659.0,5,1079,1.0,811.0,811.0
308.193,17,20,1124,10,716,34229.0,48.0,43.0,10,408,34229.0,20.0,12.0
0.009,17,2,162,1,65,0.0,37.0,37.0,1,97,0.0,69.0,69.0
0.104,6,10,1506,5,395,25.0,127.0,127.0,5,1111,16.0,843.0,843.0
0.004,17,2,148,1,60,0.0,32.0,32.0,1,88,0.0,60.0,60.0
0.004,17,2,148,1,60,0.0,32.0,32.0,1,88,0.0,60.0,60.0
0.012,6,10,1990,5,911,2.0,643.0,643.0,5,1079,3.0,811.0,811.0
0.087,6,10,1506,5,395,17.0,127.0,127.0,5,1111,18.0,843.0,843.0
0.009,6,10,1989,5,910,2.0,642.0,642.0,5,1079,2.0,811.0,811.0
0.005,6,10,1774,5,923,1.0,655.0,655.0,5,851,1.0,583.0,583.0
301.086,6,46,18826,24,12919,13090.0,4080.0,1490.0,22,5907,420.0,2667.0,385.0
240.096,6,35,9339,17,6919,15005.0,1913.0,668.0,18,2420,14123.0,580.0,164.0
0.014,6,13,3735,7,497,2.0,125.0,125.0,6,3238,2.0,1470.0,1459.0
0.005,17,2,152,1,76,0.0,48.0,48.0,1,76,0.0,48.0,48.0
0.004,6,10,1774,5,923,1.0,655.0,655.0,5,851,1.0,583.0,583.0
0.216,6,16,2672,8,1398,30.0,533.0,324.0,8,1274,19.0,529.0,212.0
0.011,6,10,1989,5,910,2.0,642.0,642.0,5,1079,2.0,811.0,811.0
0.004,17,2,136,1,60,0.0,32.0,32.0,1,76,0.0,48.0,48.0
0.081,6,10,1506,5,395,17.0,127.0,127.0,5,1111,19.0,843.0,843.0
40.072,17,10,676,5,460,10015.0,104.0,64.0,5,216,10017.0,20.0,15.0
0.001,17,2,180,1,66,0.0,38.0,38.0,1,114,0.0,86.0,86.0
0.009,6,10,1989,5,910,2.0,642.0,642.0,5,1079,2.0,811.0,811.0
0.009,17,2,144,1,64,0.0,36.0,36.0,1,80,0.0,52.0,52.0
0.004,17,4,284,2,120,1.0,32.0,32.0,2,164,0.0,60.0,54.0
0.005,6,10,1774,5,923,1.0,655.0,655.0,5,851,1.0,583.0,583.0
0.069,6,10,1506,5,395,16.0,127.0,127.0,5,1111,15.0,843.0,843.0
11.172,17,28,4418,14,1993,846.0,268.0,114.0,14,2425,846.0,588.0,145.0
0.009,6,10,1677,5,827,2.0,559.0,559.0,5,850,2.0,582.0,582.0
0.044,17,2,148,1,60,0.0,32.0,32.0,1,88,0.0,60.0,60.0
0.05,17,2,182,1,65,0.0,37.0,37.0,1,117,0.0,89.0,89.0
0.001,17,2,180,1,66,0.0,38.0,38.0,1,114,0.0,86.0,86.0
0.0,17,2,136,1,60,0.0,32.0,32.0,1,76,0.0,48.0,48.0
0.009,6,10,1983,5,910,2.0,642.0,642.0,5,1073,2.0,805.0,805.0
311.73,17,20,1124,10,716,34620.0,48.0,43.0,10,408,34622.0,20.0,12.0
40.064,17,10,676,5,460,10013.0,104.0,64.0,5,216,10014.0,20.0,15.0
0.013,6,10,1990,5,911,3.0,643.0,643.0,5,1079,3.0,811.0,811.0
0.012,6,13,3735,7,497,2.0,125.0,125.0,6,3238,2.0,1470.0,1459.0
0.005,6,10,1689,5,839,1.0,571.0,571.0,5,850,1.0,582.0,582.0
0.009,6,6,716,3,458,3.0,302.0,302.0,3,258,3.0,102.0,102.0
0.005,6,10,2000,5,927,1.0,659.0,659.0,5,1073,1.0,805.0,805.0
0.012,6,13,3816,7,578,2.0,206.0,206.0,6,3238,2.0,1470.0,1459.0
0.072,17,2,144,1,64,0.0,36.0,36.0,1,80,0.0,52.0,52.0
0.011,6,10,1972,5,910,2.0,642.0,642.0,5,1062,2.0,794.0,794.0
0.004,17,2,148,1,60,0.0,32.0,32.0,1,88,0.0,60.0,60.0
0.003,17,2,148,1,60,0.0,32.0,32.0,1,88,0.0,60.0,60.0
0.007,17,2,299,1,65,0.0,37.0,37.0,1,234,0.0,206.0,206.0
0.012,6,10,1631,5,848,3.0,580.0,580.0,5,783,3.0,515.0,515.0
0.001,17,2,179,1,62,0.0,34.0,34.0,1,117,0.0,89.0,89.0
0.004,6,10,2000,5,927,1.0,659.0,659.0,5,1073,1.0,805.0,805.0
0.071,6,10,1506,5,395,16.0,127.0,127.0,5,1111,15.0,843.0,843.0
1756.063,6,105,6240,60,3510,29763.0,26.0,26.0,45,2730,39909.0,26.0,26.0
240.014,6,9,787,5,488,60003.0,232.0,232.0,4,299,80003.0,83.0,83.0
0.096,6,10,1506,5,395,23.0,127.0,127.0,5,1111,21.0,843.0,843.0
11.391,17,28,4424,14,1995,863.0,270.0,114.0,14,2429,863.0,588.0,145.0
0.006,6,10,1643,5,860,1.0,592.0,592.0,5,783,1.0,515.0,515.0
0.005,17,2,140,1,62,0.0,34.0,34.0,1,78,0.0,50.0,50.0
0.008,6,10,1983,5,910,2.0,642.0,642.0,5,1073,1.0,805.0,805.0
0.012,6,10,1762,5,911,3.0,643.0,643.0,5,851,3.0,583.0,583.0
0.01,6,10,1990,5,911,2.0,643.0,643.0,5,1079,2.0,811.0,811.0
0.008,6,12,1926,6,1189,1.0,659.0,434.0,6,737,1.0,417.0,417.0
0.005,6,10,1989,5,927,1.0,659.0,659.0,5,1062,1.0,794.0,794.0
0.005,6,10,2007,5,928,1.0,660.0,660.0,5,1079,1.0,811.0,811.0
40.071,17,10,676,5,460,10016.0,104.0,64.0,5,216,10016.0,20.0,15.0
0.041,17,4,352,2,130,4.0,37.0,37.0,2,222,2.0,89.0,83.0
0.005,6,13,3747,7,509,0.0,137.0,137.0,6,3238,0.0,1470.0,1459.0
0.004,6,10,2006,5,927,1.0,659.0,659.0,5,1079,1.0,811.0,811.0
0.815,6,10,937,6,427,163.0,107.0,107.0,4,510,181.0,294.0,294.0
0.006,6,10,1643,5,860,1.0,592.0,592.0,5,783,1.0,515.0,515.0
0.014,6,10,1990,5,911,3.0,643.0,643.0,5,1079,3.0,811.0,811.0
40.065,17,10,676,5,460,10015.0,104.0,64.0,5,216,10015.0,20.0,15.0
0.73,6,22,5072,11,1250,62.0,325.0,133.0,11,3822,62.0,1414.0,563.0
0.013,6,10,1989,5,910,3.0,642.0,642.0,5,1079,3.0,811.0,811.0
0.137,17,2,80,1,32,0.0,4.0,4.0,1,48,0.0,20.0,20.0
300.33,6,16,2170,9,684,37518.0,146.0,146.0,7,1486,50022.0,419.0,398.0
0.085,6,10,1506,5,395,19.0,127.0,127.0,5,1111,20.0,843.0,843.0
0.001,17,2,180,1,66,0.0,38.0,38.0,1,114,0.0,86.0,86.0
0.011,6,10,1990,5,911,2.0,643.0,643.0,5,1079,2.0,811.0,811.0
0.011,6,10,1972,5,910,2.0,642.0,642.0,5,1062,2.0,794.0,794.0
0.01,6,10,1983,5,910,2.0,642.0,642.0,5,1073,2.0,805.0,805.0
0.013,6,10,1983,5,910,3.0,642.0,642.0,5,1073,3.0,805.0,805.0
0.004,6,10,2007,5,928,1.0,660.0,660.0,5,1079,1.0,811.0,811.0
0.098,17,2,144,1,64,0.0,36.0,36.0,1,80,0.0,52.0,52.0
0.005,6,10,1989,5,927,1.0,659.0,659.0,5,1062,1.0,794.0,794.0
0.0,17,2,180,1,66,0.0,38.0,38.0,1,114,0.0,86.0,86.0
0.009,6,10,1990,5,911,2.0,643.0,643.0,5,1079,2.0,811.0,811.0
0.169,17,2,152,1,76,0.0,48.0,48.0,1,76,0.0,48.0,48.0
0.005,6,14,3742,8,504,0.0,80.0,80.0,6,3238,1.0,1470.0,1459.0
0.125,6,14,4389,8,923,17.0,238.0,166.0,6,3466,16.0,1402.0,786.0
0.01,6,10,1762,5,911,2.0,643.0,643.0,5,851,2.0,583.0,583.0
0.042,17,2,152,1,76,0.0,48.0,48.0,1,76,0.0,48.0,48.0
0.005,17,2,144,1,64,0.0,36.0,36.0,1,80,0.0,52.0,52.0
0.005,6,10,1547,5,764,1.0,496.0,496.0,5,783,1.0,515.0,515.0
0.126,6,10,1506,5,395,27.0,127.0,127.0,5,1111,29.0,843.0,843.0
0.004,6,10,1989,5,927,1.0,659.0,659.0,5,1062,1.0,794.0,794.0
0.016,17,2,198,1,91,0.0,63.0,63.0,1,107,0.0,79.0,79.0
0.105,6,10,1506,5,395,22.0,127.0,127.0,5,1111,22.0,843.0,843.0
0.013,6,10,1983,5,910,3.0,642.0,642.0,5,1073,3.0,805.0,805.0
0.005,6,10,1989,5,927,1.0,659.0,659.0,5,1062,1.0,794.0,794.0
0.085,6,10,1506,5,395,18.0,127.0,127.0,5,1111,19.0,843.0,843.0
11.122,17,28,4420,14,1993,843.0,268.0,114.0,14,2427,843.0,586.0,145.0
0.005,6,10,2006,5,927,1.0,659.0,659.0,5,1079,1.0,811.0,811.0
0.014,6,10,1762,5,911,3.0,643.0,643.0,5,851,3.0,583.0,583.0
0.093,6,10,1506,5,395,20.0,127.0,127.0,5,1111,21.0,843.0,843.0
58.327,17,26,14948,14,12082,4484.0,1350.0,835.0,12,2866,5299.0,1350.0,210.0
0.004,6,10,2006,5,927,1.0,659.0,659.0,5,1079,1.0,811.0,811.0
0.225,6,16,2777,8,1395,32.0,533.0,323.0,8,1382,20.0,529.0,239.0
0.173,6,3,453,2,321,173.0,241.0,241.0,1,132,0.0,92.0,92.0
0.004,6,10,1774,5,923,1.0,655.0,655.0,5,851,1.0,583.0,583.0
0.004,6,10,2000,5,927,1.0,659.0,659.0,5,1073,1.0,805.0,805.0
0.006,6,10,1689,5,839,1.0,571.0,571.0,5,850,1.0,582.0,582.0
0.006,17,2,214,1,75,0.0,47.0,47.0,1,139,0.0,111.0,111.0
0.02,6,13,3735,7,497,3.0,125.0,125.0,6,3238,3.0,1470.0,1459.0
0.013,6,10,1972,5,910,3.0,642.0,642.0,5,1062,3.0,794.0,794.0
0.062,17,2,152,1,76,0.0,48.0,48.0,1,76,0.0,48.0,48.0
0.005,6,10,2006,5,927,1.0,659.0,659.0,5,1079,1.0,811.0,811.0
0.091,6,10,1506,5,395,21.0,127.0,127.0,5,1111,21.0,843.0,843.0
0.005,6,10,2000,5,927,1.0,659.0,659.0,5,1073,1.0,805.0,805.0
0.041,17,2,148,1,60,0.0,32.0,32.0,1,88,0.0,60.0,60.0
310.01,17,20,1124,10,716,34431.0,48.0,43.0,10,408,34432.0,20.0,12.0
0.004,17,2,136,1,60,0.0,32.0,32.0,1,76,0.0,48.0,48.0
0.013,6,10,1972,5,910,3.0,642.0,642.0,5,1062,3.0,794.0,794.0
0.076,6,10,1506,5,395,17.0,127.0,127.0,5,1111,17.0,843.0,843.0
0.088,6,10,1506,5,395,18.0,127.0,127.0,5,1111,16.0,843.0,843.0
0.008,6,12,1926,6,1189,1.0,659.0,434.0,6,737,1.0,417.0,417.0
0.005,6,10,1547,5,764,1.0,496.0,496.0,5,783,1.0,515.0,515.0
0.005,6,10,2006,5,927,1.0,659.0,659.0,5,1079,1.0,811.0,811.0
0.099,6,10,1506,5,395,20.0,127.0,127.0,5,1111,23.0,843.0,843.0
0.206,6,10,1506,5,395,48.0,127.0,127.0,5,1111,38.0,843.0,843.0
0.01,6,10,1972,5,910,2.0,642.0,642.0,5,1062,2.0,794.0,794.0
0.005,6,10,1854,5,889,1.0,621.0,621.0,5,965,1.0,697.0,697.0
0.005,6,10,1643,5,860,1.0,592.0,592.0,5,783,1.0,515.0,515.0
0.005,6,10,1774,5,923,1.0,655.0,655.0,5,851,1.0,583.0,583.0
0.263,17,45,29291,27,26168,10.0,1350.0,941.0,18,3123,13.0,1350.0,145.0
0.005,6,10,1689,5,839,1.0,571.0,571.0,5,850,1.0,582.0,582.0
0.087,17,4,352,2,130,1.0,37.0,37.0,2,222,32.0,89.0,83.0
376.371,6,22,2313,16,867,25091.0,195.0,195.0,6,1446,4636.0,419.0,398.0
0.005,6,10,1989,5,927,1.0,659.0,659.0,5,1062,1.0,794.0,794.0
0.005,17,2,170,1,65,0.0,37.0,37.0,1,105,0.0,77.0,77.0
241.79,6,299,342887,111,17284,2198.0,2736.0,959.0,188,325603,1292.0,2804.0,1774.0
0.006,6,10,1547,5,764,1.0,496.0,496.0,5,783,1.0,515.0,515.0
0.684,6,22,5072,11,1250,58.0,325.0,133.0,11,3822,57.0,1414.0,563.0
0.009,6,10,1989,5,910,2.0,642.0,642.0,5,1079,2.0,811.0,811.0
40.069,17,10,676,5,460,10015.0,104.0,64.0,5,216,10016.0,20.0,15.0
163.071,17,70,10093,35,2331,4796.0,44.0,38.0,35,7762,4795.0,239.0,193.0
0.005,6,13,3747,7,509,0.0,137.0,137.0,6,3238,0.0,1470.0,1459.0
40.074,17,10,676,5,460,10016.0,104.0,64.0,5,216,10017.0,20.0,15.0
0.001,17,2,180,1,66,0.0,38.0,38.0,1,114,0.0,86.0,86.0
0.018,6,10,1989,5,910,4.0,642.0,642.0,5,1079,4.0,811.0,811.0
0.003,17,2,136,1,60,0.0,32.0,32.0,1,76,0.0,48.0,48.0
0.005,6,13,3690,7,452,0.0,80.0,80.0,6,3238,0.0,1470.0,1459.0
0.004,6,10,1702,5,863,0.0,595.0,595.0,5,839,1.0,571.0,571.0
0.125,6,10,1506,5,395,30.0,127.0,127.0,5,1111,27.0,843.0,843.0
0.007,6,10,1547,5,764,1.0,496.0,496.0,5,783,1.0,515.0,515.0
75.482,6,26,9525,12,1627,77.0,794.0,367.0,14,7898,5796.0,1360.0,732.0
0.08,6,10,1506,5,395,18.0,127.0,127.0,5,1111,17.0,843.0,843.0
0.02,6,10,1983,5,910,4.0,642.0,642.0,5,1073,4.0,805.0,805.0
175.112,17,72,10129,36,2402,5003.0,44.0,38.0,36,7727,5003.0,260.0,186.0
0.003,17,2,148,1,60,0.0,32.0,32.0,1,88,0.0,60.0,60.0
0.014,6,10,1631,5,848,3.0,580.0,580.0,5,783,3.0,515.0,515.0
0.082,6,10,1506,5,395,18.0,127.0,127.0,5,1111,14.0,843.0,843.0
300.116,6,45,18300,24,12662,13040.0,2720.0,1296.0,21,5638,14997.0,2667.0,435.0
295.182,6,392,347569,190,21454,1561.0,2736.0,888.0,202,326115,1468.0,4206.0,1687.0
0.005,6,10,1774,5,923,1.0,655.0,655.0,5,851,1.0,583.0,583.0
0.005,6,10,1989,5,927,1.0,659.0,659.0,5,1062,1.0,794.0,794.0
0.004,6,10,1702,5,863,1.0,595.0,595.0,5,839,0.0,571.0,571.0
0.005,6,10,2007,5,928,1.0,660.0,660.0,5,1079,1.0,811.0,811.0
10.828,17,28,4421,14,1994,824.0,269.0,114.0,14,2427,824.0,586.0,145.0
0.085,6,10,1506,5,395,16.0,127.0,127.0,5,1111,20.0,843.0,843.0
0.006,6,10,1547,5,764,1.0,496.0,496.0,5,783,1.0,515.0,515.0
0.01,6,10,1972,5,910,2.0,642.0,642.0,5,1062,2.0,794.0,794.0
0.006,6,10,1547,5,764,1.0,496.0,496.0,5,783,1.0,515.0,515.0
0.081,6,10,1506,5,395,18.0,127.0,127.0,5,1111,18.0,843.0,843.0
0.013,6,10,1989,5,910,3.0,642.0,642.0,5,1079,3.0,811.0,811.0
0.009,6,10,1989,5,910,2.0,642.0,642.0,5,1079,2.0,811.0,811.0
0.079,6,10,1506,5,395,16.0,127.0,127.0,5,1111,15.0,843.0,843.0
0.005,6,10,2000,5,927,1.0,659.0,659.0,5,1073,1.0,805.0,805.0
0.138,6,10,1506,5,395,31.0,127.0,127.0,5,1111,32.0,843.0,843.0
0.009,17,2,170,1,65,0.0,37.0,37.0,1,105,0.0,77.0,77.0
10.933,17,28,4424,14,1995,832.0,270.0,114.0,14,2429,832.0,588.0,145.0
0.001,17,2,180,1,66,0.0,38.0,38.0,1,114,0.0,86.0,86.0
0.013,6,10,1989,5,910,3.0,642.0,642.0,5,1079,3.0,811.0,811.0
354.035,6,21,1795,16,1030,23602.0,190.0,190.0,5,765,60004.0,464.0,248.0
0.011,6,14,3787,7,497,1.0,125.0,125.0,7,3290,1.0,1448.0,972.0
178.221,17,78,11323,39,2602,4689.0,44.0,38.0,39,8721,4689.0,239.0,195.0
0.166,6,10,1506,5,395,38.0,127.0,127.0,5,1111,40.0,843.0,843.0
367.196,6,22,2313,16,867,24479.0,195.0,195.0,6,1446,4636.0,419.0,398.0
0.004,6,10,2006,5,927,1.0,659.0,659.0,5,1079,1.0,811.0,811.0
0.089,6,10,1506,5,395,16.0,127.0,127.0,5,1111,19.0,843.0,843.0
0.005,6,10,2006,5,927,1.0,659.0,659.0,5,1079,1.0,811.0,811.0
0.004,6,10,2006,5,927,1.0,659.0,659.0,5,1079,1.0,811.0,811.0
0.091,6,10,1506,5,395,20.0,127.0,127.0,5,1111,20.0,843.0,843.0
0.004,6,10,1779,5,928,1.0,660.0,660.0,5,851,1.0,583.0,583.0
404.856,6,36,11558,19,3490,22490.0,676.0,415.0,17,8068,25301.0,1402.0,718.0
0.008,6,10,1989,5,910,2.0,642.0,642.0,5,1079,1.0,811.0,811.0
0.006,17,2,179,1,71,0.0,43.0,43.0,1,108,0.0,80.0,80.0
0.004,6,10,1779,5,928,1.0,660.0,660.0,5,851,1.0,583.0,583.0
0.02,6,10,1774,5,923,5.0,655.0,655.0,5,851,5.0,583.0,583.0
15.083,17,16,10226,9,8017,1881.0,1350.0,862.0,7,2209,2509.0,1350.0,287.0
0.003,17,2,136,1,60,0.0,32.0,32.0,1,76,0.0,48.0,48.0
0.071,17,2,136,1,60,0.0,32.0,32.0,1,76,0.0,48.0,48.0
0.804,6,22,5168,11,1138,68.0,267.0,115.0,11,4030,67.0,1414.0,597.0
547.263,6,37,11739,20,3454,28803.0,676.0,401.0,17,8285,30450.0,1402.0,739.0
240.105,6,16,4480,9,963,30013.0,238.0,166.0,7,3517,40017.0,1402.0,786.0
0.006,6,10,1547,5,764,1.0,496.0,496.0,5,783,1.0,515.0,515.0
0.006,17,2,136,1,60,0.0,32.0,32.0,1,76,0.0,48.0,48.0
0.04,17,4,352,2,130,1.0,37.0,37.0,2,222,0.0,89.0,83.0
0.001,17,2,180,1,66,0.0,38.0,38.0,1,114,0.0,86.0,86.0
15.069,17,15,9238,8,6902,2148.0,1350.0,834.0,7,2336,2506.0,1350.0,305.0
0.004,6,10,1989,5,927,1.0,659.0,659.0,5,1062,1.0,794.0,794.0
0.004,6,10,2000,5,927,1.0,659.0,659.0,5,1073,1.0,805.0,805.0
240.02,6,9,787,5,488,60005.0,232.0,232.0,4,299,80006.0,83.0,83.0
300.36,6,16,2170,9,684,37523.0,146.0,146.0,7,1486,50030.0,419.0,398.0
0.067,17,8,3613,4,1874,22.0,1350.0,440.0,4,1739,11.0,1350.0,406.0
0.014,6,10,1990,5,911,3.0,643.0,643.0,5,1079,3.0,811.0,811.0
0.014,6,10,1972,5,910,3.0,642.0,642.0,5,1062,3.0,794.0,794.0
0.003,17,2,148,1,60,0.0,32.0,32.0,1,88,0.0,60.0,60.0
0.12,6,10,1506,5,395,29.0,127.0,127.0,5,1111,25.0,843.0,843.0
0.011,6,10,1989,5,910,2.0,642.0,642.0,5,1079,2.0,811.0,811.0
0.005,6,10,1689,5,839,1.0,571.0,571.0,5,850,1.0,582.0,582.0
40.054,17,10,676,5,460,10010.0,104.0,64.0,5,216,10012.0,20.0,15.0
0.005,6,10,2006,5,927,1.0,659.0,659.0,5,1079,1.0,811.0,811.0
0.02,6,10,1983,5,910,4.0,642.0,642.0,5,1073,5.0,805.0,805.0
0.005,6,10,1774,5,923,1.0,655.0,655.0,5,851,1.0,583.0,583.0
0.054,17,2,152,1,76,0.0,48.0,48.0,1,76,0.0,48.0,48.0
0.067,17,8,3613,4,1874,22.0,1350.0,440.0,4,1739,11.0,1350.0,406.0
0.01,6,10,1983,5,910,2.0,642.0,642.0,5,1073,2.0,805.0,805.0
0.008,6,10,1972,5,910,1.0,642.0,642.0,5,1062,1.0,794.0,794.0
0.017,6,10,1989,5,910,4.0,642.0,642.0,5,1079,4.0,811.0,811.0
0.015,6,10,1990,5,911,3.0,643.0,643.0,5,1079,3.0,811.0,811.0
0.811,6,10,2009,6,1655,162.0,1403.0,1403.0,4,354,190.0,182.0,182.0
0.072,17,8,3613,4,1874,24.0,1350.0,440.0,4,1739,12.0,1350.0,406.0
178.521,17,72,10228,36,2396,5100.0,44.0,38.0,36,7832,5100.0,239.0,189.0
0.004,6,10,1774,5,923,1.0,655.0,655.0,5,851,1.0,583.0,583.0
0.036,6,10,1989,5,910,9.0,642.0,642.0,5,1079,8.0,811.0,811.0
0.006,6,10,1547,5,764,1.0,496.0,496.0,5,783,1.0,515.0,515.0
0.001,17,2,136,1,60,0.0,32.0,32.0,1,76,0.0,48.0,48.0
0.01,6,10,1762,5,911,2.0,643.0,643.0,5,851,2.0,583.0,583.0
0.037,17,2,170,1,65,0.0,37.0,37.0,1,105,0.0,77.0,77.0
0.004,6,10,1774,5,923,1.0,655.0,655.0,5,851,1.0,583.0,583.0
11.117,17,28,4417,14,1994,842.0,269.0,114.0,14,2423,842.0,586.0,145.0
240.125,6,31,9412,15,6971,17151.0,2095.0,688.0,16,2441,16008.0,580.0,200.0
0.266,17,39,20043,21,17038,13.0,1350.0,783.0,18,3005,11.0,1350.0,138.0
0.014,6,10,1972,5,910,3.0,642.0,642.0,5,1062,3.0,794.0,794.0
0.004,17,2,136,1,60,0.0,32.0,32.0,1,76,0.0,48.0,48.0
0.016,6,10,1989,5,910,3.0,642.0,642.0,5,1079,4.0,811.0,811.0
0.104,6,10,1506,5,395,24.0,127.0,127.0,5,1111,21.0,843.0,843.0
0.004,6,10,1774,5,923,1.0,655.0,655.0,5,851,1.0,583.0,583.0
0.004,6,10,2007,5,928,1.0,660.0,660.0,5,1079,1.0,811.0,811.0
0.007,17,2,136,1,60,0.0,32.0,32.0,1,76,0.0,48.0,48.0
0.005,6,10,1989,5,927,1.0,659.0,659.0,5,1062,1.0,794.0,794.0
0.004,6,10,2006,5,927,1.0,659.0,659.0,5,1079,1.0,811.0,811.0
0.093,6,10,1506,5,395,18.0,127.0,127.0,5,1111,22.0,843.0,843.0
0.174,17,2,152,1,76,0.0,48.0,48.0,1,76,0.0,48.0,48.0
0.006,6,10,1547,5,764,1.0,496.0,496.0,5,783,1.0,515.0,515.0
0.039,17,2,148,1,60,0.0,32.0,32.0,1,88,0.0,60.0,60.0
240.257,6,43,5412,22,2534,11440.0,581.0,195.0,21,2878,12012.0,566.0,222.0
0.052,17,2,152,1,76,0.0,48.0,48.0,1,76,0.0,48.0,48.0
0.058,17,2,144,1,64,0.0,36.0,36.0,1,80,0.0,52.0,52.0
0.172,17,2,152,1,76,0.0,48.0,48.0,1,76,0.0,48.0,48.0
0.004,6,10,1989,5,927,1.0,659.0,659.0,5,1062,1.0,794.0,794.0
0.005,6,10,2000,5,927,1.0,659.0,659.0,5,1073,1.0,805.0,805.0
0.041,6,10,1762,5,911,10.0,643.0,643.0,5,851,10.0,583.0,583.0
31.003,6,26,8595,15,1828,2214.0,517.0,262.0,11,6767,3099.0,1402.0,773.0
177.316,17,82,11427,41,2739,4432.0,44.0,38.0,41,8688,4432.0,239.0,183.0
0.148,6,10,1506,5,395,34.0,127.0,127.0,5,1111,25.0,843.0,843.0
0.086,6,10,1506,5,395,20.0,127.0,127.0,5,1111,20.0,843.0,843.0
0.005,6,10,2000,5,927,1.0,659.0,659.0,5,1073,1.0,805.0,805.0
10.841,17,28,4421,14,1993,825.0,268.0,114.0,14,2428,825.0,587.0,145.0
40.054,17,10,676,5,460,10011.0,104.0,64.0,5,216,10012.0,20.0,15.0
0.011,6,10,1762,5,911,2.0,643.0,643.0,5,851,2.0,583.0,583.0
0.088,6,10,1506,5,395,19.0,127.0,127.0,5,1111,18.0,843.0,843.0
11.137,17,28,4422,14,1995,844.0,270.0,114.0,14,2427,844.0,586.0,145.0
0.001,17,2,179,1,62,0.0,34.0,34.0,1,117,0.0,89.0,89.0
0.042,17,2,412,1,61,0.0,33.0,33.0,1,351,0.0,323.0,323.0
0.005,17,2,170,1,65,0.0,37.0,37.0,1,105,0.0,77.0,77.0
0.01,6,10,1989,5,910,2.0,642.0,642.0,5,1079,2.0,811.0,811.0
0.249,17,47,28119,26,23458,9.0,1350.0,874.0,21,4661,9.0,1350.0,193.0
167.055,17,78,11217,39,2600,4396.0,44.0,38.0,39,8617,4396.0,261.0,192.0
0.008,6,10,1605,5,388,1.0,120.0,120.0,5,1217,2.0,949.0,949.0
0.073,6,10,1506,5,395,14.0,127.0,127.0,5,1111,17.0,843.0,843.0
0.004,6,10,1702,5,863,1.0,595.0,595.0,5,839,0.0,571.0,571.0
0.038,17,2,170,1,65,0.0,37.0,37.0,1,105,0.0,77.0,77.0
0.011,6,10,1989,5,910,2.0,642.0,642.0,5,1079,2.0,811.0,811.0
240.096,6,16,4481,9,963,30012.0,238.0,166.0,7,3518,40015.0,1402.0,786.0
0.006,6,10,1689,5,839,1.0,571.0,571.0,5,850,1.0,582.0,582.0
0.07,6,10,1506,5,395,16.0,127.0,127.0,5,1111,15.0,843.0,843.0
0.012,6,10,1972,5,910,2.0,642.0,642.0,5,1062,3.0,794.0,794.0
0.006,6,10,1989,5,927,1.0,659.0,659.0,5,1062,1.0,794.0,794.0
0.01,6,10,1989,5,910,2.0,642.0,642.0,5,1079,2.0,811.0,811.0
0.004,17,2,148,1,60,0.0,32.0,32.0,1,88,0.0,60.0,60.0
0.01,6,10,1989,5,910,2.0,642.0,642.0,5,1079,2.0,811.0,811.0
0.005,6,10,1643,5,860,1.0,592.0,592.0,5,783,1.0,515.0,515.0
1769.793,6,84,4422,42,2211,43164.0,27.0,27.0,42,2211,43164.0,27.0,27.0
0.014,6,14,3787,7,497,2.0,125.0,125.0,7,3290,2.0,1448.0,972.0
0.005,6,10,2006,5,927,1.0,659.0,659.0,5,1079,1.0,811.0,811.0
0.011,6,10,1972,5,910,2.0,642.0,642.0,5,1062,2.0,794.0,794.0
0.005,6,10,1989,5,927,1.0,659.0,659.0,5,1062,1.0,794.0,794.0
0.005,6,10,1989,5,927,1.0,659.0,659.0,5,1062,1.0,794.0,794.0
173.025,17,74,10391,37,2465,4806.0,44.0,38.0,37,7926,4806.0,239.0,186.0
0.134,6,10,1506,5,395,31.0,127.0,127.0,5,1111,31.0,843.0,843.0
1778.709,17,144,41760,72,22752,25052.0,288.0,288.0,72,19008,25052.0,236.0,236.0
0.016,6,10,1990,5,911,4.0,643.0,643.0,5,1079,4.0,811.0,811.0
0.005,6,10,2000,5,927,1.0,659.0,659.0,5,1073,1.0,805.0,805.0
0.016,6,10,1972,5,910,3.0,642.0,642.0,5,1062,4.0,794.0,794.0
0.011,6,10,1990,5,911,2.0,643.0,643.0,5,1079,2.0,811.0,811.0
0.065,6,10,1506,5,395,15.0,127.0,127.0,5,1111,14.0,843.0,843.0
40.041,17,10,676,5,460,10009.0,104.0,64.0,5,216,10009.0,20.0,15.0
0.132,17,2,80,1,32,0.0,4.0,4.0,1,48,0.0,20.0,20.0
0.059,17,2,152,1,76,0.0,48.0,48.0,1,76,0.0,48.0,48.0
240.089,6,16,4480,9,963,30011.0,238.0,166.0,7,3517,40014.0,1402.0,786.0
0.057,6,10,1506,5,395,13.0,127.0,127.0,5,1111,13.0,843.0,843.0
0.006,6,10,1547,5,764,1.0,496.0,496.0,5,783,1.0,515.0,515.0
0.104,6,10,1506,5,395,21.0,127.0,127.0,5,1111,24.0,843.0,843.0
0.014,6,10,1990,5,911,3.0,643.0,643.0,5,1079,3.0,811.0,811.0
169.248,17,86,12021,43,2876,4029.0,44.0,38.0,43,9145,4029.0,261.0,184.0
0.005,6,10,2006,5,927,1.0,659.0,659.0,5,1079,1.0,811.0,811.0
0.081,6,10,1506,5,395,17.0,127.0,127.0,5,1111,18.0,843.0,843.0
0.024,17,2,152,1,56,0.0,28.0,28.0,1,96,0.0,68.0,68.0
0.012,6,13,3735,7,497,2.0,125.0,125.0,6,3238,2.0,1470.0,1459.0
0.127,17,2,148,1,60,0.0,32.0,32.0,1,88,0.0,60.0,60.0
0.006,6,13,3747,7,509,1.0,137.0,137.0,6,3238,1.0,1470.0,1459.0
10.747,17,28,4422,14,1994,818.0,269.0,114.0,14,2428,818.0,587.0,145.0
0.005,6,10,2007,5,928,1.0,660.0,660.0,5,1079,1.0,811.0,811.0
0.014,6,10,1989,5,910,3.0,642.0,642.0,5,1079,3.0,811.0,811.0
0.005,6,10,2007,5,928,1.0,660.0,660.0,5,1079,1.0,811.0,811.0
0.005,17,2,179,1,71,0.0,43.0,43.0,1,108,0.0,80.0,80.0
0.005,6,10,1547,5,764,1.0,496.0,496.0,5,783,1.0,515.0,515.0
0.039,17,2,136,1,60,0.0,32.0,32.0,1,76,0.0,48.0,48.0
0.005,6,10,1854,5,889,1.0,621.0,621.0,5,965,1.0,697.0,697.0
281.505,6,23,6075,10,1186,31277.0,267.0,156.0,13,4889,23458.0,1400.0,873.0
0.015,6,10,1990,5,911,3.0,643.0,643.0,5,1079,3.0,811.0,811.0
0.005,6,10,2006,5,927,1.0,659.0,659.0,5,1079,1.0,811.0,811.0
0.005,17,2,222,1,65,0.0,37.0,37.0,1,157,0.0,129.0,129.0
0.005,6,14,3736,7,446,0.0,74.0,74.0,7,3290,0.0,1448.0,972.0
0.005,17,2,214,1,75,0.0,47.0,47.0,1,139,0.0,111.0,111.0
0.005,6,10,2007,5,928,1.0,660.0,660.0,5,1079,1.0,811.0,811.0
0.016,6,10,1983,5,910,3.0,642.0,642.0,5,1073,4.0,805.0,805.0
1772.585,17,120,11460,60,5460,30043.0,63.0,63.0,60,6000,30043.0,72.0,72.0
0.106,6,10,1506,5,395,24.0,127.0,127.0,5,1111,25.0,843.0,843.0
0.005,6,10,1989,5,927,1.0,659.0,659.0,5,1062,1.0,794.0,794.0
0.069,6,10,1506,5,395,15.0,127.0,127.0,5,1111,14.0,843.0,843.0
34.389,6,26,11203,13,1748,2865.0,538.0,350.0,13,9455,2865.0,2804.0,1096.0
0.072,17,2,182,1,65,0.0,37.0,37.0,1,117,0.0,89.0,89.0
0.127,6,10,1506,5,395,29.0,127.0,127.0,5,1111,24.0,843.0,843.0
0.022,6,10,1990,5,911,5.0,643.0,643.0,5,1079,5.0,811.0,811.0
40.064,17,10,676,5,460,10015.0,104.0,64.0,5,216,10015.0,20.0,15.0
300.292,6,16,2170,9,684,37515.0,146.0,146.0,7,1486,50020.0,419.0,398.0
0.169,6,3,453,2,321,169.0,241.0,241.0,1,132,0.0,92.0,92.0
0.019,6,10,1983,5,910,4.0,642.0,642.0,5,1073,4.0,805.0,805.0
176.116,17,78,10889,39,2612,4634.0,44.0,38.0,39,8277,4634.0,261.0,184.0
0.005,17,2,148,1,60,0.0,32.0,32.0,1,88,0.0,60.0,60.0
0.009,6,10,1677,5,827,2.0,559.0,559.0,5,850,2.0,582.0,582.0
0.014,6,10,1990,5,911,3.0,643.0,643.0,5,1079,3.0,811.0,811.0
0.005,17,2,166,1,75,0.0,47.0,47.0,1,91,0.0,63.0,63.0
0.006,6,10,1547,5,764,1.0,496.0,496.0,5,783,1.0,515.0,515.0
0.005,6,10,1989,5,927,1.0,659.0,659.0,5,1062,1.0,794.0,794.0
0.031,6,10,1989,5,910,7.0,642.0,642.0,5,1079,7.0,811.0,811.0
0.016,6,10,1989,5,910,4.0,642.0,642.0,5,1079,3.0,811.0,811.0
0.005,6,10,1689,5,839,1.0,571.0,571.0,5,850,1.0,582.0,582.0
0.005,6,10,2000,5,927,1.0,659.0,659.0,5,1073,1.0,805.0,805.0
0.103,6,10,1506,5,395,19.0,127.0,127.0,5,1111,21.0,843.0,843.0
0.054,17,2,136,1,60,0.0,32.0,32.0,1,76,0.0,48.0,48.0
0.006,6,10,1689,5,839,1.0,571.0,571.0,5,850,1.0,582.0,582.0
1771.628,6,307,98400,188,86991,9473.0,2001.0,689.0,119,11409,15013.0,452.0,70.0
0.007,17,2,164,1,74,0.0,46.0,46.0,1,90,0.0,62.0,62.0
0.006,6,10,1547,5,764,1.0,496.0,496.0,5,783,1.0,515.0,515.0
240.087,6,31,9583,16,7052,16005.0,2124.0,691.0,15,2531,17148.0,580.0,217.0
0.09,6,10,1506,5,395,20.0,127.0,127.0,5,1111,16.0,843.0,843.0
0.012,6,10,1989,5,910,3.0,642.0,642.0,5,1079,3.0,811.0,811.0
11.242,17,28,4422,14,1995,851.0,270.0,114.0,14,2427,851.0,586.0,145.0
0.005,6,10,2000,5,927,1.0,659.0,659.0,5,1073,1.0,805.0,805.0
0.005,6,10,1854,5,889,1.0,621.0,621.0,5,965,1.0,697.0,697.0
0.124,17,2,136,1,60,0.0,32.0,32.0,1,76,0.0,48.0,48.0
0.166,6,10,1506,5,395,37.0,127.0,127.0,5,1111,36.0,843.0,843.0
0.005,6,10,1774,5,923,1.0,655.0,655.0,5,851,1.0,583.0,583.0
0.006,6,10,1547,5,764,1.0,496.0,496.0,5,783,1.0,515.0,515.0
10.848,17,28,4420,14,1993,826.0,268.0,114.0,14,2427,826.0,586.0,145.0
0.006,6,10,1774,5,923,1.0,655.0,655.0,5,851,1.0,583.0,583.0
0.094,6,10,1506,5,395,20.0,127.0,127.0,5,1111,19.0,843.0,843.0
0.005,17,2,170,1,65,0.0,37.0,37.0,1,105,0.0,77.0,77.0
10.72,17,28,4422,14,1994,816.0,269.0,114.0,14,2428,816.0,587.0,145.0
0.015,6,10,1989,5,910,3.0,642.0,642.0,5,1079,3.0,811.0,811.0
170.405,17,72,10288,36,2385,4868.0,44.0,38.0,36,7903,4868.0,239.0,191.0
0.003,6,10,1702,5,863,0.0,595.0,595.0,5,839,0.0,571.0,571.0
313.198,17,20,1124,10,716,34785.0,48.0,43.0,10,408,34785.0,20.0,12.0
308.496,17,20,1124,10,716,34262.0,48.0,43.0,10,408,34262.0,20.0,12.0
0.04,17,2,136,1,60,0.0,32.0,32.0,1,76,0.0,48.0,48.0
0.016,6,10,1762,5,911,4.0,643.0,643.0,5,851,4.0,583.0,583.0
0.016,6,10,1989,5,910,4.0,642.0,642.0,5,1079,4.0,811.0,811.0
0.004,17,2,186,1,61,0.0,33.0,33.0,1,125,0.0,97.0,97.0
0.054,6,10,1506,5,395,12.0,127.0,127.0,5,1111,13.0,843.0,843.0
40.062,17,10,676,5,460,10014.0,104.0,64.0,5,216,10014.0,20.0,15.0
0.014,6,10,1989,5,910,3.0,642.0,642.0,5,1079,3.0,811.0,811.0
240.128,6,36,26639,19,17571,13340.0,2736.0,1658.0,17,9068,15007.0,2674.0,1168.0
0.005,6,13,3747,7,509,0.0,137.0,137.0,6,3238,0.0,1470.0,1459.0
0.04,17,2,182,1,65,0.0,37.0,37.0,1,117,0.0,89.0,89.0
0.01,6,10,1762,5,911,2.0,643.0,643.0,5,851,2.0,583.0,583.0
0.075,6,10,1506,5,395,16.0,127.0,127.0,5,1111,17.0,843.0,843.0
0.167,17,2,152,1,76,0.0,48.0,48.0,1,76,0.0,48.0,48.0
0.004,6,10,2006,5,927,1.0,659.0,659.0,5,1079,1.0,811.0,811.0
0.005,6,10,1854,5,889,1.0,621.0,621.0,5,965,1.0,697.0,697.0
178.501,17,72,10175,36,2394,5099.0,44.0,38.0,36,7781,5100.0,261.0,188.0
0.005,6,10,1854,5,889,1.0,621.0,621.0,5,965,1.0,697.0,697.0
0.135,6,10,1506,5,395,25.0,127.0,127.0,5,1111,26.0,843.0,843.0
0.004,6,10,2007,5,928,1.0,660.0,660.0,5,1079,1.0,811.0,811.0
0.007,17,2,179,1,71,0.0,43.0,43.0,1,108,0.0,80.0,80.0
0.11,6,10,1506,5,395,22.0,127.0,127.0,5,1111,24.0,843.0,843.0
0.087,6,10,1506,5,395,20.0,127.0,127.0,5,1111,19.0,843.0,843.0
0.004,6,10,2006,5,927,1.0,659.0,659.0,5,1079,1.0,811.0,811.0
0.005,6,10,1989,5,927,1.0,659.0,659.0,5,1062,1.0,794.0,794.0
0.014,6,10,1677,5,827,3.0,559.0,559.0,5,850,3.0,582.0,582.0
0.009,17,2,152,1,76,0.0,48.0,48.0,1,76,0.0,48.0,48.0
0.005,6,10,1643,5,860,1.0,592.0,592.0,5,783,1.0,515.0,515.0
0.122,6,10,1506,5,395,28.0,127.0,127.0,5,1111,26.0,843.0,843.0
0.003,17,2,148,1,60,0.0,32.0,32.0,1,88,0.0,60.0,60.0
0.015,6,10,1972,5,910,3.0,642.0,642.0,5,1062,3.0,794.0,794.0
0.006,6,10,1547,5,764,1.0,496.0,496.0,5,783,1.0,515.0,515.0
0.015,6,10,1983,5,910,3.0,642.0,642.0,5,1073,3.0,805.0,805.0
40.059,17,10,676,5,460,10013.0,104.0,64.0,5,216,10013.0,20.0,15.0
311.853,17,20,1124,10,716,34636.0,48.0,43.0,10,408,34636.0,20.0,12.0
0.004,6,10,2007,5,928,1.0,660.0,660.0,5,1079,1.0,811.0,811.0
0.006,6,10,1547,5,764,1.0,496.0,496.0,5,783,1.0,515.0,515.0
0.006,6,10,1779,5,928,1.0,660.0,660.0,5,851,1.0,583.0,583.0
0.006,6,10,1547,5,764,1.0,496.0,496.0,5,783,1.0,515.0,515.0
0.004,6,10,2007,5,928,1.0,660.0,660.0,5,1079,1.0,811.0,811.0
0.194,17,4,352,2,130,154.0,37.0,37.0,2,222,155.0,89.0,83.0
0.005,6,10,2006,5,927,1.0,659.0,659.0,5,1079,1.0,811.0,811.0
0.012,6,10,1762,5,911,3.0,643.0,643.0,5,851,3.0,583.0,583.0
0.005,17,2,169,1,62,0.0,34.0,34.0,1,107,0.0,79.0,79.0
241.499,6,393,347793,195,21657,1244.0,2736.0,885.0,198,326136,1225.0,2915.0,1679.0
0.067,6,10,1506,5,395,13.0,127.0,127.0,5,1111,13.0,843.0,843.0
15.081,17,16,8606,8,6357,2150.0,1350.0,766.0,8,2249,2150.0,1350.0,253.0
0.006,6,10,2006,5,927,1.0,659.0,659.0,5,1079,1.0,811.0,811.0
0.016,6,10,1983,5,910,4.0,642.0,642.0,5,1073,4.0,805.0,805.0
0.005,6,12,1698,6,863,1.0,327.0,271.0,6,835,1.0,515.0,515.0
0.005,17,2,140,1,62,0.0,34.0,34.0,1,78,0.0,50.0,50.0
0.005,6,13,3747,7,509,0.0,137.0,137.0,6,3238,0.0,1470.0,1459.0
0.009,6,10,1677,5,827,2.0,559.0,559.0,5,850,2.0,582.0,582.0
0.005,6,10,2006,5,927,1.0,659.0,659.0,5,1079,1.0,811.0,811.0
0.012,6,10,1990,5,911,2.0,643.0,643.0,5,1079,3.0,811.0,811.0
240.014,6,9,787,5,488,60003.0,232.0,232.0,4,299,80003.0,83.0,83.0
0.011,6,10,1989,5,910,2.0,642.0,642.0,5,1079,2.0,811.0,811.0
0.005,6,13,3747,7,509,0.0,137.0,137.0,6,3238,1.0,1470.0,1459.0
0.006,6,10,2007,5,928,1.0,660.0,660.0,5,1079,1.0,811.0,811.0
0.006,6,12,1698,6,863,1.0,327.0,271.0,6,835,1.0,515.0,515.0
0.009,6,10,1983,5,910,2.0,642.0,642.0,5,1073,2.0,805.0,805.0
0.012,6,10,1762,5,911,3.0,643.0,643.0,5,851,3.0,583.0,583.0
0.176,6,10,1506,5,395,42.0,127.0,127.0,5,1111,42.0,843.0,843.0
0.088,6,10,1506,5,395,18.0,127.0,127.0,5,1111,18.0,843.0,843.0
66.043,6,27,17545,15,9603,4717.0,2804.0,1469.0,12,7942,5988.0,2313.0,1218.0
0.018,6,10,1990,5,911,4.0,643.0,643.0,5,1079,4.0,811.0,811.0
0.037,17,2,152,1,76,0.0,48.0,48.0,1,76,0.0,48.0,48.0
0.005,6,10,1689,5,839,1.0,571.0,571.0,5,850,1.0,582.0,582.0
0.006,6,10,1547,5,764,1.0,496.0,496.0,5,783,1.0,515.0,515.0
0.009,6,12,1926,6,1189,1.0,659.0,434.0,6,737,1.0,417.0,417.0
0.02,6,10,1990,5,911,4.0,643.0,643.0,5,1079,5.0,811.0,811.0
0.004,17,2,214,1,75,0.0,47.0,47.0,1,139,0.0,111.0,111.0
1770.727,6,79,4162,40,2107,45402.0,27.0,27.0,39,2055,46597.0,27.0,27.0
0.173,6,3,453,2,321,173.0,241.0,241.0,1,132,0.0,92.0,92.0
0.039,17,2,136,1,60,0.0,32.0,32.0,1,76,0.0,48.0,48.0
0.005,17,2,209,1,64,0.0,36.0,36.0,1,145,0.0,117.0,117.0
240.427,6,33,10018,16,2091,16026.0,539.0,250.0,17,7927,15024.0,1402.0,640.0
0.006,6,10,1547,5,764,1.0,496.0,496.0,5,783,1.0,515.0,515.0
309.087,17,20,1124,10,716,34328.0,48.0,43.0,10,408,34328.0,20.0,12.0
40.033,17,10,676,5,460,10007.0,104.0,64.0,5,216,10007.0,20.0,15.0
0.003,17,2,148,1,60,0.0,32.0,32.0,1,88,0.0,60.0,60.0
0.005,17,2,170,1,65,0.0,37.0,37.0,1,105,0.0,77.0,77.0
0.001,17,2,136,1,60,0.0,32.0,32.0,1,76,0.0,48.0,48.0
40.062,17,10,676,5,460,10014.0,104.0,64.0,5,216,10014.0,20.0,15.0
0.009,6,10,1677,5,827,2.0,559.0,559.0,5,850,2.0,582.0,582.0
0.064,6,10,1506,5,395,13.0,127.0,127.0,5,1111,15.0,843.0,843.0
0.081,6,10,1506,5,395,18.0,127.0,127.0,5,1111,17.0,843.0,843.0
366.959,6,21,1795,16,1030,24463.0,190.0,190.0,5,765,60014.0,464.0,248.0
0.006,6,10,1854,5,889,1.0,621.0,621.0,5,965,1.0,697.0,697.0
0.005,6,10,2007,5,928,1.0,660.0,660.0,5,1079,1.0,811.0,811.0
0.003,17,2,136,1,60,0.0,32.0,32.0,1,76,0.0,48.0,48.0
0.005,6,10,1689,5,839,1.0,571.0,571.0,5,850,1.0,582.0,582.0
0.005,6,10,2007,5,928,1.0,660.0,660.0,5,1079,1.0,811.0,811.0
1778.191,17,140,44240,71,22436,25398.0,288.0,288.0,69,21804,26148.0,288.0,288.0
0.005,6,10,2007,5,928,1.0,660.0,660.0,5,1079,1.0,811.0,811.0
1791.279,6,273,25437,137,8905,13171.0,747.0,295.0,136,16532,13268.0,1624.0,72.0
0.038,17,2,184,1,61,0.0,33.0,33.0,1,123,0.0,95.0,95.0
40.062,17,10,676,5,460,10014.0,104.0,64.0,5,216,10011.0,20.0,15.0
40.066,17,10,676,5,460,10013.0,104.0,64.0,5,216,10015.0,20.0,15.0
0.006,6,10,2000,5,927,1.0,659.0,659.0,5,1073,1.0,805.0,805.0
0.124,6,10,1506,5,395,27.0,127.0,127.0,5,1111,18.0,843.0,843.0
0.008,6,10,1989,5,910,2.0,642.0,642.0,5,1079,2.0,811.0,811.0
0.005,6,10,2006,5,927,1.0,659.0,659.0,5,1079,1.0,811.0,811.0
0.008,6,10,1989,5,910,2.0,642.0,642.0,5,1079,1.0,811.0,811.0
40.069,17,10,676,5,460,10016.0,104.0,64.0,5,216,10016.0,20.0,15.0
300.026,6,12,1782,7,1348,50004.0,494.0,494.0,5,434,75005.0,83.0,83.0
0.009,6,10,1983,5,910,2.0,642.0,642.0,5,1073,2.0,805.0,805.0
0.109,6,9,1172,5,458,27.0,190.0,190.0,4,714,19.0,465.0,249.0
0.007,6,10,2007,5,928,1.0,660.0,660.0,5,1079,1.0,811.0,811.0
361.814,6,19,1688,15,978,25843.0,190.0,190.0,4,710,80014.0,494.0,494.0
0.038,6,10,1990,5,911,9.0,643.0,643.0,5,1079,9.0,811.0,811.0
0.005,6,14,3742,7,452,0.0,80.0,80.0,7,3290,0.0,1448.0,972.0
0.082,6,10,1506,5,395,18.0,127.0,127.0,5,1111,19.0,843.0,843.0
240.11,6,32,9313,16,6757,16007.0,1828.0,658.0,16,2556,16007.0,580.0,214.0
0.004,6,10,2000,5,927,1.0,659.0,659.0,5,1073,1.0,805.0,805.0
0.086,6,10,1506,5,395,20.0,127.0,127.0,5,1111,20.0,843.0,843.0
0.099,6,10,1506,5,395,19.0,127.0,127.0,5,1111,23.0,843.0,843.0
0.023,6,10,1989,5,910,5.0,642.0,642.0,5,1079,5.0,811.0,811.0
0.04,17,4,420,2,122,0.0,33.0,33.0,2,298,36.0,145.0,121.0
165.034,17,70,9977,35,2338,4853.0,44.0,38.0,35,7639,4853.0,239.0,190.0
0.007,6,10,1989,5,927,1.0,659.0,659.0,5,1062,1.0,794.0,794.0
0.04,17,2,144,1,64,0.0,36.0,36.0,1,80,0.0,52.0,52.0
0.013,6,10,1762,5,911,3.0,643.0,643.0,5,851,3.0,583.0,583.0
369.68,58,6,432,4,288,123226.0,24.0,24.0,2,144,312619.0,24.0,24.0
0.014,6,10,1972,5,910,3.0,642.0,642.0,5,1062,3.0,794.0,794.0
0.001,17,2,180,1,66,0.0,38.0,38.0,1,114,0.0,86.0,86.0
0.015,6,10,1972,5,910,3.0,642.0,642.0,5,1062,3.0,794.0,794.0
0.011,6,10,1989,5,910,2.0,642.0,642.0,5,1079,2.0,811.0,811.0
0.004,6,10,1774,5,923,1.0,655.0,655.0,5,851,1.0,583.0,583.0
0.012,6,10,1990,5,911,3.0,643.0,643.0,5,1079,3.0,811.0,811.0
0.004,6,10,1989,5,927,1.0,659.0,659.0,5,1062,1.0,794.0,794.0
0.006,17,2,170,1,65,0.0,37.0,37.0,1,105,0.0,77.0,77.0
0.037,17,2,184,1,61,0.0,33.0,33.0,1,123,0.0,95.0,95.0
0.004,6,10,1989,5,927,1.0,659.0,659.0,5,1062,1.0,794.0,794.0
0.12,6,10,1506,5,395,26.0,127.0,127.0,5,1111,25.0,843.0,843.0
0.015,6,10,1631,5,848,3.0,580.0,580.0,5,783,3.0,515.0,515.0
0.008,6,10,1989,5,910,2.0,642.0,642.0,5,1079,1.0,811.0,811.0
40.062,17,10,676,5,460,10012.0,104.0,64.0,5,216,10014.0,20.0,15.0
0.021,6,10,1989,5,910,5.0,642.0,642.0,5,1079,5.0,811.0,811.0
0.009,6,10,1989,5,910,2.0,642.0,642.0,5,1079,2.0,811.0,811.0
0.012,6,10,1989,5,910,3.0,642.0,642.0,5,1079,2.0,811.0,811.0
0.092,6,10,1506,5,395,19.0,127.0,127.0,5,1111,21.0,843.0,843.0
0.013,6,10,1631,5,848,3.0,580.0,580.0,5,783,3.0,515.0,515.0
0.026,6,10,1983,5,910,6.0,642.0,642.0,5,1073,6.0,805.0,805.0
240.1,6,16,4482,9,963,30012.0,238.0,166.0,7,3519,40016.0,1402.0,786.0
0.011,6,10,1631,5,848,2.0,580.0,580.0,5,783,2.0,515.0,515.0
0.019,6,10,1989,5,910,4.0,642.0,642.0,5,1079,4.0,811.0,811.0
40.058,17,10,676,5,460,10013.0,104.0,64.0,5,216,10013.0,20.0,15.0
0.184,17,2,194,1,59,0.0,31.0,31.0,1,135,0.0,107.0,107.0
0.005,17,2,230,1,68,0.0,40.0,40.0,1,162,0.0,134.0,134.0
0.005,17,2,170,1,65,0.0,37.0,37.0,1,105,0.0,77.0,77.0
0.017,6,10,1983,5,910,4.0,642.0,642.0,5,1073,4.0,805.0,805.0
0.006,6,10,1547,5,764,1.0,496.0,496.0,5,783,1.0,515.0,515.0
0.093,6,10,1506,5,395,21.0,127.0,127.0,5,1111,21.0,843.0,843.0
0.004,6,10,1774,5,923,1.0,655.0,655.0,5,851,1.0,583.0,583.0
10.802,17,28,4417,14,1994,822.0,269.0,114.0,14,2423,822.0,586.0,145.0
0.01,6,10,1989,5,910,2.0,642.0,642.0,5,1079,2.0,811.0,811.0
0.001,17,2,180,1,66,0.0,38.0,38.0,1,114,0.0,86.0,86.0
0.001,17,2,174,1,72,0.0,44.0,44.0,1,102,0.0,74.0,74.0
0.022,6,10,1677,5,827,5.0,559.0,559.0,5,850,5.0,582.0,582.0
40.065,17,10,676,5,460,10015.0,104.0,64.0,5,216,10015.0,20.0,15.0
0.01,6,10,1989,5,910,2.0,642.0,642.0,5,1079,2.0,811.0,811.0
0.004,17,4,284,2,120,0.0,32.0,32.0,2,164,0.0,60.0,54.0
0.004,6,10,2006,5,927,1.0,659.0,659.0,5,1079,1.0,811.0,811.0
15.075,17,14,9191,8,6902,2149.0,1350.0,834.0,6,2289,3009.0,1350.0,353.0
0.006,6,10,1854,5,889,1.0,621.0,621.0,5,965,1.0,697.0,697.0
0.005,6,10,1779,5,928,1.0,660.0,660.0,5,851,1.0,583.0,583.0
0.04,17,2,152,1,76,0.0,48.0,48.0,1,76,0.0,48.0,48.0
0.102,6,10,1506,5,395,18.0,127.0,127.0,5,1111,23.0,843.0,843.0
15.072,17,15,9239,8,6902,2149.0,1350.0,834.0,7,2337,2507.0,1350.0,305.0
0.004,6,10,1989,5,927,1.0,659.0,659.0,5,1062,1.0,794.0,794.0
9.038,17,6,376,5,280,2259.0,28.0,28.0,1,96,0.0,68.0,68.0
0.008,6,10,2006,5,927,1.0,659.0,659.0,5,1079,2.0,811.0,811.0
273.789,6,26,5963,13,2965,22815.0,967.0,453.0,13,2998,22815.0,1162.0,385.0
0.004,6,10,1989,5,927,1.0,659.0,659.0,5,1062,1.0,794.0,794.0
0.011,6,10,1989,5,910,2.0,642.0,642.0,5,1079,2.0,811.0,811.0
0.005,6,10,2007,5,928,1.0,660.0,660.0,5,1079,1.0,811.0,811.0
0.076,6,10,1506,5,395,16.0,127.0,127.0,5,1111,17.0,843.0,843.0
0.086,6,10,1506,5,395,19.0,127.0,127.0,5,1111,18.0,843.0,843.0
0.013,6,10,1677,5,827,3.0,559.0,559.0,5,850,3.0,582.0,582.0
0.018,6,14,3787,7,497,3.0,125.0,125.0,7,3290,3.0,1448.0,972.0
0.005,6,10,2006,5,927,1.0,659.0,659.0,5,1079,1.0,811.0,811.0
0.014,6,10,1989,5,910,3.0,642.0,642.0,5,1079,3.0,811.0,811.0
0.006,6,10,1547,5,764,1.0,496.0,496.0,5,783,1.0,515.0,515.0
0.004,6,10,2007,5,928,1.0,660.0,660.0,5,1079,1.0,811.0,811.0
0.012,6,13,3735,7,497,2.0,125.0,125.0,6,3238,2.0,1470.0,1459.0
0.016,6,10,1972,5,910,3.0,642.0,642.0,5,1062,4.0,794.0,794.0
0.112,6,10,1506,5,395,23.0,127.0,127.0,5,1111,26.0,843.0,843.0
0.041,17,2,152,1,76,0.0,48.0,48.0,1,76,0.0,48.0,48.0
0.005,6,10,1989,5,927,1.0,659.0,659.0,5,1062,1.0,794.0,794.0
0.004,17,2,186,1,61,0.0,33.0,33.0,1,125,0.0,97.0,97.0
0.005,17,2,144,1,64,0.0,36.0,36.0,1,80,0.0,52.0,52.0
0.001,17,2,180,1,66,0.0,38.0,38.0,1,114,0.0,86.0,86.0
0.006,6,10,1689,5,839,1.0,571.0,571.0,5,850,1.0,582.0,582.0
11.309,17,28,4419,14,1994,855.0,269.0,114.0,14,2425,857.0,588.0,145.0
0.005,6,10,2000,5,927,1.0,659.0,659.0,5,1073,1.0,805.0,805.0
0.067,6,10,1506,5,395,16.0,127.0,127.0,5,1111,16.0,843.0,843.0
0.004,6,10,1702,5,863,0.0,595.0,595.0,5,839,1.0,571.0,571.0
0.142,6,10,1506,5,395,31.0,127.0,127.0,5,1111,30.0,843.0,843.0
0.013,17,2,152,1,56,0.0,28.0,28.0,1,96,0.0,68.0,68.0
412.254,6,29,4409,12,3102,10911.0,494.0,494.0,17,1307,25765.0,83.0,83.0
0.006,17,2,136,1,60,0.0,32.0,32.0,1,76,0.0,48.0,48.0
0.077,6,10,1506,5,395,16.0,127.0,127.0,5,1111,17.0,843.0,843.0
0.009,6,12,1926,6,1189,1.0,659.0,434.0,6,737,1.0,417.0,417.0
0.006,6,10,1547,5,764,1.0,496.0,496.0,5,783,1.0,515.0,515.0
0.007,17,2,299,1,65,0.0,37.0,37.0,1,234,0.0,206.0,206.0
0.074,6,10,1506,5,395,15.0,127.0,127.0,5,1111,17.0,843.0,843.0
0.013,6,10,1990,5,911,3.0,643.0,643.0,5,1079,3.0,811.0,811.0
0.015,6,10,1677,5,827,3.0,559.0,559.0,5,850,3.0,582.0,582.0
0.006,17,2,230,1,68,0.0,40.0,40.0,1,162,0.0,134.0,134.0
0.009,6,10,1677,5,827,2.0,559.0,559.0,5,850,2.0,582.0,582.0
0.012,6,10,1990,5,911,3.0,643.0,643.0,5,1079,3.0,811.0,811.0
1776.347,6,503,78106,282,41620,6321.0,1925.0,213.0,221,36486,8073.0,1533.0,161.0
0.004,6,10,1774,5,923,1.0,655.0,655.0,5,851,1.0,583.0,583.0
10.942,17,28,4422,14,1994,833.0,269.0,114.0,14,2428,833.0,587.0,145.0
351.988,6,20,2210,6,1308,12003.0,494.0,494.0,14,902,27075.0,83.0,83.0
0.005,6,10,2006,5,927,1.0,659.0,659.0,5,1079,1.0,811.0,811.0
0.007,6,10,1547,5,764,1.0,496.0,496.0,5,783,1.0,515.0,515.0
0.009,6,14,3787,7,497,1.0,125.0,125.0,7,3290,1.0,1448.0,972.0
0.151,17,4,352,2,130,111.0,37.0,37.0,2,222,144.0,89.0,83.0
169.248,17,82,11527,41,2735,4231.0,44.0,38.0,41,8792,4231.0,261.0,186.0
300.332,6,16,2170,9,684,37521.0,146.0,146.0,7,1486,50028.0,419.0,398.0
0.099,6,10,1506,5,395,19.0,127.0,127.0,5,1111,21.0,843.0,843.0
10.976,17,26,4079,13,2165,905.0,588.0,138.0,13,1914,905.0,269.0,119.0
40.077,17,10,676,5,460,10017.0,104.0,64.0,5,216,10018.0,20.0,15.0
0.006,6,10,1643,5,860,1.0,592.0,592.0,5,783,1.0,515.0,515.0
0.006,6,10,1689,5,839,1.0,571.0,571.0,5,850,1.0,582.0,582.0
0.005,6,10,2006,5,927,1.0,659.0,659.0,5,1079,1.0,811.0,811.0
0.005,17,2,169,1,62,0.0,34.0,34.0,1,107,0.0,79.0,79.0
0.024,6,10,1677,5,827,6.0,559.0,559.0,5,850,6.0,582.0,582.0
0.004,6,10,2007,5,928,1.0,660.0,660.0,5,1079,1.0,811.0,811.0
0.193,6,3,453,2,321,193.0,241.0,241.0,1,132,0.0,92.0,92.0
0.004,17,2,136,1,60,0.0,32.0,32.0,1,76,0.0,48.0,48.0
0.006,17,2,144,1,64,0.0,36.0,36.0,1,80,0.0,52.0,52.0
0.004,6,10,1702,5,863,1.0,595.0,595.0,5,839,0.0,571.0,571.0
0.01,6,10,1990,5,911,2.0,643.0,643.0,5,1079,2.0,811.0,811.0
0.006,6,10,1547,5,764,1.0,496.0,496.0,5,783,1.0,515.0,515.0
0.011,6,10,1972,5,910,2.0,642.0,642.0,5,1062,2.0,794.0,794.0
0.099,6,10,1506,5,395,22.0,127.0,127.0,5,1111,21.0,843.0,843.0
0.004,6,10,1702,5,863,1.0,595.0,595.0,5,839,1.0,571.0,571.0
0.007,17,2,179,1,71,0.0,43.0,43.0,1,108,0.0,80.0,80.0
40.063,17,10,676,5,460,10014.0,104.0,64.0,5,216,10014.0,20.0,15.0
0.078,6,10,1506,5,395,17.0,127.0,127.0,5,1111,15.0,843.0,843.0
0.008,6,10,1631,5,848,2.0,580.0,580.0,5,783,2.0,515.0,515.0
0.01,6,10,1983,5,910,2.0,642.0,642.0,5,1073,2.0,805.0,805.0
0.006,6,10,1547,5,764,1.0,496.0,496.0,5,783,1.0,515.0,515.0
0.001,17,2,180,1,66,0.0,38.0,38.0,1,114,0.0,86.0,86.0
0.088,6,10,1506,5,395,20.0,127.0,127.0,5,1111,18.0,843.0,843.0
0.095,6,10,1506,5,395,20.0,127.0,127.0,5,1111,22.0,843.0,843.0
0.015,6,10,1983,5,910,3.0,642.0,642.0,5,1073,3.0,805.0,805.0
0.005,17,2,136,1,60,0.0,32.0,32.0,1,76,0.0,48.0,48.0
1778.147,17,144,45504,72,22752,25044.0,288.0,288.0,72,22752,25044.0,288.0,288.0
0.001,17,2,180,1,66,0.0,38.0,38.0,1,114,0.0,86.0,86.0
0.001,17,2,180,1,66,0.0,38.0,38.0,1,114,0.0,86.0,86.0
0.077,17,2,182,1,65,0.0,37.0,37.0,1,117,0.0,89.0,89.0
0.005,6,14,3742,8,504,0.0,80.0,80.0,6,3238,0.0,1470.0,1459.0
0.005,6,10,2000,5,927,1.0,659.0,659.0,5,1073,1.0,805.0,805.0
0.086,6,10,1506,5,395,20.0,127.0,127.0,5,1111,20.0,843.0,843.0
0.005,17,2,169,1,62,0.0,34.0,34.0,1,107,0.0,79.0,79.0
0.006,6,10,1547,5,764,1.0,496.0,496.0,5,783,1.0,515.0,515.0
0.005,6,10,2007,5,928,1.0,660.0,660.0,5,1079,1.0,811.0,811.0
0.005,6,10,2007,5,928,1.0,660.0,660.0,5,1079,1.0,811.0,811.0
0.004,6,10,2006,5,927,1.0,659.0,659.0,5,1079,1.0,811.0,811.0
0.006,17,2,169,1,62,0.0,34.0,34.0,1,107,0.0,79.0,79.0
0.015,6,10,1989,5,910,3.0,642.0,642.0,5,1079,3.0,811.0,811.0
15.079,17,15,8176,8,5981,2150.0,1350.0,719.0,7,2195,2508.0,1350.0,285.0
0.012,6,10,1990,5,911,3.0,643.0,643.0,5,1079,2.0,811.0,811.0
0.011,6,14,3787,7,497,1.0,125.0,125.0,7,3290,1.0,1448.0,972.0
0.005,6,14,3742,7,452,0.0,80.0,80.0,7,3290,0.0,1448.0,972.0
0.089,6,10,1506,5,395,20.0,127.0,127.0,5,1111,18.0,843.0,843.0
0.006,17,2,169,1,62,0.0,34.0,34.0,1,107,0.0,79.0,79.0
0.112,6,10,1506,5,395,26.0,127.0,127.0,5,1111,23.0,843.0,843.0
0.004,17,4,284,2,120,1.0,32.0,32.0,2,164,1.0,60.0,54.0
0.039,17,4,284,2,120,0.0,32.0,32.0,2,164,36.0,60.0,54.0
0.186,17,4,352,2,130,144.0,37.0,37.0,2,222,144.0,89.0,83.0
0.006,6,10,1547,5,764,1.0,496.0,496.0,5,783,1.0,515.0,515.0
0.005,17,2,170,1,65,0.0,37.0,37.0,1,105,0.0,77.0,77.0
0.012,6,10,1983,5,910,3.0,642.0,642.0,5,1073,3.0,805.0,805.0
0.004,6,10,2007,5,928,1.0,660.0,660.0,5,1079,1.0,811.0,811.0
0.001,17,2,180,1,66,0.0,38.0,38.0,1,114,0.0,86.0,86.0
0.005,6,10,2006,5,927,1.0,659.0,659.0,5,1079,1.0,811.0,811.0
0.038,17,2,184,1,61,0.0,33.0,33.0,1,123,0.0,95.0,95.0
1769.247,17,92,8096,46,4048,39316.0,60.0,60.0,46,4048,39316.0,60.0,60.0
0.006,6,10,1989,5,927,1.0,659.0,659.0,5,1062,1.0,794.0,794.0
0.005,6,14,3736,7,446,0.0,74.0,74.0,7,3290,0.0,1448.0,972.0
0.039,17,2,152,1,76,0.0,48.0,48.0,1,76,0.0,48.0,48.0
0.016,6,10,1972,5,910,4.0,642.0,642.0,5,1062,3.0,794.0,794.0
0.122,6,10,1506,5,395,27.0,127.0,127.0,5,1111,25.0,843.0,843.0
0.004,17,2,136,1,60,0.0,32.0,32.0,1,76,0.0,48.0,48.0
0.004,17,2,148,1,60,0.0,32.0,32.0,1,88,0.0,60.0,60.0
0.005,6,10,2006,5,927,1.0,659.0,659.0,5,1079,1.0,811.0,811.0
0.037,17,2,144,1,64,0.0,36.0,36.0,1,80,0.0,52.0,52.0
0.005,17,2,164,1,74,0.0,46.0,46.0,1,90,0.0,62.0,62.0
0.012,6,10,1972,5,910,3.0,642.0,642.0,5,1062,2.0,794.0,794.0
0.008,6,10,1989,5,910,1.0,642.0,642.0,5,1079,1.0,811.0,811.0
40.068,17,10,676,5,460,10016.0,104.0,64.0,5,216,10016.0,20.0,15.0
177.195,17,92,13382,46,3099,3937.0,44.0,39.0,46,10283,3937.0,261.0,195.0
0.005,6,10,2007,5,928,1.0,660.0,660.0,5,1079,1.0,811.0,811.0
0.023,6,13,3816,7,578,3.0,206.0,206.0,6,3238,4.0,1470.0,1459.0
0.018,6,10,1990,5,911,4.0,643.0,643.0,5,1079,4.0,811.0,811.0
240.154,6,16,4481,9,963,30019.0,238.0,166.0,7,3518,40020.0,1402.0,786.0
0.162,6,10,1506,5,395,39.0,127.0,127.0,5,1111,29.0,843.0,843.0
0.107,6,10,1506,5,395,25.0,127.0,127.0,5,1111,26.0,843.0,843.0
0.014,6,10,1990,5,911,3.0,643.0,643.0,5,1079,3.0,811.0,811.0
0.008,6,12,1926,6,1189,1.0,659.0,434.0,6,737,1.0,417.0,417.0
0.005,6,10,1989,5,927,1.0,659.0,659.0,5,1062,1.0,794.0,794.0
11.183,17,28,4420,14,1993,848.0,268.0,114.0,14,2427,847.0,586.0,145.0
311.433,17,20,1124,10,716,34590.0,48.0,43.0,10,408,34590.0,20.0,12.0
0.001,17,2,180,1,66,0.0,38.0,38.0,1,114,0.0,86.0,86.0
0.007,6,10,1990,5,911,1.0,643.0,643.0,5,1079,1.0,811.0,811.0
0.084,6,10,1506,5,395,19.0,127.0,127.0,5,1111,19.0,843.0,843.0
0.001,17,2,180,1,66,0.0,38.0,38.0,1,114,0.0,86.0,86.0
0.007,6,10,1547,5,764,1.0,496.0,496.0,5,783,1.0,515.0,515.0
0.01,6,10,1990,5,911,2.0,643.0,643.0,5,1079,2.0,811.0,811.0
0.006,17,2,170,1,65,0.0,37.0,37.0,1,105,0.0,77.0,77.0
0.011,6,10,1677,5,827,2.0,559.0,559.0,5,850,2.0,582.0,582.0
0.012,6,10,1990,5,911,3.0,643.0,643.0,5,1079,2.0,811.0,811.0
0.08,17,2,144,1,64,0.0,36.0,36.0,1,80,0.0,52.0,52.0
0.02,6,10,1989,5,910,4.0,642.0,642.0,5,1079,4.0,811.0,811.0
0.001,17,2,136,1,60,0.0,32.0,32.0,1,76,0.0,48.0,48.0
15.076,17,15,8558,8,6309,2149.0,1350.0,760.0,7,2249,2507.0,1350.0,293.0
0.005,17,2,164,1,74,0.0,46.0,46.0,1,90,0.0,62.0,62.0
0.005,6,10,1702,5,863,1.0,595.0,595.0,5,839,1.0,571.0,571.0
0.003,17,2,144,1,64,0.0,36.0,36.0,1,80,0.0,52.0,52.0
170.066,17,80,11546,40,2670,4360.0,44.0,38.0,40,8876,4360.0,252.0,193.0
300.458,6,28,9138,17,1632,18778.0,370.0,182.0,11,7506,24040.0,2804.0,989.0
0.097,6,10,1506,5,395,20.0,127.0,127.0,5,1111,19.0,843.0,843.0
312.232,17,20,1124,10,716,34678.0,48.0,43.0,10,408,34678.0,20.0,12.0
0.006,6,10,1643,5,860,1.0,592.0,592.0,5,783,1.0,515.0,515.0
0.004,6,10,1989,5,927,1.0,659.0,659.0,5,1062,1.0,794.0,794.0
0.02,6,10,1631,5,848,5.0,580.0,580.0,5,783,4.0,515.0,515.0
0.005,6,10,2006,5,927,1.0,659.0,659.0,5,1079,1.0,811.0,811.0
40.062,17,10,676,5,460,10014.0,104.0,64.0,5,216,10014.0,20.0,15.0
0.1,6,10,1506,5,395,20.0,127.0,127.0,5,1111,23.0,843.0,843.0
0.041,17,2,152,1,76,0.0,48.0,48.0,1,76,0.0,48.0,48.0
0.039,17,4,284,2,120,0.0,32.0,32.0,2,164,35.0,60.0,54.0
0.005,6,10,2006,5,927,1.0,659.0,659.0,5,1079,1.0,811.0,811.0
0.005,6,10,2006,5,927,1.0,659.0,659.0,5,1079,1.0,811.0,811.0
0.037,17,2,412,1,61,0.0,33.0,33.0,1,351,0.0,323.0,323.0
0.007,6,10,1547,5,764,1.0,496.0,496.0,5,783,1.0,515.0,515.0
0.005,6,10,1989,5,927,1.0,659.0,659.0,5,1062,1.0,794.0,794.0
0.006,6,10,1689,5,839,1.0,571.0,571.0,5,850,1.0,582.0,582.0
0.009,6,13,3735,7,497,1.0,125.0,125.0,6,3238,1.0,1470.0,1459.0
0.073,6,10,1506,5,395,16.0,127.0,127.0,5,1111,16.0,843.0,843.0
0.008,6,10,1989,5,927,1.0,659.0,659.0,5,1062,2.0,794.0,794.0
0.068,6,10,1506,5,395,15.0,127.0,127.0,5,1111,15.0,843.0,843.0
0.005,17,2,154,1,69,0.0,41.0,41.0,1,85,0.0,57.0,57.0
0.034,17,2,152,1,68,0.0,40.0,40.0,1,84,0.0,56.0,56.0
0.005,6,10,2006,5,927,1.0,659.0,659.0,5,1079,1.0,811.0,811.0
308.42,17,20,1124,10,716,34255.0,48.0,43.0,10,408,34255.0,20.0,12.0
0.125,6,10,1506,5,395,27.0,127.0,127.0,5,1111,23.0,843.0,843.0
0.018,6,10,1989,5,910,4.0,642.0,642.0,5,1079,4.0,811.0,811.0
0.014,6,10,1677,5,827,3.0,559.0,559.0,5,850,3.0,582.0,582.0
0.005,6,10,2000,5,927,1.0,659.0,659.0,5,1073,1.0,805.0,805.0
0.168,17,2,152,1,76,0.0,48.0,48.0,1,76,0.0,48.0,48.0
0.016,6,10,1990,5,911,4.0,643.0,643.0,5,1079,3.0,811.0,811.0
254.489,6,39,11504,17,2017,15905.0,606.0,160.0,22,9487,12118.0,2222.0,555.0
0.019,6,10,1631,5,848,4.0,580.0,580.0,5,783,4.0,515.0,515.0
0.166,17,2,152,1,76,0.0,48.0,48.0,1,76,0.0,48.0,48.0
0.053,17,2,152,1,76,0.0,48.0,48.0,1,76,0.0,48.0,48.0
0.005,6,10,1547,5,764,1.0,496.0,496.0,5,783,1.0,515.0,515.0
10.888,17,28,4421,14,1994,829.0,269.0,114.0,14,2427,829.0,586.0,145.0
0.004,6,10,1989,5,927,1.0,659.0,659.0,5,1062,1.0,794.0,794.0
0.039,17,2,184,1,61,0.0,33.0,33.0,1,123,0.0,95.0,95.0
0.043,17,4,284,2,120,0.0,32.0,32.0,2,164,39.0,60.0,54.0
0.043,17,2,144,1,64,0.0,36.0,36.0,1,80,0.0,52.0,52.0
0.011,6,10,1631,5,848,2.0,580.0,580.0,5,783,2.0,515.0,515.0
0.003,17,2,234,1,61,0.0,33.0,33.0,1,173,0.0,145.0,145.0
0.004,17,4,284,2,120,1.0,32.0,32.0,2,164,0.0,60.0,54.0
300.306,6,30,10802,16,5010,20020.0,1368.0,595.0,14,5792,23100.0,1655.0,844.0
0.012,6,10,1990,5,911,3.0,643.0,643.0,5,1079,2.0,811.0,811.0
0.005,6,10,1689,5,839,1.0,571.0,571.0,5,850,1.0,582.0,582.0
1756.068,6,105,6270,60,3525,29763.0,27.0,27.0,45,2745,39909.0,27.0,27.0
0.013,17,2,230,1,68,0.0,40.0,40.0,1,162,0.0,134.0,134.0
0.004,6,10,2006,5,927,1.0,659.0,659.0,5,1079,1.0,811.0,811.0
0.016,6,10,1989,5,910,4.0,642.0,642.0,5,1079,4.0,811.0,811.0
0.091,6,10,1506,5,395,18.0,127.0,127.0,5,1111,22.0,843.0,843.0
0.006,6,10,1547,5,764,1.0,496.0,496.0,5,783,1.0,515.0,515.0
0.011,6,10,1972,5,910,2.0,642.0,642.0,5,1062,2.0,794.0,794.0
0.048,6,14,3787,7,497,8.0,125.0,125.0,7,3290,7.0,1448.0,972.0
0.011,6,10,1972,5,910,2.0,642.0,642.0,5,1062,2.0,794.0,794.0
0.005,6,10,2007,5,928,1.0,660.0,660.0,5,1079,1.0,811.0,811.0
0.005,17,2,136,1,60,0.0,32.0,32.0,1,76,0.0,48.0,48.0
0.173,6,10,1506,5,395,41.0,127.0,127.0,5,1111,42.0,843.0,843.0
0.068,17,8,3613,4,1874,22.0,1350.0,440.0,4,1739,11.0,1350.0,406.0
0.008,6,10,1689,5,839,2.0,571.0,571.0,5,850,1.0,582.0,582.0
0.011,6,10,1972,5,910,2.0,642.0,642.0,5,1062,2.0,794.0,794.0
0.015,6,13,3735,7,497,2.0,125.0,125.0,6,3238,2.0,1470.0,1459.0
0.012,6,13,3735,7,497,2.0,125.0,125.0,6,3238,2.0,1470.0,1459.0
0.005,6,10,1643,5,860,1.0,592.0,592.0,5,783,1.0,515.0,515.0
0.001,17,2,180,1,66,0.0,38.0,38.0,1,114,0.0,86.0,86.0
11.232,17,28,4421,14,1993,851.0,268.0,114.0,14,2428,851.0,587.0,145.0
0.043,17,4,284,2,120,6.0,32.0,32.0,2,164,40.0,60.0,54.0
40.059,17,10,676,5,460,10011.0,104.0,64.0,5,216,10013.0,20.0,15.0
0.005,6,10,2007,5,928,1.0,660.0,660.0,5,1079,1.0,811.0,811.0
10.896,17,26,4098,13,1822,899.0,269.0,112.0,13,2276,899.0,587.0,147.0
0.103,6,10,1506,5,395,21.0,127.0,127.0,5,1111,23.0,843.0,843.0
40.053,17,10,676,5,460,10012.0,104.0,64.0,5,216,10012.0,20.0,15.0
0.13,6,10,1506,5,395,31.0,127.0,127.0,5,1111,30.0,843.0,843.0
0.054,17,2,152,1,76,0.0,48.0,48.0,1,76,0.0,48.0,48.0
0.01,6,10,1983,5,910,2.0,642.0,642.0,5,1073,2.0,805.0,805.0
0.013,6,10,1762,5,911,3.0,643.0,643.0,5,851,3.0,583.0,583.0
0.022,6,10,1972,5,910,5.0,642.0,642.0,5,1062,5.0,794.0,794.0
0.006,6,10,1547,5,764,1.0,496.0,496.0,5,783,1.0,515.0,515.0
0.02,6,10,1631,5,848,5.0,580.0,580.0,5,783,5.0,515.0,515.0
0.005,6,10,2006,5,927,1.0,659.0,659.0,5,1079,1.0,811.0,811.0
0.124,6,10,1506,5,395,30.0,127.0,127.0,5,1111,25.0,843.0,843.0
0.004,6,10,1774,5,923,1.0,655.0,655.0,5,851,1.0,583.0,583.0
0.006,6,10,2000,5,927,1.0,659.0,659.0,5,1073,1.0,805.0,805.0
0.004,17,2,136,1,60,0.0,32.0,32.0,1,76,0.0,48.0,48.0
40.063,17,10,676,5,460,10014.0,104.0,64.0,5,216,10015.0,20.0,15.0
10.847,17,28,4421,14,1993,826.0,268.0,114.0,14,2428,825.0,587.0,145.0
0.601,17,2,142,1,63,0.0,35.0,35.0,1,79,0.0,51.0,51.0
0.079,6,10,1506,5,395,17.0,127.0,127.0,5,1111,16.0,843.0,843.0
0.003,17,2,656,1,328,0.0,300.0,300.0,1,328,0.0,300.0,300.0
15.069,17,15,9239,8,6902,2148.0,1350.0,834.0,7,2337,2506.0,1350.0,305.0
0.028,6,10,1983,5,910,6.0,642.0,642.0,5,1073,7.0,805.0,805.0
0.078,6,10,1506,5,395,17.0,127.0,127.0,5,1111,13.0,843.0,843.0
0.013,6,10,1972,5,910,3.0,642.0,642.0,5,1062,3.0,794.0,794.0
0.004,6,10,1702,5,863,1.0,595.0,595.0,5,839,1.0,571.0,571.0
15.078,17,19,10122,9,6968,1881.0,1350.0,746.0,10,3154,1672.0,1350.0,287.0
0.022,6,13,3735,7,497,3.0,125.0,125.0,6,3238,4.0,1470.0,1459.0
0.004,17,2,148,1,60,0.0,32.0,32.0,1,88,0.0,60.0,60.0
0.138,6,10,1506,5,395,28.0,127.0,127.0,5,1111,31.0,843.0,843.0
0.005,6,10,1689,5,839,1.0,571.0,571.0,5,850,1.0,582.0,582.0
0.016,6,10,1762,5,911,4.0,643.0,643.0,5,851,3.0,583.0,583.0
0.123,6,10,1506,5,395,24.0,127.0,127.0,5,1111,24.0,843.0,843.0
0.006,6,10,1689,5,839,1.0,571.0,571.0,5,850,1.0,582.0,582.0
40.052,17,10,676,5,460,10012.0,104.0,64.0,5,216,10012.0,20.0,15.0
0.004,6,10,2006,5,927,1.0,659.0,659.0,5,1079,1.0,811.0,811.0
0.016,6,10,1972,5,910,4.0,642.0,642.0,5,1062,3.0,794.0,794.0
0.005,6,10,2006,5,927,1.0,659.0,659.0,5,1079,1.0,811.0,811.0
0.006,6,10,2006,5,927,1.0,659.0,659.0,5,1079,1.0,811.0,811.0
0.122,6,10,1506,5,395,29.0,127.0,127.0,5,1111,25.0,843.0,843.0
0.001,17,2,166,1,75,0.0,47.0,47.0,1,91,0.0,63.0,63.0
0.005,6,10,2006,5,927,1.0,659.0,659.0,5,1079,1.0,811.0,811.0
0.016,6,10,1990,5,911,4.0,643.0,643.0,5,1079,3.0,811.0,811.0
0.011,6,10,1989,5,910,2.0,642.0,642.0,5,1079,2.0,811.0,811.0
0.106,6,10,1506,5,395,22.0,127.0,127.0,5,1111,22.0,843.0,843.0
0.006,6,10,1547,5,764,1.0,496.0,496.0,5,783,1.0,515.0,515.0
11.556,17,28,4395,14,2313,876.0,588.0,137.0,14,2082,876.0,269.0,120.0
0.006,6,10,1547,5,764,1.0,496.0,496.0,5,783,1.0,515.0,515.0
0.005,6,10,1989,5,927,1.0,659.0,659.0,5,1062,1.0,794.0,794.0
0.003,17,2,136,1,60,0.0,32.0,32.0,1,76,0.0,48.0,48.0
40.071,17,10,676,5,460,10015.0,104.0,64.0,5,216,10017.0,20.0,15.0
0.076,6,10,1506,5,395,16.0,127.0,127.0,5,1111,18.0,843.0,843.0
0.013,6,10,1631,5,848,3.0,580.0,580.0,5,783,3.0,515.0,515.0
0.005,6,10,2006,5,927,1.0,659.0,659.0,5,1079,1.0,811.0,811.0
241.576,6,395,348593,191,21456,1271.0,2736.0,959.0,204,327137,1190.0,2804.0,1631.0
0.004,6,10,2000,5,927,1.0,659.0,659.0,5,1073,1.0,805.0,805.0
0.007,6,10,2006,5,927,1.0,659.0,659.0,5,1079,1.0,811.0,811.0
0.009,6,12,1926,6,1189,1.0,659.0,434.0,6,737,1.0,417.0,417.0
0.022,6,13,3735,7,497,3.0,125.0,125.0,6,3238,4.0,1470.0,1459.0
0.087,6,10,1506,5,395,15.0,127.0,127.0,5,1111,20.0,843.0,843.0
0.12,6,10,1506,5,395,25.0,127.0,127.0,5,1111,26.0,843.0,843.0
0.005,17,2,166,1,75,0.0,47.0,47.0,1,91,0.0,63.0,63.0
0.097,6,10,1506,5,395,23.0,127.0,127.0,5,1111,22.0,843.0,843.0
0.005,6,10,2006,5,927,1.0,659.0,659.0,5,1079,1.0,811.0,811.0
0.217,6,16,2778,8,1396,31.0,533.0,324.0,8,1382,20.0,529.0,239.0
0.005,6,10,2007,5,928,1.0,660.0,660.0,5,1079,1.0,811.0,811.0
0.039,17,4,420,2,122,0.0,33.0,33.0,2,298,35.0,145.0,121.0
1781.195,6,65,7412,43,4536,42409.0,1402.0,104.0,22,2876,84810.0,1112.0,82.0
0.014,6,10,1990,5,911,3.0,643.0,643.0,5,1079,3.0,811.0,811.0
0.004,17,4,284,2,120,0.0,32.0,32.0,2,164,1.0,60.0,54.0
0.008,17,2,194,1,59,0.0,31.0,31.0,1,135,0.0,107.0,107.0
0.005,6,10,2000,5,927,1.0,659.0,659.0,5,1073,1.0,805.0,805.0
0.009,6,12,1926,6,1189,1.0,659.0,434.0,6,737,1.0,417.0,417.0
174.262,17,74,10358,37,2457,4840.0,44.0,38.0,37,7901,4840.0,239.0,185.0
0.005,6,10,2006,5,927,1.0,659.0,659.0,5,1079,1.0,811.0,811.0
40.054,17,10,676,5,460,10012.0,104.0,64.0,5,216,10012.0,20.0,15.0
0.086,6,10,1506,5,395,18.0,127.0,127.0,5,1111,18.0,843.0,843.0
40.075,17,10,676,5,460,10017.0,104.0,64.0,5,216,10017.0,20.0,15.0
1.057,6,12,3142,6,2099,159.0,1328.0,923.0,6,1043,159.0,791.0,791.0
0.075,6,10,1506,5,395,17.0,127.0,127.0,5,1111,16.0,843.0,843.0
40.058,17,10,676,5,460,10013.0,104.0,64.0,5,216,10012.0,20.0,15.0
0.016,6,10,1990,5,911,3.0,643.0,643.0,5,1079,4.0,811.0,811.0
0.005,17,2,282,1,69,0.0,41.0,41.0,1,213,0.0,185.0,185.0
163.364,17,80,11266,40,2660,4188.0,44.0,38.0,40,8606,4188.0,261.0,187.0
0.004,6,10,2007,5,928,1.0,660.0,660.0,5,1079,1.0,811.0,811.0
0.022,6,10,1989,5,910,5.0,642.0,642.0,5,1079,5.0,811.0,811.0
0.005,6,10,2006,5,927,1.0,659.0,659.0,5,1079,1.0,811.0,811.0
0.023,6,10,1677,5,827,5.0,559.0,559.0,5,850,5.0,582.0,582.0
0.086,6,10,1506,5,395,19.0,127.0,127.0,5,1111,17.0,843.0,843.0
40.05,17,10,676,5,460,10011.0,104.0,64.0,5,216,10011.0,20.0,15.0
0.021,6,10,1990,5,911,5.0,643.0,643.0,5,1079,5.0,811.0,811.0
0.004,6,10,2006,5,927,1.0,659.0,659.0,5,1079,1.0,811.0,811.0
65.882,6,22,10152,12,3985,5989.0,1591.0,838.0,10,6167,7301.0,2111.0,939.0
9.035,17,6,376,5,280,2258.0,28.0,28.0,1,96,0.0,68.0,68.0
0.004,6,10,2000,5,927,1.0,659.0,659.0,5,1073,1.0,805.0,805.0
0.013,6,10,1990,5,911,3.0,643.0,643.0,5,1079,3.0,811.0,811.0
0.009,6,10,1989,5,910,2.0,642.0,642.0,5,1079,2.0,811.0,811.0
0.004,6,10,1989,5,927,1.0,659.0,659.0,5,1062,1.0,794.0,794.0
0.016,6,10,1972,5,910,3.0,642.0,642.0,5,1062,4.0,794.0,794.0
0.005,6,10,2007,5,928,1.0,660.0,660.0,5,1079,1.0,811.0,811.0
0.008,6,10,1677,5,827,2.0,559.0,559.0,5,850,2.0,582.0,582.0
0.01,6,10,1631,5,848,2.0,580.0,580.0,5,783,2.0,515.0,515.0
0.044,17,2,152,1,76,0.0,48.0,48.0,1,76,0.0,48.0,48.0
0.003,17,2,148,1,60,0.0,32.0,32.0,1,88,0.0,60.0,60.0
0.02,6,10,1631,5,848,5.0,580.0,580.0,5,783,4.0,515.0,515.0
0.005,17,2,166,1,75,0.0,47.0,47.0,1,91,0.0,63.0,63.0
0.013,6,10,1983,5,910,3.0,642.0,642.0,5,1073,3.0,805.0,805.0
0.01,6,10,1972,5,910,2.0,642.0,642.0,5,1062,2.0,794.0,794.0
308.844,17,20,1124,10,716,34301.0,48.0,43.0,10,408,34301.0,20.0,12.0
0.009,6,10,1989,5,910,2.0,642.0,642.0,5,1079,2.0,811.0,811.0
0.072,17,4,364,2,160,0.0,52.0,52.0,2,204,34.0,80.0,74.0
0.004,17,2,234,1,61,0.0,33.0,33.0,1,173,0.0,145.0,145.0
0.018,17,4,284,2,120,0.0,32.0,32.0,2,164,0.0,60.0,54.0
0.005,6,10,2006,5,927,1.0,659.0,659.0,5,1079,1.0,811.0,811.0
0.006,6,10,1779,5,928,1.0,660.0,660.0,5,851,1.0,583.0,583.0
0.005,6,10,2006,5,927,1.0,659.0,659.0,5,1079,1.0,811.0,811.0
0.005,6,10,2000,5,927,1.0,659.0,659.0,5,1073,1.0,805.0,805.0
0.008,6,10,1990,5,911,2.0,643.0,643.0,5,1079,2.0,811.0,811.0
0.056,17,2,179,1,71,0.0,43.0,43.0,1,108,0.0,80.0,80.0
0.075,6,10,1506,5,395,16.0,127.0,127.0,5,1111,18.0,843.0,843.0
0.004,6,10,2007,5,928,1.0,660.0,660.0,5,1079,1.0,811.0,811.0
0.009,6,10,1972,5,910,2.0,642.0,642.0,5,1062,2.0,794.0,794.0
0.124,17,2,136,1,60,0.0,32.0,32.0,1,76,0.0,48.0,48.0
0.004,6,10,1702,5,863,1.0,595.0,595.0,5,839,0.0,571.0,571.0
0.015,6,10,1972,5,910,3.0,642.0,642.0,5,1062,3.0,794.0,794.0
0.167,6,10,1506,5,395,40.0,127.0,127.0,5,1111,40.0,843.0,843.0
10.81,17,28,4423,14,1994,823.0,269.0,114.0,14,2429,823.0,588.0,145.0
0.005,6,10,2006,5,927,1.0,659.0,659.0,5,1079,1.0,811.0,811.0
0.005,17,2,169,1,62,0.0,34.0,34.0,1,107,0.0,79.0,79.0
0.005,6,10,2007,5,928,1.0,660.0,660.0,5,1079,1.0,811.0,811.0
0.005,6,10,2007,5,928,1.0,660.0,660.0,5,1079,1.0,811.0,811.0
0.006,6,10,1547,5,764,1.0,496.0,496.0,5,783,1.0,515.0,515.0
0.011,6,10,1972,5,910,2.0,642.0,642.0,5,1062,2.0,794.0,794.0
0.147,6,10,1506,5,395,33.0,127.0,127.0,5,1111,30.0,843.0,843.0
0.004,6,10,1774,5,923,1.0,655.0,655.0,5,851,1.0,583.0,583.0
0.108,6,10,1506,5,395,24.0,127.0,127.0,5,1111,23.0,843.0,843.0
0.147,6,23,7223,13,3253,11.0,1402.0,428.0,10,3970,14.0,1324.0,688.0
0.005,6,10,1989,5,927,1.0,659.0,659.0,5,1062,1.0,794.0,794.0
0.072,6,10,1506,5,395,15.0,127.0,127.0,5,1111,16.0,843.0,843.0
314.439,17,20,1124,10,716,34930.0,48.0,43.0,10,408,34931.0,20.0,12.0
40.07,17,10,676,5,460,10015.0,104.0,64.0,5,216,10016.0,20.0,15.0
0.004,17,2,136,1,60,0.0,32.0,32.0,1,76,0.0,48.0,48.0
0.006,6,10,1643,5,860,1.0,592.0,592.0,5,783,1.0,515.0,515.0
0.005,6,10,2006,5,927,1.0,659.0,659.0,5,1079,1.0,811.0,811.0
0.018,6,10,1989,5,910,4.0,642.0,642.0,5,1079,4.0,811.0,811.0
0.011,6,10,1972,5,910,2.0,642.0,642.0,5,1062,2.0,794.0,794.0
0.008,6,10,1972,5,910,2.0,642.0,642.0,5,1062,2.0,794.0,794.0
240.111,6,16,4480,9,963,30013.0,238.0,166.0,7,3517,40018.0,1402.0,786.0
0.005,6,10,2006,5,927,1.0,659.0,659.0,5,1079,1.0,811.0,811.0
10.842,17,28,4424,14,1995,825.0,270.0,114.0,14,2429,825.0,588.0,145.0
0.004,17,2,136,1,60,0.0,32.0,32.0,1,76,0.0,48.0,48.0
0.004,17,2,136,1,60,0.0,32.0,32.0,1,76,0.0,48.0,48.0
0.005,6,10,1774,5,923,1.0,655.0,655.0,5,851,1.0,583.0,583.0
0.066,6,10,1506,5,395,14.0,127.0,127.0,5,1111,14.0,843.0,843.0
0.01,6,10,1989,5,910,2.0,642.0,642.0,5,1079,2.0,811.0,811.0
0.095,6,10,1506,5,395,22.0,127.0,127.0,5,1111,20.0,843.0,843.0
0.005,6,10,1702,5,863,1.0,595.0,595.0,5,839,1.0,571.0,571.0
0.01,17,2,157,1,59,0.0,31.0,31.0,1,98,0.0,70.0,70.0
0.109,6,10,1506,5,395,22.0,127.0,127.0,5,1111,24.0,843.0,843.0
0.087,6,10,1506,5,395,20.0,127.0,127.0,5,1111,19.0,843.0,843.0
0.005,6,10,1689,5,839,1.0,571.0,571.0,5,850,1.0,582.0,582.0
0.079,6,10,1506,5,395,16.0,127.0,127.0,5,1111,17.0,843.0,843.0
0.135,17,4,596,2,122,0.0,33.0,33.0,2,474,61.0,323.0,209.0
0.081,6,10,1506,5,395,18.0,127.0,127.0,5,1111,17.0,843.0,843.0
0.004,17,2,152,1,76,0.0,48.0,48.0,1,76,0.0,48.0,48.0
0.009,6,10,1972,5,910,2.0,642.0,642.0,5,1062,2.0,794.0,794.0
0.005,6,10,2007,5,928,1.0,660.0,660.0,5,1079,1.0,811.0,811.0
62.054,6,28,17681,14,9540,4773.0,2804.0,1469.0,14,8141,4764.0,2315.0,822.0
0.005,6,10,2000,5,927,1.0,659.0,659.0,5,1073,1.0,805.0,805.0
0.073,6,10,1506,5,395,16.0,127.0,127.0,5,1111,16.0,843.0,843.0
0.004,17,2,136,1,60,0.0,32.0,32.0,1,76,0.0,48.0,48.0
0.005,6,14,3799,7,509,0.0,137.0,137.0,7,3290,0.0,1448.0,972.0
0.117,6,10,1506,5,395,26.0,127.0,127.0,5,1111,26.0,843.0,843.0
0.006,6,10,1547,5,764,1.0,496.0,496.0,5,783,1.0,515.0,515.0
240.275,6,44,8825,23,5790,10921.0,1368.0,458.0,21,3035,12013.0,580.0,241.0
177.147,17,86,11484,43,2853,4217.0,44.0,38.0,43,8631,4217.0,260.0,172.0
0.005,6,10,2006,5,927,1.0,659.0,659.0,5,1079,1.0,811.0,811.0
40.057,17,10,676,5,460,10011.0,104.0,64.0,5,216,10013.0,20.0,15.0
0.073,6,10,1506,5,395,15.0,127.0,127.0,5,1111,16.0,843.0,843.0
0.006,6,10,1689,5,839,1.0,571.0,571.0,5,850,1.0,582.0,582.0
0.006,17,2,170,1,65,0.0,37.0,37.0,1,105,0.0,77.0,77.0
0.005,6,10,1989,5,927,1.0,659.0,659.0,5,1062,1.0,794.0,794.0
0.004,17,2,148,1,60,0.0,32.0,32.0,1,88,0.0,60.0,60.0
0.06,17,2,80,1,32,0.0,4.0,4.0,1,48,0.0,20.0,20.0
0.005,6,10,2006,5,927,1.0,659.0,659.0,5,1079,1.0,811.0,811.0
0.058,6,10,1506,5,395,12.0,127.0,127.0,5,1111,12.0,843.0,843.0
0.007,6,10,1983,5,910,1.0,642.0,642.0,5,1073,1.0,805.0,805.0
0.089,6,10,1506,5,395,18.0,127.0,127.0,5,1111,20.0,843.0,843.0
0.004,6,10,2006,5,927,1.0,659.0,659.0,5,1079,1.0,811.0,811.0
0.014,6,10,1983,5,910,3.0,642.0,642.0,5,1073,3.0,805.0,805.0
0.016,6,10,1983,5,910,3.0,642.0,642.0,5,1073,4.0,805.0,805.0
0.006,6,10,1547,5,764,1.0,496.0,496.0,5,783,1.0,515.0,515.0
0.09,6,10,1506,5,395,19.0,127.0,127.0,5,1111,19.0,843.0,843.0
0.014,6,10,1631,5,848,3.0,580.0,580.0,5,783,3.0,515.0,515.0
0.008,6,10,1854,5,889,2.0,621.0,621.0,5,965,1.0,697.0,697.0
0.016,6,10,1990,5,911,4.0,643.0,643.0,5,1079,4.0,811.0,811.0
0.006,6,10,1689,5,839,1.0,571.0,571.0,5,850,1.0,582.0,582.0
10.764,17,26,4102,13,1821,888.0,268.0,112.0,13,2281,888.0,588.0,147.0
0.01,6,14,3787,7,497,1.0,125.0,125.0,7,3290,1.0,1448.0,972.0
0.008,6,10,1972,5,910,2.0,642.0,642.0,5,1062,2.0,794.0,794.0
10.864,17,28,4421,14,1994,826.0,269.0,114.0,14,2427,826.0,586.0,145.0
0.012,6,10,1989,5,910,3.0,642.0,642.0,5,1079,2.0,811.0,811.0
0.086,6,10,1506,5,395,19.0,127.0,127.0,5,1111,18.0,843.0,843.0
0.006,17,2,179,1,71,0.0,43.0,43.0,1,108,0.0,80.0,80.0
0.008,6,10,1989,5,910,2.0,642.0,642.0,5,1079,2.0,811.0,811.0
0.004,6,10,1779,5,928,1.0,660.0,660.0,5,851,1.0,583.0,583.0
0.005,6,10,1689,5,839,1.0,571.0,571.0,5,850,1.0,582.0,582.0
0.005,17,2,214,1,75,0.0,47.0,47.0,1,139,0.0,111.0,111.0
175.508,17,74,10515,37,2466,4875.0,44.0,38.0,37,8049,4875.0,239.0,189.0
0.068,17,8,3613,4,1874,22.0,1350.0,440.0,4,1739,11.0,1350.0,406.0
0.003,17,2,148,1,60,0.0,32.0,32.0,1,88,0.0,60.0,60.0
0.167,6,10,1506,5,395,27.0,127.0,127.0,5,1111,38.0,843.0,843.0
0.006,17,2,230,1,68,0.0,40.0,40.0,1,162,0.0,134.0,134.0
0.004,17,2,148,1,60,0.0,32.0,32.0,1,88,0.0,60.0,60.0
0.004,17,4,284,2,120,1.0,32.0,32.0,2,164,0.0,60.0,54.0
0.012,6,10,1989,5,910,3.0,642.0,642.0,5,1079,2.0,811.0,811.0
0.17,17,2,152,1,76,0.0,48.0,48.0,1,76,0.0,48.0,48.0
0.396,6,10,1506,5,395,90.0,127.0,127.0,5,1111,89.0,843.0,843.0
11.639,17,28,4390,14,2312,882.0,587.0,137.0,14,2078,882.0,269.0,120.0
0.071,17,2,144,1,64,0.0,36.0,36.0,1,80,0.0,52.0,52.0
0.003,6,10,1702,5,863,0.0,595.0,595.0,5,839,0.0,571.0,571.0
40.064,17,10,676,5,460,10013.0,104.0,64.0,5,216,10015.0,20.0,15.0
0.005,6,10,1702,5,863,1.0,595.0,595.0,5,839,1.0,571.0,571.0
0.001,17,2,180,1,66,0.0,38.0,38.0,1,114,0.0,86.0,86.0
40.003,17,10,676,5,460,9998.0,104.0,64.0,5,216,9999.0,20.0,15.0
0.077,6,10,1506,5,395,16.0,127.0,127.0,5,1111,16.0,843.0,843.0
0.004,6,10,2007,5,928,1.0,660.0,660.0,5,1079,1.0,811.0,811.0
240.009,6,9,787,5,488,60002.0,232.0,232.0,4,299,80002.0,83.0,83.0
0.156,6,10,1506,5,395,37.0,127.0,127.0,5,1111,35.0,843.0,843.0
0.001,17,2,180,1,66,0.0,38.0,38.0,1,114,0.0,86.0,86.0
0.005,6,13,3747,7,509,0.0,137.0,137.0,6,3238,0.0,1470.0,1459.0
0.004,6,10,2006,5,927,1.0,659.0,659.0,5,1079,1.0,811.0,811.0
1724.242,6,61,7130,40,4333,44211.0,1626.0,112.0,21,2797,86203.0,1116.0,85.0
0.163,17,2,152,1,76,0.0,48.0,48.0,1,76,0.0,48.0,48.0
177.186,17,70,9891,35,2331,5211.0,44.0,38.0,35,7560,5211.0,239.0,188.0
0.059,17,2,152,1,76,0.0,48.0,48.0,1,76,0.0,48.0,48.0
0.004,6,10,1989,5,927,1.0,659.0,659.0,5,1062,1.0,794.0,794.0
0.001,17,2,178,1,81,0.0,53.0,53.0,1,97,0.0,69.0,69.0
0.066,17,8,3613,4,1874,22.0,1350.0,440.0,4,1739,11.0,1350.0,406.0
0.001,17,2,180,1,66,0.0,38.0,38.0,1,114,0.0,86.0,86.0
0.001,17,2,180,1,66,0.0,38.0,38.0,1,114,0.0,86.0,86.0
0.005,6,10,1689,5,839,1.0,571.0,571.0,5,850,1.0,582.0,582.0
177.403,17,82,11649,41,2735,4434.0,44.0,38.0,41,8914,4434.0,239.0,189.0
0.005,6,10,1854,5,889,1.0,621.0,621.0,5,965,1.0,697.0,697.0
0.006,6,10,1643,5,860,1.0,592.0,592.0,5,783,1.0,515.0,515.0
0.088,6,10,1506,5,395,17.0,127.0,127.0,5,1111,20.0,843.0,843.0
0.003,17,4,284,2,120,0.0,32.0,32.0,2,164,0.0,60.0,54.0
0.006,17,2,169,1,62,0.0,34.0,34.0,1,107,0.0,79.0,79.0
0.004,17,2,136,1,60,0.0,32.0,32.0,1,76,0.0,48.0,48.0
0.025,6,10,1972,5,910,6.0,642.0,642.0,5,1062,6.0,794.0,794.0
0.081,6,10,1506,5,395,18.0,127.0,127.0,5,1111,18.0,843.0,843.0
240.103,6,16,4481,9,963,30012.0,238.0,166.0,7,3518,40016.0,1402.0,786.0
0.005,6,10,2006,5,927,1.0,659.0,659.0,5,1079,1.0,811.0,811.0
0.111,6,10,1506,5,395,26.0,127.0,127.0,5,1111,23.0,843.0,843.0
0.009,6,10,1972,5,910,2.0,642.0,642.0,5,1062,2.0,794.0,794.0
0.062,17,2,80,1,32,0.0,4.0,4.0,1,48,0.0,20.0,20.0
0.037,17,2,186,1,61,0.0,33.0,33.0,1,125,0.0,97.0,97.0
367.267,6,22,2313,16,867,24484.0,195.0,195.0,6,1446,4648.0,419.0,398.0
0.003,17,2,136,1,60,0.0,32.0,32.0,1,76,0.0,48.0,48.0
0.118,6,10,1506,5,395,26.0,127.0,127.0,5,1111,27.0,843.0,843.0
99.378,6,26,9525,12,1627,70.0,794.0,367.0,14,7898,7634.0,1360.0,732.0
0.004,6,10,2007,5,928,1.0,660.0,660.0,5,1079,1.0,811.0,811.0
0.012,6,10,1989,5,910,3.0,642.0,642.0,5,1079,3.0,811.0,811.0
0.007,6,10,1547,5,764,1.0,496.0,496.0,5,783,1.0,515.0,515.0
40.059,17,10,676,5,460,10014.0,104.0,64.0,5,216,10013.0,20.0,15.0
0.012,17,2,152,1,76,0.0,48.0,48.0,1,76,0.0,48.0,48.0
300.024,6,12,1782,7,1348,50004.0,494.0,494.0,5,434,75005.0,83.0,83.0
0.005,6,10,1643,5,860,1.0,592.0,592.0,5,783,1.0,515.0,515.0
0.004,17,4,284,2,120,0.0,32.0,32.0,2,164,0.0,60.0,54.0
0.004,6,10,1702,5,863,0.0,595.0,595.0,5,839,1.0,571.0,571.0
0.109,6,10,1506,5,395,24.0,127.0,127.0,5,1111,23.0,843.0,843.0
0.015,6,10,1989,5,910,3.0,642.0,642.0,5,1079,3.0,811.0,811.0
0.004,17,2,136,1,60,0.0,32.0,32.0,1,76,0.0,48.0,48.0
240.09,6,16,4481,9,963,30011.0,238.0,166.0,7,3518,40014.0,1402.0,786.0
0.005,17,2,186,1,60,0.0,32.0,32.0,1,126,0.0,98.0,98.0
0.01,6,10,1990,5,911,2.0,643.0,643.0,5,1079,2.0,811.0,811.0
240.129,6,31,9347,15,6969,17152.0,2093.0,688.0,16,2378,16008.0,580.0,192.0
0.006,6,12,1698,6,863,1.0,327.0,271.0,6,835,1.0,515.0,515.0
0.006,6,10,1689,5,839,1.0,571.0,571.0,5,850,1.0,582.0,582.0
0.014,6,10,1983,5,910,3.0,642.0,642.0,5,1073,3.0,805.0,805.0
0.008,6,10,1972,5,910,1.0,642.0,642.0,5,1062,2.0,794.0,794.0
0.091,6,10,1506,5,395,21.0,127.0,127.0,5,1111,21.0,843.0,843.0
0.078,6,10,1506,5,395,16.0,127.0,127.0,5,1111,17.0,843.0,843.0
0.207,6,16,2668,8,1394,29.0,533.0,323.0,8,1274,18.0,529.0,212.0
178.196,17,82,11922,41,2742,4454.0,44.0,38.0,41,9180,4454.0,260.0,195.0
0.006,6,10,1547,5,764,1.0,496.0,496.0,5,783,1.0,515.0,515.0
0.005,6,10,2006,5,927,1.0,659.0,659.0,5,1079,1.0,811.0,811.0
0.017,6,10,1972,5,910,4.0,642.0,642.0,5,1062,4.0,794.0,794.0
0.006,6,10,1643,5,860,1.0,592.0,592.0,5,783,1.0,515.0,515.0
361.816,6,21,1792,16,1030,24121.0,190.0,190.0,5,762,60010.0,461.0,247.0
0.004,6,10,2000,5,927,1.0,659.0,659.0,5,1073,1.0,805.0,805.0
0.122,6,10,1506,5,395,28.0,127.0,127.0,5,1111,26.0,843.0,843.0
0.013,6,10,1631,5,848,3.0,580.0,580.0,5,783,3.0,515.0,515.0
0.006,17,2,179,1,71,0.0,43.0,43.0,1,108,0.0,80.0,80.0
0.005,6,10,2007,5,928,1.0,660.0,660.0,5,1079,1.0,811.0,811.0
0.014,6,10,1762,5,911,3.0,643.0,643.0,5,851,3.0,583.0,583.0
301.12,6,48,17760,26,11853,12044.0,2264.0,1078.0,22,5907,425.0,2667.0,385.0
0.013,6,10,1983,5,910,3.0,642.0,642.0,5,1073,3.0,805.0,805.0
0.003,17,2,136,1,60,0.0,32.0,32.0,1,76,0.0,48.0,48.0
1768.959,17,92,8096,46,4048,39310.0,60.0,60.0,46,4048,39310.0,60.0,60.0
0.005,6,10,1989,5,927,1.0,659.0,659.0,5,1062,1.0,794.0,794.0
0.004,6,10,2000,5,927,1.0,659.0,659.0,5,1073,1.0,805.0,805.0
162.494,17,66,9446,33,2201,5077.0,44.0,38.0,33,7245,5077.0,261.0,191.0
0.004,6,10,2006,5,927,1.0,659.0,659.0,5,1079,1.0,811.0,811.0
40.066,17,10,676,5,460,10015.0,104.0,64.0,5,216,10015.0,20.0,15.0
0.041,17,2,152,1,76,0.0,48.0,48.0,1,76,0.0,48.0,48.0
0.016,6,10,1989,5,910,3.0,642.0,642.0,5,1079,3.0,811.0,811.0
0.01,6,10,1631,5,848,2.0,580.0,580.0,5,783,2.0,515.0,515.0
0.083,6,10,1506,5,395,19.0,127.0,127.0,5,1111,19.0,843.0,843.0
300.032,6,12,1782,7,1348,50005.0,494.0,494.0,5,434,75006.0,83.0,83.0
0.029,6,10,1989,5,910,7.0,642.0,642.0,5,1079,7.0,811.0,811.0
0.136,6,10,1506,5,395,30.0,127.0,127.0,5,1111,32.0,843.0,843.0
0.006,6,10,1643,5,860,1.0,592.0,592.0,5,783,1.0,515.0,515.0
5.103,6,20,5871,11,1384,510.0,474.0,201.0,9,4487,637.0,1925.0,804.0
0.12,6,10,1506,5,395,26.0,127.0,127.0,5,1111,21.0,843.0,843.0
0.005,17,2,169,1,62,0.0,34.0,34.0,1,107,0.0,79.0,79.0
240.089,6,16,4480,9,963,30011.0,238.0,166.0,7,3517,40014.0,1402.0,786.0
0.004,6,10,2007,5,928,1.0,660.0,660.0,5,1079,1.0,811.0,811.0
11.178,17,28,4422,14,1994,847.0,269.0,114.0,14,2428,847.0,587.0,145.0
0.005,6,10,1643,5,860,1.0,592.0,592.0,5,783,1.0,515.0,515.0
0.006,6,10,1547,5,764,1.0,496.0,496.0,5,783,1.0,515.0,515.0
0.009,6,10,1989,5,910,2.0,642.0,642.0,5,1079,2.0,811.0,811.0
0.006,6,10,1854,5,889,1.0,621.0,621.0,5,965,1.0,697.0,697.0
0.003,17,4,284,2,120,0.0,32.0,32.0,2,164,0.0,60.0,54.0
0.006,6,10,1547,5,764,1.0,496.0,496.0,5,783,1.0,515.0,515.0
0.096,6,10,1506,5,395,21.0,127.0,127.0,5,1111,19.0,843.0,843.0
0.015,6,10,1989,5,910,3.0,642.0,642.0,5,1079,3.0,811.0,811.0
0.178,6,10,1506,5,395,40.0,127.0,127.0,5,1111,43.0,843.0,843.0
0.005,6,14,3742,7,452,0.0,80.0,80.0,7,3290,0.0,1448.0,972.0
0.037,17,2,166,1,75,0.0,47.0,47.0,1,91,0.0,63.0,63.0
0.001,17,2,180,1,66,0.0,38.0,38.0,1,114,0.0,86.0,86.0
0.015,6,13,3735,7,497,2.0,125.0,125.0,6,3238,2.0,1470.0,1459.0
0.072,17,2,136,1,60,0.0,32.0,32.0,1,76,0.0,48.0,48.0
0.1,6,10,1506,5,395,23.0,127.0,127.0,5,1111,22.0,843.0,843.0
308.363,17,20,1124,10,716,34255.0,48.0,43.0,10,408,34255.0,20.0,12.0
0.094,6,10,1506,5,395,21.0,127.0,127.0,5,1111,21.0,843.0,843.0
0.099,6,10,1506,5,395,23.0,127.0,127.0,5,1111,22.0,843.0,843.0
40.056,17,10,676,5,460,10012.0,104.0,64.0,5,216,10013.0,20.0,15.0
0.005,6,10,1989,5,927,1.0,659.0,659.0,5,1062,1.0,794.0,794.0
0.006,6,10,1547,5,764,1.0,496.0,496.0,5,783,1.0,515.0,515.0
0.013,6,10,1989,5,910,3.0,642.0,642.0,5,1079,3.0,811.0,811.0
0.008,17,2,214,1,75,0.0,47.0,47.0,1,139,0.0,111.0,111.0
0.004,6,10,2007,5,928,1.0,660.0,660.0,5,1079,1.0,811.0,811.0
0.012,6,10,1983,5,910,3.0,642.0,642.0,5,1073,3.0,805.0,805.0
0.071,6,10,1506,5,395,14.0,127.0,127.0,5,1111,17.0,843.0,843.0
0.135,6,10,1506,5,395,30.0,127.0,127.0,5,1111,32.0,843.0,843.0
0.005,6,10,2006,5,927,1.0,659.0,659.0,5,1079,1.0,811.0,811.0
0.142,6,10,1506,5,395,30.0,127.0,127.0,5,1111,34.0,843.0,843.0
0.011,6,10,1972,5,910,2.0,642.0,642.0,5,1062,2.0,794.0,794.0
0.014,6,10,1983,5,910,3.0,642.0,642.0,5,1073,3.0,805.0,805.0
0.003,17,2,132,1,58,0.0,30.0,30.0,1,74,0.0,46.0,46.0
0.005,17,2,230,1,68,0.0,40.0,40.0,1,162,0.0,134.0,134.0
0.037,17,2,186,1,61,0.0,33.0,33.0,1,125,0.0,97.0,97.0
0.177,6,10,1506,5,395,41.0,127.0,127.0,5,1111,43.0,843.0,843.0
0.013,6,10,1989,5,910,3.0,642.0,642.0,5,1079,3.0,811.0,811.0
0.009,6,10,1989,5,910,2.0,642.0,642.0,5,1079,2.0,811.0,811.0
0.071,17,8,3613,4,1874,23.0,1350.0,440.0,4,1739,11.0,1350.0,406.0
0.009,6,10,1990,5,911,2.0,643.0,643.0,5,1079,2.0,811.0,811.0
0.005,6,14,3742,7,452,0.0,80.0,80.0,7,3290,0.0,1448.0,972.0
0.004,6,10,1702,5,863,0.0,595.0,595.0,5,839,1.0,571.0,571.0
0.014,6,10,1972,5,910,3.0,642.0,642.0,5,1062,3.0,794.0,794.0
1799.829,17,3211,241504,1600,128000,1125.0,75.0,52.0,1611,113504,1117.0,226.0,42.0
1786.361,6,150,19350,90,13740,20071.0,302.0,302.0,60,5610,30277.0,83.0,83.0
0.15,6,10,1506,5,395,35.0,127.0,127.0,5,1111,13.0,843.0,843.0
0.001,17,2,180,1,66,0.0,38.0,38.0,1,114,0.0,86.0,86.0
0.005,17,2,180,1,58,0.0,30.0,30.0,1,122,0.0,94.0,94.0
0.005,6,10,1689,5,839,1.0,571.0,571.0,5,850,1.0,582.0,582.0
0.083,6,10,1506,5,395,19.0,127.0,127.0,5,1111,20.0,843.0,843.0
0.005,17,2,222,1,65,0.0,37.0,37.0,1,157,0.0,129.0,129.0
1797.79,6,254,25565,103,9464,17624.0,565.0,66.0,151,16101,11984.0,1360.0,130.0
0.015,6,10,1989,5,910,3.0,642.0,642.0,5,1079,3.0,811.0,811.0
0.006,6,10,1854,5,889,1.0,621.0,621.0,5,965,1.0,697.0,697.0
0.045,6,10,1677,5,827,11.0,559.0,559.0,5,850,11.0,582.0,582.0
315.807,17,18,1008,9,640,39468.0,48.0,43.0,9,368,39468.0,20.0,12.0
0.077,6,10,1506,5,395,16.0,127.0,127.0,5,1111,16.0,843.0,843.0
0.163,17,2,152,1,76,0.0,48.0,48.0,1,76,0.0,48.0,48.0
0.005,6,10,1989,5,927,1.0,659.0,659.0,5,1062,1.0,794.0,794.0
0.005,6,13,3747,7,509,0.0,137.0,137.0,6,3238,1.0,1470.0,1459.0
0.006,6,10,1547,5,764,1.0,496.0,496.0,5,783,1.0,515.0,515.0
0.004,6,14,3742,8,504,0.0,80.0,80.0,6,3238,0.0,1470.0,1459.0
0.015,6,10,1989,5,910,3.0,642.0,642.0,5,1079,3.0,811.0,811.0
0.064,6,10,1506,5,395,13.0,127.0,127.0,5,1111,14.0,843.0,843.0
0.005,17,2,186,1,60,0.0,32.0,32.0,1,126,0.0,98.0,98.0
0.006,6,10,1854,5,889,1.0,621.0,621.0,5,965,1.0,697.0,697.0
0.004,17,2,148,1,60,0.0,32.0,32.0,1,88,0.0,60.0,60.0
0.014,6,10,1989,5,910,3.0,642.0,642.0,5,1079,3.0,811.0,811.0
300.33,6,16,2170,9,684,37520.0,146.0,146.0,7,1486,50026.0,419.0,398.0
0.159,6,10,1506,5,395,37.0,127.0,127.0,5,1111,37.0,843.0,843.0
0.0,17,2,180,1,66,0.0,38.0,38.0,1,114,0.0,86.0,86.0
309.138,17,18,1008,9,640,38630.0,48.0,43.0,9,368,38627.0,20.0,12.0
0.004,6,10,2006,5,927,1.0,659.0,659.0,5,1079,1.0,811.0,811.0
0.013,6,10,1990,5,911,3.0,643.0,643.0,5,1079,3.0,811.0,811.0
10.711,17,26,4103,13,1822,883.0,269.0,112.0,13,2281,883.0,588.0,147.0
0.004,17,2,148,1,60,0.0,32.0,32.0,1,88,0.0,60.0,60.0
300.305,6,16,2170,9,684,37517.0,146.0,146.0,7,1486,50022.0,419.0,398.0
178.051,17,80,11694,40,2697,4565.0,44.0,39.0,40,8997,4565.0,239.0,196.0
0.005,6,10,2007,5,928,1.0,660.0,660.0,5,1079,1.0,811.0,811.0
0.004,6,10,1702,5,863,1.0,595.0,595.0,5,839,1.0,571.0,571.0
0.01,6,10,1762,5,911,2.0,643.0,643.0,5,851,2.0,583.0,583.0
0.005,6,10,2007,5,928,1.0,660.0,660.0,5,1079,1.0,811.0,811.0
0.014,6,10,1983,5,910,3.0,642.0,642.0,5,1073,3.0,805.0,805.0
0.005,6,10,1547,5,764,1.0,496.0,496.0,5,783,1.0,515.0,515.0
0.009,6,10,1989,5,910,2.0,642.0,642.0,5,1079,2.0,811.0,811.0
0.006,6,10,1547,5,764,1.0,496.0,496.0,5,783,1.0,515.0,515.0
0.084,6,10,1506,5,395,16.0,127.0,127.0,5,1111,19.0,843.0,843.0
0.015,6,10,1972,5,910,3.0,642.0,642.0,5,1062,3.0,794.0,794.0
0.014,6,10,1972,5,910,3.0,642.0,642.0,5,1062,3.0,794.0,794.0
0.011,6,10,1989,5,910,2.0,642.0,642.0,5,1079,2.0,811.0,811.0
0.004,17,2,148,1,60,0.0,32.0,32.0,1,88,0.0,60.0,60.0
0.003,17,2,148,1,60,0.0,32.0,32.0,1,88,0.0,60.0,60.0
0.009,6,10,1677,5,827,2.0,559.0,559.0,5,850,2.0,582.0,582.0
0.001,17,2,180,1,66,0.0,38.0,38.0,1,114,0.0,86.0,86.0
0.005,17,2,180,1,66,0.0,38.0,38.0,1,114,0.0,86.0,86.0
0.02,6,10,1972,5,910,5.0,642.0,642.0,5,1062,4.0,794.0,794.0
0.001,17,2,180,1,66,0.0,38.0,38.0,1,114,0.0,86.0,86.0
0.007,6,10,1774,5,923,1.0,655.0,655.0,5,851,1.0,583.0,583.0
0.003,17,2,136,1,60,0.0,32.0,32.0,1,76,0.0,48.0,48.0
0.005,17,2,154,1,69,0.0,41.0,41.0,1,85,0.0,57.0,57.0
0.005,6,10,1774,5,923,1.0,655.0,655.0,5,851,1.0,583.0,583.0
0.131,6,10,1506,5,395,27.0,127.0,127.0,5,1111,32.0,843.0,843.0
0.013,6,6,716,3,458,4.0,302.0,302.0,3,258,4.0,102.0,102.0
0.006,6,10,1689,5,839,1.0,571.0,571.0,5,850,1.0,582.0,582.0
0.057,17,2,299,1,65,0.0,37.0,37.0,1,234,0.0,206.0,206.0
0.011,6,10,1983,5,910,2.0,642.0,642.0,5,1073,2.0,805.0,805.0
0.005,6,13,3690,7,452,0.0,80.0,80.0,6,3238,1.0,1470.0,1459.0
0.005,6,10,2006,5,927,1.0,659.0,659.0,5,1079,1.0,811.0,811.0
0.005,6,10,2006,5,927,1.0,659.0,659.0,5,1079,1.0,811.0,811.0
0.004,6,10,2007,5,928,1.0,660.0,660.0,5,1079,1.0,811.0,811.0
0.004,6,10,2000,5,927,1.0,659.0,659.0,5,1073,1.0,805.0,805.0
0.015,6,10,1990,5,911,3.0,643.0,643.0,5,1079,3.0,811.0,811.0
40.045,17,10,676,5,460,10009.0,104.0,64.0,5,216,10010.0,20.0,15.0
167.44,17,74,10668,37,2473,4650.0,44.0,38.0,37,8195,4651.0,261.0,193.0
0.218,6,16,2778,8,1396,31.0,533.0,324.0,8,1382,19.0,529.0,239.0
0.008,17,2,299,1,65,0.0,37.0,37.0,1,234,0.0,206.0,206.0
0.036,6,14,3787,7,497,6.0,125.0,125.0,7,3290,5.0,1448.0,972.0
40.055,17,10,676,5,460,10013.0,104.0,64.0,5,216,10013.0,20.0,15.0
0.006,6,10,1989,5,927,1.0,659.0,659.0,5,1062,1.0,794.0,794.0
0.005,6,10,2007,5,928,1.0,660.0,660.0,5,1079,1.0,811.0,811.0
0.005,17,2,213,1,69,0.0,41.0,41.0,1,144,0.0,116.0,116.0
1795.217,6,64,7361,42,4485,43785.0,1641.0,109.0,22,2876,85478.0,1112.0,82.0
0.01,6,10,1677,5,827,2.0,559.0,559.0,5,850,2.0,582.0,582.0
0.103,6,10,1506,5,395,22.0,127.0,127.0,5,1111,22.0,843.0,843.0
0.008,6,10,1989,5,910,2.0,642.0,642.0,5,1079,2.0,811.0,811.0
0.128,6,10,1506,5,395,29.0,127.0,127.0,5,1111,31.0,843.0,843.0
0.004,6,10,2006,5,927,1.0,659.0,659.0,5,1079,1.0,811.0,811.0
0.007,17,2,179,1,71,0.0,43.0,43.0,1,108,0.0,80.0,80.0
40.07,17,10,676,5,460,10013.0,104.0,64.0,5,216,10016.0,20.0,15.0
0.004,17,2,170,1,65,0.0,37.0,37.0,1,105,0.0,77.0,77.0
0.011,6,10,1972,5,910,2.0,642.0,642.0,5,1062,2.0,794.0,794.0
0.009,6,10,1677,5,827,2.0,559.0,559.0,5,850,2.0,582.0,582.0
0.018,6,10,1990,5,911,4.0,643.0,643.0,5,1079,4.0,811.0,811.0
0.004,6,10,2007,5,928,1.0,660.0,660.0,5,1079,1.0,811.0,811.0
0.004,17,2,160,1,72,0.0,44.0,44.0,1,88,0.0,60.0,60.0
0.1,6,10,1506,5,395,21.0,127.0,127.0,5,1111,23.0,843.0,843.0
0.091,6,10,1506,5,395,18.0,127.0,127.0,5,1111,22.0,843.0,843.0
581.333,6,49,17925,26,3854,23253.0,676.0,415.0,23,14071,23694.0,1402.0,804.0
0.031,6,10,1989,5,910,7.0,642.0,642.0,5,1079,7.0,811.0,811.0
295.172,6,374,346622,191,21495,1553.0,2736.0,888.0,183,325127,1621.0,2804.0,1867.0
0.001,17,2,136,1,60,0.0,32.0,32.0,1,76,0.0,48.0,48.0
0.005,6,10,1689,5,839,1.0,571.0,571.0,5,850,1.0,582.0,582.0
0.016,6,20,9974,11,704,1.0,124.0,124.0,9,9270,2.0,2896.0,1758.0
40.053,17,10,676,5,460,10012.0,104.0,64.0,5,216,10012.0,20.0,15.0
0.084,6,10,1506,5,395,17.0,127.0,127.0,5,1111,17.0,843.0,843.0
0.091,6,10,1506,5,395,17.0,127.0,127.0,5,1111,18.0,843.0,843.0
0.019,6,10,1990,5,911,4.0,643.0,643.0,5,1079,4.0,811.0,811.0
0.005,6,13,3747,7,509,0.0,137.0,137.0,6,3238,1.0,1470.0,1459.0
0.012,6,13,3735,7,497,1.0,125.0,125.0,6,3238,2.0,1470.0,1459.0
0.014,6,10,1989,5,910,3.0,642.0,642.0,5,1079,3.0,811.0,811.0
40.068,17,10,676,5,460,10013.0,104.0,64.0,5,216,10015.0,20.0,15.0
0.007,6,10,1972,5,910,1.0,642.0,642.0,5,1062,1.0,794.0,794.0
0.003,17,2,136,1,60,0.0,32.0,32.0,1,76,0.0,48.0,48.0
0.273,17,4,596,2,122,146.0,33.0,33.0,2,474,231.0,323.0,209.0
0.018,6,10,1989,5,910,4.0,642.0,642.0,5,1079,4.0,811.0,811.0
0.129,17,2,148,1,60,0.0,32.0,32.0,1,88,0.0,60.0,60.0
0.014,6,10,1762,5,911,3.0,643.0,643.0,5,851,3.0,583.0,583.0
0.006,17,2,148,1,60,0.0,32.0,32.0,1,88,0.0,60.0,60.0
0.134,6,10,1506,5,395,28.0,127.0,127.0,5,1111,28.0,843.0,843.0
0.015,6,10,1983,5,910,3.0,642.0,642.0,5,1073,3.0,805.0,805.0
0.08,6,10,1506,5,395,17.0,127.0,127.0,5,1111,19.0,843.0,843.0
0.008,6,12,1926,6,1189,1.0,659.0,434.0,6,737,1.0,417.0,417.0
0.008,6,10,1972,5,910,2.0,642.0,642.0,5,1062,2.0,794.0,794.0
0.003,17,2,148,1,60,0.0,32.0,32.0,1,88,0.0,60.0,60.0
0.135,6,10,1506,5,395,29.0,127.0,127.0,5,1111,32.0,843.0,843.0
0.009,6,10,1989,5,910,2.0,642.0,642.0,5,1079,2.0,811.0,811.0
0.005,6,10,1989,5,927,1.0,659.0,659.0,5,1062,1.0,794.0,794.0
0.019,6,10,1990,5,911,4.0,643.0,643.0,5,1079,4.0,811.0,811.0
0.009,6,10,1989,5,927,2.0,659.0,659.0,5,1062,2.0,794.0,794.0
0.003,17,2,148,1,60,0.0,32.0,32.0,1,88,0.0,60.0,60.0
0.006,6,10,1854,5,889,1.0,621.0,621.0,5,965,1.0,697.0,697.0
0.04,17,2,152,1,76,0.0,48.0,48.0,1,76,0.0,48.0,48.0
0.013,6,13,3735,7,497,2.0,125.0,125.0,6,3238,2.0,1470.0,1459.0
0.012,6,10,1983,5,910,3.0,642.0,642.0,5,1073,2.0,805.0,805.0
0.066,17,8,3613,4,1874,22.0,1350.0,440.0,4,1739,10.0,1350.0,406.0
0.004,6,10,1989,5,927,1.0,659.0,659.0,5,1062,1.0,794.0,794.0
0.006,17,2,199,1,68,0.0,40.0,40.0,1,131,0.0,103.0,103.0
0.086,6,10,1506,5,395,18.0,127.0,127.0,5,1111,19.0,843.0,843.0
0.006,6,10,1702,5,863,1.0,595.0,595.0,5,839,1.0,571.0,571.0
0.006,6,10,1547,5,764,1.0,496.0,496.0,5,783,1.0,515.0,515.0
0.016,6,10,1762,5,911,4.0,643.0,643.0,5,851,3.0,583.0,583.0
0.004,6,10,1702,5,863,0.0,595.0,595.0,5,839,1.0,571.0,571.0
0.005,6,10,2006,5,927,1.0,659.0,659.0,5,1079,1.0,811.0,811.0
1751.712,6,457,65792,252,35168,6978.0,613.0,197.0,205,30624,8586.0,453.0,142.0
15.083,17,15,8405,8,6230,2149.0,1350.0,750.0,7,2175,2508.0,1350.0,282.0
240.216,6,29,13793,14,8791,18478.0,2736.0,1342.0,15,5002,17157.0,1656.0,842.0
0.005,6,10,1774,5,923,1.0,655.0,655.0,5,851,1.0,583.0,583.0
0.004,6,10,1774,5,923,1.0,655.0,655.0,5,851,0.0,583.0,583.0
0.008,6,10,1989,5,927,1.0,659.0,659.0,5,1062,2.0,794.0,794.0
0.019,6,10,1989,5,910,4.0,642.0,642.0,5,1079,4.0,811.0,811.0
301.048,6,46,16983,25,11116,12543.0,2720.0,1120.0,21,5867,443.0,2667.0,385.0
173.045,17,76,10744,38,2537,4676.0,44.0,38.0,38,8207,4676.0,249.0,187.0
0.074,6,10,1506,5,395,16.0,127.0,127.0,5,1111,16.0,843.0,843.0
0.005,17,2,222,1,65,0.0,37.0,37.0,1,157,0.0,129.0,129.0
0.107,6,10,1506,5,395,23.0,127.0,127.0,5,1111,22.0,843.0,843.0
0.098,6,10,1506,5,395,22.0,127.0,127.0,5,1111,23.0,843.0,843.0
0.006,6,10,1547,5,764,1.0,496.0,496.0,5,783,1.0,515.0,515.0
0.006,6,10,1689,5,839,1.0,571.0,571.0,5,850,1.0,582.0,582.0
0.025,6,10,1989,5,910,6.0,642.0,642.0,5,1079,6.0,811.0,811.0
0.005,6,10,2006,5,927,1.0,659.0,659.0,5,1079,1.0,811.0,811.0
0.011,6,10,1983,5,910,2.0,642.0,642.0,5,1073,2.0,805.0,805.0
0.008,6,10,1989,5,910,2.0,642.0,642.0,5,1079,1.0,811.0,811.0
40.069,17,10,676,5,460,10016.0,104.0,64.0,5,216,10016.0,20.0,15.0
0.037,17,2,182,1,65,0.0,37.0,37.0,1,117,0.0,89.0,89.0
240.024,6,9,787,5,488,60006.0,232.0,232.0,4,299,80007.0,83.0,83.0
0.008,17,2,170,1,65,0.0,37.0,37.0,1,105,0.0,77.0,77.0
40.062,17,10,676,5,460,10014.0,104.0,64.0,5,216,10014.0,20.0,15.0
0.014,6,10,1983,5,910,3.0,642.0,642.0,5,1073,3.0,805.0,805.0
65.12,6,21,8147,11,1985,86.0,1174.0,504.0,10,6162,7216.0,1791.0,958.0
0.118,6,10,1506,5,395,20.0,127.0,127.0,5,1111,28.0,843.0,843.0
0.015,6,10,1972,5,910,3.0,642.0,642.0,5,1062,3.0,794.0,794.0
0.015,6,10,1972,5,910,3.0,642.0,642.0,5,1062,3.0,794.0,794.0
0.012,6,10,1990,5,911,2.0,643.0,643.0,5,1079,2.0,811.0,811.0
0.085,6,10,1506,5,395,18.0,127.0,127.0,5,1111,18.0,843.0,843.0
0.005,6,10,1689,5,839,1.0,571.0,571.0,5,850,1.0,582.0,582.0
0.005,6,10,1989,5,927,1.0,659.0,659.0,5,1062,1.0,794.0,794.0
0.005,17,2,166,1,75,0.0,47.0,47.0,1,91,0.0,63.0,63.0
0.003,17,4,284,2,120,0.0,32.0,32.0,2,164,0.0,60.0,54.0
1755.98,6,105,6270,60,3525,29761.0,27.0,27.0,45,2745,39907.0,27.0,27.0
0.008,6,10,1989,5,910,2.0,642.0,642.0,5,1079,1.0,811.0,811.0
0.073,17,2,234,1,61,0.0,33.0,33.0,1,173,0.0,145.0,145.0
0.005,6,10,2006,5,927,1.0,659.0,659.0,5,1079,1.0,811.0,811.0
0.012,17,2,166,1,75,0.0,47.0,47.0,1,91,0.0,63.0,63.0
0.01,6,10,1989,5,910,2.0,642.0,642.0,5,1079,2.0,811.0,811.0
0.014,6,10,1990,5,911,3.0,643.0,643.0,5,1079,3.0,811.0,811.0
177.314,17,74,10559,37,2457,4925.0,44.0,38.0,37,8102,4925.0,239.0,190.0
0.015,6,10,1972,5,910,3.0,642.0,642.0,5,1062,3.0,794.0,794.0
0.016,6,13,3735,7,497,2.0,125.0,125.0,6,3238,3.0,1470.0,1459.0
0.004,17,2,148,1,60,0.0,32.0,32.0,1,88,0.0,60.0,60.0
0.005,6,10,1689,5,839,1.0,571.0,571.0,5,850,1.0,582.0,582.0
0.047,6,10,1972,5,910,11.0,642.0,642.0,5,1062,11.0,794.0,794.0
0.006,6,10,1547,5,764,1.0,496.0,496.0,5,783,1.0,515.0,515.0
0.001,17,2,180,1,66,0.0,38.0,38.0,1,114,0.0,86.0,86.0
11.381,17,29,4590,14,1994,863.0,269.0,114.0,15,2596,801.0,587.0,145.0
0.17,17,2,152,1,76,0.0,48.0,48.0,1,76,0.0,48.0,48.0
0.014,6,10,1990,5,911,3.0,643.0,643.0,5,1079,3.0,811.0,811.0
0.08,6,10,1506,5,395,18.0,127.0,127.0,5,1111,17.0,843.0,843.0
0.006,6,10,1547,5,764,1.0,496.0,496.0,5,783,1.0,515.0,515.0
0.012,6,10,1989,5,910,3.0,642.0,642.0,5,1079,3.0,811.0,811.0
0.006,6,10,1547,5,764,1.0,496.0,496.0,5,783,1.0,515.0,515.0
0.015,6,10,1972,5,910,3.0,642.0,642.0,5,1062,3.0,794.0,794.0
0.097,6,10,1506,5,395,21.0,127.0,127.0,5,1111,23.0,843.0,843.0
40.058,17,10,676,5,460,10013.0,104.0,64.0,5,216,10013.0,20.0,15.0
0.001,17,2,180,1,66,0.0,38.0,38.0,1,114,0.0,86.0,86.0
0.054,17,2,152,1,76,0.0,48.0,48.0,1,76,0.0,48.0,48.0
0.011,6,10,1983,5,910,2.0,642.0,642.0,5,1073,2.0,805.0,805.0
0.083,6,10,1506,5,395,17.0,127.0,127.0,5,1111,18.0,843.0,843.0
0.008,17,2,194,1,59,0.0,31.0,31.0,1,135,0.0,107.0,107.0
0.004,17,4,284,2,120,0.0,32.0,32.0,2,164,0.0,60.0,54.0
0.207,17,16,8874,8,6291,29.0,1350.0,758.0,8,2583,20.0,1350.0,294.0
0.012,6,10,1989,5,910,3.0,642.0,642.0,5,1079,3.0,811.0,811.0
0.055,6,10,1506,5,395,13.0,127.0,127.0,5,1111,13.0,843.0,843.0
0.015,6,10,1972,5,910,3.0,642.0,642.0,5,1062,3.0,794.0,794.0
0.107,6,10,1506,5,395,18.0,127.0,127.0,5,1111,21.0,843.0,843.0
0.004,6,10,1989,5,927,1.0,659.0,659.0,5,1062,1.0,794.0,794.0
0.006,6,10,1547,5,764,1.0,496.0,496.0,5,783,1.0,515.0,515.0
0.009,6,12,1926,6,1189,1.0,659.0,434.0,6,737,1.0,417.0,417.0
40.079,17,10,676,5,460,10015.0,104.0,64.0,5,216,10018.0,20.0,15.0
0.006,6,10,1689,5,839,1.0,571.0,571.0,5,850,1.0,582.0,582.0
0.064,6,10,1506,5,395,14.0,127.0,127.0,5,1111,12.0,843.0,843.0
0.022,6,10,1762,5,911,5.0,643.0,643.0,5,851,5.0,583.0,583.0
0.005,6,10,2006,5,927,1.0,659.0,659.0,5,1079,1.0,811.0,811.0
0.005,6,13,3747,7,509,0.0,137.0,137.0,6,3238,0.0,1470.0,1459.0
0.005,17,2,179,1,71,0.0,43.0,43.0,1,108,0.0,80.0,80.0
0.004,6,10,1989,5,927,1.0,659.0,659.0,5,1062,1.0,794.0,794.0
0.005,6,10,2007,5,928,1.0,660.0,660.0,5,1079,1.0,811.0,811.0
0.003,17,2,148,1,60,0.0,32.0,32.0,1,88,0.0,60.0,60.0
308.573,17,20,1124,10,716,34271.0,48.0,43.0,10,408,34271.0,20.0,12.0
0.063,6,10,1506,5,395,15.0,127.0,127.0,5,1111,12.0,843.0,843.0
0.11,6,10,1506,5,395,24.0,127.0,127.0,5,1111,21.0,843.0,843.0
0.069,6,10,1506,5,395,14.0,127.0,127.0,5,1111,14.0,843.0,843.0
0.012,6,10,1990,5,911,3.0,643.0,643.0,5,1079,2.0,811.0,811.0
0.059,17,2,152,1,76,0.0,48.0,48.0,1,76,0.0,48.0,48.0
0.041,17,2,170,1,65,0.0,37.0,37.0,1,105,0.0,77.0,77.0
0.152,6,10,1506,5,395,35.0,127.0,127.0,5,1111,27.0,843.0,843.0
0.004,17,2,136,1,60,0.0,32.0,32.0,1,76,0.0,48.0,48.0
0.06,17,2,80,1,32,0.0,4.0,4.0,1,48,0.0,20.0,20.0
11.284,17,28,4423,14,1995,855.0,270.0,114.0,14,2428,855.0,587.0,145.0
0.005,6,10,1989,5,927,1.0,659.0,659.0,5,1062,1.0,794.0,794.0
0.007,6,10,1972,5,910,1.0,642.0,642.0,5,1062,1.0,794.0,794.0
0.004,6,10,1989,5,927,1.0,659.0,659.0,5,1062,1.0,794.0,794.0
0.004,17,2,148,1,60,0.0,32.0,32.0,1,88,0.0,60.0,60.0
0.009,6,10,1972,5,910,2.0,642.0,642.0,5,1062,2.0,794.0,794.0
0.008,6,10,1989,5,910,1.0,642.0,642.0,5,1079,2.0,811.0,811.0
0.005,6,10,2007,5,928,1.0,660.0,660.0,5,1079,1.0,811.0,811.0
0.006,6,10,1547,5,764,1.0,496.0,496.0,5,783,1.0,515.0,515.0
0.013,6,10,1990,5,911,3.0,643.0,643.0,5,1079,3.0,811.0,811.0
0.005,6,10,2006,5,927,1.0,659.0,659.0,5,1079,1.0,811.0,811.0
240.277,6,42,8719,21,5686,12013.0,2883.0,573.0,21,3033,12013.0,580.0,241.0
0.122,6,10,1506,5,395,29.0,127.0,127.0,5,1111,27.0,843.0,843.0
0.005,6,10,2006,5,927,1.0,659.0,659.0,5,1079,1.0,811.0,811.0
0.071,6,10,1506,5,395,16.0,127.0,127.0,5,1111,16.0,843.0,843.0
0.023,6,10,1989,5,910,5.0,642.0,642.0,5,1079,5.0,811.0,811.0
0.008,6,10,1762,5,911,1.0,643.0,643.0,5,851,2.0,583.0,583.0
0.013,6,10,1972,5,910,3.0,642.0,642.0,5,1062,3.0,794.0,794.0
0.011,6,10,1983,5,910,2.0,642.0,642.0,5,1073,2.0,805.0,805.0
0.005,6,10,1779,5,928,1.0,660.0,660.0,5,851,1.0,583.0,583.0
0.009,6,10,1990,5,911,2.0,643.0,643.0,5,1079,2.0,811.0,811.0
0.011,6,10,1677,5,827,2.0,559.0,559.0,5,850,2.0,582.0,582.0
0.117,6,10,1506,5,395,25.0,127.0,127.0,5,1111,27.0,843.0,843.0
0.005,17,2,225,1,65,0.0,37.0,37.0,1,160,0.0,132.0,132.0
0.006,6,10,1689,5,839,1.0,571.0,571.0,5,850,1.0,582.0,582.0
0.016,17,2,198,1,91,0.0,63.0,63.0,1,107,0.0,79.0,79.0
0.015,6,10,1983,5,910,3.0,642.0,642.0,5,1073,3.0,805.0,805.0
354.022,6,21,1795,16,1030,23601.0,190.0,190.0,5,765,60002.0,464.0,248.0
0.171,6,3,453,2,321,171.0,241.0,241.0,1,132,0.0,92.0,92.0
0.006,6,10,2007,5,928,1.0,660.0,660.0,5,1079,1.0,811.0,811.0
0.005,6,10,1643,5,860,1.0,592.0,592.0,5,783,1.0,515.0,515.0
240.083,6,16,4480,9,963,30010.0,238.0,166.0,7,3517,40013.0,1402.0,786.0
0.112,6,10,1506,5,395,24.0,127.0,127.0,5,1111,21.0,843.0,843.0
0.004,6,10,1774,5,923,1.0,655.0,655.0,5,851,1.0,583.0,583.0
0.004,6,10,2006,5,927,1.0,659.0,659.0,5,1079,1.0,811.0,811.0
0.005,6,10,1774,5,923,1.0,655.0,655.0,5,851,1.0,583.0,583.0
0.01,6,10,1972,5,910,2.0,642.0,642.0,5,1062,2.0,794.0,794.0
0.005,6,10,2007,5,928,1.0,660.0,660.0,5,1079,1.0,811.0,811.0
0.094,6,10,1506,5,395,21.0,127.0,127.0,5,1111,20.0,843.0,843.0
0.005,17,2,144,1,64,0.0,36.0,36.0,1,80,0.0,52.0,52.0
0.006,6,10,1689,5,839,1.0,571.0,571.0,5,850,1.0,582.0,582.0
0.231,6,16,2778,8,1396,33.0,533.0,324.0,8,1382,21.0,529.0,239.0
0.001,17,2,180,1,66,0.0,38.0,38.0,1,114,0.0,86.0,86.0
0.008,6,12,1926,6,1189,1.0,659.0,434.0,6,737,1.0,417.0,417.0
0.01,6,10,1983,5,910,2.0,642.0,642.0,5,1073,2.0,805.0,805.0
1792.5,6,491,99452,247,88102,7286.0,421.0,365.0,244,11350,7376.0,53.0,53.0
0.001,17,2,180,1,66,0.0,38.0,38.0,1,114,0.0,86.0,86.0
0.004,6,10,2006,5,927,1.0,659.0,659.0,5,1079,1.0,811.0,811.0
0.014,6,10,1989,5,910,3.0,642.0,642.0,5,1079,3.0,811.0,811.0
0.014,6,10,1989,5,910,3.0,642.0,642.0,5,1079,3.0,811.0,811.0
0.087,6,10,1506,5,395,18.0,127.0,127.0,5,1111,20.0,843.0,843.0
0.013,6,10,1983,5,910,3.0,642.0,642.0,5,1073,3.0,805.0,805.0
0.005,17,2,214,1,75,0.0,47.0,47.0,1,139,0.0,111.0,111.0
0.005,6,10,1989,5,927,1.0,659.0,659.0,5,1062,1.0,794.0,794.0
0.006,6,10,2007,5,928,1.0,660.0,660.0,5,1079,1.0,811.0,811.0
0.01,6,10,1989,5,927,2.0,659.0,659.0,5,1062,2.0,794.0,794.0
0.758,6,26,5824,13,1922,55.0,325.0,174.0,13,3902,53.0,1414.0,563.0
51.921,6,28,9605,14,1707,3993.0,794.0,367.0,14,7898,3983.0,1360.0,732.0
40.06,17,10,676,5,460,10013.0,104.0,64.0,5,216,10014.0,20.0,15.0
0.02,6,10,1989,5,910,4.0,642.0,642.0,5,1079,5.0,811.0,811.0
0.004,6,10,2007,5,928,1.0,660.0,660.0,5,1079,1.0,811.0,811.0
40.062,17,10,676,5,460,10014.0,104.0,64.0,5,216,10014.0,20.0,15.0
0.023,6,10,1677,5,827,5.0,559.0,559.0,5,850,5.0,582.0,582.0
0.005,17,2,213,1,69,0.0,41.0,41.0,1,144,0.0,116.0,116.0
0.016,6,10,1631,5,848,4.0,580.0,580.0,5,783,4.0,515.0,515.0
0.007,6,10,1643,5,860,1.0,592.0,592.0,5,783,1.0,515.0,515.0
0.091,6,10,1506,5,395,21.0,127.0,127.0,5,1111,17.0,843.0,843.0
0.008,6,10,1990,5,911,1.0,643.0,643.0,5,1079,2.0,811.0,811.0
40.066,17,10,676,5,460,10015.0,104.0,64.0,5,216,10015.0,20.0,15.0
0.016,6,10,1972,5,910,4.0,642.0,642.0,5,1062,3.0,794.0,794.0
0.016,17,2,198,1,91,0.0,63.0,63.0,1,107,0.0,79.0,79.0
10.851,17,28,4422,14,1993,825.0,268.0,114.0,14,2429,825.0,588.0,145.0
0.005,6,10,1547,5,764,1.0,496.0,496.0,5,783,1.0,515.0,515.0
0.01,6,13,3735,7,497,1.0,125.0,125.0,6,3238,2.0,1470.0,1459.0
0.077,6,10,1506,5,395,18.0,127.0,127.0,5,1111,15.0,843.0,843.0
0.171,6,10,1506,5,395,40.0,127.0,127.0,5,1111,36.0,843.0,843.0
0.118,6,10,1506,5,395,25.0,127.0,127.0,5,1111,25.0,843.0,843.0
0.006,6,10,1547,5,764,1.0,496.0,496.0,5,783,1.0,515.0,515.0
0.005,6,10,2007,5,928,1.0,660.0,660.0,5,1079,1.0,811.0,811.0
0.004,6,10,1779,5,928,1.0,660.0,660.0,5,851,1.0,583.0,583.0
0.006,6,10,1689,5,839,1.0,571.0,571.0,5,850,1.0,582.0,582.0
0.005,17,2,179,1,71,0.0,43.0,43.0,1,108,0.0,80.0,80.0
240.096,6,16,4482,9,963,30012.0,238.0,166.0,7,3519,40015.0,1402.0,786.0
0.092,6,10,1506,5,395,22.0,127.0,127.0,5,1111,19.0,843.0,843.0
0.103,6,10,1506,5,395,22.0,127.0,127.0,5,1111,24.0,843.0,843.0
0.008,17,2,194,1,59,0.0,31.0,31.0,1,135,0.0,107.0,107.0
0.077,6,10,1506,5,395,16.0,127.0,127.0,5,1111,17.0,843.0,843.0
0.0,17,2,180,1,66,0.0,38.0,38.0,1,114,0.0,86.0,86.0
0.005,6,13,3747,7,509,0.0,137.0,137.0,6,3238,0.0,1470.0,1459.0
0.121,6,10,1506,5,395,27.0,127.0,127.0,5,1111,26.0,843.0,843.0
15.094,17,17,10681,9,8290,1883.0,1350.0,893.0,8,2391,2151.0,1350.0,270.0
0.06,17,2,152,1,76,0.0,48.0,48.0,1,76,0.0,48.0,48.0
0.043,17,2,136,1,60,0.0,32.0,32.0,1,76,0.0,48.0,48.0
40.063,17,10,676,5,460,10013.0,104.0,64.0,5,216,10014.0,20.0,15.0
0.001,17,2,166,1,75,0.0,47.0,47.0,1,91,0.0,63.0,63.0
0.004,6,10,2000,5,927,1.0,659.0,659.0,5,1073,1.0,805.0,805.0
0.013,6,10,1990,5,911,3.0,643.0,643.0,5,1079,3.0,811.0,811.0
11.082,17,28,4416,14,1993,839.0,268.0,114.0,14,2423,840.0,586.0,145.0
0.011,6,10,1989,5,910,2.0,642.0,642.0,5,1079,2.0,811.0,811.0
10.865,17,28,4422,14,1993,827.0,268.0,114.0,14,2429,827.0,588.0,145.0
0.006,6,10,1547,5,764,1.0,496.0,496.0,5,783,1.0,515.0,515.0
0.005,6,10,1989,5,927,1.0,659.0,659.0,5,1062,1.0,794.0,794.0
0.004,6,10,2000,5,927,1.0,659.0,659.0,5,1073,1.0,805.0,805.0
0.014,6,10,1989,5,910,3.0,642.0,642.0,5,1079,3.0,811.0,811.0
0.088,6,10,1506,5,395,18.0,127.0,127.0,5,1111,19.0,843.0,843.0
352.245,6,20,2210,6,1308,12003.0,494.0,494.0,14,902,27095.0,83.0,83.0
0.161,17,2,152,1,76,0.0,48.0,48.0,1,76,0.0,48.0,48.0
0.01,6,10,1989,5,910,2.0,642.0,642.0,5,1079,2.0,811.0,811.0
0.005,17,4,284,2,120,0.0,32.0,32.0,2,164,0.0,60.0,54.0
0.01,6,12,1926,6,1189,1.0,659.0,434.0,6,737,2.0,417.0,417.0
0.097,6,10,1506,5,395,21.0,127.0,127.0,5,1111,21.0,843.0,843.0
0.025,6,20,9974,11,704,2.0,124.0,124.0,9,9270,3.0,2896.0,1758.0
40.072,17,10,676,5,460,10014.0,104.0,64.0,5,216,10017.0,20.0,15.0
0.001,17,2,180,1,66,0.0,38.0,38.0,1,114,0.0,86.0,86.0
0.16,17,2,152,1,76,0.0,48.0,48.0,1,76,0.0,48.0,48.0
0.008,6,10,1990,5,911,2.0,643.0,643.0,5,1079,1.0,811.0,811.0
319.678,6,55,18771,28,11579,11839.0,1612.0,675.0,27,7192,12295.0,2378.0,412.0
0.133,6,10,1506,5,395,31.0,127.0,127.0,5,1111,29.0,843.0,843.0
0.009,6,10,1677,5,827,2.0,559.0,559.0,5,850,2.0,582.0,582.0
0.07,17,8,3613,4,1874,23.0,1350.0,440.0,4,1739,12.0,1350.0,406.0
0.007,6,10,2007,5,928,1.0,660.0,660.0,5,1079,1.0,811.0,811.0
40.071,17,10,676,5,460,10014.0,104.0,64.0,5,216,10017.0,20.0,15.0
0.004,6,10,2000,5,927,1.0,659.0,659.0,5,1073,1.0,805.0,805.0
0.012,6,10,1762,5,911,3.0,643.0,643.0,5,851,2.0,583.0,583.0
0.157,6,10,1506,5,395,37.0,127.0,127.0,5,1111,34.0,843.0,843.0
0.013,6,12,1926,6,1189,2.0,659.0,434.0,6,737,2.0,417.0,417.0
0.017,6,10,1990,5,911,4.0,643.0,643.0,5,1079,4.0,811.0,811.0
0.013,6,10,1990,5,911,3.0,643.0,643.0,5,1079,3.0,811.0,811.0
0.005,6,10,2006,5,927,1.0,659.0,659.0,5,1079,1.0,811.0,811.0
0.071,6,10,1506,5,395,17.0,127.0,127.0,5,1111,14.0,843.0,843.0
0.006,17,2,255,1,82,0.0,54.0,54.0,1,173,0.0,145.0,145.0
0.036,17,2,136,1,60,0.0,32.0,32.0,1,76,0.0,48.0,48.0
0.283,17,40,20226,22,17095,13.0,1350.0,749.0,18,3131,11.0,1350.0,145.0
0.006,17,2,166,1,75,0.0,47.0,47.0,1,91,0.0,63.0,63.0
0.013,6,10,1989,5,910,3.0,642.0,642.0,5,1079,3.0,811.0,811.0
0.006,17,2,170,1,65,0.0,37.0,37.0,1,105,0.0,77.0,77.0
0.008,6,10,1972,5,910,2.0,642.0,642.0,5,1062,2.0,794.0,794.0
0.003,17,2,148,1,60,0.0,32.0,32.0,1,88,0.0,60.0,60.0
0.006,17,2,169,1,62,0.0,34.0,34.0,1,107,0.0,79.0,79.0
0.001,17,2,180,1,66,0.0,38.0,38.0,1,114,0.0,86.0,86.0
0.007,6,10,2007,5,928,1.0,660.0,660.0,5,1079,1.0,811.0,811.0
0.044,17,2,234,1,61,0.0,33.0,33.0,1,173,0.0,145.0,145.0
10.815,17,28,4419,14,1995,823.0,270.0,114.0,14,2424,823.0,587.0,145.0
0.001,17,2,140,1,62,0.0,34.0,34.0,1,78,0.0,50.0,50.0
0.121,6,10,1506,5,395,23.0,127.0,127.0,5,1111,27.0,843.0,843.0
0.01,6,10,1972,5,910,2.0,642.0,642.0,5,1062,2.0,794.0,794.0
0.004,6,10,1702,5,863,1.0,595.0,595.0,5,839,0.0,571.0,571.0
0.018,6,10,1989,5,910,4.0,642.0,642.0,5,1079,4.0,811.0,811.0
0.01,6,12,1926,6,1189,2.0,659.0,434.0,6,737,2.0,417.0,417.0
1794.277,6,557,189502,289,163976,6230.0,2883.0,891.0,268,25526,6720.0,386.0,115.0
0.08,6,10,1506,5,395,19.0,127.0,127.0,5,1111,16.0,843.0,843.0
0.123,6,10,1506,5,395,29.0,127.0,127.0,5,1111,26.0,843.0,843.0
0.072,17,2,146,1,65,0.0,37.0,37.0,1,81,0.0,53.0,53.0
0.006,6,10,1689,5,839,1.0,571.0,571.0,5,850,1.0,582.0,582.0
0.024,6,10,1762,5,911,5.0,643.0,643.0,5,851,5.0,583.0,583.0
0.007,17,2,179,1,71,0.0,43.0,43.0,1,108,0.0,80.0,80.0
300.32,6,16,2170,9,684,37519.0,146.0,146.0,7,1486,50025.0,419.0,398.0
0.101,6,10,1506,5,395,22.0,127.0,127.0,5,1111,21.0,843.0,843.0
0.004,6,10,1989,5,927,1.0,659.0,659.0,5,1062,1.0,794.0,794.0
0.088,6,10,1506,5,395,19.0,127.0,127.0,5,1111,20.0,843.0,843.0
0.005,17,2,164,1,74,0.0,46.0,46.0,1,90,0.0,62.0,62.0
0.102,6,10,1506,5,395,22.0,127.0,127.0,5,1111,23.0,843.0,843.0
0.014,17,2,152,1,56,0.0,28.0,28.0,1,96,0.0,68.0,68.0
0.005,17,2,180,1,58,0.0,30.0,30.0,1,122,0.0,94.0,94.0
0.006,6,10,1547,5,764,1.0,496.0,496.0,5,783,1.0,515.0,515.0
0.017,6,10,1983,5,910,4.0,642.0,642.0,5,1073,4.0,805.0,805.0
0.023,6,10,1989,5,910,5.0,642.0,642.0,5,1079,5.0,811.0,811.0
309.196,17,20,1124,10,716,34340.0,48.0,43.0,10,408,34340.0,20.0,12.0
15.097,17,14,9191,8,6902,2152.0,1350.0,834.0,6,2289,3009.0,1350.0,353.0
0.069,6,10,1506,5,395,16.0,127.0,127.0,5,1111,15.0,843.0,843.0
0.005,6,10,2007,5,928,1.0,660.0,660.0,5,1079,1.0,811.0,811.0
0.005,6,10,2007,5,928,1.0,660.0,660.0,5,1079,1.0,811.0,811.0
0.04,6,10,1631,5,848,9.0,580.0,580.0,5,783,10.0,515.0,515.0
0.012,6,10,1989,5,910,3.0,642.0,642.0,5,1079,3.0,811.0,811.0
0.007,6,10,2007,5,928,1.0,660.0,660.0,5,1079,1.0,811.0,811.0
0.001,17,2,180,1,65,0.0,37.0,37.0,1,115,0.0,87.0,87.0
0.065,6,10,1506,5,395,15.0,127.0,127.0,5,1111,14.0,843.0,843.0
0.091,6,10,1506,5,395,17.0,127.0,127.0,5,1111,19.0,843.0,843.0
0.004,17,4,284,2,120,0.0,32.0,32.0,2,164,0.0,60.0,54.0
0.005,6,10,2000,5,927,1.0,659.0,659.0,5,1073,1.0,805.0,805.0
0.016,6,10,1677,5,827,4.0,559.0,559.0,5,850,3.0,582.0,582.0
0.004,6,10,2006,5,927,1.0,659.0,659.0,5,1079,1.0,811.0,811.0
40.068,17,10,676,5,460,10016.0,104.0,64.0,5,216,10016.0,20.0,15.0
0.002,17,2,180,1,66,0.0,38.0,38.0,1,114,0.0,86.0,86.0
367.294,6,22,2313,16,867,24486.0,195.0,195.0,6,1446,4645.0,419.0,398.0
0.005,6,10,1643,5,860,1.0,592.0,592.0,5,783,1.0,515.0,515.0
0.005,6,10,1774,5,923,1.0,655.0,655.0,5,851,1.0,583.0,583.0
0.004,6,10,1774,5,923,1.0,655.0,655.0,5,851,1.0,583.0,583.0
0.01,6,10,1689,5,839,2.0,571.0,571.0,5,850,2.0,582.0,582.0
0.003,17,2,148,1,60,0.0,32.0,32.0,1,88,0.0,60.0,60.0
6.121,6,26,11881,14,1040,470.0,304.0,304.0,12,10841,556.0,1402.0,1134.0
0.014,6,10,1990,5,911,3.0,643.0,643.0,5,1079,3.0,811.0,811.0
0.015,6,10,1990,5,911,3.0,643.0,643.0,5,1079,3.0,811.0,811.0
0.005,6,10,2007,5,928,1.0,660.0,660.0,5,1079,1.0,811.0,811.0
0.007,6,10,1689,5,839,1.0,571.0,571.0,5,850,1.0,582.0,582.0
0.103,6,10,1506,5,395,23.0,127.0,127.0,5,1111,21.0,843.0,843.0
0.01,6,10,1989,5,910,2.0,642.0,642.0,5,1079,2.0,811.0,811.0
0.014,6,10,1989,5,910,3.0,642.0,642.0,5,1079,3.0,811.0,811.0
0.006,17,2,144,1,64,0.0,36.0,36.0,1,80,0.0,52.0,52.0
0.029,6,10,1989,5,910,7.0,642.0,642.0,5,1079,7.0,811.0,811.0
0.005,6,10,1643,5,860,1.0,592.0,592.0,5,783,1.0,515.0,515.0
0.014,6,10,1990,5,911,3.0,643.0,643.0,5,1079,3.0,811.0,811.0
0.017,6,14,3787,7,497,2.0,125.0,125.0,7,3290,2.0,1448.0,972.0
0.115,6,10,1506,5,395,22.0,127.0,127.0,5,1111,22.0,843.0,843.0
0.022,6,10,1990,5,911,5.0,643.0,643.0,5,1079,5.0,811.0,811.0
1.019,6,30,12352,17,3300,63.0,1360.0,517.0,13,9052,71.0,2720.0,1065.0
0.015,6,10,1989,5,910,3.0,642.0,642.0,5,1079,3.0,811.0,811.0
15.08,17,15,8302,8,6148,2150.0,1350.0,740.0,7,2154,2508.0,1350.0,279.0
240.167,6,48,6750,23,3288,10916.0,588.0,230.0,25,3462,10006.0,580.0,195.0
0.005,17,2,144,1,64,0.0,36.0,36.0,1,80,0.0,52.0,52.0
0.015,6,10,1990,5,911,3.0,643.0,643.0,5,1079,3.0,811.0,811.0
0.007,6,10,1643,5,860,1.0,592.0,592.0,5,783,1.0,515.0,515.0
0.132,6,10,1506,5,395,29.0,127.0,127.0,5,1111,29.0,843.0,843.0
0.016,6,10,1972,5,910,4.0,642.0,642.0,5,1062,3.0,794.0,794.0
0.111,6,44,14144,25,2617,4.0,517.0,146.0,19,11527,5.0,1402.0,752.0
0.118,6,10,1506,5,395,28.0,127.0,127.0,5,1111,25.0,843.0,843.0
0.009,6,10,1990,5,911,2.0,643.0,643.0,5,1079,2.0,811.0,811.0
0.006,6,10,1547,5,764,1.0,496.0,496.0,5,783,1.0,515.0,515.0
0.005,6,10,1989,5,927,1.0,659.0,659.0,5,1062,1.0,794.0,794.0
0.004,6,10,1702,5,863,1.0,595.0,595.0,5,839,1.0,571.0,571.0
0.089,6,10,1506,5,395,20.0,127.0,127.0,5,1111,20.0,843.0,843.0
368.421,6,22,2313,16,867,24561.0,195.0,195.0,6,1446,4657.0,419.0,398.0
364.437,6,21,1793,16,1030,24295.0,190.0,190.0,5,763,60013.0,462.0,247.0
0.006,6,10,1547,5,764,1.0,496.0,496.0,5,783,1.0,515.0,515.0
0.014,6,10,1989,5,910,3.0,642.0,642.0,5,1079,3.0,811.0,811.0
0.053,17,2,152,1,76,0.0,48.0,48.0,1,76,0.0,48.0,48.0
1778.418,17,144,45504,72,22752,25048.0,288.0,288.0,72,22752,25048.0,288.0,288.0
0.005,6,10,2000,5,927,1.0,659.0,659.0,5,1073,1.0,805.0,805.0
0.074,6,10,1506,5,395,16.0,127.0,127.0,5,1111,15.0,843.0,843.0
0.12,6,10,1506,5,395,23.0,127.0,127.0,5,1111,28.0,843.0,843.0
0.011,6,13,3735,7,497,1.0,125.0,125.0,6,3238,2.0,1470.0,1459.0
0.006,6,10,1547,5,764,1.0,496.0,496.0,5,783,1.0,515.0,515.0
240.225,6,36,10521,18,2215,14130.0,559.0,254.0,18,8306,14130.0,1402.0,614.0
0.015,6,10,1677,5,827,3.0,559.0,559.0,5,850,3.0,582.0,582.0
0.005,6,10,2006,5,927,1.0,659.0,659.0,5,1079,1.0,811.0,811.0
169.245,17,80,11442,40,2675,4339.0,44.0,38.0,40,8767,4339.0,261.0,191.0
366.038,6,22,2313,16,867,24402.0,195.0,195.0,6,1446,4642.0,419.0,398.0
0.038,17,2,152,1,76,0.0,48.0,48.0,1,76,0.0,48.0,48.0
0.017,6,10,1990,5,911,4.0,643.0,643.0,5,1079,4.0,811.0,811.0
0.009,6,10,1990,5,911,2.0,643.0,643.0,5,1079,2.0,811.0,811.0
165.272,17,68,9809,34,2267,5008.0,44.0,38.0,34,7542,5008.0,261.0,193.0
10.939,17,28,4422,14,1994,833.0,269.0,114.0,14,2428,832.0,587.0,145.0
0.004,17,2,136,1,60,0.0,32.0,32.0,1,76,0.0,48.0,48.0
0.005,6,10,2007,5,928,1.0,660.0,660.0,5,1079,1.0,811.0,811.0
240.259,6,43,8773,22,5738,11440.0,1368.0,458.0,21,3035,12012.0,580.0,241.0
0.003,17,2,136,1,60,0.0,32.0,32.0,1,76,0.0,48.0,48.0
0.008,6,10,1983,5,910,2.0,642.0,642.0,5,1073,2.0,805.0,805.0
0.015,6,10,1989,5,910,3.0,642.0,642.0,5,1079,3.0,811.0,811.0
0.011,6,10,1989,5,910,2.0,642.0,642.0,5,1079,2.0,811.0,811.0
15.078,17,16,8477,8,6247,2150.0,1350.0,752.0,8,2230,2149.0,1350.0,250.0
0.017,6,10,1983,5,910,4.0,642.0,642.0,5,1073,4.0,805.0,805.0
0.012,6,10,1762,5,911,2.0,643.0,643.0,5,851,2.0,583.0,583.0
0.004,6,10,2007,5,928,1.0,660.0,660.0,5,1079,1.0,811.0,811.0
0.006,6,10,1547,5,764,1.0,496.0,496.0,5,783,1.0,515.0,515.0
0.007,6,10,1689,5,839,1.0,571.0,571.0,5,850,1.0,582.0,582.0
300.354,6,16,2170,9,684,37523.0,146.0,146.0,7,1486,50030.0,419.0,398.0
0.001,17,2,180,1,66,0.0,38.0,38.0,1,114,0.0,86.0,86.0
0.11,6,10,1506,5,395,23.0,127.0,127.0,5,1111,23.0,843.0,843.0
0.124,6,10,1506,5,395,26.0,127.0,127.0,5,1111,27.0,843.0,843.0
0.006,6,10,1854,5,889,1.0,621.0,621.0,5,965,1.0,697.0,697.0
0.005,6,10,2006,5,927,1.0,659.0,659.0,5,1079,1.0,811.0,811.0
40.05,17,10,676,5,460,10011.0,104.0,64.0,5,216,10009.0,20.0,15.0
0.016,6,10,1990,5,911,3.0,643.0,643.0,5,1079,3.0,811.0,811.0
0.016,6,10,1990,5,911,4.0,643.0,643.0,5,1079,4.0,811.0,811.0
45.18,6,55,28232,28,22125,344.0,2720.0,1613.0,27,6107,1731.0,2667.0,385.0
0.008,6,10,1990,5,911,1.0,643.0,643.0,5,1079,2.0,811.0,811.0
241.383,6,301,343602,119,17707,2045.0,2736.0,886.0,182,325895,1333.0,2804.0,1839.0
0.005,6,10,1989,5,927,1.0,659.0,659.0,5,1062,1.0,794.0,794.0
0.008,6,10,1762,5,911,2.0,643.0,643.0,5,851,2.0,583.0,583.0
0.149,6,10,1506,5,395,24.0,127.0,127.0,5,1111,34.0,843.0,843.0
0.011,6,10,1972,5,910,2.0,642.0,642.0,5,1062,2.0,794.0,794.0
0.112,6,10,1506,5,395,23.0,127.0,127.0,5,1111,25.0,843.0,843.0
0.005,6,10,2006,5,927,1.0,659.0,659.0,5,1079,1.0,811.0,811.0
0.007,6,10,1972,5,910,1.0,642.0,642.0,5,1062,1.0,794.0,794.0
0.005,6,10,2006,5,927,1.0,659.0,659.0,5,1079,1.0,811.0,811.0
0.006,6,10,1547,5,764,1.0,496.0,496.0,5,783,1.0,515.0,515.0
40.06,17,10,676,5,460,10014.0,104.0,64.0,5,216,10014.0,20.0,15.0
0.078,6,10,1506,5,395,17.0,127.0,127.0,5,1111,18.0,843.0,843.0
0.005,6,10,2006,5,927,1.0,659.0,659.0,5,1079,1.0,811.0,811.0
0.023,6,10,1990,5,911,5.0,643.0,643.0,5,1079,5.0,811.0,811.0
9.04,17,6,376,5,280,2260.0,28.0,28.0,1,96,0.0,68.0,68.0
0.006,6,10,1643,5,860,1.0,592.0,592.0,5,783,1.0,515.0,515.0
0.006,6,10,1689,5,839,1.0,571.0,571.0,5,850,1.0,582.0,582.0
0.013,6,10,1989,5,910,3.0,642.0,642.0,5,1079,3.0,811.0,811.0
0.005,6,10,1643,5,860,1.0,592.0,592.0,5,783,1.0,515.0,515.0
40.06,17,10,676,5,460,10013.0,104.0,64.0,5,216,10014.0,20.0,15.0
0.003,17,2,148,1,60,0.0,32.0,32.0,1,88,0.0,60.0,60.0
0.004,6,10,2000,5,927,1.0,659.0,659.0,5,1073,1.0,805.0,805.0
40.054,17,10,676,5,460,10012.0,104.0,64.0,5,216,10012.0,20.0,15.0
0.013,6,10,1990,5,911,3.0,643.0,643.0,5,1079,3.0,811.0,811.0
0.01,6,10,1990,5,911,2.0,643.0,643.0,5,1079,2.0,811.0,811.0
0.006,6,10,1547,5,764,1.0,496.0,496.0,5,783,1.0,515.0,515.0
40.082,17,10,676,5,460,10019.0,104.0,64.0,5,216,10019.0,20.0,15.0
11.025,17,28,4417,14,1993,839.0,268.0,114.0,14,2424,839.0,587.0,145.0
0.113,6,10,1506,5,395,25.0,127.0,127.0,5,1111,26.0,843.0,843.0
0.012,6,10,1677,5,827,2.0,559.0,559.0,5,850,2.0,582.0,582.0
240.19,6,18,7343,10,2076,26687.0,1368.0,520.0,8,5267,34312.0,2803.0,1210.0
0.126,6,10,1242,5,751,31.0,495.0,495.0,5,491,29.0,223.0,223.0
0.006,6,10,1547,5,764,1.0,496.0,496.0,5,783,1.0,515.0,515.0
0.005,6,10,1854,5,889,1.0,621.0,621.0,5,965,1.0,697.0,697.0
0.012,6,10,1983,5,910,3.0,642.0,642.0,5,1073,3.0,805.0,805.0
0.009,6,10,1990,5,911,2.0,643.0,643.0,5,1079,2.0,811.0,811.0
0.088,6,10,1506,5,395,17.0,127.0,127.0,5,1111,20.0,843.0,843.0
0.005,6,10,2006,5,927,1.0,659.0,659.0,5,1079,1.0,811.0,811.0
0.005,17,2,213,1,69,0.0,41.0,41.0,1,144,0.0,116.0,116.0
0.005,17,2,179,1,71,0.0,43.0,43.0,1,108,0.0,80.0,80.0
0.005,17,2,213,1,69,0.0,41.0,41.0,1,144,0.0,116.0,116.0
0.105,6,10,1506,5,395,22.0,127.0,127.0,5,1111,22.0,843.0,843.0
0.014,6,10,1677,5,827,3.0,559.0,559.0,5,850,3.0,582.0,582.0
0.005,17,2,182,1,65,0.0,37.0,37.0,1,117,0.0,89.0,89.0
0.009,6,10,1990,5,911,2.0,643.0,643.0,5,1079,2.0,811.0,811.0
0.005,6,10,2007,5,928,1.0,660.0,660.0,5,1079,1.0,811.0,811.0
0.07,6,10,1506,5,395,14.0,127.0,127.0,5,1111,16.0,843.0,843.0
0.005,6,10,1989,5,927,1.0,659.0,659.0,5,1062,1.0,794.0,794.0
0.009,6,10,1762,5,911,2.0,643.0,643.0,5,851,2.0,583.0,583.0
0.005,6,10,1689,5,839,1.0,571.0,571.0,5,850,1.0,582.0,582.0
0.094,6,10,1506,5,395,22.0,127.0,127.0,5,1111,20.0,843.0,843.0
0.009,6,10,1972,5,910,2.0,642.0,642.0,5,1062,2.0,794.0,794.0
0.007,6,10,1989,5,910,1.0,642.0,642.0,5,1079,1.0,811.0,811.0
0.004,6,10,2000,5,927,1.0,659.0,659.0,5,1073,1.0,805.0,805.0
0.005,6,10,1990,5,928,1.0,660.0,660.0,5,1062,1.0,794.0,794.0
40.062,17,10,676,5,460,10014.0,104.0,64.0,5,216,10014.0,20.0,15.0
0.012,6,13,3735,7,497,1.0,125.0,125.0,6,3238,2.0,1470.0,1459.0
0.077,6,10,1506,5,395,16.0,127.0,127.0,5,1111,17.0,843.0,843.0
326.19,17,20,1124,10,716,36236.0,48.0,43.0,10,408,36236.0,20.0,12.0
0.001,17,2,140,1,62,0.0,34.0,34.0,1,78,0.0,50.0,50.0
0.08,6,10,1506,5,395,19.0,127.0,127.0,5,1111,18.0,843.0,843.0
0.005,17,4,495,2,132,0.0,38.0,38.0,2,363,3.0,176.0,153.0
0.005,6,10,2006,5,927,1.0,659.0,659.0,5,1079,1.0,811.0,811.0
0.114,6,10,1506,5,395,25.0,127.0,127.0,5,1111,26.0,843.0,843.0
0.005,6,10,2000,5,927,1.0,659.0,659.0,5,1073,1.0,805.0,805.0
354.078,6,21,1795,16,1030,23605.0,190.0,190.0,5,765,60003.0,464.0,248.0
0.004,6,10,1779,5,928,1.0,660.0,660.0,5,851,1.0,583.0,583.0
0.018,6,10,1631,5,848,4.0,580.0,580.0,5,783,4.0,515.0,515.0
0.001,17,2,136,1,60,0.0,32.0,32.0,1,76,0.0,48.0,48.0
10.789,17,28,4423,14,1995,821.0,270.0,114.0,14,2428,821.0,587.0,145.0
0.072,6,10,1506,5,395,17.0,127.0,127.0,5,1111,16.0,843.0,843.0
0.011,6,10,1989,5,910,2.0,642.0,642.0,5,1079,2.0,811.0,811.0
0.008,6,10,2006,5,927,1.0,659.0,659.0,5,1079,2.0,811.0,811.0
0.006,6,10,1854,5,889,1.0,621.0,621.0,5,965,1.0,697.0,697.0
0.008,6,10,1774,5,923,1.0,655.0,655.0,5,851,1.0,583.0,583.0
1770.791,6,84,4422,42,2211,43189.0,27.0,27.0,42,2211,43189.0,27.0,27.0
0.009,6,10,1990,5,911,2.0,643.0,643.0,5,1079,2.0,811.0,811.0
0.001,17,2,180,1,66,0.0,38.0,38.0,1,114,0.0,86.0,86.0
300.089,6,19,4661,11,1102,30008.0,238.0,130.0,8,3559,42869.0,1402.0,786.0
0.013,6,10,1972,5,910,3.0,642.0,642.0,5,1062,3.0,794.0,794.0
0.02,6,10,1631,5,848,5.0,580.0,580.0,5,783,5.0,515.0,515.0
0.123,6,10,1506,5,395,28.0,127.0,127.0,5,1111,30.0,843.0,843.0
0.008,17,2,194,1,59,0.0,31.0,31.0,1,135,0.0,107.0,107.0
0.008,6,10,1989,5,910,2.0,642.0,642.0,5,1079,1.0,811.0,811.0
0.015,6,10,1972,5,910,3.0,642.0,642.0,5,1062,3.0,794.0,794.0
0.122,6,10,1506,5,395,29.0,127.0,127.0,5,1111,25.0,843.0,843.0
0.005,17,2,214,1,75,0.0,47.0,47.0,1,139,0.0,111.0,111.0
0.129,17,2,80,1,32,0.0,4.0,4.0,1,48,0.0,20.0,20.0
0.124,6,10,1506,5,395,26.0,127.0,127.0,5,1111,27.0,843.0,843.0
0.011,6,10,1631,5,848,2.0,580.0,580.0,5,783,2.0,515.0,515.0
0.006,6,10,1643,5,860,1.0,592.0,592.0,5,783,1.0,515.0,515.0
0.015,6,10,1990,5,911,3.0,643.0,643.0,5,1079,3.0,811.0,811.0
0.016,6,10,1631,5,848,4.0,580.0,580.0,5,783,3.0,515.0,515.0
0.005,6,10,2007,5,928,1.0,660.0,660.0,5,1079,1.0,811.0,811.0
0.041,17,2,136,1,60,0.0,32.0,32.0,1,76,0.0,48.0,48.0
0.006,6,10,1547,5,764,1.0,496.0,496.0,5,783,1.0,515.0,515.0
240.088,6,16,4481,9,963,30011.0,238.0,166.0,7,3518,40014.0,1402.0,786.0
0.005,6,10,2007,5,928,1.0,660.0,660.0,5,1079,1.0,811.0,811.0
1778.468,17,144,41760,72,22752,25048.0,288.0,288.0,72,19008,25048.0,236.0,236.0
0.006,6,14,3799,7,509,1.0,137.0,137.0,7,3290,0.0,1448.0,972.0
0.005,6,10,2007,5,928,1.0,660.0,660.0,5,1079,1.0,811.0,811.0
5.108,6,23,6562,13,1500,425.0,474.0,201.0,10,5062,567.0,1925.0,757.0
0.014,6,10,1983,5,910,3.0,642.0,642.0,5,1073,3.0,805.0,805.0
15.295,17,51,27059,28,23568,565.0,1350.0,813.0,23,3491,693.0,1350.0,123.0
0.009,6,10,1989,5,910,2.0,642.0,642.0,5,1079,2.0,811.0,811.0
0.149,6,10,1506,5,395,36.0,127.0,127.0,5,1111,31.0,843.0,843.0
0.006,17,2,179,1,71,0.0,43.0,43.0,1,108,0.0,80.0,80.0
0.005,6,13,3747,7,509,0.0,137.0,137.0,6,3238,0.0,1470.0,1459.0
0.338,17,46,26092,26,19945,13.0,1350.0,739.0,20,6147,14.0,1350.0,279.0
0.005,6,10,1689,5,839,1.0,571.0,571.0,5,850,1.0,582.0,582.0
40.055,17,10,676,5,460,10012.0,104.0,64.0,5,216,10012.0,20.0,15.0
0.006,6,10,2007,5,928,1.0,660.0,660.0,5,1079,1.0,811.0,811.0
0.004,6,10,1989,5,927,1.0,659.0,659.0,5,1062,1.0,794.0,794.0
0.005,6,10,2007,5,928,1.0,660.0,660.0,5,1079,1.0,811.0,811.0
0.098,6,10,1506,5,395,21.0,127.0,127.0,5,1111,21.0,843.0,843.0
0.005,6,10,2007,5,928,1.0,660.0,660.0,5,1079,1.0,811.0,811.0
361.797,6,19,1689,15,978,25842.0,190.0,190.0,4,711,80012.0,495.0,495.0
40.055,17,10,676,5,460,10012.0,104.0,64.0,5,216,10012.0,20.0,15.0
0.013,6,10,1983,5,910,3.0,642.0,642.0,5,1073,3.0,805.0,805.0
0.008,6,10,1631,5,848,2.0,580.0,580.0,5,783,2.0,515.0,515.0
0.012,6,10,1983,5,910,3.0,642.0,642.0,5,1073,2.0,805.0,805.0
0.001,17,2,179,1,62,0.0,34.0,34.0,1,117,0.0,89.0,89.0
0.107,6,10,1506,5,395,23.0,127.0,127.0,5,1111,23.0,843.0,843.0
0.04,17,4,364,2,160,0.0,52.0,52.0,2,204,2.0,80.0,74.0
240.096,6,32,9420,16,6961,16006.0,2034.0,681.0,16,2459,16006.0,580.0,202.0
0.109,6,10,1506,5,395,24.0,127.0,127.0,5,1111,25.0,843.0,843.0
0.073,6,10,1506,5,395,17.0,127.0,127.0,5,1111,13.0,843.0,843.0
15.079,17,16,9302,8,6912,2149.0,1350.0,836.0,8,2390,2149.0,1350.0,270.0
0.005,6,10,1689,5,839,1.0,571.0,571.0,5,850,1.0,582.0,582.0
0.096,6,10,1506,5,395,19.0,127.0,127.0,5,1111,21.0,843.0,843.0
290.925,6,318,344621,123,17943,2384.0,2736.0,825.0,195,326678,1499.0,2947.0,1748.0
0.005,6,10,2007,5,928,1.0,660.0,660.0,5,1079,1.0,811.0,811.0
10.812,17,28,4421,14,1994,823.0,269.0,114.0,14,2427,822.0,586.0,145.0
0.098,6,10,1506,5,395,21.0,127.0,127.0,5,1111,20.0,843.0,843.0
0.005,6,14,3799,7,509,0.0,137.0,137.0,7,3290,0.0,1448.0,972.0
0.001,17,2,180,1,66,0.0,38.0,38.0,1,114,0.0,86.0,86.0
0.008,6,12,1926,6,1189,1.0,659.0,434.0,6,737,1.0,417.0,417.0
0.005,6,10,2007,5,928,1.0,660.0,660.0,5,1079,1.0,811.0,811.0
309.367,17,20,1124,10,716,34362.0,48.0,43.0,10,408,34361.0,20.0,12.0
0.011,6,10,1972,5,910,2.0,642.0,642.0,5,1062,2.0,794.0,794.0
241.54,6,403,348379,200,21945,1213.0,2736.0,959.0,203,326434,1195.0,2804.0,1636.0
0.004,6,10,1702,5,863,1.0,595.0,595.0,5,839,0.0,571.0,571.0
0.238,17,4,596,2,122,201.0,33.0,33.0,2,474,166.0,323.0,209.0
10.893,17,28,4421,14,1994,829.0,269.0,114.0,14,2427,829.0,586.0,145.0
0.005,6,10,2006,5,927,1.0,659.0,659.0,5,1079,1.0,811.0,811.0
0.141,6,10,1506,5,395,32.0,127.0,127.0,5,1111,29.0,843.0,843.0
0.071,6,10,1506,5,395,16.0,127.0,127.0,5,1111,16.0,843.0,843.0
1799.981,6,138,6704,77,3704,23683.0,39.0,39.0,61,3000,29995.0,35.0,35.0
0.015,6,10,1972,5,910,3.0,642.0,642.0,5,1062,3.0,794.0,794.0
0.013,6,10,1983,5,910,3.0,642.0,642.0,5,1073,3.0,805.0,805.0
0.093,17,2,152,1,76,0.0,48.0,48.0,1,76,0.0,48.0,48.0
0.214,6,16,2668,8,1394,30.0,533.0,323.0,8,1274,19.0,529.0,212.0
0.003,17,2,136,1,60,0.0,32.0,32.0,1,76,0.0,48.0,48.0
0.006,6,10,1547,5,764,1.0,496.0,496.0,5,783,1.0,515.0,515.0
0.007,6,10,1689,5,839,1.0,571.0,571.0,5,850,1.0,582.0,582.0
0.025,6,10,1972,5,910,6.0,642.0,642.0,5,1062,6.0,794.0,794.0
0.005,6,10,1643,5,860,1.0,592.0,592.0,5,783,1.0,515.0,515.0
0.001,17,2,180,1,66,0.0,38.0,38.0,1,114,0.0,86.0,86.0
47.179,6,38,8127,19,2524,489.0,1367.0,573.0,19,5603,2611.0,2667.0,402.0
300.398,6,27,8925,15,1930,21457.0,517.0,285.0,12,6995,21852.0,1402.0,909.0
0.001,17,2,136,1,60,0.0,32.0,32.0,1,76,0.0,48.0,48.0
0.003,6,10,1702,5,863,0.0,595.0,595.0,5,839,0.0,571.0,571.0
0.089,6,10,1506,5,395,20.0,127.0,127.0,5,1111,18.0,843.0,843.0
0.004,6,10,1702,5,863,1.0,595.0,595.0,5,839,0.0,571.0,571.0
0.17,6,3,453,2,321,170.0,241.0,241.0,1,132,0.0,92.0,92.0
0.005,6,10,2007,5,928,1.0,660.0,660.0,5,1079,1.0,811.0,811.0
0.004,6,10,2006,5,927,1.0,659.0,659.0,5,1079,1.0,811.0,811.0
0.084,6,10,1506,5,395,17.0,127.0,127.0,5,1111,20.0,843.0,843.0
0.092,6,10,1506,5,395,20.0,127.0,127.0,5,1111,21.0,843.0,843.0
0.008,6,10,1677,5,827,2.0,559.0,559.0,5,850,2.0,582.0,582.0
0.01,6,10,1989,5,910,2.0,642.0,642.0,5,1079,2.0,811.0,811.0
0.012,6,10,1972,5,910,3.0,642.0,642.0,5,1062,3.0,794.0,794.0
0.016,6,13,3735,7,497,2.0,125.0,125.0,6,3238,3.0,1470.0,1459.0
0.095,6,10,1506,5,395,21.0,127.0,127.0,5,1111,17.0,843.0,843.0
0.013,17,2,152,1,56,0.0,28.0,28.0,1,96,0.0,68.0,68.0
0.005,6,10,1689,5,839,1.0,571.0,571.0,5,850,1.0,582.0,582.0
0.018,6,10,1989,5,910,4.0,642.0,642.0,5,1079,4.0,811.0,811.0
0.094,6,10,1506,5,395,22.0,127.0,127.0,5,1111,16.0,843.0,843.0
0.005,6,10,1989,5,927,1.0,659.0,659.0,5,1062,1.0,794.0,794.0
0.06,17,2,152,1,76,0.0,48.0,48.0,1,76,0.0,48.0,48.0
0.005,6,10,2000,5,927,1.0,659.0,659.0,5,1073,1.0,805.0,805.0
0.001,17,2,180,1,66,0.0,38.0,38.0,1,114,0.0,86.0,86.0
0.004,6,10,2007,5,928,1.0,660.0,660.0,5,1079,1.0,811.0,811.0
0.018,6,10,1972,5,910,4.0,642.0,642.0,5,1062,4.0,794.0,794.0
0.006,6,10,1689,5,839,1.0,571.0,571.0,5,850,1.0,582.0,582.0
40.061,17,10,676,5,460,10013.0,104.0,64.0,5,216,10014.0,20.0,15.0
0.005,6,14,3799,7,509,0.0,137.0,137.0,7,3290,0.0,1448.0,972.0
0.012,6,10,1983,5,910,2.0,642.0,642.0,5,1073,2.0,805.0,805.0
0.005,6,10,1689,5,839,1.0,571.0,571.0,5,850,1.0,582.0,582.0
0.104,6,10,1506,5,395,19.0,127.0,127.0,5,1111,22.0,843.0,843.0
0.01,6,12,1926,6,1189,2.0,659.0,434.0,6,737,1.0,417.0,417.0
0.072,6,10,1506,5,395,16.0,127.0,127.0,5,1111,13.0,843.0,843.0
0.005,6,10,2006,5,927,1.0,659.0,659.0,5,1079,1.0,811.0,811.0
15.124,17,16,10077,7,4635,2516.0,1350.0,634.0,9,5442,1886.0,1350.0,576.0
1799.639,17,2512,192353,1250,101312,1440.0,84.0,53.0,1262,91041,1427.0,227.0,44.0
0.017,6,10,1989,5,910,4.0,642.0,642.0,5,1079,4.0,811.0,811.0
0.012,6,10,1983,5,910,3.0,642.0,642.0,5,1073,3.0,805.0,805.0
0.006,6,10,1689,5,839,1.0,571.0,571.0,5,850,1.0,582.0,582.0
0.006,6,10,1547,5,764,1.0,496.0,496.0,5,783,1.0,515.0,515.0
0.005,17,2,148,1,60,0.0,32.0,32.0,1,88,0.0,60.0,60.0
0.005,6,10,1547,5,764,1.0,496.0,496.0,5,783,1.0,515.0,515.0
379.53,6,22,2313,16,867,25302.0,195.0,195.0,6,1446,4642.0,419.0,398.0
5.09,6,21,5923,12,1436,462.0,474.0,201.0,9,4487,635.0,1925.0,804.0
0.005,6,10,2000,5,927,1.0,659.0,659.0,5,1073,1.0,805.0,805.0
1793.846,6,302,52123,124,34572,14583.0,2720.0,298.0,178,17551,10134.0,1360.0,128.0
0.005,6,10,2000,5,927,1.0,659.0,659.0,5,1073,1.0,805.0,805.0
0.016,6,10,1989,5,910,4.0,642.0,642.0,5,1079,3.0,811.0,811.0
0.118,6,10,1506,5,395,27.0,127.0,127.0,5,1111,27.0,843.0,843.0
40.436,6,33,6264,18,1338,2378.0,267.0,195.0,15,4926,607.0,1823.0,392.0
0.005,6,10,1989,5,927,1.0,659.0,659.0,5,1062,1.0,794.0,794.0
0.083,6,10,1506,5,395,19.0,127.0,127.0,5,1111,17.0,843.0,843.0
0.008,6,10,1990,5,911,2.0,643.0,643.0,5,1079,1.0,811.0,811.0
354.054,6,21,1795,16,1030,23603.0,190.0,190.0,5,765,60001.0,464.0,248.0
0.005,6,10,1989,5,927,1.0,659.0,659.0,5,1062,1.0,794.0,794.0
0.004,6,10,2007,5,928,1.0,660.0,660.0,5,1079,1.0,811.0,811.0
241.871,6,381,347204,196,21715,1240.0,2736.0,885.0,185,325489,1314.0,2804.0,1804.0
40.063,17,10,676,5,460,10013.0,104.0,64.0,5,216,10015.0,20.0,15.0
0.004,6,10,1989,5,927,1.0,659.0,659.0,5,1062,1.0,794.0,794.0
0.052,17,2,152,1,76,0.0,48.0,48.0,1,76,0.0,48.0,48.0
0.024,6,10,1989,5,910,5.0,642.0,642.0,5,1079,5.0,811.0,811.0
0.006,6,10,1989,5,927,1.0,659.0,659.0,5,1062,1.0,794.0,794.0
0.142,6,10,1506,5,395,34.0,127.0,127.0,5,1111,33.0,843.0,843.0
0.005,6,14,3742,7,452,0.0,80.0,80.0,7,3290,0.0,1448.0,972.0
0.006,6,10,1989,5,927,1.0,659.0,659.0,5,1062,1.0,794.0,794.0
0.007,17,2,214,1,75,0.0,47.0,47.0,1,139,0.0,111.0,111.0
0.01,6,10,1989,5,910,2.0,642.0,642.0,5,1079,2.0,811.0,811.0
300.705,6,29,8797,14,2476,23131.0,1224.0,348.0,15,6321,21478.0,1592.0,616.0
0.036,17,2,182,1,65,0.0,37.0,37.0,1,117,0.0,89.0,89.0
0.006,6,10,1547,5,764,1.0,496.0,496.0,5,783,1.0,515.0,515.0
0.004,6,10,1989,5,927,1.0,659.0,659.0,5,1062,1.0,794.0,794.0
0.025,6,10,1605,5,388,6.0,120.0,120.0,5,1217,6.0,949.0,949.0
0.005,17,2,169,1,62,0.0,34.0,34.0,1,107,0.0,79.0,79.0
0.014,6,11,1814,6,963,2.0,643.0,643.0,5,851,3.0,583.0,583.0
0.069,6,10,1506,5,395,15.0,127.0,127.0,5,1111,16.0,843.0,843.0
0.005,6,10,1989,5,927,1.0,659.0,659.0,5,1062,1.0,794.0,794.0
0.006,6,10,2007,5,928,1.0,660.0,660.0,5,1079,1.0,811.0,811.0
0.006,6,10,1643,5,860,1.0,592.0,592.0,5,783,1.0,515.0,515.0
0.123,6,10,1506,5,395,27.0,127.0,127.0,5,1111,30.0,843.0,843.0
0.005,17,2,230,1,68,0.0,40.0,40.0,1,162,0.0,134.0,134.0
0.11,6,10,1506,5,395,25.0,127.0,127.0,5,1111,25.0,843.0,843.0
0.087,6,10,1506,5,395,19.0,127.0,127.0,5,1111,20.0,843.0,843.0
0.058,6,10,1506,5,395,12.0,127.0,127.0,5,1111,13.0,843.0,843.0
0.091,6,10,1506,5,395,20.0,127.0,127.0,5,1111,21.0,843.0,843.0
0.005,6,10,1774,5,923,1.0,655.0,655.0,5,851,1.0,583.0,583.0
0.004,6,10,2007,5,928,1.0,660.0,660.0,5,1079,1.0,811.0,811.0
0.006,6,12,1698,6,863,1.0,327.0,271.0,6,835,1.0,515.0,515.0
11.093,17,28,4423,14,1994,841.0,269.0,114.0,14,2429,841.0,588.0,145.0
0.005,6,10,1774,5,923,1.0,655.0,655.0,5,851,1.0,583.0,583.0
40.063,17,10,676,5,460,10015.0,104.0,64.0,5,216,10014.0,20.0,15.0
0.045,17,2,234,1,61,0.0,33.0,33.0,1,173,0.0,145.0,145.0
0.007,17,2,179,1,71,0.0,43.0,43.0,1,108,0.0,80.0,80.0
240.098,6,31,7785,15,5546,17149.0,1515.0,528.0,16,2239,16006.0,580.0,174.0
0.012,6,10,1677,5,827,3.0,559.0,559.0,5,850,3.0,582.0,582.0
0.086,6,10,1506,5,395,17.0,127.0,127.0,5,1111,19.0,843.0,843.0
0.024,17,4,284,2,120,0.0,32.0,32.0,2,164,0.0,60.0,54.0
0.006,17,2,166,1,75,0.0,47.0,47.0,1,91,0.0,63.0,63.0
0.006,6,10,1989,5,927,1.0,659.0,659.0,5,1062,1.0,794.0,794.0
0.027,6,10,1990,5,911,6.0,643.0,643.0,5,1079,6.0,811.0,811.0
0.013,6,10,1989,5,910,3.0,642.0,642.0,5,1079,3.0,811.0,811.0
369.93,6,24,2405,17,919,23120.0,195.0,195.0,7,1486,3904.0,419.0,398.0
0.006,6,10,2000,5,927,1.0,659.0,659.0,5,1073,1.0,805.0,805.0
0.072,17,2,182,1,65,0.0,37.0,37.0,1,117,0.0,89.0,89.0
0.006,17,2,230,1,68,0.0,40.0,40.0,1,162,0.0,134.0,134.0
0.006,6,10,1643,5,860,1.0,592.0,592.0,5,783,1.0,515.0,515.0
40.055,17,10,676,5,460,10013.0,104.0,64.0,5,216,10013.0,20.0,15.0
0.005,17,2,144,1,64,0.0,36.0,36.0,1,80,0.0,52.0,52.0
0.006,17,2,179,1,71,0.0,43.0,43.0,1,108,0.0,80.0,80.0
0.008,6,10,1989,5,910,2.0,642.0,642.0,5,1079,1.0,811.0,811.0
0.012,6,12,1926,6,1189,2.0,659.0,434.0,6,737,2.0,417.0,417.0
0.067,17,2,152,1,76,0.0,48.0,48.0,1,76,0.0,48.0,48.0
0.006,6,13,3747,7,509,0.0,137.0,137.0,6,3238,1.0,1470.0,1459.0
0.003,17,4,284,2,120,0.0,32.0,32.0,2,164,0.0,60.0,54.0
0.003,17,2,148,1,60,0.0,32.0,32.0,1,88,0.0,60.0,60.0
0.01,6,10,1762,5,911,2.0,643.0,643.0,5,851,2.0,583.0,583.0
0.005,6,10,2006,5,927,1.0,659.0,659.0,5,1079,1.0,811.0,811.0
0.029,6,10,1989,5,910,7.0,642.0,642.0,5,1079,7.0,811.0,811.0
0.084,6,10,1506,5,395,19.0,127.0,127.0,5,1111,19.0,843.0,843.0
0.068,6,10,1506,5,395,15.0,127.0,127.0,5,1111,16.0,843.0,843.0
0.09,6,10,1506,5,395,20.0,127.0,127.0,5,1111,20.0,843.0,843.0
0.096,6,10,1506,5,395,21.0,127.0,127.0,5,1111,20.0,843.0,843.0
0.006,6,10,1774,5,923,1.0,655.0,655.0,5,851,1.0,583.0,583.0
0.014,6,13,3735,7,497,2.0,125.0,125.0,6,3238,2.0,1470.0,1459.0
0.01,6,10,1989,5,910,2.0,642.0,642.0,5,1079,2.0,811.0,811.0
0.01,6,10,1972,5,910,2.0,642.0,642.0,5,1062,2.0,794.0,794.0
0.021,6,10,1762,5,911,5.0,643.0,643.0,5,851,5.0,583.0,583.0
0.04,17,2,152,1,76,0.0,48.0,48.0,1,76,0.0,48.0,48.0
0.007,6,10,1643,5,860,1.0,592.0,592.0,5,783,1.0,515.0,515.0
0.005,6,10,1643,5,860,1.0,592.0,592.0,5,783,1.0,515.0,515.0
0.097,6,10,1506,5,395,22.0,127.0,127.0,5,1111,21.0,843.0,843.0
0.007,17,2,162,1,65,0.0,37.0,37.0,1,97,0.0,69.0,69.0
240.085,6,16,4481,9,963,30010.0,238.0,166.0,7,3518,40013.0,1402.0,786.0
0.004,6,10,2006,5,927,1.0,659.0,659.0,5,1079,1.0,811.0,811.0
0.005,17,2,169,1,62,0.0,34.0,34.0,1,107,0.0,79.0,79.0
0.012,6,10,1989,5,910,3.0,642.0,642.0,5,1079,3.0,811.0,811.0
0.014,6,10,1989,5,910,3.0,642.0,642.0,5,1079,3.0,811.0,811.0
0.006,17,2,140,1,62,0.0,34.0,34.0,1,78,0.0,50.0,50.0
0.023,6,10,1631,5,848,5.0,580.0,580.0,5,783,5.0,515.0,515.0
0.013,6,10,1989,5,910,3.0,642.0,642.0,5,1079,3.0,811.0,811.0
0.089,6,10,1506,5,395,21.0,127.0,127.0,5,1111,17.0,843.0,843.0
15.073,17,15,9238,8,6902,2149.0,1350.0,834.0,7,2336,2507.0,1350.0,305.0
0.004,17,2,144,1,64,0.0,36.0,36.0,1,80,0.0,52.0,52.0
0.013,6,10,1972,5,910,3.0,642.0,642.0,5,1062,3.0,794.0,794.0
0.009,6,10,1854,5,889,2.0,621.0,621.0,5,965,2.0,697.0,697.0
0.004,6,10,2000,5,927,1.0,659.0,659.0,5,1073,1.0,805.0,805.0
0.001,17,2,180,1,66,0.0,38.0,38.0,1,114,0.0,86.0,86.0
0.084,6,10,1506,5,395,17.0,127.0,127.0,5,1111,18.0,843.0,843.0
0.04,6,10,1972,5,910,10.0,642.0,642.0,5,1062,9.0,794.0,794.0
0.019,6,10,1990,5,911,4.0,643.0,643.0,5,1079,4.0,811.0,811.0
40.063,17,10,676,5,460,10015.0,104.0,64.0,5,216,10014.0,20.0,15.0
0.005,6,10,2006,5,927,1.0,659.0,659.0,5,1079,1.0,811.0,811.0
15.07,17,15,9238,8,6902,2148.0,1350.0,834.0,7,2336,2506.0,1350.0,305.0
15.079,17,15,8118,8,5948,2150.0,1350.0,715.0,7,2170,2508.0,1350.0,282.0
0.008,6,10,1779,5,928,2.0,660.0,660.0,5,851,2.0,583.0,583.0
0.085,6,10,1506,5,395,19.0,127.0,127.0,5,1111,19.0,843.0,843.0
0.005,6,10,2007,5,928,1.0,660.0,660.0,5,1079,1.0,811.0,811.0
0.005,6,10,2007,5,928,1.0,660.0,660.0,5,1079,1.0,811.0,811.0
40.057,17,10,676,5,460,10013.0,104.0,64.0,5,216,10013.0,20.0,15.0
309.011,17,20,1124,10,716,34323.0,48.0,43.0,10,408,34324.0,20.0,12.0
0.009,6,13,3735,7,497,1.0,125.0,125.0,6,3238,1.0,1470.0,1459.0
0.008,6,10,1989,5,910,2.0,642.0,642.0,5,1079,1.0,811.0,811.0
0.007,6,10,1547,5,764,1.0,496.0,496.0,5,783,1.0,515.0,515.0
0.012,6,10,1972,5,910,2.0,642.0,642.0,5,1062,2.0,794.0,794.0
0.006,6,10,1689,5,839,1.0,571.0,571.0,5,850,1.0,582.0,582.0
0.144,6,10,1506,5,395,32.0,127.0,127.0,5,1111,33.0,843.0,843.0
69.598,6,23,8984,11,1295,82.0,514.0,274.0,12,7689,6314.0,1360.0,1028.0
0.052,17,2,152,1,76,0.0,48.0,48.0,1,76,0.0,48.0,48.0
0.005,17,2,170,1,65,0.0,37.0,37.0,1,105,0.0,77.0,77.0
0.004,17,4,284,2,120,0.0,32.0,32.0,2,164,0.0,60.0,54.0
0.052,17,2,152,1,76,0.0,48.0,48.0,1,76,0.0,48.0,48.0
0.005,6,10,2006,5,927,1.0,659.0,659.0,5,1079,1.0,811.0,811.0
0.098,6,10,1506,5,395,22.0,127.0,127.0,5,1111,22.0,843.0,843.0
0.008,6,12,1926,6,1189,1.0,659.0,434.0,6,737,1.0,417.0,417.0
0.006,6,10,2007,5,928,1.0,660.0,660.0,5,1079,1.0,811.0,811.0
0.005,17,2,178,1,81,0.0,53.0,53.0,1,97,0.0,69.0,69.0
0.005,6,10,2007,5,928,1.0,660.0,660.0,5,1079,1.0,811.0,811.0
0.013,17,2,152,1,56,0.0,28.0,28.0,1,96,0.0,68.0,68.0
240.011,6,9,787,5,488,60002.0,232.0,232.0,4,299,80002.0,83.0,83.0
0.006,6,10,1779,5,928,1.0,660.0,660.0,5,851,1.0,583.0,583.0
0.006,6,10,1854,5,889,1.0,621.0,621.0,5,965,1.0,697.0,697.0
0.005,17,2,140,1,62,0.0,34.0,34.0,1,78,0.0,50.0,50.0
0.081,17,2,144,1,64,0.0,36.0,36.0,1,80,0.0,52.0,52.0
0.08,6,10,1506,5,395,18.0,127.0,127.0,5,1111,18.0,843.0,843.0
0.005,6,10,1689,5,839,1.0,571.0,571.0,5,850,1.0,582.0,582.0
0.005,17,2,230,1,68,0.0,40.0,40.0,1,162,0.0,134.0,134.0
0.005,6,10,1989,5,927,1.0,659.0,659.0,5,1062,1.0,794.0,794.0
0.005,6,10,1643,5,860,1.0,592.0,592.0,5,783,1.0,515.0,515.0
40.084,17,10,676,5,460,10017.0,104.0,64.0,5,216,10020.0,20.0,15.0
0.119,6,10,1506,5,395,25.0,127.0,127.0,5,1111,29.0,843.0,843.0
0.078,6,10,1506,5,395,17.0,127.0,127.0,5,1111,16.0,843.0,843.0
0.01,6,10,1989,5,910,2.0,642.0,642.0,5,1079,2.0,811.0,811.0
0.005,6,10,1547,5,764,1.0,496.0,496.0,5,783,1.0,515.0,515.0
0.003,17,2,132,1,58,0.0,30.0,30.0,1,74,0.0,46.0,46.0
0.01,6,10,1990,5,911,2.0,643.0,643.0,5,1079,2.0,811.0,811.0
0.007,6,12,1698,6,863,1.0,327.0,271.0,6,835,1.0,515.0,515.0
10.859,17,28,4422,14,1994,826.0,269.0,114.0,14,2428,826.0,587.0,145.0
0.003,17,2,148,1,60,0.0,32.0,32.0,1,88,0.0,60.0,60.0
0.04,17,2,170,1,65,0.0,37.0,37.0,1,105,0.0,77.0,77.0
0.016,17,2,198,1,91,0.0,63.0,63.0,1,107,0.0,79.0,79.0
0.005,6,10,1854,5,889,1.0,621.0,621.0,5,965,1.0,697.0,697.0
0.069,17,8,3613,4,1874,23.0,1350.0,440.0,4,1739,11.0,1350.0,406.0
0.014,6,10,1990,5,911,3.0,643.0,643.0,5,1079,3.0,811.0,811.0
0.005,6,10,1689,5,839,1.0,571.0,571.0,5,850,1.0,582.0,582.0
166.246,17,70,10101,35,2339,4889.0,44.0,38.0,35,7762,4889.0,239.0,193.0
40.07,17,10,676,5,460,10016.0,104.0,64.0,5,216,10016.0,20.0,15.0
0.004,6,10,1702,5,863,1.0,595.0,595.0,5,839,1.0,571.0,571.0
0.003,6,10,1702,5,863,0.0,595.0,595.0,5,839,0.0,571.0,571.0
0.001,17,2,180,1,66,0.0,38.0,38.0,1,114,0.0,86.0,86.0
1770.427,17,92,8096,46,4048,39342.0,60.0,60.0,46,4048,39342.0,60.0,60.0
40.053,17,10,676,5,460,10012.0,104.0,64.0,5,216,10012.0,20.0,15.0
0.017,6,10,1989,5,910,4.0,642.0,642.0,5,1079,4.0,811.0,811.0
0.074,6,10,1506,5,395,16.0,127.0,127.0,5,1111,17.0,843.0,843.0
0.005,6,15,3794,8,504,0.0,80.0,80.0,7,3290,0.0,1448.0,972.0
0.086,6,10,1506,5,395,18.0,127.0,127.0,5,1111,19.0,843.0,843.0
0.009,6,12,1926,6,1189,1.0,659.0,434.0,6,737,1.0,417.0,417.0
0.001,17,2,136,1,60,0.0,32.0,32.0,1,76,0.0,48.0,48.0
0.005,6,10,2006,5,927,1.0,659.0,659.0,5,1079,1.0,811.0,811.0
0.005,6,10,1689,5,839,1.0,571.0,571.0,5,850,1.0,582.0,582.0
0.01,6,10,1989,5,910,2.0,642.0,642.0,5,1079,2.0,811.0,811.0
0.005,6,10,1689,5,839,1.0,571.0,571.0,5,850,1.0,582.0,582.0
0.005,17,2,140,1,62,0.0,34.0,34.0,1,78,0.0,50.0,50.0
0.017,6,10,1762,5,911,4.0,643.0,643.0,5,851,4.0,583.0,583.0
0.009,17,4,284,2,120,0.0,32.0,32.0,2,164,0.0,60.0,54.0
0.005,6,10,1989,5,927,1.0,659.0,659.0,5,1062,1.0,794.0,794.0
0.017,6,10,1989,5,910,4.0,642.0,642.0,5,1079,4.0,811.0,811.0
0.005,17,2,180,1,58,0.0,30.0,30.0,1,122,0.0,94.0,94.0
0.017,6,10,1983,5,910,4.0,642.0,642.0,5,1073,4.0,805.0,805.0
172.115,17,82,11451,41,2728,4302.0,44.0,38.0,41,8723,4302.0,239.0,184.0
0.004,6,10,1989,5,927,1.0,659.0,659.0,5,1062,1.0,794.0,794.0
0.006,6,10,1972,5,910,1.0,642.0,642.0,5,1062,1.0,794.0,794.0
0.011,6,10,1972,5,910,2.0,642.0,642.0,5,1062,2.0,794.0,794.0
0.004,6,10,1702,5,863,1.0,595.0,595.0,5,839,1.0,571.0,571.0
15.075,17,14,7442,7,5423,2507.0,1350.0,746.0,7,2019,2507.0,1350.0,260.0
0.039,17,2,152,1,76,0.0,48.0,48.0,1,76,0.0,48.0,48.0
240.011,6,9,787,5,488,60002.0,232.0,232.0,4,299,80002.0,83.0,83.0
0.11,6,10,1506,5,395,23.0,127.0,127.0,5,1111,23.0,843.0,843.0
0.005,17,2,184,1,68,0.0,40.0,40.0,1,116,0.0,88.0,88.0
0.005,6,10,2006,5,927,1.0,659.0,659.0,5,1079,1.0,811.0,811.0
0.01,6,12,1926,6,1189,1.0,659.0,434.0,6,737,1.0,417.0,417.0
0.005,17,2,213,1,69,0.0,41.0,41.0,1,144,0.0,116.0,116.0
323.949,17,20,1124,10,716,35980.0,48.0,43.0,10,408,35980.0,20.0,12.0
0.09,6,10,1506,5,395,20.0,127.0,127.0,5,1111,22.0,843.0,843.0
0.124,17,2,136,1,60,0.0,32.0,32.0,1,76,0.0,48.0,48.0
308.434,17,20,1124,10,716,34263.0,48.0,43.0,10,408,34263.0,20.0,12.0
0.007,17,2,166,1,75,0.0,47.0,47.0,1,91,0.0,63.0,63.0
0.005,6,10,1989,5,927,1.0,659.0,659.0,5,1062,1.0,794.0,794.0
10.767,17,28,4419,14,1995,819.0,270.0,114.0,14,2424,819.0,587.0,145.0
0.134,17,2,80,1,32,0.0,4.0,4.0,1,48,0.0,20.0,20.0
0.016,6,10,1983,5,910,4.0,642.0,642.0,5,1073,4.0,805.0,805.0
0.086,6,10,1506,5,395,18.0,127.0,127.0,5,1111,19.0,843.0,843.0
40.041,17,10,676,5,460,10009.0,104.0,64.0,5,216,10009.0,20.0,15.0
0.006,6,10,1547,5,764,1.0,496.0,496.0,5,783,1.0,515.0,515.0
0.005,6,10,2007,5,928,1.0,660.0,660.0,5,1079,1.0,811.0,811.0
352.634,6,20,2210,6,1308,12004.0,494.0,494.0,14,902,27125.0,83.0,83.0
0.006,6,10,1547,5,764,1.0,496.0,496.0,5,783,1.0,515.0,515.0
0.022,6,10,1631,5,848,5.0,580.0,580.0,5,783,5.0,515.0,515.0
0.077,6,10,1506,5,395,15.0,127.0,127.0,5,1111,17.0,843.0,843.0
0.005,17,2,148,1,60,0.0,32.0,32.0,1,88,0.0,60.0,60.0
0.075,6,10,1506,5,395,15.0,127.0,127.0,5,1111,17.0,843.0,843.0
40.059,17,10,676,5,460,10014.0,104.0,64.0,5,216,10014.0,20.0,15.0
300.778,6,39,9797,21,4230,15038.0,1602.0,669.0,18,5567,505.0,2667.0,402.0
0.005,6,10,2000,5,927,1.0,659.0,659.0,5,1073,1.0,805.0,805.0
0.007,6,10,1547,5,764,1.0,496.0,496.0,5,783,1.0,515.0,515.0
0.064,17,2,144,1,64,0.0,36.0,36.0,1,80,0.0,52.0,52.0
326.266,17,16,928,8,608,46591.0,48.0,48.0,8,320,46591.0,12.0,12.0
0.009,6,10,2006,5,927,2.0,659.0,659.0,5,1079,2.0,811.0,811.0
0.005,6,10,1989,5,927,1.0,659.0,659.0,5,1062,1.0,794.0,794.0
0.005,6,14,3742,7,452,0.0,80.0,80.0,7,3290,0.0,1448.0,972.0
9.05,17,6,376,5,280,2262.0,28.0,28.0,1,96,0.0,68.0,68.0
0.011,6,10,1983,5,910,2.0,642.0,642.0,5,1073,2.0,805.0,805.0
0.008,6,10,1762,5,911,2.0,643.0,643.0,5,851,1.0,583.0,583.0
0.017,6,10,1677,5,827,4.0,559.0,559.0,5,850,4.0,582.0,582.0
0.079,6,10,1506,5,395,16.0,127.0,127.0,5,1111,16.0,843.0,843.0
0.014,17,2,214,1,75,0.0,47.0,47.0,1,139,0.0,111.0,111.0
240.055,6,9,787,5,488,60013.0,232.0,232.0,4,299,80017.0,83.0,83.0
0.011,17,2,138,1,61,0.0,33.0,33.0,1,77,0.0,49.0,49.0
0.006,6,10,1547,5,764,1.0,496.0,496.0,5,783,1.0,515.0,515.0
0.004,17,2,148,1,60,0.0,32.0,32.0,1,88,0.0,60.0,60.0
0.007,6,10,1689,5,839,1.0,571.0,571.0,5,850,1.0,582.0,582.0
0.042,17,2,136,1,60,0.0,32.0,32.0,1,76,0.0,48.0,48.0
0.001,17,2,174,1,72,0.0,44.0,44.0,1,102,0.0,74.0,74.0
0.006,17,2,164,1,74,0.0,46.0,46.0,1,90,0.0,62.0,62.0
0.005,6,10,2000,5,927,1.0,659.0,659.0,5,1073,1.0,805.0,805.0
0.115,6,10,1506,5,395,23.0,127.0,127.0,5,1111,26.0,843.0,843.0
0.005,6,13,3690,7,452,0.0,80.0,80.0,6,3238,1.0,1470.0,1459.0
0.039,17,4,284,2,120,0.0,32.0,32.0,2,164,36.0,60.0,54.0
0.005,6,10,2006,5,927,1.0,659.0,659.0,5,1079,1.0,811.0,811.0
0.082,6,10,1506,5,395,18.0,127.0,127.0,5,1111,17.0,843.0,843.0
0.113,6,10,1506,5,395,27.0,127.0,127.0,5,1111,27.0,843.0,843.0
0.015,6,10,1631,5,848,3.0,580.0,580.0,5,783,3.0,515.0,515.0
0.005,6,10,1854,5,889,1.0,621.0,621.0,5,965,1.0,697.0,697.0
0.005,6,10,2000,5,927,1.0,659.0,659.0,5,1073,1.0,805.0,805.0
0.015,6,10,1983,5,910,3.0,642.0,642.0,5,1073,3.0,805.0,805.0
0.797,6,22,5168,11,1138,66.0,267.0,115.0,11,4030,66.0,1414.0,597.0
0.001,17,2,166,1,75,0.0,47.0,47.0,1,91,0.0,63.0,63.0
0.003,17,2,208,1,72,0.0,44.0,44.0,1,136,0.0,108.0,108.0
0.004,6,10,1774,5,923,1.0,655.0,655.0,5,851,1.0,583.0,583.0
0.009,6,10,1983,5,910,2.0,642.0,642.0,5,1073,2.0,805.0,805.0
0.01,6,10,1983,5,910,2.0,642.0,642.0,5,1073,2.0,805.0,805.0
0.005,6,10,1854,5,889,1.0,621.0,621.0,5,965,1.0,697.0,697.0
0.006,6,10,1989,5,927,1.0,659.0,659.0,5,1062,1.0,794.0,794.0
25.233,6,37,12342,18,6784,521.0,4080.0,1508.0,19,5558,1392.0,2667.0,435.0
0.006,17,2,178,1,81,0.0,53.0,53.0,1,97,0.0,69.0,69.0
0.004,6,10,2007,5,928,1.0,660.0,660.0,5,1079,1.0,811.0,811.0
0.004,17,2,148,1,60,0.0,32.0,32.0,1,88,0.0,60.0,60.0
0.005,6,10,1689,5,839,1.0,571.0,571.0,5,850,1.0,582.0,582.0
0.011,6,10,1989,5,910,2.0,642.0,642.0,5,1079,2.0,811.0,811.0
352.249,6,20,2210,6,1308,12003.0,494.0,494.0,14,902,27095.0,83.0,83.0
0.005,17,2,144,1,64,0.0,36.0,36.0,1,80,0.0,52.0,52.0
175.528,17,72,10302,36,2401,5014.0,44.0,38.0,36,7901,5015.0,261.0,191.0
0.003,17,4,284,2,120,0.0,32.0,32.0,2,164,0.0,60.0,54.0
0.017,6,10,1989,5,910,4.0,642.0,642.0,5,1079,4.0,811.0,811.0
0.112,6,10,1506,5,395,24.0,127.0,127.0,5,1111,25.0,843.0,843.0
0.014,6,10,1762,5,911,3.0,643.0,643.0,5,851,3.0,583.0,583.0
0.014,6,10,1972,5,910,3.0,642.0,642.0,5,1062,3.0,794.0,794.0
0.092,6,10,1506,5,395,22.0,127.0,127.0,5,1111,22.0,843.0,843.0
0.004,17,2,136,1,60,0.0,32.0,32.0,1,76,0.0,48.0,48.0
0.019,6,10,1989,5,910,4.0,642.0,642.0,5,1079,4.0,811.0,811.0
240.354,6,35,9878,18,1899,14138.0,568.0,188.0,17,7979,15021.0,1402.0,645.0
0.016,6,10,1631,5,848,3.0,580.0,580.0,5,783,3.0,515.0,515.0
0.005,6,10,1989,5,927,1.0,659.0,659.0,5,1062,1.0,794.0,794.0
0.005,6,10,2006,5,927,1.0,659.0,659.0,5,1079,1.0,811.0,811.0
0.005,6,10,1989,5,927,1.0,659.0,659.0,5,1062,1.0,794.0,794.0
40.078,17,10,676,5,460,10018.0,104.0,64.0,5,216,10018.0,20.0,15.0
1795.756,6,296,51522,120,34095,15089.0,2720.0,304.0,176,17427,10260.0,1360.0,129.0
5.124,6,23,6467,13,1827,426.0,801.0,282.0,10,4640,568.0,1925.0,824.0
309.603,17,20,1124,10,716,34386.0,48.0,43.0,10,408,34386.0,20.0,12.0
0.005,17,2,166,1,75,0.0,47.0,47.0,1,91,0.0,63.0,63.0
0.011,6,10,1762,5,911,2.0,643.0,643.0,5,851,2.0,583.0,583.0
0.071,17,8,3613,4,1874,23.0,1350.0,440.0,4,1739,12.0,1350.0,406.0
0.077,6,10,1506,5,395,16.0,127.0,127.0,5,1111,16.0,843.0,843.0
1757.349,6,105,6270,60,3525,29784.0,27.0,27.0,45,2745,39938.0,27.0,27.0
280.624,6,23,7475,9,1146,35077.0,267.0,156.0,14,6329,21586.0,1400.0,960.0
0.003,17,2,148,1,60,0.0,32.0,32.0,1,88,0.0,60.0,60.0
0.005,6,10,1774,5,923,1.0,655.0,655.0,5,851,1.0,583.0,583.0
0.174,17,2,152,1,76,0.0,48.0,48.0,1,76,0.0,48.0,48.0
0.005,17,2,166,1,75,0.0,47.0,47.0,1,91,0.0,63.0,63.0
0.014,6,14,3868,7,578,2.0,206.0,206.0,7,3290,2.0,1448.0,972.0
0.004,17,2,136,1,60,0.0,32.0,32.0,1,76,0.0,48.0,48.0
0.122,6,10,1506,5,395,28.0,127.0,127.0,5,1111,25.0,843.0,843.0
1766.112,6,561,191117,284,164440,6240.0,2883.0,953.0,277,26677,6398.0,580.0,121.0
0.072,17,4,420,2,122,0.0,33.0,33.0,2,298,0.0,145.0,121.0
0.011,6,10,1983,5,910,2.0,642.0,642.0,5,1073,2.0,805.0,805.0
40.061,17,10,676,5,460,10014.0,104.0,64.0,5,216,10014.0,20.0,15.0
0.016,6,10,1983,5,910,4.0,642.0,642.0,5,1073,4.0,805.0,805.0
0.098,6,10,1506,5,395,23.0,127.0,127.0,5,1111,22.0,843.0,843.0
0.104,6,10,1506,5,395,22.0,127.0,127.0,5,1111,21.0,843.0,843.0
40.063,17,10,676,5,460,10014.0,104.0,64.0,5,216,10015.0,20.0,15.0
0.004,6,10,1989,5,927,1.0,659.0,659.0,5,1062,1.0,794.0,794.0
40.074,17,10,676,5,460,10015.0,104.0,64.0,5,216,10017.0,20.0,15.0
0.007,6,10,1547,5,764,1.0,496.0,496.0,5,783,1.0,515.0,515.0
0.004,6,10,2006,5,927,1.0,659.0,659.0,5,1079,1.0,811.0,811.0
0.087,6,10,1506,5,395,19.0,127.0,127.0,5,1111,18.0,843.0,843.0
0.04,6,10,1990,5,911,10.0,643.0,643.0,5,1079,9.0,811.0,811.0
0.005,6,10,1779,5,928,1.0,660.0,660.0,5,851,1.0,583.0,583.0
0.007,6,10,1989,5,910,1.0,642.0,642.0,5,1079,1.0,811.0,811.0
0.019,6,10,1989,5,910,4.0,642.0,642.0,5,1079,4.0,811.0,811.0
0.004,6,10,1702,5,863,0.0,595.0,595.0,5,839,1.0,571.0,571.0
240.022,6,9,787,5,488,60005.0,232.0,232.0,4,299,80006.0,83.0,83.0
0.041,17,2,136,1,60,0.0,32.0,32.0,1,76,0.0,48.0,48.0
0.004,17,4,284,2,120,0.0,32.0,32.0,2,164,0.0,60.0,54.0
175.218,17,78,11132,39,2596,4610.0,44.0,38.0,39,8536,4610.0,249.0,190.0
0.016,6,10,1983,5,910,4.0,642.0,642.0,5,1073,3.0,805.0,805.0
15.075,17,15,9239,8,6902,2149.0,1350.0,834.0,7,2337,2507.0,1350.0,305.0
0.004,6,10,2007,5,928,1.0,660.0,660.0,5,1079,1.0,811.0,811.0
0.081,6,10,1506,5,395,17.0,127.0,127.0,5,1111,18.0,843.0,843.0
0.013,6,10,1990,5,911,3.0,643.0,643.0,5,1079,3.0,811.0,811.0
0.001,17,2,142,1,63,0.0,35.0,35.0,1,79,0.0,51.0,51.0
0.005,17,2,170,1,65,0.0,37.0,37.0,1,105,0.0,77.0,77.0
0.082,6,10,1506,5,395,16.0,127.0,127.0,5,1111,16.0,843.0,843.0
0.005,6,10,1989,5,927,1.0,659.0,659.0,5,1062,1.0,794.0,794.0
0.005,17,2,230,1,68,0.0,40.0,40.0,1,162,0.0,134.0,134.0
0.005,6,10,2006,5,927,1.0,659.0,659.0,5,1079,1.0,811.0,811.0
0.005,6,10,2006,5,927,1.0,659.0,659.0,5,1079,1.0,811.0,811.0
0.065,6,10,1506,5,395,15.0,127.0,127.0,5,1111,13.0,843.0,843.0
0.005,6,10,1989,5,927,1.0,659.0,659.0,5,1062,1.0,794.0,794.0
0.005,6,10,2006,5,927,1.0,659.0,659.0,5,1079,1.0,811.0,811.0
0.004,6,10,1779,5,928,1.0,660.0,660.0,5,851,1.0,583.0,583.0
15.074,17,14,9190,8,6902,2149.0,1350.0,834.0,6,2288,3008.0,1350.0,353.0
0.011,6,10,1631,5,848,2.0,580.0,580.0,5,783,2.0,515.0,515.0
0.013,17,2,152,1,56,0.0,28.0,28.0,1,96,0.0,68.0,68.0
0.001,17,2,136,1,60,0.0,32.0,32.0,1,76,0.0,48.0,48.0
0.014,6,10,1972,5,910,3.0,642.0,642.0,5,1062,3.0,794.0,794.0
0.081,6,10,1506,5,395,16.0,127.0,127.0,5,1111,19.0,843.0,843.0
0.013,6,10,1983,5,910,3.0,642.0,642.0,5,1073,3.0,805.0,805.0
0.065,17,8,3613,4,1874,21.0,1350.0,440.0,4,1739,11.0,1350.0,406.0
0.091,6,10,1506,5,395,21.0,127.0,127.0,5,1111,21.0,843.0,843.0
0.005,17,2,170,1,65,0.0,37.0,37.0,1,105,0.0,77.0,77.0
0.01,6,10,1972,5,910,2.0,642.0,642.0,5,1062,2.0,794.0,794.0
0.014,6,10,1990,5,911,3.0,643.0,643.0,5,1079,3.0,811.0,811.0
0.003,17,2,132,1,58,0.0,30.0,30.0,1,74,0.0,46.0,46.0
0.053,17,2,152,1,76,0.0,48.0,48.0,1,76,0.0,48.0,48.0
0.043,17,2,166,1,75,0.0,47.0,47.0,1,91,0.0,63.0,63.0
0.277,17,39,20119,21,17039,13.0,1350.0,783.0,18,3080,12.0,1350.0,143.0
0.171,6,3,453,2,321,171.0,241.0,241.0,1,132,0.0,92.0,92.0
0.006,6,10,1989,5,927,1.0,659.0,659.0,5,1062,1.0,794.0,794.0
40.069,17,10,676,5,460,10015.0,104.0,64.0,5,216,10016.0,20.0,15.0
0.039,17,2,152,1,76,0.0,48.0,48.0,1,76,0.0,48.0,48.0
0.005,6,10,1547,5,764,1.0,496.0,496.0,5,783,1.0,515.0,515.0
1.087,6,16,2623,10,1607,120.0,593.0,268.0,6,1016,216.0,456.0,348.0
0.003,17,2,136,1,60,0.0,32.0,32.0,1,76,0.0,48.0,48.0
0.004,6,15,3794,8,504,0.0,80.0,80.0,7,3290,0.0,1448.0,972.0
0.001,17,2,180,1,66,0.0,38.0,38.0,1,114,0.0,86.0,86.0
0.003,17,2,148,1,60,0.0,32.0,32.0,1,88,0.0,60.0,60.0
0.022,6,10,1990,5,911,5.0,643.0,643.0,5,1079,5.0,811.0,811.0
0.113,6,10,1506,5,395,25.0,127.0,127.0,5,1111,25.0,843.0,843.0
0.017,6,13,3735,7,497,2.0,125.0,125.0,6,3238,3.0,1470.0,1459.0
0.071,17,2,148,1,60,0.0,32.0,32.0,1,88,0.0,60.0,60.0
0.005,6,10,2007,5,928,1.0,660.0,660.0,5,1079,1.0,811.0,811.0
0.008,6,10,2000,5,927,1.0,659.0,659.0,5,1073,1.0,805.0,805.0
0.092,6,10,1506,5,395,21.0,127.0,127.0,5,1111,17.0,843.0,843.0
0.004,6,10,2007,5,928,1.0,660.0,660.0,5,1079,1.0,811.0,811.0
0.011,6,10,1990,5,911,2.0,643.0,643.0,5,1079,2.0,811.0,811.0
0.037,17,2,166,1,75,0.0,47.0,47.0,1,91,0.0,63.0,63.0
0.001,17,2,136,1,60,0.0,32.0,32.0,1,76,0.0,48.0,48.0
0.176,6,10,1506,5,395,43.0,127.0,127.0,5,1111,40.0,843.0,843.0
0.127,6,10,1506,5,395,26.0,127.0,127.0,5,1111,29.0,843.0,843.0
0.001,17,2,180,1,66,0.0,38.0,38.0,1,114,0.0,86.0,86.0
0.016,6,10,1677,5,827,4.0,559.0,559.0,5,850,4.0,582.0,582.0
40.85,6,37,10002,19,4484,496.0,1360.0,738.0,18,5518,2393.0,2667.0,435.0
0.003,17,2,187,1,74,0.0,46.0,46.0,1,113,0.0,85.0,85.0
0.156,6,10,1506,5,395,25.0,127.0,127.0,5,1111,35.0,843.0,843.0
0.005,6,14,3799,7,509,0.0,137.0,137.0,7,3290,0.0,1448.0,972.0
0.005,6,10,2000,5,927,1.0,659.0,659.0,5,1073,1.0,805.0,805.0
0.084,6,10,1506,5,395,18.0,127.0,127.0,5,1111,19.0,843.0,843.0
0.009,6,10,1972,5,910,2.0,642.0,642.0,5,1062,2.0,794.0,794.0
0.017,6,10,1983,5,910,4.0,642.0,642.0,5,1073,4.0,805.0,805.0
0.068,17,8,3613,4,1874,22.0,1350.0,440.0,4,1739,12.0,1350.0,406.0
0.02,6,10,1631,5,848,4.0,580.0,580.0,5,783,4.0,515.0,515.0
0.004,6,10,2006,5,927,1.0,659.0,659.0,5,1079,1.0,811.0,811.0
0.018,6,10,1972,5,910,4.0,642.0,642.0,5,1062,4.0,794.0,794.0
0.098,6,10,1506,5,395,22.0,127.0,127.0,5,1111,23.0,843.0,843.0
0.091,6,10,1506,5,395,18.0,127.0,127.0,5,1111,19.0,843.0,843.0
0.068,17,8,3613,4,1874,22.0,1350.0,440.0,4,1739,11.0,1350.0,406.0
0.084,6,10,1506,5,395,18.0,127.0,127.0,5,1111,20.0,843.0,843.0
0.118,6,10,1506,5,395,27.0,127.0,127.0,5,1111,27.0,843.0,843.0
40.056,17,10,676,5,460,10013.0,104.0,64.0,5,216,10013.0,20.0,15.0
0.069,17,8,3613,4,1874,23.0,1350.0,440.0,4,1739,11.0,1350.0,406.0
0.005,6,10,2006,5,927,1.0,659.0,659.0,5,1079,1.0,811.0,811.0
0.008,6,10,1983,5,910,2.0,642.0,642.0,5,1073,1.0,805.0,805.0
0.005,6,10,1689,5,839,1.0,571.0,571.0,5,850,1.0,582.0,582.0
0.006,6,10,1854,5,889,1.0,621.0,621.0,5,965,1.0,697.0,697.0
0.01,6,10,1989,5,910,2.0,642.0,642.0,5,1079,2.0,811.0,811.0
0.115,6,10,1506,5,395,24.0,127.0,127.0,5,1111,25.0,843.0,843.0
0.054,6,10,1506,5,395,11.0,127.0,127.0,5,1111,12.0,843.0,843.0
0.004,6,10,1774,5,923,1.0,655.0,655.0,5,851,1.0,583.0,583.0
0.006,6,10,1854,5,889,1.0,621.0,621.0,5,965,1.0,697.0,697.0
0.005,17,2,169,1,62,0.0,34.0,34.0,1,107,0.0,79.0,79.0
40.089,17,10,676,5,460,10018.0,104.0,64.0,5,216,10020.0,20.0,15.0
65.94,6,27,17525,15,9579,4710.0,2804.0,1465.0,12,7946,5978.0,2317.0,1219.0
40.059,17,10,676,5,460,10013.0,104.0,64.0,5,216,10013.0,20.0,15.0
0.022,6,10,1677,5,827,5.0,559.0,559.0,5,850,5.0,582.0,582.0
0.005,6,10,1689,5,839,1.0,571.0,571.0,5,850,1.0,582.0,582.0
40.065,17,10,676,5,460,10015.0,104.0,64.0,5,216,10015.0,20.0,15.0
0.022,6,10,1973,5,911,5.0,643.0,643.0,5,1062,5.0,794.0,794.0
308.742,17,20,1124,10,716,34289.0,48.0,43.0,10,408,34289.0,20.0,12.0
0.004,6,10,2006,5,927,1.0,659.0,659.0,5,1079,1.0,811.0,811.0
0.021,6,10,1989,5,910,5.0,642.0,642.0,5,1079,5.0,811.0,811.0
0.001,17,2,180,1,66,0.0,38.0,38.0,1,114,0.0,86.0,86.0
0.095,6,10,1506,5,395,19.0,127.0,127.0,5,1111,19.0,843.0,843.0
0.004,17,4,284,2,120,0.0,32.0,32.0,2,164,0.0,60.0,54.0
0.086,6,10,1506,5,395,19.0,127.0,127.0,5,1111,18.0,843.0,843.0
0.016,6,10,1762,5,911,4.0,643.0,643.0,5,851,3.0,583.0,583.0
0.024,6,10,1990,5,911,6.0,643.0,643.0,5,1079,5.0,811.0,811.0
15.079,17,15,8617,8,6393,2150.0,1350.0,771.0,7,2224,2508.0,1350.0,289.0
11.234,17,28,4423,14,1994,851.0,269.0,114.0,14,2429,851.0,588.0,145.0
0.004,6,10,2006,5,927,1.0,659.0,659.0,5,1079,1.0,811.0,811.0
0.005,6,10,2006,5,927,1.0,659.0,659.0,5,1079,1.0,811.0,811.0
0.004,6,10,1989,5,927,1.0,659.0,659.0,5,1062,1.0,794.0,794.0
0.068,6,10,1506,5,395,14.0,127.0,127.0,5,1111,14.0,843.0,843.0
0.009,6,10,1989,5,910,2.0,642.0,642.0,5,1079,2.0,811.0,811.0
0.005,6,10,1854,5,889,1.0,621.0,621.0,5,965,1.0,697.0,697.0
40.082,17,10,676,5,460,10014.0,104.0,64.0,5,216,10017.0,20.0,15.0
0.117,6,10,1506,5,395,26.0,127.0,127.0,5,1111,27.0,843.0,843.0
0.005,6,10,1702,5,863,1.0,595.0,595.0,5,839,1.0,571.0,571.0
0.006,6,10,1547,5,764,1.0,496.0,496.0,5,783,1.0,515.0,515.0
0.074,6,10,1506,5,395,17.0,127.0,127.0,5,1111,15.0,843.0,843.0
0.004,6,10,1779,5,928,1.0,660.0,660.0,5,851,1.0,583.0,583.0
0.012,6,10,1990,5,911,3.0,643.0,643.0,5,1079,2.0,811.0,811.0
0.137,6,10,1506,5,395,31.0,127.0,127.0,5,1111,21.0,843.0,843.0
300.154,6,27,7436,16,1409,20010.0,217.0,142.0,11,6027,24014.0,1679.0,778.0
0.005,6,10,2006,5,927,1.0,659.0,659.0,5,1079,1.0,811.0,811.0
0.018,6,10,1989,5,910,4.0,642.0,642.0,5,1079,4.0,811.0,811.0
0.088,6,10,1506,5,395,19.0,127.0,127.0,5,1111,19.0,843.0,843.0
266.028,6,40,10014,16,6600,17735.0,1674.0,641.0,24,3414,11566.0,580.0,143.0
40.082,17,10,676,5,460,10017.0,104.0,64.0,5,216,10013.0,20.0,15.0
0.13,6,10,1506,5,395,28.0,127.0,127.0,5,1111,28.0,843.0,843.0
0.01,6,10,1990,5,911,2.0,643.0,643.0,5,1079,2.0,811.0,811.0
0.093,6,10,1506,5,395,17.0,127.0,127.0,5,1111,19.0,843.0,843.0
0.013,6,13,3735,7,497,2.0,125.0,125.0,6,3238,2.0,1470.0,1459.0
0.004,17,2,136,1,60,0.0,32.0,32.0,1,76,0.0,48.0,48.0
40.06,17,10,676,5,460,10014.0,104.0,64.0,5,216,10014.0,20.0,15.0
0.067,6,10,1506,5,395,13.0,127.0,127.0,5,1111,16.0,843.0,843.0
0.005,6,10,2006,5,927,1.0,659.0,659.0,5,1079,1.0,811.0,811.0
0.006,6,10,1854,5,889,1.0,621.0,621.0,5,965,1.0,697.0,697.0
0.006,6,10,1547,5,764,1.0,496.0,496.0,5,783,1.0,515.0,515.0
0.102,6,10,1506,5,395,23.0,127.0,127.0,5,1111,21.0,843.0,843.0
0.006,17,2,166,1,75,0.0,47.0,47.0,1,91,0.0,63.0,63.0
0.001,17,2,180,1,66,0.0,38.0,38.0,1,114,0.0,86.0,86.0
0.007,17,2,179,1,71,0.0,43.0,43.0,1,108,0.0,80.0,80.0
0.008,6,12,1926,6,1189,1.0,659.0,434.0,6,737,1.0,417.0,417.0
0.09,6,10,1506,5,395,20.0,127.0,127.0,5,1111,21.0,843.0,843.0
0.223,6,16,2777,8,1395,31.0,533.0,323.0,8,1382,20.0,529.0,239.0
0.169,6,10,1506,5,395,40.0,127.0,127.0,5,1111,35.0,843.0,843.0
0.006,17,2,299,1,65,0.0,37.0,37.0,1,234,0.0,206.0,206.0
240.113,6,30,9154,15,6775,17150.0,1900.0,666.0,15,2379,17150.0,580.0,227.0
40.056,17,10,676,5,460,10013.0,104.0,64.0,5,216,10013.0,20.0,15.0
0.005,6,10,1854,5,889,1.0,621.0,621.0,5,965,1.0,697.0,697.0
0.008,6,10,1983,5,910,1.0,642.0,642.0,5,1073,2.0,805.0,805.0
15.15,17,18,10725,9,8280,1885.0,1350.0,892.0,9,2445,1885.0,1350.0,243.0
0.007,6,10,1547,5,764,1.0,496.0,496.0,5,783,1.0,515.0,515.0
0.07,6,10,1506,5,395,15.0,127.0,127.0,5,1111,14.0,843.0,843.0
0.007,6,10,1547,5,764,1.0,496.0,496.0,5,783,1.0,515.0,515.0
0.003,17,2,136,1,60,0.0,32.0,32.0,1,76,0.0,48.0,48.0
0.082,6,10,1506,5,395,16.0,127.0,127.0,5,1111,17.0,843.0,843.0
0.005,6,10,1547,5,764,1.0,496.0,496.0,5,783,1.0,515.0,515.0
40.06,17,10,676,5,460,10012.0,104.0,64.0,5,216,10014.0,20.0,15.0
0.005,6,10,1547,5,764,1.0,496.0,496.0,5,783,1.0,515.0,515.0
0.005,6,10,2000,5,927,1.0,659.0,659.0,5,1073,1.0,805.0,805.0
0.124,6,10,1506,5,395,27.0,127.0,127.0,5,1111,29.0,843.0,843.0
0.006,6,10,1547,5,764,1.0,496.0,496.0,5,783,1.0,515.0,515.0
0.006,17,2,152,1,68,0.0,40.0,40.0,1,84,0.0,56.0,56.0
0.871,6,27,5539,12,1557,69.0,325.0,152.0,15,3982,54.0,1414.0,563.0
0.078,6,10,1506,5,395,16.0,127.0,127.0,5,1111,16.0,843.0,843.0
0.004,17,2,148,1,60,0.0,32.0,32.0,1,88,0.0,60.0,60.0
0.007,6,10,1547,5,764,1.0,496.0,496.0,5,783,1.0,515.0,515.0
0.018,6,10,1972,5,910,4.0,642.0,642.0,5,1062,4.0,794.0,794.0
0.265,17,38,20101,21,17028,13.0,1350.0,782.0,17,3073,12.0,1350.0,152.0
0.006,6,10,1547,5,764,1.0,496.0,496.0,5,783,1.0,515.0,515.0
0.017,6,10,1972,5,910,4.0,642.0,642.0,5,1062,4.0,794.0,794.0
0.005,6,10,1702,5,863,1.0,595.0,595.0,5,839,1.0,571.0,571.0
0.104,6,10,1506,5,395,23.0,127.0,127.0,5,1111,25.0,843.0,843.0
1787.244,6,150,19350,90,13740,20081.0,302.0,302.0,60,5610,30292.0,83.0,83.0
0.093,6,10,1506,5,395,20.0,127.0,127.0,5,1111,17.0,843.0,843.0
0.067,6,10,1506,5,395,13.0,127.0,127.0,5,1111,16.0,843.0,843.0
0.022,6,10,1989,5,910,5.0,642.0,642.0,5,1079,5.0,811.0,811.0
0.07,17,8,3613,4,1874,23.0,1350.0,440.0,4,1739,12.0,1350.0,406.0
0.011,6,10,1990,5,911,2.0,643.0,643.0,5,1079,2.0,811.0,811.0
0.085,6,10,1506,5,395,19.0,127.0,127.0,5,1111,17.0,843.0,843.0
0.005,6,10,1643,5,860,1.0,592.0,592.0,5,783,1.0,515.0,515.0
0.019,6,10,1972,5,910,4.0,642.0,642.0,5,1062,4.0,794.0,794.0
0.04,17,4,284,2,120,0.0,32.0,32.0,2,164,36.0,60.0,54.0
0.013,6,10,1983,5,910,3.0,642.0,642.0,5,1073,3.0,805.0,805.0
0.008,6,10,1989,5,910,2.0,642.0,642.0,5,1079,1.0,811.0,811.0
0.006,17,2,179,1,71,0.0,43.0,43.0,1,108,0.0,80.0,80.0
0.008,6,10,2006,5,927,1.0,659.0,659.0,5,1079,2.0,811.0,811.0
240.089,6,20,4874,11,941,24008.0,180.0,93.0,9,3933,30010.0,1593.0,576.0
0.011,6,10,1989,5,910,2.0,642.0,642.0,5,1079,2.0,811.0,811.0
0.007,6,10,1677,5,827,1.0,559.0,559.0,5,850,1.0,582.0,582.0
0.211,6,16,2670,8,1396,30.0,533.0,324.0,8,1274,19.0,529.0,212.0
0.001,17,2,136,1,60,0.0,32.0,32.0,1,76,0.0,48.0,48.0
0.015,6,10,1972,5,910,3.0,642.0,642.0,5,1062,3.0,794.0,794.0
0.087,6,10,1506,5,395,20.0,127.0,127.0,5,1111,20.0,843.0,843.0
0.091,6,10,1506,5,395,19.0,127.0,127.0,5,1111,21.0,843.0,843.0
0.014,6,10,1990,5,911,3.0,643.0,643.0,5,1079,3.0,811.0,811.0
0.004,6,10,2000,5,927,1.0,659.0,659.0,5,1073,1.0,805.0,805.0
0.006,6,10,2000,5,927,1.0,659.0,659.0,5,1073,1.0,805.0,805.0
0.092,6,10,1506,5,395,21.0,127.0,127.0,5,1111,19.0,843.0,843.0
0.004,17,2,132,1,58,0.0,30.0,30.0,1,74,0.0,46.0,46.0
0.005,6,10,2007,5,928,1.0,660.0,660.0,5,1079,1.0,811.0,811.0
0.007,6,10,2006,5,927,1.0,659.0,659.0,5,1079,1.0,811.0,811.0
0.005,17,2,144,1,64,0.0,36.0,36.0,1,80,0.0,52.0,52.0
0.005,6,10,1779,5,928,1.0,660.0,660.0,5,851,1.0,583.0,583.0
0.015,6,10,1762,5,911,3.0,643.0,643.0,5,851,3.0,583.0,583.0
0.13,6,10,1506,5,395,28.0,127.0,127.0,5,1111,29.0,843.0,843.0
0.005,6,10,2006,5,927,1.0,659.0,659.0,5,1079,1.0,811.0,811.0
0.045,17,2,179,1,71,0.0,43.0,43.0,1,108,0.0,80.0,80.0
0.001,17,2,180,1,66,0.0,38.0,38.0,1,114,0.0,86.0,86.0
0.005,17,2,222,1,65,0.0,37.0,37.0,1,157,0.0,129.0,129.0
0.017,6,10,1990,5,911,4.0,643.0,643.0,5,1079,4.0,811.0,811.0
0.012,6,10,1983,5,910,3.0,642.0,642.0,5,1073,2.0,805.0,805.0
15.073,17,14,9190,8,6902,2149.0,1350.0,834.0,6,2288,3008.0,1350.0,353.0
0.014,6,10,1972,5,910,3.0,642.0,642.0,5,1062,3.0,794.0,794.0
0.005,17,2,144,1,64,0.0,36.0,36.0,1,80,0.0,52.0,52.0
0.082,6,10,1506,5,395,19.0,127.0,127.0,5,1111,16.0,843.0,843.0
0.006,6,10,1854,5,889,1.0,621.0,621.0,5,965,1.0,697.0,697.0
0.005,6,10,2000,5,927,1.0,659.0,659.0,5,1073,1.0,805.0,805.0
0.001,17,2,180,1,66,0.0,38.0,38.0,1,114,0.0,86.0,86.0
0.005,6,13,3747,7,509,0.0,137.0,137.0,6,3238,1.0,1470.0,1459.0
0.016,6,10,1972,5,910,4.0,642.0,642.0,5,1062,3.0,794.0,794.0
0.005,6,10,1643,5,860,1.0,592.0,592.0,5,783,1.0,515.0,515.0
0.008,17,2,179,1,71,0.0,43.0,43.0,1,108,0.0,80.0,80.0
0.015,6,10,1990,5,911,3.0,643.0,643.0,5,1079,3.0,811.0,811.0
0.013,6,10,1972,5,910,3.0,642.0,642.0,5,1062,3.0,794.0,794.0
0.004,17,4,284,2,120,0.0,32.0,32.0,2,164,1.0,60.0,54.0
0.014,6,10,1677,5,827,3.0,559.0,559.0,5,850,3.0,582.0,582.0
0.015,6,10,1677,5,827,3.0,559.0,559.0,5,850,3.0,582.0,582.0
0.115,6,10,1506,5,395,27.0,127.0,127.0,5,1111,24.0,843.0,843.0
0.008,6,12,1926,6,1189,1.0,659.0,434.0,6,737,1.0,417.0,417.0
0.015,6,10,1990,5,911,3.0,643.0,643.0,5,1079,3.0,811.0,811.0
0.01,6,10,1677,5,827,2.0,559.0,559.0,5,850,2.0,582.0,582.0
0.005,17,2,157,1,59,0.0,31.0,31.0,1,98,0.0,70.0,70.0
0.001,17,2,180,1,66,0.0,38.0,38.0,1,114,0.0,86.0,86.0
0.005,6,10,2006,5,927,1.0,659.0,659.0,5,1079,1.0,811.0,811.0
0.004,6,10,1989,5,927,1.0,659.0,659.0,5,1062,1.0,794.0,794.0
0.015,6,10,1989,5,910,3.0,642.0,642.0,5,1079,3.0,811.0,811.0
15.072,17,15,9238,8,6902,2149.0,1350.0,834.0,7,2336,2507.0,1350.0,305.0
0.005,6,10,2006,5,927,1.0,659.0,659.0,5,1079,1.0,811.0,811.0
40.057,17,10,676,5,460,10013.0,104.0,64.0,5,216,10013.0,20.0,15.0
0.013,17,2,152,1,56,0.0,28.0,28.0,1,96,0.0,68.0,68.0
0.006,6,10,1689,5,839,1.0,571.0,571.0,5,850,1.0,582.0,582.0
0.006,6,10,1689,5,839,1.0,571.0,571.0,5,850,1.0,582.0,582.0
0.09,6,10,1506,5,395,16.0,127.0,127.0,5,1111,21.0,843.0,843.0
0.064,6,10,1506,5,395,13.0,127.0,127.0,5,1111,14.0,843.0,843.0
0.017,6,10,1972,5,910,4.0,642.0,642.0,5,1062,4.0,794.0,794.0
0.005,6,13,3747,7,509,0.0,137.0,137.0,6,3238,0.0,1470.0,1459.0
0.003,17,2,136,1,60,0.0,32.0,32.0,1,76,0.0,48.0,48.0
0.005,6,10,2006,5,927,1.0,659.0,659.0,5,1079,1.0,811.0,811.0
0.005,6,10,2006,5,927,1.0,659.0,659.0,5,1079,1.0,811.0,811.0
0.026,6,10,1677,5,827,6.0,559.0,559.0,5,850,6.0,582.0,582.0
300.385,6,16,2170,9,684,37526.0,146.0,146.0,7,1486,50035.0,419.0,398.0
0.253,17,2,152,1,76,0.0,48.0,48.0,1,76,0.0,48.0,48.0
0.069,6,10,1506,5,395,15.0,127.0,127.0,5,1111,16.0,843.0,843.0
0.004,6,10,1702,5,863,1.0,595.0,595.0,5,839,1.0,571.0,571.0
0.044,17,2,170,1,65,0.0,37.0,37.0,1,105,0.0,77.0,77.0
0.007,17,2,194,1,59,0.0,31.0,31.0,1,135,0.0,107.0,107.0
0.037,17,2,148,1,60,0.0,32.0,32.0,1,88,0.0,60.0,60.0
15.07,17,15,9238,8,6902,2149.0,1350.0,834.0,7,2336,2506.0,1350.0,305.0
0.013,6,10,1631,5,848,3.0,580.0,580.0,5,783,3.0,515.0,515.0
0.048,17,2,144,1,64,0.0,36.0,36.0,1,80,0.0,52.0,52.0
0.053,6,10,1989,5,910,13.0,642.0,642.0,5,1079,13.0,811.0,811.0
0.126,6,10,1506,5,395,28.0,127.0,127.0,5,1111,29.0,843.0,843.0
0.005,6,10,1547,5,764,1.0,496.0,496.0,5,783,1.0,515.0,515.0
0.005,6,10,1989,5,927,1.0,659.0,659.0,5,1062,1.0,794.0,794.0
0.006,17,2,164,1,74,0.0,46.0,46.0,1,90,0.0,62.0,62.0
0.143,6,10,1506,5,395,33.0,127.0,127.0,5,1111,32.0,843.0,843.0
0.005,6,10,2007,5,928,1.0,660.0,660.0,5,1079,1.0,811.0,811.0
0.121,6,10,1506,5,395,28.0,127.0,127.0,5,1111,25.0,843.0,843.0
0.039,17,2,170,1,65,0.0,37.0,37.0,1,105,0.0,77.0,77.0
0.016,6,10,1631,5,848,3.0,580.0,580.0,5,783,4.0,515.0,515.0
45.509,6,36,9555,18,4037,519.0,1572.0,821.0,18,5518,2667.0,2667.0,435.0
0.004,6,10,2006,5,927,1.0,659.0,659.0,5,1079,1.0,811.0,811.0
0.01,6,10,1989,5,910,2.0,642.0,642.0,5,1079,2.0,811.0,811.0
0.005,6,10,1774,5,923,1.0,655.0,655.0,5,851,1.0,583.0,583.0
0.004,17,2,136,1,60,0.0,32.0,32.0,1,76,0.0,48.0,48.0
10.78,17,28,4419,14,1995,820.0,270.0,114.0,14,2424,820.0,587.0,145.0
0.004,17,2,148,1,60,0.0,32.0,32.0,1,88,0.0,60.0,60.0
0.005,6,10,2006,5,927,1.0,659.0,659.0,5,1079,1.0,811.0,811.0
0.002,17,2,136,1,60,0.0,32.0,32.0,1,76,0.0,48.0,48.0
0.005,6,10,1989,5,927,1.0,659.0,659.0,5,1062,1.0,794.0,794.0
0.017,6,10,1989,5,910,4.0,642.0,642.0,5,1079,4.0,811.0,811.0
11.497,17,28,4395,14,2313,872.0,588.0,137.0,14,2082,872.0,269.0,120.0
0.006,6,10,1547,5,764,1.0,496.0,496.0,5,783,1.0,515.0,515.0
0.017,6,10,1631,5,848,4.0,580.0,580.0,5,783,4.0,515.0,515.0
40.057,17,10,676,5,460,10013.0,104.0,64.0,5,216,10013.0,20.0,15.0
0.006,6,10,1689,5,839,1.0,571.0,571.0,5,850,1.0,582.0,582.0
0.005,6,10,1854,5,889,1.0,621.0,621.0,5,965,1.0,697.0,697.0
0.024,6,10,1677,5,827,6.0,559.0,559.0,5,850,6.0,582.0,582.0
0.006,6,10,1547,5,764,1.0,496.0,496.0,5,783,1.0,515.0,515.0
0.167,17,2,152,1,76,0.0,48.0,48.0,1,76,0.0,48.0,48.0
300.991,6,47,19983,25,14305,12541.0,2720.0,1327.0,22,5678,419.0,2667.0,435.0
0.074,6,10,1506,5,395,16.0,127.0,127.0,5,1111,17.0,843.0,843.0
0.015,6,10,1990,5,911,3.0,643.0,643.0,5,1079,3.0,811.0,811.0
0.016,6,10,1989,5,910,4.0,642.0,642.0,5,1079,4.0,811.0,811.0
0.009,6,10,1989,5,910,2.0,642.0,642.0,5,1079,2.0,811.0,811.0
11.245,17,28,4422,14,1994,852.0,269.0,114.0,14,2428,852.0,587.0,145.0
0.108,6,10,1506,5,395,23.0,127.0,127.0,5,1111,22.0,843.0,843.0
0.006,6,10,1547,5,764,1.0,496.0,496.0,5,783,1.0,515.0,515.0
0.041,17,2,144,1,64,0.0,36.0,36.0,1,80,0.0,52.0,52.0
366.781,6,22,2313,16,867,24452.0,195.0,195.0,6,1446,4636.0,419.0,398.0
0.006,6,10,2006,5,927,1.0,659.0,659.0,5,1079,1.0,811.0,811.0
0.006,6,10,1547,5,764,1.0,496.0,496.0,5,783,1.0,515.0,515.0
0.013,6,10,1989,5,910,3.0,642.0,642.0,5,1079,3.0,811.0,811.0
0.015,6,10,1972,5,910,3.0,642.0,642.0,5,1062,3.0,794.0,794.0
126.08,6,14,2938,8,2504,17977.0,1414.0,1086.0,6,434,25168.0,182.0,182.0
0.02,6,10,1989,5,910,5.0,642.0,642.0,5,1079,5.0,811.0,811.0
0.013,6,10,1677,5,827,3.0,559.0,559.0,5,850,3.0,582.0,582.0
0.006,17,2,212,1,74,0.0,46.0,46.0,1,138,0.0,110.0,110.0
0.016,6,10,1983,5,910,4.0,642.0,642.0,5,1073,4.0,805.0,805.0
0.006,6,10,2007,5,928,1.0,660.0,660.0,5,1079,1.0,811.0,811.0
0.08,6,10,1506,5,395,16.0,127.0,127.0,5,1111,16.0,843.0,843.0
0.013,6,10,1677,5,827,3.0,559.0,559.0,5,850,3.0,582.0,582.0
0.07,17,8,3613,4,1874,23.0,1350.0,440.0,4,1739,11.0,1350.0,406.0
10.787,17,28,4422,14,1994,821.0,269.0,114.0,14,2428,821.0,587.0,145.0
0.017,6,10,1631,5,848,4.0,580.0,580.0,5,783,4.0,515.0,515.0
0.01,6,12,1926,6,1189,2.0,659.0,434.0,6,737,2.0,417.0,417.0
0.003,17,2,136,1,60,0.0,32.0,32.0,1,76,0.0,48.0,48.0
0.001,17,2,136,1,60,0.0,32.0,32.0,1,76,0.0,48.0,48.0
0.015,6,10,1762,5,911,3.0,643.0,643.0,5,851,3.0,583.0,583.0
0.015,6,11,2041,6,962,3.0,642.0,642.0,5,1079,3.0,811.0,811.0
0.004,6,13,3690,7,452,0.0,80.0,80.0,6,3238,0.0,1470.0,1459.0
0.085,6,10,1506,5,395,17.0,127.0,127.0,5,1111,19.0,843.0,843.0
0.005,6,10,2007,5,928,1.0,660.0,660.0,5,1079,1.0,811.0,811.0
240.541,6,33,9264,16,1836,16033.0,624.0,199.0,17,7428,15031.0,1402.0,595.0
0.004,17,2,136,1,60,0.0,32.0,32.0,1,76,0.0,48.0,48.0
0.109,6,10,1506,5,395,25.0,127.0,127.0,5,1111,21.0,843.0,843.0
0.001,17,2,180,1,66,0.0,38.0,38.0,1,114,0.0,86.0,86.0
0.053,17,2,152,1,76,0.0,48.0,48.0,1,76,0.0,48.0,48.0
0.072,6,10,1506,5,395,15.0,127.0,127.0,5,1111,15.0,843.0,843.0
0.131,6,10,1506,5,395,30.0,127.0,127.0,5,1111,16.0,843.0,843.0
0.032,6,10,1972,5,910,7.0,642.0,642.0,5,1062,7.0,794.0,794.0
0.005,6,10,2006,5,927,1.0,659.0,659.0,5,1079,1.0,811.0,811.0
0.1,6,10,1506,5,395,22.0,127.0,127.0,5,1111,22.0,843.0,843.0
0.11,6,10,1506,5,395,22.0,127.0,127.0,5,1111,17.0,843.0,843.0
300.393,6,16,2170,9,684,37528.0,146.0,146.0,7,1486,50037.0,419.0,398.0
0.001,17,2,166,1,75,0.0,47.0,47.0,1,91,0.0,63.0,63.0
0.009,6,10,1990,5,911,2.0,643.0,643.0,5,1079,2.0,811.0,811.0
0.165,17,2,152,1,76,0.0,48.0,48.0,1,76,0.0,48.0,48.0
0.009,6,12,1926,6,1189,1.0,659.0,434.0,6,737,1.0,417.0,417.0
0.008,6,10,1989,5,910,2.0,642.0,642.0,5,1079,2.0,811.0,811.0
308.551,17,20,1124,10,716,34267.0,48.0,43.0,10,408,34266.0,20.0,12.0
11.157,17,28,4422,14,1994,845.0,269.0,114.0,14,2428,845.0,587.0,145.0
0.006,17,2,193,1,71,0.0,43.0,43.0,1,122,0.0,94.0,94.0
0.004,17,2,148,1,60,0.0,32.0,32.0,1,88,0.0,60.0,60.0
0.075,6,10,1506,5,395,15.0,127.0,127.0,5,1111,16.0,843.0,843.0
0.011,6,11,2042,6,963,2.0,643.0,643.0,5,1079,2.0,811.0,811.0
0.107,6,10,1506,5,395,26.0,127.0,127.0,5,1111,23.0,843.0,843.0
0.005,6,10,2006,5,927,1.0,659.0,659.0,5,1079,1.0,811.0,811.0
0.005,6,10,1779,5,928,1.0,660.0,660.0,5,851,1.0,583.0,583.0
0.039,17,4,420,2,122,0.0,33.0,33.0,2,298,35.0,145.0,121.0
0.072,17,2,182,1,65,0.0,37.0,37.0,1,117,0.0,89.0,89.0
40.093,17,10,676,5,460,10022.0,104.0,64.0,5,216,10022.0,20.0,15.0
0.004,6,10,2006,5,927,1.0,659.0,659.0,5,1079,1.0,811.0,811.0
0.005,6,10,2007,5,928,1.0,660.0,660.0,5,1079,1.0,811.0,811.0
0.005,6,10,2000,5,927,1.0,659.0,659.0,5,1073,1.0,805.0,805.0
0.261,17,41,21559,23,18472,11.0,1350.0,775.0,18,3087,11.0,1350.0,143.0
0.102,6,10,1506,5,395,21.0,127.0,127.0,5,1111,24.0,843.0,843.0
40.071,17,10,676,5,460,10016.0,104.0,64.0,5,216,10016.0,20.0,15.0
0.005,6,10,1774,5,923,1.0,655.0,655.0,5,851,1.0,583.0,583.0
0.005,6,13,3747,7,509,0.0,137.0,137.0,6,3238,1.0,1470.0,1459.0
0.12,6,10,1506,5,395,23.0,127.0,127.0,5,1111,28.0,843.0,843.0
0.12,6,10,1506,5,395,25.0,127.0,127.0,5,1111,23.0,843.0,843.0
40.06,17,10,676,5,460,10014.0,104.0,64.0,5,216,10014.0,20.0,15.0
0.018,6,10,1631,5,848,4.0,580.0,580.0,5,783,4.0,515.0,515.0
0.013,6,10,1989,5,910,3.0,642.0,642.0,5,1079,3.0,811.0,811.0
0.004,6,10,1774,5,923,1.0,655.0,655.0,5,851,1.0,583.0,583.0
40.055,17,10,676,5,460,10012.0,104.0,64.0,5,216,10012.0,20.0,15.0
40.077,17,10,676,5,460,10018.0,104.0,64.0,5,216,10018.0,20.0,15.0
0.016,6,10,1972,5,910,3.0,642.0,642.0,5,1062,4.0,794.0,794.0
623.619,6,32,8420,17,4752,38974.0,973.0,482.0,15,3668,44541.0,821.0,482.0
0.041,17,2,152,1,76,0.0,48.0,48.0,1,76,0.0,48.0,48.0
0.003,17,2,132,1,58,0.0,30.0,30.0,1,74,0.0,46.0,46.0
0.011,6,10,1989,5,910,2.0,642.0,642.0,5,1079,2.0,811.0,811.0
76.807,6,22,7437,11,1305,109.0,530.0,277.0,11,6132,7663.0,2720.0,946.0
175.182,17,72,10086,36,2400,5004.0,44.0,38.0,36,7686,5004.0,239.0,185.0
0.005,17,4,284,2,120,0.0,32.0,32.0,2,164,0.0,60.0,54.0
0.005,6,10,2000,5,927,1.0,659.0,659.0,5,1073,1.0,805.0,805.0
0.012,6,10,1972,5,910,3.0,642.0,642.0,5,1062,3.0,794.0,794.0
0.009,6,10,1631,5,848,2.0,580.0,580.0,5,783,2.0,515.0,515.0
0.004,6,10,2000,5,927,1.0,659.0,659.0,5,1073,1.0,805.0,805.0
0.004,6,10,1989,5,927,1.0,659.0,659.0,5,1062,1.0,794.0,794.0
0.014,6,10,1983,5,910,3.0,642.0,642.0,5,1073,3.0,805.0,805.0
0.004,6,10,2006,5,927,1.0,659.0,659.0,5,1079,1.0,811.0,811.0
0.01,17,2,144,1,64,0.0,36.0,36.0,1,80,0.0,52.0,52.0
0.109,6,10,1506,5,395,25.0,127.0,127.0,5,1111,26.0,843.0,843.0
0.041,17,4,284,2,120,0.0,32.0,32.0,2,164,37.0,60.0,54.0
0.101,6,10,1506,5,395,23.0,127.0,127.0,5,1111,24.0,843.0,843.0
0.009,6,10,1990,5,911,2.0,643.0,643.0,5,1079,2.0,811.0,811.0
300.367,6,16,2170,9,684,37525.0,146.0,146.0,7,1486,50033.0,419.0,398.0
0.008,6,14,3787,7,497,1.0,125.0,125.0,7,3290,1.0,1448.0,972.0
0.09,6,10,1506,5,395,20.0,127.0,127.0,5,1111,20.0,843.0,843.0
0.001,17,2,180,1,66,0.0,38.0,38.0,1,114,0.0,86.0,86.0
0.018,6,10,1972,5,910,4.0,642.0,642.0,5,1062,4.0,794.0,794.0
0.019,6,10,1989,5,910,4.0,642.0,642.0,5,1079,4.0,811.0,811.0
0.012,6,10,1983,5,910,3.0,642.0,642.0,5,1073,2.0,805.0,805.0
0.004,6,10,1702,5,863,1.0,595.0,595.0,5,839,1.0,571.0,571.0
0.118,6,10,1506,5,395,27.0,127.0,127.0,5,1111,28.0,843.0,843.0
0.127,17,2,412,1,61,0.0,33.0,33.0,1,351,0.0,323.0,323.0
15.07,17,15,9238,8,6902,2148.0,1350.0,834.0,7,2336,2506.0,1350.0,305.0
0.056,17,2,299,1,65,0.0,37.0,37.0,1,234,0.0,206.0,206.0
0.005,6,13,3684,7,446,0.0,74.0,74.0,6,3238,1.0,1470.0,1459.0
0.014,17,2,179,1,71,0.0,43.0,43.0,1,108,0.0,80.0,80.0
0.003,17,2,148,1,60,0.0,32.0,32.0,1,88,0.0,60.0,60.0
0.016,6,10,1990,5,911,3.0,643.0,643.0,5,1079,4.0,811.0,811.0
0.124,6,10,1506,5,395,26.0,127.0,127.0,5,1111,28.0,843.0,843.0
0.038,17,4,284,2,120,0.0,32.0,32.0,2,164,34.0,60.0,54.0
0.006,6,10,2006,5,927,1.0,659.0,659.0,5,1079,1.0,811.0,811.0
0.004,6,10,2000,5,927,1.0,659.0,659.0,5,1073,1.0,805.0,805.0
40.064,17,10,676,5,460,10013.0,104.0,64.0,5,216,10015.0,20.0,15.0
0.012,6,10,1989,5,910,3.0,642.0,642.0,5,1079,2.0,811.0,811.0
0.004,6,10,2007,5,928,1.0,660.0,660.0,5,1079,1.0,811.0,811.0
0.005,6,10,1989,5,927,1.0,659.0,659.0,5,1062,1.0,794.0,794.0
352.254,6,20,2210,6,1308,12004.0,494.0,494.0,14,902,27096.0,83.0,83.0
0.098,6,10,1506,5,395,23.0,127.0,127.0,5,1111,21.0,843.0,843.0
0.006,6,10,1547,5,764,1.0,496.0,496.0,5,783,1.0,515.0,515.0
0.07,6,10,1506,5,395,16.0,127.0,127.0,5,1111,14.0,843.0,843.0
177.333,17,74,10631,37,2457,4925.0,44.0,38.0,37,8174,4925.0,261.0,192.0
0.01,6,10,1631,5,848,2.0,580.0,580.0,5,783,2.0,515.0,515.0
311.939,17,20,1124,10,716,34645.0,48.0,43.0,10,408,34645.0,20.0,12.0
0.005,6,13,3747,7,509,0.0,137.0,137.0,6,3238,0.0,1470.0,1459.0
0.081,6,10,1506,5,395,18.0,127.0,127.0,5,1111,18.0,843.0,843.0
0.012,6,10,1990,5,911,3.0,643.0,643.0,5,1079,3.0,811.0,811.0
0.036,17,2,136,1,60,0.0,32.0,32.0,1,76,0.0,48.0,48.0
0.007,17,4,284,2,120,0.0,32.0,32.0,2,164,0.0,60.0,54.0
0.006,6,10,1854,5,889,1.0,621.0,621.0,5,965,1.0,697.0,697.0
0.188,6,10,1506,5,395,40.0,127.0,127.0,5,1111,28.0,843.0,843.0
0.005,6,13,3747,7,509,0.0,137.0,137.0,6,3238,0.0,1470.0,1459.0
0.083,6,10,1506,5,395,18.0,127.0,127.0,5,1111,18.0,843.0,843.0
0.013,6,10,1631,5,848,3.0,580.0,580.0,5,783,3.0,515.0,515.0
0.084,6,10,1506,5,395,20.0,127.0,127.0,5,1111,18.0,843.0,843.0
11.08,17,28,4420,14,1993,839.0,268.0,114.0,14,2427,839.0,586.0,145.0
280.305,6,22,6035,10,1186,31145.0,267.0,156.0,12,4849,25481.0,1400.0,873.0
0.723,6,22,5072,11,1250,61.0,325.0,133.0,11,3822,61.0,1414.0,563.0
300.469,6,16,2170,9,684,37537.0,146.0,146.0,7,1486,50049.0,419.0,398.0
0.011,6,10,1762,5,911,2.0,643.0,643.0,5,851,2.0,583.0,583.0
0.013,6,10,1972,5,910,3.0,642.0,642.0,5,1062,3.0,794.0,794.0
0.016,6,10,1972,5,910,4.0,642.0,642.0,5,1062,4.0,794.0,794.0
0.012,6,10,1989,5,910,3.0,642.0,642.0,5,1079,2.0,811.0,811.0
15.068,17,15,9238,8,6902,2148.0,1350.0,834.0,7,2336,2506.0,1350.0,305.0
176.458,17,78,11089,39,2600,4643.0,44.0,38.0,39,8489,4643.0,239.0,189.0
0.076,6,10,1506,5,395,16.0,127.0,127.0,5,1111,15.0,843.0,843.0
0.006,6,10,1547,5,764,1.0,496.0,496.0,5,783,1.0,515.0,515.0
0.009,6,10,1989,5,910,2.0,642.0,642.0,5,1079,2.0,811.0,811.0
0.017,6,10,1677,5,827,4.0,559.0,559.0,5,850,4.0,582.0,582.0
300.938,6,46,21054,25,15416,12539.0,2720.0,1438.0,21,5638,438.0,2667.0,435.0
361.82,6,21,1792,16,1030,24121.0,190.0,190.0,5,762,60010.0,461.0,247.0
0.0,17,2,166,1,75,0.0,47.0,47.0,1,91,0.0,63.0,63.0
0.004,17,2,132,1,58,0.0,30.0,30.0,1,74,0.0,46.0,46.0
309.351,17,20,1124,10,716,34358.0,48.0,43.0,10,408,34358.0,20.0,12.0
0.003,17,2,148,1,60,0.0,32.0,32.0,1,88,0.0,60.0,60.0
15.072,17,15,9238,8,6902,2149.0,1350.0,834.0,7,2336,2507.0,1350.0,305.0
0.041,17,2,182,1,65,0.0,37.0,37.0,1,117,0.0,89.0,89.0
0.078,6,10,1506,5,395,16.0,127.0,127.0,5,1111,16.0,843.0,843.0
0.112,6,10,1506,5,395,27.0,127.0,127.0,5,1111,25.0,843.0,843.0
40.056,17,10,676,5,460,10012.0,104.0,64.0,5,216,10013.0,20.0,15.0
0.133,6,10,1506,5,395,30.0,127.0,127.0,5,1111,30.0,843.0,843.0
0.01,6,10,1983,5,910,2.0,642.0,642.0,5,1073,2.0,805.0,805.0
0.005,6,13,3747,7,509,0.0,137.0,137.0,6,3238,1.0,1470.0,1459.0
0.071,6,10,1506,5,395,16.0,127.0,127.0,5,1111,15.0,843.0,843.0
0.004,6,10,2006,5,927,1.0,659.0,659.0,5,1079,1.0,811.0,811.0
0.076,6,10,1506,5,395,17.0,127.0,127.0,5,1111,15.0,843.0,843.0
0.005,6,13,3690,7,452,0.0,80.0,80.0,6,3238,0.0,1470.0,1459.0
0.011,6,10,1972,5,910,2.0,642.0,642.0,5,1062,2.0,794.0,794.0
0.016,17,2,198,1,91,0.0,63.0,63.0,1,107,0.0,79.0,79.0
0.217,6,16,2777,8,1395,31.0,533.0,323.0,8,1382,19.0,529.0,239.0
0.006,6,10,1547,5,764,1.0,496.0,496.0,5,783,1.0,515.0,515.0
0.007,6,10,1547,5,764,1.0,496.0,496.0,5,783,1.0,515.0,515.0
0.018,6,10,1983,5,910,4.0,642.0,642.0,5,1073,4.0,805.0,805.0
0.005,6,10,2006,5,927,1.0,659.0,659.0,5,1079,1.0,811.0,811.0
0.004,17,2,132,1,58,0.0,30.0,30.0,1,74,0.0,46.0,46.0
0.005,6,10,1989,5,927,1.0,659.0,659.0,5,1062,1.0,794.0,794.0
0.007,6,10,1989,5,910,1.0,642.0,642.0,5,1079,1.0,811.0,811.0
0.038,17,4,596,2,122,0.0,33.0,33.0,2,474,34.0,323.0,209.0
0.009,6,10,1989,5,910,2.0,642.0,642.0,5,1079,2.0,811.0,811.0
0.005,6,10,2006,5,927,1.0,659.0,659.0,5,1079,1.0,811.0,811.0
0.103,17,2,179,1,71,0.0,43.0,43.0,1,108,0.0,80.0,80.0
0.118,6,10,1506,5,395,27.0,127.0,127.0,5,1111,27.0,843.0,843.0
0.038,17,2,128,1,56,0.0,28.0,28.0,1,72,0.0,44.0,44.0
0.018,6,10,1972,5,910,4.0,642.0,642.0,5,1062,4.0,794.0,794.0
0.004,17,4,284,2,120,0.0,32.0,32.0,2,164,1.0,60.0,54.0
0.005,6,10,2000,5,927,1.0,659.0,659.0,5,1073,1.0,805.0,805.0
0.005,6,10,1854,5,889,1.0,621.0,621.0,5,965,1.0,697.0,697.0
0.005,6,10,2007,5,928,1.0,660.0,660.0,5,1079,1.0,811.0,811.0
0.011,6,10,1989,5,910,2.0,642.0,642.0,5,1079,2.0,811.0,811.0
0.005,6,10,2006,5,927,1.0,659.0,659.0,5,1079,1.0,811.0,811.0
0.005,17,2,230,1,68,0.0,40.0,40.0,1,162,0.0,134.0,134.0
0.006,6,10,1689,5,839,1.0,571.0,571.0,5,850,1.0,582.0,582.0
10.866,17,28,4422,14,1994,827.0,269.0,114.0,14,2428,827.0,587.0,145.0
0.016,6,10,1989,5,910,4.0,642.0,642.0,5,1079,4.0,811.0,811.0
0.006,17,2,152,1,68,0.0,40.0,40.0,1,84,0.0,56.0,56.0
175.065,17,80,11240,40,2672,4488.0,44.0,38.0,40,8568,4488.0,239.0,186.0
0.011,6,10,1762,5,911,2.0,643.0,643.0,5,851,2.0,583.0,583.0
0.006,6,10,1547,5,764,1.0,496.0,496.0,5,783,1.0,515.0,515.0
0.016,6,10,1972,5,910,4.0,642.0,642.0,5,1062,3.0,794.0,794.0
0.127,17,2,136,1,60,0.0,32.0,32.0,1,76,0.0,48.0,48.0
0.006,6,10,1547,5,764,1.0,496.0,496.0,5,783,1.0,515.0,515.0
0.011,6,10,1972,5,910,2.0,642.0,642.0,5,1062,2.0,794.0,794.0
0.006,6,10,1854,5,889,1.0,621.0,621.0,5,965,1.0,697.0,697.0
0.005,6,10,2000,5,927,1.0,659.0,659.0,5,1073,1.0,805.0,805.0
0.019,6,10,1989,5,910,4.0,642.0,642.0,5,1079,4.0,811.0,811.0
40.076,17,10,676,5,460,10018.0,104.0,64.0,5,216,10018.0,20.0,15.0
0.003,17,2,136,1,60,0.0,32.0,32.0,1,76,0.0,48.0,48.0
0.004,17,2,148,1,60,0.0,32.0,32.0,1,88,0.0,60.0,60.0
0.004,6,10,2000,5,927,1.0,659.0,659.0,5,1073,1.0,805.0,805.0
0.089,6,10,1506,5,395,17.0,127.0,127.0,5,1111,21.0,843.0,843.0
0.096,6,10,1506,5,395,20.0,127.0,127.0,5,1111,19.0,843.0,843.0
0.005,6,10,2007,5,928,1.0,660.0,660.0,5,1079,1.0,811.0,811.0
0.106,6,10,1506,5,395,24.0,127.0,127.0,5,1111,23.0,843.0,843.0
0.005,6,10,2006,5,927,1.0,659.0,659.0,5,1079,1.0,811.0,811.0
352.589,6,20,2210,6,1308,12003.0,494.0,494.0,14,902,27122.0,83.0,83.0
175.566,17,80,11457,40,2674,4501.0,44.0,38.0,40,8783,4501.0,252.0,191.0
15.078,17,16,9302,8,6912,2149.0,1350.0,836.0,8,2390,2149.0,1350.0,270.0
0.009,6,12,1926,6,1189,1.0,659.0,434.0,6,737,1.0,417.0,417.0
0.004,17,2,148,1,60,0.0,32.0,32.0,1,88,0.0,60.0,60.0
0.007,17,2,302,1,65,0.0,37.0,37.0,1,237,0.0,209.0,209.0
0.004,17,2,148,1,60,0.0,32.0,32.0,1,88,0.0,60.0,60.0
0.005,6,10,1689,5,839,1.0,571.0,571.0,5,850,1.0,582.0,582.0
11.174,17,28,4417,14,1993,847.0,268.0,114.0,14,2424,847.0,587.0,145.0
10.703,17,28,4422,14,1994,815.0,269.0,114.0,14,2428,815.0,587.0,145.0
361.819,6,21,1793,16,1030,24121.0,190.0,190.0,5,763,60011.0,462.0,247.0
0.005,6,10,1643,5,860,1.0,592.0,592.0,5,783,1.0,515.0,515.0
0.004,6,10,1989,5,927,1.0,659.0,659.0,5,1062,1.0,794.0,794.0
0.075,6,10,1506,5,395,14.0,127.0,127.0,5,1111,17.0,843.0,843.0
0.005,6,10,1989,5,927,1.0,659.0,659.0,5,1062,1.0,794.0,794.0
40.037,17,10,676,5,460,10007.0,104.0,64.0,5,216,10006.0,20.0,15.0
301.189,6,59,31481,32,25374,9715.0,2720.0,1503.0,27,6107,346.0,2667.0,385.0
169.365,17,98,14266,49,3298,3528.0,44.0,39.0,49,10968,3528.0,252.0,195.0
0.005,6,10,2007,5,928,1.0,660.0,660.0,5,1079,1.0,811.0,811.0
0.006,6,10,1547,5,764,1.0,496.0,496.0,5,783,1.0,515.0,515.0
0.004,6,10,1774,5,923,1.0,655.0,655.0,5,851,1.0,583.0,583.0
0.015,6,10,2000,5,927,3.0,659.0,659.0,5,1073,3.0,805.0,805.0
0.008,6,10,1762,5,911,2.0,643.0,643.0,5,851,2.0,583.0,583.0
0.042,17,2,186,1,61,0.0,33.0,33.0,1,125,0.0,97.0,97.0
0.016,17,2,198,1,91,0.0,63.0,63.0,1,107,0.0,79.0,79.0
0.004,6,13,3690,7,452,0.0,80.0,80.0,6,3238,0.0,1470.0,1459.0
0.005,17,2,213,1,69,0.0,41.0,41.0,1,144,0.0,116.0,116.0
0.062,17,2,80,1,32,0.0,4.0,4.0,1,48,0.0,20.0,20.0
0.124,6,10,1506,5,395,28.0,127.0,127.0,5,1111,28.0,843.0,843.0
0.005,6,10,1547,5,764,1.0,496.0,496.0,5,783,1.0,515.0,515.0
0.219,6,16,2777,8,1395,31.0,533.0,323.0,8,1382,20.0,529.0,239.0
0.01,6,10,1983,5,910,2.0,642.0,642.0,5,1073,2.0,805.0,805.0
0.012,6,10,1983,5,910,3.0,642.0,642.0,5,1073,3.0,805.0,805.0
0.001,17,2,140,1,62,0.0,34.0,34.0,1,78,0.0,50.0,50.0
0.006,6,10,1854,5,889,1.0,621.0,621.0,5,965,1.0,697.0,697.0
0.011,6,10,1989,5,910,2.0,642.0,642.0,5,1079,2.0,811.0,811.0
0.095,6,10,1506,5,395,20.0,127.0,127.0,5,1111,21.0,843.0,843.0
0.012,6,10,1983,5,910,3.0,642.0,642.0,5,1073,3.0,805.0,805.0
0.006,6,13,3747,7,509,0.0,137.0,137.0,6,3238,1.0,1470.0,1459.0
0.013,6,10,1989,5,910,3.0,642.0,642.0,5,1079,3.0,811.0,811.0
0.008,6,12,1698,6,863,1.0,327.0,271.0,6,835,1.0,515.0,515.0
374.537,6,22,2313,16,867,24969.0,195.0,195.0,6,1446,4635.0,419.0,398.0
0.004,6,10,1702,5,863,1.0,595.0,595.0,5,839,1.0,571.0,571.0
0.005,17,2,169,1,62,0.0,34.0,34.0,1,107,0.0,79.0,79.0
0.137,6,10,1506,5,395,32.0,127.0,127.0,5,1111,31.0,843.0,843.0
0.011,6,10,1972,5,910,2.0,642.0,642.0,5,1062,2.0,794.0,794.0
0.015,6,10,1989,5,910,3.0,642.0,642.0,5,1079,3.0,811.0,811.0
0.015,6,10,1989,5,910,3.0,642.0,642.0,5,1079,3.0,811.0,811.0
0.01,6,10,1972,5,910,2.0,642.0,642.0,5,1062,2.0,794.0,794.0
15.073,17,15,8126,8,5925,2149.0,1350.0,712.0,7,2201,2507.0,1350.0,286.0
0.116,6,10,1506,5,395,26.0,127.0,127.0,5,1111,28.0,843.0,843.0
0.228,6,16,2670,8,1396,32.0,533.0,324.0,8,1274,20.0,529.0,212.0
0.004,17,2,144,1,64,0.0,36.0,36.0,1,80,0.0,52.0,52.0
0.112,6,10,1506,5,395,22.0,127.0,127.0,5,1111,25.0,843.0,843.0
0.033,6,10,1990,5,911,8.0,643.0,643.0,5,1079,8.0,811.0,811.0
0.005,6,10,2007,5,928,1.0,660.0,660.0,5,1079,1.0,811.0,811.0
241.297,6,368,346289,129,18219,1885.0,2736.0,885.0,239,328070,1013.0,2804.0,1378.0
0.118,6,10,1506,5,395,25.0,127.0,127.0,5,1111,28.0,843.0,843.0
0.065,6,10,1506,5,395,14.0,127.0,127.0,5,1111,13.0,843.0,843.0
0.012,6,10,1762,5,911,2.0,643.0,643.0,5,851,2.0,583.0,583.0
174.089,17,88,12852,44,2971,4048.0,44.0,39.0,44,9881,4048.0,239.0,196.0
0.005,6,13,3747,7,509,0.0,137.0,137.0,6,3238,0.0,1470.0,1459.0
0.011,6,10,1972,5,910,2.0,642.0,642.0,5,1062,2.0,794.0,794.0
0.005,6,13,3690,7,452,0.0,80.0,80.0,6,3238,0.0,1470.0,1459.0
0.004,17,2,136,1,60,0.0,32.0,32.0,1,76,0.0,48.0,48.0
0.004,6,10,1989,5,927,1.0,659.0,659.0,5,1062,1.0,794.0,794.0
0.01,6,10,1990,5,911,2.0,643.0,643.0,5,1079,2.0,811.0,811.0
1778.626,17,139,43924,72,22752,25050.0,288.0,288.0,67,21172,26948.0,288.0,288.0
0.224,6,16,2778,8,1396,32.0,533.0,324.0,8,1382,20.0,529.0,239.0
40.069,17,10,676,5,460,10013.0,104.0,64.0,5,216,10016.0,20.0,15.0
0.009,6,10,1990,5,911,2.0,643.0,643.0,5,1079,2.0,811.0,811.0
0.091,6,10,1506,5,395,20.0,127.0,127.0,5,1111,20.0,843.0,843.0
0.013,6,10,1762,5,911,3.0,643.0,643.0,5,851,3.0,583.0,583.0
0.006,6,10,1547,5,764,1.0,496.0,496.0,5,783,1.0,515.0,515.0
0.001,17,2,180,1,66,0.0,38.0,38.0,1,114,0.0,86.0,86.0
0.095,6,10,1506,5,395,21.0,127.0,127.0,5,1111,20.0,843.0,843.0
0.012,6,10,1990,5,911,3.0,643.0,643.0,5,1079,3.0,811.0,811.0
0.004,17,2,132,1,58,0.0,30.0,30.0,1,74,0.0,46.0,46.0
0.006,6,10,1547,5,764,1.0,496.0,496.0,5,783,1.0,515.0,515.0
0.006,6,10,1547,5,764,1.0,496.0,496.0,5,783,1.0,515.0,515.0
0.006,6,10,1689,5,839,1.0,571.0,571.0,5,850,1.0,582.0,582.0
0.006,6,10,1547,5,764,1.0,496.0,496.0,5,783,1.0,515.0,515.0
0.005,6,14,3799,7,509,0.0,137.0,137.0,7,3290,0.0,1448.0,972.0
0.004,6,10,2007,5,928,1.0,660.0,660.0,5,1079,1.0,811.0,811.0
0.005,6,10,2000,5,927,1.0,659.0,659.0,5,1073,1.0,805.0,805.0
0.125,6,10,1506,5,395,25.0,127.0,127.0,5,1111,26.0,843.0,843.0
0.005,6,10,2000,5,927,1.0,659.0,659.0,5,1073,1.0,805.0,805.0
0.165,17,2,152,1,76,0.0,48.0,48.0,1,76,0.0,48.0,48.0
0.007,17,2,194,1,59,0.0,31.0,31.0,1,135,0.0,107.0,107.0
0.01,6,10,1972,5,910,2.0,642.0,642.0,5,1062,2.0,794.0,794.0
40.062,17,10,676,5,460,10013.0,104.0,64.0,5,216,10014.0,20.0,15.0
40.057,17,10,676,5,460,10011.0,104.0,64.0,5,216,10013.0,20.0,15.0
0.014,6,10,1762,5,911,3.0,643.0,643.0,5,851,3.0,583.0,583.0
0.097,6,10,1506,5,395,22.0,127.0,127.0,5,1111,23.0,843.0,843.0
0.005,6,10,1989,5,927,1.0,659.0,659.0,5,1062,1.0,794.0,794.0
0.102,6,10,1506,5,395,23.0,127.0,127.0,5,1111,25.0,843.0,843.0
10.797,17,28,4423,14,1994,822.0,269.0,114.0,14,2429,822.0,588.0,145.0
0.005,6,10,2006,5,927,1.0,659.0,659.0,5,1079,1.0,811.0,811.0
0.005,6,10,1689,5,839,1.0,571.0,571.0,5,850,1.0,582.0,582.0
0.007,6,10,1643,5,860,1.0,592.0,592.0,5,783,1.0,515.0,515.0
40.203,17,10,676,5,460,10037.0,104.0,64.0,5,216,10045.0,20.0,15.0
0.005,6,10,2006,5,927,1.0,659.0,659.0,5,1079,1.0,811.0,811.0
0.012,6,13,3735,7,497,1.0,125.0,125.0,6,3238,2.0,1470.0,1459.0
0.009,6,10,1972,5,910,2.0,642.0,642.0,5,1062,2.0,794.0,794.0
0.013,6,10,1677,5,827,3.0,559.0,559.0,5,850,3.0,582.0,582.0
0.01,6,10,1762,5,911,2.0,643.0,643.0,5,851,2.0,583.0,583.0
0.012,6,10,1989,5,910,2.0,642.0,642.0,5,1079,3.0,811.0,811.0
0.011,6,10,1990,5,911,2.0,643.0,643.0,5,1079,2.0,811.0,811.0
300.266,6,16,2170,9,684,37512.0,146.0,146.0,7,1486,50016.0,419.0,398.0
0.014,6,10,1972,5,910,3.0,642.0,642.0,5,1062,3.0,794.0,794.0
0.377,17,67,46721,40,40067,9.0,1350.0,973.0,27,6654,13.0,1350.0,218.0
0.031,6,13,3735,7,497,5.0,125.0,125.0,6,3238,6.0,1470.0,1459.0
0.008,6,10,1972,5,910,1.0,642.0,642.0,5,1062,2.0,794.0,794.0
0.106,6,10,1506,5,395,24.0,127.0,127.0,5,1111,17.0,843.0,843.0
0.212,6,16,2782,8,1400,30.0,533.0,325.0,8,1382,19.0,529.0,239.0
0.012,6,10,1990,5,911,2.0,643.0,643.0,5,1079,2.0,811.0,811.0
0.006,6,10,1547,5,764,1.0,496.0,496.0,5,783,1.0,515.0,515.0
0.106,6,10,1506,5,395,24.0,127.0,127.0,5,1111,19.0,843.0,843.0
0.079,6,46,14088,26,2607,3.0,517.0,139.0,20,11481,3.0,1402.0,745.0
0.004,6,10,2006,5,927,1.0,659.0,659.0,5,1079,1.0,811.0,811.0
0.105,6,10,1506,5,395,24.0,127.0,127.0,5,1111,21.0,843.0,843.0
0.011,6,10,1762,5,911,2.0,643.0,643.0,5,851,2.0,583.0,583.0
1.062,6,32,12795,18,3352,62.0,1360.0,517.0,14,9443,68.0,2720.0,887.0
0.009,6,10,1983,5,910,2.0,642.0,642.0,5,1073,2.0,805.0,805.0
0.083,6,10,1506,5,395,18.0,127.0,127.0,5,1111,20.0,843.0,843.0
0.005,6,10,2006,5,927,1.0,659.0,659.0,5,1079,1.0,811.0,811.0
0.005,6,10,1689,5,839,1.0,571.0,571.0,5,850,1.0,582.0,582.0
0.008,6,10,1989,5,910,1.0,642.0,642.0,5,1079,2.0,811.0,811.0
0.011,6,10,1972,5,910,2.0,642.0,642.0,5,1062,2.0,794.0,794.0
0.005,17,2,169,1,62,0.0,34.0,34.0,1,107,0.0,79.0,79.0
0.096,6,10,1506,5,395,21.0,127.0,127.0,5,1111,18.0,843.0,843.0
0.005,6,10,2000,5,927,1.0,659.0,659.0,5,1073,1.0,805.0,805.0
0.004,17,2,412,1,61,0.0,33.0,33.0,1,351,0.0,323.0,323.0
0.005,17,2,154,1,69,0.0,41.0,41.0,1,85,0.0,57.0,57.0
0.006,6,10,1854,5,889,1.0,621.0,621.0,5,965,1.0,697.0,697.0
0.072,17,4,284,2,120,1.0,32.0,32.0,2,164,0.0,60.0,54.0
0.004,6,10,2007,5,928,1.0,660.0,660.0,5,1079,1.0,811.0,811.0
0.104,6,10,1506,5,395,22.0,127.0,127.0,5,1111,20.0,843.0,843.0
0.005,6,10,2007,5,928,1.0,660.0,660.0,5,1079,1.0,811.0,811.0
0.08,6,10,1506,5,395,16.0,127.0,127.0,5,1111,16.0,843.0,843.0
0.088,6,10,1506,5,395,19.0,127.0,127.0,5,1111,20.0,843.0,843.0
0.073,6,10,1506,5,395,15.0,127.0,127.0,5,1111,14.0,843.0,843.0
0.005,6,10,1702,5,863,1.0,595.0,595.0,5,839,1.0,571.0,571.0
0.006,6,10,1547,5,764,1.0,496.0,496.0,5,783,1.0,515.0,515.0
0.003,17,2,152,1,76,0.0,48.0,48.0,1,76,0.0,48.0,48.0
0.005,6,10,1779,5,928,1.0,660.0,660.0,5,851,1.0,583.0,583.0
10.824,17,28,4420,14,1993,824.0,268.0,114.0,14,2427,824.0,586.0,145.0
0.086,6,10,1506,5,395,19.0,127.0,127.0,5,1111,19.0,843.0,843.0
0.006,6,10,1547,5,764,1.0,496.0,496.0,5,783,1.0,515.0,515.0
0.005,17,2,170,1,65,0.0,37.0,37.0,1,105,0.0,77.0,77.0
240.183,6,44,9568,23,2486,10917.0,517.0,181.0,21,7082,12009.0,2378.0,598.0
0.004,17,2,170,1,65,0.0,37.0,37.0,1,105,0.0,77.0,77.0
0.01,6,10,1989,5,910,2.0,642.0,642.0,5,1079,2.0,811.0,811.0
0.1,6,10,1506,5,395,22.0,127.0,127.0,5,1111,22.0,843.0,843.0
0.068,17,8,3613,4,1874,22.0,1350.0,440.0,4,1739,11.0,1350.0,406.0
0.156,6,10,1506,5,395,33.0,127.0,127.0,5,1111,35.0,843.0,843.0
0.18,17,4,352,2,130,108.0,37.0,37.0,2,222,176.0,89.0,83.0
0.005,6,10,2006,5,927,1.0,659.0,659.0,5,1079,1.0,811.0,811.0
0.008,6,10,1990,5,911,2.0,643.0,643.0,5,1079,2.0,811.0,811.0
0.079,6,10,1506,5,395,19.0,127.0,127.0,5,1111,16.0,843.0,843.0
0.129,6,10,1506,5,395,29.0,127.0,127.0,5,1111,23.0,843.0,843.0
0.004,17,2,148,1,60,0.0,32.0,32.0,1,88,0.0,60.0,60.0
11.126,17,28,4421,14,1993,843.0,268.0,114.0,14,2428,843.0,587.0,145.0
0.006,6,10,1854,5,889,1.0,621.0,621.0,5,965,1.0,697.0,697.0
0.001,17,2,180,1,66,0.0,38.0,38.0,1,114,0.0,86.0,86.0
0.074,6,10,1506,5,395,16.0,127.0,127.0,5,1111,16.0,843.0,843.0
0.004,6,10,1779,5,928,1.0,660.0,660.0,5,851,1.0,583.0,583.0
0.003,17,2,148,1,60,0.0,32.0,32.0,1,88,0.0,60.0,60.0
40.064,17,10,676,5,460,10015.0,104.0,64.0,5,216,10015.0,20.0,15.0
0.004,6,10,2006,5,927,1.0,659.0,659.0,5,1079,1.0,811.0,811.0
0.015,6,10,1983,5,910,3.0,642.0,642.0,5,1073,3.0,805.0,805.0
0.012,6,10,1762,5,911,2.0,643.0,643.0,5,851,3.0,583.0,583.0
0.015,6,10,1990,5,911,3.0,643.0,643.0,5,1079,3.0,811.0,811.0
0.006,17,2,160,1,72,0.0,44.0,44.0,1,88,0.0,60.0,60.0
0.012,6,10,1990,5,911,3.0,643.0,643.0,5,1079,3.0,811.0,811.0
0.008,6,10,1990,5,911,2.0,643.0,643.0,5,1079,1.0,811.0,811.0
40.067,17,10,676,5,460,10015.0,104.0,64.0,5,216,10016.0,20.0,15.0
0.005,6,10,1989,5,927,1.0,659.0,659.0,5,1062,1.0,794.0,794.0
0.291,17,39,20195,21,17047,14.0,1350.0,783.0,18,3148,13.0,1350.0,146.0
0.016,6,10,1972,5,910,3.0,642.0,642.0,5,1062,4.0,794.0,794.0
0.004,6,10,2006,5,927,1.0,659.0,659.0,5,1079,1.0,811.0,811.0
0.005,6,10,2007,5,928,1.0,660.0,660.0,5,1079,1.0,811.0,811.0
0.004,6,10,2006,5,927,1.0,659.0,659.0,5,1079,1.0,811.0,811.0
0.006,6,10,1547,5,764,1.0,496.0,496.0,5,783,1.0,515.0,515.0
0.005,6,10,2007,5,928,1.0,660.0,660.0,5,1079,1.0,811.0,811.0
0.004,17,2,148,1,60,0.0,32.0,32.0,1,88,0.0,60.0,60.0
0.015,6,10,1983,5,910,3.0,642.0,642.0,5,1073,3.0,805.0,805.0
40.059,17,10,676,5,460,10013.0,104.0,64.0,5,216,10014.0,20.0,15.0
0.094,6,10,1506,5,395,20.0,127.0,127.0,5,1111,20.0,843.0,843.0
0.008,17,2,144,1,64,0.0,36.0,36.0,1,80,0.0,52.0,52.0
0.083,6,10,1506,5,395,17.0,127.0,127.0,5,1111,18.0,843.0,843.0
0.016,6,10,1631,5,848,3.0,580.0,580.0,5,783,4.0,515.0,515.0
0.006,6,10,1547,5,764,1.0,496.0,496.0,5,783,1.0,515.0,515.0
411.994,6,29,4409,12,3102,10911.0,494.0,494.0,17,1307,25749.0,83.0,83.0
0.005,17,2,230,1,68,0.0,40.0,40.0,1,162,0.0,134.0,134.0
10.92,17,28,4422,14,1993,831.0,268.0,114.0,14,2429,831.0,588.0,145.0
0.006,6,10,1643,5,860,1.0,592.0,592.0,5,783,1.0,515.0,515.0
0.009,6,10,2007,5,928,2.0,660.0,660.0,5,1079,2.0,811.0,811.0
409.648,6,41,16036,22,2955,19507.0,661.0,360.0,19,13081,19422.0,1402.0,929.0
0.006,6,10,1547,5,764,1.0,496.0,496.0,5,783,1.0,515.0,515.0
0.013,6,10,1990,5,911,3.0,643.0,643.0,5,1079,3.0,811.0,811.0
0.264,17,44,27935,26,24778,10.0,1350.0,925.0,18,3157,12.0,1350.0,147.0
0.006,6,10,1547,5,764,1.0,496.0,496.0,5,783,1.0,515.0,515.0
0.009,6,12,1926,6,1189,1.0,659.0,434.0,6,737,1.0,417.0,417.0
325.125,17,20,1124,10,716,36110.0,48.0,43.0,10,408,36110.0,20.0,12.0
0.005,6,10,2000,5,927,1.0,659.0,659.0,5,1073,1.0,805.0,805.0
15.073,17,15,9239,8,6902,2149.0,1350.0,834.0,7,2337,2507.0,1350.0,305.0
0.079,6,10,1506,5,395,17.0,127.0,127.0,5,1111,19.0,843.0,843.0
0.043,17,2,152,1,76,0.0,48.0,48.0,1,76,0.0,48.0,48.0
0.015,6,10,1990,5,911,3.0,643.0,643.0,5,1079,3.0,811.0,811.0
0.072,17,4,596,2,122,0.0,33.0,33.0,2,474,34.0,323.0,209.0
0.007,6,10,1972,5,910,1.0,642.0,642.0,5,1062,1.0,794.0,794.0
0.007,6,10,1547,5,764,1.0,496.0,496.0,5,783,1.0,515.0,515.0
11.113,17,28,4421,14,1993,842.0,268.0,114.0,14,2428,842.0,587.0,145.0
0.005,6,13,3747,7,509,0.0,137.0,137.0,6,3238,0.0,1470.0,1459.0
160.415,17,82,11433,41,2739,4010.0,44.0,38.0,41,8694,4010.0,239.0,184.0
0.094,6,10,1506,5,395,22.0,127.0,127.0,5,1111,22.0,843.0,843.0
0.005,6,10,1689,5,839,1.0,571.0,571.0,5,850,1.0,582.0,582.0
0.003,17,2,148,1,60,0.0,32.0,32.0,1,88,0.0,60.0,60.0
0.014,6,10,1983,5,910,3.0,642.0,642.0,5,1073,3.0,805.0,805.0
40.054,17,10,676,5,460,10012.0,104.0,64.0,5,216,10012.0,20.0,15.0
0.004,17,2,148,1,60,0.0,32.0,32.0,1,88,0.0,60.0,60.0
0.07,17,8,3613,4,1874,23.0,1350.0,440.0,4,1739,10.0,1350.0,406.0
0.009,6,10,1989,5,910,2.0,642.0,642.0,5,1079,2.0,811.0,811.0
1770.538,17,92,8096,46,4048,39345.0,60.0,60.0,46,4048,39345.0,60.0,60.0
1771.646,17,120,11460,60,5460,30027.0,63.0,63.0,60,6000,30027.0,72.0,72.0
0.006,6,10,1689,5,839,1.0,571.0,571.0,5,850,1.0,582.0,582.0
0.057,17,2,148,1,60,0.0,32.0,32.0,1,88,0.0,60.0,60.0
0.003,17,2,136,1,60,0.0,32.0,32.0,1,76,0.0,48.0,48.0
0.005,17,2,179,1,71,0.0,43.0,43.0,1,108,0.0,80.0,80.0
0.041,17,2,152,1,76,0.0,48.0,48.0,1,76,0.0,48.0,48.0
15.075,17,16,9190,8,6911,2149.0,1350.0,835.0,8,2279,2149.0,1350.0,256.0
0.006,6,10,1547,5,764,1.0,496.0,496.0,5,783,1.0,515.0,515.0
0.008,6,10,1989,5,910,2.0,642.0,642.0,5,1079,1.0,811.0,811.0
0.117,6,10,1506,5,395,25.0,127.0,127.0,5,1111,26.0,843.0,843.0
0.011,6,10,1989,5,910,2.0,642.0,642.0,5,1079,2.0,811.0,811.0
0.006,17,2,209,1,64,0.0,36.0,36.0,1,145,0.0,117.0,117.0
0.009,6,13,3735,7,497,1.0,125.0,125.0,6,3238,1.0,1470.0,1459.0
3.578,6,35,9868,18,4390,210.0,1925.0,909.0,17,5478,213.0,2667.0,435.0
0.004,6,13,3747,7,509,0.0,137.0,137.0,6,3238,0.0,1470.0,1459.0
0.004,17,2,136,1,60,0.0,32.0,32.0,1,76,0.0,48.0,48.0
40.053,17,10,676,5,460,10012.0,104.0,64.0,5,216,10012.0,20.0,15.0
0.008,17,2,194,1,59,0.0,31.0,31.0,1,135,0.0,107.0,107.0
300.328,6,16,2170,9,684,37519.0,146.0,146.0,7,1486,50026.0,419.0,398.0
0.01,6,10,1990,5,911,2.0,643.0,643.0,5,1079,2.0,811.0,811.0
0.006,6,10,1547,5,764,1.0,496.0,496.0,5,783,1.0,515.0,515.0
0.014,6,10,1989,5,910,3.0,642.0,642.0,5,1079,3.0,811.0,811.0
84.308,6,26,9525,12,1627,78.0,794.0,367.0,14,7898,6475.0,1360.0,732.0
0.007,6,10,1983,5,910,1.0,642.0,642.0,5,1073,1.0,805.0,805.0
0.006,6,10,1547,5,764,1.0,496.0,496.0,5,783,1.0,515.0,515.0
0.128,17,2,80,1,32,0.0,4.0,4.0,1,48,0.0,20.0,20.0
0.005,6,10,1854,5,889,1.0,621.0,621.0,5,965,1.0,697.0,697.0
11.168,17,28,4423,14,1995,846.0,270.0,114.0,14,2428,846.0,587.0,145.0
0.006,17,2,179,1,71,0.0,43.0,43.0,1,108,0.0,80.0,80.0
0.004,6,10,2006,5,927,1.0,659.0,659.0,5,1079,1.0,811.0,811.0
0.084,6,10,1506,5,395,20.0,127.0,127.0,5,1111,17.0,843.0,843.0
0.019,6,10,1972,5,910,4.0,642.0,642.0,5,1062,4.0,794.0,794.0
178.551,17,90,12651,45,2996,4057.0,44.0,38.0,45,9655,4057.0,261.0,186.0
0.005,17,2,164,1,74,0.0,46.0,46.0,1,90,0.0,62.0,62.0
0.005,6,10,1779,5,928,1.0,660.0,660.0,5,851,1.0,583.0,583.0
240.095,6,31,9135,15,6833,17149.0,1957.0,673.0,16,2302,16006.0,580.0,182.0
300.284,6,16,2170,9,684,37514.0,146.0,146.0,7,1486,50018.0,419.0,398.0
177.227,17,92,13270,46,3075,3938.0,44.0,38.0,46,10195,3938.0,239.0,193.0
177.146,17,90,12721,45,3004,4025.0,44.0,38.0,45,9717,4025.0,239.0,187.0
0.005,17,2,140,1,62,0.0,34.0,34.0,1,78,0.0,50.0,50.0
0.108,6,10,1506,5,395,23.0,127.0,127.0,5,1111,25.0,843.0,843.0
0.114,6,10,1506,5,395,24.0,127.0,127.0,5,1111,24.0,843.0,843.0
0.014,6,10,1972,5,910,3.0,642.0,642.0,5,1062,3.0,794.0,794.0
0.011,6,10,1547,5,764,2.0,496.0,496.0,5,783,2.0,515.0,515.0
300.405,6,27,7433,16,1409,20027.0,217.0,142.0,11,6024,24036.0,1679.0,777.0
0.003,17,2,148,1,60,0.0,32.0,32.0,1,88,0.0,60.0,60.0
0.083,6,10,1506,5,395,18.0,127.0,127.0,5,1111,19.0,843.0,843.0
0.001,17,2,180,1,66,0.0,38.0,38.0,1,114,0.0,86.0,86.0
176.318,17,86,12315,43,2862,4197.0,44.0,38.0,43,9453,4197.0,239.0,191.0
0.008,17,2,194,1,59,0.0,31.0,31.0,1,135,0.0,107.0,107.0
0.012,6,10,1990,5,911,2.0,643.0,643.0,5,1079,3.0,811.0,811.0
0.006,6,10,1643,5,860,1.0,592.0,592.0,5,783,1.0,515.0,515.0
0.014,6,10,1972,5,910,3.0,642.0,642.0,5,1062,3.0,794.0,794.0
0.039,17,4,364,2,160,0.0,52.0,52.0,2,204,1.0,80.0,74.0
0.134,6,10,1506,5,395,31.0,127.0,127.0,5,1111,30.0,843.0,843.0
0.005,6,13,3747,7,509,0.0,137.0,137.0,6,3238,0.0,1470.0,1459.0
413.384,6,29,4409,12,3102,10912.0,494.0,494.0,17,1307,25836.0,83.0,83.0
0.001,17,2,180,1,66,0.0,38.0,38.0,1,114,0.0,86.0,86.0
0.005,6,10,1643,5,860,1.0,592.0,592.0,5,783,1.0,515.0,515.0
0.009,6,10,1990,5,911,2.0,643.0,643.0,5,1079,2.0,811.0,811.0
0.075,17,4,336,2,124,4.0,34.0,34.0,2,212,37.0,84.0,78.0
0.005,6,13,3747,7,509,0.0,137.0,137.0,6,3238,1.0,1470.0,1459.0
0.037,17,2,170,1,65,0.0,37.0,37.0,1,105,0.0,77.0,77.0
300.395,6,16,2170,9,684,37528.0,146.0,146.0,7,1486,50038.0,419.0,398.0
0.018,6,10,1990,5,911,4.0,643.0,643.0,5,1079,4.0,811.0,811.0
0.005,6,10,1854,5,889,1.0,621.0,621.0,5,965,1.0,697.0,697.0
40.083,17,10,676,5,460,10019.0,104.0,64.0,5,216,10020.0,20.0,15.0
0.006,6,10,1779,5,928,1.0,660.0,660.0,5,851,1.0,583.0,583.0
0.005,6,13,3747,7,509,0.0,137.0,137.0,6,3238,1.0,1470.0,1459.0
0.06,17,2,80,1,32,0.0,4.0,4.0,1,48,0.0,20.0,20.0
0.005,6,10,1989,5,927,1.0,659.0,659.0,5,1062,1.0,794.0,794.0
0.001,17,2,142,1,63,0.0,35.0,35.0,1,79,0.0,51.0,51.0
0.098,6,10,1506,5,395,22.0,127.0,127.0,5,1111,18.0,843.0,843.0
0.09,6,10,1506,5,395,19.0,127.0,127.0,5,1111,17.0,843.0,843.0
0.015,6,10,1972,5,910,3.0,642.0,642.0,5,1062,3.0,794.0,794.0
0.115,6,10,1506,5,395,27.0,127.0,127.0,5,1111,25.0,843.0,843.0
0.105,6,10,1506,5,395,21.0,127.0,127.0,5,1111,22.0,843.0,843.0
0.005,6,10,1989,5,927,1.0,659.0,659.0,5,1062,1.0,794.0,794.0
15.145,17,20,13504,10,8344,1679.0,1350.0,806.0,10,5160,1679.0,1350.0,488.0
0.001,17,2,180,1,66,0.0,38.0,38.0,1,114,0.0,86.0,86.0
0.129,6,28,10234,15,8942,9.0,2261.0,1020.0,13,1292,9.0,367.0,102.0
0.014,6,10,1762,5,911,3.0,643.0,643.0,5,851,3.0,583.0,583.0
0.003,17,2,136,1,60,0.0,32.0,32.0,1,76,0.0,48.0,48.0
0.061,6,10,1506,5,395,13.0,127.0,127.0,5,1111,12.0,843.0,843.0
0.008,17,2,194,1,59,0.0,31.0,31.0,1,135,0.0,107.0,107.0
40.063,17,10,676,5,460,10015.0,104.0,64.0,5,216,10015.0,20.0,15.0
0.086,6,10,1506,5,395,17.0,127.0,127.0,5,1111,18.0,843.0,843.0
0.006,6,10,1547,5,764,1.0,496.0,496.0,5,783,1.0,515.0,515.0
0.016,6,10,1990,5,911,4.0,643.0,643.0,5,1079,3.0,811.0,811.0
0.005,6,10,2006,5,927,1.0,659.0,659.0,5,1079,1.0,811.0,811.0
0.064,6,10,1506,5,395,13.0,127.0,127.0,5,1111,13.0,843.0,843.0
240.088,6,16,4481,9,963,30011.0,238.0,166.0,7,3518,40014.0,1402.0,786.0
0.04,17,4,284,2,120,1.0,32.0,32.0,2,164,37.0,60.0,54.0
0.006,6,10,1643,5,860,1.0,592.0,592.0,5,783,1.0,515.0,515.0
0.011,6,10,1990,5,911,2.0,643.0,643.0,5,1079,2.0,811.0,811.0
40.06,17,10,676,5,460,10013.0,104.0,64.0,5,216,10014.0,20.0,15.0
15.033,17,46,25756,26,21274,600.0,1350.0,790.0,20,4482,789.0,1350.0,196.0
0.014,6,10,1762,5,911,3.0,643.0,643.0,5,851,3.0,583.0,583.0
0.021,17,2,179,1,71,0.0,43.0,43.0,1,108,0.0,80.0,80.0
0.002,17,2,180,1,66,0.0,38.0,38.0,1,114,0.0,86.0,86.0
0.004,6,10,2007,5,928,1.0,660.0,660.0,5,1079,1.0,811.0,811.0
0.004,6,10,2006,5,927,1.0,659.0,659.0,5,1079,1.0,811.0,811.0
0.015,6,10,1989,5,910,3.0,642.0,642.0,5,1079,3.0,811.0,811.0
0.004,6,10,1779,5,928,1.0,660.0,660.0,5,851,1.0,583.0,583.0
0.011,6,10,1972,5,910,2.0,642.0,642.0,5,1062,2.0,794.0,794.0
0.006,6,14,3736,7,446,0.0,74.0,74.0,7,3290,0.0,1448.0,972.0
0.003,17,2,148,1,60,0.0,32.0,32.0,1,88,0.0,60.0,60.0
0.017,6,10,1762,5,911,4.0,643.0,643.0,5,851,4.0,583.0,583.0
0.005,6,10,1989,5,927,1.0,659.0,659.0,5,1062,1.0,794.0,794.0
0.005,6,10,1989,5,927,1.0,659.0,659.0,5,1062,1.0,794.0,794.0
0.001,17,2,180,1,66,0.0,38.0,38.0,1,114,0.0,86.0,86.0
0.008,6,10,1989,5,927,2.0,659.0,659.0,5,1062,2.0,794.0,794.0
0.005,6,10,2006,5,927,1.0,659.0,659.0,5,1079,1.0,811.0,811.0
0.007,6,10,1989,5,927,1.0,659.0,659.0,5,1062,1.0,794.0,794.0
0.005,17,2,182,1,72,0.0,44.0,44.0,1,110,0.0,82.0,82.0
0.083,6,10,1506,5,395,19.0,127.0,127.0,5,1111,18.0,843.0,843.0
0.004,6,10,1989,5,927,1.0,659.0,659.0,5,1062,1.0,794.0,794.0
0.063,6,10,1506,5,395,13.0,127.0,127.0,5,1111,13.0,843.0,843.0
0.005,6,10,2007,5,928,1.0,660.0,660.0,5,1079,1.0,811.0,811.0
0.004,6,10,2000,5,927,1.0,659.0,659.0,5,1073,1.0,805.0,805.0
0.005,6,10,2006,5,927,1.0,659.0,659.0,5,1079,1.0,811.0,811.0
0.006,6,10,1854,5,889,1.0,621.0,621.0,5,965,1.0,697.0,697.0
11.172,17,28,4422,14,1995,847.0,270.0,114.0,14,2427,847.0,586.0,145.0
0.068,6,10,1506,5,395,16.0,127.0,127.0,5,1111,13.0,843.0,843.0
0.015,6,10,1989,5,910,3.0,642.0,642.0,5,1079,3.0,811.0,811.0
173.145,17,74,10515,37,2466,4809.0,44.0,38.0,37,8049,4809.0,239.0,189.0
0.02,6,10,1677,5,827,5.0,559.0,559.0,5,850,4.0,582.0,582.0
0.005,6,10,1689,5,839,1.0,571.0,571.0,5,850,1.0,582.0,582.0
0.005,6,10,2006,5,927,1.0,659.0,659.0,5,1079,1.0,811.0,811.0
0.015,17,2,198,1,91,0.0,63.0,63.0,1,107,0.0,79.0,79.0
0.004,6,10,2006,5,927,1.0,659.0,659.0,5,1079,1.0,811.0,811.0
0.078,6,10,1506,5,395,18.0,127.0,127.0,5,1111,14.0,843.0,843.0
0.003,17,2,148,1,60,0.0,32.0,32.0,1,88,0.0,60.0,60.0
0.001,17,2,180,1,66,0.0,38.0,38.0,1,114,0.0,86.0,86.0
0.084,6,10,1506,5,395,20.0,127.0,127.0,5,1111,17.0,843.0,843.0
0.005,6,13,3747,7,509,0.0,137.0,137.0,6,3238,0.0,1470.0,1459.0
10.851,17,28,4423,14,1995,826.0,270.0,114.0,14,2428,826.0,587.0,145.0
0.005,6,10,2006,5,927,1.0,659.0,659.0,5,1079,1.0,811.0,811.0
0.016,6,12,1926,6,1189,3.0,659.0,434.0,6,737,3.0,417.0,417.0
0.541,6,43,11497,24,3221,23.0,1021.0,197.0,19,8276,29.0,1402.0,606.0
0.1,6,10,1506,5,395,22.0,127.0,127.0,5,1111,18.0,843.0,843.0
0.004,6,14,3742,7,452,0.0,80.0,80.0,7,3290,0.0,1448.0,972.0
40.067,17,10,676,5,460,10015.0,104.0,64.0,5,216,10015.0,20.0,15.0
0.088,6,10,1506,5,395,19.0,127.0,127.0,5,1111,18.0,843.0,843.0
0.01,6,10,1972,5,910,2.0,642.0,642.0,5,1062,2.0,794.0,794.0
40.068,17,10,676,5,460,10016.0,104.0,64.0,5,216,10016.0,20.0,15.0
0.083,6,10,1506,5,395,18.0,127.0,127.0,5,1111,18.0,843.0,843.0
300.251,6,16,2170,9,684,37510.0,146.0,146.0,7,1486,50013.0,419.0,398.0
173.096,17,80,11660,40,2681,4437.0,44.0,39.0,40,8979,4438.0,261.0,196.0
0.011,6,10,1631,5,848,2.0,580.0,580.0,5,783,2.0,515.0,515.0
240.137,6,16,4482,9,963,30017.0,238.0,166.0,7,3519,40022.0,1402.0,786.0
0.017,6,10,1972,5,910,4.0,642.0,642.0,5,1062,4.0,794.0,794.0
0.07,6,10,1506,5,395,16.0,127.0,127.0,5,1111,16.0,843.0,843.0
240.019,6,9,787,5,488,60004.0,232.0,232.0,4,299,80005.0,83.0,83.0
0.145,6,10,1506,5,395,33.0,127.0,127.0,5,1111,33.0,843.0,843.0
0.467,17,2,144,1,64,0.0,36.0,36.0,1,80,0.0,52.0,52.0
0.005,6,10,1989,5,927,1.0,659.0,659.0,5,1062,1.0,794.0,794.0
0.005,6,10,2007,5,928,1.0,660.0,660.0,5,1079,1.0,811.0,811.0
0.014,6,10,1990,5,911,3.0,643.0,643.0,5,1079,3.0,811.0,811.0
0.222,6,16,2670,8,1396,31.0,533.0,324.0,8,1274,20.0,529.0,212.0
0.105,6,10,1506,5,395,22.0,127.0,127.0,5,1111,24.0,843.0,843.0
0.004,17,2,136,1,60,0.0,32.0,32.0,1,76,0.0,48.0,48.0
0.004,6,10,2006,5,927,1.0,659.0,659.0,5,1079,1.0,811.0,811.0
0.004,6,10,2000,5,927,1.0,659.0,659.0,5,1073,1.0,805.0,805.0
40.077,17,10,676,5,460,10016.0,104.0,64.0,5,216,10018.0,20.0,15.0
0.063,6,10,1506,5,395,14.0,127.0,127.0,5,1111,15.0,843.0,843.0
0.082,6,10,1506,5,395,18.0,127.0,127.0,5,1111,17.0,843.0,843.0
0.006,6,10,1547,5,764,1.0,496.0,496.0,5,783,1.0,515.0,515.0
0.003,17,2,148,1,60,0.0,32.0,32.0,1,88,0.0,60.0,60.0
0.005,6,13,3747,7,509,0.0,137.0,137.0,6,3238,0.0,1470.0,1459.0
10.797,17,28,4420,14,1993,821.0,268.0,114.0,14,2427,821.0,586.0,145.0
0.009,6,10,1677,5,827,2.0,559.0,559.0,5,850,2.0,582.0,582.0
40.059,17,10,676,5,460,10012.0,104.0,64.0,5,216,10013.0,20.0,15.0
0.004,6,10,1774,5,923,1.0,655.0,655.0,5,851,1.0,583.0,583.0
0.009,6,10,1990,5,911,2.0,643.0,643.0,5,1079,2.0,811.0,811.0
10.887,17,28,4423,14,1994,828.0,269.0,114.0,14,2429,828.0,588.0,145.0
0.077,6,10,1506,5,395,17.0,127.0,127.0,5,1111,17.0,843.0,843.0
0.017,6,13,3735,7,497,2.0,125.0,125.0,6,3238,3.0,1470.0,1459.0
0.009,6,10,1972,5,910,2.0,642.0,642.0,5,1062,2.0,794.0,794.0
0.01,6,10,1989,5,910,2.0,642.0,642.0,5,1079,2.0,811.0,811.0
0.003,17,2,136,1,60,0.0,32.0,32.0,1,76,0.0,48.0,48.0
103.74,58,5,360,4,288,34580.0,24.0,24.0,1,72,0.0,24.0,24.0
0.02,6,10,1989,5,910,4.0,642.0,642.0,5,1079,5.0,811.0,811.0
0.006,6,10,1779,5,928,1.0,660.0,660.0,5,851,1.0,583.0,583.0
0.006,6,10,1547,5,764,1.0,496.0,496.0,5,783,1.0,515.0,515.0
0.014,17,2,152,1,56,0.0,28.0,28.0,1,96,0.0,68.0,68.0
0.011,6,10,1989,5,910,2.0,642.0,642.0,5,1079,2.0,811.0,811.0
241.31,6,389,348508,201,21979,1206.0,2736.0,959.0,188,326529,1290.0,2804.0,1779.0
0.003,17,2,148,1,60,0.0,32.0,32.0,1,88,0.0,60.0,60.0
0.017,6,10,1989,5,910,4.0,642.0,642.0,5,1079,4.0,811.0,811.0
0.056,17,2,179,1,71,0.0,43.0,43.0,1,108,0.0,80.0,80.0
0.011,6,10,1972,5,910,2.0,642.0,642.0,5,1062,2.0,794.0,794.0
0.004,6,10,2000,5,927,1.0,659.0,659.0,5,1073,1.0,805.0,805.0
0.001,17,2,136,1,60,0.0,32.0,32.0,1,76,0.0,48.0,48.0
0.004,6,10,1702,5,863,1.0,595.0,595.0,5,839,0.0,571.0,571.0
0.007,6,10,1547,5,764,1.0,496.0,496.0,5,783,1.0,515.0,515.0
0.005,6,10,2007,5,928,1.0,660.0,660.0,5,1079,1.0,811.0,811.0
0.07,6,10,1506,5,395,15.0,127.0,127.0,5,1111,14.0,843.0,843.0
0.007,17,2,179,1,71,0.0,43.0,43.0,1,108,0.0,80.0,80.0
0.007,6,10,1547,5,764,1.0,496.0,496.0,5,783,1.0,515.0,515.0
0.104,6,10,1506,5,395,23.0,127.0,127.0,5,1111,23.0,843.0,843.0
0.009,6,13,3735,7,497,1.0,125.0,125.0,6,3238,1.0,1470.0,1459.0
0.121,17,2,80,1,32,0.0,4.0,4.0,1,48,0.0,20.0,20.0
40.062,17,10,676,5,460,10014.0,104.0,64.0,5,216,10013.0,20.0,15.0
300.58,6,30,7881,17,1473,18786.0,217.0,142.0,13,6408,20036.0,1402.0,636.0
0.006,6,10,1689,5,839,1.0,571.0,571.0,5,850,1.0,582.0,582.0
300.326,6,16,2170,9,684,37520.0,146.0,146.0,7,1486,50027.0,419.0,398.0
0.091,6,10,1506,5,395,18.0,127.0,127.0,5,1111,20.0,843.0,843.0
0.005,6,14,3736,7,446,0.0,74.0,74.0,7,3290,0.0,1448.0,972.0
0.103,6,10,1506,5,395,19.0,127.0,127.0,5,1111,20.0,843.0,843.0
0.006,6,10,2007,5,928,1.0,660.0,660.0,5,1079,1.0,811.0,811.0
0.11,6,10,1506,5,395,24.0,127.0,127.0,5,1111,21.0,843.0,843.0
0.242,17,39,20241,22,17085,11.0,1350.0,748.0,17,3156,11.0,1350.0,157.0
787.397,6,57,19759,30,4635,27151.0,676.0,438.0,27,15124,27975.0,1402.0,721.0
0.005,17,2,140,1,62,0.0,34.0,34.0,1,78,0.0,50.0,50.0
0.012,6,10,1990,5,911,2.0,643.0,643.0,5,1079,3.0,811.0,811.0
40.057,17,10,676,5,460,10013.0,104.0,64.0,5,216,10013.0,20.0,15.0
0.008,6,10,1972,5,910,2.0,642.0,642.0,5,1062,2.0,794.0,794.0
0.001,17,2,180,1,66,0.0,38.0,38.0,1,114,0.0,86.0,86.0
0.125,6,10,1506,5,395,30.0,127.0,127.0,5,1111,25.0,843.0,843.0
0.006,6,10,1547,5,764,1.0,496.0,496.0,5,783,1.0,515.0,515.0
0.005,6,10,2006,5,927,1.0,659.0,659.0,5,1079,1.0,811.0,811.0
40.063,17,10,676,5,460,10014.0,104.0,64.0,5,216,10015.0,20.0,15.0
0.148,6,10,1506,5,395,34.0,127.0,127.0,5,1111,33.0,843.0,843.0
163.536,17,88,12594,44,2942,3803.0,44.0,38.0,44,9652,3802.0,239.0,191.0
0.005,6,14,3736,7,446,0.0,74.0,74.0,7,3290,0.0,1448.0,972.0
0.116,6,10,1506,5,395,25.0,127.0,127.0,5,1111,25.0,843.0,843.0
0.004,6,10,2006,5,927,1.0,659.0,659.0,5,1079,1.0,811.0,811.0
0.037,17,2,148,1,60,0.0,32.0,32.0,1,88,0.0,60.0,60.0
0.039,17,2,170,1,65,0.0,37.0,37.0,1,105,0.0,77.0,77.0
0.003,17,2,136,1,60,0.0,32.0,32.0,1,76,0.0,48.0,48.0
246.937,6,22,4794,9,963,30867.0,238.0,166.0,13,3831,20577.0,1402.0,786.0
0.006,6,14,3742,8,504,0.0,80.0,80.0,6,3238,1.0,1470.0,1459.0
0.009,6,10,1989,5,910,2.0,642.0,642.0,5,1079,2.0,811.0,811.0
0.084,6,10,1506,5,395,18.0,127.0,127.0,5,1111,16.0,843.0,843.0
0.01,6,10,1631,5,848,2.0,580.0,580.0,5,783,2.0,515.0,515.0
0.005,6,10,2000,5,927,1.0,659.0,659.0,5,1073,1.0,805.0,805.0
0.005,6,10,2007,5,928,1.0,660.0,660.0,5,1079,1.0,811.0,811.0
0.098,6,10,1506,5,395,20.0,127.0,127.0,5,1111,23.0,843.0,843.0
0.016,6,10,1972,5,910,4.0,642.0,642.0,5,1062,4.0,794.0,794.0
0.006,6,10,1989,5,927,1.0,659.0,659.0,5,1062,1.0,794.0,794.0
0.006,6,10,1547,5,764,1.0,496.0,496.0,5,783,1.0,515.0,515.0
0.094,6,10,1506,5,395,21.0,127.0,127.0,5,1111,21.0,843.0,843.0
0.005,6,10,1989,5,927,1.0,659.0,659.0,5,1062,1.0,794.0,794.0
0.005,17,2,164,1,74,0.0,46.0,46.0,1,90,0.0,62.0,62.0
0.011,6,10,1631,5,848,2.0,580.0,580.0,5,783,2.0,515.0,515.0
0.005,6,10,2006,5,927,1.0,659.0,659.0,5,1079,1.0,811.0,811.0
0.005,6,10,1989,5,927,1.0,659.0,659.0,5,1062,1.0,794.0,794.0
0.22,6,16,2778,8,1396,31.0,533.0,324.0,8,1382,20.0,529.0,239.0
0.005,6,10,2000,5,927,1.0,659.0,659.0,5,1073,1.0,805.0,805.0
0.149,17,4,352,2,130,107.0,37.0,37.0,2,222,146.0,89.0,83.0
0.013,6,10,1990,5,911,3.0,643.0,643.0,5,1079,3.0,811.0,811.0
0.003,17,4,284,2,120,0.0,32.0,32.0,2,164,0.0,60.0,54.0
0.111,6,10,1506,5,395,25.0,127.0,127.0,5,1111,22.0,843.0,843.0
0.004,17,2,136,1,60,0.0,32.0,32.0,1,76,0.0,48.0,48.0
0.005,17,2,214,1,75,0.0,47.0,47.0,1,139,0.0,111.0,111.0
290.165,6,413,349280,204,22158,1429.0,2736.0,888.0,209,327122,1395.0,2804.0,1621.0
0.004,6,13,3747,7,509,0.0,137.0,137.0,6,3238,0.0,1470.0,1459.0
0.004,6,10,2006,5,927,1.0,659.0,659.0,5,1079,1.0,811.0,811.0
0.015,6,10,1631,5,848,3.0,580.0,580.0,5,783,3.0,515.0,515.0
0.005,17,2,166,1,75,0.0,47.0,47.0,1,91,0.0,63.0,63.0
0.016,6,10,1989,5,910,3.0,642.0,642.0,5,1079,3.0,811.0,811.0
0.107,6,10,1506,5,395,25.0,127.0,127.0,5,1111,23.0,843.0,843.0
0.119,6,10,1506,5,395,24.0,127.0,127.0,5,1111,26.0,843.0,843.0
0.016,6,10,1990,5,911,4.0,643.0,643.0,5,1079,3.0,811.0,811.0
0.011,6,10,1631,5,848,2.0,580.0,580.0,5,783,2.0,515.0,515.0
0.066,6,10,1506,5,395,14.0,127.0,127.0,5,1111,15.0,843.0,843.0
0.006,6,10,1689,5,839,1.0,571.0,571.0,5,850,1.0,582.0,582.0
0.18,6,10,1506,5,395,41.0,127.0,127.0,5,1111,40.0,843.0,843.0
0.011,6,13,3735,7,497,1.0,125.0,125.0,6,3238,2.0,1470.0,1459.0
0.168,6,10,1506,5,395,38.0,127.0,127.0,5,1111,40.0,843.0,843.0
0.453,17,45,20770,24,17191,19.0,1350.0,688.0,21,3579,18.0,1350.0,142.0
1796.502,6,287,27107,145,9983,12475.0,748.0,270.0,142,17124,12741.0,1625.0,72.0
0.038,6,10,1983,5,910,9.0,642.0,642.0,5,1073,9.0,805.0,805.0
0.01,6,10,1983,5,910,2.0,642.0,642.0,5,1073,2.0,805.0,805.0
0.011,6,10,1643,5,860,2.0,592.0,592.0,5,783,2.0,515.0,515.0
0.003,6,10,1702,5,863,0.0,595.0,595.0,5,839,0.0,571.0,571.0
0.011,6,10,1990,5,911,2.0,643.0,643.0,5,1079,2.0,811.0,811.0
353.455,6,20,2210,6,1308,12003.0,494.0,494.0,14,902,27188.0,83.0,83.0
0.011,6,10,1972,5,910,2.0,642.0,642.0,5,1062,2.0,794.0,794.0
0.088,6,10,1506,5,395,19.0,127.0,127.0,5,1111,17.0,843.0,843.0
0.006,17,2,144,1,64,0.0,36.0,36.0,1,80,0.0,52.0,52.0
0.004,6,10,1989,5,927,1.0,659.0,659.0,5,1062,1.0,794.0,794.0
0.005,6,10,1989,5,927,1.0,659.0,659.0,5,1062,1.0,794.0,794.0
0.006,6,10,1547,5,764,1.0,496.0,496.0,5,783,1.0,515.0,515.0
0.016,17,2,198,1,91,0.0,63.0,63.0,1,107,0.0,79.0,79.0
0.006,6,10,1547,5,764,1.0,496.0,496.0,5,783,1.0,515.0,515.0
240.092,6,32,9343,16,6999,16006.0,2068.0,685.0,16,2344,16005.0,580.0,188.0
0.005,17,2,225,1,65,0.0,37.0,37.0,1,160,0.0,132.0,132.0
0.006,17,2,194,1,57,0.0,29.0,29.0,1,137,0.0,109.0,109.0
0.005,6,10,2006,5,927,1.0,659.0,659.0,5,1079,1.0,811.0,811.0
0.1,6,10,1506,5,395,22.0,127.0,127.0,5,1111,21.0,843.0,843.0
0.071,6,10,1506,5,395,16.0,127.0,127.0,5,1111,16.0,843.0,843.0
0.078,6,10,1506,5,395,16.0,127.0,127.0,5,1111,14.0,843.0,843.0
0.04,17,2,148,1,60,0.0,32.0,32.0,1,88,0.0,60.0,60.0
0.005,6,10,1643,5,860,1.0,592.0,592.0,5,783,1.0,515.0,515.0
0.096,6,10,1506,5,395,21.0,127.0,127.0,5,1111,20.0,843.0,843.0
0.005,6,10,1779,5,928,1.0,660.0,660.0,5,851,1.0,583.0,583.0
0.006,6,10,1689,5,839,1.0,571.0,571.0,5,850,1.0,582.0,582.0
0.084,6,10,1506,5,395,19.0,127.0,127.0,5,1111,18.0,843.0,843.0
0.017,6,10,1677,5,827,4.0,559.0,559.0,5,850,4.0,582.0,582.0
0.006,6,10,1547,5,764,1.0,496.0,496.0,5,783,1.0,515.0,515.0
0.006,6,10,1689,5,839,1.0,571.0,571.0,5,850,1.0,582.0,582.0
0.01,6,10,1972,5,910,2.0,642.0,642.0,5,1062,2.0,794.0,794.0
0.005,6,10,1779,5,928,1.0,660.0,660.0,5,851,1.0,583.0,583.0
0.094,6,10,1506,5,395,20.0,127.0,127.0,5,1111,20.0,843.0,843.0
1770.51,6,89,4755,45,2394,40237.0,27.0,27.0,44,2361,41173.0,26.0,24.0
0.014,6,10,1990,5,911,3.0,643.0,643.0,5,1079,3.0,811.0,811.0
0.19,17,2,194,1,59,0.0,31.0,31.0,1,135,0.0,107.0,107.0
0.005,6,10,2000,5,927,1.0,659.0,659.0,5,1073,1.0,805.0,805.0
0.016,6,10,1972,5,910,3.0,642.0,642.0,5,1062,4.0,794.0,794.0
0.009,6,10,1762,5,911,2.0,643.0,643.0,5,851,2.0,583.0,583.0
0.124,17,2,80,1,32,0.0,4.0,4.0,1,48,0.0,20.0,20.0
0.006,6,10,1689,5,839,1.0,571.0,571.0,5,850,1.0,582.0,582.0
0.005,6,10,2006,5,927,1.0,659.0,659.0,5,1079,1.0,811.0,811.0
0.002,17,2,185,1,73,0.0,45.0,45.0,1,112,0.0,84.0,84.0
0.01,6,10,1989,5,910,2.0,642.0,642.0,5,1079,2.0,811.0,811.0
0.014,6,10,1989,5,910,3.0,642.0,642.0,5,1079,3.0,811.0,811.0
0.078,6,10,1506,5,395,17.0,127.0,127.0,5,1111,18.0,843.0,843.0
0.007,6,10,1989,5,910,1.0,642.0,642.0,5,1079,1.0,811.0,811.0
0.006,17,2,170,1,65,0.0,37.0,37.0,1,105,0.0,77.0,77.0
0.018,6,10,1983,5,910,4.0,642.0,642.0,5,1073,4.0,805.0,805.0
0.004,17,2,136,1,60,0.0,32.0,32.0,1,76,0.0,48.0,48.0
0.005,6,10,2006,5,927,1.0,659.0,659.0,5,1079,1.0,811.0,811.0
40.081,17,10,676,5,460,10017.0,104.0,64.0,5,216,10019.0,20.0,15.0
0.006,6,10,1547,5,764,1.0,496.0,496.0,5,783,1.0,515.0,515.0
0.005,6,10,1689,5,839,1.0,571.0,571.0,5,850,1.0,582.0,582.0
0.005,6,10,1989,5,927,1.0,659.0,659.0,5,1062,1.0,794.0,794.0
0.068,6,10,1506,5,395,15.0,127.0,127.0,5,1111,13.0,843.0,843.0
0.005,6,10,2000,5,927,1.0,659.0,659.0,5,1073,1.0,805.0,805.0
0.013,6,10,1990,5,911,3.0,643.0,643.0,5,1079,3.0,811.0,811.0
0.1,6,10,1506,5,395,21.0,127.0,127.0,5,1111,20.0,843.0,843.0
0.006,17,2,230,1,68,0.0,40.0,40.0,1,162,0.0,134.0,134.0
0.006,17,2,214,1,75,0.0,47.0,47.0,1,139,0.0,111.0,111.0
0.009,6,10,1972,5,910,2.0,642.0,642.0,5,1062,2.0,794.0,794.0
0.129,6,10,1506,5,395,29.0,127.0,127.0,5,1111,26.0,843.0,843.0
0.006,6,10,1547,5,764,1.0,496.0,496.0,5,783,1.0,515.0,515.0
0.001,17,2,136,1,60,0.0,32.0,32.0,1,76,0.0,48.0,48.0
0.012,6,10,1983,5,910,2.0,642.0,642.0,5,1073,2.0,805.0,805.0
8.959,6,36,9771,19,4293,497.0,1360.0,700.0,17,5478,546.0,2667.0,435.0
0.007,6,10,1762,5,911,1.0,643.0,643.0,5,851,1.0,583.0,583.0
0.012,6,10,1989,5,910,3.0,642.0,642.0,5,1079,2.0,811.0,811.0
11.206,17,28,4421,14,1994,849.0,269.0,114.0,14,2427,849.0,586.0,145.0
240.363,6,34,8692,18,1891,14138.0,572.0,189.0,16,6801,16024.0,1402.0,597.0
0.004,6,10,1702,5,863,1.0,595.0,595.0,5,839,1.0,571.0,571.0
0.004,6,10,1989,5,927,1.0,659.0,659.0,5,1062,1.0,794.0,794.0
0.011,6,10,1631,5,848,2.0,580.0,580.0,5,783,2.0,515.0,515.0
0.005,6,10,2000,5,927,1.0,659.0,659.0,5,1073,1.0,805.0,805.0
0.004,17,2,136,1,60,0.0,32.0,32.0,1,76,0.0,48.0,48.0
0.062,6,10,1506,5,395,14.0,127.0,127.0,5,1111,13.0,843.0,843.0
0.004,17,2,148,1,60,0.0,32.0,32.0,1,88,0.0,60.0,60.0
0.003,17,2,148,1,60,0.0,32.0,32.0,1,88,0.0,60.0,60.0
0.005,6,10,2006,5,927,1.0,659.0,659.0,5,1079,1.0,811.0,811.0
0.01,6,10,1989,5,910,2.0,642.0,642.0,5,1079,2.0,811.0,811.0
0.005,17,2,193,1,71,0.0,43.0,43.0,1,122,0.0,94.0,94.0
0.004,6,10,1989,5,927,1.0,659.0,659.0,5,1062,1.0,794.0,794.0
0.003,17,2,132,1,58,0.0,30.0,30.0,1,74,0.0,46.0,46.0
0.011,6,10,1677,5,827,2.0,559.0,559.0,5,850,2.0,582.0,582.0
0.004,6,10,1989,5,927,1.0,659.0,659.0,5,1062,1.0,794.0,794.0
0.092,6,10,1506,5,395,19.0,127.0,127.0,5,1111,20.0,843.0,843.0
0.006,6,13,3747,7,509,0.0,137.0,137.0,6,3238,1.0,1470.0,1459.0
0.005,6,10,2006,5,927,1.0,659.0,659.0,5,1079,1.0,811.0,811.0
0.167,17,2,152,1,76,0.0,48.0,48.0,1,76,0.0,48.0,48.0
171.677,17,68,9794,34,2266,5202.0,44.0,38.0,34,7528,5202.0,261.0,193.0
40.065,17,10,676,5,460,10014.0,104.0,64.0,5,216,10015.0,20.0,15.0
0.003,17,4,284,2,120,0.0,32.0,32.0,2,164,0.0,60.0,54.0
0.001,17,2,136,1,60,0.0,32.0,32.0,1,76,0.0,48.0,48.0
30.697,6,26,8118,15,3040,2184.0,1191.0,449.0,11,5078,3058.0,1402.0,751.0
1799.861,6,136,6550,76,3625,23998.0,39.0,39.0,60,2925,29993.0,35.0,35.0
0.072,17,2,136,1,60,0.0,32.0,32.0,1,76,0.0,48.0,48.0
174.409,17,76,10886,38,2529,4713.0,44.0,38.0,38,8357,4713.0,239.0,191.0
0.013,6,10,1972,5,910,3.0,642.0,642.0,5,1062,3.0,794.0,794.0
0.02,6,10,1989,5,910,4.0,642.0,642.0,5,1079,4.0,811.0,811.0
1.088,17,2,144,1,64,0.0,36.0,36.0,1,80,0.0,52.0,52.0
40.055,17,10,676,5,460,10012.0,104.0,64.0,5,216,10012.0,20.0,15.0
0.256,17,38,20099,21,17043,12.0,1350.0,783.0,17,3056,12.0,1350.0,151.0
0.043,17,4,420,2,122,0.0,33.0,33.0,2,298,39.0,145.0,121.0
10.804,17,28,4422,14,1993,822.0,268.0,114.0,14,2429,822.0,588.0,145.0
0.102,6,10,1506,5,395,20.0,127.0,127.0,5,1111,24.0,843.0,843.0
240.152,6,46,6506,22,3225,11435.0,588.0,230.0,24,3281,10441.0,580.0,184.0
0.126,6,10,1506,5,395,30.0,127.0,127.0,5,1111,25.0,843.0,843.0
0.01,6,10,1972,5,910,2.0,642.0,642.0,5,1062,2.0,794.0,794.0
0.079,6,10,1506,5,395,18.0,127.0,127.0,5,1111,17.0,843.0,843.0
0.015,6,10,1989,5,910,3.0,642.0,642.0,5,1079,3.0,811.0,811.0
0.005,6,10,1989,5,927,1.0,659.0,659.0,5,1062,1.0,794.0,794.0
0.005,6,10,1989,5,927,1.0,659.0,659.0,5,1062,1.0,794.0,794.0
0.082,6,10,1506,5,395,18.0,127.0,127.0,5,1111,18.0,843.0,843.0
160.589,17,76,10779,38,2537,4340.0,44.0,38.0,38,8242,4340.0,261.0,188.0
0.014,6,10,1989,5,910,3.0,642.0,642.0,5,1079,3.0,811.0,811.0
0.003,6,10,1702,5,863,0.0,595.0,595.0,5,839,0.0,571.0,571.0
0.179,6,12,2996,7,549,29.0,177.0,177.0,5,2447,43.0,1402.0,1089.0
0.011,6,10,1983,5,910,2.0,642.0,642.0,5,1073,2.0,805.0,805.0
0.007,6,10,2006,5,927,1.0,659.0,659.0,5,1079,1.0,811.0,811.0
0.01,6,10,1989,5,910,2.0,642.0,642.0,5,1079,2.0,811.0,811.0
0.007,6,10,2000,5,927,1.0,659.0,659.0,5,1073,1.0,805.0,805.0
0.092,6,10,1506,5,395,17.0,127.0,127.0,5,1111,19.0,843.0,843.0
0.004,17,4,284,2,120,0.0,32.0,32.0,2,164,0.0,60.0,54.0
0.037,17,2,136,1,60,0.0,32.0,32.0,1,76,0.0,48.0,48.0
0.013,6,10,1631,5,848,3.0,580.0,580.0,5,783,3.0,515.0,515.0
0.085,6,10,1506,5,395,18.0,127.0,127.0,5,1111,18.0,843.0,843.0
0.006,17,2,179,1,71,0.0,43.0,43.0,1,108,0.0,80.0,80.0
15.215,17,39,21616,22,18418,723.0,1350.0,809.0,17,3198,949.0,1350.0,160.0
0.003,17,2,148,1,60,0.0,32.0,32.0,1,88,0.0,60.0,60.0
0.005,17,4,284,2,120,2.0,32.0,32.0,2,164,1.0,60.0,54.0
320.778,17,18,1008,9,640,40080.0,48.0,43.0,9,368,40080.0,20.0,12.0
0.07,6,10,1506,5,395,14.0,127.0,127.0,5,1111,16.0,843.0,843.0
0.135,6,10,1506,5,395,31.0,127.0,127.0,5,1111,30.0,843.0,843.0
0.005,17,2,136,1,60,0.0,32.0,32.0,1,76,0.0,48.0,48.0
308.369,17,20,1124,10,716,34249.0,48.0,43.0,10,408,34249.0,20.0,12.0
0.008,6,10,1989,5,910,2.0,642.0,642.0,5,1079,2.0,811.0,811.0
0.014,6,10,1631,5,848,3.0,580.0,580.0,5,783,3.0,515.0,515.0
0.005,6,10,2000,5,927,1.0,659.0,659.0,5,1073,1.0,805.0,805.0
240.579,6,47,25855,21,2053,12028.0,605.0,238.0,26,23802,9621.0,2804.0,1068.0
0.081,6,10,1506,5,395,17.0,127.0,127.0,5,1111,19.0,843.0,843.0
0.006,17,2,178,1,81,0.0,53.0,53.0,1,97,0.0,69.0,69.0
40.062,17,10,676,5,460,10014.0,104.0,64.0,5,216,10012.0,20.0,15.0
40.053,17,10,676,5,460,10012.0,104.0,64.0,5,216,10012.0,20.0,15.0
0.005,6,10,2006,5,927,1.0,659.0,659.0,5,1079,1.0,811.0,811.0
0.012,6,10,1972,5,910,2.0,642.0,642.0,5,1062,3.0,794.0,794.0
0.185,6,10,1506,5,395,42.0,127.0,127.0,5,1111,42.0,843.0,843.0
0.013,6,10,1990,5,911,3.0,643.0,643.0,5,1079,3.0,811.0,811.0
0.093,6,10,1506,5,395,19.0,127.0,127.0,5,1111,22.0,843.0,843.0
0.005,6,10,1854,5,889,1.0,621.0,621.0,5,965,1.0,697.0,697.0
0.2,6,3,453,2,321,200.0,241.0,241.0,1,132,0.0,92.0,92.0
172.211,17,78,11037,39,2601,4531.0,44.0,38.0,39,8436,4531.0,239.0,188.0
0.084,6,10,1506,5,395,20.0,127.0,127.0,5,1111,17.0,843.0,843.0
0.005,6,10,2007,5,928,1.0,660.0,660.0,5,1079,1.0,811.0,811.0
0.01,6,10,1983,5,910,2.0,642.0,642.0,5,1073,2.0,805.0,805.0
0.003,17,4,284,2,120,0.0,32.0,32.0,2,164,0.0,60.0,54.0
0.005,6,10,1643,5,860,1.0,592.0,592.0,5,783,1.0,515.0,515.0
0.015,6,13,3747,7,509,2.0,137.0,137.0,6,3238,2.0,1470.0,1459.0
0.004,6,10,1989,5,927,1.0,659.0,659.0,5,1062,1.0,794.0,794.0
0.003,17,2,148,1,60,0.0,32.0,32.0,1,88,0.0,60.0,60.0
0.001,17,2,142,1,63,0.0,35.0,35.0,1,79,0.0,51.0,51.0
0.092,6,10,1506,5,395,20.0,127.0,127.0,5,1111,19.0,843.0,843.0
0.012,6,10,1972,5,910,3.0,642.0,642.0,5,1062,2.0,794.0,794.0
0.006,17,2,179,1,71,0.0,43.0,43.0,1,108,0.0,80.0,80.0
0.071,6,10,1506,5,395,15.0,127.0,127.0,5,1111,15.0,843.0,843.0
0.097,6,10,1506,5,395,21.0,127.0,127.0,5,1111,21.0,843.0,843.0
0.005,6,13,3747,7,509,0.0,137.0,137.0,6,3238,0.0,1470.0,1459.0
0.004,17,4,284,2,120,1.0,32.0,32.0,2,164,0.0,60.0,54.0
0.004,17,4,284,2,120,0.0,32.0,32.0,2,164,0.0,60.0,54.0
0.01,6,10,1989,5,910,2.0,642.0,642.0,5,1079,2.0,811.0,811.0
0.004,17,2,136,1,60,0.0,32.0,32.0,1,76,0.0,48.0,48.0
40.055,17,10,676,5,460,10012.0,104.0,64.0,5,216,10012.0,20.0,15.0
1730.397,6,45,2790,30,1725,59668.0,35.0,35.0,15,1065,123594.0,31.0,31.0
0.005,6,10,2007,5,928,1.0,660.0,660.0,5,1079,1.0,811.0,811.0
40.054,17,10,676,5,460,10012.0,104.0,64.0,5,216,10012.0,20.0,15.0
0.004,6,10,2006,5,927,1.0,659.0,659.0,5,1079,1.0,811.0,811.0
0.018,6,10,1972,5,910,4.0,642.0,642.0,5,1062,4.0,794.0,794.0
40.062,17,10,676,5,460,10014.0,104.0,64.0,5,216,10014.0,20.0,15.0
0.006,6,10,1689,5,839,1.0,571.0,571.0,5,850,1.0,582.0,582.0
0.014,6,10,1990,5,911,3.0,643.0,643.0,5,1079,3.0,811.0,811.0
0.004,17,2,148,1,60,0.0,32.0,32.0,1,88,0.0,60.0,60.0
0.006,6,10,1547,5,764,1.0,496.0,496.0,5,783,1.0,515.0,515.0
0.003,17,2,148,1,60,0.0,32.0,32.0,1,88,0.0,60.0,60.0
0.082,6,10,1506,5,395,19.0,127.0,127.0,5,1111,17.0,843.0,843.0
0.005,6,10,1989,5,927,1.0,659.0,659.0,5,1062,1.0,794.0,794.0
0.015,6,10,1989,5,910,3.0,642.0,642.0,5,1079,3.0,811.0,811.0
0.043,17,2,144,1,64,0.0,36.0,36.0,1,80,0.0,52.0,52.0
0.005,17,2,140,1,62,0.0,34.0,34.0,1,78,0.0,50.0,50.0
0.005,6,14,3799,7,509,0.0,137.0,137.0,7,3290,0.0,1448.0,972.0
0.095,6,10,1506,5,395,21.0,127.0,127.0,5,1111,20.0,843.0,843.0
0.005,6,10,2006,5,927,1.0,659.0,659.0,5,1079,1.0,811.0,811.0
0.013,6,10,1972,5,910,3.0,642.0,642.0,5,1062,3.0,794.0,794.0
0.005,6,10,1643,5,860,1.0,592.0,592.0,5,783,1.0,515.0,515.0
0.001,17,2,180,1,66,0.0,38.0,38.0,1,114,0.0,86.0,86.0
361.761,6,19,1689,15,978,25840.0,190.0,190.0,4,711,80013.0,495.0,495.0
413.693,6,29,4409,12,3102,10913.0,494.0,494.0,17,1307,25855.0,83.0,83.0
0.041,17,2,152,1,76,0.0,48.0,48.0,1,76,0.0,48.0,48.0
0.102,6,10,1506,5,395,23.0,127.0,127.0,5,1111,24.0,843.0,843.0
0.106,6,10,1506,5,395,25.0,127.0,127.0,5,1111,22.0,843.0,843.0
159.356,17,80,11362,40,2664,4085.0,44.0,38.0,40,8698,4085.0,252.0,189.0
240.478,6,38,14603,18,7878,14145.0,1752.0,990.0,20,6725,12656.0,1656.0,630.0
0.007,6,10,1972,5,910,1.0,642.0,642.0,5,1062,1.0,794.0,794.0
0.005,17,2,136,1,60,0.0,32.0,32.0,1,76,0.0,48.0,48.0
0.105,6,10,1506,5,395,25.0,127.0,127.0,5,1111,21.0,843.0,843.0
40.065,17,10,676,5,460,10015.0,104.0,64.0,5,216,10015.0,20.0,15.0
0.004,6,10,2000,5,927,1.0,659.0,659.0,5,1073,1.0,805.0,805.0
0.005,17,2,169,1,62,0.0,34.0,34.0,1,107,0.0,79.0,79.0
0.004,6,10,2007,5,928,1.0,660.0,660.0,5,1079,1.0,811.0,811.0
0.005,6,10,1643,5,860,1.0,592.0,592.0,5,783,1.0,515.0,515.0
0.005,17,2,225,1,65,0.0,37.0,37.0,1,160,0.0,132.0,132.0
0.1,6,10,1506,5,395,23.0,127.0,127.0,5,1111,23.0,843.0,843.0
0.071,6,10,1506,5,395,14.0,127.0,127.0,5,1111,16.0,843.0,843.0
0.005,6,10,2007,5,928,1.0,660.0,660.0,5,1079,1.0,811.0,811.0
0.001,17,2,136,1,60,0.0,32.0,32.0,1,76,0.0,48.0,48.0
0.01,6,10,1989,5,910,2.0,642.0,642.0,5,1079,2.0,811.0,811.0
0.024,6,10,1972,5,910,6.0,642.0,642.0,5,1062,6.0,794.0,794.0
0.023,6,10,1972,5,910,5.0,642.0,642.0,5,1062,5.0,794.0,794.0
1798.661,17,2942,225650,1464,118602,1229.0,84.0,53.0,1478,107048,1217.0,227.0,44.0
0.013,17,2,152,1,56,0.0,28.0,28.0,1,96,0.0,68.0,68.0
0.017,6,10,1972,5,910,4.0,642.0,642.0,5,1062,4.0,794.0,794.0
0.011,6,10,1990,5,911,2.0,643.0,643.0,5,1079,2.0,811.0,811.0
0.005,6,10,2007,5,928,1.0,660.0,660.0,5,1079,1.0,811.0,811.0
0.007,6,10,1972,5,910,1.0,642.0,642.0,5,1062,1.0,794.0,794.0
0.003,17,2,170,1,65,0.0,37.0,37.0,1,105,0.0,77.0,77.0
0.009,6,10,1990,5,911,2.0,643.0,643.0,5,1079,2.0,811.0,811.0
11.579,17,28,4395,14,2313,878.0,588.0,137.0,14,2082,878.0,269.0,120.0
0.009,6,10,1762,5,911,2.0,643.0,643.0,5,851,2.0,583.0,583.0
0.004,17,2,136,1,60,0.0,32.0,32.0,1,76,0.0,48.0,48.0
0.064,6,10,1506,5,395,13.0,127.0,127.0,5,1111,13.0,843.0,843.0
0.007,6,10,1689,5,839,1.0,571.0,571.0,5,850,1.0,582.0,582.0
0.006,6,10,1547,5,764,1.0,496.0,496.0,5,783,1.0,515.0,515.0
0.108,6,10,1506,5,395,22.0,127.0,127.0,5,1111,24.0,843.0,843.0
40.066,17,10,676,5,460,10015.0,104.0,64.0,5,216,10015.0,20.0,15.0
0.005,6,10,1643,5,860,1.0,592.0,592.0,5,783,1.0,515.0,515.0
0.005,6,10,2007,5,928,1.0,660.0,660.0,5,1079,1.0,811.0,811.0
0.138,17,2,152,1,76,0.0,48.0,48.0,1,76,0.0,48.0,48.0
0.005,6,14,3736,7,446,0.0,74.0,74.0,7,3290,0.0,1448.0,972.0
0.042,17,2,148,1,60,0.0,32.0,32.0,1,88,0.0,60.0,60.0
0.013,6,10,1983,5,910,3.0,642.0,642.0,5,1073,3.0,805.0,805.0
0.005,6,10,2000,5,927,1.0,659.0,659.0,5,1073,1.0,805.0,805.0
240.103,6,16,4482,9,963,30012.0,238.0,166.0,7,3519,40016.0,1402.0,786.0
0.001,17,2,136,1,60,0.0,32.0,32.0,1,76,0.0,48.0,48.0
0.084,6,10,1506,5,395,20.0,127.0,127.0,5,1111,17.0,843.0,843.0
300.151,6,38,9780,20,4262,15788.0,1686.0,686.0,18,5518,17646.0,2667.0,435.0
0.006,6,10,1854,5,889,1.0,621.0,621.0,5,965,1.0,697.0,697.0
0.015,6,10,1631,5,848,3.0,580.0,580.0,5,783,3.0,515.0,515.0
0.004,6,10,2006,5,927,1.0,659.0,659.0,5,1079,1.0,811.0,811.0
0.064,17,2,144,1,64,0.0,36.0,36.0,1,80,0.0,52.0,52.0
0.019,6,10,1989,5,910,4.0,642.0,642.0,5,1079,4.0,811.0,811.0
0.008,6,10,1990,5,911,2.0,643.0,643.0,5,1079,1.0,811.0,811.0
300.219,6,76,65731,32,2540,9684.0,525.0,220.0,44,63191,6981.0,2804.0,1485.0
0.017,6,10,1989,5,910,4.0,642.0,642.0,5,1079,4.0,811.0,811.0
0.079,6,10,1506,5,395,19.0,127.0,127.0,5,1111,18.0,843.0,843.0
0.005,6,10,2007,5,928,1.0,660.0,660.0,5,1079,1.0,811.0,811.0
0.09,6,10,1506,5,395,18.0,127.0,127.0,5,1111,21.0,843.0,843.0
0.006,6,13,3690,7,452,0.0,80.0,80.0,6,3238,1.0,1470.0,1459.0
0.006,6,10,1643,5,860,1.0,592.0,592.0,5,783,1.0,515.0,515.0
0.004,6,10,1989,5,927,1.0,659.0,659.0,5,1062,1.0,794.0,794.0
0.005,6,10,2006,5,927,1.0,659.0,659.0,5,1079,1.0,811.0,811.0
0.009,6,10,1990,5,911,2.0,643.0,643.0,5,1079,2.0,811.0,811.0
0.128,17,2,80,1,32,0.0,4.0,4.0,1,48,0.0,20.0,20.0
0.013,6,10,1631,5,848,3.0,580.0,580.0,5,783,3.0,515.0,515.0
0.004,17,2,184,1,61,0.0,33.0,33.0,1,123,0.0,95.0,95.0
0.011,6,10,1990,5,911,2.0,643.0,643.0,5,1079,2.0,811.0,811.0
0.012,6,13,3816,7,578,2.0,206.0,206.0,6,3238,2.0,1470.0,1459.0
0.013,6,10,1990,5,911,3.0,643.0,643.0,5,1079,3.0,811.0,811.0
0.015,6,10,1762,5,911,3.0,643.0,643.0,5,851,3.0,583.0,583.0
0.081,6,10,1506,5,395,18.0,127.0,127.0,5,1111,16.0,843.0,843.0
0.005,6,10,2006,5,927,1.0,659.0,659.0,5,1079,1.0,811.0,811.0
0.008,6,12,1926,6,1189,1.0,659.0,434.0,6,737,1.0,417.0,417.0
0.001,17,2,166,1,75,0.0,47.0,47.0,1,91,0.0,63.0,63.0
0.001,17,2,180,1,66,0.0,38.0,38.0,1,114,0.0,86.0,86.0
0.004,6,10,2000,5,927,1.0,659.0,659.0,5,1073,1.0,805.0,805.0
0.146,6,10,1506,5,395,34.0,127.0,127.0,5,1111,32.0,843.0,843.0
0.004,6,10,2007,5,928,1.0,660.0,660.0,5,1079,1.0,811.0,811.0
0.012,6,10,1972,5,910,3.0,642.0,642.0,5,1062,3.0,794.0,794.0
0.005,6,10,1989,5,927,1.0,659.0,659.0,5,1062,1.0,794.0,794.0
0.009,6,10,1990,5,911,2.0,643.0,643.0,5,1079,2.0,811.0,811.0
0.019,6,10,1972,5,910,4.0,642.0,642.0,5,1062,4.0,794.0,794.0
0.004,6,10,2000,5,927,1.0,659.0,659.0,5,1073,1.0,805.0,805.0
40.076,17,10,676,5,460,10016.0,104.0,64.0,5,216,10018.0,20.0,15.0
11.186,17,28,4421,14,1993,847.0,268.0,114.0,14,2428,847.0,587.0,145.0
0.004,6,10,2006,5,927,1.0,659.0,659.0,5,1079,1.0,811.0,811.0
0.001,17,2,180,1,66,0.0,38.0,38.0,1,114,0.0,86.0,86.0
0.005,6,10,2007,5,928,1.0,660.0,660.0,5,1079,1.0,811.0,811.0
0.005,6,10,1689,5,839,1.0,571.0,571.0,5,850,1.0,582.0,582.0
0.017,6,10,1972,5,910,4.0,642.0,642.0,5,1062,4.0,794.0,794.0
0.012,6,10,1989,5,927,2.0,659.0,659.0,5,1062,3.0,794.0,794.0
0.022,17,2,170,1,65,0.0,37.0,37.0,1,105,0.0,77.0,77.0
0.009,6,10,1990,5,911,2.0,643.0,643.0,5,1079,2.0,811.0,811.0
0.037,17,2,184,1,61,0.0,33.0,33.0,1,123,0.0,95.0,95.0
370.953,6,22,2313,16,867,24730.0,195.0,195.0,6,1446,4640.0,419.0,398.0
0.011,6,10,1990,5,911,2.0,643.0,643.0,5,1079,2.0,811.0,811.0
0.005,6,10,1779,5,928,1.0,660.0,660.0,5,851,1.0,583.0,583.0
0.057,6,10,1506,5,395,13.0,127.0,127.0,5,1111,13.0,843.0,843.0
40.067,17,10,676,5,460,10015.0,104.0,64.0,5,216,10015.0,20.0,15.0
0.012,6,10,1989,5,910,3.0,642.0,642.0,5,1079,3.0,811.0,811.0
0.024,6,10,1983,5,910,6.0,642.0,642.0,5,1073,6.0,805.0,805.0
0.015,6,10,1989,5,910,3.0,642.0,642.0,5,1079,3.0,811.0,811.0
0.005,6,10,1989,5,927,1.0,659.0,659.0,5,1062,1.0,794.0,794.0
0.033,17,2,136,1,60,0.0,32.0,32.0,1,76,0.0,48.0,48.0
0.171,6,3,453,2,321,171.0,241.0,241.0,1,132,0.0,92.0,92.0
0.1,6,10,1506,5,395,20.0,127.0,127.0,5,1111,20.0,843.0,843.0
0.005,6,10,1643,5,860,1.0,592.0,592.0,5,783,1.0,515.0,515.0
0.072,17,8,3613,4,1874,24.0,1350.0,440.0,4,1739,12.0,1350.0,406.0
0.013,6,10,1989,5,910,3.0,642.0,642.0,5,1079,3.0,811.0,811.0
0.013,6,10,1983,5,910,3.0,642.0,642.0,5,1073,3.0,805.0,805.0
0.075,6,10,1506,5,395,16.0,127.0,127.0,5,1111,17.0,843.0,843.0
0.01,6,10,1989,5,910,2.0,642.0,642.0,5,1079,2.0,811.0,811.0
40.064,17,10,676,5,460,10014.0,104.0,64.0,5,216,10015.0,20.0,15.0
0.053,17,2,152,1,76,0.0,48.0,48.0,1,76,0.0,48.0,48.0
352.878,6,20,2210,6,1308,12003.0,494.0,494.0,14,902,27144.0,83.0,83.0
0.007,6,10,1547,5,764,1.0,496.0,496.0,5,783,1.0,515.0,515.0
0.006,6,10,1702,5,863,1.0,595.0,595.0,5,839,1.0,571.0,571.0
0.005,6,10,2006,5,927,1.0,659.0,659.0,5,1079,1.0,811.0,811.0
0.005,6,10,2000,5,927,1.0,659.0,659.0,5,1073,1.0,805.0,805.0
0.091,6,10,1506,5,395,20.0,127.0,127.0,5,1111,21.0,843.0,843.0
0.005,6,10,2006,5,927,1.0,659.0,659.0,5,1079,1.0,811.0,811.0
0.006,6,10,1547,5,764,1.0,496.0,496.0,5,783,1.0,515.0,515.0
0.005,6,10,1689,5,839,1.0,571.0,571.0,5,850,1.0,582.0,582.0
240.141,6,46,7072,22,3223,11435.0,588.0,230.0,24,3849,10440.0,580.0,235.0
0.208,6,16,2777,8,1395,29.0,533.0,323.0,8,1382,18.0,529.0,239.0
0.01,6,10,1990,5,911,2.0,643.0,643.0,5,1079,2.0,811.0,811.0
0.006,6,10,1643,5,860,1.0,592.0,592.0,5,783,1.0,515.0,515.0
0.003,17,2,148,1,60,0.0,32.0,32.0,1,88,0.0,60.0,60.0
0.006,6,10,1547,5,764,1.0,496.0,496.0,5,783,1.0,515.0,515.0
0.006,6,10,1547,5,764,1.0,496.0,496.0,5,783,1.0,515.0,515.0
0.021,6,10,1990,5,911,5.0,643.0,643.0,5,1079,5.0,811.0,811.0
40.061,17,10,676,5,460,10012.0,104.0,64.0,5,216,10014.0,20.0,15.0
0.005,6,10,1547,5,764,1.0,496.0,496.0,5,783,1.0,515.0,515.0
240.015,6,9,787,5,488,60003.0,232.0,232.0,4,299,80004.0,83.0,83.0
0.004,6,10,1774,5,923,1.0,655.0,655.0,5,851,1.0,583.0,583.0
0.003,17,4,284,2,120,0.0,32.0,32.0,2,164,0.0,60.0,54.0
0.005,6,10,2006,5,927,1.0,659.0,659.0,5,1079,1.0,811.0,811.0
0.013,6,10,1989,5,910,3.0,642.0,642.0,5,1079,3.0,811.0,811.0
0.016,6,10,1990,5,911,3.0,643.0,643.0,5,1079,4.0,811.0,811.0
1741.982,6,304,97704,188,86515,9315.0,2001.0,679.0,116,11189,15147.0,452.0,70.0
40.065,17,10,676,5,460,10012.0,104.0,64.0,5,216,10015.0,20.0,15.0
0.198,17,4,352,2,130,126.0,37.0,37.0,2,222,194.0,89.0,83.0
0.005,6,10,2006,5,927,1.0,659.0,659.0,5,1079,1.0,811.0,811.0
0.013,6,10,1989,5,910,3.0,642.0,642.0,5,1079,3.0,811.0,811.0
0.006,6,10,1547,5,764,1.0,496.0,496.0,5,783,1.0,515.0,515.0
0.042,17,2,170,1,65,0.0,37.0,37.0,1,105,0.0,77.0,77.0
0.019,6,10,1989,5,910,4.0,642.0,642.0,5,1079,4.0,811.0,811.0
0.003,17,2,152,1,76,0.0,48.0,48.0,1,76,0.0,48.0,48.0
240.086,6,31,9218,15,6649,17149.0,1773.0,652.0,16,2569,16005.0,580.0,216.0
0.095,6,10,1506,5,395,21.0,127.0,127.0,5,1111,21.0,843.0,843.0
0.006,6,10,1689,5,839,1.0,571.0,571.0,5,850,1.0,582.0,582.0
0.004,6,10,2006,5,927,1.0,659.0,659.0,5,1079,1.0,811.0,811.0
0.005,6,10,2006,5,927,1.0,659.0,659.0,5,1079,1.0,811.0,811.0
0.042,17,2,144,1,64,0.0,36.0,36.0,1,80,0.0,52.0,52.0
286.712,6,34,9864,17,7345,17919.0,1368.0,587.0,17,2519,17917.0,580.0,162.0
0.011,6,10,1972,5,910,2.0,642.0,642.0,5,1062,2.0,794.0,794.0
0.014,6,10,1972,5,910,3.0,642.0,642.0,5,1062,3.0,794.0,794.0
0.017,6,10,1677,5,827,4.0,559.0,559.0,5,850,4.0,582.0,582.0
0.016,6,10,1989,5,910,3.0,642.0,642.0,5,1079,3.0,811.0,811.0
0.005,17,2,144,1,64,0.0,36.0,36.0,1,80,0.0,52.0,52.0
0.006,6,13,3690,7,452,0.0,80.0,80.0,6,3238,1.0,1470.0,1459.0
162.128,17,74,10653,37,2466,4503.0,44.0,38.0,37,8187,4503.0,239.0,193.0
0.004,17,2,148,1,60,0.0,32.0,32.0,1,88,0.0,60.0,60.0
0.005,6,10,2006,5,927,1.0,659.0,659.0,5,1079,1.0,811.0,811.0
0.021,6,10,1989,5,910,5.0,642.0,642.0,5,1079,5.0,811.0,811.0
0.005,6,10,2007,5,928,1.0,660.0,660.0,5,1079,1.0,811.0,811.0
0.01,6,10,2007,5,928,2.0,660.0,660.0,5,1079,2.0,811.0,811.0
0.121,6,10,1506,5,395,26.0,127.0,127.0,5,1111,25.0,843.0,843.0
0.012,6,13,3735,7,497,2.0,125.0,125.0,6,3238,2.0,1470.0,1459.0
0.005,6,10,2006,5,927,1.0,659.0,659.0,5,1079,1.0,811.0,811.0
0.005,6,10,1854,5,889,1.0,621.0,621.0,5,965,1.0,697.0,697.0
309.713,17,20,1124,10,716,34398.0,48.0,43.0,10,408,34398.0,20.0,12.0
285.21,6,30,6575,16,1433,19013.0,517.0,290.0,14,5142,21939.0,2380.0,1104.0
0.13,17,2,80,1,32,0.0,4.0,4.0,1,48,0.0,20.0,20.0
0.006,6,10,1854,5,889,1.0,621.0,621.0,5,965,1.0,697.0,697.0
0.004,17,2,148,1,60,0.0,32.0,32.0,1,88,0.0,60.0,60.0
0.074,6,10,1506,5,395,15.0,127.0,127.0,5,1111,16.0,843.0,843.0
0.238,17,15,8641,8,4076,34.0,1350.0,481.0,7,4565,30.0,1350.0,624.0
0.004,6,10,2006,5,927,1.0,659.0,659.0,5,1079,1.0,811.0,811.0
0.008,6,10,1983,5,910,2.0,642.0,642.0,5,1073,1.0,805.0,805.0
0.052,17,2,152,1,76,0.0,48.0,48.0,1,76,0.0,48.0,48.0
0.005,6,10,2000,5,927,1.0,659.0,659.0,5,1073,1.0,805.0,805.0
0.004,17,2,136,1,60,0.0,32.0,32.0,1,76,0.0,48.0,48.0
0.006,6,10,1989,5,927,1.0,659.0,659.0,5,1062,1.0,794.0,794.0
0.074,17,8,3613,4,1874,24.0,1350.0,440.0,4,1739,12.0,1350.0,406.0
0.019,6,10,1990,5,911,4.0,643.0,643.0,5,1079,4.0,811.0,811.0
0.087,6,10,1506,5,395,19.0,127.0,127.0,5,1111,19.0,843.0,843.0
0.006,6,10,1547,5,764,1.0,496.0,496.0,5,783,1.0,515.0,515.0
0.011,6,10,1989,5,910,2.0,642.0,642.0,5,1079,2.0,811.0,811.0
0.003,17,2,170,1,65,0.0,37.0,37.0,1,105,0.0,77.0,77.0
0.005,6,10,2006,5,927,1.0,659.0,659.0,5,1079,1.0,811.0,811.0
300.158,6,39,10113,21,4595,14999.0,1360.0,620.0,18,5518,17646.0,2667.0,435.0
0.043,17,2,186,1,61,0.0,33.0,33.0,1,125,0.0,97.0,97.0
0.004,6,10,1989,5,927,1.0,659.0,659.0,5,1062,1.0,794.0,794.0
0.099,6,10,1506,5,395,21.0,127.0,127.0,5,1111,21.0,843.0,843.0
0.018,6,10,1972,5,910,4.0,642.0,642.0,5,1062,4.0,794.0,794.0
0.025,17,2,148,1,60,0.0,32.0,32.0,1,88,0.0,60.0,60.0
0.013,6,10,1989,5,910,3.0,642.0,642.0,5,1079,3.0,811.0,811.0
0.001,17,2,180,1,66,0.0,38.0,38.0,1,114,0.0,86.0,86.0
0.06,17,2,152,1,76,0.0,48.0,48.0,1,76,0.0,48.0,48.0
0.011,6,10,1989,5,910,2.0,642.0,642.0,5,1079,2.0,811.0,811.0
0.043,17,2,152,1,76,0.0,48.0,48.0,1,76,0.0,48.0,48.0
0.065,6,10,1506,5,395,14.0,127.0,127.0,5,1111,14.0,843.0,843.0
0.001,17,2,180,1,66,0.0,38.0,38.0,1,114,0.0,86.0,86.0
11.18,17,28,4423,14,1995,847.0,270.0,114.0,14,2428,847.0,587.0,145.0
0.077,6,10,1506,5,395,17.0,127.0,127.0,5,1111,17.0,843.0,843.0
0.002,17,2,180,1,66,0.0,38.0,38.0,1,114,0.0,86.0,86.0
0.021,6,10,1989,5,910,5.0,642.0,642.0,5,1079,5.0,811.0,811.0
0.016,17,2,198,1,91,0.0,63.0,63.0,1,107,0.0,79.0,79.0
0.004,17,4,284,2,120,0.0,32.0,32.0,2,164,0.0,60.0,54.0
0.006,6,10,1689,5,839,1.0,571.0,571.0,5,850,1.0,582.0,582.0
0.001,17,2,136,1,60,0.0,32.0,32.0,1,76,0.0,48.0,48.0
10.817,17,28,4417,14,1994,823.0,269.0,114.0,14,2423,823.0,586.0,145.0
40.057,17,10,676,5,460,10012.0,104.0,64.0,5,216,10013.0,20.0,15.0
40.052,17,10,676,5,460,10012.0,104.0,64.0,5,216,10012.0,20.0,15.0
0.229,6,16,2777,8,1395,32.0,533.0,323.0,8,1382,21.0,529.0,239.0
0.006,6,10,1547,5,764,1.0,496.0,496.0,5,783,1.0,515.0,515.0
0.077,6,10,1506,5,395,16.0,127.0,127.0,5,1111,16.0,843.0,843.0
0.005,17,2,148,1,60,0.0,32.0,32.0,1,88,0.0,60.0,60.0
0.001,17,2,180,1,66,0.0,38.0,38.0,1,114,0.0,86.0,86.0
0.008,6,10,1989,5,927,2.0,659.0,659.0,5,1062,2.0,794.0,794.0
0.01,6,10,1990,5,911,2.0,643.0,643.0,5,1079,2.0,811.0,811.0
0.017,6,10,1989,5,910,4.0,642.0,642.0,5,1079,4.0,811.0,811.0
0.001,17,2,180,1,66,0.0,38.0,38.0,1,114,0.0,86.0,86.0
0.039,17,2,136,1,60,0.0,32.0,32.0,1,76,0.0,48.0,48.0
240.11,6,31,9722,15,7337,17150.0,2460.0,729.0,16,2385,16007.0,580.0,193.0
0.005,17,4,495,2,132,0.0,38.0,38.0,2,363,2.0,176.0,153.0
0.006,17,2,179,1,71,0.0,43.0,43.0,1,108,0.0,80.0,80.0
15.226,17,44,27863,26,24756,607.0,1350.0,924.0,18,3107,894.0,1350.0,144.0
0.001,17,2,174,1,72,0.0,44.0,44.0,1,102,0.0,74.0,74.0
0.065,6,10,1506,5,395,15.0,127.0,127.0,5,1111,14.0,843.0,843.0
0.082,6,10,1506,5,395,18.0,127.0,127.0,5,1111,18.0,843.0,843.0
0.005,6,10,2007,5,928,1.0,660.0,660.0,5,1079,1.0,811.0,811.0
166.022,17,72,10304,36,2410,4743.0,44.0,38.0,36,7894,4743.0,239.0,191.0
40.061,17,10,676,5,460,10014.0,104.0,64.0,5,216,10014.0,20.0,15.0
0.036,6,10,1983,5,910,9.0,642.0,642.0,5,1073,9.0,805.0,805.0
308.294,17,20,1124,10,716,34241.0,48.0,43.0,10,408,34241.0,20.0,12.0
40.073,17,10,676,5,460,10015.0,104.0,64.0,5,216,10017.0,20.0,15.0
0.005,17,2,222,1,65,0.0,37.0,37.0,1,157,0.0,129.0,129.0
0.007,17,2,148,1,60,0.0,32.0,32.0,1,88,0.0,60.0,60.0
0.006,6,12,1698,6,863,1.0,327.0,271.0,6,835,1.0,515.0,515.0
0.04,17,4,284,2,120,0.0,32.0,32.0,2,164,37.0,60.0,54.0
0.009,6,10,1983,5,910,2.0,642.0,642.0,5,1073,2.0,805.0,805.0
0.146,6,10,1506,5,395,33.0,127.0,127.0,5,1111,32.0,843.0,843.0
0.011,6,10,1762,5,911,2.0,643.0,643.0,5,851,2.0,583.0,583.0
0.004,6,10,1774,5,923,1.0,655.0,655.0,5,851,0.0,583.0,583.0
40.054,17,10,676,5,460,10012.0,104.0,64.0,5,216,10012.0,20.0,15.0
0.119,6,10,1506,5,395,25.0,127.0,127.0,5,1111,23.0,843.0,843.0
0.008,17,2,194,1,59,0.0,31.0,31.0,1,135,0.0,107.0,107.0
0.001,17,2,180,1,66,0.0,38.0,38.0,1,114,0.0,86.0,86.0
0.006,6,10,1854,5,889,1.0,621.0,621.0,5,965,1.0,697.0,697.0
0.105,6,10,1506,5,395,24.0,127.0,127.0,5,1111,22.0,843.0,843.0
0.012,6,10,1989,5,910,3.0,642.0,642.0,5,1079,2.0,811.0,811.0
0.103,6,10,1506,5,395,25.0,127.0,127.0,5,1111,21.0,843.0,843.0
0.003,17,2,136,1,60,0.0,32.0,32.0,1,76,0.0,48.0,48.0
0.113,6,10,1506,5,395,24.0,127.0,127.0,5,1111,23.0,843.0,843.0
0.005,6,10,2006,5,927,1.0,659.0,659.0,5,1079,1.0,811.0,811.0
40.067,17,10,676,5,460,10014.0,104.0,64.0,5,216,10016.0,20.0,15.0
0.1,6,10,1506,5,395,20.0,127.0,127.0,5,1111,20.0,843.0,843.0
0.004,6,10,1774,5,923,1.0,655.0,655.0,5,851,1.0,583.0,583.0
0.134,6,10,1506,5,395,30.0,127.0,127.0,5,1111,29.0,843.0,843.0
0.171,6,10,1506,5,395,29.0,127.0,127.0,5,1111,38.0,843.0,843.0
0.021,6,10,1990,5,911,5.0,643.0,643.0,5,1079,5.0,811.0,811.0
0.098,6,10,1506,5,395,21.0,127.0,127.0,5,1111,21.0,843.0,843.0
0.016,17,2,198,1,91,0.0,63.0,63.0,1,107,0.0,79.0,79.0
15.071,17,15,9238,8,6902,2149.0,1350.0,834.0,7,2336,2507.0,1350.0,305.0
0.004,17,4,284,2,120,0.0,32.0,32.0,2,164,0.0,60.0,54.0
0.005,17,2,213,1,69,0.0,41.0,41.0,1,144,0.0,116.0,116.0
0.081,6,10,1506,5,395,18.0,127.0,127.0,5,1111,18.0,843.0,843.0
0.01,6,10,1983,5,910,2.0,642.0,642.0,5,1073,2.0,805.0,805.0
0.005,6,10,2006,5,927,1.0,659.0,659.0,5,1079,1.0,811.0,811.0
0.005,6,10,2006,5,927,1.0,659.0,659.0,5,1079,1.0,811.0,811.0
0.005,6,10,2007,5,928,1.0,660.0,660.0,5,1079,1.0,811.0,811.0
0.001,17,2,179,1,62,0.0,34.0,34.0,1,117,0.0,89.0,89.0
1.029,6,12,3134,6,2099,155.0,1328.0,923.0,6,1035,155.0,791.0,791.0
0.008,6,10,1779,5,928,2.0,660.0,660.0,5,851,1.0,583.0,583.0
0.005,6,10,1779,5,928,1.0,660.0,660.0,5,851,1.0,583.0,583.0
0.103,6,10,1506,5,395,20.0,127.0,127.0,5,1111,19.0,843.0,843.0
0.077,6,10,1506,5,395,14.0,127.0,127.0,5,1111,18.0,843.0,843.0
0.005,6,13,3747,7,509,0.0,137.0,137.0,6,3238,1.0,1470.0,1459.0
0.036,6,10,1989,5,910,8.0,642.0,642.0,5,1079,9.0,811.0,811.0
40.051,17,10,676,5,460,10012.0,104.0,64.0,5,216,10011.0,20.0,15.0
0.219,6,19,6389,9,1443,27.0,533.0,322.0,10,4946,18.0,1402.0,736.0
40.092,17,10,676,5,460,10022.0,104.0,64.0,5,216,10022.0,20.0,15.0
0.004,6,10,1702,5,863,1.0,595.0,595.0,5,839,0.0,571.0,571.0
0.038,17,4,284,2,120,0.0,32.0,32.0,2,164,35.0,60.0,54.0
0.073,6,10,1506,5,395,16.0,127.0,127.0,5,1111,15.0,843.0,843.0
240.091,6,16,4480,9,963,30011.0,238.0,166.0,7,3517,40014.0,1402.0,786.0
0.014,6,10,1631,5,848,3.0,580.0,580.0,5,783,3.0,515.0,515.0
11.102,17,28,4398,14,2312,845.0,587.0,137.0,14,2086,845.0,269.0,121.0
0.004,6,10,2000,5,927,1.0,659.0,659.0,5,1073,1.0,805.0,805.0
40.09,17,10,676,5,460,10016.0,104.0,64.0,5,216,10021.0,20.0,15.0
0.006,17,2,230,1,68,0.0,40.0,40.0,1,162,0.0,134.0,134.0
308.823,17,20,1124,10,716,34299.0,48.0,43.0,10,408,34299.0,20.0,12.0
0.004,17,2,148,1,60,0.0,32.0,32.0,1,88,0.0,60.0,60.0
0.005,6,10,1779,5,928,1.0,660.0,660.0,5,851,1.0,583.0,583.0
40.069,17,10,676,5,460,10016.0,104.0,64.0,5,216,10016.0,20.0,15.0
0.003,17,2,136,1,60,0.0,32.0,32.0,1,76,0.0,48.0,48.0
0.01,6,10,1972,5,910,2.0,642.0,642.0,5,1062,2.0,794.0,794.0
0.005,17,2,140,1,62,0.0,34.0,34.0,1,78,0.0,50.0,50.0
0.006,6,10,1989,5,910,1.0,642.0,642.0,5,1079,1.0,811.0,811.0
50.756,6,27,11341,14,1800,3904.0,538.0,350.0,13,9541,4225.0,2804.0,984.0
0.004,6,10,2007,5,928,1.0,660.0,660.0,5,1079,1.0,811.0,811.0
0.004,17,4,284,2,120,0.0,32.0,32.0,2,164,0.0,60.0,54.0
0.005,6,10,1989,5,927,1.0,659.0,659.0,5,1062,1.0,794.0,794.0
0.005,6,10,1689,5,839,1.0,571.0,571.0,5,850,1.0,582.0,582.0
0.004,17,2,136,1,60,0.0,32.0,32.0,1,76,0.0,48.0,48.0
0.006,17,2,230,1,68,0.0,40.0,40.0,1,162,0.0,134.0,134.0
314.85,6,33,10382,18,2434,18520.0,676.0,298.0,15,7948,18202.0,1402.0,795.0
0.005,6,10,2007,5,928,1.0,660.0,660.0,5,1079,1.0,811.0,811.0
0.005,6,10,1547,5,764,1.0,496.0,496.0,5,783,1.0,515.0,515.0
40.059,17,10,676,5,460,10012.0,104.0,64.0,5,216,10013.0,20.0,15.0
240.1,6,35,9287,18,6713,14123.0,1671.0,641.0,17,2574,15006.0,580.0,210.0
0.001,17,2,140,1,62,0.0,34.0,34.0,1,78,0.0,50.0,50.0
173.062,17,76,10710,38,2529,4677.0,44.0,38.0,38,8181,4677.0,239.0,187.0
0.092,6,10,1506,5,395,18.0,127.0,127.0,5,1111,20.0,843.0,843.0
174.058,17,80,11322,40,2663,4462.0,44.0,38.0,40,8659,4462.0,239.0,188.0
0.005,6,10,1989,5,927,1.0,659.0,659.0,5,1062,1.0,794.0,794.0
0.006,6,10,2000,5,927,1.0,659.0,659.0,5,1073,1.0,805.0,805.0
240.01,6,9,787,5,488,60002.0,232.0,232.0,4,299,80002.0,83.0,83.0
0.106,6,10,1506,5,395,24.0,127.0,127.0,5,1111,22.0,843.0,843.0
0.013,6,10,1989,5,910,3.0,642.0,642.0,5,1079,3.0,811.0,811.0
0.004,17,2,164,1,74,0.0,46.0,46.0,1,90,0.0,62.0,62.0
40.058,17,10,676,5,460,10013.0,104.0,64.0,5,216,10011.0,20.0,15.0
0.103,6,10,1506,5,395,24.0,127.0,127.0,5,1111,22.0,843.0,843.0
1.085,6,33,13432,19,5933,60.0,1360.0,732.0,14,7499,70.0,2720.0,769.0
0.001,17,2,180,1,66,0.0,38.0,38.0,1,114,0.0,86.0,86.0
0.012,6,10,1990,5,911,3.0,643.0,643.0,5,1079,3.0,811.0,811.0
0.01,6,13,3735,7,497,1.0,125.0,125.0,6,3238,2.0,1470.0,1459.0
0.005,6,10,2006,5,927,1.0,659.0,659.0,5,1079,1.0,811.0,811.0
0.011,6,10,1677,5,827,2.0,559.0,559.0,5,850,2.0,582.0,582.0
0.022,6,10,1972,5,910,5.0,642.0,642.0,5,1062,5.0,794.0,794.0
0.008,6,10,1972,5,910,2.0,642.0,642.0,5,1062,2.0,794.0,794.0
40.064,17,10,676,5,460,10012.0,104.0,64.0,5,216,10015.0,20.0,15.0
15.078,17,16,9109,8,6842,2150.0,1350.0,827.0,8,2267,2149.0,1350.0,255.0
0.005,6,10,2006,5,927,1.0,659.0,659.0,5,1079,1.0,811.0,811.0
0.004,6,10,2006,5,927,1.0,659.0,659.0,5,1079,1.0,811.0,811.0
40.06,17,10,676,5,460,10013.0,104.0,64.0,5,216,10014.0,20.0,15.0
0.01,6,10,1989,5,910,2.0,642.0,642.0,5,1079,2.0,811.0,811.0
371.505,6,22,2313,16,867,24767.0,195.0,195.0,6,1446,4644.0,419.0,398.0
10.914,17,28,4399,14,2313,831.0,588.0,137.0,14,2086,831.0,269.0,121.0
0.005,6,14,3742,7,452,0.0,80.0,80.0,7,3290,0.0,1448.0,972.0
0.004,6,10,2007,5,928,1.0,660.0,660.0,5,1079,1.0,811.0,811.0
0.006,6,10,1779,5,928,1.0,660.0,660.0,5,851,1.0,583.0,583.0
0.04,17,4,284,2,120,1.0,32.0,32.0,2,164,36.0,60.0,54.0
0.008,6,10,1990,5,911,2.0,643.0,643.0,5,1079,2.0,811.0,811.0
0.005,6,10,1774,5,923,1.0,655.0,655.0,5,851,1.0,583.0,583.0
0.127,17,2,412,1,61,0.0,33.0,33.0,1,351,0.0,323.0,323.0
0.012,6,10,1983,5,910,3.0,642.0,642.0,5,1073,2.0,805.0,805.0
0.009,6,13,3735,7,497,1.0,125.0,125.0,6,3238,1.0,1470.0,1459.0
0.013,6,10,1990,5,911,3.0,643.0,643.0,5,1079,3.0,811.0,811.0
0.005,6,10,1989,5,927,1.0,659.0,659.0,5,1062,1.0,794.0,794.0
0.013,6,10,1983,5,910,3.0,642.0,642.0,5,1073,3.0,805.0,805.0
308.601,17,20,1124,10,716,34274.0,48.0,43.0,10,408,34275.0,20.0,12.0
0.011,6,10,1677,5,827,2.0,559.0,559.0,5,850,2.0,582.0,582.0
0.005,6,10,1774,5,923,1.0,655.0,655.0,5,851,1.0,583.0,583.0
0.102,6,10,1506,5,395,23.0,127.0,127.0,5,1111,20.0,843.0,843.0
0.025,6,19,9922,11,704,2.0,124.0,124.0,8,9218,3.0,2896.0,2198.0
0.001,17,2,136,1,60,0.0,32.0,32.0,1,76,0.0,48.0,48.0
0.209,6,16,2671,8,1397,29.0,533.0,324.0,8,1274,19.0,529.0,212.0
0.006,17,2,166,1,75,0.0,47.0,47.0,1,91,0.0,63.0,63.0
175.034,17,80,11262,40,2668,4487.0,44.0,38.0,40,8594,4487.0,239.0,186.0
0.011,6,10,1989,5,910,2.0,642.0,642.0,5,1079,2.0,811.0,811.0
0.009,6,10,1990,5,911,2.0,643.0,643.0,5,1079,2.0,811.0,811.0
0.026,6,10,1989,5,910,6.0,642.0,642.0,5,1079,6.0,811.0,811.0
0.091,6,10,1506,5,395,22.0,127.0,127.0,5,1111,20.0,843.0,843.0
0.008,6,10,1989,5,910,2.0,642.0,642.0,5,1079,1.0,811.0,811.0
0.009,6,14,3799,7,509,1.0,137.0,137.0,7,3290,1.0,1448.0,972.0
0.014,6,10,1972,5,910,3.0,642.0,642.0,5,1062,3.0,794.0,794.0
0.02,6,10,1989,5,910,4.0,642.0,642.0,5,1079,4.0,811.0,811.0
0.004,6,10,1774,5,923,1.0,655.0,655.0,5,851,1.0,583.0,583.0
351.987,6,20,2210,6,1308,12003.0,494.0,494.0,14,902,27075.0,83.0,83.0
0.017,6,10,1989,5,910,4.0,642.0,642.0,5,1079,4.0,811.0,811.0
0.003,17,2,148,1,60,0.0,32.0,32.0,1,88,0.0,60.0,60.0
0.005,6,10,2006,5,927,1.0,659.0,659.0,5,1079,1.0,811.0,811.0
0.01,17,2,154,1,69,0.0,41.0,41.0,1,85,0.0,57.0,57.0
0.014,6,10,1631,5,848,3.0,580.0,580.0,5,783,3.0,515.0,515.0
0.005,17,2,187,1,71,0.0,43.0,43.0,1,116,0.0,88.0,88.0
0.005,6,10,1989,5,927,1.0,659.0,659.0,5,1062,1.0,794.0,794.0
0.005,17,2,144,1,64,0.0,36.0,36.0,1,80,0.0,52.0,52.0
240.011,6,9,787,5,488,60002.0,232.0,232.0,4,299,80002.0,83.0,83.0
0.08,6,10,1506,5,395,18.0,127.0,127.0,5,1111,16.0,843.0,843.0
353.627,6,20,2210,6,1308,12004.0,494.0,494.0,14,902,27201.0,83.0,83.0
0.011,6,10,1989,5,910,2.0,642.0,642.0,5,1079,2.0,811.0,811.0
0.005,6,10,2006,5,927,1.0,659.0,659.0,5,1079,1.0,811.0,811.0
50.554,6,34,6304,18,1338,2973.0,267.0,195.0,16,4966,572.0,1823.0,392.0
0.006,6,10,1547,5,764,1.0,496.0,496.0,5,783,1.0,515.0,515.0
60.471,6,36,9704,18,4186,518.0,1753.0,858.0,18,5518,3547.0,2667.0,435.0
0.144,6,10,1506,5,395,31.0,127.0,127.0,5,1111,33.0,843.0,843.0
0.007,17,2,179,1,71,0.0,43.0,43.0,1,108,0.0,80.0,80.0
0.012,6,10,1762,5,911,3.0,643.0,643.0,5,851,2.0,583.0,583.0
0.078,6,10,1506,5,395,18.0,127.0,127.0,5,1111,15.0,843.0,843.0
0.013,6,10,1989,5,910,3.0,642.0,642.0,5,1079,3.0,811.0,811.0
0.114,6,10,1506,5,395,22.0,127.0,127.0,5,1111,27.0,843.0,843.0
0.004,6,10,2006,5,927,1.0,659.0,659.0,5,1079,1.0,811.0,811.0
0.013,6,10,1983,5,910,3.0,642.0,642.0,5,1073,3.0,805.0,805.0
0.004,17,2,136,1,60,0.0,32.0,32.0,1,76,0.0,48.0,48.0
0.005,17,2,140,1,62,0.0,34.0,34.0,1,78,0.0,50.0,50.0
0.075,6,10,1506,5,395,16.0,127.0,127.0,5,1111,16.0,843.0,843.0
0.004,6,10,1989,5,927,1.0,659.0,659.0,5,1062,1.0,794.0,794.0
10.785,17,28,4423,14,1995,820.0,270.0,114.0,14,2428,820.0,587.0,145.0
10.84,17,28,4422,14,1994,825.0,269.0,114.0,14,2428,825.0,587.0,145.0
0.01,6,10,1989,5,910,2.0,642.0,642.0,5,1079,2.0,811.0,811.0
0.012,6,13,3735,7,497,2.0,125.0,125.0,6,3238,2.0,1470.0,1459.0
0.003,17,2,136,1,60,0.0,32.0,32.0,1,76,0.0,48.0,48.0
0.323,6,48,12391,26,3935,12.0,1083.0,215.0,22,8456,15.0,2694.0,661.0
0.009,6,10,1990,5,911,2.0,643.0,643.0,5,1079,2.0,811.0,811.0
0.005,6,10,2000,5,927,1.0,659.0,659.0,5,1073,1.0,805.0,805.0
0.094,6,10,1506,5,395,22.0,127.0,127.0,5,1111,17.0,843.0,843.0
1756.175,6,105,6270,60,3525,29765.0,27.0,27.0,45,2745,39912.0,27.0,27.0
0.006,6,10,2007,5,928,1.0,660.0,660.0,5,1079,1.0,811.0,811.0
0.138,6,10,1506,5,395,30.0,127.0,127.0,5,1111,31.0,843.0,843.0
0.004,17,2,148,1,60,0.0,32.0,32.0,1,88,0.0,60.0,60.0
0.005,6,10,2006,5,927,1.0,659.0,659.0,5,1079,1.0,811.0,811.0
0.013,6,10,1983,5,910,3.0,642.0,642.0,5,1073,3.0,805.0,805.0
0.073,17,4,336,2,124,2.0,34.0,34.0,2,212,1.0,84.0,78.0
0.076,6,10,1506,5,395,18.0,127.0,127.0,5,1111,17.0,843.0,843.0
0.005,6,10,2006,5,927,1.0,659.0,659.0,5,1079,1.0,811.0,811.0
0.078,6,10,1506,5,395,16.0,127.0,127.0,5,1111,16.0,843.0,843.0
0.005,17,2,160,1,72,0.0,44.0,44.0,1,88,0.0,60.0,60.0
0.098,6,10,1506,5,395,22.0,127.0,127.0,5,1111,21.0,843.0,843.0
0.098,6,10,1506,5,395,21.0,127.0,127.0,5,1111,22.0,843.0,843.0
0.009,6,10,1989,5,910,2.0,642.0,642.0,5,1079,2.0,811.0,811.0
0.008,17,2,194,1,59,0.0,31.0,31.0,1,135,0.0,107.0,107.0
0.013,6,10,1972,5,910,3.0,642.0,642.0,5,1062,3.0,794.0,794.0
0.129,6,10,1506,5,395,28.0,127.0,127.0,5,1111,29.0,843.0,843.0
0.041,17,2,166,1,75,0.0,47.0,47.0,1,91,0.0,63.0,63.0
0.01,6,10,1972,5,910,2.0,642.0,642.0,5,1062,2.0,794.0,794.0
0.075,6,10,1506,5,395,17.0,127.0,127.0,5,1111,16.0,843.0,843.0
0.168,6,3,453,2,321,168.0,241.0,241.0,1,132,0.0,92.0,92.0
0.377,17,44,20781,23,17135,17.0,1350.0,717.0,21,3646,15.0,1350.0,145.0
0.001,17,2,142,1,63,0.0,35.0,35.0,1,79,0.0,51.0,51.0
0.004,6,10,1989,5,927,1.0,659.0,659.0,5,1062,1.0,794.0,794.0
0.013,6,10,1983,5,910,3.0,642.0,642.0,5,1073,3.0,805.0,805.0
0.008,6,10,1762,5,911,2.0,643.0,643.0,5,851,2.0,583.0,583.0
0.005,6,10,1989,5,927,1.0,659.0,659.0,5,1062,1.0,794.0,794.0
40.057,17,10,676,5,460,10013.0,104.0,64.0,5,216,10013.0,20.0,15.0
0.008,6,10,1762,5,911,2.0,643.0,643.0,5,851,2.0,583.0,583.0
0.011,6,10,1990,5,911,2.0,643.0,643.0,5,1079,2.0,811.0,811.0
0.052,17,2,152,1,76,0.0,48.0,48.0,1,76,0.0,48.0,48.0
0.016,6,10,1989,5,910,3.0,642.0,642.0,5,1079,3.0,811.0,811.0
0.091,6,10,1506,5,395,16.0,127.0,127.0,5,1111,21.0,843.0,843.0
0.063,6,10,1506,5,395,14.0,127.0,127.0,5,1111,14.0,843.0,843.0
0.016,6,10,1983,5,910,3.0,642.0,642.0,5,1073,3.0,805.0,805.0
0.129,17,2,80,1,32,0.0,4.0,4.0,1,48,0.0,20.0,20.0
0.123,6,10,1506,5,395,28.0,127.0,127.0,5,1111,25.0,843.0,843.0
0.009,6,10,1989,5,910,2.0,642.0,642.0,5,1079,2.0,811.0,811.0
0.008,6,10,1989,5,910,2.0,642.0,642.0,5,1079,1.0,811.0,811.0
0.005,6,10,2007,5,928,1.0,660.0,660.0,5,1079,1.0,811.0,811.0
0.011,6,10,1990,5,911,2.0,643.0,643.0,5,1079,2.0,811.0,811.0
0.132,6,10,1506,5,395,30.0,127.0,127.0,5,1111,24.0,843.0,843.0
0.041,17,2,152,1,76,0.0,48.0,48.0,1,76,0.0,48.0,48.0
0.009,6,10,1689,5,839,2.0,571.0,571.0,5,850,2.0,582.0,582.0
0.076,6,10,1506,5,395,16.0,127.0,127.0,5,1111,16.0,843.0,843.0
0.004,6,10,1989,5,927,1.0,659.0,659.0,5,1062,1.0,794.0,794.0
0.072,6,10,1506,5,395,16.0,127.0,127.0,5,1111,16.0,843.0,843.0
0.022,6,10,1989,5,910,5.0,642.0,642.0,5,1079,5.0,811.0,811.0
61.045,6,20,10037,11,3921,6104.0,1591.0,838.0,9,6116,7614.0,2111.0,940.0
0.008,6,10,1983,5,910,1.0,642.0,642.0,5,1073,2.0,805.0,805.0
0.006,6,12,1698,6,863,1.0,327.0,271.0,6,835,1.0,515.0,515.0
0.01,6,12,1926,6,1189,1.0,659.0,434.0,6,737,1.0,417.0,417.0
0.08,6,10,1506,5,395,16.0,127.0,127.0,5,1111,18.0,843.0,843.0
0.004,6,10,1989,5,927,1.0,659.0,659.0,5,1062,1.0,794.0,794.0
0.005,6,10,2006,5,927,1.0,659.0,659.0,5,1079,1.0,811.0,811.0
0.019,6,10,1677,5,827,4.0,559.0,559.0,5,850,4.0,582.0,582.0
0.066,6,10,1506,5,395,13.0,127.0,127.0,5,1111,15.0,843.0,843.0
0.116,6,10,1506,5,395,23.0,127.0,127.0,5,1111,23.0,843.0,843.0
0.007,6,10,1702,5,863,1.0,595.0,595.0,5,839,1.0,571.0,571.0
0.017,6,10,1972,5,910,4.0,642.0,642.0,5,1062,4.0,794.0,794.0
0.006,6,10,1689,5,839,1.0,571.0,571.0,5,850,1.0,582.0,582.0
366.799,6,22,2313,16,867,24453.0,195.0,195.0,6,1446,4636.0,419.0,398.0
0.005,6,10,1854,5,889,1.0,621.0,621.0,5,965,1.0,697.0,697.0
0.005,17,2,144,1,64,0.0,36.0,36.0,1,80,0.0,52.0,52.0
0.005,6,10,1643,5,860,1.0,592.0,592.0,5,783,1.0,515.0,515.0
0.062,6,10,1506,5,395,14.0,127.0,127.0,5,1111,13.0,843.0,843.0
0.11,6,10,1506,5,395,25.0,127.0,127.0,5,1111,25.0,843.0,843.0
8.601,6,34,8272,17,1841,537.0,773.0,376.0,17,6431,527.0,2126.0,478.0
0.009,6,10,1677,5,827,2.0,559.0,559.0,5,850,2.0,582.0,582.0
0.08,6,10,1506,5,395,18.0,127.0,127.0,5,1111,17.0,843.0,843.0
0.089,6,10,1506,5,395,19.0,127.0,127.0,5,1111,19.0,843.0,843.0
0.005,6,10,2006,5,927,1.0,659.0,659.0,5,1079,1.0,811.0,811.0
0.005,6,10,2006,5,927,1.0,659.0,659.0,5,1079,1.0,811.0,811.0
0.069,17,8,3613,4,1874,23.0,1350.0,440.0,4,1739,11.0,1350.0,406.0
0.004,17,4,495,2,132,0.0,38.0,38.0,2,363,1.0,176.0,153.0
11.277,17,27,4365,13,1937,926.0,269.0,121.0,14,2428,854.0,587.0,145.0
0.006,6,10,1643,5,860,1.0,592.0,592.0,5,783,1.0,515.0,515.0
0.005,6,10,1989,5,927,1.0,659.0,659.0,5,1062,1.0,794.0,794.0
1774.801,6,553,189043,281,163020,6338.0,2883.0,904.0,272,26023,6549.0,383.0,118.0
0.001,17,2,180,1,66,0.0,38.0,38.0,1,114,0.0,86.0,86.0
240.078,6,41,7159,20,3395,12635.0,880.0,333.0,21,3764,12003.0,1306.0,296.0
0.004,6,10,2000,5,927,1.0,659.0,659.0,5,1073,1.0,805.0,805.0
0.004,6,10,2000,5,927,1.0,659.0,659.0,5,1073,1.0,805.0,805.0
0.093,6,10,1506,5,395,20.0,127.0,127.0,5,1111,20.0,843.0,843.0
0.005,6,10,1945,5,981,1.0,713.0,713.0,5,964,1.0,696.0,696.0
0.025,6,10,1989,5,910,6.0,642.0,642.0,5,1079,6.0,811.0,811.0
0.066,6,10,1506,5,395,13.0,127.0,127.0,5,1111,15.0,843.0,843.0
0.008,6,10,1762,5,911,2.0,643.0,643.0,5,851,2.0,583.0,583.0
0.104,6,10,1506,5,395,24.0,127.0,127.0,5,1111,23.0,843.0,843.0
0.013,6,10,1990,5,911,3.0,643.0,643.0,5,1079,3.0,811.0,811.0
0.005,6,10,2000,5,927,1.0,659.0,659.0,5,1073,1.0,805.0,805.0
0.005,6,10,2000,5,927,1.0,659.0,659.0,5,1073,1.0,805.0,805.0
295.281,6,397,348761,189,21390,1570.0,2736.0,888.0,208,327371,1426.0,2804.0,1631.0
0.011,6,10,1983,5,910,2.0,642.0,642.0,5,1073,2.0,805.0,805.0
0.08,6,10,1506,5,395,16.0,127.0,127.0,5,1111,17.0,843.0,843.0
0.016,6,10,1990,5,911,3.0,643.0,643.0,5,1079,3.0,811.0,811.0
0.005,17,2,157,1,59,0.0,31.0,31.0,1,98,0.0,70.0,70.0
1276.151,6,50,6248,32,3766,41160.0,1640.0,140.0,18,2482,75058.0,1112.0,103.0
0.014,6,10,1990,5,911,3.0,643.0,643.0,5,1079,3.0,811.0,811.0
0.006,6,10,1547,5,764,1.0,496.0,496.0,5,783,1.0,515.0,515.0
0.004,6,13,3690,7,452,0.0,80.0,80.0,6,3238,0.0,1470.0,1459.0
0.108,6,10,1506,5,395,24.0,127.0,127.0,5,1111,20.0,843.0,843.0
1778.957,17,138,43608,72,22752,25053.0,288.0,288.0,66,20856,27368.0,288.0,288.0
0.012,6,10,1983,5,910,3.0,642.0,642.0,5,1073,2.0,805.0,805.0
0.005,6,10,1779,5,928,1.0,660.0,660.0,5,851,1.0,583.0,583.0
0.01,6,10,1989,5,910,2.0,642.0,642.0,5,1079,2.0,811.0,811.0
0.006,6,10,2000,5,927,1.0,659.0,659.0,5,1073,1.0,805.0,805.0
0.005,6,10,1779,5,928,1.0,660.0,660.0,5,851,1.0,583.0,583.0
0.011,6,10,1989,5,910,2.0,642.0,642.0,5,1079,2.0,811.0,811.0
240.238,6,31,9366,15,7083,17159.0,2208.0,700.0,16,2283,16014.0,580.0,180.0
0.063,6,10,1506,5,395,14.0,127.0,127.0,5,1111,14.0,843.0,843.0
0.004,6,10,1779,5,928,1.0,660.0,660.0,5,851,1.0,583.0,583.0
0.001,17,2,180,1,66,0.0,38.0,38.0,1,114,0.0,86.0,86.0
10.82,17,28,4420,14,1993,823.0,268.0,114.0,14,2427,823.0,586.0,145.0
0.082,6,10,1506,5,395,17.0,127.0,127.0,5,1111,20.0,843.0,843.0
0.087,6,10,1506,5,395,20.0,127.0,127.0,5,1111,16.0,843.0,843.0
0.286,6,24,6224,12,2081,24.0,490.0,289.0,12,4143,24.0,1324.0,585.0
0.01,6,10,1972,5,910,2.0,642.0,642.0,5,1062,2.0,794.0,794.0
0.013,6,10,1631,5,848,3.0,580.0,580.0,5,783,3.0,515.0,515.0
0.007,17,2,144,1,64,0.0,36.0,36.0,1,80,0.0,52.0,52.0
0.081,6,10,1506,5,395,18.0,127.0,127.0,5,1111,18.0,843.0,843.0
0.025,6,10,1972,5,910,6.0,642.0,642.0,5,1062,6.0,794.0,794.0
15.079,17,15,8346,8,6333,2150.0,1350.0,763.0,7,2013,2507.0,1350.0,259.0
300.026,6,12,1782,7,1348,50004.0,494.0,494.0,5,434,75005.0,83.0,83.0
0.004,17,4,284,2,120,0.0,32.0,32.0,2,164,0.0,60.0,54.0
0.005,17,2,144,1,64,0.0,36.0,36.0,1,80,0.0,52.0,52.0
0.089,6,10,1506,5,395,18.0,127.0,127.0,5,1111,19.0,843.0,843.0
0.005,6,10,2007,5,928,1.0,660.0,660.0,5,1079,1.0,811.0,811.0
280.608,6,24,6115,10,1186,31178.0,267.0,156.0,14,4929,21581.0,1400.0,873.0
0.005,6,10,2007,5,928,1.0,660.0,660.0,5,1079,1.0,811.0,811.0
0.005,6,10,1989,5,927,1.0,659.0,659.0,5,1062,1.0,794.0,794.0
0.005,6,10,2006,5,927,1.0,659.0,659.0,5,1079,1.0,811.0,811.0
177.148,17,76,10770,38,2536,4787.0,44.0,38.0,38,8234,4787.0,239.0,188.0
0.005,6,10,2000,5,927,1.0,659.0,659.0,5,1073,1.0,805.0,805.0
0.022,6,10,1762,5,911,5.0,643.0,643.0,5,851,5.0,583.0,583.0
0.005,6,10,2006,5,927,1.0,659.0,659.0,5,1079,1.0,811.0,811.0
0.01,6,10,1689,5,839,2.0,571.0,571.0,5,850,2.0,582.0,582.0
0.011,6,10,1990,5,911,2.0,643.0,643.0,5,1079,2.0,811.0,811.0
0.004,17,2,148,1,60,0.0,32.0,32.0,1,88,0.0,60.0,60.0
0.007,6,10,1989,5,910,1.0,642.0,642.0,5,1079,1.0,811.0,811.0
0.004,17,2,144,1,64,0.0,36.0,36.0,1,80,0.0,52.0,52.0
0.086,6,10,1506,5,395,20.0,127.0,127.0,5,1111,18.0,843.0,843.0
0.121,6,10,1506,5,395,26.0,127.0,127.0,5,1111,28.0,843.0,843.0
0.127,6,10,1506,5,395,30.0,127.0,127.0,5,1111,28.0,843.0,843.0
0.004,6,10,2006,5,927,1.0,659.0,659.0,5,1079,1.0,811.0,811.0
0.012,6,10,1989,5,910,3.0,642.0,642.0,5,1079,2.0,811.0,811.0
0.005,6,10,2006,5,927,1.0,659.0,659.0,5,1079,1.0,811.0,811.0
10.965,17,28,4398,14,2313,835.0,588.0,137.0,14,2085,834.0,268.0,120.0
0.04,17,2,152,1,76,0.0,48.0,48.0,1,76,0.0,48.0,48.0
0.006,6,10,1547,5,764,1.0,496.0,496.0,5,783,1.0,515.0,515.0
0.006,17,2,169,1,62,0.0,34.0,34.0,1,107,0.0,79.0,79.0
5.206,6,23,6467,13,1827,433.0,801.0,282.0,10,4640,578.0,1925.0,824.0
0.003,6,10,1702,5,863,0.0,595.0,595.0,5,839,0.0,571.0,571.0
40.061,17,10,676,5,460,10014.0,104.0,64.0,5,216,10014.0,20.0,15.0
0.007,6,10,1689,5,839,1.0,571.0,571.0,5,850,1.0,582.0,582.0
0.054,17,2,170,1,65,0.0,37.0,37.0,1,105,0.0,77.0,77.0
0.066,17,8,3613,4,1874,22.0,1350.0,440.0,4,1739,10.0,1350.0,406.0
0.006,6,10,1547,5,764,1.0,496.0,496.0,5,783,1.0,515.0,515.0
0.005,17,2,166,1,75,0.0,47.0,47.0,1,91,0.0,63.0,63.0
326.651,6,19,2158,6,1308,12004.0,494.0,494.0,13,850,27220.0,83.0,83.0
0.003,17,2,148,1,60,0.0,32.0,32.0,1,88,0.0,60.0,60.0
0.112,6,10,1506,5,395,26.0,127.0,127.0,5,1111,16.0,843.0,843.0
0.005,6,10,2000,5,927,1.0,659.0,659.0,5,1073,1.0,805.0,805.0
0.008,6,10,1677,5,827,2.0,559.0,559.0,5,850,2.0,582.0,582.0
0.011,6,10,1983,5,910,2.0,642.0,642.0,5,1073,2.0,805.0,805.0
351.986,6,20,2210,6,1308,12003.0,494.0,494.0,14,902,27075.0,83.0,83.0
0.011,6,10,1989,5,910,2.0,642.0,642.0,5,1079,2.0,811.0,811.0
0.013,6,10,1762,5,911,3.0,643.0,643.0,5,851,3.0,583.0,583.0
0.011,6,13,3735,7,497,1.0,125.0,125.0,6,3238,2.0,1470.0,1459.0
0.008,17,2,179,1,71,0.0,43.0,43.0,1,108,0.0,80.0,80.0
40.078,17,10,676,5,460,10018.0,104.0,64.0,5,216,10017.0,20.0,15.0
0.005,6,13,3690,7,452,0.0,80.0,80.0,6,3238,0.0,1470.0,1459.0
0.005,6,10,1989,5,927,1.0,659.0,659.0,5,1062,1.0,794.0,794.0
0.007,6,10,1983,5,910,1.0,642.0,642.0,5,1073,1.0,805.0,805.0
0.004,17,2,148,1,60,0.0,32.0,32.0,1,88,0.0,60.0,60.0
0.001,17,2,179,1,62,0.0,34.0,34.0,1,117,0.0,89.0,89.0
0.005,6,10,2007,5,928,1.0,660.0,660.0,5,1079,1.0,811.0,811.0
0.01,6,10,1990,5,928,2.0,660.0,660.0,5,1062,2.0,794.0,794.0
0.107,6,10,1506,5,395,24.0,127.0,127.0,5,1111,24.0,843.0,843.0
0.043,17,2,148,1,60,0.0,32.0,32.0,1,88,0.0,60.0,60.0
0.074,6,10,1506,5,395,16.0,127.0,127.0,5,1111,16.0,843.0,843.0
0.006,6,10,1854,5,889,1.0,621.0,621.0,5,965,1.0,697.0,697.0
0.084,6,10,1506,5,395,17.0,127.0,127.0,5,1111,19.0,843.0,843.0
0.077,17,8,3613,4,1874,25.0,1350.0,440.0,4,1739,9.0,1350.0,406.0
10.856,17,28,4421,14,1994,826.0,269.0,114.0,14,2427,826.0,586.0,145.0
0.088,6,10,1506,5,395,18.0,127.0,127.0,5,1111,21.0,843.0,843.0
0.04,6,10,1989,5,910,10.0,642.0,642.0,5,1079,10.0,811.0,811.0
0.118,6,10,1506,5,395,26.0,127.0,127.0,5,1111,23.0,843.0,843.0
0.097,6,10,1506,5,395,23.0,127.0,127.0,5,1111,20.0,843.0,843.0
173.196,17,84,12138,42,2825,4224.0,44.0,39.0,42,9313,4224.0,261.0,193.0
0.003,17,2,132,1,58,0.0,30.0,30.0,1,74,0.0,46.0,46.0
0.011,6,10,1972,5,910,2.0,642.0,642.0,5,1062,2.0,794.0,794.0
40.06,17,10,676,5,460,10014.0,104.0,64.0,5,216,10014.0,20.0,15.0
0.018,6,13,3735,7,497,3.0,125.0,125.0,6,3238,3.0,1470.0,1459.0
0.005,6,10,2006,5,927,1.0,659.0,659.0,5,1079,1.0,811.0,811.0
0.007,17,2,164,1,74,0.0,46.0,46.0,1,90,0.0,62.0,62.0
285.218,6,32,7667,17,1497,17825.0,517.0,290.0,15,6170,20372.0,2379.0,1078.0
0.126,6,10,1506,5,395,29.0,127.0,127.0,5,1111,26.0,843.0,843.0
240.472,6,36,10488,18,2211,14143.0,555.0,253.0,18,8277,14143.0,1402.0,612.0
0.006,6,10,1547,5,764,1.0,496.0,496.0,5,783,1.0,515.0,515.0
10.739,17,28,4422,14,1995,817.0,270.0,114.0,14,2427,817.0,586.0,145.0
0.094,6,10,1506,5,395,22.0,127.0,127.0,5,1111,21.0,843.0,843.0
0.013,6,10,1762,5,911,3.0,643.0,643.0,5,851,3.0,583.0,583.0
0.011,6,10,1990,5,911,2.0,643.0,643.0,5,1079,2.0,811.0,811.0
0.014,6,10,1983,5,910,3.0,642.0,642.0,5,1073,3.0,805.0,805.0
0.005,6,10,1774,5,923,1.0,655.0,655.0,5,851,1.0,583.0,583.0
40.065,17,10,676,5,460,10012.0,104.0,64.0,5,216,10015.0,20.0,15.0
169.267,17,76,10739,38,2530,4574.0,44.0,38.0,38,8209,4574.0,260.0,188.0
40.087,17,10,676,5,460,10019.0,104.0,64.0,5,216,10021.0,20.0,15.0
0.004,6,10,2000,5,927,1.0,659.0,659.0,5,1073,1.0,805.0,805.0
0.004,17,2,148,1,60,0.0,32.0,32.0,1,88,0.0,60.0,60.0
0.09,6,10,1506,5,395,19.0,127.0,127.0,5,1111,18.0,843.0,843.0
0.079,6,10,1506,5,395,17.0,127.0,127.0,5,1111,14.0,843.0,843.0
40.062,17,10,676,5,460,10014.0,104.0,64.0,5,216,10014.0,20.0,15.0
0.003,17,4,284,2,120,0.0,32.0,32.0,2,164,0.0,60.0,54.0
0.074,6,10,1506,5,395,16.0,127.0,127.0,5,1111,17.0,843.0,843.0
0.001,17,2,142,1,63,0.0,35.0,35.0,1,79,0.0,51.0,51.0
0.017,6,10,1989,5,910,4.0,642.0,642.0,5,1079,4.0,811.0,811.0
240.089,6,16,4482,9,963,30011.0,238.0,166.0,7,3519,40014.0,1402.0,786.0
0.004,6,10,2000,5,927,1.0,659.0,659.0,5,1073,1.0,805.0,805.0
154.421,6,26,9525,12,1627,72.0,794.0,367.0,14,7898,11869.0,1360.0,732.0
0.129,6,10,1506,5,395,28.0,127.0,127.0,5,1111,30.0,843.0,843.0
0.005,6,10,1779,5,928,1.0,660.0,660.0,5,851,1.0,583.0,583.0
0.009,6,10,1972,5,910,2.0,642.0,642.0,5,1062,2.0,794.0,794.0
0.071,6,10,1506,5,395,15.0,127.0,127.0,5,1111,14.0,843.0,843.0
0.003,17,2,148,1,60,0.0,32.0,32.0,1,88,0.0,60.0,60.0
0.07,6,10,1506,5,395,16.0,127.0,127.0,5,1111,13.0,843.0,843.0
10.831,17,28,4421,14,1994,824.0,269.0,114.0,14,2427,824.0,586.0,145.0
0.003,17,2,148,1,60,0.0,32.0,32.0,1,88,0.0,60.0,60.0
0.016,6,10,1972,5,910,4.0,642.0,642.0,5,1062,3.0,794.0,794.0
0.019,6,10,1990,5,911,4.0,643.0,643.0,5,1079,4.0,811.0,811.0
0.015,6,10,2007,5,928,3.0,660.0,660.0,5,1079,3.0,811.0,811.0
0.006,6,10,1854,5,889,1.0,621.0,621.0,5,965,1.0,697.0,697.0
0.005,6,10,1989,5,927,1.0,659.0,659.0,5,1062,1.0,794.0,794.0
0.007,6,10,1547,5,764,1.0,496.0,496.0,5,783,1.0,515.0,515.0
0.005,6,10,1643,5,860,1.0,592.0,592.0,5,783,1.0,515.0,515.0
0.001,17,2,179,1,62,0.0,34.0,34.0,1,117,0.0,89.0,89.0
0.128,6,10,1506,5,395,29.0,127.0,127.0,5,1111,28.0,843.0,843.0
0.17,17,2,152,1,76,0.0,48.0,48.0,1,76,0.0,48.0,48.0
0.009,6,10,1989,5,910,2.0,642.0,642.0,5,1079,2.0,811.0,811.0
0.037,17,2,152,1,76,0.0,48.0,48.0,1,76,0.0,48.0,48.0
0.004,17,4,420,2,122,0.0,33.0,33.0,2,298,1.0,145.0,121.0
0.18,6,10,1506,5,395,41.0,127.0,127.0,5,1111,36.0,843.0,843.0
0.005,6,10,2006,5,927,1.0,659.0,659.0,5,1079,1.0,811.0,811.0
0.001,17,2,180,1,66,0.0,38.0,38.0,1,114,0.0,86.0,86.0
0.006,6,10,1774,5,923,1.0,655.0,655.0,5,851,1.0,583.0,583.0
366.083,6,22,2313,16,867,24405.0,195.0,195.0,6,1446,4639.0,419.0,398.0
0.006,6,10,1547,5,764,1.0,496.0,496.0,5,783,1.0,515.0,515.0
0.078,6,10,1506,5,395,16.0,127.0,127.0,5,1111,16.0,843.0,843.0
175.56,17,78,11173,39,2617,4619.0,44.0,39.0,39,8556,4619.0,239.0,191.0
0.005,6,10,2006,5,927,1.0,659.0,659.0,5,1079,1.0,811.0,811.0
0.005,6,10,2006,5,927,1.0,659.0,659.0,5,1079,1.0,811.0,811.0
240.364,6,49,25430,22,2148,11444.0,605.0,196.0,27,23282,9243.0,2804.0,1042.0
40.072,17,10,676,5,460,10017.0,104.0,64.0,5,216,10017.0,20.0,15.0
241.175,6,374,347571,191,21460,1269.0,2736.0,886.0,183,326111,1325.0,3633.0,1829.0
0.087,6,10,1506,5,395,18.0,127.0,127.0,5,1111,18.0,843.0,843.0
0.016,17,2,144,1,64,0.0,36.0,36.0,1,80,0.0,52.0,52.0
9.039,17,6,376,5,280,2259.0,28.0,28.0,1,96,0.0,68.0,68.0
0.004,17,2,148,1,60,0.0,32.0,32.0,1,88,0.0,60.0,60.0
10.823,17,26,4103,13,1823,892.0,270.0,112.0,13,2280,892.0,587.0,147.0
0.006,6,10,1643,5,860,1.0,592.0,592.0,5,783,1.0,515.0,515.0
0.069,6,10,1506,5,395,14.0,127.0,127.0,5,1111,13.0,843.0,843.0
0.076,6,10,1506,5,395,16.0,127.0,127.0,5,1111,17.0,843.0,843.0
15.077,17,15,8125,8,6005,2149.0,1350.0,722.0,7,2120,2508.0,1350.0,274.0
0.091,6,10,1506,5,395,19.0,127.0,127.0,5,1111,14.0,843.0,843.0
0.006,6,10,1774,5,923,1.0,655.0,655.0,5,851,1.0,583.0,583.0
0.005,17,2,140,1,62,0.0,34.0,34.0,1,78,0.0,50.0,50.0
0.009,6,12,1926,6,1189,1.0,659.0,434.0,6,737,1.0,417.0,417.0
0.239,6,20,6552,10,1498,26.0,533.0,323.0,10,5054,18.0,1402.0,754.0
0.012,6,10,1972,5,910,2.0,642.0,642.0,5,1062,2.0,794.0,794.0
0.005,6,10,1989,5,927,1.0,659.0,659.0,5,1062,1.0,794.0,794.0
0.012,17,2,214,1,75,0.0,47.0,47.0,1,139,0.0,111.0,111.0
0.074,6,10,1506,5,395,16.0,127.0,127.0,5,1111,16.0,843.0,843.0
308.783,17,20,1124,10,716,34293.0,48.0,43.0,10,408,34294.0,20.0,12.0
321.962,17,20,1124,10,716,35759.0,48.0,43.0,10,408,35759.0,20.0,12.0
0.004,6,13,3747,7,509,0.0,137.0,137.0,6,3238,0.0,1470.0,1459.0
308.352,17,20,1124,10,716,34247.0,48.0,43.0,10,408,34247.0,20.0,12.0
0.081,6,10,1506,5,395,17.0,127.0,127.0,5,1111,16.0,843.0,843.0
0.114,6,10,1506,5,395,24.0,127.0,127.0,5,1111,23.0,843.0,843.0
0.008,6,10,1762,5,911,2.0,643.0,643.0,5,851,1.0,583.0,583.0
0.005,6,13,3690,7,452,0.0,80.0,80.0,6,3238,0.0,1470.0,1459.0
0.001,17,2,180,1,66,0.0,38.0,38.0,1,114,0.0,86.0,86.0
0.012,6,10,1990,5,911,3.0,643.0,643.0,5,1079,3.0,811.0,811.0
0.006,17,2,170,1,65,0.0,37.0,37.0,1,105,0.0,77.0,77.0
40.052,17,10,676,5,460,10011.0,104.0,64.0,5,216,10012.0,20.0,15.0
0.013,6,10,1983,5,910,3.0,642.0,642.0,5,1073,3.0,805.0,805.0
0.029,6,10,1990,5,911,7.0,643.0,643.0,5,1079,7.0,811.0,811.0
0.006,17,2,136,1,60,0.0,32.0,32.0,1,76,0.0,48.0,48.0
0.005,6,10,1989,5,927,1.0,659.0,659.0,5,1062,1.0,794.0,794.0
0.039,17,2,136,1,60,0.0,32.0,32.0,1,76,0.0,48.0,48.0
0.082,6,10,1506,5,395,17.0,127.0,127.0,5,1111,19.0,843.0,843.0
0.006,6,10,1774,5,923,1.0,655.0,655.0,5,851,1.0,583.0,583.0
0.005,17,2,178,1,81,0.0,53.0,53.0,1,97,0.0,69.0,69.0
0.005,6,10,1689,5,839,1.0,571.0,571.0,5,850,1.0,582.0,582.0
0.016,17,2,198,1,91,0.0,63.0,63.0,1,107,0.0,79.0,79.0
0.089,6,10,1506,5,395,15.0,127.0,127.0,5,1111,21.0,843.0,843.0
0.019,6,13,3735,7,497,3.0,125.0,125.0,6,3238,3.0,1470.0,1459.0
0.014,17,2,170,1,65,0.0,37.0,37.0,1,105,0.0,77.0,77.0
0.013,6,10,1990,5,911,3.0,643.0,643.0,5,1079,3.0,811.0,811.0
40.061,17,10,676,5,460,10014.0,104.0,64.0,5,216,10014.0,20.0,15.0
0.137,6,10,1506,5,395,32.0,127.0,127.0,5,1111,29.0,843.0,843.0
0.005,6,10,2000,5,927,1.0,659.0,659.0,5,1073,1.0,805.0,805.0
0.023,6,10,1972,5,910,5.0,642.0,642.0,5,1062,5.0,794.0,794.0
0.004,6,10,2000,5,927,1.0,659.0,659.0,5,1073,1.0,805.0,805.0
0.01,6,10,1762,5,911,2.0,643.0,643.0,5,851,2.0,583.0,583.0
0.115,6,10,1506,5,395,28.0,127.0,127.0,5,1111,24.0,843.0,843.0
0.017,6,10,1677,5,827,4.0,559.0,559.0,5,850,4.0,582.0,582.0
0.044,17,4,352,2,130,2.0,37.0,37.0,2,222,40.0,89.0,83.0
0.716,6,23,5165,12,1343,59.0,325.0,122.0,11,3822,60.0,1414.0,563.0
0.012,6,10,1990,5,911,3.0,643.0,643.0,5,1079,2.0,811.0,811.0
0.127,17,2,80,1,32,0.0,4.0,4.0,1,48,0.0,20.0,20.0
0.01,6,10,1983,5,910,2.0,642.0,642.0,5,1073,2.0,805.0,805.0
309.466,17,20,1124,10,716,34372.0,48.0,43.0,10,408,34372.0,20.0,12.0
0.006,6,10,1547,5,764,1.0,496.0,496.0,5,783,1.0,515.0,515.0
0.005,6,10,1689,5,839,1.0,571.0,571.0,5,850,1.0,582.0,582.0
0.061,6,10,1506,5,395,14.0,127.0,127.0,5,1111,12.0,843.0,843.0
0.113,6,10,1506,5,395,23.0,127.0,127.0,5,1111,23.0,843.0,843.0
169.369,17,80,11307,40,2681,4342.0,44.0,39.0,40,8626,4342.0,261.0,187.0
0.011,6,10,1989,5,910,2.0,642.0,642.0,5,1079,2.0,811.0,811.0
0.005,17,2,166,1,75,0.0,47.0,47.0,1,91,0.0,63.0,63.0
0.009,6,10,1989,5,910,2.0,642.0,642.0,5,1079,2.0,811.0,811.0
0.004,6,10,1774,5,923,1.0,655.0,655.0,5,851,1.0,583.0,583.0
0.006,6,10,2000,5,927,1.0,659.0,659.0,5,1073,1.0,805.0,805.0
0.014,6,10,1990,5,911,3.0,643.0,643.0,5,1079,3.0,811.0,811.0
0.015,6,10,1989,5,910,3.0,642.0,642.0,5,1079,3.0,811.0,811.0
0.011,6,10,1989,5,910,2.0,642.0,642.0,5,1079,2.0,811.0,811.0
1757.039,6,104,6188,59,3458,30293.0,26.0,26.0,45,2730,39931.0,26.0,26.0
40.073,17,10,676,5,460,10015.0,104.0,64.0,5,216,10017.0,20.0,15.0
0.008,6,10,1990,5,911,2.0,643.0,643.0,5,1079,2.0,811.0,811.0
0.004,6,10,2006,5,927,1.0,659.0,659.0,5,1079,1.0,811.0,811.0
0.001,17,2,180,1,66,0.0,38.0,38.0,1,114,0.0,86.0,86.0
0.102,6,10,1506,5,395,22.0,127.0,127.0,5,1111,21.0,843.0,843.0
0.005,6,10,2007,5,928,1.0,660.0,660.0,5,1079,1.0,811.0,811.0
0.016,6,10,1972,5,910,4.0,642.0,642.0,5,1062,4.0,794.0,794.0
0.009,6,10,1989,5,910,2.0,642.0,642.0,5,1079,2.0,811.0,811.0
0.005,17,2,166,1,75,0.0,47.0,47.0,1,91,0.0,63.0,63.0
0.038,6,13,3913,7,495,6.0,123.0,123.0,6,3418,7.0,1650.0,1549.0
0.072,6,10,1506,5,395,15.0,127.0,127.0,5,1111,15.0,843.0,843.0
0.082,6,10,1506,5,395,18.0,127.0,127.0,5,1111,16.0,843.0,843.0
0.149,6,10,1506,5,395,29.0,127.0,127.0,5,1111,31.0,843.0,843.0
5.078,6,21,5923,12,1436,461.0,474.0,201.0,9,4487,634.0,1925.0,804.0
0.087,6,10,1506,5,395,20.0,127.0,127.0,5,1111,19.0,843.0,843.0
0.072,6,10,1506,5,395,15.0,127.0,127.0,5,1111,15.0,843.0,843.0
0.08,6,10,1506,5,395,17.0,127.0,127.0,5,1111,17.0,843.0,843.0
0.019,6,10,1989,5,910,4.0,642.0,642.0,5,1079,4.0,811.0,811.0
0.005,6,13,3747,7,509,0.0,137.0,137.0,6,3238,0.0,1470.0,1459.0
0.04,17,2,148,1,60,0.0,32.0,32.0,1,88,0.0,60.0,60.0
0.005,6,10,2007,5,928,1.0,660.0,660.0,5,1079,1.0,811.0,811.0
0.005,6,10,1689,5,839,1.0,571.0,571.0,5,850,1.0,582.0,582.0
0.085,17,4,352,2,130,46.0,37.0,37.0,2,222,45.0,89.0,83.0
240.26,6,42,8719,21,5686,12012.0,1515.0,509.0,21,3033,12012.0,580.0,241.0
0.006,17,2,144,1,64,0.0,36.0,36.0,1,80,0.0,52.0,52.0
0.012,6,10,1983,5,910,3.0,642.0,642.0,5,1073,2.0,805.0,805.0
0.069,6,10,1506,5,395,16.0,127.0,127.0,5,1111,13.0,843.0,843.0
0.005,6,10,1854,5,889,1.0,621.0,621.0,5,965,1.0,697.0,697.0
0.015,6,10,1989,5,910,3.0,642.0,642.0,5,1079,3.0,811.0,811.0
0.023,6,10,1989,5,910,5.0,642.0,642.0,5,1079,5.0,811.0,811.0
0.006,17,2,179,1,71,0.0,43.0,43.0,1,108,0.0,80.0,80.0
0.004,6,10,2006,5,927,1.0,659.0,659.0,5,1079,1.0,811.0,811.0
0.052,17,4,284,2,120,0.0,32.0,32.0,2,164,36.0,60.0,54.0
0.011,6,10,1631,5,848,2.0,580.0,580.0,5,783,2.0,515.0,515.0
0.3,17,53,29020,30,25000,10.0,1350.0,805.0,23,4020,10.0,1350.0,146.0
0.012,6,10,1990,5,911,2.0,643.0,643.0,5,1079,3.0,811.0,811.0
0.008,6,12,1698,6,863,1.0,327.0,271.0,6,835,1.0,515.0,515.0
0.007,6,10,2007,5,928,1.0,660.0,660.0,5,1079,1.0,811.0,811.0
0.08,6,10,1506,5,395,18.0,127.0,127.0,5,1111,15.0,843.0,843.0
0.005,6,10,2006,5,927,1.0,659.0,659.0,5,1079,1.0,811.0,811.0
0.005,6,10,1989,5,927,1.0,659.0,659.0,5,1062,1.0,794.0,794.0
0.079,6,10,1506,5,395,16.0,127.0,127.0,5,1111,15.0,843.0,843.0
0.085,6,10,1506,5,395,16.0,127.0,127.0,5,1111,19.0,843.0,843.0
240.375,6,33,9250,16,1817,16024.0,605.0,195.0,17,7433,15023.0,1402.0,595.0
0.005,6,10,2007,5,928,1.0,660.0,660.0,5,1079,1.0,811.0,811.0
0.38,6,22,7187,11,1635,38.0,748.0,263.0,11,5552,37.0,2335.0,994.0
0.12,6,28,10227,15,8942,8.0,2883.0,1166.0,13,1285,9.0,263.0,101.0
0.003,17,2,136,1,60,0.0,32.0,32.0,1,76,0.0,48.0,48.0
0.013,6,10,1972,5,910,3.0,642.0,642.0,5,1062,3.0,794.0,794.0
0.014,6,10,1990,5,911,3.0,643.0,643.0,5,1079,3.0,811.0,811.0
0.004,17,2,136,1,60,0.0,32.0,32.0,1,76,0.0,48.0,48.0
0.104,6,10,1506,5,395,22.0,127.0,127.0,5,1111,23.0,843.0,843.0
11.175,17,28,4418,14,1993,847.0,268.0,114.0,14,2425,847.0,588.0,145.0
0.001,17,2,136,1,60,0.0,32.0,32.0,1,76,0.0,48.0,48.0
0.13,6,10,1506,5,395,28.0,127.0,127.0,5,1111,31.0,843.0,843.0
40.061,17,10,676,5,460,10012.0,104.0,64.0,5,216,10014.0,20.0,15.0
0.008,6,10,1983,5,910,2.0,642.0,642.0,5,1073,2.0,805.0,805.0
0.001,17,2,180,1,66,0.0,38.0,38.0,1,114,0.0,86.0,86.0
0.081,6,10,1506,5,395,17.0,127.0,127.0,5,1111,19.0,843.0,843.0
0.009,6,10,1989,5,910,2.0,642.0,642.0,5,1079,2.0,811.0,811.0
0.008,6,10,1989,5,910,1.0,642.0,642.0,5,1079,2.0,811.0,811.0
0.008,6,10,1972,5,910,2.0,642.0,642.0,5,1062,2.0,794.0,794.0
0.005,6,10,1774,5,923,1.0,655.0,655.0,5,851,1.0,583.0,583.0
0.014,6,13,3913,7,495,2.0,123.0,123.0,6,3418,2.0,1650.0,1549.0
0.145,6,10,1506,5,395,27.0,127.0,127.0,5,1111,32.0,843.0,843.0
0.011,6,10,1990,5,911,2.0,643.0,643.0,5,1079,2.0,811.0,811.0
0.115,6,10,1506,5,395,16.0,127.0,127.0,5,1111,26.0,843.0,843.0
0.006,6,10,1854,5,889,1.0,621.0,621.0,5,965,1.0,697.0,697.0
0.073,17,2,412,1,61,0.0,33.0,33.0,1,351,0.0,323.0,323.0
0.068,6,10,1506,5,395,16.0,127.0,127.0,5,1111,15.0,843.0,843.0
0.094,6,10,1506,5,395,19.0,127.0,127.0,5,1111,22.0,843.0,843.0
40.018,17,10,676,5,460,10003.0,104.0,64.0,5,216,10003.0,20.0,15.0
0.015,6,10,1989,5,910,3.0,642.0,642.0,5,1079,3.0,811.0,811.0
0.005,6,10,1689,5,839,1.0,571.0,571.0,5,850,1.0,582.0,582.0
0.005,17,2,230,1,68,0.0,40.0,40.0,1,162,0.0,134.0,134.0
0.005,6,13,3747,7,509,0.0,137.0,137.0,6,3238,1.0,1470.0,1459.0
0.017,6,10,1677,5,827,4.0,559.0,559.0,5,850,4.0,582.0,582.0
40.075,17,10,676,5,460,10016.0,104.0,64.0,5,216,10018.0,20.0,15.0
0.073,17,2,234,1,61,0.0,33.0,33.0,1,173,0.0,145.0,145.0
0.004,6,10,2000,5,927,1.0,659.0,659.0,5,1073,1.0,805.0,805.0
0.016,6,10,1989,5,910,4.0,642.0,642.0,5,1079,4.0,811.0,811.0
168.331,17,76,10770,38,2536,4549.0,44.0,38.0,38,8234,4549.0,239.0,188.0
314.452,17,20,1124,10,716,34925.0,48.0,43.0,10,408,34925.0,20.0,12.0
0.01,6,10,1983,5,910,2.0,642.0,642.0,5,1073,2.0,805.0,805.0
40.077,17,10,676,5,460,10016.0,104.0,64.0,5,216,10018.0,20.0,15.0
0.009,6,10,1989,5,910,2.0,642.0,642.0,5,1079,2.0,811.0,811.0
0.005,17,2,136,1,60,0.0,32.0,32.0,1,76,0.0,48.0,48.0
0.013,6,10,1989,5,910,3.0,642.0,642.0,5,1079,3.0,811.0,811.0
0.016,6,10,1990,5,911,4.0,643.0,643.0,5,1079,4.0,811.0,811.0
0.007,17,2,179,1,71,0.0,43.0,43.0,1,108,0.0,80.0,80.0
0.005,17,2,179,1,71,0.0,43.0,43.0,1,108,0.0,80.0,80.0
0.006,6,10,1547,5,764,1.0,496.0,496.0,5,783,1.0,515.0,515.0
0.014,6,10,1990,5,911,3.0,643.0,643.0,5,1079,3.0,811.0,811.0
0.006,6,10,1854,5,889,1.0,621.0,621.0,5,965,1.0,697.0,697.0
0.752,6,23,5165,12,1343,68.0,325.0,122.0,11,3822,63.0,1414.0,563.0
0.004,6,10,1774,5,923,1.0,655.0,655.0,5,851,1.0,583.0,583.0
0.017,6,10,1972,5,910,4.0,642.0,642.0,5,1062,4.0,794.0,794.0
0.004,6,10,1779,5,928,1.0,660.0,660.0,5,851,1.0,583.0,583.0
0.321,6,10,1506,5,395,79.0,127.0,127.0,5,1111,31.0,843.0,843.0
0.005,17,2,179,1,71,0.0,43.0,43.0,1,108,0.0,80.0,80.0
0.003,17,2,136,1,60,0.0,32.0,32.0,1,76,0.0,48.0,48.0
0.004,17,2,214,1,75,0.0,47.0,47.0,1,139,0.0,111.0,111.0
0.006,6,10,1854,5,889,1.0,621.0,621.0,5,965,1.0,697.0,697.0
0.103,6,10,1506,5,395,24.0,127.0,127.0,5,1111,22.0,843.0,843.0
0.01,6,10,1972,5,910,2.0,642.0,642.0,5,1062,2.0,794.0,794.0
0.014,6,13,3913,7,495,2.0,123.0,123.0,6,3418,2.0,1650.0,1549.0
0.005,6,10,1774,5,923,1.0,655.0,655.0,5,851,1.0,583.0,583.0
0.004,17,2,136,1,60,0.0,32.0,32.0,1,76,0.0,48.0,48.0
0.017,6,10,1631,5,848,4.0,580.0,580.0,5,783,4.0,515.0,515.0
40.074,17,10,676,5,460,10017.0,104.0,64.0,5,216,10017.0,20.0,15.0
0.014,6,10,1983,5,910,3.0,642.0,642.0,5,1073,3.0,805.0,805.0
0.006,17,4,284,2,120,0.0,32.0,32.0,2,164,0.0,60.0,54.0
0.008,6,10,1989,5,910,2.0,642.0,642.0,5,1079,1.0,811.0,811.0
0.003,17,2,148,1,60,0.0,32.0,32.0,1,88,0.0,60.0,60.0
300.387,6,16,2170,9,684,37528.0,146.0,146.0,7,1486,50037.0,419.0,398.0
10.841,17,28,4421,14,1993,825.0,268.0,114.0,14,2428,825.0,587.0,145.0
0.013,6,10,1972,5,910,3.0,642.0,642.0,5,1062,3.0,794.0,794.0
0.089,6,10,1506,5,395,20.0,127.0,127.0,5,1111,18.0,843.0,843.0
0.015,6,10,1631,5,848,3.0,580.0,580.0,5,783,3.0,515.0,515.0
0.009,6,10,1677,5,827,2.0,559.0,559.0,5,850,2.0,582.0,582.0
0.04,17,2,412,1,61,0.0,33.0,33.0,1,351,0.0,323.0,323.0
0.001,17,2,180,1,66,0.0,38.0,38.0,1,114,0.0,86.0,86.0
0.005,6,10,2007,5,928,1.0,660.0,660.0,5,1079,1.0,811.0,811.0
0.011,6,10,1990,5,911,2.0,643.0,643.0,5,1079,2.0,811.0,811.0
0.006,17,2,170,1,65,0.0,37.0,37.0,1,105,0.0,77.0,77.0
0.025,17,2,179,1,71,0.0,43.0,43.0,1,108,0.0,80.0,80.0
0.011,6,10,1989,5,910,2.0,642.0,642.0,5,1079,2.0,811.0,811.0
0.059,6,10,1506,5,395,13.0,127.0,127.0,5,1111,11.0,843.0,843.0
11.02,17,28,4421,14,1993,839.0,268.0,114.0,14,2428,839.0,587.0,145.0
240.094,6,16,4481,9,963,30011.0,238.0,166.0,7,3518,40015.0,1402.0,786.0
0.01,6,10,1989,5,927,2.0,659.0,659.0,5,1062,2.0,794.0,794.0
1777.678,17,144,45504,72,22752,25037.0,288.0,288.0,72,22752,25037.0,288.0,288.0
0.117,6,10,1506,5,395,26.0,127.0,127.0,5,1111,22.0,843.0,843.0
0.01,6,10,1631,5,848,2.0,580.0,580.0,5,783,2.0,515.0,515.0
0.007,6,10,1547,5,764,1.0,496.0,496.0,5,783,1.0,515.0,515.0
0.039,17,2,182,1,65,0.0,37.0,37.0,1,117,0.0,89.0,89.0
0.001,17,2,179,1,62,0.0,34.0,34.0,1,117,0.0,89.0,89.0
0.013,6,10,1972,5,910,3.0,642.0,642.0,5,1062,3.0,794.0,794.0
294.785,6,325,345018,169,20346,1754.0,2736.0,889.0,156,324672,1901.0,4206.0,2229.0
0.007,17,2,179,1,71,0.0,43.0,43.0,1,108,0.0,80.0,80.0
0.005,6,10,2006,5,927,1.0,659.0,659.0,5,1079,1.0,811.0,811.0
0.084,6,10,1506,5,395,18.0,127.0,127.0,5,1111,18.0,843.0,843.0
0.003,17,2,148,1,60,0.0,32.0,32.0,1,88,0.0,60.0,60.0
0.005,6,10,2007,5,928,1.0,660.0,660.0,5,1079,1.0,811.0,811.0
0.04,17,2,136,1,60,0.0,32.0,32.0,1,76,0.0,48.0,48.0
15.084,17,15,8428,8,6366,2150.0,1350.0,767.0,7,2062,2509.0,1350.0,266.0
0.005,6,10,2006,5,927,1.0,659.0,659.0,5,1079,1.0,811.0,811.0
0.011,17,2,180,1,66,0.0,38.0,38.0,1,114,0.0,86.0,86.0
0.001,17,2,268,1,70,0.0,42.0,42.0,1,198,0.0,170.0,170.0
308.67,17,20,1124,10,716,34281.0,48.0,43.0,10,408,34281.0,20.0,12.0
40.056,17,10,676,5,460,10010.0,104.0,64.0,5,216,10013.0,20.0,15.0
15.077,17,16,9097,8,6884,2149.0,1350.0,832.0,8,2213,2149.0,1350.0,248.0
10.893,17,28,4417,14,1993,829.0,268.0,114.0,14,2424,829.0,587.0,145.0
0.096,6,10,1506,5,395,21.0,127.0,127.0,5,1111,20.0,843.0,843.0
0.005,6,10,2006,5,927,1.0,659.0,659.0,5,1079,1.0,811.0,811.0
0.005,17,2,170,1,65,0.0,37.0,37.0,1,105,0.0,77.0,77.0
0.006,6,10,1854,5,889,1.0,621.0,621.0,5,965,1.0,697.0,697.0
241.633,6,372,346467,190,21406,1278.0,2736.0,959.0,182,325061,1334.0,2804.0,1834.0
0.012,6,10,1972,5,910,2.0,642.0,642.0,5,1062,2.0,794.0,794.0
0.021,6,10,1989,5,910,5.0,642.0,642.0,5,1079,5.0,811.0,811.0
0.087,6,10,1506,5,395,20.0,127.0,127.0,5,1111,18.0,843.0,843.0
0.013,6,10,1989,5,910,3.0,642.0,642.0,5,1079,3.0,811.0,811.0
0.011,6,10,1989,5,910,2.0,642.0,642.0,5,1079,2.0,811.0,811.0
0.0,17,2,136,1,60,0.0,32.0,32.0,1,76,0.0,48.0,48.0
0.144,6,10,1506,5,395,34.0,127.0,127.0,5,1111,33.0,843.0,843.0
0.019,6,10,1983,5,910,4.0,642.0,642.0,5,1073,4.0,805.0,805.0
0.068,17,8,3613,4,1874,22.0,1350.0,440.0,4,1739,11.0,1350.0,406.0
0.005,6,10,1989,5,927,1.0,659.0,659.0,5,1062,1.0,794.0,794.0
0.126,6,10,1506,5,395,29.0,127.0,127.0,5,1111,29.0,843.0,843.0
176.334,17,72,10262,36,2393,5037.0,44.0,38.0,36,7869,5037.0,252.0,190.0
0.009,6,12,1926,6,1189,1.0,659.0,434.0,6,737,1.0,417.0,417.0
310.002,17,20,1124,10,716,34431.0,48.0,43.0,10,408,34428.0,20.0,12.0
0.006,6,10,1547,5,764,1.0,496.0,496.0,5,783,1.0,515.0,515.0
0.015,6,10,1762,5,911,3.0,643.0,643.0,5,851,3.0,583.0,583.0
0.104,6,10,1506,5,395,24.0,127.0,127.0,5,1111,24.0,843.0,843.0
0.105,6,10,1506,5,395,25.0,127.0,127.0,5,1111,24.0,843.0,843.0
0.008,17,2,132,1,58,0.0,30.0,30.0,1,74,0.0,46.0,46.0
0.005,6,10,2006,5,927,1.0,659.0,659.0,5,1079,1.0,811.0,811.0
0.004,17,2,136,1,60,0.0,32.0,32.0,1,76,0.0,48.0,48.0
0.004,6,10,1989,5,927,1.0,659.0,659.0,5,1062,1.0,794.0,794.0
325.754,17,20,1124,10,716,36180.0,48.0,43.0,10,408,36180.0,20.0,12.0
0.096,6,10,1506,5,395,22.0,127.0,127.0,5,1111,19.0,843.0,843.0
0.016,6,10,1677,5,827,4.0,559.0,559.0,5,850,3.0,582.0,582.0
40.065,17,10,676,5,460,10013.0,104.0,64.0,5,216,10015.0,20.0,15.0
0.012,6,10,1989,5,910,3.0,642.0,642.0,5,1079,3.0,811.0,811.0
0.111,6,10,1506,5,395,21.0,127.0,127.0,5,1111,24.0,843.0,843.0
0.009,6,10,1983,5,910,2.0,642.0,642.0,5,1073,2.0,805.0,805.0
0.016,6,10,1989,5,910,3.0,642.0,642.0,5,1079,4.0,811.0,811.0
5.113,6,23,6467,13,1827,425.0,801.0,282.0,10,4640,567.0,1925.0,824.0
0.004,6,10,1779,5,928,1.0,660.0,660.0,5,851,1.0,583.0,583.0
0.005,6,13,3747,7,509,0.0,137.0,137.0,6,3238,0.0,1470.0,1459.0
0.082,6,10,1506,5,395,15.0,127.0,127.0,5,1111,17.0,843.0,843.0
354.002,6,21,1795,16,1030,23600.0,190.0,190.0,5,765,60001.0,464.0,248.0
1729.202,6,60,4400,40,2740,44338.0,33.0,33.0,20,1660,91001.0,31.0,31.0
0.011,6,10,1631,5,848,2.0,580.0,580.0,5,783,2.0,515.0,515.0
288.201,6,328,344097,122,17894,2381.0,2736.0,888.0,206,326203,1405.0,2804.0,1643.0
40.075,17,10,676,5,460,10016.0,104.0,64.0,5,216,10018.0,20.0,15.0
0.076,6,10,1506,5,395,16.0,127.0,127.0,5,1111,16.0,843.0,843.0
0.006,6,10,1547,5,764,1.0,496.0,496.0,5,783,1.0,515.0,515.0
0.038,17,2,412,1,61,0.0,33.0,33.0,1,351,0.0,323.0,323.0
0.002,17,2,180,1,66,0.0,38.0,38.0,1,114,0.0,86.0,86.0
308.533,17,20,1124,10,716,34267.0,48.0,43.0,10,408,34267.0,20.0,12.0
0.004,6,14,3742,7,452,0.0,80.0,80.0,7,3290,0.0,1448.0,972.0
40.06,17,10,676,5,460,10014.0,104.0,64.0,5,216,10014.0,20.0,15.0
0.013,6,10,1989,5,910,3.0,642.0,642.0,5,1079,3.0,811.0,811.0
0.009,17,2,179,1,71,0.0,43.0,43.0,1,108,0.0,80.0,80.0
0.118,6,10,1506,5,395,26.0,127.0,127.0,5,1111,25.0,843.0,843.0
0.005,6,10,1689,5,839,1.0,571.0,571.0,5,850,1.0,582.0,582.0
40.056,17,10,676,5,460,10013.0,104.0,64.0,5,216,10012.0,20.0,15.0
0.004,6,10,2006,5,927,1.0,659.0,659.0,5,1079,1.0,811.0,811.0
0.005,6,10,2007,5,928,1.0,660.0,660.0,5,1079,1.0,811.0,811.0
0.082,6,10,1506,5,395,15.0,127.0,127.0,5,1111,18.0,843.0,843.0
0.005,6,10,2006,5,927,1.0,659.0,659.0,5,1079,1.0,811.0,811.0
0.006,17,2,170,1,65,0.0,37.0,37.0,1,105,0.0,77.0,77.0
0.002,17,2,180,1,66,0.0,38.0,38.0,1,114,0.0,86.0,86.0
0.075,6,10,1506,5,395,17.0,127.0,127.0,5,1111,18.0,843.0,843.0
0.013,6,10,1989,5,910,3.0,642.0,642.0,5,1079,3.0,811.0,811.0
0.005,6,10,1854,5,889,1.0,621.0,621.0,5,965,1.0,697.0,697.0
0.087,6,10,1506,5,395,19.0,127.0,127.0,5,1111,18.0,843.0,843.0
0.071,17,2,234,1,61,0.0,33.0,33.0,1,173,0.0,145.0,145.0
0.002,17,2,180,1,66,0.0,38.0,38.0,1,114,0.0,86.0,86.0
0.003,17,2,185,1,73,0.0,45.0,45.0,1,112,0.0,84.0,84.0
0.009,6,10,1972,5,910,2.0,642.0,642.0,5,1062,2.0,794.0,794.0
0.005,6,10,1689,5,839,1.0,571.0,571.0,5,850,1.0,582.0,582.0
0.108,6,10,1506,5,395,24.0,127.0,127.0,5,1111,24.0,843.0,843.0
0.015,6,14,3787,7,497,2.0,125.0,125.0,7,3290,2.0,1448.0,972.0
0.011,6,10,1762,5,911,2.0,643.0,643.0,5,851,2.0,583.0,583.0
0.01,6,10,1989,5,910,2.0,642.0,642.0,5,1079,2.0,811.0,811.0
240.011,6,9,787,5,488,60002.0,232.0,232.0,4,299,80002.0,83.0,83.0
273.795,6,26,5867,13,2965,22816.0,967.0,453.0,13,2902,22816.0,1162.0,369.0
240.171,6,27,9917,15,1356,17155.0,260.0,189.0,12,8561,21830.0,1561.0,991.0
0.093,6,10,1506,5,395,20.0,127.0,127.0,5,1111,22.0,843.0,843.0
0.005,17,2,170,1,65,0.0,37.0,37.0,1,105,0.0,77.0,77.0
0.005,6,10,1689,5,839,1.0,571.0,571.0,5,850,1.0,582.0,582.0
0.006,6,10,1689,5,839,1.0,571.0,571.0,5,850,1.0,582.0,582.0
0.005,17,2,170,1,65,0.0,37.0,37.0,1,105,0.0,77.0,77.0
0.005,6,10,2000,5,927,1.0,659.0,659.0,5,1073,1.0,805.0,805.0
0.005,6,10,2006,5,927,1.0,659.0,659.0,5,1079,1.0,811.0,811.0
0.006,17,2,164,1,74,0.0,46.0,46.0,1,90,0.0,62.0,62.0
0.085,6,10,1506,5,395,18.0,127.0,127.0,5,1111,19.0,843.0,843.0
0.068,6,10,1506,5,395,15.0,127.0,127.0,5,1111,15.0,843.0,843.0
0.011,6,10,1990,5,911,2.0,643.0,643.0,5,1079,2.0,811.0,811.0
0.005,6,14,3799,7,509,0.0,137.0,137.0,7,3290,0.0,1448.0,972.0
0.087,6,10,1506,5,395,20.0,127.0,127.0,5,1111,17.0,843.0,843.0
0.013,6,10,1972,5,910,3.0,642.0,642.0,5,1062,3.0,794.0,794.0
0.021,6,10,1989,5,910,5.0,642.0,642.0,5,1079,5.0,811.0,811.0
0.013,17,2,152,1,56,0.0,28.0,28.0,1,96,0.0,68.0,68.0
0.017,6,10,1983,5,910,4.0,642.0,642.0,5,1073,4.0,805.0,805.0
15.072,17,14,9190,8,6902,2149.0,1350.0,834.0,6,2288,3008.0,1350.0,353.0
0.004,17,2,156,1,64,0.0,36.0,36.0,1,92,0.0,64.0,64.0
0.009,6,12,1926,6,1189,1.0,659.0,434.0,6,737,1.0,417.0,417.0
0.005,6,14,3799,7,509,0.0,137.0,137.0,7,3290,0.0,1448.0,972.0
0.012,6,10,1989,5,910,3.0,642.0,642.0,5,1079,2.0,811.0,811.0
0.224,6,16,2669,8,1395,32.0,533.0,323.0,8,1274,20.0,529.0,212.0
0.113,6,10,1506,5,395,24.0,127.0,127.0,5,1111,22.0,843.0,843.0
0.128,6,10,1506,5,395,30.0,127.0,127.0,5,1111,29.0,843.0,843.0
0.011,6,10,1762,5,911,2.0,643.0,643.0,5,851,2.0,583.0,583.0
0.009,6,10,1990,5,911,2.0,643.0,643.0,5,1079,2.0,811.0,811.0
0.008,6,10,1631,5,848,2.0,580.0,580.0,5,783,1.0,515.0,515.0
0.005,6,14,3742,8,504,0.0,80.0,80.0,6,3238,0.0,1470.0,1459.0
59.852,6,37,6481,20,1430,3150.0,267.0,195.0,17,5051,535.0,1823.0,363.0
0.005,17,2,214,1,75,0.0,47.0,47.0,1,139,0.0,111.0,111.0
0.011,6,10,1989,5,910,2.0,642.0,642.0,5,1079,2.0,811.0,811.0
0.089,6,10,1506,5,395,17.0,127.0,127.0,5,1111,21.0,843.0,843.0
65.691,6,27,18209,15,10262,4692.0,2804.0,1579.0,12,7947,5956.0,2318.0,1219.0
0.017,6,10,1989,5,910,4.0,642.0,642.0,5,1079,4.0,811.0,811.0
0.004,6,10,1989,5,927,1.0,659.0,659.0,5,1062,1.0,794.0,794.0
0.117,6,10,1506,5,395,28.0,127.0,127.0,5,1111,24.0,843.0,843.0
0.014,6,10,1989,5,910,3.0,642.0,642.0,5,1079,3.0,811.0,811.0
0.008,6,10,1983,5,910,2.0,642.0,642.0,5,1073,2.0,805.0,805.0
0.005,6,13,3747,7,509,0.0,137.0,137.0,6,3238,0.0,1470.0,1459.0
0.073,6,10,1506,5,395,16.0,127.0,127.0,5,1111,16.0,843.0,843.0
0.01,6,13,3735,7,497,1.0,125.0,125.0,6,3238,2.0,1470.0,1459.0
0.004,17,2,160,1,72,0.0,44.0,44.0,1,88,0.0,60.0,60.0
0.01,6,10,1989,5,910,2.0,642.0,642.0,5,1079,2.0,811.0,811.0
0.094,6,10,1506,5,395,19.0,127.0,127.0,5,1111,22.0,843.0,843.0
0.116,6,43,13910,24,2503,5.0,517.0,139.0,19,11407,5.0,1402.0,800.0
11.15,17,28,4422,14,1994,845.0,269.0,114.0,14,2428,845.0,587.0,145.0
0.005,6,10,2006,5,927,1.0,659.0,659.0,5,1079,1.0,811.0,811.0
0.004,6,10,2006,5,927,1.0,659.0,659.0,5,1079,1.0,811.0,811.0
0.081,6,10,1506,5,395,17.0,127.0,127.0,5,1111,17.0,843.0,843.0
0.005,6,10,2006,5,927,1.0,659.0,659.0,5,1079,1.0,811.0,811.0
0.118,6,10,1506,5,395,28.0,127.0,127.0,5,1111,25.0,843.0,843.0
0.015,6,10,1989,5,910,3.0,642.0,642.0,5,1079,3.0,811.0,811.0
166.466,17,76,10650,38,2537,4498.0,44.0,38.0,38,8113,4499.0,261.0,185.0
0.002,17,2,136,1,60,0.0,32.0,32.0,1,76,0.0,48.0,48.0
0.008,17,2,179,1,71,0.0,43.0,43.0,1,108,0.0,80.0,80.0
0.005,6,10,1989,5,927,1.0,659.0,659.0,5,1062,1.0,794.0,794.0
0.008,6,10,1762,5,911,2.0,643.0,643.0,5,851,1.0,583.0,583.0
1799.76,6,271,34006,109,15150,16663.0,1939.0,131.0,162,18856,11177.0,1360.0,150.0
324.273,6,762,731120,345,706894,942.0,4080.0,2172.0,417,24226,77.0,2667.0,215.0
0.101,6,10,1506,5,395,21.0,127.0,127.0,5,1111,20.0,843.0,843.0
9.075,6,36,9012,19,3525,504.0,1360.0,546.0,17,5487,554.0,2658.0,435.0
0.014,6,10,1983,5,910,3.0,642.0,642.0,5,1073,3.0,805.0,805.0
0.781,6,10,2009,6,1655,156.0,1403.0,1403.0,4,354,182.0,182.0,182.0
0.115,6,10,1506,5,395,26.0,127.0,127.0,5,1111,27.0,843.0,843.0
0.004,17,2,136,1,60,0.0,32.0,32.0,1,76,0.0,48.0,48.0
0.012,6,10,1983,5,910,3.0,642.0,642.0,5,1073,2.0,805.0,805.0
0.005,17,2,164,1,74,0.0,46.0,46.0,1,90,0.0,62.0,62.0
0.302,17,4,596,2,122,178.0,33.0,33.0,2,474,229.0,323.0,209.0
300.808,6,36,9735,19,4257,16711.0,3113.0,866.0,17,5478,540.0,2667.0,435.0
0.005,17,2,230,1,68,0.0,40.0,40.0,1,162,0.0,134.0,134.0
0.001,17,2,180,1,66,0.0,38.0,38.0,1,114,0.0,86.0,86.0
0.102,6,10,1506,5,395,18.0,127.0,127.0,5,1111,24.0,843.0,843.0
0.006,17,2,170,1,65,0.0,37.0,37.0,1,105,0.0,77.0,77.0
0.073,6,10,1506,5,395,17.0,127.0,127.0,5,1111,16.0,843.0,843.0
40.06,17,10,676,5,460,10014.0,104.0,64.0,5,216,10014.0,20.0,15.0
0.001,17,2,180,1,66,0.0,38.0,38.0,1,114,0.0,86.0,86.0
0.011,6,10,1972,5,910,2.0,642.0,642.0,5,1062,2.0,794.0,794.0
0.006,6,10,1854,5,889,1.0,621.0,621.0,5,965,1.0,697.0,697.0
0.026,6,10,1983,5,910,6.0,642.0,642.0,5,1073,6.0,805.0,805.0
0.001,17,2,180,1,66,0.0,38.0,38.0,1,114,0.0,86.0,86.0
0.016,6,10,1989,5,910,4.0,642.0,642.0,5,1079,4.0,811.0,811.0
0.018,6,10,1990,5,911,4.0,643.0,643.0,5,1079,4.0,811.0,811.0
40.072,17,10,676,5,460,10014.0,104.0,64.0,5,216,10017.0,20.0,15.0
0.012,6,10,1989,5,910,2.0,642.0,642.0,5,1079,3.0,811.0,811.0
0.017,6,13,3735,7,497,2.0,125.0,125.0,6,3238,3.0,1470.0,1459.0
0.004,6,10,1702,5,863,1.0,595.0,595.0,5,839,1.0,571.0,571.0
0.01,6,10,1631,5,848,2.0,580.0,580.0,5,783,2.0,515.0,515.0
0.003,17,4,284,2,120,0.0,32.0,32.0,2,164,0.0,60.0,54.0
0.01,17,2,179,1,71,0.0,43.0,43.0,1,108,0.0,80.0,80.0
0.005,6,10,2007,5,928,1.0,660.0,660.0,5,1079,1.0,811.0,811.0
0.005,6,10,1643,5,860,1.0,592.0,592.0,5,783,1.0,515.0,515.0
0.01,6,10,1762,5,911,2.0,643.0,643.0,5,851,2.0,583.0,583.0
0.001,17,2,180,1,66,0.0,38.0,38.0,1,114,0.0,86.0,86.0
10.832,17,28,4395,14,1995,824.0,270.0,114.0,14,2400,825.0,587.0,143.0
0.152,17,4,596,2,122,148.0,33.0,33.0,2,474,110.0,323.0,209.0
0.084,6,10,1506,5,395,16.0,127.0,127.0,5,1111,17.0,843.0,843.0
0.006,17,2,144,1,64,0.0,36.0,36.0,1,80,0.0,52.0,52.0
0.005,6,10,1779,5,928,1.0,660.0,660.0,5,851,1.0,583.0,583.0
0.006,6,10,1689,5,839,1.0,571.0,571.0,5,850,1.0,582.0,582.0
0.004,6,10,1702,5,863,0.0,595.0,595.0,5,839,1.0,571.0,571.0
0.07,6,10,1506,5,395,16.0,127.0,127.0,5,1111,15.0,843.0,843.0
0.004,6,10,1989,5,927,1.0,659.0,659.0,5,1062,1.0,794.0,794.0
0.006,6,10,1643,5,860,1.0,592.0,592.0,5,783,1.0,515.0,515.0
0.006,17,2,230,1,68,0.0,40.0,40.0,1,162,0.0,134.0,134.0
0.004,6,10,2007,5,928,1.0,660.0,660.0,5,1079,1.0,811.0,811.0
0.006,6,10,1989,5,927,1.0,659.0,659.0,5,1062,1.0,794.0,794.0
40.054,17,10,676,5,460,10012.0,104.0,64.0,5,216,10012.0,20.0,15.0
0.016,6,13,3735,7,497,2.0,125.0,125.0,6,3238,3.0,1470.0,1459.0
0.016,6,10,1762,5,911,4.0,643.0,643.0,5,851,3.0,583.0,583.0
0.004,6,10,2007,5,928,1.0,660.0,660.0,5,1079,1.0,811.0,811.0
0.119,6,10,1506,5,395,25.0,127.0,127.0,5,1111,25.0,843.0,843.0
0.117,17,2,194,1,59,0.0,31.0,31.0,1,135,0.0,107.0,107.0
0.169,17,2,152,1,76,0.0,48.0,48.0,1,76,0.0,48.0,48.0
0.005,17,2,144,1,64,0.0,36.0,36.0,1,80,0.0,52.0,52.0
0.067,17,8,3613,4,1874,22.0,1350.0,440.0,4,1739,11.0,1350.0,406.0
0.013,6,14,3787,7,497,2.0,125.0,125.0,7,3290,2.0,1448.0,972.0
0.021,6,10,1972,5,910,5.0,642.0,642.0,5,1062,5.0,794.0,794.0
0.088,6,10,1506,5,395,20.0,127.0,127.0,5,1111,21.0,843.0,843.0
0.017,6,10,1990,5,911,4.0,643.0,643.0,5,1079,4.0,811.0,811.0
66.918,6,39,12422,20,6864,464.0,2720.0,1005.0,19,5558,3708.0,2667.0,435.0
0.077,6,10,1506,5,395,15.0,127.0,127.0,5,1111,16.0,843.0,843.0
0.004,17,2,148,1,60,0.0,32.0,32.0,1,88,0.0,60.0,60.0
0.095,6,10,1506,5,395,21.0,127.0,127.0,5,1111,20.0,843.0,843.0
0.003,17,2,152,1,76,0.0,48.0,48.0,1,76,0.0,48.0,48.0
0.008,6,10,1990,5,911,2.0,643.0,643.0,5,1079,1.0,811.0,811.0
0.126,6,10,1506,5,395,29.0,127.0,127.0,5,1111,29.0,843.0,843.0
0.005,6,10,2007,5,928,1.0,660.0,660.0,5,1079,1.0,811.0,811.0
0.013,6,10,1990,5,911,3.0,643.0,643.0,5,1079,3.0,811.0,811.0
0.014,6,10,1983,5,910,3.0,642.0,642.0,5,1073,3.0,805.0,805.0
11.107,17,28,4423,14,1995,842.0,270.0,114.0,14,2428,842.0,587.0,145.0
0.018,6,10,1972,5,910,4.0,642.0,642.0,5,1062,4.0,794.0,794.0
0.005,17,2,214,1,75,0.0,47.0,47.0,1,139,0.0,111.0,111.0
0.005,6,10,2007,5,928,1.0,660.0,660.0,5,1079,1.0,811.0,811.0
240.091,6,16,4481,9,963,30011.0,238.0,166.0,7,3518,40014.0,1402.0,786.0
0.003,17,2,136,1,60,0.0,32.0,32.0,1,76,0.0,48.0,48.0
0.001,17,2,180,1,66,0.0,38.0,38.0,1,114,0.0,86.0,86.0
0.005,6,10,2006,5,927,1.0,659.0,659.0,5,1079,1.0,811.0,811.0
0.086,6,10,1506,5,395,20.0,127.0,127.0,5,1111,20.0,843.0,843.0
0.004,17,2,136,1,60,0.0,32.0,32.0,1,76,0.0,48.0,48.0
0.027,6,10,1677,5,827,6.0,559.0,559.0,5,850,6.0,582.0,582.0
0.005,6,10,2007,5,928,1.0,660.0,660.0,5,1079,1.0,811.0,811.0
0.005,6,10,1643,5,860,1.0,592.0,592.0,5,783,1.0,515.0,515.0
0.074,6,10,1506,5,395,17.0,127.0,127.0,5,1111,15.0,843.0,843.0
0.012,6,10,1983,5,910,3.0,642.0,642.0,5,1073,2.0,805.0,805.0
0.102,6,10,1506,5,395,15.0,127.0,127.0,5,1111,24.0,843.0,843.0
0.02,6,10,1983,5,910,5.0,642.0,642.0,5,1073,5.0,805.0,805.0
0.265,6,19,5996,10,1215,29.0,238.0,168.0,9,4781,32.0,1402.0,858.0
0.004,6,10,2007,5,928,1.0,660.0,660.0,5,1079,1.0,811.0,811.0
0.004,6,10,2007,5,928,1.0,660.0,660.0,5,1079,1.0,811.0,811.0
0.013,17,2,152,1,56,0.0,28.0,28.0,1,96,0.0,68.0,68.0
0.001,17,2,180,1,66,0.0,38.0,38.0,1,114,0.0,86.0,86.0
0.001,17,2,180,1,66,0.0,38.0,38.0,1,114,0.0,86.0,86.0
0.016,17,2,198,1,91,0.0,63.0,63.0,1,107,0.0,79.0,79.0
0.008,6,10,1983,5,910,1.0,642.0,642.0,5,1073,1.0,805.0,805.0
0.0,17,2,166,1,75,0.0,47.0,47.0,1,91,0.0,63.0,63.0
0.004,6,14,3742,8,504,0.0,80.0,80.0,6,3238,0.0,1470.0,1459.0
0.082,6,10,1506,5,395,18.0,127.0,127.0,5,1111,16.0,843.0,843.0
240.012,6,9,787,5,488,60003.0,232.0,232.0,4,299,80002.0,83.0,83.0
40.054,17,10,676,5,460,10012.0,104.0,64.0,5,216,10012.0,20.0,15.0
0.005,6,10,2006,5,927,1.0,659.0,659.0,5,1079,1.0,811.0,811.0
0.237,6,10,1506,5,395,57.0,127.0,127.0,5,1111,53.0,843.0,843.0
0.013,6,10,1983,5,910,3.0,642.0,642.0,5,1073,3.0,805.0,805.0
0.011,6,10,1972,5,910,2.0,642.0,642.0,5,1062,2.0,794.0,794.0
0.011,6,10,1989,5,910,2.0,642.0,642.0,5,1079,2.0,811.0,811.0
0.006,17,2,148,1,60,0.0,32.0,32.0,1,88,0.0,60.0,60.0
171.074,17,70,10105,35,2334,5031.0,44.0,38.0,35,7771,5031.0,239.0,194.0
0.005,6,10,1689,5,839,1.0,571.0,571.0,5,850,1.0,582.0,582.0
0.005,6,10,2006,5,927,1.0,659.0,659.0,5,1079,1.0,811.0,811.0
0.005,6,10,1989,5,927,1.0,659.0,659.0,5,1062,1.0,794.0,794.0
0.085,6,10,1506,5,395,15.0,127.0,127.0,5,1111,20.0,843.0,843.0
0.005,6,10,2006,5,927,1.0,659.0,659.0,5,1079,1.0,811.0,811.0
240.102,6,30,9490,15,7122,17150.0,2247.0,705.0,15,2368,17149.0,580.0,225.0
0.07,6,10,1506,5,395,16.0,127.0,127.0,5,1111,14.0,843.0,843.0
0.006,6,10,1989,5,927,1.0,659.0,659.0,5,1062,1.0,794.0,794.0
0.005,17,2,180,1,66,0.0,38.0,38.0,1,114,0.0,86.0,86.0
0.005,6,10,1689,5,839,1.0,571.0,571.0,5,850,1.0,582.0,582.0
0.272,17,39,20044,21,17034,13.0,1350.0,783.0,18,3010,12.0,1350.0,139.0
0.002,17,2,180,1,66,0.0,38.0,38.0,1,114,0.0,86.0,86.0
0.006,6,10,1547,5,764,1.0,496.0,496.0,5,783,1.0,515.0,515.0
0.005,6,10,1989,5,927,1.0,659.0,659.0,5,1062,1.0,794.0,794.0
293.995,6,321,344807,117,17644,2534.0,2736.0,889.0,204,327163,1448.0,2865.0,1666.0
0.005,6,10,2000,5,927,1.0,659.0,659.0,5,1073,1.0,805.0,805.0
0.004,17,2,136,1,60,0.0,32.0,32.0,1,76,0.0,48.0,48.0
0.02,6,10,1990,5,911,5.0,643.0,643.0,5,1079,5.0,811.0,811.0
0.005,17,2,178,1,65,0.0,37.0,37.0,1,113,0.0,85.0,85.0
0.004,6,10,2006,5,927,1.0,659.0,659.0,5,1079,1.0,811.0,811.0
0.005,6,10,2007,5,928,1.0,660.0,660.0,5,1079,1.0,811.0,811.0
0.009,6,10,1990,5,911,2.0,643.0,643.0,5,1079,2.0,811.0,811.0
0.007,6,10,2006,5,927,1.0,659.0,659.0,5,1079,1.0,811.0,811.0
0.143,6,10,1506,5,395,32.0,127.0,127.0,5,1111,28.0,843.0,843.0
0.005,6,10,1702,5,863,1.0,595.0,595.0,5,839,1.0,571.0,571.0
0.136,17,2,80,1,32,0.0,4.0,4.0,1,48,0.0,20.0,20.0
0.091,6,10,1506,5,395,19.0,127.0,127.0,5,1111,21.0,843.0,843.0
0.009,6,10,1762,5,911,2.0,643.0,643.0,5,851,2.0,583.0,583.0
61.581,6,45,16800,22,11033,426.0,2720.0,1263.0,23,5767,2791.0,2667.0,402.0
0.001,17,2,180,1,66,0.0,38.0,38.0,1,114,0.0,86.0,86.0
0.172,6,10,1506,5,395,40.0,127.0,127.0,5,1111,26.0,843.0,843.0
0.005,17,2,148,1,60,0.0,32.0,32.0,1,88,0.0,60.0,60.0
0.006,17,2,424,1,72,0.0,44.0,44.0,1,352,0.0,324.0,324.0
309.986,17,20,1124,10,716,34436.0,48.0,43.0,10,408,34436.0,20.0,12.0
0.004,6,10,2006,5,927,1.0,659.0,659.0,5,1079,1.0,811.0,811.0
0.105,6,10,1506,5,395,25.0,127.0,127.0,5,1111,25.0,843.0,843.0
0.006,6,10,1689,5,839,1.0,571.0,571.0,5,850,1.0,582.0,582.0
0.018,6,10,1989,5,910,4.0,642.0,642.0,5,1079,4.0,811.0,811.0
0.004,6,10,1774,5,923,1.0,655.0,655.0,5,851,0.0,583.0,583.0
0.006,6,10,1774,5,923,1.0,655.0,655.0,5,851,1.0,583.0,583.0
40.075,17,10,676,5,460,10016.0,104.0,64.0,5,216,10017.0,20.0,15.0
0.008,6,10,2007,5,928,2.0,660.0,660.0,5,1079,1.0,811.0,811.0
0.018,6,13,3735,7,497,3.0,125.0,125.0,6,3238,3.0,1470.0,1459.0
0.043,17,2,152,1,76,0.0,48.0,48.0,1,76,0.0,48.0,48.0
0.13,17,2,144,1,64,0.0,36.0,36.0,1,80,0.0,52.0,52.0
0.005,17,2,140,1,62,0.0,34.0,34.0,1,78,0.0,50.0,50.0
0.077,6,10,1506,5,395,17.0,127.0,127.0,5,1111,15.0,843.0,843.0
40.058,17,10,676,5,460,10012.0,104.0,64.0,5,216,10013.0,20.0,15.0
0.077,6,10,1506,5,395,18.0,127.0,127.0,5,1111,18.0,843.0,843.0
0.018,6,12,1926,6,1189,3.0,659.0,434.0,6,737,3.0,417.0,417.0
0.005,17,2,170,1,65,0.0,37.0,37.0,1,105,0.0,77.0,77.0
0.011,6,10,1989,5,910,2.0,642.0,642.0,5,1079,2.0,811.0,811.0
0.005,6,10,1779,5,928,1.0,660.0,660.0,5,851,1.0,583.0,583.0
0.005,6,10,1774,5,923,1.0,655.0,655.0,5,851,1.0,583.0,583.0
0.013,6,10,1779,5,928,3.0,660.0,660.0,5,851,3.0,583.0,583.0
0.021,6,10,1983,5,910,5.0,642.0,642.0,5,1073,5.0,805.0,805.0
0.022,6,10,1762,5,911,5.0,643.0,643.0,5,851,5.0,583.0,583.0
0.005,6,10,1854,5,889,1.0,621.0,621.0,5,965,1.0,697.0,697.0
240.012,6,9,787,5,488,60003.0,232.0,232.0,4,299,80002.0,83.0,83.0
0.073,6,10,1506,5,395,14.0,127.0,127.0,5,1111,17.0,843.0,843.0
0.045,17,2,412,1,61,0.0,33.0,33.0,1,351,0.0,323.0,323.0
240.676,6,37,9659,19,2176,13369.0,748.0,236.0,18,7483,14155.0,1402.0,595.0
0.004,6,10,1702,5,863,1.0,595.0,595.0,5,839,0.0,571.0,571.0
0.005,6,10,2006,5,927,1.0,659.0,659.0,5,1079,1.0,811.0,811.0
378.362,6,20,2210,6,1308,12003.0,494.0,494.0,14,902,29104.0,83.0,83.0
0.009,6,10,1989,5,910,2.0,642.0,642.0,5,1079,2.0,811.0,811.0
0.076,6,10,1506,5,395,17.0,127.0,127.0,5,1111,15.0,843.0,843.0
0.011,6,10,1983,5,910,2.0,642.0,642.0,5,1073,2.0,805.0,805.0
15.072,17,16,10616,9,8280,1880.0,1350.0,892.0,7,2336,2508.0,1350.0,305.0
0.006,6,10,1547,5,764,1.0,496.0,496.0,5,783,1.0,515.0,515.0
145.815,6,24,9399,11,1575,67.0,794.0,367.0,13,7824,12141.0,1360.0,810.0
15.083,17,16,9303,8,6912,2149.0,1350.0,836.0,8,2391,2150.0,1350.0,270.0
0.004,6,10,2006,5,927,1.0,659.0,659.0,5,1079,1.0,811.0,811.0
0.01,6,10,1972,5,910,2.0,642.0,642.0,5,1062,2.0,794.0,794.0
10.799,17,28,4422,14,1994,821.0,269.0,114.0,14,2428,822.0,587.0,145.0
0.093,6,10,1506,5,395,20.0,127.0,127.0,5,1111,21.0,843.0,843.0
0.004,17,4,284,2,120,0.0,32.0,32.0,2,164,0.0,60.0,54.0
0.041,17,2,152,1,76,0.0,48.0,48.0,1,76,0.0,48.0,48.0
0.006,17,2,136,1,60,0.0,32.0,32.0,1,76,0.0,48.0,48.0
0.005,6,10,1689,5,839,1.0,571.0,571.0,5,850,1.0,582.0,582.0
15.099,17,18,10724,9,8280,1883.0,1350.0,892.0,9,2444,1881.0,1350.0,243.0
0.014,6,10,1972,5,910,3.0,642.0,642.0,5,1062,3.0,794.0,794.0
66.066,6,22,8894,12,2328,6006.0,1002.0,424.0,10,6566,7322.0,2241.0,1006.0
0.041,17,4,284,2,120,1.0,32.0,32.0,2,164,37.0,60.0,54.0
0.001,17,2,166,1,75,0.0,47.0,47.0,1,91,0.0,63.0,63.0
0.005,6,10,2007,5,928,1.0,660.0,660.0,5,1079,1.0,811.0,811.0
0.01,6,10,1762,5,911,2.0,643.0,643.0,5,851,2.0,583.0,583.0
0.016,6,10,1983,5,910,4.0,642.0,642.0,5,1073,4.0,805.0,805.0
0.098,6,10,1506,5,395,23.0,127.0,127.0,5,1111,23.0,843.0,843.0
0.001,17,2,180,1,66,0.0,38.0,38.0,1,114,0.0,86.0,86.0
0.087,6,10,1506,5,395,18.0,127.0,127.0,5,1111,20.0,843.0,843.0
300.437,6,37,14546,21,2436,15021.0,662.0,334.0,16,12110,16024.0,1916.0,1024.0
0.01,6,10,1972,5,910,2.0,642.0,642.0,5,1062,2.0,794.0,794.0
40.065,17,10,676,5,460,10015.0,104.0,64.0,5,216,10015.0,20.0,15.0
0.005,6,10,1854,5,889,1.0,621.0,621.0,5,965,1.0,697.0,697.0
0.005,6,10,2006,5,927,1.0,659.0,659.0,5,1079,1.0,811.0,811.0
26.191,6,51,22918,26,16891,369.0,2720.0,1438.0,25,6027,1084.0,2667.0,385.0
0.107,6,10,1506,5,395,23.0,127.0,127.0,5,1111,25.0,843.0,843.0
0.121,6,10,1506,5,395,28.0,127.0,127.0,5,1111,28.0,843.0,843.0
0.006,17,2,179,1,71,0.0,43.0,43.0,1,108,0.0,80.0,80.0
0.005,6,14,3799,7,509,0.0,137.0,137.0,7,3290,0.0,1448.0,972.0
371.474,6,22,2313,16,867,24764.0,195.0,195.0,6,1446,4644.0,419.0,398.0
240.264,6,43,5415,22,2542,11441.0,588.0,196.0,21,2873,12013.0,580.0,221.0
240.089,6,16,4480,9,963,30011.0,238.0,166.0,7,3517,40014.0,1402.0,786.0
0.005,6,10,2007,5,928,1.0,660.0,660.0,5,1079,1.0,811.0,811.0
0.005,17,2,170,1,65,0.0,37.0,37.0,1,105,0.0,77.0,77.0
0.014,6,14,3787,7,497,2.0,125.0,125.0,7,3290,2.0,1448.0,972.0
0.005,6,10,2006,5,927,1.0,659.0,659.0,5,1079,1.0,811.0,811.0
0.072,6,10,1506,5,395,15.0,127.0,127.0,5,1111,16.0,843.0,843.0
0.013,6,10,1990,5,911,3.0,643.0,643.0,5,1079,3.0,811.0,811.0
0.004,17,2,136,1,60,0.0,32.0,32.0,1,76,0.0,48.0,48.0
0.02,6,10,1972,5,910,4.0,642.0,642.0,5,1062,5.0,794.0,794.0
0.01,6,12,1926,6,1189,2.0,659.0,434.0,6,737,2.0,417.0,417.0
0.001,17,2,154,1,69,0.0,41.0,41.0,1,85,0.0,57.0,57.0
0.092,6,10,1506,5,395,20.0,127.0,127.0,5,1111,22.0,843.0,843.0
0.122,6,10,1506,5,395,26.0,127.0,127.0,5,1111,28.0,843.0,843.0
0.008,6,10,1779,5,928,2.0,660.0,660.0,5,851,1.0,583.0,583.0
0.01,17,2,194,1,59,0.0,31.0,31.0,1,135,0.0,107.0,107.0
0.119,6,10,1506,5,395,29.0,127.0,127.0,5,1111,26.0,843.0,843.0
1792.504,6,493,99745,248,88355,7256.0,421.0,364.0,245,11390,7345.0,53.0,53.0
10.896,17,28,4418,14,1993,829.0,268.0,114.0,14,2425,830.0,588.0,145.0
0.089,6,10,1506,5,395,20.0,127.0,127.0,5,1111,16.0,843.0,843.0
0.005,6,10,1989,5,927,1.0,659.0,659.0,5,1062,1.0,794.0,794.0
0.004,17,2,136,1,60,0.0,32.0,32.0,1,76,0.0,48.0,48.0
1770.309,6,83,4368,42,2210,43177.0,26.0,26.0,41,2158,44256.0,26.0,26.0
0.009,6,12,1926,6,1189,1.0,659.0,434.0,6,737,1.0,417.0,417.0
0.113,6,10,1506,5,395,25.0,127.0,127.0,5,1111,25.0,843.0,843.0
0.015,6,10,1989,5,910,3.0,642.0,642.0,5,1079,3.0,811.0,811.0
0.112,6,10,1506,5,395,24.0,127.0,127.0,5,1111,24.0,843.0,843.0
0.02,6,10,1990,5,911,4.0,643.0,643.0,5,1079,5.0,811.0,811.0
264.896,17,18,1008,9,640,33095.0,48.0,43.0,9,368,33095.0,20.0,12.0
0.012,6,10,1989,5,910,2.0,642.0,642.0,5,1079,2.0,811.0,811.0
0.004,6,10,1774,5,923,1.0,655.0,655.0,5,851,0.0,583.0,583.0
0.004,6,10,2006,5,927,1.0,659.0,659.0,5,1079,1.0,811.0,811.0
0.005,6,10,2007,5,928,1.0,660.0,660.0,5,1079,1.0,811.0,811.0
0.006,6,10,2006,5,927,1.0,659.0,659.0,5,1079,1.0,811.0,811.0
0.012,6,10,1989,5,910,3.0,642.0,642.0,5,1079,3.0,811.0,811.0
0.014,6,10,1631,5,848,3.0,580.0,580.0,5,783,3.0,515.0,515.0
0.005,17,2,140,1,62,0.0,34.0,34.0,1,78,0.0,50.0,50.0
0.012,6,14,3787,7,497,1.0,125.0,125.0,7,3290,2.0,1448.0,972.0
0.005,6,10,2000,5,927,1.0,659.0,659.0,5,1073,1.0,805.0,805.0
0.005,6,10,1702,5,863,1.0,595.0,595.0,5,839,1.0,571.0,571.0
0.001,17,2,180,1,66,0.0,38.0,38.0,1,114,0.0,86.0,86.0
0.004,6,10,1702,5,863,0.0,595.0,595.0,5,839,1.0,571.0,571.0
0.119,6,10,1506,5,395,25.0,127.0,127.0,5,1111,23.0,843.0,843.0
0.139,6,10,1506,5,395,33.0,127.0,127.0,5,1111,31.0,843.0,843.0
0.014,6,10,1990,5,911,3.0,643.0,643.0,5,1079,3.0,811.0,811.0
1770.638,17,92,8096,46,4048,39347.0,60.0,60.0,46,4048,39347.0,60.0,60.0
0.006,6,10,1547,5,764,1.0,496.0,496.0,5,783,1.0,515.0,515.0
0.01,6,10,1972,5,910,2.0,642.0,642.0,5,1062,2.0,794.0,794.0
0.024,6,10,1990,5,911,6.0,643.0,643.0,5,1079,6.0,811.0,811.0
0.005,17,2,179,1,71,0.0,43.0,43.0,1,108,0.0,80.0,80.0
40.067,17,10,676,5,460,10013.0,104.0,64.0,5,216,10016.0,20.0,15.0
0.012,6,10,1762,5,911,3.0,643.0,643.0,5,851,2.0,583.0,583.0
0.039,17,4,284,2,120,0.0,32.0,32.0,2,164,35.0,60.0,54.0
0.006,6,14,3799,7,509,0.0,137.0,137.0,7,3290,0.0,1448.0,972.0
0.005,6,10,2000,5,927,1.0,659.0,659.0,5,1073,1.0,805.0,805.0
0.001,17,2,180,1,66,0.0,38.0,38.0,1,114,0.0,86.0,86.0
0.008,6,13,3735,7,497,1.0,125.0,125.0,6,3238,1.0,1470.0,1459.0
0.089,6,10,1506,5,395,17.0,127.0,127.0,5,1111,19.0,843.0,843.0
0.016,6,10,1972,5,910,4.0,642.0,642.0,5,1062,3.0,794.0,794.0
240.284,6,43,5363,22,2541,11441.0,588.0,196.0,21,2822,12014.0,580.0,191.0
0.003,17,2,136,1,60,0.0,32.0,32.0,1,76,0.0,48.0,48.0
0.13,17,2,182,1,65,0.0,37.0,37.0,1,117,0.0,89.0,89.0
0.017,6,10,1989,5,910,4.0,642.0,642.0,5,1079,4.0,811.0,811.0
11.553,17,28,4398,14,2311,876.0,586.0,137.0,14,2087,876.0,270.0,121.0
308.471,17,20,1124,10,716,34260.0,48.0,43.0,10,408,34260.0,20.0,12.0
0.005,6,10,1774,5,923,1.0,655.0,655.0,5,851,1.0,583.0,583.0
0.005,17,2,170,1,65,0.0,37.0,37.0,1,105,0.0,77.0,77.0
0.005,6,10,1989,5,927,1.0,659.0,659.0,5,1062,1.0,794.0,794.0
0.004,17,2,136,1,60,0.0,32.0,32.0,1,76,0.0,48.0,48.0
0.004,17,2,148,1,60,0.0,32.0,32.0,1,88,0.0,60.0,60.0
0.013,6,10,1990,5,911,3.0,643.0,643.0,5,1079,3.0,811.0,811.0
240.107,6,30,9364,15,6906,17150.0,2031.0,681.0,15,2458,17150.0,580.0,238.0
0.005,17,2,146,1,65,0.0,37.0,37.0,1,81,0.0,53.0,53.0
0.006,6,10,1547,5,764,1.0,496.0,496.0,5,783,1.0,515.0,515.0
0.005,6,10,2007,5,928,1.0,660.0,660.0,5,1079,1.0,811.0,811.0
10.78,17,28,4422,14,1993,820.0,268.0,114.0,14,2429,820.0,588.0,145.0
0.006,6,10,1689,5,839,1.0,571.0,571.0,5,850,1.0,582.0,582.0
0.016,6,10,1989,5,910,4.0,642.0,642.0,5,1079,3.0,811.0,811.0
0.168,17,2,152,1,76,0.0,48.0,48.0,1,76,0.0,48.0,48.0
0.008,6,10,1989,5,910,2.0,642.0,642.0,5,1079,1.0,811.0,811.0
354.019,6,21,1795,16,1030,23601.0,190.0,190.0,5,765,60002.0,464.0,248.0
2.845,6,26,6127,14,2100,218.0,517.0,303.0,12,4027,243.0,1330.0,589.0
0.04,17,2,156,1,64,0.0,36.0,36.0,1,92,0.0,64.0,64.0
40.07,17,10,676,5,460,10016.0,104.0,64.0,5,216,10016.0,20.0,15.0
0.012,6,10,1983,5,910,3.0,642.0,642.0,5,1073,2.0,805.0,805.0
0.012,6,10,1972,5,910,2.0,642.0,642.0,5,1062,3.0,794.0,794.0
0.006,6,10,1989,5,927,1.0,659.0,659.0,5,1062,1.0,794.0,794.0
0.005,6,14,3736,7,446,0.0,74.0,74.0,7,3290,0.0,1448.0,972.0
0.074,6,10,1506,5,395,16.0,127.0,127.0,5,1111,17.0,843.0,843.0
0.009,6,10,2000,5,927,2.0,659.0,659.0,5,1073,2.0,805.0,805.0
0.005,6,10,2006,5,927,1.0,659.0,659.0,5,1079,1.0,811.0,811.0
0.012,6,10,1972,5,910,2.0,642.0,642.0,5,1062,2.0,794.0,794.0
0.076,6,10,1506,5,395,15.0,127.0,127.0,5,1111,17.0,843.0,843.0
0.008,6,10,1677,5,827,2.0,559.0,559.0,5,850,2.0,582.0,582.0
0.003,17,2,152,1,76,0.0,48.0,48.0,1,76,0.0,48.0,48.0
0.014,6,10,1989,5,910,3.0,642.0,642.0,5,1079,3.0,811.0,811.0
0.006,6,10,1547,5,764,1.0,496.0,496.0,5,783,1.0,515.0,515.0
40.066,17,10,676,5,460,10015.0,104.0,64.0,5,216,10015.0,20.0,15.0
10.926,17,28,4390,14,2312,832.0,587.0,137.0,14,2078,832.0,269.0,120.0
0.17,6,3,453,2,321,170.0,241.0,241.0,1,132,0.0,92.0,92.0
0.005,6,10,2006,5,927,1.0,659.0,659.0,5,1079,1.0,811.0,811.0
0.012,6,10,1989,5,910,3.0,642.0,642.0,5,1079,3.0,811.0,811.0
0.103,6,10,1506,5,395,20.0,127.0,127.0,5,1111,22.0,843.0,843.0
177.057,17,80,11262,40,2668,4539.0,44.0,38.0,40,8594,4539.0,252.0,186.0
166.388,17,80,11340,40,2664,4266.0,44.0,38.0,40,8676,4266.0,261.0,188.0
0.104,6,10,1506,5,395,22.0,127.0,127.0,5,1111,21.0,843.0,843.0
0.013,6,10,1972,5,910,3.0,642.0,642.0,5,1062,3.0,794.0,794.0
0.01,6,13,3735,7,497,1.0,125.0,125.0,6,3238,2.0,1470.0,1459.0
40.353,6,46,19104,23,13386,409.0,2720.0,1381.0,23,5718,1826.0,2667.0,435.0
0.009,6,10,1972,5,910,2.0,642.0,642.0,5,1062,2.0,794.0,794.0
0.005,6,10,2006,5,927,1.0,659.0,659.0,5,1079,1.0,811.0,811.0
66.389,6,30,18795,14,10514,5106.0,2804.0,1631.0,16,8281,4417.0,2320.0,744.0
0.148,6,10,1506,5,395,34.0,127.0,127.0,5,1111,33.0,843.0,843.0
263.239,6,35,11045,19,3400,14624.0,676.0,400.0,16,7645,17549.0,1409.0,757.0
10.895,17,28,4418,14,1993,829.0,268.0,114.0,14,2425,829.0,588.0,145.0
0.005,6,13,3690,7,452,0.0,80.0,80.0,6,3238,1.0,1470.0,1459.0
0.004,17,2,136,1,60,0.0,32.0,32.0,1,76,0.0,48.0,48.0
0.005,6,10,1989,5,927,1.0,659.0,659.0,5,1062,1.0,794.0,794.0
1799.999,6,137,6590,76,3625,23996.0,39.0,39.0,61,2965,29996.0,35.0,35.0
308.945,17,20,1124,10,716,34312.0,48.0,43.0,10,408,34313.0,20.0,12.0
0.016,17,2,198,1,91,0.0,63.0,63.0,1,107,0.0,79.0,79.0
0.095,6,10,1506,5,395,19.0,127.0,127.0,5,1111,20.0,843.0,843.0
0.013,6,10,1990,5,911,3.0,643.0,643.0,5,1079,3.0,811.0,811.0
0.004,6,10,2006,5,927,1.0,659.0,659.0,5,1079,1.0,811.0,811.0
0.005,17,2,136,1,60,0.0,32.0,32.0,1,76,0.0,48.0,48.0
0.008,6,10,1989,5,910,2.0,642.0,642.0,5,1079,2.0,811.0,811.0
0.01,6,10,1972,5,910,2.0,642.0,642.0,5,1062,2.0,794.0,794.0
0.011,6,10,1972,5,910,2.0,642.0,642.0,5,1062,2.0,794.0,794.0
0.126,6,10,1506,5,395,25.0,127.0,127.0,5,1111,27.0,843.0,843.0
0.005,6,10,2007,5,928,1.0,660.0,660.0,5,1079,1.0,811.0,811.0
0.006,6,10,1547,5,764,1.0,496.0,496.0,5,783,1.0,515.0,515.0
40.083,17,10,676,5,460,10017.0,104.0,64.0,5,216,10019.0,20.0,15.0
10.87,17,28,4421,14,1993,828.0,268.0,114.0,14,2428,828.0,587.0,145.0
0.085,6,10,1506,5,395,17.0,127.0,127.0,5,1111,17.0,843.0,843.0
40.06,17,10,676,5,460,10013.0,104.0,64.0,5,216,10014.0,20.0,15.0
11.167,17,28,4420,14,1993,846.0,268.0,114.0,14,2427,846.0,586.0,145.0
0.134,6,10,1506,5,395,28.0,127.0,127.0,5,1111,26.0,843.0,843.0
169.284,17,72,10167,36,2405,4836.0,44.0,38.0,36,7762,4836.0,260.0,187.0
0.085,6,10,1506,5,395,20.0,127.0,127.0,5,1111,17.0,843.0,843.0
0.019,6,9,1214,5,775,4.0,519.0,519.0,4,439,4.0,223.0,223.0
0.006,6,10,2000,5,927,1.0,659.0,659.0,5,1073,1.0,805.0,805.0
0.014,6,10,1972,5,910,3.0,642.0,642.0,5,1062,3.0,794.0,794.0
40.022,17,10,676,5,460,10004.0,104.0,64.0,5,216,10004.0,20.0,15.0
0.013,6,10,1989,5,910,3.0,642.0,642.0,5,1079,3.0,811.0,811.0
0.017,6,10,1990,5,911,4.0,643.0,643.0,5,1079,4.0,811.0,811.0
0.079,6,10,1506,5,395,17.0,127.0,127.0,5,1111,17.0,843.0,843.0
0.011,17,2,148,1,60,0.0,32.0,32.0,1,88,0.0,60.0,60.0
0.001,17,2,180,1,66,0.0,38.0,38.0,1,114,0.0,86.0,86.0
351.984,6,20,2210,6,1308,12003.0,494.0,494.0,14,902,27075.0,83.0,83.0
0.017,6,10,1990,5,911,4.0,643.0,643.0,5,1079,4.0,811.0,811.0
0.005,6,10,2006,5,927,1.0,659.0,659.0,5,1079,1.0,811.0,811.0
0.003,17,2,148,1,60,0.0,32.0,32.0,1,88,0.0,60.0,60.0
0.005,17,2,214,1,75,0.0,47.0,47.0,1,139,0.0,111.0,111.0
0.013,6,10,1762,5,911,3.0,643.0,643.0,5,851,3.0,583.0,583.0
0.011,6,10,1631,5,848,2.0,580.0,580.0,5,783,2.0,515.0,515.0
0.006,6,10,1547,5,764,1.0,496.0,496.0,5,783,1.0,515.0,515.0
0.001,17,2,136,1,60,0.0,32.0,32.0,1,76,0.0,48.0,48.0
0.005,6,10,2006,5,927,1.0,659.0,659.0,5,1079,1.0,811.0,811.0
0.005,6,10,2006,5,927,1.0,659.0,659.0,5,1079,1.0,811.0,811.0
0.005,17,2,136,1,60,0.0,32.0,32.0,1,76,0.0,48.0,48.0
0.003,17,4,284,2,120,0.0,32.0,32.0,2,164,0.0,60.0,54.0
0.006,6,10,1547,5,764,1.0,496.0,496.0,5,783,1.0,515.0,515.0
0.006,6,10,1854,5,889,1.0,621.0,621.0,5,965,1.0,697.0,697.0
0.005,6,14,3742,8,504,0.0,80.0,80.0,6,3238,0.0,1470.0,1459.0
312.191,17,20,1124,10,716,34674.0,48.0,43.0,10,408,34675.0,20.0,12.0
0.005,6,10,2006,5,927,1.0,659.0,659.0,5,1079,1.0,811.0,811.0
0.009,6,10,1972,5,910,2.0,642.0,642.0,5,1062,2.0,794.0,794.0
0.012,6,10,1989,5,910,3.0,642.0,642.0,5,1079,3.0,811.0,811.0
0.009,6,10,1989,5,910,2.0,642.0,642.0,5,1079,2.0,811.0,811.0
0.09,6,10,1506,5,395,18.0,127.0,127.0,5,1111,21.0,843.0,843.0
0.005,17,2,170,1,65,0.0,37.0,37.0,1,105,0.0,77.0,77.0
0.005,6,10,1989,5,927,1.0,659.0,659.0,5,1062,1.0,794.0,794.0
0.215,17,4,352,2,130,144.0,37.0,37.0,2,222,174.0,89.0,83.0
309.192,17,17,968,9,640,38632.0,48.0,43.0,8,328,44151.0,20.0,13.0
0.005,6,10,1989,5,927,1.0,659.0,659.0,5,1062,1.0,794.0,794.0
361.81,6,21,1792,16,1030,24120.0,190.0,190.0,5,762,60009.0,461.0,247.0
0.001,17,2,136,1,60,0.0,32.0,32.0,1,76,0.0,48.0,48.0
0.012,6,10,1972,5,910,3.0,642.0,642.0,5,1062,3.0,794.0,794.0
0.107,6,10,1506,5,395,26.0,127.0,127.0,5,1111,23.0,843.0,843.0
168.395,17,70,10082,35,2332,4952.0,44.0,38.0,35,7750,4952.0,260.0,193.0
0.095,6,10,1506,5,395,20.0,127.0,127.0,5,1111,23.0,843.0,843.0
0.009,6,12,1926,6,1189,1.0,659.0,434.0,6,737,1.0,417.0,417.0
0.066,6,10,1506,5,395,15.0,127.0,127.0,5,1111,15.0,843.0,843.0
0.006,6,10,1689,5,839,1.0,571.0,571.0,5,850,1.0,582.0,582.0
0.086,6,10,1506,5,395,18.0,127.0,127.0,5,1111,20.0,843.0,843.0
420.806,6,40,15990,22,2955,20038.0,661.0,360.0,18,13035,21223.0,1938.0,1007.0
0.004,6,10,1779,5,928,1.0,660.0,660.0,5,851,1.0,583.0,583.0
15.076,17,15,9238,8,6902,2149.0,1350.0,834.0,7,2336,2506.0,1350.0,305.0
0.005,6,10,2000,5,927,1.0,659.0,659.0,5,1073,1.0,805.0,805.0
0.005,6,10,2006,5,927,1.0,659.0,659.0,5,1079,1.0,811.0,811.0
0.081,6,10,1506,5,395,18.0,127.0,127.0,5,1111,17.0,843.0,843.0
0.008,6,10,1990,5,911,2.0,643.0,643.0,5,1079,1.0,811.0,811.0
0.129,17,2,184,1,61,0.0,33.0,33.0,1,123,0.0,95.0,95.0
240.306,6,34,8689,18,1888,14135.0,569.0,188.0,16,6801,16020.0,1402.0,597.0
0.005,17,2,169,1,62,0.0,34.0,34.0,1,107,0.0,79.0,79.0
0.09,6,10,1506,5,395,20.0,127.0,127.0,5,1111,18.0,843.0,843.0
0.008,6,10,1983,5,910,2.0,642.0,642.0,5,1073,1.0,805.0,805.0
0.005,6,10,2006,5,927,1.0,659.0,659.0,5,1079,1.0,811.0,811.0
40.058,17,10,676,5,460,10013.0,104.0,64.0,5,216,10013.0,20.0,15.0
0.18,6,3,453,2,321,180.0,241.0,241.0,1,132,0.0,92.0,92.0
241.89,6,352,345323,137,18707,1778.0,2736.0,959.0,215,326616,1130.0,2804.0,1569.0
241.422,6,362,345683,181,20931,1341.0,2736.0,959.0,181,324752,1341.0,2804.0,1844.0
0.007,17,2,148,1,60,0.0,32.0,32.0,1,88,0.0,60.0,60.0
0.103,6,10,1506,5,395,22.0,127.0,127.0,5,1111,21.0,843.0,843.0
0.003,17,4,284,2,120,0.0,32.0,32.0,2,164,0.0,60.0,54.0
0.005,6,10,2000,5,927,1.0,659.0,659.0,5,1073,1.0,805.0,805.0
0.01,6,10,1989,5,910,2.0,642.0,642.0,5,1079,2.0,811.0,811.0
0.005,6,10,1774,5,923,1.0,655.0,655.0,5,851,1.0,583.0,583.0
0.043,17,4,284,2,120,39.0,32.0,32.0,2,164,6.0,60.0,54.0
40.059,17,10,676,5,460,10014.0,104.0,64.0,5,216,10014.0,20.0,15.0
0.015,6,10,1972,5,910,3.0,642.0,642.0,5,1062,3.0,794.0,794.0
0.016,6,10,1972,5,910,4.0,642.0,642.0,5,1062,3.0,794.0,794.0
0.007,6,10,1547,5,764,1.0,496.0,496.0,5,783,1.0,515.0,515.0
0.001,17,2,180,1,66,0.0,38.0,38.0,1,114,0.0,86.0,86.0
0.093,6,10,1506,5,395,19.0,127.0,127.0,5,1111,19.0,843.0,843.0
0.009,6,10,1972,5,910,2.0,642.0,642.0,5,1062,2.0,794.0,794.0
0.174,17,2,152,1,76,0.0,48.0,48.0,1,76,0.0,48.0,48.0
0.006,6,10,1547,5,764,1.0,496.0,496.0,5,783,1.0,515.0,515.0
368.766,6,22,2313,16,867,24584.0,195.0,195.0,6,1446,4646.0,419.0,398.0
0.004,6,10,1989,5,927,1.0,659.0,659.0,5,1062,1.0,794.0,794.0
0.005,17,2,170,1,65,0.0,37.0,37.0,1,105,0.0,77.0,77.0
0.005,17,2,187,1,71,0.0,43.0,43.0,1,116,0.0,88.0,88.0
0.004,6,10,2007,5,928,1.0,660.0,660.0,5,1079,1.0,811.0,811.0
0.005,17,2,170,1,65,0.0,37.0,37.0,1,105,0.0,77.0,77.0
0.005,17,2,170,1,65,0.0,37.0,37.0,1,105,0.0,77.0,77.0
240.088,6,16,4481,9,963,30011.0,238.0,166.0,7,3518,40014.0,1402.0,786.0
0.011,6,10,1989,5,910,2.0,642.0,642.0,5,1079,2.0,811.0,811.0
0.012,6,10,1989,5,910,3.0,642.0,642.0,5,1079,3.0,811.0,811.0
0.077,6,10,1506,5,395,15.0,127.0,127.0,5,1111,17.0,843.0,843.0
15.078,17,15,8402,8,6342,2150.0,1350.0,764.0,7,2060,2508.0,1350.0,266.0
0.004,6,10,2006,5,927,1.0,659.0,659.0,5,1079,1.0,811.0,811.0
0.005,6,10,1643,5,860,1.0,592.0,592.0,5,783,1.0,515.0,515.0
0.081,6,10,1506,5,395,19.0,127.0,127.0,5,1111,17.0,843.0,843.0
0.004,17,2,148,1,60,0.0,32.0,32.0,1,88,0.0,60.0,60.0
0.012,6,10,1972,5,910,3.0,642.0,642.0,5,1062,3.0,794.0,794.0
0.075,6,10,1506,5,395,17.0,127.0,127.0,5,1111,14.0,843.0,843.0
0.116,17,2,80,1,32,0.0,4.0,4.0,1,48,0.0,20.0,20.0
0.004,6,10,1989,5,927,1.0,659.0,659.0,5,1062,1.0,794.0,794.0
0.005,6,10,1989,5,927,1.0,659.0,659.0,5,1062,1.0,794.0,794.0
0.006,6,10,2007,5,928,1.0,660.0,660.0,5,1079,1.0,811.0,811.0
0.06,17,2,152,1,76,0.0,48.0,48.0,1,76,0.0,48.0,48.0
300.089,6,19,4659,11,1102,30008.0,238.0,130.0,8,3557,42869.0,1402.0,786.0
0.009,6,10,1983,5,910,2.0,642.0,642.0,5,1073,2.0,805.0,805.0
10.796,17,28,4416,14,1993,822.0,268.0,114.0,14,2423,822.0,586.0,145.0
0.005,6,10,2006,5,927,1.0,659.0,659.0,5,1079,1.0,811.0,811.0
0.005,6,10,2006,5,927,1.0,659.0,659.0,5,1079,1.0,811.0,811.0
0.005,6,10,2006,5,927,1.0,659.0,659.0,5,1079,1.0,811.0,811.0
244.715,6,370,201210,175,185457,1406.0,3895.0,1296.0,195,15753,1261.0,580.0,112.0
0.025,6,10,1762,5,911,6.0,643.0,643.0,5,851,6.0,583.0,583.0
0.008,6,12,1926,6,1189,1.0,659.0,434.0,6,737,1.0,417.0,417.0
0.009,6,10,1762,5,911,2.0,643.0,643.0,5,851,2.0,583.0,583.0
0.013,6,10,1631,5,848,3.0,580.0,580.0,5,783,3.0,515.0,515.0
0.012,6,10,1631,5,848,3.0,580.0,580.0,5,783,3.0,515.0,515.0
0.071,6,10,1506,5,395,17.0,127.0,127.0,5,1111,15.0,843.0,843.0
0.04,17,2,144,1,64,0.0,36.0,36.0,1,80,0.0,52.0,52.0
0.012,6,10,1990,5,911,2.0,643.0,643.0,5,1079,2.0,811.0,811.0
300.328,6,16,2170,9,684,37519.0,146.0,146.0,7,1486,50025.0,419.0,398.0
300.028,6,12,1782,7,1348,50004.0,494.0,494.0,5,434,75005.0,83.0,83.0
0.005,6,10,2006,5,927,1.0,659.0,659.0,5,1079,1.0,811.0,811.0
0.042,17,4,284,2,120,0.0,32.0,32.0,2,164,38.0,60.0,54.0
0.005,6,10,2006,5,927,1.0,659.0,659.0,5,1079,1.0,811.0,811.0
0.016,6,10,1983,5,910,3.0,642.0,642.0,5,1073,3.0,805.0,805.0
0.006,6,10,1989,5,927,1.0,659.0,659.0,5,1062,1.0,794.0,794.0
0.101,17,2,80,1,32,0.0,4.0,4.0,1,48,0.0,20.0,20.0
0.12,6,10,1506,5,395,27.0,127.0,127.0,5,1111,27.0,843.0,843.0
308.386,17,20,1124,10,716,34251.0,48.0,43.0,10,408,34251.0,20.0,12.0
171.055,17,88,12740,44,2962,3977.0,44.0,39.0,44,9778,3977.0,239.0,194.0
0.008,6,10,1989,5,910,2.0,642.0,642.0,5,1079,1.0,811.0,811.0
0.104,6,10,1506,5,395,24.0,127.0,127.0,5,1111,22.0,843.0,843.0
0.133,6,10,1506,5,395,30.0,127.0,127.0,5,1111,30.0,843.0,843.0
0.006,6,10,1547,5,764,1.0,496.0,496.0,5,783,1.0,515.0,515.0
0.005,6,14,3799,7,509,0.0,137.0,137.0,7,3290,0.0,1448.0,972.0
0.005,6,10,2006,5,927,1.0,659.0,659.0,5,1079,1.0,811.0,811.0
0.073,6,10,1506,5,395,16.0,127.0,127.0,5,1111,14.0,843.0,843.0
0.009,6,10,1972,5,910,2.0,642.0,642.0,5,1062,2.0,794.0,794.0
0.011,6,10,1990,5,911,2.0,643.0,643.0,5,1079,2.0,811.0,811.0
0.072,6,10,1506,5,395,17.0,127.0,127.0,5,1111,15.0,843.0,843.0
0.012,6,10,1989,5,910,2.0,642.0,642.0,5,1079,2.0,811.0,811.0
0.005,17,4,495,2,132,0.0,38.0,38.0,2,363,1.0,176.0,153.0
0.005,6,10,1989,5,927,1.0,659.0,659.0,5,1062,1.0,794.0,794.0
0.02,6,10,1989,5,910,5.0,642.0,642.0,5,1079,5.0,811.0,811.0
240.023,6,9,787,5,488,60005.0,232.0,232.0,4,299,80002.0,83.0,83.0
0.088,6,10,1506,5,395,15.0,127.0,127.0,5,1111,19.0,843.0,843.0
0.005,6,10,1689,5,839,1.0,571.0,571.0,5,850,1.0,582.0,582.0
0.001,17,2,180,1,66,0.0,38.0,38.0,1,114,0.0,86.0,86.0
0.009,6,10,1990,5,911,2.0,643.0,643.0,5,1079,2.0,811.0,811.0
0.104,17,2,80,1,32,0.0,4.0,4.0,1,48,0.0,20.0,20.0
0.012,6,10,1677,5,827,2.0,559.0,559.0,5,850,2.0,582.0,582.0
1729.236,6,60,4400,40,2740,44339.0,33.0,33.0,20,1660,91003.0,31.0,31.0
0.001,17,2,164,1,74,0.0,46.0,46.0,1,90,0.0,62.0,62.0
15.07,17,14,9190,8,6902,2148.0,1350.0,834.0,6,2288,3008.0,1350.0,353.0
0.005,6,10,2000,5,927,1.0,659.0,659.0,5,1073,1.0,805.0,805.0
0.01,6,10,1989,5,910,2.0,642.0,642.0,5,1079,2.0,811.0,811.0
0.005,17,2,164,1,74,0.0,46.0,46.0,1,90,0.0,62.0,62.0
0.011,6,10,1972,5,910,2.0,642.0,642.0,5,1062,2.0,794.0,794.0
0.017,6,10,1972,5,910,4.0,642.0,642.0,5,1062,4.0,794.0,794.0
0.008,17,2,194,1,59,0.0,31.0,31.0,1,135,0.0,107.0,107.0
40.068,17,10,676,5,460,10014.0,104.0,64.0,5,216,10016.0,20.0,15.0
0.068,6,10,1506,5,395,15.0,127.0,127.0,5,1111,12.0,843.0,843.0
367.174,6,22,2313,16,867,24478.0,195.0,195.0,6,1446,4646.0,419.0,398.0
0.005,6,10,1989,5,927,1.0,659.0,659.0,5,1062,1.0,794.0,794.0
0.012,6,10,1983,5,910,3.0,642.0,642.0,5,1073,2.0,805.0,805.0
11.083,17,28,4419,14,1995,840.0,270.0,114.0,14,2424,840.0,587.0,145.0
240.07,6,20,4873,10,889,26674.0,180.0,93.0,10,3984,26674.0,1592.0,576.0
1799.993,6,138,6704,77,3704,23684.0,39.0,39.0,61,3000,29995.0,35.0,35.0
0.008,6,10,1983,5,910,2.0,642.0,642.0,5,1073,2.0,805.0,805.0
0.005,6,10,1643,5,860,1.0,592.0,592.0,5,783,1.0,515.0,515.0
0.009,6,10,1983,5,910,2.0,642.0,642.0,5,1073,2.0,805.0,805.0
0.005,17,2,230,1,68,0.0,40.0,40.0,1,162,0.0,134.0,134.0
0.006,6,10,1547,5,764,1.0,496.0,496.0,5,783,1.0,515.0,515.0
0.009,6,10,1989,5,910,2.0,642.0,642.0,5,1079,2.0,811.0,811.0
0.013,6,10,1972,5,910,3.0,642.0,642.0,5,1062,3.0,794.0,794.0
0.011,6,10,1989,5,927,2.0,659.0,659.0,5,1062,2.0,794.0,794.0
0.001,17,2,178,1,81,0.0,53.0,53.0,1,97,0.0,69.0,69.0
0.005,6,10,2006,5,927,1.0,659.0,659.0,5,1079,1.0,811.0,811.0
300.422,6,16,2170,9,684,37532.0,146.0,146.0,7,1486,50042.0,419.0,398.0
0.011,6,10,1989,5,910,2.0,642.0,642.0,5,1079,2.0,811.0,811.0
0.005,6,10,2007,5,928,1.0,660.0,660.0,5,1079,1.0,811.0,811.0
0.005,17,2,170,1,65,0.0,37.0,37.0,1,105,0.0,77.0,77.0
0.006,6,10,1547,5,764,1.0,496.0,496.0,5,783,1.0,515.0,515.0
0.005,6,10,2006,5,927,1.0,659.0,659.0,5,1079,1.0,811.0,811.0
0.0,17,2,136,1,60,0.0,32.0,32.0,1,76,0.0,48.0,48.0
11.145,17,28,4391,14,2312,848.0,587.0,137.0,14,2079,848.0,270.0,120.0
0.006,17,2,249,1,60,0.0,32.0,32.0,1,189,0.0,161.0,161.0
0.005,17,2,144,1,64,0.0,36.0,36.0,1,80,0.0,52.0,52.0
0.009,6,10,2000,5,927,2.0,659.0,659.0,5,1073,2.0,805.0,805.0
0.001,17,2,136,1,60,0.0,32.0,32.0,1,76,0.0,48.0,48.0
0.005,6,10,1689,5,839,1.0,571.0,571.0,5,850,1.0,582.0,582.0
1732.228,6,65,7413,43,4537,41243.0,1402.0,104.0,22,2876,82478.0,1112.0,82.0
0.011,6,10,1972,5,910,2.0,642.0,642.0,5,1062,2.0,794.0,794.0
0.007,17,2,144,1,64,0.0,36.0,36.0,1,80,0.0,52.0,52.0
40.073,17,10,676,5,460,10017.0,104.0,64.0,5,216,10017.0,20.0,15.0
0.004,6,10,1702,5,863,1.0,595.0,595.0,5,839,1.0,571.0,571.0
52.717,6,393,347496,192,21556,275.0,2736.0,888.0,201,325940,263.0,2804.0,1678.0
0.219,6,16,2777,8,1395,31.0,533.0,323.0,8,1382,20.0,529.0,239.0
0.005,17,2,148,1,60,0.0,32.0,32.0,1,88,0.0,60.0,60.0
0.005,6,10,1989,5,927,1.0,659.0,659.0,5,1062,1.0,794.0,794.0
319.989,6,22,4794,9,963,39998.0,238.0,166.0,13,3831,26665.0,1402.0,786.0
0.061,6,10,1506,5,395,11.0,127.0,127.0,5,1111,14.0,843.0,843.0
0.005,6,10,1547,5,764,1.0,496.0,496.0,5,783,1.0,515.0,515.0
0.004,6,10,1989,5,927,1.0,659.0,659.0,5,1062,1.0,794.0,794.0
0.074,6,10,1506,5,395,17.0,127.0,127.0,5,1111,13.0,843.0,843.0
0.001,17,2,180,1,66,0.0,38.0,38.0,1,114,0.0,86.0,86.0
0.005,6,14,3736,7,446,0.0,74.0,74.0,7,3290,0.0,1448.0,972.0
0.013,6,10,1762,5,911,3.0,643.0,643.0,5,851,3.0,583.0,583.0
0.059,6,10,1506,5,395,12.0,127.0,127.0,5,1111,14.0,843.0,843.0
0.006,6,10,1547,5,764,1.0,496.0,496.0,5,783,1.0,515.0,515.0
0.005,6,10,2007,5,928,1.0,660.0,660.0,5,1079,1.0,811.0,811.0
0.013,6,10,1972,5,910,3.0,642.0,642.0,5,1062,3.0,794.0,794.0
0.005,6,10,1774,5,923,1.0,655.0,655.0,5,851,1.0,583.0,583.0
0.005,6,10,1989,5,927,1.0,659.0,659.0,5,1062,1.0,794.0,794.0
64.787,6,36,8707,18,3189,524.0,1360.0,609.0,18,5518,3800.0,2667.0,435.0
0.279,17,41,20190,23,17154,12.0,1350.0,717.0,18,3036,14.0,1350.0,140.0
0.023,6,10,1972,5,910,5.0,642.0,642.0,5,1062,5.0,794.0,794.0
0.005,6,10,2006,5,927,1.0,659.0,659.0,5,1079,1.0,811.0,811.0
0.01,6,10,1689,5,839,2.0,571.0,571.0,5,850,2.0,582.0,582.0
0.013,17,4,284,2,120,0.0,32.0,32.0,2,164,0.0,60.0,54.0
0.082,6,10,1506,5,395,17.0,127.0,127.0,5,1111,18.0,843.0,843.0
0.004,6,10,1702,5,863,1.0,595.0,595.0,5,839,0.0,571.0,571.0
0.012,6,10,1762,5,911,2.0,643.0,643.0,5,851,3.0,583.0,583.0
0.005,6,13,3747,7,509,0.0,137.0,137.0,6,3238,0.0,1470.0,1459.0
0.017,6,14,3787,7,497,2.0,125.0,125.0,7,3290,2.0,1448.0,972.0
0.006,6,10,2000,5,927,1.0,659.0,659.0,5,1073,1.0,805.0,805.0
0.027,6,10,1989,5,910,6.0,642.0,642.0,5,1079,6.0,811.0,811.0
10.823,17,28,4423,14,1995,824.0,270.0,114.0,14,2428,824.0,587.0,145.0
0.006,6,10,1779,5,928,1.0,660.0,660.0,5,851,1.0,583.0,583.0
40.073,17,10,676,5,460,10014.0,104.0,64.0,5,216,10017.0,20.0,15.0
0.012,6,10,1983,5,910,3.0,642.0,642.0,5,1073,3.0,805.0,805.0
0.005,6,10,2006,5,927,1.0,659.0,659.0,5,1079,1.0,811.0,811.0
0.006,6,10,1689,5,839,1.0,571.0,571.0,5,850,1.0,582.0,582.0
0.008,6,10,1631,5,848,2.0,580.0,580.0,5,783,2.0,515.0,515.0
0.065,17,2,144,1,64,0.0,36.0,36.0,1,80,0.0,52.0,52.0
0.005,6,10,2007,5,928,1.0,660.0,660.0,5,1079,1.0,811.0,811.0
0.004,17,2,142,1,63,0.0,35.0,35.0,1,79,0.0,51.0,51.0
0.01,6,10,1677,5,827,2.0,559.0,559.0,5,850,2.0,582.0,582.0
0.005,6,10,1989,5,927,1.0,659.0,659.0,5,1062,1.0,794.0,794.0
0.005,17,2,182,1,83,0.0,55.0,55.0,1,99,0.0,71.0,71.0
0.009,6,10,1990,5,911,2.0,643.0,643.0,5,1079,2.0,811.0,811.0
0.011,6,10,1983,5,910,2.0,642.0,642.0,5,1073,2.0,805.0,805.0
0.121,6,10,1506,5,395,20.0,127.0,127.0,5,1111,28.0,843.0,843.0
1786.641,6,154,19574,92,13852,19633.0,302.0,302.0,62,5722,29289.0,83.0,83.0
0.005,6,10,2006,5,927,1.0,659.0,659.0,5,1079,1.0,811.0,811.0
0.015,6,10,1990,5,911,3.0,643.0,643.0,5,1079,3.0,811.0,811.0
0.086,6,10,1506,5,395,19.0,127.0,127.0,5,1111,19.0,843.0,843.0
0.004,17,2,136,1,60,0.0,32.0,32.0,1,76,0.0,48.0,48.0
300.293,6,25,7300,15,1357,21449.0,217.0,142.0,10,5943,26694.0,1679.0,902.0
0.003,17,4,284,2,120,0.0,32.0,32.0,2,164,0.0,60.0,54.0
0.005,17,2,164,1,74,0.0,46.0,46.0,1,90,0.0,62.0,62.0
0.012,6,10,1983,5,910,2.0,642.0,642.0,5,1073,3.0,805.0,805.0
0.072,17,2,184,1,61,0.0,33.0,33.0,1,123,0.0,95.0,95.0
0.006,6,10,1547,5,764,1.0,496.0,496.0,5,783,1.0,515.0,515.0
0.008,17,2,148,1,60,0.0,32.0,32.0,1,88,0.0,60.0,60.0
0.003,17,2,136,1,60,0.0,32.0,32.0,1,76,0.0,48.0,48.0
0.004,17,2,136,1,60,0.0,32.0,32.0,1,76,0.0,48.0,48.0
0.001,17,2,136,1,60,0.0,32.0,32.0,1,76,0.0,48.0,48.0
0.112,6,10,1506,5,395,25.0,127.0,127.0,5,1111,25.0,843.0,843.0
0.023,6,10,1989,5,910,5.0,642.0,642.0,5,1079,5.0,811.0,811.0
0.06,6,10,1506,5,395,12.0,127.0,127.0,5,1111,14.0,843.0,843.0
300.352,6,25,7300,15,1357,21453.0,217.0,142.0,10,5943,26701.0,1679.0,902.0
0.111,6,10,1506,5,395,25.0,127.0,127.0,5,1111,24.0,843.0,843.0
0.005,17,2,148,1,60,0.0,32.0,32.0,1,88,0.0,60.0,60.0
0.005,6,10,2007,5,928,1.0,660.0,660.0,5,1079,1.0,811.0,811.0
0.016,6,10,1631,5,848,4.0,580.0,580.0,5,783,3.0,515.0,515.0
240.148,6,19,7534,10,2204,26683.0,1496.0,562.0,9,5330,30018.0,2802.0,1210.0
0.125,6,10,1506,5,395,28.0,127.0,127.0,5,1111,30.0,843.0,843.0
0.009,6,10,1990,5,911,2.0,643.0,643.0,5,1079,2.0,811.0,811.0
0.017,6,10,1972,5,910,4.0,642.0,642.0,5,1062,4.0,794.0,794.0
240.432,6,35,8925,18,2071,14142.0,692.0,225.0,17,6854,15026.0,1402.0,597.0
0.006,6,10,1547,5,764,1.0,496.0,496.0,5,783,1.0,515.0,515.0
0.005,6,10,2006,5,927,1.0,659.0,659.0,5,1079,1.0,811.0,811.0
0.024,6,10,1989,5,910,6.0,642.0,642.0,5,1079,5.0,811.0,811.0
0.005,6,10,1854,5,889,1.0,621.0,621.0,5,965,1.0,697.0,697.0
0.014,6,10,1631,5,848,3.0,580.0,580.0,5,783,3.0,515.0,515.0
0.015,6,10,1990,5,911,3.0,643.0,643.0,5,1079,3.0,811.0,811.0
15.075,17,15,9239,8,6902,2149.0,1350.0,834.0,7,2337,2507.0,1350.0,305.0
0.154,6,10,1506,5,395,29.0,127.0,127.0,5,1111,34.0,843.0,843.0
0.004,17,2,148,1,60,0.0,32.0,32.0,1,88,0.0,60.0,60.0
0.004,17,2,170,1,65,0.0,37.0,37.0,1,105,0.0,77.0,77.0
0.005,17,2,180,1,58,0.0,30.0,30.0,1,122,0.0,94.0,94.0
0.005,6,10,1702,5,863,1.0,595.0,595.0,5,839,1.0,571.0,571.0
0.004,6,10,2000,5,927,1.0,659.0,659.0,5,1073,1.0,805.0,805.0
0.107,6,10,1506,5,395,24.0,127.0,127.0,5,1111,25.0,843.0,843.0
0.12,6,10,1506,5,395,26.0,127.0,127.0,5,1111,27.0,843.0,843.0
300.329,6,19,3084,11,1647,30032.0,517.0,266.0,8,1437,34330.0,824.0,337.0
0.005,6,10,2006,5,927,1.0,659.0,659.0,5,1079,1.0,811.0,811.0
0.004,17,4,284,2,120,0.0,32.0,32.0,2,164,0.0,60.0,54.0
369.772,6,22,2313,16,867,24651.0,195.0,195.0,6,1446,4651.0,419.0,398.0
0.123,6,10,1506,5,395,25.0,127.0,127.0,5,1111,24.0,843.0,843.0
0.008,6,10,1990,5,911,2.0,643.0,643.0,5,1079,2.0,811.0,811.0
0.015,6,10,1972,5,910,3.0,642.0,642.0,5,1062,3.0,794.0,794.0
0.018,6,10,1989,5,927,4.0,659.0,659.0,5,1062,4.0,794.0,794.0
0.005,6,10,2006,5,927,1.0,659.0,659.0,5,1079,1.0,811.0,811.0
308.393,17,20,1124,10,716,34251.0,48.0,43.0,10,408,34251.0,20.0,12.0
0.01,6,10,1972,5,910,2.0,642.0,642.0,5,1062,2.0,794.0,794.0
353.261,6,20,2210,6,1308,12004.0,494.0,494.0,14,902,27173.0,83.0,83.0
0.005,6,10,2007,5,928,1.0,660.0,660.0,5,1079,1.0,811.0,811.0
0.014,6,10,1989,5,910,3.0,642.0,642.0,5,1079,3.0,811.0,811.0
66.107,6,29,19805,16,11816,4407.0,2804.0,1568.0,13,7989,5495.0,2308.0,1217.0
0.098,6,10,1506,5,395,23.0,127.0,127.0,5,1111,22.0,843.0,843.0
0.013,6,10,1990,5,911,3.0,643.0,643.0,5,1079,3.0,811.0,811.0
0.012,6,10,1779,5,928,3.0,660.0,660.0,5,851,2.0,583.0,583.0
0.001,17,2,136,1,60,0.0,32.0,32.0,1,76,0.0,48.0,48.0
0.005,6,10,2006,5,927,1.0,659.0,659.0,5,1079,1.0,811.0,811.0
0.007,6,10,1689,5,839,1.0,571.0,571.0,5,850,1.0,582.0,582.0
0.015,6,13,3735,7,497,2.0,125.0,125.0,6,3238,2.0,1470.0,1459.0
0.005,6,10,1774,5,923,1.0,655.0,655.0,5,851,1.0,583.0,583.0
0.003,17,2,136,1,60,0.0,32.0,32.0,1,76,0.0,48.0,48.0
0.007,17,2,169,1,62,0.0,34.0,34.0,1,107,0.0,79.0,79.0
0.006,17,2,180,1,66,0.0,38.0,38.0,1,114,0.0,86.0,86.0
300.336,6,31,11807,16,5762,20022.0,1368.0,703.0,15,6045,21452.0,1655.0,878.0
0.016,6,10,1989,5,910,4.0,642.0,642.0,5,1079,3.0,811.0,811.0
0.004,17,2,136,1,60,0.0,32.0,32.0,1,76,0.0,48.0,48.0
0.004,6,10,1779,5,928,1.0,660.0,660.0,5,851,1.0,583.0,583.0
0.089,6,10,1506,5,395,18.0,127.0,127.0,5,1111,20.0,843.0,843.0
0.011,6,10,1983,5,910,2.0,642.0,642.0,5,1073,2.0,805.0,805.0
0.005,17,2,146,1,65,0.0,37.0,37.0,1,81,0.0,53.0,53.0
0.009,6,10,1989,5,910,2.0,642.0,642.0,5,1079,2.0,811.0,811.0
0.001,17,2,180,1,66,0.0,38.0,38.0,1,114,0.0,86.0,86.0
0.004,17,2,136,1,60,0.0,32.0,32.0,1,76,0.0,48.0,48.0
9.038,17,6,376,5,280,2259.0,28.0,28.0,1,96,0.0,68.0,68.0
0.005,6,10,2006,5,927,1.0,659.0,659.0,5,1079,1.0,811.0,811.0
10.8,17,28,4421,14,1993,822.0,268.0,114.0,14,2428,822.0,587.0,145.0
0.007,17,2,214,1,75,0.0,47.0,47.0,1,139,0.0,111.0,111.0
0.005,6,10,1689,5,839,1.0,571.0,571.0,5,850,1.0,582.0,582.0
0.005,6,10,2007,5,928,1.0,660.0,660.0,5,1079,1.0,811.0,811.0
0.018,6,10,1989,5,910,4.0,642.0,642.0,5,1079,4.0,811.0,811.0
0.001,17,2,180,1,66,0.0,38.0,38.0,1,114,0.0,86.0,86.0
0.006,6,10,1854,5,889,1.0,621.0,621.0,5,965,1.0,697.0,697.0
0.001,17,2,180,1,66,0.0,38.0,38.0,1,114,0.0,86.0,86.0
0.004,6,10,1774,5,923,1.0,655.0,655.0,5,851,1.0,583.0,583.0
0.005,6,10,2007,5,928,1.0,660.0,660.0,5,1079,1.0,811.0,811.0
0.024,6,10,1983,5,910,6.0,642.0,642.0,5,1073,6.0,805.0,805.0
240.107,6,16,4480,9,963,30013.0,238.0,166.0,7,3517,40017.0,1402.0,786.0
0.009,6,10,1677,5,827,2.0,559.0,559.0,5,850,2.0,582.0,582.0
412.27,6,29,4409,12,3102,10912.0,494.0,494.0,17,1307,25766.0,83.0,83.0
0.009,6,10,1983,5,910,2.0,642.0,642.0,5,1073,2.0,805.0,805.0
0.088,6,10,1506,5,395,20.0,127.0,127.0,5,1111,20.0,843.0,843.0
0.069,6,10,1506,5,395,17.0,127.0,127.0,5,1111,15.0,843.0,843.0
0.089,6,10,1506,5,395,19.0,127.0,127.0,5,1111,17.0,843.0,843.0
0.006,6,10,1547,5,764,1.0,496.0,496.0,5,783,1.0,515.0,515.0
0.134,6,10,1506,5,395,30.0,127.0,127.0,5,1111,30.0,843.0,843.0
0.004,6,10,1702,5,863,1.0,595.0,595.0,5,839,1.0,571.0,571.0
0.117,6,10,1506,5,395,23.0,127.0,127.0,5,1111,26.0,843.0,843.0
0.785,6,10,1684,6,1330,157.0,1078.0,1078.0,4,354,180.0,182.0,182.0
1.083,6,32,13393,18,5893,63.0,2720.0,854.0,14,7500,70.0,2720.0,769.0
0.022,6,10,1989,5,910,5.0,642.0,642.0,5,1079,5.0,811.0,811.0
0.004,17,2,136,1,60,0.0,32.0,32.0,1,76,0.0,48.0,48.0
0.009,6,10,1972,5,910,2.0,642.0,642.0,5,1062,2.0,794.0,794.0
0.006,6,10,1547,5,764,1.0,496.0,496.0,5,783,1.0,515.0,515.0
40.067,17,10,676,5,460,10014.0,104.0,64.0,5,216,10015.0,20.0,15.0
0.006,17,2,214,1,75,0.0,47.0,47.0,1,139,0.0,111.0,111.0
0.005,17,2,144,1,64,0.0,36.0,36.0,1,80,0.0,52.0,52.0
0.009,6,10,1989,5,910,2.0,642.0,642.0,5,1079,2.0,811.0,811.0
0.01,6,10,1989,5,910,2.0,642.0,642.0,5,1079,2.0,811.0,811.0
0.005,6,10,1989,5,927,1.0,659.0,659.0,5,1062,1.0,794.0,794.0
0.012,6,10,1983,5,910,3.0,642.0,642.0,5,1073,3.0,805.0,805.0
0.005,17,2,144,1,64,0.0,36.0,36.0,1,80,0.0,52.0,52.0
0.014,6,10,1990,5,911,3.0,643.0,643.0,5,1079,3.0,811.0,811.0
0.04,17,4,284,2,120,1.0,32.0,32.0,2,164,37.0,60.0,54.0
240.013,6,9,787,5,488,60003.0,232.0,232.0,4,299,80003.0,83.0,83.0
0.005,6,10,2006,5,927,1.0,659.0,659.0,5,1079,1.0,811.0,811.0
0.01,6,10,1989,5,910,2.0,642.0,642.0,5,1079,2.0,811.0,811.0
0.007,6,10,1972,5,910,1.0,642.0,642.0,5,1062,1.0,794.0,794.0
0.171,6,3,453,2,321,171.0,241.0,241.0,1,132,0.0,92.0,92.0
0.004,17,4,284,2,120,1.0,32.0,32.0,2,164,0.0,60.0,54.0
10.915,17,24,3750,12,1993,982.0,588.0,138.0,12,1757,982.0,268.0,118.0
0.012,6,10,1989,5,910,2.0,642.0,642.0,5,1079,2.0,811.0,811.0
0.076,6,10,1506,5,395,15.0,127.0,127.0,5,1111,17.0,843.0,843.0
0.008,6,10,1989,5,910,2.0,642.0,642.0,5,1079,2.0,811.0,811.0
166.864,6,22,7437,11,1305,114.0,530.0,277.0,11,6132,16669.0,2720.0,946.0
0.005,17,2,144,1,64,0.0,36.0,36.0,1,80,0.0,52.0,52.0
0.009,6,10,1990,5,911,2.0,643.0,643.0,5,1079,2.0,811.0,811.0
0.006,6,10,1689,5,839,1.0,571.0,571.0,5,850,1.0,582.0,582.0
0.111,6,10,1506,5,395,22.0,127.0,127.0,5,1111,27.0,843.0,843.0
10.846,17,28,4421,14,1993,825.0,268.0,114.0,14,2428,825.0,587.0,145.0
0.004,17,2,148,1,60,0.0,32.0,32.0,1,88,0.0,60.0,60.0
0.005,6,10,2000,5,927,1.0,659.0,659.0,5,1073,1.0,805.0,805.0
0.101,6,10,1506,5,395,22.0,127.0,127.0,5,1111,23.0,843.0,843.0
240.014,6,9,787,5,488,60003.0,232.0,232.0,4,299,80003.0,83.0,83.0
309.469,17,20,1124,10,716,34371.0,48.0,43.0,10,408,34371.0,20.0,12.0
0.066,6,10,1506,5,395,15.0,127.0,127.0,5,1111,16.0,843.0,843.0
175.076,17,86,12536,43,2887,4168.0,44.0,39.0,43,9649,4168.0,260.0,196.0
0.001,17,2,180,1,66,0.0,38.0,38.0,1,114,0.0,86.0,86.0
0.006,6,10,1547,5,764,1.0,496.0,496.0,5,783,1.0,515.0,515.0
0.005,17,2,154,1,69,0.0,41.0,41.0,1,85,0.0,57.0,57.0
0.005,6,10,1689,5,839,1.0,571.0,571.0,5,850,1.0,582.0,582.0
0.016,6,10,1983,5,910,4.0,642.0,642.0,5,1073,4.0,805.0,805.0
0.005,6,10,2007,5,928,1.0,660.0,660.0,5,1079,1.0,811.0,811.0
0.005,6,10,2006,5,927,1.0,659.0,659.0,5,1079,1.0,811.0,811.0
23.573,6,36,8190,18,1719,540.0,651.0,322.0,18,6471,1377.0,2720.0,478.0
0.09,6,10,1506,5,395,19.0,127.0,127.0,5,1111,20.0,843.0,843.0
0.005,17,2,222,1,65,0.0,37.0,37.0,1,157,0.0,129.0,129.0
0.001,17,2,180,1,66,0.0,38.0,38.0,1,114,0.0,86.0,86.0
0.026,6,10,1990,5,911,6.0,643.0,643.0,5,1079,6.0,811.0,811.0
0.009,6,10,1989,5,910,2.0,642.0,642.0,5,1079,2.0,811.0,811.0
0.002,17,2,152,1,76,0.0,48.0,48.0,1,76,0.0,48.0,48.0
72.316,6,28,10452,13,4025,6026.0,1402.0,670.0,15,6427,5156.0,2111.0,939.0
0.13,6,10,1506,5,395,30.0,127.0,127.0,5,1111,29.0,843.0,843.0
0.011,6,10,1972,5,910,2.0,642.0,642.0,5,1062,2.0,794.0,794.0
0.218,6,16,2670,8,1396,31.0,533.0,324.0,8,1274,19.0,529.0,212.0
15.033,17,42,20441,22,17086,714.0,1350.0,748.0,20,3355,789.0,1350.0,139.0
0.005,6,10,2006,5,927,1.0,659.0,659.0,5,1079,1.0,811.0,811.0
0.011,6,10,1972,5,910,2.0,642.0,642.0,5,1062,2.0,794.0,794.0
0.005,6,10,2007,5,928,1.0,660.0,660.0,5,1079,1.0,811.0,811.0
40.066,17,10,676,5,460,10013.0,104.0,64.0,5,216,10015.0,20.0,15.0
0.009,6,10,1989,5,910,2.0,642.0,642.0,5,1079,2.0,811.0,811.0
353.43,6,20,2210,6,1308,12007.0,494.0,494.0,14,902,27186.0,83.0,83.0
0.085,6,10,1506,5,395,20.0,127.0,127.0,5,1111,17.0,843.0,843.0
0.071,6,10,1506,5,395,15.0,127.0,127.0,5,1111,14.0,843.0,843.0
0.005,17,2,212,1,74,0.0,46.0,46.0,1,138,0.0,110.0,110.0
0.005,6,10,2006,5,927,1.0,659.0,659.0,5,1079,1.0,811.0,811.0
0.123,6,10,1506,5,395,29.0,127.0,127.0,5,1111,25.0,843.0,843.0
1792.083,6,579,194972,291,165698,6179.0,2883.0,890.0,288,29274,6244.0,580.0,129.0
291.233,6,401,348247,195,21703,1501.0,2736.0,888.0,206,326544,1420.0,2804.0,1644.0
0.005,6,10,2007,5,928,1.0,660.0,660.0,5,1079,1.0,811.0,811.0
0.085,6,10,1506,5,395,18.0,127.0,127.0,5,1111,18.0,843.0,843.0
40.079,17,10,676,5,460,10012.0,104.0,64.0,5,216,10018.0,20.0,15.0
0.103,6,10,1506,5,395,23.0,127.0,127.0,5,1111,22.0,843.0,843.0
0.084,6,10,1506,5,395,18.0,127.0,127.0,5,1111,19.0,843.0,843.0
0.004,6,10,2007,5,928,1.0,660.0,660.0,5,1079,1.0,811.0,811.0
0.006,6,10,1854,5,889,1.0,621.0,621.0,5,965,1.0,697.0,697.0
0.013,6,10,1989,5,910,3.0,642.0,642.0,5,1079,3.0,811.0,811.0
0.004,6,10,1989,5,927,1.0,659.0,659.0,5,1062,1.0,794.0,794.0
0.008,6,10,1972,5,910,1.0,642.0,642.0,5,1062,2.0,794.0,794.0
0.007,6,10,1547,5,764,1.0,496.0,496.0,5,783,1.0,515.0,515.0
1.352,6,32,13392,18,5893,79.0,2720.0,854.0,14,7499,89.0,2720.0,769.0
0.005,6,10,2000,5,927,1.0,659.0,659.0,5,1073,1.0,805.0,805.0
0.005,6,14,3799,7,509,0.0,137.0,137.0,7,3290,0.0,1448.0,972.0
40.055,17,10,676,5,460,10013.0,104.0,64.0,5,216,10012.0,20.0,15.0
0.072,17,4,284,2,120,1.0,32.0,32.0,2,164,68.0,60.0,54.0
0.092,6,10,1506,5,395,21.0,127.0,127.0,5,1111,17.0,843.0,843.0
0.001,17,2,180,1,66,0.0,38.0,38.0,1,114,0.0,86.0,86.0
0.076,6,10,1506,5,395,16.0,127.0,127.0,5,1111,17.0,843.0,843.0
40.059,17,10,676,5,460,10014.0,104.0,64.0,5,216,10013.0,20.0,15.0
0.005,6,10,1643,5,860,1.0,592.0,592.0,5,783,1.0,515.0,515.0
0.017,6,13,3735,7,497,2.0,125.0,125.0,6,3238,3.0,1470.0,1459.0
49.442,6,40,13583,21,8025,442.0,1360.0,1021.0,19,5558,2737.0,2667.0,435.0
0.003,17,2,148,1,60,0.0,32.0,32.0,1,88,0.0,60.0,60.0
0.005,17,2,180,1,58,0.0,30.0,30.0,1,122,0.0,94.0,94.0
0.005,6,13,3690,7,452,0.0,80.0,80.0,6,3238,1.0,1470.0,1459.0
40.061,17,10,676,5,460,10012.0,104.0,64.0,5,216,10014.0,20.0,15.0
0.005,6,10,1689,5,839,1.0,571.0,571.0,5,850,1.0,582.0,582.0
172.08,17,70,9869,35,2330,5061.0,44.0,38.0,35,7539,5061.0,239.0,187.0
0.004,6,10,1702,5,863,0.0,595.0,595.0,5,839,1.0,571.0,571.0
240.7,6,39,9798,20,2227,12666.0,747.0,235.0,19,7571,13370.0,1402.0,548.0
0.012,6,10,1631,5,848,2.0,580.0,580.0,5,783,3.0,515.0,515.0
0.0,17,2,136,1,60,0.0,32.0,32.0,1,76,0.0,48.0,48.0
0.088,6,10,1506,5,395,19.0,127.0,127.0,5,1111,19.0,843.0,843.0
40.048,17,10,676,5,460,10010.0,104.0,64.0,5,216,10011.0,20.0,15.0
15.17,17,21,12621,11,9063,1514.0,1350.0,795.0,10,3558,1682.0,1350.0,327.0
0.005,17,2,170,1,65,0.0,37.0,37.0,1,105,0.0,77.0,77.0
0.069,17,8,3613,4,1874,23.0,1350.0,440.0,4,1739,12.0,1350.0,406.0
0.251,6,16,2669,8,1395,35.0,533.0,323.0,8,1274,23.0,529.0,212.0
0.234,17,15,8641,8,4076,33.0,1350.0,481.0,7,4565,29.0,1350.0,624.0
0.075,6,10,1506,5,395,16.0,127.0,127.0,5,1111,15.0,843.0,843.0
240.098,6,16,4481,9,963,30012.0,238.0,166.0,7,3518,40015.0,1402.0,786.0
0.077,6,10,1506,5,395,16.0,127.0,127.0,5,1111,15.0,843.0,843.0
0.002,17,2,180,1,66,0.0,38.0,38.0,1,114,0.0,86.0,86.0
40.057,17,10,676,5,460,10013.0,104.0,64.0,5,216,10013.0,20.0,15.0
0.011,6,10,1990,5,911,2.0,643.0,643.0,5,1079,2.0,811.0,811.0
0.004,6,10,2007,5,928,1.0,660.0,660.0,5,1079,1.0,811.0,811.0
0.004,17,4,596,2,122,0.0,33.0,33.0,2,474,1.0,323.0,209.0
0.038,17,2,146,1,65,0.0,37.0,37.0,1,81,0.0,53.0,53.0
0.01,17,4,284,2,120,0.0,32.0,32.0,2,164,0.0,60.0,54.0
0.013,6,10,1677,5,827,3.0,559.0,559.0,5,850,3.0,582.0,582.0
0.005,6,10,1689,5,839,1.0,571.0,571.0,5,850,1.0,582.0,582.0
0.006,17,2,225,1,65,0.0,37.0,37.0,1,160,0.0,132.0,132.0
0.006,17,2,180,1,66,0.0,38.0,38.0,1,114,0.0,86.0,86.0
356.565,6,21,1795,16,1030,23771.0,190.0,190.0,5,765,60001.0,464.0,248.0
0.008,6,10,1972,5,910,2.0,642.0,642.0,5,1062,1.0,794.0,794.0
0.005,6,10,1689,5,839,1.0,571.0,571.0,5,850,1.0,582.0,582.0
0.039,17,2,148,1,60,0.0,32.0,32.0,1,88,0.0,60.0,60.0
0.087,6,10,1506,5,395,20.0,127.0,127.0,5,1111,19.0,843.0,843.0
0.167,6,10,1506,5,395,39.0,127.0,127.0,5,1111,39.0,843.0,843.0
0.073,6,10,1506,5,395,15.0,127.0,127.0,5,1111,17.0,843.0,843.0
0.004,17,2,132,1,58,0.0,30.0,30.0,1,74,0.0,46.0,46.0
0.005,6,10,2000,5,927,1.0,659.0,659.0,5,1073,1.0,805.0,805.0
0.143,6,10,1506,5,395,27.0,127.0,127.0,5,1111,32.0,843.0,843.0
0.008,6,14,3787,7,497,1.0,125.0,125.0,7,3290,1.0,1448.0,972.0
0.004,17,2,186,1,61,0.0,33.0,33.0,1,125,0.0,97.0,97.0
71.63,6,21,8146,11,1985,78.0,1174.0,504.0,10,6161,7940.0,1791.0,958.0
0.011,6,10,1677,5,827,2.0,559.0,559.0,5,850,2.0,582.0,582.0
0.006,6,10,1547,5,764,1.0,496.0,496.0,5,783,1.0,515.0,515.0
0.009,6,10,1990,5,911,2.0,643.0,643.0,5,1079,2.0,811.0,811.0
0.004,6,10,1989,5,927,1.0,659.0,659.0,5,1062,1.0,794.0,794.0
0.005,6,10,2006,5,927,1.0,659.0,659.0,5,1079,1.0,811.0,811.0
0.005,6,10,2006,5,927,1.0,659.0,659.0,5,1079,1.0,811.0,811.0
0.005,6,10,2000,5,927,1.0,659.0,659.0,5,1073,1.0,805.0,805.0
0.041,17,2,412,1,61,0.0,33.0,33.0,1,351,0.0,323.0,323.0
0.106,6,10,1506,5,395,24.0,127.0,127.0,5,1111,24.0,843.0,843.0
0.005,17,2,180,1,66,0.0,38.0,38.0,1,114,0.0,86.0,86.0
0.1,6,10,1506,5,395,21.0,127.0,127.0,5,1111,23.0,843.0,843.0
0.01,6,12,1926,6,1189,1.0,659.0,434.0,6,737,1.0,417.0,417.0
366.341,6,22,2313,16,867,24422.0,195.0,195.0,6,1446,4660.0,419.0,398.0
0.005,17,2,169,1,62,0.0,34.0,34.0,1,107,0.0,79.0,79.0
0.008,6,12,1926,6,1189,1.0,659.0,434.0,6,737,1.0,417.0,417.0
0.011,6,10,1990,5,911,2.0,643.0,643.0,5,1079,2.0,811.0,811.0
240.092,6,31,8757,15,6320,17149.0,1515.0,616.0,16,2437,16005.0,580.0,199.0
1778.51,17,144,45504,72,22752,25049.0,288.0,288.0,72,22752,25049.0,288.0,288.0
0.12,6,10,1506,5,395,27.0,127.0,127.0,5,1111,27.0,843.0,843.0
0.005,6,10,1989,5,927,1.0,659.0,659.0,5,1062,1.0,794.0,794.0
0.168,6,10,1506,5,395,35.0,127.0,127.0,5,1111,37.0,843.0,843.0
0.005,6,10,2007,5,928,1.0,660.0,660.0,5,1079,1.0,811.0,811.0
0.013,6,10,1989,5,910,3.0,642.0,642.0,5,1079,3.0,811.0,811.0
0.005,6,10,2000,5,927,1.0,659.0,659.0,5,1073,1.0,805.0,805.0
0.005,17,2,179,1,71,0.0,43.0,43.0,1,108,0.0,80.0,80.0
0.09,6,10,1506,5,395,21.0,127.0,127.0,5,1111,21.0,843.0,843.0
0.007,6,10,1779,5,928,1.0,660.0,660.0,5,851,1.0,583.0,583.0
0.011,6,10,1989,5,910,2.0,642.0,642.0,5,1079,2.0,811.0,811.0
0.014,6,10,1990,5,911,3.0,643.0,643.0,5,1079,3.0,811.0,811.0
0.014,6,13,3735,7,497,2.0,125.0,125.0,6,3238,2.0,1470.0,1459.0
0.006,6,10,2000,5,927,1.0,659.0,659.0,5,1073,1.0,805.0,805.0
0.003,17,2,136,1,60,0.0,32.0,32.0,1,76,0.0,48.0,48.0
0.081,6,10,1506,5,395,19.0,127.0,127.0,5,1111,18.0,843.0,843.0
0.012,6,10,1989,5,910,3.0,642.0,642.0,5,1079,3.0,811.0,811.0
0.015,6,10,1972,5,910,3.0,642.0,642.0,5,1062,3.0,794.0,794.0
0.004,6,10,2006,5,927,1.0,659.0,659.0,5,1079,1.0,811.0,811.0
0.007,17,2,194,1,59,0.0,31.0,31.0,1,135,0.0,107.0,107.0
0.004,6,10,2007,5,928,1.0,660.0,660.0,5,1079,1.0,811.0,811.0
0.016,17,2,198,1,91,0.0,63.0,63.0,1,107,0.0,79.0,79.0
0.064,6,10,1506,5,395,13.0,127.0,127.0,5,1111,13.0,843.0,843.0
0.004,17,2,148,1,60,0.0,32.0,32.0,1,88,0.0,60.0,60.0
0.006,6,10,1547,5,764,1.0,496.0,496.0,5,783,1.0,515.0,515.0
0.016,6,10,1972,5,910,4.0,642.0,642.0,5,1062,4.0,794.0,794.0
300.799,6,39,12758,21,7240,15039.0,2720.0,1061.0,18,5518,507.0,2667.0,435.0
0.014,6,10,1989,5,910,3.0,642.0,642.0,5,1079,3.0,811.0,811.0
0.004,17,2,136,1,60,0.0,32.0,32.0,1,76,0.0,48.0,48.0
0.004,17,4,284,2,120,0.0,32.0,32.0,2,164,0.0,60.0,54.0
0.016,6,10,1983,5,910,4.0,642.0,642.0,5,1073,4.0,805.0,805.0
40.065,17,10,676,5,460,10015.0,104.0,64.0,5,216,10015.0,20.0,15.0
0.005,6,10,1689,5,839,1.0,571.0,571.0,5,850,1.0,582.0,582.0
0.086,6,10,1506,5,395,19.0,127.0,127.0,5,1111,19.0,843.0,843.0
10.991,17,26,4099,13,1822,906.0,269.0,112.0,13,2277,906.0,588.0,147.0
0.003,17,2,148,1,60,0.0,32.0,32.0,1,88,0.0,60.0,60.0
0.005,6,10,1689,5,839,1.0,571.0,571.0,5,850,1.0,582.0,582.0
0.005,6,10,1643,5,860,1.0,592.0,592.0,5,783,1.0,515.0,515.0
0.012,17,2,338,1,74,0.0,46.0,46.0,1,264,0.0,236.0,236.0
0.004,17,4,284,2,120,0.0,32.0,32.0,2,164,0.0,60.0,54.0
0.021,6,10,1631,5,848,5.0,580.0,580.0,5,783,5.0,515.0,515.0
0.005,6,10,1854,5,889,1.0,621.0,621.0,5,965,1.0,697.0,697.0
0.005,6,10,2006,5,927,1.0,659.0,659.0,5,1079,1.0,811.0,811.0
0.013,6,10,1989,5,910,3.0,642.0,642.0,5,1079,3.0,811.0,811.0
0.004,6,10,1702,5,863,1.0,595.0,595.0,5,839,0.0,571.0,571.0
0.005,6,10,2006,5,927,1.0,659.0,659.0,5,1079,1.0,811.0,811.0
0.001,17,2,180,1,65,0.0,37.0,37.0,1,115,0.0,87.0,87.0
0.106,6,10,1506,5,395,22.0,127.0,127.0,5,1111,23.0,843.0,843.0
0.011,17,2,169,1,62,0.0,34.0,34.0,1,107,0.0,79.0,79.0
0.015,6,10,1983,5,910,3.0,642.0,642.0,5,1073,3.0,805.0,805.0
0.006,6,10,1547,5,764,1.0,496.0,496.0,5,783,1.0,515.0,515.0
0.172,17,2,152,1,76,0.0,48.0,48.0,1,76,0.0,48.0,48.0
0.005,6,10,1689,5,839,1.0,571.0,571.0,5,850,1.0,582.0,582.0
0.001,17,2,180,1,66,0.0,38.0,38.0,1,114,0.0,86.0,86.0
0.008,6,10,1983,5,910,2.0,642.0,642.0,5,1073,1.0,805.0,805.0
0.071,6,10,1506,5,395,15.0,127.0,127.0,5,1111,16.0,843.0,843.0
0.17,6,3,453,2,321,170.0,241.0,241.0,1,132,0.0,92.0,92.0
0.004,6,10,1989,5,927,1.0,659.0,659.0,5,1062,1.0,794.0,794.0
0.038,17,2,144,1,64,0.0,36.0,36.0,1,80,0.0,52.0,52.0
0.01,6,10,1990,5,911,2.0,643.0,643.0,5,1079,2.0,811.0,811.0
0.006,6,10,1689,5,839,1.0,571.0,571.0,5,850,1.0,582.0,582.0
0.009,6,10,1677,5,827,2.0,559.0,559.0,5,850,2.0,582.0,582.0
0.004,17,2,136,1,60,0.0,32.0,32.0,1,76,0.0,48.0,48.0
0.034,6,10,1677,5,827,8.0,559.0,559.0,5,850,8.0,582.0,582.0
0.004,6,10,2006,5,927,1.0,659.0,659.0,5,1079,1.0,811.0,811.0
40.089,17,10,676,5,460,10021.0,104.0,64.0,5,216,10021.0,20.0,15.0
0.038,17,2,136,1,60,0.0,32.0,32.0,1,76,0.0,48.0,48.0
0.005,6,10,1989,5,927,1.0,659.0,659.0,5,1062,1.0,794.0,794.0
170.313,17,72,10360,36,2401,4865.0,44.0,38.0,36,7959,4866.0,261.0,193.0
0.004,17,4,284,2,120,1.0,32.0,32.0,2,164,1.0,60.0,54.0
0.006,6,10,1547,5,764,1.0,496.0,496.0,5,783,1.0,515.0,515.0
0.012,6,10,1990,5,911,3.0,643.0,643.0,5,1079,3.0,811.0,811.0
0.015,6,10,1989,5,910,3.0,642.0,642.0,5,1079,3.0,811.0,811.0
0.004,6,10,1774,5,923,1.0,655.0,655.0,5,851,1.0,583.0,583.0
53.789,6,378,346651,195,21709,277.0,2736.0,824.0,183,324942,295.0,2804.0,1855.0
0.071,17,2,182,1,65,0.0,37.0,37.0,1,117,0.0,89.0,89.0
0.086,6,10,1506,5,395,20.0,127.0,127.0,5,1111,17.0,843.0,843.0
0.005,6,10,2006,5,927,1.0,659.0,659.0,5,1079,1.0,811.0,811.0
0.005,6,14,3799,7,509,0.0,137.0,137.0,7,3290,0.0,1448.0,972.0
0.008,6,10,1989,5,910,1.0,642.0,642.0,5,1079,2.0,811.0,811.0
240.014,6,9,787,5,488,60003.0,232.0,232.0,4,299,80003.0,83.0,83.0
65.315,6,822,834942,377,809825,88.0,4080.0,2257.0,445,25117,146.0,1360.0,214.0
0.008,6,10,1983,5,910,2.0,642.0,642.0,5,1073,1.0,805.0,805.0
0.017,6,10,1983,5,910,4.0,642.0,642.0,5,1073,4.0,805.0,805.0
0.04,17,2,152,1,76,0.0,48.0,48.0,1,76,0.0,48.0,48.0
0.007,6,10,1989,5,910,1.0,642.0,642.0,5,1079,1.0,811.0,811.0
0.005,6,10,2006,5,927,1.0,659.0,659.0,5,1079,1.0,811.0,811.0
0.006,6,10,1547,5,764,1.0,496.0,496.0,5,783,1.0,515.0,515.0
0.012,6,10,1989,5,910,3.0,642.0,642.0,5,1079,3.0,811.0,811.0
0.005,6,10,1779,5,928,1.0,660.0,660.0,5,851,1.0,583.0,583.0
0.008,17,2,162,1,65,0.0,37.0,37.0,1,97,0.0,69.0,69.0
0.01,6,10,1631,5,848,2.0,580.0,580.0,5,783,2.0,515.0,515.0
0.014,6,10,1989,5,910,3.0,642.0,642.0,5,1079,3.0,811.0,811.0
0.016,6,10,1989,5,910,3.0,642.0,642.0,5,1079,3.0,811.0,811.0
0.006,6,10,1689,5,839,1.0,571.0,571.0,5,850,1.0,582.0,582.0
0.088,6,10,1506,5,395,19.0,127.0,127.0,5,1111,20.0,843.0,843.0
0.004,6,10,1702,5,863,1.0,595.0,595.0,5,839,1.0,571.0,571.0
0.001,17,2,180,1,65,0.0,37.0,37.0,1,115,0.0,87.0,87.0
0.014,6,10,1677,5,827,3.0,559.0,559.0,5,850,3.0,582.0,582.0
40.069,17,10,676,5,460,10014.0,104.0,64.0,5,216,10016.0,20.0,15.0
0.006,6,10,1854,5,889,1.0,621.0,621.0,5,965,1.0,697.0,697.0
0.012,6,10,1990,5,911,3.0,643.0,643.0,5,1079,2.0,811.0,811.0
0.006,6,10,1854,5,889,1.0,621.0,621.0,5,965,1.0,697.0,697.0
0.015,6,10,1990,5,911,3.0,643.0,643.0,5,1079,3.0,811.0,811.0
11.103,17,28,4422,14,1993,841.0,268.0,114.0,14,2429,840.0,588.0,145.0
0.095,6,10,1506,5,395,22.0,127.0,127.0,5,1111,18.0,843.0,843.0
0.006,6,10,2000,5,927,1.0,659.0,659.0,5,1073,1.0,805.0,805.0
0.082,6,10,1506,5,395,19.0,127.0,127.0,5,1111,16.0,843.0,843.0
0.083,6,10,1506,5,395,16.0,127.0,127.0,5,1111,17.0,843.0,843.0
0.005,17,2,166,1,75,0.0,47.0,47.0,1,91,0.0,63.0,63.0
0.005,6,10,1774,5,923,1.0,655.0,655.0,5,851,1.0,583.0,583.0
0.025,6,10,1762,5,911,6.0,643.0,643.0,5,851,6.0,583.0,583.0
0.013,6,10,1605,5,388,3.0,120.0,120.0,5,1217,3.0,949.0,949.0
0.014,6,10,1989,5,910,3.0,642.0,642.0,5,1079,3.0,811.0,811.0
0.301,6,10,1506,5,395,32.0,127.0,127.0,5,1111,73.0,843.0,843.0
9.037,17,6,376,5,280,2259.0,28.0,28.0,1,96,0.0,68.0,68.0
0.009,6,10,1989,5,910,2.0,642.0,642.0,5,1079,2.0,811.0,811.0
0.012,6,10,1677,5,827,3.0,559.0,559.0,5,850,2.0,582.0,582.0
0.009,6,10,1989,5,910,2.0,642.0,642.0,5,1079,2.0,811.0,811.0
0.005,6,10,1989,5,927,1.0,659.0,659.0,5,1062,1.0,794.0,794.0
0.005,6,10,1989,5,927,1.0,659.0,659.0,5,1062,1.0,794.0,794.0
0.009,6,10,1989,5,910,2.0,642.0,642.0,5,1079,2.0,811.0,811.0
0.008,17,2,194,1,59,0.0,31.0,31.0,1,135,0.0,107.0,107.0
0.004,6,10,1779,5,928,1.0,660.0,660.0,5,851,1.0,583.0,583.0
0.006,6,10,1547,5,764,1.0,496.0,496.0,5,783,1.0,515.0,515.0
0.009,6,10,1990,5,911,2.0,643.0,643.0,5,1079,2.0,811.0,811.0
0.003,17,2,136,1,60,0.0,32.0,32.0,1,76,0.0,48.0,48.0
0.005,17,2,144,1,64,0.0,36.0,36.0,1,80,0.0,52.0,52.0
0.007,6,10,2006,5,927,1.0,659.0,659.0,5,1079,1.0,811.0,811.0
0.005,6,10,2006,5,927,1.0,659.0,659.0,5,1079,1.0,811.0,811.0
40.058,17,10,676,5,460,10013.0,104.0,64.0,5,216,10013.0,20.0,15.0
0.001,17,2,136,1,60,0.0,32.0,32.0,1,76,0.0,48.0,48.0
0.006,6,10,1547,5,764,1.0,496.0,496.0,5,783,1.0,515.0,515.0
0.105,6,10,1506,5,395,18.0,127.0,127.0,5,1111,24.0,843.0,843.0
8.968,6,36,9962,19,4484,498.0,1360.0,738.0,17,5478,547.0,2667.0,435.0
0.013,6,10,1762,5,911,3.0,643.0,643.0,5,851,3.0,583.0,583.0
0.006,6,10,1547,5,764,1.0,496.0,496.0,5,783,1.0,515.0,515.0
40.072,17,10,676,5,460,10015.0,104.0,64.0,5,216,10017.0,20.0,15.0
0.006,6,10,2007,5,928,1.0,660.0,660.0,5,1079,1.0,811.0,811.0
332.378,17,20,1124,10,716,36916.0,48.0,43.0,10,408,36916.0,20.0,12.0
0.013,6,10,1972,5,910,3.0,642.0,642.0,5,1062,3.0,794.0,794.0
0.001,17,2,180,1,66,0.0,38.0,38.0,1,114,0.0,86.0,86.0
0.013,6,10,1972,5,910,3.0,642.0,642.0,5,1062,3.0,794.0,794.0
0.007,6,10,2000,5,927,1.0,659.0,659.0,5,1073,1.0,805.0,805.0
0.006,6,10,1689,5,839,1.0,571.0,571.0,5,850,1.0,582.0,582.0
40.069,17,10,676,5,460,10016.0,104.0,64.0,5,216,10016.0,20.0,15.0
0.003,17,2,136,1,60,0.0,32.0,32.0,1,76,0.0,48.0,48.0
0.008,6,12,1926,6,1189,1.0,659.0,434.0,6,737,1.0,417.0,417.0
0.004,17,2,148,1,60,0.0,32.0,32.0,1,88,0.0,60.0,60.0
0.102,6,10,1506,5,395,20.0,127.0,127.0,5,1111,22.0,843.0,843.0
0.112,6,10,1506,5,395,26.0,127.0,127.0,5,1111,27.0,843.0,843.0
0.018,6,10,1990,5,911,4.0,643.0,643.0,5,1079,4.0,811.0,811.0
0.009,6,10,1990,5,911,2.0,643.0,643.0,5,1079,2.0,811.0,811.0
0.109,6,10,1506,5,395,23.0,127.0,127.0,5,1111,25.0,843.0,843.0
40.067,17,10,676,5,460,10015.0,104.0,64.0,5,216,10015.0,20.0,15.0
0.01,6,10,1989,5,910,2.0,642.0,642.0,5,1079,2.0,811.0,811.0
0.023,6,10,1990,5,911,5.0,643.0,643.0,5,1079,5.0,811.0,811.0
0.011,6,10,1983,5,910,2.0,642.0,642.0,5,1073,2.0,805.0,805.0
0.114,6,10,1506,5,395,27.0,127.0,127.0,5,1111,26.0,843.0,843.0
240.206,6,36,4298,17,1952,15012.0,589.0,176.0,19,2346,13344.0,580.0,192.0
0.006,6,10,1547,5,764,1.0,496.0,496.0,5,783,1.0,515.0,515.0
40.059,17,10,676,5,460,10012.0,104.0,64.0,5,216,10014.0,20.0,15.0
0.115,6,10,1506,5,395,25.0,127.0,127.0,5,1111,22.0,843.0,843.0
0.082,6,10,1506,5,395,19.0,127.0,127.0,5,1111,18.0,843.0,843.0
0.001,17,2,180,1,66,0.0,38.0,38.0,1,114,0.0,86.0,86.0
0.016,6,10,1631,5,848,4.0,580.0,580.0,5,783,3.0,515.0,515.0
0.006,17,2,169,1,62,0.0,34.0,34.0,1,107,0.0,79.0,79.0
0.024,6,10,1990,5,911,6.0,643.0,643.0,5,1079,5.0,811.0,811.0
0.013,6,10,1989,5,910,3.0,642.0,642.0,5,1079,3.0,811.0,811.0
0.004,6,10,2006,5,927,1.0,659.0,659.0,5,1079,1.0,811.0,811.0
0.085,6,10,1506,5,395,18.0,127.0,127.0,5,1111,18.0,843.0,843.0
0.005,6,10,1547,5,764,1.0,496.0,496.0,5,783,1.0,515.0,515.0
10.88,17,28,4423,14,1994,828.0,269.0,114.0,14,2429,828.0,588.0,145.0
0.005,17,2,140,1,62,0.0,34.0,34.0,1,78,0.0,50.0,50.0
0.005,6,10,2007,5,928,1.0,660.0,660.0,5,1079,1.0,811.0,811.0
0.005,6,10,2006,5,927,1.0,659.0,659.0,5,1079,1.0,811.0,811.0
0.014,6,10,1983,5,910,3.0,642.0,642.0,5,1073,3.0,805.0,805.0
0.009,6,10,1677,5,827,2.0,559.0,559.0,5,850,2.0,582.0,582.0
0.012,6,10,1989,5,910,2.0,642.0,642.0,5,1079,2.0,811.0,811.0
0.059,6,13,3913,7,495,9.0,123.0,123.0,6,3418,11.0,1650.0,1549.0
309.606,17,20,1124,10,716,34386.0,48.0,43.0,10,408,34386.0,20.0,12.0
0.005,6,10,2006,5,927,1.0,659.0,659.0,5,1079,1.0,811.0,811.0
0.093,6,10,1506,5,395,20.0,127.0,127.0,5,1111,16.0,843.0,843.0
0.005,17,2,170,1,65,0.0,37.0,37.0,1,105,0.0,77.0,77.0
0.004,6,10,1702,5,863,0.0,595.0,595.0,5,839,1.0,571.0,571.0
0.14,6,10,1506,5,395,31.0,127.0,127.0,5,1111,29.0,843.0,843.0
330.552,17,20,1124,10,716,36714.0,48.0,43.0,10,408,36714.0,20.0,12.0
0.081,6,10,1506,5,395,18.0,127.0,127.0,5,1111,18.0,843.0,843.0
0.007,17,2,179,1,71,0.0,43.0,43.0,1,108,0.0,80.0,80.0
0.14,6,10,1506,5,395,33.0,127.0,127.0,5,1111,34.0,843.0,843.0
0.011,6,10,1989,5,910,2.0,642.0,642.0,5,1079,2.0,811.0,811.0
0.005,17,2,170,1,65,0.0,37.0,37.0,1,105,0.0,77.0,77.0
0.014,6,10,1631,5,848,3.0,580.0,580.0,5,783,3.0,515.0,515.0
0.005,6,10,1643,5,860,1.0,592.0,592.0,5,783,1.0,515.0,515.0
369.541,6,21,1796,16,1030,24636.0,190.0,190.0,5,766,60015.0,465.0,249.0
30.371,6,25,5883,14,1888,2336.0,517.0,260.0,11,3995,3036.0,1330.0,590.0
0.014,6,10,1990,5,911,3.0,643.0,643.0,5,1079,3.0,811.0,811.0
10.927,17,28,4424,14,1995,831.0,270.0,114.0,14,2429,831.0,588.0,145.0
0.1,6,10,1506,5,395,20.0,127.0,127.0,5,1111,22.0,843.0,843.0
0.052,17,2,152,1,76,0.0,48.0,48.0,1,76,0.0,48.0,48.0
0.003,17,4,420,2,122,0.0,33.0,33.0,2,298,0.0,145.0,121.0
0.009,6,10,1989,5,910,2.0,642.0,642.0,5,1079,2.0,811.0,811.0
0.005,6,10,1989,5,927,1.0,659.0,659.0,5,1062,1.0,794.0,794.0
0.004,6,10,2006,5,927,1.0,659.0,659.0,5,1079,1.0,811.0,811.0
0.001,17,2,180,1,66,0.0,38.0,38.0,1,114,0.0,86.0,86.0
0.068,6,10,1506,5,395,15.0,127.0,127.0,5,1111,15.0,843.0,843.0
11.338,17,28,4394,14,1994,858.0,269.0,114.0,14,2400,859.0,587.0,143.0
300.478,6,16,2170,9,684,37535.0,146.0,146.0,7,1486,50051.0,419.0,398.0
0.006,17,2,179,1,71,0.0,43.0,43.0,1,108,0.0,80.0,80.0
0.006,17,2,169,1,62,0.0,34.0,34.0,1,107,0.0,79.0,79.0
0.019,6,14,3787,7,497,3.0,125.0,125.0,7,3290,3.0,1448.0,972.0
0.014,6,10,1972,5,910,3.0,642.0,642.0,5,1062,3.0,794.0,794.0
0.053,17,2,152,1,76,0.0,48.0,48.0,1,76,0.0,48.0,48.0
0.09,6,10,1506,5,395,20.0,127.0,127.0,5,1111,20.0,843.0,843.0
40.059,17,10,676,5,460,10013.0,104.0,64.0,5,216,10014.0,20.0,15.0
0.038,17,2,136,1,60,0.0,32.0,32.0,1,76,0.0,48.0,48.0
0.014,6,10,1989,5,910,3.0,642.0,642.0,5,1079,3.0,811.0,811.0
1770.828,6,81,4266,41,2159,44269.0,27.0,27.0,40,2107,45404.0,27.0,27.0
0.007,6,10,1983,5,910,1.0,642.0,642.0,5,1073,1.0,805.0,805.0
0.011,6,10,1989,5,910,2.0,642.0,642.0,5,1079,2.0,811.0,811.0
0.003,17,2,148,1,60,0.0,32.0,32.0,1,88,0.0,60.0,60.0
0.005,6,10,2000,5,927,1.0,659.0,659.0,5,1073,1.0,805.0,805.0
0.125,6,10,1506,5,395,28.0,127.0,127.0,5,1111,27.0,843.0,843.0
0.004,6,10,2006,5,927,1.0,659.0,659.0,5,1079,1.0,811.0,811.0
361.834,6,19,1689,15,978,25845.0,190.0,190.0,4,711,80014.0,495.0,495.0
0.006,17,2,170,1,65,0.0,37.0,37.0,1,105,0.0,77.0,77.0
0.069,6,10,1506,5,395,16.0,127.0,127.0,5,1111,15.0,843.0,843.0
0.005,6,13,3747,7,509,0.0,137.0,137.0,6,3238,0.0,1470.0,1459.0
0.006,17,2,179,1,71,0.0,43.0,43.0,1,108,0.0,80.0,80.0
0.006,6,10,1547,5,764,1.0,496.0,496.0,5,783,1.0,515.0,515.0
0.006,17,2,170,1,65,0.0,37.0,37.0,1,105,0.0,77.0,77.0
40.061,17,10,676,5,460,10014.0,104.0,64.0,5,216,10014.0,20.0,15.0
0.005,6,10,2007,5,928,1.0,660.0,660.0,5,1079,1.0,811.0,811.0
0.005,6,10,2006,5,927,1.0,659.0,659.0,5,1079,1.0,811.0,811.0
0.001,17,2,179,1,62,0.0,34.0,34.0,1,117,0.0,89.0,89.0
40.08,17,10,676,5,460,10013.0,104.0,64.0,5,216,10019.0,20.0,15.0
11.817,17,29,4499,15,2098,835.0,269.0,111.0,14,2401,900.0,588.0,143.0
0.005,6,10,2007,5,928,1.0,660.0,660.0,5,1079,1.0,811.0,811.0
0.003,17,4,284,2,120,0.0,32.0,32.0,2,164,0.0,60.0,54.0
176.316,17,80,11209,40,2666,4520.0,44.0,38.0,40,8543,4520.0,239.0,185.0
0.012,6,10,1990,5,911,3.0,643.0,643.0,5,1079,2.0,811.0,811.0
0.114,6,10,1506,5,395,25.0,127.0,127.0,5,1111,25.0,843.0,843.0
0.01,6,10,1989,5,910,2.0,642.0,642.0,5,1079,2.0,811.0,811.0
0.007,6,13,3690,7,452,1.0,80.0,80.0,6,3238,1.0,1470.0,1459.0
177.079,17,80,11167,40,2668,4540.0,44.0,38.0,40,8499,4540.0,260.0,184.0
0.083,6,10,1506,5,395,20.0,127.0,127.0,5,1111,13.0,843.0,843.0
0.119,6,10,1506,5,395,27.0,127.0,127.0,5,1111,26.0,843.0,843.0
0.005,6,10,2007,5,928,1.0,660.0,660.0,5,1079,1.0,811.0,811.0
0.013,6,10,1762,5,911,3.0,643.0,643.0,5,851,3.0,583.0,583.0
0.014,6,10,1972,5,910,3.0,642.0,642.0,5,1062,3.0,794.0,794.0
0.012,6,10,1631,5,848,3.0,580.0,580.0,5,783,2.0,515.0,515.0
0.109,6,10,1506,5,395,14.0,127.0,127.0,5,1111,25.0,843.0,843.0
240.084,6,16,4480,9,963,30010.0,238.0,166.0,7,3517,40013.0,1402.0,786.0
0.008,6,10,1643,5,860,2.0,592.0,592.0,5,783,2.0,515.0,515.0
0.005,17,2,214,1,75,0.0,47.0,47.0,1,139,0.0,111.0,111.0
0.006,6,10,1547,5,764,1.0,496.0,496.0,5,783,1.0,515.0,515.0
0.126,6,10,1506,5,395,30.0,127.0,127.0,5,1111,27.0,843.0,843.0
0.006,6,10,1547,5,764,1.0,496.0,496.0,5,783,1.0,515.0,515.0
0.012,6,10,1677,5,827,3.0,559.0,559.0,5,850,3.0,582.0,582.0
0.013,17,2,152,1,56,0.0,28.0,28.0,1,96,0.0,68.0,68.0
0.109,6,10,1506,5,395,21.0,127.0,127.0,5,1111,23.0,843.0,843.0
0.014,6,10,1762,5,911,3.0,643.0,643.0,5,851,3.0,583.0,583.0
1787.465,6,152,19470,91,13800,19860.0,302.0,302.0,61,5670,29791.0,83.0,83.0
0.012,6,10,1972,5,910,3.0,642.0,642.0,5,1062,3.0,794.0,794.0
0.07,6,10,1506,5,395,15.0,127.0,127.0,5,1111,16.0,843.0,843.0
0.072,17,2,146,1,65,0.0,37.0,37.0,1,81,0.0,53.0,53.0
0.039,17,2,182,1,65,0.0,37.0,37.0,1,117,0.0,89.0,89.0
171.07,17,70,10183,35,2339,5031.0,44.0,38.0,35,7844,5031.0,239.0,196.0
0.016,6,10,1983,5,910,3.0,642.0,642.0,5,1073,4.0,805.0,805.0
0.005,6,10,1643,5,860,1.0,592.0,592.0,5,783,1.0,515.0,515.0
0.093,6,10,1506,5,395,19.0,127.0,127.0,5,1111,21.0,843.0,843.0
0.01,6,10,1990,5,911,2.0,643.0,643.0,5,1079,2.0,811.0,811.0
0.004,6,10,1702,5,863,1.0,595.0,595.0,5,839,1.0,571.0,571.0
0.129,6,10,1506,5,395,31.0,127.0,127.0,5,1111,27.0,843.0,843.0
0.006,6,10,2006,5,927,1.0,659.0,659.0,5,1079,1.0,811.0,811.0
0.016,17,2,198,1,91,0.0,63.0,63.0,1,107,0.0,79.0,79.0
0.005,6,10,2006,5,927,1.0,659.0,659.0,5,1079,1.0,811.0,811.0
0.009,6,10,1972,5,910,2.0,642.0,642.0,5,1062,2.0,794.0,794.0
0.004,17,2,214,1,75,0.0,47.0,47.0,1,139,0.0,111.0,111.0
0.001,17,2,180,1,66,0.0,38.0,38.0,1,114,0.0,86.0,86.0
25.727,6,46,16329,23,10382,409.0,2720.0,1178.0,23,5947,1162.0,2667.0,385.0
0.001,17,2,179,1,62,0.0,34.0,34.0,1,117,0.0,89.0,89.0
0.012,6,10,1972,5,910,3.0,642.0,642.0,5,1062,3.0,794.0,794.0
0.01,6,10,1631,5,848,2.0,580.0,580.0,5,783,2.0,515.0,515.0
0.005,6,10,2006,5,927,1.0,659.0,659.0,5,1079,1.0,811.0,811.0
0.001,17,2,180,1,66,0.0,38.0,38.0,1,114,0.0,86.0,86.0
0.005,6,10,2006,5,927,1.0,659.0,659.0,5,1079,1.0,811.0,811.0
0.038,17,2,152,1,76,0.0,48.0,48.0,1,76,0.0,48.0,48.0
0.014,6,10,1989,5,910,3.0,642.0,642.0,5,1079,3.0,811.0,811.0
0.014,17,2,144,1,64,0.0,36.0,36.0,1,80,0.0,52.0,52.0
0.005,6,10,1989,5,927,1.0,659.0,659.0,5,1062,1.0,794.0,794.0
0.006,6,13,3747,7,509,1.0,137.0,137.0,6,3238,1.0,1470.0,1459.0
0.081,6,10,1506,5,395,18.0,127.0,127.0,5,1111,18.0,843.0,843.0
0.08,6,10,1506,5,395,16.0,127.0,127.0,5,1111,16.0,843.0,843.0
0.008,6,10,1989,5,910,2.0,642.0,642.0,5,1079,1.0,811.0,811.0
0.001,17,2,136,1,60,0.0,32.0,32.0,1,76,0.0,48.0,48.0
0.016,6,10,1990,5,911,4.0,643.0,643.0,5,1079,4.0,811.0,811.0
0.005,6,10,2006,5,927,1.0,659.0,659.0,5,1079,1.0,811.0,811.0
0.005,17,2,148,1,60,0.0,32.0,32.0,1,88,0.0,60.0,60.0
0.005,6,10,1989,5,927,1.0,659.0,659.0,5,1062,1.0,794.0,794.0
0.003,17,2,136,1,60,0.0,32.0,32.0,1,76,0.0,48.0,48.0
0.127,17,2,412,1,61,0.0,33.0,33.0,1,351,0.0,323.0,323.0
300.417,6,16,2170,9,684,37531.0,146.0,146.0,7,1486,50041.0,419.0,398.0
0.005,6,10,2006,5,927,1.0,659.0,659.0,5,1079,1.0,811.0,811.0
0.014,6,10,1989,5,910,3.0,642.0,642.0,5,1079,3.0,811.0,811.0
0.066,6,10,1506,5,395,13.0,127.0,127.0,5,1111,13.0,843.0,843.0
0.063,6,10,1506,5,395,12.0,127.0,127.0,5,1111,15.0,843.0,843.0
0.005,17,2,179,1,71,0.0,43.0,43.0,1,108,0.0,80.0,80.0
0.009,6,10,1989,5,910,2.0,642.0,642.0,5,1079,2.0,811.0,811.0
0.005,6,10,1989,5,927,1.0,659.0,659.0,5,1062,1.0,794.0,794.0
40.062,17,10,676,5,460,10012.0,104.0,64.0,5,216,10014.0,20.0,15.0
0.095,6,10,1506,5,395,20.0,127.0,127.0,5,1111,20.0,843.0,843.0
300.024,6,12,1782,7,1348,50004.0,494.0,494.0,5,434,75005.0,83.0,83.0
0.076,6,10,1506,5,395,16.0,127.0,127.0,5,1111,17.0,843.0,843.0
0.005,6,10,1989,5,927,1.0,659.0,659.0,5,1062,1.0,794.0,794.0
0.122,6,10,1506,5,395,28.0,127.0,127.0,5,1111,21.0,843.0,843.0
0.012,6,10,1989,5,910,3.0,642.0,642.0,5,1079,2.0,811.0,811.0
0.084,6,10,1506,5,395,20.0,127.0,127.0,5,1111,20.0,843.0,843.0
0.101,6,10,1506,5,395,23.0,127.0,127.0,5,1111,22.0,843.0,843.0
176.069,17,80,11573,40,2690,4514.0,44.0,39.0,40,8883,4514.0,261.0,194.0
1792.743,6,486,99194,244,87924,7377.0,421.0,368.0,242,11270,7438.0,53.0,53.0
0.113,6,10,1506,5,395,25.0,127.0,127.0,5,1111,26.0,843.0,843.0
0.133,6,10,1506,5,395,16.0,127.0,127.0,5,1111,32.0,843.0,843.0
0.009,6,10,1972,5,910,2.0,642.0,642.0,5,1062,2.0,794.0,794.0
0.008,6,12,1926,6,1189,1.0,659.0,434.0,6,737,1.0,417.0,417.0
0.122,6,10,1506,5,395,25.0,127.0,127.0,5,1111,28.0,843.0,843.0
0.011,6,10,1631,5,848,2.0,580.0,580.0,5,783,2.0,515.0,515.0
0.212,6,16,2778,8,1396,30.0,533.0,324.0,8,1382,19.0,529.0,239.0
0.016,6,10,1989,5,910,3.0,642.0,642.0,5,1079,4.0,811.0,811.0
0.008,6,10,1774,5,923,1.0,655.0,655.0,5,851,2.0,583.0,583.0
0.014,6,10,1990,5,911,3.0,643.0,643.0,5,1079,3.0,811.0,811.0
0.012,6,10,1972,5,910,2.0,642.0,642.0,5,1062,2.0,794.0,794.0
0.006,6,10,1547,5,764,1.0,496.0,496.0,5,783,1.0,515.0,515.0
15.08,17,15,8123,8,6029,2150.0,1350.0,725.0,7,2094,2508.0,1350.0,271.0
0.037,17,2,182,1,65,0.0,37.0,37.0,1,117,0.0,89.0,89.0
0.004,6,10,2000,5,927,1.0,659.0,659.0,5,1073,1.0,805.0,805.0
0.129,17,2,148,1,60,0.0,32.0,32.0,1,88,0.0,60.0,60.0
0.016,6,10,1989,5,910,4.0,642.0,642.0,5,1079,4.0,811.0,811.0
0.068,6,10,1506,5,395,14.0,127.0,127.0,5,1111,14.0,843.0,843.0
0.011,6,10,1990,5,911,2.0,643.0,643.0,5,1079,2.0,811.0,811.0
429.61,6,31,6680,16,3259,28640.0,676.0,403.0,15,3421,26398.0,821.0,329.0
0.019,6,10,1972,5,910,4.0,642.0,642.0,5,1062,4.0,794.0,794.0
240.081,6,16,4481,9,963,30010.0,238.0,166.0,7,3518,40012.0,1402.0,786.0
0.001,17,2,136,1,60,0.0,32.0,32.0,1,76,0.0,48.0,48.0
11.185,17,29,4538,15,2483,790.0,586.0,137.0,14,2055,851.0,270.0,118.0
0.005,6,10,1989,5,927,1.0,659.0,659.0,5,1062,1.0,794.0,794.0
40.064,17,10,676,5,460,10015.0,104.0,64.0,5,216,10015.0,20.0,15.0
0.004,6,10,2000,5,927,1.0,659.0,659.0,5,1073,1.0,805.0,805.0
0.019,6,10,1972,5,910,4.0,642.0,642.0,5,1062,4.0,794.0,794.0
0.012,6,10,1677,5,827,3.0,559.0,559.0,5,850,2.0,582.0,582.0
0.004,17,2,148,1,60,0.0,32.0,32.0,1,88,0.0,60.0,60.0
30.044,6,17,6879,9,689,3755.0,209.0,209.0,8,6190,4290.0,1402.0,1153.0
0.026,6,10,1972,5,910,6.0,642.0,642.0,5,1062,6.0,794.0,794.0
0.01,6,10,1989,5,910,2.0,642.0,642.0,5,1079,2.0,811.0,811.0
0.005,6,10,2006,5,927,1.0,659.0,659.0,5,1079,1.0,811.0,811.0
240.632,6,37,9525,19,2002,13368.0,622.0,198.0,18,7523,14154.0,1402.0,549.0
0.01,6,10,1989,5,910,2.0,642.0,642.0,5,1079,2.0,811.0,811.0
110.165,6,22,9233,11,1575,78.0,794.0,367.0,11,7658,11003.0,1360.0,1029.0
0.006,6,10,1689,5,839,1.0,571.0,571.0,5,850,1.0,582.0,582.0
0.012,6,10,1972,5,910,3.0,642.0,642.0,5,1062,2.0,794.0,794.0
0.009,6,10,1989,5,910,2.0,642.0,642.0,5,1079,2.0,811.0,811.0
240.024,6,9,787,5,488,60006.0,232.0,232.0,4,299,80007.0,83.0,83.0
0.005,6,10,1689,5,839,1.0,571.0,571.0,5,850,1.0,582.0,582.0
0.006,6,10,1643,5,860,1.0,592.0,592.0,5,783,1.0,515.0,515.0
0.001,17,2,180,1,66,0.0,38.0,38.0,1,114,0.0,86.0,86.0
0.003,17,2,234,1,61,0.0,33.0,33.0,1,173,0.0,145.0,145.0
0.099,6,10,1506,5,395,22.0,127.0,127.0,5,1111,21.0,843.0,843.0
40.071,17,10,676,5,460,10015.0,104.0,64.0,5,216,10017.0,20.0,15.0
0.009,6,10,1989,5,910,2.0,642.0,642.0,5,1079,2.0,811.0,811.0
40.069,17,10,676,5,460,10016.0,104.0,64.0,5,216,10016.0,20.0,15.0
0.063,6,10,1506,5,395,14.0,127.0,127.0,5,1111,13.0,843.0,843.0
0.017,6,10,1989,5,910,4.0,642.0,642.0,5,1079,4.0,811.0,811.0
0.015,6,10,1972,5,910,3.0,642.0,642.0,5,1062,3.0,794.0,794.0
0.016,6,10,1990,5,911,4.0,643.0,643.0,5,1079,4.0,811.0,811.0
0.008,6,10,1989,5,910,2.0,642.0,642.0,5,1079,1.0,811.0,811.0
0.08,6,10,1506,5,395,19.0,127.0,127.0,5,1111,16.0,843.0,843.0
0.007,6,10,2006,5,927,1.0,659.0,659.0,5,1079,1.0,811.0,811.0
0.005,17,2,214,1,75,0.0,47.0,47.0,1,139,0.0,111.0,111.0
0.083,6,10,1506,5,395,16.0,127.0,127.0,5,1111,18.0,843.0,843.0
0.006,6,10,1547,5,764,1.0,496.0,496.0,5,783,1.0,515.0,515.0
96.063,6,22,9233,11,1575,75.0,794.0,367.0,11,7658,9593.0,1360.0,1029.0
0.106,6,10,1506,5,395,23.0,127.0,127.0,5,1111,22.0,843.0,843.0
40.065,17,10,676,5,460,10015.0,104.0,64.0,5,216,10015.0,20.0,15.0
0.012,6,10,1983,5,910,3.0,642.0,642.0,5,1073,2.0,805.0,805.0
0.005,6,10,2006,5,927,1.0,659.0,659.0,5,1079,1.0,811.0,811.0
0.015,6,10,1983,5,910,3.0,642.0,642.0,5,1073,3.0,805.0,805.0
0.003,17,2,148,1,60,0.0,32.0,32.0,1,88,0.0,60.0,60.0
0.005,6,14,3742,7,452,0.0,80.0,80.0,7,3290,0.0,1448.0,972.0
0.011,6,10,1989,5,910,2.0,642.0,642.0,5,1079,2.0,811.0,811.0
40.073,17,10,676,5,460,10017.0,104.0,64.0,5,216,10017.0,20.0,15.0
0.065,6,10,1506,5,395,15.0,127.0,127.0,5,1111,13.0,843.0,843.0
0.055,6,10,1506,5,395,12.0,127.0,127.0,5,1111,12.0,843.0,843.0
0.002,17,2,136,1,60,0.0,32.0,32.0,1,76,0.0,48.0,48.0
0.013,6,10,1990,5,911,3.0,643.0,643.0,5,1079,3.0,811.0,811.0
0.012,6,10,1972,5,910,3.0,642.0,642.0,5,1062,2.0,794.0,794.0
0.087,6,10,1506,5,395,20.0,127.0,127.0,5,1111,17.0,843.0,843.0
0.09,6,10,1506,5,395,19.0,127.0,127.0,5,1111,16.0,843.0,843.0
0.039,17,4,284,2,120,0.0,32.0,32.0,2,164,35.0,60.0,54.0
0.113,6,10,1506,5,395,26.0,127.0,127.0,5,1111,25.0,843.0,843.0
0.041,17,2,170,1,65,0.0,37.0,37.0,1,105,0.0,77.0,77.0
0.007,6,10,1774,5,923,1.0,655.0,655.0,5,851,1.0,583.0,583.0
0.005,6,10,1989,5,927,1.0,659.0,659.0,5,1062,1.0,794.0,794.0
0.012,6,10,1989,5,910,3.0,642.0,642.0,5,1079,2.0,811.0,811.0
0.025,6,10,1990,5,911,6.0,643.0,643.0,5,1079,6.0,811.0,811.0
0.005,6,14,3742,7,452,0.0,80.0,80.0,7,3290,0.0,1448.0,972.0
0.077,6,10,1506,5,395,17.0,127.0,127.0,5,1111,17.0,843.0,843.0
0.039,17,2,186,1,61,0.0,33.0,33.0,1,125,0.0,97.0,97.0
0.114,6,10,1506,5,395,25.0,127.0,127.0,5,1111,27.0,843.0,843.0
0.001,17,2,166,1,75,0.0,47.0,47.0,1,91,0.0,63.0,63.0
0.004,6,10,1702,5,863,1.0,595.0,595.0,5,839,1.0,571.0,571.0
0.101,6,10,1506,5,395,19.0,127.0,127.0,5,1111,19.0,843.0,843.0
172.316,17,78,11251,39,2598,4534.0,44.0,38.0,39,8653,4534.0,239.0,193.0
0.005,6,10,2000,5,927,1.0,659.0,659.0,5,1073,1.0,805.0,805.0
0.004,17,4,420,2,122,0.0,33.0,33.0,2,298,1.0,145.0,121.0
0.009,6,10,1990,5,911,2.0,643.0,643.0,5,1079,2.0,811.0,811.0
0.147,6,10,1506,5,395,34.0,127.0,127.0,5,1111,34.0,843.0,843.0
0.005,6,14,3736,7,446,0.0,74.0,74.0,7,3290,0.0,1448.0,972.0
0.04,17,2,148,1,60,0.0,32.0,32.0,1,88,0.0,60.0,60.0
0.004,6,10,1779,5,928,1.0,660.0,660.0,5,851,1.0,583.0,583.0
0.004,6,10,1774,5,923,1.0,655.0,655.0,5,851,1.0,583.0,583.0
0.01,6,10,1762,5,911,2.0,643.0,643.0,5,851,2.0,583.0,583.0
0.086,6,10,1506,5,395,18.0,127.0,127.0,5,1111,20.0,843.0,843.0
0.003,17,2,152,1,76,0.0,48.0,48.0,1,76,0.0,48.0,48.0
0.017,6,10,1605,5,388,4.0,120.0,120.0,5,1217,4.0,949.0,949.0
0.004,6,10,2006,5,927,1.0,659.0,659.0,5,1079,1.0,811.0,811.0
0.019,6,10,1990,5,911,4.0,643.0,643.0,5,1079,4.0,811.0,811.0
0.012,6,10,1983,5,910,3.0,642.0,642.0,5,1073,2.0,805.0,805.0
0.013,6,10,1972,5,910,3.0,642.0,642.0,5,1062,3.0,794.0,794.0
0.086,6,10,1506,5,395,17.0,127.0,127.0,5,1111,18.0,843.0,843.0
0.063,6,10,1506,5,395,13.0,127.0,127.0,5,1111,13.0,843.0,843.0
0.106,6,10,1506,5,395,24.0,127.0,127.0,5,1111,26.0,843.0,843.0
0.005,6,10,2007,5,928,1.0,660.0,660.0,5,1079,1.0,811.0,811.0
0.091,6,10,1506,5,395,19.0,127.0,127.0,5,1111,19.0,843.0,843.0
0.015,6,10,1972,5,910,3.0,642.0,642.0,5,1062,3.0,794.0,794.0
0.006,6,10,1547,5,764,1.0,496.0,496.0,5,783,1.0,515.0,515.0
40.085,17,10,676,5,460,10014.0,104.0,64.0,5,216,10013.0,20.0,15.0
0.17,17,2,152,1,76,0.0,48.0,48.0,1,76,0.0,48.0,48.0
10.814,17,28,4417,14,1993,823.0,268.0,114.0,14,2424,823.0,587.0,145.0
0.059,6,10,1506,5,395,11.0,127.0,127.0,5,1111,14.0,843.0,843.0
0.007,17,2,179,1,71,0.0,43.0,43.0,1,108,0.0,80.0,80.0
0.006,17,2,170,1,65,0.0,37.0,37.0,1,105,0.0,77.0,77.0
0.014,6,14,3787,7,497,2.0,125.0,125.0,7,3290,2.0,1448.0,972.0
15.071,17,15,9239,8,6902,2148.0,1350.0,834.0,7,2337,2506.0,1350.0,305.0
0.02,6,10,1989,5,910,5.0,642.0,642.0,5,1079,4.0,811.0,811.0
0.012,6,10,1989,5,910,3.0,642.0,642.0,5,1079,2.0,811.0,811.0
1.225,17,6,764,3,183,592.0,33.0,33.0,3,581,576.0,307.0,165.0
0.516,17,2,144,1,64,0.0,36.0,36.0,1,80,0.0,52.0,52.0
0.01,6,10,1990,5,911,2.0,643.0,643.0,5,1079,2.0,811.0,811.0
0.013,6,10,1989,5,910,3.0,642.0,642.0,5,1079,3.0,811.0,811.0
0.005,6,10,1689,5,839,1.0,571.0,571.0,5,850,1.0,582.0,582.0
0.006,6,10,1547,5,764,1.0,496.0,496.0,5,783,1.0,515.0,515.0
308.422,17,18,1008,9,640,38536.0,48.0,43.0,9,368,38536.0,20.0,12.0
0.004,17,2,148,1,60,0.0,32.0,32.0,1,88,0.0,60.0,60.0
0.014,6,10,1972,5,910,3.0,642.0,642.0,5,1062,3.0,794.0,794.0
0.01,6,10,1643,5,860,2.0,592.0,592.0,5,783,2.0,515.0,515.0
0.014,6,10,1983,5,910,3.0,642.0,642.0,5,1073,3.0,805.0,805.0
0.094,6,10,1506,5,395,21.0,127.0,127.0,5,1111,22.0,843.0,843.0
0.012,6,10,1762,5,911,3.0,643.0,643.0,5,851,3.0,583.0,583.0
0.129,17,2,136,1,60,0.0,32.0,32.0,1,76,0.0,48.0,48.0
0.006,6,10,1547,5,764,1.0,496.0,496.0,5,783,1.0,515.0,515.0
0.01,6,10,1990,5,911,2.0,643.0,643.0,5,1079,2.0,811.0,811.0
0.071,17,4,420,2,122,0.0,33.0,33.0,2,298,67.0,145.0,121.0
0.005,6,13,3747,7,509,0.0,137.0,137.0,6,3238,0.0,1470.0,1459.0
0.075,6,10,1506,5,395,16.0,127.0,127.0,5,1111,16.0,843.0,843.0
1770.765,6,307,97992,189,86517,9418.0,2001.0,678.0,118,11475,15134.0,452.0,71.0
0.001,17,2,180,1,65,0.0,37.0,37.0,1,115,0.0,87.0,87.0
0.005,17,2,214,1,75,0.0,47.0,47.0,1,139,0.0,111.0,111.0
0.008,6,10,1972,5,910,2.0,642.0,642.0,5,1062,2.0,794.0,794.0
0.05,17,2,144,1,64,0.0,36.0,36.0,1,80,0.0,52.0,52.0
0.087,6,10,1506,5,395,19.0,127.0,127.0,5,1111,18.0,843.0,843.0
0.023,6,10,1983,5,910,5.0,642.0,642.0,5,1073,5.0,805.0,805.0
0.009,6,10,1990,5,911,2.0,643.0,643.0,5,1079,2.0,811.0,811.0
0.004,6,10,2007,5,928,1.0,660.0,660.0,5,1079,1.0,811.0,811.0
0.011,6,10,1989,5,910,2.0,642.0,642.0,5,1079,2.0,811.0,811.0
240.101,6,31,9200,15,6680,17150.0,1805.0,656.0,16,2520,16006.0,580.0,210.0
0.012,6,10,1989,5,910,3.0,642.0,642.0,5,1079,2.0,811.0,811.0
0.008,17,2,194,1,59,0.0,31.0,31.0,1,135,0.0,107.0,107.0
0.143,6,10,1506,5,395,34.0,127.0,127.0,5,1111,34.0,843.0,843.0
0.235,17,15,8641,8,4076,33.0,1350.0,481.0,7,4565,30.0,1350.0,624.0
0.005,6,10,2006,5,927,1.0,659.0,659.0,5,1079,1.0,811.0,811.0
40.067,17,10,676,5,460,10013.0,104.0,64.0,5,216,10015.0,20.0,15.0
300.085,6,22,5025,11,2369,30008.0,1026.0,447.0,11,2656,30008.0,1162.0,417.0
0.004,17,2,136,1,60,0.0,32.0,32.0,1,76,0.0,48.0,48.0
11.039,17,28,4399,14,2313,840.0,588.0,137.0,14,2086,840.0,269.0,121.0
240.013,6,9,787,5,488,60003.0,232.0,232.0,4,299,80003.0,83.0,83.0
0.008,17,2,194,1,59,0.0,31.0,31.0,1,135,0.0,107.0,107.0
0.006,6,10,1547,5,764,1.0,496.0,496.0,5,783,1.0,515.0,515.0
0.006,17,2,179,1,71,0.0,43.0,43.0,1,108,0.0,80.0,80.0
0.085,6,10,1506,5,395,18.0,127.0,127.0,5,1111,16.0,843.0,843.0
1729.251,6,60,4400,40,2740,44339.0,33.0,33.0,20,1660,91003.0,31.0,31.0
0.005,6,10,1779,5,928,1.0,660.0,660.0,5,851,1.0,583.0,583.0
40.065,17,10,676,5,460,10013.0,104.0,64.0,5,216,10015.0,20.0,15.0
0.09,6,10,1506,5,395,18.0,127.0,127.0,5,1111,17.0,843.0,843.0
0.103,6,10,1506,5,395,23.0,127.0,127.0,5,1111,25.0,843.0,843.0
0.005,6,10,2006,5,927,1.0,659.0,659.0,5,1079,1.0,811.0,811.0
0.005,6,10,1989,5,927,1.0,659.0,659.0,5,1062,1.0,794.0,794.0
0.009,6,10,1990,5,911,2.0,643.0,643.0,5,1079,2.0,811.0,811.0
0.006,17,2,144,1,64,0.0,36.0,36.0,1,80,0.0,52.0,52.0
0.005,6,10,1989,5,927,1.0,659.0,659.0,5,1062,1.0,794.0,794.0
0.005,6,10,2006,5,927,1.0,659.0,659.0,5,1079,1.0,811.0,811.0
0.065,6,10,1506,5,395,15.0,127.0,127.0,5,1111,14.0,843.0,843.0
0.096,6,10,1506,5,395,21.0,127.0,127.0,5,1111,21.0,843.0,843.0
0.138,6,10,1506,5,395,32.0,127.0,127.0,5,1111,30.0,843.0,843.0
0.005,17,2,240,1,61,0.0,33.0,33.0,1,179,0.0,151.0,151.0
0.001,17,2,180,1,66,0.0,38.0,38.0,1,114,0.0,86.0,86.0
9.041,17,6,376,5,280,2260.0,28.0,28.0,1,96,0.0,68.0,68.0
319.864,17,20,1124,10,716,35526.0,48.0,43.0,10,408,35526.0,20.0,12.0
21.862,6,37,10002,19,4484,498.0,1360.0,738.0,18,5518,1275.0,2667.0,435.0
0.005,6,10,1547,5,764,1.0,496.0,496.0,5,783,1.0,515.0,515.0
0.014,6,10,1990,5,911,3.0,643.0,643.0,5,1079,3.0,811.0,811.0
0.005,6,10,2000,5,927,1.0,659.0,659.0,5,1073,1.0,805.0,805.0
0.238,6,16,2675,8,1401,34.0,533.0,325.0,8,1274,21.0,529.0,212.0
0.005,17,2,136,1,60,0.0,32.0,32.0,1,76,0.0,48.0,48.0
0.096,6,10,1506,5,395,21.0,127.0,127.0,5,1111,22.0,843.0,843.0
40.059,17,10,676,5,460,10013.0,104.0,64.0,5,216,10013.0,20.0,15.0
0.008,6,10,1989,5,927,2.0,659.0,659.0,5,1062,2.0,794.0,794.0
0.008,6,10,1972,5,910,2.0,642.0,642.0,5,1062,1.0,794.0,794.0
0.006,6,10,1689,5,839,1.0,571.0,571.0,5,850,1.0,582.0,582.0
0.005,17,2,214,1,75,0.0,47.0,47.0,1,139,0.0,111.0,111.0
0.018,6,10,1989,5,910,4.0,642.0,642.0,5,1079,4.0,811.0,811.0
0.083,6,10,1506,5,395,18.0,127.0,127.0,5,1111,16.0,843.0,843.0
0.004,6,10,2007,5,928,1.0,660.0,660.0,5,1079,1.0,811.0,811.0
0.003,6,10,1702,5,863,0.0,595.0,595.0,5,839,0.0,571.0,571.0
0.006,6,10,1547,5,764,1.0,496.0,496.0,5,783,1.0,515.0,515.0
40.059,17,10,676,5,460,10012.0,104.0,64.0,5,216,10014.0,20.0,15.0
0.108,6,10,1506,5,395,25.0,127.0,127.0,5,1111,23.0,843.0,843.0
0.172,6,10,1506,5,395,33.0,127.0,127.0,5,1111,42.0,843.0,843.0
240.019,6,9,787,5,488,60004.0,232.0,232.0,4,299,80005.0,83.0,83.0
0.093,6,10,1506,5,395,22.0,127.0,127.0,5,1111,20.0,843.0,843.0
40.068,17,10,676,5,460,10016.0,104.0,64.0,5,216,10014.0,20.0,15.0
0.004,6,10,2000,5,927,1.0,659.0,659.0,5,1073,1.0,805.0,805.0
0.005,6,14,3742,7,452,0.0,80.0,80.0,7,3290,0.0,1448.0,972.0
240.177,6,17,7292,9,2024,30022.0,1496.0,780.0,8,5268,34310.0,2804.0,1211.0
0.005,17,2,169,1,62,0.0,34.0,34.0,1,107,0.0,79.0,79.0
0.214,17,4,352,2,130,140.0,37.0,37.0,2,222,176.0,89.0,83.0
0.013,6,10,1983,5,910,3.0,642.0,642.0,5,1073,3.0,805.0,805.0
0.005,6,10,1989,5,927,1.0,659.0,659.0,5,1062,1.0,794.0,794.0
0.001,17,2,136,1,60,0.0,32.0,32.0,1,76,0.0,48.0,48.0
0.108,6,10,1506,5,395,23.0,127.0,127.0,5,1111,26.0,843.0,843.0
0.108,6,10,1506,5,395,24.0,127.0,127.0,5,1111,25.0,843.0,843.0
0.02,6,10,1972,5,910,5.0,642.0,642.0,5,1062,4.0,794.0,794.0
0.146,6,10,1506,5,395,29.0,127.0,127.0,5,1111,32.0,843.0,843.0
300.373,6,16,2170,9,684,37522.0,146.0,146.0,7,1486,50033.0,419.0,398.0
0.006,6,10,1547,5,764,1.0,496.0,496.0,5,783,1.0,515.0,515.0
0.005,6,10,2006,5,927,1.0,659.0,659.0,5,1079,1.0,811.0,811.0
0.004,6,10,2000,5,927,1.0,659.0,659.0,5,1073,1.0,805.0,805.0
0.006,6,10,1547,5,764,1.0,496.0,496.0,5,783,1.0,515.0,515.0
0.005,6,10,1547,5,764,1.0,496.0,496.0,5,783,1.0,515.0,515.0
0.019,6,10,1983,5,910,4.0,642.0,642.0,5,1073,4.0,805.0,805.0
0.015,6,10,1990,5,911,3.0,643.0,643.0,5,1079,3.0,811.0,811.0
0.005,17,4,284,2,120,0.0,32.0,32.0,2,164,2.0,60.0,54.0
0.004,17,4,284,2,120,1.0,32.0,32.0,2,164,0.0,60.0,54.0
0.08,6,10,1506,5,395,17.0,127.0,127.0,5,1111,15.0,843.0,843.0
0.206,6,16,2777,8,1395,29.0,533.0,323.0,8,1382,19.0,529.0,239.0
356.642,6,21,1795,16,1030,23776.0,190.0,190.0,5,765,60007.0,464.0,248.0
1786.266,6,150,19350,90,13740,20070.0,302.0,302.0,60,5610,30275.0,83.0,83.0
0.012,6,10,1989,5,910,2.0,642.0,642.0,5,1079,2.0,811.0,811.0
0.134,6,10,1506,5,395,32.0,127.0,127.0,5,1111,30.0,843.0,843.0
0.125,6,10,1506,5,395,25.0,127.0,127.0,5,1111,28.0,843.0,843.0
0.57,6,27,9421,15,1639,33.0,517.0,211.0,12,7782,42.0,1288.0,895.0
0.008,6,10,1989,5,910,1.0,642.0,642.0,5,1079,2.0,811.0,811.0
40.066,17,10,676,5,460,10015.0,104.0,64.0,5,216,10015.0,20.0,15.0
0.085,6,10,1506,5,395,20.0,127.0,127.0,5,1111,18.0,843.0,843.0
319.246,17,20,1124,10,716,35465.0,48.0,43.0,10,408,35465.0,20.0,12.0
0.005,17,4,284,2,120,0.0,32.0,32.0,2,164,1.0,60.0,54.0
0.008,6,10,1990,5,911,2.0,643.0,643.0,5,1079,2.0,811.0,811.0
240.207,6,46,6929,22,3225,11437.0,588.0,230.0,24,3704,10443.0,580.0,222.0
0.008,6,10,1989,5,910,2.0,642.0,642.0,5,1079,2.0,811.0,811.0
40.054,17,10,676,5,460,10012.0,104.0,64.0,5,216,10012.0,20.0,15.0
0.053,17,2,152,1,76,0.0,48.0,48.0,1,76,0.0,48.0,48.0
0.005,6,10,1989,5,927,1.0,659.0,659.0,5,1062,1.0,794.0,794.0
0.011,6,10,1972,5,910,2.0,642.0,642.0,5,1062,2.0,794.0,794.0
0.016,6,10,1972,5,910,4.0,642.0,642.0,5,1062,3.0,794.0,794.0
0.076,6,10,1506,5,395,18.0,127.0,127.0,5,1111,16.0,843.0,843.0
0.086,6,10,1506,5,395,17.0,127.0,127.0,5,1111,19.0,843.0,843.0
0.006,6,10,1547,5,764,1.0,496.0,496.0,5,783,1.0,515.0,515.0
10.776,17,28,4421,14,1993,820.0,268.0,114.0,14,2428,820.0,587.0,145.0
0.018,6,19,9922,11,704,1.0,124.0,124.0,8,9218,2.0,2896.0,2198.0
1654.169,6,231,25014,91,16109,18379.0,1360.0,170.0,140,8905,11899.0,225.0,50.0
0.009,6,10,1972,5,910,2.0,642.0,642.0,5,1062,2.0,794.0,794.0
0.015,6,10,1989,5,910,3.0,642.0,642.0,5,1079,3.0,811.0,811.0
0.004,17,4,284,2,120,1.0,32.0,32.0,2,164,0.0,60.0,54.0
240.021,6,9,787,5,488,60005.0,232.0,232.0,4,299,80006.0,83.0,83.0
0.06,6,10,1972,5,910,15.0,642.0,642.0,5,1062,15.0,794.0,794.0
240.337,6,28,10140,16,1420,16022.0,260.0,189.0,12,8720,21845.0,2804.0,1011.0
0.027,17,2,148,1,60,0.0,32.0,32.0,1,88,0.0,60.0,60.0
0.095,6,10,1506,5,395,22.0,127.0,127.0,5,1111,22.0,843.0,843.0
0.005,6,10,2000,5,927,1.0,659.0,659.0,5,1073,1.0,805.0,805.0
40.057,17,10,676,5,460,10011.0,104.0,64.0,5,216,10013.0,20.0,15.0
0.151,6,10,1506,5,395,34.0,127.0,127.0,5,1111,36.0,843.0,843.0
40.055,17,10,676,5,460,10012.0,104.0,64.0,5,216,10013.0,20.0,15.0
0.005,6,10,2000,5,927,1.0,659.0,659.0,5,1073,1.0,805.0,805.0
0.004,6,14,3742,7,452,0.0,80.0,80.0,7,3290,0.0,1448.0,972.0
0.014,6,10,1989,5,910,3.0,642.0,642.0,5,1079,3.0,811.0,811.0
0.01,6,10,1990,5,911,2.0,643.0,643.0,5,1079,2.0,811.0,811.0
0.224,17,4,352,2,130,182.0,37.0,37.0,2,222,152.0,89.0,83.0
0.006,6,10,1689,5,839,1.0,571.0,571.0,5,850,1.0,582.0,582.0
0.108,6,10,1506,5,395,23.0,127.0,127.0,5,1111,25.0,843.0,843.0
0.022,6,12,1926,6,1189,4.0,659.0,434.0,6,737,4.0,417.0,417.0
0.014,6,10,1972,5,910,3.0,642.0,642.0,5,1062,3.0,794.0,794.0
0.009,6,12,1926,6,1189,1.0,659.0,434.0,6,737,1.0,417.0,417.0
0.116,6,10,1506,5,395,26.0,127.0,127.0,5,1111,23.0,843.0,843.0
0.075,6,10,1506,5,395,16.0,127.0,127.0,5,1111,16.0,843.0,843.0
0.001,17,2,136,1,60,0.0,32.0,32.0,1,76,0.0,48.0,48.0
0.003,17,2,136,1,60,0.0,32.0,32.0,1,76,0.0,48.0,48.0
0.005,17,2,157,1,59,0.0,31.0,31.0,1,98,0.0,70.0,70.0
0.01,6,10,1989,5,910,2.0,642.0,642.0,5,1079,2.0,811.0,811.0
0.078,6,10,1506,5,395,17.0,127.0,127.0,5,1111,16.0,843.0,843.0
0.041,17,2,412,1,61,0.0,33.0,33.0,1,351,0.0,323.0,323.0
0.013,6,10,1990,5,911,3.0,643.0,643.0,5,1079,3.0,811.0,811.0
280.847,6,25,6480,11,1226,28084.0,267.0,156.0,14,5254,21601.0,1400.0,781.0
0.004,6,10,2006,5,927,1.0,659.0,659.0,5,1079,1.0,811.0,811.0
0.023,6,10,1972,5,910,5.0,642.0,642.0,5,1062,5.0,794.0,794.0
0.228,6,16,2777,8,1395,32.0,533.0,323.0,8,1382,20.0,529.0,239.0
0.172,6,10,1506,5,395,18.0,127.0,127.0,5,1111,40.0,843.0,843.0
15.07,17,15,9238,8,6902,2148.0,1350.0,834.0,7,2336,2506.0,1350.0,305.0
0.087,6,10,1506,5,395,19.0,127.0,127.0,5,1111,18.0,843.0,843.0
0.015,6,10,1983,5,910,3.0,642.0,642.0,5,1073,3.0,805.0,805.0
9.036,17,6,376,5,280,2259.0,28.0,28.0,1,96,0.0,68.0,68.0
0.004,6,10,1702,5,863,1.0,595.0,595.0,5,839,1.0,571.0,571.0
0.074,6,10,1506,5,395,17.0,127.0,127.0,5,1111,13.0,843.0,843.0
0.094,6,10,1506,5,395,18.0,127.0,127.0,5,1111,22.0,843.0,843.0
0.012,6,10,2006,5,927,3.0,659.0,659.0,5,1079,2.0,811.0,811.0
0.037,17,2,136,1,60,0.0,32.0,32.0,1,76,0.0,48.0,48.0
300.301,6,16,2170,9,684,37516.0,146.0,146.0,7,1486,50021.0,419.0,398.0
0.057,17,2,367,1,99,0.0,71.0,71.0,1,268,0.0,240.0,240.0
0.005,6,10,1989,5,927,1.0,659.0,659.0,5,1062,1.0,794.0,794.0
40.076,17,10,676,5,460,10018.0,104.0,64.0,5,216,10018.0,20.0,15.0
0.007,17,2,194,1,59,0.0,31.0,31.0,1,135,0.0,107.0,107.0
0.009,6,14,3787,7,497,1.0,125.0,125.0,7,3290,1.0,1448.0,972.0
0.005,17,2,166,1,75,0.0,47.0,47.0,1,91,0.0,63.0,63.0
0.011,17,2,144,1,64,0.0,36.0,36.0,1,80,0.0,52.0,52.0
0.014,6,10,1989,5,910,3.0,642.0,642.0,5,1079,3.0,811.0,811.0
352.241,6,20,2210,6,1308,12003.0,494.0,494.0,14,902,27095.0,83.0,83.0
0.008,6,10,1989,5,910,1.0,642.0,642.0,5,1079,2.0,811.0,811.0
0.07,6,10,1506,5,395,14.0,127.0,127.0,5,1111,15.0,843.0,843.0
0.01,6,10,1983,5,910,2.0,642.0,642.0,5,1073,2.0,805.0,805.0
309.441,17,20,1124,10,716,34369.0,48.0,43.0,10,408,34375.0,20.0,12.0
0.007,6,10,1972,5,910,1.0,642.0,642.0,5,1062,1.0,794.0,794.0
0.013,6,10,1990,5,911,3.0,643.0,643.0,5,1079,3.0,811.0,811.0
0.004,6,10,2006,5,927,1.0,659.0,659.0,5,1079,1.0,811.0,811.0
0.004,17,2,154,1,69,0.0,41.0,41.0,1,85,0.0,57.0,57.0
0.005,6,14,3742,7,452,0.0,80.0,80.0,7,3290,0.0,1448.0,972.0
0.04,17,2,148,1,60,0.0,32.0,32.0,1,88,0.0,60.0,60.0
0.006,6,10,1547,5,764,1.0,496.0,496.0,5,783,1.0,515.0,515.0
240.013,6,9,787,5,488,60003.0,232.0,232.0,4,299,80003.0,83.0,83.0
0.009,6,10,1990,5,911,2.0,643.0,643.0,5,1079,2.0,811.0,811.0
0.011,6,10,1972,5,910,2.0,642.0,642.0,5,1062,2.0,794.0,794.0
0.001,17,2,166,1,75,0.0,47.0,47.0,1,91,0.0,63.0,63.0
0.339,17,43,20273,24,17196,14.0,1350.0,688.0,19,3077,14.0,1350.0,133.0
0.005,6,10,1689,5,839,1.0,571.0,571.0,5,850,1.0,582.0,582.0
0.004,6,10,2000,5,927,1.0,659.0,659.0,5,1073,1.0,805.0,805.0
324.911,17,18,1008,9,640,40597.0,48.0,43.0,9,368,40597.0,20.0,12.0
0.011,6,10,1972,5,910,2.0,642.0,642.0,5,1062,2.0,794.0,794.0
0.004,6,10,2006,5,927,1.0,659.0,659.0,5,1079,1.0,811.0,811.0
40.065,17,10,676,5,460,10015.0,104.0,64.0,5,216,10015.0,20.0,15.0
0.066,17,8,3613,4,1874,22.0,1350.0,440.0,4,1739,11.0,1350.0,406.0
0.005,6,10,1547,5,764,1.0,496.0,496.0,5,783,1.0,515.0,515.0
0.005,6,10,1989,5,927,1.0,659.0,659.0,5,1062,1.0,794.0,794.0
241.201,6,372,347447,194,21622,1249.0,2736.0,960.0,178,325825,1362.0,4136.0,1884.0
0.219,6,10,1506,5,395,36.0,127.0,127.0,5,1111,39.0,843.0,843.0
0.001,17,2,180,1,65,0.0,37.0,37.0,1,115,0.0,87.0,87.0
0.004,6,10,1702,5,863,1.0,595.0,595.0,5,839,0.0,571.0,571.0
0.015,6,10,1989,5,910,3.0,642.0,642.0,5,1079,3.0,811.0,811.0
0.059,17,2,152,1,76,0.0,48.0,48.0,1,76,0.0,48.0,48.0
0.005,6,10,1547,5,764,1.0,496.0,496.0,5,783,1.0,515.0,515.0
0.015,6,10,1989,5,910,3.0,642.0,642.0,5,1079,3.0,811.0,811.0
0.125,6,10,1506,5,395,27.0,127.0,127.0,5,1111,28.0,843.0,843.0
40.062,17,10,676,5,460,10012.0,104.0,64.0,5,216,10007.0,20.0,15.0
0.158,6,10,1506,5,395,37.0,127.0,127.0,5,1111,31.0,843.0,843.0
0.042,17,2,136,1,60,0.0,32.0,32.0,1,76,0.0,48.0,48.0
0.004,6,10,2007,5,928,1.0,660.0,660.0,5,1079,1.0,811.0,811.0
0.001,17,2,180,1,66,0.0,38.0,38.0,1,114,0.0,86.0,86.0
0.09,6,10,1506,5,395,18.0,127.0,127.0,5,1111,18.0,843.0,843.0
0.004,17,4,420,2,122,0.0,33.0,33.0,2,298,0.0,145.0,121.0
309.093,17,20,1124,10,716,34328.0,48.0,43.0,10,408,34328.0,20.0,12.0
0.004,6,10,2007,5,928,1.0,660.0,660.0,5,1079,1.0,811.0,811.0
0.001,17,2,180,1,66,0.0,38.0,38.0,1,114,0.0,86.0,86.0
0.005,17,2,170,1,65,0.0,37.0,37.0,1,105,0.0,77.0,77.0
0.027,6,10,1972,5,910,6.0,642.0,642.0,5,1062,6.0,794.0,794.0
0.006,6,10,1547,5,764,1.0,496.0,496.0,5,783,1.0,515.0,515.0
0.005,6,10,1689,5,839,1.0,571.0,571.0,5,850,1.0,582.0,582.0
0.006,6,10,1643,5,860,1.0,592.0,592.0,5,783,1.0,515.0,515.0
0.005,17,2,230,1,68,0.0,40.0,40.0,1,162,0.0,134.0,134.0
40.076,17,10,676,5,460,10016.0,104.0,64.0,5,216,10018.0,20.0,15.0
0.014,6,10,1972,5,910,3.0,642.0,642.0,5,1062,3.0,794.0,794.0
0.415,6,18,5700,10,906,46.0,177.0,177.0,8,4794,58.0,1402.0,1089.0
0.004,6,10,2000,5,927,1.0,659.0,659.0,5,1073,1.0,805.0,805.0
240.55,6,33,8638,17,1837,15032.0,570.0,189.0,16,6801,16033.0,1402.0,597.0
0.006,6,10,2000,5,927,1.0,659.0,659.0,5,1073,1.0,805.0,805.0
0.111,6,10,1506,5,395,26.0,127.0,127.0,5,1111,23.0,843.0,843.0
0.004,6,10,1779,5,928,1.0,660.0,660.0,5,851,1.0,583.0,583.0
0.01,6,10,1989,5,910,2.0,642.0,642.0,5,1079,2.0,811.0,811.0
0.175,6,11,2944,6,497,35.0,177.0,177.0,5,2447,42.0,1402.0,1089.0
0.148,6,10,1506,5,395,34.0,127.0,127.0,5,1111,32.0,843.0,843.0
0.013,6,10,1990,5,911,3.0,643.0,643.0,5,1079,3.0,811.0,811.0
240.273,6,45,8875,23,5790,10921.0,1368.0,458.0,22,3085,11441.0,580.0,241.0
1798.602,17,2831,216239,1408,114110,1278.0,84.0,53.0,1423,102129,1264.0,227.0,43.0
0.039,17,4,284,2,120,0.0,32.0,32.0,2,164,35.0,60.0,54.0
0.013,6,10,1989,5,910,3.0,642.0,642.0,5,1079,3.0,811.0,811.0
0.009,6,10,1631,5,848,2.0,580.0,580.0,5,783,2.0,515.0,515.0
0.114,6,10,1506,5,395,26.0,127.0,127.0,5,1111,20.0,843.0,843.0
40.085,17,10,676,5,460,10020.0,104.0,64.0,5,216,10020.0,20.0,15.0
0.003,17,2,136,1,60,0.0,32.0,32.0,1,76,0.0,48.0,48.0
40.068,17,10,676,5,460,10015.0,104.0,64.0,5,216,10015.0,20.0,15.0
0.017,6,10,1972,5,910,4.0,642.0,642.0,5,1062,4.0,794.0,794.0
0.008,6,10,1990,5,911,2.0,643.0,643.0,5,1079,2.0,811.0,811.0
0.071,6,10,1506,5,395,14.0,127.0,127.0,5,1111,17.0,843.0,843.0
0.014,6,10,1762,5,911,3.0,643.0,643.0,5,851,3.0,583.0,583.0
0.01,6,10,1972,5,910,2.0,642.0,642.0,5,1062,2.0,794.0,794.0
1780.861,6,87,4628,44,2340,41414.0,26.0,26.0,43,2288,42400.0,26.0,26.0
0.006,17,2,424,1,72,0.0,44.0,44.0,1,352,0.0,324.0,324.0
0.005,17,2,140,1,62,0.0,34.0,34.0,1,78,0.0,50.0,50.0
0.004,6,10,2000,5,927,1.0,659.0,659.0,5,1073,1.0,805.0,805.0
0.008,6,10,1702,5,863,1.0,595.0,595.0,5,839,1.0,571.0,571.0
0.004,17,2,148,1,60,0.0,32.0,32.0,1,88,0.0,60.0,60.0
0.013,6,10,1989,5,910,3.0,642.0,642.0,5,1079,3.0,811.0,811.0
0.004,6,10,2007,5,928,1.0,660.0,660.0,5,1079,1.0,811.0,811.0
0.001,17,2,180,1,66,0.0,38.0,38.0,1,114,0.0,86.0,86.0
0.005,17,2,180,1,66,0.0,38.0,38.0,1,114,0.0,86.0,86.0
0.004,6,10,2000,5,927,1.0,659.0,659.0,5,1073,1.0,805.0,805.0
0.005,17,4,284,2,120,0.0,32.0,32.0,2,164,1.0,60.0,54.0
0.016,6,10,1990,5,911,4.0,643.0,643.0,5,1079,3.0,811.0,811.0
0.013,6,10,1990,5,911,3.0,643.0,643.0,5,1079,3.0,811.0,811.0
0.083,6,10,1506,5,395,18.0,127.0,127.0,5,1111,17.0,843.0,843.0
0.091,6,10,1506,5,395,20.0,127.0,127.0,5,1111,18.0,843.0,843.0
0.117,6,10,1506,5,395,24.0,127.0,127.0,5,1111,25.0,843.0,843.0
0.01,6,10,1631,5,848,2.0,580.0,580.0,5,783,2.0,515.0,515.0
0.009,6,10,1677,5,827,2.0,559.0,559.0,5,850,2.0,582.0,582.0
0.001,17,2,180,1,66,0.0,38.0,38.0,1,114,0.0,86.0,86.0
0.087,6,10,1506,5,395,17.0,127.0,127.0,5,1111,18.0,843.0,843.0
0.005,6,10,2000,5,927,1.0,659.0,659.0,5,1073,1.0,805.0,805.0
0.005,6,10,2006,5,927,1.0,659.0,659.0,5,1079,1.0,811.0,811.0
0.084,6,10,1506,5,395,18.0,127.0,127.0,5,1111,18.0,843.0,843.0
0.003,17,2,148,1,60,0.0,32.0,32.0,1,88,0.0,60.0,60.0
0.01,6,10,1990,5,911,2.0,643.0,643.0,5,1079,2.0,811.0,811.0
0.087,6,10,1506,5,395,18.0,127.0,127.0,5,1111,18.0,843.0,843.0
0.009,6,10,1989,5,910,2.0,642.0,642.0,5,1079,2.0,811.0,811.0
0.004,6,10,2007,5,928,1.0,660.0,660.0,5,1079,1.0,811.0,811.0
0.061,6,10,1506,5,395,14.0,127.0,127.0,5,1111,14.0,843.0,843.0
0.006,6,10,1547,5,764,1.0,496.0,496.0,5,783,1.0,515.0,515.0
240.114,6,32,9503,16,6968,16007.0,2040.0,682.0,16,2535,16007.0,580.0,211.0
0.012,6,10,1990,5,911,2.0,643.0,643.0,5,1079,3.0,811.0,811.0
295.015,6,312,343980,120,17817,2479.0,2697.0,889.0,192,326163,1544.0,2804.0,1776.0
0.005,6,10,1689,5,839,1.0,571.0,571.0,5,850,1.0,582.0,582.0
0.014,6,10,1972,5,910,3.0,642.0,642.0,5,1062,3.0,794.0,794.0
0.087,6,10,1506,5,395,20.0,127.0,127.0,5,1111,17.0,843.0,843.0
0.005,6,10,2006,5,927,1.0,659.0,659.0,5,1079,1.0,811.0,811.0
0.005,6,10,2006,5,927,1.0,659.0,659.0,5,1079,1.0,811.0,811.0
0.004,17,2,136,1,60,0.0,32.0,32.0,1,76,0.0,48.0,48.0
0.041,17,4,284,2,120,0.0,32.0,32.0,2,164,38.0,60.0,54.0
0.014,6,10,1989,5,910,3.0,642.0,642.0,5,1079,3.0,811.0,811.0
0.013,6,10,1989,5,910,3.0,642.0,642.0,5,1079,3.0,811.0,811.0
0.149,6,10,1506,5,395,35.0,127.0,127.0,5,1111,25.0,843.0,843.0
0.111,6,10,1506,5,395,25.0,127.0,127.0,5,1111,25.0,843.0,843.0
0.005,17,2,186,1,61,0.0,33.0,33.0,1,125,0.0,97.0,97.0
0.012,6,10,1989,5,910,3.0,642.0,642.0,5,1079,3.0,811.0,811.0
0.005,6,13,3747,7,509,0.0,137.0,137.0,6,3238,1.0,1470.0,1459.0
0.01,6,10,1677,5,827,2.0,559.0,559.0,5,850,2.0,582.0,582.0
0.005,6,10,1854,5,889,1.0,621.0,621.0,5,965,1.0,697.0,697.0
40.094,17,10,676,5,460,10022.0,104.0,64.0,5,216,10022.0,20.0,15.0
290.763,6,380,347704,196,21752,1491.0,2736.0,888.0,184,325952,1588.0,2804.0,1861.0
300.361,6,16,2170,9,684,37524.0,146.0,146.0,7,1486,50032.0,419.0,398.0
0.005,17,2,170,1,65,0.0,37.0,37.0,1,105,0.0,77.0,77.0
0.005,17,2,158,1,63,0.0,35.0,35.0,1,95,0.0,67.0,67.0
0.005,6,10,2006,5,927,1.0,659.0,659.0,5,1079,1.0,811.0,811.0
40.063,17,10,676,5,460,10014.0,104.0,64.0,5,216,10015.0,20.0,15.0
0.015,17,2,198,1,91,0.0,63.0,63.0,1,107,0.0,79.0,79.0
0.005,17,2,140,1,62,0.0,34.0,34.0,1,78,0.0,50.0,50.0
0.005,6,14,3736,7,446,0.0,74.0,74.0,7,3290,0.0,1448.0,972.0
315.95,17,20,1124,10,716,35091.0,48.0,43.0,10,408,35091.0,20.0,12.0
0.102,6,10,1506,5,395,22.0,127.0,127.0,5,1111,23.0,843.0,843.0
0.001,17,2,166,1,75,0.0,47.0,47.0,1,91,0.0,63.0,63.0
0.005,6,10,1547,5,764,1.0,496.0,496.0,5,783,1.0,515.0,515.0
0.071,17,2,184,1,61,0.0,33.0,33.0,1,123,0.0,95.0,95.0
361.824,6,21,1792,16,1030,24121.0,190.0,190.0,5,762,60009.0,461.0,247.0
0.282,6,16,2782,8,1400,40.0,533.0,325.0,8,1382,27.0,529.0,239.0
0.036,6,14,3868,7,578,6.0,206.0,206.0,7,3290,6.0,1448.0,972.0
308.885,17,18,1008,9,640,38594.0,48.0,43.0,9,368,38594.0,20.0,12.0
0.011,6,13,3735,7,497,1.0,125.0,125.0,6,3238,2.0,1470.0,1459.0
0.008,6,10,1989,5,910,1.0,642.0,642.0,5,1079,2.0,811.0,811.0
0.093,6,10,1506,5,395,20.0,127.0,127.0,5,1111,20.0,843.0,843.0
0.125,6,10,1506,5,395,26.0,127.0,127.0,5,1111,24.0,843.0,843.0
0.003,17,2,148,1,60,0.0,32.0,32.0,1,88,0.0,60.0,60.0
0.019,6,10,1989,5,910,4.0,642.0,642.0,5,1079,4.0,811.0,811.0
0.005,6,10,1689,5,839,1.0,571.0,571.0,5,850,1.0,582.0,582.0
0.004,17,2,136,1,60,0.0,32.0,32.0,1,76,0.0,48.0,48.0
0.037,17,2,136,1,60,0.0,32.0,32.0,1,76,0.0,48.0,48.0
0.004,6,10,1989,5,927,1.0,659.0,659.0,5,1062,1.0,794.0,794.0
0.08,6,10,1506,5,395,17.0,127.0,127.0,5,1111,19.0,843.0,843.0
0.175,17,2,152,1,76,0.0,48.0,48.0,1,76,0.0,48.0,48.0
0.117,6,10,1506,5,395,24.0,127.0,127.0,5,1111,24.0,843.0,843.0
0.005,17,2,156,1,64,0.0,36.0,36.0,1,92,0.0,64.0,64.0
0.004,6,10,2006,5,927,1.0,659.0,659.0,5,1079,1.0,811.0,811.0
0.112,6,10,1506,5,395,27.0,127.0,127.0,5,1111,26.0,843.0,843.0
0.005,6,10,1774,5,923,1.0,655.0,655.0,5,851,1.0,583.0,583.0
0.005,6,10,1989,5,927,1.0,659.0,659.0,5,1062,1.0,794.0,794.0
40.057,17,10,676,5,460,10013.0,104.0,64.0,5,216,10013.0,20.0,15.0
0.011,6,10,1983,5,910,2.0,642.0,642.0,5,1073,2.0,805.0,805.0
15.069,17,15,9238,8,6902,2148.0,1350.0,834.0,7,2336,2506.0,1350.0,305.0
290.11,6,397,348821,187,21291,1559.0,2736.0,889.0,210,327530,1388.0,2804.0,1615.0
0.024,6,10,1989,5,910,6.0,642.0,642.0,5,1079,5.0,811.0,811.0
0.039,17,4,420,2,122,1.0,33.0,33.0,2,298,35.0,145.0,121.0
0.005,6,10,2006,5,927,1.0,659.0,659.0,5,1079,1.0,811.0,811.0
0.013,6,10,1762,5,911,3.0,643.0,643.0,5,851,3.0,583.0,583.0
0.169,17,2,152,1,76,0.0,48.0,48.0,1,76,0.0,48.0,48.0
40.071,17,10,676,5,460,10016.0,104.0,64.0,5,216,10017.0,20.0,15.0
1759.501,6,461,67485,257,35517,6873.0,613.0,195.0,204,31968,8667.0,453.0,148.0
0.016,17,2,198,1,91,0.0,63.0,63.0,1,107,0.0,79.0,79.0
0.003,17,4,284,2,120,0.0,32.0,32.0,2,164,0.0,60.0,54.0
0.01,6,10,1547,5,764,2.0,496.0,496.0,5,783,2.0,515.0,515.0
0.001,17,2,142,1,63,0.0,35.0,35.0,1,79,0.0,51.0,51.0
0.004,6,10,1779,5,928,1.0,660.0,660.0,5,851,1.0,583.0,583.0
0.117,6,10,1506,5,395,28.0,127.0,127.0,5,1111,24.0,843.0,843.0
15.319,17,45,22101,24,18521,664.0,1350.0,743.0,21,3580,764.0,1350.0,142.0
0.005,17,2,164,1,74,0.0,46.0,46.0,1,90,0.0,62.0,62.0
0.017,6,10,1990,5,911,4.0,643.0,643.0,5,1079,4.0,811.0,811.0
0.013,17,2,152,1,56,0.0,28.0,28.0,1,96,0.0,68.0,68.0
0.124,17,4,284,2,120,1.0,32.0,32.0,2,164,120.0,60.0,54.0
0.011,6,10,1989,5,910,2.0,642.0,642.0,5,1079,2.0,811.0,811.0
0.004,6,10,2007,5,928,1.0,660.0,660.0,5,1079,1.0,811.0,811.0
0.005,6,10,2006,5,927,1.0,659.0,659.0,5,1079,1.0,811.0,811.0
0.037,17,2,182,1,65,0.0,37.0,37.0,1,117,0.0,89.0,89.0
0.006,6,10,1547,5,764,1.0,496.0,496.0,5,783,1.0,515.0,515.0
11.6,17,28,4395,14,2313,883.0,588.0,137.0,14,2082,883.0,269.0,120.0
0.01,17,2,140,1,62,0.0,34.0,34.0,1,78,0.0,50.0,50.0
0.083,6,10,1506,5,395,18.0,127.0,127.0,5,1111,18.0,843.0,843.0
0.005,17,2,144,1,64,0.0,36.0,36.0,1,80,0.0,52.0,52.0
0.01,6,10,1989,5,910,2.0,642.0,642.0,5,1079,2.0,811.0,811.0
0.005,6,10,2006,5,927,1.0,659.0,659.0,5,1079,1.0,811.0,811.0
294.451,6,405,348977,198,21869,1494.0,2736.0,771.0,207,327108,1429.0,2804.0,1639.0
0.173,17,2,152,1,76,0.0,48.0,48.0,1,76,0.0,48.0,48.0
0.005,6,13,3747,7,509,0.0,137.0,137.0,6,3238,0.0,1470.0,1459.0
44.281,6,39,10487,19,4889,498.0,1360.0,682.0,20,5598,2321.0,2667.0,435.0
0.005,6,10,2007,5,928,1.0,660.0,660.0,5,1079,1.0,811.0,811.0
0.012,6,10,1990,5,911,2.0,643.0,643.0,5,1079,2.0,811.0,811.0
0.005,6,10,1779,5,928,1.0,660.0,660.0,5,851,1.0,583.0,583.0
0.218,17,4,596,2,122,147.0,33.0,33.0,2,474,176.0,323.0,209.0
0.001,17,2,174,1,72,0.0,44.0,44.0,1,102,0.0,74.0,74.0
0.116,6,10,1506,5,395,23.0,127.0,127.0,5,1111,24.0,843.0,843.0
0.004,17,2,148,1,60,0.0,32.0,32.0,1,88,0.0,60.0,60.0
0.005,6,10,2000,5,927,1.0,659.0,659.0,5,1073,1.0,805.0,805.0
0.014,6,10,1972,5,910,3.0,642.0,642.0,5,1062,3.0,794.0,794.0
0.014,6,10,1972,5,910,3.0,642.0,642.0,5,1062,3.0,794.0,794.0
0.007,6,10,2000,5,927,1.0,659.0,659.0,5,1073,1.0,805.0,805.0
0.012,6,10,1989,5,910,2.0,642.0,642.0,5,1079,3.0,811.0,811.0
0.005,6,10,2007,5,928,1.0,660.0,660.0,5,1079,1.0,811.0,811.0
0.731,6,22,5072,11,1250,63.0,325.0,133.0,11,3822,61.0,1414.0,563.0
0.121,6,10,1506,5,395,27.0,127.0,127.0,5,1111,25.0,843.0,843.0
0.163,6,10,1266,5,775,40.0,519.0,519.0,5,491,39.0,223.0,223.0
0.004,6,10,2007,5,928,1.0,660.0,660.0,5,1079,1.0,811.0,811.0
0.004,6,10,1989,5,927,1.0,659.0,659.0,5,1062,1.0,794.0,794.0
0.003,17,2,136,1,60,0.0,32.0,32.0,1,76,0.0,48.0,48.0
0.005,6,10,2006,5,927,1.0,659.0,659.0,5,1079,1.0,811.0,811.0
0.103,6,10,1506,5,395,22.0,127.0,127.0,5,1111,21.0,843.0,843.0
0.11,6,10,1506,5,395,25.0,127.0,127.0,5,1111,25.0,843.0,843.0
0.039,17,2,148,1,60,0.0,32.0,32.0,1,88,0.0,60.0,60.0
40.072,17,10,676,5,460,10014.0,104.0,64.0,5,216,10017.0,20.0,15.0
0.005,6,10,1989,5,927,1.0,659.0,659.0,5,1062,1.0,794.0,794.0
0.009,6,10,1989,5,910,2.0,642.0,642.0,5,1079,2.0,811.0,811.0
10.81,17,28,4418,14,1994,823.0,269.0,114.0,14,2424,823.0,587.0,145.0
0.005,6,13,3747,7,509,0.0,137.0,137.0,6,3238,1.0,1470.0,1459.0
0.079,6,10,1506,5,395,17.0,127.0,127.0,5,1111,17.0,843.0,843.0
0.008,17,2,194,1,59,0.0,31.0,31.0,1,135,0.0,107.0,107.0
0.019,6,10,1990,5,911,4.0,643.0,643.0,5,1079,4.0,811.0,811.0
0.085,6,10,1506,5,395,18.0,127.0,127.0,5,1111,19.0,843.0,843.0
0.094,6,10,1506,5,395,21.0,127.0,127.0,5,1111,20.0,843.0,843.0
0.004,6,10,1702,5,863,1.0,595.0,595.0,5,839,0.0,571.0,571.0
0.085,6,10,1506,5,395,16.0,127.0,127.0,5,1111,18.0,843.0,843.0
308.911,17,20,1124,10,716,34316.0,48.0,43.0,10,408,34316.0,20.0,12.0
0.069,6,10,1506,5,395,15.0,127.0,127.0,5,1111,15.0,843.0,843.0
0.011,6,10,1989,5,910,2.0,642.0,642.0,5,1079,2.0,811.0,811.0
1756.751,6,126,12540,70,4812,25459.0,517.0,64.0,56,7728,31940.0,1402.0,228.0
0.006,6,14,3736,7,446,0.0,74.0,74.0,7,3290,1.0,1448.0,972.0
15.08,17,16,8392,8,6138,2150.0,1350.0,739.0,8,2254,2150.0,1350.0,253.0
0.005,6,10,2006,5,927,1.0,659.0,659.0,5,1079,1.0,811.0,811.0
353.988,6,21,1795,16,1030,23599.0,190.0,190.0,5,765,60001.0,464.0,248.0
305.314,17,16,928,8,608,43607.0,48.0,48.0,8,320,43607.0,12.0,12.0
0.005,6,10,2000,5,927,1.0,659.0,659.0,5,1073,1.0,805.0,805.0
0.004,17,2,136,1,60,0.0,32.0,32.0,1,76,0.0,48.0,48.0
240.098,6,16,4482,9,963,30012.0,238.0,166.0,7,3519,40015.0,1402.0,786.0
0.012,6,10,1989,5,910,3.0,642.0,642.0,5,1079,3.0,811.0,811.0
0.096,6,10,1506,5,395,22.0,127.0,127.0,5,1111,18.0,843.0,843.0
368.749,6,24,2405,17,919,23046.0,195.0,195.0,7,1486,3904.0,419.0,398.0
289.673,6,397,349058,196,21756,1485.0,2736.0,888.0,201,327302,1448.0,2804.0,1694.0
0.077,6,10,1506,5,395,17.0,127.0,127.0,5,1111,18.0,843.0,843.0
0.005,6,10,2007,5,928,1.0,660.0,660.0,5,1079,1.0,811.0,811.0
0.006,6,10,1643,5,860,1.0,592.0,592.0,5,783,1.0,515.0,515.0
0.019,6,10,1989,5,910,4.0,642.0,642.0,5,1079,4.0,811.0,811.0
1772.617,17,120,11460,60,5460,30044.0,63.0,63.0,60,6000,30044.0,72.0,72.0
0.053,17,2,152,1,76,0.0,48.0,48.0,1,76,0.0,48.0,48.0
0.07,17,8,3613,4,1874,23.0,1350.0,440.0,4,1739,11.0,1350.0,406.0
0.015,6,10,1631,5,848,3.0,580.0,580.0,5,783,3.0,515.0,515.0
0.006,6,10,1689,5,839,1.0,571.0,571.0,5,850,1.0,582.0,582.0
0.042,17,2,179,1,71,0.0,43.0,43.0,1,108,0.0,80.0,80.0
0.005,6,10,2007,5,928,1.0,660.0,660.0,5,1079,1.0,811.0,811.0
0.01,6,10,1631,5,848,2.0,580.0,580.0,5,783,2.0,515.0,515.0
0.003,17,2,148,1,60,0.0,32.0,32.0,1,88,0.0,60.0,60.0
0.042,17,4,352,2,130,1.0,37.0,37.0,2,222,2.0,89.0,83.0
0.006,6,10,1643,5,860,1.0,592.0,592.0,5,783,1.0,515.0,515.0
0.005,6,10,2007,5,928,1.0,660.0,660.0,5,1079,1.0,811.0,811.0
0.005,17,2,144,1,64,0.0,36.0,36.0,1,80,0.0,52.0,52.0
0.113,6,10,1506,5,395,24.0,127.0,127.0,5,1111,22.0,843.0,843.0
0.003,17,2,136,1,60,0.0,32.0,32.0,1,76,0.0,48.0,48.0
0.113,6,10,1506,5,395,25.0,127.0,127.0,5,1111,26.0,843.0,843.0
106.428,6,24,9399,11,1575,71.0,794.0,367.0,13,7824,8858.0,1360.0,810.0
0.084,6,10,1506,5,395,18.0,127.0,127.0,5,1111,20.0,843.0,843.0
0.005,6,10,1774,5,923,1.0,655.0,655.0,5,851,1.0,583.0,583.0
0.005,17,2,166,1,75,0.0,47.0,47.0,1,91,0.0,63.0,63.0
0.004,17,2,136,1,60,0.0,32.0,32.0,1,76,0.0,48.0,48.0
0.005,17,2,144,1,64,0.0,36.0,36.0,1,80,0.0,52.0,52.0
0.01,6,10,1989,5,910,2.0,642.0,642.0,5,1079,2.0,811.0,811.0
0.076,6,10,1506,5,395,12.0,127.0,127.0,5,1111,18.0,843.0,843.0
0.005,17,2,136,1,60,0.0,32.0,32.0,1,76,0.0,48.0,48.0
0.089,6,10,1506,5,395,16.0,127.0,127.0,5,1111,19.0,843.0,843.0
1786.231,6,154,19574,92,13852,19628.0,302.0,302.0,62,5722,29282.0,83.0,83.0
0.012,6,10,1989,5,910,3.0,642.0,642.0,5,1079,2.0,811.0,811.0
0.106,6,10,1506,5,395,24.0,127.0,127.0,5,1111,25.0,843.0,843.0
0.009,6,13,3913,7,495,1.0,123.0,123.0,6,3418,1.0,1650.0,1549.0
0.011,6,10,1972,5,910,2.0,642.0,642.0,5,1062,2.0,794.0,794.0
0.012,6,10,1989,5,910,3.0,642.0,642.0,5,1079,2.0,811.0,811.0
0.013,17,2,152,1,56,0.0,28.0,28.0,1,96,0.0,68.0,68.0
0.018,6,10,1972,5,910,4.0,642.0,642.0,5,1062,4.0,794.0,794.0
0.004,6,10,2007,5,928,1.0,660.0,660.0,5,1079,1.0,811.0,811.0
0.019,6,10,1677,5,827,4.0,559.0,559.0,5,850,4.0,582.0,582.0
0.008,6,10,1989,5,927,2.0,659.0,659.0,5,1062,1.0,794.0,794.0
0.005,6,10,2006,5,927,1.0,659.0,659.0,5,1079,1.0,811.0,811.0
0.017,6,10,1990,5,911,4.0,643.0,643.0,5,1079,4.0,811.0,811.0
0.132,6,10,1506,5,395,23.0,127.0,127.0,5,1111,28.0,843.0,843.0
0.075,6,10,1506,5,395,17.0,127.0,127.0,5,1111,15.0,843.0,843.0
0.012,6,10,1989,5,910,3.0,642.0,642.0,5,1079,2.0,811.0,811.0
0.006,6,10,1547,5,764,1.0,496.0,496.0,5,783,1.0,515.0,515.0
0.005,6,13,3747,7,509,0.0,137.0,137.0,6,3238,0.0,1470.0,1459.0
0.008,6,10,1762,5,911,2.0,643.0,643.0,5,851,2.0,583.0,583.0
0.026,6,10,1631,5,848,6.0,580.0,580.0,5,783,6.0,515.0,515.0
0.165,6,10,1506,5,395,33.0,127.0,127.0,5,1111,38.0,843.0,843.0
0.121,6,10,1506,5,395,28.0,127.0,127.0,5,1111,27.0,843.0,843.0
0.001,17,2,166,1,75,0.0,47.0,47.0,1,91,0.0,63.0,63.0
0.165,17,2,152,1,76,0.0,48.0,48.0,1,76,0.0,48.0,48.0
0.004,6,10,2000,5,927,1.0,659.0,659.0,5,1073,1.0,805.0,805.0
0.005,17,2,144,1,64,0.0,36.0,36.0,1,80,0.0,52.0,52.0
0.06,6,10,1506,5,395,14.0,127.0,127.0,5,1111,12.0,843.0,843.0
0.005,6,13,3690,7,452,0.0,80.0,80.0,6,3238,1.0,1470.0,1459.0
0.004,17,2,904,1,576,0.0,548.0,548.0,1,328,0.0,300.0,300.0
0.005,6,10,2006,5,927,1.0,659.0,659.0,5,1079,1.0,811.0,811.0
0.023,6,10,1989,5,910,5.0,642.0,642.0,5,1079,5.0,811.0,811.0
0.016,6,13,3735,7,497,2.0,125.0,125.0,6,3238,3.0,1470.0,1459.0
0.005,6,10,1989,5,927,1.0,659.0,659.0,5,1062,1.0,794.0,794.0
10.986,17,28,4389,14,2311,836.0,586.0,137.0,14,2078,836.0,269.0,120.0
0.004,6,10,2007,5,928,1.0,660.0,660.0,5,1079,1.0,811.0,811.0
0.005,6,10,2000,5,927,1.0,659.0,659.0,5,1073,1.0,805.0,805.0
11.002,17,29,4566,15,2167,777.0,270.0,116.0,14,2399,837.0,586.0,143.0
0.087,6,10,1506,5,395,17.0,127.0,127.0,5,1111,20.0,843.0,843.0
0.133,17,2,182,1,65,0.0,37.0,37.0,1,117,0.0,89.0,89.0
0.013,6,10,1631,5,848,3.0,580.0,580.0,5,783,3.0,515.0,515.0
0.011,6,10,1983,5,910,2.0,642.0,642.0,5,1073,2.0,805.0,805.0
0.006,6,10,1547,5,764,1.0,496.0,496.0,5,783,1.0,515.0,515.0
0.005,6,10,2007,5,928,1.0,660.0,660.0,5,1079,1.0,811.0,811.0
0.01,6,10,1983,5,910,2.0,642.0,642.0,5,1073,2.0,805.0,805.0
0.369,17,45,25868,25,21223,15.0,1350.0,820.0,20,4645,16.0,1350.0,204.0
296.369,6,391,348224,196,21765,1519.0,2736.0,889.0,195,326459,1527.0,2804.0,1747.0
0.08,6,10,1506,5,395,16.0,127.0,127.0,5,1111,18.0,843.0,843.0
240.52,6,33,9267,16,1835,16032.0,623.0,199.0,17,7432,15030.0,1402.0,595.0
0.006,6,10,2006,5,927,1.0,659.0,659.0,5,1079,1.0,811.0,811.0
0.005,6,10,1779,5,928,1.0,660.0,660.0,5,851,1.0,583.0,583.0
0.11,6,10,1506,5,395,23.0,127.0,127.0,5,1111,24.0,843.0,843.0
0.102,6,10,1506,5,395,20.0,127.0,127.0,5,1111,18.0,843.0,843.0
0.003,17,2,142,1,63,0.0,35.0,35.0,1,79,0.0,51.0,51.0
0.005,6,10,1689,5,839,1.0,571.0,571.0,5,850,1.0,582.0,582.0
0.004,17,4,284,2,120,1.0,32.0,32.0,2,164,0.0,60.0,54.0
0.078,6,10,1506,5,395,17.0,127.0,127.0,5,1111,19.0,843.0,843.0
0.006,6,10,1774,5,923,1.0,655.0,655.0,5,851,1.0,583.0,583.0
0.092,6,10,1506,5,395,22.0,127.0,127.0,5,1111,21.0,843.0,843.0
0.005,6,10,2006,5,927,1.0,659.0,659.0,5,1079,1.0,811.0,811.0
0.01,6,10,1983,5,910,2.0,642.0,642.0,5,1073,2.0,805.0,805.0
369.815,6,22,2313,16,867,24654.0,195.0,195.0,6,1446,4637.0,419.0,398.0
0.006,6,14,3799,7,509,0.0,137.0,137.0,7,3290,0.0,1448.0,972.0
0.012,6,10,1990,5,911,3.0,643.0,643.0,5,1079,2.0,811.0,811.0
0.014,6,10,1972,5,910,3.0,642.0,642.0,5,1062,3.0,794.0,794.0
0.005,17,2,262,1,66,0.0,38.0,38.0,1,196,0.0,168.0,168.0
0.006,6,10,1547,5,764,1.0,496.0,496.0,5,783,1.0,515.0,515.0
371.249,6,24,2405,17,919,23203.0,195.0,195.0,7,1486,3914.0,419.0,398.0
0.039,17,2,182,1,65,0.0,37.0,37.0,1,117,0.0,89.0,89.0
0.005,6,10,1854,5,889,1.0,621.0,621.0,5,965,1.0,697.0,697.0
0.1,6,10,1506,5,395,21.0,127.0,127.0,5,1111,21.0,843.0,843.0
0.041,17,2,152,1,76,0.0,48.0,48.0,1,76,0.0,48.0,48.0
0.015,6,10,1631,5,848,3.0,580.0,580.0,5,783,3.0,515.0,515.0
0.011,6,10,1972,5,910,2.0,642.0,642.0,5,1062,2.0,794.0,794.0
0.04,17,2,136,1,60,0.0,32.0,32.0,1,76,0.0,48.0,48.0
0.004,6,10,2007,5,928,1.0,660.0,660.0,5,1079,1.0,811.0,811.0
0.004,6,10,2000,5,927,1.0,659.0,659.0,5,1073,1.0,805.0,805.0
0.005,6,14,3742,7,452,0.0,80.0,80.0,7,3290,0.0,1448.0,972.0
0.005,6,10,1774,5,923,1.0,655.0,655.0,5,851,1.0,583.0,583.0
0.006,17,2,166,1,75,0.0,47.0,47.0,1,91,0.0,63.0,63.0
0.091,6,10,1506,5,395,20.0,127.0,127.0,5,1111,20.0,843.0,843.0
0.01,6,10,1989,5,910,2.0,642.0,642.0,5,1079,2.0,811.0,811.0
0.006,17,2,179,1,71,0.0,43.0,43.0,1,108,0.0,80.0,80.0
0.005,6,14,3742,8,504,0.0,80.0,80.0,6,3238,0.0,1470.0,1459.0
0.004,6,10,1989,5,927,1.0,659.0,659.0,5,1062,1.0,794.0,794.0
0.079,6,10,1506,5,395,17.0,127.0,127.0,5,1111,15.0,843.0,843.0
0.011,6,10,1989,5,910,2.0,642.0,642.0,5,1079,2.0,811.0,811.0
0.005,6,10,2006,5,927,1.0,659.0,659.0,5,1079,1.0,811.0,811.0
0.039,17,4,284,2,120,0.0,32.0,32.0,2,164,36.0,60.0,54.0
0.012,17,2,214,1,75,0.0,47.0,47.0,1,139,0.0,111.0,111.0
0.013,6,10,1983,5,910,3.0,642.0,642.0,5,1073,3.0,805.0,805.0
0.008,6,10,1990,5,911,2.0,643.0,643.0,5,1079,1.0,811.0,811.0
0.006,6,10,1547,5,764,1.0,496.0,496.0,5,783,1.0,515.0,515.0
0.008,6,10,1983,5,910,2.0,642.0,642.0,5,1073,1.0,805.0,805.0
0.013,6,14,3787,7,497,2.0,125.0,125.0,7,3290,2.0,1448.0,972.0
0.033,6,10,1989,5,910,8.0,642.0,642.0,5,1079,8.0,811.0,811.0
0.006,6,10,1989,5,927,1.0,659.0,659.0,5,1062,1.0,794.0,794.0
0.01,6,10,1989,5,910,2.0,642.0,642.0,5,1079,2.0,811.0,811.0
0.005,6,10,2007,5,928,1.0,660.0,660.0,5,1079,1.0,811.0,811.0
0.005,17,2,179,1,71,0.0,43.0,43.0,1,108,0.0,80.0,80.0
0.038,17,2,164,1,74,0.0,46.0,46.0,1,90,0.0,62.0,62.0
0.135,17,2,80,1,32,0.0,4.0,4.0,1,48,0.0,20.0,20.0
0.004,17,2,148,1,60,0.0,32.0,32.0,1,88,0.0,60.0,60.0
0.005,6,10,1989,5,927,1.0,659.0,659.0,5,1062,1.0,794.0,794.0
0.152,6,10,1506,5,395,35.0,127.0,127.0,5,1111,31.0,843.0,843.0
0.086,6,10,1506,5,395,19.0,127.0,127.0,5,1111,20.0,843.0,843.0
10.824,17,28,4420,14,1993,824.0,268.0,114.0,14,2427,824.0,586.0,145.0
0.015,17,2,194,1,59,0.0,31.0,31.0,1,135,0.0,107.0,107.0
0.091,6,10,1677,5,827,22.0,559.0,559.0,5,850,22.0,582.0,582.0
55.217,17,27,16325,15,13460,3940.0,1350.0,869.0,12,2865,5015.0,1350.0,210.0
0.131,17,2,80,1,32,0.0,4.0,4.0,1,48,0.0,20.0,20.0
0.109,6,10,1506,5,395,24.0,127.0,127.0,5,1111,23.0,843.0,843.0
0.17,6,3,453,2,321,170.0,241.0,241.0,1,132,0.0,92.0,92.0
0.006,17,2,170,1,65,0.0,37.0,37.0,1,105,0.0,77.0,77.0
0.021,6,10,1989,5,910,5.0,642.0,642.0,5,1079,5.0,811.0,811.0
240.086,6,16,4480,9,963,30010.0,238.0,166.0,7,3517,40013.0,1402.0,786.0
240.134,6,32,9353,16,6897,16008.0,1968.0,674.0,16,2456,16008.0,580.0,202.0
0.107,6,10,1506,5,395,22.0,127.0,127.0,5,1111,26.0,843.0,843.0
0.004,17,2,148,1,60,0.0,32.0,32.0,1,88,0.0,60.0,60.0
0.016,6,10,1972,5,910,4.0,642.0,642.0,5,1062,3.0,794.0,794.0
0.011,17,2,144,1,64,0.0,36.0,36.0,1,80,0.0,52.0,52.0
0.005,6,10,1643,5,860,1.0,592.0,592.0,5,783,1.0,515.0,515.0
0.006,6,10,1547,5,764,1.0,496.0,496.0,5,783,1.0,515.0,515.0
0.005,17,2,166,1,75,0.0,47.0,47.0,1,91,0.0,63.0,63.0
0.008,6,10,1989,5,910,2.0,642.0,642.0,5,1079,2.0,811.0,811.0
40.058,17,10,676,5,460,10012.0,104.0,64.0,5,216,10013.0,20.0,15.0
0.011,6,10,1989,5,910,2.0,642.0,642.0,5,1079,2.0,811.0,811.0
0.005,17,2,148,1,60,0.0,32.0,32.0,1,88,0.0,60.0,60.0
0.004,6,10,1779,5,928,1.0,660.0,660.0,5,851,0.0,583.0,583.0
0.006,6,10,1854,5,889,1.0,621.0,621.0,5,965,1.0,697.0,697.0
0.003,17,2,148,1,60,0.0,32.0,32.0,1,88,0.0,60.0,60.0
0.006,17,2,194,1,59,0.0,31.0,31.0,1,135,0.0,107.0,107.0
0.054,6,10,1506,5,395,11.0,127.0,127.0,5,1111,12.0,843.0,843.0
0.006,6,10,1547,5,764,1.0,496.0,496.0,5,783,1.0,515.0,515.0
0.007,6,10,2006,5,927,1.0,659.0,659.0,5,1079,1.0,811.0,811.0
0.102,6,10,1506,5,395,21.0,127.0,127.0,5,1111,24.0,843.0,843.0
0.01,6,10,1989,5,910,2.0,642.0,642.0,5,1079,2.0,811.0,811.0
0.007,17,2,148,1,60,0.0,32.0,32.0,1,88,0.0,60.0,60.0
0.083,6,10,1506,5,395,18.0,127.0,127.0,5,1111,16.0,843.0,843.0
0.005,6,10,1779,5,928,1.0,660.0,660.0,5,851,1.0,583.0,583.0
0.005,17,2,148,1,60,0.0,32.0,32.0,1,88,0.0,60.0,60.0
324.849,17,18,1008,9,640,40588.0,48.0,43.0,9,368,40589.0,20.0,12.0
0.01,6,10,1972,5,910,2.0,642.0,642.0,5,1062,2.0,794.0,794.0
0.023,6,10,1989,5,910,5.0,642.0,642.0,5,1079,5.0,811.0,811.0
0.004,6,10,2006,5,927,1.0,659.0,659.0,5,1079,1.0,811.0,811.0
0.005,6,10,1989,5,927,1.0,659.0,659.0,5,1062,1.0,794.0,794.0
0.017,6,10,1989,5,910,4.0,642.0,642.0,5,1079,4.0,811.0,811.0
0.011,6,10,1989,5,910,2.0,642.0,642.0,5,1079,2.0,811.0,811.0
0.062,6,10,1506,5,395,14.0,127.0,127.0,5,1111,13.0,843.0,843.0
0.011,6,13,3735,7,497,1.0,125.0,125.0,6,3238,2.0,1470.0,1459.0
0.004,17,2,136,1,60,0.0,32.0,32.0,1,76,0.0,48.0,48.0
0.005,6,10,1854,5,889,1.0,621.0,621.0,5,965,1.0,697.0,697.0
0.01,17,2,166,1,75,0.0,47.0,47.0,1,91,0.0,63.0,63.0
300.317,6,16,2170,9,684,37519.0,146.0,146.0,7,1486,50025.0,419.0,398.0
0.005,17,2,170,1,65,0.0,37.0,37.0,1,105,0.0,77.0,77.0
0.017,6,10,1990,5,911,4.0,643.0,643.0,5,1079,4.0,811.0,811.0
40.064,17,10,676,5,460,10013.0,104.0,64.0,5,216,10015.0,20.0,15.0
0.075,6,10,1506,5,395,17.0,127.0,127.0,5,1111,15.0,843.0,843.0
0.004,6,10,2006,5,927,1.0,659.0,659.0,5,1079,1.0,811.0,811.0
0.005,6,10,2007,5,928,1.0,660.0,660.0,5,1079,1.0,811.0,811.0
0.168,6,10,1506,5,395,26.0,127.0,127.0,5,1111,40.0,843.0,843.0
0.005,6,10,1989,5,927,1.0,659.0,659.0,5,1062,1.0,794.0,794.0
0.012,6,14,3787,7,497,2.0,125.0,125.0,7,3290,1.0,1448.0,972.0
0.004,6,10,1702,5,863,1.0,595.0,595.0,5,839,0.0,571.0,571.0
0.006,6,10,1643,5,860,1.0,592.0,592.0,5,783,1.0,515.0,515.0
40.077,17,10,676,5,460,10017.0,104.0,64.0,5,216,10018.0,20.0,15.0
15.075,17,14,9190,8,6902,2149.0,1350.0,834.0,6,2288,3009.0,1350.0,353.0
0.004,17,2,136,1,60,0.0,32.0,32.0,1,76,0.0,48.0,48.0
0.171,6,3,453,2,321,171.0,241.0,241.0,1,132,0.0,92.0,92.0
0.011,6,10,1990,5,911,2.0,643.0,643.0,5,1079,2.0,811.0,811.0
0.005,6,10,2006,5,927,1.0,659.0,659.0,5,1079,1.0,811.0,811.0
0.006,6,10,2006,5,927,1.0,659.0,659.0,5,1079,1.0,811.0,811.0
0.077,6,10,1506,5,395,18.0,127.0,127.0,5,1111,17.0,843.0,843.0
0.005,6,10,1689,5,839,1.0,571.0,571.0,5,850,1.0,582.0,582.0
0.001,17,2,180,1,65,0.0,37.0,37.0,1,115,0.0,87.0,87.0
0.022,17,2,136,1,60,0.0,32.0,32.0,1,76,0.0,48.0,48.0
10.817,17,28,4419,14,1995,823.0,270.0,114.0,14,2424,823.0,587.0,145.0
0.006,17,2,146,1,65,0.0,37.0,37.0,1,81,0.0,53.0,53.0
15.072,17,15,9238,8,6902,2149.0,1350.0,834.0,7,2336,2507.0,1350.0,305.0
0.005,6,14,3742,8,504,0.0,80.0,80.0,6,3238,0.0,1470.0,1459.0
0.166,6,10,1506,5,395,37.0,127.0,127.0,5,1111,40.0,843.0,843.0
0.008,6,13,3735,7,497,1.0,125.0,125.0,6,3238,1.0,1470.0,1459.0
0.012,6,10,1762,5,911,3.0,643.0,643.0,5,851,2.0,583.0,583.0
10.82,17,28,4423,14,1995,823.0,270.0,114.0,14,2428,822.0,587.0,145.0
0.013,6,10,1989,5,910,3.0,642.0,642.0,5,1079,3.0,811.0,811.0
240.544,6,33,8640,17,1840,15031.0,573.0,189.0,16,6800,16034.0,1402.0,597.0
240.009,6,9,787,5,488,60002.0,232.0,232.0,4,299,80002.0,83.0,83.0
0.133,6,10,1506,5,395,31.0,127.0,127.0,5,1111,32.0,843.0,843.0
0.011,6,10,1972,5,910,2.0,642.0,642.0,5,1062,2.0,794.0,794.0
0.004,6,10,2006,5,927,1.0,659.0,659.0,5,1079,1.0,811.0,811.0
178.656,17,92,13078,46,3061,3970.0,44.0,38.0,46,10017,3970.0,261.0,189.0
0.066,17,8,3613,4,1874,22.0,1350.0,440.0,4,1739,11.0,1350.0,406.0
0.005,6,10,1643,5,860,1.0,592.0,592.0,5,783,1.0,515.0,515.0
40.074,17,10,676,5,460,10016.0,104.0,64.0,5,216,10017.0,20.0,15.0
0.125,6,10,1506,5,395,25.0,127.0,127.0,5,1111,26.0,843.0,843.0
0.005,6,10,1989,5,927,1.0,659.0,659.0,5,1062,1.0,794.0,794.0
0.071,6,10,1506,5,395,14.0,127.0,127.0,5,1111,15.0,843.0,843.0
0.004,17,4,284,2,120,0.0,32.0,32.0,2,164,1.0,60.0,54.0
0.001,17,2,166,1,75,0.0,47.0,47.0,1,91,0.0,63.0,63.0
0.005,6,10,2000,5,927,1.0,659.0,659.0,5,1073,1.0,805.0,805.0
11.272,17,28,4423,14,1995,854.0,270.0,114.0,14,2428,854.0,587.0,145.0
0.005,17,2,170,1,65,0.0,37.0,37.0,1,105,0.0,77.0,77.0
10.948,17,28,4398,14,2312,833.0,587.0,137.0,14,2086,833.0,269.0,121.0
353.996,6,21,1795,16,1030,23599.0,190.0,190.0,5,765,60002.0,464.0,248.0
0.103,17,8,3613,4,1874,34.0,1350.0,440.0,4,1739,10.0,1350.0,406.0
0.018,6,10,1677,5,827,4.0,559.0,559.0,5,850,4.0,582.0,582.0
0.005,17,2,213,1,69,0.0,41.0,41.0,1,144,0.0,116.0,116.0
0.006,17,2,225,1,65,0.0,37.0,37.0,1,160,0.0,132.0,132.0
40.066,17,10,676,5,460,10014.0,104.0,64.0,5,216,10015.0,20.0,15.0
0.005,6,10,1689,5,839,1.0,571.0,571.0,5,850,1.0,582.0,582.0
0.006,17,2,225,1,65,0.0,37.0,37.0,1,160,0.0,132.0,132.0
0.006,6,10,2007,5,928,1.0,660.0,660.0,5,1079,1.0,811.0,811.0
0.012,6,10,1989,5,910,3.0,642.0,642.0,5,1079,3.0,811.0,811.0
40.091,17,10,676,5,460,10013.0,104.0,64.0,5,216,10017.0,20.0,15.0
0.021,6,10,1762,5,911,5.0,643.0,643.0,5,851,5.0,583.0,583.0
0.006,6,10,1547,5,764,1.0,496.0,496.0,5,783,1.0,515.0,515.0
0.005,6,10,1689,5,839,1.0,571.0,571.0,5,850,1.0,582.0,582.0
0.039,17,2,170,1,65,0.0,37.0,37.0,1,105,0.0,77.0,77.0
0.042,17,2,412,1,61,0.0,33.0,33.0,1,351,0.0,323.0,323.0
0.011,6,10,1989,5,910,2.0,642.0,642.0,5,1079,2.0,811.0,811.0
0.005,6,14,3742,7,452,0.0,80.0,80.0,7,3290,0.0,1448.0,972.0
0.019,6,13,3735,7,497,3.0,125.0,125.0,6,3238,3.0,1470.0,1459.0
0.01,6,10,1972,5,910,2.0,642.0,642.0,5,1062,2.0,794.0,794.0
0.006,6,10,1689,5,839,1.0,571.0,571.0,5,850,1.0,582.0,582.0
0.005,6,10,1989,5,927,1.0,659.0,659.0,5,1062,1.0,794.0,794.0
313.816,17,20,1124,10,716,34845.0,48.0,43.0,10,408,34849.0,20.0,12.0
83.02,6,91,71537,51,45002,1660.0,2804.0,1764.0,40,26535,2124.0,2824.0,1286.0
0.094,6,10,1506,5,395,22.0,127.0,127.0,5,1111,21.0,843.0,843.0
0.004,17,4,284,2,120,0.0,32.0,32.0,2,164,0.0,60.0,54.0
0.076,6,10,1506,5,395,15.0,127.0,127.0,5,1111,16.0,843.0,843.0
300.013,6,11,891,6,552,60002.0,232.0,232.0,5,339,75002.0,83.0,83.0
0.208,17,4,352,2,130,121.0,37.0,37.0,2,222,190.0,89.0,83.0
0.082,6,10,1506,5,395,19.0,127.0,127.0,5,1111,18.0,843.0,843.0
308.466,17,16,892,8,564,44058.0,48.0,42.0,8,328,44058.0,20.0,13.0
0.016,6,14,3787,7,497,2.0,125.0,125.0,7,3290,2.0,1448.0,972.0
0.004,6,10,1702,5,863,1.0,595.0,595.0,5,839,0.0,571.0,571.0
0.007,6,10,1989,5,927,1.0,659.0,659.0,5,1062,1.0,794.0,794.0
0.061,6,10,1506,5,395,14.0,127.0,127.0,5,1111,12.0,843.0,843.0
0.004,6,10,2006,5,927,1.0,659.0,659.0,5,1079,1.0,811.0,811.0
0.005,17,2,179,1,71,0.0,43.0,43.0,1,108,0.0,80.0,80.0
240.082,6,16,4481,9,963,30010.0,238.0,166.0,7,3518,40013.0,1402.0,786.0
9.038,17,6,376,5,280,2259.0,28.0,28.0,1,96,0.0,68.0,68.0
0.11,6,10,1506,5,395,26.0,127.0,127.0,5,1111,26.0,843.0,843.0
0.006,6,10,1547,5,764,1.0,496.0,496.0,5,783,1.0,515.0,515.0
0.006,6,10,1689,5,839,1.0,571.0,571.0,5,850,1.0,582.0,582.0
0.016,6,10,1990,5,911,4.0,643.0,643.0,5,1079,4.0,811.0,811.0
1768.953,17,92,8096,46,4048,39309.0,60.0,60.0,46,4048,39309.0,60.0,60.0
0.086,6,10,1506,5,395,19.0,127.0,127.0,5,1111,18.0,843.0,843.0
0.138,6,10,1506,5,395,23.0,127.0,127.0,5,1111,28.0,843.0,843.0
0.005,6,10,2006,5,927,1.0,659.0,659.0,5,1079,1.0,811.0,811.0
0.005,17,2,140,1,62,0.0,34.0,34.0,1,78,0.0,50.0,50.0
0.005,6,10,1989,5,927,1.0,659.0,659.0,5,1062,1.0,794.0,794.0
0.004,17,2,148,1,60,0.0,32.0,32.0,1,88,0.0,60.0,60.0
328.582,17,18,1008,9,640,41056.0,48.0,43.0,9,368,41056.0,20.0,12.0
240.303,6,29,11782,14,5821,18484.0,1756.0,849.0,15,5961,17164.0,1655.0,862.0
0.022,6,10,1983,5,910,5.0,642.0,642.0,5,1073,5.0,805.0,805.0
40.048,17,10,676,5,460,10010.0,104.0,64.0,5,216,10011.0,20.0,15.0
0.011,6,10,1762,5,911,2.0,643.0,643.0,5,851,2.0,583.0,583.0
0.005,17,2,230,1,68,0.0,40.0,40.0,1,162,0.0,134.0,134.0
0.005,6,10,2006,5,927,1.0,659.0,659.0,5,1079,1.0,811.0,811.0
0.014,6,10,1677,5,827,3.0,559.0,559.0,5,850,3.0,582.0,582.0
0.081,6,10,1506,5,395,18.0,127.0,127.0,5,1111,19.0,843.0,843.0
0.012,6,10,1972,5,910,2.0,642.0,642.0,5,1062,2.0,794.0,794.0
0.01,6,10,1983,5,910,2.0,642.0,642.0,5,1073,2.0,805.0,805.0
0.171,17,2,152,1,76,0.0,48.0,48.0,1,76,0.0,48.0,48.0
240.457,6,35,8926,18,2075,14144.0,696.0,226.0,17,6851,15028.0,1402.0,597.0
0.039,17,4,284,2,120,0.0,32.0,32.0,2,164,36.0,60.0,54.0
0.008,6,10,1972,5,910,2.0,642.0,642.0,5,1062,2.0,794.0,794.0
0.007,6,10,1547,5,764,1.0,496.0,496.0,5,783,1.0,515.0,515.0
1779.043,17,142,44872,72,22752,25050.0,288.0,288.0,70,22120,25781.0,288.0,288.0
0.012,6,10,1631,5,848,2.0,580.0,580.0,5,783,3.0,515.0,515.0
0.006,17,2,179,1,71,0.0,43.0,43.0,1,108,0.0,80.0,80.0
0.012,6,10,1983,5,910,3.0,642.0,642.0,5,1073,3.0,805.0,805.0
0.005,6,10,1774,5,923,1.0,655.0,655.0,5,851,1.0,583.0,583.0
0.004,6,10,1779,5,928,1.0,660.0,660.0,5,851,1.0,583.0,583.0
0.004,6,10,2006,5,927,1.0,659.0,659.0,5,1079,1.0,811.0,811.0
0.009,6,10,1990,5,911,2.0,643.0,643.0,5,1079,2.0,811.0,811.0
316.382,17,20,1124,10,716,35137.0,48.0,43.0,10,408,35138.0,20.0,12.0
0.005,6,10,1989,5,927,1.0,659.0,659.0,5,1062,1.0,794.0,794.0
0.04,17,2,148,1,60,0.0,32.0,32.0,1,88,0.0,60.0,60.0
0.004,6,10,1779,5,928,1.0,660.0,660.0,5,851,0.0,583.0,583.0
0.008,6,10,1972,5,910,2.0,642.0,642.0,5,1062,2.0,794.0,794.0
0.059,17,2,152,1,76,0.0,48.0,48.0,1,76,0.0,48.0,48.0
0.042,17,4,364,2,160,0.0,52.0,52.0,2,204,1.0,80.0,74.0
0.001,17,2,166,1,75,0.0,47.0,47.0,1,91,0.0,63.0,63.0
0.001,17,2,136,1,60,0.0,32.0,32.0,1,76,0.0,48.0,48.0
0.001,17,2,180,1,66,0.0,38.0,38.0,1,114,0.0,86.0,86.0
0.006,6,10,1547,5,764,1.0,496.0,496.0,5,783,1.0,515.0,515.0
0.012,6,14,3965,7,495,1.0,123.0,123.0,7,3470,2.0,1448.0,1032.0
0.022,6,10,1972,5,910,5.0,642.0,642.0,5,1062,5.0,794.0,794.0
0.018,6,10,1983,5,910,4.0,642.0,642.0,5,1073,4.0,805.0,805.0
0.16,6,10,1506,5,395,36.0,127.0,127.0,5,1111,37.0,843.0,843.0
0.011,6,10,1989,5,910,2.0,642.0,642.0,5,1079,2.0,811.0,811.0
0.003,17,2,152,1,76,0.0,48.0,48.0,1,76,0.0,48.0,48.0
0.007,6,10,2006,5,927,1.0,659.0,659.0,5,1079,1.0,811.0,811.0
0.105,6,10,1506,5,395,24.0,127.0,127.0,5,1111,22.0,843.0,843.0
0.005,6,13,3690,7,452,0.0,80.0,80.0,6,3238,1.0,1470.0,1459.0
0.005,17,4,284,2,120,0.0,32.0,32.0,2,164,0.0,60.0,54.0
0.041,17,2,152,1,76,0.0,48.0,48.0,1,76,0.0,48.0,48.0
0.073,17,4,284,2,120,0.0,32.0,32.0,2,164,69.0,60.0,54.0
0.013,6,10,1989,5,910,3.0,642.0,642.0,5,1079,3.0,811.0,811.0
0.107,6,10,1506,5,395,24.0,127.0,127.0,5,1111,23.0,843.0,843.0
0.016,6,10,1972,5,910,3.0,642.0,642.0,5,1062,4.0,794.0,794.0
0.008,17,2,144,1,64,0.0,36.0,36.0,1,80,0.0,52.0,52.0
0.012,6,10,1631,5,848,2.0,580.0,580.0,5,783,3.0,515.0,515.0
0.117,6,10,1506,5,395,25.0,127.0,127.0,5,1111,26.0,843.0,843.0
0.004,6,10,2007,5,928,1.0,660.0,660.0,5,1079,1.0,811.0,811.0
0.001,17,2,180,1,66,0.0,38.0,38.0,1,114,0.0,86.0,86.0
0.001,17,2,136,1,60,0.0,32.0,32.0,1,76,0.0,48.0,48.0
0.009,17,2,179,1,71,0.0,43.0,43.0,1,108,0.0,80.0,80.0
0.003,17,2,148,1,60,0.0,32.0,32.0,1,88,0.0,60.0,60.0
309.391,17,20,1124,10,716,34362.0,48.0,43.0,10,408,34362.0,20.0,12.0
0.016,6,10,1631,5,848,4.0,580.0,580.0,5,783,4.0,515.0,515.0
0.005,17,4,284,2,120,1.0,32.0,32.0,2,164,1.0,60.0,54.0
0.006,6,10,1547,5,764,1.0,496.0,496.0,5,783,1.0,515.0,515.0
0.009,6,10,1989,5,910,2.0,642.0,642.0,5,1079,2.0,811.0,811.0
0.016,6,10,1989,5,910,4.0,642.0,642.0,5,1079,4.0,811.0,811.0
0.012,6,10,1972,5,910,3.0,642.0,642.0,5,1062,3.0,794.0,794.0
0.014,17,2,170,1,65,0.0,37.0,37.0,1,105,0.0,77.0,77.0
0.006,17,2,230,1,68,0.0,40.0,40.0,1,162,0.0,134.0,134.0
0.013,6,10,1631,5,848,3.0,580.0,580.0,5,783,3.0,515.0,515.0
11.533,17,28,4398,14,2312,874.0,587.0,137.0,14,2086,874.0,269.0,121.0
0.004,17,4,284,2,120,1.0,32.0,32.0,2,164,0.0,60.0,54.0
0.017,6,10,1762,5,911,4.0,643.0,643.0,5,851,4.0,583.0,583.0
0.005,6,10,2006,5,927,1.0,659.0,659.0,5,1079,1.0,811.0,811.0
0.015,6,10,1972,5,910,3.0,642.0,642.0,5,1062,3.0,794.0,794.0
0.011,6,10,1762,5,911,2.0,643.0,643.0,5,851,2.0,583.0,583.0
40.063,17,10,676,5,460,10015.0,104.0,64.0,5,216,10014.0,20.0,15.0
0.007,6,10,1854,5,889,1.0,621.0,621.0,5,965,1.0,697.0,697.0
0.004,6,10,2007,5,928,1.0,660.0,660.0,5,1079,1.0,811.0,811.0
0.009,6,12,1926,6,1189,1.0,659.0,434.0,6,737,1.0,417.0,417.0
0.005,6,10,1989,5,927,1.0,659.0,659.0,5,1062,1.0,794.0,794.0
0.005,6,10,1779,5,928,1.0,660.0,660.0,5,851,1.0,583.0,583.0
0.006,6,10,1774,5,923,1.0,655.0,655.0,5,851,1.0,583.0,583.0
0.012,6,14,3787,7,497,2.0,125.0,125.0,7,3290,2.0,1448.0,972.0
0.082,6,10,1506,5,395,19.0,127.0,127.0,5,1111,17.0,843.0,843.0
0.005,6,10,1989,5,927,1.0,659.0,659.0,5,1062,1.0,794.0,794.0
0.107,6,10,1506,5,395,26.0,127.0,127.0,5,1111,23.0,843.0,843.0
0.006,6,10,2006,5,927,1.0,659.0,659.0,5,1079,1.0,811.0,811.0
0.003,17,2,136,1,60,0.0,32.0,32.0,1,76,0.0,48.0,48.0
0.005,6,10,2000,5,927,1.0,659.0,659.0,5,1073,1.0,805.0,805.0
10.984,17,28,4421,14,1993,836.0,268.0,114.0,14,2428,836.0,587.0,145.0
0.014,6,10,1983,5,910,3.0,642.0,642.0,5,1073,3.0,805.0,805.0
0.007,6,10,1643,5,860,1.0,592.0,592.0,5,783,1.0,515.0,515.0
0.275,17,39,20196,21,17035,13.0,1350.0,783.0,18,3161,12.0,1350.0,147.0
0.005,6,10,1989,5,927,1.0,659.0,659.0,5,1062,1.0,794.0,794.0
0.006,17,4,284,2,120,0.0,32.0,32.0,2,164,0.0,60.0,54.0
0.007,17,2,162,1,65,0.0,37.0,37.0,1,97,0.0,69.0,69.0
0.003,17,2,148,1,60,0.0,32.0,32.0,1,88,0.0,60.0,60.0
0.006,6,10,1547,5,764,1.0,496.0,496.0,5,783,1.0,515.0,515.0
0.005,6,10,2006,5,927,1.0,659.0,659.0,5,1079,1.0,811.0,811.0
0.68,17,50,23697,27,20019,26.0,1350.0,713.0,23,3678,28.0,1350.0,131.0
0.141,6,10,1506,5,395,33.0,127.0,127.0,5,1111,27.0,843.0,843.0
0.066,6,10,1506,5,395,15.0,127.0,127.0,5,1111,15.0,843.0,843.0
240.09,6,16,4482,9,963,30011.0,238.0,166.0,7,3519,40014.0,1402.0,786.0
0.023,6,10,1972,5,910,5.0,642.0,642.0,5,1062,5.0,794.0,794.0
0.136,6,10,1506,5,395,31.0,127.0,127.0,5,1111,32.0,843.0,843.0
0.083,6,10,1506,5,395,18.0,127.0,127.0,5,1111,19.0,843.0,843.0
0.004,17,2,162,1,65,0.0,37.0,37.0,1,97,0.0,69.0,69.0
0.014,6,10,1990,5,911,3.0,643.0,643.0,5,1079,3.0,811.0,811.0
0.073,17,4,284,2,120,1.0,32.0,32.0,2,164,69.0,60.0,54.0
0.012,6,10,1631,5,848,3.0,580.0,580.0,5,783,3.0,515.0,515.0
40.073,17,10,676,5,460,10017.0,104.0,64.0,5,216,10017.0,20.0,15.0
0.115,6,10,1506,5,395,26.0,127.0,127.0,5,1111,25.0,843.0,843.0
0.005,17,2,140,1,62,0.0,34.0,34.0,1,78,0.0,50.0,50.0
0.012,6,10,1989,5,910,3.0,642.0,642.0,5,1079,3.0,811.0,811.0
0.005,6,10,2007,5,928,1.0,660.0,660.0,5,1079,1.0,811.0,811.0
0.021,6,10,1972,5,910,5.0,642.0,642.0,5,1062,5.0,794.0,794.0
354.063,6,21,1795,16,1030,23604.0,190.0,190.0,5,765,60002.0,464.0,248.0
11.178,17,28,4423,14,1995,847.0,270.0,114.0,14,2428,847.0,587.0,145.0
0.039,17,2,182,1,65,0.0,37.0,37.0,1,117,0.0,89.0,89.0
10.832,17,28,4417,14,1993,824.0,268.0,114.0,14,2424,824.0,587.0,145.0
0.088,6,10,1506,5,395,21.0,127.0,127.0,5,1111,19.0,843.0,843.0
0.08,6,10,1506,5,395,18.0,127.0,127.0,5,1111,15.0,843.0,843.0
0.004,6,10,2000,5,927,1.0,659.0,659.0,5,1073,1.0,805.0,805.0
0.005,6,10,1774,5,923,1.0,655.0,655.0,5,851,1.0,583.0,583.0
0.004,6,10,2007,5,928,1.0,660.0,660.0,5,1079,1.0,811.0,811.0
0.011,6,10,1762,5,911,2.0,643.0,643.0,5,851,2.0,583.0,583.0
0.012,6,10,1762,5,911,3.0,643.0,643.0,5,851,3.0,583.0,583.0
0.128,17,2,128,1,56,0.0,28.0,28.0,1,72,0.0,44.0,44.0
0.007,6,10,1989,5,927,1.0,659.0,659.0,5,1062,1.0,794.0,794.0
0.098,6,10,1506,5,395,23.0,127.0,127.0,5,1111,22.0,843.0,843.0
0.09,6,10,1506,5,395,20.0,127.0,127.0,5,1111,20.0,843.0,843.0
0.017,6,10,1972,5,910,4.0,642.0,642.0,5,1062,4.0,794.0,794.0
0.005,17,2,230,1,68,0.0,40.0,40.0,1,162,0.0,134.0,134.0
0.014,6,10,1972,5,910,3.0,642.0,642.0,5,1062,3.0,794.0,794.0
0.098,6,10,1506,5,395,22.0,127.0,127.0,5,1111,23.0,843.0,843.0
0.233,6,16,2777,8,1395,33.0,533.0,323.0,8,1382,21.0,529.0,239.0
0.013,6,10,1989,5,910,3.0,642.0,642.0,5,1079,3.0,811.0,811.0
0.011,6,10,1972,5,910,2.0,642.0,642.0,5,1062,2.0,794.0,794.0
0.005,17,2,166,1,75,0.0,47.0,47.0,1,91,0.0,63.0,63.0
0.013,6,10,1972,5,910,3.0,642.0,642.0,5,1062,3.0,794.0,794.0
0.073,17,2,412,1,61,0.0,33.0,33.0,1,351,0.0,323.0,323.0
0.086,6,10,1506,5,395,17.0,127.0,127.0,5,1111,16.0,843.0,843.0
300.604,6,34,6335,19,1409,16700.0,267.0,154.0,15,4926,606.0,1823.0,392.0
309.502,17,20,1124,10,716,34378.0,48.0,43.0,10,408,34376.0,20.0,12.0
10.808,17,28,4422,14,1994,822.0,269.0,114.0,14,2428,822.0,587.0,145.0
1787.768,6,155,19721,92,13864,19645.0,302.0,302.0,63,5857,28834.0,83.0,83.0
240.01,6,9,787,5,488,60002.0,232.0,232.0,4,299,80002.0,83.0,83.0
0.006,6,10,1547,5,764,1.0,496.0,496.0,5,783,1.0,515.0,515.0
0.061,17,4,284,2,120,1.0,32.0,32.0,2,164,1.0,60.0,54.0
0.019,6,10,1677,5,827,4.0,559.0,559.0,5,850,4.0,582.0,582.0
0.004,6,10,1989,5,927,1.0,659.0,659.0,5,1062,1.0,794.0,794.0
0.005,6,10,2007,5,928,1.0,660.0,660.0,5,1079,1.0,811.0,811.0
40.066,17,10,676,5,460,10015.0,104.0,64.0,5,216,10015.0,20.0,15.0
0.01,6,10,1989,5,910,2.0,642.0,642.0,5,1079,2.0,811.0,811.0
0.014,6,10,1762,5,911,3.0,643.0,643.0,5,851,3.0,583.0,583.0
0.009,6,10,1972,5,910,2.0,642.0,642.0,5,1062,2.0,794.0,794.0
0.084,6,10,1506,5,395,13.0,127.0,127.0,5,1111,19.0,843.0,843.0
0.005,6,10,2007,5,928,1.0,660.0,660.0,5,1079,1.0,811.0,811.0
0.006,17,2,180,1,66,0.0,38.0,38.0,1,114,0.0,86.0,86.0
0.006,6,10,1547,5,764,1.0,496.0,496.0,5,783,1.0,515.0,515.0
0.005,6,10,2000,5,927,1.0,659.0,659.0,5,1073,1.0,805.0,805.0
0.004,17,4,284,2,120,1.0,32.0,32.0,2,164,0.0,60.0,54.0
40.077,17,10,676,5,460,10016.0,104.0,64.0,5,216,10018.0,20.0,15.0
0.003,17,2,136,1,60,0.0,32.0,32.0,1,76,0.0,48.0,48.0
0.018,6,10,1972,5,910,4.0,642.0,642.0,5,1062,4.0,794.0,794.0
0.042,17,2,184,1,61,0.0,33.0,33.0,1,123,0.0,95.0,95.0
0.126,6,10,1506,5,395,27.0,127.0,127.0,5,1111,28.0,843.0,843.0
0.013,6,10,1989,5,910,3.0,642.0,642.0,5,1079,3.0,811.0,811.0
0.005,17,2,214,1,75,0.0,47.0,47.0,1,139,0.0,111.0,111.0
417.993,6,38,6608,18,4896,7319.0,494.0,494.0,20,1712,21999.0,83.0,83.0
0.087,6,10,1506,5,395,19.0,127.0,127.0,5,1111,20.0,843.0,843.0
0.111,6,10,1506,5,395,22.0,127.0,127.0,5,1111,26.0,843.0,843.0
0.116,6,10,1506,5,395,27.0,127.0,127.0,5,1111,27.0,843.0,843.0
0.004,17,2,136,1,60,0.0,32.0,32.0,1,76,0.0,48.0,48.0
0.014,6,10,1990,5,911,3.0,643.0,643.0,5,1079,3.0,811.0,811.0
0.13,17,2,80,1,32,0.0,4.0,4.0,1,48,0.0,20.0,20.0
171.063,17,78,10918,39,2603,4501.0,44.0,38.0,39,8315,4501.0,239.0,185.0
0.098,6,10,1506,5,395,23.0,127.0,127.0,5,1111,19.0,843.0,843.0
0.018,6,10,1990,5,911,4.0,643.0,643.0,5,1079,4.0,811.0,811.0
0.004,17,2,148,1,60,0.0,32.0,32.0,1,88,0.0,60.0,60.0
298.703,6,21,5456,10,2192,33189.0,585.0,330.0,11,3264,29869.0,1402.0,674.0
240.102,6,32,9612,15,7096,17149.0,2207.0,700.0,17,2516,15006.0,580.0,203.0
0.009,6,10,1989,5,910,2.0,642.0,642.0,5,1079,2.0,811.0,811.0
0.01,6,10,1983,5,910,2.0,642.0,642.0,5,1073,2.0,805.0,805.0
0.005,6,10,1643,5,860,1.0,592.0,592.0,5,783,1.0,515.0,515.0
0.013,6,10,1989,5,910,3.0,642.0,642.0,5,1079,3.0,811.0,811.0
0.009,6,12,1926,6,1189,1.0,659.0,434.0,6,737,1.0,417.0,417.0
0.038,17,2,152,1,76,0.0,48.0,48.0,1,76,0.0,48.0,48.0
0.173,6,10,1506,5,395,27.0,127.0,127.0,5,1111,41.0,843.0,843.0
1.028,6,32,12787,18,3352,60.0,1360.0,517.0,14,9435,66.0,2720.0,886.0
0.104,6,10,1506,5,395,23.0,127.0,127.0,5,1111,24.0,843.0,843.0
0.013,6,10,1989,5,910,3.0,642.0,642.0,5,1079,3.0,811.0,811.0
0.014,6,10,1762,5,911,3.0,643.0,643.0,5,851,3.0,583.0,583.0
0.013,17,2,136,1,60,0.0,32.0,32.0,1,76,0.0,48.0,48.0
0.004,6,10,1989,5,927,1.0,659.0,659.0,5,1062,1.0,794.0,794.0
0.004,17,2,136,1,60,0.0,32.0,32.0,1,76,0.0,48.0,48.0
0.006,6,10,1547,5,764,1.0,496.0,496.0,5,783,1.0,515.0,515.0
0.005,6,13,3747,7,509,0.0,137.0,137.0,6,3238,1.0,1470.0,1459.0
0.005,6,10,1689,5,839,1.0,571.0,571.0,5,850,1.0,582.0,582.0
0.093,6,10,1506,5,395,21.0,127.0,127.0,5,1111,22.0,843.0,843.0
0.005,6,10,1854,5,889,1.0,621.0,621.0,5,965,1.0,697.0,697.0
0.005,17,2,170,1,65,0.0,37.0,37.0,1,105,0.0,77.0,77.0
0.005,6,10,2007,5,928,1.0,660.0,660.0,5,1079,1.0,811.0,811.0
0.065,6,10,1506,5,395,13.0,127.0,127.0,5,1111,14.0,843.0,843.0
0.149,6,10,1506,5,395,35.0,127.0,127.0,5,1111,35.0,843.0,843.0
294.434,6,321,344509,119,17752,2495.0,2736.0,889.0,202,326757,1464.0,2804.0,1682.0
0.065,6,10,1506,5,395,14.0,127.0,127.0,5,1111,14.0,843.0,843.0
300.654,6,37,8366,20,1934,15823.0,755.0,275.0,17,6432,531.0,2720.0,478.0
0.008,6,10,1972,5,910,1.0,642.0,642.0,5,1062,1.0,794.0,794.0
10.796,17,28,4422,14,1994,821.0,269.0,114.0,14,2428,821.0,587.0,145.0
0.013,6,10,1989,5,910,3.0,642.0,642.0,5,1079,3.0,811.0,811.0
0.024,6,10,1983,5,910,5.0,642.0,642.0,5,1073,5.0,805.0,805.0
308.516,17,20,1124,10,716,34265.0,48.0,43.0,10,408,34266.0,20.0,12.0
0.011,6,10,1989,5,910,2.0,642.0,642.0,5,1079,2.0,811.0,811.0
0.006,17,2,170,1,65,0.0,37.0,37.0,1,105,0.0,77.0,77.0
0.091,6,10,1506,5,395,20.0,127.0,127.0,5,1111,20.0,843.0,843.0
425.31,6,29,4409,12,3102,10911.0,494.0,494.0,17,1307,26581.0,83.0,83.0
0.012,6,10,1983,5,910,2.0,642.0,642.0,5,1073,3.0,805.0,805.0
0.009,6,10,1972,5,910,2.0,642.0,642.0,5,1062,2.0,794.0,794.0
0.011,6,10,1989,5,910,2.0,642.0,642.0,5,1079,2.0,811.0,811.0
0.004,6,10,1774,5,923,1.0,655.0,655.0,5,851,1.0,583.0,583.0
240.095,6,16,4480,9,963,30011.0,238.0,166.0,7,3517,40015.0,1402.0,786.0
0.088,6,10,1506,5,395,20.0,127.0,127.0,5,1111,19.0,843.0,843.0
0.005,6,10,2006,5,927,1.0,659.0,659.0,5,1079,1.0,811.0,811.0
0.012,6,13,3735,7,497,2.0,125.0,125.0,6,3238,2.0,1470.0,1459.0
0.01,6,14,3787,7,497,1.0,125.0,125.0,7,3290,1.0,1448.0,972.0
0.012,6,10,1990,5,911,3.0,643.0,643.0,5,1079,3.0,811.0,811.0
353.378,6,20,2210,6,1308,12003.0,494.0,494.0,14,902,27182.0,83.0,83.0
0.004,6,10,1702,5,863,1.0,595.0,595.0,5,839,0.0,571.0,571.0
0.005,6,10,2000,5,927,1.0,659.0,659.0,5,1073,1.0,805.0,805.0
0.004,6,10,2006,5,927,1.0,659.0,659.0,5,1079,1.0,811.0,811.0
0.006,17,2,168,1,76,0.0,48.0,48.0,1,92,0.0,64.0,64.0
0.004,17,2,136,1,60,0.0,32.0,32.0,1,76,0.0,48.0,48.0
0.014,6,10,1972,5,910,3.0,642.0,642.0,5,1062,3.0,794.0,794.0
0.212,6,10,1506,5,395,49.0,127.0,127.0,5,1111,49.0,843.0,843.0
0.003,17,4,284,2,120,0.0,32.0,32.0,2,164,0.0,60.0,54.0
0.011,6,10,1989,5,910,2.0,642.0,642.0,5,1079,2.0,811.0,811.0
0.006,6,10,1547,5,764,1.0,496.0,496.0,5,783,1.0,515.0,515.0
0.015,6,10,1762,5,911,3.0,643.0,643.0,5,851,3.0,583.0,583.0
0.037,17,2,148,1,60,0.0,32.0,32.0,1,88,0.0,60.0,60.0
0.014,6,10,1972,5,910,3.0,642.0,642.0,5,1062,3.0,794.0,794.0
0.143,6,10,1506,5,395,33.0,127.0,127.0,5,1111,31.0,843.0,843.0
0.001,17,2,180,1,66,0.0,38.0,38.0,1,114,0.0,86.0,86.0
0.012,6,10,1989,5,910,3.0,642.0,642.0,5,1079,2.0,811.0,811.0
0.089,6,10,1506,5,395,18.0,127.0,127.0,5,1111,20.0,843.0,843.0
0.001,17,2,180,1,66,0.0,38.0,38.0,1,114,0.0,86.0,86.0
0.004,6,10,2006,5,927,1.0,659.0,659.0,5,1079,1.0,811.0,811.0
0.004,6,10,1702,5,863,0.0,595.0,595.0,5,839,1.0,571.0,571.0
0.008,6,10,1972,5,910,2.0,642.0,642.0,5,1062,1.0,794.0,794.0
0.006,6,10,2006,5,927,1.0,659.0,659.0,5,1079,1.0,811.0,811.0
0.02,6,10,1605,5,388,5.0,120.0,120.0,5,1217,4.0,949.0,949.0
0.008,6,10,1989,5,910,1.0,642.0,642.0,5,1079,1.0,811.0,811.0
40.053,17,10,676,5,460,10012.0,104.0,64.0,5,216,10012.0,20.0,15.0
0.01,6,10,1972,5,910,2.0,642.0,642.0,5,1062,2.0,794.0,794.0
0.005,6,10,2000,5,927,1.0,659.0,659.0,5,1073,1.0,805.0,805.0
0.016,6,10,1989,5,910,4.0,642.0,642.0,5,1079,4.0,811.0,811.0
0.004,6,10,1702,5,863,0.0,595.0,595.0,5,839,1.0,571.0,571.0
0.001,17,2,180,1,66,0.0,38.0,38.0,1,114,0.0,86.0,86.0
0.004,17,2,148,1,60,0.0,32.0,32.0,1,88,0.0,60.0,60.0
40.06,17,10,676,5,460,10014.0,104.0,64.0,5,216,10014.0,20.0,15.0
0.127,17,2,186,1,61,0.0,33.0,33.0,1,125,0.0,97.0,97.0
0.014,6,10,1990,5,911,3.0,643.0,643.0,5,1079,3.0,811.0,811.0
0.022,6,10,1983,5,910,5.0,642.0,642.0,5,1073,5.0,805.0,805.0
0.011,6,10,1989,5,910,2.0,642.0,642.0,5,1079,2.0,811.0,811.0
377.979,6,20,2210,6,1308,12003.0,494.0,494.0,14,902,29075.0,83.0,83.0
0.075,6,10,1506,5,395,17.0,127.0,127.0,5,1111,15.0,843.0,843.0
300.791,6,33,6295,19,1409,16710.0,267.0,154.0,14,4886,670.0,3237.0,431.0
371.093,6,22,2313,16,867,24739.0,195.0,195.0,6,1446,4639.0,419.0,398.0
0.006,6,10,1774,5,923,1.0,655.0,655.0,5,851,1.0,583.0,583.0
0.122,6,10,1506,5,395,21.0,127.0,127.0,5,1111,26.0,843.0,843.0
0.005,6,10,2006,5,927,1.0,659.0,659.0,5,1079,1.0,811.0,811.0
0.003,17,2,148,1,60,0.0,32.0,32.0,1,88,0.0,60.0,60.0
0.004,6,10,2006,5,927,1.0,659.0,659.0,5,1079,1.0,811.0,811.0
0.085,6,10,1506,5,395,18.0,127.0,127.0,5,1111,19.0,843.0,843.0
32.266,6,36,9657,18,3978,523.0,1543.0,806.0,18,5679,1888.0,2715.0,449.0
0.175,17,2,152,1,76,0.0,48.0,48.0,1,76,0.0,48.0,48.0
0.012,6,10,1989,5,910,2.0,642.0,642.0,5,1079,2.0,811.0,811.0
0.006,6,10,1689,5,839,1.0,571.0,571.0,5,850,1.0,582.0,582.0
0.072,6,10,1506,5,395,15.0,127.0,127.0,5,1111,15.0,843.0,843.0
0.005,6,10,2007,5,928,1.0,660.0,660.0,5,1079,1.0,811.0,811.0
0.005,6,10,1989,5,927,1.0,659.0,659.0,5,1062,1.0,794.0,794.0
0.001,17,2,136,1,60,0.0,32.0,32.0,1,76,0.0,48.0,48.0
0.101,6,10,1506,5,395,22.0,127.0,127.0,5,1111,23.0,843.0,843.0
0.006,17,2,170,1,65,0.0,37.0,37.0,1,105,0.0,77.0,77.0
309.022,17,20,1124,10,716,34320.0,48.0,43.0,10,408,34320.0,20.0,12.0
0.073,6,10,1506,5,395,18.0,127.0,127.0,5,1111,17.0,843.0,843.0
0.015,6,10,1989,5,910,3.0,642.0,642.0,5,1079,3.0,811.0,811.0
0.004,6,10,1989,5,927,1.0,659.0,659.0,5,1062,1.0,794.0,794.0
15.074,17,15,9238,8,6902,2149.0,1350.0,834.0,7,2336,2507.0,1350.0,305.0
0.006,6,12,1698,6,863,1.0,327.0,271.0,6,835,1.0,515.0,515.0
0.004,17,4,284,2,120,1.0,32.0,32.0,2,164,0.0,60.0,54.0
0.03,6,10,1762,5,911,7.0,643.0,643.0,5,851,7.0,583.0,583.0
0.011,6,10,1631,5,848,2.0,580.0,580.0,5,783,2.0,515.0,515.0
0.013,6,10,1990,5,911,3.0,643.0,643.0,5,1079,3.0,811.0,811.0
0.005,6,10,2006,5,927,1.0,659.0,659.0,5,1079,1.0,811.0,811.0
0.014,6,10,1989,5,910,3.0,642.0,642.0,5,1079,3.0,811.0,811.0
280.664,6,25,6480,11,1226,28066.0,267.0,156.0,14,5254,21589.0,1400.0,781.0
240.017,6,22,3474,12,1820,21819.0,599.0,171.0,10,1654,26668.0,580.0,225.0
0.016,6,10,1631,5,848,4.0,580.0,580.0,5,783,3.0,515.0,515.0
0.007,6,10,1989,5,910,1.0,642.0,642.0,5,1079,1.0,811.0,811.0
40.054,17,10,676,5,460,10012.0,104.0,64.0,5,216,10012.0,20.0,15.0
0.012,6,10,1989,5,910,3.0,642.0,642.0,5,1079,2.0,811.0,811.0
0.013,17,2,152,1,56,0.0,28.0,28.0,1,96,0.0,68.0,68.0
0.02,6,10,1990,5,911,5.0,643.0,643.0,5,1079,5.0,811.0,811.0
0.012,6,10,1989,5,910,2.0,642.0,642.0,5,1079,3.0,811.0,811.0
0.008,6,10,2000,5,927,2.0,659.0,659.0,5,1073,2.0,805.0,805.0
0.033,6,10,1989,5,910,8.0,642.0,642.0,5,1079,8.0,811.0,811.0
0.004,6,10,1989,5,927,1.0,659.0,659.0,5,1062,1.0,794.0,794.0
0.006,17,2,179,1,71,0.0,43.0,43.0,1,108,0.0,80.0,80.0
0.004,17,2,148,1,60,0.0,32.0,32.0,1,88,0.0,60.0,60.0
354.023,6,21,1795,16,1030,23601.0,190.0,190.0,5,765,60001.0,464.0,248.0
0.001,17,2,180,1,66,0.0,38.0,38.0,1,114,0.0,86.0,86.0
0.074,6,10,1506,5,395,17.0,127.0,127.0,5,1111,14.0,843.0,843.0
0.008,6,12,1926,6,1189,1.0,659.0,434.0,6,737,1.0,417.0,417.0
0.8,6,10,2009,6,1655,160.0,1403.0,1403.0,4,354,189.0,182.0,182.0
0.005,6,10,2006,5,927,1.0,659.0,659.0,5,1079,1.0,811.0,811.0
0.013,6,10,1972,5,910,3.0,642.0,642.0,5,1062,3.0,794.0,794.0
0.15,6,10,1506,5,395,36.0,127.0,127.0,5,1111,30.0,843.0,843.0
0.005,6,10,2000,5,927,1.0,659.0,659.0,5,1073,1.0,805.0,805.0
40.062,17,10,676,5,460,10014.0,104.0,64.0,5,216,10014.0,20.0,15.0
0.025,6,10,1990,5,911,6.0,643.0,643.0,5,1079,6.0,811.0,811.0
0.01,6,10,1990,5,911,2.0,643.0,643.0,5,1079,2.0,811.0,811.0
1.026,6,30,12707,17,3312,64.0,1360.0,517.0,13,9395,71.0,2720.0,984.0
0.013,6,10,1631,5,848,3.0,580.0,580.0,5,783,3.0,515.0,515.0
0.011,6,10,1983,5,910,2.0,642.0,642.0,5,1073,2.0,805.0,805.0
0.011,6,10,1677,5,827,2.0,559.0,559.0,5,850,2.0,582.0,582.0
240.49,6,35,8925,18,2071,14146.0,692.0,225.0,17,6854,15030.0,1402.0,597.0
0.006,6,10,1689,5,839,1.0,571.0,571.0,5,850,1.0,582.0,582.0
0.005,6,10,1689,5,839,1.0,571.0,571.0,5,850,1.0,582.0,582.0
0.005,6,10,1702,5,863,1.0,595.0,595.0,5,839,1.0,571.0,571.0
0.019,6,10,1989,5,910,4.0,642.0,642.0,5,1079,4.0,811.0,811.0
0.005,6,10,2006,5,927,1.0,659.0,659.0,5,1079,1.0,811.0,811.0
0.004,6,10,1989,5,927,1.0,659.0,659.0,5,1062,1.0,794.0,794.0
0.004,17,2,136,1,60,0.0,32.0,32.0,1,76,0.0,48.0,48.0
0.006,6,10,1643,5,860,1.0,592.0,592.0,5,783,1.0,515.0,515.0
0.004,17,4,420,2,122,0.0,33.0,33.0,2,298,1.0,145.0,121.0
40.065,17,10,676,5,460,10015.0,104.0,64.0,5,216,10015.0,20.0,15.0
0.041,17,4,420,2,122,0.0,33.0,33.0,2,298,4.0,145.0,121.0
0.005,6,10,2006,5,927,1.0,659.0,659.0,5,1079,1.0,811.0,811.0
0.141,6,10,1506,5,395,33.0,127.0,127.0,5,1111,33.0,843.0,843.0
0.004,6,10,2006,5,927,1.0,659.0,659.0,5,1079,1.0,811.0,811.0
0.007,17,2,148,1,60,0.0,32.0,32.0,1,88,0.0,60.0,60.0
0.004,17,2,144,1,64,0.0,36.0,36.0,1,80,0.0,52.0,52.0
0.011,6,10,1677,5,827,2.0,559.0,559.0,5,850,2.0,582.0,582.0
0.049,17,2,144,1,64,0.0,36.0,36.0,1,80,0.0,52.0,52.0
0.01,6,13,3735,7,497,1.0,125.0,125.0,6,3238,1.0,1470.0,1459.0
0.015,6,10,1983,5,910,3.0,642.0,642.0,5,1073,3.0,805.0,805.0
1758.308,6,83,5149,41,2182,43956.0,50.0,50.0,42,2967,42884.0,434.0,391.0
0.012,6,10,1762,5,911,2.0,643.0,643.0,5,851,3.0,583.0,583.0
0.259,17,2,152,1,76,0.0,48.0,48.0,1,76,0.0,48.0,48.0
0.082,6,10,1506,5,395,18.0,127.0,127.0,5,1111,19.0,843.0,843.0
0.185,17,4,580,2,122,144.0,33.0,33.0,2,458,145.0,307.0,201.0
0.132,6,10,1506,5,395,31.0,127.0,127.0,5,1111,22.0,843.0,843.0
356.674,6,21,1795,16,1030,23778.0,190.0,190.0,5,765,60002.0,464.0,248.0
0.015,6,10,1990,5,911,3.0,643.0,643.0,5,1079,3.0,811.0,811.0
0.011,6,10,1677,5,827,2.0,559.0,559.0,5,850,2.0,582.0,582.0
308.477,17,20,1124,10,716,34260.0,48.0,43.0,10,408,34260.0,20.0,12.0
0.005,17,2,194,1,59,0.0,31.0,31.0,1,135,0.0,107.0,107.0
0.014,6,10,1990,5,911,3.0,643.0,643.0,5,1079,3.0,811.0,811.0
240.015,6,9,787,5,488,60003.0,232.0,232.0,4,299,80003.0,83.0,83.0
0.005,17,2,166,1,75,0.0,47.0,47.0,1,91,0.0,63.0,63.0
0.004,17,2,170,1,65,0.0,37.0,37.0,1,105,0.0,77.0,77.0
0.131,6,10,1506,5,395,28.0,127.0,127.0,5,1111,28.0,843.0,843.0
0.013,6,10,1677,5,827,3.0,559.0,559.0,5,850,3.0,582.0,582.0
40.076,17,10,676,5,460,10013.0,104.0,64.0,5,216,10018.0,20.0,15.0
0.008,6,10,1989,5,927,2.0,659.0,659.0,5,1062,2.0,794.0,794.0
0.005,6,13,3747,7,509,0.0,137.0,137.0,6,3238,1.0,1470.0,1459.0
0.039,17,4,284,2,120,0.0,32.0,32.0,2,164,36.0,60.0,54.0
0.005,6,10,2007,5,928,1.0,660.0,660.0,5,1079,1.0,811.0,811.0
0.005,6,10,1989,5,927,1.0,659.0,659.0,5,1062,1.0,794.0,794.0
0.005,6,10,1989,5,927,1.0,659.0,659.0,5,1062,1.0,794.0,794.0
40.057,17,10,676,5,460,10012.0,104.0,64.0,5,216,10013.0,20.0,15.0
0.106,6,10,1506,5,395,21.0,127.0,127.0,5,1111,20.0,843.0,843.0
0.005,6,10,1702,5,863,1.0,595.0,595.0,5,839,1.0,571.0,571.0
0.005,6,10,2007,5,928,1.0,660.0,660.0,5,1079,1.0,811.0,811.0
0.006,6,10,1547,5,764,1.0,496.0,496.0,5,783,1.0,515.0,515.0
0.001,17,2,166,1,75,0.0,47.0,47.0,1,91,0.0,63.0,63.0
0.004,17,2,148,1,60,0.0,32.0,32.0,1,88,0.0,60.0,60.0
0.103,6,10,1506,5,395,19.0,127.0,127.0,5,1111,21.0,843.0,843.0
0.124,6,10,1506,5,395,27.0,127.0,127.0,5,1111,28.0,843.0,843.0
0.005,6,10,2000,5,927,1.0,659.0,659.0,5,1073,1.0,805.0,805.0
0.017,6,10,1990,5,911,4.0,643.0,643.0,5,1079,4.0,811.0,811.0
0.095,6,10,1506,5,395,17.0,127.0,127.0,5,1111,22.0,843.0,843.0
0.078,6,10,1506,5,395,17.0,127.0,127.0,5,1111,17.0,843.0,843.0
0.006,6,13,3747,7,509,0.0,137.0,137.0,6,3238,1.0,1470.0,1459.0
0.007,6,10,1972,5,910,1.0,642.0,642.0,5,1062,1.0,794.0,794.0
0.111,6,10,1506,5,395,26.0,127.0,127.0,5,1111,25.0,843.0,843.0
0.095,6,10,1506,5,395,16.0,127.0,127.0,5,1111,19.0,843.0,843.0
0.01,6,10,1972,5,910,2.0,642.0,642.0,5,1062,2.0,794.0,794.0
0.009,6,10,1972,5,910,2.0,642.0,642.0,5,1062,2.0,794.0,794.0
0.083,6,10,1506,5,395,18.0,127.0,127.0,5,1111,19.0,843.0,843.0
0.006,6,10,2006,5,927,1.0,659.0,659.0,5,1079,1.0,811.0,811.0
0.069,6,10,1506,5,395,15.0,127.0,127.0,5,1111,17.0,843.0,843.0
0.113,17,2,144,1,64,0.0,36.0,36.0,1,80,0.0,52.0,52.0
0.009,6,7,695,4,448,3.0,232.0,232.0,3,247,3.0,83.0,83.0
0.005,6,10,2006,5,927,1.0,659.0,659.0,5,1079,1.0,811.0,811.0
0.006,6,10,1689,5,839,1.0,571.0,571.0,5,850,1.0,582.0,582.0
40.06,17,10,676,5,460,10014.0,104.0,64.0,5,216,10013.0,20.0,15.0
0.001,17,2,180,1,66,0.0,38.0,38.0,1,114,0.0,86.0,86.0
0.005,17,2,136,1,60,0.0,32.0,32.0,1,76,0.0,48.0,48.0
0.077,6,10,1506,5,395,16.0,127.0,127.0,5,1111,15.0,843.0,843.0
0.012,6,10,1972,5,910,2.0,642.0,642.0,5,1062,3.0,794.0,794.0
0.001,17,2,136,1,60,0.0,32.0,32.0,1,76,0.0,48.0,48.0
0.154,6,10,1506,5,395,38.0,127.0,127.0,5,1111,32.0,843.0,843.0
0.005,6,10,2007,5,928,1.0,660.0,660.0,5,1079,1.0,811.0,811.0
1796.267,17,3274,250475,1629,132048,1103.0,84.0,53.0,1645,118427,1092.0,227.0,43.0
0.005,6,10,2006,5,927,1.0,659.0,659.0,5,1079,1.0,811.0,811.0
0.005,17,2,212,1,74,0.0,46.0,46.0,1,138,0.0,110.0,110.0
10.861,17,28,4423,14,1995,827.0,270.0,114.0,14,2428,826.0,587.0,145.0
0.072,6,10,1506,5,395,17.0,127.0,127.0,5,1111,14.0,843.0,843.0
0.013,17,2,152,1,56,0.0,28.0,28.0,1,96,0.0,68.0,68.0
293.685,6,395,348663,198,21859,1490.0,2736.0,888.0,197,326804,1498.0,2804.0,1729.0
0.008,6,10,1762,5,911,2.0,643.0,643.0,5,851,2.0,583.0,583.0
0.005,17,2,282,1,69,0.0,41.0,41.0,1,213,0.0,185.0,185.0
40.053,17,10,676,5,460,10012.0,104.0,64.0,5,216,10012.0,20.0,15.0
0.128,6,10,1506,5,395,25.0,127.0,127.0,5,1111,31.0,843.0,843.0
0.005,6,10,2006,5,927,1.0,659.0,659.0,5,1079,1.0,811.0,811.0
0.116,6,10,1506,5,395,28.0,127.0,127.0,5,1111,25.0,843.0,843.0
0.132,6,10,1506,5,395,25.0,127.0,127.0,5,1111,31.0,843.0,843.0
0.072,17,4,284,2,120,1.0,32.0,32.0,2,164,68.0,60.0,54.0
0.005,6,10,2000,5,927,1.0,659.0,659.0,5,1073,1.0,805.0,805.0
0.046,6,10,1605,5,388,11.0,120.0,120.0,5,1217,11.0,949.0,949.0
0.005,6,10,2006,5,927,1.0,659.0,659.0,5,1079,1.0,811.0,811.0
0.053,17,2,152,1,76,0.0,48.0,48.0,1,76,0.0,48.0,48.0
0.007,17,2,214,1,75,0.0,47.0,47.0,1,139,0.0,111.0,111.0
0.127,6,10,1506,5,395,29.0,127.0,127.0,5,1111,30.0,843.0,843.0
0.02,6,10,1990,5,911,5.0,643.0,643.0,5,1079,4.0,811.0,811.0
0.004,6,10,2007,5,928,1.0,660.0,660.0,5,1079,1.0,811.0,811.0
0.209,6,16,2777,8,1395,29.0,533.0,323.0,8,1382,19.0,529.0,239.0
1730.388,6,48,2957,31,1800,57679.0,35.0,35.0,17,1157,108144.0,31.0,31.0
0.004,6,10,1774,5,923,1.0,655.0,655.0,5,851,1.0,583.0,583.0
0.005,6,10,1702,5,863,1.0,595.0,595.0,5,839,1.0,571.0,571.0
177.095,17,78,11237,39,2610,4660.0,44.0,38.0,39,8627,4660.0,239.0,193.0
0.005,6,10,1779,5,928,1.0,660.0,660.0,5,851,1.0,583.0,583.0
0.104,6,10,1506,5,395,23.0,127.0,127.0,5,1111,21.0,843.0,843.0
0.007,6,10,1702,5,863,1.0,595.0,595.0,5,839,1.0,571.0,571.0
0.017,6,10,1762,5,911,4.0,643.0,643.0,5,851,4.0,583.0,583.0
65.814,6,27,17576,15,9628,4701.0,2804.0,1473.0,12,7948,5968.0,2319.0,1219.0
0.008,6,10,1779,5,928,2.0,660.0,660.0,5,851,2.0,583.0,583.0
0.003,17,2,148,1,60,0.0,32.0,32.0,1,88,0.0,60.0,60.0
0.128,17,2,80,1,32,0.0,4.0,4.0,1,48,0.0,20.0,20.0
0.004,6,10,2006,5,927,1.0,659.0,659.0,5,1079,1.0,811.0,811.0
0.008,6,10,1983,5,910,1.0,642.0,642.0,5,1073,2.0,805.0,805.0
0.068,6,10,1506,5,395,14.0,127.0,127.0,5,1111,15.0,843.0,843.0
0.005,6,10,2007,5,928,1.0,660.0,660.0,5,1079,1.0,811.0,811.0
0.148,6,10,1506,5,395,34.0,127.0,127.0,5,1111,34.0,843.0,843.0
0.009,6,10,1631,5,848,2.0,580.0,580.0,5,783,2.0,515.0,515.0
0.019,6,10,1983,5,910,4.0,642.0,642.0,5,1073,4.0,805.0,805.0
0.018,6,10,1989,5,910,4.0,642.0,642.0,5,1079,4.0,811.0,811.0
11.152,17,28,4422,14,1994,845.0,269.0,114.0,14,2428,845.0,587.0,145.0
0.171,17,2,152,1,76,0.0,48.0,48.0,1,76,0.0,48.0,48.0
0.042,17,4,284,2,120,0.0,32.0,32.0,2,164,38.0,60.0,54.0
0.004,6,10,2006,5,927,1.0,659.0,659.0,5,1079,1.0,811.0,811.0
0.023,6,10,1972,5,910,5.0,642.0,642.0,5,1062,5.0,794.0,794.0
0.005,6,10,1989,5,927,1.0,659.0,659.0,5,1062,1.0,794.0,794.0
0.005,6,10,1989,5,927,1.0,659.0,659.0,5,1062,1.0,794.0,794.0
297.771,6,320,345145,122,17901,2460.0,2736.0,889.0,198,327244,1511.0,2804.0,1713.0
0.073,6,10,1506,5,395,16.0,127.0,127.0,5,1111,16.0,843.0,843.0
0.027,6,5,310,3,175,13.0,31.0,31.0,2,135,0.0,31.0,31.0
0.005,6,10,2000,5,927,1.0,659.0,659.0,5,1073,1.0,805.0,805.0
0.083,6,10,1506,5,395,17.0,127.0,127.0,5,1111,19.0,843.0,843.0
0.02,6,13,3735,7,497,3.0,125.0,125.0,6,3238,3.0,1470.0,1459.0
0.003,17,4,284,2,120,0.0,32.0,32.0,2,164,0.0,60.0,54.0
0.068,17,8,3613,4,1874,22.0,1350.0,440.0,4,1739,12.0,1350.0,406.0
0.009,6,10,1762,5,911,2.0,643.0,643.0,5,851,2.0,583.0,583.0
0.013,6,10,1989,5,910,3.0,642.0,642.0,5,1079,3.0,811.0,811.0
40.055,17,10,676,5,460,10012.0,104.0,64.0,5,216,10013.0,20.0,15.0
40.061,17,10,676,5,460,10014.0,104.0,64.0,5,216,10014.0,20.0,15.0
0.038,17,2,136,1,60,0.0,32.0,32.0,1,76,0.0,48.0,48.0
0.121,6,10,1506,5,395,30.0,127.0,127.0,5,1111,24.0,843.0,843.0
0.011,6,10,1972,5,910,2.0,642.0,642.0,5,1062,2.0,794.0,794.0
0.001,17,2,180,1,66,0.0,38.0,38.0,1,114,0.0,86.0,86.0
0.011,6,10,1547,5,764,2.0,496.0,496.0,5,783,2.0,515.0,515.0
40.066,17,10,676,5,460,10013.0,104.0,64.0,5,216,10015.0,20.0,15.0
0.036,17,2,144,1,64,0.0,36.0,36.0,1,80,0.0,52.0,52.0
0.005,17,2,136,1,60,0.0,32.0,32.0,1,76,0.0,48.0,48.0
0.005,6,10,1989,5,927,1.0,659.0,659.0,5,1062,1.0,794.0,794.0
0.094,6,10,1506,5,395,20.0,127.0,127.0,5,1111,17.0,843.0,843.0
0.076,6,10,1506,5,395,17.0,127.0,127.0,5,1111,16.0,843.0,843.0
0.005,17,2,175,1,65,0.0,37.0,37.0,1,110,0.0,82.0,82.0
0.168,6,10,1506,5,395,39.0,127.0,127.0,5,1111,39.0,843.0,843.0
0.005,17,2,240,1,61,0.0,33.0,33.0,1,179,0.0,151.0,151.0
0.005,6,10,1989,5,927,1.0,659.0,659.0,5,1062,1.0,794.0,794.0
240.017,6,9,787,5,488,60004.0,232.0,232.0,4,299,80004.0,83.0,83.0
0.096,6,10,1506,5,395,21.0,127.0,127.0,5,1111,20.0,843.0,843.0
0.005,6,10,2000,5,927,1.0,659.0,659.0,5,1073,1.0,805.0,805.0
0.004,6,10,2007,5,928,1.0,660.0,660.0,5,1079,1.0,811.0,811.0
0.003,17,2,185,1,73,0.0,45.0,45.0,1,112,0.0,84.0,84.0
0.053,17,2,152,1,76,0.0,48.0,48.0,1,76,0.0,48.0,48.0
40.072,17,10,676,5,460,10014.0,104.0,64.0,5,216,10017.0,20.0,15.0
0.005,6,10,1989,5,927,1.0,659.0,659.0,5,1062,1.0,794.0,794.0
0.092,6,10,1506,5,395,19.0,127.0,127.0,5,1111,18.0,843.0,843.0
0.089,6,10,1506,5,395,19.0,127.0,127.0,5,1111,21.0,843.0,843.0
0.103,6,10,1506,5,395,23.0,127.0,127.0,5,1111,22.0,843.0,843.0
0.001,17,2,180,1,66,0.0,38.0,38.0,1,114,0.0,86.0,86.0
0.015,6,10,1990,5,911,3.0,643.0,643.0,5,1079,3.0,811.0,811.0
0.119,6,10,1506,5,395,28.0,127.0,127.0,5,1111,25.0,843.0,843.0
0.009,6,10,1990,5,911,2.0,643.0,643.0,5,1079,2.0,811.0,811.0
0.049,6,20,9974,11,704,4.0,124.0,124.0,9,9270,6.0,2896.0,1758.0
1794.83,6,548,188845,284,163520,6342.0,2883.0,923.0,264,25325,6824.0,580.0,120.0
0.039,17,2,148,1,60,0.0,32.0,32.0,1,88,0.0,60.0,60.0
0.007,6,10,1989,5,910,1.0,642.0,642.0,5,1079,1.0,811.0,811.0
0.005,6,10,1643,5,860,1.0,592.0,592.0,5,783,1.0,515.0,515.0
0.126,6,10,1506,5,395,30.0,127.0,127.0,5,1111,20.0,843.0,843.0
175.13,17,94,13858,47,3166,3807.0,44.0,39.0,47,10692,3807.0,261.0,199.0
0.005,6,10,1547,5,764,1.0,496.0,496.0,5,783,1.0,515.0,515.0
0.006,6,10,1689,5,839,1.0,571.0,571.0,5,850,1.0,582.0,582.0
0.019,17,2,198,1,91,0.0,63.0,63.0,1,107,0.0,79.0,79.0
0.009,6,10,1990,5,911,2.0,643.0,643.0,5,1079,2.0,811.0,811.0
10.738,17,28,4418,14,1994,817.0,269.0,114.0,14,2424,817.0,587.0,145.0
0.007,6,10,1983,5,910,1.0,642.0,642.0,5,1073,1.0,805.0,805.0
0.017,6,6,716,3,458,7.0,302.0,302.0,3,258,6.0,102.0,102.0
0.027,17,2,193,1,71,0.0,43.0,43.0,1,122,0.0,94.0,94.0
240.016,6,9,787,5,488,60004.0,232.0,232.0,4,299,80004.0,83.0,83.0
0.013,6,10,1983,5,910,3.0,642.0,642.0,5,1073,3.0,805.0,805.0
0.004,6,10,1779,5,928,1.0,660.0,660.0,5,851,1.0,583.0,583.0
1770.302,6,84,4420,42,2210,43177.0,26.0,26.0,42,2210,43177.0,26.0,26.0
0.073,6,10,1506,5,395,16.0,127.0,127.0,5,1111,15.0,843.0,843.0
0.107,6,10,1506,5,395,24.0,127.0,127.0,5,1111,22.0,843.0,843.0
0.121,6,10,1506,5,395,29.0,127.0,127.0,5,1111,26.0,843.0,843.0
0.01,6,12,1926,6,1189,1.0,659.0,434.0,6,737,2.0,417.0,417.0
0.053,17,2,152,1,76,0.0,48.0,48.0,1,76,0.0,48.0,48.0
0.004,17,4,420,2,122,0.0,33.0,33.0,2,298,1.0,145.0,121.0
0.006,17,2,230,1,68,0.0,40.0,40.0,1,162,0.0,134.0,134.0
0.136,6,10,1506,5,395,30.0,127.0,127.0,5,1111,31.0,843.0,843.0
0.005,6,10,2006,5,927,1.0,659.0,659.0,5,1079,1.0,811.0,811.0
0.109,6,10,1506,5,395,24.0,127.0,127.0,5,1111,25.0,843.0,843.0
0.012,6,10,1989,5,910,2.0,642.0,642.0,5,1079,3.0,811.0,811.0
0.152,6,10,1506,5,395,33.0,127.0,127.0,5,1111,25.0,843.0,843.0
0.071,17,8,3613,4,1874,23.0,1350.0,440.0,4,1739,12.0,1350.0,406.0
0.006,6,10,1547,5,764,1.0,496.0,496.0,5,783,1.0,515.0,515.0
0.016,6,10,1677,5,827,4.0,559.0,559.0,5,850,4.0,582.0,582.0
0.002,17,2,180,1,66,0.0,38.0,38.0,1,114,0.0,86.0,86.0
240.011,6,9,787,5,488,60002.0,232.0,232.0,4,299,80002.0,83.0,83.0
0.035,17,2,144,1,64,0.0,36.0,36.0,1,80,0.0,52.0,52.0
0.01,6,10,1989,5,910,2.0,642.0,642.0,5,1079,2.0,811.0,811.0
0.098,6,10,1506,5,395,22.0,127.0,127.0,5,1111,22.0,843.0,843.0
0.007,6,10,1689,5,839,1.0,571.0,571.0,5,850,1.0,582.0,582.0
40.066,17,10,676,5,460,10015.0,104.0,64.0,5,216,10015.0,20.0,15.0
0.069,17,8,3613,4,1874,23.0,1350.0,440.0,4,1739,11.0,1350.0,406.0
0.004,6,10,2007,5,928,1.0,660.0,660.0,5,1079,1.0,811.0,811.0
0.054,17,2,152,1,76,0.0,48.0,48.0,1,76,0.0,48.0,48.0
0.005,6,10,1689,5,839,1.0,571.0,571.0,5,850,1.0,582.0,582.0
0.021,6,10,1989,5,910,5.0,642.0,642.0,5,1079,5.0,811.0,811.0
0.012,6,10,1989,5,910,2.0,642.0,642.0,5,1079,3.0,811.0,811.0
0.076,6,10,1506,5,395,17.0,127.0,127.0,5,1111,16.0,843.0,843.0
0.01,6,10,1990,5,911,2.0,643.0,643.0,5,1079,2.0,811.0,811.0
0.099,6,13,3735,7,497,16.0,125.0,125.0,6,3238,19.0,1470.0,1459.0
0.014,6,10,1989,5,910,3.0,642.0,642.0,5,1079,3.0,811.0,811.0
59.574,6,46,18366,24,12643,394.0,2720.0,1454.0,22,5723,2828.0,2667.0,402.0
0.006,6,10,2007,5,928,1.0,660.0,660.0,5,1079,1.0,811.0,811.0
0.017,6,10,1989,5,910,4.0,642.0,642.0,5,1079,4.0,811.0,811.0
0.011,17,2,214,1,75,0.0,47.0,47.0,1,139,0.0,111.0,111.0
0.006,6,10,1547,5,764,1.0,496.0,496.0,5,783,1.0,515.0,515.0
0.001,17,2,180,1,66,0.0,38.0,38.0,1,114,0.0,86.0,86.0
0.011,6,10,1989,5,910,2.0,642.0,642.0,5,1079,2.0,811.0,811.0
0.006,6,10,2006,5,927,1.0,659.0,659.0,5,1079,1.0,811.0,811.0
0.012,6,10,1989,5,910,2.0,642.0,642.0,5,1079,3.0,811.0,811.0
0.013,6,10,1983,5,910,3.0,642.0,642.0,5,1073,3.0,805.0,805.0
0.013,6,10,1989,5,910,3.0,642.0,642.0,5,1079,3.0,811.0,811.0
0.006,6,10,1854,5,889,1.0,621.0,621.0,5,965,1.0,697.0,697.0
0.037,17,2,412,1,61,0.0,33.0,33.0,1,351,0.0,323.0,323.0
0.014,6,10,1972,5,910,3.0,642.0,642.0,5,1062,3.0,794.0,794.0
15.071,17,14,9190,8,6902,2149.0,1350.0,834.0,6,2288,3008.0,1350.0,353.0
0.006,6,10,1547,5,764,1.0,496.0,496.0,5,783,1.0,515.0,515.0
0.0,17,2,166,1,75,0.0,47.0,47.0,1,91,0.0,63.0,63.0
0.004,17,4,284,2,120,0.0,32.0,32.0,2,164,1.0,60.0,54.0
0.013,6,13,3735,7,497,2.0,125.0,125.0,6,3238,2.0,1470.0,1459.0
0.071,17,8,3613,4,1874,23.0,1350.0,440.0,4,1739,12.0,1350.0,406.0
0.005,6,10,2000,5,927,1.0,659.0,659.0,5,1073,1.0,805.0,805.0
0.035,6,10,1990,5,911,8.0,643.0,643.0,5,1079,8.0,811.0,811.0
0.038,17,2,182,1,65,0.0,37.0,37.0,1,117,0.0,89.0,89.0
0.019,6,10,1989,5,910,4.0,642.0,642.0,5,1079,4.0,811.0,811.0
0.029,6,10,1989,5,910,7.0,642.0,642.0,5,1079,7.0,811.0,811.0
0.141,6,10,1506,5,395,32.0,127.0,127.0,5,1111,32.0,843.0,843.0
0.006,6,10,1547,5,764,1.0,496.0,496.0,5,783,1.0,515.0,515.0
0.017,6,10,1631,5,848,4.0,580.0,580.0,5,783,4.0,515.0,515.0
0.101,6,10,1506,5,395,24.0,127.0,127.0,5,1111,22.0,843.0,843.0
0.004,6,10,1702,5,863,1.0,595.0,595.0,5,839,0.0,571.0,571.0
0.015,6,10,1989,5,910,3.0,642.0,642.0,5,1079,3.0,811.0,811.0
0.012,6,10,1990,5,911,3.0,643.0,643.0,5,1079,2.0,811.0,811.0
0.128,17,2,80,1,32,0.0,4.0,4.0,1,48,0.0,20.0,20.0
0.019,6,10,1972,5,910,4.0,642.0,642.0,5,1062,4.0,794.0,794.0
352.261,6,20,2210,6,1308,12007.0,494.0,494.0,14,902,27096.0,83.0,83.0
300.393,6,16,2170,9,684,37527.0,146.0,146.0,7,1486,50037.0,419.0,398.0
308.599,17,16,892,8,564,44067.0,48.0,42.0,8,328,44067.0,20.0,13.0
0.154,6,10,1506,5,395,31.0,127.0,127.0,5,1111,35.0,843.0,843.0
0.005,6,10,2000,5,927,1.0,659.0,659.0,5,1073,1.0,805.0,805.0
0.004,6,10,1989,5,927,1.0,659.0,659.0,5,1062,1.0,794.0,794.0
0.06,17,2,152,1,76,0.0,48.0,48.0,1,76,0.0,48.0,48.0
0.006,6,10,1547,5,764,1.0,496.0,496.0,5,783,1.0,515.0,515.0
0.085,6,10,1506,5,395,17.0,127.0,127.0,5,1111,19.0,843.0,843.0
0.081,6,10,1506,5,395,18.0,127.0,127.0,5,1111,18.0,843.0,843.0
0.005,17,2,170,1,65,0.0,37.0,37.0,1,105,0.0,77.0,77.0
0.138,6,10,1506,5,395,32.0,127.0,127.0,5,1111,30.0,843.0,843.0
0.011,6,10,1972,5,910,2.0,642.0,642.0,5,1062,2.0,794.0,794.0
0.003,17,2,136,1,60,0.0,32.0,32.0,1,76,0.0,48.0,48.0
0.007,6,10,1689,5,839,1.0,571.0,571.0,5,850,1.0,582.0,582.0
40.064,17,10,676,5,460,10013.0,104.0,64.0,5,216,10015.0,20.0,15.0
0.007,17,2,194,1,59,0.0,31.0,31.0,1,135,0.0,107.0,107.0
0.006,6,10,1547,5,764,1.0,496.0,496.0,5,783,1.0,515.0,515.0
0.005,17,2,166,1,75,0.0,47.0,47.0,1,91,0.0,63.0,63.0
0.016,17,2,198,1,91,0.0,63.0,63.0,1,107,0.0,79.0,79.0
0.074,6,10,1506,5,395,16.0,127.0,127.0,5,1111,16.0,843.0,843.0
0.038,17,4,284,2,120,0.0,32.0,32.0,2,164,35.0,60.0,54.0
0.004,17,2,136,1,60,0.0,32.0,32.0,1,76,0.0,48.0,48.0
0.008,6,12,1926,6,1189,1.0,659.0,434.0,6,737,1.0,417.0,417.0
1772.256,6,105,6270,60,3525,30037.0,27.0,27.0,45,2745,40277.0,27.0,27.0
0.003,17,2,148,1,60,0.0,32.0,32.0,1,88,0.0,60.0,60.0
0.008,6,10,1989,5,910,2.0,642.0,642.0,5,1079,1.0,811.0,811.0
0.01,6,13,3735,7,497,1.0,125.0,125.0,6,3238,1.0,1470.0,1459.0
0.01,6,10,1983,5,910,2.0,642.0,642.0,5,1073,2.0,805.0,805.0
0.107,6,10,1506,5,395,23.0,127.0,127.0,5,1111,22.0,843.0,843.0
0.084,6,10,1506,5,395,20.0,127.0,127.0,5,1111,18.0,843.0,843.0
0.017,6,10,1989,5,910,4.0,642.0,642.0,5,1079,4.0,811.0,811.0
0.016,6,10,1631,5,848,3.0,580.0,580.0,5,783,3.0,515.0,515.0
0.171,17,2,152,1,76,0.0,48.0,48.0,1,76,0.0,48.0,48.0
0.005,6,10,1989,5,927,1.0,659.0,659.0,5,1062,1.0,794.0,794.0
0.085,6,10,1506,5,395,16.0,127.0,127.0,5,1111,16.0,843.0,843.0
0.004,17,2,136,1,60,0.0,32.0,32.0,1,76,0.0,48.0,48.0
378.672,6,22,2313,16,867,25244.0,195.0,195.0,6,1446,4677.0,419.0,398.0
0.04,17,2,412,1,61,0.0,33.0,33.0,1,351,0.0,323.0,323.0
0.005,6,13,3747,7,509,0.0,137.0,137.0,6,3238,0.0,1470.0,1459.0
0.008,6,10,1972,5,910,1.0,642.0,642.0,5,1062,2.0,794.0,794.0
0.005,6,10,2006,5,927,1.0,659.0,659.0,5,1079,1.0,811.0,811.0
0.013,6,10,1983,5,910,3.0,642.0,642.0,5,1073,3.0,805.0,805.0
240.012,6,9,787,5,488,60003.0,232.0,232.0,4,299,80003.0,83.0,83.0
0.005,6,10,1854,5,889,1.0,621.0,621.0,5,965,1.0,697.0,697.0
0.004,6,10,2000,5,927,1.0,659.0,659.0,5,1073,1.0,805.0,805.0
10.891,17,28,4422,14,1994,828.0,269.0,114.0,14,2428,828.0,587.0,145.0
0.001,17,2,144,1,64,0.0,36.0,36.0,1,80,0.0,52.0,52.0
0.037,17,4,420,2,122,0.0,33.0,33.0,2,298,33.0,145.0,121.0
0.015,6,10,1989,5,910,3.0,642.0,642.0,5,1079,3.0,811.0,811.0
0.217,6,16,2669,8,1395,31.0,533.0,323.0,8,1274,19.0,529.0,212.0
0.003,17,2,148,1,60,0.0,32.0,32.0,1,88,0.0,60.0,60.0
0.013,17,2,152,1,56,0.0,28.0,28.0,1,96,0.0,68.0,68.0
0.004,6,10,1702,5,863,1.0,595.0,595.0,5,839,1.0,571.0,571.0
0.005,6,10,2000,5,927,1.0,659.0,659.0,5,1073,1.0,805.0,805.0
178.422,17,74,10567,37,2465,4956.0,44.0,38.0,37,8102,4955.0,239.0,190.0
0.006,6,10,1854,5,889,1.0,621.0,621.0,5,965,1.0,697.0,697.0
0.006,6,10,1547,5,764,1.0,496.0,496.0,5,783,1.0,515.0,515.0
240.321,6,36,10646,18,2211,14136.0,555.0,253.0,18,8435,14135.0,1402.0,625.0
40.06,17,10,676,5,460,10014.0,104.0,64.0,5,216,10014.0,20.0,15.0
40.055,17,10,676,5,460,10012.0,104.0,64.0,5,216,10012.0,20.0,15.0
0.004,6,10,2006,5,927,1.0,659.0,659.0,5,1079,1.0,811.0,811.0
0.005,17,2,166,1,75,0.0,47.0,47.0,1,91,0.0,63.0,63.0
0.004,6,10,2000,5,927,1.0,659.0,659.0,5,1073,1.0,805.0,805.0
0.016,6,10,1983,5,910,4.0,642.0,642.0,5,1073,3.0,805.0,805.0
0.009,6,10,1983,5,910,2.0,642.0,642.0,5,1073,2.0,805.0,805.0
0.021,6,10,1972,5,910,5.0,642.0,642.0,5,1062,5.0,794.0,794.0
0.006,6,10,2007,5,928,1.0,660.0,660.0,5,1079,1.0,811.0,811.0
0.012,6,13,3735,7,497,2.0,125.0,125.0,6,3238,2.0,1470.0,1459.0
0.006,6,10,2000,5,927,1.0,659.0,659.0,5,1073,1.0,805.0,805.0
0.008,6,13,3735,7,497,1.0,125.0,125.0,6,3238,1.0,1470.0,1459.0
0.017,17,2,222,1,65,0.0,37.0,37.0,1,157,0.0,129.0,129.0
0.009,6,10,1989,5,910,2.0,642.0,642.0,5,1079,2.0,811.0,811.0
0.105,6,10,1506,5,395,25.0,127.0,127.0,5,1111,23.0,843.0,843.0
0.005,6,10,1689,5,839,1.0,571.0,571.0,5,850,1.0,582.0,582.0
0.084,6,10,1506,5,395,17.0,127.0,127.0,5,1111,19.0,843.0,843.0
0.008,6,10,1989,5,910,2.0,642.0,642.0,5,1079,2.0,811.0,811.0
15.078,17,16,8152,8,5979,2149.0,1350.0,719.0,8,2173,2149.0,1350.0,243.0
0.011,6,10,1990,5,911,2.0,643.0,643.0,5,1079,2.0,811.0,811.0
0.011,6,10,1990,5,911,2.0,643.0,643.0,5,1079,2.0,811.0,811.0
0.141,6,10,1506,5,395,33.0,127.0,127.0,5,1111,21.0,843.0,843.0
0.069,17,2,80,1,32,0.0,4.0,4.0,1,48,0.0,20.0,20.0
0.071,17,2,184,1,61,0.0,33.0,33.0,1,123,0.0,95.0,95.0
0.005,6,10,2007,5,928,1.0,660.0,660.0,5,1079,1.0,811.0,811.0
0.006,6,10,2006,5,927,1.0,659.0,659.0,5,1079,1.0,811.0,811.0
0.014,6,10,1990,5,911,3.0,643.0,643.0,5,1079,3.0,811.0,811.0
0.041,17,2,170,1,65,0.0,37.0,37.0,1,105,0.0,77.0,77.0
173.197,17,72,10094,36,2385,4948.0,44.0,38.0,36,7709,4948.0,239.0,186.0
0.013,6,10,1983,5,910,3.0,642.0,642.0,5,1073,3.0,805.0,805.0
0.004,6,10,1779,5,928,1.0,660.0,660.0,5,851,1.0,583.0,583.0
175.151,17,94,13486,47,3163,3807.0,44.0,39.0,47,10323,3807.0,261.0,191.0
0.183,6,3,453,2,321,183.0,241.0,241.0,1,132,0.0,92.0,92.0
0.007,17,2,148,1,60,0.0,32.0,32.0,1,88,0.0,60.0,60.0
0.006,6,10,2006,5,927,1.0,659.0,659.0,5,1079,1.0,811.0,811.0
0.013,6,10,1989,5,910,3.0,642.0,642.0,5,1079,3.0,811.0,811.0
0.005,6,10,1689,5,839,1.0,571.0,571.0,5,850,1.0,582.0,582.0
0.004,6,10,1989,5,927,1.0,659.0,659.0,5,1062,1.0,794.0,794.0
0.011,6,10,1990,5,911,2.0,643.0,643.0,5,1079,2.0,811.0,811.0
0.115,6,10,1506,5,395,26.0,127.0,127.0,5,1111,20.0,843.0,843.0
0.005,6,10,1774,5,923,1.0,655.0,655.0,5,851,1.0,583.0,583.0
0.004,6,10,1702,5,863,0.0,595.0,595.0,5,839,1.0,571.0,571.0
15.224,17,18,8194,9,5986,1899.0,1350.0,637.0,9,2208,1899.0,1350.0,217.0
0.109,6,10,1506,5,395,23.0,127.0,127.0,5,1111,24.0,843.0,843.0
0.028,6,10,1989,5,910,6.0,642.0,642.0,5,1079,6.0,811.0,811.0
0.083,6,10,1506,5,395,19.0,127.0,127.0,5,1111,15.0,843.0,843.0
0.067,6,10,1506,5,395,14.0,127.0,127.0,5,1111,14.0,843.0,843.0
0.025,6,13,3735,7,497,4.0,125.0,125.0,6,3238,4.0,1470.0,1459.0
0.005,17,2,164,1,74,0.0,46.0,46.0,1,90,0.0,62.0,62.0
0.004,17,2,148,1,60,0.0,32.0,32.0,1,88,0.0,60.0,60.0
0.013,6,10,1990,5,911,3.0,643.0,643.0,5,1079,3.0,811.0,811.0
0.001,17,2,180,1,66,0.0,38.0,38.0,1,114,0.0,86.0,86.0
40.075,17,10,676,5,460,10015.0,104.0,64.0,5,216,10017.0,20.0,15.0
0.014,6,10,1972,5,910,3.0,642.0,642.0,5,1062,3.0,794.0,794.0
0.003,17,2,136,1,60,0.0,32.0,32.0,1,76,0.0,48.0,48.0
0.003,17,2,136,1,60,0.0,32.0,32.0,1,76,0.0,48.0,48.0
0.094,6,10,1506,5,395,20.0,127.0,127.0,5,1111,22.0,843.0,843.0
0.004,6,10,2007,5,928,1.0,660.0,660.0,5,1079,1.0,811.0,811.0
0.012,6,10,1631,5,848,3.0,580.0,580.0,5,783,2.0,515.0,515.0
0.011,6,10,1989,5,910,2.0,642.0,642.0,5,1079,2.0,811.0,811.0
0.013,6,10,1972,5,910,3.0,642.0,642.0,5,1062,3.0,794.0,794.0
0.219,6,16,2670,8,1396,31.0,533.0,324.0,8,1274,19.0,529.0,212.0
0.04,17,2,148,1,60,0.0,32.0,32.0,1,88,0.0,60.0,60.0
0.039,17,4,284,2,120,0.0,32.0,32.0,2,164,36.0,60.0,54.0
0.016,6,10,1677,5,827,4.0,559.0,559.0,5,850,4.0,582.0,582.0
40.062,17,10,676,5,460,10012.0,104.0,64.0,5,216,10014.0,20.0,15.0
0.004,6,10,2006,5,927,1.0,659.0,659.0,5,1079,1.0,811.0,811.0
175.464,17,78,11089,39,2600,4617.0,44.0,38.0,39,8489,4617.0,239.0,189.0
0.048,6,10,1972,5,910,12.0,642.0,642.0,5,1062,12.0,794.0,794.0
0.01,6,10,1972,5,910,2.0,642.0,642.0,5,1062,2.0,794.0,794.0
0.008,6,10,1677,5,827,2.0,559.0,559.0,5,850,2.0,582.0,582.0
0.014,6,10,1990,5,911,3.0,643.0,643.0,5,1079,3.0,811.0,811.0
0.005,6,10,1854,5,889,1.0,621.0,621.0,5,965,1.0,697.0,697.0
0.023,17,2,170,1,65,0.0,37.0,37.0,1,105,0.0,77.0,77.0
0.005,17,2,170,1,65,0.0,37.0,37.0,1,105,0.0,77.0,77.0
240.108,6,20,4869,9,2181,30013.0,966.0,568.0,11,2688,24010.0,1162.0,351.0
0.006,17,2,140,1,62,0.0,34.0,34.0,1,78,0.0,50.0,50.0
0.014,6,10,1631,5,848,3.0,580.0,580.0,5,783,3.0,515.0,515.0
0.005,6,10,2000,5,927,1.0,659.0,659.0,5,1073,1.0,805.0,805.0
0.013,6,14,3787,7,497,2.0,125.0,125.0,7,3290,2.0,1448.0,972.0
167.342,17,76,11026,38,2569,4522.0,44.0,39.0,38,8457,4522.0,239.0,194.0
0.121,6,10,1506,5,395,23.0,127.0,127.0,5,1111,24.0,843.0,843.0
0.005,6,10,1989,5,927,1.0,659.0,659.0,5,1062,1.0,794.0,794.0
0.01,6,10,1990,5,911,2.0,643.0,643.0,5,1079,2.0,811.0,811.0
0.004,17,4,284,2,120,0.0,32.0,32.0,2,164,1.0,60.0,54.0
0.007,6,10,1547,5,764,1.0,496.0,496.0,5,783,1.0,515.0,515.0
0.005,6,10,2006,5,927,1.0,659.0,659.0,5,1079,1.0,811.0,811.0
0.006,17,2,148,1,60,0.0,32.0,32.0,1,88,0.0,60.0,60.0
0.005,17,2,166,1,75,0.0,47.0,47.0,1,91,0.0,63.0,63.0
354.049,6,21,1795,16,1030,23603.0,190.0,190.0,5,765,60002.0,464.0,248.0
40.067,17,10,676,5,460,10015.0,104.0,64.0,5,216,10015.0,20.0,15.0
0.004,6,10,1989,5,927,1.0,659.0,659.0,5,1062,1.0,794.0,794.0
0.005,17,2,166,1,75,0.0,47.0,47.0,1,91,0.0,63.0,63.0
0.014,6,10,1972,5,910,3.0,642.0,642.0,5,1062,3.0,794.0,794.0
0.003,17,2,148,1,60,0.0,32.0,32.0,1,88,0.0,60.0,60.0
0.079,6,10,1506,5,395,17.0,127.0,127.0,5,1111,17.0,843.0,843.0
0.12,6,10,1506,5,395,29.0,127.0,127.0,5,1111,27.0,843.0,843.0
0.005,6,10,2006,5,927,1.0,659.0,659.0,5,1079,1.0,811.0,811.0
0.145,17,2,80,1,32,0.0,4.0,4.0,1,48,0.0,20.0,20.0
240.156,6,49,6730,23,3318,10916.0,588.0,211.0,26,3412,9606.0,580.0,171.0
0.01,6,10,1762,5,911,2.0,643.0,643.0,5,851,2.0,583.0,583.0
1772.727,6,107,6374,60,3525,30045.0,27.0,27.0,47,2849,38536.0,27.0,27.0
300.288,6,16,2170,9,684,37515.0,146.0,146.0,7,1486,50020.0,419.0,398.0
0.006,6,10,1547,5,764,1.0,496.0,496.0,5,783,1.0,515.0,515.0
0.089,6,10,1506,5,395,19.0,127.0,127.0,5,1111,19.0,843.0,843.0
0.005,6,10,1989,5,927,1.0,659.0,659.0,5,1062,1.0,794.0,794.0
0.01,6,10,1677,5,827,2.0,559.0,559.0,5,850,2.0,582.0,582.0
0.013,6,10,1983,5,910,3.0,642.0,642.0,5,1073,3.0,805.0,805.0
308.273,17,20,1124,10,716,34239.0,48.0,43.0,10,408,34238.0,20.0,12.0
0.001,17,2,130,1,65,0.0,37.0,37.0,1,65,0.0,37.0,37.0
0.042,17,4,284,2,120,1.0,32.0,32.0,2,164,38.0,60.0,54.0
0.014,6,10,1989,5,910,3.0,642.0,642.0,5,1079,3.0,811.0,811.0
0.005,6,10,2006,5,927,1.0,659.0,659.0,5,1079,1.0,811.0,811.0
0.072,17,2,166,1,75,0.0,47.0,47.0,1,91,0.0,63.0,63.0
0.001,17,2,180,1,66,0.0,38.0,38.0,1,114,0.0,86.0,86.0
0.004,17,4,284,2,120,0.0,32.0,32.0,2,164,1.0,60.0,54.0
0.006,6,10,1547,5,764,1.0,496.0,496.0,5,783,1.0,515.0,515.0
0.003,17,2,148,1,60,0.0,32.0,32.0,1,88,0.0,60.0,60.0
0.0,17,2,180,1,66,0.0,38.0,38.0,1,114,0.0,86.0,86.0
292.167,6,410,349492,201,22017,1460.0,2736.0,889.0,209,327475,1404.0,2899.0,1623.0
0.085,6,10,1506,5,395,18.0,127.0,127.0,5,1111,19.0,843.0,843.0
0.006,17,2,179,1,71,0.0,43.0,43.0,1,108,0.0,80.0,80.0
0.014,6,10,1989,5,910,3.0,642.0,642.0,5,1079,3.0,811.0,811.0
0.012,6,10,1989,5,910,3.0,642.0,642.0,5,1079,2.0,811.0,811.0
166.288,17,76,10710,38,2529,4494.0,44.0,38.0,38,8181,4494.0,239.0,187.0
0.005,6,13,3747,7,509,0.0,137.0,137.0,6,3238,1.0,1470.0,1459.0
0.04,17,2,412,1,61,0.0,33.0,33.0,1,351,0.0,323.0,323.0
0.011,6,10,1990,5,911,2.0,643.0,643.0,5,1079,2.0,811.0,811.0
1.046,6,32,13391,18,5892,61.0,2720.0,854.0,14,7499,66.0,2720.0,769.0
0.011,6,14,3787,7,497,1.0,125.0,125.0,7,3290,1.0,1448.0,972.0
0.006,6,10,1547,5,764,1.0,496.0,496.0,5,783,1.0,515.0,515.0
0.005,6,10,1689,5,839,1.0,571.0,571.0,5,850,1.0,582.0,582.0
0.016,6,10,1631,5,848,3.0,580.0,580.0,5,783,4.0,515.0,515.0
0.005,6,10,2006,5,927,1.0,659.0,659.0,5,1079,1.0,811.0,811.0
0.005,6,10,1854,5,889,1.0,621.0,621.0,5,965,1.0,697.0,697.0
308.45,17,20,1124,10,716,34264.0,48.0,43.0,10,408,34263.0,20.0,12.0
0.054,17,2,152,1,76,0.0,48.0,48.0,1,76,0.0,48.0,48.0
0.006,6,10,1547,5,764,1.0,496.0,496.0,5,783,1.0,515.0,515.0
0.005,6,10,2006,5,927,1.0,659.0,659.0,5,1079,1.0,811.0,811.0
15.075,17,14,9190,8,6902,2149.0,1350.0,834.0,6,2288,3008.0,1350.0,353.0
240.033,6,9,787,5,488,60008.0,232.0,232.0,4,299,80010.0,83.0,83.0
0.008,6,10,1990,5,911,2.0,643.0,643.0,5,1079,2.0,811.0,811.0
0.022,6,10,1972,5,910,5.0,642.0,642.0,5,1062,5.0,794.0,794.0
0.219,6,16,2669,8,1395,31.0,533.0,323.0,8,1274,20.0,529.0,212.0
177.373,17,74,10533,37,2473,4926.0,44.0,38.0,37,8060,4926.0,261.0,189.0
0.111,6,10,1506,5,395,24.0,127.0,127.0,5,1111,23.0,843.0,843.0
0.004,6,10,1702,5,863,0.0,595.0,595.0,5,839,1.0,571.0,571.0
0.003,17,4,284,2,120,0.0,32.0,32.0,2,164,0.0,60.0,54.0
0.017,6,10,1983,5,910,4.0,642.0,642.0,5,1073,4.0,805.0,805.0
0.005,6,10,2007,5,928,1.0,660.0,660.0,5,1079,1.0,811.0,811.0
0.073,17,4,420,2,122,1.0,33.0,33.0,2,298,34.0,145.0,121.0
0.055,6,10,1506,5,395,12.0,127.0,127.0,5,1111,13.0,843.0,843.0
0.079,6,10,1506,5,395,18.0,127.0,127.0,5,1111,18.0,843.0,843.0
0.012,6,10,1677,5,827,3.0,559.0,559.0,5,850,3.0,582.0,582.0
0.078,6,10,1506,5,395,17.0,127.0,127.0,5,1111,16.0,843.0,843.0
0.005,6,10,1854,5,889,1.0,621.0,621.0,5,965,1.0,697.0,697.0
40.062,17,10,676,5,460,10013.0,104.0,64.0,5,216,10014.0,20.0,15.0
0.006,17,2,193,1,71,0.0,43.0,43.0,1,122,0.0,94.0,94.0
0.005,6,10,2006,5,927,1.0,659.0,659.0,5,1079,1.0,811.0,811.0
242.463,6,295,342282,116,17540,2108.0,2736.0,959.0,179,324742,1362.0,2804.0,1866.0
0.006,6,10,1547,5,764,1.0,496.0,496.0,5,783,1.0,515.0,515.0
0.005,6,10,2007,5,928,1.0,660.0,660.0,5,1079,1.0,811.0,811.0
0.021,6,10,1762,5,911,5.0,643.0,643.0,5,851,5.0,583.0,583.0
0.126,17,4,284,2,120,0.0,32.0,32.0,2,164,123.0,60.0,54.0
0.006,6,10,1547,5,764,1.0,496.0,496.0,5,783,1.0,515.0,515.0
356.626,6,21,1795,16,1030,23775.0,190.0,190.0,5,765,60003.0,464.0,248.0
0.004,6,10,2006,5,927,1.0,659.0,659.0,5,1079,1.0,811.0,811.0
0.016,6,10,1983,5,910,4.0,642.0,642.0,5,1073,3.0,805.0,805.0
0.005,6,10,1547,5,764,1.0,496.0,496.0,5,783,1.0,515.0,515.0
0.006,17,2,179,1,71,0.0,43.0,43.0,1,108,0.0,80.0,80.0
0.005,17,2,214,1,75,0.0,47.0,47.0,1,139,0.0,111.0,111.0
0.004,6,10,2006,5,927,1.0,659.0,659.0,5,1079,1.0,811.0,811.0
0.111,6,10,1506,5,395,23.0,127.0,127.0,5,1111,23.0,843.0,843.0
0.092,6,10,1506,5,395,22.0,127.0,127.0,5,1111,18.0,843.0,843.0
0.008,17,2,144,1,64,0.0,36.0,36.0,1,80,0.0,52.0,52.0
0.01,6,10,1983,5,910,2.0,642.0,642.0,5,1073,2.0,805.0,805.0
0.005,17,2,230,1,68,0.0,40.0,40.0,1,162,0.0,134.0,134.0
0.088,6,10,1506,5,395,19.0,127.0,127.0,5,1111,17.0,843.0,843.0
40.062,17,10,676,5,460,10014.0,104.0,64.0,5,216,10014.0,20.0,15.0
0.004,17,2,136,1,60,0.0,32.0,32.0,1,76,0.0,48.0,48.0
0.019,6,10,1990,5,911,4.0,643.0,643.0,5,1079,4.0,811.0,811.0
0.215,6,16,2782,8,1400,30.0,533.0,325.0,8,1382,19.0,529.0,239.0
0.009,6,10,1989,5,910,2.0,642.0,642.0,5,1079,2.0,811.0,811.0
0.012,6,10,1989,5,910,2.0,642.0,642.0,5,1079,2.0,811.0,811.0
0.092,6,10,1506,5,395,19.0,127.0,127.0,5,1111,19.0,843.0,843.0
0.006,6,10,1547,5,764,1.0,496.0,496.0,5,783,1.0,515.0,515.0
0.022,6,10,1972,5,910,5.0,642.0,642.0,5,1062,5.0,794.0,794.0
0.005,6,10,2000,5,927,1.0,659.0,659.0,5,1073,1.0,805.0,805.0
0.092,6,10,1506,5,395,21.0,127.0,127.0,5,1111,18.0,843.0,843.0
0.105,6,10,1506,5,395,23.0,127.0,127.0,5,1111,18.0,843.0,843.0
0.004,6,10,1702,5,863,0.0,595.0,595.0,5,839,1.0,571.0,571.0
0.119,17,2,80,1,32,0.0,4.0,4.0,1,48,0.0,20.0,20.0
0.107,6,10,1506,5,395,20.0,127.0,127.0,5,1111,25.0,843.0,843.0
0.004,17,2,136,1,60,0.0,32.0,32.0,1,76,0.0,48.0,48.0
40.056,17,10,676,5,460,10013.0,104.0,64.0,5,216,10010.0,20.0,15.0
0.152,6,10,1506,5,395,37.0,127.0,127.0,5,1111,35.0,843.0,843.0
0.009,6,10,1989,5,910,2.0,642.0,642.0,5,1079,2.0,811.0,811.0
40.067,17,10,676,5,460,10016.0,104.0,64.0,5,216,10015.0,20.0,15.0
0.006,6,10,1547,5,764,1.0,496.0,496.0,5,783,1.0,515.0,515.0
0.01,6,10,1989,5,927,2.0,659.0,659.0,5,1062,2.0,794.0,794.0
0.269,17,39,20216,21,17041,13.0,1350.0,783.0,18,3175,11.0,1350.0,148.0
0.005,6,10,1689,5,839,1.0,571.0,571.0,5,850,1.0,582.0,582.0
0.006,6,10,1854,5,889,1.0,621.0,621.0,5,965,1.0,697.0,697.0
0.013,6,10,1989,5,910,3.0,642.0,642.0,5,1079,3.0,811.0,811.0
11.006,17,28,4365,14,2311,838.0,586.0,137.0,14,2054,838.0,269.0,118.0
15.076,17,14,9190,8,6902,2149.0,1350.0,834.0,6,2288,3008.0,1350.0,353.0
0.042,6,10,1990,5,911,10.0,643.0,643.0,5,1079,10.0,811.0,811.0
0.005,17,2,152,1,68,0.0,40.0,40.0,1,84,0.0,56.0,56.0
0.009,6,10,1547,5,764,2.0,496.0,496.0,5,783,2.0,515.0,515.0
240.093,6,31,9256,15,6922,17149.0,2047.0,682.0,16,2334,16006.0,580.0,186.0
0.11,6,10,1506,5,395,24.0,127.0,127.0,5,1111,24.0,843.0,843.0
15.071,17,15,9238,8,6902,2148.0,1350.0,834.0,7,2336,2506.0,1350.0,305.0
0.075,6,10,1506,5,395,17.0,127.0,127.0,5,1111,16.0,843.0,843.0
0.006,6,10,1689,5,839,1.0,571.0,571.0,5,850,1.0,582.0,582.0
0.131,6,10,1506,5,395,31.0,127.0,127.0,5,1111,27.0,843.0,843.0
240.484,6,33,8639,17,1839,15028.0,572.0,189.0,16,6800,16030.0,1402.0,597.0
0.001,17,2,180,1,65,0.0,37.0,37.0,1,115,0.0,87.0,87.0
0.011,6,10,1972,5,910,2.0,642.0,642.0,5,1062,2.0,794.0,794.0
0.003,17,2,170,1,65,0.0,37.0,37.0,1,105,0.0,77.0,77.0
294.279,6,373,346658,185,21190,1599.0,2736.0,889.0,188,325468,1573.0,2804.0,1814.0
0.014,6,10,1972,5,910,3.0,642.0,642.0,5,1062,3.0,794.0,794.0
0.004,6,10,1989,5,927,1.0,659.0,659.0,5,1062,1.0,794.0,794.0
40.059,17,10,676,5,460,10013.0,104.0,64.0,5,216,10013.0,20.0,15.0
0.005,6,10,2006,5,927,1.0,659.0,659.0,5,1079,1.0,811.0,811.0
0.009,6,10,1762,5,911,2.0,643.0,643.0,5,851,2.0,583.0,583.0
0.006,6,10,2007,5,928,1.0,660.0,660.0,5,1079,1.0,811.0,811.0
11.305,17,28,4417,14,1993,857.0,268.0,114.0,14,2424,857.0,587.0,145.0
0.07,6,10,1506,5,395,16.0,127.0,127.0,5,1111,13.0,843.0,843.0
240.38,6,35,8825,18,1903,14139.0,572.0,189.0,17,6922,15023.0,1402.0,549.0
308.316,17,20,1124,10,716,34243.0,48.0,43.0,10,408,34243.0,20.0,12.0
240.186,6,41,8084,20,2178,12641.0,517.0,161.0,21,5906,12009.0,1665.0,534.0
0.01,17,4,284,2,120,7.0,32.0,32.0,2,164,6.0,60.0,54.0
0.017,6,10,1677,5,827,4.0,559.0,559.0,5,850,4.0,582.0,582.0
0.004,17,4,284,2,120,0.0,32.0,32.0,2,164,0.0,60.0,54.0
0.056,17,2,152,1,76,0.0,48.0,48.0,1,76,0.0,48.0,48.0
0.039,17,2,186,1,61,0.0,33.0,33.0,1,125,0.0,97.0,97.0
40.062,17,10,676,5,460,10014.0,104.0,64.0,5,216,10008.0,20.0,15.0
0.125,6,10,1506,5,395,30.0,127.0,127.0,5,1111,29.0,843.0,843.0
0.005,6,10,2006,5,927,1.0,659.0,659.0,5,1079,1.0,811.0,811.0
0.003,17,2,136,1,60,0.0,32.0,32.0,1,76,0.0,48.0,48.0
0.017,6,10,1677,5,827,4.0,559.0,559.0,5,850,4.0,582.0,582.0
0.084,6,10,1506,5,395,19.0,127.0,127.0,5,1111,17.0,843.0,843.0
0.006,6,10,1547,5,764,1.0,496.0,496.0,5,783,1.0,515.0,515.0
0.216,6,16,2777,8,1395,30.0,533.0,323.0,8,1382,19.0,529.0,239.0
0.003,17,4,284,2,120,0.0,32.0,32.0,2,164,0.0,60.0,54.0
0.016,17,2,198,1,91,0.0,63.0,63.0,1,107,0.0,79.0,79.0
40.069,17,10,676,5,460,10013.0,104.0,64.0,5,216,10016.0,20.0,15.0
0.004,6,10,2006,5,927,1.0,659.0,659.0,5,1079,1.0,811.0,811.0
0.012,6,10,1989,5,910,2.0,642.0,642.0,5,1079,3.0,811.0,811.0
0.006,17,2,255,1,82,0.0,54.0,54.0,1,173,0.0,145.0,145.0
0.079,6,10,1506,5,395,17.0,127.0,127.0,5,1111,19.0,843.0,843.0
0.018,6,10,1989,5,910,4.0,642.0,642.0,5,1079,4.0,811.0,811.0
0.005,6,10,1989,5,927,1.0,659.0,659.0,5,1062,1.0,794.0,794.0
0.009,6,10,1972,5,910,2.0,642.0,642.0,5,1062,2.0,794.0,794.0
240.087,6,16,4482,9,963,30010.0,238.0,166.0,7,3519,40014.0,1402.0,786.0
0.09,6,10,1506,5,395,20.0,127.0,127.0,5,1111,21.0,843.0,843.0
0.005,6,13,3747,7,509,0.0,137.0,137.0,6,3238,0.0,1470.0,1459.0
0.069,17,8,3613,4,1874,23.0,1350.0,440.0,4,1739,11.0,1350.0,406.0
0.008,6,10,1972,5,910,2.0,642.0,642.0,5,1062,2.0,794.0,794.0
0.012,17,2,152,1,56,0.0,28.0,28.0,1,96,0.0,68.0,68.0
0.129,17,2,80,1,32,0.0,4.0,4.0,1,48,0.0,20.0,20.0
0.003,17,2,136,1,60,0.0,32.0,32.0,1,76,0.0,48.0,48.0
0.009,6,10,2006,5,927,2.0,659.0,659.0,5,1079,2.0,811.0,811.0
0.004,6,10,1779,5,928,1.0,660.0,660.0,5,851,0.0,583.0,583.0
0.006,6,10,1547,5,764,1.0,496.0,496.0,5,783,1.0,515.0,515.0
0.005,6,10,2006,5,927,1.0,659.0,659.0,5,1079,1.0,811.0,811.0
0.015,6,10,1972,5,910,3.0,642.0,642.0,5,1062,3.0,794.0,794.0
0.006,6,10,1547,5,764,1.0,496.0,496.0,5,783,1.0,515.0,515.0
0.013,6,10,1983,5,910,3.0,642.0,642.0,5,1073,3.0,805.0,805.0
0.01,17,2,170,1,65,0.0,37.0,37.0,1,105,0.0,77.0,77.0
0.009,6,10,1972,5,910,2.0,642.0,642.0,5,1062,2.0,794.0,794.0
1768.529,6,88,5497,45,2438,40192.0,36.0,32.0,43,3059,42106.0,440.0,274.0
0.003,17,2,148,1,60,0.0,32.0,32.0,1,88,0.0,60.0,60.0
0.106,6,10,1506,5,395,25.0,127.0,127.0,5,1111,25.0,843.0,843.0
0.12,6,10,1506,5,395,29.0,127.0,127.0,5,1111,27.0,843.0,843.0
0.086,6,10,1506,5,395,20.0,127.0,127.0,5,1111,20.0,843.0,843.0
15.074,17,14,9191,8,6902,2149.0,1350.0,834.0,6,2289,3008.0,1350.0,353.0
0.006,6,10,1547,5,764,1.0,496.0,496.0,5,783,1.0,515.0,515.0
0.011,6,10,1989,5,910,2.0,642.0,642.0,5,1079,2.0,811.0,811.0
0.011,6,10,1972,5,910,2.0,642.0,642.0,5,1062,2.0,794.0,794.0
0.004,6,10,1702,5,863,1.0,595.0,595.0,5,839,1.0,571.0,571.0
0.005,6,10,2006,5,927,1.0,659.0,659.0,5,1079,1.0,811.0,811.0
40.063,17,10,676,5,460,10013.0,104.0,64.0,5,216,10015.0,20.0,15.0
0.009,6,10,1677,5,827,2.0,559.0,559.0,5,850,2.0,582.0,582.0
0.003,17,4,284,2,120,0.0,32.0,32.0,2,164,0.0,60.0,54.0
0.013,6,10,1972,5,910,3.0,642.0,642.0,5,1062,3.0,794.0,794.0
0.008,6,10,1689,5,839,1.0,571.0,571.0,5,850,1.0,582.0,582.0
0.088,6,10,1506,5,395,18.0,127.0,127.0,5,1111,19.0,843.0,843.0
0.077,6,10,1506,5,395,17.0,127.0,127.0,5,1111,17.0,843.0,843.0
0.012,6,10,1989,5,910,3.0,642.0,642.0,5,1079,2.0,811.0,811.0
0.012,6,10,1990,5,911,3.0,643.0,643.0,5,1079,3.0,811.0,811.0
0.009,6,10,1854,5,889,2.0,621.0,621.0,5,965,2.0,697.0,697.0
40.082,17,10,676,5,460,10019.0,104.0,64.0,5,216,10019.0,20.0,15.0
0.087,6,10,1506,5,395,21.0,127.0,127.0,5,1111,17.0,843.0,843.0
0.072,17,4,352,2,130,0.0,37.0,37.0,2,222,31.0,89.0,83.0
0.006,6,10,2006,5,927,1.0,659.0,659.0,5,1079,1.0,811.0,811.0
0.005,17,2,140,1,62,0.0,34.0,34.0,1,78,0.0,50.0,50.0
0.016,6,10,1990,5,911,4.0,643.0,643.0,5,1079,3.0,811.0,811.0
0.125,17,4,596,2,122,86.0,33.0,33.0,2,474,53.0,323.0,209.0
0.001,17,2,180,1,66,0.0,38.0,38.0,1,114,0.0,86.0,86.0
15.167,17,56,34581,32,28584,488.0,1350.0,865.0,24,5997,658.0,1350.0,221.0
0.011,6,10,1631,5,848,2.0,580.0,580.0,5,783,2.0,515.0,515.0
0.006,6,13,3690,7,452,0.0,80.0,80.0,6,3238,1.0,1470.0,1459.0
0.016,6,10,1631,5,848,3.0,580.0,580.0,5,783,4.0,515.0,515.0
0.007,6,10,1547,5,764,1.0,496.0,496.0,5,783,1.0,515.0,515.0
0.089,6,10,1506,5,395,20.0,127.0,127.0,5,1111,20.0,843.0,843.0
0.009,6,10,1631,5,848,2.0,580.0,580.0,5,783,2.0,515.0,515.0
0.102,6,10,1506,5,395,22.0,127.0,127.0,5,1111,21.0,843.0,843.0
0.005,17,2,164,1,74,0.0,46.0,46.0,1,90,0.0,62.0,62.0
0.005,6,10,2006,5,927,1.0,659.0,659.0,5,1079,1.0,811.0,811.0
0.004,17,2,208,1,72,0.0,44.0,44.0,1,136,0.0,108.0,108.0
0.005,6,10,1689,5,839,1.0,571.0,571.0,5,850,1.0,582.0,582.0
0.043,17,4,420,2,122,0.0,33.0,33.0,2,298,37.0,145.0,121.0
0.004,6,10,1702,5,863,1.0,595.0,595.0,5,839,0.0,571.0,571.0
0.003,6,10,1702,5,863,0.0,595.0,595.0,5,839,0.0,571.0,571.0
40.059,17,10,676,5,460,10013.0,104.0,64.0,5,216,10013.0,20.0,15.0
0.277,6,16,2783,8,1401,39.0,533.0,325.0,8,1382,26.0,529.0,239.0
0.005,6,10,2006,5,927,1.0,659.0,659.0,5,1079,1.0,811.0,811.0
0.009,6,10,1990,5,911,2.0,643.0,643.0,5,1079,2.0,811.0,811.0
0.019,6,10,1762,5,911,4.0,643.0,643.0,5,851,4.0,583.0,583.0
0.006,6,10,1547,5,764,1.0,496.0,496.0,5,783,1.0,515.0,515.0
0.156,6,10,1506,5,395,36.0,127.0,127.0,5,1111,34.0,843.0,843.0
0.055,17,2,182,1,65,0.0,37.0,37.0,1,117,0.0,89.0,89.0
0.017,17,2,187,1,74,0.0,46.0,46.0,1,113,0.0,85.0,85.0
0.003,17,4,284,2,120,0.0,32.0,32.0,2,164,0.0,60.0,54.0
0.076,6,10,1506,5,395,15.0,127.0,127.0,5,1111,15.0,843.0,843.0
0.019,6,13,3735,7,497,3.0,125.0,125.0,6,3238,3.0,1470.0,1459.0
40.066,17,10,676,5,460,10015.0,104.0,64.0,5,216,10015.0,20.0,15.0
264.624,6,31,11931,12,8869,24056.0,2736.0,1374.0,19,3062,14699.0,1162.0,413.0
0.005,6,10,2006,5,927,1.0,659.0,659.0,5,1079,1.0,811.0,811.0
309.0,17,20,1124,10,716,34319.0,48.0,43.0,10,408,34322.0,20.0,12.0
0.001,17,2,136,1,60,0.0,32.0,32.0,1,76,0.0,48.0,48.0
0.096,6,10,1506,5,395,21.0,127.0,127.0,5,1111,19.0,843.0,843.0
0.005,17,2,169,1,62,0.0,34.0,34.0,1,107,0.0,79.0,79.0
0.003,17,2,136,1,60,0.0,32.0,32.0,1,76,0.0,48.0,48.0
0.013,6,10,1989,5,910,3.0,642.0,642.0,5,1079,3.0,811.0,811.0
40.068,17,10,676,5,460,10016.0,104.0,64.0,5,216,10016.0,20.0,15.0
0.006,17,2,179,1,71,0.0,43.0,43.0,1,108,0.0,80.0,80.0
0.015,6,10,1990,5,911,3.0,643.0,643.0,5,1079,3.0,811.0,811.0
0.086,6,10,1506,5,395,18.0,127.0,127.0,5,1111,18.0,843.0,843.0
412.895,6,29,4409,12,3102,10915.0,494.0,494.0,17,1307,25805.0,83.0,83.0
0.001,17,2,154,1,69,0.0,41.0,41.0,1,85,0.0,57.0,57.0
0.196,17,4,352,2,130,145.0,37.0,37.0,2,222,155.0,89.0,83.0
0.018,6,10,1990,5,911,4.0,643.0,643.0,5,1079,4.0,811.0,811.0
0.006,6,10,1547,5,764,1.0,496.0,496.0,5,783,1.0,515.0,515.0
0.006,6,10,1547,5,764,1.0,496.0,496.0,5,783,1.0,515.0,515.0
0.102,6,10,1506,5,395,19.0,127.0,127.0,5,1111,21.0,843.0,843.0
0.172,6,11,1558,6,447,33.0,127.0,127.0,5,1111,41.0,843.0,843.0
0.009,6,12,1926,6,1189,1.0,659.0,434.0,6,737,1.0,417.0,417.0
11.652,17,32,5081,18,2681,678.0,268.0,120.0,14,2400,887.0,587.0,143.0
0.005,17,2,170,1,65,0.0,37.0,37.0,1,105,0.0,77.0,77.0
0.005,6,14,3799,7,509,0.0,137.0,137.0,7,3290,0.0,1448.0,972.0
0.005,6,10,2006,5,927,1.0,659.0,659.0,5,1079,1.0,811.0,811.0
0.013,6,10,1989,5,910,3.0,642.0,642.0,5,1079,3.0,811.0,811.0
335.152,17,20,1124,10,716,37225.0,48.0,43.0,10,408,37225.0,20.0,12.0
0.072,6,10,1506,5,395,16.0,127.0,127.0,5,1111,17.0,843.0,843.0
0.007,6,10,1990,5,911,1.0,643.0,643.0,5,1079,1.0,811.0,811.0
0.015,6,10,1989,5,910,3.0,642.0,642.0,5,1079,3.0,811.0,811.0
0.261,6,16,2783,8,1401,37.0,533.0,325.0,8,1382,24.0,529.0,239.0
0.005,6,10,2000,5,927,1.0,659.0,659.0,5,1073,1.0,805.0,805.0
0.004,6,10,1779,5,928,1.0,660.0,660.0,5,851,1.0,583.0,583.0
0.005,17,2,154,1,69,0.0,41.0,41.0,1,85,0.0,57.0,57.0
0.006,6,10,1989,5,927,1.0,659.0,659.0,5,1062,1.0,794.0,794.0
1787.387,6,154,19574,92,13852,19641.0,302.0,302.0,62,5722,29301.0,83.0,83.0
0.003,17,4,284,2,120,0.0,32.0,32.0,2,164,1.0,60.0,54.0
40.054,17,10,676,5,460,10012.0,104.0,64.0,5,216,10012.0,20.0,15.0
0.073,6,10,1506,5,395,15.0,127.0,127.0,5,1111,17.0,843.0,843.0
0.17,6,3,453,2,321,170.0,241.0,241.0,1,132,0.0,92.0,92.0
0.005,6,10,2006,5,927,1.0,659.0,659.0,5,1079,1.0,811.0,811.0
0.01,6,10,1989,5,910,2.0,642.0,642.0,5,1079,2.0,811.0,811.0
0.012,6,10,1983,5,910,2.0,642.0,642.0,5,1073,3.0,805.0,805.0
0.005,6,10,1989,5,927,1.0,659.0,659.0,5,1062,1.0,794.0,794.0
0.007,6,10,1990,5,911,1.0,643.0,643.0,5,1079,1.0,811.0,811.0
0.004,17,2,136,1,60,0.0,32.0,32.0,1,76,0.0,48.0,48.0
0.009,6,10,1677,5,827,2.0,559.0,559.0,5,850,2.0,582.0,582.0
0.005,17,2,170,1,65,0.0,37.0,37.0,1,105,0.0,77.0,77.0
0.005,6,10,2006,5,927,1.0,659.0,659.0,5,1079,1.0,811.0,811.0
0.016,6,10,1990,5,911,4.0,643.0,643.0,5,1079,4.0,811.0,811.0
40.067,17,10,676,5,460,10015.0,104.0,64.0,5,216,10015.0,20.0,15.0
0.005,6,10,2000,5,927,1.0,659.0,659.0,5,1073,1.0,805.0,805.0
366.969,6,22,2313,16,867,24464.0,195.0,195.0,6,1446,4642.0,419.0,398.0
0.009,6,10,1990,5,911,2.0,643.0,643.0,5,1079,2.0,811.0,811.0
0.136,6,10,1506,5,395,31.0,127.0,127.0,5,1111,31.0,843.0,843.0
0.021,6,10,1989,5,910,5.0,642.0,642.0,5,1079,5.0,811.0,811.0
0.006,6,10,1547,5,764,1.0,496.0,496.0,5,783,1.0,515.0,515.0
0.006,6,10,1547,5,764,1.0,496.0,496.0,5,783,1.0,515.0,515.0
0.011,6,10,1990,5,911,2.0,643.0,643.0,5,1079,2.0,811.0,811.0
1.116,6,32,13392,18,5893,65.0,2720.0,854.0,14,7499,70.0,2720.0,769.0
0.004,6,10,2006,5,927,1.0,659.0,659.0,5,1079,1.0,811.0,811.0
0.005,6,10,1989,5,927,1.0,659.0,659.0,5,1062,1.0,794.0,794.0
0.005,6,10,1689,5,839,1.0,571.0,571.0,5,850,1.0,582.0,582.0
11.093,17,28,4394,14,2312,844.0,587.0,137.0,14,2082,844.0,269.0,120.0
0.005,6,10,1989,5,927,1.0,659.0,659.0,5,1062,1.0,794.0,794.0
0.008,6,10,1989,5,927,2.0,659.0,659.0,5,1062,1.0,794.0,794.0
118.839,6,21,8111,11,1953,86.0,1174.0,493.0,10,6158,13185.0,2720.0,957.0
0.04,17,2,186,1,61,0.0,33.0,33.0,1,125,0.0,97.0,97.0
11.111,17,28,4423,14,1995,842.0,270.0,114.0,14,2428,842.0,587.0,145.0
0.107,6,10,1506,5,395,25.0,127.0,127.0,5,1111,23.0,843.0,843.0
0.005,6,10,2006,5,927,1.0,659.0,659.0,5,1079,1.0,811.0,811.0
0.006,17,2,164,1,74,0.0,46.0,46.0,1,90,0.0,62.0,62.0
0.005,6,10,2006,5,927,1.0,659.0,659.0,5,1079,1.0,811.0,811.0
0.011,6,10,1990,5,911,2.0,643.0,643.0,5,1079,2.0,811.0,811.0
0.005,17,2,169,1,62,0.0,34.0,34.0,1,107,0.0,79.0,79.0
0.004,17,2,132,1,58,0.0,30.0,30.0,1,74,0.0,46.0,46.0
0.003,17,2,148,1,60,0.0,32.0,32.0,1,88,0.0,60.0,60.0
0.001,17,2,136,1,60,0.0,32.0,32.0,1,76,0.0,48.0,48.0
0.008,6,10,1990,5,911,2.0,643.0,643.0,5,1079,2.0,811.0,811.0
0.005,17,2,230,1,68,0.0,40.0,40.0,1,162,0.0,134.0,134.0
0.037,6,10,1677,5,827,9.0,559.0,559.0,5,850,9.0,582.0,582.0
0.158,6,10,1506,5,395,35.0,127.0,127.0,5,1111,33.0,843.0,843.0
0.007,17,2,157,1,59,0.0,31.0,31.0,1,98,0.0,70.0,70.0
0.005,6,14,3736,7,446,0.0,74.0,74.0,7,3290,0.0,1448.0,972.0
0.009,6,10,1990,5,911,2.0,643.0,643.0,5,1079,2.0,811.0,811.0
15.08,17,15,8031,8,6008,2150.0,1350.0,723.0,7,2023,2508.0,1350.0,261.0
0.04,17,4,284,2,120,0.0,32.0,32.0,2,164,37.0,60.0,54.0
0.005,17,2,140,1,62,0.0,34.0,34.0,1,78,0.0,50.0,50.0
0.005,6,10,2006,5,927,1.0,659.0,659.0,5,1079,1.0,811.0,811.0
0.03,6,10,1990,5,911,7.0,643.0,643.0,5,1079,7.0,811.0,811.0
0.1,6,10,1506,5,395,23.0,127.0,127.0,5,1111,23.0,843.0,843.0
0.005,6,10,1989,5,927,1.0,659.0,659.0,5,1062,1.0,794.0,794.0
0.098,6,10,1506,5,395,21.0,127.0,127.0,5,1111,22.0,843.0,843.0
0.013,6,10,1990,5,911,3.0,643.0,643.0,5,1079,3.0,811.0,811.0
0.007,6,10,2000,5,927,1.0,659.0,659.0,5,1073,1.0,805.0,805.0
0.09,6,10,1506,5,395,19.0,127.0,127.0,5,1111,20.0,843.0,843.0
0.016,6,10,1989,5,910,4.0,642.0,642.0,5,1079,3.0,811.0,811.0
0.006,6,10,1689,5,839,1.0,571.0,571.0,5,850,1.0,582.0,582.0
0.005,6,13,3690,7,452,0.0,80.0,80.0,6,3238,1.0,1470.0,1459.0
0.001,17,2,152,1,68,0.0,40.0,40.0,1,84,0.0,56.0,56.0
0.087,6,10,1506,5,395,19.0,127.0,127.0,5,1111,20.0,843.0,843.0
0.072,17,8,3613,4,1874,24.0,1350.0,440.0,4,1739,12.0,1350.0,406.0
0.082,6,10,1506,5,395,19.0,127.0,127.0,5,1111,17.0,843.0,843.0
0.004,17,2,148,1,60,0.0,32.0,32.0,1,88,0.0,60.0,60.0
0.009,6,10,1989,5,910,2.0,642.0,642.0,5,1079,2.0,811.0,811.0
0.072,6,10,1506,5,395,15.0,127.0,127.0,5,1111,17.0,843.0,843.0
0.005,6,10,2006,5,927,1.0,659.0,659.0,5,1079,1.0,811.0,811.0
241.488,6,401,348258,193,21560,1257.0,2736.0,959.0,208,326698,1166.0,2804.0,1595.0
0.005,6,10,1989,5,927,1.0,659.0,659.0,5,1062,1.0,794.0,794.0
0.005,6,10,2000,5,927,1.0,659.0,659.0,5,1073,1.0,805.0,805.0
0.006,6,10,1643,5,860,1.0,592.0,592.0,5,783,1.0,515.0,515.0
0.005,17,2,144,1,64,0.0,36.0,36.0,1,80,0.0,52.0,52.0
0.003,17,4,284,2,120,0.0,32.0,32.0,2,164,0.0,60.0,54.0
0.005,6,10,1989,5,927,1.0,659.0,659.0,5,1062,1.0,794.0,794.0
126.013,6,14,2938,8,2504,17968.0,1414.0,1086.0,6,434,25155.0,182.0,182.0
0.01,6,10,1989,5,910,2.0,642.0,642.0,5,1079,2.0,811.0,811.0
0.025,6,10,1989,5,910,6.0,642.0,642.0,5,1079,6.0,811.0,811.0
10.864,17,26,4103,13,1847,895.0,270.0,114.0,13,2256,896.0,587.0,145.0
0.011,17,2,180,1,66,0.0,38.0,38.0,1,114,0.0,86.0,86.0
0.005,6,10,2006,5,927,1.0,659.0,659.0,5,1079,1.0,811.0,811.0
0.005,6,10,1547,5,764,1.0,496.0,496.0,5,783,1.0,515.0,515.0
0.01,6,10,1990,5,911,2.0,643.0,643.0,5,1079,2.0,811.0,811.0
0.06,6,10,1506,5,395,13.0,127.0,127.0,5,1111,14.0,843.0,843.0
308.649,17,20,1124,10,716,34280.0,48.0,43.0,10,408,34280.0,20.0,12.0
0.005,6,10,2006,5,927,1.0,659.0,659.0,5,1079,1.0,811.0,811.0
0.009,17,2,140,1,62,0.0,34.0,34.0,1,78,0.0,50.0,50.0
1770.654,6,82,4318,41,2159,44265.0,27.0,27.0,41,2159,44265.0,27.0,27.0
0.005,6,10,1774,5,923,1.0,655.0,655.0,5,851,1.0,583.0,583.0
240.094,6,16,4482,9,963,30011.0,238.0,166.0,7,3519,40015.0,1402.0,786.0
0.077,6,10,1506,5,395,16.0,127.0,127.0,5,1111,16.0,843.0,843.0
0.001,17,2,180,1,66,0.0,38.0,38.0,1,114,0.0,86.0,86.0
0.009,6,10,1990,5,911,2.0,643.0,643.0,5,1079,2.0,811.0,811.0
0.005,6,10,1989,5,927,1.0,659.0,659.0,5,1062,1.0,794.0,794.0
0.01,6,10,1762,5,911,2.0,643.0,643.0,5,851,2.0,583.0,583.0
0.008,6,12,1926,6,1189,1.0,659.0,434.0,6,737,1.0,417.0,417.0
0.004,6,10,1989,5,927,1.0,659.0,659.0,5,1062,1.0,794.0,794.0
240.022,6,9,787,5,488,60005.0,232.0,232.0,4,299,80006.0,83.0,83.0
0.004,6,10,2006,5,927,1.0,659.0,659.0,5,1079,1.0,811.0,811.0
0.09,6,10,1506,5,395,20.0,127.0,127.0,5,1111,21.0,843.0,843.0
0.011,6,10,1989,5,910,2.0,642.0,642.0,5,1079,2.0,811.0,811.0
0.005,6,10,2006,5,927,1.0,659.0,659.0,5,1079,1.0,811.0,811.0
180.606,6,62,19335,36,4981,5160.0,1055.0,222.0,26,14354,7224.0,2804.0,867.0
0.004,17,2,136,1,60,0.0,32.0,32.0,1,76,0.0,48.0,48.0
0.006,6,10,1547,5,764,1.0,496.0,496.0,5,783,1.0,515.0,515.0
0.01,6,10,1990,5,911,2.0,643.0,643.0,5,1079,2.0,811.0,811.0
0.006,6,10,2000,5,927,1.0,659.0,659.0,5,1073,1.0,805.0,805.0
0.012,6,10,1973,5,911,3.0,643.0,643.0,5,1062,2.0,794.0,794.0
0.001,17,2,136,1,60,0.0,32.0,32.0,1,76,0.0,48.0,48.0
0.009,6,10,1990,5,911,2.0,643.0,643.0,5,1079,2.0,811.0,811.0
0.004,6,10,2007,5,928,1.0,660.0,660.0,5,1079,1.0,811.0,811.0
0.006,6,10,1547,5,764,1.0,496.0,496.0,5,783,1.0,515.0,515.0
0.007,6,10,2006,5,927,1.0,659.0,659.0,5,1079,1.0,811.0,811.0
0.003,17,2,136,1,60,0.0,32.0,32.0,1,76,0.0,48.0,48.0
240.272,6,42,8719,21,5686,12013.0,1515.0,509.0,21,3033,12013.0,580.0,241.0
308.98,17,20,1124,10,716,34316.0,48.0,43.0,10,408,34316.0,20.0,12.0
0.001,17,2,180,1,66,0.0,38.0,38.0,1,114,0.0,86.0,86.0
0.005,17,2,170,1,65,0.0,37.0,37.0,1,105,0.0,77.0,77.0
0.011,6,10,1989,5,910,2.0,642.0,642.0,5,1079,2.0,811.0,811.0
40.06,17,10,676,5,460,10013.0,104.0,64.0,5,216,10014.0,20.0,15.0
1756.067,6,105,6270,60,3525,29763.0,27.0,27.0,45,2745,39909.0,27.0,27.0
0.013,6,13,3735,7,497,2.0,125.0,125.0,6,3238,2.0,1470.0,1459.0
168.128,17,74,10627,37,2469,4670.0,44.0,38.0,37,8158,4670.0,239.0,192.0
0.005,6,10,1643,5,860,1.0,592.0,592.0,5,783,1.0,515.0,515.0
0.012,6,10,1989,5,910,2.0,642.0,642.0,5,1079,2.0,811.0,811.0
0.097,6,10,1506,5,395,22.0,127.0,127.0,5,1111,21.0,843.0,843.0
0.008,6,10,1989,5,927,2.0,659.0,659.0,5,1062,1.0,794.0,794.0
0.022,6,10,1989,5,910,5.0,642.0,642.0,5,1079,5.0,811.0,811.0
0.006,6,10,1689,5,839,1.0,571.0,571.0,5,850,1.0,582.0,582.0
0.006,6,10,1689,5,839,1.0,571.0,571.0,5,850,1.0,582.0,582.0
0.007,6,10,1989,5,910,1.0,642.0,642.0,5,1079,1.0,811.0,811.0
0.016,6,10,1972,5,910,4.0,642.0,642.0,5,1062,3.0,794.0,794.0
0.06,6,10,1506,5,395,14.0,127.0,127.0,5,1111,14.0,843.0,843.0
0.001,17,2,140,1,62,0.0,34.0,34.0,1,78,0.0,50.0,50.0
0.01,6,10,1990,5,911,2.0,643.0,643.0,5,1079,2.0,811.0,811.0
0.004,17,4,284,2,120,0.0,32.0,32.0,2,164,0.0,60.0,54.0
0.097,6,10,1506,5,395,15.0,127.0,127.0,5,1111,21.0,843.0,843.0
0.015,6,10,1972,5,910,3.0,642.0,642.0,5,1062,3.0,794.0,794.0
20.467,6,36,8427,18,1955,513.0,887.0,401.0,18,6472,1195.0,2720.0,478.0
0.004,17,2,194,1,59,0.0,31.0,31.0,1,135,0.0,107.0,107.0
301.01,6,46,17464,24,11557,13087.0,2875.0,1320.0,22,5907,421.0,2667.0,385.0
0.006,6,10,1547,5,764,1.0,496.0,496.0,5,783,1.0,515.0,515.0
0.004,6,10,2006,5,927,1.0,659.0,659.0,5,1079,1.0,811.0,811.0
0.004,17,2,148,1,60,0.0,32.0,32.0,1,88,0.0,60.0,60.0
0.02,6,10,1989,5,910,4.0,642.0,642.0,5,1079,5.0,811.0,811.0
0.014,6,10,1989,5,910,3.0,642.0,642.0,5,1079,3.0,811.0,811.0
0.006,6,10,1689,5,839,1.0,571.0,571.0,5,850,1.0,582.0,582.0
40.068,17,10,676,5,460,10016.0,104.0,64.0,5,216,10016.0,20.0,15.0
0.022,6,10,1989,5,910,5.0,642.0,642.0,5,1079,5.0,811.0,811.0
0.039,17,2,412,1,61,0.0,33.0,33.0,1,351,0.0,323.0,323.0
0.005,17,2,168,1,76,0.0,48.0,48.0,1,92,0.0,64.0,64.0
0.004,17,2,148,1,60,0.0,32.0,32.0,1,88,0.0,60.0,60.0
0.094,6,10,1506,5,395,22.0,127.0,127.0,5,1111,19.0,843.0,843.0
0.005,17,2,214,1,75,0.0,47.0,47.0,1,139,0.0,111.0,111.0
0.102,6,10,1506,5,395,22.0,127.0,127.0,5,1111,23.0,843.0,843.0
0.001,17,2,180,1,66,0.0,38.0,38.0,1,114,0.0,86.0,86.0
0.009,6,10,1972,5,910,2.0,642.0,642.0,5,1062,2.0,794.0,794.0
294.527,6,306,343963,114,17481,2606.0,2736.0,889.0,192,326482,1542.0,2804.0,1778.0
40.064,17,10,676,5,460,10014.0,104.0,64.0,5,216,10015.0,20.0,15.0
0.004,6,10,2000,5,927,1.0,659.0,659.0,5,1073,1.0,805.0,805.0
0.073,6,10,1506,5,395,15.0,127.0,127.0,5,1111,16.0,843.0,843.0
0.082,6,10,1506,5,395,18.0,127.0,127.0,5,1111,19.0,843.0,843.0
240.032,6,9,787,5,488,60008.0,232.0,232.0,4,299,80008.0,83.0,83.0
0.009,6,10,1990,5,911,2.0,643.0,643.0,5,1079,2.0,811.0,811.0
0.011,6,10,1972,5,910,2.0,642.0,642.0,5,1062,2.0,794.0,794.0
0.018,6,10,1972,5,910,4.0,642.0,642.0,5,1062,4.0,794.0,794.0
0.003,17,2,152,1,76,0.0,48.0,48.0,1,76,0.0,48.0,48.0
0.005,6,10,2006,5,927,1.0,659.0,659.0,5,1079,1.0,811.0,811.0
293.722,6,405,348324,198,21866,1490.0,2736.0,770.0,207,326458,1425.0,2804.0,1635.0
0.005,6,10,2007,5,928,1.0,660.0,660.0,5,1079,1.0,811.0,811.0
0.243,6,10,1506,5,395,58.0,127.0,127.0,5,1111,57.0,843.0,843.0
0.068,6,10,1506,5,395,14.0,127.0,127.0,5,1111,15.0,843.0,843.0
0.091,6,10,1506,5,395,19.0,127.0,127.0,5,1111,20.0,843.0,843.0
1.027,6,13,3922,7,2139,128.0,1328.0,923.0,6,1783,154.0,1539.0,1539.0
0.006,6,10,2006,5,927,1.0,659.0,659.0,5,1079,1.0,811.0,811.0
0.003,17,2,136,1,60,0.0,32.0,32.0,1,76,0.0,48.0,48.0
0.004,6,10,2006,5,927,1.0,659.0,659.0,5,1079,1.0,811.0,811.0
0.005,6,10,1989,5,927,1.0,659.0,659.0,5,1062,1.0,794.0,794.0
0.005,6,10,2006,5,927,1.0,659.0,659.0,5,1079,1.0,811.0,811.0
0.007,6,10,2000,5,927,1.0,659.0,659.0,5,1073,1.0,805.0,805.0
0.004,6,10,2006,5,927,1.0,659.0,659.0,5,1079,1.0,811.0,811.0
0.098,6,10,1506,5,395,16.0,127.0,127.0,5,1111,24.0,843.0,843.0
0.008,17,2,194,1,59,0.0,31.0,31.0,1,135,0.0,107.0,107.0
1757.025,6,109,6478,60,3525,29779.0,27.0,27.0,49,2953,36603.0,27.0,27.0
0.335,17,42,21620,23,18473,15.0,1350.0,775.0,19,3147,15.0,1350.0,137.0
0.011,6,10,1989,5,910,2.0,642.0,642.0,5,1079,2.0,811.0,811.0
0.006,17,2,144,1,64,0.0,36.0,36.0,1,80,0.0,52.0,52.0
0.006,6,10,1547,5,764,1.0,496.0,496.0,5,783,1.0,515.0,515.0
0.02,6,10,1990,5,911,5.0,643.0,643.0,5,1079,4.0,811.0,811.0
40.072,17,10,676,5,460,10017.0,104.0,64.0,5,216,10017.0,20.0,15.0
0.006,6,10,2007,5,928,1.0,660.0,660.0,5,1079,1.0,811.0,811.0
0.076,6,10,1506,5,395,16.0,127.0,127.0,5,1111,16.0,843.0,843.0
0.065,6,10,1506,5,395,14.0,127.0,127.0,5,1111,14.0,843.0,843.0
0.005,6,10,1989,5,927,1.0,659.0,659.0,5,1062,1.0,794.0,794.0
0.037,17,2,136,1,60,0.0,32.0,32.0,1,76,0.0,48.0,48.0
0.003,17,4,284,2,120,0.0,32.0,32.0,2,164,0.0,60.0,54.0
0.126,6,10,1506,5,395,27.0,127.0,127.0,5,1111,24.0,843.0,843.0
0.001,17,2,166,1,75,0.0,47.0,47.0,1,91,0.0,63.0,63.0
0.013,6,10,1990,5,911,3.0,643.0,643.0,5,1079,3.0,811.0,811.0
0.005,6,13,3747,7,509,0.0,137.0,137.0,6,3238,1.0,1470.0,1459.0
0.085,6,10,1506,5,395,19.0,127.0,127.0,5,1111,19.0,843.0,843.0
0.001,17,2,180,1,66,0.0,38.0,38.0,1,114,0.0,86.0,86.0
40.058,17,10,676,5,460,10013.0,104.0,64.0,5,216,10013.0,20.0,15.0
0.005,17,2,214,1,75,0.0,47.0,47.0,1,139,0.0,111.0,111.0
0.008,6,10,1547,5,764,2.0,496.0,496.0,5,783,1.0,515.0,515.0
0.005,6,10,2006,5,927,1.0,659.0,659.0,5,1079,1.0,811.0,811.0
0.126,17,2,170,1,65,0.0,37.0,37.0,1,105,0.0,77.0,77.0
0.011,6,10,1989,5,910,2.0,642.0,642.0,5,1079,2.0,811.0,811.0
0.004,6,10,1702,5,863,1.0,595.0,595.0,5,839,1.0,571.0,571.0
0.009,6,10,1989,5,910,2.0,642.0,642.0,5,1079,2.0,811.0,811.0
0.004,6,10,1702,5,863,1.0,595.0,595.0,5,839,0.0,571.0,571.0
0.015,6,10,1631,5,848,3.0,580.0,580.0,5,783,3.0,515.0,515.0
0.005,6,10,1989,5,927,1.0,659.0,659.0,5,1062,1.0,794.0,794.0
177.184,17,70,10036,35,2337,5211.0,44.0,38.0,35,7699,5211.0,239.0,191.0
240.513,6,305,338059,107,9346,2268.0,2947.0,627.0,198,328713,1220.0,4136.0,1721.0
0.005,17,2,169,1,62,0.0,34.0,34.0,1,107,0.0,79.0,79.0
0.004,6,10,1989,5,927,1.0,659.0,659.0,5,1062,1.0,794.0,794.0
0.01,6,10,1989,5,910,2.0,642.0,642.0,5,1079,2.0,811.0,811.0
15.077,17,15,8138,8,5986,2149.0,1350.0,720.0,7,2152,2508.0,1350.0,279.0
0.014,6,10,1762,5,911,3.0,643.0,643.0,5,851,3.0,583.0,583.0
0.016,6,10,1989,5,910,4.0,642.0,642.0,5,1079,3.0,811.0,811.0
353.552,6,20,2210,6,1308,12004.0,494.0,494.0,14,902,27196.0,83.0,83.0
0.063,17,2,152,1,76,0.0,48.0,48.0,1,76,0.0,48.0,48.0
0.005,6,10,2006,5,927,1.0,659.0,659.0,5,1079,1.0,811.0,811.0
0.014,6,10,1972,5,910,3.0,642.0,642.0,5,1062,3.0,794.0,794.0
0.005,17,2,154,1,69,0.0,41.0,41.0,1,85,0.0,57.0,57.0
0.013,6,10,1989,5,910,3.0,642.0,642.0,5,1079,3.0,811.0,811.0
0.071,6,10,1506,5,395,16.0,127.0,127.0,5,1111,17.0,843.0,843.0
0.011,6,10,1990,5,911,2.0,643.0,643.0,5,1079,2.0,811.0,811.0
0.016,6,10,1989,5,910,4.0,642.0,642.0,5,1079,4.0,811.0,811.0
0.088,6,10,1506,5,395,20.0,127.0,127.0,5,1111,20.0,843.0,843.0
0.008,6,10,1972,5,910,2.0,642.0,642.0,5,1062,2.0,794.0,794.0
0.005,6,10,1989,5,927,1.0,659.0,659.0,5,1062,1.0,794.0,794.0
1778.393,17,144,45504,72,22752,25047.0,288.0,288.0,72,22752,25047.0,288.0,288.0
0.005,6,10,1989,5,927,1.0,659.0,659.0,5,1062,1.0,794.0,794.0
0.007,17,2,194,1,59,0.0,31.0,31.0,1,135,0.0,107.0,107.0
0.16,6,10,1506,5,395,36.0,127.0,127.0,5,1111,34.0,843.0,843.0
0.012,6,10,1972,5,910,3.0,642.0,642.0,5,1062,2.0,794.0,794.0
0.003,17,2,148,1,60,0.0,32.0,32.0,1,88,0.0,60.0,60.0
0.02,6,10,1972,5,910,5.0,642.0,642.0,5,1062,4.0,794.0,794.0
40.054,17,10,676,5,460,10012.0,104.0,64.0,5,216,10012.0,20.0,15.0
0.013,6,10,1677,5,827,3.0,559.0,559.0,5,850,3.0,582.0,582.0
0.001,17,2,180,1,66,0.0,38.0,38.0,1,114,0.0,86.0,86.0
0.088,6,10,1506,5,395,19.0,127.0,127.0,5,1111,13.0,843.0,843.0
0.006,6,10,1547,5,764,1.0,496.0,496.0,5,783,1.0,515.0,515.0
0.005,6,10,1547,5,764,1.0,496.0,496.0,5,783,1.0,515.0,515.0
0.015,6,10,1983,5,910,3.0,642.0,642.0,5,1073,3.0,805.0,805.0
0.052,17,2,152,1,76,0.0,48.0,48.0,1,76,0.0,48.0,48.0
40.061,17,10,676,5,460,10012.0,104.0,64.0,5,216,10014.0,20.0,15.0
0.015,17,2,198,1,91,0.0,63.0,63.0,1,107,0.0,79.0,79.0
0.12,6,10,1506,5,395,26.0,127.0,127.0,5,1111,25.0,843.0,843.0
0.001,17,2,136,1,60,0.0,32.0,32.0,1,76,0.0,48.0,48.0
0.013,6,13,3735,7,497,2.0,125.0,125.0,6,3238,2.0,1470.0,1459.0
0.006,6,10,1854,5,889,1.0,621.0,621.0,5,965,1.0,697.0,697.0
0.013,6,10,1989,5,910,3.0,642.0,642.0,5,1079,3.0,811.0,811.0
0.085,6,10,1506,5,395,15.0,127.0,127.0,5,1111,20.0,843.0,843.0
0.069,6,10,1506,5,395,15.0,127.0,127.0,5,1111,14.0,843.0,843.0
0.008,6,10,1989,5,910,2.0,642.0,642.0,5,1079,2.0,811.0,811.0
0.006,6,10,1547,5,764,1.0,496.0,496.0,5,783,1.0,515.0,515.0
0.005,6,10,2007,5,928,1.0,660.0,660.0,5,1079,1.0,811.0,811.0
0.006,17,2,170,1,65,0.0,37.0,37.0,1,105,0.0,77.0,77.0
0.015,6,10,1762,5,911,3.0,643.0,643.0,5,851,3.0,583.0,583.0
0.139,6,10,1506,5,395,33.0,127.0,127.0,5,1111,34.0,843.0,843.0
0.072,6,10,1506,5,395,15.0,127.0,127.0,5,1111,15.0,843.0,843.0
0.083,6,10,1506,5,395,18.0,127.0,127.0,5,1111,19.0,843.0,843.0
0.007,6,10,1547,5,764,1.0,496.0,496.0,5,783,1.0,515.0,515.0
0.006,17,2,170,1,65,0.0,37.0,37.0,1,105,0.0,77.0,77.0
0.016,6,10,1972,5,910,3.0,642.0,642.0,5,1062,4.0,794.0,794.0
0.013,6,13,3735,7,497,2.0,125.0,125.0,6,3238,2.0,1470.0,1459.0
0.038,17,4,420,2,122,0.0,33.0,33.0,2,298,34.0,145.0,121.0
240.108,6,31,9466,15,6948,17150.0,2071.0,685.0,16,2518,16007.0,580.0,209.0
0.107,6,10,1506,5,395,24.0,127.0,127.0,5,1111,22.0,843.0,843.0
303.114,6,23,4845,9,963,37889.0,238.0,166.0,14,3882,23316.0,1402.0,786.0
0.064,6,10,1506,5,395,14.0,127.0,127.0,5,1111,15.0,843.0,843.0
0.061,17,2,80,1,32,0.0,4.0,4.0,1,48,0.0,20.0,20.0
0.114,6,10,1506,5,395,27.0,127.0,127.0,5,1111,26.0,843.0,843.0
0.006,6,10,1689,5,839,1.0,571.0,571.0,5,850,1.0,582.0,582.0
0.104,6,10,1506,5,395,23.0,127.0,127.0,5,1111,23.0,843.0,843.0
0.023,6,10,1631,5,848,5.0,580.0,580.0,5,783,5.0,515.0,515.0
0.081,6,10,1506,5,395,17.0,127.0,127.0,5,1111,19.0,843.0,843.0
0.018,6,10,1762,5,911,4.0,643.0,643.0,5,851,4.0,583.0,583.0
15.072,17,15,9238,8,6902,2149.0,1350.0,834.0,7,2336,2507.0,1350.0,305.0
40.062,17,10,676,5,460,10014.0,104.0,64.0,5,216,10014.0,20.0,15.0
0.074,6,10,1506,5,395,15.0,127.0,127.0,5,1111,17.0,843.0,843.0
0.005,6,10,2007,5,928,1.0,660.0,660.0,5,1079,1.0,811.0,811.0
0.009,6,10,1990,5,911,2.0,643.0,643.0,5,1079,2.0,811.0,811.0
0.004,6,10,1774,5,923,1.0,655.0,655.0,5,851,1.0,583.0,583.0
0.133,6,10,1506,5,395,30.0,127.0,127.0,5,1111,24.0,843.0,843.0
0.004,6,10,1774,5,923,1.0,655.0,655.0,5,851,1.0,583.0,583.0
0.075,6,10,1506,5,395,17.0,127.0,127.0,5,1111,16.0,843.0,843.0
0.006,17,2,179,1,71,0.0,43.0,43.0,1,108,0.0,80.0,80.0
0.005,17,2,230,1,68,0.0,40.0,40.0,1,162,0.0,134.0,134.0
0.005,6,10,1989,5,927,1.0,659.0,659.0,5,1062,1.0,794.0,794.0
15.071,17,15,9238,8,6902,2148.0,1350.0,834.0,7,2336,2506.0,1350.0,305.0
300.311,6,16,2170,9,684,37518.0,146.0,146.0,7,1486,50024.0,419.0,398.0
0.003,17,2,136,1,60,0.0,32.0,32.0,1,76,0.0,48.0,48.0
0.042,17,2,166,1,75,0.0,47.0,47.0,1,91,0.0,63.0,63.0
15.079,17,18,8666,9,5997,1881.0,1350.0,638.0,9,2669,1881.0,1350.0,268.0
300.526,6,27,8922,15,1930,21466.0,517.0,285.0,12,6992,21862.0,1402.0,908.0
0.171,17,2,152,1,76,0.0,48.0,48.0,1,76,0.0,48.0,48.0
0.116,6,10,1506,5,395,26.0,127.0,127.0,5,1111,23.0,843.0,843.0
0.006,17,2,166,1,75,0.0,47.0,47.0,1,91,0.0,63.0,63.0
0.01,6,10,1983,5,910,2.0,642.0,642.0,5,1073,2.0,805.0,805.0
0.012,6,10,1762,5,911,2.0,643.0,643.0,5,851,2.0,583.0,583.0
0.005,6,10,2006,5,927,1.0,659.0,659.0,5,1079,1.0,811.0,811.0
0.013,6,10,1631,5,848,3.0,580.0,580.0,5,783,3.0,515.0,515.0
0.142,6,10,1506,5,395,31.0,127.0,127.0,5,1111,31.0,843.0,843.0
351.998,6,20,2210,6,1308,12003.0,494.0,494.0,14,902,27076.0,83.0,83.0
0.109,6,10,1506,5,395,25.0,127.0,127.0,5,1111,25.0,843.0,843.0
0.015,6,13,3735,7,497,2.0,125.0,125.0,6,3238,3.0,1470.0,1459.0
0.005,6,10,2006,5,927,1.0,659.0,659.0,5,1079,1.0,811.0,811.0
0.013,17,2,169,1,62,0.0,34.0,34.0,1,107,0.0,79.0,79.0
0.005,6,10,2006,5,927,1.0,659.0,659.0,5,1079,1.0,811.0,811.0
0.041,17,2,184,1,61,0.0,33.0,33.0,1,123,0.0,95.0,95.0
0.106,6,10,1506,5,395,25.0,127.0,127.0,5,1111,25.0,843.0,843.0
10.95,17,28,4423,14,1994,830.0,269.0,114.0,14,2429,832.0,588.0,145.0
0.004,17,4,284,2,120,0.0,32.0,32.0,2,164,0.0,60.0,54.0
0.005,6,10,2006,5,927,1.0,659.0,659.0,5,1079,1.0,811.0,811.0
0.016,6,10,1989,5,910,4.0,642.0,642.0,5,1079,4.0,811.0,811.0
0.005,6,10,1854,5,889,1.0,621.0,621.0,5,965,1.0,697.0,697.0
0.076,6,10,1506,5,395,16.0,127.0,127.0,5,1111,17.0,843.0,843.0
0.144,6,10,1506,5,395,23.0,127.0,127.0,5,1111,33.0,843.0,843.0
0.014,6,10,1972,5,910,3.0,642.0,642.0,5,1062,3.0,794.0,794.0
0.009,6,10,1631,5,848,2.0,580.0,580.0,5,783,2.0,515.0,515.0
0.001,17,2,180,1,66,0.0,38.0,38.0,1,114,0.0,86.0,86.0
0.013,6,10,1677,5,827,3.0,559.0,559.0,5,850,3.0,582.0,582.0
0.005,6,10,2007,5,928,1.0,660.0,660.0,5,1079,1.0,811.0,811.0
0.012,6,10,1972,5,910,2.0,642.0,642.0,5,1062,2.0,794.0,794.0
356.614,6,21,1794,16,1030,23774.0,190.0,190.0,5,764,60003.0,463.0,248.0
0.067,17,8,3613,4,1874,22.0,1350.0,440.0,4,1739,10.0,1350.0,406.0
40.065,17,10,676,5,460,10015.0,104.0,64.0,5,216,10015.0,20.0,15.0
0.096,6,10,1506,5,395,21.0,127.0,127.0,5,1111,19.0,843.0,843.0
1.148,6,33,13432,18,5893,67.0,2720.0,854.0,15,7539,69.0,2565.0,769.0
289.758,6,400,348191,203,22119,1434.0,2736.0,825.0,197,326072,1478.0,4206.0,1725.0
10.785,17,28,4421,14,1994,821.0,269.0,114.0,14,2427,821.0,586.0,145.0
91.137,6,26,9525,12,1627,76.0,794.0,367.0,14,7898,7000.0,1360.0,732.0
0.005,17,2,164,1,74,0.0,46.0,46.0,1,90,0.0,62.0,62.0
0.014,6,10,1762,5,911,3.0,643.0,643.0,5,851,3.0,583.0,583.0
0.004,6,10,1774,5,923,1.0,655.0,655.0,5,851,1.0,583.0,583.0
40.065,17,10,676,5,460,10013.0,104.0,64.0,5,216,10015.0,20.0,15.0
0.099,6,10,1506,5,395,22.0,127.0,127.0,5,1111,21.0,843.0,843.0
295.254,6,394,348367,198,21867,1498.0,2736.0,825.0,196,326500,1514.0,3285.0,1737.0
0.005,6,10,2006,5,927,1.0,659.0,659.0,5,1079,1.0,811.0,811.0
0.071,6,10,1506,5,395,16.0,127.0,127.0,5,1111,15.0,843.0,843.0
0.121,6,10,1506,5,395,28.0,127.0,127.0,5,1111,28.0,843.0,843.0
0.005,17,2,178,1,81,0.0,53.0,53.0,1,97,0.0,69.0,69.0
1771.594,17,120,11460,60,5460,30026.0,63.0,63.0,60,6000,30026.0,72.0,72.0
0.005,6,14,3799,7,509,0.0,137.0,137.0,7,3290,0.0,1448.0,972.0
0.011,6,10,1983,5,910,2.0,642.0,642.0,5,1073,2.0,805.0,805.0
0.128,6,10,1506,5,395,30.0,127.0,127.0,5,1111,26.0,843.0,843.0
0.759,6,10,2009,6,1655,151.0,1403.0,1403.0,4,354,171.0,182.0,182.0
0.005,6,10,2006,5,927,1.0,659.0,659.0,5,1079,1.0,811.0,811.0
0.006,17,2,170,1,65,0.0,37.0,37.0,1,105,0.0,77.0,77.0
0.005,6,10,1989,5,927,1.0,659.0,659.0,5,1062,1.0,794.0,794.0
0.001,17,2,180,1,66,0.0,38.0,38.0,1,114,0.0,86.0,86.0
0.011,6,10,1983,5,910,2.0,642.0,642.0,5,1073,2.0,805.0,805.0
0.037,6,10,1972,5,910,9.0,642.0,642.0,5,1062,9.0,794.0,794.0
0.005,6,10,1547,5,764,1.0,496.0,496.0,5,783,1.0,515.0,515.0
0.004,17,4,284,2,120,1.0,32.0,32.0,2,164,0.0,60.0,54.0
0.008,6,10,1989,5,910,2.0,642.0,642.0,5,1079,2.0,811.0,811.0
0.005,6,10,1989,5,927,1.0,659.0,659.0,5,1062,1.0,794.0,794.0
240.503,6,33,8641,17,1841,15029.0,574.0,189.0,16,6800,16031.0,1402.0,597.0
0.001,17,2,166,1,75,0.0,47.0,47.0,1,91,0.0,63.0,63.0
0.01,6,10,1972,5,910,2.0,642.0,642.0,5,1062,2.0,794.0,794.0
0.086,6,10,1506,5,395,17.0,127.0,127.0,5,1111,20.0,843.0,843.0
40.056,17,10,676,5,460,10013.0,104.0,64.0,5,216,10013.0,20.0,15.0
0.005,6,10,2007,5,928,1.0,660.0,660.0,5,1079,1.0,811.0,811.0
0.004,6,14,3742,7,452,0.0,80.0,80.0,7,3290,0.0,1448.0,972.0
1777.389,17,144,41760,72,22752,25033.0,288.0,288.0,72,19008,25033.0,236.0,236.0
0.017,6,10,1972,5,910,4.0,642.0,642.0,5,1062,4.0,794.0,794.0
1730.415,6,45,2790,30,1725,59669.0,35.0,35.0,15,1065,123595.0,31.0,31.0
0.006,17,2,146,1,65,0.0,37.0,37.0,1,81,0.0,53.0,53.0
0.079,6,10,1506,5,395,14.0,127.0,127.0,5,1111,19.0,843.0,843.0
0.109,6,10,1506,5,395,26.0,127.0,127.0,5,1111,25.0,843.0,843.0
0.019,6,10,1989,5,910,4.0,642.0,642.0,5,1079,4.0,811.0,811.0
0.133,6,10,1506,5,395,29.0,127.0,127.0,5,1111,19.0,843.0,843.0
0.124,6,10,1506,5,395,28.0,127.0,127.0,5,1111,26.0,843.0,843.0
0.003,17,2,136,1,60,0.0,32.0,32.0,1,76,0.0,48.0,48.0
361.763,6,21,1793,16,1030,24117.0,190.0,190.0,5,763,60011.0,462.0,247.0
0.005,6,10,2006,5,927,1.0,659.0,659.0,5,1079,1.0,811.0,811.0
0.005,6,10,1989,5,927,1.0,659.0,659.0,5,1062,1.0,794.0,794.0
0.114,6,11,1558,6,447,21.0,127.0,127.0,5,1111,25.0,843.0,843.0
0.001,17,2,166,1,75,0.0,47.0,47.0,1,91,0.0,63.0,63.0
0.258,17,43,20882,21,17044,12.0,1350.0,783.0,22,3838,10.0,1350.0,146.0
0.108,6,10,1506,5,395,20.0,127.0,127.0,5,1111,22.0,843.0,843.0
0.003,17,4,284,2,120,0.0,32.0,32.0,2,164,0.0,60.0,54.0
0.009,6,10,1972,5,910,2.0,642.0,642.0,5,1062,2.0,794.0,794.0
368.573,6,22,2313,16,867,24571.0,195.0,195.0,6,1446,4641.0,419.0,398.0
240.309,6,42,5536,20,2452,12646.0,588.0,197.0,22,3084,11443.0,580.0,214.0
0.005,6,10,2007,5,928,1.0,660.0,660.0,5,1079,1.0,811.0,811.0
0.08,6,10,1506,5,395,17.0,127.0,127.0,5,1111,15.0,843.0,843.0
0.011,6,10,1983,5,910,2.0,642.0,642.0,5,1073,2.0,805.0,805.0
0.143,6,10,1506,5,395,34.0,127.0,127.0,5,1111,34.0,843.0,843.0
0.015,6,10,1990,5,911,3.0,643.0,643.0,5,1079,3.0,811.0,811.0
0.012,6,10,1677,5,827,2.0,559.0,559.0,5,850,2.0,582.0,582.0
0.001,17,2,179,1,62,0.0,34.0,34.0,1,117,0.0,89.0,89.0
0.004,6,10,2006,5,927,1.0,659.0,659.0,5,1079,1.0,811.0,811.0
0.002,17,2,136,1,60,0.0,32.0,32.0,1,76,0.0,48.0,48.0
0.039,17,2,144,1,64,0.0,36.0,36.0,1,80,0.0,52.0,52.0
308.634,17,20,1124,10,716,34279.0,48.0,43.0,10,408,34279.0,20.0,12.0
0.004,17,2,132,1,58,0.0,30.0,30.0,1,74,0.0,46.0,46.0
0.009,6,10,1972,5,910,2.0,642.0,642.0,5,1062,2.0,794.0,794.0
0.012,6,10,1972,5,910,3.0,642.0,642.0,5,1062,2.0,794.0,794.0
0.006,6,10,1547,5,764,1.0,496.0,496.0,5,783,1.0,515.0,515.0
0.018,6,10,1972,5,910,4.0,642.0,642.0,5,1062,4.0,794.0,794.0
0.094,6,10,1506,5,395,20.0,127.0,127.0,5,1111,19.0,843.0,843.0
0.005,17,2,170,1,65,0.0,37.0,37.0,1,105,0.0,77.0,77.0
0.006,17,4,284,2,120,2.0,32.0,32.0,2,164,3.0,60.0,54.0
0.005,6,10,2000,5,927,1.0,659.0,659.0,5,1073,1.0,805.0,805.0
0.087,6,10,1506,5,395,17.0,127.0,127.0,5,1111,21.0,843.0,843.0
0.014,6,13,3735,7,497,2.0,125.0,125.0,6,3238,2.0,1470.0,1459.0
0.001,17,2,180,1,66,0.0,38.0,38.0,1,114,0.0,86.0,86.0
173.274,17,82,11631,41,2723,4331.0,44.0,38.0,41,8908,4331.0,239.0,189.0
0.12,6,10,1506,5,395,28.0,127.0,127.0,5,1111,27.0,843.0,843.0
0.008,6,10,1990,5,911,2.0,643.0,643.0,5,1079,2.0,811.0,811.0
0.005,17,2,158,1,63,0.0,35.0,35.0,1,95,0.0,67.0,67.0
0.009,6,10,1989,5,910,2.0,642.0,642.0,5,1079,2.0,811.0,811.0
0.013,17,2,152,1,56,0.0,28.0,28.0,1,96,0.0,68.0,68.0
0.161,6,22,6483,11,2013,14.0,746.0,286.0,11,4470,14.0,1324.0,778.0
0.172,6,3,453,2,321,172.0,241.0,241.0,1,132,0.0,92.0,92.0
0.006,6,10,1854,5,889,1.0,621.0,621.0,5,965,1.0,697.0,697.0
11.01,17,26,4101,13,1822,908.0,269.0,112.0,13,2279,908.0,586.0,147.0
0.012,6,10,1677,5,827,3.0,559.0,559.0,5,850,3.0,582.0,582.0
0.001,17,2,166,1,75,0.0,47.0,47.0,1,91,0.0,63.0,63.0
0.009,6,10,1989,5,910,2.0,642.0,642.0,5,1079,2.0,811.0,811.0
0.023,6,10,1990,5,911,5.0,643.0,643.0,5,1079,5.0,811.0,811.0
0.037,17,4,284,2,120,0.0,32.0,32.0,2,164,34.0,60.0,54.0
240.224,6,136,118760,57,4227,4289.0,517.0,207.0,79,114533,3079.0,2804.0,1648.0
0.013,6,10,1631,5,848,3.0,580.0,580.0,5,783,3.0,515.0,515.0
0.004,17,2,148,1,60,0.0,32.0,32.0,1,88,0.0,60.0,60.0
0.19,6,10,1506,5,395,43.0,127.0,127.0,5,1111,45.0,843.0,843.0
0.005,6,10,2006,5,927,1.0,659.0,659.0,5,1079,1.0,811.0,811.0
0.005,6,10,2007,5,928,1.0,660.0,660.0,5,1079,1.0,811.0,811.0
0.042,17,2,152,1,76,0.0,48.0,48.0,1,76,0.0,48.0,48.0
0.006,6,10,1547,5,764,1.0,496.0,496.0,5,783,1.0,515.0,515.0
0.006,6,10,2000,5,927,1.0,659.0,659.0,5,1073,1.0,805.0,805.0
22.241,58,2,144,1,72,0.0,24.0,24.0,1,72,0.0,24.0,24.0
0.013,6,10,1990,5,911,3.0,643.0,643.0,5,1079,3.0,811.0,811.0
0.005,6,10,1989,5,927,1.0,659.0,659.0,5,1062,1.0,794.0,794.0
0.005,6,10,1689,5,839,1.0,571.0,571.0,5,850,1.0,582.0,582.0
0.083,6,10,1506,5,395,17.0,127.0,127.0,5,1111,18.0,843.0,843.0
0.038,17,2,184,1,61,0.0,33.0,33.0,1,123,0.0,95.0,95.0
1756.067,6,105,6270,60,3525,29763.0,27.0,27.0,45,2745,39909.0,27.0,27.0
441.448,6,35,10842,19,2814,24524.0,676.0,363.0,16,8028,25427.0,1402.0,718.0
40.053,17,10,676,5,460,10012.0,104.0,64.0,5,216,10012.0,20.0,15.0
0.005,6,10,2007,5,928,1.0,660.0,660.0,5,1079,1.0,811.0,811.0
0.005,6,10,1643,5,860,1.0,592.0,592.0,5,783,1.0,515.0,515.0
0.009,6,10,1989,5,910,2.0,642.0,642.0,5,1079,2.0,811.0,811.0
0.011,6,10,1983,5,910,2.0,642.0,642.0,5,1073,2.0,805.0,805.0
0.006,17,2,179,1,71,0.0,43.0,43.0,1,108,0.0,80.0,80.0
0.012,6,10,1990,5,911,3.0,643.0,643.0,5,1079,3.0,811.0,811.0
0.004,6,10,2006,5,927,1.0,659.0,659.0,5,1079,1.0,811.0,811.0
0.01,6,10,1983,5,910,2.0,642.0,642.0,5,1073,2.0,805.0,805.0
0.083,6,10,1506,5,395,17.0,127.0,127.0,5,1111,18.0,843.0,843.0
0.04,17,2,184,1,61,0.0,33.0,33.0,1,123,0.0,95.0,95.0
1730.358,6,45,2790,30,1725,59667.0,35.0,35.0,15,1065,123591.0,31.0,31.0
0.005,6,10,1547,5,764,1.0,496.0,496.0,5,783,1.0,515.0,515.0
11.023,17,28,4423,14,1995,839.0,270.0,114.0,14,2428,839.0,587.0,145.0
0.004,6,10,2007,5,928,1.0,660.0,660.0,5,1079,1.0,811.0,811.0
0.012,6,10,1983,5,910,3.0,642.0,642.0,5,1073,3.0,805.0,805.0
0.004,6,10,1774,5,923,1.0,655.0,655.0,5,851,1.0,583.0,583.0
0.003,17,4,284,2,120,0.0,32.0,32.0,2,164,0.0,60.0,54.0
0.001,17,2,180,1,66,0.0,38.0,38.0,1,114,0.0,86.0,86.0
1791.545,6,485,98733,244,87503,7372.0,421.0,368.0,241,11230,7464.0,53.0,53.0
0.098,6,10,1506,5,395,19.0,127.0,127.0,5,1111,20.0,843.0,843.0
0.136,6,10,1506,5,395,32.0,127.0,127.0,5,1111,33.0,843.0,843.0
0.005,6,10,2000,5,927,1.0,659.0,659.0,5,1073,1.0,805.0,805.0
294.392,6,24,7139,7,5954,19.0,2736.0,1395.0,17,1185,18398.0,293.0,293.0
0.005,6,10,2006,5,927,1.0,659.0,659.0,5,1079,1.0,811.0,811.0
0.016,6,10,1972,5,910,4.0,642.0,642.0,5,1062,3.0,794.0,794.0
0.007,17,2,179,1,71,0.0,43.0,43.0,1,108,0.0,80.0,80.0
0.006,6,10,1643,5,860,1.0,592.0,592.0,5,783,1.0,515.0,515.0
0.006,17,2,170,1,65,0.0,37.0,37.0,1,105,0.0,77.0,77.0
0.069,6,10,1506,5,395,16.0,127.0,127.0,5,1111,15.0,843.0,843.0
0.077,6,10,1506,5,395,17.0,127.0,127.0,5,1111,15.0,843.0,843.0
0.015,6,10,1989,5,910,3.0,642.0,642.0,5,1079,3.0,811.0,811.0
0.005,17,2,144,1,64,0.0,36.0,36.0,1,80,0.0,52.0,52.0
0.003,17,2,136,1,60,0.0,32.0,32.0,1,76,0.0,48.0,48.0
15.342,17,41,20375,22,17084,729.0,1350.0,748.0,19,3291,850.0,1350.0,145.0
0.011,6,10,1677,5,827,2.0,559.0,559.0,5,850,2.0,582.0,582.0
0.005,6,10,1774,5,923,1.0,655.0,655.0,5,851,1.0,583.0,583.0
240.012,6,9,787,5,488,60003.0,232.0,232.0,4,299,80003.0,83.0,83.0
300.215,6,25,7303,15,1357,21443.0,217.0,142.0,10,5946,26687.0,1679.0,903.0
0.005,6,10,2006,5,927,1.0,659.0,659.0,5,1079,1.0,811.0,811.0
0.006,6,10,1854,5,889,1.0,621.0,621.0,5,965,1.0,697.0,697.0
292.329,6,328,344055,130,18315,2266.0,2736.0,770.0,198,325740,1483.0,2804.0,1705.0
40.074,17,10,676,5,460,10015.0,104.0,64.0,5,216,10016.0,20.0,15.0
0.078,6,10,1506,5,395,17.0,127.0,127.0,5,1111,18.0,843.0,843.0
354.021,6,21,1795,16,1030,23601.0,190.0,190.0,5,765,60002.0,464.0,248.0
0.134,6,10,1506,5,395,28.0,127.0,127.0,5,1111,24.0,843.0,843.0
0.006,6,10,1547,5,764,1.0,496.0,496.0,5,783,1.0,515.0,515.0
0.01,6,12,1926,6,1189,1.0,659.0,434.0,6,737,1.0,417.0,417.0
0.005,17,2,148,1,60,0.0,32.0,32.0,1,88,0.0,60.0,60.0
0.014,6,10,1689,5,839,3.0,571.0,571.0,5,850,3.0,582.0,582.0
0.006,6,10,1547,5,764,1.0,496.0,496.0,5,783,1.0,515.0,515.0
0.014,6,10,1990,5,911,3.0,643.0,643.0,5,1079,3.0,811.0,811.0
0.005,6,10,1989,5,927,1.0,659.0,659.0,5,1062,1.0,794.0,794.0
0.001,17,2,136,1,60,0.0,32.0,32.0,1,76,0.0,48.0,48.0
0.009,17,2,194,1,59,0.0,31.0,31.0,1,135,0.0,107.0,107.0
241.829,6,297,342520,118,17642,2066.0,2736.0,959.0,179,324878,1358.0,4043.0,1867.0
11.699,17,40,9115,20,5001,610.0,1337.0,222.0,20,4114,610.0,862.0,177.0
0.002,17,2,180,1,66,0.0,38.0,38.0,1,114,0.0,86.0,86.0
0.005,17,2,140,1,62,0.0,34.0,34.0,1,78,0.0,50.0,50.0
40.063,17,10,676,5,460,10014.0,104.0,64.0,5,216,10015.0,20.0,15.0
0.06,17,2,144,1,64,0.0,36.0,36.0,1,80,0.0,52.0,52.0
0.038,17,2,152,1,76,0.0,48.0,48.0,1,76,0.0,48.0,48.0
0.007,6,10,1689,5,839,1.0,571.0,571.0,5,850,1.0,582.0,582.0
0.004,6,10,2007,5,928,1.0,660.0,660.0,5,1079,1.0,811.0,811.0
0.001,17,2,180,1,66,0.0,38.0,38.0,1,114,0.0,86.0,86.0
0.005,17,2,154,1,69,0.0,41.0,41.0,1,85,0.0,57.0,57.0
0.007,6,10,1972,5,910,1.0,642.0,642.0,5,1062,1.0,794.0,794.0
0.007,6,10,1689,5,839,1.0,571.0,571.0,5,850,1.0,582.0,582.0
0.003,17,2,148,1,60,0.0,32.0,32.0,1,88,0.0,60.0,60.0
0.02,6,10,1990,5,911,5.0,643.0,643.0,5,1079,5.0,811.0,811.0
0.014,6,10,1990,5,911,3.0,643.0,643.0,5,1079,3.0,811.0,811.0
0.004,17,4,284,2,120,0.0,32.0,32.0,2,164,0.0,60.0,54.0
0.115,6,20,9266,11,860,11.0,280.0,280.0,9,8406,13.0,1402.0,1321.0
0.005,17,2,180,1,66,0.0,38.0,38.0,1,114,0.0,86.0,86.0
0.005,6,10,1989,5,927,1.0,659.0,659.0,5,1062,1.0,794.0,794.0
40.059,17,10,676,5,460,10013.0,104.0,64.0,5,216,10013.0,20.0,15.0
0.004,6,10,2006,5,927,1.0,659.0,659.0,5,1079,1.0,811.0,811.0
0.005,6,10,2006,5,927,1.0,659.0,659.0,5,1079,1.0,811.0,811.0
0.06,6,10,1506,5,395,13.0,127.0,127.0,5,1111,14.0,843.0,843.0
0.009,6,10,1989,5,910,2.0,642.0,642.0,5,1079,2.0,811.0,811.0
0.01,6,10,1762,5,911,2.0,643.0,643.0,5,851,2.0,583.0,583.0
15.071,17,14,9191,8,6902,2148.0,1350.0,834.0,6,2289,3008.0,1350.0,353.0
0.103,6,10,1506,5,395,23.0,127.0,127.0,5,1111,21.0,843.0,843.0
0.018,6,10,1762,5,911,4.0,643.0,643.0,5,851,4.0,583.0,583.0
0.01,6,13,3735,7,497,1.0,125.0,125.0,6,3238,1.0,1470.0,1459.0
0.115,6,10,1506,5,395,25.0,127.0,127.0,5,1111,27.0,843.0,843.0
0.07,6,10,1506,5,395,15.0,127.0,127.0,5,1111,15.0,843.0,843.0
240.352,6,33,9306,16,1832,16023.0,620.0,198.0,17,7474,15021.0,1402.0,599.0
40.061,17,10,676,5,460,10012.0,104.0,64.0,5,216,10014.0,20.0,15.0
0.016,6,10,1989,5,910,4.0,642.0,642.0,5,1079,3.0,811.0,811.0
0.004,6,10,1702,5,863,1.0,595.0,595.0,5,839,0.0,571.0,571.0
0.001,17,2,136,1,60,0.0,32.0,32.0,1,76,0.0,48.0,48.0
0.003,17,4,284,2,120,0.0,32.0,32.0,2,164,0.0,60.0,54.0
0.006,6,12,1698,6,863,1.0,327.0,271.0,6,835,1.0,515.0,515.0
0.017,6,10,1983,5,910,4.0,642.0,642.0,5,1073,4.0,805.0,805.0
0.114,6,10,1506,5,395,22.0,127.0,127.0,5,1111,25.0,843.0,843.0
0.01,6,10,1989,5,927,2.0,659.0,659.0,5,1062,2.0,794.0,794.0
0.073,6,10,1506,5,395,16.0,127.0,127.0,5,1111,15.0,843.0,843.0
0.004,6,10,1774,5,923,1.0,655.0,655.0,5,851,1.0,583.0,583.0
240.012,6,9,787,5,488,60003.0,232.0,232.0,4,299,80003.0,83.0,83.0
0.001,17,2,180,1,66,0.0,38.0,38.0,1,114,0.0,86.0,86.0
0.013,6,10,1989,5,910,3.0,642.0,642.0,5,1079,3.0,811.0,811.0
0.005,6,14,3742,8,504,0.0,80.0,80.0,6,3238,0.0,1470.0,1459.0
0.086,6,10,1506,5,395,20.0,127.0,127.0,5,1111,15.0,843.0,843.0
0.006,6,10,1689,5,839,1.0,571.0,571.0,5,850,1.0,582.0,582.0
1039.686,6,66,26738,34,7246,31505.0,676.0,497.0,32,19492,31601.0,1917.0,891.0
11.015,17,28,4394,14,2312,838.0,587.0,137.0,14,2082,838.0,269.0,120.0
0.011,6,10,1972,5,910,2.0,642.0,642.0,5,1062,2.0,794.0,794.0
0.01,6,10,1989,5,910,2.0,642.0,642.0,5,1079,2.0,811.0,811.0
0.005,6,10,2007,5,928,1.0,660.0,660.0,5,1079,1.0,811.0,811.0
0.005,6,10,1779,5,928,1.0,660.0,660.0,5,851,1.0,583.0,583.0
174.34,17,82,11911,41,2762,4358.0,44.0,39.0,41,9149,4358.0,261.0,195.0
0.207,6,16,2669,8,1395,29.0,533.0,323.0,8,1274,18.0,529.0,212.0
0.01,6,10,1990,5,911,2.0,643.0,643.0,5,1079,2.0,811.0,811.0
0.005,6,10,1989,5,927,1.0,659.0,659.0,5,1062,1.0,794.0,794.0
0.011,6,10,1631,5,848,2.0,580.0,580.0,5,783,2.0,515.0,515.0
40.055,17,10,676,5,460,10012.0,104.0,64.0,5,216,10012.0,20.0,15.0
0.011,6,10,1762,5,911,2.0,643.0,643.0,5,851,2.0,583.0,583.0
0.095,6,10,1506,5,395,17.0,127.0,127.0,5,1111,22.0,843.0,843.0
0.075,6,10,1506,5,395,14.0,127.0,127.0,5,1111,18.0,843.0,843.0
0.1,6,10,1506,5,395,21.0,127.0,127.0,5,1111,21.0,843.0,843.0
0.104,6,10,1506,5,395,23.0,127.0,127.0,5,1111,19.0,843.0,843.0
0.038,17,4,284,2,120,0.0,32.0,32.0,2,164,35.0,60.0,54.0
0.126,17,2,170,1,65,0.0,37.0,37.0,1,105,0.0,77.0,77.0
0.006,6,10,1547,5,764,1.0,496.0,496.0,5,783,1.0,515.0,515.0
0.009,6,10,1990,5,911,2.0,643.0,643.0,5,1079,2.0,811.0,811.0
0.137,6,10,1506,5,395,26.0,127.0,127.0,5,1111,31.0,843.0,843.0
0.012,6,10,1972,5,910,2.0,642.0,642.0,5,1062,3.0,794.0,794.0
0.007,6,12,1698,6,863,1.0,327.0,271.0,6,835,1.0,515.0,515.0
0.006,6,10,1643,5,860,1.0,592.0,592.0,5,783,1.0,515.0,515.0
0.004,6,10,1774,5,923,1.0,655.0,655.0,5,851,1.0,583.0,583.0
40.074,17,10,676,5,460,10013.0,104.0,64.0,5,216,10017.0,20.0,15.0
0.091,6,10,1506,5,395,19.0,127.0,127.0,5,1111,21.0,843.0,843.0
0.004,6,10,1702,5,863,0.0,595.0,595.0,5,839,1.0,571.0,571.0
0.007,6,10,2007,5,928,1.0,660.0,660.0,5,1079,1.0,811.0,811.0
0.005,6,10,1702,5,863,1.0,595.0,595.0,5,839,1.0,571.0,571.0
0.012,6,10,1989,5,910,2.0,642.0,642.0,5,1079,2.0,811.0,811.0
0.009,6,13,3735,7,497,1.0,125.0,125.0,6,3238,1.0,1470.0,1459.0
0.012,6,14,3787,7,497,2.0,125.0,125.0,7,3290,1.0,1448.0,972.0
1799.48,17,2911,219026,1450,116106,1241.0,82.0,52.0,1461,102920,1232.0,226.0,42.0
0.013,6,10,1972,5,910,3.0,642.0,642.0,5,1062,3.0,794.0,794.0
0.019,6,10,1677,5,827,4.0,559.0,559.0,5,850,4.0,582.0,582.0
290.312,6,368,347260,190,21434,1536.0,2736.0,888.0,178,325826,1640.0,2804.0,1930.0
367.255,6,22,2313,16,867,24483.0,195.0,195.0,6,1446,4638.0,419.0,398.0
0.004,6,10,2000,5,927,1.0,659.0,659.0,5,1073,1.0,805.0,805.0
0.411,17,49,30676,29,26255,14.0,1350.0,877.0,20,4421,18.0,1350.0,193.0
366.309,6,22,2313,16,867,24420.0,195.0,195.0,6,1446,4634.0,419.0,398.0
0.008,6,10,1762,5,911,1.0,643.0,643.0,5,851,2.0,583.0,583.0
0.119,6,10,1506,5,395,27.0,127.0,127.0,5,1111,25.0,843.0,843.0
0.004,17,2,136,1,60,0.0,32.0,32.0,1,76,0.0,48.0,48.0
0.004,6,10,1774,5,923,1.0,655.0,655.0,5,851,1.0,583.0,583.0
0.005,6,10,2007,5,928,1.0,660.0,660.0,5,1079,1.0,811.0,811.0
0.097,6,10,1506,5,395,21.0,127.0,127.0,5,1111,21.0,843.0,843.0
0.098,6,10,1506,5,395,21.0,127.0,127.0,5,1111,19.0,843.0,843.0
0.04,17,2,136,1,60,0.0,32.0,32.0,1,76,0.0,48.0,48.0
0.005,17,2,166,1,75,0.0,47.0,47.0,1,91,0.0,63.0,63.0
188.075,17,86,12579,43,2861,4477.0,44.0,38.0,43,9718,4477.0,258.0,198.0
0.143,6,10,1506,5,395,24.0,127.0,127.0,5,1111,32.0,843.0,843.0
0.004,6,10,2000,5,927,1.0,659.0,659.0,5,1073,1.0,805.0,805.0
174.36,17,76,10929,38,2528,4712.0,44.0,38.0,38,8401,4712.0,261.0,193.0
125.479,6,21,8147,11,1985,80.0,1174.0,504.0,10,6162,13923.0,1791.0,958.0
0.005,6,10,1779,5,928,1.0,660.0,660.0,5,851,1.0,583.0,583.0
0.083,6,10,1506,5,395,18.0,127.0,127.0,5,1111,18.0,843.0,843.0
0.009,6,12,1926,6,1189,1.0,659.0,434.0,6,737,1.0,417.0,417.0
308.872,17,20,1124,10,716,34304.0,48.0,43.0,10,408,34304.0,20.0,12.0
0.11,6,10,1506,5,395,21.0,127.0,127.0,5,1111,23.0,843.0,843.0
0.007,6,10,1547,5,764,1.0,496.0,496.0,5,783,1.0,515.0,515.0
10.837,17,28,4421,14,1993,825.0,268.0,114.0,14,2428,825.0,587.0,145.0
0.006,6,10,1547,5,764,1.0,496.0,496.0,5,783,1.0,515.0,515.0
0.072,17,4,420,2,122,0.0,33.0,33.0,2,298,69.0,145.0,121.0
0.18,6,10,1506,5,395,44.0,127.0,127.0,5,1111,44.0,843.0,843.0
15.356,17,40,20323,22,17085,729.0,1350.0,748.0,18,3238,901.0,1350.0,151.0
0.005,6,10,2006,5,927,1.0,659.0,659.0,5,1079,1.0,811.0,811.0
40.056,17,10,676,5,460,10013.0,104.0,64.0,5,216,10013.0,20.0,15.0
0.08,6,10,1506,5,395,17.0,127.0,127.0,5,1111,19.0,843.0,843.0
0.168,17,2,152,1,76,0.0,48.0,48.0,1,76,0.0,48.0,48.0
0.085,6,26,10142,13,8838,7.0,2883.0,1166.0,13,1304,6.0,269.0,104.0
40.056,17,10,676,5,460,10013.0,104.0,64.0,5,216,10013.0,20.0,15.0
0.013,6,10,1990,5,911,3.0,643.0,643.0,5,1079,3.0,811.0,811.0
0.067,17,8,3613,4,1874,22.0,1350.0,440.0,4,1739,11.0,1350.0,406.0
0.009,6,10,1990,5,911,2.0,643.0,643.0,5,1079,2.0,811.0,811.0
0.008,6,12,1926,6,1189,1.0,659.0,434.0,6,737,1.0,417.0,417.0
0.071,6,10,1506,5,395,16.0,127.0,127.0,5,1111,15.0,843.0,843.0
0.005,6,10,1989,5,927,1.0,659.0,659.0,5,1062,1.0,794.0,794.0
0.006,6,10,1547,5,764,1.0,496.0,496.0,5,783,1.0,515.0,515.0
0.04,17,2,182,1,65,0.0,37.0,37.0,1,117,0.0,89.0,89.0
0.053,17,2,152,1,76,0.0,48.0,48.0,1,76,0.0,48.0,48.0
0.006,17,2,164,1,74,0.0,46.0,46.0,1,90,0.0,62.0,62.0
0.004,6,10,2006,5,927,1.0,659.0,659.0,5,1079,1.0,811.0,811.0
171.425,17,86,11741,43,2860,4081.0,44.0,38.0,43,8881,4081.0,239.0,178.0
0.102,6,10,1506,5,395,22.0,127.0,127.0,5,1111,23.0,843.0,843.0
0.016,6,10,1989,5,910,4.0,642.0,642.0,5,1079,4.0,811.0,811.0
0.006,6,10,1547,5,764,1.0,496.0,496.0,5,783,1.0,515.0,515.0
0.013,6,10,1989,5,910,3.0,642.0,642.0,5,1079,3.0,811.0,811.0
0.005,17,2,170,1,65,0.0,37.0,37.0,1,105,0.0,77.0,77.0
40.077,17,10,676,5,460,10018.0,104.0,64.0,5,216,10018.0,20.0,15.0
0.009,6,12,1926,6,1189,1.0,659.0,434.0,6,737,1.0,417.0,417.0
0.005,6,10,2006,5,927,1.0,659.0,659.0,5,1079,1.0,811.0,811.0
0.056,17,2,179,1,71,0.0,43.0,43.0,1,108,0.0,80.0,80.0
40.071,17,10,676,5,460,10014.0,104.0,64.0,5,216,10017.0,20.0,15.0
366.993,6,21,1793,16,1030,24466.0,190.0,190.0,5,763,60010.0,462.0,247.0
0.005,6,10,2006,5,927,1.0,659.0,659.0,5,1079,1.0,811.0,811.0
0.004,6,10,2006,5,927,1.0,659.0,659.0,5,1079,1.0,811.0,811.0
0.006,6,10,1547,5,764,1.0,496.0,496.0,5,783,1.0,515.0,515.0
0.005,17,2,164,1,74,0.0,46.0,46.0,1,90,0.0,62.0,62.0
40.066,17,10,676,5,460,10014.0,104.0,64.0,5,216,10015.0,20.0,15.0
0.006,6,10,1547,5,764,1.0,496.0,496.0,5,783,1.0,515.0,515.0
0.005,6,10,2006,5,927,1.0,659.0,659.0,5,1079,1.0,811.0,811.0
0.001,17,2,180,1,66,0.0,38.0,38.0,1,114,0.0,86.0,86.0
0.005,17,2,166,1,75,0.0,47.0,47.0,1,91,0.0,63.0,63.0
0.225,6,16,2669,8,1395,32.0,533.0,323.0,8,1274,20.0,529.0,212.0
0.005,6,10,1989,5,927,1.0,659.0,659.0,5,1062,1.0,794.0,794.0
0.011,6,10,1989,5,910,2.0,642.0,642.0,5,1079,2.0,811.0,811.0
0.075,6,10,1506,5,395,16.0,127.0,127.0,5,1111,16.0,843.0,843.0
0.003,17,2,148,1,60,0.0,32.0,32.0,1,88,0.0,60.0,60.0
0.001,17,2,180,1,66,0.0,38.0,38.0,1,114,0.0,86.0,86.0
0.009,6,10,1990,5,911,2.0,643.0,643.0,5,1079,2.0,811.0,811.0
0.006,6,10,1989,5,927,1.0,659.0,659.0,5,1062,1.0,794.0,794.0
11.133,17,28,4423,14,1995,843.0,270.0,114.0,14,2428,843.0,587.0,145.0
0.007,17,2,179,1,71,0.0,43.0,43.0,1,108,0.0,80.0,80.0
0.003,17,2,148,1,60,0.0,32.0,32.0,1,88,0.0,60.0,60.0
0.235,6,10,1506,5,395,56.0,127.0,127.0,5,1111,34.0,843.0,843.0
352.749,6,20,2210,6,1308,12003.0,494.0,494.0,14,902,27134.0,83.0,83.0
0.004,6,10,1989,5,927,1.0,659.0,659.0,5,1062,1.0,794.0,794.0
0.006,17,2,170,1,65,0.0,37.0,37.0,1,105,0.0,77.0,77.0
0.005,6,10,2006,5,927,1.0,659.0,659.0,5,1079,1.0,811.0,811.0
1799.821,6,136,6550,76,3625,23997.0,39.0,39.0,60,2925,29993.0,35.0,35.0
0.071,17,2,136,1,60,0.0,32.0,32.0,1,76,0.0,48.0,48.0
0.004,17,2,148,1,60,0.0,32.0,32.0,1,88,0.0,60.0,60.0
420.186,6,29,4409,12,3102,10912.0,494.0,494.0,17,1307,26261.0,83.0,83.0
0.009,6,10,1643,5,860,2.0,592.0,592.0,5,783,2.0,515.0,515.0
0.096,6,10,1506,5,395,19.0,127.0,127.0,5,1111,19.0,843.0,843.0
0.009,6,12,1926,6,1189,1.0,659.0,434.0,6,737,1.0,417.0,417.0
0.018,6,13,3735,7,497,2.0,125.0,125.0,6,3238,3.0,1470.0,1459.0
0.289,6,10,1506,5,395,70.0,127.0,127.0,5,1111,44.0,843.0,843.0
0.135,6,10,1506,5,395,23.0,127.0,127.0,5,1111,31.0,843.0,843.0
1799.915,6,137,6590,76,3625,23995.0,39.0,39.0,61,2965,29994.0,35.0,35.0
353.622,6,20,2210,6,1308,12004.0,494.0,494.0,14,902,27201.0,83.0,83.0
0.016,6,10,1762,5,911,4.0,643.0,643.0,5,851,3.0,583.0,583.0
0.007,17,2,194,1,59,0.0,31.0,31.0,1,135,0.0,107.0,107.0
0.023,6,10,1972,5,910,5.0,642.0,642.0,5,1062,5.0,794.0,794.0
0.005,6,10,1989,5,927,1.0,659.0,659.0,5,1062,1.0,794.0,794.0
311.721,17,20,1124,10,716,34621.0,48.0,43.0,10,408,34621.0,20.0,12.0
0.001,17,2,180,1,66,0.0,38.0,38.0,1,114,0.0,86.0,86.0
0.039,17,4,420,2,122,0.0,33.0,33.0,2,298,36.0,145.0,121.0
0.089,6,10,1506,5,395,21.0,127.0,127.0,5,1111,16.0,843.0,843.0
0.133,6,10,1506,5,395,31.0,127.0,127.0,5,1111,28.0,843.0,843.0
0.004,17,2,136,1,60,0.0,32.0,32.0,1,76,0.0,48.0,48.0
0.008,6,10,1990,5,911,2.0,643.0,643.0,5,1079,1.0,811.0,811.0
0.001,17,2,180,1,66,0.0,38.0,38.0,1,114,0.0,86.0,86.0
0.006,6,10,1547,5,764,1.0,496.0,496.0,5,783,1.0,515.0,515.0
0.005,6,10,2006,5,927,1.0,659.0,659.0,5,1079,1.0,811.0,811.0
240.018,6,9,787,5,488,60004.0,232.0,232.0,4,299,80004.0,83.0,83.0
240.1,6,16,6770,8,6053,34300.0,2736.0,1410.0,8,717,34299.0,293.0,293.0
0.085,6,10,1506,5,395,19.0,127.0,127.0,5,1111,18.0,843.0,843.0
0.005,6,14,3799,7,509,0.0,137.0,137.0,7,3290,0.0,1448.0,972.0
0.008,6,10,1989,5,910,2.0,642.0,642.0,5,1079,2.0,811.0,811.0
371.586,6,22,2313,16,867,24772.0,195.0,195.0,6,1446,4660.0,419.0,398.0
0.018,6,10,1989,5,910,4.0,642.0,642.0,5,1079,4.0,811.0,811.0
0.005,6,10,2006,5,927,1.0,659.0,659.0,5,1079,1.0,811.0,811.0
0.009,6,10,1677,5,827,2.0,559.0,559.0,5,850,2.0,582.0,582.0
1772.005,6,105,6270,60,3525,30033.0,27.0,27.0,45,2745,40271.0,27.0,27.0
0.006,6,10,1547,5,764,1.0,496.0,496.0,5,783,1.0,515.0,515.0
0.007,6,10,1989,5,910,1.0,642.0,642.0,5,1079,1.0,811.0,811.0
0.004,6,10,1989,5,927,1.0,659.0,659.0,5,1062,1.0,794.0,794.0
240.742,6,33,9299,14,6557,8.0,1720.0,646.0,19,2742,13374.0,580.0,174.0
0.066,6,10,1506,5,395,15.0,127.0,127.0,5,1111,14.0,843.0,843.0
0.006,17,2,144,1,64,0.0,36.0,36.0,1,80,0.0,52.0,52.0
0.015,6,10,1762,5,911,3.0,643.0,643.0,5,851,3.0,583.0,583.0
0.001,17,2,180,1,66,0.0,38.0,38.0,1,114,0.0,86.0,86.0
0.088,6,10,1506,5,395,19.0,127.0,127.0,5,1111,20.0,843.0,843.0
0.015,6,10,1989,5,910,3.0,642.0,642.0,5,1079,3.0,811.0,811.0
0.003,17,4,284,2,120,0.0,32.0,32.0,2,164,0.0,60.0,54.0
0.011,6,10,1989,5,910,2.0,642.0,642.0,5,1079,2.0,811.0,811.0
0.005,6,10,1989,5,927,1.0,659.0,659.0,5,1062,1.0,794.0,794.0
0.034,17,2,152,1,76,0.0,48.0,48.0,1,76,0.0,48.0,48.0
0.007,6,10,1689,5,839,1.0,571.0,571.0,5,850,1.0,582.0,582.0
0.004,6,10,2000,5,927,1.0,659.0,659.0,5,1073,1.0,805.0,805.0
0.005,6,10,2006,5,927,1.0,659.0,659.0,5,1079,1.0,811.0,811.0
0.014,6,10,1983,5,910,3.0,642.0,642.0,5,1073,3.0,805.0,805.0
0.005,6,10,2006,5,927,1.0,659.0,659.0,5,1079,1.0,811.0,811.0
0.004,17,4,284,2,120,0.0,32.0,32.0,2,164,1.0,60.0,54.0
0.011,6,10,1989,5,910,2.0,642.0,642.0,5,1079,2.0,811.0,811.0
0.072,17,4,596,2,122,0.0,33.0,33.0,2,474,0.0,323.0,209.0
0.171,6,10,1506,5,395,38.0,127.0,127.0,5,1111,38.0,843.0,843.0
0.107,6,10,1506,5,395,25.0,127.0,127.0,5,1111,20.0,843.0,843.0
0.001,17,2,180,1,66,0.0,38.0,38.0,1,114,0.0,86.0,86.0
0.015,6,10,1990,5,911,3.0,643.0,643.0,5,1079,3.0,811.0,811.0
0.123,17,2,179,1,71,0.0,43.0,43.0,1,108,0.0,80.0,80.0
183.119,17,78,11067,39,2604,4818.0,44.0,38.0,39,8463,4818.0,239.0,189.0
0.169,6,3,453,2,321,169.0,241.0,241.0,1,132,0.0,92.0,92.0
0.072,6,10,1506,5,395,15.0,127.0,127.0,5,1111,13.0,843.0,843.0
0.017,6,10,1983,5,910,4.0,642.0,642.0,5,1073,4.0,805.0,805.0
0.005,17,2,212,1,74,0.0,46.0,46.0,1,138,0.0,110.0,110.0
368.558,6,22,2313,16,867,24570.0,195.0,195.0,6,1446,4635.0,419.0,398.0
0.071,17,2,136,1,60,0.0,32.0,32.0,1,76,0.0,48.0,48.0
240.094,6,32,9007,16,6528,16006.0,1515.0,570.0,16,2479,16006.0,580.0,204.0
0.009,6,10,1983,5,910,2.0,642.0,642.0,5,1073,2.0,805.0,805.0
0.222,6,10,1506,5,395,49.0,127.0,127.0,5,1111,53.0,843.0,843.0
0.009,6,10,1990,5,911,2.0,643.0,643.0,5,1079,2.0,811.0,811.0
0.005,17,2,209,1,64,0.0,36.0,36.0,1,145,0.0,117.0,117.0
294.413,6,392,347825,196,21752,1509.0,2736.0,888.0,196,326073,1509.0,2804.0,1735.0
0.041,17,2,152,1,76,0.0,48.0,48.0,1,76,0.0,48.0,48.0
0.017,6,10,1983,5,910,4.0,642.0,642.0,5,1073,4.0,805.0,805.0
10.78,17,28,4420,14,1993,820.0,268.0,114.0,14,2427,820.0,586.0,145.0
0.125,6,10,1506,5,395,25.0,127.0,127.0,5,1111,25.0,843.0,843.0
0.039,17,2,170,1,65,0.0,37.0,37.0,1,105,0.0,77.0,77.0
0.006,6,10,2006,5,927,1.0,659.0,659.0,5,1079,1.0,811.0,811.0
0.005,6,10,1547,5,764,1.0,496.0,496.0,5,783,1.0,515.0,515.0
0.017,6,10,1989,5,910,4.0,642.0,642.0,5,1079,4.0,811.0,811.0
0.009,6,10,1990,5,911,2.0,643.0,643.0,5,1079,2.0,811.0,811.0
240.662,6,35,8925,18,2072,14154.0,693.0,225.0,17,6853,15039.0,1402.0,597.0
0.268,17,45,25711,25,21227,11.0,1350.0,821.0,20,4484,10.0,1350.0,196.0
0.127,17,2,182,1,65,0.0,37.0,37.0,1,117,0.0,89.0,89.0
0.261,17,39,20172,21,17041,13.0,1350.0,783.0,18,3131,11.0,1350.0,145.0
0.003,17,2,136,1,60,0.0,32.0,32.0,1,76,0.0,48.0,48.0
0.08,6,10,1506,5,395,15.0,127.0,127.0,5,1111,17.0,843.0,843.0
0.018,6,10,1972,5,910,4.0,642.0,642.0,5,1062,4.0,794.0,794.0
0.088,6,10,1506,5,395,19.0,127.0,127.0,5,1111,18.0,843.0,843.0
0.132,6,10,1506,5,395,29.0,127.0,127.0,5,1111,29.0,843.0,843.0
0.004,6,10,2006,5,927,1.0,659.0,659.0,5,1079,1.0,811.0,811.0
0.014,6,10,1990,5,911,3.0,643.0,643.0,5,1079,3.0,811.0,811.0
0.013,6,10,1989,5,910,3.0,642.0,642.0,5,1079,3.0,811.0,811.0
0.003,17,2,136,1,60,0.0,32.0,32.0,1,76,0.0,48.0,48.0
0.006,6,10,2000,5,927,1.0,659.0,659.0,5,1073,1.0,805.0,805.0
0.01,6,10,1631,5,848,2.0,580.0,580.0,5,783,2.0,515.0,515.0
0.006,17,2,164,1,74,0.0,46.0,46.0,1,90,0.0,62.0,62.0
0.017,6,13,3735,7,497,2.0,125.0,125.0,6,3238,3.0,1470.0,1459.0
0.005,6,10,2006,5,927,1.0,659.0,659.0,5,1079,1.0,811.0,811.0
0.005,6,10,2007,5,928,1.0,660.0,660.0,5,1079,1.0,811.0,811.0
0.006,17,2,144,1,64,0.0,36.0,36.0,1,80,0.0,52.0,52.0
0.005,6,10,1689,5,839,1.0,571.0,571.0,5,850,1.0,582.0,582.0
0.006,6,10,2006,5,927,1.0,659.0,659.0,5,1079,1.0,811.0,811.0
40.068,17,10,676,5,460,10015.0,104.0,64.0,5,216,10016.0,20.0,15.0
0.022,6,20,9974,11,704,2.0,124.0,124.0,9,9270,2.0,2896.0,1758.0
0.001,17,2,180,1,66,0.0,38.0,38.0,1,114,0.0,86.0,86.0
0.006,6,10,1547,5,764,1.0,496.0,496.0,5,783,1.0,515.0,515.0
0.013,6,10,1989,5,910,3.0,642.0,642.0,5,1079,3.0,811.0,811.0
0.111,6,10,1506,5,395,24.0,127.0,127.0,5,1111,24.0,843.0,843.0
0.004,6,10,2006,5,927,1.0,659.0,659.0,5,1079,1.0,811.0,811.0
240.078,6,18,4904,9,2305,30009.0,1102.0,613.0,9,2599,30009.0,1162.0,530.0
0.003,17,2,148,1,60,0.0,32.0,32.0,1,88,0.0,60.0,60.0
0.076,6,10,1506,5,395,17.0,127.0,127.0,5,1111,16.0,843.0,843.0
0.004,6,10,1702,5,863,1.0,595.0,595.0,5,839,0.0,571.0,571.0
0.006,6,10,2006,5,927,1.0,659.0,659.0,5,1079,1.0,811.0,811.0
0.009,6,14,3787,7,497,1.0,125.0,125.0,7,3290,1.0,1448.0,972.0
0.005,6,10,1779,5,928,1.0,660.0,660.0,5,851,1.0,583.0,583.0
0.005,6,14,3742,8,504,0.0,80.0,80.0,6,3238,1.0,1470.0,1459.0
0.015,6,10,1989,5,910,3.0,642.0,642.0,5,1079,3.0,811.0,811.0
0.014,6,10,1989,5,910,3.0,642.0,642.0,5,1079,3.0,811.0,811.0
0.004,6,10,2006,5,927,1.0,659.0,659.0,5,1079,1.0,811.0,811.0
0.012,6,10,1989,5,910,3.0,642.0,642.0,5,1079,3.0,811.0,811.0
0.006,6,12,1698,6,863,1.0,327.0,271.0,6,835,1.0,515.0,515.0
0.119,6,10,1506,5,395,25.0,127.0,127.0,5,1111,24.0,843.0,843.0
0.082,6,10,1506,5,395,17.0,127.0,127.0,5,1111,18.0,843.0,843.0
0.001,17,2,142,1,63,0.0,35.0,35.0,1,79,0.0,51.0,51.0
0.065,6,10,1506,5,395,13.0,127.0,127.0,5,1111,15.0,843.0,843.0
164.481,17,86,12417,43,2891,3916.0,44.0,39.0,43,9526,3916.0,239.0,193.0
0.138,6,10,1506,5,395,31.0,127.0,127.0,5,1111,29.0,843.0,843.0
0.005,6,10,1774,5,923,1.0,655.0,655.0,5,851,1.0,583.0,583.0
0.071,6,10,1506,5,395,16.0,127.0,127.0,5,1111,16.0,843.0,843.0
0.008,6,10,1989,5,910,1.0,642.0,642.0,5,1079,2.0,811.0,811.0
0.099,6,10,1506,5,395,23.0,127.0,127.0,5,1111,21.0,843.0,843.0
0.006,6,10,1547,5,764,1.0,496.0,496.0,5,783,1.0,515.0,515.0
0.003,17,4,284,2,120,0.0,32.0,32.0,2,164,0.0,60.0,54.0
0.127,6,10,1506,5,395,29.0,127.0,127.0,5,1111,30.0,843.0,843.0
0.008,17,2,148,1,60,0.0,32.0,32.0,1,88,0.0,60.0,60.0
40.079,17,10,676,5,460,10017.0,104.0,64.0,5,216,10019.0,20.0,15.0
0.001,17,2,136,1,60,0.0,32.0,32.0,1,76,0.0,48.0,48.0
0.015,6,10,1983,5,910,3.0,642.0,642.0,5,1073,3.0,805.0,805.0
0.005,6,10,1547,5,764,1.0,496.0,496.0,5,783,1.0,515.0,515.0
0.005,6,10,2006,5,927,1.0,659.0,659.0,5,1079,1.0,811.0,811.0
0.009,6,13,3735,7,497,1.0,125.0,125.0,6,3238,1.0,1470.0,1459.0
40.051,17,10,676,5,460,10011.0,104.0,64.0,5,216,10012.0,20.0,15.0
0.004,6,10,1779,5,928,1.0,660.0,660.0,5,851,1.0,583.0,583.0
0.013,6,10,1989,5,910,3.0,642.0,642.0,5,1079,3.0,811.0,811.0
0.174,17,2,152,1,76,0.0,48.0,48.0,1,76,0.0,48.0,48.0
0.011,6,10,1989,5,910,2.0,642.0,642.0,5,1079,2.0,811.0,811.0
0.003,17,2,136,1,60,0.0,32.0,32.0,1,76,0.0,48.0,48.0
0.007,17,2,179,1,71,0.0,43.0,43.0,1,108,0.0,80.0,80.0
0.013,6,10,1983,5,910,3.0,642.0,642.0,5,1073,3.0,805.0,805.0
1121.196,6,182,35601,72,28897,15791.0,2790.0,440.0,110,6704,10285.0,148.0,50.0
0.005,6,10,2007,5,928,1.0,660.0,660.0,5,1079,1.0,811.0,811.0
0.082,6,10,1506,5,395,18.0,127.0,127.0,5,1111,17.0,843.0,843.0
102.025,6,22,9233,11,1575,74.0,794.0,367.0,11,7658,10189.0,1360.0,1029.0
74.265,6,88,69304,42,43557,1811.0,2804.0,1654.0,46,25747,1646.0,2815.0,1297.0
0.013,6,10,1972,5,910,3.0,642.0,642.0,5,1062,3.0,794.0,794.0
0.011,6,10,1972,5,910,2.0,642.0,642.0,5,1062,2.0,794.0,794.0
0.188,17,4,596,2,122,147.0,33.0,33.0,2,474,149.0,323.0,209.0
11.04,17,28,4397,14,2311,841.0,586.0,137.0,14,2086,841.0,269.0,121.0
0.007,6,12,1698,6,863,1.0,327.0,271.0,6,835,1.0,515.0,515.0
0.156,6,10,1506,5,395,35.0,127.0,127.0,5,1111,35.0,843.0,843.0
0.001,17,2,166,1,75,0.0,47.0,47.0,1,91,0.0,63.0,63.0
0.013,6,10,1972,5,910,3.0,642.0,642.0,5,1062,3.0,794.0,794.0
0.062,6,10,1506,5,395,12.0,127.0,127.0,5,1111,14.0,843.0,843.0
0.005,6,10,2006,5,927,1.0,659.0,659.0,5,1079,1.0,811.0,811.0
0.014,6,10,1990,5,911,3.0,643.0,643.0,5,1079,3.0,811.0,811.0
0.011,6,10,1989,5,910,2.0,642.0,642.0,5,1079,2.0,811.0,811.0
0.014,6,10,1983,5,910,3.0,642.0,642.0,5,1073,3.0,805.0,805.0
0.023,6,10,1989,5,910,5.0,642.0,642.0,5,1079,5.0,811.0,811.0
0.017,17,2,198,1,91,0.0,63.0,63.0,1,107,0.0,79.0,79.0
0.013,6,10,1989,5,910,3.0,642.0,642.0,5,1079,3.0,811.0,811.0
0.004,17,4,284,2,120,0.0,32.0,32.0,2,164,0.0,60.0,54.0
0.004,6,10,1702,5,863,1.0,595.0,595.0,5,839,1.0,571.0,571.0
0.058,6,10,1506,5,395,13.0,127.0,127.0,5,1111,13.0,843.0,843.0
0.012,6,10,1989,5,910,3.0,642.0,642.0,5,1079,2.0,811.0,811.0
0.005,17,2,180,1,66,0.0,38.0,38.0,1,114,0.0,86.0,86.0
0.124,17,2,156,1,64,0.0,36.0,36.0,1,92,0.0,64.0,64.0
369.871,6,22,2313,16,867,24658.0,195.0,195.0,6,1446,4678.0,419.0,398.0
0.166,6,10,1506,5,395,34.0,127.0,127.0,5,1111,35.0,843.0,843.0
0.001,17,2,136,1,60,0.0,32.0,32.0,1,76,0.0,48.0,48.0
0.005,6,10,1854,5,889,1.0,621.0,621.0,5,965,1.0,697.0,697.0
0.003,17,2,148,1,60,0.0,32.0,32.0,1,88,0.0,60.0,60.0
0.009,6,10,1972,5,910,2.0,642.0,642.0,5,1062,2.0,794.0,794.0
0.006,6,10,1547,5,764,1.0,496.0,496.0,5,783,1.0,515.0,515.0
0.108,6,10,1506,5,395,23.0,127.0,127.0,5,1111,23.0,843.0,843.0
0.006,17,2,179,1,71,0.0,43.0,43.0,1,108,0.0,80.0,80.0
0.012,6,10,1677,5,827,2.0,559.0,559.0,5,850,2.0,582.0,582.0
0.01,6,10,1989,5,910,2.0,642.0,642.0,5,1079,2.0,811.0,811.0
1730.439,6,48,2957,31,1800,57681.0,35.0,35.0,17,1157,108147.0,31.0,31.0
0.019,6,10,1989,5,910,4.0,642.0,642.0,5,1079,4.0,811.0,811.0
0.007,17,2,194,1,59,0.0,31.0,31.0,1,135,0.0,107.0,107.0
0.014,6,10,1989,5,910,3.0,642.0,642.0,5,1079,3.0,811.0,811.0
0.005,6,10,2006,5,927,1.0,659.0,659.0,5,1079,1.0,811.0,811.0
0.004,6,10,2007,5,928,1.0,660.0,660.0,5,1079,1.0,811.0,811.0
0.006,6,10,1547,5,764,1.0,496.0,496.0,5,783,1.0,515.0,515.0
300.084,6,19,4660,11,1102,30008.0,238.0,130.0,8,3558,42868.0,1402.0,786.0
10.905,17,28,4420,14,1995,830.0,270.0,114.0,14,2425,830.0,588.0,145.0
40.06,17,10,676,5,460,10014.0,104.0,64.0,5,216,10014.0,20.0,15.0
0.009,6,10,1990,5,911,2.0,643.0,643.0,5,1079,2.0,811.0,811.0
0.006,6,10,1547,5,764,1.0,496.0,496.0,5,783,1.0,515.0,515.0
0.013,6,10,1631,5,848,3.0,580.0,580.0,5,783,3.0,515.0,515.0
361.861,6,21,1793,16,1030,24124.0,190.0,190.0,5,763,60010.0,462.0,247.0
0.005,6,10,2006,5,927,1.0,659.0,659.0,5,1079,1.0,811.0,811.0
0.128,6,10,1506,5,395,29.0,127.0,127.0,5,1111,29.0,843.0,843.0
0.004,6,10,2000,5,927,1.0,659.0,659.0,5,1073,1.0,805.0,805.0
0.005,6,10,2006,5,927,1.0,659.0,659.0,5,1079,1.0,811.0,811.0
0.004,6,10,1774,5,923,1.0,655.0,655.0,5,851,1.0,583.0,583.0
0.045,17,2,152,1,76,0.0,48.0,48.0,1,76,0.0,48.0,48.0
0.005,6,13,3747,7,509,0.0,137.0,137.0,6,3238,0.0,1470.0,1459.0
0.006,6,10,2006,5,927,1.0,659.0,659.0,5,1079,1.0,811.0,811.0
0.137,17,2,182,1,65,0.0,37.0,37.0,1,117,0.0,89.0,89.0
0.004,6,10,1702,5,863,1.0,595.0,595.0,5,839,1.0,571.0,571.0
0.004,6,10,1779,5,928,1.0,660.0,660.0,5,851,1.0,583.0,583.0
0.124,17,4,284,2,120,0.0,32.0,32.0,2,164,121.0,60.0,54.0
0.001,17,2,136,1,60,0.0,32.0,32.0,1,76,0.0,48.0,48.0
300.424,6,16,2170,9,684,37531.0,146.0,146.0,7,1486,50042.0,419.0,398.0
0.001,17,2,179,1,62,0.0,34.0,34.0,1,117,0.0,89.0,89.0
0.038,17,2,170,1,65,0.0,37.0,37.0,1,105,0.0,77.0,77.0
10.817,17,28,4421,14,1994,824.0,269.0,114.0,14,2427,823.0,586.0,145.0
0.005,6,10,1643,5,860,1.0,592.0,592.0,5,783,1.0,515.0,515.0
0.013,6,10,1677,5,827,3.0,559.0,559.0,5,850,3.0,582.0,582.0
0.014,6,10,1989,5,910,3.0,642.0,642.0,5,1079,3.0,811.0,811.0
0.015,6,10,1677,5,827,3.0,559.0,559.0,5,850,3.0,582.0,582.0
0.006,6,10,1547,5,764,1.0,496.0,496.0,5,783,1.0,515.0,515.0
0.005,17,2,169,1,62,0.0,34.0,34.0,1,107,0.0,79.0,79.0
0.061,17,2,80,1,32,0.0,4.0,4.0,1,48,0.0,20.0,20.0
0.005,17,2,166,1,75,0.0,47.0,47.0,1,91,0.0,63.0,63.0
40.055,17,10,676,5,460,10012.0,104.0,64.0,5,216,10012.0,20.0,15.0
308.203,17,20,1124,10,716,34229.0,48.0,43.0,10,408,34229.0,20.0,12.0
0.004,17,4,284,2,120,1.0,32.0,32.0,2,164,0.0,60.0,54.0
0.078,6,10,1506,5,395,16.0,127.0,127.0,5,1111,18.0,843.0,843.0
0.005,6,10,2000,5,927,1.0,659.0,659.0,5,1073,1.0,805.0,805.0
0.003,17,2,136,1,60,0.0,32.0,32.0,1,76,0.0,48.0,48.0
0.117,6,10,1506,5,395,26.0,127.0,127.0,5,1111,28.0,843.0,843.0
11.173,17,28,4423,14,1994,847.0,269.0,114.0,14,2429,847.0,588.0,145.0
0.01,6,10,1989,5,910,2.0,642.0,642.0,5,1079,2.0,811.0,811.0
0.01,6,13,3735,7,497,1.0,125.0,125.0,6,3238,2.0,1470.0,1459.0
0.125,17,4,352,2,130,0.0,37.0,37.0,2,222,87.0,89.0,83.0
0.004,17,2,136,1,60,0.0,32.0,32.0,1,76,0.0,48.0,48.0
0.081,6,10,1506,5,395,14.0,127.0,127.0,5,1111,18.0,843.0,843.0
0.005,6,10,1854,5,889,1.0,621.0,621.0,5,965,1.0,697.0,697.0
0.04,17,2,136,1,60,0.0,32.0,32.0,1,76,0.0,48.0,48.0
0.098,6,10,1506,5,395,22.0,127.0,127.0,5,1111,23.0,843.0,843.0
0.005,6,13,3690,7,452,0.0,80.0,80.0,6,3238,0.0,1470.0,1459.0
0.004,6,10,1774,5,923,1.0,655.0,655.0,5,851,1.0,583.0,583.0
0.009,6,10,1762,5,911,2.0,643.0,643.0,5,851,2.0,583.0,583.0
0.11,6,10,1506,5,395,20.0,127.0,127.0,5,1111,25.0,843.0,843.0
0.008,6,10,1989,5,910,2.0,642.0,642.0,5,1079,2.0,811.0,811.0
0.054,6,10,1506,5,395,11.0,127.0,127.0,5,1111,13.0,843.0,843.0
0.008,6,12,1926,6,1189,1.0,659.0,434.0,6,737,1.0,417.0,417.0
242.329,6,382,347594,185,21153,1317.0,2736.0,960.0,197,326441,1236.0,2804.0,1690.0
0.018,6,10,1762,5,911,4.0,643.0,643.0,5,851,4.0,583.0,583.0
0.096,6,10,1506,5,395,20.0,127.0,127.0,5,1111,21.0,843.0,843.0
0.082,6,10,1506,5,395,18.0,127.0,127.0,5,1111,16.0,843.0,843.0
0.005,6,10,1774,5,923,1.0,655.0,655.0,5,851,1.0,583.0,583.0
0.062,17,2,80,1,32,0.0,4.0,4.0,1,48,0.0,20.0,20.0
0.008,6,10,1989,5,910,1.0,642.0,642.0,5,1079,2.0,811.0,811.0
0.004,6,10,2000,5,927,1.0,659.0,659.0,5,1073,1.0,805.0,805.0
380.173,6,20,2210,6,1308,12004.0,494.0,494.0,14,902,29243.0,83.0,83.0
0.12,6,29,9094,15,6832,8.0,1944.0,671.0,14,2262,8.0,580.0,218.0
0.006,6,10,1547,5,764,1.0,496.0,496.0,5,783,1.0,515.0,515.0
0.01,6,10,1989,5,910,2.0,642.0,642.0,5,1079,2.0,811.0,811.0
0.006,6,10,1547,5,764,1.0,496.0,496.0,5,783,1.0,515.0,515.0
0.005,6,10,2007,5,928,1.0,660.0,660.0,5,1079,1.0,811.0,811.0
0.003,17,2,148,1,60,0.0,32.0,32.0,1,88,0.0,60.0,60.0
0.005,6,10,1774,5,923,1.0,655.0,655.0,5,851,1.0,583.0,583.0
0.005,6,10,1989,5,927,1.0,659.0,659.0,5,1062,1.0,794.0,794.0
0.005,6,10,2000,5,927,1.0,659.0,659.0,5,1073,1.0,805.0,805.0
0.007,6,10,1547,5,764,1.0,496.0,496.0,5,783,1.0,515.0,515.0
0.009,6,12,1926,6,1189,1.0,659.0,434.0,6,737,1.0,417.0,417.0
0.111,6,10,1506,5,395,27.0,127.0,127.0,5,1111,25.0,843.0,843.0
0.013,17,2,152,1,56,0.0,28.0,28.0,1,96,0.0,68.0,68.0
0.004,17,2,136,1,60,0.0,32.0,32.0,1,76,0.0,48.0,48.0
0.101,6,10,1506,5,395,23.0,127.0,127.0,5,1111,23.0,843.0,843.0
0.006,17,2,193,1,71,0.0,43.0,43.0,1,122,0.0,94.0,94.0
308.146,17,20,1124,10,716,34231.0,48.0,43.0,10,408,34231.0,20.0,12.0
0.088,6,10,1506,5,395,20.0,127.0,127.0,5,1111,20.0,843.0,843.0
0.009,6,10,1677,5,827,2.0,559.0,559.0,5,850,2.0,582.0,582.0
0.006,6,10,1547,5,764,1.0,496.0,496.0,5,783,1.0,515.0,515.0
0.005,17,2,170,1,65,0.0,37.0,37.0,1,105,0.0,77.0,77.0
0.088,6,10,1506,5,395,16.0,127.0,127.0,5,1111,20.0,843.0,843.0
312.177,17,20,1124,10,716,34672.0,48.0,43.0,10,408,34671.0,20.0,12.0
0.006,6,10,1547,5,764,1.0,496.0,496.0,5,783,1.0,515.0,515.0
0.019,6,10,1989,5,910,4.0,642.0,642.0,5,1079,4.0,811.0,811.0
0.087,6,10,1506,5,395,21.0,127.0,127.0,5,1111,19.0,843.0,843.0
0.116,6,10,1506,5,395,24.0,127.0,127.0,5,1111,24.0,843.0,843.0
0.019,6,10,1972,5,910,4.0,642.0,642.0,5,1062,4.0,794.0,794.0
0.009,6,10,1983,5,910,2.0,642.0,642.0,5,1073,2.0,805.0,805.0
0.014,6,10,1762,5,911,3.0,643.0,643.0,5,851,3.0,583.0,583.0
0.076,6,10,1506,5,395,17.0,127.0,127.0,5,1111,14.0,843.0,843.0
40.061,17,10,676,5,460,10014.0,104.0,64.0,5,216,10014.0,20.0,15.0
0.216,6,16,2669,8,1395,30.0,533.0,323.0,8,1274,19.0,529.0,212.0
40.09,17,10,676,5,460,10021.0,104.0,64.0,5,216,10021.0,20.0,15.0
0.012,6,10,2006,5,927,3.0,659.0,659.0,5,1079,2.0,811.0,811.0
0.006,6,10,1547,5,764,1.0,496.0,496.0,5,783,1.0,515.0,515.0
0.018,6,10,1989,5,910,4.0,642.0,642.0,5,1079,4.0,811.0,811.0
0.084,6,10,1506,5,395,18.0,127.0,127.0,5,1111,18.0,843.0,843.0
0.013,6,10,1972,5,910,3.0,642.0,642.0,5,1062,3.0,794.0,794.0
0.175,17,2,80,1,32,0.0,4.0,4.0,1,48,0.0,20.0,20.0
0.018,6,10,1631,5,848,4.0,580.0,580.0,5,783,4.0,515.0,515.0
316.986,17,18,1044,10,716,35204.0,48.0,43.0,8,328,45253.0,20.0,13.0
0.014,6,10,1983,5,910,3.0,642.0,642.0,5,1073,3.0,805.0,805.0
0.003,17,4,284,2,120,0.0,32.0,32.0,2,164,0.0,60.0,54.0
0.004,6,10,2000,5,927,1.0,659.0,659.0,5,1073,1.0,805.0,805.0
172.383,17,80,11364,40,2673,4419.0,44.0,38.0,40,8691,4420.0,239.0,189.0
0.089,6,10,1506,5,395,20.0,127.0,127.0,5,1111,18.0,843.0,843.0
0.004,6,10,2006,5,927,1.0,659.0,659.0,5,1079,1.0,811.0,811.0
240.132,6,23,7574,12,2777,21830.0,1368.0,536.0,11,4797,24012.0,1657.0,843.0
0.037,17,2,182,1,65,0.0,37.0,37.0,1,117,0.0,89.0,89.0
40.07,17,10,676,5,460,10014.0,104.0,64.0,5,216,10014.0,20.0,15.0
0.004,17,4,284,2,120,0.0,32.0,32.0,2,164,1.0,60.0,54.0
0.005,6,10,2000,5,927,1.0,659.0,659.0,5,1073,1.0,805.0,805.0
0.01,6,14,3787,7,497,1.0,125.0,125.0,7,3290,1.0,1448.0,972.0
0.077,6,10,1506,5,395,13.0,127.0,127.0,5,1111,18.0,843.0,843.0
369.68,6,22,2313,16,867,24645.0,195.0,195.0,6,1446,4640.0,419.0,398.0
0.037,17,2,136,1,60,0.0,32.0,32.0,1,76,0.0,48.0,48.0
0.006,6,10,1689,5,839,1.0,571.0,571.0,5,850,1.0,582.0,582.0
0.275,6,15,4846,9,1080,34.0,294.0,294.0,6,3766,53.0,3119.0,1717.0
40.053,17,10,676,5,460,10012.0,104.0,64.0,5,216,10011.0,20.0,15.0
0.231,6,16,2778,8,1396,33.0,533.0,324.0,8,1382,21.0,529.0,239.0
0.005,6,10,1989,5,927,1.0,659.0,659.0,5,1062,1.0,794.0,794.0
0.008,17,2,194,1,59,0.0,31.0,31.0,1,135,0.0,107.0,107.0
0.011,6,10,1983,5,910,2.0,642.0,642.0,5,1073,2.0,805.0,805.0
0.022,6,10,1972,5,910,5.0,642.0,642.0,5,1062,5.0,794.0,794.0
0.114,6,10,1506,5,395,21.0,127.0,127.0,5,1111,26.0,843.0,843.0
0.001,17,2,166,1,75,0.0,47.0,47.0,1,91,0.0,63.0,63.0
0.0,17,2,166,1,75,0.0,47.0,47.0,1,91,0.0,63.0,63.0
0.001,17,2,180,1,66,0.0,38.0,38.0,1,114,0.0,86.0,86.0
0.106,6,10,1506,5,395,25.0,127.0,127.0,5,1111,25.0,843.0,843.0
0.005,6,10,2006,5,927,1.0,659.0,659.0,5,1079,1.0,811.0,811.0
0.008,6,10,1990,5,911,2.0,643.0,643.0,5,1079,2.0,811.0,811.0
0.004,6,10,2006,5,927,1.0,659.0,659.0,5,1079,1.0,811.0,811.0
0.074,6,10,1506,5,395,16.0,127.0,127.0,5,1111,17.0,843.0,843.0
0.989,6,30,7808,18,2824,58.0,1360.0,412.0,12,4984,72.0,2745.0,561.0
0.002,17,2,180,1,66,0.0,38.0,38.0,1,114,0.0,86.0,86.0
0.012,6,10,1983,5,910,2.0,642.0,642.0,5,1073,2.0,805.0,805.0
0.004,6,10,2006,5,927,1.0,659.0,659.0,5,1079,1.0,811.0,811.0
0.005,6,10,1643,5,860,1.0,592.0,592.0,5,783,1.0,515.0,515.0
308.326,17,18,1008,9,640,38530.0,48.0,43.0,9,368,38528.0,20.0,12.0
0.079,6,10,1506,5,395,15.0,127.0,127.0,5,1111,18.0,843.0,843.0
300.361,6,16,2170,9,684,37523.0,146.0,146.0,7,1486,50031.0,419.0,398.0
0.007,6,10,1547,5,764,1.0,496.0,496.0,5,783,1.0,515.0,515.0
0.021,6,10,1983,5,910,5.0,642.0,642.0,5,1073,5.0,805.0,805.0
0.011,6,10,1989,5,910,2.0,642.0,642.0,5,1079,2.0,811.0,811.0
0.004,6,10,1702,5,863,1.0,595.0,595.0,5,839,0.0,571.0,571.0
0.11,6,10,1506,5,395,25.0,127.0,127.0,5,1111,24.0,843.0,843.0
308.214,17,18,1044,10,716,34246.0,48.0,43.0,8,328,37734.0,20.0,13.0
40.071,17,10,676,5,460,10017.0,104.0,64.0,5,216,10017.0,20.0,15.0
0.005,17,2,166,1,75,0.0,47.0,47.0,1,91,0.0,63.0,63.0
308.555,17,20,1124,10,716,34267.0,48.0,43.0,10,408,34266.0,20.0,12.0
0.04,17,2,144,1,64,0.0,36.0,36.0,1,80,0.0,52.0,52.0
0.037,17,2,148,1,60,0.0,32.0,32.0,1,88,0.0,60.0,60.0
0.005,6,10,2000,5,927,1.0,659.0,659.0,5,1073,1.0,805.0,805.0
0.011,6,10,1983,5,910,2.0,642.0,642.0,5,1073,2.0,805.0,805.0
1770.649,17,120,11460,60,5460,30010.0,63.0,63.0,60,6000,30010.0,72.0,72.0
0.003,17,2,136,1,60,0.0,32.0,32.0,1,76,0.0,48.0,48.0
0.003,17,2,136,1,60,0.0,32.0,32.0,1,76,0.0,48.0,48.0
0.023,6,10,1990,5,911,5.0,643.0,643.0,5,1079,5.0,811.0,811.0
0.073,6,10,1506,5,395,17.0,127.0,127.0,5,1111,13.0,843.0,843.0
0.005,6,10,1689,5,839,1.0,571.0,571.0,5,850,1.0,582.0,582.0
0.006,6,10,1689,5,839,1.0,571.0,571.0,5,850,1.0,582.0,582.0
0.017,6,10,1989,5,910,4.0,642.0,642.0,5,1079,4.0,811.0,811.0
126.066,6,14,2938,8,2504,17976.0,1414.0,1086.0,6,434,25166.0,182.0,182.0
0.004,6,10,2000,5,927,1.0,659.0,659.0,5,1073,1.0,805.0,805.0
0.015,6,10,1972,5,910,3.0,642.0,642.0,5,1062,3.0,794.0,794.0
0.115,6,10,1506,5,395,26.0,127.0,127.0,5,1111,26.0,843.0,843.0
0.008,17,2,222,1,65,0.0,37.0,37.0,1,157,0.0,129.0,129.0
0.072,6,10,1506,5,395,17.0,127.0,127.0,5,1111,16.0,843.0,843.0
0.013,6,10,1989,5,910,3.0,642.0,642.0,5,1079,3.0,811.0,811.0
10.876,17,28,4422,14,1994,828.0,269.0,114.0,14,2428,828.0,587.0,145.0
0.012,6,10,1972,5,910,3.0,642.0,642.0,5,1062,2.0,794.0,794.0
40.068,17,10,676,5,460,10016.0,104.0,64.0,5,216,10016.0,20.0,15.0
178.421,17,86,12397,43,2888,4248.0,44.0,39.0,43,9509,4248.0,239.0,193.0
0.071,6,10,1506,5,395,15.0,127.0,127.0,5,1111,15.0,843.0,843.0
0.492,17,44,21917,25,18580,20.0,1350.0,715.0,19,3337,21.0,1350.0,147.0
0.005,6,10,1779,5,928,1.0,660.0,660.0,5,851,1.0,583.0,583.0
0.014,6,10,1990,5,911,3.0,643.0,643.0,5,1079,3.0,811.0,811.0
0.099,6,10,1506,5,395,20.0,127.0,127.0,5,1111,22.0,843.0,843.0
0.077,6,10,1506,5,395,18.0,127.0,127.0,5,1111,15.0,843.0,843.0
0.012,6,10,1983,5,910,3.0,642.0,642.0,5,1073,2.0,805.0,805.0
0.006,17,2,170,1,65,0.0,37.0,37.0,1,105,0.0,77.0,77.0
0.004,6,10,2006,5,927,1.0,659.0,659.0,5,1079,1.0,811.0,811.0
156.27,6,26,9525,12,1627,75.0,794.0,367.0,14,7898,12010.0,1360.0,732.0
0.078,6,10,1506,5,395,17.0,127.0,127.0,5,1111,16.0,843.0,843.0
301.202,6,57,27179,31,21067,10040.0,2720.0,1521.0,26,6112,361.0,2667.0,361.0
0.007,17,2,194,1,59,0.0,31.0,31.0,1,135,0.0,107.0,107.0
0.011,6,10,1989,5,910,2.0,642.0,642.0,5,1079,2.0,811.0,811.0
0.168,17,2,152,1,76,0.0,48.0,48.0,1,76,0.0,48.0,48.0
0.021,6,13,3913,7,495,3.0,123.0,123.0,6,3418,4.0,1650.0,1549.0
0.174,17,2,152,1,76,0.0,48.0,48.0,1,76,0.0,48.0,48.0
0.006,6,10,1547,5,764,1.0,496.0,496.0,5,783,1.0,515.0,515.0
0.016,6,10,1972,5,910,4.0,642.0,642.0,5,1062,4.0,794.0,794.0
0.009,6,10,1989,5,910,2.0,642.0,642.0,5,1079,2.0,811.0,811.0
240.024,6,9,787,5,488,60006.0,232.0,232.0,4,299,80007.0,83.0,83.0
0.007,6,12,1698,6,863,1.0,327.0,271.0,6,835,1.0,515.0,515.0
0.139,6,10,1506,5,395,33.0,127.0,127.0,5,1111,30.0,843.0,843.0
0.01,6,10,1983,5,910,2.0,642.0,642.0,5,1073,2.0,805.0,805.0
0.004,6,10,1989,5,927,1.0,659.0,659.0,5,1062,1.0,794.0,794.0
0.005,17,2,170,1,65,0.0,37.0,37.0,1,105,0.0,77.0,77.0
0.004,6,10,2006,5,927,1.0,659.0,659.0,5,1079,1.0,811.0,811.0
0.005,6,10,2006,5,927,1.0,659.0,659.0,5,1079,1.0,811.0,811.0
0.007,6,10,1990,5,911,1.0,643.0,643.0,5,1079,1.0,811.0,811.0
40.058,17,10,676,5,460,10013.0,104.0,64.0,5,216,10013.0,20.0,15.0
0.106,6,10,1506,5,395,24.0,127.0,127.0,5,1111,25.0,843.0,843.0
0.125,6,10,1506,5,395,29.0,127.0,127.0,5,1111,28.0,843.0,843.0
0.012,6,10,1989,5,910,3.0,642.0,642.0,5,1079,2.0,811.0,811.0
0.127,17,2,182,1,65,0.0,37.0,37.0,1,117,0.0,89.0,89.0
0.108,6,10,1506,5,395,25.0,127.0,127.0,5,1111,24.0,843.0,843.0
29.858,6,27,11188,15,1838,2132.0,506.0,350.0,12,9350,2713.0,2804.0,1089.0
0.162,17,2,152,1,76,0.0,48.0,48.0,1,76,0.0,48.0,48.0
0.005,6,10,2007,5,928,1.0,660.0,660.0,5,1079,1.0,811.0,811.0
0.073,6,10,1506,5,395,16.0,127.0,127.0,5,1111,13.0,843.0,843.0
0.012,6,10,1989,5,910,2.0,642.0,642.0,5,1079,3.0,811.0,811.0
0.141,6,10,1506,5,395,34.0,127.0,127.0,5,1111,32.0,843.0,843.0
240.093,6,16,4481,9,963,30011.0,238.0,166.0,7,3518,40014.0,1402.0,786.0
174.287,17,102,14871,51,3433,3485.0,44.0,39.0,51,11438,3485.0,239.0,196.0
0.012,6,10,1983,5,910,3.0,642.0,642.0,5,1073,2.0,805.0,805.0
0.009,6,10,1989,5,910,2.0,642.0,642.0,5,1079,2.0,811.0,811.0
0.004,6,10,1779,5,928,1.0,660.0,660.0,5,851,1.0,583.0,583.0
300.155,6,39,10113,21,4595,14999.0,1360.0,620.0,18,5518,17646.0,2667.0,435.0
0.04,17,2,170,1,65,0.0,37.0,37.0,1,105,0.0,77.0,77.0
240.119,6,32,9520,16,7030,16007.0,2101.0,689.0,16,2490,16007.0,580.0,206.0
0.006,6,10,1689,5,839,1.0,571.0,571.0,5,850,1.0,582.0,582.0
0.005,17,2,230,1,68,0.0,40.0,40.0,1,162,0.0,134.0,134.0
15.086,17,16,8694,8,6426,2151.0,1350.0,775.0,8,2268,2150.0,1350.0,255.0
0.005,17,2,214,1,75,0.0,47.0,47.0,1,139,0.0,111.0,111.0
0.005,17,2,164,1,74,0.0,46.0,46.0,1,90,0.0,62.0,62.0
0.1,6,10,1506,5,395,21.0,127.0,127.0,5,1111,24.0,843.0,843.0
1775.205,6,64,7361,42,4485,43297.0,1641.0,109.0,22,2876,84525.0,1112.0,82.0
0.041,17,2,144,1,64,0.0,36.0,36.0,1,80,0.0,52.0,52.0
0.014,6,10,1972,5,910,3.0,642.0,642.0,5,1062,3.0,794.0,794.0
0.006,6,10,1854,5,889,1.0,621.0,621.0,5,965,1.0,697.0,697.0
0.001,17,2,180,1,66,0.0,38.0,38.0,1,114,0.0,86.0,86.0
0.121,6,10,1506,5,395,25.0,127.0,127.0,5,1111,26.0,843.0,843.0
174.312,17,96,13916,48,3208,3708.0,44.0,38.0,48,10708,3708.0,239.0,195.0
10.876,17,28,4421,14,1993,828.0,268.0,114.0,14,2428,828.0,587.0,145.0
0.008,6,12,1926,6,1189,1.0,659.0,434.0,6,737,1.0,417.0,417.0
0.106,6,10,1506,5,395,21.0,127.0,127.0,5,1111,23.0,843.0,843.0
0.01,6,10,1990,5,911,2.0,643.0,643.0,5,1079,2.0,811.0,811.0
0.005,17,2,140,1,62,0.0,34.0,34.0,1,78,0.0,50.0,50.0
0.005,6,10,1989,5,927,1.0,659.0,659.0,5,1062,1.0,794.0,794.0
0.096,6,10,1506,5,395,21.0,127.0,127.0,5,1111,20.0,843.0,843.0
300.367,6,16,2170,9,684,37524.0,146.0,146.0,7,1486,50032.0,419.0,398.0
0.21,6,10,1506,5,395,50.0,127.0,127.0,5,1111,44.0,843.0,843.0
0.003,17,2,136,1,60,0.0,32.0,32.0,1,76,0.0,48.0,48.0
0.009,6,10,1677,5,827,2.0,559.0,559.0,5,850,2.0,582.0,582.0
0.071,17,2,148,1,60,0.0,32.0,32.0,1,88,0.0,60.0,60.0
0.018,6,10,1989,5,910,4.0,642.0,642.0,5,1079,4.0,811.0,811.0
0.006,17,2,230,1,68,0.0,40.0,40.0,1,162,0.0,134.0,134.0
0.006,6,10,1547,5,764,1.0,496.0,496.0,5,783,1.0,515.0,515.0
40.084,17,10,676,5,460,10020.0,104.0,64.0,5,216,10020.0,20.0,15.0
0.006,6,10,1689,5,839,1.0,571.0,571.0,5,850,1.0,582.0,582.0
0.003,17,2,136,1,60,0.0,32.0,32.0,1,76,0.0,48.0,48.0
170.095,17,78,11087,39,2609,4476.0,44.0,38.0,39,8478,4476.0,261.0,189.0
1755.906,6,105,6270,60,3525,29760.0,27.0,27.0,45,2745,39906.0,27.0,27.0
0.004,17,2,148,1,60,0.0,32.0,32.0,1,88,0.0,60.0,60.0
0.013,6,10,1990,5,911,3.0,643.0,643.0,5,1079,3.0,811.0,811.0
10.902,17,28,4417,14,1994,829.0,269.0,114.0,14,2423,829.0,586.0,145.0
0.013,6,13,3735,7,497,2.0,125.0,125.0,6,3238,2.0,1470.0,1459.0
0.096,6,10,1506,5,395,19.0,127.0,127.0,5,1111,18.0,843.0,843.0
0.1,6,10,1506,5,395,23.0,127.0,127.0,5,1111,22.0,843.0,843.0
240.028,6,9,787,5,488,60007.0,232.0,232.0,4,299,80008.0,83.0,83.0
0.062,6,10,1506,5,395,13.0,127.0,127.0,5,1111,13.0,843.0,843.0
0.121,6,10,1506,5,395,24.0,127.0,127.0,5,1111,27.0,843.0,843.0
361.792,6,21,1793,16,1030,24119.0,190.0,190.0,5,763,60010.0,462.0,247.0
0.117,6,10,1506,5,395,26.0,127.0,127.0,5,1111,26.0,843.0,843.0
0.062,6,10,1506,5,395,13.0,127.0,127.0,5,1111,14.0,843.0,843.0
0.008,6,10,1677,5,827,2.0,559.0,559.0,5,850,2.0,582.0,582.0
10.707,17,28,4421,14,1994,815.0,269.0,114.0,14,2427,815.0,586.0,145.0
0.009,17,2,136,1,60,0.0,32.0,32.0,1,76,0.0,48.0,48.0
15.07,17,15,9238,8,6902,2148.0,1350.0,834.0,7,2336,2506.0,1350.0,305.0
0.022,6,10,1983,5,910,5.0,642.0,642.0,5,1073,5.0,805.0,805.0
0.005,6,10,1702,5,863,1.0,595.0,595.0,5,839,1.0,571.0,571.0
0.005,6,10,2006,5,927,1.0,659.0,659.0,5,1079,1.0,811.0,811.0
0.068,17,8,3613,4,1874,22.0,1350.0,440.0,4,1739,11.0,1350.0,406.0
0.09,6,10,1506,5,395,20.0,127.0,127.0,5,1111,20.0,843.0,843.0
0.006,6,10,2007,5,928,1.0,660.0,660.0,5,1079,1.0,811.0,811.0
0.005,6,10,2006,5,927,1.0,659.0,659.0,5,1079,1.0,811.0,811.0
0.012,6,10,1677,5,827,3.0,559.0,559.0,5,850,3.0,582.0,582.0
0.009,6,10,1989,5,910,2.0,642.0,642.0,5,1079,2.0,811.0,811.0
0.003,17,4,284,2,120,0.0,32.0,32.0,2,164,1.0,60.0,54.0
0.041,17,2,152,1,76,0.0,48.0,48.0,1,76,0.0,48.0,48.0
240.25,6,40,5296,20,2437,12644.0,588.0,196.0,20,2859,12644.0,580.0,258.0
15.218,17,18,9094,9,6882,1898.0,1350.0,736.0,9,2212,1898.0,1350.0,217.0
0.005,6,10,1774,5,923,1.0,655.0,655.0,5,851,1.0,583.0,583.0
300.324,6,16,2170,9,684,37520.0,146.0,146.0,7,1486,50026.0,419.0,398.0
0.006,6,10,1643,5,860,1.0,592.0,592.0,5,783,1.0,515.0,515.0
0.012,6,10,1989,5,910,2.0,642.0,642.0,5,1079,2.0,811.0,811.0
365.761,6,22,2264,16,818,24384.0,146.0,146.0,6,1446,4637.0,419.0,398.0
0.073,17,4,352,2,130,0.0,37.0,37.0,2,222,33.0,89.0,83.0
300.422,6,16,2170,9,684,37531.0,146.0,146.0,7,1486,50042.0,419.0,398.0
15.078,17,15,8318,8,6299,2150.0,1350.0,759.0,7,2019,2508.0,1350.0,260.0
0.09,6,10,1506,5,395,18.0,127.0,127.0,5,1111,20.0,843.0,843.0
0.097,6,10,1506,5,395,23.0,127.0,127.0,5,1111,21.0,843.0,843.0
0.004,6,10,1702,5,863,0.0,595.0,595.0,5,839,1.0,571.0,571.0
0.004,17,2,136,1,60,0.0,32.0,32.0,1,76,0.0,48.0,48.0
0.003,17,2,148,1,60,0.0,32.0,32.0,1,88,0.0,60.0,60.0
0.093,6,10,1506,5,395,14.0,127.0,127.0,5,1111,21.0,843.0,843.0
0.096,6,10,1506,5,395,23.0,127.0,127.0,5,1111,23.0,843.0,843.0
0.006,6,10,2006,5,927,1.0,659.0,659.0,5,1079,1.0,811.0,811.0
0.07,17,8,3613,4,1874,23.0,1350.0,440.0,4,1739,11.0,1350.0,406.0
0.007,6,10,1547,5,764,1.0,496.0,496.0,5,783,1.0,515.0,515.0
0.005,6,10,2006,5,927,1.0,659.0,659.0,5,1079,1.0,811.0,811.0
0.01,6,10,1972,5,910,2.0,642.0,642.0,5,1062,2.0,794.0,794.0
0.028,6,10,1990,5,911,7.0,643.0,643.0,5,1079,6.0,811.0,811.0
0.008,6,12,1926,6,1189,1.0,659.0,434.0,6,737,1.0,417.0,417.0
163.375,17,76,10689,38,2536,4415.0,44.0,38.0,38,8153,4415.0,239.0,186.0
0.008,6,10,1989,5,910,1.0,642.0,642.0,5,1079,2.0,811.0,811.0
0.017,6,10,1990,5,911,4.0,643.0,643.0,5,1079,4.0,811.0,811.0
0.001,17,2,180,1,66,0.0,38.0,38.0,1,114,0.0,86.0,86.0
0.111,6,10,1506,5,395,22.0,127.0,127.0,5,1111,25.0,843.0,843.0
0.005,6,10,1989,5,927,1.0,659.0,659.0,5,1062,1.0,794.0,794.0
0.005,6,10,2007,5,928,1.0,660.0,660.0,5,1079,1.0,811.0,811.0
0.012,6,10,1990,5,911,3.0,643.0,643.0,5,1079,2.0,811.0,811.0
0.149,6,10,1506,5,395,28.0,127.0,127.0,5,1111,35.0,843.0,843.0
0.005,6,10,1643,5,860,1.0,592.0,592.0,5,783,1.0,515.0,515.0
0.005,17,2,214,1,75,0.0,47.0,47.0,1,139,0.0,111.0,111.0
0.081,6,10,1506,5,395,17.0,127.0,127.0,5,1111,19.0,843.0,843.0
0.089,6,10,1506,5,395,20.0,127.0,127.0,5,1111,17.0,843.0,843.0
0.086,6,10,1506,5,395,19.0,127.0,127.0,5,1111,17.0,843.0,843.0
0.105,6,10,1506,5,395,17.0,127.0,127.0,5,1111,23.0,843.0,843.0
10.884,17,28,4421,14,1994,828.0,269.0,114.0,14,2427,828.0,586.0,145.0
0.114,6,10,1506,5,395,23.0,127.0,127.0,5,1111,23.0,843.0,843.0
0.013,6,13,3735,7,497,2.0,125.0,125.0,6,3238,2.0,1470.0,1459.0
0.095,6,10,1506,5,395,20.0,127.0,127.0,5,1111,19.0,843.0,843.0
40.055,17,10,676,5,460,10011.0,104.0,64.0,5,216,10013.0,20.0,15.0
0.009,17,2,209,1,64,0.0,36.0,36.0,1,145,0.0,117.0,117.0
40.053,17,10,676,5,460,10011.0,104.0,64.0,5,216,10012.0,20.0,15.0
0.016,6,10,1990,5,911,4.0,643.0,643.0,5,1079,3.0,811.0,811.0
0.019,6,10,1990,5,911,4.0,643.0,643.0,5,1079,4.0,811.0,811.0
11.501,17,28,4398,14,2313,872.0,588.0,137.0,14,2085,872.0,268.0,120.0
0.099,6,10,1506,5,395,19.0,127.0,127.0,5,1111,22.0,843.0,843.0
0.009,6,12,1926,6,1189,1.0,659.0,434.0,6,737,1.0,417.0,417.0
0.014,6,10,1989,5,910,3.0,642.0,642.0,5,1079,3.0,811.0,811.0
0.031,6,10,1972,5,910,7.0,642.0,642.0,5,1062,7.0,794.0,794.0
0.118,6,10,1506,5,395,25.0,127.0,127.0,5,1111,27.0,843.0,843.0
0.004,17,2,148,1,60,0.0,32.0,32.0,1,88,0.0,60.0,60.0
0.005,6,10,1702,5,863,1.0,595.0,595.0,5,839,1.0,571.0,571.0
0.009,17,2,164,1,74,0.0,46.0,46.0,1,90,0.0,62.0,62.0
0.004,17,2,136,1,60,0.0,32.0,32.0,1,76,0.0,48.0,48.0
0.005,6,10,1854,5,889,1.0,621.0,621.0,5,965,1.0,697.0,697.0
0.005,6,10,2000,5,927,1.0,659.0,659.0,5,1073,1.0,805.0,805.0
10.867,17,28,4418,14,1994,827.0,269.0,114.0,14,2424,827.0,587.0,145.0
0.001,17,2,294,1,64,0.0,36.0,36.0,1,230,0.0,202.0,202.0
0.091,6,10,1506,5,395,20.0,127.0,127.0,5,1111,17.0,843.0,843.0
0.074,6,10,1506,5,395,17.0,127.0,127.0,5,1111,14.0,843.0,843.0
308.812,17,20,1124,10,716,34298.0,48.0,43.0,10,408,34298.0,20.0,12.0
0.007,6,12,1698,6,863,1.0,327.0,271.0,6,835,1.0,515.0,515.0
1786.59,6,154,19574,92,13852,19632.0,302.0,302.0,62,5722,29288.0,83.0,83.0
308.438,17,20,1124,10,716,34264.0,48.0,43.0,10,408,34260.0,20.0,12.0
308.635,17,20,1124,10,716,34279.0,48.0,43.0,10,408,34278.0,20.0,12.0
0.013,6,13,3735,7,497,2.0,125.0,125.0,6,3238,2.0,1470.0,1459.0
0.015,6,13,3735,7,497,2.0,125.0,125.0,6,3238,2.0,1470.0,1459.0
0.01,6,10,1989,5,910,2.0,642.0,642.0,5,1079,2.0,811.0,811.0
0.073,6,10,1506,5,395,16.0,127.0,127.0,5,1111,16.0,843.0,843.0
0.219,6,16,2777,8,1395,31.0,533.0,323.0,8,1382,20.0,529.0,239.0
0.167,17,2,152,1,76,0.0,48.0,48.0,1,76,0.0,48.0,48.0
0.005,6,10,2007,5,928,1.0,660.0,660.0,5,1079,1.0,811.0,811.0
0.004,6,10,1989,5,927,1.0,659.0,659.0,5,1062,1.0,794.0,794.0
0.172,17,2,152,1,76,0.0,48.0,48.0,1,76,0.0,48.0,48.0
0.012,6,10,1989,5,910,2.0,642.0,642.0,5,1079,3.0,811.0,811.0
0.005,6,10,1689,5,839,1.0,571.0,571.0,5,850,1.0,582.0,582.0
0.044,17,2,148,1,60,0.0,32.0,32.0,1,88,0.0,60.0,60.0
1772.0,6,105,6270,60,3525,30033.0,27.0,27.0,45,2745,40271.0,27.0,27.0
0.006,6,10,2007,5,928,1.0,660.0,660.0,5,1079,1.0,811.0,811.0
0.015,6,10,1989,5,910,3.0,642.0,642.0,5,1079,3.0,811.0,811.0
0.005,6,13,3747,7,509,0.0,137.0,137.0,6,3238,1.0,1470.0,1459.0
0.011,6,10,1990,5,911,2.0,643.0,643.0,5,1079,2.0,811.0,811.0
40.047,17,10,676,5,460,10009.0,104.0,64.0,5,216,10011.0,20.0,15.0
40.057,17,10,676,5,460,10013.0,104.0,64.0,5,216,10013.0,20.0,15.0
0.009,6,10,1762,5,911,2.0,643.0,643.0,5,851,2.0,583.0,583.0
0.005,17,2,170,1,65,0.0,37.0,37.0,1,105,0.0,77.0,77.0
0.005,6,10,2006,5,927,1.0,659.0,659.0,5,1079,1.0,811.0,811.0
0.013,6,10,1762,5,911,3.0,643.0,643.0,5,851,3.0,583.0,583.0
1800.0,6,228,20620,87,11758,20930.0,1938.0,111.0,141,8862,12856.0,148.0,47.0
0.11,6,10,1506,5,395,25.0,127.0,127.0,5,1111,26.0,843.0,843.0
0.118,6,10,1506,5,395,22.0,127.0,127.0,5,1111,20.0,843.0,843.0
0.012,6,10,1990,5,911,3.0,643.0,643.0,5,1079,2.0,811.0,811.0
0.01,6,10,1972,5,910,2.0,642.0,642.0,5,1062,2.0,794.0,794.0
0.016,6,10,1990,5,911,4.0,643.0,643.0,5,1079,4.0,811.0,811.0
0.004,6,10,2007,5,928,1.0,660.0,660.0,5,1079,1.0,811.0,811.0
0.039,17,2,148,1,60,0.0,32.0,32.0,1,88,0.0,60.0,60.0
0.098,6,10,1506,5,395,21.0,127.0,127.0,5,1111,19.0,843.0,843.0
0.006,6,10,1643,5,860,1.0,592.0,592.0,5,783,1.0,515.0,515.0
0.007,17,2,179,1,71,0.0,43.0,43.0,1,108,0.0,80.0,80.0
0.074,6,10,1506,5,395,17.0,127.0,127.0,5,1111,17.0,843.0,843.0
0.084,6,10,1506,5,395,17.0,127.0,127.0,5,1111,18.0,843.0,843.0
0.011,6,10,1990,5,911,2.0,643.0,643.0,5,1079,2.0,811.0,811.0
177.321,17,80,11290,40,2675,4546.0,44.0,38.0,40,8615,4546.0,239.0,187.0
0.004,6,10,2000,5,927,1.0,659.0,659.0,5,1073,1.0,805.0,805.0
0.013,6,14,3787,7,497,2.0,125.0,125.0,7,3290,2.0,1448.0,972.0
40.053,17,10,676,5,460,10011.0,104.0,64.0,5,216,10012.0,20.0,15.0
0.014,6,10,1762,5,911,3.0,643.0,643.0,5,851,3.0,583.0,583.0
0.006,6,10,1547,5,764,1.0,496.0,496.0,5,783,1.0,515.0,515.0
40.055,17,10,676,5,460,10012.0,104.0,64.0,5,216,10012.0,20.0,15.0
0.005,6,13,3747,7,509,0.0,137.0,137.0,6,3238,0.0,1470.0,1459.0
368.559,6,22,2313,16,867,24570.0,195.0,195.0,6,1446,4634.0,419.0,398.0
0.005,6,10,1689,5,839,1.0,571.0,571.0,5,850,1.0,582.0,582.0
0.004,6,10,2007,5,928,1.0,660.0,660.0,5,1079,1.0,811.0,811.0
0.004,6,10,1989,5,927,1.0,659.0,659.0,5,1062,1.0,794.0,794.0
0.041,17,4,284,2,120,0.0,32.0,32.0,2,164,0.0,60.0,54.0
0.077,6,10,1506,5,395,17.0,127.0,127.0,5,1111,16.0,843.0,843.0
0.01,6,10,1631,5,848,2.0,580.0,580.0,5,783,2.0,515.0,515.0
240.261,6,43,5390,22,2554,11440.0,588.0,196.0,21,2836,12012.0,580.0,217.0
0.084,6,10,1506,5,395,18.0,127.0,127.0,5,1111,17.0,843.0,843.0
1778.633,17,144,45504,72,22752,25051.0,288.0,288.0,72,22752,25051.0,288.0,288.0
0.092,6,10,1506,5,395,21.0,127.0,127.0,5,1111,21.0,843.0,843.0
0.089,6,10,1506,5,395,18.0,127.0,127.0,5,1111,18.0,843.0,843.0
0.003,17,2,136,1,60,0.0,32.0,32.0,1,76,0.0,48.0,48.0
0.004,6,10,2007,5,928,1.0,660.0,660.0,5,1079,1.0,811.0,811.0
0.01,6,10,1989,5,910,2.0,642.0,642.0,5,1079,2.0,811.0,811.0
0.005,17,4,495,2,132,0.0,38.0,38.0,2,363,2.0,176.0,153.0
0.106,6,10,1506,5,395,20.0,127.0,127.0,5,1111,25.0,843.0,843.0
0.043,17,2,152,1,76,0.0,48.0,48.0,1,76,0.0,48.0,48.0
0.014,6,14,3787,7,497,2.0,125.0,125.0,7,3290,2.0,1448.0,972.0
0.013,6,20,9974,11,704,1.0,124.0,124.0,9,9270,1.0,2896.0,1758.0
0.005,6,10,1689,5,839,1.0,571.0,571.0,5,850,1.0,582.0,582.0
240.307,6,43,8771,22,5738,11443.0,2883.0,573.0,21,3033,12015.0,580.0,241.0
0.014,6,13,3735,7,497,2.0,125.0,125.0,6,3238,2.0,1470.0,1459.0
0.085,6,10,1506,5,395,17.0,127.0,127.0,5,1111,17.0,843.0,843.0
0.014,6,10,1989,5,910,3.0,642.0,642.0,5,1079,3.0,811.0,811.0
0.004,6,10,2007,5,928,1.0,660.0,660.0,5,1079,1.0,811.0,811.0
0.151,6,10,1506,5,395,35.0,127.0,127.0,5,1111,34.0,843.0,843.0
0.067,6,10,1506,5,395,15.0,127.0,127.0,5,1111,15.0,843.0,843.0
0.063,6,10,1762,5,911,15.0,643.0,643.0,5,851,15.0,583.0,583.0
0.062,6,10,1506,5,395,13.0,127.0,127.0,5,1111,14.0,843.0,843.0
0.008,6,10,1989,5,910,1.0,642.0,642.0,5,1079,2.0,811.0,811.0
0.04,17,2,148,1,60,0.0,32.0,32.0,1,88,0.0,60.0,60.0
0.005,17,2,179,1,71,0.0,43.0,43.0,1,108,0.0,80.0,80.0
40.066,17,10,676,5,460,10013.0,104.0,64.0,5,216,10015.0,20.0,15.0
0.011,6,10,1972,5,910,2.0,642.0,642.0,5,1062,2.0,794.0,794.0
1787.568,6,154,19574,92,13852,19643.0,302.0,302.0,62,5722,29304.0,83.0,83.0
0.005,6,10,2007,5,928,1.0,660.0,660.0,5,1079,1.0,811.0,811.0
0.149,6,10,1506,5,395,34.0,127.0,127.0,5,1111,34.0,843.0,843.0
0.005,6,10,2000,5,927,1.0,659.0,659.0,5,1073,1.0,805.0,805.0
0.016,6,10,1989,5,910,3.0,642.0,642.0,5,1079,3.0,811.0,811.0
0.005,6,10,1547,5,764,1.0,496.0,496.0,5,783,1.0,515.0,515.0
0.001,17,2,166,1,75,0.0,47.0,47.0,1,91,0.0,63.0,63.0
0.005,17,2,170,1,65,0.0,37.0,37.0,1,105,0.0,77.0,77.0
0.004,6,10,2007,5,928,1.0,660.0,660.0,5,1079,1.0,811.0,811.0
335.704,17,18,1008,9,640,41946.0,48.0,43.0,9,368,41946.0,20.0,12.0
0.005,6,10,2007,5,928,1.0,660.0,660.0,5,1079,1.0,811.0,811.0
354.049,6,21,1795,16,1030,23603.0,190.0,190.0,5,765,60001.0,464.0,248.0
0.011,6,10,1972,5,910,2.0,642.0,642.0,5,1062,2.0,794.0,794.0
0.012,6,10,1989,5,910,3.0,642.0,642.0,5,1079,3.0,811.0,811.0
0.004,6,10,1774,5,923,1.0,655.0,655.0,5,851,1.0,583.0,583.0
0.01,6,10,1631,5,848,2.0,580.0,580.0,5,783,2.0,515.0,515.0
0.004,17,2,148,1,60,0.0,32.0,32.0,1,88,0.0,60.0,60.0
0.005,6,14,3799,7,509,0.0,137.0,137.0,7,3290,0.0,1448.0,972.0
0.06,6,27,10117,14,8890,4.0,2883.0,1166.0,13,1227,4.0,197.0,91.0
0.007,6,10,1989,5,910,1.0,642.0,642.0,5,1079,1.0,811.0,811.0
0.123,6,10,1506,5,395,26.0,127.0,127.0,5,1111,28.0,843.0,843.0
0.091,6,10,1506,5,395,20.0,127.0,127.0,5,1111,20.0,843.0,843.0
0.271,17,39,20229,21,17036,13.0,1350.0,783.0,18,3193,12.0,1350.0,149.0
0.005,6,10,2007,5,928,1.0,660.0,660.0,5,1079,1.0,811.0,811.0
0.009,6,10,1990,5,911,2.0,643.0,643.0,5,1079,2.0,811.0,811.0
0.003,6,10,1702,5,863,0.0,595.0,595.0,5,839,0.0,571.0,571.0
169.409,17,76,10530,38,2519,4578.0,44.0,38.0,38,8011,4578.0,239.0,182.0
1798.972,17,2813,214999,1395,113132,1290.0,84.0,53.0,1418,101867,1269.0,227.0,43.0
0.013,6,10,1990,5,911,3.0,643.0,643.0,5,1079,3.0,811.0,811.0
11.176,17,28,4422,14,1994,847.0,269.0,114.0,14,2428,846.0,587.0,145.0
0.014,6,10,1677,5,827,3.0,559.0,559.0,5,850,3.0,582.0,582.0
0.042,17,4,284,2,120,0.0,32.0,32.0,2,164,38.0,60.0,54.0
0.006,6,10,1547,5,764,1.0,496.0,496.0,5,783,1.0,515.0,515.0
0.005,17,2,170,1,65,0.0,37.0,37.0,1,105,0.0,77.0,77.0
354.58,6,20,2210,6,1308,12006.0,494.0,494.0,14,902,27274.0,83.0,83.0
323.315,17,20,1124,10,716,35911.0,48.0,43.0,10,408,35910.0,20.0,12.0
0.005,6,10,1779,5,928,1.0,660.0,660.0,5,851,1.0,583.0,583.0
0.091,6,10,1506,5,395,21.0,127.0,127.0,5,1111,17.0,843.0,843.0
0.005,17,2,231,1,68,0.0,40.0,40.0,1,163,0.0,135.0,135.0
0.001,17,2,192,1,71,0.0,43.0,43.0,1,121,0.0,93.0,93.0
0.013,17,2,152,1,56,0.0,28.0,28.0,1,96,0.0,68.0,68.0
369.102,6,47,19498,25,3711,15379.0,676.0,400.0,22,15787,14717.0,1402.0,975.0
0.005,6,10,2006,5,927,1.0,659.0,659.0,5,1079,1.0,811.0,811.0
1.034,6,13,3922,7,2139,129.0,1328.0,923.0,6,1783,155.0,1539.0,1539.0
0.006,6,10,1689,5,839,1.0,571.0,571.0,5,850,1.0,582.0,582.0
0.016,6,10,1989,5,910,4.0,642.0,642.0,5,1079,3.0,811.0,811.0
294.523,6,399,349060,193,21604,1533.0,2736.0,825.0,206,327456,1436.0,3364.0,1649.0
0.001,17,2,180,1,66,0.0,38.0,38.0,1,114,0.0,86.0,86.0
0.004,6,10,1702,5,863,1.0,595.0,595.0,5,839,1.0,571.0,571.0
0.004,6,10,2007,5,928,1.0,660.0,660.0,5,1079,1.0,811.0,811.0
240.736,6,39,9796,20,2223,12668.0,743.0,235.0,19,7573,13372.0,1402.0,549.0
0.011,6,10,1972,5,910,2.0,642.0,642.0,5,1062,2.0,794.0,794.0
308.851,17,20,1124,10,716,34302.0,48.0,43.0,10,408,34302.0,20.0,12.0
0.003,17,2,136,1,60,0.0,32.0,32.0,1,76,0.0,48.0,48.0
0.009,6,14,3799,7,509,1.0,137.0,137.0,7,3290,1.0,1448.0,972.0
40.06,17,10,676,5,460,10013.0,104.0,64.0,5,216,10014.0,20.0,15.0
0.008,6,12,1926,6,1189,1.0,659.0,434.0,6,737,1.0,417.0,417.0
0.071,6,10,1506,5,395,16.0,127.0,127.0,5,1111,17.0,843.0,843.0
0.005,6,10,1689,5,839,1.0,571.0,571.0,5,850,1.0,582.0,582.0
0.005,6,10,2007,5,928,1.0,660.0,660.0,5,1079,1.0,811.0,811.0
61.299,6,170,114541,100,10601,619.0,1065.0,672.0,70,103940,888.0,3306.0,1644.0
0.006,6,10,1547,5,764,1.0,496.0,496.0,5,783,1.0,515.0,515.0
8.931,6,37,9811,19,4293,496.0,1360.0,700.0,18,5518,513.0,1360.0,398.0
0.005,17,2,148,1,60,0.0,32.0,32.0,1,88,0.0,60.0,60.0
0.037,17,2,156,1,64,0.0,36.0,36.0,1,92,0.0,64.0,64.0
0.005,6,10,2006,5,927,1.0,659.0,659.0,5,1079,1.0,811.0,811.0
0.004,17,4,284,2,120,0.0,32.0,32.0,2,164,0.0,60.0,54.0
40.063,17,10,676,5,460,10014.0,104.0,64.0,5,216,10014.0,20.0,15.0
0.008,6,10,1972,5,910,2.0,642.0,642.0,5,1062,2.0,794.0,794.0
10.829,17,26,4103,13,1822,893.0,269.0,112.0,13,2281,893.0,588.0,147.0
0.041,17,4,284,2,120,0.0,32.0,32.0,2,164,37.0,60.0,54.0
1772.134,17,120,11460,60,5460,30035.0,63.0,63.0,60,6000,30035.0,72.0,72.0
15.074,17,15,9238,8,6902,2149.0,1350.0,834.0,7,2336,2507.0,1350.0,305.0
314.189,17,20,1124,10,716,34903.0,48.0,43.0,10,408,34903.0,20.0,12.0
0.074,6,10,1506,5,395,15.0,127.0,127.0,5,1111,16.0,843.0,843.0
0.107,6,10,1506,5,395,26.0,127.0,127.0,5,1111,21.0,843.0,843.0
0.012,6,10,1762,5,911,3.0,643.0,643.0,5,851,2.0,583.0,583.0
0.005,17,2,144,1,64,0.0,36.0,36.0,1,80,0.0,52.0,52.0
0.005,17,2,144,1,64,0.0,36.0,36.0,1,80,0.0,52.0,52.0
0.013,6,10,1989,5,910,3.0,642.0,642.0,5,1079,3.0,811.0,811.0
0.008,6,10,1983,5,910,1.0,642.0,642.0,5,1073,2.0,805.0,805.0
0.012,6,10,1983,5,910,2.0,642.0,642.0,5,1073,3.0,805.0,805.0
0.011,6,10,1983,5,910,2.0,642.0,642.0,5,1073,2.0,805.0,805.0
40.066,17,10,676,5,460,10015.0,104.0,64.0,5,216,10015.0,20.0,15.0
0.005,17,2,175,1,65,0.0,37.0,37.0,1,110,0.0,82.0,82.0
0.001,17,2,179,1,62,0.0,34.0,34.0,1,117,0.0,89.0,89.0
0.0,17,2,166,1,75,0.0,47.0,47.0,1,91,0.0,63.0,63.0
0.001,17,2,140,1,62,0.0,34.0,34.0,1,78,0.0,50.0,50.0
0.011,6,10,1972,5,910,2.0,642.0,642.0,5,1062,2.0,794.0,794.0
0.005,6,10,1643,5,860,1.0,592.0,592.0,5,783,1.0,515.0,515.0
0.005,6,10,2006,5,927,1.0,659.0,659.0,5,1079,1.0,811.0,811.0
0.004,17,2,164,1,74,0.0,46.0,46.0,1,90,0.0,62.0,62.0
266.743,6,25,8100,9,2024,33342.0,1496.0,780.0,16,6076,17782.0,2804.0,476.0
0.111,6,10,1506,5,395,25.0,127.0,127.0,5,1111,26.0,843.0,843.0
0.005,6,10,1989,5,927,1.0,659.0,659.0,5,1062,1.0,794.0,794.0
0.01,6,10,1972,5,910,2.0,642.0,642.0,5,1062,2.0,794.0,794.0
300.353,6,16,2170,9,684,37522.0,146.0,146.0,7,1486,50030.0,419.0,398.0
0.005,6,14,3736,7,446,0.0,74.0,74.0,7,3290,0.0,1448.0,972.0
0.074,17,8,3613,4,1874,24.0,1350.0,440.0,4,1739,10.0,1350.0,406.0
0.04,17,4,284,2,120,0.0,32.0,32.0,2,164,37.0,60.0,54.0
0.012,6,10,1990,5,911,3.0,643.0,643.0,5,1079,2.0,811.0,811.0
0.038,17,2,148,1,60,0.0,32.0,32.0,1,88,0.0,60.0,60.0
0.005,17,2,164,1,74,0.0,46.0,46.0,1,90,0.0,62.0,62.0
0.003,17,2,148,1,60,0.0,32.0,32.0,1,88,0.0,60.0,60.0
0.004,6,10,1779,5,928,1.0,660.0,660.0,5,851,1.0,583.0,583.0
0.008,6,10,1990,5,911,1.0,643.0,643.0,5,1079,2.0,811.0,811.0
0.006,6,10,1547,5,764,1.0,496.0,496.0,5,783,1.0,515.0,515.0
0.17,17,2,152,1,76,0.0,48.0,48.0,1,76,0.0,48.0,48.0
0.029,6,10,1605,5,388,7.0,120.0,120.0,5,1217,7.0,949.0,949.0
0.074,17,4,284,2,120,0.0,32.0,32.0,2,164,62.0,60.0,54.0
0.005,6,10,1774,5,923,1.0,655.0,655.0,5,851,1.0,583.0,583.0
0.011,6,10,1989,5,910,2.0,642.0,642.0,5,1079,2.0,811.0,811.0
0.011,6,10,1989,5,910,2.0,642.0,642.0,5,1079,2.0,811.0,811.0
0.191,6,11,1558,6,447,36.0,127.0,127.0,5,1111,43.0,843.0,843.0
308.747,17,20,1124,10,716,34291.0,48.0,43.0,10,408,34291.0,20.0,12.0
0.071,17,8,3613,4,1874,23.0,1350.0,440.0,4,1739,12.0,1350.0,406.0
0.007,6,10,1989,5,910,1.0,642.0,642.0,5,1079,1.0,811.0,811.0
0.005,6,10,1774,5,923,1.0,655.0,655.0,5,851,1.0,583.0,583.0
0.005,6,10,2006,5,927,1.0,659.0,659.0,5,1079,1.0,811.0,811.0
0.013,6,10,1989,5,910,3.0,642.0,642.0,5,1079,3.0,811.0,811.0
300.311,6,16,2170,9,684,37519.0,146.0,146.0,7,1486,50024.0,419.0,398.0
0.015,6,10,1762,5,911,3.0,643.0,643.0,5,851,3.0,583.0,583.0
0.004,17,2,148,1,60,0.0,32.0,32.0,1,88,0.0,60.0,60.0
0.004,6,10,2007,5,928,1.0,660.0,660.0,5,1079,1.0,811.0,811.0
0.022,6,10,1972,5,910,5.0,642.0,642.0,5,1062,5.0,794.0,794.0
40.059,17,10,676,5,460,10013.0,104.0,64.0,5,216,10013.0,20.0,15.0
0.006,6,10,1989,5,927,1.0,659.0,659.0,5,1062,1.0,794.0,794.0
0.065,6,10,1506,5,395,13.0,127.0,127.0,5,1111,15.0,843.0,843.0
0.044,17,4,284,2,120,0.0,32.0,32.0,2,164,30.0,60.0,54.0
0.01,6,10,1990,5,911,2.0,643.0,643.0,5,1079,2.0,811.0,811.0
0.005,6,10,1547,5,764,1.0,496.0,496.0,5,783,1.0,515.0,515.0
1792.626,6,497,99692,253,88342,7112.0,421.0,365.0,244,11350,7376.0,53.0,53.0
0.005,6,13,3747,7,509,0.0,137.0,137.0,6,3238,0.0,1470.0,1459.0
0.092,6,10,1506,5,395,20.0,127.0,127.0,5,1111,19.0,843.0,843.0
0.039,17,2,136,1,60,0.0,32.0,32.0,1,76,0.0,48.0,48.0
0.16,6,10,1506,5,395,38.0,127.0,127.0,5,1111,38.0,843.0,843.0
0.018,6,10,1972,5,910,4.0,642.0,642.0,5,1062,4.0,794.0,794.0
0.005,6,10,2006,5,927,1.0,659.0,659.0,5,1079,1.0,811.0,811.0
0.004,17,2,136,1,60,0.0,32.0,32.0,1,76,0.0,48.0,48.0
0.007,17,2,194,1,59,0.0,31.0,31.0,1,135,0.0,107.0,107.0
0.01,17,2,194,1,59,0.0,31.0,31.0,1,135,0.0,107.0,107.0
0.022,17,2,169,1,62,0.0,34.0,34.0,1,107,0.0,79.0,79.0
0.005,6,10,2007,5,928,1.0,660.0,660.0,5,1079,1.0,811.0,811.0
0.01,17,2,186,1,61,0.0,33.0,33.0,1,125,0.0,97.0,97.0
0.01,6,10,1989,5,910,2.0,642.0,642.0,5,1079,2.0,811.0,811.0
0.005,6,10,2006,5,927,1.0,659.0,659.0,5,1079,1.0,811.0,811.0
0.004,17,2,148,1,60,0.0,32.0,32.0,1,88,0.0,60.0,60.0
0.022,17,2,136,1,60,0.0,32.0,32.0,1,76,0.0,48.0,48.0
0.004,17,2,136,1,60,0.0,32.0,32.0,1,76,0.0,48.0,48.0
0.068,6,10,1506,5,395,12.0,127.0,127.0,5,1111,16.0,843.0,843.0
0.147,6,10,1506,5,395,34.0,127.0,127.0,5,1111,34.0,843.0,843.0
0.008,6,10,1989,5,910,2.0,642.0,642.0,5,1079,1.0,811.0,811.0
0.006,6,10,1547,5,764,1.0,496.0,496.0,5,783,1.0,515.0,515.0
0.073,6,10,1506,5,395,17.0,127.0,127.0,5,1111,15.0,843.0,843.0
0.006,6,10,1547,5,764,1.0,496.0,496.0,5,783,1.0,515.0,515.0
40.056,17,10,676,5,460,10012.0,104.0,64.0,5,216,10013.0,20.0,15.0
0.136,6,10,1506,5,395,30.0,127.0,127.0,5,1111,31.0,843.0,843.0
0.104,17,9,4991,5,3252,26.0,1350.0,622.0,4,1739,12.0,1350.0,406.0
0.04,17,2,136,1,60,0.0,32.0,32.0,1,76,0.0,48.0,48.0
0.006,6,10,2006,5,927,1.0,659.0,659.0,5,1079,1.0,811.0,811.0
0.005,17,2,170,1,65,0.0,37.0,37.0,1,105,0.0,77.0,77.0
0.027,6,10,1989,5,910,6.0,642.0,642.0,5,1079,6.0,811.0,811.0
40.076,17,10,676,5,460,10013.0,104.0,64.0,5,216,10018.0,20.0,15.0
0.164,17,2,152,1,76,0.0,48.0,48.0,1,76,0.0,48.0,48.0
0.003,17,2,148,1,60,0.0,32.0,32.0,1,88,0.0,60.0,60.0
0.004,17,4,284,2,120,0.0,32.0,32.0,2,164,1.0,60.0,54.0
0.005,6,10,2000,5,927,1.0,659.0,659.0,5,1073,1.0,805.0,805.0
0.021,6,10,1677,5,827,5.0,559.0,559.0,5,850,5.0,582.0,582.0
0.005,6,10,2007,5,928,1.0,660.0,660.0,5,1079,1.0,811.0,811.0
1783.745,6,301,45264,124,25381,14500.0,2799.0,212.0,177,19883,10134.0,1360.0,150.0
0.006,6,10,1779,5,928,1.0,660.0,660.0,5,851,1.0,583.0,583.0
0.009,17,2,194,1,59,0.0,31.0,31.0,1,135,0.0,107.0,107.0
0.005,6,10,2006,5,927,1.0,659.0,659.0,5,1079,1.0,811.0,811.0
0.125,6,10,1506,5,395,25.0,127.0,127.0,5,1111,26.0,843.0,843.0
0.097,6,10,1506,5,395,22.0,127.0,127.0,5,1111,22.0,843.0,843.0
0.004,6,10,2006,5,927,1.0,659.0,659.0,5,1079,1.0,811.0,811.0
40.073,17,10,676,5,460,10017.0,104.0,64.0,5,216,10017.0,20.0,15.0
0.014,6,10,1762,5,911,3.0,643.0,643.0,5,851,3.0,583.0,583.0
0.012,6,10,1990,5,911,2.0,643.0,643.0,5,1079,3.0,811.0,811.0
178.389,17,94,13461,47,3152,3877.0,44.0,39.0,47,10309,3877.0,261.0,191.0
0.01,6,10,1983,5,910,2.0,642.0,642.0,5,1073,2.0,805.0,805.0
0.006,6,10,1689,5,839,1.0,571.0,571.0,5,850,1.0,582.0,582.0
0.005,6,10,1989,5,927,1.0,659.0,659.0,5,1062,1.0,794.0,794.0
0.101,6,10,1506,5,395,22.0,127.0,127.0,5,1111,21.0,843.0,843.0
0.115,6,10,1506,5,395,25.0,127.0,127.0,5,1111,23.0,843.0,843.0
0.008,6,10,1677,5,827,2.0,559.0,559.0,5,850,1.0,582.0,582.0
1690.366,17,14,1106,7,441,281727.0,35.0,35.0,7,665,281726.0,67.0,67.0
0.001,17,2,136,1,60,0.0,32.0,32.0,1,76,0.0,48.0,48.0
0.006,17,2,148,1,60,0.0,32.0,32.0,1,88,0.0,60.0,60.0
0.006,17,2,170,1,65,0.0,37.0,37.0,1,105,0.0,77.0,77.0
0.015,6,10,1972,5,910,3.0,642.0,642.0,5,1062,3.0,794.0,794.0
0.004,17,2,166,1,75,0.0,47.0,47.0,1,91,0.0,63.0,63.0
0.001,17,2,180,1,66,0.0,38.0,38.0,1,114,0.0,86.0,86.0
0.006,6,10,1854,5,889,1.0,621.0,621.0,5,965,1.0,697.0,697.0
0.024,6,10,1989,5,910,6.0,642.0,642.0,5,1079,5.0,811.0,811.0
0.001,17,2,136,1,60,0.0,32.0,32.0,1,76,0.0,48.0,48.0
0.005,6,10,1989,5,927,1.0,659.0,659.0,5,1062,1.0,794.0,794.0
0.053,6,10,1506,5,395,12.0,127.0,127.0,5,1111,12.0,843.0,843.0
0.013,6,10,1989,5,910,3.0,642.0,642.0,5,1079,3.0,811.0,811.0
0.111,6,10,1506,5,395,26.0,127.0,127.0,5,1111,27.0,843.0,843.0
0.005,17,2,170,1,65,0.0,37.0,37.0,1,105,0.0,77.0,77.0
0.005,6,10,2000,5,927,1.0,659.0,659.0,5,1073,1.0,805.0,805.0
0.006,6,10,2006,5,927,1.0,659.0,659.0,5,1079,1.0,811.0,811.0
293.908,6,393,348560,203,22122,1454.0,2736.0,889.0,190,326438,1555.0,2852.0,1798.0
0.005,6,10,2007,5,928,1.0,660.0,660.0,5,1079,1.0,811.0,811.0
68.272,6,45,12766,23,6814,411.0,1602.0,975.0,22,5952,3243.0,2667.0,361.0
0.065,6,10,1506,5,395,15.0,127.0,127.0,5,1111,13.0,843.0,843.0
0.005,6,10,2006,5,927,1.0,659.0,659.0,5,1079,1.0,811.0,811.0
0.01,17,2,213,1,69,0.0,41.0,41.0,1,144,0.0,116.0,116.0
0.006,6,10,1547,5,764,1.0,496.0,496.0,5,783,1.0,515.0,515.0
0.077,6,10,1506,5,395,18.0,127.0,127.0,5,1111,15.0,843.0,843.0
0.013,6,14,3787,7,497,2.0,125.0,125.0,7,3290,2.0,1448.0,972.0
0.008,6,10,2006,5,927,2.0,659.0,659.0,5,1079,1.0,811.0,811.0
0.014,6,10,1989,5,910,3.0,642.0,642.0,5,1079,3.0,811.0,811.0
0.005,6,10,2007,5,928,1.0,660.0,660.0,5,1079,1.0,811.0,811.0
0.303,17,2,152,1,76,0.0,48.0,48.0,1,76,0.0,48.0,48.0
0.163,17,2,152,1,76,0.0,48.0,48.0,1,76,0.0,48.0,48.0
173.173,17,80,11319,40,2676,4440.0,44.0,38.0,40,8643,4440.0,260.0,188.0
0.005,6,10,1989,5,927,1.0,659.0,659.0,5,1062,1.0,794.0,794.0
177.152,17,76,10733,38,2536,4787.0,44.0,38.0,38,8197,4787.0,261.0,187.0
0.004,6,10,2006,5,927,1.0,659.0,659.0,5,1079,1.0,811.0,811.0
0.005,17,2,179,1,71,0.0,43.0,43.0,1,108,0.0,80.0,80.0
0.006,6,10,1854,5,889,1.0,621.0,621.0,5,965,1.0,697.0,697.0
0.005,6,10,1854,5,889,1.0,621.0,621.0,5,965,1.0,697.0,697.0
0.012,6,10,1972,5,910,3.0,642.0,642.0,5,1062,3.0,794.0,794.0
0.747,6,26,5824,13,1922,58.0,325.0,174.0,13,3902,53.0,1414.0,563.0
0.005,6,13,3690,7,452,0.0,80.0,80.0,6,3238,0.0,1470.0,1459.0
0.006,6,10,1547,5,764,1.0,496.0,496.0,5,783,1.0,515.0,515.0
1774.678,6,64,7361,42,4485,43284.0,1641.0,109.0,22,2876,84500.0,1112.0,82.0
0.083,6,10,1506,5,395,17.0,127.0,127.0,5,1111,17.0,843.0,843.0
0.083,6,10,1506,5,395,18.0,127.0,127.0,5,1111,19.0,843.0,843.0
0.039,17,2,184,1,61,0.0,33.0,33.0,1,123,0.0,95.0,95.0
0.022,6,13,3735,7,497,3.0,125.0,125.0,6,3238,4.0,1470.0,1459.0
0.037,17,4,284,2,120,0.0,32.0,32.0,2,164,34.0,60.0,54.0
0.005,6,10,2000,5,927,1.0,659.0,659.0,5,1073,1.0,805.0,805.0
0.032,6,10,1677,5,827,7.0,559.0,559.0,5,850,8.0,582.0,582.0
0.013,17,2,152,1,56,0.0,28.0,28.0,1,96,0.0,68.0,68.0
0.009,6,10,1677,5,827,2.0,559.0,559.0,5,850,2.0,582.0,582.0
0.005,6,10,2000,5,927,1.0,659.0,659.0,5,1073,1.0,805.0,805.0
0.028,17,2,212,1,74,0.0,46.0,46.0,1,138,0.0,110.0,110.0
0.039,17,4,596,2,122,1.0,33.0,33.0,2,474,1.0,323.0,209.0
0.004,6,10,1779,5,928,1.0,660.0,660.0,5,851,1.0,583.0,583.0
0.014,6,10,1990,5,911,3.0,643.0,643.0,5,1079,3.0,811.0,811.0
0.006,6,10,1547,5,764,1.0,496.0,496.0,5,783,1.0,515.0,515.0
0.003,17,2,136,1,60,0.0,32.0,32.0,1,76,0.0,48.0,48.0
0.01,6,10,1972,5,910,2.0,642.0,642.0,5,1062,2.0,794.0,794.0
0.006,6,10,1989,5,927,1.0,659.0,659.0,5,1062,1.0,794.0,794.0
0.015,6,10,1989,5,910,3.0,642.0,642.0,5,1079,3.0,811.0,811.0
0.068,6,10,1506,5,395,16.0,127.0,127.0,5,1111,15.0,843.0,843.0
0.021,6,10,1983,5,910,5.0,642.0,642.0,5,1073,5.0,805.0,805.0
0.167,17,2,152,1,76,0.0,48.0,48.0,1,76,0.0,48.0,48.0
0.008,6,10,1989,5,910,2.0,642.0,642.0,5,1079,2.0,811.0,811.0
0.005,6,10,1547,5,764,1.0,496.0,496.0,5,783,1.0,515.0,515.0
0.038,17,4,596,2,122,0.0,33.0,33.0,2,474,34.0,323.0,209.0
240.098,6,16,4480,9,963,30012.0,238.0,166.0,7,3517,40016.0,1402.0,786.0
0.005,6,10,2000,5,927,1.0,659.0,659.0,5,1073,1.0,805.0,805.0
0.013,6,10,1762,5,911,3.0,643.0,643.0,5,851,3.0,583.0,583.0
0.004,6,10,1774,5,923,1.0,655.0,655.0,5,851,1.0,583.0,583.0
31.256,6,26,15713,14,1268,2404.0,240.0,240.0,12,14445,2837.0,2804.0,1533.0
0.011,6,10,1983,5,910,2.0,642.0,642.0,5,1073,2.0,805.0,805.0
0.125,6,10,1506,5,395,29.0,127.0,127.0,5,1111,28.0,843.0,843.0
9.036,17,6,376,5,280,2259.0,28.0,28.0,1,96,0.0,68.0,68.0
0.075,6,10,1506,5,395,17.0,127.0,127.0,5,1111,15.0,843.0,843.0
40.1,17,10,676,5,460,10023.0,104.0,64.0,5,216,10024.0,20.0,15.0
0.006,6,10,1547,5,764,1.0,496.0,496.0,5,783,1.0,515.0,515.0
0.107,6,10,1506,5,395,23.0,127.0,127.0,5,1111,24.0,843.0,843.0
0.005,17,2,170,1,65,0.0,37.0,37.0,1,105,0.0,77.0,77.0
0.1,6,10,1506,5,395,20.0,127.0,127.0,5,1111,24.0,843.0,843.0
0.004,6,10,2007,5,928,1.0,660.0,660.0,5,1079,1.0,811.0,811.0
0.01,6,10,1983,5,910,2.0,642.0,642.0,5,1073,2.0,805.0,805.0
0.113,6,10,1506,5,395,27.0,127.0,127.0,5,1111,26.0,843.0,843.0
0.054,6,10,1506,5,395,11.0,127.0,127.0,5,1111,13.0,843.0,843.0
0.17,6,3,453,2,321,170.0,241.0,241.0,1,132,0.0,92.0,92.0
0.006,17,2,169,1,62,0.0,34.0,34.0,1,107,0.0,79.0,79.0
0.01,6,10,1990,5,911,2.0,643.0,643.0,5,1079,2.0,811.0,811.0
0.006,6,13,3747,7,509,0.0,137.0,137.0,6,3238,1.0,1470.0,1459.0
0.107,6,10,1506,5,395,23.0,127.0,127.0,5,1111,23.0,843.0,843.0
0.023,6,10,1972,5,910,5.0,642.0,642.0,5,1062,5.0,794.0,794.0
0.098,6,10,1506,5,395,20.0,127.0,127.0,5,1111,21.0,843.0,843.0
0.005,6,10,1547,5,764,1.0,496.0,496.0,5,783,1.0,515.0,515.0
289.846,6,331,344672,127,18150,2300.0,2736.0,888.0,204,326522,1427.0,2804.0,1662.0
0.004,6,10,2000,5,927,1.0,659.0,659.0,5,1073,1.0,805.0,805.0
0.004,17,2,136,1,60,0.0,32.0,32.0,1,76,0.0,48.0,48.0
0.016,6,10,1762,5,911,3.0,643.0,643.0,5,851,3.0,583.0,583.0
0.005,6,10,1547,5,764,1.0,496.0,496.0,5,783,1.0,515.0,515.0
0.006,6,10,1689,5,839,1.0,571.0,571.0,5,850,1.0,582.0,582.0
0.004,6,10,1989,5,927,1.0,659.0,659.0,5,1062,1.0,794.0,794.0
0.217,17,4,352,2,130,177.0,37.0,37.0,2,222,145.0,89.0,83.0
0.013,6,10,1990,5,911,3.0,643.0,643.0,5,1079,3.0,811.0,811.0
0.079,6,10,1506,5,395,16.0,127.0,127.0,5,1111,16.0,843.0,843.0
171.12,17,80,11424,40,2663,4387.0,44.0,38.0,40,8761,4387.0,252.0,191.0
0.01,6,10,1677,5,827,2.0,559.0,559.0,5,850,2.0,582.0,582.0
0.007,6,10,2006,5,927,1.0,659.0,659.0,5,1079,1.0,811.0,811.0
0.107,6,10,1506,5,395,21.0,127.0,127.0,5,1111,25.0,843.0,843.0
0.009,6,10,1989,5,910,2.0,642.0,642.0,5,1079,2.0,811.0,811.0
0.004,6,10,1779,5,928,1.0,660.0,660.0,5,851,1.0,583.0,583.0
0.08,6,10,1506,5,395,18.0,127.0,127.0,5,1111,18.0,843.0,843.0
0.003,17,2,148,1,60,0.0,32.0,32.0,1,88,0.0,60.0,60.0
0.003,17,2,148,1,60,0.0,32.0,32.0,1,88,0.0,60.0,60.0
0.004,6,10,1702,5,863,0.0,595.0,595.0,5,839,1.0,571.0,571.0
40.056,17,10,676,5,460,10013.0,104.0,64.0,5,216,10011.0,20.0,15.0
0.004,17,2,148,1,60,0.0,32.0,32.0,1,88,0.0,60.0,60.0
0.005,6,10,1989,5,927,1.0,659.0,659.0,5,1062,1.0,794.0,794.0
0.004,6,10,1774,5,923,1.0,655.0,655.0,5,851,1.0,583.0,583.0
0.012,6,10,1989,5,910,3.0,642.0,642.0,5,1079,2.0,811.0,811.0
0.043,17,2,148,1,60,0.0,32.0,32.0,1,88,0.0,60.0,60.0
0.013,6,10,1631,5,848,3.0,580.0,580.0,5,783,3.0,515.0,515.0
0.005,6,10,2006,5,927,1.0,659.0,659.0,5,1079,1.0,811.0,811.0
0.003,17,2,234,1,61,0.0,33.0,33.0,1,173,0.0,145.0,145.0
0.006,6,10,2000,5,927,1.0,659.0,659.0,5,1073,1.0,805.0,805.0
0.076,6,10,1506,5,395,17.0,127.0,127.0,5,1111,17.0,843.0,843.0
0.005,6,10,1989,5,927,1.0,659.0,659.0,5,1062,1.0,794.0,794.0
0.006,6,10,1547,5,764,1.0,496.0,496.0,5,783,1.0,515.0,515.0
0.011,6,10,1972,5,910,2.0,642.0,642.0,5,1062,2.0,794.0,794.0
0.004,17,4,284,2,120,1.0,32.0,32.0,2,164,0.0,60.0,54.0
0.008,6,10,1989,5,910,2.0,642.0,642.0,5,1079,2.0,811.0,811.0
0.01,6,10,1989,5,910,2.0,642.0,642.0,5,1079,2.0,811.0,811.0
0.117,6,10,1506,5,395,28.0,127.0,127.0,5,1111,24.0,843.0,843.0
0.005,17,2,170,1,65,0.0,37.0,37.0,1,105,0.0,77.0,77.0
0.015,6,10,1989,5,910,3.0,642.0,642.0,5,1079,3.0,811.0,811.0
0.004,17,2,136,1,60,0.0,32.0,32.0,1,76,0.0,48.0,48.0
0.006,6,10,1989,5,927,1.0,659.0,659.0,5,1062,1.0,794.0,794.0
0.015,6,10,1972,5,910,3.0,642.0,642.0,5,1062,3.0,794.0,794.0
0.07,6,10,1506,5,395,14.0,127.0,127.0,5,1111,14.0,843.0,843.0
0.005,6,10,2000,5,927,1.0,659.0,659.0,5,1073,1.0,805.0,805.0
0.003,17,2,148,1,60,0.0,32.0,32.0,1,88,0.0,60.0,60.0
0.005,17,2,214,1,75,0.0,47.0,47.0,1,139,0.0,111.0,111.0
40.073,17,10,676,5,460,10017.0,104.0,64.0,5,216,10017.0,20.0,15.0
0.018,6,13,3735,7,497,3.0,125.0,125.0,6,3238,3.0,1470.0,1459.0
0.006,6,10,1689,5,839,1.0,571.0,571.0,5,850,1.0,582.0,582.0
0.005,6,10,2007,5,928,1.0,660.0,660.0,5,1079,1.0,811.0,811.0
0.003,17,2,136,1,60,0.0,32.0,32.0,1,76,0.0,48.0,48.0
0.015,6,10,1989,5,910,3.0,642.0,642.0,5,1079,3.0,811.0,811.0
0.007,17,2,194,1,59,0.0,31.0,31.0,1,135,0.0,107.0,107.0
0.006,6,10,1547,5,764,1.0,496.0,496.0,5,783,1.0,515.0,515.0
0.082,6,10,1506,5,395,18.0,127.0,127.0,5,1111,19.0,843.0,843.0
0.006,6,10,1547,5,764,1.0,496.0,496.0,5,783,1.0,515.0,515.0
0.028,6,10,1972,5,910,7.0,642.0,642.0,5,1062,7.0,794.0,794.0
274.91,6,23,4845,9,963,34363.0,238.0,166.0,14,3882,21146.0,1402.0,786.0
0.005,6,10,1989,5,927,1.0,659.0,659.0,5,1062,1.0,794.0,794.0
240.012,6,9,787,5,488,60003.0,232.0,232.0,4,299,80003.0,83.0,83.0
172.174,17,76,10864,38,2545,4653.0,44.0,38.0,38,8319,4653.0,239.0,190.0
0.015,6,10,1989,5,910,3.0,642.0,642.0,5,1079,3.0,811.0,811.0
0.06,17,2,152,1,76,0.0,48.0,48.0,1,76,0.0,48.0,48.0
0.005,6,10,1689,5,839,1.0,571.0,571.0,5,850,1.0,582.0,582.0
0.005,6,10,2007,5,928,1.0,660.0,660.0,5,1079,1.0,811.0,811.0
0.008,6,10,1989,5,910,2.0,642.0,642.0,5,1079,2.0,811.0,811.0
0.01,6,12,1926,6,1189,2.0,659.0,434.0,6,737,1.0,417.0,417.0
0.097,6,10,1506,5,395,23.0,127.0,127.0,5,1111,20.0,843.0,843.0
0.001,17,2,180,1,66,0.0,38.0,38.0,1,114,0.0,86.0,86.0
0.006,6,10,1547,5,764,1.0,496.0,496.0,5,783,1.0,515.0,515.0
0.019,6,13,3735,7,497,3.0,125.0,125.0,6,3238,3.0,1470.0,1459.0
0.016,6,10,1990,5,911,3.0,643.0,643.0,5,1079,4.0,811.0,811.0
0.008,6,13,3735,7,497,1.0,125.0,125.0,6,3238,1.0,1470.0,1459.0
0.129,6,10,1506,5,395,27.0,127.0,127.0,5,1111,24.0,843.0,843.0
40.073,17,10,676,5,460,10017.0,104.0,64.0,5,216,10017.0,20.0,15.0
240.088,6,31,9147,15,6888,17149.0,2012.0,679.0,16,2259,16005.0,580.0,177.0
0.005,6,13,3690,7,452,0.0,80.0,80.0,6,3238,0.0,1470.0,1459.0
0.005,6,13,3747,7,509,0.0,137.0,137.0,6,3238,0.0,1470.0,1459.0
0.074,6,10,1506,5,395,18.0,127.0,127.0,5,1111,16.0,843.0,843.0
0.005,17,2,179,1,71,0.0,43.0,43.0,1,108,0.0,80.0,80.0
0.137,6,10,1506,5,395,29.0,127.0,127.0,5,1111,30.0,843.0,843.0
0.005,6,10,1779,5,928,1.0,660.0,660.0,5,851,1.0,583.0,583.0
0.023,6,10,1989,5,910,5.0,642.0,642.0,5,1079,5.0,811.0,811.0
0.005,17,2,214,1,75,0.0,47.0,47.0,1,139,0.0,111.0,111.0
0.013,6,10,1972,5,910,3.0,642.0,642.0,5,1062,3.0,794.0,794.0
0.009,6,10,1972,5,910,2.0,642.0,642.0,5,1062,2.0,794.0,794.0
0.116,6,10,1506,5,395,22.0,127.0,127.0,5,1111,24.0,843.0,843.0
0.006,17,2,179,1,71,0.0,43.0,43.0,1,108,0.0,80.0,80.0
0.004,17,2,136,1,60,0.0,32.0,32.0,1,76,0.0,48.0,48.0
0.014,6,10,1631,5,848,3.0,580.0,580.0,5,783,3.0,515.0,515.0
0.005,6,10,2007,5,928,1.0,660.0,660.0,5,1079,1.0,811.0,811.0
0.004,17,4,284,2,120,1.0,32.0,32.0,2,164,1.0,60.0,54.0
0.004,17,2,136,1,60,0.0,32.0,32.0,1,76,0.0,48.0,48.0
0.001,17,2,166,1,75,0.0,47.0,47.0,1,91,0.0,63.0,63.0
0.011,6,10,1990,5,911,2.0,643.0,643.0,5,1079,2.0,811.0,811.0
0.005,6,10,2006,5,927,1.0,659.0,659.0,5,1079,1.0,811.0,811.0
0.006,6,10,2006,5,927,1.0,659.0,659.0,5,1079,1.0,811.0,811.0
240.085,6,16,4482,9,963,30010.0,238.0,166.0,7,3519,40013.0,1402.0,786.0
0.018,6,10,1990,5,911,4.0,643.0,643.0,5,1079,4.0,811.0,811.0
0.027,6,10,1762,5,911,6.0,643.0,643.0,5,851,6.0,583.0,583.0
0.018,6,10,1983,5,910,4.0,642.0,642.0,5,1073,4.0,805.0,805.0
0.004,6,10,1989,5,927,1.0,659.0,659.0,5,1062,1.0,794.0,794.0
0.015,6,10,1677,5,827,3.0,559.0,559.0,5,850,3.0,582.0,582.0
0.006,17,2,170,1,65,0.0,37.0,37.0,1,105,0.0,77.0,77.0
309.982,17,20,1124,10,716,34428.0,48.0,43.0,10,408,34428.0,20.0,12.0
40.07,17,10,676,5,460,10014.0,104.0,64.0,5,216,10016.0,20.0,15.0
0.005,6,10,1779,5,928,1.0,660.0,660.0,5,851,1.0,583.0,583.0
0.001,17,2,166,1,75,0.0,47.0,47.0,1,91,0.0,63.0,63.0
0.01,6,10,1989,5,910,2.0,642.0,642.0,5,1079,2.0,811.0,811.0
0.01,6,10,1989,5,910,2.0,642.0,642.0,5,1079,2.0,811.0,811.0
0.084,6,10,1506,5,395,18.0,127.0,127.0,5,1111,19.0,843.0,843.0
300.362,6,16,2170,9,684,37524.0,146.0,146.0,7,1486,50033.0,419.0,398.0
0.011,6,10,1762,5,911,2.0,643.0,643.0,5,851,2.0,583.0,583.0
0.012,6,10,1631,5,848,3.0,580.0,580.0,5,783,3.0,515.0,515.0
0.019,6,10,1762,5,911,4.0,643.0,643.0,5,851,4.0,583.0,583.0
0.005,17,2,247,1,68,0.0,40.0,40.0,1,179,0.0,151.0,151.0
0.005,6,10,1689,5,839,1.0,571.0,571.0,5,850,1.0,582.0,582.0
309.258,17,20,1124,10,716,34355.0,48.0,43.0,10,408,34354.0,20.0,12.0
0.005,6,10,2007,5,928,1.0,660.0,660.0,5,1079,1.0,811.0,811.0
0.01,6,10,1631,5,848,2.0,580.0,580.0,5,783,2.0,515.0,515.0
0.204,6,10,1506,5,395,37.0,127.0,127.0,5,1111,49.0,843.0,843.0
0.006,6,10,1547,5,764,1.0,496.0,496.0,5,783,1.0,515.0,515.0
0.005,17,2,170,1,65,0.0,37.0,37.0,1,105,0.0,77.0,77.0
0.009,6,10,1989,5,910,2.0,642.0,642.0,5,1079,2.0,811.0,811.0
0.005,6,10,1774,5,923,1.0,655.0,655.0,5,851,1.0,583.0,583.0
0.004,17,2,136,1,60,0.0,32.0,32.0,1,76,0.0,48.0,48.0
0.092,6,10,1506,5,395,21.0,127.0,127.0,5,1111,18.0,843.0,843.0
0.006,6,10,2006,5,927,1.0,659.0,659.0,5,1079,1.0,811.0,811.0
11.16,17,28,4418,14,1994,846.0,269.0,114.0,14,2424,846.0,587.0,145.0
0.011,6,10,1989,5,910,2.0,642.0,642.0,5,1079,2.0,811.0,811.0
0.011,6,10,1989,5,910,2.0,642.0,642.0,5,1079,2.0,811.0,811.0
0.224,17,14,8577,7,4012,37.0,1350.0,545.0,7,4565,27.0,1350.0,624.0
0.01,6,10,1989,5,910,2.0,642.0,642.0,5,1079,2.0,811.0,811.0
0.007,17,2,179,1,71,0.0,43.0,43.0,1,108,0.0,80.0,80.0
0.001,17,2,166,1,75,0.0,47.0,47.0,1,91,0.0,63.0,63.0
0.072,17,2,182,1,65,0.0,37.0,37.0,1,117,0.0,89.0,89.0
0.016,6,10,1762,5,911,4.0,643.0,643.0,5,851,4.0,583.0,583.0
40.067,17,10,676,5,460,10015.0,104.0,64.0,5,216,10015.0,20.0,15.0
0.017,6,10,1983,5,910,4.0,642.0,642.0,5,1073,4.0,805.0,805.0
0.009,6,10,1631,5,848,2.0,580.0,580.0,5,783,2.0,515.0,515.0
0.001,17,2,140,1,62,0.0,34.0,34.0,1,78,0.0,50.0,50.0
0.005,17,2,140,1,62,0.0,34.0,34.0,1,78,0.0,50.0,50.0
0.012,6,10,1989,5,910,2.0,642.0,642.0,5,1079,2.0,811.0,811.0
1756.038,6,449,67025,265,36402,6651.0,613.0,191.0,184,30623,9595.0,469.0,143.0
175.429,17,78,11262,39,2600,4616.0,44.0,38.0,39,8662,4616.0,261.0,194.0
0.035,17,2,152,1,76,0.0,48.0,48.0,1,76,0.0,48.0,48.0
0.006,6,10,1547,5,764,1.0,496.0,496.0,5,783,1.0,515.0,515.0
40.063,17,10,676,5,460,10012.0,104.0,64.0,5,216,10014.0,20.0,15.0
173.293,17,94,13584,47,3167,3767.0,44.0,39.0,47,10417,3767.0,261.0,193.0
0.113,6,10,1506,5,395,23.0,127.0,127.0,5,1111,21.0,843.0,843.0
0.012,6,10,1972,5,910,3.0,642.0,642.0,5,1062,2.0,794.0,794.0
0.019,6,10,1983,5,910,4.0,642.0,642.0,5,1073,4.0,805.0,805.0
177.174,17,78,11259,39,2619,4662.0,44.0,39.0,39,8640,4662.0,261.0,193.0
0.17,6,10,1506,5,395,38.0,127.0,127.0,5,1111,39.0,843.0,843.0
0.006,6,10,1547,5,764,1.0,496.0,496.0,5,783,1.0,515.0,515.0
0.004,17,2,185,1,73,0.0,45.0,45.0,1,112,0.0,84.0,84.0
0.005,6,14,3799,7,509,0.0,137.0,137.0,7,3290,0.0,1448.0,972.0
0.004,6,10,2006,5,927,1.0,659.0,659.0,5,1079,1.0,811.0,811.0
0.005,6,10,1643,5,860,1.0,592.0,592.0,5,783,1.0,515.0,515.0
40.063,17,10,676,5,460,10014.0,104.0,64.0,5,216,10015.0,20.0,15.0
0.117,6,10,1506,5,395,25.0,127.0,127.0,5,1111,26.0,843.0,843.0
0.199,6,10,1506,5,395,25.0,127.0,127.0,5,1111,47.0,843.0,843.0
0.003,17,2,136,1,60,0.0,32.0,32.0,1,76,0.0,48.0,48.0
0.095,6,10,1506,5,395,22.0,127.0,127.0,5,1111,22.0,843.0,843.0
0.005,17,2,164,1,74,0.0,46.0,46.0,1,90,0.0,62.0,62.0
0.009,6,12,1926,6,1189,1.0,659.0,434.0,6,737,1.0,417.0,417.0
0.005,6,10,2007,5,928,1.0,660.0,660.0,5,1079,1.0,811.0,811.0
15.07,17,15,10569,9,8280,1880.0,1350.0,892.0,6,2289,3010.0,1350.0,353.0
0.005,17,2,169,1,62,0.0,34.0,34.0,1,107,0.0,79.0,79.0
0.005,17,2,154,1,69,0.0,41.0,41.0,1,85,0.0,57.0,57.0
0.084,6,10,1506,5,395,16.0,127.0,127.0,5,1111,18.0,843.0,843.0
0.016,17,2,198,1,91,0.0,63.0,63.0,1,107,0.0,79.0,79.0
1738.211,6,64,7358,42,4484,42395.0,1640.0,109.0,22,2874,82763.0,1110.0,82.0
0.005,6,10,2006,5,927,1.0,659.0,659.0,5,1079,1.0,811.0,811.0
0.005,6,10,2000,5,927,1.0,659.0,659.0,5,1073,1.0,805.0,805.0
0.018,6,10,1983,5,910,4.0,642.0,642.0,5,1073,4.0,805.0,805.0
0.01,6,10,1631,5,848,2.0,580.0,580.0,5,783,2.0,515.0,515.0
0.163,17,2,152,1,76,0.0,48.0,48.0,1,76,0.0,48.0,48.0
240.255,6,39,5240,19,2385,13347.0,588.0,196.0,20,2855,12644.0,580.0,258.0
171.342,17,70,10011,35,2337,5039.0,44.0,38.0,35,7674,5039.0,239.0,191.0
0.003,17,2,148,1,60,0.0,32.0,32.0,1,88,0.0,60.0,60.0
0.005,17,2,170,1,65,0.0,37.0,37.0,1,105,0.0,77.0,77.0
0.012,6,10,1989,5,910,3.0,642.0,642.0,5,1079,3.0,811.0,811.0
0.012,6,10,1677,5,827,3.0,559.0,559.0,5,850,2.0,582.0,582.0
0.002,17,2,148,1,60,0.0,32.0,32.0,1,88,0.0,60.0,60.0
0.109,6,10,1506,5,395,24.0,127.0,127.0,5,1111,24.0,843.0,843.0
0.005,6,10,1774,5,923,1.0,655.0,655.0,5,851,1.0,583.0,583.0
0.11,6,10,1506,5,395,25.0,127.0,127.0,5,1111,26.0,843.0,843.0
40.066,17,10,676,5,460,10013.0,104.0,64.0,5,216,10015.0,20.0,15.0
0.126,17,2,412,1,61,0.0,33.0,33.0,1,351,0.0,323.0,323.0
0.006,6,10,1854,5,889,1.0,621.0,621.0,5,965,1.0,697.0,697.0
0.088,6,10,1506,5,395,20.0,127.0,127.0,5,1111,20.0,843.0,843.0
0.012,6,10,1983,5,910,3.0,642.0,642.0,5,1073,3.0,805.0,805.0
0.004,17,2,148,1,60,0.0,32.0,32.0,1,88,0.0,60.0,60.0
0.29,6,10,1506,5,395,61.0,127.0,127.0,5,1111,71.0,843.0,843.0
0.004,6,10,1774,5,923,1.0,655.0,655.0,5,851,0.0,583.0,583.0
0.005,17,2,225,1,65,0.0,37.0,37.0,1,160,0.0,132.0,132.0
40.048,17,10,676,5,460,10011.0,104.0,64.0,5,216,10011.0,20.0,15.0
0.005,17,2,144,1,64,0.0,36.0,36.0,1,80,0.0,52.0,52.0
0.013,6,10,1990,5,911,3.0,643.0,643.0,5,1079,3.0,811.0,811.0
0.001,17,2,180,1,66,0.0,38.0,38.0,1,114,0.0,86.0,86.0
0.004,6,10,1779,5,928,1.0,660.0,660.0,5,851,1.0,583.0,583.0
0.012,6,10,1631,5,848,3.0,580.0,580.0,5,783,2.0,515.0,515.0
0.04,17,2,148,1,60,0.0,32.0,32.0,1,88,0.0,60.0,60.0
0.011,17,2,178,1,65,0.0,37.0,37.0,1,113,0.0,85.0,85.0
0.011,6,10,1972,5,910,2.0,642.0,642.0,5,1062,2.0,794.0,794.0
0.004,6,10,2007,5,928,1.0,660.0,660.0,5,1079,1.0,811.0,811.0
0.004,6,10,2007,5,928,1.0,660.0,660.0,5,1079,1.0,811.0,811.0
0.004,6,10,1989,5,927,1.0,659.0,659.0,5,1062,1.0,794.0,794.0
0.009,6,12,1926,6,1189,1.0,659.0,434.0,6,737,1.0,417.0,417.0
0.005,6,10,1989,5,927,1.0,659.0,659.0,5,1062,1.0,794.0,794.0
0.005,6,10,1989,5,927,1.0,659.0,659.0,5,1062,1.0,794.0,794.0
0.008,6,13,3735,7,497,1.0,125.0,125.0,6,3238,1.0,1470.0,1459.0
0.707,6,22,5072,11,1250,59.0,325.0,133.0,11,3822,59.0,1414.0,563.0
0.106,6,10,1506,5,395,22.0,127.0,127.0,5,1111,20.0,843.0,843.0
0.006,6,10,1854,5,889,1.0,621.0,621.0,5,965,1.0,697.0,697.0
65.712,6,26,9525,12,1627,71.0,794.0,367.0,14,7898,5045.0,1360.0,732.0
240.079,6,19,4949,9,2305,30009.0,1102.0,613.0,10,2644,26675.0,1162.0,423.0
0.011,17,2,179,1,71,0.0,43.0,43.0,1,108,0.0,80.0,80.0
0.018,6,10,1972,5,910,4.0,642.0,642.0,5,1062,4.0,794.0,794.0
0.006,6,10,1689,5,839,1.0,571.0,571.0,5,850,1.0,582.0,582.0
0.005,6,10,1689,5,839,1.0,571.0,571.0,5,850,1.0,582.0,582.0
0.007,17,2,132,1,58,0.0,30.0,30.0,1,74,0.0,46.0,46.0
0.078,6,10,1506,5,395,16.0,127.0,127.0,5,1111,17.0,843.0,843.0
0.005,17,2,152,1,68,0.0,40.0,40.0,1,84,0.0,56.0,56.0
0.001,17,2,180,1,66,0.0,38.0,38.0,1,114,0.0,86.0,86.0
0.035,6,10,1990,5,911,8.0,643.0,643.0,5,1079,8.0,811.0,811.0
0.011,6,10,1762,5,911,2.0,643.0,643.0,5,851,2.0,583.0,583.0
333.998,17,20,1124,10,716,37103.0,48.0,43.0,10,408,37101.0,20.0,12.0
0.004,6,10,1989,5,927,1.0,659.0,659.0,5,1062,1.0,794.0,794.0
0.009,6,10,1990,5,911,2.0,643.0,643.0,5,1079,2.0,811.0,811.0
0.005,6,10,2000,5,927,1.0,659.0,659.0,5,1073,1.0,805.0,805.0
0.081,6,10,1506,5,395,19.0,127.0,127.0,5,1111,19.0,843.0,843.0
0.087,6,10,1506,5,395,21.0,127.0,127.0,5,1111,16.0,843.0,843.0
166.21,17,76,10928,38,2539,4492.0,44.0,38.0,38,8389,4492.0,239.0,192.0
0.005,6,10,2007,5,928,1.0,660.0,660.0,5,1079,1.0,811.0,811.0
0.005,17,2,166,1,75,0.0,47.0,47.0,1,91,0.0,63.0,63.0
0.006,6,10,1547,5,764,1.0,496.0,496.0,5,783,1.0,515.0,515.0
0.011,6,10,1972,5,910,2.0,642.0,642.0,5,1062,2.0,794.0,794.0
0.005,6,10,1689,5,839,1.0,571.0,571.0,5,850,1.0,582.0,582.0
0.006,6,10,1547,5,764,1.0,496.0,496.0,5,783,1.0,515.0,515.0
0.005,6,10,2006,5,927,1.0,659.0,659.0,5,1079,1.0,811.0,811.0
0.017,6,10,1989,5,910,4.0,642.0,642.0,5,1079,4.0,811.0,811.0
0.005,6,10,2000,5,927,1.0,659.0,659.0,5,1073,1.0,805.0,805.0
0.012,6,10,1989,5,910,3.0,642.0,642.0,5,1079,2.0,811.0,811.0
0.005,6,10,1689,5,839,1.0,571.0,571.0,5,850,1.0,582.0,582.0
0.284,17,39,20193,22,17091,13.0,1350.0,748.0,17,3102,13.0,1350.0,154.0
0.004,6,10,1989,5,927,1.0,659.0,659.0,5,1062,1.0,794.0,794.0
0.005,6,10,1702,5,863,1.0,595.0,595.0,5,839,1.0,571.0,571.0
309.499,17,20,1124,10,716,34374.0,48.0,43.0,10,408,34374.0,20.0,12.0
0.006,6,10,1643,5,860,1.0,592.0,592.0,5,783,1.0,515.0,515.0
0.059,17,2,152,1,76,0.0,48.0,48.0,1,76,0.0,48.0,48.0
0.564,6,22,7186,11,1635,56.0,748.0,263.0,11,5551,56.0,2334.0,994.0
0.001,17,2,180,1,66,0.0,38.0,38.0,1,114,0.0,86.0,86.0
300.424,6,16,2170,9,684,37530.0,146.0,146.0,7,1486,50041.0,419.0,398.0
240.027,6,9,787,5,488,60006.0,232.0,232.0,4,299,80008.0,83.0,83.0
0.037,17,2,152,1,76,0.0,48.0,48.0,1,76,0.0,48.0,48.0
0.088,6,10,1506,5,395,19.0,127.0,127.0,5,1111,20.0,843.0,843.0
0.014,6,10,1983,5,910,3.0,642.0,642.0,5,1073,3.0,805.0,805.0
0.015,6,10,1989,5,910,3.0,642.0,642.0,5,1079,3.0,811.0,811.0
0.026,17,2,148,1,60,0.0,32.0,32.0,1,88,0.0,60.0,60.0
0.005,6,10,2007,5,928,1.0,660.0,660.0,5,1079,1.0,811.0,811.0
0.038,17,2,184,1,61,0.0,33.0,33.0,1,123,0.0,95.0,95.0
0.006,17,2,170,1,65,0.0,37.0,37.0,1,105,0.0,77.0,77.0
10.839,17,28,4417,14,1993,825.0,268.0,114.0,14,2424,825.0,587.0,145.0
240.528,6,37,9662,19,2177,13362.0,749.0,236.0,18,7485,14148.0,1402.0,595.0
10.913,17,28,4394,14,1994,831.0,269.0,114.0,14,2400,830.0,587.0,143.0
0.013,6,10,1990,5,911,3.0,643.0,643.0,5,1079,3.0,811.0,811.0
160.253,6,26,9167,14,3289,93.0,1360.0,539.0,12,5878,14553.0,2720.0,897.0
0.17,17,2,152,1,76,0.0,48.0,48.0,1,76,0.0,48.0,48.0
10.895,17,28,4419,14,1994,829.0,269.0,114.0,14,2425,829.0,588.0,145.0
0.004,6,10,1702,5,863,1.0,595.0,595.0,5,839,1.0,571.0,571.0
0.015,6,10,1989,5,910,3.0,642.0,642.0,5,1079,3.0,811.0,811.0
0.005,17,2,166,1,75,0.0,47.0,47.0,1,91,0.0,63.0,63.0
0.005,6,10,2006,5,927,1.0,659.0,659.0,5,1079,1.0,811.0,811.0
40.075,17,10,676,5,460,10015.0,104.0,64.0,5,216,10018.0,20.0,15.0
0.005,6,10,2007,5,928,1.0,660.0,660.0,5,1079,1.0,811.0,811.0
0.086,6,10,1506,5,395,18.0,127.0,127.0,5,1111,19.0,843.0,843.0
0.103,6,10,1506,5,395,22.0,127.0,127.0,5,1111,20.0,843.0,843.0
0.009,6,10,1990,5,911,2.0,643.0,643.0,5,1079,2.0,811.0,811.0
0.005,17,2,179,1,71,0.0,43.0,43.0,1,108,0.0,80.0,80.0
0.014,6,10,1989,5,910,3.0,642.0,642.0,5,1079,3.0,811.0,811.0
15.347,17,46,24527,25,21223,638.0,1350.0,820.0,21,3304,765.0,1350.0,129.0
0.011,6,10,1605,5,388,2.0,120.0,120.0,5,1217,2.0,949.0,949.0
0.005,6,10,1547,5,764,1.0,496.0,496.0,5,783,1.0,515.0,515.0
0.005,6,10,2006,5,927,1.0,659.0,659.0,5,1079,1.0,811.0,811.0
0.084,6,10,1506,5,395,20.0,127.0,127.0,5,1111,18.0,843.0,843.0
0.011,6,10,1762,5,911,2.0,643.0,643.0,5,851,2.0,583.0,583.0
0.007,6,12,1698,6,863,1.0,327.0,271.0,6,835,1.0,515.0,515.0
0.137,6,10,1506,5,395,31.0,127.0,127.0,5,1111,31.0,843.0,843.0
0.003,17,2,148,1,60,0.0,32.0,32.0,1,88,0.0,60.0,60.0
0.006,17,2,140,1,62,0.0,34.0,34.0,1,78,0.0,50.0,50.0
0.008,17,2,180,1,66,0.0,38.0,38.0,1,114,0.0,86.0,86.0
0.005,6,10,2006,5,927,1.0,659.0,659.0,5,1079,1.0,811.0,811.0
0.006,6,10,1547,5,764,1.0,496.0,496.0,5,783,1.0,515.0,515.0
0.087,6,10,1506,5,395,20.0,127.0,127.0,5,1111,20.0,843.0,843.0
0.001,17,2,180,1,66,0.0,38.0,38.0,1,114,0.0,86.0,86.0
0.011,6,10,1983,5,910,2.0,642.0,642.0,5,1073,2.0,805.0,805.0
0.014,6,10,1990,5,911,3.0,643.0,643.0,5,1079,3.0,811.0,811.0
0.015,6,12,1926,6,1189,2.0,659.0,434.0,6,737,2.0,417.0,417.0
0.005,6,10,1702,5,863,1.0,595.0,595.0,5,839,1.0,571.0,571.0
0.083,6,10,1506,5,395,19.0,127.0,127.0,5,1111,16.0,843.0,843.0
10.86,17,28,4423,14,1995,825.0,270.0,114.0,14,2428,826.0,587.0,145.0
0.005,6,13,3747,7,509,0.0,137.0,137.0,6,3238,0.0,1470.0,1459.0
290.184,6,385,348070,191,21493,1527.0,2736.0,888.0,194,326577,1503.0,2804.0,1758.0
0.005,17,2,140,1,62,0.0,34.0,34.0,1,78,0.0,50.0,50.0
0.012,6,10,1989,5,910,3.0,642.0,642.0,5,1079,2.0,811.0,811.0
11.039,17,28,4399,14,2312,840.0,587.0,137.0,14,2087,840.0,270.0,121.0
0.102,6,10,1506,5,395,23.0,127.0,127.0,5,1111,20.0,843.0,843.0
40.071,17,10,676,5,460,10014.0,104.0,64.0,5,216,10016.0,20.0,15.0
0.098,6,10,1506,5,395,20.0,127.0,127.0,5,1111,23.0,843.0,843.0
0.007,6,10,2007,5,928,1.0,660.0,660.0,5,1079,1.0,811.0,811.0
0.005,6,10,1547,5,764,1.0,496.0,496.0,5,783,1.0,515.0,515.0
0.004,6,10,2000,5,927,1.0,659.0,659.0,5,1073,1.0,805.0,805.0
240.101,6,16,4480,9,963,30012.0,238.0,166.0,7,3517,40016.0,1402.0,786.0
0.078,6,10,1506,5,395,17.0,127.0,127.0,5,1111,18.0,843.0,843.0
0.13,6,10,1506,5,395,29.0,127.0,127.0,5,1111,28.0,843.0,843.0
0.013,6,10,1989,5,910,3.0,642.0,642.0,5,1079,3.0,811.0,811.0
0.016,6,10,1631,5,848,4.0,580.0,580.0,5,783,4.0,515.0,515.0
0.008,6,12,1926,6,1189,1.0,659.0,434.0,6,737,1.0,417.0,417.0
0.109,6,10,1506,5,395,24.0,127.0,127.0,5,1111,23.0,843.0,843.0
40.056,17,10,676,5,460,10013.0,104.0,64.0,5,216,10013.0,20.0,15.0
0.005,17,2,148,1,60,0.0,32.0,32.0,1,88,0.0,60.0,60.0
0.092,6,10,1506,5,395,21.0,127.0,127.0,5,1111,21.0,843.0,843.0
0.005,6,10,1854,5,889,1.0,621.0,621.0,5,965,1.0,697.0,697.0
0.006,6,10,1547,5,764,1.0,496.0,496.0,5,783,1.0,515.0,515.0
0.009,6,10,1990,5,911,2.0,643.0,643.0,5,1079,2.0,811.0,811.0
0.071,17,8,3613,4,1874,23.0,1350.0,440.0,4,1739,12.0,1350.0,406.0
0.004,6,10,2007,5,928,1.0,660.0,660.0,5,1079,1.0,811.0,811.0
10.731,17,28,4417,14,1993,817.0,268.0,114.0,14,2424,817.0,587.0,145.0
15.079,17,16,8628,8,6444,2150.0,1350.0,777.0,8,2184,2150.0,1350.0,245.0
0.001,17,2,166,1,75,0.0,47.0,47.0,1,91,0.0,63.0,63.0
0.01,6,10,1989,5,910,2.0,642.0,642.0,5,1079,2.0,811.0,811.0
0.009,6,10,1983,5,910,2.0,642.0,642.0,5,1073,2.0,805.0,805.0
0.01,6,10,1631,5,848,2.0,580.0,580.0,5,783,2.0,515.0,515.0
0.006,6,10,1643,5,860,1.0,592.0,592.0,5,783,1.0,515.0,515.0
0.017,6,10,1677,5,827,4.0,559.0,559.0,5,850,4.0,582.0,582.0
0.1,6,10,1506,5,395,22.0,127.0,127.0,5,1111,23.0,843.0,843.0
240.085,6,16,4481,9,963,30010.0,238.0,166.0,7,3518,40013.0,1402.0,786.0
0.004,6,10,2007,5,928,1.0,660.0,660.0,5,1079,1.0,811.0,811.0
0.068,6,10,1506,5,395,16.0,127.0,127.0,5,1111,15.0,843.0,843.0
0.019,6,10,1990,5,911,4.0,643.0,643.0,5,1079,4.0,811.0,811.0
5.136,58,2,144,1,72,0.0,24.0,24.0,1,72,0.0,24.0,24.0
0.008,17,2,179,1,71,0.0,43.0,43.0,1,108,0.0,80.0,80.0
0.017,6,10,1983,5,910,4.0,642.0,642.0,5,1073,4.0,805.0,805.0
0.006,6,10,1547,5,764,1.0,496.0,496.0,5,783,1.0,515.0,515.0
0.089,6,10,1506,5,395,19.0,127.0,127.0,5,1111,19.0,843.0,843.0
0.01,6,10,1762,5,911,2.0,643.0,643.0,5,851,2.0,583.0,583.0
0.013,6,10,1989,5,910,3.0,642.0,642.0,5,1079,3.0,811.0,811.0
0.004,17,2,136,1,60,0.0,32.0,32.0,1,76,0.0,48.0,48.0
0.005,6,10,2007,5,928,1.0,660.0,660.0,5,1079,1.0,811.0,811.0
0.005,6,10,1989,5,927,1.0,659.0,659.0,5,1062,1.0,794.0,794.0
0.018,6,10,1989,5,910,4.0,642.0,642.0,5,1079,4.0,811.0,811.0
0.004,6,10,2006,5,927,1.0,659.0,659.0,5,1079,1.0,811.0,811.0
0.118,6,10,1506,5,395,28.0,127.0,127.0,5,1111,21.0,843.0,843.0
0.015,6,13,3735,7,497,2.0,125.0,125.0,6,3238,2.0,1470.0,1459.0
40.061,17,10,676,5,460,10013.0,104.0,64.0,5,216,10014.0,20.0,15.0
0.005,17,2,169,1,62,0.0,34.0,34.0,1,107,0.0,79.0,79.0
0.005,6,10,1854,5,889,1.0,621.0,621.0,5,965,1.0,697.0,697.0
10.891,17,28,4418,14,1994,829.0,269.0,114.0,14,2424,829.0,587.0,145.0
0.013,6,10,1972,5,910,3.0,642.0,642.0,5,1062,3.0,794.0,794.0
0.12,6,10,1506,5,395,27.0,127.0,127.0,5,1111,27.0,843.0,843.0
0.091,6,10,1506,5,395,21.0,127.0,127.0,5,1111,19.0,843.0,843.0
0.12,6,10,1506,5,395,27.0,127.0,127.0,5,1111,17.0,843.0,843.0
0.004,6,10,1989,5,927,1.0,659.0,659.0,5,1062,1.0,794.0,794.0
0.006,17,2,230,1,68,0.0,40.0,40.0,1,162,0.0,134.0,134.0
0.071,6,10,1506,5,395,14.0,127.0,127.0,5,1111,15.0,843.0,843.0
0.006,17,2,230,1,68,0.0,40.0,40.0,1,162,0.0,134.0,134.0
0.006,6,10,1689,5,839,1.0,571.0,571.0,5,850,1.0,582.0,582.0
0.009,6,10,1989,5,910,2.0,642.0,642.0,5,1079,2.0,811.0,811.0
0.004,6,10,2006,5,927,1.0,659.0,659.0,5,1079,1.0,811.0,811.0
11.019,17,28,4390,14,2312,839.0,587.0,137.0,14,2078,838.0,269.0,120.0
0.006,6,10,2000,5,927,1.0,659.0,659.0,5,1073,1.0,805.0,805.0
0.009,6,10,1989,5,910,2.0,642.0,642.0,5,1079,2.0,811.0,811.0
0.003,17,2,148,1,60,0.0,32.0,32.0,1,88,0.0,60.0,60.0
0.011,6,10,1762,5,911,2.0,643.0,643.0,5,851,2.0,583.0,583.0
0.005,6,10,1689,5,839,1.0,571.0,571.0,5,850,1.0,582.0,582.0
0.008,6,12,1926,6,1189,1.0,659.0,434.0,6,737,1.0,417.0,417.0
0.007,6,10,1983,5,910,1.0,642.0,642.0,5,1073,1.0,805.0,805.0
0.354,17,41,22854,23,18474,16.0,1350.0,775.0,18,4380,16.0,1350.0,215.0
0.005,17,2,187,1,71,0.0,43.0,43.0,1,116,0.0,88.0,88.0
301.04,6,48,19377,26,13470,12041.0,2720.0,1239.0,22,5907,422.0,2667.0,385.0
0.012,6,10,1989,5,910,2.0,642.0,642.0,5,1079,3.0,811.0,811.0
0.117,6,10,1506,5,395,28.0,127.0,127.0,5,1111,25.0,843.0,843.0
10.746,17,28,4418,14,1995,818.0,270.0,114.0,14,2423,818.0,586.0,145.0
0.008,6,10,1990,5,911,1.0,643.0,643.0,5,1079,2.0,811.0,811.0
0.006,17,2,160,1,72,0.0,44.0,44.0,1,88,0.0,60.0,60.0
40.081,17,10,676,5,460,10018.0,104.0,64.0,5,216,10019.0,20.0,15.0
0.018,6,10,1989,5,910,4.0,642.0,642.0,5,1079,4.0,811.0,811.0
0.005,17,2,140,1,62,0.0,34.0,34.0,1,78,0.0,50.0,50.0
0.005,6,10,2006,5,927,1.0,659.0,659.0,5,1079,1.0,811.0,811.0
0.004,17,2,136,1,60,0.0,32.0,32.0,1,76,0.0,48.0,48.0
0.016,6,10,1677,5,827,4.0,559.0,559.0,5,850,4.0,582.0,582.0
0.005,6,10,1989,5,927,1.0,659.0,659.0,5,1062,1.0,794.0,794.0
0.005,6,10,2006,5,927,1.0,659.0,659.0,5,1079,1.0,811.0,811.0
0.001,17,2,180,1,66,0.0,38.0,38.0,1,114,0.0,86.0,86.0
0.004,6,10,1774,5,923,0.0,655.0,655.0,5,851,1.0,583.0,583.0
0.761,6,10,2009,6,1655,152.0,1403.0,1403.0,4,354,172.0,182.0,182.0
0.005,6,10,2006,5,927,1.0,659.0,659.0,5,1079,1.0,811.0,811.0
0.005,17,2,140,1,62,0.0,34.0,34.0,1,78,0.0,50.0,50.0
0.006,6,10,2006,5,927,1.0,659.0,659.0,5,1079,1.0,811.0,811.0
0.005,17,2,140,1,62,0.0,34.0,34.0,1,78,0.0,50.0,50.0
0.01,6,10,1989,5,910,2.0,642.0,642.0,5,1079,2.0,811.0,811.0
1.098,6,30,12711,17,3312,68.0,1360.0,517.0,13,9399,77.0,2720.0,985.0
0.011,6,10,1689,5,839,2.0,571.0,571.0,5,850,2.0,582.0,582.0
0.083,6,10,1506,5,395,17.0,127.0,127.0,5,1111,19.0,843.0,843.0
0.005,17,2,180,1,66,0.0,38.0,38.0,1,114,0.0,86.0,86.0
0.016,6,10,2006,5,927,4.0,659.0,659.0,5,1079,4.0,811.0,811.0
0.001,17,2,180,1,66,0.0,38.0,38.0,1,114,0.0,86.0,86.0
0.022,6,10,1762,5,911,5.0,643.0,643.0,5,851,5.0,583.0,583.0
1770.579,17,92,8096,46,4048,39346.0,60.0,60.0,46,4048,39346.0,60.0,60.0
0.004,17,2,136,1,60,0.0,32.0,32.0,1,76,0.0,48.0,48.0
0.004,17,2,136,1,60,0.0,32.0,32.0,1,76,0.0,48.0,48.0
0.039,17,2,144,1,64,0.0,36.0,36.0,1,80,0.0,52.0,52.0
0.039,17,4,284,2,120,0.0,32.0,32.0,2,164,35.0,60.0,54.0
0.004,17,2,136,1,60,0.0,32.0,32.0,1,76,0.0,48.0,48.0
0.006,6,10,1689,5,839,1.0,571.0,571.0,5,850,1.0,582.0,582.0
0.004,17,2,148,1,60,0.0,32.0,32.0,1,88,0.0,60.0,60.0
0.138,6,204,208150,98,6234,1.0,517.0,281.0,106,201916,1.0,4206.0,1944.0
0.007,6,10,1547,5,764,1.0,496.0,496.0,5,783,1.0,515.0,515.0
0.014,6,10,1990,5,911,3.0,643.0,643.0,5,1079,3.0,811.0,811.0
0.021,6,10,1990,5,911,5.0,643.0,643.0,5,1079,5.0,811.0,811.0
0.039,17,2,136,1,60,0.0,32.0,32.0,1,76,0.0,48.0,48.0
0.005,6,10,2000,5,927,1.0,659.0,659.0,5,1073,1.0,805.0,805.0
0.095,6,10,1506,5,395,20.0,127.0,127.0,5,1111,22.0,843.0,843.0
0.009,6,13,3735,7,497,1.0,125.0,125.0,6,3238,1.0,1470.0,1459.0
0.005,6,13,3747,7,509,0.0,137.0,137.0,6,3238,1.0,1470.0,1459.0
300.715,6,37,8261,20,1830,15827.0,651.0,249.0,17,6431,536.0,2126.0,478.0
0.023,17,2,136,1,60,0.0,32.0,32.0,1,76,0.0,48.0,48.0
40.055,17,10,676,5,460,10012.0,104.0,64.0,5,216,10012.0,20.0,15.0
0.106,6,10,1506,5,395,21.0,127.0,127.0,5,1111,25.0,843.0,843.0
0.004,6,10,2006,5,927,1.0,659.0,659.0,5,1079,1.0,811.0,811.0
0.052,6,10,1983,5,910,12.0,642.0,642.0,5,1073,12.0,805.0,805.0
0.136,6,10,1506,5,395,31.0,127.0,127.0,5,1111,31.0,843.0,843.0
0.041,17,2,152,1,76,0.0,48.0,48.0,1,76,0.0,48.0,48.0
0.083,6,10,1506,5,395,18.0,127.0,127.0,5,1111,18.0,843.0,843.0
0.005,6,10,1989,5,927,1.0,659.0,659.0,5,1062,1.0,794.0,794.0
0.076,6,10,1506,5,395,16.0,127.0,127.0,5,1111,16.0,843.0,843.0
40.066,17,10,676,5,460,10014.0,104.0,64.0,5,216,10015.0,20.0,15.0
0.005,6,10,2006,5,927,1.0,659.0,659.0,5,1079,1.0,811.0,811.0
0.013,6,13,3816,7,578,2.0,206.0,206.0,6,3238,2.0,1470.0,1459.0
0.078,6,10,1506,5,395,16.0,127.0,127.0,5,1111,18.0,843.0,843.0
0.005,17,2,170,1,65,0.0,37.0,37.0,1,105,0.0,77.0,77.0
0.037,17,4,284,2,120,1.0,32.0,32.0,2,164,32.0,60.0,54.0
0.083,6,10,1506,5,395,17.0,127.0,127.0,5,1111,18.0,843.0,843.0
163.539,17,88,12575,44,2942,3803.0,44.0,38.0,44,9633,3803.0,261.0,190.0
0.015,6,10,1983,5,910,3.0,642.0,642.0,5,1073,3.0,805.0,805.0
0.118,6,10,1506,5,395,24.0,127.0,127.0,5,1111,24.0,843.0,843.0
0.006,6,10,1689,5,839,1.0,571.0,571.0,5,850,1.0,582.0,582.0
0.003,17,2,136,1,60,0.0,32.0,32.0,1,76,0.0,48.0,48.0
0.012,6,10,1631,5,848,3.0,580.0,580.0,5,783,3.0,515.0,515.0
0.117,6,10,1506,5,395,26.0,127.0,127.0,5,1111,26.0,843.0,843.0
0.037,17,4,284,2,120,0.0,32.0,32.0,2,164,34.0,60.0,54.0
0.072,17,2,184,1,61,0.0,33.0,33.0,1,123,0.0,95.0,95.0
0.085,6,10,1506,5,395,17.0,127.0,127.0,5,1111,17.0,843.0,843.0
0.071,17,8,3613,4,1874,23.0,1350.0,440.0,4,1739,11.0,1350.0,406.0
0.005,6,10,1547,5,764,1.0,496.0,496.0,5,783,1.0,515.0,515.0
0.004,6,10,2006,5,927,1.0,659.0,659.0,5,1079,1.0,811.0,811.0
120.907,6,54,18860,32,4768,3900.0,1054.0,221.0,22,14092,5757.0,2804.0,1078.0
0.015,6,10,1989,5,910,3.0,642.0,642.0,5,1079,3.0,811.0,811.0
0.005,6,10,2006,5,927,1.0,659.0,659.0,5,1079,1.0,811.0,811.0
1778.104,17,144,45504,72,22752,25043.0,288.0,288.0,72,22752,25043.0,288.0,288.0
0.079,6,10,1506,5,395,16.0,127.0,127.0,5,1111,15.0,843.0,843.0
0.009,6,10,1989,5,910,2.0,642.0,642.0,5,1079,2.0,811.0,811.0
0.005,6,13,3684,7,446,0.0,74.0,74.0,6,3238,1.0,1470.0,1459.0
0.005,17,2,168,1,76,0.0,48.0,48.0,1,92,0.0,64.0,64.0
0.003,17,2,148,1,60,0.0,32.0,32.0,1,88,0.0,60.0,60.0
0.018,6,13,3735,7,497,3.0,125.0,125.0,6,3238,3.0,1470.0,1459.0
0.006,6,10,1689,5,839,1.0,571.0,571.0,5,850,1.0,582.0,582.0
0.004,17,2,148,1,60,0.0,32.0,32.0,1,88,0.0,60.0,60.0
0.004,6,10,1702,5,863,1.0,595.0,595.0,5,839,0.0,571.0,571.0
240.085,6,16,4481,9,963,30010.0,238.0,166.0,7,3518,40013.0,1402.0,786.0
0.003,17,2,160,1,72,0.0,44.0,44.0,1,88,0.0,60.0,60.0
0.023,6,10,1972,5,910,5.0,642.0,642.0,5,1062,5.0,794.0,794.0
0.014,6,13,3735,7,497,2.0,125.0,125.0,6,3238,2.0,1470.0,1459.0
0.022,6,10,1990,5,911,5.0,643.0,643.0,5,1079,5.0,811.0,811.0
0.143,6,10,1506,5,395,32.0,127.0,127.0,5,1111,29.0,843.0,843.0
80.445,6,31,14645,17,6965,5027.0,2720.0,1042.0,14,7680,6172.0,2720.0,1015.0
0.006,17,2,193,1,71,0.0,43.0,43.0,1,122,0.0,94.0,94.0
10.928,17,28,4421,14,1994,832.0,269.0,114.0,14,2427,832.0,586.0,145.0
0.005,6,14,3799,7,509,0.0,137.0,137.0,7,3290,0.0,1448.0,972.0
0.067,17,8,3613,4,1874,22.0,1350.0,440.0,4,1739,11.0,1350.0,406.0
0.087,6,10,1506,5,395,19.0,127.0,127.0,5,1111,18.0,843.0,843.0
0.005,17,2,166,1,75,0.0,47.0,47.0,1,91,0.0,63.0,63.0
0.006,6,10,1643,5,860,1.0,592.0,592.0,5,783,1.0,515.0,515.0
0.012,6,13,3735,7,497,1.0,125.0,125.0,6,3238,2.0,1470.0,1459.0
0.006,6,10,1547,5,764,1.0,496.0,496.0,5,783,1.0,515.0,515.0
0.105,6,10,1506,5,395,23.0,127.0,127.0,5,1111,24.0,843.0,843.0
334.975,17,20,1124,10,716,37205.0,48.0,43.0,10,408,37205.0,20.0,12.0
0.101,6,10,1506,5,395,19.0,127.0,127.0,5,1111,22.0,843.0,843.0
0.001,17,2,180,1,66,0.0,38.0,38.0,1,114,0.0,86.0,86.0
0.066,6,10,1506,5,395,14.0,127.0,127.0,5,1111,14.0,843.0,843.0
0.001,17,2,180,1,66,0.0,38.0,38.0,1,114,0.0,86.0,86.0
0.152,6,10,1506,5,395,34.0,127.0,127.0,5,1111,35.0,843.0,843.0
0.005,6,10,1989,5,927,1.0,659.0,659.0,5,1062,1.0,794.0,794.0
240.127,6,32,9380,16,6873,16008.0,1515.0,604.0,16,2507,16008.0,580.0,208.0
0.084,6,10,1506,5,395,20.0,127.0,127.0,5,1111,19.0,843.0,843.0
240.46,6,35,14620,16,7920,16030.0,1817.0,1013.0,19,6700,13358.0,1656.0,713.0
1770.575,17,92,8096,46,4048,39345.0,60.0,60.0,46,4048,39345.0,60.0,60.0
0.006,6,13,3747,7,509,0.0,137.0,137.0,6,3238,1.0,1470.0,1459.0
298.162,17,118,16799,59,3922,5140.0,44.0,38.0,59,12877,5140.0,239.0,190.0
0.011,6,10,1677,5,827,2.0,559.0,559.0,5,850,2.0,582.0,582.0
360.044,6,21,3981,13,3142,30003.0,494.0,494.0,8,839,51434.0,83.0,83.0
0.011,6,10,1972,5,910,2.0,642.0,642.0,5,1062,2.0,794.0,794.0
0.024,6,10,1983,5,910,5.0,642.0,642.0,5,1073,5.0,805.0,805.0
0.003,17,2,136,1,60,0.0,32.0,32.0,1,76,0.0,48.0,48.0
0.005,6,10,2007,5,928,1.0,660.0,660.0,5,1079,1.0,811.0,811.0
0.009,6,12,1926,6,1189,1.0,659.0,434.0,6,737,1.0,417.0,417.0
0.013,6,10,1990,5,911,3.0,643.0,643.0,5,1079,3.0,811.0,811.0
0.001,17,2,180,1,66,0.0,38.0,38.0,1,114,0.0,86.0,86.0
0.072,6,10,1506,5,395,15.0,127.0,127.0,5,1111,15.0,843.0,843.0
0.012,6,10,1983,5,910,3.0,642.0,642.0,5,1073,3.0,805.0,805.0
0.009,6,10,1972,5,910,2.0,642.0,642.0,5,1062,2.0,794.0,794.0
0.006,6,10,1689,5,839,1.0,571.0,571.0,5,850,1.0,582.0,582.0
0.006,6,10,2007,5,928,1.0,660.0,660.0,5,1079,1.0,811.0,811.0
0.013,6,10,1989,5,910,3.0,642.0,642.0,5,1079,3.0,811.0,811.0
40.064,17,10,676,5,460,10015.0,104.0,64.0,5,216,10015.0,20.0,15.0
0.001,17,2,136,1,60,0.0,32.0,32.0,1,76,0.0,48.0,48.0
0.022,6,13,3913,7,495,3.0,123.0,123.0,6,3418,4.0,1650.0,1549.0
0.011,17,2,148,1,60,0.0,32.0,32.0,1,88,0.0,60.0,60.0
0.215,6,16,2778,8,1396,30.0,533.0,324.0,8,1382,19.0,529.0,239.0
0.009,6,10,1983,5,910,2.0,642.0,642.0,5,1073,2.0,805.0,805.0
0.087,6,10,1506,5,395,20.0,127.0,127.0,5,1111,18.0,843.0,843.0
0.017,6,10,1989,5,910,4.0,642.0,642.0,5,1079,4.0,811.0,811.0
0.006,17,2,170,1,65,0.0,37.0,37.0,1,105,0.0,77.0,77.0
15.112,17,15,8087,8,6038,2151.0,1350.0,726.0,7,2049,2511.0,1350.0,264.0
0.012,6,10,1762,5,911,3.0,643.0,643.0,5,851,3.0,583.0,583.0
0.006,17,2,179,1,71,0.0,43.0,43.0,1,108,0.0,80.0,80.0
0.001,17,2,166,1,75,0.0,47.0,47.0,1,91,0.0,63.0,63.0
0.015,6,10,1989,5,910,3.0,642.0,642.0,5,1079,3.0,811.0,811.0
1778.406,17,144,45504,72,22752,25046.0,288.0,288.0,72,22752,25046.0,288.0,288.0
369.94,6,22,2313,16,867,24662.0,195.0,195.0,6,1446,4649.0,419.0,398.0
240.163,6,29,8943,15,6626,17154.0,1751.0,650.0,14,2317,18473.0,580.0,225.0
0.006,6,10,1689,5,839,1.0,571.0,571.0,5,850,1.0,582.0,582.0
0.005,17,2,170,1,65,0.0,37.0,37.0,1,105,0.0,77.0,77.0
0.128,6,10,1506,5,395,28.0,127.0,127.0,5,1111,29.0,843.0,843.0
0.004,6,10,1774,5,923,1.0,655.0,655.0,5,851,1.0,583.0,583.0
0.039,17,2,182,1,65,0.0,37.0,37.0,1,117,0.0,89.0,89.0
0.016,17,2,198,1,91,0.0,63.0,63.0,1,107,0.0,79.0,79.0
0.01,6,10,1990,5,911,2.0,643.0,643.0,5,1079,2.0,811.0,811.0
0.078,6,10,1506,5,395,18.0,127.0,127.0,5,1111,17.0,843.0,843.0
0.011,6,10,1989,5,910,2.0,642.0,642.0,5,1079,2.0,811.0,811.0
0.003,17,2,148,1,60,0.0,32.0,32.0,1,88,0.0,60.0,60.0
0.006,6,10,1854,5,889,1.0,621.0,621.0,5,965,1.0,697.0,697.0
0.006,17,2,170,1,65,0.0,37.0,37.0,1,105,0.0,77.0,77.0
0.005,17,2,152,1,68,0.0,40.0,40.0,1,84,0.0,56.0,56.0
240.015,6,9,787,5,488,60003.0,232.0,232.0,4,299,80003.0,83.0,83.0
40.051,17,10,676,5,460,10011.0,104.0,64.0,5,216,10012.0,20.0,15.0
0.01,6,10,1762,5,911,2.0,643.0,643.0,5,851,2.0,583.0,583.0
0.072,17,2,136,1,60,0.0,32.0,32.0,1,76,0.0,48.0,48.0
0.004,6,10,2007,5,928,1.0,660.0,660.0,5,1079,1.0,811.0,811.0
40.085,17,10,676,5,460,10020.0,104.0,64.0,5,216,10020.0,20.0,15.0
309.187,17,20,1124,10,716,34340.0,48.0,43.0,10,408,34340.0,20.0,12.0
0.005,6,10,1990,5,928,1.0,660.0,660.0,5,1062,1.0,794.0,794.0
175.303,17,72,10334,36,2402,5008.0,44.0,38.0,36,7932,5008.0,239.0,192.0
0.141,6,10,1506,5,395,29.0,127.0,127.0,5,1111,28.0,843.0,843.0
0.005,6,10,2006,5,927,1.0,659.0,659.0,5,1079,1.0,811.0,811.0
11.214,17,28,4422,14,1994,849.0,269.0,114.0,14,2428,849.0,587.0,145.0
0.01,6,10,1762,5,911,2.0,643.0,643.0,5,851,2.0,583.0,583.0
0.005,6,13,3690,7,452,0.0,80.0,80.0,6,3238,1.0,1470.0,1459.0
0.011,6,13,3735,7,497,1.0,125.0,125.0,6,3238,2.0,1470.0,1459.0
0.001,17,2,180,1,66,0.0,38.0,38.0,1,114,0.0,86.0,86.0
0.014,6,10,1972,5,910,3.0,642.0,642.0,5,1062,3.0,794.0,794.0
0.006,17,2,152,1,68,0.0,40.0,40.0,1,84,0.0,56.0,56.0
0.012,6,10,1983,5,910,3.0,642.0,642.0,5,1073,3.0,805.0,805.0
40.068,17,10,676,5,460,10016.0,104.0,64.0,5,216,10016.0,20.0,15.0
0.006,6,10,2006,5,927,1.0,659.0,659.0,5,1079,1.0,811.0,811.0
0.006,6,10,1643,5,860,1.0,592.0,592.0,5,783,1.0,515.0,515.0
0.006,6,10,1547,5,764,1.0,496.0,496.0,5,783,1.0,515.0,515.0
0.013,6,10,1990,5,911,3.0,643.0,643.0,5,1079,3.0,811.0,811.0
0.005,6,10,2006,5,927,1.0,659.0,659.0,5,1079,1.0,811.0,811.0
176.29,17,70,10045,35,2332,5184.0,44.0,38.0,35,7713,5184.0,261.0,192.0
10.806,17,28,4423,14,1994,823.0,269.0,114.0,14,2429,823.0,588.0,145.0
0.105,6,10,1506,5,395,23.0,127.0,127.0,5,1111,23.0,843.0,843.0
0.005,6,10,1702,5,863,1.0,595.0,595.0,5,839,1.0,571.0,571.0
1772.604,6,314,98382,192,86598,9280.0,2001.0,683.0,122,11784,14649.0,452.0,69.0
0.009,6,10,1972,5,910,2.0,642.0,642.0,5,1062,2.0,794.0,794.0
0.08,6,10,1506,5,395,17.0,127.0,127.0,5,1111,19.0,843.0,843.0
0.005,17,2,179,1,71,0.0,43.0,43.0,1,108,0.0,80.0,80.0
0.005,6,10,1989,5,927,1.0,659.0,659.0,5,1062,1.0,794.0,794.0
49.593,6,318,344697,117,17655,427.0,2736.0,889.0,201,327042,247.0,2916.0,1692.0
0.016,6,10,1989,5,910,4.0,642.0,642.0,5,1079,4.0,811.0,811.0
0.008,6,13,3735,7,497,1.0,125.0,125.0,6,3238,1.0,1470.0,1459.0
0.089,6,10,1506,5,395,20.0,127.0,127.0,5,1111,20.0,843.0,843.0
0.011,6,10,1983,5,910,2.0,642.0,642.0,5,1073,2.0,805.0,805.0
0.098,6,10,1506,5,395,20.0,127.0,127.0,5,1111,20.0,843.0,843.0
0.009,6,10,1989,5,910,2.0,642.0,642.0,5,1079,2.0,811.0,811.0
308.885,17,20,1124,10,716,34306.0,48.0,43.0,10,408,34306.0,20.0,12.0
0.005,6,10,2006,5,927,1.0,659.0,659.0,5,1079,1.0,811.0,811.0
0.006,6,10,1547,5,764,1.0,496.0,496.0,5,783,1.0,515.0,515.0
0.263,6,10,1506,5,395,57.0,127.0,127.0,5,1111,33.0,843.0,843.0
0.01,6,10,1990,5,911,2.0,643.0,643.0,5,1079,2.0,811.0,811.0
0.004,17,2,169,1,62,0.0,34.0,34.0,1,107,0.0,79.0,79.0
1777.922,17,144,45504,72,22752,25041.0,288.0,288.0,72,22752,25041.0,288.0,288.0
0.124,17,2,182,1,65,0.0,37.0,37.0,1,117,0.0,89.0,89.0
0.005,6,10,2006,5,927,1.0,659.0,659.0,5,1079,1.0,811.0,811.0
0.008,6,10,1983,5,910,2.0,642.0,642.0,5,1073,1.0,805.0,805.0
0.214,6,16,2669,8,1395,30.0,533.0,323.0,8,1274,19.0,529.0,212.0
0.105,6,10,1506,5,395,24.0,127.0,127.0,5,1111,25.0,843.0,843.0
0.006,6,10,1689,5,839,1.0,571.0,571.0,5,850,1.0,582.0,582.0
0.004,6,10,2006,5,927,1.0,659.0,659.0,5,1079,1.0,811.0,811.0
40.056,17,10,676,5,460,10013.0,104.0,64.0,5,216,10013.0,20.0,15.0
0.01,6,10,1983,5,910,2.0,642.0,642.0,5,1073,2.0,805.0,805.0
0.001,17,2,180,1,66,0.0,38.0,38.0,1,114,0.0,86.0,86.0
0.053,17,2,152,1,76,0.0,48.0,48.0,1,76,0.0,48.0,48.0
0.01,6,10,1677,5,827,2.0,559.0,559.0,5,850,2.0,582.0,582.0
0.097,6,10,1506,5,395,23.0,127.0,127.0,5,1111,21.0,843.0,843.0
0.006,17,2,214,1,75,0.0,47.0,47.0,1,139,0.0,111.0,111.0
0.014,6,10,1990,5,911,3.0,643.0,643.0,5,1079,3.0,811.0,811.0
0.004,17,2,148,1,60,0.0,32.0,32.0,1,88,0.0,60.0,60.0
40.099,17,10,676,5,460,10021.0,104.0,64.0,5,216,10023.0,20.0,15.0
40.089,17,10,676,5,460,10020.0,104.0,64.0,5,216,10021.0,20.0,15.0
0.008,6,12,1926,6,1189,1.0,659.0,434.0,6,737,1.0,417.0,417.0
0.006,6,10,1547,5,764,1.0,496.0,496.0,5,783,1.0,515.0,515.0
0.004,6,10,1989,5,927,1.0,659.0,659.0,5,1062,1.0,794.0,794.0
0.013,6,11,2041,6,962,2.0,642.0,642.0,5,1079,3.0,811.0,811.0
0.005,6,13,3747,7,509,0.0,137.0,137.0,6,3238,0.0,1470.0,1459.0
0.07,17,8,3613,4,1874,23.0,1350.0,440.0,4,1739,13.0,1350.0,406.0
0.004,6,10,1989,5,927,1.0,659.0,659.0,5,1062,1.0,794.0,794.0
0.088,6,10,1506,5,395,20.0,127.0,127.0,5,1111,19.0,843.0,843.0
0.096,6,10,1506,5,395,22.0,127.0,127.0,5,1111,21.0,843.0,843.0
0.786,6,30,16102,17,9609,49.0,2720.0,1112.0,13,6493,50.0,2720.0,851.0
0.064,6,10,1506,5,395,15.0,127.0,127.0,5,1111,14.0,843.0,843.0
0.014,6,10,1989,5,910,3.0,642.0,642.0,5,1079,3.0,811.0,811.0
0.004,6,10,1989,5,927,1.0,659.0,659.0,5,1062,1.0,794.0,794.0
352.763,6,20,2210,6,1308,12003.0,494.0,494.0,14,902,27135.0,83.0,83.0
0.226,6,16,2670,8,1396,32.0,533.0,324.0,8,1274,20.0,529.0,212.0
0.128,17,4,352,2,130,1.0,37.0,37.0,2,222,124.0,89.0,83.0
0.017,6,10,1989,5,910,4.0,642.0,642.0,5,1079,4.0,811.0,811.0
0.011,6,10,1989,5,910,2.0,642.0,642.0,5,1079,2.0,811.0,811.0
0.011,6,12,1926,6,1189,2.0,659.0,434.0,6,737,2.0,417.0,417.0
0.009,6,12,1926,6,1189,1.0,659.0,434.0,6,737,1.0,417.0,417.0
40.076,17,10,676,5,460,10018.0,104.0,64.0,5,216,10018.0,20.0,15.0
0.005,6,10,2006,5,927,1.0,659.0,659.0,5,1079,1.0,811.0,811.0
40.06,17,10,676,5,460,10014.0,104.0,64.0,5,216,10014.0,20.0,15.0
300.046,6,12,1782,7,1348,50007.0,494.0,494.0,5,434,75010.0,83.0,83.0
0.003,17,2,148,1,60,0.0,32.0,32.0,1,88,0.0,60.0,60.0
0.011,6,10,1989,5,910,2.0,642.0,642.0,5,1079,2.0,811.0,811.0
0.131,6,10,1506,5,395,31.0,127.0,127.0,5,1111,27.0,843.0,843.0
0.005,6,10,2000,5,927,1.0,659.0,659.0,5,1073,1.0,805.0,805.0
0.005,6,10,1643,5,860,1.0,592.0,592.0,5,783,1.0,515.0,515.0
0.006,17,2,136,1,60,0.0,32.0,32.0,1,76,0.0,48.0,48.0
0.101,6,10,1506,5,395,21.0,127.0,127.0,5,1111,24.0,843.0,843.0
0.005,6,10,1547,5,764,1.0,496.0,496.0,5,783,1.0,515.0,515.0
0.276,6,10,1506,5,395,58.0,127.0,127.0,5,1111,41.0,843.0,843.0
0.006,6,10,1643,5,860,1.0,592.0,592.0,5,783,1.0,515.0,515.0
0.103,6,10,1506,5,395,23.0,127.0,127.0,5,1111,22.0,843.0,843.0
11.106,17,28,4366,14,2312,845.0,587.0,137.0,14,2054,845.0,269.0,118.0
367.256,6,22,2313,16,867,24483.0,195.0,195.0,6,1446,4634.0,419.0,398.0
0.007,6,10,1547,5,764,1.0,496.0,496.0,5,783,1.0,515.0,515.0
0.008,17,2,214,1,75,0.0,47.0,47.0,1,139,0.0,111.0,111.0
0.109,6,10,1506,5,395,25.0,127.0,127.0,5,1111,25.0,843.0,843.0
367.271,6,22,2313,16,867,24484.0,195.0,195.0,6,1446,4642.0,419.0,398.0
0.005,17,2,146,1,65,0.0,37.0,37.0,1,81,0.0,53.0,53.0
0.01,6,10,1990,5,911,2.0,643.0,643.0,5,1079,2.0,811.0,811.0
289.339,6,402,348151,188,21342,1547.0,2736.0,889.0,214,326809,1358.0,2804.0,1578.0
0.013,6,10,1972,5,910,3.0,642.0,642.0,5,1062,3.0,794.0,794.0
0.005,6,13,3747,7,509,0.0,137.0,137.0,6,3238,1.0,1470.0,1459.0
0.012,6,10,1989,5,910,2.0,642.0,642.0,5,1079,2.0,811.0,811.0
0.014,6,13,3735,7,497,2.0,125.0,125.0,6,3238,2.0,1470.0,1459.0
0.004,6,10,2000,5,927,1.0,659.0,659.0,5,1073,1.0,805.0,805.0
0.012,6,10,1989,5,910,3.0,642.0,642.0,5,1079,2.0,811.0,811.0
240.119,6,32,9225,16,6791,16007.0,1865.0,662.0,16,2434,16007.0,580.0,199.0
0.005,6,10,1689,5,839,1.0,571.0,571.0,5,850,1.0,582.0,582.0
0.014,6,10,1990,5,911,3.0,643.0,643.0,5,1079,3.0,811.0,811.0
0.006,17,2,170,1,65,0.0,37.0,37.0,1,105,0.0,77.0,77.0
0.005,6,10,2006,5,927,1.0,659.0,659.0,5,1079,1.0,811.0,811.0
240.092,6,31,9165,15,6786,17149.0,1911.0,667.0,16,2379,16005.0,580.0,192.0
0.005,6,10,2006,5,927,1.0,659.0,659.0,5,1079,1.0,811.0,811.0
10.777,17,28,4418,14,1994,820.0,269.0,114.0,14,2424,820.0,587.0,145.0
300.023,6,12,1782,7,1348,50003.0,494.0,494.0,5,434,75005.0,83.0,83.0
0.083,6,10,1506,5,395,19.0,127.0,127.0,5,1111,17.0,843.0,843.0
0.001,17,2,180,1,66,0.0,38.0,38.0,1,114,0.0,86.0,86.0
0.017,6,10,1972,5,910,4.0,642.0,642.0,5,1062,4.0,794.0,794.0
40.067,17,10,676,5,460,10014.0,104.0,64.0,5,216,10015.0,20.0,15.0
27.128,6,46,15118,23,9126,415.0,3289.0,1360.0,23,5992,1225.0,2667.0,361.0
0.006,6,10,1643,5,860,1.0,592.0,592.0,5,783,1.0,515.0,515.0
0.004,6,13,3747,7,509,0.0,137.0,137.0,6,3238,0.0,1470.0,1459.0
366.852,6,22,2313,16,867,24456.0,195.0,195.0,6,1446,4639.0,419.0,398.0
0.005,6,10,2000,5,927,1.0,659.0,659.0,5,1073,1.0,805.0,805.0
0.014,17,2,170,1,65,0.0,37.0,37.0,1,105,0.0,77.0,77.0
0.134,6,10,1506,5,395,31.0,127.0,127.0,5,1111,31.0,843.0,843.0
0.008,6,12,1926,6,1189,1.0,659.0,434.0,6,737,1.0,417.0,417.0
0.768,6,22,5072,11,1250,65.0,325.0,133.0,11,3822,65.0,1414.0,563.0
0.005,17,2,140,1,62,0.0,34.0,34.0,1,78,0.0,50.0,50.0
0.099,6,10,1506,5,395,20.0,127.0,127.0,5,1111,20.0,843.0,843.0
0.011,6,10,1990,5,911,2.0,643.0,643.0,5,1079,2.0,811.0,811.0
0.006,6,10,1643,5,860,1.0,592.0,592.0,5,783,1.0,515.0,515.0
1.082,6,32,12795,18,3352,63.0,1360.0,517.0,14,9443,68.0,2565.0,887.0
0.109,6,10,1506,5,395,22.0,127.0,127.0,5,1111,22.0,843.0,843.0
0.004,17,2,136,1,60,0.0,32.0,32.0,1,76,0.0,48.0,48.0
0.001,17,2,180,1,66,0.0,38.0,38.0,1,114,0.0,86.0,86.0
0.089,6,10,1506,5,395,17.0,127.0,127.0,5,1111,21.0,843.0,843.0
0.012,6,10,1983,5,910,2.0,642.0,642.0,5,1073,3.0,805.0,805.0
0.003,17,2,185,1,73,0.0,45.0,45.0,1,112,0.0,84.0,84.0
0.119,6,10,1506,5,395,27.0,127.0,127.0,5,1111,25.0,843.0,843.0
0.041,17,4,284,2,120,0.0,32.0,32.0,2,164,31.0,60.0,54.0
0.006,6,10,2007,5,928,1.0,660.0,660.0,5,1079,1.0,811.0,811.0
0.005,6,10,1854,5,889,1.0,621.0,621.0,5,965,1.0,697.0,697.0
0.216,6,16,2777,8,1395,30.0,533.0,323.0,8,1382,19.0,529.0,239.0
0.102,6,10,1506,5,395,19.0,127.0,127.0,5,1111,21.0,843.0,843.0
0.005,6,10,1989,5,927,1.0,659.0,659.0,5,1062,1.0,794.0,794.0
0.003,17,2,136,1,60,0.0,32.0,32.0,1,76,0.0,48.0,48.0
0.01,6,10,1989,5,910,2.0,642.0,642.0,5,1079,2.0,811.0,811.0
0.012,6,10,1990,5,911,3.0,643.0,643.0,5,1079,3.0,811.0,811.0
40.078,17,10,676,5,460,10018.0,104.0,64.0,5,216,10018.0,20.0,15.0
0.084,6,10,1506,5,395,20.0,127.0,127.0,5,1111,18.0,843.0,843.0
0.073,6,10,1506,5,395,17.0,127.0,127.0,5,1111,17.0,843.0,843.0
0.014,6,10,1990,5,911,3.0,643.0,643.0,5,1079,3.0,811.0,811.0
0.009,6,12,1926,6,1189,1.0,659.0,434.0,6,737,1.0,417.0,417.0
0.004,6,10,1779,5,928,1.0,660.0,660.0,5,851,1.0,583.0,583.0
0.015,6,10,1989,5,910,3.0,642.0,642.0,5,1079,3.0,811.0,811.0
0.006,6,10,1689,5,839,1.0,571.0,571.0,5,850,1.0,582.0,582.0
413.285,6,29,4409,12,3102,10911.0,494.0,494.0,17,1307,25830.0,83.0,83.0
0.005,17,2,144,1,64,0.0,36.0,36.0,1,80,0.0,52.0,52.0
0.009,6,10,1972,5,910,2.0,642.0,642.0,5,1062,2.0,794.0,794.0
0.04,17,2,144,1,64,0.0,36.0,36.0,1,80,0.0,52.0,52.0
0.012,6,10,1989,5,910,2.0,642.0,642.0,5,1079,2.0,811.0,811.0
66.091,6,30,17792,14,9515,5083.0,2804.0,1465.0,16,8277,4397.0,2316.0,743.0
0.005,6,10,2000,5,927,1.0,659.0,659.0,5,1073,1.0,805.0,805.0
0.005,17,2,222,1,65,0.0,37.0,37.0,1,157,0.0,129.0,129.0
0.056,17,2,179,1,71,0.0,43.0,43.0,1,108,0.0,80.0,80.0
0.006,17,2,273,1,66,0.0,38.0,38.0,1,207,0.0,179.0,179.0
15.073,17,15,8141,8,6052,2149.0,1350.0,728.0,7,2089,2507.0,1350.0,270.0
0.01,6,10,1983,5,910,2.0,642.0,642.0,5,1073,2.0,805.0,805.0
0.126,6,10,1506,5,395,30.0,127.0,127.0,5,1111,29.0,843.0,843.0
40.071,17,10,676,5,460,10016.0,104.0,64.0,5,216,10016.0,20.0,15.0
0.065,6,10,1506,5,395,14.0,127.0,127.0,5,1111,14.0,843.0,843.0
0.005,6,10,1989,5,927,1.0,659.0,659.0,5,1062,1.0,794.0,794.0
0.007,6,10,1989,5,910,1.0,642.0,642.0,5,1079,1.0,811.0,811.0
0.005,6,10,1989,5,927,1.0,659.0,659.0,5,1062,1.0,794.0,794.0
298.151,6,415,391206,222,375711,1348.0,4080.0,1881.0,193,15495,1552.0,2667.0,209.0
0.009,6,10,1990,5,911,2.0,643.0,643.0,5,1079,2.0,811.0,811.0
0.072,6,10,1506,5,395,15.0,127.0,127.0,5,1111,13.0,843.0,843.0
0.007,17,2,179,1,71,0.0,43.0,43.0,1,108,0.0,80.0,80.0
0.021,6,10,1989,5,910,5.0,642.0,642.0,5,1079,5.0,811.0,811.0
0.005,6,10,1643,5,860,1.0,592.0,592.0,5,783,1.0,515.0,515.0
0.005,6,10,1689,5,839,1.0,571.0,571.0,5,850,1.0,582.0,582.0
240.012,6,9,787,5,488,60003.0,232.0,232.0,4,299,80003.0,83.0,83.0
240.186,6,40,5366,20,2426,12641.0,588.0,196.0,20,2940,12641.0,580.0,236.0
0.014,6,10,1989,5,910,3.0,642.0,642.0,5,1079,3.0,811.0,811.0
0.006,6,10,1854,5,889,1.0,621.0,621.0,5,965,1.0,697.0,697.0
0.001,17,2,180,1,66,0.0,38.0,38.0,1,114,0.0,86.0,86.0
312.55,17,20,1124,10,716,34713.0,48.0,43.0,10,408,34713.0,20.0,12.0
0.004,6,10,2000,5,927,1.0,659.0,659.0,5,1073,1.0,805.0,805.0
0.086,6,10,1506,5,395,20.0,127.0,127.0,5,1111,19.0,843.0,843.0
0.077,6,10,1506,5,395,15.0,127.0,127.0,5,1111,18.0,843.0,843.0
0.004,6,10,2007,5,928,1.0,660.0,660.0,5,1079,1.0,811.0,811.0
0.006,6,10,2006,5,927,1.0,659.0,659.0,5,1079,1.0,811.0,811.0
0.005,6,10,1689,5,839,1.0,571.0,571.0,5,850,1.0,582.0,582.0
0.015,6,10,1983,5,910,3.0,642.0,642.0,5,1073,3.0,805.0,805.0
0.013,6,10,1972,5,910,3.0,642.0,642.0,5,1062,3.0,794.0,794.0
352.247,6,20,2210,6,1308,12003.0,494.0,494.0,14,902,27095.0,83.0,83.0
0.14,6,10,1506,5,395,31.0,127.0,127.0,5,1111,32.0,843.0,843.0
0.009,6,12,1926,6,1189,1.0,659.0,434.0,6,737,1.0,417.0,417.0
0.02,6,13,3735,7,497,3.0,125.0,125.0,6,3238,4.0,1470.0,1459.0
0.126,6,10,1506,5,395,24.0,127.0,127.0,5,1111,25.0,843.0,843.0
0.009,6,10,1989,5,910,2.0,642.0,642.0,5,1079,2.0,811.0,811.0
0.066,6,10,1506,5,395,14.0,127.0,127.0,5,1111,14.0,843.0,843.0
351.988,6,20,2210,6,1308,12003.0,494.0,494.0,14,902,27075.0,83.0,83.0
0.005,17,2,164,1,74,0.0,46.0,46.0,1,90,0.0,62.0,62.0
0.011,6,10,1990,5,911,2.0,643.0,643.0,5,1079,2.0,811.0,811.0
0.135,6,10,1506,5,395,32.0,127.0,127.0,5,1111,28.0,843.0,843.0
0.006,6,10,1547,5,764,1.0,496.0,496.0,5,783,1.0,515.0,515.0
0.003,17,2,148,1,60,0.0,32.0,32.0,1,88,0.0,60.0,60.0
0.015,6,10,1677,5,827,3.0,559.0,559.0,5,850,3.0,582.0,582.0
174.167,17,88,12628,44,2960,4050.0,44.0,39.0,44,9668,4050.0,249.0,191.0
0.007,6,10,1547,5,764,1.0,496.0,496.0,5,783,1.0,515.0,515.0
0.004,17,2,136,1,60,0.0,32.0,32.0,1,76,0.0,48.0,48.0
0.006,6,10,1547,5,764,1.0,496.0,496.0,5,783,1.0,515.0,515.0
0.004,6,10,1779,5,928,1.0,660.0,660.0,5,851,1.0,583.0,583.0
1769.038,17,92,8096,46,4048,39311.0,60.0,60.0,46,4048,39311.0,60.0,60.0
292.765,6,306,342822,120,17796,2460.0,2736.0,889.0,186,325026,1582.0,2804.0,1833.0
0.005,17,2,144,1,64,0.0,36.0,36.0,1,80,0.0,52.0,52.0
0.038,17,2,182,1,65,0.0,37.0,37.0,1,117,0.0,89.0,89.0
0.01,6,10,1990,5,911,2.0,643.0,643.0,5,1079,2.0,811.0,811.0
11.59,17,87,45316,39,16606,305.0,1350.0,397.0,48,28710,245.0,1350.0,570.0
0.005,6,10,1643,5,860,1.0,592.0,592.0,5,783,1.0,515.0,515.0
240.016,6,9,787,5,488,60004.0,232.0,232.0,4,299,80004.0,83.0,83.0
0.005,6,10,1854,5,889,1.0,621.0,621.0,5,965,1.0,697.0,697.0
0.041,17,2,152,1,76,0.0,48.0,48.0,1,76,0.0,48.0,48.0
0.015,6,10,1990,5,911,3.0,643.0,643.0,5,1079,3.0,811.0,811.0
240.016,6,9,787,5,488,60004.0,232.0,232.0,4,299,80004.0,83.0,83.0
0.021,6,10,1983,5,910,5.0,642.0,642.0,5,1073,5.0,805.0,805.0
0.097,6,10,1506,5,395,21.0,127.0,127.0,5,1111,21.0,843.0,843.0
0.216,6,16,2778,8,1396,30.0,533.0,324.0,8,1382,19.0,529.0,239.0
1777.982,17,144,45504,72,22752,25041.0,288.0,288.0,72,22752,25041.0,288.0,288.0
0.004,17,2,136,1,60,0.0,32.0,32.0,1,76,0.0,48.0,48.0
0.004,6,10,1774,5,923,1.0,655.0,655.0,5,851,1.0,583.0,583.0
0.015,6,10,1983,5,910,3.0,642.0,642.0,5,1073,3.0,805.0,805.0
0.007,17,2,194,1,59,0.0,31.0,31.0,1,135,0.0,107.0,107.0
0.012,6,10,2007,5,928,3.0,660.0,660.0,5,1079,2.0,811.0,811.0
0.073,6,10,1506,5,395,16.0,127.0,127.0,5,1111,15.0,843.0,843.0
0.039,17,2,152,1,76,0.0,48.0,48.0,1,76,0.0,48.0,48.0
0.005,17,2,166,1,75,0.0,47.0,47.0,1,91,0.0,63.0,63.0
40.059,17,10,676,5,460,10012.0,104.0,64.0,5,216,10013.0,20.0,15.0
0.006,6,10,1643,5,860,1.0,592.0,592.0,5,783,1.0,515.0,515.0
0.116,6,10,1506,5,395,26.0,127.0,127.0,5,1111,25.0,843.0,843.0
0.042,17,4,284,2,120,2.0,32.0,32.0,2,164,38.0,60.0,54.0
0.095,6,10,1506,5,395,20.0,127.0,127.0,5,1111,22.0,843.0,843.0
0.003,6,10,1702,5,863,0.0,595.0,595.0,5,839,0.0,571.0,571.0
310.559,17,18,1008,9,640,38803.0,48.0,43.0,9,368,38803.0,20.0,12.0
0.018,6,10,1990,5,911,4.0,643.0,643.0,5,1079,4.0,811.0,811.0
0.015,6,10,1677,5,827,3.0,559.0,559.0,5,850,3.0,582.0,582.0
0.019,6,10,1989,5,910,4.0,642.0,642.0,5,1079,4.0,811.0,811.0
0.105,6,10,1506,5,395,23.0,127.0,127.0,5,1111,21.0,843.0,843.0
0.005,6,10,1689,5,839,1.0,571.0,571.0,5,850,1.0,582.0,582.0
240.091,6,16,4481,9,963,30011.0,238.0,166.0,7,3518,40014.0,1402.0,786.0
0.009,6,10,1990,5,911,2.0,643.0,643.0,5,1079,2.0,811.0,811.0
0.011,6,10,1989,5,910,2.0,642.0,642.0,5,1079,2.0,811.0,811.0
40.055,17,10,676,5,460,10009.0,104.0,64.0,5,216,10012.0,20.0,15.0
0.031,6,10,1983,5,910,7.0,642.0,642.0,5,1073,7.0,805.0,805.0
0.005,6,10,1689,5,839,1.0,571.0,571.0,5,850,1.0,582.0,582.0
0.075,6,10,1506,5,395,16.0,127.0,127.0,5,1111,16.0,843.0,843.0
0.009,6,13,3735,7,497,1.0,125.0,125.0,6,3238,1.0,1470.0,1459.0
0.015,6,10,1983,5,910,3.0,642.0,642.0,5,1073,3.0,805.0,805.0
0.08,6,10,1506,5,395,16.0,127.0,127.0,5,1111,18.0,843.0,843.0
300.141,6,32,19978,18,14753,17655.0,2736.0,1534.0,14,5225,23087.0,1656.0,1125.0
0.085,6,10,1506,5,395,19.0,127.0,127.0,5,1111,20.0,843.0,843.0
0.011,6,13,3735,7,497,1.0,125.0,125.0,6,3238,2.0,1470.0,1459.0
0.01,6,10,1989,5,910,2.0,642.0,642.0,5,1079,2.0,811.0,811.0
0.013,6,10,1631,5,848,3.0,580.0,580.0,5,783,3.0,515.0,515.0
0.005,17,2,164,1,74,0.0,46.0,46.0,1,90,0.0,62.0,62.0
0.216,6,16,2670,8,1396,30.0,533.0,324.0,8,1274,19.0,529.0,212.0
40.06,17,10,676,5,460,10013.0,104.0,64.0,5,216,10014.0,20.0,15.0
0.012,17,2,136,1,60,0.0,32.0,32.0,1,76,0.0,48.0,48.0
0.075,6,10,1506,5,395,16.0,127.0,127.0,5,1111,16.0,843.0,843.0
0.018,6,10,1983,5,910,4.0,642.0,642.0,5,1073,4.0,805.0,805.0
0.008,6,10,1989,5,910,2.0,642.0,642.0,5,1079,2.0,811.0,811.0
0.007,17,2,179,1,71,0.0,43.0,43.0,1,108,0.0,80.0,80.0
0.004,6,10,1989,5,927,1.0,659.0,659.0,5,1062,1.0,794.0,794.0
0.003,17,2,148,1,60,0.0,32.0,32.0,1,88,0.0,60.0,60.0
0.003,17,2,132,1,58,0.0,30.0,30.0,1,74,0.0,46.0,46.0
240.217,6,27,4623,13,1876,20017.0,555.0,238.0,14,2747,18477.0,1212.0,252.0
240.105,6,31,8926,15,6697,17150.0,1823.0,657.0,16,2229,16006.0,580.0,173.0
240.018,6,9,787,5,488,60004.0,232.0,232.0,4,299,80004.0,83.0,83.0
368.833,6,22,2313,16,867,24588.0,195.0,195.0,6,1446,4637.0,419.0,398.0
1.07,6,31,12753,17,3312,66.0,1360.0,517.0,14,9441,69.0,2720.0,985.0
0.021,6,10,1983,5,910,5.0,642.0,642.0,5,1073,5.0,805.0,805.0
0.019,6,10,1990,5,911,4.0,643.0,643.0,5,1079,4.0,811.0,811.0
0.011,6,10,1990,5,911,2.0,643.0,643.0,5,1079,2.0,811.0,811.0
0.098,6,10,1506,5,395,19.0,127.0,127.0,5,1111,21.0,843.0,843.0
0.001,17,2,180,1,66,0.0,38.0,38.0,1,114,0.0,86.0,86.0
0.003,17,4,284,2,120,0.0,32.0,32.0,2,164,0.0,60.0,54.0
0.024,6,10,1762,5,911,5.0,643.0,643.0,5,851,6.0,583.0,583.0
0.001,17,2,164,1,74,0.0,46.0,46.0,1,90,0.0,62.0,62.0
0.001,17,2,142,1,63,0.0,35.0,35.0,1,79,0.0,51.0,51.0
0.017,6,10,1990,5,911,4.0,643.0,643.0,5,1079,4.0,811.0,811.0
174.342,17,78,11301,39,2597,4587.0,44.0,38.0,39,8704,4587.0,261.0,195.0
0.095,6,10,1506,5,395,21.0,127.0,127.0,5,1111,23.0,843.0,843.0
241.386,6,309,343843,118,17648,2063.0,2736.0,959.0,191,326195,1270.0,2804.0,1747.0
0.11,6,10,1506,5,395,24.0,127.0,127.0,5,1111,25.0,843.0,843.0
0.069,6,10,1506,5,395,14.0,127.0,127.0,5,1111,17.0,843.0,843.0
0.003,17,2,148,1,60,0.0,32.0,32.0,1,88,0.0,60.0,60.0
0.018,6,10,1762,5,911,4.0,643.0,643.0,5,851,4.0,583.0,583.0
0.037,17,4,420,2,122,0.0,33.0,33.0,2,298,33.0,145.0,121.0
0.231,6,16,2777,8,1395,33.0,533.0,323.0,8,1382,21.0,529.0,239.0
0.012,6,10,1990,5,911,3.0,643.0,643.0,5,1079,2.0,811.0,811.0
0.022,6,10,1972,5,910,5.0,642.0,642.0,5,1062,5.0,794.0,794.0
0.006,6,10,2000,5,927,1.0,659.0,659.0,5,1073,1.0,805.0,805.0
0.019,6,10,1983,5,910,4.0,642.0,642.0,5,1073,4.0,805.0,805.0
0.01,17,2,148,1,60,0.0,32.0,32.0,1,88,0.0,60.0,60.0
240.741,6,48,12177,24,6126,10466.0,1368.0,485.0,24,6051,10466.0,1666.0,531.0
0.012,6,13,3735,7,497,1.0,125.0,125.0,6,3238,2.0,1470.0,1459.0
0.006,6,10,1547,5,764,1.0,496.0,496.0,5,783,1.0,515.0,515.0
1756.063,6,105,6240,60,3510,29763.0,26.0,26.0,45,2730,39909.0,26.0,26.0
0.076,6,10,1506,5,395,17.0,127.0,127.0,5,1111,14.0,843.0,843.0
0.004,6,10,1989,5,927,1.0,659.0,659.0,5,1062,1.0,794.0,794.0
71.935,6,32,17807,15,9602,5138.0,2804.0,1471.0,17,8205,4488.0,2430.0,1218.0
0.041,17,2,148,1,60,0.0,32.0,32.0,1,88,0.0,60.0,60.0
0.015,6,10,1989,5,910,3.0,642.0,642.0,5,1079,3.0,811.0,811.0
0.017,6,13,3735,7,497,2.0,125.0,125.0,6,3238,3.0,1470.0,1459.0
40.06,17,10,676,5,460,10014.0,104.0,64.0,5,216,10011.0,20.0,15.0
0.005,6,10,1689,5,839,1.0,571.0,571.0,5,850,1.0,582.0,582.0
0.015,6,10,1762,5,911,3.0,643.0,643.0,5,851,3.0,583.0,583.0
0.072,6,10,1506,5,395,16.0,127.0,127.0,5,1111,15.0,843.0,843.0
0.023,6,10,1677,5,827,5.0,559.0,559.0,5,850,5.0,582.0,582.0
0.005,6,10,1989,5,927,1.0,659.0,659.0,5,1062,1.0,794.0,794.0
0.007,17,2,179,1,71,0.0,43.0,43.0,1,108,0.0,80.0,80.0
0.006,6,10,1989,5,927,1.0,659.0,659.0,5,1062,1.0,794.0,794.0
0.005,6,10,2000,5,927,1.0,659.0,659.0,5,1073,1.0,805.0,805.0
0.072,17,2,136,1,60,0.0,32.0,32.0,1,76,0.0,48.0,48.0
0.042,17,2,184,1,61,0.0,33.0,33.0,1,123,0.0,95.0,95.0
0.037,17,2,148,1,60,0.0,32.0,32.0,1,88,0.0,60.0,60.0
0.001,17,2,136,1,60,0.0,32.0,32.0,1,76,0.0,48.0,48.0
0.012,6,10,1990,5,911,3.0,643.0,643.0,5,1079,2.0,811.0,811.0
0.006,17,2,179,1,71,0.0,43.0,43.0,1,108,0.0,80.0,80.0
0.042,17,2,169,1,62,0.0,34.0,34.0,1,107,0.0,79.0,79.0
0.038,17,4,284,2,120,0.0,32.0,32.0,2,164,34.0,60.0,54.0
0.149,6,10,1506,5,395,34.0,127.0,127.0,5,1111,33.0,843.0,843.0
0.005,6,10,2007,5,928,1.0,660.0,660.0,5,1079,1.0,811.0,811.0
0.012,6,10,1990,5,911,3.0,643.0,643.0,5,1079,3.0,811.0,811.0
0.011,6,10,1989,5,910,2.0,642.0,642.0,5,1079,2.0,811.0,811.0
0.062,6,10,1506,5,395,14.0,127.0,127.0,5,1111,14.0,843.0,843.0
0.081,6,10,1506,5,395,17.0,127.0,127.0,5,1111,18.0,843.0,843.0
0.006,6,10,1643,5,860,1.0,592.0,592.0,5,783,1.0,515.0,515.0
0.013,6,10,1972,5,910,3.0,642.0,642.0,5,1062,3.0,794.0,794.0
0.01,6,13,3735,7,497,1.0,125.0,125.0,6,3238,1.0,1470.0,1459.0
0.015,6,10,1972,5,910,3.0,642.0,642.0,5,1062,3.0,794.0,794.0
40.058,17,10,676,5,460,10013.0,104.0,64.0,5,216,10013.0,20.0,15.0
0.004,6,10,1989,5,927,1.0,659.0,659.0,5,1062,1.0,794.0,794.0
0.005,6,10,2007,5,928,1.0,660.0,660.0,5,1079,1.0,811.0,811.0
0.005,6,10,1689,5,839,1.0,571.0,571.0,5,850,1.0,582.0,582.0
0.012,6,10,1990,5,911,2.0,643.0,643.0,5,1079,3.0,811.0,811.0
0.009,6,10,1972,5,910,2.0,642.0,642.0,5,1062,2.0,794.0,794.0
0.007,6,10,1547,5,764,1.0,496.0,496.0,5,783,1.0,515.0,515.0
0.003,17,4,284,2,120,0.0,32.0,32.0,2,164,0.0,60.0,54.0
0.01,17,2,166,1,75,0.0,47.0,47.0,1,91,0.0,63.0,63.0
0.123,6,10,1506,5,395,28.0,127.0,127.0,5,1111,27.0,843.0,843.0
10.921,17,28,4423,14,1995,831.0,270.0,114.0,14,2428,831.0,587.0,145.0
0.014,6,10,1972,5,910,3.0,642.0,642.0,5,1062,3.0,794.0,794.0
0.053,17,2,152,1,76,0.0,48.0,48.0,1,76,0.0,48.0,48.0
0.01,6,10,1983,5,910,2.0,642.0,642.0,5,1073,2.0,805.0,805.0
0.015,17,2,136,1,60,0.0,32.0,32.0,1,76,0.0,48.0,48.0
0.005,6,10,2006,5,927,1.0,659.0,659.0,5,1079,1.0,811.0,811.0
0.001,17,2,180,1,66,0.0,38.0,38.0,1,114,0.0,86.0,86.0
0.006,17,2,170,1,65,0.0,37.0,37.0,1,105,0.0,77.0,77.0
0.019,6,13,3735,7,497,3.0,125.0,125.0,6,3238,3.0,1470.0,1459.0
0.002,17,2,174,1,72,0.0,44.0,44.0,1,102,0.0,74.0,74.0
0.005,6,10,1990,5,928,1.0,660.0,660.0,5,1062,1.0,794.0,794.0
0.123,6,10,1506,5,395,27.0,127.0,127.0,5,1111,26.0,843.0,843.0
0.008,6,10,1983,5,910,2.0,642.0,642.0,5,1073,1.0,805.0,805.0
0.004,17,4,284,2,120,1.0,32.0,32.0,2,164,0.0,60.0,54.0
354.016,6,21,1794,16,1030,23601.0,190.0,190.0,5,764,60003.0,463.0,248.0
0.087,6,10,1506,5,395,19.0,127.0,127.0,5,1111,19.0,843.0,843.0
0.008,6,10,1989,5,910,2.0,642.0,642.0,5,1079,2.0,811.0,811.0
0.016,6,10,1989,5,910,3.0,642.0,642.0,5,1079,4.0,811.0,811.0
9.037,17,6,376,5,280,2259.0,28.0,28.0,1,96,0.0,68.0,68.0
178.757,17,78,11041,39,2602,4703.0,44.0,38.0,39,8439,4703.0,239.0,188.0
0.004,17,2,136,1,60,0.0,32.0,32.0,1,76,0.0,48.0,48.0
0.004,6,10,2006,5,927,1.0,659.0,659.0,5,1079,1.0,811.0,811.0
0.166,17,2,152,1,76,0.0,48.0,48.0,1,76,0.0,48.0,48.0
0.005,6,10,2007,5,928,1.0,660.0,660.0,5,1079,1.0,811.0,811.0
0.011,6,10,1990,5,911,2.0,643.0,643.0,5,1079,2.0,811.0,811.0
0.006,6,10,1547,5,764,1.0,496.0,496.0,5,783,1.0,515.0,515.0
0.439,6,47,12315,25,3881,18.0,1081.0,215.0,22,8434,20.0,2694.0,725.0
0.115,6,10,1506,5,395,25.0,127.0,127.0,5,1111,24.0,843.0,843.0
0.001,17,2,180,1,66,0.0,38.0,38.0,1,114,0.0,86.0,86.0
0.003,17,2,136,1,60,0.0,32.0,32.0,1,76,0.0,48.0,48.0
0.096,6,10,1506,5,395,20.0,127.0,127.0,5,1111,21.0,843.0,843.0
0.022,6,10,1631,5,848,5.0,580.0,580.0,5,783,5.0,515.0,515.0
0.124,17,2,80,1,32,0.0,4.0,4.0,1,48,0.0,20.0,20.0
0.005,6,13,3690,7,452,0.0,80.0,80.0,6,3238,0.0,1470.0,1459.0
0.08,6,10,1506,5,395,16.0,127.0,127.0,5,1111,17.0,843.0,843.0
0.006,6,10,1547,5,764,1.0,496.0,496.0,5,783,1.0,515.0,515.0
0.009,6,10,1989,5,910,2.0,642.0,642.0,5,1079,2.0,811.0,811.0
0.021,6,13,3735,7,497,3.0,125.0,125.0,6,3238,4.0,1470.0,1459.0
0.067,6,10,1506,5,395,15.0,127.0,127.0,5,1111,15.0,843.0,843.0
0.005,6,10,2000,5,927,1.0,659.0,659.0,5,1073,1.0,805.0,805.0
0.069,6,10,1506,5,395,15.0,127.0,127.0,5,1111,14.0,843.0,843.0
40.075,17,10,676,5,460,10017.0,104.0,64.0,5,216,10018.0,20.0,15.0
0.071,6,10,1506,5,395,16.0,127.0,127.0,5,1111,16.0,843.0,843.0
0.003,17,2,148,1,60,0.0,32.0,32.0,1,88,0.0,60.0,60.0
0.005,17,2,213,1,69,0.0,41.0,41.0,1,144,0.0,116.0,116.0
0.115,6,10,1506,5,395,22.0,127.0,127.0,5,1111,25.0,843.0,843.0
0.009,6,10,1972,5,910,2.0,642.0,642.0,5,1062,2.0,794.0,794.0
0.016,6,10,1989,5,910,4.0,642.0,642.0,5,1079,3.0,811.0,811.0
0.015,6,10,1989,5,910,3.0,642.0,642.0,5,1079,3.0,811.0,811.0
0.006,6,10,1854,5,889,1.0,621.0,621.0,5,965,1.0,697.0,697.0
0.011,6,10,1631,5,848,2.0,580.0,580.0,5,783,2.0,515.0,515.0
0.005,17,2,170,1,65,0.0,37.0,37.0,1,105,0.0,77.0,77.0
0.017,6,10,1989,5,910,4.0,642.0,642.0,5,1079,4.0,811.0,811.0
0.076,6,10,1506,5,395,17.0,127.0,127.0,5,1111,16.0,843.0,843.0
0.072,17,2,184,1,61,0.0,33.0,33.0,1,123,0.0,95.0,95.0
0.001,17,2,180,1,66,0.0,38.0,38.0,1,114,0.0,86.0,86.0
0.065,17,2,80,1,32,0.0,4.0,4.0,1,48,0.0,20.0,20.0
0.004,6,10,2000,5,927,1.0,659.0,659.0,5,1073,1.0,805.0,805.0
40.067,17,10,676,5,460,10014.0,104.0,64.0,5,216,10015.0,20.0,15.0
0.005,17,2,180,1,66,0.0,38.0,38.0,1,114,0.0,86.0,86.0
0.014,6,10,1972,5,910,3.0,642.0,642.0,5,1062,3.0,794.0,794.0
0.005,6,10,1989,5,927,1.0,659.0,659.0,5,1062,1.0,794.0,794.0
0.006,6,10,1689,5,839,1.0,571.0,571.0,5,850,1.0,582.0,582.0
0.01,6,12,1926,6,1189,2.0,659.0,434.0,6,737,1.0,417.0,417.0
0.006,6,10,1547,5,764,1.0,496.0,496.0,5,783,1.0,515.0,515.0
0.007,17,2,179,1,71,0.0,43.0,43.0,1,108,0.0,80.0,80.0
240.011,6,9,787,5,488,60002.0,232.0,232.0,4,299,80002.0,83.0,83.0
0.005,6,10,2007,5,928,1.0,660.0,660.0,5,1079,1.0,811.0,811.0
0.006,17,2,170,1,65,0.0,37.0,37.0,1,105,0.0,77.0,77.0
0.229,6,16,2778,8,1396,32.0,533.0,324.0,8,1382,20.0,529.0,239.0
0.008,6,10,1643,5,860,2.0,592.0,592.0,5,783,1.0,515.0,515.0
0.012,6,10,1631,5,848,3.0,580.0,580.0,5,783,2.0,515.0,515.0
0.011,6,10,1989,5,910,2.0,642.0,642.0,5,1079,2.0,811.0,811.0
0.02,6,10,1990,5,911,4.0,643.0,643.0,5,1079,4.0,811.0,811.0
0.005,6,10,2007,5,928,1.0,660.0,660.0,5,1079,1.0,811.0,811.0
0.239,17,37,19967,21,17042,11.0,1350.0,783.0,16,2925,11.0,1350.0,154.0
0.005,6,10,1989,5,927,1.0,659.0,659.0,5,1062,1.0,794.0,794.0
0.014,6,10,1972,5,910,3.0,642.0,642.0,5,1062,3.0,794.0,794.0
0.001,17,2,179,1,62,0.0,34.0,34.0,1,117,0.0,89.0,89.0
0.006,6,10,1547,5,764,1.0,496.0,496.0,5,783,1.0,515.0,515.0
0.012,6,10,1972,5,910,3.0,642.0,642.0,5,1062,3.0,794.0,794.0
0.005,6,10,1854,5,889,1.0,621.0,621.0,5,965,1.0,697.0,697.0
0.06,17,2,80,1,32,0.0,4.0,4.0,1,48,0.0,20.0,20.0
0.004,6,10,2006,5,927,1.0,659.0,659.0,5,1079,1.0,811.0,811.0
240.012,6,9,787,5,488,60003.0,232.0,232.0,4,299,80003.0,83.0,83.0
0.012,6,10,1972,5,910,3.0,642.0,642.0,5,1062,3.0,794.0,794.0
0.01,6,10,1989,5,910,2.0,642.0,642.0,5,1079,2.0,811.0,811.0
0.123,6,10,1506,5,395,28.0,127.0,127.0,5,1111,27.0,843.0,843.0
10.764,17,28,4421,14,1993,819.0,268.0,114.0,14,2428,819.0,587.0,145.0
0.142,6,10,1506,5,395,30.0,127.0,127.0,5,1111,33.0,843.0,843.0
0.01,6,10,1989,5,910,2.0,642.0,642.0,5,1079,2.0,811.0,811.0
0.004,17,2,148,1,60,0.0,32.0,32.0,1,88,0.0,60.0,60.0
1778.097,17,143,41496,72,22752,25043.0,288.0,288.0,71,18744,25401.0,236.0,236.0
0.004,6,10,1779,5,928,1.0,660.0,660.0,5,851,1.0,583.0,583.0
0.185,6,44,11551,24,3222,8.0,1022.0,197.0,20,8329,9.0,1402.0,606.0
0.011,6,10,1972,5,910,2.0,642.0,642.0,5,1062,2.0,794.0,794.0
40.066,17,10,676,5,460,10015.0,104.0,64.0,5,216,10015.0,20.0,15.0
0.011,6,10,1990,5,911,2.0,643.0,643.0,5,1079,2.0,811.0,811.0
0.01,6,10,1983,5,910,2.0,642.0,642.0,5,1073,2.0,805.0,805.0
0.006,6,10,1854,5,889,1.0,621.0,621.0,5,965,1.0,697.0,697.0
0.005,6,10,2000,5,927,1.0,659.0,659.0,5,1073,1.0,805.0,805.0
0.004,6,10,2007,5,928,1.0,660.0,660.0,5,1079,1.0,811.0,811.0
0.063,6,10,1506,5,395,15.0,127.0,127.0,5,1111,14.0,843.0,843.0
40.076,17,10,676,5,460,10018.0,104.0,64.0,5,216,10018.0,20.0,15.0
0.015,6,14,3787,7,497,2.0,125.0,125.0,7,3290,2.0,1448.0,972.0
0.011,6,10,1989,5,910,2.0,642.0,642.0,5,1079,2.0,811.0,811.0
0.012,6,10,1989,5,910,3.0,642.0,642.0,5,1079,2.0,811.0,811.0
0.01,6,10,1631,5,848,2.0,580.0,580.0,5,783,2.0,515.0,515.0
0.019,6,10,1990,5,911,4.0,643.0,643.0,5,1079,4.0,811.0,811.0
0.098,6,45,14137,25,2555,4.0,517.0,139.0,20,11582,4.0,1402.0,752.0
0.004,6,14,3742,7,452,0.0,80.0,80.0,7,3290,0.0,1448.0,972.0
0.072,6,10,1506,5,395,17.0,127.0,127.0,5,1111,16.0,843.0,843.0
40.051,17,10,676,5,460,10012.0,104.0,64.0,5,216,10012.0,20.0,15.0
0.009,6,12,1926,6,1189,1.0,659.0,434.0,6,737,1.0,417.0,417.0
0.005,6,10,1689,5,839,1.0,571.0,571.0,5,850,1.0,582.0,582.0
0.076,6,10,1506,5,395,17.0,127.0,127.0,5,1111,17.0,843.0,843.0
367.406,6,22,2313,16,867,24493.0,195.0,195.0,6,1446,4641.0,419.0,398.0
361.802,6,21,1793,16,1030,24120.0,190.0,190.0,5,763,60010.0,462.0,247.0
0.005,6,10,2007,5,928,1.0,660.0,660.0,5,1079,1.0,811.0,811.0
0.105,6,10,1506,5,395,24.0,127.0,127.0,5,1111,22.0,843.0,843.0
0.009,6,10,1990,5,911,2.0,643.0,643.0,5,1079,2.0,811.0,811.0
0.005,17,2,136,1,60,0.0,32.0,32.0,1,76,0.0,48.0,48.0
40.062,17,10,676,5,460,10014.0,104.0,64.0,5,216,10014.0,20.0,15.0
0.012,6,10,1989,5,910,3.0,642.0,642.0,5,1079,2.0,811.0,811.0
0.004,17,2,148,1,60,0.0,32.0,32.0,1,88,0.0,60.0,60.0
0.13,6,10,1506,5,395,28.0,127.0,127.0,5,1111,30.0,843.0,843.0
0.005,17,2,164,1,74,0.0,46.0,46.0,1,90,0.0,62.0,62.0
11.128,17,28,4423,14,1994,843.0,269.0,114.0,14,2429,843.0,588.0,145.0
0.039,17,2,170,1,65,0.0,37.0,37.0,1,105,0.0,77.0,77.0
0.004,17,2,148,1,60,0.0,32.0,32.0,1,88,0.0,60.0,60.0
0.01,17,2,170,1,65,0.0,37.0,37.0,1,105,0.0,77.0,77.0
0.008,17,2,194,1,59,0.0,31.0,31.0,1,135,0.0,107.0,107.0
0.008,6,11,2042,6,963,1.0,643.0,643.0,5,1079,1.0,811.0,811.0
0.013,6,10,1972,5,910,3.0,642.0,642.0,5,1062,3.0,794.0,794.0
0.008,6,12,1926,6,1189,1.0,659.0,434.0,6,737,1.0,417.0,417.0
0.037,17,2,184,1,61,0.0,33.0,33.0,1,123,0.0,95.0,95.0
177.052,17,74,10515,37,2466,4918.0,44.0,38.0,37,8049,4918.0,239.0,189.0
11.211,17,34,6374,17,2659,693.0,270.0,128.0,17,3715,693.0,1145.0,190.0
0.016,6,10,1972,5,910,4.0,642.0,642.0,5,1062,3.0,794.0,794.0
0.008,6,10,1990,5,911,2.0,643.0,643.0,5,1079,1.0,811.0,811.0
0.005,6,10,1689,5,839,1.0,571.0,571.0,5,850,1.0,582.0,582.0
0.01,6,10,1989,5,910,2.0,642.0,642.0,5,1079,2.0,811.0,811.0
300.184,6,32,10621,15,4246,21441.0,1578.0,576.0,17,6375,18761.0,1592.0,610.0
0.005,17,2,140,1,62,0.0,34.0,34.0,1,78,0.0,50.0,50.0
0.005,6,10,1989,5,927,1.0,659.0,659.0,5,1062,1.0,794.0,794.0
23.576,6,33,6264,18,1338,1386.0,267.0,195.0,15,4926,611.0,1823.0,392.0
120.673,6,93,46139,53,6111,2320.0,992.0,198.0,40,40028,3094.0,2804.0,1308.0
0.014,6,10,1989,5,910,3.0,642.0,642.0,5,1079,3.0,811.0,811.0
0.122,6,10,1506,5,395,22.0,127.0,127.0,5,1111,28.0,843.0,843.0
0.098,6,10,1506,5,395,22.0,127.0,127.0,5,1111,22.0,843.0,843.0
0.014,6,10,1989,5,910,3.0,642.0,642.0,5,1079,3.0,811.0,811.0
0.087,6,10,1506,5,395,18.0,127.0,127.0,5,1111,16.0,843.0,843.0
0.118,6,22,2185,12,1185,10.0,426.0,140.0,10,1000,12.0,169.0,80.0
40.062,17,10,676,5,460,10014.0,104.0,64.0,5,216,10014.0,20.0,15.0
0.005,17,2,214,1,75,0.0,47.0,47.0,1,139,0.0,111.0,111.0
0.006,6,10,1854,5,889,1.0,621.0,621.0,5,965,1.0,697.0,697.0
0.023,6,13,3735,7,497,3.0,125.0,125.0,6,3238,4.0,1470.0,1459.0
0.005,6,10,2006,5,927,1.0,659.0,659.0,5,1079,1.0,811.0,811.0
0.103,6,10,1506,5,395,23.0,127.0,127.0,5,1111,24.0,843.0,843.0
333.52,17,20,1124,10,716,37051.0,48.0,43.0,10,408,37051.0,20.0,12.0
0.005,6,10,2006,5,927,1.0,659.0,659.0,5,1079,1.0,811.0,811.0
0.066,17,8,3613,4,1874,22.0,1350.0,440.0,4,1739,11.0,1350.0,406.0
0.012,6,10,1989,5,910,2.0,642.0,642.0,5,1079,3.0,811.0,811.0
0.004,17,4,284,2,120,0.0,32.0,32.0,2,164,0.0,60.0,54.0
0.005,6,10,1989,5,927,1.0,659.0,659.0,5,1062,1.0,794.0,794.0
325.094,17,20,1124,10,716,36106.0,48.0,43.0,10,408,36106.0,20.0,12.0
0.005,6,10,1547,5,764,1.0,496.0,496.0,5,783,1.0,515.0,515.0
0.067,17,2,152,1,76,0.0,48.0,48.0,1,76,0.0,48.0,48.0
0.005,6,14,3799,7,509,0.0,137.0,137.0,7,3290,0.0,1448.0,972.0
0.013,17,2,152,1,56,0.0,28.0,28.0,1,96,0.0,68.0,68.0
0.005,6,10,1774,5,923,1.0,655.0,655.0,5,851,1.0,583.0,583.0
240.015,6,9,787,5,488,60003.0,232.0,232.0,4,299,80004.0,83.0,83.0
0.014,6,10,1989,5,910,3.0,642.0,642.0,5,1079,3.0,811.0,811.0
11.167,17,28,4423,14,1994,846.0,269.0,114.0,14,2429,846.0,588.0,145.0
0.008,6,10,2006,5,927,2.0,659.0,659.0,5,1079,1.0,811.0,811.0
40.066,17,10,676,5,460,10013.0,104.0,64.0,5,216,10015.0,20.0,15.0
0.017,6,10,1972,5,910,4.0,642.0,642.0,5,1062,4.0,794.0,794.0
0.013,6,10,1990,5,911,3.0,643.0,643.0,5,1079,3.0,811.0,811.0
0.005,6,10,2006,5,927,1.0,659.0,659.0,5,1079,1.0,811.0,811.0
0.02,6,10,1989,5,910,5.0,642.0,642.0,5,1079,5.0,811.0,811.0
0.006,6,10,1689,5,839,1.0,571.0,571.0,5,850,1.0,582.0,582.0
0.005,6,10,1989,5,927,1.0,659.0,659.0,5,1062,1.0,794.0,794.0
290.854,6,362,347158,191,21492,1530.0,2736.0,888.0,171,325666,1710.0,4136.0,2017.0
0.006,6,10,2007,5,928,1.0,660.0,660.0,5,1079,1.0,811.0,811.0
0.004,6,10,2006,5,927,1.0,659.0,659.0,5,1079,1.0,811.0,811.0
0.005,17,2,140,1,62,0.0,34.0,34.0,1,78,0.0,50.0,50.0
0.006,6,10,1854,5,889,1.0,621.0,621.0,5,965,1.0,697.0,697.0
0.016,17,2,198,1,91,0.0,63.0,63.0,1,107,0.0,79.0,79.0
0.004,6,10,2006,5,927,1.0,659.0,659.0,5,1079,1.0,811.0,811.0
0.004,6,10,1779,5,928,1.0,660.0,660.0,5,851,1.0,583.0,583.0
0.086,6,10,1506,5,395,20.0,127.0,127.0,5,1111,20.0,843.0,843.0
0.221,6,16,2780,8,1506,31.0,533.0,360.0,8,1274,20.0,529.0,212.0
0.005,6,13,3747,7,509,0.0,137.0,137.0,6,3238,0.0,1470.0,1459.0
0.082,6,10,1506,5,395,18.0,127.0,127.0,5,1111,18.0,843.0,843.0
0.009,6,13,3747,7,509,1.0,137.0,137.0,6,3238,1.0,1470.0,1459.0
0.081,6,10,1506,5,395,18.0,127.0,127.0,5,1111,16.0,843.0,843.0
0.013,6,10,1983,5,910,3.0,642.0,642.0,5,1073,3.0,805.0,805.0
0.014,6,10,1989,5,910,3.0,642.0,642.0,5,1079,3.0,811.0,811.0
0.024,6,10,1983,5,910,5.0,642.0,642.0,5,1073,5.0,805.0,805.0
308.808,17,20,1124,10,716,34305.0,48.0,43.0,10,408,34305.0,20.0,12.0
9.037,17,6,376,5,280,2259.0,28.0,28.0,1,96,0.0,68.0,68.0
0.011,6,10,1989,5,910,2.0,642.0,642.0,5,1079,2.0,811.0,811.0
0.002,17,2,180,1,66,0.0,38.0,38.0,1,114,0.0,86.0,86.0
0.095,6,10,1506,5,395,23.0,127.0,127.0,5,1111,22.0,843.0,843.0
0.006,6,10,2007,5,928,1.0,660.0,660.0,5,1079,1.0,811.0,811.0
15.174,17,20,11463,10,7848,1682.0,1350.0,756.0,10,3615,1682.0,1350.0,333.0
0.013,6,10,1677,5,827,3.0,559.0,559.0,5,850,3.0,582.0,582.0
0.117,6,10,1506,5,395,25.0,127.0,127.0,5,1111,26.0,843.0,843.0
335.157,17,20,1124,10,716,37225.0,48.0,43.0,10,408,37225.0,20.0,12.0
0.005,6,10,1989,5,927,1.0,659.0,659.0,5,1062,1.0,794.0,794.0
300.054,6,12,1782,7,1348,50009.0,494.0,494.0,5,434,75011.0,83.0,83.0
0.001,17,2,136,1,60,0.0,32.0,32.0,1,76,0.0,48.0,48.0
308.438,17,20,1124,10,716,34264.0,48.0,43.0,10,408,34264.0,20.0,12.0
0.008,6,10,1989,5,910,2.0,642.0,642.0,5,1079,1.0,811.0,811.0
0.083,6,10,1506,5,395,18.0,127.0,127.0,5,1111,18.0,843.0,843.0
0.001,17,2,136,1,60,0.0,32.0,32.0,1,76,0.0,48.0,48.0
0.007,6,10,1990,5,911,1.0,643.0,643.0,5,1079,1.0,811.0,811.0
0.009,6,10,1989,5,910,2.0,642.0,642.0,5,1079,2.0,811.0,811.0
0.009,6,10,1779,5,928,2.0,660.0,660.0,5,851,2.0,583.0,583.0
0.018,6,10,1631,5,848,4.0,580.0,580.0,5,783,4.0,515.0,515.0
0.083,6,10,1506,5,395,19.0,127.0,127.0,5,1111,18.0,843.0,843.0
0.088,6,10,1506,5,395,19.0,127.0,127.0,5,1111,20.0,843.0,843.0
0.011,6,13,3735,7,497,1.0,125.0,125.0,6,3238,2.0,1470.0,1459.0
300.286,6,16,2170,9,684,37515.0,146.0,146.0,7,1486,50021.0,419.0,398.0
0.004,6,10,1989,5,927,1.0,659.0,659.0,5,1062,1.0,794.0,794.0
0.093,6,10,1506,5,395,21.0,127.0,127.0,5,1111,21.0,843.0,843.0
0.093,6,10,1506,5,395,21.0,127.0,127.0,5,1111,18.0,843.0,843.0
0.007,6,10,1547,5,764,1.0,496.0,496.0,5,783,1.0,515.0,515.0
0.103,17,2,136,1,60,0.0,32.0,32.0,1,76,0.0,48.0,48.0
0.005,6,14,3742,8,504,0.0,80.0,80.0,6,3238,1.0,1470.0,1459.0
0.059,17,2,152,1,76,0.0,48.0,48.0,1,76,0.0,48.0,48.0
0.001,17,2,136,1,60,0.0,32.0,32.0,1,76,0.0,48.0,48.0
0.004,6,10,2007,5,928,1.0,660.0,660.0,5,1079,1.0,811.0,811.0
0.005,6,10,2006,5,927,1.0,659.0,659.0,5,1079,1.0,811.0,811.0
0.096,6,10,1506,5,395,20.0,127.0,127.0,5,1111,21.0,843.0,843.0
356.594,6,19,1691,15,978,25471.0,190.0,190.0,4,713,80002.0,497.0,497.0
0.004,17,2,164,1,74,0.0,46.0,46.0,1,90,0.0,62.0,62.0
0.005,6,14,3742,7,452,0.0,80.0,80.0,7,3290,0.0,1448.0,972.0
0.006,6,10,2007,5,928,1.0,660.0,660.0,5,1079,1.0,811.0,811.0
0.221,6,16,2777,8,1395,31.0,533.0,323.0,8,1382,20.0,529.0,239.0
0.009,6,10,1972,5,910,2.0,642.0,642.0,5,1062,2.0,794.0,794.0
0.001,17,2,180,1,66,0.0,38.0,38.0,1,114,0.0,86.0,86.0
0.067,6,10,1506,5,395,15.0,127.0,127.0,5,1111,14.0,843.0,843.0
40.052,17,10,676,5,460,10011.0,104.0,64.0,5,216,10012.0,20.0,15.0
0.004,6,10,1989,5,927,1.0,659.0,659.0,5,1062,1.0,794.0,794.0
300.155,6,26,8251,13,1793,25012.0,815.0,277.0,13,6458,25012.0,1402.0,723.0
0.072,6,10,1506,5,395,16.0,127.0,127.0,5,1111,16.0,843.0,843.0
0.041,17,2,136,1,60,0.0,32.0,32.0,1,76,0.0,48.0,48.0
0.009,6,10,1989,5,910,2.0,642.0,642.0,5,1079,2.0,811.0,811.0
40.062,17,10,676,5,460,10012.0,104.0,64.0,5,216,10014.0,20.0,15.0
0.004,6,10,2006,5,927,1.0,659.0,659.0,5,1079,1.0,811.0,811.0
240.116,6,32,9318,16,7002,16007.0,2073.0,686.0,16,2316,16007.0,580.0,184.0
0.015,6,10,1983,5,910,3.0,642.0,642.0,5,1073,3.0,805.0,805.0
0.012,6,13,3816,7,578,2.0,206.0,206.0,6,3238,2.0,1470.0,1459.0
0.012,6,10,1990,5,911,3.0,643.0,643.0,5,1079,3.0,811.0,811.0
0.004,6,10,2007,5,928,1.0,660.0,660.0,5,1079,1.0,811.0,811.0
0.008,6,10,1972,5,910,2.0,642.0,642.0,5,1062,2.0,794.0,794.0
0.005,17,2,169,1,62,0.0,34.0,34.0,1,107,0.0,79.0,79.0
0.004,6,10,2006,5,927,1.0,659.0,659.0,5,1079,1.0,811.0,811.0
0.003,17,4,284,2,120,0.0,32.0,32.0,2,164,0.0,60.0,54.0
0.012,6,10,1989,5,910,3.0,642.0,642.0,5,1079,3.0,811.0,811.0
0.005,6,10,1989,5,927,1.0,659.0,659.0,5,1062,1.0,794.0,794.0
0.021,6,10,1605,5,388,5.0,120.0,120.0,5,1217,5.0,949.0,949.0
0.005,6,14,3742,7,452,0.0,80.0,80.0,7,3290,0.0,1448.0,972.0
0.014,6,10,1762,5,911,3.0,643.0,643.0,5,851,3.0,583.0,583.0
0.005,6,10,1689,5,839,1.0,571.0,571.0,5,850,1.0,582.0,582.0
0.068,6,10,1506,5,395,16.0,127.0,127.0,5,1111,15.0,843.0,843.0
0.001,17,2,180,1,66,0.0,38.0,38.0,1,114,0.0,86.0,86.0
0.006,6,10,2007,5,928,1.0,660.0,660.0,5,1079,1.0,811.0,811.0
0.005,17,2,157,1,59,0.0,31.0,31.0,1,98,0.0,70.0,70.0
0.0,17,2,140,1,62,0.0,34.0,34.0,1,78,0.0,50.0,50.0
0.01,6,10,1677,5,827,2.0,559.0,559.0,5,850,2.0,582.0,582.0
0.115,6,10,1506,5,395,21.0,127.0,127.0,5,1111,27.0,843.0,843.0
0.005,17,2,136,1,60,0.0,32.0,32.0,1,76,0.0,48.0,48.0
0.008,6,10,1677,5,827,2.0,559.0,559.0,5,850,2.0,582.0,582.0
0.013,6,10,1677,5,827,3.0,559.0,559.0,5,850,3.0,582.0,582.0
369.85,6,22,2313,16,867,24656.0,195.0,195.0,6,1446,4652.0,419.0,398.0
324.911,17,17,960,9,640,40598.0,48.0,43.0,8,320,46397.0,12.0,12.0
0.003,17,2,148,1,60,0.0,32.0,32.0,1,88,0.0,60.0,60.0
0.024,6,10,1631,5,848,5.0,580.0,580.0,5,783,5.0,515.0,515.0
0.016,6,10,1990,5,911,3.0,643.0,643.0,5,1079,4.0,811.0,811.0
0.106,6,10,1506,5,395,24.0,127.0,127.0,5,1111,24.0,843.0,843.0
0.009,6,10,1989,5,910,2.0,642.0,642.0,5,1079,2.0,811.0,811.0
11.249,17,28,4423,14,1995,853.0,270.0,114.0,14,2428,852.0,587.0,145.0
0.003,17,2,148,1,60,0.0,32.0,32.0,1,88,0.0,60.0,60.0
0.082,6,10,1506,5,395,17.0,127.0,127.0,5,1111,19.0,843.0,843.0
0.039,17,2,144,1,64,0.0,36.0,36.0,1,80,0.0,52.0,52.0
15.345,17,43,20799,23,17139,695.0,1350.0,717.0,20,3660,806.0,1350.0,155.0
0.012,6,10,1631,5,848,2.0,580.0,580.0,5,783,3.0,515.0,515.0
0.013,6,10,1990,5,911,3.0,643.0,643.0,5,1079,3.0,811.0,811.0
0.004,6,10,2000,5,927,1.0,659.0,659.0,5,1073,1.0,805.0,805.0
0.019,6,10,1677,5,827,4.0,559.0,559.0,5,850,4.0,582.0,582.0
0.012,6,10,1972,5,910,3.0,642.0,642.0,5,1062,2.0,794.0,794.0
0.005,6,10,1989,5,927,1.0,659.0,659.0,5,1062,1.0,794.0,794.0
374.577,6,22,2313,16,867,24971.0,195.0,195.0,6,1446,4646.0,419.0,398.0
40.072,17,10,676,5,460,10014.0,104.0,64.0,5,216,10017.0,20.0,15.0
0.013,6,10,1990,5,911,3.0,643.0,643.0,5,1079,3.0,811.0,811.0
240.013,6,9,787,5,488,60003.0,232.0,232.0,4,299,80003.0,83.0,83.0
0.078,6,10,1506,5,395,17.0,127.0,127.0,5,1111,17.0,843.0,843.0
0.005,6,10,1774,5,923,1.0,655.0,655.0,5,851,1.0,583.0,583.0
0.006,6,10,1547,5,764,1.0,496.0,496.0,5,783,1.0,515.0,515.0
0.121,6,10,1506,5,395,25.0,127.0,127.0,5,1111,27.0,843.0,843.0
0.008,6,10,1983,5,910,2.0,642.0,642.0,5,1073,2.0,805.0,805.0
0.005,6,10,1689,5,839,1.0,571.0,571.0,5,850,1.0,582.0,582.0
0.005,6,10,2006,5,927,1.0,659.0,659.0,5,1079,1.0,811.0,811.0
0.019,6,10,1972,5,910,4.0,642.0,642.0,5,1062,4.0,794.0,794.0
0.006,17,2,140,1,62,0.0,34.0,34.0,1,78,0.0,50.0,50.0
65.959,6,22,8569,12,2328,5996.0,1002.0,424.0,10,6241,7310.0,2241.0,952.0
1.111,6,25,8170,14,1671,85.0,517.0,235.0,11,6499,19.0,1402.0,843.0
0.015,6,14,3787,7,497,2.0,125.0,125.0,7,3290,2.0,1448.0,972.0
0.087,6,10,1506,5,395,19.0,127.0,127.0,5,1111,20.0,843.0,843.0
0.095,6,10,1506,5,395,18.0,127.0,127.0,5,1111,23.0,843.0,843.0
0.104,6,10,1506,5,395,21.0,127.0,127.0,5,1111,20.0,843.0,843.0
0.171,6,3,453,2,321,171.0,241.0,241.0,1,132,0.0,92.0,92.0
240.097,6,16,4481,9,963,30012.0,238.0,166.0,7,3518,40015.0,1402.0,786.0
0.004,6,10,1779,5,928,1.0,660.0,660.0,5,851,1.0,583.0,583.0
0.004,6,10,1702,5,863,1.0,595.0,595.0,5,839,1.0,571.0,571.0
1778.806,17,144,45504,72,22752,25052.0,288.0,288.0,72,22752,25048.0,288.0,288.0
0.148,6,10,1506,5,395,29.0,127.0,127.0,5,1111,34.0,843.0,843.0
0.017,6,10,1989,5,910,4.0,642.0,642.0,5,1079,4.0,811.0,811.0
40.062,17,10,676,5,460,10014.0,104.0,64.0,5,216,10014.0,20.0,15.0
0.105,6,10,1506,5,395,23.0,127.0,127.0,5,1111,19.0,843.0,843.0
0.013,6,14,3787,7,497,2.0,125.0,125.0,7,3290,2.0,1448.0,972.0
0.014,6,10,1989,5,910,3.0,642.0,642.0,5,1079,3.0,811.0,811.0
300.319,6,27,8576,15,1581,21451.0,447.0,198.0,12,6995,21846.0,1402.0,909.0
0.005,6,10,1643,5,860,1.0,592.0,592.0,5,783,1.0,515.0,515.0
0.073,6,10,1506,5,395,15.0,127.0,127.0,5,1111,16.0,843.0,843.0
0.06,17,2,152,1,76,0.0,48.0,48.0,1,76,0.0,48.0,48.0
0.008,6,10,1689,5,839,1.0,571.0,571.0,5,850,1.0,582.0,582.0
0.012,6,13,3735,7,497,1.0,125.0,125.0,6,3238,2.0,1470.0,1459.0
0.005,6,10,1689,5,839,1.0,571.0,571.0,5,850,1.0,582.0,582.0
0.017,6,10,1605,5,388,4.0,120.0,120.0,5,1217,4.0,949.0,949.0
0.009,17,2,136,1,60,0.0,32.0,32.0,1,76,0.0,48.0,48.0
0.011,17,2,170,1,65,0.0,37.0,37.0,1,105,0.0,77.0,77.0
0.005,17,2,230,1,68,0.0,40.0,40.0,1,162,0.0,134.0,134.0
0.004,6,10,2007,5,928,1.0,660.0,660.0,5,1079,1.0,811.0,811.0
40.062,17,10,676,5,460,10014.0,104.0,64.0,5,216,10014.0,20.0,15.0
0.005,6,10,1854,5,889,1.0,621.0,621.0,5,965,1.0,697.0,697.0
0.006,17,2,214,1,75,0.0,47.0,47.0,1,139,0.0,111.0,111.0
0.009,6,10,1972,5,910,2.0,642.0,642.0,5,1062,2.0,794.0,794.0
0.007,6,10,1547,5,764,1.0,496.0,496.0,5,783,1.0,515.0,515.0
0.007,17,2,179,1,71,0.0,43.0,43.0,1,108,0.0,80.0,80.0
0.005,6,10,1989,5,927,1.0,659.0,659.0,5,1062,1.0,794.0,794.0
0.081,6,10,1506,5,395,17.0,127.0,127.0,5,1111,17.0,843.0,843.0
0.005,6,10,2006,5,927,1.0,659.0,659.0,5,1079,1.0,811.0,811.0
0.068,17,8,3613,4,1874,22.0,1350.0,440.0,4,1739,11.0,1350.0,406.0
40.062,17,10,676,5,460,10014.0,104.0,64.0,5,216,10013.0,20.0,15.0
0.013,6,10,1989,5,910,3.0,642.0,642.0,5,1079,3.0,811.0,811.0
0.088,6,10,1506,5,395,21.0,127.0,127.0,5,1111,19.0,843.0,843.0
0.005,6,13,3747,7,509,0.0,137.0,137.0,6,3238,1.0,1470.0,1459.0
10.806,17,28,4421,14,1994,822.0,269.0,114.0,14,2427,822.0,586.0,145.0
0.09,6,10,1506,5,395,21.0,127.0,127.0,5,1111,20.0,843.0,843.0
0.013,6,10,1990,5,911,3.0,643.0,643.0,5,1079,3.0,811.0,811.0
0.005,6,10,1689,5,839,1.0,571.0,571.0,5,850,1.0,582.0,582.0
0.005,6,10,2007,5,928,1.0,660.0,660.0,5,1079,1.0,811.0,811.0
0.069,17,8,3613,4,1874,23.0,1350.0,440.0,4,1739,12.0,1350.0,406.0
0.135,6,10,1506,5,395,31.0,127.0,127.0,5,1111,29.0,843.0,843.0
40.062,17,10,676,5,460,10014.0,104.0,64.0,5,216,10014.0,20.0,15.0
0.004,17,2,148,1,60,0.0,32.0,32.0,1,88,0.0,60.0,60.0
0.014,17,2,152,1,56,0.0,28.0,28.0,1,96,0.0,68.0,68.0
0.016,6,14,3787,7,497,2.0,125.0,125.0,7,3290,2.0,1448.0,972.0
0.004,17,2,148,1,60,0.0,32.0,32.0,1,88,0.0,60.0,60.0
40.052,17,10,676,5,460,10012.0,104.0,64.0,5,216,10012.0,20.0,15.0
0.005,6,10,1854,5,889,1.0,621.0,621.0,5,965,1.0,697.0,697.0
0.014,6,10,1989,5,910,3.0,642.0,642.0,5,1079,3.0,811.0,811.0
0.006,6,10,1547,5,764,1.0,496.0,496.0,5,783,1.0,515.0,515.0
17.404,6,26,5210,15,1238,1243.0,180.0,75.0,11,3972,1740.0,1591.0,678.0
0.01,6,10,1762,5,911,2.0,643.0,643.0,5,851,2.0,583.0,583.0
0.003,17,2,136,1,60,0.0,32.0,32.0,1,76,0.0,48.0,48.0
40.055,17,10,676,5,460,10012.0,104.0,64.0,5,216,10012.0,20.0,15.0
0.005,6,10,2006,5,927,1.0,659.0,659.0,5,1079,1.0,811.0,811.0
0.005,6,10,2006,5,927,1.0,659.0,659.0,5,1079,1.0,811.0,811.0
0.003,17,4,284,2,120,0.0,32.0,32.0,2,164,0.0,60.0,54.0
240.365,6,45,8918,22,5750,11445.0,1368.0,458.0,23,3168,10925.0,580.0,218.0
0.04,17,4,352,2,130,0.0,37.0,37.0,2,222,0.0,89.0,83.0
0.108,6,10,1506,5,395,25.0,127.0,127.0,5,1111,21.0,843.0,843.0
0.27,17,44,27802,26,24778,10.0,1350.0,925.0,18,3024,12.0,1350.0,140.0
0.012,6,10,1972,5,910,3.0,642.0,642.0,5,1062,3.0,794.0,794.0
0.041,17,4,352,2,130,0.0,37.0,37.0,2,222,38.0,89.0,83.0
0.01,6,10,1983,5,910,2.0,642.0,642.0,5,1073,2.0,805.0,805.0
0.005,6,10,2007,5,928,1.0,660.0,660.0,5,1079,1.0,811.0,811.0
0.006,6,10,1547,5,764,1.0,496.0,496.0,5,783,1.0,515.0,515.0
0.005,6,10,2007,5,928,1.0,660.0,660.0,5,1079,1.0,811.0,811.0
336.124,17,20,1124,10,716,37332.0,48.0,43.0,10,408,37332.0,20.0,12.0
0.255,6,10,1506,5,395,50.0,127.0,127.0,5,1111,60.0,843.0,843.0
0.17,17,2,152,1,76,0.0,48.0,48.0,1,76,0.0,48.0,48.0
0.013,6,10,1989,5,910,3.0,642.0,642.0,5,1079,3.0,811.0,811.0
0.004,6,10,1702,5,863,1.0,595.0,595.0,5,839,0.0,571.0,571.0
0.005,6,10,2007,5,928,1.0,660.0,660.0,5,1079,1.0,811.0,811.0
0.004,6,10,2007,5,928,1.0,660.0,660.0,5,1079,1.0,811.0,811.0
176.221,17,74,10555,37,2457,4894.0,44.0,38.0,37,8098,4894.0,261.0,190.0
0.005,6,10,2007,5,928,1.0,660.0,660.0,5,1079,1.0,811.0,811.0
0.004,6,10,1989,5,927,1.0,659.0,659.0,5,1062,1.0,794.0,794.0
0.005,6,10,2000,5,927,1.0,659.0,659.0,5,1073,1.0,805.0,805.0
0.021,6,10,1990,5,911,5.0,643.0,643.0,5,1079,5.0,811.0,811.0
0.01,6,10,1972,5,910,2.0,642.0,642.0,5,1062,2.0,794.0,794.0
0.005,6,10,1779,5,928,1.0,660.0,660.0,5,851,1.0,583.0,583.0
0.005,6,10,2006,5,927,1.0,659.0,659.0,5,1079,1.0,811.0,811.0
0.013,6,10,1972,5,910,3.0,642.0,642.0,5,1062,3.0,794.0,794.0
0.074,6,10,1506,5,395,17.0,127.0,127.0,5,1111,15.0,843.0,843.0
40.059,17,10,676,5,460,10013.0,104.0,64.0,5,216,10013.0,20.0,15.0
0.005,17,2,179,1,71,0.0,43.0,43.0,1,108,0.0,80.0,80.0
0.008,17,2,132,1,58,0.0,30.0,30.0,1,74,0.0,46.0,46.0
0.005,17,2,170,1,65,0.0,37.0,37.0,1,105,0.0,77.0,77.0
0.013,6,13,3735,7,497,2.0,125.0,125.0,6,3238,2.0,1470.0,1459.0
0.024,6,10,1631,5,848,5.0,580.0,580.0,5,783,6.0,515.0,515.0
0.017,6,10,1989,5,910,4.0,642.0,642.0,5,1079,4.0,811.0,811.0
0.017,17,4,284,2,120,0.0,32.0,32.0,2,164,0.0,60.0,54.0
0.005,6,10,1689,5,839,1.0,571.0,571.0,5,850,1.0,582.0,582.0
0.003,17,2,136,1,60,0.0,32.0,32.0,1,76,0.0,48.0,48.0
0.01,6,10,1989,5,910,2.0,642.0,642.0,5,1079,2.0,811.0,811.0
0.015,6,10,1989,5,910,3.0,642.0,642.0,5,1079,3.0,811.0,811.0
0.012,6,10,1990,5,911,3.0,643.0,643.0,5,1079,2.0,811.0,811.0
300.019,6,12,1782,7,1348,50003.0,494.0,494.0,5,434,75004.0,83.0,83.0
0.043,17,4,284,2,120,1.0,32.0,32.0,2,164,39.0,60.0,54.0
0.085,6,10,1506,5,395,18.0,127.0,127.0,5,1111,18.0,843.0,843.0
0.004,6,10,2000,5,927,1.0,659.0,659.0,5,1073,1.0,805.0,805.0
0.011,6,10,1983,5,910,2.0,642.0,642.0,5,1073,2.0,805.0,805.0
0.009,6,10,1972,5,910,2.0,642.0,642.0,5,1062,2.0,794.0,794.0
0.005,17,2,164,1,74,0.0,46.0,46.0,1,90,0.0,62.0,62.0
0.011,6,10,1972,5,910,2.0,642.0,642.0,5,1062,2.0,794.0,794.0
388.794,6,24,2405,17,919,24299.0,195.0,195.0,7,1486,3908.0,419.0,398.0
0.067,17,8,3613,4,1874,22.0,1350.0,440.0,4,1739,11.0,1350.0,406.0
15.074,17,16,10617,9,8280,1880.0,1350.0,892.0,7,2337,2509.0,1350.0,305.0
0.207,6,16,2671,8,1397,29.0,533.0,324.0,8,1274,18.0,529.0,212.0
309.665,17,20,1124,10,716,34400.0,48.0,43.0,10,408,34400.0,20.0,12.0
0.012,6,13,3735,7,497,1.0,125.0,125.0,6,3238,2.0,1470.0,1459.0
0.113,6,10,1506,5,395,27.0,127.0,127.0,5,1111,23.0,843.0,843.0
0.004,17,2,148,1,60,0.0,32.0,32.0,1,88,0.0,60.0,60.0
0.013,6,10,1990,5,911,3.0,643.0,643.0,5,1079,3.0,811.0,811.0
0.003,17,2,148,1,60,0.0,32.0,32.0,1,88,0.0,60.0,60.0
0.07,6,10,1506,5,395,14.0,127.0,127.0,5,1111,16.0,843.0,843.0
0.005,6,13,3690,7,452,0.0,80.0,80.0,6,3238,1.0,1470.0,1459.0
0.005,6,10,1689,5,839,1.0,571.0,571.0,5,850,1.0,582.0,582.0
0.073,6,10,1506,5,395,16.0,127.0,127.0,5,1111,14.0,843.0,843.0
0.001,17,2,136,1,60,0.0,32.0,32.0,1,76,0.0,48.0,48.0
0.044,17,2,152,1,76,0.0,48.0,48.0,1,76,0.0,48.0,48.0
0.011,6,10,1631,5,848,2.0,580.0,580.0,5,783,2.0,515.0,515.0
0.041,17,2,412,1,61,0.0,33.0,33.0,1,351,0.0,323.0,323.0
0.14,6,10,1506,5,395,31.0,127.0,127.0,5,1111,29.0,843.0,843.0
0.005,17,2,214,1,75,0.0,47.0,47.0,1,139,0.0,111.0,111.0
0.006,17,2,166,1,75,0.0,47.0,47.0,1,91,0.0,63.0,63.0
0.005,6,10,1774,5,923,1.0,655.0,655.0,5,851,1.0,583.0,583.0
0.001,17,2,136,1,60,0.0,32.0,32.0,1,76,0.0,48.0,48.0
1792.728,6,239,46402,116,34104,15588.0,2497.0,1002.0,123,12298,14694.0,580.0,62.0
15.071,17,15,9238,8,6902,2149.0,1350.0,834.0,7,2336,2507.0,1350.0,305.0
0.002,17,2,180,1,66,0.0,38.0,38.0,1,114,0.0,86.0,86.0
0.004,6,10,1702,5,863,1.0,595.0,595.0,5,839,0.0,571.0,571.0
1.151,6,32,13391,18,5892,67.0,2720.0,854.0,14,7499,74.0,2720.0,769.0
0.01,6,10,1989,5,910,2.0,642.0,642.0,5,1079,2.0,811.0,811.0
1770.623,17,120,11460,60,5460,30010.0,63.0,63.0,60,6000,30010.0,72.0,72.0
0.01,6,13,3735,7,497,1.0,125.0,125.0,6,3238,2.0,1470.0,1459.0
0.039,17,4,364,2,160,0.0,52.0,52.0,2,204,2.0,80.0,74.0
0.005,6,10,1989,5,927,1.0,659.0,659.0,5,1062,1.0,794.0,794.0
0.029,6,10,1972,5,910,7.0,642.0,642.0,5,1062,7.0,794.0,794.0
0.006,6,10,1643,5,860,1.0,592.0,592.0,5,783,1.0,515.0,515.0
301.08,6,46,16650,24,10698,13090.0,4080.0,1615.0,22,5952,423.0,2667.0,361.0
0.012,6,10,1989,5,910,3.0,642.0,642.0,5,1079,2.0,811.0,811.0
0.04,17,4,284,2,120,0.0,32.0,32.0,2,164,3.0,60.0,54.0
0.319,17,14,9851,8,6907,45.0,1350.0,835.0,6,2944,52.0,1350.0,462.0
0.013,6,10,1677,5,827,3.0,559.0,559.0,5,850,3.0,582.0,582.0
0.183,6,10,1506,5,395,34.0,127.0,127.0,5,1111,39.0,843.0,843.0
368.51,6,22,2313,16,867,24567.0,195.0,195.0,6,1446,4647.0,419.0,398.0
0.011,6,10,1989,5,910,2.0,642.0,642.0,5,1079,2.0,811.0,811.0
0.005,6,10,1774,5,923,1.0,655.0,655.0,5,851,1.0,583.0,583.0
0.001,17,2,136,1,60,0.0,32.0,32.0,1,76,0.0,48.0,48.0
0.005,6,10,1689,5,839,1.0,571.0,571.0,5,850,1.0,582.0,582.0
0.087,6,10,1506,5,395,19.0,127.0,127.0,5,1111,20.0,843.0,843.0
0.005,17,2,194,1,59,0.0,31.0,31.0,1,135,0.0,107.0,107.0
0.005,17,2,180,1,66,0.0,38.0,38.0,1,114,0.0,86.0,86.0
0.012,17,2,152,1,56,0.0,28.0,28.0,1,96,0.0,68.0,68.0
0.006,6,10,1854,5,889,1.0,621.0,621.0,5,965,1.0,697.0,697.0
0.021,6,10,1972,5,910,5.0,642.0,642.0,5,1062,5.0,794.0,794.0
0.009,6,10,1983,5,910,2.0,642.0,642.0,5,1073,2.0,805.0,805.0
40.065,17,10,676,5,460,10015.0,104.0,64.0,5,216,10015.0,20.0,15.0
0.001,17,2,180,1,66,0.0,38.0,38.0,1,114,0.0,86.0,86.0
0.078,6,10,1506,5,395,18.0,127.0,127.0,5,1111,14.0,843.0,843.0
0.005,6,10,1547,5,764,1.0,496.0,496.0,5,783,1.0,515.0,515.0
0.04,17,2,184,1,61,0.0,33.0,33.0,1,123,0.0,95.0,95.0
240.432,6,33,8639,17,1837,15026.0,570.0,189.0,16,6802,16028.0,1402.0,597.0
0.075,6,10,1506,5,395,18.0,127.0,127.0,5,1111,14.0,843.0,843.0
0.011,6,10,1983,5,910,2.0,642.0,642.0,5,1073,2.0,805.0,805.0
0.006,17,2,302,1,65,0.0,37.0,37.0,1,237,0.0,209.0,209.0
0.001,17,2,180,1,66,0.0,38.0,38.0,1,114,0.0,86.0,86.0
0.005,6,10,2006,5,927,1.0,659.0,659.0,5,1079,1.0,811.0,811.0
0.001,17,2,180,1,66,0.0,38.0,38.0,1,114,0.0,86.0,86.0
0.008,6,10,1990,5,911,2.0,643.0,643.0,5,1079,2.0,811.0,811.0
354.032,6,21,1795,16,1030,23602.0,190.0,190.0,5,765,60003.0,464.0,248.0
40.086,17,10,676,5,460,10018.0,104.0,64.0,5,216,10020.0,20.0,15.0
0.005,6,10,2007,5,928,1.0,660.0,660.0,5,1079,1.0,811.0,811.0
0.155,6,10,1506,5,395,27.0,127.0,127.0,5,1111,34.0,843.0,843.0
0.005,6,10,1643,5,860,1.0,592.0,592.0,5,783,1.0,515.0,515.0
0.004,17,4,284,2,120,0.0,32.0,32.0,2,164,0.0,60.0,54.0
0.012,6,10,1990,5,911,3.0,643.0,643.0,5,1079,3.0,811.0,811.0
0.013,6,10,1989,5,910,3.0,642.0,642.0,5,1079,3.0,811.0,811.0
0.084,6,10,1506,5,395,16.0,127.0,127.0,5,1111,17.0,843.0,843.0
0.151,17,2,144,1,64,0.0,36.0,36.0,1,80,0.0,52.0,52.0
0.039,17,2,152,1,76,0.0,48.0,48.0,1,76,0.0,48.0,48.0
0.031,6,13,3735,7,497,5.0,125.0,125.0,6,3238,6.0,1470.0,1459.0
0.058,6,10,1506,5,395,13.0,127.0,127.0,5,1111,13.0,843.0,843.0
0.007,17,2,179,1,71,0.0,43.0,43.0,1,108,0.0,80.0,80.0
0.003,17,2,148,1,60,0.0,32.0,32.0,1,88,0.0,60.0,60.0
0.008,6,10,1983,5,910,2.0,642.0,642.0,5,1073,1.0,805.0,805.0
0.089,6,10,1506,5,395,20.0,127.0,127.0,5,1111,17.0,843.0,843.0
240.016,6,9,787,5,488,60004.0,232.0,232.0,4,299,80004.0,83.0,83.0
0.004,6,10,2007,5,928,1.0,660.0,660.0,5,1079,1.0,811.0,811.0
0.005,17,2,230,1,68,0.0,40.0,40.0,1,162,0.0,134.0,134.0
0.005,6,10,2007,5,928,1.0,660.0,660.0,5,1079,1.0,811.0,811.0
0.033,6,10,1990,5,911,8.0,643.0,643.0,5,1079,8.0,811.0,811.0
0.004,6,10,2007,5,928,1.0,660.0,660.0,5,1079,1.0,811.0,811.0
0.001,17,2,180,1,66,0.0,38.0,38.0,1,114,0.0,86.0,86.0
0.015,6,10,1677,5,827,3.0,559.0,559.0,5,850,3.0,582.0,582.0
240.183,6,40,5152,21,2476,12008.0,588.0,196.0,19,2676,13342.0,580.0,240.0
0.005,6,10,2006,5,927,1.0,659.0,659.0,5,1079,1.0,811.0,811.0
300.415,6,17,2222,10,736,33361.0,146.0,146.0,7,1486,50042.0,419.0,398.0
0.005,6,10,1854,5,889,1.0,621.0,621.0,5,965,1.0,697.0,697.0
0.073,6,10,1506,5,395,15.0,127.0,127.0,5,1111,16.0,843.0,843.0
0.175,6,10,1506,5,395,41.0,127.0,127.0,5,1111,41.0,843.0,843.0
0.071,6,10,1506,5,395,16.0,127.0,127.0,5,1111,13.0,843.0,843.0
0.015,6,10,1762,5,911,3.0,643.0,643.0,5,851,3.0,583.0,583.0
0.011,6,10,1972,5,910,2.0,642.0,642.0,5,1062,2.0,794.0,794.0
0.011,6,10,1989,5,910,2.0,642.0,642.0,5,1079,2.0,811.0,811.0
0.004,6,10,2007,5,928,1.0,660.0,660.0,5,1079,1.0,811.0,811.0
0.075,6,10,1506,5,395,16.0,127.0,127.0,5,1111,17.0,843.0,843.0
0.097,6,10,1506,5,395,18.0,127.0,127.0,5,1111,20.0,843.0,843.0
0.005,6,10,2006,5,927,1.0,659.0,659.0,5,1079,1.0,811.0,811.0
40.05,17,10,676,5,460,10011.0,104.0,64.0,5,216,10011.0,20.0,15.0
0.005,6,14,3736,7,446,0.0,74.0,74.0,7,3290,0.0,1448.0,972.0
0.005,17,2,140,1,62,0.0,34.0,34.0,1,78,0.0,50.0,50.0
0.005,6,10,2006,5,927,1.0,659.0,659.0,5,1079,1.0,811.0,811.0
0.005,6,10,2006,5,927,1.0,659.0,659.0,5,1079,1.0,811.0,811.0
0.006,6,10,1689,5,839,1.0,571.0,571.0,5,850,1.0,582.0,582.0
0.016,6,10,1677,5,827,4.0,559.0,559.0,5,850,3.0,582.0,582.0
0.071,17,2,148,1,60,0.0,32.0,32.0,1,88,0.0,60.0,60.0
300.402,6,16,2170,9,684,37529.0,146.0,146.0,7,1486,50039.0,419.0,398.0
0.104,6,10,1506,5,395,24.0,127.0,127.0,5,1111,24.0,843.0,843.0
0.008,6,10,1643,5,860,2.0,592.0,592.0,5,783,1.0,515.0,515.0
0.009,6,10,1989,5,910,2.0,642.0,642.0,5,1079,2.0,811.0,811.0
0.041,17,2,152,1,76,0.0,48.0,48.0,1,76,0.0,48.0,48.0
15.082,17,17,8962,9,6362,1881.0,1350.0,678.0,8,2600,2150.0,1350.0,297.0
0.008,17,2,162,1,65,0.0,37.0,37.0,1,97,0.0,69.0,69.0
0.015,6,13,3735,7,497,2.0,125.0,125.0,6,3238,2.0,1470.0,1459.0
15.075,17,16,8684,8,6399,2149.0,1350.0,771.0,8,2285,2149.0,1350.0,257.0
0.063,6,10,1506,5,395,14.0,127.0,127.0,5,1111,14.0,843.0,843.0
40.1,17,10,676,5,460,10019.0,104.0,64.0,5,216,10021.0,20.0,15.0
15.08,17,15,7955,8,5944,2150.0,1350.0,715.0,7,2011,2508.0,1350.0,259.0
0.028,6,10,1989,5,910,6.0,642.0,642.0,5,1079,6.0,811.0,811.0
0.129,6,10,1506,5,395,26.0,127.0,127.0,5,1111,30.0,843.0,843.0
10.783,17,28,4423,14,1995,820.0,270.0,114.0,14,2428,821.0,587.0,145.0
0.076,6,10,1506,5,395,16.0,127.0,127.0,5,1111,17.0,843.0,843.0
0.007,6,10,1989,5,910,1.0,642.0,642.0,5,1079,1.0,811.0,811.0
0.004,6,10,2006,5,927,1.0,659.0,659.0,5,1079,1.0,811.0,811.0
0.004,17,2,148,1,60,0.0,32.0,32.0,1,88,0.0,60.0,60.0
0.005,6,10,2000,5,927,1.0,659.0,659.0,5,1073,1.0,805.0,805.0
1786.792,6,281,41410,114,22356,15811.0,2720.0,204.0,167,19054,10763.0,1360.0,150.0
0.17,6,3,453,2,321,170.0,241.0,241.0,1,132,0.0,92.0,92.0
0.003,17,2,148,1,60,0.0,32.0,32.0,1,88,0.0,60.0,60.0
0.005,17,2,166,1,75,0.0,47.0,47.0,1,91,0.0,63.0,63.0
0.012,6,10,1677,5,827,2.0,559.0,559.0,5,850,3.0,582.0,582.0
0.005,6,10,2006,5,927,1.0,659.0,659.0,5,1079,1.0,811.0,811.0
0.001,17,2,179,1,62,0.0,34.0,34.0,1,117,0.0,89.0,89.0
0.004,6,10,1774,5,923,1.0,655.0,655.0,5,851,1.0,583.0,583.0
0.009,17,2,168,1,76,0.0,48.0,48.0,1,92,0.0,64.0,64.0
0.005,17,2,166,1,75,0.0,47.0,47.0,1,91,0.0,63.0,63.0
0.004,17,2,144,1,64,0.0,36.0,36.0,1,80,0.0,52.0,52.0
0.006,17,2,136,1,60,0.0,32.0,32.0,1,76,0.0,48.0,48.0
15.073,17,14,9190,8,6902,2149.0,1350.0,834.0,6,2288,3008.0,1350.0,353.0
15.032,17,46,24892,24,19828,652.0,1350.0,798.0,22,5064,714.0,1350.0,202.0
40.067,17,10,676,5,460,10014.0,104.0,64.0,5,216,10016.0,20.0,15.0
0.006,6,10,1989,5,927,1.0,659.0,659.0,5,1062,1.0,794.0,794.0
0.011,6,10,1983,5,910,2.0,642.0,642.0,5,1073,2.0,805.0,805.0
0.066,6,10,1506,5,395,14.0,127.0,127.0,5,1111,15.0,843.0,843.0
0.006,6,10,1643,5,860,1.0,592.0,592.0,5,783,1.0,515.0,515.0
11.155,17,28,4421,14,1993,845.0,268.0,114.0,14,2428,845.0,587.0,145.0
0.004,6,10,2000,5,927,1.0,659.0,659.0,5,1073,1.0,805.0,805.0
40.062,17,10,676,5,460,10014.0,104.0,64.0,5,216,10014.0,20.0,15.0
0.004,6,10,2006,5,927,1.0,659.0,659.0,5,1079,1.0,811.0,811.0
0.085,6,10,1506,5,395,17.0,127.0,127.0,5,1111,20.0,843.0,843.0
0.081,6,10,1506,5,395,19.0,127.0,127.0,5,1111,17.0,843.0,843.0
0.011,6,10,1990,5,911,2.0,643.0,643.0,5,1079,2.0,811.0,811.0
0.124,17,4,284,2,120,0.0,32.0,32.0,2,164,121.0,60.0,54.0
0.741,6,10,2009,6,1655,148.0,1403.0,1403.0,4,354,170.0,182.0,182.0
353.02,6,20,2210,6,1308,12006.0,494.0,494.0,14,902,27154.0,83.0,83.0
0.004,17,2,148,1,60,0.0,32.0,32.0,1,88,0.0,60.0,60.0
0.006,6,10,1547,5,764,1.0,496.0,496.0,5,783,1.0,515.0,515.0
0.013,17,2,152,1,56,0.0,28.0,28.0,1,96,0.0,68.0,68.0
0.109,6,10,1506,5,395,25.0,127.0,127.0,5,1111,22.0,843.0,843.0
172.08,17,86,12495,43,2889,4097.0,44.0,39.0,43,9606,4097.0,261.0,195.0
0.012,6,10,1972,5,910,3.0,642.0,642.0,5,1062,2.0,794.0,794.0
0.003,17,2,136,1,60,0.0,32.0,32.0,1,76,0.0,48.0,48.0
0.005,6,10,2007,5,928,1.0,660.0,660.0,5,1079,1.0,811.0,811.0
0.013,17,2,152,1,56,0.0,28.0,28.0,1,96,0.0,68.0,68.0
0.009,6,10,1990,5,911,2.0,643.0,643.0,5,1079,2.0,811.0,811.0
0.137,6,10,1506,5,395,25.0,127.0,127.0,5,1111,31.0,843.0,843.0
11.191,17,28,4418,14,1994,848.0,269.0,114.0,14,2424,848.0,587.0,145.0
0.006,6,10,1547,5,764,1.0,496.0,496.0,5,783,1.0,515.0,515.0
0.004,6,10,2006,5,927,1.0,659.0,659.0,5,1079,1.0,811.0,811.0
0.001,17,2,180,1,65,0.0,37.0,37.0,1,115,0.0,87.0,87.0
0.163,17,2,152,1,76,0.0,48.0,48.0,1,76,0.0,48.0,48.0
0.003,17,2,136,1,60,0.0,32.0,32.0,1,76,0.0,48.0,48.0
0.014,6,10,1989,5,910,3.0,642.0,642.0,5,1079,3.0,811.0,811.0
0.039,17,2,148,1,60,0.0,32.0,32.0,1,88,0.0,60.0,60.0
0.037,17,2,184,1,61,0.0,33.0,33.0,1,123,0.0,95.0,95.0
0.004,6,10,1989,5,927,1.0,659.0,659.0,5,1062,1.0,794.0,794.0
0.206,6,10,1506,5,395,47.0,127.0,127.0,5,1111,46.0,843.0,843.0
0.012,6,10,1983,5,910,3.0,642.0,642.0,5,1073,3.0,805.0,805.0
301.481,6,61,27312,32,21080,9725.0,2720.0,1411.0,29,6232,332.0,2667.0,361.0
240.18,6,50,6926,24,3370,10442.0,588.0,211.0,26,3556,9607.0,580.0,183.0
1778.168,17,144,45504,72,22752,25044.0,288.0,288.0,72,22752,25044.0,288.0,288.0
0.013,6,10,1972,5,910,3.0,642.0,642.0,5,1062,3.0,794.0,794.0
0.041,17,2,170,1,65,0.0,37.0,37.0,1,105,0.0,77.0,77.0
0.009,17,2,170,1,65,0.0,37.0,37.0,1,105,0.0,77.0,77.0
0.142,6,10,1506,5,395,32.0,127.0,127.0,5,1111,31.0,843.0,843.0
0.006,6,10,1547,5,764,1.0,496.0,496.0,5,783,1.0,515.0,515.0
0.006,6,10,2007,5,928,1.0,660.0,660.0,5,1079,1.0,811.0,811.0
0.021,6,13,3735,7,497,3.0,125.0,125.0,6,3238,4.0,1470.0,1459.0
565.046,6,29,8048,16,3168,37669.0,676.0,388.0,13,4880,42082.0,1402.0,699.0
40.064,17,10,676,5,460,10013.0,104.0,64.0,5,216,10015.0,20.0,15.0
0.027,6,10,1677,5,827,6.0,559.0,559.0,5,850,6.0,582.0,582.0
0.006,6,10,2006,5,927,1.0,659.0,659.0,5,1079,1.0,811.0,811.0
0.012,6,10,1990,5,911,3.0,643.0,643.0,5,1079,3.0,811.0,811.0
0.006,6,10,1689,5,839,1.0,571.0,571.0,5,850,1.0,582.0,582.0
0.103,6,10,1506,5,395,16.0,127.0,127.0,5,1111,23.0,843.0,843.0
240.112,6,31,9440,15,7072,17150.0,2196.0,699.0,16,2368,16007.0,580.0,191.0
0.016,17,2,198,1,91,0.0,63.0,63.0,1,107,0.0,79.0,79.0
0.005,6,10,2006,5,927,1.0,659.0,659.0,5,1079,1.0,811.0,811.0
240.148,6,50,6976,24,3368,10441.0,588.0,211.0,26,3608,9605.0,580.0,187.0
40.066,17,10,676,5,460,10015.0,104.0,64.0,5,216,10013.0,20.0,15.0
0.005,6,10,2000,5,927,1.0,659.0,659.0,5,1073,1.0,805.0,805.0
11.137,17,28,4417,14,1994,843.0,269.0,114.0,14,2423,843.0,586.0,145.0
1778.28,17,144,45504,72,22752,25046.0,288.0,288.0,72,22752,25046.0,288.0,288.0
0.004,17,2,136,1,60,0.0,32.0,32.0,1,76,0.0,48.0,48.0
120.024,6,19,3889,12,3102,10911.0,494.0,494.0,7,787,20003.0,83.0,83.0
0.006,6,10,1689,5,839,1.0,571.0,571.0,5,850,1.0,582.0,582.0
240.089,6,16,4480,9,963,30011.0,238.0,166.0,7,3517,40014.0,1402.0,786.0
0.005,6,13,3747,7,509,0.0,137.0,137.0,6,3238,0.0,1470.0,1459.0
0.005,6,10,2006,5,927,1.0,659.0,659.0,5,1079,1.0,811.0,811.0
300.454,6,31,8820,15,2541,21460.0,1225.0,348.0,16,6279,20030.0,1592.0,545.0
0.004,6,10,2007,5,928,1.0,660.0,660.0,5,1079,1.0,811.0,811.0
0.005,6,14,3742,7,452,0.0,80.0,80.0,7,3290,0.0,1448.0,972.0
0.004,17,2,148,1,60,0.0,32.0,32.0,1,88,0.0,60.0,60.0
0.005,6,14,3799,7,509,0.0,137.0,137.0,7,3290,0.0,1448.0,972.0
0.014,6,10,1989,5,910,3.0,642.0,642.0,5,1079,3.0,811.0,811.0
0.074,6,10,1506,5,395,17.0,127.0,127.0,5,1111,15.0,843.0,843.0
0.005,17,2,170,1,65,0.0,37.0,37.0,1,105,0.0,77.0,77.0
0.02,6,10,1631,5,848,5.0,580.0,580.0,5,783,5.0,515.0,515.0
0.011,6,10,1990,5,911,2.0,643.0,643.0,5,1079,2.0,811.0,811.0
0.04,17,4,284,2,120,1.0,32.0,32.0,2,164,36.0,60.0,54.0
178.075,17,96,13894,48,3230,3788.0,44.0,39.0,48,10664,3788.0,239.0,194.0
165.076,17,66,9361,33,2194,5158.0,44.0,38.0,33,7167,5158.0,239.0,189.0
0.006,6,10,1854,5,889,1.0,621.0,621.0,5,965,1.0,697.0,697.0
0.005,17,2,164,1,74,0.0,46.0,46.0,1,90,0.0,62.0,62.0
0.009,6,12,1926,6,1189,1.0,659.0,434.0,6,737,1.0,417.0,417.0
0.079,6,10,1506,5,395,18.0,127.0,127.0,5,1111,16.0,843.0,843.0
0.011,6,10,1989,5,910,2.0,642.0,642.0,5,1079,2.0,811.0,811.0
0.013,6,10,1989,5,910,3.0,642.0,642.0,5,1079,3.0,811.0,811.0
0.005,6,10,2006,5,927,1.0,659.0,659.0,5,1079,1.0,811.0,811.0
0.018,6,10,1989,5,910,4.0,642.0,642.0,5,1079,4.0,811.0,811.0
0.09,6,10,1506,5,395,21.0,127.0,127.0,5,1111,20.0,843.0,843.0
411.264,6,30,6180,19,4936,22848.0,494.0,494.0,11,1244,41125.0,83.0,83.0
0.001,17,2,136,1,60,0.0,32.0,32.0,1,76,0.0,48.0,48.0
0.203,6,16,2777,8,1395,29.0,533.0,323.0,8,1382,18.0,529.0,239.0
66.523,6,87,85780,42,11295,1622.0,2834.0,1300.0,45,74485,1508.0,2804.0,1898.0
0.005,6,10,2007,5,928,1.0,660.0,660.0,5,1079,1.0,811.0,811.0
0.015,6,10,1631,5,848,3.0,580.0,580.0,5,783,3.0,515.0,515.0
0.003,17,4,284,2,120,0.0,32.0,32.0,2,164,0.0,60.0,54.0
0.003,17,2,162,1,65,0.0,37.0,37.0,1,97,0.0,69.0,69.0
0.012,6,10,1631,5,848,3.0,580.0,580.0,5,783,2.0,515.0,515.0
0.006,6,10,1547,5,764,1.0,496.0,496.0,5,783,1.0,515.0,515.0
0.006,17,2,179,1,71,0.0,43.0,43.0,1,108,0.0,80.0,80.0
0.004,17,2,148,1,60,0.0,32.0,32.0,1,88,0.0,60.0,60.0
0.011,6,10,1972,5,910,2.0,642.0,642.0,5,1062,2.0,794.0,794.0
164.142,17,78,11076,39,2601,4319.0,44.0,38.0,39,8475,4319.0,260.0,189.0
0.173,17,2,152,1,76,0.0,48.0,48.0,1,76,0.0,48.0,48.0
159.284,17,76,10598,38,2529,4304.0,44.0,38.0,38,8069,4304.0,261.0,184.0
40.061,17,10,676,5,460,10013.0,104.0,64.0,5,216,10014.0,20.0,15.0
0.068,17,8,3613,4,1874,22.0,1350.0,440.0,4,1739,11.0,1350.0,406.0
240.484,6,37,9658,19,2174,13360.0,746.0,235.0,18,7484,14145.0,1402.0,595.0
40.077,17,10,676,5,460,10018.0,104.0,64.0,5,216,10018.0,20.0,15.0
0.005,6,10,2006,5,927,1.0,659.0,659.0,5,1079,1.0,811.0,811.0
11.223,17,28,4422,14,1995,850.0,270.0,114.0,14,2427,849.0,586.0,145.0
0.005,6,13,3747,7,509,0.0,137.0,137.0,6,3238,0.0,1470.0,1459.0
0.012,6,10,1990,5,911,3.0,643.0,643.0,5,1079,3.0,811.0,811.0
0.07,17,8,3613,4,1874,23.0,1350.0,440.0,4,1739,12.0,1350.0,406.0
0.005,6,14,3742,8,504,0.0,80.0,80.0,6,3238,0.0,1470.0,1459.0
0.091,6,10,1506,5,395,21.0,127.0,127.0,5,1111,22.0,843.0,843.0
0.013,6,10,1762,5,911,3.0,643.0,643.0,5,851,3.0,583.0,583.0
0.084,6,10,1506,5,395,17.0,127.0,127.0,5,1111,19.0,843.0,843.0
0.005,6,10,1854,5,889,1.0,621.0,621.0,5,965,1.0,697.0,697.0
0.001,17,2,180,1,66,0.0,38.0,38.0,1,114,0.0,86.0,86.0
0.006,6,10,1689,5,839,1.0,571.0,571.0,5,850,1.0,582.0,582.0
0.008,6,10,1989,5,910,2.0,642.0,642.0,5,1079,1.0,811.0,811.0
0.005,6,10,2007,5,928,1.0,660.0,660.0,5,1079,1.0,811.0,811.0
0.01,6,10,1990,5,911,2.0,643.0,643.0,5,1079,2.0,811.0,811.0
0.008,6,10,1990,5,911,2.0,643.0,643.0,5,1079,2.0,811.0,811.0
0.005,6,10,1689,5,839,1.0,571.0,571.0,5,850,1.0,582.0,582.0
0.018,6,10,1989,5,910,4.0,642.0,642.0,5,1079,4.0,811.0,811.0
1791.268,6,282,26799,142,9824,12704.0,747.0,270.0,140,16975,12886.0,1625.0,72.0
0.165,6,10,1506,5,395,38.0,127.0,127.0,5,1111,38.0,843.0,843.0
0.099,6,10,1506,5,395,23.0,127.0,127.0,5,1111,20.0,843.0,843.0
0.007,6,13,3816,7,578,1.0,206.0,206.0,6,3238,1.0,1470.0,1459.0
10.829,17,28,4422,14,1994,824.0,269.0,114.0,14,2428,824.0,587.0,145.0
0.784,6,10,937,6,427,156.0,107.0,107.0,4,510,174.0,294.0,294.0
40.08,17,10,676,5,460,10019.0,104.0,64.0,5,216,10019.0,20.0,15.0
0.145,6,10,1506,5,395,23.0,127.0,127.0,5,1111,30.0,843.0,843.0
0.004,6,10,2007,5,928,1.0,660.0,660.0,5,1079,1.0,811.0,811.0
0.004,6,10,2006,5,927,1.0,659.0,659.0,5,1079,1.0,811.0,811.0
0.074,6,10,1506,5,395,16.0,127.0,127.0,5,1111,17.0,843.0,843.0
0.005,6,10,2006,5,927,1.0,659.0,659.0,5,1079,1.0,811.0,811.0
0.124,17,4,352,2,130,0.0,37.0,37.0,2,222,84.0,89.0,83.0
0.007,6,10,1990,5,911,1.0,643.0,643.0,5,1079,1.0,811.0,811.0
0.084,6,10,1506,5,395,19.0,127.0,127.0,5,1111,15.0,843.0,843.0
0.015,6,10,1983,5,910,3.0,642.0,642.0,5,1073,3.0,805.0,805.0
241.715,6,305,342512,115,17493,2120.0,2736.0,959.0,190,325019,1278.0,2804.0,1750.0
0.005,6,10,2006,5,927,1.0,659.0,659.0,5,1079,1.0,811.0,811.0
0.013,6,10,1762,5,911,3.0,643.0,643.0,5,851,3.0,583.0,583.0
0.006,6,12,1698,6,863,1.0,327.0,271.0,6,835,1.0,515.0,515.0
0.119,6,10,1506,5,395,27.0,127.0,127.0,5,1111,25.0,843.0,843.0
0.012,6,10,1983,5,910,3.0,642.0,642.0,5,1073,3.0,805.0,805.0
0.005,17,2,140,1,62,0.0,34.0,34.0,1,78,0.0,50.0,50.0
0.023,17,2,194,1,59,0.0,31.0,31.0,1,135,0.0,107.0,107.0
0.014,6,10,1677,5,827,3.0,559.0,559.0,5,850,3.0,582.0,582.0
40.049,17,10,676,5,460,10011.0,104.0,64.0,5,216,10011.0,20.0,15.0
280.249,6,22,6035,10,1186,31138.0,267.0,156.0,12,4849,25476.0,1400.0,873.0
0.016,6,10,1990,5,911,4.0,643.0,643.0,5,1079,3.0,811.0,811.0
0.002,17,2,194,1,57,0.0,29.0,29.0,1,137,0.0,109.0,109.0
0.008,6,10,1677,5,827,2.0,559.0,559.0,5,850,2.0,582.0,582.0
368.652,6,22,2313,16,867,24576.0,195.0,195.0,6,1446,4647.0,419.0,398.0
0.01,6,10,1677,5,827,2.0,559.0,559.0,5,850,2.0,582.0,582.0
1729.428,6,62,7194,41,4397,43235.0,1626.0,112.0,21,2797,86463.0,1116.0,85.0
0.005,6,10,2006,5,927,1.0,659.0,659.0,5,1079,1.0,811.0,811.0
0.013,6,10,1972,5,910,3.0,642.0,642.0,5,1062,3.0,794.0,794.0
0.009,6,10,1989,5,910,2.0,642.0,642.0,5,1079,2.0,811.0,811.0
0.064,6,10,1506,5,395,14.0,127.0,127.0,5,1111,13.0,843.0,843.0
0.01,17,2,148,1,60,0.0,32.0,32.0,1,88,0.0,60.0,60.0
0.013,6,10,1983,5,910,3.0,642.0,642.0,5,1073,3.0,805.0,805.0
0.005,6,10,2007,5,928,1.0,660.0,660.0,5,1079,1.0,811.0,811.0
0.005,6,10,2006,5,927,1.0,659.0,659.0,5,1079,1.0,811.0,811.0
0.001,17,2,180,1,66,0.0,38.0,38.0,1,114,0.0,86.0,86.0
40.064,17,10,676,5,460,10015.0,104.0,64.0,5,216,10015.0,20.0,15.0
0.01,6,10,1972,5,910,2.0,642.0,642.0,5,1062,2.0,794.0,794.0
0.075,17,2,148,1,60,0.0,32.0,32.0,1,88,0.0,60.0,60.0
0.009,6,12,1926,6,1189,1.0,659.0,434.0,6,737,1.0,417.0,417.0
0.08,6,10,1506,5,395,19.0,127.0,127.0,5,1111,19.0,843.0,843.0
0.01,6,10,1990,5,911,2.0,643.0,643.0,5,1079,2.0,811.0,811.0
0.005,17,2,154,1,69,0.0,41.0,41.0,1,85,0.0,57.0,57.0
0.004,17,2,144,1,64,0.0,36.0,36.0,1,80,0.0,52.0,52.0
0.006,6,10,2006,5,927,1.0,659.0,659.0,5,1079,1.0,811.0,811.0
0.005,6,10,1689,5,839,1.0,571.0,571.0,5,850,1.0,582.0,582.0
0.006,6,10,1689,5,839,1.0,571.0,571.0,5,850,1.0,582.0,582.0
0.004,6,10,2000,5,927,1.0,659.0,659.0,5,1073,1.0,805.0,805.0
0.003,17,2,136,1,60,0.0,32.0,32.0,1,76,0.0,48.0,48.0
0.009,6,10,1972,5,910,2.0,642.0,642.0,5,1062,2.0,794.0,794.0
0.007,17,2,194,1,59,0.0,31.0,31.0,1,135,0.0,107.0,107.0
146.631,6,25,9107,14,3269,85.0,1360.0,666.0,11,5838,14645.0,2720.0,897.0
0.012,6,10,1989,5,910,3.0,642.0,642.0,5,1079,3.0,811.0,811.0
0.016,6,10,1989,5,910,4.0,642.0,642.0,5,1079,4.0,811.0,811.0
0.006,6,10,1854,5,889,1.0,621.0,621.0,5,965,1.0,697.0,697.0
0.013,6,10,1990,5,911,3.0,643.0,643.0,5,1079,3.0,811.0,811.0
0.006,6,10,1547,5,764,1.0,496.0,496.0,5,783,1.0,515.0,515.0
0.117,6,10,1506,5,395,27.0,127.0,127.0,5,1111,27.0,843.0,843.0
0.04,6,10,1983,5,910,9.0,642.0,642.0,5,1073,10.0,805.0,805.0
0.005,6,10,2006,5,927,1.0,659.0,659.0,5,1079,1.0,811.0,811.0
0.015,6,10,1989,5,910,3.0,642.0,642.0,5,1079,3.0,811.0,811.0
0.018,6,10,1989,5,910,4.0,642.0,642.0,5,1079,4.0,811.0,811.0
40.056,17,10,676,5,460,10011.0,104.0,64.0,5,216,10013.0,20.0,15.0
0.004,6,10,1702,5,863,1.0,595.0,595.0,5,839,1.0,571.0,571.0
0.005,17,2,170,1,65,0.0,37.0,37.0,1,105,0.0,77.0,77.0
0.003,17,2,148,1,60,0.0,32.0,32.0,1,88,0.0,60.0,60.0
0.175,6,10,1506,5,395,40.0,127.0,127.0,5,1111,42.0,843.0,843.0
0.011,6,10,1989,5,910,2.0,642.0,642.0,5,1079,2.0,811.0,811.0
0.005,6,10,2000,5,927,1.0,659.0,659.0,5,1073,1.0,805.0,805.0
0.012,6,10,1989,5,910,3.0,642.0,642.0,5,1079,3.0,811.0,811.0
0.005,6,10,2000,5,927,1.0,659.0,659.0,5,1073,1.0,805.0,805.0
178.496,17,78,10870,39,2600,4697.0,44.0,38.0,39,8270,4697.0,261.0,184.0
0.005,17,2,148,1,60,0.0,32.0,32.0,1,88,0.0,60.0,60.0
0.095,6,10,1506,5,395,17.0,127.0,127.0,5,1111,22.0,843.0,843.0
0.18,6,10,1506,5,395,42.0,127.0,127.0,5,1111,40.0,843.0,843.0
0.069,6,10,1506,5,395,15.0,127.0,127.0,5,1111,15.0,843.0,843.0
0.013,6,10,1631,5,848,3.0,580.0,580.0,5,783,3.0,515.0,515.0
0.037,17,2,166,1,75,0.0,47.0,47.0,1,91,0.0,63.0,63.0
0.113,6,10,1506,5,395,25.0,127.0,127.0,5,1111,25.0,843.0,843.0
0.013,6,13,3735,7,497,2.0,125.0,125.0,6,3238,2.0,1470.0,1459.0
176.446,17,72,10120,36,2401,5041.0,44.0,38.0,36,7719,5041.0,249.0,186.0
0.014,6,10,1983,5,910,3.0,642.0,642.0,5,1073,3.0,805.0,805.0
0.008,6,12,1926,6,1189,1.0,659.0,434.0,6,737,1.0,417.0,417.0
40.064,17,10,676,5,460,10015.0,104.0,64.0,5,216,10015.0,20.0,15.0
0.019,6,10,1990,5,911,4.0,643.0,643.0,5,1079,4.0,811.0,811.0
0.005,6,10,1989,5,927,1.0,659.0,659.0,5,1062,1.0,794.0,794.0
0.155,6,10,1506,5,395,36.0,127.0,127.0,5,1111,32.0,843.0,843.0
0.004,17,2,148,1,60,0.0,32.0,32.0,1,88,0.0,60.0,60.0
0.006,6,10,1547,5,764,1.0,496.0,496.0,5,783,1.0,515.0,515.0
0.005,6,10,2007,5,928,1.0,660.0,660.0,5,1079,1.0,811.0,811.0
0.005,6,10,1854,5,889,1.0,621.0,621.0,5,965,1.0,697.0,697.0
0.079,6,10,1506,5,395,17.0,127.0,127.0,5,1111,17.0,843.0,843.0
0.006,17,2,225,1,65,0.0,37.0,37.0,1,160,0.0,132.0,132.0
0.013,6,10,1972,5,910,3.0,642.0,642.0,5,1062,3.0,794.0,794.0
61.099,6,25,17458,14,9563,4699.0,2804.0,1473.0,11,7895,6096.0,2432.0,1219.0
0.011,6,10,1983,5,910,2.0,642.0,642.0,5,1073,2.0,805.0,805.0
720.554,6,44,2612,25,1462,30021.0,27.0,27.0,19,1150,40028.0,27.0,27.0
0.091,6,10,1506,5,395,19.0,127.0,127.0,5,1111,20.0,843.0,843.0
240.086,6,16,4481,9,963,30010.0,238.0,166.0,7,3518,40013.0,1402.0,786.0
0.067,17,8,3613,4,1874,22.0,1350.0,440.0,4,1739,11.0,1350.0,406.0
0.021,17,2,144,1,64,0.0,36.0,36.0,1,80,0.0,52.0,52.0
0.006,6,10,2007,5,928,1.0,660.0,660.0,5,1079,1.0,811.0,811.0
0.173,17,2,152,1,76,0.0,48.0,48.0,1,76,0.0,48.0,48.0
0.005,6,10,1774,5,923,1.0,655.0,655.0,5,851,1.0,583.0,583.0
0.013,6,13,3735,7,497,2.0,125.0,125.0,6,3238,2.0,1470.0,1459.0
0.014,6,10,1983,5,910,3.0,642.0,642.0,5,1073,3.0,805.0,805.0
0.012,6,14,3787,7,497,2.0,125.0,125.0,7,3290,2.0,1448.0,972.0
240.019,6,9,787,5,488,60004.0,232.0,232.0,4,299,80005.0,83.0,83.0
0.114,6,10,1506,5,395,27.0,127.0,127.0,5,1111,24.0,843.0,843.0
0.01,6,10,1677,5,827,2.0,559.0,559.0,5,850,2.0,582.0,582.0
0.008,6,10,1989,5,910,2.0,642.0,642.0,5,1079,1.0,811.0,811.0
354.067,6,21,1795,16,1030,23604.0,190.0,190.0,5,765,60001.0,464.0,248.0
351.987,6,20,2210,6,1308,12003.0,494.0,494.0,14,902,27075.0,83.0,83.0
0.163,6,10,1506,5,395,38.0,127.0,127.0,5,1111,37.0,843.0,843.0
0.109,6,10,1506,5,395,24.0,127.0,127.0,5,1111,23.0,843.0,843.0
10.98,17,28,4397,14,2312,835.0,587.0,137.0,14,2085,836.0,268.0,120.0
0.004,6,10,2007,5,928,1.0,660.0,660.0,5,1079,1.0,811.0,811.0
0.003,17,4,284,2,120,0.0,32.0,32.0,2,164,0.0,60.0,54.0
280.715,6,25,6480,12,1266,25519.0,267.0,156.0,13,5214,23391.0,1400.0,781.0
0.009,17,4,284,2,120,0.0,32.0,32.0,2,164,0.0,60.0,54.0
0.092,6,10,1506,5,395,18.0,127.0,127.0,5,1111,20.0,843.0,843.0
0.013,6,10,1972,5,910,3.0,642.0,642.0,5,1062,3.0,794.0,794.0
0.091,6,10,1506,5,395,19.0,127.0,127.0,5,1111,19.0,843.0,843.0
0.004,6,10,1989,5,927,1.0,659.0,659.0,5,1062,1.0,794.0,794.0
0.005,6,10,2006,5,927,1.0,659.0,659.0,5,1079,1.0,811.0,811.0
0.07,6,10,1506,5,395,15.0,127.0,127.0,5,1111,17.0,843.0,843.0
10.923,17,28,4421,14,1993,832.0,268.0,114.0,14,2428,832.0,587.0,145.0
0.033,6,10,1983,5,910,8.0,642.0,642.0,5,1073,8.0,805.0,805.0
0.004,6,10,2006,5,927,1.0,659.0,659.0,5,1079,1.0,811.0,811.0
300.315,6,16,2170,9,684,37518.0,146.0,146.0,7,1486,50024.0,419.0,398.0
0.004,17,2,214,1,75,0.0,47.0,47.0,1,139,0.0,111.0,111.0
0.089,6,10,1506,5,395,16.0,127.0,127.0,5,1111,19.0,843.0,843.0
0.006,6,10,1547,5,764,1.0,496.0,496.0,5,783,1.0,515.0,515.0
0.006,6,10,1854,5,889,1.0,621.0,621.0,5,965,1.0,697.0,697.0
242.01,6,390,347686,191,21460,1273.0,2736.0,886.0,199,326226,1222.0,2804.0,1671.0
0.007,17,2,169,1,62,0.0,34.0,34.0,1,107,0.0,79.0,79.0
0.016,6,10,1989,5,910,4.0,642.0,642.0,5,1079,4.0,811.0,811.0
0.013,6,13,3735,7,497,2.0,125.0,125.0,6,3238,2.0,1470.0,1459.0
0.076,6,10,1506,5,395,17.0,127.0,127.0,5,1111,17.0,843.0,843.0
0.008,6,10,1762,5,911,2.0,643.0,643.0,5,851,2.0,583.0,583.0
40.056,17,10,676,5,460,10013.0,104.0,64.0,5,216,10013.0,20.0,15.0
0.011,6,10,1631,5,848,2.0,580.0,580.0,5,783,2.0,515.0,515.0
0.012,17,2,214,1,75,0.0,47.0,47.0,1,139,0.0,111.0,111.0
0.104,6,10,1506,5,395,23.0,127.0,127.0,5,1111,21.0,843.0,843.0
300.286,6,16,2170,9,684,37514.0,146.0,146.0,7,1486,50019.0,419.0,398.0
0.013,17,2,170,1,65,0.0,37.0,37.0,1,105,0.0,77.0,77.0
0.006,17,2,136,1,60,0.0,32.0,32.0,1,76,0.0,48.0,48.0
0.003,17,2,136,1,60,0.0,32.0,32.0,1,76,0.0,48.0,48.0
0.116,6,10,1506,5,395,26.0,127.0,127.0,5,1111,20.0,843.0,843.0
10.9,17,28,4423,14,1994,830.0,269.0,114.0,14,2429,830.0,588.0,145.0
0.014,6,13,3735,7,497,2.0,125.0,125.0,6,3238,2.0,1470.0,1459.0
0.108,6,10,1506,5,395,23.0,127.0,127.0,5,1111,24.0,843.0,843.0
0.019,6,10,1990,5,911,4.0,643.0,643.0,5,1079,4.0,811.0,811.0
0.001,17,2,136,1,60,0.0,32.0,32.0,1,76,0.0,48.0,48.0
0.005,6,10,2006,5,927,1.0,659.0,659.0,5,1079,1.0,811.0,811.0
0.007,17,2,194,1,59,0.0,31.0,31.0,1,135,0.0,107.0,107.0
0.003,17,2,148,1,60,0.0,32.0,32.0,1,88,0.0,60.0,60.0
0.075,6,10,1506,5,395,17.0,127.0,127.0,5,1111,13.0,843.0,843.0
0.004,6,10,2006,5,927,1.0,659.0,659.0,5,1079,1.0,811.0,811.0
0.007,6,10,1762,5,911,1.0,643.0,643.0,5,851,1.0,583.0,583.0
66.153,6,22,10140,12,3973,6013.0,1579.0,835.0,10,6167,7331.0,2111.0,939.0
0.013,6,10,1983,5,910,3.0,642.0,642.0,5,1073,3.0,805.0,805.0
40.069,17,10,676,5,460,10014.0,104.0,64.0,5,216,10016.0,20.0,15.0
0.008,6,12,1926,6,1189,1.0,659.0,434.0,6,737,1.0,417.0,417.0
0.016,6,10,1989,5,910,4.0,642.0,642.0,5,1079,3.0,811.0,811.0
0.005,17,2,140,1,62,0.0,34.0,34.0,1,78,0.0,50.0,50.0
0.038,17,2,152,1,76,0.0,48.0,48.0,1,76,0.0,48.0,48.0
0.011,6,10,1983,5,910,2.0,642.0,642.0,5,1073,2.0,805.0,805.0
0.006,17,2,273,1,66,0.0,38.0,38.0,1,207,0.0,179.0,179.0
40.067,17,10,676,5,460,10015.0,104.0,64.0,5,216,10015.0,20.0,15.0
1.089,6,32,13392,18,5893,64.0,2720.0,854.0,14,7499,70.0,2565.0,769.0
0.004,6,10,2000,5,927,1.0,659.0,659.0,5,1073,1.0,805.0,805.0
0.016,6,10,1990,5,911,4.0,643.0,643.0,5,1079,3.0,811.0,811.0
0.04,17,2,136,1,60,0.0,32.0,32.0,1,76,0.0,48.0,48.0
0.011,6,10,1983,5,910,2.0,642.0,642.0,5,1073,2.0,805.0,805.0
0.172,17,2,152,1,76,0.0,48.0,48.0,1,76,0.0,48.0,48.0
0.009,6,10,1990,5,911,2.0,643.0,643.0,5,1079,2.0,811.0,811.0
10.81,17,26,4100,13,1845,892.0,268.0,113.0,13,2255,892.0,586.0,145.0
0.001,17,2,180,1,66,0.0,38.0,38.0,1,114,0.0,86.0,86.0
0.095,6,10,1506,5,395,22.0,127.0,127.0,5,1111,22.0,843.0,843.0
0.091,6,10,1506,5,395,19.0,127.0,127.0,5,1111,19.0,843.0,843.0
0.008,6,10,1989,5,910,2.0,642.0,642.0,5,1079,1.0,811.0,811.0
0.025,6,10,1972,5,910,6.0,642.0,642.0,5,1062,6.0,794.0,794.0
0.005,6,14,3742,7,452,0.0,80.0,80.0,7,3290,0.0,1448.0,972.0
0.006,6,10,1779,5,928,1.0,660.0,660.0,5,851,1.0,583.0,583.0
240.268,6,44,8825,22,5738,11441.0,1515.0,509.0,22,3087,11441.0,580.0,241.0
0.037,17,2,152,1,76,0.0,48.0,48.0,1,76,0.0,48.0,48.0
0.038,17,2,152,1,76,0.0,48.0,48.0,1,76,0.0,48.0,48.0
0.001,17,2,178,1,81,0.0,53.0,53.0,1,97,0.0,69.0,69.0
0.005,6,10,2007,5,928,1.0,660.0,660.0,5,1079,1.0,811.0,811.0
15.07,17,15,9238,8,6902,2148.0,1350.0,834.0,7,2336,2506.0,1350.0,305.0
0.008,6,10,1854,5,889,2.0,621.0,621.0,5,965,2.0,697.0,697.0
40.062,17,10,676,5,460,10012.0,104.0,64.0,5,216,10014.0,20.0,15.0
0.006,6,10,1989,5,910,1.0,642.0,642.0,5,1079,1.0,811.0,811.0
0.1,6,10,1506,5,395,20.0,127.0,127.0,5,1111,22.0,843.0,843.0
0.006,6,10,1547,5,764,1.0,496.0,496.0,5,783,1.0,515.0,515.0
0.02,6,10,1990,5,911,4.0,643.0,643.0,5,1079,5.0,811.0,811.0
308.517,17,18,1008,9,640,38549.0,48.0,43.0,9,368,38549.0,20.0,12.0
0.072,17,2,136,1,60,0.0,32.0,32.0,1,76,0.0,48.0,48.0
368.918,6,22,2313,16,867,24594.0,195.0,195.0,6,1446,4657.0,419.0,398.0
0.006,17,2,169,1,62,0.0,34.0,34.0,1,107,0.0,79.0,79.0
0.105,6,10,1506,5,395,24.0,127.0,127.0,5,1111,25.0,843.0,843.0
0.006,6,10,1689,5,839,1.0,571.0,571.0,5,850,1.0,582.0,582.0
0.015,6,10,1989,5,910,3.0,642.0,642.0,5,1079,3.0,811.0,811.0
293.343,6,397,348782,189,21386,1560.0,2736.0,825.0,208,327396,1417.0,2855.0,1623.0
366.467,6,22,2313,16,867,24431.0,195.0,195.0,6,1446,4638.0,419.0,398.0
0.005,17,2,144,1,64,0.0,36.0,36.0,1,80,0.0,52.0,52.0
0.07,6,10,1506,5,395,15.0,127.0,127.0,5,1111,14.0,843.0,843.0
0.005,17,2,168,1,76,0.0,48.0,48.0,1,92,0.0,64.0,64.0
0.004,6,10,1989,5,927,1.0,659.0,659.0,5,1062,1.0,794.0,794.0
0.01,6,10,1989,5,910,2.0,642.0,642.0,5,1079,2.0,811.0,811.0
240.285,6,43,8771,21,5686,12014.0,1515.0,509.0,22,3085,11441.0,580.0,241.0
0.004,6,10,2006,5,927,1.0,659.0,659.0,5,1079,1.0,811.0,811.0
0.046,6,10,1983,5,910,11.0,642.0,642.0,5,1073,11.0,805.0,805.0
0.016,6,10,1983,5,910,4.0,642.0,642.0,5,1073,3.0,805.0,805.0
0.006,6,10,1547,5,764,1.0,496.0,496.0,5,783,1.0,515.0,515.0
0.006,17,2,213,1,69,0.0,41.0,41.0,1,144,0.0,116.0,116.0
40.061,17,10,676,5,460,10014.0,104.0,64.0,5,216,10014.0,20.0,15.0
0.009,6,12,1926,6,1189,1.0,659.0,434.0,6,737,1.0,417.0,417.0
353.313,6,20,2210,6,1308,12003.0,494.0,494.0,14,902,27177.0,83.0,83.0
0.004,6,10,1779,5,928,1.0,660.0,660.0,5,851,1.0,583.0,583.0
0.004,6,10,1702,5,863,1.0,595.0,595.0,5,839,1.0,571.0,571.0
0.004,17,4,284,2,120,0.0,32.0,32.0,2,164,0.0,60.0,54.0
300.415,6,16,2170,9,684,37530.0,146.0,146.0,7,1486,50040.0,419.0,398.0
0.008,6,10,1774,5,923,2.0,655.0,655.0,5,851,2.0,583.0,583.0
0.009,6,10,1989,5,910,2.0,642.0,642.0,5,1079,2.0,811.0,811.0
0.005,6,10,1689,5,839,1.0,571.0,571.0,5,850,1.0,582.0,582.0
0.001,17,2,180,1,66,0.0,38.0,38.0,1,114,0.0,86.0,86.0
671.891,6,29,8006,16,3168,44792.0,676.0,388.0,13,4838,50987.0,1402.0,692.0
0.011,6,10,1989,5,910,2.0,642.0,642.0,5,1079,2.0,811.0,811.0
0.005,6,10,1989,5,927,1.0,659.0,659.0,5,1062,1.0,794.0,794.0
0.006,6,10,1643,5,860,1.0,592.0,592.0,5,783,1.0,515.0,515.0
0.118,6,10,1506,5,395,26.0,127.0,127.0,5,1111,26.0,843.0,843.0
0.003,17,4,420,2,122,0.0,33.0,33.0,2,298,0.0,145.0,121.0
0.004,6,10,1774,5,923,1.0,655.0,655.0,5,851,1.0,583.0,583.0
0.068,6,10,1506,5,395,14.0,127.0,127.0,5,1111,14.0,843.0,843.0
0.004,6,10,2006,5,927,1.0,659.0,659.0,5,1079,1.0,811.0,811.0
0.007,6,10,1854,5,889,1.0,621.0,621.0,5,965,1.0,697.0,697.0
300.296,6,16,2170,9,684,37516.0,146.0,146.0,7,1486,50021.0,419.0,398.0
0.005,6,10,1689,5,839,1.0,571.0,571.0,5,850,1.0,582.0,582.0
0.011,6,10,1990,5,911,2.0,643.0,643.0,5,1079,2.0,811.0,811.0
0.015,6,10,1989,5,910,3.0,642.0,642.0,5,1079,3.0,811.0,811.0
364.428,6,21,1793,16,1030,24295.0,190.0,190.0,5,763,60011.0,462.0,247.0
0.008,6,10,1989,5,910,2.0,642.0,642.0,5,1079,1.0,811.0,811.0
300.372,6,16,2170,9,684,37526.0,146.0,146.0,7,1486,50035.0,419.0,398.0
0.008,6,10,1762,5,911,2.0,643.0,643.0,5,851,2.0,583.0,583.0
0.083,6,10,1506,5,395,19.0,127.0,127.0,5,1111,16.0,843.0,843.0
0.005,6,10,2000,5,927,1.0,659.0,659.0,5,1073,1.0,805.0,805.0
0.005,6,10,2006,5,927,1.0,659.0,659.0,5,1079,1.0,811.0,811.0
0.068,17,2,144,1,64,0.0,36.0,36.0,1,80,0.0,52.0,52.0
0.008,6,10,1972,5,910,1.0,642.0,642.0,5,1062,2.0,794.0,794.0
0.006,17,2,157,1,59,0.0,31.0,31.0,1,98,0.0,70.0,70.0
0.006,6,10,2006,5,927,1.0,659.0,659.0,5,1079,1.0,811.0,811.0
0.006,6,10,1547,5,764,1.0,496.0,496.0,5,783,1.0,515.0,515.0
0.038,17,2,136,1,60,0.0,32.0,32.0,1,76,0.0,48.0,48.0
0.004,17,4,284,2,120,0.0,32.0,32.0,2,164,0.0,60.0,54.0
0.004,6,10,1989,5,927,1.0,659.0,659.0,5,1062,1.0,794.0,794.0
0.005,6,10,2007,5,928,1.0,660.0,660.0,5,1079,1.0,811.0,811.0
0.026,6,10,1983,5,910,6.0,642.0,642.0,5,1073,6.0,805.0,805.0
0.085,6,10,1506,5,395,19.0,127.0,127.0,5,1111,16.0,843.0,843.0
0.016,17,2,198,1,91,0.0,63.0,63.0,1,107,0.0,79.0,79.0
240.277,6,42,5404,22,2542,11441.0,588.0,196.0,20,2862,12646.0,580.0,226.0
0.005,6,10,2000,5,927,1.0,659.0,659.0,5,1073,1.0,805.0,805.0
0.006,6,10,1547,5,764,1.0,496.0,496.0,5,783,1.0,515.0,515.0
0.015,6,10,1983,5,910,3.0,642.0,642.0,5,1073,3.0,805.0,805.0
0.006,6,10,1643,5,860,1.0,592.0,592.0,5,783,1.0,515.0,515.0
0.137,6,10,1506,5,395,32.0,127.0,127.0,5,1111,32.0,843.0,843.0
0.095,6,10,1506,5,395,22.0,127.0,127.0,5,1111,18.0,843.0,843.0
0.005,6,10,2006,5,927,1.0,659.0,659.0,5,1079,1.0,811.0,811.0
134.522,6,20,3472,10,1537,14941.0,533.0,252.0,10,1935,14941.0,529.0,281.0
173.399,17,82,11443,41,2743,4334.0,44.0,38.0,41,8700,4334.0,239.0,184.0
0.172,17,2,152,1,76,0.0,48.0,48.0,1,76,0.0,48.0,48.0
0.004,6,10,2006,5,927,1.0,659.0,659.0,5,1079,1.0,811.0,811.0
0.005,17,2,214,1,75,0.0,47.0,47.0,1,139,0.0,111.0,111.0
0.003,17,2,136,1,60,0.0,32.0,32.0,1,76,0.0,48.0,48.0
0.006,6,10,1547,5,764,1.0,496.0,496.0,5,783,1.0,515.0,515.0
0.039,17,2,152,1,76,0.0,48.0,48.0,1,76,0.0,48.0,48.0
0.081,6,10,1506,5,395,15.0,127.0,127.0,5,1111,18.0,843.0,843.0
0.133,6,10,1506,5,395,26.0,127.0,127.0,5,1111,27.0,843.0,843.0
0.005,6,10,2000,5,927,1.0,659.0,659.0,5,1073,1.0,805.0,805.0
0.014,6,10,1972,5,910,3.0,642.0,642.0,5,1062,3.0,794.0,794.0
0.005,6,10,2007,5,928,1.0,660.0,660.0,5,1079,1.0,811.0,811.0
0.02,6,10,1990,5,911,5.0,643.0,643.0,5,1079,5.0,811.0,811.0
0.004,6,10,2007,5,928,1.0,660.0,660.0,5,1079,1.0,811.0,811.0
0.006,17,2,225,1,65,0.0,37.0,37.0,1,160,0.0,132.0,132.0
0.005,6,10,1689,5,839,1.0,571.0,571.0,5,850,1.0,582.0,582.0
0.039,17,2,170,1,65,0.0,37.0,37.0,1,105,0.0,77.0,77.0
0.01,6,10,1983,5,910,2.0,642.0,642.0,5,1073,2.0,805.0,805.0
0.005,6,10,2000,5,927,1.0,659.0,659.0,5,1073,1.0,805.0,805.0
0.111,6,10,1506,5,395,26.0,127.0,127.0,5,1111,24.0,843.0,843.0
0.09,6,10,1506,5,395,20.0,127.0,127.0,5,1111,20.0,843.0,843.0
0.012,6,10,1989,5,910,2.0,642.0,642.0,5,1079,3.0,811.0,811.0
0.139,6,10,1506,5,395,20.0,127.0,127.0,5,1111,31.0,843.0,843.0
291.886,6,401,348888,214,22678,1370.0,2736.0,888.0,187,326210,1569.0,2804.0,1829.0
0.004,6,10,2007,5,928,1.0,660.0,660.0,5,1079,1.0,811.0,811.0
0.011,6,10,1989,5,910,2.0,642.0,642.0,5,1079,2.0,811.0,811.0
0.079,6,10,1506,5,395,18.0,127.0,127.0,5,1111,17.0,843.0,843.0
0.006,6,10,1854,5,889,1.0,621.0,621.0,5,965,1.0,697.0,697.0
0.005,17,2,166,1,75,0.0,47.0,47.0,1,91,0.0,63.0,63.0
0.171,17,2,152,1,76,0.0,48.0,48.0,1,76,0.0,48.0,48.0
0.01,6,10,1762,5,911,2.0,643.0,643.0,5,851,2.0,583.0,583.0
1.045,6,22,7922,12,1487,95.0,517.0,287.0,10,6435,18.0,1402.0,843.0
240.099,6,42,9883,21,2078,12004.0,517.0,163.0,21,7805,12004.0,1402.0,670.0
0.008,6,10,1990,5,911,2.0,643.0,643.0,5,1079,2.0,811.0,811.0
0.018,6,10,1990,5,911,4.0,643.0,643.0,5,1079,4.0,811.0,811.0
0.008,6,10,1990,5,911,2.0,643.0,643.0,5,1079,1.0,811.0,811.0
0.095,6,10,1506,5,395,20.0,127.0,127.0,5,1111,22.0,843.0,843.0
0.01,6,10,1989,5,910,2.0,642.0,642.0,5,1079,2.0,811.0,811.0
0.005,6,10,2006,5,927,1.0,659.0,659.0,5,1079,1.0,811.0,811.0
0.012,6,10,1990,5,911,3.0,643.0,643.0,5,1079,2.0,811.0,811.0
0.005,6,10,2006,5,927,1.0,659.0,659.0,5,1079,1.0,811.0,811.0
0.009,6,10,1677,5,827,2.0,559.0,559.0,5,850,2.0,582.0,582.0
0.005,6,10,2006,5,927,1.0,659.0,659.0,5,1079,1.0,811.0,811.0
354.048,6,21,1795,16,1030,23603.0,190.0,190.0,5,765,60001.0,464.0,248.0
0.012,6,10,1989,5,910,2.0,642.0,642.0,5,1079,2.0,811.0,811.0
0.011,6,10,1972,5,910,2.0,642.0,642.0,5,1062,2.0,794.0,794.0
0.031,6,10,1972,5,910,7.0,642.0,642.0,5,1062,7.0,794.0,794.0
0.008,6,10,1989,5,910,2.0,642.0,642.0,5,1079,1.0,811.0,811.0
0.084,6,10,1506,5,395,19.0,127.0,127.0,5,1111,17.0,843.0,843.0
0.005,6,13,3747,7,509,0.0,137.0,137.0,6,3238,1.0,1470.0,1459.0
0.016,6,10,1972,5,910,4.0,642.0,642.0,5,1062,4.0,794.0,794.0
0.008,17,4,284,2,120,1.0,32.0,32.0,2,164,1.0,60.0,54.0
0.006,6,10,1547,5,764,1.0,496.0,496.0,5,783,1.0,515.0,515.0
0.037,17,2,182,1,65,0.0,37.0,37.0,1,117,0.0,89.0,89.0
0.006,6,10,2007,5,928,1.0,660.0,660.0,5,1079,1.0,811.0,811.0
10.815,17,28,4423,14,1994,823.0,269.0,114.0,14,2429,823.0,588.0,145.0
40.06,17,10,676,5,460,10012.0,104.0,64.0,5,216,10014.0,20.0,15.0
1756.146,6,105,6240,60,3510,29764.0,26.0,26.0,45,2730,39911.0,26.0,26.0
0.17,6,10,1506,5,395,36.0,127.0,127.0,5,1111,41.0,843.0,843.0
0.121,6,10,1506,5,395,21.0,127.0,127.0,5,1111,27.0,843.0,843.0
0.005,17,2,144,1,64,0.0,36.0,36.0,1,80,0.0,52.0,52.0
0.037,17,4,284,2,120,0.0,32.0,32.0,2,164,34.0,60.0,54.0
0.007,6,10,1989,5,910,1.0,642.0,642.0,5,1079,1.0,811.0,811.0
0.001,17,2,136,1,60,0.0,32.0,32.0,1,76,0.0,48.0,48.0
10.955,17,28,4418,14,1993,833.0,268.0,114.0,14,2425,833.0,588.0,145.0
0.004,17,2,136,1,60,0.0,32.0,32.0,1,76,0.0,48.0,48.0
0.006,6,10,1547,5,764,1.0,496.0,496.0,5,783,1.0,515.0,515.0
0.172,6,10,1506,5,395,40.0,127.0,127.0,5,1111,39.0,843.0,843.0
0.003,17,2,148,1,60,0.0,32.0,32.0,1,88,0.0,60.0,60.0
0.001,17,2,140,1,62,0.0,34.0,34.0,1,78,0.0,50.0,50.0
0.014,6,10,1631,5,848,3.0,580.0,580.0,5,783,3.0,515.0,515.0
0.005,6,10,2007,5,928,1.0,660.0,660.0,5,1079,1.0,811.0,811.0
0.004,17,4,284,2,120,0.0,32.0,32.0,2,164,1.0,60.0,54.0
0.005,6,10,2006,5,927,1.0,659.0,659.0,5,1079,1.0,811.0,811.0
0.103,6,10,1506,5,395,22.0,127.0,127.0,5,1111,23.0,843.0,843.0
0.012,6,10,1990,5,911,2.0,643.0,643.0,5,1079,3.0,811.0,811.0
0.005,6,10,1689,5,839,1.0,571.0,571.0,5,850,1.0,582.0,582.0
40.068,17,10,676,5,460,10016.0,104.0,64.0,5,216,10015.0,20.0,15.0
0.003,17,2,152,1,76,0.0,48.0,48.0,1,76,0.0,48.0,48.0
40.052,17,10,676,5,460,10012.0,104.0,64.0,5,216,10012.0,20.0,15.0
0.006,6,10,1854,5,889,1.0,621.0,621.0,5,965,1.0,697.0,697.0
369.881,6,22,2313,16,867,24658.0,195.0,195.0,6,1446,4635.0,419.0,398.0
0.039,17,4,284,2,120,0.0,32.0,32.0,2,164,36.0,60.0,54.0
0.005,6,10,2006,5,927,1.0,659.0,659.0,5,1079,1.0,811.0,811.0
0.006,6,10,1854,5,889,1.0,621.0,621.0,5,965,1.0,697.0,697.0
0.003,17,2,148,1,60,0.0,32.0,32.0,1,88,0.0,60.0,60.0
0.007,17,2,236,1,64,0.0,36.0,36.0,1,172,0.0,144.0,144.0
0.005,6,10,2006,5,927,1.0,659.0,659.0,5,1079,1.0,811.0,811.0
0.02,6,10,1762,5,911,5.0,643.0,643.0,5,851,4.0,583.0,583.0
0.22,6,16,2778,8,1396,31.0,533.0,324.0,8,1382,19.0,529.0,239.0
0.124,17,2,179,1,71,0.0,43.0,43.0,1,108,0.0,80.0,80.0
0.143,6,10,1506,5,395,34.0,127.0,127.0,5,1111,33.0,843.0,843.0
0.077,6,10,1506,5,395,17.0,127.0,127.0,5,1111,18.0,843.0,843.0
0.096,6,10,1506,5,395,20.0,127.0,127.0,5,1111,19.0,843.0,843.0
0.014,6,10,1983,5,910,3.0,642.0,642.0,5,1073,3.0,805.0,805.0
0.003,17,4,284,2,120,0.0,32.0,32.0,2,164,0.0,60.0,54.0
0.011,6,10,1990,5,911,2.0,643.0,643.0,5,1079,2.0,811.0,811.0
0.004,17,2,136,1,60,0.0,32.0,32.0,1,76,0.0,48.0,48.0
0.034,17,2,152,1,76,0.0,48.0,48.0,1,76,0.0,48.0,48.0
0.094,6,10,1506,5,395,21.0,127.0,127.0,5,1111,18.0,843.0,843.0
352.876,6,20,2210,6,1308,12004.0,494.0,494.0,14,902,27144.0,83.0,83.0
0.005,6,13,3747,7,509,0.0,137.0,137.0,6,3238,0.0,1470.0,1459.0
0.106,6,10,1506,5,395,25.0,127.0,127.0,5,1111,12.0,843.0,843.0
0.005,6,10,2000,5,927,1.0,659.0,659.0,5,1073,1.0,805.0,805.0
40.074,17,10,676,5,460,10017.0,104.0,64.0,5,216,10017.0,20.0,15.0
0.014,6,14,3787,7,497,2.0,125.0,125.0,7,3290,2.0,1448.0,972.0
240.179,6,32,9424,16,6993,16011.0,2064.0,685.0,16,2431,16009.0,580.0,198.0
0.053,17,2,152,1,76,0.0,48.0,48.0,1,76,0.0,48.0,48.0
0.007,6,10,1983,5,910,1.0,642.0,642.0,5,1073,1.0,805.0,805.0
9.037,17,6,376,5,280,2259.0,28.0,28.0,1,96,0.0,68.0,68.0
0.06,6,10,1506,5,395,14.0,127.0,127.0,5,1111,13.0,843.0,843.0
0.017,17,2,148,1,60,0.0,32.0,32.0,1,88,0.0,60.0,60.0
0.013,6,10,1762,5,911,3.0,643.0,643.0,5,851,3.0,583.0,583.0
241.448,6,384,347972,199,21875,1219.0,2736.0,886.0,185,326097,1312.0,4171.0,1808.0
0.005,17,2,170,1,65,0.0,37.0,37.0,1,105,0.0,77.0,77.0
0.009,6,10,1972,5,910,2.0,642.0,642.0,5,1062,2.0,794.0,794.0
0.018,6,10,1989,5,910,4.0,642.0,642.0,5,1079,4.0,811.0,811.0
0.008,6,10,1972,5,910,2.0,642.0,642.0,5,1062,2.0,794.0,794.0
0.003,17,2,148,1,60,0.0,32.0,32.0,1,88,0.0,60.0,60.0
0.005,6,10,1689,5,839,1.0,571.0,571.0,5,850,1.0,582.0,582.0
169.521,17,78,11355,39,2618,4460.0,44.0,39.0,39,8737,4461.0,261.0,196.0
0.008,6,12,1926,6,1189,1.0,659.0,434.0,6,737,1.0,417.0,417.0
15.075,17,15,9239,8,6902,2149.0,1350.0,834.0,7,2337,2507.0,1350.0,305.0
0.006,6,10,2007,5,928,1.0,660.0,660.0,5,1079,1.0,811.0,811.0
0.059,6,10,1506,5,395,12.0,127.0,127.0,5,1111,13.0,843.0,843.0
0.001,17,2,136,1,60,0.0,32.0,32.0,1,76,0.0,48.0,48.0
293.349,6,370,346886,195,21702,1512.0,2736.0,888.0,175,325184,1685.0,2804.0,1963.0
0.079,6,10,1506,5,395,15.0,127.0,127.0,5,1111,19.0,843.0,843.0
111.948,6,23,9339,11,1575,63.0,794.0,367.0,12,7764,10164.0,1360.0,909.0
0.113,6,10,1506,5,395,26.0,127.0,127.0,5,1111,25.0,843.0,843.0
0.005,6,10,2007,5,928,1.0,660.0,660.0,5,1079,1.0,811.0,811.0
174.101,17,88,12988,44,2975,4048.0,44.0,39.0,44,10013,4048.0,239.0,199.0
300.333,6,16,2170,9,684,37520.0,146.0,146.0,7,1486,50027.0,419.0,398.0
40.064,17,10,676,5,460,10012.0,104.0,64.0,5,216,10015.0,20.0,15.0
0.006,6,10,2006,5,927,1.0,659.0,659.0,5,1079,1.0,811.0,811.0
0.096,6,10,1506,5,395,21.0,127.0,127.0,5,1111,22.0,843.0,843.0
0.117,6,10,1506,5,395,25.0,127.0,127.0,5,1111,25.0,843.0,843.0
40.039,17,10,676,5,460,10008.0,104.0,64.0,5,216,10009.0,20.0,15.0
289.185,6,375,347607,198,21850,1467.0,2736.0,889.0,177,325757,1643.0,2930.0,1941.0
0.006,6,10,1547,5,764,1.0,496.0,496.0,5,783,1.0,515.0,515.0
0.23,6,16,2671,8,1397,32.0,533.0,324.0,8,1274,21.0,529.0,212.0
0.014,6,10,1989,5,910,3.0,642.0,642.0,5,1079,3.0,811.0,811.0
0.003,17,2,148,1,60,0.0,32.0,32.0,1,88,0.0,60.0,60.0
15.087,17,15,9238,8,6902,2150.0,1350.0,834.0,7,2336,2507.0,1350.0,305.0
0.005,6,10,2006,5,927,1.0,659.0,659.0,5,1079,1.0,811.0,811.0
0.005,6,10,1689,5,839,1.0,571.0,571.0,5,850,1.0,582.0,582.0
0.008,6,10,1989,5,910,2.0,642.0,642.0,5,1079,2.0,811.0,811.0
0.006,6,10,1689,5,839,1.0,571.0,571.0,5,850,1.0,582.0,582.0
0.17,17,2,152,1,76,0.0,48.0,48.0,1,76,0.0,48.0,48.0
0.005,6,14,3799,7,509,0.0,137.0,137.0,7,3290,0.0,1448.0,972.0
0.005,6,10,2000,5,927,1.0,659.0,659.0,5,1073,1.0,805.0,805.0
308.879,17,20,1124,10,716,34306.0,48.0,43.0,10,408,34306.0,20.0,12.0
0.014,6,10,1990,5,911,3.0,643.0,643.0,5,1079,3.0,811.0,811.0
0.005,6,10,2007,5,928,1.0,660.0,660.0,5,1079,1.0,811.0,811.0
0.006,6,10,1547,5,764,1.0,496.0,496.0,5,783,1.0,515.0,515.0
15.071,17,14,9190,8,6902,2148.0,1350.0,834.0,6,2288,3008.0,1350.0,353.0
378.8,6,22,2313,16,867,25253.0,195.0,195.0,6,1446,4634.0,419.0,398.0
0.006,6,10,1547,5,764,1.0,496.0,496.0,5,783,1.0,515.0,515.0
0.006,17,2,164,1,74,0.0,46.0,46.0,1,90,0.0,62.0,62.0
0.009,6,10,1972,5,910,2.0,642.0,642.0,5,1062,2.0,794.0,794.0
0.008,6,10,1989,5,910,2.0,642.0,642.0,5,1079,2.0,811.0,811.0
0.001,17,2,180,1,66,0.0,38.0,38.0,1,114,0.0,86.0,86.0
0.008,6,10,1983,5,910,2.0,642.0,642.0,5,1073,2.0,805.0,805.0
0.006,6,10,1643,5,860,1.0,592.0,592.0,5,783,1.0,515.0,515.0
0.008,6,12,1926,6,1189,1.0,659.0,434.0,6,737,1.0,417.0,417.0
0.009,6,10,1762,5,911,2.0,643.0,643.0,5,851,2.0,583.0,583.0
0.011,6,10,1983,5,910,2.0,642.0,642.0,5,1073,2.0,805.0,805.0
0.011,6,10,1677,5,827,2.0,559.0,559.0,5,850,2.0,582.0,582.0
0.073,17,4,364,2,160,0.0,52.0,52.0,2,204,31.0,80.0,74.0
0.008,6,13,3735,7,497,1.0,125.0,125.0,6,3238,1.0,1470.0,1459.0
0.005,17,2,154,1,69,0.0,41.0,41.0,1,85,0.0,57.0,57.0
0.011,6,10,1983,5,910,2.0,642.0,642.0,5,1073,2.0,805.0,805.0
0.005,17,2,136,1,60,0.0,32.0,32.0,1,76,0.0,48.0,48.0
0.005,6,13,3747,7,509,0.0,137.0,137.0,6,3238,1.0,1470.0,1459.0
0.005,6,13,3690,7,452,0.0,80.0,80.0,6,3238,1.0,1470.0,1459.0
0.015,6,10,1972,5,910,3.0,642.0,642.0,5,1062,3.0,794.0,794.0
40.056,17,10,676,5,460,10013.0,104.0,64.0,5,216,10013.0,20.0,15.0
240.01,6,9,787,5,488,60002.0,232.0,232.0,4,299,80002.0,83.0,83.0
0.015,6,10,1972,5,910,3.0,642.0,642.0,5,1062,3.0,794.0,794.0
0.005,17,2,212,1,74,0.0,46.0,46.0,1,138,0.0,110.0,110.0
0.005,17,2,179,1,71,0.0,43.0,43.0,1,108,0.0,80.0,80.0
0.006,17,2,179,1,71,0.0,43.0,43.0,1,108,0.0,80.0,80.0
0.007,17,2,179,1,71,0.0,43.0,43.0,1,108,0.0,80.0,80.0
0.096,6,10,1506,5,395,19.0,127.0,127.0,5,1111,21.0,843.0,843.0
0.136,6,10,1506,5,395,31.0,127.0,127.0,5,1111,29.0,843.0,843.0
178.047,17,80,11616,40,2705,4565.0,44.0,39.0,40,8911,4565.0,239.0,194.0
0.017,6,10,1972,5,910,4.0,642.0,642.0,5,1062,4.0,794.0,794.0
0.005,6,10,2000,5,927,1.0,659.0,659.0,5,1073,1.0,805.0,805.0
240.085,6,16,4480,9,963,30010.0,238.0,166.0,7,3517,40013.0,1402.0,786.0
0.012,6,10,1989,5,910,2.0,642.0,642.0,5,1079,2.0,811.0,811.0
0.015,17,2,230,1,68,0.0,40.0,40.0,1,162,0.0,134.0,134.0
0.202,6,16,2669,8,1395,28.0,533.0,323.0,8,1274,18.0,529.0,212.0
0.008,17,2,148,1,60,0.0,32.0,32.0,1,88,0.0,60.0,60.0
0.005,6,10,2000,5,927,1.0,659.0,659.0,5,1073,1.0,805.0,805.0
0.003,17,4,284,2,120,0.0,32.0,32.0,2,164,0.0,60.0,54.0
15.072,17,15,9238,8,6902,2149.0,1350.0,834.0,7,2336,2507.0,1350.0,305.0
300.824,6,39,10129,21,4566,15041.0,3298.0,920.0,18,5563,509.0,2667.0,402.0
0.004,6,10,2007,5,928,1.0,660.0,660.0,5,1079,1.0,811.0,811.0
240.011,6,9,787,5,488,60002.0,232.0,232.0,4,299,80002.0,83.0,83.0
0.004,6,10,1702,5,863,1.0,595.0,595.0,5,839,1.0,571.0,571.0
0.005,6,10,1989,5,927,1.0,659.0,659.0,5,1062,1.0,794.0,794.0
0.091,6,10,1506,5,395,21.0,127.0,127.0,5,1111,19.0,843.0,843.0
0.005,17,2,230,1,68,0.0,40.0,40.0,1,162,0.0,134.0,134.0
0.014,6,13,3913,7,495,2.0,123.0,123.0,6,3418,2.0,1650.0,1549.0
0.009,6,10,1989,5,910,2.0,642.0,642.0,5,1079,2.0,811.0,811.0
0.13,6,10,1506,5,395,30.0,127.0,127.0,5,1111,30.0,843.0,843.0
0.169,17,2,152,1,76,0.0,48.0,48.0,1,76,0.0,48.0,48.0
0.027,6,10,1762,5,911,6.0,643.0,643.0,5,851,6.0,583.0,583.0
0.017,6,10,1989,5,910,4.0,642.0,642.0,5,1079,4.0,811.0,811.0
0.004,17,4,284,2,120,0.0,32.0,32.0,2,164,1.0,60.0,54.0
0.004,17,2,136,1,60,0.0,32.0,32.0,1,76,0.0,48.0,48.0
0.02,6,10,1983,5,910,5.0,642.0,642.0,5,1073,4.0,805.0,805.0
0.076,6,10,1506,5,395,18.0,127.0,127.0,5,1111,17.0,843.0,843.0
10.882,17,28,4422,14,1995,828.0,270.0,114.0,14,2427,828.0,586.0,145.0
0.014,6,10,1990,5,911,3.0,643.0,643.0,5,1079,3.0,811.0,811.0
0.006,6,10,1689,5,839,1.0,571.0,571.0,5,850,1.0,582.0,582.0
0.004,6,10,2000,5,927,1.0,659.0,659.0,5,1073,1.0,805.0,805.0
413.273,6,29,4409,12,3102,10913.0,494.0,494.0,17,1307,25829.0,83.0,83.0
0.013,6,10,1677,5,827,3.0,559.0,559.0,5,850,3.0,582.0,582.0
0.006,17,2,179,1,71,0.0,43.0,43.0,1,108,0.0,80.0,80.0
175.143,17,96,13352,48,3227,3726.0,44.0,39.0,48,10125,3726.0,239.0,182.0
0.01,6,10,1983,5,910,2.0,642.0,642.0,5,1073,2.0,805.0,805.0
0.009,6,12,1926,6,1189,1.0,659.0,434.0,6,737,1.0,417.0,417.0
240.401,6,28,10138,16,1420,16026.0,260.0,189.0,12,8718,21848.0,2804.0,1010.0
0.005,6,10,1702,5,863,1.0,595.0,595.0,5,839,1.0,571.0,571.0
0.005,17,2,144,1,64,0.0,36.0,36.0,1,80,0.0,52.0,52.0
0.01,6,10,1631,5,848,2.0,580.0,580.0,5,783,2.0,515.0,515.0
1787.532,6,154,19574,92,13852,19643.0,302.0,302.0,62,5722,29303.0,83.0,83.0
240.072,6,20,4872,10,889,26674.0,180.0,93.0,10,3983,26674.0,1591.0,575.0
0.004,6,10,1989,5,927,1.0,659.0,659.0,5,1062,1.0,794.0,794.0
40.071,17,10,676,5,460,10015.0,104.0,64.0,5,216,10017.0,20.0,15.0
0.003,17,2,148,1,60,0.0,32.0,32.0,1,88,0.0,60.0,60.0
0.005,17,2,214,1,75,0.0,47.0,47.0,1,139,0.0,111.0,111.0
0.087,6,10,1506,5,395,19.0,127.0,127.0,5,1111,19.0,843.0,843.0
0.011,6,10,1989,5,910,2.0,642.0,642.0,5,1079,2.0,811.0,811.0
0.103,6,10,1506,5,395,23.0,127.0,127.0,5,1111,23.0,843.0,843.0
0.005,6,10,2006,5,927,1.0,659.0,659.0,5,1079,1.0,811.0,811.0
0.005,6,10,2000,5,927,1.0,659.0,659.0,5,1073,1.0,805.0,805.0
0.008,6,13,3735,7,497,1.0,125.0,125.0,6,3238,1.0,1470.0,1459.0
0.005,6,13,3747,7,509,0.0,137.0,137.0,6,3238,0.0,1470.0,1459.0
0.019,6,10,1989,5,910,4.0,642.0,642.0,5,1079,4.0,811.0,811.0
0.005,6,10,2006,5,927,1.0,659.0,659.0,5,1079,1.0,811.0,811.0
0.007,6,10,1989,5,910,1.0,642.0,642.0,5,1079,1.0,811.0,811.0
0.103,6,10,1506,5,395,21.0,127.0,127.0,5,1111,22.0,843.0,843.0
0.157,6,10,1506,5,395,35.0,127.0,127.0,5,1111,37.0,843.0,843.0
300.793,6,38,11789,20,6271,15831.0,4080.0,1087.0,18,5518,506.0,2667.0,435.0
0.023,6,10,1631,5,848,5.0,580.0,580.0,5,783,5.0,515.0,515.0
0.014,6,10,1972,5,910,3.0,642.0,642.0,5,1062,3.0,794.0,794.0
0.006,6,10,1854,5,889,1.0,621.0,621.0,5,965,1.0,697.0,697.0
0.011,6,10,1990,5,911,2.0,643.0,643.0,5,1079,2.0,811.0,811.0
0.005,6,10,1779,5,928,1.0,660.0,660.0,5,851,1.0,583.0,583.0
0.084,6,10,1506,5,395,18.0,127.0,127.0,5,1111,18.0,843.0,843.0
0.127,17,4,352,2,130,0.0,37.0,37.0,2,222,87.0,89.0,83.0
0.078,6,10,1506,5,395,17.0,127.0,127.0,5,1111,17.0,843.0,843.0
0.017,6,10,1762,5,911,4.0,643.0,643.0,5,851,4.0,583.0,583.0
0.005,6,10,2006,5,927,1.0,659.0,659.0,5,1079,1.0,811.0,811.0
0.004,6,10,2007,5,928,1.0,660.0,660.0,5,1079,1.0,811.0,811.0
0.005,6,10,2000,5,927,1.0,659.0,659.0,5,1073,1.0,805.0,805.0
0.088,6,10,1506,5,395,19.0,127.0,127.0,5,1111,19.0,843.0,843.0
0.082,6,10,1506,5,395,16.0,127.0,127.0,5,1111,17.0,843.0,843.0
0.003,17,2,148,1,60,0.0,32.0,32.0,1,88,0.0,60.0,60.0
0.003,17,2,148,1,60,0.0,32.0,32.0,1,88,0.0,60.0,60.0
0.073,17,4,284,2,120,0.0,32.0,32.0,2,164,63.0,60.0,54.0
0.005,6,10,2006,5,927,1.0,659.0,659.0,5,1079,1.0,811.0,811.0
40.06,17,10,676,5,460,10012.0,104.0,64.0,5,216,10014.0,20.0,15.0
1771.053,6,302,97529,187,86393,9521.0,1402.0,672.0,115,11136,15535.0,452.0,70.0
0.129,6,10,1506,5,395,30.0,127.0,127.0,5,1111,28.0,843.0,843.0
0.009,6,10,1989,5,910,2.0,642.0,642.0,5,1079,2.0,811.0,811.0
0.007,6,10,1547,5,764,1.0,496.0,496.0,5,783,1.0,515.0,515.0
40.054,17,10,676,5,460,10012.0,104.0,64.0,5,216,10012.0,20.0,15.0
0.024,6,10,1989,5,910,5.0,642.0,642.0,5,1079,6.0,811.0,811.0
0.015,6,10,1631,5,848,3.0,580.0,580.0,5,783,3.0,515.0,515.0
0.068,6,10,1506,5,395,14.0,127.0,127.0,5,1111,13.0,843.0,843.0
0.006,6,10,1689,5,839,1.0,571.0,571.0,5,850,1.0,582.0,582.0
40.054,17,10,676,5,460,10012.0,104.0,64.0,5,216,10012.0,20.0,15.0
0.009,6,10,1677,5,827,2.0,559.0,559.0,5,850,2.0,582.0,582.0
0.145,6,10,1506,5,395,33.0,127.0,127.0,5,1111,34.0,843.0,843.0
0.011,6,10,1762,5,911,2.0,643.0,643.0,5,851,2.0,583.0,583.0
0.01,6,10,1990,5,911,2.0,643.0,643.0,5,1079,2.0,811.0,811.0
0.005,6,10,2007,5,928,1.0,660.0,660.0,5,1079,1.0,811.0,811.0
368.533,6,22,2313,16,867,24568.0,195.0,195.0,6,1446,4639.0,419.0,398.0
0.013,6,10,1762,5,911,3.0,643.0,643.0,5,851,3.0,583.0,583.0
240.111,6,32,9575,16,7018,16007.0,2087.0,687.0,16,2557,16007.0,580.0,214.0
0.012,6,10,1990,5,911,2.0,643.0,643.0,5,1079,2.0,811.0,811.0
369.486,6,22,2313,16,867,24632.0,195.0,195.0,6,1446,4718.0,419.0,398.0
0.001,17,2,166,1,75,0.0,47.0,47.0,1,91,0.0,63.0,63.0
1778.18,17,144,41760,72,22752,25044.0,288.0,288.0,72,19008,25044.0,236.0,236.0
0.005,6,10,1774,5,923,1.0,655.0,655.0,5,851,1.0,583.0,583.0
0.094,6,10,1506,5,395,20.0,127.0,127.0,5,1111,19.0,843.0,843.0
0.013,6,10,1677,5,827,3.0,559.0,559.0,5,850,3.0,582.0,582.0
0.041,17,2,152,1,76,0.0,48.0,48.0,1,76,0.0,48.0,48.0
40.057,17,10,676,5,460,10012.0,104.0,64.0,5,216,10013.0,20.0,15.0
0.009,6,10,1989,5,910,2.0,642.0,642.0,5,1079,2.0,811.0,811.0
0.006,17,2,179,1,71,0.0,43.0,43.0,1,108,0.0,80.0,80.0
0.129,6,10,1506,5,395,28.0,127.0,127.0,5,1111,29.0,843.0,843.0
10.794,17,28,4417,14,1994,822.0,269.0,114.0,14,2423,822.0,586.0,145.0
0.08,6,10,1506,5,395,16.0,127.0,127.0,5,1111,18.0,843.0,843.0
352.246,6,20,2210,6,1308,12004.0,494.0,494.0,14,902,27095.0,83.0,83.0
40.079,17,10,676,5,460,10015.0,104.0,64.0,5,216,10018.0,20.0,15.0
310.649,17,20,1124,10,716,34502.0,48.0,43.0,10,408,34502.0,20.0,12.0
0.005,6,10,2006,5,927,1.0,659.0,659.0,5,1079,1.0,811.0,811.0
0.005,6,10,1989,5,927,1.0,659.0,659.0,5,1062,1.0,794.0,794.0
0.019,6,10,1989,5,910,4.0,642.0,642.0,5,1079,4.0,811.0,811.0
0.079,6,10,1506,5,395,18.0,127.0,127.0,5,1111,16.0,843.0,843.0
0.009,6,10,1972,5,910,2.0,642.0,642.0,5,1062,2.0,794.0,794.0
0.014,6,10,1989,5,910,3.0,642.0,642.0,5,1079,3.0,811.0,811.0
0.137,6,10,1506,5,395,29.0,127.0,127.0,5,1111,30.0,843.0,843.0
0.004,17,2,186,1,61,0.0,33.0,33.0,1,125,0.0,97.0,97.0
0.005,17,2,214,1,75,0.0,47.0,47.0,1,139,0.0,111.0,111.0
0.136,6,10,1506,5,395,28.0,127.0,127.0,5,1111,30.0,843.0,843.0
0.101,6,10,1506,5,395,24.0,127.0,127.0,5,1111,22.0,843.0,843.0
0.003,17,2,142,1,63,0.0,35.0,35.0,1,79,0.0,51.0,51.0
40.06,17,10,676,5,460,10014.0,104.0,64.0,5,216,10014.0,20.0,15.0
0.119,6,10,1506,5,395,23.0,127.0,127.0,5,1111,25.0,843.0,843.0
0.02,6,10,1989,5,910,5.0,642.0,642.0,5,1079,4.0,811.0,811.0
0.003,17,2,148,1,60,0.0,32.0,32.0,1,88,0.0,60.0,60.0
0.011,6,10,1990,5,911,2.0,643.0,643.0,5,1079,2.0,811.0,811.0
0.005,6,10,2000,5,927,1.0,659.0,659.0,5,1073,1.0,805.0,805.0
0.005,6,10,2006,5,927,1.0,659.0,659.0,5,1079,1.0,811.0,811.0
0.097,6,10,1506,5,395,22.0,127.0,127.0,5,1111,23.0,843.0,843.0
0.005,17,2,140,1,62,0.0,34.0,34.0,1,78,0.0,50.0,50.0
0.003,17,2,136,1,60,0.0,32.0,32.0,1,76,0.0,48.0,48.0
0.186,6,3,453,2,321,186.0,241.0,241.0,1,132,0.0,92.0,92.0
0.129,17,2,80,1,32,0.0,4.0,4.0,1,48,0.0,20.0,20.0
308.6,17,20,1124,10,716,34273.0,48.0,43.0,10,408,34276.0,20.0,12.0
0.008,6,10,1989,5,910,2.0,642.0,642.0,5,1079,1.0,811.0,811.0
66.319,6,22,10140,12,3973,6029.0,1579.0,835.0,10,6167,7350.0,2111.0,939.0
0.017,6,10,1989,5,910,4.0,642.0,642.0,5,1079,4.0,811.0,811.0
0.067,6,10,1506,5,395,15.0,127.0,127.0,5,1111,15.0,843.0,843.0
0.004,6,10,2006,5,927,1.0,659.0,659.0,5,1079,1.0,811.0,811.0
0.013,6,10,1972,5,910,3.0,642.0,642.0,5,1062,3.0,794.0,794.0
121.192,58,3,216,2,144,121192.0,24.0,24.0,1,72,0.0,24.0,24.0
0.004,17,4,284,2,120,1.0,32.0,32.0,2,164,1.0,60.0,54.0
0.085,6,10,1506,5,395,20.0,127.0,127.0,5,1111,16.0,843.0,843.0
0.096,6,10,1506,5,395,16.0,127.0,127.0,5,1111,21.0,843.0,843.0
0.001,17,2,179,1,62,0.0,34.0,34.0,1,117,0.0,89.0,89.0
0.001,17,2,180,1,66,0.0,38.0,38.0,1,114,0.0,86.0,86.0
0.005,6,10,2007,5,928,1.0,660.0,660.0,5,1079,1.0,811.0,811.0
246.569,6,27,5564,11,953,11.0,180.0,93.0,16,4611,16437.0,1592.0,342.0
0.068,6,10,1506,5,395,14.0,127.0,127.0,5,1111,14.0,843.0,843.0
0.005,6,10,1774,5,923,1.0,655.0,655.0,5,851,1.0,583.0,583.0
40.071,17,10,676,5,460,10016.0,104.0,64.0,5,216,10016.0,20.0,15.0
0.106,6,10,1506,5,395,22.0,127.0,127.0,5,1111,24.0,843.0,843.0
1.056,6,13,3922,7,2139,132.0,1328.0,923.0,6,1783,158.0,1539.0,1539.0
0.011,6,10,1989,5,910,2.0,642.0,642.0,5,1079,2.0,811.0,811.0
0.006,6,10,2006,5,927,1.0,659.0,659.0,5,1079,1.0,811.0,811.0
0.006,6,13,3747,7,509,0.0,137.0,137.0,6,3238,1.0,1470.0,1459.0
0.07,6,10,1506,5,395,15.0,127.0,127.0,5,1111,15.0,843.0,843.0
0.016,6,10,1989,5,910,4.0,642.0,642.0,5,1079,3.0,811.0,811.0
0.013,6,10,1989,5,910,3.0,642.0,642.0,5,1079,3.0,811.0,811.0
0.005,6,10,2000,5,927,1.0,659.0,659.0,5,1073,1.0,805.0,805.0
0.041,17,2,184,1,61,0.0,33.0,33.0,1,123,0.0,95.0,95.0
0.004,6,10,2006,5,927,1.0,659.0,659.0,5,1079,1.0,811.0,811.0
0.191,6,10,1506,5,395,46.0,127.0,127.0,5,1111,42.0,843.0,843.0
0.005,6,14,3736,7,446,0.0,74.0,74.0,7,3290,0.0,1448.0,972.0
240.091,6,32,9631,16,7116,16006.0,2188.0,698.0,16,2515,16005.0,580.0,209.0
0.004,6,10,2006,5,927,1.0,659.0,659.0,5,1079,1.0,811.0,811.0
0.012,6,10,1677,5,827,3.0,559.0,559.0,5,850,2.0,582.0,582.0
0.004,6,10,1989,5,927,1.0,659.0,659.0,5,1062,1.0,794.0,794.0
0.062,17,2,144,1,64,0.0,36.0,36.0,1,80,0.0,52.0,52.0
0.008,6,12,1926,6,1189,1.0,659.0,434.0,6,737,1.0,417.0,417.0
0.003,17,2,148,1,60,0.0,32.0,32.0,1,88,0.0,60.0,60.0
0.068,17,8,3613,4,1874,22.0,1350.0,440.0,4,1739,11.0,1350.0,406.0
0.006,6,10,1547,5,764,1.0,496.0,496.0,5,783,1.0,515.0,515.0
0.008,6,10,1972,5,910,2.0,642.0,642.0,5,1062,1.0,794.0,794.0
0.004,17,2,138,1,61,0.0,33.0,33.0,1,77,0.0,49.0,49.0
40.068,17,10,676,5,460,10016.0,104.0,64.0,5,216,10016.0,20.0,15.0
0.006,6,10,2006,5,927,1.0,659.0,659.0,5,1079,1.0,811.0,811.0
0.003,17,2,132,1,58,0.0,30.0,30.0,1,74,0.0,46.0,46.0
0.124,17,4,284,2,120,1.0,32.0,32.0,2,164,120.0,60.0,54.0
0.012,6,10,1989,5,910,2.0,642.0,642.0,5,1079,3.0,811.0,811.0
0.005,6,10,2006,5,927,1.0,659.0,659.0,5,1079,1.0,811.0,811.0
0.005,17,2,164,1,74,0.0,46.0,46.0,1,90,0.0,62.0,62.0
0.001,17,2,180,1,65,0.0,37.0,37.0,1,115,0.0,87.0,87.0
0.018,6,10,1989,5,910,4.0,642.0,642.0,5,1079,4.0,811.0,811.0
0.001,17,2,180,1,66,0.0,38.0,38.0,1,114,0.0,86.0,86.0
0.011,6,10,1989,5,910,2.0,642.0,642.0,5,1079,2.0,811.0,811.0
0.004,6,10,2000,5,927,1.0,659.0,659.0,5,1073,1.0,805.0,805.0
167.162,17,72,10420,36,2403,4775.0,44.0,38.0,36,8017,4775.0,239.0,194.0
0.01,6,10,2006,5,927,2.0,659.0,659.0,5,1079,2.0,811.0,811.0
0.003,6,10,1702,5,863,0.0,595.0,595.0,5,839,0.0,571.0,571.0
0.005,6,10,2006,5,927,1.0,659.0,659.0,5,1079,1.0,811.0,811.0
0.006,6,10,1547,5,764,1.0,496.0,496.0,5,783,1.0,515.0,515.0
0.01,6,10,1677,5,827,2.0,559.0,559.0,5,850,2.0,582.0,582.0
0.005,6,14,3736,7,446,0.0,74.0,74.0,7,3290,0.0,1448.0,972.0
0.001,17,2,180,1,66,0.0,38.0,38.0,1,114,0.0,86.0,86.0
0.035,6,10,1989,5,910,8.0,642.0,642.0,5,1079,8.0,811.0,811.0
0.005,6,10,2006,5,927,1.0,659.0,659.0,5,1079,1.0,811.0,811.0
0.005,6,10,1689,5,839,1.0,571.0,571.0,5,850,1.0,582.0,582.0
0.005,6,10,2006,5,927,1.0,659.0,659.0,5,1079,1.0,811.0,811.0
0.126,17,2,80,1,32,0.0,4.0,4.0,1,48,0.0,20.0,20.0
0.014,6,10,1990,5,911,3.0,643.0,643.0,5,1079,3.0,811.0,811.0
0.004,6,10,2006,5,927,1.0,659.0,659.0,5,1079,1.0,811.0,811.0
0.013,6,10,1990,5,911,3.0,643.0,643.0,5,1079,3.0,811.0,811.0
0.004,6,10,2006,5,927,1.0,659.0,659.0,5,1079,1.0,811.0,811.0
0.077,6,10,1506,5,395,17.0,127.0,127.0,5,1111,16.0,843.0,843.0
0.001,17,2,180,1,66,0.0,38.0,38.0,1,114,0.0,86.0,86.0
0.01,6,10,1990,5,911,2.0,643.0,643.0,5,1079,2.0,811.0,811.0
0.006,6,10,1547,5,764,1.0,496.0,496.0,5,783,1.0,515.0,515.0
0.005,6,10,2007,5,928,1.0,660.0,660.0,5,1079,1.0,811.0,811.0
0.006,6,10,2000,5,927,1.0,659.0,659.0,5,1073,1.0,805.0,805.0
0.004,17,2,80,1,32,0.0,4.0,4.0,1,48,0.0,20.0,20.0
0.003,17,2,136,1,60,0.0,32.0,32.0,1,76,0.0,48.0,48.0
0.072,17,8,3613,4,1874,24.0,1350.0,440.0,4,1739,12.0,1350.0,406.0
40.063,17,10,676,5,460,10013.0,104.0,64.0,5,216,10014.0,20.0,15.0
0.005,6,10,2000,5,927,1.0,659.0,659.0,5,1073,1.0,805.0,805.0
0.013,6,10,1762,5,911,3.0,643.0,643.0,5,851,3.0,583.0,583.0
40.054,17,10,676,5,460,10012.0,104.0,64.0,5,216,10012.0,20.0,15.0
0.005,6,10,1779,5,928,1.0,660.0,660.0,5,851,1.0,583.0,583.0
0.006,6,10,1547,5,764,1.0,496.0,496.0,5,783,1.0,515.0,515.0
0.005,6,10,2007,5,928,1.0,660.0,660.0,5,1079,1.0,811.0,811.0
0.037,17,2,148,1,60,0.0,32.0,32.0,1,88,0.0,60.0,60.0
0.012,6,10,1983,5,910,2.0,642.0,642.0,5,1073,2.0,805.0,805.0
0.103,6,10,1506,5,395,24.0,127.0,127.0,5,1111,23.0,843.0,843.0
0.107,6,10,1506,5,395,24.0,127.0,127.0,5,1111,24.0,843.0,843.0
0.006,6,13,3690,7,452,1.0,80.0,80.0,6,3238,1.0,1470.0,1459.0
0.005,6,10,1689,5,839,1.0,571.0,571.0,5,850,1.0,582.0,582.0
0.006,6,10,1547,5,764,1.0,496.0,496.0,5,783,1.0,515.0,515.0
0.006,6,10,1547,5,764,1.0,496.0,496.0,5,783,1.0,515.0,515.0
0.006,6,10,2006,5,927,1.0,659.0,659.0,5,1079,1.0,811.0,811.0
178.124,17,82,11621,41,2737,4452.0,44.0,38.0,41,8884,4453.0,239.0,188.0
0.004,6,10,2000,5,927,1.0,659.0,659.0,5,1073,1.0,805.0,805.0
0.097,6,10,1506,5,395,22.0,127.0,127.0,5,1111,20.0,843.0,843.0
0.006,6,10,1689,5,839,1.0,571.0,571.0,5,850,1.0,582.0,582.0
0.008,6,12,1926,6,1189,1.0,659.0,434.0,6,737,1.0,417.0,417.0
0.004,6,10,2006,5,927,1.0,659.0,659.0,5,1079,1.0,811.0,811.0
0.012,17,2,138,1,61,0.0,33.0,33.0,1,77,0.0,49.0,49.0
0.014,6,10,1983,5,910,3.0,642.0,642.0,5,1073,3.0,805.0,805.0
0.009,6,10,1972,5,910,2.0,642.0,642.0,5,1062,2.0,794.0,794.0
0.111,6,10,1506,5,395,25.0,127.0,127.0,5,1111,23.0,843.0,843.0
0.005,17,2,154,1,69,0.0,41.0,41.0,1,85,0.0,57.0,57.0
0.006,6,10,1547,5,764,1.0,496.0,496.0,5,783,1.0,515.0,515.0
0.011,6,10,1990,5,911,2.0,643.0,643.0,5,1079,2.0,811.0,811.0
0.071,6,10,1506,5,395,15.0,127.0,127.0,5,1111,14.0,843.0,843.0
0.01,6,10,1989,5,910,2.0,642.0,642.0,5,1079,2.0,811.0,811.0
0.01,6,10,1631,5,848,2.0,580.0,580.0,5,783,2.0,515.0,515.0
0.004,6,10,1774,5,923,1.0,655.0,655.0,5,851,1.0,583.0,583.0
0.078,6,10,1506,5,395,19.0,127.0,127.0,5,1111,15.0,843.0,843.0
40.051,17,10,676,5,460,10012.0,104.0,64.0,5,216,10011.0,20.0,15.0
0.016,17,2,198,1,91,0.0,63.0,63.0,1,107,0.0,79.0,79.0
0.09,6,10,1506,5,395,21.0,127.0,127.0,5,1111,18.0,843.0,843.0
0.006,17,2,170,1,65,0.0,37.0,37.0,1,105,0.0,77.0,77.0
0.005,6,10,2000,5,927,1.0,659.0,659.0,5,1073,1.0,805.0,805.0
0.084,6,10,1506,5,395,19.0,127.0,127.0,5,1111,19.0,843.0,843.0
0.084,6,10,1506,5,395,19.0,127.0,127.0,5,1111,19.0,843.0,843.0
0.072,17,2,234,1,61,0.0,33.0,33.0,1,173,0.0,145.0,145.0
0.041,17,2,148,1,60,0.0,32.0,32.0,1,88,0.0,60.0,60.0
0.018,6,10,1989,5,910,4.0,642.0,642.0,5,1079,4.0,811.0,811.0
0.01,6,10,1762,5,911,2.0,643.0,643.0,5,851,2.0,583.0,583.0
0.08,6,10,1506,5,395,17.0,127.0,127.0,5,1111,16.0,843.0,843.0
0.005,6,10,2007,5,928,1.0,660.0,660.0,5,1079,1.0,811.0,811.0
0.068,6,10,1506,5,395,15.0,127.0,127.0,5,1111,14.0,843.0,843.0
0.011,6,10,1989,5,910,2.0,642.0,642.0,5,1079,2.0,811.0,811.0
0.022,6,10,1989,5,910,5.0,642.0,642.0,5,1079,5.0,811.0,811.0
0.004,17,2,136,1,60,0.0,32.0,32.0,1,76,0.0,48.0,48.0
0.006,17,2,166,1,75,0.0,47.0,47.0,1,91,0.0,63.0,63.0
0.008,6,10,2006,5,927,2.0,659.0,659.0,5,1079,1.0,811.0,811.0
0.02,6,10,1677,5,827,5.0,559.0,559.0,5,850,5.0,582.0,582.0
0.005,6,10,2007,5,928,1.0,660.0,660.0,5,1079,1.0,811.0,811.0
0.006,6,10,2006,5,927,1.0,659.0,659.0,5,1079,1.0,811.0,811.0
0.006,17,2,179,1,71,0.0,43.0,43.0,1,108,0.0,80.0,80.0
0.009,6,10,1989,5,910,2.0,642.0,642.0,5,1079,2.0,811.0,811.0
0.013,6,10,1989,5,910,3.0,642.0,642.0,5,1079,3.0,811.0,811.0
0.008,6,10,1989,5,910,2.0,642.0,642.0,5,1079,2.0,811.0,811.0
0.005,17,2,184,1,68,0.0,40.0,40.0,1,116,0.0,88.0,88.0
0.004,17,2,136,1,60,0.0,32.0,32.0,1,76,0.0,48.0,48.0
0.004,17,2,136,1,60,0.0,32.0,32.0,1,76,0.0,48.0,48.0
0.04,17,2,136,1,60,0.0,32.0,32.0,1,76,0.0,48.0,48.0
0.005,6,10,1779,5,928,1.0,660.0,660.0,5,851,1.0,583.0,583.0
240.011,6,9,787,5,488,60002.0,232.0,232.0,4,299,80002.0,83.0,83.0
0.092,6,10,1506,5,395,20.0,127.0,127.0,5,1111,20.0,843.0,843.0
40.071,17,10,676,5,460,10015.0,104.0,64.0,5,216,10016.0,20.0,15.0
0.005,6,10,2007,5,928,1.0,660.0,660.0,5,1079,1.0,811.0,811.0
1769.704,6,548,190039,276,163698,6435.0,2883.0,945.0,272,26341,6530.0,580.0,119.0
240.095,6,16,4481,9,963,30011.0,238.0,166.0,7,3518,40015.0,1402.0,786.0
0.005,6,14,3736,7,446,0.0,74.0,74.0,7,3290,0.0,1448.0,972.0
0.004,6,10,2007,5,928,1.0,660.0,660.0,5,1079,1.0,811.0,811.0
0.004,6,10,2006,5,927,1.0,659.0,659.0,5,1079,1.0,811.0,811.0
0.006,6,10,1989,5,927,1.0,659.0,659.0,5,1062,1.0,794.0,794.0
0.01,6,10,1972,5,910,2.0,642.0,642.0,5,1062,2.0,794.0,794.0
0.094,6,10,1506,5,395,20.0,127.0,127.0,5,1111,21.0,843.0,843.0
0.004,17,2,136,1,60,0.0,32.0,32.0,1,76,0.0,48.0,48.0
15.073,17,15,9239,8,6902,2149.0,1350.0,834.0,7,2337,2507.0,1350.0,305.0
0.005,17,2,154,1,69,0.0,41.0,41.0,1,85,0.0,57.0,57.0
240.454,6,44,8835,22,5750,11450.0,1515.0,509.0,22,3085,11450.0,580.0,241.0
0.005,6,10,2006,5,927,1.0,659.0,659.0,5,1079,1.0,811.0,811.0
0.038,17,4,420,2,122,0.0,33.0,33.0,2,298,35.0,145.0,121.0
0.121,6,10,1506,5,395,27.0,127.0,127.0,5,1111,26.0,843.0,843.0
0.005,17,2,144,1,64,0.0,36.0,36.0,1,80,0.0,52.0,52.0
0.164,17,2,152,1,76,0.0,48.0,48.0,1,76,0.0,48.0,48.0
0.005,17,2,225,1,65,0.0,37.0,37.0,1,160,0.0,132.0,132.0
0.005,6,10,1547,5,764,1.0,496.0,496.0,5,783,1.0,515.0,515.0
0.005,17,2,168,1,76,0.0,48.0,48.0,1,92,0.0,64.0,64.0
0.078,6,10,1506,5,395,17.0,127.0,127.0,5,1111,17.0,843.0,843.0
0.005,17,2,170,1,65,0.0,37.0,37.0,1,105,0.0,77.0,77.0
309.55,17,20,1124,10,716,34380.0,48.0,43.0,10,408,34380.0,20.0,12.0
0.001,17,2,180,1,66,0.0,38.0,38.0,1,114,0.0,86.0,86.0
0.008,6,10,1972,5,910,2.0,642.0,642.0,5,1062,1.0,794.0,794.0
0.005,6,10,2007,5,928,1.0,660.0,660.0,5,1079,1.0,811.0,811.0
0.006,6,12,1698,6,863,1.0,327.0,271.0,6,835,1.0,515.0,515.0
0.4,17,47,22141,25,18574,16.0,1350.0,714.0,22,3567,16.0,1350.0,134.0
0.005,6,10,1989,5,927,1.0,659.0,659.0,5,1062,1.0,794.0,794.0
0.09,6,10,1506,5,395,16.0,127.0,127.0,5,1111,20.0,843.0,843.0
0.007,6,10,1989,5,910,1.0,642.0,642.0,5,1079,1.0,811.0,811.0
0.088,6,10,1506,5,395,21.0,127.0,127.0,5,1111,21.0,843.0,843.0
0.117,6,10,1506,5,395,25.0,127.0,127.0,5,1111,25.0,843.0,843.0
0.005,6,10,2006,5,927,1.0,659.0,659.0,5,1079,1.0,811.0,811.0
0.004,6,10,1989,5,927,1.0,659.0,659.0,5,1062,1.0,794.0,794.0
240.329,6,46,8939,23,5802,10923.0,1368.0,458.0,23,3137,10923.0,580.0,241.0
0.004,6,10,2007,5,928,1.0,660.0,660.0,5,1079,1.0,811.0,811.0
0.008,6,10,1989,5,910,2.0,642.0,642.0,5,1079,2.0,811.0,811.0
0.011,6,10,1990,5,911,2.0,643.0,643.0,5,1079,2.0,811.0,811.0
0.004,17,2,166,1,75,0.0,47.0,47.0,1,91,0.0,63.0,63.0
0.006,6,10,1689,5,839,1.0,571.0,571.0,5,850,1.0,582.0,582.0
0.078,6,10,1506,5,395,18.0,127.0,127.0,5,1111,15.0,843.0,843.0
0.004,17,2,148,1,60,0.0,32.0,32.0,1,88,0.0,60.0,60.0
0.005,17,2,209,1,64,0.0,36.0,36.0,1,145,0.0,117.0,117.0
0.018,6,10,1989,5,910,4.0,642.0,642.0,5,1079,4.0,811.0,811.0
0.042,17,2,152,1,76,0.0,48.0,48.0,1,76,0.0,48.0,48.0
0.006,6,10,1689,5,839,1.0,571.0,571.0,5,850,1.0,582.0,582.0
0.078,6,10,1506,5,395,17.0,127.0,127.0,5,1111,17.0,843.0,843.0
183.305,17,78,11090,39,2610,4823.0,44.0,38.0,39,8480,4823.0,261.0,189.0
0.006,6,10,1547,5,764,1.0,496.0,496.0,5,783,1.0,515.0,515.0
0.005,6,10,1779,5,928,1.0,660.0,660.0,5,851,1.0,583.0,583.0
0.008,6,10,1989,5,910,2.0,642.0,642.0,5,1079,1.0,811.0,811.0
0.005,6,10,1989,5,927,1.0,659.0,659.0,5,1062,1.0,794.0,794.0
0.005,17,2,170,1,65,0.0,37.0,37.0,1,105,0.0,77.0,77.0
0.01,6,10,1983,5,910,2.0,642.0,642.0,5,1073,2.0,805.0,805.0
0.005,6,13,3747,7,509,0.0,137.0,137.0,6,3238,0.0,1470.0,1459.0
0.006,6,13,3684,7,446,1.0,74.0,74.0,6,3238,1.0,1470.0,1459.0
0.007,6,13,3735,7,497,1.0,125.0,125.0,6,3238,1.0,1470.0,1459.0
0.005,6,14,3742,7,452,0.0,80.0,80.0,7,3290,0.0,1448.0,972.0
0.013,6,11,2024,6,962,2.0,642.0,642.0,5,1062,3.0,794.0,794.0
0.008,6,10,1983,5,910,2.0,642.0,642.0,5,1073,2.0,805.0,805.0
16.076,17,24,14826,13,12031,1337.0,1350.0,897.0,11,2795,1604.0,1350.0,226.0
11.188,17,28,4397,14,2312,851.0,587.0,137.0,14,2085,851.0,268.0,120.0
0.013,6,10,1983,5,910,3.0,642.0,642.0,5,1073,3.0,805.0,805.0
0.006,6,10,1547,5,764,1.0,496.0,496.0,5,783,1.0,515.0,515.0
0.005,6,10,2007,5,928,1.0,660.0,660.0,5,1079,1.0,811.0,811.0
0.066,6,10,1506,5,395,16.0,127.0,127.0,5,1111,15.0,843.0,843.0
0.061,17,2,148,1,60,0.0,32.0,32.0,1,88,0.0,60.0,60.0
0.005,17,2,170,1,65,0.0,37.0,37.0,1,105,0.0,77.0,77.0
0.151,6,10,1506,5,395,36.0,127.0,127.0,5,1111,29.0,843.0,843.0
0.005,6,10,2007,5,928,1.0,660.0,660.0,5,1079,1.0,811.0,811.0
0.162,6,10,1506,5,395,38.0,127.0,127.0,5,1111,38.0,843.0,843.0
0.008,6,10,1990,5,911,2.0,643.0,643.0,5,1079,2.0,811.0,811.0
0.005,6,10,1989,5,927,1.0,659.0,659.0,5,1062,1.0,794.0,794.0
382.266,6,24,2405,17,919,23891.0,195.0,195.0,7,1486,3933.0,419.0,398.0
0.012,6,10,1989,5,910,3.0,642.0,642.0,5,1079,2.0,811.0,811.0
0.006,17,2,166,1,75,0.0,47.0,47.0,1,91,0.0,63.0,63.0
0.005,17,2,164,1,74,0.0,46.0,46.0,1,90,0.0,62.0,62.0
0.069,17,8,3613,4,1874,23.0,1350.0,440.0,4,1739,12.0,1350.0,406.0
0.234,6,10,1506,5,395,57.0,127.0,127.0,5,1111,26.0,843.0,843.0
0.005,6,10,2006,5,927,1.0,659.0,659.0,5,1079,1.0,811.0,811.0
0.096,6,10,1506,5,395,17.0,127.0,127.0,5,1111,19.0,843.0,843.0
9.035,17,6,376,5,280,2258.0,28.0,28.0,1,96,0.0,68.0,68.0
0.006,6,10,1702,5,863,1.0,595.0,595.0,5,839,1.0,571.0,571.0
0.006,6,10,1689,5,839,1.0,571.0,571.0,5,850,1.0,582.0,582.0
0.005,6,14,3799,7,509,0.0,137.0,137.0,7,3290,0.0,1448.0,972.0
0.037,17,2,152,1,76,0.0,48.0,48.0,1,76,0.0,48.0,48.0
11.197,17,28,4422,14,1994,849.0,269.0,114.0,14,2428,848.0,587.0,145.0
0.005,6,10,1989,5,927,1.0,659.0,659.0,5,1062,1.0,794.0,794.0
40.055,17,10,676,5,460,10013.0,104.0,64.0,5,216,10012.0,20.0,15.0
0.008,6,10,1990,5,911,2.0,643.0,643.0,5,1079,1.0,811.0,811.0
0.101,6,10,1506,5,395,24.0,127.0,127.0,5,1111,20.0,843.0,843.0
0.104,6,10,1506,5,395,25.0,127.0,127.0,5,1111,19.0,843.0,843.0
0.004,6,10,1774,5,923,0.0,655.0,655.0,5,851,1.0,583.0,583.0
300.345,6,27,7433,16,1409,20023.0,217.0,142.0,11,6024,24031.0,1679.0,777.0
40.06,17,10,676,5,460,10014.0,104.0,64.0,5,216,10013.0,20.0,15.0
0.001,17,2,180,1,66,0.0,38.0,38.0,1,114,0.0,86.0,86.0
0.006,6,10,1643,5,860,1.0,592.0,592.0,5,783,1.0,515.0,515.0
352.951,6,20,2210,6,1308,12003.0,494.0,494.0,14,902,27149.0,83.0,83.0
169.491,17,72,10338,36,2397,4842.0,44.0,38.0,36,7941,4842.0,239.0,192.0
0.071,6,10,1506,5,395,13.0,127.0,127.0,5,1111,17.0,843.0,843.0
0.004,6,10,2006,5,927,1.0,659.0,659.0,5,1079,1.0,811.0,811.0
0.038,17,2,152,1,56,0.0,28.0,28.0,1,96,0.0,68.0,68.0
0.105,6,10,1506,5,395,24.0,127.0,127.0,5,1111,21.0,843.0,843.0
0.004,6,10,1702,5,863,1.0,595.0,595.0,5,839,1.0,571.0,571.0
0.079,6,10,1506,5,395,18.0,127.0,127.0,5,1111,18.0,843.0,843.0
0.005,6,10,1779,5,928,1.0,660.0,660.0,5,851,1.0,583.0,583.0
0.127,6,10,1506,5,395,28.0,127.0,127.0,5,1111,27.0,843.0,843.0
0.005,6,10,2000,5,927,1.0,659.0,659.0,5,1073,1.0,805.0,805.0
0.005,17,2,214,1,75,0.0,47.0,47.0,1,139,0.0,111.0,111.0
0.074,6,10,1506,5,395,15.0,127.0,127.0,5,1111,16.0,843.0,843.0
0.11,6,10,1506,5,395,24.0,127.0,127.0,5,1111,25.0,843.0,843.0
0.003,17,2,148,1,60,0.0,32.0,32.0,1,88,0.0,60.0,60.0
0.005,6,10,1945,5,981,1.0,713.0,713.0,5,964,1.0,696.0,696.0
292.036,6,321,344527,135,18584,2179.0,2736.0,825.0,186,325943,1578.0,2804.0,1849.0
0.005,6,10,2006,5,927,1.0,659.0,659.0,5,1079,1.0,811.0,811.0
0.169,6,10,1506,5,395,39.0,127.0,127.0,5,1111,38.0,843.0,843.0
0.008,6,10,1972,5,910,2.0,642.0,642.0,5,1062,1.0,794.0,794.0
0.008,17,2,148,1,60,0.0,32.0,32.0,1,88,0.0,60.0,60.0
0.006,17,2,170,1,65,0.0,37.0,37.0,1,105,0.0,77.0,77.0
0.013,6,10,1631,5,848,3.0,580.0,580.0,5,783,3.0,515.0,515.0
0.101,6,10,1506,5,395,23.0,127.0,127.0,5,1111,19.0,843.0,843.0
15.072,17,15,9238,8,6902,2148.0,1350.0,834.0,7,2336,2507.0,1350.0,305.0
40.07,17,10,676,5,460,10014.0,104.0,64.0,5,216,10016.0,20.0,15.0
0.265,17,38,20087,21,17042,13.0,1350.0,783.0,17,3045,12.0,1350.0,151.0
0.004,6,10,2006,5,927,1.0,659.0,659.0,5,1079,1.0,811.0,811.0
0.005,6,10,2007,5,928,1.0,660.0,660.0,5,1079,1.0,811.0,811.0
0.005,6,10,1774,5,923,1.0,655.0,655.0,5,851,1.0,583.0,583.0
0.004,17,2,186,1,61,0.0,33.0,33.0,1,125,0.0,97.0,97.0
0.006,6,10,1643,5,860,1.0,592.0,592.0,5,783,1.0,515.0,515.0
0.005,6,10,1989,5,927,1.0,659.0,659.0,5,1062,1.0,794.0,794.0
0.073,6,10,1506,5,395,16.0,127.0,127.0,5,1111,15.0,843.0,843.0
0.109,6,10,1506,5,395,24.0,127.0,127.0,5,1111,21.0,843.0,843.0
0.004,6,10,2000,5,927,1.0,659.0,659.0,5,1073,1.0,805.0,805.0
0.017,6,10,1972,5,910,4.0,642.0,642.0,5,1062,4.0,794.0,794.0
0.106,6,10,1506,5,395,25.0,127.0,127.0,5,1111,25.0,843.0,843.0
0.005,17,2,180,1,58,0.0,30.0,30.0,1,122,0.0,94.0,94.0
0.22,6,16,2778,8,1396,31.0,533.0,324.0,8,1382,20.0,529.0,239.0
300.168,6,46,18340,25,12702,12500.0,2720.0,1167.0,21,5638,15000.0,2667.0,435.0
0.007,6,10,1547,5,764,1.0,496.0,496.0,5,783,1.0,515.0,515.0
0.012,6,10,1990,5,911,3.0,643.0,643.0,5,1079,2.0,811.0,811.0
0.013,17,2,152,1,56,0.0,28.0,28.0,1,96,0.0,68.0,68.0
0.041,17,4,596,2,122,1.0,33.0,33.0,2,474,2.0,323.0,209.0
11.183,17,28,4421,14,1993,847.0,268.0,114.0,14,2428,847.0,587.0,145.0
0.006,6,14,3799,7,509,0.0,137.0,137.0,7,3290,1.0,1448.0,972.0
0.106,6,10,1506,5,395,23.0,127.0,127.0,5,1111,25.0,843.0,843.0
0.01,6,10,1990,5,911,2.0,643.0,643.0,5,1079,2.0,811.0,811.0
0.014,6,10,1983,5,910,3.0,642.0,642.0,5,1073,3.0,805.0,805.0
0.008,6,10,1989,5,910,2.0,642.0,642.0,5,1079,2.0,811.0,811.0
0.009,6,10,1990,5,911,2.0,643.0,643.0,5,1079,2.0,811.0,811.0
0.006,6,10,1643,5,860,1.0,592.0,592.0,5,783,1.0,515.0,515.0
15.231,17,21,9462,10,6717,1689.0,1350.0,643.0,11,2745,1520.0,1350.0,221.0
0.01,6,10,1677,5,827,2.0,559.0,559.0,5,850,2.0,582.0,582.0
0.004,6,10,2000,5,927,1.0,659.0,659.0,5,1073,1.0,805.0,805.0
0.093,6,10,1506,5,395,20.0,127.0,127.0,5,1111,20.0,843.0,843.0
0.012,6,10,1989,5,910,2.0,642.0,642.0,5,1079,3.0,811.0,811.0
0.009,6,10,1983,5,910,2.0,642.0,642.0,5,1073,2.0,805.0,805.0
0.014,6,10,1990,5,911,3.0,643.0,643.0,5,1079,3.0,811.0,811.0
0.094,6,10,1506,5,395,22.0,127.0,127.0,5,1111,19.0,843.0,843.0
0.005,6,10,1989,5,927,1.0,659.0,659.0,5,1062,1.0,794.0,794.0
0.004,6,10,1779,5,928,1.0,660.0,660.0,5,851,0.0,583.0,583.0
168.485,17,76,10860,38,2525,4553.0,44.0,38.0,38,8335,4553.0,261.0,191.0
0.005,6,10,2007,5,928,1.0,660.0,660.0,5,1079,1.0,811.0,811.0
0.101,6,10,1506,5,395,19.0,127.0,127.0,5,1111,21.0,843.0,843.0
0.001,17,2,179,1,62,0.0,34.0,34.0,1,117,0.0,89.0,89.0
40.069,17,10,676,5,460,10014.0,104.0,64.0,5,216,10016.0,20.0,15.0
0.104,6,10,1506,5,395,21.0,127.0,127.0,5,1111,22.0,843.0,843.0
0.252,17,46,27927,26,23444,10.0,1350.0,873.0,20,4483,10.0,1350.0,196.0
0.006,6,10,1547,5,764,1.0,496.0,496.0,5,783,1.0,515.0,515.0
0.005,6,10,1779,5,928,1.0,660.0,660.0,5,851,1.0,583.0,583.0
0.012,6,10,1972,5,910,3.0,642.0,642.0,5,1062,3.0,794.0,794.0
0.013,6,10,1990,5,911,3.0,643.0,643.0,5,1079,3.0,811.0,811.0
0.005,6,10,2006,5,927,1.0,659.0,659.0,5,1079,1.0,811.0,811.0
0.094,6,10,1506,5,395,22.0,127.0,127.0,5,1111,21.0,843.0,843.0
0.194,6,43,11556,24,3279,8.0,1079.0,203.0,19,8277,10.0,1402.0,606.0
0.091,6,10,1506,5,395,21.0,127.0,127.0,5,1111,20.0,843.0,843.0
0.006,17,2,152,1,68,0.0,40.0,40.0,1,84,0.0,56.0,56.0
0.006,6,10,1547,5,764,1.0,496.0,496.0,5,783,1.0,515.0,515.0
301.365,6,54,23142,29,17115,10763.0,2720.0,1224.0,25,6027,383.0,2667.0,385.0
0.018,6,13,3735,7,497,3.0,125.0,125.0,6,3238,3.0,1470.0,1459.0
0.006,6,10,1547,5,764,1.0,496.0,496.0,5,783,1.0,515.0,515.0
0.009,6,10,1990,5,911,2.0,643.0,643.0,5,1079,2.0,811.0,811.0
0.069,6,10,1506,5,395,15.0,127.0,127.0,5,1111,15.0,843.0,843.0
240.088,6,16,4482,9,963,30011.0,238.0,166.0,7,3519,40014.0,1402.0,786.0
10.829,17,26,4100,13,1847,893.0,270.0,114.0,13,2253,893.0,588.0,145.0
0.003,17,4,284,2,120,0.0,32.0,32.0,2,164,0.0,60.0,54.0
0.004,6,10,2007,5,928,1.0,660.0,660.0,5,1079,1.0,811.0,811.0
0.005,17,2,164,1,74,0.0,46.0,46.0,1,90,0.0,62.0,62.0
0.001,17,2,268,1,70,0.0,42.0,42.0,1,198,0.0,170.0,170.0
0.01,6,13,3735,7,497,1.0,125.0,125.0,6,3238,1.0,1470.0,1459.0
0.005,6,10,1689,5,839,1.0,571.0,571.0,5,850,1.0,582.0,582.0
0.005,6,10,2000,5,927,1.0,659.0,659.0,5,1073,1.0,805.0,805.0
40.081,17,10,676,5,460,10017.0,104.0,64.0,5,216,10018.0,20.0,15.0
240.116,6,32,9374,16,7114,16007.0,2186.0,698.0,16,2260,16007.0,580.0,177.0
0.011,6,10,1983,5,910,2.0,642.0,642.0,5,1073,2.0,805.0,805.0
0.004,17,2,136,1,60,0.0,32.0,32.0,1,76,0.0,48.0,48.0
0.001,17,2,174,1,72,0.0,44.0,44.0,1,102,0.0,74.0,74.0
0.167,17,2,152,1,76,0.0,48.0,48.0,1,76,0.0,48.0,48.0
0.123,6,10,1506,5,395,25.0,127.0,127.0,5,1111,22.0,843.0,843.0
0.008,6,10,1972,5,910,1.0,642.0,642.0,5,1062,1.0,794.0,794.0
0.005,6,10,2006,5,927,1.0,659.0,659.0,5,1079,1.0,811.0,811.0
0.008,6,10,1989,5,910,2.0,642.0,642.0,5,1079,2.0,811.0,811.0
0.004,6,10,1702,5,863,1.0,595.0,595.0,5,839,0.0,571.0,571.0
0.004,17,2,148,1,60,0.0,32.0,32.0,1,88,0.0,60.0,60.0
0.018,6,10,1989,5,910,4.0,642.0,642.0,5,1079,4.0,811.0,811.0
174.224,17,84,12056,42,2817,4249.0,44.0,39.0,42,9239,4249.0,239.0,191.0
0.778,6,25,5459,12,1557,60.0,325.0,152.0,13,3902,55.0,1414.0,563.0
0.006,6,13,3684,7,446,0.0,74.0,74.0,6,3238,1.0,1470.0,1459.0
0.028,6,10,1762,5,911,7.0,643.0,643.0,5,851,7.0,583.0,583.0
0.003,17,2,136,1,60,0.0,32.0,32.0,1,76,0.0,48.0,48.0
0.004,6,10,1779,5,928,1.0,660.0,660.0,5,851,1.0,583.0,583.0
240.012,6,9,787,5,488,60003.0,232.0,232.0,4,299,80003.0,83.0,83.0
0.007,6,10,1643,5,860,1.0,592.0,592.0,5,783,1.0,515.0,515.0
0.004,17,4,284,2,120,0.0,32.0,32.0,2,164,1.0,60.0,54.0
10.899,17,28,4421,14,1994,829.0,269.0,114.0,14,2427,829.0,586.0,145.0
0.005,6,10,1774,5,923,1.0,655.0,655.0,5,851,1.0,583.0,583.0
40.06,17,10,676,5,460,10014.0,104.0,64.0,5,216,10014.0,20.0,15.0
0.005,6,10,2006,5,927,1.0,659.0,659.0,5,1079,1.0,811.0,811.0
0.016,6,10,1990,5,911,3.0,643.0,643.0,5,1079,4.0,811.0,811.0
0.009,6,10,1677,5,827,2.0,559.0,559.0,5,850,2.0,582.0,582.0
0.005,6,13,3747,7,509,0.0,137.0,137.0,6,3238,0.0,1470.0,1459.0
15.071,17,15,9239,8,6902,2149.0,1350.0,834.0,7,2337,2507.0,1350.0,305.0
0.005,6,10,1989,5,927,1.0,659.0,659.0,5,1062,1.0,794.0,794.0
0.022,6,10,1677,5,827,5.0,559.0,559.0,5,850,5.0,582.0,582.0
0.041,17,2,182,1,65,0.0,37.0,37.0,1,117,0.0,89.0,89.0
0.013,6,10,1677,5,827,3.0,559.0,559.0,5,850,3.0,582.0,582.0
0.005,17,2,170,1,65,0.0,37.0,37.0,1,105,0.0,77.0,77.0
0.15,6,10,1506,5,395,35.0,127.0,127.0,5,1111,34.0,843.0,843.0
1778.602,17,144,41760,72,22752,25050.0,288.0,288.0,72,19008,25050.0,236.0,236.0
0.851,6,23,14750,11,14076,85.0,2828.0,2270.0,12,674,55.0,182.0,182.0
0.01,6,10,1972,5,910,2.0,642.0,642.0,5,1062,2.0,794.0,794.0
0.041,17,2,184,1,61,0.0,33.0,33.0,1,123,0.0,95.0,95.0
15.074,17,16,8899,8,6736,2149.0,1350.0,814.0,8,2163,2149.0,1350.0,242.0
0.005,17,2,166,1,75,0.0,47.0,47.0,1,91,0.0,63.0,63.0
0.005,6,10,2006,5,927,1.0,659.0,659.0,5,1079,1.0,811.0,811.0
0.009,6,12,1926,6,1189,1.0,659.0,434.0,6,737,1.0,417.0,417.0
40.058,17,10,676,5,460,10013.0,104.0,64.0,5,216,10013.0,20.0,15.0
1798.617,17,3004,229681,1495,121126,1203.0,84.0,53.0,1509,108555,1192.0,227.0,43.0
0.069,6,10,1506,5,395,14.0,127.0,127.0,5,1111,16.0,843.0,843.0
0.016,6,10,1972,5,910,4.0,642.0,642.0,5,1062,3.0,794.0,794.0
0.081,6,10,1506,5,395,18.0,127.0,127.0,5,1111,16.0,843.0,843.0
0.008,6,10,1989,5,910,1.0,642.0,642.0,5,1079,2.0,811.0,811.0
0.001,17,2,136,1,60,0.0,32.0,32.0,1,76,0.0,48.0,48.0
0.012,6,10,1989,5,910,3.0,642.0,642.0,5,1079,2.0,811.0,811.0
0.001,17,2,180,1,66,0.0,38.0,38.0,1,114,0.0,86.0,86.0
0.007,6,10,1762,5,911,1.0,643.0,643.0,5,851,1.0,583.0,583.0
0.005,6,14,3736,7,446,0.0,74.0,74.0,7,3290,0.0,1448.0,972.0
0.006,6,10,1547,5,764,1.0,496.0,496.0,5,783,1.0,515.0,515.0
0.012,6,10,1972,5,910,3.0,642.0,642.0,5,1062,3.0,794.0,794.0
0.005,17,2,140,1,62,0.0,34.0,34.0,1,78,0.0,50.0,50.0
0.011,6,10,1989,5,910,2.0,642.0,642.0,5,1079,2.0,811.0,811.0
40.066,17,10,676,5,460,10013.0,104.0,64.0,5,216,10015.0,20.0,15.0
371.24,6,22,2313,16,867,24749.0,195.0,195.0,6,1446,4640.0,419.0,398.0
0.01,6,10,1762,5,911,2.0,643.0,643.0,5,851,2.0,583.0,583.0
0.089,6,10,1506,5,395,19.0,127.0,127.0,5,1111,18.0,843.0,843.0
0.005,6,10,2006,5,927,1.0,659.0,659.0,5,1079,1.0,811.0,811.0
0.007,17,4,284,2,120,4.0,32.0,32.0,2,164,3.0,60.0,54.0
412.84,6,29,4409,12,3102,10911.0,494.0,494.0,17,1307,25802.0,83.0,83.0
0.003,17,2,148,1,60,0.0,32.0,32.0,1,88,0.0,60.0,60.0
0.064,6,10,1506,5,395,13.0,127.0,127.0,5,1111,14.0,843.0,843.0
300.805,6,38,9637,21,4159,15040.0,1360.0,547.0,17,5478,539.0,2667.0,435.0
0.005,6,10,1989,5,927,1.0,659.0,659.0,5,1062,1.0,794.0,794.0
0.005,6,10,2007,5,928,1.0,660.0,660.0,5,1079,1.0,811.0,811.0
0.006,6,10,2000,5,927,1.0,659.0,659.0,5,1073,1.0,805.0,805.0
0.007,6,10,2006,5,927,1.0,659.0,659.0,5,1079,1.0,811.0,811.0
371.001,6,22,2313,16,867,24733.0,195.0,195.0,6,1446,4638.0,419.0,398.0
0.004,6,10,1702,5,863,1.0,595.0,595.0,5,839,0.0,571.0,571.0
0.015,6,10,1972,5,910,3.0,642.0,642.0,5,1062,3.0,794.0,794.0
0.004,6,10,1989,5,927,1.0,659.0,659.0,5,1062,1.0,794.0,794.0
0.095,6,10,1506,5,395,21.0,127.0,127.0,5,1111,20.0,843.0,843.0
0.08,6,10,1506,5,395,16.0,127.0,127.0,5,1111,17.0,843.0,843.0
0.112,6,10,1506,5,395,20.0,127.0,127.0,5,1111,24.0,843.0,843.0
0.005,6,10,2006,5,927,1.0,659.0,659.0,5,1079,1.0,811.0,811.0
0.003,17,2,148,1,60,0.0,32.0,32.0,1,88,0.0,60.0,60.0
0.119,6,10,1506,5,395,27.0,127.0,127.0,5,1111,28.0,843.0,843.0
0.005,6,10,2000,5,927,1.0,659.0,659.0,5,1073,1.0,805.0,805.0
0.008,17,2,214,1,75,0.0,47.0,47.0,1,139,0.0,111.0,111.0
0.006,6,10,1989,5,927,1.0,659.0,659.0,5,1062,1.0,794.0,794.0
0.005,6,10,2006,5,927,1.0,659.0,659.0,5,1079,1.0,811.0,811.0
0.224,6,16,2670,8,1396,32.0,533.0,324.0,8,1274,21.0,529.0,212.0
0.164,17,2,152,1,76,0.0,48.0,48.0,1,76,0.0,48.0,48.0
0.01,6,10,2006,5,927,2.0,659.0,659.0,5,1079,2.0,811.0,811.0
0.011,6,10,1989,5,910,2.0,642.0,642.0,5,1079,2.0,811.0,811.0
0.1,6,10,1506,5,395,21.0,127.0,127.0,5,1111,21.0,843.0,843.0
0.004,17,2,136,1,60,0.0,32.0,32.0,1,76,0.0,48.0,48.0
0.005,6,10,1989,5,927,1.0,659.0,659.0,5,1062,1.0,794.0,794.0
0.001,17,2,180,1,66,0.0,38.0,38.0,1,114,0.0,86.0,86.0
0.071,17,2,144,1,64,0.0,36.0,36.0,1,80,0.0,52.0,52.0
0.078,6,10,1506,5,395,16.0,127.0,127.0,5,1111,17.0,843.0,843.0
0.014,6,13,3735,7,497,2.0,125.0,125.0,6,3238,2.0,1470.0,1459.0
40.064,17,10,676,5,460,10013.0,104.0,64.0,5,216,10015.0,20.0,15.0
0.013,6,10,1989,5,910,3.0,642.0,642.0,5,1079,3.0,811.0,811.0
0.005,6,10,1689,5,839,1.0,571.0,571.0,5,850,1.0,582.0,582.0
0.005,6,10,2007,5,928,1.0,660.0,660.0,5,1079,1.0,811.0,811.0
0.008,6,10,1677,5,827,2.0,559.0,559.0,5,850,1.0,582.0,582.0
0.001,17,2,180,1,66,0.0,38.0,38.0,1,114,0.0,86.0,86.0
0.003,17,4,284,2,120,0.0,32.0,32.0,2,164,0.0,60.0,54.0
40.06,17,10,676,5,460,10014.0,104.0,64.0,5,216,10014.0,20.0,15.0
0.004,17,4,284,2,120,0.0,32.0,32.0,2,164,0.0,60.0,54.0
0.01,6,10,1990,5,911,2.0,643.0,643.0,5,1079,2.0,811.0,811.0
0.007,6,10,1989,5,910,1.0,642.0,642.0,5,1079,1.0,811.0,811.0
0.077,6,10,1506,5,395,17.0,127.0,127.0,5,1111,15.0,843.0,843.0
0.072,17,4,284,2,120,1.0,32.0,32.0,2,164,68.0,60.0,54.0
0.07,6,10,1506,5,395,15.0,127.0,127.0,5,1111,16.0,843.0,843.0
0.072,6,10,1506,5,395,16.0,127.0,127.0,5,1111,15.0,843.0,843.0
0.005,6,10,2006,5,927,1.0,659.0,659.0,5,1079,1.0,811.0,811.0
0.014,6,10,1983,5,910,3.0,642.0,642.0,5,1073,3.0,805.0,805.0
0.007,17,2,179,1,71,0.0,43.0,43.0,1,108,0.0,80.0,80.0
0.005,6,10,1689,5,839,1.0,571.0,571.0,5,850,1.0,582.0,582.0
0.016,6,10,1983,5,910,4.0,642.0,642.0,5,1073,4.0,805.0,805.0
53.845,6,36,8600,18,2129,509.0,1021.0,459.0,18,6471,3159.0,2126.0,478.0
0.003,17,2,148,1,60,0.0,32.0,32.0,1,88,0.0,60.0,60.0
0.004,6,10,1989,5,927,1.0,659.0,659.0,5,1062,1.0,794.0,794.0
0.071,6,10,1506,5,395,14.0,127.0,127.0,5,1111,17.0,843.0,843.0
0.071,6,10,1506,5,395,15.0,127.0,127.0,5,1111,13.0,843.0,843.0
0.017,6,10,1972,5,910,4.0,642.0,642.0,5,1062,4.0,794.0,794.0
40.054,17,10,676,5,460,10012.0,104.0,64.0,5,216,10012.0,20.0,15.0
0.009,6,10,1989,5,910,2.0,642.0,642.0,5,1079,2.0,811.0,811.0
0.005,6,10,2007,5,928,1.0,660.0,660.0,5,1079,1.0,811.0,811.0
0.082,6,10,1506,5,395,17.0,127.0,127.0,5,1111,18.0,843.0,843.0
0.075,6,10,1506,5,395,16.0,127.0,127.0,5,1111,17.0,843.0,843.0
0.004,6,10,2007,5,928,1.0,660.0,660.0,5,1079,1.0,811.0,811.0
40.153,17,10,676,5,460,10037.0,104.0,64.0,5,216,10036.0,20.0,15.0
0.005,17,2,213,1,69,0.0,41.0,41.0,1,144,0.0,116.0,116.0
0.005,6,10,2006,5,927,1.0,659.0,659.0,5,1079,1.0,811.0,811.0
0.005,6,10,2000,5,927,1.0,659.0,659.0,5,1073,1.0,805.0,805.0
0.005,6,10,2006,5,927,1.0,659.0,659.0,5,1079,1.0,811.0,811.0
0.005,6,10,1774,5,923,1.0,655.0,655.0,5,851,1.0,583.0,583.0
0.005,6,10,1643,5,860,1.0,592.0,592.0,5,783,1.0,515.0,515.0
0.008,6,10,1989,5,910,2.0,642.0,642.0,5,1079,1.0,811.0,811.0
15.169,17,22,14008,11,9110,1514.0,1350.0,800.0,11,4898,1513.0,1350.0,417.0
40.054,17,10,676,5,460,10012.0,104.0,64.0,5,216,10012.0,20.0,15.0
0.173,17,2,152,1,76,0.0,48.0,48.0,1,76,0.0,48.0,48.0
0.002,17,2,150,1,67,0.0,39.0,39.0,1,83,0.0,55.0,55.0
40.078,17,10,676,5,460,10015.0,104.0,64.0,5,216,10012.0,20.0,15.0
0.005,6,10,2006,5,927,1.0,659.0,659.0,5,1079,1.0,811.0,811.0
309.162,17,20,1124,10,716,34336.0,48.0,43.0,10,408,34336.0,20.0,12.0
0.005,6,10,1774,5,923,1.0,655.0,655.0,5,851,1.0,583.0,583.0
0.003,17,2,148,1,60,0.0,32.0,32.0,1,88,0.0,60.0,60.0
15.07,17,16,10616,9,8280,1880.0,1350.0,892.0,7,2336,2508.0,1350.0,305.0
0.002,17,2,194,1,57,0.0,29.0,29.0,1,137,0.0,109.0,109.0
0.019,6,10,1989,5,910,4.0,642.0,642.0,5,1079,4.0,811.0,811.0
0.005,6,10,1854,5,889,1.0,621.0,621.0,5,965,1.0,697.0,697.0
280.868,6,25,6480,11,1226,28086.0,267.0,156.0,14,5254,21604.0,1400.0,781.0
0.132,6,10,1506,5,395,29.0,127.0,127.0,5,1111,26.0,843.0,843.0
0.069,17,8,3613,4,1874,23.0,1350.0,440.0,4,1739,11.0,1350.0,406.0
0.353,6,10,1506,5,395,83.0,127.0,127.0,5,1111,87.0,843.0,843.0
0.173,6,10,1506,5,395,30.0,127.0,127.0,5,1111,40.0,843.0,843.0
0.015,6,10,1990,5,911,3.0,643.0,643.0,5,1079,3.0,811.0,811.0
0.005,17,2,170,1,65,0.0,37.0,37.0,1,105,0.0,77.0,77.0
40.064,17,10,676,5,460,10015.0,104.0,64.0,5,216,10015.0,20.0,15.0
0.015,6,10,1972,5,910,3.0,642.0,642.0,5,1062,3.0,794.0,794.0
0.005,6,10,2006,5,927,1.0,659.0,659.0,5,1079,1.0,811.0,811.0
0.01,6,10,1983,5,910,2.0,642.0,642.0,5,1073,2.0,805.0,805.0
0.113,6,10,1506,5,395,25.0,127.0,127.0,5,1111,27.0,843.0,843.0
174.031,17,68,9774,34,2267,5273.0,44.0,38.0,34,7507,5273.0,239.0,192.0
0.006,6,10,1989,5,927,1.0,659.0,659.0,5,1062,1.0,794.0,794.0
0.005,6,13,3747,7,509,0.0,137.0,137.0,6,3238,0.0,1470.0,1459.0
0.004,17,2,148,1,60,0.0,32.0,32.0,1,88,0.0,60.0,60.0
0.005,6,10,2006,5,927,1.0,659.0,659.0,5,1079,1.0,811.0,811.0
367.421,6,22,2313,16,867,24494.0,195.0,195.0,6,1446,4641.0,419.0,398.0
0.001,17,2,180,1,66,0.0,38.0,38.0,1,114,0.0,86.0,86.0
40.054,17,10,676,5,460,10012.0,104.0,64.0,5,216,10012.0,20.0,15.0
0.013,6,10,1983,5,910,3.0,642.0,642.0,5,1073,3.0,805.0,805.0
40.063,17,10,676,5,460,10014.0,104.0,64.0,5,216,10014.0,20.0,15.0
0.005,6,10,1774,5,923,1.0,655.0,655.0,5,851,1.0,583.0,583.0
0.072,6,10,1506,5,395,16.0,127.0,127.0,5,1111,15.0,843.0,843.0
10.737,17,28,4421,14,1993,817.0,268.0,114.0,14,2428,817.0,587.0,145.0
0.008,6,10,1677,5,827,2.0,559.0,559.0,5,850,1.0,582.0,582.0
15.072,17,15,9238,8,6902,2149.0,1350.0,834.0,7,2336,2507.0,1350.0,305.0
0.169,17,2,152,1,76,0.0,48.0,48.0,1,76,0.0,48.0,48.0
0.105,6,10,1506,5,395,22.0,127.0,127.0,5,1111,24.0,843.0,843.0
0.007,6,10,1854,5,889,1.0,621.0,621.0,5,965,1.0,697.0,697.0
594.506,6,32,5142,14,3700,23095.0,494.0,494.0,18,1442,34970.0,83.0,83.0
0.037,17,2,148,1,60,0.0,32.0,32.0,1,88,0.0,60.0,60.0
0.005,17,2,144,1,64,0.0,36.0,36.0,1,80,0.0,52.0,52.0
0.006,17,2,294,1,64,0.0,36.0,36.0,1,230,0.0,202.0,202.0
0.006,6,10,2006,5,927,1.0,659.0,659.0,5,1079,1.0,811.0,811.0
0.014,6,10,1983,5,910,3.0,642.0,642.0,5,1073,3.0,805.0,805.0
40.062,17,10,676,5,460,10014.0,104.0,64.0,5,216,10014.0,20.0,15.0
0.006,17,2,136,1,60,0.0,32.0,32.0,1,76,0.0,48.0,48.0
309.249,17,20,1124,10,716,34346.0,48.0,43.0,10,408,34346.0,20.0,12.0
0.038,6,10,1972,5,910,9.0,642.0,642.0,5,1062,9.0,794.0,794.0
0.039,17,2,152,1,76,0.0,48.0,48.0,1,76,0.0,48.0,48.0
0.006,6,10,1547,5,764,1.0,496.0,496.0,5,783,1.0,515.0,515.0
0.005,6,10,1989,5,927,1.0,659.0,659.0,5,1062,1.0,794.0,794.0
0.012,6,10,1989,5,910,3.0,642.0,642.0,5,1079,3.0,811.0,811.0
369.506,6,24,2405,17,919,23094.0,195.0,195.0,7,1486,3974.0,419.0,398.0
40.032,17,10,676,5,460,10007.0,104.0,64.0,5,216,10007.0,20.0,15.0
300.019,6,12,1782,7,1348,50003.0,494.0,494.0,5,434,75004.0,83.0,83.0
0.005,6,10,1989,5,927,1.0,659.0,659.0,5,1062,1.0,794.0,794.0
0.092,6,10,1506,5,395,20.0,127.0,127.0,5,1111,19.0,843.0,843.0
0.012,17,2,152,1,76,0.0,48.0,48.0,1,76,0.0,48.0,48.0
0.005,6,10,1774,5,923,1.0,655.0,655.0,5,851,1.0,583.0,583.0
0.11,6,10,1506,5,395,25.0,127.0,127.0,5,1111,22.0,843.0,843.0
0.006,6,10,1547,5,764,1.0,496.0,496.0,5,783,1.0,515.0,515.0
240.092,6,31,9674,15,7173,17149.0,2297.0,710.0,16,2501,16006.0,580.0,207.0
40.06,17,10,676,5,460,10014.0,104.0,64.0,5,216,10012.0,20.0,15.0
0.085,6,10,1506,5,395,17.0,127.0,127.0,5,1111,19.0,843.0,843.0
0.108,17,4,596,2,122,63.0,33.0,33.0,2,474,62.0,323.0,209.0
0.014,6,10,1677,5,827,3.0,559.0,559.0,5,850,3.0,582.0,582.0
0.079,6,10,1506,5,395,16.0,127.0,127.0,5,1111,18.0,843.0,843.0
0.004,17,2,148,1,60,0.0,32.0,32.0,1,88,0.0,60.0,60.0
0.009,6,10,1762,5,911,2.0,643.0,643.0,5,851,2.0,583.0,583.0
0.004,17,2,148,1,60,0.0,32.0,32.0,1,88,0.0,60.0,60.0
0.005,17,2,144,1,64,0.0,36.0,36.0,1,80,0.0,52.0,52.0
0.013,6,10,1983,5,910,3.0,642.0,642.0,5,1073,3.0,805.0,805.0
0.001,17,2,180,1,66,0.0,38.0,38.0,1,114,0.0,86.0,86.0
0.008,6,10,1972,5,910,1.0,642.0,642.0,5,1062,2.0,794.0,794.0
0.012,6,10,1989,5,910,2.0,642.0,642.0,5,1079,2.0,811.0,811.0
0.005,6,10,2006,5,927,1.0,659.0,659.0,5,1079,1.0,811.0,811.0
0.082,6,10,1506,5,395,18.0,127.0,127.0,5,1111,18.0,843.0,843.0
0.004,6,10,2007,5,928,1.0,660.0,660.0,5,1079,1.0,811.0,811.0
0.006,6,10,1547,5,764,1.0,496.0,496.0,5,783,1.0,515.0,515.0
0.01,6,10,1677,5,827,2.0,559.0,559.0,5,850,2.0,582.0,582.0
0.008,6,10,2006,5,927,2.0,659.0,659.0,5,1079,2.0,811.0,811.0
21.624,6,51,23227,25,17160,389.0,4080.0,1612.0,26,6067,858.0,2667.0,385.0
0.005,17,2,144,1,64,0.0,36.0,36.0,1,80,0.0,52.0,52.0
0.013,6,10,1677,5,827,3.0,559.0,559.0,5,850,3.0,582.0,582.0
0.015,6,10,1989,5,910,3.0,642.0,642.0,5,1079,3.0,811.0,811.0
40.056,17,10,676,5,460,10013.0,104.0,64.0,5,216,10013.0,20.0,15.0
0.005,6,10,2006,5,927,1.0,659.0,659.0,5,1079,1.0,811.0,811.0
40.054,17,10,676,5,460,10012.0,104.0,64.0,5,216,10010.0,20.0,15.0
0.116,6,10,1506,5,395,24.0,127.0,127.0,5,1111,24.0,843.0,843.0
0.001,17,2,180,1,66,0.0,38.0,38.0,1,114,0.0,86.0,86.0
0.016,6,10,1990,5,911,4.0,643.0,643.0,5,1079,4.0,811.0,811.0
0.005,6,10,2007,5,928,1.0,660.0,660.0,5,1079,1.0,811.0,811.0
0.004,6,10,1989,5,927,1.0,659.0,659.0,5,1062,1.0,794.0,794.0
0.013,6,10,1989,5,910,3.0,642.0,642.0,5,1079,3.0,811.0,811.0
0.078,6,10,1506,5,395,15.0,127.0,127.0,5,1111,16.0,843.0,843.0
0.119,6,10,1506,5,395,25.0,127.0,127.0,5,1111,23.0,843.0,843.0
0.006,17,2,213,1,69,0.0,41.0,41.0,1,144,0.0,116.0,116.0
0.044,6,10,1605,5,388,10.0,120.0,120.0,5,1217,10.0,949.0,949.0
0.004,17,4,284,2,120,0.0,32.0,32.0,2,164,0.0,60.0,54.0
0.006,17,2,170,1,65,0.0,37.0,37.0,1,105,0.0,77.0,77.0
0.068,6,10,1506,5,395,14.0,127.0,127.0,5,1111,15.0,843.0,843.0
10.81,17,28,4421,14,1994,823.0,269.0,114.0,14,2427,823.0,586.0,145.0
0.063,6,10,1506,5,395,14.0,127.0,127.0,5,1111,12.0,843.0,843.0
300.279,6,28,7485,16,1409,20018.0,217.0,142.0,12,6076,21840.0,1402.0,680.0
40.056,17,10,676,5,460,10012.0,104.0,64.0,5,216,10013.0,20.0,15.0
0.003,17,2,148,1,60,0.0,32.0,32.0,1,88,0.0,60.0,60.0
0.1,6,10,1506,5,395,22.0,127.0,127.0,5,1111,22.0,843.0,843.0
40.058,17,10,676,5,460,10013.0,104.0,64.0,5,216,10013.0,20.0,15.0
0.006,6,10,1689,5,839,1.0,571.0,571.0,5,850,1.0,582.0,582.0
40.052,17,10,676,5,460,10012.0,104.0,64.0,5,216,10012.0,20.0,15.0
0.071,6,10,1506,5,395,15.0,127.0,127.0,5,1111,15.0,843.0,843.0
0.009,6,10,1972,5,910,2.0,642.0,642.0,5,1062,2.0,794.0,794.0
0.067,6,10,1506,5,395,16.0,127.0,127.0,5,1111,13.0,843.0,843.0
170.084,17,80,11329,40,2672,4360.0,44.0,38.0,40,8657,4361.0,239.0,188.0
0.005,6,10,1689,5,839,1.0,571.0,571.0,5,850,1.0,582.0,582.0
0.019,6,9,1214,5,775,4.0,519.0,519.0,4,439,4.0,223.0,223.0
0.112,6,10,1506,5,395,25.0,127.0,127.0,5,1111,24.0,843.0,843.0
0.004,6,10,1989,5,927,1.0,659.0,659.0,5,1062,1.0,794.0,794.0
0.005,6,13,3747,7,509,0.0,137.0,137.0,6,3238,0.0,1470.0,1459.0
0.103,6,10,1506,5,395,22.0,127.0,127.0,5,1111,23.0,843.0,843.0
0.077,6,10,1506,5,395,16.0,127.0,127.0,5,1111,17.0,843.0,843.0
0.008,6,10,1989,5,910,2.0,642.0,642.0,5,1079,2.0,811.0,811.0
0.006,6,10,1547,5,764,1.0,496.0,496.0,5,783,1.0,515.0,515.0
0.081,6,10,1506,5,395,18.0,127.0,127.0,5,1111,18.0,843.0,843.0
0.005,17,2,136,1,60,0.0,32.0,32.0,1,76,0.0,48.0,48.0
0.11,6,10,1506,5,395,24.0,127.0,127.0,5,1111,26.0,843.0,843.0
0.037,17,2,136,1,60,0.0,32.0,32.0,1,76,0.0,48.0,48.0
0.009,6,10,1702,5,863,2.0,595.0,595.0,5,839,2.0,571.0,571.0
0.013,6,10,1989,5,910,3.0,642.0,642.0,5,1079,3.0,811.0,811.0
0.013,6,10,1972,5,910,3.0,642.0,642.0,5,1062,3.0,794.0,794.0
308.501,17,20,1124,10,716,34264.0,48.0,43.0,10,408,34264.0,20.0,12.0
0.016,6,10,1989,5,910,4.0,642.0,642.0,5,1079,3.0,811.0,811.0
0.005,17,2,140,1,62,0.0,34.0,34.0,1,78,0.0,50.0,50.0
0.013,6,10,1990,5,911,3.0,643.0,643.0,5,1079,3.0,811.0,811.0
0.004,17,2,148,1,60,0.0,32.0,32.0,1,88,0.0,60.0,60.0
0.004,6,10,1702,5,863,1.0,595.0,595.0,5,839,1.0,571.0,571.0
0.006,17,2,180,1,66,0.0,38.0,38.0,1,114,0.0,86.0,86.0
240.094,6,16,4480,9,963,30011.0,238.0,166.0,7,3517,40015.0,1402.0,786.0
0.004,6,10,2006,5,927,1.0,659.0,659.0,5,1079,1.0,811.0,811.0
0.017,6,10,1972,5,910,4.0,642.0,642.0,5,1062,4.0,794.0,794.0
0.005,6,10,2000,5,927,1.0,659.0,659.0,5,1073,1.0,805.0,805.0
40.064,17,10,676,5,460,10014.0,104.0,64.0,5,216,10015.0,20.0,15.0
0.043,17,2,152,1,76,0.0,48.0,48.0,1,76,0.0,48.0,48.0
0.016,6,10,1990,5,911,4.0,643.0,643.0,5,1079,3.0,811.0,811.0
0.006,6,10,1854,5,889,1.0,621.0,621.0,5,965,1.0,697.0,697.0
0.011,6,10,1989,5,910,2.0,642.0,642.0,5,1079,2.0,811.0,811.0
0.011,6,10,1762,5,911,2.0,643.0,643.0,5,851,2.0,583.0,583.0
0.009,6,10,1990,5,911,2.0,643.0,643.0,5,1079,2.0,811.0,811.0
309.817,17,20,1124,10,716,34417.0,48.0,43.0,10,408,34417.0,20.0,12.0
0.009,6,10,1972,5,910,2.0,642.0,642.0,5,1062,2.0,794.0,794.0
0.07,6,10,1506,5,395,15.0,127.0,127.0,5,1111,15.0,843.0,843.0
0.1,6,10,1506,5,395,21.0,127.0,127.0,5,1111,20.0,843.0,843.0
0.086,6,10,1506,5,395,19.0,127.0,127.0,5,1111,15.0,843.0,843.0
0.005,6,14,3742,7,452,0.0,80.0,80.0,7,3290,0.0,1448.0,972.0
10.811,17,28,4419,14,1995,823.0,270.0,114.0,14,2424,823.0,587.0,145.0
0.014,6,10,1762,5,911,3.0,643.0,643.0,5,851,3.0,583.0,583.0
0.081,6,10,1506,5,395,18.0,127.0,127.0,5,1111,15.0,843.0,843.0
0.007,6,10,1547,5,764,1.0,496.0,496.0,5,783,1.0,515.0,515.0
38.423,17,26,14947,14,12082,2953.0,1350.0,835.0,12,2865,3490.0,1350.0,210.0
0.085,6,10,1506,5,395,17.0,127.0,127.0,5,1111,18.0,843.0,843.0
0.004,6,10,2006,5,927,1.0,659.0,659.0,5,1079,1.0,811.0,811.0
0.011,6,10,1990,5,911,2.0,643.0,643.0,5,1079,2.0,811.0,811.0
0.091,6,10,1506,5,395,21.0,127.0,127.0,5,1111,21.0,843.0,843.0
0.173,6,12,2996,7,549,28.0,177.0,177.0,5,2447,42.0,1402.0,1089.0
0.098,6,10,1506,5,395,22.0,127.0,127.0,5,1111,22.0,843.0,843.0
120.543,6,54,18776,31,4643,4018.0,1054.0,253.0,23,14133,5478.0,2804.0,1077.0
0.044,6,13,3735,7,497,7.0,125.0,125.0,6,3238,8.0,1470.0,1459.0
0.005,6,10,2006,5,927,1.0,659.0,659.0,5,1079,1.0,811.0,811.0
0.014,6,10,1990,5,911,3.0,643.0,643.0,5,1079,3.0,811.0,811.0
0.008,6,10,1972,5,910,2.0,642.0,642.0,5,1062,1.0,794.0,794.0
0.006,6,10,1547,5,764,1.0,496.0,496.0,5,783,1.0,515.0,515.0
0.002,17,2,136,1,60,0.0,32.0,32.0,1,76,0.0,48.0,48.0
0.001,17,2,136,1,60,0.0,32.0,32.0,1,76,0.0,48.0,48.0
0.005,6,10,2000,5,927,1.0,659.0,659.0,5,1073,1.0,805.0,805.0
0.012,6,10,1989,5,910,3.0,642.0,642.0,5,1079,3.0,811.0,811.0
0.004,17,2,148,1,60,0.0,32.0,32.0,1,88,0.0,60.0,60.0
0.001,17,2,180,1,66,0.0,38.0,38.0,1,114,0.0,86.0,86.0
0.082,6,10,1506,5,395,19.0,127.0,127.0,5,1111,18.0,843.0,843.0
0.071,6,10,1506,5,395,15.0,127.0,127.0,5,1111,15.0,843.0,843.0
11.033,17,28,4399,14,2312,840.0,587.0,137.0,14,2087,840.0,270.0,121.0
0.07,6,10,1506,5,395,14.0,127.0,127.0,5,1111,15.0,843.0,843.0
0.005,6,10,2006,5,927,1.0,659.0,659.0,5,1079,1.0,811.0,811.0
0.009,6,10,1972,5,910,2.0,642.0,642.0,5,1062,2.0,794.0,794.0
0.171,17,2,213,1,69,0.0,41.0,41.0,1,144,0.0,116.0,116.0
0.005,6,10,2007,5,928,1.0,660.0,660.0,5,1079,1.0,811.0,811.0
0.038,17,2,184,1,61,0.0,33.0,33.0,1,123,0.0,95.0,95.0
0.011,6,10,1631,5,848,2.0,580.0,580.0,5,783,2.0,515.0,515.0
0.007,6,10,1972,5,910,1.0,642.0,642.0,5,1062,1.0,794.0,794.0
0.011,6,10,1990,5,911,2.0,643.0,643.0,5,1079,2.0,811.0,811.0
0.005,6,10,2006,5,927,1.0,659.0,659.0,5,1079,1.0,811.0,811.0
0.007,17,2,162,1,65,0.0,37.0,37.0,1,97,0.0,69.0,69.0
1777.481,17,144,45504,72,22752,25034.0,288.0,288.0,72,22752,25034.0,288.0,288.0
0.068,6,10,1506,5,395,16.0,127.0,127.0,5,1111,12.0,843.0,843.0
0.006,6,10,2006,5,927,1.0,659.0,659.0,5,1079,1.0,811.0,811.0
0.098,6,10,1506,5,395,21.0,127.0,127.0,5,1111,22.0,843.0,843.0
0.014,6,10,1762,5,911,3.0,643.0,643.0,5,851,3.0,583.0,583.0
0.004,6,10,1989,5,927,1.0,659.0,659.0,5,1062,1.0,794.0,794.0
0.005,17,2,214,1,75,0.0,47.0,47.0,1,139,0.0,111.0,111.0
0.005,6,10,2007,5,928,1.0,660.0,660.0,5,1079,1.0,811.0,811.0
0.017,6,10,1990,5,911,4.0,643.0,643.0,5,1079,4.0,811.0,811.0
0.08,6,10,1506,5,395,19.0,127.0,127.0,5,1111,19.0,843.0,843.0
0.038,17,2,136,1,60,0.0,32.0,32.0,1,76,0.0,48.0,48.0
0.004,17,2,148,1,60,0.0,32.0,32.0,1,88,0.0,60.0,60.0
0.021,6,10,1972,5,910,5.0,642.0,642.0,5,1062,5.0,794.0,794.0
0.011,6,10,1983,5,910,2.0,642.0,642.0,5,1073,2.0,805.0,805.0
0.01,6,10,1989,5,910,2.0,642.0,642.0,5,1079,2.0,811.0,811.0
0.128,17,2,80,1,32,0.0,4.0,4.0,1,48,0.0,20.0,20.0
40.075,17,10,676,5,460,10017.0,104.0,64.0,5,216,10017.0,20.0,15.0
0.068,17,8,3613,4,1874,22.0,1350.0,440.0,4,1739,11.0,1350.0,406.0
0.012,6,10,1989,5,910,2.0,642.0,642.0,5,1079,3.0,811.0,811.0
0.009,17,2,170,1,65,0.0,37.0,37.0,1,105,0.0,77.0,77.0
0.006,6,10,1989,5,927,1.0,659.0,659.0,5,1062,1.0,794.0,794.0
40.066,17,10,676,5,460,10015.0,104.0,64.0,5,216,10015.0,20.0,15.0
0.005,17,2,170,1,65,0.0,37.0,37.0,1,105,0.0,77.0,77.0
0.032,6,10,1972,5,910,8.0,642.0,642.0,5,1062,8.0,794.0,794.0
0.012,6,10,1990,5,911,3.0,643.0,643.0,5,1079,3.0,811.0,811.0
0.072,17,4,284,2,120,0.0,32.0,32.0,2,164,69.0,60.0,54.0
0.003,17,2,136,1,60,0.0,32.0,32.0,1,76,0.0,48.0,48.0
0.005,6,10,1547,5,764,1.0,496.0,496.0,5,783,1.0,515.0,515.0
0.005,17,2,180,1,66,0.0,38.0,38.0,1,114,0.0,86.0,86.0
0.004,17,2,187,1,74,0.0,46.0,46.0,1,113,0.0,85.0,85.0
0.007,6,10,2007,5,928,1.0,660.0,660.0,5,1079,1.0,811.0,811.0
0.001,17,2,179,1,62,0.0,34.0,34.0,1,117,0.0,89.0,89.0
0.014,6,10,1989,5,910,3.0,642.0,642.0,5,1079,3.0,811.0,811.0
0.037,17,2,136,1,60,0.0,32.0,32.0,1,76,0.0,48.0,48.0
0.015,6,10,1972,5,910,3.0,642.0,642.0,5,1062,3.0,794.0,794.0
0.014,6,10,1762,5,911,3.0,643.0,643.0,5,851,3.0,583.0,583.0
0.006,6,10,1643,5,860,1.0,592.0,592.0,5,783,1.0,515.0,515.0
0.013,6,10,1990,5,911,3.0,643.0,643.0,5,1079,3.0,811.0,811.0
0.005,17,2,164,1,74,0.0,46.0,46.0,1,90,0.0,62.0,62.0
0.0,17,2,166,1,75,0.0,47.0,47.0,1,91,0.0,63.0,63.0
0.119,6,10,1506,5,395,24.0,127.0,127.0,5,1111,27.0,843.0,843.0
0.007,17,2,194,1,59,0.0,31.0,31.0,1,135,0.0,107.0,107.0
0.001,17,2,142,1,63,0.0,35.0,35.0,1,79,0.0,51.0,51.0
0.088,6,10,1506,5,395,19.0,127.0,127.0,5,1111,20.0,843.0,843.0
0.139,6,10,1506,5,395,28.0,127.0,127.0,5,1111,31.0,843.0,843.0
0.014,6,10,1990,5,911,3.0,643.0,643.0,5,1079,3.0,811.0,811.0
0.004,17,2,148,1,60,0.0,32.0,32.0,1,88,0.0,60.0,60.0
0.008,17,4,284,2,120,0.0,32.0,32.0,2,164,1.0,60.0,54.0
0.089,6,10,1506,5,395,17.0,127.0,127.0,5,1111,21.0,843.0,843.0
0.004,6,10,2007,5,928,1.0,660.0,660.0,5,1079,1.0,811.0,811.0
0.013,6,10,1990,5,911,3.0,643.0,643.0,5,1079,3.0,811.0,811.0
0.001,17,2,180,1,66,0.0,38.0,38.0,1,114,0.0,86.0,86.0
0.006,6,10,1547,5,764,1.0,496.0,496.0,5,783,1.0,515.0,515.0
300.98,6,49,21603,25,15616,12540.0,4080.0,1620.0,24,5987,383.0,1360.0,358.0
0.079,6,10,1506,5,395,19.0,127.0,127.0,5,1111,16.0,843.0,843.0
0.041,17,4,352,2,130,1.0,37.0,37.0,2,222,37.0,89.0,83.0
0.003,17,2,136,1,60,0.0,32.0,32.0,1,76,0.0,48.0,48.0
40.056,17,10,676,5,460,10013.0,104.0,64.0,5,216,10013.0,20.0,15.0
241.993,6,387,347867,187,21252,1301.0,2736.0,960.0,200,326615,1216.0,2804.0,1664.0
0.003,17,2,136,1,60,0.0,32.0,32.0,1,76,0.0,48.0,48.0
0.015,6,10,1677,5,827,3.0,559.0,559.0,5,850,3.0,582.0,582.0
0.005,6,10,1989,5,927,1.0,659.0,659.0,5,1062,1.0,794.0,794.0
0.13,17,2,136,1,60,0.0,32.0,32.0,1,76,0.0,48.0,48.0
0.003,17,2,136,1,60,0.0,32.0,32.0,1,76,0.0,48.0,48.0
0.005,6,10,1779,5,928,1.0,660.0,660.0,5,851,1.0,583.0,583.0
300.191,6,27,7436,16,1409,20012.0,217.0,142.0,11,6027,24017.0,1679.0,778.0
0.009,6,10,1989,5,910,2.0,642.0,642.0,5,1079,2.0,811.0,811.0
0.025,6,8,832,4,522,8.0,302.0,302.0,4,310,6.0,102.0,102.0
0.046,17,4,284,2,120,43.0,32.0,32.0,2,164,9.0,60.0,54.0
0.069,6,10,1506,5,395,16.0,127.0,127.0,5,1111,15.0,843.0,843.0
0.009,6,10,1989,5,910,2.0,642.0,642.0,5,1079,2.0,811.0,811.0
0.011,6,10,1989,5,910,2.0,642.0,642.0,5,1079,2.0,811.0,811.0
0.006,6,10,1547,5,764,1.0,496.0,496.0,5,783,1.0,515.0,515.0
0.004,6,10,1774,5,923,1.0,655.0,655.0,5,851,1.0,583.0,583.0
0.012,6,10,1989,5,910,3.0,642.0,642.0,5,1079,3.0,811.0,811.0
0.005,17,2,214,1,75,0.0,47.0,47.0,1,139,0.0,111.0,111.0
0.056,17,2,152,1,76,0.0,48.0,48.0,1,76,0.0,48.0,48.0
0.009,6,10,1990,5,911,2.0,643.0,643.0,5,1079,2.0,811.0,811.0
0.008,6,10,1983,5,910,2.0,642.0,642.0,5,1073,1.0,805.0,805.0
0.15,6,10,1506,5,395,35.0,127.0,127.0,5,1111,35.0,843.0,843.0
0.001,17,2,180,1,66,0.0,38.0,38.0,1,114,0.0,86.0,86.0
0.007,17,2,179,1,71,0.0,43.0,43.0,1,108,0.0,80.0,80.0
300.804,6,38,10019,21,4541,15040.0,1360.0,611.0,17,5478,539.0,2667.0,435.0
0.093,6,10,1506,5,395,20.0,127.0,127.0,5,1111,19.0,843.0,843.0
1770.639,17,92,8096,46,4048,39347.0,60.0,60.0,46,4048,39347.0,60.0,60.0
0.006,6,10,1689,5,839,1.0,571.0,571.0,5,850,1.0,582.0,582.0
0.004,17,2,148,1,60,0.0,32.0,32.0,1,88,0.0,60.0,60.0
0.072,17,4,336,2,124,0.0,34.0,34.0,2,212,29.0,84.0,78.0
0.088,6,10,1506,5,395,19.0,127.0,127.0,5,1111,19.0,843.0,843.0
0.016,6,10,1631,5,848,4.0,580.0,580.0,5,783,4.0,515.0,515.0
240.131,6,49,7171,23,3314,10914.0,588.0,211.0,26,3857,9605.0,580.0,208.0
0.012,6,13,3735,7,497,2.0,125.0,125.0,6,3238,2.0,1470.0,1459.0
0.013,6,10,1677,5,827,3.0,559.0,559.0,5,850,3.0,582.0,582.0
0.093,6,10,1506,5,395,20.0,127.0,127.0,5,1111,21.0,843.0,843.0
0.007,17,2,180,1,66,0.0,38.0,38.0,1,114,0.0,86.0,86.0
0.008,6,10,1989,5,910,2.0,642.0,642.0,5,1079,2.0,811.0,811.0
0.133,17,2,80,1,32,0.0,4.0,4.0,1,48,0.0,20.0,20.0
0.06,17,2,80,1,32,0.0,4.0,4.0,1,48,0.0,20.0,20.0
0.004,6,10,2000,5,927,1.0,659.0,659.0,5,1073,1.0,805.0,805.0
0.005,6,10,1689,5,839,1.0,571.0,571.0,5,850,1.0,582.0,582.0
0.079,6,10,1506,5,395,18.0,127.0,127.0,5,1111,17.0,843.0,843.0
0.017,6,10,1989,5,910,4.0,642.0,642.0,5,1079,4.0,811.0,811.0
0.006,6,10,1643,5,860,1.0,592.0,592.0,5,783,1.0,515.0,515.0
0.113,6,10,1506,5,395,27.0,127.0,127.0,5,1111,26.0,843.0,843.0
0.012,6,10,1983,5,910,3.0,642.0,642.0,5,1073,2.0,805.0,805.0
0.095,6,10,1506,5,395,21.0,127.0,127.0,5,1111,23.0,843.0,843.0
1761.173,6,465,66208,252,35168,7016.0,613.0,197.0,213,31040,8307.0,453.0,142.0
0.067,17,8,3613,4,1874,22.0,1350.0,440.0,4,1739,11.0,1350.0,406.0
0.005,6,10,2007,5,928,1.0,660.0,660.0,5,1079,1.0,811.0,811.0
0.005,6,10,2007,5,928,1.0,660.0,660.0,5,1079,1.0,811.0,811.0
0.014,6,10,1989,5,910,3.0,642.0,642.0,5,1079,3.0,811.0,811.0
0.002,17,2,166,1,75,0.0,47.0,47.0,1,91,0.0,63.0,63.0
0.005,6,10,1643,5,860,1.0,592.0,592.0,5,783,1.0,515.0,515.0
0.243,17,38,20098,21,17044,12.0,1350.0,783.0,17,3054,11.0,1350.0,151.0
0.001,17,2,180,1,66,0.0,38.0,38.0,1,114,0.0,86.0,86.0
0.005,6,10,2006,5,927,1.0,659.0,659.0,5,1079,1.0,811.0,811.0
0.003,17,2,136,1,60,0.0,32.0,32.0,1,76,0.0,48.0,48.0
0.005,6,10,1989,5,927,1.0,659.0,659.0,5,1062,1.0,794.0,794.0
0.001,17,2,180,1,66,0.0,38.0,38.0,1,114,0.0,86.0,86.0
0.004,6,10,2007,5,928,1.0,660.0,660.0,5,1079,1.0,811.0,811.0
0.001,17,2,180,1,66,0.0,38.0,38.0,1,114,0.0,86.0,86.0
0.004,6,10,2006,5,927,1.0,659.0,659.0,5,1079,1.0,811.0,811.0
0.014,6,13,3735,7,497,2.0,125.0,125.0,6,3238,2.0,1470.0,1459.0
0.016,6,10,1989,5,910,4.0,642.0,642.0,5,1079,3.0,811.0,811.0
0.005,6,13,3747,7,509,0.0,137.0,137.0,6,3238,1.0,1470.0,1459.0
0.017,6,14,3787,7,497,2.0,125.0,125.0,7,3290,2.0,1448.0,972.0
0.006,6,13,3747,7,509,0.0,137.0,137.0,6,3238,1.0,1470.0,1459.0
1778.779,17,138,43608,72,22752,25049.0,288.0,288.0,66,20856,27359.0,288.0,288.0
0.013,17,2,152,1,56,0.0,28.0,28.0,1,96,0.0,68.0,68.0
0.075,6,10,1506,5,395,15.0,127.0,127.0,5,1111,18.0,843.0,843.0
0.02,6,10,1983,5,910,5.0,642.0,642.0,5,1073,5.0,805.0,805.0
0.01,6,10,1989,5,910,2.0,642.0,642.0,5,1079,2.0,811.0,811.0
0.004,6,10,2007,5,928,1.0,660.0,660.0,5,1079,1.0,811.0,811.0
300.85,6,39,9855,21,4337,15042.0,1753.0,693.0,18,5518,511.0,1360.0,398.0
0.006,6,10,1547,5,764,1.0,496.0,496.0,5,783,1.0,515.0,515.0
0.006,6,10,1547,5,764,1.0,496.0,496.0,5,783,1.0,515.0,515.0
0.009,6,10,1990,5,911,2.0,643.0,643.0,5,1079,2.0,811.0,811.0
0.017,6,10,1989,5,910,4.0,642.0,642.0,5,1079,4.0,811.0,811.0
240.137,6,32,9199,16,6807,16009.0,1879.0,664.0,16,2392,16008.0,580.0,194.0
0.116,6,10,1506,5,395,27.0,127.0,127.0,5,1111,25.0,843.0,843.0
0.007,17,2,170,1,65,0.0,37.0,37.0,1,105,0.0,77.0,77.0
0.04,17,2,156,1,64,0.0,36.0,36.0,1,92,0.0,64.0,64.0
0.012,17,2,162,1,65,0.0,37.0,37.0,1,97,0.0,69.0,69.0
0.004,6,10,1702,5,863,1.0,595.0,595.0,5,839,1.0,571.0,571.0
0.006,6,10,1547,5,764,1.0,496.0,496.0,5,783,1.0,515.0,515.0
0.065,6,10,1506,5,395,14.0,127.0,127.0,5,1111,14.0,843.0,843.0
0.003,17,4,284,2,120,0.0,32.0,32.0,2,164,0.0,60.0,54.0
0.005,6,10,1689,5,839,1.0,571.0,571.0,5,850,1.0,582.0,582.0
0.005,6,10,2006,5,927,1.0,659.0,659.0,5,1079,1.0,811.0,811.0
40.068,17,10,676,5,460,10016.0,104.0,64.0,5,216,10016.0,20.0,15.0
0.038,6,10,1989,5,910,9.0,642.0,642.0,5,1079,9.0,811.0,811.0
0.185,17,4,352,2,130,146.0,37.0,37.0,2,222,142.0,89.0,83.0
0.01,6,10,1989,5,910,2.0,642.0,642.0,5,1079,2.0,811.0,811.0
0.005,6,10,2000,5,927,1.0,659.0,659.0,5,1073,1.0,805.0,805.0
0.012,17,2,152,1,76,0.0,48.0,48.0,1,76,0.0,48.0,48.0
0.005,6,10,1989,5,927,1.0,659.0,659.0,5,1062,1.0,794.0,794.0
40.06,17,10,676,5,460,10013.0,104.0,64.0,5,216,10014.0,20.0,15.0
0.106,6,10,1506,5,395,25.0,127.0,127.0,5,1111,24.0,843.0,843.0
0.007,6,10,1972,5,910,1.0,642.0,642.0,5,1062,1.0,794.0,794.0
0.114,6,10,1506,5,395,26.0,127.0,127.0,5,1111,26.0,843.0,843.0
0.785,6,10,2009,6,1655,157.0,1403.0,1403.0,4,354,183.0,182.0,182.0
40.055,17,10,676,5,460,10012.0,104.0,64.0,5,216,10012.0,20.0,15.0
0.001,17,2,166,1,75,0.0,47.0,47.0,1,91,0.0,63.0,63.0
40.067,17,10,676,5,460,10014.0,104.0,64.0,5,216,10015.0,20.0,15.0
0.011,6,10,1990,5,911,2.0,643.0,643.0,5,1079,2.0,811.0,811.0
0.014,6,10,1989,5,910,3.0,642.0,642.0,5,1079,3.0,811.0,811.0
0.004,17,2,148,1,60,0.0,32.0,32.0,1,88,0.0,60.0,60.0
0.004,6,10,1702,5,863,1.0,595.0,595.0,5,839,0.0,571.0,571.0
0.005,6,10,1989,5,927,1.0,659.0,659.0,5,1062,1.0,794.0,794.0
0.007,6,10,2006,5,927,1.0,659.0,659.0,5,1079,1.0,811.0,811.0
240.297,6,27,10629,14,4874,18484.0,1368.0,691.0,13,5755,20024.0,1657.0,845.0
0.006,6,10,1547,5,764,1.0,496.0,496.0,5,783,1.0,515.0,515.0
0.013,6,10,2006,5,927,3.0,659.0,659.0,5,1079,3.0,811.0,811.0
0.005,17,2,170,1,65,0.0,37.0,37.0,1,105,0.0,77.0,77.0
0.006,6,10,2007,5,928,1.0,660.0,660.0,5,1079,1.0,811.0,811.0
300.325,6,16,2170,9,684,37520.0,146.0,146.0,7,1486,50026.0,419.0,398.0
309.892,17,19,1084,10,716,34410.0,48.0,43.0,9,368,38710.0,20.0,12.0
0.003,17,2,136,1,60,0.0,32.0,32.0,1,76,0.0,48.0,48.0
0.067,17,8,3613,4,1874,22.0,1350.0,440.0,4,1739,11.0,1350.0,406.0
0.01,6,10,1631,5,848,2.0,580.0,580.0,5,783,2.0,515.0,515.0
0.1,6,10,1506,5,395,22.0,127.0,127.0,5,1111,24.0,843.0,843.0
0.086,6,10,1506,5,395,16.0,127.0,127.0,5,1111,17.0,843.0,843.0
0.015,6,10,1972,5,910,3.0,642.0,642.0,5,1062,3.0,794.0,794.0
0.006,6,10,2007,5,928,1.0,660.0,660.0,5,1079,1.0,811.0,811.0
0.007,6,10,2006,5,927,1.0,659.0,659.0,5,1079,1.0,811.0,811.0
0.004,6,10,2006,5,927,1.0,659.0,659.0,5,1079,1.0,811.0,811.0
0.005,6,10,2006,5,927,1.0,659.0,659.0,5,1079,1.0,811.0,811.0
0.001,17,2,180,1,66,0.0,38.0,38.0,1,114,0.0,86.0,86.0
0.005,17,2,180,1,66,0.0,38.0,38.0,1,114,0.0,86.0,86.0
0.005,6,14,3799,7,509,0.0,137.0,137.0,7,3290,0.0,1448.0,972.0
0.005,6,10,1854,5,889,1.0,621.0,621.0,5,965,1.0,697.0,697.0
0.015,6,10,1972,5,910,3.0,642.0,642.0,5,1062,3.0,794.0,794.0
0.092,6,10,1506,5,395,18.0,127.0,127.0,5,1111,20.0,843.0,843.0
0.039,6,10,1989,5,910,9.0,642.0,642.0,5,1079,9.0,811.0,811.0
0.005,6,10,2000,5,927,1.0,659.0,659.0,5,1073,1.0,805.0,805.0
0.006,6,10,1547,5,764,1.0,496.0,496.0,5,783,1.0,515.0,515.0
1793.994,6,489,99372,245,88022,7352.0,421.0,365.0,244,11350,7381.0,53.0,53.0
0.007,17,2,194,1,59,0.0,31.0,31.0,1,135,0.0,107.0,107.0
0.013,6,10,1972,5,910,3.0,642.0,642.0,5,1062,3.0,794.0,794.0
0.004,17,2,136,1,60,0.0,32.0,32.0,1,76,0.0,48.0,48.0
0.005,17,2,164,1,74,0.0,46.0,46.0,1,90,0.0,62.0,62.0
0.103,6,10,1506,5,395,22.0,127.0,127.0,5,1111,23.0,843.0,843.0
40.053,17,10,676,5,460,10012.0,104.0,64.0,5,216,10011.0,20.0,15.0
9.036,17,6,376,5,280,2259.0,28.0,28.0,1,96,0.0,68.0,68.0
0.005,6,10,1779,5,928,1.0,660.0,660.0,5,851,1.0,583.0,583.0
366.047,6,22,2313,16,867,24403.0,195.0,195.0,6,1446,4655.0,419.0,398.0
0.004,6,10,1702,5,863,1.0,595.0,595.0,5,839,1.0,571.0,571.0
0.004,6,10,2007,5,928,1.0,660.0,660.0,5,1079,1.0,811.0,811.0
0.009,6,10,1983,5,910,2.0,642.0,642.0,5,1073,2.0,805.0,805.0
0.005,17,2,180,1,58,0.0,30.0,30.0,1,122,0.0,94.0,94.0
241.459,6,395,342337,145,11308,1676.0,1368.0,470.0,250,331029,969.0,1629.0,1353.0
0.003,17,2,136,1,60,0.0,32.0,32.0,1,76,0.0,48.0,48.0
0.067,6,10,1506,5,395,14.0,127.0,127.0,5,1111,15.0,843.0,843.0
0.005,6,10,2006,5,927,1.0,659.0,659.0,5,1079,1.0,811.0,811.0
40.065,17,10,676,5,460,10014.0,104.0,64.0,5,216,10015.0,20.0,15.0
0.083,6,10,1506,5,395,19.0,127.0,127.0,5,1111,17.0,843.0,843.0
0.003,17,2,132,1,58,0.0,30.0,30.0,1,74,0.0,46.0,46.0
240.242,6,36,10527,18,2215,14131.0,559.0,254.0,18,8312,14131.0,1402.0,615.0
0.005,6,10,1989,5,927,1.0,659.0,659.0,5,1062,1.0,794.0,794.0
0.006,6,10,1990,5,911,1.0,643.0,643.0,5,1079,1.0,811.0,811.0
0.009,6,12,1926,6,1189,1.0,659.0,434.0,6,737,1.0,417.0,417.0
240.114,6,31,9164,15,6731,17151.0,1856.0,661.0,16,2433,16007.0,580.0,199.0
0.007,6,10,1631,5,848,1.0,580.0,580.0,5,783,1.0,515.0,515.0
0.001,17,2,136,1,60,0.0,32.0,32.0,1,76,0.0,48.0,48.0
0.005,6,10,2007,5,928,1.0,660.0,660.0,5,1079,1.0,811.0,811.0
0.014,6,10,1983,5,910,3.0,642.0,642.0,5,1073,3.0,805.0,805.0
0.024,6,10,1972,5,910,6.0,642.0,642.0,5,1062,6.0,794.0,794.0
0.006,6,10,1547,5,764,1.0,496.0,496.0,5,783,1.0,515.0,515.0
0.042,17,4,284,2,120,0.0,32.0,32.0,2,164,38.0,60.0,54.0
0.005,6,10,2006,5,927,1.0,659.0,659.0,5,1079,1.0,811.0,811.0
0.001,17,2,166,1,75,0.0,47.0,47.0,1,91,0.0,63.0,63.0
0.006,6,10,1989,5,927,1.0,659.0,659.0,5,1062,1.0,794.0,794.0
0.115,6,10,1506,5,395,25.0,127.0,127.0,5,1111,25.0,843.0,843.0
0.004,17,2,148,1,60,0.0,32.0,32.0,1,88,0.0,60.0,60.0
0.005,6,10,2007,5,928,1.0,660.0,660.0,5,1079,1.0,811.0,811.0
0.119,6,10,1506,5,395,25.0,127.0,127.0,5,1111,25.0,843.0,843.0
0.018,6,10,1990,5,911,4.0,643.0,643.0,5,1079,4.0,811.0,811.0
240.081,6,21,4924,11,941,24008.0,180.0,93.0,10,3983,26675.0,1591.0,575.0
0.005,6,10,1774,5,923,1.0,655.0,655.0,5,851,1.0,583.0,583.0
0.105,6,10,1506,5,395,25.0,127.0,127.0,5,1111,24.0,843.0,843.0
0.018,6,10,1990,5,911,4.0,643.0,643.0,5,1079,4.0,811.0,811.0
0.011,6,10,1972,5,910,2.0,642.0,642.0,5,1062,2.0,794.0,794.0
0.196,6,10,1506,5,395,44.0,127.0,127.0,5,1111,35.0,843.0,843.0
0.005,17,4,284,2,120,0.0,32.0,32.0,2,164,0.0,60.0,54.0
0.014,6,10,1983,5,910,3.0,642.0,642.0,5,1073,3.0,805.0,805.0
0.016,6,10,1990,5,911,4.0,643.0,643.0,5,1079,4.0,811.0,811.0
0.004,17,2,136,1,60,0.0,32.0,32.0,1,76,0.0,48.0,48.0
0.079,6,10,1506,5,395,18.0,127.0,127.0,5,1111,17.0,843.0,843.0
0.026,6,10,1677,5,827,6.0,559.0,559.0,5,850,6.0,582.0,582.0
0.094,6,10,1506,5,395,19.0,127.0,127.0,5,1111,17.0,843.0,843.0
0.001,17,2,166,1,75,0.0,47.0,47.0,1,91,0.0,63.0,63.0
0.013,17,2,152,1,56,0.0,28.0,28.0,1,96,0.0,68.0,68.0
0.005,17,2,140,1,62,0.0,34.0,34.0,1,78,0.0,50.0,50.0
0.016,6,10,1972,5,910,4.0,642.0,642.0,5,1062,4.0,794.0,794.0
0.006,17,2,170,1,65,0.0,37.0,37.0,1,105,0.0,77.0,77.0
240.107,6,32,9200,16,6639,16007.0,1711.0,645.0,16,2561,16006.0,580.0,215.0
0.005,6,10,2006,5,927,1.0,659.0,659.0,5,1079,1.0,811.0,811.0
0.004,6,10,1989,5,927,1.0,659.0,659.0,5,1062,1.0,794.0,794.0
0.01,6,10,1990,5,911,2.0,643.0,643.0,5,1079,2.0,811.0,811.0
0.004,6,10,1779,5,928,1.0,660.0,660.0,5,851,1.0,583.0,583.0
0.005,17,2,146,1,65,0.0,37.0,37.0,1,81,0.0,53.0,53.0
0.005,6,14,3799,7,509,0.0,137.0,137.0,7,3290,0.0,1448.0,972.0
0.005,6,10,1689,5,839,1.0,571.0,571.0,5,850,1.0,582.0,582.0
0.006,6,10,1547,5,764,1.0,496.0,496.0,5,783,1.0,515.0,515.0
0.038,17,2,186,1,61,0.0,33.0,33.0,1,125,0.0,97.0,97.0
0.077,17,4,284,2,120,0.0,32.0,32.0,2,164,74.0,60.0,54.0
293.068,6,306,343384,113,17430,2616.0,2736.0,889.0,193,325954,1526.0,2804.0,1764.0
295.621,6,312,343695,125,18054,2384.0,2691.0,889.0,187,325641,1589.0,4206.0,1826.0
0.022,6,10,1990,5,911,5.0,643.0,643.0,5,1079,5.0,811.0,811.0
0.089,6,10,1506,5,395,18.0,127.0,127.0,5,1111,19.0,843.0,843.0
240.096,6,16,4480,9,963,30012.0,238.0,166.0,7,3517,40015.0,1402.0,786.0
0.011,6,10,1989,5,910,2.0,642.0,642.0,5,1079,2.0,811.0,811.0
0.074,6,10,1506,5,395,15.0,127.0,127.0,5,1111,16.0,843.0,843.0
0.006,6,10,1854,5,889,1.0,621.0,621.0,5,965,1.0,697.0,697.0
0.005,6,10,2007,5,928,1.0,660.0,660.0,5,1079,1.0,811.0,811.0
0.003,17,2,136,1,60,0.0,32.0,32.0,1,76,0.0,48.0,48.0
0.327,17,43,26509,26,23446,13.0,1350.0,873.0,17,3063,15.0,1350.0,152.0
0.01,6,10,1762,5,911,2.0,643.0,643.0,5,851,2.0,583.0,583.0
0.006,6,10,1989,5,927,1.0,659.0,659.0,5,1062,1.0,794.0,794.0
0.004,6,10,2006,5,927,1.0,659.0,659.0,5,1079,1.0,811.0,811.0
0.039,17,2,136,1,60,0.0,32.0,32.0,1,76,0.0,48.0,48.0
240.102,6,16,4481,9,963,30012.0,238.0,166.0,7,3518,40016.0,1402.0,786.0
0.006,17,2,230,1,68,0.0,40.0,40.0,1,162,0.0,134.0,134.0
0.155,6,10,1506,5,395,34.0,127.0,127.0,5,1111,33.0,843.0,843.0
0.124,17,2,170,1,65,0.0,37.0,37.0,1,105,0.0,77.0,77.0
0.005,6,10,1643,5,860,1.0,592.0,592.0,5,783,1.0,515.0,515.0
0.108,6,10,1506,5,395,24.0,127.0,127.0,5,1111,23.0,843.0,843.0
0.006,6,10,1547,5,764,1.0,496.0,496.0,5,783,1.0,515.0,515.0
360.049,6,21,3981,13,3142,30004.0,494.0,494.0,8,839,51435.0,83.0,83.0
0.005,6,10,1989,5,927,1.0,659.0,659.0,5,1062,1.0,794.0,794.0
40.058,17,10,676,5,460,10012.0,104.0,64.0,5,216,10013.0,20.0,15.0
0.005,6,10,1989,5,927,1.0,659.0,659.0,5,1062,1.0,794.0,794.0
0.009,6,10,1972,5,910,2.0,642.0,642.0,5,1062,2.0,794.0,794.0
40.073,17,10,676,5,460,10015.0,104.0,64.0,5,216,10017.0,20.0,15.0
241.616,6,376,347089,192,21515,1265.0,2736.0,960.0,184,325574,1320.0,4127.0,1816.0
0.104,6,10,1506,5,395,23.0,127.0,127.0,5,1111,24.0,843.0,843.0
0.019,6,10,1983,5,910,4.0,642.0,642.0,5,1073,4.0,805.0,805.0
0.004,6,10,2007,5,928,1.0,660.0,660.0,5,1079,1.0,811.0,811.0
0.084,6,10,1506,5,395,17.0,127.0,127.0,5,1111,19.0,843.0,843.0
0.004,6,10,1989,5,927,1.0,659.0,659.0,5,1062,1.0,794.0,794.0
0.001,17,2,180,1,66,0.0,38.0,38.0,1,114,0.0,86.0,86.0
0.005,17,2,170,1,65,0.0,37.0,37.0,1,105,0.0,77.0,77.0
0.012,6,10,1983,5,910,3.0,642.0,642.0,5,1073,3.0,805.0,805.0
0.006,6,10,1547,5,764,1.0,496.0,496.0,5,783,1.0,515.0,515.0
0.006,6,13,3684,7,446,1.0,74.0,74.0,6,3238,1.0,1470.0,1459.0
0.005,6,10,2000,5,927,1.0,659.0,659.0,5,1073,1.0,805.0,805.0
40.054,17,10,676,5,460,10012.0,104.0,64.0,5,216,10012.0,20.0,15.0
0.007,6,10,1990,5,911,1.0,643.0,643.0,5,1079,1.0,811.0,811.0
0.001,17,2,180,1,66,0.0,38.0,38.0,1,114,0.0,86.0,86.0
0.004,6,10,1773,5,922,1.0,654.0,654.0,5,851,1.0,583.0,583.0
9.037,17,6,376,5,280,2259.0,28.0,28.0,1,96,0.0,68.0,68.0
240.094,6,16,4480,9,963,30011.0,238.0,166.0,7,3517,40015.0,1402.0,786.0
40.058,17,10,676,5,460,10013.0,104.0,64.0,5,216,10013.0,20.0,15.0
0.005,6,10,1774,5,923,1.0,655.0,655.0,5,851,1.0,583.0,583.0
0.006,17,2,243,1,68,0.0,40.0,40.0,1,175,0.0,147.0,147.0
0.004,17,2,136,1,60,0.0,32.0,32.0,1,76,0.0,48.0,48.0
0.073,17,2,148,1,60,0.0,32.0,32.0,1,88,0.0,60.0,60.0
0.005,17,2,170,1,65,0.0,37.0,37.0,1,105,0.0,77.0,77.0
0.001,17,2,180,1,66,0.0,38.0,38.0,1,114,0.0,86.0,86.0
0.094,6,10,1506,5,395,20.0,127.0,127.0,5,1111,21.0,843.0,843.0
0.206,6,16,2670,8,1396,29.0,533.0,324.0,8,1274,18.0,529.0,212.0
0.012,6,10,1989,5,910,2.0,642.0,642.0,5,1079,3.0,811.0,811.0
0.01,6,10,1989,5,910,2.0,642.0,642.0,5,1079,2.0,811.0,811.0
0.005,17,2,166,1,75,0.0,47.0,47.0,1,91,0.0,63.0,63.0
0.007,6,10,1972,5,910,1.0,642.0,642.0,5,1062,1.0,794.0,794.0
0.005,6,13,3747,7,509,0.0,137.0,137.0,6,3238,0.0,1470.0,1459.0
0.007,6,10,2000,5,927,1.0,659.0,659.0,5,1073,1.0,805.0,805.0
0.008,6,10,1989,5,910,2.0,642.0,642.0,5,1079,2.0,811.0,811.0
0.005,6,10,2007,5,928,1.0,660.0,660.0,5,1079,1.0,811.0,811.0
0.078,6,10,1506,5,395,14.0,127.0,127.0,5,1111,18.0,843.0,843.0
0.005,6,10,1547,5,764,1.0,496.0,496.0,5,783,1.0,515.0,515.0
40.062,17,10,676,5,460,10014.0,104.0,64.0,5,216,10014.0,20.0,15.0
0.091,6,10,1506,5,395,20.0,127.0,127.0,5,1111,18.0,843.0,843.0
0.007,6,10,1547,5,764,1.0,496.0,496.0,5,783,1.0,515.0,515.0
1799.998,6,242,28649,92,17111,19450.0,2720.0,174.0,150,11538,12079.0,1062.0,75.0
0.09,6,10,1506,5,395,21.0,127.0,127.0,5,1111,21.0,843.0,843.0
0.172,17,2,152,1,76,0.0,48.0,48.0,1,76,0.0,48.0,48.0
164.579,17,70,10023,35,2334,4840.0,44.0,38.0,35,7689,4840.0,239.0,191.0
0.006,17,2,212,1,74,0.0,46.0,46.0,1,138,0.0,110.0,110.0
0.006,6,13,3747,7,509,1.0,137.0,137.0,6,3238,1.0,1470.0,1459.0
0.006,17,2,166,1,75,0.0,47.0,47.0,1,91,0.0,63.0,63.0
0.005,17,2,170,1,65,0.0,37.0,37.0,1,105,0.0,77.0,77.0
1757.175,6,101,6062,58,3421,30826.0,27.0,27.0,43,2641,41836.0,27.0,27.0
0.004,17,4,284,2,120,0.0,32.0,32.0,2,164,0.0,60.0,54.0
0.18,6,10,1506,5,395,43.0,127.0,127.0,5,1111,40.0,843.0,843.0
0.013,6,10,1990,5,911,3.0,643.0,643.0,5,1079,3.0,811.0,811.0
0.004,17,2,136,1,60,0.0,32.0,32.0,1,76,0.0,48.0,48.0
0.005,17,2,164,1,74,0.0,46.0,46.0,1,90,0.0,62.0,62.0
240.087,6,16,4481,9,963,30010.0,238.0,166.0,7,3518,40014.0,1402.0,786.0
0.013,6,10,1989,5,910,3.0,642.0,642.0,5,1079,3.0,811.0,811.0
0.011,6,10,1972,5,910,2.0,642.0,642.0,5,1062,2.0,794.0,794.0
0.008,6,10,1990,5,911,1.0,643.0,643.0,5,1079,1.0,811.0,811.0
0.005,17,2,214,1,75,0.0,47.0,47.0,1,139,0.0,111.0,111.0
0.003,17,2,148,1,60,0.0,32.0,32.0,1,88,0.0,60.0,60.0
0.015,6,10,1677,5,827,3.0,559.0,559.0,5,850,3.0,582.0,582.0
0.006,6,10,1547,5,764,1.0,496.0,496.0,5,783,1.0,515.0,515.0
0.012,6,10,2006,5,927,3.0,659.0,659.0,5,1079,3.0,811.0,811.0
15.069,17,15,9238,8,6902,2148.0,1350.0,834.0,7,2336,2506.0,1350.0,305.0
0.005,6,10,1643,5,860,1.0,592.0,592.0,5,783,1.0,515.0,515.0
0.182,6,10,1506,5,395,44.0,127.0,127.0,5,1111,41.0,843.0,843.0
0.006,17,2,144,1,64,0.0,36.0,36.0,1,80,0.0,52.0,52.0
0.008,6,10,1677,5,827,2.0,559.0,559.0,5,850,1.0,582.0,582.0
0.111,6,10,1506,5,395,26.0,127.0,127.0,5,1111,26.0,843.0,843.0
0.007,6,10,1547,5,764,1.0,496.0,496.0,5,783,1.0,515.0,515.0
0.003,17,2,136,1,60,0.0,32.0,32.0,1,76,0.0,48.0,48.0
0.038,17,2,136,1,60,0.0,32.0,32.0,1,76,0.0,48.0,48.0
10.708,17,28,4416,14,1993,815.0,268.0,114.0,14,2423,815.0,586.0,145.0
164.325,17,82,11666,41,2738,4107.0,44.0,38.0,41,8928,4108.0,261.0,189.0
1730.338,6,45,2790,30,1725,59666.0,35.0,35.0,15,1065,123584.0,31.0,31.0
398.834,6,31,8424,17,4784,24927.0,1473.0,556.0,14,3640,26063.0,824.0,484.0
0.008,6,10,1677,5,827,2.0,559.0,559.0,5,850,1.0,582.0,582.0
11.002,17,28,4423,14,1994,838.0,269.0,114.0,14,2429,838.0,588.0,145.0
0.016,6,10,1972,5,910,4.0,642.0,642.0,5,1062,4.0,794.0,794.0
0.005,6,10,1774,5,923,1.0,655.0,655.0,5,851,1.0,583.0,583.0
0.005,6,13,3747,7,509,0.0,137.0,137.0,6,3238,1.0,1470.0,1459.0
170.348,17,74,10607,37,2466,4731.0,44.0,38.0,37,8141,4731.0,261.0,192.0
0.006,6,10,1689,5,839,1.0,571.0,571.0,5,850,1.0,582.0,582.0
0.207,6,16,2777,8,1395,29.0,533.0,323.0,8,1382,18.0,529.0,239.0
0.079,6,10,1506,5,395,16.0,127.0,127.0,5,1111,17.0,843.0,843.0
0.005,6,10,2000,5,927,1.0,659.0,659.0,5,1073,1.0,805.0,805.0
0.003,17,2,152,1,76,0.0,48.0,48.0,1,76,0.0,48.0,48.0
11.271,17,27,4275,13,1846,925.0,269.0,114.0,14,2429,853.0,588.0,145.0
0.017,6,14,3787,7,497,2.0,125.0,125.0,7,3290,2.0,1448.0,972.0
0.004,6,10,2006,5,927,1.0,659.0,659.0,5,1079,1.0,811.0,811.0
0.307,17,17,9186,8,6720,43.0,1350.0,812.0,9,2466,27.0,1350.0,246.0
0.014,6,10,1989,5,910,3.0,642.0,642.0,5,1079,3.0,811.0,811.0
0.053,17,2,152,1,76,0.0,48.0,48.0,1,76,0.0,48.0,48.0
1792.695,6,484,98693,243,87463,7407.0,421.0,368.0,241,11230,7469.0,53.0,53.0
0.011,6,10,1983,5,910,2.0,642.0,642.0,5,1073,2.0,805.0,805.0
353.461,6,20,2210,6,1308,12004.0,494.0,494.0,14,902,27189.0,83.0,83.0
0.006,6,10,1547,5,764,1.0,496.0,496.0,5,783,1.0,515.0,515.0
0.137,17,4,420,2,122,0.0,33.0,33.0,2,298,79.0,145.0,121.0
0.004,6,13,3747,7,509,0.0,137.0,137.0,6,3238,0.0,1470.0,1459.0
0.136,6,10,1506,5,395,30.0,127.0,127.0,5,1111,30.0,843.0,843.0
0.011,6,10,1989,5,910,2.0,642.0,642.0,5,1079,2.0,811.0,811.0
0.005,17,2,180,1,66,0.0,38.0,38.0,1,114,0.0,86.0,86.0
0.008,6,12,1926,6,1189,1.0,659.0,434.0,6,737,1.0,417.0,417.0
1786.23,6,266,21110,134,8288,13430.0,512.0,220.0,132,12822,13635.0,90.0,46.0
0.103,6,10,1506,5,395,19.0,127.0,127.0,5,1111,24.0,843.0,843.0
0.005,17,2,140,1,62,0.0,34.0,34.0,1,78,0.0,50.0,50.0
1787.858,6,305,54127,125,34368,14417.0,2720.0,296.0,180,19759,9987.0,1360.0,149.0
0.005,6,10,2006,5,927,1.0,659.0,659.0,5,1079,1.0,811.0,811.0
0.015,6,10,1631,5,848,3.0,580.0,580.0,5,783,3.0,515.0,515.0
0.014,6,10,1631,5,848,3.0,580.0,580.0,5,783,3.0,515.0,515.0
0.012,6,10,1989,5,910,3.0,642.0,642.0,5,1079,3.0,811.0,811.0
0.013,6,10,1972,5,910,3.0,642.0,642.0,5,1062,3.0,794.0,794.0
316.5,17,20,1124,10,716,35153.0,48.0,43.0,10,408,35153.0,20.0,12.0
0.006,6,10,1643,5,860,1.0,592.0,592.0,5,783,1.0,515.0,515.0
0.005,6,10,1702,5,863,1.0,595.0,595.0,5,839,1.0,571.0,571.0
0.093,6,10,1506,5,395,16.0,127.0,127.0,5,1111,19.0,843.0,843.0
0.01,6,10,1989,5,910,2.0,642.0,642.0,5,1079,2.0,811.0,811.0
40.073,17,10,676,5,460,10017.0,104.0,64.0,5,216,10017.0,20.0,15.0
0.006,17,2,179,1,71,0.0,43.0,43.0,1,108,0.0,80.0,80.0
240.01,6,9,787,5,488,60002.0,232.0,232.0,4,299,80002.0,83.0,83.0
0.072,17,4,596,2,122,0.0,33.0,33.0,2,474,30.0,323.0,209.0
40.069,17,10,676,5,460,10012.0,104.0,64.0,5,216,10016.0,20.0,15.0
240.426,6,27,4895,13,1876,20032.0,555.0,238.0,14,3019,18491.0,1402.0,286.0
0.012,6,10,1989,5,910,3.0,642.0,642.0,5,1079,2.0,811.0,811.0
0.073,6,10,1506,5,395,16.0,127.0,127.0,5,1111,16.0,843.0,843.0
0.005,17,2,180,1,58,0.0,30.0,30.0,1,122,0.0,94.0,94.0
0.004,6,10,2007,5,928,1.0,660.0,660.0,5,1079,1.0,811.0,811.0
0.006,6,10,1643,5,860,1.0,592.0,592.0,5,783,1.0,515.0,515.0
0.005,6,14,3742,7,452,0.0,80.0,80.0,7,3290,0.0,1448.0,972.0
0.001,17,2,180,1,66,0.0,38.0,38.0,1,114,0.0,86.0,86.0
0.018,6,10,1972,5,910,4.0,642.0,642.0,5,1062,4.0,794.0,794.0
0.096,6,10,1506,5,395,18.0,127.0,127.0,5,1111,21.0,843.0,843.0
1772.376,6,105,6270,60,3525,30039.0,27.0,27.0,45,2745,40280.0,27.0,27.0
0.004,6,10,1989,5,927,1.0,659.0,659.0,5,1062,1.0,794.0,794.0
0.127,17,2,148,1,60,0.0,32.0,32.0,1,88,0.0,60.0,60.0
0.003,17,2,136,1,60,0.0,32.0,32.0,1,76,0.0,48.0,48.0
0.006,6,10,1547,5,764,1.0,496.0,496.0,5,783,1.0,515.0,515.0
0.005,6,10,2007,5,928,1.0,660.0,660.0,5,1079,1.0,811.0,811.0
0.007,6,10,1989,5,927,1.0,659.0,659.0,5,1062,1.0,794.0,794.0
0.004,6,10,2006,5,927,1.0,659.0,659.0,5,1079,1.0,811.0,811.0
0.004,6,10,2006,5,927,1.0,659.0,659.0,5,1079,1.0,811.0,811.0
0.103,6,10,1506,5,395,24.0,127.0,127.0,5,1111,20.0,843.0,843.0
0.009,6,10,1983,5,910,2.0,642.0,642.0,5,1073,2.0,805.0,805.0
369.91,6,22,2264,16,818,24660.0,146.0,146.0,6,1446,4652.0,419.0,398.0
0.007,17,2,222,1,65,0.0,37.0,37.0,1,157,0.0,129.0,129.0
0.041,17,2,184,1,61,0.0,33.0,33.0,1,123,0.0,95.0,95.0
0.08,6,10,1506,5,395,16.0,127.0,127.0,5,1111,17.0,843.0,843.0
0.108,6,10,1506,5,395,23.0,127.0,127.0,5,1111,23.0,843.0,843.0
0.092,6,10,1506,5,395,20.0,127.0,127.0,5,1111,19.0,843.0,843.0
0.005,6,10,2000,5,927,1.0,659.0,659.0,5,1073,1.0,805.0,805.0
0.013,6,10,1989,5,910,3.0,642.0,642.0,5,1079,3.0,811.0,811.0
