flowDurationMilliseconds,protocolIdentifier,TotPackets,TotBytes,packetTotalCount,octetTotalCount,averageInterarrivalTime,maxPacketSize,bytesPerPacket,reversePacketTotalCount,reverseOctetTotalCount,reverseAverageInterarrivalTime,reverseMaxPacketSize,reverseBytesPerPacket
0.097,17,2,144,1,64,0.0,36.0,36.0,1,80,0.0,52.0,52.0
0.004,6,10,1779,5,928,1.0,660.0,660.0,5,851,1.0,583.0,583.0
0.069,17,2,80,1,32,0.0,4.0,4.0,1,48,0.0,20.0,20.0
0.005,6,10,2000,5,927,1.0,659.0,659.0,5,1073,1.0,805.0,805.0
0.005,6,10,1989,5,927,1.0,659.0,659.0,5,1062,1.0,794.0,794.0
0.011,6,10,1990,5,911,2.0,643.0,643.0,5,1079,2.0,811.0,811.0
0.034,6,10,1631,5,848,8.0,580.0,580.0,5,783,8.0,515.0,515.0
0.01,6,10,1989,5,910,2.0,642.0,642.0,5,1079,2.0,811.0,811.0
1787.316,6,150,19350,90,13740,20082.0,302.0,302.0,60,5610,30293.0,83.0,83.0
0.006,6,10,1547,5,764,1.0,496.0,496.0,5,783,1.0,515.0,515.0
0.005,17,2,178,1,81,0.0,53.0,53.0,1,97,0.0,69.0,69.0
10.942,17,28,4397,14,2312,833.0,587.0,137.0,14,2085,833.0,268.0,120.0
0.005,6,10,1779,5,928,1.0,660.0,660.0,5,851,1.0,583.0,583.0
0.138,6,10,1506,5,395,33.0,127.0,127.0,5,1111,31.0,843.0,843.0
0.009,6,12,1926,6,1189,1.0,659.0,434.0,6,737,1.0,417.0,417.0
0.004,17,2,152,1,76,0.0,48.0,48.0,1,76,0.0,48.0,48.0
0.011,6,10,1677,5,827,2.0,559.0,559.0,5,850,2.0,582.0,582.0
0.28,17,2,152,1,76,0.0,48.0,48.0,1,76,0.0,48.0,48.0
0.068,6,10,1506,5,395,15.0,127.0,127.0,5,1111,15.0,843.0,843.0
67.1,58,5,360,4,288,22366.0,24.0,24.0,1,72,0.0,24.0,24.0
0.004,6,10,2000,5,927,1.0,659.0,659.0,5,1073,1.0,805.0,805.0
0.006,17,2,136,1,60,0.0,32.0,32.0,1,76,0.0,48.0,48.0
0.004,17,2,148,1,60,0.0,32.0,32.0,1,88,0.0,60.0,60.0
0.005,6,10,2007,5,928,1.0,660.0,660.0,5,1079,1.0,811.0,811.0
240.123,6,16,4480,9,963,30015.0,238.0,166.0,7,3517,40018.0,1402.0,786.0
0.004,17,2,193,1,71,0.0,43.0,43.0,1,122,0.0,94.0,94.0
0.104,6,10,1506,5,395,24.0,127.0,127.0,5,1111,21.0,843.0,843.0
40.056,17,10,676,5,460,10012.0,104.0,64.0,5,216,10013.0,20.0,15.0
40.057,17,10,676,5,460,10011.0,104.0,64.0,5,216,10013.0,20.0,15.0
0.011,6,14,3787,7,497,1.0,125.0,125.0,7,3290,1.0,1448.0,972.0
0.006,17,2,194,1,57,0.0,29.0,29.0,1,137,0.0,109.0,109.0
0.007,6,10,1762,5,911,1.0,643.0,643.0,5,851,1.0,583.0,583.0
0.004,17,2,162,1,65,0.0,37.0,37.0,1,97,0.0,69.0,69.0
0.014,6,10,1631,5,848,3.0,580.0,580.0,5,783,3.0,515.0,515.0
0.005,17,2,170,1,65,0.0,37.0,37.0,1,105,0.0,77.0,77.0
0.044,6,10,1972,5,910,10.0,642.0,642.0,5,1062,11.0,794.0,794.0
0.005,6,10,2006,5,927,1.0,659.0,659.0,5,1079,1.0,811.0,811.0
0.005,6,10,2006,5,927,1.0,659.0,659.0,5,1079,1.0,811.0,811.0
0.005,17,2,144,1,64,0.0,36.0,36.0,1,80,0.0,52.0,52.0
0.13,17,4,284,2,120,0.0,32.0,32.0,2,164,126.0,60.0,54.0
40.06,17,10,676,5,460,10012.0,104.0,64.0,5,216,10013.0,20.0,15.0
0.009,6,10,1762,5,911,2.0,643.0,643.0,5,851,2.0,583.0,583.0
0.041,17,2,152,1,76,0.0,48.0,48.0,1,76,0.0,48.0,48.0
0.006,6,10,2000,5,927,1.0,659.0,659.0,5,1073,1.0,805.0,805.0
240.08,6,16,4481,9,963,30010.0,238.0,166.0,7,3518,40012.0,1402.0,786.0
240.017,6,9,787,5,488,60004.0,232.0,232.0,4,299,80005.0,83.0,83.0
0.073,6,10,1506,5,395,16.0,127.0,127.0,5,1111,15.0,843.0,843.0
0.005,17,2,164,1,74,0.0,46.0,46.0,1,90,0.0,62.0,62.0
1778.361,17,142,41232,72,22752,25047.0,288.0,288.0,70,18480,25773.0,236.0,236.0
0.004,6,10,1989,5,927,1.0,659.0,659.0,5,1062,1.0,794.0,794.0
0.006,6,10,1547,5,764,1.0,496.0,496.0,5,783,1.0,515.0,515.0
40.072,17,10,676,5,460,10015.0,104.0,64.0,5,216,10017.0,20.0,15.0
0.006,6,10,1547,5,764,1.0,496.0,496.0,5,783,1.0,515.0,515.0
0.005,6,10,2007,5,928,1.0,660.0,660.0,5,1079,1.0,811.0,811.0
0.015,6,10,1762,5,911,3.0,643.0,643.0,5,851,3.0,583.0,583.0
175.085,17,76,10740,38,2521,4731.0,44.0,38.0,38,8219,4731.0,239.0,188.0
0.005,6,10,2007,5,928,1.0,660.0,660.0,5,1079,1.0,811.0,811.0
0.139,17,2,80,1,32,0.0,4.0,4.0,1,48,0.0,20.0,20.0
371.357,6,24,2405,17,919,23209.0,195.0,195.0,7,1486,3918.0,419.0,398.0
0.011,6,10,1989,5,910,2.0,642.0,642.0,5,1079,2.0,811.0,811.0
0.042,17,2,184,1,61,0.0,33.0,33.0,1,123,0.0,95.0,95.0
0.006,6,10,1547,5,764,1.0,496.0,496.0,5,783,1.0,515.0,515.0
0.012,6,10,1854,5,889,2.0,621.0,621.0,5,965,2.0,697.0,697.0
0.011,6,10,1989,5,910,2.0,642.0,642.0,5,1079,2.0,811.0,811.0
0.005,17,4,284,2,120,2.0,32.0,32.0,2,164,1.0,60.0,54.0
0.001,17,2,180,1,66,0.0,38.0,38.0,1,114,0.0,86.0,86.0
0.004,6,10,2006,5,927,1.0,659.0,659.0,5,1079,1.0,811.0,811.0
0.005,6,10,1989,5,927,1.0,659.0,659.0,5,1062,1.0,794.0,794.0
240.094,6,40,7107,19,3343,13338.0,880.0,333.0,21,3764,12004.0,1306.0,296.0
0.005,6,10,1989,5,927,1.0,659.0,659.0,5,1062,1.0,794.0,794.0
0.023,6,10,1972,5,910,5.0,642.0,642.0,5,1062,5.0,794.0,794.0
0.005,6,14,3799,7,509,0.0,137.0,137.0,7,3290,0.0,1448.0,972.0
0.114,6,10,1506,5,395,27.0,127.0,127.0,5,1111,25.0,843.0,843.0
0.014,6,10,1983,5,910,3.0,642.0,642.0,5,1073,3.0,805.0,805.0
0.005,6,10,1643,5,860,1.0,592.0,592.0,5,783,1.0,515.0,515.0
0.006,6,10,1547,5,764,1.0,496.0,496.0,5,783,1.0,515.0,515.0
0.041,17,4,284,2,120,0.0,32.0,32.0,2,164,37.0,60.0,54.0
0.007,17,2,132,1,58,0.0,30.0,30.0,1,74,0.0,46.0,46.0
40.065,17,10,676,5,460,10014.0,104.0,64.0,5,216,10015.0,20.0,15.0
0.087,6,10,1506,5,395,20.0,127.0,127.0,5,1111,17.0,843.0,843.0
0.008,6,10,1677,5,827,2.0,559.0,559.0,5,850,1.0,582.0,582.0
0.006,17,2,146,1,65,0.0,37.0,37.0,1,81,0.0,53.0,53.0
40.06,17,10,676,5,460,10012.0,104.0,64.0,5,216,10013.0,20.0,15.0
0.137,6,10,1506,5,395,30.0,127.0,127.0,5,1111,31.0,843.0,843.0
0.005,6,10,1689,5,839,1.0,571.0,571.0,5,850,1.0,582.0,582.0
0.062,6,10,1506,5,395,13.0,127.0,127.0,5,1111,14.0,843.0,843.0
0.001,17,2,166,1,75,0.0,47.0,47.0,1,91,0.0,63.0,63.0
0.115,6,10,1506,5,395,25.0,127.0,127.0,5,1111,25.0,843.0,843.0
0.006,6,10,1547,5,764,1.0,496.0,496.0,5,783,1.0,515.0,515.0
0.007,6,10,1990,5,911,1.0,643.0,643.0,5,1079,1.0,811.0,811.0
309.924,17,20,1124,10,716,34421.0,48.0,43.0,10,408,34421.0,20.0,12.0
0.005,17,2,166,1,75,0.0,47.0,47.0,1,91,0.0,63.0,63.0
0.007,6,10,1547,5,764,1.0,496.0,496.0,5,783,1.0,515.0,515.0
0.001,17,2,136,1,60,0.0,32.0,32.0,1,76,0.0,48.0,48.0
0.006,6,10,1547,5,764,1.0,496.0,496.0,5,783,1.0,515.0,515.0
0.065,6,10,1506,5,395,14.0,127.0,127.0,5,1111,14.0,843.0,843.0
0.006,6,10,1547,5,764,1.0,496.0,496.0,5,783,1.0,515.0,515.0
0.02,6,10,1990,5,911,5.0,643.0,643.0,5,1079,5.0,811.0,811.0
0.001,17,2,180,1,66,0.0,38.0,38.0,1,114,0.0,86.0,86.0
0.023,6,10,1990,5,911,5.0,643.0,643.0,5,1079,5.0,811.0,811.0
0.012,6,10,1990,5,911,3.0,643.0,643.0,5,1079,2.0,811.0,811.0
0.131,6,10,1506,5,395,30.0,127.0,127.0,5,1111,28.0,843.0,843.0
0.106,6,10,1506,5,395,25.0,127.0,127.0,5,1111,22.0,843.0,843.0
0.001,17,2,180,1,66,0.0,38.0,38.0,1,114,0.0,86.0,86.0
0.013,6,10,1990,5,911,3.0,643.0,643.0,5,1079,3.0,811.0,811.0
40.063,17,10,676,5,460,10015.0,104.0,64.0,5,216,10014.0,20.0,15.0
0.001,17,2,180,1,66,0.0,38.0,38.0,1,114,0.0,86.0,86.0
0.013,6,10,1990,5,911,3.0,643.0,643.0,5,1079,3.0,811.0,811.0
106.597,6,33,11259,18,5559,6270.0,1368.0,659.0,15,5700,7613.0,1656.0,816.0
0.004,6,10,2006,5,927,1.0,659.0,659.0,5,1079,1.0,811.0,811.0
0.006,6,10,1547,5,764,1.0,496.0,496.0,5,783,1.0,515.0,515.0
0.004,6,10,1702,5,863,1.0,595.0,595.0,5,839,0.0,571.0,571.0
0.009,6,10,1762,5,911,2.0,643.0,643.0,5,851,2.0,583.0,583.0
240.099,6,16,4482,9,963,30012.0,238.0,166.0,7,3519,40015.0,1402.0,786.0
0.06,6,10,1506,5,395,14.0,127.0,127.0,5,1111,13.0,843.0,843.0
0.129,17,2,80,1,32,0.0,4.0,4.0,1,48,0.0,20.0,20.0
0.119,6,10,1506,5,395,25.0,127.0,127.0,5,1111,25.0,843.0,843.0
0.006,17,2,166,1,75,0.0,47.0,47.0,1,91,0.0,63.0,63.0
325.36,17,20,1124,10,716,36137.0,48.0,43.0,10,408,36137.0,20.0,12.0
0.016,6,10,1677,5,827,4.0,559.0,559.0,5,850,3.0,582.0,582.0
0.131,17,2,80,1,32,0.0,4.0,4.0,1,48,0.0,20.0,20.0
293.168,6,321,343905,119,17738,2484.0,2736.0,825.0,202,326167,1458.0,2804.0,1679.0
0.013,6,13,3735,7,497,2.0,125.0,125.0,6,3238,2.0,1470.0,1459.0
0.005,6,10,1989,5,927,1.0,659.0,659.0,5,1062,1.0,794.0,794.0
15.081,17,16,8219,8,6021,2150.0,1350.0,724.0,8,2198,2150.0,1350.0,246.0
40.063,17,10,676,5,460,10012.0,104.0,64.0,5,216,10015.0,20.0,15.0
0.015,6,10,1990,5,911,3.0,643.0,643.0,5,1079,3.0,811.0,811.0
0.004,17,4,284,2,120,0.0,32.0,32.0,2,164,1.0,60.0,54.0
0.091,6,10,1506,5,395,20.0,127.0,127.0,5,1111,19.0,843.0,843.0
0.004,17,4,284,2,120,1.0,32.0,32.0,2,164,0.0,60.0,54.0
0.004,17,4,284,2,120,0.0,32.0,32.0,2,164,0.0,60.0,54.0
0.009,6,12,1926,6,1189,1.0,659.0,434.0,6,737,1.0,417.0,417.0
0.013,6,10,1990,5,911,3.0,643.0,643.0,5,1079,3.0,811.0,811.0
290.374,6,374,347584,189,21394,1544.0,2736.0,889.0,185,326190,1578.0,2804.0,1851.0
0.004,6,10,1702,5,863,1.0,595.0,595.0,5,839,0.0,571.0,571.0
40.092,17,10,676,5,460,10022.0,104.0,64.0,5,216,10022.0,20.0,15.0
0.006,6,10,1854,5,889,1.0,621.0,621.0,5,965,1.0,697.0,697.0
0.004,17,4,284,2,120,1.0,32.0,32.0,2,164,0.0,60.0,54.0
0.011,6,14,3787,7,497,1.0,125.0,125.0,7,3290,1.0,1448.0,972.0
0.006,6,10,1689,5,839,1.0,571.0,571.0,5,850,1.0,582.0,582.0
0.068,17,8,3613,4,1874,22.0,1350.0,440.0,4,1739,11.0,1350.0,406.0
310.309,6,36,10449,19,2737,17239.0,662.0,345.0,17,7712,15645.0,1402.0,682.0
313.365,17,20,1124,10,716,34804.0,48.0,43.0,10,408,34804.0,20.0,12.0
0.004,6,10,2006,5,927,1.0,659.0,659.0,5,1079,1.0,811.0,811.0
40.074,17,10,676,5,460,10017.0,104.0,64.0,5,216,10017.0,20.0,15.0
31.504,6,36,15362,19,3186,1750.0,1004.0,432.0,17,12176,1968.0,2804.0,1252.0
0.039,17,2,184,1,61,0.0,33.0,33.0,1,123,0.0,95.0,95.0
0.004,6,10,1702,5,863,1.0,595.0,595.0,5,839,0.0,571.0,571.0
0.006,17,2,299,1,65,0.0,37.0,37.0,1,234,0.0,206.0,206.0
178.102,17,78,10857,39,2592,4686.0,44.0,38.0,39,8265,4686.0,239.0,183.0
0.004,6,10,2006,5,927,1.0,659.0,659.0,5,1079,1.0,811.0,811.0
0.095,6,10,1506,5,395,20.0,127.0,127.0,5,1111,19.0,843.0,843.0
0.005,17,2,214,1,75,0.0,47.0,47.0,1,139,0.0,111.0,111.0
0.02,6,13,3735,7,497,3.0,125.0,125.0,6,3238,3.0,1470.0,1459.0
0.163,17,2,152,1,76,0.0,48.0,48.0,1,76,0.0,48.0,48.0
0.025,6,10,1983,5,910,6.0,642.0,642.0,5,1073,6.0,805.0,805.0
0.011,6,10,1989,5,910,2.0,642.0,642.0,5,1079,2.0,811.0,811.0
0.129,17,2,184,1,61,0.0,33.0,33.0,1,123,0.0,95.0,95.0
0.019,6,10,1677,5,827,4.0,559.0,559.0,5,850,4.0,582.0,582.0
0.006,6,10,1547,5,764,1.0,496.0,496.0,5,783,1.0,515.0,515.0
0.123,6,10,1506,5,395,25.0,127.0,127.0,5,1111,27.0,843.0,843.0
0.01,6,10,1983,5,910,2.0,642.0,642.0,5,1073,2.0,805.0,805.0
0.006,6,13,3747,7,509,0.0,137.0,137.0,6,3238,1.0,1470.0,1459.0
40.08,17,10,676,5,460,10017.0,104.0,64.0,5,216,10019.0,20.0,15.0
0.005,6,10,2006,5,927,1.0,659.0,659.0,5,1079,1.0,811.0,811.0
240.325,6,41,9077,20,2856,12647.0,708.0,258.0,21,6221,12014.0,2379.0,569.0
0.005,6,10,2006,5,927,1.0,659.0,659.0,5,1079,1.0,811.0,811.0
0.012,6,10,2007,5,928,3.0,660.0,660.0,5,1079,3.0,811.0,811.0
0.005,6,10,2007,5,928,1.0,660.0,660.0,5,1079,1.0,811.0,811.0
0.005,6,10,2007,5,928,1.0,660.0,660.0,5,1079,1.0,811.0,811.0
0.22,6,16,2778,8,1396,31.0,533.0,324.0,8,1382,20.0,529.0,239.0
387.946,6,22,2313,16,867,25863.0,195.0,195.0,6,1446,4646.0,419.0,398.0
253.251,6,39,9685,16,6554,16883.0,1625.0,636.0,23,3131,11511.0,580.0,137.0
0.004,6,10,1989,5,927,1.0,659.0,659.0,5,1062,1.0,794.0,794.0
0.004,17,2,136,1,60,0.0,32.0,32.0,1,76,0.0,48.0,48.0
0.101,6,10,1506,5,395,23.0,127.0,127.0,5,1111,23.0,843.0,843.0
0.006,6,10,1547,5,764,1.0,496.0,496.0,5,783,1.0,515.0,515.0
0.005,17,2,140,1,62,0.0,34.0,34.0,1,78,0.0,50.0,50.0
0.011,6,10,1983,5,910,2.0,642.0,642.0,5,1073,2.0,805.0,805.0
0.04,17,2,182,1,65,0.0,37.0,37.0,1,117,0.0,89.0,89.0
0.094,6,10,1506,5,395,19.0,127.0,127.0,5,1111,22.0,843.0,843.0
0.071,6,10,1506,5,395,15.0,127.0,127.0,5,1111,15.0,843.0,843.0
0.011,6,10,1990,5,911,2.0,643.0,643.0,5,1079,2.0,811.0,811.0
0.005,6,10,1989,5,927,1.0,659.0,659.0,5,1062,1.0,794.0,794.0
0.075,6,10,1506,5,395,16.0,127.0,127.0,5,1111,17.0,843.0,843.0
0.092,6,10,1506,5,395,21.0,127.0,127.0,5,1111,21.0,843.0,843.0
0.006,17,2,166,1,75,0.0,47.0,47.0,1,91,0.0,63.0,63.0
0.096,6,10,1506,5,395,22.0,127.0,127.0,5,1111,21.0,843.0,843.0
0.145,6,10,1506,5,395,34.0,127.0,127.0,5,1111,30.0,843.0,843.0
0.181,6,44,11551,24,3222,7.0,1022.0,197.0,20,8329,9.0,1402.0,606.0
0.106,6,10,1506,5,395,24.0,127.0,127.0,5,1111,23.0,843.0,843.0
0.004,6,10,2006,5,927,1.0,659.0,659.0,5,1079,1.0,811.0,811.0
0.004,17,2,214,1,75,0.0,47.0,47.0,1,139,0.0,111.0,111.0
40.059,17,10,676,5,460,10013.0,104.0,64.0,5,216,10014.0,20.0,15.0
0.013,6,10,1983,5,910,3.0,642.0,642.0,5,1073,3.0,805.0,805.0
0.005,6,10,2007,5,928,1.0,660.0,660.0,5,1079,1.0,811.0,811.0
0.073,17,8,3613,4,1874,24.0,1350.0,440.0,4,1739,11.0,1350.0,406.0
0.005,6,10,1989,5,927,1.0,659.0,659.0,5,1062,1.0,794.0,794.0
0.012,6,10,1989,5,910,3.0,642.0,642.0,5,1079,3.0,811.0,811.0
0.01,6,10,1631,5,848,2.0,580.0,580.0,5,783,2.0,515.0,515.0
0.004,17,4,284,2,120,0.0,32.0,32.0,2,164,1.0,60.0,54.0
172.148,17,70,9968,35,2331,5062.0,44.0,38.0,35,7637,5063.0,261.0,190.0
0.006,6,10,1547,5,764,1.0,496.0,496.0,5,783,1.0,515.0,515.0
1747.16,6,543,187300,277,162802,6330.0,2883.0,916.0,266,24498,6593.0,387.0,106.0
0.013,6,10,1990,5,911,3.0,643.0,643.0,5,1079,3.0,811.0,811.0
0.006,6,10,1989,5,927,1.0,659.0,659.0,5,1062,1.0,794.0,794.0
0.015,6,10,1990,5,911,3.0,643.0,643.0,5,1079,3.0,811.0,811.0
0.005,6,10,2000,5,927,1.0,659.0,659.0,5,1073,1.0,805.0,805.0
0.076,6,10,1506,5,395,18.0,127.0,127.0,5,1111,16.0,843.0,843.0
0.005,6,10,2006,5,927,1.0,659.0,659.0,5,1079,1.0,811.0,811.0
0.081,6,10,1506,5,395,15.0,127.0,127.0,5,1111,17.0,843.0,843.0
0.005,6,10,2000,5,927,1.0,659.0,659.0,5,1073,1.0,805.0,805.0
0.004,17,4,284,2,120,1.0,32.0,32.0,2,164,0.0,60.0,54.0
0.074,6,10,1506,5,395,18.0,127.0,127.0,5,1111,16.0,843.0,843.0
0.078,6,10,1506,5,395,17.0,127.0,127.0,5,1111,18.0,843.0,843.0
0.001,17,2,180,1,66,0.0,38.0,38.0,1,114,0.0,86.0,86.0
0.014,6,10,1631,5,848,3.0,580.0,580.0,5,783,3.0,515.0,515.0
0.041,17,2,152,1,76,0.0,48.0,48.0,1,76,0.0,48.0,48.0
0.005,6,10,2006,5,927,1.0,659.0,659.0,5,1079,1.0,811.0,811.0
0.003,17,2,136,1,60,0.0,32.0,32.0,1,76,0.0,48.0,48.0
0.008,6,12,1926,6,1189,1.0,659.0,434.0,6,737,1.0,417.0,417.0
11.172,17,28,4423,14,1995,847.0,270.0,114.0,14,2428,847.0,587.0,145.0
0.005,6,10,1547,5,764,1.0,496.0,496.0,5,783,1.0,515.0,515.0
0.012,6,10,1972,5,910,3.0,642.0,642.0,5,1062,3.0,794.0,794.0
0.01,6,10,1989,5,910,2.0,642.0,642.0,5,1079,2.0,811.0,811.0
173.438,17,82,11931,41,2749,4335.0,44.0,39.0,41,9182,4335.0,258.0,195.0
0.001,17,2,166,1,75,0.0,47.0,47.0,1,91,0.0,63.0,63.0
0.006,17,2,166,1,75,0.0,47.0,47.0,1,91,0.0,63.0,63.0
240.117,6,34,9367,18,7056,14124.0,2024.0,680.0,16,2311,16007.0,580.0,183.0
0.039,17,2,184,1,61,0.0,33.0,33.0,1,123,0.0,95.0,95.0
0.249,17,44,24482,24,21179,10.0,1350.0,854.0,20,3303,9.0,1350.0,137.0
0.009,6,10,1990,5,911,2.0,643.0,643.0,5,1079,2.0,811.0,811.0
0.006,6,10,1689,5,839,1.0,571.0,571.0,5,850,1.0,582.0,582.0
40.06,17,10,676,5,460,10012.0,104.0,64.0,5,216,10014.0,20.0,15.0
0.005,17,2,164,1,74,0.0,46.0,46.0,1,90,0.0,62.0,62.0
0.01,6,10,1762,5,911,2.0,643.0,643.0,5,851,2.0,583.0,583.0
0.001,17,2,166,1,75,0.0,47.0,47.0,1,91,0.0,63.0,63.0
0.006,17,2,144,1,64,0.0,36.0,36.0,1,80,0.0,52.0,52.0
0.004,6,10,1989,5,927,1.0,659.0,659.0,5,1062,1.0,794.0,794.0
0.005,6,10,2007,5,928,1.0,660.0,660.0,5,1079,1.0,811.0,811.0
0.012,6,10,2006,5,927,3.0,659.0,659.0,5,1079,2.0,811.0,811.0
0.005,6,10,2007,5,928,1.0,660.0,660.0,5,1079,1.0,811.0,811.0
290.548,6,379,347859,195,21713,1497.0,2694.0,889.0,184,326146,1587.0,2849.0,1862.0
300.309,6,27,7436,16,1409,20020.0,217.0,142.0,11,6027,24029.0,1679.0,778.0
0.005,17,2,179,1,71,0.0,43.0,43.0,1,108,0.0,80.0,80.0
0.003,17,2,136,1,60,0.0,32.0,32.0,1,76,0.0,48.0,48.0
0.001,17,2,136,1,60,0.0,32.0,32.0,1,76,0.0,48.0,48.0
0.068,6,10,1506,5,395,15.0,127.0,127.0,5,1111,15.0,843.0,843.0
0.003,17,2,136,1,60,0.0,32.0,32.0,1,76,0.0,48.0,48.0
1741.796,6,308,98117,191,86695,9167.0,1402.0,673.0,117,11422,15015.0,452.0,71.0
0.005,17,2,166,1,75,0.0,47.0,47.0,1,91,0.0,63.0,63.0
40.055,17,10,676,5,460,10012.0,104.0,64.0,5,216,10013.0,20.0,15.0
0.005,6,10,2006,5,927,1.0,659.0,659.0,5,1079,1.0,811.0,811.0
1799.249,17,3192,244416,1586,128475,1135.0,84.0,53.0,1606,115941,1120.0,227.0,44.0
173.092,6,21,8144,11,1985,84.0,1174.0,504.0,10,6159,19213.0,2720.0,957.0
0.001,17,2,179,1,62,0.0,34.0,34.0,1,117,0.0,89.0,89.0
0.005,17,2,193,1,71,0.0,43.0,43.0,1,122,0.0,94.0,94.0
0.02,17,2,180,1,66,0.0,38.0,38.0,1,114,0.0,86.0,86.0
0.016,6,10,1989,5,910,3.0,642.0,642.0,5,1079,3.0,811.0,811.0
0.02,6,10,1972,5,910,4.0,642.0,642.0,5,1062,4.0,794.0,794.0
0.023,17,4,284,2,120,0.0,32.0,32.0,2,164,0.0,60.0,54.0
0.005,6,13,3747,7,509,0.0,137.0,137.0,6,3238,0.0,1470.0,1459.0
0.005,17,2,140,1,62,0.0,34.0,34.0,1,78,0.0,50.0,50.0
0.027,6,10,1677,5,827,6.0,559.0,559.0,5,850,6.0,582.0,582.0
0.14,6,14,4388,8,923,20.0,238.0,166.0,6,3465,20.0,1402.0,786.0
0.015,6,10,1989,5,910,3.0,642.0,642.0,5,1079,3.0,811.0,811.0
0.005,6,10,2006,5,927,1.0,659.0,659.0,5,1079,1.0,811.0,811.0
0.214,6,16,2670,8,1396,30.0,533.0,324.0,8,1274,19.0,529.0,212.0
0.008,6,10,2006,5,927,2.0,659.0,659.0,5,1079,1.0,811.0,811.0
0.0,17,2,136,1,60,0.0,32.0,32.0,1,76,0.0,48.0,48.0
0.049,6,13,3816,7,578,8.0,206.0,206.0,6,3238,9.0,1470.0,1459.0
15.071,17,14,9190,8,6902,2148.0,1350.0,834.0,6,2288,3008.0,1350.0,353.0
0.005,17,2,148,1,60,0.0,32.0,32.0,1,88,0.0,60.0,60.0
0.014,6,10,1762,5,911,3.0,643.0,643.0,5,851,3.0,583.0,583.0
0.009,6,10,1972,5,910,2.0,642.0,642.0,5,1062,2.0,794.0,794.0
0.11,6,10,1506,5,395,24.0,127.0,127.0,5,1111,24.0,843.0,843.0
0.076,6,10,1506,5,395,16.0,127.0,127.0,5,1111,16.0,843.0,843.0
40.053,17,10,676,5,460,10012.0,104.0,64.0,5,216,10012.0,20.0,15.0
0.076,6,10,1506,5,395,17.0,127.0,127.0,5,1111,16.0,843.0,843.0
0.106,6,10,1506,5,395,23.0,127.0,127.0,5,1111,26.0,843.0,843.0
0.004,6,10,2007,5,928,1.0,660.0,660.0,5,1079,1.0,811.0,811.0
0.005,6,10,1989,5,927,1.0,659.0,659.0,5,1062,1.0,794.0,794.0
0.011,6,10,1989,5,910,2.0,642.0,642.0,5,1079,2.0,811.0,811.0
0.016,6,10,1990,5,911,3.0,643.0,643.0,5,1079,3.0,811.0,811.0
0.001,17,2,180,1,66,0.0,38.0,38.0,1,114,0.0,86.0,86.0
0.005,6,10,1779,5,928,1.0,660.0,660.0,5,851,1.0,583.0,583.0
0.069,6,10,1506,5,395,15.0,127.0,127.0,5,1111,14.0,843.0,843.0
0.005,6,10,2007,5,928,1.0,660.0,660.0,5,1079,1.0,811.0,811.0
0.001,17,2,154,1,69,0.0,41.0,41.0,1,85,0.0,57.0,57.0
0.006,6,10,1547,5,764,1.0,496.0,496.0,5,783,1.0,515.0,515.0
0.005,6,13,3747,7,509,0.0,137.0,137.0,6,3238,0.0,1470.0,1459.0
0.01,6,10,1983,5,910,2.0,642.0,642.0,5,1073,2.0,805.0,805.0
0.053,17,2,152,1,76,0.0,48.0,48.0,1,76,0.0,48.0,48.0
0.005,6,10,2007,5,928,1.0,660.0,660.0,5,1079,1.0,811.0,811.0
0.005,17,2,160,1,64,0.0,36.0,36.0,1,96,0.0,68.0,68.0
11.1,17,28,4397,14,2311,845.0,586.0,137.0,14,2086,845.0,269.0,121.0
40.056,17,10,676,5,460,10013.0,104.0,64.0,5,216,10013.0,20.0,15.0
0.004,17,2,148,1,60,0.0,32.0,32.0,1,88,0.0,60.0,60.0
0.005,6,10,1989,5,927,1.0,659.0,659.0,5,1062,1.0,794.0,794.0
0.01,6,10,1989,5,910,2.0,642.0,642.0,5,1079,2.0,811.0,811.0
0.019,6,10,1677,5,827,4.0,559.0,559.0,5,850,4.0,582.0,582.0
0.014,6,10,1989,5,910,3.0,642.0,642.0,5,1079,3.0,811.0,811.0
0.004,6,10,2007,5,928,1.0,660.0,660.0,5,1079,1.0,811.0,811.0
0.008,6,10,1702,5,863,1.0,595.0,595.0,5,839,2.0,571.0,571.0
0.009,6,10,1989,5,910,2.0,642.0,642.0,5,1079,2.0,811.0,811.0
0.004,17,2,136,1,60,0.0,32.0,32.0,1,76,0.0,48.0,48.0
0.013,6,10,1972,5,910,3.0,642.0,642.0,5,1062,3.0,794.0,794.0
0.085,6,10,1506,5,395,19.0,127.0,127.0,5,1111,18.0,843.0,843.0
0.006,6,10,1547,5,764,1.0,496.0,496.0,5,783,1.0,515.0,515.0
0.006,6,13,3747,7,509,1.0,137.0,137.0,6,3238,1.0,1470.0,1459.0
40.066,17,10,676,5,460,10015.0,104.0,64.0,5,216,10015.0,20.0,15.0
0.076,17,2,182,1,65,0.0,37.0,37.0,1,117,0.0,89.0,89.0
0.006,6,10,1689,5,839,1.0,571.0,571.0,5,850,1.0,582.0,582.0
0.018,6,10,1990,5,911,4.0,643.0,643.0,5,1079,4.0,811.0,811.0
0.074,6,10,1506,5,395,16.0,127.0,127.0,5,1111,14.0,843.0,843.0
0.009,6,10,1972,5,910,2.0,642.0,642.0,5,1062,2.0,794.0,794.0
0.011,6,13,3735,7,497,1.0,125.0,125.0,6,3238,2.0,1470.0,1459.0
0.015,6,13,3735,7,497,2.0,125.0,125.0,6,3238,3.0,1470.0,1459.0
0.005,6,10,2000,5,927,1.0,659.0,659.0,5,1073,1.0,805.0,805.0
0.006,6,10,1547,5,764,1.0,496.0,496.0,5,783,1.0,515.0,515.0
316.171,17,20,1124,10,716,35115.0,48.0,43.0,10,408,35115.0,20.0,12.0
0.009,6,12,1926,6,1189,1.0,659.0,434.0,6,737,1.0,417.0,417.0
0.006,17,2,169,1,62,0.0,34.0,34.0,1,107,0.0,79.0,79.0
0.012,6,10,1990,5,911,3.0,643.0,643.0,5,1079,3.0,811.0,811.0
0.005,6,10,2000,5,927,1.0,659.0,659.0,5,1073,1.0,805.0,805.0
0.038,17,4,284,2,120,0.0,32.0,32.0,2,164,35.0,60.0,54.0
0.005,6,10,2000,5,927,1.0,659.0,659.0,5,1073,1.0,805.0,805.0
0.004,17,2,186,1,61,0.0,33.0,33.0,1,125,0.0,97.0,97.0
0.005,17,2,225,1,65,0.0,37.0,37.0,1,160,0.0,132.0,132.0
0.074,6,10,1506,5,395,17.0,127.0,127.0,5,1111,16.0,843.0,843.0
0.007,6,10,1547,5,764,1.0,496.0,496.0,5,783,1.0,515.0,515.0
0.097,6,10,1506,5,395,21.0,127.0,127.0,5,1111,20.0,843.0,843.0
0.007,17,2,179,1,71,0.0,43.0,43.0,1,108,0.0,80.0,80.0
0.094,6,10,1506,5,395,19.0,127.0,127.0,5,1111,21.0,843.0,843.0
0.015,6,10,1983,5,910,3.0,642.0,642.0,5,1073,3.0,805.0,805.0
0.041,17,2,186,1,61,0.0,33.0,33.0,1,125,0.0,97.0,97.0
300.118,6,38,9637,20,4119,15787.0,1543.0,657.0,18,5518,17644.0,2667.0,435.0
0.005,6,10,2000,5,927,1.0,659.0,659.0,5,1073,1.0,805.0,805.0
301.018,6,47,17775,25,11868,12542.0,2720.0,1204.0,22,5907,421.0,2667.0,385.0
0.003,17,4,284,2,120,0.0,32.0,32.0,2,164,0.0,60.0,54.0
0.002,17,2,152,1,76,0.0,48.0,48.0,1,76,0.0,48.0,48.0
0.006,17,2,230,1,68,0.0,40.0,40.0,1,162,0.0,134.0,134.0
0.161,17,2,152,1,76,0.0,48.0,48.0,1,76,0.0,48.0,48.0
0.011,6,10,1990,5,911,2.0,643.0,643.0,5,1079,2.0,811.0,811.0
0.099,6,10,1506,5,395,22.0,127.0,127.0,5,1111,21.0,843.0,843.0
0.004,17,2,194,1,59,0.0,31.0,31.0,1,135,0.0,107.0,107.0
326.548,6,19,2158,6,1308,12003.0,494.0,494.0,13,850,27212.0,83.0,83.0
0.011,6,10,1762,5,911,2.0,643.0,643.0,5,851,2.0,583.0,583.0
0.005,6,10,2006,5,927,1.0,659.0,659.0,5,1079,1.0,811.0,811.0
0.013,6,10,1990,5,911,3.0,643.0,643.0,5,1079,3.0,811.0,811.0
0.006,6,10,1547,5,764,1.0,496.0,496.0,5,783,1.0,515.0,515.0
0.016,17,2,179,1,71,0.0,43.0,43.0,1,108,0.0,80.0,80.0
0.007,6,10,1989,5,927,1.0,659.0,659.0,5,1062,1.0,794.0,794.0
0.006,6,10,1779,5,928,1.0,660.0,660.0,5,851,1.0,583.0,583.0
0.005,17,2,168,1,76,0.0,48.0,48.0,1,92,0.0,64.0,64.0
0.02,6,10,1972,5,910,5.0,642.0,642.0,5,1062,5.0,794.0,794.0
0.009,6,10,1989,5,910,2.0,642.0,642.0,5,1079,2.0,811.0,811.0
0.087,6,10,1506,5,395,19.0,127.0,127.0,5,1111,19.0,843.0,843.0
0.008,6,12,1926,6,1189,1.0,659.0,434.0,6,737,1.0,417.0,417.0
0.011,6,10,1989,5,910,2.0,642.0,642.0,5,1079,2.0,811.0,811.0
0.005,6,10,2006,5,927,1.0,659.0,659.0,5,1079,1.0,811.0,811.0
329.178,17,20,1124,10,716,36561.0,48.0,43.0,10,408,36561.0,20.0,12.0
0.006,6,10,1689,5,839,1.0,571.0,571.0,5,850,1.0,582.0,582.0
10.829,17,28,4421,14,1993,824.0,268.0,114.0,14,2428,824.0,587.0,145.0
0.011,6,10,1677,5,827,2.0,559.0,559.0,5,850,2.0,582.0,582.0
264.9,17,18,1008,9,640,33099.0,48.0,43.0,9,368,33103.0,20.0,12.0
0.017,6,10,1990,5,911,4.0,643.0,643.0,5,1079,4.0,811.0,811.0
0.008,6,10,1990,5,911,2.0,643.0,643.0,5,1079,1.0,811.0,811.0
0.128,6,10,1506,5,395,24.0,127.0,127.0,5,1111,28.0,843.0,843.0
0.097,6,10,1506,5,395,21.0,127.0,127.0,5,1111,20.0,843.0,843.0
0.007,6,10,1689,5,839,1.0,571.0,571.0,5,850,1.0,582.0,582.0
0.006,6,12,1698,6,863,1.0,327.0,271.0,6,835,1.0,515.0,515.0
0.041,17,2,412,1,61,0.0,33.0,33.0,1,351,0.0,323.0,323.0
0.005,6,10,1989,5,927,1.0,659.0,659.0,5,1062,1.0,794.0,794.0
0.013,6,10,1631,5,848,3.0,580.0,580.0,5,783,3.0,515.0,515.0
0.006,6,10,1547,5,764,1.0,496.0,496.0,5,783,1.0,515.0,515.0
0.083,6,10,1506,5,395,18.0,127.0,127.0,5,1111,16.0,843.0,843.0
0.005,6,10,2007,5,928,1.0,660.0,660.0,5,1079,1.0,811.0,811.0
0.004,17,4,284,2,120,1.0,32.0,32.0,2,164,1.0,60.0,54.0
0.014,6,10,1989,5,910,3.0,642.0,642.0,5,1079,3.0,811.0,811.0
0.004,17,2,148,1,60,0.0,32.0,32.0,1,88,0.0,60.0,60.0
0.142,17,2,80,1,32,0.0,4.0,4.0,1,48,0.0,20.0,20.0
0.007,6,10,1547,5,764,1.0,496.0,496.0,5,783,1.0,515.0,515.0
0.002,17,2,180,1,66,0.0,38.0,38.0,1,114,0.0,86.0,86.0
0.116,6,10,1506,5,395,26.0,127.0,127.0,5,1111,26.0,843.0,843.0
0.008,6,12,1926,6,1189,1.0,659.0,434.0,6,737,1.0,417.0,417.0
0.021,17,4,284,2,120,1.0,32.0,32.0,2,164,0.0,60.0,54.0
0.014,6,14,3787,7,497,2.0,125.0,125.0,7,3290,2.0,1448.0,972.0
0.003,17,2,136,1,60,0.0,32.0,32.0,1,76,0.0,48.0,48.0
0.094,6,10,1506,5,395,21.0,127.0,127.0,5,1111,20.0,843.0,843.0
40.093,17,10,676,5,460,10022.0,104.0,64.0,5,216,10022.0,20.0,15.0
0.09,6,10,1506,5,395,18.0,127.0,127.0,5,1111,20.0,843.0,843.0
0.005,6,13,3747,7,509,0.0,137.0,137.0,6,3238,0.0,1470.0,1459.0
294.372,6,301,342806,119,17747,2494.0,2736.0,889.0,182,325059,1626.0,2804.0,1867.0
0.164,17,2,152,1,76,0.0,48.0,48.0,1,76,0.0,48.0,48.0
0.012,6,10,1972,5,910,3.0,642.0,642.0,5,1062,2.0,794.0,794.0
0.007,6,10,1547,5,764,1.0,496.0,496.0,5,783,1.0,515.0,515.0
240.09,6,16,4481,9,963,30011.0,238.0,166.0,7,3518,40014.0,1402.0,786.0
0.044,17,2,152,1,76,0.0,48.0,48.0,1,76,0.0,48.0,48.0
0.015,6,10,1989,5,910,3.0,642.0,642.0,5,1079,3.0,811.0,811.0
173.111,17,82,11503,41,2727,4327.0,44.0,38.0,41,8776,4327.0,239.0,186.0
0.109,6,10,1506,5,395,24.0,127.0,127.0,5,1111,23.0,843.0,843.0
0.035,17,2,152,1,76,0.0,48.0,48.0,1,76,0.0,48.0,48.0
0.073,6,10,1506,5,395,17.0,127.0,127.0,5,1111,17.0,843.0,843.0
40.059,17,10,676,5,460,10013.0,104.0,64.0,5,216,10005.0,20.0,15.0
0.005,6,10,1689,5,839,1.0,571.0,571.0,5,850,1.0,582.0,582.0
0.006,6,10,1547,5,764,1.0,496.0,496.0,5,783,1.0,515.0,515.0
0.007,6,10,1762,5,911,1.0,643.0,643.0,5,851,1.0,583.0,583.0
0.012,6,13,3735,7,497,1.0,125.0,125.0,6,3238,2.0,1470.0,1459.0
0.009,6,10,1990,5,911,2.0,643.0,643.0,5,1079,2.0,811.0,811.0
0.016,6,10,1989,5,910,4.0,642.0,642.0,5,1079,3.0,811.0,811.0
0.007,6,10,1989,5,910,1.0,642.0,642.0,5,1079,1.0,811.0,811.0
0.005,17,2,170,1,65,0.0,37.0,37.0,1,105,0.0,77.0,77.0
0.004,6,10,2007,5,928,1.0,660.0,660.0,5,1079,1.0,811.0,811.0
0.01,6,10,1972,5,910,2.0,642.0,642.0,5,1062,2.0,794.0,794.0
0.098,6,10,1506,5,395,22.0,127.0,127.0,5,1111,21.0,843.0,843.0
0.019,6,10,1990,5,911,4.0,643.0,643.0,5,1079,4.0,811.0,811.0
0.011,6,10,1989,5,910,2.0,642.0,642.0,5,1079,2.0,811.0,811.0
0.009,6,10,1990,5,911,2.0,643.0,643.0,5,1079,2.0,811.0,811.0
0.005,6,10,2006,5,927,1.0,659.0,659.0,5,1079,1.0,811.0,811.0
0.017,17,2,198,1,91,0.0,63.0,63.0,1,107,0.0,79.0,79.0
0.012,6,10,1990,5,911,3.0,643.0,643.0,5,1079,3.0,811.0,811.0
0.039,17,4,284,2,120,0.0,32.0,32.0,2,164,2.0,60.0,54.0
10.803,17,28,4423,14,1995,822.0,270.0,114.0,14,2428,822.0,587.0,145.0
0.164,17,2,152,1,76,0.0,48.0,48.0,1,76,0.0,48.0,48.0
0.012,6,10,1983,5,910,3.0,642.0,642.0,5,1073,2.0,805.0,805.0
0.085,6,10,1506,5,395,20.0,127.0,127.0,5,1111,18.0,843.0,843.0
0.001,17,2,154,1,69,0.0,41.0,41.0,1,85,0.0,57.0,57.0
0.013,6,10,1677,5,827,3.0,559.0,559.0,5,850,3.0,582.0,582.0
0.015,6,10,1990,5,911,3.0,643.0,643.0,5,1079,3.0,811.0,811.0
0.072,17,2,136,1,60,0.0,32.0,32.0,1,76,0.0,48.0,48.0
0.076,6,10,1506,5,395,16.0,127.0,127.0,5,1111,16.0,843.0,843.0
0.011,6,10,1990,5,911,2.0,643.0,643.0,5,1079,2.0,811.0,811.0
0.006,17,2,230,1,68,0.0,40.0,40.0,1,162,0.0,134.0,134.0
0.006,6,10,1689,5,839,1.0,571.0,571.0,5,850,1.0,582.0,582.0
0.006,6,10,1547,5,764,1.0,496.0,496.0,5,783,1.0,515.0,515.0
0.077,6,10,1506,5,395,17.0,127.0,127.0,5,1111,16.0,843.0,843.0
10.978,17,28,4398,14,2312,835.0,587.0,137.0,14,2086,835.0,269.0,121.0
0.005,17,2,170,1,65,0.0,37.0,37.0,1,105,0.0,77.0,77.0
0.077,6,10,1506,5,395,19.0,127.0,127.0,5,1111,18.0,843.0,843.0
0.17,17,2,152,1,76,0.0,48.0,48.0,1,76,0.0,48.0,48.0
0.004,6,10,1702,5,863,1.0,595.0,595.0,5,839,0.0,571.0,571.0
0.014,6,10,1990,5,911,3.0,643.0,643.0,5,1079,3.0,811.0,811.0
40.067,17,10,676,5,460,10015.0,104.0,64.0,5,216,10016.0,20.0,15.0
0.175,17,2,152,1,76,0.0,48.0,48.0,1,76,0.0,48.0,48.0
0.004,6,10,2006,5,927,1.0,659.0,659.0,5,1079,1.0,811.0,811.0
0.018,6,10,1972,5,910,4.0,642.0,642.0,5,1062,4.0,794.0,794.0
0.014,6,10,1972,5,910,3.0,642.0,642.0,5,1062,3.0,794.0,794.0
0.005,17,2,170,1,65,0.0,37.0,37.0,1,105,0.0,77.0,77.0
0.01,6,10,1989,5,910,2.0,642.0,642.0,5,1079,2.0,811.0,811.0
0.004,6,10,2006,5,927,1.0,659.0,659.0,5,1079,1.0,811.0,811.0
0.022,6,10,1990,5,911,5.0,643.0,643.0,5,1079,5.0,811.0,811.0
240.012,6,9,787,5,488,60003.0,232.0,232.0,4,299,80003.0,83.0,83.0
0.011,17,2,179,1,71,0.0,43.0,43.0,1,108,0.0,80.0,80.0
0.007,17,2,179,1,71,0.0,43.0,43.0,1,108,0.0,80.0,80.0
172.032,17,80,11249,40,2652,4410.0,44.0,38.0,40,8597,4411.0,261.0,186.0
240.1,6,16,4481,9,963,30012.0,238.0,166.0,7,3518,40016.0,1402.0,786.0
0.136,6,10,1506,5,395,29.0,127.0,127.0,5,1111,31.0,843.0,843.0
354.065,6,21,1795,16,1030,23604.0,190.0,190.0,5,765,60004.0,464.0,248.0
0.098,6,10,1506,5,395,22.0,127.0,127.0,5,1111,23.0,843.0,843.0
0.005,6,10,1547,5,764,1.0,496.0,496.0,5,783,1.0,515.0,515.0
0.009,17,2,179,1,71,0.0,43.0,43.0,1,108,0.0,80.0,80.0
1771.918,6,105,6270,60,3525,30031.0,27.0,27.0,45,2745,40269.0,27.0,27.0
0.005,6,10,2006,5,927,1.0,659.0,659.0,5,1079,1.0,811.0,811.0
0.016,6,10,1631,5,848,3.0,580.0,580.0,5,783,4.0,515.0,515.0
0.118,6,10,1506,5,395,27.0,127.0,127.0,5,1111,26.0,843.0,843.0
0.113,6,10,1506,5,395,26.0,127.0,127.0,5,1111,26.0,843.0,843.0
0.001,17,2,180,1,66,0.0,38.0,38.0,1,114,0.0,86.0,86.0
0.042,17,4,352,2,130,0.0,37.0,37.0,2,222,2.0,89.0,83.0
9.053,17,6,376,5,280,2263.0,28.0,28.0,1,96,0.0,68.0,68.0
0.012,6,10,1990,5,911,3.0,643.0,643.0,5,1079,2.0,811.0,811.0
0.008,6,13,3735,7,497,1.0,125.0,125.0,6,3238,1.0,1470.0,1459.0
0.07,6,10,1506,5,395,15.0,127.0,127.0,5,1111,16.0,843.0,843.0
240.141,6,49,6912,23,3317,10915.0,588.0,211.0,26,3595,9605.0,580.0,186.0
0.07,6,10,1506,5,395,15.0,127.0,127.0,5,1111,13.0,843.0,843.0
0.005,6,10,2007,5,928,1.0,660.0,660.0,5,1079,1.0,811.0,811.0
0.011,6,10,1972,5,910,2.0,642.0,642.0,5,1062,2.0,794.0,794.0
0.101,6,10,1506,5,395,21.0,127.0,127.0,5,1111,20.0,843.0,843.0
0.005,6,10,1774,5,923,1.0,655.0,655.0,5,851,1.0,583.0,583.0
0.006,6,10,2006,5,927,1.0,659.0,659.0,5,1079,1.0,811.0,811.0
0.111,6,10,1506,5,395,25.0,127.0,127.0,5,1111,25.0,843.0,843.0
0.006,17,2,144,1,64,0.0,36.0,36.0,1,80,0.0,52.0,52.0
0.017,6,10,1972,5,910,4.0,642.0,642.0,5,1062,4.0,794.0,794.0
0.007,6,10,1547,5,764,1.0,496.0,496.0,5,783,1.0,515.0,515.0
0.014,6,10,1631,5,848,3.0,580.0,580.0,5,783,3.0,515.0,515.0
0.012,6,10,1989,5,910,3.0,642.0,642.0,5,1079,3.0,811.0,811.0
10.811,17,27,4270,13,1846,891.0,269.0,114.0,14,2424,822.0,587.0,145.0
0.116,6,10,1506,5,395,24.0,127.0,127.0,5,1111,21.0,843.0,843.0
0.02,6,13,3735,7,497,3.0,125.0,125.0,6,3238,4.0,1470.0,1459.0
0.01,6,10,1972,5,910,2.0,642.0,642.0,5,1062,2.0,794.0,794.0
0.007,6,10,1689,5,839,1.0,571.0,571.0,5,850,1.0,582.0,582.0
0.004,17,4,284,2,120,0.0,32.0,32.0,2,164,0.0,60.0,54.0
0.004,6,10,2007,5,928,1.0,660.0,660.0,5,1079,1.0,811.0,811.0
0.004,6,14,3736,7,446,0.0,74.0,74.0,7,3290,0.0,1448.0,972.0
0.004,17,2,136,1,60,0.0,32.0,32.0,1,76,0.0,48.0,48.0
0.008,6,10,1989,5,910,2.0,642.0,642.0,5,1079,2.0,811.0,811.0
0.085,6,10,1506,5,395,17.0,127.0,127.0,5,1111,19.0,843.0,843.0
0.125,6,10,1506,5,395,28.0,127.0,127.0,5,1111,23.0,843.0,843.0
0.008,6,10,1989,5,910,2.0,642.0,642.0,5,1079,1.0,811.0,811.0
1.023,6,23,7974,13,1539,85.0,517.0,287.0,10,6435,18.0,1402.0,843.0
0.007,6,10,1989,5,910,1.0,642.0,642.0,5,1079,1.0,811.0,811.0
0.001,17,2,180,1,66,0.0,38.0,38.0,1,114,0.0,86.0,86.0
0.112,6,10,1506,5,395,27.0,127.0,127.0,5,1111,23.0,843.0,843.0
0.011,6,10,1990,5,911,2.0,643.0,643.0,5,1079,2.0,811.0,811.0
360.826,6,30,6180,19,4936,20045.0,494.0,494.0,11,1244,36082.0,83.0,83.0
0.006,6,10,2006,5,927,1.0,659.0,659.0,5,1079,1.0,811.0,811.0
0.018,6,10,1972,5,910,4.0,642.0,642.0,5,1062,4.0,794.0,794.0
0.001,17,2,166,1,75,0.0,47.0,47.0,1,91,0.0,63.0,63.0
0.004,17,2,186,1,61,0.0,33.0,33.0,1,125,0.0,97.0,97.0
0.017,6,10,1631,5,848,4.0,580.0,580.0,5,783,4.0,515.0,515.0
0.013,6,10,1990,5,911,3.0,643.0,643.0,5,1079,3.0,811.0,811.0
308.369,17,20,1124,10,716,34248.0,48.0,43.0,10,408,34249.0,20.0,12.0
0.008,6,10,1983,5,910,2.0,642.0,642.0,5,1073,2.0,805.0,805.0
0.009,6,12,1926,6,1189,1.0,659.0,434.0,6,737,1.0,417.0,417.0
0.007,6,10,1547,5,764,1.0,496.0,496.0,5,783,1.0,515.0,515.0
0.013,6,10,1990,5,911,3.0,643.0,643.0,5,1079,3.0,811.0,811.0
0.008,17,2,208,1,72,0.0,44.0,44.0,1,136,0.0,108.0,108.0
0.004,6,10,1702,5,863,1.0,595.0,595.0,5,839,0.0,571.0,571.0
391.024,6,24,2405,17,919,24439.0,195.0,195.0,7,1486,3909.0,419.0,398.0
0.005,17,2,140,1,62,0.0,34.0,34.0,1,78,0.0,50.0,50.0
0.004,6,10,2006,5,927,1.0,659.0,659.0,5,1079,1.0,811.0,811.0
0.079,6,10,1506,5,395,18.0,127.0,127.0,5,1111,17.0,843.0,843.0
0.008,6,10,1989,5,910,2.0,642.0,642.0,5,1079,2.0,811.0,811.0
0.005,6,10,2007,5,928,1.0,660.0,660.0,5,1079,1.0,811.0,811.0
15.074,17,15,9238,8,6902,2149.0,1350.0,834.0,7,2336,2507.0,1350.0,305.0
0.037,17,2,412,1,61,0.0,33.0,33.0,1,351,0.0,323.0,323.0
0.005,6,10,2006,5,927,1.0,659.0,659.0,5,1079,1.0,811.0,811.0
0.004,17,2,136,1,60,0.0,32.0,32.0,1,76,0.0,48.0,48.0
0.005,6,10,1989,5,927,1.0,659.0,659.0,5,1062,1.0,794.0,794.0
0.004,17,2,136,1,60,0.0,32.0,32.0,1,76,0.0,48.0,48.0
0.1,6,10,1506,5,395,24.0,127.0,127.0,5,1111,24.0,843.0,843.0
0.005,6,10,1689,5,839,1.0,571.0,571.0,5,850,1.0,582.0,582.0
15.07,17,15,9238,8,6902,2148.0,1350.0,834.0,7,2336,2506.0,1350.0,305.0
0.013,6,13,3735,7,497,2.0,125.0,125.0,6,3238,2.0,1470.0,1459.0
0.003,17,2,148,1,60,0.0,32.0,32.0,1,88,0.0,60.0,60.0
309.978,17,20,1124,10,716,34435.0,48.0,43.0,10,408,34435.0,20.0,12.0
0.004,17,4,284,2,120,0.0,32.0,32.0,2,164,1.0,60.0,54.0
240.085,6,16,4480,9,963,30010.0,238.0,166.0,7,3517,40013.0,1402.0,786.0
0.008,6,10,1762,5,911,2.0,643.0,643.0,5,851,2.0,583.0,583.0
0.116,6,10,1506,5,395,25.0,127.0,127.0,5,1111,24.0,843.0,843.0
0.012,6,10,1989,5,910,3.0,642.0,642.0,5,1079,3.0,811.0,811.0
0.012,6,10,1990,5,911,3.0,643.0,643.0,5,1079,2.0,811.0,811.0
0.008,6,10,1989,5,910,1.0,642.0,642.0,5,1079,1.0,811.0,811.0
0.004,6,10,2000,5,927,1.0,659.0,659.0,5,1073,1.0,805.0,805.0
0.005,6,10,2000,5,927,1.0,659.0,659.0,5,1073,1.0,805.0,805.0
0.005,6,10,2000,5,927,1.0,659.0,659.0,5,1073,1.0,805.0,805.0
0.01,6,10,1983,5,910,2.0,642.0,642.0,5,1073,2.0,805.0,805.0
0.009,6,10,1854,5,889,2.0,621.0,621.0,5,965,2.0,697.0,697.0
0.009,6,10,1990,5,911,2.0,643.0,643.0,5,1079,2.0,811.0,811.0
0.003,17,2,148,1,60,0.0,32.0,32.0,1,88,0.0,60.0,60.0
0.095,6,10,1506,5,395,21.0,127.0,127.0,5,1111,22.0,843.0,843.0
0.092,6,10,1506,5,395,20.0,127.0,127.0,5,1111,21.0,843.0,843.0
0.008,6,10,1990,5,911,2.0,643.0,643.0,5,1079,2.0,811.0,811.0
0.005,6,10,2006,5,927,1.0,659.0,659.0,5,1079,1.0,811.0,811.0
0.004,17,2,136,1,60,0.0,32.0,32.0,1,76,0.0,48.0,48.0
0.071,17,2,182,1,65,0.0,37.0,37.0,1,117,0.0,89.0,89.0
0.001,17,2,180,1,66,0.0,38.0,38.0,1,114,0.0,86.0,86.0
40.066,17,10,676,5,460,10014.0,104.0,64.0,5,216,10015.0,20.0,15.0
0.005,17,2,166,1,75,0.0,47.0,47.0,1,91,0.0,63.0,63.0
0.011,6,10,1990,5,911,2.0,643.0,643.0,5,1079,2.0,811.0,811.0
0.03,6,10,1989,5,910,7.0,642.0,642.0,5,1079,7.0,811.0,811.0
1760.149,6,446,67345,260,35754,6795.0,613.0,194.0,186,31591,9513.0,453.0,149.0
0.005,6,10,2006,5,927,1.0,659.0,659.0,5,1079,1.0,811.0,811.0
0.005,6,10,2006,5,927,1.0,659.0,659.0,5,1079,1.0,811.0,811.0
0.018,6,20,9974,11,704,1.0,124.0,124.0,9,9270,2.0,2896.0,1758.0
0.005,6,10,1854,5,889,1.0,621.0,621.0,5,965,1.0,697.0,697.0
0.005,6,10,2000,5,927,1.0,659.0,659.0,5,1073,1.0,805.0,805.0
0.005,6,10,1774,5,923,1.0,655.0,655.0,5,851,1.0,583.0,583.0
0.067,17,8,3613,4,1874,22.0,1350.0,440.0,4,1739,11.0,1350.0,406.0
0.015,6,10,1677,5,827,3.0,559.0,559.0,5,850,3.0,582.0,582.0
108.932,6,28,9605,14,1707,8379.0,794.0,367.0,14,7898,8368.0,1360.0,732.0
0.004,6,10,2000,5,927,1.0,659.0,659.0,5,1073,1.0,805.0,805.0
0.005,17,2,179,1,71,0.0,43.0,43.0,1,108,0.0,80.0,80.0
0.001,17,2,180,1,66,0.0,38.0,38.0,1,114,0.0,86.0,86.0
0.005,17,2,170,1,65,0.0,37.0,37.0,1,105,0.0,77.0,77.0
0.005,6,10,2000,5,927,1.0,659.0,659.0,5,1073,1.0,805.0,805.0
0.004,17,2,148,1,60,0.0,32.0,32.0,1,88,0.0,60.0,60.0
300.192,6,29,7552,16,1421,20012.0,217.0,142.0,13,6131,20016.0,1402.0,680.0
0.005,17,2,154,1,69,0.0,41.0,41.0,1,85,0.0,57.0,57.0
291.611,6,415,348958,205,22223,1429.0,2690.0,825.0,210,326735,1395.0,2804.0,1611.0
0.084,6,10,1506,5,395,17.0,127.0,127.0,5,1111,18.0,843.0,843.0
0.04,17,4,420,2,122,1.0,33.0,33.0,2,298,3.0,145.0,121.0
0.005,6,10,2006,5,927,1.0,659.0,659.0,5,1079,1.0,811.0,811.0
0.113,6,10,1506,5,395,26.0,127.0,127.0,5,1111,26.0,843.0,843.0
0.001,17,2,180,1,66,0.0,38.0,38.0,1,114,0.0,86.0,86.0
0.005,17,2,170,1,65,0.0,37.0,37.0,1,105,0.0,77.0,77.0
354.052,6,19,1691,15,978,25289.0,190.0,190.0,4,713,80002.0,497.0,497.0
0.041,6,19,9922,11,704,4.0,124.0,124.0,8,9218,5.0,2896.0,2198.0
0.076,6,10,1506,5,395,16.0,127.0,127.0,5,1111,18.0,843.0,843.0
0.005,6,10,2006,5,927,1.0,659.0,659.0,5,1079,1.0,811.0,811.0
0.005,6,10,1989,5,927,1.0,659.0,659.0,5,1062,1.0,794.0,794.0
0.104,6,10,1506,5,395,22.0,127.0,127.0,5,1111,21.0,843.0,843.0
311.914,17,20,1124,10,716,34642.0,48.0,43.0,10,408,34642.0,20.0,12.0
0.03,6,10,1972,5,910,7.0,642.0,642.0,5,1062,7.0,794.0,794.0
0.087,6,10,1506,5,395,18.0,127.0,127.0,5,1111,19.0,843.0,843.0
0.006,6,10,1689,5,839,1.0,571.0,571.0,5,850,1.0,582.0,582.0
240.094,6,16,4481,9,963,30011.0,238.0,166.0,7,3518,40015.0,1402.0,786.0
0.003,6,10,1702,5,863,0.0,595.0,595.0,5,839,0.0,571.0,571.0
15.073,17,15,9238,8,6902,2149.0,1350.0,834.0,7,2336,2507.0,1350.0,305.0
0.005,6,10,2007,5,928,1.0,660.0,660.0,5,1079,1.0,811.0,811.0
331.055,17,20,1124,10,716,36768.0,48.0,43.0,10,408,36768.0,20.0,12.0
0.04,17,2,170,1,65,0.0,37.0,37.0,1,105,0.0,77.0,77.0
241.793,6,320,344432,129,18237,1889.0,2736.0,961.0,191,326195,1272.0,2804.0,1747.0
0.017,17,2,148,1,60,0.0,32.0,32.0,1,88,0.0,60.0,60.0
0.073,6,10,1506,5,395,16.0,127.0,127.0,5,1111,16.0,843.0,843.0
0.081,6,10,1506,5,395,18.0,127.0,127.0,5,1111,17.0,843.0,843.0
0.004,6,10,2007,5,928,1.0,660.0,660.0,5,1079,1.0,811.0,811.0
308.25,58,7,504,5,360,77062.0,24.0,24.0,2,144,261650.0,24.0,24.0
0.02,6,10,1989,5,910,4.0,642.0,642.0,5,1079,5.0,811.0,811.0
0.005,6,10,1702,5,863,1.0,595.0,595.0,5,839,1.0,571.0,571.0
0.005,6,10,2006,5,927,1.0,659.0,659.0,5,1079,1.0,811.0,811.0
0.005,6,10,2006,5,927,1.0,659.0,659.0,5,1079,1.0,811.0,811.0
240.016,6,9,787,5,488,60004.0,232.0,232.0,4,299,80004.0,83.0,83.0
0.012,17,2,170,1,65,0.0,37.0,37.0,1,105,0.0,77.0,77.0
0.089,6,10,1506,5,395,18.0,127.0,127.0,5,1111,17.0,843.0,843.0
40.065,17,10,676,5,460,10012.0,104.0,64.0,5,216,10015.0,20.0,15.0
15.258,17,42,20673,22,17098,725.0,1350.0,749.0,20,3575,801.0,1350.0,150.0
40.049,17,10,676,5,460,10011.0,104.0,64.0,5,216,10011.0,20.0,15.0
0.006,6,10,1547,5,764,1.0,496.0,496.0,5,783,1.0,515.0,515.0
0.069,17,8,3613,4,1874,23.0,1350.0,440.0,4,1739,12.0,1350.0,406.0
0.08,6,10,1506,5,395,16.0,127.0,127.0,5,1111,18.0,843.0,843.0
0.009,6,10,1972,5,910,2.0,642.0,642.0,5,1062,2.0,794.0,794.0
0.007,6,10,1989,5,927,1.0,659.0,659.0,5,1062,1.0,794.0,794.0
0.108,6,10,1506,5,395,25.0,127.0,127.0,5,1111,22.0,843.0,843.0
0.014,6,13,3735,7,497,2.0,125.0,125.0,6,3238,2.0,1470.0,1459.0
10.812,17,28,4417,14,1993,822.0,268.0,114.0,14,2424,822.0,587.0,145.0
0.009,6,10,1762,5,911,2.0,643.0,643.0,5,851,2.0,583.0,583.0
0.006,6,10,2006,5,927,1.0,659.0,659.0,5,1079,1.0,811.0,811.0
0.079,6,10,1506,5,395,17.0,127.0,127.0,5,1111,14.0,843.0,843.0
0.006,6,10,1547,5,764,1.0,496.0,496.0,5,783,1.0,515.0,515.0
0.005,17,2,180,1,66,0.0,38.0,38.0,1,114,0.0,86.0,86.0
1730.383,6,45,2790,30,1725,59668.0,35.0,35.0,15,1065,123593.0,31.0,31.0
0.006,6,10,2006,5,927,1.0,659.0,659.0,5,1079,1.0,811.0,811.0
0.005,6,10,1774,5,923,1.0,655.0,655.0,5,851,1.0,583.0,583.0
0.005,6,10,2006,5,927,1.0,659.0,659.0,5,1079,1.0,811.0,811.0
352.868,6,21,2262,6,1308,12005.0,494.0,494.0,15,954,25204.0,83.0,83.0
53.117,6,35,9515,17,3997,551.0,2932.0,1095.0,18,5518,3114.0,2667.0,435.0
0.37,17,45,22061,24,18526,16.0,1350.0,743.0,21,3535,15.0,1350.0,140.0
0.005,6,10,2006,5,927,1.0,659.0,659.0,5,1079,1.0,811.0,811.0
0.01,6,10,1983,5,910,2.0,642.0,642.0,5,1073,2.0,805.0,805.0
0.005,17,2,230,1,68,0.0,40.0,40.0,1,162,0.0,134.0,134.0
0.104,6,10,1506,5,395,22.0,127.0,127.0,5,1111,23.0,843.0,843.0
0.005,6,10,1779,5,928,1.0,660.0,660.0,5,851,1.0,583.0,583.0
308.49,17,20,1124,10,716,34263.0,48.0,43.0,10,408,34263.0,20.0,12.0
0.012,6,10,1990,5,911,2.0,643.0,643.0,5,1079,3.0,811.0,811.0
1778.376,17,144,45504,72,22752,25047.0,288.0,288.0,72,22752,25047.0,288.0,288.0
0.111,6,10,1506,5,395,25.0,127.0,127.0,5,1111,27.0,843.0,843.0
0.006,17,2,170,1,65,0.0,37.0,37.0,1,105,0.0,77.0,77.0
0.012,6,10,1677,5,827,3.0,559.0,559.0,5,850,2.0,582.0,582.0
0.012,6,10,1990,5,911,3.0,643.0,643.0,5,1079,2.0,811.0,811.0
15.087,17,16,9302,8,6912,2151.0,1350.0,836.0,8,2390,2151.0,1350.0,270.0
0.001,17,2,166,1,75,0.0,47.0,47.0,1,91,0.0,63.0,63.0
0.028,6,10,1990,5,911,7.0,643.0,643.0,5,1079,6.0,811.0,811.0
0.009,6,12,1926,6,1189,1.0,659.0,434.0,6,737,1.0,417.0,417.0
0.005,6,10,1689,5,839,1.0,571.0,571.0,5,850,1.0,582.0,582.0
0.006,6,10,1779,5,928,1.0,660.0,660.0,5,851,1.0,583.0,583.0
0.014,6,10,1990,5,911,3.0,643.0,643.0,5,1079,3.0,811.0,811.0
0.005,6,10,1779,5,928,1.0,660.0,660.0,5,851,1.0,583.0,583.0
40.047,17,10,676,5,460,10011.0,104.0,64.0,5,216,10010.0,20.0,15.0
0.008,6,10,1990,5,911,2.0,643.0,643.0,5,1079,2.0,811.0,811.0
0.022,6,10,1989,5,910,5.0,642.0,642.0,5,1079,5.0,811.0,811.0
0.141,17,2,80,1,32,0.0,4.0,4.0,1,48,0.0,20.0,20.0
0.003,17,4,284,2,120,0.0,32.0,32.0,2,164,0.0,60.0,54.0
0.003,17,2,136,1,60,0.0,32.0,32.0,1,76,0.0,48.0,48.0
0.005,6,10,2006,5,927,1.0,659.0,659.0,5,1079,1.0,811.0,811.0
240.087,6,16,4481,9,963,30010.0,238.0,166.0,7,3518,40013.0,1402.0,786.0
39.969,17,10,676,5,460,9990.0,104.0,64.0,5,216,9991.0,20.0,15.0
0.006,6,10,1547,5,764,1.0,496.0,496.0,5,783,1.0,515.0,515.0
240.194,6,35,4246,17,1952,15011.0,589.0,176.0,18,2294,14128.0,580.0,192.0
0.013,6,10,1972,5,910,3.0,642.0,642.0,5,1062,3.0,794.0,794.0
0.006,6,14,3799,7,509,0.0,137.0,137.0,7,3290,0.0,1448.0,972.0
0.001,17,2,180,1,66,0.0,38.0,38.0,1,114,0.0,86.0,86.0
0.005,17,2,164,1,74,0.0,46.0,46.0,1,90,0.0,62.0,62.0
0.006,6,10,2007,5,928,1.0,660.0,660.0,5,1079,1.0,811.0,811.0
0.084,6,10,1506,5,395,18.0,127.0,127.0,5,1111,16.0,843.0,843.0
0.001,17,2,136,1,60,0.0,32.0,32.0,1,76,0.0,48.0,48.0
0.001,17,2,136,1,60,0.0,32.0,32.0,1,76,0.0,48.0,48.0
378.907,6,20,2210,6,1308,12003.0,494.0,494.0,14,902,29146.0,83.0,83.0
0.02,6,10,1983,5,910,5.0,642.0,642.0,5,1073,5.0,805.0,805.0
0.004,17,2,148,1,60,0.0,32.0,32.0,1,88,0.0,60.0,60.0
0.012,6,10,1989,5,910,3.0,642.0,642.0,5,1079,3.0,811.0,811.0
0.009,6,12,1926,6,1189,1.0,659.0,434.0,6,737,1.0,417.0,417.0
0.001,17,2,142,1,63,0.0,35.0,35.0,1,79,0.0,51.0,51.0
0.006,17,2,158,1,63,0.0,35.0,35.0,1,95,0.0,67.0,67.0
0.005,6,10,1989,5,927,1.0,659.0,659.0,5,1062,1.0,794.0,794.0
177.191,17,92,13408,46,3109,3937.0,44.0,39.0,46,10299,3937.0,239.0,195.0
0.04,17,2,136,1,60,0.0,32.0,32.0,1,76,0.0,48.0,48.0
0.007,6,10,1547,5,764,1.0,496.0,496.0,5,783,1.0,515.0,515.0
11.39,17,28,4392,14,2313,864.0,588.0,137.0,14,2079,864.0,270.0,120.0
0.008,6,13,3747,7,509,1.0,137.0,137.0,6,3238,1.0,1470.0,1459.0
0.059,6,10,1506,5,395,14.0,127.0,127.0,5,1111,13.0,843.0,843.0
40.063,17,10,676,5,460,10014.0,104.0,64.0,5,216,10014.0,20.0,15.0
0.008,6,10,1989,5,927,2.0,659.0,659.0,5,1062,2.0,794.0,794.0
0.078,6,10,1506,5,395,19.0,127.0,127.0,5,1111,18.0,843.0,843.0
0.007,17,2,307,1,61,0.0,33.0,33.0,1,246,0.0,218.0,218.0
0.007,6,10,2006,5,927,1.0,659.0,659.0,5,1079,1.0,811.0,811.0
0.041,17,2,152,1,76,0.0,48.0,48.0,1,76,0.0,48.0,48.0
240.015,6,9,787,5,488,60003.0,232.0,232.0,4,299,80004.0,83.0,83.0
40.05,17,10,676,5,460,10011.0,104.0,64.0,5,216,10011.0,20.0,15.0
0.102,6,10,1506,5,395,24.0,127.0,127.0,5,1111,22.0,843.0,843.0
40.064,17,10,676,5,460,10014.0,104.0,64.0,5,216,10015.0,20.0,15.0
0.585,6,27,9420,15,1639,34.0,517.0,211.0,12,7781,43.0,1288.0,895.0
0.027,6,12,4068,7,671,4.0,295.0,295.0,5,3397,5.0,1727.0,1564.0
0.019,6,10,1972,5,910,4.0,642.0,642.0,5,1062,4.0,794.0,794.0
0.006,17,2,164,1,74,0.0,46.0,46.0,1,90,0.0,62.0,62.0
0.142,6,10,1506,5,395,27.0,127.0,127.0,5,1111,32.0,843.0,843.0
0.008,6,10,1677,5,827,2.0,559.0,559.0,5,850,2.0,582.0,582.0
0.008,6,12,1926,6,1189,1.0,659.0,434.0,6,737,1.0,417.0,417.0
0.006,6,10,1689,5,839,1.0,571.0,571.0,5,850,1.0,582.0,582.0
0.005,6,10,1689,5,839,1.0,571.0,571.0,5,850,1.0,582.0,582.0
240.09,6,16,4481,9,963,30011.0,238.0,166.0,7,3518,40014.0,1402.0,786.0
0.012,6,10,1631,5,848,3.0,580.0,580.0,5,783,3.0,515.0,515.0
352.245,6,20,2210,6,1308,12003.0,494.0,494.0,14,902,27095.0,83.0,83.0
0.004,17,2,136,1,60,0.0,32.0,32.0,1,76,0.0,48.0,48.0
0.006,6,10,1547,5,764,1.0,496.0,496.0,5,783,1.0,515.0,515.0
0.004,6,10,2006,5,927,1.0,659.0,659.0,5,1079,1.0,811.0,811.0
0.009,6,10,1972,5,910,2.0,642.0,642.0,5,1062,2.0,794.0,794.0
0.005,6,10,2006,5,927,1.0,659.0,659.0,5,1079,1.0,811.0,811.0
0.009,6,10,1983,5,910,2.0,642.0,642.0,5,1073,2.0,805.0,805.0
240.028,6,9,787,5,488,60007.0,232.0,232.0,4,299,80008.0,83.0,83.0
0.005,17,2,169,1,62,0.0,34.0,34.0,1,107,0.0,79.0,79.0
0.005,17,2,170,1,65,0.0,37.0,37.0,1,105,0.0,77.0,77.0
0.123,6,10,1506,5,395,27.0,127.0,127.0,5,1111,26.0,843.0,843.0
354.058,6,21,1795,16,1030,23603.0,190.0,190.0,5,765,60001.0,464.0,248.0
0.08,6,10,1506,5,395,17.0,127.0,127.0,5,1111,17.0,843.0,843.0
0.007,17,2,222,1,65,0.0,37.0,37.0,1,157,0.0,129.0,129.0
0.005,6,10,1854,5,889,1.0,621.0,621.0,5,965,1.0,697.0,697.0
0.004,6,10,2000,5,927,1.0,659.0,659.0,5,1073,1.0,805.0,805.0
0.005,6,10,1689,5,839,1.0,571.0,571.0,5,850,1.0,582.0,582.0
40.057,17,10,676,5,460,10012.0,104.0,64.0,5,216,10013.0,20.0,15.0
0.016,6,10,1983,5,910,4.0,642.0,642.0,5,1073,4.0,805.0,805.0
0.003,17,4,284,2,120,0.0,32.0,32.0,2,164,0.0,60.0,54.0
1.243,6,32,13392,18,5893,73.0,2720.0,854.0,14,7499,82.0,2565.0,769.0
0.008,6,10,1983,5,910,2.0,642.0,642.0,5,1073,1.0,805.0,805.0
177.374,17,82,11451,41,2728,4434.0,44.0,38.0,41,8723,4434.0,239.0,184.0
177.135,17,70,10007,35,2330,5209.0,44.0,38.0,35,7677,5209.0,239.0,191.0
0.283,6,22,7135,11,1609,28.0,746.0,257.0,11,5526,28.0,2333.0,989.0
40.063,17,10,676,5,460,10013.0,104.0,64.0,5,216,10014.0,20.0,15.0
0.082,6,10,1506,5,395,19.0,127.0,127.0,5,1111,18.0,843.0,843.0
0.004,17,4,284,2,120,0.0,32.0,32.0,2,164,0.0,60.0,54.0
0.005,6,10,2006,5,927,1.0,659.0,659.0,5,1079,1.0,811.0,811.0
0.011,6,10,1990,5,911,2.0,643.0,643.0,5,1079,2.0,811.0,811.0
0.011,6,10,1990,5,911,2.0,643.0,643.0,5,1079,2.0,811.0,811.0
0.005,17,2,179,1,71,0.0,43.0,43.0,1,108,0.0,80.0,80.0
0.845,6,29,7768,17,2784,52.0,1477.0,515.0,12,4984,61.0,2745.0,561.0
0.001,17,2,180,1,66,0.0,38.0,38.0,1,114,0.0,86.0,86.0
0.009,6,10,1989,5,910,2.0,642.0,642.0,5,1079,2.0,811.0,811.0
0.006,6,10,1547,5,764,1.0,496.0,496.0,5,783,1.0,515.0,515.0
0.031,6,10,1983,5,910,7.0,642.0,642.0,5,1073,7.0,805.0,805.0
240.082,6,16,4481,9,963,30010.0,238.0,166.0,7,3518,40013.0,1402.0,786.0
0.018,6,10,1989,5,910,4.0,642.0,642.0,5,1079,4.0,811.0,811.0
0.004,17,2,148,1,60,0.0,32.0,32.0,1,88,0.0,60.0,60.0
0.008,6,10,1990,5,911,2.0,643.0,643.0,5,1079,1.0,811.0,811.0
0.012,6,13,3735,7,497,2.0,125.0,125.0,6,3238,2.0,1470.0,1459.0
0.008,6,10,1547,5,764,1.0,496.0,496.0,5,783,2.0,515.0,515.0
0.01,6,10,1989,5,910,2.0,642.0,642.0,5,1079,2.0,811.0,811.0
0.005,6,10,2006,5,927,1.0,659.0,659.0,5,1079,1.0,811.0,811.0
0.016,6,10,1989,5,910,4.0,642.0,642.0,5,1079,4.0,811.0,811.0
0.003,6,10,1702,5,863,0.0,595.0,595.0,5,839,0.0,571.0,571.0
0.094,6,10,1506,5,395,20.0,127.0,127.0,5,1111,18.0,843.0,843.0
1730.391,6,47,2905,31,1800,57679.0,35.0,35.0,16,1105,115354.0,31.0,31.0
0.005,6,10,2006,5,927,1.0,659.0,659.0,5,1079,1.0,811.0,811.0
40.063,17,10,676,5,460,10014.0,104.0,64.0,5,216,10014.0,20.0,15.0
0.005,6,10,2007,5,928,1.0,660.0,660.0,5,1079,1.0,811.0,811.0
0.005,6,10,2006,5,927,1.0,659.0,659.0,5,1079,1.0,811.0,811.0
310.375,17,17,968,9,640,38767.0,48.0,43.0,8,328,44309.0,20.0,13.0
0.004,17,2,148,1,60,0.0,32.0,32.0,1,88,0.0,60.0,60.0
0.134,6,10,1506,5,395,26.0,127.0,127.0,5,1111,30.0,843.0,843.0
0.061,6,10,1506,5,395,14.0,127.0,127.0,5,1111,13.0,843.0,843.0
0.009,6,12,1926,6,1189,1.0,659.0,434.0,6,737,1.0,417.0,417.0
0.005,6,10,2006,5,927,1.0,659.0,659.0,5,1079,1.0,811.0,811.0
0.006,6,10,1689,5,839,1.0,571.0,571.0,5,850,1.0,582.0,582.0
0.069,17,2,144,1,64,0.0,36.0,36.0,1,80,0.0,52.0,52.0
0.02,6,10,1990,5,911,5.0,643.0,643.0,5,1079,4.0,811.0,811.0
0.005,6,10,2006,5,927,1.0,659.0,659.0,5,1079,1.0,811.0,811.0
0.105,6,10,1506,5,395,22.0,127.0,127.0,5,1111,20.0,843.0,843.0
0.004,6,10,2006,5,927,1.0,659.0,659.0,5,1079,1.0,811.0,811.0
0.005,6,14,3799,7,509,0.0,137.0,137.0,7,3290,0.0,1448.0,972.0
0.153,6,10,1506,5,395,33.0,127.0,127.0,5,1111,36.0,843.0,843.0
0.003,17,2,148,1,60,0.0,32.0,32.0,1,88,0.0,60.0,60.0
0.023,6,10,1990,5,911,5.0,643.0,643.0,5,1079,5.0,811.0,811.0
0.008,17,2,194,1,59,0.0,31.0,31.0,1,135,0.0,107.0,107.0
0.004,6,10,2006,5,927,1.0,659.0,659.0,5,1079,1.0,811.0,811.0
0.038,6,10,1989,5,910,9.0,642.0,642.0,5,1079,9.0,811.0,811.0
0.015,6,10,1989,5,910,3.0,642.0,642.0,5,1079,3.0,811.0,811.0
0.005,6,10,1774,5,923,1.0,655.0,655.0,5,851,1.0,583.0,583.0
0.11,6,10,1506,5,395,27.0,127.0,127.0,5,1111,26.0,843.0,843.0
0.086,6,10,1506,5,395,18.0,127.0,127.0,5,1111,20.0,843.0,843.0
0.005,17,2,166,1,75,0.0,47.0,47.0,1,91,0.0,63.0,63.0
0.005,6,10,1854,5,889,1.0,621.0,621.0,5,965,1.0,697.0,697.0
0.083,6,10,1506,5,395,19.0,127.0,127.0,5,1111,18.0,843.0,843.0
0.006,6,10,2000,5,927,1.0,659.0,659.0,5,1073,1.0,805.0,805.0
240.01,6,9,787,5,488,60002.0,232.0,232.0,4,299,80002.0,83.0,83.0
0.004,6,10,2000,5,927,1.0,659.0,659.0,5,1073,1.0,805.0,805.0
0.916,6,22,5168,11,1138,78.0,267.0,115.0,11,4030,78.0,1414.0,597.0
0.005,6,10,1989,5,927,1.0,659.0,659.0,5,1062,1.0,794.0,794.0
0.013,6,10,1989,5,910,3.0,642.0,642.0,5,1079,3.0,811.0,811.0
0.006,6,10,1774,5,923,1.0,655.0,655.0,5,851,1.0,583.0,583.0
0.001,17,2,180,1,66,0.0,38.0,38.0,1,114,0.0,86.0,86.0
0.007,6,10,1989,5,910,1.0,642.0,642.0,5,1079,1.0,811.0,811.0
0.005,6,13,3747,7,509,0.0,137.0,137.0,6,3238,1.0,1470.0,1459.0
0.005,6,10,1854,5,889,1.0,621.0,621.0,5,965,1.0,697.0,697.0
0.006,6,10,1547,5,764,1.0,496.0,496.0,5,783,1.0,515.0,515.0
0.006,6,10,1547,5,764,1.0,496.0,496.0,5,783,1.0,515.0,515.0
0.002,17,2,180,1,66,0.0,38.0,38.0,1,114,0.0,86.0,86.0
0.007,17,2,194,1,59,0.0,31.0,31.0,1,135,0.0,107.0,107.0
0.008,6,10,1983,5,910,2.0,642.0,642.0,5,1073,1.0,805.0,805.0
0.014,6,10,1990,5,911,3.0,643.0,643.0,5,1079,3.0,811.0,811.0
0.087,6,10,1506,5,395,21.0,127.0,127.0,5,1111,16.0,843.0,843.0
241.223,6,327,345226,123,17913,1977.0,2736.0,959.0,204,327313,1188.0,2804.0,1640.0
240.054,6,9,799,5,500,60013.0,232.0,232.0,4,299,80005.0,83.0,83.0
40.061,17,10,676,5,460,10014.0,104.0,64.0,5,216,10014.0,20.0,15.0
0.005,6,10,1643,5,860,1.0,592.0,592.0,5,783,1.0,515.0,515.0
0.02,6,10,1989,5,910,4.0,642.0,642.0,5,1079,4.0,811.0,811.0
0.017,6,10,1983,5,910,4.0,642.0,642.0,5,1073,4.0,805.0,805.0
0.016,6,10,1762,5,911,3.0,643.0,643.0,5,851,4.0,583.0,583.0
40.05,17,10,676,5,460,10011.0,104.0,64.0,5,216,10011.0,20.0,15.0
0.006,6,10,1779,5,928,1.0,660.0,660.0,5,851,1.0,583.0,583.0
0.01,6,10,1983,5,910,2.0,642.0,642.0,5,1073,2.0,805.0,805.0
0.006,17,2,214,1,75,0.0,47.0,47.0,1,139,0.0,111.0,111.0
0.006,6,10,1689,5,839,1.0,571.0,571.0,5,850,1.0,582.0,582.0
40.068,17,10,676,5,460,10014.0,104.0,64.0,5,216,10016.0,20.0,15.0
0.005,17,2,170,1,65,0.0,37.0,37.0,1,105,0.0,77.0,77.0
0.004,17,2,136,1,60,0.0,32.0,32.0,1,76,0.0,48.0,48.0
0.174,17,2,152,1,76,0.0,48.0,48.0,1,76,0.0,48.0,48.0
0.005,6,10,2000,5,927,1.0,659.0,659.0,5,1073,1.0,805.0,805.0
40.056,17,10,676,5,460,10012.0,104.0,64.0,5,216,10011.0,20.0,15.0
0.004,6,10,1702,5,863,1.0,595.0,595.0,5,839,1.0,571.0,571.0
240.086,6,32,9491,16,7010,16005.0,2083.0,686.0,16,2481,16005.0,580.0,205.0
0.208,6,16,2776,8,1394,29.0,533.0,323.0,8,1382,18.0,529.0,239.0
0.006,6,10,1547,5,764,1.0,496.0,496.0,5,783,1.0,515.0,515.0
0.012,6,10,1983,5,910,2.0,642.0,642.0,5,1073,2.0,805.0,805.0
0.131,17,2,80,1,32,0.0,4.0,4.0,1,48,0.0,20.0,20.0
0.041,17,2,152,1,76,0.0,48.0,48.0,1,76,0.0,48.0,48.0
1.101,6,32,13391,18,5892,64.0,2073.0,854.0,14,7499,70.0,2720.0,769.0
15.289,17,41,20337,22,17092,726.0,1350.0,748.0,19,3245,847.0,1350.0,142.0
0.097,6,10,1506,5,395,21.0,127.0,127.0,5,1111,21.0,843.0,843.0
240.015,6,9,787,5,488,60003.0,232.0,232.0,4,299,80003.0,83.0,83.0
0.006,17,2,170,1,65,0.0,37.0,37.0,1,105,0.0,77.0,77.0
0.005,6,10,1689,5,839,1.0,571.0,571.0,5,850,1.0,582.0,582.0
0.006,6,10,1547,5,764,1.0,496.0,496.0,5,783,1.0,515.0,515.0
0.014,6,10,1989,5,910,3.0,642.0,642.0,5,1079,3.0,811.0,811.0
0.006,6,10,1547,5,764,1.0,496.0,496.0,5,783,1.0,515.0,515.0
0.012,6,10,1677,5,827,2.0,559.0,559.0,5,850,3.0,582.0,582.0
0.087,6,10,1506,5,395,19.0,127.0,127.0,5,1111,18.0,843.0,843.0
0.111,6,10,1506,5,395,25.0,127.0,127.0,5,1111,24.0,843.0,843.0
40.066,17,10,676,5,460,10014.0,104.0,64.0,5,216,10015.0,20.0,15.0
40.073,17,10,676,5,460,10016.0,104.0,64.0,5,216,10017.0,20.0,15.0
0.004,6,10,2006,5,927,1.0,659.0,659.0,5,1079,1.0,811.0,811.0
60.018,6,10,1690,6,1308,12003.0,494.0,494.0,4,382,20005.0,83.0,83.0
300.156,6,48,18979,25,13261,12499.0,2720.0,1222.0,23,5718,13635.0,2667.0,435.0
0.005,6,10,2000,5,927,1.0,659.0,659.0,5,1073,1.0,805.0,805.0
0.013,6,10,1983,5,910,3.0,642.0,642.0,5,1073,3.0,805.0,805.0
0.006,6,10,1689,5,839,1.0,571.0,571.0,5,850,1.0,582.0,582.0
0.084,6,10,1506,5,395,19.0,127.0,127.0,5,1111,17.0,843.0,843.0
0.005,6,10,1989,5,927,1.0,659.0,659.0,5,1062,1.0,794.0,794.0
0.012,6,10,1972,5,910,2.0,642.0,642.0,5,1062,3.0,794.0,794.0
0.089,6,10,1506,5,395,20.0,127.0,127.0,5,1111,18.0,843.0,843.0
0.013,17,2,152,1,56,0.0,28.0,28.0,1,96,0.0,68.0,68.0
0.011,6,10,1989,5,910,2.0,642.0,642.0,5,1079,2.0,811.0,811.0
0.099,6,10,1506,5,395,23.0,127.0,127.0,5,1111,22.0,843.0,843.0
10.94,17,28,4422,14,1994,832.0,269.0,114.0,14,2428,832.0,587.0,145.0
40.068,17,10,676,5,460,10013.0,104.0,64.0,5,216,10014.0,20.0,15.0
0.041,17,2,156,1,64,0.0,36.0,36.0,1,92,0.0,64.0,64.0
0.005,6,10,1989,5,927,1.0,659.0,659.0,5,1062,1.0,794.0,794.0
0.002,17,2,136,1,60,0.0,32.0,32.0,1,76,0.0,48.0,48.0
0.005,6,10,1989,5,927,1.0,659.0,659.0,5,1062,1.0,794.0,794.0
0.001,17,2,142,1,63,0.0,35.0,35.0,1,79,0.0,51.0,51.0
0.005,6,10,1779,5,928,1.0,660.0,660.0,5,851,1.0,583.0,583.0
0.012,6,10,1972,5,910,2.0,642.0,642.0,5,1062,2.0,794.0,794.0
0.092,6,10,1506,5,395,21.0,127.0,127.0,5,1111,22.0,843.0,843.0
0.004,17,2,148,1,60,0.0,32.0,32.0,1,88,0.0,60.0,60.0
0.011,6,10,1983,5,910,2.0,642.0,642.0,5,1073,2.0,805.0,805.0
0.087,6,10,1506,5,395,20.0,127.0,127.0,5,1111,18.0,843.0,843.0
40.057,17,10,676,5,460,10013.0,104.0,64.0,5,216,10013.0,20.0,15.0
300.292,6,16,2170,9,684,37515.0,146.0,146.0,7,1486,50021.0,419.0,398.0
0.005,17,2,136,1,60,0.0,32.0,32.0,1,76,0.0,48.0,48.0
0.005,6,10,1989,5,927,1.0,659.0,659.0,5,1062,1.0,794.0,794.0
0.006,6,10,1547,5,764,1.0,496.0,496.0,5,783,1.0,515.0,515.0
0.04,17,2,144,1,64,0.0,36.0,36.0,1,80,0.0,52.0,52.0
40.064,17,10,676,5,460,10015.0,104.0,64.0,5,216,10015.0,20.0,15.0
1791.74,6,275,34166,112,15270,16140.0,1939.0,123.0,163,18896,11059.0,1360.0,150.0
0.005,6,10,2007,5,928,1.0,660.0,660.0,5,1079,1.0,811.0,811.0
0.001,17,2,179,1,62,0.0,34.0,34.0,1,117,0.0,89.0,89.0
126.017,6,14,2938,8,2504,17968.0,1414.0,1086.0,6,434,25156.0,182.0,182.0
0.004,17,4,284,2,120,0.0,32.0,32.0,2,164,0.0,60.0,54.0
0.038,17,2,234,1,61,0.0,33.0,33.0,1,173,0.0,145.0,145.0
40.067,17,10,676,5,460,10015.0,104.0,64.0,5,216,10015.0,20.0,15.0
0.006,17,2,214,1,75,0.0,47.0,47.0,1,139,0.0,111.0,111.0
0.052,17,2,152,1,76,0.0,48.0,48.0,1,76,0.0,48.0,48.0
0.005,17,2,166,1,75,0.0,47.0,47.0,1,91,0.0,63.0,63.0
0.02,6,10,1983,5,910,4.0,642.0,642.0,5,1073,5.0,805.0,805.0
0.006,6,10,1547,5,764,1.0,496.0,496.0,5,783,1.0,515.0,515.0
0.011,6,10,1990,5,911,2.0,643.0,643.0,5,1079,2.0,811.0,811.0
0.005,6,10,2006,5,927,1.0,659.0,659.0,5,1079,1.0,811.0,811.0
0.007,6,12,1698,6,863,1.0,327.0,271.0,6,835,1.0,515.0,515.0
0.008,6,10,1990,5,911,2.0,643.0,643.0,5,1079,2.0,811.0,811.0
0.005,6,10,1989,5,927,1.0,659.0,659.0,5,1062,1.0,794.0,794.0
0.009,6,12,1926,6,1189,1.0,659.0,434.0,6,737,1.0,417.0,417.0
0.009,6,10,1990,5,911,2.0,643.0,643.0,5,1079,2.0,811.0,811.0
0.005,17,2,164,1,74,0.0,46.0,46.0,1,90,0.0,62.0,62.0
40.053,17,10,676,5,460,10012.0,104.0,64.0,5,216,10012.0,20.0,15.0
0.106,6,10,1506,5,395,25.0,127.0,127.0,5,1111,24.0,843.0,843.0
0.004,6,10,2006,5,927,1.0,659.0,659.0,5,1079,1.0,811.0,811.0
0.005,17,2,169,1,62,0.0,34.0,34.0,1,107,0.0,79.0,79.0
1772.188,6,103,6166,59,3473,30554.0,27.0,27.0,44,2693,41212.0,27.0,27.0
0.006,6,10,1547,5,764,1.0,496.0,496.0,5,783,1.0,515.0,515.0
0.094,6,10,1506,5,395,20.0,127.0,127.0,5,1111,20.0,843.0,843.0
0.015,6,10,1972,5,910,3.0,642.0,642.0,5,1062,3.0,794.0,794.0
0.005,6,10,1854,5,889,1.0,621.0,621.0,5,965,1.0,697.0,697.0
0.017,6,10,1989,5,910,4.0,642.0,642.0,5,1079,4.0,811.0,811.0
0.098,6,10,1506,5,395,23.0,127.0,127.0,5,1111,21.0,843.0,843.0
15.083,17,15,8650,8,6490,2150.0,1350.0,783.0,7,2160,2508.0,1350.0,280.0
0.081,6,10,1506,5,395,19.0,127.0,127.0,5,1111,15.0,843.0,843.0
0.005,6,10,2006,5,927,1.0,659.0,659.0,5,1079,1.0,811.0,811.0
368.782,6,22,2313,16,867,24585.0,195.0,195.0,6,1446,4636.0,419.0,398.0
0.008,6,10,1989,5,910,2.0,642.0,642.0,5,1079,1.0,811.0,811.0
0.006,6,10,1547,5,764,1.0,496.0,496.0,5,783,1.0,515.0,515.0
0.009,6,13,3735,7,497,1.0,125.0,125.0,6,3238,1.0,1470.0,1459.0
0.009,6,10,1989,5,910,2.0,642.0,642.0,5,1079,2.0,811.0,811.0
0.005,6,10,2007,5,928,1.0,660.0,660.0,5,1079,1.0,811.0,811.0
0.008,6,12,1926,6,1189,1.0,659.0,434.0,6,737,1.0,417.0,417.0
0.004,6,10,2000,5,927,1.0,659.0,659.0,5,1073,1.0,805.0,805.0
0.17,17,2,152,1,76,0.0,48.0,48.0,1,76,0.0,48.0,48.0
0.003,17,2,148,1,60,0.0,32.0,32.0,1,88,0.0,60.0,60.0
0.059,17,2,152,1,76,0.0,48.0,48.0,1,76,0.0,48.0,48.0
0.092,6,10,1506,5,395,20.0,127.0,127.0,5,1111,14.0,843.0,843.0
0.004,6,10,1702,5,863,1.0,595.0,595.0,5,839,0.0,571.0,571.0
0.005,6,10,2006,5,927,1.0,659.0,659.0,5,1079,1.0,811.0,811.0
0.006,6,10,1643,5,860,1.0,592.0,592.0,5,783,1.0,515.0,515.0
15.076,17,15,8334,8,6264,2149.0,1350.0,755.0,7,2070,2507.0,1350.0,267.0
0.001,17,2,152,1,68,0.0,40.0,40.0,1,84,0.0,56.0,56.0
0.006,6,10,1779,5,928,1.0,660.0,660.0,5,851,1.0,583.0,583.0
0.006,6,10,1547,5,764,1.0,496.0,496.0,5,783,1.0,515.0,515.0
0.004,6,10,2006,5,927,1.0,659.0,659.0,5,1079,1.0,811.0,811.0
0.006,6,10,1643,5,860,1.0,592.0,592.0,5,783,1.0,515.0,515.0
0.039,17,4,284,2,120,0.0,32.0,32.0,2,164,35.0,60.0,54.0
0.04,17,2,136,1,60,0.0,32.0,32.0,1,76,0.0,48.0,48.0
0.009,17,2,136,1,60,0.0,32.0,32.0,1,76,0.0,48.0,48.0
240.098,6,16,4481,9,963,30012.0,238.0,166.0,7,3518,40015.0,1402.0,786.0
240.137,6,16,4494,9,975,30017.0,238.0,166.0,7,3519,40016.0,1402.0,786.0
0.015,17,2,198,1,91,0.0,63.0,63.0,1,107,0.0,79.0,79.0
0.014,6,10,1972,5,910,3.0,642.0,642.0,5,1062,3.0,794.0,794.0
0.123,6,10,1506,5,395,28.0,127.0,127.0,5,1111,28.0,843.0,843.0
15.076,17,16,8610,8,6330,2149.0,1350.0,763.0,8,2280,2149.0,1350.0,257.0
0.004,6,10,1779,5,928,1.0,660.0,660.0,5,851,1.0,583.0,583.0
0.553,17,2,144,1,64,0.0,36.0,36.0,1,80,0.0,52.0,52.0
0.006,6,10,1689,5,839,1.0,571.0,571.0,5,850,1.0,582.0,582.0
0.004,17,2,148,1,60,0.0,32.0,32.0,1,88,0.0,60.0,60.0
0.015,6,10,1972,5,910,3.0,642.0,642.0,5,1062,3.0,794.0,794.0
0.103,6,10,1506,5,395,19.0,127.0,127.0,5,1111,23.0,843.0,843.0
0.017,6,10,1990,5,911,4.0,643.0,643.0,5,1079,4.0,811.0,811.0
0.103,6,10,1506,5,395,20.0,127.0,127.0,5,1111,20.0,843.0,843.0
0.005,6,10,1989,5,927,1.0,659.0,659.0,5,1062,1.0,794.0,794.0
52.945,6,37,10002,19,4484,500.0,1360.0,738.0,18,5518,3104.0,2667.0,435.0
0.005,6,10,2006,5,927,1.0,659.0,659.0,5,1079,1.0,811.0,811.0
0.004,6,10,2006,5,927,1.0,659.0,659.0,5,1079,1.0,811.0,811.0
0.005,6,10,2006,5,927,1.0,659.0,659.0,5,1079,1.0,811.0,811.0
0.005,17,2,148,1,60,0.0,32.0,32.0,1,88,0.0,60.0,60.0
0.001,17,2,179,1,62,0.0,34.0,34.0,1,117,0.0,89.0,89.0
0.083,6,10,1506,5,395,19.0,127.0,127.0,5,1111,16.0,843.0,843.0
0.005,6,10,1547,5,764,1.0,496.0,496.0,5,783,1.0,515.0,515.0
0.069,6,10,1506,5,395,14.0,127.0,127.0,5,1111,16.0,843.0,843.0
0.014,6,10,1990,5,911,3.0,643.0,643.0,5,1079,3.0,811.0,811.0
0.015,6,10,1762,5,911,3.0,643.0,643.0,5,851,3.0,583.0,583.0
0.081,6,10,1506,5,395,18.0,127.0,127.0,5,1111,18.0,843.0,843.0
0.003,17,2,148,1,60,0.0,32.0,32.0,1,88,0.0,60.0,60.0
0.005,17,2,170,1,65,0.0,37.0,37.0,1,105,0.0,77.0,77.0
0.006,17,2,170,1,65,0.0,37.0,37.0,1,105,0.0,77.0,77.0
0.003,17,2,148,1,60,0.0,32.0,32.0,1,88,0.0,60.0,60.0
0.006,17,2,140,1,62,0.0,34.0,34.0,1,78,0.0,50.0,50.0
0.95,6,24,8452,14,2108,73.0,1141.0,379.0,10,6344,86.0,2720.0,988.0
27.419,6,36,8316,18,1845,511.0,777.0,364.0,18,6471,1605.0,2720.0,478.0
492.962,6,36,13225,18,5048,28997.0,1402.0,586.0,18,8177,25466.0,1402.0,723.0
0.012,6,12,1926,6,1189,2.0,659.0,434.0,6,737,2.0,417.0,417.0
40.068,17,10,676,5,460,10014.0,104.0,64.0,5,216,10016.0,20.0,15.0
0.152,6,10,1506,5,395,35.0,127.0,127.0,5,1111,36.0,843.0,843.0
412.317,6,29,4409,12,3102,10917.0,494.0,494.0,17,1307,25769.0,83.0,83.0
0.003,17,2,148,1,60,0.0,32.0,32.0,1,88,0.0,60.0,60.0
240.013,6,9,787,5,488,60003.0,232.0,232.0,4,299,80003.0,83.0,83.0
0.005,6,10,2007,5,928,1.0,660.0,660.0,5,1079,1.0,811.0,811.0
0.13,17,4,284,2,120,6.0,32.0,32.0,2,164,126.0,60.0,54.0
0.013,6,10,1631,5,848,3.0,580.0,580.0,5,783,3.0,515.0,515.0
352.961,6,20,2210,6,1308,12006.0,494.0,494.0,14,902,27150.0,83.0,83.0
0.004,17,2,148,1,60,0.0,32.0,32.0,1,88,0.0,60.0,60.0
0.004,6,10,1989,5,927,1.0,659.0,659.0,5,1062,1.0,794.0,794.0
0.005,6,10,2000,5,927,1.0,659.0,659.0,5,1073,1.0,805.0,805.0
0.039,17,4,284,2,120,0.0,32.0,32.0,2,164,36.0,60.0,54.0
0.006,17,2,180,1,66,0.0,38.0,38.0,1,114,0.0,86.0,86.0
240.087,6,30,9200,15,6754,17149.0,1877.0,664.0,15,2446,17148.0,580.0,207.0
0.071,6,10,1506,5,395,16.0,127.0,127.0,5,1111,14.0,843.0,843.0
0.017,6,13,3816,7,578,2.0,206.0,206.0,6,3238,3.0,1470.0,1459.0
0.038,17,2,148,1,60,0.0,32.0,32.0,1,88,0.0,60.0,60.0
240.101,6,16,4480,9,963,30012.0,238.0,166.0,7,3517,40016.0,1402.0,786.0
0.005,17,2,136,1,60,0.0,32.0,32.0,1,76,0.0,48.0,48.0
0.011,6,10,1990,5,911,2.0,643.0,643.0,5,1079,2.0,811.0,811.0
0.01,6,10,1762,5,911,2.0,643.0,643.0,5,851,2.0,583.0,583.0
0.127,6,10,1506,5,395,31.0,127.0,127.0,5,1111,28.0,843.0,843.0
0.053,17,2,152,1,76,0.0,48.0,48.0,1,76,0.0,48.0,48.0
0.016,6,10,1989,5,910,3.0,642.0,642.0,5,1079,3.0,811.0,811.0
0.006,6,10,1547,5,764,1.0,496.0,496.0,5,783,1.0,515.0,515.0
0.063,6,10,1506,5,395,13.0,127.0,127.0,5,1111,15.0,843.0,843.0
0.005,6,10,2006,5,927,1.0,659.0,659.0,5,1079,1.0,811.0,811.0
0.007,6,10,1547,5,764,1.0,496.0,496.0,5,783,1.0,515.0,515.0
40.059,17,10,676,5,460,10014.0,104.0,64.0,5,216,10007.0,20.0,15.0
0.01,6,10,1989,5,910,2.0,642.0,642.0,5,1079,2.0,811.0,811.0
0.004,6,10,2006,5,927,1.0,659.0,659.0,5,1079,1.0,811.0,811.0
240.373,6,36,9472,17,1899,15023.0,623.0,199.0,19,7573,13353.0,1402.0,549.0
0.08,6,10,1506,5,395,18.0,127.0,127.0,5,1111,17.0,843.0,843.0
0.004,17,2,178,1,81,0.0,53.0,53.0,1,97,0.0,69.0,69.0
0.118,6,10,1506,5,395,27.0,127.0,127.0,5,1111,26.0,843.0,843.0
0.01,6,10,1989,5,910,2.0,642.0,642.0,5,1079,2.0,811.0,811.0
0.128,6,10,1506,5,395,28.0,127.0,127.0,5,1111,29.0,843.0,843.0
0.014,6,10,1990,5,911,3.0,643.0,643.0,5,1079,3.0,811.0,811.0
0.006,6,10,1689,5,839,1.0,571.0,571.0,5,850,1.0,582.0,582.0
0.001,17,2,180,1,66,0.0,38.0,38.0,1,114,0.0,86.0,86.0
0.078,6,10,1506,5,395,18.0,127.0,127.0,5,1111,17.0,843.0,843.0
0.116,6,10,1506,5,395,27.0,127.0,127.0,5,1111,26.0,843.0,843.0
412.284,6,29,4409,12,3102,10913.0,494.0,494.0,17,1307,25767.0,83.0,83.0
0.005,17,2,230,1,68,0.0,40.0,40.0,1,162,0.0,134.0,134.0
0.005,17,2,170,1,65,0.0,37.0,37.0,1,105,0.0,77.0,77.0
0.013,6,10,1990,5,911,3.0,643.0,643.0,5,1079,3.0,811.0,811.0
98.598,6,22,7437,11,1305,167.0,530.0,277.0,11,6132,9843.0,2720.0,946.0
0.006,17,2,144,1,64,0.0,36.0,36.0,1,80,0.0,52.0,52.0
0.009,6,10,2000,5,927,2.0,659.0,659.0,5,1073,2.0,805.0,805.0
0.003,17,2,136,1,60,0.0,32.0,32.0,1,76,0.0,48.0,48.0
0.01,6,10,1990,5,911,2.0,643.0,643.0,5,1079,2.0,811.0,811.0
0.091,6,10,1506,5,395,22.0,127.0,127.0,5,1111,22.0,843.0,843.0
0.006,17,2,144,1,64,0.0,36.0,36.0,1,80,0.0,52.0,52.0
0.034,6,13,3735,7,497,5.0,125.0,125.0,6,3238,6.0,1470.0,1459.0
0.014,6,10,1631,5,848,3.0,580.0,580.0,5,783,3.0,515.0,515.0
0.074,6,10,1506,5,395,16.0,127.0,127.0,5,1111,16.0,843.0,843.0
40.052,17,10,676,5,460,10012.0,104.0,64.0,5,216,10012.0,20.0,15.0
40.059,17,10,676,5,460,10013.0,104.0,64.0,5,216,10014.0,20.0,15.0
0.017,6,10,1989,5,910,4.0,642.0,642.0,5,1079,4.0,811.0,811.0
0.012,6,10,1762,5,911,3.0,643.0,643.0,5,851,2.0,583.0,583.0
0.006,6,13,3747,7,509,0.0,137.0,137.0,6,3238,1.0,1470.0,1459.0
0.005,6,10,2007,5,928,1.0,660.0,660.0,5,1079,1.0,811.0,811.0
0.007,6,12,1698,6,863,1.0,327.0,271.0,6,835,1.0,515.0,515.0
0.017,6,10,1677,5,827,4.0,559.0,559.0,5,850,4.0,582.0,582.0
0.012,6,10,1989,5,910,2.0,642.0,642.0,5,1079,3.0,811.0,811.0
240.104,6,30,9211,15,6923,17150.0,2048.0,683.0,15,2288,17150.0,580.0,214.0
0.003,17,2,148,1,60,0.0,32.0,32.0,1,88,0.0,60.0,60.0
0.007,6,10,1762,5,911,1.0,643.0,643.0,5,851,1.0,583.0,583.0
0.011,6,10,1990,5,911,2.0,643.0,643.0,5,1079,2.0,811.0,811.0
0.001,17,2,180,1,66,0.0,38.0,38.0,1,114,0.0,86.0,86.0
354.04,6,21,1794,16,1030,23602.0,190.0,190.0,5,764,60002.0,463.0,248.0
0.006,6,10,1689,5,839,1.0,571.0,571.0,5,850,1.0,582.0,582.0
0.006,17,2,212,1,74,0.0,46.0,46.0,1,138,0.0,110.0,110.0
0.011,6,10,1983,5,910,2.0,642.0,642.0,5,1073,2.0,805.0,805.0
0.012,6,10,1972,5,910,3.0,642.0,642.0,5,1062,2.0,794.0,794.0
0.008,6,10,1983,5,910,2.0,642.0,642.0,5,1073,2.0,805.0,805.0
0.014,6,10,1677,5,827,3.0,559.0,559.0,5,850,3.0,582.0,582.0
0.004,6,10,2006,5,927,1.0,659.0,659.0,5,1079,1.0,811.0,811.0
0.013,6,10,1989,5,910,3.0,642.0,642.0,5,1079,3.0,811.0,811.0
0.005,6,10,1989,5,927,1.0,659.0,659.0,5,1062,1.0,794.0,794.0
0.12,6,10,1506,5,395,28.0,127.0,127.0,5,1111,27.0,843.0,843.0
0.005,6,10,2006,5,927,1.0,659.0,659.0,5,1079,1.0,811.0,811.0
15.021,17,38,20082,22,17066,713.0,1350.0,747.0,16,3016,999.0,1350.0,160.0
0.016,6,10,1983,5,910,3.0,642.0,642.0,5,1073,4.0,805.0,805.0
0.005,17,2,180,1,58,0.0,30.0,30.0,1,122,0.0,94.0,94.0
290.167,6,389,348611,196,21756,1488.0,2692.0,825.0,193,326855,1511.0,3169.0,1769.0
0.005,6,10,2000,5,927,1.0,659.0,659.0,5,1073,1.0,805.0,805.0
0.006,6,10,1854,5,889,1.0,621.0,621.0,5,965,1.0,697.0,697.0
313.178,17,20,1124,10,716,34790.0,48.0,43.0,10,408,34790.0,20.0,12.0
0.006,6,10,1989,5,927,1.0,659.0,659.0,5,1062,1.0,794.0,794.0
0.014,6,10,1983,5,910,3.0,642.0,642.0,5,1073,3.0,805.0,805.0
0.004,6,10,2000,5,927,1.0,659.0,659.0,5,1073,1.0,805.0,805.0
0.083,6,10,1506,5,395,19.0,127.0,127.0,5,1111,17.0,843.0,843.0
0.012,6,10,1762,5,911,2.0,643.0,643.0,5,851,3.0,583.0,583.0
0.11,6,10,1506,5,395,25.0,127.0,127.0,5,1111,24.0,843.0,843.0
0.005,17,2,166,1,75,0.0,47.0,47.0,1,91,0.0,63.0,63.0
0.115,6,10,1506,5,395,27.0,127.0,127.0,5,1111,26.0,843.0,843.0
0.005,6,10,2007,5,928,1.0,660.0,660.0,5,1079,1.0,811.0,811.0
0.005,6,13,3690,7,452,0.0,80.0,80.0,6,3238,1.0,1470.0,1459.0
0.068,17,8,3613,4,1874,22.0,1350.0,440.0,4,1739,11.0,1350.0,406.0
0.074,6,10,1506,5,395,15.0,127.0,127.0,5,1111,15.0,843.0,843.0
0.068,17,8,3613,4,1874,22.0,1350.0,440.0,4,1739,11.0,1350.0,406.0
0.005,6,10,1774,5,923,1.0,655.0,655.0,5,851,1.0,583.0,583.0
0.006,6,10,1854,5,889,1.0,621.0,621.0,5,965,1.0,697.0,697.0
0.005,6,10,2006,5,927,1.0,659.0,659.0,5,1079,1.0,811.0,811.0
0.005,17,2,166,1,75,0.0,47.0,47.0,1,91,0.0,63.0,63.0
0.003,17,2,136,1,60,0.0,32.0,32.0,1,76,0.0,48.0,48.0
0.008,6,10,1972,5,910,2.0,642.0,642.0,5,1062,1.0,794.0,794.0
0.019,6,10,1989,5,910,4.0,642.0,642.0,5,1079,4.0,811.0,811.0
0.087,6,10,1506,5,395,20.0,127.0,127.0,5,1111,18.0,843.0,843.0
0.005,17,2,230,1,68,0.0,40.0,40.0,1,162,0.0,134.0,134.0
0.013,6,10,1989,5,910,3.0,642.0,642.0,5,1079,3.0,811.0,811.0
0.0,17,2,179,1,62,0.0,34.0,34.0,1,117,0.0,89.0,89.0
0.017,6,10,1989,5,910,4.0,642.0,642.0,5,1079,4.0,811.0,811.0
0.005,6,10,2006,5,927,1.0,659.0,659.0,5,1079,1.0,811.0,811.0
0.067,6,10,1506,5,395,13.0,127.0,127.0,5,1111,15.0,843.0,843.0
0.008,6,12,1926,6,1189,1.0,659.0,434.0,6,737,1.0,417.0,417.0
0.041,17,2,184,1,61,0.0,33.0,33.0,1,123,0.0,95.0,95.0
0.006,6,10,2006,5,927,1.0,659.0,659.0,5,1079,1.0,811.0,811.0
0.007,6,10,1547,5,764,1.0,496.0,496.0,5,783,1.0,515.0,515.0
0.006,6,10,1547,5,764,1.0,496.0,496.0,5,783,1.0,515.0,515.0
0.123,17,2,80,1,32,0.0,4.0,4.0,1,48,0.0,20.0,20.0
0.001,17,2,180,1,66,0.0,38.0,38.0,1,114,0.0,86.0,86.0
300.37,6,16,2170,9,684,37524.0,146.0,146.0,7,1486,50033.0,419.0,398.0
0.115,17,2,80,1,32,0.0,4.0,4.0,1,48,0.0,20.0,20.0
240.105,6,21,4925,11,941,24010.0,180.0,93.0,10,3984,26678.0,1592.0,576.0
0.004,6,10,2006,5,927,1.0,659.0,659.0,5,1079,1.0,811.0,811.0
0.003,17,2,148,1,60,0.0,32.0,32.0,1,88,0.0,60.0,60.0
0.011,6,10,1972,5,910,2.0,642.0,642.0,5,1062,2.0,794.0,794.0
0.011,6,10,1989,5,910,2.0,642.0,642.0,5,1079,2.0,811.0,811.0
0.134,17,2,80,1,32,0.0,4.0,4.0,1,48,0.0,20.0,20.0
0.01,6,10,1854,5,889,2.0,621.0,621.0,5,965,2.0,697.0,697.0
240.267,6,46,8927,22,5738,11441.0,1515.0,509.0,24,3189,10446.0,580.0,241.0
170.056,17,90,12943,45,3033,3864.0,44.0,39.0,45,9910,3864.0,239.0,192.0
0.005,6,10,2006,5,927,1.0,659.0,659.0,5,1079,1.0,811.0,811.0
0.005,6,10,2007,5,928,1.0,660.0,660.0,5,1079,1.0,811.0,811.0
309.764,17,20,1124,10,716,34404.0,48.0,43.0,10,408,34404.0,20.0,12.0
0.098,6,10,1506,5,395,20.0,127.0,127.0,5,1111,23.0,843.0,843.0
0.052,17,2,152,1,76,0.0,48.0,48.0,1,76,0.0,48.0,48.0
0.005,6,10,1689,5,839,1.0,571.0,571.0,5,850,1.0,582.0,582.0
0.04,17,2,184,1,61,0.0,33.0,33.0,1,123,0.0,95.0,95.0
0.014,6,10,1972,5,910,3.0,642.0,642.0,5,1062,3.0,794.0,794.0
0.004,6,10,2007,5,928,1.0,660.0,660.0,5,1079,1.0,811.0,811.0
0.04,17,2,136,1,60,0.0,32.0,32.0,1,76,0.0,48.0,48.0
0.011,6,10,1677,5,827,2.0,559.0,559.0,5,850,2.0,582.0,582.0
0.008,6,13,3735,7,497,1.0,125.0,125.0,6,3238,1.0,1470.0,1459.0
0.004,17,4,284,2,120,0.0,32.0,32.0,2,164,0.0,60.0,54.0
0.005,6,10,1774,5,923,1.0,655.0,655.0,5,851,1.0,583.0,583.0
0.133,6,10,1506,5,395,19.0,127.0,127.0,5,1111,30.0,843.0,843.0
1778.603,17,143,45188,72,22752,25050.0,288.0,288.0,71,22436,25408.0,288.0,288.0
0.196,6,10,1506,5,395,46.0,127.0,127.0,5,1111,46.0,843.0,843.0
0.005,6,10,1989,5,927,1.0,659.0,659.0,5,1062,1.0,794.0,794.0
0.106,6,10,1506,5,395,24.0,127.0,127.0,5,1111,25.0,843.0,843.0
0.005,17,2,140,1,62,0.0,34.0,34.0,1,78,0.0,50.0,50.0
0.093,6,10,1506,5,395,21.0,127.0,127.0,5,1111,21.0,843.0,843.0
308.493,17,20,1124,10,716,34266.0,48.0,43.0,10,408,34263.0,20.0,12.0
241.498,6,320,344689,116,17551,2099.0,2736.0,886.0,204,327138,1189.0,2804.0,1631.0
0.005,17,2,170,1,65,0.0,37.0,37.0,1,105,0.0,77.0,77.0
0.005,6,10,2007,5,928,1.0,660.0,660.0,5,1079,1.0,811.0,811.0
0.014,6,10,1989,5,910,3.0,642.0,642.0,5,1079,3.0,811.0,811.0
0.014,6,10,1631,5,848,3.0,580.0,580.0,5,783,3.0,515.0,515.0
40.057,17,10,676,5,460,10013.0,104.0,64.0,5,216,10013.0,20.0,15.0
0.009,6,10,1989,5,910,2.0,642.0,642.0,5,1079,2.0,811.0,811.0
0.006,6,13,3747,7,509,0.0,137.0,137.0,6,3238,1.0,1470.0,1459.0
0.004,6,10,1702,5,863,1.0,595.0,595.0,5,839,0.0,571.0,571.0
0.017,6,10,1631,5,848,4.0,580.0,580.0,5,783,4.0,515.0,515.0
0.004,17,2,136,1,60,0.0,32.0,32.0,1,76,0.0,48.0,48.0
0.008,17,2,194,1,59,0.0,31.0,31.0,1,135,0.0,107.0,107.0
0.013,6,13,3735,7,497,2.0,125.0,125.0,6,3238,2.0,1470.0,1459.0
0.005,6,10,2007,5,928,1.0,660.0,660.0,5,1079,1.0,811.0,811.0
0.005,6,10,2000,5,927,1.0,659.0,659.0,5,1073,1.0,805.0,805.0
0.004,6,10,2000,5,927,1.0,659.0,659.0,5,1073,1.0,805.0,805.0
0.012,17,2,170,1,65,0.0,37.0,37.0,1,105,0.0,77.0,77.0
0.01,6,10,1983,5,910,2.0,642.0,642.0,5,1073,2.0,805.0,805.0
170.2,17,74,10462,37,2462,4726.0,44.0,38.0,37,8000,4727.0,239.0,188.0
176.438,17,76,11164,38,2542,4768.0,44.0,38.0,38,8622,4768.0,252.0,198.0
0.017,6,10,1983,5,910,4.0,642.0,642.0,5,1073,4.0,805.0,805.0
0.004,17,4,284,2,120,0.0,32.0,32.0,2,164,0.0,60.0,54.0
0.005,6,10,2007,5,928,1.0,660.0,660.0,5,1079,1.0,811.0,811.0
0.012,6,10,1990,5,911,2.0,643.0,643.0,5,1079,3.0,811.0,811.0
0.001,17,2,180,1,66,0.0,38.0,38.0,1,114,0.0,86.0,86.0
0.008,6,10,1989,5,910,2.0,642.0,642.0,5,1079,2.0,811.0,811.0
0.005,6,10,1779,5,928,1.0,660.0,660.0,5,851,1.0,583.0,583.0
0.006,17,2,179,1,71,0.0,43.0,43.0,1,108,0.0,80.0,80.0
0.004,17,2,156,1,64,0.0,36.0,36.0,1,92,0.0,64.0,64.0
0.101,6,10,1506,5,395,23.0,127.0,127.0,5,1111,21.0,843.0,843.0
0.002,17,2,136,1,60,0.0,32.0,32.0,1,76,0.0,48.0,48.0
0.073,17,2,170,1,65,0.0,37.0,37.0,1,105,0.0,77.0,77.0
0.004,17,4,284,2,120,0.0,32.0,32.0,2,164,0.0,60.0,54.0
0.01,6,10,1989,5,910,2.0,642.0,642.0,5,1079,2.0,811.0,811.0
0.012,6,10,1972,5,910,3.0,642.0,642.0,5,1062,3.0,794.0,794.0
0.011,6,10,1983,5,910,2.0,642.0,642.0,5,1073,2.0,805.0,805.0
15.074,17,15,9238,8,6902,2149.0,1350.0,834.0,7,2336,2507.0,1350.0,305.0
0.014,6,10,1990,5,911,3.0,643.0,643.0,5,1079,3.0,811.0,811.0
0.006,6,10,1547,5,764,1.0,496.0,496.0,5,783,1.0,515.0,515.0
0.006,6,10,1854,5,889,1.0,621.0,621.0,5,965,1.0,697.0,697.0
0.011,6,10,1983,5,910,2.0,642.0,642.0,5,1073,2.0,805.0,805.0
0.005,17,2,180,1,58,0.0,30.0,30.0,1,122,0.0,94.0,94.0
0.011,6,10,1972,5,910,2.0,642.0,642.0,5,1062,2.0,794.0,794.0
0.005,17,2,230,1,68,0.0,40.0,40.0,1,162,0.0,134.0,134.0
0.006,6,10,1547,5,764,1.0,496.0,496.0,5,783,1.0,515.0,515.0
0.019,6,6,716,3,458,7.0,302.0,302.0,3,258,6.0,102.0,102.0
0.022,6,10,1990,5,911,5.0,643.0,643.0,5,1079,5.0,811.0,811.0
0.011,6,10,1972,5,910,2.0,642.0,642.0,5,1062,2.0,794.0,794.0
0.004,17,2,148,1,60,0.0,32.0,32.0,1,88,0.0,60.0,60.0
0.003,17,2,136,1,60,0.0,32.0,32.0,1,76,0.0,48.0,48.0
10.908,17,28,4422,14,1994,830.0,269.0,114.0,14,2428,830.0,587.0,145.0
0.079,6,10,1506,5,395,15.0,127.0,127.0,5,1111,16.0,843.0,843.0
0.015,6,10,1990,5,911,3.0,643.0,643.0,5,1079,3.0,811.0,811.0
0.079,6,10,1506,5,395,17.0,127.0,127.0,5,1111,17.0,843.0,843.0
0.005,17,2,170,1,65,0.0,37.0,37.0,1,105,0.0,77.0,77.0
0.076,6,10,1506,5,395,17.0,127.0,127.0,5,1111,17.0,843.0,843.0
0.983,6,13,3930,7,2139,123.0,1328.0,923.0,6,1791,147.0,1539.0,1539.0
0.016,6,10,1989,5,910,4.0,642.0,642.0,5,1079,3.0,811.0,811.0
0.01,6,10,1989,5,910,2.0,642.0,642.0,5,1079,2.0,811.0,811.0
0.006,6,10,1547,5,764,1.0,496.0,496.0,5,783,1.0,515.0,515.0
11.015,17,26,4102,13,1846,908.0,269.0,114.0,13,2256,908.0,587.0,145.0
0.006,6,10,2000,5,927,1.0,659.0,659.0,5,1073,1.0,805.0,805.0
0.083,6,10,1506,5,395,18.0,127.0,127.0,5,1111,19.0,843.0,843.0
0.115,6,10,1506,5,395,27.0,127.0,127.0,5,1111,27.0,843.0,843.0
0.123,6,10,1506,5,395,29.0,127.0,127.0,5,1111,26.0,843.0,843.0
0.004,6,10,2006,5,927,1.0,659.0,659.0,5,1079,1.0,811.0,811.0
15.069,17,15,9239,8,6902,2148.0,1350.0,834.0,7,2337,2506.0,1350.0,305.0
0.227,6,16,2777,8,1395,32.0,533.0,323.0,8,1382,20.0,529.0,239.0
0.004,6,10,1779,5,928,1.0,660.0,660.0,5,851,1.0,583.0,583.0
0.013,6,10,1972,5,910,3.0,642.0,642.0,5,1062,3.0,794.0,794.0
0.086,6,10,1506,5,395,19.0,127.0,127.0,5,1111,20.0,843.0,843.0
0.015,6,10,1983,5,910,3.0,642.0,642.0,5,1073,3.0,805.0,805.0
0.016,6,10,1990,5,911,4.0,643.0,643.0,5,1079,4.0,811.0,811.0
0.006,6,10,1774,5,923,1.0,655.0,655.0,5,851,1.0,583.0,583.0
0.094,6,10,1506,5,395,19.0,127.0,127.0,5,1111,19.0,843.0,843.0
0.01,6,10,1983,5,910,2.0,642.0,642.0,5,1073,2.0,805.0,805.0
240.091,6,16,4481,9,963,30011.0,238.0,166.0,7,3518,40014.0,1402.0,786.0
0.001,17,2,136,1,60,0.0,32.0,32.0,1,76,0.0,48.0,48.0
180.526,6,46,12025,26,3886,7221.0,1027.0,251.0,20,8139,9501.0,2694.0,591.0
0.005,6,10,2006,5,927,1.0,659.0,659.0,5,1079,1.0,811.0,811.0
0.005,6,10,2006,5,927,1.0,659.0,659.0,5,1079,1.0,811.0,811.0
0.016,6,10,1989,5,910,3.0,642.0,642.0,5,1079,4.0,811.0,811.0
0.097,6,10,1506,5,395,17.0,127.0,127.0,5,1111,22.0,843.0,843.0
0.025,6,10,1605,5,388,6.0,120.0,120.0,5,1217,6.0,949.0,949.0
0.009,6,10,1643,5,860,2.0,592.0,592.0,5,783,2.0,515.0,515.0
0.005,6,10,2000,5,927,1.0,659.0,659.0,5,1073,1.0,805.0,805.0
0.005,6,10,1989,5,927,1.0,659.0,659.0,5,1062,1.0,794.0,794.0
0.005,6,10,1989,5,927,1.0,659.0,659.0,5,1062,1.0,794.0,794.0
0.014,6,10,1972,5,910,3.0,642.0,642.0,5,1062,3.0,794.0,794.0
168.033,17,106,15380,53,3576,3231.0,44.0,39.0,53,11804,3231.0,261.0,194.0
0.107,6,10,1506,5,395,26.0,127.0,127.0,5,1111,23.0,843.0,843.0
40.071,17,10,676,5,460,10015.0,104.0,64.0,5,216,10016.0,20.0,15.0
0.091,6,10,1506,5,395,19.0,127.0,127.0,5,1111,17.0,843.0,843.0
0.94,6,25,8459,14,2075,72.0,1140.0,370.0,11,6384,77.0,2720.0,988.0
0.018,6,10,1983,5,910,4.0,642.0,642.0,5,1073,4.0,805.0,805.0
10.917,17,28,4421,14,1993,831.0,268.0,114.0,14,2428,831.0,587.0,145.0
0.005,6,10,2006,5,927,1.0,659.0,659.0,5,1079,1.0,811.0,811.0
0.005,6,10,2006,5,927,1.0,659.0,659.0,5,1079,1.0,811.0,811.0
0.006,6,10,1547,5,764,1.0,496.0,496.0,5,783,1.0,515.0,515.0
0.009,6,10,1631,5,848,2.0,580.0,580.0,5,783,2.0,515.0,515.0
0.163,17,2,152,1,76,0.0,48.0,48.0,1,76,0.0,48.0,48.0
0.013,6,10,1990,5,911,3.0,643.0,643.0,5,1079,3.0,811.0,811.0
0.015,6,10,1972,5,910,3.0,642.0,642.0,5,1062,3.0,794.0,794.0
0.086,6,10,1506,5,395,18.0,127.0,127.0,5,1111,17.0,843.0,843.0
0.016,6,10,1972,5,910,4.0,642.0,642.0,5,1062,3.0,794.0,794.0
277.346,6,25,7264,15,1811,19810.0,253.0,207.0,10,5453,30815.0,1402.0,703.0
0.11,6,10,1506,5,395,25.0,127.0,127.0,5,1111,24.0,843.0,843.0
0.08,6,10,1506,5,395,18.0,127.0,127.0,5,1111,17.0,843.0,843.0
0.004,17,2,136,1,60,0.0,32.0,32.0,1,76,0.0,48.0,48.0
0.043,17,2,225,1,65,0.0,37.0,37.0,1,160,0.0,132.0,132.0
0.001,17,2,136,1,60,0.0,32.0,32.0,1,76,0.0,48.0,48.0
0.012,6,10,1989,5,910,3.0,642.0,642.0,5,1079,3.0,811.0,811.0
0.006,6,10,1547,5,764,1.0,496.0,496.0,5,783,1.0,515.0,515.0
0.012,6,10,1990,5,911,2.0,643.0,643.0,5,1079,2.0,811.0,811.0
0.084,6,10,1506,5,395,19.0,127.0,127.0,5,1111,18.0,843.0,843.0
300.31,6,16,2170,9,684,37517.0,146.0,146.0,7,1486,50023.0,419.0,398.0
0.009,6,10,1989,5,910,2.0,642.0,642.0,5,1079,2.0,811.0,811.0
0.016,17,2,198,1,91,0.0,63.0,63.0,1,107,0.0,79.0,79.0
40.066,17,10,676,5,460,10014.0,104.0,64.0,5,216,10015.0,20.0,15.0
0.111,6,10,1506,5,395,25.0,127.0,127.0,5,1111,22.0,843.0,843.0
0.018,6,10,1677,5,827,4.0,559.0,559.0,5,850,4.0,582.0,582.0
0.094,6,10,1506,5,395,19.0,127.0,127.0,5,1111,21.0,843.0,843.0
0.006,6,10,2006,5,927,1.0,659.0,659.0,5,1079,1.0,811.0,811.0
0.004,6,10,1702,5,863,1.0,595.0,595.0,5,839,0.0,571.0,571.0
353.598,6,20,2210,6,1308,12003.0,494.0,494.0,14,902,27199.0,83.0,83.0
0.061,6,10,1506,5,395,13.0,127.0,127.0,5,1111,13.0,843.0,843.0
0.017,6,10,1989,5,910,4.0,642.0,642.0,5,1079,4.0,811.0,811.0
0.005,6,13,3747,7,509,0.0,137.0,137.0,6,3238,0.0,1470.0,1459.0
1755.509,6,454,66069,253,35232,6966.0,613.0,197.0,201,30837,8777.0,453.0,144.0
0.013,6,10,1990,5,911,3.0,643.0,643.0,5,1079,3.0,811.0,811.0
0.005,6,10,1779,5,928,1.0,660.0,660.0,5,851,1.0,583.0,583.0
11.083,17,28,4422,14,1994,840.0,269.0,114.0,14,2428,840.0,587.0,145.0
0.004,6,10,1989,5,927,1.0,659.0,659.0,5,1062,1.0,794.0,794.0
0.072,17,2,136,1,60,0.0,32.0,32.0,1,76,0.0,48.0,48.0
241.478,6,366,347146,191,21462,1270.0,2736.0,960.0,175,325684,1387.0,2933.0,1918.0
0.017,17,2,198,1,91,0.0,63.0,63.0,1,107,0.0,79.0,79.0
0.137,6,10,1506,5,395,33.0,127.0,127.0,5,1111,32.0,843.0,843.0
0.004,17,2,136,1,60,0.0,32.0,32.0,1,76,0.0,48.0,48.0
0.005,17,2,179,1,71,0.0,43.0,43.0,1,108,0.0,80.0,80.0
0.015,6,10,1983,5,910,3.0,642.0,642.0,5,1073,3.0,805.0,805.0
0.112,6,10,1506,5,395,24.0,127.0,127.0,5,1111,24.0,843.0,843.0
40.07,17,10,676,5,460,10016.0,104.0,64.0,5,216,10016.0,20.0,15.0
0.006,6,10,2006,5,927,1.0,659.0,659.0,5,1079,1.0,811.0,811.0
0.003,17,4,284,2,120,0.0,32.0,32.0,2,164,0.0,60.0,54.0
0.022,6,10,1631,5,848,5.0,580.0,580.0,5,783,5.0,515.0,515.0
0.003,17,2,148,1,60,0.0,32.0,32.0,1,88,0.0,60.0,60.0
0.004,6,10,2006,5,927,1.0,659.0,659.0,5,1079,1.0,811.0,811.0
0.012,6,10,1989,5,910,3.0,642.0,642.0,5,1079,3.0,811.0,811.0
0.004,17,2,136,1,60,0.0,32.0,32.0,1,76,0.0,48.0,48.0
0.075,6,10,1506,5,395,17.0,127.0,127.0,5,1111,15.0,843.0,843.0
11.215,17,28,4418,14,1994,850.0,269.0,114.0,14,2424,850.0,587.0,145.0
0.005,6,14,3742,8,504,0.0,80.0,80.0,6,3238,0.0,1470.0,1459.0
0.006,6,10,1689,5,839,1.0,571.0,571.0,5,850,1.0,582.0,582.0
0.009,6,10,1762,5,911,2.0,643.0,643.0,5,851,2.0,583.0,583.0
122.293,6,26,9525,12,1627,78.0,794.0,367.0,14,7898,9397.0,1360.0,732.0
0.006,6,10,1989,5,927,1.0,659.0,659.0,5,1062,1.0,794.0,794.0
0.006,6,10,1779,5,928,1.0,660.0,660.0,5,851,1.0,583.0,583.0
0.006,6,10,2000,5,927,1.0,659.0,659.0,5,1073,1.0,805.0,805.0
1770.661,17,120,11460,60,5460,30010.0,63.0,63.0,60,6000,30010.0,72.0,72.0
0.117,6,10,1506,5,395,27.0,127.0,127.0,5,1111,27.0,843.0,843.0
10.702,17,28,4421,14,1994,815.0,269.0,114.0,14,2427,815.0,586.0,145.0
0.005,6,10,1989,5,927,1.0,659.0,659.0,5,1062,1.0,794.0,794.0
0.041,17,2,148,1,60,0.0,32.0,32.0,1,88,0.0,60.0,60.0
0.009,6,10,1989,5,910,2.0,642.0,642.0,5,1079,2.0,811.0,811.0
0.013,6,10,1972,5,910,3.0,642.0,642.0,5,1062,3.0,794.0,794.0
0.111,6,10,1506,5,395,24.0,127.0,127.0,5,1111,22.0,843.0,843.0
0.012,6,10,1972,5,910,3.0,642.0,642.0,5,1062,3.0,794.0,794.0
0.005,6,10,1547,5,764,1.0,496.0,496.0,5,783,1.0,515.0,515.0
0.006,17,2,140,1,62,0.0,34.0,34.0,1,78,0.0,50.0,50.0
40.051,17,10,676,5,460,10011.0,104.0,64.0,5,216,10011.0,20.0,15.0
0.006,6,10,1547,5,764,1.0,496.0,496.0,5,783,1.0,515.0,515.0
0.068,6,10,1506,5,395,15.0,127.0,127.0,5,1111,14.0,843.0,843.0
0.044,17,2,182,1,65,0.0,37.0,37.0,1,117,0.0,89.0,89.0
0.014,6,10,1990,5,911,3.0,643.0,643.0,5,1079,3.0,811.0,811.0
0.005,6,10,1643,5,860,1.0,592.0,592.0,5,783,1.0,515.0,515.0
0.005,6,10,1643,5,860,1.0,592.0,592.0,5,783,1.0,515.0,515.0
0.008,17,2,194,1,59,0.0,31.0,31.0,1,135,0.0,107.0,107.0
0.006,6,10,1689,5,839,1.0,571.0,571.0,5,850,1.0,582.0,582.0
0.12,6,10,1506,5,395,27.0,127.0,127.0,5,1111,23.0,843.0,843.0
0.006,6,10,1643,5,860,1.0,592.0,592.0,5,783,1.0,515.0,515.0
0.01,6,10,1990,5,911,2.0,643.0,643.0,5,1079,2.0,811.0,811.0
0.001,17,2,136,1,60,0.0,32.0,32.0,1,76,0.0,48.0,48.0
0.004,17,2,213,1,69,0.0,41.0,41.0,1,144,0.0,116.0,116.0
0.004,6,10,1989,5,927,1.0,659.0,659.0,5,1062,1.0,794.0,794.0
0.005,6,10,1779,5,928,1.0,660.0,660.0,5,851,1.0,583.0,583.0
0.004,17,2,148,1,60,0.0,32.0,32.0,1,88,0.0,60.0,60.0
0.011,6,10,1972,5,910,2.0,642.0,642.0,5,1062,2.0,794.0,794.0
0.005,6,10,2006,5,927,1.0,659.0,659.0,5,1079,1.0,811.0,811.0
367.027,6,22,2313,16,867,24468.0,195.0,195.0,6,1446,4644.0,419.0,398.0
0.005,6,10,2000,5,927,1.0,659.0,659.0,5,1073,1.0,805.0,805.0
0.088,6,10,1506,5,395,21.0,127.0,127.0,5,1111,19.0,843.0,843.0
0.011,6,10,1989,5,910,2.0,642.0,642.0,5,1079,2.0,811.0,811.0
0.01,6,10,1677,5,827,2.0,559.0,559.0,5,850,2.0,582.0,582.0
161.447,17,88,12890,44,2971,3754.0,44.0,39.0,44,9919,3754.0,239.0,197.0
0.005,6,10,2000,5,927,1.0,659.0,659.0,5,1073,1.0,805.0,805.0
0.005,17,2,144,1,64,0.0,36.0,36.0,1,80,0.0,52.0,52.0
0.001,17,2,180,1,66,0.0,38.0,38.0,1,114,0.0,86.0,86.0
0.009,6,10,1989,5,910,2.0,642.0,642.0,5,1079,2.0,811.0,811.0
0.014,6,13,3735,7,497,2.0,125.0,125.0,6,3238,2.0,1470.0,1459.0
0.091,6,10,1506,5,395,19.0,127.0,127.0,5,1111,19.0,843.0,843.0
0.009,6,13,3735,7,497,1.0,125.0,125.0,6,3238,1.0,1470.0,1459.0
0.006,6,10,1547,5,764,1.0,496.0,496.0,5,783,1.0,515.0,515.0
15.071,17,15,9239,8,6902,2148.0,1350.0,834.0,7,2337,2506.0,1350.0,305.0
0.005,6,10,2006,5,927,1.0,659.0,659.0,5,1079,1.0,811.0,811.0
0.08,6,10,1506,5,395,19.0,127.0,127.0,5,1111,15.0,843.0,843.0
0.001,17,2,180,1,66,0.0,38.0,38.0,1,114,0.0,86.0,86.0
0.006,6,10,1702,5,863,1.0,595.0,595.0,5,839,1.0,571.0,571.0
240.304,6,45,8938,23,5814,10922.0,2883.0,573.0,22,3124,11442.0,580.0,219.0
0.005,6,10,1689,5,839,1.0,571.0,571.0,5,850,1.0,582.0,582.0
0.006,6,10,1547,5,764,1.0,496.0,496.0,5,783,1.0,515.0,515.0
0.005,6,10,1547,5,764,1.0,496.0,496.0,5,783,1.0,515.0,515.0
0.096,6,10,1506,5,395,20.0,127.0,127.0,5,1111,20.0,843.0,843.0
0.005,6,10,2006,5,927,1.0,659.0,659.0,5,1079,1.0,811.0,811.0
0.004,17,2,136,1,60,0.0,32.0,32.0,1,76,0.0,48.0,48.0
0.101,6,10,1506,5,395,21.0,127.0,127.0,5,1111,22.0,843.0,843.0
0.252,6,16,2777,8,1395,36.0,533.0,323.0,8,1382,24.0,529.0,239.0
0.097,6,10,1506,5,395,21.0,127.0,127.0,5,1111,22.0,843.0,843.0
0.003,17,2,136,1,60,0.0,32.0,32.0,1,76,0.0,48.0,48.0
0.018,6,10,1989,5,910,4.0,642.0,642.0,5,1079,4.0,811.0,811.0
0.019,6,10,1972,5,910,4.0,642.0,642.0,5,1062,4.0,794.0,794.0
0.001,17,2,180,1,66,0.0,38.0,38.0,1,114,0.0,86.0,86.0
0.13,6,10,1506,5,395,29.0,127.0,127.0,5,1111,31.0,843.0,843.0
0.006,6,10,1547,5,764,1.0,496.0,496.0,5,783,1.0,515.0,515.0
0.135,6,10,1506,5,395,29.0,127.0,127.0,5,1111,22.0,843.0,843.0
0.005,6,10,1689,5,839,1.0,571.0,571.0,5,850,1.0,582.0,582.0
0.086,6,10,1506,5,395,20.0,127.0,127.0,5,1111,18.0,843.0,843.0
40.059,17,10,676,5,460,10014.0,104.0,64.0,5,216,10013.0,20.0,15.0
0.005,6,10,1989,5,927,1.0,659.0,659.0,5,1062,1.0,794.0,794.0
0.105,17,4,284,2,120,0.0,32.0,32.0,2,164,73.0,60.0,54.0
0.012,6,10,1989,5,910,3.0,642.0,642.0,5,1079,3.0,811.0,811.0
300.023,6,12,1782,7,1348,50003.0,494.0,494.0,5,434,75005.0,83.0,83.0
0.005,6,10,2006,5,927,1.0,659.0,659.0,5,1079,1.0,811.0,811.0
0.01,6,13,3735,7,497,1.0,125.0,125.0,6,3238,2.0,1470.0,1459.0
11.21,17,28,4418,14,1995,849.0,270.0,114.0,14,2423,849.0,586.0,145.0
0.004,17,2,148,1,60,0.0,32.0,32.0,1,88,0.0,60.0,60.0
0.005,17,2,170,1,65,0.0,37.0,37.0,1,105,0.0,77.0,77.0
0.01,6,10,1972,5,910,2.0,642.0,642.0,5,1062,2.0,794.0,794.0
351.99,6,20,2210,6,1308,12003.0,494.0,494.0,14,902,27075.0,83.0,83.0
361.799,6,21,1793,16,1030,24119.0,190.0,190.0,5,763,60009.0,462.0,247.0
0.011,6,10,1983,5,910,2.0,642.0,642.0,5,1073,2.0,805.0,805.0
0.013,6,10,1989,5,910,3.0,642.0,642.0,5,1079,3.0,811.0,811.0
0.006,6,10,1547,5,764,1.0,496.0,496.0,5,783,1.0,515.0,515.0
240.291,6,46,8927,24,5842,10447.0,1368.0,458.0,22,3085,11442.0,580.0,241.0
368.615,6,22,2313,16,867,24574.0,195.0,195.0,6,1446,4668.0,419.0,398.0
300.798,6,38,13341,20,7823,15831.0,4080.0,1398.0,18,5518,507.0,2667.0,435.0
240.325,6,37,7631,20,2044,12648.0,517.0,166.0,17,5587,15020.0,1402.0,670.0
0.254,17,12,9092,7,6851,42.0,1350.0,950.0,5,2241,56.0,1350.0,420.0
0.005,17,2,214,1,75,0.0,47.0,47.0,1,139,0.0,111.0,111.0
0.039,17,2,156,1,64,0.0,36.0,36.0,1,92,0.0,64.0,64.0
0.039,17,2,156,1,64,0.0,36.0,36.0,1,92,0.0,64.0,64.0
0.011,6,10,1989,5,910,2.0,642.0,642.0,5,1079,2.0,811.0,811.0
0.007,6,10,1547,5,764,1.0,496.0,496.0,5,783,1.0,515.0,515.0
0.011,6,10,1989,5,910,2.0,642.0,642.0,5,1079,2.0,811.0,811.0
0.005,17,2,166,1,75,0.0,47.0,47.0,1,91,0.0,63.0,63.0
0.053,17,2,152,1,76,0.0,48.0,48.0,1,76,0.0,48.0,48.0
0.012,6,10,1631,5,848,3.0,580.0,580.0,5,783,3.0,515.0,515.0
240.711,6,42,11152,20,2216,12668.0,606.0,128.0,22,8936,11462.0,2164.0,649.0
0.217,6,4,493,2,321,217.0,241.0,241.0,2,172,3.0,92.0,92.0
0.004,17,2,136,1,60,0.0,32.0,32.0,1,76,0.0,48.0,48.0
40.066,17,10,676,5,460,10015.0,104.0,64.0,5,216,10015.0,20.0,15.0
0.005,6,10,1774,5,923,1.0,655.0,655.0,5,851,1.0,583.0,583.0
0.071,17,4,284,2,120,0.0,32.0,32.0,2,164,67.0,60.0,54.0
22.497,6,38,13338,19,7780,490.0,2720.0,1397.0,19,5558,1240.0,2667.0,435.0
0.014,6,10,1989,5,910,3.0,642.0,642.0,5,1079,3.0,811.0,811.0
0.009,17,2,179,1,71,0.0,43.0,43.0,1,108,0.0,80.0,80.0
0.093,6,10,1506,5,395,20.0,127.0,127.0,5,1111,20.0,843.0,843.0
0.004,6,13,3747,7,509,0.0,137.0,137.0,6,3238,0.0,1470.0,1459.0
0.074,6,10,1506,5,395,15.0,127.0,127.0,5,1111,14.0,843.0,843.0
0.005,17,2,180,1,58,0.0,30.0,30.0,1,122,0.0,94.0,94.0
0.016,6,10,1989,5,910,4.0,642.0,642.0,5,1079,3.0,811.0,811.0
0.091,6,10,1506,5,395,20.0,127.0,127.0,5,1111,19.0,843.0,843.0
0.006,6,10,1689,5,839,1.0,571.0,571.0,5,850,1.0,582.0,582.0
0.064,6,10,1506,5,395,13.0,127.0,127.0,5,1111,14.0,843.0,843.0
0.11,6,10,1506,5,395,26.0,127.0,127.0,5,1111,26.0,843.0,843.0
40.065,17,10,676,5,460,10013.0,104.0,64.0,5,216,10015.0,20.0,15.0
0.006,6,10,1854,5,889,1.0,621.0,621.0,5,965,1.0,697.0,697.0
0.005,6,10,1774,5,923,1.0,655.0,655.0,5,851,1.0,583.0,583.0
0.004,6,10,1989,5,927,1.0,659.0,659.0,5,1062,1.0,794.0,794.0
0.005,6,10,2006,5,927,1.0,659.0,659.0,5,1079,1.0,811.0,811.0
0.005,6,10,2007,5,928,1.0,660.0,660.0,5,1079,1.0,811.0,811.0
0.006,17,2,214,1,75,0.0,47.0,47.0,1,139,0.0,111.0,111.0
0.079,6,10,1506,5,395,19.0,127.0,127.0,5,1111,16.0,843.0,843.0
0.168,17,2,152,1,76,0.0,48.0,48.0,1,76,0.0,48.0,48.0
0.005,6,10,2006,5,927,1.0,659.0,659.0,5,1079,1.0,811.0,811.0
0.013,6,10,1983,5,910,3.0,642.0,642.0,5,1073,3.0,805.0,805.0
0.006,6,10,1854,5,889,1.0,621.0,621.0,5,965,1.0,697.0,697.0
11.126,17,28,4422,14,1994,847.0,269.0,114.0,14,2428,846.0,587.0,145.0
0.003,17,2,148,1,60,0.0,32.0,32.0,1,88,0.0,60.0,60.0
0.004,17,4,284,2,120,1.0,32.0,32.0,2,164,0.0,60.0,54.0
241.325,6,298,342358,113,17396,2154.0,2736.0,960.0,185,324962,1311.0,2804.0,1801.0
0.005,6,10,1689,5,839,1.0,571.0,571.0,5,850,1.0,582.0,582.0
178.065,17,92,13294,46,3092,3956.0,44.0,39.0,46,10202,3956.0,249.0,193.0
0.119,6,10,1506,5,395,28.0,127.0,127.0,5,1111,24.0,843.0,843.0
0.006,6,10,1547,5,764,1.0,496.0,496.0,5,783,1.0,515.0,515.0
40.056,17,10,676,5,460,10012.0,104.0,64.0,5,216,10013.0,20.0,15.0
0.005,6,10,1854,5,889,1.0,621.0,621.0,5,965,1.0,697.0,697.0
0.019,6,10,1990,5,911,4.0,643.0,643.0,5,1079,4.0,811.0,811.0
0.005,6,10,1854,5,889,1.0,621.0,621.0,5,965,1.0,697.0,697.0
0.009,6,14,3787,7,497,1.0,125.0,125.0,7,3290,1.0,1448.0,972.0
0.001,17,2,136,1,60,0.0,32.0,32.0,1,76,0.0,48.0,48.0
0.012,6,10,1989,5,910,3.0,642.0,642.0,5,1079,3.0,811.0,811.0
0.003,17,2,148,1,60,0.0,32.0,32.0,1,88,0.0,60.0,60.0
0.005,6,10,1989,5,927,1.0,659.0,659.0,5,1062,1.0,794.0,794.0
0.032,6,10,1972,5,910,7.0,642.0,642.0,5,1062,8.0,794.0,794.0
0.019,17,2,136,1,60,0.0,32.0,32.0,1,76,0.0,48.0,48.0
9.037,17,6,376,5,280,2259.0,28.0,28.0,1,96,0.0,68.0,68.0
0.081,6,10,1506,5,395,16.0,127.0,127.0,5,1111,15.0,843.0,843.0
0.005,6,10,2006,5,927,1.0,659.0,659.0,5,1079,1.0,811.0,811.0
0.011,6,10,1989,5,910,2.0,642.0,642.0,5,1079,2.0,811.0,811.0
0.006,6,10,1547,5,764,1.0,496.0,496.0,5,783,1.0,515.0,515.0
0.066,17,8,3613,4,1874,22.0,1350.0,440.0,4,1739,11.0,1350.0,406.0
0.014,6,10,1990,5,911,3.0,643.0,643.0,5,1079,3.0,811.0,811.0
0.008,6,10,1677,5,827,2.0,559.0,559.0,5,850,2.0,582.0,582.0
0.005,6,10,2007,5,928,1.0,660.0,660.0,5,1079,1.0,811.0,811.0
0.08,6,10,1506,5,395,16.0,127.0,127.0,5,1111,16.0,843.0,843.0
0.001,17,2,136,1,60,0.0,32.0,32.0,1,76,0.0,48.0,48.0
0.012,6,10,1983,5,910,2.0,642.0,642.0,5,1073,3.0,805.0,805.0
0.01,6,10,1989,5,910,2.0,642.0,642.0,5,1079,2.0,811.0,811.0
0.006,6,10,1689,5,839,1.0,571.0,571.0,5,850,1.0,582.0,582.0
0.009,6,10,1990,5,911,2.0,643.0,643.0,5,1079,2.0,811.0,811.0
0.098,6,10,1506,5,395,21.0,127.0,127.0,5,1111,22.0,843.0,843.0
0.008,6,10,1990,5,911,1.0,643.0,643.0,5,1079,2.0,811.0,811.0
0.008,6,10,1990,5,911,2.0,643.0,643.0,5,1079,2.0,811.0,811.0
0.006,6,10,1547,5,764,1.0,496.0,496.0,5,783,1.0,515.0,515.0
0.098,6,10,1506,5,395,20.0,127.0,127.0,5,1111,19.0,843.0,843.0
0.015,6,10,1983,5,910,3.0,642.0,642.0,5,1073,3.0,805.0,805.0
0.094,6,10,1506,5,395,18.0,127.0,127.0,5,1111,22.0,843.0,843.0
240.105,6,31,9382,15,7030,17150.0,2156.0,694.0,16,2352,16006.0,580.0,189.0
351.989,6,20,2210,6,1308,12003.0,494.0,494.0,14,902,27075.0,83.0,83.0
282.485,6,24,6440,11,1226,28248.0,267.0,156.0,13,5214,23539.0,1400.0,781.0
0.095,6,10,1506,5,395,19.0,127.0,127.0,5,1111,23.0,843.0,843.0
0.008,6,10,1989,5,910,2.0,642.0,642.0,5,1079,1.0,811.0,811.0
0.005,17,2,170,1,65,0.0,37.0,37.0,1,105,0.0,77.0,77.0
0.01,6,10,1989,5,910,2.0,642.0,642.0,5,1079,2.0,811.0,811.0
0.005,6,10,1989,5,927,1.0,659.0,659.0,5,1062,1.0,794.0,794.0
0.011,6,14,3787,7,497,1.0,125.0,125.0,7,3290,1.0,1448.0,972.0
0.011,6,10,1677,5,827,2.0,559.0,559.0,5,850,2.0,582.0,582.0
0.003,17,2,132,1,58,0.0,30.0,30.0,1,74,0.0,46.0,46.0
0.006,6,10,1547,5,764,1.0,496.0,496.0,5,783,1.0,515.0,515.0
463.037,6,29,7795,16,3168,30869.0,676.0,388.0,13,4627,33585.0,1402.0,657.0
0.039,17,2,182,1,65,0.0,37.0,37.0,1,117,0.0,89.0,89.0
0.006,6,10,1989,5,927,1.0,659.0,659.0,5,1062,1.0,794.0,794.0
40.051,17,10,676,5,460,10012.0,104.0,64.0,5,216,10011.0,20.0,15.0
240.08,6,16,4480,9,963,30010.0,238.0,166.0,7,3517,40012.0,1402.0,786.0
308.579,17,18,1008,9,640,38556.0,48.0,43.0,9,368,38556.0,20.0,12.0
0.009,6,10,1983,5,910,2.0,642.0,642.0,5,1073,2.0,805.0,805.0
1799.996,6,233,28110,88,19088,20345.0,2720.0,207.0,145,9022,12499.0,148.0,47.0
240.015,6,9,787,5,488,60003.0,232.0,232.0,4,299,80003.0,83.0,83.0
0.083,6,10,1506,5,395,19.0,127.0,127.0,5,1111,19.0,843.0,843.0
0.132,6,10,1506,5,395,22.0,127.0,127.0,5,1111,29.0,843.0,843.0
369.69,6,22,2313,16,867,24646.0,195.0,195.0,6,1446,4646.0,419.0,398.0
0.003,17,2,148,1,60,0.0,32.0,32.0,1,88,0.0,60.0,60.0
0.005,6,10,2007,5,928,1.0,660.0,660.0,5,1079,1.0,811.0,811.0
0.007,6,10,1762,5,911,1.0,643.0,643.0,5,851,1.0,583.0,583.0
0.016,6,10,1989,5,910,3.0,642.0,642.0,5,1079,3.0,811.0,811.0
0.01,6,10,1989,5,910,2.0,642.0,642.0,5,1079,2.0,811.0,811.0
0.014,6,10,1990,5,911,3.0,643.0,643.0,5,1079,3.0,811.0,811.0
0.072,6,10,1506,5,395,15.0,127.0,127.0,5,1111,15.0,843.0,843.0
0.005,6,10,2006,5,927,1.0,659.0,659.0,5,1079,1.0,811.0,811.0
0.005,6,10,2006,5,927,1.0,659.0,659.0,5,1079,1.0,811.0,811.0
0.081,6,10,1506,5,395,18.0,127.0,127.0,5,1111,17.0,843.0,843.0
0.012,6,10,1972,5,910,2.0,642.0,642.0,5,1062,3.0,794.0,794.0
0.004,17,4,284,2,120,0.0,32.0,32.0,2,164,0.0,60.0,54.0
0.012,6,10,1631,5,848,3.0,580.0,580.0,5,783,3.0,515.0,515.0
0.001,17,2,180,1,66,0.0,38.0,38.0,1,114,0.0,86.0,86.0
0.08,6,10,1506,5,395,19.0,127.0,127.0,5,1111,19.0,843.0,843.0
0.014,6,10,1990,5,911,3.0,643.0,643.0,5,1079,3.0,811.0,811.0
0.015,6,10,1989,5,910,3.0,642.0,642.0,5,1079,3.0,811.0,811.0
0.005,6,14,3799,7,509,0.0,137.0,137.0,7,3290,0.0,1448.0,972.0
0.092,6,10,1506,5,395,20.0,127.0,127.0,5,1111,19.0,843.0,843.0
0.011,6,10,1989,5,910,2.0,642.0,642.0,5,1079,2.0,811.0,811.0
0.091,6,10,1506,5,395,17.0,127.0,127.0,5,1111,21.0,843.0,843.0
0.014,6,10,1990,5,911,3.0,643.0,643.0,5,1079,3.0,811.0,811.0
0.011,6,10,1972,5,910,2.0,642.0,642.0,5,1062,2.0,794.0,794.0
0.115,6,10,1506,5,395,25.0,127.0,127.0,5,1111,25.0,843.0,843.0
0.004,6,10,2000,5,927,1.0,659.0,659.0,5,1073,1.0,805.0,805.0
1797.813,6,299,43065,126,25472,14381.0,2058.0,210.0,173,17593,10451.0,1360.0,130.0
0.004,6,10,1702,5,863,1.0,595.0,595.0,5,839,1.0,571.0,571.0
0.008,6,10,1990,5,911,2.0,643.0,643.0,5,1079,2.0,811.0,811.0
0.019,6,10,1972,5,910,4.0,642.0,642.0,5,1062,4.0,794.0,794.0
0.004,17,2,136,1,60,0.0,32.0,32.0,1,76,0.0,48.0,48.0
0.009,6,10,1631,5,848,2.0,580.0,580.0,5,783,2.0,515.0,515.0
0.08,6,10,1506,5,395,17.0,127.0,127.0,5,1111,18.0,843.0,843.0
0.001,17,2,180,1,66,0.0,38.0,38.0,1,114,0.0,86.0,86.0
70.937,6,26,9525,12,1627,74.0,794.0,367.0,14,7898,5446.0,1360.0,732.0
0.012,6,10,1990,5,911,3.0,643.0,643.0,5,1079,3.0,811.0,811.0
0.005,17,2,164,1,74,0.0,46.0,46.0,1,90,0.0,62.0,62.0
0.005,6,10,2006,5,927,1.0,659.0,659.0,5,1079,1.0,811.0,811.0
0.007,6,10,1689,5,839,1.0,571.0,571.0,5,850,1.0,582.0,582.0
40.064,17,10,676,5,460,10014.0,104.0,64.0,5,216,10014.0,20.0,15.0
0.006,6,10,2000,5,927,1.0,659.0,659.0,5,1073,1.0,805.0,805.0
0.005,6,14,3742,7,452,0.0,80.0,80.0,7,3290,0.0,1448.0,972.0
0.005,6,10,2006,5,927,1.0,659.0,659.0,5,1079,1.0,811.0,811.0
278.085,6,25,6722,15,2064,19863.0,253.0,214.0,10,4658,30897.0,1402.0,590.0
0.013,6,10,1677,5,827,3.0,559.0,559.0,5,850,3.0,582.0,582.0
0.004,6,10,1702,5,863,1.0,595.0,595.0,5,839,0.0,571.0,571.0
0.005,6,10,1854,5,889,1.0,621.0,621.0,5,965,1.0,697.0,697.0
40.081,17,10,676,5,460,10017.0,104.0,64.0,5,216,10019.0,20.0,15.0
15.079,17,15,8277,8,6055,2150.0,1350.0,728.0,7,2222,2508.0,1350.0,289.0
0.018,6,10,1972,5,910,4.0,642.0,642.0,5,1062,4.0,794.0,794.0
0.005,6,10,1989,5,927,1.0,659.0,659.0,5,1062,1.0,794.0,794.0
0.005,6,10,1643,5,860,1.0,592.0,592.0,5,783,1.0,515.0,515.0
158.408,17,80,11351,40,2668,4061.0,44.0,38.0,40,8683,4061.0,261.0,189.0
0.017,6,10,1762,5,911,4.0,643.0,643.0,5,851,4.0,583.0,583.0
0.005,6,10,1547,5,764,1.0,496.0,496.0,5,783,1.0,515.0,515.0
40.072,17,10,676,5,460,10016.0,104.0,64.0,5,216,10017.0,20.0,15.0
0.02,6,10,1989,5,910,5.0,642.0,642.0,5,1079,4.0,811.0,811.0
0.08,6,10,1506,5,395,19.0,127.0,127.0,5,1111,17.0,843.0,843.0
10.867,17,28,4421,14,1993,827.0,268.0,114.0,14,2428,827.0,587.0,145.0
0.007,17,2,179,1,71,0.0,43.0,43.0,1,108,0.0,80.0,80.0
0.006,6,10,1643,5,860,1.0,592.0,592.0,5,783,1.0,515.0,515.0
0.013,6,10,1990,5,911,3.0,643.0,643.0,5,1079,3.0,811.0,811.0
0.006,6,10,1547,5,764,1.0,496.0,496.0,5,783,1.0,515.0,515.0
0.078,6,10,1506,5,395,15.0,127.0,127.0,5,1111,17.0,843.0,843.0
0.016,6,10,1989,5,910,4.0,642.0,642.0,5,1079,3.0,811.0,811.0
0.012,6,10,1972,5,910,3.0,642.0,642.0,5,1062,2.0,794.0,794.0
0.08,6,10,1506,5,395,17.0,127.0,127.0,5,1111,15.0,843.0,843.0
0.01,6,10,1989,5,910,2.0,642.0,642.0,5,1079,2.0,811.0,811.0
0.022,6,10,1989,5,910,5.0,642.0,642.0,5,1079,5.0,811.0,811.0
0.071,17,2,146,1,65,0.0,37.0,37.0,1,81,0.0,53.0,53.0
0.005,6,10,1779,5,928,1.0,660.0,660.0,5,851,1.0,583.0,583.0
1793.608,6,286,27093,145,9983,12455.0,748.0,270.0,141,17110,12811.0,1624.0,72.0
0.005,17,2,214,1,75,0.0,47.0,47.0,1,139,0.0,111.0,111.0
0.019,6,10,1762,5,911,4.0,643.0,643.0,5,851,4.0,583.0,583.0
0.004,6,10,2000,5,927,1.0,659.0,659.0,5,1073,1.0,805.0,805.0
0.005,6,10,1989,5,927,1.0,659.0,659.0,5,1062,1.0,794.0,794.0
0.006,17,2,169,1,62,0.0,34.0,34.0,1,107,0.0,79.0,79.0
0.091,6,10,1506,5,395,18.0,127.0,127.0,5,1111,22.0,843.0,843.0
15.078,17,15,8369,8,6329,2149.0,1350.0,763.0,7,2040,2508.0,1350.0,263.0
308.355,17,20,1124,10,716,34246.0,48.0,43.0,10,408,34246.0,20.0,12.0
0.006,6,10,1689,5,839,1.0,571.0,571.0,5,850,1.0,582.0,582.0
0.094,6,10,1506,5,395,22.0,127.0,127.0,5,1111,20.0,843.0,843.0
0.003,17,2,136,1,60,0.0,32.0,32.0,1,76,0.0,48.0,48.0
0.008,6,10,2006,5,927,1.0,659.0,659.0,5,1079,2.0,811.0,811.0
0.005,17,2,164,1,74,0.0,46.0,46.0,1,90,0.0,62.0,62.0
15.157,17,52,27020,29,23599,540.0,1350.0,785.0,23,3421,687.0,1350.0,120.0
0.162,6,10,1506,5,395,38.0,127.0,127.0,5,1111,38.0,843.0,843.0
0.006,6,10,1854,5,889,1.0,621.0,621.0,5,965,1.0,697.0,697.0
0.005,17,2,164,1,74,0.0,46.0,46.0,1,90,0.0,62.0,62.0
1786.154,6,150,19350,90,13740,20069.0,302.0,302.0,60,5610,30273.0,83.0,83.0
0.119,6,10,1506,5,395,27.0,127.0,127.0,5,1111,22.0,843.0,843.0
40.099,17,10,676,5,460,10024.0,104.0,64.0,5,216,10024.0,20.0,15.0
312.483,17,20,1124,10,716,34706.0,48.0,43.0,10,408,34706.0,20.0,12.0
0.0,17,2,179,1,62,0.0,34.0,34.0,1,117,0.0,89.0,89.0
0.005,6,10,2006,5,927,1.0,659.0,659.0,5,1079,1.0,811.0,811.0
0.011,6,10,1989,5,910,2.0,642.0,642.0,5,1079,2.0,811.0,811.0
40.091,17,10,676,5,460,10019.0,104.0,64.0,5,216,10021.0,20.0,15.0
40.06,17,10,676,5,460,10014.0,104.0,64.0,5,216,10014.0,20.0,15.0
31.322,6,28,11295,15,1840,2237.0,538.0,350.0,13,9455,2606.0,2804.0,974.0
0.014,6,10,1689,5,839,3.0,571.0,571.0,5,850,3.0,582.0,582.0
0.001,17,2,136,1,60,0.0,32.0,32.0,1,76,0.0,48.0,48.0
40.06,17,10,676,5,460,10014.0,104.0,64.0,5,216,10014.0,20.0,15.0
0.005,6,10,2000,5,927,1.0,659.0,659.0,5,1073,1.0,805.0,805.0
0.021,6,10,1972,5,910,5.0,642.0,642.0,5,1062,5.0,794.0,794.0
0.006,6,10,1547,5,764,1.0,496.0,496.0,5,783,1.0,515.0,515.0
0.003,17,2,148,1,60,0.0,32.0,32.0,1,88,0.0,60.0,60.0
0.004,6,10,2000,5,927,1.0,659.0,659.0,5,1073,1.0,805.0,805.0
0.01,6,10,1989,5,910,2.0,642.0,642.0,5,1079,2.0,811.0,811.0
0.005,17,2,164,1,74,0.0,46.0,46.0,1,90,0.0,62.0,62.0
240.435,6,36,10553,18,2211,14141.0,555.0,253.0,18,8342,14141.0,1402.0,617.0
0.001,17,2,180,1,66,0.0,38.0,38.0,1,114,0.0,86.0,86.0
0.007,6,10,1854,5,889,1.0,621.0,621.0,5,965,1.0,697.0,697.0
0.085,6,10,1506,5,395,17.0,127.0,127.0,5,1111,18.0,843.0,843.0
301.228,6,51,20714,28,14767,11156.0,2720.0,1134.0,23,5947,409.0,2667.0,385.0
166.032,17,80,11483,40,2683,4257.0,44.0,39.0,40,8800,4257.0,260.0,192.0
0.005,6,13,3747,7,509,0.0,137.0,137.0,6,3238,1.0,1470.0,1459.0
0.015,6,10,1989,5,910,3.0,642.0,642.0,5,1079,3.0,811.0,811.0
0.001,17,2,180,1,66,0.0,38.0,38.0,1,114,0.0,86.0,86.0
0.107,6,10,1506,5,395,22.0,127.0,127.0,5,1111,24.0,843.0,843.0
0.001,17,2,136,1,60,0.0,32.0,32.0,1,76,0.0,48.0,48.0
0.094,6,10,1506,5,395,19.0,127.0,127.0,5,1111,21.0,843.0,843.0
412.258,6,29,4409,12,3102,10911.0,494.0,494.0,17,1307,25765.0,83.0,83.0
0.005,6,10,1989,5,927,1.0,659.0,659.0,5,1062,1.0,794.0,794.0
0.005,6,10,1989,5,927,1.0,659.0,659.0,5,1062,1.0,794.0,794.0
0.006,6,12,1698,6,863,1.0,327.0,271.0,6,835,1.0,515.0,515.0
0.006,6,10,1854,5,889,1.0,621.0,621.0,5,965,1.0,697.0,697.0
0.005,17,2,157,1,59,0.0,31.0,31.0,1,98,0.0,70.0,70.0
300.376,6,16,2170,9,684,37526.0,146.0,146.0,7,1486,50035.0,419.0,398.0
0.137,6,10,1506,5,395,30.0,127.0,127.0,5,1111,31.0,843.0,843.0
0.009,6,12,1926,6,1189,1.0,659.0,434.0,6,737,1.0,417.0,417.0
0.073,6,10,1506,5,395,15.0,127.0,127.0,5,1111,16.0,843.0,843.0
0.008,6,10,1972,5,910,2.0,642.0,642.0,5,1062,2.0,794.0,794.0
0.02,6,10,1990,5,911,4.0,643.0,643.0,5,1079,4.0,811.0,811.0
0.065,6,10,1506,5,395,14.0,127.0,127.0,5,1111,15.0,843.0,843.0
0.006,17,2,214,1,75,0.0,47.0,47.0,1,139,0.0,111.0,111.0
0.082,6,10,1506,5,395,16.0,127.0,127.0,5,1111,17.0,843.0,843.0
40.067,17,10,676,5,460,10013.0,104.0,64.0,5,216,10016.0,20.0,15.0
0.005,6,10,1643,5,860,1.0,592.0,592.0,5,783,1.0,515.0,515.0
0.005,17,2,178,1,65,0.0,37.0,37.0,1,113,0.0,85.0,85.0
0.008,6,10,1989,5,910,2.0,642.0,642.0,5,1079,2.0,811.0,811.0
10.985,17,28,4422,14,1995,836.0,270.0,114.0,14,2427,834.0,586.0,145.0
0.04,17,4,352,2,130,0.0,37.0,37.0,2,222,3.0,89.0,83.0
0.004,6,10,1779,5,928,1.0,660.0,660.0,5,851,1.0,583.0,583.0
44.736,6,37,9811,19,4293,498.0,1360.0,700.0,18,5518,2621.0,2667.0,435.0
0.25,6,14,2016,8,744,35.0,154.0,154.0,6,1272,49.0,470.0,470.0
0.005,6,10,2007,5,928,1.0,660.0,660.0,5,1079,1.0,811.0,811.0
40.053,17,10,676,5,460,10012.0,104.0,64.0,5,216,10012.0,20.0,15.0
0.012,6,10,1762,5,911,3.0,643.0,643.0,5,851,3.0,583.0,583.0
0.017,17,2,198,1,91,0.0,63.0,63.0,1,107,0.0,79.0,79.0
0.118,6,10,1506,5,395,27.0,127.0,127.0,5,1111,24.0,843.0,843.0
15.218,17,18,8835,9,6569,1898.0,1350.0,701.0,9,2266,1898.0,1350.0,223.0
0.006,6,10,1547,5,764,1.0,496.0,496.0,5,783,1.0,515.0,515.0
0.065,6,10,1506,5,395,15.0,127.0,127.0,5,1111,14.0,843.0,843.0
0.013,6,13,3735,7,497,2.0,125.0,125.0,6,3238,2.0,1470.0,1459.0
0.012,6,10,1989,5,910,3.0,642.0,642.0,5,1079,2.0,811.0,811.0
10.826,17,28,4423,14,1994,824.0,269.0,114.0,14,2429,824.0,588.0,145.0
0.004,6,10,1989,5,927,1.0,659.0,659.0,5,1062,1.0,794.0,794.0
0.138,6,10,1506,5,395,33.0,127.0,127.0,5,1111,30.0,843.0,843.0
40.063,17,10,676,5,460,10012.0,104.0,64.0,5,216,10014.0,20.0,15.0
0.028,6,10,1989,5,910,7.0,642.0,642.0,5,1079,7.0,811.0,811.0
0.016,6,10,1983,5,910,4.0,642.0,642.0,5,1073,4.0,805.0,805.0
0.14,6,10,1506,5,395,34.0,127.0,127.0,5,1111,31.0,843.0,843.0
290.402,6,387,347012,192,21541,1520.0,2736.0,888.0,195,325471,1496.0,2804.0,1742.0
0.012,6,10,1983,5,910,3.0,642.0,642.0,5,1073,2.0,805.0,805.0
0.109,17,2,144,1,64,0.0,36.0,36.0,1,80,0.0,52.0,52.0
0.006,6,10,1547,5,764,1.0,496.0,496.0,5,783,1.0,515.0,515.0
0.006,17,2,179,1,71,0.0,43.0,43.0,1,108,0.0,80.0,80.0
0.011,6,10,1990,5,911,2.0,643.0,643.0,5,1079,2.0,811.0,811.0
316.17,17,20,1124,10,716,35115.0,48.0,43.0,10,408,35116.0,20.0,12.0
0.006,6,12,1698,6,863,1.0,327.0,271.0,6,835,1.0,515.0,515.0
0.004,17,4,284,2,120,0.0,32.0,32.0,2,164,1.0,60.0,54.0
0.013,6,10,1983,5,910,3.0,642.0,642.0,5,1073,3.0,805.0,805.0
0.013,6,10,1972,5,910,3.0,642.0,642.0,5,1062,3.0,794.0,794.0
351.987,6,20,2210,6,1308,12003.0,494.0,494.0,14,902,27075.0,83.0,83.0
0.105,6,10,1506,5,395,23.0,127.0,127.0,5,1111,21.0,843.0,843.0
0.013,6,10,1990,5,911,3.0,643.0,643.0,5,1079,3.0,811.0,811.0
0.009,6,12,1926,6,1189,1.0,659.0,434.0,6,737,1.0,417.0,417.0
65.677,6,21,10088,12,3973,5970.0,1579.0,835.0,9,6115,8189.0,2111.0,1127.0
0.011,6,13,3735,7,497,1.0,125.0,125.0,6,3238,2.0,1470.0,1459.0
0.005,6,10,2006,5,927,1.0,659.0,659.0,5,1079,1.0,811.0,811.0
0.071,17,4,284,2,120,10.0,32.0,32.0,2,164,21.0,60.0,54.0
15.078,17,16,8646,8,6436,2150.0,1350.0,776.0,8,2210,2149.0,1350.0,248.0
0.005,6,10,2006,5,927,1.0,659.0,659.0,5,1079,1.0,811.0,811.0
0.005,6,10,2007,5,928,1.0,660.0,660.0,5,1079,1.0,811.0,811.0
0.005,6,10,1779,5,928,1.0,660.0,660.0,5,851,1.0,583.0,583.0
126.004,6,14,2938,8,2504,17967.0,1414.0,1086.0,6,434,25153.0,182.0,182.0
0.113,6,10,1506,5,395,24.0,127.0,127.0,5,1111,24.0,843.0,843.0
0.001,17,2,180,1,66,0.0,38.0,38.0,1,114,0.0,86.0,86.0
0.104,6,10,1506,5,395,24.0,127.0,127.0,5,1111,17.0,843.0,843.0
0.075,6,10,1506,5,395,16.0,127.0,127.0,5,1111,15.0,843.0,843.0
0.007,6,14,3799,7,509,1.0,137.0,137.0,7,3290,1.0,1448.0,972.0
1770.57,17,120,11460,60,5460,30009.0,63.0,63.0,60,6000,30009.0,72.0,72.0
0.012,6,10,1990,5,911,2.0,643.0,643.0,5,1079,3.0,811.0,811.0
0.104,6,10,1506,5,395,21.0,127.0,127.0,5,1111,23.0,843.0,843.0
0.004,17,2,136,1,60,0.0,32.0,32.0,1,76,0.0,48.0,48.0
0.04,17,2,182,1,65,0.0,37.0,37.0,1,117,0.0,89.0,89.0
2.098,6,30,11523,16,1691,139.0,517.0,211.0,14,9832,161.0,1402.0,909.0
0.004,17,2,148,1,60,0.0,32.0,32.0,1,88,0.0,60.0,60.0
0.006,6,10,1643,5,860,1.0,592.0,592.0,5,783,1.0,515.0,515.0
240.011,6,9,787,5,488,60002.0,232.0,232.0,4,299,80003.0,83.0,83.0
0.013,6,10,1631,5,848,3.0,580.0,580.0,5,783,3.0,515.0,515.0
0.007,6,13,3747,7,509,1.0,137.0,137.0,6,3238,1.0,1470.0,1459.0
0.015,6,10,1989,5,910,3.0,642.0,642.0,5,1079,3.0,811.0,811.0
0.005,6,10,1779,5,928,1.0,660.0,660.0,5,851,1.0,583.0,583.0
0.005,6,10,1547,5,764,1.0,496.0,496.0,5,783,1.0,515.0,515.0
0.015,6,10,1990,5,911,3.0,643.0,643.0,5,1079,3.0,811.0,811.0
0.009,6,10,1972,5,910,2.0,642.0,642.0,5,1062,2.0,794.0,794.0
0.006,6,10,1689,5,839,1.0,571.0,571.0,5,850,1.0,582.0,582.0
0.014,6,10,1983,5,910,3.0,642.0,642.0,5,1073,3.0,805.0,805.0
15.072,17,14,9190,8,6902,2149.0,1350.0,834.0,6,2288,3008.0,1350.0,353.0
0.079,6,10,1506,5,395,17.0,127.0,127.0,5,1111,18.0,843.0,843.0
0.009,6,10,1677,5,827,2.0,559.0,559.0,5,850,2.0,582.0,582.0
368.575,6,22,2313,16,867,24571.0,195.0,195.0,6,1446,4639.0,419.0,398.0
0.003,17,2,148,1,60,0.0,32.0,32.0,1,88,0.0,60.0,60.0
0.013,6,10,1990,5,911,3.0,643.0,643.0,5,1079,3.0,811.0,811.0
0.022,6,10,1990,5,911,5.0,643.0,643.0,5,1079,5.0,811.0,811.0
0.005,6,10,2006,5,927,1.0,659.0,659.0,5,1079,1.0,811.0,811.0
0.094,6,10,1506,5,395,17.0,127.0,127.0,5,1111,21.0,843.0,843.0
0.003,17,2,136,1,60,0.0,32.0,32.0,1,76,0.0,48.0,48.0
0.01,6,10,1990,5,911,2.0,643.0,643.0,5,1079,2.0,811.0,811.0
0.037,17,2,170,1,65,0.0,37.0,37.0,1,105,0.0,77.0,77.0
11.168,17,28,4417,14,1994,846.0,269.0,114.0,14,2423,846.0,586.0,145.0
0.095,6,10,1506,5,395,21.0,127.0,127.0,5,1111,21.0,843.0,843.0
0.004,6,10,1989,5,927,1.0,659.0,659.0,5,1062,1.0,794.0,794.0
0.201,6,16,2670,8,1396,28.0,533.0,324.0,8,1274,18.0,529.0,212.0
0.009,6,10,1989,5,910,2.0,642.0,642.0,5,1079,2.0,811.0,811.0
0.086,6,10,1506,5,395,20.0,127.0,127.0,5,1111,19.0,843.0,843.0
0.003,17,4,284,2,120,0.0,32.0,32.0,2,164,0.0,60.0,54.0
0.006,6,10,1689,5,839,1.0,571.0,571.0,5,850,1.0,582.0,582.0
0.004,6,10,2006,5,927,1.0,659.0,659.0,5,1079,1.0,811.0,811.0
0.013,6,10,1983,5,910,3.0,642.0,642.0,5,1073,3.0,805.0,805.0
0.006,6,10,1854,5,889,1.0,621.0,621.0,5,965,1.0,697.0,697.0
10.795,17,28,4421,14,1993,822.0,268.0,114.0,14,2428,822.0,587.0,145.0
0.005,17,2,255,1,82,0.0,54.0,54.0,1,173,0.0,145.0,145.0
0.009,6,10,1989,5,910,2.0,642.0,642.0,5,1079,2.0,811.0,811.0
0.01,6,10,1990,5,911,2.0,643.0,643.0,5,1079,2.0,811.0,811.0
0.01,6,10,1990,5,911,2.0,643.0,643.0,5,1079,2.0,811.0,811.0
0.01,6,10,1990,5,911,2.0,643.0,643.0,5,1079,2.0,811.0,811.0
0.005,6,10,2007,5,928,1.0,660.0,660.0,5,1079,1.0,811.0,811.0
0.021,6,14,3787,7,497,3.0,125.0,125.0,7,3290,3.0,1448.0,972.0
0.007,6,10,1643,5,860,1.0,592.0,592.0,5,783,1.0,515.0,515.0
0.005,6,10,1989,5,927,1.0,659.0,659.0,5,1062,1.0,794.0,794.0
0.015,6,13,3735,7,497,2.0,125.0,125.0,6,3238,2.0,1470.0,1459.0
0.003,17,2,148,1,60,0.0,32.0,32.0,1,88,0.0,60.0,60.0
0.096,6,10,1506,5,395,23.0,127.0,127.0,5,1111,20.0,843.0,843.0
0.007,17,2,307,1,61,0.0,33.0,33.0,1,246,0.0,218.0,218.0
240.068,6,21,4926,11,941,24006.0,180.0,93.0,10,3985,26673.0,1593.0,576.0
0.013,6,13,3735,7,497,2.0,125.0,125.0,6,3238,2.0,1470.0,1459.0
0.218,17,14,8577,7,4012,36.0,1350.0,545.0,7,4565,27.0,1350.0,624.0
0.01,6,10,1972,5,910,2.0,642.0,642.0,5,1062,2.0,794.0,794.0
366.376,6,22,2313,16,867,24425.0,195.0,195.0,6,1446,4687.0,419.0,398.0
0.009,6,10,1989,5,910,2.0,642.0,642.0,5,1079,2.0,811.0,811.0
0.015,6,10,1631,5,848,3.0,580.0,580.0,5,783,3.0,515.0,515.0
0.005,6,10,1989,5,927,1.0,659.0,659.0,5,1062,1.0,794.0,794.0
0.013,6,10,1762,5,911,3.0,643.0,643.0,5,851,3.0,583.0,583.0
0.04,17,2,186,1,61,0.0,33.0,33.0,1,125,0.0,97.0,97.0
15.071,17,15,9238,8,6902,2149.0,1350.0,834.0,7,2336,2507.0,1350.0,305.0
0.117,6,10,1506,5,395,25.0,127.0,127.0,5,1111,25.0,843.0,843.0
0.006,6,10,2007,5,928,1.0,660.0,660.0,5,1079,1.0,811.0,811.0
0.006,6,10,1989,5,927,1.0,659.0,659.0,5,1062,1.0,794.0,794.0
0.076,6,10,1506,5,395,17.0,127.0,127.0,5,1111,16.0,843.0,843.0
0.005,6,10,2007,5,928,1.0,660.0,660.0,5,1079,1.0,811.0,811.0
0.04,17,2,148,1,60,0.0,32.0,32.0,1,88,0.0,60.0,60.0
0.004,6,10,1702,5,863,1.0,595.0,595.0,5,839,0.0,571.0,571.0
15.073,17,16,8954,8,6767,2149.0,1350.0,817.0,8,2187,2149.0,1350.0,245.0
0.087,6,10,1506,5,395,17.0,127.0,127.0,5,1111,21.0,843.0,843.0
0.008,6,12,1926,6,1189,1.0,659.0,434.0,6,737,1.0,417.0,417.0
0.206,6,16,2671,8,1397,29.0,533.0,324.0,8,1274,18.0,529.0,212.0
0.008,6,10,1677,5,827,2.0,559.0,559.0,5,850,2.0,582.0,582.0
0.106,6,10,1506,5,395,23.0,127.0,127.0,5,1111,22.0,843.0,843.0
0.004,6,10,1702,5,863,1.0,595.0,595.0,5,839,1.0,571.0,571.0
0.037,6,10,1983,5,910,9.0,642.0,642.0,5,1073,9.0,805.0,805.0
0.004,17,2,148,1,60,0.0,32.0,32.0,1,88,0.0,60.0,60.0
0.011,6,10,1990,5,911,2.0,643.0,643.0,5,1079,2.0,811.0,811.0
0.317,17,45,25919,25,21228,13.0,1350.0,821.0,20,4691,13.0,1350.0,206.0
40.066,17,10,676,5,460,10015.0,104.0,64.0,5,216,10015.0,20.0,15.0
0.015,6,10,1989,5,910,3.0,642.0,642.0,5,1079,3.0,811.0,811.0
0.168,17,2,152,1,76,0.0,48.0,48.0,1,76,0.0,48.0,48.0
0.001,17,2,180,1,66,0.0,38.0,38.0,1,114,0.0,86.0,86.0
0.017,6,10,1972,5,910,4.0,642.0,642.0,5,1062,4.0,794.0,794.0
0.009,6,10,1989,5,910,2.0,642.0,642.0,5,1079,2.0,811.0,811.0
0.005,6,10,1643,5,860,1.0,592.0,592.0,5,783,1.0,515.0,515.0
0.005,6,10,1547,5,764,1.0,496.0,496.0,5,783,1.0,515.0,515.0
0.015,6,10,1972,5,910,3.0,642.0,642.0,5,1062,3.0,794.0,794.0
0.005,6,10,2007,5,928,1.0,660.0,660.0,5,1079,1.0,811.0,811.0
0.0,17,2,136,1,60,0.0,32.0,32.0,1,76,0.0,48.0,48.0
0.071,6,10,1506,5,395,17.0,127.0,127.0,5,1111,16.0,843.0,843.0
0.006,6,10,1643,5,860,1.0,592.0,592.0,5,783,1.0,515.0,515.0
0.074,6,10,1506,5,395,15.0,127.0,127.0,5,1111,16.0,843.0,843.0
0.001,17,2,136,1,60,0.0,32.0,32.0,1,76,0.0,48.0,48.0
0.004,17,2,136,1,60,0.0,32.0,32.0,1,76,0.0,48.0,48.0
0.005,17,2,273,1,66,0.0,38.0,38.0,1,207,0.0,179.0,179.0
0.003,17,2,148,1,60,0.0,32.0,32.0,1,88,0.0,60.0,60.0
0.004,17,2,148,1,60,0.0,32.0,32.0,1,88,0.0,60.0,60.0
0.008,6,10,1989,5,910,2.0,642.0,642.0,5,1079,2.0,811.0,811.0
0.002,17,2,152,1,76,0.0,48.0,48.0,1,76,0.0,48.0,48.0
40.08,17,10,676,5,460,10019.0,104.0,64.0,5,216,10017.0,20.0,15.0
0.006,6,10,1547,5,764,1.0,496.0,496.0,5,783,1.0,515.0,515.0
0.005,6,10,1989,5,927,1.0,659.0,659.0,5,1062,1.0,794.0,794.0
366.408,6,22,2313,16,867,24427.0,195.0,195.0,6,1446,4633.0,419.0,398.0
0.012,6,10,1989,5,910,3.0,642.0,642.0,5,1079,2.0,811.0,811.0
0.013,6,10,1631,5,848,3.0,580.0,580.0,5,783,3.0,515.0,515.0
0.08,6,10,1506,5,395,18.0,127.0,127.0,5,1111,16.0,843.0,843.0
0.012,6,10,1972,5,910,3.0,642.0,642.0,5,1062,3.0,794.0,794.0
0.008,6,10,1983,5,910,2.0,642.0,642.0,5,1073,2.0,805.0,805.0
315.631,6,31,10498,17,2710,19726.0,676.0,363.0,14,7788,19660.0,1402.0,881.0
0.012,6,10,1631,5,848,3.0,580.0,580.0,5,783,2.0,515.0,515.0
0.009,6,10,1990,5,911,2.0,643.0,643.0,5,1079,2.0,811.0,811.0
0.004,6,10,1702,5,863,1.0,595.0,595.0,5,839,0.0,571.0,571.0
0.005,6,10,2006,5,927,1.0,659.0,659.0,5,1079,1.0,811.0,811.0
0.012,6,10,1989,5,910,2.0,642.0,642.0,5,1079,3.0,811.0,811.0
0.224,6,16,2777,8,1395,32.0,533.0,323.0,8,1382,20.0,529.0,239.0
0.006,6,10,1689,5,839,1.0,571.0,571.0,5,850,1.0,582.0,582.0
0.011,6,10,1990,5,911,2.0,643.0,643.0,5,1079,2.0,811.0,811.0
0.092,6,10,1506,5,395,22.0,127.0,127.0,5,1111,19.0,843.0,843.0
0.124,6,10,1506,5,395,29.0,127.0,127.0,5,1111,29.0,843.0,843.0
0.102,6,10,1506,5,395,20.0,127.0,127.0,5,1111,21.0,843.0,843.0
0.079,6,10,1506,5,395,17.0,127.0,127.0,5,1111,19.0,843.0,843.0
0.005,6,10,2007,5,928,1.0,660.0,660.0,5,1079,1.0,811.0,811.0
0.005,6,10,2007,5,928,1.0,660.0,660.0,5,1079,1.0,811.0,811.0
0.018,6,10,1990,5,911,4.0,643.0,643.0,5,1079,4.0,811.0,811.0
0.006,6,10,1547,5,764,1.0,496.0,496.0,5,783,1.0,515.0,515.0
0.009,6,10,1702,5,863,2.0,595.0,595.0,5,839,2.0,571.0,571.0
0.012,6,10,1972,5,910,3.0,642.0,642.0,5,1062,3.0,794.0,794.0
0.001,17,2,180,1,66,0.0,38.0,38.0,1,114,0.0,86.0,86.0
0.005,6,10,2007,5,928,1.0,660.0,660.0,5,1079,1.0,811.0,811.0
0.005,6,10,1989,5,927,1.0,659.0,659.0,5,1062,1.0,794.0,794.0
0.034,17,2,152,1,76,0.0,48.0,48.0,1,76,0.0,48.0,48.0
1793.399,6,551,187415,282,163063,6382.0,2883.0,963.0,269,24352,6691.0,365.0,103.0
0.001,17,2,180,1,66,0.0,38.0,38.0,1,114,0.0,86.0,86.0
0.004,17,2,234,1,61,0.0,33.0,33.0,1,173,0.0,145.0,145.0
0.01,6,10,1990,5,911,2.0,643.0,643.0,5,1079,2.0,811.0,811.0
0.005,6,10,2006,5,927,1.0,659.0,659.0,5,1079,1.0,811.0,811.0
0.159,6,10,1506,5,395,32.0,127.0,127.0,5,1111,39.0,843.0,843.0
0.005,6,10,2000,5,927,1.0,659.0,659.0,5,1073,1.0,805.0,805.0
0.075,6,10,1506,5,395,18.0,127.0,127.0,5,1111,14.0,843.0,843.0
0.005,6,10,2006,5,927,1.0,659.0,659.0,5,1079,1.0,811.0,811.0
300.968,6,46,18759,26,13161,12038.0,2720.0,1099.0,20,5598,463.0,2667.0,435.0
0.037,17,2,186,1,61,0.0,33.0,33.0,1,125,0.0,97.0,97.0
0.009,6,12,1926,6,1189,1.0,659.0,434.0,6,737,1.0,417.0,417.0
0.005,6,10,1854,5,889,1.0,621.0,621.0,5,965,1.0,697.0,697.0
0.016,6,10,1983,5,910,3.0,642.0,642.0,5,1073,4.0,805.0,805.0
241.698,6,371,346392,193,21556,1258.0,2736.0,959.0,178,324836,1365.0,2804.0,1878.0
0.005,6,10,1989,5,927,1.0,659.0,659.0,5,1062,1.0,794.0,794.0
0.068,6,10,1506,5,395,13.0,127.0,127.0,5,1111,15.0,843.0,843.0
0.005,6,10,1989,5,927,1.0,659.0,659.0,5,1062,1.0,794.0,794.0
0.005,6,10,1643,5,860,1.0,592.0,592.0,5,783,1.0,515.0,515.0
0.11,6,10,1506,5,395,25.0,127.0,127.0,5,1111,24.0,843.0,843.0
0.038,17,2,412,1,61,0.0,33.0,33.0,1,351,0.0,323.0,323.0
0.011,6,10,1983,5,910,2.0,642.0,642.0,5,1073,2.0,805.0,805.0
0.006,17,2,154,1,69,0.0,41.0,41.0,1,85,0.0,57.0,57.0
0.004,6,10,2000,5,927,1.0,659.0,659.0,5,1073,1.0,805.0,805.0
240.119,6,32,9450,16,7035,16007.0,2107.0,689.0,16,2415,16007.0,580.0,196.0
0.005,6,10,2000,5,927,1.0,659.0,659.0,5,1073,1.0,805.0,805.0
0.005,6,10,2006,5,927,1.0,659.0,659.0,5,1079,1.0,811.0,811.0
0.003,17,2,148,1,60,0.0,32.0,32.0,1,88,0.0,60.0,60.0
0.005,6,10,2000,5,927,1.0,659.0,659.0,5,1073,1.0,805.0,805.0
0.001,17,2,180,1,66,0.0,38.0,38.0,1,114,0.0,86.0,86.0
0.008,6,10,1972,5,910,2.0,642.0,642.0,5,1062,2.0,794.0,794.0
0.01,6,10,2007,5,928,2.0,660.0,660.0,5,1079,2.0,811.0,811.0
40.099,17,10,676,5,460,10016.0,104.0,64.0,5,216,10021.0,20.0,15.0
0.004,17,2,136,1,60,0.0,32.0,32.0,1,76,0.0,48.0,48.0
308.911,17,20,1124,10,716,34309.0,48.0,43.0,10,408,34309.0,20.0,12.0
0.009,6,10,1762,5,911,2.0,643.0,643.0,5,851,2.0,583.0,583.0
0.005,6,10,1643,5,860,1.0,592.0,592.0,5,783,1.0,515.0,515.0
0.026,6,10,1762,5,911,6.0,643.0,643.0,5,851,6.0,583.0,583.0
0.005,6,10,2000,5,927,1.0,659.0,659.0,5,1073,1.0,805.0,805.0
0.009,6,12,1926,6,1189,1.0,659.0,434.0,6,737,1.0,417.0,417.0
0.005,17,2,179,1,71,0.0,43.0,43.0,1,108,0.0,80.0,80.0
0.004,17,2,148,1,60,0.0,32.0,32.0,1,88,0.0,60.0,60.0
0.017,6,10,1990,5,911,4.0,643.0,643.0,5,1079,4.0,811.0,811.0
0.004,17,2,214,1,75,0.0,47.0,47.0,1,139,0.0,111.0,111.0
0.005,6,10,1779,5,928,1.0,660.0,660.0,5,851,1.0,583.0,583.0
0.003,17,4,284,2,120,0.0,32.0,32.0,2,164,0.0,60.0,54.0
0.004,17,2,179,1,71,0.0,43.0,43.0,1,108,0.0,80.0,80.0
0.009,6,12,1926,6,1189,1.0,659.0,434.0,6,737,1.0,417.0,417.0
0.005,6,10,1989,5,927,1.0,659.0,659.0,5,1062,1.0,794.0,794.0
0.005,6,10,1989,5,927,1.0,659.0,659.0,5,1062,1.0,794.0,794.0
0.012,6,10,1762,5,911,3.0,643.0,643.0,5,851,3.0,583.0,583.0
0.004,17,2,136,1,60,0.0,32.0,32.0,1,76,0.0,48.0,48.0
0.005,6,10,2000,5,927,1.0,659.0,659.0,5,1073,1.0,805.0,805.0
0.13,17,2,182,1,65,0.0,37.0,37.0,1,117,0.0,89.0,89.0
0.003,17,4,284,2,120,0.0,32.0,32.0,2,164,0.0,60.0,54.0
0.006,17,2,164,1,74,0.0,46.0,46.0,1,90,0.0,62.0,62.0
0.099,6,10,1506,5,395,23.0,127.0,127.0,5,1111,22.0,843.0,843.0
0.006,17,2,148,1,60,0.0,32.0,32.0,1,88,0.0,60.0,60.0
0.005,6,14,3799,7,509,0.0,137.0,137.0,7,3290,0.0,1448.0,972.0
0.009,6,10,1972,5,910,2.0,642.0,642.0,5,1062,2.0,794.0,794.0
40.054,17,10,676,5,460,10012.0,104.0,64.0,5,216,10012.0,20.0,15.0
0.082,6,10,1506,5,395,18.0,127.0,127.0,5,1111,16.0,843.0,843.0
0.005,6,10,1989,5,927,1.0,659.0,659.0,5,1062,1.0,794.0,794.0
0.026,6,10,1990,5,911,6.0,643.0,643.0,5,1079,6.0,811.0,811.0
0.006,17,2,170,1,65,0.0,37.0,37.0,1,105,0.0,77.0,77.0
0.004,17,4,284,2,120,1.0,32.0,32.0,2,164,0.0,60.0,54.0
0.013,6,10,1990,5,911,3.0,643.0,643.0,5,1079,3.0,811.0,811.0
0.005,6,10,2006,5,927,1.0,659.0,659.0,5,1079,1.0,811.0,811.0
0.004,17,2,136,1,60,0.0,32.0,32.0,1,76,0.0,48.0,48.0
0.019,6,10,1972,5,910,4.0,642.0,642.0,5,1062,4.0,794.0,794.0
0.02,6,10,1631,5,848,5.0,580.0,580.0,5,783,5.0,515.0,515.0
0.005,17,2,136,1,60,0.0,32.0,32.0,1,76,0.0,48.0,48.0
0.071,6,10,1506,5,395,16.0,127.0,127.0,5,1111,16.0,843.0,843.0
0.006,17,2,178,1,65,0.0,37.0,37.0,1,113,0.0,85.0,85.0
0.01,6,10,1854,5,889,2.0,621.0,621.0,5,965,2.0,697.0,697.0
0.006,6,10,1547,5,764,1.0,496.0,496.0,5,783,1.0,515.0,515.0
0.0,17,2,180,1,65,0.0,37.0,37.0,1,115,0.0,87.0,87.0
0.005,17,2,166,1,75,0.0,47.0,47.0,1,91,0.0,63.0,63.0
0.006,6,10,1547,5,764,1.0,496.0,496.0,5,783,1.0,515.0,515.0
0.01,6,10,1972,5,910,2.0,642.0,642.0,5,1062,2.0,794.0,794.0
0.006,17,2,179,1,71,0.0,43.0,43.0,1,108,0.0,80.0,80.0
15.211,17,19,10779,10,8341,1687.0,1350.0,806.0,9,2438,1897.0,1350.0,242.0
0.015,6,10,1972,5,910,3.0,642.0,642.0,5,1062,3.0,794.0,794.0
0.079,6,10,1506,5,395,15.0,127.0,127.0,5,1111,17.0,843.0,843.0
0.004,6,10,1702,5,863,1.0,595.0,595.0,5,839,1.0,571.0,571.0
0.008,6,10,1983,5,910,2.0,642.0,642.0,5,1073,2.0,805.0,805.0
0.001,17,2,154,1,69,0.0,41.0,41.0,1,85,0.0,57.0,57.0
0.038,17,2,136,1,60,0.0,32.0,32.0,1,76,0.0,48.0,48.0
40.09,17,10,676,5,460,10020.0,104.0,64.0,5,216,10021.0,20.0,15.0
0.001,17,2,180,1,66,0.0,38.0,38.0,1,114,0.0,86.0,86.0
0.003,17,2,136,1,60,0.0,32.0,32.0,1,76,0.0,48.0,48.0
0.041,17,2,152,1,76,0.0,48.0,48.0,1,76,0.0,48.0,48.0
0.02,6,10,1989,5,910,5.0,642.0,642.0,5,1079,5.0,811.0,811.0
366.017,6,22,2313,16,867,24401.0,195.0,195.0,6,1446,4636.0,419.0,398.0
0.014,6,10,1983,5,910,3.0,642.0,642.0,5,1073,3.0,805.0,805.0
240.145,6,37,6869,18,3279,14126.0,880.0,333.0,19,3590,13341.0,1306.0,370.0
30.153,6,26,8595,15,1828,2153.0,517.0,262.0,11,6767,3014.0,1402.0,773.0
0.001,17,2,268,1,70,0.0,42.0,42.0,1,198,0.0,170.0,170.0
0.004,6,10,2006,5,927,1.0,659.0,659.0,5,1079,1.0,811.0,811.0
0.172,17,2,152,1,76,0.0,48.0,48.0,1,76,0.0,48.0,48.0
0.005,17,2,164,1,74,0.0,46.0,46.0,1,90,0.0,62.0,62.0
0.008,6,12,1926,6,1189,1.0,659.0,434.0,6,737,1.0,417.0,417.0
0.006,6,14,3736,7,446,1.0,74.0,74.0,7,3290,0.0,1448.0,972.0
0.005,6,10,2000,5,927,1.0,659.0,659.0,5,1073,1.0,805.0,805.0
0.013,6,10,1989,5,910,3.0,642.0,642.0,5,1079,3.0,811.0,811.0
0.067,17,2,144,1,64,0.0,36.0,36.0,1,80,0.0,52.0,52.0
0.01,17,2,138,1,61,0.0,33.0,33.0,1,77,0.0,49.0,49.0
0.003,17,2,148,1,60,0.0,32.0,32.0,1,88,0.0,60.0,60.0
0.009,6,10,1989,5,910,2.0,642.0,642.0,5,1079,2.0,811.0,811.0
300.434,6,16,2170,9,684,37532.0,146.0,146.0,7,1486,50043.0,419.0,398.0
0.006,6,10,1854,5,889,1.0,621.0,621.0,5,965,1.0,697.0,697.0
0.003,17,2,136,1,60,0.0,32.0,32.0,1,76,0.0,48.0,48.0
0.008,6,10,1972,5,910,2.0,642.0,642.0,5,1062,1.0,794.0,794.0
0.008,6,12,1926,6,1189,1.0,659.0,434.0,6,737,1.0,417.0,417.0
0.005,6,10,1989,5,927,1.0,659.0,659.0,5,1062,1.0,794.0,794.0
40.049,17,10,676,5,460,10011.0,104.0,64.0,5,216,10011.0,20.0,15.0
0.01,6,10,2000,5,927,2.0,659.0,659.0,5,1073,2.0,805.0,805.0
0.017,6,10,1989,5,910,4.0,642.0,642.0,5,1079,4.0,811.0,811.0
1.051,6,12,3142,6,2099,158.0,1328.0,923.0,6,1043,158.0,791.0,791.0
0.129,6,10,1506,5,395,30.0,127.0,127.0,5,1111,29.0,843.0,843.0
0.013,6,10,1989,5,910,3.0,642.0,642.0,5,1079,3.0,811.0,811.0
0.014,17,2,148,1,60,0.0,32.0,32.0,1,88,0.0,60.0,60.0
0.005,6,10,2006,5,927,1.0,659.0,659.0,5,1079,1.0,811.0,811.0
0.005,17,2,164,1,74,0.0,46.0,46.0,1,90,0.0,62.0,62.0
0.015,6,10,1989,5,910,3.0,642.0,642.0,5,1079,3.0,811.0,811.0
0.007,6,10,1989,5,927,1.0,659.0,659.0,5,1062,1.0,794.0,794.0
106.029,6,28,9605,14,1707,8156.0,794.0,367.0,14,7898,8145.0,1360.0,732.0
0.004,6,10,1702,5,863,1.0,595.0,595.0,5,839,0.0,571.0,571.0
0.071,17,8,3613,4,1874,23.0,1350.0,440.0,4,1739,12.0,1350.0,406.0
0.01,6,10,1990,5,911,2.0,643.0,643.0,5,1079,2.0,811.0,811.0
0.109,6,10,1506,5,395,23.0,127.0,127.0,5,1111,24.0,843.0,843.0
0.012,6,10,1989,5,910,2.0,642.0,642.0,5,1079,2.0,811.0,811.0
0.004,17,4,284,2,120,0.0,32.0,32.0,2,164,1.0,60.0,54.0
0.03,6,10,1631,5,848,7.0,580.0,580.0,5,783,7.0,515.0,515.0
0.015,6,10,1677,5,827,3.0,559.0,559.0,5,850,3.0,582.0,582.0
0.124,6,10,1506,5,395,26.0,127.0,127.0,5,1111,26.0,843.0,843.0
0.139,6,10,1506,5,395,29.0,127.0,127.0,5,1111,32.0,843.0,843.0
0.004,17,2,132,1,58,0.0,30.0,30.0,1,74,0.0,46.0,46.0
0.008,6,10,1989,5,910,2.0,642.0,642.0,5,1079,1.0,811.0,811.0
0.011,6,10,1989,5,910,2.0,642.0,642.0,5,1079,2.0,811.0,811.0
0.067,6,10,1506,5,395,16.0,127.0,127.0,5,1111,15.0,843.0,843.0
0.01,6,10,1989,5,910,2.0,642.0,642.0,5,1079,2.0,811.0,811.0
0.012,6,12,1926,6,1189,2.0,659.0,434.0,6,737,2.0,417.0,417.0
0.016,6,10,1983,5,910,3.0,642.0,642.0,5,1073,4.0,805.0,805.0
0.008,6,10,1972,5,910,2.0,642.0,642.0,5,1062,2.0,794.0,794.0
0.004,6,10,2006,5,927,1.0,659.0,659.0,5,1079,1.0,811.0,811.0
0.004,6,10,1989,5,927,1.0,659.0,659.0,5,1062,1.0,794.0,794.0
0.003,17,2,148,1,60,0.0,32.0,32.0,1,88,0.0,60.0,60.0
0.001,17,2,180,1,66,0.0,38.0,38.0,1,114,0.0,86.0,86.0
0.004,17,4,284,2,120,1.0,32.0,32.0,2,164,0.0,60.0,54.0
40.081,17,10,676,5,460,10017.0,104.0,64.0,5,216,10019.0,20.0,15.0
0.006,6,10,1547,5,764,1.0,496.0,496.0,5,783,1.0,515.0,515.0
0.077,6,10,1506,5,395,18.0,127.0,127.0,5,1111,16.0,843.0,843.0
10.882,17,28,4423,14,1995,828.0,270.0,114.0,14,2428,828.0,587.0,145.0
0.009,6,10,1972,5,910,2.0,642.0,642.0,5,1062,2.0,794.0,794.0
0.006,6,10,1854,5,889,1.0,621.0,621.0,5,965,1.0,697.0,697.0
0.006,6,10,1854,5,889,1.0,621.0,621.0,5,965,1.0,697.0,697.0
0.084,6,10,1506,5,395,19.0,127.0,127.0,5,1111,17.0,843.0,843.0
0.016,6,10,1990,5,911,3.0,643.0,643.0,5,1079,3.0,811.0,811.0
0.013,6,10,1762,5,911,3.0,643.0,643.0,5,851,3.0,583.0,583.0
0.014,6,10,1989,5,910,3.0,642.0,642.0,5,1079,3.0,811.0,811.0
0.013,6,10,1989,5,910,3.0,642.0,642.0,5,1079,3.0,811.0,811.0
0.008,6,10,1989,5,910,2.0,642.0,642.0,5,1079,2.0,811.0,811.0
0.003,17,2,148,1,60,0.0,32.0,32.0,1,88,0.0,60.0,60.0
0.107,6,10,1506,5,395,23.0,127.0,127.0,5,1111,22.0,843.0,843.0
0.005,17,2,168,1,76,0.0,48.0,48.0,1,92,0.0,64.0,64.0
0.046,17,2,152,1,76,0.0,48.0,48.0,1,76,0.0,48.0,48.0
0.019,6,10,1989,5,910,4.0,642.0,642.0,5,1079,4.0,811.0,811.0
0.011,6,10,1989,5,910,2.0,642.0,642.0,5,1079,2.0,811.0,811.0
0.016,6,10,1972,5,910,3.0,642.0,642.0,5,1062,4.0,794.0,794.0
0.005,6,13,3747,7,509,0.0,137.0,137.0,6,3238,1.0,1470.0,1459.0
0.006,6,10,2007,5,928,1.0,660.0,660.0,5,1079,1.0,811.0,811.0
353.226,6,20,2210,6,1308,12003.0,494.0,494.0,14,902,27171.0,83.0,83.0
0.01,6,12,1926,6,1189,1.0,659.0,434.0,6,737,2.0,417.0,417.0
0.084,6,10,1506,5,395,19.0,127.0,127.0,5,1111,17.0,843.0,843.0
0.012,6,10,1989,5,910,2.0,642.0,642.0,5,1079,2.0,811.0,811.0
300.45,6,16,2158,9,684,37535.0,146.0,146.0,7,1474,50047.0,419.0,394.0
0.008,6,14,3799,7,509,1.0,137.0,137.0,7,3290,1.0,1448.0,972.0
0.005,6,10,1989,5,927,1.0,659.0,659.0,5,1062,1.0,794.0,794.0
0.038,17,2,152,1,76,0.0,48.0,48.0,1,76,0.0,48.0,48.0
0.006,17,2,166,1,75,0.0,47.0,47.0,1,91,0.0,63.0,63.0
240.56,6,34,9354,16,1836,16035.0,624.0,199.0,18,7518,14148.0,1402.0,548.0
0.011,6,10,1972,5,910,2.0,642.0,642.0,5,1062,2.0,794.0,794.0
0.101,6,10,1506,5,395,23.0,127.0,127.0,5,1111,21.0,843.0,843.0
0.005,6,10,2007,5,928,1.0,660.0,660.0,5,1079,1.0,811.0,811.0
0.039,17,2,148,1,60,0.0,32.0,32.0,1,88,0.0,60.0,60.0
0.089,6,10,1506,5,395,21.0,127.0,127.0,5,1111,19.0,843.0,843.0
0.004,6,10,1702,5,863,1.0,595.0,595.0,5,839,0.0,571.0,571.0
240.008,6,9,787,5,488,60002.0,232.0,232.0,4,299,80002.0,83.0,83.0
0.057,17,2,427,1,129,0.0,101.0,101.0,1,298,0.0,270.0,270.0
0.017,6,10,1983,5,910,4.0,642.0,642.0,5,1073,4.0,805.0,805.0
0.096,6,10,1506,5,395,19.0,127.0,127.0,5,1111,19.0,843.0,843.0
0.005,6,14,3742,7,452,0.0,80.0,80.0,7,3290,0.0,1448.0,972.0
0.081,6,10,1506,5,395,19.0,127.0,127.0,5,1111,17.0,843.0,843.0
0.009,6,10,1983,5,910,2.0,642.0,642.0,5,1073,2.0,805.0,805.0
0.011,6,10,1990,5,911,2.0,643.0,643.0,5,1079,2.0,811.0,811.0
0.006,6,10,1547,5,764,1.0,496.0,496.0,5,783,1.0,515.0,515.0
353.578,6,20,2210,6,1308,12003.0,494.0,494.0,14,902,27198.0,83.0,83.0
0.001,17,2,179,1,62,0.0,34.0,34.0,1,117,0.0,89.0,89.0
352.261,6,20,2210,6,1308,12006.0,494.0,494.0,14,902,27096.0,83.0,83.0
300.321,6,16,2170,9,684,37519.0,146.0,146.0,7,1486,50025.0,419.0,398.0
0.006,6,10,1643,5,860,1.0,592.0,592.0,5,783,1.0,515.0,515.0
0.006,6,10,1547,5,764,1.0,496.0,496.0,5,783,1.0,515.0,515.0
0.005,6,10,1689,5,839,1.0,571.0,571.0,5,850,1.0,582.0,582.0
0.013,6,10,1989,5,910,3.0,642.0,642.0,5,1079,3.0,811.0,811.0
0.005,6,10,2007,5,928,1.0,660.0,660.0,5,1079,1.0,811.0,811.0
11.109,17,28,4422,14,1995,841.0,270.0,114.0,14,2427,841.0,586.0,145.0
0.005,6,10,2007,5,928,1.0,660.0,660.0,5,1079,1.0,811.0,811.0
0.078,6,10,1506,5,395,18.0,127.0,127.0,5,1111,16.0,843.0,843.0
0.009,6,12,1926,6,1189,1.0,659.0,434.0,6,737,1.0,417.0,417.0
0.019,6,10,1631,5,848,4.0,580.0,580.0,5,783,4.0,515.0,515.0
0.072,17,2,182,1,65,0.0,37.0,37.0,1,117,0.0,89.0,89.0
0.006,6,10,1689,5,839,1.0,571.0,571.0,5,850,1.0,582.0,582.0
0.074,6,10,1506,5,395,16.0,127.0,127.0,5,1111,13.0,843.0,843.0
0.021,6,10,1605,5,388,5.0,120.0,120.0,5,1217,5.0,949.0,949.0
0.005,17,2,170,1,65,0.0,37.0,37.0,1,105,0.0,77.0,77.0
0.003,17,2,148,1,60,0.0,32.0,32.0,1,88,0.0,60.0,60.0
15.08,17,15,8336,8,6105,2150.0,1350.0,735.0,7,2231,2508.0,1350.0,290.0
0.25,6,10,1506,5,395,23.0,127.0,127.0,5,1111,56.0,843.0,843.0
240.118,6,16,4482,9,963,30014.0,238.0,166.0,7,3519,40018.0,1402.0,786.0
0.074,6,10,1506,5,395,15.0,127.0,127.0,5,1111,15.0,843.0,843.0
0.015,6,10,1972,5,910,3.0,642.0,642.0,5,1062,3.0,794.0,794.0
10.776,17,28,4422,14,1994,820.0,269.0,114.0,14,2428,820.0,587.0,145.0
0.02,17,2,170,1,65,0.0,37.0,37.0,1,105,0.0,77.0,77.0
0.007,6,10,1689,5,839,1.0,571.0,571.0,5,850,1.0,582.0,582.0
0.005,17,2,170,1,65,0.0,37.0,37.0,1,105,0.0,77.0,77.0
0.004,6,10,1774,5,923,1.0,655.0,655.0,5,851,1.0,583.0,583.0
0.094,6,10,1506,5,395,21.0,127.0,127.0,5,1111,21.0,843.0,843.0
0.23,6,16,2669,8,1395,32.0,533.0,323.0,8,1274,21.0,529.0,212.0
0.006,6,10,1547,5,764,1.0,496.0,496.0,5,783,1.0,515.0,515.0
240.012,6,9,787,5,488,60003.0,232.0,232.0,4,299,80002.0,83.0,83.0
0.012,6,10,1983,5,910,3.0,642.0,642.0,5,1073,3.0,805.0,805.0
0.003,17,2,148,1,60,0.0,32.0,32.0,1,88,0.0,60.0,60.0
0.006,6,10,1547,5,764,1.0,496.0,496.0,5,783,1.0,515.0,515.0
0.012,6,10,1972,5,910,3.0,642.0,642.0,5,1062,3.0,794.0,794.0
0.009,6,12,1926,6,1189,1.0,659.0,434.0,6,737,1.0,417.0,417.0
0.011,6,10,1972,5,910,2.0,642.0,642.0,5,1062,2.0,794.0,794.0
5.175,6,23,6467,13,1827,430.0,801.0,282.0,10,4640,574.0,1925.0,824.0
0.006,6,10,1547,5,764,1.0,496.0,496.0,5,783,1.0,515.0,515.0
0.007,17,2,170,1,65,0.0,37.0,37.0,1,105,0.0,77.0,77.0
0.075,6,10,1506,5,395,16.0,127.0,127.0,5,1111,14.0,843.0,843.0
0.011,17,2,170,1,65,0.0,37.0,37.0,1,105,0.0,77.0,77.0
0.005,6,13,3747,7,509,0.0,137.0,137.0,6,3238,0.0,1470.0,1459.0
0.112,6,10,1506,5,395,24.0,127.0,127.0,5,1111,23.0,843.0,843.0
0.08,6,10,1506,5,395,17.0,127.0,127.0,5,1111,18.0,843.0,843.0
0.006,6,10,1547,5,764,1.0,496.0,496.0,5,783,1.0,515.0,515.0
0.001,17,2,180,1,66,0.0,38.0,38.0,1,114,0.0,86.0,86.0
0.172,17,2,152,1,76,0.0,48.0,48.0,1,76,0.0,48.0,48.0
0.017,6,10,1989,5,910,4.0,642.0,642.0,5,1079,4.0,811.0,811.0
308.299,17,20,1124,10,716,34241.0,48.0,43.0,10,408,34241.0,20.0,12.0
0.182,6,10,1506,5,395,43.0,127.0,127.0,5,1111,41.0,843.0,843.0
0.005,6,10,2007,5,928,1.0,660.0,660.0,5,1079,1.0,811.0,811.0
0.005,6,10,2007,5,928,1.0,660.0,660.0,5,1079,1.0,811.0,811.0
0.008,6,10,1983,5,910,1.0,642.0,642.0,5,1073,2.0,805.0,805.0
0.006,6,10,1547,5,764,1.0,496.0,496.0,5,783,1.0,515.0,515.0
0.011,6,10,1677,5,827,2.0,559.0,559.0,5,850,2.0,582.0,582.0
0.007,6,10,1762,5,911,1.0,643.0,643.0,5,851,1.0,583.0,583.0
0.015,6,10,1989,5,910,3.0,642.0,642.0,5,1079,3.0,811.0,811.0
0.006,6,10,1547,5,764,1.0,496.0,496.0,5,783,1.0,515.0,515.0
0.005,17,2,214,1,75,0.0,47.0,47.0,1,139,0.0,111.0,111.0
0.072,6,10,1506,5,395,16.0,127.0,127.0,5,1111,14.0,843.0,843.0
0.013,6,10,1631,5,848,3.0,580.0,580.0,5,783,3.0,515.0,515.0
0.01,6,10,1989,5,910,2.0,642.0,642.0,5,1079,2.0,811.0,811.0
0.013,6,10,1990,5,911,3.0,643.0,643.0,5,1079,3.0,811.0,811.0
0.089,6,10,1506,5,395,20.0,127.0,127.0,5,1111,18.0,843.0,843.0
0.006,6,10,1643,5,860,1.0,592.0,592.0,5,783,1.0,515.0,515.0
0.005,6,10,2006,5,927,1.0,659.0,659.0,5,1079,1.0,811.0,811.0
0.039,17,2,234,1,61,0.0,33.0,33.0,1,173,0.0,145.0,145.0
0.004,17,2,148,1,60,0.0,32.0,32.0,1,88,0.0,60.0,60.0
0.013,6,13,3735,7,497,2.0,125.0,125.0,6,3238,2.0,1470.0,1459.0
0.007,6,10,1990,5,911,1.0,643.0,643.0,5,1079,1.0,811.0,811.0
0.014,6,10,1972,5,910,3.0,642.0,642.0,5,1062,3.0,794.0,794.0
0.015,6,10,1990,5,911,3.0,643.0,643.0,5,1079,3.0,811.0,811.0
0.005,6,10,1643,5,860,1.0,592.0,592.0,5,783,1.0,515.0,515.0
0.025,17,2,164,1,74,0.0,46.0,46.0,1,90,0.0,62.0,62.0
0.009,17,2,169,1,62,0.0,34.0,34.0,1,107,0.0,79.0,79.0
0.009,6,10,1677,5,827,2.0,559.0,559.0,5,850,2.0,582.0,582.0
0.006,6,10,1547,5,764,1.0,496.0,496.0,5,783,1.0,515.0,515.0
0.006,17,2,152,1,68,0.0,40.0,40.0,1,84,0.0,56.0,56.0
0.005,6,10,1854,5,889,1.0,621.0,621.0,5,965,1.0,697.0,697.0
0.116,6,10,1506,5,395,27.0,127.0,127.0,5,1111,23.0,843.0,843.0
0.016,17,2,198,1,91,0.0,63.0,63.0,1,107,0.0,79.0,79.0
245.859,6,30,9715,16,2658,16387.0,676.0,363.0,14,7057,18909.0,1402.0,791.0
0.005,6,10,1643,5,860,1.0,592.0,592.0,5,783,1.0,515.0,515.0
0.004,6,10,2007,5,928,1.0,660.0,660.0,5,1079,1.0,811.0,811.0
0.033,6,10,1989,5,910,8.0,642.0,642.0,5,1079,8.0,811.0,811.0
0.011,6,10,1983,5,910,2.0,642.0,642.0,5,1073,2.0,805.0,805.0
0.011,6,10,1972,5,910,2.0,642.0,642.0,5,1062,2.0,794.0,794.0
0.077,6,10,1506,5,395,17.0,127.0,127.0,5,1111,15.0,843.0,843.0
0.005,6,10,2006,5,927,1.0,659.0,659.0,5,1079,1.0,811.0,811.0
0.079,6,10,1506,5,395,18.0,127.0,127.0,5,1111,16.0,843.0,843.0
0.071,17,4,352,2,130,0.0,37.0,37.0,2,222,30.0,89.0,83.0
0.004,17,4,284,2,120,0.0,32.0,32.0,2,164,1.0,60.0,54.0
0.006,17,2,170,1,65,0.0,37.0,37.0,1,105,0.0,77.0,77.0
0.005,6,10,1989,5,927,1.0,659.0,659.0,5,1062,1.0,794.0,794.0
120.825,6,57,19047,33,4819,3775.0,1054.0,221.0,24,14228,5253.0,2804.0,926.0
240.101,6,16,4481,9,963,30012.0,238.0,166.0,7,3518,40016.0,1402.0,786.0
0.095,6,10,1506,5,395,22.0,127.0,127.0,5,1111,20.0,843.0,843.0
0.004,17,2,136,1,60,0.0,32.0,32.0,1,76,0.0,48.0,48.0
0.016,6,10,1631,5,848,4.0,580.0,580.0,5,783,3.0,515.0,515.0
0.044,17,2,152,1,76,0.0,48.0,48.0,1,76,0.0,48.0,48.0
0.01,6,10,1762,5,911,2.0,643.0,643.0,5,851,2.0,583.0,583.0
0.005,6,10,2006,5,927,1.0,659.0,659.0,5,1079,1.0,811.0,811.0
10.703,17,28,4417,14,1993,815.0,268.0,114.0,14,2424,815.0,587.0,145.0
0.004,17,2,136,1,60,0.0,32.0,32.0,1,76,0.0,48.0,48.0
0.005,17,2,168,1,76,0.0,48.0,48.0,1,92,0.0,64.0,64.0
0.017,6,10,1989,5,910,4.0,642.0,642.0,5,1079,4.0,811.0,811.0
0.01,6,10,1990,5,911,2.0,643.0,643.0,5,1079,2.0,811.0,811.0
0.001,17,2,180,1,66,0.0,38.0,38.0,1,114,0.0,86.0,86.0
0.005,6,10,1779,5,928,1.0,660.0,660.0,5,851,1.0,583.0,583.0
0.015,6,14,3787,7,497,2.0,125.0,125.0,7,3290,2.0,1448.0,972.0
0.005,6,10,2000,5,927,1.0,659.0,659.0,5,1073,1.0,805.0,805.0
0.005,6,10,2007,5,928,1.0,660.0,660.0,5,1079,1.0,811.0,811.0
0.005,6,10,2006,5,927,1.0,659.0,659.0,5,1079,1.0,811.0,811.0
14.094,6,37,10658,20,3670,741.0,967.0,524.0,17,6988,880.0,1662.0,609.0
0.103,6,10,1506,5,395,23.0,127.0,127.0,5,1111,23.0,843.0,843.0
0.005,6,10,1643,5,860,1.0,592.0,592.0,5,783,1.0,515.0,515.0
0.008,17,2,179,1,71,0.0,43.0,43.0,1,108,0.0,80.0,80.0
0.002,17,2,136,1,60,0.0,32.0,32.0,1,76,0.0,48.0,48.0
1793.503,6,567,190860,290,164447,6205.0,2883.0,933.0,277,26413,6498.0,580.0,116.0
240.281,6,47,9024,24,5854,10446.0,1515.0,509.0,23,3170,10921.0,580.0,218.0
0.078,6,10,1506,5,395,17.0,127.0,127.0,5,1111,17.0,843.0,843.0
0.006,6,10,1643,5,860,1.0,592.0,592.0,5,783,1.0,515.0,515.0
0.091,6,10,1506,5,395,20.0,127.0,127.0,5,1111,17.0,843.0,843.0
0.007,17,2,194,1,59,0.0,31.0,31.0,1,135,0.0,107.0,107.0
0.023,6,13,3913,7,495,3.0,123.0,123.0,6,3418,4.0,1650.0,1549.0
0.013,6,10,1972,5,910,3.0,642.0,642.0,5,1062,3.0,794.0,794.0
0.087,6,10,1506,5,395,19.0,127.0,127.0,5,1111,20.0,843.0,843.0
0.008,6,10,1972,5,910,2.0,642.0,642.0,5,1062,2.0,794.0,794.0
0.005,17,4,284,2,120,1.0,32.0,32.0,2,164,1.0,60.0,54.0
15.072,17,15,9239,8,6902,2149.0,1350.0,834.0,7,2337,2506.0,1350.0,305.0
0.27,17,40,21525,22,18428,12.0,1350.0,809.0,18,3097,11.0,1350.0,144.0
126.041,6,14,2938,8,2504,17972.0,1414.0,1086.0,6,434,25161.0,182.0,182.0
0.009,6,10,1972,5,910,2.0,642.0,642.0,5,1062,2.0,794.0,794.0
0.006,17,2,180,1,58,0.0,30.0,30.0,1,122,0.0,94.0,94.0
0.006,6,10,2007,5,928,1.0,660.0,660.0,5,1079,1.0,811.0,811.0
0.005,6,10,2007,5,928,1.0,660.0,660.0,5,1079,1.0,811.0,811.0
40.068,17,10,676,5,460,10013.0,104.0,64.0,5,216,10015.0,20.0,15.0
0.001,17,2,179,1,62,0.0,34.0,34.0,1,117,0.0,89.0,89.0
0.088,6,10,1506,5,395,21.0,127.0,127.0,5,1111,17.0,843.0,843.0
0.005,6,13,3747,7,509,0.0,137.0,137.0,6,3238,0.0,1470.0,1459.0
300.344,6,16,2170,9,684,37522.0,146.0,146.0,7,1486,50029.0,419.0,398.0
0.858,6,25,5555,12,1445,67.0,267.0,136.0,13,4110,60.0,1414.0,597.0
0.006,6,10,1689,5,839,1.0,571.0,571.0,5,850,1.0,582.0,582.0
0.005,6,10,2006,5,927,1.0,659.0,659.0,5,1079,1.0,811.0,811.0
0.089,6,10,1506,5,395,20.0,127.0,127.0,5,1111,19.0,843.0,843.0
0.014,6,10,1989,5,910,3.0,642.0,642.0,5,1079,3.0,811.0,811.0
0.003,17,2,136,1,60,0.0,32.0,32.0,1,76,0.0,48.0,48.0
0.119,17,2,179,1,71,0.0,43.0,43.0,1,108,0.0,80.0,80.0
0.118,6,10,1506,5,395,23.0,127.0,127.0,5,1111,26.0,843.0,843.0
0.08,6,10,1506,5,395,17.0,127.0,127.0,5,1111,16.0,843.0,843.0
0.126,17,4,352,2,130,1.0,37.0,37.0,2,222,87.0,89.0,83.0
0.263,17,2,152,1,76,0.0,48.0,48.0,1,76,0.0,48.0,48.0
0.011,6,10,1990,5,911,2.0,643.0,643.0,5,1079,2.0,811.0,811.0
0.015,17,2,198,1,91,0.0,63.0,63.0,1,107,0.0,79.0,79.0
0.009,6,10,1990,5,911,2.0,643.0,643.0,5,1079,2.0,811.0,811.0
0.005,6,10,2000,5,927,1.0,659.0,659.0,5,1073,1.0,805.0,805.0
0.017,17,2,136,1,60,0.0,32.0,32.0,1,76,0.0,48.0,48.0
240.156,6,42,5231,22,2527,11435.0,588.0,196.0,20,2704,12639.0,580.0,207.0
0.068,6,10,1506,5,395,15.0,127.0,127.0,5,1111,13.0,843.0,843.0
0.006,6,10,1547,5,764,1.0,496.0,496.0,5,783,1.0,515.0,515.0
412.293,6,29,4409,12,3102,10913.0,494.0,494.0,17,1307,25768.0,83.0,83.0
361.874,6,21,1793,16,1030,24124.0,190.0,190.0,5,763,60010.0,462.0,247.0
0.019,6,10,1983,5,910,4.0,642.0,642.0,5,1073,4.0,805.0,805.0
0.143,17,2,152,1,76,0.0,48.0,48.0,1,76,0.0,48.0,48.0
0.127,6,10,1506,5,395,28.0,127.0,127.0,5,1111,30.0,843.0,843.0
0.076,6,10,1506,5,395,17.0,127.0,127.0,5,1111,16.0,843.0,843.0
0.007,6,10,1689,5,839,1.0,571.0,571.0,5,850,1.0,582.0,582.0
0.001,17,2,180,1,66,0.0,38.0,38.0,1,114,0.0,86.0,86.0
0.013,6,10,1990,5,911,3.0,643.0,643.0,5,1079,3.0,811.0,811.0
1794.774,6,244,25186,95,9165,19091.0,1360.0,71.0,149,16021,12126.0,1360.0,130.0
0.012,6,10,1677,5,827,2.0,559.0,559.0,5,850,2.0,582.0,582.0
9.039,17,6,376,5,280,2259.0,28.0,28.0,1,96,0.0,68.0,68.0
0.122,6,10,1506,5,395,24.0,127.0,127.0,5,1111,26.0,843.0,843.0
0.006,6,10,2007,5,928,1.0,660.0,660.0,5,1079,1.0,811.0,811.0
0.005,6,10,1854,5,889,1.0,621.0,621.0,5,965,1.0,697.0,697.0
0.011,6,10,1972,5,910,2.0,642.0,642.0,5,1062,2.0,794.0,794.0
0.015,6,10,1972,5,910,3.0,642.0,642.0,5,1062,3.0,794.0,794.0
0.142,6,10,1506,5,395,31.0,127.0,127.0,5,1111,34.0,843.0,843.0
0.011,6,10,1631,5,848,2.0,580.0,580.0,5,783,2.0,515.0,515.0
0.004,17,2,136,1,60,0.0,32.0,32.0,1,76,0.0,48.0,48.0
0.016,6,10,1762,5,911,4.0,643.0,643.0,5,851,3.0,583.0,583.0
0.006,17,2,170,1,65,0.0,37.0,37.0,1,105,0.0,77.0,77.0
40.062,17,10,676,5,460,10014.0,104.0,64.0,5,216,10014.0,20.0,15.0
0.012,6,10,1990,5,911,3.0,643.0,643.0,5,1079,3.0,811.0,811.0
0.004,17,2,142,1,63,0.0,35.0,35.0,1,79,0.0,51.0,51.0
0.006,6,10,1547,5,764,1.0,496.0,496.0,5,783,1.0,515.0,515.0
0.007,17,2,179,1,71,0.0,43.0,43.0,1,108,0.0,80.0,80.0
0.093,6,10,1506,5,395,21.0,127.0,127.0,5,1111,22.0,843.0,843.0
300.315,6,16,2170,9,684,37518.0,146.0,146.0,7,1486,50024.0,419.0,398.0
310.894,17,20,1124,10,716,34527.0,48.0,43.0,10,408,34529.0,20.0,12.0
0.006,17,2,214,1,73,0.0,45.0,45.0,1,141,0.0,113.0,113.0
0.006,6,10,1547,5,764,1.0,496.0,496.0,5,783,1.0,515.0,515.0
0.1,6,10,1506,5,395,23.0,127.0,127.0,5,1111,24.0,843.0,843.0
15.072,17,15,9238,8,6902,2149.0,1350.0,834.0,7,2336,2507.0,1350.0,305.0
0.006,6,10,1547,5,764,1.0,496.0,496.0,5,783,1.0,515.0,515.0
0.038,17,2,148,1,60,0.0,32.0,32.0,1,88,0.0,60.0,60.0
0.117,6,10,1506,5,395,27.0,127.0,127.0,5,1111,27.0,843.0,843.0
0.004,6,10,1774,5,923,1.0,655.0,655.0,5,851,1.0,583.0,583.0
0.001,17,2,180,1,66,0.0,38.0,38.0,1,114,0.0,86.0,86.0
0.004,17,4,284,2,120,0.0,32.0,32.0,2,164,0.0,60.0,54.0
0.023,6,13,3735,7,497,3.0,125.0,125.0,6,3238,4.0,1470.0,1459.0
0.004,17,2,186,1,61,0.0,33.0,33.0,1,125,0.0,97.0,97.0
0.079,6,10,1506,5,395,17.0,127.0,127.0,5,1111,18.0,843.0,843.0
0.005,6,10,2000,5,927,1.0,659.0,659.0,5,1073,1.0,805.0,805.0
0.005,6,10,2006,5,927,1.0,659.0,659.0,5,1079,1.0,811.0,811.0
0.011,6,10,1631,5,848,2.0,580.0,580.0,5,783,2.0,515.0,515.0
0.005,6,10,1989,5,927,1.0,659.0,659.0,5,1062,1.0,794.0,794.0
0.086,6,10,1506,5,395,19.0,127.0,127.0,5,1111,20.0,843.0,843.0
0.041,17,2,412,1,61,0.0,33.0,33.0,1,351,0.0,323.0,323.0
0.015,6,10,1989,5,910,3.0,642.0,642.0,5,1079,3.0,811.0,811.0
0.005,6,10,2006,5,927,1.0,659.0,659.0,5,1079,1.0,811.0,811.0
0.107,6,10,1506,5,395,25.0,127.0,127.0,5,1111,25.0,843.0,843.0
0.005,6,10,1989,5,927,1.0,659.0,659.0,5,1062,1.0,794.0,794.0
40.069,17,10,676,5,460,10015.0,104.0,64.0,5,216,10016.0,20.0,15.0
0.119,6,10,1506,5,395,27.0,127.0,127.0,5,1111,26.0,843.0,843.0
0.001,17,2,180,1,66,0.0,38.0,38.0,1,114,0.0,86.0,86.0
68.443,6,38,9806,19,4203,491.0,3046.0,1133.0,19,5603,3792.0,2667.0,402.0
0.016,6,14,3787,7,497,2.0,125.0,125.0,7,3290,2.0,1448.0,972.0
0.014,6,10,1989,5,910,3.0,642.0,642.0,5,1079,3.0,811.0,811.0
0.001,17,2,180,1,66,0.0,38.0,38.0,1,114,0.0,86.0,86.0
0.007,6,10,1689,5,839,1.0,571.0,571.0,5,850,1.0,582.0,582.0
0.037,17,2,412,1,61,0.0,33.0,33.0,1,351,0.0,323.0,323.0
0.009,17,2,299,1,65,0.0,37.0,37.0,1,234,0.0,206.0,206.0
0.001,17,2,174,1,72,0.0,44.0,44.0,1,102,0.0,74.0,74.0
1770.616,6,100,6282,47,2545,38490.0,37.0,33.0,53,3737,34049.0,280.0,98.0
0.008,6,12,1926,6,1189,1.0,659.0,434.0,6,737,1.0,417.0,417.0
0.119,6,10,1506,5,395,25.0,127.0,127.0,5,1111,25.0,843.0,843.0
40.065,17,10,676,5,460,10014.0,104.0,64.0,5,216,10014.0,20.0,15.0
0.006,6,10,1854,5,889,1.0,621.0,621.0,5,965,1.0,697.0,697.0
0.006,6,10,2007,5,928,1.0,660.0,660.0,5,1079,1.0,811.0,811.0
0.051,17,4,352,2,130,10.0,37.0,37.0,2,222,13.0,89.0,83.0
0.12,6,10,1506,5,395,29.0,127.0,127.0,5,1111,28.0,843.0,843.0
0.017,6,10,1990,5,911,4.0,643.0,643.0,5,1079,4.0,811.0,811.0
240.011,6,9,787,5,488,60002.0,232.0,232.0,4,299,80002.0,83.0,83.0
65.7,6,25,10408,11,3909,6570.0,1579.0,835.0,14,6499,5043.0,2111.0,576.0
0.004,17,4,420,2,122,0.0,33.0,33.0,2,298,0.0,145.0,121.0
0.012,6,10,1989,5,910,2.0,642.0,642.0,5,1079,3.0,811.0,811.0
0.012,6,10,1983,5,910,3.0,642.0,642.0,5,1073,3.0,805.0,805.0
0.011,6,10,1990,5,911,2.0,643.0,643.0,5,1079,2.0,811.0,811.0
0.001,17,2,164,1,74,0.0,46.0,46.0,1,90,0.0,62.0,62.0
0.103,6,10,1506,5,395,23.0,127.0,127.0,5,1111,20.0,843.0,843.0
0.001,17,2,180,1,66,0.0,38.0,38.0,1,114,0.0,86.0,86.0
0.01,6,13,3735,7,497,1.0,125.0,125.0,6,3238,2.0,1470.0,1459.0
0.112,6,10,1506,5,395,22.0,127.0,127.0,5,1111,23.0,843.0,843.0
0.295,17,46,27293,26,22600,11.0,1350.0,841.0,20,4693,13.0,1350.0,206.0
0.066,6,10,1506,5,395,15.0,127.0,127.0,5,1111,14.0,843.0,843.0
0.109,6,10,1506,5,395,24.0,127.0,127.0,5,1111,19.0,843.0,843.0
61.596,6,27,9532,14,1707,4738.0,794.0,367.0,13,7825,5122.0,1360.0,810.0
0.005,6,10,2007,5,928,1.0,660.0,660.0,5,1079,1.0,811.0,811.0
0.083,6,10,1506,5,395,18.0,127.0,127.0,5,1111,17.0,843.0,843.0
10.861,17,28,4417,14,1993,827.0,268.0,114.0,14,2424,826.0,587.0,145.0
0.006,6,10,2006,5,927,1.0,659.0,659.0,5,1079,1.0,811.0,811.0
0.012,6,10,1631,5,848,3.0,580.0,580.0,5,783,3.0,515.0,515.0
0.014,6,10,1990,5,911,3.0,643.0,643.0,5,1079,3.0,811.0,811.0
0.128,6,10,1506,5,395,29.0,127.0,127.0,5,1111,30.0,843.0,843.0
2.141,6,27,10461,14,1587,164.0,517.0,211.0,13,8874,178.0,1402.0,910.0
0.005,6,10,1989,5,927,1.0,659.0,659.0,5,1062,1.0,794.0,794.0
15.079,17,16,8579,8,6339,2150.0,1350.0,764.0,8,2240,2149.0,1350.0,252.0
171.375,17,86,12240,43,2864,4080.0,44.0,38.0,43,9376,4080.0,261.0,190.0
0.005,6,10,1643,5,860,1.0,592.0,592.0,5,783,1.0,515.0,515.0
0.001,17,2,180,1,66,0.0,38.0,38.0,1,114,0.0,86.0,86.0
0.013,6,10,1989,5,910,3.0,642.0,642.0,5,1079,3.0,811.0,811.0
0.004,6,10,2007,5,928,1.0,660.0,660.0,5,1079,1.0,811.0,811.0
300.805,6,37,9889,20,4411,15831.0,1835.0,715.0,17,5478,536.0,2667.0,435.0
0.004,17,4,284,2,120,0.0,32.0,32.0,2,164,1.0,60.0,54.0
0.005,6,10,2000,5,927,1.0,659.0,659.0,5,1073,1.0,805.0,805.0
240.018,6,9,787,5,488,60004.0,232.0,232.0,4,299,80005.0,83.0,83.0
0.005,6,10,1989,5,927,1.0,659.0,659.0,5,1062,1.0,794.0,794.0
0.013,6,10,1972,5,910,3.0,642.0,642.0,5,1062,3.0,794.0,794.0
0.012,6,10,1972,5,910,2.0,642.0,642.0,5,1062,2.0,794.0,794.0
0.005,6,10,1989,5,927,1.0,659.0,659.0,5,1062,1.0,794.0,794.0
0.075,6,10,1506,5,395,16.0,127.0,127.0,5,1111,18.0,843.0,843.0
0.005,6,10,1989,5,927,1.0,659.0,659.0,5,1062,1.0,794.0,794.0
0.004,6,10,2006,5,927,1.0,659.0,659.0,5,1079,1.0,811.0,811.0
0.038,17,4,284,2,120,0.0,32.0,32.0,2,164,34.0,60.0,54.0
0.062,6,10,1506,5,395,14.0,127.0,127.0,5,1111,13.0,843.0,843.0
0.011,17,2,179,1,71,0.0,43.0,43.0,1,108,0.0,80.0,80.0
0.061,6,10,1506,5,395,13.0,127.0,127.0,5,1111,14.0,843.0,843.0
0.005,6,10,1989,5,927,1.0,659.0,659.0,5,1062,1.0,794.0,794.0
0.013,6,10,1983,5,910,3.0,642.0,642.0,5,1073,3.0,805.0,805.0
0.006,17,2,214,1,75,0.0,47.0,47.0,1,139,0.0,111.0,111.0
0.005,17,2,169,1,62,0.0,34.0,34.0,1,107,0.0,79.0,79.0
0.005,17,2,164,1,74,0.0,46.0,46.0,1,90,0.0,62.0,62.0
0.019,6,10,1983,5,910,4.0,642.0,642.0,5,1073,4.0,805.0,805.0
0.011,6,10,1983,5,910,2.0,642.0,642.0,5,1073,2.0,805.0,805.0
0.103,6,10,1506,5,395,20.0,127.0,127.0,5,1111,20.0,843.0,843.0
0.005,6,10,1702,5,863,1.0,595.0,595.0,5,839,1.0,571.0,571.0
0.01,6,10,1972,5,910,2.0,642.0,642.0,5,1062,2.0,794.0,794.0
0.005,6,10,2006,5,927,1.0,659.0,659.0,5,1079,1.0,811.0,811.0
0.082,6,10,1506,5,395,18.0,127.0,127.0,5,1111,17.0,843.0,843.0
0.038,17,2,152,1,76,0.0,48.0,48.0,1,76,0.0,48.0,48.0
0.011,6,10,1989,5,910,2.0,642.0,642.0,5,1079,2.0,811.0,811.0
0.001,17,2,180,1,66,0.0,38.0,38.0,1,114,0.0,86.0,86.0
0.005,6,10,1989,5,927,1.0,659.0,659.0,5,1062,1.0,794.0,794.0
240.128,6,30,9161,15,6868,17152.0,1994.0,676.0,15,2293,17151.0,580.0,215.0
0.015,6,10,1989,5,910,3.0,642.0,642.0,5,1079,3.0,811.0,811.0
0.001,17,2,132,1,58,0.0,30.0,30.0,1,74,0.0,46.0,46.0
0.003,17,4,284,2,120,0.0,32.0,32.0,2,164,0.0,60.0,54.0
0.013,6,10,1677,5,827,3.0,559.0,559.0,5,850,3.0,582.0,582.0
0.009,6,12,1926,6,1189,1.0,659.0,434.0,6,737,1.0,417.0,417.0
0.005,6,10,1547,5,764,1.0,496.0,496.0,5,783,1.0,515.0,515.0
0.17,17,2,152,1,76,0.0,48.0,48.0,1,76,0.0,48.0,48.0
0.003,17,2,136,1,60,0.0,32.0,32.0,1,76,0.0,48.0,48.0
0.009,6,10,1989,5,910,2.0,642.0,642.0,5,1079,2.0,811.0,811.0
1786.083,6,150,19350,90,13740,20068.0,302.0,302.0,60,5610,30272.0,83.0,83.0
10.94,17,28,4395,14,1995,833.0,270.0,114.0,14,2400,833.0,587.0,143.0
0.004,17,2,148,1,60,0.0,32.0,32.0,1,88,0.0,60.0,60.0
0.081,6,10,1506,5,395,17.0,127.0,127.0,5,1111,18.0,843.0,843.0
0.012,6,10,1990,5,911,3.0,643.0,643.0,5,1079,2.0,811.0,811.0
0.052,17,2,152,1,76,0.0,48.0,48.0,1,76,0.0,48.0,48.0
0.005,17,2,140,1,62,0.0,34.0,34.0,1,78,0.0,50.0,50.0
0.005,6,10,2007,5,928,1.0,660.0,660.0,5,1079,1.0,811.0,811.0
0.221,6,16,2782,8,1400,31.0,533.0,325.0,8,1382,20.0,529.0,239.0
0.006,6,10,1989,5,927,1.0,659.0,659.0,5,1062,1.0,794.0,794.0
123.411,6,23,8538,12,2236,82.0,1345.0,574.0,11,6302,12324.0,1776.0,975.0
0.04,17,2,152,1,76,0.0,48.0,48.0,1,76,0.0,48.0,48.0
0.242,17,15,8641,8,4076,34.0,1350.0,481.0,7,4565,30.0,1350.0,624.0
0.013,6,10,1972,5,910,3.0,642.0,642.0,5,1062,3.0,794.0,794.0
0.006,17,2,209,1,64,0.0,36.0,36.0,1,145,0.0,117.0,117.0
0.123,6,10,1506,5,395,22.0,127.0,127.0,5,1111,29.0,843.0,843.0
0.012,6,10,1972,5,910,2.0,642.0,642.0,5,1062,3.0,794.0,794.0
0.163,6,10,1506,5,395,39.0,127.0,127.0,5,1111,35.0,843.0,843.0
0.011,6,10,1989,5,910,2.0,642.0,642.0,5,1079,2.0,811.0,811.0
0.048,6,10,1983,5,910,11.0,642.0,642.0,5,1073,12.0,805.0,805.0
0.144,6,10,1506,5,395,34.0,127.0,127.0,5,1111,33.0,843.0,843.0
0.009,6,13,3735,7,497,1.0,125.0,125.0,6,3238,1.0,1470.0,1459.0
0.005,6,10,2006,5,927,1.0,659.0,659.0,5,1079,1.0,811.0,811.0
0.004,6,10,2007,5,928,1.0,660.0,660.0,5,1079,1.0,811.0,811.0
0.016,6,10,1989,5,910,4.0,642.0,642.0,5,1079,4.0,811.0,811.0
40.118,17,10,676,5,460,10027.0,104.0,64.0,5,216,10028.0,20.0,15.0
0.006,6,10,1854,5,889,1.0,621.0,621.0,5,965,1.0,697.0,697.0
50.381,6,25,11127,13,1724,4198.0,538.0,350.0,12,9403,4578.0,2804.0,1096.0
0.006,6,10,1547,5,764,1.0,496.0,496.0,5,783,1.0,515.0,515.0
0.006,17,2,230,1,68,0.0,40.0,40.0,1,162,0.0,134.0,134.0
40.086,17,10,676,5,460,10020.0,104.0,64.0,5,216,10020.0,20.0,15.0
0.048,17,2,152,1,76,0.0,48.0,48.0,1,76,0.0,48.0,48.0
0.01,6,10,1762,5,911,2.0,643.0,643.0,5,851,2.0,583.0,583.0
0.004,6,10,1989,5,927,1.0,659.0,659.0,5,1062,1.0,794.0,794.0
0.077,6,13,3816,7,578,12.0,206.0,206.0,6,3238,15.0,1470.0,1459.0
0.006,17,2,214,1,75,0.0,47.0,47.0,1,139,0.0,111.0,111.0
0.004,17,2,136,1,60,0.0,32.0,32.0,1,76,0.0,48.0,48.0
0.029,6,10,1989,5,910,7.0,642.0,642.0,5,1079,7.0,811.0,811.0
0.152,6,10,1506,5,395,33.0,127.0,127.0,5,1111,35.0,843.0,843.0
0.032,6,10,1983,5,910,8.0,642.0,642.0,5,1073,7.0,805.0,805.0
0.203,6,16,2777,8,1395,29.0,533.0,323.0,8,1382,18.0,529.0,239.0
240.01,6,9,787,5,488,60002.0,232.0,232.0,4,299,80002.0,83.0,83.0
0.009,6,10,1983,5,910,2.0,642.0,642.0,5,1073,2.0,805.0,805.0
0.007,6,10,1989,5,927,1.0,659.0,659.0,5,1062,1.0,794.0,794.0
0.127,6,10,1506,5,395,27.0,127.0,127.0,5,1111,31.0,843.0,843.0
0.086,6,10,1506,5,395,18.0,127.0,127.0,5,1111,19.0,843.0,843.0
0.005,6,10,2007,5,928,1.0,660.0,660.0,5,1079,1.0,811.0,811.0
0.007,6,10,1547,5,764,1.0,496.0,496.0,5,783,1.0,515.0,515.0
0.012,6,10,1631,5,848,3.0,580.0,580.0,5,783,2.0,515.0,515.0
0.008,17,2,144,1,64,0.0,36.0,36.0,1,80,0.0,52.0,52.0
0.071,17,2,170,1,65,0.0,37.0,37.0,1,105,0.0,77.0,77.0
0.005,6,10,1774,5,923,1.0,655.0,655.0,5,851,1.0,583.0,583.0
0.005,6,10,1643,5,860,1.0,592.0,592.0,5,783,1.0,515.0,515.0
0.001,17,2,180,1,66,0.0,38.0,38.0,1,114,0.0,86.0,86.0
0.279,17,16,8490,8,6018,39.0,1350.0,724.0,8,2472,28.0,1350.0,281.0
0.004,6,10,1989,5,927,1.0,659.0,659.0,5,1062,1.0,794.0,794.0
0.006,6,10,1547,5,764,1.0,496.0,496.0,5,783,1.0,515.0,515.0
0.01,6,10,1990,5,911,2.0,643.0,643.0,5,1079,2.0,811.0,811.0
0.22,6,16,2777,8,1395,31.0,533.0,323.0,8,1382,20.0,529.0,239.0
0.004,17,2,148,1,60,0.0,32.0,32.0,1,88,0.0,60.0,60.0
0.101,6,10,1506,5,395,22.0,127.0,127.0,5,1111,24.0,843.0,843.0
0.082,6,10,1506,5,395,18.0,127.0,127.0,5,1111,17.0,843.0,843.0
0.087,6,10,1506,5,395,19.0,127.0,127.0,5,1111,20.0,843.0,843.0
40.055,17,10,676,5,460,10013.0,104.0,64.0,5,216,10012.0,20.0,15.0
0.005,6,10,1547,5,764,1.0,496.0,496.0,5,783,1.0,515.0,515.0
0.005,6,10,1643,5,860,1.0,592.0,592.0,5,783,1.0,515.0,515.0
0.005,6,10,1774,5,923,1.0,655.0,655.0,5,851,1.0,583.0,583.0
0.016,17,2,166,1,75,0.0,47.0,47.0,1,91,0.0,63.0,63.0
0.01,6,10,1972,5,910,2.0,642.0,642.0,5,1062,2.0,794.0,794.0
0.004,17,2,152,1,76,0.0,48.0,48.0,1,76,0.0,48.0,48.0
0.004,6,11,2041,6,979,0.0,659.0,659.0,5,1062,1.0,794.0,794.0
0.084,6,10,1506,5,395,16.0,127.0,127.0,5,1111,18.0,843.0,843.0
0.004,6,10,2007,5,928,1.0,660.0,660.0,5,1079,1.0,811.0,811.0
0.005,6,13,3747,7,509,0.0,137.0,137.0,6,3238,1.0,1470.0,1459.0
0.111,6,10,1506,5,395,26.0,127.0,127.0,5,1111,21.0,843.0,843.0
0.004,6,10,1779,5,928,1.0,660.0,660.0,5,851,1.0,583.0,583.0
0.073,6,10,1506,5,395,15.0,127.0,127.0,5,1111,16.0,843.0,843.0
240.143,6,31,9402,15,7003,17153.0,2127.0,691.0,16,2399,16009.0,580.0,194.0
0.006,17,2,179,1,71,0.0,43.0,43.0,1,108,0.0,80.0,80.0
300.428,6,16,2170,9,684,37532.0,146.0,146.0,7,1486,50042.0,419.0,398.0
0.007,6,10,1990,5,911,1.0,643.0,643.0,5,1079,1.0,811.0,811.0
0.005,6,10,1989,5,927,1.0,659.0,659.0,5,1062,1.0,794.0,794.0
240.385,6,27,4629,13,1880,20029.0,559.0,239.0,14,2749,18488.0,1214.0,253.0
0.017,6,10,1983,5,910,4.0,642.0,642.0,5,1073,4.0,805.0,805.0
0.071,6,10,1506,5,395,15.0,127.0,127.0,5,1111,17.0,843.0,843.0
0.008,6,10,1989,5,910,2.0,642.0,642.0,5,1079,1.0,811.0,811.0
0.004,6,10,1989,5,927,1.0,659.0,659.0,5,1062,1.0,794.0,794.0
0.006,6,10,1689,5,839,1.0,571.0,571.0,5,850,1.0,582.0,582.0
0.007,6,10,1677,5,827,1.0,559.0,559.0,5,850,1.0,582.0,582.0
0.001,17,2,166,1,75,0.0,47.0,47.0,1,91,0.0,63.0,63.0
0.013,6,10,1989,5,910,3.0,642.0,642.0,5,1079,3.0,811.0,811.0
0.009,6,10,1983,5,910,2.0,642.0,642.0,5,1073,2.0,805.0,805.0
176.304,17,88,12637,44,2929,4099.0,44.0,38.0,44,9708,4100.0,260.0,192.0
0.066,6,10,1506,5,395,14.0,127.0,127.0,5,1111,14.0,843.0,843.0
0.173,6,10,1506,5,395,40.0,127.0,127.0,5,1111,38.0,843.0,843.0
0.004,6,10,1702,5,863,1.0,595.0,595.0,5,839,0.0,571.0,571.0
0.094,6,10,1506,5,395,18.0,127.0,127.0,5,1111,21.0,843.0,843.0
0.004,6,10,2006,5,927,1.0,659.0,659.0,5,1079,1.0,811.0,811.0
0.004,6,10,2000,5,927,1.0,659.0,659.0,5,1073,1.0,805.0,805.0
0.004,6,10,1989,5,927,1.0,659.0,659.0,5,1062,1.0,794.0,794.0
0.011,6,10,1989,5,910,2.0,642.0,642.0,5,1079,2.0,811.0,811.0
0.006,17,2,144,1,64,0.0,36.0,36.0,1,80,0.0,52.0,52.0
0.005,6,10,2006,5,927,1.0,659.0,659.0,5,1079,1.0,811.0,811.0
0.004,6,10,1702,5,863,1.0,595.0,595.0,5,839,1.0,571.0,571.0
0.002,17,2,180,1,66,0.0,38.0,38.0,1,114,0.0,86.0,86.0
0.057,6,10,1506,5,395,12.0,127.0,127.0,5,1111,14.0,843.0,843.0
0.004,17,2,148,1,60,0.0,32.0,32.0,1,88,0.0,60.0,60.0
0.006,6,10,1643,5,860,1.0,592.0,592.0,5,783,1.0,515.0,515.0
0.005,6,10,1989,5,927,1.0,659.0,659.0,5,1062,1.0,794.0,794.0
0.006,6,10,1689,5,839,1.0,571.0,571.0,5,850,1.0,582.0,582.0
0.008,17,2,190,1,63,0.0,35.0,35.0,1,127,0.0,99.0,99.0
0.005,6,10,2000,5,927,1.0,659.0,659.0,5,1073,1.0,805.0,805.0
542.395,6,37,11880,20,3467,28547.0,676.0,403.0,17,8413,30148.0,1933.0,752.0
11.183,17,28,4422,14,1995,847.0,270.0,114.0,14,2427,847.0,586.0,145.0
0.005,6,10,2000,5,927,1.0,659.0,659.0,5,1073,1.0,805.0,805.0
0.01,6,10,1631,5,848,2.0,580.0,580.0,5,783,2.0,515.0,515.0
0.013,6,10,1989,5,910,3.0,642.0,642.0,5,1079,3.0,811.0,811.0
0.013,6,10,1990,5,911,3.0,643.0,643.0,5,1079,3.0,811.0,811.0
0.008,6,10,1972,5,910,2.0,642.0,642.0,5,1062,2.0,794.0,794.0
0.008,6,10,1990,5,911,1.0,643.0,643.0,5,1079,2.0,811.0,811.0
0.005,17,2,179,1,71,0.0,43.0,43.0,1,108,0.0,80.0,80.0
0.149,6,10,1506,5,395,33.0,127.0,127.0,5,1111,35.0,843.0,843.0
0.087,6,10,1506,5,395,18.0,127.0,127.0,5,1111,19.0,843.0,843.0
0.109,6,10,1506,5,395,25.0,127.0,127.0,5,1111,23.0,843.0,843.0
0.025,6,10,1762,5,911,6.0,643.0,643.0,5,851,6.0,583.0,583.0
0.003,17,2,136,1,60,0.0,32.0,32.0,1,76,0.0,48.0,48.0
0.016,6,10,1989,5,910,4.0,642.0,642.0,5,1079,4.0,811.0,811.0
0.005,6,10,2006,5,927,1.0,659.0,659.0,5,1079,1.0,811.0,811.0
0.014,6,10,1990,5,911,3.0,643.0,643.0,5,1079,3.0,811.0,811.0
0.113,6,10,1506,5,395,22.0,127.0,127.0,5,1111,25.0,843.0,843.0
0.012,6,10,1989,5,927,3.0,659.0,659.0,5,1062,3.0,794.0,794.0
0.006,6,10,1547,5,764,1.0,496.0,496.0,5,783,1.0,515.0,515.0
0.016,6,13,3913,7,495,2.0,123.0,123.0,6,3418,3.0,1650.0,1549.0
0.098,6,10,1506,5,395,16.0,127.0,127.0,5,1111,23.0,843.0,843.0
354.055,6,19,1691,15,978,25289.0,190.0,190.0,4,713,80003.0,497.0,497.0
1.131,6,32,13392,18,5893,66.0,2720.0,854.0,14,7499,72.0,2720.0,769.0
0.014,6,10,1989,5,910,3.0,642.0,642.0,5,1079,3.0,811.0,811.0
0.009,6,12,1926,6,1189,1.0,659.0,434.0,6,737,1.0,417.0,417.0
173.178,17,74,10521,37,2481,4810.0,44.0,39.0,37,8040,4810.0,249.0,189.0
0.005,17,2,213,1,69,0.0,41.0,41.0,1,144,0.0,116.0,116.0
0.007,6,10,2000,5,927,1.0,659.0,659.0,5,1073,1.0,805.0,805.0
1727.854,6,45,2790,30,1725,59581.0,35.0,35.0,15,1065,123412.0,31.0,31.0
0.004,17,2,148,1,60,0.0,32.0,32.0,1,88,0.0,60.0,60.0
0.016,6,10,1989,5,910,4.0,642.0,642.0,5,1079,3.0,811.0,811.0
0.004,6,10,1989,5,927,1.0,659.0,659.0,5,1062,1.0,794.0,794.0
0.005,6,10,1702,5,863,1.0,595.0,595.0,5,839,1.0,571.0,571.0
0.005,17,2,146,1,65,0.0,37.0,37.0,1,81,0.0,53.0,53.0
175.301,17,90,13089,45,3032,3983.0,44.0,39.0,45,10057,3984.0,261.0,195.0
0.005,6,10,1989,5,927,1.0,659.0,659.0,5,1062,1.0,794.0,794.0
0.005,17,2,180,1,66,0.0,38.0,38.0,1,114,0.0,86.0,86.0
0.137,6,10,1506,5,395,33.0,127.0,127.0,5,1111,30.0,843.0,843.0
0.005,6,10,2006,5,927,1.0,659.0,659.0,5,1079,1.0,811.0,811.0
40.078,17,10,676,5,460,10018.0,104.0,64.0,5,216,10018.0,20.0,15.0
0.073,6,10,1506,5,395,16.0,127.0,127.0,5,1111,14.0,843.0,843.0
240.067,6,22,4977,12,993,21824.0,180.0,93.0,10,3984,26673.0,1592.0,576.0
0.004,17,2,136,1,60,0.0,32.0,32.0,1,76,0.0,48.0,48.0
0.011,6,10,1983,5,910,2.0,642.0,642.0,5,1073,2.0,805.0,805.0
240.049,6,9,787,5,488,60012.0,232.0,232.0,4,299,80015.0,83.0,83.0
0.11,6,10,1506,5,395,22.0,127.0,127.0,5,1111,24.0,843.0,843.0
0.014,6,10,1989,5,910,3.0,642.0,642.0,5,1079,3.0,811.0,811.0
0.006,6,10,1854,5,889,1.0,621.0,621.0,5,965,1.0,697.0,697.0
294.166,6,399,348574,191,21496,1548.0,2736.0,888.0,208,327078,1421.0,2804.0,1630.0
0.005,6,10,2006,5,927,1.0,659.0,659.0,5,1079,1.0,811.0,811.0
0.064,6,10,1506,5,395,14.0,127.0,127.0,5,1111,15.0,843.0,843.0
0.004,6,10,2006,5,927,1.0,659.0,659.0,5,1079,1.0,811.0,811.0
0.005,6,10,1689,5,839,1.0,571.0,571.0,5,850,1.0,582.0,582.0
0.015,6,13,3735,7,497,2.0,125.0,125.0,6,3238,2.0,1470.0,1459.0
10.75,17,28,4419,14,1994,818.0,269.0,114.0,14,2425,818.0,588.0,145.0
0.01,6,10,1972,5,910,2.0,642.0,642.0,5,1062,2.0,794.0,794.0
0.001,17,2,174,1,72,0.0,44.0,44.0,1,102,0.0,74.0,74.0
0.005,17,2,282,1,69,0.0,41.0,41.0,1,213,0.0,185.0,185.0
40.068,17,10,676,5,460,10016.0,104.0,64.0,5,216,10016.0,20.0,15.0
0.006,6,10,1689,5,839,1.0,571.0,571.0,5,850,1.0,582.0,582.0
0.005,6,10,2006,5,927,1.0,659.0,659.0,5,1079,1.0,811.0,811.0
0.009,6,12,1926,6,1189,1.0,659.0,434.0,6,737,1.0,417.0,417.0
0.01,6,10,1677,5,827,2.0,559.0,559.0,5,850,2.0,582.0,582.0
0.086,6,10,1506,5,395,17.0,127.0,127.0,5,1111,20.0,843.0,843.0
15.082,17,15,8357,8,6331,2150.0,1350.0,763.0,7,2026,2508.0,1350.0,261.0
0.066,6,10,1506,5,395,16.0,127.0,127.0,5,1111,13.0,843.0,843.0
0.015,6,10,1983,5,910,3.0,642.0,642.0,5,1073,3.0,805.0,805.0
0.014,6,10,1762,5,911,3.0,643.0,643.0,5,851,3.0,583.0,583.0
0.149,6,10,1506,5,395,34.0,127.0,127.0,5,1111,34.0,843.0,843.0
0.143,6,10,1506,5,395,34.0,127.0,127.0,5,1111,29.0,843.0,843.0
0.008,6,10,1983,5,910,2.0,642.0,642.0,5,1073,2.0,805.0,805.0
0.009,6,10,1972,5,910,2.0,642.0,642.0,5,1062,2.0,794.0,794.0
0.006,6,13,3747,7,509,0.0,137.0,137.0,6,3238,1.0,1470.0,1459.0
0.326,17,2,142,1,63,0.0,35.0,35.0,1,79,0.0,51.0,51.0
0.006,6,10,1689,5,839,1.0,571.0,571.0,5,850,1.0,582.0,582.0
0.004,6,10,1779,5,928,1.0,660.0,660.0,5,851,1.0,583.0,583.0
30.291,6,58,35192,28,2870,1121.0,517.0,280.0,30,32322,1044.0,2804.0,1280.0
40.049,17,10,676,5,460,10011.0,104.0,64.0,5,216,10011.0,20.0,15.0
0.038,17,2,166,1,75,0.0,47.0,47.0,1,91,0.0,63.0,63.0
0.018,6,10,1677,5,827,4.0,559.0,559.0,5,850,4.0,582.0,582.0
0.07,6,10,1506,5,395,16.0,127.0,127.0,5,1111,14.0,843.0,843.0
0.084,6,10,1506,5,395,18.0,127.0,127.0,5,1111,17.0,843.0,843.0
40.072,17,10,676,5,460,10014.0,104.0,64.0,5,216,10017.0,20.0,15.0
0.004,17,4,495,2,132,0.0,38.0,38.0,2,363,1.0,176.0,153.0
40.055,17,10,676,5,460,10012.0,104.0,64.0,5,216,10013.0,20.0,15.0
0.005,6,10,1774,5,923,1.0,655.0,655.0,5,851,1.0,583.0,583.0
0.004,6,10,2006,5,927,1.0,659.0,659.0,5,1079,1.0,811.0,811.0
0.008,6,10,1972,5,910,2.0,642.0,642.0,5,1062,1.0,794.0,794.0
0.005,6,10,1689,5,839,1.0,571.0,571.0,5,850,1.0,582.0,582.0
0.004,17,2,170,1,65,0.0,37.0,37.0,1,105,0.0,77.0,77.0
0.166,17,2,152,1,76,0.0,48.0,48.0,1,76,0.0,48.0,48.0
0.004,6,10,1702,5,863,1.0,595.0,595.0,5,839,0.0,571.0,571.0
240.018,6,9,787,5,488,60004.0,232.0,232.0,4,299,80005.0,83.0,83.0
0.015,6,10,1972,5,910,3.0,642.0,642.0,5,1062,3.0,794.0,794.0
0.047,17,2,138,1,61,0.0,33.0,33.0,1,77,0.0,49.0,49.0
0.135,6,10,1506,5,395,31.0,127.0,127.0,5,1111,32.0,843.0,843.0
0.012,6,10,1631,5,848,3.0,580.0,580.0,5,783,3.0,515.0,515.0
170.318,6,22,8496,12,2236,78.0,1345.0,574.0,10,6260,18905.0,2720.0,974.0
240.013,6,9,787,5,488,60003.0,232.0,232.0,4,299,80003.0,83.0,83.0
0.019,6,10,1972,5,910,4.0,642.0,642.0,5,1062,4.0,794.0,794.0
0.005,6,10,2000,5,927,1.0,659.0,659.0,5,1073,1.0,805.0,805.0
0.01,6,10,1972,5,910,2.0,642.0,642.0,5,1062,2.0,794.0,794.0
0.014,6,10,1989,5,910,3.0,642.0,642.0,5,1079,3.0,811.0,811.0
0.123,6,10,1506,5,395,30.0,127.0,127.0,5,1111,29.0,843.0,843.0
0.004,6,10,1779,5,928,1.0,660.0,660.0,5,851,1.0,583.0,583.0
0.091,6,10,1506,5,395,19.0,127.0,127.0,5,1111,19.0,843.0,843.0
0.04,17,4,284,2,120,0.0,32.0,32.0,2,164,37.0,60.0,54.0
0.072,17,2,234,1,61,0.0,33.0,33.0,1,173,0.0,145.0,145.0
0.097,6,10,1506,5,395,21.0,127.0,127.0,5,1111,22.0,843.0,843.0
0.022,6,10,1972,5,910,5.0,642.0,642.0,5,1062,5.0,794.0,794.0
0.005,6,10,2006,5,927,1.0,659.0,659.0,5,1079,1.0,811.0,811.0
354.002,6,21,1795,16,1030,23600.0,190.0,190.0,5,765,60001.0,464.0,248.0
0.017,6,10,1990,5,911,4.0,643.0,643.0,5,1079,4.0,811.0,811.0
309.562,17,20,1124,10,716,34389.0,48.0,43.0,10,408,34389.0,20.0,12.0
0.017,6,10,1989,5,910,4.0,642.0,642.0,5,1079,4.0,811.0,811.0
0.004,6,10,1989,5,927,1.0,659.0,659.0,5,1062,1.0,794.0,794.0
0.016,6,10,1989,5,910,3.0,642.0,642.0,5,1079,4.0,811.0,811.0
0.005,6,10,1779,5,928,1.0,660.0,660.0,5,851,1.0,583.0,583.0
10.9,17,28,4421,14,1993,829.0,268.0,114.0,14,2428,830.0,587.0,145.0
0.004,6,10,2007,5,928,1.0,660.0,660.0,5,1079,1.0,811.0,811.0
159.563,17,72,10346,36,2405,4558.0,44.0,38.0,36,7941,4558.0,239.0,192.0
1792.37,6,279,26139,140,9145,12894.0,748.0,263.0,139,16994,12988.0,1624.0,73.0
0.006,6,10,1689,5,839,1.0,571.0,571.0,5,850,1.0,582.0,582.0
0.015,6,10,1989,5,910,3.0,642.0,642.0,5,1079,3.0,811.0,811.0
0.01,6,10,1677,5,827,2.0,559.0,559.0,5,850,2.0,582.0,582.0
0.123,17,2,136,1,60,0.0,32.0,32.0,1,76,0.0,48.0,48.0
0.019,6,10,1990,5,911,4.0,643.0,643.0,5,1079,4.0,811.0,811.0
0.013,6,10,1972,5,910,3.0,642.0,642.0,5,1062,3.0,794.0,794.0
0.004,6,10,2006,5,927,1.0,659.0,659.0,5,1079,1.0,811.0,811.0
0.004,6,10,2006,5,927,1.0,659.0,659.0,5,1079,1.0,811.0,811.0
0.005,6,10,1989,5,927,1.0,659.0,659.0,5,1062,1.0,794.0,794.0
0.004,6,10,2007,5,928,1.0,660.0,660.0,5,1079,1.0,811.0,811.0
117.26,58,5,360,4,288,39086.0,24.0,24.0,1,72,0.0,24.0,24.0
0.005,6,10,2007,5,928,1.0,660.0,660.0,5,1079,1.0,811.0,811.0
0.005,6,10,1702,5,863,1.0,595.0,595.0,5,839,1.0,571.0,571.0
0.005,6,10,1774,5,923,1.0,655.0,655.0,5,851,1.0,583.0,583.0
0.004,17,2,148,1,60,0.0,32.0,32.0,1,88,0.0,60.0,60.0
0.005,6,10,1643,5,860,1.0,592.0,592.0,5,783,1.0,515.0,515.0
0.006,17,2,164,1,74,0.0,46.0,46.0,1,90,0.0,62.0,62.0
0.006,6,14,3799,7,509,1.0,137.0,137.0,7,3290,1.0,1448.0,972.0
0.011,6,10,1990,5,911,2.0,643.0,643.0,5,1079,2.0,811.0,811.0
0.012,6,10,1972,5,910,2.0,642.0,642.0,5,1062,3.0,794.0,794.0
0.018,6,10,1631,5,848,4.0,580.0,580.0,5,783,4.0,515.0,515.0
0.012,6,10,1989,5,910,3.0,642.0,642.0,5,1079,3.0,811.0,811.0
0.001,17,2,132,1,58,0.0,30.0,30.0,1,74,0.0,46.0,46.0
10.787,17,28,4420,14,1993,821.0,268.0,114.0,14,2427,821.0,586.0,145.0
309.462,17,20,1124,10,716,34370.0,48.0,43.0,10,408,34370.0,20.0,12.0
0.004,17,2,148,1,60,0.0,32.0,32.0,1,88,0.0,60.0,60.0
0.006,6,10,2006,5,927,1.0,659.0,659.0,5,1079,1.0,811.0,811.0
0.105,6,10,1506,5,395,25.0,127.0,127.0,5,1111,24.0,843.0,843.0
0.129,6,10,1506,5,395,30.0,127.0,127.0,5,1111,31.0,843.0,843.0
0.005,6,10,2006,5,927,1.0,659.0,659.0,5,1079,1.0,811.0,811.0
0.006,17,2,170,1,65,0.0,37.0,37.0,1,105,0.0,77.0,77.0
40.051,17,10,676,5,460,10012.0,104.0,64.0,5,216,10012.0,20.0,15.0
0.009,17,2,179,1,71,0.0,43.0,43.0,1,108,0.0,80.0,80.0
0.005,6,10,2006,5,927,1.0,659.0,659.0,5,1079,1.0,811.0,811.0
0.014,6,10,1762,5,911,3.0,643.0,643.0,5,851,3.0,583.0,583.0
0.005,6,10,2000,5,927,1.0,659.0,659.0,5,1073,1.0,805.0,805.0
0.013,6,10,1983,5,910,3.0,642.0,642.0,5,1073,3.0,805.0,805.0
0.01,6,10,1989,5,910,2.0,642.0,642.0,5,1079,2.0,811.0,811.0
0.167,17,2,152,1,76,0.0,48.0,48.0,1,76,0.0,48.0,48.0
0.095,6,10,1506,5,395,19.0,127.0,127.0,5,1111,21.0,843.0,843.0
0.004,6,10,2007,5,928,1.0,660.0,660.0,5,1079,1.0,811.0,811.0
0.096,6,10,1506,5,395,20.0,127.0,127.0,5,1111,23.0,843.0,843.0
0.005,6,10,1689,5,839,1.0,571.0,571.0,5,850,1.0,582.0,582.0
240.035,6,9,787,5,488,60008.0,232.0,232.0,4,299,80010.0,83.0,83.0
0.001,17,2,136,1,60,0.0,32.0,32.0,1,76,0.0,48.0,48.0
1770.634,17,120,11460,60,5460,30010.0,63.0,63.0,60,6000,30010.0,72.0,72.0
0.01,6,14,3868,7,578,1.0,206.0,206.0,7,3290,1.0,1448.0,972.0
0.015,6,10,1972,5,910,3.0,642.0,642.0,5,1062,3.0,794.0,794.0
376.86,58,6,432,5,360,94215.0,24.0,24.0,1,72,0.0,24.0,24.0
0.107,6,10,1506,5,395,21.0,127.0,127.0,5,1111,24.0,843.0,843.0
0.005,17,2,152,1,68,0.0,40.0,40.0,1,84,0.0,56.0,56.0
0.069,6,10,1506,5,395,15.0,127.0,127.0,5,1111,16.0,843.0,843.0
0.009,6,10,1989,5,910,2.0,642.0,642.0,5,1079,2.0,811.0,811.0
0.079,6,10,1506,5,395,15.0,127.0,127.0,5,1111,15.0,843.0,843.0
0.015,6,6,716,3,458,6.0,302.0,302.0,3,258,4.0,102.0,102.0
0.009,6,10,1677,5,827,2.0,559.0,559.0,5,850,2.0,582.0,582.0
0.013,6,10,1989,5,910,3.0,642.0,642.0,5,1079,3.0,811.0,811.0
0.008,6,10,1762,5,911,2.0,643.0,643.0,5,851,1.0,583.0,583.0
0.005,6,10,1643,5,860,1.0,592.0,592.0,5,783,1.0,515.0,515.0
0.01,6,10,1989,5,910,2.0,642.0,642.0,5,1079,2.0,811.0,811.0
0.005,17,2,142,1,63,0.0,35.0,35.0,1,79,0.0,51.0,51.0
0.005,6,10,2006,5,927,1.0,659.0,659.0,5,1079,1.0,811.0,811.0
0.005,6,10,2006,5,927,1.0,659.0,659.0,5,1079,1.0,811.0,811.0
0.004,6,10,2006,5,927,1.0,659.0,659.0,5,1079,1.0,811.0,811.0
0.005,6,10,1774,5,923,1.0,655.0,655.0,5,851,1.0,583.0,583.0
0.012,6,10,1989,5,910,3.0,642.0,642.0,5,1079,2.0,811.0,811.0
0.004,6,10,1989,5,927,1.0,659.0,659.0,5,1062,1.0,794.0,794.0
0.004,17,4,284,2,120,0.0,32.0,32.0,2,164,0.0,60.0,54.0
0.019,6,10,1990,5,911,4.0,643.0,643.0,5,1079,4.0,811.0,811.0
40.086,17,10,676,5,460,10018.0,104.0,64.0,5,216,10020.0,20.0,15.0
0.073,6,10,1506,5,395,16.0,127.0,127.0,5,1111,16.0,843.0,843.0
0.005,6,10,2007,5,928,1.0,660.0,660.0,5,1079,1.0,811.0,811.0
0.001,17,2,180,1,66,0.0,38.0,38.0,1,114,0.0,86.0,86.0
0.006,6,10,1547,5,764,1.0,496.0,496.0,5,783,1.0,515.0,515.0
0.08,6,10,1506,5,395,16.0,127.0,127.0,5,1111,16.0,843.0,843.0
0.005,6,10,1989,5,927,1.0,659.0,659.0,5,1062,1.0,794.0,794.0
40.057,17,10,676,5,460,10013.0,104.0,64.0,5,216,10013.0,20.0,15.0
0.013,6,10,1990,5,911,3.0,643.0,643.0,5,1079,3.0,811.0,811.0
371.366,6,22,2313,16,867,24757.0,195.0,195.0,6,1446,4645.0,419.0,398.0
0.018,6,10,1677,5,827,4.0,559.0,559.0,5,850,4.0,582.0,582.0
0.061,6,10,1506,5,395,14.0,127.0,127.0,5,1111,13.0,843.0,843.0
40.062,17,10,676,5,460,10014.0,104.0,64.0,5,216,10014.0,20.0,15.0
0.005,6,10,1989,5,927,1.0,659.0,659.0,5,1062,1.0,794.0,794.0
0.004,6,10,1702,5,863,1.0,595.0,595.0,5,839,1.0,571.0,571.0
0.014,6,10,1972,5,910,3.0,642.0,642.0,5,1062,3.0,794.0,794.0
0.042,17,2,152,1,76,0.0,48.0,48.0,1,76,0.0,48.0,48.0
0.004,6,10,2006,5,927,1.0,659.0,659.0,5,1079,1.0,811.0,811.0
1778.69,17,144,41760,72,22752,25051.0,288.0,288.0,72,19008,25051.0,236.0,236.0
0.006,6,10,1547,5,764,1.0,496.0,496.0,5,783,1.0,515.0,515.0
0.108,6,10,1506,5,395,23.0,127.0,127.0,5,1111,25.0,843.0,843.0
0.003,17,4,284,2,120,0.0,32.0,32.0,2,164,0.0,60.0,54.0
0.005,17,2,230,1,68,0.0,40.0,40.0,1,162,0.0,134.0,134.0
0.004,6,10,2006,5,927,1.0,659.0,659.0,5,1079,1.0,811.0,811.0
0.011,6,10,1990,5,911,2.0,643.0,643.0,5,1079,2.0,811.0,811.0
160.585,17,76,10683,38,2537,4340.0,44.0,38.0,38,8146,4340.0,261.0,186.0
0.087,6,10,1506,5,395,20.0,127.0,127.0,5,1111,16.0,843.0,843.0
0.003,17,4,284,2,120,0.0,32.0,32.0,2,164,0.0,60.0,54.0
0.006,17,2,194,1,59,0.0,31.0,31.0,1,135,0.0,107.0,107.0
0.018,6,10,1989,5,910,4.0,642.0,642.0,5,1079,4.0,811.0,811.0
0.097,6,10,1506,5,395,20.0,127.0,127.0,5,1111,22.0,843.0,843.0
0.008,6,10,1990,5,911,2.0,643.0,643.0,5,1079,2.0,811.0,811.0
0.081,6,10,1506,5,395,16.0,127.0,127.0,5,1111,19.0,843.0,843.0
0.009,6,10,1989,5,910,2.0,642.0,642.0,5,1079,2.0,811.0,811.0
1770.3,6,89,4755,45,2394,40233.0,27.0,27.0,44,2361,41168.0,26.0,24.0
0.015,6,10,1983,5,910,3.0,642.0,642.0,5,1073,3.0,805.0,805.0
0.114,6,10,1506,5,395,24.0,127.0,127.0,5,1111,24.0,843.0,843.0
0.014,6,10,1989,5,910,3.0,642.0,642.0,5,1079,3.0,811.0,811.0
0.005,6,10,2007,5,928,1.0,660.0,660.0,5,1079,1.0,811.0,811.0
0.011,6,12,1926,6,1189,2.0,659.0,434.0,6,737,2.0,417.0,417.0
0.008,6,10,2006,5,927,1.0,659.0,659.0,5,1079,2.0,811.0,811.0
0.012,6,10,1989,5,910,2.0,642.0,642.0,5,1079,2.0,811.0,811.0
0.32,17,42,22990,23,18466,14.0,1350.0,774.0,19,4524,14.0,1350.0,210.0
0.005,6,10,2006,5,927,1.0,659.0,659.0,5,1079,1.0,811.0,811.0
241.295,6,321,344440,120,17760,2027.0,2736.0,960.0,201,326680,1206.0,2804.0,1655.0
0.004,17,4,284,2,120,1.0,32.0,32.0,2,164,0.0,60.0,54.0
0.095,6,10,1506,5,395,20.0,127.0,127.0,5,1111,22.0,843.0,843.0
0.003,17,2,136,1,60,0.0,32.0,32.0,1,76,0.0,48.0,48.0
280.834,6,251,200813,128,187836,11.0,3990.0,1826.0,123,12977,2301.0,1330.0,321.0
0.066,17,2,152,1,76,0.0,48.0,48.0,1,76,0.0,48.0,48.0
0.074,6,10,1506,5,395,16.0,127.0,127.0,5,1111,16.0,843.0,843.0
126.041,6,14,2938,8,2504,17971.0,1414.0,1086.0,6,434,25160.0,182.0,182.0
0.015,6,10,1983,5,910,3.0,642.0,642.0,5,1073,3.0,805.0,805.0
0.005,17,2,412,1,61,0.0,33.0,33.0,1,351,0.0,323.0,323.0
0.064,6,10,1506,5,395,14.0,127.0,127.0,5,1111,13.0,843.0,843.0
0.005,6,10,1643,5,860,1.0,592.0,592.0,5,783,1.0,515.0,515.0
0.024,6,10,1989,5,910,6.0,642.0,642.0,5,1079,5.0,811.0,811.0
0.086,6,10,1506,5,395,19.0,127.0,127.0,5,1111,18.0,843.0,843.0
0.093,6,10,1506,5,395,20.0,127.0,127.0,5,1111,20.0,843.0,843.0
0.01,6,10,1972,5,910,2.0,642.0,642.0,5,1062,2.0,794.0,794.0
0.038,6,13,3913,7,495,6.0,123.0,123.0,6,3418,7.0,1650.0,1549.0
0.009,6,10,1989,5,910,2.0,642.0,642.0,5,1079,2.0,811.0,811.0
0.005,6,10,2000,5,927,1.0,659.0,659.0,5,1073,1.0,805.0,805.0
0.016,17,2,198,1,91,0.0,63.0,63.0,1,107,0.0,79.0,79.0
0.004,6,10,1779,5,928,1.0,660.0,660.0,5,851,1.0,583.0,583.0
178.065,17,78,11107,39,2605,4685.0,44.0,38.0,39,8502,4685.0,261.0,190.0
300.308,6,27,8059,15,1482,21450.0,384.0,173.0,12,6577,21845.0,1402.0,849.0
0.008,6,10,1990,5,911,2.0,643.0,643.0,5,1079,2.0,811.0,811.0
0.001,17,2,166,1,75,0.0,47.0,47.0,1,91,0.0,63.0,63.0
10.948,17,28,4396,14,2313,833.0,588.0,137.0,14,2083,833.0,270.0,120.0
0.005,6,10,1774,5,923,1.0,655.0,655.0,5,851,1.0,583.0,583.0
240.114,6,9,787,5,488,60028.0,232.0,232.0,4,299,80021.0,83.0,83.0
302.215,6,52,19215,28,13228,11193.0,2720.0,1004.0,24,5987,391.0,2667.0,385.0
0.007,6,10,1972,5,910,1.0,642.0,642.0,5,1062,1.0,794.0,794.0
0.005,17,2,144,1,64,0.0,36.0,36.0,1,80,0.0,52.0,52.0
40.062,17,10,676,5,460,10013.0,104.0,64.0,5,216,10014.0,20.0,15.0
0.016,6,10,1989,5,910,4.0,642.0,642.0,5,1079,3.0,811.0,811.0
1777.449,17,144,45504,72,22752,25034.0,288.0,288.0,72,22752,25034.0,288.0,288.0
106.876,6,22,7437,11,1305,110.0,530.0,277.0,11,6132,10671.0,1823.0,946.0
0.052,17,2,152,1,76,0.0,48.0,48.0,1,76,0.0,48.0,48.0
0.071,17,2,136,1,60,0.0,32.0,32.0,1,76,0.0,48.0,48.0
0.008,6,12,1926,6,1189,1.0,659.0,434.0,6,737,1.0,417.0,417.0
0.358,17,40,21640,22,18406,17.0,1350.0,808.0,18,3234,17.0,1350.0,151.0
0.011,6,10,1990,5,911,2.0,643.0,643.0,5,1079,2.0,811.0,811.0
0.038,17,2,152,1,76,0.0,48.0,48.0,1,76,0.0,48.0,48.0
1778.761,17,143,41496,72,22752,25052.0,288.0,288.0,71,18744,25410.0,236.0,236.0
0.01,6,10,1983,5,910,2.0,642.0,642.0,5,1073,2.0,805.0,805.0
0.005,6,10,2006,5,927,1.0,659.0,659.0,5,1079,1.0,811.0,811.0
0.068,6,10,1506,5,395,15.0,127.0,127.0,5,1111,13.0,843.0,843.0
0.006,6,10,1547,5,764,1.0,496.0,496.0,5,783,1.0,515.0,515.0
0.013,6,10,1631,5,848,3.0,580.0,580.0,5,783,3.0,515.0,515.0
0.012,6,10,1990,5,911,3.0,643.0,643.0,5,1079,3.0,811.0,811.0
0.004,6,10,1702,5,863,1.0,595.0,595.0,5,839,0.0,571.0,571.0
0.018,6,10,1990,5,911,4.0,643.0,643.0,5,1079,4.0,811.0,811.0
0.004,6,10,1774,5,923,1.0,655.0,655.0,5,851,1.0,583.0,583.0
0.015,6,10,1972,5,910,3.0,642.0,642.0,5,1062,3.0,794.0,794.0
177.387,17,78,11137,39,2597,4667.0,44.0,38.0,39,8540,4668.0,261.0,190.0
69.99,6,21,8145,11,1985,85.0,1174.0,504.0,10,6160,7757.0,2720.0,958.0
0.017,6,10,1762,5,911,4.0,643.0,643.0,5,851,4.0,583.0,583.0
0.005,17,2,164,1,74,0.0,46.0,46.0,1,90,0.0,62.0,62.0
0.016,17,2,180,1,66,0.0,38.0,38.0,1,114,0.0,86.0,86.0
0.014,6,10,1989,5,910,3.0,642.0,642.0,5,1079,3.0,811.0,811.0
240.102,6,31,8919,15,6529,17150.0,1655.0,639.0,16,2390,16006.0,580.0,193.0
0.015,6,10,1989,5,910,3.0,642.0,642.0,5,1079,3.0,811.0,811.0
0.005,6,14,3736,7,446,0.0,74.0,74.0,7,3290,0.0,1448.0,972.0
0.004,6,10,1989,5,927,1.0,659.0,659.0,5,1062,1.0,794.0,794.0
0.005,17,2,199,1,68,0.0,40.0,40.0,1,131,0.0,103.0,103.0
0.004,17,4,284,2,120,0.0,32.0,32.0,2,164,1.0,60.0,54.0
0.005,6,10,2006,5,927,1.0,659.0,659.0,5,1079,1.0,811.0,811.0
240.012,6,9,787,5,488,60003.0,232.0,232.0,4,299,80002.0,83.0,83.0
0.018,6,10,1631,5,848,4.0,580.0,580.0,5,783,4.0,515.0,515.0
15.082,17,16,8415,8,6263,2149.0,1350.0,754.0,8,2152,2150.0,1350.0,241.0
11.158,17,28,4422,14,1994,845.0,269.0,114.0,14,2428,845.0,587.0,145.0
0.39,17,16,9973,8,6917,55.0,1350.0,836.0,8,3056,44.0,1350.0,354.0
0.005,6,10,2000,5,927,1.0,659.0,659.0,5,1073,1.0,805.0,805.0
0.005,17,2,169,1,62,0.0,34.0,34.0,1,107,0.0,79.0,79.0
0.013,17,2,152,1,76,0.0,48.0,48.0,1,76,0.0,48.0,48.0
353.274,6,20,2210,6,1308,12003.0,494.0,494.0,14,902,27174.0,83.0,83.0
0.005,6,10,2006,5,927,1.0,659.0,659.0,5,1079,1.0,811.0,811.0
0.005,6,10,1989,5,927,1.0,659.0,659.0,5,1062,1.0,794.0,794.0
0.005,6,10,2006,5,927,1.0,659.0,659.0,5,1079,1.0,811.0,811.0
0.016,6,11,1729,6,879,3.0,559.0,559.0,5,850,4.0,582.0,582.0
1.529,6,38,6827,21,3555,76.0,1103.0,204.0,17,3272,91.0,1796.0,396.0
0.09,6,10,1506,5,395,18.0,127.0,127.0,5,1111,20.0,843.0,843.0
1.096,6,30,13239,17,5840,68.0,2073.0,854.0,13,7399,77.0,2720.0,858.0
0.107,6,10,1506,5,395,26.0,127.0,127.0,5,1111,25.0,843.0,843.0
0.012,6,10,1983,5,910,3.0,642.0,642.0,5,1073,3.0,805.0,805.0
0.005,6,10,2007,5,928,1.0,660.0,660.0,5,1079,1.0,811.0,811.0
0.006,17,2,214,1,75,0.0,47.0,47.0,1,139,0.0,111.0,111.0
0.001,17,2,174,1,72,0.0,44.0,44.0,1,102,0.0,74.0,74.0
0.012,6,10,1631,5,848,2.0,580.0,580.0,5,783,3.0,515.0,515.0
0.138,6,10,1506,5,395,30.0,127.0,127.0,5,1111,31.0,843.0,843.0
0.005,6,10,2006,5,927,1.0,659.0,659.0,5,1079,1.0,811.0,811.0
0.053,17,2,152,1,76,0.0,48.0,48.0,1,76,0.0,48.0,48.0
0.135,17,2,80,1,32,0.0,4.0,4.0,1,48,0.0,20.0,20.0
0.016,6,10,1989,5,910,4.0,642.0,642.0,5,1079,3.0,811.0,811.0
240.167,6,44,6792,21,3174,12008.0,588.0,230.0,23,3618,10916.0,580.0,241.0
0.013,6,12,1926,6,1189,2.0,659.0,434.0,6,737,2.0,417.0,417.0
0.079,17,4,352,2,130,42.0,37.0,37.0,2,222,39.0,89.0,83.0
0.012,6,10,1762,5,911,2.0,643.0,643.0,5,851,3.0,583.0,583.0
0.007,6,10,1547,5,764,1.0,496.0,496.0,5,783,1.0,515.0,515.0
0.223,6,10,1506,5,395,53.0,127.0,127.0,5,1111,51.0,843.0,843.0
310.779,17,20,1124,10,716,34516.0,48.0,43.0,10,408,34516.0,20.0,12.0
0.088,6,10,1506,5,395,21.0,127.0,127.0,5,1111,20.0,843.0,843.0
0.13,17,2,396,1,61,0.0,33.0,33.0,1,335,0.0,307.0,307.0
0.11,6,10,1506,5,395,26.0,127.0,127.0,5,1111,26.0,843.0,843.0
0.063,6,10,1506,5,395,13.0,127.0,127.0,5,1111,14.0,843.0,843.0
40.063,17,10,676,5,460,10013.0,104.0,64.0,5,216,10015.0,20.0,15.0
0.117,6,10,1506,5,395,24.0,127.0,127.0,5,1111,25.0,843.0,843.0
0.17,17,2,152,1,76,0.0,48.0,48.0,1,76,0.0,48.0,48.0
0.132,6,10,1506,5,395,29.0,127.0,127.0,5,1111,29.0,843.0,843.0
0.069,6,10,1506,5,395,14.0,127.0,127.0,5,1111,15.0,843.0,843.0
0.012,6,10,1762,5,911,3.0,643.0,643.0,5,851,2.0,583.0,583.0
0.005,17,2,170,1,65,0.0,37.0,37.0,1,105,0.0,77.0,77.0
0.012,6,10,1989,5,910,3.0,642.0,642.0,5,1079,2.0,811.0,811.0
0.005,6,10,1774,5,923,1.0,655.0,655.0,5,851,1.0,583.0,583.0
351.991,6,20,2210,6,1308,12003.0,494.0,494.0,14,902,27076.0,83.0,83.0
0.028,6,10,1990,5,911,7.0,643.0,643.0,5,1079,6.0,811.0,811.0
0.005,6,10,1779,5,928,1.0,660.0,660.0,5,851,1.0,583.0,583.0
0.128,17,2,80,1,32,0.0,4.0,4.0,1,48,0.0,20.0,20.0
15.074,17,14,9190,8,6902,2149.0,1350.0,834.0,6,2288,3009.0,1350.0,353.0
0.009,6,12,1926,6,1189,1.0,659.0,434.0,6,737,1.0,417.0,417.0
0.006,6,10,1547,5,764,1.0,496.0,496.0,5,783,1.0,515.0,515.0
0.005,6,10,1779,5,928,1.0,660.0,660.0,5,851,1.0,583.0,583.0
0.039,17,2,166,1,75,0.0,47.0,47.0,1,91,0.0,63.0,63.0
0.006,6,10,1547,5,764,1.0,496.0,496.0,5,783,1.0,515.0,515.0
0.012,17,2,214,1,75,0.0,47.0,47.0,1,139,0.0,111.0,111.0
0.038,17,4,596,2,122,1.0,33.0,33.0,2,474,1.0,323.0,209.0
0.009,6,10,1983,5,910,2.0,642.0,642.0,5,1073,2.0,805.0,805.0
0.005,6,10,2007,5,928,1.0,660.0,660.0,5,1079,1.0,811.0,811.0
0.1,6,10,1506,5,395,21.0,127.0,127.0,5,1111,21.0,843.0,843.0
0.04,17,2,152,1,76,0.0,48.0,48.0,1,76,0.0,48.0,48.0
0.019,6,10,1989,5,910,4.0,642.0,642.0,5,1079,4.0,811.0,811.0
0.005,6,10,2006,5,927,1.0,659.0,659.0,5,1079,1.0,811.0,811.0
0.017,6,10,1972,5,910,4.0,642.0,642.0,5,1062,4.0,794.0,794.0
0.005,6,10,1989,5,927,1.0,659.0,659.0,5,1062,1.0,794.0,794.0
300.097,6,19,4661,11,1102,30009.0,238.0,130.0,8,3559,42870.0,1402.0,786.0
10.95,17,34,6366,17,2656,677.0,269.0,128.0,17,3710,677.0,1145.0,190.0
0.006,6,10,1854,5,889,1.0,621.0,621.0,5,965,1.0,697.0,697.0
0.006,17,2,169,1,62,0.0,34.0,34.0,1,107,0.0,79.0,79.0
0.015,6,10,1631,5,848,3.0,580.0,580.0,5,783,3.0,515.0,515.0
0.006,6,10,1643,5,860,1.0,592.0,592.0,5,783,1.0,515.0,515.0
0.175,17,2,152,1,76,0.0,48.0,48.0,1,76,0.0,48.0,48.0
0.011,6,10,1990,5,911,2.0,643.0,643.0,5,1079,2.0,811.0,811.0
472.297,6,35,5875,16,4298,12004.0,494.0,494.0,19,1577,26238.0,83.0,83.0
0.013,6,10,1631,5,848,3.0,580.0,580.0,5,783,3.0,515.0,515.0
0.006,6,10,1689,5,839,1.0,571.0,571.0,5,850,1.0,582.0,582.0
40.079,17,10,676,5,460,10014.0,104.0,64.0,5,216,10014.0,20.0,15.0
0.009,6,10,1989,5,910,2.0,642.0,642.0,5,1079,2.0,811.0,811.0
0.011,6,10,1989,5,910,2.0,642.0,642.0,5,1079,2.0,811.0,811.0
15.073,17,15,9239,8,6902,2149.0,1350.0,834.0,7,2337,2507.0,1350.0,305.0
0.009,6,10,1972,5,910,2.0,642.0,642.0,5,1062,2.0,794.0,794.0
0.016,6,10,1762,5,911,4.0,643.0,643.0,5,851,3.0,583.0,583.0
0.007,17,2,299,1,65,0.0,37.0,37.0,1,234,0.0,206.0,206.0
0.014,6,10,1989,5,910,3.0,642.0,642.0,5,1079,3.0,811.0,811.0
0.006,6,10,1547,5,764,1.0,496.0,496.0,5,783,1.0,515.0,515.0
0.041,17,4,420,2,122,0.0,33.0,33.0,2,298,38.0,145.0,121.0
0.04,17,2,152,1,76,0.0,48.0,48.0,1,76,0.0,48.0,48.0
0.001,17,2,166,1,75,0.0,47.0,47.0,1,91,0.0,63.0,63.0
0.035,17,2,178,1,81,0.0,53.0,53.0,1,97,0.0,69.0,69.0
0.005,6,10,1547,5,764,1.0,496.0,496.0,5,783,1.0,515.0,515.0
0.005,6,14,3736,7,446,0.0,74.0,74.0,7,3290,0.0,1448.0,972.0
0.016,6,10,1989,5,910,3.0,642.0,642.0,5,1079,4.0,811.0,811.0
0.012,6,10,1972,5,910,3.0,642.0,642.0,5,1062,2.0,794.0,794.0
0.004,17,2,148,1,60,0.0,32.0,32.0,1,88,0.0,60.0,60.0
0.005,6,10,2007,5,928,1.0,660.0,660.0,5,1079,1.0,811.0,811.0
0.005,6,10,2007,5,928,1.0,660.0,660.0,5,1079,1.0,811.0,811.0
0.074,6,10,1506,5,395,16.0,127.0,127.0,5,1111,14.0,843.0,843.0
0.103,6,10,1506,5,395,23.0,127.0,127.0,5,1111,21.0,843.0,843.0
15.078,17,15,8299,8,6098,2150.0,1350.0,734.0,7,2201,2508.0,1350.0,286.0
0.006,17,2,248,1,58,0.0,30.0,30.0,1,190,0.0,162.0,162.0
0.004,6,10,1989,5,927,1.0,659.0,659.0,5,1062,1.0,794.0,794.0
0.107,6,10,1506,5,395,22.0,127.0,127.0,5,1111,26.0,843.0,843.0
0.017,6,10,1989,5,910,4.0,642.0,642.0,5,1079,4.0,811.0,811.0
11.379,17,28,4421,14,1993,863.0,268.0,114.0,14,2428,863.0,587.0,145.0
0.006,6,10,1547,5,764,1.0,496.0,496.0,5,783,1.0,515.0,515.0
0.005,6,10,1989,5,927,1.0,659.0,659.0,5,1062,1.0,794.0,794.0
11.086,17,28,4416,14,1993,840.0,268.0,114.0,14,2423,840.0,586.0,145.0
0.017,6,10,1631,5,848,4.0,580.0,580.0,5,783,4.0,515.0,515.0
0.006,6,10,1547,5,764,1.0,496.0,496.0,5,783,1.0,515.0,515.0
0.005,6,10,2006,5,927,1.0,659.0,659.0,5,1079,1.0,811.0,811.0
0.094,6,10,1506,5,395,21.0,127.0,127.0,5,1111,21.0,843.0,843.0
10.727,17,28,4423,14,1995,816.0,270.0,114.0,14,2428,816.0,587.0,145.0
40.08,17,10,676,5,460,10019.0,104.0,64.0,5,216,10019.0,20.0,15.0
0.007,6,10,1854,5,889,1.0,621.0,621.0,5,965,1.0,697.0,697.0
361.783,6,19,1689,15,978,25841.0,190.0,190.0,4,711,80014.0,495.0,495.0
11.183,17,28,4422,14,1994,847.0,269.0,114.0,14,2428,847.0,587.0,145.0
15.103,17,15,8195,8,6053,2152.0,1350.0,728.0,7,2142,2511.0,1350.0,278.0
0.068,6,10,1506,5,395,16.0,127.0,127.0,5,1111,14.0,843.0,843.0
0.012,6,10,1989,5,910,3.0,642.0,642.0,5,1079,3.0,811.0,811.0
0.008,6,10,1989,5,910,2.0,642.0,642.0,5,1079,2.0,811.0,811.0
0.009,6,10,2006,5,927,2.0,659.0,659.0,5,1079,2.0,811.0,811.0
0.013,6,10,1972,5,910,3.0,642.0,642.0,5,1062,3.0,794.0,794.0
0.005,6,13,3747,7,509,0.0,137.0,137.0,6,3238,1.0,1470.0,1459.0
0.008,6,10,1762,5,911,2.0,643.0,643.0,5,851,2.0,583.0,583.0
0.009,6,10,1990,5,911,2.0,643.0,643.0,5,1079,2.0,811.0,811.0
0.092,6,10,1506,5,395,20.0,127.0,127.0,5,1111,21.0,843.0,843.0
0.011,6,10,1972,5,910,2.0,642.0,642.0,5,1062,2.0,794.0,794.0
0.069,17,8,3613,4,1874,23.0,1350.0,440.0,4,1739,12.0,1350.0,406.0
0.004,17,2,136,1,60,0.0,32.0,32.0,1,76,0.0,48.0,48.0
0.091,6,10,1506,5,395,18.0,127.0,127.0,5,1111,21.0,843.0,843.0
0.006,6,10,1689,5,839,1.0,571.0,571.0,5,850,1.0,582.0,582.0
0.014,17,2,136,1,60,0.0,32.0,32.0,1,76,0.0,48.0,48.0
0.046,17,4,284,2,120,5.0,32.0,32.0,2,164,43.0,60.0,54.0
0.007,17,2,179,1,71,0.0,43.0,43.0,1,108,0.0,80.0,80.0
0.014,6,10,1677,5,827,3.0,559.0,559.0,5,850,3.0,582.0,582.0
0.004,6,10,2007,5,928,1.0,660.0,660.0,5,1079,1.0,811.0,811.0
0.005,17,2,148,1,60,0.0,32.0,32.0,1,88,0.0,60.0,60.0
0.017,6,10,1989,5,910,4.0,642.0,642.0,5,1079,4.0,811.0,811.0
0.004,6,10,1989,5,927,1.0,659.0,659.0,5,1062,1.0,794.0,794.0
0.005,17,2,140,1,62,0.0,34.0,34.0,1,78,0.0,50.0,50.0
40.079,17,10,676,5,460,10014.0,104.0,64.0,5,216,10018.0,20.0,15.0
432.836,6,44,17921,23,3605,19674.0,662.0,398.0,21,14316,21641.0,1402.0,944.0
0.004,17,2,170,1,65,0.0,37.0,37.0,1,105,0.0,77.0,77.0
0.005,6,10,1547,5,764,1.0,496.0,496.0,5,783,1.0,515.0,515.0
0.017,6,10,1989,5,910,4.0,642.0,642.0,5,1079,4.0,811.0,811.0
0.004,17,2,136,1,60,0.0,32.0,32.0,1,76,0.0,48.0,48.0
0.005,6,10,2000,5,927,1.0,659.0,659.0,5,1073,1.0,805.0,805.0
0.007,6,10,1983,5,910,1.0,642.0,642.0,5,1073,1.0,805.0,805.0
0.004,17,2,148,1,60,0.0,32.0,32.0,1,88,0.0,60.0,60.0
0.007,6,10,1972,5,910,1.0,642.0,642.0,5,1062,1.0,794.0,794.0
0.004,17,4,284,2,120,0.0,32.0,32.0,2,164,0.0,60.0,54.0
0.004,17,2,136,1,60,0.0,32.0,32.0,1,76,0.0,48.0,48.0
0.088,6,10,1506,5,395,21.0,127.0,127.0,5,1111,20.0,843.0,843.0
0.098,6,10,1506,5,395,20.0,127.0,127.0,5,1111,19.0,843.0,843.0
0.004,17,2,169,1,62,0.0,34.0,34.0,1,107,0.0,79.0,79.0
0.112,6,10,1506,5,395,23.0,127.0,127.0,5,1111,25.0,843.0,843.0
0.008,6,10,1990,5,911,2.0,643.0,643.0,5,1079,2.0,811.0,811.0
40.065,17,10,676,5,460,10015.0,104.0,64.0,5,216,10014.0,20.0,15.0
0.005,6,10,1989,5,927,1.0,659.0,659.0,5,1062,1.0,794.0,794.0
0.08,6,10,1506,5,395,16.0,127.0,127.0,5,1111,15.0,843.0,843.0
0.009,6,12,1926,6,1189,1.0,659.0,434.0,6,737,1.0,417.0,417.0
40.077,17,10,676,5,460,10016.0,104.0,64.0,5,216,10018.0,20.0,15.0
0.008,6,10,1989,5,910,2.0,642.0,642.0,5,1079,2.0,811.0,811.0
0.009,6,10,1983,5,910,2.0,642.0,642.0,5,1073,2.0,805.0,805.0
0.008,6,10,1631,5,848,1.0,580.0,580.0,5,783,2.0,515.0,515.0
0.01,6,10,1990,5,911,2.0,643.0,643.0,5,1079,2.0,811.0,811.0
0.004,6,10,2000,5,927,1.0,659.0,659.0,5,1073,1.0,805.0,805.0
0.081,6,10,1506,5,395,18.0,127.0,127.0,5,1111,15.0,843.0,843.0
0.243,17,2,142,1,63,0.0,35.0,35.0,1,79,0.0,51.0,51.0
0.004,6,10,1989,5,927,1.0,659.0,659.0,5,1062,1.0,794.0,794.0
0.015,6,10,1989,5,910,3.0,642.0,642.0,5,1079,3.0,811.0,811.0
0.102,6,10,1506,5,395,23.0,127.0,127.0,5,1111,23.0,843.0,843.0
40.062,17,10,676,5,460,10014.0,104.0,64.0,5,216,10014.0,20.0,15.0
0.014,6,10,1972,5,910,3.0,642.0,642.0,5,1062,3.0,794.0,794.0
0.004,17,2,136,1,60,0.0,32.0,32.0,1,76,0.0,48.0,48.0
0.015,6,10,1972,5,910,3.0,642.0,642.0,5,1062,3.0,794.0,794.0
291.43,6,412,348789,200,21961,1464.0,2736.0,888.0,212,326828,1381.0,2804.0,1594.0
0.004,6,10,1779,5,928,1.0,660.0,660.0,5,851,1.0,583.0,583.0
11.019,17,28,4422,14,1994,839.0,269.0,114.0,14,2428,839.0,587.0,145.0
0.023,6,10,1677,5,827,5.0,559.0,559.0,5,850,5.0,582.0,582.0
0.006,6,13,3684,7,446,1.0,74.0,74.0,6,3238,1.0,1470.0,1459.0
0.11,6,10,1506,5,395,26.0,127.0,127.0,5,1111,20.0,843.0,843.0
0.011,6,10,1990,5,911,2.0,643.0,643.0,5,1079,2.0,811.0,811.0
0.005,6,10,1854,5,889,1.0,621.0,621.0,5,965,1.0,697.0,697.0
0.005,17,2,235,1,64,0.0,36.0,36.0,1,171,0.0,143.0,143.0
0.112,6,10,1506,5,395,24.0,127.0,127.0,5,1111,26.0,843.0,843.0
0.071,17,2,136,1,60,0.0,32.0,32.0,1,76,0.0,48.0,48.0
0.086,6,10,1506,5,395,17.0,127.0,127.0,5,1111,18.0,843.0,843.0
40.055,17,10,676,5,460,10013.0,104.0,64.0,5,216,10012.0,20.0,15.0
0.005,6,10,1689,5,839,1.0,571.0,571.0,5,850,1.0,582.0,582.0
0.007,17,2,194,1,59,0.0,31.0,31.0,1,135,0.0,107.0,107.0
0.009,6,10,1989,5,910,2.0,642.0,642.0,5,1079,2.0,811.0,811.0
0.011,6,10,1972,5,910,2.0,642.0,642.0,5,1062,2.0,794.0,794.0
0.171,17,2,152,1,76,0.0,48.0,48.0,1,76,0.0,48.0,48.0
0.134,6,10,1506,5,395,28.0,127.0,127.0,5,1111,27.0,843.0,843.0
0.006,6,10,1689,5,839,1.0,571.0,571.0,5,850,1.0,582.0,582.0
0.008,6,12,1926,6,1189,1.0,659.0,434.0,6,737,1.0,417.0,417.0
0.086,6,10,1506,5,395,18.0,127.0,127.0,5,1111,19.0,843.0,843.0
0.12,6,10,1506,5,395,22.0,127.0,127.0,5,1111,26.0,843.0,843.0
0.006,6,10,1547,5,764,1.0,496.0,496.0,5,783,1.0,515.0,515.0
11.704,17,42,9364,21,5102,578.0,1337.0,214.0,21,4262,578.0,863.0,174.0
11.114,17,28,4421,14,1994,842.0,269.0,114.0,14,2427,842.0,586.0,145.0
106.166,6,21,8145,11,1985,81.0,1174.0,504.0,10,6160,11777.0,2720.0,958.0
0.005,6,10,2006,5,927,1.0,659.0,659.0,5,1079,1.0,811.0,811.0
40.057,17,10,676,5,460,10013.0,104.0,64.0,5,216,10013.0,20.0,15.0
0.041,17,2,152,1,76,0.0,48.0,48.0,1,76,0.0,48.0,48.0
0.068,6,10,1506,5,395,12.0,127.0,127.0,5,1111,16.0,843.0,843.0
0.005,6,10,1689,5,839,1.0,571.0,571.0,5,850,1.0,582.0,582.0
0.022,6,10,1989,5,910,5.0,642.0,642.0,5,1079,5.0,811.0,811.0
0.006,17,2,180,1,66,0.0,38.0,38.0,1,114,0.0,86.0,86.0
0.012,6,10,1990,5,911,2.0,643.0,643.0,5,1079,2.0,811.0,811.0
0.151,6,10,1506,5,395,35.0,127.0,127.0,5,1111,34.0,843.0,843.0
0.005,17,2,230,1,68,0.0,40.0,40.0,1,162,0.0,134.0,134.0
0.004,6,10,2006,5,927,1.0,659.0,659.0,5,1079,1.0,811.0,811.0
0.003,17,2,136,1,60,0.0,32.0,32.0,1,76,0.0,48.0,48.0
0.005,6,10,2006,5,927,1.0,659.0,659.0,5,1079,1.0,811.0,811.0
0.001,17,2,180,1,66,0.0,38.0,38.0,1,114,0.0,86.0,86.0
241.348,6,376,347741,197,21761,1231.0,2736.0,959.0,179,325980,1355.0,2804.0,1873.0
11.138,17,28,4418,14,1993,844.0,268.0,114.0,14,2425,842.0,588.0,145.0
0.005,6,10,2007,5,928,1.0,660.0,660.0,5,1079,1.0,811.0,811.0
40.049,17,10,676,5,460,10011.0,104.0,64.0,5,216,10011.0,20.0,15.0
0.254,17,2,152,1,76,0.0,48.0,48.0,1,76,0.0,48.0,48.0
0.004,6,10,1779,5,928,1.0,660.0,660.0,5,851,1.0,583.0,583.0
0.005,17,2,170,1,65,0.0,37.0,37.0,1,105,0.0,77.0,77.0
0.006,6,13,3747,7,509,1.0,137.0,137.0,6,3238,1.0,1470.0,1459.0
0.012,6,10,1972,5,910,3.0,642.0,642.0,5,1062,3.0,794.0,794.0
0.006,6,10,1854,5,889,1.0,621.0,621.0,5,965,1.0,697.0,697.0
0.006,6,10,1854,5,889,1.0,621.0,621.0,5,965,1.0,697.0,697.0
0.017,6,13,3735,7,497,2.0,125.0,125.0,6,3238,3.0,1470.0,1459.0
240.088,6,16,4481,9,963,30011.0,238.0,166.0,7,3518,40014.0,1402.0,786.0
0.01,6,10,1983,5,910,2.0,642.0,642.0,5,1073,2.0,805.0,805.0
0.006,17,2,140,1,62,0.0,34.0,34.0,1,78,0.0,50.0,50.0
0.015,6,13,3735,7,497,2.0,125.0,125.0,6,3238,2.0,1470.0,1459.0
130.12,6,21,8146,11,1985,81.0,1174.0,504.0,10,6161,14438.0,2720.0,958.0
0.006,17,2,180,1,66,0.0,38.0,38.0,1,114,0.0,86.0,86.0
0.004,6,10,1989,5,927,1.0,659.0,659.0,5,1062,1.0,794.0,794.0
0.01,6,10,1989,5,910,2.0,642.0,642.0,5,1079,2.0,811.0,811.0
0.013,6,10,1989,5,910,3.0,642.0,642.0,5,1079,3.0,811.0,811.0
0.001,17,2,180,1,66,0.0,38.0,38.0,1,114,0.0,86.0,86.0
0.005,6,10,2007,5,928,1.0,660.0,660.0,5,1079,1.0,811.0,811.0
0.004,17,2,148,1,60,0.0,32.0,32.0,1,88,0.0,60.0,60.0
0.005,6,14,3799,7,509,0.0,137.0,137.0,7,3290,0.0,1448.0,972.0
0.072,6,10,1506,5,395,16.0,127.0,127.0,5,1111,16.0,843.0,843.0
0.013,6,10,1631,5,848,3.0,580.0,580.0,5,783,3.0,515.0,515.0
0.001,17,2,180,1,66,0.0,38.0,38.0,1,114,0.0,86.0,86.0
0.059,6,10,1762,5,911,14.0,643.0,643.0,5,851,14.0,583.0,583.0
0.004,6,10,1779,5,928,1.0,660.0,660.0,5,851,1.0,583.0,583.0
0.014,6,10,1972,5,910,3.0,642.0,642.0,5,1062,3.0,794.0,794.0
0.175,6,12,2996,7,549,29.0,177.0,177.0,5,2447,42.0,1402.0,1089.0
0.006,6,10,1547,5,764,1.0,496.0,496.0,5,783,1.0,515.0,515.0
0.013,6,10,1677,5,827,3.0,559.0,559.0,5,850,3.0,582.0,582.0
0.005,6,10,1689,5,839,1.0,571.0,571.0,5,850,1.0,582.0,582.0
0.005,6,10,2007,5,928,1.0,660.0,660.0,5,1079,1.0,811.0,811.0
0.01,6,10,1990,5,911,2.0,643.0,643.0,5,1079,2.0,811.0,811.0
0.005,6,14,3799,7,509,0.0,137.0,137.0,7,3290,0.0,1448.0,972.0
10.729,17,28,4421,14,1993,817.0,268.0,114.0,14,2428,817.0,587.0,145.0
15.072,17,14,9191,8,6902,2149.0,1350.0,834.0,6,2289,3008.0,1350.0,353.0
40.062,17,10,676,5,460,10014.0,104.0,64.0,5,216,10014.0,20.0,15.0
0.005,17,2,225,1,65,0.0,37.0,37.0,1,160,0.0,132.0,132.0
0.006,6,10,1547,5,764,1.0,496.0,496.0,5,783,1.0,515.0,515.0
0.14,6,10,1506,5,395,32.0,127.0,127.0,5,1111,32.0,843.0,843.0
0.015,6,10,1972,5,910,3.0,642.0,642.0,5,1062,3.0,794.0,794.0
1.169,6,33,13432,19,5933,64.0,1360.0,732.0,14,7499,76.0,2720.0,769.0
0.012,6,10,1631,5,848,3.0,580.0,580.0,5,783,2.0,515.0,515.0
0.018,6,10,1972,5,910,4.0,642.0,642.0,5,1062,4.0,794.0,794.0
0.012,17,2,230,1,68,0.0,40.0,40.0,1,162,0.0,134.0,134.0
0.009,6,12,1926,6,1189,1.0,659.0,434.0,6,737,1.0,417.0,417.0
0.005,6,10,2007,5,928,1.0,660.0,660.0,5,1079,1.0,811.0,811.0
0.085,6,10,1506,5,395,18.0,127.0,127.0,5,1111,19.0,843.0,843.0
0.005,6,10,1643,5,860,1.0,592.0,592.0,5,783,1.0,515.0,515.0
0.004,6,10,1989,5,927,1.0,659.0,659.0,5,1062,1.0,794.0,794.0
1772.008,6,105,6309,59,3485,30551.0,27.0,27.0,46,2824,39377.0,27.0,27.0
240.014,6,9,787,5,488,60003.0,232.0,232.0,4,299,80003.0,83.0,83.0
0.005,6,13,3747,7,509,0.0,137.0,137.0,6,3238,1.0,1470.0,1459.0
0.009,6,10,1762,5,911,2.0,643.0,643.0,5,851,2.0,583.0,583.0
0.005,6,10,1989,5,927,1.0,659.0,659.0,5,1062,1.0,794.0,794.0
0.006,6,10,1547,5,764,1.0,496.0,496.0,5,783,1.0,515.0,515.0
0.079,6,10,1506,5,395,17.0,127.0,127.0,5,1111,17.0,843.0,843.0
0.104,6,10,1506,5,395,23.0,127.0,127.0,5,1111,22.0,843.0,843.0
0.005,6,10,2000,5,927,1.0,659.0,659.0,5,1073,1.0,805.0,805.0
0.102,6,10,1506,5,395,24.0,127.0,127.0,5,1111,23.0,843.0,843.0
0.008,6,10,1547,5,764,2.0,496.0,496.0,5,783,2.0,515.0,515.0
0.004,6,10,1989,5,927,1.0,659.0,659.0,5,1062,1.0,794.0,794.0
0.21,6,16,2778,8,1396,30.0,533.0,324.0,8,1382,19.0,529.0,239.0
0.007,17,2,170,1,65,0.0,37.0,37.0,1,105,0.0,77.0,77.0
0.012,6,13,3735,7,497,2.0,125.0,125.0,6,3238,2.0,1470.0,1459.0
0.006,6,10,2007,5,928,1.0,660.0,660.0,5,1079,1.0,811.0,811.0
40.061,17,10,676,5,460,10013.0,104.0,64.0,5,216,10014.0,20.0,15.0
0.001,17,2,140,1,62,0.0,34.0,34.0,1,78,0.0,50.0,50.0
359.263,6,19,2158,6,1308,12004.0,494.0,494.0,13,850,29938.0,83.0,83.0
0.005,6,10,2006,5,927,1.0,659.0,659.0,5,1079,1.0,811.0,811.0
300.091,6,19,4660,11,1102,30008.0,238.0,130.0,8,3558,42869.0,1402.0,786.0
0.004,17,4,284,2,120,0.0,32.0,32.0,2,164,0.0,60.0,54.0
0.012,6,10,1677,5,827,3.0,559.0,559.0,5,850,2.0,582.0,582.0
0.005,6,10,1989,5,927,1.0,659.0,659.0,5,1062,1.0,794.0,794.0
40.064,17,10,676,5,460,10014.0,104.0,64.0,5,216,10015.0,20.0,15.0
0.004,6,10,2006,5,927,1.0,659.0,659.0,5,1079,1.0,811.0,811.0
0.009,6,10,1989,5,910,2.0,642.0,642.0,5,1079,2.0,811.0,811.0
0.014,6,10,1989,5,910,3.0,642.0,642.0,5,1079,3.0,811.0,811.0
0.072,17,2,184,1,61,0.0,33.0,33.0,1,123,0.0,95.0,95.0
0.014,6,10,1990,5,911,3.0,643.0,643.0,5,1079,3.0,811.0,811.0
308.908,17,20,1124,10,716,34311.0,48.0,43.0,10,408,34311.0,20.0,12.0
0.005,6,10,1643,5,860,1.0,592.0,592.0,5,783,1.0,515.0,515.0
0.004,6,10,2007,5,928,1.0,660.0,660.0,5,1079,1.0,811.0,811.0
0.005,6,10,2000,5,927,1.0,659.0,659.0,5,1073,1.0,805.0,805.0
0.011,6,10,1990,5,911,2.0,643.0,643.0,5,1079,2.0,811.0,811.0
40.063,17,10,676,5,460,10013.0,104.0,64.0,5,216,10015.0,20.0,15.0
0.169,17,2,152,1,76,0.0,48.0,48.0,1,76,0.0,48.0,48.0
0.005,17,2,164,1,74,0.0,46.0,46.0,1,90,0.0,62.0,62.0
0.128,17,4,352,2,130,0.0,37.0,37.0,2,222,88.0,89.0,83.0
295.133,6,405,349567,203,22749,1461.0,2736.0,870.0,202,326818,1468.0,2804.0,1691.0
0.005,6,10,2006,5,927,1.0,659.0,659.0,5,1079,1.0,811.0,811.0
0.005,6,10,2006,5,927,1.0,659.0,659.0,5,1079,1.0,811.0,811.0
40.062,17,10,676,5,460,10014.0,104.0,64.0,5,216,10014.0,20.0,15.0
0.073,17,4,596,2,122,1.0,33.0,33.0,2,474,32.0,323.0,209.0
0.005,6,10,2000,5,927,1.0,659.0,659.0,5,1073,1.0,805.0,805.0
11.044,17,28,4423,14,1994,840.0,269.0,114.0,14,2429,840.0,588.0,145.0
0.004,17,2,136,1,60,0.0,32.0,32.0,1,76,0.0,48.0,48.0
0.004,6,10,2006,5,927,1.0,659.0,659.0,5,1079,1.0,811.0,811.0
0.101,6,19,9166,11,860,10.0,280.0,280.0,8,8306,13.0,2274.0,1576.0
0.009,6,10,1990,5,911,2.0,643.0,643.0,5,1079,2.0,811.0,811.0
0.072,17,4,284,2,120,0.0,32.0,32.0,2,164,68.0,60.0,54.0
0.005,6,10,1854,5,889,1.0,621.0,621.0,5,965,1.0,697.0,697.0
0.084,17,4,596,2,122,43.0,33.0,33.0,2,474,43.0,323.0,209.0
458.62,6,45,17595,24,3735,19940.0,676.0,413.0,21,13860,19929.0,1402.0,911.0
0.012,6,10,1989,5,910,2.0,642.0,642.0,5,1079,3.0,811.0,811.0
0.014,6,10,1677,5,827,3.0,559.0,559.0,5,850,3.0,582.0,582.0
0.297,17,39,20138,21,17041,14.0,1350.0,783.0,18,3097,13.0,1350.0,144.0
0.015,6,10,1983,5,910,3.0,642.0,642.0,5,1073,3.0,805.0,805.0
0.003,17,2,148,1,60,0.0,32.0,32.0,1,88,0.0,60.0,60.0
0.015,6,10,1983,5,910,3.0,642.0,642.0,5,1073,3.0,805.0,805.0
0.004,6,10,2007,5,928,1.0,660.0,660.0,5,1079,1.0,811.0,811.0
0.017,6,10,1990,5,911,4.0,643.0,643.0,5,1079,4.0,811.0,811.0
0.069,6,10,1506,5,395,15.0,127.0,127.0,5,1111,14.0,843.0,843.0
0.092,6,10,1506,5,395,20.0,127.0,127.0,5,1111,19.0,843.0,843.0
0.041,6,10,1983,5,910,10.0,642.0,642.0,5,1073,10.0,805.0,805.0
0.038,17,2,152,1,76,0.0,48.0,48.0,1,76,0.0,48.0,48.0
0.005,6,10,2007,5,928,1.0,660.0,660.0,5,1079,1.0,811.0,811.0
1756.067,6,105,6270,60,3525,29763.0,27.0,27.0,45,2745,39909.0,27.0,27.0
0.006,6,10,1854,5,889,1.0,621.0,621.0,5,965,1.0,697.0,697.0
0.005,6,10,2006,5,927,1.0,659.0,659.0,5,1079,1.0,811.0,811.0
0.009,6,10,1989,5,910,2.0,642.0,642.0,5,1079,2.0,811.0,811.0
0.005,6,10,2000,5,927,1.0,659.0,659.0,5,1073,1.0,805.0,805.0
0.001,17,2,136,1,60,0.0,32.0,32.0,1,76,0.0,48.0,48.0
0.006,6,10,1689,5,839,1.0,571.0,571.0,5,850,1.0,582.0,582.0
0.006,6,10,1547,5,764,1.0,496.0,496.0,5,783,1.0,515.0,515.0
0.008,6,10,1983,5,910,2.0,642.0,642.0,5,1073,2.0,805.0,805.0
0.112,17,2,152,1,76,0.0,48.0,48.0,1,76,0.0,48.0,48.0
0.004,6,10,1990,5,928,1.0,660.0,660.0,5,1062,1.0,794.0,794.0
0.014,6,10,1989,5,910,3.0,642.0,642.0,5,1079,3.0,811.0,811.0
0.065,6,10,1506,5,395,14.0,127.0,127.0,5,1111,14.0,843.0,843.0
0.005,6,10,2000,5,927,1.0,659.0,659.0,5,1073,1.0,805.0,805.0
0.006,6,10,1547,5,764,1.0,496.0,496.0,5,783,1.0,515.0,515.0
0.011,6,10,1983,5,910,2.0,642.0,642.0,5,1073,2.0,805.0,805.0
0.013,6,10,1989,5,910,3.0,642.0,642.0,5,1079,3.0,811.0,811.0
0.005,6,14,3799,7,509,0.0,137.0,137.0,7,3290,0.0,1448.0,972.0
0.074,17,4,352,2,130,3.0,37.0,37.0,2,222,33.0,89.0,83.0
0.003,17,2,148,1,60,0.0,32.0,32.0,1,88,0.0,60.0,60.0
0.022,6,10,1989,5,910,5.0,642.0,642.0,5,1079,5.0,811.0,811.0
0.001,17,2,180,1,66,0.0,38.0,38.0,1,114,0.0,86.0,86.0
0.005,6,10,1989,5,927,1.0,659.0,659.0,5,1062,1.0,794.0,794.0
0.023,6,10,1989,5,910,5.0,642.0,642.0,5,1079,5.0,811.0,811.0
0.008,6,10,1989,5,927,2.0,659.0,659.0,5,1062,2.0,794.0,794.0
15.071,17,15,9238,8,6902,2149.0,1350.0,834.0,7,2336,2507.0,1350.0,305.0
0.006,6,10,1689,5,839,1.0,571.0,571.0,5,850,1.0,582.0,582.0
368.905,6,22,2313,16,867,24593.0,195.0,195.0,6,1446,4637.0,419.0,398.0
0.005,6,13,3690,7,452,0.0,80.0,80.0,6,3238,0.0,1470.0,1459.0
0.018,6,14,3868,7,578,3.0,206.0,206.0,7,3290,2.0,1448.0,972.0
240.015,6,9,787,5,488,60003.0,232.0,232.0,4,299,80003.0,83.0,83.0
0.003,17,4,284,2,120,0.0,32.0,32.0,2,164,0.0,60.0,54.0
163.505,17,78,11005,39,2600,4302.0,44.0,38.0,39,8405,4302.0,261.0,187.0
0.013,6,10,1972,5,910,3.0,642.0,642.0,5,1062,3.0,794.0,794.0
0.017,6,10,1989,5,910,4.0,642.0,642.0,5,1079,4.0,811.0,811.0
0.127,6,10,1506,5,395,28.0,127.0,127.0,5,1111,23.0,843.0,843.0
0.067,6,10,1506,5,395,15.0,127.0,127.0,5,1111,14.0,843.0,843.0
0.093,6,10,1506,5,395,20.0,127.0,127.0,5,1111,22.0,843.0,843.0
371.311,6,22,2313,16,867,24754.0,195.0,195.0,6,1446,4635.0,419.0,398.0
240.015,6,9,787,5,488,60003.0,232.0,232.0,4,299,80003.0,83.0,83.0
178.073,17,94,13591,47,3156,3871.0,44.0,39.0,47,10435,3871.0,239.0,194.0
40.087,17,10,676,5,460,10013.0,104.0,64.0,5,216,10007.0,20.0,15.0
0.133,17,2,80,1,32,0.0,4.0,4.0,1,48,0.0,20.0,20.0
0.045,6,10,1989,5,910,11.0,642.0,642.0,5,1079,11.0,811.0,811.0
0.006,6,10,1643,5,860,1.0,592.0,592.0,5,783,1.0,515.0,515.0
300.281,6,16,2170,9,684,37514.0,146.0,146.0,7,1486,50019.0,419.0,398.0
0.105,6,10,1506,5,395,21.0,127.0,127.0,5,1111,24.0,843.0,843.0
0.003,17,2,136,1,60,0.0,32.0,32.0,1,76,0.0,48.0,48.0
240.092,6,31,9075,15,6766,17149.0,1893.0,665.0,16,2309,16006.0,580.0,183.0
0.007,6,10,1990,5,911,1.0,643.0,643.0,5,1079,1.0,811.0,811.0
0.081,6,10,1506,5,395,16.0,127.0,127.0,5,1111,17.0,843.0,843.0
0.029,6,10,1989,5,910,7.0,642.0,642.0,5,1079,7.0,811.0,811.0
0.017,6,13,3735,7,497,2.0,125.0,125.0,6,3238,3.0,1470.0,1459.0
300.809,6,37,8424,20,2946,15832.0,1360.0,422.0,17,5478,538.0,2667.0,435.0
0.001,17,2,166,1,75,0.0,47.0,47.0,1,91,0.0,63.0,63.0
0.005,17,2,170,1,65,0.0,37.0,37.0,1,105,0.0,77.0,77.0
0.093,6,10,1506,5,395,20.0,127.0,127.0,5,1111,21.0,843.0,843.0
0.005,6,10,2006,5,927,1.0,659.0,659.0,5,1079,1.0,811.0,811.0
40.075,17,10,676,5,460,10015.0,104.0,64.0,5,216,10017.0,20.0,15.0
0.085,6,10,1506,5,395,17.0,127.0,127.0,5,1111,19.0,843.0,843.0
0.005,6,10,1774,5,923,1.0,655.0,655.0,5,851,1.0,583.0,583.0
311.327,17,20,1124,10,716,34578.0,48.0,43.0,10,408,34578.0,20.0,12.0
0.11,6,10,1506,5,395,24.0,127.0,127.0,5,1111,22.0,843.0,843.0
0.008,6,10,1762,5,911,1.0,643.0,643.0,5,851,2.0,583.0,583.0
0.012,6,10,1983,5,910,3.0,642.0,642.0,5,1073,3.0,805.0,805.0
0.006,6,10,1547,5,764,1.0,496.0,496.0,5,783,1.0,515.0,515.0
11.289,17,28,4421,14,1993,855.0,268.0,114.0,14,2428,854.0,587.0,145.0
0.008,6,10,1762,5,911,2.0,643.0,643.0,5,851,2.0,583.0,583.0
0.079,6,10,1506,5,395,19.0,127.0,127.0,5,1111,16.0,843.0,843.0
15.071,17,15,9239,8,6902,2149.0,1350.0,834.0,7,2337,2506.0,1350.0,305.0
0.005,6,10,1779,5,928,1.0,660.0,660.0,5,851,1.0,583.0,583.0
0.067,6,10,1506,5,395,14.0,127.0,127.0,5,1111,15.0,843.0,843.0
0.099,6,10,1506,5,395,23.0,127.0,127.0,5,1111,20.0,843.0,843.0
0.008,17,2,170,1,65,0.0,37.0,37.0,1,105,0.0,77.0,77.0
388.587,6,22,2313,16,867,25905.0,195.0,195.0,6,1446,4638.0,419.0,398.0
0.014,6,10,1989,5,910,3.0,642.0,642.0,5,1079,3.0,811.0,811.0
0.09,6,10,1506,5,395,19.0,127.0,127.0,5,1111,18.0,843.0,843.0
0.006,6,10,1854,5,889,1.0,621.0,621.0,5,965,1.0,697.0,697.0
0.005,6,10,1989,5,927,1.0,659.0,659.0,5,1062,1.0,794.0,794.0
0.005,6,10,1989,5,927,1.0,659.0,659.0,5,1062,1.0,794.0,794.0
0.005,6,13,3747,7,509,0.0,137.0,137.0,6,3238,0.0,1470.0,1459.0
0.016,6,10,1990,5,911,4.0,643.0,643.0,5,1079,4.0,811.0,811.0
292.017,6,384,347681,196,21755,1497.0,2736.0,888.0,188,325926,1561.0,2804.0,1816.0
20.371,17,50,10925,25,5712,843.0,1337.0,200.0,25,5213,844.0,861.0,180.0
0.016,6,10,1989,5,910,4.0,642.0,642.0,5,1079,4.0,811.0,811.0
0.005,6,10,1854,5,889,1.0,621.0,621.0,5,965,1.0,697.0,697.0
40.089,17,10,676,5,460,10021.0,104.0,64.0,5,216,10021.0,20.0,15.0
0.006,6,10,1547,5,764,1.0,496.0,496.0,5,783,1.0,515.0,515.0
0.134,17,4,284,2,120,0.0,32.0,32.0,2,164,131.0,60.0,54.0
10.821,17,28,4423,14,1995,823.0,270.0,114.0,14,2428,823.0,587.0,145.0
0.004,6,10,1779,5,928,1.0,660.0,660.0,5,851,1.0,583.0,583.0
0.005,6,10,2006,5,927,1.0,659.0,659.0,5,1079,1.0,811.0,811.0
0.003,17,2,148,1,60,0.0,32.0,32.0,1,88,0.0,60.0,60.0
0.779,6,10,2009,6,1655,155.0,1403.0,1403.0,4,354,182.0,182.0,182.0
0.214,6,16,2779,8,1397,30.0,533.0,324.0,8,1382,19.0,529.0,239.0
0.017,6,10,1989,5,910,4.0,642.0,642.0,5,1079,4.0,811.0,811.0
0.005,6,10,1989,5,927,1.0,659.0,659.0,5,1062,1.0,794.0,794.0
1.001,6,12,3142,6,2099,150.0,1328.0,923.0,6,1043,150.0,791.0,791.0
0.014,6,10,1989,5,910,3.0,642.0,642.0,5,1079,3.0,811.0,811.0
0.006,6,10,1779,5,928,1.0,660.0,660.0,5,851,1.0,583.0,583.0
300.326,6,16,2170,9,684,37519.0,146.0,146.0,7,1486,50026.0,419.0,398.0
0.109,6,10,1506,5,395,19.0,127.0,127.0,5,1111,23.0,843.0,843.0
0.267,17,4,352,2,130,228.0,37.0,37.0,2,222,144.0,89.0,83.0
0.005,6,10,2000,5,927,1.0,659.0,659.0,5,1073,1.0,805.0,805.0
0.124,6,10,1506,5,395,30.0,127.0,127.0,5,1111,30.0,843.0,843.0
0.012,6,10,1983,5,910,3.0,642.0,642.0,5,1073,3.0,805.0,805.0
40.065,17,10,676,5,460,10015.0,104.0,64.0,5,216,10015.0,20.0,15.0
0.005,6,10,2006,5,927,1.0,659.0,659.0,5,1079,1.0,811.0,811.0
1730.391,6,45,2790,30,1725,59668.0,35.0,35.0,15,1065,123593.0,31.0,31.0
0.01,6,10,1989,5,910,2.0,642.0,642.0,5,1079,2.0,811.0,811.0
15.072,17,14,9191,8,6902,2149.0,1350.0,834.0,6,2289,3008.0,1350.0,353.0
0.005,17,2,170,1,65,0.0,37.0,37.0,1,105,0.0,77.0,77.0
0.005,17,2,178,1,81,0.0,53.0,53.0,1,97,0.0,69.0,69.0
0.363,17,46,30791,28,26208,13.0,1350.0,908.0,18,4583,18.0,1350.0,226.0
0.006,6,10,1689,5,839,1.0,571.0,571.0,5,850,1.0,582.0,582.0
0.008,6,10,2007,5,928,2.0,660.0,660.0,5,1079,2.0,811.0,811.0
0.006,17,2,169,1,62,0.0,34.0,34.0,1,107,0.0,79.0,79.0
0.072,6,10,1506,5,395,16.0,127.0,127.0,5,1111,15.0,843.0,843.0
240.131,6,38,9674,18,1922,14125.0,517.0,163.0,20,7752,12637.0,1402.0,670.0
0.006,6,10,1989,5,927,1.0,659.0,659.0,5,1062,1.0,794.0,794.0
0.006,6,10,1547,5,764,1.0,496.0,496.0,5,783,1.0,515.0,515.0
0.011,6,10,1989,5,910,2.0,642.0,642.0,5,1079,2.0,811.0,811.0
0.011,6,10,1990,5,911,2.0,643.0,643.0,5,1079,2.0,811.0,811.0
0.225,6,16,2777,8,1395,32.0,533.0,323.0,8,1382,20.0,529.0,239.0
0.025,6,10,1983,5,910,6.0,642.0,642.0,5,1073,6.0,805.0,805.0
0.004,17,4,284,2,120,0.0,32.0,32.0,2,164,1.0,60.0,54.0
0.004,6,10,2007,5,928,1.0,660.0,660.0,5,1079,1.0,811.0,811.0
0.163,6,10,1506,5,395,36.0,127.0,127.0,5,1111,38.0,843.0,843.0
0.016,6,14,3787,7,497,2.0,125.0,125.0,7,3290,2.0,1448.0,972.0
0.004,6,10,1989,5,927,1.0,659.0,659.0,5,1062,1.0,794.0,794.0
0.006,6,10,2007,5,928,1.0,660.0,660.0,5,1079,1.0,811.0,811.0
0.039,17,4,284,2,120,0.0,32.0,32.0,2,164,36.0,60.0,54.0
0.013,6,10,1972,5,910,3.0,642.0,642.0,5,1062,3.0,794.0,794.0
0.079,6,10,1506,5,395,16.0,127.0,127.0,5,1111,17.0,843.0,843.0
20.243,6,52,22792,25,16685,390.0,2720.0,1423.0,27,6107,771.0,2667.0,385.0
0.014,6,10,1989,5,910,3.0,642.0,642.0,5,1079,3.0,811.0,811.0
0.011,6,10,1972,5,910,2.0,642.0,642.0,5,1062,2.0,794.0,794.0
0.042,17,4,420,2,122,0.0,33.0,33.0,2,298,39.0,145.0,121.0
40.05,17,10,676,5,460,10011.0,104.0,64.0,5,216,10011.0,20.0,15.0
0.005,6,10,1689,5,839,1.0,571.0,571.0,5,850,1.0,582.0,582.0
0.096,6,10,1506,5,395,20.0,127.0,127.0,5,1111,22.0,843.0,843.0
0.01,6,10,1989,5,910,2.0,642.0,642.0,5,1079,2.0,811.0,811.0
0.014,6,10,1972,5,910,3.0,642.0,642.0,5,1062,3.0,794.0,794.0
0.011,6,10,1990,5,911,2.0,643.0,643.0,5,1079,2.0,811.0,811.0
0.006,6,13,3747,7,509,0.0,137.0,137.0,6,3238,1.0,1470.0,1459.0
0.006,6,10,1547,5,764,1.0,496.0,496.0,5,783,1.0,515.0,515.0
0.008,6,10,1989,5,910,1.0,642.0,642.0,5,1079,2.0,811.0,811.0
0.011,6,10,1990,5,911,2.0,643.0,643.0,5,1079,2.0,811.0,811.0
0.006,6,10,1547,5,764,1.0,496.0,496.0,5,783,1.0,515.0,515.0
0.109,6,10,1506,5,395,26.0,127.0,127.0,5,1111,24.0,843.0,843.0
0.131,6,10,1506,5,395,29.0,127.0,127.0,5,1111,30.0,843.0,843.0
0.005,6,10,1779,5,928,1.0,660.0,660.0,5,851,1.0,583.0,583.0
11.022,17,28,4423,14,1994,839.0,269.0,114.0,14,2429,839.0,588.0,145.0
1778.761,17,144,45504,72,22752,25052.0,288.0,288.0,72,22752,25052.0,288.0,288.0
0.006,6,10,2000,5,927,1.0,659.0,659.0,5,1073,1.0,805.0,805.0
0.004,17,2,136,1,60,0.0,32.0,32.0,1,76,0.0,48.0,48.0
0.006,6,10,1689,5,839,1.0,571.0,571.0,5,850,1.0,582.0,582.0
0.015,6,13,3913,7,495,2.0,123.0,123.0,6,3418,2.0,1650.0,1549.0
0.13,6,10,1506,5,395,28.0,127.0,127.0,5,1111,28.0,843.0,843.0
11.125,17,28,4422,14,1995,843.0,270.0,114.0,14,2427,843.0,586.0,145.0
0.006,6,10,1547,5,764,1.0,496.0,496.0,5,783,1.0,515.0,515.0
0.08,6,10,1506,5,395,18.0,127.0,127.0,5,1111,18.0,843.0,843.0
300.142,6,36,20162,17,14703,18758.0,2736.0,1534.0,19,5459,16674.0,1656.0,1118.0
0.003,17,2,148,1,60,0.0,32.0,32.0,1,88,0.0,60.0,60.0
240.098,6,16,4482,9,963,30012.0,238.0,166.0,7,3519,40015.0,1402.0,786.0
0.004,6,10,2007,5,928,1.0,660.0,660.0,5,1079,1.0,811.0,811.0
0.003,17,2,136,1,60,0.0,32.0,32.0,1,76,0.0,48.0,48.0
9.036,17,6,376,5,280,2259.0,28.0,28.0,1,96,0.0,68.0,68.0
0.01,6,10,1990,5,911,2.0,643.0,643.0,5,1079,2.0,811.0,811.0
0.006,17,2,230,1,68,0.0,40.0,40.0,1,162,0.0,134.0,134.0
0.004,6,10,1989,5,927,1.0,659.0,659.0,5,1062,1.0,794.0,794.0
0.004,6,10,1774,5,923,1.0,655.0,655.0,5,851,1.0,583.0,583.0
0.005,17,2,178,1,65,0.0,37.0,37.0,1,113,0.0,85.0,85.0
0.015,6,10,1990,5,911,3.0,643.0,643.0,5,1079,3.0,811.0,811.0
0.066,6,10,1506,5,395,13.0,127.0,127.0,5,1111,14.0,843.0,843.0
0.012,6,10,1990,5,911,3.0,643.0,643.0,5,1079,3.0,811.0,811.0
0.059,17,2,152,1,76,0.0,48.0,48.0,1,76,0.0,48.0,48.0
0.09,6,10,1506,5,395,21.0,127.0,127.0,5,1111,18.0,843.0,843.0
0.008,17,2,194,1,59,0.0,31.0,31.0,1,135,0.0,107.0,107.0
10.824,17,28,4417,14,1993,824.0,268.0,114.0,14,2424,824.0,587.0,145.0
0.001,17,2,180,1,66,0.0,38.0,38.0,1,114,0.0,86.0,86.0
1756.771,6,103,6166,59,3473,30288.0,27.0,27.0,44,2693,40854.0,27.0,27.0
0.005,17,2,164,1,74,0.0,46.0,46.0,1,90,0.0,62.0,62.0
240.091,6,16,4481,9,963,30011.0,238.0,166.0,7,3518,40014.0,1402.0,786.0
1730.416,6,45,2790,30,1725,59669.0,35.0,35.0,15,1065,123595.0,31.0,31.0
0.084,6,10,1506,5,395,19.0,127.0,127.0,5,1111,17.0,843.0,843.0
0.001,17,2,136,1,60,0.0,32.0,32.0,1,76,0.0,48.0,48.0
361.783,6,21,1793,16,1030,24118.0,190.0,190.0,5,763,60010.0,462.0,247.0
0.008,6,10,1989,5,910,2.0,642.0,642.0,5,1079,1.0,811.0,811.0
0.011,6,10,1677,5,827,2.0,559.0,559.0,5,850,2.0,582.0,582.0
0.012,6,13,3735,7,497,2.0,125.0,125.0,6,3238,2.0,1470.0,1459.0
0.001,17,2,142,1,63,0.0,35.0,35.0,1,79,0.0,51.0,51.0
0.005,6,10,2007,5,928,1.0,660.0,660.0,5,1079,1.0,811.0,811.0
0.005,6,10,1989,5,927,1.0,659.0,659.0,5,1062,1.0,794.0,794.0
0.004,17,2,136,1,60,0.0,32.0,32.0,1,76,0.0,48.0,48.0
66.059,6,24,11975,13,5359,5504.0,2804.0,935.0,11,6616,6589.0,2111.0,1006.0
40.092,17,10,676,5,460,10022.0,104.0,64.0,5,216,10022.0,20.0,15.0
0.017,17,2,148,1,60,0.0,32.0,32.0,1,88,0.0,60.0,60.0
0.071,6,10,1506,5,395,14.0,127.0,127.0,5,1111,16.0,843.0,843.0
0.005,6,10,1547,5,764,1.0,496.0,496.0,5,783,1.0,515.0,515.0
0.011,6,10,1989,5,910,2.0,642.0,642.0,5,1079,2.0,811.0,811.0
0.004,6,10,1774,5,923,1.0,655.0,655.0,5,851,1.0,583.0,583.0
0.004,6,10,1989,5,927,1.0,659.0,659.0,5,1062,1.0,794.0,794.0
0.01,6,10,1989,5,910,2.0,642.0,642.0,5,1079,2.0,811.0,811.0
0.007,17,2,179,1,71,0.0,43.0,43.0,1,108,0.0,80.0,80.0
300.983,6,44,13830,24,8003,13086.0,1797.0,876.0,20,5827,462.0,2667.0,385.0
0.014,6,10,1972,5,910,3.0,642.0,642.0,5,1062,3.0,794.0,794.0
0.011,6,10,1631,5,848,2.0,580.0,580.0,5,783,2.0,515.0,515.0
40.066,17,10,676,5,460,10014.0,104.0,64.0,5,216,10015.0,20.0,15.0
0.006,6,10,2006,5,927,1.0,659.0,659.0,5,1079,1.0,811.0,811.0
0.013,6,10,1972,5,910,3.0,642.0,642.0,5,1062,3.0,794.0,794.0
0.003,6,10,1702,5,863,0.0,595.0,595.0,5,839,0.0,571.0,571.0
1729.208,6,60,4400,40,2740,44338.0,33.0,33.0,20,1660,91001.0,31.0,31.0
0.005,17,2,230,1,68,0.0,40.0,40.0,1,162,0.0,134.0,134.0
0.006,17,2,146,1,65,0.0,37.0,37.0,1,81,0.0,53.0,53.0
0.008,6,10,1989,5,910,2.0,642.0,642.0,5,1079,2.0,811.0,811.0
0.184,17,4,596,2,122,147.0,33.0,33.0,2,474,142.0,323.0,209.0
0.004,6,10,1702,5,863,1.0,595.0,595.0,5,839,0.0,571.0,571.0
0.009,6,10,1989,5,910,2.0,642.0,642.0,5,1079,2.0,811.0,811.0
0.01,6,10,1677,5,827,2.0,559.0,559.0,5,850,2.0,582.0,582.0
0.005,6,10,2007,5,928,1.0,660.0,660.0,5,1079,1.0,811.0,811.0
0.167,17,2,152,1,76,0.0,48.0,48.0,1,76,0.0,48.0,48.0
0.108,6,10,1506,5,395,23.0,127.0,127.0,5,1111,22.0,843.0,843.0
0.107,6,10,1506,5,395,25.0,127.0,127.0,5,1111,25.0,843.0,843.0
10.765,17,28,4421,14,1994,819.0,269.0,114.0,14,2427,819.0,586.0,145.0
0.076,17,2,225,1,65,0.0,37.0,37.0,1,160,0.0,132.0,132.0
0.014,6,10,1989,5,910,3.0,642.0,642.0,5,1079,3.0,811.0,811.0
0.008,6,12,1926,6,1189,1.0,659.0,434.0,6,737,1.0,417.0,417.0
0.011,6,13,3735,7,497,1.0,125.0,125.0,6,3238,2.0,1470.0,1459.0
0.005,6,10,2000,5,927,1.0,659.0,659.0,5,1073,1.0,805.0,805.0
0.005,17,2,152,1,76,0.0,48.0,48.0,1,76,0.0,48.0,48.0
0.006,6,10,1689,5,839,1.0,571.0,571.0,5,850,1.0,582.0,582.0
0.004,6,10,2006,5,927,1.0,659.0,659.0,5,1079,1.0,811.0,811.0
0.005,6,10,1689,5,839,1.0,571.0,571.0,5,850,1.0,582.0,582.0
40.069,17,10,676,5,460,10014.0,104.0,64.0,5,216,10016.0,20.0,15.0
0.212,6,10,1506,5,395,50.0,127.0,127.0,5,1111,31.0,843.0,843.0
8.996,6,39,10487,20,4929,473.0,1360.0,682.0,19,5558,488.0,2667.0,435.0
0.086,6,10,1506,5,395,19.0,127.0,127.0,5,1111,19.0,843.0,843.0
0.009,6,10,1989,5,910,2.0,642.0,642.0,5,1079,2.0,811.0,811.0
0.005,17,2,225,1,65,0.0,37.0,37.0,1,160,0.0,132.0,132.0
0.094,6,10,1506,5,395,20.0,127.0,127.0,5,1111,21.0,843.0,843.0
0.006,6,10,1689,5,839,1.0,571.0,571.0,5,850,1.0,582.0,582.0
0.073,17,4,352,2,130,1.0,37.0,37.0,2,222,35.0,89.0,83.0
0.009,6,10,1990,5,911,2.0,643.0,643.0,5,1079,2.0,811.0,811.0
0.285,17,44,27975,26,24775,11.0,1350.0,924.0,18,3200,12.0,1350.0,149.0
0.069,6,10,1506,5,395,16.0,127.0,127.0,5,1111,14.0,843.0,843.0
0.011,6,10,1990,5,911,2.0,643.0,643.0,5,1079,2.0,811.0,811.0
352.966,6,20,2210,6,1308,12003.0,494.0,494.0,14,902,27151.0,83.0,83.0
0.005,17,2,136,1,60,0.0,32.0,32.0,1,76,0.0,48.0,48.0
0.006,17,2,179,1,71,0.0,43.0,43.0,1,108,0.0,80.0,80.0
0.005,6,10,2007,5,928,1.0,660.0,660.0,5,1079,1.0,811.0,811.0
55.06,6,46,18924,23,13206,408.0,2720.0,1361.0,23,5718,2495.0,2667.0,435.0
240.44,6,41,8667,21,5686,12021.0,1515.0,509.0,20,2981,12654.0,580.0,241.0
0.038,17,2,412,1,61,0.0,33.0,33.0,1,351,0.0,323.0,323.0
0.005,6,13,3684,7,446,0.0,74.0,74.0,6,3238,1.0,1470.0,1459.0
371.711,6,22,2313,16,867,24780.0,195.0,195.0,6,1446,4639.0,419.0,398.0
0.006,17,2,230,1,68,0.0,40.0,40.0,1,162,0.0,134.0,134.0
0.013,6,10,1989,5,910,3.0,642.0,642.0,5,1079,3.0,811.0,811.0
0.071,6,10,1506,5,395,16.0,127.0,127.0,5,1111,17.0,843.0,843.0
0.014,6,14,3787,7,497,2.0,125.0,125.0,7,3290,2.0,1448.0,972.0
0.127,6,10,1506,5,395,29.0,127.0,127.0,5,1111,27.0,843.0,843.0
0.059,6,10,1506,5,395,14.0,127.0,127.0,5,1111,14.0,843.0,843.0
0.005,6,13,3747,7,509,0.0,137.0,137.0,6,3238,1.0,1470.0,1459.0
0.003,17,2,136,1,60,0.0,32.0,32.0,1,76,0.0,48.0,48.0
0.005,6,10,2000,5,927,1.0,659.0,659.0,5,1073,1.0,805.0,805.0
0.13,17,2,186,1,61,0.0,33.0,33.0,1,125,0.0,97.0,97.0
0.083,6,10,1506,5,395,20.0,127.0,127.0,5,1111,17.0,843.0,843.0
242.284,6,395,347455,192,21508,1268.0,2736.0,885.0,203,325947,1199.0,2804.0,1634.0
0.003,17,2,136,1,60,0.0,32.0,32.0,1,76,0.0,48.0,48.0
0.005,6,10,1989,5,927,1.0,659.0,659.0,5,1062,1.0,794.0,794.0
0.005,6,10,1989,5,927,1.0,659.0,659.0,5,1062,1.0,794.0,794.0
368.522,6,22,2313,16,867,24568.0,195.0,195.0,6,1446,4636.0,419.0,398.0
0.009,6,10,1989,5,910,2.0,642.0,642.0,5,1079,2.0,811.0,811.0
300.986,6,42,11325,22,5498,14332.0,1511.0,764.0,20,5827,462.0,2667.0,385.0
0.006,6,10,1689,5,839,1.0,571.0,571.0,5,850,1.0,582.0,582.0
0.001,17,2,136,1,60,0.0,32.0,32.0,1,76,0.0,48.0,48.0
35.264,6,63,38156,33,31929,295.0,2720.0,1698.0,30,6227,1210.0,2667.0,385.0
0.355,17,49,25114,26,21272,14.0,1350.0,790.0,23,3842,13.0,1350.0,139.0
354.071,6,21,1795,16,1030,23604.0,190.0,190.0,5,765,60002.0,464.0,248.0
0.006,6,10,1547,5,764,1.0,496.0,496.0,5,783,1.0,515.0,515.0
0.052,17,2,152,1,76,0.0,48.0,48.0,1,76,0.0,48.0,48.0
0.008,6,10,1989,5,910,2.0,642.0,642.0,5,1079,2.0,811.0,811.0
240.095,6,16,4481,9,963,30011.0,238.0,166.0,7,3518,40015.0,1402.0,786.0
10.831,17,28,4424,14,1995,824.0,270.0,114.0,14,2429,824.0,588.0,145.0
243.043,6,399,348977,192,21499,1272.0,2736.0,958.0,207,327478,1179.0,2804.0,1607.0
0.766,6,10,2009,6,1655,153.0,1403.0,1403.0,4,354,176.0,182.0,182.0
0.094,6,10,1506,5,395,20.0,127.0,127.0,5,1111,20.0,843.0,843.0
0.004,6,10,1989,5,927,1.0,659.0,659.0,5,1062,1.0,794.0,794.0
0.012,6,10,1972,5,910,2.0,642.0,642.0,5,1062,3.0,794.0,794.0
0.009,6,10,1989,5,910,2.0,642.0,642.0,5,1079,2.0,811.0,811.0
0.095,6,10,1506,5,395,23.0,127.0,127.0,5,1111,21.0,843.0,843.0
0.005,6,10,1989,5,927,1.0,659.0,659.0,5,1062,1.0,794.0,794.0
177.303,17,78,11147,39,2610,4665.0,44.0,38.0,39,8537,4665.0,239.0,190.0
0.005,6,10,2007,5,928,1.0,660.0,660.0,5,1079,1.0,811.0,811.0
0.003,17,2,136,1,60,0.0,32.0,32.0,1,76,0.0,48.0,48.0
0.081,6,10,1506,5,395,17.0,127.0,127.0,5,1111,17.0,843.0,843.0
0.005,6,10,1989,5,927,1.0,659.0,659.0,5,1062,1.0,794.0,794.0
0.079,6,10,1506,5,395,17.0,127.0,127.0,5,1111,16.0,843.0,843.0
15.109,17,20,12158,10,8336,1675.0,1350.0,805.0,10,3822,1671.0,1350.0,354.0
0.009,6,12,1926,6,1189,1.0,659.0,434.0,6,737,1.0,417.0,417.0
0.006,6,10,2000,5,927,1.0,659.0,659.0,5,1073,1.0,805.0,805.0
0.005,6,10,1854,5,889,1.0,621.0,621.0,5,965,1.0,697.0,697.0
241.571,6,401,349098,195,21664,1245.0,2736.0,959.0,206,327434,1178.0,2804.0,1615.0
40.058,17,10,676,5,460,10013.0,104.0,64.0,5,216,10013.0,20.0,15.0
40.091,17,10,676,5,460,10021.0,104.0,64.0,5,216,10021.0,20.0,15.0
0.078,17,2,170,1,65,0.0,37.0,37.0,1,105,0.0,77.0,77.0
0.011,6,10,1762,5,911,2.0,643.0,643.0,5,851,2.0,583.0,583.0
0.009,6,10,1989,5,910,2.0,642.0,642.0,5,1079,2.0,811.0,811.0
0.116,6,10,1506,5,395,20.0,127.0,127.0,5,1111,23.0,843.0,843.0
0.005,6,10,1854,5,889,1.0,621.0,621.0,5,965,1.0,697.0,697.0
0.005,6,10,2006,5,927,1.0,659.0,659.0,5,1079,1.0,811.0,811.0
1798.336,6,273,25438,138,8956,13126.0,747.0,295.0,135,16482,13420.0,1625.0,72.0
0.005,6,10,2000,5,927,1.0,659.0,659.0,5,1073,1.0,805.0,805.0
310.291,17,20,1124,10,716,34463.0,48.0,43.0,10,408,34463.0,20.0,12.0
40.06,17,10,676,5,460,10014.0,104.0,64.0,5,216,10014.0,20.0,15.0
15.071,17,15,9238,8,6902,2149.0,1350.0,834.0,7,2336,2507.0,1350.0,305.0
0.013,6,10,1989,5,910,3.0,642.0,642.0,5,1079,3.0,811.0,811.0
0.004,17,2,136,1,60,0.0,32.0,32.0,1,76,0.0,48.0,48.0
0.126,17,2,136,1,60,0.0,32.0,32.0,1,76,0.0,48.0,48.0
0.004,17,2,136,1,60,0.0,32.0,32.0,1,76,0.0,48.0,48.0
10.825,17,28,4424,14,1995,824.0,270.0,114.0,14,2429,824.0,588.0,145.0
15.126,17,19,13437,9,8280,1886.0,1350.0,892.0,10,5157,1677.0,1350.0,487.0
0.004,6,10,2006,5,927,1.0,659.0,659.0,5,1079,1.0,811.0,811.0
240.105,6,34,9587,17,7102,15006.0,1368.0,564.0,17,2485,15006.0,580.0,199.0
0.001,17,2,136,1,60,0.0,32.0,32.0,1,76,0.0,48.0,48.0
0.067,17,8,3613,4,1874,22.0,1350.0,440.0,4,1739,11.0,1350.0,406.0
0.004,6,10,1774,5,923,1.0,655.0,655.0,5,851,1.0,583.0,583.0
0.011,6,10,1972,5,910,2.0,642.0,642.0,5,1062,2.0,794.0,794.0
0.008,6,10,1990,5,911,2.0,643.0,643.0,5,1079,2.0,811.0,811.0
0.007,6,10,1983,5,910,1.0,642.0,642.0,5,1073,1.0,805.0,805.0
0.004,6,10,1702,5,863,1.0,595.0,595.0,5,839,0.0,571.0,571.0
15.079,17,18,8767,9,6113,1881.0,1350.0,651.0,9,2654,1881.0,1350.0,266.0
0.004,6,10,1702,5,863,1.0,595.0,595.0,5,839,0.0,571.0,571.0
0.072,17,2,156,1,64,0.0,36.0,36.0,1,92,0.0,64.0,64.0
0.012,6,10,1677,5,827,2.0,559.0,559.0,5,850,2.0,582.0,582.0
0.015,6,10,1989,5,910,3.0,642.0,642.0,5,1079,3.0,811.0,811.0
0.005,6,13,3684,7,446,0.0,74.0,74.0,6,3238,1.0,1470.0,1459.0
0.044,17,2,182,1,65,0.0,37.0,37.0,1,117,0.0,89.0,89.0
0.145,6,10,1506,5,395,31.0,127.0,127.0,5,1111,32.0,843.0,843.0
15.322,17,39,20531,22,17087,728.0,1350.0,748.0,17,3444,955.0,1350.0,174.0
0.006,6,10,1689,5,839,1.0,571.0,571.0,5,850,1.0,582.0,582.0
0.024,17,2,170,1,65,0.0,37.0,37.0,1,105,0.0,77.0,77.0
0.003,17,2,148,1,60,0.0,32.0,32.0,1,88,0.0,60.0,60.0
0.018,6,10,1989,5,910,4.0,642.0,642.0,5,1079,4.0,811.0,811.0
0.004,6,10,2007,5,928,1.0,660.0,660.0,5,1079,1.0,811.0,811.0
0.015,6,10,1989,5,910,3.0,642.0,642.0,5,1079,3.0,811.0,811.0
0.005,6,10,1989,5,927,1.0,659.0,659.0,5,1062,1.0,794.0,794.0
40.076,17,10,676,5,460,10016.0,104.0,64.0,5,216,10018.0,20.0,15.0
1730.475,6,48,2957,31,1800,57682.0,35.0,35.0,17,1157,108149.0,31.0,31.0
318.432,17,20,1124,10,716,35374.0,48.0,43.0,10,408,35374.0,20.0,12.0
0.009,6,10,1972,5,910,2.0,642.0,642.0,5,1062,2.0,794.0,794.0
0.012,6,10,1989,5,910,3.0,642.0,642.0,5,1079,3.0,811.0,811.0
0.005,6,10,2000,5,927,1.0,659.0,659.0,5,1073,1.0,805.0,805.0
9.037,17,6,376,5,280,2259.0,28.0,28.0,1,96,0.0,68.0,68.0
0.077,6,10,1506,5,395,18.0,127.0,127.0,5,1111,16.0,843.0,843.0
15.08,17,14,9190,8,6902,2149.0,1350.0,834.0,6,2288,3010.0,1350.0,353.0
50.401,6,392,347324,195,21718,259.0,2736.0,889.0,197,325606,257.0,2804.0,1713.0
0.019,6,10,1990,5,911,4.0,643.0,643.0,5,1079,4.0,811.0,811.0
0.013,6,10,1631,5,848,3.0,580.0,580.0,5,783,3.0,515.0,515.0
0.004,17,2,148,1,60,0.0,32.0,32.0,1,88,0.0,60.0,60.0
0.096,6,10,1506,5,395,23.0,127.0,127.0,5,1111,22.0,843.0,843.0
0.041,17,2,152,1,76,0.0,48.0,48.0,1,76,0.0,48.0,48.0
300.124,6,26,7915,14,3040,23086.0,1368.0,458.0,12,4875,27283.0,1656.0,851.0
0.119,6,10,1506,5,395,23.0,127.0,127.0,5,1111,24.0,843.0,843.0
0.098,6,10,1506,5,395,24.0,127.0,127.0,5,1111,17.0,843.0,843.0
0.229,6,16,2669,8,1395,32.0,533.0,323.0,8,1274,20.0,529.0,212.0
0.008,6,10,1983,5,910,2.0,642.0,642.0,5,1073,1.0,805.0,805.0
0.004,6,10,2000,5,927,1.0,659.0,659.0,5,1073,1.0,805.0,805.0
0.128,6,10,1506,5,395,30.0,127.0,127.0,5,1111,26.0,843.0,843.0
0.005,6,10,1689,5,839,1.0,571.0,571.0,5,850,1.0,582.0,582.0
0.005,17,2,140,1,62,0.0,34.0,34.0,1,78,0.0,50.0,50.0
40.071,17,10,676,5,460,10015.0,104.0,64.0,5,216,10016.0,20.0,15.0
10.91,17,28,4422,14,1994,830.0,269.0,114.0,14,2428,830.0,587.0,145.0
0.009,6,10,1972,5,910,2.0,642.0,642.0,5,1062,2.0,794.0,794.0
1786.153,6,150,19350,90,13740,20069.0,302.0,302.0,60,5610,30273.0,83.0,83.0
0.001,17,2,180,1,66,0.0,38.0,38.0,1,114,0.0,86.0,86.0
0.014,6,10,1631,5,848,3.0,580.0,580.0,5,783,3.0,515.0,515.0
599.797,17,156,22952,78,5223,7789.0,44.0,38.0,78,17729,7789.0,239.0,199.0
0.001,17,2,180,1,66,0.0,38.0,38.0,1,114,0.0,86.0,86.0
0.073,6,10,1506,5,395,17.0,127.0,127.0,5,1111,13.0,843.0,843.0
0.005,17,2,136,1,60,0.0,32.0,32.0,1,76,0.0,48.0,48.0
0.003,17,2,148,1,60,0.0,32.0,32.0,1,88,0.0,60.0,60.0
0.063,6,10,1506,5,395,13.0,127.0,127.0,5,1111,14.0,843.0,843.0
0.006,6,10,1547,5,764,1.0,496.0,496.0,5,783,1.0,515.0,515.0
0.008,6,10,1983,5,910,2.0,642.0,642.0,5,1073,1.0,805.0,805.0
11.093,17,28,4421,14,1994,841.0,269.0,114.0,14,2427,841.0,586.0,145.0
0.005,6,10,2006,5,927,1.0,659.0,659.0,5,1079,1.0,811.0,811.0
0.004,17,2,234,1,61,0.0,33.0,33.0,1,173,0.0,145.0,145.0
0.005,17,2,170,1,65,0.0,37.0,37.0,1,105,0.0,77.0,77.0
175.296,17,76,10984,38,2533,4737.0,44.0,38.0,38,8451,4737.0,239.0,194.0
0.006,6,10,1854,5,889,1.0,621.0,621.0,5,965,1.0,697.0,697.0
0.009,6,10,1631,5,848,2.0,580.0,580.0,5,783,2.0,515.0,515.0
1770.243,6,82,4315,41,2159,44255.0,27.0,27.0,41,2156,44255.0,24.0,24.0
0.133,17,2,80,1,32,0.0,4.0,4.0,1,48,0.0,20.0,20.0
0.114,6,10,1506,5,395,26.0,127.0,127.0,5,1111,25.0,843.0,843.0
0.003,17,2,136,1,60,0.0,32.0,32.0,1,76,0.0,48.0,48.0
0.157,6,10,1506,5,395,36.0,127.0,127.0,5,1111,35.0,843.0,843.0
0.004,6,10,2006,5,927,1.0,659.0,659.0,5,1079,1.0,811.0,811.0
40.059,17,10,676,5,460,10013.0,104.0,64.0,5,216,10013.0,20.0,15.0
0.005,6,10,1547,5,764,1.0,496.0,496.0,5,783,1.0,515.0,515.0
351.987,6,20,2210,6,1308,12003.0,494.0,494.0,14,902,27075.0,83.0,83.0
0.01,6,10,1990,5,911,2.0,643.0,643.0,5,1079,2.0,811.0,811.0
0.089,6,10,1506,5,395,19.0,127.0,127.0,5,1111,19.0,843.0,843.0
11.213,17,28,4418,14,1994,849.0,269.0,114.0,14,2424,849.0,587.0,145.0
0.131,6,10,1506,5,395,29.0,127.0,127.0,5,1111,29.0,843.0,843.0
0.066,17,8,3613,4,1874,22.0,1350.0,440.0,4,1739,11.0,1350.0,406.0
0.011,6,10,1990,5,911,2.0,643.0,643.0,5,1079,2.0,811.0,811.0
0.079,6,10,1506,5,395,17.0,127.0,127.0,5,1111,16.0,843.0,843.0
0.055,6,10,1989,5,910,13.0,642.0,642.0,5,1079,13.0,811.0,811.0
0.006,17,2,170,1,65,0.0,37.0,37.0,1,105,0.0,77.0,77.0
0.039,17,2,170,1,65,0.0,37.0,37.0,1,105,0.0,77.0,77.0
0.013,6,10,1990,5,911,3.0,643.0,643.0,5,1079,3.0,811.0,811.0
0.005,6,10,2006,5,927,1.0,659.0,659.0,5,1079,1.0,811.0,811.0
0.022,6,10,1989,5,910,5.0,642.0,642.0,5,1079,5.0,811.0,811.0
0.208,6,16,2670,8,1396,29.0,533.0,324.0,8,1274,18.0,529.0,212.0
0.014,6,10,1972,5,910,3.0,642.0,642.0,5,1062,3.0,794.0,794.0
0.006,17,2,136,1,60,0.0,32.0,32.0,1,76,0.0,48.0,48.0
8.952,6,50,11069,27,5257,344.0,1360.0,682.0,23,5812,397.0,2667.0,375.0
0.004,6,10,1779,5,928,1.0,660.0,660.0,5,851,1.0,583.0,583.0
0.005,17,2,148,1,60,0.0,32.0,32.0,1,88,0.0,60.0,60.0
0.09,6,10,1506,5,395,21.0,127.0,127.0,5,1111,21.0,843.0,843.0
0.018,6,10,1677,5,827,4.0,559.0,559.0,5,850,4.0,582.0,582.0
0.108,6,10,1506,5,395,23.0,127.0,127.0,5,1111,25.0,843.0,843.0
0.131,6,10,1506,5,395,30.0,127.0,127.0,5,1111,31.0,843.0,843.0
0.084,6,10,1506,5,395,16.0,127.0,127.0,5,1111,19.0,843.0,843.0
0.007,17,2,179,1,71,0.0,43.0,43.0,1,108,0.0,80.0,80.0
10.883,17,28,4424,14,1995,828.0,270.0,114.0,14,2429,828.0,588.0,145.0
0.006,6,10,1547,5,764,1.0,496.0,496.0,5,783,1.0,515.0,515.0
0.001,17,2,180,1,66,0.0,38.0,38.0,1,114,0.0,86.0,86.0
0.085,6,10,1506,5,395,20.0,127.0,127.0,5,1111,15.0,843.0,843.0
10.884,17,28,4423,14,1994,828.0,269.0,114.0,14,2429,828.0,588.0,145.0
0.006,6,10,1547,5,764,1.0,496.0,496.0,5,783,1.0,515.0,515.0
0.007,6,10,1983,5,910,1.0,642.0,642.0,5,1073,1.0,805.0,805.0
0.016,6,10,1989,5,910,4.0,642.0,642.0,5,1079,3.0,811.0,811.0
0.012,17,4,284,2,120,0.0,32.0,32.0,2,164,1.0,60.0,54.0
0.014,6,10,1983,5,910,3.0,642.0,642.0,5,1073,3.0,805.0,805.0
0.006,6,10,1547,5,764,1.0,496.0,496.0,5,783,1.0,515.0,515.0
0.101,6,10,1506,5,395,23.0,127.0,127.0,5,1111,23.0,843.0,843.0
0.076,6,10,1506,5,395,17.0,127.0,127.0,5,1111,15.0,843.0,843.0
0.006,6,10,1643,5,860,1.0,592.0,592.0,5,783,1.0,515.0,515.0
0.271,17,42,22915,23,18461,12.0,1350.0,774.0,19,4454,11.0,1350.0,206.0
0.005,6,10,1854,5,889,1.0,621.0,621.0,5,965,1.0,697.0,697.0
0.004,6,10,2000,5,927,1.0,659.0,659.0,5,1073,1.0,805.0,805.0
0.108,6,10,1506,5,395,25.0,127.0,127.0,5,1111,16.0,843.0,843.0
0.005,6,10,1989,5,927,1.0,659.0,659.0,5,1062,1.0,794.0,794.0
0.005,17,2,214,1,75,0.0,47.0,47.0,1,139,0.0,111.0,111.0
0.011,6,10,1989,5,910,2.0,642.0,642.0,5,1079,2.0,811.0,811.0
0.005,6,10,2000,5,927,1.0,659.0,659.0,5,1073,1.0,805.0,805.0
0.005,6,10,2007,5,928,1.0,660.0,660.0,5,1079,1.0,811.0,811.0
15.072,17,15,9238,8,6902,2149.0,1350.0,834.0,7,2336,2507.0,1350.0,305.0
8.636,6,35,8267,18,1836,508.0,728.0,361.0,17,6431,529.0,2720.0,478.0
0.039,17,2,182,1,65,0.0,37.0,37.0,1,117,0.0,89.0,89.0
0.072,17,4,284,2,120,0.0,32.0,32.0,2,164,69.0,60.0,54.0
15.09,17,16,8623,8,6542,2151.0,1350.0,789.0,8,2081,2151.0,1350.0,232.0
0.008,6,10,1972,5,910,2.0,642.0,642.0,5,1062,1.0,794.0,794.0
0.01,6,10,1762,5,911,2.0,643.0,643.0,5,851,2.0,583.0,583.0
0.005,17,2,169,1,62,0.0,34.0,34.0,1,107,0.0,79.0,79.0
0.007,6,10,1983,5,910,1.0,642.0,642.0,5,1073,1.0,805.0,805.0
0.092,6,10,1506,5,395,19.0,127.0,127.0,5,1111,20.0,843.0,843.0
309.419,17,20,1124,10,716,34365.0,48.0,43.0,10,408,34366.0,20.0,12.0
0.008,6,12,1926,6,1189,1.0,659.0,434.0,6,737,1.0,417.0,417.0
308.845,17,20,1124,10,716,34301.0,48.0,43.0,10,408,34301.0,20.0,12.0
0.108,6,10,1506,5,395,24.0,127.0,127.0,5,1111,24.0,843.0,843.0
0.064,6,10,1506,5,395,13.0,127.0,127.0,5,1111,14.0,843.0,843.0
0.121,6,10,1506,5,395,27.0,127.0,127.0,5,1111,29.0,843.0,843.0
0.005,6,10,2006,5,927,1.0,659.0,659.0,5,1079,1.0,811.0,811.0
0.006,17,2,230,1,68,0.0,40.0,40.0,1,162,0.0,134.0,134.0
0.005,6,14,3799,7,509,0.0,137.0,137.0,7,3290,0.0,1448.0,972.0
0.005,17,2,169,1,62,0.0,34.0,34.0,1,107,0.0,79.0,79.0
240.35,6,34,9318,17,1886,15021.0,622.0,198.0,17,7432,15021.0,1402.0,595.0
0.014,17,2,152,1,56,0.0,28.0,28.0,1,96,0.0,68.0,68.0
240.013,6,17,1882,9,1132,30001.0,517.0,167.0,8,750,34287.0,156.0,81.0
0.005,6,10,1689,5,839,1.0,571.0,571.0,5,850,1.0,582.0,582.0
0.004,6,10,2007,5,928,1.0,660.0,660.0,5,1079,1.0,811.0,811.0
0.041,17,2,170,1,65,0.0,37.0,37.0,1,105,0.0,77.0,77.0
240.016,6,9,787,5,488,60004.0,232.0,232.0,4,299,80002.0,83.0,83.0
0.024,6,10,1990,5,911,6.0,643.0,643.0,5,1079,6.0,811.0,811.0
0.013,6,10,1990,5,911,3.0,643.0,643.0,5,1079,3.0,811.0,811.0
0.004,6,10,1989,5,927,1.0,659.0,659.0,5,1062,1.0,794.0,794.0
0.005,6,10,2000,5,927,1.0,659.0,659.0,5,1073,1.0,805.0,805.0
0.005,6,10,1643,5,860,1.0,592.0,592.0,5,783,1.0,515.0,515.0
0.086,6,10,1506,5,395,19.0,127.0,127.0,5,1111,18.0,843.0,843.0
40.078,17,10,676,5,460,10016.0,104.0,64.0,5,216,10018.0,20.0,15.0
40.041,17,10,676,5,460,10007.0,104.0,64.0,5,216,9998.0,20.0,15.0
0.052,17,2,152,1,76,0.0,48.0,48.0,1,76,0.0,48.0,48.0
0.005,17,2,179,1,71,0.0,43.0,43.0,1,108,0.0,80.0,80.0
0.012,6,13,3735,7,497,2.0,125.0,125.0,6,3238,2.0,1470.0,1459.0
0.001,17,2,180,1,66,0.0,38.0,38.0,1,114,0.0,86.0,86.0
0.011,6,10,1972,5,910,2.0,642.0,642.0,5,1062,2.0,794.0,794.0
0.006,6,10,1689,5,839,1.0,571.0,571.0,5,850,1.0,582.0,582.0
0.01,6,10,1972,5,910,2.0,642.0,642.0,5,1062,2.0,794.0,794.0
0.213,6,16,2670,8,1396,30.0,533.0,324.0,8,1274,19.0,529.0,212.0
0.004,17,2,148,1,60,0.0,32.0,32.0,1,88,0.0,60.0,60.0
0.013,6,10,1989,5,910,3.0,642.0,642.0,5,1079,3.0,811.0,811.0
0.005,17,2,164,1,74,0.0,46.0,46.0,1,90,0.0,62.0,62.0
0.023,6,10,1989,5,910,5.0,642.0,642.0,5,1079,5.0,811.0,811.0
0.094,6,10,1506,5,395,21.0,127.0,127.0,5,1111,21.0,843.0,843.0
40.072,17,10,676,5,460,10016.0,104.0,64.0,5,216,10015.0,20.0,15.0
40.068,17,10,676,5,460,10014.0,104.0,64.0,5,216,10016.0,20.0,15.0
0.011,6,13,3735,7,497,1.0,125.0,125.0,6,3238,2.0,1470.0,1459.0
40.055,17,10,676,5,460,10013.0,104.0,64.0,5,216,10012.0,20.0,15.0
0.004,17,2,148,1,60,0.0,32.0,32.0,1,88,0.0,60.0,60.0
296.018,17,118,16755,59,3937,5103.0,44.0,38.0,59,12818,5103.0,239.0,189.0
0.005,17,2,170,1,65,0.0,37.0,37.0,1,105,0.0,77.0,77.0
0.014,6,13,3735,7,497,2.0,125.0,125.0,6,3238,2.0,1470.0,1459.0
0.098,6,10,1506,5,395,21.0,127.0,127.0,5,1111,20.0,843.0,843.0
0.074,6,10,1506,5,395,16.0,127.0,127.0,5,1111,15.0,843.0,843.0
40.056,17,10,676,5,460,10013.0,104.0,64.0,5,216,10013.0,20.0,15.0
0.076,6,10,1506,5,395,15.0,127.0,127.0,5,1111,18.0,843.0,843.0
0.02,6,14,3965,7,495,3.0,123.0,123.0,7,3470,3.0,1448.0,1032.0
0.552,17,56,29704,30,25848,19.0,1350.0,833.0,26,3856,19.0,1350.0,120.0
0.09,6,10,1506,5,395,21.0,127.0,127.0,5,1111,21.0,843.0,843.0
0.006,6,10,1643,5,860,1.0,592.0,592.0,5,783,1.0,515.0,515.0
0.077,6,10,1506,5,395,17.0,127.0,127.0,5,1111,15.0,843.0,843.0
0.005,17,2,166,1,75,0.0,47.0,47.0,1,91,0.0,63.0,63.0
0.006,6,10,1854,5,889,1.0,621.0,621.0,5,965,1.0,697.0,697.0
240.104,6,16,4480,9,963,30013.0,238.0,166.0,7,3517,40016.0,1402.0,786.0
0.016,6,10,1631,5,848,4.0,580.0,580.0,5,783,3.0,515.0,515.0
0.012,6,10,1990,5,911,3.0,643.0,643.0,5,1079,3.0,811.0,811.0
0.01,6,10,1677,5,827,2.0,559.0,559.0,5,850,2.0,582.0,582.0
0.009,6,10,1990,5,911,2.0,643.0,643.0,5,1079,2.0,811.0,811.0
0.022,6,10,1972,5,910,5.0,642.0,642.0,5,1062,5.0,794.0,794.0
0.008,6,10,1972,5,910,2.0,642.0,642.0,5,1062,1.0,794.0,794.0
0.168,6,3,453,2,321,168.0,241.0,241.0,1,132,0.0,92.0,92.0
0.016,6,10,1983,5,910,3.0,642.0,642.0,5,1073,4.0,805.0,805.0
0.005,6,10,2007,5,928,1.0,660.0,660.0,5,1079,1.0,811.0,811.0
0.015,6,10,1677,5,827,3.0,559.0,559.0,5,850,3.0,582.0,582.0
0.204,6,10,1506,5,395,49.0,127.0,127.0,5,1111,46.0,843.0,843.0
0.005,6,10,1989,5,927,1.0,659.0,659.0,5,1062,1.0,794.0,794.0
0.085,6,10,1506,5,395,20.0,127.0,127.0,5,1111,17.0,843.0,843.0
0.009,6,10,1972,5,910,2.0,642.0,642.0,5,1062,2.0,794.0,794.0
0.104,6,10,1506,5,395,21.0,127.0,127.0,5,1111,22.0,843.0,843.0
0.015,6,10,1989,5,910,3.0,642.0,642.0,5,1079,3.0,811.0,811.0
0.004,17,2,144,1,64,0.0,36.0,36.0,1,80,0.0,52.0,52.0
40.059,17,10,676,5,460,10013.0,104.0,64.0,5,216,10013.0,20.0,15.0
0.006,6,10,1989,5,927,1.0,659.0,659.0,5,1062,1.0,794.0,794.0
0.005,6,10,1774,5,923,1.0,655.0,655.0,5,851,1.0,583.0,583.0
0.011,6,10,1972,5,910,2.0,642.0,642.0,5,1062,2.0,794.0,794.0
0.004,6,10,2006,5,927,1.0,659.0,659.0,5,1079,1.0,811.0,811.0
0.005,6,10,1689,5,839,1.0,571.0,571.0,5,850,1.0,582.0,582.0
316.813,17,20,1124,10,716,35190.0,48.0,43.0,10,408,35190.0,20.0,12.0
0.003,17,2,148,1,60,0.0,32.0,32.0,1,88,0.0,60.0,60.0
0.005,6,10,1547,5,764,1.0,496.0,496.0,5,783,1.0,515.0,515.0
0.004,6,10,2000,5,927,1.0,659.0,659.0,5,1073,1.0,805.0,805.0
0.017,6,10,1989,5,910,4.0,642.0,642.0,5,1079,4.0,811.0,811.0
0.107,6,10,1506,5,395,24.0,127.0,127.0,5,1111,22.0,843.0,843.0
0.013,6,10,1972,5,910,3.0,642.0,642.0,5,1062,3.0,794.0,794.0
0.158,6,10,1506,5,395,36.0,127.0,127.0,5,1111,33.0,843.0,843.0
0.004,6,10,1702,5,863,1.0,595.0,595.0,5,839,0.0,571.0,571.0
0.013,6,10,1989,5,910,3.0,642.0,642.0,5,1079,3.0,811.0,811.0
0.004,17,2,136,1,60,0.0,32.0,32.0,1,76,0.0,48.0,48.0
0.092,6,10,1506,5,395,20.0,127.0,127.0,5,1111,21.0,843.0,843.0
0.011,6,10,1983,5,910,2.0,642.0,642.0,5,1073,2.0,805.0,805.0
360.048,6,21,3981,13,3142,30004.0,494.0,494.0,8,839,51435.0,83.0,83.0
0.004,17,2,136,1,60,0.0,32.0,32.0,1,76,0.0,48.0,48.0
300.158,6,42,12573,22,6975,14285.0,2720.0,866.0,20,5598,15788.0,1360.0,398.0
40.07,17,10,676,5,460,10015.0,104.0,64.0,5,216,10016.0,20.0,15.0
0.138,6,10,1506,5,395,33.0,127.0,127.0,5,1111,33.0,843.0,843.0
308.416,17,20,1124,10,716,34253.0,48.0,43.0,10,408,34253.0,20.0,12.0
38.694,6,44,13284,22,7332,433.0,3483.0,1281.0,22,5952,1834.0,2667.0,361.0
0.107,6,10,1506,5,395,22.0,127.0,127.0,5,1111,24.0,843.0,843.0
0.005,6,10,2007,5,928,1.0,660.0,660.0,5,1079,1.0,811.0,811.0
0.009,6,10,1989,5,910,2.0,642.0,642.0,5,1079,2.0,811.0,811.0
169.402,58,3,216,2,144,169402.0,24.0,24.0,1,72,0.0,24.0,24.0
0.017,6,10,1631,5,848,4.0,580.0,580.0,5,783,4.0,515.0,515.0
240.099,6,16,4481,9,963,30012.0,238.0,166.0,7,3518,40015.0,1402.0,786.0
0.01,6,10,1990,5,911,2.0,643.0,643.0,5,1079,2.0,811.0,811.0
0.006,6,10,1989,5,927,1.0,659.0,659.0,5,1062,1.0,794.0,794.0
0.005,6,10,1689,5,839,1.0,571.0,571.0,5,850,1.0,582.0,582.0
0.014,6,10,1983,5,910,3.0,642.0,642.0,5,1073,3.0,805.0,805.0
0.012,6,10,1972,5,910,2.0,642.0,642.0,5,1062,2.0,794.0,794.0
0.014,6,10,1972,5,910,3.0,642.0,642.0,5,1062,3.0,794.0,794.0
178.144,17,84,12056,42,2805,4344.0,44.0,38.0,42,9251,4344.0,239.0,192.0
40.093,17,10,676,5,460,10020.0,104.0,64.0,5,216,10022.0,20.0,15.0
0.009,6,13,3747,7,509,1.0,137.0,137.0,6,3238,1.0,1470.0,1459.0
0.005,6,10,2006,5,927,1.0,659.0,659.0,5,1079,1.0,811.0,811.0
0.039,17,2,184,1,61,0.0,33.0,33.0,1,123,0.0,95.0,95.0
40.054,17,10,676,5,460,10012.0,104.0,64.0,5,216,10012.0,20.0,15.0
0.005,6,10,2007,5,928,1.0,660.0,660.0,5,1079,1.0,811.0,811.0
0.013,6,10,1990,5,911,3.0,643.0,643.0,5,1079,3.0,811.0,811.0
0.013,6,10,1631,5,848,3.0,580.0,580.0,5,783,3.0,515.0,515.0
0.081,6,10,1506,5,395,18.0,127.0,127.0,5,1111,17.0,843.0,843.0
0.016,6,10,1972,5,910,4.0,642.0,642.0,5,1062,3.0,794.0,794.0
0.005,6,10,2007,5,928,1.0,660.0,660.0,5,1079,1.0,811.0,811.0
0.007,6,10,1990,5,911,1.0,643.0,643.0,5,1079,1.0,811.0,811.0
0.097,6,10,1506,5,395,20.0,127.0,127.0,5,1111,22.0,843.0,843.0
0.001,17,2,180,1,66,0.0,38.0,38.0,1,114,0.0,86.0,86.0
0.006,6,10,1547,5,764,1.0,496.0,496.0,5,783,1.0,515.0,515.0
0.008,17,2,194,1,59,0.0,31.0,31.0,1,135,0.0,107.0,107.0
0.073,6,10,1506,5,395,17.0,127.0,127.0,5,1111,13.0,843.0,843.0
0.17,6,3,453,2,321,170.0,241.0,241.0,1,132,0.0,92.0,92.0
0.005,6,10,2006,5,927,1.0,659.0,659.0,5,1079,1.0,811.0,811.0
40.079,17,10,676,5,460,10017.0,104.0,64.0,5,216,10019.0,20.0,15.0
0.004,6,10,2006,5,927,1.0,659.0,659.0,5,1079,1.0,811.0,811.0
0.009,6,10,1983,5,910,2.0,642.0,642.0,5,1073,2.0,805.0,805.0
240.017,6,9,787,5,488,60004.0,232.0,232.0,4,299,80004.0,83.0,83.0
0.008,17,2,179,1,71,0.0,43.0,43.0,1,108,0.0,80.0,80.0
286.919,6,28,9509,15,2606,20492.0,676.0,363.0,13,6903,23907.0,1402.0,890.0
0.021,6,10,1989,5,910,5.0,642.0,642.0,5,1079,5.0,811.0,811.0
0.004,6,10,2007,5,928,1.0,660.0,660.0,5,1079,1.0,811.0,811.0
0.021,6,10,1972,5,910,5.0,642.0,642.0,5,1062,5.0,794.0,794.0
1791.521,6,483,98653,242,87423,7433.0,421.0,368.0,241,11230,7464.0,53.0,53.0
0.007,17,2,132,1,58,0.0,30.0,30.0,1,74,0.0,46.0,46.0
443.765,6,38,6608,18,4896,8914.0,494.0,494.0,20,1712,23355.0,83.0,83.0
11.065,17,28,4391,14,2312,843.0,587.0,137.0,14,2079,843.0,270.0,120.0
0.012,6,10,1983,5,910,3.0,642.0,642.0,5,1073,2.0,805.0,805.0
0.084,17,2,80,1,32,0.0,4.0,4.0,1,48,0.0,20.0,20.0
0.005,6,10,1689,5,839,1.0,571.0,571.0,5,850,1.0,582.0,582.0
0.007,6,13,3690,7,452,1.0,80.0,80.0,6,3238,1.0,1470.0,1459.0
0.065,6,10,1506,5,395,15.0,127.0,127.0,5,1111,13.0,843.0,843.0
247.028,6,28,9599,15,2564,17644.0,655.0,355.0,13,7035,20585.0,1402.0,909.0
308.446,17,20,1124,10,716,34257.0,48.0,43.0,10,408,34257.0,20.0,12.0
0.016,6,10,1990,5,911,4.0,643.0,643.0,5,1079,3.0,811.0,811.0
0.115,6,10,1506,5,395,26.0,127.0,127.0,5,1111,26.0,843.0,843.0
0.075,6,10,1506,5,395,17.0,127.0,127.0,5,1111,15.0,843.0,843.0
285.129,6,27,6405,15,1369,20366.0,517.0,290.0,12,5036,25920.0,2378.0,1104.0
311.7,17,20,1124,10,716,34618.0,48.0,43.0,10,408,34619.0,20.0,12.0
0.005,6,10,1989,5,927,1.0,659.0,659.0,5,1062,1.0,794.0,794.0
0.013,6,10,1989,5,910,3.0,642.0,642.0,5,1079,3.0,811.0,811.0
0.004,6,10,1774,5,923,1.0,655.0,655.0,5,851,1.0,583.0,583.0
0.005,6,13,3747,7,509,0.0,137.0,137.0,6,3238,1.0,1470.0,1459.0
0.006,6,10,1689,5,839,1.0,571.0,571.0,5,850,1.0,582.0,582.0
0.04,17,2,182,1,65,0.0,37.0,37.0,1,117,0.0,89.0,89.0
0.015,6,10,1989,5,910,3.0,642.0,642.0,5,1079,3.0,811.0,811.0
76.219,6,21,8144,11,1985,86.0,1174.0,504.0,10,6159,8450.0,2720.0,957.0
0.006,17,2,169,1,62,0.0,34.0,34.0,1,107,0.0,79.0,79.0
0.021,6,10,1989,5,910,5.0,642.0,642.0,5,1079,5.0,811.0,811.0
0.004,17,2,234,1,61,0.0,33.0,33.0,1,173,0.0,145.0,145.0
0.118,6,10,1506,5,395,27.0,127.0,127.0,5,1111,23.0,843.0,843.0
0.006,17,2,140,1,62,0.0,34.0,34.0,1,78,0.0,50.0,50.0
1770.931,6,88,4703,44,2342,41183.0,27.0,27.0,44,2361,41183.0,26.0,24.0
0.005,6,10,1547,5,764,1.0,496.0,496.0,5,783,1.0,515.0,515.0
0.085,6,10,1506,5,395,19.0,127.0,127.0,5,1111,16.0,843.0,843.0
0.08,6,10,1506,5,395,17.0,127.0,127.0,5,1111,17.0,843.0,843.0
0.004,6,10,1702,5,863,1.0,595.0,595.0,5,839,0.0,571.0,571.0
301.343,6,54,25684,28,19617,11160.0,4080.0,1538.0,26,6067,367.0,2667.0,385.0
0.02,6,10,1972,5,910,4.0,642.0,642.0,5,1062,4.0,794.0,794.0
0.013,6,10,1990,5,911,3.0,643.0,643.0,5,1079,3.0,811.0,811.0
0.136,6,10,1506,5,395,33.0,127.0,127.0,5,1111,29.0,843.0,843.0
0.064,6,10,1506,5,395,15.0,127.0,127.0,5,1111,15.0,843.0,843.0
0.003,17,2,136,1,60,0.0,32.0,32.0,1,76,0.0,48.0,48.0
0.006,6,10,1689,5,839,1.0,571.0,571.0,5,850,1.0,582.0,582.0
15.07,17,15,9238,8,6902,2148.0,1350.0,834.0,7,2336,2506.0,1350.0,305.0
0.001,17,2,180,1,66,0.0,38.0,38.0,1,114,0.0,86.0,86.0
172.089,17,80,11214,40,2666,4412.0,44.0,38.0,40,8548,4412.0,239.0,185.0
0.007,6,10,1547,5,764,1.0,496.0,496.0,5,783,1.0,515.0,515.0
0.008,6,12,1926,6,1189,1.0,659.0,434.0,6,737,1.0,417.0,417.0
0.016,6,10,1983,5,910,4.0,642.0,642.0,5,1073,4.0,805.0,805.0
0.013,6,13,3735,7,497,2.0,125.0,125.0,6,3238,2.0,1470.0,1459.0
40.063,17,10,676,5,460,10014.0,104.0,64.0,5,216,10014.0,20.0,15.0
0.013,6,10,1983,5,910,3.0,642.0,642.0,5,1073,3.0,805.0,805.0
0.112,17,4,580,2,122,109.0,33.0,33.0,2,458,108.0,307.0,201.0
40.057,17,10,676,5,460,10012.0,104.0,64.0,5,216,10013.0,20.0,15.0
178.141,17,88,12640,44,2960,4142.0,44.0,39.0,44,9680,4142.0,261.0,192.0
0.006,6,10,1547,5,764,1.0,496.0,496.0,5,783,1.0,515.0,515.0
0.072,17,4,284,2,120,0.0,32.0,32.0,2,164,69.0,60.0,54.0
0.004,17,2,148,1,60,0.0,32.0,32.0,1,88,0.0,60.0,60.0
0.007,6,10,1854,5,889,1.0,621.0,621.0,5,965,1.0,697.0,697.0
0.006,6,10,1689,5,839,1.0,571.0,571.0,5,850,1.0,582.0,582.0
0.006,6,10,1547,5,764,1.0,496.0,496.0,5,783,1.0,515.0,515.0
0.004,17,2,136,1,60,0.0,32.0,32.0,1,76,0.0,48.0,48.0
309.55,17,20,1124,10,716,34380.0,48.0,43.0,10,408,34380.0,20.0,12.0
0.004,17,2,148,1,60,0.0,32.0,32.0,1,88,0.0,60.0,60.0
0.009,6,13,3735,7,497,1.0,125.0,125.0,6,3238,1.0,1470.0,1459.0
0.005,6,10,2007,5,928,1.0,660.0,660.0,5,1079,1.0,811.0,811.0
0.017,6,10,1990,5,911,4.0,643.0,643.0,5,1079,4.0,811.0,811.0
0.041,17,2,152,1,76,0.0,48.0,48.0,1,76,0.0,48.0,48.0
0.004,6,10,2006,5,927,1.0,659.0,659.0,5,1079,1.0,811.0,811.0
0.011,6,10,1990,5,911,2.0,643.0,643.0,5,1079,2.0,811.0,811.0
0.009,6,10,1989,5,927,2.0,659.0,659.0,5,1062,2.0,794.0,794.0
0.008,6,10,1989,5,910,2.0,642.0,642.0,5,1079,1.0,811.0,811.0
0.001,17,2,136,1,60,0.0,32.0,32.0,1,76,0.0,48.0,48.0
0.006,6,10,1643,5,860,1.0,592.0,592.0,5,783,1.0,515.0,515.0
0.005,6,10,2000,5,927,1.0,659.0,659.0,5,1073,1.0,805.0,805.0
40.07,17,10,676,5,460,10015.0,104.0,64.0,5,216,10016.0,20.0,15.0
0.001,17,2,180,1,66,0.0,38.0,38.0,1,114,0.0,86.0,86.0
0.004,6,10,2006,5,927,1.0,659.0,659.0,5,1079,1.0,811.0,811.0
0.022,6,10,1989,5,910,5.0,642.0,642.0,5,1079,5.0,811.0,811.0
0.002,17,2,185,1,73,0.0,45.0,45.0,1,112,0.0,84.0,84.0
300.353,6,16,2170,9,684,37523.0,146.0,146.0,7,1486,50031.0,419.0,398.0
0.009,6,10,1677,5,827,2.0,559.0,559.0,5,850,2.0,582.0,582.0
0.08,17,8,3613,4,1874,26.0,1350.0,440.0,4,1739,11.0,1350.0,406.0
15.096,17,15,8186,8,6059,2152.0,1350.0,729.0,7,2127,2509.0,1350.0,275.0
0.766,6,10,2009,6,1655,153.0,1403.0,1403.0,4,354,177.0,182.0,182.0
0.005,6,10,1854,5,889,1.0,621.0,621.0,5,965,1.0,697.0,697.0
0.006,17,2,179,1,71,0.0,43.0,43.0,1,108,0.0,80.0,80.0
0.096,6,10,1506,5,395,22.0,127.0,127.0,5,1111,19.0,843.0,843.0
40.068,17,10,676,5,460,10015.0,104.0,64.0,5,216,10016.0,20.0,15.0
0.089,6,10,1506,5,395,21.0,127.0,127.0,5,1111,21.0,843.0,843.0
0.012,6,10,1972,5,910,2.0,642.0,642.0,5,1062,3.0,794.0,794.0
0.012,6,10,1990,5,911,3.0,643.0,643.0,5,1079,3.0,811.0,811.0
174.09,17,90,12497,45,3003,3956.0,44.0,38.0,45,9494,3956.0,239.0,182.0
0.007,6,10,1547,5,764,1.0,496.0,496.0,5,783,1.0,515.0,515.0
0.008,17,2,148,1,60,0.0,32.0,32.0,1,88,0.0,60.0,60.0
0.006,6,10,1547,5,764,1.0,496.0,496.0,5,783,1.0,515.0,515.0
0.005,6,10,1989,5,927,1.0,659.0,659.0,5,1062,1.0,794.0,794.0
0.018,6,10,1972,5,910,4.0,642.0,642.0,5,1062,4.0,794.0,794.0
0.009,6,10,1972,5,910,2.0,642.0,642.0,5,1062,2.0,794.0,794.0
0.006,6,10,2006,5,927,1.0,659.0,659.0,5,1079,1.0,811.0,811.0
0.011,6,10,1990,5,911,2.0,643.0,643.0,5,1079,2.0,811.0,811.0
0.075,6,10,1506,5,395,16.0,127.0,127.0,5,1111,16.0,843.0,843.0
0.006,6,10,1854,5,889,1.0,621.0,621.0,5,965,1.0,697.0,697.0
0.081,6,10,1506,5,395,18.0,127.0,127.0,5,1111,19.0,843.0,843.0
0.001,17,2,180,1,65,0.0,37.0,37.0,1,115,0.0,87.0,87.0
0.012,17,2,179,1,71,0.0,43.0,43.0,1,108,0.0,80.0,80.0
0.004,6,10,1702,5,863,1.0,595.0,595.0,5,839,0.0,571.0,571.0
0.041,17,2,148,1,60,0.0,32.0,32.0,1,88,0.0,60.0,60.0
0.008,6,13,3735,7,497,1.0,125.0,125.0,6,3238,1.0,1470.0,1459.0
0.005,17,2,154,1,69,0.0,41.0,41.0,1,85,0.0,57.0,57.0
0.005,6,10,1989,5,927,1.0,659.0,659.0,5,1062,1.0,794.0,794.0
40.053,17,10,676,5,460,10012.0,104.0,64.0,5,216,10012.0,20.0,15.0
40.078,17,10,676,5,460,10017.0,104.0,64.0,5,216,10017.0,20.0,15.0
0.067,6,10,1506,5,395,14.0,127.0,127.0,5,1111,14.0,843.0,843.0
0.098,6,10,1506,5,395,18.0,127.0,127.0,5,1111,23.0,843.0,843.0
0.016,6,11,2024,6,962,3.0,642.0,642.0,5,1062,3.0,794.0,794.0
0.004,17,4,284,2,120,0.0,32.0,32.0,2,164,1.0,60.0,54.0
0.053,6,10,1677,5,827,13.0,559.0,559.0,5,850,13.0,582.0,582.0
0.009,6,10,1677,5,827,2.0,559.0,559.0,5,850,2.0,582.0,582.0
0.102,6,10,1506,5,395,21.0,127.0,127.0,5,1111,21.0,843.0,843.0
360.025,6,21,3981,13,3142,30002.0,494.0,494.0,8,839,51431.0,83.0,83.0
0.074,6,10,1506,5,395,16.0,127.0,127.0,5,1111,16.0,843.0,843.0
0.042,17,4,580,2,122,1.0,33.0,33.0,2,458,1.0,307.0,201.0
0.005,6,10,2006,5,927,1.0,659.0,659.0,5,1079,1.0,811.0,811.0
0.004,6,10,2007,5,928,1.0,660.0,660.0,5,1079,1.0,811.0,811.0
0.007,6,10,2007,5,928,1.0,660.0,660.0,5,1079,1.0,811.0,811.0
0.022,17,2,170,1,65,0.0,37.0,37.0,1,105,0.0,77.0,77.0
240.023,6,9,787,5,488,60005.0,232.0,232.0,4,299,80006.0,83.0,83.0
0.005,6,10,2007,5,928,1.0,660.0,660.0,5,1079,1.0,811.0,811.0
0.004,6,10,2006,5,927,1.0,659.0,659.0,5,1079,1.0,811.0,811.0
0.009,6,10,1631,5,848,2.0,580.0,580.0,5,783,2.0,515.0,515.0
0.173,6,3,453,2,321,173.0,241.0,241.0,1,132,0.0,92.0,92.0
0.005,6,10,1643,5,860,1.0,592.0,592.0,5,783,1.0,515.0,515.0
0.008,17,2,180,1,66,0.0,38.0,38.0,1,114,0.0,86.0,86.0
0.103,6,10,1506,5,395,21.0,127.0,127.0,5,1111,22.0,843.0,843.0
0.004,6,10,2007,5,928,1.0,660.0,660.0,5,1079,1.0,811.0,811.0
0.005,6,10,1989,5,927,1.0,659.0,659.0,5,1062,1.0,794.0,794.0
0.005,6,10,2006,5,927,1.0,659.0,659.0,5,1079,1.0,811.0,811.0
0.005,6,13,3747,7,509,0.0,137.0,137.0,6,3238,1.0,1470.0,1459.0
0.076,6,10,1506,5,395,16.0,127.0,127.0,5,1111,15.0,843.0,843.0
15.071,17,15,9238,8,6902,2149.0,1350.0,834.0,7,2336,2507.0,1350.0,305.0
0.005,6,10,2000,5,927,1.0,659.0,659.0,5,1073,1.0,805.0,805.0
0.011,6,10,1990,5,911,2.0,643.0,643.0,5,1079,2.0,811.0,811.0
0.012,6,10,1677,5,827,3.0,559.0,559.0,5,850,3.0,582.0,582.0
0.005,6,10,1854,5,889,1.0,621.0,621.0,5,965,1.0,697.0,697.0
0.005,6,10,2007,5,928,1.0,660.0,660.0,5,1079,1.0,811.0,811.0
0.015,6,10,1989,5,910,3.0,642.0,642.0,5,1079,3.0,811.0,811.0
0.007,6,10,2006,5,927,1.0,659.0,659.0,5,1079,1.0,811.0,811.0
0.0,17,2,136,1,60,0.0,32.0,32.0,1,76,0.0,48.0,48.0
0.072,17,2,148,1,60,0.0,32.0,32.0,1,88,0.0,60.0,60.0
0.003,17,2,136,1,60,0.0,32.0,32.0,1,76,0.0,48.0,48.0
240.524,6,35,8925,18,2073,14148.0,694.0,225.0,17,6852,15032.0,1402.0,597.0
0.011,6,10,1677,5,827,2.0,559.0,559.0,5,850,2.0,582.0,582.0
0.008,6,10,1983,5,910,2.0,642.0,642.0,5,1073,1.0,805.0,805.0
11.166,17,28,4418,14,1994,846.0,269.0,114.0,14,2424,846.0,587.0,145.0
0.012,6,10,1631,5,848,2.0,580.0,580.0,5,783,2.0,515.0,515.0
0.006,6,10,2006,5,927,1.0,659.0,659.0,5,1079,1.0,811.0,811.0
0.019,6,10,1990,5,911,4.0,643.0,643.0,5,1079,4.0,811.0,811.0
0.367,17,47,28463,27,24829,14.0,1350.0,891.0,20,3634,18.0,1350.0,153.0
0.005,6,10,2000,5,927,1.0,659.0,659.0,5,1073,1.0,805.0,805.0
0.09,6,10,1506,5,395,20.0,127.0,127.0,5,1111,21.0,843.0,843.0
0.004,17,2,148,1,60,0.0,32.0,32.0,1,88,0.0,60.0,60.0
0.009,6,13,3747,7,509,1.0,137.0,137.0,6,3238,1.0,1470.0,1459.0
0.006,6,10,1547,5,764,1.0,496.0,496.0,5,783,1.0,515.0,515.0
0.017,6,6,716,3,458,7.0,302.0,302.0,3,258,6.0,102.0,102.0
0.011,6,10,1990,5,911,2.0,643.0,643.0,5,1079,2.0,811.0,811.0
0.005,17,2,187,1,71,0.0,43.0,43.0,1,116,0.0,88.0,88.0
0.005,6,10,1989,5,927,1.0,659.0,659.0,5,1062,1.0,794.0,794.0
0.001,17,2,180,1,66,0.0,38.0,38.0,1,114,0.0,86.0,86.0
0.004,6,10,2007,5,928,1.0,660.0,660.0,5,1079,1.0,811.0,811.0
351.99,6,20,2210,6,1308,12003.0,494.0,494.0,14,902,27075.0,83.0,83.0
0.006,6,10,1854,5,889,1.0,621.0,621.0,5,965,1.0,697.0,697.0
0.017,6,10,1983,5,910,4.0,642.0,642.0,5,1073,4.0,805.0,805.0
0.005,6,10,1643,5,860,1.0,592.0,592.0,5,783,1.0,515.0,515.0
0.004,6,10,1779,5,928,1.0,660.0,660.0,5,851,1.0,583.0,583.0
308.458,17,20,1124,10,716,34264.0,48.0,43.0,10,408,34264.0,20.0,12.0
0.01,6,10,1989,5,910,2.0,642.0,642.0,5,1079,2.0,811.0,811.0
0.126,6,10,1506,5,395,25.0,127.0,127.0,5,1111,26.0,843.0,843.0
0.013,6,10,1983,5,910,3.0,642.0,642.0,5,1073,3.0,805.0,805.0
0.005,6,10,2000,5,927,1.0,659.0,659.0,5,1073,1.0,805.0,805.0
0.006,17,2,140,1,62,0.0,34.0,34.0,1,78,0.0,50.0,50.0
40.064,17,10,676,5,460,10014.0,104.0,64.0,5,216,10014.0,20.0,15.0
0.075,6,10,1506,5,395,17.0,127.0,127.0,5,1111,14.0,843.0,843.0
0.001,17,2,180,1,65,0.0,37.0,37.0,1,115,0.0,87.0,87.0
0.005,17,2,136,1,60,0.0,32.0,32.0,1,76,0.0,48.0,48.0
0.014,6,10,1990,5,911,3.0,643.0,643.0,5,1079,3.0,811.0,811.0
0.112,6,10,1506,5,395,25.0,127.0,127.0,5,1111,24.0,843.0,843.0
0.005,6,10,1989,5,927,1.0,659.0,659.0,5,1062,1.0,794.0,794.0
0.015,6,10,1989,5,910,3.0,642.0,642.0,5,1079,3.0,811.0,811.0
0.006,6,10,1689,5,839,1.0,571.0,571.0,5,850,1.0,582.0,582.0
0.005,6,10,2007,5,928,1.0,660.0,660.0,5,1079,1.0,811.0,811.0
0.264,17,44,27991,26,24778,10.0,1350.0,925.0,18,3213,12.0,1350.0,150.0
300.33,6,16,2170,9,684,37520.0,146.0,146.0,7,1486,50026.0,419.0,398.0
0.004,6,10,1989,5,927,1.0,659.0,659.0,5,1062,1.0,794.0,794.0
0.012,6,10,1762,5,911,3.0,643.0,643.0,5,851,2.0,583.0,583.0
0.004,6,10,1774,5,923,1.0,655.0,655.0,5,851,1.0,583.0,583.0
240.207,6,16,4482,9,963,30025.0,238.0,166.0,7,3519,40028.0,1402.0,786.0
0.005,6,14,3736,7,446,0.0,74.0,74.0,7,3290,0.0,1448.0,972.0
0.005,17,2,168,1,76,0.0,48.0,48.0,1,92,0.0,64.0,64.0
0.016,6,10,1631,5,848,4.0,580.0,580.0,5,783,4.0,515.0,515.0
0.005,6,10,2007,5,928,1.0,660.0,660.0,5,1079,1.0,811.0,811.0
0.11,6,10,1506,5,395,26.0,127.0,127.0,5,1111,24.0,843.0,843.0
0.102,6,10,1506,5,395,22.0,127.0,127.0,5,1111,22.0,843.0,843.0
0.005,6,10,1547,5,764,1.0,496.0,496.0,5,783,1.0,515.0,515.0
0.113,6,10,1506,5,395,25.0,127.0,127.0,5,1111,24.0,843.0,843.0
0.011,6,10,1989,5,910,2.0,642.0,642.0,5,1079,2.0,811.0,811.0
0.007,6,10,1990,5,911,1.0,643.0,643.0,5,1079,1.0,811.0,811.0
0.008,6,12,1926,6,1189,1.0,659.0,434.0,6,737,1.0,417.0,417.0
0.01,6,10,1762,5,911,2.0,643.0,643.0,5,851,2.0,583.0,583.0
0.006,6,10,2007,5,928,1.0,660.0,660.0,5,1079,1.0,811.0,811.0
0.004,6,10,1989,5,927,1.0,659.0,659.0,5,1062,1.0,794.0,794.0
0.097,6,10,1506,5,395,20.0,127.0,127.0,5,1111,20.0,843.0,843.0
0.011,6,10,1989,5,910,2.0,642.0,642.0,5,1079,2.0,811.0,811.0
0.011,6,10,1972,5,910,2.0,642.0,642.0,5,1062,2.0,794.0,794.0
0.006,6,13,3747,7,509,0.0,137.0,137.0,6,3238,1.0,1470.0,1459.0
0.004,17,4,284,2,120,0.0,32.0,32.0,2,164,1.0,60.0,54.0
40.058,17,10,676,5,460,10013.0,104.0,64.0,5,216,10013.0,20.0,15.0
40.058,17,10,676,5,460,10012.0,104.0,64.0,5,216,10013.0,20.0,15.0
15.077,17,15,8190,8,6051,2149.0,1350.0,728.0,7,2139,2508.0,1350.0,277.0
0.006,6,10,1547,5,764,1.0,496.0,496.0,5,783,1.0,515.0,515.0
11.142,17,28,4397,14,2311,848.0,586.0,137.0,14,2086,848.0,269.0,121.0
0.004,17,2,136,1,60,0.0,32.0,32.0,1,76,0.0,48.0,48.0
0.005,17,2,152,1,68,0.0,40.0,40.0,1,84,0.0,56.0,56.0
0.016,6,10,1990,5,911,4.0,643.0,643.0,5,1079,3.0,811.0,811.0
0.076,6,10,1506,5,395,18.0,127.0,127.0,5,1111,17.0,843.0,843.0
0.001,17,2,180,1,66,0.0,38.0,38.0,1,114,0.0,86.0,86.0
0.004,6,10,1779,5,928,1.0,660.0,660.0,5,851,0.0,583.0,583.0
0.005,6,10,1689,5,839,1.0,571.0,571.0,5,850,1.0,582.0,582.0
15.071,17,15,9239,8,6902,2149.0,1350.0,834.0,7,2337,2507.0,1350.0,305.0
0.014,6,10,1762,5,911,3.0,643.0,643.0,5,851,3.0,583.0,583.0
15.079,17,16,8667,8,6369,2150.0,1350.0,768.0,8,2298,2149.0,1350.0,259.0
0.004,6,10,1702,5,863,1.0,595.0,595.0,5,839,1.0,571.0,571.0
0.004,6,10,2006,5,927,1.0,659.0,659.0,5,1079,1.0,811.0,811.0
40.1,17,10,676,5,460,10022.0,104.0,64.0,5,216,10024.0,20.0,15.0
0.069,17,8,3613,4,1874,23.0,1350.0,440.0,4,1739,12.0,1350.0,406.0
0.075,6,10,1506,5,395,16.0,127.0,127.0,5,1111,16.0,843.0,843.0
0.004,17,2,169,1,62,0.0,34.0,34.0,1,107,0.0,79.0,79.0
0.012,6,10,1990,5,911,3.0,643.0,643.0,5,1079,2.0,811.0,811.0
0.082,6,10,1506,5,395,16.0,127.0,127.0,5,1111,17.0,843.0,843.0
0.003,17,4,284,2,120,0.0,32.0,32.0,2,164,0.0,60.0,54.0
0.011,6,10,1972,5,910,2.0,642.0,642.0,5,1062,2.0,794.0,794.0
0.005,17,2,209,1,64,0.0,36.0,36.0,1,145,0.0,117.0,117.0
0.016,6,10,1762,5,911,4.0,643.0,643.0,5,851,3.0,583.0,583.0
0.006,6,10,1689,5,839,1.0,571.0,571.0,5,850,1.0,582.0,582.0
1772.549,6,107,6374,60,3525,30042.0,27.0,27.0,47,2849,38532.0,27.0,27.0
0.006,6,10,2006,5,927,1.0,659.0,659.0,5,1079,1.0,811.0,811.0
0.071,6,10,1506,5,395,15.0,127.0,127.0,5,1111,15.0,843.0,843.0
40.072,17,10,676,5,460,10017.0,104.0,64.0,5,216,10016.0,20.0,15.0
241.544,6,321,344279,122,17853,1996.0,2736.0,885.0,199,326426,1219.0,2804.0,1672.0
0.006,6,10,1689,5,839,1.0,571.0,571.0,5,850,1.0,582.0,582.0
364.979,6,20,2210,6,1308,12003.0,494.0,494.0,14,902,28075.0,83.0,83.0
0.087,6,10,1506,5,395,17.0,127.0,127.0,5,1111,18.0,843.0,843.0
0.006,6,10,1547,5,764,1.0,496.0,496.0,5,783,1.0,515.0,515.0
0.006,17,2,179,1,71,0.0,43.0,43.0,1,108,0.0,80.0,80.0
0.04,17,4,284,2,120,1.0,32.0,32.0,2,164,36.0,60.0,54.0
0.04,17,4,284,2,120,0.0,32.0,32.0,2,164,3.0,60.0,54.0
0.005,6,10,2000,5,927,1.0,659.0,659.0,5,1073,1.0,805.0,805.0
0.006,6,10,1547,5,764,1.0,496.0,496.0,5,783,1.0,515.0,515.0
0.011,6,10,1990,5,911,2.0,643.0,643.0,5,1079,2.0,811.0,811.0
0.011,6,10,1989,5,910,2.0,642.0,642.0,5,1079,2.0,811.0,811.0
0.045,17,2,169,1,62,0.0,34.0,34.0,1,107,0.0,79.0,79.0
0.015,6,10,1677,5,827,3.0,559.0,559.0,5,850,3.0,582.0,582.0
0.007,6,10,1990,5,911,1.0,643.0,643.0,5,1079,1.0,811.0,811.0
0.229,6,16,2777,8,1395,32.0,533.0,323.0,8,1382,21.0,529.0,239.0
0.014,6,10,1631,5,848,3.0,580.0,580.0,5,783,3.0,515.0,515.0
0.101,6,10,1506,5,395,21.0,127.0,127.0,5,1111,21.0,843.0,843.0
0.001,17,2,136,1,60,0.0,32.0,32.0,1,76,0.0,48.0,48.0
0.081,6,10,1506,5,395,17.0,127.0,127.0,5,1111,18.0,843.0,843.0
0.174,6,3,453,2,321,174.0,241.0,241.0,1,132,0.0,92.0,92.0
0.004,17,2,136,1,60,0.0,32.0,32.0,1,76,0.0,48.0,48.0
0.011,6,10,1972,5,910,2.0,642.0,642.0,5,1062,2.0,794.0,794.0
0.068,6,10,1506,5,395,16.0,127.0,127.0,5,1111,12.0,843.0,843.0
0.002,17,2,185,1,73,0.0,45.0,45.0,1,112,0.0,84.0,84.0
0.008,6,10,1972,5,910,1.0,642.0,642.0,5,1062,1.0,794.0,794.0
840.497,6,39,8379,25,6730,35020.0,494.0,494.0,14,1649,64653.0,83.0,83.0
0.006,6,13,3747,7,509,0.0,137.0,137.0,6,3238,1.0,1470.0,1459.0
0.084,6,10,1506,5,395,19.0,127.0,127.0,5,1111,18.0,843.0,843.0
0.008,6,10,1631,5,848,1.0,580.0,580.0,5,783,1.0,515.0,515.0
0.012,6,10,1989,5,910,2.0,642.0,642.0,5,1079,3.0,811.0,811.0
0.006,6,10,1547,5,764,1.0,496.0,496.0,5,783,1.0,515.0,515.0
0.005,6,10,2006,5,927,1.0,659.0,659.0,5,1079,1.0,811.0,811.0
0.006,6,10,1547,5,764,1.0,496.0,496.0,5,783,1.0,515.0,515.0
0.013,6,10,1631,5,848,3.0,580.0,580.0,5,783,3.0,515.0,515.0
0.009,6,10,1989,5,910,2.0,642.0,642.0,5,1079,2.0,811.0,811.0
0.013,6,10,1989,5,910,3.0,642.0,642.0,5,1079,3.0,811.0,811.0
0.125,6,10,1506,5,395,26.0,127.0,127.0,5,1111,28.0,843.0,843.0
0.012,6,10,1990,5,911,3.0,643.0,643.0,5,1079,3.0,811.0,811.0
240.565,6,21,7341,11,1823,24056.0,990.0,418.0,10,5518,26729.0,1591.0,831.0
13.66,17,45,10422,23,5528,615.0,1337.0,212.0,22,4894,645.0,861.0,194.0
0.069,6,10,1762,5,911,17.0,643.0,643.0,5,851,17.0,583.0,583.0
0.126,6,10,1506,5,395,29.0,127.0,127.0,5,1111,29.0,843.0,843.0
0.005,6,10,2007,5,928,1.0,660.0,660.0,5,1079,1.0,811.0,811.0
0.127,6,10,1506,5,395,27.0,127.0,127.0,5,1111,29.0,843.0,843.0
0.008,6,10,1972,5,910,2.0,642.0,642.0,5,1062,2.0,794.0,794.0
15.073,17,15,9238,8,6902,2149.0,1350.0,834.0,7,2336,2507.0,1350.0,305.0
0.005,6,10,2006,5,927,1.0,659.0,659.0,5,1079,1.0,811.0,811.0
0.01,6,10,1989,5,910,2.0,642.0,642.0,5,1079,2.0,811.0,811.0
0.008,6,10,1762,5,911,2.0,643.0,643.0,5,851,2.0,583.0,583.0
0.027,6,10,1990,5,911,6.0,643.0,643.0,5,1079,6.0,811.0,811.0
241.447,6,307,344152,118,17656,2063.0,2736.0,960.0,189,326496,1284.0,2804.0,1769.0
0.005,17,2,144,1,64,0.0,36.0,36.0,1,80,0.0,52.0,52.0
0.015,6,10,1677,5,827,3.0,559.0,559.0,5,850,3.0,582.0,582.0
0.004,17,2,180,1,66,0.0,38.0,38.0,1,114,0.0,86.0,86.0
0.005,6,10,1643,5,860,1.0,592.0,592.0,5,783,1.0,515.0,515.0
0.074,6,10,1506,5,395,15.0,127.0,127.0,5,1111,16.0,843.0,843.0
0.007,6,10,1989,5,927,1.0,659.0,659.0,5,1062,1.0,794.0,794.0
0.082,6,10,1506,5,395,17.0,127.0,127.0,5,1111,18.0,843.0,843.0
0.001,17,2,180,1,66,0.0,38.0,38.0,1,114,0.0,86.0,86.0
40.064,17,10,676,5,460,10015.0,104.0,64.0,5,216,10015.0,20.0,15.0
300.013,6,11,891,6,552,60002.0,232.0,232.0,5,339,75002.0,83.0,83.0
0.006,6,10,1989,5,927,1.0,659.0,659.0,5,1062,1.0,794.0,794.0
0.007,6,10,1989,5,927,1.0,659.0,659.0,5,1062,1.0,794.0,794.0
0.004,17,4,284,2,120,0.0,32.0,32.0,2,164,1.0,60.0,54.0
0.02,6,13,3735,7,497,3.0,125.0,125.0,6,3238,4.0,1470.0,1459.0
0.085,6,10,1506,5,395,19.0,127.0,127.0,5,1111,18.0,843.0,843.0
0.173,6,10,1506,5,395,38.0,127.0,127.0,5,1111,41.0,843.0,843.0
0.015,6,10,1983,5,910,3.0,642.0,642.0,5,1073,3.0,805.0,805.0
0.004,6,10,1774,5,923,1.0,655.0,655.0,5,851,1.0,583.0,583.0
0.115,6,10,1506,5,395,28.0,127.0,127.0,5,1111,24.0,843.0,843.0
0.088,6,10,1506,5,395,19.0,127.0,127.0,5,1111,21.0,843.0,843.0
0.017,6,13,3735,7,497,2.0,125.0,125.0,6,3238,3.0,1470.0,1459.0
376.264,6,22,2313,16,867,25084.0,195.0,195.0,6,1446,4651.0,419.0,398.0
10.874,17,28,4423,14,1995,827.0,270.0,114.0,14,2428,827.0,587.0,145.0
40.07,17,10,676,5,460,10015.0,104.0,64.0,5,216,10016.0,20.0,15.0
0.012,6,10,1631,5,848,3.0,580.0,580.0,5,783,2.0,515.0,515.0
0.004,6,10,2007,5,928,1.0,660.0,660.0,5,1079,1.0,811.0,811.0
953.73,6,50,9540,26,7288,26419.0,494.0,494.0,24,2252,41466.0,83.0,83.0
0.005,6,10,2000,5,927,1.0,659.0,659.0,5,1073,1.0,805.0,805.0
0.003,17,2,185,1,73,0.0,45.0,45.0,1,112,0.0,84.0,84.0
0.007,6,13,3735,7,497,1.0,125.0,125.0,6,3238,1.0,1470.0,1459.0
0.004,17,2,136,1,60,0.0,32.0,32.0,1,76,0.0,48.0,48.0
0.015,6,10,1774,5,923,3.0,655.0,655.0,5,851,3.0,583.0,583.0
0.006,17,2,169,1,62,0.0,34.0,34.0,1,107,0.0,79.0,79.0
15.069,17,15,9239,8,6902,2148.0,1350.0,834.0,7,2337,2506.0,1350.0,305.0
0.072,17,2,148,1,60,0.0,32.0,32.0,1,88,0.0,60.0,60.0
0.004,17,2,136,1,60,0.0,32.0,32.0,1,76,0.0,48.0,48.0
0.012,6,14,3787,7,497,2.0,125.0,125.0,7,3290,2.0,1448.0,972.0
1.075,6,13,3930,7,2139,134.0,1328.0,923.0,6,1791,161.0,1539.0,1539.0
11.115,17,28,4418,14,1993,842.0,268.0,114.0,14,2425,842.0,588.0,145.0
0.004,17,2,180,1,58,0.0,30.0,30.0,1,122,0.0,94.0,94.0
0.015,6,10,1989,5,910,3.0,642.0,642.0,5,1079,3.0,811.0,811.0
0.012,6,10,1972,5,910,3.0,642.0,642.0,5,1062,3.0,794.0,794.0
0.014,6,13,3735,7,497,2.0,125.0,125.0,6,3238,2.0,1470.0,1459.0
0.039,17,2,152,1,76,0.0,48.0,48.0,1,76,0.0,48.0,48.0
0.005,6,10,1779,5,928,1.0,660.0,660.0,5,851,1.0,583.0,583.0
169.346,17,80,11042,40,2671,4341.0,44.0,38.0,40,8371,4342.0,239.0,181.0
0.004,6,10,1779,5,928,1.0,660.0,660.0,5,851,1.0,583.0,583.0
0.006,6,10,1689,5,839,1.0,571.0,571.0,5,850,1.0,582.0,582.0
0.005,17,2,179,1,71,0.0,43.0,43.0,1,108,0.0,80.0,80.0
0.13,6,10,1506,5,395,26.0,127.0,127.0,5,1111,29.0,843.0,843.0
0.005,6,10,2006,5,927,1.0,659.0,659.0,5,1079,1.0,811.0,811.0
40.065,17,10,676,5,460,10015.0,104.0,64.0,5,216,10015.0,20.0,15.0
0.019,6,10,1990,5,911,4.0,643.0,643.0,5,1079,4.0,811.0,811.0
0.005,6,10,1989,5,927,1.0,659.0,659.0,5,1062,1.0,794.0,794.0
0.006,6,10,1547,5,764,1.0,496.0,496.0,5,783,1.0,515.0,515.0
0.067,17,8,3613,4,1874,22.0,1350.0,440.0,4,1739,10.0,1350.0,406.0
0.086,6,10,1506,5,395,17.0,127.0,127.0,5,1111,18.0,843.0,843.0
0.005,17,2,214,1,75,0.0,47.0,47.0,1,139,0.0,111.0,111.0
0.005,6,10,1779,5,928,1.0,660.0,660.0,5,851,1.0,583.0,583.0
0.001,17,2,180,1,66,0.0,38.0,38.0,1,114,0.0,86.0,86.0
40.059,17,10,676,5,460,10014.0,104.0,64.0,5,216,10013.0,20.0,15.0
0.067,6,10,1506,5,395,14.0,127.0,127.0,5,1111,14.0,843.0,843.0
0.082,6,10,1506,5,395,18.0,127.0,127.0,5,1111,14.0,843.0,843.0
240.096,6,16,4480,9,963,30012.0,238.0,166.0,7,3517,40015.0,1402.0,786.0
0.098,6,10,1506,5,395,22.0,127.0,127.0,5,1111,19.0,843.0,843.0
0.071,17,4,284,2,120,0.0,32.0,32.0,2,164,32.0,60.0,54.0
0.008,6,10,1983,5,910,2.0,642.0,642.0,5,1073,2.0,805.0,805.0
40.064,17,10,676,5,460,10015.0,104.0,64.0,5,216,10015.0,20.0,15.0
0.011,6,10,1972,5,910,2.0,642.0,642.0,5,1062,2.0,794.0,794.0
170.201,17,92,13003,46,3063,3782.0,44.0,38.0,46,9940,3782.0,261.0,188.0
0.009,6,13,3735,7,497,1.0,125.0,125.0,6,3238,1.0,1470.0,1459.0
0.013,17,2,152,1,56,0.0,28.0,28.0,1,96,0.0,68.0,68.0
0.091,6,10,1506,5,395,18.0,127.0,127.0,5,1111,16.0,843.0,843.0
0.053,17,2,152,1,76,0.0,48.0,48.0,1,76,0.0,48.0,48.0
0.01,6,10,1989,5,910,2.0,642.0,642.0,5,1079,2.0,811.0,811.0
0.005,6,10,2006,5,927,1.0,659.0,659.0,5,1079,1.0,811.0,811.0
0.003,6,10,1702,5,863,0.0,595.0,595.0,5,839,0.0,571.0,571.0
0.006,6,10,1547,5,764,1.0,496.0,496.0,5,783,1.0,515.0,515.0
52.242,6,47,18065,24,12118,398.0,2720.0,1236.0,23,5947,2366.0,2667.0,385.0
0.182,6,19,7599,10,2699,20.0,1368.0,542.0,9,4900,21.0,1657.0,1106.0
0.075,6,10,1506,5,395,15.0,127.0,127.0,5,1111,17.0,843.0,843.0
0.118,6,10,1506,5,395,26.0,127.0,127.0,5,1111,28.0,843.0,843.0
0.014,6,14,3787,7,497,2.0,125.0,125.0,7,3290,2.0,1448.0,972.0
10.923,17,28,4421,14,1994,831.0,269.0,114.0,14,2427,831.0,586.0,145.0
0.005,17,2,179,1,71,0.0,43.0,43.0,1,108,0.0,80.0,80.0
0.067,6,13,3735,7,497,11.0,125.0,125.0,6,3238,13.0,1470.0,1459.0
0.005,17,2,179,1,71,0.0,43.0,43.0,1,108,0.0,80.0,80.0
11.098,17,28,4397,14,2311,844.0,586.0,137.0,14,2086,844.0,269.0,121.0
0.005,6,13,3747,7,509,0.0,137.0,137.0,6,3238,0.0,1470.0,1459.0
0.005,17,2,179,1,71,0.0,43.0,43.0,1,108,0.0,80.0,80.0
178.108,17,68,9736,34,2258,5397.0,44.0,38.0,34,7478,5397.0,239.0,191.0
0.01,6,10,1677,5,827,2.0,559.0,559.0,5,850,2.0,582.0,582.0
0.012,6,10,1990,5,911,3.0,643.0,643.0,5,1079,3.0,811.0,811.0
0.098,6,10,1506,5,395,21.0,127.0,127.0,5,1111,22.0,843.0,843.0
0.006,6,10,1689,5,839,1.0,571.0,571.0,5,850,1.0,582.0,582.0
0.075,6,10,1506,5,395,17.0,127.0,127.0,5,1111,16.0,843.0,843.0
0.008,6,10,1989,5,910,2.0,642.0,642.0,5,1079,2.0,811.0,811.0
0.004,6,10,2006,5,927,1.0,659.0,659.0,5,1079,1.0,811.0,811.0
0.006,6,10,2007,5,928,1.0,660.0,660.0,5,1079,1.0,811.0,811.0
0.005,6,14,3736,7,446,0.0,74.0,74.0,7,3290,0.0,1448.0,972.0
0.004,6,10,1989,5,927,1.0,659.0,659.0,5,1062,1.0,794.0,794.0
0.034,6,13,3816,7,578,5.0,206.0,206.0,6,3238,6.0,1470.0,1459.0
0.108,6,10,1506,5,395,24.0,127.0,127.0,5,1111,24.0,843.0,843.0
0.006,6,10,1854,5,889,1.0,621.0,621.0,5,965,1.0,697.0,697.0
0.092,6,10,1506,5,395,20.0,127.0,127.0,5,1111,22.0,843.0,843.0
0.073,6,10,1506,5,395,14.0,127.0,127.0,5,1111,17.0,843.0,843.0
1799.819,6,136,6589,76,3664,23997.0,39.0,39.0,60,2925,30004.0,35.0,35.0
10.866,17,28,4423,14,1995,827.0,270.0,114.0,14,2428,827.0,587.0,145.0
0.01,17,2,148,1,60,0.0,32.0,32.0,1,88,0.0,60.0,60.0
0.014,6,10,1677,5,827,3.0,559.0,559.0,5,850,3.0,582.0,582.0
0.006,6,10,1689,5,839,1.0,571.0,571.0,5,850,1.0,582.0,582.0
0.108,6,10,1506,5,395,25.0,127.0,127.0,5,1111,25.0,843.0,843.0
0.06,6,10,1506,5,395,14.0,127.0,127.0,5,1111,12.0,843.0,843.0
0.017,6,10,2007,5,928,4.0,660.0,660.0,5,1079,4.0,811.0,811.0
240.131,6,48,7201,24,3339,10440.0,588.0,230.0,24,3862,10440.0,580.0,217.0
0.017,6,10,1677,5,827,4.0,559.0,559.0,5,850,4.0,582.0,582.0
0.005,6,10,1989,5,927,1.0,659.0,659.0,5,1062,1.0,794.0,794.0
0.017,6,13,3735,7,497,2.0,125.0,125.0,6,3238,3.0,1470.0,1459.0
0.001,17,2,180,1,66,0.0,38.0,38.0,1,114,0.0,86.0,86.0
0.003,17,2,148,1,60,0.0,32.0,32.0,1,88,0.0,60.0,60.0
0.039,17,2,136,1,60,0.0,32.0,32.0,1,76,0.0,48.0,48.0
0.065,6,10,1506,5,395,14.0,127.0,127.0,5,1111,15.0,843.0,843.0
0.004,6,10,1774,5,923,1.0,655.0,655.0,5,851,1.0,583.0,583.0
0.121,6,10,1506,5,395,26.0,127.0,127.0,5,1111,26.0,843.0,843.0
0.014,6,10,1972,5,910,3.0,642.0,642.0,5,1062,3.0,794.0,794.0
1777.863,17,141,44556,72,22752,25035.0,288.0,288.0,69,21804,26143.0,288.0,288.0
0.005,17,2,170,1,65,0.0,37.0,37.0,1,105,0.0,77.0,77.0
0.01,6,10,1972,5,910,2.0,642.0,642.0,5,1062,2.0,794.0,794.0
0.007,6,10,2000,5,927,1.0,659.0,659.0,5,1073,1.0,805.0,805.0
0.001,17,2,180,1,66,0.0,38.0,38.0,1,114,0.0,86.0,86.0
0.006,17,2,193,1,71,0.0,43.0,43.0,1,122,0.0,94.0,94.0
0.071,17,2,170,1,65,0.0,37.0,37.0,1,105,0.0,77.0,77.0
0.006,6,10,1547,5,764,1.0,496.0,496.0,5,783,1.0,515.0,515.0
0.105,6,10,1506,5,395,23.0,127.0,127.0,5,1111,20.0,843.0,843.0
0.011,6,10,1983,5,910,2.0,642.0,642.0,5,1073,2.0,805.0,805.0
0.014,6,10,1631,5,848,3.0,580.0,580.0,5,783,3.0,515.0,515.0
0.007,6,10,2000,5,927,1.0,659.0,659.0,5,1073,1.0,805.0,805.0
40.059,17,10,676,5,460,10014.0,104.0,64.0,5,216,10014.0,20.0,15.0
0.006,17,2,170,1,65,0.0,37.0,37.0,1,105,0.0,77.0,77.0
0.01,6,10,1762,5,911,2.0,643.0,643.0,5,851,2.0,583.0,583.0
0.108,6,10,1506,5,395,21.0,127.0,127.0,5,1111,23.0,843.0,843.0
0.007,6,10,1547,5,764,1.0,496.0,496.0,5,783,1.0,515.0,515.0
0.077,6,10,1506,5,395,17.0,127.0,127.0,5,1111,16.0,843.0,843.0
0.092,6,10,1506,5,395,21.0,127.0,127.0,5,1111,19.0,843.0,843.0
0.005,17,2,140,1,62,0.0,34.0,34.0,1,78,0.0,50.0,50.0
0.005,6,10,2006,5,927,1.0,659.0,659.0,5,1079,1.0,811.0,811.0
0.006,6,10,1547,5,764,1.0,496.0,496.0,5,783,1.0,515.0,515.0
9.037,17,6,376,5,280,2259.0,28.0,28.0,1,96,0.0,68.0,68.0
0.012,6,10,1990,5,911,3.0,643.0,643.0,5,1079,2.0,811.0,811.0
0.009,6,10,1989,5,910,2.0,642.0,642.0,5,1079,2.0,811.0,811.0
0.144,6,10,1506,5,395,29.0,127.0,127.0,5,1111,29.0,843.0,843.0
0.005,6,10,1989,5,927,1.0,659.0,659.0,5,1062,1.0,794.0,794.0
0.025,6,10,1989,5,910,6.0,642.0,642.0,5,1079,6.0,811.0,811.0
327.376,17,20,1124,10,716,36360.0,48.0,43.0,10,408,36360.0,20.0,12.0
0.067,6,10,1506,5,395,15.0,127.0,127.0,5,1111,12.0,843.0,843.0
0.013,6,10,1972,5,910,3.0,642.0,642.0,5,1062,3.0,794.0,794.0
0.005,17,2,154,1,69,0.0,41.0,41.0,1,85,0.0,57.0,57.0
0.005,6,10,1989,5,927,1.0,659.0,659.0,5,1062,1.0,794.0,794.0
0.016,6,10,1983,5,910,3.0,642.0,642.0,5,1073,3.0,805.0,805.0
0.004,6,10,2006,5,927,1.0,659.0,659.0,5,1079,1.0,811.0,811.0
353.658,6,20,2210,6,1308,12003.0,494.0,494.0,14,902,27204.0,83.0,83.0
0.012,6,10,1990,5,911,2.0,643.0,643.0,5,1079,2.0,811.0,811.0
0.011,6,10,1972,5,910,2.0,642.0,642.0,5,1062,2.0,794.0,794.0
0.009,17,2,162,1,65,0.0,37.0,37.0,1,97,0.0,69.0,69.0
0.001,17,2,166,1,75,0.0,47.0,47.0,1,91,0.0,63.0,63.0
0.042,17,2,396,1,61,0.0,33.0,33.0,1,335,0.0,307.0,307.0
0.086,6,10,1506,5,395,19.0,127.0,127.0,5,1111,19.0,843.0,843.0
369.43,6,22,2313,16,867,24628.0,195.0,195.0,6,1446,4689.0,419.0,398.0
0.004,6,10,1702,5,863,1.0,595.0,595.0,5,839,0.0,571.0,571.0
0.084,6,10,1506,5,395,17.0,127.0,127.0,5,1111,18.0,843.0,843.0
0.173,17,2,152,1,76,0.0,48.0,48.0,1,76,0.0,48.0,48.0
0.005,17,2,146,1,65,0.0,37.0,37.0,1,81,0.0,53.0,53.0
0.012,6,12,1926,6,1189,2.0,659.0,434.0,6,737,2.0,417.0,417.0
0.007,6,10,1972,5,910,1.0,642.0,642.0,5,1062,1.0,794.0,794.0
0.003,17,2,136,1,60,0.0,32.0,32.0,1,76,0.0,48.0,48.0
0.005,6,10,2006,5,927,1.0,659.0,659.0,5,1079,1.0,811.0,811.0
0.003,17,2,136,1,60,0.0,32.0,32.0,1,76,0.0,48.0,48.0
0.076,6,10,1506,5,395,16.0,127.0,127.0,5,1111,16.0,843.0,843.0
10.848,17,28,4422,14,1993,825.0,268.0,114.0,14,2429,825.0,588.0,145.0
0.016,6,10,1762,5,911,4.0,643.0,643.0,5,851,4.0,583.0,583.0
0.008,6,12,1926,6,1189,1.0,659.0,434.0,6,737,1.0,417.0,417.0
0.004,6,10,1989,5,927,1.0,659.0,659.0,5,1062,1.0,794.0,794.0
0.005,6,10,1989,5,927,1.0,659.0,659.0,5,1062,1.0,794.0,794.0
0.01,6,10,1989,5,910,2.0,642.0,642.0,5,1079,2.0,811.0,811.0
0.041,17,4,352,2,130,0.0,37.0,37.0,2,222,1.0,89.0,83.0
1770.464,6,84,4420,42,2210,43181.0,26.0,26.0,42,2210,43181.0,26.0,26.0
0.042,17,2,152,1,76,0.0,48.0,48.0,1,76,0.0,48.0,48.0
0.129,6,10,1506,5,395,27.0,127.0,127.0,5,1111,27.0,843.0,843.0
0.004,17,4,284,2,120,0.0,32.0,32.0,2,164,0.0,60.0,54.0
0.173,17,2,152,1,76,0.0,48.0,48.0,1,76,0.0,48.0,48.0
0.005,6,10,1989,5,927,1.0,659.0,659.0,5,1062,1.0,794.0,794.0
0.006,6,10,1643,5,860,1.0,592.0,592.0,5,783,1.0,515.0,515.0
0.007,17,2,179,1,71,0.0,43.0,43.0,1,108,0.0,80.0,80.0
0.013,6,10,1631,5,848,3.0,580.0,580.0,5,783,3.0,515.0,515.0
0.012,17,2,179,1,71,0.0,43.0,43.0,1,108,0.0,80.0,80.0
1792.609,6,492,99913,247,88523,7286.0,421.0,365.0,245,11390,7346.0,53.0,53.0
40.062,17,10,676,5,460,10014.0,104.0,64.0,5,216,10014.0,20.0,15.0
0.088,6,10,1506,5,395,20.0,127.0,127.0,5,1111,15.0,843.0,843.0
0.009,6,10,1989,5,910,2.0,642.0,642.0,5,1079,2.0,811.0,811.0
0.005,17,2,214,1,75,0.0,47.0,47.0,1,139,0.0,111.0,111.0
0.04,17,2,136,1,60,0.0,32.0,32.0,1,76,0.0,48.0,48.0
0.09,6,10,1506,5,395,20.0,127.0,127.0,5,1111,18.0,843.0,843.0
0.006,6,10,1854,5,889,1.0,621.0,621.0,5,965,1.0,697.0,697.0
40.063,17,10,676,5,460,10015.0,104.0,64.0,5,216,10014.0,20.0,15.0
0.215,6,16,2670,8,1396,30.0,533.0,324.0,8,1274,19.0,529.0,212.0
0.015,6,10,1972,5,910,3.0,642.0,642.0,5,1062,3.0,794.0,794.0
0.006,17,2,179,1,71,0.0,43.0,43.0,1,108,0.0,80.0,80.0
10.815,17,28,4421,14,1993,823.0,268.0,114.0,14,2428,823.0,587.0,145.0
0.011,6,10,1990,5,911,2.0,643.0,643.0,5,1079,2.0,811.0,811.0
0.005,6,14,3736,7,446,0.0,74.0,74.0,7,3290,0.0,1448.0,972.0
0.117,6,10,1506,5,395,26.0,127.0,127.0,5,1111,26.0,843.0,843.0
0.009,6,10,1990,5,911,2.0,643.0,643.0,5,1079,2.0,811.0,811.0
0.005,6,10,1774,5,923,1.0,655.0,655.0,5,851,1.0,583.0,583.0
0.076,6,10,1506,5,395,18.0,127.0,127.0,5,1111,16.0,843.0,843.0
0.005,17,2,170,1,65,0.0,37.0,37.0,1,105,0.0,77.0,77.0
0.118,6,10,1506,5,395,26.0,127.0,127.0,5,1111,27.0,843.0,843.0
0.004,17,2,148,1,60,0.0,32.0,32.0,1,88,0.0,60.0,60.0
15.272,17,18,9691,10,7512,1695.0,1350.0,723.0,8,2179,2177.0,1350.0,244.0
0.01,6,10,1989,5,910,2.0,642.0,642.0,5,1079,2.0,811.0,811.0
0.006,17,2,222,1,65,0.0,37.0,37.0,1,157,0.0,129.0,129.0
0.129,17,4,596,2,122,0.0,33.0,33.0,2,474,91.0,323.0,209.0
0.086,6,10,1506,5,395,19.0,127.0,127.0,5,1111,16.0,843.0,843.0
0.005,6,10,2006,5,927,1.0,659.0,659.0,5,1079,1.0,811.0,811.0
0.007,6,10,1983,5,910,1.0,642.0,642.0,5,1073,1.0,805.0,805.0
0.009,6,12,1926,6,1189,1.0,659.0,434.0,6,737,1.0,417.0,417.0
0.01,6,10,1989,5,910,2.0,642.0,642.0,5,1079,2.0,811.0,811.0
40.064,17,10,676,5,460,10014.0,104.0,64.0,5,216,10015.0,20.0,15.0
0.005,17,2,148,1,60,0.0,32.0,32.0,1,88,0.0,60.0,60.0
285.223,6,30,6573,16,1433,19014.0,517.0,290.0,14,5140,21940.0,2378.0,1104.0
0.005,6,10,1989,5,927,1.0,659.0,659.0,5,1062,1.0,794.0,794.0
0.024,6,13,3735,7,497,4.0,125.0,125.0,6,3238,4.0,1470.0,1459.0
0.005,6,10,1689,5,839,1.0,571.0,571.0,5,850,1.0,582.0,582.0
1755.238,6,64,7344,42,4469,42810.0,1625.0,108.0,22,2875,83574.0,1111.0,82.0
160.892,6,21,7397,11,1305,94.0,530.0,277.0,10,6092,17858.0,2720.0,946.0
0.169,17,2,152,1,76,0.0,48.0,48.0,1,76,0.0,48.0,48.0
0.089,6,10,1506,5,395,21.0,127.0,127.0,5,1111,20.0,843.0,843.0
0.013,6,10,1990,5,911,3.0,643.0,643.0,5,1079,3.0,811.0,811.0
0.009,6,10,1989,5,910,2.0,642.0,642.0,5,1079,2.0,811.0,811.0
0.006,6,10,1547,5,764,1.0,496.0,496.0,5,783,1.0,515.0,515.0
0.014,6,10,1989,5,910,3.0,642.0,642.0,5,1079,3.0,811.0,811.0
0.012,6,10,2007,5,928,3.0,660.0,660.0,5,1079,3.0,811.0,811.0
361.826,6,21,1792,16,1030,24121.0,190.0,190.0,5,762,60010.0,461.0,247.0
0.01,6,10,1989,5,910,2.0,642.0,642.0,5,1079,2.0,811.0,811.0
0.012,6,10,1677,5,827,2.0,559.0,559.0,5,850,3.0,582.0,582.0
0.04,17,2,170,1,65,0.0,37.0,37.0,1,105,0.0,77.0,77.0
0.005,6,10,2006,5,927,1.0,659.0,659.0,5,1079,1.0,811.0,811.0
0.006,6,10,2000,5,927,1.0,659.0,659.0,5,1073,1.0,805.0,805.0
0.072,6,10,1506,5,395,15.0,127.0,127.0,5,1111,16.0,843.0,843.0
0.041,17,4,596,2,122,0.0,33.0,33.0,2,474,1.0,323.0,209.0
0.071,17,2,144,1,64,0.0,36.0,36.0,1,80,0.0,52.0,52.0
40.067,17,10,676,5,460,10015.0,104.0,64.0,5,216,10015.0,20.0,15.0
0.118,6,10,1506,5,395,25.0,127.0,127.0,5,1111,27.0,843.0,843.0
0.171,6,3,453,2,321,171.0,241.0,241.0,1,132,0.0,92.0,92.0
0.009,6,10,1989,5,927,2.0,659.0,659.0,5,1062,2.0,794.0,794.0
40.068,17,10,676,5,460,10014.0,104.0,64.0,5,216,10016.0,20.0,15.0
0.005,6,10,2007,5,928,1.0,660.0,660.0,5,1079,1.0,811.0,811.0
0.006,6,10,2000,5,927,1.0,659.0,659.0,5,1073,1.0,805.0,805.0
300.799,6,39,11136,21,5618,15039.0,2720.0,791.0,18,5518,507.0,2667.0,435.0
168.24,17,80,11574,40,2675,4313.0,44.0,38.0,40,8899,4313.0,239.0,194.0
0.017,6,10,1631,5,848,4.0,580.0,580.0,5,783,4.0,515.0,515.0
0.127,6,10,1506,5,395,28.0,127.0,127.0,5,1111,19.0,843.0,843.0
0.003,17,2,136,1,60,0.0,32.0,32.0,1,76,0.0,48.0,48.0
0.117,6,10,1506,5,395,25.0,127.0,127.0,5,1111,25.0,843.0,843.0
0.005,6,10,2007,5,928,1.0,660.0,660.0,5,1079,1.0,811.0,811.0
0.012,6,10,1990,5,911,3.0,643.0,643.0,5,1079,2.0,811.0,811.0
0.005,6,10,1989,5,927,1.0,659.0,659.0,5,1062,1.0,794.0,794.0
0.011,6,10,1972,5,910,2.0,642.0,642.0,5,1062,2.0,794.0,794.0
0.012,6,10,1972,5,910,3.0,642.0,642.0,5,1062,2.0,794.0,794.0
0.082,6,10,1506,5,395,18.0,127.0,127.0,5,1111,18.0,843.0,843.0
240.087,6,16,4481,9,963,30010.0,238.0,166.0,7,3518,40014.0,1402.0,786.0
0.148,6,10,1506,5,395,23.0,127.0,127.0,5,1111,33.0,843.0,843.0
0.013,6,10,1990,5,911,3.0,643.0,643.0,5,1079,3.0,811.0,811.0
0.095,6,10,1506,5,395,20.0,127.0,127.0,5,1111,19.0,843.0,843.0
0.005,6,10,2006,5,927,1.0,659.0,659.0,5,1079,1.0,811.0,811.0
0.017,6,10,1762,5,911,4.0,643.0,643.0,5,851,4.0,583.0,583.0
0.011,6,10,1990,5,911,2.0,643.0,643.0,5,1079,2.0,811.0,811.0
0.006,6,10,1547,5,764,1.0,496.0,496.0,5,783,1.0,515.0,515.0
0.011,6,10,1762,5,911,2.0,643.0,643.0,5,851,2.0,583.0,583.0
390.85,6,22,2313,16,867,26056.0,195.0,195.0,6,1446,4665.0,419.0,398.0
0.009,6,10,1983,5,910,2.0,642.0,642.0,5,1073,2.0,805.0,805.0
0.009,6,10,1972,5,910,2.0,642.0,642.0,5,1062,2.0,794.0,794.0
240.488,6,35,8930,18,2076,14146.0,697.0,226.0,17,6854,15030.0,1402.0,597.0
322.355,17,20,1124,10,716,35808.0,48.0,43.0,10,408,35810.0,20.0,12.0
0.008,6,10,1762,5,911,2.0,643.0,643.0,5,851,2.0,583.0,583.0
0.004,17,2,136,1,60,0.0,32.0,32.0,1,76,0.0,48.0,48.0
0.015,17,2,198,1,91,0.0,63.0,63.0,1,107,0.0,79.0,79.0
0.001,17,2,180,1,66,0.0,38.0,38.0,1,114,0.0,86.0,86.0
0.003,17,2,152,1,76,0.0,48.0,48.0,1,76,0.0,48.0,48.0
11.015,17,28,4421,14,1994,839.0,269.0,114.0,14,2427,839.0,586.0,145.0
0.174,17,2,152,1,76,0.0,48.0,48.0,1,76,0.0,48.0,48.0
0.012,6,10,1989,5,910,3.0,642.0,642.0,5,1079,3.0,811.0,811.0
0.092,6,10,1506,5,395,18.0,127.0,127.0,5,1111,20.0,843.0,843.0
0.107,6,10,1506,5,395,23.0,127.0,127.0,5,1111,26.0,843.0,843.0
0.001,17,2,178,1,81,0.0,53.0,53.0,1,97,0.0,69.0,69.0
0.018,6,10,1972,5,910,4.0,642.0,642.0,5,1062,4.0,794.0,794.0
240.122,6,16,4480,9,963,30015.0,238.0,166.0,7,3517,40019.0,1402.0,786.0
0.013,6,10,1990,5,911,3.0,643.0,643.0,5,1079,3.0,811.0,811.0
0.027,6,13,3735,7,497,4.0,125.0,125.0,6,3238,5.0,1470.0,1459.0
167.101,17,74,10469,37,2473,4641.0,44.0,38.0,37,7996,4641.0,252.0,188.0
0.005,6,10,2000,5,927,1.0,659.0,659.0,5,1073,1.0,805.0,805.0
0.007,6,10,2006,5,927,1.0,659.0,659.0,5,1079,1.0,811.0,811.0
0.011,6,10,1631,5,848,2.0,580.0,580.0,5,783,2.0,515.0,515.0
0.003,17,4,284,2,120,0.0,32.0,32.0,2,164,1.0,60.0,54.0
0.006,6,10,1989,5,927,1.0,659.0,659.0,5,1062,1.0,794.0,794.0
0.042,6,10,1989,5,910,10.0,642.0,642.0,5,1079,10.0,811.0,811.0
0.072,17,4,352,2,130,1.0,37.0,37.0,2,222,31.0,89.0,83.0
0.006,6,10,2006,5,927,1.0,659.0,659.0,5,1079,1.0,811.0,811.0
0.011,6,10,1989,5,910,2.0,642.0,642.0,5,1079,2.0,811.0,811.0
0.004,17,2,148,1,60,0.0,32.0,32.0,1,88,0.0,60.0,60.0
65.741,6,20,8231,11,1898,6574.0,986.0,439.0,9,6333,8197.0,2111.0,976.0
0.005,17,2,164,1,74,0.0,46.0,46.0,1,90,0.0,62.0,62.0
40.052,17,10,676,5,460,10012.0,104.0,64.0,5,216,10012.0,20.0,15.0
0.015,6,10,1990,5,911,3.0,643.0,643.0,5,1079,3.0,811.0,811.0
0.01,6,12,1926,6,1189,2.0,659.0,434.0,6,737,1.0,417.0,417.0
1779.026,17,143,45188,72,22752,25053.0,288.0,288.0,71,22436,25413.0,288.0,288.0
0.008,6,10,1990,5,911,2.0,643.0,643.0,5,1079,2.0,811.0,811.0
0.005,6,14,3799,7,509,0.0,137.0,137.0,7,3290,0.0,1448.0,972.0
0.005,6,10,2006,5,927,1.0,659.0,659.0,5,1079,1.0,811.0,811.0
310.436,17,20,1124,10,716,34478.0,48.0,43.0,10,408,34478.0,20.0,12.0
0.011,6,13,3735,7,497,1.0,125.0,125.0,6,3238,2.0,1470.0,1459.0
0.005,6,10,1989,5,927,1.0,659.0,659.0,5,1062,1.0,794.0,794.0
0.004,17,2,136,1,60,0.0,32.0,32.0,1,76,0.0,48.0,48.0
0.003,17,2,136,1,60,0.0,32.0,32.0,1,76,0.0,48.0,48.0
352.261,6,20,2210,6,1308,12006.0,494.0,494.0,14,902,27096.0,83.0,83.0
0.004,6,10,1702,5,863,1.0,595.0,595.0,5,839,0.0,571.0,571.0
0.003,17,2,136,1,60,0.0,32.0,32.0,1,76,0.0,48.0,48.0
0.038,17,2,148,1,60,0.0,32.0,32.0,1,88,0.0,60.0,60.0
0.006,6,10,1689,5,839,1.0,571.0,571.0,5,850,1.0,582.0,582.0
0.005,17,2,214,1,75,0.0,47.0,47.0,1,139,0.0,111.0,111.0
0.022,6,10,1990,5,911,5.0,643.0,643.0,5,1079,5.0,811.0,811.0
177.162,17,102,14247,51,3451,3543.0,44.0,39.0,51,10796,3543.0,239.0,183.0
0.004,17,2,148,1,60,0.0,32.0,32.0,1,88,0.0,60.0,60.0
0.015,6,10,1972,5,910,3.0,642.0,642.0,5,1062,3.0,794.0,794.0
0.007,17,2,179,1,71,0.0,43.0,43.0,1,108,0.0,80.0,80.0
0.017,6,10,1972,5,910,4.0,642.0,642.0,5,1062,4.0,794.0,794.0
0.005,17,2,179,1,71,0.0,43.0,43.0,1,108,0.0,80.0,80.0
0.038,17,2,152,1,76,0.0,48.0,48.0,1,76,0.0,48.0,48.0
0.004,6,10,2000,5,927,1.0,659.0,659.0,5,1073,1.0,805.0,805.0
0.01,6,10,1762,5,911,2.0,643.0,643.0,5,851,2.0,583.0,583.0
11.176,17,28,4421,14,1993,847.0,268.0,114.0,14,2428,847.0,587.0,145.0
0.167,17,2,152,1,76,0.0,48.0,48.0,1,76,0.0,48.0,48.0
0.006,6,10,1547,5,764,1.0,496.0,496.0,5,783,1.0,515.0,515.0
0.006,6,10,1547,5,764,1.0,496.0,496.0,5,783,1.0,515.0,515.0
0.005,6,10,1774,5,923,1.0,655.0,655.0,5,851,1.0,583.0,583.0
0.005,6,10,1547,5,764,1.0,496.0,496.0,5,783,1.0,515.0,515.0
0.014,6,10,1989,5,910,3.0,642.0,642.0,5,1079,3.0,811.0,811.0
0.11,6,10,1506,5,395,25.0,127.0,127.0,5,1111,22.0,843.0,843.0
0.011,6,10,1983,5,910,2.0,642.0,642.0,5,1073,2.0,805.0,805.0
0.005,6,10,1989,5,927,1.0,659.0,659.0,5,1062,1.0,794.0,794.0
0.005,6,10,2006,5,927,1.0,659.0,659.0,5,1079,1.0,811.0,811.0
0.009,6,10,1972,5,910,2.0,642.0,642.0,5,1062,2.0,794.0,794.0
0.011,6,10,1972,5,910,2.0,642.0,642.0,5,1062,2.0,794.0,794.0
0.004,6,10,2007,5,928,1.0,660.0,660.0,5,1079,1.0,811.0,811.0
0.006,6,10,1547,5,764,1.0,496.0,496.0,5,783,1.0,515.0,515.0
40.052,17,10,676,5,460,10012.0,104.0,64.0,5,216,10012.0,20.0,15.0
0.005,6,10,1989,5,927,1.0,659.0,659.0,5,1062,1.0,794.0,794.0
0.009,6,10,1631,5,848,2.0,580.0,580.0,5,783,2.0,515.0,515.0
240.084,6,16,4481,9,963,30010.0,238.0,166.0,7,3518,40013.0,1402.0,786.0
10.708,17,28,4422,14,1994,815.0,269.0,114.0,14,2428,815.0,587.0,145.0
40.064,17,10,676,5,460,10014.0,104.0,64.0,5,216,10015.0,20.0,15.0
0.004,6,10,1989,5,927,1.0,659.0,659.0,5,1062,1.0,794.0,794.0
0.027,6,10,1989,5,910,6.0,642.0,642.0,5,1079,6.0,811.0,811.0
0.006,6,10,1547,5,764,1.0,496.0,496.0,5,783,1.0,515.0,515.0
0.01,6,10,1989,5,910,2.0,642.0,642.0,5,1079,2.0,811.0,811.0
351.984,6,20,2210,6,1308,12003.0,494.0,494.0,14,902,27075.0,83.0,83.0
0.097,6,10,1506,5,395,20.0,127.0,127.0,5,1111,23.0,843.0,843.0
0.005,6,10,2006,5,927,1.0,659.0,659.0,5,1079,1.0,811.0,811.0
0.014,6,10,1989,5,910,3.0,642.0,642.0,5,1079,3.0,811.0,811.0
0.004,17,2,152,1,68,0.0,40.0,40.0,1,84,0.0,56.0,56.0
0.07,6,10,1506,5,395,15.0,127.0,127.0,5,1111,15.0,843.0,843.0
0.012,6,10,1983,5,910,3.0,642.0,642.0,5,1073,2.0,805.0,805.0
0.01,6,10,1762,5,911,2.0,643.0,643.0,5,851,2.0,583.0,583.0
0.004,6,10,2000,5,927,1.0,659.0,659.0,5,1073,1.0,805.0,805.0
0.038,17,2,144,1,64,0.0,36.0,36.0,1,80,0.0,52.0,52.0
0.004,17,2,412,1,61,0.0,33.0,33.0,1,351,0.0,323.0,323.0
1787.029,6,155,20019,92,14158,19637.0,302.0,302.0,63,5861,28822.0,83.0,83.0
0.119,6,10,1506,5,395,25.0,127.0,127.0,5,1111,26.0,843.0,843.0
0.006,6,10,2000,5,927,1.0,659.0,659.0,5,1073,1.0,805.0,805.0
172.216,17,86,12297,43,2879,4100.0,44.0,38.0,43,9418,4100.0,239.0,191.0
0.01,6,10,1677,5,827,2.0,559.0,559.0,5,850,2.0,582.0,582.0
0.015,6,10,1983,5,910,3.0,642.0,642.0,5,1073,3.0,805.0,805.0
0.004,6,10,2000,5,927,1.0,659.0,659.0,5,1073,1.0,805.0,805.0
0.041,17,2,170,1,65,0.0,37.0,37.0,1,105,0.0,77.0,77.0
0.005,6,10,2007,5,928,1.0,660.0,660.0,5,1079,1.0,811.0,811.0
0.017,6,10,1972,5,910,4.0,642.0,642.0,5,1062,4.0,794.0,794.0
0.08,6,10,1506,5,395,17.0,127.0,127.0,5,1111,18.0,843.0,843.0
0.005,6,13,3747,7,509,0.0,137.0,137.0,6,3238,1.0,1470.0,1459.0
0.009,6,10,1989,5,910,2.0,642.0,642.0,5,1079,2.0,811.0,811.0
0.005,6,10,1643,5,860,1.0,592.0,592.0,5,783,1.0,515.0,515.0
0.087,17,8,3613,4,1874,29.0,1350.0,440.0,4,1739,13.0,1350.0,406.0
0.004,6,10,2007,5,928,1.0,660.0,660.0,5,1079,1.0,811.0,811.0
0.005,17,2,230,1,68,0.0,40.0,40.0,1,162,0.0,134.0,134.0
0.072,17,2,184,1,61,0.0,33.0,33.0,1,123,0.0,95.0,95.0
0.008,6,10,1983,5,910,2.0,642.0,642.0,5,1073,2.0,805.0,805.0
0.008,6,10,1989,5,910,1.0,642.0,642.0,5,1079,2.0,811.0,811.0
0.001,17,2,180,1,66,0.0,38.0,38.0,1,114,0.0,86.0,86.0
0.005,6,10,1689,5,839,1.0,571.0,571.0,5,850,1.0,582.0,582.0
0.006,6,10,2000,5,927,1.0,659.0,659.0,5,1073,1.0,805.0,805.0
0.006,6,10,1547,5,764,1.0,496.0,496.0,5,783,1.0,515.0,515.0
0.078,6,10,1506,5,395,17.0,127.0,127.0,5,1111,17.0,843.0,843.0
40.056,17,10,676,5,460,10012.0,104.0,64.0,5,216,10013.0,20.0,15.0
0.038,17,2,170,1,65,0.0,37.0,37.0,1,105,0.0,77.0,77.0
0.005,17,2,169,1,62,0.0,34.0,34.0,1,107,0.0,79.0,79.0
0.003,17,2,136,1,60,0.0,32.0,32.0,1,76,0.0,48.0,48.0
0.013,17,2,152,1,56,0.0,28.0,28.0,1,96,0.0,68.0,68.0
0.008,6,10,1972,5,910,2.0,642.0,642.0,5,1062,1.0,794.0,794.0
0.015,6,10,1990,5,911,3.0,643.0,643.0,5,1079,3.0,811.0,811.0
0.014,6,10,1990,5,911,3.0,643.0,643.0,5,1079,3.0,811.0,811.0
0.001,17,2,180,1,66,0.0,38.0,38.0,1,114,0.0,86.0,86.0
0.068,17,8,3613,4,1874,22.0,1350.0,440.0,4,1739,11.0,1350.0,406.0
40.057,17,10,676,5,460,10011.0,104.0,64.0,5,216,10013.0,20.0,15.0
0.005,6,10,2000,5,927,1.0,659.0,659.0,5,1073,1.0,805.0,805.0
0.002,17,2,179,1,62,0.0,34.0,34.0,1,117,0.0,89.0,89.0
0.095,6,10,1506,5,395,22.0,127.0,127.0,5,1111,17.0,843.0,843.0
0.137,17,2,152,1,76,0.0,48.0,48.0,1,76,0.0,48.0,48.0
0.005,6,10,2000,5,927,1.0,659.0,659.0,5,1073,1.0,805.0,805.0
40.058,17,10,676,5,460,10013.0,104.0,64.0,5,216,10013.0,20.0,15.0
0.008,6,10,1972,5,910,2.0,642.0,642.0,5,1062,1.0,794.0,794.0
0.005,6,10,1779,5,928,1.0,660.0,660.0,5,851,1.0,583.0,583.0
0.005,6,10,1989,5,927,1.0,659.0,659.0,5,1062,1.0,794.0,794.0
0.003,17,4,284,2,120,0.0,32.0,32.0,2,164,0.0,60.0,54.0
0.023,6,10,1972,5,910,5.0,642.0,642.0,5,1062,5.0,794.0,794.0
1.517,6,142,99590,73,96641,17.0,2828.0,1358.0,69,2949,18.0,177.0,177.0
0.009,17,4,284,2,120,0.0,32.0,32.0,2,164,0.0,60.0,54.0
0.005,6,10,1989,5,927,1.0,659.0,659.0,5,1062,1.0,794.0,794.0
0.039,6,14,3787,7,497,6.0,125.0,125.0,7,3290,6.0,1448.0,972.0
0.011,6,10,1990,5,911,2.0,643.0,643.0,5,1079,2.0,811.0,811.0
0.114,6,10,1506,5,395,23.0,127.0,127.0,5,1111,24.0,843.0,843.0
0.005,6,10,2006,5,927,1.0,659.0,659.0,5,1079,1.0,811.0,811.0
0.001,17,2,180,1,66,0.0,38.0,38.0,1,114,0.0,86.0,86.0
0.01,6,10,1989,5,910,2.0,642.0,642.0,5,1079,2.0,811.0,811.0
0.004,6,10,2006,5,927,1.0,659.0,659.0,5,1079,1.0,811.0,811.0
0.039,17,2,170,1,65,0.0,37.0,37.0,1,105,0.0,77.0,77.0
0.012,6,10,1989,5,910,2.0,642.0,642.0,5,1079,2.0,811.0,811.0
0.009,6,12,1926,6,1189,1.0,659.0,434.0,6,737,1.0,417.0,417.0
0.013,6,10,1989,5,910,3.0,642.0,642.0,5,1079,3.0,811.0,811.0
0.07,6,10,1506,5,395,15.0,127.0,127.0,5,1111,15.0,843.0,843.0
0.072,6,10,1506,5,395,15.0,127.0,127.0,5,1111,16.0,843.0,843.0
0.006,6,10,1547,5,764,1.0,496.0,496.0,5,783,1.0,515.0,515.0
0.001,17,2,180,1,66,0.0,38.0,38.0,1,114,0.0,86.0,86.0
0.006,6,10,1689,5,839,1.0,571.0,571.0,5,850,1.0,582.0,582.0
0.075,6,10,1506,5,395,18.0,127.0,127.0,5,1111,13.0,843.0,843.0
0.004,6,10,2000,5,927,1.0,659.0,659.0,5,1073,1.0,805.0,805.0
0.013,6,10,1983,5,910,3.0,642.0,642.0,5,1073,3.0,805.0,805.0
0.022,6,10,1631,5,848,5.0,580.0,580.0,5,783,5.0,515.0,515.0
0.074,17,2,144,1,64,0.0,36.0,36.0,1,80,0.0,52.0,52.0
0.001,17,2,179,1,62,0.0,34.0,34.0,1,117,0.0,89.0,89.0
0.042,17,2,182,1,65,0.0,37.0,37.0,1,117,0.0,89.0,89.0
0.031,17,2,136,1,60,0.0,32.0,32.0,1,76,0.0,48.0,48.0
0.006,6,10,2006,5,927,1.0,659.0,659.0,5,1079,1.0,811.0,811.0
0.005,6,10,2007,5,928,1.0,660.0,660.0,5,1079,1.0,811.0,811.0
0.005,6,13,3690,7,452,0.0,80.0,80.0,6,3238,0.0,1470.0,1459.0
0.025,17,2,169,1,62,0.0,34.0,34.0,1,107,0.0,79.0,79.0
50.308,6,20,3474,10,1539,5585.0,533.0,252.0,10,1935,5585.0,529.0,281.0
0.016,6,10,1631,5,848,4.0,580.0,580.0,5,783,4.0,515.0,515.0
0.003,17,2,152,1,76,0.0,48.0,48.0,1,76,0.0,48.0,48.0
0.014,6,10,1989,5,910,3.0,642.0,642.0,5,1079,3.0,811.0,811.0
0.006,6,10,2000,5,927,1.0,659.0,659.0,5,1073,1.0,805.0,805.0
0.135,6,10,1506,5,395,28.0,127.0,127.0,5,1111,31.0,843.0,843.0
0.009,6,10,1989,5,910,2.0,642.0,642.0,5,1079,2.0,811.0,811.0
0.005,17,2,136,1,60,0.0,32.0,32.0,1,76,0.0,48.0,48.0
0.082,17,4,580,2,122,45.0,33.0,33.0,2,458,39.0,307.0,201.0
0.001,17,2,132,1,58,0.0,30.0,30.0,1,74,0.0,46.0,46.0
40.071,17,10,676,5,460,10014.0,104.0,64.0,5,216,10016.0,20.0,15.0
0.005,17,2,179,1,71,0.0,43.0,43.0,1,108,0.0,80.0,80.0
0.075,6,10,1506,5,395,16.0,127.0,127.0,5,1111,17.0,843.0,843.0
0.009,17,2,170,1,65,0.0,37.0,37.0,1,105,0.0,77.0,77.0
240.677,6,35,8923,18,2073,14155.0,694.0,225.0,17,6850,15040.0,1402.0,597.0
0.012,6,10,1983,5,910,3.0,642.0,642.0,5,1073,3.0,805.0,805.0
1755.982,6,105,6270,60,3525,29761.0,27.0,27.0,45,2745,39907.0,27.0,27.0
253.142,6,31,2068,12,894,23012.0,46.0,46.0,19,1174,14053.0,46.0,46.0
0.005,6,10,1547,5,764,1.0,496.0,496.0,5,783,1.0,515.0,515.0
0.154,6,10,1506,5,395,35.0,127.0,127.0,5,1111,36.0,843.0,843.0
15.075,17,15,9238,8,6902,2149.0,1350.0,834.0,7,2336,2507.0,1350.0,305.0
0.005,6,10,1989,5,927,1.0,659.0,659.0,5,1062,1.0,794.0,794.0
0.017,6,13,3735,7,497,2.0,125.0,125.0,6,3238,3.0,1470.0,1459.0
0.076,6,10,1506,5,395,16.0,127.0,127.0,5,1111,14.0,843.0,843.0
11.04,17,28,4391,14,2312,840.0,587.0,137.0,14,2079,840.0,270.0,120.0
0.005,6,13,3747,7,509,0.0,137.0,137.0,6,3238,1.0,1470.0,1459.0
0.003,17,2,136,1,60,0.0,32.0,32.0,1,76,0.0,48.0,48.0
0.005,6,10,1779,5,928,1.0,660.0,660.0,5,851,1.0,583.0,583.0
0.072,6,10,1506,5,395,17.0,127.0,127.0,5,1111,14.0,843.0,843.0
0.005,17,2,166,1,75,0.0,47.0,47.0,1,91,0.0,63.0,63.0
0.001,17,2,179,1,62,0.0,34.0,34.0,1,117,0.0,89.0,89.0
1777.99,17,144,41760,72,22752,25041.0,288.0,288.0,72,19008,25041.0,236.0,236.0
0.004,6,10,1989,5,927,1.0,659.0,659.0,5,1062,1.0,794.0,794.0
0.016,17,2,180,1,66,0.0,38.0,38.0,1,114,0.0,86.0,86.0
0.04,17,2,152,1,76,0.0,48.0,48.0,1,76,0.0,48.0,48.0
0.006,17,2,302,1,65,0.0,37.0,37.0,1,237,0.0,209.0,209.0
0.04,17,2,136,1,60,0.0,32.0,32.0,1,76,0.0,48.0,48.0
0.015,6,10,1631,5,848,3.0,580.0,580.0,5,783,3.0,515.0,515.0
0.005,17,2,136,1,60,0.0,32.0,32.0,1,76,0.0,48.0,48.0
0.005,17,2,152,1,68,0.0,40.0,40.0,1,84,0.0,56.0,56.0
0.001,17,2,180,1,66,0.0,38.0,38.0,1,114,0.0,86.0,86.0
0.008,6,10,1989,5,910,1.0,642.0,642.0,5,1079,2.0,811.0,811.0
0.006,6,10,1989,5,927,1.0,659.0,659.0,5,1062,1.0,794.0,794.0
0.087,6,10,1506,5,395,19.0,127.0,127.0,5,1111,20.0,843.0,843.0
0.004,17,2,148,1,60,0.0,32.0,32.0,1,88,0.0,60.0,60.0
0.032,6,10,1972,5,910,8.0,642.0,642.0,5,1062,7.0,794.0,794.0
0.011,6,10,1990,5,911,2.0,643.0,643.0,5,1079,2.0,811.0,811.0
0.006,6,10,1547,5,764,1.0,496.0,496.0,5,783,1.0,515.0,515.0
0.001,17,2,180,1,66,0.0,38.0,38.0,1,114,0.0,86.0,86.0
0.005,6,10,2006,5,927,1.0,659.0,659.0,5,1079,1.0,811.0,811.0
0.005,6,10,1689,5,839,1.0,571.0,571.0,5,850,1.0,582.0,582.0
10.817,17,28,4417,14,1994,823.0,269.0,114.0,14,2423,823.0,586.0,145.0
0.005,6,10,1774,5,923,1.0,655.0,655.0,5,851,1.0,583.0,583.0
0.015,6,10,1983,5,910,3.0,642.0,642.0,5,1073,3.0,805.0,805.0
0.151,6,10,1506,5,395,35.0,127.0,127.0,5,1111,35.0,843.0,843.0
0.01,6,12,1926,6,1189,2.0,659.0,434.0,6,737,1.0,417.0,417.0
0.005,6,10,1774,5,923,1.0,655.0,655.0,5,851,1.0,583.0,583.0
0.074,6,10,1506,5,395,14.0,127.0,127.0,5,1111,16.0,843.0,843.0
0.026,6,13,3735,7,497,4.0,125.0,125.0,6,3238,5.0,1470.0,1459.0
0.012,6,10,1989,5,910,3.0,642.0,642.0,5,1079,3.0,811.0,811.0
0.005,6,10,2007,5,928,1.0,660.0,660.0,5,1079,1.0,811.0,811.0
0.005,6,10,1689,5,839,1.0,571.0,571.0,5,850,1.0,582.0,582.0
0.016,6,10,1989,5,910,3.0,642.0,642.0,5,1079,4.0,811.0,811.0
0.007,17,2,179,1,71,0.0,43.0,43.0,1,108,0.0,80.0,80.0
0.043,17,2,152,1,76,0.0,48.0,48.0,1,76,0.0,48.0,48.0
0.12,6,10,1506,5,395,29.0,127.0,127.0,5,1111,26.0,843.0,843.0
1770.517,6,82,4316,41,2158,44261.0,26.0,26.0,41,2158,44261.0,26.0,26.0
0.017,6,10,1631,5,848,4.0,580.0,580.0,5,783,4.0,515.0,515.0
40.067,17,10,676,5,460,10014.0,104.0,64.0,5,216,10015.0,20.0,15.0
0.005,6,10,2006,5,927,1.0,659.0,659.0,5,1079,1.0,811.0,811.0
0.005,6,10,1779,5,928,1.0,660.0,660.0,5,851,1.0,583.0,583.0
0.013,6,10,1677,5,827,3.0,559.0,559.0,5,850,3.0,582.0,582.0
0.125,17,2,80,1,32,0.0,4.0,4.0,1,48,0.0,20.0,20.0
0.029,6,10,1990,5,911,7.0,643.0,643.0,5,1079,7.0,811.0,811.0
0.14,6,10,1506,5,395,31.0,127.0,127.0,5,1111,30.0,843.0,843.0
0.012,6,10,1631,5,848,3.0,580.0,580.0,5,783,3.0,515.0,515.0
0.078,6,10,1506,5,395,18.0,127.0,127.0,5,1111,15.0,843.0,843.0
0.006,6,10,1547,5,764,1.0,496.0,496.0,5,783,1.0,515.0,515.0
0.004,6,10,1702,5,863,1.0,595.0,595.0,5,839,1.0,571.0,571.0
0.012,6,10,1990,5,911,3.0,643.0,643.0,5,1079,3.0,811.0,811.0
0.164,17,2,152,1,76,0.0,48.0,48.0,1,76,0.0,48.0,48.0
0.071,17,2,144,1,64,0.0,36.0,36.0,1,80,0.0,52.0,52.0
0.006,6,10,1547,5,764,1.0,496.0,496.0,5,783,1.0,515.0,515.0
0.01,6,10,1983,5,910,2.0,642.0,642.0,5,1073,2.0,805.0,805.0
0.005,6,10,1854,5,889,1.0,621.0,621.0,5,965,1.0,697.0,697.0
178.343,17,72,10210,36,2401,5095.0,44.0,38.0,36,7809,5095.0,239.0,188.0
0.009,6,10,1989,5,910,2.0,642.0,642.0,5,1079,2.0,811.0,811.0
1779.588,6,239,46364,114,33835,15748.0,2473.0,995.0,125,12529,14351.0,580.0,62.0
40.053,17,10,676,5,460,10010.0,104.0,64.0,5,216,10011.0,20.0,15.0
0.005,6,10,2006,5,927,1.0,659.0,659.0,5,1079,1.0,811.0,811.0
0.007,17,2,179,1,71,0.0,43.0,43.0,1,108,0.0,80.0,80.0
0.005,6,10,1989,5,927,1.0,659.0,659.0,5,1062,1.0,794.0,794.0
0.005,6,10,1989,5,927,1.0,659.0,659.0,5,1062,1.0,794.0,794.0
0.013,17,2,152,1,56,0.0,28.0,28.0,1,96,0.0,68.0,68.0
0.008,6,10,1989,5,910,2.0,642.0,642.0,5,1079,1.0,811.0,811.0
0.005,6,10,1547,5,764,1.0,496.0,496.0,5,783,1.0,515.0,515.0
0.02,6,13,3735,7,497,3.0,125.0,125.0,6,3238,4.0,1470.0,1459.0
0.005,6,10,2006,5,927,1.0,659.0,659.0,5,1079,1.0,811.0,811.0
0.004,6,10,2000,5,927,1.0,659.0,659.0,5,1073,1.0,805.0,805.0
0.005,17,2,136,1,60,0.0,32.0,32.0,1,76,0.0,48.0,48.0
0.077,6,10,1506,5,395,17.0,127.0,127.0,5,1111,14.0,843.0,843.0
0.004,6,10,2007,5,928,1.0,660.0,660.0,5,1079,1.0,811.0,811.0
40.063,17,10,676,5,460,10015.0,104.0,64.0,5,216,10015.0,20.0,15.0
0.239,6,21,6492,11,1546,23.0,533.0,322.0,10,4946,22.0,1402.0,736.0
177.229,17,92,13251,46,3075,3938.0,44.0,38.0,46,10176,3938.0,261.0,193.0
0.016,6,10,1983,5,910,3.0,642.0,642.0,5,1073,3.0,805.0,805.0
0.01,6,10,1631,5,848,2.0,580.0,580.0,5,783,2.0,515.0,515.0
0.005,6,10,2006,5,927,1.0,659.0,659.0,5,1079,1.0,811.0,811.0
351.984,6,20,2210,6,1308,12003.0,494.0,494.0,14,902,27075.0,83.0,83.0
0.017,6,10,1972,5,910,4.0,642.0,642.0,5,1062,4.0,794.0,794.0
0.028,6,10,1983,5,910,7.0,642.0,642.0,5,1073,7.0,805.0,805.0
0.011,6,10,1972,5,910,2.0,642.0,642.0,5,1062,2.0,794.0,794.0
0.005,17,2,140,1,62,0.0,34.0,34.0,1,78,0.0,50.0,50.0
0.008,6,13,3735,7,497,1.0,125.0,125.0,6,3238,1.0,1470.0,1459.0
0.04,17,2,148,1,60,0.0,32.0,32.0,1,88,0.0,60.0,60.0
240.025,6,9,787,5,488,60006.0,232.0,232.0,4,299,80007.0,83.0,83.0
0.052,17,2,152,1,76,0.0,48.0,48.0,1,76,0.0,48.0,48.0
0.005,6,10,1643,5,860,1.0,592.0,592.0,5,783,1.0,515.0,515.0
0.149,6,10,1506,5,395,35.0,127.0,127.0,5,1111,35.0,843.0,843.0
0.009,6,10,1972,5,910,2.0,642.0,642.0,5,1062,2.0,794.0,794.0
0.001,17,2,180,1,66,0.0,38.0,38.0,1,114,0.0,86.0,86.0
0.005,6,13,3747,7,509,0.0,137.0,137.0,6,3238,1.0,1470.0,1459.0
15.121,17,19,13436,9,8280,1886.0,1350.0,892.0,10,5156,1676.0,1350.0,487.0
40.092,17,10,676,5,460,10022.0,104.0,64.0,5,216,10022.0,20.0,15.0
175.35,17,72,10259,36,2401,5009.0,44.0,38.0,36,7858,5009.0,260.0,190.0
0.014,6,10,1989,5,910,3.0,642.0,642.0,5,1079,3.0,811.0,811.0
0.008,6,10,1989,5,910,2.0,642.0,642.0,5,1079,1.0,811.0,811.0
241.477,6,399,348839,196,21709,1238.0,2736.0,885.0,203,327130,1195.0,2804.0,1640.0
0.112,6,10,1506,5,395,24.0,127.0,127.0,5,1111,25.0,843.0,843.0
0.012,6,10,1990,5,911,3.0,643.0,643.0,5,1079,3.0,811.0,811.0
1755.916,6,105,6240,60,3510,29760.0,26.0,26.0,45,2730,39906.0,26.0,26.0
0.011,6,10,1990,5,911,2.0,643.0,643.0,5,1079,2.0,811.0,811.0
0.005,6,10,2000,5,927,1.0,659.0,659.0,5,1073,1.0,805.0,805.0
258.44,6,17,4534,9,963,32305.0,238.0,166.0,8,3571,36919.0,1402.0,786.0
0.005,6,10,2000,5,927,1.0,659.0,659.0,5,1073,1.0,805.0,805.0
10.991,17,28,4417,14,1994,836.0,269.0,114.0,14,2423,836.0,586.0,145.0
0.003,17,2,148,1,60,0.0,32.0,32.0,1,88,0.0,60.0,60.0
11.287,17,28,4423,14,1995,855.0,270.0,114.0,14,2428,855.0,587.0,145.0
0.006,6,10,2006,5,927,1.0,659.0,659.0,5,1079,1.0,811.0,811.0
0.005,6,10,1689,5,839,1.0,571.0,571.0,5,850,1.0,582.0,582.0
0.005,17,2,179,1,71,0.0,43.0,43.0,1,108,0.0,80.0,80.0
0.005,6,10,2006,5,927,1.0,659.0,659.0,5,1079,1.0,811.0,811.0
0.004,6,10,2007,5,928,1.0,660.0,660.0,5,1079,1.0,811.0,811.0
241.123,6,310,343847,115,17492,2115.0,2736.0,959.0,195,326355,1242.0,2804.0,1709.0
176.42,17,74,10478,37,2461,4900.0,44.0,38.0,37,8017,4900.0,260.0,188.0
0.013,6,10,1990,5,911,3.0,643.0,643.0,5,1079,3.0,811.0,811.0
0.069,17,8,3613,4,1874,23.0,1350.0,440.0,4,1739,11.0,1350.0,406.0
0.108,6,10,1506,5,395,22.0,127.0,127.0,5,1111,20.0,843.0,843.0
0.039,17,4,284,2,120,0.0,32.0,32.0,2,164,36.0,60.0,54.0
0.01,6,12,1926,6,1189,2.0,659.0,434.0,6,737,1.0,417.0,417.0
11.173,17,28,4423,14,1995,847.0,270.0,114.0,14,2428,847.0,587.0,145.0
0.005,6,13,3747,7,509,0.0,137.0,137.0,6,3238,1.0,1470.0,1459.0
15.081,17,15,8318,8,6164,2150.0,1350.0,742.0,7,2154,2508.0,1350.0,279.0
0.006,6,10,1689,5,839,1.0,571.0,571.0,5,850,1.0,582.0,582.0
0.004,6,10,1774,5,923,1.0,655.0,655.0,5,851,1.0,583.0,583.0
0.012,6,10,1983,5,910,3.0,642.0,642.0,5,1073,2.0,805.0,805.0
0.079,6,10,1506,5,395,17.0,127.0,127.0,5,1111,17.0,843.0,843.0
0.006,6,10,1689,5,839,1.0,571.0,571.0,5,850,1.0,582.0,582.0
0.007,6,10,1547,5,764,1.0,496.0,496.0,5,783,1.0,515.0,515.0
0.001,17,2,180,1,66,0.0,38.0,38.0,1,114,0.0,86.0,86.0
0.005,17,2,193,1,71,0.0,43.0,43.0,1,122,0.0,94.0,94.0
0.167,17,2,152,1,76,0.0,48.0,48.0,1,76,0.0,48.0,48.0
0.004,6,10,2006,5,927,1.0,659.0,659.0,5,1079,1.0,811.0,811.0
0.092,6,10,1506,5,395,20.0,127.0,127.0,5,1111,21.0,843.0,843.0
0.006,6,10,1989,5,927,1.0,659.0,659.0,5,1062,1.0,794.0,794.0
0.117,6,10,1506,5,395,27.0,127.0,127.0,5,1111,27.0,843.0,843.0
353.972,6,21,1795,16,1030,23598.0,190.0,190.0,5,765,60002.0,464.0,248.0
0.001,17,2,136,1,60,0.0,32.0,32.0,1,76,0.0,48.0,48.0
40.083,17,10,676,5,460,10018.0,104.0,64.0,5,216,10019.0,20.0,15.0
0.012,6,10,1983,5,910,2.0,642.0,642.0,5,1073,2.0,805.0,805.0
378.607,6,22,2313,16,867,25240.0,195.0,195.0,6,1446,4636.0,419.0,398.0
0.009,6,10,1972,5,910,2.0,642.0,642.0,5,1062,2.0,794.0,794.0
40.06,17,10,676,5,460,10013.0,104.0,64.0,5,216,10014.0,20.0,15.0
0.012,6,10,1677,5,827,3.0,559.0,559.0,5,850,3.0,582.0,582.0
0.001,17,2,136,1,60,0.0,32.0,32.0,1,76,0.0,48.0,48.0
0.006,6,10,1547,5,764,1.0,496.0,496.0,5,783,1.0,515.0,515.0
0.006,6,10,1547,5,764,1.0,496.0,496.0,5,783,1.0,515.0,515.0
15.227,17,39,20181,21,17037,759.0,1350.0,783.0,18,3144,893.0,1350.0,146.0
0.07,6,10,1506,5,395,16.0,127.0,127.0,5,1111,13.0,843.0,843.0
0.005,6,10,1989,5,927,1.0,659.0,659.0,5,1062,1.0,794.0,794.0
240.016,6,9,787,5,488,60004.0,232.0,232.0,4,299,80004.0,83.0,83.0
0.088,6,10,1506,5,395,19.0,127.0,127.0,5,1111,17.0,843.0,843.0
0.004,6,10,1779,5,928,1.0,660.0,660.0,5,851,1.0,583.0,583.0
11.23,17,28,4421,14,1993,855.0,268.0,114.0,14,2428,855.0,587.0,145.0
0.014,6,10,1762,5,911,3.0,643.0,643.0,5,851,3.0,583.0,583.0
0.005,6,10,2007,5,928,1.0,660.0,660.0,5,1079,1.0,811.0,811.0
11.187,17,28,4419,14,1994,847.0,269.0,114.0,14,2425,847.0,588.0,145.0
0.005,17,2,284,1,69,0.0,41.0,41.0,1,215,0.0,187.0,187.0
0.005,6,10,2006,5,927,1.0,659.0,659.0,5,1079,1.0,811.0,811.0
0.006,6,10,1547,5,764,1.0,496.0,496.0,5,783,1.0,515.0,515.0
0.003,17,4,284,2,120,0.0,32.0,32.0,2,164,0.0,60.0,54.0
0.116,6,10,1506,5,395,26.0,127.0,127.0,5,1111,26.0,843.0,843.0
0.108,6,10,1506,5,395,20.0,127.0,127.0,5,1111,24.0,843.0,843.0
1756.145,6,105,6270,60,3525,29764.0,27.0,27.0,45,2745,39911.0,27.0,27.0
0.01,6,10,1990,5,911,2.0,643.0,643.0,5,1079,2.0,811.0,811.0
30.039,6,12,1310,7,557,5006.0,185.0,185.0,5,753,7501.0,473.0,242.0
0.012,6,10,1983,5,910,3.0,642.0,642.0,5,1073,2.0,805.0,805.0
0.021,6,10,1631,5,848,5.0,580.0,580.0,5,783,5.0,515.0,515.0
0.006,6,10,1547,5,764,1.0,496.0,496.0,5,783,1.0,515.0,515.0
0.005,6,10,1702,5,863,1.0,595.0,595.0,5,839,1.0,571.0,571.0
0.004,6,10,2000,5,927,1.0,659.0,659.0,5,1073,1.0,805.0,805.0
0.011,6,10,1762,5,911,2.0,643.0,643.0,5,851,2.0,583.0,583.0
0.005,6,10,2000,5,927,1.0,659.0,659.0,5,1073,1.0,805.0,805.0
0.005,6,13,3747,7,509,0.0,137.0,137.0,6,3238,1.0,1470.0,1459.0
0.005,6,10,2000,5,927,1.0,659.0,659.0,5,1073,1.0,805.0,805.0
0.01,6,10,1989,5,910,2.0,642.0,642.0,5,1079,2.0,811.0,811.0
0.006,6,10,1547,5,764,1.0,496.0,496.0,5,783,1.0,515.0,515.0
0.142,6,10,1506,5,395,33.0,127.0,127.0,5,1111,34.0,843.0,843.0
0.003,17,2,136,1,60,0.0,32.0,32.0,1,76,0.0,48.0,48.0
0.005,6,10,1989,5,927,1.0,659.0,659.0,5,1062,1.0,794.0,794.0
0.083,6,10,1506,5,395,18.0,127.0,127.0,5,1111,18.0,843.0,843.0
0.087,6,10,1506,5,395,19.0,127.0,127.0,5,1111,19.0,843.0,843.0
0.008,6,10,1989,5,910,2.0,642.0,642.0,5,1079,2.0,811.0,811.0
0.001,17,2,180,1,66,0.0,38.0,38.0,1,114,0.0,86.0,86.0
0.005,17,2,222,1,65,0.0,37.0,37.0,1,157,0.0,129.0,129.0
0.012,6,10,1983,5,910,2.0,642.0,642.0,5,1073,2.0,805.0,805.0
0.037,17,2,152,1,76,0.0,48.0,48.0,1,76,0.0,48.0,48.0
0.008,6,10,1689,5,839,1.0,571.0,571.0,5,850,1.0,582.0,582.0
0.012,6,10,1972,5,910,3.0,642.0,642.0,5,1062,3.0,794.0,794.0
0.005,6,10,2006,5,927,1.0,659.0,659.0,5,1079,1.0,811.0,811.0
0.091,6,10,1506,5,395,21.0,127.0,127.0,5,1111,21.0,843.0,843.0
0.005,6,10,2000,5,927,1.0,659.0,659.0,5,1073,1.0,805.0,805.0
64.11,58,5,360,4,288,21370.0,24.0,24.0,1,72,0.0,24.0,24.0
0.017,6,10,1972,5,910,4.0,642.0,642.0,5,1062,4.0,794.0,794.0
0.051,17,2,136,1,60,0.0,32.0,32.0,1,76,0.0,48.0,48.0
0.005,17,4,284,2,120,2.0,32.0,32.0,2,164,2.0,60.0,54.0
0.008,17,2,194,1,59,0.0,31.0,31.0,1,135,0.0,107.0,107.0
0.086,6,10,1506,5,395,19.0,127.0,127.0,5,1111,18.0,843.0,843.0
0.004,6,10,1989,5,927,1.0,659.0,659.0,5,1062,1.0,794.0,794.0
0.003,17,4,284,2,120,1.0,32.0,32.0,2,164,0.0,60.0,54.0
0.027,6,10,1989,5,910,6.0,642.0,642.0,5,1079,6.0,811.0,811.0
0.05,17,2,148,1,60,0.0,32.0,32.0,1,88,0.0,60.0,60.0
0.039,17,2,148,1,60,0.0,32.0,32.0,1,88,0.0,60.0,60.0
0.006,6,10,2007,5,928,1.0,660.0,660.0,5,1079,1.0,811.0,811.0
15.082,17,16,8194,8,6065,2150.0,1350.0,730.0,8,2129,2150.0,1350.0,238.0
0.013,17,2,152,1,56,0.0,28.0,28.0,1,96,0.0,68.0,68.0
0.118,6,10,1506,5,395,27.0,127.0,127.0,5,1111,27.0,843.0,843.0
300.401,6,16,2170,9,684,37529.0,146.0,146.0,7,1486,50038.0,419.0,398.0
0.006,6,10,1547,5,764,1.0,496.0,496.0,5,783,1.0,515.0,515.0
0.011,6,10,2000,5,927,2.0,659.0,659.0,5,1073,2.0,805.0,805.0
0.005,6,10,1989,5,927,1.0,659.0,659.0,5,1062,1.0,794.0,794.0
43.592,6,46,16659,23,10712,413.0,2720.0,1220.0,23,5947,1974.0,2667.0,385.0
0.085,6,10,1506,5,395,19.0,127.0,127.0,5,1111,18.0,843.0,843.0
0.01,6,10,1762,5,911,2.0,643.0,643.0,5,851,2.0,583.0,583.0
240.017,6,9,787,5,488,60004.0,232.0,232.0,4,299,80004.0,83.0,83.0
0.004,17,2,170,1,65,0.0,37.0,37.0,1,105,0.0,77.0,77.0
0.003,17,4,284,2,120,0.0,32.0,32.0,2,164,0.0,60.0,54.0
292.918,6,40,9979,16,6657,19527.0,1729.0,647.0,24,3322,12735.0,580.0,129.0
0.022,17,2,234,1,61,0.0,33.0,33.0,1,173,0.0,145.0,145.0
0.006,6,10,1547,5,764,1.0,496.0,496.0,5,783,1.0,515.0,515.0
0.012,6,10,1983,5,910,3.0,642.0,642.0,5,1073,3.0,805.0,805.0
0.003,17,2,148,1,60,0.0,32.0,32.0,1,88,0.0,60.0,60.0
0.059,6,10,1762,5,911,14.0,643.0,643.0,5,851,14.0,583.0,583.0
0.005,17,2,180,1,66,0.0,38.0,38.0,1,114,0.0,86.0,86.0
0.008,6,10,1677,5,827,2.0,559.0,559.0,5,850,2.0,582.0,582.0
0.004,6,10,2000,5,927,1.0,659.0,659.0,5,1073,1.0,805.0,805.0
0.004,17,2,180,1,66,0.0,38.0,38.0,1,114,0.0,86.0,86.0
0.006,6,10,1689,5,839,1.0,571.0,571.0,5,850,1.0,582.0,582.0
0.006,6,10,2006,5,927,1.0,659.0,659.0,5,1079,1.0,811.0,811.0
0.009,6,13,3735,7,497,1.0,125.0,125.0,6,3238,1.0,1470.0,1459.0
0.005,6,10,2006,5,927,1.0,659.0,659.0,5,1079,1.0,811.0,811.0
0.004,17,4,284,2,120,0.0,32.0,32.0,2,164,0.0,60.0,54.0
0.084,6,10,1506,5,395,19.0,127.0,127.0,5,1111,18.0,843.0,843.0
0.004,6,10,1702,5,863,1.0,595.0,595.0,5,839,1.0,571.0,571.0
0.006,6,10,1547,5,764,1.0,496.0,496.0,5,783,1.0,515.0,515.0
0.007,17,2,194,1,59,0.0,31.0,31.0,1,135,0.0,107.0,107.0
295.152,6,317,343838,125,18039,2380.0,2736.0,887.0,192,325799,1545.0,2804.0,1774.0
331.508,17,20,1124,10,716,36819.0,48.0,43.0,10,408,36819.0,20.0,12.0
0.018,6,10,1989,5,910,4.0,642.0,642.0,5,1079,4.0,811.0,811.0
0.017,17,2,198,1,91,0.0,63.0,63.0,1,107,0.0,79.0,79.0
0.016,6,10,1989,5,910,4.0,642.0,642.0,5,1079,4.0,811.0,811.0
0.005,6,10,1989,5,927,1.0,659.0,659.0,5,1062,1.0,794.0,794.0
15.217,17,18,9201,9,7041,1898.0,1350.0,754.0,9,2160,1898.0,1350.0,212.0
40.063,17,10,676,5,460,10012.0,104.0,64.0,5,216,10014.0,20.0,15.0
0.003,17,2,136,1,60,0.0,32.0,32.0,1,76,0.0,48.0,48.0
0.005,6,10,1989,5,927,1.0,659.0,659.0,5,1062,1.0,794.0,794.0
0.005,6,14,3736,7,446,0.0,74.0,74.0,7,3290,0.0,1448.0,972.0
0.004,6,10,2006,5,927,1.0,659.0,659.0,5,1079,1.0,811.0,811.0
0.008,6,10,1972,5,910,2.0,642.0,642.0,5,1062,2.0,794.0,794.0
0.006,17,2,230,1,68,0.0,40.0,40.0,1,162,0.0,134.0,134.0
436.632,6,32,11123,17,3295,27287.0,676.0,400.0,15,7828,31185.0,1402.0,881.0
0.001,17,2,166,1,75,0.0,47.0,47.0,1,91,0.0,63.0,63.0
81.296,6,26,9525,12,1627,100.0,794.0,367.0,14,7898,6242.0,1360.0,732.0
0.003,17,4,284,2,120,0.0,32.0,32.0,2,164,0.0,60.0,54.0
0.004,17,2,170,1,65,0.0,37.0,37.0,1,105,0.0,77.0,77.0
0.008,6,14,3787,7,497,1.0,125.0,125.0,7,3290,1.0,1448.0,972.0
0.009,6,10,1972,5,910,2.0,642.0,642.0,5,1062,2.0,794.0,794.0
0.006,6,13,3747,7,509,1.0,137.0,137.0,6,3238,1.0,1470.0,1459.0
0.005,6,10,1989,5,927,1.0,659.0,659.0,5,1062,1.0,794.0,794.0
0.018,6,10,1990,5,911,4.0,643.0,643.0,5,1079,4.0,811.0,811.0
40.066,17,10,676,5,460,10015.0,104.0,64.0,5,216,10015.0,20.0,15.0
0.009,6,10,1983,5,910,2.0,642.0,642.0,5,1073,2.0,805.0,805.0
0.005,17,2,169,1,62,0.0,34.0,34.0,1,107,0.0,79.0,79.0
0.126,17,2,136,1,60,0.0,32.0,32.0,1,76,0.0,48.0,48.0
0.005,6,10,1989,5,927,1.0,659.0,659.0,5,1062,1.0,794.0,794.0
0.014,6,10,1972,5,910,3.0,642.0,642.0,5,1062,3.0,794.0,794.0
0.07,6,10,1506,5,395,16.0,127.0,127.0,5,1111,16.0,843.0,843.0
361.847,6,21,1792,16,1030,24123.0,190.0,190.0,5,762,60008.0,461.0,247.0
0.008,17,2,194,1,59,0.0,31.0,31.0,1,135,0.0,107.0,107.0
0.015,6,10,1990,5,911,3.0,643.0,643.0,5,1079,3.0,811.0,811.0
0.005,6,10,2000,5,927,1.0,659.0,659.0,5,1073,1.0,805.0,805.0
0.012,6,10,1989,5,910,3.0,642.0,642.0,5,1079,2.0,811.0,811.0
0.164,17,2,152,1,76,0.0,48.0,48.0,1,76,0.0,48.0,48.0
0.076,6,10,1506,5,395,17.0,127.0,127.0,5,1111,16.0,843.0,843.0
0.004,6,10,2000,5,927,1.0,659.0,659.0,5,1073,1.0,805.0,805.0
0.014,6,10,1990,5,911,3.0,643.0,643.0,5,1079,3.0,811.0,811.0
40.06,17,10,676,5,460,10013.0,104.0,64.0,5,216,10014.0,20.0,15.0
0.006,6,10,1547,5,764,1.0,496.0,496.0,5,783,1.0,515.0,515.0
0.067,6,10,1506,5,395,14.0,127.0,127.0,5,1111,13.0,843.0,843.0
0.005,6,10,2007,5,928,1.0,660.0,660.0,5,1079,1.0,811.0,811.0
0.087,6,10,1506,5,395,18.0,127.0,127.0,5,1111,19.0,843.0,843.0
0.013,6,10,1677,5,827,3.0,559.0,559.0,5,850,3.0,582.0,582.0
0.021,6,10,1989,5,910,5.0,642.0,642.0,5,1079,5.0,811.0,811.0
0.007,6,10,1983,5,910,1.0,642.0,642.0,5,1073,1.0,805.0,805.0
0.036,17,2,152,1,76,0.0,48.0,48.0,1,76,0.0,48.0,48.0
0.009,6,10,1989,5,910,2.0,642.0,642.0,5,1079,2.0,811.0,811.0
0.004,17,4,284,2,120,0.0,32.0,32.0,2,164,0.0,60.0,54.0
0.103,6,10,1506,5,395,23.0,127.0,127.0,5,1111,25.0,843.0,843.0
0.04,17,2,148,1,60,0.0,32.0,32.0,1,88,0.0,60.0,60.0
246.919,6,21,4752,8,923,17.0,238.0,166.0,13,3829,20576.0,1402.0,786.0
0.007,6,10,1547,5,764,1.0,496.0,496.0,5,783,1.0,515.0,515.0
0.01,6,10,1972,5,910,2.0,642.0,642.0,5,1062,2.0,794.0,794.0
309.608,17,20,1124,10,716,34386.0,48.0,43.0,10,408,34385.0,20.0,12.0
0.12,6,10,1506,5,395,26.0,127.0,127.0,5,1111,25.0,843.0,843.0
0.006,6,10,1643,5,860,1.0,592.0,592.0,5,783,1.0,515.0,515.0
15.075,17,15,9238,8,6902,2149.0,1350.0,834.0,7,2336,2507.0,1350.0,305.0
0.006,6,10,1643,5,860,1.0,592.0,592.0,5,783,1.0,515.0,515.0
0.045,6,10,1972,5,910,11.0,642.0,642.0,5,1062,11.0,794.0,794.0
0.122,6,10,1506,5,395,29.0,127.0,127.0,5,1111,25.0,843.0,843.0
0.005,6,10,2006,5,927,1.0,659.0,659.0,5,1079,1.0,811.0,811.0
0.005,6,10,1689,5,839,1.0,571.0,571.0,5,850,1.0,582.0,582.0
0.01,6,10,1983,5,910,2.0,642.0,642.0,5,1073,2.0,805.0,805.0
0.014,6,10,1990,5,911,3.0,643.0,643.0,5,1079,3.0,811.0,811.0
0.007,6,13,3735,7,497,1.0,125.0,125.0,6,3238,1.0,1470.0,1459.0
0.008,6,10,1990,5,911,2.0,643.0,643.0,5,1079,2.0,811.0,811.0
0.012,6,10,1972,5,910,3.0,642.0,642.0,5,1062,2.0,794.0,794.0
0.001,17,2,136,1,60,0.0,32.0,32.0,1,76,0.0,48.0,48.0
0.005,17,2,144,1,64,0.0,36.0,36.0,1,80,0.0,52.0,52.0
0.004,6,10,2006,5,927,1.0,659.0,659.0,5,1079,1.0,811.0,811.0
0.077,6,10,1506,5,395,16.0,127.0,127.0,5,1111,18.0,843.0,843.0
0.113,6,10,1506,5,395,24.0,127.0,127.0,5,1111,23.0,843.0,843.0
11.171,17,28,4423,14,1995,846.0,270.0,114.0,14,2428,846.0,587.0,145.0
11.141,17,28,4422,14,1994,844.0,269.0,114.0,14,2428,844.0,587.0,145.0
0.012,6,14,3787,7,497,1.0,125.0,125.0,7,3290,1.0,1448.0,972.0
0.006,6,10,1547,5,764,1.0,496.0,496.0,5,783,1.0,515.0,515.0
0.005,6,10,1779,5,928,1.0,660.0,660.0,5,851,1.0,583.0,583.0
0.005,6,10,1774,5,923,1.0,655.0,655.0,5,851,1.0,583.0,583.0
40.079,17,10,676,5,460,10018.0,104.0,64.0,5,216,10018.0,20.0,15.0
0.005,6,13,3747,7,509,0.0,137.0,137.0,6,3238,1.0,1470.0,1459.0
0.016,6,10,1983,5,910,4.0,642.0,642.0,5,1073,4.0,805.0,805.0
0.005,6,10,1689,5,839,1.0,571.0,571.0,5,850,1.0,582.0,582.0
0.004,17,4,284,2,120,0.0,32.0,32.0,2,164,1.0,60.0,54.0
0.086,6,10,1506,5,395,19.0,127.0,127.0,5,1111,18.0,843.0,843.0
0.012,6,10,1990,5,911,2.0,643.0,643.0,5,1079,2.0,811.0,811.0
30.484,6,56,35080,30,2986,1051.0,517.0,280.0,26,32094,1219.0,2804.0,1462.0
0.008,17,2,160,1,72,0.0,44.0,44.0,1,88,0.0,60.0,60.0
1756.191,6,105,6240,60,3510,29765.0,26.0,26.0,45,2730,39912.0,26.0,26.0
0.013,17,2,152,1,56,0.0,28.0,28.0,1,96,0.0,68.0,68.0
366.019,6,22,2313,16,867,24401.0,195.0,195.0,6,1446,4638.0,419.0,398.0
0.082,6,10,1506,5,395,17.0,127.0,127.0,5,1111,17.0,843.0,843.0
0.005,17,2,164,1,74,0.0,46.0,46.0,1,90,0.0,62.0,62.0
0.005,6,10,2006,5,927,1.0,659.0,659.0,5,1079,1.0,811.0,811.0
11.221,17,28,4418,14,1994,850.0,269.0,114.0,14,2424,850.0,587.0,145.0
0.258,17,16,8391,8,5989,36.0,1350.0,720.0,8,2402,24.0,1350.0,272.0
0.001,17,2,180,1,66,0.0,38.0,38.0,1,114,0.0,86.0,86.0
0.009,6,10,1989,5,910,2.0,642.0,642.0,5,1079,2.0,811.0,811.0
1786.482,6,150,19350,90,13740,20072.0,302.0,302.0,60,5610,30279.0,83.0,83.0
0.078,6,10,1506,5,395,18.0,127.0,127.0,5,1111,19.0,843.0,843.0
0.005,17,2,209,1,64,0.0,36.0,36.0,1,145,0.0,117.0,117.0
0.008,6,10,1989,5,910,2.0,642.0,642.0,5,1079,1.0,811.0,811.0
0.01,6,14,3868,7,578,1.0,206.0,206.0,7,3290,1.0,1448.0,972.0
0.075,6,10,1506,5,395,15.0,127.0,127.0,5,1111,16.0,843.0,843.0
0.01,6,10,1677,5,827,2.0,559.0,559.0,5,850,2.0,582.0,582.0
0.012,6,10,1989,5,910,2.0,642.0,642.0,5,1079,2.0,811.0,811.0
0.005,6,10,1643,5,860,1.0,592.0,592.0,5,783,1.0,515.0,515.0
0.006,17,2,194,1,59,0.0,31.0,31.0,1,135,0.0,107.0,107.0
40.064,17,10,676,5,460,10013.0,104.0,64.0,5,216,10015.0,20.0,15.0
0.01,6,10,1989,5,910,2.0,642.0,642.0,5,1079,2.0,811.0,811.0
0.003,17,2,148,1,60,0.0,32.0,32.0,1,88,0.0,60.0,60.0
0.077,6,10,1506,5,395,17.0,127.0,127.0,5,1111,17.0,843.0,843.0
308.409,17,20,1124,10,716,34252.0,48.0,43.0,10,408,34252.0,20.0,12.0
0.125,6,10,1506,5,395,29.0,127.0,127.0,5,1111,25.0,843.0,843.0
0.003,17,2,186,1,61,0.0,33.0,33.0,1,125,0.0,97.0,97.0
0.006,6,10,2000,5,927,1.0,659.0,659.0,5,1073,1.0,805.0,805.0
0.187,6,12,2996,7,549,31.0,177.0,177.0,5,2447,44.0,1402.0,1089.0
15.072,17,15,9238,8,6902,2149.0,1350.0,834.0,7,2336,2506.0,1350.0,305.0
0.005,6,10,2007,5,928,1.0,660.0,660.0,5,1079,1.0,811.0,811.0
0.085,6,10,1506,5,395,19.0,127.0,127.0,5,1111,17.0,843.0,843.0
0.007,17,2,164,1,74,0.0,46.0,46.0,1,90,0.0,62.0,62.0
0.004,6,10,2007,5,928,1.0,660.0,660.0,5,1079,1.0,811.0,811.0
0.021,6,10,1762,5,911,5.0,643.0,643.0,5,851,5.0,583.0,583.0
0.012,6,10,1989,5,910,2.0,642.0,642.0,5,1079,2.0,811.0,811.0
0.013,6,10,1990,5,911,3.0,643.0,643.0,5,1079,3.0,811.0,811.0
0.068,17,8,3613,4,1874,22.0,1350.0,440.0,4,1739,11.0,1350.0,406.0
0.006,6,10,1547,5,764,1.0,496.0,496.0,5,783,1.0,515.0,515.0
0.004,17,2,148,1,60,0.0,32.0,32.0,1,88,0.0,60.0,60.0
308.751,17,18,1008,9,640,38578.0,48.0,43.0,9,368,38578.0,20.0,12.0
0.017,6,10,1677,5,827,4.0,559.0,559.0,5,850,4.0,582.0,582.0
0.062,6,10,1506,5,395,14.0,127.0,127.0,5,1111,12.0,843.0,843.0
300.118,6,11,1271,6,610,60017.0,290.0,290.0,5,661,75021.0,393.0,393.0
0.172,6,10,1506,5,395,40.0,127.0,127.0,5,1111,32.0,843.0,843.0
0.136,6,10,1506,5,395,33.0,127.0,127.0,5,1111,32.0,843.0,843.0
300.354,6,16,2170,9,684,37522.0,146.0,146.0,7,1486,50030.0,419.0,398.0
0.014,6,10,1983,5,910,3.0,642.0,642.0,5,1073,3.0,805.0,805.0
0.006,17,2,230,1,68,0.0,40.0,40.0,1,162,0.0,134.0,134.0
0.009,6,10,1972,5,910,2.0,642.0,642.0,5,1062,2.0,794.0,794.0
0.11,6,10,1506,5,395,24.0,127.0,127.0,5,1111,21.0,843.0,843.0
0.005,6,10,2007,5,928,1.0,660.0,660.0,5,1079,1.0,811.0,811.0
0.173,6,10,1506,5,395,41.0,127.0,127.0,5,1111,38.0,843.0,843.0
0.009,6,12,1926,6,1189,1.0,659.0,434.0,6,737,1.0,417.0,417.0
15.078,17,17,9218,9,7130,1881.0,1350.0,764.0,8,2088,2150.0,1350.0,233.0
40.06,17,10,676,5,460,10011.0,104.0,64.0,5,216,10014.0,20.0,15.0
0.013,6,10,1631,5,848,3.0,580.0,580.0,5,783,3.0,515.0,515.0
173.18,17,72,10192,36,2395,4947.0,44.0,38.0,36,7797,4947.0,239.0,188.0
0.009,6,10,1983,5,910,2.0,642.0,642.0,5,1073,2.0,805.0,805.0
0.005,6,10,2007,5,928,1.0,660.0,660.0,5,1079,1.0,811.0,811.0
0.005,6,10,2007,5,928,1.0,660.0,660.0,5,1079,1.0,811.0,811.0
0.006,6,10,1547,5,764,1.0,496.0,496.0,5,783,1.0,515.0,515.0
0.005,6,10,2006,5,927,1.0,659.0,659.0,5,1079,1.0,811.0,811.0
40.064,17,10,676,5,460,10014.0,104.0,64.0,5,216,10015.0,20.0,15.0
0.093,6,10,1506,5,395,18.0,127.0,127.0,5,1111,20.0,843.0,843.0
0.019,6,10,1983,5,910,4.0,642.0,642.0,5,1073,4.0,805.0,805.0
0.011,6,10,1989,5,910,2.0,642.0,642.0,5,1079,2.0,811.0,811.0
0.006,6,10,1547,5,764,1.0,496.0,496.0,5,783,1.0,515.0,515.0
150.57,58,4,288,3,216,75285.0,24.0,24.0,1,72,0.0,24.0,24.0
0.005,6,14,3799,7,509,0.0,137.0,137.0,7,3290,0.0,1448.0,972.0
0.078,6,10,1506,5,395,17.0,127.0,127.0,5,1111,17.0,843.0,843.0
0.001,17,2,180,1,66,0.0,38.0,38.0,1,114,0.0,86.0,86.0
0.006,17,2,148,1,60,0.0,32.0,32.0,1,88,0.0,60.0,60.0
0.005,6,10,2000,5,927,1.0,659.0,659.0,5,1073,1.0,805.0,805.0
0.009,6,10,1989,5,910,2.0,642.0,642.0,5,1079,2.0,811.0,811.0
0.013,6,10,1989,5,910,3.0,642.0,642.0,5,1079,3.0,811.0,811.0
0.004,6,10,2006,5,927,1.0,659.0,659.0,5,1079,1.0,811.0,811.0
71.42,6,27,10388,12,3961,6492.0,1579.0,835.0,15,6427,5092.0,2111.0,939.0
0.001,17,2,142,1,63,0.0,35.0,35.0,1,79,0.0,51.0,51.0
9.037,17,6,376,5,280,2259.0,28.0,28.0,1,96,0.0,68.0,68.0
0.005,6,10,1643,5,860,1.0,592.0,592.0,5,783,1.0,515.0,515.0
0.006,17,2,179,1,71,0.0,43.0,43.0,1,108,0.0,80.0,80.0
0.004,17,2,148,1,60,0.0,32.0,32.0,1,88,0.0,60.0,60.0
0.005,17,2,170,1,65,0.0,37.0,37.0,1,105,0.0,77.0,77.0
0.05,17,2,148,1,60,0.0,32.0,32.0,1,88,0.0,60.0,60.0
0.01,6,10,1972,5,910,2.0,642.0,642.0,5,1062,2.0,794.0,794.0
0.005,6,10,2000,5,927,1.0,659.0,659.0,5,1073,1.0,805.0,805.0
0.097,6,10,1506,5,395,21.0,127.0,127.0,5,1111,23.0,843.0,843.0
0.005,6,10,1989,5,927,1.0,659.0,659.0,5,1062,1.0,794.0,794.0
0.108,6,10,1506,5,395,23.0,127.0,127.0,5,1111,24.0,843.0,843.0
0.012,6,10,1972,5,910,3.0,642.0,642.0,5,1062,3.0,794.0,794.0
0.019,6,10,1990,5,911,4.0,643.0,643.0,5,1079,4.0,811.0,811.0
0.004,17,2,186,1,61,0.0,33.0,33.0,1,125,0.0,97.0,97.0
0.009,6,12,1926,6,1189,1.0,659.0,434.0,6,737,1.0,417.0,417.0
0.016,6,10,1631,5,848,3.0,580.0,580.0,5,783,3.0,515.0,515.0
1766.949,6,549,187316,280,162957,6333.0,2883.0,995.0,269,24359,6593.0,387.0,103.0
0.005,6,10,2000,5,927,1.0,659.0,659.0,5,1073,1.0,805.0,805.0
241.883,6,397,348321,189,21373,1286.0,2736.0,960.0,208,326948,1168.0,2804.0,1604.0
0.018,6,10,1990,5,911,4.0,643.0,643.0,5,1079,4.0,811.0,811.0
0.005,6,10,1547,5,764,1.0,496.0,496.0,5,783,1.0,515.0,515.0
0.005,17,2,230,1,68,0.0,40.0,40.0,1,162,0.0,134.0,134.0
11.212,17,28,4417,14,1993,854.0,268.0,114.0,14,2424,854.0,587.0,145.0
0.004,6,10,2000,5,927,1.0,659.0,659.0,5,1073,1.0,805.0,805.0
0.006,6,10,2000,5,927,1.0,659.0,659.0,5,1073,1.0,805.0,805.0
0.013,6,10,1989,5,910,3.0,642.0,642.0,5,1079,3.0,811.0,811.0
0.005,6,10,1854,5,889,1.0,621.0,621.0,5,965,1.0,697.0,697.0
0.003,17,2,148,1,60,0.0,32.0,32.0,1,88,0.0,60.0,60.0
0.006,6,10,1547,5,764,1.0,496.0,496.0,5,783,1.0,515.0,515.0
0.008,6,10,1990,5,911,2.0,643.0,643.0,5,1079,1.0,811.0,811.0
0.003,17,2,136,1,60,0.0,32.0,32.0,1,76,0.0,48.0,48.0
0.037,17,4,420,2,122,0.0,33.0,33.0,2,298,33.0,145.0,121.0
0.129,6,10,1506,5,395,31.0,127.0,127.0,5,1111,26.0,843.0,843.0
0.011,6,10,1677,5,827,2.0,559.0,559.0,5,850,2.0,582.0,582.0
0.005,6,10,2007,5,928,1.0,660.0,660.0,5,1079,1.0,811.0,811.0
0.004,17,2,148,1,60,0.0,32.0,32.0,1,88,0.0,60.0,60.0
0.006,6,12,1698,6,863,1.0,327.0,271.0,6,835,1.0,515.0,515.0
0.017,6,10,1989,5,910,4.0,642.0,642.0,5,1079,4.0,811.0,811.0
0.013,17,2,152,1,56,0.0,28.0,28.0,1,96,0.0,68.0,68.0
15.08,17,15,9238,8,6902,2150.0,1350.0,834.0,7,2336,2507.0,1350.0,305.0
0.004,6,10,2000,5,927,1.0,659.0,659.0,5,1073,1.0,805.0,805.0
0.017,6,10,1631,5,848,4.0,580.0,580.0,5,783,4.0,515.0,515.0
0.006,6,10,1547,5,764,1.0,496.0,496.0,5,783,1.0,515.0,515.0
0.008,6,10,1983,5,910,2.0,642.0,642.0,5,1073,2.0,805.0,805.0
0.004,6,10,1989,5,927,1.0,659.0,659.0,5,1062,1.0,794.0,794.0
0.006,6,10,1547,5,764,1.0,496.0,496.0,5,783,1.0,515.0,515.0
165.322,17,82,11567,41,2744,4132.0,44.0,38.0,41,8823,4132.0,239.0,187.0
0.005,6,14,3799,7,509,0.0,137.0,137.0,7,3290,0.0,1448.0,972.0
1798.736,6,288,40067,119,20746,15242.0,3299.0,175.0,169,19321,10705.0,1360.0,149.0
0.001,17,2,180,1,66,0.0,38.0,38.0,1,114,0.0,86.0,86.0
0.005,6,10,2007,5,928,1.0,660.0,660.0,5,1079,1.0,811.0,811.0
0.116,6,10,1506,5,395,24.0,127.0,127.0,5,1111,26.0,843.0,843.0
300.388,6,16,2170,9,684,37528.0,146.0,146.0,7,1486,50037.0,419.0,398.0
0.007,6,12,1698,6,863,1.0,327.0,271.0,6,835,1.0,515.0,515.0
0.005,6,10,1779,5,928,1.0,660.0,660.0,5,851,1.0,583.0,583.0
0.004,6,10,1989,5,927,1.0,659.0,659.0,5,1062,1.0,794.0,794.0
0.005,17,2,136,1,60,0.0,32.0,32.0,1,76,0.0,48.0,48.0
0.153,6,10,1506,5,395,36.0,127.0,127.0,5,1111,37.0,843.0,843.0
0.012,6,10,1972,5,910,2.0,642.0,642.0,5,1062,2.0,794.0,794.0
0.008,6,10,1989,5,910,2.0,642.0,642.0,5,1079,2.0,811.0,811.0
0.116,6,10,1506,5,395,27.0,127.0,127.0,5,1111,15.0,843.0,843.0
0.082,6,10,1506,5,395,18.0,127.0,127.0,5,1111,17.0,843.0,843.0
0.029,6,10,1972,5,910,7.0,642.0,642.0,5,1062,7.0,794.0,794.0
0.138,6,10,1506,5,395,33.0,127.0,127.0,5,1111,33.0,843.0,843.0
1778.826,17,144,45504,72,22752,25053.0,288.0,288.0,72,22752,25053.0,288.0,288.0
0.082,6,10,1506,5,395,19.0,127.0,127.0,5,1111,19.0,843.0,843.0
0.001,17,2,180,1,66,0.0,38.0,38.0,1,114,0.0,86.0,86.0
0.075,6,10,1506,5,395,15.0,127.0,127.0,5,1111,17.0,843.0,843.0
0.008,6,10,1983,5,910,2.0,642.0,642.0,5,1073,2.0,805.0,805.0
0.006,6,10,1689,5,839,1.0,571.0,571.0,5,850,1.0,582.0,582.0
0.005,6,10,1689,5,839,1.0,571.0,571.0,5,850,1.0,582.0,582.0
0.015,6,13,3735,7,497,2.0,125.0,125.0,6,3238,2.0,1470.0,1459.0
0.079,6,10,1506,5,395,18.0,127.0,127.0,5,1111,16.0,843.0,843.0
0.012,6,10,1631,5,848,3.0,580.0,580.0,5,783,2.0,515.0,515.0
15.071,17,15,9238,8,6902,2148.0,1350.0,834.0,7,2336,2507.0,1350.0,305.0
0.079,6,10,1506,5,395,18.0,127.0,127.0,5,1111,17.0,843.0,843.0
0.015,6,14,3787,7,497,2.0,125.0,125.0,7,3290,2.0,1448.0,972.0
0.004,6,10,1774,5,923,1.0,655.0,655.0,5,851,1.0,583.0,583.0
0.005,17,2,170,1,65,0.0,37.0,37.0,1,105,0.0,77.0,77.0
0.855,6,26,5499,11,1517,81.0,325.0,152.0,15,3982,53.0,1414.0,563.0
0.005,6,10,2006,5,927,1.0,659.0,659.0,5,1079,1.0,811.0,811.0
0.041,17,2,412,1,61,0.0,33.0,33.0,1,351,0.0,323.0,323.0
0.04,17,2,152,1,76,0.0,48.0,48.0,1,76,0.0,48.0,48.0
240.09,6,16,4482,9,963,30011.0,238.0,166.0,7,3519,40014.0,1402.0,786.0
0.005,6,10,2006,5,927,1.0,659.0,659.0,5,1079,1.0,811.0,811.0
0.003,17,2,136,1,60,0.0,32.0,32.0,1,76,0.0,48.0,48.0
0.021,6,10,1972,5,910,5.0,642.0,642.0,5,1062,5.0,794.0,794.0
0.072,6,10,1506,5,395,16.0,127.0,127.0,5,1111,15.0,843.0,843.0
0.015,6,10,1631,5,848,3.0,580.0,580.0,5,783,3.0,515.0,515.0
0.016,6,10,1989,5,910,3.0,642.0,642.0,5,1079,4.0,811.0,811.0
0.024,6,10,1989,5,910,6.0,642.0,642.0,5,1079,5.0,811.0,811.0
0.027,17,2,148,1,60,0.0,32.0,32.0,1,88,0.0,60.0,60.0
0.003,17,2,148,1,60,0.0,32.0,32.0,1,88,0.0,60.0,60.0
11.285,17,28,4423,14,1995,855.0,270.0,114.0,14,2428,855.0,587.0,145.0
0.006,17,2,166,1,75,0.0,47.0,47.0,1,91,0.0,63.0,63.0
1770.703,17,92,8096,46,4048,39348.0,60.0,60.0,46,4048,39348.0,60.0,60.0
0.416,17,63,46482,39,40408,10.0,1350.0,1008.0,24,6074,15.0,1350.0,225.0
0.006,6,10,1547,5,764,1.0,496.0,496.0,5,783,1.0,515.0,515.0
0.114,6,10,1506,5,395,24.0,127.0,127.0,5,1111,25.0,843.0,843.0
0.005,6,10,1989,5,927,1.0,659.0,659.0,5,1062,1.0,794.0,794.0
0.006,6,10,1643,5,860,1.0,592.0,592.0,5,783,1.0,515.0,515.0
0.066,6,10,1506,5,395,14.0,127.0,127.0,5,1111,16.0,843.0,843.0
0.172,17,2,152,1,76,0.0,48.0,48.0,1,76,0.0,48.0,48.0
308.505,17,20,1124,10,716,34264.0,48.0,43.0,10,408,34264.0,20.0,12.0
0.006,6,10,1689,5,839,1.0,571.0,571.0,5,850,1.0,582.0,582.0
0.004,17,2,136,1,60,0.0,32.0,32.0,1,76,0.0,48.0,48.0
0.003,17,2,148,1,60,0.0,32.0,32.0,1,88,0.0,60.0,60.0
0.005,6,10,2006,5,927,1.0,659.0,659.0,5,1079,1.0,811.0,811.0
0.005,6,10,1779,5,928,1.0,660.0,660.0,5,851,1.0,583.0,583.0
0.012,6,10,1762,5,911,2.0,643.0,643.0,5,851,3.0,583.0,583.0
0.006,6,10,1854,5,889,1.0,621.0,621.0,5,965,1.0,697.0,697.0
0.118,6,10,1506,5,395,23.0,127.0,127.0,5,1111,27.0,843.0,843.0
0.005,6,10,2007,5,928,1.0,660.0,660.0,5,1079,1.0,811.0,811.0
0.073,6,21,9959,11,8734,7.0,2883.0,1166.0,10,1225,7.0,340.0,117.0
40.063,17,10,676,5,460,10014.0,104.0,64.0,5,216,10014.0,20.0,15.0
0.005,6,13,3690,7,452,0.0,80.0,80.0,6,3238,0.0,1470.0,1459.0
0.007,17,2,194,1,59,0.0,31.0,31.0,1,135,0.0,107.0,107.0
0.005,6,10,1989,5,927,1.0,659.0,659.0,5,1062,1.0,794.0,794.0
0.015,6,10,1990,5,911,3.0,643.0,643.0,5,1079,3.0,811.0,811.0
0.005,6,10,2006,5,927,1.0,659.0,659.0,5,1079,1.0,811.0,811.0
0.012,6,10,1983,5,910,3.0,642.0,642.0,5,1073,3.0,805.0,805.0
0.102,6,10,1506,5,395,22.0,127.0,127.0,5,1111,21.0,843.0,843.0
0.064,6,10,1506,5,395,14.0,127.0,127.0,5,1111,15.0,843.0,843.0
0.091,6,10,1506,5,395,18.0,127.0,127.0,5,1111,21.0,843.0,843.0
0.004,6,10,1702,5,863,1.0,595.0,595.0,5,839,0.0,571.0,571.0
0.004,17,2,136,1,60,0.0,32.0,32.0,1,76,0.0,48.0,48.0
0.006,6,10,1547,5,764,1.0,496.0,496.0,5,783,1.0,515.0,515.0
0.086,6,10,1506,5,395,18.0,127.0,127.0,5,1111,17.0,843.0,843.0
0.005,6,10,2007,5,928,1.0,660.0,660.0,5,1079,1.0,811.0,811.0
10.81,17,28,4423,14,1995,823.0,270.0,114.0,14,2428,823.0,587.0,145.0
0.111,6,10,1506,5,395,24.0,127.0,127.0,5,1111,27.0,843.0,843.0
40.07,17,10,676,5,460,10016.0,104.0,64.0,5,216,10016.0,20.0,15.0
0.006,6,10,1643,5,860,1.0,592.0,592.0,5,783,1.0,515.0,515.0
0.003,17,2,148,1,60,0.0,32.0,32.0,1,88,0.0,60.0,60.0
0.005,6,14,3742,7,452,0.0,80.0,80.0,7,3290,0.0,1448.0,972.0
0.009,6,10,1972,5,910,2.0,642.0,642.0,5,1062,2.0,794.0,794.0
0.039,17,2,412,1,61,0.0,33.0,33.0,1,351,0.0,323.0,323.0
311.295,17,20,1124,10,716,34573.0,48.0,43.0,10,408,34573.0,20.0,12.0
0.005,17,2,170,1,65,0.0,37.0,37.0,1,105,0.0,77.0,77.0
240.138,6,31,9296,15,6944,17152.0,2070.0,685.0,16,2352,16009.0,580.0,189.0
0.011,6,10,1983,5,910,2.0,642.0,642.0,5,1073,2.0,805.0,805.0
0.092,6,10,1506,5,395,21.0,127.0,127.0,5,1111,20.0,843.0,843.0
0.013,6,14,3787,7,497,2.0,125.0,125.0,7,3290,2.0,1448.0,972.0
0.005,6,10,2006,5,927,1.0,659.0,659.0,5,1079,1.0,811.0,811.0
0.038,17,4,420,2,122,0.0,33.0,33.0,2,298,34.0,145.0,121.0
0.02,6,10,1989,5,910,5.0,642.0,642.0,5,1079,4.0,811.0,811.0
0.167,17,2,152,1,76,0.0,48.0,48.0,1,76,0.0,48.0,48.0
0.005,6,14,3799,7,509,0.0,137.0,137.0,7,3290,0.0,1448.0,972.0
0.073,6,10,1506,5,395,16.0,127.0,127.0,5,1111,15.0,843.0,843.0
15.076,17,14,9191,8,6902,2149.0,1350.0,834.0,6,2289,3009.0,1350.0,353.0
0.006,17,2,170,1,65,0.0,37.0,37.0,1,105,0.0,77.0,77.0
356.672,6,21,1795,16,1030,23778.0,190.0,190.0,5,765,60002.0,464.0,248.0
0.005,6,10,1989,5,927,1.0,659.0,659.0,5,1062,1.0,794.0,794.0
10.803,17,28,4422,14,1994,822.0,269.0,114.0,14,2428,822.0,587.0,145.0
0.005,6,10,2006,5,927,1.0,659.0,659.0,5,1079,1.0,811.0,811.0
0.009,17,2,152,1,76,0.0,48.0,48.0,1,76,0.0,48.0,48.0
0.018,6,10,1989,5,910,4.0,642.0,642.0,5,1079,4.0,811.0,811.0
0.008,6,10,1972,5,910,2.0,642.0,642.0,5,1062,2.0,794.0,794.0
0.089,6,10,1506,5,395,19.0,127.0,127.0,5,1111,20.0,843.0,843.0
0.005,17,2,166,1,75,0.0,47.0,47.0,1,91,0.0,63.0,63.0
0.038,17,2,152,1,76,0.0,48.0,48.0,1,76,0.0,48.0,48.0
0.081,6,10,1506,5,395,17.0,127.0,127.0,5,1111,19.0,843.0,843.0
40.053,17,10,676,5,460,10012.0,104.0,64.0,5,216,10012.0,20.0,15.0
240.074,6,20,4873,10,889,26674.0,180.0,93.0,10,3984,26674.0,1592.0,576.0
0.061,6,10,1506,5,395,13.0,127.0,127.0,5,1111,13.0,843.0,843.0
0.008,17,2,194,1,59,0.0,31.0,31.0,1,135,0.0,107.0,107.0
0.037,17,4,284,2,120,0.0,32.0,32.0,2,164,33.0,60.0,54.0
0.003,17,4,284,2,120,0.0,32.0,32.0,2,164,0.0,60.0,54.0
0.071,6,10,1506,5,395,15.0,127.0,127.0,5,1111,16.0,843.0,843.0
0.004,17,4,284,2,120,0.0,32.0,32.0,2,164,0.0,60.0,54.0
0.007,6,14,3799,7,509,1.0,137.0,137.0,7,3290,1.0,1448.0,972.0
0.1,6,10,1506,5,395,22.0,127.0,127.0,5,1111,23.0,843.0,843.0
0.001,17,2,166,1,75,0.0,47.0,47.0,1,91,0.0,63.0,63.0
0.005,6,10,2006,5,927,1.0,659.0,659.0,5,1079,1.0,811.0,811.0
0.016,6,10,1989,5,910,3.0,642.0,642.0,5,1079,3.0,811.0,811.0
300.342,6,16,2170,9,684,37521.0,146.0,146.0,7,1486,50029.0,419.0,398.0
0.116,6,10,1506,5,395,26.0,127.0,127.0,5,1111,27.0,843.0,843.0
0.001,17,2,180,1,66,0.0,38.0,38.0,1,114,0.0,86.0,86.0
0.01,6,10,1972,5,910,2.0,642.0,642.0,5,1062,2.0,794.0,794.0
0.078,6,10,1506,5,395,16.0,127.0,127.0,5,1111,17.0,843.0,843.0
0.067,6,10,1506,5,395,13.0,127.0,127.0,5,1111,15.0,843.0,843.0
40.071,17,10,676,5,460,10016.0,104.0,64.0,5,216,10016.0,20.0,15.0
178.23,17,78,11183,39,2609,4690.0,44.0,38.0,39,8574,4689.0,239.0,191.0
0.01,6,10,1972,5,910,2.0,642.0,642.0,5,1062,2.0,794.0,794.0
0.014,6,10,1677,5,827,3.0,559.0,559.0,5,850,3.0,582.0,582.0
0.006,6,10,1689,5,839,1.0,571.0,571.0,5,850,1.0,582.0,582.0
0.014,6,10,1972,5,910,3.0,642.0,642.0,5,1062,3.0,794.0,794.0
0.005,6,10,2007,5,928,1.0,660.0,660.0,5,1079,1.0,811.0,811.0
0.011,6,10,1631,5,848,2.0,580.0,580.0,5,783,2.0,515.0,515.0
241.918,6,395,348354,189,21359,1286.0,2736.0,960.0,206,326995,1180.0,2804.0,1613.0
0.067,6,10,1506,5,395,15.0,127.0,127.0,5,1111,15.0,843.0,843.0
240.529,6,34,8689,18,1891,14146.0,572.0,189.0,16,6798,16032.0,1402.0,597.0
0.006,6,10,1689,5,839,1.0,571.0,571.0,5,850,1.0,582.0,582.0
0.012,6,10,1762,5,911,3.0,643.0,643.0,5,851,2.0,583.0,583.0
0.008,6,10,1990,5,911,1.0,643.0,643.0,5,1079,2.0,811.0,811.0
0.017,6,10,1990,5,911,4.0,643.0,643.0,5,1079,4.0,811.0,811.0
177.133,17,72,10139,36,2394,5060.0,44.0,38.0,36,7745,5060.0,261.0,187.0
0.027,6,10,1990,5,911,6.0,643.0,643.0,5,1079,6.0,811.0,811.0
0.068,6,10,1506,5,395,15.0,127.0,127.0,5,1111,15.0,843.0,843.0
0.012,6,10,1989,5,910,3.0,642.0,642.0,5,1079,3.0,811.0,811.0
0.043,6,10,1989,5,910,10.0,642.0,642.0,5,1079,10.0,811.0,811.0
0.004,6,10,2000,5,927,1.0,659.0,659.0,5,1073,1.0,805.0,805.0
0.004,6,10,2006,5,927,1.0,659.0,659.0,5,1079,1.0,811.0,811.0
240.381,6,33,9304,16,1835,16024.0,623.0,199.0,17,7469,15023.0,1402.0,599.0
309.391,17,20,1124,10,716,34362.0,48.0,43.0,10,408,34362.0,20.0,12.0
0.024,6,10,1990,5,911,6.0,643.0,643.0,5,1079,5.0,811.0,811.0
173.461,17,82,11597,41,2736,4336.0,44.0,38.0,41,8861,4336.0,239.0,188.0
0.004,17,4,284,2,120,0.0,32.0,32.0,2,164,0.0,60.0,54.0
0.081,6,10,1506,5,395,18.0,127.0,127.0,5,1111,17.0,843.0,843.0
0.001,17,2,180,1,66,0.0,38.0,38.0,1,114,0.0,86.0,86.0
308.523,17,20,1124,10,716,34267.0,48.0,43.0,10,408,34267.0,20.0,12.0
0.005,6,13,3747,7,509,0.0,137.0,137.0,6,3238,1.0,1470.0,1459.0
0.011,6,10,1677,5,827,2.0,559.0,559.0,5,850,2.0,582.0,582.0
0.012,6,10,1972,5,910,2.0,642.0,642.0,5,1062,3.0,794.0,794.0
0.006,6,10,1547,5,764,1.0,496.0,496.0,5,783,1.0,515.0,515.0
0.037,17,2,156,1,64,0.0,36.0,36.0,1,92,0.0,64.0,64.0
0.005,6,10,2007,5,928,1.0,660.0,660.0,5,1079,1.0,811.0,811.0
1770.472,6,84,4420,42,2210,43181.0,26.0,26.0,42,2210,43181.0,26.0,26.0
0.01,17,2,179,1,71,0.0,43.0,43.0,1,108,0.0,80.0,80.0
0.008,17,2,179,1,71,0.0,43.0,43.0,1,108,0.0,80.0,80.0
0.073,6,10,1506,5,395,16.0,127.0,127.0,5,1111,16.0,843.0,843.0
0.088,6,10,1506,5,395,20.0,127.0,127.0,5,1111,18.0,843.0,843.0
0.006,6,10,1854,5,889,1.0,621.0,621.0,5,965,1.0,697.0,697.0
0.105,6,10,1506,5,395,19.0,127.0,127.0,5,1111,23.0,843.0,843.0
0.165,17,2,152,1,76,0.0,48.0,48.0,1,76,0.0,48.0,48.0
176.539,17,98,13841,49,3274,3677.0,44.0,38.0,49,10567,3677.0,239.0,187.0
0.006,6,10,1547,5,764,1.0,496.0,496.0,5,783,1.0,515.0,515.0
40.067,17,10,676,5,460,10016.0,104.0,64.0,5,216,10016.0,20.0,15.0
0.005,6,10,2006,5,927,1.0,659.0,659.0,5,1079,1.0,811.0,811.0
40.06,17,10,676,5,460,10014.0,104.0,64.0,5,216,10014.0,20.0,15.0
0.052,17,2,152,1,76,0.0,48.0,48.0,1,76,0.0,48.0,48.0
40.071,17,10,676,5,460,10014.0,104.0,64.0,5,216,10016.0,20.0,15.0
0.013,6,10,1989,5,910,3.0,642.0,642.0,5,1079,3.0,811.0,811.0
0.117,6,10,1506,5,395,28.0,127.0,127.0,5,1111,23.0,843.0,843.0
0.01,6,13,3735,7,497,1.0,125.0,125.0,6,3238,1.0,1470.0,1459.0
308.631,17,20,1124,10,716,34277.0,48.0,43.0,10,408,34277.0,20.0,12.0
0.081,6,10,1506,5,395,18.0,127.0,127.0,5,1111,15.0,843.0,843.0
0.014,6,10,1689,5,839,3.0,571.0,571.0,5,850,3.0,582.0,582.0
0.005,6,10,2006,5,927,1.0,659.0,659.0,5,1079,1.0,811.0,811.0
293.137,6,403,348292,195,21708,1511.0,2736.0,889.0,208,326584,1416.0,2804.0,1627.0
0.019,6,13,3735,7,497,3.0,125.0,125.0,6,3238,3.0,1470.0,1459.0
0.072,6,10,1506,5,395,15.0,127.0,127.0,5,1111,16.0,843.0,843.0
0.006,6,10,1989,5,927,1.0,659.0,659.0,5,1062,1.0,794.0,794.0
10.803,17,28,4421,14,1994,822.0,269.0,114.0,14,2427,822.0,586.0,145.0
0.082,6,10,1506,5,395,18.0,127.0,127.0,5,1111,16.0,843.0,843.0
0.043,17,2,144,1,64,0.0,36.0,36.0,1,80,0.0,52.0,52.0
0.005,17,2,170,1,65,0.0,37.0,37.0,1,105,0.0,77.0,77.0
0.072,17,2,148,1,60,0.0,32.0,32.0,1,88,0.0,60.0,60.0
40.057,17,10,676,5,460,10013.0,104.0,64.0,5,216,10013.0,20.0,15.0
0.013,6,10,1989,5,910,3.0,642.0,642.0,5,1079,3.0,811.0,811.0
15.376,17,41,20243,22,17096,730.0,1350.0,749.0,19,3147,852.0,1350.0,137.0
0.109,6,10,1506,5,395,23.0,127.0,127.0,5,1111,23.0,843.0,843.0
0.013,6,10,1631,5,848,3.0,580.0,580.0,5,783,3.0,515.0,515.0
0.076,6,10,1506,5,395,17.0,127.0,127.0,5,1111,18.0,843.0,843.0
0.016,6,10,1677,5,827,4.0,559.0,559.0,5,850,3.0,582.0,582.0
40.057,17,10,676,5,460,10010.0,104.0,64.0,5,216,10013.0,20.0,15.0
0.005,6,10,1702,5,863,1.0,595.0,595.0,5,839,1.0,571.0,571.0
0.008,17,2,194,1,59,0.0,31.0,31.0,1,135,0.0,107.0,107.0
0.008,6,10,1762,5,911,1.0,643.0,643.0,5,851,2.0,583.0,583.0
0.005,6,13,3747,7,509,0.0,137.0,137.0,6,3238,0.0,1470.0,1459.0
0.016,6,10,1990,5,911,4.0,643.0,643.0,5,1079,4.0,811.0,811.0
0.006,6,12,1698,6,863,1.0,327.0,271.0,6,835,1.0,515.0,515.0
0.095,6,10,1506,5,395,21.0,127.0,127.0,5,1111,14.0,843.0,843.0
40.076,17,10,676,5,460,10015.0,104.0,64.0,5,216,10017.0,20.0,15.0
0.004,6,10,2006,5,927,1.0,659.0,659.0,5,1079,1.0,811.0,811.0
0.001,17,2,142,1,63,0.0,35.0,35.0,1,79,0.0,51.0,51.0
0.01,6,10,1972,5,910,2.0,642.0,642.0,5,1062,2.0,794.0,794.0
0.006,6,10,1989,5,927,1.0,659.0,659.0,5,1062,1.0,794.0,794.0
0.069,6,10,1506,5,395,15.0,127.0,127.0,5,1111,16.0,843.0,843.0
0.043,17,2,152,1,76,0.0,48.0,48.0,1,76,0.0,48.0,48.0
0.005,6,10,1989,5,927,1.0,659.0,659.0,5,1062,1.0,794.0,794.0
0.003,17,2,142,1,63,0.0,35.0,35.0,1,79,0.0,51.0,51.0
10.824,17,28,4422,14,1994,823.0,269.0,114.0,14,2428,823.0,587.0,145.0
0.009,6,10,2006,5,927,2.0,659.0,659.0,5,1079,2.0,811.0,811.0
0.022,6,10,1990,5,911,5.0,643.0,643.0,5,1079,5.0,811.0,811.0
0.087,6,10,1506,5,395,20.0,127.0,127.0,5,1111,17.0,843.0,843.0
0.013,6,10,1677,5,827,3.0,559.0,559.0,5,850,3.0,582.0,582.0
0.004,6,10,1774,5,923,1.0,655.0,655.0,5,851,1.0,583.0,583.0
10.765,17,28,4418,14,1994,819.0,269.0,114.0,14,2424,819.0,587.0,145.0
0.006,6,10,1854,5,889,1.0,621.0,621.0,5,965,1.0,697.0,697.0
300.358,6,16,2170,9,684,37523.0,146.0,146.0,7,1486,50031.0,419.0,398.0
40.053,17,10,676,5,460,10011.0,104.0,64.0,5,216,10012.0,20.0,15.0
0.064,6,10,1506,5,395,13.0,127.0,127.0,5,1111,14.0,843.0,843.0
0.11,6,10,1506,5,395,23.0,127.0,127.0,5,1111,25.0,843.0,843.0
0.005,17,2,160,1,72,0.0,44.0,44.0,1,88,0.0,60.0,60.0
0.005,6,10,2006,5,927,1.0,659.0,659.0,5,1079,1.0,811.0,811.0
0.013,17,4,284,2,120,0.0,32.0,32.0,2,164,1.0,60.0,54.0
0.015,6,10,1989,5,910,3.0,642.0,642.0,5,1079,3.0,811.0,811.0
0.006,6,10,1854,5,889,1.0,621.0,621.0,5,965,1.0,697.0,697.0
0.127,6,10,1506,5,395,30.0,127.0,127.0,5,1111,28.0,843.0,843.0
0.004,6,10,1989,5,927,1.0,659.0,659.0,5,1062,1.0,794.0,794.0
0.002,17,2,180,1,66,0.0,38.0,38.0,1,114,0.0,86.0,86.0
0.005,17,2,214,1,75,0.0,47.0,47.0,1,139,0.0,111.0,111.0
0.089,6,10,1506,5,395,20.0,127.0,127.0,5,1111,19.0,843.0,843.0
0.005,6,10,1774,5,923,1.0,655.0,655.0,5,851,1.0,583.0,583.0
0.004,6,10,1702,5,863,1.0,595.0,595.0,5,839,0.0,571.0,571.0
300.333,6,16,2170,9,684,37521.0,146.0,146.0,7,1486,50026.0,419.0,398.0
0.014,6,10,1631,5,848,3.0,580.0,580.0,5,783,3.0,515.0,515.0
0.164,6,10,1506,5,395,37.0,127.0,127.0,5,1111,35.0,843.0,843.0
0.001,17,2,180,1,66,0.0,38.0,38.0,1,114,0.0,86.0,86.0
0.016,6,10,1983,5,910,4.0,642.0,642.0,5,1073,4.0,805.0,805.0
0.01,17,4,284,2,120,7.0,32.0,32.0,2,164,7.0,60.0,54.0
0.013,6,10,1677,5,827,3.0,559.0,559.0,5,850,3.0,582.0,582.0
0.005,6,10,1689,5,839,1.0,571.0,571.0,5,850,1.0,582.0,582.0
0.107,6,10,1506,5,395,24.0,127.0,127.0,5,1111,24.0,843.0,843.0
0.007,17,2,162,1,65,0.0,37.0,37.0,1,97,0.0,69.0,69.0
0.06,6,10,1506,5,395,13.0,127.0,127.0,5,1111,14.0,843.0,843.0
0.006,6,10,1547,5,764,1.0,496.0,496.0,5,783,1.0,515.0,515.0
0.065,6,10,1506,5,395,14.0,127.0,127.0,5,1111,15.0,843.0,843.0
0.112,6,10,1506,5,395,26.0,127.0,127.0,5,1111,23.0,843.0,843.0
0.015,6,10,1989,5,910,3.0,642.0,642.0,5,1079,3.0,811.0,811.0
0.068,6,10,1506,5,395,13.0,127.0,127.0,5,1111,15.0,843.0,843.0
0.004,6,10,1989,5,927,1.0,659.0,659.0,5,1062,1.0,794.0,794.0
40.07,17,10,676,5,460,10014.0,104.0,64.0,5,216,10016.0,20.0,15.0
0.006,17,2,293,1,73,0.0,45.0,45.0,1,220,0.0,192.0,192.0
0.013,6,10,1972,5,910,3.0,642.0,642.0,5,1062,3.0,794.0,794.0
0.022,6,13,3913,7,495,3.0,123.0,123.0,6,3418,4.0,1650.0,1549.0
0.005,6,14,3799,7,509,0.0,137.0,137.0,7,3290,0.0,1448.0,972.0
0.005,6,10,1779,5,928,1.0,660.0,660.0,5,851,1.0,583.0,583.0
0.093,6,10,1506,5,395,18.0,127.0,127.0,5,1111,20.0,843.0,843.0
0.0,17,2,136,1,60,0.0,32.0,32.0,1,76,0.0,48.0,48.0
240.089,6,16,4480,9,963,30011.0,238.0,166.0,7,3517,40014.0,1402.0,786.0
0.009,6,10,1989,5,910,2.0,642.0,642.0,5,1079,2.0,811.0,811.0
0.008,6,12,1698,6,863,1.0,327.0,271.0,6,835,1.0,515.0,515.0
0.005,6,10,2007,5,928,1.0,660.0,660.0,5,1079,1.0,811.0,811.0
0.12,6,10,1506,5,395,27.0,127.0,127.0,5,1111,29.0,843.0,843.0
0.014,6,10,1983,5,910,3.0,642.0,642.0,5,1073,3.0,805.0,805.0
0.005,6,10,2007,5,928,1.0,660.0,660.0,5,1079,1.0,811.0,811.0
1.027,6,30,12711,17,3312,64.0,1360.0,517.0,13,9399,71.0,2720.0,985.0
0.044,6,14,3787,8,549,6.0,125.0,125.0,6,3238,8.0,1470.0,1459.0
0.005,6,10,1643,5,860,1.0,592.0,592.0,5,783,1.0,515.0,515.0
0.006,6,10,1854,5,889,1.0,621.0,621.0,5,965,1.0,697.0,697.0
0.006,17,2,225,1,65,0.0,37.0,37.0,1,160,0.0,132.0,132.0
0.005,6,10,1989,5,927,1.0,659.0,659.0,5,1062,1.0,794.0,794.0
308.379,17,20,1124,10,716,34256.0,48.0,43.0,10,408,34257.0,20.0,12.0
0.015,6,10,1990,5,911,3.0,643.0,643.0,5,1079,3.0,811.0,811.0
0.005,17,2,144,1,64,0.0,36.0,36.0,1,80,0.0,52.0,52.0
0.071,6,10,1506,5,395,17.0,127.0,127.0,5,1111,15.0,843.0,843.0
0.006,6,10,1547,5,764,1.0,496.0,496.0,5,783,1.0,515.0,515.0
0.1,6,10,1506,5,395,22.0,127.0,127.0,5,1111,21.0,843.0,843.0
0.005,17,2,166,1,75,0.0,47.0,47.0,1,91,0.0,63.0,63.0
0.008,6,10,1762,5,911,2.0,643.0,643.0,5,851,2.0,583.0,583.0
240.537,6,35,8925,18,2072,14148.0,693.0,225.0,17,6853,15031.0,1402.0,597.0
0.01,6,13,3735,7,497,1.0,125.0,125.0,6,3238,1.0,1470.0,1459.0
0.005,6,10,1689,5,839,1.0,571.0,571.0,5,850,1.0,582.0,582.0
0.83,6,10,1816,6,1462,166.0,1210.0,1210.0,4,354,188.0,182.0,182.0
0.005,6,10,2000,5,927,1.0,659.0,659.0,5,1073,1.0,805.0,805.0
0.019,17,2,168,1,76,0.0,48.0,48.0,1,92,0.0,64.0,64.0
0.013,6,10,1972,5,910,3.0,642.0,642.0,5,1062,3.0,794.0,794.0
0.074,6,10,1506,5,395,17.0,127.0,127.0,5,1111,16.0,843.0,843.0
0.013,6,10,1605,5,388,3.0,120.0,120.0,5,1217,3.0,949.0,949.0
379.113,6,24,2405,17,919,23694.0,195.0,195.0,7,1486,3914.0,419.0,398.0
40.008,17,10,676,5,460,10001.0,104.0,64.0,5,216,10001.0,20.0,15.0
0.014,6,10,1990,5,911,3.0,643.0,643.0,5,1079,3.0,811.0,811.0
0.102,6,10,1506,5,395,24.0,127.0,127.0,5,1111,23.0,843.0,843.0
0.01,6,10,1990,5,911,2.0,643.0,643.0,5,1079,2.0,811.0,811.0
0.013,17,2,175,1,65,0.0,37.0,37.0,1,110,0.0,82.0,82.0
0.009,6,10,1983,5,910,2.0,642.0,642.0,5,1073,2.0,805.0,805.0
0.004,6,10,1702,5,863,1.0,595.0,595.0,5,839,0.0,571.0,571.0
0.005,6,10,1989,5,927,1.0,659.0,659.0,5,1062,1.0,794.0,794.0
0.082,6,10,1506,5,395,18.0,127.0,127.0,5,1111,16.0,843.0,843.0
0.13,6,10,1506,5,395,26.0,127.0,127.0,5,1111,25.0,843.0,843.0
0.069,17,8,3613,4,1874,23.0,1350.0,440.0,4,1739,11.0,1350.0,406.0
366.797,6,22,2313,16,867,24453.0,195.0,195.0,6,1446,4634.0,419.0,398.0
10.825,17,28,4418,14,1993,824.0,268.0,114.0,14,2425,824.0,588.0,145.0
0.083,6,10,1506,5,395,17.0,127.0,127.0,5,1111,17.0,843.0,843.0
0.005,6,10,1643,5,860,1.0,592.0,592.0,5,783,1.0,515.0,515.0
0.008,6,10,1989,5,910,1.0,642.0,642.0,5,1079,2.0,811.0,811.0
15.075,17,17,8210,9,6058,1880.0,1350.0,645.0,8,2152,2149.0,1350.0,241.0
171.132,17,78,11337,39,2627,4503.0,44.0,39.0,39,8710,4503.0,239.0,195.0
0.004,6,10,1989,5,927,1.0,659.0,659.0,5,1062,1.0,794.0,794.0
292.519,6,323,344295,130,18311,2267.0,2736.0,888.0,193,325984,1523.0,2769.0,1765.0
0.005,6,10,2000,5,927,1.0,659.0,659.0,5,1073,1.0,805.0,805.0
0.012,6,10,1972,5,910,3.0,642.0,642.0,5,1062,3.0,794.0,794.0
0.067,17,8,3613,4,1874,22.0,1350.0,440.0,4,1739,11.0,1350.0,406.0
353.984,6,21,1795,16,1030,23598.0,190.0,190.0,5,765,60002.0,464.0,248.0
0.07,6,10,1506,5,395,15.0,127.0,127.0,5,1111,16.0,843.0,843.0
0.112,6,10,1506,5,395,23.0,127.0,127.0,5,1111,23.0,843.0,843.0
40.063,17,10,676,5,460,10015.0,104.0,64.0,5,216,10014.0,20.0,15.0
0.003,17,2,136,1,60,0.0,32.0,32.0,1,76,0.0,48.0,48.0
0.005,6,13,3747,7,509,0.0,137.0,137.0,6,3238,0.0,1470.0,1459.0
310.924,17,18,1008,9,640,38858.0,48.0,43.0,9,368,38858.0,20.0,12.0
0.005,6,14,3736,7,446,0.0,74.0,74.0,7,3290,0.0,1448.0,972.0
0.102,6,10,1506,5,395,22.0,127.0,127.0,5,1111,24.0,843.0,843.0
0.004,17,4,284,2,120,1.0,32.0,32.0,2,164,0.0,60.0,54.0
0.009,6,10,1762,5,911,2.0,643.0,643.0,5,851,2.0,583.0,583.0
0.001,17,2,136,1,60,0.0,32.0,32.0,1,76,0.0,48.0,48.0
0.016,6,10,1983,5,910,3.0,642.0,642.0,5,1073,4.0,805.0,805.0
0.006,6,10,1547,5,764,1.0,496.0,496.0,5,783,1.0,515.0,515.0
0.021,6,10,1990,5,911,5.0,643.0,643.0,5,1079,5.0,811.0,811.0
0.008,6,10,1990,5,911,2.0,643.0,643.0,5,1079,1.0,811.0,811.0
0.006,6,10,2007,5,928,1.0,660.0,660.0,5,1079,1.0,811.0,811.0
0.01,6,10,1983,5,910,2.0,642.0,642.0,5,1073,2.0,805.0,805.0
0.005,6,10,2006,5,927,1.0,659.0,659.0,5,1079,1.0,811.0,811.0
0.001,17,2,166,1,75,0.0,47.0,47.0,1,91,0.0,63.0,63.0
240.097,6,31,9529,15,6929,17149.0,2052.0,683.0,16,2600,16006.0,580.0,220.0
0.011,6,10,1990,5,911,2.0,643.0,643.0,5,1079,2.0,811.0,811.0
0.039,17,4,284,2,120,1.0,32.0,32.0,2,164,35.0,60.0,54.0
0.013,6,10,1762,5,911,3.0,643.0,643.0,5,851,3.0,583.0,583.0
0.011,17,2,164,1,74,0.0,46.0,46.0,1,90,0.0,62.0,62.0
0.018,6,10,1990,5,911,4.0,643.0,643.0,5,1079,4.0,811.0,811.0
0.006,17,2,169,1,62,0.0,34.0,34.0,1,107,0.0,79.0,79.0
0.012,6,10,1989,5,910,2.0,642.0,642.0,5,1079,2.0,811.0,811.0
0.012,6,10,1989,5,910,3.0,642.0,642.0,5,1079,3.0,811.0,811.0
0.067,17,8,3613,4,1874,22.0,1350.0,440.0,4,1739,11.0,1350.0,406.0
0.006,6,10,1854,5,889,1.0,621.0,621.0,5,965,1.0,697.0,697.0
0.005,17,2,178,1,81,0.0,53.0,53.0,1,97,0.0,69.0,69.0
0.006,17,2,166,1,75,0.0,47.0,47.0,1,91,0.0,63.0,63.0
40.062,17,10,676,5,460,10014.0,104.0,64.0,5,216,10014.0,20.0,15.0
0.129,6,10,1506,5,395,29.0,127.0,127.0,5,1111,30.0,843.0,843.0
0.098,6,10,1506,5,395,20.0,127.0,127.0,5,1111,22.0,843.0,843.0
0.005,6,10,1774,5,923,1.0,655.0,655.0,5,851,1.0,583.0,583.0
0.001,17,2,179,1,62,0.0,34.0,34.0,1,117,0.0,89.0,89.0
0.006,17,2,230,1,68,0.0,40.0,40.0,1,162,0.0,134.0,134.0
0.093,17,4,284,2,120,0.0,32.0,32.0,2,164,29.0,60.0,54.0
40.057,17,10,676,5,460,10012.0,104.0,64.0,5,216,10013.0,20.0,15.0
0.01,6,10,1983,5,910,2.0,642.0,642.0,5,1073,2.0,805.0,805.0
0.006,17,2,140,1,62,0.0,34.0,34.0,1,78,0.0,50.0,50.0
0.012,6,10,1990,5,911,3.0,643.0,643.0,5,1079,2.0,811.0,811.0
0.007,6,10,1689,5,839,1.0,571.0,571.0,5,850,1.0,582.0,582.0
9.038,17,6,376,5,280,2259.0,28.0,28.0,1,96,0.0,68.0,68.0
0.028,6,10,1972,5,910,7.0,642.0,642.0,5,1062,6.0,794.0,794.0
0.006,6,10,1547,5,764,1.0,496.0,496.0,5,783,1.0,515.0,515.0
0.121,6,10,1506,5,395,25.0,127.0,127.0,5,1111,24.0,843.0,843.0
0.014,6,10,1990,5,911,3.0,643.0,643.0,5,1079,3.0,811.0,811.0
0.03,6,10,1989,5,910,7.0,642.0,642.0,5,1079,7.0,811.0,811.0
22.054,6,23,5004,11,2310,2205.0,967.0,432.0,12,2694,2004.0,1162.0,412.0
0.005,6,10,2007,5,928,1.0,660.0,660.0,5,1079,1.0,811.0,811.0
0.006,6,10,1689,5,839,1.0,571.0,571.0,5,850,1.0,582.0,582.0
10.921,17,28,4420,14,1995,831.0,270.0,114.0,14,2425,831.0,588.0,145.0
0.017,6,10,1631,5,848,4.0,580.0,580.0,5,783,4.0,515.0,515.0
0.006,6,10,1854,5,889,1.0,621.0,621.0,5,965,1.0,697.0,697.0
0.089,6,10,1506,5,395,19.0,127.0,127.0,5,1111,20.0,843.0,843.0
0.06,17,2,80,1,32,0.0,4.0,4.0,1,48,0.0,20.0,20.0
0.011,6,10,1989,5,910,2.0,642.0,642.0,5,1079,2.0,811.0,811.0
0.079,6,10,1506,5,395,17.0,127.0,127.0,5,1111,17.0,843.0,843.0
0.003,17,2,148,1,60,0.0,32.0,32.0,1,88,0.0,60.0,60.0
0.009,6,14,3799,7,509,1.0,137.0,137.0,7,3290,1.0,1448.0,972.0
0.005,6,10,1689,5,839,1.0,571.0,571.0,5,850,1.0,582.0,582.0
0.013,6,10,1990,5,911,3.0,643.0,643.0,5,1079,3.0,811.0,811.0
11.036,17,28,4423,14,1995,839.0,270.0,114.0,14,2428,839.0,587.0,145.0
0.005,6,10,1547,5,764,1.0,496.0,496.0,5,783,1.0,515.0,515.0
0.116,6,10,1506,5,395,21.0,127.0,127.0,5,1111,27.0,843.0,843.0
0.204,6,16,2777,8,1395,29.0,533.0,323.0,8,1382,18.0,529.0,239.0
0.012,6,10,1677,5,827,3.0,559.0,559.0,5,850,3.0,582.0,582.0
0.01,6,10,1989,5,910,2.0,642.0,642.0,5,1079,2.0,811.0,811.0
0.012,6,10,1972,5,910,3.0,642.0,642.0,5,1062,2.0,794.0,794.0
0.013,6,10,1989,5,910,3.0,642.0,642.0,5,1079,3.0,811.0,811.0
240.079,6,16,4482,9,963,30009.0,238.0,166.0,7,3519,40012.0,1402.0,786.0
0.004,6,10,1989,5,927,1.0,659.0,659.0,5,1062,1.0,794.0,794.0
321.24,17,20,1124,10,716,35679.0,48.0,43.0,10,408,35679.0,20.0,12.0
0.135,6,10,1506,5,395,29.0,127.0,127.0,5,1111,31.0,843.0,843.0
0.004,6,10,2006,5,927,1.0,659.0,659.0,5,1079,1.0,811.0,811.0
0.265,17,47,27962,26,23451,10.0,1350.0,873.0,21,4511,10.0,1350.0,186.0
0.006,17,2,179,1,71,0.0,43.0,43.0,1,108,0.0,80.0,80.0
40.036,17,10,676,5,460,10007.0,104.0,64.0,5,216,10008.0,20.0,15.0
0.006,6,10,1547,5,764,1.0,496.0,496.0,5,783,1.0,515.0,515.0
0.006,6,10,1547,5,764,1.0,496.0,496.0,5,783,1.0,515.0,515.0
0.087,6,10,1506,5,395,17.0,127.0,127.0,5,1111,21.0,843.0,843.0
0.004,6,10,2006,5,927,1.0,659.0,659.0,5,1079,1.0,811.0,811.0
0.007,17,4,284,2,120,0.0,32.0,32.0,2,164,1.0,60.0,54.0
40.059,17,10,676,5,460,10012.0,104.0,64.0,5,216,10014.0,20.0,15.0
40.074,17,10,676,5,460,10014.0,104.0,64.0,5,216,10017.0,20.0,15.0
240.12,6,31,9178,15,6809,17151.0,1933.0,670.0,16,2369,16007.0,580.0,191.0
0.004,6,10,2006,5,927,1.0,659.0,659.0,5,1079,1.0,811.0,811.0
0.265,17,38,20214,21,17030,13.0,1350.0,782.0,17,3184,12.0,1350.0,159.0
0.004,17,2,148,1,60,0.0,32.0,32.0,1,88,0.0,60.0,60.0
0.003,17,4,284,2,120,0.0,32.0,32.0,2,164,0.0,60.0,54.0
0.006,6,10,1547,5,764,1.0,496.0,496.0,5,783,1.0,515.0,515.0
178.021,17,78,11063,39,2609,4684.0,44.0,38.0,39,8454,4684.0,239.0,188.0
0.007,6,10,1643,5,860,1.0,592.0,592.0,5,783,1.0,515.0,515.0
0.004,6,10,1989,5,927,1.0,659.0,659.0,5,1062,1.0,794.0,794.0
0.014,6,10,1631,5,848,3.0,580.0,580.0,5,783,3.0,515.0,515.0
0.866,6,25,5555,12,1445,66.0,267.0,136.0,13,4110,60.0,1414.0,597.0
0.097,6,10,1506,5,395,21.0,127.0,127.0,5,1111,19.0,843.0,843.0
0.038,17,2,144,1,64,0.0,36.0,36.0,1,80,0.0,52.0,52.0
0.001,17,2,180,1,66,0.0,38.0,38.0,1,114,0.0,86.0,86.0
0.005,6,10,1989,5,927,1.0,659.0,659.0,5,1062,1.0,794.0,794.0
0.005,17,2,180,1,66,0.0,38.0,38.0,1,114,0.0,86.0,86.0
40.061,17,10,676,5,460,10012.0,104.0,64.0,5,216,10014.0,20.0,15.0
0.072,6,10,1506,5,395,15.0,127.0,127.0,5,1111,15.0,843.0,843.0
0.086,6,10,1506,5,395,19.0,127.0,127.0,5,1111,18.0,843.0,843.0
0.167,17,2,152,1,76,0.0,48.0,48.0,1,76,0.0,48.0,48.0
0.005,6,10,2006,5,927,1.0,659.0,659.0,5,1079,1.0,811.0,811.0
10.87,17,28,4421,14,1994,827.0,269.0,114.0,14,2427,827.0,586.0,145.0
0.08,6,10,1506,5,395,19.0,127.0,127.0,5,1111,19.0,843.0,843.0
166.029,17,72,10307,36,2410,4743.0,44.0,38.0,36,7897,4743.0,261.0,191.0
0.023,6,10,1990,5,911,5.0,643.0,643.0,5,1079,5.0,811.0,811.0
0.025,6,10,1989,5,910,6.0,642.0,642.0,5,1079,6.0,811.0,811.0
0.013,6,10,1983,5,910,3.0,642.0,642.0,5,1073,3.0,805.0,805.0
0.006,6,10,1689,5,839,1.0,571.0,571.0,5,850,1.0,582.0,582.0
0.094,6,10,1506,5,395,22.0,127.0,127.0,5,1111,22.0,843.0,843.0
0.001,17,2,180,1,66,0.0,38.0,38.0,1,114,0.0,86.0,86.0
0.011,6,10,1989,5,910,2.0,642.0,642.0,5,1079,2.0,811.0,811.0
1.013,6,13,3921,7,2138,127.0,1328.0,923.0,6,1783,152.0,1539.0,1539.0
0.005,6,10,1854,5,889,1.0,621.0,621.0,5,965,1.0,697.0,697.0
0.087,6,10,1506,5,395,20.0,127.0,127.0,5,1111,19.0,843.0,843.0
312.176,17,20,1124,10,716,34671.0,48.0,43.0,10,408,34671.0,20.0,12.0
0.016,6,10,1972,5,910,4.0,642.0,642.0,5,1062,3.0,794.0,794.0
0.052,17,2,152,1,76,0.0,48.0,48.0,1,76,0.0,48.0,48.0
0.095,6,10,1506,5,395,21.0,127.0,127.0,5,1111,21.0,843.0,843.0
0.017,6,10,1972,5,910,4.0,642.0,642.0,5,1062,4.0,794.0,794.0
0.102,6,10,1506,5,395,22.0,127.0,127.0,5,1111,20.0,843.0,843.0
272.542,6,39,10041,16,6734,18169.0,1807.0,656.0,23,3307,12388.0,580.0,150.0
0.017,6,10,1677,5,827,4.0,559.0,559.0,5,850,4.0,582.0,582.0
309.146,17,20,1124,10,716,34335.0,48.0,43.0,10,408,34335.0,20.0,12.0
40.057,17,10,676,5,460,10011.0,104.0,64.0,5,216,10013.0,20.0,15.0
0.009,17,2,214,1,75,0.0,47.0,47.0,1,139,0.0,111.0,111.0
0.004,17,2,136,1,60,0.0,32.0,32.0,1,76,0.0,48.0,48.0
0.219,17,4,596,2,122,147.0,33.0,33.0,2,474,179.0,323.0,209.0
0.072,6,10,1506,5,395,16.0,127.0,127.0,5,1111,17.0,843.0,843.0
0.005,17,2,178,1,81,0.0,53.0,53.0,1,97,0.0,69.0,69.0
240.026,6,9,787,5,488,60006.0,232.0,232.0,4,299,80007.0,83.0,83.0
0.004,17,2,136,1,60,0.0,32.0,32.0,1,76,0.0,48.0,48.0
0.122,6,10,1506,5,395,28.0,127.0,127.0,5,1111,24.0,843.0,843.0
0.006,6,10,1854,5,889,1.0,621.0,621.0,5,965,1.0,697.0,697.0
0.011,6,10,1631,5,848,2.0,580.0,580.0,5,783,2.0,515.0,515.0
0.004,6,10,1989,5,927,1.0,659.0,659.0,5,1062,1.0,794.0,794.0
0.012,6,10,1990,5,911,2.0,643.0,643.0,5,1079,2.0,811.0,811.0
15.071,17,14,9190,8,6902,2149.0,1350.0,834.0,6,2288,3008.0,1350.0,353.0
0.034,17,2,152,1,76,0.0,48.0,48.0,1,76,0.0,48.0,48.0
0.001,17,2,180,1,66,0.0,38.0,38.0,1,114,0.0,86.0,86.0
0.069,6,10,1506,5,395,15.0,127.0,127.0,5,1111,16.0,843.0,843.0
0.003,17,2,132,1,58,0.0,30.0,30.0,1,74,0.0,46.0,46.0
0.008,6,10,1989,5,910,2.0,642.0,642.0,5,1079,1.0,811.0,811.0
0.013,6,10,1983,5,910,3.0,642.0,642.0,5,1073,3.0,805.0,805.0
40.053,17,10,676,5,460,10012.0,104.0,64.0,5,216,10012.0,20.0,15.0
0.037,17,2,144,1,64,0.0,36.0,36.0,1,80,0.0,52.0,52.0
0.016,6,10,1605,5,388,3.0,120.0,120.0,5,1217,4.0,949.0,949.0
0.013,6,10,1989,5,910,3.0,642.0,642.0,5,1079,3.0,811.0,811.0
0.114,6,10,1506,5,395,27.0,127.0,127.0,5,1111,25.0,843.0,843.0
0.01,6,10,1631,5,848,2.0,580.0,580.0,5,783,2.0,515.0,515.0
0.001,17,2,180,1,66,0.0,38.0,38.0,1,114,0.0,86.0,86.0
0.021,6,10,1989,5,910,5.0,642.0,642.0,5,1079,5.0,811.0,811.0
0.044,6,10,1989,5,910,11.0,642.0,642.0,5,1079,11.0,811.0,811.0
0.005,17,2,179,1,71,0.0,43.0,43.0,1,108,0.0,80.0,80.0
0.006,17,2,230,1,68,0.0,40.0,40.0,1,162,0.0,134.0,134.0
0.013,6,10,1983,5,910,3.0,642.0,642.0,5,1073,3.0,805.0,805.0
0.004,6,10,2000,5,927,1.0,659.0,659.0,5,1073,1.0,805.0,805.0
0.014,6,10,1989,5,910,3.0,642.0,642.0,5,1079,3.0,811.0,811.0
0.003,17,2,136,1,60,0.0,32.0,32.0,1,76,0.0,48.0,48.0
0.078,6,10,1506,5,395,16.0,127.0,127.0,5,1111,17.0,843.0,843.0
0.094,6,10,1506,5,395,20.0,127.0,127.0,5,1111,20.0,843.0,843.0
0.003,17,2,148,1,60,0.0,32.0,32.0,1,88,0.0,60.0,60.0
0.009,6,10,1643,5,860,2.0,592.0,592.0,5,783,2.0,515.0,515.0
0.063,17,2,144,1,64,0.0,36.0,36.0,1,80,0.0,52.0,52.0
0.1,6,10,1506,5,395,19.0,127.0,127.0,5,1111,22.0,843.0,843.0
0.018,6,10,1989,5,910,4.0,642.0,642.0,5,1079,4.0,811.0,811.0
0.016,6,10,1972,5,910,3.0,642.0,642.0,5,1062,4.0,794.0,794.0
0.014,6,10,1972,5,910,3.0,642.0,642.0,5,1062,3.0,794.0,794.0
0.386,17,50,23779,26,19966,15.0,1350.0,739.0,24,3813,13.0,1350.0,130.0
0.016,6,10,1990,5,911,4.0,643.0,643.0,5,1079,4.0,811.0,811.0
0.018,6,10,1762,5,911,4.0,643.0,643.0,5,851,4.0,583.0,583.0
0.006,6,10,1854,5,889,1.0,621.0,621.0,5,965,1.0,697.0,697.0
0.274,17,39,20118,21,17040,13.0,1350.0,783.0,18,3078,12.0,1350.0,143.0
0.004,6,10,2007,5,928,1.0,660.0,660.0,5,1079,1.0,811.0,811.0
0.005,6,10,1689,5,839,1.0,571.0,571.0,5,850,1.0,582.0,582.0
0.038,17,4,284,2,120,1.0,32.0,32.0,2,164,34.0,60.0,54.0
0.051,6,10,1989,5,910,12.0,642.0,642.0,5,1079,12.0,811.0,811.0
0.114,6,10,1506,5,395,25.0,127.0,127.0,5,1111,25.0,843.0,843.0
0.005,6,10,1989,5,927,1.0,659.0,659.0,5,1062,1.0,794.0,794.0
0.04,17,2,144,1,64,0.0,36.0,36.0,1,80,0.0,52.0,52.0
0.021,6,10,1990,5,911,5.0,643.0,643.0,5,1079,5.0,811.0,811.0
0.005,6,10,2006,5,927,1.0,659.0,659.0,5,1079,1.0,811.0,811.0
0.016,6,10,1631,5,848,4.0,580.0,580.0,5,783,4.0,515.0,515.0
0.138,6,10,1506,5,395,30.0,127.0,127.0,5,1111,28.0,843.0,843.0
0.011,6,10,1989,5,910,2.0,642.0,642.0,5,1079,2.0,811.0,811.0
0.076,6,10,1506,5,395,16.0,127.0,127.0,5,1111,17.0,843.0,843.0
0.013,6,10,1972,5,910,3.0,642.0,642.0,5,1062,3.0,794.0,794.0
0.012,6,10,1983,5,910,3.0,642.0,642.0,5,1073,3.0,805.0,805.0
0.009,6,10,1972,5,910,2.0,642.0,642.0,5,1062,2.0,794.0,794.0
0.005,6,10,1774,5,923,1.0,655.0,655.0,5,851,1.0,583.0,583.0
0.005,6,14,3799,7,509,0.0,137.0,137.0,7,3290,0.0,1448.0,972.0
0.005,17,2,160,1,72,0.0,44.0,44.0,1,88,0.0,60.0,60.0
0.021,6,10,1989,5,910,5.0,642.0,642.0,5,1079,5.0,811.0,811.0
0.006,6,10,1854,5,889,1.0,621.0,621.0,5,965,1.0,697.0,697.0
0.005,6,10,1779,5,928,1.0,660.0,660.0,5,851,1.0,583.0,583.0
0.004,6,10,2000,5,927,1.0,659.0,659.0,5,1073,1.0,805.0,805.0
0.071,6,10,1506,5,395,15.0,127.0,127.0,5,1111,15.0,843.0,843.0
351.985,6,20,2210,6,1308,12003.0,494.0,494.0,14,902,27075.0,83.0,83.0
0.074,6,10,1506,5,395,16.0,127.0,127.0,5,1111,17.0,843.0,843.0
0.006,6,10,1547,5,764,1.0,496.0,496.0,5,783,1.0,515.0,515.0
0.01,6,10,1990,5,911,2.0,643.0,643.0,5,1079,2.0,811.0,811.0
40.061,17,10,676,5,460,10014.0,104.0,64.0,5,216,10014.0,20.0,15.0
0.005,6,10,1689,5,839,1.0,571.0,571.0,5,850,1.0,582.0,582.0
0.124,6,10,1506,5,395,28.0,127.0,127.0,5,1111,23.0,843.0,843.0
1777.681,17,143,41496,72,22752,25037.0,288.0,288.0,71,18744,25395.0,236.0,236.0
0.009,6,10,1989,5,910,2.0,642.0,642.0,5,1079,2.0,811.0,811.0
0.006,17,2,293,1,73,0.0,45.0,45.0,1,220,0.0,192.0,192.0
0.008,17,2,132,1,58,0.0,30.0,30.0,1,74,0.0,46.0,46.0
0.037,17,4,284,2,120,1.0,32.0,32.0,2,164,33.0,60.0,54.0
0.022,6,10,1989,5,910,5.0,642.0,642.0,5,1079,5.0,811.0,811.0
314.176,17,20,1124,10,716,34893.0,48.0,43.0,10,408,34893.0,20.0,12.0
40.071,17,10,676,5,460,10016.0,104.0,64.0,5,216,10016.0,20.0,15.0
0.089,6,10,1506,5,395,20.0,127.0,127.0,5,1111,19.0,843.0,843.0
0.006,6,10,1689,5,839,1.0,571.0,571.0,5,850,1.0,582.0,582.0
0.021,6,10,1972,5,910,5.0,642.0,642.0,5,1062,5.0,794.0,794.0
0.001,17,2,180,1,66,0.0,38.0,38.0,1,114,0.0,86.0,86.0
1799.839,6,136,6550,76,3625,23997.0,39.0,39.0,60,2925,29993.0,35.0,35.0
0.011,6,10,1631,5,848,2.0,580.0,580.0,5,783,2.0,515.0,515.0
0.158,6,10,1506,5,395,32.0,127.0,127.0,5,1111,37.0,843.0,843.0
0.126,6,10,1506,5,395,30.0,127.0,127.0,5,1111,23.0,843.0,843.0
0.012,6,10,1990,5,911,2.0,643.0,643.0,5,1079,2.0,811.0,811.0
0.005,6,10,2007,5,928,1.0,660.0,660.0,5,1079,1.0,811.0,811.0
0.018,6,10,1677,5,827,4.0,559.0,559.0,5,850,4.0,582.0,582.0
0.005,17,2,170,1,65,0.0,37.0,37.0,1,105,0.0,77.0,77.0
0.004,6,10,2006,5,927,1.0,659.0,659.0,5,1079,1.0,811.0,811.0
0.103,6,10,1506,5,395,23.0,127.0,127.0,5,1111,22.0,843.0,843.0
0.005,6,10,1702,5,863,1.0,595.0,595.0,5,839,1.0,571.0,571.0
0.097,6,10,1506,5,395,21.0,127.0,127.0,5,1111,20.0,843.0,843.0
0.077,6,10,1506,5,395,16.0,127.0,127.0,5,1111,17.0,843.0,843.0
0.004,6,10,1989,5,927,1.0,659.0,659.0,5,1062,1.0,794.0,794.0
40.071,17,10,676,5,460,10014.0,104.0,64.0,5,216,10017.0,20.0,15.0
1755.988,6,105,6270,60,3525,29761.0,27.0,27.0,45,2745,39907.0,27.0,27.0
0.085,6,10,1506,5,395,20.0,127.0,127.0,5,1111,19.0,843.0,843.0
0.238,6,10,1506,5,395,55.0,127.0,127.0,5,1111,31.0,843.0,843.0
0.005,6,10,2006,5,927,1.0,659.0,659.0,5,1079,1.0,811.0,811.0
0.005,6,10,2006,5,927,1.0,659.0,659.0,5,1079,1.0,811.0,811.0
0.012,6,10,1989,5,910,3.0,642.0,642.0,5,1079,3.0,811.0,811.0
15.073,17,15,9239,8,6902,2149.0,1350.0,834.0,7,2337,2507.0,1350.0,305.0
0.005,6,10,2006,5,927,1.0,659.0,659.0,5,1079,1.0,811.0,811.0
0.004,17,2,148,1,60,0.0,32.0,32.0,1,88,0.0,60.0,60.0
0.009,6,10,1989,5,910,2.0,642.0,642.0,5,1079,2.0,811.0,811.0
0.018,6,10,1989,5,910,4.0,642.0,642.0,5,1079,4.0,811.0,811.0
0.003,17,4,284,2,120,0.0,32.0,32.0,2,164,0.0,60.0,54.0
40.087,17,10,676,5,460,10015.0,104.0,64.0,5,216,10016.0,20.0,15.0
0.005,6,13,3690,7,452,0.0,80.0,80.0,6,3238,1.0,1470.0,1459.0
0.086,6,10,1506,5,395,18.0,127.0,127.0,5,1111,18.0,843.0,843.0
0.013,6,10,1989,5,910,3.0,642.0,642.0,5,1079,3.0,811.0,811.0
0.1,6,10,1506,5,395,23.0,127.0,127.0,5,1111,22.0,843.0,843.0
0.006,6,10,1547,5,764,1.0,496.0,496.0,5,783,1.0,515.0,515.0
40.065,17,10,676,5,460,10014.0,104.0,64.0,5,216,10015.0,20.0,15.0
0.004,17,4,284,2,120,0.0,32.0,32.0,2,164,0.0,60.0,54.0
0.085,6,10,1506,5,395,20.0,127.0,127.0,5,1111,16.0,843.0,843.0
0.011,6,10,1989,5,910,2.0,642.0,642.0,5,1079,2.0,811.0,811.0
0.745,6,22,5168,11,1138,62.0,267.0,115.0,11,4030,62.0,1414.0,597.0
0.004,6,10,2000,5,927,1.0,659.0,659.0,5,1073,1.0,805.0,805.0
40.079,17,10,676,5,460,10019.0,104.0,64.0,5,216,10018.0,20.0,15.0
292.118,6,396,347919,200,21958,1467.0,2736.0,888.0,196,325961,1498.0,2999.0,1744.0
0.011,6,13,3735,7,497,1.0,125.0,125.0,6,3238,2.0,1470.0,1459.0
0.01,6,10,1972,5,910,2.0,642.0,642.0,5,1062,2.0,794.0,794.0
0.011,6,10,1990,5,911,2.0,643.0,643.0,5,1079,2.0,811.0,811.0
0.006,6,13,3747,7,509,0.0,137.0,137.0,6,3238,1.0,1470.0,1459.0
0.137,6,10,1506,5,395,31.0,127.0,127.0,5,1111,24.0,843.0,843.0
0.092,6,10,1506,5,395,17.0,127.0,127.0,5,1111,22.0,843.0,843.0
0.005,6,10,2006,5,927,1.0,659.0,659.0,5,1079,1.0,811.0,811.0
0.046,17,2,148,1,60,0.0,32.0,32.0,1,88,0.0,60.0,60.0
0.004,6,10,1702,5,863,1.0,595.0,595.0,5,839,0.0,571.0,571.0
0.001,17,2,179,1,62,0.0,34.0,34.0,1,117,0.0,89.0,89.0
0.074,6,10,1506,5,395,17.0,127.0,127.0,5,1111,16.0,843.0,843.0
1784.149,6,242,46459,118,34036,15249.0,2473.0,961.0,124,12423,14504.0,580.0,62.0
0.017,6,10,1631,5,848,4.0,580.0,580.0,5,783,4.0,515.0,515.0
0.005,6,10,2006,5,927,1.0,659.0,659.0,5,1079,1.0,811.0,811.0
0.001,17,2,180,1,66,0.0,38.0,38.0,1,114,0.0,86.0,86.0
0.005,17,2,179,1,71,0.0,43.0,43.0,1,108,0.0,80.0,80.0
0.005,6,10,1989,5,927,1.0,659.0,659.0,5,1062,1.0,794.0,794.0
0.031,6,14,3965,7,495,5.0,123.0,123.0,7,3470,5.0,1448.0,1032.0
0.053,17,2,152,1,76,0.0,48.0,48.0,1,76,0.0,48.0,48.0
0.071,6,10,1506,5,395,16.0,127.0,127.0,5,1111,16.0,843.0,843.0
0.312,17,42,21552,23,18477,14.0,1350.0,775.0,19,3075,13.0,1350.0,133.0
0.089,6,10,1506,5,395,20.0,127.0,127.0,5,1111,20.0,843.0,843.0
0.037,6,10,1677,5,827,9.0,559.0,559.0,5,850,9.0,582.0,582.0
0.114,6,10,1506,5,395,25.0,127.0,127.0,5,1111,25.0,843.0,843.0
0.005,6,10,1689,5,839,1.0,571.0,571.0,5,850,1.0,582.0,582.0
0.005,6,10,1989,5,927,1.0,659.0,659.0,5,1062,1.0,794.0,794.0
0.005,6,10,2006,5,927,1.0,659.0,659.0,5,1079,1.0,811.0,811.0
0.091,6,10,1506,5,395,21.0,127.0,127.0,5,1111,21.0,843.0,843.0
0.003,17,2,148,1,60,0.0,32.0,32.0,1,88,0.0,60.0,60.0
0.006,6,10,1547,5,764,1.0,496.0,496.0,5,783,1.0,515.0,515.0
0.013,6,10,1989,5,910,3.0,642.0,642.0,5,1079,3.0,811.0,811.0
40.056,17,10,676,5,460,10012.0,104.0,64.0,5,216,10013.0,20.0,15.0
0.011,6,10,1762,5,911,2.0,643.0,643.0,5,851,2.0,583.0,583.0
0.006,6,10,1643,5,860,1.0,592.0,592.0,5,783,1.0,515.0,515.0
0.011,6,10,1689,5,839,2.0,571.0,571.0,5,850,2.0,582.0,582.0
0.001,17,2,136,1,60,0.0,32.0,32.0,1,76,0.0,48.0,48.0
0.005,6,10,2000,5,927,1.0,659.0,659.0,5,1073,1.0,805.0,805.0
0.012,6,10,1972,5,910,3.0,642.0,642.0,5,1062,3.0,794.0,794.0
0.001,17,2,180,1,65,0.0,37.0,37.0,1,115,0.0,87.0,87.0
0.004,17,2,186,1,61,0.0,33.0,33.0,1,125,0.0,97.0,97.0
300.019,6,12,1782,7,1348,50003.0,494.0,494.0,5,434,75004.0,83.0,83.0
0.005,6,10,2006,5,927,1.0,659.0,659.0,5,1079,1.0,811.0,811.0
0.014,6,10,1990,5,911,3.0,643.0,643.0,5,1079,3.0,811.0,811.0
40.058,17,10,676,5,460,10013.0,104.0,64.0,5,216,10013.0,20.0,15.0
0.008,6,10,1972,5,910,2.0,642.0,642.0,5,1062,2.0,794.0,794.0
93.26,6,24,9037,12,3129,108.0,1360.0,654.0,12,5908,8462.0,1745.0,902.0
0.006,6,10,1547,5,764,1.0,496.0,496.0,5,783,1.0,515.0,515.0
0.038,17,4,596,2,122,1.0,33.0,33.0,2,474,0.0,323.0,209.0
0.005,17,2,148,1,60,0.0,32.0,32.0,1,88,0.0,60.0,60.0
0.089,6,10,1506,5,395,19.0,127.0,127.0,5,1111,21.0,843.0,843.0
0.01,6,13,3735,7,497,1.0,125.0,125.0,6,3238,1.0,1470.0,1459.0
0.076,6,10,1506,5,395,18.0,127.0,127.0,5,1111,16.0,843.0,843.0
1772.654,17,120,11460,60,5460,30044.0,63.0,63.0,60,6000,30044.0,72.0,72.0
0.097,6,10,1506,5,395,21.0,127.0,127.0,5,1111,23.0,843.0,843.0
0.068,17,8,3613,4,1874,22.0,1350.0,440.0,4,1739,11.0,1350.0,406.0
0.009,6,13,3735,7,497,1.0,125.0,125.0,6,3238,1.0,1470.0,1459.0
0.01,17,2,166,1,75,0.0,47.0,47.0,1,91,0.0,63.0,63.0
0.018,17,2,198,1,91,0.0,63.0,63.0,1,107,0.0,79.0,79.0
0.005,17,2,148,1,60,0.0,32.0,32.0,1,88,0.0,60.0,60.0
0.01,6,10,1990,5,911,2.0,643.0,643.0,5,1079,2.0,811.0,811.0
0.174,17,2,152,1,76,0.0,48.0,48.0,1,76,0.0,48.0,48.0
0.006,6,10,1989,5,927,1.0,659.0,659.0,5,1062,1.0,794.0,794.0
0.004,6,10,1702,5,863,1.0,595.0,595.0,5,839,0.0,571.0,571.0
0.009,6,10,1989,5,910,2.0,642.0,642.0,5,1079,2.0,811.0,811.0
40.064,17,10,676,5,460,10015.0,104.0,64.0,5,216,10015.0,20.0,15.0
0.079,6,10,1506,5,395,15.0,127.0,127.0,5,1111,19.0,843.0,843.0
0.094,6,10,1506,5,395,19.0,127.0,127.0,5,1111,19.0,843.0,843.0
0.005,6,10,1702,5,863,1.0,595.0,595.0,5,839,1.0,571.0,571.0
0.005,6,10,1689,5,839,1.0,571.0,571.0,5,850,1.0,582.0,582.0
0.004,17,2,136,1,60,0.0,32.0,32.0,1,76,0.0,48.0,48.0
1786.308,6,150,19350,90,13740,20070.0,302.0,302.0,60,5610,30276.0,83.0,83.0
0.017,6,10,1989,5,910,4.0,642.0,642.0,5,1079,4.0,811.0,811.0
0.005,6,10,2007,5,928,1.0,660.0,660.0,5,1079,1.0,811.0,811.0
0.096,6,10,1506,5,395,21.0,127.0,127.0,5,1111,19.0,843.0,843.0
0.07,6,10,1506,5,395,16.0,127.0,127.0,5,1111,16.0,843.0,843.0
0.011,6,10,1989,5,910,2.0,642.0,642.0,5,1079,2.0,811.0,811.0
1730.386,6,45,2790,30,1725,59668.0,35.0,35.0,15,1065,123593.0,31.0,31.0
0.01,6,10,1989,5,910,2.0,642.0,642.0,5,1079,2.0,811.0,811.0
0.1,6,10,1506,5,395,23.0,127.0,127.0,5,1111,23.0,843.0,843.0
0.005,17,2,136,1,60,0.0,32.0,32.0,1,76,0.0,48.0,48.0
40.053,17,10,676,5,460,10012.0,104.0,64.0,5,216,10012.0,20.0,15.0
0.008,6,10,1677,5,827,2.0,559.0,559.0,5,850,2.0,582.0,582.0
0.005,6,10,1989,5,927,1.0,659.0,659.0,5,1062,1.0,794.0,794.0
295.61,6,323,344616,120,17781,2484.0,2736.0,888.0,203,326835,1463.0,2804.0,1673.0
0.072,6,10,1506,5,395,17.0,127.0,127.0,5,1111,14.0,843.0,843.0
40.063,17,10,676,5,460,10014.0,104.0,64.0,5,216,10014.0,20.0,15.0
0.004,17,4,284,2,120,0.0,32.0,32.0,2,164,1.0,60.0,54.0
0.003,17,2,136,1,60,0.0,32.0,32.0,1,76,0.0,48.0,48.0
0.004,6,10,2006,5,927,1.0,659.0,659.0,5,1079,1.0,811.0,811.0
11.19,17,28,4421,14,1993,848.0,268.0,114.0,14,2428,848.0,587.0,145.0
0.005,6,10,2000,5,927,1.0,659.0,659.0,5,1073,1.0,805.0,805.0
0.005,6,10,2006,5,927,1.0,659.0,659.0,5,1079,1.0,811.0,811.0
0.132,6,10,1506,5,395,30.0,127.0,127.0,5,1111,29.0,843.0,843.0
0.018,6,10,1983,5,910,4.0,642.0,642.0,5,1073,4.0,805.0,805.0
0.013,6,10,1990,5,911,3.0,643.0,643.0,5,1079,3.0,811.0,811.0
0.112,6,10,1506,5,395,25.0,127.0,127.0,5,1111,27.0,843.0,843.0
0.005,6,10,2007,5,928,1.0,660.0,660.0,5,1079,1.0,811.0,811.0
0.006,6,10,1854,5,889,1.0,621.0,621.0,5,965,1.0,697.0,697.0
0.005,6,10,1779,5,928,1.0,660.0,660.0,5,851,1.0,583.0,583.0
0.004,6,10,1774,5,923,1.0,655.0,655.0,5,851,1.0,583.0,583.0
0.014,6,13,3735,7,497,2.0,125.0,125.0,6,3238,2.0,1470.0,1459.0
0.146,6,10,1506,5,395,34.0,127.0,127.0,5,1111,35.0,843.0,843.0
0.04,17,2,152,1,76,0.0,48.0,48.0,1,76,0.0,48.0,48.0
0.005,6,10,2007,5,928,1.0,660.0,660.0,5,1079,1.0,811.0,811.0
0.009,6,13,3735,7,497,1.0,125.0,125.0,6,3238,1.0,1470.0,1459.0
0.038,17,4,352,2,130,1.0,37.0,37.0,2,222,34.0,89.0,83.0
0.01,6,10,1972,5,910,2.0,642.0,642.0,5,1062,2.0,794.0,794.0
0.012,6,10,1762,5,911,2.0,643.0,643.0,5,851,2.0,583.0,583.0
0.009,6,10,1989,5,910,2.0,642.0,642.0,5,1079,2.0,811.0,811.0
0.004,17,2,170,1,65,0.0,37.0,37.0,1,105,0.0,77.0,77.0
0.004,6,10,2006,5,927,1.0,659.0,659.0,5,1079,1.0,811.0,811.0
0.014,6,10,1631,5,848,3.0,580.0,580.0,5,783,3.0,515.0,515.0
0.012,6,10,1983,5,910,3.0,642.0,642.0,5,1073,2.0,805.0,805.0
0.005,6,10,2006,5,927,1.0,659.0,659.0,5,1079,1.0,811.0,811.0
0.008,6,10,1990,5,911,2.0,643.0,643.0,5,1079,1.0,811.0,811.0
0.103,6,10,1506,5,395,24.0,127.0,127.0,5,1111,21.0,843.0,843.0
0.007,6,10,1989,5,910,1.0,642.0,642.0,5,1079,1.0,811.0,811.0
40.051,17,10,676,5,460,10011.0,104.0,64.0,5,216,10012.0,20.0,15.0
15.071,17,15,9238,8,6902,2148.0,1350.0,834.0,7,2336,2506.0,1350.0,305.0
0.012,6,10,1989,5,910,2.0,642.0,642.0,5,1079,2.0,811.0,811.0
0.01,6,10,1989,5,910,2.0,642.0,642.0,5,1079,2.0,811.0,811.0
0.005,6,10,2006,5,927,1.0,659.0,659.0,5,1079,1.0,811.0,811.0
0.005,17,2,148,1,60,0.0,32.0,32.0,1,88,0.0,60.0,60.0
0.081,6,10,1506,5,395,17.0,127.0,127.0,5,1111,19.0,843.0,843.0
10.893,17,28,4422,14,1994,829.0,269.0,114.0,14,2428,829.0,587.0,145.0
0.004,6,10,1702,5,863,0.0,595.0,595.0,5,839,1.0,571.0,571.0
0.089,6,10,1506,5,395,19.0,127.0,127.0,5,1111,18.0,843.0,843.0
0.061,17,2,80,1,32,0.0,4.0,4.0,1,48,0.0,20.0,20.0
0.07,6,10,1506,5,395,16.0,127.0,127.0,5,1111,14.0,843.0,843.0
0.007,6,10,1702,5,863,1.0,595.0,595.0,5,839,1.0,571.0,571.0
240.115,6,32,9477,16,7036,16007.0,2107.0,689.0,16,2441,16007.0,580.0,200.0
0.006,6,13,3747,7,509,0.0,137.0,137.0,6,3238,1.0,1470.0,1459.0
0.005,6,10,2007,5,928,1.0,660.0,660.0,5,1079,1.0,811.0,811.0
0.005,6,10,2006,5,927,1.0,659.0,659.0,5,1079,1.0,811.0,811.0
40.048,17,10,676,5,460,10011.0,104.0,64.0,5,216,10011.0,20.0,15.0
0.119,6,10,1506,5,395,27.0,127.0,127.0,5,1111,26.0,843.0,843.0
0.093,6,10,1506,5,395,18.0,127.0,127.0,5,1111,20.0,843.0,843.0
0.001,17,2,180,1,66,0.0,38.0,38.0,1,114,0.0,86.0,86.0
0.006,6,10,1547,5,764,1.0,496.0,496.0,5,783,1.0,515.0,515.0
40.054,17,10,676,5,460,10012.0,104.0,64.0,5,216,10012.0,20.0,15.0
0.004,17,2,148,1,60,0.0,32.0,32.0,1,88,0.0,60.0,60.0
0.109,6,10,1506,5,395,22.0,127.0,127.0,5,1111,23.0,843.0,843.0
244.084,6,278,342440,112,17342,2198.0,2694.0,886.0,166,325098,1479.0,4206.0,2028.0
0.007,17,2,230,1,68,0.0,40.0,40.0,1,162,0.0,134.0,134.0
0.014,6,10,1762,5,911,3.0,643.0,643.0,5,851,3.0,583.0,583.0
0.117,6,10,1506,5,395,25.0,127.0,127.0,5,1111,20.0,843.0,843.0
0.005,6,10,1689,5,839,1.0,571.0,571.0,5,850,1.0,582.0,582.0
0.088,6,10,1506,5,395,20.0,127.0,127.0,5,1111,19.0,843.0,843.0
40.075,17,10,676,5,460,10015.0,104.0,64.0,5,216,10017.0,20.0,15.0
0.005,17,2,136,1,60,0.0,32.0,32.0,1,76,0.0,48.0,48.0
0.065,6,10,1506,5,395,13.0,127.0,127.0,5,1111,15.0,843.0,843.0
0.001,17,2,180,1,66,0.0,38.0,38.0,1,114,0.0,86.0,86.0
0.06,17,2,80,1,32,0.0,4.0,4.0,1,48,0.0,20.0,20.0
40.056,17,10,676,5,460,10013.0,104.0,64.0,5,216,10013.0,20.0,15.0
0.164,6,10,1506,5,395,38.0,127.0,127.0,5,1111,39.0,843.0,843.0
0.005,6,10,2000,5,927,1.0,659.0,659.0,5,1073,1.0,805.0,805.0
0.013,6,13,3735,7,497,2.0,125.0,125.0,6,3238,2.0,1470.0,1459.0
0.014,6,10,1972,5,910,3.0,642.0,642.0,5,1062,3.0,794.0,794.0
308.548,17,20,1124,10,716,34268.0,48.0,43.0,10,408,34268.0,20.0,12.0
0.006,6,10,1779,5,928,1.0,660.0,660.0,5,851,1.0,583.0,583.0
0.021,6,10,1989,5,910,5.0,642.0,642.0,5,1079,5.0,811.0,811.0
0.067,6,10,1506,5,395,15.0,127.0,127.0,5,1111,15.0,843.0,843.0
300.954,6,44,16760,23,10893,13679.0,3252.0,1420.0,21,5867,439.0,2667.0,385.0
0.005,6,14,3799,7,509,0.0,137.0,137.0,7,3290,0.0,1448.0,972.0
0.004,6,10,1989,5,927,1.0,659.0,659.0,5,1062,1.0,794.0,794.0
0.016,17,2,198,1,91,0.0,63.0,63.0,1,107,0.0,79.0,79.0
0.004,6,10,2000,5,927,1.0,659.0,659.0,5,1073,1.0,805.0,805.0
0.023,6,10,1677,5,827,5.0,559.0,559.0,5,850,5.0,582.0,582.0
0.007,17,4,284,2,120,4.0,32.0,32.0,2,164,4.0,60.0,54.0
0.005,17,2,175,1,65,0.0,37.0,37.0,1,110,0.0,82.0,82.0
0.015,6,10,1990,5,911,3.0,643.0,643.0,5,1079,3.0,811.0,811.0
240.27,6,42,8719,21,5686,12013.0,2883.0,573.0,21,3033,12013.0,580.0,241.0
0.006,6,10,1547,5,764,1.0,496.0,496.0,5,783,1.0,515.0,515.0
770.745,6,79,33517,40,8012,19762.0,1073.0,591.0,39,25505,20282.0,1402.0,869.0
0.001,17,2,180,1,66,0.0,38.0,38.0,1,114,0.0,86.0,86.0
0.012,6,10,1972,5,910,2.0,642.0,642.0,5,1062,3.0,794.0,794.0
0.004,6,10,1989,5,927,1.0,659.0,659.0,5,1062,1.0,794.0,794.0
11.195,17,28,4422,14,1994,849.0,269.0,114.0,14,2428,848.0,587.0,145.0
172.498,17,84,12142,42,2806,4207.0,44.0,38.0,42,9336,4207.0,239.0,194.0
0.073,6,10,1506,5,395,16.0,127.0,127.0,5,1111,16.0,843.0,843.0
0.005,17,2,170,1,65,0.0,37.0,37.0,1,105,0.0,77.0,77.0
0.009,6,10,1643,5,860,2.0,592.0,592.0,5,783,2.0,515.0,515.0
0.083,6,10,1506,5,395,18.0,127.0,127.0,5,1111,17.0,843.0,843.0
0.004,6,10,2000,5,927,1.0,659.0,659.0,5,1073,1.0,805.0,805.0
0.003,17,2,136,1,60,0.0,32.0,32.0,1,76,0.0,48.0,48.0
0.004,6,10,1779,5,928,1.0,660.0,660.0,5,851,1.0,583.0,583.0
0.082,6,10,1506,5,395,18.0,127.0,127.0,5,1111,19.0,843.0,843.0
0.094,6,10,1506,5,395,21.0,127.0,127.0,5,1111,22.0,843.0,843.0
0.091,6,10,1506,5,395,19.0,127.0,127.0,5,1111,18.0,843.0,843.0
0.086,6,10,1506,5,395,17.0,127.0,127.0,5,1111,20.0,843.0,843.0
0.007,6,10,1779,5,928,1.0,660.0,660.0,5,851,1.0,583.0,583.0
0.004,17,2,148,1,60,0.0,32.0,32.0,1,88,0.0,60.0,60.0
0.001,17,2,180,1,66,0.0,38.0,38.0,1,114,0.0,86.0,86.0
0.005,6,10,2007,5,928,1.0,660.0,660.0,5,1079,1.0,811.0,811.0
0.102,6,10,1506,5,395,21.0,127.0,127.0,5,1111,22.0,843.0,843.0
0.005,6,10,1989,5,927,1.0,659.0,659.0,5,1062,1.0,794.0,794.0
0.005,6,10,1689,5,839,1.0,571.0,571.0,5,850,1.0,582.0,582.0
40.039,17,10,676,5,460,10008.0,104.0,64.0,5,216,10008.0,20.0,15.0
0.011,6,10,1677,5,827,2.0,559.0,559.0,5,850,2.0,582.0,582.0
0.001,17,2,136,1,60,0.0,32.0,32.0,1,76,0.0,48.0,48.0
0.189,6,10,1506,5,395,42.0,127.0,127.0,5,1111,44.0,843.0,843.0
11.203,17,28,4394,14,1994,849.0,269.0,114.0,14,2400,849.0,587.0,143.0
0.004,6,10,2007,5,928,1.0,660.0,660.0,5,1079,1.0,811.0,811.0
1.071,6,30,12351,17,3300,66.0,1360.0,517.0,13,9051,74.0,2720.0,1064.0
0.167,6,10,1506,5,395,39.0,127.0,127.0,5,1111,38.0,843.0,843.0
0.005,17,2,164,1,74,0.0,46.0,46.0,1,90,0.0,62.0,62.0
0.037,17,2,184,1,61,0.0,33.0,33.0,1,123,0.0,95.0,95.0
0.006,17,2,170,1,65,0.0,37.0,37.0,1,105,0.0,77.0,77.0
40.112,17,10,676,5,460,10026.0,104.0,64.0,5,216,10027.0,20.0,15.0
0.007,6,10,1990,5,911,1.0,643.0,643.0,5,1079,1.0,811.0,811.0
0.005,17,2,170,1,65,0.0,37.0,37.0,1,105,0.0,77.0,77.0
40.059,17,10,676,5,460,10012.0,104.0,64.0,5,216,10014.0,20.0,15.0
360.028,6,15,2515,9,1946,45003.0,494.0,494.0,6,569,72004.0,83.0,83.0
0.014,6,10,1972,5,910,3.0,642.0,642.0,5,1062,3.0,794.0,794.0
40.059,17,10,676,5,460,10013.0,104.0,64.0,5,216,10013.0,20.0,15.0
0.009,6,12,1926,6,1189,1.0,659.0,434.0,6,737,1.0,417.0,417.0
0.006,17,2,180,1,66,0.0,38.0,38.0,1,114,0.0,86.0,86.0
0.017,6,10,1990,5,911,4.0,643.0,643.0,5,1079,4.0,811.0,811.0
0.009,6,14,3787,7,497,1.0,125.0,125.0,7,3290,1.0,1448.0,972.0
15.083,17,16,9331,9,7293,1881.0,1350.0,782.0,7,2038,2508.0,1350.0,263.0
0.014,6,10,1677,5,827,3.0,559.0,559.0,5,850,3.0,582.0,582.0
0.037,17,2,136,1,60,0.0,32.0,32.0,1,76,0.0,48.0,48.0
0.013,6,10,1989,5,910,3.0,642.0,642.0,5,1079,3.0,811.0,811.0
0.006,6,10,1643,5,860,1.0,592.0,592.0,5,783,1.0,515.0,515.0
0.005,17,2,255,1,82,0.0,54.0,54.0,1,173,0.0,145.0,145.0
0.012,6,10,1983,5,910,2.0,642.0,642.0,5,1073,3.0,805.0,805.0
0.005,6,10,2006,5,927,1.0,659.0,659.0,5,1079,1.0,811.0,811.0
0.001,17,2,164,1,74,0.0,46.0,46.0,1,90,0.0,62.0,62.0
0.006,6,10,1689,5,839,1.0,571.0,571.0,5,850,1.0,582.0,582.0
0.005,6,10,1989,5,927,1.0,659.0,659.0,5,1062,1.0,794.0,794.0
0.132,17,4,284,2,120,0.0,32.0,32.0,2,164,129.0,60.0,54.0
0.008,17,2,170,1,65,0.0,37.0,37.0,1,105,0.0,77.0,77.0
0.011,6,10,1972,5,910,2.0,642.0,642.0,5,1062,2.0,794.0,794.0
0.022,6,10,1972,5,910,5.0,642.0,642.0,5,1062,5.0,794.0,794.0
0.005,6,10,2006,5,927,1.0,659.0,659.0,5,1079,1.0,811.0,811.0
174.303,17,80,11347,40,2664,4469.0,44.0,38.0,40,8683,4469.0,261.0,189.0
0.214,6,16,2670,8,1396,30.0,533.0,324.0,8,1274,19.0,529.0,212.0
0.005,6,10,2006,5,927,1.0,659.0,659.0,5,1079,1.0,811.0,811.0
0.017,17,2,136,1,60,0.0,32.0,32.0,1,76,0.0,48.0,48.0
1770.468,6,83,4368,42,2210,43181.0,26.0,26.0,41,2158,44260.0,26.0,26.0
0.012,6,10,1983,5,910,2.0,642.0,642.0,5,1073,3.0,805.0,805.0
0.004,6,10,2007,5,928,1.0,660.0,660.0,5,1079,1.0,811.0,811.0
0.004,17,2,136,1,60,0.0,32.0,32.0,1,76,0.0,48.0,48.0
0.01,6,10,1762,5,911,2.0,643.0,643.0,5,851,2.0,583.0,583.0
0.013,6,10,1989,5,910,3.0,642.0,642.0,5,1079,3.0,811.0,811.0
0.005,6,10,1854,5,889,1.0,621.0,621.0,5,965,1.0,697.0,697.0
0.008,6,10,1983,5,910,2.0,642.0,642.0,5,1073,2.0,805.0,805.0
0.066,17,8,3613,4,1874,22.0,1350.0,440.0,4,1739,11.0,1350.0,406.0
0.006,17,2,154,1,69,0.0,41.0,41.0,1,85,0.0,57.0,57.0
0.024,6,10,1990,5,911,6.0,643.0,643.0,5,1079,6.0,811.0,811.0
0.097,6,10,1506,5,395,20.0,127.0,127.0,5,1111,19.0,843.0,843.0
0.004,6,10,1774,5,923,1.0,655.0,655.0,5,851,1.0,583.0,583.0
0.005,17,2,170,1,65,0.0,37.0,37.0,1,105,0.0,77.0,77.0
0.004,6,10,2006,5,927,1.0,659.0,659.0,5,1079,1.0,811.0,811.0
0.004,17,2,148,1,60,0.0,32.0,32.0,1,88,0.0,60.0,60.0
0.004,6,10,1989,5,927,1.0,659.0,659.0,5,1062,1.0,794.0,794.0
0.02,6,10,1972,5,910,4.0,642.0,642.0,5,1062,4.0,794.0,794.0
0.012,6,10,1989,5,910,3.0,642.0,642.0,5,1079,3.0,811.0,811.0
0.005,6,10,2006,5,927,1.0,659.0,659.0,5,1079,1.0,811.0,811.0
0.112,6,10,1506,5,395,24.0,127.0,127.0,5,1111,24.0,843.0,843.0
163.454,17,78,11131,39,2610,4301.0,44.0,38.0,39,8521,4300.0,239.0,190.0
0.005,6,10,1989,5,927,1.0,659.0,659.0,5,1062,1.0,794.0,794.0
0.015,6,10,1762,5,911,3.0,643.0,643.0,5,851,3.0,583.0,583.0
169.111,17,82,12075,41,2762,4227.0,44.0,39.0,41,9313,4227.0,239.0,199.0
0.005,6,14,3742,8,504,0.0,80.0,80.0,6,3238,1.0,1470.0,1459.0
0.014,6,10,1983,5,910,3.0,642.0,642.0,5,1073,3.0,805.0,805.0
0.005,6,10,1989,5,927,1.0,659.0,659.0,5,1062,1.0,794.0,794.0
0.083,6,10,1506,5,395,19.0,127.0,127.0,5,1111,19.0,843.0,843.0
0.128,6,10,1506,5,395,30.0,127.0,127.0,5,1111,31.0,843.0,843.0
0.036,17,4,284,2,120,0.0,32.0,32.0,2,164,33.0,60.0,54.0
0.025,6,10,1989,5,910,6.0,642.0,642.0,5,1079,6.0,811.0,811.0
292.249,6,399,348512,187,21286,1571.0,2736.0,888.0,212,327226,1385.0,2804.0,1596.0
173.472,17,92,13253,46,3077,3854.0,44.0,38.0,46,10176,3854.0,279.0,193.0
1772.704,6,298,97415,184,86256,9686.0,2001.0,696.0,114,11159,15687.0,452.0,70.0
0.113,6,10,1506,5,395,27.0,127.0,127.0,5,1111,25.0,843.0,843.0
0.117,6,10,1506,5,395,25.0,127.0,127.0,5,1111,26.0,843.0,843.0
0.013,6,10,1983,5,910,3.0,642.0,642.0,5,1073,3.0,805.0,805.0
0.005,17,2,148,1,60,0.0,32.0,32.0,1,88,0.0,60.0,60.0
0.005,6,10,1989,5,927,1.0,659.0,659.0,5,1062,1.0,794.0,794.0
0.015,6,10,1762,5,911,3.0,643.0,643.0,5,851,3.0,583.0,583.0
0.006,6,10,1547,5,764,1.0,496.0,496.0,5,783,1.0,515.0,515.0
0.076,6,10,1506,5,395,17.0,127.0,127.0,5,1111,15.0,843.0,843.0
40.068,17,10,676,5,460,10015.0,104.0,64.0,5,216,10016.0,20.0,15.0
0.072,6,10,1506,5,395,15.0,127.0,127.0,5,1111,15.0,843.0,843.0
0.132,6,10,1506,5,395,29.0,127.0,127.0,5,1111,31.0,843.0,843.0
170.331,17,78,11035,39,2592,4482.0,44.0,38.0,39,8443,4482.0,261.0,188.0
0.008,6,10,1990,5,911,2.0,643.0,643.0,5,1079,1.0,811.0,811.0
0.092,6,10,1506,5,395,21.0,127.0,127.0,5,1111,21.0,843.0,843.0
0.004,17,2,144,1,64,0.0,36.0,36.0,1,80,0.0,52.0,52.0
0.01,6,10,1983,5,910,2.0,642.0,642.0,5,1073,2.0,805.0,805.0
10.766,17,28,4421,14,1994,819.0,269.0,114.0,14,2427,819.0,586.0,145.0
40.064,17,10,676,5,460,10015.0,104.0,64.0,5,216,10015.0,20.0,15.0
240.131,6,32,9623,16,7087,16008.0,2159.0,695.0,16,2536,16008.0,580.0,212.0
0.042,17,2,170,1,65,0.0,37.0,37.0,1,105,0.0,77.0,77.0
0.005,6,10,2006,5,927,1.0,659.0,659.0,5,1079,1.0,811.0,811.0
0.014,6,10,1631,5,848,3.0,580.0,580.0,5,783,3.0,515.0,515.0
0.133,17,2,80,1,32,0.0,4.0,4.0,1,48,0.0,20.0,20.0
0.024,6,10,1631,5,848,6.0,580.0,580.0,5,783,5.0,515.0,515.0
0.005,6,10,1854,5,889,1.0,621.0,621.0,5,965,1.0,697.0,697.0
0.005,17,2,164,1,74,0.0,46.0,46.0,1,90,0.0,62.0,62.0
0.114,17,2,164,1,74,0.0,46.0,46.0,1,90,0.0,62.0,62.0
0.007,17,2,194,1,59,0.0,31.0,31.0,1,135,0.0,107.0,107.0
0.015,6,10,1989,5,910,3.0,642.0,642.0,5,1079,3.0,811.0,811.0
0.009,6,10,1989,5,910,2.0,642.0,642.0,5,1079,2.0,811.0,811.0
0.072,6,10,1506,5,395,14.0,127.0,127.0,5,1111,16.0,843.0,843.0
0.089,6,10,1506,5,395,18.0,127.0,127.0,5,1111,19.0,843.0,843.0
0.011,6,10,1972,5,910,2.0,642.0,642.0,5,1062,2.0,794.0,794.0
0.125,6,10,1506,5,395,27.0,127.0,127.0,5,1111,29.0,843.0,843.0
0.005,17,2,180,1,66,0.0,38.0,38.0,1,114,0.0,86.0,86.0
240.015,6,9,787,5,488,60003.0,232.0,232.0,4,299,80003.0,83.0,83.0
0.004,6,10,2006,5,927,1.0,659.0,659.0,5,1079,1.0,811.0,811.0
0.012,6,10,1983,5,910,2.0,642.0,642.0,5,1073,2.0,805.0,805.0
0.006,17,2,213,1,69,0.0,41.0,41.0,1,144,0.0,116.0,116.0
0.005,6,10,2006,5,927,1.0,659.0,659.0,5,1079,1.0,811.0,811.0
0.057,17,2,152,1,76,0.0,48.0,48.0,1,76,0.0,48.0,48.0
0.083,6,10,1506,5,395,19.0,127.0,127.0,5,1111,16.0,843.0,843.0
0.005,6,10,1989,5,927,1.0,659.0,659.0,5,1062,1.0,794.0,794.0
0.007,6,10,1762,5,911,1.0,643.0,643.0,5,851,1.0,583.0,583.0
0.004,17,2,136,1,60,0.0,32.0,32.0,1,76,0.0,48.0,48.0
0.073,6,10,1506,5,395,17.0,127.0,127.0,5,1111,14.0,843.0,843.0
0.116,6,10,1506,5,395,28.0,127.0,127.0,5,1111,24.0,843.0,843.0
240.52,6,36,13300,18,6512,14148.0,1569.0,928.0,18,6788,14148.0,1656.0,649.0
0.006,6,10,1547,5,764,1.0,496.0,496.0,5,783,1.0,515.0,515.0
0.004,6,10,2000,5,927,1.0,659.0,659.0,5,1073,1.0,805.0,805.0
0.005,6,10,2006,5,927,1.0,659.0,659.0,5,1079,1.0,811.0,811.0
0.004,17,2,136,1,60,0.0,32.0,32.0,1,76,0.0,48.0,48.0
0.129,17,2,80,1,32,0.0,4.0,4.0,1,48,0.0,20.0,20.0
0.005,6,10,2000,5,927,1.0,659.0,659.0,5,1073,1.0,805.0,805.0
0.085,6,10,1506,5,395,20.0,127.0,127.0,5,1111,19.0,843.0,843.0
0.005,6,10,1989,5,927,1.0,659.0,659.0,5,1062,1.0,794.0,794.0
0.004,17,2,136,1,60,0.0,32.0,32.0,1,76,0.0,48.0,48.0
0.091,6,10,1506,5,395,18.0,127.0,127.0,5,1111,17.0,843.0,843.0
0.067,6,10,1506,5,395,15.0,127.0,127.0,5,1111,15.0,843.0,843.0
0.092,6,10,1506,5,395,16.0,127.0,127.0,5,1111,21.0,843.0,843.0
311.915,17,20,1124,10,716,34643.0,48.0,43.0,10,408,34643.0,20.0,12.0
0.042,17,4,284,2,120,0.0,32.0,32.0,2,164,39.0,60.0,54.0
0.005,17,2,230,1,68,0.0,40.0,40.0,1,162,0.0,134.0,134.0
0.008,6,12,1926,6,1189,1.0,659.0,434.0,6,737,1.0,417.0,417.0
300.33,6,16,2170,9,684,37520.0,146.0,146.0,7,1486,50027.0,419.0,398.0
0.011,17,2,214,1,75,0.0,47.0,47.0,1,139,0.0,111.0,111.0
0.016,6,10,1972,5,910,4.0,642.0,642.0,5,1062,4.0,794.0,794.0
0.014,6,10,1631,5,848,3.0,580.0,580.0,5,783,3.0,515.0,515.0
0.003,17,2,148,1,60,0.0,32.0,32.0,1,88,0.0,60.0,60.0
0.101,6,10,1506,5,395,21.0,127.0,127.0,5,1111,24.0,843.0,843.0
0.005,17,2,180,1,58,0.0,30.0,30.0,1,122,0.0,94.0,94.0
0.005,17,2,179,1,71,0.0,43.0,43.0,1,108,0.0,80.0,80.0
1771.559,17,120,11460,60,5460,30026.0,63.0,63.0,60,6000,30026.0,72.0,72.0
0.008,6,10,1989,5,910,2.0,642.0,642.0,5,1079,1.0,811.0,811.0
0.018,6,10,1989,5,910,4.0,642.0,642.0,5,1079,4.0,811.0,811.0
0.044,17,4,580,2,122,0.0,33.0,33.0,2,458,41.0,307.0,201.0
0.009,17,2,132,1,58,0.0,30.0,30.0,1,74,0.0,46.0,46.0
0.003,17,2,136,1,60,0.0,32.0,32.0,1,76,0.0,48.0,48.0
0.013,6,10,1990,5,911,3.0,643.0,643.0,5,1079,3.0,811.0,811.0
0.087,6,10,1506,5,395,19.0,127.0,127.0,5,1111,17.0,843.0,843.0
0.03,6,10,1989,5,910,7.0,642.0,642.0,5,1079,7.0,811.0,811.0
0.007,6,12,1698,6,863,1.0,327.0,271.0,6,835,1.0,515.0,515.0
0.005,6,10,1774,5,923,1.0,655.0,655.0,5,851,1.0,583.0,583.0
40.06,17,10,676,5,460,10012.0,104.0,64.0,5,216,10014.0,20.0,15.0
0.014,6,10,1990,5,911,3.0,643.0,643.0,5,1079,3.0,811.0,811.0
0.091,6,10,1506,5,395,18.0,127.0,127.0,5,1111,20.0,843.0,843.0
0.005,6,13,3747,7,509,0.0,137.0,137.0,6,3238,1.0,1470.0,1459.0
0.041,6,10,1677,5,827,10.0,559.0,559.0,5,850,10.0,582.0,582.0
0.004,6,10,1989,5,927,1.0,659.0,659.0,5,1062,1.0,794.0,794.0
0.027,6,10,1989,5,910,6.0,642.0,642.0,5,1079,6.0,811.0,811.0
0.112,6,10,1506,5,395,25.0,127.0,127.0,5,1111,26.0,843.0,843.0
0.013,6,10,1762,5,911,3.0,643.0,643.0,5,851,3.0,583.0,583.0
0.006,17,2,230,1,68,0.0,40.0,40.0,1,162,0.0,134.0,134.0
0.005,6,10,2006,5,927,1.0,659.0,659.0,5,1079,1.0,811.0,811.0
0.018,6,10,1989,5,910,4.0,642.0,642.0,5,1079,4.0,811.0,811.0
40.06,17,10,676,5,460,10014.0,104.0,64.0,5,216,10013.0,20.0,15.0
0.001,17,2,164,1,74,0.0,46.0,46.0,1,90,0.0,62.0,62.0
98.129,6,39,10380,21,4862,4898.0,1360.0,665.0,18,5518,5762.0,2667.0,435.0
0.085,6,10,1506,5,395,19.0,127.0,127.0,5,1111,20.0,843.0,843.0
0.108,6,10,1506,5,395,22.0,127.0,127.0,5,1111,22.0,843.0,843.0
51.93,58,5,360,4,288,17310.0,24.0,24.0,1,72,0.0,24.0,24.0
0.097,6,10,1506,5,395,24.0,127.0,127.0,5,1111,22.0,843.0,843.0
0.005,6,10,2006,5,927,1.0,659.0,659.0,5,1079,1.0,811.0,811.0
0.006,6,10,1854,5,889,1.0,621.0,621.0,5,965,1.0,697.0,697.0
240.094,6,28,7040,14,4568,18468.0,1368.0,480.0,14,2472,18468.0,580.0,217.0
0.067,6,10,1506,5,395,16.0,127.0,127.0,5,1111,14.0,843.0,843.0
0.017,6,10,1972,5,910,4.0,642.0,642.0,5,1062,4.0,794.0,794.0
0.003,17,2,186,1,61,0.0,33.0,33.0,1,125,0.0,97.0,97.0
28.455,6,38,11259,19,5701,489.0,1836.0,981.0,19,5558,1571.0,2667.0,435.0
0.004,6,10,1779,5,928,1.0,660.0,660.0,5,851,1.0,583.0,583.0
0.012,6,10,1983,5,910,2.0,642.0,642.0,5,1073,3.0,805.0,805.0
0.146,17,2,152,1,76,0.0,48.0,48.0,1,76,0.0,48.0,48.0
0.1,6,10,1506,5,395,22.0,127.0,127.0,5,1111,19.0,843.0,843.0
0.005,6,13,3690,7,452,0.0,80.0,80.0,6,3238,1.0,1470.0,1459.0
0.074,6,10,1506,5,395,16.0,127.0,127.0,5,1111,17.0,843.0,843.0
0.005,6,10,2007,5,928,1.0,660.0,660.0,5,1079,1.0,811.0,811.0
1727.91,6,45,2790,30,1725,59583.0,35.0,35.0,15,1065,123417.0,31.0,31.0
0.005,6,10,1689,5,839,1.0,571.0,571.0,5,850,1.0,582.0,582.0
0.027,6,13,3913,7,495,4.0,123.0,123.0,6,3418,5.0,1650.0,1549.0
0.021,6,10,1631,5,848,5.0,580.0,580.0,5,783,5.0,515.0,515.0
0.005,6,10,1989,5,927,1.0,659.0,659.0,5,1062,1.0,794.0,794.0
1730.389,6,45,2790,30,1725,59668.0,35.0,35.0,15,1065,123594.0,31.0,31.0
40.058,17,10,676,5,460,10013.0,104.0,64.0,5,216,10013.0,20.0,15.0
0.011,17,2,148,1,60,0.0,32.0,32.0,1,88,0.0,60.0,60.0
0.005,6,10,1774,5,923,1.0,655.0,655.0,5,851,1.0,583.0,583.0
0.005,17,2,144,1,64,0.0,36.0,36.0,1,80,0.0,52.0,52.0
0.014,6,13,3735,7,497,2.0,125.0,125.0,6,3238,2.0,1470.0,1459.0
0.065,6,10,1506,5,395,15.0,127.0,127.0,5,1111,15.0,843.0,843.0
0.003,17,2,148,1,60,0.0,32.0,32.0,1,88,0.0,60.0,60.0
0.019,6,10,1990,5,911,4.0,643.0,643.0,5,1079,4.0,811.0,811.0
0.011,17,4,284,2,120,0.0,32.0,32.0,2,164,0.0,60.0,54.0
0.005,6,10,1774,5,923,1.0,655.0,655.0,5,851,1.0,583.0,583.0
0.783,6,22,5168,11,1138,65.0,267.0,115.0,11,4030,65.0,1414.0,597.0
0.216,6,16,2778,8,1396,30.0,533.0,324.0,8,1382,20.0,529.0,239.0
0.005,6,10,2007,5,928,1.0,660.0,660.0,5,1079,1.0,811.0,811.0
0.012,6,10,1631,5,848,3.0,580.0,580.0,5,783,2.0,515.0,515.0
40.062,17,10,676,5,460,10014.0,104.0,64.0,5,216,10014.0,20.0,15.0
0.005,6,10,2006,5,927,1.0,659.0,659.0,5,1079,1.0,811.0,811.0
0.004,6,10,2000,5,927,1.0,659.0,659.0,5,1073,1.0,805.0,805.0
66.021,6,24,9000,14,2432,5078.0,1002.0,424.0,10,6568,7316.0,2241.0,1006.0
15.072,17,15,9238,8,6902,2149.0,1350.0,834.0,7,2336,2507.0,1350.0,305.0
0.005,6,10,2007,5,928,1.0,660.0,660.0,5,1079,1.0,811.0,811.0
300.077,6,42,10290,23,4687,13632.0,1360.0,620.0,19,5603,16660.0,2667.0,402.0
0.005,6,10,2007,5,928,1.0,660.0,660.0,5,1079,1.0,811.0,811.0
0.018,6,10,1983,5,910,4.0,642.0,642.0,5,1073,4.0,805.0,805.0
0.006,6,10,1702,5,863,1.0,595.0,595.0,5,839,1.0,571.0,571.0
0.122,6,10,1506,5,395,28.0,127.0,127.0,5,1111,26.0,843.0,843.0
0.024,6,10,1989,5,910,6.0,642.0,642.0,5,1079,5.0,811.0,811.0
0.004,17,2,148,1,60,0.0,32.0,32.0,1,88,0.0,60.0,60.0
0.004,6,10,2006,5,927,1.0,659.0,659.0,5,1079,1.0,811.0,811.0
0.014,6,10,1989,5,910,3.0,642.0,642.0,5,1079,3.0,811.0,811.0
0.038,17,2,148,1,60,0.0,32.0,32.0,1,88,0.0,60.0,60.0
0.074,6,10,1506,5,395,16.0,127.0,127.0,5,1111,14.0,843.0,843.0
0.091,6,10,1506,5,395,21.0,127.0,127.0,5,1111,19.0,843.0,843.0
15.073,17,15,9238,8,6902,2149.0,1350.0,834.0,7,2336,2507.0,1350.0,305.0
15.072,17,15,9238,8,6902,2149.0,1350.0,834.0,7,2336,2507.0,1350.0,305.0
0.005,6,10,1689,5,839,1.0,571.0,571.0,5,850,1.0,582.0,582.0
0.001,17,2,154,1,69,0.0,41.0,41.0,1,85,0.0,57.0,57.0
0.004,17,2,144,1,64,0.0,36.0,36.0,1,80,0.0,52.0,52.0
0.004,6,10,2007,5,928,1.0,660.0,660.0,5,1079,1.0,811.0,811.0
0.041,17,2,170,1,65,0.0,37.0,37.0,1,105,0.0,77.0,77.0
0.004,6,10,1989,5,927,1.0,659.0,659.0,5,1062,1.0,794.0,794.0
0.005,6,10,1689,5,839,1.0,571.0,571.0,5,850,1.0,582.0,582.0
0.009,6,10,1762,5,911,2.0,643.0,643.0,5,851,2.0,583.0,583.0
0.015,6,10,1972,5,910,3.0,642.0,642.0,5,1062,3.0,794.0,794.0
0.01,6,10,1989,5,910,2.0,642.0,642.0,5,1079,2.0,811.0,811.0
0.005,6,10,1989,5,927,1.0,659.0,659.0,5,1062,1.0,794.0,794.0
0.001,17,2,180,1,65,0.0,37.0,37.0,1,115,0.0,87.0,87.0
10.818,17,28,4419,14,1994,823.0,269.0,114.0,14,2425,823.0,588.0,145.0
0.091,6,10,1506,5,395,19.0,127.0,127.0,5,1111,21.0,843.0,843.0
0.034,6,10,1677,5,827,8.0,559.0,559.0,5,850,8.0,582.0,582.0
0.004,6,10,1702,5,863,1.0,595.0,595.0,5,839,0.0,571.0,571.0
0.096,6,10,1506,5,395,19.0,127.0,127.0,5,1111,19.0,843.0,843.0
0.007,17,2,179,1,71,0.0,43.0,43.0,1,108,0.0,80.0,80.0
0.015,6,10,1990,5,911,3.0,643.0,643.0,5,1079,3.0,811.0,811.0
0.013,6,6,716,3,458,5.0,302.0,302.0,3,258,5.0,102.0,102.0
0.009,6,10,1990,5,911,2.0,643.0,643.0,5,1079,2.0,811.0,811.0
0.004,17,2,136,1,60,0.0,32.0,32.0,1,76,0.0,48.0,48.0
0.106,6,10,1506,5,395,24.0,127.0,127.0,5,1111,22.0,843.0,843.0
0.001,17,2,140,1,62,0.0,34.0,34.0,1,78,0.0,50.0,50.0
0.005,6,10,1989,5,927,1.0,659.0,659.0,5,1062,1.0,794.0,794.0
0.075,6,10,1506,5,395,15.0,127.0,127.0,5,1111,18.0,843.0,843.0
0.005,6,10,2006,5,927,1.0,659.0,659.0,5,1079,1.0,811.0,811.0
0.08,6,10,1506,5,395,17.0,127.0,127.0,5,1111,18.0,843.0,843.0
0.006,6,13,3747,7,509,0.0,137.0,137.0,6,3238,1.0,1470.0,1459.0
0.077,6,10,1506,5,395,14.0,127.0,127.0,5,1111,18.0,843.0,843.0
0.005,6,10,2007,5,928,1.0,660.0,660.0,5,1079,1.0,811.0,811.0
0.006,6,10,1989,5,927,1.0,659.0,659.0,5,1062,1.0,794.0,794.0
0.005,6,10,2006,5,927,1.0,659.0,659.0,5,1079,1.0,811.0,811.0
0.005,6,10,1854,5,889,1.0,621.0,621.0,5,965,1.0,697.0,697.0
0.006,6,10,1779,5,928,1.0,660.0,660.0,5,851,1.0,583.0,583.0
0.004,6,14,3742,8,504,0.0,80.0,80.0,6,3238,0.0,1470.0,1459.0
0.005,6,10,2006,5,927,1.0,659.0,659.0,5,1079,1.0,811.0,811.0
0.12,6,10,1506,5,395,27.0,127.0,127.0,5,1111,26.0,843.0,843.0
114.298,6,22,9233,11,1575,72.0,794.0,367.0,11,7658,11417.0,1360.0,1029.0
0.004,17,2,170,1,65,0.0,37.0,37.0,1,105,0.0,77.0,77.0
0.02,6,10,1762,5,911,5.0,643.0,643.0,5,851,4.0,583.0,583.0
0.005,6,10,2006,5,927,1.0,659.0,659.0,5,1079,1.0,811.0,811.0
0.051,6,10,1989,5,910,12.0,642.0,642.0,5,1079,12.0,811.0,811.0
0.006,6,10,1643,5,860,1.0,592.0,592.0,5,783,1.0,515.0,515.0
0.04,6,10,1983,5,910,10.0,642.0,642.0,5,1073,10.0,805.0,805.0
5.075,6,20,5871,11,1384,507.0,474.0,201.0,9,4487,634.0,1925.0,804.0
241.888,6,302,343431,118,17644,2067.0,2736.0,885.0,184,325787,1321.0,4157.0,1817.0
0.006,6,10,1689,5,839,1.0,571.0,571.0,5,850,1.0,582.0,582.0
0.008,6,12,1926,6,1189,1.0,659.0,434.0,6,737,1.0,417.0,417.0
0.088,17,2,152,1,76,0.0,48.0,48.0,1,76,0.0,48.0,48.0
0.013,6,10,1972,5,910,3.0,642.0,642.0,5,1062,3.0,794.0,794.0
0.011,6,10,1972,5,910,2.0,642.0,642.0,5,1062,2.0,794.0,794.0
0.005,6,10,1689,5,839,1.0,571.0,571.0,5,850,1.0,582.0,582.0
0.003,6,10,1702,5,863,0.0,595.0,595.0,5,839,0.0,571.0,571.0
0.008,6,10,1989,5,910,2.0,642.0,642.0,5,1079,2.0,811.0,811.0
0.004,6,10,2007,5,928,1.0,660.0,660.0,5,1079,1.0,811.0,811.0
0.047,6,10,1989,5,910,11.0,642.0,642.0,5,1079,11.0,811.0,811.0
160.583,17,76,10718,38,2537,4339.0,44.0,38.0,38,8181,4340.0,239.0,187.0
0.094,6,10,1506,5,395,19.0,127.0,127.0,5,1111,22.0,843.0,843.0
0.005,6,10,1774,5,923,1.0,655.0,655.0,5,851,1.0,583.0,583.0
0.006,6,10,1547,5,764,1.0,496.0,496.0,5,783,1.0,515.0,515.0
0.004,6,10,1779,5,928,1.0,660.0,660.0,5,851,1.0,583.0,583.0
0.004,6,10,1774,5,923,1.0,655.0,655.0,5,851,1.0,583.0,583.0
0.088,6,10,1506,5,395,19.0,127.0,127.0,5,1111,18.0,843.0,843.0
0.13,17,2,148,1,60,0.0,32.0,32.0,1,88,0.0,60.0,60.0
1796.503,6,488,99332,244,87982,7393.0,421.0,365.0,244,11350,7391.0,53.0,53.0
354.059,6,21,1795,16,1030,23603.0,190.0,190.0,5,765,60003.0,464.0,248.0
0.011,6,10,1631,5,848,2.0,580.0,580.0,5,783,2.0,515.0,515.0
0.005,6,10,1689,5,839,1.0,571.0,571.0,5,850,1.0,582.0,582.0
0.088,6,10,1506,5,395,20.0,127.0,127.0,5,1111,18.0,843.0,843.0
0.005,17,2,144,1,64,0.0,36.0,36.0,1,80,0.0,52.0,52.0
0.008,17,2,170,1,65,0.0,37.0,37.0,1,105,0.0,77.0,77.0
0.007,6,10,1547,5,764,1.0,496.0,496.0,5,783,1.0,515.0,515.0
0.132,6,10,1506,5,395,31.0,127.0,127.0,5,1111,28.0,843.0,843.0
10.828,17,30,5334,15,2290,764.0,269.0,124.0,15,3044,765.0,1146.0,174.0
0.011,6,10,1983,5,910,2.0,642.0,642.0,5,1073,2.0,805.0,805.0
0.018,6,10,1972,5,910,4.0,642.0,642.0,5,1062,4.0,794.0,794.0
0.006,17,2,166,1,75,0.0,47.0,47.0,1,91,0.0,63.0,63.0
1772.206,6,107,6413,60,3537,30036.0,27.0,27.0,47,2876,38525.0,27.0,27.0
0.005,6,10,2007,5,928,1.0,660.0,660.0,5,1079,1.0,811.0,811.0
0.169,6,10,1506,5,395,41.0,127.0,127.0,5,1111,38.0,843.0,843.0
0.041,17,2,152,1,76,0.0,48.0,48.0,1,76,0.0,48.0,48.0
0.006,17,2,166,1,75,0.0,47.0,47.0,1,91,0.0,63.0,63.0
0.14,6,10,1506,5,395,33.0,127.0,127.0,5,1111,31.0,843.0,843.0
0.001,17,2,180,1,65,0.0,37.0,37.0,1,115,0.0,87.0,87.0
0.004,6,10,2007,5,928,1.0,660.0,660.0,5,1079,1.0,811.0,811.0
0.005,6,10,2006,5,927,1.0,659.0,659.0,5,1079,1.0,811.0,811.0
0.037,17,2,136,1,60,0.0,32.0,32.0,1,76,0.0,48.0,48.0
0.004,6,10,2006,5,927,1.0,659.0,659.0,5,1079,1.0,811.0,811.0
0.083,6,10,1506,5,395,13.0,127.0,127.0,5,1111,20.0,843.0,843.0
0.054,17,2,152,1,76,0.0,48.0,48.0,1,76,0.0,48.0,48.0
0.001,17,2,180,1,66,0.0,38.0,38.0,1,114,0.0,86.0,86.0
291.578,6,395,348074,190,21446,1542.0,2736.0,889.0,205,326628,1429.0,2804.0,1654.0
0.008,6,10,1989,5,910,1.0,642.0,642.0,5,1079,2.0,811.0,811.0
0.004,6,10,2000,5,927,1.0,659.0,659.0,5,1073,1.0,805.0,805.0
0.072,6,10,1506,5,395,15.0,127.0,127.0,5,1111,16.0,843.0,843.0
0.006,17,2,170,1,65,0.0,37.0,37.0,1,105,0.0,77.0,77.0
0.126,17,2,148,1,60,0.0,32.0,32.0,1,88,0.0,60.0,60.0
0.005,17,2,179,1,71,0.0,43.0,43.0,1,108,0.0,80.0,80.0
0.008,17,2,194,1,59,0.0,31.0,31.0,1,135,0.0,107.0,107.0
0.007,6,10,1983,5,910,1.0,642.0,642.0,5,1073,1.0,805.0,805.0
40.056,17,10,676,5,460,10013.0,104.0,64.0,5,216,10013.0,20.0,15.0
0.013,6,10,1677,5,827,3.0,559.0,559.0,5,850,3.0,582.0,582.0
0.023,6,10,1983,5,910,5.0,642.0,642.0,5,1073,5.0,805.0,805.0
0.007,6,10,1689,5,839,1.0,571.0,571.0,5,850,1.0,582.0,582.0
0.004,6,10,1779,5,928,1.0,660.0,660.0,5,851,1.0,583.0,583.0
0.006,6,10,1547,5,764,1.0,496.0,496.0,5,783,1.0,515.0,515.0
0.718,17,404,350215,142,23117,5.0,1350.0,134.0,262,327098,2.0,1350.0,1220.0
0.038,17,2,148,1,60,0.0,32.0,32.0,1,88,0.0,60.0,60.0
308.443,17,20,1124,10,716,34253.0,48.0,43.0,10,408,34260.0,20.0,12.0
0.005,6,10,1547,5,764,1.0,496.0,496.0,5,783,1.0,515.0,515.0
0.006,17,2,170,1,65,0.0,37.0,37.0,1,105,0.0,77.0,77.0
0.013,6,10,1983,5,910,3.0,642.0,642.0,5,1073,3.0,805.0,805.0
0.01,6,10,1762,5,911,2.0,643.0,643.0,5,851,2.0,583.0,583.0
0.041,6,10,1989,5,910,10.0,642.0,642.0,5,1079,10.0,811.0,811.0
0.006,6,10,1689,5,839,1.0,571.0,571.0,5,850,1.0,582.0,582.0
0.01,6,10,1989,5,910,2.0,642.0,642.0,5,1079,2.0,811.0,811.0
0.101,6,10,1506,5,395,23.0,127.0,127.0,5,1111,22.0,843.0,843.0
0.008,6,10,1990,5,911,1.0,643.0,643.0,5,1079,1.0,811.0,811.0
0.008,6,10,1972,5,910,2.0,642.0,642.0,5,1062,2.0,794.0,794.0
0.017,6,10,1983,5,910,4.0,642.0,642.0,5,1073,4.0,805.0,805.0
0.004,17,2,144,1,64,0.0,36.0,36.0,1,80,0.0,52.0,52.0
0.013,6,10,1989,5,910,3.0,642.0,642.0,5,1079,3.0,811.0,811.0
0.013,6,10,1990,5,911,3.0,643.0,643.0,5,1079,3.0,811.0,811.0
0.005,6,10,1989,5,927,1.0,659.0,659.0,5,1062,1.0,794.0,794.0
0.005,17,2,166,1,75,0.0,47.0,47.0,1,91,0.0,63.0,63.0
0.016,6,10,1989,5,910,3.0,642.0,642.0,5,1079,3.0,811.0,811.0
40.078,17,10,676,5,460,10014.0,104.0,64.0,5,216,10018.0,20.0,15.0
0.009,6,10,1762,5,911,2.0,643.0,643.0,5,851,2.0,583.0,583.0
0.008,17,2,194,1,59,0.0,31.0,31.0,1,135,0.0,107.0,107.0
0.127,6,10,1506,5,395,29.0,127.0,127.0,5,1111,28.0,843.0,843.0
0.001,17,2,180,1,66,0.0,38.0,38.0,1,114,0.0,86.0,86.0
0.087,6,13,3816,7,578,14.0,206.0,206.0,6,3238,17.0,1470.0,1459.0
0.005,6,10,2007,5,928,1.0,660.0,660.0,5,1079,1.0,811.0,811.0
0.005,6,10,1989,5,927,1.0,659.0,659.0,5,1062,1.0,794.0,794.0
0.13,6,10,1506,5,395,29.0,127.0,127.0,5,1111,25.0,843.0,843.0
0.013,6,10,1990,5,911,3.0,643.0,643.0,5,1079,3.0,811.0,811.0
240.028,6,9,787,5,488,60007.0,232.0,232.0,4,299,80008.0,83.0,83.0
0.001,17,2,179,1,62,0.0,34.0,34.0,1,117,0.0,89.0,89.0
40.075,17,10,676,5,460,10015.0,104.0,64.0,5,216,10018.0,20.0,15.0
0.006,6,10,1547,5,764,1.0,496.0,496.0,5,783,1.0,515.0,515.0
0.017,6,13,3747,7,509,2.0,137.0,137.0,6,3238,3.0,1470.0,1459.0
0.005,6,10,2007,5,928,1.0,660.0,660.0,5,1079,1.0,811.0,811.0
0.004,17,2,136,1,60,0.0,32.0,32.0,1,76,0.0,48.0,48.0
0.004,6,10,2006,5,927,1.0,659.0,659.0,5,1079,1.0,811.0,811.0
0.142,6,10,1506,5,395,34.0,127.0,127.0,5,1111,31.0,843.0,843.0
0.004,6,10,2000,5,927,1.0,659.0,659.0,5,1073,1.0,805.0,805.0
0.146,6,10,1506,5,395,34.0,127.0,127.0,5,1111,32.0,843.0,843.0
0.005,6,10,1854,5,889,1.0,621.0,621.0,5,965,1.0,697.0,697.0
300.31,6,27,7433,16,1409,20020.0,217.0,142.0,11,6024,24027.0,1679.0,777.0
0.072,17,2,184,1,61,0.0,33.0,33.0,1,123,0.0,95.0,95.0
0.006,17,2,164,1,74,0.0,46.0,46.0,1,90,0.0,62.0,62.0
0.003,17,4,284,2,120,0.0,32.0,32.0,2,164,0.0,60.0,54.0
0.007,17,2,136,1,60,0.0,32.0,32.0,1,76,0.0,48.0,48.0
0.005,6,10,2007,5,928,1.0,660.0,660.0,5,1079,1.0,811.0,811.0
0.005,6,10,1989,5,927,1.0,659.0,659.0,5,1062,1.0,794.0,794.0
0.009,6,10,1990,5,911,2.0,643.0,643.0,5,1079,2.0,811.0,811.0
0.066,17,8,3613,4,1874,22.0,1350.0,440.0,4,1739,10.0,1350.0,406.0
368.414,6,22,2313,16,867,24560.0,195.0,195.0,6,1446,4657.0,419.0,398.0
0.006,17,2,194,1,59,0.0,31.0,31.0,1,135,0.0,107.0,107.0
300.96,6,45,15281,24,9414,13085.0,2720.0,1052.0,21,5867,440.0,2667.0,385.0
8.976,6,39,10487,19,4889,498.0,1360.0,682.0,20,5598,461.0,1360.0,398.0
0.001,17,2,194,1,57,0.0,29.0,29.0,1,137,0.0,109.0,109.0
0.123,6,10,1506,5,395,24.0,127.0,127.0,5,1111,25.0,843.0,843.0
52.71,6,50,22181,25,16154,378.0,4080.0,1512.0,25,6027,2189.0,2667.0,385.0
0.095,6,10,1506,5,395,15.0,127.0,127.0,5,1111,20.0,843.0,843.0
240.014,6,9,787,5,488,60003.0,232.0,232.0,4,299,80003.0,83.0,83.0
0.01,6,10,1990,5,911,2.0,643.0,643.0,5,1079,2.0,811.0,811.0
0.003,17,4,284,2,120,0.0,32.0,32.0,2,164,0.0,60.0,54.0
0.038,17,2,170,1,65,0.0,37.0,37.0,1,105,0.0,77.0,77.0
0.012,17,2,136,1,60,0.0,32.0,32.0,1,76,0.0,48.0,48.0
0.008,17,2,299,1,65,0.0,37.0,37.0,1,234,0.0,206.0,206.0
0.001,17,2,180,1,66,0.0,38.0,38.0,1,114,0.0,86.0,86.0
0.014,6,10,1989,5,910,3.0,642.0,642.0,5,1079,3.0,811.0,811.0
0.004,6,10,1774,5,923,1.0,655.0,655.0,5,851,1.0,583.0,583.0
11.171,17,28,4423,14,1994,846.0,269.0,114.0,14,2429,846.0,588.0,145.0
0.005,17,2,213,1,69,0.0,41.0,41.0,1,144,0.0,116.0,116.0
0.016,6,10,1631,5,848,4.0,580.0,580.0,5,783,3.0,515.0,515.0
0.014,6,10,1990,5,911,3.0,643.0,643.0,5,1079,3.0,811.0,811.0
40.06,17,10,676,5,460,10014.0,104.0,64.0,5,216,10013.0,20.0,15.0
0.081,6,10,1506,5,395,18.0,127.0,127.0,5,1111,19.0,843.0,843.0
0.001,17,2,180,1,66,0.0,38.0,38.0,1,114,0.0,86.0,86.0
11.135,17,28,4424,14,1995,844.0,270.0,114.0,14,2429,844.0,588.0,145.0
0.01,6,10,1989,5,910,2.0,642.0,642.0,5,1079,2.0,811.0,811.0
0.004,6,10,1774,5,923,1.0,655.0,655.0,5,851,1.0,583.0,583.0
0.01,6,10,1989,5,910,2.0,642.0,642.0,5,1079,2.0,811.0,811.0
10.84,17,28,4419,14,1995,825.0,270.0,114.0,14,2424,824.0,587.0,145.0
40.087,17,10,676,5,460,10020.0,104.0,64.0,5,216,10021.0,20.0,15.0
0.005,6,10,2000,5,927,1.0,659.0,659.0,5,1073,1.0,805.0,805.0
0.104,6,10,1506,5,395,16.0,127.0,127.0,5,1111,24.0,843.0,843.0
0.008,6,10,1547,5,764,2.0,496.0,496.0,5,783,1.0,515.0,515.0
0.006,6,10,1643,5,860,1.0,592.0,592.0,5,783,1.0,515.0,515.0
40.071,17,10,676,5,460,10015.0,104.0,64.0,5,216,10016.0,20.0,15.0
0.004,6,10,2000,5,927,1.0,659.0,659.0,5,1073,1.0,805.0,805.0
0.004,17,2,136,1,60,0.0,32.0,32.0,1,76,0.0,48.0,48.0
0.068,17,8,3613,4,1874,22.0,1350.0,440.0,4,1739,11.0,1350.0,406.0
0.004,6,10,2006,5,927,1.0,659.0,659.0,5,1079,1.0,811.0,811.0
0.006,6,10,2007,5,928,1.0,660.0,660.0,5,1079,1.0,811.0,811.0
353.983,6,21,1795,16,1030,23598.0,190.0,190.0,5,765,60002.0,464.0,248.0
0.004,17,2,148,1,60,0.0,32.0,32.0,1,88,0.0,60.0,60.0
0.086,6,10,1506,5,395,18.0,127.0,127.0,5,1111,17.0,843.0,843.0
0.01,6,10,1972,5,910,2.0,642.0,642.0,5,1062,2.0,794.0,794.0
1183.129,6,177,21180,72,14545,16663.0,1780.0,207.0,105,6635,11375.0,225.0,51.0
0.006,6,10,1547,5,764,1.0,496.0,496.0,5,783,1.0,515.0,515.0
0.083,6,10,1506,5,395,17.0,127.0,127.0,5,1111,18.0,843.0,843.0
0.068,6,10,1506,5,395,16.0,127.0,127.0,5,1111,16.0,843.0,843.0
0.005,6,10,2006,5,927,1.0,659.0,659.0,5,1079,1.0,811.0,811.0
240.115,6,31,9110,15,6774,17151.0,1898.0,666.0,16,2336,16007.0,580.0,187.0
0.042,17,2,136,1,60,0.0,32.0,32.0,1,76,0.0,48.0,48.0
0.006,6,13,3747,7,509,0.0,137.0,137.0,6,3238,1.0,1470.0,1459.0
0.11,6,10,1506,5,395,26.0,127.0,127.0,5,1111,26.0,843.0,843.0
300.024,6,12,1782,7,1348,50004.0,494.0,494.0,5,434,75005.0,83.0,83.0
0.006,17,2,180,1,66,0.0,38.0,38.0,1,114,0.0,86.0,86.0
0.005,6,10,1643,5,860,1.0,592.0,592.0,5,783,1.0,515.0,515.0
0.006,6,10,1547,5,764,1.0,496.0,496.0,5,783,1.0,515.0,515.0
0.005,17,2,170,1,65,0.0,37.0,37.0,1,105,0.0,77.0,77.0
0.099,6,10,1506,5,395,22.0,127.0,127.0,5,1111,23.0,843.0,843.0
0.005,6,10,1779,5,928,1.0,660.0,660.0,5,851,1.0,583.0,583.0
0.005,6,10,2006,5,927,1.0,659.0,659.0,5,1079,1.0,811.0,811.0
0.011,6,13,3735,7,497,1.0,125.0,125.0,6,3238,2.0,1470.0,1459.0
0.004,6,10,1989,5,927,1.0,659.0,659.0,5,1062,1.0,794.0,794.0
0.008,6,10,1631,5,848,2.0,580.0,580.0,5,783,2.0,515.0,515.0
0.098,6,10,1506,5,395,21.0,127.0,127.0,5,1111,23.0,843.0,843.0
0.005,6,10,2006,5,927,1.0,659.0,659.0,5,1079,1.0,811.0,811.0
0.04,17,2,148,1,60,0.0,32.0,32.0,1,88,0.0,60.0,60.0
0.008,17,2,179,1,71,0.0,43.0,43.0,1,108,0.0,80.0,80.0
0.008,6,10,1990,5,911,1.0,643.0,643.0,5,1079,2.0,811.0,811.0
0.011,6,10,1677,5,827,2.0,559.0,559.0,5,850,2.0,582.0,582.0
0.001,17,2,180,1,66,0.0,38.0,38.0,1,114,0.0,86.0,86.0
0.009,6,10,1989,5,927,2.0,659.0,659.0,5,1062,2.0,794.0,794.0
0.038,17,2,136,1,60,0.0,32.0,32.0,1,76,0.0,48.0,48.0
0.014,6,10,1989,5,910,3.0,642.0,642.0,5,1079,3.0,811.0,811.0
10.867,17,28,4421,14,1994,827.0,269.0,114.0,14,2427,827.0,586.0,145.0
0.066,6,10,1506,5,395,16.0,127.0,127.0,5,1111,13.0,843.0,843.0
0.102,6,10,1506,5,395,22.0,127.0,127.0,5,1111,23.0,843.0,843.0
0.005,17,2,164,1,74,0.0,46.0,46.0,1,90,0.0,62.0,62.0
0.006,6,10,1643,5,860,1.0,592.0,592.0,5,783,1.0,515.0,515.0
240.081,6,16,4480,9,963,30010.0,238.0,166.0,7,3517,40013.0,1402.0,786.0
15.079,17,16,9024,8,6931,2150.0,1350.0,838.0,8,2093,2149.0,1350.0,233.0
0.008,6,10,1989,5,910,2.0,642.0,642.0,5,1079,1.0,811.0,811.0
0.005,6,10,1702,5,863,1.0,595.0,595.0,5,839,1.0,571.0,571.0
241.666,6,393,348179,191,21456,1271.0,2736.0,959.0,202,326723,1202.0,2804.0,1646.0
0.009,6,13,3735,7,497,1.0,125.0,125.0,6,3238,1.0,1470.0,1459.0
40.064,17,10,676,5,460,10015.0,104.0,64.0,5,216,10015.0,20.0,15.0
0.099,6,10,1506,5,395,22.0,127.0,127.0,5,1111,22.0,843.0,843.0
0.132,17,2,170,1,65,0.0,37.0,37.0,1,105,0.0,77.0,77.0
0.015,6,13,3735,7,497,2.0,125.0,125.0,6,3238,2.0,1470.0,1459.0
0.006,6,10,1547,5,764,1.0,496.0,496.0,5,783,1.0,515.0,515.0
311.628,17,20,1124,10,716,34614.0,48.0,43.0,10,408,34613.0,20.0,12.0
0.006,6,10,1689,5,839,1.0,571.0,571.0,5,850,1.0,582.0,582.0
40.075,17,10,676,5,460,10016.0,104.0,64.0,5,216,10018.0,20.0,15.0
0.018,6,10,1972,5,910,4.0,642.0,642.0,5,1062,4.0,794.0,794.0
0.005,6,10,2007,5,928,1.0,660.0,660.0,5,1079,1.0,811.0,811.0
0.085,6,10,1506,5,395,19.0,127.0,127.0,5,1111,20.0,843.0,843.0
0.107,6,10,1506,5,395,22.0,127.0,127.0,5,1111,23.0,843.0,843.0
0.041,17,2,412,1,61,0.0,33.0,33.0,1,351,0.0,323.0,323.0
0.17,6,10,1506,5,395,41.0,127.0,127.0,5,1111,39.0,843.0,843.0
0.001,17,2,136,1,60,0.0,32.0,32.0,1,76,0.0,48.0,48.0
15.168,17,22,12483,11,8939,1514.0,1350.0,784.0,11,3544,1513.0,1350.0,294.0
0.005,6,10,2006,5,927,1.0,659.0,659.0,5,1079,1.0,811.0,811.0
0.006,6,10,1547,5,764,1.0,496.0,496.0,5,783,1.0,515.0,515.0
0.195,6,10,1506,5,395,47.0,127.0,127.0,5,1111,35.0,843.0,843.0
0.005,6,10,2000,5,927,1.0,659.0,659.0,5,1073,1.0,805.0,805.0
0.02,6,10,1989,5,910,4.0,642.0,642.0,5,1079,5.0,811.0,811.0
0.005,6,10,2007,5,928,1.0,660.0,660.0,5,1079,1.0,811.0,811.0
0.016,6,10,1972,5,910,4.0,642.0,642.0,5,1062,3.0,794.0,794.0
0.005,6,10,2006,5,927,1.0,659.0,659.0,5,1079,1.0,811.0,811.0
0.017,6,10,1631,5,848,4.0,580.0,580.0,5,783,4.0,515.0,515.0
0.005,17,2,170,1,65,0.0,37.0,37.0,1,105,0.0,77.0,77.0
0.006,6,10,2007,5,928,1.0,660.0,660.0,5,1079,1.0,811.0,811.0
0.196,6,10,1506,5,395,46.0,127.0,127.0,5,1111,41.0,843.0,843.0
0.006,6,10,1547,5,764,1.0,496.0,496.0,5,783,1.0,515.0,515.0
0.077,6,10,1506,5,395,16.0,127.0,127.0,5,1111,17.0,843.0,843.0
0.019,6,10,1631,5,848,4.0,580.0,580.0,5,783,4.0,515.0,515.0
0.076,6,10,1506,5,395,17.0,127.0,127.0,5,1111,18.0,843.0,843.0
0.021,6,10,1983,5,910,5.0,642.0,642.0,5,1073,5.0,805.0,805.0
0.005,6,10,1643,5,860,1.0,592.0,592.0,5,783,1.0,515.0,515.0
0.087,6,10,1506,5,395,18.0,127.0,127.0,5,1111,19.0,843.0,843.0
167.083,17,82,11709,41,2722,4177.0,44.0,38.0,41,8987,4176.0,239.0,191.0
0.113,6,10,1506,5,395,26.0,127.0,127.0,5,1111,27.0,843.0,843.0
0.014,6,10,1989,5,910,3.0,642.0,642.0,5,1079,3.0,811.0,811.0
0.013,6,10,1990,5,911,3.0,643.0,643.0,5,1079,3.0,811.0,811.0
0.133,17,2,80,1,32,0.0,4.0,4.0,1,48,0.0,20.0,20.0
0.005,6,10,2006,5,927,1.0,659.0,659.0,5,1079,1.0,811.0,811.0
0.001,17,2,164,1,74,0.0,46.0,46.0,1,90,0.0,62.0,62.0
0.006,6,10,2007,5,928,1.0,660.0,660.0,5,1079,1.0,811.0,811.0
178.385,17,72,10098,36,2392,5096.0,44.0,38.0,36,7706,5096.0,239.0,186.0
0.13,6,10,1506,5,395,23.0,127.0,127.0,5,1111,29.0,843.0,843.0
0.006,17,2,293,1,73,0.0,45.0,45.0,1,220,0.0,192.0,192.0
0.513,17,45,24728,24,19856,22.0,1350.0,799.0,21,4872,22.0,1350.0,204.0
0.009,6,10,1989,5,910,2.0,642.0,642.0,5,1079,2.0,811.0,811.0
0.005,6,10,1989,5,927,1.0,659.0,659.0,5,1062,1.0,794.0,794.0
0.005,6,10,1774,5,923,1.0,655.0,655.0,5,851,1.0,583.0,583.0
15.074,17,15,9238,8,6902,2149.0,1350.0,834.0,7,2336,2507.0,1350.0,305.0
0.04,17,4,284,2,120,1.0,32.0,32.0,2,164,36.0,60.0,54.0
0.137,6,10,1506,5,395,32.0,127.0,127.0,5,1111,26.0,843.0,843.0
0.106,6,10,1506,5,395,23.0,127.0,127.0,5,1111,22.0,843.0,843.0
0.083,6,10,1506,5,395,18.0,127.0,127.0,5,1111,16.0,843.0,843.0
0.32,17,41,20587,23,17137,14.0,1350.0,717.0,18,3450,14.0,1350.0,163.0
0.041,17,2,152,1,76,0.0,48.0,48.0,1,76,0.0,48.0,48.0
0.021,6,10,1983,5,910,5.0,642.0,642.0,5,1073,5.0,805.0,805.0
0.174,6,10,1506,5,395,41.0,127.0,127.0,5,1111,41.0,843.0,843.0
15.069,17,15,9239,8,6902,2148.0,1350.0,834.0,7,2337,2506.0,1350.0,305.0
0.021,6,10,1989,5,910,5.0,642.0,642.0,5,1079,5.0,811.0,811.0
0.005,6,10,2007,5,928,1.0,660.0,660.0,5,1079,1.0,811.0,811.0
0.004,6,10,1702,5,863,1.0,595.0,595.0,5,839,1.0,571.0,571.0
125.98,6,14,2938,8,2504,17963.0,1414.0,1086.0,6,434,25148.0,182.0,182.0
0.004,6,10,2006,5,927,1.0,659.0,659.0,5,1079,1.0,811.0,811.0
240.102,6,19,4669,9,2153,30012.0,950.0,563.0,10,2516,26677.0,1162.0,397.0
0.037,17,2,184,1,61,0.0,33.0,33.0,1,123,0.0,95.0,95.0
0.005,6,10,2006,5,927,1.0,659.0,659.0,5,1079,1.0,811.0,811.0
40.058,17,10,676,5,460,10013.0,104.0,64.0,5,216,10013.0,20.0,15.0
0.076,6,10,1506,5,395,16.0,127.0,127.0,5,1111,15.0,843.0,843.0
0.003,17,2,148,1,60,0.0,32.0,32.0,1,88,0.0,60.0,60.0
0.012,6,10,1631,5,848,3.0,580.0,580.0,5,783,2.0,515.0,515.0
0.004,6,10,2007,5,928,1.0,660.0,660.0,5,1079,1.0,811.0,811.0
0.005,6,10,1989,5,927,1.0,659.0,659.0,5,1062,1.0,794.0,794.0
0.1,6,10,1506,5,395,22.0,127.0,127.0,5,1111,18.0,843.0,843.0
0.007,17,2,144,1,64,0.0,36.0,36.0,1,80,0.0,52.0,52.0
0.055,6,10,1506,5,395,12.0,127.0,127.0,5,1111,13.0,843.0,843.0
0.012,6,10,1989,5,910,2.0,642.0,642.0,5,1079,3.0,811.0,811.0
0.102,6,10,1506,5,395,20.0,127.0,127.0,5,1111,24.0,843.0,843.0
40.053,17,10,676,5,460,10012.0,104.0,64.0,5,216,10012.0,20.0,15.0
0.015,6,10,1990,5,911,3.0,643.0,643.0,5,1079,3.0,811.0,811.0
0.096,6,10,1506,5,395,17.0,127.0,127.0,5,1111,22.0,843.0,843.0
40.095,17,10,676,5,460,10020.0,104.0,64.0,5,216,10023.0,20.0,15.0
0.004,6,10,1774,5,923,1.0,655.0,655.0,5,851,1.0,583.0,583.0
0.069,17,8,3613,4,1874,23.0,1350.0,440.0,4,1739,12.0,1350.0,406.0
0.016,6,10,1972,5,910,3.0,642.0,642.0,5,1062,3.0,794.0,794.0
0.016,17,2,198,1,91,0.0,63.0,63.0,1,107,0.0,79.0,79.0
0.049,6,10,1983,5,910,12.0,642.0,642.0,5,1073,12.0,805.0,805.0
0.014,6,10,1631,5,848,3.0,580.0,580.0,5,783,3.0,515.0,515.0
0.008,6,10,1990,5,911,2.0,643.0,643.0,5,1079,1.0,811.0,811.0
15.071,17,15,9238,8,6902,2148.0,1350.0,834.0,7,2336,2506.0,1350.0,305.0
0.015,6,10,1989,5,910,3.0,642.0,642.0,5,1079,3.0,811.0,811.0
0.016,6,10,1989,5,910,4.0,642.0,642.0,5,1079,4.0,811.0,811.0
0.086,6,10,1506,5,395,18.0,127.0,127.0,5,1111,19.0,843.0,843.0
116.815,6,22,8497,12,2236,70.0,1345.0,574.0,10,6261,12961.0,2720.0,974.0
0.039,17,2,136,1,60,0.0,32.0,32.0,1,76,0.0,48.0,48.0
0.07,6,10,1506,5,395,16.0,127.0,127.0,5,1111,16.0,843.0,843.0
0.005,6,10,2006,5,927,1.0,659.0,659.0,5,1079,1.0,811.0,811.0
40.07,17,10,676,5,460,10016.0,104.0,64.0,5,216,10016.0,20.0,15.0
0.01,6,10,1689,5,839,2.0,571.0,571.0,5,850,2.0,582.0,582.0
0.005,6,10,2006,5,927,1.0,659.0,659.0,5,1079,1.0,811.0,811.0
11.34,17,34,6340,17,3600,701.0,1146.0,183.0,17,2740,701.0,270.0,133.0
0.005,6,10,1774,5,923,1.0,655.0,655.0,5,851,1.0,583.0,583.0
0.138,6,10,1506,5,395,33.0,127.0,127.0,5,1111,30.0,843.0,843.0
0.006,6,10,1547,5,764,1.0,496.0,496.0,5,783,1.0,515.0,515.0
0.004,6,10,2007,5,928,1.0,660.0,660.0,5,1079,1.0,811.0,811.0
0.005,6,10,2006,5,927,1.0,659.0,659.0,5,1079,1.0,811.0,811.0
0.012,6,10,1990,5,911,3.0,643.0,643.0,5,1079,2.0,811.0,811.0
0.138,6,10,1506,5,395,25.0,127.0,127.0,5,1111,33.0,843.0,843.0
0.011,6,10,1989,5,910,2.0,642.0,642.0,5,1079,2.0,811.0,811.0
0.007,17,2,144,1,64,0.0,36.0,36.0,1,80,0.0,52.0,52.0
0.01,6,10,1983,5,910,2.0,642.0,642.0,5,1073,2.0,805.0,805.0
0.054,6,10,1972,5,910,13.0,642.0,642.0,5,1062,13.0,794.0,794.0
0.037,17,2,152,1,76,0.0,48.0,48.0,1,76,0.0,48.0,48.0
40.07,17,10,676,5,460,10016.0,104.0,64.0,5,216,10016.0,20.0,15.0
0.005,17,2,193,1,71,0.0,43.0,43.0,1,122,0.0,94.0,94.0
40.075,17,10,676,5,460,10018.0,104.0,64.0,5,216,10018.0,20.0,15.0
0.012,6,10,1989,5,910,3.0,642.0,642.0,5,1079,3.0,811.0,811.0
0.01,6,10,1972,5,910,2.0,642.0,642.0,5,1062,2.0,794.0,794.0
15.072,17,15,9239,8,6902,2149.0,1350.0,834.0,7,2337,2507.0,1350.0,305.0
0.006,17,2,230,1,68,0.0,40.0,40.0,1,162,0.0,134.0,134.0
0.107,6,10,1506,5,395,23.0,127.0,127.0,5,1111,24.0,843.0,843.0
0.005,6,10,2007,5,928,1.0,660.0,660.0,5,1079,1.0,811.0,811.0
0.004,17,2,148,1,60,0.0,32.0,32.0,1,88,0.0,60.0,60.0
0.006,6,10,1643,5,860,1.0,592.0,592.0,5,783,1.0,515.0,515.0
0.011,6,10,1989,5,910,2.0,642.0,642.0,5,1079,2.0,811.0,811.0
0.001,17,2,180,1,66,0.0,38.0,38.0,1,114,0.0,86.0,86.0
0.011,6,10,1989,5,910,2.0,642.0,642.0,5,1079,2.0,811.0,811.0
241.404,6,313,344023,118,17646,2063.0,2736.0,959.0,195,326377,1244.0,2804.0,1709.0
0.092,6,10,1506,5,395,18.0,127.0,127.0,5,1111,19.0,843.0,843.0
0.104,6,10,1506,5,395,22.0,127.0,127.0,5,1111,24.0,843.0,843.0
0.032,6,10,1983,5,910,8.0,642.0,642.0,5,1073,8.0,805.0,805.0
0.004,6,10,2006,5,927,1.0,659.0,659.0,5,1079,1.0,811.0,811.0
0.015,6,10,1990,5,911,3.0,643.0,643.0,5,1079,3.0,811.0,811.0
0.006,6,10,1689,5,839,1.0,571.0,571.0,5,850,1.0,582.0,582.0
0.01,6,10,1989,5,910,2.0,642.0,642.0,5,1079,2.0,811.0,811.0
240.099,6,16,4482,9,963,30012.0,238.0,166.0,7,3519,40016.0,1402.0,786.0
0.037,17,4,284,2,120,0.0,32.0,32.0,2,164,33.0,60.0,54.0
0.01,17,2,138,1,61,0.0,33.0,33.0,1,77,0.0,49.0,49.0
40.08,17,10,676,5,460,10016.0,104.0,64.0,5,216,10019.0,20.0,15.0
0.016,6,10,1762,5,911,3.0,643.0,643.0,5,851,3.0,583.0,583.0
0.011,6,10,1990,5,911,2.0,643.0,643.0,5,1079,2.0,811.0,811.0
0.016,6,10,1677,5,827,3.0,559.0,559.0,5,850,4.0,582.0,582.0
0.064,6,10,1972,5,910,16.0,642.0,642.0,5,1062,16.0,794.0,794.0
0.005,6,10,2006,5,927,1.0,659.0,659.0,5,1079,1.0,811.0,811.0
0.006,6,10,2006,5,927,1.0,659.0,659.0,5,1079,1.0,811.0,811.0
0.005,6,14,3799,7,509,0.0,137.0,137.0,7,3290,0.0,1448.0,972.0
11.293,17,28,4395,14,1994,855.0,269.0,114.0,14,2401,856.0,588.0,143.0
0.011,6,10,1983,5,910,2.0,642.0,642.0,5,1073,2.0,805.0,805.0
0.005,6,10,1547,5,764,1.0,496.0,496.0,5,783,1.0,515.0,515.0
0.004,17,2,152,1,68,0.0,40.0,40.0,1,84,0.0,56.0,56.0
1771.898,6,102,6153,58,3433,31085.0,27.0,27.0,44,2720,41206.0,27.0,27.0
0.005,17,2,166,1,75,0.0,47.0,47.0,1,91,0.0,63.0,63.0
0.015,6,10,1989,5,910,3.0,642.0,642.0,5,1079,3.0,811.0,811.0
0.005,6,10,1779,5,928,1.0,660.0,660.0,5,851,1.0,583.0,583.0
40.07,17,10,676,5,460,10016.0,104.0,64.0,5,216,10016.0,20.0,15.0
0.019,6,10,1989,5,910,4.0,642.0,642.0,5,1079,4.0,811.0,811.0
0.006,6,13,3747,7,509,0.0,137.0,137.0,6,3238,1.0,1470.0,1459.0
1767.729,17,92,8096,46,4048,39282.0,60.0,60.0,46,4048,39282.0,60.0,60.0
10.807,17,28,4418,14,1994,823.0,269.0,114.0,14,2424,823.0,587.0,145.0
0.005,6,10,1779,5,928,1.0,660.0,660.0,5,851,1.0,583.0,583.0
0.006,6,10,1689,5,839,1.0,571.0,571.0,5,850,1.0,582.0,582.0
0.001,17,2,136,1,60,0.0,32.0,32.0,1,76,0.0,48.0,48.0
0.006,17,2,164,1,74,0.0,46.0,46.0,1,90,0.0,62.0,62.0
0.004,6,10,1989,5,927,1.0,659.0,659.0,5,1062,1.0,794.0,794.0
0.171,17,2,152,1,76,0.0,48.0,48.0,1,76,0.0,48.0,48.0
0.005,6,10,2000,5,927,1.0,659.0,659.0,5,1073,1.0,805.0,805.0
0.005,6,10,2006,5,927,1.0,659.0,659.0,5,1079,1.0,811.0,811.0
240.092,6,30,7131,14,4745,18468.0,1425.0,501.0,16,2386,16006.0,580.0,193.0
0.088,6,10,1506,5,395,19.0,127.0,127.0,5,1111,19.0,843.0,843.0
0.005,6,10,1774,5,923,1.0,655.0,655.0,5,851,1.0,583.0,583.0
0.005,6,10,1689,5,839,1.0,571.0,571.0,5,850,1.0,582.0,582.0
0.134,6,10,1506,5,395,31.0,127.0,127.0,5,1111,32.0,843.0,843.0
353.993,6,21,1795,16,1030,23599.0,190.0,190.0,5,765,60001.0,464.0,248.0
266.591,6,41,10113,19,6993,14810.0,1515.0,600.0,22,3120,12694.0,580.0,140.0
308.704,17,16,892,8,564,44086.0,48.0,42.0,8,328,44090.0,20.0,13.0
300.368,6,16,2170,9,684,37524.0,146.0,146.0,7,1486,50032.0,419.0,398.0
0.078,6,10,1506,5,395,18.0,127.0,127.0,5,1111,17.0,843.0,843.0
305.497,6,39,15905,21,2903,15274.0,661.0,360.0,18,13002,14436.0,1402.0,1004.0
0.003,17,2,136,1,60,0.0,32.0,32.0,1,76,0.0,48.0,48.0
0.005,6,10,2006,5,927,1.0,659.0,659.0,5,1079,1.0,811.0,811.0
0.015,6,10,1983,5,910,3.0,642.0,642.0,5,1073,3.0,805.0,805.0
0.001,17,2,136,1,60,0.0,32.0,32.0,1,76,0.0,48.0,48.0
0.004,17,2,169,1,62,0.0,34.0,34.0,1,107,0.0,79.0,79.0
0.011,6,10,1983,5,910,2.0,642.0,642.0,5,1073,2.0,805.0,805.0
0.005,6,10,2000,5,927,1.0,659.0,659.0,5,1073,1.0,805.0,805.0
40.094,17,10,676,5,460,10022.0,104.0,64.0,5,216,10022.0,20.0,15.0
0.005,6,10,1774,5,923,1.0,655.0,655.0,5,851,1.0,583.0,583.0
0.085,6,10,1506,5,395,19.0,127.0,127.0,5,1111,19.0,843.0,843.0
0.035,17,2,152,1,76,0.0,48.0,48.0,1,76,0.0,48.0,48.0
0.007,17,2,194,1,59,0.0,31.0,31.0,1,135,0.0,107.0,107.0
15.386,17,48,25884,26,21275,614.0,1350.0,790.0,22,4609,731.0,1350.0,181.0
0.106,6,10,1506,5,395,24.0,127.0,127.0,5,1111,25.0,843.0,843.0
289.726,6,394,347525,185,21182,1574.0,2736.0,888.0,209,326343,1392.0,2804.0,1617.0
0.133,17,2,80,1,32,0.0,4.0,4.0,1,48,0.0,20.0,20.0
308.889,17,20,1124,10,716,34314.0,48.0,43.0,10,408,34314.0,20.0,12.0
0.008,6,10,1989,5,910,2.0,642.0,642.0,5,1079,2.0,811.0,811.0
0.005,17,2,148,1,60,0.0,32.0,32.0,1,88,0.0,60.0,60.0
0.005,6,10,1774,5,923,1.0,655.0,655.0,5,851,1.0,583.0,583.0
0.203,6,16,2669,8,1395,29.0,533.0,323.0,8,1274,18.0,529.0,212.0
1785.021,6,299,93422,185,82834,9701.0,1402.0,665.0,114,10588,15796.0,92.0,65.0
10.824,17,28,4416,14,1993,824.0,268.0,114.0,14,2423,824.0,586.0,145.0
0.126,17,2,144,1,64,0.0,36.0,36.0,1,80,0.0,52.0,52.0
0.094,6,10,1506,5,395,21.0,127.0,127.0,5,1111,21.0,843.0,843.0
0.004,6,10,2007,5,928,1.0,660.0,660.0,5,1079,1.0,811.0,811.0
0.004,6,10,2006,5,927,1.0,659.0,659.0,5,1079,1.0,811.0,811.0
0.004,6,10,1702,5,863,1.0,595.0,595.0,5,839,1.0,571.0,571.0
0.007,6,10,1990,5,911,1.0,643.0,643.0,5,1079,1.0,811.0,811.0
0.006,6,10,2000,5,927,1.0,659.0,659.0,5,1073,1.0,805.0,805.0
0.039,17,2,144,1,64,0.0,36.0,36.0,1,80,0.0,52.0,52.0
0.091,6,10,1506,5,395,19.0,127.0,127.0,5,1111,19.0,843.0,843.0
15.068,17,15,9238,8,6902,2148.0,1350.0,834.0,7,2336,2506.0,1350.0,305.0
0.008,6,10,1989,5,910,2.0,642.0,642.0,5,1079,2.0,811.0,811.0
0.003,17,2,144,1,64,0.0,36.0,36.0,1,80,0.0,52.0,52.0
0.017,6,14,3787,7,497,2.0,125.0,125.0,7,3290,2.0,1448.0,972.0
0.085,6,10,1506,5,395,18.0,127.0,127.0,5,1111,18.0,843.0,843.0
0.021,17,2,230,1,68,0.0,40.0,40.0,1,162,0.0,134.0,134.0
0.007,6,10,1547,5,764,1.0,496.0,496.0,5,783,1.0,515.0,515.0
0.006,6,10,1547,5,764,1.0,496.0,496.0,5,783,1.0,515.0,515.0
0.008,17,2,194,1,59,0.0,31.0,31.0,1,135,0.0,107.0,107.0
0.013,17,2,152,1,56,0.0,28.0,28.0,1,96,0.0,68.0,68.0
0.014,6,10,1989,5,910,3.0,642.0,642.0,5,1079,3.0,811.0,811.0
15.072,17,15,9238,8,6902,2149.0,1350.0,834.0,7,2336,2507.0,1350.0,305.0
0.126,6,10,1506,5,395,26.0,127.0,127.0,5,1111,27.0,843.0,843.0
0.005,17,2,164,1,74,0.0,46.0,46.0,1,90,0.0,62.0,62.0
0.01,6,10,1989,5,910,2.0,642.0,642.0,5,1079,2.0,811.0,811.0
0.01,6,10,1762,5,911,2.0,643.0,643.0,5,851,2.0,583.0,583.0
0.008,6,10,1983,5,910,2.0,642.0,642.0,5,1073,2.0,805.0,805.0
0.004,17,2,148,1,60,0.0,32.0,32.0,1,88,0.0,60.0,60.0
308.688,17,20,1124,10,716,34284.0,48.0,43.0,10,408,34284.0,20.0,12.0
308.84,17,20,1124,10,716,34300.0,48.0,43.0,10,408,34301.0,20.0,12.0
352.266,6,20,2210,6,1308,12003.0,494.0,494.0,14,902,27097.0,83.0,83.0
0.005,6,10,1547,5,764,1.0,496.0,496.0,5,783,1.0,515.0,515.0
0.004,17,2,148,1,60,0.0,32.0,32.0,1,88,0.0,60.0,60.0
0.013,6,10,1990,5,911,3.0,643.0,643.0,5,1079,3.0,811.0,811.0
0.006,6,10,1547,5,764,1.0,496.0,496.0,5,783,1.0,515.0,515.0
65.897,6,27,17596,15,9656,4706.0,2804.0,1478.0,12,7940,5976.0,2425.0,1218.0
0.006,6,10,1854,5,889,1.0,621.0,621.0,5,965,1.0,697.0,697.0
240.086,6,16,4482,9,963,30010.0,238.0,166.0,7,3519,40013.0,1402.0,786.0
0.005,6,14,3799,7,509,0.0,137.0,137.0,7,3290,0.0,1448.0,972.0
0.008,6,10,2007,5,928,2.0,660.0,660.0,5,1079,1.0,811.0,811.0
0.095,6,10,1506,5,395,20.0,127.0,127.0,5,1111,20.0,843.0,843.0
0.008,6,10,1983,5,910,2.0,642.0,642.0,5,1073,2.0,805.0,805.0
0.002,17,2,180,1,66,0.0,38.0,38.0,1,114,0.0,86.0,86.0
0.003,17,2,136,1,60,0.0,32.0,32.0,1,76,0.0,48.0,48.0
240.702,6,33,14096,16,2191,16046.0,944.0,227.0,17,11905,15043.0,2790.0,917.0
0.005,6,10,1989,5,927,1.0,659.0,659.0,5,1062,1.0,794.0,794.0
0.005,6,10,1689,5,839,1.0,571.0,571.0,5,850,1.0,582.0,582.0
0.086,6,10,1506,5,395,18.0,127.0,127.0,5,1111,19.0,843.0,843.0
40.069,17,10,676,5,460,10014.0,104.0,64.0,5,216,10016.0,20.0,15.0
0.005,6,10,1779,5,928,1.0,660.0,660.0,5,851,1.0,583.0,583.0
0.109,6,10,1506,5,395,26.0,127.0,127.0,5,1111,25.0,843.0,843.0
0.005,6,13,3747,7,509,0.0,137.0,137.0,6,3238,0.0,1470.0,1459.0
0.001,17,2,180,1,66,0.0,38.0,38.0,1,114,0.0,86.0,86.0
0.006,6,10,1643,5,860,1.0,592.0,592.0,5,783,1.0,515.0,515.0
0.014,6,10,1631,5,848,3.0,580.0,580.0,5,783,3.0,515.0,515.0
0.068,6,10,1506,5,395,15.0,127.0,127.0,5,1111,15.0,843.0,843.0
0.018,6,10,1989,5,910,4.0,642.0,642.0,5,1079,4.0,811.0,811.0
0.004,17,2,144,1,64,0.0,36.0,36.0,1,80,0.0,52.0,52.0
0.005,6,10,1689,5,839,1.0,571.0,571.0,5,850,1.0,582.0,582.0
0.069,6,10,1506,5,395,15.0,127.0,127.0,5,1111,16.0,843.0,843.0
0.006,6,12,1698,6,863,1.0,327.0,271.0,6,835,1.0,515.0,515.0
0.006,6,10,1774,5,923,1.0,655.0,655.0,5,851,1.0,583.0,583.0
0.006,6,10,1547,5,764,1.0,496.0,496.0,5,783,1.0,515.0,515.0
0.161,17,4,352,2,130,123.0,37.0,37.0,2,222,121.0,89.0,83.0
240.287,6,40,5303,19,2385,13349.0,588.0,196.0,21,2918,12013.0,580.0,227.0
0.005,6,10,2007,5,928,1.0,660.0,660.0,5,1079,1.0,811.0,811.0
0.008,6,10,1972,5,910,1.0,642.0,642.0,5,1062,2.0,794.0,794.0
40.078,17,10,676,5,460,10017.0,104.0,64.0,5,216,10018.0,20.0,15.0
11.11,17,28,4421,14,1993,842.0,268.0,114.0,14,2428,842.0,587.0,145.0
0.006,17,2,170,1,65,0.0,37.0,37.0,1,105,0.0,77.0,77.0
0.015,6,13,3735,7,497,2.0,125.0,125.0,6,3238,2.0,1470.0,1459.0
0.038,17,4,284,2,120,0.0,32.0,32.0,2,164,34.0,60.0,54.0
0.006,6,10,1989,5,927,1.0,659.0,659.0,5,1062,1.0,794.0,794.0
0.011,6,10,1972,5,910,2.0,642.0,642.0,5,1062,2.0,794.0,794.0
0.006,17,2,170,1,65,0.0,37.0,37.0,1,105,0.0,77.0,77.0
0.017,6,10,1989,5,910,4.0,642.0,642.0,5,1079,4.0,811.0,811.0
0.004,6,10,1989,5,927,1.0,659.0,659.0,5,1062,1.0,794.0,794.0
0.022,6,10,1990,5,911,5.0,643.0,643.0,5,1079,5.0,811.0,811.0
0.001,17,2,166,1,75,0.0,47.0,47.0,1,91,0.0,63.0,63.0
313.167,17,20,1124,10,716,34781.0,48.0,43.0,10,408,34781.0,20.0,12.0
0.011,6,10,1677,5,827,2.0,559.0,559.0,5,850,2.0,582.0,582.0
0.006,6,10,1547,5,764,1.0,496.0,496.0,5,783,1.0,515.0,515.0
0.009,6,10,1972,5,910,2.0,642.0,642.0,5,1062,2.0,794.0,794.0
291.124,6,389,347460,194,21657,1508.0,2736.0,825.0,195,325803,1500.0,2804.0,1743.0
40.08,17,10,676,5,460,10016.0,104.0,64.0,5,216,10019.0,20.0,15.0
0.104,6,10,1506,5,395,21.0,127.0,127.0,5,1111,24.0,843.0,843.0
240.016,6,9,787,5,488,60004.0,232.0,232.0,4,299,80004.0,83.0,83.0
0.088,6,10,1506,5,395,20.0,127.0,127.0,5,1111,19.0,843.0,843.0
0.141,17,2,156,1,64,0.0,36.0,36.0,1,92,0.0,64.0,64.0
0.016,6,10,1972,5,910,4.0,642.0,642.0,5,1062,4.0,794.0,794.0
0.114,6,10,1506,5,395,23.0,127.0,127.0,5,1111,25.0,843.0,843.0
0.005,6,10,1547,5,764,1.0,496.0,496.0,5,783,1.0,515.0,515.0
0.095,6,10,1506,5,395,22.0,127.0,127.0,5,1111,21.0,843.0,843.0
0.007,6,10,1547,5,764,1.0,496.0,496.0,5,783,1.0,515.0,515.0
0.004,6,10,2000,5,927,1.0,659.0,659.0,5,1073,1.0,805.0,805.0
40.072,17,10,676,5,460,10017.0,104.0,64.0,5,216,10016.0,20.0,15.0
0.005,6,10,2000,5,927,1.0,659.0,659.0,5,1073,1.0,805.0,805.0
300.425,6,16,2170,9,684,37532.0,146.0,146.0,7,1486,50043.0,419.0,398.0
0.088,6,10,1506,5,395,20.0,127.0,127.0,5,1111,17.0,843.0,843.0
0.079,6,10,1506,5,395,18.0,127.0,127.0,5,1111,18.0,843.0,843.0
0.006,6,10,1547,5,764,1.0,496.0,496.0,5,783,1.0,515.0,515.0
0.04,17,4,284,2,120,0.0,32.0,32.0,2,164,37.0,60.0,54.0
1799.986,17,2920,223154,1454,117827,1238.0,84.0,53.0,1466,105327,1228.0,227.0,43.0
0.223,6,16,2670,8,1396,31.0,533.0,324.0,8,1274,20.0,529.0,212.0
0.005,17,2,170,1,65,0.0,37.0,37.0,1,105,0.0,77.0,77.0
0.012,6,10,1972,5,910,3.0,642.0,642.0,5,1062,3.0,794.0,794.0
0.011,6,12,1926,6,1189,2.0,659.0,434.0,6,737,2.0,417.0,417.0
0.021,6,10,1983,5,910,5.0,642.0,642.0,5,1073,5.0,805.0,805.0
0.013,6,10,1983,5,910,3.0,642.0,642.0,5,1073,3.0,805.0,805.0
0.013,6,10,1989,5,910,3.0,642.0,642.0,5,1079,3.0,811.0,811.0
0.013,6,10,1983,5,910,3.0,642.0,642.0,5,1073,3.0,805.0,805.0
0.004,6,10,2006,5,927,1.0,659.0,659.0,5,1079,1.0,811.0,811.0
0.167,17,2,152,1,76,0.0,48.0,48.0,1,76,0.0,48.0,48.0
0.012,6,10,1989,5,910,2.0,642.0,642.0,5,1079,3.0,811.0,811.0
163.349,17,82,11709,41,2739,4083.0,44.0,38.0,41,8970,4083.0,239.0,190.0
0.126,6,10,1506,5,395,29.0,127.0,127.0,5,1111,27.0,843.0,843.0
0.005,6,10,2007,5,928,1.0,660.0,660.0,5,1079,1.0,811.0,811.0
0.129,17,2,80,1,32,0.0,4.0,4.0,1,48,0.0,20.0,20.0
0.024,17,2,194,1,59,0.0,31.0,31.0,1,135,0.0,107.0,107.0
0.008,6,10,1983,5,910,1.0,642.0,642.0,5,1073,2.0,805.0,805.0
0.021,6,10,1989,5,910,5.0,642.0,642.0,5,1079,5.0,811.0,811.0
0.021,6,10,1631,5,848,5.0,580.0,580.0,5,783,5.0,515.0,515.0
0.004,6,10,2007,5,928,1.0,660.0,660.0,5,1079,1.0,811.0,811.0
240.231,6,40,5309,20,2424,12643.0,588.0,196.0,20,2885,12643.0,580.0,262.0
0.005,6,10,1643,5,860,1.0,592.0,592.0,5,783,1.0,515.0,515.0
0.004,6,10,2007,5,928,1.0,660.0,660.0,5,1079,1.0,811.0,811.0
0.004,6,10,2007,5,928,1.0,660.0,660.0,5,1079,1.0,811.0,811.0
0.12,6,10,1506,5,395,28.0,127.0,127.0,5,1111,29.0,843.0,843.0
0.013,6,13,3816,7,578,2.0,206.0,206.0,6,3238,2.0,1470.0,1459.0
0.142,6,10,1506,5,395,31.0,127.0,127.0,5,1111,32.0,843.0,843.0
178.1,17,92,13232,46,3096,3957.0,44.0,39.0,46,10136,3957.0,239.0,192.0
0.004,17,4,284,2,120,0.0,32.0,32.0,2,164,1.0,60.0,54.0
177.125,17,76,10886,38,2529,4787.0,44.0,38.0,38,8357,4787.0,239.0,191.0
0.005,6,14,3799,7,509,0.0,137.0,137.0,7,3290,0.0,1448.0,972.0
0.004,6,10,2000,5,927,1.0,659.0,659.0,5,1073,1.0,805.0,805.0
10.882,17,26,4103,13,1823,898.0,270.0,112.0,13,2280,898.0,587.0,147.0
0.005,6,10,2007,5,928,1.0,660.0,660.0,5,1079,1.0,811.0,811.0
0.153,6,10,1506,5,395,36.0,127.0,127.0,5,1111,36.0,843.0,843.0
0.004,6,10,2007,5,928,1.0,660.0,660.0,5,1079,1.0,811.0,811.0
0.006,17,2,194,1,59,0.0,31.0,31.0,1,135,0.0,107.0,107.0
0.106,6,10,1506,5,395,22.0,127.0,127.0,5,1111,25.0,843.0,843.0
0.004,17,2,156,1,64,0.0,36.0,36.0,1,92,0.0,64.0,64.0
0.006,6,10,1547,5,764,1.0,496.0,496.0,5,783,1.0,515.0,515.0
0.005,6,10,1689,5,839,1.0,571.0,571.0,5,850,1.0,582.0,582.0
291.41,6,298,342764,120,17786,2448.0,2688.0,888.0,178,324978,1646.0,4206.0,1925.0
0.004,17,4,284,2,120,0.0,32.0,32.0,2,164,0.0,60.0,54.0
0.005,6,10,1854,5,889,1.0,621.0,621.0,5,965,1.0,697.0,697.0
240.079,6,16,4481,9,963,30009.0,238.0,166.0,7,3518,40012.0,1402.0,786.0
0.013,6,10,1989,5,910,3.0,642.0,642.0,5,1079,3.0,811.0,811.0
0.005,6,10,1774,5,923,1.0,655.0,655.0,5,851,1.0,583.0,583.0
0.007,17,2,230,1,68,0.0,40.0,40.0,1,162,0.0,134.0,134.0
0.005,17,2,168,1,76,0.0,48.0,48.0,1,92,0.0,64.0,64.0
0.039,17,4,284,2,120,0.0,32.0,32.0,2,164,36.0,60.0,54.0
0.04,17,4,352,2,130,0.0,37.0,37.0,2,222,36.0,89.0,83.0
0.005,6,10,2007,5,928,1.0,660.0,660.0,5,1079,1.0,811.0,811.0
308.788,17,20,1124,10,716,34295.0,48.0,43.0,10,408,34295.0,20.0,12.0
40.053,17,10,676,5,460,10012.0,104.0,64.0,5,216,10012.0,20.0,15.0
0.005,6,10,2007,5,928,1.0,660.0,660.0,5,1079,1.0,811.0,811.0
371.019,6,22,2313,16,867,24734.0,195.0,195.0,6,1446,4636.0,419.0,398.0
40.08,17,10,676,5,460,10017.0,104.0,64.0,5,216,10019.0,20.0,15.0
240.084,6,16,4482,9,963,30010.0,238.0,166.0,7,3519,40013.0,1402.0,786.0
0.006,17,2,230,1,68,0.0,40.0,40.0,1,162,0.0,134.0,134.0
0.004,17,4,284,2,120,0.0,32.0,32.0,2,164,1.0,60.0,54.0
40.066,17,10,676,5,460,10014.0,104.0,64.0,5,216,10015.0,20.0,15.0
0.168,17,2,152,1,76,0.0,48.0,48.0,1,76,0.0,48.0,48.0
0.01,6,13,3735,7,497,1.0,125.0,125.0,6,3238,2.0,1470.0,1459.0
0.001,17,2,180,1,66,0.0,38.0,38.0,1,114,0.0,86.0,86.0
0.005,17,2,164,1,74,0.0,46.0,46.0,1,90,0.0,62.0,62.0
0.018,6,10,1762,5,911,4.0,643.0,643.0,5,851,4.0,583.0,583.0
40.072,17,10,676,5,460,10017.0,104.0,64.0,5,216,10017.0,20.0,15.0
0.001,17,2,136,1,60,0.0,32.0,32.0,1,76,0.0,48.0,48.0
0.006,6,10,1547,5,764,1.0,496.0,496.0,5,783,1.0,515.0,515.0
0.006,6,10,1547,5,764,1.0,496.0,496.0,5,783,1.0,515.0,515.0
0.004,17,2,136,1,60,0.0,32.0,32.0,1,76,0.0,48.0,48.0
0.108,6,10,1506,5,395,22.0,127.0,127.0,5,1111,23.0,843.0,843.0
0.005,6,10,1989,5,927,1.0,659.0,659.0,5,1062,1.0,794.0,794.0
0.078,6,10,1506,5,395,18.0,127.0,127.0,5,1111,14.0,843.0,843.0
0.016,6,10,1990,5,911,4.0,643.0,643.0,5,1079,4.0,811.0,811.0
0.1,6,10,1506,5,395,22.0,127.0,127.0,5,1111,21.0,843.0,843.0
0.005,6,10,1989,5,927,1.0,659.0,659.0,5,1062,1.0,794.0,794.0
0.079,6,10,1506,5,395,16.0,127.0,127.0,5,1111,17.0,843.0,843.0
0.011,6,10,1989,5,910,2.0,642.0,642.0,5,1079,2.0,811.0,811.0
241.176,6,376,347745,197,21769,1230.0,2736.0,885.0,179,325976,1354.0,2804.0,1873.0
0.004,6,10,2000,5,927,1.0,659.0,659.0,5,1073,1.0,805.0,805.0
0.157,6,10,1506,5,395,38.0,127.0,127.0,5,1111,36.0,843.0,843.0
0.005,17,2,213,1,69,0.0,41.0,41.0,1,144,0.0,116.0,116.0
40.058,17,10,676,5,460,10013.0,104.0,64.0,5,216,10013.0,20.0,15.0
0.009,17,2,162,1,65,0.0,37.0,37.0,1,97,0.0,69.0,69.0
1717.191,6,61,7142,40,4349,44030.0,1642.0,113.0,21,2793,85849.0,1112.0,85.0
0.096,6,10,1605,5,388,23.0,120.0,120.0,5,1217,24.0,949.0,949.0
0.012,6,10,1983,5,910,3.0,642.0,642.0,5,1073,2.0,805.0,805.0
175.297,17,68,9656,34,2267,5311.0,44.0,38.0,34,7389,5311.0,239.0,189.0
0.014,6,10,1972,5,910,3.0,642.0,642.0,5,1062,3.0,794.0,794.0
0.127,17,4,596,2,122,0.0,33.0,33.0,2,474,88.0,323.0,209.0
0.008,6,10,1762,5,911,2.0,643.0,643.0,5,851,2.0,583.0,583.0
300.31,6,16,2170,9,684,37517.0,146.0,146.0,7,1486,50023.0,419.0,398.0
1758.503,6,524,84690,286,45273,6170.0,1781.0,235.0,238,39417,7419.0,1402.0,170.0
0.005,6,10,2007,5,928,1.0,660.0,660.0,5,1079,1.0,811.0,811.0
40.043,17,10,676,5,460,10010.0,104.0,64.0,5,216,10010.0,20.0,15.0
10.752,17,28,4422,14,1994,818.0,269.0,114.0,14,2428,818.0,587.0,145.0
0.012,6,10,1989,5,910,2.0,642.0,642.0,5,1079,2.0,811.0,811.0
0.007,6,10,1854,5,889,1.0,621.0,621.0,5,965,1.0,697.0,697.0
0.078,6,10,1506,5,395,17.0,127.0,127.0,5,1111,17.0,843.0,843.0
0.138,6,10,1506,5,395,33.0,127.0,127.0,5,1111,31.0,843.0,843.0
0.04,17,2,182,1,65,0.0,37.0,37.0,1,117,0.0,89.0,89.0
0.084,6,10,1506,5,395,17.0,127.0,127.0,5,1111,16.0,843.0,843.0
0.006,6,13,3690,7,452,1.0,80.0,80.0,6,3238,1.0,1470.0,1459.0
0.005,6,10,1989,5,927,1.0,659.0,659.0,5,1062,1.0,794.0,794.0
0.004,6,10,2007,5,928,1.0,660.0,660.0,5,1079,1.0,811.0,811.0
0.005,6,10,2007,5,928,1.0,660.0,660.0,5,1079,1.0,811.0,811.0
0.07,6,10,1506,5,395,15.0,127.0,127.0,5,1111,15.0,843.0,843.0
0.006,6,10,2006,5,927,1.0,659.0,659.0,5,1079,1.0,811.0,811.0
0.014,6,10,1631,5,848,3.0,580.0,580.0,5,783,3.0,515.0,515.0
0.016,6,10,1972,5,910,4.0,642.0,642.0,5,1062,4.0,794.0,794.0
30.954,6,87,74318,43,3308,736.0,517.0,262.0,44,71010,719.0,2861.0,1675.0
0.006,6,10,1547,5,764,1.0,496.0,496.0,5,783,1.0,515.0,515.0
0.016,6,13,3735,7,497,2.0,125.0,125.0,6,3238,3.0,1470.0,1459.0
0.127,17,2,170,1,65,0.0,37.0,37.0,1,105,0.0,77.0,77.0
0.196,6,10,1506,5,395,47.0,127.0,127.0,5,1111,48.0,843.0,843.0
0.005,17,2,144,1,64,0.0,36.0,36.0,1,80,0.0,52.0,52.0
0.005,6,10,1989,5,927,1.0,659.0,659.0,5,1062,1.0,794.0,794.0
0.006,17,2,230,1,68,0.0,40.0,40.0,1,162,0.0,134.0,134.0
0.001,17,2,180,1,66,0.0,38.0,38.0,1,114,0.0,86.0,86.0
0.019,6,10,1631,5,848,4.0,580.0,580.0,5,783,4.0,515.0,515.0
0.005,6,10,2006,5,927,1.0,659.0,659.0,5,1079,1.0,811.0,811.0
0.02,6,10,1989,5,910,4.0,642.0,642.0,5,1079,4.0,811.0,811.0
0.005,6,10,1689,5,839,1.0,571.0,571.0,5,850,1.0,582.0,582.0
0.117,6,10,1506,5,395,24.0,127.0,127.0,5,1111,23.0,843.0,843.0
0.04,17,4,284,2,120,0.0,32.0,32.0,2,164,36.0,60.0,54.0
5.102,6,21,5923,12,1436,463.0,474.0,201.0,9,4487,637.0,1925.0,804.0
0.005,17,2,166,1,75,0.0,47.0,47.0,1,91,0.0,63.0,63.0
1756.185,6,105,6240,60,3510,29765.0,26.0,26.0,45,2730,39912.0,26.0,26.0
0.001,17,2,179,1,62,0.0,34.0,34.0,1,117,0.0,89.0,89.0
0.122,6,10,1506,5,395,29.0,127.0,127.0,5,1111,25.0,843.0,843.0
0.014,6,13,3735,7,497,2.0,125.0,125.0,6,3238,2.0,1470.0,1459.0
0.22,6,16,2778,8,1396,31.0,533.0,324.0,8,1382,19.0,529.0,239.0
0.001,17,2,180,1,66,0.0,38.0,38.0,1,114,0.0,86.0,86.0
0.006,6,10,1854,5,889,1.0,621.0,621.0,5,965,1.0,697.0,697.0
0.075,6,10,1506,5,395,18.0,127.0,127.0,5,1111,14.0,843.0,843.0
0.006,17,4,284,2,120,3.0,32.0,32.0,2,164,3.0,60.0,54.0
300.387,6,16,2170,9,684,37526.0,146.0,146.0,7,1486,50035.0,419.0,398.0
0.009,6,10,1989,5,910,2.0,642.0,642.0,5,1079,2.0,811.0,811.0
0.077,6,10,1506,5,395,18.0,127.0,127.0,5,1111,18.0,843.0,843.0
0.006,17,2,166,1,75,0.0,47.0,47.0,1,91,0.0,63.0,63.0
0.011,6,10,1972,5,910,2.0,642.0,642.0,5,1062,2.0,794.0,794.0
1771.594,17,120,11460,60,5460,30026.0,63.0,63.0,60,6000,30026.0,72.0,72.0
0.001,17,2,180,1,66,0.0,38.0,38.0,1,114,0.0,86.0,86.0
360.118,6,21,3981,13,3142,30009.0,494.0,494.0,8,839,51444.0,83.0,83.0
0.007,6,10,1972,5,910,1.0,642.0,642.0,5,1062,1.0,794.0,794.0
0.006,17,2,408,1,72,0.0,44.0,44.0,1,336,0.0,308.0,308.0
0.009,6,10,1989,5,910,2.0,642.0,642.0,5,1079,2.0,811.0,811.0
0.004,6,10,2006,5,927,1.0,659.0,659.0,5,1079,1.0,811.0,811.0
0.006,6,10,1689,5,839,1.0,571.0,571.0,5,850,1.0,582.0,582.0
0.006,6,10,1547,5,764,1.0,496.0,496.0,5,783,1.0,515.0,515.0
178.077,17,84,11932,42,2816,4343.0,44.0,39.0,42,9116,4343.0,239.0,189.0
0.005,17,2,170,1,65,0.0,37.0,37.0,1,105,0.0,77.0,77.0
0.163,17,2,152,1,76,0.0,48.0,48.0,1,76,0.0,48.0,48.0
0.005,6,10,2007,5,928,1.0,660.0,660.0,5,1079,1.0,811.0,811.0
0.004,6,10,1774,5,923,1.0,655.0,655.0,5,851,1.0,583.0,583.0
0.132,17,2,136,1,60,0.0,32.0,32.0,1,76,0.0,48.0,48.0
0.005,17,2,169,1,62,0.0,34.0,34.0,1,107,0.0,79.0,79.0
0.062,6,10,1506,5,395,14.0,127.0,127.0,5,1111,14.0,843.0,843.0
0.004,6,10,2006,5,927,1.0,659.0,659.0,5,1079,1.0,811.0,811.0
31.01,6,25,5883,14,1888,2385.0,517.0,260.0,11,3995,3100.0,1330.0,590.0
0.004,17,2,148,1,60,0.0,32.0,32.0,1,88,0.0,60.0,60.0
0.009,6,10,1972,5,910,2.0,642.0,642.0,5,1062,2.0,794.0,794.0
0.006,6,13,3747,7,509,1.0,137.0,137.0,6,3238,1.0,1470.0,1459.0
0.001,17,2,180,1,66,0.0,38.0,38.0,1,114,0.0,86.0,86.0
0.073,6,10,1506,5,395,15.0,127.0,127.0,5,1111,14.0,843.0,843.0
240.701,6,37,9655,19,2173,13370.0,745.0,235.0,18,7482,14156.0,1402.0,595.0
0.005,6,10,1643,5,860,1.0,592.0,592.0,5,783,1.0,515.0,515.0
0.001,17,2,166,1,75,0.0,47.0,47.0,1,91,0.0,63.0,63.0
0.003,17,2,142,1,63,0.0,35.0,35.0,1,79,0.0,51.0,51.0
377.972,6,20,2210,6,1308,12003.0,494.0,494.0,14,902,29074.0,83.0,83.0
0.005,6,10,1779,5,928,1.0,660.0,660.0,5,851,1.0,583.0,583.0
0.066,17,8,3613,4,1874,22.0,1350.0,440.0,4,1739,10.0,1350.0,406.0
0.069,6,10,1506,5,395,15.0,127.0,127.0,5,1111,14.0,843.0,843.0
0.013,6,10,1972,5,910,3.0,642.0,642.0,5,1062,3.0,794.0,794.0
0.011,6,10,1990,5,911,2.0,643.0,643.0,5,1079,2.0,811.0,811.0
40.109,17,10,676,5,460,10024.0,104.0,64.0,5,216,10026.0,20.0,15.0
0.064,17,2,234,1,61,0.0,33.0,33.0,1,173,0.0,145.0,145.0
0.227,6,16,2669,8,1395,32.0,533.0,323.0,8,1274,20.0,529.0,212.0
89.735,17,6,348,3,228,44806.0,48.0,48.0,3,120,44807.0,12.0,12.0
0.007,6,10,2006,5,927,1.0,659.0,659.0,5,1079,1.0,811.0,811.0
0.005,6,10,1643,5,860,1.0,592.0,592.0,5,783,1.0,515.0,515.0
0.112,6,10,1506,5,395,20.0,127.0,127.0,5,1111,25.0,843.0,843.0
0.105,6,10,1506,5,395,23.0,127.0,127.0,5,1111,24.0,843.0,843.0
0.006,6,12,1698,6,863,1.0,327.0,271.0,6,835,1.0,515.0,515.0
253.326,6,38,9988,15,6852,18094.0,1976.0,675.0,23,3136,11514.0,580.0,138.0
0.005,17,2,144,1,64,0.0,36.0,36.0,1,80,0.0,52.0,52.0
0.015,6,10,1762,5,911,3.0,643.0,643.0,5,851,3.0,583.0,583.0
0.01,6,10,1972,5,910,2.0,642.0,642.0,5,1062,2.0,794.0,794.0
240.011,6,9,787,5,488,60002.0,232.0,232.0,4,299,80002.0,83.0,83.0
0.037,6,10,1989,5,910,9.0,642.0,642.0,5,1079,9.0,811.0,811.0
0.005,6,10,2006,5,927,1.0,659.0,659.0,5,1079,1.0,811.0,811.0
40.064,17,10,676,5,460,10014.0,104.0,64.0,5,216,10015.0,20.0,15.0
0.016,6,10,1972,5,910,4.0,642.0,642.0,5,1062,4.0,794.0,794.0
0.008,6,10,1990,5,911,2.0,643.0,643.0,5,1079,1.0,811.0,811.0
0.089,6,10,1506,5,395,18.0,127.0,127.0,5,1111,19.0,843.0,843.0
0.005,6,10,2006,5,927,1.0,659.0,659.0,5,1079,1.0,811.0,811.0
0.035,17,2,152,1,76,0.0,48.0,48.0,1,76,0.0,48.0,48.0
0.012,6,10,1983,5,910,3.0,642.0,642.0,5,1073,3.0,805.0,805.0
0.005,6,10,2006,5,927,1.0,659.0,659.0,5,1079,1.0,811.0,811.0
40.081,17,10,676,5,460,10016.0,104.0,64.0,5,216,10019.0,20.0,15.0
0.0,17,2,180,1,66,0.0,38.0,38.0,1,114,0.0,86.0,86.0
0.112,17,2,142,1,63,0.0,35.0,35.0,1,79,0.0,51.0,51.0
0.083,6,10,1506,5,395,17.0,127.0,127.0,5,1111,17.0,843.0,843.0
0.007,6,10,1547,5,764,1.0,496.0,496.0,5,783,1.0,515.0,515.0
0.001,17,2,136,1,60,0.0,32.0,32.0,1,76,0.0,48.0,48.0
0.009,6,10,1972,5,910,2.0,642.0,642.0,5,1062,2.0,794.0,794.0
0.005,6,10,2006,5,927,1.0,659.0,659.0,5,1079,1.0,811.0,811.0
0.006,6,10,2007,5,928,1.0,660.0,660.0,5,1079,1.0,811.0,811.0
0.005,6,10,2007,5,928,1.0,660.0,660.0,5,1079,1.0,811.0,811.0
0.006,6,10,1779,5,928,1.0,660.0,660.0,5,851,1.0,583.0,583.0
0.118,6,10,1506,5,395,26.0,127.0,127.0,5,1111,28.0,843.0,843.0
11.084,17,28,4389,14,2312,843.0,587.0,137.0,14,2077,843.0,268.0,120.0
0.004,6,10,2000,5,927,1.0,659.0,659.0,5,1073,1.0,805.0,805.0
0.004,6,10,2007,5,928,1.0,660.0,660.0,5,1079,1.0,811.0,811.0
0.009,6,10,1989,5,910,2.0,642.0,642.0,5,1079,2.0,811.0,811.0
0.004,6,10,1989,5,927,1.0,659.0,659.0,5,1062,1.0,794.0,794.0
0.004,6,10,2007,5,928,1.0,660.0,660.0,5,1079,1.0,811.0,811.0
0.006,17,2,212,1,74,0.0,46.0,46.0,1,138,0.0,110.0,110.0
0.025,17,2,170,1,65,0.0,37.0,37.0,1,105,0.0,77.0,77.0
0.023,6,10,1972,5,910,5.0,642.0,642.0,5,1062,5.0,794.0,794.0
0.009,6,10,1983,5,910,2.0,642.0,642.0,5,1073,2.0,805.0,805.0
0.014,6,10,1990,5,911,3.0,643.0,643.0,5,1079,3.0,811.0,811.0
0.005,17,2,168,1,76,0.0,48.0,48.0,1,92,0.0,64.0,64.0
0.169,17,2,152,1,76,0.0,48.0,48.0,1,76,0.0,48.0,48.0
0.003,17,2,148,1,60,0.0,32.0,32.0,1,88,0.0,60.0,60.0
0.001,17,2,180,1,66,0.0,38.0,38.0,1,114,0.0,86.0,86.0
0.093,6,10,1506,5,395,21.0,127.0,127.0,5,1111,20.0,843.0,843.0
0.005,6,10,2006,5,927,1.0,659.0,659.0,5,1079,1.0,811.0,811.0
0.003,17,2,234,1,61,0.0,33.0,33.0,1,173,0.0,145.0,145.0
0.007,17,2,170,1,65,0.0,37.0,37.0,1,105,0.0,77.0,77.0
0.014,6,10,1631,5,848,3.0,580.0,580.0,5,783,3.0,515.0,515.0
0.007,6,10,1547,5,764,1.0,496.0,496.0,5,783,1.0,515.0,515.0
8.954,6,39,10487,20,4929,471.0,1360.0,682.0,19,5558,486.0,2667.0,435.0
0.014,6,10,1990,5,911,3.0,643.0,643.0,5,1079,3.0,811.0,811.0
0.705,17,391,338337,133,13008,5.0,1350.0,69.0,258,325329,2.0,1350.0,1232.0
0.014,6,10,1983,5,910,3.0,642.0,642.0,5,1073,3.0,805.0,805.0
0.115,6,10,1506,5,395,24.0,127.0,127.0,5,1111,23.0,843.0,843.0
0.038,17,2,144,1,64,0.0,36.0,36.0,1,80,0.0,52.0,52.0
0.004,17,2,136,1,60,0.0,32.0,32.0,1,76,0.0,48.0,48.0
0.013,6,10,1990,5,911,3.0,643.0,643.0,5,1079,3.0,811.0,811.0
0.013,6,10,1972,5,910,3.0,642.0,642.0,5,1062,3.0,794.0,794.0
0.013,17,2,179,1,71,0.0,43.0,43.0,1,108,0.0,80.0,80.0
0.209,6,10,1506,5,395,34.0,127.0,127.0,5,1111,51.0,843.0,843.0
0.072,6,10,1506,5,395,16.0,127.0,127.0,5,1111,15.0,843.0,843.0
0.004,6,10,2006,5,927,1.0,659.0,659.0,5,1079,1.0,811.0,811.0
0.008,6,10,1774,5,923,1.0,655.0,655.0,5,851,2.0,583.0,583.0
0.011,6,13,3816,7,578,1.0,206.0,206.0,6,3238,2.0,1470.0,1459.0
0.001,17,2,194,1,57,0.0,29.0,29.0,1,137,0.0,109.0,109.0
0.069,17,8,3613,4,1874,23.0,1350.0,440.0,4,1739,12.0,1350.0,406.0
120.771,6,53,18662,31,4618,4025.0,1054.0,253.0,22,14044,5750.0,2804.0,1074.0
1756.145,6,105,6270,60,3525,29764.0,27.0,27.0,45,2745,39911.0,27.0,27.0
0.109,6,10,1506,5,395,25.0,127.0,127.0,5,1111,25.0,843.0,843.0
0.005,6,10,2007,5,928,1.0,660.0,660.0,5,1079,1.0,811.0,811.0
0.085,6,10,1506,5,395,19.0,127.0,127.0,5,1111,19.0,843.0,843.0
1771.695,17,120,11460,60,5460,30028.0,63.0,63.0,60,6000,30028.0,72.0,72.0
0.006,6,10,1689,5,839,1.0,571.0,571.0,5,850,1.0,582.0,582.0
0.016,17,2,180,1,66,0.0,38.0,38.0,1,114,0.0,86.0,86.0
0.005,6,13,3747,7,509,0.0,137.0,137.0,6,3238,0.0,1470.0,1459.0
0.039,17,2,136,1,60,0.0,32.0,32.0,1,76,0.0,48.0,48.0
240.12,6,31,9178,15,6853,17151.0,1977.0,675.0,16,2325,16007.0,580.0,185.0
0.004,17,2,148,1,60,0.0,32.0,32.0,1,88,0.0,60.0,60.0
0.001,17,2,180,1,66,0.0,38.0,38.0,1,114,0.0,86.0,86.0
0.137,6,10,1506,5,395,27.0,127.0,127.0,5,1111,33.0,843.0,843.0
0.007,17,2,194,1,59,0.0,31.0,31.0,1,135,0.0,107.0,107.0
0.01,6,10,1983,5,910,2.0,642.0,642.0,5,1073,2.0,805.0,805.0
0.013,6,10,1989,5,910,3.0,642.0,642.0,5,1079,3.0,811.0,811.0
0.006,6,10,1547,5,764,1.0,496.0,496.0,5,783,1.0,515.0,515.0
0.005,17,2,164,1,74,0.0,46.0,46.0,1,90,0.0,62.0,62.0
40.08,17,10,676,5,460,10019.0,104.0,64.0,5,216,10019.0,20.0,15.0
0.006,6,10,1689,5,839,1.0,571.0,571.0,5,850,1.0,582.0,582.0
0.005,6,10,2000,5,927,1.0,659.0,659.0,5,1073,1.0,805.0,805.0
0.038,17,2,136,1,60,0.0,32.0,32.0,1,76,0.0,48.0,48.0
0.007,17,2,179,1,71,0.0,43.0,43.0,1,108,0.0,80.0,80.0
0.006,6,10,1547,5,764,1.0,496.0,496.0,5,783,1.0,515.0,515.0
11.182,17,28,4424,14,1995,847.0,270.0,114.0,14,2429,846.0,588.0,145.0
15.078,17,18,8729,9,6042,1881.0,1350.0,643.0,9,2687,1881.0,1350.0,270.0
0.006,6,10,1547,5,764,1.0,496.0,496.0,5,783,1.0,515.0,515.0
0.005,6,10,1689,5,839,1.0,571.0,571.0,5,850,1.0,582.0,582.0
0.005,6,10,2006,5,927,1.0,659.0,659.0,5,1079,1.0,811.0,811.0
0.008,6,10,1972,5,910,2.0,642.0,642.0,5,1062,2.0,794.0,794.0
0.005,6,10,2007,5,928,1.0,660.0,660.0,5,1079,1.0,811.0,811.0
0.02,6,10,1972,5,910,5.0,642.0,642.0,5,1062,4.0,794.0,794.0
0.006,17,2,179,1,71,0.0,43.0,43.0,1,108,0.0,80.0,80.0
0.005,6,13,3747,7,509,0.0,137.0,137.0,6,3238,0.0,1470.0,1459.0
0.009,6,12,1926,6,1189,1.0,659.0,434.0,6,737,1.0,417.0,417.0
0.079,6,10,1506,5,395,17.0,127.0,127.0,5,1111,17.0,843.0,843.0
0.003,17,2,148,1,60,0.0,32.0,32.0,1,88,0.0,60.0,60.0
0.001,17,2,180,1,66,0.0,38.0,38.0,1,114,0.0,86.0,86.0
0.042,17,2,170,1,65,0.0,37.0,37.0,1,105,0.0,77.0,77.0
0.005,6,14,3736,7,446,0.0,74.0,74.0,7,3290,0.0,1448.0,972.0
0.005,6,10,2000,5,927,1.0,659.0,659.0,5,1073,1.0,805.0,805.0
0.077,6,10,1506,5,395,17.0,127.0,127.0,5,1111,15.0,843.0,843.0
0.005,6,10,2007,5,928,1.0,660.0,660.0,5,1079,1.0,811.0,811.0
40.054,17,10,676,5,460,10011.0,104.0,64.0,5,216,10012.0,20.0,15.0
0.015,6,10,1677,5,827,3.0,559.0,559.0,5,850,3.0,582.0,582.0
0.043,17,2,170,1,65,0.0,37.0,37.0,1,105,0.0,77.0,77.0
0.004,17,2,152,1,76,0.0,48.0,48.0,1,76,0.0,48.0,48.0
240.086,6,16,4481,9,963,30010.0,238.0,166.0,7,3518,40013.0,1402.0,786.0
40.075,17,10,676,5,460,10016.0,104.0,64.0,5,216,10017.0,20.0,15.0
240.093,6,17,4532,10,1015,26677.0,238.0,166.0,7,3517,40015.0,1402.0,786.0
0.006,6,10,1643,5,860,1.0,592.0,592.0,5,783,1.0,515.0,515.0
92.824,6,21,8146,11,1985,84.0,1174.0,504.0,10,6161,10295.0,2720.0,958.0
0.11,6,10,1506,5,395,21.0,127.0,127.0,5,1111,24.0,843.0,843.0
0.009,17,2,338,1,74,0.0,46.0,46.0,1,264,0.0,236.0,236.0
0.004,6,10,2006,5,927,1.0,659.0,659.0,5,1079,1.0,811.0,811.0
0.011,6,10,1972,5,910,2.0,642.0,642.0,5,1062,2.0,794.0,794.0
0.008,6,10,1762,5,911,2.0,643.0,643.0,5,851,2.0,583.0,583.0
40.063,17,10,676,5,460,10014.0,104.0,64.0,5,216,10015.0,20.0,15.0
0.085,6,10,1506,5,395,18.0,127.0,127.0,5,1111,19.0,843.0,843.0
0.013,6,10,1972,5,910,3.0,642.0,642.0,5,1062,3.0,794.0,794.0
0.163,17,2,152,1,76,0.0,48.0,48.0,1,76,0.0,48.0,48.0
0.008,6,10,1990,5,911,2.0,643.0,643.0,5,1079,1.0,811.0,811.0
352.241,6,20,2210,6,1308,12003.0,494.0,494.0,14,902,27095.0,83.0,83.0
0.01,6,10,1972,5,910,2.0,642.0,642.0,5,1062,2.0,794.0,794.0
0.098,6,10,1506,5,395,20.0,127.0,127.0,5,1111,21.0,843.0,843.0
0.004,17,2,148,1,60,0.0,32.0,32.0,1,88,0.0,60.0,60.0
0.005,6,10,2007,5,928,1.0,660.0,660.0,5,1079,1.0,811.0,811.0
0.054,6,10,1506,5,395,12.0,127.0,127.0,5,1111,13.0,843.0,843.0
0.009,6,10,1677,5,827,2.0,559.0,559.0,5,850,2.0,582.0,582.0
0.078,6,10,1506,5,395,14.0,127.0,127.0,5,1111,16.0,843.0,843.0
11.139,17,28,4418,14,1994,844.0,269.0,114.0,14,2424,844.0,587.0,145.0
0.007,17,2,194,1,59,0.0,31.0,31.0,1,135,0.0,107.0,107.0
0.022,6,10,1990,5,911,5.0,643.0,643.0,5,1079,5.0,811.0,811.0
0.006,6,10,2006,5,927,1.0,659.0,659.0,5,1079,1.0,811.0,811.0
0.083,6,10,1506,5,395,18.0,127.0,127.0,5,1111,20.0,843.0,843.0
0.081,6,10,1506,5,395,16.0,127.0,127.0,5,1111,19.0,843.0,843.0
0.145,6,10,1506,5,395,33.0,127.0,127.0,5,1111,34.0,843.0,843.0
0.005,6,10,2006,5,927,1.0,659.0,659.0,5,1079,1.0,811.0,811.0
0.26,17,41,20333,22,17093,12.0,1350.0,748.0,19,3240,10.0,1350.0,142.0
0.006,6,10,1547,5,764,1.0,496.0,496.0,5,783,1.0,515.0,515.0
0.006,6,10,1547,5,764,1.0,496.0,496.0,5,783,1.0,515.0,515.0
0.005,6,10,2007,5,928,1.0,660.0,660.0,5,1079,1.0,811.0,811.0
126.028,6,13,2150,7,1716,20966.0,1424.0,1424.0,6,434,25159.0,182.0,182.0
0.001,17,2,180,1,66,0.0,38.0,38.0,1,114,0.0,86.0,86.0
0.005,17,2,166,1,75,0.0,47.0,47.0,1,91,0.0,63.0,63.0
0.151,6,10,1506,5,395,36.0,127.0,127.0,5,1111,36.0,843.0,843.0
0.013,6,10,1972,5,910,3.0,642.0,642.0,5,1062,3.0,794.0,794.0
0.004,6,10,2006,5,927,1.0,659.0,659.0,5,1079,1.0,811.0,811.0
0.094,6,10,1506,5,395,19.0,127.0,127.0,5,1111,21.0,843.0,843.0
15.07,17,15,9238,8,6902,2148.0,1350.0,834.0,7,2336,2506.0,1350.0,305.0
0.098,6,10,1506,5,395,20.0,127.0,127.0,5,1111,23.0,843.0,843.0
0.11,6,10,1506,5,395,26.0,127.0,127.0,5,1111,26.0,843.0,843.0
0.018,6,10,1990,5,911,4.0,643.0,643.0,5,1079,4.0,811.0,811.0
0.078,6,10,1506,5,395,18.0,127.0,127.0,5,1111,14.0,843.0,843.0
0.004,6,10,1702,5,863,1.0,595.0,595.0,5,839,0.0,571.0,571.0
0.186,17,2,160,1,72,0.0,44.0,44.0,1,88,0.0,60.0,60.0
0.07,6,10,1506,5,395,15.0,127.0,127.0,5,1111,15.0,843.0,843.0
0.005,6,10,2007,5,928,1.0,660.0,660.0,5,1079,1.0,811.0,811.0
0.001,17,2,180,1,66,0.0,38.0,38.0,1,114,0.0,86.0,86.0
0.005,6,13,3747,7,509,0.0,137.0,137.0,6,3238,0.0,1470.0,1459.0
0.007,17,2,170,1,65,0.0,37.0,37.0,1,105,0.0,77.0,77.0
1795.545,6,244,35804,152,26032,11891.0,302.0,302.0,92,9772,19731.0,83.0,83.0
0.113,6,10,1506,5,395,24.0,127.0,127.0,5,1111,23.0,843.0,843.0
0.011,6,10,1990,5,911,2.0,643.0,643.0,5,1079,2.0,811.0,811.0
0.012,6,10,1762,5,911,2.0,643.0,643.0,5,851,2.0,583.0,583.0
40.075,17,10,676,5,460,10016.0,104.0,64.0,5,216,10017.0,20.0,15.0
0.005,6,10,1989,5,927,1.0,659.0,659.0,5,1062,1.0,794.0,794.0
0.005,6,10,2006,5,927,1.0,659.0,659.0,5,1079,1.0,811.0,811.0
0.099,17,2,80,1,32,0.0,4.0,4.0,1,48,0.0,20.0,20.0
0.008,6,12,1926,6,1189,1.0,659.0,434.0,6,737,1.0,417.0,417.0
0.017,6,11,1814,6,963,3.0,643.0,643.0,5,851,4.0,583.0,583.0
0.008,6,10,1990,5,911,2.0,643.0,643.0,5,1079,2.0,811.0,811.0
0.006,6,10,1689,5,839,1.0,571.0,571.0,5,850,1.0,582.0,582.0
0.008,6,10,1983,5,910,1.0,642.0,642.0,5,1073,1.0,805.0,805.0
0.008,6,10,1774,5,923,1.0,655.0,655.0,5,851,2.0,583.0,583.0
0.006,6,10,1547,5,764,1.0,496.0,496.0,5,783,1.0,515.0,515.0
11.136,17,28,4418,14,1994,843.0,269.0,114.0,14,2424,843.0,587.0,145.0
0.005,6,10,2006,5,927,1.0,659.0,659.0,5,1079,1.0,811.0,811.0
0.113,17,4,596,2,122,108.0,33.0,33.0,2,474,109.0,323.0,209.0
0.007,17,2,194,1,59,0.0,31.0,31.0,1,135,0.0,107.0,107.0
0.005,6,10,1989,5,927,1.0,659.0,659.0,5,1062,1.0,794.0,794.0
0.014,6,10,1989,5,910,3.0,642.0,642.0,5,1079,3.0,811.0,811.0
0.076,6,10,1506,5,395,16.0,127.0,127.0,5,1111,17.0,843.0,843.0
40.053,17,10,676,5,460,10012.0,104.0,64.0,5,216,10012.0,20.0,15.0
0.005,6,10,1854,5,889,1.0,621.0,621.0,5,965,1.0,697.0,697.0
0.08,6,10,1506,5,395,17.0,127.0,127.0,5,1111,17.0,843.0,843.0
0.013,6,10,1989,5,910,3.0,642.0,642.0,5,1079,3.0,811.0,811.0
0.013,6,10,1972,5,910,3.0,642.0,642.0,5,1062,3.0,794.0,794.0
0.006,6,10,1547,5,764,1.0,496.0,496.0,5,783,1.0,515.0,515.0
0.005,17,2,170,1,65,0.0,37.0,37.0,1,105,0.0,77.0,77.0
40.059,17,10,676,5,460,10013.0,104.0,64.0,5,216,10013.0,20.0,15.0
0.005,6,10,1774,5,923,1.0,655.0,655.0,5,851,1.0,583.0,583.0
1743.092,6,64,7360,42,4484,42514.0,1640.0,109.0,22,2876,82996.0,1112.0,82.0
0.074,6,10,1506,5,395,17.0,127.0,127.0,5,1111,17.0,843.0,843.0
0.006,6,10,2006,5,927,1.0,659.0,659.0,5,1079,1.0,811.0,811.0
0.005,6,13,3747,7,509,0.0,137.0,137.0,6,3238,1.0,1470.0,1459.0
0.005,6,10,1689,5,839,1.0,571.0,571.0,5,850,1.0,582.0,582.0
0.013,6,10,1972,5,910,3.0,642.0,642.0,5,1062,3.0,794.0,794.0
0.215,6,16,2778,8,1396,30.0,533.0,324.0,8,1382,19.0,529.0,239.0
0.009,6,10,1990,5,911,2.0,643.0,643.0,5,1079,2.0,811.0,811.0
0.001,17,2,180,1,66,0.0,38.0,38.0,1,114,0.0,86.0,86.0
0.005,6,10,1989,5,927,1.0,659.0,659.0,5,1062,1.0,794.0,794.0
240.087,6,16,4481,9,963,30010.0,238.0,166.0,7,3518,40013.0,1402.0,786.0
0.004,17,2,136,1,60,0.0,32.0,32.0,1,76,0.0,48.0,48.0
0.006,17,2,268,1,70,0.0,42.0,42.0,1,198,0.0,170.0,170.0
0.168,6,10,1506,5,395,40.0,127.0,127.0,5,1111,39.0,843.0,843.0
0.004,6,10,2007,5,928,1.0,660.0,660.0,5,1079,1.0,811.0,811.0
40.08,17,10,676,5,460,10017.0,104.0,64.0,5,216,10019.0,20.0,15.0
0.07,6,10,1506,5,395,15.0,127.0,127.0,5,1111,15.0,843.0,843.0
0.773,6,10,2009,6,1655,154.0,1403.0,1403.0,4,354,179.0,182.0,182.0
314.936,17,20,1124,10,716,34978.0,48.0,43.0,10,408,34978.0,20.0,12.0
0.008,6,10,1762,5,911,2.0,643.0,643.0,5,851,2.0,583.0,583.0
0.005,17,2,170,1,65,0.0,37.0,37.0,1,105,0.0,77.0,77.0
0.005,6,10,1643,5,860,1.0,592.0,592.0,5,783,1.0,515.0,515.0
0.005,17,2,184,1,68,0.0,40.0,40.0,1,116,0.0,88.0,88.0
313.762,17,20,1124,10,716,34848.0,48.0,43.0,10,408,34848.0,20.0,12.0
0.005,17,2,164,1,74,0.0,46.0,46.0,1,90,0.0,62.0,62.0
0.005,6,10,1989,5,927,1.0,659.0,659.0,5,1062,1.0,794.0,794.0
369.44,6,24,2405,17,919,23090.0,195.0,195.0,7,1486,3906.0,419.0,398.0
0.01,6,10,1983,5,910,2.0,642.0,642.0,5,1073,2.0,805.0,805.0
0.004,6,10,2006,5,927,1.0,659.0,659.0,5,1079,1.0,811.0,811.0
0.039,17,2,148,1,60,0.0,32.0,32.0,1,88,0.0,60.0,60.0
0.018,6,10,1983,5,910,4.0,642.0,642.0,5,1073,4.0,805.0,805.0
0.016,6,10,1989,5,910,4.0,642.0,642.0,5,1079,4.0,811.0,811.0
40.079,17,10,676,5,460,10018.0,104.0,64.0,5,216,10018.0,20.0,15.0
240.011,6,9,787,5,488,60002.0,232.0,232.0,4,299,80002.0,83.0,83.0
0.007,6,10,1547,5,764,1.0,496.0,496.0,5,783,1.0,515.0,515.0
0.006,6,10,1643,5,860,1.0,592.0,592.0,5,783,1.0,515.0,515.0
0.099,6,10,1506,5,395,24.0,127.0,127.0,5,1111,22.0,843.0,843.0
9.04,17,6,376,5,280,2260.0,28.0,28.0,1,96,0.0,68.0,68.0
0.01,6,10,1779,5,928,2.0,660.0,660.0,5,851,2.0,583.0,583.0
40.057,17,10,676,5,460,10013.0,104.0,64.0,5,216,10013.0,20.0,15.0
0.04,17,2,148,1,60,0.0,32.0,32.0,1,88,0.0,60.0,60.0
0.006,6,10,1547,5,764,1.0,496.0,496.0,5,783,1.0,515.0,515.0
0.009,6,13,3735,7,497,1.0,125.0,125.0,6,3238,1.0,1470.0,1459.0
0.019,6,10,1989,5,910,4.0,642.0,642.0,5,1079,4.0,811.0,811.0
0.017,6,10,1677,5,827,4.0,559.0,559.0,5,850,4.0,582.0,582.0
0.005,6,10,1854,5,889,1.0,621.0,621.0,5,965,1.0,697.0,697.0
0.042,17,2,148,1,60,0.0,32.0,32.0,1,88,0.0,60.0,60.0
0.007,6,10,2007,5,928,1.0,660.0,660.0,5,1079,1.0,811.0,811.0
0.012,6,10,1989,5,910,2.0,642.0,642.0,5,1079,3.0,811.0,811.0
0.006,6,13,3690,7,452,1.0,80.0,80.0,6,3238,1.0,1470.0,1459.0
0.088,6,10,1506,5,395,21.0,127.0,127.0,5,1111,17.0,843.0,843.0
0.005,17,4,284,2,120,1.0,32.0,32.0,2,164,1.0,60.0,54.0
0.017,6,10,1605,5,388,4.0,120.0,120.0,5,1217,4.0,949.0,949.0
0.01,6,10,1983,5,910,2.0,642.0,642.0,5,1073,2.0,805.0,805.0
0.005,6,10,1779,5,928,1.0,660.0,660.0,5,851,1.0,583.0,583.0
0.011,6,10,1990,5,911,2.0,643.0,643.0,5,1079,2.0,811.0,811.0
0.01,17,2,179,1,71,0.0,43.0,43.0,1,108,0.0,80.0,80.0
0.008,6,10,1989,5,910,2.0,642.0,642.0,5,1079,2.0,811.0,811.0
0.147,6,10,1506,5,395,27.0,127.0,127.0,5,1111,33.0,843.0,843.0
0.017,6,10,1631,5,848,4.0,580.0,580.0,5,783,4.0,515.0,515.0
0.004,17,2,140,1,62,0.0,34.0,34.0,1,78,0.0,50.0,50.0
0.11,6,10,1506,5,395,24.0,127.0,127.0,5,1111,23.0,843.0,843.0
0.038,17,4,352,2,130,1.0,37.0,37.0,2,222,0.0,89.0,83.0
0.01,6,10,1972,5,910,2.0,642.0,642.0,5,1062,2.0,794.0,794.0
0.004,17,4,284,2,120,0.0,32.0,32.0,2,164,0.0,60.0,54.0
0.08,6,10,1506,5,395,19.0,127.0,127.0,5,1111,17.0,843.0,843.0
0.008,17,2,194,1,59,0.0,31.0,31.0,1,135,0.0,107.0,107.0
0.005,17,2,144,1,64,0.0,36.0,36.0,1,80,0.0,52.0,52.0
0.006,6,10,1989,5,910,1.0,642.0,642.0,5,1079,1.0,811.0,811.0
174.034,17,74,10653,37,2466,4834.0,44.0,38.0,37,8187,4834.0,239.0,193.0
0.103,6,10,1506,5,395,23.0,127.0,127.0,5,1111,22.0,843.0,843.0
0.006,6,10,1689,5,839,1.0,571.0,571.0,5,850,1.0,582.0,582.0
0.018,6,10,1983,5,910,4.0,642.0,642.0,5,1073,4.0,805.0,805.0
0.005,6,10,1989,5,927,1.0,659.0,659.0,5,1062,1.0,794.0,794.0
0.004,6,10,1989,5,927,1.0,659.0,659.0,5,1062,1.0,794.0,794.0
0.086,6,10,1506,5,395,16.0,127.0,127.0,5,1111,20.0,843.0,843.0
0.004,17,2,142,1,63,0.0,35.0,35.0,1,79,0.0,51.0,51.0
0.001,17,2,180,1,66,0.0,38.0,38.0,1,114,0.0,86.0,86.0
0.351,17,41,21664,22,18421,16.0,1350.0,809.0,19,3243,15.0,1350.0,142.0
240.086,6,16,4482,9,963,30010.0,238.0,166.0,7,3519,40013.0,1402.0,786.0
0.005,6,10,2000,5,927,1.0,659.0,659.0,5,1073,1.0,805.0,805.0
0.005,6,10,2007,5,928,1.0,660.0,660.0,5,1079,1.0,811.0,811.0
0.004,17,2,136,1,60,0.0,32.0,32.0,1,76,0.0,48.0,48.0
386.15,6,28,4345,13,3142,32179.0,494.0,494.0,15,1203,27581.0,83.0,83.0
0.039,17,4,284,2,120,0.0,32.0,32.0,2,164,36.0,60.0,54.0
0.01,6,10,1989,5,910,2.0,642.0,642.0,5,1079,2.0,811.0,811.0
0.077,6,10,1506,5,395,18.0,127.0,127.0,5,1111,14.0,843.0,843.0
0.104,6,10,1506,5,395,25.0,127.0,127.0,5,1111,23.0,843.0,843.0
0.012,6,10,1762,5,911,2.0,643.0,643.0,5,851,3.0,583.0,583.0
0.005,6,10,1989,5,927,1.0,659.0,659.0,5,1062,1.0,794.0,794.0
11.015,17,28,4419,14,1994,839.0,269.0,114.0,14,2425,839.0,588.0,145.0
0.005,6,10,2000,5,927,1.0,659.0,659.0,5,1073,1.0,805.0,805.0
0.043,17,2,136,1,60,0.0,32.0,32.0,1,76,0.0,48.0,48.0
0.012,6,10,1990,5,911,2.0,643.0,643.0,5,1079,2.0,811.0,811.0
0.006,6,10,1689,5,839,1.0,571.0,571.0,5,850,1.0,582.0,582.0
0.0,17,2,136,1,60,0.0,32.0,32.0,1,76,0.0,48.0,48.0
0.006,6,10,2006,5,927,1.0,659.0,659.0,5,1079,1.0,811.0,811.0
0.124,17,2,182,1,65,0.0,37.0,37.0,1,117,0.0,89.0,89.0
0.014,6,10,1989,5,910,3.0,642.0,642.0,5,1079,3.0,811.0,811.0
0.006,6,10,1854,5,889,1.0,621.0,621.0,5,965,1.0,697.0,697.0
0.004,6,10,1989,5,927,1.0,659.0,659.0,5,1062,1.0,794.0,794.0
0.003,17,2,136,1,60,0.0,32.0,32.0,1,76,0.0,48.0,48.0
0.004,6,10,2007,5,928,1.0,660.0,660.0,5,1079,1.0,811.0,811.0
240.138,6,45,7000,22,3223,11435.0,588.0,230.0,23,3777,10915.0,589.0,257.0
0.038,17,4,284,2,120,0.0,32.0,32.0,2,164,34.0,60.0,54.0
0.01,6,10,1677,5,827,2.0,559.0,559.0,5,850,2.0,582.0,582.0
0.02,6,10,1990,5,911,5.0,643.0,643.0,5,1079,4.0,811.0,811.0
0.039,17,4,284,2,120,1.0,32.0,32.0,2,164,35.0,60.0,54.0
0.012,6,10,1989,5,910,3.0,642.0,642.0,5,1079,2.0,811.0,811.0
1755.947,6,441,64944,252,35168,6995.0,613.0,197.0,189,29776,9339.0,453.0,142.0
0.009,6,10,1989,5,910,2.0,642.0,642.0,5,1079,2.0,811.0,811.0
0.072,6,10,1506,5,395,16.0,127.0,127.0,5,1111,14.0,843.0,843.0
0.109,6,10,1506,5,395,24.0,127.0,127.0,5,1111,23.0,843.0,843.0
0.004,6,10,1989,5,927,1.0,659.0,659.0,5,1062,1.0,794.0,794.0
0.031,6,10,1989,5,910,7.0,642.0,642.0,5,1079,7.0,811.0,811.0
0.005,17,2,164,1,74,0.0,46.0,46.0,1,90,0.0,62.0,62.0
0.004,6,10,1989,5,927,1.0,659.0,659.0,5,1062,1.0,794.0,794.0
0.008,17,2,179,1,71,0.0,43.0,43.0,1,108,0.0,80.0,80.0
0.083,6,10,1506,5,395,18.0,127.0,127.0,5,1111,18.0,843.0,843.0
0.018,6,10,1677,5,827,4.0,559.0,559.0,5,850,4.0,582.0,582.0
40.072,17,10,676,5,460,10017.0,104.0,64.0,5,216,10016.0,20.0,15.0
0.081,6,10,1506,5,395,17.0,127.0,127.0,5,1111,19.0,843.0,843.0
0.01,6,10,1779,5,928,2.0,660.0,660.0,5,851,2.0,583.0,583.0
0.004,17,4,284,2,120,0.0,32.0,32.0,2,164,0.0,60.0,54.0
0.088,6,10,1506,5,395,19.0,127.0,127.0,5,1111,19.0,843.0,843.0
0.004,6,10,2006,5,927,1.0,659.0,659.0,5,1079,1.0,811.0,811.0
0.011,6,10,1989,5,910,2.0,642.0,642.0,5,1079,2.0,811.0,811.0
309.77,17,20,1124,10,716,34405.0,48.0,43.0,10,408,34405.0,20.0,12.0
309.091,17,20,1124,10,716,34336.0,48.0,43.0,10,408,34336.0,20.0,12.0
0.071,6,10,1506,5,395,16.0,127.0,127.0,5,1111,15.0,843.0,843.0
0.124,17,2,170,1,65,0.0,37.0,37.0,1,105,0.0,77.0,77.0
0.013,6,10,1972,5,910,3.0,642.0,642.0,5,1062,3.0,794.0,794.0
0.075,6,10,1506,5,395,17.0,127.0,127.0,5,1111,17.0,843.0,843.0
0.017,6,10,1989,5,910,4.0,642.0,642.0,5,1079,4.0,811.0,811.0
0.01,6,10,1983,5,910,2.0,642.0,642.0,5,1073,2.0,805.0,805.0
0.003,17,2,148,1,60,0.0,32.0,32.0,1,88,0.0,60.0,60.0
0.012,6,10,1989,5,910,3.0,642.0,642.0,5,1079,2.0,811.0,811.0
0.813,6,25,5459,12,1557,65.0,325.0,152.0,13,3902,58.0,1414.0,563.0
1792.508,6,303,97683,188,86455,9585.0,2001.0,678.0,115,11228,15723.0,452.0,70.0
586.173,6,74,4984,29,2172,20934.0,46.0,46.0,45,2812,13319.0,46.0,46.0
0.005,6,14,3736,7,446,0.0,74.0,74.0,7,3290,0.0,1448.0,972.0
352.246,6,20,2210,6,1308,12003.0,494.0,494.0,14,902,27095.0,83.0,83.0
0.005,6,10,2006,5,927,1.0,659.0,659.0,5,1079,1.0,811.0,811.0
0.009,6,13,3735,7,497,1.0,125.0,125.0,6,3238,1.0,1470.0,1459.0
0.113,6,10,1506,5,395,26.0,127.0,127.0,5,1111,25.0,843.0,843.0
0.004,6,10,1702,5,863,0.0,595.0,595.0,5,839,1.0,571.0,571.0
0.071,17,4,284,2,120,0.0,32.0,32.0,2,164,68.0,60.0,54.0
0.006,6,10,1643,5,860,1.0,592.0,592.0,5,783,1.0,515.0,515.0
0.004,6,10,2006,5,927,1.0,659.0,659.0,5,1079,1.0,811.0,811.0
0.027,17,2,170,1,65,0.0,37.0,37.0,1,105,0.0,77.0,77.0
240.086,6,16,4480,9,963,30010.0,238.0,166.0,7,3517,40013.0,1402.0,786.0
0.004,6,10,2007,5,928,1.0,660.0,660.0,5,1079,1.0,811.0,811.0
0.072,6,10,1506,5,395,16.0,127.0,127.0,5,1111,15.0,843.0,843.0
0.007,6,10,2007,5,928,1.0,660.0,660.0,5,1079,1.0,811.0,811.0
0.005,6,10,2007,5,928,1.0,660.0,660.0,5,1079,1.0,811.0,811.0
0.005,17,2,169,1,62,0.0,34.0,34.0,1,107,0.0,79.0,79.0
0.005,6,10,1779,5,928,1.0,660.0,660.0,5,851,1.0,583.0,583.0
15.072,17,15,9238,8,6902,2149.0,1350.0,834.0,7,2336,2507.0,1350.0,305.0
0.002,17,2,180,1,66,0.0,38.0,38.0,1,114,0.0,86.0,86.0
0.01,6,13,3735,7,497,1.0,125.0,125.0,6,3238,1.0,1470.0,1459.0
0.006,6,10,1643,5,860,1.0,592.0,592.0,5,783,1.0,515.0,515.0
0.008,6,12,1926,6,1189,1.0,659.0,434.0,6,737,1.0,417.0,417.0
0.01,6,10,1989,5,910,2.0,642.0,642.0,5,1079,2.0,811.0,811.0
0.072,17,2,184,1,61,0.0,33.0,33.0,1,123,0.0,95.0,95.0
0.069,17,8,3613,4,1874,23.0,1350.0,440.0,4,1739,11.0,1350.0,406.0
240.015,6,9,787,5,488,60003.0,232.0,232.0,4,299,80003.0,83.0,83.0
0.005,17,2,166,1,75,0.0,47.0,47.0,1,91,0.0,63.0,63.0
0.009,6,12,1926,6,1189,1.0,659.0,434.0,6,737,1.0,417.0,417.0
0.004,6,10,2006,5,927,1.0,659.0,659.0,5,1079,1.0,811.0,811.0
0.012,6,10,1989,5,910,3.0,642.0,642.0,5,1079,3.0,811.0,811.0
0.125,6,10,1506,5,395,30.0,127.0,127.0,5,1111,29.0,843.0,843.0
1756.07,6,105,6270,60,3525,29763.0,27.0,27.0,45,2745,39909.0,27.0,27.0
0.113,6,10,1506,5,395,25.0,127.0,127.0,5,1111,24.0,843.0,843.0
0.003,17,2,136,1,60,0.0,32.0,32.0,1,76,0.0,48.0,48.0
0.023,6,10,1631,5,848,5.0,580.0,580.0,5,783,5.0,515.0,515.0
0.135,17,2,80,1,32,0.0,4.0,4.0,1,48,0.0,20.0,20.0
0.069,6,10,1506,5,395,15.0,127.0,127.0,5,1111,15.0,843.0,843.0
0.165,17,2,166,1,75,0.0,47.0,47.0,1,91,0.0,63.0,63.0
0.047,17,2,209,1,64,0.0,36.0,36.0,1,145,0.0,117.0,117.0
0.005,6,10,1854,5,889,1.0,621.0,621.0,5,965,1.0,697.0,697.0
309.121,17,20,1124,10,716,34333.0,48.0,43.0,10,408,34340.0,20.0,12.0
0.005,6,10,1689,5,839,1.0,571.0,571.0,5,850,1.0,582.0,582.0
300.032,6,12,1782,7,1348,50005.0,494.0,494.0,5,434,75007.0,83.0,83.0
0.01,6,10,1989,5,910,2.0,642.0,642.0,5,1079,2.0,811.0,811.0
0.008,6,10,1983,5,910,1.0,642.0,642.0,5,1073,2.0,805.0,805.0
0.009,6,10,1989,5,910,2.0,642.0,642.0,5,1079,2.0,811.0,811.0
0.006,6,10,1547,5,764,1.0,496.0,496.0,5,783,1.0,515.0,515.0
0.01,6,10,1972,5,910,2.0,642.0,642.0,5,1062,2.0,794.0,794.0
0.058,6,10,1506,5,395,12.0,127.0,127.0,5,1111,13.0,843.0,843.0
0.019,6,10,1972,5,910,4.0,642.0,642.0,5,1062,4.0,794.0,794.0
0.003,17,2,148,1,60,0.0,32.0,32.0,1,88,0.0,60.0,60.0
308.758,17,20,1124,10,716,34292.0,48.0,43.0,10,408,34292.0,20.0,12.0
0.008,6,10,1972,5,910,2.0,642.0,642.0,5,1062,2.0,794.0,794.0
0.079,6,10,1506,5,395,18.0,127.0,127.0,5,1111,13.0,843.0,843.0
0.006,17,2,169,1,62,0.0,34.0,34.0,1,107,0.0,79.0,79.0
0.005,17,2,230,1,68,0.0,40.0,40.0,1,162,0.0,134.0,134.0
312.222,17,20,1124,10,716,34677.0,48.0,43.0,10,408,34675.0,20.0,12.0
0.021,6,10,1990,5,911,5.0,643.0,643.0,5,1079,5.0,811.0,811.0
0.011,6,10,1983,5,910,2.0,642.0,642.0,5,1073,2.0,805.0,805.0
0.189,6,10,1506,5,395,42.0,127.0,127.0,5,1111,40.0,843.0,843.0
0.005,6,10,2006,5,927,1.0,659.0,659.0,5,1079,1.0,811.0,811.0
0.013,17,4,284,2,120,10.0,32.0,32.0,2,164,10.0,60.0,54.0
240.124,6,31,9437,15,7164,17151.0,2289.0,709.0,16,2273,16008.0,580.0,179.0
0.008,6,10,1972,5,910,2.0,642.0,642.0,5,1062,2.0,794.0,794.0
0.01,6,10,1972,5,910,2.0,642.0,642.0,5,1062,2.0,794.0,794.0
40.066,17,10,676,5,460,10015.0,104.0,64.0,5,216,10015.0,20.0,15.0
0.006,6,10,1547,5,764,1.0,496.0,496.0,5,783,1.0,515.0,515.0
40.051,17,10,676,5,460,10011.0,104.0,64.0,5,216,10012.0,20.0,15.0
0.014,6,10,1631,5,848,3.0,580.0,580.0,5,783,3.0,515.0,515.0
0.021,6,10,1989,5,910,5.0,642.0,642.0,5,1079,5.0,811.0,811.0
0.038,17,2,152,1,76,0.0,48.0,48.0,1,76,0.0,48.0,48.0
0.01,6,10,1983,5,910,2.0,642.0,642.0,5,1073,2.0,805.0,805.0
0.087,6,10,1506,5,395,21.0,127.0,127.0,5,1111,17.0,843.0,843.0
0.068,6,10,1506,5,395,15.0,127.0,127.0,5,1111,13.0,843.0,843.0
300.445,6,16,2170,9,684,37533.0,146.0,146.0,7,1486,50046.0,419.0,398.0
0.005,6,10,2006,5,927,1.0,659.0,659.0,5,1079,1.0,811.0,811.0
0.004,17,4,284,2,120,0.0,32.0,32.0,2,164,0.0,60.0,54.0
0.005,6,10,1702,5,863,1.0,595.0,595.0,5,839,1.0,571.0,571.0
0.006,6,10,1547,5,764,1.0,496.0,496.0,5,783,1.0,515.0,515.0
0.012,6,10,1983,5,910,3.0,642.0,642.0,5,1073,3.0,805.0,805.0
0.187,17,2,194,1,59,0.0,31.0,31.0,1,135,0.0,107.0,107.0
0.005,6,10,2007,5,928,1.0,660.0,660.0,5,1079,1.0,811.0,811.0
352.755,6,20,2210,6,1308,12006.0,494.0,494.0,14,902,27134.0,83.0,83.0
0.006,6,10,2000,5,927,1.0,659.0,659.0,5,1073,1.0,805.0,805.0
0.039,6,10,1989,5,910,9.0,642.0,642.0,5,1079,9.0,811.0,811.0
0.017,6,10,1990,5,911,4.0,643.0,643.0,5,1079,4.0,811.0,811.0
0.005,6,10,1689,5,839,1.0,571.0,571.0,5,850,1.0,582.0,582.0
0.005,6,14,3742,7,452,0.0,80.0,80.0,7,3290,0.0,1448.0,972.0
0.005,17,2,230,1,68,0.0,40.0,40.0,1,162,0.0,134.0,134.0
0.001,17,2,180,1,66,0.0,38.0,38.0,1,114,0.0,86.0,86.0
0.008,6,10,1547,5,764,1.0,496.0,496.0,5,783,1.0,515.0,515.0
0.008,6,10,1983,5,910,2.0,642.0,642.0,5,1073,2.0,805.0,805.0
0.006,6,10,1547,5,764,1.0,496.0,496.0,5,783,1.0,515.0,515.0
401.493,6,35,12860,19,2735,22305.0,585.0,345.0,16,10125,22765.0,1402.0,928.0
0.042,17,2,136,1,60,0.0,32.0,32.0,1,76,0.0,48.0,48.0
0.004,17,2,136,1,60,0.0,32.0,32.0,1,76,0.0,48.0,48.0
0.011,6,10,1989,5,910,2.0,642.0,642.0,5,1079,2.0,811.0,811.0
0.012,6,10,1990,5,911,3.0,643.0,643.0,5,1079,2.0,811.0,811.0
0.005,6,10,1989,5,927,1.0,659.0,659.0,5,1062,1.0,794.0,794.0
0.005,6,10,2000,5,927,1.0,659.0,659.0,5,1073,1.0,805.0,805.0
0.013,6,10,1631,5,848,3.0,580.0,580.0,5,783,3.0,515.0,515.0
0.006,6,10,1547,5,764,1.0,496.0,496.0,5,783,1.0,515.0,515.0
40.06,17,10,676,5,460,10014.0,104.0,64.0,5,216,10014.0,20.0,15.0
0.024,6,10,1990,5,911,5.0,643.0,643.0,5,1079,5.0,811.0,811.0
0.101,6,10,1506,5,395,22.0,127.0,127.0,5,1111,22.0,843.0,843.0
0.066,6,10,1506,5,395,14.0,127.0,127.0,5,1111,14.0,843.0,843.0
0.093,6,10,1506,5,395,19.0,127.0,127.0,5,1111,21.0,843.0,843.0
292.051,6,23,6842,6,5657,16.0,3060.0,1779.0,17,1185,18253.0,293.0,293.0
0.073,6,10,1506,5,395,16.0,127.0,127.0,5,1111,15.0,843.0,843.0
40.06,17,10,676,5,460,10012.0,104.0,64.0,5,216,10014.0,20.0,15.0
0.186,6,46,11746,25,3365,7.0,1082.0,187.0,21,8381,9.0,1402.0,606.0
0.012,6,10,1989,5,910,3.0,642.0,642.0,5,1079,2.0,811.0,811.0
0.007,17,2,179,1,71,0.0,43.0,43.0,1,108,0.0,80.0,80.0
0.001,17,2,180,1,66,0.0,38.0,38.0,1,114,0.0,86.0,86.0
0.005,6,10,2007,5,928,1.0,660.0,660.0,5,1079,1.0,811.0,811.0
0.12,6,10,1506,5,395,25.0,127.0,127.0,5,1111,25.0,843.0,843.0
0.004,17,2,148,1,60,0.0,32.0,32.0,1,88,0.0,60.0,60.0
0.087,6,10,1506,5,395,19.0,127.0,127.0,5,1111,20.0,843.0,843.0
240.097,6,31,8986,15,6767,17149.0,1891.0,665.0,16,2219,16006.0,580.0,172.0
0.005,6,10,1990,5,928,1.0,660.0,660.0,5,1062,1.0,794.0,794.0
0.005,6,10,1779,5,928,1.0,660.0,660.0,5,851,1.0,583.0,583.0
300.69,6,37,8261,20,1830,15825.0,651.0,249.0,17,6431,534.0,2720.0,478.0
0.005,6,10,1643,5,860,1.0,592.0,592.0,5,783,1.0,515.0,515.0
0.005,6,10,2000,5,927,1.0,659.0,659.0,5,1073,1.0,805.0,805.0
0.006,6,10,1547,5,764,1.0,496.0,496.0,5,783,1.0,515.0,515.0
0.005,6,10,2006,5,927,1.0,659.0,659.0,5,1079,1.0,811.0,811.0
40.054,17,10,676,5,460,10012.0,104.0,64.0,5,216,10012.0,20.0,15.0
11.176,17,28,4423,14,1994,847.0,269.0,114.0,14,2429,847.0,588.0,145.0
264.371,17,18,1008,9,640,33030.0,48.0,43.0,9,368,33030.0,20.0,12.0
0.012,6,10,1989,5,910,3.0,642.0,642.0,5,1079,2.0,811.0,811.0
0.007,17,2,194,1,59,0.0,31.0,31.0,1,135,0.0,107.0,107.0
40.058,17,10,676,5,460,10011.0,104.0,64.0,5,216,10013.0,20.0,15.0
0.016,6,10,1972,5,910,3.0,642.0,642.0,5,1062,4.0,794.0,794.0
0.005,6,10,2007,5,928,1.0,660.0,660.0,5,1079,1.0,811.0,811.0
0.007,6,10,2006,5,927,1.0,659.0,659.0,5,1079,1.0,811.0,811.0
0.006,6,10,1689,5,839,1.0,571.0,571.0,5,850,1.0,582.0,582.0
0.076,6,10,1506,5,395,17.0,127.0,127.0,5,1111,16.0,843.0,843.0
0.217,6,16,2669,8,1395,31.0,533.0,323.0,8,1274,20.0,529.0,212.0
0.205,6,16,2777,8,1395,29.0,533.0,323.0,8,1382,18.0,529.0,239.0
241.092,6,27,7795,12,3410,21917.0,1031.0,697.0,15,4385,17220.0,1162.0,399.0
40.102,17,10,676,5,460,10022.0,104.0,64.0,5,216,10024.0,20.0,15.0
0.006,6,10,1547,5,764,1.0,496.0,496.0,5,783,1.0,515.0,515.0
0.143,6,14,4388,8,923,20.0,238.0,166.0,6,3465,19.0,1402.0,786.0
351.991,6,20,2210,6,1308,12003.0,494.0,494.0,14,902,27076.0,83.0,83.0
300.216,6,20,5150,10,1724,33357.0,585.0,296.0,10,3426,26689.0,1402.0,724.0
0.005,17,2,170,1,65,0.0,37.0,37.0,1,105,0.0,77.0,77.0
0.005,6,10,2006,5,927,1.0,659.0,659.0,5,1079,1.0,811.0,811.0
0.001,17,2,180,1,66,0.0,38.0,38.0,1,114,0.0,86.0,86.0
0.006,6,10,2007,5,928,1.0,660.0,660.0,5,1079,1.0,811.0,811.0
0.014,6,13,3735,7,497,2.0,125.0,125.0,6,3238,2.0,1470.0,1459.0
0.148,6,10,1506,5,395,35.0,127.0,127.0,5,1111,32.0,843.0,843.0
0.011,6,10,1973,5,911,2.0,643.0,643.0,5,1062,2.0,794.0,794.0
0.001,17,2,136,1,60,0.0,32.0,32.0,1,76,0.0,48.0,48.0
0.034,17,2,152,1,76,0.0,48.0,48.0,1,76,0.0,48.0,48.0
0.112,6,10,1506,5,395,27.0,127.0,127.0,5,1111,22.0,843.0,843.0
0.015,6,10,1972,5,910,3.0,642.0,642.0,5,1062,3.0,794.0,794.0
361.799,6,19,1689,15,978,25842.0,190.0,190.0,4,711,80012.0,495.0,495.0
0.009,6,12,1926,6,1189,1.0,659.0,434.0,6,737,1.0,417.0,417.0
0.008,6,10,1983,5,910,2.0,642.0,642.0,5,1073,2.0,805.0,805.0
300.023,6,12,1782,7,1348,50003.0,494.0,494.0,5,434,75005.0,83.0,83.0
0.005,17,2,180,1,58,0.0,30.0,30.0,1,122,0.0,94.0,94.0
0.005,17,2,170,1,65,0.0,37.0,37.0,1,105,0.0,77.0,77.0
0.001,17,2,180,1,66,0.0,38.0,38.0,1,114,0.0,86.0,86.0
0.053,17,2,152,1,76,0.0,48.0,48.0,1,76,0.0,48.0,48.0
0.009,6,13,3735,7,497,1.0,125.0,125.0,6,3238,1.0,1470.0,1459.0
0.015,6,10,1989,5,910,3.0,642.0,642.0,5,1079,3.0,811.0,811.0
0.012,6,10,1972,5,910,2.0,642.0,642.0,5,1062,3.0,794.0,794.0
0.006,6,10,2000,5,927,1.0,659.0,659.0,5,1073,1.0,805.0,805.0
0.396,6,16,2777,8,1395,56.0,533.0,323.0,8,1382,45.0,529.0,239.0
0.001,17,2,180,1,66,0.0,38.0,38.0,1,114,0.0,86.0,86.0
0.184,6,46,11684,25,3304,7.0,1021.0,182.0,21,8380,9.0,1402.0,606.0
176.168,17,66,9432,33,2199,5505.0,44.0,38.0,33,7233,5505.0,260.0,191.0
0.211,6,16,2778,8,1396,30.0,533.0,324.0,8,1382,19.0,529.0,239.0
0.005,6,10,1854,5,889,1.0,621.0,621.0,5,965,1.0,697.0,697.0
0.071,17,8,3613,4,1874,23.0,1350.0,440.0,4,1739,10.0,1350.0,406.0
0.004,6,10,1702,5,863,1.0,595.0,595.0,5,839,1.0,571.0,571.0
0.001,17,2,180,1,66,0.0,38.0,38.0,1,114,0.0,86.0,86.0
0.01,6,10,1983,5,910,2.0,642.0,642.0,5,1073,2.0,805.0,805.0
0.078,6,10,1506,5,395,18.0,127.0,127.0,5,1111,15.0,843.0,843.0
0.009,6,10,1983,5,910,2.0,642.0,642.0,5,1073,2.0,805.0,805.0
0.007,6,10,1972,5,910,1.0,642.0,642.0,5,1062,1.0,794.0,794.0
0.005,6,10,1989,5,927,1.0,659.0,659.0,5,1062,1.0,794.0,794.0
0.014,6,10,1989,5,910,3.0,642.0,642.0,5,1079,3.0,811.0,811.0
0.006,6,10,1547,5,764,1.0,496.0,496.0,5,783,1.0,515.0,515.0
295.44,6,387,346987,205,22214,1448.0,2736.0,825.0,182,324773,1632.0,2804.0,1876.0
0.019,6,10,1972,5,910,4.0,642.0,642.0,5,1062,4.0,794.0,794.0
0.003,17,2,148,1,60,0.0,32.0,32.0,1,88,0.0,60.0,60.0
0.007,17,2,170,1,65,0.0,37.0,37.0,1,105,0.0,77.0,77.0
0.005,6,10,1547,5,764,1.0,496.0,496.0,5,783,1.0,515.0,515.0
0.01,6,10,1972,5,910,2.0,642.0,642.0,5,1062,2.0,794.0,794.0
40.053,17,10,676,5,460,10012.0,104.0,64.0,5,216,10012.0,20.0,15.0
0.017,17,2,198,1,91,0.0,63.0,63.0,1,107,0.0,79.0,79.0
0.011,6,10,1983,5,910,2.0,642.0,642.0,5,1073,2.0,805.0,805.0
0.009,6,10,1989,5,927,2.0,659.0,659.0,5,1062,2.0,794.0,794.0
0.092,6,10,1506,5,395,17.0,127.0,127.0,5,1111,19.0,843.0,843.0
163.374,17,74,10455,37,2474,4538.0,44.0,38.0,37,7981,4538.0,261.0,187.0
0.009,6,10,1989,5,927,2.0,659.0,659.0,5,1062,2.0,794.0,794.0
0.006,6,10,1854,5,889,1.0,621.0,621.0,5,965,1.0,697.0,697.0
0.008,6,10,1972,5,910,1.0,642.0,642.0,5,1062,2.0,794.0,794.0
0.004,6,10,1989,5,927,1.0,659.0,659.0,5,1062,1.0,794.0,794.0
0.009,6,10,1972,5,910,2.0,642.0,642.0,5,1062,2.0,794.0,794.0
0.005,6,10,2006,5,927,1.0,659.0,659.0,5,1079,1.0,811.0,811.0
0.015,17,2,198,1,91,0.0,63.0,63.0,1,107,0.0,79.0,79.0
40.065,17,10,676,5,460,10015.0,104.0,64.0,5,216,10015.0,20.0,15.0
301.018,6,47,17691,25,11784,12542.0,2720.0,1194.0,22,5907,421.0,2667.0,385.0
0.061,17,2,80,1,32,0.0,4.0,4.0,1,48,0.0,20.0,20.0
0.012,6,10,1972,5,910,3.0,642.0,642.0,5,1062,3.0,794.0,794.0
0.068,6,10,1506,5,395,14.0,127.0,127.0,5,1111,16.0,843.0,843.0
10.817,17,28,4421,14,1994,824.0,269.0,114.0,14,2427,824.0,586.0,145.0
0.001,17,2,136,1,60,0.0,32.0,32.0,1,76,0.0,48.0,48.0
11.536,17,28,4390,14,2312,874.0,587.0,137.0,14,2078,874.0,269.0,120.0
0.039,17,4,284,2,120,0.0,32.0,32.0,2,164,36.0,60.0,54.0
0.001,17,2,180,1,66,0.0,38.0,38.0,1,114,0.0,86.0,86.0
0.046,6,10,1989,5,910,11.0,642.0,642.0,5,1079,11.0,811.0,811.0
1.058,6,12,3142,6,2099,159.0,1328.0,923.0,6,1043,159.0,791.0,791.0
0.034,17,2,152,1,76,0.0,48.0,48.0,1,76,0.0,48.0,48.0
0.006,6,10,1643,5,860,1.0,592.0,592.0,5,783,1.0,515.0,515.0
0.004,6,10,2000,5,927,1.0,659.0,659.0,5,1073,1.0,805.0,805.0
0.006,6,10,1854,5,889,1.0,621.0,621.0,5,965,1.0,697.0,697.0
175.43,17,74,10515,37,2466,4872.0,44.0,38.0,37,8049,4872.0,239.0,189.0
290.157,6,20,4074,11,2920,29014.0,1273.0,468.0,9,1154,36268.0,501.0,230.0
0.014,6,10,1990,5,911,3.0,643.0,643.0,5,1079,3.0,811.0,811.0
0.082,6,10,1506,5,395,19.0,127.0,127.0,5,1111,16.0,843.0,843.0
0.005,6,10,1989,5,927,1.0,659.0,659.0,5,1062,1.0,794.0,794.0
1772.598,6,103,6166,59,3473,30561.0,27.0,27.0,44,2693,41222.0,27.0,27.0
0.001,17,2,180,1,65,0.0,37.0,37.0,1,115,0.0,87.0,87.0
0.001,17,2,136,1,60,0.0,32.0,32.0,1,76,0.0,48.0,48.0
0.088,6,10,1506,5,395,21.0,127.0,127.0,5,1111,18.0,843.0,843.0
0.009,6,10,1972,5,910,2.0,642.0,642.0,5,1062,2.0,794.0,794.0
0.002,17,2,179,1,62,0.0,34.0,34.0,1,117,0.0,89.0,89.0
0.004,6,10,1989,5,927,1.0,659.0,659.0,5,1062,1.0,794.0,794.0
0.006,6,10,1547,5,764,1.0,496.0,496.0,5,783,1.0,515.0,515.0
0.005,17,2,179,1,71,0.0,43.0,43.0,1,108,0.0,80.0,80.0
0.005,6,10,1547,5,764,1.0,496.0,496.0,5,783,1.0,515.0,515.0
0.013,6,10,1989,5,910,3.0,642.0,642.0,5,1079,3.0,811.0,811.0
0.011,6,10,1983,5,910,2.0,642.0,642.0,5,1073,2.0,805.0,805.0
176.511,17,84,11914,42,2798,4304.0,44.0,38.0,42,9116,4305.0,239.0,189.0
0.007,17,2,194,1,59,0.0,31.0,31.0,1,135,0.0,107.0,107.0
11.166,17,28,4422,14,1994,846.0,269.0,114.0,14,2428,846.0,587.0,145.0
0.023,6,10,1677,5,827,5.0,559.0,559.0,5,850,5.0,582.0,582.0
0.011,6,10,1989,5,910,2.0,642.0,642.0,5,1079,2.0,811.0,811.0
0.003,17,2,160,1,72,0.0,44.0,44.0,1,88,0.0,60.0,60.0
0.005,17,2,170,1,65,0.0,37.0,37.0,1,105,0.0,77.0,77.0
0.009,6,10,1983,5,910,2.0,642.0,642.0,5,1073,2.0,805.0,805.0
0.012,6,10,1762,5,911,2.0,643.0,643.0,5,851,3.0,583.0,583.0
0.076,6,10,1506,5,395,17.0,127.0,127.0,5,1111,16.0,843.0,843.0
0.001,17,2,136,1,60,0.0,32.0,32.0,1,76,0.0,48.0,48.0
0.004,17,2,148,1,60,0.0,32.0,32.0,1,88,0.0,60.0,60.0
0.015,6,13,3735,7,497,2.0,125.0,125.0,6,3238,3.0,1470.0,1459.0
240.093,6,16,4481,9,963,30011.0,238.0,166.0,7,3518,40014.0,1402.0,786.0
168.367,17,78,11037,39,2601,4430.0,44.0,38.0,39,8436,4430.0,239.0,188.0
0.005,6,10,2006,5,927,1.0,659.0,659.0,5,1079,1.0,811.0,811.0
0.169,17,2,152,1,76,0.0,48.0,48.0,1,76,0.0,48.0,48.0
0.004,6,10,2006,5,927,1.0,659.0,659.0,5,1079,1.0,811.0,811.0
0.005,6,10,1779,5,928,1.0,660.0,660.0,5,851,1.0,583.0,583.0
178.059,17,78,10989,39,2596,4685.0,44.0,38.0,39,8393,4685.0,252.0,187.0
40.054,17,10,676,5,460,10012.0,104.0,64.0,5,216,10012.0,20.0,15.0
0.002,17,2,136,1,60,0.0,32.0,32.0,1,76,0.0,48.0,48.0
0.013,6,10,1990,5,911,3.0,643.0,643.0,5,1079,3.0,811.0,811.0
0.042,6,13,3816,7,578,6.0,206.0,206.0,6,3238,8.0,1470.0,1459.0
0.006,6,10,1547,5,764,1.0,496.0,496.0,5,783,1.0,515.0,515.0
0.003,17,2,136,1,60,0.0,32.0,32.0,1,76,0.0,48.0,48.0
0.013,6,10,1989,5,910,3.0,642.0,642.0,5,1079,3.0,811.0,811.0
0.09,6,10,1506,5,395,20.0,127.0,127.0,5,1111,21.0,843.0,843.0
0.005,6,10,2007,5,928,1.0,660.0,660.0,5,1079,1.0,811.0,811.0
0.005,17,2,180,1,66,0.0,38.0,38.0,1,114,0.0,86.0,86.0
0.042,17,2,136,1,60,0.0,32.0,32.0,1,76,0.0,48.0,48.0
1.265,6,34,13472,19,5933,70.0,1360.0,732.0,15,7539,77.0,2720.0,769.0
0.013,6,10,1762,5,911,3.0,643.0,643.0,5,851,3.0,583.0,583.0
0.089,6,10,1506,5,395,20.0,127.0,127.0,5,1111,19.0,843.0,843.0
0.005,17,2,170,1,65,0.0,37.0,37.0,1,105,0.0,77.0,77.0
0.08,6,10,1506,5,395,16.0,127.0,127.0,5,1111,19.0,843.0,843.0
0.013,6,10,1989,5,910,3.0,642.0,642.0,5,1079,3.0,811.0,811.0
0.005,6,10,1774,5,923,1.0,655.0,655.0,5,851,1.0,583.0,583.0
0.027,6,10,1989,5,910,6.0,642.0,642.0,5,1079,6.0,811.0,811.0
240.014,6,9,787,5,488,60003.0,232.0,232.0,4,299,80004.0,83.0,83.0
0.004,6,10,2006,5,927,1.0,659.0,659.0,5,1079,1.0,811.0,811.0
0.004,6,14,3742,8,504,0.0,80.0,80.0,6,3238,0.0,1470.0,1459.0
0.166,17,2,152,1,76,0.0,48.0,48.0,1,76,0.0,48.0,48.0
40.067,17,10,676,5,460,10014.0,104.0,64.0,5,216,10016.0,20.0,15.0
0.006,6,10,1689,5,839,1.0,571.0,571.0,5,850,1.0,582.0,582.0
0.013,6,10,1677,5,827,3.0,559.0,559.0,5,850,3.0,582.0,582.0
0.007,6,10,1990,5,911,1.0,643.0,643.0,5,1079,1.0,811.0,811.0
0.038,17,2,152,1,76,0.0,48.0,48.0,1,76,0.0,48.0,48.0
0.003,17,2,148,1,60,0.0,32.0,32.0,1,88,0.0,60.0,60.0
11.141,17,28,4419,14,1994,844.0,269.0,114.0,14,2425,844.0,588.0,145.0
0.006,17,2,170,1,65,0.0,37.0,37.0,1,105,0.0,77.0,77.0
308.594,17,20,1124,10,716,34274.0,48.0,43.0,10,408,34274.0,20.0,12.0
0.005,6,10,2007,5,928,1.0,660.0,660.0,5,1079,1.0,811.0,811.0
40.075,17,10,676,5,460,10016.0,104.0,64.0,5,216,10017.0,20.0,15.0
0.009,17,4,284,2,120,0.0,32.0,32.0,2,164,0.0,60.0,54.0
0.006,6,10,1547,5,764,1.0,496.0,496.0,5,783,1.0,515.0,515.0
0.005,6,10,1689,5,839,1.0,571.0,571.0,5,850,1.0,582.0,582.0
0.001,17,2,180,1,66,0.0,38.0,38.0,1,114,0.0,86.0,86.0
0.096,6,10,1506,5,395,20.0,127.0,127.0,5,1111,21.0,843.0,843.0
0.005,6,10,1989,5,927,1.0,659.0,659.0,5,1062,1.0,794.0,794.0
0.017,6,10,1972,5,910,4.0,642.0,642.0,5,1062,4.0,794.0,794.0
0.006,6,10,1689,5,839,1.0,571.0,571.0,5,850,1.0,582.0,582.0
0.002,17,2,164,1,74,0.0,46.0,46.0,1,90,0.0,62.0,62.0
11.016,17,28,4421,14,1993,838.0,268.0,114.0,14,2428,838.0,587.0,145.0
40.067,17,10,676,5,460,10014.0,104.0,64.0,5,216,10015.0,20.0,15.0
11.404,17,28,4398,14,2312,864.0,587.0,137.0,14,2086,864.0,269.0,121.0
0.008,6,10,1983,5,910,2.0,642.0,642.0,5,1073,2.0,805.0,805.0
0.004,17,2,136,1,60,0.0,32.0,32.0,1,76,0.0,48.0,48.0
0.04,17,2,152,1,76,0.0,48.0,48.0,1,76,0.0,48.0,48.0
361.746,6,21,1792,16,1030,24116.0,190.0,190.0,5,762,60009.0,461.0,247.0
0.075,6,10,1506,5,395,17.0,127.0,127.0,5,1111,16.0,843.0,843.0
0.004,17,2,136,1,60,0.0,32.0,32.0,1,76,0.0,48.0,48.0
0.004,6,10,1989,5,927,1.0,659.0,659.0,5,1062,1.0,794.0,794.0
40.066,17,10,676,5,460,10015.0,104.0,64.0,5,216,10015.0,20.0,15.0
0.006,6,10,1689,5,839,1.0,571.0,571.0,5,850,1.0,582.0,582.0
0.001,17,2,180,1,66,0.0,38.0,38.0,1,114,0.0,86.0,86.0
15.077,17,16,9653,9,7515,1881.0,1350.0,807.0,7,2138,2508.0,1350.0,277.0
40.048,17,10,676,5,460,10010.0,104.0,64.0,5,216,10011.0,20.0,15.0
0.005,17,2,140,1,62,0.0,34.0,34.0,1,78,0.0,50.0,50.0
0.137,6,10,1506,5,395,31.0,127.0,127.0,5,1111,30.0,843.0,843.0
0.005,6,10,2007,5,928,1.0,660.0,660.0,5,1079,1.0,811.0,811.0
0.132,17,2,80,1,32,0.0,4.0,4.0,1,48,0.0,20.0,20.0
0.006,6,10,2006,5,927,1.0,659.0,659.0,5,1079,1.0,811.0,811.0
0.006,6,10,2007,5,928,1.0,660.0,660.0,5,1079,1.0,811.0,811.0
0.007,17,2,194,1,59,0.0,31.0,31.0,1,135,0.0,107.0,107.0
0.005,6,10,1989,5,927,1.0,659.0,659.0,5,1062,1.0,794.0,794.0
0.005,6,10,2000,5,927,1.0,659.0,659.0,5,1073,1.0,805.0,805.0
0.005,6,10,1689,5,839,1.0,571.0,571.0,5,850,1.0,582.0,582.0
40.073,17,10,676,5,460,10015.0,104.0,64.0,5,216,10017.0,20.0,15.0
0.015,6,10,1989,5,910,3.0,642.0,642.0,5,1079,3.0,811.0,811.0
0.006,17,2,230,1,68,0.0,40.0,40.0,1,162,0.0,134.0,134.0
0.004,6,10,2006,5,927,1.0,659.0,659.0,5,1079,1.0,811.0,811.0
0.076,6,10,1506,5,395,16.0,127.0,127.0,5,1111,17.0,843.0,843.0
0.071,6,10,1506,5,395,16.0,127.0,127.0,5,1111,14.0,843.0,843.0
0.005,6,10,1989,5,927,1.0,659.0,659.0,5,1062,1.0,794.0,794.0
0.006,6,10,1547,5,764,1.0,496.0,496.0,5,783,1.0,515.0,515.0
318.689,17,20,1124,10,716,35395.0,48.0,43.0,10,408,35395.0,20.0,12.0
0.001,17,2,179,1,62,0.0,34.0,34.0,1,117,0.0,89.0,89.0
0.005,17,2,169,1,62,0.0,34.0,34.0,1,107,0.0,79.0,79.0
0.012,6,10,1972,5,910,3.0,642.0,642.0,5,1062,3.0,794.0,794.0
240.081,6,16,4482,9,963,30010.0,238.0,166.0,7,3519,40013.0,1402.0,786.0
0.01,6,10,1990,5,911,2.0,643.0,643.0,5,1079,2.0,811.0,811.0
0.076,17,2,136,1,60,0.0,32.0,32.0,1,76,0.0,48.0,48.0
0.049,17,2,170,1,65,0.0,37.0,37.0,1,105,0.0,77.0,77.0
0.014,6,10,1990,5,911,3.0,643.0,643.0,5,1079,3.0,811.0,811.0
0.005,17,2,169,1,62,0.0,34.0,34.0,1,107,0.0,79.0,79.0
0.071,6,10,1506,5,395,15.0,127.0,127.0,5,1111,15.0,843.0,843.0
40.081,17,10,676,5,460,10019.0,104.0,64.0,5,216,10019.0,20.0,15.0
0.004,6,10,1702,5,863,1.0,595.0,595.0,5,839,1.0,571.0,571.0
0.007,6,10,1547,5,764,1.0,496.0,496.0,5,783,1.0,515.0,515.0
40.048,17,10,676,5,460,10010.0,104.0,64.0,5,216,10011.0,20.0,15.0
300.341,6,16,2170,9,684,37522.0,146.0,146.0,7,1486,50029.0,419.0,398.0
240.015,6,9,787,5,488,60003.0,232.0,232.0,4,299,80003.0,83.0,83.0
0.082,6,10,1506,5,395,19.0,127.0,127.0,5,1111,18.0,843.0,843.0
0.016,6,10,1983,5,910,4.0,642.0,642.0,5,1073,3.0,805.0,805.0
0.148,6,10,1506,5,395,27.0,127.0,127.0,5,1111,36.0,843.0,843.0
0.005,6,10,2006,5,927,1.0,659.0,659.0,5,1079,1.0,811.0,811.0
0.006,6,10,1854,5,889,1.0,621.0,621.0,5,965,1.0,697.0,697.0
0.003,17,4,284,2,120,0.0,32.0,32.0,2,164,0.0,60.0,54.0
0.004,6,10,1779,5,928,1.0,660.0,660.0,5,851,1.0,583.0,583.0
1797.174,6,522,107204,261,91421,6911.0,421.0,353.0,261,15783,6911.0,1414.0,118.0
0.006,6,10,1547,5,764,1.0,496.0,496.0,5,783,1.0,515.0,515.0
0.093,6,10,1506,5,395,20.0,127.0,127.0,5,1111,16.0,843.0,843.0
0.013,6,10,1989,5,910,3.0,642.0,642.0,5,1079,3.0,811.0,811.0
0.006,6,10,2006,5,927,1.0,659.0,659.0,5,1079,1.0,811.0,811.0
0.011,6,10,1983,5,910,2.0,642.0,642.0,5,1073,2.0,805.0,805.0
0.015,6,10,1990,5,911,3.0,643.0,643.0,5,1079,3.0,811.0,811.0
0.106,6,10,1506,5,395,24.0,127.0,127.0,5,1111,19.0,843.0,843.0
0.037,17,2,186,1,61,0.0,33.0,33.0,1,125,0.0,97.0,97.0
10.775,17,28,4423,14,1994,820.0,269.0,114.0,14,2429,820.0,588.0,145.0
0.1,6,10,1506,5,395,23.0,127.0,127.0,5,1111,22.0,843.0,843.0
11.5,17,28,4395,14,2312,872.0,587.0,137.0,14,2083,872.0,270.0,120.0
0.018,6,10,1631,5,848,4.0,580.0,580.0,5,783,4.0,515.0,515.0
0.044,17,4,596,2,122,7.0,33.0,33.0,2,474,7.0,323.0,209.0
15.171,17,20,11092,10,7353,1682.0,1350.0,707.0,10,3739,1682.0,1350.0,345.0
0.005,6,10,2006,5,927,1.0,659.0,659.0,5,1079,1.0,811.0,811.0
0.006,6,10,1989,5,927,1.0,659.0,659.0,5,1062,1.0,794.0,794.0
0.178,6,10,1506,5,395,42.0,127.0,127.0,5,1111,40.0,843.0,843.0
0.005,6,10,2006,5,927,1.0,659.0,659.0,5,1079,1.0,811.0,811.0
40.055,17,10,676,5,460,10012.0,104.0,64.0,5,216,10012.0,20.0,15.0
0.012,6,10,1983,5,910,3.0,642.0,642.0,5,1073,2.0,805.0,805.0
0.012,6,10,1990,5,911,3.0,643.0,643.0,5,1079,3.0,811.0,811.0
0.013,6,10,1631,5,848,3.0,580.0,580.0,5,783,3.0,515.0,515.0
0.079,6,10,1506,5,395,17.0,127.0,127.0,5,1111,14.0,843.0,843.0
0.088,6,10,1506,5,395,18.0,127.0,127.0,5,1111,20.0,843.0,843.0
0.075,6,10,1506,5,395,15.0,127.0,127.0,5,1111,15.0,843.0,843.0
0.084,6,10,1506,5,395,16.0,127.0,127.0,5,1111,19.0,843.0,843.0
0.005,17,2,144,1,64,0.0,36.0,36.0,1,80,0.0,52.0,52.0
0.016,6,10,1631,5,848,3.0,580.0,580.0,5,783,4.0,515.0,515.0
0.009,6,10,1989,5,910,2.0,642.0,642.0,5,1079,2.0,811.0,811.0
0.081,6,10,1506,5,395,19.0,127.0,127.0,5,1111,19.0,843.0,843.0
0.135,6,10,1506,5,395,30.0,127.0,127.0,5,1111,30.0,843.0,843.0
0.004,17,2,136,1,60,0.0,32.0,32.0,1,76,0.0,48.0,48.0
295.358,6,385,347822,186,21248,1596.0,2736.0,889.0,199,326574,1491.0,2804.0,1709.0
0.006,6,10,1547,5,764,1.0,496.0,496.0,5,783,1.0,515.0,515.0
0.006,6,10,1547,5,764,1.0,496.0,496.0,5,783,1.0,515.0,515.0
240.485,6,35,10318,18,2211,14144.0,555.0,253.0,17,8107,15028.0,1503.0,657.0
0.007,6,10,1779,5,928,1.0,660.0,660.0,5,851,1.0,583.0,583.0
0.145,6,10,1506,5,395,34.0,127.0,127.0,5,1111,32.0,843.0,843.0
0.133,6,10,1506,5,395,30.0,127.0,127.0,5,1111,31.0,843.0,843.0
0.021,17,2,291,1,66,0.0,38.0,38.0,1,225,0.0,197.0,197.0
0.006,6,10,1547,5,764,1.0,496.0,496.0,5,783,1.0,515.0,515.0
0.003,17,2,148,1,60,0.0,32.0,32.0,1,88,0.0,60.0,60.0
0.024,6,14,3787,7,497,3.0,125.0,125.0,7,3290,3.0,1448.0,972.0
0.145,6,10,1506,5,395,36.0,127.0,127.0,5,1111,32.0,843.0,843.0
0.005,6,10,2000,5,927,1.0,659.0,659.0,5,1073,1.0,805.0,805.0
280.259,6,23,6075,11,1226,28025.0,267.0,156.0,12,4849,25477.0,1400.0,873.0
0.07,17,8,3613,4,1874,23.0,1350.0,440.0,4,1739,12.0,1350.0,406.0
0.004,6,10,1989,5,927,1.0,659.0,659.0,5,1062,1.0,794.0,794.0
0.006,6,10,1547,5,764,1.0,496.0,496.0,5,783,1.0,515.0,515.0
361.814,6,21,1792,16,1030,24120.0,190.0,190.0,5,762,60009.0,461.0,247.0
0.005,6,10,1689,5,839,1.0,571.0,571.0,5,850,1.0,582.0,582.0
0.006,6,10,1689,5,839,1.0,571.0,571.0,5,850,1.0,582.0,582.0
0.014,6,10,1990,5,911,3.0,643.0,643.0,5,1079,3.0,811.0,811.0
0.099,6,10,1506,5,395,21.0,127.0,127.0,5,1111,20.0,843.0,843.0
0.001,17,2,180,1,66,0.0,38.0,38.0,1,114,0.0,86.0,86.0
0.01,6,10,1972,5,910,2.0,642.0,642.0,5,1062,2.0,794.0,794.0
0.014,6,10,1990,5,911,3.0,643.0,643.0,5,1079,3.0,811.0,811.0
40.065,17,10,676,5,460,10015.0,104.0,64.0,5,216,10015.0,20.0,15.0
0.118,6,10,1506,5,395,25.0,127.0,127.0,5,1111,28.0,843.0,843.0
66.455,6,82,84502,39,11137,1748.0,2833.0,1300.0,43,73365,1578.0,2804.0,2031.0
0.137,6,10,1506,5,395,30.0,127.0,127.0,5,1111,31.0,843.0,843.0
0.005,6,10,2006,5,927,1.0,659.0,659.0,5,1079,1.0,811.0,811.0
0.013,17,2,152,1,56,0.0,28.0,28.0,1,96,0.0,68.0,68.0
0.113,6,10,1506,5,395,25.0,127.0,127.0,5,1111,23.0,843.0,843.0
0.003,17,2,148,1,60,0.0,32.0,32.0,1,88,0.0,60.0,60.0
0.006,6,12,1698,6,863,1.0,327.0,271.0,6,835,1.0,515.0,515.0
0.089,6,10,1506,5,395,21.0,127.0,127.0,5,1111,20.0,843.0,843.0
0.006,6,10,2007,5,928,1.0,660.0,660.0,5,1079,1.0,811.0,811.0
0.177,17,2,152,1,76,0.0,48.0,48.0,1,76,0.0,48.0,48.0
0.118,6,10,1506,5,395,27.0,127.0,127.0,5,1111,24.0,843.0,843.0
0.043,17,2,182,1,65,0.0,37.0,37.0,1,117,0.0,89.0,89.0
0.022,6,10,1989,5,910,5.0,642.0,642.0,5,1079,5.0,811.0,811.0
40.07,17,10,676,5,460,10016.0,104.0,64.0,5,216,10016.0,20.0,15.0
0.051,17,2,148,1,60,0.0,32.0,32.0,1,88,0.0,60.0,60.0
0.003,17,2,187,1,74,0.0,46.0,46.0,1,113,0.0,85.0,85.0
0.005,6,10,1989,5,927,1.0,659.0,659.0,5,1062,1.0,794.0,794.0
0.016,6,10,1989,5,910,4.0,642.0,642.0,5,1079,4.0,811.0,811.0
1729.233,6,60,4400,40,2740,44339.0,33.0,33.0,20,1660,91003.0,31.0,31.0
0.193,6,10,1506,5,395,46.0,127.0,127.0,5,1111,42.0,843.0,843.0
0.007,6,10,1989,5,927,1.0,659.0,659.0,5,1062,1.0,794.0,794.0
0.006,6,10,2000,5,927,1.0,659.0,659.0,5,1073,1.0,805.0,805.0
0.003,17,2,148,1,60,0.0,32.0,32.0,1,88,0.0,60.0,60.0
0.037,17,2,170,1,65,0.0,37.0,37.0,1,105,0.0,77.0,77.0
0.073,6,10,1506,5,395,14.0,127.0,127.0,5,1111,15.0,843.0,843.0
0.005,6,10,1779,5,928,1.0,660.0,660.0,5,851,1.0,583.0,583.0
0.018,6,10,1990,5,911,4.0,643.0,643.0,5,1079,4.0,811.0,811.0
0.006,17,2,148,1,60,0.0,32.0,32.0,1,88,0.0,60.0,60.0
0.107,6,10,1506,5,395,23.0,127.0,127.0,5,1111,23.0,843.0,843.0
0.005,6,10,1774,5,923,1.0,655.0,655.0,5,851,1.0,583.0,583.0
0.094,6,10,1506,5,395,22.0,127.0,127.0,5,1111,21.0,843.0,843.0
0.01,6,10,1972,5,910,2.0,642.0,642.0,5,1062,2.0,794.0,794.0
10.811,17,26,4097,13,1846,892.0,269.0,114.0,13,2251,892.0,586.0,145.0
0.006,17,2,160,1,72,0.0,44.0,44.0,1,88,0.0,60.0,60.0
0.005,6,10,2006,5,927,1.0,659.0,659.0,5,1079,1.0,811.0,811.0
0.017,6,10,1972,5,910,4.0,642.0,642.0,5,1062,4.0,794.0,794.0
0.015,6,10,1972,5,910,3.0,642.0,642.0,5,1062,3.0,794.0,794.0
0.006,6,10,1689,5,839,1.0,571.0,571.0,5,850,1.0,582.0,582.0
0.004,6,10,2007,5,928,1.0,660.0,660.0,5,1079,1.0,811.0,811.0
0.003,17,4,284,2,120,0.0,32.0,32.0,2,164,0.0,60.0,54.0
0.004,6,10,1989,5,927,1.0,659.0,659.0,5,1062,1.0,794.0,794.0
0.006,6,10,2006,5,927,1.0,659.0,659.0,5,1079,1.0,811.0,811.0
0.011,6,10,1990,5,911,2.0,643.0,643.0,5,1079,2.0,811.0,811.0
0.005,6,10,2007,5,928,1.0,660.0,660.0,5,1079,1.0,811.0,811.0
0.004,6,10,1989,5,927,1.0,659.0,659.0,5,1062,1.0,794.0,794.0
0.014,6,10,1990,5,911,3.0,643.0,643.0,5,1079,3.0,811.0,811.0
0.009,6,10,1972,5,910,2.0,642.0,642.0,5,1062,2.0,794.0,794.0
0.009,6,10,1983,5,910,2.0,642.0,642.0,5,1073,2.0,805.0,805.0
0.015,6,13,3735,7,497,2.0,125.0,125.0,6,3238,3.0,1470.0,1459.0
0.071,6,10,1506,5,395,15.0,127.0,127.0,5,1111,16.0,843.0,843.0
40.072,17,10,676,5,460,10015.0,104.0,64.0,5,216,10017.0,20.0,15.0
0.006,6,10,1547,5,764,1.0,496.0,496.0,5,783,1.0,515.0,515.0
0.005,6,10,2000,5,927,1.0,659.0,659.0,5,1073,1.0,805.0,805.0
0.018,6,10,1972,5,910,4.0,642.0,642.0,5,1062,4.0,794.0,794.0
300.52,6,27,8922,15,1930,21465.0,517.0,285.0,12,6992,21861.0,1402.0,908.0
0.013,6,10,1631,5,848,3.0,580.0,580.0,5,783,3.0,515.0,515.0
0.006,6,10,1689,5,839,1.0,571.0,571.0,5,850,1.0,582.0,582.0
0.003,17,2,148,1,60,0.0,32.0,32.0,1,88,0.0,60.0,60.0
0.006,6,10,1854,5,889,1.0,621.0,621.0,5,965,1.0,697.0,697.0
0.005,6,10,1689,5,839,1.0,571.0,571.0,5,850,1.0,582.0,582.0
40.063,17,10,676,5,460,10013.0,104.0,64.0,5,216,10014.0,20.0,15.0
240.099,6,16,4482,9,963,30012.0,238.0,166.0,7,3519,40016.0,1402.0,786.0
0.004,6,10,1702,5,863,1.0,595.0,595.0,5,839,0.0,571.0,571.0
0.012,6,10,1989,5,910,3.0,642.0,642.0,5,1079,2.0,811.0,811.0
0.092,6,10,1506,5,395,19.0,127.0,127.0,5,1111,17.0,843.0,843.0
0.111,6,10,1506,5,395,27.0,127.0,127.0,5,1111,25.0,843.0,843.0
0.004,17,4,284,2,120,0.0,32.0,32.0,2,164,0.0,60.0,54.0
0.057,17,2,152,1,76,0.0,48.0,48.0,1,76,0.0,48.0,48.0
240.12,6,34,9552,17,7039,15007.0,1515.0,614.0,17,2513,15007.0,580.0,202.0
0.001,17,2,136,1,60,0.0,32.0,32.0,1,76,0.0,48.0,48.0
0.004,6,10,2000,5,927,1.0,659.0,659.0,5,1073,1.0,805.0,805.0
0.163,17,2,152,1,76,0.0,48.0,48.0,1,76,0.0,48.0,48.0
0.005,6,10,1547,5,764,1.0,496.0,496.0,5,783,1.0,515.0,515.0
0.007,17,2,148,1,66,0.0,38.0,38.0,1,82,0.0,54.0,54.0
0.005,6,10,1779,5,928,1.0,660.0,660.0,5,851,1.0,583.0,583.0
0.005,6,10,2006,5,927,1.0,659.0,659.0,5,1079,1.0,811.0,811.0
0.008,6,13,3735,7,497,1.0,125.0,125.0,6,3238,1.0,1470.0,1459.0
0.005,6,10,1689,5,839,1.0,571.0,571.0,5,850,1.0,582.0,582.0
361.867,6,21,1792,16,1030,24124.0,190.0,190.0,5,762,60009.0,461.0,247.0
0.012,6,10,1983,5,910,3.0,642.0,642.0,5,1073,2.0,805.0,805.0
0.004,6,10,2006,5,927,1.0,659.0,659.0,5,1079,1.0,811.0,811.0
40.079,17,10,676,5,460,10017.0,104.0,64.0,5,216,10019.0,20.0,15.0
0.012,6,10,1762,5,911,2.0,643.0,643.0,5,851,2.0,583.0,583.0
0.008,6,12,1926,6,1189,1.0,659.0,434.0,6,737,1.0,417.0,417.0
0.12,6,10,1506,5,395,29.0,127.0,127.0,5,1111,25.0,843.0,843.0
0.168,17,2,152,1,76,0.0,48.0,48.0,1,76,0.0,48.0,48.0
0.014,6,10,1972,5,910,3.0,642.0,642.0,5,1062,3.0,794.0,794.0
0.012,6,10,1972,5,910,3.0,642.0,642.0,5,1062,3.0,794.0,794.0
0.02,6,10,1972,5,910,5.0,642.0,642.0,5,1062,4.0,794.0,794.0
0.093,6,10,1506,5,395,17.0,127.0,127.0,5,1111,21.0,843.0,843.0
0.018,6,10,1989,5,910,4.0,642.0,642.0,5,1079,4.0,811.0,811.0
0.038,17,4,284,2,120,0.0,32.0,32.0,2,164,35.0,60.0,54.0
0.018,6,10,1972,5,910,4.0,642.0,642.0,5,1062,4.0,794.0,794.0
0.005,6,10,1989,5,927,1.0,659.0,659.0,5,1062,1.0,794.0,794.0
0.005,6,10,1854,5,889,1.0,621.0,621.0,5,965,1.0,697.0,697.0
0.005,6,10,2006,5,927,1.0,659.0,659.0,5,1079,1.0,811.0,811.0
300.268,6,16,2170,9,684,37512.0,146.0,146.0,7,1486,50016.0,419.0,398.0
0.006,6,10,1643,5,860,1.0,592.0,592.0,5,783,1.0,515.0,515.0
0.005,6,10,2006,5,927,1.0,659.0,659.0,5,1079,1.0,811.0,811.0
0.169,17,2,152,1,76,0.0,48.0,48.0,1,76,0.0,48.0,48.0
0.003,17,2,186,1,61,0.0,33.0,33.0,1,125,0.0,97.0,97.0
0.006,6,10,1689,5,839,1.0,571.0,571.0,5,850,1.0,582.0,582.0
40.068,17,10,676,5,460,10016.0,104.0,64.0,5,216,10015.0,20.0,15.0
9.051,17,6,376,5,280,2262.0,28.0,28.0,1,96,0.0,68.0,68.0
0.069,6,10,1506,5,395,14.0,127.0,127.0,5,1111,14.0,843.0,843.0
242.236,6,376,346860,186,21197,1309.0,2736.0,885.0,190,325663,1281.0,2804.0,1754.0
0.014,6,10,1631,5,848,3.0,580.0,580.0,5,783,3.0,515.0,515.0
0.006,17,2,169,1,62,0.0,34.0,34.0,1,107,0.0,79.0,79.0
0.001,17,2,180,1,66,0.0,38.0,38.0,1,114,0.0,86.0,86.0
0.001,17,2,180,1,66,0.0,38.0,38.0,1,114,0.0,86.0,86.0
0.004,6,10,1989,5,927,1.0,659.0,659.0,5,1062,1.0,794.0,794.0
308.716,17,20,1124,10,716,34286.0,48.0,43.0,10,408,34287.0,20.0,12.0
0.09,6,10,1506,5,395,19.0,127.0,127.0,5,1111,18.0,843.0,843.0
0.01,6,10,1989,5,910,2.0,642.0,642.0,5,1079,2.0,811.0,811.0
0.006,6,10,1547,5,764,1.0,496.0,496.0,5,783,1.0,515.0,515.0
0.07,6,10,1506,5,395,15.0,127.0,127.0,5,1111,15.0,843.0,843.0
0.011,6,10,1990,5,911,2.0,643.0,643.0,5,1079,2.0,811.0,811.0
0.012,6,10,1989,5,910,3.0,642.0,642.0,5,1079,2.0,811.0,811.0
0.005,17,2,212,1,74,0.0,46.0,46.0,1,138,0.0,110.0,110.0
0.016,6,10,1972,5,910,4.0,642.0,642.0,5,1062,4.0,794.0,794.0
0.006,6,10,1689,5,839,1.0,571.0,571.0,5,850,1.0,582.0,582.0
0.006,6,10,1689,5,839,1.0,571.0,571.0,5,850,1.0,582.0,582.0
0.12,6,10,1506,5,395,26.0,127.0,127.0,5,1111,27.0,843.0,843.0
0.009,6,10,1983,5,910,2.0,642.0,642.0,5,1073,2.0,805.0,805.0
300.321,6,16,2170,9,684,37519.0,146.0,146.0,7,1486,50025.0,419.0,398.0
0.071,17,2,182,1,65,0.0,37.0,37.0,1,117,0.0,89.0,89.0
0.098,6,10,1506,5,395,22.0,127.0,127.0,5,1111,20.0,843.0,843.0
174.061,17,72,10175,36,2394,4973.0,44.0,38.0,36,7781,4973.0,261.0,188.0
0.009,6,10,1983,5,910,2.0,642.0,642.0,5,1073,2.0,805.0,805.0
0.005,17,2,179,1,71,0.0,43.0,43.0,1,108,0.0,80.0,80.0
0.098,6,10,1506,5,395,23.0,127.0,127.0,5,1111,22.0,843.0,843.0
0.004,17,4,284,2,120,0.0,32.0,32.0,2,164,0.0,60.0,54.0
0.08,6,10,1506,5,395,17.0,127.0,127.0,5,1111,19.0,843.0,843.0
0.004,17,2,148,1,60,0.0,32.0,32.0,1,88,0.0,60.0,60.0
0.022,6,10,1677,5,827,5.0,559.0,559.0,5,850,5.0,582.0,582.0
40.057,17,10,676,5,460,10013.0,104.0,64.0,5,216,10013.0,20.0,15.0
0.137,6,10,1506,5,395,31.0,127.0,127.0,5,1111,32.0,843.0,843.0
0.005,6,10,1989,5,927,1.0,659.0,659.0,5,1062,1.0,794.0,794.0
0.078,6,10,1506,5,395,17.0,127.0,127.0,5,1111,17.0,843.0,843.0
0.098,6,10,1506,5,395,21.0,127.0,127.0,5,1111,20.0,843.0,843.0
15.083,17,16,8912,8,6642,2150.0,1350.0,802.0,8,2270,2150.0,1350.0,255.0
0.01,6,10,1989,5,910,2.0,642.0,642.0,5,1079,2.0,811.0,811.0
0.133,6,10,1506,5,395,29.0,127.0,127.0,5,1111,31.0,843.0,843.0
0.004,6,10,2006,5,927,1.0,659.0,659.0,5,1079,1.0,811.0,811.0
0.087,6,10,1506,5,395,19.0,127.0,127.0,5,1111,16.0,843.0,843.0
0.008,6,10,1689,5,839,1.0,571.0,571.0,5,850,1.0,582.0,582.0
0.006,6,10,1689,5,839,1.0,571.0,571.0,5,850,1.0,582.0,582.0
0.074,6,10,1506,5,395,15.0,127.0,127.0,5,1111,16.0,843.0,843.0
0.001,17,2,180,1,66,0.0,38.0,38.0,1,114,0.0,86.0,86.0
0.063,6,10,1506,5,395,15.0,127.0,127.0,5,1111,14.0,843.0,843.0
19.197,17,22,14752,13,12031,1597.0,1350.0,897.0,9,2721,2396.0,1350.0,274.0
0.004,17,2,148,1,60,0.0,32.0,32.0,1,88,0.0,60.0,60.0
0.013,6,10,1990,5,911,3.0,643.0,643.0,5,1079,3.0,811.0,811.0
0.006,6,10,1547,5,764,1.0,496.0,496.0,5,783,1.0,515.0,515.0
174.056,17,82,11695,41,2740,4351.0,44.0,38.0,41,8955,4351.0,239.0,190.0
0.015,6,10,1990,5,911,3.0,643.0,643.0,5,1079,3.0,811.0,811.0
40.078,17,10,676,5,460,10016.0,104.0,64.0,5,216,10017.0,20.0,15.0
0.019,6,10,1762,5,911,4.0,643.0,643.0,5,851,4.0,583.0,583.0
0.005,17,2,230,1,68,0.0,40.0,40.0,1,162,0.0,134.0,134.0
164.093,17,86,12391,43,2877,3906.0,44.0,38.0,43,9514,3906.0,279.0,193.0
300.336,6,16,2170,9,684,37521.0,146.0,146.0,7,1486,50028.0,419.0,398.0
0.004,6,10,1702,5,863,1.0,595.0,595.0,5,839,0.0,571.0,571.0
10.915,17,28,4420,14,1993,831.0,268.0,114.0,14,2427,831.0,586.0,145.0
0.008,6,10,1990,5,911,2.0,643.0,643.0,5,1079,2.0,811.0,811.0
240.83,6,27,7818,12,3525,21893.0,1211.0,726.0,15,4293,17201.0,1162.0,389.0
0.148,6,10,1506,5,395,36.0,127.0,127.0,5,1111,32.0,843.0,843.0
0.094,6,10,1506,5,395,21.0,127.0,127.0,5,1111,19.0,843.0,843.0
0.083,6,10,1506,5,395,19.0,127.0,127.0,5,1111,16.0,843.0,843.0
0.013,6,10,1983,5,910,3.0,642.0,642.0,5,1073,3.0,805.0,805.0
0.128,6,10,1506,5,395,28.0,127.0,127.0,5,1111,29.0,843.0,843.0
0.003,17,2,148,1,60,0.0,32.0,32.0,1,88,0.0,60.0,60.0
0.122,6,10,1506,5,395,29.0,127.0,127.0,5,1111,28.0,843.0,843.0
0.22,6,16,2783,8,1401,31.0,533.0,325.0,8,1382,20.0,529.0,239.0
0.014,6,10,1990,5,911,3.0,643.0,643.0,5,1079,3.0,811.0,811.0
0.004,6,10,1989,5,927,1.0,659.0,659.0,5,1062,1.0,794.0,794.0
1787.152,6,154,19574,92,13852,19639.0,302.0,302.0,62,5722,29297.0,83.0,83.0
0.005,6,10,1854,5,889,1.0,621.0,621.0,5,965,1.0,697.0,697.0
0.102,6,10,1506,5,395,23.0,127.0,127.0,5,1111,23.0,843.0,843.0
0.003,17,2,148,1,60,0.0,32.0,32.0,1,88,0.0,60.0,60.0
0.018,6,10,1989,5,910,4.0,642.0,642.0,5,1079,4.0,811.0,811.0
0.095,6,10,1506,5,395,22.0,127.0,127.0,5,1111,21.0,843.0,843.0
241.619,6,129,125580,58,17854,4238.0,2736.0,1481.0,71,107726,3451.0,4206.0,1857.0
0.005,6,10,1774,5,923,1.0,655.0,655.0,5,851,1.0,583.0,583.0
0.016,17,2,198,1,91,0.0,63.0,63.0,1,107,0.0,79.0,79.0
0.127,6,10,1506,5,395,31.0,127.0,127.0,5,1111,29.0,843.0,843.0
40.074,17,10,676,5,460,10017.0,104.0,64.0,5,216,10017.0,20.0,15.0
0.006,17,2,146,1,65,0.0,37.0,37.0,1,81,0.0,53.0,53.0
0.076,6,10,1506,5,395,16.0,127.0,127.0,5,1111,17.0,843.0,843.0
0.009,6,10,1989,5,910,2.0,642.0,642.0,5,1079,2.0,811.0,811.0
0.005,6,10,2006,5,927,1.0,659.0,659.0,5,1079,1.0,811.0,811.0
0.01,6,10,1989,5,910,2.0,642.0,642.0,5,1079,2.0,811.0,811.0
0.005,17,2,170,1,65,0.0,37.0,37.0,1,105,0.0,77.0,77.0
0.037,17,2,412,1,61,0.0,33.0,33.0,1,351,0.0,323.0,323.0
0.004,17,2,154,1,69,0.0,41.0,41.0,1,85,0.0,57.0,57.0
0.017,6,20,9974,11,704,1.0,124.0,124.0,9,9270,2.0,2896.0,1758.0
240.09,6,16,4481,9,963,30011.0,238.0,166.0,7,3518,40014.0,1402.0,786.0
0.012,6,10,1983,5,910,3.0,642.0,642.0,5,1073,2.0,805.0,805.0
0.004,6,10,1989,5,927,1.0,659.0,659.0,5,1062,1.0,794.0,794.0
0.005,17,2,170,1,65,0.0,37.0,37.0,1,105,0.0,77.0,77.0
0.005,6,10,1989,5,927,1.0,659.0,659.0,5,1062,1.0,794.0,794.0
0.006,6,10,1547,5,764,1.0,496.0,496.0,5,783,1.0,515.0,515.0
0.084,6,10,1506,5,395,20.0,127.0,127.0,5,1111,16.0,843.0,843.0
0.115,6,10,1506,5,395,27.0,127.0,127.0,5,1111,23.0,843.0,843.0
0.006,6,10,1689,5,839,1.0,571.0,571.0,5,850,1.0,582.0,582.0
1770.465,6,83,4368,42,2210,43181.0,26.0,26.0,41,2158,44260.0,26.0,26.0
0.01,6,10,1972,5,910,2.0,642.0,642.0,5,1062,2.0,794.0,794.0
0.009,6,10,1972,5,910,2.0,642.0,642.0,5,1062,2.0,794.0,794.0
0.014,6,10,1983,5,910,3.0,642.0,642.0,5,1073,3.0,805.0,805.0
0.011,6,10,1983,5,910,2.0,642.0,642.0,5,1073,2.0,805.0,805.0
0.012,6,10,1989,5,910,3.0,642.0,642.0,5,1079,2.0,811.0,811.0
0.119,6,10,1506,5,395,27.0,127.0,127.0,5,1111,26.0,843.0,843.0
0.005,17,2,164,1,74,0.0,46.0,46.0,1,90,0.0,62.0,62.0
300.082,6,19,4659,11,1102,30008.0,238.0,130.0,8,3557,42868.0,1402.0,786.0
0.139,6,10,1506,5,395,27.0,127.0,127.0,5,1111,34.0,843.0,843.0
0.012,6,10,1762,5,911,3.0,643.0,643.0,5,851,2.0,583.0,583.0
0.046,17,2,136,1,60,0.0,32.0,32.0,1,76,0.0,48.0,48.0
300.323,6,16,2170,9,684,37519.0,146.0,146.0,7,1486,50026.0,419.0,398.0
0.006,6,10,2007,5,928,1.0,660.0,660.0,5,1079,1.0,811.0,811.0
0.174,17,2,152,1,76,0.0,48.0,48.0,1,76,0.0,48.0,48.0
11.036,17,28,4419,14,1995,840.0,270.0,114.0,14,2424,840.0,587.0,145.0
0.009,6,10,1972,5,910,2.0,642.0,642.0,5,1062,2.0,794.0,794.0
0.02,6,10,1990,5,911,5.0,643.0,643.0,5,1079,4.0,811.0,811.0
1.136,6,27,8603,16,2211,75.0,517.0,273.0,11,6392,112.0,1402.0,726.0
0.042,17,4,352,2,130,2.0,37.0,37.0,2,222,3.0,89.0,83.0
0.111,6,10,1506,5,395,24.0,127.0,127.0,5,1111,24.0,843.0,843.0
0.115,6,10,1506,5,395,25.0,127.0,127.0,5,1111,27.0,843.0,843.0
0.012,6,10,1677,5,827,2.0,559.0,559.0,5,850,3.0,582.0,582.0
0.101,6,10,1506,5,395,21.0,127.0,127.0,5,1111,23.0,843.0,843.0
0.005,6,10,1779,5,928,1.0,660.0,660.0,5,851,1.0,583.0,583.0
0.005,6,10,2000,5,927,1.0,659.0,659.0,5,1073,1.0,805.0,805.0
0.006,17,2,136,1,60,0.0,32.0,32.0,1,76,0.0,48.0,48.0
0.115,6,10,1506,5,395,26.0,127.0,127.0,5,1111,27.0,843.0,843.0
0.009,6,10,2006,5,927,2.0,659.0,659.0,5,1079,2.0,811.0,811.0
0.01,6,13,3735,7,497,1.0,125.0,125.0,6,3238,2.0,1470.0,1459.0
0.006,6,10,1547,5,764,1.0,496.0,496.0,5,783,1.0,515.0,515.0
0.016,6,10,1983,5,910,3.0,642.0,642.0,5,1073,3.0,805.0,805.0
0.008,6,10,1972,5,910,2.0,642.0,642.0,5,1062,1.0,794.0,794.0
0.004,17,4,284,2,120,0.0,32.0,32.0,2,164,1.0,60.0,54.0
0.084,6,10,1506,5,395,18.0,127.0,127.0,5,1111,17.0,843.0,843.0
0.015,6,13,3735,7,497,2.0,125.0,125.0,6,3238,3.0,1470.0,1459.0
0.008,6,10,1972,5,910,2.0,642.0,642.0,5,1062,2.0,794.0,794.0
0.053,17,2,152,1,76,0.0,48.0,48.0,1,76,0.0,48.0,48.0
0.005,6,10,1989,5,927,1.0,659.0,659.0,5,1062,1.0,794.0,794.0
0.005,6,10,1774,5,923,1.0,655.0,655.0,5,851,1.0,583.0,583.0
0.01,6,10,1983,5,910,2.0,642.0,642.0,5,1073,2.0,805.0,805.0
0.01,6,10,1983,5,910,2.0,642.0,642.0,5,1073,2.0,805.0,805.0
0.105,6,10,1506,5,395,20.0,127.0,127.0,5,1111,23.0,843.0,843.0
368.472,6,22,2313,16,867,24564.0,195.0,195.0,6,1446,4642.0,419.0,398.0
300.022,6,12,1782,7,1348,50003.0,494.0,494.0,5,434,75004.0,83.0,83.0
0.11,6,10,1506,5,395,24.0,127.0,127.0,5,1111,24.0,843.0,843.0
0.003,17,2,136,1,60,0.0,32.0,32.0,1,76,0.0,48.0,48.0
0.005,6,10,1989,5,927,1.0,659.0,659.0,5,1062,1.0,794.0,794.0
0.005,6,10,2006,5,927,1.0,659.0,659.0,5,1079,1.0,811.0,811.0
0.005,6,10,1989,5,927,1.0,659.0,659.0,5,1062,1.0,794.0,794.0
0.08,6,10,1506,5,395,19.0,127.0,127.0,5,1111,17.0,843.0,843.0
0.004,6,10,2007,5,928,1.0,660.0,660.0,5,1079,1.0,811.0,811.0
0.005,6,10,2006,5,927,1.0,659.0,659.0,5,1079,1.0,811.0,811.0
0.164,6,10,1506,5,395,36.0,127.0,127.0,5,1111,33.0,843.0,843.0
0.003,17,2,148,1,60,0.0,32.0,32.0,1,88,0.0,60.0,60.0
0.013,6,10,1990,5,911,3.0,643.0,643.0,5,1079,3.0,811.0,811.0
0.001,17,2,180,1,66,0.0,38.0,38.0,1,114,0.0,86.0,86.0
0.005,6,10,2000,5,927,1.0,659.0,659.0,5,1073,1.0,805.0,805.0
0.001,17,2,180,1,66,0.0,38.0,38.0,1,114,0.0,86.0,86.0
0.008,6,10,1989,5,910,2.0,642.0,642.0,5,1079,2.0,811.0,811.0
0.004,17,2,148,1,60,0.0,32.0,32.0,1,88,0.0,60.0,60.0
0.001,17,2,174,1,72,0.0,44.0,44.0,1,102,0.0,74.0,74.0
0.013,6,10,1983,5,910,3.0,642.0,642.0,5,1073,3.0,805.0,805.0
0.018,6,14,3787,7,497,2.0,125.0,125.0,7,3290,3.0,1448.0,972.0
0.129,17,2,170,1,65,0.0,37.0,37.0,1,105,0.0,77.0,77.0
0.038,17,2,136,1,60,0.0,32.0,32.0,1,76,0.0,48.0,48.0
0.016,6,10,1989,5,910,4.0,642.0,642.0,5,1079,4.0,811.0,811.0
0.014,6,10,1990,5,911,3.0,643.0,643.0,5,1079,3.0,811.0,811.0
0.007,6,10,2000,5,927,1.0,659.0,659.0,5,1073,1.0,805.0,805.0
0.007,6,10,1989,5,927,1.0,659.0,659.0,5,1062,1.0,794.0,794.0
40.058,17,10,676,5,460,10013.0,104.0,64.0,5,216,10013.0,20.0,15.0
0.228,6,16,2778,8,1396,32.0,533.0,324.0,8,1382,21.0,529.0,239.0
0.01,6,10,1762,5,911,2.0,643.0,643.0,5,851,2.0,583.0,583.0
240.31,6,42,8719,21,5686,12015.0,1515.0,509.0,21,3033,12015.0,580.0,241.0
314.802,17,19,1048,9,640,39334.0,48.0,43.0,10,408,34963.0,20.0,12.0
308.589,17,20,1124,10,716,34272.0,48.0,43.0,10,408,34272.0,20.0,12.0
0.006,6,10,1547,5,764,1.0,496.0,496.0,5,783,1.0,515.0,515.0
0.004,17,2,144,1,64,0.0,36.0,36.0,1,80,0.0,52.0,52.0
0.11,6,10,1506,5,395,24.0,127.0,127.0,5,1111,26.0,843.0,843.0
0.006,6,10,1547,5,764,1.0,496.0,496.0,5,783,1.0,515.0,515.0
0.006,6,10,1689,5,839,1.0,571.0,571.0,5,850,1.0,582.0,582.0
0.01,6,10,1989,5,910,2.0,642.0,642.0,5,1079,2.0,811.0,811.0
0.788,6,25,5459,12,1557,61.0,325.0,152.0,13,3902,56.0,1414.0,563.0
0.005,6,10,1643,5,860,1.0,592.0,592.0,5,783,1.0,515.0,515.0
0.005,6,10,2000,5,927,1.0,659.0,659.0,5,1073,1.0,805.0,805.0
335.569,17,20,1124,10,716,37271.0,48.0,43.0,10,408,37271.0,20.0,12.0
0.005,17,2,214,1,75,0.0,47.0,47.0,1,139,0.0,111.0,111.0
40.064,17,10,676,5,460,10015.0,104.0,64.0,5,216,10015.0,20.0,15.0
0.011,6,10,1990,5,911,2.0,643.0,643.0,5,1079,2.0,811.0,811.0
0.005,6,10,2007,5,928,1.0,660.0,660.0,5,1079,1.0,811.0,811.0
300.026,6,12,1782,7,1348,50004.0,494.0,494.0,5,434,75006.0,83.0,83.0
0.052,17,2,152,1,76,0.0,48.0,48.0,1,76,0.0,48.0,48.0
0.008,6,10,1989,5,910,2.0,642.0,642.0,5,1079,1.0,811.0,811.0
0.005,6,14,3742,7,452,0.0,80.0,80.0,7,3290,0.0,1448.0,972.0
0.135,6,10,1506,5,395,24.0,127.0,127.0,5,1111,28.0,843.0,843.0
0.092,6,10,1506,5,395,20.0,127.0,127.0,5,1111,19.0,843.0,843.0
1770.455,17,92,8096,46,4048,39343.0,60.0,60.0,46,4048,39343.0,60.0,60.0
0.005,17,2,169,1,62,0.0,34.0,34.0,1,107,0.0,79.0,79.0
0.003,17,2,136,1,60,0.0,32.0,32.0,1,76,0.0,48.0,48.0
0.019,6,10,1972,5,910,4.0,642.0,642.0,5,1062,4.0,794.0,794.0
0.108,6,10,1506,5,395,22.0,127.0,127.0,5,1111,25.0,843.0,843.0
0.082,6,10,1506,5,395,18.0,127.0,127.0,5,1111,17.0,843.0,843.0
0.003,17,2,136,1,60,0.0,32.0,32.0,1,76,0.0,48.0,48.0
0.004,6,10,1779,5,928,1.0,660.0,660.0,5,851,1.0,583.0,583.0
0.005,17,2,144,1,64,0.0,36.0,36.0,1,80,0.0,52.0,52.0
0.012,6,10,1990,5,911,2.0,643.0,643.0,5,1079,3.0,811.0,811.0
0.18,6,10,1506,5,395,43.0,127.0,127.0,5,1111,40.0,843.0,843.0
0.044,17,2,152,1,76,0.0,48.0,48.0,1,76,0.0,48.0,48.0
0.006,6,10,1854,5,889,1.0,621.0,621.0,5,965,1.0,697.0,697.0
0.014,6,10,1762,5,911,3.0,643.0,643.0,5,851,3.0,583.0,583.0
0.105,6,10,1506,5,395,22.0,127.0,127.0,5,1111,23.0,843.0,843.0
0.005,6,10,2000,5,927,1.0,659.0,659.0,5,1073,1.0,805.0,805.0
0.003,17,2,148,1,60,0.0,32.0,32.0,1,88,0.0,60.0,60.0
0.113,6,10,1506,5,395,24.0,127.0,127.0,5,1111,26.0,843.0,843.0
0.068,6,10,1506,5,395,14.0,127.0,127.0,5,1111,15.0,843.0,843.0
0.015,6,10,1972,5,910,3.0,642.0,642.0,5,1062,3.0,794.0,794.0
0.084,6,10,1506,5,395,20.0,127.0,127.0,5,1111,17.0,843.0,843.0
0.005,6,10,2007,5,928,1.0,660.0,660.0,5,1079,1.0,811.0,811.0
0.09,6,10,1506,5,395,21.0,127.0,127.0,5,1111,20.0,843.0,843.0
0.006,6,10,1689,5,839,1.0,571.0,571.0,5,850,1.0,582.0,582.0
169.111,17,74,10601,37,2467,4697.0,44.0,38.0,37,8134,4697.0,239.0,191.0
0.019,6,10,1989,5,910,4.0,642.0,642.0,5,1079,4.0,811.0,811.0
0.005,6,10,1989,5,927,1.0,659.0,659.0,5,1062,1.0,794.0,794.0
412.943,6,29,4409,12,3102,10912.0,494.0,494.0,17,1307,25808.0,83.0,83.0
0.004,6,10,2000,5,927,1.0,659.0,659.0,5,1073,1.0,805.0,805.0
0.005,6,10,2006,5,927,1.0,659.0,659.0,5,1079,1.0,811.0,811.0
0.004,17,2,234,1,61,0.0,33.0,33.0,1,173,0.0,145.0,145.0
0.003,17,2,170,1,65,0.0,37.0,37.0,1,105,0.0,77.0,77.0
40.065,17,10,676,5,460,10015.0,104.0,64.0,5,216,10013.0,20.0,15.0
0.005,6,10,1854,5,889,1.0,621.0,621.0,5,965,1.0,697.0,697.0
0.061,6,10,1506,5,395,13.0,127.0,127.0,5,1111,13.0,843.0,843.0
0.001,17,2,180,1,66,0.0,38.0,38.0,1,114,0.0,86.0,86.0
0.006,6,12,1698,6,863,1.0,327.0,271.0,6,835,1.0,515.0,515.0
0.007,17,2,132,1,58,0.0,30.0,30.0,1,74,0.0,46.0,46.0
0.011,6,10,1972,5,910,2.0,642.0,642.0,5,1062,2.0,794.0,794.0
0.011,6,10,1990,5,911,2.0,643.0,643.0,5,1079,2.0,811.0,811.0
0.004,17,2,148,1,60,0.0,32.0,32.0,1,88,0.0,60.0,60.0
0.005,6,10,2007,5,928,1.0,660.0,660.0,5,1079,1.0,811.0,811.0
0.009,6,10,1990,5,911,2.0,643.0,643.0,5,1079,2.0,811.0,811.0
0.005,17,2,152,1,68,0.0,40.0,40.0,1,84,0.0,56.0,56.0
0.013,6,10,1990,5,911,3.0,643.0,643.0,5,1079,3.0,811.0,811.0
0.001,17,2,136,1,60,0.0,32.0,32.0,1,76,0.0,48.0,48.0
0.001,17,2,166,1,75,0.0,47.0,47.0,1,91,0.0,63.0,63.0
0.009,6,10,1989,5,910,2.0,642.0,642.0,5,1079,2.0,811.0,811.0
0.01,6,10,1989,5,910,2.0,642.0,642.0,5,1079,2.0,811.0,811.0
0.132,6,10,1506,5,395,29.0,127.0,127.0,5,1111,28.0,843.0,843.0
0.006,6,10,1547,5,764,1.0,496.0,496.0,5,783,1.0,515.0,515.0
40.055,17,10,676,5,460,10013.0,104.0,64.0,5,216,10012.0,20.0,15.0
0.005,6,10,1989,5,927,1.0,659.0,659.0,5,1062,1.0,794.0,794.0
0.005,6,10,1643,5,860,1.0,592.0,592.0,5,783,1.0,515.0,515.0
0.01,6,10,1972,5,910,2.0,642.0,642.0,5,1062,2.0,794.0,794.0
0.004,6,10,2006,5,927,1.0,659.0,659.0,5,1079,1.0,811.0,811.0
0.003,17,2,148,1,60,0.0,32.0,32.0,1,88,0.0,60.0,60.0
377.413,6,22,2313,16,867,25160.0,195.0,195.0,6,1446,4641.0,419.0,398.0
0.003,17,2,136,1,60,0.0,32.0,32.0,1,76,0.0,48.0,48.0
0.005,6,10,2007,5,928,1.0,660.0,660.0,5,1079,1.0,811.0,811.0
0.062,17,2,80,1,32,0.0,4.0,4.0,1,48,0.0,20.0,20.0
0.014,6,10,1990,5,911,3.0,643.0,643.0,5,1079,3.0,811.0,811.0
0.072,6,10,1506,5,395,16.0,127.0,127.0,5,1111,15.0,843.0,843.0
0.017,6,10,1972,5,910,4.0,642.0,642.0,5,1062,4.0,794.0,794.0
0.082,6,10,1506,5,395,20.0,127.0,127.0,5,1111,17.0,843.0,843.0
0.04,17,2,152,1,76,0.0,48.0,48.0,1,76,0.0,48.0,48.0
0.107,6,10,1506,5,395,24.0,127.0,127.0,5,1111,24.0,843.0,843.0
0.014,6,10,1990,5,911,3.0,643.0,643.0,5,1079,3.0,811.0,811.0
0.006,6,12,1698,6,863,1.0,327.0,271.0,6,835,1.0,515.0,515.0
0.071,6,10,1506,5,395,16.0,127.0,127.0,5,1111,14.0,843.0,843.0
842.329,17,8,632,4,252,280774.0,35.0,35.0,4,380,280774.0,67.0,67.0
0.011,6,10,1990,5,911,2.0,643.0,643.0,5,1079,2.0,811.0,811.0
0.005,6,10,2006,5,927,1.0,659.0,659.0,5,1079,1.0,811.0,811.0
0.114,6,10,1506,5,395,27.0,127.0,127.0,5,1111,26.0,843.0,843.0
0.011,6,10,1990,5,911,2.0,643.0,643.0,5,1079,2.0,811.0,811.0
0.005,17,2,148,1,60,0.0,32.0,32.0,1,88,0.0,60.0,60.0
0.105,6,10,1506,5,395,24.0,127.0,127.0,5,1111,20.0,843.0,843.0
40.07,17,10,676,5,460,10014.0,104.0,64.0,5,216,10016.0,20.0,15.0
0.013,6,10,1990,5,911,3.0,643.0,643.0,5,1079,3.0,811.0,811.0
0.003,17,2,152,1,76,0.0,48.0,48.0,1,76,0.0,48.0,48.0
0.123,6,10,1506,5,395,29.0,127.0,127.0,5,1111,27.0,843.0,843.0
0.013,6,10,1989,5,910,3.0,642.0,642.0,5,1079,3.0,811.0,811.0
351.988,6,20,2210,6,1308,12003.0,494.0,494.0,14,902,27075.0,83.0,83.0
0.005,6,10,1779,5,928,1.0,660.0,660.0,5,851,1.0,583.0,583.0
40.066,17,10,676,5,460,10015.0,104.0,64.0,5,216,10015.0,20.0,15.0
170.164,17,82,11672,41,2732,4253.0,44.0,38.0,41,8940,4254.0,261.0,190.0
0.004,6,10,1989,5,927,1.0,659.0,659.0,5,1062,1.0,794.0,794.0
0.004,17,2,148,1,60,0.0,32.0,32.0,1,88,0.0,60.0,60.0
0.099,6,10,1506,5,395,22.0,127.0,127.0,5,1111,22.0,843.0,843.0
0.095,6,10,1506,5,395,23.0,127.0,127.0,5,1111,20.0,843.0,843.0
15.299,17,3,228,2,152,15053.0,48.0,48.0,1,76,0.0,48.0,48.0
0.194,6,43,11560,24,3283,8.0,1083.0,203.0,19,8277,10.0,1402.0,606.0
0.006,6,10,1547,5,764,1.0,496.0,496.0,5,783,1.0,515.0,515.0
1800.0,6,137,6590,76,3625,23996.0,39.0,39.0,61,2965,29996.0,35.0,35.0
0.008,6,12,1926,6,1189,1.0,659.0,434.0,6,737,1.0,417.0,417.0
0.015,6,10,1972,5,910,3.0,642.0,642.0,5,1062,3.0,794.0,794.0
0.04,17,2,144,1,64,0.0,36.0,36.0,1,80,0.0,52.0,52.0
0.003,17,2,136,1,60,0.0,32.0,32.0,1,76,0.0,48.0,48.0
0.015,6,10,1972,5,910,3.0,642.0,642.0,5,1062,3.0,794.0,794.0
0.013,6,10,1972,5,910,3.0,642.0,642.0,5,1062,3.0,794.0,794.0
0.98,17,23,16443,10,4278,108.0,1350.0,399.0,13,12165,76.0,1350.0,907.0
40.064,17,10,676,5,460,10015.0,104.0,64.0,5,216,10015.0,20.0,15.0
0.004,17,2,148,1,60,0.0,32.0,32.0,1,88,0.0,60.0,60.0
43.427,6,36,8271,19,1840,2412.0,732.0,349.0,17,6431,546.0,2720.0,478.0
0.08,6,10,1506,5,395,19.0,127.0,127.0,5,1111,19.0,843.0,843.0
40.065,17,10,676,5,460,10015.0,104.0,64.0,5,216,10015.0,20.0,15.0
0.009,17,2,136,1,60,0.0,32.0,32.0,1,76,0.0,48.0,48.0
0.077,6,10,1506,5,395,17.0,127.0,127.0,5,1111,17.0,843.0,843.0
0.003,17,2,148,1,60,0.0,32.0,32.0,1,88,0.0,60.0,60.0
0.005,6,13,3690,7,452,0.0,80.0,80.0,6,3238,0.0,1470.0,1459.0
0.037,6,10,1990,5,911,9.0,643.0,643.0,5,1079,9.0,811.0,811.0
0.077,6,10,1506,5,395,17.0,127.0,127.0,5,1111,14.0,843.0,843.0
0.04,17,2,184,1,61,0.0,33.0,33.0,1,123,0.0,95.0,95.0
0.005,6,10,1689,5,839,1.0,571.0,571.0,5,850,1.0,582.0,582.0
0.009,6,10,1989,5,910,2.0,642.0,642.0,5,1079,2.0,811.0,811.0
38.12,58,3,216,2,144,38120.0,24.0,24.0,1,72,0.0,24.0,24.0
0.001,17,2,136,1,60,0.0,32.0,32.0,1,76,0.0,48.0,48.0
15.076,17,14,9190,8,6902,2149.0,1350.0,834.0,6,2288,3009.0,1350.0,353.0
1778.563,17,144,45504,72,22752,25050.0,288.0,288.0,72,22752,25050.0,288.0,288.0
0.016,6,10,1989,5,910,4.0,642.0,642.0,5,1079,4.0,811.0,811.0
0.126,6,10,1506,5,395,28.0,127.0,127.0,5,1111,17.0,843.0,843.0
0.005,6,10,2000,5,927,1.0,659.0,659.0,5,1073,1.0,805.0,805.0
40.066,17,10,676,5,460,10013.0,104.0,64.0,5,216,10015.0,20.0,15.0
0.005,6,13,3747,7,509,0.0,137.0,137.0,6,3238,1.0,1470.0,1459.0
0.006,6,10,1689,5,839,1.0,571.0,571.0,5,850,1.0,582.0,582.0
0.069,17,8,3613,4,1874,23.0,1350.0,440.0,4,1739,11.0,1350.0,406.0
0.001,17,2,136,1,60,0.0,32.0,32.0,1,76,0.0,48.0,48.0
0.025,6,10,1972,5,910,6.0,642.0,642.0,5,1062,6.0,794.0,794.0
0.004,6,10,1989,5,927,1.0,659.0,659.0,5,1062,1.0,794.0,794.0
0.004,6,10,1989,5,927,1.0,659.0,659.0,5,1062,1.0,794.0,794.0
0.073,6,10,1506,5,395,15.0,127.0,127.0,5,1111,15.0,843.0,843.0
0.004,6,10,2006,5,927,1.0,659.0,659.0,5,1079,1.0,811.0,811.0
0.008,6,12,1926,6,1189,1.0,659.0,434.0,6,737,1.0,417.0,417.0
0.02,6,10,1762,5,911,5.0,643.0,643.0,5,851,4.0,583.0,583.0
0.005,17,2,168,1,76,0.0,48.0,48.0,1,92,0.0,64.0,64.0
0.005,6,13,3747,7,509,0.0,137.0,137.0,6,3238,0.0,1470.0,1459.0
0.004,6,10,1702,5,863,1.0,595.0,595.0,5,839,1.0,571.0,571.0
0.116,6,10,1506,5,395,25.0,127.0,127.0,5,1111,23.0,843.0,843.0
0.112,6,10,1506,5,395,25.0,127.0,127.0,5,1111,25.0,843.0,843.0
0.009,6,10,1631,5,848,2.0,580.0,580.0,5,783,2.0,515.0,515.0
0.001,17,2,184,1,68,0.0,40.0,40.0,1,116,0.0,88.0,88.0
40.061,17,10,676,5,460,10013.0,104.0,64.0,5,216,10014.0,20.0,15.0
0.004,17,4,284,2,120,0.0,32.0,32.0,2,164,1.0,60.0,54.0
0.007,6,10,1989,5,927,1.0,659.0,659.0,5,1062,1.0,794.0,794.0
0.093,6,10,1506,5,395,19.0,127.0,127.0,5,1111,20.0,843.0,843.0
0.007,6,10,1547,5,764,1.0,496.0,496.0,5,783,1.0,515.0,515.0
0.005,6,13,3747,7,509,0.0,137.0,137.0,6,3238,1.0,1470.0,1459.0
0.016,17,2,198,1,91,0.0,63.0,63.0,1,107,0.0,79.0,79.0
313.793,17,20,1124,10,716,34852.0,48.0,43.0,10,408,34852.0,20.0,12.0
0.006,6,10,1854,5,889,1.0,621.0,621.0,5,965,1.0,697.0,697.0
0.011,6,10,1983,5,910,2.0,642.0,642.0,5,1073,2.0,805.0,805.0
41.623,6,24,7517,13,1385,3468.0,530.0,277.0,11,6132,4145.0,2720.0,946.0
310.579,17,20,1124,10,716,34496.0,48.0,43.0,10,408,34496.0,20.0,12.0
0.013,6,10,1983,5,910,3.0,642.0,642.0,5,1073,3.0,805.0,805.0
308.836,17,20,1124,10,716,34301.0,48.0,43.0,10,408,34301.0,20.0,12.0
0.018,6,10,1972,5,910,4.0,642.0,642.0,5,1062,4.0,794.0,794.0
0.018,6,10,1677,5,827,4.0,559.0,559.0,5,850,4.0,582.0,582.0
0.005,6,14,3742,8,504,0.0,80.0,80.0,6,3238,1.0,1470.0,1459.0
0.129,6,10,1506,5,395,32.0,127.0,127.0,5,1111,27.0,843.0,843.0
0.037,17,2,146,1,65,0.0,37.0,37.0,1,81,0.0,53.0,53.0
0.093,6,10,1506,5,395,18.0,127.0,127.0,5,1111,18.0,843.0,843.0
0.011,6,10,1989,5,910,2.0,642.0,642.0,5,1079,2.0,811.0,811.0
0.004,17,2,148,1,60,0.0,32.0,32.0,1,88,0.0,60.0,60.0
0.101,6,10,1506,5,395,23.0,127.0,127.0,5,1111,22.0,843.0,843.0
0.015,6,10,1983,5,910,3.0,642.0,642.0,5,1073,3.0,805.0,805.0
0.005,6,10,2007,5,928,1.0,660.0,660.0,5,1079,1.0,811.0,811.0
176.353,17,84,11970,42,2798,4301.0,44.0,38.0,42,9172,4301.0,261.0,190.0
0.001,17,2,180,1,66,0.0,38.0,38.0,1,114,0.0,86.0,86.0
40.053,17,10,676,5,460,10012.0,104.0,64.0,5,216,10012.0,20.0,15.0
0.005,17,2,169,1,62,0.0,34.0,34.0,1,107,0.0,79.0,79.0
0.007,17,2,132,1,58,0.0,30.0,30.0,1,74,0.0,46.0,46.0
0.01,6,10,1631,5,848,2.0,580.0,580.0,5,783,2.0,515.0,515.0
0.005,6,10,1689,5,839,1.0,571.0,571.0,5,850,1.0,582.0,582.0
0.005,17,2,230,1,68,0.0,40.0,40.0,1,162,0.0,134.0,134.0
0.005,6,10,2007,5,928,1.0,660.0,660.0,5,1079,1.0,811.0,811.0
0.001,17,2,180,1,66,0.0,38.0,38.0,1,114,0.0,86.0,86.0
0.005,6,10,2006,5,927,1.0,659.0,659.0,5,1079,1.0,811.0,811.0
0.063,6,10,1506,5,395,15.0,127.0,127.0,5,1111,13.0,843.0,843.0
0.029,6,10,1677,5,827,7.0,559.0,559.0,5,850,7.0,582.0,582.0
0.003,17,2,148,1,60,0.0,32.0,32.0,1,88,0.0,60.0,60.0
0.006,6,10,1689,5,839,1.0,571.0,571.0,5,850,1.0,582.0,582.0
0.004,6,10,1989,5,927,1.0,659.0,659.0,5,1062,1.0,794.0,794.0
40.065,17,10,676,5,460,10013.0,104.0,64.0,5,216,10015.0,20.0,15.0
40.048,17,10,676,5,460,10008.0,104.0,64.0,5,216,10010.0,20.0,15.0
0.019,6,10,1990,5,911,4.0,643.0,643.0,5,1079,4.0,811.0,811.0
0.003,17,2,136,1,60,0.0,32.0,32.0,1,76,0.0,48.0,48.0
0.018,6,10,1631,5,848,4.0,580.0,580.0,5,783,4.0,515.0,515.0
0.011,6,10,1989,5,910,2.0,642.0,642.0,5,1079,2.0,811.0,811.0
0.004,6,13,3747,7,509,0.0,137.0,137.0,6,3238,0.0,1470.0,1459.0
173.325,17,86,12235,43,2888,4125.0,44.0,39.0,43,9347,4126.0,249.0,189.0
0.157,6,10,1506,5,395,38.0,127.0,127.0,5,1111,37.0,843.0,843.0
0.005,6,10,1774,5,923,1.0,655.0,655.0,5,851,1.0,583.0,583.0
10.879,17,28,4419,14,1994,828.0,269.0,114.0,14,2425,827.0,588.0,145.0
0.023,6,10,1972,5,910,5.0,642.0,642.0,5,1062,5.0,794.0,794.0
0.015,6,10,1989,5,910,3.0,642.0,642.0,5,1079,3.0,811.0,811.0
0.113,6,10,1506,5,395,24.0,127.0,127.0,5,1111,27.0,843.0,843.0
0.005,6,10,2007,5,928,1.0,660.0,660.0,5,1079,1.0,811.0,811.0
0.071,6,10,1506,5,395,16.0,127.0,127.0,5,1111,12.0,843.0,843.0
0.005,17,2,166,1,75,0.0,47.0,47.0,1,91,0.0,63.0,63.0
0.005,6,10,1854,5,889,1.0,621.0,621.0,5,965,1.0,697.0,697.0
0.17,17,2,152,1,76,0.0,48.0,48.0,1,76,0.0,48.0,48.0
0.016,6,10,1989,5,910,4.0,642.0,642.0,5,1079,3.0,811.0,811.0
0.004,6,10,2007,5,928,1.0,660.0,660.0,5,1079,1.0,811.0,811.0
300.023,6,12,1782,7,1348,50003.0,494.0,494.0,5,434,75005.0,83.0,83.0
40.073,17,10,676,5,460,10015.0,104.0,64.0,5,216,10016.0,20.0,15.0
0.041,17,4,420,2,122,0.0,33.0,33.0,2,298,35.0,145.0,121.0
0.005,17,2,293,1,73,0.0,45.0,45.0,1,220,0.0,192.0,192.0
0.092,6,10,1506,5,395,20.0,127.0,127.0,5,1111,20.0,843.0,843.0
0.007,17,2,194,1,59,0.0,31.0,31.0,1,135,0.0,107.0,107.0
0.101,6,10,1506,5,395,15.0,127.0,127.0,5,1111,23.0,843.0,843.0
0.004,6,10,2006,5,927,1.0,659.0,659.0,5,1079,1.0,811.0,811.0
11.034,17,28,4396,14,2313,840.0,588.0,137.0,14,2083,840.0,270.0,120.0
300.095,6,22,4963,11,2369,30009.0,1026.0,447.0,11,2594,30009.0,1162.0,405.0
0.004,6,10,1774,5,923,1.0,655.0,655.0,5,851,1.0,583.0,583.0
0.006,17,2,144,1,64,0.0,36.0,36.0,1,80,0.0,52.0,52.0
0.017,6,10,1989,5,910,4.0,642.0,642.0,5,1079,4.0,811.0,811.0
0.112,17,4,596,2,122,108.0,33.0,33.0,2,474,108.0,323.0,209.0
0.011,6,10,1989,5,910,2.0,642.0,642.0,5,1079,2.0,811.0,811.0
0.012,6,6,716,3,458,4.0,302.0,302.0,3,258,4.0,102.0,102.0
0.04,17,2,148,1,60,0.0,32.0,32.0,1,88,0.0,60.0,60.0
0.02,6,10,1990,5,911,4.0,643.0,643.0,5,1079,5.0,811.0,811.0
176.197,17,82,11838,41,2741,4404.0,44.0,38.0,41,9097,4404.0,249.0,193.0
0.061,17,2,80,1,32,0.0,4.0,4.0,1,48,0.0,20.0,20.0
0.005,6,10,1989,5,927,1.0,659.0,659.0,5,1062,1.0,794.0,794.0
0.005,6,10,1774,5,923,1.0,655.0,655.0,5,851,1.0,583.0,583.0
0.037,17,2,148,1,60,0.0,32.0,32.0,1,88,0.0,60.0,60.0
0.008,6,10,1972,5,910,2.0,642.0,642.0,5,1062,2.0,794.0,794.0
0.01,6,10,1990,5,911,2.0,643.0,643.0,5,1079,2.0,811.0,811.0
0.003,17,4,284,2,120,0.0,32.0,32.0,2,164,0.0,60.0,54.0
0.006,6,10,1643,5,860,1.0,592.0,592.0,5,783,1.0,515.0,515.0
0.005,6,10,2006,5,927,1.0,659.0,659.0,5,1079,1.0,811.0,811.0
0.005,17,2,160,1,72,0.0,44.0,44.0,1,88,0.0,60.0,60.0
164.336,17,76,11078,38,2554,4441.0,44.0,39.0,38,8524,4441.0,239.0,196.0
0.009,6,10,1990,5,911,2.0,643.0,643.0,5,1079,2.0,811.0,811.0
0.004,6,10,1779,5,928,1.0,660.0,660.0,5,851,1.0,583.0,583.0
0.098,6,10,1506,5,395,22.0,127.0,127.0,5,1111,18.0,843.0,843.0
0.004,6,10,2006,5,927,1.0,659.0,659.0,5,1079,1.0,811.0,811.0
0.013,6,10,1972,5,910,3.0,642.0,642.0,5,1062,3.0,794.0,794.0
0.005,17,2,166,1,75,0.0,47.0,47.0,1,91,0.0,63.0,63.0
0.015,6,13,3735,7,497,2.0,125.0,125.0,6,3238,2.0,1470.0,1459.0
0.009,6,10,1989,5,910,2.0,642.0,642.0,5,1079,2.0,811.0,811.0
40.069,17,10,676,5,460,10015.0,104.0,64.0,5,216,10016.0,20.0,15.0
0.004,17,2,148,1,60,0.0,32.0,32.0,1,88,0.0,60.0,60.0
0.005,6,10,1989,5,927,1.0,659.0,659.0,5,1062,1.0,794.0,794.0
0.006,6,10,1547,5,764,1.0,496.0,496.0,5,783,1.0,515.0,515.0
354.015,6,21,1795,16,1030,23601.0,190.0,190.0,5,765,60002.0,464.0,248.0
0.006,17,2,179,1,71,0.0,43.0,43.0,1,108,0.0,80.0,80.0
0.09,6,10,1506,5,395,19.0,127.0,127.0,5,1111,20.0,843.0,843.0
0.005,6,10,2007,5,928,1.0,660.0,660.0,5,1079,1.0,811.0,811.0
0.107,6,10,1506,5,395,22.0,127.0,127.0,5,1111,25.0,843.0,843.0
379.432,6,30,6180,19,4936,21079.0,494.0,494.0,11,1244,37942.0,83.0,83.0
0.259,17,39,20157,21,17047,12.0,1350.0,783.0,18,3110,11.0,1350.0,144.0
0.005,6,10,2006,5,927,1.0,659.0,659.0,5,1079,1.0,811.0,811.0
0.006,6,10,1779,5,928,1.0,660.0,660.0,5,851,1.0,583.0,583.0
0.084,6,10,1506,5,395,18.0,127.0,127.0,5,1111,18.0,843.0,843.0
240.1,6,16,4481,9,963,30012.0,238.0,166.0,7,3518,40015.0,1402.0,786.0
0.123,6,10,1506,5,395,27.0,127.0,127.0,5,1111,26.0,843.0,843.0
0.006,6,10,1989,5,927,1.0,659.0,659.0,5,1062,1.0,794.0,794.0
0.04,17,2,136,1,60,0.0,32.0,32.0,1,76,0.0,48.0,48.0
0.083,6,10,1506,5,395,18.0,127.0,127.0,5,1111,18.0,843.0,843.0
0.009,6,10,1989,5,910,2.0,642.0,642.0,5,1079,2.0,811.0,811.0
0.02,6,10,1972,5,910,4.0,642.0,642.0,5,1062,4.0,794.0,794.0
0.006,6,10,1547,5,764,1.0,496.0,496.0,5,783,1.0,515.0,515.0
0.005,6,10,1689,5,839,1.0,571.0,571.0,5,850,1.0,582.0,582.0
0.013,6,10,1983,5,910,3.0,642.0,642.0,5,1073,3.0,805.0,805.0
0.004,17,2,136,1,60,0.0,32.0,32.0,1,76,0.0,48.0,48.0
0.105,6,10,1506,5,395,24.0,127.0,127.0,5,1111,25.0,843.0,843.0
0.018,6,13,3735,7,497,3.0,125.0,125.0,6,3238,3.0,1470.0,1459.0
0.004,6,10,1989,5,927,1.0,659.0,659.0,5,1062,1.0,794.0,794.0
0.076,6,10,1506,5,395,14.0,127.0,127.0,5,1111,17.0,843.0,843.0
0.012,6,10,1983,5,910,3.0,642.0,642.0,5,1073,3.0,805.0,805.0
0.077,6,10,1506,5,395,16.0,127.0,127.0,5,1111,17.0,843.0,843.0
0.136,6,10,1506,5,395,31.0,127.0,127.0,5,1111,30.0,843.0,843.0
0.016,6,10,1631,5,848,3.0,580.0,580.0,5,783,3.0,515.0,515.0
0.005,6,10,1774,5,923,1.0,655.0,655.0,5,851,1.0,583.0,583.0
0.005,6,10,2006,5,927,1.0,659.0,659.0,5,1079,1.0,811.0,811.0
331.204,17,20,1124,10,716,36786.0,48.0,43.0,10,408,36786.0,20.0,12.0
0.007,6,10,1547,5,764,1.0,496.0,496.0,5,783,1.0,515.0,515.0
0.015,6,10,1983,5,910,3.0,642.0,642.0,5,1073,3.0,805.0,805.0
175.568,17,76,10886,38,2529,4744.0,44.0,38.0,38,8357,4744.0,239.0,191.0
0.086,6,10,1506,5,395,19.0,127.0,127.0,5,1111,16.0,843.0,843.0
0.004,6,10,1779,5,928,1.0,660.0,660.0,5,851,1.0,583.0,583.0
0.068,17,8,3613,4,1874,22.0,1350.0,440.0,4,1739,11.0,1350.0,406.0
0.014,6,10,1989,5,910,3.0,642.0,642.0,5,1079,3.0,811.0,811.0
0.013,6,10,1972,5,910,3.0,642.0,642.0,5,1062,3.0,794.0,794.0
488.669,6,37,13889,20,3451,25719.0,676.0,400.0,17,10438,26790.0,1402.0,954.0
0.004,6,10,1774,5,923,1.0,655.0,655.0,5,851,1.0,583.0,583.0
0.002,17,2,166,1,75,0.0,47.0,47.0,1,91,0.0,63.0,63.0
0.088,6,10,1506,5,395,20.0,127.0,127.0,5,1111,19.0,843.0,843.0
300.335,6,16,2170,9,684,37520.0,146.0,146.0,7,1486,50027.0,419.0,398.0
11.174,17,28,4422,14,1994,846.0,269.0,114.0,14,2428,846.0,587.0,145.0
0.226,6,16,2778,8,1396,32.0,533.0,324.0,8,1382,20.0,529.0,239.0
0.014,6,10,1989,5,910,3.0,642.0,642.0,5,1079,3.0,811.0,811.0
0.005,6,10,2007,5,928,1.0,660.0,660.0,5,1079,1.0,811.0,811.0
0.041,17,2,170,1,65,0.0,37.0,37.0,1,105,0.0,77.0,77.0
0.005,6,10,1643,5,860,1.0,592.0,592.0,5,783,1.0,515.0,515.0
0.001,17,2,180,1,66,0.0,38.0,38.0,1,114,0.0,86.0,86.0
0.005,6,10,2006,5,927,1.0,659.0,659.0,5,1079,1.0,811.0,811.0
0.018,6,10,1990,5,911,4.0,643.0,643.0,5,1079,4.0,811.0,811.0
0.004,17,2,148,1,60,0.0,32.0,32.0,1,88,0.0,60.0,60.0
0.001,17,2,152,1,68,0.0,40.0,40.0,1,84,0.0,56.0,56.0
0.013,6,10,1989,5,910,3.0,642.0,642.0,5,1079,3.0,811.0,811.0
0.008,6,10,1990,5,911,1.0,643.0,643.0,5,1079,2.0,811.0,811.0
0.005,17,2,213,1,69,0.0,41.0,41.0,1,144,0.0,116.0,116.0
170.062,17,80,11402,40,2661,4360.0,44.0,38.0,40,8741,4360.0,239.0,190.0
0.087,6,10,1506,5,395,20.0,127.0,127.0,5,1111,19.0,843.0,843.0
40.064,17,10,676,5,460,10014.0,104.0,64.0,5,216,10015.0,20.0,15.0
0.078,6,10,1506,5,395,16.0,127.0,127.0,5,1111,16.0,843.0,843.0
0.014,6,10,1989,5,910,3.0,642.0,642.0,5,1079,3.0,811.0,811.0
240.24,6,39,5341,18,2324,14131.0,588.0,197.0,21,3017,12011.0,580.0,239.0
0.008,6,10,2007,5,928,1.0,660.0,660.0,5,1079,2.0,811.0,811.0
0.003,17,2,148,1,60,0.0,32.0,32.0,1,88,0.0,60.0,60.0
0.009,6,12,1926,6,1189,1.0,659.0,434.0,6,737,1.0,417.0,417.0
240.1,6,16,4481,9,963,30012.0,238.0,166.0,7,3518,40016.0,1402.0,786.0
300.335,6,16,2170,9,684,37520.0,146.0,146.0,7,1486,50026.0,419.0,398.0
0.007,6,10,1989,5,910,1.0,642.0,642.0,5,1079,1.0,811.0,811.0
0.005,6,10,1854,5,889,1.0,621.0,621.0,5,965,1.0,697.0,697.0
0.007,17,2,179,1,71,0.0,43.0,43.0,1,108,0.0,80.0,80.0
40.048,17,10,676,5,460,10011.0,104.0,64.0,5,216,10011.0,20.0,15.0
0.056,6,10,1506,5,395,13.0,127.0,127.0,5,1111,12.0,843.0,843.0
0.082,6,10,1506,5,395,16.0,127.0,127.0,5,1111,17.0,843.0,843.0
0.009,6,10,1631,5,848,2.0,580.0,580.0,5,783,2.0,515.0,515.0
0.043,17,2,234,1,61,0.0,33.0,33.0,1,173,0.0,145.0,145.0
354.065,6,21,1795,16,1030,23604.0,190.0,190.0,5,765,60002.0,464.0,248.0
0.063,6,10,1506,5,395,15.0,127.0,127.0,5,1111,13.0,843.0,843.0
0.01,6,10,1972,5,910,2.0,642.0,642.0,5,1062,2.0,794.0,794.0
0.008,6,10,1972,5,910,2.0,642.0,642.0,5,1062,2.0,794.0,794.0
0.013,6,14,3787,7,497,2.0,125.0,125.0,7,3290,2.0,1448.0,972.0
0.127,17,2,148,1,60,0.0,32.0,32.0,1,88,0.0,60.0,60.0
0.006,6,10,1689,5,839,1.0,571.0,571.0,5,850,1.0,582.0,582.0
0.023,6,10,1989,5,910,5.0,642.0,642.0,5,1079,5.0,811.0,811.0
0.011,6,10,1983,5,910,2.0,642.0,642.0,5,1073,2.0,805.0,805.0
0.012,6,10,1990,5,911,3.0,643.0,643.0,5,1079,3.0,811.0,811.0
12.324,17,42,9462,21,5173,607.0,1337.0,218.0,21,4289,607.0,861.0,176.0
0.004,6,10,1702,5,863,1.0,595.0,595.0,5,839,0.0,571.0,571.0
0.006,6,10,1689,5,839,1.0,571.0,571.0,5,850,1.0,582.0,582.0
15.074,17,16,8780,8,6493,2149.0,1350.0,783.0,8,2287,2149.0,1350.0,257.0
0.01,6,10,1972,5,910,2.0,642.0,642.0,5,1062,2.0,794.0,794.0
0.023,6,10,1989,5,910,5.0,642.0,642.0,5,1079,5.0,811.0,811.0
0.007,6,12,1698,6,863,1.0,327.0,271.0,6,835,1.0,515.0,515.0
0.101,6,10,1506,5,395,18.0,127.0,127.0,5,1111,23.0,843.0,843.0
0.148,6,10,1506,5,395,29.0,127.0,127.0,5,1111,31.0,843.0,843.0
0.133,17,4,284,2,120,0.0,32.0,32.0,2,164,129.0,60.0,54.0
240.016,6,10,839,6,540,48003.0,232.0,232.0,4,299,80003.0,83.0,83.0
15.08,17,15,8392,8,6146,2150.0,1350.0,740.0,7,2246,2508.0,1350.0,292.0
0.005,6,10,2000,5,927,1.0,659.0,659.0,5,1073,1.0,805.0,805.0
0.005,6,10,1643,5,860,1.0,592.0,592.0,5,783,1.0,515.0,515.0
1778.76,17,144,45504,72,22752,25052.0,288.0,288.0,72,22752,25052.0,288.0,288.0
0.005,6,10,1643,5,860,1.0,592.0,592.0,5,783,1.0,515.0,515.0
0.005,6,10,2007,5,928,1.0,660.0,660.0,5,1079,1.0,811.0,811.0
0.114,6,10,1506,5,395,24.0,127.0,127.0,5,1111,23.0,843.0,843.0
0.067,6,10,1506,5,395,14.0,127.0,127.0,5,1111,15.0,843.0,843.0
0.005,6,10,2006,5,927,1.0,659.0,659.0,5,1079,1.0,811.0,811.0
0.003,17,2,234,1,61,0.0,33.0,33.0,1,173,0.0,145.0,145.0
0.004,6,10,2006,5,927,1.0,659.0,659.0,5,1079,1.0,811.0,811.0
0.005,17,2,179,1,71,0.0,43.0,43.0,1,108,0.0,80.0,80.0
0.004,6,10,2006,5,927,1.0,659.0,659.0,5,1079,1.0,811.0,811.0
0.006,17,2,140,1,62,0.0,34.0,34.0,1,78,0.0,50.0,50.0
0.004,6,10,1989,5,927,1.0,659.0,659.0,5,1062,1.0,794.0,794.0
0.012,6,10,1990,5,911,3.0,643.0,643.0,5,1079,3.0,811.0,811.0
0.005,17,2,214,1,75,0.0,47.0,47.0,1,139,0.0,111.0,111.0
0.004,6,10,2006,5,927,1.0,659.0,659.0,5,1079,1.0,811.0,811.0
0.007,6,10,1547,5,764,1.0,496.0,496.0,5,783,1.0,515.0,515.0
240.417,6,35,10430,18,2215,14140.0,559.0,254.0,17,8215,15023.0,1611.0,666.0
0.069,6,10,1506,5,395,15.0,127.0,127.0,5,1111,14.0,843.0,843.0
0.008,6,10,1990,5,911,2.0,643.0,643.0,5,1079,2.0,811.0,811.0
0.005,6,10,1989,5,927,1.0,659.0,659.0,5,1062,1.0,794.0,794.0
40.051,17,10,676,5,460,10011.0,104.0,64.0,5,216,10011.0,20.0,15.0
0.086,6,10,1506,5,395,20.0,127.0,127.0,5,1111,19.0,843.0,843.0
0.005,6,10,2006,5,927,1.0,659.0,659.0,5,1079,1.0,811.0,811.0
0.074,6,10,1506,5,395,17.0,127.0,127.0,5,1111,16.0,843.0,843.0
0.004,6,10,2006,5,927,1.0,659.0,659.0,5,1079,1.0,811.0,811.0
0.005,6,10,1547,5,764,1.0,496.0,496.0,5,783,1.0,515.0,515.0
0.007,17,2,213,1,69,0.0,41.0,41.0,1,144,0.0,116.0,116.0
0.013,6,10,1989,5,910,3.0,642.0,642.0,5,1079,3.0,811.0,811.0
0.005,17,2,230,1,68,0.0,40.0,40.0,1,162,0.0,134.0,134.0
10.876,17,28,4421,14,1993,828.0,268.0,114.0,14,2428,828.0,587.0,145.0
0.009,6,10,1762,5,911,2.0,643.0,643.0,5,851,2.0,583.0,583.0
0.005,6,10,1989,5,927,1.0,659.0,659.0,5,1062,1.0,794.0,794.0
0.229,6,16,2670,8,1396,32.0,533.0,324.0,8,1274,21.0,529.0,212.0
0.004,6,10,2000,5,927,1.0,659.0,659.0,5,1073,1.0,805.0,805.0
0.007,17,2,179,1,71,0.0,43.0,43.0,1,108,0.0,80.0,80.0
0.001,17,2,180,1,66,0.0,38.0,38.0,1,114,0.0,86.0,86.0
0.004,6,10,1989,5,927,1.0,659.0,659.0,5,1062,1.0,794.0,794.0
0.012,6,10,1983,5,910,3.0,642.0,642.0,5,1073,2.0,805.0,805.0
0.119,6,10,1506,5,395,26.0,127.0,127.0,5,1111,27.0,843.0,843.0
0.013,6,10,1989,5,910,3.0,642.0,642.0,5,1079,3.0,811.0,811.0
0.02,6,10,1989,5,910,4.0,642.0,642.0,5,1079,4.0,811.0,811.0
0.01,6,10,1990,5,911,2.0,643.0,643.0,5,1079,2.0,811.0,811.0
0.004,6,10,2007,5,928,1.0,660.0,660.0,5,1079,1.0,811.0,811.0
1049.132,6,160,20070,65,14023,16392.0,2801.0,228.0,95,6047,11159.0,225.0,52.0
0.033,6,10,1989,5,910,8.0,642.0,642.0,5,1079,8.0,811.0,811.0
0.004,6,10,2006,5,927,1.0,659.0,659.0,5,1079,1.0,811.0,811.0
0.039,6,10,1989,5,910,9.0,642.0,642.0,5,1079,9.0,811.0,811.0
0.005,6,13,3747,7,509,0.0,137.0,137.0,6,3238,1.0,1470.0,1459.0
240.114,6,16,4482,9,963,30014.0,238.0,166.0,7,3519,40018.0,1402.0,786.0
0.069,6,10,1506,5,395,14.0,127.0,127.0,5,1111,16.0,843.0,843.0
0.005,17,2,180,1,58,0.0,30.0,30.0,1,122,0.0,94.0,94.0
0.014,6,10,1972,5,910,3.0,642.0,642.0,5,1062,3.0,794.0,794.0
0.012,6,10,1990,5,911,2.0,643.0,643.0,5,1079,2.0,811.0,811.0
0.005,6,10,2006,5,927,1.0,659.0,659.0,5,1079,1.0,811.0,811.0
0.005,6,14,3736,7,446,0.0,74.0,74.0,7,3290,0.0,1448.0,972.0
0.206,6,16,2675,8,1401,29.0,533.0,325.0,8,1274,18.0,529.0,212.0
0.004,17,2,136,1,60,0.0,32.0,32.0,1,76,0.0,48.0,48.0
0.069,6,10,1506,5,395,15.0,127.0,127.0,5,1111,16.0,843.0,843.0
0.004,6,10,1779,5,928,1.0,660.0,660.0,5,851,1.0,583.0,583.0
300.861,6,34,6335,19,1409,16714.0,267.0,154.0,15,4926,625.0,1823.0,392.0
0.009,6,10,1762,5,911,2.0,643.0,643.0,5,851,2.0,583.0,583.0
0.011,6,10,1972,5,910,2.0,642.0,642.0,5,1062,2.0,794.0,794.0
0.003,17,2,148,1,60,0.0,32.0,32.0,1,88,0.0,60.0,60.0
0.021,6,10,1983,5,910,5.0,642.0,642.0,5,1073,5.0,805.0,805.0
0.01,6,10,1990,5,911,2.0,643.0,643.0,5,1079,2.0,811.0,811.0
0.005,6,10,2006,5,927,1.0,659.0,659.0,5,1079,1.0,811.0,811.0
176.486,17,72,10334,36,2402,5042.0,44.0,38.0,36,7932,5042.0,239.0,192.0
0.078,6,10,1506,5,395,16.0,127.0,127.0,5,1111,18.0,843.0,843.0
0.107,6,10,1506,5,395,22.0,127.0,127.0,5,1111,24.0,843.0,843.0
0.132,6,10,1506,5,395,29.0,127.0,127.0,5,1111,30.0,843.0,843.0
0.12,6,10,1506,5,395,22.0,127.0,127.0,5,1111,28.0,843.0,843.0
1.015,6,12,3141,6,2098,153.0,1328.0,923.0,6,1043,153.0,791.0,791.0
368.967,6,22,2313,16,867,24597.0,195.0,195.0,6,1446,4641.0,419.0,398.0
0.008,6,10,1631,5,848,2.0,580.0,580.0,5,783,2.0,515.0,515.0
0.039,17,2,152,1,76,0.0,48.0,48.0,1,76,0.0,48.0,48.0
15.08,17,15,8123,8,6110,2150.0,1350.0,735.0,7,2013,2508.0,1350.0,259.0
0.008,6,10,1989,5,910,2.0,642.0,642.0,5,1079,1.0,811.0,811.0
0.075,6,10,1506,5,395,16.0,127.0,127.0,5,1111,13.0,843.0,843.0
0.1,6,10,1506,5,395,23.0,127.0,127.0,5,1111,21.0,843.0,843.0
0.006,6,10,1854,5,889,1.0,621.0,621.0,5,965,1.0,697.0,697.0
0.008,6,10,1983,5,910,2.0,642.0,642.0,5,1073,1.0,805.0,805.0
240.093,6,33,9486,17,6958,15005.0,1515.0,607.0,16,2528,16006.0,580.0,211.0
0.07,6,10,1506,5,395,15.0,127.0,127.0,5,1111,15.0,843.0,843.0
0.175,6,10,1506,5,395,29.0,127.0,127.0,5,1111,40.0,843.0,843.0
0.006,6,10,1643,5,860,1.0,592.0,592.0,5,783,1.0,515.0,515.0
0.003,17,2,148,1,60,0.0,32.0,32.0,1,88,0.0,60.0,60.0
0.075,6,10,1506,5,395,15.0,127.0,127.0,5,1111,17.0,843.0,843.0
0.005,6,13,3747,7,509,0.0,137.0,137.0,6,3238,0.0,1470.0,1459.0
0.005,6,10,2006,5,927,1.0,659.0,659.0,5,1079,1.0,811.0,811.0
0.011,6,10,1989,5,910,2.0,642.0,642.0,5,1079,2.0,811.0,811.0
0.004,6,10,1779,5,928,1.0,660.0,660.0,5,851,1.0,583.0,583.0
0.003,17,2,148,1,60,0.0,32.0,32.0,1,88,0.0,60.0,60.0
1799.996,6,233,28209,88,19187,20344.0,2720.0,208.0,145,9022,12499.0,148.0,47.0
174.037,17,90,12683,45,3016,3955.0,44.0,39.0,45,9667,3955.0,239.0,186.0
0.001,17,2,136,1,60,0.0,32.0,32.0,1,76,0.0,48.0,48.0
0.02,6,10,1989,5,910,4.0,642.0,642.0,5,1079,4.0,811.0,811.0
0.017,6,10,1983,5,910,4.0,642.0,642.0,5,1073,4.0,805.0,805.0
0.005,17,2,214,1,75,0.0,47.0,47.0,1,139,0.0,111.0,111.0
0.07,6,10,1506,5,395,16.0,127.0,127.0,5,1111,15.0,843.0,843.0
0.007,6,10,1547,5,764,1.0,496.0,496.0,5,783,1.0,515.0,515.0
0.005,6,10,2006,5,927,1.0,659.0,659.0,5,1079,1.0,811.0,811.0
0.008,6,10,1762,5,911,1.0,643.0,643.0,5,851,2.0,583.0,583.0
0.129,17,2,184,1,61,0.0,33.0,33.0,1,123,0.0,95.0,95.0
0.003,17,4,284,2,120,0.0,32.0,32.0,2,164,0.0,60.0,54.0
0.006,6,10,1643,5,860,1.0,592.0,592.0,5,783,1.0,515.0,515.0
0.007,6,10,1762,5,911,1.0,643.0,643.0,5,851,1.0,583.0,583.0
0.074,6,10,1506,5,395,17.0,127.0,127.0,5,1111,14.0,843.0,843.0
0.005,6,10,2007,5,928,1.0,660.0,660.0,5,1079,1.0,811.0,811.0
0.006,6,10,1547,5,764,1.0,496.0,496.0,5,783,1.0,515.0,515.0
0.095,6,10,1506,5,395,18.0,127.0,127.0,5,1111,21.0,843.0,843.0
0.009,6,10,1989,5,910,2.0,642.0,642.0,5,1079,2.0,811.0,811.0
0.005,6,10,2006,5,927,1.0,659.0,659.0,5,1079,1.0,811.0,811.0
1780.932,6,85,4522,43,2288,42402.0,26.0,26.0,42,2234,43436.0,26.0,25.0
0.004,6,10,1702,5,863,1.0,595.0,595.0,5,839,1.0,571.0,571.0
0.012,6,13,3735,7,497,2.0,125.0,125.0,6,3238,2.0,1470.0,1459.0
300.021,6,12,1782,7,1348,50003.0,494.0,494.0,5,434,75004.0,83.0,83.0
0.088,6,10,1506,5,395,21.0,127.0,127.0,5,1111,16.0,843.0,843.0
0.13,17,2,80,1,32,0.0,4.0,4.0,1,48,0.0,20.0,20.0
0.069,6,10,1506,5,395,15.0,127.0,127.0,5,1111,15.0,843.0,843.0
0.005,6,10,2000,5,927,1.0,659.0,659.0,5,1073,1.0,805.0,805.0
0.019,6,10,1990,5,911,4.0,643.0,643.0,5,1079,4.0,811.0,811.0
0.005,6,10,2000,5,927,1.0,659.0,659.0,5,1073,1.0,805.0,805.0
0.009,6,10,1990,5,911,2.0,643.0,643.0,5,1079,2.0,811.0,811.0
0.015,6,10,1989,5,910,3.0,642.0,642.0,5,1079,3.0,811.0,811.0
0.101,6,10,1506,5,395,24.0,127.0,127.0,5,1111,23.0,843.0,843.0
369.538,6,22,2313,16,867,24635.0,195.0,195.0,6,1446,4636.0,419.0,398.0
0.014,6,10,1983,5,910,3.0,642.0,642.0,5,1073,3.0,805.0,805.0
0.038,17,2,146,1,65,0.0,37.0,37.0,1,81,0.0,53.0,53.0
0.078,6,10,1506,5,395,16.0,127.0,127.0,5,1111,16.0,843.0,843.0
126.015,6,14,2938,8,2504,17968.0,1414.0,1086.0,6,434,25156.0,182.0,182.0
0.003,17,2,132,1,58,0.0,30.0,30.0,1,74,0.0,46.0,46.0
0.001,17,2,180,1,66,0.0,38.0,38.0,1,114,0.0,86.0,86.0
0.016,6,10,1972,5,910,4.0,642.0,642.0,5,1062,3.0,794.0,794.0
0.096,6,10,1506,5,395,22.0,127.0,127.0,5,1111,18.0,843.0,843.0
0.004,17,2,148,1,60,0.0,32.0,32.0,1,88,0.0,60.0,60.0
0.004,6,10,2006,5,927,1.0,659.0,659.0,5,1079,1.0,811.0,811.0
0.014,6,10,1631,5,848,3.0,580.0,580.0,5,783,3.0,515.0,515.0
0.143,6,10,1506,5,395,34.0,127.0,127.0,5,1111,32.0,843.0,843.0
0.004,17,2,148,1,60,0.0,32.0,32.0,1,88,0.0,60.0,60.0
0.167,17,2,152,1,76,0.0,48.0,48.0,1,76,0.0,48.0,48.0
0.131,6,10,1506,5,395,31.0,127.0,127.0,5,1111,28.0,843.0,843.0
0.013,6,10,1762,5,911,3.0,643.0,643.0,5,851,3.0,583.0,583.0
0.072,17,4,284,2,120,0.0,32.0,32.0,2,164,0.0,60.0,54.0
11.194,17,28,4399,14,2312,852.0,587.0,137.0,14,2087,852.0,270.0,121.0
0.016,6,10,1677,5,827,4.0,559.0,559.0,5,850,3.0,582.0,582.0
0.011,6,10,1989,5,910,2.0,642.0,642.0,5,1079,2.0,811.0,811.0
0.003,17,2,136,1,60,0.0,32.0,32.0,1,76,0.0,48.0,48.0
955.44,6,53,10202,27,7834,25411.0,494.0,494.0,26,2368,38217.0,83.0,83.0
1751.22,6,64,7361,42,4485,42712.0,1641.0,109.0,22,2876,83383.0,1112.0,82.0
0.008,6,10,2006,5,927,2.0,659.0,659.0,5,1079,2.0,811.0,811.0
0.011,6,13,3735,7,497,1.0,125.0,125.0,6,3238,2.0,1470.0,1459.0
0.078,6,10,1506,5,395,17.0,127.0,127.0,5,1111,18.0,843.0,843.0
0.04,17,2,152,1,76,0.0,48.0,48.0,1,76,0.0,48.0,48.0
0.019,6,10,1989,5,910,4.0,642.0,642.0,5,1079,4.0,811.0,811.0
0.116,6,10,1506,5,395,24.0,127.0,127.0,5,1111,26.0,843.0,843.0
9.036,17,6,376,5,280,2259.0,28.0,28.0,1,96,0.0,68.0,68.0
0.005,6,10,2007,5,928,1.0,660.0,660.0,5,1079,1.0,811.0,811.0
0.017,6,10,1972,5,910,4.0,642.0,642.0,5,1062,4.0,794.0,794.0
0.006,6,10,1547,5,764,1.0,496.0,496.0,5,783,1.0,515.0,515.0
40.061,17,10,676,5,460,10014.0,104.0,64.0,5,216,10014.0,20.0,15.0
0.008,6,10,1989,5,910,2.0,642.0,642.0,5,1079,2.0,811.0,811.0
0.08,6,10,1506,5,395,16.0,127.0,127.0,5,1111,18.0,843.0,843.0
0.003,17,2,160,1,72,0.0,44.0,44.0,1,88,0.0,60.0,60.0
1787.632,6,154,19574,92,13852,19644.0,302.0,302.0,62,5722,29305.0,83.0,83.0
0.001,17,2,180,1,66,0.0,38.0,38.0,1,114,0.0,86.0,86.0
0.091,6,10,1506,5,395,21.0,127.0,127.0,5,1111,19.0,843.0,843.0
0.004,6,10,1702,5,863,1.0,595.0,595.0,5,839,1.0,571.0,571.0
0.006,6,10,1643,5,860,1.0,592.0,592.0,5,783,1.0,515.0,515.0
0.004,6,10,2000,5,927,1.0,659.0,659.0,5,1073,1.0,805.0,805.0
0.039,17,4,284,2,120,0.0,32.0,32.0,2,164,36.0,60.0,54.0
0.006,6,10,1547,5,764,1.0,496.0,496.0,5,783,1.0,515.0,515.0
40.088,17,10,676,5,460,10021.0,104.0,64.0,5,216,10021.0,20.0,15.0
0.001,17,2,180,1,66,0.0,38.0,38.0,1,114,0.0,86.0,86.0
0.083,6,10,1506,5,395,20.0,127.0,127.0,5,1111,16.0,843.0,843.0
0.006,6,10,1689,5,839,1.0,571.0,571.0,5,850,1.0,582.0,582.0
0.107,6,10,1506,5,395,23.0,127.0,127.0,5,1111,25.0,843.0,843.0
0.005,6,10,2007,5,928,1.0,660.0,660.0,5,1079,1.0,811.0,811.0
0.103,6,10,1506,5,395,24.0,127.0,127.0,5,1111,23.0,843.0,843.0
0.007,17,2,194,1,59,0.0,31.0,31.0,1,135,0.0,107.0,107.0
15.081,17,16,8560,8,6441,2150.0,1350.0,777.0,8,2119,2150.0,1350.0,236.0
0.015,6,10,1677,5,827,3.0,559.0,559.0,5,850,3.0,582.0,582.0
0.041,17,4,284,2,120,0.0,32.0,32.0,2,164,38.0,60.0,54.0
0.088,6,10,1506,5,395,18.0,127.0,127.0,5,1111,20.0,843.0,843.0
0.005,6,10,1989,5,927,1.0,659.0,659.0,5,1062,1.0,794.0,794.0
0.005,6,10,1643,5,860,1.0,592.0,592.0,5,783,1.0,515.0,515.0
0.011,6,10,1983,5,910,2.0,642.0,642.0,5,1073,2.0,805.0,805.0
0.107,6,10,1506,5,395,25.0,127.0,127.0,5,1111,21.0,843.0,843.0
0.012,6,10,1972,5,910,3.0,642.0,642.0,5,1062,2.0,794.0,794.0
0.005,6,11,1741,6,891,1.0,571.0,571.0,5,850,1.0,582.0,582.0
0.014,6,10,1990,5,911,3.0,643.0,643.0,5,1079,3.0,811.0,811.0
0.005,6,10,2007,5,928,1.0,660.0,660.0,5,1079,1.0,811.0,811.0
0.006,6,10,2007,5,928,1.0,660.0,660.0,5,1079,1.0,811.0,811.0
0.005,6,10,2000,5,927,1.0,659.0,659.0,5,1073,1.0,805.0,805.0
240.093,6,16,4482,9,963,30011.0,238.0,166.0,7,3519,40014.0,1402.0,786.0
0.011,6,10,1972,5,910,2.0,642.0,642.0,5,1062,2.0,794.0,794.0
0.009,6,10,1990,5,911,2.0,643.0,643.0,5,1079,2.0,811.0,811.0
0.001,17,2,179,1,62,0.0,34.0,34.0,1,117,0.0,89.0,89.0
0.01,6,10,1631,5,848,2.0,580.0,580.0,5,783,2.0,515.0,515.0
0.006,6,10,1547,5,764,1.0,496.0,496.0,5,783,1.0,515.0,515.0
0.005,6,10,2006,5,927,1.0,659.0,659.0,5,1079,1.0,811.0,811.0
0.009,6,10,1989,5,910,2.0,642.0,642.0,5,1079,2.0,811.0,811.0
309.535,17,20,1124,10,716,34378.0,48.0,43.0,10,408,34378.0,20.0,12.0
0.005,6,10,1989,5,927,1.0,659.0,659.0,5,1062,1.0,794.0,794.0
354.005,6,19,1691,15,978,25286.0,190.0,190.0,4,713,80005.0,497.0,497.0
0.792,6,10,2009,6,1655,158.0,1403.0,1403.0,4,354,185.0,182.0,182.0
0.009,6,12,1926,6,1189,1.0,659.0,434.0,6,737,1.0,417.0,417.0
0.005,6,10,1774,5,923,1.0,655.0,655.0,5,851,1.0,583.0,583.0
0.015,6,10,1989,5,910,3.0,642.0,642.0,5,1079,3.0,811.0,811.0
0.104,6,10,1506,5,395,23.0,127.0,127.0,5,1111,23.0,843.0,843.0
0.004,6,10,2006,5,927,1.0,659.0,659.0,5,1079,1.0,811.0,811.0
0.008,6,10,1989,5,910,2.0,642.0,642.0,5,1079,2.0,811.0,811.0
0.004,6,10,2006,5,927,1.0,659.0,659.0,5,1079,1.0,811.0,811.0
0.005,17,2,164,1,74,0.0,46.0,46.0,1,90,0.0,62.0,62.0
1772.603,17,120,11460,60,5460,30043.0,63.0,63.0,60,6000,30043.0,72.0,72.0
0.005,6,10,2006,5,927,1.0,659.0,659.0,5,1079,1.0,811.0,811.0
0.069,17,8,3613,4,1874,23.0,1350.0,440.0,4,1739,12.0,1350.0,406.0
0.005,6,10,2007,5,928,1.0,660.0,660.0,5,1079,1.0,811.0,811.0
240.023,6,9,787,5,488,60005.0,232.0,232.0,4,299,80006.0,83.0,83.0
0.06,6,10,1506,5,395,13.0,127.0,127.0,5,1111,13.0,843.0,843.0
0.004,6,10,2006,5,927,1.0,659.0,659.0,5,1079,1.0,811.0,811.0
0.01,6,10,1990,5,911,2.0,643.0,643.0,5,1079,2.0,811.0,811.0
0.007,6,10,1547,5,764,1.0,496.0,496.0,5,783,1.0,515.0,515.0
0.005,6,10,2000,5,927,1.0,659.0,659.0,5,1073,1.0,805.0,805.0
0.005,6,10,1689,5,839,1.0,571.0,571.0,5,850,1.0,582.0,582.0
0.006,6,10,1547,5,764,1.0,496.0,496.0,5,783,1.0,515.0,515.0
0.094,6,10,1506,5,395,19.0,127.0,127.0,5,1111,18.0,843.0,843.0
0.01,6,10,1677,5,827,2.0,559.0,559.0,5,850,2.0,582.0,582.0
0.009,6,10,1990,5,911,2.0,643.0,643.0,5,1079,2.0,811.0,811.0
0.004,6,10,1989,5,927,1.0,659.0,659.0,5,1062,1.0,794.0,794.0
0.005,17,2,144,1,64,0.0,36.0,36.0,1,80,0.0,52.0,52.0
0.037,17,2,184,1,61,0.0,33.0,33.0,1,123,0.0,95.0,95.0
0.005,6,10,2000,5,927,1.0,659.0,659.0,5,1073,1.0,805.0,805.0
0.086,6,10,1506,5,395,18.0,127.0,127.0,5,1111,18.0,843.0,843.0
0.097,6,10,1506,5,395,22.0,127.0,127.0,5,1111,21.0,843.0,843.0
0.003,17,2,148,1,60,0.0,32.0,32.0,1,88,0.0,60.0,60.0
40.076,17,10,676,5,460,10018.0,104.0,64.0,5,216,10018.0,20.0,15.0
0.202,17,17,9535,8,6952,28.0,1350.0,841.0,9,2583,21.0,1350.0,259.0
0.097,6,10,1506,5,395,23.0,127.0,127.0,5,1111,22.0,843.0,843.0
0.004,6,10,1989,5,927,1.0,659.0,659.0,5,1062,1.0,794.0,794.0
0.015,17,2,148,1,60,0.0,32.0,32.0,1,88,0.0,60.0,60.0
0.006,6,10,2006,5,927,1.0,659.0,659.0,5,1079,1.0,811.0,811.0
0.005,17,2,179,1,71,0.0,43.0,43.0,1,108,0.0,80.0,80.0
0.01,6,10,1990,5,911,2.0,643.0,643.0,5,1079,2.0,811.0,811.0
0.014,17,2,194,1,59,0.0,31.0,31.0,1,135,0.0,107.0,107.0
0.013,6,10,1983,5,910,3.0,642.0,642.0,5,1073,3.0,805.0,805.0
0.005,6,10,1643,5,860,1.0,592.0,592.0,5,783,1.0,515.0,515.0
0.067,6,10,1506,5,395,12.0,127.0,127.0,5,1111,13.0,843.0,843.0
0.005,6,10,1779,5,928,1.0,660.0,660.0,5,851,1.0,583.0,583.0
1.001,6,42,25032,22,18288,47.0,2720.0,1448.0,20,6744,43.0,2720.0,988.0
0.006,6,10,1547,5,764,1.0,496.0,496.0,5,783,1.0,515.0,515.0
0.005,6,10,1774,5,923,1.0,655.0,655.0,5,851,1.0,583.0,583.0
40.053,17,10,676,5,460,10012.0,104.0,64.0,5,216,10006.0,20.0,15.0
0.024,6,10,1983,5,910,6.0,642.0,642.0,5,1073,5.0,805.0,805.0
0.007,6,10,1547,5,764,1.0,496.0,496.0,5,783,1.0,515.0,515.0
0.227,6,16,2669,8,1395,32.0,533.0,323.0,8,1274,21.0,529.0,212.0
0.037,6,10,1762,5,911,9.0,643.0,643.0,5,851,9.0,583.0,583.0
0.005,6,10,2007,5,928,1.0,660.0,660.0,5,1079,1.0,811.0,811.0
0.002,17,2,136,1,60,0.0,32.0,32.0,1,76,0.0,48.0,48.0
0.005,6,10,2000,5,927,1.0,659.0,659.0,5,1073,1.0,805.0,805.0
0.092,6,10,1506,5,395,20.0,127.0,127.0,5,1111,20.0,843.0,843.0
0.007,17,2,299,1,65,0.0,37.0,37.0,1,234,0.0,206.0,206.0
240.013,6,9,787,5,488,60003.0,232.0,232.0,4,299,80003.0,83.0,83.0
0.005,6,10,2006,5,927,1.0,659.0,659.0,5,1079,1.0,811.0,811.0
0.188,17,2,152,1,76,0.0,48.0,48.0,1,76,0.0,48.0,48.0
0.004,6,10,1774,5,923,0.0,655.0,655.0,5,851,1.0,583.0,583.0
0.011,6,10,1983,5,910,2.0,642.0,642.0,5,1073,2.0,805.0,805.0
0.085,6,10,1506,5,395,17.0,127.0,127.0,5,1111,19.0,843.0,843.0
0.008,6,10,1989,5,910,2.0,642.0,642.0,5,1079,2.0,811.0,811.0
0.008,6,10,1989,5,910,2.0,642.0,642.0,5,1079,1.0,811.0,811.0
0.07,6,20,9974,11,704,7.0,124.0,124.0,9,9270,8.0,2896.0,1758.0
0.012,6,10,1990,5,911,2.0,643.0,643.0,5,1079,2.0,811.0,811.0
240.133,6,32,9262,16,6810,16008.0,1883.0,664.0,16,2452,16008.0,580.0,201.0
0.006,6,10,2007,5,928,1.0,660.0,660.0,5,1079,1.0,811.0,811.0
0.01,6,10,1989,5,910,2.0,642.0,642.0,5,1079,2.0,811.0,811.0
0.013,6,10,1983,5,910,3.0,642.0,642.0,5,1073,3.0,805.0,805.0
0.005,6,10,1689,5,839,1.0,571.0,571.0,5,850,1.0,582.0,582.0
0.004,17,2,136,1,60,0.0,32.0,32.0,1,76,0.0,48.0,48.0
0.006,6,10,1547,5,764,1.0,496.0,496.0,5,783,1.0,515.0,515.0
0.01,6,10,1989,5,910,2.0,642.0,642.0,5,1079,2.0,811.0,811.0
0.121,6,10,1506,5,395,27.0,127.0,127.0,5,1111,29.0,843.0,843.0
0.003,17,2,136,1,60,0.0,32.0,32.0,1,76,0.0,48.0,48.0
0.068,6,10,1506,5,395,14.0,127.0,127.0,5,1111,14.0,843.0,843.0
0.11,6,10,1506,5,395,21.0,127.0,127.0,5,1111,25.0,843.0,843.0
0.006,6,10,1547,5,764,1.0,496.0,496.0,5,783,1.0,515.0,515.0
0.006,6,13,3690,7,452,1.0,80.0,80.0,6,3238,1.0,1470.0,1459.0
0.019,6,14,3787,7,497,3.0,125.0,125.0,7,3290,3.0,1448.0,972.0
0.004,17,2,148,1,60,0.0,32.0,32.0,1,88,0.0,60.0,60.0
0.009,6,10,1990,5,911,2.0,643.0,643.0,5,1079,2.0,811.0,811.0
0.026,6,10,1972,5,910,6.0,642.0,642.0,5,1062,6.0,794.0,794.0
0.257,17,2,184,1,61,0.0,33.0,33.0,1,123,0.0,95.0,95.0
1772.201,6,105,6270,60,3525,30036.0,27.0,27.0,45,2745,40276.0,27.0,27.0
0.082,6,10,1506,5,395,19.0,127.0,127.0,5,1111,18.0,843.0,843.0
0.001,17,2,212,1,64,0.0,36.0,36.0,1,148,0.0,120.0,120.0
0.08,6,10,1506,5,395,16.0,127.0,127.0,5,1111,19.0,843.0,843.0
0.005,17,2,230,1,68,0.0,40.0,40.0,1,162,0.0,134.0,134.0
0.117,6,10,1506,5,395,25.0,127.0,127.0,5,1111,24.0,843.0,843.0
0.006,6,10,1689,5,839,1.0,571.0,571.0,5,850,1.0,582.0,582.0
0.014,6,10,1990,5,911,3.0,643.0,643.0,5,1079,3.0,811.0,811.0
240.534,6,38,7685,19,1992,13362.0,517.0,166.0,19,5693,13362.0,1402.0,778.0
0.005,17,2,230,1,68,0.0,40.0,40.0,1,162,0.0,134.0,134.0
40.085,17,10,676,5,460,10018.0,104.0,64.0,5,216,10020.0,20.0,15.0
0.014,6,10,1989,5,910,3.0,642.0,642.0,5,1079,3.0,811.0,811.0
0.022,6,10,1631,5,848,5.0,580.0,580.0,5,783,5.0,515.0,515.0
0.004,17,4,284,2,120,0.0,32.0,32.0,2,164,0.0,60.0,54.0
15.081,17,16,9303,8,6912,2150.0,1350.0,836.0,8,2391,2150.0,1350.0,270.0
285.105,6,29,6509,16,1421,19006.0,517.0,290.0,13,5088,23758.0,2378.0,1104.0
240.088,6,31,9302,15,6932,17149.0,2055.0,684.0,16,2370,16005.0,580.0,191.0
0.004,6,10,1774,5,923,1.0,655.0,655.0,5,851,0.0,583.0,583.0
0.114,6,10,1506,5,395,26.0,127.0,127.0,5,1111,25.0,843.0,843.0
0.014,6,10,1972,5,910,3.0,642.0,642.0,5,1062,3.0,794.0,794.0
0.01,6,10,1762,5,911,2.0,643.0,643.0,5,851,2.0,583.0,583.0
0.005,6,10,1854,5,889,1.0,621.0,621.0,5,965,1.0,697.0,697.0
9.068,17,6,376,5,280,2267.0,28.0,28.0,1,96,0.0,68.0,68.0
0.022,6,10,1631,5,848,5.0,580.0,580.0,5,783,5.0,515.0,515.0
40.074,17,10,676,5,460,10015.0,104.0,64.0,5,216,10017.0,20.0,15.0
10.829,17,28,4422,14,1994,824.0,269.0,114.0,14,2428,824.0,587.0,145.0
0.011,6,10,1983,5,910,2.0,642.0,642.0,5,1073,2.0,805.0,805.0
0.009,6,10,1989,5,910,2.0,642.0,642.0,5,1079,2.0,811.0,811.0
0.012,17,2,152,1,76,0.0,48.0,48.0,1,76,0.0,48.0,48.0
0.01,6,10,1983,5,910,2.0,642.0,642.0,5,1073,2.0,805.0,805.0
0.004,6,10,1702,5,863,0.0,595.0,595.0,5,839,1.0,571.0,571.0
0.01,6,10,1762,5,911,2.0,643.0,643.0,5,851,2.0,583.0,583.0
0.105,6,10,1506,5,395,24.0,127.0,127.0,5,1111,23.0,843.0,843.0
0.04,17,4,284,2,120,0.0,32.0,32.0,2,164,37.0,60.0,54.0
0.005,6,10,2000,5,927,1.0,659.0,659.0,5,1073,1.0,805.0,805.0
240.013,6,9,787,5,488,60003.0,232.0,232.0,4,299,80003.0,83.0,83.0
0.006,6,10,1989,5,927,1.0,659.0,659.0,5,1062,1.0,794.0,794.0
177.112,17,88,12724,44,2956,4118.0,44.0,39.0,44,9768,4118.0,261.0,194.0
0.019,6,10,1990,5,911,4.0,643.0,643.0,5,1079,4.0,811.0,811.0
368.425,6,24,2405,17,919,23026.0,195.0,195.0,7,1486,3910.0,419.0,398.0
0.021,17,2,148,1,66,0.0,38.0,38.0,1,82,0.0,54.0,54.0
9.037,17,6,376,5,280,2259.0,28.0,28.0,1,96,0.0,68.0,68.0
0.006,6,10,1547,5,764,1.0,496.0,496.0,5,783,1.0,515.0,515.0
0.005,6,10,1854,5,889,1.0,621.0,621.0,5,965,1.0,697.0,697.0
0.005,6,10,1774,5,923,1.0,655.0,655.0,5,851,1.0,583.0,583.0
0.015,6,10,1990,5,911,3.0,643.0,643.0,5,1079,3.0,811.0,811.0
0.012,6,10,1972,5,910,3.0,642.0,642.0,5,1062,2.0,794.0,794.0
0.015,6,10,1631,5,848,3.0,580.0,580.0,5,783,3.0,515.0,515.0
0.081,6,10,1506,5,395,18.0,127.0,127.0,5,1111,19.0,843.0,843.0
0.018,6,10,1990,5,911,4.0,643.0,643.0,5,1079,4.0,811.0,811.0
0.043,17,2,152,1,76,0.0,48.0,48.0,1,76,0.0,48.0,48.0
0.089,6,10,1506,5,395,20.0,127.0,127.0,5,1111,20.0,843.0,843.0
0.016,17,2,198,1,91,0.0,63.0,63.0,1,107,0.0,79.0,79.0
0.105,6,10,1506,5,395,25.0,127.0,127.0,5,1111,25.0,843.0,843.0
0.005,6,14,3799,7,509,0.0,137.0,137.0,7,3290,0.0,1448.0,972.0
0.005,6,10,2006,5,927,1.0,659.0,659.0,5,1079,1.0,811.0,811.0
0.004,6,10,2000,5,927,1.0,659.0,659.0,5,1073,1.0,805.0,805.0
0.011,6,6,716,3,458,4.0,302.0,302.0,3,258,3.0,102.0,102.0
0.04,17,4,284,2,120,1.0,32.0,32.0,2,164,36.0,60.0,54.0
0.267,17,39,20223,22,17083,12.0,1350.0,748.0,17,3140,13.0,1350.0,156.0
0.04,17,2,152,1,76,0.0,48.0,48.0,1,76,0.0,48.0,48.0
0.006,6,10,1643,5,860,1.0,592.0,592.0,5,783,1.0,515.0,515.0
0.005,6,14,3736,7,446,0.0,74.0,74.0,7,3290,0.0,1448.0,972.0
0.069,6,10,1506,5,395,16.0,127.0,127.0,5,1111,14.0,843.0,843.0
40.061,17,10,676,5,460,10014.0,104.0,64.0,5,216,10014.0,20.0,15.0
0.021,6,10,1631,5,848,5.0,580.0,580.0,5,783,5.0,515.0,515.0
0.004,6,10,1989,5,927,1.0,659.0,659.0,5,1062,1.0,794.0,794.0
0.005,17,2,166,1,75,0.0,47.0,47.0,1,91,0.0,63.0,63.0
0.008,17,2,187,1,74,0.0,46.0,46.0,1,113,0.0,85.0,85.0
0.042,17,2,136,1,60,0.0,32.0,32.0,1,76,0.0,48.0,48.0
0.008,6,10,1762,5,911,1.0,643.0,643.0,5,851,2.0,583.0,583.0
0.001,17,2,180,1,66,0.0,38.0,38.0,1,114,0.0,86.0,86.0
0.015,6,10,1972,5,910,3.0,642.0,642.0,5,1062,3.0,794.0,794.0
0.005,6,10,2007,5,928,1.0,660.0,660.0,5,1079,1.0,811.0,811.0
0.003,17,2,148,1,60,0.0,32.0,32.0,1,88,0.0,60.0,60.0
0.105,6,10,1506,5,395,23.0,127.0,127.0,5,1111,17.0,843.0,843.0
0.1,6,10,1506,5,395,22.0,127.0,127.0,5,1111,22.0,843.0,843.0
0.07,6,10,1506,5,395,15.0,127.0,127.0,5,1111,14.0,843.0,843.0
0.004,17,4,284,2,120,1.0,32.0,32.0,2,164,0.0,60.0,54.0
0.006,6,10,1854,5,1169,1.0,901.0,901.0,5,685,1.0,417.0,417.0
0.105,6,10,1506,5,395,25.0,127.0,127.0,5,1111,22.0,843.0,843.0
0.115,6,10,1506,5,395,25.0,127.0,127.0,5,1111,24.0,843.0,843.0
0.004,17,2,166,1,75,0.0,47.0,47.0,1,91,0.0,63.0,63.0
0.208,6,16,2777,8,1395,29.0,533.0,323.0,8,1382,18.0,529.0,239.0
0.062,6,10,1506,5,395,14.0,127.0,127.0,5,1111,14.0,843.0,843.0
0.009,6,10,1972,5,910,2.0,642.0,642.0,5,1062,2.0,794.0,794.0
0.005,6,10,1854,5,889,1.0,621.0,621.0,5,965,1.0,697.0,697.0
0.003,17,2,136,1,60,0.0,32.0,32.0,1,76,0.0,48.0,48.0
0.094,6,10,1506,5,395,18.0,127.0,127.0,5,1111,20.0,843.0,843.0
0.005,6,10,1989,5,927,1.0,659.0,659.0,5,1062,1.0,794.0,794.0
0.004,6,10,1774,5,923,1.0,655.0,655.0,5,851,1.0,583.0,583.0
0.004,6,10,1989,5,927,1.0,659.0,659.0,5,1062,1.0,794.0,794.0
15.082,17,16,9894,9,7767,1881.0,1350.0,835.0,7,2127,2508.0,1350.0,275.0
26.283,6,57,29351,27,2195,1010.0,408.0,151.0,30,27156,906.0,2795.0,1178.0
0.087,6,10,1506,5,395,20.0,127.0,127.0,5,1111,20.0,843.0,843.0
0.011,6,10,1677,5,827,2.0,559.0,559.0,5,850,2.0,582.0,582.0
0.003,17,4,284,2,120,0.0,32.0,32.0,2,164,0.0,60.0,54.0
0.001,17,2,180,1,66,0.0,38.0,38.0,1,114,0.0,86.0,86.0
0.127,6,10,1506,5,395,28.0,127.0,127.0,5,1111,28.0,843.0,843.0
0.07,6,10,1506,5,395,15.0,127.0,127.0,5,1111,16.0,843.0,843.0
15.071,17,14,9190,8,6902,2149.0,1350.0,834.0,6,2288,3008.0,1350.0,353.0
0.006,6,10,1547,5,764,1.0,496.0,496.0,5,783,1.0,515.0,515.0
0.004,17,2,136,1,60,0.0,32.0,32.0,1,76,0.0,48.0,48.0
0.08,6,10,1506,5,395,16.0,127.0,127.0,5,1111,15.0,843.0,843.0
0.048,6,10,1762,5,911,11.0,643.0,643.0,5,851,11.0,583.0,583.0
0.013,6,10,1972,5,910,3.0,642.0,642.0,5,1062,3.0,794.0,794.0
0.011,6,10,1972,5,910,2.0,642.0,642.0,5,1062,2.0,794.0,794.0
0.014,6,10,1983,5,910,3.0,642.0,642.0,5,1073,3.0,805.0,805.0
0.019,6,10,1989,5,910,4.0,642.0,642.0,5,1079,4.0,811.0,811.0
0.005,6,10,1702,5,863,1.0,595.0,595.0,5,839,1.0,571.0,571.0
0.041,17,4,284,2,120,0.0,32.0,32.0,2,164,38.0,60.0,54.0
0.004,17,2,136,1,60,0.0,32.0,32.0,1,76,0.0,48.0,48.0
0.037,17,2,136,1,60,0.0,32.0,32.0,1,76,0.0,48.0,48.0
0.005,17,2,170,1,65,0.0,37.0,37.0,1,105,0.0,77.0,77.0
0.108,6,10,1506,5,395,24.0,127.0,127.0,5,1111,23.0,843.0,843.0
0.04,17,2,148,1,60,0.0,32.0,32.0,1,88,0.0,60.0,60.0
0.016,6,10,1972,5,910,4.0,642.0,642.0,5,1062,4.0,794.0,794.0
0.127,6,10,1506,5,395,28.0,127.0,127.0,5,1111,29.0,843.0,843.0
0.005,6,10,1689,5,839,1.0,571.0,571.0,5,850,1.0,582.0,582.0
0.004,6,10,1989,5,927,1.0,659.0,659.0,5,1062,1.0,794.0,794.0
0.04,17,4,284,2,120,0.0,32.0,32.0,2,164,31.0,60.0,54.0
11.096,17,28,4396,14,2311,845.0,586.0,137.0,14,2085,845.0,268.0,120.0
0.001,17,2,180,1,66,0.0,38.0,38.0,1,114,0.0,86.0,86.0
0.001,17,2,180,1,66,0.0,38.0,38.0,1,114,0.0,86.0,86.0
0.005,6,10,1547,5,764,1.0,496.0,496.0,5,783,1.0,515.0,515.0
0.101,6,10,1506,5,395,22.0,127.0,127.0,5,1111,20.0,843.0,843.0
0.008,6,10,2000,5,927,2.0,659.0,659.0,5,1073,2.0,805.0,805.0
365.795,6,22,2264,16,818,24386.0,146.0,146.0,6,1446,4638.0,419.0,398.0
240.014,6,9,787,5,488,60003.0,232.0,232.0,4,299,80003.0,83.0,83.0
0.005,6,10,2000,5,927,1.0,659.0,659.0,5,1073,1.0,805.0,805.0
0.005,17,2,140,1,62,0.0,34.0,34.0,1,78,0.0,50.0,50.0
11.039,17,28,4423,14,1994,840.0,269.0,114.0,14,2429,840.0,588.0,145.0
0.004,6,10,2006,5,927,1.0,659.0,659.0,5,1079,1.0,811.0,811.0
0.011,6,10,1989,5,910,2.0,642.0,642.0,5,1079,2.0,811.0,811.0
0.014,6,10,1989,5,910,3.0,642.0,642.0,5,1079,3.0,811.0,811.0
0.005,6,10,2006,5,927,1.0,659.0,659.0,5,1079,1.0,811.0,811.0
0.04,17,2,186,1,61,0.0,33.0,33.0,1,125,0.0,97.0,97.0
0.004,6,10,1989,5,927,1.0,659.0,659.0,5,1062,1.0,794.0,794.0
0.099,6,10,1506,5,395,22.0,127.0,127.0,5,1111,20.0,843.0,843.0
0.001,17,2,180,1,66,0.0,38.0,38.0,1,114,0.0,86.0,86.0
0.007,17,2,148,1,60,0.0,32.0,32.0,1,88,0.0,60.0,60.0
0.001,17,2,179,1,62,0.0,34.0,34.0,1,117,0.0,89.0,89.0
0.02,6,10,1990,5,911,4.0,643.0,643.0,5,1079,5.0,811.0,811.0
0.005,6,10,2006,5,927,1.0,659.0,659.0,5,1079,1.0,811.0,811.0
0.016,6,13,3735,7,497,2.0,125.0,125.0,6,3238,3.0,1470.0,1459.0
0.019,6,10,1983,5,910,4.0,642.0,642.0,5,1073,4.0,805.0,805.0
0.1,6,10,1506,5,395,21.0,127.0,127.0,5,1111,23.0,843.0,843.0
0.006,6,10,1989,5,927,1.0,659.0,659.0,5,1062,1.0,794.0,794.0
0.008,17,4,284,2,120,2.0,32.0,32.0,2,164,1.0,60.0,54.0
0.005,17,2,164,1,74,0.0,46.0,46.0,1,90,0.0,62.0,62.0
0.014,6,10,2007,5,928,3.0,660.0,660.0,5,1079,3.0,811.0,811.0
0.008,6,14,3787,7,497,1.0,125.0,125.0,7,3290,1.0,1448.0,972.0
0.268,17,45,26502,26,23454,10.0,1350.0,874.0,19,3048,11.0,1350.0,132.0
0.087,6,10,1506,5,395,17.0,127.0,127.0,5,1111,20.0,843.0,843.0
1799.988,6,256,40735,99,31047,18367.0,2790.0,318.0,157,9688,11422.0,148.0,48.0
0.038,17,2,148,1,60,0.0,32.0,32.0,1,88,0.0,60.0,60.0
0.122,6,10,1506,5,395,29.0,127.0,127.0,5,1111,25.0,843.0,843.0
0.006,6,10,1547,5,764,1.0,496.0,496.0,5,783,1.0,515.0,515.0
15.143,17,16,8674,8,6566,2155.0,1350.0,792.0,8,2108,2154.0,1350.0,235.0
0.006,6,10,1547,5,764,1.0,496.0,496.0,5,783,1.0,515.0,515.0
240.013,6,9,787,5,488,60003.0,232.0,232.0,4,299,80003.0,83.0,83.0
0.009,6,10,1990,5,911,2.0,643.0,643.0,5,1079,2.0,811.0,811.0
0.068,17,8,3613,4,1874,22.0,1350.0,440.0,4,1739,12.0,1350.0,406.0
0.01,6,10,1989,5,910,2.0,642.0,642.0,5,1079,2.0,811.0,811.0
0.009,6,10,1972,5,910,2.0,642.0,642.0,5,1062,2.0,794.0,794.0
0.006,6,10,1689,5,839,1.0,571.0,571.0,5,850,1.0,582.0,582.0
0.007,6,10,1689,5,839,1.0,571.0,571.0,5,850,1.0,582.0,582.0
0.128,6,10,1506,5,395,23.0,127.0,127.0,5,1111,30.0,843.0,843.0
0.02,6,10,1990,5,911,4.0,643.0,643.0,5,1079,5.0,811.0,811.0
0.156,6,10,1506,5,395,36.0,127.0,127.0,5,1111,34.0,843.0,843.0
0.097,6,10,1506,5,395,18.0,127.0,127.0,5,1111,23.0,843.0,843.0
0.009,17,2,225,1,65,0.0,37.0,37.0,1,160,0.0,132.0,132.0
1.086,6,32,13391,18,5892,63.0,2720.0,854.0,14,7499,70.0,2720.0,769.0
0.018,6,10,1972,5,910,4.0,642.0,642.0,5,1062,4.0,794.0,794.0
40.058,17,10,676,5,460,10013.0,104.0,64.0,5,216,10013.0,20.0,15.0
0.008,6,10,1990,5,911,2.0,643.0,643.0,5,1079,2.0,811.0,811.0
0.006,6,10,1702,5,863,1.0,595.0,595.0,5,839,1.0,571.0,571.0
0.005,6,10,1989,5,927,1.0,659.0,659.0,5,1062,1.0,794.0,794.0
0.014,6,10,1762,5,911,3.0,643.0,643.0,5,851,3.0,583.0,583.0
0.077,6,10,1506,5,395,18.0,127.0,127.0,5,1111,16.0,843.0,843.0
0.219,6,16,2782,8,1400,31.0,533.0,325.0,8,1382,19.0,529.0,239.0
40.058,17,10,676,5,460,10013.0,104.0,64.0,5,216,10013.0,20.0,15.0
0.004,6,10,2006,5,927,1.0,659.0,659.0,5,1079,1.0,811.0,811.0
9.037,17,6,376,5,280,2259.0,28.0,28.0,1,96,0.0,68.0,68.0
0.009,6,10,1631,5,848,2.0,580.0,580.0,5,783,2.0,515.0,515.0
0.068,17,8,3613,4,1874,22.0,1350.0,440.0,4,1739,11.0,1350.0,406.0
0.005,6,10,2007,5,928,1.0,660.0,660.0,5,1079,1.0,811.0,811.0
0.003,17,2,234,1,61,0.0,33.0,33.0,1,173,0.0,145.0,145.0
0.005,6,10,1689,5,839,1.0,571.0,571.0,5,850,1.0,582.0,582.0
0.006,17,2,166,1,75,0.0,47.0,47.0,1,91,0.0,63.0,63.0
0.089,6,10,1506,5,395,18.0,127.0,127.0,5,1111,20.0,843.0,843.0
0.01,6,10,1989,5,910,2.0,642.0,642.0,5,1079,2.0,811.0,811.0
0.014,6,10,1762,5,911,3.0,643.0,643.0,5,851,3.0,583.0,583.0
0.001,17,2,180,1,66,0.0,38.0,38.0,1,114,0.0,86.0,86.0
0.01,17,2,214,1,75,0.0,47.0,47.0,1,139,0.0,111.0,111.0
0.01,6,10,1972,5,910,2.0,642.0,642.0,5,1062,2.0,794.0,794.0
0.001,17,2,136,1,60,0.0,32.0,32.0,1,76,0.0,48.0,48.0
0.002,17,2,180,1,66,0.0,38.0,38.0,1,114,0.0,86.0,86.0
0.005,6,10,2006,5,927,1.0,659.0,659.0,5,1079,1.0,811.0,811.0
0.028,6,13,3735,7,497,4.0,125.0,125.0,6,3238,5.0,1470.0,1459.0
0.006,6,10,1989,5,927,1.0,659.0,659.0,5,1062,1.0,794.0,794.0
15.072,17,15,9238,8,6902,2149.0,1350.0,834.0,7,2336,2507.0,1350.0,305.0
0.175,17,4,352,2,130,133.0,37.0,37.0,2,222,103.0,89.0,83.0
0.006,17,2,302,1,65,0.0,37.0,37.0,1,237,0.0,209.0,209.0
0.071,6,10,1506,5,395,15.0,127.0,127.0,5,1111,16.0,843.0,843.0
0.008,6,10,1990,5,911,2.0,643.0,643.0,5,1079,2.0,811.0,811.0
0.079,6,10,1506,5,395,19.0,127.0,127.0,5,1111,17.0,843.0,843.0
0.006,6,10,2007,5,928,1.0,660.0,660.0,5,1079,1.0,811.0,811.0
0.006,6,10,1547,5,764,1.0,496.0,496.0,5,783,1.0,515.0,515.0
40.05,17,10,676,5,460,10011.0,104.0,64.0,5,216,10011.0,20.0,15.0
40.064,17,10,676,5,460,10013.0,104.0,64.0,5,216,10013.0,20.0,15.0
0.004,6,10,1989,5,927,1.0,659.0,659.0,5,1062,1.0,794.0,794.0
0.005,6,10,2006,5,927,1.0,659.0,659.0,5,1079,1.0,811.0,811.0
0.011,6,10,1989,5,910,2.0,642.0,642.0,5,1079,2.0,811.0,811.0
0.001,17,2,180,1,66,0.0,38.0,38.0,1,114,0.0,86.0,86.0
40.055,17,10,676,5,460,10012.0,104.0,64.0,5,216,10013.0,20.0,15.0
0.171,17,2,152,1,76,0.0,48.0,48.0,1,76,0.0,48.0,48.0
351.995,6,20,2210,6,1308,12003.0,494.0,494.0,14,902,27076.0,83.0,83.0
0.01,6,13,3735,7,497,1.0,125.0,125.0,6,3238,2.0,1470.0,1459.0
0.008,17,2,194,1,59,0.0,31.0,31.0,1,135,0.0,107.0,107.0
0.123,6,10,1506,5,395,25.0,127.0,127.0,5,1111,24.0,843.0,843.0
0.011,6,10,1972,5,910,2.0,642.0,642.0,5,1062,2.0,794.0,794.0
0.097,6,10,1506,5,395,22.0,127.0,127.0,5,1111,21.0,843.0,843.0
40.055,17,10,676,5,460,10013.0,104.0,64.0,5,216,10012.0,20.0,15.0
0.104,6,10,1506,5,395,23.0,127.0,127.0,5,1111,25.0,843.0,843.0
0.113,6,10,1506,5,395,22.0,127.0,127.0,5,1111,25.0,843.0,843.0
0.011,6,10,1989,5,910,2.0,642.0,642.0,5,1079,2.0,811.0,811.0
0.011,6,14,3787,7,497,1.0,125.0,125.0,7,3290,1.0,1448.0,972.0
0.004,6,10,2000,5,927,1.0,659.0,659.0,5,1073,1.0,805.0,805.0
1778.53,17,144,41760,72,22752,25049.0,288.0,288.0,72,19008,25049.0,236.0,236.0
0.013,6,10,1989,5,910,3.0,642.0,642.0,5,1079,3.0,811.0,811.0
0.005,6,10,2006,5,927,1.0,659.0,659.0,5,1079,1.0,811.0,811.0
0.088,6,10,1506,5,395,20.0,127.0,127.0,5,1111,18.0,843.0,843.0
0.005,6,10,1989,5,927,1.0,659.0,659.0,5,1062,1.0,794.0,794.0
0.105,6,10,1506,5,395,23.0,127.0,127.0,5,1111,20.0,843.0,843.0
0.026,6,10,1989,5,910,6.0,642.0,642.0,5,1079,6.0,811.0,811.0
0.005,6,10,1689,5,839,1.0,571.0,571.0,5,850,1.0,582.0,582.0
281.973,6,24,6115,10,1186,31330.0,267.0,156.0,14,4929,21681.0,1400.0,873.0
0.006,6,10,2006,5,927,1.0,659.0,659.0,5,1079,1.0,811.0,811.0
0.068,17,8,3613,4,1874,22.0,1350.0,440.0,4,1739,11.0,1350.0,406.0
0.097,6,10,1506,5,395,21.0,127.0,127.0,5,1111,21.0,843.0,843.0
0.006,6,10,1689,5,839,1.0,571.0,571.0,5,850,1.0,582.0,582.0
0.015,6,10,1989,5,910,3.0,642.0,642.0,5,1079,3.0,811.0,811.0
0.011,6,10,1989,5,910,2.0,642.0,642.0,5,1079,2.0,811.0,811.0
0.003,17,2,148,1,60,0.0,32.0,32.0,1,88,0.0,60.0,60.0
40.059,17,10,676,5,460,10013.0,104.0,64.0,5,216,10013.0,20.0,15.0
0.17,17,2,152,1,76,0.0,48.0,48.0,1,76,0.0,48.0,48.0
0.004,17,2,136,1,60,0.0,32.0,32.0,1,76,0.0,48.0,48.0
240.157,6,51,7226,24,3382,10441.0,588.0,211.0,27,3844,9236.0,580.0,187.0
0.005,6,10,1989,5,927,1.0,659.0,659.0,5,1062,1.0,794.0,794.0
0.004,6,10,1702,5,863,1.0,595.0,595.0,5,839,0.0,571.0,571.0
175.463,17,100,14554,50,3346,3580.0,44.0,38.0,50,11208,3580.0,261.0,196.0
0.017,6,10,1631,5,848,4.0,580.0,580.0,5,783,4.0,515.0,515.0
0.006,17,2,170,1,65,0.0,37.0,37.0,1,105,0.0,77.0,77.0
0.004,6,10,1989,5,927,1.0,659.0,659.0,5,1062,1.0,794.0,794.0
339.539,6,23,4663,13,2427,28294.0,676.0,348.0,10,2236,31058.0,824.0,427.0
0.0,17,2,154,1,69,0.0,41.0,41.0,1,85,0.0,57.0,57.0
0.008,6,10,1631,5,848,2.0,580.0,580.0,5,783,2.0,515.0,515.0
15.081,17,16,8490,8,6209,2150.0,1350.0,748.0,8,2281,2150.0,1350.0,257.0
40.064,17,10,676,5,460,10013.0,104.0,64.0,5,216,10013.0,20.0,15.0
0.078,6,10,1506,5,395,17.0,127.0,127.0,5,1111,15.0,843.0,843.0
0.095,6,10,1506,5,395,21.0,127.0,127.0,5,1111,19.0,843.0,843.0
356.641,6,21,1795,16,1030,23776.0,190.0,190.0,5,765,60003.0,464.0,248.0
0.016,6,13,3735,7,497,2.0,125.0,125.0,6,3238,3.0,1470.0,1459.0
0.004,6,10,1774,5,923,1.0,655.0,655.0,5,851,1.0,583.0,583.0
0.006,6,12,1698,6,863,1.0,327.0,271.0,6,835,1.0,515.0,515.0
0.019,6,10,1631,5,848,4.0,580.0,580.0,5,783,4.0,515.0,515.0
0.016,6,10,1990,5,911,3.0,643.0,643.0,5,1079,4.0,811.0,811.0
0.04,17,2,182,1,65,0.0,37.0,37.0,1,117,0.0,89.0,89.0
0.005,6,10,1774,5,923,1.0,655.0,655.0,5,851,1.0,583.0,583.0
40.072,17,10,676,5,460,10017.0,104.0,64.0,5,216,10017.0,20.0,15.0
0.005,6,10,2007,5,928,1.0,660.0,660.0,5,1079,1.0,811.0,811.0
0.01,6,10,1989,5,910,2.0,642.0,642.0,5,1079,2.0,811.0,811.0
0.005,6,10,1989,5,927,1.0,659.0,659.0,5,1062,1.0,794.0,794.0
0.108,6,10,1506,5,395,25.0,127.0,127.0,5,1111,26.0,843.0,843.0
0.001,17,2,180,1,66,0.0,38.0,38.0,1,114,0.0,86.0,86.0
0.005,6,10,1689,5,839,1.0,571.0,571.0,5,850,1.0,582.0,582.0
0.005,6,10,2007,5,928,1.0,660.0,660.0,5,1079,1.0,811.0,811.0
0.019,6,10,1989,5,910,4.0,642.0,642.0,5,1079,4.0,811.0,811.0
0.015,6,10,1989,5,910,3.0,642.0,642.0,5,1079,3.0,811.0,811.0
0.089,6,10,1506,5,395,18.0,127.0,127.0,5,1111,18.0,843.0,843.0
0.017,6,10,1762,5,911,4.0,643.0,643.0,5,851,4.0,583.0,583.0
176.036,17,72,10304,36,2410,5029.0,44.0,38.0,36,7894,5029.0,239.0,191.0
40.06,17,10,676,5,460,10012.0,104.0,64.0,5,216,10011.0,20.0,15.0
0.004,6,10,1774,5,923,1.0,655.0,655.0,5,851,1.0,583.0,583.0
0.039,17,2,184,1,61,0.0,33.0,33.0,1,123,0.0,95.0,95.0
0.01,6,10,1989,5,910,2.0,642.0,642.0,5,1079,2.0,811.0,811.0
175.321,17,78,11075,39,2601,4613.0,44.0,38.0,39,8474,4613.0,239.0,189.0
0.068,6,10,1506,5,395,14.0,127.0,127.0,5,1111,16.0,843.0,843.0
0.005,17,2,148,1,60,0.0,32.0,32.0,1,88,0.0,60.0,60.0
0.004,17,2,412,1,61,0.0,33.0,33.0,1,351,0.0,323.0,323.0
354.017,6,21,1795,16,1030,23601.0,190.0,190.0,5,765,60002.0,464.0,248.0
0.001,17,2,180,1,66,0.0,38.0,38.0,1,114,0.0,86.0,86.0
0.004,17,2,412,1,61,0.0,33.0,33.0,1,351,0.0,323.0,323.0
0.004,17,2,180,1,66,0.0,38.0,38.0,1,114,0.0,86.0,86.0
0.105,6,10,1506,5,395,24.0,127.0,127.0,5,1111,22.0,843.0,843.0
0.005,6,14,3742,7,452,0.0,80.0,80.0,7,3290,0.0,1448.0,972.0
0.01,6,10,1990,5,911,2.0,643.0,643.0,5,1079,2.0,811.0,811.0
0.053,17,2,152,1,76,0.0,48.0,48.0,1,76,0.0,48.0,48.0
1796.042,6,552,189427,273,162914,6603.0,2883.0,935.0,279,26513,6460.0,383.0,118.0
0.005,6,10,2000,5,927,1.0,659.0,659.0,5,1073,1.0,805.0,805.0
0.012,6,10,1990,5,911,3.0,643.0,643.0,5,1079,2.0,811.0,811.0
0.072,17,2,170,1,65,0.0,37.0,37.0,1,105,0.0,77.0,77.0
0.004,6,10,1702,5,863,1.0,595.0,595.0,5,839,1.0,571.0,571.0
0.009,6,10,1972,5,910,2.0,642.0,642.0,5,1062,2.0,794.0,794.0
240.092,6,31,9467,15,6919,17149.0,2044.0,682.0,16,2548,16006.0,580.0,213.0
0.005,6,10,2006,5,927,1.0,659.0,659.0,5,1079,1.0,811.0,811.0
0.005,6,10,2006,5,927,1.0,659.0,659.0,5,1079,1.0,811.0,811.0
369.87,6,22,2313,16,867,24658.0,195.0,195.0,6,1446,4639.0,419.0,398.0
0.004,6,10,1989,5,927,1.0,659.0,659.0,5,1062,1.0,794.0,794.0
0.006,6,10,1547,5,764,1.0,496.0,496.0,5,783,1.0,515.0,515.0
0.089,6,10,1506,5,395,19.0,127.0,127.0,5,1111,18.0,843.0,843.0
0.004,17,2,164,1,74,0.0,46.0,46.0,1,90,0.0,62.0,62.0
0.141,6,10,1506,5,395,22.0,127.0,127.0,5,1111,33.0,843.0,843.0
10.874,17,28,4423,14,1995,828.0,270.0,114.0,14,2428,827.0,587.0,145.0
1787.044,6,150,19350,90,13740,20079.0,302.0,302.0,60,5610,30288.0,83.0,83.0
0.011,6,10,1990,5,911,2.0,643.0,643.0,5,1079,2.0,811.0,811.0
0.003,17,2,152,1,76,0.0,48.0,48.0,1,76,0.0,48.0,48.0
0.008,6,10,1972,5,910,2.0,642.0,642.0,5,1062,2.0,794.0,794.0
0.02,6,10,1990,5,911,5.0,643.0,643.0,5,1079,4.0,811.0,811.0
0.039,17,2,148,1,60,0.0,32.0,32.0,1,88,0.0,60.0,60.0
0.005,6,10,1774,5,923,1.0,655.0,655.0,5,851,1.0,583.0,583.0
0.024,6,10,1989,5,910,6.0,642.0,642.0,5,1079,6.0,811.0,811.0
0.172,6,3,453,2,321,172.0,241.0,241.0,1,132,0.0,92.0,92.0
0.003,6,10,1702,5,863,0.0,595.0,595.0,5,839,0.0,571.0,571.0
66.428,6,22,10162,12,3995,6038.0,1601.0,840.0,10,6167,7362.0,2111.0,939.0
0.001,17,2,142,1,63,0.0,35.0,35.0,1,79,0.0,51.0,51.0
0.008,6,10,1762,5,911,1.0,643.0,643.0,5,851,1.0,583.0,583.0
0.008,6,10,1990,5,911,2.0,643.0,643.0,5,1079,1.0,811.0,811.0
0.13,6,10,1506,5,395,31.0,127.0,127.0,5,1111,28.0,843.0,843.0
0.01,6,13,3735,7,497,1.0,125.0,125.0,6,3238,1.0,1470.0,1459.0
0.003,17,2,136,1,60,0.0,32.0,32.0,1,76,0.0,48.0,48.0
0.101,6,10,1506,5,395,21.0,127.0,127.0,5,1111,22.0,843.0,843.0
0.018,6,10,1990,5,911,4.0,643.0,643.0,5,1079,4.0,811.0,811.0
0.0,17,2,140,1,62,0.0,34.0,34.0,1,78,0.0,50.0,50.0
0.009,6,10,1631,5,848,2.0,580.0,580.0,5,783,2.0,515.0,515.0
0.019,6,10,1989,5,910,4.0,642.0,642.0,5,1079,4.0,811.0,811.0
0.04,17,2,234,1,61,0.0,33.0,33.0,1,173,0.0,145.0,145.0
0.011,6,10,1631,5,848,2.0,580.0,580.0,5,783,2.0,515.0,515.0
0.005,6,10,1774,5,923,1.0,655.0,655.0,5,851,1.0,583.0,583.0
0.088,6,10,1506,5,395,20.0,127.0,127.0,5,1111,21.0,843.0,843.0
10.925,17,28,4418,14,1994,832.0,269.0,114.0,14,2424,832.0,587.0,145.0
300.292,6,16,2170,9,684,37516.0,146.0,146.0,7,1486,50021.0,419.0,398.0
0.005,6,13,3747,7,509,0.0,137.0,137.0,6,3238,0.0,1470.0,1459.0
0.22,6,16,2777,8,1395,31.0,533.0,323.0,8,1382,19.0,529.0,239.0
0.009,17,2,214,1,75,0.0,47.0,47.0,1,139,0.0,111.0,111.0
0.003,17,2,152,1,76,0.0,48.0,48.0,1,76,0.0,48.0,48.0
0.014,6,10,1972,5,910,3.0,642.0,642.0,5,1062,3.0,794.0,794.0
0.005,17,2,170,1,65,0.0,37.0,37.0,1,105,0.0,77.0,77.0
0.008,6,10,1989,5,910,2.0,642.0,642.0,5,1079,1.0,811.0,811.0
300.314,6,17,2222,10,736,33349.0,146.0,146.0,7,1486,50024.0,419.0,398.0
0.003,17,2,160,1,72,0.0,44.0,44.0,1,88,0.0,60.0,60.0
53.342,6,37,10002,19,4484,498.0,1360.0,738.0,18,5518,3127.0,2667.0,435.0
0.009,6,10,1989,5,910,2.0,642.0,642.0,5,1079,2.0,811.0,811.0
0.006,6,10,1547,5,764,1.0,496.0,496.0,5,783,1.0,515.0,515.0
300.443,6,19,3081,11,1647,30044.0,517.0,266.0,8,1434,34341.0,821.0,336.0
0.013,17,2,152,1,56,0.0,28.0,28.0,1,96,0.0,68.0,68.0
0.005,6,10,2006,5,927,1.0,659.0,659.0,5,1079,1.0,811.0,811.0
0.089,6,10,1506,5,395,17.0,127.0,127.0,5,1111,20.0,843.0,843.0
0.011,6,10,1972,5,910,2.0,642.0,642.0,5,1062,2.0,794.0,794.0
0.001,17,2,180,1,66,0.0,38.0,38.0,1,114,0.0,86.0,86.0
0.001,17,2,136,1,60,0.0,32.0,32.0,1,76,0.0,48.0,48.0
0.005,17,2,170,1,65,0.0,37.0,37.0,1,105,0.0,77.0,77.0
0.001,17,2,180,1,66,0.0,38.0,38.0,1,114,0.0,86.0,86.0
0.015,6,10,1983,5,910,3.0,642.0,642.0,5,1073,3.0,805.0,805.0
354.041,6,19,1691,15,978,25288.0,190.0,190.0,4,713,80002.0,497.0,497.0
1771.594,17,120,11460,60,5460,30026.0,63.0,63.0,60,6000,30026.0,72.0,72.0
0.005,6,10,2006,5,927,1.0,659.0,659.0,5,1079,1.0,811.0,811.0
0.005,6,10,2000,5,927,1.0,659.0,659.0,5,1073,1.0,805.0,805.0
169.258,17,78,11067,39,2593,4453.0,44.0,38.0,39,8474,4453.0,239.0,189.0
328.502,17,20,1124,10,716,36486.0,48.0,43.0,10,408,36485.0,20.0,12.0
0.005,6,10,1689,5,839,1.0,571.0,571.0,5,850,1.0,582.0,582.0
0.01,6,10,1989,5,910,2.0,642.0,642.0,5,1079,2.0,811.0,811.0
0.004,17,2,136,1,60,0.0,32.0,32.0,1,76,0.0,48.0,48.0
0.005,6,13,3747,7,509,0.0,137.0,137.0,6,3238,1.0,1470.0,1459.0
0.013,6,10,1972,5,910,3.0,642.0,642.0,5,1062,3.0,794.0,794.0
0.004,6,10,1702,5,863,1.0,595.0,595.0,5,839,1.0,571.0,571.0
0.084,6,10,1506,5,395,19.0,127.0,127.0,5,1111,19.0,843.0,843.0
40.098,17,10,676,5,460,10023.0,104.0,64.0,5,216,10023.0,20.0,15.0
0.013,6,10,1989,5,910,3.0,642.0,642.0,5,1079,3.0,811.0,811.0
0.021,6,10,1989,5,910,5.0,642.0,642.0,5,1079,5.0,811.0,811.0
240.025,6,9,787,5,488,60006.0,232.0,232.0,4,299,80007.0,83.0,83.0
0.005,6,13,3747,7,509,0.0,137.0,137.0,6,3238,0.0,1470.0,1459.0
0.004,6,10,1774,5,923,1.0,655.0,655.0,5,851,1.0,583.0,583.0
0.014,6,10,1972,5,910,3.0,642.0,642.0,5,1062,3.0,794.0,794.0
0.005,17,2,214,1,75,0.0,47.0,47.0,1,139,0.0,111.0,111.0
1730.409,6,45,2790,30,1725,59669.0,35.0,35.0,15,1065,123595.0,31.0,31.0
0.005,6,10,2007,5,928,1.0,660.0,660.0,5,1079,1.0,811.0,811.0
0.0,17,2,180,1,66,0.0,38.0,38.0,1,114,0.0,86.0,86.0
0.012,6,10,1677,5,827,3.0,559.0,559.0,5,850,3.0,582.0,582.0
11.145,17,28,4417,14,1994,844.0,269.0,114.0,14,2423,844.0,586.0,145.0
0.001,17,2,136,1,60,0.0,32.0,32.0,1,76,0.0,48.0,48.0
0.009,6,10,1990,5,911,2.0,643.0,643.0,5,1079,2.0,811.0,811.0
0.107,6,10,1506,5,395,20.0,127.0,127.0,5,1111,24.0,843.0,843.0
0.005,6,10,2000,5,927,1.0,659.0,659.0,5,1073,1.0,805.0,805.0
0.005,6,10,1989,5,927,1.0,659.0,659.0,5,1062,1.0,794.0,794.0
0.011,6,13,3735,7,497,1.0,125.0,125.0,6,3238,2.0,1470.0,1459.0
0.009,6,13,3735,7,497,1.0,125.0,125.0,6,3238,1.0,1470.0,1459.0
0.007,6,10,1689,5,839,1.0,571.0,571.0,5,850,1.0,582.0,582.0
0.367,17,49,25099,26,21271,14.0,1350.0,790.0,23,3828,13.0,1350.0,138.0
308.556,17,20,1124,10,716,34270.0,48.0,43.0,10,408,34270.0,20.0,12.0
300.861,6,38,9637,21,4159,15043.0,1360.0,547.0,17,5478,543.0,2667.0,435.0
0.096,6,10,1506,5,395,21.0,127.0,127.0,5,1111,22.0,843.0,843.0
0.081,6,10,1506,5,395,18.0,127.0,127.0,5,1111,19.0,843.0,843.0
40.065,17,10,676,5,460,10013.0,104.0,64.0,5,216,10015.0,20.0,15.0
0.004,6,10,2006,5,927,1.0,659.0,659.0,5,1079,1.0,811.0,811.0
0.004,17,2,136,1,60,0.0,32.0,32.0,1,76,0.0,48.0,48.0
0.008,6,10,1990,5,911,2.0,643.0,643.0,5,1079,1.0,811.0,811.0
15.082,17,15,8289,8,6156,2150.0,1350.0,741.0,7,2133,2508.0,1350.0,276.0
0.117,6,10,1506,5,395,27.0,127.0,127.0,5,1111,24.0,843.0,843.0
0.01,6,10,1989,5,910,2.0,642.0,642.0,5,1079,2.0,811.0,811.0
0.095,6,10,1506,5,395,21.0,127.0,127.0,5,1111,22.0,843.0,843.0
0.107,6,10,1506,5,395,23.0,127.0,127.0,5,1111,25.0,843.0,843.0
0.005,6,10,2006,5,927,1.0,659.0,659.0,5,1079,1.0,811.0,811.0
40.057,17,10,676,5,460,10012.0,104.0,64.0,5,216,10013.0,20.0,15.0
0.004,6,10,1702,5,863,0.0,595.0,595.0,5,839,1.0,571.0,571.0
0.013,17,2,186,1,61,0.0,33.0,33.0,1,125,0.0,97.0,97.0
0.008,17,2,136,1,60,0.0,32.0,32.0,1,76,0.0,48.0,48.0
0.11,6,10,1506,5,395,26.0,127.0,127.0,5,1111,24.0,843.0,843.0
75.549,6,76,68643,40,43367,1937.0,2804.0,1794.0,36,25276,2153.0,2845.0,1231.0
0.124,17,2,80,1,32,0.0,4.0,4.0,1,48,0.0,20.0,20.0
0.014,6,10,1972,5,910,3.0,642.0,642.0,5,1062,3.0,794.0,794.0
0.005,6,10,2000,5,927,1.0,659.0,659.0,5,1073,1.0,805.0,805.0
0.071,6,10,1506,5,395,15.0,127.0,127.0,5,1111,17.0,843.0,843.0
40.064,17,10,676,5,460,10014.0,104.0,64.0,5,216,10015.0,20.0,15.0
40.061,17,10,676,5,460,10014.0,104.0,64.0,5,216,10014.0,20.0,15.0
0.005,6,10,2006,5,927,1.0,659.0,659.0,5,1079,1.0,811.0,811.0
0.098,6,10,1506,5,395,22.0,127.0,127.0,5,1111,16.0,843.0,843.0
0.005,6,10,2006,5,927,1.0,659.0,659.0,5,1079,1.0,811.0,811.0
0.126,6,14,4389,8,923,18.0,238.0,166.0,6,3466,16.0,1402.0,786.0
0.004,6,10,2006,5,927,1.0,659.0,659.0,5,1079,1.0,811.0,811.0
40.06,17,10,676,5,460,10013.0,104.0,64.0,5,216,10014.0,20.0,15.0
0.128,6,10,1506,5,395,29.0,127.0,127.0,5,1111,29.0,843.0,843.0
10.855,17,26,4098,13,1846,895.0,269.0,114.0,13,2252,895.0,587.0,145.0
0.105,6,10,1506,5,395,21.0,127.0,127.0,5,1111,23.0,843.0,843.0
0.008,17,2,194,1,59,0.0,31.0,31.0,1,135,0.0,107.0,107.0
0.005,17,2,170,1,65,0.0,37.0,37.0,1,105,0.0,77.0,77.0
0.005,6,10,2006,5,927,1.0,659.0,659.0,5,1079,1.0,811.0,811.0
0.061,6,10,1983,5,910,15.0,642.0,642.0,5,1073,15.0,805.0,805.0
0.006,17,2,194,1,59,0.0,31.0,31.0,1,135,0.0,107.0,107.0
1755.906,6,105,6270,60,3525,29760.0,27.0,27.0,45,2745,39906.0,27.0,27.0
0.011,6,10,1990,5,911,2.0,643.0,643.0,5,1079,2.0,811.0,811.0
0.006,6,10,2006,5,927,1.0,659.0,659.0,5,1079,1.0,811.0,811.0
240.099,6,16,4481,9,963,30012.0,238.0,166.0,7,3518,40016.0,1402.0,786.0
0.005,17,2,214,1,75,0.0,47.0,47.0,1,139,0.0,111.0,111.0
0.005,6,10,2006,5,927,1.0,659.0,659.0,5,1079,1.0,811.0,811.0
0.005,6,10,2007,5,928,1.0,660.0,660.0,5,1079,1.0,811.0,811.0
0.009,6,13,3735,7,497,1.0,125.0,125.0,6,3238,1.0,1470.0,1459.0
0.005,6,10,2006,5,927,1.0,659.0,659.0,5,1079,1.0,811.0,811.0
0.015,6,10,1762,5,911,3.0,643.0,643.0,5,851,3.0,583.0,583.0
0.072,6,10,1506,5,395,14.0,127.0,127.0,5,1111,16.0,843.0,843.0
0.092,6,10,1506,5,395,17.0,127.0,127.0,5,1111,22.0,843.0,843.0
300.115,6,11,1270,6,609,60016.0,289.0,289.0,5,661,75020.0,393.0,393.0
0.005,6,10,1689,5,839,1.0,571.0,571.0,5,850,1.0,582.0,582.0
0.018,6,10,1990,5,911,4.0,643.0,643.0,5,1079,4.0,811.0,811.0
0.005,6,10,2006,5,927,1.0,659.0,659.0,5,1079,1.0,811.0,811.0
0.007,17,2,132,1,58,0.0,30.0,30.0,1,74,0.0,46.0,46.0
0.005,17,2,169,1,62,0.0,34.0,34.0,1,107,0.0,79.0,79.0
240.088,6,16,4481,9,963,30011.0,238.0,166.0,7,3518,40014.0,1402.0,786.0
0.005,6,10,2000,5,927,1.0,659.0,659.0,5,1073,1.0,805.0,805.0
0.01,6,10,1989,5,910,2.0,642.0,642.0,5,1079,2.0,811.0,811.0
40.08,17,10,676,5,460,10017.0,104.0,64.0,5,216,10019.0,20.0,15.0
1795.07,6,556,188975,282,163001,6388.0,2883.0,909.0,274,25974,6575.0,383.0,118.0
0.075,6,10,1506,5,395,17.0,127.0,127.0,5,1111,15.0,843.0,843.0
0.014,6,10,1972,5,910,3.0,642.0,642.0,5,1062,3.0,794.0,794.0
0.013,6,10,1631,5,848,3.0,580.0,580.0,5,783,3.0,515.0,515.0
0.008,6,6,716,3,458,2.0,302.0,302.0,3,258,3.0,102.0,102.0
0.012,6,10,1990,5,911,2.0,643.0,643.0,5,1079,2.0,811.0,811.0
39.995,17,10,676,5,460,9997.0,104.0,64.0,5,216,9998.0,20.0,15.0
0.001,17,2,180,1,66,0.0,38.0,38.0,1,114,0.0,86.0,86.0
0.001,17,2,180,1,66,0.0,38.0,38.0,1,114,0.0,86.0,86.0
0.003,17,2,136,1,60,0.0,32.0,32.0,1,76,0.0,48.0,48.0
0.007,6,10,2006,5,927,1.0,659.0,659.0,5,1079,1.0,811.0,811.0
0.006,6,10,1547,5,764,1.0,496.0,496.0,5,783,1.0,515.0,515.0
0.005,17,2,214,1,75,0.0,47.0,47.0,1,139,0.0,111.0,111.0
40.07,17,10,676,5,460,10015.0,104.0,64.0,5,216,10016.0,20.0,15.0
0.126,17,2,136,1,60,0.0,32.0,32.0,1,76,0.0,48.0,48.0
0.838,6,12,2996,7,549,139.0,177.0,177.0,5,2447,155.0,1402.0,1089.0
0.039,17,2,156,1,64,0.0,36.0,36.0,1,92,0.0,64.0,64.0
0.009,6,12,1926,6,1189,1.0,659.0,434.0,6,737,1.0,417.0,417.0
0.011,6,10,1972,5,910,2.0,642.0,642.0,5,1062,2.0,794.0,794.0
0.038,17,4,284,2,120,0.0,32.0,32.0,2,164,35.0,60.0,54.0
0.005,6,10,1689,5,839,1.0,571.0,571.0,5,850,1.0,582.0,582.0
0.014,6,10,1989,5,910,3.0,642.0,642.0,5,1079,3.0,811.0,811.0
353.518,6,20,2210,6,1308,12003.0,494.0,494.0,14,902,27193.0,83.0,83.0
0.07,17,8,3613,4,1874,23.0,1350.0,440.0,4,1739,12.0,1350.0,406.0
0.006,6,10,1547,5,764,1.0,496.0,496.0,5,783,1.0,515.0,515.0
0.093,6,10,1506,5,395,17.0,127.0,127.0,5,1111,21.0,843.0,843.0
0.006,17,2,170,1,65,0.0,37.0,37.0,1,105,0.0,77.0,77.0
0.005,6,10,1547,5,764,1.0,496.0,496.0,5,783,1.0,515.0,515.0
0.005,17,2,170,1,65,0.0,37.0,37.0,1,105,0.0,77.0,77.0
0.079,6,10,1506,5,395,19.0,127.0,127.0,5,1111,15.0,843.0,843.0
0.038,17,4,284,2,120,0.0,32.0,32.0,2,164,35.0,60.0,54.0
40.055,17,10,676,5,460,10012.0,104.0,64.0,5,216,10013.0,20.0,15.0
0.01,6,10,1989,5,910,2.0,642.0,642.0,5,1079,2.0,811.0,811.0
0.004,17,2,148,1,60,0.0,32.0,32.0,1,88,0.0,60.0,60.0
352.243,6,20,2210,6,1308,12003.0,494.0,494.0,14,902,27095.0,83.0,83.0
0.006,6,10,2007,5,928,1.0,660.0,660.0,5,1079,1.0,811.0,811.0
0.006,6,10,1689,5,839,1.0,571.0,571.0,5,850,1.0,582.0,582.0
0.013,6,10,1990,5,911,3.0,643.0,643.0,5,1079,3.0,811.0,811.0
0.012,6,10,1990,5,911,3.0,643.0,643.0,5,1079,2.0,811.0,811.0
0.013,6,10,1989,5,910,3.0,642.0,642.0,5,1079,3.0,811.0,811.0
318.397,6,22,7684,8,1984,31.0,1496.0,780.0,14,5700,24491.0,2644.0,551.0
0.004,6,13,3747,7,509,0.0,137.0,137.0,6,3238,0.0,1470.0,1459.0
0.009,6,10,1989,5,910,2.0,642.0,642.0,5,1079,2.0,811.0,811.0
167.089,17,90,12749,45,3005,3797.0,44.0,38.0,45,9744,3797.0,239.0,188.0
0.006,6,10,2007,5,928,1.0,660.0,660.0,5,1079,1.0,811.0,811.0
0.005,6,10,1989,5,927,1.0,659.0,659.0,5,1062,1.0,794.0,794.0
0.073,6,10,1506,5,395,14.0,127.0,127.0,5,1111,14.0,843.0,843.0
0.005,6,10,2007,5,928,1.0,660.0,660.0,5,1079,1.0,811.0,811.0
0.005,6,10,1989,5,927,1.0,659.0,659.0,5,1062,1.0,794.0,794.0
0.086,6,10,1506,5,395,19.0,127.0,127.0,5,1111,19.0,843.0,843.0
290.685,6,380,347753,193,21596,1513.0,2736.0,888.0,187,326157,1562.0,3320.0,1839.0
0.006,6,10,1689,5,839,1.0,571.0,571.0,5,850,1.0,582.0,582.0
0.019,6,10,1972,5,910,4.0,642.0,642.0,5,1062,4.0,794.0,794.0
0.067,17,8,3613,4,1874,22.0,1350.0,440.0,4,1739,11.0,1350.0,406.0
0.011,6,10,1983,5,910,2.0,642.0,642.0,5,1073,2.0,805.0,805.0
0.015,6,13,3735,7,497,2.0,125.0,125.0,6,3238,3.0,1470.0,1459.0
0.005,6,10,2000,5,927,1.0,659.0,659.0,5,1073,1.0,805.0,805.0
0.005,6,10,1854,5,889,1.0,621.0,621.0,5,965,1.0,697.0,697.0
0.005,6,10,1689,5,839,1.0,571.0,571.0,5,850,1.0,582.0,582.0
0.005,6,10,2006,5,927,1.0,659.0,659.0,5,1079,1.0,811.0,811.0
0.007,6,10,1689,5,839,1.0,571.0,571.0,5,850,1.0,582.0,582.0
0.005,6,10,1774,5,923,1.0,655.0,655.0,5,851,1.0,583.0,583.0
0.019,6,10,1972,5,910,4.0,642.0,642.0,5,1062,4.0,794.0,794.0
0.024,6,10,1972,5,910,6.0,642.0,642.0,5,1062,6.0,794.0,794.0
0.005,6,10,1774,5,923,1.0,655.0,655.0,5,851,1.0,583.0,583.0
40.065,17,10,676,5,460,10013.0,104.0,64.0,5,216,10015.0,20.0,15.0
0.006,6,10,1547,5,764,1.0,496.0,496.0,5,783,1.0,515.0,515.0
0.073,6,10,1506,5,395,16.0,127.0,127.0,5,1111,16.0,843.0,843.0
0.004,17,2,136,1,60,0.0,32.0,32.0,1,76,0.0,48.0,48.0
0.009,6,10,1972,5,910,2.0,642.0,642.0,5,1062,2.0,794.0,794.0
0.006,17,2,230,1,68,0.0,40.0,40.0,1,162,0.0,134.0,134.0
0.099,6,10,1506,5,395,21.0,127.0,127.0,5,1111,23.0,843.0,843.0
0.009,6,10,1972,5,910,2.0,642.0,642.0,5,1062,2.0,794.0,794.0
0.051,6,10,1990,5,911,12.0,643.0,643.0,5,1079,12.0,811.0,811.0
288.787,6,376,348400,190,22081,1527.0,2736.0,870.0,186,326319,1560.0,2804.0,1851.0
0.006,6,10,1547,5,764,1.0,496.0,496.0,5,783,1.0,515.0,515.0
0.005,6,10,2000,5,927,1.0,659.0,659.0,5,1073,1.0,805.0,805.0
0.004,6,10,2006,5,927,1.0,659.0,659.0,5,1079,1.0,811.0,811.0
0.013,17,2,152,1,56,0.0,28.0,28.0,1,96,0.0,68.0,68.0
1.3,6,21,3565,12,2284,118.0,577.0,327.0,9,1281,161.0,343.0,264.0
0.011,6,10,1972,5,910,2.0,642.0,642.0,5,1062,2.0,794.0,794.0
0.077,6,10,1506,5,395,16.0,127.0,127.0,5,1111,16.0,843.0,843.0
0.004,6,10,1774,5,923,1.0,655.0,655.0,5,851,1.0,583.0,583.0
0.017,6,10,1972,5,910,4.0,642.0,642.0,5,1062,4.0,794.0,794.0
0.014,6,10,1990,5,911,3.0,643.0,643.0,5,1079,3.0,811.0,811.0
0.006,17,2,179,1,71,0.0,43.0,43.0,1,108,0.0,80.0,80.0
0.01,6,10,1762,5,911,2.0,643.0,643.0,5,851,2.0,583.0,583.0
0.014,6,10,1990,5,911,3.0,643.0,643.0,5,1079,3.0,811.0,811.0
0.006,6,10,2000,5,927,1.0,659.0,659.0,5,1073,1.0,805.0,805.0
0.006,6,10,1643,5,860,1.0,592.0,592.0,5,783,1.0,515.0,515.0
0.014,6,10,1990,5,911,3.0,643.0,643.0,5,1079,3.0,811.0,811.0
0.005,6,10,2007,5,928,1.0,660.0,660.0,5,1079,1.0,811.0,811.0
0.004,6,10,1779,5,928,1.0,660.0,660.0,5,851,1.0,583.0,583.0
0.005,17,2,214,1,75,0.0,47.0,47.0,1,139,0.0,111.0,111.0
0.005,6,10,2000,5,927,1.0,659.0,659.0,5,1073,1.0,805.0,805.0
0.098,6,10,1506,5,395,21.0,127.0,127.0,5,1111,23.0,843.0,843.0
0.015,6,10,1972,5,910,3.0,642.0,642.0,5,1062,3.0,794.0,794.0
0.004,6,10,2006,5,927,1.0,659.0,659.0,5,1079,1.0,811.0,811.0
411.995,6,29,4409,12,3102,10911.0,494.0,494.0,17,1307,25749.0,83.0,83.0
40.068,17,10,676,5,460,10015.0,104.0,64.0,5,216,10016.0,20.0,15.0
0.017,6,10,1989,5,910,4.0,642.0,642.0,5,1079,4.0,811.0,811.0
0.005,17,2,144,1,64,0.0,36.0,36.0,1,80,0.0,52.0,52.0
0.014,6,10,1989,5,910,3.0,642.0,642.0,5,1079,3.0,811.0,811.0
367.165,6,22,2313,16,867,24477.0,195.0,195.0,6,1446,4635.0,419.0,398.0
0.005,17,2,294,1,64,0.0,36.0,36.0,1,230,0.0,202.0,202.0
0.017,6,10,1989,5,910,4.0,642.0,642.0,5,1079,4.0,811.0,811.0
0.073,6,10,1506,5,395,16.0,127.0,127.0,5,1111,16.0,843.0,843.0
0.005,17,2,294,1,64,0.0,36.0,36.0,1,230,0.0,202.0,202.0
0.006,6,10,1547,5,764,1.0,496.0,496.0,5,783,1.0,515.0,515.0
0.005,6,10,2000,5,927,1.0,659.0,659.0,5,1073,1.0,805.0,805.0
15.368,17,39,20282,22,17086,730.0,1350.0,748.0,17,3196,958.0,1350.0,160.0
0.072,17,8,3613,4,1874,24.0,1350.0,440.0,4,1739,12.0,1350.0,406.0
290.114,6,328,345132,119,17741,2458.0,2736.0,889.0,209,327391,1394.0,4206.0,1623.0
0.015,6,10,1989,5,910,3.0,642.0,642.0,5,1079,3.0,811.0,811.0
0.015,6,10,1990,5,911,3.0,643.0,643.0,5,1079,3.0,811.0,811.0
0.01,6,10,1631,5,848,2.0,580.0,580.0,5,783,2.0,515.0,515.0
0.008,6,10,1972,5,910,2.0,642.0,642.0,5,1062,1.0,794.0,794.0
0.007,17,2,194,1,59,0.0,31.0,31.0,1,135,0.0,107.0,107.0
0.085,6,10,1506,5,395,19.0,127.0,127.0,5,1111,20.0,843.0,843.0
0.006,6,10,1547,5,764,1.0,496.0,496.0,5,783,1.0,515.0,515.0
0.005,17,2,170,1,65,0.0,37.0,37.0,1,105,0.0,77.0,77.0
0.158,6,10,1506,5,395,36.0,127.0,127.0,5,1111,35.0,843.0,843.0
0.007,6,10,1989,5,927,1.0,659.0,659.0,5,1062,1.0,794.0,794.0
40.05,17,10,676,5,460,10011.0,104.0,64.0,5,216,10011.0,20.0,15.0
0.018,6,10,1989,5,910,4.0,642.0,642.0,5,1079,4.0,811.0,811.0
0.006,6,10,1989,5,927,1.0,659.0,659.0,5,1062,1.0,794.0,794.0
0.006,6,10,1689,5,839,1.0,571.0,571.0,5,850,1.0,582.0,582.0
0.012,6,10,1972,5,910,3.0,642.0,642.0,5,1062,2.0,794.0,794.0
0.004,6,10,1702,5,863,1.0,595.0,595.0,5,839,1.0,571.0,571.0
0.009,6,10,1972,5,910,2.0,642.0,642.0,5,1062,2.0,794.0,794.0
0.109,6,10,1506,5,395,26.0,127.0,127.0,5,1111,24.0,843.0,843.0
0.114,6,10,1506,5,395,24.0,127.0,127.0,5,1111,24.0,843.0,843.0
0.006,6,10,1854,5,889,1.0,621.0,621.0,5,965,1.0,697.0,697.0
0.004,17,2,148,1,60,0.0,32.0,32.0,1,88,0.0,60.0,60.0
0.011,6,10,1989,5,910,2.0,642.0,642.0,5,1079,2.0,811.0,811.0
9.037,17,6,376,5,280,2259.0,28.0,28.0,1,96,0.0,68.0,68.0
0.014,6,10,1990,5,911,3.0,643.0,643.0,5,1079,3.0,811.0,811.0
0.005,6,10,1779,5,928,1.0,660.0,660.0,5,851,1.0,583.0,583.0
0.073,6,10,1506,5,395,16.0,127.0,127.0,5,1111,14.0,843.0,843.0
0.011,6,10,1983,5,910,2.0,642.0,642.0,5,1073,2.0,805.0,805.0
0.027,6,10,1989,5,910,6.0,642.0,642.0,5,1079,6.0,811.0,811.0
0.006,6,10,2007,5,928,1.0,660.0,660.0,5,1079,1.0,811.0,811.0
40.057,17,10,676,5,460,10013.0,104.0,64.0,5,216,10013.0,20.0,15.0
309.881,6,31,10492,16,2658,20658.0,676.0,363.0,15,7834,22134.0,1402.0,882.0
0.001,17,2,180,1,66,0.0,38.0,38.0,1,114,0.0,86.0,86.0
0.011,6,10,1631,5,848,2.0,580.0,580.0,5,783,2.0,515.0,515.0
0.007,6,10,1972,5,910,1.0,642.0,642.0,5,1062,1.0,794.0,794.0
0.005,6,10,2007,5,928,1.0,660.0,660.0,5,1079,1.0,811.0,811.0
240.376,6,33,9252,16,1820,16024.0,608.0,196.0,17,7432,15023.0,1402.0,595.0
0.019,6,10,1983,5,910,4.0,642.0,642.0,5,1073,4.0,805.0,805.0
0.004,17,4,284,2,120,0.0,32.0,32.0,2,164,1.0,60.0,54.0
0.043,17,2,152,1,76,0.0,48.0,48.0,1,76,0.0,48.0,48.0
0.005,6,10,2006,5,927,1.0,659.0,659.0,5,1079,1.0,811.0,811.0
0.016,6,14,3787,7,497,2.0,125.0,125.0,7,3290,2.0,1448.0,972.0
0.041,17,2,186,1,61,0.0,33.0,33.0,1,125,0.0,97.0,97.0
0.092,6,10,1506,5,395,16.0,127.0,127.0,5,1111,21.0,843.0,843.0
240.154,6,31,8275,15,5866,17153.0,1515.0,565.0,16,2409,16008.0,580.0,196.0
0.129,6,10,1506,5,395,29.0,127.0,127.0,5,1111,26.0,843.0,843.0
376.313,6,22,2313,16,867,25087.0,195.0,195.0,6,1446,4669.0,419.0,398.0
0.005,6,13,3690,7,452,0.0,80.0,80.0,6,3238,1.0,1470.0,1459.0
0.005,6,10,2006,5,927,1.0,659.0,659.0,5,1079,1.0,811.0,811.0
0.001,17,2,166,1,75,0.0,47.0,47.0,1,91,0.0,63.0,63.0
0.149,17,4,352,2,130,108.0,37.0,37.0,2,222,77.0,89.0,83.0
0.005,6,10,1643,5,860,1.0,592.0,592.0,5,783,1.0,515.0,515.0
0.019,6,10,1972,5,910,4.0,642.0,642.0,5,1062,4.0,794.0,794.0
40.077,17,10,676,5,460,10018.0,104.0,64.0,5,216,10016.0,20.0,15.0
0.797,6,10,937,6,427,159.0,107.0,107.0,4,510,177.0,294.0,294.0
0.017,6,10,1972,5,910,4.0,642.0,642.0,5,1062,4.0,794.0,794.0
240.025,6,9,787,5,488,60006.0,232.0,232.0,4,299,80007.0,83.0,83.0
240.163,6,28,4732,13,1892,20013.0,559.0,239.0,15,2840,17154.0,1215.0,229.0
0.005,6,10,2007,5,928,1.0,660.0,660.0,5,1079,1.0,811.0,811.0
0.014,6,13,3735,7,497,2.0,125.0,125.0,6,3238,2.0,1470.0,1459.0
308.313,17,20,1124,10,716,34250.0,48.0,43.0,10,408,34250.0,20.0,12.0
0.005,6,10,2007,5,928,1.0,660.0,660.0,5,1079,1.0,811.0,811.0
177.453,17,76,10994,38,2526,4795.0,44.0,38.0,38,8468,4795.0,261.0,194.0
0.005,6,10,2000,5,927,1.0,659.0,659.0,5,1073,1.0,805.0,805.0
178.041,17,74,10565,37,2478,4945.0,44.0,38.0,37,8087,4945.0,261.0,190.0
0.067,6,10,1506,5,395,14.0,127.0,127.0,5,1111,15.0,843.0,843.0
0.005,6,10,2006,5,927,1.0,659.0,659.0,5,1079,1.0,811.0,811.0
309.78,17,20,1124,10,716,34406.0,48.0,43.0,10,408,34406.0,20.0,12.0
8.936,6,37,10002,19,4484,496.0,1360.0,738.0,18,5518,513.0,2667.0,435.0
10.906,17,26,4102,13,1822,900.0,269.0,112.0,13,2280,900.0,587.0,147.0
0.009,6,10,1972,5,910,2.0,642.0,642.0,5,1062,2.0,794.0,794.0
0.005,6,10,1989,5,927,1.0,659.0,659.0,5,1062,1.0,794.0,794.0
0.147,6,10,1506,5,395,30.0,127.0,127.0,5,1111,35.0,843.0,843.0
0.006,6,10,1689,5,839,1.0,571.0,571.0,5,850,1.0,582.0,582.0
0.003,17,2,148,1,60,0.0,32.0,32.0,1,88,0.0,60.0,60.0
0.097,6,10,1506,5,395,19.0,127.0,127.0,5,1111,23.0,843.0,843.0
0.005,6,10,2006,5,927,1.0,659.0,659.0,5,1079,1.0,811.0,811.0
0.784,6,23,8411,13,2038,65.0,1143.0,371.0,10,6373,67.0,2720.0,851.0
0.011,6,10,1989,5,910,2.0,642.0,642.0,5,1079,2.0,811.0,811.0
0.183,17,16,9015,8,6373,26.0,1350.0,768.0,8,2642,17.0,1350.0,302.0
0.017,6,10,1762,5,911,4.0,643.0,643.0,5,851,4.0,583.0,583.0
0.011,6,10,1989,5,910,2.0,642.0,642.0,5,1079,2.0,811.0,811.0
11.027,17,28,4421,14,1994,838.0,269.0,114.0,14,2427,839.0,586.0,145.0
0.039,17,2,184,1,61,0.0,33.0,33.0,1,123,0.0,95.0,95.0
299.945,6,40,12493,21,6935,14988.0,2720.0,1010.0,19,5558,16654.0,2667.0,435.0
0.008,6,10,1972,5,910,2.0,642.0,642.0,5,1062,2.0,794.0,794.0
0.085,6,10,1506,5,395,19.0,127.0,127.0,5,1111,18.0,843.0,843.0
40.064,17,10,676,5,460,10014.0,104.0,64.0,5,216,10014.0,20.0,15.0
0.01,6,12,1926,6,1189,2.0,659.0,434.0,6,737,1.0,417.0,417.0
0.111,6,10,1506,5,395,23.0,127.0,127.0,5,1111,25.0,843.0,843.0
240.423,6,31,8518,15,2762,17173.0,782.0,329.0,16,5756,16028.0,1664.0,544.0
40.065,17,10,676,5,460,10013.0,104.0,64.0,5,216,10015.0,20.0,15.0
0.005,6,10,1689,5,839,1.0,571.0,571.0,5,850,1.0,582.0,582.0
0.001,17,2,178,1,81,0.0,53.0,53.0,1,97,0.0,69.0,69.0
0.006,6,10,1689,5,839,1.0,571.0,571.0,5,850,1.0,582.0,582.0
0.01,6,10,1989,5,910,2.0,642.0,642.0,5,1079,2.0,811.0,811.0
0.007,17,2,180,1,66,0.0,38.0,38.0,1,114,0.0,86.0,86.0
0.085,6,10,1506,5,395,19.0,127.0,127.0,5,1111,17.0,843.0,843.0
0.004,17,2,144,1,64,0.0,36.0,36.0,1,80,0.0,52.0,52.0
0.01,17,2,148,1,60,0.0,32.0,32.0,1,88,0.0,60.0,60.0
0.063,6,10,1506,5,395,15.0,127.0,127.0,5,1111,14.0,843.0,843.0
2.109,6,29,8720,16,2199,140.0,517.0,273.0,13,6521,175.0,1402.0,648.0
0.003,17,2,184,1,61,0.0,33.0,33.0,1,123,0.0,95.0,95.0
0.013,6,10,1990,5,911,3.0,643.0,643.0,5,1079,3.0,811.0,811.0
0.014,6,10,1989,5,910,3.0,642.0,642.0,5,1079,3.0,811.0,811.0
0.176,17,2,152,1,76,0.0,48.0,48.0,1,76,0.0,48.0,48.0
0.001,17,2,180,1,66,0.0,38.0,38.0,1,114,0.0,86.0,86.0
0.006,6,10,1547,5,764,1.0,496.0,496.0,5,783,1.0,515.0,515.0
0.005,6,10,1989,5,927,1.0,659.0,659.0,5,1062,1.0,794.0,794.0
0.006,6,10,1989,5,927,1.0,659.0,659.0,5,1062,1.0,794.0,794.0
0.037,17,4,284,2,120,0.0,32.0,32.0,2,164,33.0,60.0,54.0
40.055,17,10,676,5,460,10013.0,104.0,64.0,5,216,10012.0,20.0,15.0
0.072,6,10,1506,5,395,15.0,127.0,127.0,5,1111,16.0,843.0,843.0
0.005,6,10,2007,5,928,1.0,660.0,660.0,5,1079,1.0,811.0,811.0
0.005,6,10,2000,5,927,1.0,659.0,659.0,5,1073,1.0,805.0,805.0
0.04,17,2,152,1,76,0.0,48.0,48.0,1,76,0.0,48.0,48.0
0.124,6,10,1506,5,395,30.0,127.0,127.0,5,1111,29.0,843.0,843.0
0.006,6,10,1854,5,889,1.0,621.0,621.0,5,965,1.0,697.0,697.0
293.899,6,319,343600,131,18364,2260.0,2736.0,888.0,188,325236,1571.0,2769.0,1812.0
0.078,6,10,1506,5,395,17.0,127.0,127.0,5,1111,18.0,843.0,843.0
0.006,6,10,1643,5,860,1.0,592.0,592.0,5,783,1.0,515.0,515.0
0.015,6,10,1990,5,911,3.0,643.0,643.0,5,1079,3.0,811.0,811.0
0.095,6,10,1506,5,395,21.0,127.0,127.0,5,1111,19.0,843.0,843.0
0.005,6,13,3747,7,509,0.0,137.0,137.0,6,3238,1.0,1470.0,1459.0
0.005,6,10,1989,5,927,1.0,659.0,659.0,5,1062,1.0,794.0,794.0
0.079,6,10,1506,5,395,18.0,127.0,127.0,5,1111,15.0,843.0,843.0
0.055,17,2,146,1,65,0.0,37.0,37.0,1,81,0.0,53.0,53.0
0.005,6,10,1989,5,927,1.0,659.0,659.0,5,1062,1.0,794.0,794.0
0.055,17,2,144,1,64,0.0,36.0,36.0,1,80,0.0,52.0,52.0
0.007,6,10,2006,5,927,1.0,659.0,659.0,5,1079,1.0,811.0,811.0
0.006,6,10,1643,5,860,1.0,592.0,592.0,5,783,1.0,515.0,515.0
315.254,17,20,1124,10,716,35013.0,48.0,43.0,10,408,35013.0,20.0,12.0
0.006,6,10,1547,5,764,1.0,496.0,496.0,5,783,1.0,515.0,515.0
0.067,17,8,3613,4,1874,22.0,1350.0,440.0,4,1739,11.0,1350.0,406.0
0.012,6,10,1983,5,910,3.0,642.0,642.0,5,1073,2.0,805.0,805.0
0.014,6,10,1677,5,827,3.0,559.0,559.0,5,850,3.0,582.0,582.0
0.012,6,13,3735,7,497,2.0,125.0,125.0,6,3238,2.0,1470.0,1459.0
0.088,6,10,1506,5,395,19.0,127.0,127.0,5,1111,16.0,843.0,843.0
0.006,6,10,1547,5,764,1.0,496.0,496.0,5,783,1.0,515.0,515.0
0.019,6,11,1683,6,900,3.0,580.0,580.0,5,783,4.0,515.0,515.0
0.004,6,10,1702,5,863,1.0,595.0,595.0,5,839,0.0,571.0,571.0
0.005,17,2,180,1,58,0.0,30.0,30.0,1,122,0.0,94.0,94.0
2.114,6,30,8771,17,2251,132.0,517.0,273.0,13,6520,175.0,1402.0,648.0
1776.232,6,64,7344,42,4469,43322.0,1625.0,108.0,22,2875,84573.0,1111.0,82.0
40.074,17,10,676,5,460,10012.0,104.0,64.0,5,216,10017.0,20.0,15.0
0.012,6,10,1989,5,910,3.0,642.0,642.0,5,1079,2.0,811.0,811.0
0.005,6,10,1989,5,927,1.0,659.0,659.0,5,1062,1.0,794.0,794.0
0.005,17,2,140,1,62,0.0,34.0,34.0,1,78,0.0,50.0,50.0
0.005,6,10,2000,5,927,1.0,659.0,659.0,5,1073,1.0,805.0,805.0
40.07,17,10,676,5,460,10015.0,104.0,64.0,5,216,10016.0,20.0,15.0
0.012,6,13,3735,7,497,1.0,125.0,125.0,6,3238,2.0,1470.0,1459.0
0.014,6,10,1983,5,910,3.0,642.0,642.0,5,1073,3.0,805.0,805.0
11.28,17,28,4409,14,1993,855.0,268.0,114.0,14,2416,854.0,587.0,144.0
0.006,6,10,1547,5,764,1.0,496.0,496.0,5,783,1.0,515.0,515.0
0.01,6,10,1983,5,910,2.0,642.0,642.0,5,1073,2.0,805.0,805.0
0.136,6,10,1506,5,395,31.0,127.0,127.0,5,1111,30.0,843.0,843.0
0.005,6,10,2006,5,927,1.0,659.0,659.0,5,1079,1.0,811.0,811.0
0.02,6,10,1989,5,910,5.0,642.0,642.0,5,1079,5.0,811.0,811.0
0.006,6,14,3799,7,509,1.0,137.0,137.0,7,3290,0.0,1448.0,972.0
0.012,6,12,1926,6,1189,2.0,659.0,434.0,6,737,2.0,417.0,417.0
0.006,6,10,1547,5,764,1.0,496.0,496.0,5,783,1.0,515.0,515.0
0.004,6,10,1774,5,923,1.0,655.0,655.0,5,851,1.0,583.0,583.0
0.006,17,2,166,1,75,0.0,47.0,47.0,1,91,0.0,63.0,63.0
0.005,6,10,2000,5,927,1.0,659.0,659.0,5,1073,1.0,805.0,805.0
0.12,6,10,1506,5,395,27.0,127.0,127.0,5,1111,25.0,843.0,843.0
0.005,6,10,2000,5,927,1.0,659.0,659.0,5,1073,1.0,805.0,805.0
0.007,6,10,1989,5,927,1.0,659.0,659.0,5,1062,1.0,794.0,794.0
0.003,17,2,148,1,60,0.0,32.0,32.0,1,88,0.0,60.0,60.0
0.005,6,10,1689,5,839,1.0,571.0,571.0,5,850,1.0,582.0,582.0
0.053,17,2,152,1,76,0.0,48.0,48.0,1,76,0.0,48.0,48.0
0.065,17,8,3613,4,1874,21.0,1350.0,440.0,4,1739,11.0,1350.0,406.0
0.04,17,2,136,1,60,0.0,32.0,32.0,1,76,0.0,48.0,48.0
0.005,6,10,2007,5,928,1.0,660.0,660.0,5,1079,1.0,811.0,811.0
0.006,6,10,1547,5,764,1.0,496.0,496.0,5,783,1.0,515.0,515.0
0.011,6,10,1983,5,910,2.0,642.0,642.0,5,1073,2.0,805.0,805.0
0.006,6,10,1547,5,764,1.0,496.0,496.0,5,783,1.0,515.0,515.0
0.001,17,2,140,1,62,0.0,34.0,34.0,1,78,0.0,50.0,50.0
0.097,6,10,1506,5,395,22.0,127.0,127.0,5,1111,21.0,843.0,843.0
40.062,17,10,676,5,460,10014.0,104.0,64.0,5,216,10014.0,20.0,15.0
0.02,6,10,1989,5,910,4.0,642.0,642.0,5,1079,5.0,811.0,811.0
0.227,6,16,2670,8,1396,32.0,533.0,324.0,8,1274,21.0,529.0,212.0
0.009,6,13,3735,7,497,1.0,125.0,125.0,6,3238,1.0,1470.0,1459.0
0.005,17,2,136,1,60,0.0,32.0,32.0,1,76,0.0,48.0,48.0
0.108,6,10,1506,5,395,24.0,127.0,127.0,5,1111,25.0,843.0,843.0
0.01,6,13,3735,7,497,1.0,125.0,125.0,6,3238,2.0,1470.0,1459.0
0.004,6,10,2000,5,927,1.0,659.0,659.0,5,1073,1.0,805.0,805.0
0.086,6,10,1506,5,395,19.0,127.0,127.0,5,1111,16.0,843.0,843.0
0.069,6,10,1506,5,395,16.0,127.0,127.0,5,1111,13.0,843.0,843.0
0.209,6,16,2777,8,1395,29.0,533.0,323.0,8,1382,18.0,529.0,239.0
0.012,6,10,1972,5,910,2.0,642.0,642.0,5,1062,2.0,794.0,794.0
0.016,6,10,1989,5,910,3.0,642.0,642.0,5,1079,4.0,811.0,811.0
0.078,6,10,1506,5,395,16.0,127.0,127.0,5,1111,19.0,843.0,843.0
40.068,17,10,676,5,460,10014.0,104.0,64.0,5,216,10016.0,20.0,15.0
0.004,17,2,136,1,60,0.0,32.0,32.0,1,76,0.0,48.0,48.0
0.127,17,2,170,1,65,0.0,37.0,37.0,1,105,0.0,77.0,77.0
0.013,6,10,1990,5,911,3.0,643.0,643.0,5,1079,3.0,811.0,811.0
0.005,6,10,2007,5,928,1.0,660.0,660.0,5,1079,1.0,811.0,811.0
0.012,6,10,1631,5,848,3.0,580.0,580.0,5,783,3.0,515.0,515.0
40.063,17,10,676,5,460,10014.0,104.0,64.0,5,216,10015.0,20.0,15.0
0.008,6,12,1926,6,1189,1.0,659.0,434.0,6,737,1.0,417.0,417.0
0.005,6,10,2006,5,927,1.0,659.0,659.0,5,1079,1.0,811.0,811.0
0.004,6,10,1774,5,923,1.0,655.0,655.0,5,851,1.0,583.0,583.0
0.016,6,10,1972,5,910,4.0,642.0,642.0,5,1062,4.0,794.0,794.0
0.012,6,10,1990,5,911,2.0,643.0,643.0,5,1079,2.0,811.0,811.0
0.039,17,2,152,1,76,0.0,48.0,48.0,1,76,0.0,48.0,48.0
40.067,17,10,676,5,460,10014.0,104.0,64.0,5,216,10016.0,20.0,15.0
0.039,17,2,136,1,60,0.0,32.0,32.0,1,76,0.0,48.0,48.0
0.005,6,10,2000,5,927,1.0,659.0,659.0,5,1073,1.0,805.0,805.0
0.706,6,22,5072,11,1250,59.0,325.0,133.0,11,3822,59.0,1414.0,563.0
240.202,6,43,9506,21,2383,12010.0,517.0,181.0,22,7123,11438.0,2380.0,597.0
0.004,6,10,1702,5,863,0.0,595.0,595.0,5,839,1.0,571.0,571.0
0.01,6,10,1677,5,827,2.0,559.0,559.0,5,850,2.0,582.0,582.0
308.453,17,20,1124,10,716,34260.0,48.0,43.0,10,408,34259.0,20.0,12.0
240.01,6,9,787,5,488,60002.0,232.0,232.0,4,299,80002.0,83.0,83.0
0.004,6,10,2007,5,928,1.0,660.0,660.0,5,1079,1.0,811.0,811.0
1770.042,6,79,4160,40,2106,45384.0,26.0,26.0,39,2054,46578.0,26.0,26.0
0.303,17,38,20190,21,17042,15.0,1350.0,783.0,17,3148,12.0,1350.0,157.0
0.006,6,10,1547,5,764,1.0,496.0,496.0,5,783,1.0,515.0,515.0
0.015,17,2,144,1,64,0.0,36.0,36.0,1,80,0.0,52.0,52.0
240.081,6,20,4872,10,889,26675.0,180.0,93.0,10,3983,26674.0,1591.0,575.0
0.01,6,10,1677,5,827,2.0,559.0,559.0,5,850,2.0,582.0,582.0
240.091,6,30,9096,15,6759,17149.0,1885.0,664.0,15,2337,17149.0,580.0,193.0
0.182,17,4,596,2,122,144.0,33.0,33.0,2,474,143.0,323.0,209.0
0.008,6,10,1972,5,910,2.0,642.0,642.0,5,1062,2.0,794.0,794.0
0.02,6,10,1989,5,910,4.0,642.0,642.0,5,1079,5.0,811.0,811.0
0.005,6,10,1547,5,764,1.0,496.0,496.0,5,783,1.0,515.0,515.0
0.007,17,2,179,1,71,0.0,43.0,43.0,1,108,0.0,80.0,80.0
0.006,6,10,1689,5,839,1.0,571.0,571.0,5,850,1.0,582.0,582.0
174.485,17,96,12908,48,3206,3712.0,44.0,38.0,48,9702,3712.0,261.0,174.0
0.009,6,12,1926,6,1189,1.0,659.0,434.0,6,737,1.0,417.0,417.0
0.01,6,10,1972,5,910,2.0,642.0,642.0,5,1062,2.0,794.0,794.0
99.206,6,39,10113,21,4595,4952.0,1360.0,620.0,18,5518,5826.0,2667.0,435.0
40.063,17,10,676,5,460,10012.0,104.0,64.0,5,216,10015.0,20.0,15.0
0.005,6,10,2007,5,928,1.0,660.0,660.0,5,1079,1.0,811.0,811.0
0.129,6,10,1506,5,395,31.0,127.0,127.0,5,1111,26.0,843.0,843.0
0.003,17,2,152,1,76,0.0,48.0,48.0,1,76,0.0,48.0,48.0
0.101,6,10,1506,5,395,23.0,127.0,127.0,5,1111,23.0,843.0,843.0
0.005,6,10,2007,5,928,1.0,660.0,660.0,5,1079,1.0,811.0,811.0
0.01,6,10,1989,5,910,2.0,642.0,642.0,5,1079,2.0,811.0,811.0
0.007,6,10,1689,5,839,1.0,571.0,571.0,5,850,1.0,582.0,582.0
0.083,6,10,1506,5,395,16.0,127.0,127.0,5,1111,19.0,843.0,843.0
0.001,17,2,179,1,62,0.0,34.0,34.0,1,117,0.0,89.0,89.0
0.001,17,2,142,1,63,0.0,35.0,35.0,1,79,0.0,51.0,51.0
0.012,6,10,1990,5,911,3.0,643.0,643.0,5,1079,3.0,811.0,811.0
0.011,6,10,1972,5,910,2.0,642.0,642.0,5,1062,2.0,794.0,794.0
0.005,6,10,2007,5,928,1.0,660.0,660.0,5,1079,1.0,811.0,811.0
0.006,17,2,179,1,71,0.0,43.0,43.0,1,108,0.0,80.0,80.0
0.005,6,10,1547,5,764,1.0,496.0,496.0,5,783,1.0,515.0,515.0
0.004,6,10,1702,5,863,1.0,595.0,595.0,5,839,0.0,571.0,571.0
0.12,6,10,1506,5,395,27.0,127.0,127.0,5,1111,28.0,843.0,843.0
0.006,6,10,2000,5,927,1.0,659.0,659.0,5,1073,1.0,805.0,805.0
240.017,6,9,787,5,488,60004.0,232.0,232.0,4,299,80004.0,83.0,83.0
0.004,6,10,2006,5,927,1.0,659.0,659.0,5,1079,1.0,811.0,811.0
0.003,17,2,148,1,60,0.0,32.0,32.0,1,88,0.0,60.0,60.0
0.009,6,12,1926,6,1189,1.0,659.0,434.0,6,737,1.0,417.0,417.0
0.011,6,10,1983,5,910,2.0,642.0,642.0,5,1073,2.0,805.0,805.0
0.01,6,10,1990,5,911,2.0,643.0,643.0,5,1079,2.0,811.0,811.0
0.005,17,2,178,1,65,0.0,37.0,37.0,1,113,0.0,85.0,85.0
0.108,6,10,1506,5,395,24.0,127.0,127.0,5,1111,21.0,843.0,843.0
0.085,6,10,1506,5,395,19.0,127.0,127.0,5,1111,19.0,843.0,843.0
240.082,6,39,7004,19,3331,13337.0,880.0,333.0,20,3673,12635.0,1306.0,328.0
0.039,17,2,170,1,65,0.0,37.0,37.0,1,105,0.0,77.0,77.0
0.005,6,10,2007,5,928,1.0,660.0,660.0,5,1079,1.0,811.0,811.0
0.065,6,10,1506,5,395,13.0,127.0,127.0,5,1111,14.0,843.0,843.0
0.01,6,10,1677,5,827,2.0,559.0,559.0,5,850,2.0,582.0,582.0
0.006,17,2,194,1,59,0.0,31.0,31.0,1,135,0.0,107.0,107.0
0.094,6,10,1506,5,395,21.0,127.0,127.0,5,1111,18.0,843.0,843.0
0.006,17,2,214,1,75,0.0,47.0,47.0,1,139,0.0,111.0,111.0
177.151,17,72,10116,36,2392,5061.0,44.0,38.0,36,7724,5061.0,239.0,186.0
40.074,17,10,676,5,460,10013.0,104.0,64.0,5,216,10017.0,20.0,15.0
40.057,17,10,676,5,460,10013.0,104.0,64.0,5,216,10013.0,20.0,15.0
0.009,6,10,1762,5,911,2.0,643.0,643.0,5,851,2.0,583.0,583.0
0.016,6,10,1990,5,911,4.0,643.0,643.0,5,1079,4.0,811.0,811.0
0.006,6,10,1547,5,764,1.0,496.0,496.0,5,783,1.0,515.0,515.0
10.941,17,28,4422,14,1994,832.0,269.0,114.0,14,2428,831.0,587.0,145.0
0.008,6,10,1677,5,827,2.0,559.0,559.0,5,850,2.0,582.0,582.0
0.013,6,10,1972,5,910,3.0,642.0,642.0,5,1062,3.0,794.0,794.0
0.005,6,10,2000,5,927,1.0,659.0,659.0,5,1073,1.0,805.0,805.0
0.013,6,10,1989,5,910,3.0,642.0,642.0,5,1079,3.0,811.0,811.0
0.009,6,10,1972,5,910,2.0,642.0,642.0,5,1062,2.0,794.0,794.0
40.072,17,10,676,5,460,10013.0,104.0,64.0,5,216,10014.0,20.0,15.0
1772.625,17,120,11460,60,5460,30044.0,63.0,63.0,60,6000,30044.0,72.0,72.0
0.027,6,10,1990,5,911,6.0,643.0,643.0,5,1079,6.0,811.0,811.0
10.829,17,28,4422,14,1993,824.0,268.0,114.0,14,2429,824.0,588.0,145.0
0.006,6,10,1547,5,764,1.0,496.0,496.0,5,783,1.0,515.0,515.0
0.087,6,10,1506,5,395,18.0,127.0,127.0,5,1111,18.0,843.0,843.0
0.007,6,10,1972,5,910,1.0,642.0,642.0,5,1062,1.0,794.0,794.0
0.004,6,10,1989,5,927,1.0,659.0,659.0,5,1062,1.0,794.0,794.0
0.006,6,10,1547,5,764,1.0,496.0,496.0,5,783,1.0,515.0,515.0
0.005,6,10,2006,5,927,1.0,659.0,659.0,5,1079,1.0,811.0,811.0
0.005,6,10,2000,5,927,1.0,659.0,659.0,5,1073,1.0,805.0,805.0
0.001,17,2,140,1,62,0.0,34.0,34.0,1,78,0.0,50.0,50.0
0.041,17,2,148,1,60,0.0,32.0,32.0,1,88,0.0,60.0,60.0
0.016,6,10,1983,5,910,3.0,642.0,642.0,5,1073,3.0,805.0,805.0
0.01,6,10,1631,5,848,2.0,580.0,580.0,5,783,2.0,515.0,515.0
0.0,17,2,154,1,69,0.0,41.0,41.0,1,85,0.0,57.0,57.0
0.128,6,10,1506,5,395,29.0,127.0,127.0,5,1111,25.0,843.0,843.0
0.005,6,10,2000,5,927,1.0,659.0,659.0,5,1073,1.0,805.0,805.0
0.008,6,12,1926,6,1189,1.0,659.0,434.0,6,737,1.0,417.0,417.0
40.078,17,10,676,5,460,10017.0,104.0,64.0,5,216,10018.0,20.0,15.0
0.088,6,10,1506,5,395,20.0,127.0,127.0,5,1111,21.0,843.0,843.0
0.006,17,2,164,1,74,0.0,46.0,46.0,1,90,0.0,62.0,62.0
0.018,6,10,1677,5,827,4.0,559.0,559.0,5,850,4.0,582.0,582.0
0.003,17,2,136,1,60,0.0,32.0,32.0,1,76,0.0,48.0,48.0
240.047,6,9,787,5,488,60011.0,232.0,232.0,4,299,80005.0,83.0,83.0
0.01,6,10,1990,5,911,2.0,643.0,643.0,5,1079,2.0,811.0,811.0
0.006,6,10,1547,5,764,1.0,496.0,496.0,5,783,1.0,515.0,515.0
10.806,17,28,4420,14,1993,822.0,268.0,114.0,14,2427,822.0,586.0,145.0
0.005,6,10,2007,5,928,1.0,660.0,660.0,5,1079,1.0,811.0,811.0
0.122,6,10,1506,5,395,25.0,127.0,127.0,5,1111,28.0,843.0,843.0
0.01,6,10,1762,5,911,2.0,643.0,643.0,5,851,2.0,583.0,583.0
0.005,6,10,2006,5,927,1.0,659.0,659.0,5,1079,1.0,811.0,811.0
0.006,6,10,1854,5,889,1.0,621.0,621.0,5,965,1.0,697.0,697.0
0.008,6,10,1990,5,911,2.0,643.0,643.0,5,1079,2.0,811.0,811.0
0.005,6,10,2007,5,928,1.0,660.0,660.0,5,1079,1.0,811.0,811.0
0.006,6,10,1989,5,927,1.0,659.0,659.0,5,1062,1.0,794.0,794.0
0.009,6,10,1990,5,911,2.0,643.0,643.0,5,1079,2.0,811.0,811.0
10.844,17,28,4418,14,1994,826.0,269.0,114.0,14,2424,826.0,587.0,145.0
0.005,17,2,140,1,62,0.0,34.0,34.0,1,78,0.0,50.0,50.0
0.004,17,2,152,1,76,0.0,48.0,48.0,1,76,0.0,48.0,48.0
176.086,17,98,14063,49,3308,3668.0,44.0,39.0,49,10755,3668.0,239.0,191.0
0.006,17,2,148,1,60,0.0,32.0,32.0,1,88,0.0,60.0,60.0
0.005,17,2,214,1,75,0.0,47.0,47.0,1,139,0.0,111.0,111.0
40.05,17,10,676,5,460,10009.0,104.0,64.0,5,216,10011.0,20.0,15.0
0.004,17,2,132,1,58,0.0,30.0,30.0,1,74,0.0,46.0,46.0
0.004,6,10,2000,5,927,1.0,659.0,659.0,5,1073,1.0,805.0,805.0
0.101,6,10,1506,5,395,24.0,127.0,127.0,5,1111,21.0,843.0,843.0
300.025,6,12,1782,7,1348,50004.0,494.0,494.0,5,434,75005.0,83.0,83.0
0.068,17,8,3613,4,1874,22.0,1350.0,440.0,4,1739,12.0,1350.0,406.0
0.005,6,14,3736,7,446,0.0,74.0,74.0,7,3290,0.0,1448.0,972.0
0.024,6,10,1983,5,910,5.0,642.0,642.0,5,1073,5.0,805.0,805.0
0.091,6,10,1506,5,395,18.0,127.0,127.0,5,1111,21.0,843.0,843.0
0.084,6,10,1506,5,395,18.0,127.0,127.0,5,1111,17.0,843.0,843.0
0.007,6,10,1689,5,839,1.0,571.0,571.0,5,850,1.0,582.0,582.0
0.006,6,10,1643,5,860,1.0,592.0,592.0,5,783,1.0,515.0,515.0
0.004,17,4,284,2,120,0.0,32.0,32.0,2,164,0.0,60.0,54.0
40.079,17,10,676,5,460,10018.0,104.0,64.0,5,216,10019.0,20.0,15.0
0.005,6,13,3690,7,452,0.0,80.0,80.0,6,3238,0.0,1470.0,1459.0
0.111,6,10,1506,5,395,26.0,127.0,127.0,5,1111,25.0,843.0,843.0
1778.173,17,144,45504,72,22752,25044.0,288.0,288.0,72,22752,25044.0,288.0,288.0
10.829,17,28,4417,14,1994,824.0,269.0,114.0,14,2423,824.0,586.0,145.0
0.017,6,10,1990,5,911,4.0,643.0,643.0,5,1079,4.0,811.0,811.0
0.005,6,10,1989,5,927,1.0,659.0,659.0,5,1062,1.0,794.0,794.0
0.004,17,2,148,1,60,0.0,32.0,32.0,1,88,0.0,60.0,60.0
15.086,17,15,8256,8,6067,2151.0,1350.0,730.0,7,2189,2507.0,1350.0,284.0
1799.783,6,298,51742,122,34271,14873.0,2790.0,302.0,176,17471,10283.0,1360.0,128.0
366.117,6,22,2313,16,867,24407.0,195.0,195.0,6,1446,4642.0,419.0,398.0
0.004,6,10,1702,5,863,1.0,595.0,595.0,5,839,0.0,571.0,571.0
0.071,17,2,148,1,60,0.0,32.0,32.0,1,88,0.0,60.0,60.0
0.011,6,10,1972,5,910,2.0,642.0,642.0,5,1062,2.0,794.0,794.0
0.005,6,10,2007,5,928,1.0,660.0,660.0,5,1079,1.0,811.0,811.0
0.005,6,13,3747,7,509,0.0,137.0,137.0,6,3238,0.0,1470.0,1459.0
0.108,6,10,1506,5,395,25.0,127.0,127.0,5,1111,25.0,843.0,843.0
0.005,17,2,136,1,60,0.0,32.0,32.0,1,76,0.0,48.0,48.0
0.005,6,10,2006,5,927,1.0,659.0,659.0,5,1079,1.0,811.0,811.0
40.077,17,10,676,5,460,10015.0,104.0,64.0,5,216,10018.0,20.0,15.0
0.005,6,10,2000,5,927,1.0,659.0,659.0,5,1073,1.0,805.0,805.0
0.001,17,2,180,1,66,0.0,38.0,38.0,1,114,0.0,86.0,86.0
0.013,6,10,1989,5,910,3.0,642.0,642.0,5,1079,3.0,811.0,811.0
0.009,6,12,1926,6,1189,1.0,659.0,434.0,6,737,1.0,417.0,417.0
240.469,6,47,25532,22,2148,11449.0,504.0,196.0,25,23384,10018.0,2804.0,1104.0
9.038,17,6,376,5,280,2259.0,28.0,28.0,1,96,0.0,68.0,68.0
0.123,17,2,80,1,32,0.0,4.0,4.0,1,48,0.0,20.0,20.0
0.005,6,10,2006,5,927,1.0,659.0,659.0,5,1079,1.0,811.0,811.0
0.158,6,10,1506,5,395,35.0,127.0,127.0,5,1111,38.0,843.0,843.0
15.231,17,43,24309,25,19888,633.0,1350.0,767.0,18,4421,894.0,1350.0,217.0
0.005,6,10,2006,5,927,1.0,659.0,659.0,5,1079,1.0,811.0,811.0
0.015,6,10,1972,5,910,3.0,642.0,642.0,5,1062,3.0,794.0,794.0
0.004,17,2,148,1,60,0.0,32.0,32.0,1,88,0.0,60.0,60.0
0.005,6,10,2007,5,928,1.0,660.0,660.0,5,1079,1.0,811.0,811.0
0.005,6,10,1989,5,927,1.0,659.0,659.0,5,1062,1.0,794.0,794.0
0.005,6,10,1643,5,860,1.0,592.0,592.0,5,783,1.0,515.0,515.0
353.478,6,20,2210,6,1308,12004.0,494.0,494.0,14,902,27190.0,83.0,83.0
0.003,6,10,1702,5,863,0.0,595.0,595.0,5,839,0.0,571.0,571.0
0.006,6,10,1854,5,889,1.0,621.0,621.0,5,965,1.0,697.0,697.0
0.011,6,10,1631,5,848,2.0,580.0,580.0,5,783,2.0,515.0,515.0
0.001,17,2,180,1,66,0.0,38.0,38.0,1,114,0.0,86.0,86.0
0.138,6,10,1506,5,395,32.0,127.0,127.0,5,1111,31.0,843.0,843.0
40.061,17,10,676,5,460,10013.0,104.0,64.0,5,216,10014.0,20.0,15.0
0.132,6,10,1506,5,395,30.0,127.0,127.0,5,1111,30.0,843.0,843.0
0.039,17,2,170,1,65,0.0,37.0,37.0,1,105,0.0,77.0,77.0
0.017,6,10,1990,5,911,4.0,643.0,643.0,5,1079,4.0,811.0,811.0
40.06,17,10,676,5,460,10012.0,104.0,64.0,5,216,10014.0,20.0,15.0
0.014,6,10,1989,5,910,3.0,642.0,642.0,5,1079,3.0,811.0,811.0
0.077,6,10,1506,5,395,15.0,127.0,127.0,5,1111,16.0,843.0,843.0
0.005,6,10,2006,5,927,1.0,659.0,659.0,5,1079,1.0,811.0,811.0
0.012,6,10,1989,5,910,3.0,642.0,642.0,5,1079,2.0,811.0,811.0
0.115,6,10,1506,5,395,24.0,127.0,127.0,5,1111,26.0,843.0,843.0
0.006,6,10,1689,5,839,1.0,571.0,571.0,5,850,1.0,582.0,582.0
0.02,6,10,1989,5,927,5.0,659.0,659.0,5,1062,4.0,794.0,794.0
40.087,17,10,676,5,460,10020.0,104.0,64.0,5,216,10020.0,20.0,15.0
0.013,6,10,1989,5,910,3.0,642.0,642.0,5,1079,3.0,811.0,811.0
0.011,6,10,1762,5,911,2.0,643.0,643.0,5,851,2.0,583.0,583.0
0.012,6,10,1989,5,910,3.0,642.0,642.0,5,1079,3.0,811.0,811.0
0.098,6,10,1506,5,395,23.0,127.0,127.0,5,1111,21.0,843.0,843.0
0.006,6,10,1547,5,764,1.0,496.0,496.0,5,783,1.0,515.0,515.0
0.127,6,10,1506,5,395,27.0,127.0,127.0,5,1111,22.0,843.0,843.0
0.006,6,13,3747,7,509,0.0,137.0,137.0,6,3238,1.0,1470.0,1459.0
0.17,17,2,152,1,76,0.0,48.0,48.0,1,76,0.0,48.0,48.0
243.06,6,407,349264,197,21769,1240.0,2736.0,885.0,210,327495,1162.0,2804.0,1582.0
0.105,6,10,1506,5,395,25.0,127.0,127.0,5,1111,25.0,843.0,843.0
0.006,17,2,170,1,65,0.0,37.0,37.0,1,105,0.0,77.0,77.0
0.087,6,10,1506,5,395,17.0,127.0,127.0,5,1111,18.0,843.0,843.0
0.092,6,10,1506,5,395,19.0,127.0,127.0,5,1111,20.0,843.0,843.0
0.005,6,10,2000,5,927,1.0,659.0,659.0,5,1073,1.0,805.0,805.0
0.004,17,4,284,2,120,1.0,32.0,32.0,2,164,0.0,60.0,54.0
15.078,17,19,10791,9,8290,1881.0,1350.0,893.0,10,2501,1672.0,1350.0,222.0
0.001,17,2,180,1,66,0.0,38.0,38.0,1,114,0.0,86.0,86.0
0.006,6,10,1779,5,928,1.0,660.0,660.0,5,851,1.0,583.0,583.0
0.013,6,10,1989,5,910,3.0,642.0,642.0,5,1079,3.0,811.0,811.0
0.005,6,10,1989,5,927,1.0,659.0,659.0,5,1062,1.0,794.0,794.0
0.006,17,2,164,1,74,0.0,46.0,46.0,1,90,0.0,62.0,62.0
0.001,17,2,180,1,66,0.0,38.0,38.0,1,114,0.0,86.0,86.0
0.004,6,10,1779,5,928,1.0,660.0,660.0,5,851,1.0,583.0,583.0
0.04,17,2,156,1,64,0.0,36.0,36.0,1,92,0.0,64.0,64.0
240.106,6,16,4480,9,963,30013.0,238.0,166.0,7,3517,40015.0,1402.0,786.0
0.129,17,2,136,1,60,0.0,32.0,32.0,1,76,0.0,48.0,48.0
319.822,17,20,1124,10,716,35520.0,48.0,43.0,10,408,35520.0,20.0,12.0
0.116,6,10,1506,5,395,23.0,127.0,127.0,5,1111,26.0,843.0,843.0
0.11,6,10,1506,5,395,24.0,127.0,127.0,5,1111,25.0,843.0,843.0
40.061,17,10,676,5,460,10014.0,104.0,64.0,5,216,10014.0,20.0,15.0
351.989,6,20,2210,6,1308,12003.0,494.0,494.0,14,902,27075.0,83.0,83.0
0.001,17,2,180,1,66,0.0,38.0,38.0,1,114,0.0,86.0,86.0
0.006,6,10,1689,5,839,1.0,571.0,571.0,5,850,1.0,582.0,582.0
0.005,6,10,2000,5,927,1.0,659.0,659.0,5,1073,1.0,805.0,805.0
0.003,17,2,170,1,65,0.0,37.0,37.0,1,105,0.0,77.0,77.0
0.005,6,10,1989,5,927,1.0,659.0,659.0,5,1062,1.0,794.0,794.0
294.015,6,324,348785,120,17791,2470.0,2736.0,888.0,204,330994,1448.0,2804.0,1686.0
0.011,6,10,1983,5,910,2.0,642.0,642.0,5,1073,2.0,805.0,805.0
0.07,17,8,3613,4,1874,23.0,1350.0,440.0,4,1739,12.0,1350.0,406.0
0.001,17,2,180,1,66,0.0,38.0,38.0,1,114,0.0,86.0,86.0
0.081,6,10,1506,5,395,18.0,127.0,127.0,5,1111,18.0,843.0,843.0
0.07,6,10,1506,5,395,16.0,127.0,127.0,5,1111,15.0,843.0,843.0
0.004,6,10,1989,5,927,1.0,659.0,659.0,5,1062,1.0,794.0,794.0
0.055,17,2,179,1,71,0.0,43.0,43.0,1,108,0.0,80.0,80.0
0.005,6,10,1689,5,839,1.0,571.0,571.0,5,850,1.0,582.0,582.0
0.011,6,10,1762,5,911,2.0,643.0,643.0,5,851,2.0,583.0,583.0
0.005,6,10,2006,5,927,1.0,659.0,659.0,5,1079,1.0,811.0,811.0
0.042,17,2,364,1,61,0.0,33.0,33.0,1,303,0.0,275.0,275.0
0.065,6,10,1506,5,395,14.0,127.0,127.0,5,1111,13.0,843.0,843.0
0.071,17,8,3613,4,1874,23.0,1350.0,440.0,4,1739,12.0,1350.0,406.0
0.012,6,10,1972,5,910,3.0,642.0,642.0,5,1062,2.0,794.0,794.0
0.086,6,10,1506,5,395,18.0,127.0,127.0,5,1111,18.0,843.0,843.0
0.008,6,12,1926,6,1189,1.0,659.0,434.0,6,737,1.0,417.0,417.0
0.005,6,10,2000,5,927,1.0,659.0,659.0,5,1073,1.0,805.0,805.0
0.087,6,10,1506,5,395,19.0,127.0,127.0,5,1111,20.0,843.0,843.0
0.014,6,10,1983,5,910,3.0,642.0,642.0,5,1073,3.0,805.0,805.0
0.005,6,10,1854,5,889,1.0,621.0,621.0,5,965,1.0,697.0,697.0
1741.872,6,299,94062,184,83316,9518.0,1402.0,664.0,115,10746,15279.0,92.0,66.0
40.083,17,10,676,5,460,10019.0,104.0,64.0,5,216,10019.0,20.0,15.0
40.064,17,10,676,5,460,10015.0,104.0,64.0,5,216,10015.0,20.0,15.0
0.009,6,10,1990,5,911,2.0,643.0,643.0,5,1079,2.0,811.0,811.0
0.006,6,10,1854,5,889,1.0,621.0,621.0,5,965,1.0,697.0,697.0
0.07,6,10,1506,5,395,14.0,127.0,127.0,5,1111,15.0,843.0,843.0
0.006,6,10,1547,5,764,1.0,496.0,496.0,5,783,1.0,515.0,515.0
0.008,6,10,1972,5,910,1.0,642.0,642.0,5,1062,2.0,794.0,794.0
0.005,17,2,170,1,65,0.0,37.0,37.0,1,105,0.0,77.0,77.0
0.004,17,4,284,2,120,1.0,32.0,32.0,2,164,0.0,60.0,54.0
0.005,6,10,2006,5,927,1.0,659.0,659.0,5,1079,1.0,811.0,811.0
0.008,6,10,2006,5,927,2.0,659.0,659.0,5,1079,1.0,811.0,811.0
0.006,6,14,3736,7,446,0.0,74.0,74.0,7,3290,0.0,1448.0,972.0
0.005,17,2,140,1,62,0.0,34.0,34.0,1,78,0.0,50.0,50.0
0.063,17,2,152,1,76,0.0,48.0,48.0,1,76,0.0,48.0,48.0
0.067,6,10,1506,5,395,16.0,127.0,127.0,5,1111,13.0,843.0,843.0
0.005,6,10,1774,5,923,1.0,655.0,655.0,5,851,1.0,583.0,583.0
0.014,6,10,1989,5,910,3.0,642.0,642.0,5,1079,3.0,811.0,811.0
10.806,17,28,4422,14,1994,822.0,269.0,114.0,14,2428,822.0,587.0,145.0
0.009,6,10,1989,5,910,2.0,642.0,642.0,5,1079,2.0,811.0,811.0
0.005,6,10,1989,5,927,1.0,659.0,659.0,5,1062,1.0,794.0,794.0
0.016,6,10,1990,5,911,3.0,643.0,643.0,5,1079,3.0,811.0,811.0
0.18,17,2,194,1,59,0.0,31.0,31.0,1,135,0.0,107.0,107.0
0.004,17,4,284,2,120,1.0,32.0,32.0,2,164,0.0,60.0,54.0
0.071,17,2,136,1,60,0.0,32.0,32.0,1,76,0.0,48.0,48.0
0.006,6,10,1689,5,839,1.0,571.0,571.0,5,850,1.0,582.0,582.0
0.004,17,2,136,1,60,0.0,32.0,32.0,1,76,0.0,48.0,48.0
240.085,6,16,4482,9,963,30010.0,238.0,166.0,7,3519,40013.0,1402.0,786.0
0.006,17,2,170,1,65,0.0,37.0,37.0,1,105,0.0,77.0,77.0
0.008,6,10,1677,5,827,2.0,559.0,559.0,5,850,1.0,582.0,582.0
11.082,17,28,4422,14,1994,840.0,269.0,114.0,14,2428,840.0,587.0,145.0
0.113,6,10,1506,5,395,26.0,127.0,127.0,5,1111,23.0,843.0,843.0
0.037,17,2,412,1,61,0.0,33.0,33.0,1,351,0.0,323.0,323.0
0.006,6,10,1854,5,889,1.0,621.0,621.0,5,965,1.0,697.0,697.0
0.076,6,10,1506,5,395,18.0,127.0,127.0,5,1111,16.0,843.0,843.0
372.243,6,22,2313,16,867,24816.0,195.0,195.0,6,1446,4644.0,419.0,398.0
0.04,17,2,136,1,60,0.0,32.0,32.0,1,76,0.0,48.0,48.0
15.072,17,15,9238,8,6902,2149.0,1350.0,834.0,7,2336,2507.0,1350.0,305.0
0.001,17,2,180,1,65,0.0,37.0,37.0,1,115,0.0,87.0,87.0
0.034,6,10,1989,5,910,8.0,642.0,642.0,5,1079,8.0,811.0,811.0
40.078,17,10,676,5,460,10016.0,104.0,64.0,5,216,10018.0,20.0,15.0
0.01,6,10,1989,5,910,2.0,642.0,642.0,5,1079,2.0,811.0,811.0
1780.218,6,64,7360,42,4484,43419.0,1640.0,109.0,22,2876,84764.0,1112.0,82.0
0.005,6,13,3747,7,509,0.0,137.0,137.0,6,3238,0.0,1470.0,1459.0
0.023,6,10,1990,5,911,5.0,643.0,643.0,5,1079,5.0,811.0,811.0
0.004,6,10,1774,5,923,1.0,655.0,655.0,5,851,1.0,583.0,583.0
0.075,6,10,1506,5,395,16.0,127.0,127.0,5,1111,16.0,843.0,843.0
0.005,6,10,2006,5,927,1.0,659.0,659.0,5,1079,1.0,811.0,811.0
0.074,6,10,1506,5,395,16.0,127.0,127.0,5,1111,18.0,843.0,843.0
0.1,6,10,1506,5,395,20.0,127.0,127.0,5,1111,23.0,843.0,843.0
0.029,17,2,198,1,91,0.0,63.0,63.0,1,107,0.0,79.0,79.0
240.847,6,25,8148,13,1451,20070.0,417.0,255.0,12,6697,21888.0,1402.0,866.0
0.017,6,10,1631,5,848,4.0,580.0,580.0,5,783,4.0,515.0,515.0
0.005,6,10,2000,5,927,1.0,659.0,659.0,5,1073,1.0,805.0,805.0
11.068,17,28,4395,14,2312,842.0,587.0,137.0,14,2083,842.0,270.0,120.0
0.005,6,10,1779,5,928,1.0,660.0,660.0,5,851,1.0,583.0,583.0
0.008,6,10,1631,5,848,2.0,580.0,580.0,5,783,1.0,515.0,515.0
0.013,6,10,1990,5,911,3.0,643.0,643.0,5,1079,3.0,811.0,811.0
0.09,6,10,1506,5,395,20.0,127.0,127.0,5,1111,20.0,843.0,843.0
44.866,6,268,244736,147,233037,136.0,4080.0,1831.0,121,11699,372.0,2667.0,236.0
0.004,6,10,2007,5,928,1.0,660.0,660.0,5,1079,1.0,811.0,811.0
0.01,6,13,3690,7,452,1.0,80.0,80.0,6,3238,1.0,1470.0,1459.0
0.004,17,4,284,2,120,0.0,32.0,32.0,2,164,0.0,60.0,54.0
0.002,17,2,180,1,66,0.0,38.0,38.0,1,114,0.0,86.0,86.0
0.005,6,10,2000,5,927,1.0,659.0,659.0,5,1073,1.0,805.0,805.0
0.005,6,14,3736,7,446,0.0,74.0,74.0,7,3290,0.0,1448.0,972.0
40.047,17,10,676,5,460,10010.0,104.0,64.0,5,216,10010.0,20.0,15.0
0.005,6,10,2006,5,927,1.0,659.0,659.0,5,1079,1.0,811.0,811.0
0.04,17,2,148,1,60,0.0,32.0,32.0,1,88,0.0,60.0,60.0
0.006,6,10,2006,5,927,1.0,659.0,659.0,5,1079,1.0,811.0,811.0
0.015,6,10,1677,5,827,3.0,559.0,559.0,5,850,3.0,582.0,582.0
0.005,17,2,170,1,65,0.0,37.0,37.0,1,105,0.0,77.0,77.0
0.004,17,2,136,1,60,0.0,32.0,32.0,1,76,0.0,48.0,48.0
0.008,6,12,1926,6,1189,1.0,659.0,434.0,6,737,1.0,417.0,417.0
0.013,6,10,1989,5,910,3.0,642.0,642.0,5,1079,3.0,811.0,811.0
0.022,6,10,1972,5,910,5.0,642.0,642.0,5,1062,5.0,794.0,794.0
0.016,6,10,1972,5,910,4.0,642.0,642.0,5,1062,4.0,794.0,794.0
0.004,6,10,2000,5,927,1.0,659.0,659.0,5,1073,1.0,805.0,805.0
0.012,6,10,1989,5,910,3.0,642.0,642.0,5,1079,3.0,811.0,811.0
0.012,6,10,1990,5,911,3.0,643.0,643.0,5,1079,3.0,811.0,811.0
0.012,6,10,1989,5,910,3.0,642.0,642.0,5,1079,2.0,811.0,811.0
0.005,6,10,1989,5,927,1.0,659.0,659.0,5,1062,1.0,794.0,794.0
40.069,17,10,676,5,460,10014.0,104.0,64.0,5,216,10016.0,20.0,15.0
0.005,6,10,1989,5,927,1.0,659.0,659.0,5,1062,1.0,794.0,794.0
10.899,17,28,4422,14,1995,829.0,270.0,114.0,14,2427,829.0,586.0,145.0
0.011,6,10,1677,5,827,2.0,559.0,559.0,5,850,2.0,582.0,582.0
0.006,6,10,1643,5,860,1.0,592.0,592.0,5,783,1.0,515.0,515.0
0.096,6,10,1506,5,395,23.0,127.0,127.0,5,1111,22.0,843.0,843.0
0.029,6,20,9974,11,704,2.0,124.0,124.0,9,9270,3.0,2896.0,1758.0
0.264,6,10,1972,5,910,66.0,642.0,642.0,5,1062,65.0,794.0,794.0
0.006,17,2,170,1,65,0.0,37.0,37.0,1,105,0.0,77.0,77.0
1.027,6,13,3922,7,2139,129.0,1328.0,923.0,6,1783,153.0,1539.0,1539.0
0.011,6,12,1926,6,1189,2.0,659.0,434.0,6,737,2.0,417.0,417.0
0.071,17,8,3613,4,1874,23.0,1350.0,440.0,4,1739,11.0,1350.0,406.0
290.711,6,314,344081,132,18413,2219.0,2690.0,825.0,182,325668,1606.0,2804.0,1870.0
0.015,6,10,1983,5,910,3.0,642.0,642.0,5,1073,3.0,805.0,805.0
0.008,6,10,1989,5,910,1.0,642.0,642.0,5,1079,2.0,811.0,811.0
0.001,17,2,180,1,66,0.0,38.0,38.0,1,114,0.0,86.0,86.0
0.006,6,10,1689,5,839,1.0,571.0,571.0,5,850,1.0,582.0,582.0
0.004,6,10,2006,5,927,1.0,659.0,659.0,5,1079,1.0,811.0,811.0
0.072,17,2,170,1,65,0.0,37.0,37.0,1,105,0.0,77.0,77.0
0.016,6,10,1989,5,910,4.0,642.0,642.0,5,1079,4.0,811.0,811.0
0.006,6,10,2006,5,927,1.0,659.0,659.0,5,1079,1.0,811.0,811.0
15.078,17,16,9303,8,6912,2150.0,1350.0,836.0,8,2391,2149.0,1350.0,270.0
0.013,17,2,140,1,62,0.0,34.0,34.0,1,78,0.0,50.0,50.0
0.129,17,2,80,1,32,0.0,4.0,4.0,1,48,0.0,20.0,20.0
0.035,17,2,152,1,76,0.0,48.0,48.0,1,76,0.0,48.0,48.0
0.011,6,10,1983,5,910,2.0,642.0,642.0,5,1073,2.0,805.0,805.0
0.08,6,10,1506,5,395,17.0,127.0,127.0,5,1111,18.0,843.0,843.0
240.025,6,9,787,5,488,60006.0,232.0,232.0,4,299,80007.0,83.0,83.0
0.011,6,10,1605,5,388,2.0,120.0,120.0,5,1217,2.0,949.0,949.0
0.141,6,10,1506,5,395,31.0,127.0,127.0,5,1111,26.0,843.0,843.0
0.011,6,10,1990,5,911,2.0,643.0,643.0,5,1079,2.0,811.0,811.0
40.06,17,10,676,5,460,10012.0,104.0,64.0,5,216,10013.0,20.0,15.0
0.113,6,10,1506,5,395,25.0,127.0,127.0,5,1111,24.0,843.0,843.0
240.009,6,9,787,5,488,60002.0,232.0,232.0,4,299,80002.0,83.0,83.0
291.146,6,379,347075,186,21230,1573.0,2688.0,888.0,193,325845,1516.0,4206.0,1764.0
0.088,6,10,1506,5,395,19.0,127.0,127.0,5,1111,20.0,843.0,843.0
0.062,6,10,1506,5,395,13.0,127.0,127.0,5,1111,14.0,843.0,843.0
0.004,17,2,148,1,60,0.0,32.0,32.0,1,88,0.0,60.0,60.0
0.094,6,10,1506,5,395,21.0,127.0,127.0,5,1111,20.0,843.0,843.0
0.012,6,10,1983,5,910,3.0,642.0,642.0,5,1073,2.0,805.0,805.0
0.01,6,10,2007,5,928,2.0,660.0,660.0,5,1079,2.0,811.0,811.0
0.007,6,14,3787,7,497,1.0,125.0,125.0,7,3290,1.0,1448.0,972.0
0.006,6,10,1547,5,764,1.0,496.0,496.0,5,783,1.0,515.0,515.0
0.007,6,10,1990,5,911,1.0,643.0,643.0,5,1079,1.0,811.0,811.0
0.007,6,10,1989,5,927,1.0,659.0,659.0,5,1062,1.0,794.0,794.0
0.041,17,2,182,1,65,0.0,37.0,37.0,1,117,0.0,89.0,89.0
0.005,6,10,1854,5,889,1.0,621.0,621.0,5,965,1.0,697.0,697.0
309.026,17,20,1124,10,716,34322.0,48.0,43.0,10,408,34322.0,20.0,12.0
0.091,6,10,1506,5,395,21.0,127.0,127.0,5,1111,20.0,843.0,843.0
11.082,17,28,4421,14,1993,840.0,268.0,114.0,14,2428,840.0,587.0,145.0
0.006,6,10,1547,5,764,1.0,496.0,496.0,5,783,1.0,515.0,515.0
0.092,6,10,1506,5,395,20.0,127.0,127.0,5,1111,18.0,843.0,843.0
0.005,6,10,2007,5,928,1.0,660.0,660.0,5,1079,1.0,811.0,811.0
0.113,6,10,1506,5,395,28.0,127.0,127.0,5,1111,26.0,843.0,843.0
0.012,6,10,1989,5,910,3.0,642.0,642.0,5,1079,3.0,811.0,811.0
0.005,6,10,1689,5,839,1.0,571.0,571.0,5,850,1.0,582.0,582.0
1797.059,6,285,26843,144,9856,12566.0,747.0,295.0,141,16987,12836.0,1625.0,71.0
0.007,17,2,194,1,59,0.0,31.0,31.0,1,135,0.0,107.0,107.0
0.003,6,10,1702,5,863,0.0,595.0,595.0,5,839,0.0,571.0,571.0
0.008,6,10,1972,5,910,2.0,642.0,642.0,5,1062,1.0,794.0,794.0
0.007,17,2,194,1,59,0.0,31.0,31.0,1,135,0.0,107.0,107.0
0.067,6,10,1506,5,395,14.0,127.0,127.0,5,1111,16.0,843.0,843.0
0.01,6,10,1972,5,910,2.0,642.0,642.0,5,1062,2.0,794.0,794.0
0.078,6,10,1506,5,395,19.0,127.0,127.0,5,1111,16.0,843.0,843.0
0.015,6,10,1989,5,910,3.0,642.0,642.0,5,1079,3.0,811.0,811.0
0.004,17,4,284,2,120,0.0,32.0,32.0,2,164,1.0,60.0,54.0
1778.085,17,143,41496,72,22752,25043.0,288.0,288.0,71,18744,25401.0,236.0,236.0
0.02,6,10,1990,5,911,4.0,643.0,643.0,5,1079,5.0,811.0,811.0
0.103,6,10,1506,5,395,23.0,127.0,127.0,5,1111,23.0,843.0,843.0
0.111,6,10,1506,5,395,24.0,127.0,127.0,5,1111,22.0,843.0,843.0
0.008,6,10,1989,5,910,2.0,642.0,642.0,5,1079,1.0,811.0,811.0
0.134,6,10,1506,5,395,31.0,127.0,127.0,5,1111,27.0,843.0,843.0
0.183,6,3,453,2,321,183.0,241.0,241.0,1,132,0.0,92.0,92.0
66.334,6,27,17547,15,9603,4738.0,2847.0,1469.0,12,7944,6015.0,2315.0,1218.0
0.005,17,2,169,1,62,0.0,34.0,34.0,1,107,0.0,79.0,79.0
0.005,17,2,214,1,75,0.0,47.0,47.0,1,139,0.0,111.0,111.0
0.013,6,10,1989,5,910,3.0,642.0,642.0,5,1079,3.0,811.0,811.0
0.013,6,10,1989,5,910,3.0,642.0,642.0,5,1079,3.0,811.0,811.0
0.005,6,10,1989,5,927,1.0,659.0,659.0,5,1062,1.0,794.0,794.0
0.004,17,2,234,1,61,0.0,33.0,33.0,1,173,0.0,145.0,145.0
0.01,6,10,1983,5,910,2.0,642.0,642.0,5,1073,2.0,805.0,805.0
0.006,6,10,1689,5,839,1.0,571.0,571.0,5,850,1.0,582.0,582.0
0.025,6,10,1990,5,911,6.0,643.0,643.0,5,1079,6.0,811.0,811.0
0.013,6,10,1989,5,910,3.0,642.0,642.0,5,1079,3.0,811.0,811.0
10.965,17,28,4423,14,1995,834.0,270.0,114.0,14,2428,834.0,587.0,145.0
0.004,17,2,148,1,60,0.0,32.0,32.0,1,88,0.0,60.0,60.0
1770.617,17,120,11460,60,5460,30010.0,63.0,63.0,60,6000,30010.0,72.0,72.0
0.011,6,10,1972,5,910,2.0,642.0,642.0,5,1062,2.0,794.0,794.0
0.073,6,10,1506,5,395,17.0,127.0,127.0,5,1111,17.0,843.0,843.0
0.005,6,10,1643,5,860,1.0,592.0,592.0,5,783,1.0,515.0,515.0
0.004,6,10,1774,5,923,1.0,655.0,655.0,5,851,1.0,583.0,583.0
40.054,17,10,676,5,460,10012.0,104.0,64.0,5,216,10012.0,20.0,15.0
0.071,6,10,1506,5,395,16.0,127.0,127.0,5,1111,15.0,843.0,843.0
0.007,6,10,1990,5,911,1.0,643.0,643.0,5,1079,1.0,811.0,811.0
0.077,6,10,1506,5,395,17.0,127.0,127.0,5,1111,14.0,843.0,843.0
309.82,17,20,1124,10,716,34409.0,48.0,43.0,10,408,34409.0,20.0,12.0
0.08,6,10,1506,5,395,17.0,127.0,127.0,5,1111,19.0,843.0,843.0
300.207,6,32,12099,16,6386,20013.0,2208.0,922.0,16,5713,20013.0,1656.0,697.0
0.07,6,10,1506,5,395,16.0,127.0,127.0,5,1111,15.0,843.0,843.0
0.068,6,10,1506,5,395,12.0,127.0,127.0,5,1111,15.0,843.0,843.0
0.004,6,10,2006,5,927,1.0,659.0,659.0,5,1079,1.0,811.0,811.0
0.073,6,10,1506,5,395,16.0,127.0,127.0,5,1111,14.0,843.0,843.0
0.006,17,2,160,1,72,0.0,44.0,44.0,1,88,0.0,60.0,60.0
0.004,6,10,1989,5,927,1.0,659.0,659.0,5,1062,1.0,794.0,794.0
240.021,6,9,787,5,488,60005.0,232.0,232.0,4,299,80006.0,83.0,83.0
1756.886,6,103,6166,59,3473,30290.0,27.0,27.0,44,2693,40856.0,27.0,27.0
0.004,17,4,284,2,120,0.0,32.0,32.0,2,164,1.0,60.0,54.0
15.088,17,15,8528,8,6408,2151.0,1350.0,773.0,7,2120,2509.0,1350.0,274.0
40.073,17,10,676,5,460,10015.0,104.0,64.0,5,216,10017.0,20.0,15.0
0.001,17,2,180,1,66,0.0,38.0,38.0,1,114,0.0,86.0,86.0
0.081,6,10,1506,5,395,18.0,127.0,127.0,5,1111,17.0,843.0,843.0
240.091,6,31,9548,15,6992,17149.0,2116.0,690.0,16,2556,16005.0,580.0,214.0
0.073,6,10,1506,5,395,17.0,127.0,127.0,5,1111,15.0,843.0,843.0
0.006,6,10,1774,5,923,1.0,655.0,655.0,5,851,1.0,583.0,583.0
0.003,17,2,148,1,60,0.0,32.0,32.0,1,88,0.0,60.0,60.0
40.065,17,10,676,5,460,10013.0,104.0,64.0,5,216,10015.0,20.0,15.0
0.103,6,10,1506,5,395,22.0,127.0,127.0,5,1111,24.0,843.0,843.0
0.006,6,10,1547,5,764,1.0,496.0,496.0,5,783,1.0,515.0,515.0
0.078,6,10,1506,5,395,17.0,127.0,127.0,5,1111,17.0,843.0,843.0
165.635,6,28,9605,14,1707,12741.0,794.0,367.0,14,7898,12730.0,1360.0,732.0
0.006,6,10,1643,5,860,1.0,592.0,592.0,5,783,1.0,515.0,515.0
0.017,17,2,198,1,91,0.0,63.0,63.0,1,107,0.0,79.0,79.0
0.027,6,13,3735,7,497,4.0,125.0,125.0,6,3238,5.0,1470.0,1459.0
40.077,17,10,676,5,460,10018.0,104.0,64.0,5,216,10018.0,20.0,15.0
0.004,6,10,2007,5,928,1.0,660.0,660.0,5,1079,1.0,811.0,811.0
0.005,17,2,214,1,75,0.0,47.0,47.0,1,139,0.0,111.0,111.0
0.06,17,2,152,1,76,0.0,48.0,48.0,1,76,0.0,48.0,48.0
0.006,6,10,1689,5,839,1.0,571.0,571.0,5,850,1.0,582.0,582.0
0.004,6,10,1989,5,927,1.0,659.0,659.0,5,1062,1.0,794.0,794.0
0.015,6,10,1631,5,848,3.0,580.0,580.0,5,783,3.0,515.0,515.0
40.083,17,10,676,5,460,10019.0,104.0,64.0,5,216,10019.0,20.0,15.0
0.04,17,4,352,2,130,0.0,37.0,37.0,2,222,1.0,89.0,83.0
15.071,17,15,9238,8,6902,2149.0,1350.0,834.0,7,2336,2506.0,1350.0,305.0
69.512,6,22,9233,11,1575,78.0,794.0,367.0,11,7658,6938.0,1360.0,1029.0
0.01,6,10,1989,5,910,2.0,642.0,642.0,5,1079,2.0,811.0,811.0
308.7,17,20,1124,10,716,34286.0,48.0,43.0,10,408,34286.0,20.0,12.0
11.178,17,28,4417,14,1994,847.0,269.0,114.0,14,2423,847.0,586.0,145.0
0.031,6,10,1972,5,910,7.0,642.0,642.0,5,1062,7.0,794.0,794.0
0.012,6,10,1989,5,910,3.0,642.0,642.0,5,1079,3.0,811.0,811.0
0.013,6,10,1972,5,910,3.0,642.0,642.0,5,1062,3.0,794.0,794.0
0.015,6,10,1972,5,910,3.0,642.0,642.0,5,1062,3.0,794.0,794.0
0.009,17,2,170,1,65,0.0,37.0,37.0,1,105,0.0,77.0,77.0
0.005,6,13,3747,7,509,0.0,137.0,137.0,6,3238,0.0,1470.0,1459.0
240.024,6,9,787,5,488,60006.0,232.0,232.0,4,299,80004.0,83.0,83.0
0.021,6,10,1972,5,910,5.0,642.0,642.0,5,1062,5.0,794.0,794.0
0.005,6,10,2007,5,928,1.0,660.0,660.0,5,1079,1.0,811.0,811.0
0.01,6,10,1677,5,827,2.0,559.0,559.0,5,850,2.0,582.0,582.0
0.012,6,12,1926,6,1189,2.0,659.0,434.0,6,737,2.0,417.0,417.0
0.017,6,10,1989,5,927,4.0,659.0,659.0,5,1062,4.0,794.0,794.0
0.005,6,10,2006,5,927,1.0,659.0,659.0,5,1079,1.0,811.0,811.0
0.004,17,2,148,1,60,0.0,32.0,32.0,1,88,0.0,60.0,60.0
0.075,6,10,1506,5,395,18.0,127.0,127.0,5,1111,18.0,843.0,843.0
0.014,6,10,1762,5,911,3.0,643.0,643.0,5,851,3.0,583.0,583.0
0.016,6,10,1989,5,910,4.0,642.0,642.0,5,1079,3.0,811.0,811.0
0.001,17,2,180,1,66,0.0,38.0,38.0,1,114,0.0,86.0,86.0
0.127,6,10,1677,5,827,31.0,559.0,559.0,5,850,31.0,582.0,582.0
0.011,6,10,1983,5,910,2.0,642.0,642.0,5,1073,2.0,805.0,805.0
0.004,6,10,2007,5,928,1.0,660.0,660.0,5,1079,1.0,811.0,811.0
0.005,6,10,2006,5,927,1.0,659.0,659.0,5,1079,1.0,811.0,811.0
0.004,6,10,1774,5,923,1.0,655.0,655.0,5,851,1.0,583.0,583.0
0.004,6,10,1779,5,928,1.0,660.0,660.0,5,851,1.0,583.0,583.0
0.007,17,2,230,1,68,0.0,40.0,40.0,1,162,0.0,134.0,134.0
0.007,17,2,194,1,59,0.0,31.0,31.0,1,135,0.0,107.0,107.0
0.011,6,10,1631,5,848,2.0,580.0,580.0,5,783,2.0,515.0,515.0
0.107,6,10,1506,5,395,24.0,127.0,127.0,5,1111,22.0,843.0,843.0
0.005,6,10,1689,5,839,1.0,571.0,571.0,5,850,1.0,582.0,582.0
0.006,6,10,1547,5,764,1.0,496.0,496.0,5,783,1.0,515.0,515.0
0.004,6,10,1989,5,927,1.0,659.0,659.0,5,1062,1.0,794.0,794.0
0.006,17,2,170,1,65,0.0,37.0,37.0,1,105,0.0,77.0,77.0
0.012,6,10,1990,5,911,3.0,643.0,643.0,5,1079,3.0,811.0,811.0
0.005,6,13,3747,7,509,0.0,137.0,137.0,6,3238,0.0,1470.0,1459.0
0.012,6,10,1972,5,910,3.0,642.0,642.0,5,1062,3.0,794.0,794.0
40.075,17,10,676,5,460,10017.0,104.0,64.0,5,216,10017.0,20.0,15.0
10.922,17,26,4099,13,1847,901.0,270.0,114.0,13,2252,901.0,587.0,145.0
317.823,17,20,1124,10,716,35305.0,48.0,43.0,10,408,35305.0,20.0,12.0
40.067,17,10,676,5,460,10014.0,104.0,64.0,5,216,10015.0,20.0,15.0
5.323,6,27,7253,15,1955,379.0,801.0,282.0,12,5298,483.0,1925.0,668.0
0.013,6,10,1989,5,910,3.0,642.0,642.0,5,1079,3.0,811.0,811.0
0.004,17,2,136,1,60,0.0,32.0,32.0,1,76,0.0,48.0,48.0
0.006,17,2,299,1,65,0.0,37.0,37.0,1,234,0.0,206.0,206.0
0.005,17,2,170,1,65,0.0,37.0,37.0,1,105,0.0,77.0,77.0
0.005,6,10,2000,5,927,1.0,659.0,659.0,5,1073,1.0,805.0,805.0
151.349,58,3,216,2,144,151349.0,24.0,24.0,1,72,0.0,24.0,24.0
0.003,17,2,136,1,60,0.0,32.0,32.0,1,76,0.0,48.0,48.0
11.223,17,28,4423,14,1995,850.0,270.0,114.0,14,2428,850.0,587.0,145.0
0.013,6,10,1677,5,827,3.0,559.0,559.0,5,850,3.0,582.0,582.0
40.054,17,10,676,5,460,10012.0,104.0,64.0,5,216,10009.0,20.0,15.0
0.064,6,10,1506,5,395,15.0,127.0,127.0,5,1111,12.0,843.0,843.0
240.096,6,16,4481,9,963,30012.0,238.0,166.0,7,3518,40015.0,1402.0,786.0
0.014,6,10,1677,5,827,3.0,559.0,559.0,5,850,3.0,582.0,582.0
176.298,17,80,11502,40,2689,4520.0,44.0,39.0,40,8813,4520.0,260.0,192.0
0.005,17,2,140,1,62,0.0,34.0,34.0,1,78,0.0,50.0,50.0
0.012,6,10,1677,5,827,3.0,559.0,559.0,5,850,2.0,582.0,582.0
0.091,6,10,1506,5,395,21.0,127.0,127.0,5,1111,19.0,843.0,843.0
0.006,6,10,1547,5,764,1.0,496.0,496.0,5,783,1.0,515.0,515.0
0.013,6,10,1972,5,910,3.0,642.0,642.0,5,1062,3.0,794.0,794.0
0.006,6,10,1643,5,860,1.0,592.0,592.0,5,783,1.0,515.0,515.0
0.018,6,10,1972,5,910,4.0,642.0,642.0,5,1062,4.0,794.0,794.0
0.134,6,10,1506,5,395,29.0,127.0,127.0,5,1111,29.0,843.0,843.0
240.181,6,43,9804,21,2383,12008.0,517.0,181.0,22,7421,11437.0,2380.0,626.0
0.095,6,10,1506,5,395,19.0,127.0,127.0,5,1111,18.0,843.0,843.0
0.005,6,10,2007,5,928,1.0,660.0,660.0,5,1079,1.0,811.0,811.0
0.013,17,2,152,1,56,0.0,28.0,28.0,1,96,0.0,68.0,68.0
0.006,6,10,1547,5,764,1.0,496.0,496.0,5,783,1.0,515.0,515.0
0.005,6,10,1689,5,839,1.0,571.0,571.0,5,850,1.0,582.0,582.0
0.064,6,10,1506,5,395,15.0,127.0,127.0,5,1111,14.0,843.0,843.0
0.006,6,10,1547,5,764,1.0,496.0,496.0,5,783,1.0,515.0,515.0
0.012,6,10,1990,5,911,3.0,643.0,643.0,5,1079,2.0,811.0,811.0
316.842,17,20,1124,10,716,35189.0,48.0,43.0,10,408,35189.0,20.0,12.0
0.08,6,10,1506,5,395,16.0,127.0,127.0,5,1111,19.0,843.0,843.0
40.061,17,10,676,5,460,10014.0,104.0,64.0,5,216,10014.0,20.0,15.0
0.068,6,10,1506,5,395,14.0,127.0,127.0,5,1111,14.0,843.0,843.0
0.004,6,10,1702,5,863,1.0,595.0,595.0,5,839,0.0,571.0,571.0
0.005,6,10,2000,5,927,1.0,659.0,659.0,5,1073,1.0,805.0,805.0
0.006,6,10,1643,5,860,1.0,592.0,592.0,5,783,1.0,515.0,515.0
0.154,6,10,1506,5,395,34.0,127.0,127.0,5,1111,37.0,843.0,843.0
0.005,17,2,144,1,64,0.0,36.0,36.0,1,80,0.0,52.0,52.0
0.002,17,2,144,1,64,0.0,36.0,36.0,1,80,0.0,52.0,52.0
0.259,17,39,20130,22,17073,12.0,1350.0,748.0,17,3057,12.0,1350.0,151.0
0.001,17,2,166,1,75,0.0,47.0,47.0,1,91,0.0,63.0,63.0
0.006,6,10,1689,5,839,1.0,571.0,571.0,5,850,1.0,582.0,582.0
0.005,6,10,2006,5,927,1.0,659.0,659.0,5,1079,1.0,811.0,811.0
0.005,6,10,1689,5,839,1.0,571.0,571.0,5,850,1.0,582.0,582.0
0.066,6,10,1506,5,395,14.0,127.0,127.0,5,1111,14.0,843.0,843.0
0.003,17,2,136,1,60,0.0,32.0,32.0,1,76,0.0,48.0,48.0
0.005,6,10,2006,5,927,1.0,659.0,659.0,5,1079,1.0,811.0,811.0
0.016,6,10,1677,5,827,4.0,559.0,559.0,5,850,4.0,582.0,582.0
0.095,6,10,1506,5,395,20.0,127.0,127.0,5,1111,20.0,843.0,843.0
0.015,6,10,1989,5,910,3.0,642.0,642.0,5,1079,3.0,811.0,811.0
0.015,6,10,1972,5,910,3.0,642.0,642.0,5,1062,3.0,794.0,794.0
40.059,17,10,676,5,460,10013.0,104.0,64.0,5,216,10013.0,20.0,15.0
0.065,6,10,1506,5,395,15.0,127.0,127.0,5,1111,13.0,843.0,843.0
0.085,6,10,1506,5,395,19.0,127.0,127.0,5,1111,20.0,843.0,843.0
0.039,17,2,136,1,60,0.0,32.0,32.0,1,76,0.0,48.0,48.0
0.13,17,2,234,1,61,0.0,33.0,33.0,1,173,0.0,145.0,145.0
0.042,6,20,9974,11,704,4.0,124.0,124.0,9,9270,5.0,2896.0,1758.0
0.061,6,10,1506,5,395,14.0,127.0,127.0,5,1111,13.0,843.0,843.0
40.059,17,10,676,5,460,10013.0,104.0,64.0,5,216,10014.0,20.0,15.0
0.064,6,10,1506,5,395,13.0,127.0,127.0,5,1111,14.0,843.0,843.0
10.918,17,28,4421,14,1993,831.0,268.0,114.0,14,2428,831.0,587.0,145.0
0.128,6,10,1506,5,395,31.0,127.0,127.0,5,1111,26.0,843.0,843.0
0.009,6,10,1972,5,910,2.0,642.0,642.0,5,1062,2.0,794.0,794.0
0.245,17,45,28080,27,24831,9.0,1350.0,891.0,18,3249,11.0,1350.0,152.0
0.217,6,10,1506,5,395,39.0,127.0,127.0,5,1111,47.0,843.0,843.0
0.086,17,8,3613,4,1874,28.0,1350.0,440.0,4,1739,11.0,1350.0,406.0
0.005,6,10,1643,5,860,1.0,592.0,592.0,5,783,1.0,515.0,515.0
0.007,6,10,1854,5,889,1.0,621.0,621.0,5,965,1.0,697.0,697.0
0.004,6,10,2007,5,928,1.0,660.0,660.0,5,1079,1.0,811.0,811.0
0.018,6,10,1677,5,827,4.0,559.0,559.0,5,850,4.0,582.0,582.0
0.007,6,10,1547,5,764,1.0,496.0,496.0,5,783,1.0,515.0,515.0
0.007,6,10,1547,5,764,1.0,496.0,496.0,5,783,1.0,515.0,515.0
0.109,6,10,1506,5,395,25.0,127.0,127.0,5,1111,26.0,843.0,843.0
0.011,6,10,1990,5,911,2.0,643.0,643.0,5,1079,2.0,811.0,811.0
0.127,6,10,1506,5,395,29.0,127.0,127.0,5,1111,29.0,843.0,843.0
0.01,6,10,1972,5,910,2.0,642.0,642.0,5,1062,2.0,794.0,794.0
0.263,17,38,20226,21,17039,13.0,1350.0,783.0,17,3187,12.0,1350.0,159.0
0.012,6,10,1990,5,911,2.0,643.0,643.0,5,1079,2.0,811.0,811.0
0.06,17,2,152,1,76,0.0,48.0,48.0,1,76,0.0,48.0,48.0
0.005,6,10,1989,5,927,1.0,659.0,659.0,5,1062,1.0,794.0,794.0
0.005,6,10,1989,5,927,1.0,659.0,659.0,5,1062,1.0,794.0,794.0
0.004,17,2,148,1,60,0.0,32.0,32.0,1,88,0.0,60.0,60.0
0.004,6,10,1989,5,927,1.0,659.0,659.0,5,1062,1.0,794.0,794.0
0.023,6,10,1762,5,911,5.0,643.0,643.0,5,851,5.0,583.0,583.0
0.013,6,10,1989,5,910,3.0,642.0,642.0,5,1079,3.0,811.0,811.0
0.005,6,10,1643,5,860,1.0,592.0,592.0,5,783,1.0,515.0,515.0
175.048,17,74,10411,37,2472,4862.0,44.0,38.0,37,7939,4862.0,261.0,186.0
0.007,17,2,170,1,65,0.0,37.0,37.0,1,105,0.0,77.0,77.0
300.375,6,16,2170,9,684,37526.0,146.0,146.0,7,1486,50035.0,419.0,398.0
0.09,6,10,1506,5,395,20.0,127.0,127.0,5,1111,19.0,843.0,843.0
0.109,6,10,1506,5,395,24.0,127.0,127.0,5,1111,15.0,843.0,843.0
0.005,6,14,3742,7,452,0.0,80.0,80.0,7,3290,0.0,1448.0,972.0
0.081,6,10,1506,5,395,17.0,127.0,127.0,5,1111,16.0,843.0,843.0
0.004,17,4,284,2,120,0.0,32.0,32.0,2,164,0.0,60.0,54.0
0.005,6,10,2006,5,927,1.0,659.0,659.0,5,1079,1.0,811.0,811.0
310.935,17,20,1124,10,716,34534.0,48.0,43.0,10,408,34534.0,20.0,12.0
0.07,17,8,3613,4,1874,23.0,1350.0,440.0,4,1739,12.0,1350.0,406.0
0.004,6,10,2007,5,928,1.0,660.0,660.0,5,1079,1.0,811.0,811.0
0.005,6,10,2006,5,927,1.0,659.0,659.0,5,1079,1.0,811.0,811.0
0.004,6,10,2000,5,927,1.0,659.0,659.0,5,1073,1.0,805.0,805.0
0.003,17,2,148,1,60,0.0,32.0,32.0,1,88,0.0,60.0,60.0
0.023,6,10,1972,5,910,5.0,642.0,642.0,5,1062,5.0,794.0,794.0
0.006,6,10,1547,5,764,1.0,496.0,496.0,5,783,1.0,515.0,515.0
0.008,6,10,1990,5,911,1.0,643.0,643.0,5,1079,1.0,811.0,811.0
0.004,17,2,136,1,60,0.0,32.0,32.0,1,76,0.0,48.0,48.0
0.072,17,2,156,1,64,0.0,36.0,36.0,1,92,0.0,64.0,64.0
0.019,6,10,1989,5,910,4.0,642.0,642.0,5,1079,4.0,811.0,811.0
0.084,17,2,144,1,64,0.0,36.0,36.0,1,80,0.0,52.0,52.0
0.133,6,10,1506,5,395,30.0,127.0,127.0,5,1111,26.0,843.0,843.0
0.004,6,10,1702,5,863,0.0,595.0,595.0,5,839,1.0,571.0,571.0
0.007,17,2,193,1,71,0.0,43.0,43.0,1,122,0.0,94.0,94.0
0.039,17,2,182,1,65,0.0,37.0,37.0,1,117,0.0,89.0,89.0
0.023,6,10,1972,5,910,5.0,642.0,642.0,5,1062,5.0,794.0,794.0
0.06,6,10,1506,5,395,14.0,127.0,127.0,5,1111,12.0,843.0,843.0
0.057,6,10,1506,5,395,12.0,127.0,127.0,5,1111,13.0,843.0,843.0
10.93,17,28,4421,14,1993,832.0,268.0,114.0,14,2428,832.0,587.0,145.0
0.006,17,2,199,1,68,0.0,40.0,40.0,1,131,0.0,103.0,103.0
0.005,17,2,230,1,68,0.0,40.0,40.0,1,162,0.0,134.0,134.0
0.001,17,2,136,1,60,0.0,32.0,32.0,1,76,0.0,48.0,48.0
0.102,6,10,1506,5,395,21.0,127.0,127.0,5,1111,22.0,843.0,843.0
0.005,6,10,2006,5,927,1.0,659.0,659.0,5,1079,1.0,811.0,811.0
0.005,17,2,170,1,65,0.0,37.0,37.0,1,105,0.0,77.0,77.0
364.41,6,21,1793,16,1030,24294.0,190.0,190.0,5,763,60009.0,462.0,247.0
0.014,6,10,1990,5,911,3.0,643.0,643.0,5,1079,3.0,811.0,811.0
0.006,17,2,170,1,65,0.0,37.0,37.0,1,105,0.0,77.0,77.0
0.005,6,10,1989,5,927,1.0,659.0,659.0,5,1062,1.0,794.0,794.0
40.074,17,10,676,5,460,10017.0,104.0,64.0,5,216,10017.0,20.0,15.0
0.119,6,10,1506,5,395,25.0,127.0,127.0,5,1111,24.0,843.0,843.0
0.074,6,10,1506,5,395,15.0,127.0,127.0,5,1111,17.0,843.0,843.0
0.006,6,10,2006,5,927,1.0,659.0,659.0,5,1079,1.0,811.0,811.0
0.013,6,10,1983,5,910,3.0,642.0,642.0,5,1073,3.0,805.0,805.0
0.004,6,10,2006,5,927,1.0,659.0,659.0,5,1079,1.0,811.0,811.0
0.091,6,10,1506,5,395,20.0,127.0,127.0,5,1111,21.0,843.0,843.0
15.072,17,15,9239,8,6902,2149.0,1350.0,834.0,7,2337,2507.0,1350.0,305.0
0.013,6,10,1972,5,910,3.0,642.0,642.0,5,1062,3.0,794.0,794.0
0.168,6,3,453,2,321,168.0,241.0,241.0,1,132,0.0,92.0,92.0
0.005,6,10,2006,5,927,1.0,659.0,659.0,5,1079,1.0,811.0,811.0
0.004,6,14,3742,7,452,0.0,80.0,80.0,7,3290,0.0,1448.0,972.0
0.004,6,10,2006,5,927,1.0,659.0,659.0,5,1079,1.0,811.0,811.0
0.099,6,10,1506,5,395,21.0,127.0,127.0,5,1111,22.0,843.0,843.0
0.075,17,8,3613,4,1874,25.0,1350.0,440.0,4,1739,11.0,1350.0,406.0
300.943,6,47,19360,25,13682,12539.0,2720.0,1265.0,22,5678,417.0,2667.0,435.0
0.009,6,10,1631,5,848,2.0,580.0,580.0,5,783,2.0,515.0,515.0
0.041,17,2,186,1,61,0.0,33.0,33.0,1,125,0.0,97.0,97.0
0.018,6,10,1990,5,911,4.0,643.0,643.0,5,1079,4.0,811.0,811.0
40.05,17,10,676,5,460,10011.0,104.0,64.0,5,216,10011.0,20.0,15.0
0.005,6,10,2006,5,927,1.0,659.0,659.0,5,1079,1.0,811.0,811.0
0.005,6,10,1547,5,764,1.0,496.0,496.0,5,783,1.0,515.0,515.0
15.074,17,15,8174,8,6087,2149.0,1350.0,732.0,7,2087,2507.0,1350.0,270.0
0.006,17,2,166,1,75,0.0,47.0,47.0,1,91,0.0,63.0,63.0
0.006,17,2,178,1,65,0.0,37.0,37.0,1,113,0.0,85.0,85.0
0.172,17,2,152,1,76,0.0,48.0,48.0,1,76,0.0,48.0,48.0
0.004,6,10,2006,5,927,1.0,659.0,659.0,5,1079,1.0,811.0,811.0
0.085,6,10,1506,5,395,19.0,127.0,127.0,5,1111,16.0,843.0,843.0
0.206,6,10,1506,5,395,46.0,127.0,127.0,5,1111,43.0,843.0,843.0
0.001,17,2,180,1,66,0.0,38.0,38.0,1,114,0.0,86.0,86.0
1771.331,6,103,10629,52,3525,34730.0,517.0,203.0,51,7104,35425.0,1402.0,634.0
0.014,6,10,1972,5,910,3.0,642.0,642.0,5,1062,3.0,794.0,794.0
0.006,6,10,1689,5,839,1.0,571.0,571.0,5,850,1.0,582.0,582.0
0.072,6,10,1506,5,395,15.0,127.0,127.0,5,1111,14.0,843.0,843.0
0.123,6,10,1506,5,395,28.0,127.0,127.0,5,1111,27.0,843.0,843.0
40.062,17,10,676,5,460,10012.0,104.0,64.0,5,216,10013.0,20.0,15.0
0.007,6,10,1983,5,910,1.0,642.0,642.0,5,1073,1.0,805.0,805.0
0.093,6,10,1506,5,395,17.0,127.0,127.0,5,1111,22.0,843.0,843.0
0.005,6,13,3747,7,509,0.0,137.0,137.0,6,3238,0.0,1470.0,1459.0
40.072,17,10,676,5,460,10017.0,104.0,64.0,5,216,10017.0,20.0,15.0
0.005,6,10,2006,5,927,1.0,659.0,659.0,5,1079,1.0,811.0,811.0
0.005,17,2,170,1,65,0.0,37.0,37.0,1,105,0.0,77.0,77.0
0.114,6,10,1506,5,395,23.0,127.0,127.0,5,1111,25.0,843.0,843.0
0.017,6,19,9922,11,704,1.0,124.0,124.0,8,9218,2.0,2896.0,2198.0
0.07,17,8,3613,4,1874,23.0,1350.0,440.0,4,1739,12.0,1350.0,406.0
0.067,17,8,3613,4,1874,22.0,1350.0,440.0,4,1739,10.0,1350.0,406.0
0.163,6,10,1506,5,395,38.0,127.0,127.0,5,1111,36.0,843.0,843.0
0.084,6,10,1506,5,395,20.0,127.0,127.0,5,1111,16.0,843.0,843.0
0.173,6,10,1506,5,395,34.0,127.0,127.0,5,1111,40.0,843.0,843.0
0.11,6,10,1506,5,395,25.0,127.0,127.0,5,1111,20.0,843.0,843.0
0.078,6,10,1506,5,395,19.0,127.0,127.0,5,1111,15.0,843.0,843.0
0.073,17,4,420,2,122,0.0,33.0,33.0,2,298,1.0,145.0,121.0
0.01,6,10,1631,5,848,2.0,580.0,580.0,5,783,2.0,515.0,515.0
0.008,6,12,1926,6,1189,1.0,659.0,434.0,6,737,1.0,417.0,417.0
0.005,6,10,2000,5,927,1.0,659.0,659.0,5,1073,1.0,805.0,805.0
40.056,17,10,676,5,460,10012.0,104.0,64.0,5,216,10013.0,20.0,15.0
0.04,17,2,182,1,65,0.0,37.0,37.0,1,117,0.0,89.0,89.0
0.005,6,10,1689,5,839,1.0,571.0,571.0,5,850,1.0,582.0,582.0
0.005,6,10,1854,5,889,1.0,621.0,621.0,5,965,1.0,697.0,697.0
0.063,6,10,1506,5,395,13.0,127.0,127.0,5,1111,14.0,843.0,843.0
0.005,17,2,144,1,64,0.0,36.0,36.0,1,80,0.0,52.0,52.0
0.06,17,2,152,1,76,0.0,48.0,48.0,1,76,0.0,48.0,48.0
0.01,6,10,1989,5,910,2.0,642.0,642.0,5,1079,2.0,811.0,811.0
0.077,17,4,284,2,120,0.0,32.0,32.0,2,164,38.0,60.0,54.0
0.005,6,10,2000,5,927,1.0,659.0,659.0,5,1073,1.0,805.0,805.0
0.08,6,10,1506,5,395,18.0,127.0,127.0,5,1111,17.0,843.0,843.0
0.008,6,10,1989,5,910,2.0,642.0,642.0,5,1079,2.0,811.0,811.0
0.098,6,10,1506,5,395,21.0,127.0,127.0,5,1111,17.0,843.0,843.0
0.006,6,10,2006,5,927,1.0,659.0,659.0,5,1079,1.0,811.0,811.0
0.001,17,2,180,1,66,0.0,38.0,38.0,1,114,0.0,86.0,86.0
0.008,6,12,1926,6,1189,1.0,659.0,434.0,6,737,1.0,417.0,417.0
15.072,17,15,9238,8,6902,2149.0,1350.0,834.0,7,2336,2507.0,1350.0,305.0
0.003,17,2,136,1,60,0.0,32.0,32.0,1,76,0.0,48.0,48.0
0.004,6,10,2000,5,927,1.0,659.0,659.0,5,1073,1.0,805.0,805.0
0.164,17,2,152,1,76,0.0,48.0,48.0,1,76,0.0,48.0,48.0
0.005,6,10,2007,5,928,1.0,660.0,660.0,5,1079,1.0,811.0,811.0
0.018,6,10,1983,5,910,4.0,642.0,642.0,5,1073,4.0,805.0,805.0
0.005,6,10,1989,5,927,1.0,659.0,659.0,5,1062,1.0,794.0,794.0
0.004,6,14,3799,7,509,0.0,137.0,137.0,7,3290,0.0,1448.0,972.0
40.062,17,10,676,5,460,10013.0,104.0,64.0,5,216,10014.0,20.0,15.0
0.006,6,10,2006,5,927,1.0,659.0,659.0,5,1079,1.0,811.0,811.0
0.004,17,2,136,1,60,0.0,32.0,32.0,1,76,0.0,48.0,48.0
0.017,6,10,1972,5,910,4.0,642.0,642.0,5,1062,4.0,794.0,794.0
0.005,17,2,412,1,61,0.0,33.0,33.0,1,351,0.0,323.0,323.0
0.005,6,10,2006,5,927,1.0,659.0,659.0,5,1079,1.0,811.0,811.0
0.096,6,10,1506,5,395,20.0,127.0,127.0,5,1111,20.0,843.0,843.0
0.015,6,10,1762,5,911,3.0,643.0,643.0,5,851,3.0,583.0,583.0
0.01,6,10,1989,5,910,2.0,642.0,642.0,5,1079,2.0,811.0,811.0
0.005,6,10,2006,5,927,1.0,659.0,659.0,5,1079,1.0,811.0,811.0
0.004,17,4,284,2,120,0.0,32.0,32.0,2,164,1.0,60.0,54.0
0.005,6,10,1779,5,928,1.0,660.0,660.0,5,851,1.0,583.0,583.0
0.013,17,4,284,2,120,0.0,32.0,32.0,2,164,0.0,60.0,54.0
0.044,6,10,1631,5,848,10.0,580.0,580.0,5,783,11.0,515.0,515.0
0.004,6,10,2007,5,928,1.0,660.0,660.0,5,1079,1.0,811.0,811.0
0.013,6,10,1989,5,910,3.0,642.0,642.0,5,1079,3.0,811.0,811.0
0.006,6,10,1547,5,764,1.0,496.0,496.0,5,783,1.0,515.0,515.0
40.083,17,10,676,5,460,10018.0,104.0,64.0,5,216,10019.0,20.0,15.0
0.005,6,10,1774,5,923,1.0,655.0,655.0,5,851,1.0,583.0,583.0
0.004,6,10,1779,5,928,1.0,660.0,660.0,5,851,1.0,583.0,583.0
0.011,6,10,2006,5,927,2.0,659.0,659.0,5,1079,2.0,811.0,811.0
178.332,17,76,10748,38,2529,4819.0,44.0,38.0,38,8219,4819.0,239.0,188.0
0.006,6,10,1547,5,764,1.0,496.0,496.0,5,783,1.0,515.0,515.0
0.001,17,2,136,1,60,0.0,32.0,32.0,1,76,0.0,48.0,48.0
240.996,6,44,8825,22,5738,11475.0,1368.0,458.0,22,3087,11475.0,580.0,241.0
0.005,6,10,2007,5,928,1.0,660.0,660.0,5,1079,1.0,811.0,811.0
0.005,17,2,166,1,75,0.0,47.0,47.0,1,91,0.0,63.0,63.0
0.13,6,10,1506,5,395,31.0,127.0,127.0,5,1111,27.0,843.0,843.0
0.005,6,10,2006,5,927,1.0,659.0,659.0,5,1079,1.0,811.0,811.0
9.066,17,6,376,5,280,2266.0,28.0,28.0,1,96,0.0,68.0,68.0
361.813,6,21,1793,16,1030,24120.0,190.0,190.0,5,763,60010.0,462.0,247.0
0.072,17,2,186,1,61,0.0,33.0,33.0,1,125,0.0,97.0,97.0
517.127,6,41,16194,22,5028,24625.0,1473.0,553.0,19,11166,25391.0,1402.0,924.0
0.006,6,10,2007,5,928,1.0,660.0,660.0,5,1079,1.0,811.0,811.0
0.011,6,10,1983,5,910,2.0,642.0,642.0,5,1073,2.0,805.0,805.0
0.009,6,13,3735,7,497,1.0,125.0,125.0,6,3238,1.0,1470.0,1459.0
0.005,6,10,2006,5,927,1.0,659.0,659.0,5,1079,1.0,811.0,811.0
0.005,6,10,1547,5,764,1.0,496.0,496.0,5,783,1.0,515.0,515.0
0.006,6,10,1689,5,839,1.0,571.0,571.0,5,850,1.0,582.0,582.0
0.005,6,10,2006,5,927,1.0,659.0,659.0,5,1079,1.0,811.0,811.0
0.009,6,10,1989,5,910,2.0,642.0,642.0,5,1079,2.0,811.0,811.0
0.796,6,10,2289,6,1935,159.0,1683.0,1683.0,4,354,188.0,182.0,182.0
0.005,6,10,1643,5,860,1.0,592.0,592.0,5,783,1.0,515.0,515.0
40.064,17,10,676,5,460,10015.0,104.0,64.0,5,216,10015.0,20.0,15.0
0.072,17,8,3613,4,1874,24.0,1350.0,440.0,4,1739,12.0,1350.0,406.0
0.005,17,2,164,1,74,0.0,46.0,46.0,1,90,0.0,62.0,62.0
0.004,6,10,2007,5,928,1.0,660.0,660.0,5,1079,1.0,811.0,811.0
0.004,6,10,2000,5,927,1.0,659.0,659.0,5,1073,1.0,805.0,805.0
0.004,6,10,2000,5,927,1.0,659.0,659.0,5,1073,1.0,805.0,805.0
0.003,17,2,186,1,61,0.0,33.0,33.0,1,125,0.0,97.0,97.0
374.953,6,22,2313,16,867,24996.0,195.0,195.0,6,1446,4647.0,419.0,398.0
0.005,6,10,1689,5,839,1.0,571.0,571.0,5,850,1.0,582.0,582.0
0.006,6,10,1854,5,889,1.0,621.0,621.0,5,965,1.0,697.0,697.0
0.074,6,10,1506,5,395,18.0,127.0,127.0,5,1111,15.0,843.0,843.0
11.119,17,28,4419,14,1994,842.0,269.0,114.0,14,2425,842.0,588.0,145.0
0.013,6,10,1989,5,910,3.0,642.0,642.0,5,1079,3.0,811.0,811.0
178.235,17,92,13230,46,3093,3960.0,44.0,39.0,46,10137,3960.0,239.0,192.0
0.006,6,10,1854,5,889,1.0,621.0,621.0,5,965,1.0,697.0,697.0
0.005,17,2,170,1,65,0.0,37.0,37.0,1,105,0.0,77.0,77.0
0.017,6,10,1989,5,910,4.0,642.0,642.0,5,1079,4.0,811.0,811.0
40.088,17,10,676,5,460,10020.0,104.0,64.0,5,216,10021.0,20.0,15.0
10.988,17,28,4366,14,2311,837.0,586.0,137.0,14,2055,837.0,270.0,118.0
0.017,6,10,1990,5,911,4.0,643.0,643.0,5,1079,4.0,811.0,811.0
0.006,6,10,1854,5,889,1.0,621.0,621.0,5,965,1.0,697.0,697.0
308.962,17,20,1124,10,716,34314.0,48.0,43.0,10,408,34314.0,20.0,12.0
0.012,6,10,1983,5,910,3.0,642.0,642.0,5,1073,3.0,805.0,805.0
0.012,6,10,1972,5,910,3.0,642.0,642.0,5,1062,3.0,794.0,794.0
0.129,6,10,1506,5,395,30.0,127.0,127.0,5,1111,29.0,843.0,843.0
0.009,6,10,1972,5,910,2.0,642.0,642.0,5,1062,2.0,794.0,794.0
0.041,17,2,148,1,60,0.0,32.0,32.0,1,88,0.0,60.0,60.0
66.015,6,22,10152,12,3985,6001.0,1591.0,838.0,10,6167,7316.0,2111.0,939.0
0.004,6,10,1989,5,927,1.0,659.0,659.0,5,1062,1.0,794.0,794.0
0.012,6,10,1762,5,911,2.0,643.0,643.0,5,851,3.0,583.0,583.0
0.093,6,10,1506,5,395,20.0,127.0,127.0,5,1111,16.0,843.0,843.0
0.005,6,10,2006,5,927,1.0,659.0,659.0,5,1079,1.0,811.0,811.0
0.069,6,10,1506,5,395,15.0,127.0,127.0,5,1111,16.0,843.0,843.0
0.011,6,13,3735,7,497,1.0,125.0,125.0,6,3238,2.0,1470.0,1459.0
0.071,6,10,1506,5,395,15.0,127.0,127.0,5,1111,14.0,843.0,843.0
0.009,6,10,1989,5,910,2.0,642.0,642.0,5,1079,2.0,811.0,811.0
15.07,17,14,9190,8,6902,2148.0,1350.0,834.0,6,2288,3008.0,1350.0,353.0
0.039,17,2,412,1,61,0.0,33.0,33.0,1,351,0.0,323.0,323.0
0.005,6,10,2006,5,927,1.0,659.0,659.0,5,1079,1.0,811.0,811.0
0.004,6,10,1774,5,923,1.0,655.0,655.0,5,851,0.0,583.0,583.0
0.005,6,10,1989,5,927,1.0,659.0,659.0,5,1062,1.0,794.0,794.0
165.472,17,80,11698,40,2690,4242.0,44.0,39.0,40,9008,4242.0,239.0,197.0
0.084,6,10,1506,5,395,18.0,127.0,127.0,5,1111,18.0,843.0,843.0
0.001,17,2,174,1,72,0.0,44.0,44.0,1,102,0.0,74.0,74.0
0.005,6,10,2006,5,927,1.0,659.0,659.0,5,1079,1.0,811.0,811.0
0.125,6,10,1506,5,395,29.0,127.0,127.0,5,1111,28.0,843.0,843.0
0.039,17,2,136,1,60,0.0,32.0,32.0,1,76,0.0,48.0,48.0
0.01,6,10,1983,5,910,2.0,642.0,642.0,5,1073,2.0,805.0,805.0
1777.651,17,144,45504,72,22752,25037.0,288.0,288.0,72,22752,25037.0,288.0,288.0
0.005,6,10,1774,5,923,1.0,655.0,655.0,5,851,1.0,583.0,583.0
0.002,17,2,148,1,60,0.0,32.0,32.0,1,88,0.0,60.0,60.0
0.001,17,2,180,1,66,0.0,38.0,38.0,1,114,0.0,86.0,86.0
0.006,17,2,180,1,66,0.0,38.0,38.0,1,114,0.0,86.0,86.0
0.006,6,10,1547,5,764,1.0,496.0,496.0,5,783,1.0,515.0,515.0
0.005,17,2,170,1,65,0.0,37.0,37.0,1,105,0.0,77.0,77.0
0.003,17,2,148,1,60,0.0,32.0,32.0,1,88,0.0,60.0,60.0
0.012,6,10,1989,5,910,3.0,642.0,642.0,5,1079,2.0,811.0,811.0
0.001,17,2,180,1,66,0.0,38.0,38.0,1,114,0.0,86.0,86.0
40.072,17,10,676,5,460,10014.0,104.0,64.0,5,216,10017.0,20.0,15.0
0.084,6,18,7612,10,808,9.0,280.0,280.0,8,6804,11.0,1402.0,1276.0
0.014,6,10,1990,5,911,3.0,643.0,643.0,5,1079,3.0,811.0,811.0
0.012,6,10,1983,5,910,2.0,642.0,642.0,5,1073,2.0,805.0,805.0
0.005,6,10,2000,5,927,1.0,659.0,659.0,5,1073,1.0,805.0,805.0
0.069,6,10,1506,5,395,15.0,127.0,127.0,5,1111,15.0,843.0,843.0
0.094,6,10,1506,5,395,22.0,127.0,127.0,5,1111,21.0,843.0,843.0
0.006,6,10,1547,5,764,1.0,496.0,496.0,5,783,1.0,515.0,515.0
0.02,6,10,1989,5,910,5.0,642.0,642.0,5,1079,4.0,811.0,811.0
0.041,17,2,186,1,61,0.0,33.0,33.0,1,125,0.0,97.0,97.0
0.005,17,2,230,1,68,0.0,40.0,40.0,1,162,0.0,134.0,134.0
0.003,17,2,152,1,76,0.0,48.0,48.0,1,76,0.0,48.0,48.0
40.052,17,10,676,5,460,10012.0,104.0,64.0,5,216,10012.0,20.0,15.0
0.004,17,2,152,1,76,0.0,48.0,48.0,1,76,0.0,48.0,48.0
0.0,17,2,136,1,60,0.0,32.0,32.0,1,76,0.0,48.0,48.0
0.103,6,10,1506,5,395,24.0,127.0,127.0,5,1111,23.0,843.0,843.0
178.142,17,72,10154,36,2401,5089.0,44.0,38.0,36,7753,5089.0,239.0,187.0
0.005,6,10,1779,5,928,1.0,660.0,660.0,5,851,1.0,583.0,583.0
0.017,6,10,1677,5,827,4.0,559.0,559.0,5,850,4.0,582.0,582.0
0.005,6,10,2000,5,927,1.0,659.0,659.0,5,1073,1.0,805.0,805.0
0.006,17,2,179,1,71,0.0,43.0,43.0,1,108,0.0,80.0,80.0
0.005,6,10,1989,5,927,1.0,659.0,659.0,5,1062,1.0,794.0,794.0
0.006,6,10,1689,5,839,1.0,571.0,571.0,5,850,1.0,582.0,582.0
0.016,6,10,1972,5,910,4.0,642.0,642.0,5,1062,4.0,794.0,794.0
0.133,6,10,1506,5,395,31.0,127.0,127.0,5,1111,30.0,843.0,843.0
0.017,6,10,1972,5,910,4.0,642.0,642.0,5,1062,4.0,794.0,794.0
0.114,6,10,1506,5,395,27.0,127.0,127.0,5,1111,27.0,843.0,843.0
0.013,6,10,1972,5,910,3.0,642.0,642.0,5,1062,3.0,794.0,794.0
0.012,6,10,1972,5,910,3.0,642.0,642.0,5,1062,3.0,794.0,794.0
0.01,6,10,1631,5,848,2.0,580.0,580.0,5,783,2.0,515.0,515.0
0.004,6,10,2006,5,927,1.0,659.0,659.0,5,1079,1.0,811.0,811.0
240.092,6,16,4482,9,963,30011.0,238.0,166.0,7,3519,40014.0,1402.0,786.0
0.114,6,10,1506,5,395,25.0,127.0,127.0,5,1111,26.0,843.0,843.0
0.013,17,2,170,1,65,0.0,37.0,37.0,1,105,0.0,77.0,77.0
0.072,6,10,1506,5,395,15.0,127.0,127.0,5,1111,15.0,843.0,843.0
0.072,6,10,1506,5,395,17.0,127.0,127.0,5,1111,14.0,843.0,843.0
0.008,17,2,162,1,65,0.0,37.0,37.0,1,97,0.0,69.0,69.0
40.068,17,10,676,5,460,10016.0,104.0,64.0,5,216,10016.0,20.0,15.0
0.038,17,2,136,1,60,0.0,32.0,32.0,1,76,0.0,48.0,48.0
0.005,6,10,1989,5,927,1.0,659.0,659.0,5,1062,1.0,794.0,794.0
0.004,6,10,1702,5,863,0.0,595.0,595.0,5,839,1.0,571.0,571.0
0.005,6,10,2007,5,928,1.0,660.0,660.0,5,1079,1.0,811.0,811.0
0.069,17,8,3613,4,1874,23.0,1350.0,440.0,4,1739,12.0,1350.0,406.0
0.119,6,10,1506,5,395,27.0,127.0,127.0,5,1111,25.0,843.0,843.0
266.805,6,40,13024,16,6399,17787.0,1368.0,794.0,24,6625,11600.0,1656.0,767.0
0.076,6,10,1506,5,395,17.0,127.0,127.0,5,1111,14.0,843.0,843.0
0.072,17,2,148,1,60,0.0,32.0,32.0,1,88,0.0,60.0,60.0
3.62,6,24,7517,13,1385,301.0,530.0,277.0,11,6132,344.0,2720.0,946.0
0.004,6,10,2000,5,927,1.0,659.0,659.0,5,1073,1.0,805.0,805.0
0.012,6,10,1631,5,848,2.0,580.0,580.0,5,783,3.0,515.0,515.0
0.04,17,2,234,1,61,0.0,33.0,33.0,1,173,0.0,145.0,145.0
0.005,6,10,1774,5,923,1.0,655.0,655.0,5,851,1.0,583.0,583.0
0.005,17,2,230,1,68,0.0,40.0,40.0,1,162,0.0,134.0,134.0
240.029,6,9,787,5,488,60007.0,232.0,232.0,4,299,80008.0,83.0,83.0
0.005,6,10,2006,5,927,1.0,659.0,659.0,5,1079,1.0,811.0,811.0
0.011,6,10,1990,5,911,2.0,643.0,643.0,5,1079,2.0,811.0,811.0
0.117,6,10,1506,5,395,26.0,127.0,127.0,5,1111,27.0,843.0,843.0
40.057,17,10,676,5,460,10012.0,104.0,64.0,5,216,10013.0,20.0,15.0
0.005,6,10,2007,5,928,1.0,660.0,660.0,5,1079,1.0,811.0,811.0
0.005,17,2,170,1,65,0.0,37.0,37.0,1,105,0.0,77.0,77.0
1.041,6,12,3134,6,2099,156.0,1328.0,923.0,6,1035,156.0,791.0,791.0
0.022,6,10,1677,5,827,5.0,559.0,559.0,5,850,5.0,582.0,582.0
0.09,6,10,1506,5,395,21.0,127.0,127.0,5,1111,18.0,843.0,843.0
0.1,6,10,1506,5,395,22.0,127.0,127.0,5,1111,21.0,843.0,843.0
0.006,17,2,179,1,71,0.0,43.0,43.0,1,108,0.0,80.0,80.0
10.864,17,28,4420,14,1993,827.0,268.0,114.0,14,2427,827.0,586.0,145.0
0.013,6,10,1983,5,910,3.0,642.0,642.0,5,1073,3.0,805.0,805.0
0.013,6,10,1990,5,911,3.0,643.0,643.0,5,1079,3.0,811.0,811.0
0.017,6,10,1983,5,910,4.0,642.0,642.0,5,1073,4.0,805.0,805.0
0.006,6,10,1547,5,764,1.0,496.0,496.0,5,783,1.0,515.0,515.0
3.967,6,24,7517,13,1385,330.0,530.0,277.0,11,6132,378.0,2720.0,946.0
0.004,6,10,1774,5,923,1.0,655.0,655.0,5,851,1.0,583.0,583.0
0.125,6,10,1506,5,395,25.0,127.0,127.0,5,1111,27.0,843.0,843.0
308.214,17,20,1124,10,716,34231.0,48.0,43.0,10,408,34231.0,20.0,12.0
0.07,17,8,3613,4,1874,23.0,1350.0,440.0,4,1739,12.0,1350.0,406.0
0.044,17,2,136,1,60,0.0,32.0,32.0,1,76,0.0,48.0,48.0
0.226,6,16,2778,8,1396,32.0,533.0,324.0,8,1382,20.0,529.0,239.0
0.005,6,14,3742,7,452,0.0,80.0,80.0,7,3290,0.0,1448.0,972.0
0.042,17,2,152,1,76,0.0,48.0,48.0,1,76,0.0,48.0,48.0
176.37,17,74,10357,37,2474,4898.0,44.0,38.0,37,7883,4898.0,239.0,185.0
40.057,17,10,676,5,460,10013.0,104.0,64.0,5,216,10013.0,20.0,15.0
0.014,6,10,1983,5,910,3.0,642.0,642.0,5,1073,3.0,805.0,805.0
0.072,17,4,352,2,130,0.0,37.0,37.0,2,222,32.0,89.0,83.0
0.014,6,10,1631,5,848,3.0,580.0,580.0,5,783,3.0,515.0,515.0
0.005,6,10,1643,5,860,1.0,592.0,592.0,5,783,1.0,515.0,515.0
0.011,6,10,1989,5,910,2.0,642.0,642.0,5,1079,2.0,811.0,811.0
0.004,6,10,2007,5,928,1.0,660.0,660.0,5,1079,1.0,811.0,811.0
0.095,6,10,1506,5,395,20.0,127.0,127.0,5,1111,22.0,843.0,843.0
292.991,6,303,343120,117,17635,2525.0,2736.0,888.0,186,325485,1583.0,2804.0,1836.0
0.004,6,10,1702,5,863,1.0,595.0,595.0,5,839,0.0,571.0,571.0
0.005,6,10,1774,5,923,1.0,655.0,655.0,5,851,1.0,583.0,583.0
0.018,6,10,1677,5,827,4.0,559.0,559.0,5,850,4.0,582.0,582.0
40.059,17,10,676,5,460,10014.0,104.0,64.0,5,216,10014.0,20.0,15.0
40.058,17,10,676,5,460,10013.0,104.0,64.0,5,216,10013.0,20.0,15.0
0.098,6,10,1506,5,395,18.0,127.0,127.0,5,1111,23.0,843.0,843.0
300.297,6,19,3084,11,1647,30029.0,517.0,266.0,8,1437,34326.0,824.0,337.0
0.016,6,10,1989,5,910,4.0,642.0,642.0,5,1079,4.0,811.0,811.0
0.003,17,2,136,1,60,0.0,32.0,32.0,1,76,0.0,48.0,48.0
0.004,6,10,2006,5,927,1.0,659.0,659.0,5,1079,1.0,811.0,811.0
352.251,6,20,2210,6,1308,12003.0,494.0,494.0,14,902,27096.0,83.0,83.0
485.392,6,33,10704,18,2762,28552.0,676.0,363.0,15,7942,30380.0,1402.0,794.0
40.046,17,10,676,5,460,10010.0,104.0,64.0,5,216,10010.0,20.0,15.0
0.004,6,10,2007,5,928,1.0,660.0,660.0,5,1079,1.0,811.0,811.0
0.008,6,10,1989,5,910,2.0,642.0,642.0,5,1079,2.0,811.0,811.0
300.39,6,16,2170,9,684,37527.0,146.0,146.0,7,1486,50037.0,419.0,398.0
0.093,6,10,1506,5,395,20.0,127.0,127.0,5,1111,19.0,843.0,843.0
0.01,6,10,1972,5,910,2.0,642.0,642.0,5,1062,2.0,794.0,794.0
0.232,6,16,2778,8,1396,33.0,533.0,324.0,8,1382,21.0,529.0,239.0
300.78,6,39,11225,21,5707,15039.0,1763.0,805.0,18,5518,509.0,2667.0,435.0
11.784,17,34,6371,17,2655,726.0,269.0,128.0,17,3716,726.0,1146.0,190.0
0.076,6,10,1506,5,395,16.0,127.0,127.0,5,1111,17.0,843.0,843.0
0.016,6,10,1631,5,848,4.0,580.0,580.0,5,783,4.0,515.0,515.0
0.006,6,10,1547,5,764,1.0,496.0,496.0,5,783,1.0,515.0,515.0
0.009,6,10,1990,5,911,2.0,643.0,643.0,5,1079,2.0,811.0,811.0
0.006,17,2,140,1,62,0.0,34.0,34.0,1,78,0.0,50.0,50.0
0.086,6,10,1506,5,395,20.0,127.0,127.0,5,1111,18.0,843.0,843.0
0.005,6,10,2006,5,927,1.0,659.0,659.0,5,1079,1.0,811.0,811.0
0.005,6,10,1547,5,764,1.0,496.0,496.0,5,783,1.0,515.0,515.0
0.096,6,10,1506,5,395,17.0,127.0,127.0,5,1111,22.0,843.0,843.0
0.012,6,10,1989,5,910,2.0,642.0,642.0,5,1079,3.0,811.0,811.0
15.071,17,15,9239,8,6902,2149.0,1350.0,834.0,7,2337,2507.0,1350.0,305.0
0.005,6,10,1989,5,927,1.0,659.0,659.0,5,1062,1.0,794.0,794.0
0.009,6,13,3735,7,497,1.0,125.0,125.0,6,3238,1.0,1470.0,1459.0
40.058,17,10,676,5,460,10012.0,104.0,64.0,5,216,10013.0,20.0,15.0
40.068,17,10,676,5,460,10016.0,104.0,64.0,5,216,10015.0,20.0,15.0
414.592,6,29,4409,12,3102,10914.0,494.0,494.0,17,1307,25910.0,83.0,83.0
0.016,6,10,1677,5,827,4.0,559.0,559.0,5,850,3.0,582.0,582.0
0.004,17,2,148,1,60,0.0,32.0,32.0,1,88,0.0,60.0,60.0
0.078,6,10,1506,5,395,18.0,127.0,127.0,5,1111,18.0,843.0,843.0
0.006,6,10,1989,5,927,1.0,659.0,659.0,5,1062,1.0,794.0,794.0
0.016,17,2,198,1,91,0.0,63.0,63.0,1,107,0.0,79.0,79.0
0.005,6,14,3742,7,452,0.0,80.0,80.0,7,3290,0.0,1448.0,972.0
0.005,6,10,2007,5,928,1.0,660.0,660.0,5,1079,1.0,811.0,811.0
0.083,6,10,1506,5,395,18.0,127.0,127.0,5,1111,19.0,843.0,843.0
0.081,6,10,1506,5,395,18.0,127.0,127.0,5,1111,16.0,843.0,843.0
40.056,17,10,676,5,460,10013.0,104.0,64.0,5,216,10012.0,20.0,15.0
0.003,17,2,136,1,60,0.0,32.0,32.0,1,76,0.0,48.0,48.0
0.005,6,10,2007,5,928,1.0,660.0,660.0,5,1079,1.0,811.0,811.0
0.004,17,4,284,2,120,0.0,32.0,32.0,2,164,0.0,60.0,54.0
0.091,6,10,1506,5,395,19.0,127.0,127.0,5,1111,19.0,843.0,843.0
0.005,6,10,1854,5,889,1.0,621.0,621.0,5,965,1.0,697.0,697.0
0.006,17,2,293,1,73,0.0,45.0,45.0,1,220,0.0,192.0,192.0
240.377,6,44,8825,22,5738,11446.0,1515.0,509.0,22,3087,11445.0,580.0,241.0
0.006,6,13,3747,7,509,1.0,137.0,137.0,6,3238,1.0,1470.0,1459.0
0.069,6,10,1506,5,395,14.0,127.0,127.0,5,1111,14.0,843.0,843.0
10.913,17,28,4421,14,1994,831.0,269.0,114.0,14,2427,831.0,586.0,145.0
1727.872,6,45,2790,30,1725,59581.0,35.0,35.0,15,1065,123407.0,31.0,31.0
0.004,17,2,136,1,60,0.0,32.0,32.0,1,76,0.0,48.0,48.0
15.075,17,15,9238,8,6902,2149.0,1350.0,834.0,7,2336,2507.0,1350.0,305.0
240.083,6,16,4480,9,963,30010.0,238.0,166.0,7,3517,40013.0,1402.0,786.0
0.006,17,2,212,1,74,0.0,46.0,46.0,1,138,0.0,110.0,110.0
0.016,6,10,1631,5,848,3.0,580.0,580.0,5,783,3.0,515.0,515.0
354.048,6,21,1795,16,1030,23603.0,190.0,190.0,5,765,60003.0,464.0,248.0
0.011,6,10,1989,5,910,2.0,642.0,642.0,5,1079,2.0,811.0,811.0
0.005,6,10,2007,5,928,1.0,660.0,660.0,5,1079,1.0,811.0,811.0
0.015,6,10,1677,5,827,3.0,559.0,559.0,5,850,3.0,582.0,582.0
0.014,6,10,1989,5,910,3.0,642.0,642.0,5,1079,3.0,811.0,811.0
0.067,6,10,1506,5,395,13.0,127.0,127.0,5,1111,14.0,843.0,843.0
173.079,17,76,10872,38,2541,4677.0,44.0,38.0,38,8331,4677.0,239.0,191.0
66.328,6,27,17578,15,9627,4737.0,2804.0,1473.0,12,7951,6015.0,2322.0,1219.0
0.006,6,10,1689,5,839,1.0,571.0,571.0,5,850,1.0,582.0,582.0
0.006,6,10,1547,5,764,1.0,496.0,496.0,5,783,1.0,515.0,515.0
15.073,17,15,9238,8,6902,2149.0,1350.0,834.0,7,2336,2507.0,1350.0,305.0
0.039,17,4,288,2,122,0.0,33.0,33.0,2,166,36.0,61.0,55.0
0.009,6,12,1926,6,1189,1.0,659.0,434.0,6,737,1.0,417.0,417.0
0.126,6,10,1506,5,395,29.0,127.0,127.0,5,1111,26.0,843.0,843.0
308.743,17,20,1124,10,716,34289.0,48.0,43.0,10,408,34289.0,20.0,12.0
0.039,17,4,284,2,120,0.0,32.0,32.0,2,164,35.0,60.0,54.0
0.001,17,2,180,1,66,0.0,38.0,38.0,1,114,0.0,86.0,86.0
0.014,6,10,1989,5,910,3.0,642.0,642.0,5,1079,3.0,811.0,811.0
0.005,6,10,2007,5,928,1.0,660.0,660.0,5,1079,1.0,811.0,811.0
0.078,6,10,1506,5,395,16.0,127.0,127.0,5,1111,17.0,843.0,843.0
0.005,17,2,169,1,62,0.0,34.0,34.0,1,107,0.0,79.0,79.0
0.014,6,10,1631,5,848,3.0,580.0,580.0,5,783,3.0,515.0,515.0
0.009,6,10,2006,5,927,2.0,659.0,659.0,5,1079,2.0,811.0,811.0
0.006,6,10,1643,5,860,1.0,592.0,592.0,5,783,1.0,515.0,515.0
0.217,6,10,1506,5,395,52.0,127.0,127.0,5,1111,49.0,843.0,843.0
0.375,17,48,29578,28,24888,13.0,1350.0,860.0,20,4690,17.0,1350.0,206.0
0.005,17,2,214,1,75,0.0,47.0,47.0,1,139,0.0,111.0,111.0
0.005,6,10,2006,5,927,1.0,659.0,659.0,5,1079,1.0,811.0,811.0
0.005,6,10,2006,5,927,1.0,659.0,659.0,5,1079,1.0,811.0,811.0
328.107,17,20,1124,10,716,36447.0,48.0,43.0,10,408,36445.0,20.0,12.0
0.078,6,10,1506,5,395,18.0,127.0,127.0,5,1111,15.0,843.0,843.0
0.016,17,2,198,1,91,0.0,63.0,63.0,1,107,0.0,79.0,79.0
0.008,6,10,1990,5,911,1.0,643.0,643.0,5,1079,1.0,811.0,811.0
308.244,17,19,1084,10,716,34235.0,48.0,43.0,9,368,38515.0,20.0,12.0
0.002,17,2,180,1,66,0.0,38.0,38.0,1,114,0.0,86.0,86.0
0.006,6,10,1547,5,764,1.0,496.0,496.0,5,783,1.0,515.0,515.0
0.005,6,10,2000,5,927,1.0,659.0,659.0,5,1073,1.0,805.0,805.0
0.121,6,10,1506,5,395,24.0,127.0,127.0,5,1111,24.0,843.0,843.0
0.004,6,10,2006,5,927,1.0,659.0,659.0,5,1079,1.0,811.0,811.0
0.007,6,10,1702,5,863,1.0,595.0,595.0,5,839,1.0,571.0,571.0
0.005,6,10,1854,5,889,1.0,621.0,621.0,5,965,1.0,697.0,697.0
0.06,6,10,1506,5,395,14.0,127.0,127.0,5,1111,14.0,843.0,843.0
0.001,17,2,180,1,66,0.0,38.0,38.0,1,114,0.0,86.0,86.0
0.004,6,10,1989,5,927,1.0,659.0,659.0,5,1062,1.0,794.0,794.0
0.01,6,10,1989,5,910,2.0,642.0,642.0,5,1079,2.0,811.0,811.0
0.006,6,10,1547,5,764,1.0,496.0,496.0,5,783,1.0,515.0,515.0
11.139,17,28,4388,14,2311,848.0,586.0,137.0,14,2077,848.0,268.0,120.0
0.077,6,10,1506,5,395,17.0,127.0,127.0,5,1111,16.0,843.0,843.0
0.009,6,10,1989,5,910,2.0,642.0,642.0,5,1079,2.0,811.0,811.0
0.169,17,2,152,1,76,0.0,48.0,48.0,1,76,0.0,48.0,48.0
0.002,17,2,180,1,66,0.0,38.0,38.0,1,114,0.0,86.0,86.0
0.021,6,10,2006,5,927,5.0,659.0,659.0,5,1079,5.0,811.0,811.0
0.005,17,2,169,1,62,0.0,34.0,34.0,1,107,0.0,79.0,79.0
0.077,6,10,1506,5,395,16.0,127.0,127.0,5,1111,16.0,843.0,843.0
518.366,6,47,14742,25,3114,21598.0,664.0,361.0,22,11628,21824.0,1402.0,654.0
0.001,17,2,180,1,66,0.0,38.0,38.0,1,114,0.0,86.0,86.0
0.005,17,2,170,1,65,0.0,37.0,37.0,1,105,0.0,77.0,77.0
0.005,6,10,2007,5,928,1.0,660.0,660.0,5,1079,1.0,811.0,811.0
0.005,6,14,3736,7,446,0.0,74.0,74.0,7,3290,0.0,1448.0,972.0
266.368,6,40,10065,16,6706,17757.0,1780.0,653.0,24,3359,11581.0,580.0,140.0
0.072,17,4,420,2,122,0.0,33.0,33.0,2,298,29.0,145.0,121.0
240.107,6,31,9295,15,6866,17150.0,1991.0,676.0,16,2429,16007.0,580.0,198.0
40.07,17,10,676,5,460,10015.0,104.0,64.0,5,216,10016.0,20.0,15.0
0.017,6,10,1990,5,911,4.0,643.0,643.0,5,1079,4.0,811.0,811.0
0.015,6,10,1983,5,910,3.0,642.0,642.0,5,1073,3.0,805.0,805.0
0.015,6,10,1983,5,910,3.0,642.0,642.0,5,1073,3.0,805.0,805.0
240.099,6,16,4482,9,963,30012.0,238.0,166.0,7,3519,40016.0,1402.0,786.0
0.007,6,10,1989,5,910,1.0,642.0,642.0,5,1079,1.0,811.0,811.0
0.003,17,2,148,1,60,0.0,32.0,32.0,1,88,0.0,60.0,60.0
0.01,6,10,1989,5,910,2.0,642.0,642.0,5,1079,2.0,811.0,811.0
0.005,17,2,169,1,62,0.0,34.0,34.0,1,107,0.0,79.0,79.0
0.171,6,10,1506,5,395,40.0,127.0,127.0,5,1111,34.0,843.0,843.0
0.012,6,10,1983,5,910,2.0,642.0,642.0,5,1073,3.0,805.0,805.0
0.015,6,10,1762,5,911,3.0,643.0,643.0,5,851,3.0,583.0,583.0
0.006,6,10,1689,5,839,1.0,571.0,571.0,5,850,1.0,582.0,582.0
0.006,17,2,150,1,67,0.0,39.0,39.0,1,83,0.0,55.0,55.0
0.004,6,10,1989,5,927,1.0,659.0,659.0,5,1062,1.0,794.0,794.0
0.005,6,10,2007,5,928,1.0,660.0,660.0,5,1079,1.0,811.0,811.0
0.015,6,10,1677,5,827,3.0,559.0,559.0,5,850,3.0,582.0,582.0
0.005,6,10,1689,5,839,1.0,571.0,571.0,5,850,1.0,582.0,582.0
240.084,6,16,4481,9,963,30010.0,238.0,166.0,7,3518,40013.0,1402.0,786.0
0.006,6,10,1643,5,860,1.0,592.0,592.0,5,783,1.0,515.0,515.0
0.006,6,14,3799,7,509,0.0,137.0,137.0,7,3290,0.0,1448.0,972.0
0.013,6,10,1983,5,910,3.0,642.0,642.0,5,1073,3.0,805.0,805.0
368.752,6,22,2313,16,867,24583.0,195.0,195.0,6,1446,4669.0,419.0,398.0
0.005,6,10,2007,5,928,1.0,660.0,660.0,5,1079,1.0,811.0,811.0
0.009,17,2,214,1,75,0.0,47.0,47.0,1,139,0.0,111.0,111.0
0.011,6,10,1989,5,910,2.0,642.0,642.0,5,1079,2.0,811.0,811.0
367.114,6,24,2405,17,919,22944.0,195.0,195.0,7,1486,3904.0,419.0,398.0
0.008,6,12,1926,6,1189,1.0,659.0,434.0,6,737,1.0,417.0,417.0
293.673,6,376,347732,194,21649,1521.0,2736.0,825.0,182,326083,1622.0,4136.0,1884.0
0.004,17,2,148,1,60,0.0,32.0,32.0,1,88,0.0,60.0,60.0
0.005,6,13,3747,7,509,0.0,137.0,137.0,6,3238,0.0,1470.0,1459.0
0.005,6,10,1547,5,764,1.0,496.0,496.0,5,783,1.0,515.0,515.0
0.006,6,10,1547,5,764,1.0,496.0,496.0,5,783,1.0,515.0,515.0
0.002,17,2,180,1,66,0.0,38.0,38.0,1,114,0.0,86.0,86.0
0.014,6,10,1762,5,911,3.0,643.0,643.0,5,851,3.0,583.0,583.0
0.005,6,10,2007,5,928,1.0,660.0,660.0,5,1079,1.0,811.0,811.0
0.01,17,2,154,1,69,0.0,41.0,41.0,1,85,0.0,57.0,57.0
0.012,6,10,1631,5,848,3.0,580.0,580.0,5,783,2.0,515.0,515.0
0.006,6,10,1547,5,764,1.0,496.0,496.0,5,783,1.0,515.0,515.0
0.072,17,2,234,1,61,0.0,33.0,33.0,1,173,0.0,145.0,145.0
0.004,6,10,2006,5,927,1.0,659.0,659.0,5,1079,1.0,811.0,811.0
0.013,6,10,1990,5,911,3.0,643.0,643.0,5,1079,3.0,811.0,811.0
0.009,6,10,1972,5,910,2.0,642.0,642.0,5,1062,2.0,794.0,794.0
0.008,6,10,1989,5,910,2.0,642.0,642.0,5,1079,2.0,811.0,811.0
0.009,6,10,1989,5,910,2.0,642.0,642.0,5,1079,2.0,811.0,811.0
0.003,17,2,136,1,60,0.0,32.0,32.0,1,76,0.0,48.0,48.0
0.01,6,10,1677,5,827,2.0,559.0,559.0,5,850,2.0,582.0,582.0
0.005,6,10,2007,5,928,1.0,660.0,660.0,5,1079,1.0,811.0,811.0
1.372,6,377,347736,202,22024,6.0,2736.0,959.0,175,325712,7.0,4136.0,1907.0
0.004,6,10,1989,5,927,1.0,659.0,659.0,5,1062,1.0,794.0,794.0
0.113,6,10,1506,5,395,25.0,127.0,127.0,5,1111,22.0,843.0,843.0
125.977,6,13,2150,7,1716,20956.0,1424.0,1424.0,6,434,25148.0,182.0,182.0
0.005,6,10,1689,5,839,1.0,571.0,571.0,5,850,1.0,582.0,582.0
0.004,6,10,1702,5,863,1.0,595.0,595.0,5,839,1.0,571.0,571.0
174.208,17,88,12695,44,2961,4051.0,44.0,39.0,44,9734,4051.0,260.0,193.0
0.071,6,10,1506,5,395,15.0,127.0,127.0,5,1111,14.0,843.0,843.0
0.04,17,4,564,2,122,1.0,33.0,33.0,2,442,36.0,291.0,193.0
0.005,17,2,164,1,74,0.0,46.0,46.0,1,90,0.0,62.0,62.0
0.08,6,10,1506,5,395,18.0,127.0,127.0,5,1111,15.0,843.0,843.0
0.005,6,10,2006,5,927,1.0,659.0,659.0,5,1079,1.0,811.0,811.0
40.068,17,10,676,5,460,10015.0,104.0,64.0,5,216,10016.0,20.0,15.0
0.009,17,4,284,2,120,0.0,32.0,32.0,2,164,0.0,60.0,54.0
40.062,17,10,676,5,460,10014.0,104.0,64.0,5,216,10014.0,20.0,15.0
0.005,17,2,214,1,75,0.0,47.0,47.0,1,139,0.0,111.0,111.0
0.009,6,10,1990,5,911,2.0,643.0,643.0,5,1079,2.0,811.0,811.0
0.183,6,10,1506,5,395,31.0,127.0,127.0,5,1111,44.0,843.0,843.0
0.005,6,10,1989,5,927,1.0,659.0,659.0,5,1062,1.0,794.0,794.0
0.004,6,10,2000,5,927,1.0,659.0,659.0,5,1073,1.0,805.0,805.0
0.014,6,6,716,3,458,6.0,302.0,302.0,3,258,5.0,102.0,102.0
10.782,17,28,4421,14,1994,820.0,269.0,114.0,14,2427,820.0,586.0,145.0
0.081,6,10,1506,5,395,14.0,127.0,127.0,5,1111,18.0,843.0,843.0
0.141,6,10,1506,5,395,33.0,127.0,127.0,5,1111,30.0,843.0,843.0
0.011,6,10,1989,5,910,2.0,642.0,642.0,5,1079,2.0,811.0,811.0
0.024,6,10,1989,5,910,6.0,642.0,642.0,5,1079,5.0,811.0,811.0
0.082,6,10,1506,5,395,18.0,127.0,127.0,5,1111,19.0,843.0,843.0
308.736,17,19,1084,10,716,34289.0,48.0,43.0,9,368,38575.0,20.0,12.0
0.004,17,4,284,2,120,0.0,32.0,32.0,2,164,1.0,60.0,54.0
0.117,6,10,1506,5,395,24.0,127.0,127.0,5,1111,24.0,843.0,843.0
0.014,17,2,169,1,62,0.0,34.0,34.0,1,107,0.0,79.0,79.0
0.085,6,10,1506,5,395,20.0,127.0,127.0,5,1111,16.0,843.0,843.0
0.011,6,10,1762,5,911,2.0,643.0,643.0,5,851,2.0,583.0,583.0
0.017,6,10,1983,5,910,4.0,642.0,642.0,5,1073,4.0,805.0,805.0
0.01,6,10,1631,5,848,2.0,580.0,580.0,5,783,2.0,515.0,515.0
0.008,6,10,1983,5,910,2.0,642.0,642.0,5,1073,1.0,805.0,805.0
0.001,17,2,180,1,66,0.0,38.0,38.0,1,114,0.0,86.0,86.0
0.008,6,10,1854,5,889,1.0,621.0,621.0,5,965,2.0,697.0,697.0
0.008,6,12,1926,6,1189,1.0,659.0,434.0,6,737,1.0,417.0,417.0
0.009,6,10,2006,5,927,2.0,659.0,659.0,5,1079,2.0,811.0,811.0
0.005,6,10,1643,5,860,1.0,592.0,592.0,5,783,1.0,515.0,515.0
0.011,6,10,1990,5,911,2.0,643.0,643.0,5,1079,2.0,811.0,811.0
0.001,17,2,294,1,64,0.0,36.0,36.0,1,230,0.0,202.0,202.0
40.075,17,10,676,5,460,10018.0,104.0,64.0,5,216,10018.0,20.0,15.0
40.063,17,10,676,5,460,10013.0,104.0,64.0,5,216,10015.0,20.0,15.0
0.005,17,2,136,1,60,0.0,32.0,32.0,1,76,0.0,48.0,48.0
0.004,6,10,2006,5,927,1.0,659.0,659.0,5,1079,1.0,811.0,811.0
0.092,6,10,1506,5,395,18.0,127.0,127.0,5,1111,20.0,843.0,843.0
0.012,6,10,1989,5,910,2.0,642.0,642.0,5,1079,2.0,811.0,811.0
40.065,17,10,676,5,460,10013.0,104.0,64.0,5,216,10015.0,20.0,15.0
10.985,17,28,4422,14,1994,836.0,269.0,114.0,14,2428,836.0,587.0,145.0
0.091,6,10,1506,5,395,19.0,127.0,127.0,5,1111,21.0,843.0,843.0
0.005,6,10,2006,5,927,1.0,659.0,659.0,5,1079,1.0,811.0,811.0
0.007,6,10,1989,5,910,1.0,642.0,642.0,5,1079,1.0,811.0,811.0
0.015,6,10,1990,5,911,3.0,643.0,643.0,5,1079,3.0,811.0,811.0
0.018,6,10,1989,5,910,4.0,642.0,642.0,5,1079,4.0,811.0,811.0
308.377,17,20,1124,10,716,34249.0,48.0,43.0,10,408,34249.0,20.0,12.0
0.014,6,6,716,3,458,5.0,302.0,302.0,3,258,5.0,102.0,102.0
0.109,6,10,1506,5,395,25.0,127.0,127.0,5,1111,25.0,843.0,843.0
0.073,6,10,1506,5,395,15.0,127.0,127.0,5,1111,15.0,843.0,843.0
0.019,6,10,1677,5,827,4.0,559.0,559.0,5,850,4.0,582.0,582.0
0.162,17,2,152,1,76,0.0,48.0,48.0,1,76,0.0,48.0,48.0
1.054,6,12,3134,6,2099,158.0,1328.0,923.0,6,1035,158.0,791.0,791.0
0.092,6,10,1506,5,395,20.0,127.0,127.0,5,1111,21.0,843.0,843.0
0.005,17,2,164,1,74,0.0,46.0,46.0,1,90,0.0,62.0,62.0
0.01,6,10,1989,5,910,2.0,642.0,642.0,5,1079,2.0,811.0,811.0
0.053,17,2,152,1,76,0.0,48.0,48.0,1,76,0.0,48.0,48.0
0.005,17,2,214,1,75,0.0,47.0,47.0,1,139,0.0,111.0,111.0
0.018,6,10,1989,5,910,4.0,642.0,642.0,5,1079,4.0,811.0,811.0
0.004,6,10,2006,5,927,1.0,659.0,659.0,5,1079,1.0,811.0,811.0
0.004,6,10,1779,5,928,1.0,660.0,660.0,5,851,1.0,583.0,583.0
0.005,6,10,1779,5,928,1.0,660.0,660.0,5,851,1.0,583.0,583.0
0.014,6,10,1762,5,911,3.0,643.0,643.0,5,851,3.0,583.0,583.0
0.07,6,10,1506,5,395,14.0,127.0,127.0,5,1111,15.0,843.0,843.0
40.103,17,10,676,5,460,10023.0,104.0,64.0,5,216,10024.0,20.0,15.0
0.005,6,10,1989,5,927,1.0,659.0,659.0,5,1062,1.0,794.0,794.0
0.008,6,10,1631,5,848,2.0,580.0,580.0,5,783,1.0,515.0,515.0
0.004,17,2,136,1,60,0.0,32.0,32.0,1,76,0.0,48.0,48.0
0.152,6,10,1506,5,395,31.0,127.0,127.0,5,1111,33.0,843.0,843.0
0.006,6,10,1689,5,839,1.0,571.0,571.0,5,850,1.0,582.0,582.0
0.005,6,10,1989,5,927,1.0,659.0,659.0,5,1062,1.0,794.0,794.0
0.014,6,10,1989,5,910,3.0,642.0,642.0,5,1079,3.0,811.0,811.0
0.069,6,10,1506,5,395,15.0,127.0,127.0,5,1111,16.0,843.0,843.0
0.103,6,10,1506,5,395,22.0,127.0,127.0,5,1111,21.0,843.0,843.0
0.004,6,10,1989,5,927,1.0,659.0,659.0,5,1062,1.0,794.0,794.0
300.09,6,19,4660,11,1102,30008.0,238.0,130.0,8,3558,42869.0,1402.0,786.0
240.06,6,10,1211,5,458,60014.0,190.0,190.0,5,753,60014.0,497.0,497.0
0.013,17,2,152,1,56,0.0,28.0,28.0,1,96,0.0,68.0,68.0
0.092,6,10,1506,5,395,20.0,127.0,127.0,5,1111,21.0,843.0,843.0
1799.234,17,2877,220516,1431,115986,1258.0,84.0,53.0,1446,104530,1245.0,227.0,44.0
0.005,6,13,3690,7,452,0.0,80.0,80.0,6,3238,1.0,1470.0,1459.0
0.111,6,10,1506,5,395,25.0,127.0,127.0,5,1111,23.0,843.0,843.0
40.077,17,10,676,5,460,10016.0,104.0,64.0,5,216,10018.0,20.0,15.0
0.005,6,10,2006,5,927,1.0,659.0,659.0,5,1079,1.0,811.0,811.0
0.004,17,2,148,1,60,0.0,32.0,32.0,1,88,0.0,60.0,60.0
1792.656,6,490,99465,245,88075,7346.0,421.0,364.0,245,11390,7346.0,53.0,53.0
0.096,6,10,1506,5,395,21.0,127.0,127.0,5,1111,18.0,843.0,843.0
0.057,6,10,1506,5,395,13.0,127.0,127.0,5,1111,12.0,843.0,843.0
0.001,17,2,180,1,66,0.0,38.0,38.0,1,114,0.0,86.0,86.0
0.014,6,10,1989,5,910,3.0,642.0,642.0,5,1079,3.0,811.0,811.0
0.009,6,10,1779,5,928,2.0,660.0,660.0,5,851,2.0,583.0,583.0
0.018,6,10,1972,5,910,4.0,642.0,642.0,5,1062,4.0,794.0,794.0
0.005,6,10,1643,5,860,1.0,592.0,592.0,5,783,1.0,515.0,515.0
0.006,6,10,1547,5,764,1.0,496.0,496.0,5,783,1.0,515.0,515.0
0.005,6,10,1854,5,889,1.0,621.0,621.0,5,965,1.0,697.0,697.0
0.005,17,2,140,1,62,0.0,34.0,34.0,1,78,0.0,50.0,50.0
300.367,6,16,2170,9,684,37525.0,146.0,146.0,7,1486,50033.0,419.0,398.0
0.007,6,10,1689,5,839,1.0,571.0,571.0,5,850,1.0,582.0,582.0
0.005,6,10,2006,5,927,1.0,659.0,659.0,5,1079,1.0,811.0,811.0
0.015,6,14,3787,7,497,2.0,125.0,125.0,7,3290,2.0,1448.0,972.0
0.005,6,10,2007,5,928,1.0,660.0,660.0,5,1079,1.0,811.0,811.0
0.016,6,12,1926,6,1189,3.0,659.0,434.0,6,737,3.0,417.0,417.0
0.009,6,10,1677,5,827,2.0,559.0,559.0,5,850,2.0,582.0,582.0
10.816,17,28,4423,14,1994,823.0,269.0,114.0,14,2429,823.0,588.0,145.0
0.004,6,10,2006,5,927,1.0,659.0,659.0,5,1079,1.0,811.0,811.0
0.001,17,2,180,1,66,0.0,38.0,38.0,1,114,0.0,86.0,86.0
0.17,6,3,453,2,321,170.0,241.0,241.0,1,132,0.0,92.0,92.0
0.012,6,13,3735,7,497,2.0,125.0,125.0,6,3238,2.0,1470.0,1459.0
0.025,6,10,1983,5,910,6.0,642.0,642.0,5,1073,6.0,805.0,805.0
0.041,17,2,182,1,65,0.0,37.0,37.0,1,117,0.0,89.0,89.0
0.017,17,2,140,1,62,0.0,34.0,34.0,1,78,0.0,50.0,50.0
0.005,6,10,1989,5,927,1.0,659.0,659.0,5,1062,1.0,794.0,794.0
0.136,6,10,1506,5,395,32.0,127.0,127.0,5,1111,29.0,843.0,843.0
352.942,6,20,2210,6,1308,12003.0,494.0,494.0,14,902,27149.0,83.0,83.0
0.076,6,10,1506,5,395,17.0,127.0,127.0,5,1111,17.0,843.0,843.0
0.012,6,10,1989,5,910,2.0,642.0,642.0,5,1079,3.0,811.0,811.0
0.006,6,10,1989,5,927,1.0,659.0,659.0,5,1062,1.0,794.0,794.0
300.032,6,12,1782,7,1348,50005.0,494.0,494.0,5,434,75005.0,83.0,83.0
0.01,6,10,1762,5,911,2.0,643.0,643.0,5,851,2.0,583.0,583.0
240.109,6,31,9460,15,7044,17150.0,2169.0,696.0,16,2416,16007.0,580.0,197.0
0.005,6,10,2000,5,927,1.0,659.0,659.0,5,1073,1.0,805.0,805.0
0.002,17,2,180,1,66,0.0,38.0,38.0,1,114,0.0,86.0,86.0
0.082,6,10,1506,5,395,18.0,127.0,127.0,5,1111,17.0,843.0,843.0
0.063,6,10,1506,5,395,15.0,127.0,127.0,5,1111,14.0,843.0,843.0
0.001,17,2,136,1,60,0.0,32.0,32.0,1,76,0.0,48.0,48.0
0.006,17,2,214,1,75,0.0,47.0,47.0,1,139,0.0,111.0,111.0
0.011,6,10,1989,5,910,2.0,642.0,642.0,5,1079,2.0,811.0,811.0
0.011,6,13,3735,7,497,1.0,125.0,125.0,6,3238,2.0,1470.0,1459.0
9.038,17,6,376,5,280,2259.0,28.0,28.0,1,96,0.0,68.0,68.0
1778.714,17,141,44556,72,22752,25051.0,288.0,288.0,69,21804,26156.0,288.0,288.0
0.01,6,10,1989,5,910,2.0,642.0,642.0,5,1079,2.0,811.0,811.0
0.011,6,10,1989,5,910,2.0,642.0,642.0,5,1079,2.0,811.0,811.0
0.111,6,10,1506,5,395,22.0,127.0,127.0,5,1111,26.0,843.0,843.0
0.001,17,2,180,1,66,0.0,38.0,38.0,1,114,0.0,86.0,86.0
0.126,6,10,1506,5,395,30.0,127.0,127.0,5,1111,28.0,843.0,843.0
0.122,6,10,1506,5,395,26.0,127.0,127.0,5,1111,29.0,843.0,843.0
0.012,6,12,1926,6,1189,2.0,659.0,434.0,6,737,2.0,417.0,417.0
0.01,6,10,1990,5,911,2.0,643.0,643.0,5,1079,2.0,811.0,811.0
300.308,6,16,2170,9,684,37518.0,146.0,146.0,7,1486,50024.0,419.0,398.0
280.384,6,23,6075,10,1186,31153.0,267.0,156.0,13,4889,23360.0,1400.0,873.0
0.005,6,10,2007,5,928,1.0,660.0,660.0,5,1079,1.0,811.0,811.0
0.011,17,2,144,1,64,0.0,36.0,36.0,1,80,0.0,52.0,52.0
0.016,6,10,1631,5,848,3.0,580.0,580.0,5,783,4.0,515.0,515.0
0.005,17,2,136,1,60,0.0,32.0,32.0,1,76,0.0,48.0,48.0
0.012,6,10,1983,5,910,3.0,642.0,642.0,5,1073,3.0,805.0,805.0
0.011,6,10,1972,5,910,2.0,642.0,642.0,5,1062,2.0,794.0,794.0
173.267,17,78,11249,39,2619,4556.0,44.0,39.0,39,8630,4559.0,261.0,193.0
0.005,6,10,1643,5,860,1.0,592.0,592.0,5,783,1.0,515.0,515.0
0.015,6,10,1989,5,910,3.0,642.0,642.0,5,1079,3.0,811.0,811.0
264.363,17,16,892,8,564,37746.0,48.0,42.0,8,328,37747.0,20.0,13.0
0.084,6,10,1506,5,395,19.0,127.0,127.0,5,1111,19.0,843.0,843.0
240.029,6,9,787,5,488,60007.0,232.0,232.0,4,299,80008.0,83.0,83.0
12.377,17,42,9460,21,5172,610.0,1337.0,218.0,21,4288,610.0,861.0,176.0
0.135,6,10,1506,5,395,31.0,127.0,127.0,5,1111,29.0,843.0,843.0
0.01,6,10,2000,5,927,2.0,659.0,659.0,5,1073,2.0,805.0,805.0
0.005,6,10,2000,5,927,1.0,659.0,659.0,5,1073,1.0,805.0,805.0
0.331,17,45,25881,25,19896,13.0,1350.0,767.0,20,5985,14.0,1350.0,271.0
0.009,6,10,1972,5,910,2.0,642.0,642.0,5,1062,2.0,794.0,794.0
0.072,17,2,148,1,60,0.0,32.0,32.0,1,88,0.0,60.0,60.0
0.004,6,10,1774,5,923,1.0,655.0,655.0,5,851,1.0,583.0,583.0
0.014,6,10,1677,5,827,3.0,559.0,559.0,5,850,3.0,582.0,582.0
0.005,6,10,2007,5,928,1.0,660.0,660.0,5,1079,1.0,811.0,811.0
0.005,6,10,1547,5,764,1.0,496.0,496.0,5,783,1.0,515.0,515.0
0.008,6,10,1989,5,910,2.0,642.0,642.0,5,1079,2.0,811.0,811.0
498.487,6,33,9848,18,3948,29322.0,676.0,429.0,15,5900,31320.0,1402.0,730.0
40.079,17,10,676,5,460,10018.0,104.0,64.0,5,216,10019.0,20.0,15.0
0.122,6,10,1506,5,395,23.0,127.0,127.0,5,1111,27.0,843.0,843.0
0.069,6,10,1506,5,395,14.0,127.0,127.0,5,1111,16.0,843.0,843.0
0.013,6,10,1631,5,848,3.0,580.0,580.0,5,783,3.0,515.0,515.0
0.037,17,4,284,2,120,0.0,32.0,32.0,2,164,34.0,60.0,54.0
0.005,6,13,3747,7,509,0.0,137.0,137.0,6,3238,0.0,1470.0,1459.0
0.017,6,10,1972,5,910,4.0,642.0,642.0,5,1062,4.0,794.0,794.0
0.012,6,10,1983,5,910,3.0,642.0,642.0,5,1073,2.0,805.0,805.0
0.006,6,10,1989,5,927,1.0,659.0,659.0,5,1062,1.0,794.0,794.0
0.095,6,10,1506,5,395,22.0,127.0,127.0,5,1111,21.0,843.0,843.0
8.754,6,35,10593,18,5115,514.0,1360.0,872.0,17,5478,534.0,2667.0,435.0
301.051,6,47,18094,25,12187,12543.0,2720.0,1239.0,22,5907,423.0,2667.0,385.0
0.005,6,10,2006,5,927,1.0,659.0,659.0,5,1079,1.0,811.0,811.0
0.01,6,10,1989,5,927,2.0,659.0,659.0,5,1062,2.0,794.0,794.0
0.004,6,10,1774,5,923,1.0,655.0,655.0,5,851,0.0,583.0,583.0
0.006,17,2,175,1,65,0.0,37.0,37.0,1,110,0.0,82.0,82.0
240.013,6,9,787,5,488,60003.0,232.0,232.0,4,299,80003.0,83.0,83.0
0.006,17,2,140,1,62,0.0,34.0,34.0,1,78,0.0,50.0,50.0
40.054,17,10,676,5,460,10011.0,104.0,64.0,5,216,10011.0,20.0,15.0
0.011,6,10,1989,5,910,2.0,642.0,642.0,5,1079,2.0,811.0,811.0
0.008,17,2,132,1,58,0.0,30.0,30.0,1,74,0.0,46.0,46.0
0.019,6,10,1983,5,910,4.0,642.0,642.0,5,1073,4.0,805.0,805.0
0.004,6,10,1989,5,927,1.0,659.0,659.0,5,1062,1.0,794.0,794.0
0.127,17,2,80,1,32,0.0,4.0,4.0,1,48,0.0,20.0,20.0
40.061,17,10,676,5,460,10014.0,104.0,64.0,5,216,10014.0,20.0,15.0
0.011,6,10,1983,5,910,2.0,642.0,642.0,5,1073,2.0,805.0,805.0
0.071,17,8,3613,4,1874,23.0,1350.0,440.0,4,1739,13.0,1350.0,406.0
0.005,6,10,1547,5,764,1.0,496.0,496.0,5,783,1.0,515.0,515.0
0.021,6,10,1677,5,827,5.0,559.0,559.0,5,850,5.0,582.0,582.0
40.055,17,10,676,5,460,10012.0,104.0,64.0,5,216,10012.0,20.0,15.0
0.102,6,10,1506,5,395,21.0,127.0,127.0,5,1111,22.0,843.0,843.0
0.005,6,10,1689,5,839,1.0,571.0,571.0,5,850,1.0,582.0,582.0
0.006,17,2,170,1,65,0.0,37.0,37.0,1,105,0.0,77.0,77.0
40.055,17,10,676,5,460,10011.0,104.0,64.0,5,216,10012.0,20.0,15.0
0.005,6,10,1989,5,927,1.0,659.0,659.0,5,1062,1.0,794.0,794.0
0.006,17,2,214,1,75,0.0,47.0,47.0,1,139,0.0,111.0,111.0
40.059,17,10,676,5,460,10013.0,104.0,64.0,5,216,10013.0,20.0,15.0
0.007,6,10,1547,5,764,1.0,496.0,496.0,5,783,1.0,515.0,515.0
0.005,6,10,2006,5,927,1.0,659.0,659.0,5,1079,1.0,811.0,811.0
0.041,17,4,284,2,120,0.0,32.0,32.0,2,164,37.0,60.0,54.0
0.014,6,10,1989,5,910,3.0,642.0,642.0,5,1079,3.0,811.0,811.0
0.005,6,10,1774,5,923,1.0,655.0,655.0,5,851,1.0,583.0,583.0
0.005,17,2,166,1,75,0.0,47.0,47.0,1,91,0.0,63.0,63.0
0.082,6,10,1506,5,395,18.0,127.0,127.0,5,1111,18.0,843.0,843.0
15.077,17,15,8581,8,6342,2149.0,1350.0,764.0,7,2239,2508.0,1350.0,291.0
0.075,6,10,1506,5,395,15.0,127.0,127.0,5,1111,18.0,843.0,843.0
0.001,17,2,136,1,60,0.0,32.0,32.0,1,76,0.0,48.0,48.0
0.08,6,10,1506,5,395,17.0,127.0,127.0,5,1111,18.0,843.0,843.0
0.069,6,10,1506,5,395,16.0,127.0,127.0,5,1111,15.0,843.0,843.0
10.896,17,28,4421,14,1993,829.0,268.0,114.0,14,2428,829.0,587.0,145.0
0.005,6,10,2000,5,927,1.0,659.0,659.0,5,1073,1.0,805.0,805.0
0.071,6,10,1506,5,395,15.0,127.0,127.0,5,1111,16.0,843.0,843.0
0.013,6,10,1677,5,827,3.0,559.0,559.0,5,850,3.0,582.0,582.0
1749.229,6,65,7413,43,4537,41648.0,1402.0,104.0,22,2876,83288.0,1112.0,82.0
0.13,6,10,1506,5,395,30.0,127.0,127.0,5,1111,26.0,843.0,843.0
0.005,6,10,2006,5,927,1.0,659.0,659.0,5,1079,1.0,811.0,811.0
11.172,17,28,4423,14,1994,846.0,269.0,114.0,14,2429,846.0,588.0,145.0
0.008,6,10,1989,5,910,2.0,642.0,642.0,5,1079,1.0,811.0,811.0
0.005,6,10,2006,5,927,1.0,659.0,659.0,5,1079,1.0,811.0,811.0
169.12,17,78,11037,39,2601,4450.0,44.0,38.0,39,8436,4450.0,239.0,188.0
0.005,17,4,284,2,120,0.0,32.0,32.0,2,164,0.0,60.0,54.0
0.048,17,2,166,1,75,0.0,47.0,47.0,1,91,0.0,63.0,63.0
11.242,17,28,4396,14,2311,856.0,586.0,137.0,14,2085,856.0,268.0,120.0
0.005,6,10,2000,5,927,1.0,659.0,659.0,5,1073,1.0,805.0,805.0
0.005,6,10,2000,5,927,1.0,659.0,659.0,5,1073,1.0,805.0,805.0
0.003,17,2,203,1,61,0.0,33.0,33.0,1,142,0.0,114.0,114.0
0.089,6,10,1506,5,395,18.0,127.0,127.0,5,1111,20.0,843.0,843.0
300.806,6,38,12811,20,7293,15831.0,4080.0,1292.0,18,5518,508.0,2667.0,435.0
0.005,17,2,170,1,65,0.0,37.0,37.0,1,105,0.0,77.0,77.0
0.117,17,2,80,1,32,0.0,4.0,4.0,1,48,0.0,20.0,20.0
0.015,6,10,1989,5,910,3.0,642.0,642.0,5,1079,3.0,811.0,811.0
40.067,17,10,676,5,460,10013.0,104.0,64.0,5,216,10015.0,20.0,15.0
0.005,6,10,1989,5,927,1.0,659.0,659.0,5,1062,1.0,794.0,794.0
0.006,6,10,2006,5,927,1.0,659.0,659.0,5,1079,1.0,811.0,811.0
0.06,17,2,80,1,32,0.0,4.0,4.0,1,48,0.0,20.0,20.0
300.369,6,16,2170,9,684,37525.0,146.0,146.0,7,1486,50034.0,419.0,398.0
0.006,6,10,1774,5,923,1.0,655.0,655.0,5,851,1.0,583.0,583.0
40.062,17,10,676,5,460,10013.0,104.0,64.0,5,216,10014.0,20.0,15.0
0.086,6,10,1506,5,395,19.0,127.0,127.0,5,1111,17.0,843.0,843.0
0.005,17,2,230,1,68,0.0,40.0,40.0,1,162,0.0,134.0,134.0
0.001,17,2,180,1,66,0.0,38.0,38.0,1,114,0.0,86.0,86.0
0.005,6,10,1643,5,860,1.0,592.0,592.0,5,783,1.0,515.0,515.0
0.01,6,10,1972,5,910,2.0,642.0,642.0,5,1062,2.0,794.0,794.0
0.077,6,10,1506,5,395,18.0,127.0,127.0,5,1111,14.0,843.0,843.0
0.005,17,2,179,1,71,0.0,43.0,43.0,1,108,0.0,80.0,80.0
0.005,6,10,1774,5,923,1.0,655.0,655.0,5,851,1.0,583.0,583.0
0.001,17,2,180,1,66,0.0,38.0,38.0,1,114,0.0,86.0,86.0
0.011,6,10,1631,5,848,2.0,580.0,580.0,5,783,2.0,515.0,515.0
0.005,17,2,225,1,65,0.0,37.0,37.0,1,160,0.0,132.0,132.0
0.006,17,2,179,1,71,0.0,43.0,43.0,1,108,0.0,80.0,80.0
0.081,6,10,1506,5,395,18.0,127.0,127.0,5,1111,18.0,843.0,843.0
366.048,6,22,2313,16,867,24403.0,195.0,195.0,6,1446,4635.0,419.0,398.0
0.006,6,10,1547,5,764,1.0,496.0,496.0,5,783,1.0,515.0,515.0
10.93,17,28,4421,14,1994,831.0,269.0,114.0,14,2427,831.0,586.0,145.0
0.005,6,10,1779,5,928,1.0,660.0,660.0,5,851,1.0,583.0,583.0
0.053,17,2,152,1,76,0.0,48.0,48.0,1,76,0.0,48.0,48.0
0.012,6,10,1972,5,910,3.0,642.0,642.0,5,1062,3.0,794.0,794.0
0.001,17,2,166,1,75,0.0,47.0,47.0,1,91,0.0,63.0,63.0
0.216,6,10,1506,5,395,49.0,127.0,127.0,5,1111,47.0,843.0,843.0
0.016,6,10,1983,5,910,4.0,642.0,642.0,5,1073,4.0,805.0,805.0
0.015,6,10,1990,5,911,3.0,643.0,643.0,5,1079,3.0,811.0,811.0
0.004,17,2,142,1,63,0.0,35.0,35.0,1,79,0.0,51.0,51.0
0.006,6,10,1547,5,764,1.0,496.0,496.0,5,783,1.0,515.0,515.0
0.04,17,2,170,1,65,0.0,37.0,37.0,1,105,0.0,77.0,77.0
0.092,6,10,1506,5,395,19.0,127.0,127.0,5,1111,19.0,843.0,843.0
0.094,6,10,1506,5,395,20.0,127.0,127.0,5,1111,21.0,843.0,843.0
0.098,6,10,1506,5,395,19.0,127.0,127.0,5,1111,21.0,843.0,843.0
1756.357,6,126,12573,69,4792,25828.0,517.0,66.0,57,7781,31362.0,1402.0,229.0
376.625,6,22,2313,16,867,25108.0,195.0,195.0,6,1446,4642.0,419.0,398.0
11.162,17,28,4424,14,1995,846.0,270.0,114.0,14,2429,846.0,588.0,145.0
0.061,6,10,1506,5,395,13.0,127.0,127.0,5,1111,13.0,843.0,843.0
0.016,6,13,3816,7,578,2.0,206.0,206.0,6,3238,3.0,1470.0,1459.0
40.067,17,10,676,5,460,10015.0,104.0,64.0,5,216,10015.0,20.0,15.0
0.004,6,10,1702,5,863,1.0,595.0,595.0,5,839,0.0,571.0,571.0
0.005,6,10,2006,5,927,1.0,659.0,659.0,5,1079,1.0,811.0,811.0
0.006,17,2,170,1,65,0.0,37.0,37.0,1,105,0.0,77.0,77.0
0.004,6,10,1702,5,863,1.0,595.0,595.0,5,839,1.0,571.0,571.0
0.129,6,10,1506,5,395,31.0,127.0,127.0,5,1111,31.0,843.0,843.0
0.006,17,2,179,1,71,0.0,43.0,43.0,1,108,0.0,80.0,80.0
0.005,6,10,2006,5,927,1.0,659.0,659.0,5,1079,1.0,811.0,811.0
0.005,6,10,1689,5,839,1.0,571.0,571.0,5,850,1.0,582.0,582.0
0.004,6,10,2006,5,927,1.0,659.0,659.0,5,1079,1.0,811.0,811.0
0.01,6,10,1972,5,910,2.0,642.0,642.0,5,1062,2.0,794.0,794.0
0.005,6,10,2007,5,928,1.0,660.0,660.0,5,1079,1.0,811.0,811.0
0.097,6,10,1506,5,395,21.0,127.0,127.0,5,1111,21.0,843.0,843.0
0.072,17,4,336,2,124,0.0,34.0,34.0,2,212,31.0,84.0,78.0
0.015,17,2,186,1,61,0.0,33.0,33.0,1,125,0.0,97.0,97.0
0.012,6,10,1983,5,910,2.0,642.0,642.0,5,1073,3.0,805.0,805.0
0.036,6,13,3735,7,497,6.0,125.0,125.0,6,3238,7.0,1470.0,1459.0
0.01,6,10,1972,5,910,2.0,642.0,642.0,5,1062,2.0,794.0,794.0
301.023,6,48,19420,25,13473,12542.0,4080.0,1382.0,23,5947,403.0,2667.0,385.0
11.046,17,28,4395,14,2312,840.0,587.0,137.0,14,2083,840.0,270.0,120.0
0.005,6,10,2006,5,927,1.0,659.0,659.0,5,1079,1.0,811.0,811.0
0.093,6,10,1506,5,395,19.0,127.0,127.0,5,1111,22.0,843.0,843.0
40.075,17,10,676,5,460,10015.0,104.0,64.0,5,216,10017.0,20.0,15.0
0.11,6,10,1506,5,395,24.0,127.0,127.0,5,1111,23.0,843.0,843.0
0.094,6,10,1506,5,395,20.0,127.0,127.0,5,1111,19.0,843.0,843.0
15.121,17,19,13436,9,8280,1886.0,1350.0,892.0,10,5156,1676.0,1350.0,487.0
0.268,17,38,20025,21,17041,13.0,1350.0,783.0,17,2984,12.0,1350.0,147.0
0.005,6,10,2006,5,927,1.0,659.0,659.0,5,1079,1.0,811.0,811.0
126.021,6,13,2150,7,1716,20965.0,1424.0,1424.0,6,434,25156.0,182.0,182.0
1778.257,17,144,45504,72,22752,25045.0,288.0,288.0,72,22752,25045.0,288.0,288.0
104.22,58,5,360,4,288,34740.0,24.0,24.0,1,72,0.0,24.0,24.0
0.009,6,10,2000,5,927,2.0,659.0,659.0,5,1073,2.0,805.0,805.0
0.017,6,10,1990,5,911,4.0,643.0,643.0,5,1079,4.0,811.0,811.0
0.005,6,14,3799,7,509,0.0,137.0,137.0,7,3290,0.0,1448.0,972.0
0.104,6,10,1506,5,395,21.0,127.0,127.0,5,1111,22.0,843.0,843.0
0.007,6,10,2007,5,928,1.0,660.0,660.0,5,1079,1.0,811.0,811.0
0.016,6,10,1989,5,910,4.0,642.0,642.0,5,1079,4.0,811.0,811.0
0.005,6,10,1689,5,839,1.0,571.0,571.0,5,850,1.0,582.0,582.0
0.006,6,10,2006,5,927,1.0,659.0,659.0,5,1079,1.0,811.0,811.0
0.04,17,2,152,1,76,0.0,48.0,48.0,1,76,0.0,48.0,48.0
0.143,6,10,1506,5,395,35.0,127.0,127.0,5,1111,33.0,843.0,843.0
11.465,17,28,4389,14,2312,868.0,587.0,137.0,14,2077,869.0,268.0,120.0
0.095,6,10,1506,5,395,20.0,127.0,127.0,5,1111,22.0,843.0,843.0
0.005,6,10,1689,5,839,1.0,571.0,571.0,5,850,1.0,582.0,582.0
0.001,17,2,180,1,66,0.0,38.0,38.0,1,114,0.0,86.0,86.0
0.12,6,10,1506,5,395,27.0,127.0,127.0,5,1111,25.0,843.0,843.0
0.013,6,10,1972,5,910,3.0,642.0,642.0,5,1062,3.0,794.0,794.0
0.081,17,4,596,2,122,44.0,33.0,33.0,2,474,43.0,323.0,209.0
0.009,6,10,2006,5,927,2.0,659.0,659.0,5,1079,2.0,811.0,811.0
0.004,17,2,234,1,61,0.0,33.0,33.0,1,173,0.0,145.0,145.0
0.001,17,2,180,1,66,0.0,38.0,38.0,1,114,0.0,86.0,86.0
1770.401,17,92,8096,46,4048,39342.0,60.0,60.0,46,4048,39342.0,60.0,60.0
0.006,6,13,3747,7,509,0.0,137.0,137.0,6,3238,1.0,1470.0,1459.0
0.001,17,2,180,1,66,0.0,38.0,38.0,1,114,0.0,86.0,86.0
0.007,6,10,1989,5,910,1.0,642.0,642.0,5,1079,1.0,811.0,811.0
0.111,6,10,1506,5,395,23.0,127.0,127.0,5,1111,23.0,843.0,843.0
0.042,17,2,152,1,76,0.0,48.0,48.0,1,76,0.0,48.0,48.0
0.085,6,10,1506,5,395,19.0,127.0,127.0,5,1111,18.0,843.0,843.0
0.115,17,4,352,2,130,76.0,37.0,37.0,2,222,76.0,89.0,83.0
0.001,17,2,180,1,66,0.0,38.0,38.0,1,114,0.0,86.0,86.0
171.101,17,80,11380,40,2677,4387.0,44.0,38.0,40,8703,4387.0,239.0,189.0
300.291,6,19,3084,11,1647,30029.0,517.0,266.0,8,1437,34326.0,824.0,337.0
0.135,6,10,1242,5,751,33.0,495.0,495.0,5,491,31.0,223.0,223.0
0.01,6,10,1989,5,910,2.0,642.0,642.0,5,1079,2.0,811.0,811.0
0.019,17,2,198,1,91,0.0,63.0,63.0,1,107,0.0,79.0,79.0
0.005,6,10,1689,5,839,1.0,571.0,571.0,5,850,1.0,582.0,582.0
0.004,17,4,284,2,120,1.0,32.0,32.0,2,164,0.0,60.0,54.0
0.006,6,10,1547,5,764,1.0,496.0,496.0,5,783,1.0,515.0,515.0
0.097,6,10,1506,5,395,20.0,127.0,127.0,5,1111,22.0,843.0,843.0
0.07,6,10,1506,5,395,15.0,127.0,127.0,5,1111,17.0,843.0,843.0
0.004,6,10,2007,5,928,1.0,660.0,660.0,5,1079,1.0,811.0,811.0
0.016,6,10,1631,5,848,3.0,580.0,580.0,5,783,3.0,515.0,515.0
0.054,6,10,1506,5,395,12.0,127.0,127.0,5,1111,12.0,843.0,843.0
0.007,6,10,2007,5,928,1.0,660.0,660.0,5,1079,1.0,811.0,811.0
0.069,17,8,3613,4,1874,23.0,1350.0,440.0,4,1739,11.0,1350.0,406.0
0.006,6,10,1774,5,923,1.0,655.0,655.0,5,851,1.0,583.0,583.0
0.005,6,10,1989,5,927,1.0,659.0,659.0,5,1062,1.0,794.0,794.0
0.097,6,10,1506,5,395,21.0,127.0,127.0,5,1111,23.0,843.0,843.0
0.019,6,10,1631,5,848,4.0,580.0,580.0,5,783,4.0,515.0,515.0
40.074,17,10,676,5,460,10017.0,104.0,64.0,5,216,10017.0,20.0,15.0
352.249,6,20,2210,6,1308,12003.0,494.0,494.0,14,902,27095.0,83.0,83.0
0.037,17,2,234,1,61,0.0,33.0,33.0,1,173,0.0,145.0,145.0
0.005,6,10,1854,5,889,1.0,621.0,621.0,5,965,1.0,697.0,697.0
0.005,6,10,1989,5,927,1.0,659.0,659.0,5,1062,1.0,794.0,794.0
0.019,17,4,284,2,120,0.0,32.0,32.0,2,164,0.0,60.0,54.0
0.035,17,2,152,1,76,0.0,48.0,48.0,1,76,0.0,48.0,48.0
0.004,6,10,1779,5,928,1.0,660.0,660.0,5,851,1.0,583.0,583.0
0.085,6,10,1506,5,395,19.0,127.0,127.0,5,1111,19.0,843.0,843.0
0.124,6,10,1506,5,395,29.0,127.0,127.0,5,1111,27.0,843.0,843.0
0.022,6,10,1631,5,848,5.0,580.0,580.0,5,783,5.0,515.0,515.0
0.006,6,10,1547,5,764,1.0,496.0,496.0,5,783,1.0,515.0,515.0
0.001,17,2,136,1,60,0.0,32.0,32.0,1,76,0.0,48.0,48.0
0.003,17,2,136,1,60,0.0,32.0,32.0,1,76,0.0,48.0,48.0
0.012,6,10,1990,5,911,2.0,643.0,643.0,5,1079,3.0,811.0,811.0
0.092,6,10,1506,5,395,18.0,127.0,127.0,5,1111,19.0,843.0,843.0
0.004,17,4,284,2,120,0.0,32.0,32.0,2,164,1.0,60.0,54.0
0.122,6,10,1506,5,395,27.0,127.0,127.0,5,1111,28.0,843.0,843.0
0.083,6,10,1506,5,395,19.0,127.0,127.0,5,1111,17.0,843.0,843.0
0.008,6,12,1926,6,1189,1.0,659.0,434.0,6,737,1.0,417.0,417.0
0.005,6,10,2007,5,928,1.0,660.0,660.0,5,1079,1.0,811.0,811.0
0.061,6,10,1506,5,395,14.0,127.0,127.0,5,1111,14.0,843.0,843.0
0.018,6,10,1990,5,911,4.0,643.0,643.0,5,1079,4.0,811.0,811.0
40.056,17,10,676,5,460,10013.0,104.0,64.0,5,216,10013.0,20.0,15.0
0.116,6,10,1506,5,395,17.0,127.0,127.0,5,1111,26.0,843.0,843.0
0.003,17,2,152,1,76,0.0,48.0,48.0,1,76,0.0,48.0,48.0
0.006,6,10,1989,5,927,1.0,659.0,659.0,5,1062,1.0,794.0,794.0
0.064,6,10,1506,5,395,15.0,127.0,127.0,5,1111,15.0,843.0,843.0
0.085,6,10,1506,5,395,17.0,127.0,127.0,5,1111,19.0,843.0,843.0
0.082,6,10,1506,5,395,17.0,127.0,127.0,5,1111,16.0,843.0,843.0
0.038,17,2,148,1,60,0.0,32.0,32.0,1,88,0.0,60.0,60.0
5.115,6,23,6467,13,1827,425.0,801.0,282.0,10,4640,567.0,1925.0,824.0
462.691,6,47,14748,25,3114,19278.0,664.0,361.0,22,11634,19173.0,1402.0,655.0
0.084,6,10,1506,5,395,17.0,127.0,127.0,5,1111,19.0,843.0,843.0
0.005,6,10,2006,5,927,1.0,659.0,659.0,5,1079,1.0,811.0,811.0
0.082,6,10,1506,5,395,18.0,127.0,127.0,5,1111,18.0,843.0,843.0
0.014,6,10,1762,5,911,3.0,643.0,643.0,5,851,3.0,583.0,583.0
0.076,6,10,1506,5,395,16.0,127.0,127.0,5,1111,17.0,843.0,843.0
0.089,6,10,1506,5,395,20.0,127.0,127.0,5,1111,20.0,843.0,843.0
0.005,6,10,1989,5,927,1.0,659.0,659.0,5,1062,1.0,794.0,794.0
0.004,6,10,2006,5,927,1.0,659.0,659.0,5,1079,1.0,811.0,811.0
0.001,17,2,180,1,66,0.0,38.0,38.0,1,114,0.0,86.0,86.0
0.005,17,2,144,1,64,0.0,36.0,36.0,1,80,0.0,52.0,52.0
0.006,6,10,2006,5,927,1.0,659.0,659.0,5,1079,1.0,811.0,811.0
0.017,6,10,1989,5,910,4.0,642.0,642.0,5,1079,4.0,811.0,811.0
0.011,6,13,3735,7,497,1.0,125.0,125.0,6,3238,2.0,1470.0,1459.0
0.005,6,10,2007,5,928,1.0,660.0,660.0,5,1079,1.0,811.0,811.0
0.015,6,10,1677,5,827,3.0,559.0,559.0,5,850,3.0,582.0,582.0
10.943,17,28,4422,14,1993,833.0,268.0,114.0,14,2429,833.0,588.0,145.0
0.007,6,10,1547,5,764,1.0,496.0,496.0,5,783,1.0,515.0,515.0
0.006,6,10,1989,5,927,1.0,659.0,659.0,5,1062,1.0,794.0,794.0
0.006,6,10,1547,5,764,1.0,496.0,496.0,5,783,1.0,515.0,515.0
0.01,6,10,1990,5,911,2.0,643.0,643.0,5,1079,2.0,811.0,811.0
0.007,17,2,412,1,61,0.0,33.0,33.0,1,351,0.0,323.0,323.0
0.004,6,10,2000,5,927,1.0,659.0,659.0,5,1073,1.0,805.0,805.0
0.005,6,10,2006,5,927,1.0,659.0,659.0,5,1079,1.0,811.0,811.0
0.134,6,10,1506,5,395,31.0,127.0,127.0,5,1111,30.0,843.0,843.0
0.074,6,10,1506,5,395,16.0,127.0,127.0,5,1111,17.0,843.0,843.0
0.005,6,10,2007,5,928,1.0,660.0,660.0,5,1079,1.0,811.0,811.0
0.013,6,10,1989,5,910,3.0,642.0,642.0,5,1079,3.0,811.0,811.0
0.012,6,10,1972,5,910,3.0,642.0,642.0,5,1062,3.0,794.0,794.0
0.094,6,10,1506,5,395,21.0,127.0,127.0,5,1111,20.0,843.0,843.0
0.004,6,10,1779,5,928,1.0,660.0,660.0,5,851,1.0,583.0,583.0
0.089,6,10,1506,5,395,20.0,127.0,127.0,5,1111,16.0,843.0,843.0
0.006,6,10,1643,5,860,1.0,592.0,592.0,5,783,1.0,515.0,515.0
309.734,17,20,1124,10,716,34400.0,48.0,43.0,10,408,34400.0,20.0,12.0
0.1,6,10,1506,5,395,23.0,127.0,127.0,5,1111,23.0,843.0,843.0
0.102,17,2,152,1,76,0.0,48.0,48.0,1,76,0.0,48.0,48.0
0.005,6,10,2007,5,928,1.0,660.0,660.0,5,1079,1.0,811.0,811.0
0.003,17,2,148,1,60,0.0,32.0,32.0,1,88,0.0,60.0,60.0
0.1,6,10,1506,5,395,16.0,127.0,127.0,5,1111,24.0,843.0,843.0
0.006,6,10,1547,5,764,1.0,496.0,496.0,5,783,1.0,515.0,515.0
0.118,6,10,1506,5,395,28.0,127.0,127.0,5,1111,23.0,843.0,843.0
0.005,6,10,2006,5,927,1.0,659.0,659.0,5,1079,1.0,811.0,811.0
0.018,6,10,1983,5,910,4.0,642.0,642.0,5,1073,4.0,805.0,805.0
0.009,6,10,1989,5,910,2.0,642.0,642.0,5,1079,2.0,811.0,811.0
0.005,6,10,1854,5,889,1.0,621.0,621.0,5,965,1.0,697.0,697.0
0.071,17,2,136,1,60,0.0,32.0,32.0,1,76,0.0,48.0,48.0
0.003,17,2,148,1,60,0.0,32.0,32.0,1,88,0.0,60.0,60.0
0.042,17,4,352,2,130,0.0,37.0,37.0,2,222,5.0,89.0,83.0
0.016,6,10,1983,5,910,4.0,642.0,642.0,5,1073,4.0,805.0,805.0
0.004,6,10,1989,5,927,1.0,659.0,659.0,5,1062,1.0,794.0,794.0
0.004,6,10,1774,5,923,1.0,655.0,655.0,5,851,1.0,583.0,583.0
0.013,6,10,1972,5,910,3.0,642.0,642.0,5,1062,3.0,794.0,794.0
0.022,6,10,1677,5,827,5.0,559.0,559.0,5,850,5.0,582.0,582.0
0.006,6,10,1779,5,928,1.0,660.0,660.0,5,851,1.0,583.0,583.0
0.009,6,10,1983,5,910,2.0,642.0,642.0,5,1073,2.0,805.0,805.0
0.077,6,10,1506,5,395,16.0,127.0,127.0,5,1111,17.0,843.0,843.0
0.01,6,10,1972,5,910,2.0,642.0,642.0,5,1062,2.0,794.0,794.0
0.001,17,2,179,1,62,0.0,34.0,34.0,1,117,0.0,89.0,89.0
1.58,6,37,6787,19,3451,87.0,1103.0,204.0,18,3336,89.0,1402.0,340.0
0.007,17,2,179,1,71,0.0,43.0,43.0,1,108,0.0,80.0,80.0
0.065,6,10,1506,5,395,15.0,127.0,127.0,5,1111,14.0,843.0,843.0
0.007,6,10,1989,5,910,1.0,642.0,642.0,5,1079,1.0,811.0,811.0
0.126,6,10,1506,5,395,30.0,127.0,127.0,5,1111,28.0,843.0,843.0
0.006,6,10,1547,5,764,1.0,496.0,496.0,5,783,1.0,515.0,515.0
0.213,6,16,2674,8,1400,30.0,533.0,325.0,8,1274,19.0,529.0,212.0
0.02,6,10,1989,5,910,4.0,642.0,642.0,5,1079,5.0,811.0,811.0
0.103,6,10,1506,5,395,22.0,127.0,127.0,5,1111,24.0,843.0,843.0
0.011,6,10,1983,5,910,2.0,642.0,642.0,5,1073,2.0,805.0,805.0
0.08,6,10,1506,5,395,18.0,127.0,127.0,5,1111,12.0,843.0,843.0
0.005,6,10,2000,5,927,1.0,659.0,659.0,5,1073,1.0,805.0,805.0
0.014,6,10,1762,5,911,3.0,643.0,643.0,5,851,3.0,583.0,583.0
0.095,6,10,1506,5,395,20.0,127.0,127.0,5,1111,21.0,843.0,843.0
0.004,17,2,136,1,60,0.0,32.0,32.0,1,76,0.0,48.0,48.0
0.039,17,4,420,2,122,0.0,33.0,33.0,2,298,35.0,145.0,121.0
0.038,17,2,152,1,76,0.0,48.0,48.0,1,76,0.0,48.0,48.0
0.078,6,10,1506,5,395,17.0,127.0,127.0,5,1111,15.0,843.0,843.0
0.011,6,10,1990,5,911,2.0,643.0,643.0,5,1079,2.0,811.0,811.0
0.008,6,10,1972,5,910,2.0,642.0,642.0,5,1062,2.0,794.0,794.0
0.001,17,2,136,1,60,0.0,32.0,32.0,1,76,0.0,48.0,48.0
0.005,6,10,1854,5,889,1.0,621.0,621.0,5,965,1.0,697.0,697.0
0.126,6,10,1506,5,395,30.0,127.0,127.0,5,1111,26.0,843.0,843.0
40.059,17,10,676,5,460,10014.0,104.0,64.0,5,216,10014.0,20.0,15.0
0.007,17,2,194,1,59,0.0,31.0,31.0,1,135,0.0,107.0,107.0
0.003,17,2,148,1,60,0.0,32.0,32.0,1,88,0.0,60.0,60.0
0.099,6,10,1506,5,395,22.0,127.0,127.0,5,1111,21.0,843.0,843.0
0.005,17,2,169,1,62,0.0,34.0,34.0,1,107,0.0,79.0,79.0
0.01,6,10,1989,5,910,2.0,642.0,642.0,5,1079,2.0,811.0,811.0
0.084,6,10,1506,5,395,20.0,127.0,127.0,5,1111,15.0,843.0,843.0
0.771,6,10,2009,6,1655,154.0,1403.0,1403.0,4,354,179.0,182.0,182.0
0.005,6,14,3799,7,509,0.0,137.0,137.0,7,3290,0.0,1448.0,972.0
0.0,17,2,146,1,65,0.0,37.0,37.0,1,81,0.0,53.0,53.0
0.005,6,13,3690,7,452,0.0,80.0,80.0,6,3238,1.0,1470.0,1459.0
0.082,6,10,1990,5,911,20.0,643.0,643.0,5,1079,20.0,811.0,811.0
0.005,6,10,1989,5,927,1.0,659.0,659.0,5,1062,1.0,794.0,794.0
0.005,17,2,144,1,64,0.0,36.0,36.0,1,80,0.0,52.0,52.0
0.092,6,10,1506,5,395,20.0,127.0,127.0,5,1111,21.0,843.0,843.0
0.005,6,10,1547,5,764,1.0,496.0,496.0,5,783,1.0,515.0,515.0
0.088,6,10,1506,5,395,16.0,127.0,127.0,5,1111,21.0,843.0,843.0
0.033,6,10,1990,5,911,8.0,643.0,643.0,5,1079,8.0,811.0,811.0
0.001,17,2,180,1,66,0.0,38.0,38.0,1,114,0.0,86.0,86.0
0.081,6,10,1506,5,395,16.0,127.0,127.0,5,1111,17.0,843.0,843.0
354.004,6,21,1795,16,1030,23600.0,190.0,190.0,5,765,60002.0,464.0,248.0
0.009,6,12,1926,6,1189,1.0,659.0,434.0,6,737,1.0,417.0,417.0
0.006,17,2,214,1,75,0.0,47.0,47.0,1,139,0.0,111.0,111.0
0.004,6,10,2006,5,927,1.0,659.0,659.0,5,1079,1.0,811.0,811.0
0.096,6,10,1506,5,395,21.0,127.0,127.0,5,1111,21.0,843.0,843.0
0.129,6,10,1506,5,395,32.0,127.0,127.0,5,1111,26.0,843.0,843.0
0.005,6,10,1643,5,860,1.0,592.0,592.0,5,783,1.0,515.0,515.0
0.072,17,2,156,1,64,0.0,36.0,36.0,1,92,0.0,64.0,64.0
0.004,6,10,2000,5,927,1.0,659.0,659.0,5,1073,1.0,805.0,805.0
0.005,17,2,166,1,75,0.0,47.0,47.0,1,91,0.0,63.0,63.0
0.055,6,10,1506,5,395,12.0,127.0,127.0,5,1111,12.0,843.0,843.0
40.065,17,10,676,5,460,10014.0,104.0,64.0,5,216,10015.0,20.0,15.0
0.015,6,10,1989,5,910,3.0,642.0,642.0,5,1079,3.0,811.0,811.0
365.87,6,22,2313,16,867,24391.0,195.0,195.0,6,1446,4640.0,419.0,398.0
1799.94,17,3132,239815,1555,126207,1158.0,84.0,53.0,1577,113608,1142.0,227.0,44.0
0.013,6,10,1631,5,848,3.0,580.0,580.0,5,783,3.0,515.0,515.0
0.004,6,10,2006,5,927,1.0,659.0,659.0,5,1079,1.0,811.0,811.0
0.005,17,2,140,1,62,0.0,34.0,34.0,1,78,0.0,50.0,50.0
0.006,6,10,1643,5,860,1.0,592.0,592.0,5,783,1.0,515.0,515.0
0.005,6,10,2007,5,928,1.0,660.0,660.0,5,1079,1.0,811.0,811.0
0.112,6,10,1506,5,395,25.0,127.0,127.0,5,1111,20.0,843.0,843.0
0.016,6,10,1990,5,911,3.0,643.0,643.0,5,1079,4.0,811.0,811.0
0.006,17,2,140,1,62,0.0,34.0,34.0,1,78,0.0,50.0,50.0
0.007,6,10,1990,5,911,1.0,643.0,643.0,5,1079,1.0,811.0,811.0
0.006,6,13,3747,7,509,0.0,137.0,137.0,6,3238,1.0,1470.0,1459.0
376.145,6,24,2405,17,919,23509.0,195.0,195.0,7,1486,3901.0,419.0,398.0
0.016,6,10,1989,5,910,4.0,642.0,642.0,5,1079,3.0,811.0,811.0
0.004,6,10,1702,5,863,1.0,595.0,595.0,5,839,1.0,571.0,571.0
0.009,6,10,1972,5,910,2.0,642.0,642.0,5,1062,2.0,794.0,794.0
0.0,17,2,154,1,69,0.0,41.0,41.0,1,85,0.0,57.0,57.0
0.011,6,10,1983,5,910,2.0,642.0,642.0,5,1073,2.0,805.0,805.0
0.006,6,10,1854,5,889,1.0,621.0,621.0,5,965,1.0,697.0,697.0
0.006,17,2,179,1,71,0.0,43.0,43.0,1,108,0.0,80.0,80.0
0.005,6,10,1689,5,839,1.0,571.0,571.0,5,850,1.0,582.0,582.0
0.014,17,2,152,1,56,0.0,28.0,28.0,1,96,0.0,68.0,68.0
0.006,6,10,1762,5,911,1.0,643.0,643.0,5,851,1.0,583.0,583.0
0.007,6,10,2000,5,927,1.0,659.0,659.0,5,1073,1.0,805.0,805.0
0.015,6,10,1989,5,910,3.0,642.0,642.0,5,1079,3.0,811.0,811.0
0.003,17,2,136,1,60,0.0,32.0,32.0,1,76,0.0,48.0,48.0
0.019,6,10,1631,5,848,4.0,580.0,580.0,5,783,4.0,515.0,515.0
0.011,6,10,1989,5,910,2.0,642.0,642.0,5,1079,2.0,811.0,811.0
0.084,6,10,1506,5,395,20.0,127.0,127.0,5,1111,16.0,843.0,843.0
0.09,6,10,1506,5,395,20.0,127.0,127.0,5,1111,20.0,843.0,843.0
0.004,6,10,1989,5,927,1.0,659.0,659.0,5,1062,1.0,794.0,794.0
0.005,6,10,1547,5,764,1.0,496.0,496.0,5,783,1.0,515.0,515.0
59.028,6,255,210929,137,199121,150.0,2720.0,1713.0,118,11808,503.0,2667.0,228.0
0.015,6,10,1989,5,910,3.0,642.0,642.0,5,1079,3.0,811.0,811.0
0.069,6,10,1506,5,395,14.0,127.0,127.0,5,1111,14.0,843.0,843.0
0.014,6,10,1989,5,910,3.0,642.0,642.0,5,1079,3.0,811.0,811.0
0.012,6,10,1990,5,911,3.0,643.0,643.0,5,1079,2.0,811.0,811.0
0.011,6,10,1972,5,910,2.0,642.0,642.0,5,1062,2.0,794.0,794.0
0.005,6,10,2007,5,928,1.0,660.0,660.0,5,1079,1.0,811.0,811.0
179.078,17,84,11778,42,2797,4367.0,44.0,38.0,42,8981,4367.0,239.0,185.0
0.006,17,2,152,1,76,0.0,48.0,48.0,1,76,0.0,48.0,48.0
0.005,17,2,214,1,75,0.0,47.0,47.0,1,139,0.0,111.0,111.0
0.077,6,10,1506,5,395,17.0,127.0,127.0,5,1111,17.0,843.0,843.0
0.01,6,10,1989,5,910,2.0,642.0,642.0,5,1079,2.0,811.0,811.0
0.006,6,10,1689,5,839,1.0,571.0,571.0,5,850,1.0,582.0,582.0
40.074,17,10,676,5,460,10016.0,104.0,64.0,5,216,10017.0,20.0,15.0
0.09,6,10,1506,5,395,19.0,127.0,127.0,5,1111,18.0,843.0,843.0
0.005,17,2,166,1,75,0.0,47.0,47.0,1,91,0.0,63.0,63.0
295.383,6,318,343819,123,17902,2421.0,2736.0,885.0,195,325917,1522.0,2804.0,1764.0
0.005,6,10,1689,5,839,1.0,571.0,571.0,5,850,1.0,582.0,582.0
0.1,6,10,1506,5,395,22.0,127.0,127.0,5,1111,24.0,843.0,843.0
0.005,6,10,2000,5,927,1.0,659.0,659.0,5,1073,1.0,805.0,805.0
0.042,17,2,146,1,65,0.0,37.0,37.0,1,81,0.0,53.0,53.0
0.128,6,10,1506,5,395,29.0,127.0,127.0,5,1111,29.0,843.0,843.0
0.078,6,10,1506,5,395,16.0,127.0,127.0,5,1111,18.0,843.0,843.0
0.012,6,10,1631,5,848,3.0,580.0,580.0,5,783,2.0,515.0,515.0
0.103,6,10,1506,5,395,20.0,127.0,127.0,5,1111,21.0,843.0,843.0
0.006,6,10,1989,5,927,1.0,659.0,659.0,5,1062,1.0,794.0,794.0
0.001,17,2,180,1,65,0.0,37.0,37.0,1,115,0.0,87.0,87.0
0.005,6,13,3690,7,452,0.0,80.0,80.0,6,3238,0.0,1470.0,1459.0
0.012,6,10,1972,5,910,3.0,642.0,642.0,5,1062,2.0,794.0,794.0
0.013,17,2,152,1,56,0.0,28.0,28.0,1,96,0.0,68.0,68.0
0.005,17,2,179,1,71,0.0,43.0,43.0,1,108,0.0,80.0,80.0
40.065,17,10,676,5,460,10015.0,104.0,64.0,5,216,10015.0,20.0,15.0
0.004,6,10,1702,5,863,1.0,595.0,595.0,5,839,1.0,571.0,571.0
0.003,17,2,148,1,60,0.0,32.0,32.0,1,88,0.0,60.0,60.0
0.006,6,10,1989,5,927,1.0,659.0,659.0,5,1062,1.0,794.0,794.0
293.441,6,407,349359,201,22006,1467.0,2736.0,889.0,206,327353,1431.0,2804.0,1649.0
0.001,17,2,180,1,66,0.0,38.0,38.0,1,114,0.0,86.0,86.0
0.015,6,10,1631,5,848,3.0,580.0,580.0,5,783,3.0,515.0,515.0
0.01,6,10,1972,5,910,2.0,642.0,642.0,5,1062,2.0,794.0,794.0
0.097,6,10,1506,5,395,21.0,127.0,127.0,5,1111,22.0,843.0,843.0
0.009,6,10,1983,5,910,2.0,642.0,642.0,5,1073,2.0,805.0,805.0
40.059,17,10,676,5,460,10013.0,104.0,64.0,5,216,10014.0,20.0,15.0
280.534,6,23,6075,10,1186,31169.0,267.0,156.0,13,4889,23377.0,1400.0,873.0
0.004,6,10,1774,5,923,1.0,655.0,655.0,5,851,1.0,583.0,583.0
0.117,6,10,1506,5,395,24.0,127.0,127.0,5,1111,23.0,843.0,843.0
0.005,6,10,2006,5,927,1.0,659.0,659.0,5,1079,1.0,811.0,811.0
0.071,17,2,169,1,62,0.0,34.0,34.0,1,107,0.0,79.0,79.0
240.07,6,20,4872,11,941,24007.0,180.0,93.0,9,3931,30008.0,1591.0,575.0
0.005,6,10,1643,5,860,1.0,592.0,592.0,5,783,1.0,515.0,515.0
0.012,6,10,1972,5,910,3.0,642.0,642.0,5,1062,3.0,794.0,794.0
0.135,17,2,80,1,32,0.0,4.0,4.0,1,48,0.0,20.0,20.0
0.009,17,2,194,1,59,0.0,31.0,31.0,1,135,0.0,107.0,107.0
0.01,6,10,1989,5,910,2.0,642.0,642.0,5,1079,2.0,811.0,811.0
0.017,6,10,1972,5,910,4.0,642.0,642.0,5,1062,4.0,794.0,794.0
0.009,6,10,1972,5,910,2.0,642.0,642.0,5,1062,2.0,794.0,794.0
0.037,17,2,148,1,60,0.0,32.0,32.0,1,88,0.0,60.0,60.0
0.009,6,10,1989,5,927,2.0,659.0,659.0,5,1062,2.0,794.0,794.0
0.078,6,10,1506,5,395,15.0,127.0,127.0,5,1111,16.0,843.0,843.0
0.004,6,10,2006,5,927,1.0,659.0,659.0,5,1079,1.0,811.0,811.0
0.015,6,10,1989,5,910,3.0,642.0,642.0,5,1079,3.0,811.0,811.0
0.004,6,10,2006,5,927,1.0,659.0,659.0,5,1079,1.0,811.0,811.0
0.004,6,10,1989,5,927,1.0,659.0,659.0,5,1062,1.0,794.0,794.0
40.068,17,10,676,5,460,10015.0,104.0,64.0,5,216,10016.0,20.0,15.0
0.249,17,2,152,1,76,0.0,48.0,48.0,1,76,0.0,48.0,48.0
0.01,6,10,1972,5,910,2.0,642.0,642.0,5,1062,2.0,794.0,794.0
0.005,17,2,169,1,62,0.0,34.0,34.0,1,107,0.0,79.0,79.0
0.001,17,2,166,1,75,0.0,47.0,47.0,1,91,0.0,63.0,63.0
0.147,6,10,1506,5,395,36.0,127.0,127.0,5,1111,30.0,843.0,843.0
0.097,6,10,1506,5,395,19.0,127.0,127.0,5,1111,21.0,843.0,843.0
0.001,17,2,180,1,66,0.0,38.0,38.0,1,114,0.0,86.0,86.0
0.099,17,2,80,1,32,0.0,4.0,4.0,1,48,0.0,20.0,20.0
0.003,17,2,148,1,60,0.0,32.0,32.0,1,88,0.0,60.0,60.0
0.006,6,10,1643,5,860,1.0,592.0,592.0,5,783,1.0,515.0,515.0
0.015,6,10,1631,5,848,3.0,580.0,580.0,5,783,3.0,515.0,515.0
170.209,17,82,11537,41,2752,4255.0,44.0,39.0,41,8785,4255.0,239.0,186.0
0.128,17,2,80,1,32,0.0,4.0,4.0,1,48,0.0,20.0,20.0
0.092,6,10,1506,5,395,20.0,127.0,127.0,5,1111,21.0,843.0,843.0
0.085,6,10,1506,5,395,19.0,127.0,127.0,5,1111,16.0,843.0,843.0
0.005,6,10,1702,5,863,1.0,595.0,595.0,5,839,1.0,571.0,571.0
0.006,6,10,1547,5,764,1.0,496.0,496.0,5,783,1.0,515.0,515.0
174.458,17,78,10947,39,2599,4590.0,44.0,38.0,39,8348,4590.0,239.0,186.0
0.004,6,10,2007,5,928,1.0,660.0,660.0,5,1079,1.0,811.0,811.0
0.005,6,10,1774,5,923,1.0,655.0,655.0,5,851,1.0,583.0,583.0
0.122,6,10,1506,5,395,26.0,127.0,127.0,5,1111,25.0,843.0,843.0
1770.766,17,120,11460,60,5460,30012.0,63.0,63.0,60,6000,30012.0,72.0,72.0
0.08,17,2,80,1,32,0.0,4.0,4.0,1,48,0.0,20.0,20.0
0.009,6,10,1762,5,911,2.0,643.0,643.0,5,851,2.0,583.0,583.0
0.08,6,10,1506,5,395,18.0,127.0,127.0,5,1111,15.0,843.0,843.0
10.884,17,28,4422,14,1994,828.0,269.0,114.0,14,2428,828.0,587.0,145.0
0.068,6,10,1506,5,395,14.0,127.0,127.0,5,1111,15.0,843.0,843.0
0.003,17,2,148,1,60,0.0,32.0,32.0,1,88,0.0,60.0,60.0
0.019,6,10,1990,5,911,4.0,643.0,643.0,5,1079,4.0,811.0,811.0
0.005,6,10,1854,5,889,1.0,621.0,621.0,5,965,1.0,697.0,697.0
0.006,17,2,136,1,60,0.0,32.0,32.0,1,76,0.0,48.0,48.0
0.082,6,10,1506,5,395,18.0,127.0,127.0,5,1111,19.0,843.0,843.0
0.092,6,10,1506,5,395,20.0,127.0,127.0,5,1111,19.0,843.0,843.0
0.008,6,10,1989,5,910,2.0,642.0,642.0,5,1079,2.0,811.0,811.0
0.006,6,10,1547,5,764,1.0,496.0,496.0,5,783,1.0,515.0,515.0
0.011,6,10,1983,5,910,2.0,642.0,642.0,5,1073,2.0,805.0,805.0
1.045,6,12,3142,6,2099,157.0,1328.0,923.0,6,1043,157.0,791.0,791.0
0.103,6,10,1506,5,395,23.0,127.0,127.0,5,1111,22.0,843.0,843.0
0.004,6,10,2007,5,928,1.0,660.0,660.0,5,1079,1.0,811.0,811.0
8.974,6,39,10487,20,4929,472.0,1360.0,682.0,19,5558,487.0,2667.0,435.0
0.005,6,10,2007,5,928,1.0,660.0,660.0,5,1079,1.0,811.0,811.0
0.011,6,10,1972,5,910,2.0,642.0,642.0,5,1062,2.0,794.0,794.0
0.006,17,2,152,1,76,0.0,48.0,48.0,1,76,0.0,48.0,48.0
40.064,17,10,676,5,460,10014.0,104.0,64.0,5,216,10015.0,20.0,15.0
0.005,6,10,2006,5,927,1.0,659.0,659.0,5,1079,1.0,811.0,811.0
0.015,6,10,1989,5,910,3.0,642.0,642.0,5,1079,3.0,811.0,811.0
0.017,6,10,1631,5,848,4.0,580.0,580.0,5,783,4.0,515.0,515.0
0.005,6,10,2007,5,928,1.0,660.0,660.0,5,1079,1.0,811.0,811.0
0.006,17,2,170,1,65,0.0,37.0,37.0,1,105,0.0,77.0,77.0
0.017,6,10,1989,5,910,4.0,642.0,642.0,5,1079,4.0,811.0,811.0
0.005,6,10,2006,5,927,1.0,659.0,659.0,5,1079,1.0,811.0,811.0
0.013,6,10,1989,5,910,3.0,642.0,642.0,5,1079,3.0,811.0,811.0
0.004,6,10,1989,5,927,1.0,659.0,659.0,5,1062,1.0,794.0,794.0
0.012,6,10,1972,5,910,3.0,642.0,642.0,5,1062,2.0,794.0,794.0
0.27,17,43,24451,24,21172,11.0,1350.0,854.0,19,3279,11.0,1350.0,144.0
0.011,6,10,1989,5,910,2.0,642.0,642.0,5,1079,2.0,811.0,811.0
0.011,6,10,1990,5,911,2.0,643.0,643.0,5,1079,2.0,811.0,811.0
0.009,6,10,1972,5,910,2.0,642.0,642.0,5,1062,2.0,794.0,794.0
0.005,6,10,2007,5,928,1.0,660.0,660.0,5,1079,1.0,811.0,811.0
0.005,6,10,1779,5,928,1.0,660.0,660.0,5,851,1.0,583.0,583.0
310.307,17,20,1124,10,716,34464.0,48.0,43.0,10,408,34464.0,20.0,12.0
0.005,6,10,2006,5,927,1.0,659.0,659.0,5,1079,1.0,811.0,811.0
0.014,6,10,1972,5,910,3.0,642.0,642.0,5,1062,3.0,794.0,794.0
0.001,17,2,180,1,66,0.0,38.0,38.0,1,114,0.0,86.0,86.0
0.013,6,10,1972,5,910,3.0,642.0,642.0,5,1062,3.0,794.0,794.0
11.153,17,28,4422,14,1994,845.0,269.0,114.0,14,2428,845.0,587.0,145.0
0.004,6,10,2007,5,928,1.0,660.0,660.0,5,1079,1.0,811.0,811.0
0.024,6,10,1989,5,910,5.0,642.0,642.0,5,1079,6.0,811.0,811.0
0.009,6,12,1926,6,1189,1.0,659.0,434.0,6,737,1.0,417.0,417.0
0.005,6,10,1774,5,923,1.0,655.0,655.0,5,851,1.0,583.0,583.0
0.006,6,10,1689,5,839,1.0,571.0,571.0,5,850,1.0,582.0,582.0
0.002,17,2,180,1,66,0.0,38.0,38.0,1,114,0.0,86.0,86.0
328.21,17,18,1008,9,640,41018.0,48.0,43.0,9,368,41018.0,20.0,12.0
0.005,6,10,2006,5,927,1.0,659.0,659.0,5,1079,1.0,811.0,811.0
0.003,17,2,148,1,60,0.0,32.0,32.0,1,88,0.0,60.0,60.0
0.193,6,3,453,2,321,193.0,241.0,241.0,1,132,0.0,92.0,92.0
0.007,6,10,2006,5,927,1.0,659.0,659.0,5,1079,1.0,811.0,811.0
0.005,6,10,2006,5,927,1.0,659.0,659.0,5,1079,1.0,811.0,811.0
0.005,6,10,1689,5,839,1.0,571.0,571.0,5,850,1.0,582.0,582.0
0.004,17,4,284,2,120,0.0,32.0,32.0,2,164,0.0,60.0,54.0
0.042,17,2,412,1,61,0.0,33.0,33.0,1,351,0.0,323.0,323.0
0.01,6,13,3735,7,497,1.0,125.0,125.0,6,3238,1.0,1470.0,1459.0
0.006,6,10,1547,5,764,1.0,496.0,496.0,5,783,1.0,515.0,515.0
0.005,6,10,2006,5,927,1.0,659.0,659.0,5,1079,1.0,811.0,811.0
0.005,6,10,1989,5,927,1.0,659.0,659.0,5,1062,1.0,794.0,794.0
0.093,6,10,1506,5,395,21.0,127.0,127.0,5,1111,20.0,843.0,843.0
333.571,6,34,13147,16,3153,22237.0,661.0,385.0,18,9994,19621.0,1934.0,906.0
0.022,6,10,1972,5,910,5.0,642.0,642.0,5,1062,5.0,794.0,794.0
352.042,6,20,2210,6,1308,12014.0,494.0,494.0,14,902,27079.0,83.0,83.0
0.006,6,10,1547,5,764,1.0,496.0,496.0,5,783,1.0,515.0,515.0
240.089,6,16,4480,9,963,30011.0,238.0,166.0,7,3517,40014.0,1402.0,786.0
0.023,6,10,1989,5,910,5.0,642.0,642.0,5,1079,5.0,811.0,811.0
15.07,17,14,9191,8,6902,2148.0,1350.0,834.0,6,2289,3008.0,1350.0,353.0
0.01,6,10,1989,5,910,2.0,642.0,642.0,5,1079,2.0,811.0,811.0
0.005,6,13,3690,7,452,0.0,80.0,80.0,6,3238,0.0,1470.0,1459.0
0.004,6,10,1989,5,927,1.0,659.0,659.0,5,1062,1.0,794.0,794.0
0.007,6,10,1989,5,910,1.0,642.0,642.0,5,1079,1.0,811.0,811.0
40.086,17,10,676,5,460,10020.0,104.0,64.0,5,216,10020.0,20.0,15.0
0.005,6,13,3690,7,452,0.0,80.0,80.0,6,3238,0.0,1470.0,1459.0
0.001,17,2,178,1,81,0.0,53.0,53.0,1,97,0.0,69.0,69.0
0.062,6,10,1506,5,395,13.0,127.0,127.0,5,1111,14.0,843.0,843.0
0.09,6,10,1506,5,395,19.0,127.0,127.0,5,1111,17.0,843.0,843.0
0.006,6,10,1689,5,839,1.0,571.0,571.0,5,850,1.0,582.0,582.0
0.005,6,10,1774,5,923,1.0,655.0,655.0,5,851,1.0,583.0,583.0
0.006,6,10,1689,5,839,1.0,571.0,571.0,5,850,1.0,582.0,582.0
0.082,6,10,1506,5,395,16.0,127.0,127.0,5,1111,18.0,843.0,843.0
0.005,6,10,2007,5,928,1.0,660.0,660.0,5,1079,1.0,811.0,811.0
0.003,17,2,148,1,60,0.0,32.0,32.0,1,88,0.0,60.0,60.0
0.083,6,10,1506,5,395,18.0,127.0,127.0,5,1111,17.0,843.0,843.0
0.097,6,10,1506,5,395,21.0,127.0,127.0,5,1111,21.0,843.0,843.0
0.007,6,10,1547,5,764,1.0,496.0,496.0,5,783,1.0,515.0,515.0
0.013,6,10,1989,5,910,3.0,642.0,642.0,5,1079,3.0,811.0,811.0
0.011,6,10,1989,5,910,2.0,642.0,642.0,5,1079,2.0,811.0,811.0
0.008,6,10,1547,5,764,1.0,496.0,496.0,5,783,1.0,515.0,515.0
0.013,17,2,152,1,56,0.0,28.0,28.0,1,96,0.0,68.0,68.0
0.005,6,10,2000,5,927,1.0,659.0,659.0,5,1073,1.0,805.0,805.0
0.015,6,10,1631,5,848,3.0,580.0,580.0,5,783,3.0,515.0,515.0
0.02,17,2,198,1,91,0.0,63.0,63.0,1,107,0.0,79.0,79.0
0.004,6,10,1989,5,927,1.0,659.0,659.0,5,1062,1.0,794.0,794.0
40.071,17,10,676,5,460,10014.0,104.0,64.0,5,216,10016.0,20.0,15.0
40.113,17,10,676,5,460,10014.0,104.0,64.0,5,216,10024.0,20.0,15.0
0.005,6,13,3747,7,509,0.0,137.0,137.0,6,3238,1.0,1470.0,1459.0
0.006,6,10,1689,5,839,1.0,571.0,571.0,5,850,1.0,582.0,582.0
0.001,17,2,136,1,60,0.0,32.0,32.0,1,76,0.0,48.0,48.0
0.015,6,10,1989,5,910,3.0,642.0,642.0,5,1079,3.0,811.0,811.0
0.005,6,10,1689,5,839,1.0,571.0,571.0,5,850,1.0,582.0,582.0
0.004,6,10,2007,5,928,1.0,660.0,660.0,5,1079,1.0,811.0,811.0
0.116,6,10,1506,5,395,24.0,127.0,127.0,5,1111,25.0,843.0,843.0
0.02,6,10,1990,5,911,4.0,643.0,643.0,5,1079,4.0,811.0,811.0
0.005,6,10,2006,5,927,1.0,659.0,659.0,5,1079,1.0,811.0,811.0
0.041,17,2,166,1,75,0.0,47.0,47.0,1,91,0.0,63.0,63.0
0.009,6,10,1983,5,910,2.0,642.0,642.0,5,1073,2.0,805.0,805.0
0.02,6,10,1989,5,910,5.0,642.0,642.0,5,1079,4.0,811.0,811.0
15.083,17,15,8575,8,6326,2150.0,1350.0,762.0,7,2249,2507.0,1350.0,293.0
0.169,17,2,152,1,76,0.0,48.0,48.0,1,76,0.0,48.0,48.0
0.004,6,10,2007,5,928,1.0,660.0,660.0,5,1079,1.0,811.0,811.0
0.005,6,10,2007,5,928,1.0,660.0,660.0,5,1079,1.0,811.0,811.0
0.012,6,10,1989,5,910,3.0,642.0,642.0,5,1079,3.0,811.0,811.0
241.325,6,401,349087,196,21722,1237.0,2736.0,960.0,205,327365,1182.0,3036.0,1624.0
0.095,6,10,1506,5,395,22.0,127.0,127.0,5,1111,22.0,843.0,843.0
0.109,6,10,1506,5,395,22.0,127.0,127.0,5,1111,22.0,843.0,843.0
0.038,17,2,136,1,60,0.0,32.0,32.0,1,76,0.0,48.0,48.0
240.113,6,34,10558,18,7915,14124.0,2883.0,775.0,16,2643,16007.0,580.0,225.0
0.104,6,10,1506,5,395,23.0,127.0,127.0,5,1111,21.0,843.0,843.0
0.005,17,2,144,1,64,0.0,36.0,36.0,1,80,0.0,52.0,52.0
0.011,17,2,148,1,60,0.0,32.0,32.0,1,88,0.0,60.0,60.0
0.01,6,10,1989,5,910,2.0,642.0,642.0,5,1079,2.0,811.0,811.0
240.119,6,19,5053,9,2305,30014.0,1102.0,613.0,10,2748,26679.0,1162.0,444.0
0.004,17,2,148,1,60,0.0,32.0,32.0,1,88,0.0,60.0,60.0
0.005,17,2,158,1,71,0.0,43.0,43.0,1,87,0.0,59.0,59.0
0.005,17,4,284,2,120,0.0,32.0,32.0,2,164,1.0,60.0,54.0
0.006,6,10,1547,5,764,1.0,496.0,496.0,5,783,1.0,515.0,515.0
0.005,6,10,1779,5,928,1.0,660.0,660.0,5,851,1.0,583.0,583.0
0.005,6,10,1989,5,927,1.0,659.0,659.0,5,1062,1.0,794.0,794.0
0.017,6,10,1990,5,911,4.0,643.0,643.0,5,1079,4.0,811.0,811.0
300.368,6,16,2170,9,684,37524.0,146.0,146.0,7,1486,50033.0,419.0,398.0
0.005,6,10,2006,5,927,1.0,659.0,659.0,5,1079,1.0,811.0,811.0
0.069,6,10,1506,5,395,13.0,127.0,127.0,5,1111,16.0,843.0,843.0
0.006,6,10,1989,5,927,1.0,659.0,659.0,5,1062,1.0,794.0,794.0
0.015,6,10,1677,5,827,3.0,559.0,559.0,5,850,3.0,582.0,582.0
0.039,17,4,284,2,120,0.0,32.0,32.0,2,164,36.0,60.0,54.0
0.006,17,2,152,1,68,0.0,40.0,40.0,1,84,0.0,56.0,56.0
300.305,6,16,2170,9,684,37517.0,146.0,146.0,7,1486,50022.0,419.0,398.0
0.038,17,2,234,1,61,0.0,33.0,33.0,1,173,0.0,145.0,145.0
0.004,17,2,170,1,65,0.0,37.0,37.0,1,105,0.0,77.0,77.0
0.071,17,4,284,2,120,0.0,32.0,32.0,2,164,68.0,60.0,54.0
0.022,6,13,3735,7,497,3.0,125.0,125.0,6,3238,4.0,1470.0,1459.0
369.719,6,22,2313,16,867,24647.0,195.0,195.0,6,1446,4661.0,419.0,398.0
0.166,17,2,152,1,76,0.0,48.0,48.0,1,76,0.0,48.0,48.0
0.005,6,10,2000,5,927,1.0,659.0,659.0,5,1073,1.0,805.0,805.0
0.072,6,10,1506,5,395,14.0,127.0,127.0,5,1111,16.0,843.0,843.0
11.429,17,28,4369,14,2312,867.0,587.0,137.0,14,2057,867.0,268.0,118.0
0.007,6,13,3684,7,446,1.0,74.0,74.0,6,3238,1.0,1470.0,1459.0
0.016,17,2,198,1,91,0.0,63.0,63.0,1,107,0.0,79.0,79.0
0.005,17,2,144,1,64,0.0,36.0,36.0,1,80,0.0,52.0,52.0
0.004,6,10,2006,5,927,1.0,659.0,659.0,5,1079,1.0,811.0,811.0
0.052,17,2,152,1,76,0.0,48.0,48.0,1,76,0.0,48.0,48.0
0.021,6,10,1762,5,911,5.0,643.0,643.0,5,851,5.0,583.0,583.0
0.009,6,10,1989,5,910,2.0,642.0,642.0,5,1079,2.0,811.0,811.0
0.006,6,10,1643,5,860,1.0,592.0,592.0,5,783,1.0,515.0,515.0
1793.405,6,275,25814,138,8968,13090.0,747.0,295.0,137,16846,13186.0,1625.0,73.0
15.133,17,18,13388,9,8280,1887.0,1350.0,892.0,9,5108,1887.0,1350.0,539.0
0.005,6,10,1547,5,764,1.0,496.0,496.0,5,783,1.0,515.0,515.0
0.004,6,10,1989,5,927,1.0,659.0,659.0,5,1062,1.0,794.0,794.0
0.01,6,10,1762,5,911,2.0,643.0,643.0,5,851,2.0,583.0,583.0
0.059,6,10,1506,5,395,12.0,127.0,127.0,5,1111,14.0,843.0,843.0
0.006,6,10,1547,5,764,1.0,496.0,496.0,5,783,1.0,515.0,515.0
0.059,6,10,1506,5,395,14.0,127.0,127.0,5,1111,12.0,843.0,843.0
0.013,6,10,1989,5,910,3.0,642.0,642.0,5,1079,3.0,811.0,811.0
1778.774,6,281,41523,114,22469,15740.0,2720.0,200.0,167,19054,10714.0,1360.0,150.0
0.047,17,2,170,1,65,0.0,37.0,37.0,1,105,0.0,77.0,77.0
0.005,6,10,1989,5,927,1.0,659.0,659.0,5,1062,1.0,794.0,794.0
0.015,6,10,1989,5,910,3.0,642.0,642.0,5,1079,3.0,811.0,811.0
0.021,6,10,1983,5,910,5.0,642.0,642.0,5,1073,5.0,805.0,805.0
10.958,17,28,4390,14,2312,834.0,587.0,137.0,14,2078,834.0,269.0,120.0
0.005,17,2,148,1,60,0.0,32.0,32.0,1,88,0.0,60.0,60.0
0.008,6,10,1989,5,910,2.0,642.0,642.0,5,1079,1.0,811.0,811.0
0.009,6,6,716,3,458,3.0,302.0,302.0,3,258,3.0,102.0,102.0
0.005,6,10,2006,5,927,1.0,659.0,659.0,5,1079,1.0,811.0,811.0
0.004,17,4,284,2,120,0.0,32.0,32.0,2,164,0.0,60.0,54.0
0.066,6,10,1506,5,395,15.0,127.0,127.0,5,1111,15.0,843.0,843.0
0.013,17,2,152,1,56,0.0,28.0,28.0,1,96,0.0,68.0,68.0
0.071,17,8,3613,4,1874,23.0,1350.0,440.0,4,1739,12.0,1350.0,406.0
0.014,6,10,1972,5,910,3.0,642.0,642.0,5,1062,3.0,794.0,794.0
0.063,6,10,1506,5,395,13.0,127.0,127.0,5,1111,14.0,843.0,843.0
0.006,6,10,1547,5,764,1.0,496.0,496.0,5,783,1.0,515.0,515.0
0.04,17,2,234,1,61,0.0,33.0,33.0,1,173,0.0,145.0,145.0
300.446,6,16,2170,9,684,37534.0,146.0,146.0,7,1486,50046.0,419.0,398.0
0.103,6,10,1506,5,395,23.0,127.0,127.0,5,1111,24.0,843.0,843.0
0.014,6,10,1989,5,910,3.0,642.0,642.0,5,1079,3.0,811.0,811.0
0.067,17,8,3613,4,1874,22.0,1350.0,440.0,4,1739,10.0,1350.0,406.0
240.098,6,16,4482,9,963,30012.0,238.0,166.0,7,3519,40015.0,1402.0,786.0
0.004,17,4,284,2,120,0.0,32.0,32.0,2,164,0.0,60.0,54.0
0.005,6,10,2007,5,928,1.0,660.0,660.0,5,1079,1.0,811.0,811.0
0.006,6,10,1702,5,863,1.0,595.0,595.0,5,839,1.0,571.0,571.0
11.189,17,28,4419,14,1994,848.0,269.0,114.0,14,2425,848.0,588.0,145.0
0.012,6,10,1983,5,910,3.0,642.0,642.0,5,1073,2.0,805.0,805.0
0.127,6,10,1506,5,395,26.0,127.0,127.0,5,1111,27.0,843.0,843.0
0.005,6,10,2006,5,927,1.0,659.0,659.0,5,1079,1.0,811.0,811.0
95.678,6,22,8464,12,2204,72.0,1345.0,564.0,10,6260,10612.0,2720.0,974.0
0.126,17,2,182,1,65,0.0,37.0,37.0,1,117,0.0,89.0,89.0
0.003,17,4,284,2,120,0.0,32.0,32.0,2,164,0.0,60.0,54.0
0.131,17,2,136,1,60,0.0,32.0,32.0,1,76,0.0,48.0,48.0
0.107,6,10,1506,5,395,26.0,127.0,127.0,5,1111,22.0,843.0,843.0
0.01,6,10,1972,5,910,2.0,642.0,642.0,5,1062,2.0,794.0,794.0
240.014,6,9,787,5,488,60003.0,232.0,232.0,4,299,80003.0,83.0,83.0
0.005,17,2,170,1,65,0.0,37.0,37.0,1,105,0.0,77.0,77.0
0.006,6,10,1689,5,839,1.0,571.0,571.0,5,850,1.0,582.0,582.0
0.005,6,10,1643,5,860,1.0,592.0,592.0,5,783,1.0,515.0,515.0
0.009,6,10,1762,5,911,2.0,643.0,643.0,5,851,2.0,583.0,583.0
0.006,17,2,180,1,66,0.0,38.0,38.0,1,114,0.0,86.0,86.0
32.43,6,37,12647,18,7089,520.0,4080.0,1584.0,19,5558,1792.0,2667.0,435.0
0.009,6,10,1972,5,910,2.0,642.0,642.0,5,1062,2.0,794.0,794.0
301.121,6,35,10511,19,2939,16728.0,799.0,388.0,16,7572,16072.0,1402.0,673.0
0.008,17,2,179,1,71,0.0,43.0,43.0,1,108,0.0,80.0,80.0
0.005,6,10,2007,5,928,1.0,660.0,660.0,5,1079,1.0,811.0,811.0
0.005,17,2,179,1,71,0.0,43.0,43.0,1,108,0.0,80.0,80.0
0.077,6,10,1506,5,395,15.0,127.0,127.0,5,1111,17.0,843.0,843.0
0.004,17,4,284,2,120,0.0,32.0,32.0,2,164,1.0,60.0,54.0
0.037,17,2,184,1,61,0.0,33.0,33.0,1,123,0.0,95.0,95.0
0.008,6,12,1926,6,1189,1.0,659.0,434.0,6,737,1.0,417.0,417.0
1771.72,17,120,11460,60,5460,30028.0,63.0,63.0,60,6000,30028.0,72.0,72.0
0.01,6,10,1990,5,911,2.0,643.0,643.0,5,1079,2.0,811.0,811.0
0.006,6,10,1547,5,764,1.0,496.0,496.0,5,783,1.0,515.0,515.0
0.041,17,4,284,2,120,1.0,32.0,32.0,2,164,37.0,60.0,54.0
0.069,6,10,1506,5,395,15.0,127.0,127.0,5,1111,14.0,843.0,843.0
0.005,6,10,1989,5,927,1.0,659.0,659.0,5,1062,1.0,794.0,794.0
0.005,6,10,1547,5,764,1.0,496.0,496.0,5,783,1.0,515.0,515.0
0.0,17,2,166,1,75,0.0,47.0,47.0,1,91,0.0,63.0,63.0
367.309,6,22,2313,16,867,24487.0,195.0,195.0,6,1446,4643.0,419.0,398.0
0.007,6,10,1547,5,764,1.0,496.0,496.0,5,783,1.0,515.0,515.0
0.005,6,10,2000,5,927,1.0,659.0,659.0,5,1073,1.0,805.0,805.0
0.004,6,10,1702,5,863,1.0,595.0,595.0,5,839,0.0,571.0,571.0
0.019,6,10,1972,5,910,4.0,642.0,642.0,5,1062,4.0,794.0,794.0
0.168,17,2,152,1,76,0.0,48.0,48.0,1,76,0.0,48.0,48.0
0.013,6,10,1972,5,910,3.0,642.0,642.0,5,1062,3.0,794.0,794.0
0.02,6,10,1631,5,848,5.0,580.0,580.0,5,783,4.0,515.0,515.0
300.392,6,16,2170,9,684,37528.0,146.0,146.0,7,1486,50038.0,419.0,398.0
0.067,6,10,1506,5,395,13.0,127.0,127.0,5,1111,13.0,843.0,843.0
40.07,17,10,676,5,460,10016.0,104.0,64.0,5,216,10016.0,20.0,15.0
0.005,6,10,2000,5,927,1.0,659.0,659.0,5,1073,1.0,805.0,805.0
0.014,6,10,1989,5,910,3.0,642.0,642.0,5,1079,3.0,811.0,811.0
0.012,6,10,1983,5,910,2.0,642.0,642.0,5,1073,2.0,805.0,805.0
0.021,6,10,1972,5,910,5.0,642.0,642.0,5,1062,5.0,794.0,794.0
0.071,17,8,3613,4,1874,23.0,1350.0,440.0,4,1739,12.0,1350.0,406.0
1756.048,6,103,6136,59,3458,30276.0,26.0,26.0,44,2678,40837.0,26.0,26.0
0.005,6,14,3742,7,452,0.0,80.0,80.0,7,3290,0.0,1448.0,972.0
0.006,6,10,2007,5,928,1.0,660.0,660.0,5,1079,1.0,811.0,811.0
0.006,6,10,1779,5,928,1.0,660.0,660.0,5,851,1.0,583.0,583.0
1780.897,6,312,98370,193,86730,9275.0,2001.0,672.0,119,11640,15092.0,452.0,70.0
1799.922,6,137,6590,76,3625,23995.0,39.0,39.0,61,2965,29994.0,35.0,35.0
0.013,6,10,1983,5,910,3.0,642.0,642.0,5,1073,3.0,805.0,805.0
0.005,17,2,178,1,81,0.0,53.0,53.0,1,97,0.0,69.0,69.0
0.006,6,10,1702,5,863,1.0,595.0,595.0,5,839,1.0,571.0,571.0
40.05,17,10,676,5,460,10011.0,104.0,64.0,5,216,10011.0,20.0,15.0
0.012,6,10,1990,5,911,3.0,643.0,643.0,5,1079,3.0,811.0,811.0
0.182,6,10,1506,5,395,32.0,127.0,127.0,5,1111,41.0,843.0,843.0
0.005,17,2,164,1,74,0.0,46.0,46.0,1,90,0.0,62.0,62.0
0.013,6,10,1983,5,910,3.0,642.0,642.0,5,1073,3.0,805.0,805.0
0.01,6,10,1677,5,827,2.0,559.0,559.0,5,850,2.0,582.0,582.0
1756.226,6,105,6270,60,3525,29765.0,27.0,27.0,45,2745,39913.0,27.0,27.0
0.04,17,2,148,1,60,0.0,32.0,32.0,1,88,0.0,60.0,60.0
1788.607,6,287,27331,145,9992,12420.0,747.0,270.0,142,17339,12685.0,1624.0,73.0
178.253,17,96,13774,48,3230,3792.0,44.0,39.0,48,10544,3792.0,239.0,191.0
0.065,6,10,1983,5,910,16.0,642.0,642.0,5,1073,16.0,805.0,805.0
10.802,17,28,4420,14,1993,822.0,268.0,114.0,14,2427,822.0,586.0,145.0
0.091,6,10,1506,5,395,19.0,127.0,127.0,5,1111,19.0,843.0,843.0
0.005,6,10,2007,5,928,1.0,660.0,660.0,5,1079,1.0,811.0,811.0
0.038,17,2,136,1,60,0.0,32.0,32.0,1,76,0.0,48.0,48.0
0.024,6,10,1990,5,911,6.0,643.0,643.0,5,1079,6.0,811.0,811.0
0.004,6,10,2007,5,928,1.0,660.0,660.0,5,1079,1.0,811.0,811.0
0.111,6,10,1506,5,395,25.0,127.0,127.0,5,1111,23.0,843.0,843.0
0.081,6,10,1506,5,395,17.0,127.0,127.0,5,1111,18.0,843.0,843.0
253.236,6,38,9525,15,6469,18088.0,1595.0,632.0,23,3056,11510.0,580.0,132.0
240.148,6,44,6692,21,3173,12007.0,588.0,230.0,23,3519,10915.0,580.0,210.0
0.005,17,2,136,1,60,0.0,32.0,32.0,1,76,0.0,48.0,48.0
0.006,17,2,230,1,68,0.0,40.0,40.0,1,162,0.0,134.0,134.0
0.107,6,10,1506,5,395,22.0,127.0,127.0,5,1111,23.0,843.0,843.0
0.04,17,4,284,2,120,1.0,32.0,32.0,2,164,36.0,60.0,54.0
0.091,6,10,1506,5,395,22.0,127.0,127.0,5,1111,20.0,843.0,843.0
0.103,6,10,1506,5,395,21.0,127.0,127.0,5,1111,22.0,843.0,843.0
0.013,6,10,1677,5,827,3.0,559.0,559.0,5,850,3.0,582.0,582.0
0.008,17,2,179,1,71,0.0,43.0,43.0,1,108,0.0,80.0,80.0
0.076,6,10,1506,5,395,17.0,127.0,127.0,5,1111,18.0,843.0,843.0
0.006,6,13,3747,7,509,1.0,137.0,137.0,6,3238,1.0,1470.0,1459.0
0.05,17,2,136,1,60,0.0,32.0,32.0,1,76,0.0,48.0,48.0
0.001,17,2,136,1,60,0.0,32.0,32.0,1,76,0.0,48.0,48.0
0.014,6,10,1983,5,910,3.0,642.0,642.0,5,1073,3.0,805.0,805.0
0.012,17,2,194,1,59,0.0,31.0,31.0,1,135,0.0,107.0,107.0
0.005,6,13,3747,7,509,0.0,137.0,137.0,6,3238,1.0,1470.0,1459.0
0.036,6,13,3735,7,497,6.0,125.0,125.0,6,3238,7.0,1470.0,1459.0
0.005,6,10,1547,5,764,1.0,496.0,496.0,5,783,1.0,515.0,515.0
0.005,6,10,1774,5,923,1.0,655.0,655.0,5,851,1.0,583.0,583.0
0.005,17,2,170,1,65,0.0,37.0,37.0,1,105,0.0,77.0,77.0
0.054,17,2,152,1,76,0.0,48.0,48.0,1,76,0.0,48.0,48.0
300.591,6,34,6335,19,1409,16699.0,267.0,154.0,15,4926,604.0,1823.0,392.0
0.008,6,12,1926,6,1189,1.0,659.0,434.0,6,737,1.0,417.0,417.0
240.052,6,9,787,5,488,60013.0,232.0,232.0,4,299,80016.0,83.0,83.0
329.11,17,20,1124,10,716,36552.0,48.0,43.0,10,408,36552.0,20.0,12.0
0.005,17,2,170,1,65,0.0,37.0,37.0,1,105,0.0,77.0,77.0
0.004,6,10,2006,5,927,1.0,659.0,659.0,5,1079,1.0,811.0,811.0
0.014,6,10,1983,5,910,3.0,642.0,642.0,5,1073,3.0,805.0,805.0
0.132,6,10,1506,5,395,29.0,127.0,127.0,5,1111,31.0,843.0,843.0
0.295,17,41,21616,23,18463,13.0,1350.0,774.0,18,3153,12.0,1350.0,147.0
0.005,6,13,3747,7,509,0.0,137.0,137.0,6,3238,0.0,1470.0,1459.0
0.083,6,10,1506,5,395,17.0,127.0,127.0,5,1111,20.0,843.0,843.0
0.004,6,10,1989,5,927,1.0,659.0,659.0,5,1062,1.0,794.0,794.0
0.08,6,10,1506,5,395,18.0,127.0,127.0,5,1111,18.0,843.0,843.0
0.011,6,10,1989,5,910,2.0,642.0,642.0,5,1079,2.0,811.0,811.0
0.089,6,10,1506,5,395,21.0,127.0,127.0,5,1111,17.0,843.0,843.0
0.004,17,4,284,2,120,0.0,32.0,32.0,2,164,0.0,60.0,54.0
0.004,17,4,284,2,120,0.0,32.0,32.0,2,164,0.0,60.0,54.0
0.003,17,2,148,1,60,0.0,32.0,32.0,1,88,0.0,60.0,60.0
0.005,6,10,1779,5,928,1.0,660.0,660.0,5,851,1.0,583.0,583.0
0.036,17,2,152,1,76,0.0,48.0,48.0,1,76,0.0,48.0,48.0
0.005,6,10,1989,5,927,1.0,659.0,659.0,5,1062,1.0,794.0,794.0
0.011,6,10,1989,5,910,2.0,642.0,642.0,5,1079,2.0,811.0,811.0
0.005,6,13,3690,7,452,0.0,80.0,80.0,6,3238,0.0,1470.0,1459.0
40.063,17,10,676,5,460,10015.0,104.0,64.0,5,216,10014.0,20.0,15.0
0.145,6,10,1506,5,395,33.0,127.0,127.0,5,1111,32.0,843.0,843.0
0.045,17,4,352,2,130,6.0,37.0,37.0,2,222,5.0,89.0,83.0
310.195,17,20,1124,10,716,34451.0,48.0,43.0,10,408,34451.0,20.0,12.0
0.006,6,10,1854,5,889,1.0,621.0,621.0,5,965,1.0,697.0,697.0
0.012,6,10,1631,5,848,3.0,580.0,580.0,5,783,3.0,515.0,515.0
0.001,17,2,180,1,66,0.0,38.0,38.0,1,114,0.0,86.0,86.0
0.005,17,2,164,1,74,0.0,46.0,46.0,1,90,0.0,62.0,62.0
0.005,6,10,1989,5,927,1.0,659.0,659.0,5,1062,1.0,794.0,794.0
0.01,6,10,1972,5,910,2.0,642.0,642.0,5,1062,2.0,794.0,794.0
0.153,6,10,1506,5,395,35.0,127.0,127.0,5,1111,27.0,843.0,843.0
0.004,6,15,3794,8,504,0.0,80.0,80.0,7,3290,0.0,1448.0,972.0
281.768,6,25,6155,11,1226,28176.0,267.0,156.0,14,4929,21673.0,1400.0,873.0
0.038,17,2,148,1,60,0.0,32.0,32.0,1,88,0.0,60.0,60.0
0.006,6,10,1547,5,764,1.0,496.0,496.0,5,783,1.0,515.0,515.0
0.012,6,10,1631,5,848,3.0,580.0,580.0,5,783,2.0,515.0,515.0
0.001,17,2,166,1,75,0.0,47.0,47.0,1,91,0.0,63.0,63.0
0.005,6,10,2006,5,927,1.0,659.0,659.0,5,1079,1.0,811.0,811.0
0.219,6,16,2778,8,1396,31.0,533.0,324.0,8,1382,20.0,529.0,239.0
0.041,17,2,182,1,65,0.0,37.0,37.0,1,117,0.0,89.0,89.0
40.068,17,10,676,5,460,10015.0,104.0,64.0,5,216,10016.0,20.0,15.0
0.075,6,10,1506,5,395,18.0,127.0,127.0,5,1111,16.0,843.0,843.0
0.005,6,10,1854,5,889,1.0,621.0,621.0,5,965,1.0,697.0,697.0
0.006,6,10,2007,5,928,1.0,660.0,660.0,5,1079,1.0,811.0,811.0
0.005,17,2,154,1,69,0.0,41.0,41.0,1,85,0.0,57.0,57.0
300.325,6,16,2170,9,684,37520.0,146.0,146.0,7,1486,50026.0,419.0,398.0
0.012,6,10,1631,5,848,3.0,580.0,580.0,5,783,2.0,515.0,515.0
0.006,6,10,1689,5,839,1.0,571.0,571.0,5,850,1.0,582.0,582.0
0.008,6,12,1926,6,1189,1.0,659.0,434.0,6,737,1.0,417.0,417.0
371.276,6,22,2313,16,867,24751.0,195.0,195.0,6,1446,4636.0,419.0,398.0
0.099,6,10,1506,5,395,20.0,127.0,127.0,5,1111,21.0,843.0,843.0
0.005,17,2,169,1,62,0.0,34.0,34.0,1,107,0.0,79.0,79.0
0.015,6,10,1972,5,910,3.0,642.0,642.0,5,1062,3.0,794.0,794.0
0.017,6,10,1990,5,911,4.0,643.0,643.0,5,1079,4.0,811.0,811.0
0.005,6,10,2006,5,927,1.0,659.0,659.0,5,1079,1.0,811.0,811.0
0.11,17,2,179,1,71,0.0,43.0,43.0,1,108,0.0,80.0,80.0
0.005,6,10,2000,5,927,1.0,659.0,659.0,5,1073,1.0,805.0,805.0
0.004,6,10,2000,5,927,1.0,659.0,659.0,5,1073,1.0,805.0,805.0
1769.155,17,92,8096,46,4048,39313.0,60.0,60.0,46,4048,39314.0,60.0,60.0
0.054,17,2,152,1,76,0.0,48.0,48.0,1,76,0.0,48.0,48.0
0.003,17,4,284,2,120,0.0,32.0,32.0,2,164,0.0,60.0,54.0
0.006,6,10,1547,5,764,1.0,496.0,496.0,5,783,1.0,515.0,515.0
0.005,6,10,2007,5,928,1.0,660.0,660.0,5,1079,1.0,811.0,811.0
0.108,6,10,1506,5,395,25.0,127.0,127.0,5,1111,23.0,843.0,843.0
0.005,6,10,1854,5,889,1.0,621.0,621.0,5,965,1.0,697.0,697.0
0.005,6,10,1854,5,889,1.0,621.0,621.0,5,965,1.0,697.0,697.0
0.001,17,2,136,1,60,0.0,32.0,32.0,1,76,0.0,48.0,48.0
0.005,6,10,1779,5,928,1.0,660.0,660.0,5,851,1.0,583.0,583.0
11.122,17,28,4421,14,1993,843.0,268.0,114.0,14,2428,842.0,587.0,145.0
0.004,17,2,136,1,60,0.0,32.0,32.0,1,76,0.0,48.0,48.0
0.005,6,10,1774,5,923,1.0,655.0,655.0,5,851,1.0,583.0,583.0
0.101,6,10,1506,5,395,21.0,127.0,127.0,5,1111,24.0,843.0,843.0
0.109,6,10,1506,5,395,25.0,127.0,127.0,5,1111,21.0,843.0,843.0
0.039,17,2,184,1,61,0.0,33.0,33.0,1,123,0.0,95.0,95.0
0.003,17,2,136,1,60,0.0,32.0,32.0,1,76,0.0,48.0,48.0
0.015,6,10,1677,5,827,3.0,559.0,559.0,5,850,3.0,582.0,582.0
0.006,6,10,1547,5,764,1.0,496.0,496.0,5,783,1.0,515.0,515.0
0.037,17,2,182,1,65,0.0,37.0,37.0,1,117,0.0,89.0,89.0
0.005,17,2,146,1,65,0.0,37.0,37.0,1,81,0.0,53.0,53.0
0.015,6,10,1990,5,911,3.0,643.0,643.0,5,1079,3.0,811.0,811.0
0.134,17,2,412,1,61,0.0,33.0,33.0,1,351,0.0,323.0,323.0
0.155,6,10,1506,5,395,36.0,127.0,127.0,5,1111,34.0,843.0,843.0
0.009,6,10,1990,5,911,2.0,643.0,643.0,5,1079,2.0,811.0,811.0
363.237,6,22,2264,16,818,24215.0,146.0,146.0,6,1446,4633.0,419.0,398.0
0.008,6,10,1983,5,910,2.0,642.0,642.0,5,1073,1.0,805.0,805.0
0.005,17,2,164,1,74,0.0,46.0,46.0,1,90,0.0,62.0,62.0
0.088,6,10,1506,5,395,21.0,127.0,127.0,5,1111,13.0,843.0,843.0
0.005,6,10,1547,5,764,1.0,496.0,496.0,5,783,1.0,515.0,515.0
0.018,6,13,3735,7,497,3.0,125.0,125.0,6,3238,3.0,1470.0,1459.0
1799.964,6,138,6704,77,3704,23683.0,39.0,39.0,61,3000,29995.0,35.0,35.0
0.008,17,2,148,1,60,0.0,32.0,32.0,1,88,0.0,60.0,60.0
55.343,6,40,12986,21,7428,448.0,1360.0,936.0,19,5558,3065.0,2667.0,435.0
40.06,17,10,676,5,460,10013.0,104.0,64.0,5,216,10014.0,20.0,15.0
0.006,17,2,164,1,74,0.0,46.0,46.0,1,90,0.0,62.0,62.0
0.015,6,10,1762,5,911,3.0,643.0,643.0,5,851,3.0,583.0,583.0
0.006,6,10,1547,5,764,1.0,496.0,496.0,5,783,1.0,515.0,515.0
40.064,17,10,676,5,460,10015.0,104.0,64.0,5,216,10015.0,20.0,15.0
0.003,17,2,136,1,60,0.0,32.0,32.0,1,76,0.0,48.0,48.0
240.013,6,9,787,5,488,60003.0,232.0,232.0,4,299,80003.0,83.0,83.0
0.006,6,10,2006,5,927,1.0,659.0,659.0,5,1079,1.0,811.0,811.0
0.005,6,10,1854,5,889,1.0,621.0,621.0,5,965,1.0,697.0,697.0
0.004,17,2,148,1,60,0.0,32.0,32.0,1,88,0.0,60.0,60.0
0.006,6,10,1547,5,764,1.0,496.0,496.0,5,783,1.0,515.0,515.0
0.085,6,10,1506,5,395,18.0,127.0,127.0,5,1111,18.0,843.0,843.0
0.041,17,2,412,1,61,0.0,33.0,33.0,1,351,0.0,323.0,323.0
40.047,17,10,676,5,460,10010.0,104.0,64.0,5,216,10010.0,20.0,15.0
308.901,17,20,1124,10,716,34308.0,48.0,43.0,10,408,34308.0,20.0,12.0
240.35,6,35,9884,18,1905,14137.0,574.0,189.0,17,7979,15021.0,1402.0,645.0
10.777,17,28,4423,14,1995,820.0,270.0,114.0,14,2428,820.0,587.0,145.0
0.073,6,10,1506,5,395,16.0,127.0,127.0,5,1111,14.0,843.0,843.0
40.048,17,10,676,5,460,10011.0,104.0,64.0,5,216,10011.0,20.0,15.0
0.008,6,10,1990,5,911,2.0,643.0,643.0,5,1079,2.0,811.0,811.0
0.017,6,10,1631,5,848,4.0,580.0,580.0,5,783,4.0,515.0,515.0
0.006,6,10,1547,5,764,1.0,496.0,496.0,5,783,1.0,515.0,515.0
328.284,17,18,1008,9,640,41018.0,48.0,43.0,9,368,41018.0,20.0,12.0
0.015,6,10,1989,5,910,3.0,642.0,642.0,5,1079,3.0,811.0,811.0
0.124,6,10,1506,5,395,29.0,127.0,127.0,5,1111,19.0,843.0,843.0
0.009,6,10,1989,5,910,2.0,642.0,642.0,5,1079,2.0,811.0,811.0
0.005,6,14,3742,8,504,0.0,80.0,80.0,6,3238,0.0,1470.0,1459.0
0.018,6,10,1631,5,848,4.0,580.0,580.0,5,783,4.0,515.0,515.0
0.125,6,10,1506,5,395,29.0,127.0,127.0,5,1111,29.0,843.0,843.0
0.006,6,10,1547,5,764,1.0,496.0,496.0,5,783,1.0,515.0,515.0
0.005,6,10,2000,5,927,1.0,659.0,659.0,5,1073,1.0,805.0,805.0
0.006,6,10,1689,5,839,1.0,571.0,571.0,5,850,1.0,582.0,582.0
0.018,6,10,1990,5,911,4.0,643.0,643.0,5,1079,4.0,811.0,811.0
0.005,17,2,179,1,71,0.0,43.0,43.0,1,108,0.0,80.0,80.0
0.085,6,10,1506,5,395,18.0,127.0,127.0,5,1111,17.0,843.0,843.0
0.005,6,10,2006,5,927,1.0,659.0,659.0,5,1079,1.0,811.0,811.0
11.123,17,28,4422,14,1994,843.0,269.0,114.0,14,2428,843.0,587.0,145.0
0.005,6,10,1643,5,860,1.0,592.0,592.0,5,783,1.0,515.0,515.0
0.006,6,10,1547,5,764,1.0,496.0,496.0,5,783,1.0,515.0,515.0
0.001,17,2,180,1,66,0.0,38.0,38.0,1,114,0.0,86.0,86.0
0.006,17,2,148,1,60,0.0,32.0,32.0,1,88,0.0,60.0,60.0
0.009,6,10,1983,5,910,2.0,642.0,642.0,5,1073,2.0,805.0,805.0
0.008,6,10,1989,5,927,2.0,659.0,659.0,5,1062,1.0,794.0,794.0
40.092,17,10,676,5,460,10020.0,104.0,64.0,5,216,10022.0,20.0,15.0
242.099,6,402,348502,204,22134,1192.0,2736.0,959.0,198,326368,1228.0,2804.0,1681.0
0.014,6,10,1972,5,910,3.0,642.0,642.0,5,1062,3.0,794.0,794.0
0.004,6,10,1702,5,863,1.0,595.0,595.0,5,839,1.0,571.0,571.0
0.006,6,10,1547,5,764,1.0,496.0,496.0,5,783,1.0,515.0,515.0
0.021,6,10,1972,5,910,5.0,642.0,642.0,5,1062,5.0,794.0,794.0
0.127,6,10,1506,5,395,28.0,127.0,127.0,5,1111,23.0,843.0,843.0
0.098,6,10,1506,5,395,22.0,127.0,127.0,5,1111,23.0,843.0,843.0
0.016,6,10,1972,5,910,3.0,642.0,642.0,5,1062,4.0,794.0,794.0
0.005,6,10,2000,5,927,1.0,659.0,659.0,5,1073,1.0,805.0,805.0
0.005,6,10,1643,5,860,1.0,592.0,592.0,5,783,1.0,515.0,515.0
0.003,17,2,160,1,72,0.0,44.0,44.0,1,88,0.0,60.0,60.0
15.083,17,18,8523,9,5952,1881.0,1350.0,633.0,9,2571,1881.0,1350.0,257.0
0.01,6,10,1972,5,910,2.0,642.0,642.0,5,1062,2.0,794.0,794.0
0.005,6,10,2007,5,928,1.0,660.0,660.0,5,1079,1.0,811.0,811.0
0.08,6,10,1506,5,395,18.0,127.0,127.0,5,1111,19.0,843.0,843.0
240.013,6,9,787,5,488,60003.0,232.0,232.0,4,299,80003.0,83.0,83.0
40.06,17,10,676,5,460,10012.0,104.0,64.0,5,216,10013.0,20.0,15.0
10.78,17,28,4416,14,1993,820.0,268.0,114.0,14,2423,820.0,586.0,145.0
0.005,6,10,2006,5,927,1.0,659.0,659.0,5,1079,1.0,811.0,811.0
308.543,17,20,1124,10,716,34268.0,48.0,43.0,10,408,34268.0,20.0,12.0
0.01,6,10,1989,5,910,2.0,642.0,642.0,5,1079,2.0,811.0,811.0
0.074,6,10,1506,5,395,16.0,127.0,127.0,5,1111,16.0,843.0,843.0
0.013,6,13,3735,7,497,2.0,125.0,125.0,6,3238,2.0,1470.0,1459.0
0.073,6,10,1506,5,395,17.0,127.0,127.0,5,1111,16.0,843.0,843.0
0.005,6,10,1989,5,927,1.0,659.0,659.0,5,1062,1.0,794.0,794.0
0.01,6,6,716,3,458,4.0,302.0,302.0,3,258,3.0,102.0,102.0
0.097,6,10,1506,5,395,20.0,127.0,127.0,5,1111,21.0,843.0,843.0
0.072,17,2,136,1,60,0.0,32.0,32.0,1,76,0.0,48.0,48.0
0.04,17,2,136,1,60,0.0,32.0,32.0,1,76,0.0,48.0,48.0
0.017,6,10,1989,5,910,4.0,642.0,642.0,5,1079,4.0,811.0,811.0
0.005,6,10,1547,5,764,1.0,496.0,496.0,5,783,1.0,515.0,515.0
0.006,17,2,166,1,75,0.0,47.0,47.0,1,91,0.0,63.0,63.0
40.184,17,10,676,5,460,10043.0,104.0,64.0,5,216,10045.0,20.0,15.0
0.018,6,10,1989,5,910,4.0,642.0,642.0,5,1079,4.0,811.0,811.0
0.005,6,10,2006,5,927,1.0,659.0,659.0,5,1079,1.0,811.0,811.0
0.02,6,10,1990,5,911,5.0,643.0,643.0,5,1079,5.0,811.0,811.0
0.012,6,10,1989,5,910,3.0,642.0,642.0,5,1079,3.0,811.0,811.0
0.07,6,10,1506,5,395,16.0,127.0,127.0,5,1111,15.0,843.0,843.0
1787.739,6,239,46362,114,33833,15820.0,2474.0,996.0,125,12529,14417.0,580.0,62.0
0.017,6,10,1972,5,910,4.0,642.0,642.0,5,1062,4.0,794.0,794.0
0.011,6,10,1990,5,911,2.0,643.0,643.0,5,1079,2.0,811.0,811.0
0.011,6,10,1989,5,910,2.0,642.0,642.0,5,1079,2.0,811.0,811.0
0.003,17,2,136,1,60,0.0,32.0,32.0,1,76,0.0,48.0,48.0
0.004,17,2,136,1,60,0.0,32.0,32.0,1,76,0.0,48.0,48.0
0.004,17,2,148,1,60,0.0,32.0,32.0,1,88,0.0,60.0,60.0
0.012,6,13,3735,7,497,1.0,125.0,125.0,6,3238,2.0,1470.0,1459.0
0.04,17,2,136,1,60,0.0,32.0,32.0,1,76,0.0,48.0,48.0
0.006,6,10,1547,5,764,1.0,496.0,496.0,5,783,1.0,515.0,515.0
15.075,17,15,9238,8,6902,2149.0,1350.0,834.0,7,2336,2507.0,1350.0,305.0
0.946,6,25,8459,14,2075,72.0,1140.0,370.0,11,6384,77.0,2720.0,988.0
0.013,6,10,1989,5,910,3.0,642.0,642.0,5,1079,3.0,811.0,811.0
0.011,6,10,1989,5,910,2.0,642.0,642.0,5,1079,2.0,811.0,811.0
280.667,6,25,6480,11,1226,28066.0,267.0,156.0,14,5254,21589.0,1400.0,781.0
0.022,6,10,1990,5,911,5.0,643.0,643.0,5,1079,5.0,811.0,811.0
0.092,6,10,1506,5,395,20.0,127.0,127.0,5,1111,20.0,843.0,843.0
0.001,17,2,136,1,60,0.0,32.0,32.0,1,76,0.0,48.0,48.0
0.004,17,2,170,1,65,0.0,37.0,37.0,1,105,0.0,77.0,77.0
290.21,6,398,348902,190,21449,1535.0,2736.0,889.0,208,327453,1401.0,2804.0,1632.0
0.001,17,2,136,1,60,0.0,32.0,32.0,1,76,0.0,48.0,48.0
40.064,17,10,676,5,460,10015.0,104.0,64.0,5,216,10015.0,20.0,15.0
0.084,6,10,1506,5,395,20.0,127.0,127.0,5,1111,17.0,843.0,843.0
0.079,6,10,1506,5,395,16.0,127.0,127.0,5,1111,16.0,843.0,843.0
309.177,17,20,1124,10,716,34338.0,48.0,43.0,10,408,34338.0,20.0,12.0
0.005,6,10,1779,5,928,1.0,660.0,660.0,5,851,1.0,583.0,583.0
0.098,17,2,144,1,64,0.0,36.0,36.0,1,80,0.0,52.0,52.0
0.004,6,10,2006,5,927,1.0,659.0,659.0,5,1079,1.0,811.0,811.0
0.135,6,10,1506,5,395,31.0,127.0,127.0,5,1111,31.0,843.0,843.0
0.006,17,2,169,1,62,0.0,34.0,34.0,1,107,0.0,79.0,79.0
0.058,6,10,1506,5,395,14.0,127.0,127.0,5,1111,14.0,843.0,843.0
0.049,6,10,1983,5,910,12.0,642.0,642.0,5,1073,12.0,805.0,805.0
0.01,6,10,1989,5,910,2.0,642.0,642.0,5,1079,2.0,811.0,811.0
0.016,6,10,1972,5,910,4.0,642.0,642.0,5,1062,4.0,794.0,794.0
0.011,6,13,3735,7,497,1.0,125.0,125.0,6,3238,2.0,1470.0,1459.0
0.005,6,10,2006,5,927,1.0,659.0,659.0,5,1079,1.0,811.0,811.0
0.006,6,10,1643,5,860,1.0,592.0,592.0,5,783,1.0,515.0,515.0
0.001,17,2,180,1,66,0.0,38.0,38.0,1,114,0.0,86.0,86.0
0.011,6,10,1990,5,911,2.0,643.0,643.0,5,1079,2.0,811.0,811.0
0.006,6,10,1689,5,839,1.0,571.0,571.0,5,850,1.0,582.0,582.0
0.006,6,10,1547,5,764,1.0,496.0,496.0,5,783,1.0,515.0,515.0
10.853,17,28,4418,14,1994,826.0,269.0,114.0,14,2424,825.0,587.0,145.0
0.015,6,10,1762,5,911,3.0,643.0,643.0,5,851,3.0,583.0,583.0
291.89,6,328,345198,125,18054,2353.0,2736.0,889.0,203,327144,1444.0,2804.0,1683.0
0.086,6,10,1506,5,395,19.0,127.0,127.0,5,1111,17.0,843.0,843.0
0.005,6,10,1989,5,927,1.0,659.0,659.0,5,1062,1.0,794.0,794.0
0.012,6,10,1983,5,910,3.0,642.0,642.0,5,1073,3.0,805.0,805.0
0.126,6,10,1506,5,395,25.0,127.0,127.0,5,1111,29.0,843.0,843.0
0.04,17,2,182,1,65,0.0,37.0,37.0,1,117,0.0,89.0,89.0
0.03,6,10,1972,5,910,7.0,642.0,642.0,5,1062,7.0,794.0,794.0
0.006,6,10,1689,5,839,1.0,571.0,571.0,5,850,1.0,582.0,582.0
0.015,6,13,3735,7,497,2.0,125.0,125.0,6,3238,3.0,1470.0,1459.0
0.006,17,2,214,1,75,0.0,47.0,47.0,1,139,0.0,111.0,111.0
0.015,6,10,1989,5,910,3.0,642.0,642.0,5,1079,3.0,811.0,811.0
0.007,6,10,2006,5,927,1.0,659.0,659.0,5,1079,1.0,811.0,811.0
0.008,6,12,1926,6,1189,1.0,659.0,434.0,6,737,1.0,417.0,417.0
0.013,6,10,1989,5,910,3.0,642.0,642.0,5,1079,3.0,811.0,811.0
0.006,6,10,1547,5,764,1.0,496.0,496.0,5,783,1.0,515.0,515.0
0.09,17,2,152,1,76,0.0,48.0,48.0,1,76,0.0,48.0,48.0
0.018,6,10,1762,5,911,4.0,643.0,643.0,5,851,4.0,583.0,583.0
0.005,17,2,164,1,74,0.0,46.0,46.0,1,90,0.0,62.0,62.0
0.007,17,2,194,1,59,0.0,31.0,31.0,1,135,0.0,107.0,107.0
0.087,6,10,1506,5,395,18.0,127.0,127.0,5,1111,19.0,843.0,843.0
168.165,17,72,10420,36,2403,4804.0,44.0,38.0,36,8017,4804.0,239.0,194.0
0.087,6,10,1506,5,395,18.0,127.0,127.0,5,1111,20.0,843.0,843.0
0.014,6,10,1677,5,827,3.0,559.0,559.0,5,850,3.0,582.0,582.0
0.018,6,10,1989,5,910,4.0,642.0,642.0,5,1079,4.0,811.0,811.0
0.006,17,2,136,1,60,0.0,32.0,32.0,1,76,0.0,48.0,48.0
0.0,17,2,179,1,62,0.0,34.0,34.0,1,117,0.0,89.0,89.0
0.042,17,2,152,1,76,0.0,48.0,48.0,1,76,0.0,48.0,48.0
0.009,6,10,1989,5,910,2.0,642.0,642.0,5,1079,2.0,811.0,811.0
0.005,6,10,2006,5,927,1.0,659.0,659.0,5,1079,1.0,811.0,811.0
0.011,6,10,1631,5,848,2.0,580.0,580.0,5,783,2.0,515.0,515.0
240.092,6,16,4480,9,963,30011.0,238.0,166.0,7,3517,40014.0,1402.0,786.0
15.073,17,15,9239,8,6902,2149.0,1350.0,834.0,7,2337,2507.0,1350.0,305.0
0.005,6,10,2007,5,928,1.0,660.0,660.0,5,1079,1.0,811.0,811.0
40.059,17,10,676,5,460,10012.0,104.0,64.0,5,216,10014.0,20.0,15.0
0.001,17,2,154,1,69,0.0,41.0,41.0,1,85,0.0,57.0,57.0
0.089,6,10,1506,5,395,20.0,127.0,127.0,5,1111,17.0,843.0,843.0
0.01,6,10,1677,5,827,2.0,559.0,559.0,5,850,2.0,582.0,582.0
0.013,6,10,1989,5,910,3.0,642.0,642.0,5,1079,3.0,811.0,811.0
0.011,6,10,1990,5,911,2.0,643.0,643.0,5,1079,2.0,811.0,811.0
0.011,6,10,1989,5,910,2.0,642.0,642.0,5,1079,2.0,811.0,811.0
0.074,6,10,1506,5,395,16.0,127.0,127.0,5,1111,15.0,843.0,843.0
0.076,6,10,1506,5,395,14.0,127.0,127.0,5,1111,16.0,843.0,843.0
0.017,6,10,1972,5,910,4.0,642.0,642.0,5,1062,4.0,794.0,794.0
0.078,6,10,1506,5,395,17.0,127.0,127.0,5,1111,16.0,843.0,843.0
0.005,6,10,1989,5,927,1.0,659.0,659.0,5,1062,1.0,794.0,794.0
0.053,17,2,412,1,61,0.0,33.0,33.0,1,351,0.0,323.0,323.0
0.011,17,2,144,1,64,0.0,36.0,36.0,1,80,0.0,52.0,52.0
0.012,6,14,3787,7,497,2.0,125.0,125.0,7,3290,1.0,1448.0,972.0
40.055,17,10,676,5,460,10012.0,104.0,64.0,5,216,10013.0,20.0,15.0
0.087,6,10,1506,5,395,18.0,127.0,127.0,5,1111,21.0,843.0,843.0
0.068,6,10,1506,5,395,14.0,127.0,127.0,5,1111,15.0,843.0,843.0
0.006,6,10,1854,5,889,1.0,621.0,621.0,5,965,1.0,697.0,697.0
240.077,6,16,4482,9,963,30009.0,238.0,166.0,7,3519,40012.0,1402.0,786.0
0.014,6,10,1990,5,911,3.0,643.0,643.0,5,1079,3.0,811.0,811.0
15.072,17,14,9190,8,6902,2149.0,1350.0,834.0,6,2288,3008.0,1350.0,353.0
0.006,17,2,214,1,75,0.0,47.0,47.0,1,139,0.0,111.0,111.0
0.005,6,13,3747,7,509,0.0,137.0,137.0,6,3238,0.0,1470.0,1459.0
40.084,17,10,676,5,460,10020.0,104.0,64.0,5,216,10020.0,20.0,15.0
0.089,6,10,1506,5,395,20.0,127.0,127.0,5,1111,18.0,843.0,843.0
0.007,6,10,1547,5,764,1.0,496.0,496.0,5,783,1.0,515.0,515.0
0.005,6,10,2006,5,927,1.0,659.0,659.0,5,1079,1.0,811.0,811.0
0.005,6,10,2006,5,927,1.0,659.0,659.0,5,1079,1.0,811.0,811.0
354.012,6,21,1795,16,1030,23600.0,190.0,190.0,5,765,60002.0,464.0,248.0
0.052,17,2,152,1,76,0.0,48.0,48.0,1,76,0.0,48.0,48.0
0.02,6,10,1631,5,848,5.0,580.0,580.0,5,783,4.0,515.0,515.0
0.005,17,2,170,1,65,0.0,37.0,37.0,1,105,0.0,77.0,77.0
0.006,6,10,1643,5,860,1.0,592.0,592.0,5,783,1.0,515.0,515.0
0.004,17,2,148,1,60,0.0,32.0,32.0,1,88,0.0,60.0,60.0
0.093,6,28,9094,14,6751,7.0,1915.0,668.0,14,2343,6.0,580.0,229.0
0.006,6,10,1643,5,860,1.0,592.0,592.0,5,783,1.0,515.0,515.0
0.037,17,2,179,1,71,0.0,43.0,43.0,1,108,0.0,80.0,80.0
0.014,6,10,1990,5,911,3.0,643.0,643.0,5,1079,3.0,811.0,811.0
0.005,6,10,2000,5,927,1.0,659.0,659.0,5,1073,1.0,805.0,805.0
0.004,6,10,2006,5,927,1.0,659.0,659.0,5,1079,1.0,811.0,811.0
0.014,6,10,1972,5,910,3.0,642.0,642.0,5,1062,3.0,794.0,794.0
10.729,17,28,4418,14,1994,816.0,269.0,114.0,14,2424,816.0,587.0,145.0
0.005,6,10,1989,5,927,1.0,659.0,659.0,5,1062,1.0,794.0,794.0
0.005,17,2,179,1,71,0.0,43.0,43.0,1,108,0.0,80.0,80.0
0.016,6,10,1983,5,910,3.0,642.0,642.0,5,1073,4.0,805.0,805.0
0.11,17,2,179,1,71,0.0,43.0,43.0,1,108,0.0,80.0,80.0
0.062,6,10,1506,5,395,14.0,127.0,127.0,5,1111,14.0,843.0,843.0
0.01,6,10,1762,5,911,2.0,643.0,643.0,5,851,2.0,583.0,583.0
0.194,6,10,1506,5,395,46.0,127.0,127.0,5,1111,42.0,843.0,843.0
0.004,17,2,208,1,72,0.0,44.0,44.0,1,136,0.0,108.0,108.0
0.015,17,2,198,1,91,0.0,63.0,63.0,1,107,0.0,79.0,79.0
241.114,6,41,13634,21,4602,12055.0,990.0,583.0,20,9032,12690.0,1592.0,614.0
40.062,17,10,676,5,460,10014.0,104.0,64.0,5,216,10014.0,20.0,15.0
0.088,6,10,1506,5,395,20.0,127.0,127.0,5,1111,18.0,843.0,843.0
0.014,6,10,1972,5,910,3.0,642.0,642.0,5,1062,3.0,794.0,794.0
0.005,6,10,2007,5,928,1.0,660.0,660.0,5,1079,1.0,811.0,811.0
0.006,6,13,3690,7,452,0.0,80.0,80.0,6,3238,1.0,1470.0,1459.0
0.007,17,2,179,1,71,0.0,43.0,43.0,1,108,0.0,80.0,80.0
0.006,6,10,1989,5,927,1.0,659.0,659.0,5,1062,1.0,794.0,794.0
0.004,17,2,136,1,60,0.0,32.0,32.0,1,76,0.0,48.0,48.0
1778.179,17,144,45504,72,22752,25044.0,288.0,288.0,72,22752,25044.0,288.0,288.0
0.02,6,10,1990,5,911,5.0,643.0,643.0,5,1079,5.0,811.0,811.0
0.001,17,2,180,1,66,0.0,38.0,38.0,1,114,0.0,86.0,86.0
354.079,6,19,1691,15,978,25291.0,190.0,190.0,4,713,80007.0,497.0,497.0
0.006,6,10,1547,5,764,1.0,496.0,496.0,5,783,1.0,515.0,515.0
0.005,6,10,2006,5,927,1.0,659.0,659.0,5,1079,1.0,811.0,811.0
0.005,6,10,1689,5,839,1.0,571.0,571.0,5,850,1.0,582.0,582.0
40.063,17,10,676,5,460,10013.0,104.0,64.0,5,216,10014.0,20.0,15.0
0.011,6,14,3787,7,497,1.0,125.0,125.0,7,3290,1.0,1448.0,972.0
0.169,17,2,152,1,76,0.0,48.0,48.0,1,76,0.0,48.0,48.0
0.057,6,10,1631,5,848,14.0,580.0,580.0,5,783,14.0,515.0,515.0
0.001,17,2,180,1,66,0.0,38.0,38.0,1,114,0.0,86.0,86.0
0.004,6,10,1702,5,863,1.0,595.0,595.0,5,839,0.0,571.0,571.0
0.069,17,8,3613,4,1874,23.0,1350.0,440.0,4,1739,11.0,1350.0,406.0
412.756,6,29,4409,12,3102,10912.0,494.0,494.0,17,1307,25797.0,83.0,83.0
0.007,17,2,299,1,65,0.0,37.0,37.0,1,234,0.0,206.0,206.0
0.005,6,10,1989,5,927,1.0,659.0,659.0,5,1062,1.0,794.0,794.0
0.008,6,12,1926,6,1189,1.0,659.0,434.0,6,737,1.0,417.0,417.0
0.077,6,10,1506,5,395,17.0,127.0,127.0,5,1111,15.0,843.0,843.0
0.09,6,10,1506,5,395,18.0,127.0,127.0,5,1111,20.0,843.0,843.0
0.007,6,10,1990,5,911,1.0,643.0,643.0,5,1079,1.0,811.0,811.0
0.005,17,2,302,1,65,0.0,37.0,37.0,1,237,0.0,209.0,209.0
0.005,6,10,2006,5,927,1.0,659.0,659.0,5,1079,1.0,811.0,811.0
0.007,6,10,1989,5,910,1.0,642.0,642.0,5,1079,1.0,811.0,811.0
0.011,6,10,1990,5,911,2.0,643.0,643.0,5,1079,2.0,811.0,811.0
0.082,6,10,1506,5,395,18.0,127.0,127.0,5,1111,18.0,843.0,843.0
0.011,6,10,1989,5,910,2.0,642.0,642.0,5,1079,2.0,811.0,811.0
0.006,6,10,1547,5,764,1.0,496.0,496.0,5,783,1.0,515.0,515.0
40.073,17,10,676,5,460,10017.0,104.0,64.0,5,216,10017.0,20.0,15.0
0.005,6,10,2000,5,927,1.0,659.0,659.0,5,1073,1.0,805.0,805.0
0.202,6,16,2777,8,1395,28.0,533.0,323.0,8,1382,18.0,529.0,239.0
0.006,17,2,169,1,62,0.0,34.0,34.0,1,107,0.0,79.0,79.0
0.004,6,10,1779,5,928,1.0,660.0,660.0,5,851,1.0,583.0,583.0
0.077,6,10,1506,5,395,18.0,127.0,127.0,5,1111,16.0,843.0,843.0
0.009,6,10,1990,5,911,2.0,643.0,643.0,5,1079,2.0,811.0,811.0
0.023,6,10,1983,5,910,5.0,642.0,642.0,5,1073,5.0,805.0,805.0
240.107,6,31,9277,15,6796,17150.0,1920.0,668.0,16,2481,16006.0,580.0,205.0
0.005,6,10,2006,5,927,1.0,659.0,659.0,5,1079,1.0,811.0,811.0
0.005,17,2,166,1,75,0.0,47.0,47.0,1,91,0.0,63.0,63.0
0.005,6,10,2006,5,927,1.0,659.0,659.0,5,1079,1.0,811.0,811.0
0.218,17,4,352,2,130,146.0,37.0,37.0,2,222,179.0,89.0,83.0
0.005,17,2,146,1,65,0.0,37.0,37.0,1,81,0.0,53.0,53.0
0.039,17,4,284,2,120,0.0,32.0,32.0,2,164,35.0,60.0,54.0
0.005,6,10,1779,5,928,1.0,660.0,660.0,5,851,1.0,583.0,583.0
8.992,6,36,9771,19,4293,499.0,1360.0,700.0,17,5478,549.0,2667.0,435.0
0.003,17,2,136,1,60,0.0,32.0,32.0,1,76,0.0,48.0,48.0
40.062,17,10,676,5,460,10014.0,104.0,64.0,5,216,10014.0,20.0,15.0
0.005,6,10,2006,5,927,1.0,659.0,659.0,5,1079,1.0,811.0,811.0
0.111,6,10,1506,5,395,23.0,127.0,127.0,5,1111,24.0,843.0,843.0
0.016,6,10,1972,5,910,3.0,642.0,642.0,5,1062,3.0,794.0,794.0
0.005,6,10,2007,5,928,1.0,660.0,660.0,5,1079,1.0,811.0,811.0
0.018,6,10,1983,5,910,4.0,642.0,642.0,5,1073,4.0,805.0,805.0
0.063,6,10,1506,5,395,13.0,127.0,127.0,5,1111,14.0,843.0,843.0
0.014,6,10,1989,5,910,3.0,642.0,642.0,5,1079,3.0,811.0,811.0
0.011,6,10,1972,5,910,2.0,642.0,642.0,5,1062,2.0,794.0,794.0
293.887,6,384,347357,204,22161,1447.0,2736.0,889.0,180,325196,1641.0,2804.0,1902.0
0.006,17,2,367,1,99,0.0,71.0,71.0,1,268,0.0,240.0,240.0
300.957,6,45,14903,24,9036,13085.0,2720.0,1005.0,21,5867,439.0,2667.0,385.0
0.003,17,4,284,2,120,0.0,32.0,32.0,2,164,0.0,60.0,54.0
1781.589,6,240,46415,115,33907,15627.0,2474.0,996.0,125,12508,14367.0,580.0,61.0
0.004,6,14,3742,7,452,0.0,80.0,80.0,7,3290,0.0,1448.0,972.0
533.274,6,33,10182,18,2672,31369.0,661.0,345.0,15,7510,33803.0,1402.0,746.0
40.071,17,10,676,5,460,10014.0,104.0,64.0,5,216,10017.0,20.0,15.0
0.006,17,2,180,1,66,0.0,38.0,38.0,1,114,0.0,86.0,86.0
0.012,6,10,1677,5,827,3.0,559.0,559.0,5,850,2.0,582.0,582.0
0.176,6,3,453,2,321,176.0,241.0,241.0,1,132,0.0,92.0,92.0
0.085,6,10,1506,5,395,20.0,127.0,127.0,5,1111,18.0,843.0,843.0
0.017,6,10,1972,5,910,4.0,642.0,642.0,5,1062,4.0,794.0,794.0
11.106,17,28,4417,14,1994,842.0,269.0,114.0,14,2423,842.0,586.0,145.0
240.01,6,9,787,5,488,60002.0,232.0,232.0,4,299,80002.0,83.0,83.0
0.005,6,10,1643,5,860,1.0,592.0,592.0,5,783,1.0,515.0,515.0
0.126,6,10,1506,5,395,25.0,127.0,127.0,5,1111,26.0,843.0,843.0
0.012,6,13,3735,7,497,2.0,125.0,125.0,6,3238,2.0,1470.0,1459.0
0.005,6,10,2006,5,927,1.0,659.0,659.0,5,1079,1.0,811.0,811.0
0.071,17,2,80,1,32,0.0,4.0,4.0,1,48,0.0,20.0,20.0
40.059,17,10,676,5,460,10013.0,104.0,64.0,5,216,10013.0,20.0,15.0
0.004,6,10,2006,5,927,1.0,659.0,659.0,5,1079,1.0,811.0,811.0
0.014,6,10,1990,5,911,3.0,643.0,643.0,5,1079,3.0,811.0,811.0
0.004,17,2,148,1,60,0.0,32.0,32.0,1,88,0.0,60.0,60.0
0.005,6,10,1689,5,839,1.0,571.0,571.0,5,850,1.0,582.0,582.0
0.021,6,10,1972,5,910,5.0,642.0,642.0,5,1062,5.0,794.0,794.0
11.22,17,28,4421,14,1994,850.0,269.0,114.0,14,2427,850.0,586.0,145.0
0.006,6,10,1547,5,764,1.0,496.0,496.0,5,783,1.0,515.0,515.0
0.024,6,10,1989,5,910,5.0,642.0,642.0,5,1079,6.0,811.0,811.0
0.09,6,10,1506,5,395,20.0,127.0,127.0,5,1111,20.0,843.0,843.0
316.909,6,43,15222,25,2427,13204.0,260.0,186.0,18,12795,15111.0,1436.0,846.0
0.005,6,10,1779,5,928,1.0,660.0,660.0,5,851,1.0,583.0,583.0
178.239,17,92,13200,46,3093,3960.0,44.0,39.0,46,10107,3960.0,261.0,191.0
0.013,6,10,1989,5,910,3.0,642.0,642.0,5,1079,3.0,811.0,811.0
0.0,17,2,136,1,60,0.0,32.0,32.0,1,76,0.0,48.0,48.0
353.508,6,20,2210,6,1308,12006.0,494.0,494.0,14,902,27192.0,83.0,83.0
40.056,17,10,676,5,460,10012.0,104.0,64.0,5,216,10010.0,20.0,15.0
0.005,6,10,2006,5,927,1.0,659.0,659.0,5,1079,1.0,811.0,811.0
0.003,17,4,284,2,120,0.0,32.0,32.0,2,164,0.0,60.0,54.0
0.044,17,2,136,1,60,0.0,32.0,32.0,1,76,0.0,48.0,48.0
0.004,17,4,284,2,120,1.0,32.0,32.0,2,164,0.0,60.0,54.0
0.006,6,10,1547,5,764,1.0,496.0,496.0,5,783,1.0,515.0,515.0
0.028,6,10,1989,5,910,6.0,642.0,642.0,5,1079,7.0,811.0,811.0
0.084,6,10,1506,5,395,19.0,127.0,127.0,5,1111,19.0,843.0,843.0
0.009,6,10,1972,5,910,2.0,642.0,642.0,5,1062,2.0,794.0,794.0
0.02,6,10,1983,5,910,5.0,642.0,642.0,5,1073,5.0,805.0,805.0
0.075,6,10,1506,5,395,17.0,127.0,127.0,5,1111,17.0,843.0,843.0
0.004,6,10,2006,5,927,1.0,659.0,659.0,5,1079,1.0,811.0,811.0
0.168,6,10,1506,5,395,17.0,127.0,127.0,5,1111,41.0,843.0,843.0
0.003,17,2,136,1,60,0.0,32.0,32.0,1,76,0.0,48.0,48.0
0.004,6,10,2006,5,927,1.0,659.0,659.0,5,1079,1.0,811.0,811.0
1762.925,6,430,65318,254,35296,6968.0,613.0,197.0,176,30022,10073.0,453.0,146.0
240.1,6,31,10019,15,7604,17150.0,2729.0,758.0,16,2415,16006.0,580.0,196.0
0.011,17,2,169,1,62,0.0,34.0,34.0,1,107,0.0,79.0,79.0
0.005,6,10,1989,5,927,1.0,659.0,659.0,5,1062,1.0,794.0,794.0
10.874,17,28,4422,14,1994,827.0,269.0,114.0,14,2428,828.0,587.0,145.0
0.106,6,10,1506,5,395,25.0,127.0,127.0,5,1111,22.0,843.0,843.0
0.005,6,13,3690,7,452,0.0,80.0,80.0,6,3238,1.0,1470.0,1459.0
0.009,6,10,1989,5,910,2.0,642.0,642.0,5,1079,2.0,811.0,811.0
0.009,6,10,1989,5,910,2.0,642.0,642.0,5,1079,2.0,811.0,811.0
0.005,17,2,152,1,68,0.0,40.0,40.0,1,84,0.0,56.0,56.0
0.015,6,10,1972,5,910,3.0,642.0,642.0,5,1062,3.0,794.0,794.0
0.005,17,2,209,1,64,0.0,36.0,36.0,1,145,0.0,117.0,117.0
0.006,6,10,1547,5,764,1.0,496.0,496.0,5,783,1.0,515.0,515.0
40.048,17,10,676,5,460,10011.0,104.0,64.0,5,216,10011.0,20.0,15.0
0.076,6,10,1506,5,395,16.0,127.0,127.0,5,1111,18.0,843.0,843.0
0.039,17,2,170,1,65,0.0,37.0,37.0,1,105,0.0,77.0,77.0
0.012,6,10,1989,5,910,3.0,642.0,642.0,5,1079,3.0,811.0,811.0
168.188,17,78,11021,39,2597,4425.0,44.0,38.0,39,8424,4425.0,239.0,188.0
40.057,17,10,676,5,460,10013.0,104.0,64.0,5,216,10012.0,20.0,15.0
0.011,6,10,1972,5,910,2.0,642.0,642.0,5,1062,2.0,794.0,794.0
0.004,17,2,136,1,60,0.0,32.0,32.0,1,76,0.0,48.0,48.0
0.005,6,10,2006,5,927,1.0,659.0,659.0,5,1079,1.0,811.0,811.0
0.011,6,10,1983,5,910,2.0,642.0,642.0,5,1073,2.0,805.0,805.0
240.112,6,31,9405,15,7043,17150.0,2166.0,696.0,16,2362,16007.0,580.0,190.0
0.027,6,12,4062,7,675,4.0,299.0,299.0,5,3387,4.0,1717.0,1559.0
0.004,6,10,1989,5,927,1.0,659.0,659.0,5,1062,1.0,794.0,794.0
0.148,6,10,1506,5,395,35.0,127.0,127.0,5,1111,35.0,843.0,843.0
0.006,6,10,1774,5,923,1.0,655.0,655.0,5,851,1.0,583.0,583.0
0.266,17,42,20199,22,17084,12.0,1350.0,748.0,20,3115,10.0,1350.0,127.0
0.003,17,2,146,1,65,0.0,37.0,37.0,1,81,0.0,53.0,53.0
300.385,6,16,2170,9,684,37526.0,146.0,146.0,7,1486,50035.0,419.0,398.0
240.447,6,33,10016,16,2091,16027.0,539.0,250.0,17,7925,15025.0,1402.0,640.0
0.014,6,10,1677,5,827,3.0,559.0,559.0,5,850,3.0,582.0,582.0
0.005,6,10,2000,5,927,1.0,659.0,659.0,5,1073,1.0,805.0,805.0
40.068,17,10,676,5,460,10015.0,104.0,64.0,5,216,10016.0,20.0,15.0
0.027,6,10,1989,5,910,6.0,642.0,642.0,5,1079,6.0,811.0,811.0
0.005,6,10,1779,5,928,1.0,660.0,660.0,5,851,1.0,583.0,583.0
55.72,6,63,35073,31,28766,314.0,4080.0,1718.0,32,6307,1792.0,2667.0,385.0
1745.023,6,497,76201,269,40453,6511.0,1925.0,222.0,228,35748,7686.0,1533.0,160.0
0.006,17,2,170,1,65,0.0,37.0,37.0,1,105,0.0,77.0,77.0
0.005,6,10,2007,5,928,1.0,660.0,660.0,5,1079,1.0,811.0,811.0
0.071,17,4,284,2,120,0.0,32.0,32.0,2,164,68.0,60.0,54.0
0.041,17,2,152,1,76,0.0,48.0,48.0,1,76,0.0,48.0,48.0
0.073,17,4,284,2,120,1.0,32.0,32.0,2,164,69.0,60.0,54.0
0.098,6,10,1506,5,395,20.0,127.0,127.0,5,1111,22.0,843.0,843.0
40.064,17,10,676,5,460,10013.0,104.0,64.0,5,216,10015.0,20.0,15.0
0.003,17,4,284,2,120,0.0,32.0,32.0,2,164,0.0,60.0,54.0
0.016,6,10,1631,5,848,3.0,580.0,580.0,5,783,3.0,515.0,515.0
0.005,17,2,170,1,65,0.0,37.0,37.0,1,105,0.0,77.0,77.0
0.015,6,10,1972,5,910,3.0,642.0,642.0,5,1062,3.0,794.0,794.0
0.015,6,10,1989,5,910,3.0,642.0,642.0,5,1079,3.0,811.0,811.0
0.078,6,10,1506,5,395,17.0,127.0,127.0,5,1111,14.0,843.0,843.0
0.006,17,2,136,1,60,0.0,32.0,32.0,1,76,0.0,48.0,48.0
0.006,6,10,1547,5,764,1.0,496.0,496.0,5,783,1.0,515.0,515.0
1.011,6,12,3142,6,2099,152.0,1328.0,923.0,6,1043,152.0,791.0,791.0
0.005,6,10,1854,5,889,1.0,621.0,621.0,5,965,1.0,697.0,697.0
0.067,6,10,1506,5,395,14.0,127.0,127.0,5,1111,14.0,843.0,843.0
0.016,6,10,1983,5,910,3.0,642.0,642.0,5,1073,4.0,805.0,805.0
0.112,6,10,1506,5,395,23.0,127.0,127.0,5,1111,25.0,843.0,843.0
243.199,6,37,9825,16,6969,16213.0,1515.0,614.0,21,2856,12159.0,580.0,146.0
0.028,6,10,1972,5,910,7.0,642.0,642.0,5,1062,6.0,794.0,794.0
0.006,6,10,1689,5,839,1.0,571.0,571.0,5,850,1.0,582.0,582.0
65.012,6,52,22781,27,16754,355.0,2720.0,1303.0,25,6027,2702.0,2667.0,385.0
0.039,17,2,182,1,65,0.0,37.0,37.0,1,117,0.0,89.0,89.0
40.046,17,10,676,5,460,10010.0,104.0,64.0,5,216,10010.0,20.0,15.0
0.112,6,10,1506,5,395,23.0,127.0,127.0,5,1111,22.0,843.0,843.0
0.135,17,2,80,1,32,0.0,4.0,4.0,1,48,0.0,20.0,20.0
0.005,6,10,2006,5,927,1.0,659.0,659.0,5,1079,1.0,811.0,811.0
0.008,6,10,1972,5,910,1.0,642.0,642.0,5,1062,2.0,794.0,794.0
0.04,17,2,396,1,61,0.0,33.0,33.0,1,335,0.0,307.0,307.0
0.005,6,10,1702,5,863,1.0,595.0,595.0,5,839,1.0,571.0,571.0
1756.228,6,105,6270,60,3525,29765.0,27.0,27.0,45,2745,39913.0,27.0,27.0
40.067,17,10,676,5,460,10015.0,104.0,64.0,5,216,10015.0,20.0,15.0
0.014,6,10,1989,5,910,3.0,642.0,642.0,5,1079,3.0,811.0,811.0
309.427,17,20,1124,10,716,34374.0,48.0,43.0,10,408,34374.0,20.0,12.0
0.006,6,10,1547,5,764,1.0,496.0,496.0,5,783,1.0,515.0,515.0
0.006,6,10,1689,5,839,1.0,571.0,571.0,5,850,1.0,582.0,582.0
0.018,6,10,1983,5,910,4.0,642.0,642.0,5,1073,4.0,805.0,805.0
0.039,17,2,152,1,76,0.0,48.0,48.0,1,76,0.0,48.0,48.0
312.681,17,20,1124,10,716,34727.0,48.0,43.0,10,408,34727.0,20.0,12.0
0.019,6,10,1983,5,910,4.0,642.0,642.0,5,1073,4.0,805.0,805.0
0.013,6,10,1631,5,848,3.0,580.0,580.0,5,783,3.0,515.0,515.0
0.018,6,10,1762,5,911,4.0,643.0,643.0,5,851,4.0,583.0,583.0
40.064,17,10,676,5,460,10014.0,104.0,64.0,5,216,10014.0,20.0,15.0
0.004,17,2,148,1,60,0.0,32.0,32.0,1,88,0.0,60.0,60.0
0.007,17,2,136,1,60,0.0,32.0,32.0,1,76,0.0,48.0,48.0
240.115,6,31,9273,15,6947,17151.0,2071.0,685.0,16,2326,16007.0,580.0,185.0
0.005,6,10,2006,5,927,1.0,659.0,659.0,5,1079,1.0,811.0,811.0
0.037,17,2,152,1,76,0.0,48.0,48.0,1,76,0.0,48.0,48.0
0.101,6,10,1506,5,395,22.0,127.0,127.0,5,1111,22.0,843.0,843.0
10.866,17,28,4424,14,1995,827.0,270.0,114.0,14,2429,827.0,588.0,145.0
0.014,6,10,1983,5,910,3.0,642.0,642.0,5,1073,3.0,805.0,805.0
0.001,17,2,140,1,62,0.0,34.0,34.0,1,78,0.0,50.0,50.0
40.062,17,10,676,5,460,10014.0,104.0,64.0,5,216,10014.0,20.0,15.0
553.004,6,51,17710,27,5167,21269.0,676.0,469.0,24,12543,21433.0,1402.0,752.0
240.28,6,42,5658,21,2783,12013.0,588.0,207.0,21,2875,12013.0,580.0,195.0
0.011,6,10,1990,5,911,2.0,643.0,643.0,5,1079,2.0,811.0,811.0
0.001,17,2,180,1,66,0.0,38.0,38.0,1,114,0.0,86.0,86.0
0.004,6,10,2007,5,928,1.0,660.0,660.0,5,1079,1.0,811.0,811.0
0.107,6,10,1506,5,395,16.0,127.0,127.0,5,1111,22.0,843.0,843.0
0.005,17,2,169,1,62,0.0,34.0,34.0,1,107,0.0,79.0,79.0
0.005,6,10,1989,5,927,1.0,659.0,659.0,5,1062,1.0,794.0,794.0
0.006,6,10,2006,5,927,1.0,659.0,659.0,5,1079,1.0,811.0,811.0
0.005,17,2,170,1,65,0.0,37.0,37.0,1,105,0.0,77.0,77.0
0.005,17,2,200,1,68,0.0,40.0,40.0,1,132,0.0,104.0,104.0
0.003,17,4,284,2,120,0.0,32.0,32.0,2,164,0.0,60.0,54.0
0.009,6,10,1983,5,910,2.0,642.0,642.0,5,1073,2.0,805.0,805.0
0.006,6,10,2006,5,927,1.0,659.0,659.0,5,1079,1.0,811.0,811.0
0.007,17,2,194,1,59,0.0,31.0,31.0,1,135,0.0,107.0,107.0
0.014,6,10,1990,5,911,3.0,643.0,643.0,5,1079,3.0,811.0,811.0
0.038,17,4,284,2,120,0.0,32.0,32.0,2,164,0.0,60.0,54.0
0.005,6,10,1643,5,860,1.0,592.0,592.0,5,783,1.0,515.0,515.0
0.008,6,11,2035,6,962,1.0,642.0,642.0,5,1073,1.0,805.0,805.0
0.004,6,10,2000,5,927,1.0,659.0,659.0,5,1073,1.0,805.0,805.0
0.004,6,10,2006,5,927,1.0,659.0,659.0,5,1079,1.0,811.0,811.0
0.804,6,22,5072,11,1250,69.0,325.0,133.0,11,3822,69.0,1414.0,563.0
0.005,17,2,214,1,75,0.0,47.0,47.0,1,139,0.0,111.0,111.0
40.073,17,10,676,5,460,10017.0,104.0,64.0,5,216,10017.0,20.0,15.0
300.378,6,16,2170,9,684,37527.0,146.0,146.0,7,1486,50035.0,419.0,398.0
0.014,6,10,1972,5,910,3.0,642.0,642.0,5,1062,3.0,794.0,794.0
0.124,17,2,148,1,60,0.0,32.0,32.0,1,88,0.0,60.0,60.0
0.021,6,10,1972,5,910,5.0,642.0,642.0,5,1062,5.0,794.0,794.0
0.078,6,10,1506,5,395,16.0,127.0,127.0,5,1111,16.0,843.0,843.0
0.001,17,2,136,1,60,0.0,32.0,32.0,1,76,0.0,48.0,48.0
0.014,17,2,170,1,65,0.0,37.0,37.0,1,105,0.0,77.0,77.0
0.005,6,10,1547,5,764,1.0,496.0,496.0,5,783,1.0,515.0,515.0
0.004,6,10,1779,5,928,1.0,660.0,660.0,5,851,0.0,583.0,583.0
0.038,17,2,152,1,76,0.0,48.0,48.0,1,76,0.0,48.0,48.0
240.088,6,30,8911,15,6694,17149.0,1817.0,657.0,15,2217,17148.0,580.0,204.0
9.037,17,6,376,5,280,2259.0,28.0,28.0,1,96,0.0,68.0,68.0
0.023,6,10,1983,5,910,5.0,642.0,642.0,5,1073,5.0,805.0,805.0
0.005,6,10,1643,5,860,1.0,592.0,592.0,5,783,1.0,515.0,515.0
0.012,6,10,1989,5,910,3.0,642.0,642.0,5,1079,2.0,811.0,811.0
0.004,6,10,1702,5,863,1.0,595.0,595.0,5,839,1.0,571.0,571.0
0.005,6,10,2006,5,927,1.0,659.0,659.0,5,1079,1.0,811.0,811.0
0.105,6,10,1506,5,395,22.0,127.0,127.0,5,1111,22.0,843.0,843.0
0.011,6,10,1972,5,910,2.0,642.0,642.0,5,1062,2.0,794.0,794.0
0.134,17,2,80,1,32,0.0,4.0,4.0,1,48,0.0,20.0,20.0
0.227,6,16,2778,8,1396,32.0,533.0,324.0,8,1382,20.0,529.0,239.0
0.037,17,2,136,1,60,0.0,32.0,32.0,1,76,0.0,48.0,48.0
9.036,17,6,376,5,280,2259.0,28.0,28.0,1,96,0.0,68.0,68.0
0.006,6,10,1547,5,764,1.0,496.0,496.0,5,783,1.0,515.0,515.0
0.006,6,10,1547,5,764,1.0,496.0,496.0,5,783,1.0,515.0,515.0
0.167,6,3,453,2,321,167.0,241.0,241.0,1,132,0.0,92.0,92.0
0.004,17,2,136,1,60,0.0,32.0,32.0,1,76,0.0,48.0,48.0
240.01,6,9,787,5,488,60002.0,232.0,232.0,4,299,80002.0,83.0,83.0
0.005,6,10,2000,5,927,1.0,659.0,659.0,5,1073,1.0,805.0,805.0
0.006,6,10,1547,5,764,1.0,496.0,496.0,5,783,1.0,515.0,515.0
0.011,6,10,1972,5,910,2.0,642.0,642.0,5,1062,2.0,794.0,794.0
0.001,17,2,180,1,66,0.0,38.0,38.0,1,114,0.0,86.0,86.0
0.005,6,10,1989,5,927,1.0,659.0,659.0,5,1062,1.0,794.0,794.0
0.087,6,10,1506,5,395,21.0,127.0,127.0,5,1111,20.0,843.0,843.0
0.005,6,10,2000,5,927,1.0,659.0,659.0,5,1073,1.0,805.0,805.0
40.062,17,10,676,5,460,10013.0,104.0,64.0,5,216,10014.0,20.0,15.0
1.091,6,25,10339,14,1587,83.0,517.0,211.0,11,8752,108.0,1402.0,1021.0
0.001,17,2,180,1,66,0.0,38.0,38.0,1,114,0.0,86.0,86.0
0.047,6,10,1989,5,910,11.0,642.0,642.0,5,1079,11.0,811.0,811.0
1.064,17,6,420,3,180,513.0,32.0,32.0,3,240,511.0,60.0,52.0
0.017,6,10,1983,5,910,4.0,642.0,642.0,5,1073,4.0,805.0,805.0
0.009,6,10,1631,5,848,2.0,580.0,580.0,5,783,2.0,515.0,515.0
0.005,6,10,1989,5,927,1.0,659.0,659.0,5,1062,1.0,794.0,794.0
0.061,6,10,1506,5,395,13.0,127.0,127.0,5,1111,13.0,843.0,843.0
0.005,6,10,1989,5,927,1.0,659.0,659.0,5,1062,1.0,794.0,794.0
40.066,17,10,676,5,460,10015.0,104.0,64.0,5,216,10015.0,20.0,15.0
0.067,6,10,1506,5,395,14.0,127.0,127.0,5,1111,15.0,843.0,843.0
0.006,6,10,1689,5,839,1.0,571.0,571.0,5,850,1.0,582.0,582.0
0.181,6,10,1506,5,395,31.0,127.0,127.0,5,1111,43.0,843.0,843.0
0.066,17,8,3613,4,1874,22.0,1350.0,440.0,4,1739,11.0,1350.0,406.0
0.009,6,10,1989,5,910,2.0,642.0,642.0,5,1079,2.0,811.0,811.0
0.009,6,10,1990,5,911,2.0,643.0,643.0,5,1079,2.0,811.0,811.0
0.001,17,2,180,1,66,0.0,38.0,38.0,1,114,0.0,86.0,86.0
40.129,17,10,676,5,460,10029.0,104.0,64.0,5,216,10031.0,20.0,15.0
0.004,6,10,1702,5,863,1.0,595.0,595.0,5,839,1.0,571.0,571.0
0.005,17,2,178,1,81,0.0,53.0,53.0,1,97,0.0,69.0,69.0
0.094,6,10,1506,5,395,21.0,127.0,127.0,5,1111,19.0,843.0,843.0
0.017,6,10,1989,5,910,4.0,642.0,642.0,5,1079,4.0,811.0,811.0
0.005,17,2,230,1,68,0.0,40.0,40.0,1,162,0.0,134.0,134.0
0.072,17,2,186,1,61,0.0,33.0,33.0,1,125,0.0,97.0,97.0
308.638,17,20,1124,10,716,34283.0,48.0,43.0,10,408,34279.0,20.0,12.0
0.005,6,10,1989,5,927,1.0,659.0,659.0,5,1062,1.0,794.0,794.0
0.068,17,8,3613,4,1874,22.0,1350.0,440.0,4,1739,12.0,1350.0,406.0
0.259,6,10,1506,5,395,46.0,127.0,127.0,5,1111,51.0,843.0,843.0
0.124,17,2,80,1,32,0.0,4.0,4.0,1,48,0.0,20.0,20.0
0.011,6,10,1972,5,910,2.0,642.0,642.0,5,1062,2.0,794.0,794.0
0.105,6,10,1506,5,395,25.0,127.0,127.0,5,1111,25.0,843.0,843.0
0.001,17,2,166,1,75,0.0,47.0,47.0,1,91,0.0,63.0,63.0
0.024,6,10,1983,5,910,6.0,642.0,642.0,5,1073,5.0,805.0,805.0
0.081,6,10,1506,5,395,17.0,127.0,127.0,5,1111,17.0,843.0,843.0
0.092,6,10,1506,5,395,21.0,127.0,127.0,5,1111,18.0,843.0,843.0
0.162,17,2,152,1,76,0.0,48.0,48.0,1,76,0.0,48.0,48.0
40.051,17,10,676,5,460,10011.0,104.0,64.0,5,216,10011.0,20.0,15.0
0.016,6,10,1983,5,910,3.0,642.0,642.0,5,1073,4.0,805.0,805.0
0.004,6,10,2006,5,927,1.0,659.0,659.0,5,1079,1.0,811.0,811.0
0.012,6,13,3735,7,497,2.0,125.0,125.0,6,3238,2.0,1470.0,1459.0
0.005,17,2,144,1,64,0.0,36.0,36.0,1,80,0.0,52.0,52.0
0.006,6,10,1547,5,764,1.0,496.0,496.0,5,783,1.0,515.0,515.0
0.004,6,10,1779,5,928,1.0,660.0,660.0,5,851,0.0,583.0,583.0
0.005,6,10,2006,5,927,1.0,659.0,659.0,5,1079,1.0,811.0,811.0
0.005,17,2,166,1,75,0.0,47.0,47.0,1,91,0.0,63.0,63.0
0.006,6,10,1547,5,764,1.0,496.0,496.0,5,783,1.0,515.0,515.0
0.014,6,10,1972,5,910,3.0,642.0,642.0,5,1062,3.0,794.0,794.0
352.775,6,20,2210,6,1308,12005.0,494.0,494.0,14,902,27136.0,83.0,83.0
0.019,6,10,1989,5,910,4.0,642.0,642.0,5,1079,4.0,811.0,811.0
0.007,6,10,1989,5,910,1.0,642.0,642.0,5,1079,1.0,811.0,811.0
0.072,17,2,148,1,60,0.0,32.0,32.0,1,88,0.0,60.0,60.0
11.223,17,28,4422,14,1994,851.0,269.0,114.0,14,2428,850.0,587.0,145.0
0.005,17,2,180,1,66,0.0,38.0,38.0,1,114,0.0,86.0,86.0
0.067,17,8,3613,4,1874,22.0,1350.0,440.0,4,1739,10.0,1350.0,406.0
0.01,6,10,1972,5,910,2.0,642.0,642.0,5,1062,2.0,794.0,794.0
0.049,6,10,1990,5,911,12.0,643.0,643.0,5,1079,12.0,811.0,811.0
40.077,17,10,676,5,460,10017.0,104.0,64.0,5,216,10018.0,20.0,15.0
0.004,6,10,2006,5,927,1.0,659.0,659.0,5,1079,1.0,811.0,811.0
0.009,6,12,1926,6,1189,1.0,659.0,434.0,6,737,1.0,417.0,417.0
0.009,6,10,1989,5,910,2.0,642.0,642.0,5,1079,2.0,811.0,811.0
1769.306,17,92,8096,46,4048,39317.0,60.0,60.0,46,4048,39317.0,60.0,60.0
0.004,17,2,148,1,60,0.0,32.0,32.0,1,88,0.0,60.0,60.0
0.003,17,4,284,2,120,0.0,32.0,32.0,2,164,0.0,60.0,54.0
177.322,17,86,12381,43,2885,4221.0,44.0,39.0,43,9496,4221.0,261.0,192.0
0.017,6,10,1989,5,910,4.0,642.0,642.0,5,1079,4.0,811.0,811.0
120.891,6,59,19504,33,5217,3777.0,1053.0,234.0,26,14287,4835.0,2804.0,994.0
0.011,6,6,716,3,458,4.0,302.0,302.0,3,258,4.0,102.0,102.0
0.095,6,10,1506,5,395,22.0,127.0,127.0,5,1111,22.0,843.0,843.0
0.068,6,10,1506,5,395,15.0,127.0,127.0,5,1111,16.0,843.0,843.0
0.083,6,10,1506,5,395,19.0,127.0,127.0,5,1111,19.0,843.0,843.0
0.008,6,10,1972,5,910,2.0,642.0,642.0,5,1062,2.0,794.0,794.0
0.011,6,10,1972,5,910,2.0,642.0,642.0,5,1062,2.0,794.0,794.0
0.005,6,10,2007,5,928,1.0,660.0,660.0,5,1079,1.0,811.0,811.0
0.005,6,10,2000,5,927,1.0,659.0,659.0,5,1073,1.0,805.0,805.0
0.02,6,10,1983,5,910,5.0,642.0,642.0,5,1073,4.0,805.0,805.0
0.081,6,10,1506,5,395,18.0,127.0,127.0,5,1111,18.0,843.0,843.0
0.004,17,2,166,1,75,0.0,47.0,47.0,1,91,0.0,63.0,63.0
0.006,6,10,1854,5,889,1.0,621.0,621.0,5,965,1.0,697.0,697.0
0.081,6,10,1506,5,395,18.0,127.0,127.0,5,1111,16.0,843.0,843.0
0.006,6,10,1547,5,764,1.0,496.0,496.0,5,783,1.0,515.0,515.0
0.021,6,10,1972,5,910,5.0,642.0,642.0,5,1062,5.0,794.0,794.0
0.005,6,10,1779,5,928,1.0,660.0,660.0,5,851,1.0,583.0,583.0
0.105,6,10,1506,5,395,22.0,127.0,127.0,5,1111,21.0,843.0,843.0
1798.207,17,2623,200396,1305,105745,1378.0,84.0,53.0,1318,94651,1365.0,227.0,43.0
0.018,6,6,716,3,458,7.0,302.0,302.0,3,258,7.0,102.0,102.0
0.031,6,10,1972,5,910,7.0,642.0,642.0,5,1062,7.0,794.0,794.0
11.069,17,28,4396,14,2313,842.0,588.0,137.0,14,2083,842.0,270.0,120.0
0.004,6,10,1779,5,928,1.0,660.0,660.0,5,851,1.0,583.0,583.0
0.13,17,2,146,1,65,0.0,37.0,37.0,1,81,0.0,53.0,53.0
0.0,17,2,179,1,62,0.0,34.0,34.0,1,117,0.0,89.0,89.0
0.232,6,16,2669,8,1395,33.0,533.0,323.0,8,1274,21.0,529.0,212.0
1771.746,17,119,11360,60,5460,30029.0,63.0,63.0,59,5900,30547.0,72.0,72.0
0.003,6,10,1702,5,863,0.0,595.0,595.0,5,839,0.0,571.0,571.0
0.107,6,10,1506,5,395,26.0,127.0,127.0,5,1111,24.0,843.0,843.0
0.001,17,2,180,1,66,0.0,38.0,38.0,1,114,0.0,86.0,86.0
0.109,6,10,1506,5,395,23.0,127.0,127.0,5,1111,23.0,843.0,843.0
0.005,6,10,1689,5,839,1.0,571.0,571.0,5,850,1.0,582.0,582.0
0.005,6,10,2000,5,927,1.0,659.0,659.0,5,1073,1.0,805.0,805.0
0.071,6,10,1506,5,395,15.0,127.0,127.0,5,1111,15.0,843.0,843.0
0.074,6,10,1506,5,395,16.0,127.0,127.0,5,1111,14.0,843.0,843.0
0.004,17,2,136,1,60,0.0,32.0,32.0,1,76,0.0,48.0,48.0
0.107,6,10,1506,5,395,24.0,127.0,127.0,5,1111,24.0,843.0,843.0
0.005,17,2,170,1,65,0.0,37.0,37.0,1,105,0.0,77.0,77.0
0.009,6,10,1989,5,910,2.0,642.0,642.0,5,1079,2.0,811.0,811.0
11.219,17,28,4417,14,1993,850.0,268.0,114.0,14,2424,850.0,587.0,145.0
0.02,6,10,1989,5,910,4.0,642.0,642.0,5,1079,4.0,811.0,811.0
0.934,17,65,40304,36,30617,26.0,1350.0,822.0,29,9687,28.0,1350.0,306.0
40.078,17,10,676,5,460,10018.0,104.0,64.0,5,216,10018.0,20.0,15.0
0.011,6,10,1989,5,910,2.0,642.0,642.0,5,1079,2.0,811.0,811.0
0.005,17,2,293,1,73,0.0,45.0,45.0,1,220,0.0,192.0,192.0
1.136,17,6,780,3,183,566.0,33.0,33.0,3,597,566.0,323.0,171.0
0.005,17,2,140,1,62,0.0,34.0,34.0,1,78,0.0,50.0,50.0
0.004,6,10,2007,5,928,1.0,660.0,660.0,5,1079,1.0,811.0,811.0
429.022,6,77,14958,40,10339,11000.0,1515.0,514.0,37,4619,11917.0,580.0,191.0
0.11,6,10,1506,5,395,26.0,127.0,127.0,5,1111,25.0,843.0,843.0
0.016,6,10,1983,5,910,4.0,642.0,642.0,5,1073,3.0,805.0,805.0
0.134,6,10,1506,5,395,23.0,127.0,127.0,5,1111,31.0,843.0,843.0
0.005,6,10,1547,5,764,1.0,496.0,496.0,5,783,1.0,515.0,515.0
0.005,6,13,3690,7,452,0.0,80.0,80.0,6,3238,0.0,1470.0,1459.0
0.084,6,10,1506,5,395,16.0,127.0,127.0,5,1111,17.0,843.0,843.0
40.075,17,10,676,5,460,10017.0,104.0,64.0,5,216,10018.0,20.0,15.0
0.01,6,10,1762,5,911,2.0,643.0,643.0,5,851,2.0,583.0,583.0
0.001,17,2,136,1,60,0.0,32.0,32.0,1,76,0.0,48.0,48.0
0.011,6,10,1631,5,848,2.0,580.0,580.0,5,783,2.0,515.0,515.0
0.019,6,10,1989,5,910,4.0,642.0,642.0,5,1079,4.0,811.0,811.0
0.006,6,10,1547,5,764,1.0,496.0,496.0,5,783,1.0,515.0,515.0
240.322,6,33,8638,17,1836,15020.0,569.0,188.0,16,6802,16021.0,1402.0,597.0
0.001,17,2,179,1,62,0.0,34.0,34.0,1,117,0.0,89.0,89.0
300.295,6,16,2170,9,684,37516.0,146.0,146.0,7,1486,50021.0,419.0,398.0
366.843,6,22,2313,16,867,24456.0,195.0,195.0,6,1446,4636.0,419.0,398.0
0.008,6,10,1990,5,911,2.0,643.0,643.0,5,1079,2.0,811.0,811.0
0.005,17,2,164,1,74,0.0,46.0,46.0,1,90,0.0,62.0,62.0
0.12,6,10,1506,5,395,24.0,127.0,127.0,5,1111,26.0,843.0,843.0
0.004,6,10,1989,5,927,1.0,659.0,659.0,5,1062,1.0,794.0,794.0
0.005,6,10,1547,5,764,1.0,496.0,496.0,5,783,1.0,515.0,515.0
0.004,6,10,2000,5,927,1.0,659.0,659.0,5,1073,1.0,805.0,805.0
0.081,6,10,1506,5,395,18.0,127.0,127.0,5,1111,17.0,843.0,843.0
1779.659,17,138,43608,72,22752,25055.0,288.0,288.0,66,20856,27379.0,288.0,288.0
0.004,6,10,2000,5,927,1.0,659.0,659.0,5,1073,1.0,805.0,805.0
0.008,6,10,1990,5,911,1.0,643.0,643.0,5,1079,1.0,811.0,811.0
0.005,6,10,2006,5,927,1.0,659.0,659.0,5,1079,1.0,811.0,811.0
0.0,17,2,179,1,62,0.0,34.0,34.0,1,117,0.0,89.0,89.0
0.013,6,10,1972,5,910,3.0,642.0,642.0,5,1062,3.0,794.0,794.0
0.037,17,4,284,2,120,0.0,32.0,32.0,2,164,34.0,60.0,54.0
0.004,6,10,1702,5,863,0.0,595.0,595.0,5,839,1.0,571.0,571.0
0.005,6,10,2006,5,927,1.0,659.0,659.0,5,1079,1.0,811.0,811.0
0.001,17,2,180,1,66,0.0,38.0,38.0,1,114,0.0,86.0,86.0
0.006,6,10,2007,5,928,1.0,660.0,660.0,5,1079,1.0,811.0,811.0
0.006,6,10,1689,5,839,1.0,571.0,571.0,5,850,1.0,582.0,582.0
0.001,17,2,180,1,66,0.0,38.0,38.0,1,114,0.0,86.0,86.0
1772.354,17,92,8096,46,4048,39385.0,60.0,60.0,46,4048,39385.0,60.0,60.0
0.02,6,10,1983,5,910,5.0,642.0,642.0,5,1073,4.0,805.0,805.0
0.013,6,10,1677,5,827,3.0,559.0,559.0,5,850,3.0,582.0,582.0
0.006,17,2,144,1,64,0.0,36.0,36.0,1,80,0.0,52.0,52.0
0.005,6,10,1989,5,927,1.0,659.0,659.0,5,1062,1.0,794.0,794.0
0.169,17,2,152,1,76,0.0,48.0,48.0,1,76,0.0,48.0,48.0
0.006,6,10,2006,5,927,1.0,659.0,659.0,5,1079,1.0,811.0,811.0
0.072,17,2,182,1,65,0.0,37.0,37.0,1,117,0.0,89.0,89.0
0.02,6,10,1990,5,911,5.0,643.0,643.0,5,1079,4.0,811.0,811.0
0.011,6,10,1989,5,910,2.0,642.0,642.0,5,1079,2.0,811.0,811.0
40.065,17,10,676,5,460,10014.0,104.0,64.0,5,216,10015.0,20.0,15.0
10.79,17,28,4421,14,1993,821.0,268.0,114.0,14,2428,821.0,587.0,145.0
0.006,6,10,1643,5,860,1.0,592.0,592.0,5,783,1.0,515.0,515.0
0.006,17,2,178,1,65,0.0,37.0,37.0,1,113,0.0,85.0,85.0
0.004,17,2,152,1,76,0.0,48.0,48.0,1,76,0.0,48.0,48.0
40.069,17,10,676,5,460,10012.0,104.0,64.0,5,216,10016.0,20.0,15.0
0.001,17,2,179,1,62,0.0,34.0,34.0,1,117,0.0,89.0,89.0
40.06,17,10,676,5,460,10014.0,104.0,64.0,5,216,10014.0,20.0,15.0
0.008,6,10,1990,5,911,2.0,643.0,643.0,5,1079,1.0,811.0,811.0
0.104,6,10,1506,5,395,21.0,127.0,127.0,5,1111,24.0,843.0,843.0
0.02,6,13,3735,7,497,3.0,125.0,125.0,6,3238,4.0,1470.0,1459.0
367.005,6,19,2158,6,1308,12014.0,494.0,494.0,13,850,30583.0,83.0,83.0
0.001,17,2,180,1,66,0.0,38.0,38.0,1,114,0.0,86.0,86.0
15.071,17,16,10616,9,8280,1880.0,1350.0,892.0,7,2336,2508.0,1350.0,305.0
0.095,6,10,1506,5,395,21.0,127.0,127.0,5,1111,14.0,843.0,843.0
0.017,6,13,3735,7,497,2.0,125.0,125.0,6,3238,3.0,1470.0,1459.0
0.083,6,10,1506,5,395,18.0,127.0,127.0,5,1111,16.0,843.0,843.0
134.357,6,21,8145,11,1985,83.0,1174.0,504.0,10,6160,14909.0,2720.0,958.0
0.006,6,10,1547,5,764,1.0,496.0,496.0,5,783,1.0,515.0,515.0
24.828,6,36,8190,18,1719,512.0,651.0,322.0,18,6471,1453.0,2720.0,478.0
0.006,6,10,1689,5,839,1.0,571.0,571.0,5,850,1.0,582.0,582.0
0.102,6,10,1506,5,395,23.0,127.0,127.0,5,1111,22.0,843.0,843.0
0.071,17,2,80,1,32,0.0,4.0,4.0,1,48,0.0,20.0,20.0
0.012,6,10,1762,5,911,3.0,643.0,643.0,5,851,2.0,583.0,583.0
1778.742,17,142,44872,72,22752,25050.0,288.0,288.0,70,22120,25777.0,288.0,288.0
0.008,6,10,1990,5,911,2.0,643.0,643.0,5,1079,1.0,811.0,811.0
0.006,17,2,136,1,60,0.0,32.0,32.0,1,76,0.0,48.0,48.0
10.758,17,28,4421,14,1994,819.0,269.0,114.0,14,2427,819.0,586.0,145.0
0.117,6,10,1506,5,395,25.0,127.0,127.0,5,1111,27.0,843.0,843.0
40.067,17,10,676,5,460,10014.0,104.0,64.0,5,216,10015.0,20.0,15.0
0.006,6,10,2007,5,928,1.0,660.0,660.0,5,1079,1.0,811.0,811.0
0.012,6,10,1990,5,911,2.0,643.0,643.0,5,1079,2.0,811.0,811.0
0.005,6,10,1779,5,928,1.0,660.0,660.0,5,851,1.0,583.0,583.0
0.005,6,10,1689,5,839,1.0,571.0,571.0,5,850,1.0,582.0,582.0
0.005,17,2,144,1,64,0.0,36.0,36.0,1,80,0.0,52.0,52.0
0.006,6,10,1689,5,839,1.0,571.0,571.0,5,850,1.0,582.0,582.0
0.01,6,10,1989,5,910,2.0,642.0,642.0,5,1079,2.0,811.0,811.0
0.061,17,2,80,1,32,0.0,4.0,4.0,1,48,0.0,20.0,20.0
0.014,17,2,152,1,56,0.0,28.0,28.0,1,96,0.0,68.0,68.0
0.015,6,13,3735,7,497,2.0,125.0,125.0,6,3238,3.0,1470.0,1459.0
0.12,6,10,1506,5,395,25.0,127.0,127.0,5,1111,26.0,843.0,843.0
0.086,6,10,1506,5,395,20.0,127.0,127.0,5,1111,20.0,843.0,843.0
11.122,17,28,4423,14,1994,843.0,269.0,114.0,14,2429,843.0,588.0,145.0
0.009,6,10,2007,5,928,2.0,660.0,660.0,5,1079,2.0,811.0,811.0
0.01,6,10,1990,5,911,2.0,643.0,643.0,5,1079,2.0,811.0,811.0
0.004,6,10,2007,5,928,1.0,660.0,660.0,5,1079,1.0,811.0,811.0
0.003,17,2,148,1,60,0.0,32.0,32.0,1,88,0.0,60.0,60.0
0.009,6,10,1762,5,911,2.0,643.0,643.0,5,851,2.0,583.0,583.0
0.005,6,10,2007,5,928,1.0,660.0,660.0,5,1079,1.0,811.0,811.0
0.016,6,10,1972,5,910,3.0,642.0,642.0,5,1062,3.0,794.0,794.0
0.089,6,10,1506,5,395,19.0,127.0,127.0,5,1111,19.0,843.0,843.0
0.07,6,10,1506,5,395,14.0,127.0,127.0,5,1111,15.0,843.0,843.0
15.168,17,18,10943,10,7332,1682.0,1350.0,705.0,8,3611,2162.0,1350.0,423.0
0.006,6,10,1547,5,764,1.0,496.0,496.0,5,783,1.0,515.0,515.0
0.015,6,10,1990,5,911,3.0,643.0,643.0,5,1079,3.0,811.0,811.0
0.092,6,10,1506,5,395,21.0,127.0,127.0,5,1111,16.0,843.0,843.0
0.071,17,2,136,1,60,0.0,32.0,32.0,1,76,0.0,48.0,48.0
1757.112,6,106,6361,59,3485,30294.0,27.0,27.0,47,2876,38197.0,27.0,27.0
0.005,17,2,302,1,65,0.0,37.0,37.0,1,237,0.0,209.0,209.0
0.005,6,10,2006,5,927,1.0,659.0,659.0,5,1079,1.0,811.0,811.0
0.016,17,2,198,1,91,0.0,63.0,63.0,1,107,0.0,79.0,79.0
0.127,17,2,182,1,65,0.0,37.0,37.0,1,117,0.0,89.0,89.0
40.09,17,10,676,5,460,10018.0,104.0,64.0,5,216,10021.0,20.0,15.0
0.004,6,10,1774,5,923,1.0,655.0,655.0,5,851,0.0,583.0,583.0
0.102,6,10,1506,5,395,22.0,127.0,127.0,5,1111,21.0,843.0,843.0
0.004,6,10,2007,5,928,1.0,660.0,660.0,5,1079,1.0,811.0,811.0
0.001,17,2,180,1,66,0.0,38.0,38.0,1,114,0.0,86.0,86.0
0.115,6,10,1506,5,395,25.0,127.0,127.0,5,1111,24.0,843.0,843.0
0.005,6,13,3690,7,452,0.0,80.0,80.0,6,3238,0.0,1470.0,1459.0
0.135,6,10,1506,5,395,30.0,127.0,127.0,5,1111,30.0,843.0,843.0
0.007,17,2,136,1,60,0.0,32.0,32.0,1,76,0.0,48.0,48.0
0.236,17,39,20147,21,17048,11.0,1350.0,783.0,18,3099,10.0,1350.0,144.0
0.269,17,39,20271,21,17046,13.0,1350.0,783.0,18,3225,12.0,1350.0,151.0
0.005,17,2,214,1,75,0.0,47.0,47.0,1,139,0.0,111.0,111.0
0.057,17,2,182,1,65,0.0,37.0,37.0,1,117,0.0,89.0,89.0
0.062,6,10,1506,5,395,13.0,127.0,127.0,5,1111,14.0,843.0,843.0
0.003,17,2,136,1,60,0.0,32.0,32.0,1,76,0.0,48.0,48.0
0.006,6,10,1547,5,764,1.0,496.0,496.0,5,783,1.0,515.0,515.0
0.005,17,2,144,1,64,0.0,36.0,36.0,1,80,0.0,52.0,52.0
0.005,6,10,2000,5,927,1.0,659.0,659.0,5,1073,1.0,805.0,805.0
0.066,6,10,1506,5,395,14.0,127.0,127.0,5,1111,14.0,843.0,843.0
0.098,6,10,1506,5,395,21.0,127.0,127.0,5,1111,21.0,843.0,843.0
11.078,17,26,4073,13,2140,914.0,587.0,136.0,13,1933,914.0,268.0,120.0
0.005,6,10,1689,5,839,1.0,571.0,571.0,5,850,1.0,582.0,582.0
0.009,6,10,1990,5,911,2.0,643.0,643.0,5,1079,2.0,811.0,811.0
0.005,6,10,1643,5,860,1.0,592.0,592.0,5,783,1.0,515.0,515.0
0.006,6,10,2000,5,927,1.0,659.0,659.0,5,1073,1.0,805.0,805.0
10.879,17,26,4102,13,1822,897.0,269.0,112.0,13,2280,897.0,587.0,147.0
0.019,6,10,1631,5,848,4.0,580.0,580.0,5,783,4.0,515.0,515.0
0.023,17,2,136,1,60,0.0,32.0,32.0,1,76,0.0,48.0,48.0
0.007,17,2,194,1,59,0.0,31.0,31.0,1,135,0.0,107.0,107.0
0.042,17,2,184,1,61,0.0,33.0,33.0,1,123,0.0,95.0,95.0
354.065,6,21,1795,16,1030,23604.0,190.0,190.0,5,765,60003.0,464.0,248.0
0.072,17,2,182,1,65,0.0,37.0,37.0,1,117,0.0,89.0,89.0
40.071,17,10,676,5,460,10015.0,104.0,64.0,5,216,10017.0,20.0,15.0
0.018,6,10,1989,5,910,4.0,642.0,642.0,5,1079,4.0,811.0,811.0
40.056,17,10,676,5,460,10011.0,104.0,64.0,5,216,10013.0,20.0,15.0
0.005,6,10,1689,5,839,1.0,571.0,571.0,5,850,1.0,582.0,582.0
0.087,6,10,1506,5,395,19.0,127.0,127.0,5,1111,17.0,843.0,843.0
0.004,6,10,2006,5,927,1.0,659.0,659.0,5,1079,1.0,811.0,811.0
0.003,17,2,148,1,60,0.0,32.0,32.0,1,88,0.0,60.0,60.0
369.858,6,22,2313,16,867,24657.0,195.0,195.0,6,1446,4652.0,419.0,398.0
0.012,6,10,1990,5,911,3.0,643.0,643.0,5,1079,2.0,811.0,811.0
0.001,17,2,179,1,62,0.0,34.0,34.0,1,117,0.0,89.0,89.0
290.986,6,417,348963,201,22019,1454.0,2736.0,889.0,216,326944,1353.0,2804.0,1562.0
0.059,17,2,152,1,76,0.0,48.0,48.0,1,76,0.0,48.0,48.0
0.016,6,10,1631,5,848,4.0,580.0,580.0,5,783,3.0,515.0,515.0
0.003,17,4,284,2,120,0.0,32.0,32.0,2,164,0.0,60.0,54.0
0.168,17,2,152,1,76,0.0,48.0,48.0,1,76,0.0,48.0,48.0
0.005,6,10,2006,5,927,1.0,659.0,659.0,5,1079,1.0,811.0,811.0
0.004,6,10,1702,5,863,1.0,595.0,595.0,5,839,1.0,571.0,571.0
40.069,17,10,676,5,460,10015.0,104.0,64.0,5,216,10016.0,20.0,15.0
0.006,6,10,1689,5,839,1.0,571.0,571.0,5,850,1.0,582.0,582.0
0.074,6,10,1506,5,395,17.0,127.0,127.0,5,1111,15.0,843.0,843.0
0.068,17,8,3613,4,1874,22.0,1350.0,440.0,4,1739,12.0,1350.0,406.0
0.004,6,10,2000,5,927,1.0,659.0,659.0,5,1073,1.0,805.0,805.0
0.005,6,10,1547,5,764,1.0,496.0,496.0,5,783,1.0,515.0,515.0
0.005,6,10,1702,5,863,1.0,595.0,595.0,5,839,1.0,571.0,571.0
0.114,6,10,1506,5,395,26.0,127.0,127.0,5,1111,23.0,843.0,843.0
0.005,6,10,2007,5,928,1.0,660.0,660.0,5,1079,1.0,811.0,811.0
0.078,6,10,1506,5,395,16.0,127.0,127.0,5,1111,17.0,843.0,843.0
171.072,17,86,12325,43,2890,4073.0,44.0,39.0,43,9435,4073.0,239.0,191.0
0.005,6,10,1689,5,839,1.0,571.0,571.0,5,850,1.0,582.0,582.0
240.098,6,16,4482,9,963,30012.0,238.0,166.0,7,3519,40016.0,1402.0,786.0
0.014,6,10,1990,5,911,3.0,643.0,643.0,5,1079,3.0,811.0,811.0
0.014,6,10,1983,5,910,3.0,642.0,642.0,5,1073,3.0,805.0,805.0
0.006,6,10,1547,5,764,1.0,496.0,496.0,5,783,1.0,515.0,515.0
0.005,6,10,2007,5,928,1.0,660.0,660.0,5,1079,1.0,811.0,811.0
0.004,6,10,2006,5,927,1.0,659.0,659.0,5,1079,1.0,811.0,811.0
0.205,6,16,2777,8,1395,29.0,533.0,323.0,8,1382,18.0,529.0,239.0
0.053,17,2,152,1,76,0.0,48.0,48.0,1,76,0.0,48.0,48.0
0.005,6,10,2006,5,927,1.0,659.0,659.0,5,1079,1.0,811.0,811.0
0.006,6,10,1547,5,764,1.0,496.0,496.0,5,783,1.0,515.0,515.0
0.004,17,2,148,1,60,0.0,32.0,32.0,1,88,0.0,60.0,60.0
0.01,17,2,152,1,76,0.0,48.0,48.0,1,76,0.0,48.0,48.0
0.005,17,2,214,1,75,0.0,47.0,47.0,1,139,0.0,111.0,111.0
2.71,6,27,6163,15,2136,193.0,517.0,302.0,12,4027,231.0,1330.0,589.0
0.096,6,10,1506,5,395,21.0,127.0,127.0,5,1111,19.0,843.0,843.0
15.097,17,23,14360,12,10583,1369.0,1350.0,853.0,11,3777,1506.0,1350.0,315.0
0.005,6,10,1702,5,863,1.0,595.0,595.0,5,839,1.0,571.0,571.0
0.005,6,13,3747,7,509,0.0,137.0,137.0,6,3238,1.0,1470.0,1459.0
0.078,6,10,1506,5,395,16.0,127.0,127.0,5,1111,18.0,843.0,843.0
0.077,6,10,1506,5,395,18.0,127.0,127.0,5,1111,14.0,843.0,843.0
0.013,6,10,1972,5,910,3.0,642.0,642.0,5,1062,3.0,794.0,794.0
169.274,17,78,11101,39,2597,4454.0,44.0,38.0,39,8504,4454.0,239.0,190.0
0.005,6,10,1989,5,927,1.0,659.0,659.0,5,1062,1.0,794.0,794.0
0.007,17,2,170,1,65,0.0,37.0,37.0,1,105,0.0,77.0,77.0
0.037,17,2,148,1,60,0.0,32.0,32.0,1,88,0.0,60.0,60.0
0.004,17,2,136,1,60,0.0,32.0,32.0,1,76,0.0,48.0,48.0
0.1,6,10,1506,5,395,17.0,127.0,127.0,5,1111,23.0,843.0,843.0
0.018,6,10,1631,5,848,4.0,580.0,580.0,5,783,4.0,515.0,515.0
0.005,6,10,2007,5,928,1.0,660.0,660.0,5,1079,1.0,811.0,811.0
0.005,6,10,2007,5,928,1.0,660.0,660.0,5,1079,1.0,811.0,811.0
0.012,6,10,1990,5,911,3.0,643.0,643.0,5,1079,2.0,811.0,811.0
0.103,6,10,1506,5,395,21.0,127.0,127.0,5,1111,23.0,843.0,843.0
0.011,6,10,1983,5,910,2.0,642.0,642.0,5,1073,2.0,805.0,805.0
0.006,17,2,136,1,60,0.0,32.0,32.0,1,76,0.0,48.0,48.0
0.005,6,10,2006,5,927,1.0,659.0,659.0,5,1079,1.0,811.0,811.0
0.006,17,2,164,1,74,0.0,46.0,46.0,1,90,0.0,62.0,62.0
40.052,17,10,676,5,460,10011.0,104.0,64.0,5,216,10012.0,20.0,15.0
0.005,17,2,170,1,65,0.0,37.0,37.0,1,105,0.0,77.0,77.0
0.006,6,10,1547,5,764,1.0,496.0,496.0,5,783,1.0,515.0,515.0
0.173,17,2,152,1,76,0.0,48.0,48.0,1,76,0.0,48.0,48.0
0.005,17,2,170,1,65,0.0,37.0,37.0,1,105,0.0,77.0,77.0
0.001,17,2,180,1,66,0.0,38.0,38.0,1,114,0.0,86.0,86.0
0.006,6,10,1547,5,764,1.0,496.0,496.0,5,783,1.0,515.0,515.0
0.067,17,8,3613,4,1874,22.0,1350.0,440.0,4,1739,10.0,1350.0,406.0
0.005,6,10,2007,5,928,1.0,660.0,660.0,5,1079,1.0,811.0,811.0
0.013,6,10,1990,5,911,3.0,643.0,643.0,5,1079,3.0,811.0,811.0
0.005,6,10,2007,5,928,1.0,660.0,660.0,5,1079,1.0,811.0,811.0
34.55,6,24,9313,13,1655,2879.0,794.0,367.0,11,7658,3442.0,1360.0,1029.0
308.563,17,20,1124,10,716,34270.0,48.0,43.0,10,408,34270.0,20.0,12.0
0.005,6,10,1989,5,927,1.0,659.0,659.0,5,1062,1.0,794.0,794.0
0.005,6,10,1774,5,923,1.0,655.0,655.0,5,851,1.0,583.0,583.0
0.127,17,4,420,2,122,0.0,33.0,33.0,2,298,89.0,145.0,121.0
0.103,6,10,1506,5,395,21.0,127.0,127.0,5,1111,20.0,843.0,843.0
0.005,6,10,1689,5,839,1.0,571.0,571.0,5,850,1.0,582.0,582.0
0.541,17,18,10079,9,6973,67.0,1350.0,746.0,9,3106,57.0,1350.0,317.0
0.005,6,10,2007,5,928,1.0,660.0,660.0,5,1079,1.0,811.0,811.0
0.014,6,10,1990,5,911,3.0,643.0,643.0,5,1079,3.0,811.0,811.0
0.004,17,4,284,2,120,1.0,32.0,32.0,2,164,0.0,60.0,54.0
0.016,17,2,198,1,91,0.0,63.0,63.0,1,107,0.0,79.0,79.0
0.007,6,10,1547,5,764,1.0,496.0,496.0,5,783,1.0,515.0,515.0
0.005,6,10,2006,5,927,1.0,659.0,659.0,5,1079,1.0,811.0,811.0
0.007,6,12,1698,6,863,1.0,327.0,271.0,6,835,1.0,515.0,515.0
0.086,6,10,1506,5,395,18.0,127.0,127.0,5,1111,20.0,843.0,843.0
242.008,6,380,347831,186,21196,1308.0,2736.0,885.0,194,326635,1253.0,3364.0,1720.0
0.031,6,10,1989,5,910,7.0,642.0,642.0,5,1079,7.0,811.0,811.0
0.008,6,10,1972,5,910,2.0,642.0,642.0,5,1062,2.0,794.0,794.0
0.027,6,10,1990,5,911,6.0,643.0,643.0,5,1079,6.0,811.0,811.0
0.009,6,10,1990,5,911,2.0,643.0,643.0,5,1079,2.0,811.0,811.0
11.115,17,28,4393,14,1994,844.0,269.0,114.0,14,2399,845.0,586.0,143.0
0.011,6,10,1631,5,848,2.0,580.0,580.0,5,783,2.0,515.0,515.0
0.004,6,10,1702,5,863,1.0,595.0,595.0,5,839,1.0,571.0,571.0
0.012,6,10,1972,5,910,3.0,642.0,642.0,5,1062,3.0,794.0,794.0
0.009,6,10,1972,5,910,2.0,642.0,642.0,5,1062,2.0,794.0,794.0
0.005,17,2,166,1,75,0.0,47.0,47.0,1,91,0.0,63.0,63.0
0.006,6,10,1547,5,764,1.0,496.0,496.0,5,783,1.0,515.0,515.0
0.004,6,10,2007,5,928,1.0,660.0,660.0,5,1079,1.0,811.0,811.0
0.004,6,10,2006,5,927,1.0,659.0,659.0,5,1079,1.0,811.0,811.0
0.019,17,2,140,1,62,0.0,34.0,34.0,1,78,0.0,50.0,50.0
0.01,6,10,1631,5,848,2.0,580.0,580.0,5,783,2.0,515.0,515.0
0.12,6,10,1506,5,395,28.0,127.0,127.0,5,1111,20.0,843.0,843.0
0.015,6,10,1989,5,910,3.0,642.0,642.0,5,1079,3.0,811.0,811.0
0.001,17,2,166,1,75,0.0,47.0,47.0,1,91,0.0,63.0,63.0
354.02,6,21,1795,16,1030,23601.0,190.0,190.0,5,765,60002.0,464.0,248.0
0.066,6,10,1506,5,395,16.0,127.0,127.0,5,1111,12.0,843.0,843.0
0.005,6,10,1989,5,927,1.0,659.0,659.0,5,1062,1.0,794.0,794.0
0.074,6,10,1506,5,395,17.0,127.0,127.0,5,1111,15.0,843.0,843.0
0.004,6,10,1989,5,927,1.0,659.0,659.0,5,1062,1.0,794.0,794.0
1778.189,17,144,41760,72,22752,25044.0,288.0,288.0,72,19008,25044.0,236.0,236.0
0.083,6,10,1506,5,395,17.0,127.0,127.0,5,1111,18.0,843.0,843.0
0.069,6,10,1506,5,395,15.0,127.0,127.0,5,1111,14.0,843.0,843.0
0.123,6,10,1506,5,395,27.0,127.0,127.0,5,1111,27.0,843.0,843.0
240.014,6,9,787,5,488,60003.0,232.0,232.0,4,299,80003.0,83.0,83.0
0.075,6,10,1506,5,395,17.0,127.0,127.0,5,1111,16.0,843.0,843.0
0.016,6,10,1990,5,911,4.0,643.0,643.0,5,1079,3.0,811.0,811.0
0.067,6,10,1506,5,395,15.0,127.0,127.0,5,1111,14.0,843.0,843.0
0.005,17,2,170,1,65,0.0,37.0,37.0,1,105,0.0,77.0,77.0
0.001,17,2,180,1,66,0.0,38.0,38.0,1,114,0.0,86.0,86.0
0.001,17,2,136,1,60,0.0,32.0,32.0,1,76,0.0,48.0,48.0
0.009,6,10,1989,5,927,2.0,659.0,659.0,5,1062,2.0,794.0,794.0
0.009,6,12,1926,6,1189,1.0,659.0,434.0,6,737,1.0,417.0,417.0
0.005,17,2,180,1,66,0.0,38.0,38.0,1,114,0.0,86.0,86.0
0.01,6,10,1983,5,910,2.0,642.0,642.0,5,1073,2.0,805.0,805.0
0.111,6,10,1506,5,395,26.0,127.0,127.0,5,1111,24.0,843.0,843.0
0.093,6,10,1506,5,395,18.0,127.0,127.0,5,1111,20.0,843.0,843.0
0.005,17,2,164,1,74,0.0,46.0,46.0,1,90,0.0,62.0,62.0
0.013,6,10,1989,5,910,3.0,642.0,642.0,5,1079,3.0,811.0,811.0
0.018,6,10,1990,5,911,4.0,643.0,643.0,5,1079,4.0,811.0,811.0
314.314,17,20,1124,10,716,34909.0,48.0,43.0,10,408,34909.0,20.0,12.0
0.005,6,10,1989,5,927,1.0,659.0,659.0,5,1062,1.0,794.0,794.0
369.037,6,22,2313,16,867,24602.0,195.0,195.0,6,1446,4650.0,419.0,398.0
0.012,6,10,1631,5,848,3.0,580.0,580.0,5,783,2.0,515.0,515.0
0.098,6,10,1506,5,395,20.0,127.0,127.0,5,1111,21.0,843.0,843.0
0.004,6,10,2007,5,928,1.0,660.0,660.0,5,1079,1.0,811.0,811.0
11.147,17,28,4424,14,1995,844.0,270.0,114.0,14,2429,844.0,588.0,145.0
0.005,6,10,1643,5,860,1.0,592.0,592.0,5,783,1.0,515.0,515.0
0.006,6,10,1854,5,889,1.0,621.0,621.0,5,965,1.0,697.0,697.0
40.051,17,10,676,5,460,10011.0,104.0,64.0,5,216,10012.0,20.0,15.0
40.059,17,10,676,5,460,10013.0,104.0,64.0,5,216,10013.0,20.0,15.0
0.008,17,2,162,1,65,0.0,37.0,37.0,1,97,0.0,69.0,69.0
0.005,17,2,166,1,75,0.0,47.0,47.0,1,91,0.0,63.0,63.0
0.1,6,10,1506,5,395,19.0,127.0,127.0,5,1111,24.0,843.0,843.0
0.004,6,10,2006,5,927,1.0,659.0,659.0,5,1079,1.0,811.0,811.0
0.005,6,10,2007,5,928,1.0,660.0,660.0,5,1079,1.0,811.0,811.0
300.34,6,16,2170,9,684,37520.0,146.0,146.0,7,1486,50027.0,419.0,398.0
225.751,58,3,216,2,144,225751.0,24.0,24.0,1,72,0.0,24.0,24.0
0.006,6,10,1643,5,860,1.0,592.0,592.0,5,783,1.0,515.0,515.0
15.071,17,15,9238,8,6902,2148.0,1350.0,834.0,7,2336,2507.0,1350.0,305.0
0.086,6,10,1506,5,395,20.0,127.0,127.0,5,1111,19.0,843.0,843.0
2.748,6,27,6167,15,2140,196.0,517.0,303.0,12,4027,234.0,1330.0,589.0
11.159,17,28,4424,14,1995,845.0,270.0,114.0,14,2429,845.0,588.0,145.0
46.294,6,36,9526,18,4008,519.0,1543.0,814.0,18,5518,2713.0,2667.0,435.0
0.005,6,14,3742,8,504,0.0,80.0,80.0,6,3238,0.0,1470.0,1459.0
0.04,17,2,152,1,76,0.0,48.0,48.0,1,76,0.0,48.0,48.0
308.619,17,20,1124,10,716,34277.0,48.0,43.0,10,408,34277.0,20.0,12.0
0.066,17,8,3613,4,1874,22.0,1350.0,440.0,4,1739,11.0,1350.0,406.0
0.137,6,10,1506,5,395,31.0,127.0,127.0,5,1111,33.0,843.0,843.0
0.012,6,10,1989,5,910,3.0,642.0,642.0,5,1079,3.0,811.0,811.0
0.005,6,10,2000,5,927,1.0,659.0,659.0,5,1073,1.0,805.0,805.0
0.011,6,10,1990,5,911,2.0,643.0,643.0,5,1079,2.0,811.0,811.0
0.005,6,10,1854,5,889,1.0,621.0,621.0,5,965,1.0,697.0,697.0
10.854,17,28,4417,14,1994,826.0,269.0,114.0,14,2423,826.0,586.0,145.0
0.005,6,10,2006,5,927,1.0,659.0,659.0,5,1079,1.0,811.0,811.0
0.004,6,10,1779,5,928,1.0,660.0,660.0,5,851,0.0,583.0,583.0
0.013,6,10,1989,5,910,3.0,642.0,642.0,5,1079,3.0,811.0,811.0
0.02,6,10,1989,5,910,4.0,642.0,642.0,5,1079,4.0,811.0,811.0
0.003,6,10,1702,5,863,0.0,595.0,595.0,5,839,0.0,571.0,571.0
0.005,6,10,1989,5,927,1.0,659.0,659.0,5,1062,1.0,794.0,794.0
0.009,17,2,214,1,75,0.0,47.0,47.0,1,139,0.0,111.0,111.0
0.004,6,10,2007,5,928,1.0,660.0,660.0,5,1079,1.0,811.0,811.0
0.013,6,10,1989,5,910,3.0,642.0,642.0,5,1079,3.0,811.0,811.0
0.083,6,10,1506,5,395,20.0,127.0,127.0,5,1111,17.0,843.0,843.0
40.059,17,10,676,5,460,10012.0,104.0,64.0,5,216,10013.0,20.0,15.0
0.379,17,43,23066,24,19853,16.0,1350.0,799.0,19,3213,17.0,1350.0,141.0
168.129,17,70,9705,35,2325,4944.0,44.0,38.0,35,7380,4944.0,239.0,182.0
0.005,6,10,1689,5,839,1.0,571.0,571.0,5,850,1.0,582.0,582.0
373.567,6,22,2313,16,867,24904.0,195.0,195.0,6,1446,4646.0,419.0,398.0
0.017,6,10,1677,5,827,4.0,559.0,559.0,5,850,4.0,582.0,582.0
0.005,6,10,1779,5,928,1.0,660.0,660.0,5,851,1.0,583.0,583.0
365.717,6,22,2264,16,818,24381.0,146.0,146.0,6,1446,4649.0,419.0,398.0
40.077,17,10,676,5,460,10018.0,104.0,64.0,5,216,10017.0,20.0,15.0
11.225,17,28,4421,14,1994,854.0,269.0,114.0,14,2427,854.0,586.0,145.0
0.019,6,10,1762,5,911,4.0,643.0,643.0,5,851,4.0,583.0,583.0
0.077,6,10,1506,5,395,17.0,127.0,127.0,5,1111,17.0,843.0,843.0
251.694,6,27,7600,12,3336,22881.0,1031.0,679.0,15,4264,17977.0,1162.0,386.0
0.127,17,2,148,1,60,0.0,32.0,32.0,1,88,0.0,60.0,60.0
0.005,6,13,3747,7,509,0.0,137.0,137.0,6,3238,1.0,1470.0,1459.0
246.449,6,38,10039,16,6850,16429.0,1923.0,669.0,22,3189,11735.0,580.0,156.0
0.037,17,2,144,1,64,0.0,36.0,36.0,1,80,0.0,52.0,52.0
0.078,6,10,1506,5,395,16.0,127.0,127.0,5,1111,17.0,843.0,843.0
0.013,6,10,1972,5,910,3.0,642.0,642.0,5,1062,3.0,794.0,794.0
0.01,6,10,1972,5,910,2.0,642.0,642.0,5,1062,2.0,794.0,794.0
0.011,6,10,2006,5,927,2.0,659.0,659.0,5,1079,2.0,811.0,811.0
0.006,6,10,2007,5,928,1.0,660.0,660.0,5,1079,1.0,811.0,811.0
241.193,6,382,349479,193,21586,1256.0,2736.0,959.0,189,327893,1282.0,2804.0,1776.0
0.004,6,10,1702,5,863,0.0,595.0,595.0,5,839,1.0,571.0,571.0
0.005,6,10,2006,5,927,1.0,659.0,659.0,5,1079,1.0,811.0,811.0
0.039,17,2,148,1,60,0.0,32.0,32.0,1,88,0.0,60.0,60.0
0.071,6,10,1506,5,395,15.0,127.0,127.0,5,1111,14.0,843.0,843.0
0.072,17,8,3613,4,1874,24.0,1350.0,440.0,4,1739,12.0,1350.0,406.0
0.073,6,10,1506,5,395,17.0,127.0,127.0,5,1111,16.0,843.0,843.0
0.004,6,10,2007,5,928,1.0,660.0,660.0,5,1079,1.0,811.0,811.0
0.009,6,10,1989,5,910,2.0,642.0,642.0,5,1079,2.0,811.0,811.0
0.006,6,10,1689,5,839,1.0,571.0,571.0,5,850,1.0,582.0,582.0
0.014,6,10,1972,5,910,3.0,642.0,642.0,5,1062,3.0,794.0,794.0
0.011,6,10,1989,5,910,2.0,642.0,642.0,5,1079,2.0,811.0,811.0
0.008,6,10,1989,5,910,2.0,642.0,642.0,5,1079,1.0,811.0,811.0
0.065,6,10,1506,5,395,14.0,127.0,127.0,5,1111,14.0,843.0,843.0
0.007,6,10,1643,5,860,1.0,592.0,592.0,5,783,1.0,515.0,515.0
0.001,17,2,180,1,66,0.0,38.0,38.0,1,114,0.0,86.0,86.0
0.04,17,2,182,1,65,0.0,37.0,37.0,1,117,0.0,89.0,89.0
0.014,17,2,152,1,56,0.0,28.0,28.0,1,96,0.0,68.0,68.0
0.014,17,2,152,1,56,0.0,28.0,28.0,1,96,0.0,68.0,68.0
0.072,6,10,1506,5,395,12.0,127.0,127.0,5,1111,16.0,843.0,843.0
0.005,6,10,2000,5,927,1.0,659.0,659.0,5,1073,1.0,805.0,805.0
0.107,6,10,1506,5,395,24.0,127.0,127.0,5,1111,23.0,843.0,843.0
0.004,6,10,1989,5,927,1.0,659.0,659.0,5,1062,1.0,794.0,794.0
40.062,17,10,676,5,460,10014.0,104.0,64.0,5,216,10014.0,20.0,15.0
0.175,17,2,152,1,76,0.0,48.0,48.0,1,76,0.0,48.0,48.0
0.004,6,10,2007,5,928,1.0,660.0,660.0,5,1079,1.0,811.0,811.0
0.02,6,10,1989,5,910,5.0,642.0,642.0,5,1079,4.0,811.0,811.0
0.241,6,16,2778,8,1396,34.0,533.0,324.0,8,1382,23.0,529.0,239.0
0.006,17,2,144,1,64,0.0,36.0,36.0,1,80,0.0,52.0,52.0
0.004,17,2,136,1,60,0.0,32.0,32.0,1,76,0.0,48.0,48.0
44.582,6,36,8190,18,1719,541.0,651.0,322.0,18,6471,2614.0,2720.0,478.0
1.202,6,30,13240,17,5840,75.0,2720.0,854.0,13,7400,86.0,2720.0,858.0
0.005,6,10,2000,5,927,1.0,659.0,659.0,5,1073,1.0,805.0,805.0
0.006,17,2,214,1,75,0.0,47.0,47.0,1,139,0.0,111.0,111.0
40.059,17,10,676,5,460,10013.0,104.0,64.0,5,216,10013.0,20.0,15.0
0.004,17,2,136,1,60,0.0,32.0,32.0,1,76,0.0,48.0,48.0
0.017,6,10,1972,5,910,4.0,642.0,642.0,5,1062,4.0,794.0,794.0
0.001,17,2,136,1,60,0.0,32.0,32.0,1,76,0.0,48.0,48.0
0.008,6,12,1926,6,1189,1.0,659.0,434.0,6,737,1.0,417.0,417.0
0.056,17,2,179,1,71,0.0,43.0,43.0,1,108,0.0,80.0,80.0
0.058,6,10,1506,5,395,13.0,127.0,127.0,5,1111,13.0,843.0,843.0
0.01,6,10,1972,5,910,2.0,642.0,642.0,5,1062,2.0,794.0,794.0
0.1,6,10,1506,5,395,22.0,127.0,127.0,5,1111,17.0,843.0,843.0
40.062,17,10,676,5,460,10014.0,104.0,64.0,5,216,10014.0,20.0,15.0
0.072,17,2,412,1,61,0.0,33.0,33.0,1,351,0.0,323.0,323.0
10.794,17,28,4423,14,1994,821.0,269.0,114.0,14,2429,821.0,588.0,145.0
0.005,6,10,1689,5,839,1.0,571.0,571.0,5,850,1.0,582.0,582.0
0.006,17,2,214,1,75,0.0,47.0,47.0,1,139,0.0,111.0,111.0
0.006,17,2,170,1,65,0.0,37.0,37.0,1,105,0.0,77.0,77.0
0.006,6,10,1547,5,764,1.0,496.0,496.0,5,783,1.0,515.0,515.0
0.017,6,13,3735,7,497,2.0,125.0,125.0,6,3238,3.0,1470.0,1459.0
0.005,6,10,1643,5,860,1.0,592.0,592.0,5,783,1.0,515.0,515.0
0.005,6,10,2006,5,927,1.0,659.0,659.0,5,1079,1.0,811.0,811.0
0.008,6,10,1762,5,911,1.0,643.0,643.0,5,851,2.0,583.0,583.0
0.053,17,2,152,1,76,0.0,48.0,48.0,1,76,0.0,48.0,48.0
0.073,17,4,352,2,130,2.0,37.0,37.0,2,222,35.0,89.0,83.0
0.01,6,13,3735,7,497,1.0,125.0,125.0,6,3238,2.0,1470.0,1459.0
0.12,6,10,1506,5,395,28.0,127.0,127.0,5,1111,28.0,843.0,843.0
0.076,6,10,1506,5,395,18.0,127.0,127.0,5,1111,14.0,843.0,843.0
0.005,6,10,1989,5,927,1.0,659.0,659.0,5,1062,1.0,794.0,794.0
0.09,6,10,1506,5,395,19.0,127.0,127.0,5,1111,20.0,843.0,843.0
10.865,17,28,4424,14,1995,826.0,270.0,114.0,14,2429,827.0,588.0,145.0
0.005,17,2,169,1,62,0.0,34.0,34.0,1,107,0.0,79.0,79.0
0.009,6,10,1990,5,911,2.0,643.0,643.0,5,1079,2.0,811.0,811.0
0.087,6,10,1506,5,395,18.0,127.0,127.0,5,1111,18.0,843.0,843.0
0.013,6,10,1972,5,910,3.0,642.0,642.0,5,1062,3.0,794.0,794.0
0.01,6,10,1983,5,910,2.0,642.0,642.0,5,1073,2.0,805.0,805.0
0.012,6,10,1989,5,910,3.0,642.0,642.0,5,1079,3.0,811.0,811.0
0.007,6,10,1989,5,910,1.0,642.0,642.0,5,1079,1.0,811.0,811.0
0.003,17,2,136,1,60,0.0,32.0,32.0,1,76,0.0,48.0,48.0
0.011,6,10,1989,5,910,2.0,642.0,642.0,5,1079,2.0,811.0,811.0
0.244,17,44,24468,24,21161,10.0,1350.0,853.0,20,3307,9.0,1350.0,137.0
308.418,17,20,1124,10,716,34259.0,48.0,43.0,10,408,34260.0,20.0,12.0
0.005,17,2,179,1,71,0.0,43.0,43.0,1,108,0.0,80.0,80.0
0.219,6,16,2782,8,1400,31.0,533.0,325.0,8,1382,19.0,529.0,239.0
0.005,6,10,2007,5,928,1.0,660.0,660.0,5,1079,1.0,811.0,811.0
0.072,6,10,1506,5,395,16.0,127.0,127.0,5,1111,15.0,843.0,843.0
0.004,6,10,2006,5,927,1.0,659.0,659.0,5,1079,1.0,811.0,811.0
1792.366,6,549,190929,275,164015,6541.0,2883.0,1004.0,274,26914,6565.0,580.0,124.0
0.012,6,10,1983,5,910,3.0,642.0,642.0,5,1073,2.0,805.0,805.0
0.005,6,10,1774,5,923,1.0,655.0,655.0,5,851,1.0,583.0,583.0
0.005,6,10,2006,5,927,1.0,659.0,659.0,5,1079,1.0,811.0,811.0
152.34,58,5,360,4,288,50780.0,24.0,24.0,1,72,0.0,24.0,24.0
0.211,6,16,2669,8,1395,30.0,533.0,323.0,8,1274,19.0,529.0,212.0
240.085,6,16,4480,9,963,30010.0,238.0,166.0,7,3517,40013.0,1402.0,786.0
0.071,17,2,182,1,65,0.0,37.0,37.0,1,117,0.0,89.0,89.0
40.081,17,10,676,5,460,10019.0,104.0,64.0,5,216,10019.0,20.0,15.0
0.017,6,10,1989,5,910,4.0,642.0,642.0,5,1079,4.0,811.0,811.0
0.094,6,10,1506,5,395,19.0,127.0,127.0,5,1111,20.0,843.0,843.0
0.117,6,10,1506,5,395,27.0,127.0,127.0,5,1111,28.0,843.0,843.0
0.079,6,10,1506,5,395,17.0,127.0,127.0,5,1111,16.0,843.0,843.0
240.094,6,16,4480,9,963,30011.0,238.0,166.0,7,3517,40015.0,1402.0,786.0
0.004,6,10,2007,5,928,1.0,660.0,660.0,5,1079,1.0,811.0,811.0
0.005,6,10,2000,5,927,1.0,659.0,659.0,5,1073,1.0,805.0,805.0
0.006,6,10,1547,5,764,1.0,496.0,496.0,5,783,1.0,515.0,515.0
0.004,6,10,2007,5,928,1.0,660.0,660.0,5,1079,1.0,811.0,811.0
0.011,6,10,1983,5,910,2.0,642.0,642.0,5,1073,2.0,805.0,805.0
0.004,6,10,2006,5,927,1.0,659.0,659.0,5,1079,1.0,811.0,811.0
0.014,6,13,3913,7,495,2.0,123.0,123.0,6,3418,2.0,1650.0,1549.0
0.014,6,10,1989,5,910,3.0,642.0,642.0,5,1079,3.0,811.0,811.0
0.005,6,10,1689,5,839,1.0,571.0,571.0,5,850,1.0,582.0,582.0
0.005,17,2,148,1,60,0.0,32.0,32.0,1,88,0.0,60.0,60.0
0.23,6,16,2777,8,1395,32.0,533.0,323.0,8,1382,21.0,529.0,239.0
0.005,6,10,1547,5,764,1.0,496.0,496.0,5,783,1.0,515.0,515.0
0.025,6,10,1677,5,827,6.0,559.0,559.0,5,850,6.0,582.0,582.0
0.013,6,10,1972,5,910,3.0,642.0,642.0,5,1062,3.0,794.0,794.0
0.004,17,2,136,1,60,0.0,32.0,32.0,1,76,0.0,48.0,48.0
0.011,6,10,1631,5,848,2.0,580.0,580.0,5,783,2.0,515.0,515.0
0.01,6,13,3735,7,497,1.0,125.0,125.0,6,3238,1.0,1470.0,1459.0
0.001,17,2,136,1,60,0.0,32.0,32.0,1,76,0.0,48.0,48.0
0.004,17,4,284,2,120,0.0,32.0,32.0,2,164,0.0,60.0,54.0
0.011,6,10,1983,5,910,2.0,642.0,642.0,5,1073,2.0,805.0,805.0
0.005,6,10,2007,5,928,1.0,660.0,660.0,5,1079,1.0,811.0,811.0
11.146,17,28,4422,14,1994,845.0,269.0,114.0,14,2428,845.0,587.0,145.0
40.054,17,10,676,5,460,10012.0,104.0,64.0,5,216,10012.0,20.0,15.0
0.072,6,10,1506,5,395,17.0,127.0,127.0,5,1111,15.0,843.0,843.0
0.008,6,10,1989,5,910,1.0,642.0,642.0,5,1079,1.0,811.0,811.0
85.746,6,21,8145,11,1985,81.0,1174.0,504.0,10,6160,9508.0,2720.0,958.0
0.004,6,10,2007,5,928,1.0,660.0,660.0,5,1079,1.0,811.0,811.0
0.006,6,10,2000,5,927,1.0,659.0,659.0,5,1073,1.0,805.0,805.0
0.014,6,13,3913,7,495,2.0,123.0,123.0,6,3418,2.0,1650.0,1549.0
0.072,6,10,1506,5,395,16.0,127.0,127.0,5,1111,16.0,843.0,843.0
0.005,6,10,2006,5,927,1.0,659.0,659.0,5,1079,1.0,811.0,811.0
0.092,6,10,1506,5,395,21.0,127.0,127.0,5,1111,20.0,843.0,843.0
0.005,17,2,150,1,67,0.0,39.0,39.0,1,83,0.0,55.0,55.0
0.009,6,12,1926,6,1189,1.0,659.0,434.0,6,737,1.0,417.0,417.0
0.011,6,10,1989,5,910,2.0,642.0,642.0,5,1079,2.0,811.0,811.0
0.005,6,10,2007,5,928,1.0,660.0,660.0,5,1079,1.0,811.0,811.0
0.009,6,10,1989,5,910,2.0,642.0,642.0,5,1079,2.0,811.0,811.0
0.072,6,10,1506,5,395,16.0,127.0,127.0,5,1111,14.0,843.0,843.0
0.005,6,10,2000,5,927,1.0,659.0,659.0,5,1073,1.0,805.0,805.0
0.013,17,2,169,1,62,0.0,34.0,34.0,1,107,0.0,79.0,79.0
0.061,6,10,1506,5,395,13.0,127.0,127.0,5,1111,14.0,843.0,843.0
0.01,6,10,1972,5,910,2.0,642.0,642.0,5,1062,2.0,794.0,794.0
40.056,17,10,676,5,460,10012.0,104.0,64.0,5,216,10012.0,20.0,15.0
0.003,17,2,136,1,60,0.0,32.0,32.0,1,76,0.0,48.0,48.0
0.107,17,2,152,1,76,0.0,48.0,48.0,1,76,0.0,48.0,48.0
0.009,6,10,1989,5,910,2.0,642.0,642.0,5,1079,2.0,811.0,811.0
0.006,6,10,1689,5,839,1.0,571.0,571.0,5,850,1.0,582.0,582.0
0.089,6,10,1506,5,395,20.0,127.0,127.0,5,1111,20.0,843.0,843.0
0.111,6,10,1506,5,395,24.0,127.0,127.0,5,1111,26.0,843.0,843.0
0.004,6,10,1989,5,927,1.0,659.0,659.0,5,1062,1.0,794.0,794.0
0.001,17,2,192,1,71,0.0,43.0,43.0,1,121,0.0,93.0,93.0
0.037,6,13,3913,7,495,6.0,123.0,123.0,6,3418,7.0,1650.0,1549.0
24.76,6,36,8277,18,1806,508.0,698.0,351.0,18,6471,1448.0,2720.0,478.0
467.057,6,37,12350,20,4037,24580.0,676.0,427.0,17,8313,29188.0,1930.0,825.0
0.006,6,10,1643,5,860,1.0,592.0,592.0,5,783,1.0,515.0,515.0
0.004,6,10,2000,5,927,1.0,659.0,659.0,5,1073,1.0,805.0,805.0
0.006,17,2,194,1,59,0.0,31.0,31.0,1,135,0.0,107.0,107.0
0.081,6,10,1506,5,395,18.0,127.0,127.0,5,1111,18.0,843.0,843.0
0.006,6,10,1547,5,764,1.0,496.0,496.0,5,783,1.0,515.0,515.0
0.006,6,10,1854,5,889,1.0,621.0,621.0,5,965,1.0,697.0,697.0
0.008,6,10,2007,5,928,2.0,660.0,660.0,5,1079,2.0,811.0,811.0
309.559,17,20,1124,10,716,34381.0,48.0,43.0,10,408,34381.0,20.0,12.0
0.041,17,2,170,1,65,0.0,37.0,37.0,1,105,0.0,77.0,77.0
0.005,6,10,2006,5,927,1.0,659.0,659.0,5,1079,1.0,811.0,811.0
0.01,6,10,1989,5,910,2.0,642.0,642.0,5,1079,2.0,811.0,811.0
0.006,6,10,1689,5,839,1.0,571.0,571.0,5,850,1.0,582.0,582.0
0.004,6,10,2006,5,927,1.0,659.0,659.0,5,1079,1.0,811.0,811.0
0.001,17,2,154,1,69,0.0,41.0,41.0,1,85,0.0,57.0,57.0
0.007,6,10,1677,5,827,1.0,559.0,559.0,5,850,1.0,582.0,582.0
0.017,17,2,198,1,91,0.0,63.0,63.0,1,107,0.0,79.0,79.0
0.008,6,10,1547,5,764,2.0,496.0,496.0,5,783,1.0,515.0,515.0
0.078,6,10,1506,5,395,18.0,127.0,127.0,5,1111,15.0,843.0,843.0
40.064,17,10,676,5,460,10014.0,104.0,64.0,5,216,10015.0,20.0,15.0
0.02,6,10,1631,5,848,4.0,580.0,580.0,5,783,4.0,515.0,515.0
0.005,17,2,136,1,60,0.0,32.0,32.0,1,76,0.0,48.0,48.0
352.246,6,20,2210,6,1308,12004.0,494.0,494.0,14,902,27095.0,83.0,83.0
0.005,6,10,2006,5,927,1.0,659.0,659.0,5,1079,1.0,811.0,811.0
0.103,6,10,1506,5,395,24.0,127.0,127.0,5,1111,21.0,843.0,843.0
0.078,6,10,1506,5,395,17.0,127.0,127.0,5,1111,15.0,843.0,843.0
0.005,6,10,1989,5,927,1.0,659.0,659.0,5,1062,1.0,794.0,794.0
0.733,6,22,5072,11,1250,63.0,325.0,133.0,11,3822,62.0,1414.0,563.0
40.061,17,10,676,5,460,10013.0,104.0,64.0,5,216,10014.0,20.0,15.0
240.014,6,9,787,5,488,60003.0,232.0,232.0,4,299,80003.0,83.0,83.0
308.42,17,20,1124,10,716,34258.0,48.0,43.0,10,408,34257.0,20.0,12.0
40.056,17,10,676,5,460,10012.0,104.0,64.0,5,216,10013.0,20.0,15.0
0.004,17,2,148,1,60,0.0,32.0,32.0,1,88,0.0,60.0,60.0
1.14,6,32,13391,18,5892,67.0,2720.0,854.0,14,7499,74.0,2720.0,769.0
240.121,6,31,9302,15,6745,17151.0,1868.0,663.0,16,2557,16007.0,580.0,214.0
0.025,6,10,1990,5,911,6.0,643.0,643.0,5,1079,6.0,811.0,811.0
240.103,6,31,9087,15,6730,17150.0,1854.0,661.0,16,2357,16006.0,580.0,189.0
0.019,6,10,1990,5,911,4.0,643.0,643.0,5,1079,4.0,811.0,811.0
0.009,6,12,1926,6,1189,1.0,659.0,434.0,6,737,1.0,417.0,417.0
0.016,6,10,1989,5,910,4.0,642.0,642.0,5,1079,3.0,811.0,811.0
0.149,17,4,596,2,122,144.0,33.0,33.0,2,474,109.0,323.0,209.0
0.007,6,10,1989,5,910,1.0,642.0,642.0,5,1079,1.0,811.0,811.0
0.163,17,2,152,1,76,0.0,48.0,48.0,1,76,0.0,48.0,48.0
0.003,17,4,284,2,120,0.0,32.0,32.0,2,164,0.0,60.0,54.0
0.008,17,2,148,1,60,0.0,32.0,32.0,1,88,0.0,60.0,60.0
0.207,6,16,2671,8,1397,29.0,533.0,324.0,8,1274,18.0,529.0,212.0
40.069,17,10,676,5,460,10015.0,104.0,64.0,5,216,10016.0,20.0,15.0
0.039,6,10,1972,5,910,9.0,642.0,642.0,5,1062,9.0,794.0,794.0
15.071,17,15,9238,8,6902,2149.0,1350.0,834.0,7,2336,2507.0,1350.0,305.0
0.015,6,10,1990,5,911,3.0,643.0,643.0,5,1079,3.0,811.0,811.0
0.005,6,10,1689,5,839,1.0,571.0,571.0,5,850,1.0,582.0,582.0
240.087,6,31,9398,15,7003,17149.0,2128.0,691.0,16,2395,16005.0,580.0,194.0
0.104,6,10,1506,5,395,25.0,127.0,127.0,5,1111,23.0,843.0,843.0
0.04,17,2,234,1,61,0.0,33.0,33.0,1,173,0.0,145.0,145.0
0.001,17,2,166,1,75,0.0,47.0,47.0,1,91,0.0,63.0,63.0
0.006,6,10,1547,5,764,1.0,496.0,496.0,5,783,1.0,515.0,515.0
0.0,17,2,166,1,75,0.0,47.0,47.0,1,91,0.0,63.0,63.0
40.066,17,10,676,5,460,10015.0,104.0,64.0,5,216,10015.0,20.0,15.0
0.016,6,10,1989,5,910,4.0,642.0,642.0,5,1079,3.0,811.0,811.0
0.01,6,10,1972,5,910,2.0,642.0,642.0,5,1062,2.0,794.0,794.0
0.208,6,16,2777,8,1395,29.0,533.0,323.0,8,1382,18.0,529.0,239.0
0.01,6,10,1990,5,911,2.0,643.0,643.0,5,1079,2.0,811.0,811.0
164.623,17,72,10469,36,2403,4703.0,44.0,38.0,36,8066,4703.0,260.0,196.0
0.001,17,2,180,1,66,0.0,38.0,38.0,1,114,0.0,86.0,86.0
0.129,6,10,1506,5,395,23.0,127.0,127.0,5,1111,28.0,843.0,843.0
0.005,6,10,2006,5,927,1.0,659.0,659.0,5,1079,1.0,811.0,811.0
0.001,17,2,180,1,66,0.0,38.0,38.0,1,114,0.0,86.0,86.0
240.099,6,16,4481,9,963,30012.0,238.0,166.0,7,3518,40016.0,1402.0,786.0
0.091,6,10,1506,5,395,22.0,127.0,127.0,5,1111,20.0,843.0,843.0
0.08,6,10,1506,5,395,17.0,127.0,127.0,5,1111,17.0,843.0,843.0
0.006,6,10,1547,5,764,1.0,496.0,496.0,5,783,1.0,515.0,515.0
0.005,6,10,1689,5,839,1.0,571.0,571.0,5,850,1.0,582.0,582.0
240.092,6,32,9434,16,7181,16006.0,2252.0,635.0,16,2253,16005.0,580.0,176.0
0.004,6,10,2000,5,927,1.0,659.0,659.0,5,1073,1.0,805.0,805.0
0.005,6,10,1989,5,927,1.0,659.0,659.0,5,1062,1.0,794.0,794.0
0.005,17,2,230,1,68,0.0,40.0,40.0,1,162,0.0,134.0,134.0
0.018,6,10,1989,5,910,4.0,642.0,642.0,5,1079,4.0,811.0,811.0
40.069,17,10,676,5,460,10016.0,104.0,64.0,5,216,10016.0,20.0,15.0
0.004,6,10,2000,5,927,1.0,659.0,659.0,5,1073,1.0,805.0,805.0
0.041,17,2,152,1,76,0.0,48.0,48.0,1,76,0.0,48.0,48.0
0.006,6,10,2006,5,927,1.0,659.0,659.0,5,1079,1.0,811.0,811.0
0.005,6,10,2007,5,928,1.0,660.0,660.0,5,1079,1.0,811.0,811.0
0.005,17,2,164,1,74,0.0,46.0,46.0,1,90,0.0,62.0,62.0
0.005,6,10,1643,5,860,1.0,592.0,592.0,5,783,1.0,515.0,515.0
0.093,6,10,1506,5,395,21.0,127.0,127.0,5,1111,20.0,843.0,843.0
0.098,6,10,1506,5,395,22.0,127.0,127.0,5,1111,20.0,843.0,843.0
0.119,6,10,1506,5,395,29.0,127.0,127.0,5,1111,26.0,843.0,843.0
0.005,6,10,2006,5,927,1.0,659.0,659.0,5,1079,1.0,811.0,811.0
0.006,17,2,180,1,66,0.0,38.0,38.0,1,114,0.0,86.0,86.0
40.055,17,10,676,5,460,10012.0,104.0,64.0,5,216,10011.0,20.0,15.0
0.006,17,2,169,1,62,0.0,34.0,34.0,1,107,0.0,79.0,79.0
301.127,6,48,19497,25,13779,12546.0,2720.0,1274.0,23,5718,406.0,1360.0,398.0
0.005,6,10,2006,5,927,1.0,659.0,659.0,5,1079,1.0,811.0,811.0
0.005,6,14,3736,7,446,0.0,74.0,74.0,7,3290,0.0,1448.0,972.0
240.015,6,9,787,5,488,60003.0,232.0,232.0,4,299,80003.0,83.0,83.0
308.438,17,20,1124,10,716,34256.0,48.0,43.0,10,408,34256.0,20.0,12.0
0.011,6,10,1762,5,911,2.0,643.0,643.0,5,851,2.0,583.0,583.0
0.22,6,16,2669,8,1395,31.0,533.0,323.0,8,1274,20.0,529.0,212.0
0.156,6,10,1506,5,395,37.0,127.0,127.0,5,1111,29.0,843.0,843.0
240.097,6,31,9088,16,6604,16006.0,1677.0,641.0,15,2484,17149.0,580.0,212.0
313.664,17,20,1124,10,716,34839.0,48.0,43.0,10,408,34838.0,20.0,12.0
0.014,6,14,3787,7,497,2.0,125.0,125.0,7,3290,2.0,1448.0,972.0
40.071,17,10,676,5,460,10016.0,104.0,64.0,5,216,10016.0,20.0,15.0
0.005,17,2,136,1,60,0.0,32.0,32.0,1,76,0.0,48.0,48.0
0.015,6,10,1989,5,910,3.0,642.0,642.0,5,1079,3.0,811.0,811.0
0.005,6,10,1989,5,927,1.0,659.0,659.0,5,1062,1.0,794.0,794.0
0.001,17,2,180,1,66,0.0,38.0,38.0,1,114,0.0,86.0,86.0
0.01,6,10,1762,5,911,2.0,643.0,643.0,5,851,2.0,583.0,583.0
0.17,6,3,453,2,321,170.0,241.0,241.0,1,132,0.0,92.0,92.0
0.003,17,2,136,1,60,0.0,32.0,32.0,1,76,0.0,48.0,48.0
0.012,6,10,1983,5,910,3.0,642.0,642.0,5,1073,2.0,805.0,805.0
40.071,17,10,676,5,460,10014.0,104.0,64.0,5,216,10016.0,20.0,15.0
0.006,6,10,1854,5,889,1.0,621.0,621.0,5,965,1.0,697.0,697.0
0.074,6,10,1506,5,395,17.0,127.0,127.0,5,1111,16.0,843.0,843.0
0.008,6,10,1989,5,910,2.0,642.0,642.0,5,1079,1.0,811.0,811.0
0.001,17,2,180,1,66,0.0,38.0,38.0,1,114,0.0,86.0,86.0
0.122,17,2,80,1,32,0.0,4.0,4.0,1,48,0.0,20.0,20.0
0.063,6,10,1506,5,395,14.0,127.0,127.0,5,1111,14.0,843.0,843.0
0.004,17,2,136,1,60,0.0,32.0,32.0,1,76,0.0,48.0,48.0
0.004,17,2,136,1,60,0.0,32.0,32.0,1,76,0.0,48.0,48.0
240.511,6,37,9656,19,2173,13361.0,745.0,235.0,18,7483,14147.0,1402.0,595.0
0.013,6,10,1983,5,910,3.0,642.0,642.0,5,1073,3.0,805.0,805.0
0.088,6,10,1506,5,395,20.0,127.0,127.0,5,1111,20.0,843.0,843.0
366.803,6,22,2313,16,867,24453.0,195.0,195.0,6,1446,4637.0,419.0,398.0
15.077,17,15,8064,8,6024,2149.0,1350.0,725.0,7,2040,2507.0,1350.0,263.0
334.692,17,20,1124,10,716,37173.0,48.0,43.0,10,408,37173.0,20.0,12.0
0.006,6,10,1854,5,889,1.0,621.0,621.0,5,965,1.0,697.0,697.0
0.013,6,10,1990,5,911,3.0,643.0,643.0,5,1079,3.0,811.0,811.0
0.005,17,2,152,1,68,0.0,40.0,40.0,1,84,0.0,56.0,56.0
0.077,6,10,1506,5,395,15.0,127.0,127.0,5,1111,17.0,843.0,843.0
0.006,6,10,1547,5,764,1.0,496.0,496.0,5,783,1.0,515.0,515.0
1772.41,6,101,6062,58,3421,31094.0,27.0,27.0,43,2641,42199.0,27.0,27.0
0.006,6,10,1689,5,839,1.0,571.0,571.0,5,850,1.0,582.0,582.0
240.015,6,9,787,5,488,60003.0,232.0,232.0,4,299,80004.0,83.0,83.0
0.126,17,2,80,1,32,0.0,4.0,4.0,1,48,0.0,20.0,20.0
0.015,6,10,1677,5,827,3.0,559.0,559.0,5,850,3.0,582.0,582.0
40.052,17,10,676,5,460,10011.0,104.0,64.0,5,216,10012.0,20.0,15.0
0.004,6,10,1989,5,927,1.0,659.0,659.0,5,1062,1.0,794.0,794.0
0.009,6,10,1689,5,839,2.0,571.0,571.0,5,850,2.0,582.0,582.0
0.005,6,10,1689,5,839,1.0,571.0,571.0,5,850,1.0,582.0,582.0
0.012,6,13,3735,7,497,2.0,125.0,125.0,6,3238,2.0,1470.0,1459.0
0.165,17,2,152,1,76,0.0,48.0,48.0,1,76,0.0,48.0,48.0
0.005,6,10,2000,5,927,1.0,659.0,659.0,5,1073,1.0,805.0,805.0
0.019,6,10,1983,5,910,4.0,642.0,642.0,5,1073,4.0,805.0,805.0
40.055,17,10,676,5,460,10013.0,104.0,64.0,5,216,10012.0,20.0,15.0
0.042,17,2,184,1,61,0.0,33.0,33.0,1,123,0.0,95.0,95.0
0.09,6,10,1506,5,395,17.0,127.0,127.0,5,1111,20.0,843.0,843.0
0.009,6,10,1972,5,910,2.0,642.0,642.0,5,1062,2.0,794.0,794.0
639.055,6,37,13700,20,3361,33634.0,661.0,385.0,17,10339,36187.0,1872.0,944.0
0.011,6,10,1990,5,911,2.0,643.0,643.0,5,1079,2.0,811.0,811.0
0.004,17,2,136,1,60,0.0,32.0,32.0,1,76,0.0,48.0,48.0
0.014,6,10,1989,5,910,3.0,642.0,642.0,5,1079,3.0,811.0,811.0
0.005,6,10,1689,5,839,1.0,571.0,571.0,5,850,1.0,582.0,582.0
0.005,6,10,2006,5,927,1.0,659.0,659.0,5,1079,1.0,811.0,811.0
0.131,6,10,1506,5,395,31.0,127.0,127.0,5,1111,32.0,843.0,843.0
0.005,17,2,136,1,60,0.0,32.0,32.0,1,76,0.0,48.0,48.0
0.013,6,10,1631,5,848,3.0,580.0,580.0,5,783,3.0,515.0,515.0
0.045,6,13,3735,7,497,7.0,125.0,125.0,6,3238,9.0,1470.0,1459.0
0.015,6,10,1990,5,911,3.0,643.0,643.0,5,1079,3.0,811.0,811.0
0.098,6,10,1506,5,395,21.0,127.0,127.0,5,1111,18.0,843.0,843.0
0.016,6,10,1983,5,910,3.0,642.0,642.0,5,1073,3.0,805.0,805.0
0.006,6,10,1547,5,764,1.0,496.0,496.0,5,783,1.0,515.0,515.0
0.01,6,10,1762,5,911,2.0,643.0,643.0,5,851,2.0,583.0,583.0
0.008,6,10,1990,5,911,2.0,643.0,643.0,5,1079,2.0,811.0,811.0
174.091,17,88,12865,44,2971,4048.0,44.0,39.0,44,9894,4048.0,260.0,196.0
0.074,6,10,1506,5,395,16.0,127.0,127.0,5,1111,14.0,843.0,843.0
0.004,17,2,170,1,65,0.0,37.0,37.0,1,105,0.0,77.0,77.0
0.04,17,4,364,2,160,1.0,52.0,52.0,2,204,0.0,80.0,74.0
0.008,6,10,1989,5,910,1.0,642.0,642.0,5,1079,2.0,811.0,811.0
0.006,6,13,3747,7,509,0.0,137.0,137.0,6,3238,1.0,1470.0,1459.0
0.019,6,10,1983,5,910,4.0,642.0,642.0,5,1073,4.0,805.0,805.0
0.006,6,10,1547,5,764,1.0,496.0,496.0,5,783,1.0,515.0,515.0
0.004,6,10,1989,5,927,1.0,659.0,659.0,5,1062,1.0,794.0,794.0
21.449,6,37,8242,19,1771,485.0,651.0,322.0,18,6471,1254.0,2720.0,478.0
0.005,6,10,2007,5,928,1.0,660.0,660.0,5,1079,1.0,811.0,811.0
40.057,17,10,676,5,460,10013.0,104.0,64.0,5,216,10013.0,20.0,15.0
0.005,6,10,2006,5,927,1.0,659.0,659.0,5,1079,1.0,811.0,811.0
0.068,17,8,3613,4,1874,22.0,1350.0,440.0,4,1739,11.0,1350.0,406.0
0.013,6,10,1983,5,910,3.0,642.0,642.0,5,1073,3.0,805.0,805.0
0.006,6,10,1643,5,860,1.0,592.0,592.0,5,783,1.0,515.0,515.0
0.006,6,10,1854,5,889,1.0,621.0,621.0,5,965,1.0,697.0,697.0
0.005,6,10,2006,5,927,1.0,659.0,659.0,5,1079,1.0,811.0,811.0
0.005,17,2,154,1,69,0.0,41.0,41.0,1,85,0.0,57.0,57.0
0.005,6,13,3747,7,509,0.0,137.0,137.0,6,3238,1.0,1470.0,1459.0
10.912,17,28,4421,14,1994,831.0,269.0,114.0,14,2427,831.0,586.0,145.0
0.009,6,13,3735,7,497,1.0,125.0,125.0,6,3238,1.0,1470.0,1459.0
0.005,6,10,1989,5,927,1.0,659.0,659.0,5,1062,1.0,794.0,794.0
0.068,17,8,3613,4,1874,22.0,1350.0,440.0,4,1739,11.0,1350.0,406.0
0.077,6,10,1506,5,395,17.0,127.0,127.0,5,1111,17.0,843.0,843.0
0.005,6,10,2007,5,928,1.0,660.0,660.0,5,1079,1.0,811.0,811.0
328.155,17,20,1124,10,716,36447.0,48.0,43.0,10,408,36447.0,20.0,12.0
0.006,6,10,1643,5,860,1.0,592.0,592.0,5,783,1.0,515.0,515.0
0.012,6,10,1972,5,910,3.0,642.0,642.0,5,1062,3.0,794.0,794.0
40.094,17,10,676,5,460,10022.0,104.0,64.0,5,216,10022.0,20.0,15.0
0.064,6,10,1506,5,395,14.0,127.0,127.0,5,1111,14.0,843.0,843.0
9.037,17,6,376,5,280,2259.0,28.0,28.0,1,96,0.0,68.0,68.0
0.004,17,2,136,1,60,0.0,32.0,32.0,1,76,0.0,48.0,48.0
10.8,17,28,4419,14,1995,821.0,270.0,114.0,14,2424,821.0,587.0,145.0
1788.75,6,357,92226,155,70988,11614.0,2790.0,526.0,202,21238,8898.0,1360.0,144.0
0.04,17,2,152,1,76,0.0,48.0,48.0,1,76,0.0,48.0,48.0
0.085,6,10,1506,5,395,15.0,127.0,127.0,5,1111,18.0,843.0,843.0
0.039,17,4,420,2,122,0.0,33.0,33.0,2,298,1.0,145.0,121.0
0.013,6,10,1762,5,911,3.0,643.0,643.0,5,851,3.0,583.0,583.0
0.004,17,2,136,1,60,0.0,32.0,32.0,1,76,0.0,48.0,48.0
311.408,17,20,1124,10,716,34594.0,48.0,43.0,10,408,34594.0,20.0,12.0
0.27,17,38,20133,21,17035,13.0,1350.0,783.0,17,3098,13.0,1350.0,154.0
15.073,17,15,9238,8,6902,2149.0,1350.0,834.0,7,2336,2507.0,1350.0,305.0
0.099,6,10,1506,5,395,23.0,127.0,127.0,5,1111,22.0,843.0,843.0
0.004,6,10,1989,5,927,1.0,659.0,659.0,5,1062,1.0,794.0,794.0
0.013,6,10,1983,5,910,3.0,642.0,642.0,5,1073,3.0,805.0,805.0
0.087,6,10,1506,5,395,19.0,127.0,127.0,5,1111,19.0,843.0,843.0
0.005,6,10,2000,5,927,1.0,659.0,659.0,5,1073,1.0,805.0,805.0
81.053,6,22,9233,11,1575,80.0,794.0,367.0,11,7658,8092.0,1360.0,1029.0
0.008,6,10,1989,5,910,2.0,642.0,642.0,5,1079,1.0,811.0,811.0
0.016,6,10,1989,5,910,3.0,642.0,642.0,5,1079,3.0,811.0,811.0
0.008,6,10,1779,5,928,1.0,660.0,660.0,5,851,2.0,583.0,583.0
0.004,6,10,2006,5,927,1.0,659.0,659.0,5,1079,1.0,811.0,811.0
0.005,6,10,1774,5,923,1.0,655.0,655.0,5,851,1.0,583.0,583.0
0.015,6,13,3735,7,497,2.0,125.0,125.0,6,3238,2.0,1470.0,1459.0
0.006,6,10,1547,5,764,1.0,496.0,496.0,5,783,1.0,515.0,515.0
0.014,6,10,1990,5,911,3.0,643.0,643.0,5,1079,3.0,811.0,811.0
0.077,6,10,1506,5,395,16.0,127.0,127.0,5,1111,17.0,843.0,843.0
0.005,6,10,1854,5,889,1.0,621.0,621.0,5,965,1.0,697.0,697.0
0.02,6,14,3787,7,497,3.0,125.0,125.0,7,3290,3.0,1448.0,972.0
0.08,6,10,1506,5,395,18.0,127.0,127.0,5,1111,15.0,843.0,843.0
0.006,17,2,194,1,59,0.0,31.0,31.0,1,135,0.0,107.0,107.0
0.004,17,2,148,1,60,0.0,32.0,32.0,1,88,0.0,60.0,60.0
11.405,17,27,4365,13,1937,935.0,269.0,121.0,14,2428,864.0,587.0,145.0
0.005,6,10,2000,5,927,1.0,659.0,659.0,5,1073,1.0,805.0,805.0
0.06,17,2,152,1,76,0.0,48.0,48.0,1,76,0.0,48.0,48.0
0.104,6,10,1506,5,395,18.0,127.0,127.0,5,1111,23.0,843.0,843.0
240.086,6,16,4480,9,963,30010.0,238.0,166.0,7,3517,40013.0,1402.0,786.0
40.059,17,10,676,5,460,10013.0,104.0,64.0,5,216,10014.0,20.0,15.0
47.815,6,48,14871,25,8879,380.0,2720.0,1119.0,23,5992,2165.0,2667.0,361.0
0.132,17,2,166,1,75,0.0,47.0,47.0,1,91,0.0,63.0,63.0
0.102,6,10,1506,5,395,22.0,127.0,127.0,5,1111,23.0,843.0,843.0
0.054,17,2,152,1,76,0.0,48.0,48.0,1,76,0.0,48.0,48.0
0.119,6,10,1506,5,395,27.0,127.0,127.0,5,1111,25.0,843.0,843.0
0.135,6,10,1506,5,395,31.0,127.0,127.0,5,1111,29.0,843.0,843.0
0.005,6,10,2007,5,928,1.0,660.0,660.0,5,1079,1.0,811.0,811.0
169.263,17,82,11682,41,2741,4231.0,44.0,38.0,41,8941,4231.0,261.0,190.0
0.016,6,10,1983,5,910,3.0,642.0,642.0,5,1073,3.0,805.0,805.0
11.925,17,34,6374,17,2658,735.0,270.0,128.0,17,3716,735.0,1146.0,190.0
0.006,6,10,2000,5,927,1.0,659.0,659.0,5,1073,1.0,805.0,805.0
0.142,6,10,1506,5,395,31.0,127.0,127.0,5,1111,32.0,843.0,843.0
0.005,17,2,214,1,75,0.0,47.0,47.0,1,139,0.0,111.0,111.0
174.191,17,82,11896,41,2743,4354.0,44.0,38.0,41,9153,4354.0,279.0,195.0
15.076,17,16,8736,8,6534,2149.0,1350.0,788.0,8,2202,2149.0,1350.0,247.0
240.109,6,31,9282,15,6883,17150.0,2008.0,678.0,16,2399,16007.0,580.0,194.0
0.006,17,2,170,1,65,0.0,37.0,37.0,1,105,0.0,77.0,77.0
0.066,6,10,1506,5,395,14.0,127.0,127.0,5,1111,14.0,843.0,843.0
0.007,6,10,1547,5,764,1.0,496.0,496.0,5,783,1.0,515.0,515.0
0.013,6,10,1677,5,827,3.0,559.0,559.0,5,850,3.0,582.0,582.0
0.087,6,10,1506,5,395,18.0,127.0,127.0,5,1111,20.0,843.0,843.0
0.013,6,10,1972,5,910,3.0,642.0,642.0,5,1062,3.0,794.0,794.0
40.08,17,10,676,5,460,10018.0,104.0,64.0,5,216,10018.0,20.0,15.0
0.496,17,58,35241,32,28593,16.0,1350.0,865.0,26,6648,15.0,1350.0,227.0
0.004,6,10,2007,5,928,1.0,660.0,660.0,5,1079,1.0,811.0,811.0
0.008,6,10,1989,5,910,1.0,642.0,642.0,5,1079,2.0,811.0,811.0
0.154,6,10,1506,5,395,37.0,127.0,127.0,5,1111,35.0,843.0,843.0
300.397,6,16,2170,9,684,37528.0,146.0,146.0,7,1486,50037.0,419.0,398.0
0.005,17,2,170,1,65,0.0,37.0,37.0,1,105,0.0,77.0,77.0
40.074,17,10,676,5,460,10015.0,104.0,64.0,5,216,10017.0,20.0,15.0
0.01,6,10,1983,5,910,2.0,642.0,642.0,5,1073,2.0,805.0,805.0
0.003,17,2,152,1,76,0.0,48.0,48.0,1,76,0.0,48.0,48.0
0.001,17,2,179,1,62,0.0,34.0,34.0,1,117,0.0,89.0,89.0
0.103,6,10,1506,5,395,22.0,127.0,127.0,5,1111,20.0,843.0,843.0
1786.006,6,154,19574,92,13852,19626.0,302.0,302.0,62,5722,29278.0,83.0,83.0
0.004,6,10,2006,5,927,1.0,659.0,659.0,5,1079,1.0,811.0,811.0
15.069,17,15,9238,8,6902,2148.0,1350.0,834.0,7,2336,2506.0,1350.0,305.0
0.071,17,2,182,1,65,0.0,37.0,37.0,1,117,0.0,89.0,89.0
0.006,6,10,1689,5,839,1.0,571.0,571.0,5,850,1.0,582.0,582.0
0.091,6,10,1506,5,395,20.0,127.0,127.0,5,1111,21.0,843.0,843.0
0.006,6,10,1643,5,860,1.0,592.0,592.0,5,783,1.0,515.0,515.0
0.006,6,10,2000,5,927,1.0,659.0,659.0,5,1073,1.0,805.0,805.0
0.012,6,10,1989,5,910,3.0,642.0,642.0,5,1079,3.0,811.0,811.0
0.005,6,10,2006,5,927,1.0,659.0,659.0,5,1079,1.0,811.0,811.0
0.028,6,10,1972,5,910,7.0,642.0,642.0,5,1062,7.0,794.0,794.0
0.005,6,10,2000,5,927,1.0,659.0,659.0,5,1073,1.0,805.0,805.0
0.039,17,4,284,2,120,0.0,32.0,32.0,2,164,35.0,60.0,54.0
0.005,17,2,144,1,64,0.0,36.0,36.0,1,80,0.0,52.0,52.0
0.005,6,10,1779,5,928,1.0,660.0,660.0,5,851,1.0,583.0,583.0
0.005,17,2,193,1,71,0.0,43.0,43.0,1,122,0.0,94.0,94.0
0.006,17,2,179,1,71,0.0,43.0,43.0,1,108,0.0,80.0,80.0
0.005,17,2,136,1,60,0.0,32.0,32.0,1,76,0.0,48.0,48.0
0.005,6,10,1854,5,889,1.0,621.0,621.0,5,965,1.0,697.0,697.0
0.005,6,14,3742,7,452,0.0,80.0,80.0,7,3290,0.0,1448.0,972.0
330.127,17,20,1124,10,716,36666.0,48.0,43.0,10,408,36666.0,20.0,12.0
0.075,6,10,1506,5,395,14.0,127.0,127.0,5,1111,18.0,843.0,843.0
0.009,6,10,1989,5,910,2.0,642.0,642.0,5,1079,2.0,811.0,811.0
11.183,17,28,4419,14,1995,847.0,270.0,114.0,14,2424,847.0,587.0,145.0
0.052,17,2,152,1,76,0.0,48.0,48.0,1,76,0.0,48.0,48.0
0.001,17,2,192,1,71,0.0,43.0,43.0,1,121,0.0,93.0,93.0
0.001,17,2,180,1,66,0.0,38.0,38.0,1,114,0.0,86.0,86.0
0.004,6,10,1989,5,927,1.0,659.0,659.0,5,1062,1.0,794.0,794.0
0.004,17,2,148,1,60,0.0,32.0,32.0,1,88,0.0,60.0,60.0
0.006,17,2,293,1,73,0.0,45.0,45.0,1,220,0.0,192.0,192.0
0.186,17,4,596,2,122,146.0,33.0,33.0,2,474,145.0,323.0,209.0
0.044,6,10,1989,5,910,11.0,642.0,642.0,5,1079,10.0,811.0,811.0
0.119,6,10,1506,5,395,23.0,127.0,127.0,5,1111,25.0,843.0,843.0
0.018,6,10,1989,5,910,4.0,642.0,642.0,5,1079,4.0,811.0,811.0
0.001,17,2,180,1,66,0.0,38.0,38.0,1,114,0.0,86.0,86.0
0.005,6,10,2006,5,927,1.0,659.0,659.0,5,1079,1.0,811.0,811.0
0.013,6,10,1990,5,911,3.0,643.0,643.0,5,1079,3.0,811.0,811.0
0.005,6,10,1989,5,927,1.0,659.0,659.0,5,1062,1.0,794.0,794.0
0.011,6,10,1990,5,911,2.0,643.0,643.0,5,1079,2.0,811.0,811.0
0.005,17,4,284,2,120,0.0,32.0,32.0,2,164,1.0,60.0,54.0
0.005,6,10,1689,5,839,1.0,571.0,571.0,5,850,1.0,582.0,582.0
0.258,17,17,9326,8,6864,36.0,1350.0,830.0,9,2462,21.0,1350.0,245.0
0.012,6,10,1983,5,910,3.0,642.0,642.0,5,1073,3.0,805.0,805.0
308.776,17,20,1124,10,716,34294.0,48.0,43.0,10,408,34294.0,20.0,12.0
0.075,6,10,1506,5,395,16.0,127.0,127.0,5,1111,15.0,843.0,843.0
0.099,6,10,1506,5,395,22.0,127.0,127.0,5,1111,17.0,843.0,843.0
0.114,6,10,1506,5,395,26.0,127.0,127.0,5,1111,23.0,843.0,843.0
0.004,17,2,148,1,60,0.0,32.0,32.0,1,88,0.0,60.0,60.0
0.001,17,2,166,1,75,0.0,47.0,47.0,1,91,0.0,63.0,63.0
15.36,17,17,9682,8,4149,2189.0,1350.0,490.0,9,5533,1915.0,1350.0,586.0
0.097,6,10,1506,5,395,21.0,127.0,127.0,5,1111,21.0,843.0,843.0
0.015,6,10,1983,5,910,3.0,642.0,642.0,5,1073,3.0,805.0,805.0
0.013,6,10,1631,5,848,3.0,580.0,580.0,5,783,3.0,515.0,515.0
40.068,17,10,676,5,460,10016.0,104.0,64.0,5,216,10016.0,20.0,15.0
0.005,6,10,2007,5,928,1.0,660.0,660.0,5,1079,1.0,811.0,811.0
0.006,17,2,166,1,75,0.0,47.0,47.0,1,91,0.0,63.0,63.0
0.004,6,10,1702,5,863,0.0,595.0,595.0,5,839,1.0,571.0,571.0
0.01,6,10,1972,5,910,2.0,642.0,642.0,5,1062,2.0,794.0,794.0
167.065,17,68,9825,34,2267,5062.0,44.0,38.0,34,7558,5062.0,261.0,194.0
40.073,17,10,676,5,460,10017.0,104.0,64.0,5,216,10017.0,20.0,15.0
0.003,17,4,284,2,120,0.0,32.0,32.0,2,164,0.0,60.0,54.0
0.081,6,10,1506,5,395,18.0,127.0,127.0,5,1111,16.0,843.0,843.0
0.208,17,15,8649,8,6227,29.0,1350.0,750.0,7,2422,22.0,1350.0,318.0
240.231,6,36,10194,18,1887,14130.0,559.0,188.0,18,8307,14130.0,1402.0,614.0
0.015,6,10,1989,5,910,3.0,642.0,642.0,5,1079,3.0,811.0,811.0
0.005,6,10,2007,5,928,1.0,660.0,660.0,5,1079,1.0,811.0,811.0
0.023,6,10,1762,5,911,5.0,643.0,643.0,5,851,5.0,583.0,583.0
0.003,17,4,284,2,120,0.0,32.0,32.0,2,164,0.0,60.0,54.0
240.776,6,22,8910,11,1717,24077.0,568.0,383.0,11,7193,24077.0,2369.0,1102.0
0.076,6,10,1506,5,395,16.0,127.0,127.0,5,1111,17.0,843.0,843.0
0.004,17,2,170,1,65,0.0,37.0,37.0,1,105,0.0,77.0,77.0
1.222,6,13,1678,7,507,201.0,127.0,127.0,6,1171,19.0,843.0,843.0
0.092,6,10,1506,5,395,19.0,127.0,127.0,5,1111,19.0,843.0,843.0
0.014,6,10,1989,5,910,3.0,642.0,642.0,5,1079,3.0,811.0,811.0
0.008,6,10,1972,5,910,2.0,642.0,642.0,5,1062,2.0,794.0,794.0
0.143,6,10,1506,5,395,33.0,127.0,127.0,5,1111,31.0,843.0,843.0
0.028,6,10,1631,5,848,7.0,580.0,580.0,5,783,6.0,515.0,515.0
0.097,6,10,1506,5,395,19.0,127.0,127.0,5,1111,23.0,843.0,843.0
0.003,6,10,1702,5,863,0.0,595.0,595.0,5,839,0.0,571.0,571.0
0.004,6,10,2007,5,928,1.0,660.0,660.0,5,1079,1.0,811.0,811.0
0.002,17,2,185,1,73,0.0,45.0,45.0,1,112,0.0,84.0,84.0
11.185,17,28,4424,14,1995,847.0,270.0,114.0,14,2429,847.0,588.0,145.0
0.013,6,10,1983,5,910,3.0,642.0,642.0,5,1073,3.0,805.0,805.0
0.105,6,10,1506,5,395,19.0,127.0,127.0,5,1111,21.0,843.0,843.0
0.013,6,10,1990,5,911,3.0,643.0,643.0,5,1079,3.0,811.0,811.0
309.519,17,20,1124,10,716,34376.0,48.0,43.0,10,408,34376.0,20.0,12.0
946.393,6,58,19715,30,6392,32634.0,676.0,482.0,28,13323,32828.0,1402.0,697.0
0.006,6,10,1989,5,927,1.0,659.0,659.0,5,1062,1.0,794.0,794.0
0.143,17,2,152,1,76,0.0,48.0,48.0,1,76,0.0,48.0,48.0
0.005,6,10,1854,5,889,1.0,621.0,621.0,5,965,1.0,697.0,697.0
0.068,6,10,1506,5,395,14.0,127.0,127.0,5,1111,16.0,843.0,843.0
0.013,6,10,1762,5,911,3.0,643.0,643.0,5,851,3.0,583.0,583.0
0.006,6,10,1989,5,927,1.0,659.0,659.0,5,1062,1.0,794.0,794.0
0.007,6,10,1990,5,911,1.0,643.0,643.0,5,1079,1.0,811.0,811.0
0.013,6,10,1990,5,911,3.0,643.0,643.0,5,1079,3.0,811.0,811.0
0.116,6,10,1506,5,395,26.0,127.0,127.0,5,1111,26.0,843.0,843.0
0.038,17,2,234,1,61,0.0,33.0,33.0,1,173,0.0,145.0,145.0
0.016,6,10,1989,5,910,3.0,642.0,642.0,5,1079,4.0,811.0,811.0
0.008,6,10,1972,5,910,2.0,642.0,642.0,5,1062,2.0,794.0,794.0
0.008,17,2,179,1,71,0.0,43.0,43.0,1,108,0.0,80.0,80.0
0.036,17,2,148,1,60,0.0,32.0,32.0,1,88,0.0,60.0,60.0
0.084,6,10,1506,5,395,18.0,127.0,127.0,5,1111,18.0,843.0,843.0
0.001,17,2,180,1,66,0.0,38.0,38.0,1,114,0.0,86.0,86.0
0.005,6,10,2007,5,928,1.0,660.0,660.0,5,1079,1.0,811.0,811.0
0.003,17,4,284,2,120,0.0,32.0,32.0,2,164,0.0,60.0,54.0
0.004,6,10,1989,5,927,1.0,659.0,659.0,5,1062,1.0,794.0,794.0
0.0,17,2,140,1,62,0.0,34.0,34.0,1,78,0.0,50.0,50.0
0.169,6,10,1506,5,395,40.0,127.0,127.0,5,1111,31.0,843.0,843.0
0.041,17,2,152,1,76,0.0,48.0,48.0,1,76,0.0,48.0,48.0
0.005,6,10,1989,5,927,1.0,659.0,659.0,5,1062,1.0,794.0,794.0
0.009,6,12,1926,6,1189,1.0,659.0,434.0,6,737,1.0,417.0,417.0
10.919,17,28,4421,14,1993,831.0,268.0,114.0,14,2428,831.0,587.0,145.0
0.008,6,10,1989,5,910,2.0,642.0,642.0,5,1079,2.0,811.0,811.0
310.941,17,20,1124,10,716,34534.0,48.0,43.0,10,408,34534.0,20.0,12.0
0.126,6,10,1506,5,395,26.0,127.0,127.0,5,1111,27.0,843.0,843.0
0.057,17,2,179,1,71,0.0,43.0,43.0,1,108,0.0,80.0,80.0
0.017,6,10,1677,5,827,4.0,559.0,559.0,5,850,4.0,582.0,582.0
0.004,17,2,148,1,60,0.0,32.0,32.0,1,88,0.0,60.0,60.0
0.015,6,10,1631,5,848,3.0,580.0,580.0,5,783,3.0,515.0,515.0
0.005,6,10,1689,5,839,1.0,571.0,571.0,5,850,1.0,582.0,582.0
0.244,17,38,20199,22,17091,11.0,1350.0,748.0,16,3108,11.0,1350.0,166.0
0.07,17,8,3613,4,1874,23.0,1350.0,440.0,4,1739,12.0,1350.0,406.0
0.068,6,10,1506,5,395,15.0,127.0,127.0,5,1111,13.0,843.0,843.0
0.144,6,10,1506,5,395,32.0,127.0,127.0,5,1111,32.0,843.0,843.0
0.005,6,10,2000,5,927,1.0,659.0,659.0,5,1073,1.0,805.0,805.0
0.018,6,10,1983,5,910,4.0,642.0,642.0,5,1073,4.0,805.0,805.0
0.012,6,10,2006,5,927,2.0,659.0,659.0,5,1079,2.0,811.0,811.0
0.005,17,2,179,1,71,0.0,43.0,43.0,1,108,0.0,80.0,80.0
0.006,6,10,1547,5,764,1.0,496.0,496.0,5,783,1.0,515.0,515.0
0.004,6,10,1702,5,863,1.0,595.0,595.0,5,839,0.0,571.0,571.0
0.006,6,10,1547,5,764,1.0,496.0,496.0,5,783,1.0,515.0,515.0
0.096,6,10,1506,5,395,21.0,127.0,127.0,5,1111,19.0,843.0,843.0
40.1,17,10,676,5,460,10019.0,104.0,64.0,5,216,10021.0,20.0,15.0
0.178,6,12,2996,7,549,29.0,177.0,177.0,5,2447,43.0,1402.0,1089.0
0.095,6,10,1506,5,395,21.0,127.0,127.0,5,1111,17.0,843.0,843.0
0.039,17,2,166,1,75,0.0,47.0,47.0,1,91,0.0,63.0,63.0
0.005,6,10,1989,5,927,1.0,659.0,659.0,5,1062,1.0,794.0,794.0
0.008,17,4,284,2,120,0.0,32.0,32.0,2,164,0.0,60.0,54.0
172.743,17,80,11300,40,2656,4428.0,44.0,38.0,40,8644,4428.0,239.0,188.0
0.005,6,10,2000,5,927,1.0,659.0,659.0,5,1073,1.0,805.0,805.0
0.103,6,10,1506,5,395,23.0,127.0,127.0,5,1111,21.0,843.0,843.0
0.01,6,10,1631,5,848,2.0,580.0,580.0,5,783,2.0,515.0,515.0
0.014,6,10,1983,5,910,3.0,642.0,642.0,5,1073,3.0,805.0,805.0
0.018,6,10,1989,5,910,4.0,642.0,642.0,5,1079,4.0,811.0,811.0
0.005,6,10,1989,5,927,1.0,659.0,659.0,5,1062,1.0,794.0,794.0
0.011,6,10,1989,5,910,2.0,642.0,642.0,5,1079,2.0,811.0,811.0
0.066,6,10,1506,5,395,15.0,127.0,127.0,5,1111,13.0,843.0,843.0
0.049,6,10,1506,5,395,11.0,127.0,127.0,5,1111,11.0,843.0,843.0
0.067,17,8,3613,4,1874,22.0,1350.0,440.0,4,1739,10.0,1350.0,406.0
0.005,6,10,2007,5,928,1.0,660.0,660.0,5,1079,1.0,811.0,811.0
0.005,6,14,3799,7,509,0.0,137.0,137.0,7,3290,0.0,1448.0,972.0
0.006,6,10,1547,5,764,1.0,496.0,496.0,5,783,1.0,515.0,515.0
0.038,17,4,284,2,120,0.0,32.0,32.0,2,164,35.0,60.0,54.0
0.014,6,10,1983,5,910,3.0,642.0,642.0,5,1073,3.0,805.0,805.0
0.009,6,10,1990,5,911,2.0,643.0,643.0,5,1079,2.0,811.0,811.0
0.039,17,2,148,1,60,0.0,32.0,32.0,1,88,0.0,60.0,60.0
0.006,17,2,222,1,65,0.0,37.0,37.0,1,157,0.0,129.0,129.0
310.184,17,20,1124,10,716,34455.0,48.0,43.0,10,408,34458.0,20.0,12.0
0.069,6,10,1506,5,395,14.0,127.0,127.0,5,1111,15.0,843.0,843.0
0.014,6,10,1990,5,911,3.0,643.0,643.0,5,1079,3.0,811.0,811.0
0.01,17,2,170,1,65,0.0,37.0,37.0,1,105,0.0,77.0,77.0
0.016,6,10,1989,5,910,4.0,642.0,642.0,5,1079,3.0,811.0,811.0
0.012,6,10,1989,5,910,3.0,642.0,642.0,5,1079,2.0,811.0,811.0
0.111,6,10,1506,5,395,24.0,127.0,127.0,5,1111,23.0,843.0,843.0
0.005,17,2,170,1,65,0.0,37.0,37.0,1,105,0.0,77.0,77.0
0.009,6,10,1990,5,911,2.0,643.0,643.0,5,1079,2.0,811.0,811.0
0.009,6,10,1990,5,911,2.0,643.0,643.0,5,1079,2.0,811.0,811.0
0.005,17,2,166,1,75,0.0,47.0,47.0,1,91,0.0,63.0,63.0
0.004,6,10,2007,5,928,1.0,660.0,660.0,5,1079,1.0,811.0,811.0
0.074,6,10,1506,5,395,15.0,127.0,127.0,5,1111,16.0,843.0,843.0
0.095,6,10,1506,5,395,21.0,127.0,127.0,5,1111,22.0,843.0,843.0
0.118,6,14,4390,8,923,16.0,238.0,166.0,6,3467,15.0,1402.0,786.0
294.438,6,402,347959,192,21548,1541.0,2736.0,888.0,210,326411,1408.0,2804.0,1609.0
0.004,6,10,2000,5,927,1.0,659.0,659.0,5,1073,1.0,805.0,805.0
0.009,6,10,1989,5,910,2.0,642.0,642.0,5,1079,2.0,811.0,811.0
0.004,17,2,136,1,60,0.0,32.0,32.0,1,76,0.0,48.0,48.0
0.011,6,10,1762,5,911,2.0,643.0,643.0,5,851,2.0,583.0,583.0
0.004,6,10,2006,5,927,1.0,659.0,659.0,5,1079,1.0,811.0,811.0
0.142,17,2,80,1,32,0.0,4.0,4.0,1,48,0.0,20.0,20.0
0.004,6,10,1989,5,927,1.0,659.0,659.0,5,1062,1.0,794.0,794.0
0.005,6,13,3690,7,452,0.0,80.0,80.0,6,3238,0.0,1470.0,1459.0
0.005,6,10,1779,5,928,1.0,660.0,660.0,5,851,1.0,583.0,583.0
0.016,17,2,198,1,91,0.0,63.0,63.0,1,107,0.0,79.0,79.0
0.099,6,10,1506,5,395,22.0,127.0,127.0,5,1111,18.0,843.0,843.0
0.008,6,10,1972,5,910,2.0,642.0,642.0,5,1062,2.0,794.0,794.0
0.005,17,2,170,1,65,0.0,37.0,37.0,1,105,0.0,77.0,77.0
0.005,6,10,1989,5,927,1.0,659.0,659.0,5,1062,1.0,794.0,794.0
0.006,6,10,1547,5,764,1.0,496.0,496.0,5,783,1.0,515.0,515.0
1752.224,6,64,7344,42,4469,42737.0,1625.0,108.0,22,2875,83431.0,1111.0,82.0
0.015,6,10,1972,5,910,3.0,642.0,642.0,5,1062,3.0,794.0,794.0
0.006,6,10,1547,5,764,1.0,496.0,496.0,5,783,1.0,515.0,515.0
0.105,6,10,1506,5,395,21.0,127.0,127.0,5,1111,24.0,843.0,843.0
0.005,6,10,1643,5,860,1.0,592.0,592.0,5,783,1.0,515.0,515.0
308.985,17,20,1124,10,716,34317.0,48.0,43.0,10,408,34317.0,20.0,12.0
0.005,6,10,2006,5,927,1.0,659.0,659.0,5,1079,1.0,811.0,811.0
0.005,6,10,2006,5,927,1.0,659.0,659.0,5,1079,1.0,811.0,811.0
178.115,17,82,12127,41,2761,4452.0,44.0,39.0,41,9366,4452.0,261.0,200.0
0.004,6,10,2006,5,927,1.0,659.0,659.0,5,1079,1.0,811.0,811.0
0.014,6,10,1972,5,910,3.0,642.0,642.0,5,1062,3.0,794.0,794.0
0.008,6,10,1990,5,911,2.0,643.0,643.0,5,1079,1.0,811.0,811.0
0.014,6,10,1677,5,827,3.0,559.0,559.0,5,850,3.0,582.0,582.0
0.059,17,2,152,1,76,0.0,48.0,48.0,1,76,0.0,48.0,48.0
0.005,17,2,136,1,60,0.0,32.0,32.0,1,76,0.0,48.0,48.0
0.049,17,2,182,1,65,0.0,37.0,37.0,1,117,0.0,89.0,89.0
0.012,6,10,1990,5,911,3.0,643.0,643.0,5,1079,2.0,811.0,811.0
0.004,17,2,213,1,69,0.0,41.0,41.0,1,144,0.0,116.0,116.0
0.005,6,10,2006,5,927,1.0,659.0,659.0,5,1079,1.0,811.0,811.0
10.914,17,28,4422,14,1994,831.0,269.0,114.0,14,2428,831.0,587.0,145.0
315.169,17,20,1124,10,716,35005.0,48.0,43.0,10,408,35005.0,20.0,12.0
0.001,17,2,180,1,66,0.0,38.0,38.0,1,114,0.0,86.0,86.0
0.005,6,10,2006,5,927,1.0,659.0,659.0,5,1079,1.0,811.0,811.0
293.127,6,387,347410,191,21492,1542.0,2736.0,825.0,196,325918,1503.0,2804.0,1725.0
0.004,6,10,2006,5,927,1.0,659.0,659.0,5,1079,1.0,811.0,811.0
0.005,17,2,170,1,65,0.0,37.0,37.0,1,105,0.0,77.0,77.0
0.042,17,4,284,2,120,2.0,32.0,32.0,2,164,35.0,60.0,54.0
0.006,6,14,3736,7,446,1.0,74.0,74.0,7,3290,0.0,1448.0,972.0
0.004,6,10,2000,5,927,1.0,659.0,659.0,5,1073,1.0,805.0,805.0
0.001,17,2,142,1,63,0.0,35.0,35.0,1,79,0.0,51.0,51.0
0.004,6,10,2006,5,927,1.0,659.0,659.0,5,1079,1.0,811.0,811.0
0.005,6,10,1854,5,889,1.0,621.0,621.0,5,965,1.0,697.0,697.0
0.017,6,13,3735,7,497,2.0,125.0,125.0,6,3238,3.0,1470.0,1459.0
0.005,6,10,2006,5,927,1.0,659.0,659.0,5,1079,1.0,811.0,811.0
0.058,6,10,1506,5,395,13.0,127.0,127.0,5,1111,13.0,843.0,843.0
0.093,6,10,1506,5,395,18.0,127.0,127.0,5,1111,22.0,843.0,843.0
0.073,6,10,1506,5,395,15.0,127.0,127.0,5,1111,16.0,843.0,843.0
0.128,6,10,1506,5,395,29.0,127.0,127.0,5,1111,26.0,843.0,843.0
0.091,6,10,1506,5,395,16.0,127.0,127.0,5,1111,21.0,843.0,843.0
0.004,17,2,136,1,60,0.0,32.0,32.0,1,76,0.0,48.0,48.0
0.009,6,10,1983,5,910,2.0,642.0,642.0,5,1073,2.0,805.0,805.0
0.086,6,10,1506,5,395,20.0,127.0,127.0,5,1111,17.0,843.0,843.0
0.014,6,10,1972,5,910,3.0,642.0,642.0,5,1062,3.0,794.0,794.0
172.063,17,84,11718,42,2791,4196.0,44.0,38.0,42,8927,4196.0,239.0,184.0
0.128,17,2,136,1,60,0.0,32.0,32.0,1,76,0.0,48.0,48.0
0.004,17,2,136,1,60,0.0,32.0,32.0,1,76,0.0,48.0,48.0
0.004,6,10,2006,5,927,1.0,659.0,659.0,5,1079,1.0,811.0,811.0
0.021,6,14,3787,7,497,3.0,125.0,125.0,7,3290,3.0,1448.0,972.0
0.071,6,10,1506,5,395,14.0,127.0,127.0,5,1111,17.0,843.0,843.0
241.302,6,286,342042,112,17339,2173.0,2736.0,959.0,174,324703,1394.0,2804.0,1924.0
0.093,6,10,1506,5,395,20.0,127.0,127.0,5,1111,21.0,843.0,843.0
0.006,6,10,1643,5,860,1.0,592.0,592.0,5,783,1.0,515.0,515.0
0.127,6,10,1506,5,395,28.0,127.0,127.0,5,1111,30.0,843.0,843.0
0.009,6,10,1972,5,910,2.0,642.0,642.0,5,1062,2.0,794.0,794.0
0.011,6,10,1972,5,910,2.0,642.0,642.0,5,1062,2.0,794.0,794.0
0.103,6,10,1506,5,395,21.0,127.0,127.0,5,1111,21.0,843.0,843.0
0.013,6,13,3735,7,497,2.0,125.0,125.0,6,3238,2.0,1470.0,1459.0
0.006,6,10,1547,5,764,1.0,496.0,496.0,5,783,1.0,515.0,515.0
0.01,6,10,1990,5,911,2.0,643.0,643.0,5,1079,2.0,811.0,811.0
0.003,17,4,284,2,120,0.0,32.0,32.0,2,164,0.0,60.0,54.0
0.262,17,39,20028,21,17034,13.0,1350.0,783.0,18,2994,11.0,1350.0,138.0
0.005,6,10,2006,5,927,1.0,659.0,659.0,5,1079,1.0,811.0,811.0
0.007,6,10,1547,5,764,1.0,496.0,496.0,5,783,1.0,515.0,515.0
40.058,17,10,676,5,460,10013.0,104.0,64.0,5,216,10013.0,20.0,15.0
0.082,6,10,1506,5,395,17.0,127.0,127.0,5,1111,19.0,843.0,843.0
0.009,6,10,1972,5,910,2.0,642.0,642.0,5,1062,2.0,794.0,794.0
40.061,17,10,676,5,460,10014.0,104.0,64.0,5,216,10014.0,20.0,15.0
0.117,6,10,1506,5,395,26.0,127.0,127.0,5,1111,27.0,843.0,843.0
15.076,17,14,9191,8,6902,2149.0,1350.0,834.0,6,2289,3009.0,1350.0,353.0
0.097,6,10,1506,5,395,19.0,127.0,127.0,5,1111,20.0,843.0,843.0
0.006,17,2,170,1,69,0.0,41.0,41.0,1,101,0.0,73.0,73.0
0.005,17,2,170,1,65,0.0,37.0,37.0,1,105,0.0,77.0,77.0
0.012,6,10,1990,5,911,3.0,643.0,643.0,5,1079,2.0,811.0,811.0
0.079,6,10,1506,5,395,18.0,127.0,127.0,5,1111,14.0,843.0,843.0
0.012,6,10,1989,5,910,3.0,642.0,642.0,5,1079,2.0,811.0,811.0
0.005,6,10,2000,5,927,1.0,659.0,659.0,5,1073,1.0,805.0,805.0
0.064,6,10,1506,5,395,14.0,127.0,127.0,5,1111,15.0,843.0,843.0
10.817,17,28,4417,14,1994,823.0,269.0,114.0,14,2423,823.0,586.0,145.0
0.004,17,4,284,2,120,0.0,32.0,32.0,2,164,0.0,60.0,54.0
0.005,6,10,2006,5,927,1.0,659.0,659.0,5,1079,1.0,811.0,811.0
0.005,17,2,179,1,71,0.0,43.0,43.0,1,108,0.0,80.0,80.0
0.008,17,2,203,1,61,0.0,33.0,33.0,1,142,0.0,114.0,114.0
0.003,6,10,1702,5,863,0.0,595.0,595.0,5,839,0.0,571.0,571.0
0.206,6,16,2777,8,1395,29.0,533.0,323.0,8,1382,18.0,529.0,239.0
0.001,17,2,180,1,66,0.0,38.0,38.0,1,114,0.0,86.0,86.0
0.113,6,10,1506,5,395,24.0,127.0,127.0,5,1111,25.0,843.0,843.0
0.041,17,2,170,1,65,0.0,37.0,37.0,1,105,0.0,77.0,77.0
0.005,6,10,2000,5,927,1.0,659.0,659.0,5,1073,1.0,805.0,805.0
0.011,6,10,1762,5,911,2.0,643.0,643.0,5,851,2.0,583.0,583.0
0.015,6,10,1990,5,911,3.0,643.0,643.0,5,1079,3.0,811.0,811.0
413.24,6,29,4409,12,3102,10911.0,494.0,494.0,17,1307,25827.0,83.0,83.0
0.006,6,10,1854,5,889,1.0,621.0,621.0,5,965,1.0,697.0,697.0
0.011,6,10,1983,5,910,2.0,642.0,642.0,5,1073,2.0,805.0,805.0
0.005,6,10,1774,5,923,1.0,655.0,655.0,5,851,1.0,583.0,583.0
0.005,6,10,2006,5,927,1.0,659.0,659.0,5,1079,1.0,811.0,811.0
0.004,6,10,2000,5,927,1.0,659.0,659.0,5,1073,1.0,805.0,805.0
0.129,17,2,80,1,32,0.0,4.0,4.0,1,48,0.0,20.0,20.0
0.01,6,10,1972,5,910,2.0,642.0,642.0,5,1062,2.0,794.0,794.0
240.021,6,9,787,5,488,60005.0,232.0,232.0,4,299,80003.0,83.0,83.0
0.168,6,3,453,2,321,168.0,241.0,241.0,1,132,0.0,92.0,92.0
240.321,6,35,10649,18,2211,14136.0,555.0,253.0,17,8438,15019.0,1834.0,687.0
0.112,6,10,1506,5,395,19.0,127.0,127.0,5,1111,25.0,843.0,843.0
0.009,6,10,1989,5,927,2.0,659.0,659.0,5,1062,2.0,794.0,794.0
0.013,6,10,1972,5,910,3.0,642.0,642.0,5,1062,3.0,794.0,794.0
0.013,6,10,1989,5,910,3.0,642.0,642.0,5,1079,3.0,811.0,811.0
0.129,6,10,1506,5,395,28.0,127.0,127.0,5,1111,20.0,843.0,843.0
0.018,6,10,1972,5,910,4.0,642.0,642.0,5,1062,4.0,794.0,794.0
0.005,6,10,1989,5,927,1.0,659.0,659.0,5,1062,1.0,794.0,794.0
0.106,6,10,1506,5,395,23.0,127.0,127.0,5,1111,21.0,843.0,843.0
0.004,6,10,2006,5,927,1.0,659.0,659.0,5,1079,1.0,811.0,811.0
0.005,6,10,1689,5,839,1.0,571.0,571.0,5,850,1.0,582.0,582.0
0.09,6,10,1506,5,395,19.0,127.0,127.0,5,1111,18.0,843.0,843.0
0.004,17,2,136,1,60,0.0,32.0,32.0,1,76,0.0,48.0,48.0
0.005,6,14,3742,7,452,0.0,80.0,80.0,7,3290,0.0,1448.0,972.0
0.007,17,2,140,1,62,0.0,34.0,34.0,1,78,0.0,50.0,50.0
0.009,6,10,1972,5,910,2.0,642.0,642.0,5,1062,2.0,794.0,794.0
0.006,6,10,1547,5,764,1.0,496.0,496.0,5,783,1.0,515.0,515.0
0.012,6,10,1631,5,848,3.0,580.0,580.0,5,783,2.0,515.0,515.0
0.009,6,10,1972,5,910,2.0,642.0,642.0,5,1062,2.0,794.0,794.0
40.062,17,10,676,5,460,10014.0,104.0,64.0,5,216,10014.0,20.0,15.0
300.424,6,16,2170,9,684,37532.0,146.0,146.0,7,1486,50042.0,419.0,398.0
0.005,17,2,170,1,65,0.0,37.0,37.0,1,105,0.0,77.0,77.0
0.009,6,10,1983,5,910,2.0,642.0,642.0,5,1073,2.0,805.0,805.0
0.17,6,3,453,2,321,170.0,241.0,241.0,1,132,0.0,92.0,92.0
0.08,6,10,1506,5,395,18.0,127.0,127.0,5,1111,17.0,843.0,843.0
0.005,6,10,1854,5,889,1.0,621.0,621.0,5,965,1.0,697.0,697.0
0.02,6,10,1989,5,910,5.0,642.0,642.0,5,1079,4.0,811.0,811.0
0.043,17,2,152,1,76,0.0,48.0,48.0,1,76,0.0,48.0,48.0
0.078,6,10,1506,5,395,17.0,127.0,127.0,5,1111,17.0,843.0,843.0
0.001,17,2,180,1,66,0.0,38.0,38.0,1,114,0.0,86.0,86.0
0.006,6,10,2000,5,927,1.0,659.0,659.0,5,1073,1.0,805.0,805.0
0.011,6,10,1990,5,911,2.0,643.0,643.0,5,1079,2.0,811.0,811.0
0.054,6,10,1983,5,910,13.0,642.0,642.0,5,1073,13.0,805.0,805.0
241.52,6,306,343124,110,17239,2215.0,2736.0,960.0,196,325885,1238.0,2804.0,1697.0
0.001,17,2,166,1,75,0.0,47.0,47.0,1,91,0.0,63.0,63.0
0.078,6,10,1506,5,395,18.0,127.0,127.0,5,1111,17.0,843.0,843.0
0.013,6,10,1989,5,910,3.0,642.0,642.0,5,1079,3.0,811.0,811.0
0.005,6,10,2007,5,928,1.0,660.0,660.0,5,1079,1.0,811.0,811.0
0.008,6,12,1926,6,1189,1.0,659.0,434.0,6,737,1.0,417.0,417.0
0.007,17,2,230,1,68,0.0,40.0,40.0,1,162,0.0,134.0,134.0
0.071,6,10,1506,5,395,16.0,127.0,127.0,5,1111,17.0,843.0,843.0
0.005,6,10,2007,5,928,1.0,660.0,660.0,5,1079,1.0,811.0,811.0
0.005,6,13,3690,7,452,0.0,80.0,80.0,6,3238,0.0,1470.0,1459.0
0.017,6,10,1972,5,910,4.0,642.0,642.0,5,1062,4.0,794.0,794.0
0.016,6,10,1989,5,910,4.0,642.0,642.0,5,1079,4.0,811.0,811.0
0.003,17,4,284,2,120,0.0,32.0,32.0,2,164,0.0,60.0,54.0
0.005,17,2,214,1,75,0.0,47.0,47.0,1,139,0.0,111.0,111.0
0.07,6,10,1506,5,395,13.0,127.0,127.0,5,1111,17.0,843.0,843.0
0.014,6,10,1983,5,910,3.0,642.0,642.0,5,1073,3.0,805.0,805.0
40.048,17,10,676,5,460,10009.0,104.0,64.0,5,216,10005.0,20.0,15.0
0.165,17,2,152,1,76,0.0,48.0,48.0,1,76,0.0,48.0,48.0
0.004,17,2,136,1,60,0.0,32.0,32.0,1,76,0.0,48.0,48.0
0.098,6,10,1506,5,395,22.0,127.0,127.0,5,1111,19.0,843.0,843.0
0.103,6,10,1506,5,395,18.0,127.0,127.0,5,1111,24.0,843.0,843.0
0.007,17,2,132,1,58,0.0,30.0,30.0,1,74,0.0,46.0,46.0
308.995,17,20,1124,10,716,34325.0,48.0,43.0,10,408,34326.0,20.0,12.0
0.124,6,10,1506,5,395,28.0,127.0,127.0,5,1111,26.0,843.0,843.0
0.011,6,10,1972,5,910,2.0,642.0,642.0,5,1062,2.0,794.0,794.0
40.055,17,10,676,5,460,10012.0,104.0,64.0,5,216,10012.0,20.0,15.0
0.003,17,2,136,1,60,0.0,32.0,32.0,1,76,0.0,48.0,48.0
0.12,6,10,1506,5,395,21.0,127.0,127.0,5,1111,23.0,843.0,843.0
0.001,17,2,180,1,66,0.0,38.0,38.0,1,114,0.0,86.0,86.0
300.023,6,12,1782,7,1348,50003.0,494.0,494.0,5,434,75004.0,83.0,83.0
0.005,6,10,2007,5,928,1.0,660.0,660.0,5,1079,1.0,811.0,811.0
0.013,17,2,152,1,56,0.0,28.0,28.0,1,96,0.0,68.0,68.0
40.056,17,10,676,5,460,10013.0,104.0,64.0,5,216,10013.0,20.0,15.0
0.01,6,10,1989,5,910,2.0,642.0,642.0,5,1079,2.0,811.0,811.0
0.713,6,22,5072,11,1250,60.0,325.0,133.0,11,3822,60.0,1414.0,563.0
0.046,17,4,352,2,130,1.0,37.0,37.0,2,222,2.0,89.0,83.0
0.004,17,2,148,1,60,0.0,32.0,32.0,1,88,0.0,60.0,60.0
0.006,17,2,148,1,60,0.0,32.0,32.0,1,88,0.0,60.0,60.0
0.012,6,10,1990,5,911,3.0,643.0,643.0,5,1079,2.0,811.0,811.0
0.009,6,12,1926,6,1189,1.0,659.0,434.0,6,737,1.0,417.0,417.0
0.068,6,10,1506,5,395,13.0,127.0,127.0,5,1111,16.0,843.0,843.0
0.005,17,2,179,1,71,0.0,43.0,43.0,1,108,0.0,80.0,80.0
0.005,17,2,214,1,75,0.0,47.0,47.0,1,139,0.0,111.0,111.0
176.262,17,76,10847,38,2530,4763.0,44.0,38.0,38,8317,4763.0,252.0,190.0
0.003,17,2,148,1,60,0.0,32.0,32.0,1,88,0.0,60.0,60.0
0.101,6,10,1506,5,395,20.0,127.0,127.0,5,1111,24.0,843.0,843.0
0.01,6,12,1926,6,1189,2.0,659.0,434.0,6,737,2.0,417.0,417.0
0.764,6,22,5168,11,1138,64.0,267.0,115.0,11,4030,64.0,1414.0,597.0
0.004,6,10,1774,5,923,1.0,655.0,655.0,5,851,1.0,583.0,583.0
0.017,6,10,1990,5,911,4.0,643.0,643.0,5,1079,4.0,811.0,811.0
0.006,6,10,1854,5,889,1.0,621.0,621.0,5,965,1.0,697.0,697.0
368.894,6,22,2313,16,867,24592.0,195.0,195.0,6,1446,4635.0,419.0,398.0
0.004,6,10,1989,5,927,1.0,659.0,659.0,5,1062,1.0,794.0,794.0
0.009,6,10,2007,5,928,2.0,660.0,660.0,5,1079,2.0,811.0,811.0
0.01,6,10,1983,5,910,2.0,642.0,642.0,5,1073,2.0,805.0,805.0
0.009,6,10,2006,5,927,2.0,659.0,659.0,5,1079,2.0,811.0,811.0
40.066,17,10,676,5,460,10015.0,104.0,64.0,5,216,10015.0,20.0,15.0
0.102,6,10,1506,5,395,21.0,127.0,127.0,5,1111,23.0,843.0,843.0
0.006,17,2,166,1,75,0.0,47.0,47.0,1,91,0.0,63.0,63.0
0.005,17,4,284,2,120,1.0,32.0,32.0,2,164,1.0,60.0,54.0
0.004,6,10,2006,5,927,1.0,659.0,659.0,5,1079,1.0,811.0,811.0
0.007,6,10,1547,5,764,1.0,496.0,496.0,5,783,1.0,515.0,515.0
0.012,6,10,1989,5,910,3.0,642.0,642.0,5,1079,2.0,811.0,811.0
0.005,6,10,2007,5,928,1.0,660.0,660.0,5,1079,1.0,811.0,811.0
0.018,6,20,9974,11,704,1.0,124.0,124.0,9,9270,2.0,2896.0,1758.0
0.012,6,10,1762,5,911,3.0,643.0,643.0,5,851,3.0,583.0,583.0
0.005,6,10,2000,5,927,1.0,659.0,659.0,5,1073,1.0,805.0,805.0
0.017,6,10,1990,5,911,4.0,643.0,643.0,5,1079,4.0,811.0,811.0
0.005,6,10,2006,5,927,1.0,659.0,659.0,5,1079,1.0,811.0,811.0
0.005,6,10,1547,5,764,1.0,496.0,496.0,5,783,1.0,515.0,515.0
40.053,17,10,676,5,460,10012.0,104.0,64.0,5,216,10012.0,20.0,15.0
0.022,6,10,1990,5,911,5.0,643.0,643.0,5,1079,5.0,811.0,811.0
0.091,6,10,1506,5,395,21.0,127.0,127.0,5,1111,21.0,843.0,843.0
0.209,6,16,2777,8,1395,29.0,533.0,323.0,8,1382,18.0,529.0,239.0
0.021,6,10,1631,5,848,5.0,580.0,580.0,5,783,5.0,515.0,515.0
40.053,17,10,676,5,460,10012.0,104.0,64.0,5,216,10012.0,20.0,15.0
0.005,6,10,1643,5,860,1.0,592.0,592.0,5,783,1.0,515.0,515.0
0.009,6,10,1989,5,910,2.0,642.0,642.0,5,1079,2.0,811.0,811.0
0.096,6,10,1506,5,395,21.0,127.0,127.0,5,1111,23.0,843.0,843.0
0.084,6,10,1506,5,395,18.0,127.0,127.0,5,1111,18.0,843.0,843.0
0.067,6,10,1506,5,395,15.0,127.0,127.0,5,1111,13.0,843.0,843.0
0.015,6,10,1989,5,910,3.0,642.0,642.0,5,1079,3.0,811.0,811.0
0.005,6,10,2006,5,927,1.0,659.0,659.0,5,1079,1.0,811.0,811.0
0.001,17,2,174,1,72,0.0,44.0,44.0,1,102,0.0,74.0,74.0
0.041,17,2,152,1,76,0.0,48.0,48.0,1,76,0.0,48.0,48.0
0.004,6,10,1989,5,927,1.0,659.0,659.0,5,1062,1.0,794.0,794.0
0.001,17,2,180,1,66,0.0,38.0,38.0,1,114,0.0,86.0,86.0
15.121,17,15,9238,8,6902,2152.0,1350.0,834.0,7,2336,2511.0,1350.0,305.0
0.004,6,10,1989,5,927,1.0,659.0,659.0,5,1062,1.0,794.0,794.0
0.004,17,4,284,2,120,0.0,32.0,32.0,2,164,1.0,60.0,54.0
0.005,6,10,1689,5,839,1.0,571.0,571.0,5,850,1.0,582.0,582.0
0.005,17,2,170,1,65,0.0,37.0,37.0,1,105,0.0,77.0,77.0
10.773,17,28,4417,14,1993,820.0,268.0,114.0,14,2424,820.0,587.0,145.0
0.001,17,2,180,1,66,0.0,38.0,38.0,1,114,0.0,86.0,86.0
0.07,6,10,1506,5,395,17.0,127.0,127.0,5,1111,15.0,843.0,843.0
367.247,6,22,2313,16,867,24483.0,195.0,195.0,6,1446,4650.0,419.0,398.0
0.003,17,2,148,1,60,0.0,32.0,32.0,1,88,0.0,60.0,60.0
15.097,17,16,8797,8,6564,2150.0,1350.0,792.0,8,2233,2152.0,1350.0,251.0
0.088,6,10,1989,5,910,21.0,642.0,642.0,5,1079,21.0,811.0,811.0
0.041,17,4,420,2,122,2.0,33.0,33.0,2,298,37.0,145.0,121.0
0.005,6,10,1643,5,860,1.0,592.0,592.0,5,783,1.0,515.0,515.0
0.005,6,10,2007,5,928,1.0,660.0,660.0,5,1079,1.0,811.0,811.0
0.008,6,10,2007,5,928,1.0,660.0,660.0,5,1079,1.0,811.0,811.0
0.039,17,2,148,1,60,0.0,32.0,32.0,1,88,0.0,60.0,60.0
430.398,6,25,6271,14,4177,33107.0,1402.0,573.0,11,2094,37036.0,824.0,378.0
0.004,6,10,1774,5,923,1.0,655.0,655.0,5,851,1.0,583.0,583.0
0.013,6,14,3787,7,497,2.0,125.0,125.0,7,3290,2.0,1448.0,972.0
0.064,17,2,152,1,76,0.0,48.0,48.0,1,76,0.0,48.0,48.0
0.087,6,10,1506,5,395,19.0,127.0,127.0,5,1111,19.0,843.0,843.0
0.014,6,10,1989,5,910,3.0,642.0,642.0,5,1079,3.0,811.0,811.0
0.009,6,10,1983,5,910,2.0,642.0,642.0,5,1073,2.0,805.0,805.0
0.014,6,14,3787,7,497,2.0,125.0,125.0,7,3290,2.0,1448.0,972.0
0.002,17,2,136,1,60,0.0,32.0,32.0,1,76,0.0,48.0,48.0
310.436,17,20,1124,10,716,34477.0,48.0,43.0,10,408,34478.0,20.0,12.0
0.012,6,10,1989,5,910,2.0,642.0,642.0,5,1079,2.0,811.0,811.0
10.756,17,28,4421,14,1993,818.0,268.0,114.0,14,2428,818.0,587.0,145.0
0.012,6,10,1631,5,848,2.0,580.0,580.0,5,783,3.0,515.0,515.0
0.005,6,10,1989,5,927,1.0,659.0,659.0,5,1062,1.0,794.0,794.0
0.009,6,10,1990,5,911,2.0,643.0,643.0,5,1079,2.0,811.0,811.0
0.004,17,4,284,2,120,0.0,32.0,32.0,2,164,1.0,60.0,54.0
0.008,6,10,1989,5,910,2.0,642.0,642.0,5,1079,2.0,811.0,811.0
1787.006,6,277,25837,140,9144,12856.0,747.0,263.0,137,16693,13139.0,1625.0,72.0
0.045,17,2,184,1,61,0.0,33.0,33.0,1,123,0.0,95.0,95.0
0.004,6,10,1989,5,927,1.0,659.0,659.0,5,1062,1.0,794.0,794.0
0.074,6,10,1506,5,395,16.0,127.0,127.0,5,1111,14.0,843.0,843.0
294.073,6,383,348208,191,21499,1547.0,2691.0,825.0,192,326709,1539.0,2804.0,1769.0
0.017,6,10,1762,5,911,4.0,643.0,643.0,5,851,4.0,583.0,583.0
0.005,6,10,2007,5,928,1.0,660.0,660.0,5,1079,1.0,811.0,811.0
0.005,6,10,2007,5,928,1.0,660.0,660.0,5,1079,1.0,811.0,811.0
0.008,6,10,1989,5,910,2.0,642.0,642.0,5,1079,2.0,811.0,811.0
0.005,6,10,1643,5,860,1.0,592.0,592.0,5,783,1.0,515.0,515.0
0.006,6,10,1689,5,839,1.0,571.0,571.0,5,850,1.0,582.0,582.0
300.373,6,16,2170,9,684,37525.0,146.0,146.0,7,1486,50034.0,419.0,398.0
0.008,6,10,1983,5,910,2.0,642.0,642.0,5,1073,1.0,805.0,805.0
308.635,17,20,1124,10,716,34279.0,48.0,43.0,10,408,34281.0,20.0,12.0
0.037,17,2,148,1,60,0.0,32.0,32.0,1,88,0.0,60.0,60.0
0.041,17,2,152,1,76,0.0,48.0,48.0,1,76,0.0,48.0,48.0
0.006,6,10,1854,5,889,1.0,621.0,621.0,5,965,1.0,697.0,697.0
312.704,17,20,1124,10,716,34729.0,48.0,43.0,10,408,34730.0,20.0,12.0
0.004,17,4,284,2,120,0.0,32.0,32.0,2,164,1.0,60.0,54.0
0.005,17,2,170,1,65,0.0,37.0,37.0,1,105,0.0,77.0,77.0
0.005,6,10,2007,5,928,1.0,660.0,660.0,5,1079,1.0,811.0,811.0
293.896,6,376,346628,196,21746,1507.0,2736.0,888.0,180,324882,1641.0,2804.0,1900.0
0.01,6,10,1989,5,910,2.0,642.0,642.0,5,1079,2.0,811.0,811.0
0.001,17,2,136,1,60,0.0,32.0,32.0,1,76,0.0,48.0,48.0
0.005,6,10,1547,5,764,1.0,496.0,496.0,5,783,1.0,515.0,515.0
10.819,17,28,4422,14,1994,823.0,269.0,114.0,14,2428,823.0,587.0,145.0
0.006,6,10,1689,5,839,1.0,571.0,571.0,5,850,1.0,582.0,582.0
0.01,6,10,1973,5,911,2.0,643.0,643.0,5,1062,2.0,794.0,794.0
0.005,6,10,1547,5,764,1.0,496.0,496.0,5,783,1.0,515.0,515.0
0.079,6,10,1506,5,395,17.0,127.0,127.0,5,1111,18.0,843.0,843.0
0.004,6,10,2006,5,927,1.0,659.0,659.0,5,1079,1.0,811.0,811.0
0.012,6,10,1631,5,848,3.0,580.0,580.0,5,783,3.0,515.0,515.0
0.008,17,2,179,1,71,0.0,43.0,43.0,1,108,0.0,80.0,80.0
0.014,6,10,1990,5,911,3.0,643.0,643.0,5,1079,3.0,811.0,811.0
15.078,17,15,9239,8,6902,2149.0,1350.0,834.0,7,2337,2508.0,1350.0,305.0
0.114,6,10,1506,5,395,23.0,127.0,127.0,5,1111,26.0,843.0,843.0
0.129,6,10,1506,5,395,30.0,127.0,127.0,5,1111,31.0,843.0,843.0
0.018,6,10,1972,5,910,4.0,642.0,642.0,5,1062,4.0,794.0,794.0
0.007,17,2,234,1,61,0.0,33.0,33.0,1,173,0.0,145.0,145.0
0.008,6,10,1989,5,910,2.0,642.0,642.0,5,1079,1.0,811.0,811.0
0.005,17,2,170,1,65,0.0,37.0,37.0,1,105,0.0,77.0,77.0
0.14,6,10,1506,5,395,33.0,127.0,127.0,5,1111,29.0,843.0,843.0
0.005,6,10,1689,5,839,1.0,571.0,571.0,5,850,1.0,582.0,582.0
0.005,6,10,1989,5,927,1.0,659.0,659.0,5,1062,1.0,794.0,794.0
0.066,6,10,1506,5,395,13.0,127.0,127.0,5,1111,15.0,843.0,843.0
0.003,17,2,136,1,60,0.0,32.0,32.0,1,76,0.0,48.0,48.0
0.121,6,10,1506,5,395,25.0,127.0,127.0,5,1111,24.0,843.0,843.0
1.919,6,38,6827,21,3555,95.0,1103.0,204.0,17,3272,111.0,1796.0,396.0
0.003,17,2,144,1,64,0.0,36.0,36.0,1,80,0.0,52.0,52.0
0.005,6,10,2006,5,927,1.0,659.0,659.0,5,1079,1.0,811.0,811.0
15.071,17,15,9238,8,6902,2148.0,1350.0,834.0,7,2336,2506.0,1350.0,305.0
0.005,6,10,1989,5,927,1.0,659.0,659.0,5,1062,1.0,794.0,794.0
40.093,17,10,676,5,460,10020.0,104.0,64.0,5,216,10022.0,20.0,15.0
0.005,6,10,2007,5,928,1.0,660.0,660.0,5,1079,1.0,811.0,811.0
10.811,17,28,4423,14,1995,822.0,270.0,114.0,14,2428,822.0,587.0,145.0
0.006,17,2,168,1,76,0.0,48.0,48.0,1,92,0.0,64.0,64.0
0.134,6,10,1506,5,395,26.0,127.0,127.0,5,1111,32.0,843.0,843.0
0.005,6,14,3799,7,509,0.0,137.0,137.0,7,3290,0.0,1448.0,972.0
0.013,6,10,1989,5,910,3.0,642.0,642.0,5,1079,3.0,811.0,811.0
0.005,6,10,2006,5,927,1.0,659.0,659.0,5,1079,1.0,811.0,811.0
0.094,6,10,1506,5,395,23.0,127.0,127.0,5,1111,17.0,843.0,843.0
0.012,6,10,1972,5,910,2.0,642.0,642.0,5,1062,2.0,794.0,794.0
1793.54,6,529,186664,264,161387,6819.0,2883.0,1054.0,265,25277,6793.0,373.0,121.0
0.01,6,14,3787,7,497,1.0,125.0,125.0,7,3290,1.0,1448.0,972.0
240.08,6,19,4976,9,2305,30010.0,1102.0,613.0,10,2671,26675.0,1162.0,428.0
0.116,6,10,1506,5,395,27.0,127.0,127.0,5,1111,26.0,843.0,843.0
1.01,6,13,3922,7,2139,126.0,1328.0,923.0,6,1783,151.0,1539.0,1539.0
0.005,6,10,1989,5,927,1.0,659.0,659.0,5,1062,1.0,794.0,794.0
242.273,6,323,345022,123,17900,1985.0,2736.0,959.0,200,327122,1217.0,3018.0,1666.0
0.083,6,10,1506,5,395,18.0,127.0,127.0,5,1111,15.0,843.0,843.0
0.135,6,10,1506,5,395,33.0,127.0,127.0,5,1111,29.0,843.0,843.0
0.119,6,10,1506,5,395,28.0,127.0,127.0,5,1111,24.0,843.0,843.0
0.005,6,10,2000,5,927,1.0,659.0,659.0,5,1073,1.0,805.0,805.0
0.016,6,10,1990,5,911,4.0,643.0,643.0,5,1079,4.0,811.0,811.0
0.001,17,2,140,1,62,0.0,34.0,34.0,1,78,0.0,50.0,50.0
15.074,17,15,9239,8,6902,2149.0,1350.0,834.0,7,2337,2507.0,1350.0,305.0
0.013,6,13,3735,7,497,2.0,125.0,125.0,6,3238,2.0,1470.0,1459.0
0.006,6,10,1547,5,764,1.0,496.0,496.0,5,783,1.0,515.0,515.0
356.623,6,21,1795,16,1030,23774.0,190.0,190.0,5,765,60004.0,464.0,248.0
0.125,6,10,1506,5,395,24.0,127.0,127.0,5,1111,26.0,843.0,843.0
0.015,6,10,1989,5,910,3.0,642.0,642.0,5,1079,3.0,811.0,811.0
0.012,6,10,1990,5,911,3.0,643.0,643.0,5,1079,2.0,811.0,811.0
0.005,6,10,2007,5,928,1.0,660.0,660.0,5,1079,1.0,811.0,811.0
0.005,6,10,2007,5,928,1.0,660.0,660.0,5,1079,1.0,811.0,811.0
0.003,17,2,148,1,60,0.0,32.0,32.0,1,88,0.0,60.0,60.0
0.141,6,10,1506,5,395,33.0,127.0,127.0,5,1111,33.0,843.0,843.0
10.968,17,28,4422,14,1995,835.0,270.0,114.0,14,2427,835.0,586.0,145.0
0.005,6,10,1779,5,928,1.0,660.0,660.0,5,851,1.0,583.0,583.0
0.012,6,10,1990,5,911,2.0,643.0,643.0,5,1079,3.0,811.0,811.0
10.931,17,28,4394,14,1993,832.0,268.0,114.0,14,2401,832.0,588.0,143.0
0.005,17,2,164,1,74,0.0,46.0,46.0,1,90,0.0,62.0,62.0
0.013,6,10,1990,5,911,3.0,643.0,643.0,5,1079,3.0,811.0,811.0
0.042,17,4,284,2,120,5.0,32.0,32.0,2,164,39.0,60.0,54.0
0.104,6,10,1506,5,395,24.0,127.0,127.0,5,1111,24.0,843.0,843.0
0.041,17,2,184,1,61,0.0,33.0,33.0,1,123,0.0,95.0,95.0
0.001,17,2,180,1,66,0.0,38.0,38.0,1,114,0.0,86.0,86.0
0.005,6,13,3747,7,509,0.0,137.0,137.0,6,3238,0.0,1470.0,1459.0
0.004,6,10,2006,5,927,1.0,659.0,659.0,5,1079,1.0,811.0,811.0
0.081,6,10,1506,5,395,18.0,127.0,127.0,5,1111,18.0,843.0,843.0
0.164,6,10,1506,5,395,34.0,127.0,127.0,5,1111,25.0,843.0,843.0
0.098,6,10,1506,5,395,22.0,127.0,127.0,5,1111,20.0,843.0,843.0
0.005,6,10,1774,5,923,1.0,655.0,655.0,5,851,1.0,583.0,583.0
0.005,17,2,170,1,65,0.0,37.0,37.0,1,105,0.0,77.0,77.0
0.004,6,10,1989,5,927,1.0,659.0,659.0,5,1062,1.0,794.0,794.0
0.009,6,10,1990,5,911,2.0,643.0,643.0,5,1079,2.0,811.0,811.0
0.005,6,10,2007,5,928,1.0,660.0,660.0,5,1079,1.0,811.0,811.0
0.006,6,10,1547,5,764,1.0,496.0,496.0,5,783,1.0,515.0,515.0
0.012,6,10,1677,5,827,3.0,559.0,559.0,5,850,2.0,582.0,582.0
0.008,6,10,1983,5,910,1.0,642.0,642.0,5,1073,2.0,805.0,805.0
0.005,6,10,2006,5,927,1.0,659.0,659.0,5,1079,1.0,811.0,811.0
0.005,6,10,2006,5,927,1.0,659.0,659.0,5,1079,1.0,811.0,811.0
1770.535,17,92,8096,46,4048,39345.0,60.0,60.0,46,4048,39344.0,60.0,60.0
0.006,6,10,1989,5,927,1.0,659.0,659.0,5,1062,1.0,794.0,794.0
0.004,6,10,1989,5,927,1.0,659.0,659.0,5,1062,1.0,794.0,794.0
40.067,17,10,676,5,460,10013.0,104.0,64.0,5,216,10015.0,20.0,15.0
0.009,6,12,1926,6,1189,1.0,659.0,434.0,6,737,1.0,417.0,417.0
0.724,6,22,5072,11,1250,61.0,325.0,133.0,11,3822,61.0,1414.0,563.0
0.012,6,10,1983,5,910,3.0,642.0,642.0,5,1073,3.0,805.0,805.0
178.379,17,84,11676,42,2806,4350.0,44.0,38.0,42,8870,4350.0,239.0,183.0
0.005,6,10,2000,5,927,1.0,659.0,659.0,5,1073,1.0,805.0,805.0
0.005,6,10,2006,5,927,1.0,659.0,659.0,5,1079,1.0,811.0,811.0
0.005,6,10,1989,5,927,1.0,659.0,659.0,5,1062,1.0,794.0,794.0
0.013,6,10,2006,5,927,3.0,659.0,659.0,5,1079,3.0,811.0,811.0
1.048,6,12,3134,6,2099,157.0,1328.0,923.0,6,1035,157.0,791.0,791.0
0.133,6,10,1506,5,395,24.0,127.0,127.0,5,1111,31.0,843.0,843.0
0.003,17,2,136,1,60,0.0,32.0,32.0,1,76,0.0,48.0,48.0
15.093,17,15,9239,8,6902,2149.0,1350.0,834.0,7,2337,2510.0,1350.0,305.0
0.129,17,4,364,2,160,0.0,52.0,52.0,2,204,57.0,80.0,74.0
240.018,6,9,787,5,488,60004.0,232.0,232.0,4,299,80004.0,83.0,83.0
0.011,6,10,1990,5,911,2.0,643.0,643.0,5,1079,2.0,811.0,811.0
11.175,17,28,4422,14,1993,846.0,268.0,114.0,14,2429,846.0,588.0,145.0
0.022,6,13,3913,7,495,3.0,123.0,123.0,6,3418,4.0,1650.0,1549.0
0.005,6,10,1689,5,839,1.0,571.0,571.0,5,850,1.0,582.0,582.0
0.013,6,10,1989,5,910,3.0,642.0,642.0,5,1079,3.0,811.0,811.0
0.01,6,10,1762,5,911,2.0,643.0,643.0,5,851,2.0,583.0,583.0
0.005,6,10,2000,5,927,1.0,659.0,659.0,5,1073,1.0,805.0,805.0
0.011,6,10,1989,5,910,2.0,642.0,642.0,5,1079,2.0,811.0,811.0
0.005,6,10,1689,5,839,1.0,571.0,571.0,5,850,1.0,582.0,582.0
0.987,6,14,3962,7,2139,123.0,1328.0,923.0,7,1823,123.0,1300.0,769.0
0.015,6,10,1989,5,910,3.0,642.0,642.0,5,1079,3.0,811.0,811.0
0.008,6,10,1972,5,910,2.0,642.0,642.0,5,1062,1.0,794.0,794.0
0.015,6,10,1631,5,848,3.0,580.0,580.0,5,783,3.0,515.0,515.0
40.06,17,10,676,5,460,10014.0,104.0,64.0,5,216,10014.0,20.0,15.0
0.004,17,2,148,1,60,0.0,32.0,32.0,1,88,0.0,60.0,60.0
0.006,17,2,168,1,76,0.0,48.0,48.0,1,92,0.0,64.0,64.0
0.005,6,10,2007,5,928,1.0,660.0,660.0,5,1079,1.0,811.0,811.0
0.003,17,2,136,1,60,0.0,32.0,32.0,1,76,0.0,48.0,48.0
0.003,17,4,284,2,120,0.0,32.0,32.0,2,164,0.0,60.0,54.0
65.74,6,40,10793,20,5195,471.0,1360.0,727.0,20,5598,3451.0,2667.0,435.0
0.043,17,2,152,1,76,0.0,48.0,48.0,1,76,0.0,48.0,48.0
0.008,6,10,1631,5,848,1.0,580.0,580.0,5,783,2.0,515.0,515.0
0.012,6,10,1972,5,910,3.0,642.0,642.0,5,1062,3.0,794.0,794.0
0.004,17,2,148,1,60,0.0,32.0,32.0,1,88,0.0,60.0,60.0
354.542,6,20,2210,6,1308,12005.0,494.0,494.0,14,902,27271.0,83.0,83.0
0.097,6,10,1506,5,395,21.0,127.0,127.0,5,1111,20.0,843.0,843.0
0.005,17,2,169,1,62,0.0,34.0,34.0,1,107,0.0,79.0,79.0
0.005,6,10,1547,5,764,1.0,496.0,496.0,5,783,1.0,515.0,515.0
240.012,6,9,787,5,488,60003.0,232.0,232.0,4,299,80003.0,83.0,83.0
0.744,6,25,5459,12,1557,57.0,325.0,152.0,13,3902,52.0,1414.0,563.0
0.015,6,10,1972,5,910,3.0,642.0,642.0,5,1062,3.0,794.0,794.0
15.07,17,15,10568,9,8280,1880.0,1350.0,892.0,6,2288,3007.0,1350.0,353.0
0.013,6,10,1990,5,911,3.0,643.0,643.0,5,1079,3.0,811.0,811.0
0.007,17,2,179,1,71,0.0,43.0,43.0,1,108,0.0,80.0,80.0
0.007,6,10,1972,5,910,1.0,642.0,642.0,5,1062,1.0,794.0,794.0
166.112,17,80,11445,40,2673,4258.0,44.0,38.0,40,8772,4259.0,260.0,191.0
0.005,6,10,2006,5,927,1.0,659.0,659.0,5,1079,1.0,811.0,811.0
0.005,17,2,179,1,71,0.0,43.0,43.0,1,108,0.0,80.0,80.0
0.005,6,10,2000,5,927,1.0,659.0,659.0,5,1073,1.0,805.0,805.0
0.005,6,10,1689,5,839,1.0,571.0,571.0,5,850,1.0,582.0,582.0
0.025,6,10,1631,5,848,6.0,580.0,580.0,5,783,6.0,515.0,515.0
0.005,6,13,3747,7,509,0.0,137.0,137.0,6,3238,0.0,1470.0,1459.0
40.062,17,10,676,5,460,10012.0,104.0,64.0,5,216,10014.0,20.0,15.0
40.065,17,10,676,5,460,10013.0,104.0,64.0,5,216,10015.0,20.0,15.0
0.005,6,13,3747,7,509,0.0,137.0,137.0,6,3238,1.0,1470.0,1459.0
0.008,6,10,1983,5,910,2.0,642.0,642.0,5,1073,2.0,805.0,805.0
1732.219,6,66,7460,44,4585,40284.0,1402.0,103.0,22,2875,82478.0,1111.0,82.0
0.006,6,10,1643,5,860,1.0,592.0,592.0,5,783,1.0,515.0,515.0
40.073,17,10,676,5,460,10017.0,104.0,64.0,5,216,10017.0,20.0,15.0
290.642,6,392,348119,190,21444,1537.0,2736.0,888.0,202,326675,1445.0,2804.0,1681.0
0.017,6,10,1989,5,910,4.0,642.0,642.0,5,1079,4.0,811.0,811.0
0.019,6,10,1983,5,910,4.0,642.0,642.0,5,1073,4.0,805.0,805.0
0.17,6,3,453,2,321,170.0,241.0,241.0,1,132,0.0,92.0,92.0
0.016,17,2,304,1,77,0.0,49.0,49.0,1,227,0.0,199.0,199.0
0.019,6,10,1762,5,911,4.0,643.0,643.0,5,851,4.0,583.0,583.0
0.003,17,2,136,1,60,0.0,32.0,32.0,1,76,0.0,48.0,48.0
0.007,6,10,1762,5,911,1.0,643.0,643.0,5,851,1.0,583.0,583.0
0.008,6,10,1972,5,910,2.0,642.0,642.0,5,1062,1.0,794.0,794.0
0.001,17,2,136,1,60,0.0,32.0,32.0,1,76,0.0,48.0,48.0
0.004,6,10,1702,5,863,1.0,595.0,595.0,5,839,0.0,571.0,571.0
0.01,6,10,1989,5,910,2.0,642.0,642.0,5,1079,2.0,811.0,811.0
0.119,6,10,1506,5,395,26.0,127.0,127.0,5,1111,25.0,843.0,843.0
0.005,17,2,140,1,62,0.0,34.0,34.0,1,78,0.0,50.0,50.0
0.092,6,10,1506,5,395,20.0,127.0,127.0,5,1111,21.0,843.0,843.0
0.001,17,2,194,1,57,0.0,29.0,29.0,1,137,0.0,109.0,109.0
0.006,6,10,1547,5,764,1.0,496.0,496.0,5,783,1.0,515.0,515.0
0.005,6,13,3747,7,509,0.0,137.0,137.0,6,3238,0.0,1470.0,1459.0
0.013,6,10,1762,5,911,3.0,643.0,643.0,5,851,3.0,583.0,583.0
0.005,6,10,2007,5,928,1.0,660.0,660.0,5,1079,1.0,811.0,811.0
0.074,6,10,1506,5,395,15.0,127.0,127.0,5,1111,16.0,843.0,843.0
0.066,6,10,1506,5,395,15.0,127.0,127.0,5,1111,13.0,843.0,843.0
40.068,17,10,676,5,460,10014.0,104.0,64.0,5,216,10016.0,20.0,15.0
0.037,17,2,148,1,60,0.0,32.0,32.0,1,88,0.0,60.0,60.0
0.005,6,10,1774,5,923,1.0,655.0,655.0,5,851,1.0,583.0,583.0
0.069,6,10,1506,5,395,16.0,127.0,127.0,5,1111,16.0,843.0,843.0
0.139,6,10,1506,5,395,32.0,127.0,127.0,5,1111,22.0,843.0,843.0
0.005,6,10,1989,5,927,1.0,659.0,659.0,5,1062,1.0,794.0,794.0
0.003,17,2,148,1,60,0.0,32.0,32.0,1,88,0.0,60.0,60.0
0.016,6,10,1989,5,910,4.0,642.0,642.0,5,1079,3.0,811.0,811.0
0.014,6,10,1989,5,910,3.0,642.0,642.0,5,1079,3.0,811.0,811.0
0.038,17,2,198,1,91,0.0,63.0,63.0,1,107,0.0,79.0,79.0
0.004,6,10,1702,5,863,1.0,595.0,595.0,5,839,1.0,571.0,571.0
0.006,6,10,1689,5,839,1.0,571.0,571.0,5,850,1.0,582.0,582.0
0.006,6,10,1547,5,764,1.0,496.0,496.0,5,783,1.0,515.0,515.0
0.006,6,10,1643,5,860,1.0,592.0,592.0,5,783,1.0,515.0,515.0
0.005,6,10,1779,5,928,1.0,660.0,660.0,5,851,1.0,583.0,583.0
0.007,6,10,1689,5,839,1.0,571.0,571.0,5,850,1.0,582.0,582.0
0.176,6,10,1506,5,395,39.0,127.0,127.0,5,1111,26.0,843.0,843.0
40.051,17,10,676,5,460,10011.0,104.0,64.0,5,216,10011.0,20.0,15.0
0.005,6,10,2006,5,927,1.0,659.0,659.0,5,1079,1.0,811.0,811.0
0.005,6,10,1854,5,889,1.0,621.0,621.0,5,965,1.0,697.0,697.0
0.031,17,2,132,1,58,0.0,30.0,30.0,1,74,0.0,46.0,46.0
0.008,6,13,3735,7,497,1.0,125.0,125.0,6,3238,1.0,1470.0,1459.0
0.093,6,10,1506,5,395,17.0,127.0,127.0,5,1111,19.0,843.0,843.0
0.018,6,10,1989,5,910,4.0,642.0,642.0,5,1079,4.0,811.0,811.0
354.012,6,21,1795,16,1030,23600.0,190.0,190.0,5,765,60002.0,464.0,248.0
240.081,6,16,4482,9,963,30010.0,238.0,166.0,7,3519,40013.0,1402.0,786.0
40.063,17,10,676,5,460,10014.0,104.0,64.0,5,216,10015.0,20.0,15.0
0.04,17,2,148,1,60,0.0,32.0,32.0,1,88,0.0,60.0,60.0
0.081,6,10,1506,5,395,18.0,127.0,127.0,5,1111,14.0,843.0,843.0
372.45,6,22,2313,16,867,24830.0,195.0,195.0,6,1446,4691.0,419.0,398.0
0.011,6,10,1989,5,910,2.0,642.0,642.0,5,1079,2.0,811.0,811.0
0.004,6,10,2007,5,928,1.0,660.0,660.0,5,1079,1.0,811.0,811.0
0.006,6,10,1689,5,839,1.0,571.0,571.0,5,850,1.0,582.0,582.0
0.006,6,10,1689,5,839,1.0,571.0,571.0,5,850,1.0,582.0,582.0
0.004,6,10,2000,5,927,1.0,659.0,659.0,5,1073,1.0,805.0,805.0
0.07,6,10,1506,5,395,15.0,127.0,127.0,5,1111,13.0,843.0,843.0
0.005,6,10,1854,5,889,1.0,621.0,621.0,5,965,1.0,697.0,697.0
0.006,6,10,1989,5,927,1.0,659.0,659.0,5,1062,1.0,794.0,794.0
0.005,17,4,284,2,120,0.0,32.0,32.0,2,164,1.0,60.0,54.0
0.014,6,10,1990,5,911,3.0,643.0,643.0,5,1079,3.0,811.0,811.0
0.043,17,2,152,1,76,0.0,48.0,48.0,1,76,0.0,48.0,48.0
0.082,6,10,1506,5,395,17.0,127.0,127.0,5,1111,18.0,843.0,843.0
0.005,6,10,1547,5,764,1.0,496.0,496.0,5,783,1.0,515.0,515.0
0.004,17,2,208,1,72,0.0,44.0,44.0,1,136,0.0,108.0,108.0
0.009,6,10,1989,5,910,2.0,642.0,642.0,5,1079,2.0,811.0,811.0
0.103,6,10,1506,5,395,23.0,127.0,127.0,5,1111,21.0,843.0,843.0
167.141,17,86,12616,43,2898,3979.0,44.0,39.0,43,9718,3979.0,261.0,198.0
0.009,6,10,1989,5,910,2.0,642.0,642.0,5,1079,2.0,811.0,811.0
0.041,17,4,284,2,120,0.0,32.0,32.0,2,164,36.0,60.0,54.0
1661.66,6,321,67555,133,47203,12588.0,2720.0,410.0,188,20352,8885.0,1360.0,145.0
164.467,17,76,10998,38,2535,4444.0,44.0,38.0,38,8463,4444.0,261.0,194.0
0.004,6,10,2006,5,927,1.0,659.0,659.0,5,1079,1.0,811.0,811.0
0.003,17,4,284,2,120,0.0,32.0,32.0,2,164,0.0,60.0,54.0
0.009,6,10,1990,5,911,2.0,643.0,643.0,5,1079,2.0,811.0,811.0
0.019,6,10,1972,5,910,4.0,642.0,642.0,5,1062,4.0,794.0,794.0
0.014,6,10,1631,5,848,3.0,580.0,580.0,5,783,3.0,515.0,515.0
0.004,6,10,2000,5,927,1.0,659.0,659.0,5,1073,1.0,805.0,805.0
292.665,6,393,348293,191,21505,1540.0,2736.0,889.0,202,326788,1456.0,2804.0,1682.0
0.011,6,10,1972,5,910,2.0,642.0,642.0,5,1062,2.0,794.0,794.0
0.005,17,2,170,1,65,0.0,37.0,37.0,1,105,0.0,77.0,77.0
0.695,6,25,5459,12,1557,53.0,325.0,152.0,13,3902,49.0,1414.0,563.0
0.148,6,10,1506,5,395,34.0,127.0,127.0,5,1111,33.0,843.0,843.0
0.147,6,10,1506,5,395,30.0,127.0,127.0,5,1111,35.0,843.0,843.0
1781.468,6,90,4839,46,2473,39587.0,27.0,27.0,44,2366,41428.0,27.0,26.0
0.005,6,10,1989,5,927,1.0,659.0,659.0,5,1062,1.0,794.0,794.0
0.085,6,10,1506,5,395,17.0,127.0,127.0,5,1111,17.0,843.0,843.0
0.009,6,10,1972,5,910,2.0,642.0,642.0,5,1062,2.0,794.0,794.0
40.056,17,10,676,5,460,10013.0,104.0,64.0,5,216,10013.0,20.0,15.0
0.121,6,10,1506,5,395,29.0,127.0,127.0,5,1111,26.0,843.0,843.0
0.039,17,4,352,2,130,1.0,37.0,37.0,2,222,1.0,89.0,83.0
0.004,17,4,284,2,120,0.0,32.0,32.0,2,164,0.0,60.0,54.0
0.006,6,14,3799,7,509,1.0,137.0,137.0,7,3290,1.0,1448.0,972.0
0.005,17,2,164,1,74,0.0,46.0,46.0,1,90,0.0,62.0,62.0
311.903,17,20,1124,10,716,34642.0,48.0,43.0,10,408,34642.0,20.0,12.0
1772.268,6,105,6270,60,3525,30037.0,27.0,27.0,45,2745,40277.0,27.0,27.0
0.081,6,10,1506,5,395,19.0,127.0,127.0,5,1111,18.0,843.0,843.0
15.071,17,15,8000,8,5910,2149.0,1350.0,710.0,7,2090,2507.0,1350.0,270.0
0.005,6,10,2006,5,927,1.0,659.0,659.0,5,1079,1.0,811.0,811.0
0.003,17,2,148,1,60,0.0,32.0,32.0,1,88,0.0,60.0,60.0
0.001,17,2,180,1,66,0.0,38.0,38.0,1,114,0.0,86.0,86.0
0.006,6,10,1989,5,927,1.0,659.0,659.0,5,1062,1.0,794.0,794.0
0.216,17,4,352,2,130,144.0,37.0,37.0,2,222,176.0,89.0,83.0
0.006,17,2,166,1,75,0.0,47.0,47.0,1,91,0.0,63.0,63.0
0.009,6,12,1926,6,1189,1.0,659.0,434.0,6,737,1.0,417.0,417.0
0.001,17,2,180,1,66,0.0,38.0,38.0,1,114,0.0,86.0,86.0
0.013,6,10,1631,5,848,3.0,580.0,580.0,5,783,3.0,515.0,515.0
0.004,17,2,148,1,60,0.0,32.0,32.0,1,88,0.0,60.0,60.0
0.006,17,2,170,1,65,0.0,37.0,37.0,1,105,0.0,77.0,77.0
0.005,6,10,1547,5,764,1.0,496.0,496.0,5,783,1.0,515.0,515.0
0.02,6,10,1990,5,911,4.0,643.0,643.0,5,1079,5.0,811.0,811.0
174.3,17,88,12883,44,2961,4053.0,44.0,39.0,44,9922,4053.0,261.0,197.0
0.085,6,10,1506,5,395,20.0,127.0,127.0,5,1111,18.0,843.0,843.0
40.059,17,10,676,5,460,10012.0,104.0,64.0,5,216,10014.0,20.0,15.0
0.007,17,2,162,1,65,0.0,37.0,37.0,1,97,0.0,69.0,69.0
15.071,17,15,9238,8,6902,2149.0,1350.0,834.0,7,2336,2507.0,1350.0,305.0
0.005,6,10,1547,5,764,1.0,496.0,496.0,5,783,1.0,515.0,515.0
171.132,17,78,10943,39,2592,4503.0,44.0,38.0,39,8351,4503.0,239.0,186.0
0.006,6,10,1547,5,764,1.0,496.0,496.0,5,783,1.0,515.0,515.0
0.005,6,10,1689,5,839,1.0,571.0,571.0,5,850,1.0,582.0,582.0
0.001,17,2,136,1,60,0.0,32.0,32.0,1,76,0.0,48.0,48.0
0.006,6,10,1854,5,889,1.0,621.0,621.0,5,965,1.0,697.0,697.0
288.997,6,318,343692,114,17479,2557.0,2736.0,888.0,204,326213,1423.0,2804.0,1661.0
10.876,17,28,4422,14,1994,827.0,269.0,114.0,14,2428,827.0,587.0,145.0
0.053,17,2,152,1,76,0.0,48.0,48.0,1,76,0.0,48.0,48.0
0.009,6,10,1689,5,839,2.0,571.0,571.0,5,850,2.0,582.0,582.0
0.074,6,10,1506,5,395,16.0,127.0,127.0,5,1111,17.0,843.0,843.0
0.006,6,10,1689,5,839,1.0,571.0,571.0,5,850,1.0,582.0,582.0
0.107,6,10,1506,5,395,23.0,127.0,127.0,5,1111,24.0,843.0,843.0
0.122,6,10,1506,5,395,29.0,127.0,127.0,5,1111,27.0,843.0,843.0
300.604,6,37,8366,20,1934,15821.0,755.0,275.0,17,6432,529.0,2720.0,478.0
0.193,6,45,11610,24,3251,8.0,1020.0,182.0,21,8359,9.0,1402.0,659.0
0.038,17,4,284,2,120,0.0,32.0,32.0,2,164,35.0,60.0,54.0
0.009,6,13,3735,7,497,1.0,125.0,125.0,6,3238,1.0,1470.0,1459.0
0.083,6,10,1506,5,395,19.0,127.0,127.0,5,1111,19.0,843.0,843.0
0.01,6,10,1983,5,910,2.0,642.0,642.0,5,1073,2.0,805.0,805.0
11.041,17,28,4420,14,1995,840.0,270.0,114.0,14,2425,840.0,588.0,145.0
31.869,6,87,67163,45,39334,724.0,2804.0,1479.0,42,27829,175.0,2804.0,1281.0
0.094,6,10,1506,5,395,20.0,127.0,127.0,5,1111,20.0,843.0,843.0
0.018,6,10,1990,5,911,4.0,643.0,643.0,5,1079,4.0,811.0,811.0
0.006,6,10,1689,5,839,1.0,571.0,571.0,5,850,1.0,582.0,582.0
0.001,17,2,136,1,60,0.0,32.0,32.0,1,76,0.0,48.0,48.0
0.107,6,10,1506,5,395,24.0,127.0,127.0,5,1111,24.0,843.0,843.0
0.007,6,10,2006,5,927,1.0,659.0,659.0,5,1079,1.0,811.0,811.0
0.005,6,10,2006,5,927,1.0,659.0,659.0,5,1079,1.0,811.0,811.0
0.024,6,10,1989,5,910,6.0,642.0,642.0,5,1079,5.0,811.0,811.0
0.007,6,10,1689,5,839,1.0,571.0,571.0,5,850,1.0,582.0,582.0
178.463,17,72,10334,36,2402,5098.0,44.0,38.0,36,7932,5098.0,239.0,192.0
0.019,6,14,3787,7,497,3.0,125.0,125.0,7,3290,3.0,1448.0,972.0
0.099,6,10,1506,5,395,20.0,127.0,127.0,5,1111,23.0,843.0,843.0
0.014,6,10,1989,5,910,3.0,642.0,642.0,5,1079,3.0,811.0,811.0
0.005,6,10,2006,5,927,1.0,659.0,659.0,5,1079,1.0,811.0,811.0
0.001,17,2,179,1,62,0.0,34.0,34.0,1,117,0.0,89.0,89.0
0.12,6,10,1506,5,395,27.0,127.0,127.0,5,1111,26.0,843.0,843.0
0.003,17,2,136,1,60,0.0,32.0,32.0,1,76,0.0,48.0,48.0
0.111,6,10,1506,5,395,24.0,127.0,127.0,5,1111,23.0,843.0,843.0
0.005,6,10,1989,5,927,1.0,659.0,659.0,5,1062,1.0,794.0,794.0
0.008,6,10,1989,5,910,1.0,642.0,642.0,5,1079,2.0,811.0,811.0
0.006,6,10,1547,5,764,1.0,496.0,496.0,5,783,1.0,515.0,515.0
0.109,6,10,1506,5,395,25.0,127.0,127.0,5,1111,26.0,843.0,843.0
0.009,6,6,716,3,458,3.0,302.0,302.0,3,258,3.0,102.0,102.0
0.012,6,10,1762,5,911,3.0,643.0,643.0,5,851,2.0,583.0,583.0
0.006,17,2,180,1,66,0.0,38.0,38.0,1,114,0.0,86.0,86.0
0.006,17,2,179,1,71,0.0,43.0,43.0,1,108,0.0,80.0,80.0
15.081,17,16,8693,8,6608,2150.0,1350.0,798.0,8,2085,2150.0,1350.0,232.0
0.005,17,2,166,1,75,0.0,47.0,47.0,1,91,0.0,63.0,63.0
0.01,6,14,3787,7,497,1.0,125.0,125.0,7,3290,1.0,1448.0,972.0
0.004,17,2,136,1,60,0.0,32.0,32.0,1,76,0.0,48.0,48.0
0.003,17,2,148,1,60,0.0,32.0,32.0,1,88,0.0,60.0,60.0
11.141,17,28,4399,14,2313,848.0,588.0,137.0,14,2086,848.0,269.0,121.0
311.914,17,20,1124,10,716,34644.0,48.0,43.0,10,408,34643.0,20.0,12.0
0.109,6,10,1506,5,395,26.0,127.0,127.0,5,1111,21.0,843.0,843.0
0.016,17,2,198,1,91,0.0,63.0,63.0,1,107,0.0,79.0,79.0
0.004,6,10,2007,5,928,1.0,660.0,660.0,5,1079,1.0,811.0,811.0
0.004,6,10,1779,5,928,1.0,660.0,660.0,5,851,1.0,583.0,583.0
0.139,6,10,1506,5,395,33.0,127.0,127.0,5,1111,32.0,843.0,843.0
0.007,6,10,1547,5,764,1.0,496.0,496.0,5,783,1.0,515.0,515.0
0.009,6,10,1990,5,911,2.0,643.0,643.0,5,1079,2.0,811.0,811.0
0.11,6,10,1506,5,395,25.0,127.0,127.0,5,1111,25.0,843.0,843.0
0.016,6,10,1983,5,910,4.0,642.0,642.0,5,1073,4.0,805.0,805.0
0.016,6,10,1983,5,910,3.0,642.0,642.0,5,1073,3.0,805.0,805.0
0.148,6,10,1506,5,395,34.0,127.0,127.0,5,1111,28.0,843.0,843.0
0.06,6,10,1972,5,910,14.0,642.0,642.0,5,1062,14.0,794.0,794.0
0.016,6,10,1989,5,910,4.0,642.0,642.0,5,1079,3.0,811.0,811.0
240.657,6,38,9101,21,2252,12031.0,693.0,225.0,17,6849,15038.0,1402.0,596.0
0.025,6,10,1677,5,827,6.0,559.0,559.0,5,850,6.0,582.0,582.0
0.004,6,10,1779,5,928,1.0,660.0,660.0,5,851,1.0,583.0,583.0
0.006,6,10,1547,5,764,1.0,496.0,496.0,5,783,1.0,515.0,515.0
0.002,17,2,136,1,60,0.0,32.0,32.0,1,76,0.0,48.0,48.0
11.216,17,28,4422,14,1995,850.0,270.0,114.0,14,2427,850.0,586.0,145.0
0.01,6,10,1762,5,911,2.0,643.0,643.0,5,851,2.0,583.0,583.0
0.017,6,10,1989,5,910,4.0,642.0,642.0,5,1079,4.0,811.0,811.0
1791.49,6,485,98733,244,87503,7371.0,421.0,368.0,241,11230,7464.0,53.0,53.0
240.084,6,16,4482,9,963,30010.0,238.0,166.0,7,3519,40013.0,1402.0,786.0
40.055,17,10,676,5,460,10013.0,104.0,64.0,5,216,10013.0,20.0,15.0
0.004,6,10,2007,5,928,1.0,660.0,660.0,5,1079,1.0,811.0,811.0
0.004,17,2,136,1,60,0.0,32.0,32.0,1,76,0.0,48.0,48.0
0.044,17,2,262,1,67,0.0,39.0,39.0,1,195,0.0,167.0,167.0
0.005,17,2,166,1,75,0.0,47.0,47.0,1,91,0.0,63.0,63.0
0.018,6,10,1677,5,827,4.0,559.0,559.0,5,850,4.0,582.0,582.0
40.061,17,10,676,5,460,10014.0,104.0,64.0,5,216,10014.0,20.0,15.0
0.006,6,10,1689,5,839,1.0,571.0,571.0,5,850,1.0,582.0,582.0
0.008,6,10,2007,5,928,2.0,660.0,660.0,5,1079,2.0,811.0,811.0
0.013,6,10,1983,5,910,3.0,642.0,642.0,5,1073,3.0,805.0,805.0
0.014,6,10,1990,5,911,3.0,643.0,643.0,5,1079,3.0,811.0,811.0
240.246,6,40,5225,19,2384,13346.0,588.0,196.0,21,2841,12012.0,580.0,217.0
0.001,17,2,166,1,75,0.0,47.0,47.0,1,91,0.0,63.0,63.0
0.001,17,2,142,1,63,0.0,35.0,35.0,1,79,0.0,51.0,51.0
0.175,17,2,152,1,76,0.0,48.0,48.0,1,76,0.0,48.0,48.0
0.005,6,13,3747,7,509,0.0,137.0,137.0,6,3238,0.0,1470.0,1459.0
0.005,6,10,1643,5,860,1.0,592.0,592.0,5,783,1.0,515.0,515.0
0.165,17,2,152,1,76,0.0,48.0,48.0,1,76,0.0,48.0,48.0
1770.538,17,92,8096,46,4048,39344.0,60.0,60.0,46,4048,39344.0,60.0,60.0
0.018,6,10,1989,5,910,4.0,642.0,642.0,5,1079,4.0,811.0,811.0
0.087,6,10,1506,5,395,20.0,127.0,127.0,5,1111,18.0,843.0,843.0
0.012,6,10,1677,5,827,3.0,559.0,559.0,5,850,2.0,582.0,582.0
0.006,17,2,225,1,65,0.0,37.0,37.0,1,160,0.0,132.0,132.0
0.006,6,10,1643,5,860,1.0,592.0,592.0,5,783,1.0,515.0,515.0
0.011,6,10,1990,5,911,2.0,643.0,643.0,5,1079,2.0,811.0,811.0
0.116,6,10,1506,5,395,26.0,127.0,127.0,5,1111,20.0,843.0,843.0
0.009,6,12,1926,6,1189,1.0,659.0,434.0,6,737,1.0,417.0,417.0
0.005,6,10,2006,5,927,1.0,659.0,659.0,5,1079,1.0,811.0,811.0
0.171,17,2,152,1,76,0.0,48.0,48.0,1,76,0.0,48.0,48.0
0.004,17,2,160,1,72,0.0,44.0,44.0,1,88,0.0,60.0,60.0
361.904,6,21,1793,16,1030,24126.0,190.0,190.0,5,763,60009.0,462.0,247.0
0.009,6,10,1989,5,910,2.0,642.0,642.0,5,1079,2.0,811.0,811.0
0.005,6,10,1989,5,927,1.0,659.0,659.0,5,1062,1.0,794.0,794.0
9.052,17,6,376,5,280,2263.0,28.0,28.0,1,96,0.0,68.0,68.0
0.009,6,10,1990,5,911,2.0,643.0,643.0,5,1079,2.0,811.0,811.0
240.492,6,37,9657,19,2174,13360.0,746.0,235.0,18,7483,14146.0,1402.0,595.0
0.006,6,10,1547,5,764,1.0,496.0,496.0,5,783,1.0,515.0,515.0
0.006,17,2,170,1,65,0.0,37.0,37.0,1,105,0.0,77.0,77.0
0.001,17,2,180,1,66,0.0,38.0,38.0,1,114,0.0,86.0,86.0
0.088,6,10,1506,5,395,20.0,127.0,127.0,5,1111,20.0,843.0,843.0
0.005,6,10,2006,5,927,1.0,659.0,659.0,5,1079,1.0,811.0,811.0
0.086,6,10,1506,5,395,20.0,127.0,127.0,5,1111,19.0,843.0,843.0
0.004,17,2,148,1,60,0.0,32.0,32.0,1,88,0.0,60.0,60.0
0.012,6,10,1990,5,911,3.0,643.0,643.0,5,1079,2.0,811.0,811.0
0.005,6,13,3690,7,452,0.0,80.0,80.0,6,3238,1.0,1470.0,1459.0
0.077,6,10,1506,5,395,17.0,127.0,127.0,5,1111,16.0,843.0,843.0
0.004,17,4,284,2,120,0.0,32.0,32.0,2,164,0.0,60.0,54.0
0.072,17,4,284,2,120,1.0,32.0,32.0,2,164,67.0,60.0,54.0
0.005,17,4,284,2,120,2.0,32.0,32.0,2,164,1.0,60.0,54.0
0.004,6,10,2006,5,927,1.0,659.0,659.0,5,1079,1.0,811.0,811.0
0.005,6,10,1643,5,860,1.0,592.0,592.0,5,783,1.0,515.0,515.0
0.005,17,4,284,2,120,1.0,32.0,32.0,2,164,1.0,60.0,54.0
40.058,17,10,676,5,460,10013.0,104.0,64.0,5,216,10013.0,20.0,15.0
0.001,17,2,180,1,66,0.0,38.0,38.0,1,114,0.0,86.0,86.0
0.008,6,10,2007,5,928,2.0,660.0,660.0,5,1079,1.0,811.0,811.0
0.005,6,10,1779,5,928,1.0,660.0,660.0,5,851,1.0,583.0,583.0
0.018,6,13,3735,7,497,2.0,125.0,125.0,6,3238,3.0,1470.0,1459.0
0.004,17,2,148,1,60,0.0,32.0,32.0,1,88,0.0,60.0,60.0
0.018,6,10,1989,5,910,4.0,642.0,642.0,5,1079,4.0,811.0,811.0
0.006,6,10,1643,5,860,1.0,592.0,592.0,5,783,1.0,515.0,515.0
0.005,17,2,164,1,74,0.0,46.0,46.0,1,90,0.0,62.0,62.0
0.007,6,10,1990,5,911,1.0,643.0,643.0,5,1079,1.0,811.0,811.0
0.079,6,10,1506,5,395,17.0,127.0,127.0,5,1111,18.0,843.0,843.0
0.072,17,8,3613,4,1874,24.0,1350.0,440.0,4,1739,12.0,1350.0,406.0
0.005,6,14,3799,7,509,0.0,137.0,137.0,7,3290,0.0,1448.0,972.0
0.063,6,10,1506,5,395,13.0,127.0,127.0,5,1111,14.0,843.0,843.0
0.005,17,2,144,1,64,0.0,36.0,36.0,1,80,0.0,52.0,52.0
0.006,17,2,194,1,57,0.0,29.0,29.0,1,137,0.0,109.0,109.0
0.003,17,2,136,1,60,0.0,32.0,32.0,1,76,0.0,48.0,48.0
0.101,6,10,1506,5,395,21.0,127.0,127.0,5,1111,24.0,843.0,843.0
0.088,6,10,1506,5,395,19.0,127.0,127.0,5,1111,21.0,843.0,843.0
0.112,6,10,1506,5,395,19.0,127.0,127.0,5,1111,25.0,843.0,843.0
0.003,17,2,136,1,60,0.0,32.0,32.0,1,76,0.0,48.0,48.0
40.078,17,10,676,5,460,10018.0,104.0,64.0,5,216,10018.0,20.0,15.0
0.008,6,10,1990,5,911,2.0,643.0,643.0,5,1079,2.0,811.0,811.0
0.129,6,10,1506,5,395,29.0,127.0,127.0,5,1111,26.0,843.0,843.0
0.001,17,2,174,1,72,0.0,44.0,44.0,1,102,0.0,74.0,74.0
0.011,6,10,1972,5,910,2.0,642.0,642.0,5,1062,2.0,794.0,794.0
0.001,17,2,180,1,66,0.0,38.0,38.0,1,114,0.0,86.0,86.0
0.006,6,10,1689,5,839,1.0,571.0,571.0,5,850,1.0,582.0,582.0
0.039,17,2,146,1,65,0.0,37.0,37.0,1,81,0.0,53.0,53.0
0.012,6,10,1989,5,910,3.0,642.0,642.0,5,1079,3.0,811.0,811.0
1798.52,17,2851,218354,1417,114852,1270.0,84.0,53.0,1434,103502,1255.0,227.0,44.0
240.271,6,26,8388,12,2265,21842.0,1156.0,411.0,14,6123,18482.0,1592.0,598.0
240.215,6,51,7078,25,3423,10008.0,588.0,211.0,26,3655,9608.0,580.0,191.0
0.005,6,10,2006,5,927,1.0,659.0,659.0,5,1079,1.0,811.0,811.0
0.01,6,10,1972,5,910,2.0,642.0,642.0,5,1062,2.0,794.0,794.0
300.277,6,16,2170,9,684,37513.0,146.0,146.0,7,1486,50018.0,419.0,398.0
240.087,6,16,4482,9,963,30010.0,238.0,166.0,7,3519,40014.0,1402.0,786.0
0.038,17,2,156,1,64,0.0,36.0,36.0,1,92,0.0,64.0,64.0
0.005,6,14,3799,7,509,0.0,137.0,137.0,7,3290,0.0,1448.0,972.0
0.006,6,10,1854,5,889,1.0,621.0,621.0,5,965,1.0,697.0,697.0
0.005,6,10,2006,5,927,1.0,659.0,659.0,5,1079,1.0,811.0,811.0
0.004,17,2,136,1,60,0.0,32.0,32.0,1,76,0.0,48.0,48.0
0.006,6,10,1547,5,764,1.0,496.0,496.0,5,783,1.0,515.0,515.0
0.006,6,14,3742,8,504,0.0,80.0,80.0,6,3238,1.0,1470.0,1459.0
0.006,6,10,1547,5,764,1.0,496.0,496.0,5,783,1.0,515.0,515.0
40.061,17,10,676,5,460,10014.0,104.0,64.0,5,216,10014.0,20.0,15.0
0.083,6,10,1506,5,395,18.0,127.0,127.0,5,1111,17.0,843.0,843.0
0.79,6,10,2009,6,1655,158.0,1403.0,1403.0,4,354,186.0,182.0,182.0
0.001,17,2,180,1,66,0.0,38.0,38.0,1,114,0.0,86.0,86.0
0.105,6,10,1506,5,395,23.0,127.0,127.0,5,1111,24.0,843.0,843.0
0.009,6,10,1990,5,911,2.0,643.0,643.0,5,1079,2.0,811.0,811.0
0.003,17,2,148,1,60,0.0,32.0,32.0,1,88,0.0,60.0,60.0
0.023,6,10,1989,5,910,5.0,642.0,642.0,5,1079,5.0,811.0,811.0
309.324,17,20,1124,10,716,34353.0,48.0,43.0,10,408,34354.0,20.0,12.0
308.551,17,20,1124,10,716,34268.0,48.0,43.0,10,408,34268.0,20.0,12.0
0.011,6,6,716,3,458,4.0,302.0,302.0,3,258,3.0,102.0,102.0
0.015,6,10,1989,5,910,3.0,642.0,642.0,5,1079,3.0,811.0,811.0
0.041,6,10,1989,5,910,10.0,642.0,642.0,5,1079,10.0,811.0,811.0
0.081,17,2,170,1,65,0.0,37.0,37.0,1,105,0.0,77.0,77.0
0.006,6,10,1547,5,764,1.0,496.0,496.0,5,783,1.0,515.0,515.0
0.121,6,10,1506,5,395,24.0,127.0,127.0,5,1111,28.0,843.0,843.0
0.005,17,2,154,1,69,0.0,41.0,41.0,1,85,0.0,57.0,57.0
0.008,6,10,1989,5,910,2.0,642.0,642.0,5,1079,2.0,811.0,811.0
0.009,6,12,1926,6,1189,1.0,659.0,434.0,6,737,1.0,417.0,417.0
0.007,17,2,222,1,65,0.0,37.0,37.0,1,157,0.0,129.0,129.0
0.077,6,10,1506,5,395,16.0,127.0,127.0,5,1111,17.0,843.0,843.0
0.004,17,2,170,1,65,0.0,37.0,37.0,1,105,0.0,77.0,77.0
0.005,6,10,2006,5,927,1.0,659.0,659.0,5,1079,1.0,811.0,811.0
0.021,6,10,1983,5,910,5.0,642.0,642.0,5,1073,5.0,805.0,805.0
0.005,6,10,2006,5,927,1.0,659.0,659.0,5,1079,1.0,811.0,811.0
0.017,6,10,1989,5,910,4.0,642.0,642.0,5,1079,4.0,811.0,811.0
0.011,6,10,1972,5,910,2.0,642.0,642.0,5,1062,2.0,794.0,794.0
0.003,17,2,148,1,60,0.0,32.0,32.0,1,88,0.0,60.0,60.0
0.005,6,10,2007,5,928,1.0,660.0,660.0,5,1079,1.0,811.0,811.0
0.016,6,10,1677,5,827,3.0,559.0,559.0,5,850,3.0,582.0,582.0
0.001,17,2,180,1,66,0.0,38.0,38.0,1,114,0.0,86.0,86.0
309.923,17,18,1008,9,640,38727.0,48.0,43.0,9,368,38728.0,20.0,12.0
352.244,6,20,2210,6,1308,12004.0,494.0,494.0,14,902,27095.0,83.0,83.0
0.167,6,10,1506,5,395,40.0,127.0,127.0,5,1111,38.0,843.0,843.0
0.091,6,10,1506,5,395,18.0,127.0,127.0,5,1111,21.0,843.0,843.0
40.074,17,10,676,5,460,10015.0,104.0,64.0,5,216,10017.0,20.0,15.0
0.126,6,10,1506,5,395,21.0,127.0,127.0,5,1111,29.0,843.0,843.0
10.717,17,26,4102,13,1822,884.0,269.0,112.0,13,2280,884.0,587.0,147.0
0.005,6,10,2006,5,927,1.0,659.0,659.0,5,1079,1.0,811.0,811.0
0.005,6,10,2007,5,928,1.0,660.0,660.0,5,1079,1.0,811.0,811.0
0.005,6,10,1547,5,764,1.0,496.0,496.0,5,783,1.0,515.0,515.0
0.01,6,10,1983,5,910,2.0,642.0,642.0,5,1073,2.0,805.0,805.0
0.014,6,10,1972,5,910,3.0,642.0,642.0,5,1062,3.0,794.0,794.0
0.119,17,2,179,1,71,0.0,43.0,43.0,1,108,0.0,80.0,80.0
0.011,6,10,1990,5,911,2.0,643.0,643.0,5,1079,2.0,811.0,811.0
0.009,6,10,1983,5,910,2.0,642.0,642.0,5,1073,2.0,805.0,805.0
0.013,17,2,179,1,71,0.0,43.0,43.0,1,108,0.0,80.0,80.0
0.005,6,10,1547,5,764,1.0,496.0,496.0,5,783,1.0,515.0,515.0
0.086,6,10,1506,5,395,19.0,127.0,127.0,5,1111,20.0,843.0,843.0
0.12,6,10,1506,5,395,28.0,127.0,127.0,5,1111,20.0,843.0,843.0
10.861,17,28,4420,14,1995,827.0,270.0,114.0,14,2425,827.0,588.0,145.0
0.087,6,10,1506,5,395,20.0,127.0,127.0,5,1111,19.0,843.0,843.0
0.005,6,10,1547,5,764,1.0,496.0,496.0,5,783,1.0,515.0,515.0
0.005,6,10,1643,5,860,1.0,592.0,592.0,5,783,1.0,515.0,515.0
0.004,6,10,2000,5,927,1.0,659.0,659.0,5,1073,1.0,805.0,805.0
0.017,6,10,1631,5,848,4.0,580.0,580.0,5,783,4.0,515.0,515.0
178.502,17,78,11358,39,2609,4697.0,44.0,38.0,39,8749,4697.0,261.0,196.0
0.005,6,10,1689,5,839,1.0,571.0,571.0,5,850,1.0,582.0,582.0
0.005,6,10,2006,5,927,1.0,659.0,659.0,5,1079,1.0,811.0,811.0
0.004,17,2,166,1,75,0.0,47.0,47.0,1,91,0.0,63.0,63.0
300.395,6,16,2170,9,684,37528.0,146.0,146.0,7,1486,50037.0,419.0,398.0
0.001,17,2,136,1,60,0.0,32.0,32.0,1,76,0.0,48.0,48.0
0.056,17,2,222,1,65,0.0,37.0,37.0,1,157,0.0,129.0,129.0
0.005,6,10,2006,5,927,1.0,659.0,659.0,5,1079,1.0,811.0,811.0
240.459,6,35,9948,18,1883,14142.0,555.0,187.0,17,8065,15026.0,1461.0,653.0
0.01,6,10,1989,5,910,2.0,642.0,642.0,5,1079,2.0,811.0,811.0
176.233,17,72,10334,36,2402,5035.0,44.0,38.0,36,7932,5035.0,239.0,192.0
0.007,6,12,1698,6,863,1.0,327.0,271.0,6,835,1.0,515.0,515.0
0.079,6,10,1506,5,395,18.0,127.0,127.0,5,1111,14.0,843.0,843.0
0.009,17,2,148,1,60,0.0,32.0,32.0,1,88,0.0,60.0,60.0
0.008,6,10,1677,5,827,2.0,559.0,559.0,5,850,2.0,582.0,582.0
0.012,6,10,1983,5,910,2.0,642.0,642.0,5,1073,2.0,805.0,805.0
0.007,17,2,136,1,60,0.0,32.0,32.0,1,76,0.0,48.0,48.0
0.001,17,2,146,1,65,0.0,37.0,37.0,1,81,0.0,53.0,53.0
0.005,6,14,3736,7,446,0.0,74.0,74.0,7,3290,0.0,1448.0,972.0
0.005,17,2,140,1,62,0.0,34.0,34.0,1,78,0.0,50.0,50.0
0.007,17,2,194,1,59,0.0,31.0,31.0,1,135,0.0,107.0,107.0
0.026,6,10,1677,5,827,6.0,559.0,559.0,5,850,6.0,582.0,582.0
0.005,6,10,2007,5,928,1.0,660.0,660.0,5,1079,1.0,811.0,811.0
0.001,17,2,180,1,66,0.0,38.0,38.0,1,114,0.0,86.0,86.0
0.005,17,2,144,1,64,0.0,36.0,36.0,1,80,0.0,52.0,52.0
0.288,17,53,28608,28,24898,10.0,1350.0,861.0,25,3710,10.0,1350.0,120.0
0.005,6,10,1643,5,860,1.0,592.0,592.0,5,783,1.0,515.0,515.0
0.005,6,10,1989,5,927,1.0,659.0,659.0,5,1062,1.0,794.0,794.0
240.096,6,32,9329,16,7085,16006.0,2157.0,695.0,16,2244,16006.0,580.0,175.0
0.009,6,12,1926,6,1189,1.0,659.0,434.0,6,737,1.0,417.0,417.0
0.007,6,10,1989,5,910,1.0,642.0,642.0,5,1079,1.0,811.0,811.0
177.02,17,80,11175,40,2657,4538.0,44.0,38.0,40,8518,4538.0,260.0,184.0
0.006,6,10,1854,5,889,1.0,621.0,621.0,5,965,1.0,697.0,697.0
0.017,6,14,3787,7,497,2.0,125.0,125.0,7,3290,2.0,1448.0,972.0
0.149,6,10,1506,5,395,31.0,127.0,127.0,5,1111,32.0,843.0,843.0
0.013,6,10,1990,5,911,3.0,643.0,643.0,5,1079,3.0,811.0,811.0
0.006,17,2,182,1,65,0.0,37.0,37.0,1,117,0.0,89.0,89.0
0.013,6,10,1677,5,827,3.0,559.0,559.0,5,850,3.0,582.0,582.0
0.095,6,10,1506,5,395,21.0,127.0,127.0,5,1111,22.0,843.0,843.0
0.02,17,2,198,1,91,0.0,63.0,63.0,1,107,0.0,79.0,79.0
0.013,6,10,1990,5,911,3.0,643.0,643.0,5,1079,3.0,811.0,811.0
0.012,6,10,1989,5,910,3.0,642.0,642.0,5,1079,3.0,811.0,811.0
353.529,6,20,2210,6,1308,12004.0,494.0,494.0,14,902,27194.0,83.0,83.0
0.005,6,10,1989,5,927,1.0,659.0,659.0,5,1062,1.0,794.0,794.0
0.006,17,2,164,1,74,0.0,46.0,46.0,1,90,0.0,62.0,62.0
0.007,6,10,1774,5,923,1.0,655.0,655.0,5,851,1.0,583.0,583.0
0.084,6,10,1506,5,395,17.0,127.0,127.0,5,1111,18.0,843.0,843.0
0.001,17,2,179,1,62,0.0,34.0,34.0,1,117,0.0,89.0,89.0
40.075,17,10,676,5,460,10017.0,104.0,64.0,5,216,10018.0,20.0,15.0
176.435,17,90,12957,45,3017,4009.0,44.0,39.0,45,9940,4009.0,239.0,192.0
0.268,17,39,20192,21,17041,13.0,1350.0,783.0,18,3151,12.0,1350.0,147.0
0.008,6,10,1972,5,910,1.0,642.0,642.0,5,1062,2.0,794.0,794.0
0.006,6,10,1854,5,889,1.0,621.0,621.0,5,965,1.0,697.0,697.0
0.011,6,13,3735,7,497,1.0,125.0,125.0,6,3238,2.0,1470.0,1459.0
1772.595,17,120,11460,60,5460,30043.0,63.0,63.0,60,6000,30043.0,72.0,72.0
0.017,6,10,1983,5,910,4.0,642.0,642.0,5,1073,4.0,805.0,805.0
0.152,6,10,1506,5,395,34.0,127.0,127.0,5,1111,35.0,843.0,843.0
0.019,6,10,1972,5,910,4.0,642.0,642.0,5,1062,4.0,794.0,794.0
0.006,6,10,2006,5,927,1.0,659.0,659.0,5,1079,1.0,811.0,811.0
0.001,17,2,180,1,66,0.0,38.0,38.0,1,114,0.0,86.0,86.0
15.077,17,15,8121,8,6079,2149.0,1350.0,731.0,7,2042,2507.0,1350.0,263.0
0.005,17,2,170,1,65,0.0,37.0,37.0,1,105,0.0,77.0,77.0
0.024,6,10,1972,5,910,6.0,642.0,642.0,5,1062,6.0,794.0,794.0
240.694,6,35,8923,18,2071,14156.0,692.0,225.0,17,6852,15040.0,1402.0,597.0
0.001,17,2,132,1,58,0.0,30.0,30.0,1,74,0.0,46.0,46.0
0.119,6,10,1506,5,395,27.0,127.0,127.0,5,1111,28.0,843.0,843.0
63.687,6,22,7437,11,1305,102.0,530.0,277.0,11,6132,6351.0,1823.0,946.0
0.035,6,10,1983,5,910,8.0,642.0,642.0,5,1073,8.0,805.0,805.0
300.016,6,12,1782,7,1348,50002.0,494.0,494.0,5,434,75003.0,83.0,83.0
1770.311,6,83,4368,42,2210,43177.0,26.0,26.0,41,2158,44256.0,26.0,26.0
0.004,17,2,148,1,60,0.0,32.0,32.0,1,88,0.0,60.0,60.0
0.001,17,2,180,1,66,0.0,38.0,38.0,1,114,0.0,86.0,86.0
0.019,6,10,1983,5,910,4.0,642.0,642.0,5,1073,4.0,805.0,805.0
240.281,6,44,8823,22,5738,11441.0,1368.0,458.0,22,3085,11441.0,580.0,241.0
0.004,17,2,144,1,64,0.0,36.0,36.0,1,80,0.0,52.0,52.0
40.065,17,10,676,5,460,10013.0,104.0,64.0,5,216,10015.0,20.0,15.0
0.005,6,10,2006,5,927,1.0,659.0,659.0,5,1079,1.0,811.0,811.0
40.072,17,10,676,5,460,10017.0,104.0,64.0,5,216,10017.0,20.0,15.0
0.005,6,10,1643,5,860,1.0,592.0,592.0,5,783,1.0,515.0,515.0
0.016,17,2,198,1,91,0.0,63.0,63.0,1,107,0.0,79.0,79.0
0.009,6,10,2000,5,927,2.0,659.0,659.0,5,1073,2.0,805.0,805.0
0.004,17,2,412,1,61,0.0,33.0,33.0,1,351,0.0,323.0,323.0
9.036,17,6,376,5,280,2259.0,28.0,28.0,1,96,0.0,68.0,68.0
0.005,6,10,2000,5,927,1.0,659.0,659.0,5,1073,1.0,805.0,805.0
0.013,6,10,1972,5,910,3.0,642.0,642.0,5,1062,3.0,794.0,794.0
0.012,6,10,1989,5,910,3.0,642.0,642.0,5,1079,3.0,811.0,811.0
0.004,6,10,2006,5,927,1.0,659.0,659.0,5,1079,1.0,811.0,811.0
0.001,17,2,136,1,60,0.0,32.0,32.0,1,76,0.0,48.0,48.0
0.005,6,10,2007,5,928,1.0,660.0,660.0,5,1079,1.0,811.0,811.0
40.055,17,10,676,5,460,10012.0,104.0,64.0,5,216,10012.0,20.0,15.0
0.008,6,12,1926,6,1189,1.0,659.0,434.0,6,737,1.0,417.0,417.0
10.757,17,28,4421,14,1994,819.0,269.0,114.0,14,2427,818.0,586.0,145.0
0.005,17,2,164,1,74,0.0,46.0,46.0,1,90,0.0,62.0,62.0
0.016,6,10,1983,5,910,4.0,642.0,642.0,5,1073,4.0,805.0,805.0
0.01,6,14,3787,7,497,1.0,125.0,125.0,7,3290,1.0,1448.0,972.0
300.374,6,16,2170,9,684,37526.0,146.0,146.0,7,1486,50034.0,419.0,398.0
0.056,17,2,179,1,71,0.0,43.0,43.0,1,108,0.0,80.0,80.0
0.016,6,10,1762,5,911,4.0,643.0,643.0,5,851,3.0,583.0,583.0
0.011,6,10,1972,5,910,2.0,642.0,642.0,5,1062,2.0,794.0,794.0
0.117,6,10,1506,5,395,23.0,127.0,127.0,5,1111,25.0,843.0,843.0
0.085,6,10,1506,5,395,18.0,127.0,127.0,5,1111,18.0,843.0,843.0
0.006,6,10,2006,5,927,1.0,659.0,659.0,5,1079,1.0,811.0,811.0
0.005,6,10,2007,5,928,1.0,660.0,660.0,5,1079,1.0,811.0,811.0
0.178,6,10,1242,5,751,44.0,495.0,495.0,5,491,41.0,223.0,223.0
368.934,6,22,2313,16,867,24595.0,195.0,195.0,6,1446,4643.0,419.0,398.0
0.005,6,10,1854,5,889,1.0,621.0,621.0,5,965,1.0,697.0,697.0
300.039,6,12,1782,7,1348,50006.0,494.0,494.0,5,434,75009.0,83.0,83.0
0.006,6,10,1854,5,889,1.0,621.0,621.0,5,965,1.0,697.0,697.0
15.097,17,18,9860,9,7548,1883.0,1350.0,810.0,9,2312,1883.0,1350.0,228.0
0.101,6,10,1506,5,395,22.0,127.0,127.0,5,1111,13.0,843.0,843.0
0.004,17,2,144,1,64,0.0,36.0,36.0,1,80,0.0,52.0,52.0
0.012,6,10,1983,5,910,2.0,642.0,642.0,5,1073,2.0,805.0,805.0
0.091,6,10,1506,5,395,21.0,127.0,127.0,5,1111,20.0,843.0,843.0
0.073,17,4,352,2,130,2.0,37.0,37.0,2,222,34.0,89.0,83.0
366.204,6,22,2313,16,867,24413.0,195.0,195.0,6,1446,4644.0,419.0,398.0
0.004,6,10,1702,5,863,1.0,595.0,595.0,5,839,1.0,571.0,571.0
0.012,6,10,1983,5,910,3.0,642.0,642.0,5,1073,2.0,805.0,805.0
0.01,6,10,1990,5,911,2.0,643.0,643.0,5,1079,2.0,811.0,811.0
0.005,6,10,2007,5,928,1.0,660.0,660.0,5,1079,1.0,811.0,811.0
0.005,17,2,136,1,60,0.0,32.0,32.0,1,76,0.0,48.0,48.0
0.006,6,10,1547,5,764,1.0,496.0,496.0,5,783,1.0,515.0,515.0
0.004,6,14,3742,7,452,0.0,80.0,80.0,7,3290,0.0,1448.0,972.0
0.006,6,10,1989,5,927,1.0,659.0,659.0,5,1062,1.0,794.0,794.0
0.072,6,10,1506,5,395,16.0,127.0,127.0,5,1111,16.0,843.0,843.0
0.016,6,10,1989,5,910,3.0,642.0,642.0,5,1079,4.0,811.0,811.0
0.012,17,4,284,2,120,9.0,32.0,32.0,2,164,9.0,60.0,54.0
0.005,6,10,1854,5,889,1.0,621.0,621.0,5,965,1.0,697.0,697.0
0.074,6,10,1506,5,395,17.0,127.0,127.0,5,1111,17.0,843.0,843.0
0.005,6,10,1689,5,839,1.0,571.0,571.0,5,850,1.0,582.0,582.0
0.011,6,10,1989,5,910,2.0,642.0,642.0,5,1079,2.0,811.0,811.0
10.964,17,28,4399,14,2313,834.0,588.0,137.0,14,2086,834.0,269.0,121.0
0.039,17,2,412,1,61,0.0,33.0,33.0,1,351,0.0,323.0,323.0
0.001,17,2,180,1,66,0.0,38.0,38.0,1,114,0.0,86.0,86.0
0.01,6,10,1989,5,910,2.0,642.0,642.0,5,1079,2.0,811.0,811.0
0.002,17,2,180,1,66,0.0,38.0,38.0,1,114,0.0,86.0,86.0
0.005,6,13,3747,7,509,0.0,137.0,137.0,6,3238,0.0,1470.0,1459.0
0.013,6,10,1631,5,848,3.0,580.0,580.0,5,783,3.0,515.0,515.0
0.006,6,10,1547,5,764,1.0,496.0,496.0,5,783,1.0,515.0,515.0
0.072,6,10,1506,5,395,15.0,127.0,127.0,5,1111,15.0,843.0,843.0
0.014,6,10,1972,5,910,3.0,642.0,642.0,5,1062,3.0,794.0,794.0
0.003,17,4,284,2,120,0.0,32.0,32.0,2,164,0.0,60.0,54.0
0.017,6,10,1972,5,910,4.0,642.0,642.0,5,1062,4.0,794.0,794.0
0.005,6,10,2007,5,928,1.0,660.0,660.0,5,1079,1.0,811.0,811.0
300.455,6,27,7436,16,1409,20030.0,217.0,142.0,11,6027,24042.0,1679.0,778.0
0.123,6,10,1506,5,395,19.0,127.0,127.0,5,1111,29.0,843.0,843.0
0.004,17,4,284,2,120,0.0,32.0,32.0,2,164,1.0,60.0,54.0
40.059,17,10,676,5,460,10013.0,104.0,64.0,5,216,10013.0,20.0,15.0
240.085,6,16,4482,9,963,30010.0,238.0,166.0,7,3519,40013.0,1402.0,786.0
0.012,17,4,284,2,120,8.0,32.0,32.0,2,164,8.0,60.0,54.0
0.006,6,10,1547,5,764,1.0,496.0,496.0,5,783,1.0,515.0,515.0
0.001,17,2,132,1,58,0.0,30.0,30.0,1,74,0.0,46.0,46.0
0.005,6,10,2006,5,927,1.0,659.0,659.0,5,1079,1.0,811.0,811.0
0.005,6,10,2007,5,928,1.0,660.0,660.0,5,1079,1.0,811.0,811.0
0.053,17,2,152,1,76,0.0,48.0,48.0,1,76,0.0,48.0,48.0
0.005,6,10,2006,5,927,1.0,659.0,659.0,5,1079,1.0,811.0,811.0
0.008,6,10,1989,5,910,2.0,642.0,642.0,5,1079,1.0,811.0,811.0
0.001,17,2,180,1,66,0.0,38.0,38.0,1,114,0.0,86.0,86.0
0.005,6,10,1989,5,927,1.0,659.0,659.0,5,1062,1.0,794.0,794.0
0.003,17,2,148,1,60,0.0,32.0,32.0,1,88,0.0,60.0,60.0
0.005,6,13,3747,7,509,0.0,137.0,137.0,6,3238,1.0,1470.0,1459.0
11.051,17,28,4398,14,2312,841.0,587.0,137.0,14,2086,841.0,269.0,121.0
0.006,6,10,1547,5,764,1.0,496.0,496.0,5,783,1.0,515.0,515.0
0.004,6,10,1702,5,863,0.0,595.0,595.0,5,839,1.0,571.0,571.0
0.006,6,10,2007,5,928,1.0,660.0,660.0,5,1079,1.0,811.0,811.0
0.032,6,10,1677,5,827,7.0,559.0,559.0,5,850,7.0,582.0,582.0
0.203,6,16,2777,8,1395,29.0,533.0,323.0,8,1382,18.0,529.0,239.0
0.006,6,10,1689,5,839,1.0,571.0,571.0,5,850,1.0,582.0,582.0
15.078,17,15,7917,8,5900,2150.0,1350.0,709.0,7,2017,2508.0,1350.0,260.0
0.004,17,4,284,2,120,1.0,32.0,32.0,2,164,0.0,60.0,54.0
0.006,6,10,1689,5,839,1.0,571.0,571.0,5,850,1.0,582.0,582.0
0.005,17,2,179,1,71,0.0,43.0,43.0,1,108,0.0,80.0,80.0
0.003,17,2,136,1,60,0.0,32.0,32.0,1,76,0.0,48.0,48.0
0.011,6,10,1972,5,910,2.0,642.0,642.0,5,1062,2.0,794.0,794.0
0.008,6,10,1762,5,911,2.0,643.0,643.0,5,851,2.0,583.0,583.0
0.005,17,2,160,1,72,0.0,44.0,44.0,1,88,0.0,60.0,60.0
0.013,6,10,1990,5,911,3.0,643.0,643.0,5,1079,3.0,811.0,811.0
0.011,6,10,1983,5,910,2.0,642.0,642.0,5,1073,2.0,805.0,805.0
0.005,6,10,1643,5,860,1.0,592.0,592.0,5,783,1.0,515.0,515.0
0.173,6,10,1506,5,395,37.0,127.0,127.0,5,1111,38.0,843.0,843.0
0.007,17,2,169,1,62,0.0,34.0,34.0,1,107,0.0,79.0,79.0
0.016,6,10,1983,5,910,3.0,642.0,642.0,5,1073,4.0,805.0,805.0
0.089,6,10,1506,5,395,18.0,127.0,127.0,5,1111,18.0,843.0,843.0
0.005,6,10,1779,5,928,1.0,660.0,660.0,5,851,1.0,583.0,583.0
0.005,6,10,1989,5,927,1.0,659.0,659.0,5,1062,1.0,794.0,794.0
300.244,6,16,2170,9,684,37511.0,146.0,146.0,7,1486,50013.0,419.0,398.0
0.118,6,10,1506,5,395,27.0,127.0,127.0,5,1111,27.0,843.0,843.0
0.016,6,10,1983,5,910,4.0,642.0,642.0,5,1073,4.0,805.0,805.0
0.121,6,10,1506,5,395,27.0,127.0,127.0,5,1111,29.0,843.0,843.0
290.336,6,400,348612,196,21755,1488.0,2736.0,888.0,204,326857,1430.0,2916.0,1664.0
173.069,17,82,11468,41,2723,4326.0,44.0,38.0,41,8745,4326.0,261.0,185.0
0.005,6,10,2006,5,927,1.0,659.0,659.0,5,1079,1.0,811.0,811.0
0.001,17,2,166,1,75,0.0,47.0,47.0,1,91,0.0,63.0,63.0
0.072,17,4,284,2,120,0.0,32.0,32.0,2,164,68.0,60.0,54.0
0.005,6,10,2007,5,928,1.0,660.0,660.0,5,1079,1.0,811.0,811.0
0.005,6,10,2006,5,927,1.0,659.0,659.0,5,1079,1.0,811.0,811.0
0.004,6,10,2006,5,927,1.0,659.0,659.0,5,1079,1.0,811.0,811.0
0.003,17,2,136,1,60,0.0,32.0,32.0,1,76,0.0,48.0,48.0
0.004,6,10,1702,5,863,1.0,595.0,595.0,5,839,0.0,571.0,571.0
293.667,6,320,344079,125,18049,2368.0,2736.0,888.0,195,326030,1513.0,2804.0,1745.0
0.004,17,4,284,2,120,1.0,32.0,32.0,2,164,0.0,60.0,54.0
0.004,6,10,2007,5,928,1.0,660.0,660.0,5,1079,1.0,811.0,811.0
0.013,6,14,3787,7,497,2.0,125.0,125.0,7,3290,2.0,1448.0,972.0
0.005,6,10,1989,5,927,1.0,659.0,659.0,5,1062,1.0,794.0,794.0
0.122,6,10,1506,5,395,25.0,127.0,127.0,5,1111,27.0,843.0,843.0
0.02,6,13,3735,7,497,3.0,125.0,125.0,6,3238,3.0,1470.0,1459.0
0.156,6,10,1506,5,395,37.0,127.0,127.0,5,1111,36.0,843.0,843.0
0.008,17,2,194,1,59,0.0,31.0,31.0,1,135,0.0,107.0,107.0
0.004,6,10,2000,5,927,1.0,659.0,659.0,5,1073,1.0,805.0,805.0
10.988,17,28,4390,14,2311,837.0,586.0,137.0,14,2079,837.0,270.0,120.0
0.005,6,10,1989,5,927,1.0,659.0,659.0,5,1062,1.0,794.0,794.0
0.07,17,2,152,1,76,0.0,48.0,48.0,1,76,0.0,48.0,48.0
0.001,17,2,136,1,60,0.0,32.0,32.0,1,76,0.0,48.0,48.0
0.012,6,10,1972,5,910,3.0,642.0,642.0,5,1062,3.0,794.0,794.0
0.008,6,10,1989,5,910,1.0,642.0,642.0,5,1079,2.0,811.0,811.0
0.096,6,10,1506,5,395,21.0,127.0,127.0,5,1111,22.0,843.0,843.0
0.001,17,2,132,1,58,0.0,30.0,30.0,1,74,0.0,46.0,46.0
0.099,6,10,1506,5,395,21.0,127.0,127.0,5,1111,22.0,843.0,843.0
0.005,6,10,2006,5,927,1.0,659.0,659.0,5,1079,1.0,811.0,811.0
0.016,17,2,180,1,66,0.0,38.0,38.0,1,114,0.0,86.0,86.0
300.319,6,16,2170,9,684,37519.0,146.0,146.0,7,1486,50025.0,419.0,398.0
0.01,6,10,1989,5,910,2.0,642.0,642.0,5,1079,2.0,811.0,811.0
0.016,6,10,1972,5,910,4.0,642.0,642.0,5,1062,3.0,794.0,794.0
0.005,6,10,1989,5,927,1.0,659.0,659.0,5,1062,1.0,794.0,794.0
0.004,6,10,2006,5,927,1.0,659.0,659.0,5,1079,1.0,811.0,811.0
0.008,6,10,1989,5,910,1.0,642.0,642.0,5,1079,2.0,811.0,811.0
0.006,6,10,1547,5,764,1.0,496.0,496.0,5,783,1.0,515.0,515.0
0.021,6,10,1989,5,910,5.0,642.0,642.0,5,1079,5.0,811.0,811.0
0.007,17,2,179,1,71,0.0,43.0,43.0,1,108,0.0,80.0,80.0
0.035,6,10,1989,5,910,8.0,642.0,642.0,5,1079,8.0,811.0,811.0
0.009,6,10,1677,5,827,2.0,559.0,559.0,5,850,2.0,582.0,582.0
0.005,6,10,1643,5,860,1.0,592.0,592.0,5,783,1.0,515.0,515.0
0.006,6,10,1643,5,860,1.0,592.0,592.0,5,783,1.0,515.0,515.0
0.006,6,10,1854,5,889,1.0,621.0,621.0,5,965,1.0,697.0,697.0
300.828,6,41,14392,22,8834,14325.0,2720.0,1131.0,19,5558,480.0,2667.0,435.0
0.012,6,10,1990,5,911,3.0,643.0,643.0,5,1079,2.0,811.0,811.0
15.07,17,15,9238,8,6902,2148.0,1350.0,834.0,7,2336,2506.0,1350.0,305.0
0.005,17,2,168,1,76,0.0,48.0,48.0,1,92,0.0,64.0,64.0
0.011,6,10,1983,5,910,2.0,642.0,642.0,5,1073,2.0,805.0,805.0
10.906,17,28,4418,14,1995,830.0,270.0,114.0,14,2423,830.0,586.0,145.0
0.102,6,10,1506,5,395,20.0,127.0,127.0,5,1111,24.0,843.0,843.0
0.009,6,13,3735,7,497,1.0,125.0,125.0,6,3238,1.0,1470.0,1459.0
0.008,6,10,1989,5,910,2.0,642.0,642.0,5,1079,2.0,811.0,811.0
0.005,6,10,1689,5,839,1.0,571.0,571.0,5,850,1.0,582.0,582.0
0.005,6,10,2006,5,927,1.0,659.0,659.0,5,1079,1.0,811.0,811.0
0.012,6,10,1989,5,910,3.0,642.0,642.0,5,1079,3.0,811.0,811.0
0.005,17,2,209,1,64,0.0,36.0,36.0,1,145,0.0,117.0,117.0
0.006,6,10,1643,5,860,1.0,592.0,592.0,5,783,1.0,515.0,515.0
0.005,6,10,1689,5,839,1.0,571.0,571.0,5,850,1.0,582.0,582.0
0.013,6,10,1989,5,910,3.0,642.0,642.0,5,1079,3.0,811.0,811.0
0.004,17,2,148,1,60,0.0,32.0,32.0,1,88,0.0,60.0,60.0
15.073,17,11,4688,5,2268,3761.0,1350.0,425.0,6,2420,3008.0,1350.0,375.0
0.006,6,10,1547,5,764,1.0,496.0,496.0,5,783,1.0,515.0,515.0
1.311,6,32,13392,18,5893,77.0,2720.0,854.0,14,7499,87.0,2720.0,769.0
0.008,6,12,1926,6,1189,1.0,659.0,434.0,6,737,1.0,417.0,417.0
10.796,17,28,4422,14,1993,822.0,268.0,114.0,14,2429,821.0,588.0,145.0
374.336,6,37,13853,20,3451,19701.0,676.0,400.0,17,10402,19643.0,1402.0,951.0
0.014,6,10,1989,5,910,3.0,642.0,642.0,5,1079,3.0,811.0,811.0
0.006,17,2,179,1,71,0.0,43.0,43.0,1,108,0.0,80.0,80.0
0.012,6,13,3735,7,497,1.0,125.0,125.0,6,3238,2.0,1470.0,1459.0
0.001,17,2,132,1,58,0.0,30.0,30.0,1,74,0.0,46.0,46.0
0.013,6,10,1677,5,827,3.0,559.0,559.0,5,850,3.0,582.0,582.0
0.003,17,2,136,1,60,0.0,32.0,32.0,1,76,0.0,48.0,48.0
0.013,6,10,1990,5,911,3.0,643.0,643.0,5,1079,3.0,811.0,811.0
0.006,6,10,1854,5,889,1.0,621.0,621.0,5,965,1.0,697.0,697.0
40.063,17,10,676,5,460,10015.0,104.0,64.0,5,216,10015.0,20.0,15.0
0.005,6,10,1989,5,927,1.0,659.0,659.0,5,1062,1.0,794.0,794.0
0.067,6,10,1506,5,395,13.0,127.0,127.0,5,1111,14.0,843.0,843.0
0.006,6,10,2000,5,927,1.0,659.0,659.0,5,1073,1.0,805.0,805.0
0.007,17,2,179,1,71,0.0,43.0,43.0,1,108,0.0,80.0,80.0
0.008,6,10,1972,5,910,2.0,642.0,642.0,5,1062,2.0,794.0,794.0
0.001,17,2,136,1,60,0.0,32.0,32.0,1,76,0.0,48.0,48.0
0.004,6,10,1989,5,927,1.0,659.0,659.0,5,1062,1.0,794.0,794.0
0.005,6,10,2000,5,927,1.0,659.0,659.0,5,1073,1.0,805.0,805.0
0.01,6,10,1989,5,910,2.0,642.0,642.0,5,1079,2.0,811.0,811.0
0.006,6,10,1689,5,839,1.0,571.0,571.0,5,850,1.0,582.0,582.0
0.126,6,10,1506,5,395,28.0,127.0,127.0,5,1111,26.0,843.0,843.0
0.01,6,10,1990,5,911,2.0,643.0,643.0,5,1079,2.0,811.0,811.0
0.004,6,10,2006,5,927,1.0,659.0,659.0,5,1079,1.0,811.0,811.0
0.129,17,2,80,1,32,0.0,4.0,4.0,1,48,0.0,20.0,20.0
0.012,6,10,1990,5,911,3.0,643.0,643.0,5,1079,2.0,811.0,811.0
0.006,6,10,2000,5,927,1.0,659.0,659.0,5,1073,1.0,805.0,805.0
0.013,6,10,1989,5,910,3.0,642.0,642.0,5,1079,3.0,811.0,811.0
0.074,6,10,1506,5,395,16.0,127.0,127.0,5,1111,17.0,843.0,843.0
0.017,6,10,1631,5,848,4.0,580.0,580.0,5,783,4.0,515.0,515.0
1770.567,17,120,11460,60,5460,30009.0,63.0,63.0,60,6000,30009.0,72.0,72.0
0.013,6,10,1989,5,910,3.0,642.0,642.0,5,1079,3.0,811.0,811.0
0.004,6,10,1779,5,928,1.0,660.0,660.0,5,851,1.0,583.0,583.0
240.086,6,16,4481,9,963,30010.0,238.0,166.0,7,3518,40013.0,1402.0,786.0
0.741,6,25,5459,12,1557,57.0,325.0,152.0,13,3902,52.0,1414.0,563.0
0.006,6,10,1547,5,764,1.0,496.0,496.0,5,783,1.0,515.0,515.0
0.005,6,10,1643,5,860,1.0,592.0,592.0,5,783,1.0,515.0,515.0
0.015,6,10,1677,5,827,3.0,559.0,559.0,5,850,3.0,582.0,582.0
0.011,6,10,1990,5,911,2.0,643.0,643.0,5,1079,2.0,811.0,811.0
0.009,6,10,1762,5,911,2.0,643.0,643.0,5,851,2.0,583.0,583.0
0.004,17,4,284,2,120,0.0,32.0,32.0,2,164,0.0,60.0,54.0
11.124,17,28,4422,14,1994,843.0,269.0,114.0,14,2428,842.0,587.0,145.0
0.006,6,10,1854,5,889,1.0,621.0,621.0,5,965,1.0,697.0,697.0
40.074,17,10,676,5,460,10016.0,104.0,64.0,5,216,10017.0,20.0,15.0
0.005,6,10,1989,5,927,1.0,659.0,659.0,5,1062,1.0,794.0,794.0
0.086,6,10,1506,5,395,19.0,127.0,127.0,5,1111,17.0,843.0,843.0
0.001,17,2,180,1,66,0.0,38.0,38.0,1,114,0.0,86.0,86.0
0.011,6,10,1762,5,911,2.0,643.0,643.0,5,851,2.0,583.0,583.0
0.007,6,10,1854,5,889,1.0,621.0,621.0,5,965,1.0,697.0,697.0
0.005,6,10,2007,5,928,1.0,660.0,660.0,5,1079,1.0,811.0,811.0
0.164,17,2,152,1,76,0.0,48.0,48.0,1,76,0.0,48.0,48.0
0.074,6,10,1506,5,395,16.0,127.0,127.0,5,1111,14.0,843.0,843.0
0.13,17,2,170,1,65,0.0,37.0,37.0,1,105,0.0,77.0,77.0
0.128,17,2,182,1,65,0.0,37.0,37.0,1,117,0.0,89.0,89.0
15.075,17,14,9191,8,6902,2149.0,1350.0,834.0,6,2289,3009.0,1350.0,353.0
0.01,6,10,1989,5,910,2.0,642.0,642.0,5,1079,2.0,811.0,811.0
0.207,17,2,80,1,32,0.0,4.0,4.0,1,48,0.0,20.0,20.0
0.077,6,10,1506,5,395,15.0,127.0,127.0,5,1111,16.0,843.0,843.0
0.139,6,10,1506,5,395,31.0,127.0,127.0,5,1111,20.0,843.0,843.0
0.012,6,10,1990,5,911,3.0,643.0,643.0,5,1079,2.0,811.0,811.0
1778.934,17,143,45188,72,22752,25046.0,288.0,288.0,71,22436,25412.0,288.0,288.0
0.07,17,8,3613,4,1874,23.0,1350.0,440.0,4,1739,12.0,1350.0,406.0
0.006,17,2,179,1,71,0.0,43.0,43.0,1,108,0.0,80.0,80.0
0.01,6,10,1989,5,910,2.0,642.0,642.0,5,1079,2.0,811.0,811.0
300.388,6,16,2170,9,684,37527.0,146.0,146.0,7,1486,50036.0,419.0,398.0
0.005,6,14,3799,7,509,0.0,137.0,137.0,7,3290,0.0,1448.0,972.0
167.187,17,88,12637,44,2961,3887.0,44.0,39.0,44,9676,3888.0,261.0,191.0
0.005,6,10,2006,5,927,1.0,659.0,659.0,5,1079,1.0,811.0,811.0
0.098,6,10,1506,5,395,21.0,127.0,127.0,5,1111,23.0,843.0,843.0
0.066,6,10,1506,5,395,15.0,127.0,127.0,5,1111,13.0,843.0,843.0
0.004,6,10,2006,5,927,1.0,659.0,659.0,5,1079,1.0,811.0,811.0
0.004,6,10,1702,5,863,1.0,595.0,595.0,5,839,1.0,571.0,571.0
0.005,6,10,1689,5,839,1.0,571.0,571.0,5,850,1.0,582.0,582.0
40.06,17,10,676,5,460,10014.0,104.0,64.0,5,216,10014.0,20.0,15.0
0.03,6,10,1989,5,910,7.0,642.0,642.0,5,1079,7.0,811.0,811.0
0.006,6,10,1854,5,889,1.0,621.0,621.0,5,965,1.0,697.0,697.0
0.128,6,10,1506,5,395,30.0,127.0,127.0,5,1111,29.0,843.0,843.0
5.468,6,38,25525,18,15988,321.0,2804.0,2149.0,20,9537,281.0,1288.0,1212.0
353.28,6,20,2210,6,1308,12005.0,494.0,494.0,14,902,27175.0,83.0,83.0
0.005,6,10,1779,5,928,1.0,660.0,660.0,5,851,1.0,583.0,583.0
0.005,6,10,2000,5,927,1.0,659.0,659.0,5,1073,1.0,805.0,805.0
15.07,17,15,9238,8,6902,2149.0,1350.0,834.0,7,2336,2507.0,1350.0,305.0
40.068,17,10,676,5,460,10015.0,104.0,64.0,5,216,10016.0,20.0,15.0
0.087,6,10,1506,5,395,18.0,127.0,127.0,5,1111,17.0,843.0,843.0
0.029,6,10,1989,5,910,7.0,642.0,642.0,5,1079,7.0,811.0,811.0
0.013,6,10,1990,5,911,3.0,643.0,643.0,5,1079,3.0,811.0,811.0
0.011,6,10,1983,5,910,2.0,642.0,642.0,5,1073,2.0,805.0,805.0
0.006,17,2,169,1,62,0.0,34.0,34.0,1,107,0.0,79.0,79.0
0.018,6,10,1631,5,848,4.0,580.0,580.0,5,783,4.0,515.0,515.0
0.005,6,10,1689,5,839,1.0,571.0,571.0,5,850,1.0,582.0,582.0
0.004,6,10,2006,5,927,1.0,659.0,659.0,5,1079,1.0,811.0,811.0
240.096,6,16,4481,9,963,30012.0,238.0,166.0,7,3518,40015.0,1402.0,786.0
0.079,6,10,1506,5,395,17.0,127.0,127.0,5,1111,18.0,843.0,843.0
0.005,17,2,170,1,65,0.0,37.0,37.0,1,105,0.0,77.0,77.0
0.079,6,10,1506,5,395,18.0,127.0,127.0,5,1111,17.0,843.0,843.0
0.012,6,10,1631,5,848,2.0,580.0,580.0,5,783,3.0,515.0,515.0
0.014,6,10,1989,5,910,3.0,642.0,642.0,5,1079,3.0,811.0,811.0
0.012,6,10,1990,5,911,3.0,643.0,643.0,5,1079,2.0,811.0,811.0
240.095,6,16,4481,9,963,30011.0,238.0,166.0,7,3518,40015.0,1402.0,786.0
0.008,6,10,1989,5,910,2.0,642.0,642.0,5,1079,2.0,811.0,811.0
0.01,6,10,1990,5,911,2.0,643.0,643.0,5,1079,2.0,811.0,811.0
0.004,17,4,284,2,120,0.0,32.0,32.0,2,164,0.0,60.0,54.0
0.001,17,2,166,1,75,0.0,47.0,47.0,1,91,0.0,63.0,63.0
0.004,6,10,1989,5,927,1.0,659.0,659.0,5,1062,1.0,794.0,794.0
0.006,6,10,1547,5,764,1.0,496.0,496.0,5,783,1.0,515.0,515.0
0.006,6,10,1547,5,764,1.0,496.0,496.0,5,783,1.0,515.0,515.0
0.071,17,4,420,2,122,0.0,33.0,33.0,2,298,31.0,145.0,121.0
1778.864,17,143,45188,72,22752,25053.0,288.0,288.0,71,22436,25411.0,288.0,288.0
0.064,6,10,1506,5,395,13.0,127.0,127.0,5,1111,14.0,843.0,843.0
0.009,6,10,1677,5,827,2.0,559.0,559.0,5,850,2.0,582.0,582.0
0.006,6,10,1547,5,764,1.0,496.0,496.0,5,783,1.0,515.0,515.0
0.028,6,10,1972,5,910,6.0,642.0,642.0,5,1062,6.0,794.0,794.0
0.059,6,10,1506,5,395,13.0,127.0,127.0,5,1111,13.0,843.0,843.0
0.082,6,10,1506,5,395,17.0,127.0,127.0,5,1111,18.0,843.0,843.0
0.001,17,2,136,1,60,0.0,32.0,32.0,1,76,0.0,48.0,48.0
42.909,6,38,9663,19,4060,491.0,2903.0,1085.0,19,5603,2374.0,2667.0,402.0
160.06,17,76,10743,38,2537,4325.0,44.0,38.0,38,8206,4325.0,252.0,187.0
0.021,6,10,1989,5,910,5.0,642.0,642.0,5,1079,5.0,811.0,811.0
0.004,17,4,284,2,120,0.0,32.0,32.0,2,164,0.0,60.0,54.0
0.01,6,10,1990,5,911,2.0,643.0,643.0,5,1079,2.0,811.0,811.0
0.046,17,4,352,2,130,6.0,37.0,37.0,2,222,43.0,89.0,83.0
0.015,17,2,136,1,60,0.0,32.0,32.0,1,76,0.0,48.0,48.0
1761.262,6,435,65065,253,35232,6989.0,613.0,197.0,182,29833,9730.0,453.0,144.0
0.119,6,10,1506,5,395,26.0,127.0,127.0,5,1111,25.0,843.0,843.0
0.009,6,12,1926,6,1189,1.0,659.0,434.0,6,737,1.0,417.0,417.0
0.012,17,2,170,1,65,0.0,37.0,37.0,1,105,0.0,77.0,77.0
0.035,6,10,1677,5,827,8.0,559.0,559.0,5,850,8.0,582.0,582.0
0.005,17,2,230,1,68,0.0,40.0,40.0,1,162,0.0,134.0,134.0
0.087,6,10,1506,5,395,19.0,127.0,127.0,5,1111,20.0,843.0,843.0
0.129,17,2,80,1,32,0.0,4.0,4.0,1,48,0.0,20.0,20.0
300.419,6,16,2170,9,684,37531.0,146.0,146.0,7,1486,50040.0,419.0,398.0
0.163,6,10,1506,5,395,38.0,127.0,127.0,5,1111,38.0,843.0,843.0
0.001,17,2,146,1,65,0.0,37.0,37.0,1,81,0.0,53.0,53.0
0.012,6,10,1677,5,827,3.0,559.0,559.0,5,850,2.0,582.0,582.0
0.022,6,10,1990,5,911,5.0,643.0,643.0,5,1079,5.0,811.0,811.0
0.006,6,10,1547,5,764,1.0,496.0,496.0,5,783,1.0,515.0,515.0
11.29,17,28,4421,14,1993,855.0,268.0,114.0,14,2428,854.0,587.0,145.0
0.005,17,2,179,1,71,0.0,43.0,43.0,1,108,0.0,80.0,80.0
0.002,17,2,180,1,66,0.0,38.0,38.0,1,114,0.0,86.0,86.0
0.02,6,10,1972,5,910,4.0,642.0,642.0,5,1062,4.0,794.0,794.0
168.385,17,72,10223,36,2397,4810.0,44.0,38.0,36,7826,4810.0,260.0,189.0
0.004,17,2,148,1,60,0.0,32.0,32.0,1,88,0.0,60.0,60.0
1799.996,6,137,6590,76,3625,23996.0,39.0,39.0,61,2965,29996.0,35.0,35.0
0.068,17,8,3613,4,1874,22.0,1350.0,440.0,4,1739,11.0,1350.0,406.0
0.0,17,2,180,1,65,0.0,37.0,37.0,1,115,0.0,87.0,87.0
0.044,17,2,152,1,76,0.0,48.0,48.0,1,76,0.0,48.0,48.0
0.001,17,2,180,1,66,0.0,38.0,38.0,1,114,0.0,86.0,86.0
0.011,6,10,1989,5,910,2.0,642.0,642.0,5,1079,2.0,811.0,811.0
300.192,6,32,10870,17,5194,18761.0,1368.0,612.0,15,5676,21442.0,1656.0,700.0
0.118,6,10,1506,5,395,24.0,127.0,127.0,5,1111,28.0,843.0,843.0
0.013,6,10,1989,5,910,3.0,642.0,642.0,5,1079,3.0,811.0,811.0
0.009,6,10,1972,5,910,2.0,642.0,642.0,5,1062,2.0,794.0,794.0
0.003,17,2,185,1,73,0.0,45.0,45.0,1,112,0.0,84.0,84.0
373.12,58,4,288,3,216,186560.0,24.0,24.0,1,72,0.0,24.0,24.0
0.013,6,10,1972,5,910,3.0,642.0,642.0,5,1062,3.0,794.0,794.0
0.009,6,10,1989,5,910,2.0,642.0,642.0,5,1079,2.0,811.0,811.0
0.006,6,10,1547,5,764,1.0,496.0,496.0,5,783,1.0,515.0,515.0
0.229,6,10,1506,5,395,42.0,127.0,127.0,5,1111,53.0,843.0,843.0
0.004,6,10,1774,5,923,1.0,655.0,655.0,5,851,1.0,583.0,583.0
0.012,6,10,1990,5,911,3.0,643.0,643.0,5,1079,2.0,811.0,811.0
0.009,6,10,1989,5,910,2.0,642.0,642.0,5,1079,2.0,811.0,811.0
0.135,17,2,80,1,32,0.0,4.0,4.0,1,48,0.0,20.0,20.0
0.004,6,10,1774,5,923,1.0,655.0,655.0,5,851,1.0,583.0,583.0
178.187,17,84,11792,42,2799,4345.0,44.0,38.0,42,8993,4345.0,239.0,186.0
0.006,6,10,1689,5,839,1.0,571.0,571.0,5,850,1.0,582.0,582.0
0.015,6,10,1983,5,910,3.0,642.0,642.0,5,1073,3.0,805.0,805.0
0.008,6,10,1990,5,911,2.0,643.0,643.0,5,1079,2.0,811.0,811.0
240.011,6,9,787,5,488,60002.0,232.0,232.0,4,299,80002.0,83.0,83.0
0.015,6,10,1631,5,848,3.0,580.0,580.0,5,783,3.0,515.0,515.0
0.003,17,2,148,1,60,0.0,32.0,32.0,1,88,0.0,60.0,60.0
0.004,6,10,2006,5,927,1.0,659.0,659.0,5,1079,1.0,811.0,811.0
0.037,6,10,1989,5,910,9.0,642.0,642.0,5,1079,9.0,811.0,811.0
0.016,6,10,1990,5,911,4.0,643.0,643.0,5,1079,3.0,811.0,811.0
0.019,6,10,1972,5,910,4.0,642.0,642.0,5,1062,4.0,794.0,794.0
0.072,6,10,1506,5,395,15.0,127.0,127.0,5,1111,16.0,843.0,843.0
0.005,6,10,2006,5,927,1.0,659.0,659.0,5,1079,1.0,811.0,811.0
0.005,6,10,1689,5,839,1.0,571.0,571.0,5,850,1.0,582.0,582.0
0.012,6,10,1762,5,911,3.0,643.0,643.0,5,851,3.0,583.0,583.0
0.004,6,10,2007,5,928,1.0,660.0,660.0,5,1079,1.0,811.0,811.0
0.006,6,10,1989,5,927,1.0,659.0,659.0,5,1062,1.0,794.0,794.0
0.1,6,10,1506,5,395,22.0,127.0,127.0,5,1111,22.0,843.0,843.0
0.011,6,10,1983,5,910,2.0,642.0,642.0,5,1073,2.0,805.0,805.0
0.066,6,10,1506,5,395,14.0,127.0,127.0,5,1111,15.0,843.0,843.0
176.146,17,84,12112,42,2808,4296.0,44.0,38.0,42,9304,4296.0,239.0,193.0
0.006,6,10,1689,5,839,1.0,571.0,571.0,5,850,1.0,582.0,582.0
0.004,6,10,2006,5,927,1.0,659.0,659.0,5,1079,1.0,811.0,811.0
0.016,6,10,1989,5,910,4.0,642.0,642.0,5,1079,3.0,811.0,811.0
0.006,6,10,2007,5,928,1.0,660.0,660.0,5,1079,1.0,811.0,811.0
0.006,6,10,1547,5,764,1.0,496.0,496.0,5,783,1.0,515.0,515.0
0.005,17,2,170,1,65,0.0,37.0,37.0,1,105,0.0,77.0,77.0
0.067,17,8,3613,4,1874,22.0,1350.0,440.0,4,1739,11.0,1350.0,406.0
0.004,17,2,148,1,60,0.0,32.0,32.0,1,88,0.0,60.0,60.0
0.005,6,10,2006,5,927,1.0,659.0,659.0,5,1079,1.0,811.0,811.0
0.004,6,13,3747,7,509,0.0,137.0,137.0,6,3238,0.0,1470.0,1459.0
0.006,6,10,1547,5,764,1.0,496.0,496.0,5,783,1.0,515.0,515.0
178.087,17,80,11240,40,2672,4566.0,44.0,38.0,40,8568,4565.0,239.0,186.0
0.005,17,2,214,1,75,0.0,47.0,47.0,1,139,0.0,111.0,111.0
0.119,6,10,1506,5,395,25.0,127.0,127.0,5,1111,25.0,843.0,843.0
0.072,17,2,412,1,61,0.0,33.0,33.0,1,351,0.0,323.0,323.0
0.019,6,10,1972,5,910,4.0,642.0,642.0,5,1062,4.0,794.0,794.0
0.006,6,10,1547,5,764,1.0,496.0,496.0,5,783,1.0,515.0,515.0
0.095,6,10,1506,5,395,22.0,127.0,127.0,5,1111,22.0,843.0,843.0
0.005,6,10,1779,5,928,1.0,660.0,660.0,5,851,1.0,583.0,583.0
0.005,6,10,2000,5,927,1.0,659.0,659.0,5,1073,1.0,805.0,805.0
0.069,6,10,1506,5,395,15.0,127.0,127.0,5,1111,13.0,843.0,843.0
0.008,6,10,1972,5,910,2.0,642.0,642.0,5,1062,2.0,794.0,794.0
0.019,6,10,1762,5,911,4.0,643.0,643.0,5,851,4.0,583.0,583.0
0.114,6,10,1506,5,395,26.0,127.0,127.0,5,1111,25.0,843.0,843.0
0.005,6,10,2007,5,928,1.0,660.0,660.0,5,1079,1.0,811.0,811.0
0.089,6,10,1506,5,395,19.0,127.0,127.0,5,1111,21.0,843.0,843.0
0.007,6,10,1689,5,839,1.0,571.0,571.0,5,850,1.0,582.0,582.0
1783.232,6,64,7344,42,4469,43493.0,1625.0,108.0,22,2875,84907.0,1111.0,82.0
0.02,6,10,1983,5,910,5.0,642.0,642.0,5,1073,4.0,805.0,805.0
0.006,6,10,2006,5,927,1.0,659.0,659.0,5,1079,1.0,811.0,811.0
0.011,6,10,1990,5,911,2.0,643.0,643.0,5,1079,2.0,811.0,811.0
0.015,6,10,1972,5,910,3.0,642.0,642.0,5,1062,3.0,794.0,794.0
0.098,6,10,1506,5,395,23.0,127.0,127.0,5,1111,22.0,843.0,843.0
0.06,6,10,1506,5,395,14.0,127.0,127.0,5,1111,13.0,843.0,843.0
0.012,6,10,1972,5,910,3.0,642.0,642.0,5,1062,2.0,794.0,794.0
0.006,6,10,1547,5,764,1.0,496.0,496.0,5,783,1.0,515.0,515.0
0.013,6,10,1990,5,911,3.0,643.0,643.0,5,1079,3.0,811.0,811.0
0.016,6,10,1631,5,848,4.0,580.0,580.0,5,783,3.0,515.0,515.0
0.126,17,4,284,2,120,0.0,32.0,32.0,2,164,89.0,60.0,54.0
0.003,17,2,148,1,60,0.0,32.0,32.0,1,88,0.0,60.0,60.0
0.005,17,2,166,1,75,0.0,47.0,47.0,1,91,0.0,63.0,63.0
0.011,6,10,1972,5,910,2.0,642.0,642.0,5,1062,2.0,794.0,794.0
40.061,17,10,676,5,460,10014.0,104.0,64.0,5,216,10014.0,20.0,15.0
0.013,17,2,152,1,56,0.0,28.0,28.0,1,96,0.0,68.0,68.0
0.022,6,10,1989,5,910,5.0,642.0,642.0,5,1079,5.0,811.0,811.0
0.013,6,10,1631,5,848,3.0,580.0,580.0,5,783,3.0,515.0,515.0
0.008,6,10,1762,5,911,2.0,643.0,643.0,5,851,1.0,583.0,583.0
48.78,58,5,360,4,288,16260.0,24.0,24.0,1,72,0.0,24.0,24.0
0.005,17,2,230,1,68,0.0,40.0,40.0,1,162,0.0,134.0,134.0
0.012,6,10,1972,5,910,2.0,642.0,642.0,5,1062,2.0,794.0,794.0
0.008,17,2,179,1,71,0.0,43.0,43.0,1,108,0.0,80.0,80.0
0.005,17,2,214,1,75,0.0,47.0,47.0,1,139,0.0,111.0,111.0
0.005,17,2,166,1,75,0.0,47.0,47.0,1,91,0.0,63.0,63.0
242.543,6,298,343532,119,17703,2055.0,2736.0,886.0,179,325829,1362.0,2968.0,1872.0
312.107,17,20,1124,10,716,34671.0,48.0,43.0,10,408,34671.0,20.0,12.0
5.183,6,23,6467,13,1827,431.0,801.0,282.0,10,4640,575.0,1925.0,824.0
0.194,6,45,11694,24,3314,8.0,1083.0,187.0,21,8380,9.0,1402.0,606.0
0.009,6,12,1926,6,1189,1.0,659.0,434.0,6,737,1.0,417.0,417.0
0.005,6,10,2000,5,927,1.0,659.0,659.0,5,1073,1.0,805.0,805.0
0.06,17,2,152,1,76,0.0,48.0,48.0,1,76,0.0,48.0,48.0
0.009,6,10,2006,5,927,2.0,659.0,659.0,5,1079,2.0,811.0,811.0
0.003,17,2,136,1,60,0.0,32.0,32.0,1,76,0.0,48.0,48.0
0.001,17,2,166,1,75,0.0,47.0,47.0,1,91,0.0,63.0,63.0
291.019,6,416,349374,205,22231,1426.0,2736.0,889.0,211,327143,1385.0,2804.0,1604.0
1787.192,6,273,25550,137,8976,13141.0,747.0,263.0,136,16574,13238.0,1626.0,73.0
0.004,6,10,2006,5,927,1.0,659.0,659.0,5,1079,1.0,811.0,811.0
0.001,17,2,180,1,66,0.0,38.0,38.0,1,114,0.0,86.0,86.0
361.828,6,19,1689,15,978,25844.0,190.0,190.0,4,711,80014.0,495.0,495.0
241.334,6,405,348805,195,21662,1243.0,2736.0,959.0,210,327143,1154.0,2804.0,1581.0
308.802,17,20,1124,10,716,34297.0,48.0,43.0,10,408,34297.0,20.0,12.0
0.005,6,10,2000,5,927,1.0,659.0,659.0,5,1073,1.0,805.0,805.0
0.105,6,10,1506,5,395,20.0,127.0,127.0,5,1111,24.0,843.0,843.0
40.098,17,10,676,5,460,10023.0,104.0,64.0,5,216,10023.0,20.0,15.0
0.124,17,2,80,1,32,0.0,4.0,4.0,1,48,0.0,20.0,20.0
0.017,6,10,1972,5,910,4.0,642.0,642.0,5,1062,4.0,794.0,794.0
0.004,6,10,2007,5,928,1.0,660.0,660.0,5,1079,1.0,811.0,811.0
0.004,17,2,148,1,60,0.0,32.0,32.0,1,88,0.0,60.0,60.0
0.014,6,10,1972,5,910,3.0,642.0,642.0,5,1062,3.0,794.0,794.0
0.078,17,2,152,1,76,0.0,48.0,48.0,1,76,0.0,48.0,48.0
0.014,6,10,1677,5,827,3.0,559.0,559.0,5,850,3.0,582.0,582.0
0.005,6,10,2006,5,927,1.0,659.0,659.0,5,1079,1.0,811.0,811.0
0.008,6,10,1972,5,910,1.0,642.0,642.0,5,1062,2.0,794.0,794.0
1778.675,17,144,45504,72,22752,25051.0,288.0,288.0,72,22752,25051.0,288.0,288.0
40.066,17,10,676,5,460,10015.0,104.0,64.0,5,216,10015.0,20.0,15.0
0.02,6,10,1631,5,848,5.0,580.0,580.0,5,783,5.0,515.0,515.0
1729.22,6,60,4400,40,2740,44338.0,33.0,33.0,20,1660,91002.0,31.0,31.0
354.059,6,21,1795,16,1030,23603.0,190.0,190.0,5,765,60004.0,464.0,248.0
0.012,6,10,1989,5,910,2.0,642.0,642.0,5,1079,2.0,811.0,811.0
0.144,6,10,1506,5,395,29.0,127.0,127.0,5,1111,30.0,843.0,843.0
0.001,17,2,136,1,60,0.0,32.0,32.0,1,76,0.0,48.0,48.0
0.036,17,4,284,2,120,0.0,32.0,32.0,2,164,33.0,60.0,54.0
0.008,6,10,1989,5,910,2.0,642.0,642.0,5,1079,1.0,811.0,811.0
0.009,6,12,1926,6,1189,1.0,659.0,434.0,6,737,1.0,417.0,417.0
0.009,6,10,1762,5,911,2.0,643.0,643.0,5,851,2.0,583.0,583.0
40.073,17,10,676,5,460,10015.0,104.0,64.0,5,216,10017.0,20.0,15.0
0.053,17,2,152,1,76,0.0,48.0,48.0,1,76,0.0,48.0,48.0
0.011,6,10,1989,5,910,2.0,642.0,642.0,5,1079,2.0,811.0,811.0
0.009,6,10,2006,5,927,2.0,659.0,659.0,5,1079,2.0,811.0,811.0
0.005,6,10,2007,5,928,1.0,660.0,660.0,5,1079,1.0,811.0,811.0
0.126,17,4,596,2,122,83.0,33.0,33.0,2,474,46.0,323.0,209.0
240.008,6,9,787,5,488,60002.0,232.0,232.0,4,299,80002.0,83.0,83.0
0.01,6,10,1989,5,910,2.0,642.0,642.0,5,1079,2.0,811.0,811.0
0.001,17,2,180,1,66,0.0,38.0,38.0,1,114,0.0,86.0,86.0
40.066,17,10,676,5,460,10015.0,104.0,64.0,5,216,10015.0,20.0,15.0
0.015,6,10,1762,5,911,3.0,643.0,643.0,5,851,3.0,583.0,583.0
0.005,6,10,2000,5,927,1.0,659.0,659.0,5,1073,1.0,805.0,805.0
0.005,6,10,2006,5,927,1.0,659.0,659.0,5,1079,1.0,811.0,811.0
0.006,6,10,1689,5,839,1.0,571.0,571.0,5,850,1.0,582.0,582.0
0.089,6,10,1506,5,395,16.0,127.0,127.0,5,1111,16.0,843.0,843.0
0.004,6,10,1989,5,927,1.0,659.0,659.0,5,1062,1.0,794.0,794.0
0.004,6,10,2000,5,927,1.0,659.0,659.0,5,1073,1.0,805.0,805.0
0.005,6,10,1547,5,764,1.0,496.0,496.0,5,783,1.0,515.0,515.0
0.001,17,2,136,1,60,0.0,32.0,32.0,1,76,0.0,48.0,48.0
0.004,6,10,1774,5,923,1.0,655.0,655.0,5,851,1.0,583.0,583.0
0.004,6,10,1989,5,927,1.0,659.0,659.0,5,1062,1.0,794.0,794.0
40.07,17,10,676,5,460,10014.0,104.0,64.0,5,216,10016.0,20.0,15.0
0.083,6,10,1506,5,395,16.0,127.0,127.0,5,1111,18.0,843.0,843.0
0.009,6,10,1990,5,911,2.0,643.0,643.0,5,1079,2.0,811.0,811.0
0.002,17,2,136,1,60,0.0,32.0,32.0,1,76,0.0,48.0,48.0
0.014,6,10,1762,5,911,3.0,643.0,643.0,5,851,3.0,583.0,583.0
0.014,6,10,1677,5,827,3.0,559.0,559.0,5,850,3.0,582.0,582.0
300.187,6,26,7876,14,2801,23091.0,1368.0,410.0,12,5075,27289.0,1655.0,891.0
0.015,6,10,1983,5,910,3.0,642.0,642.0,5,1073,3.0,805.0,805.0
0.006,17,4,284,2,120,0.0,32.0,32.0,2,164,0.0,60.0,54.0
0.005,6,10,2006,5,927,1.0,659.0,659.0,5,1079,1.0,811.0,811.0
0.012,6,10,1677,5,827,3.0,559.0,559.0,5,850,2.0,582.0,582.0
0.004,6,10,1779,5,928,1.0,660.0,660.0,5,851,1.0,583.0,583.0
0.219,6,16,2779,8,1397,31.0,533.0,324.0,8,1382,20.0,529.0,239.0
0.011,6,10,1990,5,911,2.0,643.0,643.0,5,1079,2.0,811.0,811.0
0.006,6,10,1854,5,889,1.0,621.0,621.0,5,965,1.0,697.0,697.0
0.004,6,10,1702,5,863,1.0,595.0,595.0,5,839,1.0,571.0,571.0
0.005,6,10,1989,5,927,1.0,659.0,659.0,5,1062,1.0,794.0,794.0
0.005,6,10,2007,5,928,1.0,660.0,660.0,5,1079,1.0,811.0,811.0
0.008,6,12,1926,6,1189,1.0,659.0,434.0,6,737,1.0,417.0,417.0
0.004,6,10,2006,5,927,1.0,659.0,659.0,5,1079,1.0,811.0,811.0
0.011,6,12,1926,6,1189,2.0,659.0,434.0,6,737,2.0,417.0,417.0
1770.505,6,311,98811,190,87166,9367.0,2001.0,677.0,121,11645,14754.0,452.0,71.0
0.028,6,10,1983,5,910,7.0,642.0,642.0,5,1073,6.0,805.0,805.0
0.01,17,2,170,1,65,0.0,37.0,37.0,1,105,0.0,77.0,77.0
0.113,6,10,1506,5,395,26.0,127.0,127.0,5,1111,24.0,843.0,843.0
0.001,17,2,140,1,62,0.0,34.0,34.0,1,78,0.0,50.0,50.0
0.004,6,10,2006,5,927,1.0,659.0,659.0,5,1079,1.0,811.0,811.0
11.173,17,28,4424,14,1995,847.0,270.0,114.0,14,2429,847.0,588.0,145.0
0.012,6,10,1989,5,910,2.0,642.0,642.0,5,1079,3.0,811.0,811.0
0.056,17,2,179,1,71,0.0,43.0,43.0,1,108,0.0,80.0,80.0
0.004,17,4,284,2,120,0.0,32.0,32.0,2,164,0.0,60.0,54.0
0.004,17,2,136,1,60,0.0,32.0,32.0,1,76,0.0,48.0,48.0
0.086,6,10,1506,5,395,18.0,127.0,127.0,5,1111,18.0,843.0,843.0
0.003,17,2,136,1,60,0.0,32.0,32.0,1,76,0.0,48.0,48.0
0.005,6,10,2006,5,927,1.0,659.0,659.0,5,1079,1.0,811.0,811.0
0.185,6,10,1506,5,395,45.0,127.0,127.0,5,1111,34.0,843.0,843.0
0.005,6,10,2000,5,927,1.0,659.0,659.0,5,1073,1.0,805.0,805.0
0.013,6,10,1972,5,910,3.0,642.0,642.0,5,1062,3.0,794.0,794.0
1778.43,17,144,41760,72,22752,25048.0,288.0,288.0,72,19008,25048.0,236.0,236.0
0.14,6,10,1506,5,395,34.0,127.0,127.0,5,1111,31.0,843.0,843.0
0.004,6,10,1702,5,863,1.0,595.0,595.0,5,839,1.0,571.0,571.0
0.001,17,2,166,1,75,0.0,47.0,47.0,1,91,0.0,63.0,63.0
0.005,6,10,1689,5,839,1.0,571.0,571.0,5,850,1.0,582.0,582.0
240.641,6,35,8925,18,2073,14153.0,694.0,225.0,17,6852,15037.0,1402.0,597.0
0.038,17,2,184,1,61,0.0,33.0,33.0,1,123,0.0,95.0,95.0
0.013,6,10,1989,5,910,3.0,642.0,642.0,5,1079,3.0,811.0,811.0
0.005,17,2,230,1,68,0.0,40.0,40.0,1,162,0.0,134.0,134.0
0.008,6,10,1990,5,911,2.0,643.0,643.0,5,1079,2.0,811.0,811.0
0.005,17,2,164,1,74,0.0,46.0,46.0,1,90,0.0,62.0,62.0
0.006,17,2,179,1,71,0.0,43.0,43.0,1,108,0.0,80.0,80.0
0.171,6,3,453,2,321,171.0,241.0,241.0,1,132,0.0,92.0,92.0
0.11,6,10,1506,5,395,23.0,127.0,127.0,5,1111,22.0,843.0,843.0
0.02,6,10,1989,5,910,5.0,642.0,642.0,5,1079,4.0,811.0,811.0
0.005,6,10,2006,5,927,1.0,659.0,659.0,5,1079,1.0,811.0,811.0
0.163,17,2,152,1,76,0.0,48.0,48.0,1,76,0.0,48.0,48.0
0.114,6,10,1506,5,395,26.0,127.0,127.0,5,1111,22.0,843.0,843.0
0.005,17,2,248,1,58,0.0,30.0,30.0,1,190,0.0,162.0,162.0
0.015,6,10,1989,5,910,3.0,642.0,642.0,5,1079,3.0,811.0,811.0
0.107,6,10,1506,5,395,22.0,127.0,127.0,5,1111,23.0,843.0,843.0
0.006,6,10,1547,5,764,1.0,496.0,496.0,5,783,1.0,515.0,515.0
0.01,6,10,1989,5,910,2.0,642.0,642.0,5,1079,2.0,811.0,811.0
0.006,6,10,1689,5,839,1.0,571.0,571.0,5,850,1.0,582.0,582.0
0.077,6,10,1506,5,395,16.0,127.0,127.0,5,1111,14.0,843.0,843.0
0.021,6,10,1990,5,911,5.0,643.0,643.0,5,1079,5.0,811.0,811.0
0.01,6,10,1989,5,910,2.0,642.0,642.0,5,1079,2.0,811.0,811.0
0.009,6,10,1989,5,910,2.0,642.0,642.0,5,1079,2.0,811.0,811.0
0.005,6,10,1547,5,764,1.0,496.0,496.0,5,783,1.0,515.0,515.0
0.011,6,10,1989,5,910,2.0,642.0,642.0,5,1079,2.0,811.0,811.0
0.005,6,10,1689,5,839,1.0,571.0,571.0,5,850,1.0,582.0,582.0
0.005,6,10,2000,5,927,1.0,659.0,659.0,5,1073,1.0,805.0,805.0
0.012,6,10,1989,5,910,2.0,642.0,642.0,5,1079,2.0,811.0,811.0
0.01,6,10,1989,5,910,2.0,642.0,642.0,5,1079,2.0,811.0,811.0
0.015,17,2,144,1,64,0.0,36.0,36.0,1,80,0.0,52.0,52.0
0.061,6,10,1506,5,395,14.0,127.0,127.0,5,1111,13.0,843.0,843.0
0.084,6,10,1506,5,395,19.0,127.0,127.0,5,1111,19.0,843.0,843.0
0.006,17,2,169,1,62,0.0,34.0,34.0,1,107,0.0,79.0,79.0
0.012,6,10,1990,5,911,3.0,643.0,643.0,5,1079,3.0,811.0,811.0
0.004,17,2,136,1,60,0.0,32.0,32.0,1,76,0.0,48.0,48.0
0.006,6,10,1689,5,839,1.0,571.0,571.0,5,850,1.0,582.0,582.0
1.737,6,143,99630,72,96601,21.0,2828.0,1378.0,71,3029,21.0,177.0,177.0
0.005,6,14,3736,7,446,0.0,74.0,74.0,7,3290,0.0,1448.0,972.0
0.006,17,2,170,1,65,0.0,37.0,37.0,1,105,0.0,77.0,77.0
0.209,6,16,2778,8,1396,29.0,533.0,324.0,8,1382,18.0,529.0,239.0
15.07,17,15,9238,8,6902,2149.0,1350.0,834.0,7,2336,2506.0,1350.0,305.0
0.005,6,10,2000,5,927,1.0,659.0,659.0,5,1073,1.0,805.0,805.0
0.06,17,2,152,1,76,0.0,48.0,48.0,1,76,0.0,48.0,48.0
0.015,6,10,1990,5,911,3.0,643.0,643.0,5,1079,3.0,811.0,811.0
0.005,6,10,1779,5,928,1.0,660.0,660.0,5,851,1.0,583.0,583.0
0.009,17,2,169,1,62,0.0,34.0,34.0,1,107,0.0,79.0,79.0
0.004,6,10,1779,5,928,1.0,660.0,660.0,5,851,1.0,583.0,583.0
0.001,17,2,180,1,66,0.0,38.0,38.0,1,114,0.0,86.0,86.0
0.106,6,10,1506,5,395,21.0,127.0,127.0,5,1111,20.0,843.0,843.0
0.012,6,10,1972,5,910,3.0,642.0,642.0,5,1062,2.0,794.0,794.0
300.027,6,12,1782,7,1348,50004.0,494.0,494.0,5,434,75006.0,83.0,83.0
0.012,6,10,1677,5,827,3.0,559.0,559.0,5,850,3.0,582.0,582.0
0.003,17,2,136,1,60,0.0,32.0,32.0,1,76,0.0,48.0,48.0
0.001,17,2,194,1,57,0.0,29.0,29.0,1,137,0.0,109.0,109.0
0.004,6,10,1989,5,927,1.0,659.0,659.0,5,1062,1.0,794.0,794.0
0.004,6,10,1774,5,923,1.0,655.0,655.0,5,851,1.0,583.0,583.0
0.078,6,10,1506,5,395,17.0,127.0,127.0,5,1111,15.0,843.0,843.0
0.071,17,2,170,1,65,0.0,37.0,37.0,1,105,0.0,77.0,77.0
0.019,6,10,1989,5,910,4.0,642.0,642.0,5,1079,4.0,811.0,811.0
0.092,6,10,1506,5,395,20.0,127.0,127.0,5,1111,19.0,843.0,843.0
10.777,17,24,3782,12,1675,970.0,270.0,111.0,12,2107,970.0,586.0,147.0
0.005,6,10,1689,5,839,1.0,571.0,571.0,5,850,1.0,582.0,582.0
0.083,6,10,1506,5,395,18.0,127.0,127.0,5,1111,16.0,843.0,843.0
0.001,17,2,180,1,66,0.0,38.0,38.0,1,114,0.0,86.0,86.0
0.006,6,10,1854,5,889,1.0,621.0,621.0,5,965,1.0,697.0,697.0
0.101,6,10,1506,5,395,21.0,127.0,127.0,5,1111,23.0,843.0,843.0
172.333,17,88,12531,44,2935,4007.0,44.0,38.0,44,9596,4007.0,261.0,190.0
0.003,17,2,152,1,76,0.0,48.0,48.0,1,76,0.0,48.0,48.0
0.006,6,10,1547,5,764,1.0,496.0,496.0,5,783,1.0,515.0,515.0
0.005,6,10,2007,5,928,1.0,660.0,660.0,5,1079,1.0,811.0,811.0
15.092,17,15,8476,8,6355,2151.0,1350.0,766.0,7,2121,2510.0,1350.0,275.0
0.111,6,10,1506,5,395,25.0,127.0,127.0,5,1111,25.0,843.0,843.0
0.072,17,2,136,1,60,0.0,32.0,32.0,1,76,0.0,48.0,48.0
0.005,6,10,1547,5,764,1.0,496.0,496.0,5,783,1.0,515.0,515.0
0.005,17,2,140,1,62,0.0,34.0,34.0,1,78,0.0,50.0,50.0
0.047,6,13,3913,7,495,7.0,123.0,123.0,6,3418,9.0,1650.0,1549.0
0.004,17,2,170,1,65,0.0,37.0,37.0,1,105,0.0,77.0,77.0
0.008,6,10,1989,5,910,2.0,642.0,642.0,5,1079,1.0,811.0,811.0
0.004,17,2,136,1,60,0.0,32.0,32.0,1,76,0.0,48.0,48.0
40.053,17,10,676,5,460,10011.0,104.0,64.0,5,216,10012.0,20.0,15.0
11.035,17,28,4395,14,2312,840.0,587.0,137.0,14,2083,840.0,270.0,120.0
0.017,17,2,198,1,91,0.0,63.0,63.0,1,107,0.0,79.0,79.0
2.616,6,25,6037,14,2096,201.0,517.0,302.0,11,3941,250.0,1360.0,697.0
0.006,6,10,1854,5,889,1.0,621.0,621.0,5,965,1.0,697.0,697.0
0.005,6,10,1989,5,927,1.0,659.0,659.0,5,1062,1.0,794.0,794.0
178.333,17,76,10696,38,2533,4819.0,44.0,38.0,38,8163,4819.0,239.0,186.0
0.009,6,10,1989,5,910,2.0,642.0,642.0,5,1079,2.0,811.0,811.0
0.108,6,10,1506,5,395,23.0,127.0,127.0,5,1111,22.0,843.0,843.0
0.106,6,10,1506,5,395,21.0,127.0,127.0,5,1111,25.0,843.0,843.0
0.006,6,10,1547,5,764,1.0,496.0,496.0,5,783,1.0,515.0,515.0
0.005,6,10,2006,5,927,1.0,659.0,659.0,5,1079,1.0,811.0,811.0
0.071,17,2,144,1,64,0.0,36.0,36.0,1,80,0.0,52.0,52.0
0.562,6,26,8926,14,1587,35.0,517.0,211.0,12,7339,41.0,1288.0,839.0
0.005,6,10,1774,5,923,1.0,655.0,655.0,5,851,1.0,583.0,583.0
0.096,6,10,1506,5,395,22.0,127.0,127.0,5,1111,20.0,843.0,843.0
308.575,17,18,1008,9,640,38555.0,48.0,43.0,9,368,38555.0,20.0,12.0
0.005,17,2,180,1,66,0.0,38.0,38.0,1,114,0.0,86.0,86.0
0.01,6,10,1774,5,923,2.0,655.0,655.0,5,851,2.0,583.0,583.0
0.15,6,10,1506,5,395,33.0,127.0,127.0,5,1111,35.0,843.0,843.0
0.005,6,13,3747,7,509,0.0,137.0,137.0,6,3238,1.0,1470.0,1459.0
0.005,6,10,1774,5,923,1.0,655.0,655.0,5,851,1.0,583.0,583.0
0.078,6,10,1506,5,395,16.0,127.0,127.0,5,1111,18.0,843.0,843.0
0.016,6,10,1989,5,910,4.0,642.0,642.0,5,1079,4.0,811.0,811.0
1792.808,6,277,39032,112,22230,16150.0,2790.0,199.0,165,16802,10930.0,1360.0,130.0
0.083,6,10,1506,5,395,18.0,127.0,127.0,5,1111,16.0,843.0,843.0
0.084,6,10,1506,5,395,16.0,127.0,127.0,5,1111,18.0,843.0,843.0
0.074,6,10,1506,5,395,16.0,127.0,127.0,5,1111,14.0,843.0,843.0
0.083,6,10,1506,5,395,19.0,127.0,127.0,5,1111,16.0,843.0,843.0
0.007,6,10,1990,5,911,1.0,643.0,643.0,5,1079,1.0,811.0,811.0
0.004,6,10,2007,5,928,1.0,660.0,660.0,5,1079,1.0,811.0,811.0
0.004,6,10,2007,5,928,1.0,660.0,660.0,5,1079,1.0,811.0,811.0
0.005,17,2,170,1,65,0.0,37.0,37.0,1,105,0.0,77.0,77.0
0.005,6,10,1547,5,764,1.0,496.0,496.0,5,783,1.0,515.0,515.0
0.013,6,10,1990,5,911,3.0,643.0,643.0,5,1079,3.0,811.0,811.0
40.062,17,10,676,5,460,10014.0,104.0,64.0,5,216,10014.0,20.0,15.0
0.091,6,10,1506,5,395,20.0,127.0,127.0,5,1111,20.0,843.0,843.0
0.213,6,16,2669,8,1395,30.0,533.0,323.0,8,1274,19.0,529.0,212.0
0.01,6,10,1990,5,911,2.0,643.0,643.0,5,1079,2.0,811.0,811.0
0.01,6,10,1989,5,910,2.0,642.0,642.0,5,1079,2.0,811.0,811.0
0.005,17,2,164,1,74,0.0,46.0,46.0,1,90,0.0,62.0,62.0
0.006,6,10,1547,5,764,1.0,496.0,496.0,5,783,1.0,515.0,515.0
0.018,6,10,1983,5,910,4.0,642.0,642.0,5,1073,4.0,805.0,805.0
0.011,17,4,284,2,120,8.0,32.0,32.0,2,164,7.0,60.0,54.0
40.094,17,10,676,5,460,10020.0,104.0,64.0,5,216,10022.0,20.0,15.0
0.005,6,10,2006,5,927,1.0,659.0,659.0,5,1079,1.0,811.0,811.0
11.542,17,28,4398,14,2312,875.0,587.0,137.0,14,2086,875.0,269.0,121.0
241.39,6,376,364572,196,22195,1237.0,2736.0,958.0,180,342377,1348.0,3319.0,1958.0
0.112,6,10,1506,5,395,25.0,127.0,127.0,5,1111,26.0,843.0,843.0
0.282,17,4,352,2,130,237.0,37.0,37.0,2,222,159.0,89.0,83.0
15.169,17,20,11473,10,7822,1682.0,1350.0,754.0,10,3651,1682.0,1350.0,337.0
0.085,6,10,1506,5,395,20.0,127.0,127.0,5,1111,19.0,843.0,843.0
0.058,6,10,1506,5,395,13.0,127.0,127.0,5,1111,13.0,843.0,843.0
313.892,17,18,1008,9,640,39221.0,48.0,43.0,9,368,39221.0,20.0,12.0
0.006,6,10,1643,5,860,1.0,592.0,592.0,5,783,1.0,515.0,515.0
9.037,17,6,376,5,280,2259.0,28.0,28.0,1,96,0.0,68.0,68.0
0.012,6,13,3735,7,497,2.0,125.0,125.0,6,3238,2.0,1470.0,1459.0
0.011,6,10,1972,5,910,2.0,642.0,642.0,5,1062,2.0,794.0,794.0
0.005,6,10,2000,5,927,1.0,659.0,659.0,5,1073,1.0,805.0,805.0
0.005,6,13,3747,7,509,0.0,137.0,137.0,6,3238,1.0,1470.0,1459.0
0.013,6,10,1677,5,827,3.0,559.0,559.0,5,850,3.0,582.0,582.0
0.005,17,2,214,1,75,0.0,47.0,47.0,1,139,0.0,111.0,111.0
0.003,17,4,284,2,120,0.0,32.0,32.0,2,164,0.0,60.0,54.0
0.006,6,10,1774,5,923,1.0,655.0,655.0,5,851,1.0,583.0,583.0
1772.79,6,300,97298,185,86223,9634.0,1402.0,683.0,115,11075,15550.0,452.0,69.0
0.009,6,10,1677,5,827,2.0,559.0,559.0,5,850,2.0,582.0,582.0
0.129,17,4,352,2,130,1.0,37.0,37.0,2,222,89.0,89.0,83.0
0.006,6,10,2006,5,927,1.0,659.0,659.0,5,1079,1.0,811.0,811.0
0.006,6,10,1547,5,764,1.0,496.0,496.0,5,783,1.0,515.0,515.0
0.005,17,2,166,1,75,0.0,47.0,47.0,1,91,0.0,63.0,63.0
0.005,6,10,1689,5,839,1.0,571.0,571.0,5,850,1.0,582.0,582.0
0.004,17,4,284,2,120,0.0,32.0,32.0,2,164,1.0,60.0,54.0
0.051,6,10,1506,5,395,12.0,127.0,127.0,5,1111,12.0,843.0,843.0
0.004,6,10,2007,5,928,1.0,660.0,660.0,5,1079,1.0,811.0,811.0
40.063,17,10,676,5,460,10014.0,104.0,64.0,5,216,10015.0,20.0,15.0
293.46,6,300,343624,115,17530,2574.0,2736.0,888.0,185,326094,1594.0,2804.0,1861.0
0.271,17,2,152,1,76,0.0,48.0,48.0,1,76,0.0,48.0,48.0
0.093,6,10,1506,5,395,22.0,127.0,127.0,5,1111,20.0,843.0,843.0
0.008,6,10,1677,5,827,2.0,559.0,559.0,5,850,2.0,582.0,582.0
0.099,6,10,1506,5,395,23.0,127.0,127.0,5,1111,24.0,843.0,843.0
0.004,6,10,2006,5,927,1.0,659.0,659.0,5,1079,1.0,811.0,811.0
0.005,6,10,2007,5,928,1.0,660.0,660.0,5,1079,1.0,811.0,811.0
0.025,6,10,1972,5,910,6.0,642.0,642.0,5,1062,6.0,794.0,794.0
40.054,17,10,676,5,460,10012.0,104.0,64.0,5,216,10012.0,20.0,15.0
0.005,6,10,2006,5,927,1.0,659.0,659.0,5,1079,1.0,811.0,811.0
0.004,17,2,148,1,60,0.0,32.0,32.0,1,88,0.0,60.0,60.0
0.005,6,10,1774,5,923,1.0,655.0,655.0,5,851,1.0,583.0,583.0
0.004,6,10,1702,5,863,1.0,595.0,595.0,5,839,0.0,571.0,571.0
0.014,6,10,1989,5,910,3.0,642.0,642.0,5,1079,3.0,811.0,811.0
0.005,17,2,178,1,81,0.0,53.0,53.0,1,97,0.0,69.0,69.0
0.001,17,2,154,1,69,0.0,41.0,41.0,1,85,0.0,57.0,57.0
0.005,6,10,2006,5,927,1.0,659.0,659.0,5,1079,1.0,811.0,811.0
0.005,6,10,2006,5,927,1.0,659.0,659.0,5,1079,1.0,811.0,811.0
242.117,6,308,343278,118,17655,2069.0,2736.0,960.0,190,325623,1281.0,2804.0,1754.0
0.009,6,10,1762,5,911,2.0,643.0,643.0,5,851,2.0,583.0,583.0
0.005,6,10,1643,5,860,1.0,592.0,592.0,5,783,1.0,515.0,515.0
284.756,6,18,4584,9,963,35594.0,238.0,166.0,9,3621,35594.0,1402.0,786.0
11.213,17,28,4421,14,1994,849.0,269.0,114.0,14,2427,850.0,586.0,145.0
0.004,17,2,148,1,60,0.0,32.0,32.0,1,88,0.0,60.0,60.0
0.021,17,2,148,1,60,0.0,32.0,32.0,1,88,0.0,60.0,60.0
0.005,17,2,169,1,62,0.0,34.0,34.0,1,107,0.0,79.0,79.0
0.015,6,10,1990,5,911,3.0,643.0,643.0,5,1079,3.0,811.0,811.0
0.005,17,2,169,1,62,0.0,34.0,34.0,1,107,0.0,79.0,79.0
0.004,6,10,1989,5,927,1.0,659.0,659.0,5,1062,1.0,794.0,794.0
0.164,17,2,152,1,76,0.0,48.0,48.0,1,76,0.0,48.0,48.0
0.018,6,10,1972,5,910,4.0,642.0,642.0,5,1062,4.0,794.0,794.0
0.086,6,10,1506,5,395,18.0,127.0,127.0,5,1111,19.0,843.0,843.0
0.087,6,10,1506,5,395,19.0,127.0,127.0,5,1111,20.0,843.0,843.0
0.005,6,10,2006,5,927,1.0,659.0,659.0,5,1079,1.0,811.0,811.0
0.014,6,10,1989,5,910,3.0,642.0,642.0,5,1079,3.0,811.0,811.0
0.005,6,10,1989,5,927,1.0,659.0,659.0,5,1062,1.0,794.0,794.0
0.086,6,10,1506,5,395,19.0,127.0,127.0,5,1111,16.0,843.0,843.0
0.097,6,10,1506,5,395,20.0,127.0,127.0,5,1111,22.0,843.0,843.0
0.037,17,4,596,2,122,0.0,33.0,33.0,2,474,33.0,323.0,209.0
0.004,6,10,2006,5,927,1.0,659.0,659.0,5,1079,1.0,811.0,811.0
0.04,6,13,3816,7,578,6.0,206.0,206.0,6,3238,8.0,1470.0,1459.0
0.072,17,4,284,2,120,0.0,32.0,32.0,2,164,68.0,60.0,54.0
0.04,17,2,170,1,65,0.0,37.0,37.0,1,105,0.0,77.0,77.0
0.031,6,10,1972,5,910,7.0,642.0,642.0,5,1062,7.0,794.0,794.0
0.017,6,10,1972,5,910,4.0,642.0,642.0,5,1062,4.0,794.0,794.0
0.005,17,2,179,1,71,0.0,43.0,43.0,1,108,0.0,80.0,80.0
0.12,6,10,1506,5,395,26.0,127.0,127.0,5,1111,24.0,843.0,843.0
0.004,17,4,284,2,120,1.0,32.0,32.0,2,164,1.0,60.0,54.0
30.905,6,27,6425,15,2366,2207.0,517.0,290.0,12,4059,2808.0,1330.0,590.0
0.001,17,2,166,1,75,0.0,47.0,47.0,1,91,0.0,63.0,63.0
0.005,6,14,3742,7,452,0.0,80.0,80.0,7,3290,0.0,1448.0,972.0
0.024,6,10,1983,5,910,6.0,642.0,642.0,5,1073,5.0,805.0,805.0
0.147,6,10,1506,5,395,25.0,127.0,127.0,5,1111,29.0,843.0,843.0
0.004,17,2,144,1,64,0.0,36.0,36.0,1,80,0.0,52.0,52.0
0.006,6,10,1854,5,889,1.0,621.0,621.0,5,965,1.0,697.0,697.0
0.123,6,10,1506,5,395,25.0,127.0,127.0,5,1111,26.0,843.0,843.0
0.115,6,10,1506,5,395,23.0,127.0,127.0,5,1111,25.0,843.0,843.0
0.015,6,10,1983,5,910,3.0,642.0,642.0,5,1073,3.0,805.0,805.0
0.047,17,2,148,1,60,0.0,32.0,32.0,1,88,0.0,60.0,60.0
0.005,6,14,3799,7,509,0.0,137.0,137.0,7,3290,0.0,1448.0,972.0
0.005,17,2,178,1,65,0.0,37.0,37.0,1,113,0.0,85.0,85.0
0.016,6,10,1989,5,910,4.0,642.0,642.0,5,1079,4.0,811.0,811.0
240.349,6,32,9213,15,1783,17167.0,623.0,199.0,17,7430,15021.0,1402.0,595.0
308.458,17,20,1124,10,716,34258.0,48.0,43.0,10,408,34258.0,20.0,12.0
0.103,6,10,1506,5,395,22.0,127.0,127.0,5,1111,22.0,843.0,843.0
0.011,6,14,3787,7,497,1.0,125.0,125.0,7,3290,1.0,1448.0,972.0
0.01,6,10,1983,5,910,2.0,642.0,642.0,5,1073,2.0,805.0,805.0
0.015,6,10,1990,5,911,3.0,643.0,643.0,5,1079,3.0,811.0,811.0
0.122,6,10,1506,5,395,28.0,127.0,127.0,5,1111,14.0,843.0,843.0
0.011,6,10,1762,5,911,2.0,643.0,643.0,5,851,2.0,583.0,583.0
0.004,6,10,2007,5,928,1.0,660.0,660.0,5,1079,1.0,811.0,811.0
0.009,17,2,148,1,60,0.0,32.0,32.0,1,88,0.0,60.0,60.0
0.006,6,10,1547,5,764,1.0,496.0,496.0,5,783,1.0,515.0,515.0
40.062,17,10,676,5,460,10012.0,104.0,64.0,5,216,10014.0,20.0,15.0
0.005,6,10,2007,5,928,1.0,660.0,660.0,5,1079,1.0,811.0,811.0
0.994,6,14,3962,7,2139,124.0,1328.0,923.0,7,1823,124.0,1300.0,769.0
0.005,17,2,214,1,75,0.0,47.0,47.0,1,139,0.0,111.0,111.0
0.005,6,10,2007,5,928,1.0,660.0,660.0,5,1079,1.0,811.0,811.0
0.001,17,2,166,1,75,0.0,47.0,47.0,1,91,0.0,63.0,63.0
0.063,6,10,1506,5,395,14.0,127.0,127.0,5,1111,14.0,843.0,843.0
0.004,6,10,2006,5,927,1.0,659.0,659.0,5,1079,1.0,811.0,811.0
0.004,17,2,148,1,60,0.0,32.0,32.0,1,88,0.0,60.0,60.0
0.005,17,2,169,1,62,0.0,34.0,34.0,1,107,0.0,79.0,79.0
0.009,6,10,1989,5,910,2.0,642.0,642.0,5,1079,2.0,811.0,811.0
0.163,17,2,152,1,76,0.0,48.0,48.0,1,76,0.0,48.0,48.0
0.013,6,10,1989,5,910,3.0,642.0,642.0,5,1079,3.0,811.0,811.0
0.013,6,10,1972,5,910,3.0,642.0,642.0,5,1062,3.0,794.0,794.0
0.014,6,10,1990,5,911,3.0,643.0,643.0,5,1079,3.0,811.0,811.0
0.088,6,10,1506,5,395,19.0,127.0,127.0,5,1111,19.0,843.0,843.0
66.056,6,27,17556,15,9603,4718.0,2804.0,1469.0,12,7953,5990.0,2324.0,1220.0
0.012,6,10,1677,5,827,3.0,559.0,559.0,5,850,2.0,582.0,582.0
0.009,6,13,3747,7,509,1.0,137.0,137.0,6,3238,1.0,1470.0,1459.0
0.008,6,10,1989,5,910,2.0,642.0,642.0,5,1079,2.0,811.0,811.0
176.48,17,70,10015,35,2338,5190.0,44.0,38.0,35,7677,5190.0,239.0,191.0
40.05,17,10,676,5,460,10011.0,104.0,64.0,5,216,10011.0,20.0,15.0
0.003,17,2,148,1,60,0.0,32.0,32.0,1,88,0.0,60.0,60.0
301.07,6,37,8261,20,1830,15845.0,651.0,249.0,17,6431,557.0,2720.0,478.0
0.013,6,10,1990,5,911,3.0,643.0,643.0,5,1079,3.0,811.0,811.0
0.006,6,10,1547,5,764,1.0,496.0,496.0,5,783,1.0,515.0,515.0
0.084,6,10,1506,5,395,19.0,127.0,127.0,5,1111,20.0,843.0,843.0
0.004,17,2,148,1,60,0.0,32.0,32.0,1,88,0.0,60.0,60.0
0.015,6,10,1989,5,910,3.0,642.0,642.0,5,1079,3.0,811.0,811.0
40.061,17,10,676,5,460,10014.0,104.0,64.0,5,216,10014.0,20.0,15.0
0.04,17,2,182,1,65,0.0,37.0,37.0,1,117,0.0,89.0,89.0
0.021,17,2,144,1,64,0.0,36.0,36.0,1,80,0.0,52.0,52.0
10.959,17,28,4419,14,1995,834.0,270.0,114.0,14,2424,834.0,587.0,145.0
15.074,17,15,10568,9,8280,1880.0,1350.0,892.0,6,2288,3010.0,1350.0,353.0
0.005,6,10,2006,5,927,1.0,659.0,659.0,5,1079,1.0,811.0,811.0
0.118,6,10,1506,5,395,24.0,127.0,127.0,5,1111,24.0,843.0,843.0
0.029,6,13,3735,7,497,4.0,125.0,125.0,6,3238,5.0,1470.0,1459.0
0.006,6,10,1547,5,764,1.0,496.0,496.0,5,783,1.0,515.0,515.0
40.069,17,10,676,5,460,10015.0,104.0,64.0,5,216,10016.0,20.0,15.0
0.005,6,10,2006,5,927,1.0,659.0,659.0,5,1079,1.0,811.0,811.0
0.012,6,10,1989,5,910,3.0,642.0,642.0,5,1079,2.0,811.0,811.0
240.438,6,33,11854,16,5968,16029.0,1776.0,854.0,17,5886,15026.0,1402.0,624.0
0.014,6,13,3735,7,497,2.0,125.0,125.0,6,3238,2.0,1470.0,1459.0
0.004,17,2,214,1,75,0.0,47.0,47.0,1,139,0.0,111.0,111.0
0.005,6,10,1779,5,928,1.0,660.0,660.0,5,851,1.0,583.0,583.0
0.004,17,2,148,1,60,0.0,32.0,32.0,1,88,0.0,60.0,60.0
0.015,6,10,1972,5,910,3.0,642.0,642.0,5,1062,3.0,794.0,794.0
0.013,6,10,1989,5,910,3.0,642.0,642.0,5,1079,3.0,811.0,811.0
0.008,6,10,1702,5,863,2.0,595.0,595.0,5,839,2.0,571.0,571.0
0.149,6,10,1506,5,395,25.0,127.0,127.0,5,1111,32.0,843.0,843.0
0.058,17,2,144,1,64,0.0,36.0,36.0,1,80,0.0,52.0,52.0
15.1,17,15,8152,8,5895,2153.0,1350.0,708.0,7,2257,2511.0,1350.0,294.0
870.342,6,54,3240,31,1828,29011.0,27.0,27.0,23,1412,39559.0,27.0,27.0
0.006,6,10,1547,5,764,1.0,496.0,496.0,5,783,1.0,515.0,515.0
0.109,6,10,1506,5,395,21.0,127.0,127.0,5,1111,23.0,843.0,843.0
1791.219,6,64,7361,42,4485,43688.0,1641.0,109.0,22,2876,85287.0,1112.0,82.0
0.005,6,10,1643,5,860,1.0,592.0,592.0,5,783,1.0,515.0,515.0
0.004,17,4,284,2,120,0.0,32.0,32.0,2,164,0.0,60.0,54.0
0.006,17,2,166,1,75,0.0,47.0,47.0,1,91,0.0,63.0,63.0
1757.409,6,105,6270,60,3525,29785.0,27.0,27.0,45,2745,39940.0,27.0,27.0
0.289,6,10,1506,5,395,71.0,127.0,127.0,5,1111,43.0,843.0,843.0
1742.286,6,305,98255,187,86994,9367.0,2001.0,683.0,118,11261,14891.0,452.0,70.0
0.005,6,10,2000,5,927,1.0,659.0,659.0,5,1073,1.0,805.0,805.0
0.011,6,10,1983,5,910,2.0,642.0,642.0,5,1073,2.0,805.0,805.0
0.016,6,10,1989,5,910,3.0,642.0,642.0,5,1079,3.0,811.0,811.0
0.011,6,10,1972,5,910,2.0,642.0,642.0,5,1062,2.0,794.0,794.0
40.058,17,10,676,5,460,10012.0,104.0,64.0,5,216,10013.0,20.0,15.0
0.134,17,2,80,1,32,0.0,4.0,4.0,1,48,0.0,20.0,20.0
0.033,6,13,3735,7,497,5.0,125.0,125.0,6,3238,6.0,1470.0,1459.0
300.022,6,12,1782,7,1348,50003.0,494.0,494.0,5,434,75004.0,83.0,83.0
0.067,17,8,3613,4,1874,22.0,1350.0,440.0,4,1739,11.0,1350.0,406.0
0.014,6,10,1983,5,910,3.0,642.0,642.0,5,1073,3.0,805.0,805.0
40.066,17,10,676,5,460,10015.0,104.0,64.0,5,216,10015.0,20.0,15.0
0.079,6,10,1506,5,395,16.0,127.0,127.0,5,1111,18.0,843.0,843.0
0.04,17,2,184,1,61,0.0,33.0,33.0,1,123,0.0,95.0,95.0
0.005,6,14,3799,7,509,0.0,137.0,137.0,7,3290,0.0,1448.0,972.0
0.003,17,2,148,1,60,0.0,32.0,32.0,1,88,0.0,60.0,60.0
0.004,17,2,148,1,60,0.0,32.0,32.0,1,88,0.0,60.0,60.0
170.061,17,76,10962,38,2561,4596.0,44.0,39.0,38,8401,4596.0,239.0,193.0
0.005,6,10,2006,5,927,1.0,659.0,659.0,5,1079,1.0,811.0,811.0
0.004,6,10,2006,5,927,1.0,659.0,659.0,5,1079,1.0,811.0,811.0
0.006,17,2,230,1,68,0.0,40.0,40.0,1,162,0.0,134.0,134.0
0.08,6,10,1506,5,395,17.0,127.0,127.0,5,1111,17.0,843.0,843.0
0.004,6,10,1702,5,863,1.0,595.0,595.0,5,839,1.0,571.0,571.0
0.001,17,2,179,1,62,0.0,34.0,34.0,1,117,0.0,89.0,89.0
0.018,6,10,1990,5,911,4.0,643.0,643.0,5,1079,4.0,811.0,811.0
0.081,6,10,1506,5,395,18.0,127.0,127.0,5,1111,16.0,843.0,843.0
0.001,17,2,136,1,60,0.0,32.0,32.0,1,76,0.0,48.0,48.0
0.012,6,10,1990,5,911,3.0,643.0,643.0,5,1079,2.0,811.0,811.0
0.099,6,10,1506,5,395,23.0,127.0,127.0,5,1111,24.0,843.0,843.0
10.791,17,28,4422,14,1994,821.0,269.0,114.0,14,2428,821.0,587.0,145.0
0.018,17,2,136,1,60,0.0,32.0,32.0,1,76,0.0,48.0,48.0
0.021,6,10,1631,5,848,5.0,580.0,580.0,5,783,5.0,515.0,515.0
0.071,17,2,156,1,64,0.0,36.0,36.0,1,92,0.0,64.0,64.0
0.001,17,2,180,1,66,0.0,38.0,38.0,1,114,0.0,86.0,86.0
0.017,6,10,1989,5,910,4.0,642.0,642.0,5,1079,4.0,811.0,811.0
0.14,6,10,1506,5,395,34.0,127.0,127.0,5,1111,32.0,843.0,843.0
0.063,6,10,1506,5,395,15.0,127.0,127.0,5,1111,14.0,843.0,843.0
0.015,6,10,1631,5,848,3.0,580.0,580.0,5,783,3.0,515.0,515.0
0.012,6,10,1972,5,910,3.0,642.0,642.0,5,1062,3.0,794.0,794.0
0.123,6,10,1506,5,395,28.0,127.0,127.0,5,1111,28.0,843.0,843.0
0.013,6,10,1983,5,910,3.0,642.0,642.0,5,1073,3.0,805.0,805.0
0.013,6,10,1990,5,911,3.0,643.0,643.0,5,1079,3.0,811.0,811.0
0.015,6,10,1972,5,910,3.0,642.0,642.0,5,1062,3.0,794.0,794.0
0.018,6,10,1972,5,910,4.0,642.0,642.0,5,1062,4.0,794.0,794.0
0.074,6,10,1506,5,395,16.0,127.0,127.0,5,1111,17.0,843.0,843.0
0.005,17,2,293,1,73,0.0,45.0,45.0,1,220,0.0,192.0,192.0
0.011,6,10,1972,5,910,2.0,642.0,642.0,5,1062,2.0,794.0,794.0
0.1,6,10,1506,5,395,20.0,127.0,127.0,5,1111,20.0,843.0,843.0
0.012,6,10,1990,5,911,2.0,643.0,643.0,5,1079,3.0,811.0,811.0
0.005,6,10,2007,5,928,1.0,660.0,660.0,5,1079,1.0,811.0,811.0
0.005,6,10,1689,5,839,1.0,571.0,571.0,5,850,1.0,582.0,582.0
0.003,17,4,284,2,120,0.0,32.0,32.0,2,164,0.0,60.0,54.0
0.011,6,10,1972,5,910,2.0,642.0,642.0,5,1062,2.0,794.0,794.0
0.014,6,10,1631,5,848,3.0,580.0,580.0,5,783,3.0,515.0,515.0
0.006,6,10,1854,5,889,1.0,621.0,621.0,5,965,1.0,697.0,697.0
0.007,17,2,179,1,71,0.0,43.0,43.0,1,108,0.0,80.0,80.0
0.016,6,10,1989,5,910,4.0,642.0,642.0,5,1079,4.0,811.0,811.0
0.006,6,13,3747,7,509,0.0,137.0,137.0,6,3238,1.0,1470.0,1459.0
11.175,17,28,4422,14,1994,847.0,269.0,114.0,14,2428,846.0,587.0,145.0
0.09,6,10,1506,5,395,20.0,127.0,127.0,5,1111,19.0,843.0,843.0
0.004,6,10,2007,5,928,1.0,660.0,660.0,5,1079,1.0,811.0,811.0
0.007,17,2,148,1,60,0.0,32.0,32.0,1,88,0.0,60.0,60.0
0.005,6,10,2006,5,927,1.0,659.0,659.0,5,1079,1.0,811.0,811.0
0.01,6,10,1677,5,827,2.0,559.0,559.0,5,850,2.0,582.0,582.0
240.012,6,9,787,5,488,60003.0,232.0,232.0,4,299,80003.0,83.0,83.0
5.099,58,2,144,1,72,0.0,24.0,24.0,1,72,0.0,24.0,24.0
0.052,17,2,152,1,76,0.0,48.0,48.0,1,76,0.0,48.0,48.0
300.016,6,12,1782,7,1348,50002.0,494.0,494.0,5,434,75003.0,83.0,83.0
0.038,17,2,144,1,64,0.0,36.0,36.0,1,80,0.0,52.0,52.0
0.004,6,10,1702,5,863,1.0,595.0,595.0,5,839,0.0,571.0,571.0
0.014,6,10,1990,5,911,3.0,643.0,643.0,5,1079,3.0,811.0,811.0
295.901,6,388,347177,198,21860,1502.0,2736.0,888.0,190,325317,1565.0,2804.0,1792.0
240.09,6,16,4480,9,963,30011.0,238.0,166.0,7,3517,40014.0,1402.0,786.0
0.016,6,10,1989,5,910,4.0,642.0,642.0,5,1079,4.0,811.0,811.0
15.086,17,15,8090,8,5885,2151.0,1350.0,707.0,7,2205,2509.0,1350.0,287.0
1770.424,6,82,4318,41,2159,44259.0,27.0,27.0,41,2159,44259.0,27.0,27.0
0.013,6,10,1989,5,910,3.0,642.0,642.0,5,1079,3.0,811.0,811.0
11.19,17,28,4421,14,1994,848.0,269.0,114.0,14,2427,848.0,586.0,145.0
0.005,6,10,1643,5,860,1.0,592.0,592.0,5,783,1.0,515.0,515.0
0.006,6,10,1547,5,764,1.0,496.0,496.0,5,783,1.0,515.0,515.0
0.018,6,10,1972,5,910,4.0,642.0,642.0,5,1062,4.0,794.0,794.0
0.066,6,10,1506,5,395,14.0,127.0,127.0,5,1111,16.0,843.0,843.0
40.067,17,10,676,5,460,10014.0,104.0,64.0,5,216,10015.0,20.0,15.0
0.006,6,10,1643,5,860,1.0,592.0,592.0,5,783,1.0,515.0,515.0
178.038,17,96,14001,48,3237,3787.0,44.0,39.0,48,10764,3787.0,261.0,196.0
308.515,17,20,1124,10,716,34272.0,48.0,43.0,10,408,34272.0,20.0,12.0
0.017,6,10,1972,5,910,4.0,642.0,642.0,5,1062,4.0,794.0,794.0
0.006,17,2,170,1,65,0.0,37.0,37.0,1,105,0.0,77.0,77.0
1799.916,6,137,6590,76,3625,23995.0,39.0,39.0,61,2965,29994.0,35.0,35.0
40.073,17,10,676,5,460,10015.0,104.0,64.0,5,216,10017.0,20.0,15.0
0.019,6,10,1983,5,910,4.0,642.0,642.0,5,1073,4.0,805.0,805.0
0.004,6,10,2006,5,927,1.0,659.0,659.0,5,1079,1.0,811.0,811.0
169.214,17,74,10443,37,2464,4700.0,44.0,38.0,37,7979,4700.0,239.0,187.0
176.44,17,94,13661,47,3160,3835.0,44.0,39.0,47,10501,3835.0,261.0,195.0
0.013,17,2,152,1,56,0.0,28.0,28.0,1,96,0.0,68.0,68.0
0.082,6,10,1506,5,395,18.0,127.0,127.0,5,1111,18.0,843.0,843.0
0.005,6,10,2006,5,927,1.0,659.0,659.0,5,1079,1.0,811.0,811.0
0.006,6,10,1547,5,764,1.0,496.0,496.0,5,783,1.0,515.0,515.0
0.106,6,10,1506,5,395,21.0,127.0,127.0,5,1111,23.0,843.0,843.0
240.694,6,37,9659,19,2175,13370.0,747.0,235.0,18,7484,14156.0,1402.0,595.0
0.005,6,13,3747,7,509,0.0,137.0,137.0,6,3238,1.0,1470.0,1459.0
0.016,6,10,1989,5,910,4.0,642.0,642.0,5,1079,3.0,811.0,811.0
0.005,17,2,169,1,62,0.0,34.0,34.0,1,107,0.0,79.0,79.0
0.118,6,10,1506,5,395,27.0,127.0,127.0,5,1111,26.0,843.0,843.0
0.007,6,10,1989,5,910,1.0,642.0,642.0,5,1079,1.0,811.0,811.0
0.004,6,10,2000,5,927,1.0,659.0,659.0,5,1073,1.0,805.0,805.0
40.048,17,10,676,5,460,10010.0,104.0,64.0,5,216,10011.0,20.0,15.0
0.065,6,10,1506,5,395,14.0,127.0,127.0,5,1111,14.0,843.0,843.0
0.01,6,10,1972,5,910,2.0,642.0,642.0,5,1062,2.0,794.0,794.0
0.016,6,10,1989,5,910,3.0,642.0,642.0,5,1079,4.0,811.0,811.0
0.006,17,2,144,1,64,0.0,36.0,36.0,1,80,0.0,52.0,52.0
0.011,6,13,3735,7,497,1.0,125.0,125.0,6,3238,2.0,1470.0,1459.0
0.011,6,12,1926,6,1189,2.0,659.0,434.0,6,737,2.0,417.0,417.0
0.005,6,10,2007,5,928,1.0,660.0,660.0,5,1079,1.0,811.0,811.0
1.039,6,12,3134,6,2099,156.0,1328.0,923.0,6,1035,156.0,791.0,791.0
0.088,6,10,1506,5,395,19.0,127.0,127.0,5,1111,20.0,843.0,843.0
15.073,17,14,9190,8,6902,2149.0,1350.0,834.0,6,2288,3008.0,1350.0,353.0
0.01,6,10,1990,5,911,2.0,643.0,643.0,5,1079,2.0,811.0,811.0
0.016,17,2,198,1,91,0.0,63.0,63.0,1,107,0.0,79.0,79.0
331.148,17,20,1124,10,716,36786.0,48.0,43.0,10,408,36786.0,20.0,12.0
0.145,6,10,1506,5,395,35.0,127.0,127.0,5,1111,32.0,843.0,843.0
0.073,17,4,352,2,130,2.0,37.0,37.0,2,222,69.0,89.0,83.0
0.101,6,10,1506,5,395,23.0,127.0,127.0,5,1111,22.0,843.0,843.0
0.077,6,10,1506,5,395,16.0,127.0,127.0,5,1111,17.0,843.0,843.0
0.007,6,10,1990,5,911,1.0,643.0,643.0,5,1079,1.0,811.0,811.0
0.165,17,2,152,1,76,0.0,48.0,48.0,1,76,0.0,48.0,48.0
0.113,6,10,1506,5,395,25.0,127.0,127.0,5,1111,21.0,843.0,843.0
0.005,6,10,1854,5,889,1.0,621.0,621.0,5,965,1.0,697.0,697.0
0.004,6,10,2000,5,927,1.0,659.0,659.0,5,1073,1.0,805.0,805.0
0.13,6,10,1506,5,395,29.0,127.0,127.0,5,1111,31.0,843.0,843.0
0.005,6,10,1989,5,927,1.0,659.0,659.0,5,1062,1.0,794.0,794.0
15.034,17,39,20068,22,17070,714.0,1350.0,747.0,17,2998,937.0,1350.0,148.0
265.74,6,28,9638,15,2606,18979.0,676.0,363.0,13,7032,22142.0,1402.0,908.0
0.068,6,10,1506,5,395,14.0,127.0,127.0,5,1111,15.0,843.0,843.0
0.082,6,10,1506,5,395,19.0,127.0,127.0,5,1111,17.0,843.0,843.0
0.006,6,10,1854,5,889,1.0,621.0,621.0,5,965,1.0,697.0,697.0
0.008,6,10,1643,5,860,1.0,592.0,592.0,5,783,2.0,515.0,515.0
0.005,6,10,1989,5,927,1.0,659.0,659.0,5,1062,1.0,794.0,794.0
0.115,6,10,1506,5,395,28.0,127.0,127.0,5,1111,25.0,843.0,843.0
0.004,17,2,136,1,60,0.0,32.0,32.0,1,76,0.0,48.0,48.0
0.015,6,10,1989,5,910,3.0,642.0,642.0,5,1079,3.0,811.0,811.0
0.005,6,10,1989,5,927,1.0,659.0,659.0,5,1062,1.0,794.0,794.0
0.014,6,10,1631,5,848,3.0,580.0,580.0,5,783,3.0,515.0,515.0
0.015,6,10,1989,5,910,3.0,642.0,642.0,5,1079,3.0,811.0,811.0
0.005,6,10,2007,5,928,1.0,660.0,660.0,5,1079,1.0,811.0,811.0
0.082,6,10,1506,5,395,17.0,127.0,127.0,5,1111,18.0,843.0,843.0
40.093,17,10,676,5,460,10020.0,104.0,64.0,5,216,10022.0,20.0,15.0
0.006,6,10,1689,5,839,1.0,571.0,571.0,5,850,1.0,582.0,582.0
300.021,6,12,1782,7,1348,50003.0,494.0,494.0,5,434,75004.0,83.0,83.0
0.01,6,10,1989,5,910,2.0,642.0,642.0,5,1079,2.0,811.0,811.0
0.014,6,10,1983,5,910,3.0,642.0,642.0,5,1073,3.0,805.0,805.0
40.074,17,10,676,5,460,10016.0,104.0,64.0,5,216,10017.0,20.0,15.0
308.488,17,20,1124,10,716,34269.0,48.0,43.0,10,408,34269.0,20.0,12.0
0.004,6,10,2006,5,927,1.0,659.0,659.0,5,1079,0.0,811.0,811.0
1.55,6,140,99510,70,96521,19.0,2828.0,1419.0,70,2989,19.0,177.0,177.0
0.015,17,2,198,1,91,0.0,63.0,63.0,1,107,0.0,79.0,79.0
0.005,6,10,2007,5,928,1.0,660.0,660.0,5,1079,1.0,811.0,811.0
0.01,6,10,1989,5,910,2.0,642.0,642.0,5,1079,2.0,811.0,811.0
0.092,6,10,1506,5,395,20.0,127.0,127.0,5,1111,19.0,843.0,843.0
0.011,6,10,1972,5,910,2.0,642.0,642.0,5,1062,2.0,794.0,794.0
0.005,6,10,2007,5,928,1.0,660.0,660.0,5,1079,1.0,811.0,811.0
0.005,6,10,2007,5,928,1.0,660.0,660.0,5,1079,1.0,811.0,811.0
0.016,17,2,198,1,91,0.0,63.0,63.0,1,107,0.0,79.0,79.0
1756.227,6,105,6270,60,3525,29765.0,27.0,27.0,45,2745,39913.0,27.0,27.0
0.015,6,10,1972,5,910,3.0,642.0,642.0,5,1062,3.0,794.0,794.0
0.007,17,2,154,1,69,0.0,41.0,41.0,1,85,0.0,57.0,57.0
0.012,6,10,1762,5,911,3.0,643.0,643.0,5,851,3.0,583.0,583.0
0.006,6,10,1547,5,764,1.0,496.0,496.0,5,783,1.0,515.0,515.0
0.008,6,10,1990,5,911,2.0,643.0,643.0,5,1079,1.0,811.0,811.0
0.006,6,10,1547,5,764,1.0,496.0,496.0,5,783,1.0,515.0,515.0
0.016,6,10,1983,5,910,3.0,642.0,642.0,5,1073,4.0,805.0,805.0
0.013,6,10,1983,5,910,3.0,642.0,642.0,5,1073,3.0,805.0,805.0
0.006,6,10,1547,5,764,1.0,496.0,496.0,5,783,1.0,515.0,515.0
0.08,6,10,1506,5,395,17.0,127.0,127.0,5,1111,17.0,843.0,843.0
0.007,6,10,1983,5,910,1.0,642.0,642.0,5,1073,1.0,805.0,805.0
0.008,6,12,1926,6,1189,1.0,659.0,434.0,6,737,1.0,417.0,417.0
0.014,6,10,1989,5,910,3.0,642.0,642.0,5,1079,3.0,811.0,811.0
0.038,17,4,284,2,120,0.0,32.0,32.0,2,164,35.0,60.0,54.0
0.006,6,10,1547,5,764,1.0,496.0,496.0,5,783,1.0,515.0,515.0
0.012,6,10,1990,5,911,2.0,643.0,643.0,5,1079,2.0,811.0,811.0
0.006,6,10,1547,5,764,1.0,496.0,496.0,5,783,1.0,515.0,515.0
0.014,6,10,1989,5,910,3.0,642.0,642.0,5,1079,3.0,811.0,811.0
0.089,6,10,1506,5,395,21.0,127.0,127.0,5,1111,19.0,843.0,843.0
0.009,6,10,1762,5,911,2.0,643.0,643.0,5,851,2.0,583.0,583.0
0.125,6,10,1506,5,395,28.0,127.0,127.0,5,1111,30.0,843.0,843.0
0.006,6,10,1643,5,860,1.0,592.0,592.0,5,783,1.0,515.0,515.0
241.823,6,383,348135,198,21829,1227.0,2736.0,960.0,185,326306,1314.0,2804.0,1809.0
0.016,17,2,198,1,91,0.0,63.0,63.0,1,107,0.0,79.0,79.0
0.005,17,2,144,1,64,0.0,36.0,36.0,1,80,0.0,52.0,52.0
0.003,17,2,136,1,60,0.0,32.0,32.0,1,76,0.0,48.0,48.0
0.009,6,10,1762,5,911,2.0,643.0,643.0,5,851,2.0,583.0,583.0
0.009,6,10,1972,5,910,2.0,642.0,642.0,5,1062,2.0,794.0,794.0
0.004,6,10,1702,5,863,1.0,595.0,595.0,5,839,1.0,571.0,571.0
0.007,17,2,194,1,59,0.0,31.0,31.0,1,135,0.0,107.0,107.0
0.005,6,10,1774,5,923,1.0,655.0,655.0,5,851,1.0,583.0,583.0
0.005,6,10,1689,5,839,1.0,571.0,571.0,5,850,1.0,582.0,582.0
0.005,17,2,166,1,75,0.0,47.0,47.0,1,91,0.0,63.0,63.0
40.07,17,10,676,5,460,10016.0,104.0,64.0,5,216,10016.0,20.0,15.0
0.005,6,10,2007,5,928,1.0,660.0,660.0,5,1079,1.0,811.0,811.0
0.04,17,4,284,2,120,0.0,32.0,32.0,2,164,37.0,60.0,54.0
0.001,17,2,140,1,62,0.0,34.0,34.0,1,78,0.0,50.0,50.0
0.005,6,10,2007,5,928,1.0,660.0,660.0,5,1079,1.0,811.0,811.0
0.005,6,10,2000,5,927,1.0,659.0,659.0,5,1073,1.0,805.0,805.0
0.005,17,2,427,1,129,0.0,101.0,101.0,1,298,0.0,270.0,270.0
0.008,6,10,1989,5,910,2.0,642.0,642.0,5,1079,1.0,811.0,811.0
0.005,6,10,2006,5,927,1.0,659.0,659.0,5,1079,1.0,811.0,811.0
0.073,6,10,1506,5,395,16.0,127.0,127.0,5,1111,14.0,843.0,843.0
0.012,6,10,1989,5,910,3.0,642.0,642.0,5,1079,3.0,811.0,811.0
15.073,17,15,9238,8,6902,2149.0,1350.0,834.0,7,2336,2507.0,1350.0,305.0
0.015,6,10,1989,5,910,3.0,642.0,642.0,5,1079,3.0,811.0,811.0
11.22,17,28,4422,14,1995,850.0,270.0,114.0,14,2427,849.0,586.0,145.0
0.018,6,10,1989,5,910,4.0,642.0,642.0,5,1079,4.0,811.0,811.0
0.016,6,10,1972,5,910,4.0,642.0,642.0,5,1062,4.0,794.0,794.0
0.078,6,10,1506,5,395,17.0,127.0,127.0,5,1111,15.0,843.0,843.0
0.011,6,10,1990,5,911,2.0,643.0,643.0,5,1079,2.0,811.0,811.0
0.006,6,10,1689,5,839,1.0,571.0,571.0,5,850,1.0,582.0,582.0
40.055,17,10,676,5,460,10013.0,104.0,64.0,5,216,10013.0,20.0,15.0
1778.276,17,141,44556,72,22752,25043.0,288.0,288.0,69,21804,26151.0,288.0,288.0
545.712,6,41,13971,22,3555,25986.0,676.0,400.0,19,10416,26981.0,1402.0,785.0
0.007,17,2,179,1,71,0.0,43.0,43.0,1,108,0.0,80.0,80.0
240.087,6,19,4827,9,2169,30010.0,966.0,568.0,10,2658,26675.0,1162.0,426.0
0.011,6,10,1983,5,910,2.0,642.0,642.0,5,1073,2.0,805.0,805.0
0.02,17,2,194,1,59,0.0,31.0,31.0,1,135,0.0,107.0,107.0
0.004,17,2,168,1,76,0.0,48.0,48.0,1,92,0.0,64.0,64.0
0.004,17,2,136,1,60,0.0,32.0,32.0,1,76,0.0,48.0,48.0
0.083,6,10,1506,5,395,18.0,127.0,127.0,5,1111,18.0,843.0,843.0
40.061,17,10,676,5,460,10014.0,104.0,64.0,5,216,10014.0,20.0,15.0
0.008,17,2,166,1,75,0.0,47.0,47.0,1,91,0.0,63.0,63.0
0.005,6,10,2000,5,927,1.0,659.0,659.0,5,1073,1.0,805.0,805.0
0.004,6,14,3742,8,504,0.0,80.0,80.0,6,3238,0.0,1470.0,1459.0
0.011,6,12,1926,6,1189,2.0,659.0,434.0,6,737,2.0,417.0,417.0
120.989,6,58,19065,33,4817,3780.0,1053.0,221.0,25,14248,5040.0,2804.0,995.0
9.037,17,6,376,5,280,2259.0,28.0,28.0,1,96,0.0,68.0,68.0
300.031,6,12,1782,7,1348,50005.0,494.0,494.0,5,434,75007.0,83.0,83.0
0.01,6,10,1989,5,910,2.0,642.0,642.0,5,1079,2.0,811.0,811.0
0.005,6,10,1989,5,927,1.0,659.0,659.0,5,1062,1.0,794.0,794.0
367.271,6,22,2313,16,867,24484.0,195.0,195.0,6,1446,4636.0,419.0,398.0
40.064,17,10,676,5,460,10013.0,104.0,64.0,5,216,10015.0,20.0,15.0
0.143,6,10,1506,5,395,33.0,127.0,127.0,5,1111,32.0,843.0,843.0
0.003,17,2,152,1,76,0.0,48.0,48.0,1,76,0.0,48.0,48.0
0.103,6,10,1506,5,395,24.0,127.0,127.0,5,1111,24.0,843.0,843.0
168.071,17,76,10837,38,2530,4542.0,44.0,38.0,38,8307,4542.0,261.0,190.0
0.082,6,10,1506,5,395,17.0,127.0,127.0,5,1111,18.0,843.0,843.0
0.004,17,2,148,1,60,0.0,32.0,32.0,1,88,0.0,60.0,60.0
15.171,17,21,12299,11,8736,1514.0,1350.0,766.0,10,3563,1682.0,1350.0,328.0
1791.448,6,295,27440,141,9256,12796.0,747.0,263.0,154,18184,11708.0,1402.0,68.0
0.11,6,10,1506,5,395,24.0,127.0,127.0,5,1111,21.0,843.0,843.0
0.098,6,10,1506,5,395,22.0,127.0,127.0,5,1111,19.0,843.0,843.0
15.237,17,18,9402,9,6963,1901.0,1350.0,745.0,9,2439,1900.0,1350.0,243.0
0.082,6,10,1506,5,395,19.0,127.0,127.0,5,1111,16.0,843.0,843.0
0.008,6,10,1989,5,910,2.0,642.0,642.0,5,1079,2.0,811.0,811.0
0.087,6,10,1506,5,395,19.0,127.0,127.0,5,1111,20.0,843.0,843.0
0.01,6,10,1989,5,910,2.0,642.0,642.0,5,1079,2.0,811.0,811.0
0.005,17,2,225,1,65,0.0,37.0,37.0,1,160,0.0,132.0,132.0
0.004,6,10,2007,5,928,1.0,660.0,660.0,5,1079,1.0,811.0,811.0
1772.299,6,105,6270,60,3525,30038.0,27.0,27.0,45,2745,40278.0,27.0,27.0
10.876,17,28,4417,14,1994,828.0,269.0,114.0,14,2423,828.0,586.0,145.0
0.018,6,10,1989,5,910,4.0,642.0,642.0,5,1079,4.0,811.0,811.0
0.004,6,10,2000,5,927,1.0,659.0,659.0,5,1073,1.0,805.0,805.0
0.001,17,2,180,1,66,0.0,38.0,38.0,1,114,0.0,86.0,86.0
0.008,6,10,1983,5,910,2.0,642.0,642.0,5,1073,2.0,805.0,805.0
0.109,6,10,1506,5,395,25.0,127.0,127.0,5,1111,26.0,843.0,843.0
0.005,6,10,1774,5,923,1.0,655.0,655.0,5,851,1.0,583.0,583.0
0.009,6,10,1989,5,910,2.0,642.0,642.0,5,1079,2.0,811.0,811.0
0.006,6,10,2007,5,928,1.0,660.0,660.0,5,1079,1.0,811.0,811.0
0.005,6,10,1774,5,923,1.0,655.0,655.0,5,851,1.0,583.0,583.0
0.008,6,10,1972,5,910,2.0,642.0,642.0,5,1062,2.0,794.0,794.0
0.1,6,10,1506,5,395,21.0,127.0,127.0,5,1111,22.0,843.0,843.0
280.632,6,21,5995,8,1106,40089.0,267.0,156.0,13,4889,23385.0,1400.0,873.0
0.008,6,10,1989,5,910,2.0,642.0,642.0,5,1079,1.0,811.0,811.0
0.005,6,10,2006,5,927,1.0,659.0,659.0,5,1079,1.0,811.0,811.0
0.109,6,10,1506,5,395,25.0,127.0,127.0,5,1111,24.0,843.0,843.0
0.134,6,10,1506,5,395,30.0,127.0,127.0,5,1111,27.0,843.0,843.0
0.012,6,10,1972,5,910,3.0,642.0,642.0,5,1062,3.0,794.0,794.0
1773.121,6,308,98483,188,87049,9481.0,2001.0,689.0,120,11434,14900.0,452.0,70.0
0.296,17,16,8946,8,6381,42.0,1350.0,769.0,8,2565,30.0,1350.0,292.0
0.206,6,16,2777,8,1395,29.0,533.0,323.0,8,1382,18.0,529.0,239.0
0.005,6,10,2007,5,928,1.0,660.0,660.0,5,1079,1.0,811.0,811.0
0.006,6,10,1547,5,764,1.0,496.0,496.0,5,783,1.0,515.0,515.0
0.151,6,10,1506,5,395,31.0,127.0,127.0,5,1111,36.0,843.0,843.0
411.912,6,25,5436,13,3012,34322.0,676.0,388.0,12,2424,37443.0,821.0,360.0
0.005,6,10,1643,5,860,1.0,592.0,592.0,5,783,1.0,515.0,515.0
0.005,17,2,200,1,68,0.0,40.0,40.0,1,132,0.0,104.0,104.0
0.006,6,10,1547,5,764,1.0,496.0,496.0,5,783,1.0,515.0,515.0
0.006,6,10,1547,5,764,1.0,496.0,496.0,5,783,1.0,515.0,515.0
0.001,17,2,180,1,66,0.0,38.0,38.0,1,114,0.0,86.0,86.0
0.012,6,10,1990,5,911,3.0,643.0,643.0,5,1079,3.0,811.0,811.0
0.011,6,10,1989,5,910,2.0,642.0,642.0,5,1079,2.0,811.0,811.0
0.001,17,2,180,1,66,0.0,38.0,38.0,1,114,0.0,86.0,86.0
11.55,17,28,4393,14,2311,876.0,586.0,137.0,14,2082,875.0,269.0,120.0
0.018,6,10,1990,5,911,4.0,643.0,643.0,5,1079,4.0,811.0,811.0
0.006,6,10,1643,5,860,1.0,592.0,592.0,5,783,1.0,515.0,515.0
308.458,17,20,1124,10,716,34257.0,48.0,43.0,10,408,34255.0,20.0,12.0
0.04,17,4,284,2,120,0.0,32.0,32.0,2,164,37.0,60.0,54.0
0.006,6,10,1779,5,928,1.0,660.0,660.0,5,851,1.0,583.0,583.0
40.053,17,10,676,5,460,10012.0,104.0,64.0,5,216,10012.0,20.0,15.0
0.014,6,10,1989,5,910,3.0,642.0,642.0,5,1079,3.0,811.0,811.0
0.01,6,13,3735,7,497,1.0,125.0,125.0,6,3238,2.0,1470.0,1459.0
0.005,6,10,2000,5,927,1.0,659.0,659.0,5,1073,1.0,805.0,805.0
0.017,6,10,1677,5,827,4.0,559.0,559.0,5,850,4.0,582.0,582.0
40.059,17,10,676,5,460,10012.0,104.0,64.0,5,216,10014.0,20.0,15.0
0.006,17,4,495,2,132,2.0,38.0,38.0,2,363,1.0,176.0,153.0
10.82,17,28,4423,14,1995,823.0,270.0,114.0,14,2428,823.0,587.0,145.0
0.004,6,10,2006,5,927,1.0,659.0,659.0,5,1079,1.0,811.0,811.0
0.037,17,2,184,1,61,0.0,33.0,33.0,1,123,0.0,95.0,95.0
0.125,6,10,1506,5,395,29.0,127.0,127.0,5,1111,25.0,843.0,843.0
0.005,6,10,1779,5,928,1.0,660.0,660.0,5,851,1.0,583.0,583.0
0.117,6,10,1506,5,395,26.0,127.0,127.0,5,1111,25.0,843.0,843.0
0.004,6,10,1702,5,863,1.0,595.0,595.0,5,839,0.0,571.0,571.0
0.009,6,10,1989,5,927,2.0,659.0,659.0,5,1062,2.0,794.0,794.0
0.005,6,10,2007,5,928,1.0,660.0,660.0,5,1079,1.0,811.0,811.0
0.006,6,10,1547,5,764,1.0,496.0,496.0,5,783,1.0,515.0,515.0
0.004,6,10,2007,5,928,1.0,660.0,660.0,5,1079,1.0,811.0,811.0
240.09,6,16,4481,9,963,30011.0,238.0,166.0,7,3518,40014.0,1402.0,786.0
0.001,17,2,180,1,66,0.0,38.0,38.0,1,114,0.0,86.0,86.0
0.01,6,10,1989,5,910,2.0,642.0,642.0,5,1079,2.0,811.0,811.0
0.01,6,10,1983,5,910,2.0,642.0,642.0,5,1073,2.0,805.0,805.0
0.003,17,2,136,1,60,0.0,32.0,32.0,1,76,0.0,48.0,48.0
0.006,6,10,1854,5,889,1.0,621.0,621.0,5,965,1.0,697.0,697.0
353.663,6,20,2210,6,1308,12003.0,494.0,494.0,14,902,27204.0,83.0,83.0
0.005,6,10,2006,5,927,1.0,659.0,659.0,5,1079,1.0,811.0,811.0
0.005,17,2,299,1,65,0.0,37.0,37.0,1,234,0.0,206.0,206.0
0.006,6,12,1698,6,863,1.0,327.0,271.0,6,835,1.0,515.0,515.0
240.465,6,37,9660,19,2175,13359.0,747.0,235.0,18,7485,14144.0,1402.0,595.0
0.039,17,4,284,2,120,0.0,32.0,32.0,2,164,36.0,60.0,54.0
0.161,6,22,6483,11,2013,14.0,746.0,286.0,11,4470,14.0,1324.0,778.0
0.005,6,10,2006,5,927,1.0,659.0,659.0,5,1079,1.0,811.0,811.0
0.084,6,10,1506,5,395,17.0,127.0,127.0,5,1111,19.0,843.0,843.0
0.002,17,2,166,1,75,0.0,47.0,47.0,1,91,0.0,63.0,63.0
353.498,6,20,2210,6,1308,12004.0,494.0,494.0,14,902,27191.0,83.0,83.0
0.005,6,10,2006,5,927,1.0,659.0,659.0,5,1079,1.0,811.0,811.0
0.014,6,10,1972,5,910,3.0,642.0,642.0,5,1062,3.0,794.0,794.0
0.071,17,2,184,1,61,0.0,33.0,33.0,1,123,0.0,95.0,95.0
0.004,17,2,208,1,72,0.0,44.0,44.0,1,136,0.0,108.0,108.0
0.01,6,10,1972,5,910,2.0,642.0,642.0,5,1062,2.0,794.0,794.0
0.052,17,2,152,1,76,0.0,48.0,48.0,1,76,0.0,48.0,48.0
0.004,17,4,284,2,120,0.0,32.0,32.0,2,164,0.0,60.0,54.0
240.008,6,9,787,5,488,60002.0,232.0,232.0,4,299,80002.0,83.0,83.0
0.005,6,14,3799,7,509,0.0,137.0,137.0,7,3290,0.0,1448.0,972.0
0.038,17,2,148,1,60,0.0,32.0,32.0,1,88,0.0,60.0,60.0
240.156,6,64,54306,32,3167,7746.0,1226.0,498.0,32,51139,7746.0,2864.0,1766.0
0.011,6,10,1762,5,911,2.0,643.0,643.0,5,851,2.0,583.0,583.0
0.015,6,10,1972,5,910,3.0,642.0,642.0,5,1062,3.0,794.0,794.0
0.01,6,10,1990,5,911,2.0,643.0,643.0,5,1079,2.0,811.0,811.0
0.005,6,10,2006,5,927,1.0,659.0,659.0,5,1079,1.0,811.0,811.0
0.012,6,10,1989,5,910,2.0,642.0,642.0,5,1079,2.0,811.0,811.0
0.039,17,4,284,2,120,0.0,32.0,32.0,2,164,36.0,60.0,54.0
1756.175,6,105,6270,60,3525,29764.0,27.0,27.0,45,2745,39912.0,27.0,27.0
0.005,17,2,169,1,62,0.0,34.0,34.0,1,107,0.0,79.0,79.0
0.006,6,10,1689,5,839,1.0,571.0,571.0,5,850,1.0,582.0,582.0
0.003,17,2,132,1,58,0.0,30.0,30.0,1,74,0.0,46.0,46.0
0.158,6,10,1506,5,395,38.0,127.0,127.0,5,1111,36.0,843.0,843.0
0.005,17,2,144,1,64,0.0,36.0,36.0,1,80,0.0,52.0,52.0
0.001,17,2,180,1,66,0.0,38.0,38.0,1,114,0.0,86.0,86.0
0.065,6,10,1506,5,395,15.0,127.0,127.0,5,1111,13.0,843.0,843.0
1793.074,6,521,186692,255,161675,7059.0,2883.0,1023.0,266,25017,6766.0,384.0,110.0
11.234,17,28,4422,14,1994,851.0,269.0,114.0,14,2428,851.0,587.0,145.0
0.089,6,10,1506,5,395,20.0,127.0,127.0,5,1111,19.0,843.0,843.0
0.006,6,10,2006,5,927,1.0,659.0,659.0,5,1079,1.0,811.0,811.0
0.084,6,10,1506,5,395,18.0,127.0,127.0,5,1111,17.0,843.0,843.0
0.084,6,10,1506,5,395,20.0,127.0,127.0,5,1111,15.0,843.0,843.0
0.005,6,10,2006,5,927,1.0,659.0,659.0,5,1079,1.0,811.0,811.0
40.084,17,10,676,5,460,10020.0,104.0,64.0,5,216,10020.0,20.0,15.0
0.014,6,10,1983,5,910,3.0,642.0,642.0,5,1073,3.0,805.0,805.0
0.008,17,2,166,1,75,0.0,47.0,47.0,1,91,0.0,63.0,63.0
0.01,6,10,1983,5,910,2.0,642.0,642.0,5,1073,2.0,805.0,805.0
15.076,17,17,9223,9,7153,1880.0,1350.0,766.0,8,2070,2149.0,1350.0,230.0
0.041,17,2,182,1,65,0.0,37.0,37.0,1,117,0.0,89.0,89.0
0.005,6,10,1643,5,860,1.0,592.0,592.0,5,783,1.0,515.0,515.0
0.006,17,2,140,1,62,0.0,34.0,34.0,1,78,0.0,50.0,50.0
364.369,6,19,1689,15,978,26026.0,190.0,190.0,4,711,80019.0,495.0,495.0
0.016,6,10,1762,5,911,4.0,643.0,643.0,5,851,4.0,583.0,583.0
0.071,17,2,136,1,60,0.0,32.0,32.0,1,76,0.0,48.0,48.0
40.052,17,10,676,5,460,10012.0,104.0,64.0,5,216,10012.0,20.0,15.0
0.019,6,10,1989,5,910,4.0,642.0,642.0,5,1079,4.0,811.0,811.0
0.006,6,10,2006,5,927,1.0,659.0,659.0,5,1079,1.0,811.0,811.0
0.011,6,10,1989,5,910,2.0,642.0,642.0,5,1079,2.0,811.0,811.0
0.005,6,10,1779,5,928,1.0,660.0,660.0,5,851,1.0,583.0,583.0
0.058,6,10,1506,5,395,13.0,127.0,127.0,5,1111,13.0,843.0,843.0
0.01,6,13,3735,7,497,1.0,125.0,125.0,6,3238,2.0,1470.0,1459.0
0.129,6,10,1506,5,395,31.0,127.0,127.0,5,1111,28.0,843.0,843.0
0.005,6,10,1989,5,927,1.0,659.0,659.0,5,1062,1.0,794.0,794.0
0.006,6,10,1689,5,839,1.0,571.0,571.0,5,850,1.0,582.0,582.0
0.008,6,10,1631,5,848,2.0,580.0,580.0,5,783,1.0,515.0,515.0
0.005,17,2,214,1,75,0.0,47.0,47.0,1,139,0.0,111.0,111.0
11.121,17,28,4422,14,1993,842.0,268.0,114.0,14,2429,842.0,588.0,145.0
0.012,6,10,1631,5,848,2.0,580.0,580.0,5,783,2.0,515.0,515.0
0.005,6,10,1989,5,927,1.0,659.0,659.0,5,1062,1.0,794.0,794.0
0.007,6,10,1989,5,910,1.0,642.0,642.0,5,1079,1.0,811.0,811.0
0.005,6,10,1989,5,927,1.0,659.0,659.0,5,1062,1.0,794.0,794.0
40.053,17,10,676,5,460,10012.0,104.0,64.0,5,216,10012.0,20.0,15.0
0.006,6,10,2000,5,927,1.0,659.0,659.0,5,1073,1.0,805.0,805.0
0.005,17,2,180,1,58,0.0,30.0,30.0,1,122,0.0,94.0,94.0
0.112,6,10,1506,5,395,24.0,127.0,127.0,5,1111,24.0,843.0,843.0
0.165,6,10,1506,5,395,38.0,127.0,127.0,5,1111,39.0,843.0,843.0
0.015,6,10,1983,5,910,3.0,642.0,642.0,5,1073,3.0,805.0,805.0
0.007,17,2,132,1,58,0.0,30.0,30.0,1,74,0.0,46.0,46.0
40.067,17,10,676,5,460,10016.0,104.0,64.0,5,216,10015.0,20.0,15.0
0.005,6,10,1643,5,860,1.0,592.0,592.0,5,783,1.0,515.0,515.0
0.005,6,14,3736,7,446,0.0,74.0,74.0,7,3290,0.0,1448.0,972.0
240.086,6,16,4481,9,963,30010.0,238.0,166.0,7,3518,40013.0,1402.0,786.0
0.014,6,10,1989,5,910,3.0,642.0,642.0,5,1079,3.0,811.0,811.0
277.618,6,29,11068,16,4356,18507.0,1402.0,586.0,13,6712,23134.0,1402.0,862.0
0.01,6,10,1972,5,910,2.0,642.0,642.0,5,1062,2.0,794.0,794.0
0.02,6,13,3913,7,495,3.0,123.0,123.0,6,3418,3.0,1650.0,1549.0
0.04,17,4,284,2,120,1.0,32.0,32.0,2,164,36.0,60.0,54.0
40.064,17,10,676,5,460,10012.0,104.0,64.0,5,216,10014.0,20.0,15.0
0.011,6,10,1989,5,927,2.0,659.0,659.0,5,1062,2.0,794.0,794.0
0.006,6,10,1547,5,764,1.0,496.0,496.0,5,783,1.0,515.0,515.0
0.009,6,10,1990,5,911,2.0,643.0,643.0,5,1079,2.0,811.0,811.0
0.004,17,2,136,1,60,0.0,32.0,32.0,1,76,0.0,48.0,48.0
0.004,6,10,2006,5,927,1.0,659.0,659.0,5,1079,1.0,811.0,811.0
0.005,6,10,2007,5,928,1.0,660.0,660.0,5,1079,1.0,811.0,811.0
0.11,6,10,1506,5,395,26.0,127.0,127.0,5,1111,24.0,843.0,843.0
0.006,6,10,1774,5,923,1.0,655.0,655.0,5,851,1.0,583.0,583.0
0.042,17,4,352,2,130,3.0,37.0,37.0,2,222,3.0,89.0,83.0
0.005,6,10,1689,5,839,1.0,571.0,571.0,5,850,1.0,582.0,582.0
0.097,6,10,1506,5,395,23.0,127.0,127.0,5,1111,19.0,843.0,843.0
0.016,6,10,1983,5,910,4.0,642.0,642.0,5,1073,3.0,805.0,805.0
0.005,17,2,170,1,65,0.0,37.0,37.0,1,105,0.0,77.0,77.0
0.013,6,10,1677,5,827,3.0,559.0,559.0,5,850,3.0,582.0,582.0
0.008,6,10,1972,5,910,2.0,642.0,642.0,5,1062,2.0,794.0,794.0
0.018,6,10,1983,5,910,4.0,642.0,642.0,5,1073,4.0,805.0,805.0
0.109,6,10,1506,5,395,26.0,127.0,127.0,5,1111,26.0,843.0,843.0
0.008,6,10,1990,5,911,2.0,643.0,643.0,5,1079,2.0,811.0,811.0
240.025,6,9,787,5,488,60006.0,232.0,232.0,4,299,80003.0,83.0,83.0
0.041,17,2,184,1,61,0.0,33.0,33.0,1,123,0.0,95.0,95.0
40.076,17,10,676,5,460,10015.0,104.0,64.0,5,216,10017.0,20.0,15.0
0.013,6,10,1983,5,910,3.0,642.0,642.0,5,1073,3.0,805.0,805.0
0.067,17,8,3613,4,1874,22.0,1350.0,440.0,4,1739,11.0,1350.0,406.0
0.001,17,2,180,1,66,0.0,38.0,38.0,1,114,0.0,86.0,86.0
0.001,17,2,226,1,97,0.0,69.0,69.0,1,129,0.0,101.0,101.0
0.005,17,2,170,1,65,0.0,37.0,37.0,1,105,0.0,77.0,77.0
0.005,17,2,136,1,60,0.0,32.0,32.0,1,76,0.0,48.0,48.0
0.001,17,2,180,1,66,0.0,38.0,38.0,1,114,0.0,86.0,86.0
0.011,6,10,1677,5,827,2.0,559.0,559.0,5,850,2.0,582.0,582.0
281.644,17,138,19581,69,4646,4141.0,44.0,39.0,69,14935,4141.0,239.0,188.0
0.001,17,2,180,1,66,0.0,38.0,38.0,1,114,0.0,86.0,86.0
0.008,6,10,1989,5,910,2.0,642.0,642.0,5,1079,2.0,811.0,811.0
168.245,17,80,11724,40,2675,4313.0,44.0,38.0,40,9049,4313.0,261.0,198.0
0.006,17,2,169,1,62,0.0,34.0,34.0,1,107,0.0,79.0,79.0
0.039,17,4,284,2,120,0.0,32.0,32.0,2,164,35.0,60.0,54.0
0.006,6,12,1698,6,863,1.0,327.0,271.0,6,835,1.0,515.0,515.0
402.212,6,22,2313,16,867,26814.0,195.0,195.0,6,1446,4657.0,419.0,398.0
0.004,6,10,2007,5,928,1.0,660.0,660.0,5,1079,1.0,811.0,811.0
0.086,6,10,1506,5,395,18.0,127.0,127.0,5,1111,20.0,843.0,843.0
0.084,6,10,1506,5,395,17.0,127.0,127.0,5,1111,17.0,843.0,843.0
0.218,6,16,2669,8,1395,31.0,533.0,323.0,8,1274,20.0,529.0,212.0
0.079,6,10,1506,5,395,17.0,127.0,127.0,5,1111,17.0,843.0,843.0
0.004,17,2,136,1,60,0.0,32.0,32.0,1,76,0.0,48.0,48.0
0.005,6,10,2007,5,928,1.0,660.0,660.0,5,1079,1.0,811.0,811.0
0.004,17,2,136,1,60,0.0,32.0,32.0,1,76,0.0,48.0,48.0
0.005,6,10,2006,5,927,1.0,659.0,659.0,5,1079,1.0,811.0,811.0
0.005,6,10,1689,5,839,1.0,571.0,571.0,5,850,1.0,582.0,582.0
0.005,6,10,2006,5,927,1.0,659.0,659.0,5,1079,1.0,811.0,811.0
40.068,17,10,676,5,460,10014.0,104.0,64.0,5,216,10016.0,20.0,15.0
0.134,6,10,1506,5,395,28.0,127.0,127.0,5,1111,27.0,843.0,843.0
0.007,17,2,179,1,71,0.0,43.0,43.0,1,108,0.0,80.0,80.0
0.075,6,10,1506,5,395,15.0,127.0,127.0,5,1111,16.0,843.0,843.0
0.007,6,10,1547,5,764,1.0,496.0,496.0,5,783,1.0,515.0,515.0
0.003,17,2,136,1,60,0.0,32.0,32.0,1,76,0.0,48.0,48.0
0.001,17,2,136,1,60,0.0,32.0,32.0,1,76,0.0,48.0,48.0
0.003,17,2,148,1,60,0.0,32.0,32.0,1,88,0.0,60.0,60.0
240.12,6,31,9069,15,6731,17151.0,1855.0,661.0,16,2338,16007.0,580.0,187.0
1778.759,17,144,45504,72,22752,25052.0,288.0,288.0,72,22752,25052.0,288.0,288.0
0.037,17,2,170,1,65,0.0,37.0,37.0,1,105,0.0,77.0,77.0
0.082,6,10,1506,5,395,18.0,127.0,127.0,5,1111,17.0,843.0,843.0
0.005,17,2,148,1,60,0.0,32.0,32.0,1,88,0.0,60.0,60.0
0.035,6,13,3816,7,578,5.0,206.0,206.0,6,3238,6.0,1470.0,1459.0
0.005,6,10,2006,5,927,1.0,659.0,659.0,5,1079,1.0,811.0,811.0
0.011,6,10,1677,5,827,2.0,559.0,559.0,5,850,2.0,582.0,582.0
0.004,6,10,1989,5,927,1.0,659.0,659.0,5,1062,1.0,794.0,794.0
0.008,6,10,1972,5,910,2.0,642.0,642.0,5,1062,2.0,794.0,794.0
0.01,6,10,1972,5,910,2.0,642.0,642.0,5,1062,2.0,794.0,794.0
0.018,6,10,1677,5,827,4.0,559.0,559.0,5,850,4.0,582.0,582.0
0.005,6,10,1989,5,927,1.0,659.0,659.0,5,1062,1.0,794.0,794.0
0.101,6,10,1506,5,395,24.0,127.0,127.0,5,1111,20.0,843.0,843.0
0.005,6,10,2006,5,927,1.0,659.0,659.0,5,1079,1.0,811.0,811.0
0.006,6,10,1643,5,860,1.0,592.0,592.0,5,783,1.0,515.0,515.0
40.068,17,10,676,5,460,10014.0,104.0,64.0,5,216,10016.0,20.0,15.0
1.149,6,22,7021,13,1693,95.0,517.0,251.0,9,5328,142.0,1402.0,808.0
15.078,17,14,9190,8,6902,2149.0,1350.0,834.0,6,2288,3009.0,1350.0,353.0
0.004,6,10,2000,5,927,1.0,659.0,659.0,5,1073,1.0,805.0,805.0
0.013,6,10,1677,5,827,3.0,559.0,559.0,5,850,3.0,582.0,582.0
0.005,17,2,175,1,65,0.0,37.0,37.0,1,110,0.0,82.0,82.0
0.013,6,13,3735,7,497,2.0,125.0,125.0,6,3238,2.0,1470.0,1459.0
0.005,6,10,2006,5,927,1.0,659.0,659.0,5,1079,1.0,811.0,811.0
0.039,17,2,136,1,60,0.0,32.0,32.0,1,76,0.0,48.0,48.0
0.072,17,4,284,2,120,0.0,32.0,32.0,2,164,68.0,60.0,54.0
0.097,6,10,1506,5,395,21.0,127.0,127.0,5,1111,20.0,843.0,843.0
0.099,6,10,1506,5,395,21.0,127.0,127.0,5,1111,22.0,843.0,843.0
0.074,6,10,1506,5,395,17.0,127.0,127.0,5,1111,16.0,843.0,843.0
177.114,17,70,10015,35,2338,5209.0,44.0,38.0,35,7677,5209.0,239.0,191.0
0.011,6,10,1989,5,910,2.0,642.0,642.0,5,1079,2.0,811.0,811.0
0.003,17,2,148,1,60,0.0,32.0,32.0,1,88,0.0,60.0,60.0
0.007,6,10,2006,5,927,1.0,659.0,659.0,5,1079,1.0,811.0,811.0
0.005,17,2,230,1,68,0.0,40.0,40.0,1,162,0.0,134.0,134.0
0.004,6,10,2000,5,927,1.0,659.0,659.0,5,1073,1.0,805.0,805.0
63.058,6,22,7437,11,1305,107.0,530.0,277.0,11,6132,6288.0,2720.0,946.0
40.053,17,10,676,5,460,10012.0,104.0,64.0,5,216,10011.0,20.0,15.0
0.006,6,10,1547,5,764,1.0,496.0,496.0,5,783,1.0,515.0,515.0
0.004,6,10,2006,5,927,1.0,659.0,659.0,5,1079,1.0,811.0,811.0
0.018,6,10,1631,5,848,4.0,580.0,580.0,5,783,4.0,515.0,515.0
0.132,6,10,1506,5,395,27.0,127.0,127.0,5,1111,25.0,843.0,843.0
0.011,6,13,3735,7,497,1.0,125.0,125.0,6,3238,2.0,1470.0,1459.0
0.005,17,2,169,1,62,0.0,34.0,34.0,1,107,0.0,79.0,79.0
240.093,6,32,9135,15,6662,17149.0,1774.0,652.0,17,2473,15005.0,580.0,197.0
0.038,17,2,148,1,60,0.0,32.0,32.0,1,88,0.0,60.0,60.0
40.057,17,10,676,5,460,10013.0,104.0,64.0,5,216,10013.0,20.0,15.0
305.146,17,16,928,8,608,43583.0,48.0,48.0,8,320,43583.0,12.0,12.0
177.091,17,76,10744,38,2528,4786.0,44.0,38.0,38,8216,4786.0,239.0,188.0
0.001,17,2,180,1,66,0.0,38.0,38.0,1,114,0.0,86.0,86.0
0.006,6,10,1547,5,764,1.0,496.0,496.0,5,783,1.0,515.0,515.0
0.064,6,10,1506,5,395,15.0,127.0,127.0,5,1111,14.0,843.0,843.0
0.845,6,22,5168,11,1138,72.0,267.0,115.0,11,4030,70.0,1414.0,597.0
0.085,6,10,1506,5,395,20.0,127.0,127.0,5,1111,18.0,843.0,843.0
0.005,6,10,2007,5,928,1.0,660.0,660.0,5,1079,1.0,811.0,811.0
240.512,6,37,9655,19,2169,13361.0,741.0,234.0,18,7486,14147.0,1402.0,595.0
0.015,6,10,1983,5,910,3.0,642.0,642.0,5,1073,3.0,805.0,805.0
0.039,17,2,128,1,56,0.0,28.0,28.0,1,72,0.0,44.0,44.0
0.074,6,10,1506,5,395,16.0,127.0,127.0,5,1111,16.0,843.0,843.0
0.008,6,10,1972,5,910,2.0,642.0,642.0,5,1062,1.0,794.0,794.0
0.004,6,10,2007,5,928,1.0,660.0,660.0,5,1079,1.0,811.0,811.0
1777.344,17,144,45504,72,22752,25032.0,288.0,288.0,72,22752,25032.0,288.0,288.0
169.43,17,72,10334,36,2402,4840.0,44.0,38.0,36,7932,4840.0,239.0,192.0
0.131,6,10,1506,5,395,32.0,127.0,127.0,5,1111,20.0,843.0,843.0
40.091,17,10,676,5,460,10015.0,104.0,64.0,5,216,10014.0,20.0,15.0
0.005,17,2,214,1,75,0.0,47.0,47.0,1,139,0.0,111.0,111.0
0.005,6,10,2006,5,927,1.0,659.0,659.0,5,1079,1.0,811.0,811.0
0.006,17,2,140,1,62,0.0,34.0,34.0,1,78,0.0,50.0,50.0
0.005,6,10,2007,5,928,1.0,660.0,660.0,5,1079,1.0,811.0,811.0
0.005,6,10,2007,5,928,1.0,660.0,660.0,5,1079,1.0,811.0,811.0
0.005,6,10,2000,5,927,1.0,659.0,659.0,5,1073,1.0,805.0,805.0
0.014,6,10,1605,5,388,3.0,120.0,120.0,5,1217,3.0,949.0,949.0
0.004,6,10,1702,5,863,1.0,595.0,595.0,5,839,0.0,571.0,571.0
0.063,6,10,1506,5,395,15.0,127.0,127.0,5,1111,14.0,843.0,843.0
0.007,6,10,1972,5,910,1.0,642.0,642.0,5,1062,1.0,794.0,794.0
51.068,6,28,9605,14,1707,3928.0,794.0,367.0,14,7898,3916.0,1360.0,732.0
412.252,6,29,4409,12,3102,10911.0,494.0,494.0,17,1307,25765.0,83.0,83.0
0.006,17,4,284,2,120,0.0,32.0,32.0,2,164,0.0,60.0,54.0
0.005,6,10,2007,5,928,1.0,660.0,660.0,5,1079,1.0,811.0,811.0
0.057,6,10,1506,5,395,13.0,127.0,127.0,5,1111,13.0,843.0,843.0
10.729,17,28,4422,14,1995,817.0,270.0,114.0,14,2427,817.0,586.0,145.0
0.084,6,10,1506,5,395,18.0,127.0,127.0,5,1111,16.0,843.0,843.0
0.004,17,4,284,2,120,0.0,32.0,32.0,2,164,1.0,60.0,54.0
0.006,6,10,1547,5,764,1.0,496.0,496.0,5,783,1.0,515.0,515.0
0.006,6,10,1547,5,764,1.0,496.0,496.0,5,783,1.0,515.0,515.0
0.005,6,10,1779,5,928,1.0,660.0,660.0,5,851,1.0,583.0,583.0
0.011,6,10,1990,5,911,2.0,643.0,643.0,5,1079,2.0,811.0,811.0
0.069,6,10,1506,5,395,16.0,127.0,127.0,5,1111,17.0,843.0,843.0
0.071,17,8,3613,4,1874,23.0,1350.0,440.0,4,1739,12.0,1350.0,406.0
0.13,17,2,80,1,32,0.0,4.0,4.0,1,48,0.0,20.0,20.0
0.009,6,10,1990,5,911,2.0,643.0,643.0,5,1079,2.0,811.0,811.0
0.011,6,10,1983,5,910,2.0,642.0,642.0,5,1073,2.0,805.0,805.0
40.067,17,10,676,5,460,10013.0,104.0,64.0,5,216,10015.0,20.0,15.0
0.123,6,10,1506,5,395,26.0,127.0,127.0,5,1111,25.0,843.0,843.0
0.221,17,4,352,2,130,178.0,37.0,37.0,2,222,149.0,89.0,83.0
0.004,6,10,1702,5,863,0.0,595.0,595.0,5,839,1.0,571.0,571.0
0.078,6,10,1506,5,395,17.0,127.0,127.0,5,1111,15.0,843.0,843.0
0.005,6,10,1854,5,889,1.0,621.0,621.0,5,965,1.0,697.0,697.0
0.006,6,10,2007,5,928,1.0,660.0,660.0,5,1079,1.0,811.0,811.0
0.005,6,10,2006,5,927,1.0,659.0,659.0,5,1079,1.0,811.0,811.0
0.122,6,10,1506,5,395,26.0,127.0,127.0,5,1111,27.0,843.0,843.0
0.005,17,2,179,1,71,0.0,43.0,43.0,1,108,0.0,80.0,80.0
0.005,6,10,1774,5,923,1.0,655.0,655.0,5,851,1.0,583.0,583.0
1771.844,6,106,6322,60,3525,30030.0,27.0,27.0,46,2797,39373.0,27.0,27.0
0.013,6,10,1989,5,927,3.0,659.0,659.0,5,1062,3.0,794.0,794.0
0.005,6,10,2007,5,928,1.0,660.0,660.0,5,1079,1.0,811.0,811.0
0.002,17,2,180,1,66,0.0,38.0,38.0,1,114,0.0,86.0,86.0
0.217,6,16,2778,8,1396,31.0,533.0,324.0,8,1382,20.0,529.0,239.0
0.011,6,10,1677,5,827,2.0,559.0,559.0,5,850,2.0,582.0,582.0
0.007,6,10,1983,5,910,1.0,642.0,642.0,5,1073,1.0,805.0,805.0
0.005,6,10,1854,5,889,1.0,621.0,621.0,5,965,1.0,697.0,697.0
0.003,17,2,185,1,73,0.0,45.0,45.0,1,112,0.0,84.0,84.0
0.11,6,10,1506,5,395,24.0,127.0,127.0,5,1111,23.0,843.0,843.0
0.114,6,10,1506,5,395,27.0,127.0,127.0,5,1111,27.0,843.0,843.0
0.006,6,10,1689,5,839,1.0,571.0,571.0,5,850,1.0,582.0,582.0
0.005,6,10,1854,5,889,1.0,621.0,621.0,5,965,1.0,697.0,697.0
0.139,6,10,1506,5,395,33.0,127.0,127.0,5,1111,33.0,843.0,843.0
0.021,6,10,1677,5,827,5.0,559.0,559.0,5,850,5.0,582.0,582.0
0.001,17,2,180,1,66,0.0,38.0,38.0,1,114,0.0,86.0,86.0
0.016,6,10,1972,5,910,3.0,642.0,642.0,5,1062,3.0,794.0,794.0
0.067,6,10,1506,5,395,14.0,127.0,127.0,5,1111,13.0,843.0,843.0
0.013,6,10,1989,5,910,3.0,642.0,642.0,5,1079,3.0,811.0,811.0
0.005,6,10,1989,5,927,1.0,659.0,659.0,5,1062,1.0,794.0,794.0
0.065,6,10,1506,5,395,14.0,127.0,127.0,5,1111,14.0,843.0,843.0
0.163,17,2,152,1,76,0.0,48.0,48.0,1,76,0.0,48.0,48.0
0.005,17,2,164,1,74,0.0,46.0,46.0,1,90,0.0,62.0,62.0
0.006,6,10,1689,5,839,1.0,571.0,571.0,5,850,1.0,582.0,582.0
0.005,17,2,179,1,71,0.0,43.0,43.0,1,108,0.0,80.0,80.0
0.089,6,10,1506,5,395,17.0,127.0,127.0,5,1111,21.0,843.0,843.0
0.008,6,10,1989,5,910,2.0,642.0,642.0,5,1079,1.0,811.0,811.0
0.004,6,10,2006,5,927,1.0,659.0,659.0,5,1079,1.0,811.0,811.0
0.005,6,13,3690,7,452,0.0,80.0,80.0,6,3238,1.0,1470.0,1459.0
0.006,6,10,1643,5,860,1.0,592.0,592.0,5,783,1.0,515.0,515.0
0.006,6,14,3799,7,509,1.0,137.0,137.0,7,3290,0.0,1448.0,972.0
0.004,6,10,2006,5,927,1.0,659.0,659.0,5,1079,1.0,811.0,811.0
0.009,6,10,1972,5,910,2.0,642.0,642.0,5,1062,2.0,794.0,794.0
167.29,17,90,12820,45,3009,3801.0,44.0,38.0,45,9811,3802.0,260.0,190.0
0.129,17,2,80,1,32,0.0,4.0,4.0,1,48,0.0,20.0,20.0
0.279,6,10,1506,5,395,67.0,127.0,127.0,5,1111,38.0,843.0,843.0
0.004,17,4,284,2,120,1.0,32.0,32.0,2,164,0.0,60.0,54.0
0.004,6,10,2007,5,928,1.0,660.0,660.0,5,1079,1.0,811.0,811.0
0.005,6,10,2006,5,927,1.0,659.0,659.0,5,1079,1.0,811.0,811.0
0.001,17,2,142,1,63,0.0,35.0,35.0,1,79,0.0,51.0,51.0
0.005,6,13,3747,7,509,0.0,137.0,137.0,6,3238,1.0,1470.0,1459.0
0.009,6,10,1990,5,911,2.0,643.0,643.0,5,1079,2.0,811.0,811.0
0.007,6,10,1547,5,764,1.0,496.0,496.0,5,783,1.0,515.0,515.0
0.006,17,2,140,1,62,0.0,34.0,34.0,1,78,0.0,50.0,50.0
0.004,6,10,1702,5,863,1.0,595.0,595.0,5,839,0.0,571.0,571.0
40.068,17,10,676,5,460,10016.0,104.0,64.0,5,216,10015.0,20.0,15.0
0.013,6,10,1983,5,910,3.0,642.0,642.0,5,1073,3.0,805.0,805.0
66.619,6,31,17899,14,9539,5124.0,2847.0,1469.0,17,8360,4155.0,2316.0,678.0
0.021,6,10,1677,5,827,5.0,559.0,559.0,5,850,5.0,582.0,582.0
15.071,17,15,9238,8,6902,2149.0,1350.0,834.0,7,2336,2507.0,1350.0,305.0
0.003,17,2,148,1,60,0.0,32.0,32.0,1,88,0.0,60.0,60.0
152.998,6,21,8146,11,1985,81.0,1174.0,504.0,10,6161,16981.0,2720.0,958.0
1772.709,17,120,11460,60,5460,30045.0,63.0,63.0,60,6000,30045.0,72.0,72.0
0.005,6,10,2006,5,927,1.0,659.0,659.0,5,1079,1.0,811.0,811.0
0.104,6,10,1506,5,395,25.0,127.0,127.0,5,1111,22.0,843.0,843.0
0.005,6,10,2007,5,928,1.0,660.0,660.0,5,1079,1.0,811.0,811.0
0.004,6,10,1702,5,863,0.0,595.0,595.0,5,839,1.0,571.0,571.0
0.103,6,10,1506,5,395,22.0,127.0,127.0,5,1111,19.0,843.0,843.0
0.006,6,10,1689,5,839,1.0,571.0,571.0,5,850,1.0,582.0,582.0
40.069,17,10,676,5,460,10016.0,104.0,64.0,5,216,10016.0,20.0,15.0
0.072,17,4,284,2,120,0.0,32.0,32.0,2,164,69.0,60.0,54.0
0.008,6,10,1989,5,910,2.0,642.0,642.0,5,1079,1.0,811.0,811.0
0.004,6,10,2000,5,927,1.0,659.0,659.0,5,1073,1.0,805.0,805.0
0.004,6,10,1779,5,928,1.0,660.0,660.0,5,851,1.0,583.0,583.0
0.006,17,2,169,1,62,0.0,34.0,34.0,1,107,0.0,79.0,79.0
0.005,6,10,1989,5,927,1.0,659.0,659.0,5,1062,1.0,794.0,794.0
0.072,6,10,1506,5,395,16.0,127.0,127.0,5,1111,16.0,843.0,843.0
0.005,6,10,1989,5,927,1.0,659.0,659.0,5,1062,1.0,794.0,794.0
0.002,17,2,148,1,60,0.0,32.0,32.0,1,88,0.0,60.0,60.0
0.006,6,10,1689,5,839,1.0,571.0,571.0,5,850,1.0,582.0,582.0
0.008,6,14,3787,7,497,1.0,125.0,125.0,7,3290,1.0,1448.0,972.0
0.041,17,4,284,2,120,0.0,32.0,32.0,2,164,38.0,60.0,54.0
0.009,6,12,1926,6,1189,1.0,659.0,434.0,6,737,1.0,417.0,417.0
0.009,6,10,1983,5,910,2.0,642.0,642.0,5,1073,2.0,805.0,805.0
0.005,17,2,144,1,64,0.0,36.0,36.0,1,80,0.0,52.0,52.0
0.005,6,10,1547,5,764,1.0,496.0,496.0,5,783,1.0,515.0,515.0
0.01,6,10,1989,5,910,2.0,642.0,642.0,5,1079,2.0,811.0,811.0
0.004,6,10,1779,5,928,1.0,660.0,660.0,5,851,1.0,583.0,583.0
15.073,17,15,9239,8,6902,2149.0,1350.0,834.0,7,2337,2507.0,1350.0,305.0
0.01,6,10,1990,5,911,2.0,643.0,643.0,5,1079,2.0,811.0,811.0
294.995,6,312,344522,120,17795,2478.0,2691.0,889.0,192,326727,1544.0,2804.0,1779.0
0.015,6,10,1989,5,910,3.0,642.0,642.0,5,1079,3.0,811.0,811.0
0.005,6,10,1689,5,839,1.0,571.0,571.0,5,850,1.0,582.0,582.0
0.005,6,10,1989,5,927,1.0,659.0,659.0,5,1062,1.0,794.0,794.0
0.119,6,10,1506,5,395,23.0,127.0,127.0,5,1111,26.0,843.0,843.0
0.08,6,10,1506,5,395,18.0,127.0,127.0,5,1111,19.0,843.0,843.0
0.08,6,10,1506,5,395,18.0,127.0,127.0,5,1111,17.0,843.0,843.0
0.012,6,10,1972,5,910,3.0,642.0,642.0,5,1062,3.0,794.0,794.0
0.006,6,10,1547,5,764,1.0,496.0,496.0,5,783,1.0,515.0,515.0
0.001,17,2,174,1,72,0.0,44.0,44.0,1,102,0.0,74.0,74.0
0.01,6,10,1972,5,910,2.0,642.0,642.0,5,1062,2.0,794.0,794.0
40.062,17,10,676,5,460,10014.0,104.0,64.0,5,216,10014.0,20.0,15.0
0.118,6,10,1506,5,395,25.0,127.0,127.0,5,1111,24.0,843.0,843.0
0.008,6,10,1972,5,910,2.0,642.0,642.0,5,1062,1.0,794.0,794.0
0.009,6,12,1926,6,1189,1.0,659.0,434.0,6,737,1.0,417.0,417.0
0.004,17,2,166,1,75,0.0,47.0,47.0,1,91,0.0,63.0,63.0
0.071,17,2,136,1,60,0.0,32.0,32.0,1,76,0.0,48.0,48.0
0.005,17,4,284,2,120,0.0,32.0,32.0,2,164,0.0,60.0,54.0
179.034,17,68,9710,34,2267,5425.0,44.0,38.0,34,7443,5425.0,239.0,190.0
0.004,6,10,1779,5,928,1.0,660.0,660.0,5,851,1.0,583.0,583.0
0.005,6,10,1643,5,860,1.0,592.0,592.0,5,783,1.0,515.0,515.0
308.331,17,20,1124,10,716,34245.0,48.0,43.0,10,408,34246.0,20.0,12.0
11.099,17,28,4422,14,1995,841.0,270.0,114.0,14,2427,841.0,586.0,145.0
0.012,6,10,1989,5,910,3.0,642.0,642.0,5,1079,3.0,811.0,811.0
0.128,17,2,80,1,32,0.0,4.0,4.0,1,48,0.0,20.0,20.0
0.005,6,14,3799,7,509,0.0,137.0,137.0,7,3290,0.0,1448.0,972.0
40.067,17,10,676,5,460,10015.0,104.0,64.0,5,216,10015.0,20.0,15.0
0.001,17,2,180,1,66,0.0,38.0,38.0,1,114,0.0,86.0,86.0
0.004,6,10,2000,5,927,1.0,659.0,659.0,5,1073,1.0,805.0,805.0
0.006,6,10,1547,5,764,1.0,496.0,496.0,5,783,1.0,515.0,515.0
0.01,6,10,1643,5,860,2.0,592.0,592.0,5,783,2.0,515.0,515.0
308.589,17,20,1124,10,716,34272.0,48.0,43.0,10,408,34272.0,20.0,12.0
0.088,6,10,1506,5,395,20.0,127.0,127.0,5,1111,19.0,843.0,843.0
0.01,6,10,1983,5,910,2.0,642.0,642.0,5,1073,2.0,805.0,805.0
0.013,17,2,152,1,56,0.0,28.0,28.0,1,96,0.0,68.0,68.0
0.124,6,10,1506,5,395,23.0,127.0,127.0,5,1111,27.0,843.0,843.0
0.005,6,10,2006,5,927,1.0,659.0,659.0,5,1079,1.0,811.0,811.0
0.009,6,13,3735,7,497,1.0,125.0,125.0,6,3238,1.0,1470.0,1459.0
0.005,6,10,2006,5,927,1.0,659.0,659.0,5,1079,1.0,811.0,811.0
0.005,17,2,136,1,60,0.0,32.0,32.0,1,76,0.0,48.0,48.0
0.005,6,10,2007,5,928,1.0,660.0,660.0,5,1079,1.0,811.0,811.0
1792.104,6,569,191046,291,164855,6179.0,2883.0,947.0,278,26191,6469.0,580.0,113.0
0.008,6,10,1990,5,911,2.0,643.0,643.0,5,1079,2.0,811.0,811.0
0.005,6,10,1547,5,764,1.0,496.0,496.0,5,783,1.0,515.0,515.0
0.005,6,10,1779,5,928,1.0,660.0,660.0,5,851,1.0,583.0,583.0
0.021,17,2,170,1,65,0.0,37.0,37.0,1,105,0.0,77.0,77.0
0.086,6,10,1506,5,395,18.0,127.0,127.0,5,1111,20.0,843.0,843.0
0.005,6,10,1854,5,889,1.0,621.0,621.0,5,965,1.0,697.0,697.0
174.054,17,82,11678,41,2752,4351.0,44.0,39.0,41,8926,4351.0,260.0,189.0
0.087,6,10,1506,5,395,17.0,127.0,127.0,5,1111,20.0,843.0,843.0
0.001,17,2,166,1,75,0.0,47.0,47.0,1,91,0.0,63.0,63.0
0.052,17,2,152,1,76,0.0,48.0,48.0,1,76,0.0,48.0,48.0
0.02,6,10,1990,5,911,5.0,643.0,643.0,5,1079,4.0,811.0,811.0
40.036,17,10,676,5,460,10005.0,104.0,64.0,5,216,10008.0,20.0,15.0
0.006,6,10,1547,5,764,1.0,496.0,496.0,5,783,1.0,515.0,515.0
0.042,17,2,136,1,60,0.0,32.0,32.0,1,76,0.0,48.0,48.0
0.014,6,14,3787,7,497,2.0,125.0,125.0,7,3290,2.0,1448.0,972.0
240.016,6,9,787,5,488,60004.0,232.0,232.0,4,299,80004.0,83.0,83.0
0.006,6,10,1547,5,764,1.0,496.0,496.0,5,783,1.0,515.0,515.0
177.366,17,82,11203,41,2749,4434.0,44.0,39.0,41,8454,4434.0,239.0,178.0
0.107,6,10,1506,5,395,23.0,127.0,127.0,5,1111,25.0,843.0,843.0
240.083,6,16,4480,9,963,30010.0,238.0,166.0,7,3517,40013.0,1402.0,786.0
0.006,17,2,179,1,71,0.0,43.0,43.0,1,108,0.0,80.0,80.0
0.108,6,10,1506,5,395,23.0,127.0,127.0,5,1111,25.0,843.0,843.0
40.062,17,10,676,5,460,10014.0,104.0,64.0,5,216,10014.0,20.0,15.0
0.01,6,10,1990,5,911,2.0,643.0,643.0,5,1079,2.0,811.0,811.0
0.008,6,10,1762,5,911,2.0,643.0,643.0,5,851,2.0,583.0,583.0
0.042,17,4,284,2,120,0.0,32.0,32.0,2,164,31.0,60.0,54.0
0.003,17,2,185,1,73,0.0,45.0,45.0,1,112,0.0,84.0,84.0
0.072,6,10,1506,5,395,17.0,127.0,127.0,5,1111,16.0,843.0,843.0
0.012,6,10,1990,5,911,3.0,643.0,643.0,5,1079,3.0,811.0,811.0
10.978,17,28,4398,14,2312,836.0,587.0,137.0,14,2086,835.0,269.0,121.0
0.004,6,10,1989,5,927,1.0,659.0,659.0,5,1062,1.0,794.0,794.0
0.012,6,10,1989,5,910,3.0,642.0,642.0,5,1079,3.0,811.0,811.0
0.001,17,2,180,1,66,0.0,38.0,38.0,1,114,0.0,86.0,86.0
0.005,6,10,2006,5,927,1.0,659.0,659.0,5,1079,1.0,811.0,811.0
0.024,6,10,1983,5,910,5.0,642.0,642.0,5,1073,6.0,805.0,805.0
246.659,6,20,3887,10,2388,27402.0,676.0,372.0,10,1499,27402.0,760.0,245.0
0.005,6,10,2006,5,927,1.0,659.0,659.0,5,1079,1.0,811.0,811.0
0.013,6,10,1989,5,910,3.0,642.0,642.0,5,1079,3.0,811.0,811.0
0.006,6,10,1989,5,927,1.0,659.0,659.0,5,1062,1.0,794.0,794.0
254.735,6,11,891,5,488,63683.0,232.0,232.0,6,403,50946.0,83.0,83.0
0.006,6,10,1547,5,764,1.0,496.0,496.0,5,783,1.0,515.0,515.0
0.056,6,10,1506,5,395,12.0,127.0,127.0,5,1111,11.0,843.0,843.0
0.122,6,10,1506,5,395,23.0,127.0,127.0,5,1111,27.0,843.0,843.0
0.016,6,10,1990,5,911,4.0,643.0,643.0,5,1079,4.0,811.0,811.0
0.006,6,10,1689,5,839,1.0,571.0,571.0,5,850,1.0,582.0,582.0
0.07,6,10,1506,5,395,14.0,127.0,127.0,5,1111,15.0,843.0,843.0
0.008,6,10,1983,5,910,2.0,642.0,642.0,5,1073,2.0,805.0,805.0
0.004,6,10,1774,5,923,1.0,655.0,655.0,5,851,1.0,583.0,583.0
0.005,6,10,1643,5,860,1.0,592.0,592.0,5,783,1.0,515.0,515.0
0.005,6,10,1854,5,889,1.0,621.0,621.0,5,965,1.0,697.0,697.0
0.005,6,13,3747,7,509,0.0,137.0,137.0,6,3238,0.0,1470.0,1459.0
0.012,6,10,1990,5,911,2.0,643.0,643.0,5,1079,2.0,811.0,811.0
170.51,17,72,10108,36,2396,4871.0,44.0,38.0,36,7712,4871.0,239.0,186.0
0.004,6,10,2000,5,927,1.0,659.0,659.0,5,1073,1.0,805.0,805.0
0.006,6,10,1547,5,764,1.0,496.0,496.0,5,783,1.0,515.0,515.0
0.013,6,10,1990,5,911,3.0,643.0,643.0,5,1079,3.0,811.0,811.0
40.071,17,10,676,5,460,10016.0,104.0,64.0,5,216,10017.0,20.0,15.0
0.084,6,10,1506,5,395,20.0,127.0,127.0,5,1111,18.0,843.0,843.0
0.005,6,10,2006,5,927,1.0,659.0,659.0,5,1079,1.0,811.0,811.0
0.01,6,10,1990,5,911,2.0,643.0,643.0,5,1079,2.0,811.0,811.0
0.009,6,10,1989,5,910,2.0,642.0,642.0,5,1079,2.0,811.0,811.0
0.066,6,10,1506,5,395,14.0,127.0,127.0,5,1111,15.0,843.0,843.0
0.094,6,10,1506,5,395,19.0,127.0,127.0,5,1111,21.0,843.0,843.0
0.012,6,10,1989,5,910,3.0,642.0,642.0,5,1079,3.0,811.0,811.0
0.005,6,10,1547,5,764,1.0,496.0,496.0,5,783,1.0,515.0,515.0
235.29,58,5,360,4,288,78430.0,24.0,24.0,1,72,0.0,24.0,24.0
40.069,17,10,676,5,460,10016.0,104.0,64.0,5,216,10016.0,20.0,15.0
0.019,6,13,3913,7,495,3.0,123.0,123.0,6,3418,3.0,1650.0,1549.0
0.119,6,10,1506,5,395,25.0,127.0,127.0,5,1111,26.0,843.0,843.0
0.0,17,2,140,1,62,0.0,34.0,34.0,1,78,0.0,50.0,50.0
0.009,6,14,3787,7,497,1.0,125.0,125.0,7,3290,1.0,1448.0,972.0
0.168,6,3,453,2,321,168.0,241.0,241.0,1,132,0.0,92.0,92.0
0.006,6,10,1689,5,839,1.0,571.0,571.0,5,850,1.0,582.0,582.0
0.004,6,10,1779,5,928,1.0,660.0,660.0,5,851,1.0,583.0,583.0
40.063,17,10,676,5,460,10013.0,104.0,64.0,5,216,10012.0,20.0,15.0
300.977,6,45,18239,25,12641,12540.0,2720.0,1160.0,20,5598,463.0,2667.0,435.0
0.005,17,2,193,1,71,0.0,43.0,43.0,1,122,0.0,94.0,94.0
0.111,17,2,230,1,68,0.0,40.0,40.0,1,162,0.0,134.0,134.0
0.041,17,2,152,1,76,0.0,48.0,48.0,1,76,0.0,48.0,48.0
0.425,6,16,2778,8,1396,60.0,533.0,324.0,8,1382,42.0,529.0,239.0
0.292,6,10,1506,5,395,57.0,127.0,127.0,5,1111,72.0,843.0,843.0
0.005,17,2,136,1,60,0.0,32.0,32.0,1,76,0.0,48.0,48.0
0.003,17,4,284,2,120,0.0,32.0,32.0,2,164,0.0,60.0,54.0
240.103,6,16,4482,9,963,30012.0,238.0,166.0,7,3519,40016.0,1402.0,786.0
0.011,6,10,1972,5,910,2.0,642.0,642.0,5,1062,2.0,794.0,794.0
0.173,6,3,453,2,321,173.0,241.0,241.0,1,132,0.0,92.0,92.0
0.005,6,10,2007,5,928,1.0,660.0,660.0,5,1079,1.0,811.0,811.0
0.015,6,10,1989,5,910,3.0,642.0,642.0,5,1079,3.0,811.0,811.0
0.006,6,10,1643,5,860,1.0,592.0,592.0,5,783,1.0,515.0,515.0
0.007,6,10,1643,5,860,1.0,592.0,592.0,5,783,1.0,515.0,515.0
0.011,6,10,1989,5,910,2.0,642.0,642.0,5,1079,2.0,811.0,811.0
0.004,6,10,2007,5,928,1.0,660.0,660.0,5,1079,1.0,811.0,811.0
1729.237,6,60,4400,40,2740,44339.0,33.0,33.0,20,1660,91003.0,31.0,31.0
0.027,6,10,1677,5,827,6.0,559.0,559.0,5,850,6.0,582.0,582.0
0.019,17,2,170,1,65,0.0,37.0,37.0,1,105,0.0,77.0,77.0
0.129,6,10,1506,5,395,29.0,127.0,127.0,5,1111,27.0,843.0,843.0
40.056,17,10,676,5,460,10012.0,104.0,64.0,5,216,10013.0,20.0,15.0
0.012,6,10,1677,5,827,3.0,559.0,559.0,5,850,2.0,582.0,582.0
0.038,17,2,144,1,64,0.0,36.0,36.0,1,80,0.0,52.0,52.0
0.012,6,10,1972,5,910,3.0,642.0,642.0,5,1062,3.0,794.0,794.0
0.018,6,10,1631,5,848,4.0,580.0,580.0,5,783,4.0,515.0,515.0
40.063,17,10,676,5,460,10015.0,104.0,64.0,5,216,10009.0,20.0,15.0
132.172,6,43,13508,23,7681,6007.0,1753.0,961.0,20,5827,468.0,2667.0,385.0
0.012,6,10,1990,5,911,3.0,643.0,643.0,5,1079,3.0,811.0,811.0
1012.707,6,89,19069,52,15062,14122.0,494.0,494.0,37,4007,28130.0,83.0,83.0
0.009,6,10,1990,5,911,2.0,643.0,643.0,5,1079,2.0,811.0,811.0
0.005,6,10,1702,5,863,1.0,595.0,595.0,5,839,1.0,571.0,571.0
0.004,6,10,2006,5,927,1.0,659.0,659.0,5,1079,1.0,811.0,811.0
0.019,6,10,1972,5,910,4.0,642.0,642.0,5,1062,4.0,794.0,794.0
0.004,6,10,1989,5,927,1.0,659.0,659.0,5,1062,1.0,794.0,794.0
0.018,6,13,3816,7,578,3.0,206.0,206.0,6,3238,3.0,1470.0,1459.0
0.037,17,2,148,1,60,0.0,32.0,32.0,1,88,0.0,60.0,60.0
0.012,6,10,1989,5,910,2.0,642.0,642.0,5,1079,3.0,811.0,811.0
10.901,17,28,4422,14,1994,830.0,269.0,114.0,14,2428,830.0,587.0,145.0
0.001,17,2,180,1,66,0.0,38.0,38.0,1,114,0.0,86.0,86.0
0.003,17,2,142,1,63,0.0,35.0,35.0,1,79,0.0,51.0,51.0
0.006,6,10,1989,5,927,1.0,659.0,659.0,5,1062,1.0,794.0,794.0
0.005,6,10,1774,5,923,1.0,655.0,655.0,5,851,1.0,583.0,583.0
0.072,17,2,136,1,60,0.0,32.0,32.0,1,76,0.0,48.0,48.0
0.001,17,2,136,1,60,0.0,32.0,32.0,1,76,0.0,48.0,48.0
0.006,6,10,1547,5,764,1.0,496.0,496.0,5,783,1.0,515.0,515.0
0.004,17,2,136,1,60,0.0,32.0,32.0,1,76,0.0,48.0,48.0
0.003,17,2,185,1,73,0.0,45.0,45.0,1,112,0.0,84.0,84.0
308.444,17,20,1124,10,716,34257.0,48.0,43.0,10,408,34257.0,20.0,12.0
0.013,6,10,1990,5,911,3.0,643.0,643.0,5,1079,3.0,811.0,811.0
0.004,6,10,2007,5,928,1.0,660.0,660.0,5,1079,1.0,811.0,811.0
0.009,6,10,1983,5,910,2.0,642.0,642.0,5,1073,2.0,805.0,805.0
0.025,6,10,1972,5,910,6.0,642.0,642.0,5,1062,6.0,794.0,794.0
0.11,6,10,1506,5,395,26.0,127.0,127.0,5,1111,24.0,843.0,843.0
0.003,17,2,148,1,60,0.0,32.0,32.0,1,88,0.0,60.0,60.0
0.004,6,10,1774,5,923,1.0,655.0,655.0,5,851,0.0,583.0,583.0
0.005,17,2,214,1,75,0.0,47.0,47.0,1,139,0.0,111.0,111.0
0.005,17,2,412,1,61,0.0,33.0,33.0,1,351,0.0,323.0,323.0
0.008,6,10,1989,5,910,2.0,642.0,642.0,5,1079,2.0,811.0,811.0
0.017,6,10,1989,5,910,4.0,642.0,642.0,5,1079,4.0,811.0,811.0
352.248,6,20,2210,6,1308,12004.0,494.0,494.0,14,902,27095.0,83.0,83.0
0.008,17,2,194,1,59,0.0,31.0,31.0,1,135,0.0,107.0,107.0
0.07,6,10,1506,5,395,14.0,127.0,127.0,5,1111,16.0,843.0,843.0
0.29,17,2,152,1,76,0.0,48.0,48.0,1,76,0.0,48.0,48.0
0.038,17,2,184,1,61,0.0,33.0,33.0,1,123,0.0,95.0,95.0
0.078,6,10,1506,5,395,17.0,127.0,127.0,5,1111,17.0,843.0,843.0
0.075,6,10,1506,5,395,15.0,127.0,127.0,5,1111,17.0,843.0,843.0
0.21,6,16,2669,8,1395,30.0,533.0,323.0,8,1274,19.0,529.0,212.0
0.004,6,10,1702,5,863,1.0,595.0,595.0,5,839,1.0,571.0,571.0
0.013,6,10,1989,5,910,3.0,642.0,642.0,5,1079,3.0,811.0,811.0
0.015,6,10,1990,5,911,3.0,643.0,643.0,5,1079,3.0,811.0,811.0
0.029,6,13,3913,7,495,4.0,123.0,123.0,6,3418,5.0,1650.0,1549.0
0.009,6,10,1989,5,910,2.0,642.0,642.0,5,1079,2.0,811.0,811.0
0.103,6,10,1506,5,395,25.0,127.0,127.0,5,1111,20.0,843.0,843.0
65.684,6,28,17808,15,9809,4691.0,2804.0,1503.0,13,7999,5459.0,2318.0,1045.0
0.005,6,10,1689,5,839,1.0,571.0,571.0,5,850,1.0,582.0,582.0
0.004,6,10,1989,5,927,1.0,659.0,659.0,5,1062,1.0,794.0,794.0
0.017,6,10,1972,5,910,4.0,642.0,642.0,5,1062,4.0,794.0,794.0
334.771,17,18,1008,9,640,41830.0,48.0,43.0,9,368,41830.0,20.0,12.0
0.006,6,10,1643,5,860,1.0,592.0,592.0,5,783,1.0,515.0,515.0
0.019,6,10,1989,5,910,4.0,642.0,642.0,5,1079,4.0,811.0,811.0
0.093,6,10,1506,5,395,21.0,127.0,127.0,5,1111,20.0,843.0,843.0
0.001,17,2,180,1,66,0.0,38.0,38.0,1,114,0.0,86.0,86.0
0.014,6,10,1990,5,911,3.0,643.0,643.0,5,1079,3.0,811.0,811.0
0.109,6,10,1506,5,395,19.0,127.0,127.0,5,1111,24.0,843.0,843.0
0.001,17,2,179,1,62,0.0,34.0,34.0,1,117,0.0,89.0,89.0
0.104,6,10,1506,5,395,22.0,127.0,127.0,5,1111,25.0,843.0,843.0
11.112,17,28,4421,14,1993,842.0,268.0,114.0,14,2428,842.0,587.0,145.0
0.005,6,10,2006,5,927,1.0,659.0,659.0,5,1079,1.0,811.0,811.0
0.005,6,10,2007,5,928,1.0,660.0,660.0,5,1079,1.0,811.0,811.0
0.006,6,10,1689,5,839,1.0,571.0,571.0,5,850,1.0,582.0,582.0
0.016,6,10,1989,5,910,4.0,642.0,642.0,5,1079,4.0,811.0,811.0
0.007,6,10,1983,5,910,1.0,642.0,642.0,5,1073,1.0,805.0,805.0
0.116,6,10,1506,5,395,17.0,127.0,127.0,5,1111,25.0,843.0,843.0
0.004,17,2,148,1,60,0.0,32.0,32.0,1,88,0.0,60.0,60.0
0.014,6,10,1989,5,910,3.0,642.0,642.0,5,1079,3.0,811.0,811.0
0.07,6,10,1506,5,395,16.0,127.0,127.0,5,1111,15.0,843.0,843.0
0.006,6,10,1643,5,860,1.0,592.0,592.0,5,783,1.0,515.0,515.0
0.005,6,10,2007,5,928,1.0,660.0,660.0,5,1079,1.0,811.0,811.0
0.012,6,10,1989,5,910,2.0,642.0,642.0,5,1079,2.0,811.0,811.0
0.04,17,4,596,2,122,0.0,33.0,33.0,2,474,0.0,323.0,209.0
0.005,17,2,170,1,65,0.0,37.0,37.0,1,105,0.0,77.0,77.0
176.279,17,86,12159,43,2868,4196.0,44.0,38.0,43,9291,4197.0,261.0,188.0
10.742,17,28,4422,14,1995,817.0,270.0,114.0,14,2427,817.0,586.0,145.0
1787.804,6,151,19402,90,13740,20087.0,302.0,302.0,61,5662,29796.0,83.0,83.0
11.477,17,28,4389,14,2312,870.0,587.0,137.0,14,2077,870.0,268.0,120.0
0.015,6,10,1990,5,911,3.0,643.0,643.0,5,1079,3.0,811.0,811.0
0.005,6,10,1689,5,839,1.0,571.0,571.0,5,850,1.0,582.0,582.0
0.079,6,10,1506,5,395,17.0,127.0,127.0,5,1111,15.0,843.0,843.0
0.073,6,10,1506,5,395,14.0,127.0,127.0,5,1111,16.0,843.0,843.0
40.057,17,10,676,5,460,10013.0,104.0,64.0,5,216,10013.0,20.0,15.0
0.005,6,10,2000,5,927,1.0,659.0,659.0,5,1073,1.0,805.0,805.0
0.006,17,2,148,1,60,0.0,32.0,32.0,1,88,0.0,60.0,60.0
0.004,6,10,2000,5,927,1.0,659.0,659.0,5,1073,1.0,805.0,805.0
308.453,17,18,1008,9,640,38546.0,48.0,43.0,9,368,38543.0,20.0,12.0
0.204,6,16,2783,8,1401,29.0,533.0,325.0,8,1382,18.0,529.0,239.0
0.005,6,10,2000,5,927,1.0,659.0,659.0,5,1073,1.0,805.0,805.0
0.154,6,10,1506,5,395,33.0,127.0,127.0,5,1111,24.0,843.0,843.0
496.806,6,51,20062,28,5296,18400.0,676.0,479.0,23,14766,22581.0,1907.0,969.0
1770.309,6,83,4368,42,2210,43177.0,26.0,26.0,41,2158,44256.0,26.0,26.0
0.009,6,10,1990,5,911,2.0,643.0,643.0,5,1079,2.0,811.0,811.0
0.005,6,10,2006,5,927,1.0,659.0,659.0,5,1079,1.0,811.0,811.0
0.018,6,10,1762,5,911,4.0,643.0,643.0,5,851,4.0,583.0,583.0
0.008,6,10,1989,5,910,2.0,642.0,642.0,5,1079,2.0,811.0,811.0
0.008,6,10,1972,5,910,2.0,642.0,642.0,5,1062,1.0,794.0,794.0
0.005,6,10,1643,5,860,1.0,592.0,592.0,5,783,1.0,515.0,515.0
0.217,6,16,2778,8,1396,31.0,533.0,324.0,8,1382,19.0,529.0,239.0
0.018,6,6,716,3,458,8.0,302.0,302.0,3,258,7.0,102.0,102.0
0.011,6,10,1989,5,910,2.0,642.0,642.0,5,1079,2.0,811.0,811.0
15.075,17,15,9238,8,6902,2149.0,1350.0,834.0,7,2336,2507.0,1350.0,305.0
0.041,17,2,234,1,61,0.0,33.0,33.0,1,173,0.0,145.0,145.0
0.006,6,10,1547,5,764,1.0,496.0,496.0,5,783,1.0,515.0,515.0
0.004,17,2,148,1,60,0.0,32.0,32.0,1,88,0.0,60.0,60.0
0.005,6,13,3747,7,509,0.0,137.0,137.0,6,3238,0.0,1470.0,1459.0
0.006,6,11,2059,6,980,1.0,660.0,660.0,5,1079,1.0,811.0,811.0
0.01,6,10,1989,5,910,2.0,642.0,642.0,5,1079,2.0,811.0,811.0
40.055,17,10,676,5,460,10013.0,104.0,64.0,5,216,10012.0,20.0,15.0
0.004,6,10,1779,5,928,1.0,660.0,660.0,5,851,1.0,583.0,583.0
15.075,17,15,9238,8,6902,2149.0,1350.0,834.0,7,2336,2507.0,1350.0,305.0
0.004,17,2,136,1,60,0.0,32.0,32.0,1,76,0.0,48.0,48.0
0.007,6,10,2006,5,927,1.0,659.0,659.0,5,1079,1.0,811.0,811.0
361.83,6,21,1793,16,1030,24122.0,190.0,190.0,5,763,60010.0,462.0,247.0
0.014,6,10,1989,5,910,3.0,642.0,642.0,5,1079,3.0,811.0,811.0
0.004,17,4,284,2,120,0.0,32.0,32.0,2,164,1.0,60.0,54.0
0.005,6,10,1989,5,927,1.0,659.0,659.0,5,1062,1.0,794.0,794.0
0.011,6,6,716,3,458,4.0,302.0,302.0,3,258,4.0,102.0,102.0
0.005,17,2,164,1,74,0.0,46.0,46.0,1,90,0.0,62.0,62.0
0.019,6,13,3735,7,497,3.0,125.0,125.0,6,3238,3.0,1470.0,1459.0
0.01,6,10,1989,5,910,2.0,642.0,642.0,5,1079,2.0,811.0,811.0
0.001,17,2,180,1,66,0.0,38.0,38.0,1,114,0.0,86.0,86.0
0.068,6,10,1506,5,395,16.0,127.0,127.0,5,1111,12.0,843.0,843.0
40.054,17,10,676,5,460,10012.0,104.0,64.0,5,216,10012.0,20.0,15.0
0.007,6,10,1547,5,764,1.0,496.0,496.0,5,783,1.0,515.0,515.0
0.006,6,10,1689,5,839,1.0,571.0,571.0,5,850,1.0,582.0,582.0
0.005,17,2,144,1,64,0.0,36.0,36.0,1,80,0.0,52.0,52.0
0.006,6,10,1989,5,927,1.0,659.0,659.0,5,1062,1.0,794.0,794.0
10.774,17,28,4418,14,1994,819.0,269.0,114.0,14,2424,819.0,587.0,145.0
0.001,17,2,180,1,66,0.0,38.0,38.0,1,114,0.0,86.0,86.0
0.039,17,2,152,1,76,0.0,48.0,48.0,1,76,0.0,48.0,48.0
0.088,6,10,1506,5,395,19.0,127.0,127.0,5,1111,19.0,843.0,843.0
0.124,6,10,1506,5,395,28.0,127.0,127.0,5,1111,25.0,843.0,843.0
0.004,17,2,148,1,60,0.0,32.0,32.0,1,88,0.0,60.0,60.0
0.004,17,2,148,1,60,0.0,32.0,32.0,1,88,0.0,60.0,60.0
0.009,6,10,1990,5,911,2.0,643.0,643.0,5,1079,2.0,811.0,811.0
120.723,6,60,19190,35,4909,3550.0,1053.0,221.0,25,14281,5029.0,2804.0,926.0
0.076,6,10,1506,5,395,16.0,127.0,127.0,5,1111,16.0,843.0,843.0
0.005,6,10,1989,5,927,1.0,659.0,659.0,5,1062,1.0,794.0,794.0
0.005,6,10,2007,5,928,1.0,660.0,660.0,5,1079,1.0,811.0,811.0
40.076,17,10,676,5,460,10018.0,104.0,64.0,5,216,10018.0,20.0,15.0
0.011,6,10,1972,5,910,2.0,642.0,642.0,5,1062,2.0,794.0,794.0
300.792,6,39,11172,21,5654,15039.0,1678.0,797.0,18,5518,506.0,2667.0,435.0
0.004,6,10,2000,5,927,1.0,659.0,659.0,5,1073,1.0,805.0,805.0
0.008,17,2,179,1,71,0.0,43.0,43.0,1,108,0.0,80.0,80.0
0.006,6,10,1547,5,764,1.0,496.0,496.0,5,783,1.0,515.0,515.0
11.184,17,28,4418,14,1994,847.0,269.0,114.0,14,2424,847.0,587.0,145.0
0.004,6,10,1702,5,863,0.0,595.0,595.0,5,839,1.0,571.0,571.0
0.013,6,10,1972,5,910,3.0,642.0,642.0,5,1062,3.0,794.0,794.0
0.003,17,2,234,1,61,0.0,33.0,33.0,1,173,0.0,145.0,145.0
0.125,17,2,80,1,32,0.0,4.0,4.0,1,48,0.0,20.0,20.0
0.015,6,10,1983,5,910,3.0,642.0,642.0,5,1073,3.0,805.0,805.0
332.212,17,20,1124,10,716,36898.0,48.0,43.0,10,408,36898.0,20.0,12.0
0.089,6,10,1506,5,395,19.0,127.0,127.0,5,1111,19.0,843.0,843.0
0.118,6,10,1506,5,395,26.0,127.0,127.0,5,1111,26.0,843.0,843.0
0.008,6,10,1989,5,910,1.0,642.0,642.0,5,1079,2.0,811.0,811.0
0.009,6,10,1990,5,911,2.0,643.0,643.0,5,1079,2.0,811.0,811.0
0.092,6,10,1506,5,395,18.0,127.0,127.0,5,1111,20.0,843.0,843.0
0.125,17,2,80,1,32,0.0,4.0,4.0,1,48,0.0,20.0,20.0
0.109,6,10,1506,5,395,25.0,127.0,127.0,5,1111,24.0,843.0,843.0
0.005,6,10,1989,5,927,1.0,659.0,659.0,5,1062,1.0,794.0,794.0
0.012,6,10,1983,5,910,3.0,642.0,642.0,5,1073,2.0,805.0,805.0
0.001,17,2,180,1,66,0.0,38.0,38.0,1,114,0.0,86.0,86.0
40.061,17,10,676,5,460,10014.0,104.0,64.0,5,216,10014.0,20.0,15.0
0.118,6,10,1506,5,395,19.0,127.0,127.0,5,1111,26.0,843.0,843.0
15.074,17,15,9238,8,6902,2149.0,1350.0,834.0,7,2336,2507.0,1350.0,305.0
1729.216,6,60,4400,40,2740,44338.0,33.0,33.0,20,1660,91002.0,31.0,31.0
0.04,17,4,284,2,120,0.0,32.0,32.0,2,164,37.0,60.0,54.0
0.006,17,4,284,2,120,0.0,32.0,32.0,2,164,1.0,60.0,54.0
0.005,6,13,3747,7,509,0.0,137.0,137.0,6,3238,0.0,1470.0,1459.0
0.009,6,10,1989,5,910,2.0,642.0,642.0,5,1079,2.0,811.0,811.0
0.005,6,10,1689,5,839,1.0,571.0,571.0,5,850,1.0,582.0,582.0
1.152,6,32,13393,19,5933,64.0,1360.0,732.0,13,7460,81.0,2720.0,769.0
15.07,17,15,9239,8,6902,2148.0,1350.0,834.0,7,2337,2506.0,1350.0,305.0
0.004,6,10,2006,5,927,1.0,659.0,659.0,5,1079,1.0,811.0,811.0
0.071,17,4,284,2,120,0.0,32.0,32.0,2,164,68.0,60.0,54.0
15.075,17,15,9239,8,6902,2149.0,1350.0,834.0,7,2337,2507.0,1350.0,305.0
0.043,17,2,152,1,76,0.0,48.0,48.0,1,76,0.0,48.0,48.0
0.039,17,4,284,2,120,0.0,32.0,32.0,2,164,35.0,60.0,54.0
0.014,6,10,1989,5,910,3.0,642.0,642.0,5,1079,3.0,811.0,811.0
0.005,6,10,1779,5,928,1.0,660.0,660.0,5,851,1.0,583.0,583.0
65.867,6,27,17553,15,9603,4704.0,2804.0,1469.0,12,7950,5972.0,2321.0,1219.0
0.006,6,10,1547,5,764,1.0,496.0,496.0,5,783,1.0,515.0,515.0
1787.625,6,150,19350,90,13740,20085.0,302.0,302.0,60,5610,30298.0,83.0,83.0
40.069,17,10,676,5,460,10015.0,104.0,64.0,5,216,10016.0,20.0,15.0
0.012,6,10,1983,5,910,3.0,642.0,642.0,5,1073,3.0,805.0,805.0
165.346,17,78,10951,39,2600,4351.0,44.0,38.0,39,8351,4351.0,239.0,186.0
0.144,17,4,336,2,124,11.0,34.0,34.0,2,212,69.0,84.0,78.0
1.019,6,14,3962,7,2139,127.0,1328.0,923.0,7,1823,127.0,1300.0,769.0
0.005,6,10,2006,5,927,1.0,659.0,659.0,5,1079,1.0,811.0,811.0
0.006,6,10,1547,5,764,1.0,496.0,496.0,5,783,1.0,515.0,515.0
0.003,17,2,148,1,60,0.0,32.0,32.0,1,88,0.0,60.0,60.0
0.029,6,10,1990,5,911,7.0,643.0,643.0,5,1079,7.0,811.0,811.0
0.072,6,10,1506,5,395,15.0,127.0,127.0,5,1111,17.0,843.0,843.0
40.075,17,10,676,5,460,10016.0,104.0,64.0,5,216,10018.0,20.0,15.0
0.07,17,8,3613,4,1874,23.0,1350.0,440.0,4,1739,11.0,1350.0,406.0
0.053,17,4,284,2,120,1.0,32.0,32.0,2,164,32.0,60.0,54.0
0.004,17,2,136,1,60,0.0,32.0,32.0,1,76,0.0,48.0,48.0
1799.934,6,138,6704,77,3704,23683.0,39.0,39.0,61,3000,29994.0,35.0,35.0
0.041,17,4,596,2,122,0.0,33.0,33.0,2,474,36.0,323.0,209.0
0.017,6,10,1989,5,910,4.0,642.0,642.0,5,1079,4.0,811.0,811.0
0.004,6,10,1989,5,927,1.0,659.0,659.0,5,1062,1.0,794.0,794.0
0.012,6,10,1990,5,911,3.0,643.0,643.0,5,1079,2.0,811.0,811.0
40.054,17,10,676,5,460,10012.0,104.0,64.0,5,216,10012.0,20.0,15.0
0.007,17,4,284,2,120,1.0,32.0,32.0,2,164,0.0,60.0,54.0
0.009,6,13,3690,7,452,1.0,80.0,80.0,6,3238,1.0,1470.0,1459.0
0.077,6,10,1506,5,395,15.0,127.0,127.0,5,1111,18.0,843.0,843.0
240.11,6,22,4977,12,993,21828.0,180.0,93.0,10,3984,26678.0,1592.0,576.0
0.005,6,10,2000,5,927,1.0,659.0,659.0,5,1073,1.0,805.0,805.0
0.306,17,14,9851,8,6907,43.0,1350.0,835.0,6,2944,49.0,1350.0,462.0
0.005,6,10,2006,5,927,1.0,659.0,659.0,5,1079,1.0,811.0,811.0
0.001,17,2,180,1,66,0.0,38.0,38.0,1,114,0.0,86.0,86.0
15.071,17,14,9190,8,6902,2149.0,1350.0,834.0,6,2288,3008.0,1350.0,353.0
0.082,6,10,1506,5,395,18.0,127.0,127.0,5,1111,19.0,843.0,843.0
10.816,17,28,4422,14,1994,823.0,269.0,114.0,14,2428,823.0,587.0,145.0
0.015,6,10,1989,5,910,3.0,642.0,642.0,5,1079,3.0,811.0,811.0
0.024,6,12,1698,6,863,4.0,327.0,271.0,6,835,4.0,515.0,515.0
0.085,6,10,1506,5,395,19.0,127.0,127.0,5,1111,16.0,843.0,843.0
0.005,17,2,170,1,65,0.0,37.0,37.0,1,105,0.0,77.0,77.0
240.215,6,46,10743,23,7853,10918.0,1368.0,603.0,23,2890,10918.0,580.0,210.0
0.012,6,10,1983,5,910,3.0,642.0,642.0,5,1073,3.0,805.0,805.0
0.009,6,10,1983,5,910,2.0,642.0,642.0,5,1073,2.0,805.0,805.0
0.004,6,10,2006,5,927,1.0,659.0,659.0,5,1079,1.0,811.0,811.0
10.923,17,28,4399,14,2312,832.0,587.0,137.0,14,2087,832.0,270.0,121.0
0.074,6,10,1506,5,395,16.0,127.0,127.0,5,1111,17.0,843.0,843.0
0.079,6,10,1506,5,395,13.0,127.0,127.0,5,1111,19.0,843.0,843.0
0.008,6,10,1989,5,910,2.0,642.0,642.0,5,1079,2.0,811.0,811.0
240.083,6,16,4482,9,963,30010.0,238.0,166.0,7,3519,40013.0,1402.0,786.0
0.009,6,10,1989,5,910,2.0,642.0,642.0,5,1079,2.0,811.0,811.0
0.019,6,10,1990,5,911,4.0,643.0,643.0,5,1079,4.0,811.0,811.0
0.012,6,10,1972,5,910,3.0,642.0,642.0,5,1062,3.0,794.0,794.0
1731.209,6,52,3164,32,1875,55845.0,35.0,35.0,20,1289,91112.0,31.0,31.0
0.009,6,10,1972,5,910,2.0,642.0,642.0,5,1062,2.0,794.0,794.0
0.016,6,10,1989,5,910,4.0,642.0,642.0,5,1079,3.0,811.0,811.0
180.575,6,61,19355,35,4959,5311.0,1053.0,209.0,26,14396,7222.0,2804.0,815.0
0.001,17,2,180,1,65,0.0,37.0,37.0,1,115,0.0,87.0,87.0
0.006,6,10,1547,5,764,1.0,496.0,496.0,5,783,1.0,515.0,515.0
0.006,17,2,214,1,75,0.0,47.0,47.0,1,139,0.0,111.0,111.0
414.595,6,29,4409,12,3102,10913.0,494.0,494.0,17,1307,25911.0,83.0,83.0
0.004,6,10,2006,5,927,1.0,659.0,659.0,5,1079,1.0,811.0,811.0
0.016,6,10,1972,5,910,4.0,642.0,642.0,5,1062,3.0,794.0,794.0
0.006,6,10,1643,5,860,1.0,592.0,592.0,5,783,1.0,515.0,515.0
0.086,6,10,1506,5,395,17.0,127.0,127.0,5,1111,20.0,843.0,843.0
301.381,6,53,23860,27,17793,11591.0,4080.0,1516.0,26,6067,367.0,1360.0,358.0
0.091,6,10,1506,5,395,20.0,127.0,127.0,5,1111,21.0,843.0,843.0
0.09,6,10,1506,5,395,20.0,127.0,127.0,5,1111,18.0,843.0,843.0
0.005,17,2,175,1,65,0.0,37.0,37.0,1,110,0.0,82.0,82.0
0.004,6,10,2006,5,927,1.0,659.0,659.0,5,1079,1.0,811.0,811.0
0.066,6,10,1506,5,395,13.0,127.0,127.0,5,1111,13.0,843.0,843.0
0.021,6,10,1983,5,910,5.0,642.0,642.0,5,1073,5.0,805.0,805.0
0.006,6,10,1689,5,839,1.0,571.0,571.0,5,850,1.0,582.0,582.0
0.142,6,10,1506,5,395,32.0,127.0,127.0,5,1111,20.0,843.0,843.0
0.006,6,10,2006,5,927,1.0,659.0,659.0,5,1079,1.0,811.0,811.0
0.005,6,10,2007,5,928,1.0,660.0,660.0,5,1079,1.0,811.0,811.0
0.006,6,10,1774,5,923,1.0,655.0,655.0,5,851,1.0,583.0,583.0
0.355,17,53,34473,30,28482,12.0,1350.0,921.0,23,5991,13.0,1350.0,232.0
0.187,6,21,9080,11,4255,18.0,1368.0,735.0,10,4825,19.0,1657.0,1074.0
0.004,6,10,2007,5,928,1.0,660.0,660.0,5,1079,1.0,811.0,811.0
0.001,17,2,166,1,75,0.0,47.0,47.0,1,91,0.0,63.0,63.0
0.001,17,2,180,1,65,0.0,37.0,37.0,1,115,0.0,87.0,87.0
0.01,17,2,170,1,65,0.0,37.0,37.0,1,105,0.0,77.0,77.0
0.015,6,10,1762,5,911,3.0,643.0,643.0,5,851,3.0,583.0,583.0
0.079,6,10,1506,5,395,17.0,127.0,127.0,5,1111,16.0,843.0,843.0
0.013,6,10,1990,5,911,3.0,643.0,643.0,5,1079,3.0,811.0,811.0
0.035,6,10,1990,5,911,8.0,643.0,643.0,5,1079,8.0,811.0,811.0
0.009,6,10,1989,5,910,2.0,642.0,642.0,5,1079,2.0,811.0,811.0
0.088,6,10,1506,5,395,20.0,127.0,127.0,5,1111,18.0,843.0,843.0
0.019,6,10,1972,5,910,4.0,642.0,642.0,5,1062,4.0,794.0,794.0
0.005,6,10,1989,5,927,1.0,659.0,659.0,5,1062,1.0,794.0,794.0
0.004,6,10,1989,5,927,1.0,659.0,659.0,5,1062,1.0,794.0,794.0
0.006,6,10,1547,5,764,1.0,496.0,496.0,5,783,1.0,515.0,515.0
0.009,6,10,1989,5,910,2.0,642.0,642.0,5,1079,2.0,811.0,811.0
0.004,6,10,2006,5,927,1.0,659.0,659.0,5,1079,1.0,811.0,811.0
0.006,17,2,179,1,71,0.0,43.0,43.0,1,108,0.0,80.0,80.0
0.007,17,2,162,1,65,0.0,37.0,37.0,1,97,0.0,69.0,69.0
40.063,17,10,676,5,460,10015.0,104.0,64.0,5,216,10014.0,20.0,15.0
300.402,6,16,2170,9,684,37529.0,146.0,146.0,7,1486,50039.0,419.0,398.0
0.005,6,10,2006,5,927,1.0,659.0,659.0,5,1079,1.0,811.0,811.0
0.015,6,10,1983,5,910,3.0,642.0,642.0,5,1073,3.0,805.0,805.0
0.005,6,10,2006,5,927,1.0,659.0,659.0,5,1079,1.0,811.0,811.0
0.009,6,12,1926,6,1189,1.0,659.0,434.0,6,737,1.0,417.0,417.0
0.014,6,10,1989,5,910,3.0,642.0,642.0,5,1079,3.0,811.0,811.0
0.011,6,10,1631,5,848,2.0,580.0,580.0,5,783,2.0,515.0,515.0
0.097,6,10,1506,5,395,21.0,127.0,127.0,5,1111,22.0,843.0,843.0
0.004,6,10,2006,5,927,1.0,659.0,659.0,5,1079,1.0,811.0,811.0
11.17,17,28,4423,14,1995,846.0,270.0,114.0,14,2428,846.0,587.0,145.0
308.487,17,20,1124,10,716,34269.0,48.0,43.0,10,408,34269.0,20.0,12.0
0.127,6,10,1506,5,395,28.0,127.0,127.0,5,1111,27.0,843.0,843.0
0.175,17,2,152,1,76,0.0,48.0,48.0,1,76,0.0,48.0,48.0
0.013,6,10,1989,5,910,3.0,642.0,642.0,5,1079,3.0,811.0,811.0
0.042,17,4,284,2,120,0.0,32.0,32.0,2,164,4.0,60.0,54.0
0.096,6,10,1506,5,395,21.0,127.0,127.0,5,1111,22.0,843.0,843.0
0.012,6,10,1972,5,910,3.0,642.0,642.0,5,1062,3.0,794.0,794.0
0.015,6,13,3735,7,497,2.0,125.0,125.0,6,3238,2.0,1470.0,1459.0
0.013,6,10,1989,5,910,3.0,642.0,642.0,5,1079,3.0,811.0,811.0
0.097,6,10,1506,5,395,22.0,127.0,127.0,5,1111,21.0,843.0,843.0
0.263,17,42,26442,25,23391,10.0,1350.0,907.0,17,3051,12.0,1350.0,151.0
240.013,6,9,787,5,488,60003.0,232.0,232.0,4,299,80003.0,83.0,83.0
0.089,6,10,1506,5,395,19.0,127.0,127.0,5,1111,18.0,843.0,843.0
0.004,17,2,148,1,60,0.0,32.0,32.0,1,88,0.0,60.0,60.0
0.086,6,10,1506,5,395,18.0,127.0,127.0,5,1111,16.0,843.0,843.0
0.005,17,2,144,1,64,0.0,36.0,36.0,1,80,0.0,52.0,52.0
1730.369,6,54,3291,33,1950,54074.0,35.0,35.0,21,1341,86500.0,31.0,31.0
0.156,6,10,1506,5,395,36.0,127.0,127.0,5,1111,37.0,843.0,843.0
0.017,6,6,716,3,458,7.0,302.0,302.0,3,258,7.0,102.0,102.0
0.117,6,10,1506,5,395,26.0,127.0,127.0,5,1111,24.0,843.0,843.0
0.082,6,10,1506,5,395,17.0,127.0,127.0,5,1111,20.0,843.0,843.0
0.006,6,10,1689,5,839,1.0,571.0,571.0,5,850,1.0,582.0,582.0
0.092,6,10,1506,5,395,19.0,127.0,127.0,5,1111,20.0,843.0,843.0
0.02,6,10,1983,5,910,5.0,642.0,642.0,5,1073,4.0,805.0,805.0
0.01,6,10,1989,5,910,2.0,642.0,642.0,5,1079,2.0,811.0,811.0
0.006,6,10,1547,5,764,1.0,496.0,496.0,5,783,1.0,515.0,515.0
0.016,6,10,1972,5,910,3.0,642.0,642.0,5,1062,3.0,794.0,794.0
0.005,6,10,2007,5,928,1.0,660.0,660.0,5,1079,1.0,811.0,811.0
0.013,6,10,1677,5,827,3.0,559.0,559.0,5,850,3.0,582.0,582.0
0.084,6,10,1506,5,395,18.0,127.0,127.0,5,1111,16.0,843.0,843.0
0.005,17,2,140,1,62,0.0,34.0,34.0,1,78,0.0,50.0,50.0
0.085,6,10,1506,5,395,20.0,127.0,127.0,5,1111,18.0,843.0,843.0
0.125,6,10,1506,5,395,28.0,127.0,127.0,5,1111,27.0,843.0,843.0
0.014,6,10,1983,5,910,3.0,642.0,642.0,5,1073,3.0,805.0,805.0
0.005,6,10,2000,5,927,1.0,659.0,659.0,5,1073,1.0,805.0,805.0
0.004,17,4,284,2,120,0.0,32.0,32.0,2,164,1.0,60.0,54.0
0.072,17,2,182,1,65,0.0,37.0,37.0,1,117,0.0,89.0,89.0
0.004,6,10,2006,5,927,1.0,659.0,659.0,5,1079,1.0,811.0,811.0
0.006,17,2,239,1,63,0.0,35.0,35.0,1,176,0.0,148.0,148.0
0.013,6,10,1989,5,910,3.0,642.0,642.0,5,1079,3.0,811.0,811.0
0.011,6,10,1972,5,910,2.0,642.0,642.0,5,1062,2.0,794.0,794.0
0.008,6,10,1677,5,827,2.0,559.0,559.0,5,850,2.0,582.0,582.0
0.004,6,10,1774,5,923,1.0,655.0,655.0,5,851,1.0,583.0,583.0
0.014,6,10,1990,5,911,3.0,643.0,643.0,5,1079,3.0,811.0,811.0
0.009,6,13,3735,7,497,1.0,125.0,125.0,6,3238,1.0,1470.0,1459.0
15.07,17,14,9190,8,6902,2148.0,1350.0,834.0,6,2288,3008.0,1350.0,353.0
0.003,6,10,1702,5,863,0.0,595.0,595.0,5,839,0.0,571.0,571.0
0.005,6,10,1689,5,839,1.0,571.0,571.0,5,850,1.0,582.0,582.0
0.02,6,10,1972,5,910,4.0,642.0,642.0,5,1062,4.0,794.0,794.0
0.008,6,10,1989,5,910,2.0,642.0,642.0,5,1079,2.0,811.0,811.0
0.061,6,10,1506,5,395,12.0,127.0,127.0,5,1111,14.0,843.0,843.0
0.238,17,2,152,1,76,0.0,48.0,48.0,1,76,0.0,48.0,48.0
0.089,6,10,1506,5,395,19.0,127.0,127.0,5,1111,20.0,843.0,843.0
0.204,6,10,1506,5,395,43.0,127.0,127.0,5,1111,43.0,843.0,843.0
0.003,17,4,284,2,120,0.0,32.0,32.0,2,164,0.0,60.0,54.0
0.038,17,4,284,2,120,0.0,32.0,32.0,2,164,35.0,60.0,54.0
0.014,6,10,1989,5,910,3.0,642.0,642.0,5,1079,3.0,811.0,811.0
0.004,6,10,1774,5,923,1.0,655.0,655.0,5,851,1.0,583.0,583.0
293.849,6,408,349571,194,21651,1522.0,2736.0,888.0,214,327920,1379.0,2804.0,1583.0
0.006,6,10,1547,5,764,1.0,496.0,496.0,5,783,1.0,515.0,515.0
0.016,6,10,1631,5,848,3.0,580.0,580.0,5,783,4.0,515.0,515.0
0.012,6,10,1989,5,910,3.0,642.0,642.0,5,1079,3.0,811.0,811.0
0.008,6,10,1547,5,764,2.0,496.0,496.0,5,783,1.0,515.0,515.0
40.054,17,10,676,5,460,10012.0,104.0,64.0,5,216,10012.0,20.0,15.0
0.015,6,10,1972,5,910,3.0,642.0,642.0,5,1062,3.0,794.0,794.0
0.006,6,10,1547,5,764,1.0,496.0,496.0,5,783,1.0,515.0,515.0
0.007,6,10,1547,5,764,1.0,496.0,496.0,5,783,1.0,515.0,515.0
354.09,6,21,1795,16,1030,23606.0,190.0,190.0,5,765,60001.0,464.0,248.0
0.009,6,10,1990,5,911,2.0,643.0,643.0,5,1079,2.0,811.0,811.0
0.037,17,2,166,1,75,0.0,47.0,47.0,1,91,0.0,63.0,63.0
19.45,6,45,14537,23,8630,411.0,1679.0,959.0,22,5907,917.0,2667.0,385.0
0.005,6,10,1989,5,927,1.0,659.0,659.0,5,1062,1.0,794.0,794.0
0.005,6,10,2000,5,927,1.0,659.0,659.0,5,1073,1.0,805.0,805.0
0.005,6,10,1547,5,764,1.0,496.0,496.0,5,783,1.0,515.0,515.0
0.001,17,2,180,1,66,0.0,38.0,38.0,1,114,0.0,86.0,86.0
0.011,6,13,3735,7,497,1.0,125.0,125.0,6,3238,2.0,1470.0,1459.0
0.1,6,10,1506,5,395,20.0,127.0,127.0,5,1111,23.0,843.0,843.0
0.015,6,10,1972,5,910,3.0,642.0,642.0,5,1062,3.0,794.0,794.0
0.004,6,13,3747,7,509,0.0,137.0,137.0,6,3238,0.0,1470.0,1459.0
0.004,6,10,2006,5,927,1.0,659.0,659.0,5,1079,1.0,811.0,811.0
0.006,6,14,3799,7,509,0.0,137.0,137.0,7,3290,0.0,1448.0,972.0
0.005,6,10,1989,5,927,1.0,659.0,659.0,5,1062,1.0,794.0,794.0
0.038,6,20,9974,11,704,3.0,124.0,124.0,9,9270,4.0,2896.0,1758.0
354.069,6,21,1795,16,1030,23604.0,190.0,190.0,5,765,60004.0,464.0,248.0
0.005,6,10,2000,5,927,1.0,659.0,659.0,5,1073,1.0,805.0,805.0
0.004,6,10,2006,5,927,1.0,659.0,659.0,5,1079,1.0,811.0,811.0
0.015,6,10,1989,5,910,3.0,642.0,642.0,5,1079,3.0,811.0,811.0
0.005,6,10,2007,5,928,1.0,660.0,660.0,5,1079,1.0,811.0,811.0
0.013,6,10,1989,5,910,3.0,642.0,642.0,5,1079,3.0,811.0,811.0
0.013,6,10,1989,5,910,3.0,642.0,642.0,5,1079,3.0,811.0,811.0
0.005,6,10,2006,5,927,1.0,659.0,659.0,5,1079,1.0,811.0,811.0
0.004,6,10,2006,5,927,1.0,659.0,659.0,5,1079,1.0,811.0,811.0
283.576,17,124,17552,62,4122,4648.0,44.0,38.0,62,13430,4648.0,261.0,188.0
0.005,6,13,3747,7,509,0.0,137.0,137.0,6,3238,1.0,1470.0,1459.0
0.08,6,10,1506,5,395,17.0,127.0,127.0,5,1111,16.0,843.0,843.0
0.005,6,10,2006,5,927,1.0,659.0,659.0,5,1079,1.0,811.0,811.0
0.004,6,10,1774,5,923,1.0,655.0,655.0,5,851,1.0,583.0,583.0
0.005,6,10,1689,5,839,1.0,571.0,571.0,5,850,1.0,582.0,582.0
0.008,6,10,1989,5,910,2.0,642.0,642.0,5,1079,2.0,811.0,811.0
0.005,17,2,180,1,66,0.0,38.0,38.0,1,114,0.0,86.0,86.0
0.005,6,10,2006,5,927,1.0,659.0,659.0,5,1079,1.0,811.0,811.0
0.07,6,10,1506,5,395,16.0,127.0,127.0,5,1111,17.0,843.0,843.0
0.005,6,10,2006,5,927,1.0,659.0,659.0,5,1079,1.0,811.0,811.0
0.005,6,10,2006,5,927,1.0,659.0,659.0,5,1079,1.0,811.0,811.0
0.006,6,10,1689,5,839,1.0,571.0,571.0,5,850,1.0,582.0,582.0
0.012,6,10,1983,5,910,2.0,642.0,642.0,5,1073,2.0,805.0,805.0
0.001,17,2,140,1,62,0.0,34.0,34.0,1,78,0.0,50.0,50.0
10.945,17,28,4417,14,1993,833.0,268.0,114.0,14,2424,832.0,587.0,145.0
0.005,6,10,2000,5,927,1.0,659.0,659.0,5,1073,1.0,805.0,805.0
15.069,17,15,9239,8,6902,2148.0,1350.0,834.0,7,2337,2506.0,1350.0,305.0
0.004,6,10,1779,5,928,1.0,660.0,660.0,5,851,1.0,583.0,583.0
0.013,6,10,1990,5,911,3.0,643.0,643.0,5,1079,3.0,811.0,811.0
0.096,6,10,1506,5,395,22.0,127.0,127.0,5,1111,19.0,843.0,843.0
0.067,6,10,1506,5,395,14.0,127.0,127.0,5,1111,15.0,843.0,843.0
0.099,6,10,1506,5,395,22.0,127.0,127.0,5,1111,22.0,843.0,843.0
0.007,17,2,299,1,65,0.0,37.0,37.0,1,234,0.0,206.0,206.0
241.173,6,395,348280,199,21883,1218.0,2736.0,960.0,196,326397,1236.0,2804.0,1699.0
0.008,6,12,1926,6,1189,1.0,659.0,434.0,6,737,1.0,417.0,417.0
0.003,17,2,148,1,60,0.0,32.0,32.0,1,88,0.0,60.0,60.0
0.005,17,2,178,1,65,0.0,37.0,37.0,1,113,0.0,85.0,85.0
0.005,6,10,2006,5,927,1.0,659.0,659.0,5,1079,1.0,811.0,811.0
0.005,6,10,1989,5,927,1.0,659.0,659.0,5,1062,1.0,794.0,794.0
0.04,17,2,136,1,60,0.0,32.0,32.0,1,76,0.0,48.0,48.0
0.009,6,10,1989,5,910,2.0,642.0,642.0,5,1079,2.0,811.0,811.0
0.001,17,2,180,1,66,0.0,38.0,38.0,1,114,0.0,86.0,86.0
0.092,6,10,1506,5,395,19.0,127.0,127.0,5,1111,20.0,843.0,843.0
0.006,6,10,1972,5,910,1.0,642.0,642.0,5,1062,1.0,794.0,794.0
0.008,6,10,1989,5,910,2.0,642.0,642.0,5,1079,2.0,811.0,811.0
168.385,17,92,13106,46,3091,3741.0,44.0,39.0,46,10015,3741.0,261.0,189.0
0.003,17,2,187,1,74,0.0,46.0,46.0,1,113,0.0,85.0,85.0
0.013,6,10,1990,5,911,3.0,643.0,643.0,5,1079,3.0,811.0,811.0
0.004,17,2,136,1,60,0.0,32.0,32.0,1,76,0.0,48.0,48.0
0.01,6,10,1989,5,910,2.0,642.0,642.0,5,1079,2.0,811.0,811.0
0.004,6,10,1779,5,928,1.0,660.0,660.0,5,851,1.0,583.0,583.0
240.297,6,20,4994,9,2182,30037.0,967.0,568.0,11,2812,24029.0,1162.0,372.0
0.009,6,12,1926,6,1189,1.0,659.0,434.0,6,737,1.0,417.0,417.0
0.032,6,10,1990,5,911,7.0,643.0,643.0,5,1079,7.0,811.0,811.0
40.057,17,10,676,5,460,10012.0,104.0,64.0,5,216,10013.0,20.0,15.0
0.006,6,10,1547,5,764,1.0,496.0,496.0,5,783,1.0,515.0,515.0
0.04,17,4,364,2,160,0.0,52.0,52.0,2,204,1.0,80.0,74.0
300.433,6,16,2170,9,684,37534.0,146.0,146.0,7,1486,50043.0,419.0,398.0
0.121,6,10,1506,5,395,27.0,127.0,127.0,5,1111,26.0,843.0,843.0
0.006,6,10,1547,5,764,1.0,496.0,496.0,5,783,1.0,515.0,515.0
0.164,6,10,1506,5,395,33.0,127.0,127.0,5,1111,37.0,843.0,843.0
0.001,17,2,268,1,70,0.0,42.0,42.0,1,198,0.0,170.0,170.0
0.004,17,2,148,1,60,0.0,32.0,32.0,1,88,0.0,60.0,60.0
0.009,6,10,1989,5,910,2.0,642.0,642.0,5,1079,2.0,811.0,811.0
0.013,6,10,1972,5,910,3.0,642.0,642.0,5,1062,3.0,794.0,794.0
0.004,17,2,148,1,60,0.0,32.0,32.0,1,88,0.0,60.0,60.0
0.127,17,4,420,2,122,2.0,33.0,33.0,2,298,84.0,145.0,121.0
0.014,6,10,1972,5,910,3.0,642.0,642.0,5,1062,3.0,794.0,794.0
0.016,17,2,180,1,66,0.0,38.0,38.0,1,114,0.0,86.0,86.0
0.148,6,10,1506,5,395,34.0,127.0,127.0,5,1111,31.0,843.0,843.0
0.011,6,10,1989,5,910,2.0,642.0,642.0,5,1079,2.0,811.0,811.0
0.022,6,10,1983,5,910,5.0,642.0,642.0,5,1073,5.0,805.0,805.0
0.006,6,10,1547,5,764,1.0,496.0,496.0,5,783,1.0,515.0,515.0
0.006,6,10,1547,5,764,1.0,496.0,496.0,5,783,1.0,515.0,515.0
0.009,6,12,1926,6,1189,1.0,659.0,434.0,6,737,1.0,417.0,417.0
0.011,6,10,1989,5,910,2.0,642.0,642.0,5,1079,2.0,811.0,811.0
0.005,6,10,1643,5,860,1.0,592.0,592.0,5,783,1.0,515.0,515.0
0.226,6,10,1506,5,395,55.0,127.0,127.0,5,1111,53.0,843.0,843.0
0.102,6,10,1506,5,395,21.0,127.0,127.0,5,1111,23.0,843.0,843.0
0.001,17,2,180,1,66,0.0,38.0,38.0,1,114,0.0,86.0,86.0
0.004,6,10,1774,5,923,1.0,655.0,655.0,5,851,1.0,583.0,583.0
0.007,6,10,1989,5,910,1.0,642.0,642.0,5,1079,1.0,811.0,811.0
0.071,17,4,284,2,120,0.0,32.0,32.0,2,164,67.0,60.0,54.0
308.386,17,20,1124,10,716,34251.0,48.0,43.0,10,408,34251.0,20.0,12.0
0.009,6,10,1989,5,910,2.0,642.0,642.0,5,1079,2.0,811.0,811.0
0.001,17,2,180,1,66,0.0,38.0,38.0,1,114,0.0,86.0,86.0
0.116,6,10,1506,5,395,26.0,127.0,127.0,5,1111,27.0,843.0,843.0
173.053,17,80,11296,40,2672,4437.0,44.0,38.0,40,8624,4437.0,239.0,187.0
0.006,17,2,193,1,71,0.0,43.0,43.0,1,122,0.0,94.0,94.0
0.006,6,10,1854,5,889,1.0,621.0,621.0,5,965,1.0,697.0,697.0
0.006,6,10,1643,5,860,1.0,592.0,592.0,5,783,1.0,515.0,515.0
10.733,17,28,4419,14,1995,817.0,270.0,114.0,14,2424,817.0,587.0,145.0
0.013,6,10,1972,5,910,3.0,642.0,642.0,5,1062,3.0,794.0,794.0
15.071,17,15,9239,8,6902,2149.0,1350.0,834.0,7,2337,2507.0,1350.0,305.0
0.12,6,10,1506,5,395,24.0,127.0,127.0,5,1111,28.0,843.0,843.0
0.001,17,2,180,1,66,0.0,38.0,38.0,1,114,0.0,86.0,86.0
0.001,17,2,180,1,66,0.0,38.0,38.0,1,114,0.0,86.0,86.0
0.016,6,10,1972,5,910,3.0,642.0,642.0,5,1062,3.0,794.0,794.0
0.038,17,2,148,1,60,0.0,32.0,32.0,1,88,0.0,60.0,60.0
10.937,17,24,3756,12,1991,984.0,586.0,137.0,12,1765,984.0,268.0,119.0
0.001,17,2,180,1,66,0.0,38.0,38.0,1,114,0.0,86.0,86.0
0.078,6,10,1506,5,395,17.0,127.0,127.0,5,1111,16.0,843.0,843.0
0.004,6,10,1779,5,928,1.0,660.0,660.0,5,851,1.0,583.0,583.0
0.004,17,4,284,2,120,1.0,32.0,32.0,2,164,0.0,60.0,54.0
0.004,6,10,2006,5,927,1.0,659.0,659.0,5,1079,1.0,811.0,811.0
0.098,6,10,1506,5,395,19.0,127.0,127.0,5,1111,21.0,843.0,843.0
0.005,6,10,2000,5,927,1.0,659.0,659.0,5,1073,1.0,805.0,805.0
1433.675,6,72,3820,36,1898,40961.0,26.0,26.0,36,1922,40961.0,26.0,25.0
0.004,6,10,1989,5,927,1.0,659.0,659.0,5,1062,1.0,794.0,794.0
0.135,6,10,1506,5,395,28.0,127.0,127.0,5,1111,29.0,843.0,843.0
0.006,6,10,1989,5,927,1.0,659.0,659.0,5,1062,1.0,794.0,794.0
0.001,17,2,180,1,66,0.0,38.0,38.0,1,114,0.0,86.0,86.0
1.087,6,32,13391,18,5892,63.0,2720.0,854.0,14,7499,70.0,2720.0,769.0
0.02,6,10,1989,5,910,4.0,642.0,642.0,5,1079,4.0,811.0,811.0
0.021,6,10,1989,5,910,5.0,642.0,642.0,5,1079,5.0,811.0,811.0
0.115,6,10,1506,5,395,23.0,127.0,127.0,5,1111,25.0,843.0,843.0
0.079,6,10,1506,5,395,18.0,127.0,127.0,5,1111,17.0,843.0,843.0
0.014,6,10,1983,5,910,3.0,642.0,642.0,5,1073,3.0,805.0,805.0
0.016,6,10,1990,5,911,4.0,643.0,643.0,5,1079,4.0,811.0,811.0
0.078,6,10,1506,5,395,17.0,127.0,127.0,5,1111,18.0,843.0,843.0
301.054,6,38,9637,21,4159,15052.0,1360.0,547.0,17,5478,553.0,2667.0,435.0
0.004,6,10,1989,5,927,1.0,659.0,659.0,5,1062,1.0,794.0,794.0
0.017,6,10,1990,5,911,4.0,643.0,643.0,5,1079,4.0,811.0,811.0
40.065,17,10,676,5,460,10015.0,104.0,64.0,5,216,10015.0,20.0,15.0
0.04,17,4,596,2,122,0.0,33.0,33.0,2,474,36.0,323.0,209.0
0.071,17,4,284,2,120,0.0,32.0,32.0,2,164,68.0,60.0,54.0
0.015,6,10,1983,5,910,3.0,642.0,642.0,5,1073,3.0,805.0,805.0
0.079,6,10,1506,5,395,17.0,127.0,127.0,5,1111,17.0,843.0,843.0
0.017,6,10,1989,5,910,4.0,642.0,642.0,5,1079,4.0,811.0,811.0
0.011,6,10,1631,5,848,2.0,580.0,580.0,5,783,2.0,515.0,515.0
0.005,6,10,2007,5,928,1.0,660.0,660.0,5,1079,1.0,811.0,811.0
0.011,6,10,1972,5,910,2.0,642.0,642.0,5,1062,2.0,794.0,794.0
0.003,17,2,136,1,60,0.0,32.0,32.0,1,76,0.0,48.0,48.0
0.007,6,10,1989,5,910,1.0,642.0,642.0,5,1079,1.0,811.0,811.0
309.758,17,20,1124,10,716,34403.0,48.0,43.0,10,408,34400.0,20.0,12.0
240.089,6,16,4480,9,963,30011.0,238.0,166.0,7,3517,40014.0,1402.0,786.0
0.007,17,2,179,1,71,0.0,43.0,43.0,1,108,0.0,80.0,80.0
40.068,17,10,676,5,460,10016.0,104.0,64.0,5,216,10016.0,20.0,15.0
0.005,6,10,2007,5,928,1.0,660.0,660.0,5,1079,1.0,811.0,811.0
40.057,17,10,676,5,460,10013.0,104.0,64.0,5,216,10013.0,20.0,15.0
15.076,17,16,9303,8,6912,2149.0,1350.0,836.0,8,2391,2149.0,1350.0,270.0
0.006,6,10,1689,5,839,1.0,571.0,571.0,5,850,1.0,582.0,582.0
0.005,6,10,1547,5,764,1.0,496.0,496.0,5,783,1.0,515.0,515.0
0.004,17,2,136,1,60,0.0,32.0,32.0,1,76,0.0,48.0,48.0
0.004,6,10,2007,5,928,1.0,660.0,660.0,5,1079,1.0,811.0,811.0
0.072,17,8,3613,4,1874,24.0,1350.0,440.0,4,1739,12.0,1350.0,406.0
0.004,17,2,136,1,60,0.0,32.0,32.0,1,76,0.0,48.0,48.0
0.005,6,10,2006,5,927,1.0,659.0,659.0,5,1079,1.0,811.0,811.0
0.053,17,4,596,2,122,0.0,33.0,33.0,2,474,2.0,323.0,209.0
0.054,6,10,1506,5,395,11.0,127.0,127.0,5,1111,13.0,843.0,843.0
0.012,6,10,1990,5,911,3.0,643.0,643.0,5,1079,3.0,811.0,811.0
0.018,6,10,1990,5,911,4.0,643.0,643.0,5,1079,4.0,811.0,811.0
0.004,6,10,1989,5,927,1.0,659.0,659.0,5,1062,1.0,794.0,794.0
0.06,17,2,152,1,76,0.0,48.0,48.0,1,76,0.0,48.0,48.0
0.006,6,10,1547,5,764,1.0,496.0,496.0,5,783,1.0,515.0,515.0
0.003,17,2,136,1,60,0.0,32.0,32.0,1,76,0.0,48.0,48.0
0.069,6,10,1506,5,395,14.0,127.0,127.0,5,1111,14.0,843.0,843.0
10.907,17,28,4423,14,1994,830.0,269.0,114.0,14,2429,830.0,588.0,145.0
0.003,17,2,142,1,63,0.0,35.0,35.0,1,79,0.0,51.0,51.0
0.004,6,10,2006,5,927,1.0,659.0,659.0,5,1079,1.0,811.0,811.0
0.013,6,10,1989,5,910,3.0,642.0,642.0,5,1079,3.0,811.0,811.0
0.04,6,13,3735,7,497,6.0,125.0,125.0,6,3238,7.0,1470.0,1459.0
0.108,6,10,1506,5,395,25.0,127.0,127.0,5,1111,25.0,843.0,843.0
0.098,6,10,1506,5,395,24.0,127.0,127.0,5,1111,19.0,843.0,843.0
0.006,17,2,164,1,74,0.0,46.0,46.0,1,90,0.0,62.0,62.0
0.011,6,10,1762,5,911,2.0,643.0,643.0,5,851,2.0,583.0,583.0
0.079,6,10,1506,5,395,17.0,127.0,127.0,5,1111,18.0,843.0,843.0
0.13,6,10,1506,5,395,29.0,127.0,127.0,5,1111,21.0,843.0,843.0
0.014,6,10,1989,5,910,3.0,642.0,642.0,5,1079,3.0,811.0,811.0
0.001,17,2,180,1,66,0.0,38.0,38.0,1,114,0.0,86.0,86.0
0.005,6,10,1854,5,889,1.0,621.0,621.0,5,965,1.0,697.0,697.0
0.004,17,2,136,1,60,0.0,32.0,32.0,1,76,0.0,48.0,48.0
0.003,17,2,148,1,60,0.0,32.0,32.0,1,88,0.0,60.0,60.0
0.005,6,10,2006,5,927,1.0,659.0,659.0,5,1079,1.0,811.0,811.0
11.272,17,28,4395,14,1995,854.0,270.0,114.0,14,2400,854.0,587.0,143.0
0.012,6,10,1989,5,910,3.0,642.0,642.0,5,1079,2.0,811.0,811.0
0.006,6,10,1547,5,764,1.0,496.0,496.0,5,783,1.0,515.0,515.0
10.879,17,28,4421,14,1994,827.0,269.0,114.0,14,2427,827.0,586.0,145.0
412.955,6,28,4357,12,3102,10913.0,494.0,494.0,16,1255,27530.0,83.0,83.0
0.005,6,10,2000,5,927,1.0,659.0,659.0,5,1073,1.0,805.0,805.0
0.011,6,10,1762,5,911,2.0,643.0,643.0,5,851,2.0,583.0,583.0
0.103,6,10,1506,5,395,24.0,127.0,127.0,5,1111,23.0,843.0,843.0
0.001,17,2,136,1,60,0.0,32.0,32.0,1,76,0.0,48.0,48.0
0.009,6,13,3735,7,497,1.0,125.0,125.0,6,3238,1.0,1470.0,1459.0
0.012,6,10,1989,5,910,3.0,642.0,642.0,5,1079,3.0,811.0,811.0
0.067,17,8,3613,4,1874,22.0,1350.0,440.0,4,1739,11.0,1350.0,406.0
0.085,6,10,1506,5,395,18.0,127.0,127.0,5,1111,20.0,843.0,843.0
0.016,6,10,1972,5,910,3.0,642.0,642.0,5,1062,3.0,794.0,794.0
0.101,6,10,1506,5,395,23.0,127.0,127.0,5,1111,21.0,843.0,843.0
0.018,6,10,1631,5,848,4.0,580.0,580.0,5,783,4.0,515.0,515.0
0.005,6,10,2007,5,928,1.0,660.0,660.0,5,1079,1.0,811.0,811.0
0.005,6,10,1774,5,923,1.0,655.0,655.0,5,851,1.0,583.0,583.0
0.038,17,2,148,1,60,0.0,32.0,32.0,1,88,0.0,60.0,60.0
0.013,6,10,1972,5,910,3.0,642.0,642.0,5,1062,3.0,794.0,794.0
0.004,6,10,2007,5,928,1.0,660.0,660.0,5,1079,1.0,811.0,811.0
0.064,6,10,1506,5,395,14.0,127.0,127.0,5,1111,15.0,843.0,843.0
8.785,6,35,9731,18,4253,516.0,1498.0,875.0,17,5478,536.0,2667.0,435.0
177.189,17,92,13408,46,3099,3937.0,44.0,39.0,46,10309,3937.0,239.0,196.0
312.4,17,20,1124,10,716,34697.0,48.0,43.0,10,408,34697.0,20.0,12.0
0.004,6,10,2006,5,927,1.0,659.0,659.0,5,1079,1.0,811.0,811.0
0.165,6,10,1506,5,395,38.0,127.0,127.0,5,1111,37.0,843.0,843.0
0.003,17,2,136,1,60,0.0,32.0,32.0,1,76,0.0,48.0,48.0
0.006,6,14,3799,7,509,0.0,137.0,137.0,7,3290,0.0,1448.0,972.0
0.001,17,2,140,1,62,0.0,34.0,34.0,1,78,0.0,50.0,50.0
0.006,6,14,3742,7,452,1.0,80.0,80.0,7,3290,0.0,1448.0,972.0
0.217,6,16,2777,8,1395,31.0,533.0,323.0,8,1382,20.0,529.0,239.0
0.001,17,2,180,1,66,0.0,38.0,38.0,1,114,0.0,86.0,86.0
0.071,6,10,1506,5,395,15.0,127.0,127.0,5,1111,16.0,843.0,843.0
0.004,6,10,1779,5,928,1.0,660.0,660.0,5,851,1.0,583.0,583.0
0.007,6,10,1547,5,764,1.0,496.0,496.0,5,783,1.0,515.0,515.0
0.005,6,10,2007,5,928,1.0,660.0,660.0,5,1079,1.0,811.0,811.0
0.005,6,10,2006,5,927,1.0,659.0,659.0,5,1079,1.0,811.0,811.0
240.102,6,16,4480,9,963,30012.0,238.0,166.0,7,3517,40016.0,1402.0,786.0
0.012,6,10,1990,5,911,2.0,643.0,643.0,5,1079,3.0,811.0,811.0
0.001,17,2,180,1,66,0.0,38.0,38.0,1,114,0.0,86.0,86.0
0.006,17,2,230,1,68,0.0,40.0,40.0,1,162,0.0,134.0,134.0
0.018,6,10,1972,5,910,4.0,642.0,642.0,5,1062,4.0,794.0,794.0
0.162,6,10,1506,5,395,37.0,127.0,127.0,5,1111,40.0,843.0,843.0
0.005,6,10,1989,5,927,1.0,659.0,659.0,5,1062,1.0,794.0,794.0
0.005,6,10,1689,5,839,1.0,571.0,571.0,5,850,1.0,582.0,582.0
0.005,17,2,170,1,65,0.0,37.0,37.0,1,105,0.0,77.0,77.0
0.004,6,10,1774,5,923,1.0,655.0,655.0,5,851,1.0,583.0,583.0
123.358,6,27,6001,13,4636,10279.0,494.0,494.0,14,1365,9467.0,83.0,83.0
0.005,6,10,2007,5,928,1.0,660.0,660.0,5,1079,1.0,811.0,811.0
0.005,17,2,166,1,75,0.0,47.0,47.0,1,91,0.0,63.0,63.0
0.016,6,10,1989,5,910,4.0,642.0,642.0,5,1079,4.0,811.0,811.0
0.006,6,10,1689,5,839,1.0,571.0,571.0,5,850,1.0,582.0,582.0
0.004,6,14,3742,7,452,0.0,80.0,80.0,7,3290,0.0,1448.0,972.0
0.006,17,2,179,1,71,0.0,43.0,43.0,1,108,0.0,80.0,80.0
0.005,17,2,184,1,68,0.0,40.0,40.0,1,116,0.0,88.0,88.0
0.006,6,10,2006,5,927,1.0,659.0,659.0,5,1079,1.0,811.0,811.0
0.203,6,10,1506,5,395,45.0,127.0,127.0,5,1111,50.0,843.0,843.0
0.004,17,4,284,2,120,0.0,32.0,32.0,2,164,0.0,60.0,54.0
0.145,6,10,1506,5,395,32.0,127.0,127.0,5,1111,35.0,843.0,843.0
0.004,6,10,1702,5,863,1.0,595.0,595.0,5,839,0.0,571.0,571.0
0.146,6,10,1506,5,395,34.0,127.0,127.0,5,1111,32.0,843.0,843.0
0.005,6,10,2006,5,927,1.0,659.0,659.0,5,1079,1.0,811.0,811.0
0.004,17,2,170,1,65,0.0,37.0,37.0,1,105,0.0,77.0,77.0
241.227,6,373,347523,189,21358,1283.0,2736.0,960.0,184,326165,1318.0,2804.0,1819.0
0.071,6,10,1506,5,395,16.0,127.0,127.0,5,1111,17.0,843.0,843.0
1729.213,6,60,4400,40,2740,44338.0,33.0,33.0,20,1660,91002.0,31.0,31.0
0.087,6,10,1506,5,395,19.0,127.0,127.0,5,1111,17.0,843.0,843.0
0.005,6,10,2006,5,927,1.0,659.0,659.0,5,1079,1.0,811.0,811.0
0.004,6,10,1989,5,927,1.0,659.0,659.0,5,1062,1.0,794.0,794.0
0.126,6,24,6480,11,2285,11.0,746.0,341.0,13,4195,9.0,1324.0,585.0
0.005,6,10,1702,5,863,1.0,595.0,595.0,5,839,1.0,571.0,571.0
0.003,17,2,148,1,60,0.0,32.0,32.0,1,88,0.0,60.0,60.0
0.006,6,10,1547,5,764,1.0,496.0,496.0,5,783,1.0,515.0,515.0
0.039,17,2,412,1,61,0.0,33.0,33.0,1,351,0.0,323.0,323.0
0.004,6,10,1774,5,923,1.0,655.0,655.0,5,851,1.0,583.0,583.0
0.001,17,2,180,1,66,0.0,38.0,38.0,1,114,0.0,86.0,86.0
0.006,6,10,1547,5,764,1.0,496.0,496.0,5,783,1.0,515.0,515.0
0.097,6,10,1506,5,395,22.0,127.0,127.0,5,1111,21.0,843.0,843.0
0.126,6,10,1506,5,395,30.0,127.0,127.0,5,1111,29.0,843.0,843.0
0.037,17,2,148,1,60,0.0,32.0,32.0,1,88,0.0,60.0,60.0
0.004,6,10,1989,5,927,1.0,659.0,659.0,5,1062,1.0,794.0,794.0
0.005,6,10,2000,5,927,1.0,659.0,659.0,5,1073,1.0,805.0,805.0
0.07,6,10,1506,5,395,15.0,127.0,127.0,5,1111,15.0,843.0,843.0
0.101,6,10,1506,5,395,19.0,127.0,127.0,5,1111,23.0,843.0,843.0
0.004,6,10,1774,5,923,1.0,655.0,655.0,5,851,1.0,583.0,583.0
0.009,6,10,1989,5,910,2.0,642.0,642.0,5,1079,2.0,811.0,811.0
0.007,6,10,1689,5,839,1.0,571.0,571.0,5,850,1.0,582.0,582.0
2.811,6,25,6056,14,2100,216.0,517.0,303.0,11,3956,265.0,1330.0,700.0
0.096,6,10,1506,5,395,21.0,127.0,127.0,5,1111,19.0,843.0,843.0
40.071,17,10,676,5,460,10016.0,104.0,64.0,5,216,10016.0,20.0,15.0
0.003,17,2,148,1,60,0.0,32.0,32.0,1,88,0.0,60.0,60.0
0.006,6,10,1547,5,764,1.0,496.0,496.0,5,783,1.0,515.0,515.0
0.005,6,10,1854,5,889,1.0,621.0,621.0,5,965,1.0,697.0,697.0
0.076,6,10,1506,5,395,16.0,127.0,127.0,5,1111,16.0,843.0,843.0
0.01,6,10,1972,5,910,2.0,642.0,642.0,5,1062,2.0,794.0,794.0
1757.396,6,104,6226,59,3470,30299.0,26.0,26.0,45,2756,39939.0,26.0,26.0
0.017,6,10,1990,5,911,4.0,643.0,643.0,5,1079,4.0,811.0,811.0
413.257,6,29,4409,12,3102,10914.0,494.0,494.0,17,1307,25828.0,83.0,83.0
0.011,6,10,1972,5,910,2.0,642.0,642.0,5,1062,2.0,794.0,794.0
0.004,6,10,2006,5,927,1.0,659.0,659.0,5,1079,1.0,811.0,811.0
0.04,17,4,284,2,120,1.0,32.0,32.0,2,164,36.0,60.0,54.0
0.005,6,10,2006,5,927,1.0,659.0,659.0,5,1079,1.0,811.0,811.0
0.007,6,12,1698,6,863,1.0,327.0,271.0,6,835,1.0,515.0,515.0
0.006,17,2,294,1,64,0.0,36.0,36.0,1,230,0.0,202.0,202.0
0.103,6,10,1506,5,395,24.0,127.0,127.0,5,1111,25.0,843.0,843.0
40.06,17,10,676,5,460,10013.0,104.0,64.0,5,216,10014.0,20.0,15.0
0.079,17,4,564,2,122,75.0,33.0,33.0,2,442,7.0,291.0,193.0
0.085,6,10,1506,5,395,17.0,127.0,127.0,5,1111,16.0,843.0,843.0
0.011,6,10,1990,5,911,2.0,643.0,643.0,5,1079,2.0,811.0,811.0
0.083,6,10,1506,5,395,19.0,127.0,127.0,5,1111,18.0,843.0,843.0
0.013,6,10,1990,5,911,3.0,643.0,643.0,5,1079,3.0,811.0,811.0
0.108,6,10,1506,5,395,25.0,127.0,127.0,5,1111,24.0,843.0,843.0
312.884,17,20,1124,10,716,34750.0,48.0,43.0,10,408,34750.0,20.0,12.0
0.042,17,2,182,1,65,0.0,37.0,37.0,1,117,0.0,89.0,89.0
1778.112,17,144,45504,72,22752,25043.0,288.0,288.0,72,22752,25043.0,288.0,288.0
0.001,17,2,136,1,60,0.0,32.0,32.0,1,76,0.0,48.0,48.0
240.058,6,12,1315,6,510,48010.0,190.0,190.0,6,805,48010.0,464.0,248.0
0.006,6,10,2000,5,927,1.0,659.0,659.0,5,1073,1.0,805.0,805.0
0.007,6,10,2006,5,927,1.0,659.0,659.0,5,1079,1.0,811.0,811.0
0.091,6,10,1506,5,395,20.0,127.0,127.0,5,1111,18.0,843.0,843.0
1787.084,6,154,19574,92,13852,19638.0,302.0,302.0,62,5722,29296.0,83.0,83.0
240.012,6,9,787,5,488,60003.0,232.0,232.0,4,299,80003.0,83.0,83.0
0.092,6,10,1506,5,395,21.0,127.0,127.0,5,1111,14.0,843.0,843.0
0.005,6,10,2006,5,927,1.0,659.0,659.0,5,1079,1.0,811.0,811.0
300.331,6,16,2170,9,684,37521.0,146.0,146.0,7,1486,50027.0,419.0,398.0
0.006,6,10,1547,5,764,1.0,496.0,496.0,5,783,1.0,515.0,515.0
0.008,6,10,1972,5,910,2.0,642.0,642.0,5,1062,2.0,794.0,794.0
0.005,6,13,3747,7,509,0.0,137.0,137.0,6,3238,1.0,1470.0,1459.0
0.017,6,10,1989,5,910,4.0,642.0,642.0,5,1079,4.0,811.0,811.0
0.004,6,10,2007,5,928,1.0,660.0,660.0,5,1079,1.0,811.0,811.0
0.002,17,2,136,1,60,0.0,32.0,32.0,1,76,0.0,48.0,48.0
40.05,17,10,676,5,460,10011.0,104.0,64.0,5,216,10011.0,20.0,15.0
0.032,6,10,1972,5,910,7.0,642.0,642.0,5,1062,7.0,794.0,794.0
0.005,6,10,2007,5,928,1.0,660.0,660.0,5,1079,1.0,811.0,811.0
0.11,6,10,1506,5,395,25.0,127.0,127.0,5,1111,23.0,843.0,843.0
240.083,6,16,4481,9,963,30010.0,238.0,166.0,7,3518,40013.0,1402.0,786.0
0.004,6,10,1779,5,928,1.0,660.0,660.0,5,851,1.0,583.0,583.0
0.106,6,10,1506,5,395,25.0,127.0,127.0,5,1111,25.0,843.0,843.0
0.005,17,2,140,1,62,0.0,34.0,34.0,1,78,0.0,50.0,50.0
1770.42,6,83,4368,42,2210,43179.0,26.0,26.0,41,2158,44259.0,26.0,26.0
0.005,6,10,2007,5,928,1.0,660.0,660.0,5,1079,1.0,811.0,811.0
0.005,6,10,2006,5,927,1.0,659.0,659.0,5,1079,1.0,811.0,811.0
0.759,6,25,5459,12,1557,59.0,325.0,152.0,13,3902,53.0,1414.0,563.0
0.012,6,10,1677,5,827,3.0,559.0,559.0,5,850,3.0,582.0,582.0
1794.634,6,287,27141,145,9980,12462.0,747.0,270.0,142,17161,12727.0,1624.0,72.0
0.136,6,10,1506,5,395,29.0,127.0,127.0,5,1111,26.0,843.0,843.0
0.005,17,2,255,1,82,0.0,54.0,54.0,1,173,0.0,145.0,145.0
0.005,6,10,1689,5,839,1.0,571.0,571.0,5,850,1.0,582.0,582.0
0.039,17,4,284,2,120,0.0,32.0,32.0,2,164,36.0,60.0,54.0
0.224,6,16,2669,8,1395,32.0,533.0,323.0,8,1274,20.0,529.0,212.0
0.004,17,4,284,2,120,0.0,32.0,32.0,2,164,0.0,60.0,54.0
0.007,17,2,179,1,71,0.0,43.0,43.0,1,108,0.0,80.0,80.0
0.009,6,10,1983,5,910,2.0,642.0,642.0,5,1073,2.0,805.0,805.0
0.01,6,10,1677,5,827,2.0,559.0,559.0,5,850,2.0,582.0,582.0
0.006,6,14,3799,7,509,0.0,137.0,137.0,7,3290,0.0,1448.0,972.0
0.097,6,10,1506,5,395,22.0,127.0,127.0,5,1111,19.0,843.0,843.0
0.005,6,10,2000,5,927,1.0,659.0,659.0,5,1073,1.0,805.0,805.0
0.005,6,10,2007,5,928,1.0,660.0,660.0,5,1079,1.0,811.0,811.0
0.012,6,10,1990,5,911,3.0,643.0,643.0,5,1079,3.0,811.0,811.0
0.005,6,10,2006,5,927,1.0,659.0,659.0,5,1079,1.0,811.0,811.0
40.067,17,10,676,5,460,10015.0,104.0,64.0,5,216,10016.0,20.0,15.0
0.017,6,10,1990,5,911,4.0,643.0,643.0,5,1079,4.0,811.0,811.0
0.005,17,2,170,1,65,0.0,37.0,37.0,1,105,0.0,77.0,77.0
0.013,6,10,1989,5,910,3.0,642.0,642.0,5,1079,3.0,811.0,811.0
0.379,17,49,25960,26,21279,15.0,1350.0,790.0,23,4681,14.0,1350.0,175.0
0.021,6,10,1972,5,910,5.0,642.0,642.0,5,1062,5.0,794.0,794.0
0.006,6,10,2007,5,928,1.0,660.0,660.0,5,1079,1.0,811.0,811.0
0.016,6,10,1677,5,827,4.0,559.0,559.0,5,850,4.0,582.0,582.0
0.124,6,10,1506,5,395,25.0,127.0,127.0,5,1111,26.0,843.0,843.0
1756.543,6,109,6478,60,3525,29771.0,27.0,27.0,49,2953,36593.0,27.0,27.0
0.005,6,10,2006,5,927,1.0,659.0,659.0,5,1079,1.0,811.0,811.0
40.08,17,10,676,5,460,10017.0,104.0,64.0,5,216,10019.0,20.0,15.0
0.006,6,10,1547,5,764,1.0,496.0,496.0,5,783,1.0,515.0,515.0
0.014,6,10,1989,5,910,3.0,642.0,642.0,5,1079,3.0,811.0,811.0
240.012,6,9,787,5,488,60003.0,232.0,232.0,4,299,80002.0,83.0,83.0
0.769,17,391,337992,132,12944,5.0,1350.0,70.0,259,325048,2.0,1350.0,1227.0
0.009,6,10,1983,5,910,2.0,642.0,642.0,5,1073,2.0,805.0,805.0
174.193,17,80,11646,40,2685,4466.0,44.0,39.0,40,8961,4466.0,239.0,196.0
0.01,6,10,1990,5,911,2.0,643.0,643.0,5,1079,2.0,811.0,811.0
0.006,6,10,1547,5,764,1.0,496.0,496.0,5,783,1.0,515.0,515.0
0.002,17,2,180,1,66,0.0,38.0,38.0,1,114,0.0,86.0,86.0
0.005,6,10,1989,5,927,1.0,659.0,659.0,5,1062,1.0,794.0,794.0
0.014,6,10,1989,5,910,3.0,642.0,642.0,5,1079,3.0,811.0,811.0
10.708,17,26,4102,13,1846,883.0,269.0,114.0,13,2256,883.0,587.0,145.0
0.003,17,4,284,2,120,0.0,32.0,32.0,2,164,0.0,60.0,54.0
0.005,6,10,1989,5,927,1.0,659.0,659.0,5,1062,1.0,794.0,794.0
0.006,6,10,1547,5,764,1.0,496.0,496.0,5,783,1.0,515.0,515.0
0.009,6,10,1972,5,910,2.0,642.0,642.0,5,1062,2.0,794.0,794.0
0.123,6,10,1506,5,395,28.0,127.0,127.0,5,1111,27.0,843.0,843.0
0.011,6,10,1762,5,911,2.0,643.0,643.0,5,851,2.0,583.0,583.0
0.005,6,10,1779,5,928,1.0,660.0,660.0,5,851,1.0,583.0,583.0
0.004,6,10,1774,5,923,1.0,655.0,655.0,5,851,1.0,583.0,583.0
0.01,6,10,1677,5,827,2.0,559.0,559.0,5,850,2.0,582.0,582.0
0.083,6,10,1506,5,395,19.0,127.0,127.0,5,1111,18.0,843.0,843.0
0.119,6,10,1506,5,395,25.0,127.0,127.0,5,1111,23.0,843.0,843.0
0.008,6,10,1989,5,910,2.0,642.0,642.0,5,1079,2.0,811.0,811.0
0.038,6,13,3735,7,497,6.0,125.0,125.0,6,3238,7.0,1470.0,1459.0
40.087,17,10,676,5,460,10018.0,104.0,64.0,5,216,10021.0,20.0,15.0
0.001,17,2,180,1,65,0.0,37.0,37.0,1,115,0.0,87.0,87.0
10.866,17,28,4418,14,1993,827.0,268.0,114.0,14,2425,827.0,588.0,145.0
0.039,17,4,284,2,120,0.0,32.0,32.0,2,164,35.0,60.0,54.0
240.099,6,16,4480,9,963,30012.0,238.0,166.0,7,3517,40015.0,1402.0,786.0
0.015,6,10,1972,5,910,3.0,642.0,642.0,5,1062,3.0,794.0,794.0
40.056,17,10,676,5,460,10013.0,104.0,64.0,5,216,10013.0,20.0,15.0
177.21,17,78,11037,39,2601,4663.0,44.0,38.0,39,8436,4663.0,239.0,188.0
0.081,6,10,1506,5,395,18.0,127.0,127.0,5,1111,17.0,843.0,843.0
0.216,6,16,2671,8,1397,30.0,533.0,324.0,8,1274,19.0,529.0,212.0
0.005,6,10,2000,5,927,1.0,659.0,659.0,5,1073,1.0,805.0,805.0
10.99,17,32,6048,16,2507,725.0,269.0,128.0,16,3541,725.0,1144.0,193.0
0.044,17,2,136,1,60,0.0,32.0,32.0,1,76,0.0,48.0,48.0
0.108,6,10,1506,5,395,25.0,127.0,127.0,5,1111,25.0,843.0,843.0
0.005,6,10,2006,5,927,1.0,659.0,659.0,5,1079,1.0,811.0,811.0
0.008,6,10,1990,5,911,1.0,643.0,643.0,5,1079,2.0,811.0,811.0
0.017,6,10,1631,5,848,4.0,580.0,580.0,5,783,4.0,515.0,515.0
40.06,17,10,676,5,460,10013.0,104.0,64.0,5,216,10013.0,20.0,15.0
0.008,6,10,2006,5,927,2.0,659.0,659.0,5,1079,1.0,811.0,811.0
0.008,6,10,1989,5,910,2.0,642.0,642.0,5,1079,1.0,811.0,811.0
0.001,17,2,179,1,62,0.0,34.0,34.0,1,117,0.0,89.0,89.0
0.01,6,10,1677,5,827,2.0,559.0,559.0,5,850,2.0,582.0,582.0
0.077,6,10,1506,5,395,16.0,127.0,127.0,5,1111,15.0,843.0,843.0
0.001,17,2,180,1,66,0.0,38.0,38.0,1,114,0.0,86.0,86.0
0.012,6,10,1990,5,911,3.0,643.0,643.0,5,1079,3.0,811.0,811.0
0.114,6,10,1506,5,395,26.0,127.0,127.0,5,1111,26.0,843.0,843.0
0.009,6,10,1990,5,911,2.0,643.0,643.0,5,1079,2.0,811.0,811.0
0.001,17,2,180,1,66,0.0,38.0,38.0,1,114,0.0,86.0,86.0
10.932,17,28,4423,14,1994,831.0,269.0,114.0,14,2429,831.0,588.0,145.0
0.004,6,10,2007,5,928,1.0,660.0,660.0,5,1079,1.0,811.0,811.0
0.006,17,2,144,1,64,0.0,36.0,36.0,1,80,0.0,52.0,52.0
0.123,17,2,80,1,32,0.0,4.0,4.0,1,48,0.0,20.0,20.0
240.011,6,9,787,5,488,60002.0,232.0,232.0,4,299,80002.0,83.0,83.0
0.001,17,2,136,1,60,0.0,32.0,32.0,1,76,0.0,48.0,48.0
0.006,17,2,144,1,64,0.0,36.0,36.0,1,80,0.0,52.0,52.0
314.238,17,20,1124,10,716,34900.0,48.0,43.0,10,408,34900.0,20.0,12.0
0.081,6,10,1506,5,395,19.0,127.0,127.0,5,1111,19.0,843.0,843.0
0.005,6,10,1774,5,923,1.0,655.0,655.0,5,851,1.0,583.0,583.0
240.101,6,16,4482,9,963,30012.0,238.0,166.0,7,3519,40016.0,1402.0,786.0
0.004,6,10,2006,5,927,1.0,659.0,659.0,5,1079,1.0,811.0,811.0
0.004,6,10,1702,5,863,1.0,595.0,595.0,5,839,1.0,571.0,571.0
0.089,6,10,1506,5,395,20.0,127.0,127.0,5,1111,21.0,843.0,843.0
0.003,17,2,148,1,60,0.0,32.0,32.0,1,88,0.0,60.0,60.0
0.009,6,12,1926,6,1189,1.0,659.0,434.0,6,737,1.0,417.0,417.0
0.128,17,2,80,1,32,0.0,4.0,4.0,1,48,0.0,20.0,20.0
0.006,6,10,1547,5,764,1.0,496.0,496.0,5,783,1.0,515.0,515.0
0.001,17,2,180,1,66,0.0,38.0,38.0,1,114,0.0,86.0,86.0
0.005,17,2,148,1,60,0.0,32.0,32.0,1,88,0.0,60.0,60.0
0.011,6,10,1989,5,910,2.0,642.0,642.0,5,1079,2.0,811.0,811.0
0.06,6,10,1506,5,395,13.0,127.0,127.0,5,1111,13.0,843.0,843.0
0.004,6,10,2006,5,927,1.0,659.0,659.0,5,1079,1.0,811.0,811.0
0.041,17,2,152,1,76,0.0,48.0,48.0,1,76,0.0,48.0,48.0
0.004,17,2,148,1,60,0.0,32.0,32.0,1,88,0.0,60.0,60.0
0.007,17,2,194,1,59,0.0,31.0,31.0,1,135,0.0,107.0,107.0
0.009,6,10,1990,5,911,2.0,643.0,643.0,5,1079,2.0,811.0,811.0
0.132,6,10,1506,5,395,30.0,127.0,127.0,5,1111,26.0,843.0,843.0
0.132,6,10,1506,5,395,30.0,127.0,127.0,5,1111,28.0,843.0,843.0
0.013,6,10,1990,5,911,3.0,643.0,643.0,5,1079,3.0,811.0,811.0
0.04,17,4,284,2,120,2.0,32.0,32.0,2,164,2.0,60.0,54.0
0.005,17,2,230,1,68,0.0,40.0,40.0,1,162,0.0,134.0,134.0
0.005,6,10,2006,5,927,1.0,659.0,659.0,5,1079,1.0,811.0,811.0
0.005,6,10,2006,5,927,1.0,659.0,659.0,5,1079,1.0,811.0,811.0
0.12,6,10,1506,5,395,24.0,127.0,127.0,5,1111,25.0,843.0,843.0
0.006,6,10,1547,5,764,1.0,496.0,496.0,5,783,1.0,515.0,515.0
0.016,6,10,1989,5,910,3.0,642.0,642.0,5,1079,4.0,811.0,811.0
0.005,6,10,2006,5,927,1.0,659.0,659.0,5,1079,1.0,811.0,811.0
240.012,6,9,787,5,488,60003.0,232.0,232.0,4,299,80002.0,83.0,83.0
0.098,6,10,1506,5,395,21.0,127.0,127.0,5,1111,22.0,843.0,843.0
0.005,6,10,2006,5,927,1.0,659.0,659.0,5,1079,1.0,811.0,811.0
1783.397,6,242,46496,117,33990,15374.0,2473.0,1032.0,125,12506,14382.0,580.0,62.0
0.005,6,10,1689,5,839,1.0,571.0,571.0,5,850,1.0,582.0,582.0
15.079,17,16,8579,8,6379,2150.0,1350.0,769.0,8,2200,2150.0,1350.0,247.0
177.298,17,84,11916,42,2800,4324.0,44.0,38.0,42,9116,4324.0,239.0,189.0
240.268,6,47,5677,23,2587,10921.0,581.0,195.0,24,3090,10446.0,566.0,224.0
0.1,6,10,1506,5,395,20.0,127.0,127.0,5,1111,22.0,843.0,843.0
0.121,6,10,1506,5,395,29.0,127.0,127.0,5,1111,28.0,843.0,843.0
0.005,6,10,2007,5,928,1.0,660.0,660.0,5,1079,1.0,811.0,811.0
0.006,17,2,166,1,75,0.0,47.0,47.0,1,91,0.0,63.0,63.0
0.079,6,10,1506,5,395,17.0,127.0,127.0,5,1111,18.0,843.0,843.0
0.004,6,10,2000,5,927,1.0,659.0,659.0,5,1073,1.0,805.0,805.0
0.01,6,10,1989,5,910,2.0,642.0,642.0,5,1079,2.0,811.0,811.0
0.005,6,13,3747,7,509,0.0,137.0,137.0,6,3238,1.0,1470.0,1459.0
0.038,17,2,152,1,76,0.0,48.0,48.0,1,76,0.0,48.0,48.0
0.008,6,10,1990,5,911,2.0,643.0,643.0,5,1079,1.0,811.0,811.0
0.004,6,10,2000,5,927,1.0,659.0,659.0,5,1073,1.0,805.0,805.0
0.005,6,10,1547,5,764,1.0,496.0,496.0,5,783,1.0,515.0,515.0
0.007,6,10,1677,5,827,1.0,559.0,559.0,5,850,1.0,582.0,582.0
0.01,6,10,1972,5,910,2.0,642.0,642.0,5,1062,2.0,794.0,794.0
0.003,17,4,284,2,120,0.0,32.0,32.0,2,164,0.0,60.0,54.0
0.016,6,10,1972,5,910,4.0,642.0,642.0,5,1062,4.0,794.0,794.0
0.019,6,10,1989,5,910,4.0,642.0,642.0,5,1079,4.0,811.0,811.0
327.09,17,20,1124,10,716,36330.0,48.0,43.0,10,408,36319.0,20.0,12.0
178.047,6,21,8147,11,1985,92.0,1174.0,504.0,10,6162,19763.0,2720.0,958.0
0.205,6,16,2669,8,1395,29.0,533.0,323.0,8,1274,18.0,529.0,212.0
176.041,17,76,10783,38,2536,4757.0,44.0,38.0,38,8247,4757.0,260.0,189.0
0.008,6,10,1972,5,910,2.0,642.0,642.0,5,1062,1.0,794.0,794.0
171.037,17,90,13011,45,3036,3887.0,44.0,39.0,45,9975,3887.0,239.0,193.0
0.004,6,10,1702,5,863,1.0,595.0,595.0,5,839,0.0,571.0,571.0
0.003,17,2,148,1,60,0.0,32.0,32.0,1,88,0.0,60.0,60.0
0.004,6,10,1989,5,927,1.0,659.0,659.0,5,1062,1.0,794.0,794.0
0.005,6,13,3690,7,452,0.0,80.0,80.0,6,3238,0.0,1470.0,1459.0
0.003,17,2,136,1,60,0.0,32.0,32.0,1,76,0.0,48.0,48.0
0.038,17,4,284,2,120,1.0,32.0,32.0,2,164,34.0,60.0,54.0
0.024,6,10,1631,5,848,5.0,580.0,580.0,5,783,5.0,515.0,515.0
1788.109,6,238,46504,114,34027,15823.0,2500.0,1123.0,124,12477,14537.0,580.0,62.0
15.081,17,15,8065,8,5888,2150.0,1350.0,708.0,7,2177,2508.0,1350.0,283.0
0.005,6,10,2006,5,927,1.0,659.0,659.0,5,1079,1.0,811.0,811.0
0.001,17,2,152,1,68,0.0,40.0,40.0,1,84,0.0,56.0,56.0
0.004,17,2,148,1,60,0.0,32.0,32.0,1,88,0.0,60.0,60.0
40.061,17,10,676,5,460,10012.0,104.0,64.0,5,216,10011.0,20.0,15.0
0.018,6,10,1990,5,911,4.0,643.0,643.0,5,1079,4.0,811.0,811.0
0.107,6,10,1506,5,395,23.0,127.0,127.0,5,1111,21.0,843.0,843.0
0.005,6,10,1547,5,764,1.0,496.0,496.0,5,783,1.0,515.0,515.0
0.135,6,10,1506,5,395,32.0,127.0,127.0,5,1111,22.0,843.0,843.0
0.162,6,10,1506,5,395,36.0,127.0,127.0,5,1111,38.0,843.0,843.0
0.007,17,2,179,1,71,0.0,43.0,43.0,1,108,0.0,80.0,80.0
0.002,17,2,136,1,60,0.0,32.0,32.0,1,76,0.0,48.0,48.0
0.001,17,2,166,1,75,0.0,47.0,47.0,1,91,0.0,63.0,63.0
0.009,6,10,1983,5,910,2.0,642.0,642.0,5,1073,2.0,805.0,805.0
0.011,6,10,1989,5,910,2.0,642.0,642.0,5,1079,2.0,811.0,811.0
0.108,6,10,1506,5,395,24.0,127.0,127.0,5,1111,24.0,843.0,843.0
0.039,6,10,1972,5,910,9.0,642.0,642.0,5,1062,9.0,794.0,794.0
0.006,6,10,1854,5,889,1.0,621.0,621.0,5,965,1.0,697.0,697.0
353.951,6,21,1795,16,1030,23596.0,190.0,190.0,5,765,60003.0,464.0,248.0
40.061,17,10,676,5,460,10014.0,104.0,64.0,5,216,10014.0,20.0,15.0
11.034,17,28,4424,14,1995,840.0,270.0,114.0,14,2429,840.0,588.0,145.0
0.001,17,2,180,1,66,0.0,38.0,38.0,1,114,0.0,86.0,86.0
0.069,6,10,1506,5,395,15.0,127.0,127.0,5,1111,15.0,843.0,843.0
0.006,6,10,1547,5,764,1.0,496.0,496.0,5,783,1.0,515.0,515.0
0.075,6,10,1506,5,395,17.0,127.0,127.0,5,1111,15.0,843.0,843.0
0.005,6,10,2007,5,928,1.0,660.0,660.0,5,1079,1.0,811.0,811.0
0.015,6,10,1762,5,911,3.0,643.0,643.0,5,851,3.0,583.0,583.0
0.117,17,2,144,1,64,0.0,36.0,36.0,1,80,0.0,52.0,52.0
40.082,17,10,676,5,460,10017.0,104.0,64.0,5,216,10019.0,20.0,15.0
0.12,6,10,1506,5,395,26.0,127.0,127.0,5,1111,27.0,843.0,843.0
0.007,6,10,1989,5,927,1.0,659.0,659.0,5,1062,1.0,794.0,794.0
0.006,6,10,1854,5,889,1.0,621.0,621.0,5,965,1.0,697.0,697.0
0.013,6,10,1990,5,911,3.0,643.0,643.0,5,1079,3.0,811.0,811.0
0.016,6,10,1983,5,910,3.0,642.0,642.0,5,1073,3.0,805.0,805.0
0.009,6,13,3735,7,497,1.0,125.0,125.0,6,3238,1.0,1470.0,1459.0
0.005,6,10,2007,5,928,1.0,660.0,660.0,5,1079,1.0,811.0,811.0
0.007,6,10,1989,5,910,1.0,642.0,642.0,5,1079,1.0,811.0,811.0
0.006,6,10,2007,5,928,1.0,660.0,660.0,5,1079,1.0,811.0,811.0
0.018,6,10,1677,5,827,4.0,559.0,559.0,5,850,4.0,582.0,582.0
0.004,17,2,148,1,60,0.0,32.0,32.0,1,88,0.0,60.0,60.0
0.005,6,10,1989,5,927,1.0,659.0,659.0,5,1062,1.0,794.0,794.0
0.037,17,2,136,1,60,0.0,32.0,32.0,1,76,0.0,48.0,48.0
15.344,17,41,20179,22,17085,729.0,1350.0,748.0,19,3094,850.0,1350.0,134.0
0.104,6,10,1506,5,395,22.0,127.0,127.0,5,1111,23.0,843.0,843.0
0.005,6,10,1854,5,889,1.0,621.0,621.0,5,965,1.0,697.0,697.0
0.152,6,10,1506,5,395,36.0,127.0,127.0,5,1111,36.0,843.0,843.0
0.952,6,24,8565,14,2221,73.0,1254.0,407.0,10,6344,87.0,2720.0,988.0
0.003,17,4,284,2,120,0.0,32.0,32.0,2,164,0.0,60.0,54.0
0.005,6,10,1702,5,863,1.0,595.0,595.0,5,839,1.0,571.0,571.0
0.003,17,2,148,1,60,0.0,32.0,32.0,1,88,0.0,60.0,60.0
0.012,6,10,1989,5,910,3.0,642.0,642.0,5,1079,3.0,811.0,811.0
0.005,17,2,248,1,68,0.0,40.0,40.0,1,180,0.0,152.0,152.0
0.005,6,10,2006,5,927,1.0,659.0,659.0,5,1079,1.0,811.0,811.0
1771.787,6,105,6270,60,3525,30029.0,27.0,27.0,45,2745,40267.0,27.0,27.0
0.009,6,10,1972,5,910,2.0,642.0,642.0,5,1062,2.0,794.0,794.0
309.251,17,20,1124,10,716,34346.0,48.0,43.0,10,408,34347.0,20.0,12.0
0.004,6,10,2007,5,928,1.0,660.0,660.0,5,1079,1.0,811.0,811.0
0.004,17,2,148,1,60,0.0,32.0,32.0,1,88,0.0,60.0,60.0
0.089,6,10,1506,5,395,19.0,127.0,127.0,5,1111,19.0,843.0,843.0
0.007,6,10,1547,5,764,1.0,496.0,496.0,5,783,1.0,515.0,515.0
0.03,6,13,3735,7,497,5.0,125.0,125.0,6,3238,6.0,1470.0,1459.0
40.065,17,10,676,5,460,10014.0,104.0,64.0,5,216,10015.0,20.0,15.0
0.083,6,10,1506,5,395,18.0,127.0,127.0,5,1111,17.0,843.0,843.0
0.004,6,10,1989,5,927,1.0,659.0,659.0,5,1062,1.0,794.0,794.0
0.089,6,10,1506,5,395,18.0,127.0,127.0,5,1111,18.0,843.0,843.0
0.005,17,2,178,1,81,0.0,53.0,53.0,1,97,0.0,69.0,69.0
0.091,6,10,1506,5,395,18.0,127.0,127.0,5,1111,20.0,843.0,843.0
0.012,6,10,1972,5,910,3.0,642.0,642.0,5,1062,3.0,794.0,794.0
0.004,6,10,1989,5,927,1.0,659.0,659.0,5,1062,1.0,794.0,794.0
40.07,17,10,676,5,460,10016.0,104.0,64.0,5,216,10016.0,20.0,15.0
0.017,6,10,1972,5,910,4.0,642.0,642.0,5,1062,4.0,794.0,794.0
0.009,6,10,1989,5,910,2.0,642.0,642.0,5,1079,2.0,811.0,811.0
0.051,6,8,3114,4,2314,17.0,1124.0,1053.0,4,800,15.0,296.0,296.0
0.006,17,2,146,1,65,0.0,37.0,37.0,1,81,0.0,53.0,53.0
0.01,6,10,1972,5,910,2.0,642.0,642.0,5,1062,2.0,794.0,794.0
0.016,6,10,1983,5,910,3.0,642.0,642.0,5,1073,4.0,805.0,805.0
0.013,17,2,152,1,56,0.0,28.0,28.0,1,96,0.0,68.0,68.0
0.005,17,2,144,1,64,0.0,36.0,36.0,1,80,0.0,52.0,52.0
15.081,17,18,9051,9,6428,1881.0,1350.0,686.0,9,2623,1881.0,1350.0,263.0
0.172,6,10,1506,5,395,40.0,127.0,127.0,5,1111,40.0,843.0,843.0
0.005,6,10,2007,5,928,1.0,660.0,660.0,5,1079,1.0,811.0,811.0
0.005,6,10,2000,5,927,1.0,659.0,659.0,5,1073,1.0,805.0,805.0
0.005,6,10,2007,5,928,1.0,660.0,660.0,5,1079,1.0,811.0,811.0
0.012,6,10,1983,5,910,3.0,642.0,642.0,5,1073,3.0,805.0,805.0
40.044,17,10,676,5,460,10009.0,104.0,64.0,5,216,10010.0,20.0,15.0
0.005,6,13,3747,7,509,0.0,137.0,137.0,6,3238,0.0,1470.0,1459.0
0.004,6,10,2006,5,927,1.0,659.0,659.0,5,1079,1.0,811.0,811.0
0.127,17,4,364,2,160,0.0,52.0,52.0,2,204,90.0,80.0,74.0
0.005,6,14,3799,7,509,0.0,137.0,137.0,7,3290,0.0,1448.0,972.0
10.723,17,30,5336,15,2292,758.0,270.0,124.0,15,3044,758.0,1146.0,174.0
40.07,17,10,676,5,460,10014.0,104.0,64.0,5,216,10016.0,20.0,15.0
0.089,6,10,1506,5,395,19.0,127.0,127.0,5,1111,20.0,843.0,843.0
0.012,17,2,169,1,62,0.0,34.0,34.0,1,107,0.0,79.0,79.0
0.129,6,10,1506,5,395,27.0,127.0,127.0,5,1111,30.0,843.0,843.0
0.166,17,2,152,1,76,0.0,48.0,48.0,1,76,0.0,48.0,48.0
0.098,6,10,1506,5,395,20.0,127.0,127.0,5,1111,22.0,843.0,843.0
0.082,6,10,1506,5,395,18.0,127.0,127.0,5,1111,17.0,843.0,843.0
1756.079,6,105,6270,60,3525,29763.0,27.0,27.0,45,2745,39909.0,27.0,27.0
285.361,6,29,6511,16,1421,19023.0,517.0,290.0,13,5090,23779.0,2380.0,1104.0
0.056,6,10,1506,5,395,12.0,127.0,127.0,5,1111,13.0,843.0,843.0
0.01,6,10,2006,5,927,2.0,659.0,659.0,5,1079,2.0,811.0,811.0
0.001,17,2,180,1,66,0.0,38.0,38.0,1,114,0.0,86.0,86.0
0.008,6,10,1989,5,910,2.0,642.0,642.0,5,1079,1.0,811.0,811.0
0.012,6,13,3735,7,497,2.0,125.0,125.0,6,3238,2.0,1470.0,1459.0
0.005,6,10,1854,5,889,1.0,621.0,621.0,5,965,1.0,697.0,697.0
40.064,17,10,676,5,460,10015.0,104.0,64.0,5,216,10015.0,20.0,15.0
0.004,6,10,2006,5,927,1.0,659.0,659.0,5,1079,1.0,811.0,811.0
0.095,6,10,1506,5,395,20.0,127.0,127.0,5,1111,22.0,843.0,843.0
0.005,17,2,214,1,75,0.0,47.0,47.0,1,139,0.0,111.0,111.0
0.012,6,10,1989,5,910,3.0,642.0,642.0,5,1079,2.0,811.0,811.0
0.003,17,2,136,1,60,0.0,32.0,32.0,1,76,0.0,48.0,48.0
241.229,6,393,348640,203,22079,1194.0,2736.0,959.0,190,326561,1276.0,2804.0,1759.0
0.039,6,10,1677,5,827,9.0,559.0,559.0,5,850,9.0,582.0,582.0
0.13,6,27,10260,15,8942,9.0,2883.0,1166.0,12,1318,11.0,243.0,115.0
0.028,6,10,1990,5,911,7.0,643.0,643.0,5,1079,7.0,811.0,811.0
0.004,6,10,1702,5,863,1.0,595.0,595.0,5,839,0.0,571.0,571.0
40.062,17,10,676,5,460,10014.0,104.0,64.0,5,216,10014.0,20.0,15.0
0.009,6,10,1989,5,910,2.0,642.0,642.0,5,1079,2.0,811.0,811.0
0.073,17,2,396,1,61,0.0,33.0,33.0,1,335,0.0,307.0,307.0
0.211,17,15,8307,8,5914,30.0,1350.0,711.0,7,2393,25.0,1350.0,313.0
0.006,6,10,2006,5,927,1.0,659.0,659.0,5,1079,1.0,811.0,811.0
0.013,6,10,1631,5,848,3.0,580.0,580.0,5,783,3.0,515.0,515.0
0.097,6,10,1506,5,395,21.0,127.0,127.0,5,1111,22.0,843.0,843.0
0.017,6,10,1677,5,827,4.0,559.0,559.0,5,850,4.0,582.0,582.0
0.007,6,10,1547,5,764,1.0,496.0,496.0,5,783,1.0,515.0,515.0
0.027,6,10,1990,5,911,6.0,643.0,643.0,5,1079,6.0,811.0,811.0
0.003,17,2,148,1,60,0.0,32.0,32.0,1,88,0.0,60.0,60.0
0.005,6,10,1689,5,839,1.0,571.0,571.0,5,850,1.0,582.0,582.0
0.013,6,10,1990,5,911,3.0,643.0,643.0,5,1079,3.0,811.0,811.0
0.01,6,10,1990,5,911,2.0,643.0,643.0,5,1079,2.0,811.0,811.0
0.007,6,10,1689,5,839,1.0,571.0,571.0,5,850,1.0,582.0,582.0
0.01,6,10,1989,5,910,2.0,642.0,642.0,5,1079,2.0,811.0,811.0
0.005,6,10,2007,5,928,1.0,660.0,660.0,5,1079,1.0,811.0,811.0
0.012,6,10,1983,5,910,3.0,642.0,642.0,5,1073,2.0,805.0,805.0
0.087,6,10,1506,5,395,20.0,127.0,127.0,5,1111,17.0,843.0,843.0
0.006,6,10,1689,5,839,1.0,571.0,571.0,5,850,1.0,582.0,582.0
308.704,17,20,1124,10,716,34286.0,48.0,43.0,10,408,34286.0,20.0,12.0
0.013,6,10,1631,5,848,3.0,580.0,580.0,5,783,3.0,515.0,515.0
137.639,6,29,14573,16,6964,69.0,1360.0,898.0,13,7609,11456.0,2581.0,1179.0
240.012,6,9,787,5,488,60003.0,232.0,232.0,4,299,80003.0,83.0,83.0
0.089,6,10,1506,5,395,18.0,127.0,127.0,5,1111,20.0,843.0,843.0
0.054,17,2,152,1,76,0.0,48.0,48.0,1,76,0.0,48.0,48.0
0.006,6,10,1547,5,764,1.0,496.0,496.0,5,783,1.0,515.0,515.0
0.011,6,10,1762,5,911,2.0,643.0,643.0,5,851,2.0,583.0,583.0
0.038,17,4,352,2,130,1.0,37.0,37.0,2,222,0.0,89.0,83.0
0.085,6,10,1506,5,395,18.0,127.0,127.0,5,1111,18.0,843.0,843.0
0.016,6,10,1989,5,910,3.0,642.0,642.0,5,1079,3.0,811.0,811.0
15.075,17,15,9238,8,6902,2149.0,1350.0,834.0,7,2336,2507.0,1350.0,305.0
0.005,17,2,169,1,62,0.0,34.0,34.0,1,107,0.0,79.0,79.0
0.005,6,10,1989,5,927,1.0,659.0,659.0,5,1062,1.0,794.0,794.0
0.069,6,10,1506,5,395,14.0,127.0,127.0,5,1111,15.0,843.0,843.0
0.016,6,10,1990,5,911,3.0,643.0,643.0,5,1079,4.0,811.0,811.0
0.012,6,10,1972,5,910,2.0,642.0,642.0,5,1062,2.0,794.0,794.0
0.004,6,10,2007,5,928,1.0,660.0,660.0,5,1079,1.0,811.0,811.0
0.011,6,10,1972,5,910,2.0,642.0,642.0,5,1062,2.0,794.0,794.0
0.005,6,10,1689,5,839,1.0,571.0,571.0,5,850,1.0,582.0,582.0
0.011,6,10,1972,5,910,2.0,642.0,642.0,5,1062,2.0,794.0,794.0
0.005,6,10,2000,5,927,1.0,659.0,659.0,5,1073,1.0,805.0,805.0
10.781,17,28,4417,14,1993,820.0,268.0,114.0,14,2424,820.0,587.0,145.0
40.081,17,10,676,5,460,10017.0,104.0,64.0,5,216,10019.0,20.0,15.0
0.018,6,10,1989,5,910,4.0,642.0,642.0,5,1079,4.0,811.0,811.0
10.818,17,28,4417,14,1993,824.0,268.0,114.0,14,2424,824.0,587.0,145.0
0.029,6,10,1989,5,910,7.0,642.0,642.0,5,1079,7.0,811.0,811.0
1787.573,6,157,20044,93,14206,19430.0,302.0,302.0,64,5838,28374.0,83.0,83.0
0.007,17,2,179,1,71,0.0,43.0,43.0,1,108,0.0,80.0,80.0
0.006,6,10,1547,5,764,1.0,496.0,496.0,5,783,1.0,515.0,515.0
0.082,6,10,1506,5,395,16.0,127.0,127.0,5,1111,17.0,843.0,843.0
0.006,6,10,1547,5,764,1.0,496.0,496.0,5,783,1.0,515.0,515.0
0.081,6,10,1506,5,395,17.0,127.0,127.0,5,1111,18.0,843.0,843.0
0.001,17,2,180,1,66,0.0,38.0,38.0,1,114,0.0,86.0,86.0
15.07,17,15,9238,8,6902,2148.0,1350.0,834.0,7,2336,2506.0,1350.0,305.0
0.005,6,14,3742,8,504,0.0,80.0,80.0,6,3238,1.0,1470.0,1459.0
312.356,17,20,1124,10,716,34692.0,48.0,43.0,10,408,34692.0,20.0,12.0
0.005,6,10,1989,5,927,1.0,659.0,659.0,5,1062,1.0,794.0,794.0
0.112,6,10,1506,5,395,25.0,127.0,127.0,5,1111,25.0,843.0,843.0
0.069,6,10,1506,5,395,15.0,127.0,127.0,5,1111,14.0,843.0,843.0
1.039,6,13,3922,7,2139,130.0,1328.0,923.0,6,1783,153.0,1539.0,1539.0
0.005,6,10,2000,5,927,1.0,659.0,659.0,5,1073,1.0,805.0,805.0
0.004,17,4,284,2,120,0.0,32.0,32.0,2,164,1.0,60.0,54.0
0.014,6,10,1989,5,910,3.0,642.0,642.0,5,1079,3.0,811.0,811.0
0.016,6,14,3787,7,497,2.0,125.0,125.0,7,3290,2.0,1448.0,972.0
240.016,6,9,787,5,488,60004.0,232.0,232.0,4,299,80004.0,83.0,83.0
0.087,6,10,1506,5,395,20.0,127.0,127.0,5,1111,20.0,843.0,843.0
0.091,6,10,1506,5,395,21.0,127.0,127.0,5,1111,19.0,843.0,843.0
0.005,6,10,2006,5,927,1.0,659.0,659.0,5,1079,1.0,811.0,811.0
0.003,17,2,185,1,73,0.0,45.0,45.0,1,112,0.0,84.0,84.0
0.005,6,10,2000,5,927,1.0,659.0,659.0,5,1073,1.0,805.0,805.0
0.173,17,2,152,1,76,0.0,48.0,48.0,1,76,0.0,48.0,48.0
0.006,6,10,1854,5,889,1.0,621.0,621.0,5,965,1.0,697.0,697.0
0.04,17,2,412,1,61,0.0,33.0,33.0,1,351,0.0,323.0,323.0
0.005,6,10,1989,5,927,1.0,659.0,659.0,5,1062,1.0,794.0,794.0
0.005,6,10,2000,5,927,1.0,659.0,659.0,5,1073,1.0,805.0,805.0
40.087,17,10,676,5,460,10021.0,104.0,64.0,5,216,10020.0,20.0,15.0
40.091,17,10,676,5,460,10016.0,104.0,64.0,5,216,10019.0,20.0,15.0
0.006,6,10,1643,5,860,1.0,592.0,592.0,5,783,1.0,515.0,515.0
0.016,17,2,180,1,66,0.0,38.0,38.0,1,114,0.0,86.0,86.0
0.004,6,10,1774,5,923,1.0,655.0,655.0,5,851,1.0,583.0,583.0
0.111,6,10,1506,5,395,24.0,127.0,127.0,5,1111,23.0,843.0,843.0
0.011,6,10,1989,5,910,2.0,642.0,642.0,5,1079,2.0,811.0,811.0
0.141,17,4,284,2,120,102.0,32.0,32.0,2,164,70.0,60.0,54.0
0.004,17,2,136,1,60,0.0,32.0,32.0,1,76,0.0,48.0,48.0
0.005,6,10,1989,5,927,1.0,659.0,659.0,5,1062,1.0,794.0,794.0
416.777,6,47,8807,24,6690,5415.0,494.0,494.0,23,2117,18944.0,83.0,83.0
0.071,17,2,186,1,61,0.0,33.0,33.0,1,125,0.0,97.0,97.0
0.011,6,10,1990,5,911,2.0,643.0,643.0,5,1079,2.0,811.0,811.0
0.053,17,2,152,1,76,0.0,48.0,48.0,1,76,0.0,48.0,48.0
40.059,17,10,676,5,460,10013.0,104.0,64.0,5,216,10014.0,20.0,15.0
0.013,6,10,1990,5,911,3.0,643.0,643.0,5,1079,3.0,811.0,811.0
0.12,6,10,1506,5,395,27.0,127.0,127.0,5,1111,25.0,843.0,843.0
0.004,6,10,1779,5,928,1.0,660.0,660.0,5,851,1.0,583.0,583.0
0.006,17,2,179,1,71,0.0,43.0,43.0,1,108,0.0,80.0,80.0
0.003,17,2,152,1,76,0.0,48.0,48.0,1,76,0.0,48.0,48.0
0.012,6,10,1983,5,910,3.0,642.0,642.0,5,1073,3.0,805.0,805.0
0.004,17,2,180,1,58,0.0,30.0,30.0,1,122,0.0,94.0,94.0
0.016,6,10,1990,5,911,3.0,643.0,643.0,5,1079,4.0,811.0,811.0
0.007,17,2,150,1,67,0.0,39.0,39.0,1,83,0.0,55.0,55.0
0.089,6,10,1506,5,395,17.0,127.0,127.0,5,1111,21.0,843.0,843.0
0.15,6,10,1506,5,395,34.0,127.0,127.0,5,1111,26.0,843.0,843.0
0.015,6,10,1990,5,911,3.0,643.0,643.0,5,1079,3.0,811.0,811.0
0.015,6,10,1972,5,910,3.0,642.0,642.0,5,1062,3.0,794.0,794.0
0.016,17,2,198,1,91,0.0,63.0,63.0,1,107,0.0,79.0,79.0
0.076,6,10,1506,5,395,18.0,127.0,127.0,5,1111,17.0,843.0,843.0
10.889,17,24,3783,12,1674,980.0,269.0,111.0,12,2109,980.0,588.0,147.0
0.11,6,10,1506,5,395,24.0,127.0,127.0,5,1111,25.0,843.0,843.0
0.108,6,10,1506,5,395,22.0,127.0,127.0,5,1111,22.0,843.0,843.0
0.005,17,4,495,2,132,0.0,38.0,38.0,2,363,2.0,176.0,153.0
0.092,6,10,1506,5,395,21.0,127.0,127.0,5,1111,20.0,843.0,843.0
0.043,17,2,170,1,65,0.0,37.0,37.0,1,105,0.0,77.0,77.0
0.072,6,10,1506,5,395,16.0,127.0,127.0,5,1111,16.0,843.0,843.0
0.017,6,10,1631,5,848,4.0,580.0,580.0,5,783,4.0,515.0,515.0
0.005,6,10,2000,5,927,1.0,659.0,659.0,5,1073,1.0,805.0,805.0
0.005,17,2,166,1,75,0.0,47.0,47.0,1,91,0.0,63.0,63.0
0.038,17,2,136,1,60,0.0,32.0,32.0,1,76,0.0,48.0,48.0
0.005,17,2,158,1,71,0.0,43.0,43.0,1,87,0.0,59.0,59.0
0.102,6,10,1506,5,395,24.0,127.0,127.0,5,1111,23.0,843.0,843.0
0.088,6,10,1506,5,395,19.0,127.0,127.0,5,1111,21.0,843.0,843.0
0.075,6,10,1506,5,395,16.0,127.0,127.0,5,1111,17.0,843.0,843.0
0.01,6,10,1989,5,927,2.0,659.0,659.0,5,1062,2.0,794.0,794.0
40.065,17,10,676,5,460,10015.0,104.0,64.0,5,216,10015.0,20.0,15.0
0.119,6,10,1506,5,395,26.0,127.0,127.0,5,1111,24.0,843.0,843.0
0.004,6,10,2007,5,928,1.0,660.0,660.0,5,1079,1.0,811.0,811.0
0.005,6,10,1643,5,860,1.0,592.0,592.0,5,783,1.0,515.0,515.0
0.01,6,10,1990,5,911,2.0,643.0,643.0,5,1079,2.0,811.0,811.0
0.077,6,10,1506,5,395,17.0,127.0,127.0,5,1111,14.0,843.0,843.0
0.092,6,10,1506,5,395,21.0,127.0,127.0,5,1111,19.0,843.0,843.0
0.106,6,10,1506,5,395,22.0,127.0,127.0,5,1111,23.0,843.0,843.0
0.001,17,2,179,1,62,0.0,34.0,34.0,1,117,0.0,89.0,89.0
0.008,6,10,1972,5,910,2.0,642.0,642.0,5,1062,1.0,794.0,794.0
0.007,17,2,194,1,59,0.0,31.0,31.0,1,135,0.0,107.0,107.0
0.005,6,10,1854,5,889,1.0,621.0,621.0,5,965,1.0,697.0,697.0
0.005,6,10,1989,5,927,1.0,659.0,659.0,5,1062,1.0,794.0,794.0
40.07,17,10,676,5,460,10016.0,104.0,64.0,5,216,10016.0,20.0,15.0
0.009,6,10,1762,5,911,2.0,643.0,643.0,5,851,2.0,583.0,583.0
0.275,17,43,24400,24,21170,11.0,1350.0,854.0,19,3230,11.0,1350.0,142.0
0.017,6,10,1972,5,910,4.0,642.0,642.0,5,1062,4.0,794.0,794.0
0.005,17,2,170,1,65,0.0,37.0,37.0,1,105,0.0,77.0,77.0
0.012,6,10,1762,5,911,3.0,643.0,643.0,5,851,2.0,583.0,583.0
0.072,17,2,166,1,75,0.0,47.0,47.0,1,91,0.0,63.0,63.0
0.013,6,10,1631,5,848,3.0,580.0,580.0,5,783,3.0,515.0,515.0
0.006,6,10,1547,5,764,1.0,496.0,496.0,5,783,1.0,515.0,515.0
0.018,6,10,1989,5,910,4.0,642.0,642.0,5,1079,4.0,811.0,811.0
0.005,6,10,2006,5,927,1.0,659.0,659.0,5,1079,1.0,811.0,811.0
0.005,6,10,1989,5,927,1.0,659.0,659.0,5,1062,1.0,794.0,794.0
0.005,6,10,1989,5,927,1.0,659.0,659.0,5,1062,1.0,794.0,794.0
11.504,17,28,4399,14,2312,872.0,587.0,137.0,14,2087,872.0,270.0,121.0
0.005,6,10,1689,5,839,1.0,571.0,571.0,5,850,1.0,582.0,582.0
0.01,6,10,1972,5,910,2.0,642.0,642.0,5,1062,2.0,794.0,794.0
0.015,6,10,1972,5,910,3.0,642.0,642.0,5,1062,3.0,794.0,794.0
0.005,6,10,2006,5,927,1.0,659.0,659.0,5,1079,1.0,811.0,811.0
0.006,6,10,2007,5,928,1.0,660.0,660.0,5,1079,1.0,811.0,811.0
0.087,6,10,1506,5,395,18.0,127.0,127.0,5,1111,19.0,843.0,843.0
0.004,6,13,3690,7,452,0.0,80.0,80.0,6,3238,0.0,1470.0,1459.0
0.012,6,10,1983,5,910,3.0,642.0,642.0,5,1073,2.0,805.0,805.0
0.017,6,10,1989,5,910,4.0,642.0,642.0,5,1079,4.0,811.0,811.0
0.005,6,13,3747,7,509,0.0,137.0,137.0,6,3238,0.0,1470.0,1459.0
0.004,17,2,148,1,60,0.0,32.0,32.0,1,88,0.0,60.0,60.0
0.005,17,2,136,1,60,0.0,32.0,32.0,1,76,0.0,48.0,48.0
0.021,6,10,1989,5,910,5.0,642.0,642.0,5,1079,5.0,811.0,811.0
0.005,6,10,2007,5,928,1.0,660.0,660.0,5,1079,1.0,811.0,811.0
0.007,17,2,144,1,64,0.0,36.0,36.0,1,80,0.0,52.0,52.0
0.007,17,2,222,1,65,0.0,37.0,37.0,1,157,0.0,129.0,129.0
0.089,6,10,1506,5,395,18.0,127.0,127.0,5,1111,20.0,843.0,843.0
5.136,58,2,144,1,72,0.0,24.0,24.0,1,72,0.0,24.0,24.0
0.006,6,10,1689,5,839,1.0,571.0,571.0,5,850,1.0,582.0,582.0
0.004,6,10,2006,5,927,1.0,659.0,659.0,5,1079,1.0,811.0,811.0
0.001,17,2,180,1,66,0.0,38.0,38.0,1,114,0.0,86.0,86.0
0.013,6,10,1972,5,910,3.0,642.0,642.0,5,1062,3.0,794.0,794.0
0.006,6,10,1547,5,764,1.0,496.0,496.0,5,783,1.0,515.0,515.0
0.082,17,2,144,1,64,0.0,36.0,36.0,1,80,0.0,52.0,52.0
0.018,6,10,1990,5,911,4.0,643.0,643.0,5,1079,4.0,811.0,811.0
0.173,6,10,1506,5,395,43.0,127.0,127.0,5,1111,39.0,843.0,843.0
40.058,17,10,676,5,460,10013.0,104.0,64.0,5,216,10013.0,20.0,15.0
0.008,17,2,170,1,65,0.0,37.0,37.0,1,105,0.0,77.0,77.0
0.117,6,10,1506,5,395,28.0,127.0,127.0,5,1111,26.0,843.0,843.0
0.012,6,10,1990,5,911,3.0,643.0,643.0,5,1079,2.0,811.0,811.0
0.011,6,10,1983,5,910,2.0,642.0,642.0,5,1073,2.0,805.0,805.0
0.702,6,23,5165,12,1343,63.0,325.0,122.0,11,3822,59.0,1414.0,563.0
0.012,6,10,1989,5,910,3.0,642.0,642.0,5,1079,2.0,811.0,811.0
0.116,6,10,1506,5,395,21.0,127.0,127.0,5,1111,27.0,843.0,843.0
0.005,6,10,2006,5,927,1.0,659.0,659.0,5,1079,1.0,811.0,811.0
0.01,6,10,1677,5,827,2.0,559.0,559.0,5,850,2.0,582.0,582.0
10.73,17,26,4098,13,1845,885.0,268.0,113.0,13,2253,885.0,588.0,145.0
0.078,6,10,1506,5,395,18.0,127.0,127.0,5,1111,14.0,843.0,843.0
0.005,6,13,3747,7,509,0.0,137.0,137.0,6,3238,0.0,1470.0,1459.0
0.005,6,10,2000,5,927,1.0,659.0,659.0,5,1073,1.0,805.0,805.0
0.005,6,13,3747,7,509,0.0,137.0,137.0,6,3238,0.0,1470.0,1459.0
0.001,17,2,136,1,60,0.0,32.0,32.0,1,76,0.0,48.0,48.0
0.001,17,2,136,1,60,0.0,32.0,32.0,1,76,0.0,48.0,48.0
0.001,17,2,136,1,60,0.0,32.0,32.0,1,76,0.0,48.0,48.0
240.093,6,16,4481,9,963,30011.0,238.0,166.0,7,3518,40015.0,1402.0,786.0
0.166,17,2,152,1,76,0.0,48.0,48.0,1,76,0.0,48.0,48.0
0.08,17,4,596,2,122,42.0,33.0,33.0,2,474,40.0,323.0,209.0
0.001,17,2,294,1,64,0.0,36.0,36.0,1,230,0.0,202.0,202.0
0.006,6,10,1547,5,764,1.0,496.0,496.0,5,783,1.0,515.0,515.0
0.001,17,2,180,1,66,0.0,38.0,38.0,1,114,0.0,86.0,86.0
40.081,17,10,676,5,460,10019.0,104.0,64.0,5,216,10019.0,20.0,15.0
241.213,6,402,349139,192,21497,1262.0,2736.0,958.0,210,327642,1154.0,2804.0,1583.0
0.121,6,10,1506,5,395,28.0,127.0,127.0,5,1111,29.0,843.0,843.0
0.004,6,10,2006,5,927,1.0,659.0,659.0,5,1079,1.0,811.0,811.0
0.006,6,10,1989,5,927,1.0,659.0,659.0,5,1062,1.0,794.0,794.0
0.004,6,10,1774,5,923,1.0,655.0,655.0,5,851,1.0,583.0,583.0
0.004,6,10,1774,5,923,1.0,655.0,655.0,5,851,1.0,583.0,583.0
0.011,6,10,1990,5,911,2.0,643.0,643.0,5,1079,2.0,811.0,811.0
366.984,6,22,2313,16,867,24465.0,195.0,195.0,6,1446,4635.0,419.0,398.0
0.021,6,10,1972,5,910,5.0,642.0,642.0,5,1062,5.0,794.0,794.0
0.005,17,2,140,1,62,0.0,34.0,34.0,1,78,0.0,50.0,50.0
0.008,6,12,1926,6,1189,1.0,659.0,434.0,6,737,1.0,417.0,417.0
0.004,6,10,1774,5,923,1.0,655.0,655.0,5,851,1.0,583.0,583.0
0.101,6,10,1506,5,395,22.0,127.0,127.0,5,1111,22.0,843.0,843.0
0.004,17,4,284,2,120,0.0,32.0,32.0,2,164,0.0,60.0,54.0
0.006,17,2,273,1,66,0.0,38.0,38.0,1,207,0.0,179.0,179.0
0.013,6,10,1989,5,910,3.0,642.0,642.0,5,1079,3.0,811.0,811.0
0.006,6,10,1779,5,928,1.0,660.0,660.0,5,851,1.0,583.0,583.0
0.799,6,10,2009,6,1655,159.0,1403.0,1403.0,4,354,185.0,182.0,182.0
0.007,6,10,1689,5,839,1.0,571.0,571.0,5,850,1.0,582.0,582.0
0.005,6,10,1547,5,764,1.0,496.0,496.0,5,783,1.0,515.0,515.0
0.015,6,10,1990,5,911,3.0,643.0,643.0,5,1079,3.0,811.0,811.0
0.015,6,10,1631,5,848,3.0,580.0,580.0,5,783,3.0,515.0,515.0
0.013,6,10,1983,5,910,3.0,642.0,642.0,5,1073,3.0,805.0,805.0
0.003,17,2,136,1,60,0.0,32.0,32.0,1,76,0.0,48.0,48.0
0.084,6,10,1506,5,395,19.0,127.0,127.0,5,1111,19.0,843.0,843.0
0.037,17,2,136,1,60,0.0,32.0,32.0,1,76,0.0,48.0,48.0
0.078,6,10,1506,5,395,17.0,127.0,127.0,5,1111,18.0,843.0,843.0
0.004,6,10,2007,5,928,1.0,660.0,660.0,5,1079,1.0,811.0,811.0
0.006,6,10,2007,5,928,1.0,660.0,660.0,5,1079,1.0,811.0,811.0
40.067,17,10,676,5,460,10013.0,104.0,64.0,5,216,10016.0,20.0,15.0
0.001,17,2,180,1,66,0.0,38.0,38.0,1,114,0.0,86.0,86.0
0.001,17,2,154,1,69,0.0,41.0,41.0,1,85,0.0,57.0,57.0
0.001,17,2,180,1,66,0.0,38.0,38.0,1,114,0.0,86.0,86.0
0.008,6,10,1989,5,910,1.0,642.0,642.0,5,1079,2.0,811.0,811.0
0.134,6,10,1506,5,395,29.0,127.0,127.0,5,1111,31.0,843.0,843.0
0.012,6,10,1989,5,910,3.0,642.0,642.0,5,1079,3.0,811.0,811.0
0.005,6,10,2007,5,928,1.0,660.0,660.0,5,1079,1.0,811.0,811.0
0.006,6,10,1547,5,764,1.0,496.0,496.0,5,783,1.0,515.0,515.0
0.006,6,10,1689,5,839,1.0,571.0,571.0,5,850,1.0,582.0,582.0
0.011,6,10,1989,5,910,2.0,642.0,642.0,5,1079,2.0,811.0,811.0
0.015,6,10,1983,5,910,3.0,642.0,642.0,5,1073,3.0,805.0,805.0
0.012,6,10,1990,5,911,3.0,643.0,643.0,5,1079,3.0,811.0,811.0
0.18,6,3,453,2,321,180.0,241.0,241.0,1,132,0.0,92.0,92.0
0.009,6,13,3735,7,497,1.0,125.0,125.0,6,3238,1.0,1470.0,1459.0
0.121,6,10,1506,5,395,29.0,127.0,127.0,5,1111,24.0,843.0,843.0
0.009,6,10,1989,5,910,2.0,642.0,642.0,5,1079,2.0,811.0,811.0
0.005,17,4,495,2,132,0.0,38.0,38.0,2,363,2.0,176.0,153.0
0.012,6,10,1983,5,910,3.0,642.0,642.0,5,1073,3.0,805.0,805.0
0.005,6,10,2006,5,927,1.0,659.0,659.0,5,1079,1.0,811.0,811.0
0.098,6,10,1506,5,395,18.0,127.0,127.0,5,1111,21.0,843.0,843.0
40.06,17,10,676,5,460,10014.0,104.0,64.0,5,216,10014.0,20.0,15.0
0.122,17,2,80,1,32,0.0,4.0,4.0,1,48,0.0,20.0,20.0
0.089,6,10,1506,5,395,20.0,127.0,127.0,5,1111,18.0,843.0,843.0
0.005,6,10,2000,5,927,1.0,659.0,659.0,5,1073,1.0,805.0,805.0
0.061,6,10,1506,5,395,12.0,127.0,127.0,5,1111,14.0,843.0,843.0
0.009,6,10,1983,5,910,2.0,642.0,642.0,5,1073,2.0,805.0,805.0
0.003,17,2,148,1,60,0.0,32.0,32.0,1,88,0.0,60.0,60.0
0.084,6,10,1506,5,395,17.0,127.0,127.0,5,1111,17.0,843.0,843.0
0.041,17,2,152,1,76,0.0,48.0,48.0,1,76,0.0,48.0,48.0
0.013,6,10,1990,5,911,3.0,643.0,643.0,5,1079,3.0,811.0,811.0
0.005,6,10,2006,5,927,1.0,659.0,659.0,5,1079,1.0,811.0,811.0
0.082,6,10,1506,5,395,17.0,127.0,127.0,5,1111,18.0,843.0,843.0
0.014,6,13,3735,7,497,2.0,125.0,125.0,6,3238,2.0,1470.0,1459.0
240.388,6,36,10588,17,1898,15024.0,622.0,198.0,19,8690,13354.0,1402.0,592.0
0.07,17,8,3613,4,1874,23.0,1350.0,440.0,4,1739,12.0,1350.0,406.0
0.196,6,10,1506,5,395,46.0,127.0,127.0,5,1111,46.0,843.0,843.0
0.08,6,10,1506,5,395,16.0,127.0,127.0,5,1111,17.0,843.0,843.0
0.005,17,2,154,1,69,0.0,41.0,41.0,1,85,0.0,57.0,57.0
0.103,6,10,1506,5,395,25.0,127.0,127.0,5,1111,22.0,843.0,843.0
0.004,6,10,1989,5,927,1.0,659.0,659.0,5,1062,1.0,794.0,794.0
0.003,17,2,132,1,58,0.0,30.0,30.0,1,74,0.0,46.0,46.0
1778.261,17,144,41760,72,22752,25045.0,288.0,288.0,72,19008,25045.0,236.0,236.0
0.01,6,10,1990,5,911,2.0,643.0,643.0,5,1079,2.0,811.0,811.0
0.065,6,10,1506,5,395,14.0,127.0,127.0,5,1111,13.0,843.0,843.0
0.005,6,10,1779,5,928,1.0,660.0,660.0,5,851,1.0,583.0,583.0
0.041,17,4,284,2,120,0.0,32.0,32.0,2,164,38.0,60.0,54.0
40.053,17,10,676,5,460,10012.0,104.0,64.0,5,216,10012.0,20.0,15.0
0.069,6,10,1506,5,395,14.0,127.0,127.0,5,1111,16.0,843.0,843.0
0.155,17,2,144,1,64,0.0,36.0,36.0,1,80,0.0,52.0,52.0
0.017,6,10,1972,5,910,4.0,642.0,642.0,5,1062,4.0,794.0,794.0
0.008,17,2,194,1,59,0.0,31.0,31.0,1,135,0.0,107.0,107.0
0.068,6,10,1506,5,395,12.0,127.0,127.0,5,1111,15.0,843.0,843.0
0.004,6,13,3690,7,452,0.0,80.0,80.0,6,3238,0.0,1470.0,1459.0
240.029,6,9,787,5,488,60007.0,232.0,232.0,4,299,80009.0,83.0,83.0
10.739,17,28,4424,14,1995,817.0,270.0,114.0,14,2429,817.0,588.0,145.0
0.078,6,10,1506,5,395,17.0,127.0,127.0,5,1111,16.0,843.0,843.0
0.005,6,10,1989,5,927,1.0,659.0,659.0,5,1062,1.0,794.0,794.0
0.005,17,2,144,1,64,0.0,36.0,36.0,1,80,0.0,52.0,52.0
0.005,17,2,214,1,75,0.0,47.0,47.0,1,139,0.0,111.0,111.0
0.015,6,10,1677,5,827,3.0,559.0,559.0,5,850,3.0,582.0,582.0
0.005,6,10,1989,5,927,1.0,659.0,659.0,5,1062,1.0,794.0,794.0
0.005,6,10,2000,5,927,1.0,659.0,659.0,5,1073,1.0,805.0,805.0
170.278,17,78,11183,39,2621,4480.0,44.0,39.0,39,8562,4480.0,260.0,191.0
0.001,17,2,180,1,66,0.0,38.0,38.0,1,114,0.0,86.0,86.0
0.006,6,10,1547,5,764,1.0,496.0,496.0,5,783,1.0,515.0,515.0
0.006,6,11,1695,6,912,1.0,592.0,592.0,5,783,1.0,515.0,515.0
0.113,6,10,1506,5,395,20.0,127.0,127.0,5,1111,24.0,843.0,843.0
0.009,6,10,1762,5,911,2.0,643.0,643.0,5,851,2.0,583.0,583.0
40.078,17,10,676,5,460,10016.0,104.0,64.0,5,216,10018.0,20.0,15.0
0.006,17,2,179,1,71,0.0,43.0,43.0,1,108,0.0,80.0,80.0
0.005,6,13,3747,7,509,0.0,137.0,137.0,6,3238,1.0,1470.0,1459.0
178.332,17,76,10697,38,2529,4819.0,44.0,38.0,38,8168,4819.0,260.0,186.0
0.006,6,10,1547,5,764,1.0,496.0,496.0,5,783,1.0,515.0,515.0
0.012,6,10,1983,5,910,2.0,642.0,642.0,5,1073,3.0,805.0,805.0
0.07,6,10,1506,5,395,13.0,127.0,127.0,5,1111,15.0,843.0,843.0
0.005,6,13,3690,7,452,0.0,80.0,80.0,6,3238,1.0,1470.0,1459.0
0.005,17,2,170,1,65,0.0,37.0,37.0,1,105,0.0,77.0,77.0
0.108,6,10,1506,5,395,24.0,127.0,127.0,5,1111,23.0,843.0,843.0
0.01,6,10,1983,5,910,2.0,642.0,642.0,5,1073,2.0,805.0,805.0
0.007,17,2,194,1,59,0.0,31.0,31.0,1,135,0.0,107.0,107.0
0.001,17,2,166,1,75,0.0,47.0,47.0,1,91,0.0,63.0,63.0
0.005,17,4,284,2,120,1.0,32.0,32.0,2,164,1.0,60.0,54.0
0.005,17,2,136,1,60,0.0,32.0,32.0,1,76,0.0,48.0,48.0
0.171,6,3,453,2,321,171.0,241.0,241.0,1,132,0.0,92.0,92.0
0.007,6,10,1990,5,911,1.0,643.0,643.0,5,1079,1.0,811.0,811.0
0.006,6,10,1547,5,764,1.0,496.0,496.0,5,783,1.0,515.0,515.0
0.04,17,4,284,2,120,0.0,32.0,32.0,2,164,1.0,60.0,54.0
172.16,17,76,10856,38,2537,4652.0,44.0,38.0,38,8319,4652.0,239.0,190.0
0.008,6,10,1677,5,827,2.0,559.0,559.0,5,850,2.0,582.0,582.0
351.987,6,20,2210,6,1308,12003.0,494.0,494.0,14,902,27075.0,83.0,83.0
0.084,6,10,1506,5,395,18.0,127.0,127.0,5,1111,19.0,843.0,843.0
0.008,6,13,3735,7,497,1.0,125.0,125.0,6,3238,1.0,1470.0,1459.0
0.005,6,10,2006,5,927,1.0,659.0,659.0,5,1079,1.0,811.0,811.0
241.412,6,25,8200,13,2732,20117.0,1038.0,515.0,12,5468,21946.0,1592.0,690.0
0.04,17,4,284,2,120,0.0,32.0,32.0,2,164,36.0,60.0,54.0
0.037,17,2,152,1,76,0.0,48.0,48.0,1,76,0.0,48.0,48.0
0.004,6,10,1989,5,927,1.0,659.0,659.0,5,1062,1.0,794.0,794.0
0.014,6,10,1990,5,911,3.0,643.0,643.0,5,1079,3.0,811.0,811.0
0.004,17,2,148,1,60,0.0,32.0,32.0,1,88,0.0,60.0,60.0
0.004,6,10,1774,5,923,1.0,655.0,655.0,5,851,1.0,583.0,583.0
0.009,6,10,1689,5,839,2.0,571.0,571.0,5,850,2.0,582.0,582.0
0.014,6,10,1990,5,911,3.0,643.0,643.0,5,1079,3.0,811.0,811.0
0.013,6,10,1990,5,911,3.0,643.0,643.0,5,1079,3.0,811.0,811.0
0.083,6,10,1506,5,395,18.0,127.0,127.0,5,1111,18.0,843.0,843.0
15.075,17,15,9238,8,6902,2149.0,1350.0,834.0,7,2336,2507.0,1350.0,305.0
0.005,6,10,2007,5,928,1.0,660.0,660.0,5,1079,1.0,811.0,811.0
0.102,6,10,1506,5,395,20.0,127.0,127.0,5,1111,25.0,843.0,843.0
0.005,6,10,1989,5,927,1.0,659.0,659.0,5,1062,1.0,794.0,794.0
293.281,6,334,344592,127,18151,2327.0,2736.0,825.0,207,326441,1423.0,2804.0,1635.0
0.069,6,10,1506,5,395,14.0,127.0,127.0,5,1111,15.0,843.0,843.0
0.001,17,2,179,1,62,0.0,34.0,34.0,1,117,0.0,89.0,89.0
240.009,6,9,787,5,488,60002.0,232.0,232.0,4,299,80002.0,83.0,83.0
10.797,17,28,4421,14,1994,822.0,269.0,114.0,14,2427,822.0,586.0,145.0
0.014,6,10,1983,5,910,3.0,642.0,642.0,5,1073,3.0,805.0,805.0
0.003,17,2,148,1,60,0.0,32.0,32.0,1,88,0.0,60.0,60.0
0.007,6,12,1698,6,863,1.0,327.0,271.0,6,835,1.0,515.0,515.0
240.088,6,31,9034,15,6707,17149.0,1832.0,659.0,16,2327,16005.0,580.0,185.0
0.07,6,10,1506,5,395,15.0,127.0,127.0,5,1111,14.0,843.0,843.0
0.005,6,10,2006,5,927,1.0,659.0,659.0,5,1079,1.0,811.0,811.0
354.067,6,21,1795,16,1030,23604.0,190.0,190.0,5,765,60001.0,464.0,248.0
0.005,17,2,144,1,64,0.0,36.0,36.0,1,80,0.0,52.0,52.0
1786.487,6,150,19350,90,13740,20072.0,302.0,302.0,60,5610,30279.0,83.0,83.0
0.006,6,10,1689,5,839,1.0,571.0,571.0,5,850,1.0,582.0,582.0
0.008,6,10,1989,5,910,2.0,642.0,642.0,5,1079,1.0,811.0,811.0
0.061,6,10,1506,5,395,12.0,127.0,127.0,5,1111,14.0,843.0,843.0
0.006,6,10,1643,5,860,1.0,592.0,592.0,5,783,1.0,515.0,515.0
0.142,6,10,1506,5,395,33.0,127.0,127.0,5,1111,21.0,843.0,843.0
0.004,6,10,2007,5,928,1.0,660.0,660.0,5,1079,1.0,811.0,811.0
0.022,6,10,1983,5,910,5.0,642.0,642.0,5,1073,5.0,805.0,805.0
294.005,6,376,347746,191,21489,1547.0,2736.0,888.0,185,326257,1597.0,2804.0,1851.0
0.013,6,10,1989,5,910,3.0,642.0,642.0,5,1079,3.0,811.0,811.0
0.079,6,10,1506,5,395,17.0,127.0,127.0,5,1111,17.0,843.0,843.0
0.004,17,2,148,1,60,0.0,32.0,32.0,1,88,0.0,60.0,60.0
0.005,17,2,144,1,64,0.0,36.0,36.0,1,80,0.0,52.0,52.0
240.02,6,9,787,5,488,60005.0,232.0,232.0,4,299,80005.0,83.0,83.0
0.006,6,10,1547,5,764,1.0,496.0,496.0,5,783,1.0,515.0,515.0
0.005,6,13,3747,7,509,0.0,137.0,137.0,6,3238,1.0,1470.0,1459.0
0.005,6,10,2006,5,927,1.0,659.0,659.0,5,1079,1.0,811.0,811.0
0.003,17,2,132,1,58,0.0,30.0,30.0,1,74,0.0,46.0,46.0
0.016,6,10,1983,5,910,4.0,642.0,642.0,5,1073,3.0,805.0,805.0
0.148,6,10,1506,5,395,31.0,127.0,127.0,5,1111,35.0,843.0,843.0
0.005,6,10,1989,5,927,1.0,659.0,659.0,5,1062,1.0,794.0,794.0
0.006,6,10,2006,5,927,1.0,659.0,659.0,5,1079,1.0,811.0,811.0
0.103,6,10,1506,5,395,22.0,127.0,127.0,5,1111,20.0,843.0,843.0
0.066,6,10,1506,5,395,14.0,127.0,127.0,5,1111,15.0,843.0,843.0
0.278,17,47,28454,26,24770,11.0,1350.0,924.0,21,3684,11.0,1350.0,147.0
40.078,17,10,676,5,460,10018.0,104.0,64.0,5,216,10018.0,20.0,15.0
0.009,6,13,3735,7,497,1.0,125.0,125.0,6,3238,1.0,1470.0,1459.0
0.042,17,2,136,1,60,0.0,32.0,32.0,1,76,0.0,48.0,48.0
0.005,6,14,3736,7,446,0.0,74.0,74.0,7,3290,0.0,1448.0,972.0
0.105,6,10,1506,5,395,23.0,127.0,127.0,5,1111,25.0,843.0,843.0
0.015,6,10,1990,5,911,3.0,643.0,643.0,5,1079,3.0,811.0,811.0
0.008,6,10,1983,5,910,2.0,642.0,642.0,5,1073,1.0,805.0,805.0
0.298,17,15,9899,8,6907,42.0,1350.0,835.0,7,2992,40.0,1350.0,399.0
0.005,6,10,2006,5,927,1.0,659.0,659.0,5,1079,1.0,811.0,811.0
0.171,6,10,1506,5,395,39.0,127.0,127.0,5,1111,41.0,843.0,843.0
280.263,6,23,6075,10,1186,31139.0,267.0,156.0,13,4889,23354.0,1400.0,873.0
0.01,6,12,1926,6,1189,1.0,659.0,434.0,6,737,2.0,417.0,417.0
0.004,6,10,1779,5,928,1.0,660.0,660.0,5,851,1.0,583.0,583.0
0.005,6,10,2006,5,927,1.0,659.0,659.0,5,1079,1.0,811.0,811.0
0.038,17,2,170,1,65,0.0,37.0,37.0,1,105,0.0,77.0,77.0
240.173,6,20,7441,11,2759,24017.0,1368.0,547.0,9,4682,30021.0,1657.0,1051.0
0.012,6,10,1989,5,910,3.0,642.0,642.0,5,1079,3.0,811.0,811.0
0.094,6,10,1506,5,395,22.0,127.0,127.0,5,1111,20.0,843.0,843.0
0.06,17,2,80,1,32,0.0,4.0,4.0,1,48,0.0,20.0,20.0
1757.944,6,533,189136,268,162728,6584.0,2883.0,991.0,265,26408,6658.0,580.0,130.0
0.004,6,10,1702,5,863,0.0,595.0,595.0,5,839,1.0,571.0,571.0
1797.588,17,3198,244940,1587,128684,1133.0,84.0,53.0,1611,116256,1116.0,227.0,44.0
0.004,17,4,284,2,120,1.0,32.0,32.0,2,164,0.0,60.0,54.0
0.128,6,10,1506,5,395,31.0,127.0,127.0,5,1111,30.0,843.0,843.0
0.423,6,10,1266,5,775,105.0,519.0,519.0,5,491,104.0,223.0,223.0
0.004,6,10,1779,5,928,1.0,660.0,660.0,5,851,1.0,583.0,583.0
0.128,17,2,80,1,32,0.0,4.0,4.0,1,48,0.0,20.0,20.0
0.031,17,2,140,1,62,0.0,34.0,34.0,1,78,0.0,50.0,50.0
0.018,6,10,1631,5,848,4.0,580.0,580.0,5,783,4.0,515.0,515.0
0.018,6,10,1972,5,910,4.0,642.0,642.0,5,1062,4.0,794.0,794.0
0.018,6,10,1990,5,911,4.0,643.0,643.0,5,1079,4.0,811.0,811.0
0.004,6,10,1774,5,923,1.0,655.0,655.0,5,851,0.0,583.0,583.0
0.005,17,2,170,1,65,0.0,37.0,37.0,1,105,0.0,77.0,77.0
0.011,6,10,1972,5,910,2.0,642.0,642.0,5,1062,2.0,794.0,794.0
0.008,17,2,194,1,59,0.0,31.0,31.0,1,135,0.0,107.0,107.0
0.009,6,12,1926,6,1189,1.0,659.0,434.0,6,737,1.0,417.0,417.0
0.009,6,10,1972,5,910,2.0,642.0,642.0,5,1062,2.0,794.0,794.0
0.008,6,10,1989,5,910,2.0,642.0,642.0,5,1079,1.0,811.0,811.0
240.105,6,32,9541,16,6931,16007.0,2002.0,678.0,16,2610,16006.0,580.0,221.0
0.002,17,2,136,1,60,0.0,32.0,32.0,1,76,0.0,48.0,48.0
0.018,6,10,1990,5,911,4.0,643.0,643.0,5,1079,4.0,811.0,811.0
10.801,17,28,4419,14,1994,822.0,269.0,114.0,14,2425,822.0,588.0,145.0
0.126,6,10,1506,5,395,26.0,127.0,127.0,5,1111,26.0,843.0,843.0
240.013,6,9,787,5,488,60003.0,232.0,232.0,4,299,80003.0,83.0,83.0
0.003,17,2,148,1,60,0.0,32.0,32.0,1,88,0.0,60.0,60.0
0.005,17,2,164,1,74,0.0,46.0,46.0,1,90,0.0,62.0,62.0
0.004,17,2,136,1,60,0.0,32.0,32.0,1,76,0.0,48.0,48.0
0.067,6,10,1506,5,395,16.0,127.0,127.0,5,1111,12.0,843.0,843.0
0.005,17,2,179,1,71,0.0,43.0,43.0,1,108,0.0,80.0,80.0
240.011,6,9,787,5,488,60002.0,232.0,232.0,4,299,80002.0,83.0,83.0
240.011,6,9,787,5,488,60002.0,232.0,232.0,4,299,80002.0,83.0,83.0
0.01,6,10,1989,5,910,2.0,642.0,642.0,5,1079,2.0,811.0,811.0
0.004,6,10,2007,5,928,1.0,660.0,660.0,5,1079,1.0,811.0,811.0
171.142,17,86,12409,43,2871,4074.0,44.0,38.0,43,9538,4074.0,239.0,193.0
352.249,6,20,2210,6,1308,12004.0,494.0,494.0,14,902,27095.0,83.0,83.0
0.068,17,2,80,1,32,0.0,4.0,4.0,1,48,0.0,20.0,20.0
0.102,6,10,1506,5,395,22.0,127.0,127.0,5,1111,22.0,843.0,843.0
0.127,17,2,148,1,60,0.0,32.0,32.0,1,88,0.0,60.0,60.0
0.161,6,10,1506,5,395,38.0,127.0,127.0,5,1111,37.0,843.0,843.0
0.004,6,10,2000,5,927,1.0,659.0,659.0,5,1073,1.0,805.0,805.0
367.382,6,22,2313,16,867,24492.0,195.0,195.0,6,1446,4653.0,419.0,398.0
0.005,6,10,1989,5,927,1.0,659.0,659.0,5,1062,1.0,794.0,794.0
0.004,17,4,284,2,120,0.0,32.0,32.0,2,164,0.0,60.0,54.0
0.003,17,4,284,2,120,0.0,32.0,32.0,2,164,0.0,60.0,54.0
0.114,6,10,1506,5,395,22.0,127.0,127.0,5,1111,23.0,843.0,843.0
0.004,17,2,148,1,60,0.0,32.0,32.0,1,88,0.0,60.0,60.0
0.18,6,10,1506,5,395,41.0,127.0,127.0,5,1111,35.0,843.0,843.0
289.75,6,369,346753,190,21443,1533.0,2736.0,888.0,179,325310,1627.0,2804.0,1915.0
40.072,17,10,676,5,460,10014.0,104.0,64.0,5,216,10017.0,20.0,15.0
0.023,17,2,179,1,71,0.0,43.0,43.0,1,108,0.0,80.0,80.0
0.004,6,10,2006,5,927,1.0,659.0,659.0,5,1079,1.0,811.0,811.0
40.063,17,10,676,5,460,10013.0,104.0,64.0,5,216,10014.0,20.0,15.0
0.068,17,8,3613,4,1874,22.0,1350.0,440.0,4,1739,11.0,1350.0,406.0
240.026,6,9,787,5,488,60006.0,232.0,232.0,4,299,80007.0,83.0,83.0
0.083,6,10,1506,5,395,19.0,127.0,127.0,5,1111,19.0,843.0,843.0
0.038,17,2,136,1,60,0.0,32.0,32.0,1,76,0.0,48.0,48.0
0.026,6,10,1762,5,911,6.0,643.0,643.0,5,851,6.0,583.0,583.0
0.003,17,2,148,1,60,0.0,32.0,32.0,1,88,0.0,60.0,60.0
10.955,17,28,4418,14,1994,834.0,269.0,114.0,14,2424,834.0,587.0,145.0
0.001,17,2,179,1,62,0.0,34.0,34.0,1,117,0.0,89.0,89.0
0.005,6,13,3747,7,509,0.0,137.0,137.0,6,3238,0.0,1470.0,1459.0
0.005,6,10,1643,5,860,1.0,592.0,592.0,5,783,1.0,515.0,515.0
0.202,6,16,2777,8,1395,28.0,533.0,323.0,8,1382,18.0,529.0,239.0
10.913,17,28,4417,14,1994,830.0,269.0,114.0,14,2423,829.0,586.0,145.0
0.108,6,10,1506,5,395,20.0,127.0,127.0,5,1111,24.0,843.0,843.0
0.063,6,10,1506,5,395,15.0,127.0,127.0,5,1111,14.0,843.0,843.0
0.075,6,10,1506,5,395,17.0,127.0,127.0,5,1111,13.0,843.0,843.0
40.061,17,10,676,5,460,10014.0,104.0,64.0,5,216,10014.0,20.0,15.0
0.014,6,10,1989,5,910,3.0,642.0,642.0,5,1079,3.0,811.0,811.0
0.098,6,10,1506,5,395,22.0,127.0,127.0,5,1111,19.0,843.0,843.0
0.088,6,10,1506,5,395,20.0,127.0,127.0,5,1111,17.0,843.0,843.0
0.121,6,10,1506,5,395,26.0,127.0,127.0,5,1111,26.0,843.0,843.0
240.186,6,21,7363,11,2646,24018.0,1368.0,519.0,10,4717,26686.0,1656.0,1047.0
0.006,6,10,1854,5,889,1.0,621.0,621.0,5,965,1.0,697.0,697.0
0.001,17,2,166,1,75,0.0,47.0,47.0,1,91,0.0,63.0,63.0
0.005,17,2,213,1,69,0.0,41.0,41.0,1,144,0.0,116.0,116.0
300.085,6,19,4660,11,1102,30008.0,238.0,130.0,8,3558,42868.0,1402.0,786.0
10.89,17,28,4393,14,1993,828.0,268.0,114.0,14,2400,828.0,587.0,143.0
84.507,6,27,9565,13,1667,66.0,794.0,367.0,14,7898,6490.0,1360.0,732.0
0.005,17,2,169,1,62,0.0,34.0,34.0,1,107,0.0,79.0,79.0
0.008,6,10,1989,5,910,2.0,642.0,642.0,5,1079,2.0,811.0,811.0
0.005,6,10,1989,5,927,1.0,659.0,659.0,5,1062,1.0,794.0,794.0
0.013,6,10,1972,5,910,3.0,642.0,642.0,5,1062,3.0,794.0,794.0
0.088,6,10,1506,5,395,19.0,127.0,127.0,5,1111,19.0,843.0,843.0
0.001,17,2,136,1,60,0.0,32.0,32.0,1,76,0.0,48.0,48.0
0.095,6,10,1506,5,395,21.0,127.0,127.0,5,1111,19.0,843.0,843.0
11.182,17,28,4421,14,1994,847.0,269.0,114.0,14,2427,847.0,586.0,145.0
0.097,6,10,1506,5,395,23.0,127.0,127.0,5,1111,23.0,843.0,843.0
0.088,6,10,1506,5,395,19.0,127.0,127.0,5,1111,18.0,843.0,843.0
0.011,6,10,1989,5,910,2.0,642.0,642.0,5,1079,2.0,811.0,811.0
0.115,6,10,1506,5,395,26.0,127.0,127.0,5,1111,25.0,843.0,843.0
0.001,17,2,166,1,75,0.0,47.0,47.0,1,91,0.0,63.0,63.0
1768.926,17,92,8096,46,4048,39309.0,60.0,60.0,46,4048,39309.0,60.0,60.0
0.021,6,10,1972,5,910,5.0,642.0,642.0,5,1062,5.0,794.0,794.0
15.071,17,14,9190,8,6902,2149.0,1350.0,834.0,6,2288,3008.0,1350.0,353.0
165.036,6,24,9399,11,1575,73.0,794.0,367.0,13,7824,13742.0,1360.0,810.0
0.005,6,10,2007,5,928,1.0,660.0,660.0,5,1079,1.0,811.0,811.0
0.061,6,10,1506,5,395,13.0,127.0,127.0,5,1111,14.0,843.0,843.0
0.121,6,10,1506,5,395,25.0,127.0,127.0,5,1111,27.0,843.0,843.0
0.074,6,10,1506,5,395,17.0,127.0,127.0,5,1111,16.0,843.0,843.0
0.004,6,10,2006,5,927,1.0,659.0,659.0,5,1079,1.0,811.0,811.0
0.009,6,10,1972,5,910,2.0,642.0,642.0,5,1062,2.0,794.0,794.0
0.005,17,2,179,1,71,0.0,43.0,43.0,1,108,0.0,80.0,80.0
0.01,6,10,1990,5,911,2.0,643.0,643.0,5,1079,2.0,811.0,811.0
0.006,17,2,214,1,75,0.0,47.0,47.0,1,139,0.0,111.0,111.0
0.038,17,4,284,2,120,0.0,32.0,32.0,2,164,34.0,60.0,54.0
0.009,6,10,1989,5,910,2.0,642.0,642.0,5,1079,2.0,811.0,811.0
0.005,6,10,2006,5,927,1.0,659.0,659.0,5,1079,1.0,811.0,811.0
0.01,6,10,1631,5,848,2.0,580.0,580.0,5,783,2.0,515.0,515.0
0.123,6,10,1506,5,395,28.0,127.0,127.0,5,1111,26.0,843.0,843.0
40.059,17,10,676,5,460,10013.0,104.0,64.0,5,216,10013.0,20.0,15.0
291.834,6,307,343693,122,17902,2411.0,2736.0,889.0,185,325791,1586.0,2769.0,1848.0
0.013,6,10,1631,5,848,3.0,580.0,580.0,5,783,3.0,515.0,515.0
0.006,17,2,214,1,75,0.0,47.0,47.0,1,139,0.0,111.0,111.0
300.037,6,12,1782,7,1348,50006.0,494.0,494.0,5,434,75008.0,83.0,83.0
0.086,6,10,1506,5,395,20.0,127.0,127.0,5,1111,19.0,843.0,843.0
0.133,6,10,1506,5,395,27.0,127.0,127.0,5,1111,30.0,843.0,843.0
0.006,6,12,1698,6,863,1.0,327.0,271.0,6,835,1.0,515.0,515.0
0.084,6,10,1506,5,395,17.0,127.0,127.0,5,1111,19.0,843.0,843.0
0.01,6,10,1972,5,910,2.0,642.0,642.0,5,1062,2.0,794.0,794.0
0.014,6,10,1990,5,911,3.0,643.0,643.0,5,1079,3.0,811.0,811.0
0.083,6,10,1506,5,395,20.0,127.0,127.0,5,1111,17.0,843.0,843.0
0.012,6,10,1983,5,910,2.0,642.0,642.0,5,1073,3.0,805.0,805.0
0.007,17,2,194,1,59,0.0,31.0,31.0,1,135,0.0,107.0,107.0
40.058,17,10,676,5,460,10013.0,104.0,64.0,5,216,10013.0,20.0,15.0
0.005,6,10,2007,5,928,1.0,660.0,660.0,5,1079,1.0,811.0,811.0
0.006,6,10,1547,5,764,1.0,496.0,496.0,5,783,1.0,515.0,515.0
0.01,6,12,1926,6,1189,2.0,659.0,434.0,6,737,1.0,417.0,417.0
11.558,17,28,4365,14,2311,876.0,586.0,137.0,14,2054,876.0,269.0,118.0
1.451,6,31,11714,16,2713,96.0,517.0,313.0,15,9001,103.0,1402.0,909.0
0.009,6,10,1631,5,848,2.0,580.0,580.0,5,783,2.0,515.0,515.0
11.309,17,27,4365,13,1937,929.0,269.0,121.0,14,2428,857.0,587.0,145.0
0.22,6,16,2777,8,1395,31.0,533.0,323.0,8,1382,20.0,529.0,239.0
0.006,6,10,1547,5,764,1.0,496.0,496.0,5,783,1.0,515.0,515.0
0.004,17,4,284,2,120,0.0,32.0,32.0,2,164,0.0,60.0,54.0
0.083,6,10,1506,5,395,19.0,127.0,127.0,5,1111,19.0,843.0,843.0
0.018,6,10,1972,5,910,4.0,642.0,642.0,5,1062,4.0,794.0,794.0
0.082,6,10,1506,5,395,20.0,127.0,127.0,5,1111,17.0,843.0,843.0
0.006,6,10,1547,5,764,1.0,496.0,496.0,5,783,1.0,515.0,515.0
0.01,6,10,1983,5,910,2.0,642.0,642.0,5,1073,2.0,805.0,805.0
0.016,6,10,1990,5,911,4.0,643.0,643.0,5,1079,3.0,811.0,811.0
0.01,6,10,1972,5,910,2.0,642.0,642.0,5,1062,2.0,794.0,794.0
368.81,6,22,2313,16,867,24587.0,195.0,195.0,6,1446,4635.0,419.0,398.0
0.005,17,2,166,1,75,0.0,47.0,47.0,1,91,0.0,63.0,63.0
0.007,6,10,1643,5,860,1.0,592.0,592.0,5,783,1.0,515.0,515.0
0.066,6,10,1506,5,395,14.0,127.0,127.0,5,1111,15.0,843.0,843.0
0.013,6,10,1972,5,910,3.0,642.0,642.0,5,1062,3.0,794.0,794.0
0.005,6,10,2007,5,928,1.0,660.0,660.0,5,1079,1.0,811.0,811.0
0.005,6,10,1547,5,764,1.0,496.0,496.0,5,783,1.0,515.0,515.0
0.116,6,10,1506,5,395,26.0,127.0,127.0,5,1111,28.0,843.0,843.0
287.88,6,37,17770,20,9442,7163.0,2720.0,955.0,17,8328,17982.0,2720.0,848.0
10.935,17,28,4424,14,1995,832.0,270.0,114.0,14,2429,832.0,588.0,145.0
0.005,6,10,1989,5,927,1.0,659.0,659.0,5,1062,1.0,794.0,794.0
0.008,6,10,2007,5,928,2.0,660.0,660.0,5,1079,1.0,811.0,811.0
0.013,6,10,1989,5,910,3.0,642.0,642.0,5,1079,3.0,811.0,811.0
300.776,6,39,12758,21,7240,15038.0,2720.0,1061.0,18,5518,505.0,2667.0,435.0
1756.066,6,105,6270,60,3525,29763.0,27.0,27.0,45,2745,39909.0,27.0,27.0
0.003,17,2,136,1,60,0.0,32.0,32.0,1,76,0.0,48.0,48.0
0.009,6,12,1926,6,1189,1.0,659.0,434.0,6,737,1.0,417.0,417.0
0.006,6,10,1547,5,764,1.0,496.0,496.0,5,783,1.0,515.0,515.0
0.044,17,2,186,1,61,0.0,33.0,33.0,1,125,0.0,97.0,97.0
240.708,6,35,8920,18,2070,14157.0,691.0,225.0,17,6850,15041.0,1402.0,597.0
0.006,6,10,1689,5,839,1.0,571.0,571.0,5,850,1.0,582.0,582.0
0.004,17,2,136,1,60,0.0,32.0,32.0,1,76,0.0,48.0,48.0
0.005,6,10,1779,5,928,1.0,660.0,660.0,5,851,1.0,583.0,583.0
0.004,6,10,2007,5,928,1.0,660.0,660.0,5,1079,1.0,811.0,811.0
0.009,17,4,284,2,120,6.0,32.0,32.0,2,164,5.0,60.0,54.0
0.005,6,10,1989,5,927,1.0,659.0,659.0,5,1062,1.0,794.0,794.0
353.691,6,20,2210,6,1308,12003.0,494.0,494.0,14,902,27206.0,83.0,83.0
0.081,6,10,1506,5,395,15.0,127.0,127.0,5,1111,19.0,843.0,843.0
0.013,6,10,1972,5,910,3.0,642.0,642.0,5,1062,3.0,794.0,794.0
0.007,17,2,136,1,60,0.0,32.0,32.0,1,76,0.0,48.0,48.0
0.007,6,10,1762,5,911,1.0,643.0,643.0,5,851,1.0,583.0,583.0
0.012,6,10,1972,5,910,3.0,642.0,642.0,5,1062,3.0,794.0,794.0
0.006,6,10,1689,5,839,1.0,571.0,571.0,5,850,1.0,582.0,582.0
0.074,6,10,1506,5,395,17.0,127.0,127.0,5,1111,13.0,843.0,843.0
0.004,6,10,2000,5,927,1.0,659.0,659.0,5,1073,1.0,805.0,805.0
0.019,6,10,1990,5,911,4.0,643.0,643.0,5,1079,4.0,811.0,811.0
25.621,6,56,27946,30,21879,318.0,2720.0,1376.0,26,6067,1018.0,2667.0,385.0
0.017,6,10,1989,5,910,4.0,642.0,642.0,5,1079,4.0,811.0,811.0
0.008,6,10,1972,5,910,1.0,642.0,642.0,5,1062,2.0,794.0,794.0
0.004,6,10,1774,5,923,1.0,655.0,655.0,5,851,1.0,583.0,583.0
0.01,6,10,2006,5,927,2.0,659.0,659.0,5,1079,2.0,811.0,811.0
0.015,6,10,1983,5,910,3.0,642.0,642.0,5,1073,3.0,805.0,805.0
0.005,6,10,2006,5,927,1.0,659.0,659.0,5,1079,1.0,811.0,811.0
0.014,6,10,1989,5,910,3.0,642.0,642.0,5,1079,3.0,811.0,811.0
0.005,17,2,170,1,65,0.0,37.0,37.0,1,105,0.0,77.0,77.0
0.004,6,10,1779,5,928,1.0,660.0,660.0,5,851,1.0,583.0,583.0
0.07,6,10,1506,5,395,16.0,127.0,127.0,5,1111,14.0,843.0,843.0
0.06,17,2,80,1,32,0.0,4.0,4.0,1,48,0.0,20.0,20.0
0.031,6,13,3816,7,578,5.0,206.0,206.0,6,3238,6.0,1470.0,1459.0
240.102,6,16,4482,9,963,30012.0,238.0,166.0,7,3519,40016.0,1402.0,786.0
0.023,6,10,1762,5,911,5.0,643.0,643.0,5,851,5.0,583.0,583.0
0.005,6,10,1643,5,860,1.0,592.0,592.0,5,783,1.0,515.0,515.0
0.015,6,10,1989,5,910,3.0,642.0,642.0,5,1079,3.0,811.0,811.0
352.009,6,20,2210,6,1308,12003.0,494.0,494.0,14,902,27077.0,83.0,83.0
0.011,6,10,1972,5,910,2.0,642.0,642.0,5,1062,2.0,794.0,794.0
0.009,6,10,1762,5,911,2.0,643.0,643.0,5,851,2.0,583.0,583.0
0.083,6,10,1506,5,395,19.0,127.0,127.0,5,1111,17.0,843.0,843.0
0.004,6,10,2000,5,927,1.0,659.0,659.0,5,1073,1.0,805.0,805.0
0.005,17,2,175,1,65,0.0,37.0,37.0,1,110,0.0,82.0,82.0
0.106,6,10,1506,5,395,25.0,127.0,127.0,5,1111,25.0,843.0,843.0
0.023,6,10,1989,5,910,5.0,642.0,642.0,5,1079,5.0,811.0,811.0
0.005,17,2,230,1,68,0.0,40.0,40.0,1,162,0.0,134.0,134.0
0.006,6,10,1547,5,764,1.0,496.0,496.0,5,783,1.0,515.0,515.0
0.015,6,10,1972,5,910,3.0,642.0,642.0,5,1062,3.0,794.0,794.0
0.072,6,10,1506,5,395,15.0,127.0,127.0,5,1111,15.0,843.0,843.0
0.013,17,2,152,1,56,0.0,28.0,28.0,1,96,0.0,68.0,68.0
0.018,6,10,1983,5,910,4.0,642.0,642.0,5,1073,4.0,805.0,805.0
0.004,6,10,2006,5,927,1.0,659.0,659.0,5,1079,1.0,811.0,811.0
0.035,6,10,1631,5,848,8.0,580.0,580.0,5,783,8.0,515.0,515.0
0.014,6,10,1989,5,910,3.0,642.0,642.0,5,1079,3.0,811.0,811.0
0.005,6,10,2007,5,928,1.0,660.0,660.0,5,1079,1.0,811.0,811.0
0.011,6,10,1972,5,910,2.0,642.0,642.0,5,1062,2.0,794.0,794.0
0.013,6,10,1989,5,910,3.0,642.0,642.0,5,1079,3.0,811.0,811.0
0.005,6,10,2007,5,928,1.0,660.0,660.0,5,1079,1.0,811.0,811.0
0.021,6,14,3787,7,497,3.0,125.0,125.0,7,3290,3.0,1448.0,972.0
0.004,6,10,2000,5,927,1.0,659.0,659.0,5,1073,1.0,805.0,805.0
0.001,17,2,180,1,66,0.0,38.0,38.0,1,114,0.0,86.0,86.0
0.084,6,10,1506,5,395,19.0,127.0,127.0,5,1111,19.0,843.0,843.0
0.078,6,10,1506,5,395,17.0,127.0,127.0,5,1111,18.0,843.0,843.0
0.005,6,10,2006,5,927,1.0,659.0,659.0,5,1079,1.0,811.0,811.0
0.004,6,14,3742,7,452,0.0,80.0,80.0,7,3290,0.0,1448.0,972.0
15.071,17,15,9239,8,6902,2149.0,1350.0,834.0,7,2337,2507.0,1350.0,305.0
0.004,17,2,136,1,60,0.0,32.0,32.0,1,76,0.0,48.0,48.0
15.079,17,19,9295,9,6776,1881.0,1350.0,724.0,10,2519,1672.0,1350.0,223.0
0.006,17,2,230,1,68,0.0,40.0,40.0,1,162,0.0,134.0,134.0
0.006,17,2,427,1,129,0.0,101.0,101.0,1,298,0.0,270.0,270.0
0.014,6,10,1972,5,910,3.0,642.0,642.0,5,1062,3.0,794.0,794.0
0.01,6,10,1983,5,910,2.0,642.0,642.0,5,1073,2.0,805.0,805.0
0.009,17,2,140,1,62,0.0,34.0,34.0,1,78,0.0,50.0,50.0
0.004,6,10,2006,5,927,1.0,659.0,659.0,5,1079,1.0,811.0,811.0
0.005,17,2,136,1,60,0.0,32.0,32.0,1,76,0.0,48.0,48.0
40.088,17,10,676,5,460,10021.0,104.0,64.0,5,216,10021.0,20.0,15.0
40.064,17,10,676,5,460,10015.0,104.0,64.0,5,216,10015.0,20.0,15.0
0.218,6,16,2669,8,1395,31.0,533.0,323.0,8,1274,20.0,529.0,212.0
0.005,17,2,166,1,75,0.0,47.0,47.0,1,91,0.0,63.0,63.0
280.309,6,23,6075,11,1226,28030.0,267.0,156.0,12,4849,25476.0,1400.0,873.0
0.005,6,10,2000,5,927,1.0,659.0,659.0,5,1073,1.0,805.0,805.0
0.057,6,10,1989,5,910,14.0,642.0,642.0,5,1079,14.0,811.0,811.0
0.015,6,10,1989,5,910,3.0,642.0,642.0,5,1079,3.0,811.0,811.0
0.074,6,10,1506,5,395,17.0,127.0,127.0,5,1111,16.0,843.0,843.0
240.012,6,9,787,5,488,60003.0,232.0,232.0,4,299,80003.0,83.0,83.0
1792.4,6,568,191681,296,165121,6075.0,2883.0,901.0,272,26560,6614.0,580.0,120.0
0.014,6,10,1990,5,911,3.0,643.0,643.0,5,1079,3.0,811.0,811.0
0.088,6,10,1506,5,395,20.0,127.0,127.0,5,1111,19.0,843.0,843.0
0.006,6,10,1547,5,764,1.0,496.0,496.0,5,783,1.0,515.0,515.0
0.129,17,2,80,1,32,0.0,4.0,4.0,1,48,0.0,20.0,20.0
0.005,6,10,2007,5,928,1.0,660.0,660.0,5,1079,1.0,811.0,811.0
367.121,6,22,2313,16,867,24474.0,195.0,195.0,6,1446,4635.0,419.0,398.0
0.005,6,10,1779,5,928,1.0,660.0,660.0,5,851,1.0,583.0,583.0
0.011,6,10,1989,5,910,2.0,642.0,642.0,5,1079,2.0,811.0,811.0
0.019,6,10,1990,5,911,4.0,643.0,643.0,5,1079,4.0,811.0,811.0
0.004,6,10,1989,5,927,1.0,659.0,659.0,5,1062,1.0,794.0,794.0
0.074,6,10,1506,5,395,15.0,127.0,127.0,5,1111,15.0,843.0,843.0
0.018,6,10,1983,5,910,4.0,642.0,642.0,5,1073,4.0,805.0,805.0
40.054,17,10,676,5,460,10012.0,104.0,64.0,5,216,10012.0,20.0,15.0
0.038,6,10,1990,5,911,9.0,643.0,643.0,5,1079,9.0,811.0,811.0
0.009,6,10,2006,5,927,2.0,659.0,659.0,5,1079,2.0,811.0,811.0
0.006,6,10,1547,5,764,1.0,496.0,496.0,5,783,1.0,515.0,515.0
0.099,6,10,1506,5,395,23.0,127.0,127.0,5,1111,21.0,843.0,843.0
0.116,6,10,1506,5,395,28.0,127.0,127.0,5,1111,28.0,843.0,843.0
0.009,6,13,3735,7,497,1.0,125.0,125.0,6,3238,1.0,1470.0,1459.0
0.015,6,10,1972,5,910,3.0,642.0,642.0,5,1062,3.0,794.0,794.0
0.006,6,10,2000,5,927,1.0,659.0,659.0,5,1073,1.0,805.0,805.0
0.085,6,10,1506,5,395,18.0,127.0,127.0,5,1111,17.0,843.0,843.0
0.016,6,10,1972,5,910,4.0,642.0,642.0,5,1062,4.0,794.0,794.0
10.912,17,28,4423,14,1994,830.0,269.0,114.0,14,2429,830.0,588.0,145.0
0.005,6,10,2006,5,927,1.0,659.0,659.0,5,1079,1.0,811.0,811.0
40.059,17,10,676,5,460,10013.0,104.0,64.0,5,216,10014.0,20.0,15.0
0.138,6,10,1506,5,395,32.0,127.0,127.0,5,1111,31.0,843.0,843.0
40.054,17,10,676,5,460,10012.0,104.0,64.0,5,216,10012.0,20.0,15.0
0.038,17,2,186,1,61,0.0,33.0,33.0,1,125,0.0,97.0,97.0
0.005,6,10,1989,5,927,1.0,659.0,659.0,5,1062,1.0,794.0,794.0
0.037,6,10,1762,5,911,9.0,643.0,643.0,5,851,9.0,583.0,583.0
0.004,6,10,2006,5,927,1.0,659.0,659.0,5,1079,1.0,811.0,811.0
0.079,6,10,1506,5,395,16.0,127.0,127.0,5,1111,15.0,843.0,843.0
353.628,6,19,2158,6,1308,12005.0,494.0,494.0,13,850,29468.0,83.0,83.0
0.004,6,14,3742,7,452,0.0,80.0,80.0,7,3290,0.0,1448.0,972.0
0.007,17,2,179,1,71,0.0,43.0,43.0,1,108,0.0,80.0,80.0
0.005,6,10,2006,5,927,1.0,659.0,659.0,5,1079,1.0,811.0,811.0
0.081,6,10,1506,5,395,19.0,127.0,127.0,5,1111,17.0,843.0,843.0
0.005,6,10,1989,5,927,1.0,659.0,659.0,5,1062,1.0,794.0,794.0
0.006,17,2,164,1,74,0.0,46.0,46.0,1,90,0.0,62.0,62.0
0.005,6,10,2007,5,928,1.0,660.0,660.0,5,1079,1.0,811.0,811.0
0.004,6,10,1702,5,863,1.0,595.0,595.0,5,839,1.0,571.0,571.0
0.006,6,10,1643,5,860,1.0,592.0,592.0,5,783,1.0,515.0,515.0
0.003,17,4,284,2,120,0.0,32.0,32.0,2,164,0.0,60.0,54.0
0.123,6,10,1506,5,395,27.0,127.0,127.0,5,1111,21.0,843.0,843.0
40.057,17,10,676,5,460,10013.0,104.0,64.0,5,216,10013.0,20.0,15.0
0.009,6,10,1547,5,764,2.0,496.0,496.0,5,783,2.0,515.0,515.0
0.004,17,2,148,1,60,0.0,32.0,32.0,1,88,0.0,60.0,60.0
0.004,6,10,1774,5,923,1.0,655.0,655.0,5,851,1.0,583.0,583.0
0.075,6,10,1506,5,395,15.0,127.0,127.0,5,1111,18.0,843.0,843.0
0.0,17,2,136,1,60,0.0,32.0,32.0,1,76,0.0,48.0,48.0
0.012,6,10,1983,5,910,3.0,642.0,642.0,5,1073,3.0,805.0,805.0
0.013,6,10,1631,5,848,3.0,580.0,580.0,5,783,3.0,515.0,515.0
0.01,6,10,1762,5,911,2.0,643.0,643.0,5,851,2.0,583.0,583.0
0.128,6,10,1506,5,395,26.0,127.0,127.0,5,1111,25.0,843.0,843.0
0.006,6,10,1643,5,860,1.0,592.0,592.0,5,783,1.0,515.0,515.0
0.006,6,10,1547,5,764,1.0,496.0,496.0,5,783,1.0,515.0,515.0
0.072,17,2,412,1,61,0.0,33.0,33.0,1,351,0.0,323.0,323.0
15.074,17,14,9191,8,6902,2149.0,1350.0,834.0,6,2289,3009.0,1350.0,353.0
0.024,6,10,1677,5,827,6.0,559.0,559.0,5,850,5.0,582.0,582.0
0.004,17,2,230,1,68,0.0,40.0,40.0,1,162,0.0,134.0,134.0
0.005,6,10,1689,5,839,1.0,571.0,571.0,5,850,1.0,582.0,582.0
0.09,6,10,1506,5,395,18.0,127.0,127.0,5,1111,18.0,843.0,843.0
0.005,6,10,2000,5,927,1.0,659.0,659.0,5,1073,1.0,805.0,805.0
0.127,6,10,1506,5,395,27.0,127.0,127.0,5,1111,26.0,843.0,843.0
40.062,17,10,676,5,460,10014.0,104.0,64.0,5,216,10014.0,20.0,15.0
0.005,6,14,3742,8,504,0.0,80.0,80.0,6,3238,0.0,1470.0,1459.0
0.006,6,10,1547,5,764,1.0,496.0,496.0,5,783,1.0,515.0,515.0
0.071,6,10,1506,5,395,16.0,127.0,127.0,5,1111,15.0,843.0,843.0
0.005,6,13,3747,7,509,0.0,137.0,137.0,6,3238,1.0,1470.0,1459.0
0.004,6,13,3747,7,509,0.0,137.0,137.0,6,3238,0.0,1470.0,1459.0
0.076,6,10,1506,5,395,17.0,127.0,127.0,5,1111,18.0,843.0,843.0
9.037,17,6,376,5,280,2259.0,28.0,28.0,1,96,0.0,68.0,68.0
40.068,17,10,676,5,460,10013.0,104.0,64.0,5,216,10016.0,20.0,15.0
0.086,6,10,1506,5,395,18.0,127.0,127.0,5,1111,20.0,843.0,843.0
0.014,6,10,1989,5,910,3.0,642.0,642.0,5,1079,3.0,811.0,811.0
40.062,17,10,676,5,460,10013.0,104.0,64.0,5,216,10014.0,20.0,15.0
40.083,17,10,676,5,460,10020.0,104.0,64.0,5,216,10020.0,20.0,15.0
0.008,6,10,1983,5,910,2.0,642.0,642.0,5,1073,2.0,805.0,805.0
0.004,6,10,1779,5,928,1.0,660.0,660.0,5,851,1.0,583.0,583.0
0.006,6,10,1547,5,764,1.0,496.0,496.0,5,783,1.0,515.0,515.0
0.011,6,10,1989,5,910,2.0,642.0,642.0,5,1079,2.0,811.0,811.0
0.001,17,2,180,1,66,0.0,38.0,38.0,1,114,0.0,86.0,86.0
240.129,6,39,7008,19,3335,13340.0,880.0,334.0,20,3673,12637.0,1306.0,328.0
40.073,17,10,676,5,460,10017.0,104.0,64.0,5,216,10017.0,20.0,15.0
0.005,6,10,2007,5,928,1.0,660.0,660.0,5,1079,1.0,811.0,811.0
0.004,6,10,1989,5,927,1.0,659.0,659.0,5,1062,1.0,794.0,794.0
0.074,6,10,1506,5,395,17.0,127.0,127.0,5,1111,17.0,843.0,843.0
308.412,17,20,1124,10,716,34254.0,48.0,43.0,10,408,34254.0,20.0,12.0
40.054,17,10,676,5,460,10012.0,104.0,64.0,5,216,10012.0,20.0,15.0
0.092,6,10,1506,5,395,19.0,127.0,127.0,5,1111,20.0,843.0,843.0
0.014,6,10,1989,5,910,3.0,642.0,642.0,5,1079,3.0,811.0,811.0
40.063,17,10,676,5,460,10014.0,104.0,64.0,5,216,10015.0,20.0,15.0
0.005,6,10,1779,5,928,1.0,660.0,660.0,5,851,1.0,583.0,583.0
0.004,6,10,2000,5,927,1.0,659.0,659.0,5,1073,1.0,805.0,805.0
0.009,6,12,1926,6,1189,1.0,659.0,434.0,6,737,1.0,417.0,417.0
15.074,17,14,9191,8,6902,2149.0,1350.0,834.0,6,2289,3008.0,1350.0,353.0
0.072,17,4,336,2,124,0.0,34.0,34.0,2,212,31.0,84.0,78.0
40.055,17,10,676,5,460,10012.0,104.0,64.0,5,216,10013.0,20.0,15.0
0.009,6,10,1989,5,910,2.0,642.0,642.0,5,1079,2.0,811.0,811.0
0.015,17,2,180,1,66,0.0,38.0,38.0,1,114,0.0,86.0,86.0
0.005,17,2,179,1,71,0.0,43.0,43.0,1,108,0.0,80.0,80.0
0.019,6,10,1983,5,910,4.0,642.0,642.0,5,1073,4.0,805.0,805.0
0.215,17,16,9512,8,6908,30.0,1350.0,835.0,8,2604,21.0,1350.0,297.0
0.004,6,10,2000,5,927,1.0,659.0,659.0,5,1073,1.0,805.0,805.0
0.005,6,13,3747,7,509,0.0,137.0,137.0,6,3238,0.0,1470.0,1459.0
0.114,6,10,1506,5,395,24.0,127.0,127.0,5,1111,23.0,843.0,843.0
0.071,6,10,1506,5,395,15.0,127.0,127.0,5,1111,16.0,843.0,843.0
0.005,6,10,2000,5,927,1.0,659.0,659.0,5,1073,1.0,805.0,805.0
0.005,6,10,2006,5,927,1.0,659.0,659.0,5,1079,1.0,811.0,811.0
0.018,6,10,1762,5,911,4.0,643.0,643.0,5,851,4.0,583.0,583.0
0.006,6,10,1689,5,839,1.0,571.0,571.0,5,850,1.0,582.0,582.0
0.008,6,10,1972,5,910,2.0,642.0,642.0,5,1062,2.0,794.0,794.0
0.009,6,10,1972,5,910,2.0,642.0,642.0,5,1062,2.0,794.0,794.0
0.745,6,26,5499,12,1557,57.0,325.0,152.0,14,3942,48.0,1414.0,563.0
0.004,6,10,1989,5,927,1.0,659.0,659.0,5,1062,1.0,794.0,794.0
0.004,6,10,1774,5,923,1.0,655.0,655.0,5,851,1.0,583.0,583.0
1778.193,17,144,41760,72,22752,25044.0,288.0,288.0,72,19008,25044.0,236.0,236.0
0.007,6,10,1989,5,910,1.0,642.0,642.0,5,1079,1.0,811.0,811.0
0.006,6,10,1547,5,764,1.0,496.0,496.0,5,783,1.0,515.0,515.0
0.148,6,10,1506,5,395,25.0,127.0,127.0,5,1111,35.0,843.0,843.0
0.076,6,10,1506,5,395,16.0,127.0,127.0,5,1111,16.0,843.0,843.0
0.001,17,2,180,1,66,0.0,38.0,38.0,1,114,0.0,86.0,86.0
0.001,17,2,180,1,66,0.0,38.0,38.0,1,114,0.0,86.0,86.0
0.004,6,10,1702,5,863,1.0,595.0,595.0,5,839,1.0,571.0,571.0
0.015,6,10,1990,5,911,3.0,643.0,643.0,5,1079,3.0,811.0,811.0
0.004,6,10,1702,5,863,0.0,595.0,595.0,5,839,1.0,571.0,571.0
0.072,6,10,1506,5,395,15.0,127.0,127.0,5,1111,17.0,843.0,843.0
172.146,17,74,10623,37,2474,4781.0,44.0,38.0,37,8149,4781.0,239.0,192.0
0.073,6,10,1506,5,395,16.0,127.0,127.0,5,1111,16.0,843.0,843.0
0.006,6,10,2006,5,927,1.0,659.0,659.0,5,1079,1.0,811.0,811.0
310.137,17,20,1124,10,716,34449.0,48.0,43.0,10,408,34449.0,20.0,12.0
0.037,17,2,412,1,61,0.0,33.0,33.0,1,351,0.0,323.0,323.0
0.085,6,10,1506,5,395,18.0,127.0,127.0,5,1111,19.0,843.0,843.0
0.004,6,10,2006,5,927,1.0,659.0,659.0,5,1079,1.0,811.0,811.0
0.076,17,8,3613,4,1874,25.0,1350.0,440.0,4,1739,11.0,1350.0,406.0
0.003,17,2,148,1,60,0.0,32.0,32.0,1,88,0.0,60.0,60.0
0.004,6,10,2006,5,927,1.0,659.0,659.0,5,1079,1.0,811.0,811.0
0.072,17,2,412,1,61,0.0,33.0,33.0,1,351,0.0,323.0,323.0
0.016,6,10,1989,5,910,4.0,642.0,642.0,5,1079,3.0,811.0,811.0
0.001,17,2,140,1,62,0.0,34.0,34.0,1,78,0.0,50.0,50.0
0.012,6,10,1989,5,910,2.0,642.0,642.0,5,1079,2.0,811.0,811.0
0.013,6,10,1972,5,910,3.0,642.0,642.0,5,1062,3.0,794.0,794.0
0.101,6,10,1506,5,395,23.0,127.0,127.0,5,1111,16.0,843.0,843.0
0.142,6,10,1506,5,395,34.0,127.0,127.0,5,1111,30.0,843.0,843.0
0.088,6,10,1506,5,395,20.0,127.0,127.0,5,1111,21.0,843.0,843.0
0.101,6,10,1506,5,395,23.0,127.0,127.0,5,1111,23.0,843.0,843.0
40.054,17,10,676,5,460,10012.0,104.0,64.0,5,216,10012.0,20.0,15.0
0.009,6,10,1983,5,910,2.0,642.0,642.0,5,1073,2.0,805.0,805.0
300.391,6,29,10774,16,2099,20026.0,585.0,314.0,13,8675,20029.0,1402.0,998.0
0.083,6,10,1506,5,395,17.0,127.0,127.0,5,1111,18.0,843.0,843.0
0.001,17,2,180,1,66,0.0,38.0,38.0,1,114,0.0,86.0,86.0
0.014,6,10,1762,5,911,3.0,643.0,643.0,5,851,3.0,583.0,583.0
0.005,6,10,2000,5,927,1.0,659.0,659.0,5,1073,1.0,805.0,805.0
0.004,6,10,1989,5,927,1.0,659.0,659.0,5,1062,1.0,794.0,794.0
0.004,17,2,148,1,60,0.0,32.0,32.0,1,88,0.0,60.0,60.0
0.006,6,10,1689,5,839,1.0,571.0,571.0,5,850,1.0,582.0,582.0
0.01,6,10,1989,5,910,2.0,642.0,642.0,5,1079,2.0,811.0,811.0
0.022,6,10,1990,5,911,5.0,643.0,643.0,5,1079,5.0,811.0,811.0
240.1,6,16,4481,9,963,30012.0,238.0,166.0,7,3518,40015.0,1402.0,786.0
0.014,6,10,1990,5,911,3.0,643.0,643.0,5,1079,3.0,811.0,811.0
0.005,6,10,2006,5,927,1.0,659.0,659.0,5,1079,1.0,811.0,811.0
0.001,17,2,179,1,62,0.0,34.0,34.0,1,117,0.0,89.0,89.0
40.061,17,10,676,5,460,10014.0,104.0,64.0,5,216,10014.0,20.0,15.0
0.014,6,10,1989,5,910,3.0,642.0,642.0,5,1079,3.0,811.0,811.0
0.012,6,10,1972,5,910,3.0,642.0,642.0,5,1062,2.0,794.0,794.0
0.004,6,10,2007,5,928,1.0,660.0,660.0,5,1079,1.0,811.0,811.0
0.004,6,10,2007,5,928,1.0,660.0,660.0,5,1079,1.0,811.0,811.0
0.005,6,14,3742,7,452,0.0,80.0,80.0,7,3290,0.0,1448.0,972.0
0.014,6,10,1989,5,910,3.0,642.0,642.0,5,1079,3.0,811.0,811.0
0.005,17,2,170,1,65,0.0,37.0,37.0,1,105,0.0,77.0,77.0
0.005,17,2,222,1,65,0.0,37.0,37.0,1,157,0.0,129.0,129.0
241.379,6,386,346987,185,21143,1311.0,2736.0,959.0,201,325844,1206.0,2804.0,1651.0
0.005,6,10,2006,5,927,1.0,659.0,659.0,5,1079,1.0,811.0,811.0
0.005,6,10,2007,5,928,1.0,660.0,660.0,5,1079,1.0,811.0,811.0
0.005,6,10,2006,5,927,1.0,659.0,659.0,5,1079,1.0,811.0,811.0
0.006,17,2,164,1,74,0.0,46.0,46.0,1,90,0.0,62.0,62.0
6.081,6,26,12117,14,1040,467.0,304.0,304.0,12,11077,552.0,1402.0,1160.0
0.013,6,10,2006,5,927,3.0,659.0,659.0,5,1079,3.0,811.0,811.0
352.569,6,20,2210,6,1308,12003.0,494.0,494.0,14,902,27120.0,83.0,83.0
0.009,6,10,1631,5,848,2.0,580.0,580.0,5,783,2.0,515.0,515.0
0.011,6,10,1989,5,910,2.0,642.0,642.0,5,1079,2.0,811.0,811.0
0.02,6,10,1989,5,910,5.0,642.0,642.0,5,1079,4.0,811.0,811.0
0.008,6,13,3735,7,497,1.0,125.0,125.0,6,3238,1.0,1470.0,1459.0
0.007,6,10,1989,5,910,1.0,642.0,642.0,5,1079,1.0,811.0,811.0
0.007,6,10,1547,5,764,1.0,496.0,496.0,5,783,1.0,515.0,515.0
0.009,6,10,1972,5,910,2.0,642.0,642.0,5,1062,2.0,794.0,794.0
0.041,17,2,182,1,65,0.0,37.0,37.0,1,117,0.0,89.0,89.0
0.004,17,2,136,1,60,0.0,32.0,32.0,1,76,0.0,48.0,48.0
0.077,6,10,1506,5,395,16.0,127.0,127.0,5,1111,17.0,843.0,843.0
0.006,6,13,3690,7,452,1.0,80.0,80.0,6,3238,1.0,1470.0,1459.0
0.008,6,10,1972,5,910,2.0,642.0,642.0,5,1062,1.0,794.0,794.0
0.135,6,10,1506,5,395,29.0,127.0,127.0,5,1111,33.0,843.0,843.0
0.082,6,10,1506,5,395,18.0,127.0,127.0,5,1111,15.0,843.0,843.0
0.005,6,10,2006,5,927,1.0,659.0,659.0,5,1079,1.0,811.0,811.0
0.006,17,2,170,1,65,0.0,37.0,37.0,1,105,0.0,77.0,77.0
0.018,6,13,3735,7,497,2.0,125.0,125.0,6,3238,3.0,1470.0,1459.0
0.245,6,16,2777,8,1395,35.0,533.0,323.0,8,1382,22.0,529.0,239.0
56.41,58,5,360,4,288,18803.0,24.0,24.0,1,72,0.0,24.0,24.0
0.063,6,10,1506,5,395,14.0,127.0,127.0,5,1111,14.0,843.0,843.0
0.005,17,2,144,1,64,0.0,36.0,36.0,1,80,0.0,52.0,52.0
0.11,6,10,1506,5,395,24.0,127.0,127.0,5,1111,25.0,843.0,843.0
240.248,6,43,5786,20,2730,12644.0,588.0,207.0,23,3056,10920.0,580.0,204.0
0.041,6,10,1989,5,910,10.0,642.0,642.0,5,1079,10.0,811.0,811.0
0.016,6,10,1989,5,910,3.0,642.0,642.0,5,1079,4.0,811.0,811.0
0.013,6,10,1677,5,827,3.0,559.0,559.0,5,850,3.0,582.0,582.0
10.886,17,28,4423,14,1994,828.0,269.0,114.0,14,2429,828.0,588.0,145.0
0.003,17,4,284,2,120,0.0,32.0,32.0,2,164,0.0,60.0,54.0
0.114,6,10,1506,5,395,21.0,127.0,127.0,5,1111,24.0,843.0,843.0
0.008,6,10,1990,5,911,2.0,643.0,643.0,5,1079,2.0,811.0,811.0
0.005,6,10,1779,5,928,1.0,660.0,660.0,5,851,1.0,583.0,583.0
0.007,17,2,140,1,62,0.0,34.0,34.0,1,78,0.0,50.0,50.0
0.012,6,10,1983,5,910,2.0,642.0,642.0,5,1073,3.0,805.0,805.0
0.005,6,10,2006,5,927,1.0,659.0,659.0,5,1079,1.0,811.0,811.0
0.015,6,10,1990,5,911,3.0,643.0,643.0,5,1079,3.0,811.0,811.0
0.039,17,4,284,2,120,0.0,32.0,32.0,2,164,35.0,60.0,54.0
174.555,17,84,11832,42,2805,4257.0,44.0,38.0,42,9027,4257.0,261.0,186.0
0.015,6,10,1983,5,910,3.0,642.0,642.0,5,1073,3.0,805.0,805.0
0.073,6,10,1506,5,395,17.0,127.0,127.0,5,1111,18.0,843.0,843.0
0.023,6,10,1990,5,911,5.0,643.0,643.0,5,1079,5.0,811.0,811.0
0.015,6,10,1990,5,911,3.0,643.0,643.0,5,1079,3.0,811.0,811.0
15.081,17,17,10006,9,7717,1881.0,1350.0,829.0,8,2289,2150.0,1350.0,258.0
0.112,6,10,1506,5,395,21.0,127.0,127.0,5,1111,24.0,843.0,843.0
0.077,6,10,1506,5,395,16.0,127.0,127.0,5,1111,17.0,843.0,843.0
1718.226,6,61,7138,40,4347,44057.0,1640.0,113.0,21,2791,85902.0,1110.0,84.0
0.005,6,10,2007,5,928,1.0,660.0,660.0,5,1079,1.0,811.0,811.0
0.008,6,10,1983,5,910,2.0,642.0,642.0,5,1073,2.0,805.0,805.0
0.084,6,10,1506,5,395,20.0,127.0,127.0,5,1111,17.0,843.0,843.0
0.019,6,10,1989,5,910,4.0,642.0,642.0,5,1079,4.0,811.0,811.0
0.006,6,10,2007,5,928,1.0,660.0,660.0,5,1079,1.0,811.0,811.0
0.013,6,10,1990,5,911,3.0,643.0,643.0,5,1079,3.0,811.0,811.0
0.012,6,10,1989,5,910,3.0,642.0,642.0,5,1079,3.0,811.0,811.0
0.016,6,10,1983,5,910,3.0,642.0,642.0,5,1073,4.0,805.0,805.0
0.004,6,14,3742,7,452,0.0,80.0,80.0,7,3290,0.0,1448.0,972.0
240.244,6,31,7560,17,5434,15015.0,1368.0,506.0,14,2126,18479.0,580.0,198.0
0.004,17,2,148,1,60,0.0,32.0,32.0,1,88,0.0,60.0,60.0
0.005,6,10,2006,5,927,1.0,659.0,659.0,5,1079,1.0,811.0,811.0
0.005,6,10,2006,5,927,1.0,659.0,659.0,5,1079,1.0,811.0,811.0
240.089,6,16,4482,9,963,30011.0,238.0,166.0,7,3519,40014.0,1402.0,786.0
0.169,17,2,152,1,76,0.0,48.0,48.0,1,76,0.0,48.0,48.0
11.179,17,28,4423,14,1994,847.0,269.0,114.0,14,2429,847.0,588.0,145.0
0.004,6,10,2007,5,928,1.0,660.0,660.0,5,1079,1.0,811.0,811.0
0.001,17,2,180,1,66,0.0,38.0,38.0,1,114,0.0,86.0,86.0
0.006,6,13,3684,7,446,1.0,74.0,74.0,6,3238,1.0,1470.0,1459.0
0.005,6,10,1689,5,839,1.0,571.0,571.0,5,850,1.0,582.0,582.0
0.163,17,2,152,1,76,0.0,48.0,48.0,1,76,0.0,48.0,48.0
0.009,6,10,1972,5,910,2.0,642.0,642.0,5,1062,2.0,794.0,794.0
15.073,17,15,9238,8,6902,2149.0,1350.0,834.0,7,2336,2507.0,1350.0,305.0
0.006,6,10,1547,5,764,1.0,496.0,496.0,5,783,1.0,515.0,515.0
15.039,17,43,20506,23,17142,682.0,1350.0,717.0,20,3364,789.0,1350.0,140.0
0.014,6,10,1762,5,911,3.0,643.0,643.0,5,851,3.0,583.0,583.0
0.113,6,10,1506,5,395,22.0,127.0,127.0,5,1111,24.0,843.0,843.0
0.221,6,16,2670,8,1396,31.0,533.0,324.0,8,1274,20.0,529.0,212.0
242.135,6,310,343146,118,17642,2069.0,2736.0,959.0,192,325504,1267.0,2804.0,1733.0
300.187,6,27,7436,16,1409,20012.0,217.0,142.0,11,6027,24018.0,1679.0,778.0
0.111,6,10,1506,5,395,21.0,127.0,127.0,5,1111,22.0,843.0,843.0
173.21,17,80,11632,40,2689,4441.0,44.0,39.0,40,8943,4441.0,261.0,195.0
0.01,6,10,1990,5,911,2.0,643.0,643.0,5,1079,2.0,811.0,811.0
0.064,6,10,1506,5,395,14.0,127.0,127.0,5,1111,15.0,843.0,843.0
0.005,17,2,179,1,71,0.0,43.0,43.0,1,108,0.0,80.0,80.0
0.005,6,10,2007,5,928,1.0,660.0,660.0,5,1079,1.0,811.0,811.0
0.013,6,10,1990,5,911,3.0,643.0,643.0,5,1079,3.0,811.0,811.0
0.01,6,10,1989,5,910,2.0,642.0,642.0,5,1079,2.0,811.0,811.0
0.006,6,10,1689,5,839,1.0,571.0,571.0,5,850,1.0,582.0,582.0
0.004,6,10,2006,5,927,1.0,659.0,659.0,5,1079,1.0,811.0,811.0
0.099,6,10,1506,5,395,20.0,127.0,127.0,5,1111,19.0,843.0,843.0
0.005,17,2,140,1,62,0.0,34.0,34.0,1,78,0.0,50.0,50.0
40.049,17,10,676,5,460,10009.0,104.0,64.0,5,216,10011.0,20.0,15.0
0.086,6,10,1506,5,395,19.0,127.0,127.0,5,1111,18.0,843.0,843.0
0.016,17,2,152,1,56,0.0,28.0,28.0,1,96,0.0,68.0,68.0
0.016,6,14,3787,8,549,2.0,125.0,125.0,6,3238,3.0,1470.0,1459.0
0.088,6,10,1506,5,395,19.0,127.0,127.0,5,1111,21.0,843.0,843.0
40.096,17,10,676,5,460,10023.0,104.0,64.0,5,216,10023.0,20.0,15.0
0.024,6,10,1989,5,910,5.0,642.0,642.0,5,1079,6.0,811.0,811.0
0.015,6,10,1631,5,848,3.0,580.0,580.0,5,783,3.0,515.0,515.0
1783.225,6,64,7344,42,4469,43493.0,1625.0,108.0,22,2875,84907.0,1111.0,82.0
0.017,17,2,198,1,91,0.0,63.0,63.0,1,107,0.0,79.0,79.0
0.004,6,10,2006,5,927,1.0,659.0,659.0,5,1079,1.0,811.0,811.0
0.004,6,10,1774,5,923,1.0,655.0,655.0,5,851,1.0,583.0,583.0
0.073,6,10,1506,5,395,15.0,127.0,127.0,5,1111,16.0,843.0,843.0
0.126,17,4,596,2,122,0.0,33.0,33.0,2,474,54.0,323.0,209.0
0.011,6,10,1989,5,910,2.0,642.0,642.0,5,1079,2.0,811.0,811.0
0.103,6,10,1506,5,395,24.0,127.0,127.0,5,1111,20.0,843.0,843.0
0.04,17,2,412,1,61,0.0,33.0,33.0,1,351,0.0,323.0,323.0
0.012,6,10,1972,5,910,3.0,642.0,642.0,5,1062,2.0,794.0,794.0
0.008,6,12,1926,6,1189,1.0,659.0,434.0,6,737,1.0,417.0,417.0
0.005,17,2,146,1,65,0.0,37.0,37.0,1,81,0.0,53.0,53.0
0.009,6,10,1990,5,911,2.0,643.0,643.0,5,1079,2.0,811.0,811.0
0.005,6,10,1989,5,927,1.0,659.0,659.0,5,1062,1.0,794.0,794.0
0.01,17,2,222,1,65,0.0,37.0,37.0,1,157,0.0,129.0,129.0
240.178,6,27,4630,13,1880,20014.0,559.0,239.0,14,2750,18474.0,1214.0,253.0
0.003,17,2,136,1,60,0.0,32.0,32.0,1,76,0.0,48.0,48.0
0.796,6,10,937,6,427,159.0,107.0,107.0,4,510,177.0,294.0,294.0
0.04,17,2,136,1,60,0.0,32.0,32.0,1,76,0.0,48.0,48.0
240.281,6,21,4784,11,2274,24028.0,967.0,568.0,10,2510,26697.0,1162.0,396.0
15.076,17,19,9416,9,6728,1881.0,1350.0,719.0,10,2688,1671.0,1350.0,240.0
0.005,6,10,2006,5,927,1.0,659.0,659.0,5,1079,1.0,811.0,811.0
0.037,17,2,136,1,60,0.0,32.0,32.0,1,76,0.0,48.0,48.0
0.087,6,10,1506,5,395,20.0,127.0,127.0,5,1111,18.0,843.0,843.0
0.099,6,10,1506,5,395,22.0,127.0,127.0,5,1111,21.0,843.0,843.0
0.004,6,10,1779,5,928,1.0,660.0,660.0,5,851,1.0,583.0,583.0
0.01,6,13,3735,7,497,1.0,125.0,125.0,6,3238,1.0,1470.0,1459.0
0.016,6,10,1972,5,910,4.0,642.0,642.0,5,1062,3.0,794.0,794.0
0.148,6,10,1506,5,395,34.0,127.0,127.0,5,1111,34.0,843.0,843.0
0.016,17,2,198,1,91,0.0,63.0,63.0,1,107,0.0,79.0,79.0
0.005,6,10,2007,5,928,1.0,660.0,660.0,5,1079,1.0,811.0,811.0
0.008,6,10,1989,5,910,2.0,642.0,642.0,5,1079,1.0,811.0,811.0
0.076,6,10,1506,5,395,16.0,127.0,127.0,5,1111,16.0,843.0,843.0
0.006,6,10,1989,5,927,1.0,659.0,659.0,5,1062,1.0,794.0,794.0
0.001,17,2,180,1,66,0.0,38.0,38.0,1,114,0.0,86.0,86.0
0.006,6,10,1547,5,764,1.0,496.0,496.0,5,783,1.0,515.0,515.0
0.01,6,10,1990,5,911,2.0,643.0,643.0,5,1079,2.0,811.0,811.0
0.004,6,10,2006,5,927,1.0,659.0,659.0,5,1079,1.0,811.0,811.0
0.022,6,10,1983,5,910,5.0,642.0,642.0,5,1073,5.0,805.0,805.0
0.005,6,10,2006,5,927,1.0,659.0,659.0,5,1079,1.0,811.0,811.0
0.008,6,10,1631,5,848,2.0,580.0,580.0,5,783,2.0,515.0,515.0
354.011,6,21,1795,16,1030,23600.0,190.0,190.0,5,765,60002.0,464.0,248.0
0.01,6,10,1972,5,910,2.0,642.0,642.0,5,1062,2.0,794.0,794.0
0.005,17,2,230,1,68,0.0,40.0,40.0,1,162,0.0,134.0,134.0
15.072,17,15,9238,8,6902,2149.0,1350.0,834.0,7,2336,2507.0,1350.0,305.0
0.004,17,2,148,1,60,0.0,32.0,32.0,1,88,0.0,60.0,60.0
0.097,6,10,1506,5,395,19.0,127.0,127.0,5,1111,21.0,843.0,843.0
0.004,6,10,2000,5,927,1.0,659.0,659.0,5,1073,1.0,805.0,805.0
0.009,6,12,1926,6,1189,1.0,659.0,434.0,6,737,1.0,417.0,417.0
0.005,6,10,1547,5,764,1.0,496.0,496.0,5,783,1.0,515.0,515.0
0.006,6,10,1547,5,764,1.0,496.0,496.0,5,783,1.0,515.0,515.0
0.063,17,2,152,1,56,0.0,28.0,28.0,1,96,0.0,68.0,68.0
240.083,6,16,4481,9,963,30010.0,238.0,166.0,7,3518,40013.0,1402.0,786.0
0.013,6,10,1989,5,910,3.0,642.0,642.0,5,1079,3.0,811.0,811.0
0.008,6,10,1989,5,910,2.0,642.0,642.0,5,1079,2.0,811.0,811.0
0.009,6,10,1983,5,910,2.0,642.0,642.0,5,1073,2.0,805.0,805.0
0.04,17,2,148,1,60,0.0,32.0,32.0,1,88,0.0,60.0,60.0
46.107,6,40,10527,20,4929,471.0,1360.0,682.0,20,5598,2418.0,2667.0,435.0
10.817,17,28,4422,14,1994,823.0,269.0,114.0,14,2428,823.0,587.0,145.0
0.083,6,10,1506,5,395,17.0,127.0,127.0,5,1111,18.0,843.0,843.0
0.195,6,10,1506,5,395,47.0,127.0,127.0,5,1111,42.0,843.0,843.0
0.123,6,10,1506,5,395,28.0,127.0,127.0,5,1111,29.0,843.0,843.0
0.005,6,10,2000,5,927,1.0,659.0,659.0,5,1073,1.0,805.0,805.0
40.051,17,10,676,5,460,10012.0,104.0,64.0,5,216,10011.0,20.0,15.0
1741.814,6,305,97857,189,86578,9264.0,1402.0,673.0,116,11279,15146.0,452.0,70.0
0.004,6,10,2007,5,928,1.0,660.0,660.0,5,1079,1.0,811.0,811.0
0.089,6,10,1506,5,395,21.0,127.0,127.0,5,1111,19.0,843.0,843.0
0.164,17,2,152,1,76,0.0,48.0,48.0,1,76,0.0,48.0,48.0
0.006,17,2,170,1,65,0.0,37.0,37.0,1,105,0.0,77.0,77.0
0.122,6,10,1506,5,395,23.0,127.0,127.0,5,1111,26.0,843.0,843.0
0.005,6,10,1779,5,928,1.0,660.0,660.0,5,851,1.0,583.0,583.0
0.004,6,10,1774,5,923,1.0,655.0,655.0,5,851,1.0,583.0,583.0
0.004,6,10,1779,5,928,1.0,660.0,660.0,5,851,1.0,583.0,583.0
0.005,6,10,2006,5,927,1.0,659.0,659.0,5,1079,1.0,811.0,811.0
0.004,6,10,1702,5,863,1.0,595.0,595.0,5,839,1.0,571.0,571.0
0.011,6,10,1983,5,910,2.0,642.0,642.0,5,1073,2.0,805.0,805.0
0.099,6,10,1506,5,395,21.0,127.0,127.0,5,1111,22.0,843.0,843.0
0.007,6,10,1547,5,764,1.0,496.0,496.0,5,783,1.0,515.0,515.0
0.11,6,10,1506,5,395,23.0,127.0,127.0,5,1111,24.0,843.0,843.0
40.051,17,10,676,5,460,10012.0,104.0,64.0,5,216,10012.0,20.0,15.0
0.001,17,2,180,1,66,0.0,38.0,38.0,1,114,0.0,86.0,86.0
0.003,17,2,136,1,60,0.0,32.0,32.0,1,76,0.0,48.0,48.0
0.162,6,10,1506,5,395,34.0,127.0,127.0,5,1111,35.0,843.0,843.0
0.061,6,10,1506,5,395,14.0,127.0,127.0,5,1111,13.0,843.0,843.0
0.024,6,10,1989,5,910,6.0,642.0,642.0,5,1079,6.0,811.0,811.0
0.005,6,10,1547,5,764,1.0,496.0,496.0,5,783,1.0,515.0,515.0
0.009,6,10,1989,5,910,2.0,642.0,642.0,5,1079,2.0,811.0,811.0
0.067,6,10,1506,5,395,13.0,127.0,127.0,5,1111,15.0,843.0,843.0
0.001,17,2,136,1,60,0.0,32.0,32.0,1,76,0.0,48.0,48.0
0.005,6,10,2006,5,927,1.0,659.0,659.0,5,1079,1.0,811.0,811.0
11.242,17,28,4419,14,1994,852.0,269.0,114.0,14,2425,852.0,588.0,145.0
0.018,6,10,1972,5,910,4.0,642.0,642.0,5,1062,4.0,794.0,794.0
0.005,6,10,2006,5,927,1.0,659.0,659.0,5,1079,1.0,811.0,811.0
0.001,17,2,180,1,66,0.0,38.0,38.0,1,114,0.0,86.0,86.0
0.001,17,2,180,1,66,0.0,38.0,38.0,1,114,0.0,86.0,86.0
0.084,6,10,1506,5,395,19.0,127.0,127.0,5,1111,18.0,843.0,843.0
0.005,6,10,1854,5,889,1.0,621.0,621.0,5,965,1.0,697.0,697.0
0.062,17,2,80,1,32,0.0,4.0,4.0,1,48,0.0,20.0,20.0
0.073,6,10,1506,5,395,16.0,127.0,127.0,5,1111,14.0,843.0,843.0
0.011,6,10,1972,5,910,2.0,642.0,642.0,5,1062,2.0,794.0,794.0
0.08,6,10,1506,5,395,19.0,127.0,127.0,5,1111,18.0,843.0,843.0
0.01,6,12,1926,6,1189,2.0,659.0,434.0,6,737,2.0,417.0,417.0
0.081,6,10,1506,5,395,19.0,127.0,127.0,5,1111,14.0,843.0,843.0
0.005,6,10,1689,5,839,1.0,571.0,571.0,5,850,1.0,582.0,582.0
40.104,17,10,676,5,460,10023.0,104.0,64.0,5,216,10024.0,20.0,15.0
0.129,6,10,1506,5,395,30.0,127.0,127.0,5,1111,29.0,843.0,843.0
0.006,17,2,178,1,81,0.0,53.0,53.0,1,97,0.0,69.0,69.0
0.125,6,10,1506,5,395,26.0,127.0,127.0,5,1111,26.0,843.0,843.0
0.008,6,10,1762,5,911,1.0,643.0,643.0,5,851,1.0,583.0,583.0
0.052,17,4,284,2,120,0.0,32.0,32.0,2,164,40.0,60.0,54.0
0.007,6,10,2006,5,927,1.0,659.0,659.0,5,1079,1.0,811.0,811.0
15.082,17,15,9238,8,6902,2149.0,1350.0,834.0,7,2336,2508.0,1350.0,305.0
40.053,17,10,676,5,460,10012.0,104.0,64.0,5,216,10012.0,20.0,15.0
0.016,6,10,1989,5,910,4.0,642.0,642.0,5,1079,3.0,811.0,811.0
0.005,6,10,2000,5,927,1.0,659.0,659.0,5,1073,1.0,805.0,805.0
0.018,6,10,1677,5,827,4.0,559.0,559.0,5,850,4.0,582.0,582.0
0.072,6,10,1506,5,395,15.0,127.0,127.0,5,1111,15.0,843.0,843.0
0.022,6,10,1631,5,848,5.0,580.0,580.0,5,783,5.0,515.0,515.0
0.009,6,10,1989,5,910,2.0,642.0,642.0,5,1079,2.0,811.0,811.0
0.005,17,2,164,1,74,0.0,46.0,46.0,1,90,0.0,62.0,62.0
0.13,17,2,184,1,61,0.0,33.0,33.0,1,123,0.0,95.0,95.0
1747.23,6,64,7344,42,4469,42615.0,1625.0,108.0,22,2875,83193.0,1111.0,82.0
0.004,6,10,1774,5,923,1.0,655.0,655.0,5,851,1.0,583.0,583.0
0.101,6,207,228634,103,6489,0.0,517.0,280.0,104,222145,0.0,4206.0,2189.0
0.203,6,16,2669,8,1395,29.0,533.0,323.0,8,1274,18.0,529.0,212.0
0.025,6,10,1677,5,827,6.0,559.0,559.0,5,850,6.0,582.0,582.0
0.01,6,10,1983,5,910,2.0,642.0,642.0,5,1073,2.0,805.0,805.0
0.105,17,4,352,2,130,68.0,37.0,37.0,2,222,65.0,89.0,83.0
0.001,17,2,180,1,66,0.0,38.0,38.0,1,114,0.0,86.0,86.0
0.011,6,10,1631,5,848,2.0,580.0,580.0,5,783,2.0,515.0,515.0
0.008,6,10,1990,5,911,1.0,643.0,643.0,5,1079,2.0,811.0,811.0
0.227,17,14,7263,8,4076,32.0,1350.0,481.0,6,3187,34.0,1350.0,503.0
0.01,6,12,1926,6,1189,2.0,659.0,434.0,6,737,1.0,417.0,417.0
0.098,6,10,1506,5,395,22.0,127.0,127.0,5,1111,23.0,843.0,843.0
376.305,6,22,2313,16,867,25087.0,195.0,195.0,6,1446,4641.0,419.0,398.0
40.066,17,10,676,5,460,10014.0,104.0,64.0,5,216,10015.0,20.0,15.0
377.449,17,120,17244,60,4003,6397.0,44.0,38.0,60,13241,6397.0,239.0,192.0
0.004,17,4,284,2,120,0.0,32.0,32.0,2,164,1.0,60.0,54.0
309.412,17,18,1008,9,640,38660.0,48.0,43.0,9,368,38660.0,20.0,12.0
0.004,6,14,3742,8,504,0.0,80.0,80.0,6,3238,0.0,1470.0,1459.0
0.005,6,10,1854,5,889,1.0,621.0,621.0,5,965,1.0,697.0,697.0
0.005,6,10,1989,5,927,1.0,659.0,659.0,5,1062,1.0,794.0,794.0
1757.432,6,105,6270,60,3525,29786.0,27.0,27.0,45,2745,39940.0,27.0,27.0
0.006,6,10,1547,5,764,1.0,496.0,496.0,5,783,1.0,515.0,515.0
0.007,6,10,1547,5,764,1.0,496.0,496.0,5,783,1.0,515.0,515.0
0.091,6,10,1506,5,395,19.0,127.0,127.0,5,1111,21.0,843.0,843.0
1.005,6,13,3922,7,2139,125.0,1328.0,923.0,6,1783,151.0,1539.0,1539.0
436.868,6,29,7895,16,3168,29124.0,676.0,388.0,13,4727,31404.0,1402.0,673.0
0.009,6,10,1983,5,910,2.0,642.0,642.0,5,1073,2.0,805.0,805.0
0.018,6,10,1989,5,910,4.0,642.0,642.0,5,1079,4.0,811.0,811.0
0.004,17,2,136,1,60,0.0,32.0,32.0,1,76,0.0,48.0,48.0
0.006,6,10,2006,5,927,1.0,659.0,659.0,5,1079,1.0,811.0,811.0
0.024,17,4,284,2,120,21.0,32.0,32.0,2,164,21.0,60.0,54.0
0.005,6,10,2006,5,927,1.0,659.0,659.0,5,1079,1.0,811.0,811.0
0.009,6,10,1990,5,911,2.0,643.0,643.0,5,1079,2.0,811.0,811.0
0.001,17,2,174,1,72,0.0,44.0,44.0,1,102,0.0,74.0,74.0
0.006,6,12,1698,6,863,1.0,327.0,271.0,6,835,1.0,515.0,515.0
0.005,17,2,166,1,75,0.0,47.0,47.0,1,91,0.0,63.0,63.0
0.004,6,10,2006,5,927,1.0,659.0,659.0,5,1079,1.0,811.0,811.0
0.009,6,10,1677,5,827,2.0,559.0,559.0,5,850,2.0,582.0,582.0
0.015,6,10,1631,5,848,3.0,580.0,580.0,5,783,3.0,515.0,515.0
308.445,17,20,1124,10,716,34257.0,48.0,43.0,10,408,34257.0,20.0,12.0
0.003,17,2,136,1,60,0.0,32.0,32.0,1,76,0.0,48.0,48.0
0.016,6,10,1983,5,910,3.0,642.0,642.0,5,1073,4.0,805.0,805.0
0.005,6,10,1689,5,839,1.0,571.0,571.0,5,850,1.0,582.0,582.0
0.005,6,10,1689,5,839,1.0,571.0,571.0,5,850,1.0,582.0,582.0
0.038,17,2,182,1,65,0.0,37.0,37.0,1,117,0.0,89.0,89.0
11.007,17,28,4393,14,2311,837.0,586.0,137.0,14,2082,837.0,269.0,120.0
0.006,6,10,1547,5,764,1.0,496.0,496.0,5,783,1.0,515.0,515.0
0.099,6,10,1506,5,395,22.0,127.0,127.0,5,1111,21.0,843.0,843.0
0.011,6,10,1983,5,910,2.0,642.0,642.0,5,1073,2.0,805.0,805.0
0.135,17,2,80,1,32,0.0,4.0,4.0,1,48,0.0,20.0,20.0
0.006,6,10,1689,5,839,1.0,571.0,571.0,5,850,1.0,582.0,582.0
0.01,6,10,1990,5,911,2.0,643.0,643.0,5,1079,2.0,811.0,811.0
40.061,17,10,676,5,460,10012.0,104.0,64.0,5,216,10014.0,20.0,15.0
0.016,6,10,1983,5,910,4.0,642.0,642.0,5,1073,3.0,805.0,805.0
0.015,6,10,1972,5,910,3.0,642.0,642.0,5,1062,3.0,794.0,794.0
0.003,17,2,170,1,65,0.0,37.0,37.0,1,105,0.0,77.0,77.0
0.004,17,2,186,1,61,0.0,33.0,33.0,1,125,0.0,97.0,97.0
0.429,17,42,20393,22,17089,20.0,1350.0,748.0,20,3304,17.0,1350.0,137.0
40.059,17,10,676,5,460,10014.0,104.0,64.0,5,216,10013.0,20.0,15.0
280.263,6,23,6075,10,1186,31140.0,267.0,156.0,13,4889,23354.0,1400.0,873.0
0.01,6,10,1677,5,827,2.0,559.0,559.0,5,850,2.0,582.0,582.0
0.081,6,10,1506,5,395,17.0,127.0,127.0,5,1111,18.0,843.0,843.0
0.077,6,10,1506,5,395,16.0,127.0,127.0,5,1111,15.0,843.0,843.0
309.015,17,20,1124,10,716,34322.0,48.0,43.0,10,408,34321.0,20.0,12.0
293.429,6,356,345771,123,17943,2405.0,2736.0,888.0,233,327828,1264.0,2804.0,1448.0
240.016,6,9,787,5,488,60004.0,232.0,232.0,4,299,80004.0,83.0,83.0
0.004,17,2,170,1,65,0.0,37.0,37.0,1,105,0.0,77.0,77.0
0.006,6,10,1547,5,764,1.0,496.0,496.0,5,783,1.0,515.0,515.0
40.072,17,10,676,5,460,10017.0,104.0,64.0,5,216,10017.0,20.0,15.0
40.06,17,10,676,5,460,10014.0,104.0,64.0,5,216,10014.0,20.0,15.0
0.005,6,10,1547,5,764,1.0,496.0,496.0,5,783,1.0,515.0,515.0
0.005,6,14,3799,7,509,0.0,137.0,137.0,7,3290,0.0,1448.0,972.0
0.007,6,10,1972,5,910,1.0,642.0,642.0,5,1062,1.0,794.0,794.0
0.418,17,2,144,1,64,0.0,36.0,36.0,1,80,0.0,52.0,52.0
0.004,6,10,2006,5,927,1.0,659.0,659.0,5,1079,1.0,811.0,811.0
15.331,17,19,8888,10,6542,1700.0,1350.0,626.0,9,2346,1912.0,1350.0,232.0
0.079,6,10,1506,5,395,19.0,127.0,127.0,5,1111,19.0,843.0,843.0
0.014,6,10,1677,5,827,3.0,559.0,559.0,5,850,3.0,582.0,582.0
0.087,6,10,1506,5,395,17.0,127.0,127.0,5,1111,20.0,843.0,843.0
1787.09,6,154,19574,92,13852,19638.0,302.0,302.0,62,5722,29296.0,83.0,83.0
40.06,17,10,676,5,460,10014.0,104.0,64.0,5,216,10014.0,20.0,15.0
0.006,6,10,1547,5,764,1.0,496.0,496.0,5,783,1.0,515.0,515.0
10.867,17,28,4423,14,1995,827.0,270.0,114.0,14,2428,827.0,587.0,145.0
0.006,6,10,1547,5,764,1.0,496.0,496.0,5,783,1.0,515.0,515.0
0.008,6,12,1926,6,1189,1.0,659.0,434.0,6,737,1.0,417.0,417.0
0.005,6,10,1547,5,764,1.0,496.0,496.0,5,783,1.0,515.0,515.0
40.055,17,10,676,5,460,10013.0,104.0,64.0,5,216,10012.0,20.0,15.0
0.007,17,2,179,1,71,0.0,43.0,43.0,1,108,0.0,80.0,80.0
0.001,17,2,180,1,66,0.0,38.0,38.0,1,114,0.0,86.0,86.0
1786.267,6,150,19350,90,13740,20070.0,302.0,302.0,60,5610,30275.0,83.0,83.0
240.046,6,9,787,5,488,60011.0,232.0,232.0,4,299,80014.0,83.0,83.0
0.119,6,10,1506,5,395,26.0,127.0,127.0,5,1111,27.0,843.0,843.0
11.042,17,28,4391,14,2313,840.0,588.0,137.0,14,2078,840.0,269.0,120.0
0.107,6,10,1506,5,395,23.0,127.0,127.0,5,1111,22.0,843.0,843.0
0.22,6,16,2669,8,1395,31.0,533.0,323.0,8,1274,19.0,529.0,212.0
0.052,17,2,152,1,76,0.0,48.0,48.0,1,76,0.0,48.0,48.0
0.226,6,16,2803,8,1421,32.0,533.0,332.0,8,1382,20.0,529.0,239.0
0.069,17,8,3613,4,1874,23.0,1350.0,440.0,4,1739,11.0,1350.0,406.0
0.02,6,13,4111,7,675,3.0,299.0,299.0,6,3436,3.0,1402.0,1038.0
0.006,17,2,230,1,68,0.0,40.0,40.0,1,162,0.0,134.0,134.0
0.09,6,10,1506,5,395,17.0,127.0,127.0,5,1111,18.0,843.0,843.0
0.013,6,10,1972,5,910,3.0,642.0,642.0,5,1062,3.0,794.0,794.0
40.068,17,10,676,5,460,10014.0,104.0,64.0,5,216,10016.0,20.0,15.0
0.114,6,10,1506,5,395,27.0,127.0,127.0,5,1111,26.0,843.0,843.0
335.399,17,20,1124,10,716,37252.0,48.0,43.0,10,408,37253.0,20.0,12.0
0.005,6,10,2006,5,927,1.0,659.0,659.0,5,1079,1.0,811.0,811.0
0.124,6,10,1506,5,395,29.0,127.0,127.0,5,1111,28.0,843.0,843.0
0.004,17,2,148,1,60,0.0,32.0,32.0,1,88,0.0,60.0,60.0
0.077,6,10,1506,5,395,18.0,127.0,127.0,5,1111,17.0,843.0,843.0
0.013,6,10,1972,5,910,3.0,642.0,642.0,5,1062,3.0,794.0,794.0
0.023,6,10,1677,5,827,5.0,559.0,559.0,5,850,5.0,582.0,582.0
0.001,17,2,136,1,60,0.0,32.0,32.0,1,76,0.0,48.0,48.0
0.143,6,10,1506,5,395,34.0,127.0,127.0,5,1111,34.0,843.0,843.0
240.706,6,37,9661,19,2177,13370.0,749.0,236.0,18,7484,14156.0,1402.0,595.0
0.082,6,10,1506,5,395,17.0,127.0,127.0,5,1111,19.0,843.0,843.0
0.022,6,10,1972,5,910,5.0,642.0,642.0,5,1062,5.0,794.0,794.0
40.041,17,10,676,5,460,10008.0,104.0,64.0,5,216,10009.0,20.0,15.0
0.065,6,10,1506,5,395,15.0,127.0,127.0,5,1111,15.0,843.0,843.0
0.09,6,10,1506,5,395,20.0,127.0,127.0,5,1111,21.0,843.0,843.0
0.009,6,10,1990,5,911,2.0,643.0,643.0,5,1079,2.0,811.0,811.0
1799.997,6,137,6590,76,3625,23996.0,39.0,39.0,61,2965,29996.0,35.0,35.0
0.005,6,13,3747,7,509,0.0,137.0,137.0,6,3238,0.0,1470.0,1459.0
0.006,6,10,2000,5,927,1.0,659.0,659.0,5,1073,1.0,805.0,805.0
0.005,6,13,3747,7,509,0.0,137.0,137.0,6,3238,1.0,1470.0,1459.0
293.511,6,306,343976,126,18108,2348.0,2736.0,889.0,180,325868,1639.0,3967.0,1906.0
0.005,17,2,170,1,65,0.0,37.0,37.0,1,105,0.0,77.0,77.0
0.038,17,2,166,1,75,0.0,47.0,47.0,1,91,0.0,63.0,63.0
0.002,17,2,185,1,73,0.0,45.0,45.0,1,112,0.0,84.0,84.0
0.097,6,10,1506,5,395,22.0,127.0,127.0,5,1111,21.0,843.0,843.0
0.005,6,10,2000,5,927,1.0,659.0,659.0,5,1073,1.0,805.0,805.0
0.013,6,10,1762,5,911,3.0,643.0,643.0,5,851,3.0,583.0,583.0
1772.432,6,105,6270,60,3525,30040.0,27.0,27.0,45,2745,40281.0,27.0,27.0
0.01,6,10,1972,5,910,2.0,642.0,642.0,5,1062,2.0,794.0,794.0
0.004,17,4,284,2,120,0.0,32.0,32.0,2,164,0.0,60.0,54.0
0.066,6,10,1506,5,395,14.0,127.0,127.0,5,1111,13.0,843.0,843.0
0.006,6,10,1643,5,860,1.0,592.0,592.0,5,783,1.0,515.0,515.0
0.016,6,10,1762,5,911,4.0,643.0,643.0,5,851,4.0,583.0,583.0
0.088,6,10,1506,5,395,19.0,127.0,127.0,5,1111,16.0,843.0,843.0
0.012,6,10,1989,5,910,3.0,642.0,642.0,5,1079,3.0,811.0,811.0
0.012,6,10,1989,5,910,3.0,642.0,642.0,5,1079,3.0,811.0,811.0
178.536,17,80,11324,40,2666,4577.0,44.0,38.0,40,8658,4577.0,261.0,188.0
0.005,17,2,180,1,66,0.0,38.0,38.0,1,114,0.0,86.0,86.0
40.064,17,10,676,5,460,10013.0,104.0,64.0,5,216,10015.0,20.0,15.0
0.012,6,10,1972,5,910,3.0,642.0,642.0,5,1062,2.0,794.0,794.0
0.013,6,10,1990,5,911,3.0,643.0,643.0,5,1079,3.0,811.0,811.0
0.005,6,10,2006,5,927,1.0,659.0,659.0,5,1079,1.0,811.0,811.0
0.001,17,2,180,1,66,0.0,38.0,38.0,1,114,0.0,86.0,86.0
0.01,6,12,1926,6,1189,2.0,659.0,434.0,6,737,1.0,417.0,417.0
439.637,6,29,4409,12,3102,10912.0,494.0,494.0,17,1307,27477.0,83.0,83.0
0.014,6,10,1989,5,910,3.0,642.0,642.0,5,1079,3.0,811.0,811.0
0.004,6,10,2007,5,928,1.0,660.0,660.0,5,1079,1.0,811.0,811.0
0.004,6,10,2007,5,928,1.0,660.0,660.0,5,1079,1.0,811.0,811.0
0.012,6,10,1762,5,911,2.0,643.0,643.0,5,851,3.0,583.0,583.0
175.604,17,94,13578,47,3163,3817.0,44.0,39.0,47,10415,3817.0,260.0,193.0
0.009,6,10,1989,5,910,2.0,642.0,642.0,5,1079,2.0,811.0,811.0
0.004,6,10,1779,5,928,1.0,660.0,660.0,5,851,1.0,583.0,583.0
0.075,6,10,1506,5,395,15.0,127.0,127.0,5,1111,16.0,843.0,843.0
0.001,17,2,180,1,66,0.0,38.0,38.0,1,114,0.0,86.0,86.0
0.007,6,10,1989,5,910,1.0,642.0,642.0,5,1079,1.0,811.0,811.0
0.004,6,10,1702,5,863,1.0,595.0,595.0,5,839,0.0,571.0,571.0
40.061,17,10,676,5,460,10014.0,104.0,64.0,5,216,10014.0,20.0,15.0
0.006,17,2,169,1,62,0.0,34.0,34.0,1,107,0.0,79.0,79.0
0.009,6,10,1762,5,911,2.0,643.0,643.0,5,851,2.0,583.0,583.0
0.071,17,2,136,1,60,0.0,32.0,32.0,1,76,0.0,48.0,48.0
0.006,6,10,1689,5,839,1.0,571.0,571.0,5,850,1.0,582.0,582.0
0.003,17,2,142,1,63,0.0,35.0,35.0,1,79,0.0,51.0,51.0
0.106,6,10,1506,5,395,22.0,127.0,127.0,5,1111,24.0,843.0,843.0
431.553,6,47,8807,24,6690,5999.0,494.0,494.0,23,2117,19615.0,83.0,83.0
0.107,17,2,179,1,71,0.0,43.0,43.0,1,108,0.0,80.0,80.0
0.009,6,14,3787,7,497,1.0,125.0,125.0,7,3290,1.0,1448.0,972.0
0.119,6,10,1506,5,395,24.0,127.0,127.0,5,1111,24.0,843.0,843.0
40.054,17,10,676,5,460,10012.0,104.0,64.0,5,216,10012.0,20.0,15.0
0.04,17,2,144,1,64,0.0,36.0,36.0,1,80,0.0,52.0,52.0
0.006,6,10,1547,5,764,1.0,496.0,496.0,5,783,1.0,515.0,515.0
0.012,6,10,1990,5,911,3.0,643.0,643.0,5,1079,2.0,811.0,811.0
1779.085,17,144,45504,72,22752,25057.0,288.0,288.0,72,22752,25057.0,288.0,288.0
0.081,17,4,284,2,120,43.0,32.0,32.0,2,164,42.0,60.0,54.0
40.047,17,10,676,5,460,10010.0,104.0,64.0,5,216,10010.0,20.0,15.0
308.606,17,20,1124,10,716,34275.0,48.0,43.0,10,408,34275.0,20.0,12.0
0.039,17,2,184,1,61,0.0,33.0,33.0,1,123,0.0,95.0,95.0
0.019,17,2,148,1,60,0.0,32.0,32.0,1,88,0.0,60.0,60.0
293.07,6,384,348102,200,21955,1472.0,2686.0,888.0,184,326147,1601.0,2804.0,1862.0
0.068,17,8,3613,4,1874,22.0,1350.0,440.0,4,1739,12.0,1350.0,406.0
0.004,6,10,1702,5,863,0.0,595.0,595.0,5,839,1.0,571.0,571.0
0.006,6,10,1643,5,860,1.0,592.0,592.0,5,783,1.0,515.0,515.0
0.016,6,13,3735,7,497,2.0,125.0,125.0,6,3238,3.0,1470.0,1459.0
0.005,6,10,1643,5,860,1.0,592.0,592.0,5,783,1.0,515.0,515.0
0.006,6,10,1643,5,860,1.0,592.0,592.0,5,783,1.0,515.0,515.0
240.163,6,24,4126,11,1756,24016.0,539.0,235.0,13,2370,20013.0,1324.0,242.0
335.843,17,20,1124,10,716,37302.0,48.0,43.0,10,408,37302.0,20.0,12.0
0.115,6,10,1506,5,395,26.0,127.0,127.0,5,1111,20.0,843.0,843.0
0.09,6,10,1506,5,395,21.0,127.0,127.0,5,1111,18.0,843.0,843.0
0.088,6,10,1506,5,395,18.0,127.0,127.0,5,1111,20.0,843.0,843.0
0.004,6,10,2006,5,927,1.0,659.0,659.0,5,1079,1.0,811.0,811.0
0.071,6,10,1506,5,395,16.0,127.0,127.0,5,1111,13.0,843.0,843.0
0.013,6,10,1989,5,910,3.0,642.0,642.0,5,1079,3.0,811.0,811.0
0.007,6,10,1689,5,839,1.0,571.0,571.0,5,850,1.0,582.0,582.0
0.006,6,10,1643,5,860,1.0,592.0,592.0,5,783,1.0,515.0,515.0
0.013,6,10,1972,5,910,3.0,642.0,642.0,5,1062,3.0,794.0,794.0
0.001,17,2,180,1,66,0.0,38.0,38.0,1,114,0.0,86.0,86.0
0.005,6,10,1547,5,764,1.0,496.0,496.0,5,783,1.0,515.0,515.0
0.006,17,2,164,1,74,0.0,46.0,46.0,1,90,0.0,62.0,62.0
0.78,6,26,10464,15,4051,55.0,1360.0,569.0,11,6413,60.0,2720.0,851.0
240.052,6,9,787,5,488,60013.0,232.0,232.0,4,299,80016.0,83.0,83.0
0.139,6,10,1506,5,395,32.0,127.0,127.0,5,1111,29.0,843.0,843.0
0.007,17,2,136,1,60,0.0,32.0,32.0,1,76,0.0,48.0,48.0
0.003,17,2,136,1,60,0.0,32.0,32.0,1,76,0.0,48.0,48.0
0.037,17,2,148,1,60,0.0,32.0,32.0,1,88,0.0,60.0,60.0
0.065,17,2,136,1,60,0.0,32.0,32.0,1,76,0.0,48.0,48.0
0.004,17,2,148,1,60,0.0,32.0,32.0,1,88,0.0,60.0,60.0
0.018,6,10,1989,5,910,4.0,642.0,642.0,5,1079,4.0,811.0,811.0
15.072,17,14,9190,8,6902,2149.0,1350.0,834.0,6,2288,3008.0,1350.0,353.0
0.071,17,2,184,1,61,0.0,33.0,33.0,1,123,0.0,95.0,95.0
40.059,17,10,676,5,460,10013.0,104.0,64.0,5,216,10014.0,20.0,15.0
40.06,17,10,676,5,460,10014.0,104.0,64.0,5,216,10013.0,20.0,15.0
0.089,6,10,1506,5,395,20.0,127.0,127.0,5,1111,21.0,843.0,843.0
0.16,6,11,1558,6,447,31.0,127.0,127.0,5,1111,34.0,843.0,843.0
0.004,17,2,148,1,60,0.0,32.0,32.0,1,88,0.0,60.0,60.0
0.005,17,2,230,1,68,0.0,40.0,40.0,1,162,0.0,134.0,134.0
0.017,6,10,1989,5,910,4.0,642.0,642.0,5,1079,4.0,811.0,811.0
0.019,6,10,1990,5,911,4.0,643.0,643.0,5,1079,4.0,811.0,811.0
0.012,6,10,1990,5,911,2.0,643.0,643.0,5,1079,3.0,811.0,811.0
0.004,6,10,2006,5,927,1.0,659.0,659.0,5,1079,1.0,811.0,811.0
0.014,6,10,1989,5,910,3.0,642.0,642.0,5,1079,3.0,811.0,811.0
0.021,6,10,1989,5,910,5.0,642.0,642.0,5,1079,5.0,811.0,811.0
0.003,17,2,136,1,60,0.0,32.0,32.0,1,76,0.0,48.0,48.0
0.014,6,10,1990,5,911,3.0,643.0,643.0,5,1079,3.0,811.0,811.0
0.005,6,10,1774,5,923,1.0,655.0,655.0,5,851,1.0,583.0,583.0
5.09,6,21,6351,12,1763,462.0,801.0,282.0,9,4588,635.0,1925.0,824.0
0.078,6,10,1506,5,395,17.0,127.0,127.0,5,1111,16.0,843.0,843.0
0.009,6,10,1989,5,910,2.0,642.0,642.0,5,1079,2.0,811.0,811.0
0.01,6,10,1762,5,911,2.0,643.0,643.0,5,851,2.0,583.0,583.0
538.169,58,13,936,10,720,59796.0,24.0,24.0,3,216,252971.0,24.0,24.0
15.071,17,15,9238,8,6902,2149.0,1350.0,834.0,7,2336,2507.0,1350.0,305.0
0.016,6,10,1990,5,911,4.0,643.0,643.0,5,1079,4.0,811.0,811.0
0.083,6,10,1506,5,395,19.0,127.0,127.0,5,1111,17.0,843.0,843.0
0.013,6,11,2035,6,962,2.0,642.0,642.0,5,1073,3.0,805.0,805.0
0.001,17,2,180,1,66,0.0,38.0,38.0,1,114,0.0,86.0,86.0
0.006,17,2,166,1,75,0.0,47.0,47.0,1,91,0.0,63.0,63.0
0.005,6,10,1689,5,839,1.0,571.0,571.0,5,850,1.0,582.0,582.0
0.006,6,10,1547,5,764,1.0,496.0,496.0,5,783,1.0,515.0,515.0
0.008,17,2,194,1,59,0.0,31.0,31.0,1,135,0.0,107.0,107.0
0.005,6,10,1854,5,889,1.0,621.0,621.0,5,965,1.0,697.0,697.0
0.005,6,10,2006,5,927,1.0,659.0,659.0,5,1079,1.0,811.0,811.0
0.04,17,2,170,1,65,0.0,37.0,37.0,1,105,0.0,77.0,77.0
0.005,6,10,2000,5,927,1.0,659.0,659.0,5,1073,1.0,805.0,805.0
0.224,6,16,2669,8,1395,32.0,533.0,323.0,8,1274,20.0,529.0,212.0
0.008,6,10,1643,5,860,1.0,592.0,592.0,5,783,2.0,515.0,515.0
10.762,17,28,4421,14,1993,819.0,268.0,114.0,14,2428,819.0,587.0,145.0
0.013,6,10,1989,5,910,3.0,642.0,642.0,5,1079,3.0,811.0,811.0
0.006,6,10,1547,5,764,1.0,496.0,496.0,5,783,1.0,515.0,515.0
0.006,6,10,2000,5,927,1.0,659.0,659.0,5,1073,1.0,805.0,805.0
40.06,17,10,676,5,460,10014.0,104.0,64.0,5,216,10014.0,20.0,15.0
0.004,17,2,152,1,76,0.0,48.0,48.0,1,76,0.0,48.0,48.0
240.505,6,32,8582,16,1784,16031.0,569.0,188.0,16,6798,16031.0,1402.0,597.0
0.01,6,12,1926,6,1189,2.0,659.0,434.0,6,737,1.0,417.0,417.0
11.151,17,28,4422,14,1994,845.0,269.0,114.0,14,2428,845.0,587.0,145.0
0.081,6,10,1506,5,395,16.0,127.0,127.0,5,1111,19.0,843.0,843.0
0.006,6,10,2006,5,927,1.0,659.0,659.0,5,1079,1.0,811.0,811.0
0.186,6,10,1506,5,395,43.0,127.0,127.0,5,1111,19.0,843.0,843.0
0.067,17,8,3613,4,1874,22.0,1350.0,440.0,4,1739,11.0,1350.0,406.0
0.012,6,10,1989,5,910,3.0,642.0,642.0,5,1079,2.0,811.0,811.0
0.009,6,10,1989,5,910,2.0,642.0,642.0,5,1079,2.0,811.0,811.0
0.008,6,10,1989,5,910,1.0,642.0,642.0,5,1079,2.0,811.0,811.0
171.173,17,82,11984,41,2753,4279.0,44.0,39.0,41,9231,4279.0,279.0,197.0
0.009,6,10,1972,5,910,2.0,642.0,642.0,5,1062,2.0,794.0,794.0
0.001,17,2,166,1,75,0.0,47.0,47.0,1,91,0.0,63.0,63.0
0.102,6,10,1506,5,395,22.0,127.0,127.0,5,1111,19.0,843.0,843.0
0.001,17,2,180,1,66,0.0,38.0,38.0,1,114,0.0,86.0,86.0
0.082,6,10,1506,5,395,19.0,127.0,127.0,5,1111,14.0,843.0,843.0
0.01,6,10,1990,5,911,2.0,643.0,643.0,5,1079,2.0,811.0,811.0
0.077,6,10,1506,5,395,17.0,127.0,127.0,5,1111,15.0,843.0,843.0
10.928,17,28,4421,14,1994,832.0,269.0,114.0,14,2427,832.0,586.0,145.0
301.315,6,328,344150,133,18463,2282.0,2736.0,888.0,195,325687,1552.0,2804.0,1752.0
0.004,6,10,1989,5,927,1.0,659.0,659.0,5,1062,1.0,794.0,794.0
0.008,6,10,1631,5,848,2.0,580.0,580.0,5,783,2.0,515.0,515.0
0.005,17,2,225,1,65,0.0,37.0,37.0,1,160,0.0,132.0,132.0
0.075,6,10,1506,5,395,17.0,127.0,127.0,5,1111,15.0,843.0,843.0
0.005,6,10,1989,5,927,1.0,659.0,659.0,5,1062,1.0,794.0,794.0
0.013,6,10,1983,5,910,3.0,642.0,642.0,5,1073,3.0,805.0,805.0
0.005,6,10,2007,5,928,1.0,660.0,660.0,5,1079,1.0,811.0,811.0
0.089,6,10,1506,5,395,20.0,127.0,127.0,5,1111,17.0,843.0,843.0
417.06,6,40,15992,22,2957,19860.0,663.0,361.0,18,13035,21000.0,1924.0,1007.0
0.004,6,10,2006,5,927,1.0,659.0,659.0,5,1079,1.0,811.0,811.0
0.009,6,10,1989,5,910,2.0,642.0,642.0,5,1079,2.0,811.0,811.0
0.013,6,10,1989,5,910,3.0,642.0,642.0,5,1079,3.0,811.0,811.0
0.011,6,10,1989,5,910,2.0,642.0,642.0,5,1079,2.0,811.0,811.0
240.084,6,16,4481,9,963,30010.0,238.0,166.0,7,3518,40013.0,1402.0,786.0
0.012,6,10,2006,5,927,3.0,659.0,659.0,5,1079,3.0,811.0,811.0
0.006,6,10,1547,5,764,1.0,496.0,496.0,5,783,1.0,515.0,515.0
0.006,6,10,1547,5,764,1.0,496.0,496.0,5,783,1.0,515.0,515.0
0.005,6,10,1774,5,923,1.0,655.0,655.0,5,851,1.0,583.0,583.0
0.007,17,2,179,1,71,0.0,43.0,43.0,1,108,0.0,80.0,80.0
175.136,17,90,12917,45,3027,3980.0,44.0,39.0,45,9890,3980.0,239.0,191.0
0.013,6,10,1990,5,911,3.0,643.0,643.0,5,1079,3.0,811.0,811.0
0.006,6,10,1547,5,764,1.0,496.0,496.0,5,783,1.0,515.0,515.0
0.13,17,4,596,2,122,92.0,33.0,33.0,2,474,91.0,323.0,209.0
0.005,6,10,1989,5,927,1.0,659.0,659.0,5,1062,1.0,794.0,794.0
0.011,6,10,1989,5,910,2.0,642.0,642.0,5,1079,2.0,811.0,811.0
0.006,6,10,1689,5,839,1.0,571.0,571.0,5,850,1.0,582.0,582.0
9.036,17,6,376,5,280,2259.0,28.0,28.0,1,96,0.0,68.0,68.0
11.042,17,28,4392,14,2313,840.0,588.0,137.0,14,2079,840.0,270.0,120.0
0.005,6,10,2006,5,927,1.0,659.0,659.0,5,1079,1.0,811.0,811.0
0.003,17,2,148,1,60,0.0,32.0,32.0,1,88,0.0,60.0,60.0
0.006,6,10,1547,5,764,1.0,496.0,496.0,5,783,1.0,515.0,515.0
300.031,6,12,1782,7,1348,50005.0,494.0,494.0,5,434,75007.0,83.0,83.0
0.005,6,10,1779,5,928,1.0,660.0,660.0,5,851,1.0,583.0,583.0
0.076,6,10,1506,5,395,18.0,127.0,127.0,5,1111,17.0,843.0,843.0
0.009,6,10,1972,5,910,2.0,642.0,642.0,5,1062,2.0,794.0,794.0
10.813,17,28,4418,14,1993,823.0,268.0,114.0,14,2425,823.0,588.0,145.0
0.011,6,10,1972,5,910,2.0,642.0,642.0,5,1062,2.0,794.0,794.0
295.536,6,20,4071,11,2920,29550.0,1273.0,468.0,9,1151,36937.0,498.0,229.0
0.117,17,2,80,1,32,0.0,4.0,4.0,1,48,0.0,20.0,20.0
0.141,6,10,1506,5,395,30.0,127.0,127.0,5,1111,31.0,843.0,843.0
40.059,17,10,676,5,460,10013.0,104.0,64.0,5,216,10013.0,20.0,15.0
0.005,6,10,2006,5,927,1.0,659.0,659.0,5,1079,1.0,811.0,811.0
0.076,6,10,1506,5,395,18.0,127.0,127.0,5,1111,15.0,843.0,843.0
0.167,17,2,152,1,76,0.0,48.0,48.0,1,76,0.0,48.0,48.0
40.058,17,10,676,5,460,10013.0,104.0,64.0,5,216,10013.0,20.0,15.0
0.005,6,10,1689,5,839,1.0,571.0,571.0,5,850,1.0,582.0,582.0
0.004,6,10,1774,5,923,1.0,655.0,655.0,5,851,1.0,583.0,583.0
0.005,6,10,2000,5,927,1.0,659.0,659.0,5,1073,1.0,805.0,805.0
0.004,6,10,2007,5,928,1.0,660.0,660.0,5,1079,1.0,811.0,811.0
305.096,17,14,812,7,532,50827.0,48.0,48.0,7,280,50827.0,12.0,12.0
0.016,6,10,1983,5,910,4.0,642.0,642.0,5,1073,4.0,805.0,805.0
0.031,6,10,1677,5,827,7.0,559.0,559.0,5,850,7.0,582.0,582.0
0.021,6,10,1972,5,910,5.0,642.0,642.0,5,1062,5.0,794.0,794.0
0.006,6,14,3799,7,509,1.0,137.0,137.0,7,3290,0.0,1448.0,972.0
15.073,17,15,8474,8,6309,2149.0,1350.0,760.0,7,2165,2507.0,1350.0,281.0
0.005,6,10,2006,5,927,1.0,659.0,659.0,5,1079,1.0,811.0,811.0
0.005,6,10,2000,5,927,1.0,659.0,659.0,5,1073,1.0,805.0,805.0
0.009,6,12,1926,6,1189,1.0,659.0,434.0,6,737,1.0,417.0,417.0
0.005,17,2,170,1,65,0.0,37.0,37.0,1,105,0.0,77.0,77.0
240.012,6,9,787,5,488,60003.0,232.0,232.0,4,299,80003.0,83.0,83.0
0.105,6,10,1506,5,395,24.0,127.0,127.0,5,1111,24.0,843.0,843.0
0.005,6,10,2007,5,928,1.0,660.0,660.0,5,1079,1.0,811.0,811.0
0.005,6,10,1547,5,764,1.0,496.0,496.0,5,783,1.0,515.0,515.0
0.01,6,10,1989,5,910,2.0,642.0,642.0,5,1079,2.0,811.0,811.0
15.075,17,16,8535,8,6352,2149.0,1350.0,766.0,8,2183,2149.0,1350.0,244.0
0.011,6,10,1677,5,827,2.0,559.0,559.0,5,850,2.0,582.0,582.0
0.009,6,10,1631,5,848,2.0,580.0,580.0,5,783,2.0,515.0,515.0
0.121,6,10,1506,5,395,27.0,127.0,127.0,5,1111,24.0,843.0,843.0
0.144,6,10,1506,5,395,34.0,127.0,127.0,5,1111,35.0,843.0,843.0
40.069,17,10,676,5,460,10014.0,104.0,64.0,5,216,10016.0,20.0,15.0
0.006,6,13,3747,7,509,1.0,137.0,137.0,6,3238,1.0,1470.0,1459.0
0.034,6,10,1990,5,911,8.0,643.0,643.0,5,1079,8.0,811.0,811.0
0.092,6,10,1506,5,395,20.0,127.0,127.0,5,1111,20.0,843.0,843.0
0.006,6,10,1547,5,764,1.0,496.0,496.0,5,783,1.0,515.0,515.0
0.118,6,10,1506,5,395,21.0,127.0,127.0,5,1111,28.0,843.0,843.0
0.011,6,10,1990,5,911,2.0,643.0,643.0,5,1079,2.0,811.0,811.0
0.121,6,10,1506,5,395,28.0,127.0,127.0,5,1111,25.0,843.0,843.0
40.065,17,10,676,5,460,10015.0,104.0,64.0,5,216,10014.0,20.0,15.0
0.081,6,10,1506,5,395,19.0,127.0,127.0,5,1111,16.0,843.0,843.0
0.01,6,10,1989,5,910,2.0,642.0,642.0,5,1079,2.0,811.0,811.0
0.008,6,10,2000,5,927,2.0,659.0,659.0,5,1073,1.0,805.0,805.0
294.641,6,393,349193,207,22966,1430.0,2736.0,871.0,186,326227,1592.0,2947.0,1851.0
0.069,6,10,1506,5,395,16.0,127.0,127.0,5,1111,14.0,843.0,843.0
0.005,6,10,2006,5,927,1.0,659.0,659.0,5,1079,1.0,811.0,811.0
40.072,17,10,676,5,460,10016.0,104.0,64.0,5,216,10017.0,20.0,15.0
0.006,6,10,1547,5,764,1.0,496.0,496.0,5,783,1.0,515.0,515.0
0.01,6,10,1989,5,910,2.0,642.0,642.0,5,1079,2.0,811.0,811.0
0.009,6,10,1990,5,911,2.0,643.0,643.0,5,1079,2.0,811.0,811.0
0.008,6,13,3735,7,497,1.0,125.0,125.0,6,3238,1.0,1470.0,1459.0
0.011,6,10,1989,5,910,2.0,642.0,642.0,5,1079,2.0,811.0,811.0
0.005,6,13,3747,7,509,0.0,137.0,137.0,6,3238,0.0,1470.0,1459.0
0.096,6,10,1506,5,395,22.0,127.0,127.0,5,1111,21.0,843.0,843.0
0.008,6,10,1972,5,910,2.0,642.0,642.0,5,1062,2.0,794.0,794.0
0.006,6,10,1547,5,764,1.0,496.0,496.0,5,783,1.0,515.0,515.0
0.007,6,10,1774,5,923,1.0,655.0,655.0,5,851,1.0,583.0,583.0
0.005,17,2,214,1,75,0.0,47.0,47.0,1,139,0.0,111.0,111.0
40.059,17,10,676,5,460,10013.0,104.0,64.0,5,216,10013.0,20.0,15.0
0.038,17,2,136,1,60,0.0,32.0,32.0,1,76,0.0,48.0,48.0
0.006,6,10,1689,5,839,1.0,571.0,571.0,5,850,1.0,582.0,582.0
0.01,6,10,1983,5,910,2.0,642.0,642.0,5,1073,2.0,805.0,805.0
0.015,17,2,148,1,60,0.0,32.0,32.0,1,88,0.0,60.0,60.0
0.013,6,10,1989,5,910,3.0,642.0,642.0,5,1079,3.0,811.0,811.0
0.005,6,10,1989,5,927,1.0,659.0,659.0,5,1062,1.0,794.0,794.0
361.809,6,21,1792,16,1030,24120.0,190.0,190.0,5,762,60011.0,461.0,247.0
0.004,17,2,136,1,60,0.0,32.0,32.0,1,76,0.0,48.0,48.0
0.168,17,2,152,1,76,0.0,48.0,48.0,1,76,0.0,48.0,48.0
0.005,6,10,1989,5,927,1.0,659.0,659.0,5,1062,1.0,794.0,794.0
0.084,6,10,1506,5,395,19.0,127.0,127.0,5,1111,19.0,843.0,843.0
0.005,6,10,1989,5,927,1.0,659.0,659.0,5,1062,1.0,794.0,794.0
0.006,6,10,1643,5,860,1.0,592.0,592.0,5,783,1.0,515.0,515.0
0.093,6,10,1506,5,395,22.0,127.0,127.0,5,1111,21.0,843.0,843.0
1799.975,6,586,194503,305,166149,5920.0,2883.0,873.0,281,28354,6428.0,580.0,127.0
0.005,6,10,2006,5,927,1.0,659.0,659.0,5,1079,1.0,811.0,811.0
0.005,17,2,154,1,69,0.0,41.0,41.0,1,85,0.0,57.0,57.0
0.094,6,10,1506,5,395,18.0,127.0,127.0,5,1111,20.0,843.0,843.0
51.186,6,37,12342,18,6784,518.0,4080.0,1508.0,19,5558,2834.0,2667.0,435.0
308.646,17,20,1124,10,716,34279.0,48.0,43.0,10,408,34279.0,20.0,12.0
0.005,17,2,140,1,62,0.0,34.0,34.0,1,78,0.0,50.0,50.0
0.135,6,10,1506,5,395,31.0,127.0,127.0,5,1111,29.0,843.0,843.0
0.014,6,10,1972,5,910,3.0,642.0,642.0,5,1062,3.0,794.0,794.0
0.007,6,10,1972,5,910,1.0,642.0,642.0,5,1062,1.0,794.0,794.0
0.112,6,10,1506,5,395,25.0,127.0,127.0,5,1111,27.0,843.0,843.0
0.219,6,10,1506,5,395,49.0,127.0,127.0,5,1111,50.0,843.0,843.0
0.0,17,2,166,1,75,0.0,47.0,47.0,1,91,0.0,63.0,63.0
240.022,6,9,787,5,488,60005.0,232.0,232.0,4,299,80004.0,83.0,83.0
0.094,6,10,1506,5,395,21.0,127.0,127.0,5,1111,21.0,843.0,843.0
0.004,17,2,234,1,61,0.0,33.0,33.0,1,173,0.0,145.0,145.0
0.17,6,10,1506,5,395,35.0,127.0,127.0,5,1111,39.0,843.0,843.0
0.005,6,10,2007,5,928,1.0,660.0,660.0,5,1079,1.0,811.0,811.0
0.055,6,10,1506,5,395,11.0,127.0,127.0,5,1111,12.0,843.0,843.0
0.005,6,13,3690,7,452,0.0,80.0,80.0,6,3238,1.0,1470.0,1459.0
0.005,6,10,1689,5,839,1.0,571.0,571.0,5,850,1.0,582.0,582.0
0.005,6,10,1854,5,889,1.0,621.0,621.0,5,965,1.0,697.0,697.0
0.009,6,10,1989,5,910,2.0,642.0,642.0,5,1079,2.0,811.0,811.0
0.004,6,10,2007,5,928,1.0,660.0,660.0,5,1079,1.0,811.0,811.0
0.004,6,10,1702,5,863,0.0,595.0,595.0,5,839,1.0,571.0,571.0
0.125,6,10,1506,5,395,25.0,127.0,127.0,5,1111,27.0,843.0,843.0
0.089,6,10,1506,5,395,19.0,127.0,127.0,5,1111,19.0,843.0,843.0
0.005,17,2,164,1,74,0.0,46.0,46.0,1,90,0.0,62.0,62.0
240.014,6,9,787,5,488,60003.0,232.0,232.0,4,299,80003.0,83.0,83.0
1790.813,6,319,51322,134,30977,13463.0,1939.0,243.0,185,20345,9731.0,1360.0,150.0
0.015,6,10,1990,5,911,3.0,643.0,643.0,5,1079,3.0,811.0,811.0
0.005,17,2,169,1,62,0.0,34.0,34.0,1,107,0.0,79.0,79.0
0.005,6,10,1989,5,927,1.0,659.0,659.0,5,1062,1.0,794.0,794.0
0.005,6,10,2006,5,927,1.0,659.0,659.0,5,1079,1.0,811.0,811.0
0.018,6,10,1990,5,911,4.0,643.0,643.0,5,1079,4.0,811.0,811.0
0.015,6,10,1989,5,910,3.0,642.0,642.0,5,1079,3.0,811.0,811.0
0.005,6,10,2007,5,928,1.0,660.0,660.0,5,1079,1.0,811.0,811.0
0.008,6,10,1677,5,827,2.0,559.0,559.0,5,850,1.0,582.0,582.0
0.004,17,2,136,1,60,0.0,32.0,32.0,1,76,0.0,48.0,48.0
40.057,17,10,676,5,460,10013.0,104.0,64.0,5,216,10013.0,20.0,15.0
0.012,6,13,3735,7,497,2.0,125.0,125.0,6,3238,2.0,1470.0,1459.0
0.007,17,2,299,1,65,0.0,37.0,37.0,1,234,0.0,206.0,206.0
0.001,17,2,136,1,60,0.0,32.0,32.0,1,76,0.0,48.0,48.0
40.076,17,10,676,5,460,10016.0,104.0,64.0,5,216,10018.0,20.0,15.0
40.057,17,10,676,5,460,10013.0,104.0,64.0,5,216,10013.0,20.0,15.0
40.103,17,10,676,5,460,10023.0,104.0,64.0,5,216,10024.0,20.0,15.0
0.004,17,2,136,1,60,0.0,32.0,32.0,1,76,0.0,48.0,48.0
0.17,6,3,453,2,321,170.0,241.0,241.0,1,132,0.0,92.0,92.0
0.11,17,2,152,1,76,0.0,48.0,48.0,1,76,0.0,48.0,48.0
0.148,6,10,1506,5,395,35.0,127.0,127.0,5,1111,31.0,843.0,843.0
40.061,17,10,676,5,460,10014.0,104.0,64.0,5,216,10014.0,20.0,15.0
289.848,6,400,348106,202,22078,1442.0,2736.0,888.0,198,326028,1471.0,2804.0,1725.0
0.021,6,13,3735,7,497,3.0,125.0,125.0,6,3238,4.0,1470.0,1459.0
0.007,6,10,1547,5,764,1.0,496.0,496.0,5,783,1.0,515.0,515.0
0.005,6,10,1854,5,889,1.0,621.0,621.0,5,965,1.0,697.0,697.0
0.04,17,4,420,2,122,0.0,33.0,33.0,2,298,37.0,145.0,121.0
0.034,6,10,1972,5,910,8.0,642.0,642.0,5,1062,8.0,794.0,794.0
0.006,6,10,1547,5,764,1.0,496.0,496.0,5,783,1.0,515.0,515.0
0.096,6,10,1506,5,395,20.0,127.0,127.0,5,1111,20.0,843.0,843.0
0.109,6,10,1506,5,395,24.0,127.0,127.0,5,1111,23.0,843.0,843.0
0.015,17,2,198,1,91,0.0,63.0,63.0,1,107,0.0,79.0,79.0
0.011,6,10,1990,5,911,2.0,643.0,643.0,5,1079,2.0,811.0,811.0
0.006,6,10,1547,5,764,1.0,496.0,496.0,5,783,1.0,515.0,515.0
0.0,17,2,132,1,58,0.0,30.0,30.0,1,74,0.0,46.0,46.0
0.006,6,10,1547,5,764,1.0,496.0,496.0,5,783,1.0,515.0,515.0
40.061,17,10,676,5,460,10013.0,104.0,64.0,5,216,10014.0,20.0,15.0
0.041,17,2,182,1,65,0.0,37.0,37.0,1,117,0.0,89.0,89.0
0.014,6,10,1983,5,910,3.0,642.0,642.0,5,1073,3.0,805.0,805.0
0.092,6,10,1506,5,395,20.0,127.0,127.0,5,1111,21.0,843.0,843.0
240.088,6,16,4481,9,963,30011.0,238.0,166.0,7,3518,40014.0,1402.0,786.0
0.016,6,10,1972,5,910,3.0,642.0,642.0,5,1062,4.0,794.0,794.0
0.005,17,2,170,1,65,0.0,37.0,37.0,1,105,0.0,77.0,77.0
0.004,6,10,2007,5,928,1.0,660.0,660.0,5,1079,1.0,811.0,811.0
0.004,17,2,136,1,60,0.0,32.0,32.0,1,76,0.0,48.0,48.0
308.598,17,20,1124,10,716,34274.0,48.0,43.0,10,408,34274.0,20.0,12.0
183.592,6,17,2721,9,1447,22949.0,533.0,323.0,8,1274,22.0,529.0,212.0
1800.0,6,253,41382,96,31694,18947.0,2926.0,339.0,157,9688,11537.0,148.0,48.0
0.018,6,10,1989,5,910,4.0,642.0,642.0,5,1079,4.0,811.0,811.0
40.119,17,10,676,5,460,10028.0,104.0,64.0,5,216,10028.0,20.0,15.0
0.006,6,10,2000,5,927,1.0,659.0,659.0,5,1073,1.0,805.0,805.0
0.006,6,10,1689,5,839,1.0,571.0,571.0,5,850,1.0,582.0,582.0
10.762,17,26,4101,13,1845,887.0,268.0,113.0,13,2256,887.0,587.0,145.0
0.019,6,10,1983,5,910,4.0,642.0,642.0,5,1073,4.0,805.0,805.0
280.751,6,24,6440,11,1226,28075.0,267.0,156.0,13,5214,23395.0,1400.0,781.0
352.248,6,20,2210,6,1308,12004.0,494.0,494.0,14,902,27095.0,83.0,83.0
0.007,6,10,1989,5,910,1.0,642.0,642.0,5,1079,1.0,811.0,811.0
0.068,6,10,1506,5,395,15.0,127.0,127.0,5,1111,14.0,843.0,843.0
0.075,6,10,1506,5,395,17.0,127.0,127.0,5,1111,16.0,843.0,843.0
0.005,6,14,3742,8,504,0.0,80.0,80.0,6,3238,0.0,1470.0,1459.0
0.006,6,10,1547,5,764,1.0,496.0,496.0,5,783,1.0,515.0,515.0
0.006,17,2,166,1,75,0.0,47.0,47.0,1,91,0.0,63.0,63.0
0.166,17,2,152,1,76,0.0,48.0,48.0,1,76,0.0,48.0,48.0
0.005,17,2,144,1,64,0.0,36.0,36.0,1,80,0.0,52.0,52.0
0.116,6,10,1506,5,395,26.0,127.0,127.0,5,1111,24.0,843.0,843.0
40.075,17,10,676,5,460,10017.0,104.0,64.0,5,216,10017.0,20.0,15.0
40.057,17,10,676,5,460,10013.0,104.0,64.0,5,216,10013.0,20.0,15.0
0.009,17,2,132,1,58,0.0,30.0,30.0,1,74,0.0,46.0,46.0
6.168,6,37,28574,20,16569,324.0,2804.0,1553.0,17,12005,377.0,2804.0,1389.0
0.017,6,10,1983,5,910,4.0,642.0,642.0,5,1073,4.0,805.0,805.0
0.148,6,10,1506,5,395,33.0,127.0,127.0,5,1111,35.0,843.0,843.0
0.005,17,2,179,1,71,0.0,43.0,43.0,1,108,0.0,80.0,80.0
0.088,6,10,1506,5,395,21.0,127.0,127.0,5,1111,20.0,843.0,843.0
0.005,17,2,168,1,76,0.0,48.0,48.0,1,92,0.0,64.0,64.0
0.006,6,10,1547,5,764,1.0,496.0,496.0,5,783,1.0,515.0,515.0
0.005,17,2,170,1,65,0.0,37.0,37.0,1,105,0.0,77.0,77.0
0.039,17,2,182,1,65,0.0,37.0,37.0,1,117,0.0,89.0,89.0
0.065,6,10,1506,5,395,14.0,127.0,127.0,5,1111,14.0,843.0,843.0
0.005,6,10,1547,5,764,1.0,496.0,496.0,5,783,1.0,515.0,515.0
0.005,17,2,148,1,60,0.0,32.0,32.0,1,88,0.0,60.0,60.0
0.015,6,10,1762,5,911,3.0,643.0,643.0,5,851,3.0,583.0,583.0
40.063,17,10,676,5,460,10014.0,104.0,64.0,5,216,10014.0,20.0,15.0
0.039,17,2,148,1,60,0.0,32.0,32.0,1,88,0.0,60.0,60.0
0.008,6,13,3735,7,497,1.0,125.0,125.0,6,3238,1.0,1470.0,1459.0
0.005,6,10,2006,5,927,1.0,659.0,659.0,5,1079,1.0,811.0,811.0
0.004,6,10,1989,5,927,1.0,659.0,659.0,5,1062,1.0,794.0,794.0
0.004,6,10,1989,5,927,1.0,659.0,659.0,5,1062,1.0,794.0,794.0
0.005,6,14,3799,7,509,0.0,137.0,137.0,7,3290,0.0,1448.0,972.0
0.009,6,13,3735,7,497,1.0,125.0,125.0,6,3238,1.0,1470.0,1459.0
0.02,6,10,1972,5,910,5.0,642.0,642.0,5,1062,5.0,794.0,794.0
10.802,17,28,4423,14,1994,822.0,269.0,114.0,14,2429,822.0,588.0,145.0
40.058,17,10,676,5,460,10012.0,104.0,64.0,5,216,10012.0,20.0,15.0
0.005,17,2,170,1,65,0.0,37.0,37.0,1,105,0.0,77.0,77.0
0.075,6,10,1506,5,395,17.0,127.0,127.0,5,1111,17.0,843.0,843.0
0.013,6,10,1762,5,911,3.0,643.0,643.0,5,851,3.0,583.0,583.0
0.084,17,4,596,2,122,42.0,33.0,33.0,2,474,43.0,323.0,209.0
0.007,6,12,1698,6,863,1.0,327.0,271.0,6,835,1.0,515.0,515.0
0.005,6,10,2006,5,927,1.0,659.0,659.0,5,1079,1.0,811.0,811.0
0.013,6,10,1983,5,910,3.0,642.0,642.0,5,1073,3.0,805.0,805.0
0.003,17,2,136,1,60,0.0,32.0,32.0,1,76,0.0,48.0,48.0
40.068,17,10,676,5,460,10013.0,104.0,64.0,5,216,10016.0,20.0,15.0
0.106,6,10,1506,5,395,24.0,127.0,127.0,5,1111,24.0,843.0,843.0
1.065,17,23,16916,10,4278,118.0,1350.0,399.0,13,12638,83.0,1350.0,944.0
0.011,6,10,1990,5,911,2.0,643.0,643.0,5,1079,2.0,811.0,811.0
0.012,6,10,1972,5,910,3.0,642.0,642.0,5,1062,3.0,794.0,794.0
0.005,6,10,1854,5,889,1.0,621.0,621.0,5,965,1.0,697.0,697.0
40.066,17,10,676,5,460,10015.0,104.0,64.0,5,216,10015.0,20.0,15.0
0.009,6,10,1989,5,910,2.0,642.0,642.0,5,1079,2.0,811.0,811.0
0.005,6,10,2007,5,928,1.0,660.0,660.0,5,1079,1.0,811.0,811.0
0.005,6,13,3747,7,509,0.0,137.0,137.0,6,3238,0.0,1470.0,1459.0
0.08,6,10,1506,5,395,19.0,127.0,127.0,5,1111,17.0,843.0,843.0
0.005,17,2,166,1,75,0.0,47.0,47.0,1,91,0.0,63.0,63.0
0.206,6,16,2777,8,1395,29.0,533.0,323.0,8,1382,18.0,529.0,239.0
0.005,17,2,164,1,74,0.0,46.0,46.0,1,90,0.0,62.0,62.0
0.006,6,10,1547,5,764,1.0,496.0,496.0,5,783,1.0,515.0,515.0
0.015,6,10,1990,5,911,3.0,643.0,643.0,5,1079,3.0,811.0,811.0
0.082,6,10,1506,5,395,17.0,127.0,127.0,5,1111,15.0,843.0,843.0
0.01,6,10,1762,5,911,2.0,643.0,643.0,5,851,2.0,583.0,583.0
354.087,6,21,1795,16,1030,23605.0,190.0,190.0,5,765,60001.0,464.0,248.0
0.001,17,2,180,1,66,0.0,38.0,38.0,1,114,0.0,86.0,86.0
0.04,17,2,170,1,65,0.0,37.0,37.0,1,105,0.0,77.0,77.0
0.784,6,10,2009,6,1655,156.0,1403.0,1403.0,4,354,182.0,182.0,182.0
0.005,6,10,1774,5,923,1.0,655.0,655.0,5,851,1.0,583.0,583.0
0.085,6,10,1506,5,395,19.0,127.0,127.0,5,1111,16.0,843.0,843.0
0.083,6,10,1506,5,395,16.0,127.0,127.0,5,1111,19.0,843.0,843.0
0.099,6,10,1506,5,395,19.0,127.0,127.0,5,1111,23.0,843.0,843.0
1.516,6,142,99590,73,96641,17.0,1414.0,1358.0,69,2949,18.0,177.0,177.0
0.005,17,2,144,1,64,0.0,36.0,36.0,1,80,0.0,52.0,52.0
0.012,6,10,1762,5,911,2.0,643.0,643.0,5,851,3.0,583.0,583.0
0.012,6,10,1990,5,911,2.0,643.0,643.0,5,1079,2.0,811.0,811.0
40.056,17,10,676,5,460,10013.0,104.0,64.0,5,216,10013.0,20.0,15.0
1787.46,6,155,19626,92,13852,19642.0,302.0,302.0,63,5774,28829.0,83.0,83.0
0.006,6,13,3747,7,509,0.0,137.0,137.0,6,3238,1.0,1470.0,1459.0
0.004,6,10,1989,5,927,1.0,659.0,659.0,5,1062,1.0,794.0,794.0
0.125,6,10,1506,5,395,26.0,127.0,127.0,5,1111,25.0,843.0,843.0
0.005,6,10,2006,5,927,1.0,659.0,659.0,5,1079,1.0,811.0,811.0
0.005,6,10,2000,5,927,1.0,659.0,659.0,5,1073,1.0,805.0,805.0
0.003,17,2,185,1,73,0.0,45.0,45.0,1,112,0.0,84.0,84.0
0.001,17,2,136,1,60,0.0,32.0,32.0,1,76,0.0,48.0,48.0
0.005,6,10,1854,5,889,1.0,621.0,621.0,5,965,1.0,697.0,697.0
0.118,6,10,1506,5,395,20.0,127.0,127.0,5,1111,26.0,843.0,843.0
0.005,17,2,180,1,58,0.0,30.0,30.0,1,122,0.0,94.0,94.0
0.004,6,10,2006,5,927,1.0,659.0,659.0,5,1079,1.0,811.0,811.0
0.01,6,10,1989,5,910,2.0,642.0,642.0,5,1079,2.0,811.0,811.0
40.052,17,10,676,5,460,10012.0,104.0,64.0,5,216,10012.0,20.0,15.0
0.012,6,13,3735,7,497,2.0,125.0,125.0,6,3238,2.0,1470.0,1459.0
0.086,6,10,1506,5,395,18.0,127.0,127.0,5,1111,20.0,843.0,843.0
0.001,17,2,212,1,64,0.0,36.0,36.0,1,148,0.0,120.0,120.0
0.006,17,2,293,1,73,0.0,45.0,45.0,1,220,0.0,192.0,192.0
240.112,6,31,8995,15,6714,17150.0,1839.0,659.0,16,2281,16007.0,580.0,180.0
176.371,17,78,10955,39,2595,4641.0,44.0,38.0,39,8360,4641.0,239.0,186.0
0.015,6,11,2041,6,962,3.0,642.0,642.0,5,1079,3.0,811.0,811.0
0.004,6,10,1702,5,863,1.0,595.0,595.0,5,839,1.0,571.0,571.0
0.073,17,2,184,1,61,0.0,33.0,33.0,1,123,0.0,95.0,95.0
166.124,17,76,10890,38,2530,4489.0,44.0,38.0,38,8360,4489.0,239.0,192.0
0.005,6,10,2000,5,927,1.0,659.0,659.0,5,1073,1.0,805.0,805.0
0.134,6,10,1506,5,395,30.0,127.0,127.0,5,1111,30.0,843.0,843.0
0.005,6,10,2006,5,927,1.0,659.0,659.0,5,1079,1.0,811.0,811.0
0.098,6,10,1506,5,395,21.0,127.0,127.0,5,1111,23.0,843.0,843.0
0.13,6,10,1506,5,395,29.0,127.0,127.0,5,1111,24.0,843.0,843.0
0.025,6,10,1972,5,910,6.0,642.0,642.0,5,1062,6.0,794.0,794.0
0.089,6,10,1506,5,395,20.0,127.0,127.0,5,1111,20.0,843.0,843.0
0.1,6,10,1506,5,395,23.0,127.0,127.0,5,1111,21.0,843.0,843.0
0.108,6,10,1506,5,395,25.0,127.0,127.0,5,1111,23.0,843.0,843.0
0.005,6,10,1689,5,839,1.0,571.0,571.0,5,850,1.0,582.0,582.0
166.393,17,84,12106,42,2813,4058.0,44.0,38.0,42,9293,4058.0,252.0,193.0
10.839,17,28,4423,14,1995,823.0,270.0,114.0,14,2428,825.0,587.0,145.0
0.082,6,10,1506,5,395,19.0,127.0,127.0,5,1111,16.0,843.0,843.0
40.065,17,10,676,5,460,10013.0,104.0,64.0,5,216,10015.0,20.0,15.0
0.007,6,10,1762,5,911,1.0,643.0,643.0,5,851,1.0,583.0,583.0
40.06,17,10,676,5,460,10014.0,104.0,64.0,5,216,10014.0,20.0,15.0
12.08,58,2,144,1,72,0.0,24.0,24.0,1,72,0.0,24.0,24.0
0.078,6,10,1506,5,395,17.0,127.0,127.0,5,1111,18.0,843.0,843.0
0.042,17,4,596,2,122,1.0,33.0,33.0,2,474,2.0,323.0,209.0
0.054,17,2,152,1,76,0.0,48.0,48.0,1,76,0.0,48.0,48.0
0.005,17,2,164,1,74,0.0,46.0,46.0,1,90,0.0,62.0,62.0
178.296,17,70,10105,35,2334,5243.0,44.0,38.0,35,7771,5243.0,239.0,194.0
0.017,6,10,1989,5,910,4.0,642.0,642.0,5,1079,4.0,811.0,811.0
0.015,6,10,1989,5,910,3.0,642.0,642.0,5,1079,3.0,811.0,811.0
0.006,17,2,179,1,71,0.0,43.0,43.0,1,108,0.0,80.0,80.0
40.063,17,10,676,5,460,10013.0,104.0,64.0,5,216,10015.0,20.0,15.0
0.017,6,10,1990,5,911,4.0,643.0,643.0,5,1079,4.0,811.0,811.0
40.066,17,10,676,5,460,10015.0,104.0,64.0,5,216,10015.0,20.0,15.0
0.016,6,10,1972,5,910,4.0,642.0,642.0,5,1062,4.0,794.0,794.0
0.004,6,10,1989,5,927,1.0,659.0,659.0,5,1062,1.0,794.0,794.0
0.007,6,10,1689,5,839,1.0,571.0,571.0,5,850,1.0,582.0,582.0
0.033,6,10,1762,5,911,8.0,643.0,643.0,5,851,8.0,583.0,583.0
0.015,6,10,1990,5,911,3.0,643.0,643.0,5,1079,3.0,811.0,811.0
0.018,6,10,1972,5,910,4.0,642.0,642.0,5,1062,4.0,794.0,794.0
0.005,6,10,2007,5,928,1.0,660.0,660.0,5,1079,1.0,811.0,811.0
0.008,6,10,1972,5,910,2.0,642.0,642.0,5,1062,1.0,794.0,794.0
0.004,17,4,284,2,120,1.0,32.0,32.0,2,164,1.0,60.0,54.0
0.005,6,10,1689,5,839,1.0,571.0,571.0,5,850,1.0,582.0,582.0
0.005,6,10,2007,5,928,1.0,660.0,660.0,5,1079,1.0,811.0,811.0
0.091,6,10,1506,5,395,21.0,127.0,127.0,5,1111,18.0,843.0,843.0
240.032,6,9,787,5,488,60008.0,232.0,232.0,4,299,80009.0,83.0,83.0
0.005,17,2,166,1,75,0.0,47.0,47.0,1,91,0.0,63.0,63.0
0.005,17,2,169,1,62,0.0,34.0,34.0,1,107,0.0,79.0,79.0
0.006,6,14,3799,7,509,1.0,137.0,137.0,7,3290,1.0,1448.0,972.0
0.008,6,10,1989,5,910,1.0,642.0,642.0,5,1079,2.0,811.0,811.0
0.012,6,13,3735,7,497,2.0,125.0,125.0,6,3238,2.0,1470.0,1459.0
0.004,6,10,1730,5,513,1.0,245.0,245.0,5,1217,1.0,949.0,949.0
15.075,17,15,9239,8,6902,2149.0,1350.0,834.0,7,2337,2507.0,1350.0,305.0
0.013,6,10,1989,5,910,3.0,642.0,642.0,5,1079,3.0,811.0,811.0
0.004,17,2,136,1,60,0.0,32.0,32.0,1,76,0.0,48.0,48.0
0.005,17,2,144,1,64,0.0,36.0,36.0,1,80,0.0,52.0,52.0
361.785,6,19,1689,15,978,25841.0,190.0,190.0,4,711,80013.0,495.0,495.0
0.014,6,10,1989,5,910,3.0,642.0,642.0,5,1079,3.0,811.0,811.0
0.009,6,12,1926,6,1189,1.0,659.0,434.0,6,737,1.0,417.0,417.0
0.099,6,10,1506,5,395,21.0,127.0,127.0,5,1111,19.0,843.0,843.0
0.074,17,2,184,1,61,0.0,33.0,33.0,1,123,0.0,95.0,95.0
8.963,6,39,10487,20,4929,471.0,1360.0,682.0,19,5558,486.0,2667.0,435.0
0.005,17,2,180,1,66,0.0,38.0,38.0,1,114,0.0,86.0,86.0
0.005,6,10,2006,5,927,1.0,659.0,659.0,5,1079,1.0,811.0,811.0
0.092,6,10,1506,5,395,20.0,127.0,127.0,5,1111,20.0,843.0,843.0
40.071,17,10,676,5,460,10015.0,104.0,64.0,5,216,10017.0,20.0,15.0
285.199,6,30,6574,16,1433,19013.0,517.0,290.0,14,5141,21938.0,2379.0,1104.0
0.004,6,10,1774,5,923,1.0,655.0,655.0,5,851,1.0,583.0,583.0
0.003,17,2,162,1,65,0.0,37.0,37.0,1,97,0.0,69.0,69.0
0.009,6,13,3735,7,497,1.0,125.0,125.0,6,3238,1.0,1470.0,1459.0
0.074,6,10,1506,5,395,16.0,127.0,127.0,5,1111,15.0,843.0,843.0
0.001,17,2,136,1,60,0.0,32.0,32.0,1,76,0.0,48.0,48.0
0.005,6,10,1854,5,889,1.0,621.0,621.0,5,965,1.0,697.0,697.0
0.008,6,10,1989,5,910,2.0,642.0,642.0,5,1079,2.0,811.0,811.0
0.004,17,2,154,1,69,0.0,41.0,41.0,1,85,0.0,57.0,57.0
0.011,6,10,1972,5,910,2.0,642.0,642.0,5,1062,2.0,794.0,794.0
0.011,6,6,716,3,458,4.0,302.0,302.0,3,258,4.0,102.0,102.0
0.041,17,2,152,1,76,0.0,48.0,48.0,1,76,0.0,48.0,48.0
0.005,6,10,1989,5,927,1.0,659.0,659.0,5,1062,1.0,794.0,794.0
0.012,6,10,1983,5,910,2.0,642.0,642.0,5,1073,2.0,805.0,805.0
0.151,6,10,1506,5,395,34.0,127.0,127.0,5,1111,35.0,843.0,843.0
0.073,6,10,1506,5,395,16.0,127.0,127.0,5,1111,17.0,843.0,843.0
0.005,6,10,2006,5,927,1.0,659.0,659.0,5,1079,1.0,811.0,811.0
0.005,6,14,3799,7,509,0.0,137.0,137.0,7,3290,0.0,1448.0,972.0
0.094,6,10,1506,5,395,19.0,127.0,127.0,5,1111,22.0,843.0,843.0
0.006,6,10,1854,5,889,1.0,621.0,621.0,5,965,1.0,697.0,697.0
0.005,6,13,3747,7,509,0.0,137.0,137.0,6,3238,1.0,1470.0,1459.0
0.006,6,10,1547,5,764,1.0,496.0,496.0,5,783,1.0,515.0,515.0
0.004,6,10,2006,5,927,1.0,659.0,659.0,5,1079,1.0,811.0,811.0
0.005,6,10,2007,5,928,1.0,660.0,660.0,5,1079,1.0,811.0,811.0
0.005,6,10,2006,5,927,1.0,659.0,659.0,5,1079,1.0,811.0,811.0
0.011,6,10,1990,5,911,2.0,643.0,643.0,5,1079,2.0,811.0,811.0
0.02,6,10,1989,5,910,4.0,642.0,642.0,5,1079,4.0,811.0,811.0
0.01,6,10,1983,5,910,2.0,642.0,642.0,5,1073,2.0,805.0,805.0
361.796,6,19,1689,15,978,25842.0,190.0,190.0,4,711,80013.0,495.0,495.0
0.005,6,10,2000,5,927,1.0,659.0,659.0,5,1073,1.0,805.0,805.0
0.087,6,10,1506,5,395,18.0,127.0,127.0,5,1111,17.0,843.0,843.0
0.005,17,2,144,1,64,0.0,36.0,36.0,1,80,0.0,52.0,52.0
0.065,6,10,1506,5,395,15.0,127.0,127.0,5,1111,14.0,843.0,843.0
0.013,6,10,1989,5,910,3.0,642.0,642.0,5,1079,3.0,811.0,811.0
308.273,17,20,1124,10,716,34244.0,48.0,43.0,10,408,34243.0,20.0,12.0
240.479,6,43,8771,22,5738,11451.0,1368.0,458.0,21,3033,12023.0,580.0,241.0
179.122,17,78,11089,39,2600,4713.0,44.0,38.0,39,8489,4713.0,239.0,189.0
0.007,6,13,3690,7,452,1.0,80.0,80.0,6,3238,1.0,1470.0,1459.0
0.006,6,10,1547,5,764,1.0,496.0,496.0,5,783,1.0,515.0,515.0
0.09,6,10,1506,5,395,19.0,127.0,127.0,5,1111,20.0,843.0,843.0
0.004,6,10,1779,5,928,1.0,660.0,660.0,5,851,0.0,583.0,583.0
0.101,6,10,1506,5,395,21.0,127.0,127.0,5,1111,20.0,843.0,843.0
0.005,17,2,166,1,75,0.0,47.0,47.0,1,91,0.0,63.0,63.0
1778.611,17,143,41496,72,22752,25050.0,288.0,288.0,71,18744,25408.0,236.0,236.0
40.071,17,10,676,5,460,10015.0,104.0,64.0,5,216,10016.0,20.0,15.0
0.069,17,8,3613,4,1874,23.0,1350.0,440.0,4,1739,10.0,1350.0,406.0
0.16,6,10,1506,5,395,29.0,127.0,127.0,5,1111,37.0,843.0,843.0
0.018,17,2,148,1,60,0.0,32.0,32.0,1,88,0.0,60.0,60.0
0.012,6,10,1990,5,911,2.0,643.0,643.0,5,1079,2.0,811.0,811.0
0.01,6,10,1972,5,910,2.0,642.0,642.0,5,1062,2.0,794.0,794.0
0.038,17,2,184,1,61,0.0,33.0,33.0,1,123,0.0,95.0,95.0
0.004,17,2,136,1,60,0.0,32.0,32.0,1,76,0.0,48.0,48.0
0.091,6,10,1506,5,395,20.0,127.0,127.0,5,1111,20.0,843.0,843.0
0.003,17,2,148,1,60,0.0,32.0,32.0,1,88,0.0,60.0,60.0
0.006,6,10,1547,5,764,1.0,496.0,496.0,5,783,1.0,515.0,515.0
0.006,6,10,1689,5,839,1.0,571.0,571.0,5,850,1.0,582.0,582.0
0.008,6,10,1972,5,910,2.0,642.0,642.0,5,1062,2.0,794.0,794.0
0.011,6,10,1989,5,910,2.0,642.0,642.0,5,1079,2.0,811.0,811.0
0.039,17,2,152,1,76,0.0,48.0,48.0,1,76,0.0,48.0,48.0
0.013,6,10,1989,5,910,3.0,642.0,642.0,5,1079,3.0,811.0,811.0
0.005,6,10,1989,5,927,1.0,659.0,659.0,5,1062,1.0,794.0,794.0
0.006,6,10,1689,5,839,1.0,571.0,571.0,5,850,1.0,582.0,582.0
0.075,6,10,1506,5,395,16.0,127.0,127.0,5,1111,15.0,843.0,843.0
0.04,17,2,182,1,65,0.0,37.0,37.0,1,117,0.0,89.0,89.0
0.065,6,10,1506,5,395,13.0,127.0,127.0,5,1111,12.0,843.0,843.0
0.161,17,2,152,1,76,0.0,48.0,48.0,1,76,0.0,48.0,48.0
0.052,6,10,1631,5,848,13.0,580.0,580.0,5,783,13.0,515.0,515.0
0.013,17,2,179,1,71,0.0,43.0,43.0,1,108,0.0,80.0,80.0
0.029,6,10,1972,5,910,7.0,642.0,642.0,5,1062,7.0,794.0,794.0
0.004,17,2,136,1,60,0.0,32.0,32.0,1,76,0.0,48.0,48.0
0.138,6,10,1506,5,395,34.0,127.0,127.0,5,1111,32.0,843.0,843.0
0.005,6,10,2006,5,927,1.0,659.0,659.0,5,1079,1.0,811.0,811.0
0.005,6,10,2000,5,927,1.0,659.0,659.0,5,1073,1.0,805.0,805.0
0.004,6,10,1702,5,863,1.0,595.0,595.0,5,839,0.0,571.0,571.0
0.005,6,10,2000,5,927,1.0,659.0,659.0,5,1073,1.0,805.0,805.0
0.08,6,10,1506,5,395,18.0,127.0,127.0,5,1111,15.0,843.0,843.0
40.059,17,10,676,5,460,10013.0,104.0,64.0,5,216,10013.0,20.0,15.0
0.069,17,8,3613,4,1874,23.0,1350.0,440.0,4,1739,11.0,1350.0,406.0
40.063,17,10,676,5,460,10015.0,104.0,64.0,5,216,10015.0,20.0,15.0
0.102,6,10,1506,5,395,23.0,127.0,127.0,5,1111,25.0,843.0,843.0
0.004,6,10,1989,5,927,1.0,659.0,659.0,5,1062,1.0,794.0,794.0
0.005,6,10,2007,5,928,1.0,660.0,660.0,5,1079,1.0,811.0,811.0
0.129,17,4,596,2,122,0.0,33.0,33.0,2,474,57.0,323.0,209.0
0.101,6,10,1506,5,395,22.0,127.0,127.0,5,1111,23.0,843.0,843.0
323.984,17,14,812,7,532,53977.0,48.0,48.0,7,280,53975.0,12.0,12.0
0.006,6,10,2007,5,928,1.0,660.0,660.0,5,1079,1.0,811.0,811.0
0.005,6,10,2006,5,927,1.0,659.0,659.0,5,1079,1.0,811.0,811.0
0.001,17,2,180,1,65,0.0,37.0,37.0,1,115,0.0,87.0,87.0
0.086,6,10,1506,5,395,18.0,127.0,127.0,5,1111,19.0,843.0,843.0
0.075,6,10,1506,5,395,17.0,127.0,127.0,5,1111,16.0,843.0,843.0
0.022,6,10,1990,5,911,5.0,643.0,643.0,5,1079,5.0,811.0,811.0
0.08,6,10,1506,5,395,18.0,127.0,127.0,5,1111,18.0,843.0,843.0
0.288,17,47,27032,26,23452,11.0,1350.0,874.0,21,3580,11.0,1350.0,142.0
0.012,6,10,1990,5,911,2.0,643.0,643.0,5,1079,2.0,811.0,811.0
0.006,17,2,179,1,71,0.0,43.0,43.0,1,108,0.0,80.0,80.0
0.006,17,2,170,1,65,0.0,37.0,37.0,1,105,0.0,77.0,77.0
0.008,6,10,1972,5,910,2.0,642.0,642.0,5,1062,1.0,794.0,794.0
0.001,17,2,179,1,62,0.0,34.0,34.0,1,117,0.0,89.0,89.0
0.008,6,10,1989,5,910,2.0,642.0,642.0,5,1079,2.0,811.0,811.0
0.012,6,10,1631,5,848,3.0,580.0,580.0,5,783,3.0,515.0,515.0
0.01,6,10,1677,5,827,2.0,559.0,559.0,5,850,2.0,582.0,582.0
366.837,6,22,2313,16,867,24455.0,195.0,195.0,6,1446,4638.0,419.0,398.0
0.009,6,10,1989,5,910,2.0,642.0,642.0,5,1079,2.0,811.0,811.0
0.102,6,10,1506,5,395,24.0,127.0,127.0,5,1111,22.0,843.0,843.0
0.039,17,2,156,1,64,0.0,36.0,36.0,1,92,0.0,64.0,64.0
308.707,17,20,1124,10,716,34285.0,48.0,43.0,10,408,34285.0,20.0,12.0
0.009,6,10,1677,5,827,2.0,559.0,559.0,5,850,2.0,582.0,582.0
0.005,17,2,302,1,65,0.0,37.0,37.0,1,237,0.0,209.0,209.0
1.09,6,27,10460,14,1575,83.0,517.0,211.0,13,8885,90.0,1402.0,911.0
0.101,6,10,1506,5,395,22.0,127.0,127.0,5,1111,19.0,843.0,843.0
0.134,6,10,1506,5,395,30.0,127.0,127.0,5,1111,30.0,843.0,843.0
0.09,6,10,1506,5,395,20.0,127.0,127.0,5,1111,18.0,843.0,843.0
0.008,6,10,1990,5,911,1.0,643.0,643.0,5,1079,1.0,811.0,811.0
0.087,6,10,1506,5,395,20.0,127.0,127.0,5,1111,19.0,843.0,843.0
10.92,17,28,4422,14,1994,831.0,269.0,114.0,14,2428,831.0,587.0,145.0
0.001,17,2,136,1,60,0.0,32.0,32.0,1,76,0.0,48.0,48.0
0.084,6,10,1506,5,395,18.0,127.0,127.0,5,1111,16.0,843.0,843.0
0.006,6,10,1689,5,839,1.0,571.0,571.0,5,850,1.0,582.0,582.0
0.005,6,10,1547,5,764,1.0,496.0,496.0,5,783,1.0,515.0,515.0
0.004,6,10,1702,5,863,0.0,595.0,595.0,5,839,1.0,571.0,571.0
300.281,6,27,7436,16,1409,20018.0,217.0,142.0,11,6027,24021.0,1679.0,778.0
0.015,6,10,1972,5,910,3.0,642.0,642.0,5,1062,3.0,794.0,794.0
0.005,6,10,1854,5,889,1.0,621.0,621.0,5,965,1.0,697.0,697.0
0.013,6,12,1926,6,1189,2.0,659.0,434.0,6,737,2.0,417.0,417.0
0.001,17,2,180,1,66,0.0,38.0,38.0,1,114,0.0,86.0,86.0
0.114,6,10,1506,5,395,22.0,127.0,127.0,5,1111,24.0,843.0,843.0
0.111,6,10,1506,5,395,25.0,127.0,127.0,5,1111,21.0,843.0,843.0
0.005,6,10,2000,5,927,1.0,659.0,659.0,5,1073,1.0,805.0,805.0
0.005,6,10,2006,5,927,1.0,659.0,659.0,5,1079,1.0,811.0,811.0
0.012,6,13,3735,7,497,2.0,125.0,125.0,6,3238,2.0,1470.0,1459.0
15.082,17,16,9303,8,6912,2150.0,1350.0,836.0,8,2391,2150.0,1350.0,270.0
0.304,17,40,20080,22,17086,14.0,1350.0,748.0,18,2994,12.0,1350.0,138.0
0.013,6,10,1990,5,911,3.0,643.0,643.0,5,1079,3.0,811.0,811.0
0.072,6,10,1506,5,395,15.0,127.0,127.0,5,1111,16.0,843.0,843.0
0.02,6,14,3787,7,497,3.0,125.0,125.0,7,3290,3.0,1448.0,972.0
0.009,6,10,1972,5,910,2.0,642.0,642.0,5,1062,2.0,794.0,794.0
0.385,17,40,20205,22,17078,18.0,1350.0,748.0,18,3127,18.0,1350.0,145.0
0.014,6,10,1983,5,910,3.0,642.0,642.0,5,1073,3.0,805.0,805.0
0.003,17,2,148,1,60,0.0,32.0,32.0,1,88,0.0,60.0,60.0
0.003,17,2,148,1,60,0.0,32.0,32.0,1,88,0.0,60.0,60.0
0.001,17,2,180,1,66,0.0,38.0,38.0,1,114,0.0,86.0,86.0
0.006,17,2,164,1,74,0.0,46.0,46.0,1,90,0.0,62.0,62.0
40.056,17,10,676,5,460,10013.0,104.0,64.0,5,216,10013.0,20.0,15.0
0.011,6,10,1989,5,910,2.0,642.0,642.0,5,1079,2.0,811.0,811.0
0.004,6,10,1702,5,863,1.0,595.0,595.0,5,839,1.0,571.0,571.0
0.019,6,10,1990,5,911,4.0,643.0,643.0,5,1079,4.0,811.0,811.0
0.144,6,10,1506,5,395,34.0,127.0,127.0,5,1111,26.0,843.0,843.0
0.012,6,13,3735,7,497,1.0,125.0,125.0,6,3238,2.0,1470.0,1459.0
0.005,17,2,166,1,75,0.0,47.0,47.0,1,91,0.0,63.0,63.0
0.006,6,10,1547,5,764,1.0,496.0,496.0,5,783,1.0,515.0,515.0
0.065,6,10,1506,5,395,13.0,127.0,127.0,5,1111,14.0,843.0,843.0
0.041,17,2,412,1,61,0.0,33.0,33.0,1,351,0.0,323.0,323.0
0.077,6,10,1506,5,395,16.0,127.0,127.0,5,1111,17.0,843.0,843.0
240.013,6,9,787,5,488,60003.0,232.0,232.0,4,299,80002.0,83.0,83.0
0.005,6,10,1689,5,839,1.0,571.0,571.0,5,850,1.0,582.0,582.0
0.004,6,10,2006,5,927,1.0,659.0,659.0,5,1079,1.0,811.0,811.0
0.014,6,10,1762,5,911,3.0,643.0,643.0,5,851,3.0,583.0,583.0
0.004,6,10,2000,5,927,1.0,659.0,659.0,5,1073,1.0,805.0,805.0
0.006,6,10,1689,5,839,1.0,571.0,571.0,5,850,1.0,582.0,582.0
0.009,6,10,1972,5,910,2.0,642.0,642.0,5,1062,2.0,794.0,794.0
0.004,6,10,2000,5,927,1.0,659.0,659.0,5,1073,1.0,805.0,805.0
0.004,6,10,2006,5,927,1.0,659.0,659.0,5,1079,1.0,811.0,811.0
0.113,6,10,1506,5,395,26.0,127.0,127.0,5,1111,26.0,843.0,843.0
15.073,17,15,9238,8,6902,2149.0,1350.0,834.0,7,2336,2507.0,1350.0,305.0
0.006,6,10,2006,5,927,1.0,659.0,659.0,5,1079,1.0,811.0,811.0
0.005,6,10,1689,5,839,1.0,571.0,571.0,5,850,1.0,582.0,582.0
0.004,6,10,1989,5,927,1.0,659.0,659.0,5,1062,1.0,794.0,794.0
40.052,17,10,676,5,460,10012.0,104.0,64.0,5,216,10012.0,20.0,15.0
0.005,6,10,1989,5,927,1.0,659.0,659.0,5,1062,1.0,794.0,794.0
0.073,6,10,1506,5,395,16.0,127.0,127.0,5,1111,15.0,843.0,843.0
10.9,17,28,4423,14,1994,830.0,269.0,114.0,14,2429,830.0,588.0,145.0
0.005,6,14,3742,7,452,0.0,80.0,80.0,7,3290,0.0,1448.0,972.0
0.021,6,10,1983,5,910,5.0,642.0,642.0,5,1073,5.0,805.0,805.0
0.005,6,10,2007,5,928,1.0,660.0,660.0,5,1079,1.0,811.0,811.0
0.006,6,10,2006,5,927,1.0,659.0,659.0,5,1079,1.0,811.0,811.0
0.007,17,2,166,1,75,0.0,47.0,47.0,1,91,0.0,63.0,63.0
40.085,17,10,676,5,460,10020.0,104.0,64.0,5,216,10020.0,20.0,15.0
0.004,6,10,1702,5,863,1.0,595.0,595.0,5,839,1.0,571.0,571.0
0.063,6,10,1506,5,395,14.0,127.0,127.0,5,1111,14.0,843.0,843.0
0.039,17,2,166,1,75,0.0,47.0,47.0,1,91,0.0,63.0,63.0
0.004,6,10,1989,5,927,1.0,659.0,659.0,5,1062,1.0,794.0,794.0
300.023,6,12,1782,7,1348,50003.0,494.0,494.0,5,434,75004.0,83.0,83.0
0.005,6,13,3747,7,509,0.0,137.0,137.0,6,3238,0.0,1470.0,1459.0
0.008,6,10,1972,5,910,2.0,642.0,642.0,5,1062,1.0,794.0,794.0
0.006,6,10,1989,5,927,1.0,659.0,659.0,5,1062,1.0,794.0,794.0
0.07,6,10,1506,5,395,15.0,127.0,127.0,5,1111,13.0,843.0,843.0
0.089,6,10,1506,5,395,20.0,127.0,127.0,5,1111,16.0,843.0,843.0
240.013,6,9,787,5,488,60003.0,232.0,232.0,4,299,80003.0,83.0,83.0
0.005,17,2,166,1,75,0.0,47.0,47.0,1,91,0.0,63.0,63.0
40.061,17,10,676,5,460,10013.0,104.0,64.0,5,216,10014.0,20.0,15.0
0.112,6,10,1506,5,395,25.0,127.0,127.0,5,1111,24.0,843.0,843.0
0.017,6,10,1990,5,911,4.0,643.0,643.0,5,1079,4.0,811.0,811.0
0.018,6,10,1972,5,910,4.0,642.0,642.0,5,1062,4.0,794.0,794.0
0.014,6,10,1677,5,827,3.0,559.0,559.0,5,850,3.0,582.0,582.0
0.011,6,10,1989,5,910,2.0,642.0,642.0,5,1079,2.0,811.0,811.0
0.006,6,13,3690,7,452,0.0,80.0,80.0,6,3238,1.0,1470.0,1459.0
0.019,6,10,1762,5,911,4.0,643.0,643.0,5,851,4.0,583.0,583.0
0.016,6,10,1989,5,910,4.0,642.0,642.0,5,1079,3.0,811.0,811.0
40.074,17,10,676,5,460,10017.0,104.0,64.0,5,216,10017.0,20.0,15.0
0.013,17,4,420,2,122,9.0,33.0,33.0,2,298,11.0,145.0,121.0
40.076,17,10,676,5,460,10017.0,104.0,64.0,5,216,10018.0,20.0,15.0
0.005,6,10,2006,5,927,1.0,659.0,659.0,5,1079,1.0,811.0,811.0
0.071,17,2,234,1,61,0.0,33.0,33.0,1,173,0.0,145.0,145.0
240.124,6,31,9238,15,6937,17151.0,2060.0,684.0,16,2301,16008.0,580.0,182.0
0.006,6,10,1547,5,764,1.0,496.0,496.0,5,783,1.0,515.0,515.0
330.208,6,19,2158,6,1308,12021.0,494.0,494.0,13,850,27514.0,83.0,83.0
325.24,17,20,1124,10,716,36131.0,48.0,43.0,10,408,36131.0,20.0,12.0
0.006,17,2,179,1,71,0.0,43.0,43.0,1,108,0.0,80.0,80.0
0.124,6,10,1506,5,395,28.0,127.0,127.0,5,1111,28.0,843.0,843.0
0.119,6,10,1506,5,395,23.0,127.0,127.0,5,1111,25.0,843.0,843.0
0.01,6,12,1926,6,1189,2.0,659.0,434.0,6,737,2.0,417.0,417.0
280.232,6,22,6035,10,1186,31136.0,267.0,156.0,12,4849,25474.0,1400.0,873.0
0.006,17,2,213,1,69,0.0,41.0,41.0,1,144,0.0,116.0,116.0
0.072,6,10,1506,5,395,15.0,127.0,127.0,5,1111,16.0,843.0,843.0
0.006,6,10,1762,5,911,1.0,643.0,643.0,5,851,1.0,583.0,583.0
0.005,17,2,148,1,60,0.0,32.0,32.0,1,88,0.0,60.0,60.0
40.08,17,10,676,5,460,10019.0,104.0,64.0,5,216,10019.0,20.0,15.0
40.06,17,10,676,5,460,10014.0,104.0,64.0,5,216,10013.0,20.0,15.0
0.019,6,10,1990,5,911,4.0,643.0,643.0,5,1079,4.0,811.0,811.0
63.782,6,36,8316,19,1885,3543.0,777.0,364.0,17,6431,545.0,2126.0,478.0
0.011,6,10,1983,5,910,2.0,642.0,642.0,5,1073,2.0,805.0,805.0
0.083,6,10,1506,5,395,19.0,127.0,127.0,5,1111,16.0,843.0,843.0
40.061,17,10,676,5,460,10013.0,104.0,64.0,5,216,10014.0,20.0,15.0
353.504,6,20,2210,6,1308,12004.0,494.0,494.0,14,902,27192.0,83.0,83.0
0.094,6,10,1506,5,395,14.0,127.0,127.0,5,1111,21.0,843.0,843.0
0.004,17,2,136,1,60,0.0,32.0,32.0,1,76,0.0,48.0,48.0
0.048,17,2,170,1,65,0.0,37.0,37.0,1,105,0.0,77.0,77.0
0.038,17,4,284,2,120,0.0,32.0,32.0,2,164,34.0,60.0,54.0
0.004,17,2,148,1,60,0.0,32.0,32.0,1,88,0.0,60.0,60.0
0.006,6,10,1547,5,764,1.0,496.0,496.0,5,783,1.0,515.0,515.0
0.005,17,2,140,1,62,0.0,34.0,34.0,1,78,0.0,50.0,50.0
0.037,17,2,128,1,56,0.0,28.0,28.0,1,72,0.0,44.0,44.0
0.003,17,2,136,1,60,0.0,32.0,32.0,1,76,0.0,48.0,48.0
0.054,6,10,1983,5,910,13.0,642.0,642.0,5,1073,13.0,805.0,805.0
0.07,17,8,3613,4,1874,23.0,1350.0,440.0,4,1739,11.0,1350.0,406.0
0.004,6,10,2006,5,927,1.0,659.0,659.0,5,1079,1.0,811.0,811.0
0.11,6,10,1506,5,395,24.0,127.0,127.0,5,1111,22.0,843.0,843.0
0.014,6,10,1990,5,911,3.0,643.0,643.0,5,1079,3.0,811.0,811.0
0.121,6,10,1506,5,395,28.0,127.0,127.0,5,1111,25.0,843.0,843.0
9.045,17,6,376,5,280,2261.0,28.0,28.0,1,96,0.0,68.0,68.0
0.005,6,14,3742,7,452,0.0,80.0,80.0,7,3290,0.0,1448.0,972.0
0.005,6,10,1989,5,927,1.0,659.0,659.0,5,1062,1.0,794.0,794.0
0.016,17,2,198,1,91,0.0,63.0,63.0,1,107,0.0,79.0,79.0
0.005,17,2,168,1,76,0.0,48.0,48.0,1,92,0.0,64.0,64.0
0.013,6,10,1989,5,910,3.0,642.0,642.0,5,1079,3.0,811.0,811.0
0.005,6,10,1643,5,860,1.0,592.0,592.0,5,783,1.0,515.0,515.0
0.006,6,13,3690,7,452,0.0,80.0,80.0,6,3238,1.0,1470.0,1459.0
0.087,6,10,1506,5,395,18.0,127.0,127.0,5,1111,20.0,843.0,843.0
0.005,6,10,2000,5,927,1.0,659.0,659.0,5,1073,1.0,805.0,805.0
0.006,6,10,1547,5,764,1.0,496.0,496.0,5,783,1.0,515.0,515.0
178.202,17,78,10827,39,2599,4689.0,44.0,38.0,39,8228,4689.0,239.0,182.0
49.85,6,33,6264,18,1338,2932.0,267.0,195.0,15,4926,618.0,1823.0,392.0
0.016,6,10,1990,5,911,4.0,643.0,643.0,5,1079,4.0,811.0,811.0
176.608,17,84,12086,42,2832,4307.0,44.0,39.0,42,9254,4307.0,239.0,192.0
0.006,6,10,1547,5,764,1.0,496.0,496.0,5,783,1.0,515.0,515.0
0.019,6,10,1762,5,911,4.0,643.0,643.0,5,851,4.0,583.0,583.0
308.23,17,20,1124,10,716,34233.0,48.0,43.0,10,408,34233.0,20.0,12.0
0.019,6,10,1972,5,910,4.0,642.0,642.0,5,1062,4.0,794.0,794.0
0.004,6,10,2006,5,927,1.0,659.0,659.0,5,1079,1.0,811.0,811.0
1778.395,17,144,45504,74,23384,24361.0,288.0,288.0,70,22120,25411.0,288.0,288.0
0.014,6,10,1989,5,910,3.0,642.0,642.0,5,1079,3.0,811.0,811.0
241.879,6,305,343130,111,17287,2198.0,2736.0,959.0,194,325843,1253.0,2804.0,1716.0
0.009,6,10,1990,5,911,2.0,643.0,643.0,5,1079,2.0,811.0,811.0
0.004,6,10,1779,5,928,1.0,660.0,660.0,5,851,1.0,583.0,583.0
0.037,6,10,1983,5,910,9.0,642.0,642.0,5,1073,9.0,805.0,805.0
40.069,17,10,676,5,460,10016.0,104.0,64.0,5,216,10016.0,20.0,15.0
0.019,6,10,1989,5,910,4.0,642.0,642.0,5,1079,4.0,811.0,811.0
1772.244,6,64,7344,42,4469,43225.0,1625.0,108.0,22,2875,84384.0,1111.0,82.0
0.001,17,2,180,1,66,0.0,38.0,38.0,1,114,0.0,86.0,86.0
0.079,6,10,1506,5,395,18.0,127.0,127.0,5,1111,19.0,843.0,843.0
0.013,6,10,1990,5,911,3.0,643.0,643.0,5,1079,3.0,811.0,811.0
0.005,6,10,2006,5,927,1.0,659.0,659.0,5,1079,1.0,811.0,811.0
0.01,6,10,1677,5,827,2.0,559.0,559.0,5,850,2.0,582.0,582.0
357.003,6,20,2210,6,1308,12010.0,494.0,494.0,14,902,27460.0,83.0,83.0
0.006,6,10,1547,5,764,1.0,496.0,496.0,5,783,1.0,515.0,515.0
0.001,17,2,136,1,60,0.0,32.0,32.0,1,76,0.0,48.0,48.0
0.019,6,10,1631,5,848,4.0,580.0,580.0,5,783,4.0,515.0,515.0
0.01,17,2,261,1,74,0.0,46.0,46.0,1,187,0.0,159.0,159.0
0.099,6,10,1506,5,395,24.0,127.0,127.0,5,1111,19.0,843.0,843.0
0.005,6,10,2007,5,928,1.0,660.0,660.0,5,1079,1.0,811.0,811.0
0.009,6,10,1989,5,910,2.0,642.0,642.0,5,1079,2.0,811.0,811.0
40.062,17,10,676,5,460,10014.0,104.0,64.0,5,216,10014.0,20.0,15.0
0.07,6,10,1506,5,395,16.0,127.0,127.0,5,1111,16.0,843.0,843.0
0.005,6,10,1779,5,928,1.0,660.0,660.0,5,851,1.0,583.0,583.0
0.003,17,2,148,1,60,0.0,32.0,32.0,1,88,0.0,60.0,60.0
0.012,6,10,1972,5,910,3.0,642.0,642.0,5,1062,3.0,794.0,794.0
0.014,17,2,148,1,60,0.0,32.0,32.0,1,88,0.0,60.0,60.0
1794.436,6,551,188151,277,162543,6501.0,2883.0,943.0,274,25608,6573.0,374.0,115.0
0.0,17,2,180,1,66,0.0,38.0,38.0,1,114,0.0,86.0,86.0
0.009,6,10,1989,5,910,2.0,642.0,642.0,5,1079,2.0,811.0,811.0
0.004,6,14,3742,7,452,0.0,80.0,80.0,7,3290,0.0,1448.0,972.0
0.012,6,10,1989,5,910,2.0,642.0,642.0,5,1079,3.0,811.0,811.0
0.001,17,2,180,1,66,0.0,38.0,38.0,1,114,0.0,86.0,86.0
0.005,6,10,2007,5,928,1.0,660.0,660.0,5,1079,1.0,811.0,811.0
0.013,6,10,1983,5,910,3.0,642.0,642.0,5,1073,3.0,805.0,805.0
0.003,17,2,148,1,60,0.0,32.0,32.0,1,88,0.0,60.0,60.0
0.004,17,2,136,1,60,0.0,32.0,32.0,1,76,0.0,48.0,48.0
0.008,6,10,1972,5,910,2.0,642.0,642.0,5,1062,1.0,794.0,794.0
0.005,6,10,1989,5,927,1.0,659.0,659.0,5,1062,1.0,794.0,794.0
0.013,6,10,1989,5,910,3.0,642.0,642.0,5,1079,3.0,811.0,811.0
0.003,17,2,148,1,60,0.0,32.0,32.0,1,88,0.0,60.0,60.0
0.101,6,10,1506,5,395,22.0,127.0,127.0,5,1111,24.0,843.0,843.0
0.006,17,2,178,1,81,0.0,53.0,53.0,1,97,0.0,69.0,69.0
0.068,6,10,1506,5,395,15.0,127.0,127.0,5,1111,13.0,843.0,843.0
0.006,6,10,1547,5,764,1.0,496.0,496.0,5,783,1.0,515.0,515.0
0.046,17,4,352,2,130,6.0,37.0,37.0,2,222,43.0,89.0,83.0
368.543,6,22,2313,16,867,24569.0,195.0,195.0,6,1446,4634.0,419.0,398.0
40.072,17,10,676,5,460,10017.0,104.0,64.0,5,216,10014.0,20.0,15.0
0.005,6,10,2007,5,928,1.0,660.0,660.0,5,1079,1.0,811.0,811.0
0.005,6,10,1989,5,927,1.0,659.0,659.0,5,1062,1.0,794.0,794.0
0.02,6,10,1990,5,911,5.0,643.0,643.0,5,1079,4.0,811.0,811.0
0.076,17,2,412,1,61,0.0,33.0,33.0,1,351,0.0,323.0,323.0
0.005,6,10,2006,5,927,1.0,659.0,659.0,5,1079,1.0,811.0,811.0
240.11,6,19,7536,10,2204,26678.0,1496.0,562.0,9,5332,30013.0,2804.0,1211.0
0.006,6,10,1547,5,764,1.0,496.0,496.0,5,783,1.0,515.0,515.0
0.099,6,10,1506,5,395,22.0,127.0,127.0,5,1111,19.0,843.0,843.0
0.01,6,10,1972,5,910,2.0,642.0,642.0,5,1062,2.0,794.0,794.0
0.082,6,10,1506,5,395,18.0,127.0,127.0,5,1111,17.0,843.0,843.0
40.062,17,10,676,5,460,10012.0,104.0,64.0,5,216,10014.0,20.0,15.0
0.003,17,2,152,1,76,0.0,48.0,48.0,1,76,0.0,48.0,48.0
0.103,6,10,1506,5,395,24.0,127.0,127.0,5,1111,22.0,843.0,843.0
0.073,6,46,14078,26,2607,2.0,517.0,139.0,20,11471,3.0,1402.0,744.0
0.08,6,10,1506,5,395,19.0,127.0,127.0,5,1111,17.0,843.0,843.0
0.006,6,10,1547,5,764,1.0,496.0,496.0,5,783,1.0,515.0,515.0
0.179,6,10,1506,5,395,40.0,127.0,127.0,5,1111,37.0,843.0,843.0
0.159,6,10,1506,5,395,31.0,127.0,127.0,5,1111,34.0,843.0,843.0
0.09,6,10,1506,5,395,21.0,127.0,127.0,5,1111,20.0,843.0,843.0
413.334,6,29,4409,12,3102,10912.0,494.0,494.0,17,1307,25833.0,83.0,83.0
0.003,17,2,136,1,60,0.0,32.0,32.0,1,76,0.0,48.0,48.0
0.065,6,10,1506,5,395,14.0,127.0,127.0,5,1111,14.0,843.0,843.0
0.006,6,10,1547,5,764,1.0,496.0,496.0,5,783,1.0,515.0,515.0
0.014,6,10,1989,5,910,3.0,642.0,642.0,5,1079,3.0,811.0,811.0
0.011,6,10,1990,5,911,2.0,643.0,643.0,5,1079,2.0,811.0,811.0
0.017,6,10,1990,5,911,4.0,643.0,643.0,5,1079,4.0,811.0,811.0
0.004,6,10,1702,5,863,0.0,595.0,595.0,5,839,1.0,571.0,571.0
0.018,17,2,166,1,75,0.0,47.0,47.0,1,91,0.0,63.0,63.0
0.001,17,2,180,1,66,0.0,38.0,38.0,1,114,0.0,86.0,86.0
0.017,6,10,1989,5,910,4.0,642.0,642.0,5,1079,4.0,811.0,811.0
0.001,17,2,140,1,62,0.0,34.0,34.0,1,78,0.0,50.0,50.0
300.438,6,19,3081,11,1647,30043.0,517.0,266.0,8,1434,34342.0,821.0,336.0
40.052,17,10,676,5,460,10011.0,104.0,64.0,5,216,10012.0,20.0,15.0
172.157,17,78,11179,39,2610,4530.0,44.0,38.0,39,8569,4530.0,261.0,191.0
40.057,17,10,676,5,460,10013.0,104.0,64.0,5,216,10013.0,20.0,15.0
0.146,6,10,1506,5,395,25.0,127.0,127.0,5,1111,32.0,843.0,843.0
5.572,6,38,25496,18,15988,327.0,2804.0,2149.0,20,9508,286.0,1288.0,1208.0
0.071,6,10,1506,5,395,15.0,127.0,127.0,5,1111,14.0,843.0,843.0
0.038,17,2,182,1,65,0.0,37.0,37.0,1,117,0.0,89.0,89.0
0.013,6,10,1762,5,911,3.0,643.0,643.0,5,851,3.0,583.0,583.0
0.009,6,13,3735,7,497,1.0,125.0,125.0,6,3238,1.0,1470.0,1459.0
0.001,17,2,180,1,66,0.0,38.0,38.0,1,114,0.0,86.0,86.0
0.01,6,10,1631,5,848,2.0,580.0,580.0,5,783,2.0,515.0,515.0
0.085,17,2,144,1,64,0.0,36.0,36.0,1,80,0.0,52.0,52.0
0.005,17,2,152,1,68,0.0,40.0,40.0,1,84,0.0,56.0,56.0
0.006,6,10,1854,5,889,1.0,621.0,621.0,5,965,1.0,697.0,697.0
1.02,6,10,1690,6,1336,204.0,1084.0,1084.0,4,354,258.0,182.0,182.0
0.004,17,4,284,2,120,0.0,32.0,32.0,2,164,1.0,60.0,54.0
0.065,6,10,1506,5,395,15.0,127.0,127.0,5,1111,15.0,843.0,843.0
0.48,17,2,144,1,64,0.0,36.0,36.0,1,80,0.0,52.0,52.0
0.004,6,10,2006,5,927,1.0,659.0,659.0,5,1079,1.0,811.0,811.0
0.005,6,10,2006,5,927,1.0,659.0,659.0,5,1079,1.0,811.0,811.0
0.055,17,4,284,2,120,15.0,32.0,32.0,2,164,52.0,60.0,54.0
0.104,6,10,1506,5,395,22.0,127.0,127.0,5,1111,25.0,843.0,843.0
0.068,6,10,1506,5,395,14.0,127.0,127.0,5,1111,15.0,843.0,843.0
270.532,6,79,40816,35,5594,7956.0,944.0,314.0,44,35222,6291.0,2790.0,1028.0
0.016,6,10,1983,5,910,4.0,642.0,642.0,5,1073,3.0,805.0,805.0
0.006,6,10,1689,5,839,1.0,571.0,571.0,5,850,1.0,582.0,582.0
0.006,6,10,1779,5,928,1.0,660.0,660.0,5,851,1.0,583.0,583.0
0.005,6,10,2000,5,927,1.0,659.0,659.0,5,1073,1.0,805.0,805.0
0.006,6,10,1547,5,764,1.0,496.0,496.0,5,783,1.0,515.0,515.0
0.007,6,10,2006,5,927,1.0,659.0,659.0,5,1079,1.0,811.0,811.0
0.004,6,10,2006,5,927,1.0,659.0,659.0,5,1079,1.0,811.0,811.0
9.036,17,6,376,5,280,2259.0,28.0,28.0,1,96,0.0,68.0,68.0
0.116,6,10,1506,5,395,27.0,127.0,127.0,5,1111,26.0,843.0,843.0
0.004,17,2,136,1,60,0.0,32.0,32.0,1,76,0.0,48.0,48.0
0.132,6,10,1506,5,395,28.0,127.0,127.0,5,1111,29.0,843.0,843.0
0.005,17,2,179,1,71,0.0,43.0,43.0,1,108,0.0,80.0,80.0
0.007,17,4,284,2,120,0.0,32.0,32.0,2,164,0.0,60.0,54.0
0.08,6,10,1506,5,395,15.0,127.0,127.0,5,1111,16.0,843.0,843.0
0.012,6,10,1989,5,910,3.0,642.0,642.0,5,1079,2.0,811.0,811.0
0.001,17,2,166,1,75,0.0,47.0,47.0,1,91,0.0,63.0,63.0
0.127,17,4,284,2,120,0.0,32.0,32.0,2,164,116.0,60.0,54.0
0.004,6,10,2000,5,927,1.0,659.0,659.0,5,1073,1.0,805.0,805.0
0.012,6,10,1989,5,910,3.0,642.0,642.0,5,1079,2.0,811.0,811.0
0.006,6,10,1689,5,839,1.0,571.0,571.0,5,850,1.0,582.0,582.0
80.503,58,5,360,4,288,26834.0,24.0,24.0,1,72,0.0,24.0,24.0
1787.292,6,151,19402,90,13740,20081.0,302.0,302.0,61,5662,29788.0,83.0,83.0
0.007,17,2,169,1,62,0.0,34.0,34.0,1,107,0.0,79.0,79.0
0.009,6,10,1631,5,848,2.0,580.0,580.0,5,783,2.0,515.0,515.0
0.135,6,10,1506,5,395,28.0,127.0,127.0,5,1111,30.0,843.0,843.0
0.005,6,10,1547,5,764,1.0,496.0,496.0,5,783,1.0,515.0,515.0
0.005,17,2,214,1,75,0.0,47.0,47.0,1,139,0.0,111.0,111.0
0.001,17,2,180,1,66,0.0,38.0,38.0,1,114,0.0,86.0,86.0
1729.22,6,60,4400,40,2740,44338.0,33.0,33.0,20,1660,91002.0,31.0,31.0
0.006,6,10,1547,5,764,1.0,496.0,496.0,5,783,1.0,515.0,515.0
0.005,6,10,2006,5,927,1.0,659.0,659.0,5,1079,1.0,811.0,811.0
40.088,17,10,676,5,460,10020.0,104.0,64.0,5,216,10021.0,20.0,15.0
0.004,6,10,1779,5,928,1.0,660.0,660.0,5,851,0.0,583.0,583.0
0.003,17,2,136,1,60,0.0,32.0,32.0,1,76,0.0,48.0,48.0
0.009,6,10,1983,5,910,2.0,642.0,642.0,5,1073,2.0,805.0,805.0
0.005,17,2,148,1,60,0.0,32.0,32.0,1,88,0.0,60.0,60.0
1756.45,6,122,12332,66,4604,27021.0,517.0,64.0,56,7728,31934.0,1402.0,228.0
0.001,17,2,180,1,66,0.0,38.0,38.0,1,114,0.0,86.0,86.0
0.004,6,10,1702,5,863,1.0,595.0,595.0,5,839,1.0,571.0,571.0
0.052,17,2,152,1,76,0.0,48.0,48.0,1,76,0.0,48.0,48.0
325.115,17,20,1124,10,716,36110.0,48.0,43.0,10,408,36110.0,20.0,12.0
0.013,6,10,1762,5,911,3.0,643.0,643.0,5,851,3.0,583.0,583.0
0.004,6,10,2006,5,927,1.0,659.0,659.0,5,1079,1.0,811.0,811.0
15.183,17,17,9941,9,6307,1894.0,1350.0,672.0,8,3634,2164.0,1350.0,426.0
0.004,6,10,2000,5,927,1.0,659.0,659.0,5,1073,1.0,805.0,805.0
0.07,6,10,1506,5,395,15.0,127.0,127.0,5,1111,13.0,843.0,843.0
0.006,6,10,1547,5,764,1.0,496.0,496.0,5,783,1.0,515.0,515.0
0.004,6,10,2000,5,927,1.0,659.0,659.0,5,1073,1.0,805.0,805.0
0.013,6,10,1972,5,910,3.0,642.0,642.0,5,1062,3.0,794.0,794.0
15.077,17,16,9302,8,6912,2149.0,1350.0,836.0,8,2390,2149.0,1350.0,270.0
0.017,6,10,1631,5,848,4.0,580.0,580.0,5,783,4.0,515.0,515.0
0.002,17,2,180,1,66,0.0,38.0,38.0,1,114,0.0,86.0,86.0
0.005,6,10,2000,5,927,1.0,659.0,659.0,5,1073,1.0,805.0,805.0
0.042,17,2,184,1,61,0.0,33.0,33.0,1,123,0.0,95.0,95.0
0.072,6,10,1506,5,395,17.0,127.0,127.0,5,1111,15.0,843.0,843.0
240.083,6,16,4482,9,963,30010.0,238.0,166.0,7,3519,40013.0,1402.0,786.0
11.191,17,28,4421,14,1993,848.0,268.0,114.0,14,2428,848.0,587.0,145.0
0.005,6,10,1989,5,927,1.0,659.0,659.0,5,1062,1.0,794.0,794.0
0.004,6,10,2007,5,928,1.0,660.0,660.0,5,1079,1.0,811.0,811.0
300.137,6,31,12013,15,9044,21438.0,2736.0,1032.0,16,2969,20008.0,1162.0,428.0
0.008,6,10,1972,5,910,2.0,642.0,642.0,5,1062,2.0,794.0,794.0
0.085,6,10,1506,5,395,19.0,127.0,127.0,5,1111,16.0,843.0,843.0
0.013,6,10,1989,5,910,3.0,642.0,642.0,5,1079,3.0,811.0,811.0
0.014,6,10,1990,5,911,3.0,643.0,643.0,5,1079,3.0,811.0,811.0
0.038,17,2,136,1,60,0.0,32.0,32.0,1,76,0.0,48.0,48.0
0.004,6,10,2006,5,927,1.0,659.0,659.0,5,1079,1.0,811.0,811.0
40.053,17,10,676,5,460,10011.0,104.0,64.0,5,216,10012.0,20.0,15.0
0.013,6,10,1990,5,911,3.0,643.0,643.0,5,1079,3.0,811.0,811.0
0.004,6,10,2006,5,927,1.0,659.0,659.0,5,1079,1.0,811.0,811.0
0.185,6,10,1506,5,395,40.0,127.0,127.0,5,1111,28.0,843.0,843.0
0.017,6,10,1989,5,910,4.0,642.0,642.0,5,1079,4.0,811.0,811.0
0.011,6,10,1983,5,910,2.0,642.0,642.0,5,1073,2.0,805.0,805.0
0.008,6,10,1983,5,910,2.0,642.0,642.0,5,1073,2.0,805.0,805.0
0.005,17,2,179,1,71,0.0,43.0,43.0,1,108,0.0,80.0,80.0
0.03,6,13,3735,7,497,5.0,125.0,125.0,6,3238,6.0,1470.0,1459.0
15.081,17,16,8826,8,6639,2150.0,1350.0,801.0,8,2187,2150.0,1350.0,245.0
371.217,6,22,2313,16,867,24747.0,195.0,195.0,6,1446,4642.0,419.0,398.0
0.009,6,10,1983,5,910,2.0,642.0,642.0,5,1073,2.0,805.0,805.0
0.02,6,10,1983,5,910,5.0,642.0,642.0,5,1073,5.0,805.0,805.0
242.108,6,385,347972,193,21552,1260.0,2736.0,959.0,192,326420,1267.0,3322.0,1738.0
300.4,6,16,2170,9,684,37528.0,146.0,146.0,7,1486,50038.0,419.0,398.0
0.011,6,10,1972,5,910,2.0,642.0,642.0,5,1062,2.0,794.0,794.0
240.01,6,9,787,5,488,60002.0,232.0,232.0,4,299,80002.0,83.0,83.0
0.081,6,10,1506,5,395,18.0,127.0,127.0,5,1111,18.0,843.0,843.0
0.161,17,2,152,1,76,0.0,48.0,48.0,1,76,0.0,48.0,48.0
0.013,6,10,1989,5,910,3.0,642.0,642.0,5,1079,3.0,811.0,811.0
0.004,6,10,1702,5,863,1.0,595.0,595.0,5,839,0.0,571.0,571.0
40.07,17,10,676,5,460,10016.0,104.0,64.0,5,216,10014.0,20.0,15.0
0.185,6,3,453,2,321,185.0,241.0,241.0,1,132,0.0,92.0,92.0
0.001,17,2,180,1,66,0.0,38.0,38.0,1,114,0.0,86.0,86.0
0.039,17,2,152,1,76,0.0,48.0,48.0,1,76,0.0,48.0,48.0
40.061,17,10,676,5,460,10012.0,104.0,64.0,5,216,10014.0,20.0,15.0
0.005,6,10,2000,5,927,1.0,659.0,659.0,5,1073,1.0,805.0,805.0
11.081,17,28,4422,14,1993,840.0,268.0,114.0,14,2429,840.0,588.0,145.0
0.042,17,2,148,1,60,0.0,32.0,32.0,1,88,0.0,60.0,60.0
0.005,6,10,1774,5,923,1.0,655.0,655.0,5,851,1.0,583.0,583.0
240.098,6,16,4481,9,963,30012.0,238.0,166.0,7,3518,40015.0,1402.0,786.0
0.01,6,10,1762,5,911,2.0,643.0,643.0,5,851,2.0,583.0,583.0
0.079,6,10,1506,5,395,17.0,127.0,127.0,5,1111,18.0,843.0,843.0
0.014,6,10,1983,5,910,3.0,642.0,642.0,5,1073,3.0,805.0,805.0
40.06,17,10,676,5,460,10013.0,104.0,64.0,5,216,10013.0,20.0,15.0
0.037,17,2,234,1,61,0.0,33.0,33.0,1,173,0.0,145.0,145.0
0.004,6,10,1989,5,927,1.0,659.0,659.0,5,1062,1.0,794.0,794.0
0.04,17,2,182,1,65,0.0,37.0,37.0,1,117,0.0,89.0,89.0
0.01,6,10,1989,5,910,2.0,642.0,642.0,5,1079,2.0,811.0,811.0
0.005,6,13,3690,7,452,0.0,80.0,80.0,6,3238,1.0,1470.0,1459.0
10.759,17,28,4420,14,1995,819.0,270.0,114.0,14,2425,819.0,588.0,145.0
0.07,6,10,1506,5,395,15.0,127.0,127.0,5,1111,14.0,843.0,843.0
0.008,6,10,1989,5,910,2.0,642.0,642.0,5,1079,2.0,811.0,811.0
0.005,17,2,212,1,74,0.0,46.0,46.0,1,138,0.0,110.0,110.0
10.879,17,28,4422,14,1994,828.0,269.0,114.0,14,2428,828.0,587.0,145.0
0.004,6,10,2007,5,928,1.0,660.0,660.0,5,1079,1.0,811.0,811.0
0.04,17,2,136,1,60,0.0,32.0,32.0,1,76,0.0,48.0,48.0
0.005,6,10,2007,5,928,1.0,660.0,660.0,5,1079,1.0,811.0,811.0
0.012,6,10,1762,5,911,2.0,643.0,643.0,5,851,3.0,583.0,583.0
0.004,17,2,170,1,65,0.0,37.0,37.0,1,105,0.0,77.0,77.0
0.009,6,10,1631,5,848,2.0,580.0,580.0,5,783,2.0,515.0,515.0
0.038,17,2,152,1,76,0.0,48.0,48.0,1,76,0.0,48.0,48.0
125.053,6,21,8144,11,1985,81.0,1174.0,504.0,10,6159,13876.0,2720.0,957.0
0.012,6,10,1989,5,910,3.0,642.0,642.0,5,1079,2.0,811.0,811.0
0.012,6,10,1983,5,910,2.0,642.0,642.0,5,1073,2.0,805.0,805.0
0.218,6,16,2669,8,1395,31.0,533.0,323.0,8,1274,19.0,529.0,212.0
0.013,6,10,1972,5,910,3.0,642.0,642.0,5,1062,3.0,794.0,794.0
0.005,6,10,2007,5,928,1.0,660.0,660.0,5,1079,1.0,811.0,811.0
0.155,6,10,1506,5,395,36.0,127.0,127.0,5,1111,17.0,843.0,843.0
0.204,6,16,2670,8,1396,29.0,533.0,324.0,8,1274,18.0,529.0,212.0
0.014,6,10,1983,5,910,3.0,642.0,642.0,5,1073,3.0,805.0,805.0
0.005,17,2,179,1,71,0.0,43.0,43.0,1,108,0.0,80.0,80.0
0.022,6,10,1762,5,911,5.0,643.0,643.0,5,851,5.0,583.0,583.0
244.539,6,34,9279,16,6689,16302.0,1515.0,586.0,18,2590,14384.0,580.0,149.0
0.004,6,10,1702,5,863,1.0,595.0,595.0,5,839,0.0,571.0,571.0
0.006,6,10,1689,5,839,1.0,571.0,571.0,5,850,1.0,582.0,582.0
0.006,17,2,166,1,75,0.0,47.0,47.0,1,91,0.0,63.0,63.0
176.103,17,76,10657,38,2529,4759.0,44.0,38.0,38,8128,4759.0,260.0,185.0
0.005,6,10,2007,5,928,1.0,660.0,660.0,5,1079,1.0,811.0,811.0
0.128,6,10,1506,5,395,27.0,127.0,127.0,5,1111,30.0,843.0,843.0
1778.633,17,144,45504,72,22752,25048.0,288.0,288.0,72,22752,25050.0,288.0,288.0
40.054,17,10,676,5,460,10012.0,104.0,64.0,5,216,10012.0,20.0,15.0
0.012,6,10,1990,5,911,3.0,643.0,643.0,5,1079,2.0,811.0,811.0
0.005,6,10,2006,5,927,1.0,659.0,659.0,5,1079,1.0,811.0,811.0
15.072,17,15,9238,8,6902,2149.0,1350.0,834.0,7,2336,2507.0,1350.0,305.0
0.083,6,10,1506,5,395,18.0,127.0,127.0,5,1111,18.0,843.0,843.0
0.009,6,10,1990,5,911,2.0,643.0,643.0,5,1079,2.0,811.0,811.0
0.009,6,10,1989,5,910,2.0,642.0,642.0,5,1079,2.0,811.0,811.0
0.004,17,2,150,1,67,0.0,39.0,39.0,1,83,0.0,55.0,55.0
0.006,6,10,1547,5,764,1.0,496.0,496.0,5,783,1.0,515.0,515.0
0.003,17,2,148,1,60,0.0,32.0,32.0,1,88,0.0,60.0,60.0
0.008,6,13,3735,7,497,1.0,125.0,125.0,6,3238,1.0,1470.0,1459.0
0.011,6,10,1972,5,910,2.0,642.0,642.0,5,1062,2.0,794.0,794.0
291.655,6,421,349509,218,22896,1344.0,2736.0,888.0,203,326613,1443.0,2804.0,1663.0
40.064,17,10,676,5,460,10013.0,104.0,64.0,5,216,10015.0,20.0,15.0
0.272,17,4,596,2,122,232.0,33.0,33.0,2,474,144.0,323.0,209.0
0.016,6,10,1990,5,911,4.0,643.0,643.0,5,1079,3.0,811.0,811.0
0.01,6,10,1972,5,910,2.0,642.0,642.0,5,1062,2.0,794.0,794.0
0.015,6,10,1972,5,910,3.0,642.0,642.0,5,1062,3.0,794.0,794.0
0.011,6,10,1989,5,910,2.0,642.0,642.0,5,1079,2.0,811.0,811.0
0.122,6,10,1506,5,395,29.0,127.0,127.0,5,1111,27.0,843.0,843.0
0.003,17,2,148,1,60,0.0,32.0,32.0,1,88,0.0,60.0,60.0
0.005,6,10,1779,5,928,1.0,660.0,660.0,5,851,1.0,583.0,583.0
0.005,6,10,2000,5,927,1.0,659.0,659.0,5,1073,1.0,805.0,805.0
10.798,17,28,4417,14,1993,822.0,268.0,114.0,14,2424,822.0,587.0,145.0
0.002,17,2,180,1,66,0.0,38.0,38.0,1,114,0.0,86.0,86.0
0.009,6,10,1989,5,910,2.0,642.0,642.0,5,1079,2.0,811.0,811.0
0.026,6,10,1989,5,910,6.0,642.0,642.0,5,1079,6.0,811.0,811.0
0.016,6,10,1983,5,910,4.0,642.0,642.0,5,1073,3.0,805.0,805.0
0.019,6,10,1972,5,910,4.0,642.0,642.0,5,1062,4.0,794.0,794.0
0.005,6,10,2006,5,927,1.0,659.0,659.0,5,1079,1.0,811.0,811.0
0.006,6,10,1689,5,839,1.0,571.0,571.0,5,850,1.0,582.0,582.0
0.006,6,13,3684,7,446,1.0,74.0,74.0,6,3238,1.0,1470.0,1459.0
0.004,6,10,2006,5,927,1.0,659.0,659.0,5,1079,1.0,811.0,811.0
0.04,17,4,284,2,120,0.0,32.0,32.0,2,164,3.0,60.0,54.0
0.187,17,2,142,1,63,0.0,35.0,35.0,1,79,0.0,51.0,51.0
0.003,17,4,284,2,120,0.0,32.0,32.0,2,164,0.0,60.0,54.0
0.005,6,13,3747,7,509,0.0,137.0,137.0,6,3238,0.0,1470.0,1459.0
0.094,6,10,1506,5,395,21.0,127.0,127.0,5,1111,22.0,843.0,843.0
0.171,6,3,453,2,321,171.0,241.0,241.0,1,132,0.0,92.0,92.0
15.189,17,22,14180,11,9148,1516.0,1350.0,803.0,11,5032,1516.0,1350.0,429.0
44.509,6,35,9486,17,3968,551.0,2903.0,1085.0,18,5518,2608.0,2667.0,435.0
0.112,6,10,1506,5,395,26.0,127.0,127.0,5,1111,23.0,843.0,843.0
0.007,6,10,2006,5,927,1.0,659.0,659.0,5,1079,1.0,811.0,811.0
0.004,6,10,1702,5,863,1.0,595.0,595.0,5,839,0.0,571.0,571.0
40.065,17,10,676,5,460,10014.0,104.0,64.0,5,216,10015.0,20.0,15.0
0.004,17,4,284,2,120,0.0,32.0,32.0,2,164,1.0,60.0,54.0
1778.583,17,144,45504,72,22752,25050.0,288.0,288.0,72,22752,25050.0,288.0,288.0
0.017,6,10,1990,5,911,4.0,643.0,643.0,5,1079,4.0,811.0,811.0
0.005,6,10,2007,5,928,1.0,660.0,660.0,5,1079,1.0,811.0,811.0
1770.387,6,572,191980,288,164337,6168.0,2883.0,916.0,284,27643,6255.0,580.0,124.0
0.005,6,10,2006,5,927,1.0,659.0,659.0,5,1079,1.0,811.0,811.0
0.005,6,13,3747,7,509,0.0,137.0,137.0,6,3238,1.0,1470.0,1459.0
10.945,17,28,4418,14,1995,833.0,270.0,114.0,14,2423,833.0,586.0,145.0
1777.994,17,144,45504,72,22752,25042.0,288.0,288.0,72,22752,25042.0,288.0,288.0
0.005,6,13,3747,7,509,0.0,137.0,137.0,6,3238,1.0,1470.0,1459.0
0.005,6,10,1774,5,923,1.0,655.0,655.0,5,851,1.0,583.0,583.0
0.004,6,10,2000,5,927,1.0,659.0,659.0,5,1073,1.0,805.0,805.0
0.021,6,10,1990,5,911,5.0,643.0,643.0,5,1079,5.0,811.0,811.0
0.004,17,2,136,1,60,0.0,32.0,32.0,1,76,0.0,48.0,48.0
0.009,6,10,1972,5,910,2.0,642.0,642.0,5,1062,2.0,794.0,794.0
0.001,17,2,180,1,66,0.0,38.0,38.0,1,114,0.0,86.0,86.0
40.058,17,10,676,5,460,10013.0,104.0,64.0,5,216,10013.0,20.0,15.0
240.099,6,32,9484,16,6852,16006.0,1924.0,669.0,16,2632,16006.0,580.0,224.0
0.111,6,10,1506,5,395,26.0,127.0,127.0,5,1111,20.0,843.0,843.0
0.007,6,10,1677,5,827,1.0,559.0,559.0,5,850,1.0,582.0,582.0
0.081,6,10,1506,5,395,18.0,127.0,127.0,5,1111,18.0,843.0,843.0
0.089,6,10,1506,5,395,17.0,127.0,127.0,5,1111,21.0,843.0,843.0
0.015,6,10,1989,5,910,3.0,642.0,642.0,5,1079,3.0,811.0,811.0
0.068,6,10,1506,5,395,14.0,127.0,127.0,5,1111,15.0,843.0,843.0
0.006,6,10,2006,5,927,1.0,659.0,659.0,5,1079,1.0,811.0,811.0
0.01,6,10,1677,5,827,2.0,559.0,559.0,5,850,2.0,582.0,582.0
0.005,6,10,1779,5,928,1.0,660.0,660.0,5,851,1.0,583.0,583.0
0.015,6,10,1677,5,827,3.0,559.0,559.0,5,850,3.0,582.0,582.0
0.012,6,10,1989,5,910,3.0,642.0,642.0,5,1079,2.0,811.0,811.0
0.006,6,10,1689,5,839,1.0,571.0,571.0,5,850,1.0,582.0,582.0
0.016,6,10,1990,5,911,4.0,643.0,643.0,5,1079,3.0,811.0,811.0
0.009,6,10,1989,5,910,2.0,642.0,642.0,5,1079,2.0,811.0,811.0
0.148,6,10,1506,5,395,33.0,127.0,127.0,5,1111,36.0,843.0,843.0
0.01,6,10,1972,5,910,2.0,642.0,642.0,5,1062,2.0,794.0,794.0
0.007,6,10,1989,5,910,1.0,642.0,642.0,5,1079,1.0,811.0,811.0
0.009,6,10,1631,5,848,2.0,580.0,580.0,5,783,2.0,515.0,515.0
0.083,6,10,1506,5,395,16.0,127.0,127.0,5,1111,19.0,843.0,843.0
0.005,6,13,3747,7,509,0.0,137.0,137.0,6,3238,0.0,1470.0,1459.0
0.008,6,10,1989,5,910,2.0,642.0,642.0,5,1079,1.0,811.0,811.0
0.008,6,12,1926,6,1189,1.0,659.0,434.0,6,737,1.0,417.0,417.0
0.005,17,2,273,1,66,0.0,38.0,38.0,1,207,0.0,179.0,179.0
0.005,17,2,179,1,71,0.0,43.0,43.0,1,108,0.0,80.0,80.0
0.005,6,10,1774,5,923,1.0,655.0,655.0,5,851,1.0,583.0,583.0
240.077,6,16,4480,9,963,30009.0,238.0,166.0,7,3517,40012.0,1402.0,786.0
0.004,17,4,284,2,120,0.0,32.0,32.0,2,164,0.0,60.0,54.0
0.008,6,10,2000,5,927,2.0,659.0,659.0,5,1073,1.0,805.0,805.0
0.007,6,10,1774,5,923,1.0,655.0,655.0,5,851,1.0,583.0,583.0
0.072,6,10,1506,5,395,16.0,127.0,127.0,5,1111,15.0,843.0,843.0
0.005,6,10,2006,5,927,1.0,659.0,659.0,5,1079,1.0,811.0,811.0
0.015,6,10,1983,5,910,3.0,642.0,642.0,5,1073,3.0,805.0,805.0
0.005,6,10,2006,5,927,1.0,659.0,659.0,5,1079,1.0,811.0,811.0
0.005,6,10,2007,5,928,1.0,660.0,660.0,5,1079,1.0,811.0,811.0
0.003,17,2,136,1,60,0.0,32.0,32.0,1,76,0.0,48.0,48.0
0.005,6,14,3799,7,509,0.0,137.0,137.0,7,3290,0.0,1448.0,972.0
0.004,6,10,2006,5,927,1.0,659.0,659.0,5,1079,1.0,811.0,811.0
0.129,6,10,1506,5,395,30.0,127.0,127.0,5,1111,31.0,843.0,843.0
0.003,17,2,136,1,60,0.0,32.0,32.0,1,76,0.0,48.0,48.0
0.089,6,10,1506,5,395,18.0,127.0,127.0,5,1111,18.0,843.0,843.0
0.005,17,2,170,1,65,0.0,37.0,37.0,1,105,0.0,77.0,77.0
0.005,17,2,140,1,62,0.0,34.0,34.0,1,78,0.0,50.0,50.0
0.479,17,40,21611,22,18411,22.0,1350.0,808.0,18,3200,23.0,1350.0,149.0
0.003,17,4,284,2,120,0.0,32.0,32.0,2,164,0.0,60.0,54.0
0.111,6,10,1506,5,395,26.0,127.0,127.0,5,1111,27.0,843.0,843.0
0.009,6,13,3735,7,497,1.0,125.0,125.0,6,3238,1.0,1470.0,1459.0
0.105,6,10,1506,5,395,21.0,127.0,127.0,5,1111,22.0,843.0,843.0
309.313,17,20,1124,10,716,34353.0,48.0,43.0,10,408,34353.0,20.0,12.0
0.006,6,10,1854,5,889,1.0,621.0,621.0,5,965,1.0,697.0,697.0
0.01,6,10,1983,5,910,2.0,642.0,642.0,5,1073,2.0,805.0,805.0
368.504,6,22,2313,16,867,24566.0,195.0,195.0,6,1446,4769.0,419.0,398.0
0.005,6,10,1689,5,839,1.0,571.0,571.0,5,850,1.0,582.0,582.0
0.015,6,10,1989,5,910,3.0,642.0,642.0,5,1079,3.0,811.0,811.0
0.004,6,10,2000,5,927,1.0,659.0,659.0,5,1073,1.0,805.0,805.0
0.007,6,10,1983,5,910,1.0,642.0,642.0,5,1073,1.0,805.0,805.0
0.107,6,10,1506,5,395,24.0,127.0,127.0,5,1111,24.0,843.0,843.0
0.007,17,2,179,1,71,0.0,43.0,43.0,1,108,0.0,80.0,80.0
0.005,6,10,2006,5,927,1.0,659.0,659.0,5,1079,1.0,811.0,811.0
0.005,6,10,2006,5,927,1.0,659.0,659.0,5,1079,1.0,811.0,811.0
0.01,6,10,1972,5,910,2.0,642.0,642.0,5,1062,2.0,794.0,794.0
240.65,6,35,8923,18,2072,14153.0,693.0,225.0,17,6851,15038.0,1402.0,597.0
0.097,6,10,1506,5,395,21.0,127.0,127.0,5,1111,22.0,843.0,843.0
0.015,6,10,1990,5,911,3.0,643.0,643.0,5,1079,3.0,811.0,811.0
0.123,17,2,80,1,32,0.0,4.0,4.0,1,48,0.0,20.0,20.0
0.04,17,2,152,1,76,0.0,48.0,48.0,1,76,0.0,48.0,48.0
0.006,6,10,1547,5,764,1.0,496.0,496.0,5,783,1.0,515.0,515.0
0.005,6,10,1643,5,860,1.0,592.0,592.0,5,783,1.0,515.0,515.0
0.004,6,10,2006,5,927,1.0,659.0,659.0,5,1079,1.0,811.0,811.0
0.005,17,2,160,1,72,0.0,44.0,44.0,1,88,0.0,60.0,60.0
0.005,6,10,2006,5,927,1.0,659.0,659.0,5,1079,1.0,811.0,811.0
0.381,6,16,2674,8,1400,54.0,533.0,325.0,8,1274,37.0,529.0,212.0
0.02,6,10,1990,5,911,4.0,643.0,643.0,5,1079,4.0,811.0,811.0
0.004,6,10,2007,5,928,1.0,660.0,660.0,5,1079,1.0,811.0,811.0
0.008,6,12,1926,6,1189,1.0,659.0,434.0,6,737,1.0,417.0,417.0
0.017,6,10,1677,5,827,4.0,559.0,559.0,5,850,4.0,582.0,582.0
10.899,17,28,4422,14,1993,830.0,268.0,114.0,14,2429,830.0,588.0,145.0
0.067,17,8,3613,4,1874,22.0,1350.0,440.0,4,1739,10.0,1350.0,406.0
0.004,6,10,2006,5,927,1.0,659.0,659.0,5,1079,1.0,811.0,811.0
0.016,6,13,3735,7,497,2.0,125.0,125.0,6,3238,3.0,1470.0,1459.0
300.312,6,16,2170,9,684,37517.0,146.0,146.0,7,1486,50023.0,419.0,398.0
0.009,6,10,1677,5,827,2.0,559.0,559.0,5,850,2.0,582.0,582.0
0.005,6,10,1643,5,860,1.0,592.0,592.0,5,783,1.0,515.0,515.0
0.004,17,2,148,1,60,0.0,32.0,32.0,1,88,0.0,60.0,60.0
0.015,6,10,1762,5,911,3.0,643.0,643.0,5,851,3.0,583.0,583.0
0.008,6,10,1989,5,910,2.0,642.0,642.0,5,1079,2.0,811.0,811.0
0.005,6,10,2000,5,927,1.0,659.0,659.0,5,1073,1.0,805.0,805.0
0.005,6,13,3747,7,509,0.0,137.0,137.0,6,3238,1.0,1470.0,1459.0
0.005,6,10,1774,5,923,1.0,655.0,655.0,5,851,1.0,583.0,583.0
240.118,6,31,9556,15,7196,17151.0,2320.0,713.0,16,2360,16007.0,580.0,190.0
0.005,6,10,2006,5,927,1.0,659.0,659.0,5,1079,1.0,811.0,811.0
0.006,6,10,1547,5,764,1.0,496.0,496.0,5,783,1.0,515.0,515.0
0.099,6,10,1506,5,395,22.0,127.0,127.0,5,1111,18.0,843.0,843.0
0.005,6,10,2000,5,927,1.0,659.0,659.0,5,1073,1.0,805.0,805.0
0.006,6,10,1779,5,928,1.0,660.0,660.0,5,851,1.0,583.0,583.0
0.007,6,10,1547,5,764,1.0,496.0,496.0,5,783,1.0,515.0,515.0
0.001,17,2,136,1,60,0.0,32.0,32.0,1,76,0.0,48.0,48.0
0.118,6,10,1506,5,395,21.0,127.0,127.0,5,1111,24.0,843.0,843.0
0.676,6,25,5459,12,1557,51.0,325.0,152.0,13,3902,47.0,1414.0,563.0
0.009,6,10,1989,5,910,2.0,642.0,642.0,5,1079,2.0,811.0,811.0
10.88,17,28,4424,14,1995,828.0,270.0,114.0,14,2429,828.0,588.0,145.0
0.01,6,10,1989,5,910,2.0,642.0,642.0,5,1079,2.0,811.0,811.0
0.005,6,10,2006,5,927,1.0,659.0,659.0,5,1079,1.0,811.0,811.0
40.054,17,10,676,5,460,10012.0,104.0,64.0,5,216,10012.0,20.0,15.0
0.005,6,10,2007,5,928,1.0,660.0,660.0,5,1079,1.0,811.0,811.0
0.004,6,10,2006,5,927,1.0,659.0,659.0,5,1079,1.0,811.0,811.0
0.001,17,2,136,1,60,0.0,32.0,32.0,1,76,0.0,48.0,48.0
0.059,6,10,1990,5,911,14.0,643.0,643.0,5,1079,14.0,811.0,811.0
0.009,6,10,1989,5,910,2.0,642.0,642.0,5,1079,2.0,811.0,811.0
0.087,6,10,1506,5,395,20.0,127.0,127.0,5,1111,14.0,843.0,843.0
0.005,6,10,1689,5,839,1.0,571.0,571.0,5,850,1.0,582.0,582.0
0.08,6,10,1506,5,395,17.0,127.0,127.0,5,1111,17.0,843.0,843.0
0.004,6,10,1774,5,923,1.0,655.0,655.0,5,851,1.0,583.0,583.0
96.549,6,26,9525,12,1627,84.0,794.0,367.0,14,7898,7416.0,1360.0,732.0
0.005,6,10,2007,5,928,1.0,660.0,660.0,5,1079,1.0,811.0,811.0
0.005,6,10,1779,5,928,1.0,660.0,660.0,5,851,1.0,583.0,583.0
0.02,6,10,1989,5,910,4.0,642.0,642.0,5,1079,5.0,811.0,811.0
40.063,17,10,676,5,460,10014.0,104.0,64.0,5,216,10015.0,20.0,15.0
0.004,17,2,148,1,60,0.0,32.0,32.0,1,88,0.0,60.0,60.0
0.013,6,10,1989,5,910,3.0,642.0,642.0,5,1079,3.0,811.0,811.0
0.005,17,2,225,1,65,0.0,37.0,37.0,1,160,0.0,132.0,132.0
0.006,6,12,1698,6,863,1.0,327.0,271.0,6,835,1.0,515.0,515.0
0.012,6,10,1972,5,910,3.0,642.0,642.0,5,1062,2.0,794.0,794.0
0.006,6,10,1547,5,764,1.0,496.0,496.0,5,783,1.0,515.0,515.0
0.005,6,10,2000,5,927,1.0,659.0,659.0,5,1073,1.0,805.0,805.0
0.004,17,2,136,1,60,0.0,32.0,32.0,1,76,0.0,48.0,48.0
0.013,6,10,1677,5,827,3.0,559.0,559.0,5,850,3.0,582.0,582.0
0.105,6,10,1506,5,395,20.0,127.0,127.0,5,1111,23.0,843.0,843.0
0.005,6,10,2007,5,928,1.0,660.0,660.0,5,1079,1.0,811.0,811.0
0.15,6,10,1506,5,395,36.0,127.0,127.0,5,1111,34.0,843.0,843.0
0.009,6,10,1972,5,910,2.0,642.0,642.0,5,1062,2.0,794.0,794.0
0.109,6,10,1506,5,395,20.0,127.0,127.0,5,1111,21.0,843.0,843.0
0.004,17,2,148,1,60,0.0,32.0,32.0,1,88,0.0,60.0,60.0
0.007,6,10,1774,5,923,1.0,655.0,655.0,5,851,1.0,583.0,583.0
0.005,17,2,140,1,62,0.0,34.0,34.0,1,78,0.0,50.0,50.0
0.126,17,2,148,1,60,0.0,32.0,32.0,1,88,0.0,60.0,60.0
171.159,17,78,11022,39,2597,4504.0,44.0,38.0,39,8425,4504.0,249.0,188.0
0.014,6,10,1989,5,910,3.0,642.0,642.0,5,1079,3.0,811.0,811.0
173.152,17,76,11105,38,2552,4679.0,44.0,39.0,38,8553,4679.0,279.0,197.0
309.15,17,20,1124,10,716,34336.0,48.0,43.0,10,408,34336.0,20.0,12.0
0.001,17,2,166,1,75,0.0,47.0,47.0,1,91,0.0,63.0,63.0
9.037,17,6,376,5,280,2259.0,28.0,28.0,1,96,0.0,68.0,68.0
0.008,6,10,1989,5,910,2.0,642.0,642.0,5,1079,1.0,811.0,811.0
0.004,17,4,284,2,120,0.0,32.0,32.0,2,164,1.0,60.0,54.0
0.011,6,10,1989,5,910,2.0,642.0,642.0,5,1079,2.0,811.0,811.0
0.042,17,4,284,2,120,1.0,32.0,32.0,2,164,38.0,60.0,54.0
0.005,6,10,2007,5,928,1.0,660.0,660.0,5,1079,1.0,811.0,811.0
0.005,6,10,1779,5,928,1.0,660.0,660.0,5,851,1.0,583.0,583.0
0.008,6,10,1983,5,910,2.0,642.0,642.0,5,1073,1.0,805.0,805.0
0.075,6,10,1506,5,395,16.0,127.0,127.0,5,1111,14.0,843.0,843.0
0.008,6,10,1990,5,911,2.0,643.0,643.0,5,1079,2.0,811.0,811.0
0.01,6,10,1989,5,910,2.0,642.0,642.0,5,1079,2.0,811.0,811.0
40.055,17,10,676,5,460,10012.0,104.0,64.0,5,216,10012.0,20.0,15.0
240.019,6,9,787,5,488,60004.0,232.0,232.0,4,299,80005.0,83.0,83.0
0.115,6,10,1506,5,395,24.0,127.0,127.0,5,1111,22.0,843.0,843.0
0.005,17,2,144,1,64,0.0,36.0,36.0,1,80,0.0,52.0,52.0
0.08,6,10,1506,5,395,18.0,127.0,127.0,5,1111,18.0,843.0,843.0
241.311,6,358,346831,183,21038,1325.0,2736.0,885.0,175,325793,1386.0,4206.0,1919.0
0.01,6,10,1762,5,911,2.0,643.0,643.0,5,851,2.0,583.0,583.0
1792.81,6,492,99492,248,88142,7257.0,421.0,365.0,244,11350,7377.0,53.0,53.0
0.006,6,10,1689,5,839,1.0,571.0,571.0,5,850,1.0,582.0,582.0
0.005,17,2,170,1,65,0.0,37.0,37.0,1,105,0.0,77.0,77.0
0.005,6,10,2000,5,927,1.0,659.0,659.0,5,1073,1.0,805.0,805.0
240.119,6,31,9156,15,6898,17151.0,2022.0,680.0,16,2258,16007.0,580.0,177.0
0.005,6,10,2006,5,927,1.0,659.0,659.0,5,1079,1.0,811.0,811.0
0.082,6,10,1506,5,395,19.0,127.0,127.0,5,1111,19.0,843.0,843.0
0.008,17,2,179,1,71,0.0,43.0,43.0,1,108,0.0,80.0,80.0
15.073,17,15,9238,8,6902,2149.0,1350.0,834.0,7,2336,2506.0,1350.0,305.0
0.087,6,10,1506,5,395,18.0,127.0,127.0,5,1111,19.0,843.0,843.0
0.005,6,10,2006,5,927,1.0,659.0,659.0,5,1079,1.0,811.0,811.0
0.005,17,2,144,1,64,0.0,36.0,36.0,1,80,0.0,52.0,52.0
177.205,17,80,11270,40,2664,4543.0,44.0,38.0,40,8606,4543.0,239.0,187.0
0.015,6,10,1983,5,910,3.0,642.0,642.0,5,1073,3.0,805.0,805.0
0.004,6,10,2000,5,927,1.0,659.0,659.0,5,1073,1.0,805.0,805.0
0.116,6,10,1506,5,395,28.0,127.0,127.0,5,1111,25.0,843.0,843.0
0.054,6,10,1983,5,910,13.0,642.0,642.0,5,1073,13.0,805.0,805.0
0.012,6,10,1989,5,910,3.0,642.0,642.0,5,1079,3.0,811.0,811.0
0.005,6,10,1989,5,927,1.0,659.0,659.0,5,1062,1.0,794.0,794.0
0.095,6,10,1506,5,395,21.0,127.0,127.0,5,1111,21.0,843.0,843.0
0.005,17,2,144,1,64,0.0,36.0,36.0,1,80,0.0,52.0,52.0
0.009,6,10,1983,5,910,2.0,642.0,642.0,5,1073,2.0,805.0,805.0
0.005,17,2,154,1,69,0.0,41.0,41.0,1,85,0.0,57.0,57.0
0.005,6,10,2006,5,927,1.0,659.0,659.0,5,1079,1.0,811.0,811.0
0.073,6,10,1506,5,395,17.0,127.0,127.0,5,1111,15.0,843.0,843.0
0.004,6,10,1989,5,927,1.0,659.0,659.0,5,1062,1.0,794.0,794.0
0.013,6,10,1990,5,911,3.0,643.0,643.0,5,1079,3.0,811.0,811.0
0.005,17,2,152,1,76,0.0,48.0,48.0,1,76,0.0,48.0,48.0
0.01,6,14,3787,7,497,1.0,125.0,125.0,7,3290,1.0,1448.0,972.0
0.01,6,10,1990,5,911,2.0,643.0,643.0,5,1079,2.0,811.0,811.0
0.005,6,13,3747,7,509,0.0,137.0,137.0,6,3238,0.0,1470.0,1459.0
0.124,17,2,179,1,71,0.0,43.0,43.0,1,108,0.0,80.0,80.0
0.079,6,10,1506,5,395,17.0,127.0,127.0,5,1111,16.0,843.0,843.0
0.003,6,10,1702,5,863,0.0,595.0,595.0,5,839,0.0,571.0,571.0
413.36,6,29,4409,12,3102,10911.0,494.0,494.0,17,1307,25834.0,83.0,83.0
377.154,6,22,2313,16,867,25143.0,195.0,195.0,6,1446,4648.0,419.0,398.0
0.014,6,10,1989,5,910,3.0,642.0,642.0,5,1079,3.0,811.0,811.0
0.01,6,10,1989,5,910,2.0,642.0,642.0,5,1079,2.0,811.0,811.0
0.126,17,2,184,1,61,0.0,33.0,33.0,1,123,0.0,95.0,95.0
0.014,6,10,1989,5,910,3.0,642.0,642.0,5,1079,3.0,811.0,811.0
1771.598,6,304,97891,187,86489,9524.0,2001.0,685.0,117,11402,15272.0,452.0,70.0
40.064,17,10,676,5,460,10015.0,104.0,64.0,5,216,10015.0,20.0,15.0
0.004,17,2,136,1,60,0.0,32.0,32.0,1,76,0.0,48.0,48.0
0.223,6,16,2777,8,1395,31.0,533.0,323.0,8,1382,20.0,529.0,239.0
0.005,6,10,2007,5,928,1.0,660.0,660.0,5,1079,1.0,811.0,811.0
0.007,17,2,132,1,58,0.0,30.0,30.0,1,74,0.0,46.0,46.0
0.02,6,10,1762,5,911,4.0,643.0,643.0,5,851,5.0,583.0,583.0
0.004,6,10,2007,5,928,1.0,660.0,660.0,5,1079,1.0,811.0,811.0
11.172,17,28,4422,14,1994,846.0,269.0,114.0,14,2428,846.0,587.0,145.0
0.005,6,10,1689,5,839,1.0,571.0,571.0,5,850,1.0,582.0,582.0
171.355,17,88,12696,44,2949,3984.0,44.0,39.0,44,9747,3984.0,279.0,193.0
0.017,6,6,716,3,458,5.0,302.0,302.0,3,258,5.0,102.0,102.0
0.104,6,10,1506,5,395,24.0,127.0,127.0,5,1111,22.0,843.0,843.0
0.003,17,2,136,1,60,0.0,32.0,32.0,1,76,0.0,48.0,48.0
0.051,17,2,182,1,65,0.0,37.0,37.0,1,117,0.0,89.0,89.0
40.067,17,10,676,5,460,10015.0,104.0,64.0,5,216,10015.0,20.0,15.0
0.072,6,10,1506,5,395,15.0,127.0,127.0,5,1111,14.0,843.0,843.0
0.053,17,2,152,1,76,0.0,48.0,48.0,1,76,0.0,48.0,48.0
0.011,6,10,1972,5,910,2.0,642.0,642.0,5,1062,2.0,794.0,794.0
0.012,6,10,1762,5,911,3.0,643.0,643.0,5,851,3.0,583.0,583.0
40.052,17,10,676,5,460,10012.0,104.0,64.0,5,216,10012.0,20.0,15.0
0.024,6,10,1972,5,910,6.0,642.0,642.0,5,1062,5.0,794.0,794.0
0.004,6,10,2006,5,927,1.0,659.0,659.0,5,1079,1.0,811.0,811.0
40.066,17,10,676,5,460,10015.0,104.0,64.0,5,216,10015.0,20.0,15.0
0.086,6,10,1506,5,395,16.0,127.0,127.0,5,1111,18.0,843.0,843.0
40.064,17,10,676,5,460,10012.0,104.0,64.0,5,216,10015.0,20.0,15.0
0.013,6,10,1972,5,910,3.0,642.0,642.0,5,1062,3.0,794.0,794.0
0.005,6,10,1779,5,928,1.0,660.0,660.0,5,851,1.0,583.0,583.0
0.005,6,10,2007,5,928,1.0,660.0,660.0,5,1079,1.0,811.0,811.0
0.003,17,2,184,1,61,0.0,33.0,33.0,1,123,0.0,95.0,95.0
0.004,17,2,148,1,60,0.0,32.0,32.0,1,88,0.0,60.0,60.0
0.039,6,10,1989,5,910,9.0,642.0,642.0,5,1079,9.0,811.0,811.0
0.005,6,10,2006,5,927,1.0,659.0,659.0,5,1079,1.0,811.0,811.0
0.019,6,10,1972,5,910,4.0,642.0,642.0,5,1062,4.0,794.0,794.0
0.014,6,10,1990,5,911,3.0,643.0,643.0,5,1079,3.0,811.0,811.0
0.009,6,10,2007,5,928,2.0,660.0,660.0,5,1079,2.0,811.0,811.0
0.005,6,10,1779,5,928,1.0,660.0,660.0,5,851,1.0,583.0,583.0
0.087,6,10,1506,5,395,19.0,127.0,127.0,5,1111,19.0,843.0,843.0
0.104,6,10,1506,5,395,24.0,127.0,127.0,5,1111,25.0,843.0,843.0
0.004,6,10,1989,5,927,1.0,659.0,659.0,5,1062,1.0,794.0,794.0
0.002,17,2,136,1,60,0.0,32.0,32.0,1,76,0.0,48.0,48.0
0.008,6,10,1989,5,910,2.0,642.0,642.0,5,1079,1.0,811.0,811.0
0.015,6,10,1989,5,910,3.0,642.0,642.0,5,1079,3.0,811.0,811.0
0.012,6,10,1989,5,910,2.0,642.0,642.0,5,1079,2.0,811.0,811.0
0.006,17,2,225,1,65,0.0,37.0,37.0,1,160,0.0,132.0,132.0
0.009,6,10,1983,5,910,2.0,642.0,642.0,5,1073,2.0,805.0,805.0
0.097,6,10,1506,5,395,21.0,127.0,127.0,5,1111,21.0,843.0,843.0
0.005,6,10,2006,5,927,1.0,659.0,659.0,5,1079,1.0,811.0,811.0
0.122,6,10,1506,5,395,24.0,127.0,127.0,5,1111,27.0,843.0,843.0
5.1,58,2,144,1,72,0.0,24.0,24.0,1,72,0.0,24.0,24.0
0.009,6,10,1677,5,827,2.0,559.0,559.0,5,850,2.0,582.0,582.0
0.004,6,10,1989,5,927,1.0,659.0,659.0,5,1062,1.0,794.0,794.0
0.004,6,10,2006,5,927,1.0,659.0,659.0,5,1079,1.0,811.0,811.0
0.005,6,10,2000,5,927,1.0,659.0,659.0,5,1073,1.0,805.0,805.0
0.006,6,10,1989,5,927,1.0,659.0,659.0,5,1062,1.0,794.0,794.0
0.001,17,2,136,1,60,0.0,32.0,32.0,1,76,0.0,48.0,48.0
0.004,17,4,284,2,120,0.0,32.0,32.0,2,164,1.0,60.0,54.0
0.01,6,10,1972,5,910,2.0,642.0,642.0,5,1062,2.0,794.0,794.0
40.071,17,10,676,5,460,10016.0,104.0,64.0,5,216,10016.0,20.0,15.0
0.092,6,10,1506,5,395,20.0,127.0,127.0,5,1111,17.0,843.0,843.0
0.007,6,10,1990,5,911,1.0,643.0,643.0,5,1079,1.0,811.0,811.0
0.005,6,10,2007,5,928,1.0,660.0,660.0,5,1079,1.0,811.0,811.0
177.382,17,76,10822,38,2529,4793.0,44.0,38.0,38,8293,4793.0,249.0,190.0
120.64,6,39,12488,23,3831,5483.0,1053.0,239.0,16,8657,8042.0,2032.0,977.0
0.015,6,10,1989,5,910,3.0,642.0,642.0,5,1079,3.0,811.0,811.0
0.01,6,10,1631,5,848,2.0,580.0,580.0,5,783,2.0,515.0,515.0
369.87,6,22,2313,16,867,24658.0,195.0,195.0,6,1446,4706.0,419.0,398.0
0.013,6,10,1972,5,910,3.0,642.0,642.0,5,1062,3.0,794.0,794.0
0.071,6,10,1506,5,395,15.0,127.0,127.0,5,1111,17.0,843.0,843.0
0.079,6,10,1506,5,395,17.0,127.0,127.0,5,1111,18.0,843.0,843.0
0.006,6,10,1689,5,839,1.0,571.0,571.0,5,850,1.0,582.0,582.0
240.097,6,32,9595,15,7024,17149.0,2137.0,692.0,17,2571,15005.0,580.0,209.0
0.004,6,10,1989,5,927,1.0,659.0,659.0,5,1062,1.0,794.0,794.0
0.001,17,2,136,1,60,0.0,32.0,32.0,1,76,0.0,48.0,48.0
0.013,6,10,1972,5,910,3.0,642.0,642.0,5,1062,3.0,794.0,794.0
0.167,17,2,152,1,76,0.0,48.0,48.0,1,76,0.0,48.0,48.0
0.065,6,10,1506,5,395,15.0,127.0,127.0,5,1111,13.0,843.0,843.0
0.04,17,4,420,2,122,0.0,33.0,33.0,2,298,36.0,145.0,121.0
0.006,6,10,1854,5,889,1.0,621.0,621.0,5,965,1.0,697.0,697.0
0.073,6,10,1506,5,395,15.0,127.0,127.0,5,1111,14.0,843.0,843.0
0.005,6,14,3736,7,446,0.0,74.0,74.0,7,3290,0.0,1448.0,972.0
0.017,6,10,1990,5,911,4.0,643.0,643.0,5,1079,4.0,811.0,811.0
235.162,6,33,2148,14,974,18089.0,46.0,46.0,19,1174,13057.0,46.0,46.0
0.005,6,10,1989,5,927,1.0,659.0,659.0,5,1062,1.0,794.0,794.0
0.001,17,2,136,1,60,0.0,32.0,32.0,1,76,0.0,48.0,48.0
0.101,6,10,1506,5,395,15.0,127.0,127.0,5,1111,23.0,843.0,843.0
0.01,6,10,1631,5,848,2.0,580.0,580.0,5,783,2.0,515.0,515.0
40.052,17,10,676,5,460,10012.0,104.0,64.0,5,216,10012.0,20.0,15.0
40.064,17,10,676,5,460,10014.0,104.0,64.0,5,216,10015.0,20.0,15.0
0.067,6,10,1506,5,395,14.0,127.0,127.0,5,1111,14.0,843.0,843.0
0.077,6,10,1506,5,395,18.0,127.0,127.0,5,1111,16.0,843.0,843.0
0.183,17,4,352,2,130,146.0,37.0,37.0,2,222,144.0,89.0,83.0
10.889,17,28,4421,14,1994,829.0,269.0,114.0,14,2427,829.0,586.0,145.0
0.012,17,2,132,1,58,0.0,30.0,30.0,1,74,0.0,46.0,46.0
0.006,6,10,2007,5,928,1.0,660.0,660.0,5,1079,1.0,811.0,811.0
0.011,6,10,1990,5,911,2.0,643.0,643.0,5,1079,2.0,811.0,811.0
300.315,6,16,2170,9,684,37518.0,146.0,146.0,7,1486,50024.0,419.0,398.0
240.099,6,31,9046,15,6721,17149.0,1844.0,660.0,16,2325,16006.0,580.0,185.0
15.081,17,16,8472,8,6359,2150.0,1350.0,766.0,8,2113,2150.0,1350.0,236.0
20.783,6,40,10527,20,4929,472.0,1360.0,682.0,20,5598,1085.0,2667.0,435.0
0.006,6,10,1854,5,889,1.0,621.0,621.0,5,965,1.0,697.0,697.0
0.004,17,2,148,1,60,0.0,32.0,32.0,1,88,0.0,60.0,60.0
0.005,17,2,214,1,75,0.0,47.0,47.0,1,139,0.0,111.0,111.0
0.005,6,10,1689,5,839,1.0,571.0,571.0,5,850,1.0,582.0,582.0
243.262,6,37,9836,16,6821,16217.0,1893.0,665.0,21,3015,12162.0,580.0,159.0
0.005,6,10,2006,5,927,1.0,659.0,659.0,5,1079,1.0,811.0,811.0
0.004,6,14,3742,8,504,0.0,80.0,80.0,6,3238,0.0,1470.0,1459.0
0.014,17,2,152,1,56,0.0,28.0,28.0,1,96,0.0,68.0,68.0
0.004,6,10,2006,5,927,1.0,659.0,659.0,5,1079,1.0,811.0,811.0
0.008,6,10,1989,5,927,2.0,659.0,659.0,5,1062,2.0,794.0,794.0
0.123,17,2,80,1,32,0.0,4.0,4.0,1,48,0.0,20.0,20.0
240.098,6,18,5744,10,1027,26677.0,238.0,166.0,8,4717,34299.0,1402.0,858.0
0.015,6,10,1983,5,910,3.0,642.0,642.0,5,1073,3.0,805.0,805.0
0.004,6,10,1989,5,927,1.0,659.0,659.0,5,1062,1.0,794.0,794.0
0.004,6,10,2000,5,927,1.0,659.0,659.0,5,1073,1.0,805.0,805.0
0.013,6,10,1989,5,910,3.0,642.0,642.0,5,1079,3.0,811.0,811.0
0.005,6,10,1689,5,839,1.0,571.0,571.0,5,850,1.0,582.0,582.0
0.04,17,2,182,1,65,0.0,37.0,37.0,1,117,0.0,89.0,89.0
0.218,6,16,2777,8,1395,31.0,533.0,323.0,8,1382,20.0,529.0,239.0
40.057,17,10,676,5,460,10013.0,104.0,64.0,5,216,10013.0,20.0,15.0
0.017,6,10,1677,5,827,4.0,559.0,559.0,5,850,4.0,582.0,582.0
0.006,6,10,1547,5,764,1.0,496.0,496.0,5,783,1.0,515.0,515.0
0.005,6,10,2007,5,928,1.0,660.0,660.0,5,1079,1.0,811.0,811.0
0.007,6,10,1689,5,839,1.0,571.0,571.0,5,850,1.0,582.0,582.0
40.069,17,10,676,5,460,10015.0,104.0,64.0,5,216,10016.0,20.0,15.0
0.172,6,10,1506,5,395,28.0,127.0,127.0,5,1111,37.0,843.0,843.0
308.341,17,20,1124,10,716,34253.0,48.0,43.0,10,408,34253.0,20.0,12.0
308.532,17,16,892,8,564,44067.0,48.0,42.0,8,328,44067.0,20.0,13.0
0.018,6,10,1989,5,910,4.0,642.0,642.0,5,1079,4.0,811.0,811.0
0.006,6,10,1779,5,928,1.0,660.0,660.0,5,851,1.0,583.0,583.0
0.005,6,10,2006,5,927,1.0,659.0,659.0,5,1079,1.0,811.0,811.0
0.004,6,10,1989,5,927,1.0,659.0,659.0,5,1062,1.0,794.0,794.0
40.058,17,10,676,5,460,10012.0,104.0,64.0,5,216,10013.0,20.0,15.0
0.004,6,10,2006,5,927,1.0,659.0,659.0,5,1079,1.0,811.0,811.0
0.012,6,10,1989,5,910,3.0,642.0,642.0,5,1079,3.0,811.0,811.0
0.072,17,4,352,2,130,0.0,37.0,37.0,2,222,33.0,89.0,83.0
0.014,6,10,1762,5,911,3.0,643.0,643.0,5,851,3.0,583.0,583.0
0.012,6,10,1989,5,910,3.0,642.0,642.0,5,1079,2.0,811.0,811.0
0.005,6,10,2007,5,928,1.0,660.0,660.0,5,1079,1.0,811.0,811.0
300.027,6,12,1782,7,1348,50004.0,494.0,494.0,5,434,75006.0,83.0,83.0
0.005,17,2,140,1,62,0.0,34.0,34.0,1,78,0.0,50.0,50.0
0.006,6,10,2007,5,928,1.0,660.0,660.0,5,1079,1.0,811.0,811.0
0.005,17,2,169,1,62,0.0,34.0,34.0,1,107,0.0,79.0,79.0
0.004,17,4,284,2,120,0.0,32.0,32.0,2,164,0.0,60.0,54.0
308.407,17,20,1124,10,716,34254.0,48.0,43.0,10,408,34256.0,20.0,12.0
0.077,6,10,1506,5,395,16.0,127.0,127.0,5,1111,16.0,843.0,843.0
0.016,6,10,1605,5,388,3.0,120.0,120.0,5,1217,4.0,949.0,949.0
0.012,6,10,1972,5,910,3.0,642.0,642.0,5,1062,2.0,794.0,794.0
0.005,17,2,193,1,71,0.0,43.0,43.0,1,122,0.0,94.0,94.0
0.006,6,10,1689,5,839,1.0,571.0,571.0,5,850,1.0,582.0,582.0
0.004,6,10,1774,5,923,1.0,655.0,655.0,5,851,1.0,583.0,583.0
0.012,6,10,1677,5,827,3.0,559.0,559.0,5,850,3.0,582.0,582.0
0.112,17,4,596,2,122,109.0,33.0,33.0,2,474,108.0,323.0,209.0
0.084,6,10,1506,5,395,19.0,127.0,127.0,5,1111,19.0,843.0,843.0
0.079,6,10,1506,5,395,16.0,127.0,127.0,5,1111,19.0,843.0,843.0
270.104,6,37,10483,17,4622,16881.0,1001.0,748.0,20,5861,14215.0,1162.0,370.0
0.019,6,10,1989,5,910,4.0,642.0,642.0,5,1079,4.0,811.0,811.0
0.012,6,14,3787,7,497,2.0,125.0,125.0,7,3290,1.0,1448.0,972.0
0.009,6,10,1972,5,910,2.0,642.0,642.0,5,1062,2.0,794.0,794.0
0.104,6,10,1506,5,395,22.0,127.0,127.0,5,1111,21.0,843.0,843.0
0.01,6,10,1677,5,827,2.0,559.0,559.0,5,850,2.0,582.0,582.0
0.005,17,2,182,1,72,0.0,44.0,44.0,1,110,0.0,82.0,82.0
0.128,6,10,1506,5,395,29.0,127.0,127.0,5,1111,26.0,843.0,843.0
0.021,6,10,1677,5,827,5.0,559.0,559.0,5,850,5.0,582.0,582.0
0.005,6,10,1989,5,927,1.0,659.0,659.0,5,1062,1.0,794.0,794.0
0.005,17,2,166,1,75,0.0,47.0,47.0,1,91,0.0,63.0,63.0
0.006,17,2,144,1,64,0.0,36.0,36.0,1,80,0.0,52.0,52.0
0.013,6,10,1989,5,910,3.0,642.0,642.0,5,1079,3.0,811.0,811.0
0.006,6,10,1547,5,764,1.0,496.0,496.0,5,783,1.0,515.0,515.0
0.016,6,10,1990,5,911,4.0,643.0,643.0,5,1079,4.0,811.0,811.0
0.006,6,10,1689,5,839,1.0,571.0,571.0,5,850,1.0,582.0,582.0
0.116,6,10,1506,5,395,25.0,127.0,127.0,5,1111,19.0,843.0,843.0
0.013,6,10,1989,5,910,3.0,642.0,642.0,5,1079,3.0,811.0,811.0
0.077,6,10,1506,5,395,17.0,127.0,127.0,5,1111,15.0,843.0,843.0
0.005,6,10,2006,5,927,1.0,659.0,659.0,5,1079,1.0,811.0,811.0
0.145,6,10,1506,5,395,27.0,127.0,127.0,5,1111,32.0,843.0,843.0
0.005,6,10,2006,5,927,1.0,659.0,659.0,5,1079,1.0,811.0,811.0
0.118,6,10,1506,5,395,24.0,127.0,127.0,5,1111,25.0,843.0,843.0
0.043,17,4,284,2,120,0.0,32.0,32.0,2,164,4.0,60.0,54.0
178.138,17,72,10458,36,2395,5088.0,44.0,38.0,36,8063,5089.0,260.0,195.0
10.741,17,28,4416,14,1993,817.0,268.0,114.0,14,2423,817.0,586.0,145.0
0.007,17,2,179,1,71,0.0,43.0,43.0,1,108,0.0,80.0,80.0
0.006,6,10,1547,5,764,1.0,496.0,496.0,5,783,1.0,515.0,515.0
0.004,6,10,2006,5,927,1.0,659.0,659.0,5,1079,1.0,811.0,811.0
0.073,6,10,1506,5,395,15.0,127.0,127.0,5,1111,16.0,843.0,843.0
0.074,6,10,1506,5,395,16.0,127.0,127.0,5,1111,15.0,843.0,843.0
0.078,6,10,1506,5,395,17.0,127.0,127.0,5,1111,17.0,843.0,843.0
309.15,17,20,1124,10,716,34336.0,48.0,43.0,10,408,34336.0,20.0,12.0
0.1,6,10,1506,5,395,18.0,127.0,127.0,5,1111,21.0,843.0,843.0
0.001,17,2,180,1,66,0.0,38.0,38.0,1,114,0.0,86.0,86.0
0.004,17,2,148,1,60,0.0,32.0,32.0,1,88,0.0,60.0,60.0
0.1,6,10,1506,5,395,23.0,127.0,127.0,5,1111,23.0,843.0,843.0
0.018,6,10,1983,5,910,4.0,642.0,642.0,5,1073,4.0,805.0,805.0
310.798,17,18,1008,9,640,38833.0,48.0,43.0,9,368,38833.0,20.0,12.0
0.11,6,10,1506,5,395,26.0,127.0,127.0,5,1111,23.0,843.0,843.0
0.004,6,10,2007,5,928,1.0,660.0,660.0,5,1079,1.0,811.0,811.0
0.005,6,10,1547,5,764,1.0,496.0,496.0,5,783,1.0,515.0,515.0
1729.194,6,60,4400,40,2740,44338.0,33.0,33.0,20,1660,91001.0,31.0,31.0
0.039,17,4,284,2,120,1.0,32.0,32.0,2,164,35.0,60.0,54.0
0.004,6,10,2006,5,927,1.0,659.0,659.0,5,1079,1.0,811.0,811.0
0.001,17,2,166,1,75,0.0,47.0,47.0,1,91,0.0,63.0,63.0
0.093,6,10,1506,5,395,17.0,127.0,127.0,5,1111,20.0,843.0,843.0
0.004,17,2,148,1,60,0.0,32.0,32.0,1,88,0.0,60.0,60.0
0.006,6,10,1547,5,764,1.0,496.0,496.0,5,783,1.0,515.0,515.0
0.019,6,10,1989,5,910,4.0,642.0,642.0,5,1079,4.0,811.0,811.0
0.01,6,10,1990,5,911,2.0,643.0,643.0,5,1079,2.0,811.0,811.0
0.005,17,2,170,1,65,0.0,37.0,37.0,1,105,0.0,77.0,77.0
0.005,6,10,1689,5,839,1.0,571.0,571.0,5,850,1.0,582.0,582.0
0.041,17,2,182,1,65,0.0,37.0,37.0,1,117,0.0,89.0,89.0
0.006,6,10,1547,5,764,1.0,496.0,496.0,5,783,1.0,515.0,515.0
0.014,6,10,1990,5,911,3.0,643.0,643.0,5,1079,3.0,811.0,811.0
280.236,6,22,6035,10,1186,31137.0,267.0,156.0,12,4849,25475.0,1400.0,873.0
0.006,6,10,1689,5,839,1.0,571.0,571.0,5,850,1.0,582.0,582.0
368.78,6,22,2313,16,867,24585.0,195.0,195.0,6,1446,4636.0,419.0,398.0
11.128,17,28,4423,14,1994,843.0,269.0,114.0,14,2429,843.0,588.0,145.0
0.004,17,2,136,1,60,0.0,32.0,32.0,1,76,0.0,48.0,48.0
0.005,17,2,170,1,65,0.0,37.0,37.0,1,105,0.0,77.0,77.0
0.004,17,2,148,1,60,0.0,32.0,32.0,1,88,0.0,60.0,60.0
0.006,6,10,1689,5,839,1.0,571.0,571.0,5,850,1.0,582.0,582.0
0.009,17,2,194,1,59,0.0,31.0,31.0,1,135,0.0,107.0,107.0
0.019,6,10,1972,5,910,4.0,642.0,642.0,5,1062,4.0,794.0,794.0
0.08,6,10,1506,5,395,17.0,127.0,127.0,5,1111,16.0,843.0,843.0
0.005,17,2,170,1,65,0.0,37.0,37.0,1,105,0.0,77.0,77.0
0.041,17,2,170,1,65,0.0,37.0,37.0,1,105,0.0,77.0,77.0
0.036,17,2,136,1,60,0.0,32.0,32.0,1,76,0.0,48.0,48.0
0.006,6,10,1689,5,839,1.0,571.0,571.0,5,850,1.0,582.0,582.0
0.005,6,10,2006,5,927,1.0,659.0,659.0,5,1079,1.0,811.0,811.0
0.009,6,10,1983,5,910,2.0,642.0,642.0,5,1073,2.0,805.0,805.0
0.005,6,10,2007,5,928,1.0,660.0,660.0,5,1079,1.0,811.0,811.0
0.096,6,10,1506,5,395,21.0,127.0,127.0,5,1111,19.0,843.0,843.0
0.005,17,2,166,1,75,0.0,47.0,47.0,1,91,0.0,63.0,63.0
0.019,6,10,1989,5,910,4.0,642.0,642.0,5,1079,4.0,811.0,811.0
0.008,6,12,1926,6,1189,1.0,659.0,434.0,6,737,1.0,417.0,417.0
0.011,6,10,1677,5,827,2.0,559.0,559.0,5,850,2.0,582.0,582.0
10.851,17,28,4395,14,1994,826.0,269.0,114.0,14,2401,826.0,588.0,143.0
0.011,6,13,3735,7,497,1.0,125.0,125.0,6,3238,2.0,1470.0,1459.0
0.008,6,10,1990,5,911,2.0,643.0,643.0,5,1079,2.0,811.0,811.0
291.383,6,327,344756,120,17792,2448.0,2736.0,888.0,207,326964,1414.0,2804.0,1638.0
0.005,17,2,169,1,62,0.0,34.0,34.0,1,107,0.0,79.0,79.0
0.009,17,2,152,1,76,0.0,48.0,48.0,1,76,0.0,48.0,48.0
0.012,6,10,1989,5,910,2.0,642.0,642.0,5,1079,3.0,811.0,811.0
413.219,6,29,4409,12,3102,10911.0,494.0,494.0,17,1307,25825.0,83.0,83.0
0.005,6,14,3736,7,446,0.0,74.0,74.0,7,3290,0.0,1448.0,972.0
0.006,6,10,1547,5,764,1.0,496.0,496.0,5,783,1.0,515.0,515.0
0.006,6,10,1643,5,860,1.0,592.0,592.0,5,783,1.0,515.0,515.0
0.005,17,2,180,1,66,0.0,38.0,38.0,1,114,0.0,86.0,86.0
0.011,6,10,1972,5,910,2.0,642.0,642.0,5,1062,2.0,794.0,794.0
0.005,6,10,1989,5,927,1.0,659.0,659.0,5,1062,1.0,794.0,794.0
1793.721,6,290,27496,147,10098,12285.0,748.0,270.0,143,17398,12631.0,1625.0,73.0
1760.218,6,64,7360,42,4484,42932.0,1640.0,109.0,22,2876,83812.0,1112.0,82.0
353.455,6,20,2210,6,1308,12004.0,494.0,494.0,14,902,27188.0,83.0,83.0
0.001,17,2,180,1,66,0.0,38.0,38.0,1,114,0.0,86.0,86.0
0.083,6,10,1506,5,395,17.0,127.0,127.0,5,1111,20.0,843.0,843.0
0.009,6,10,1983,5,910,2.0,642.0,642.0,5,1073,2.0,805.0,805.0
300.499,6,16,2170,9,684,37538.0,146.0,146.0,7,1486,50052.0,419.0,398.0
0.005,6,10,1779,5,928,1.0,660.0,660.0,5,851,1.0,583.0,583.0
0.016,6,10,1972,5,910,4.0,642.0,642.0,5,1062,3.0,794.0,794.0
0.073,6,10,1506,5,395,17.0,127.0,127.0,5,1111,17.0,843.0,843.0
300.181,6,71,51500,36,3413,8576.0,1229.0,380.0,35,48087,8828.0,2804.0,1542.0
0.002,17,2,180,1,66,0.0,38.0,38.0,1,114,0.0,86.0,86.0
0.009,6,10,1762,5,911,2.0,643.0,643.0,5,851,2.0,583.0,583.0
0.018,6,10,1972,5,910,4.0,642.0,642.0,5,1062,4.0,794.0,794.0
40.064,17,10,676,5,460,10015.0,104.0,64.0,5,216,10015.0,20.0,15.0
0.107,6,10,1506,5,395,22.0,127.0,127.0,5,1111,23.0,843.0,843.0
0.012,6,10,1989,5,910,3.0,642.0,642.0,5,1079,3.0,811.0,811.0
0.005,6,10,2006,5,927,1.0,659.0,659.0,5,1079,1.0,811.0,811.0
0.016,6,10,1972,5,910,4.0,642.0,642.0,5,1062,4.0,794.0,794.0
0.005,6,10,1774,5,923,1.0,655.0,655.0,5,851,1.0,583.0,583.0
10.845,17,28,4422,14,1994,826.0,269.0,114.0,14,2428,826.0,587.0,145.0
1729.192,6,60,4400,40,2740,44338.0,33.0,33.0,20,1660,91001.0,31.0,31.0
0.004,6,13,3690,7,452,0.0,80.0,80.0,6,3238,0.0,1470.0,1459.0
0.006,6,10,1547,5,764,1.0,496.0,496.0,5,783,1.0,515.0,515.0
0.158,6,10,1506,5,395,38.0,127.0,127.0,5,1111,37.0,843.0,843.0
40.067,17,10,676,5,460,10013.0,104.0,64.0,5,216,10016.0,20.0,15.0
0.009,6,10,1990,5,911,2.0,643.0,643.0,5,1079,2.0,811.0,811.0
0.061,6,10,1506,5,395,12.0,127.0,127.0,5,1111,13.0,843.0,843.0
0.003,17,4,284,2,120,0.0,32.0,32.0,2,164,0.0,60.0,54.0
0.006,6,10,2000,5,927,1.0,659.0,659.0,5,1073,1.0,805.0,805.0
0.004,6,10,2006,5,927,1.0,659.0,659.0,5,1079,1.0,811.0,811.0
0.013,6,13,3735,7,497,2.0,125.0,125.0,6,3238,2.0,1470.0,1459.0
0.041,17,2,412,1,61,0.0,33.0,33.0,1,351,0.0,323.0,323.0
0.011,6,13,3735,7,497,1.0,125.0,125.0,6,3238,2.0,1470.0,1459.0
0.135,6,10,1506,5,395,30.0,127.0,127.0,5,1111,30.0,843.0,843.0
0.004,6,10,2000,5,927,1.0,659.0,659.0,5,1073,1.0,805.0,805.0
0.005,6,10,1989,5,927,1.0,659.0,659.0,5,1062,1.0,794.0,794.0
40.066,17,10,676,5,460,10014.0,104.0,64.0,5,216,10015.0,20.0,15.0
0.004,17,2,144,1,64,0.0,36.0,36.0,1,80,0.0,52.0,52.0
0.079,6,10,1506,5,395,18.0,127.0,127.0,5,1111,14.0,843.0,843.0
0.005,17,2,140,1,62,0.0,34.0,34.0,1,78,0.0,50.0,50.0
0.014,6,10,1989,5,910,3.0,642.0,642.0,5,1079,3.0,811.0,811.0
1.211,6,32,6224,17,1298,75.0,267.0,195.0,15,4926,77.0,1823.0,392.0
0.013,6,10,1989,5,910,3.0,642.0,642.0,5,1079,3.0,811.0,811.0
0.006,6,10,1547,5,764,1.0,496.0,496.0,5,783,1.0,515.0,515.0
0.022,6,10,1631,5,848,5.0,580.0,580.0,5,783,5.0,515.0,515.0
0.01,6,10,1989,5,910,2.0,642.0,642.0,5,1079,2.0,811.0,811.0
0.011,6,10,1989,5,910,2.0,642.0,642.0,5,1079,2.0,811.0,811.0
0.098,6,10,1506,5,395,20.0,127.0,127.0,5,1111,18.0,843.0,843.0
0.016,6,10,1983,5,910,4.0,642.0,642.0,5,1073,3.0,805.0,805.0
0.003,17,2,142,1,63,0.0,35.0,35.0,1,79,0.0,51.0,51.0
0.011,6,10,1677,5,827,2.0,559.0,559.0,5,850,2.0,582.0,582.0
0.004,17,2,136,1,60,0.0,32.0,32.0,1,76,0.0,48.0,48.0
15.086,17,15,8208,8,6142,2150.0,1350.0,739.0,7,2066,2509.0,1350.0,267.0
0.022,6,10,1989,5,910,5.0,642.0,642.0,5,1079,5.0,811.0,811.0
40.05,17,10,676,5,460,10011.0,104.0,64.0,5,216,10011.0,20.0,15.0
15.071,17,15,9238,8,6902,2149.0,1350.0,834.0,7,2336,2506.0,1350.0,305.0
0.008,6,10,1990,5,911,1.0,643.0,643.0,5,1079,2.0,811.0,811.0
0.168,17,2,152,1,76,0.0,48.0,48.0,1,76,0.0,48.0,48.0
366.528,6,17,2054,6,1308,12003.0,494.0,494.0,11,746,36652.0,83.0,83.0
0.01,6,10,1631,5,848,2.0,580.0,580.0,5,783,2.0,515.0,515.0
0.016,6,10,1677,5,827,4.0,559.0,559.0,5,850,3.0,582.0,582.0
0.094,6,10,1506,5,395,18.0,127.0,127.0,5,1111,20.0,843.0,843.0
0.02,6,10,1631,5,848,5.0,580.0,580.0,5,783,4.0,515.0,515.0
0.055,6,10,1506,5,395,12.0,127.0,127.0,5,1111,11.0,843.0,843.0
0.018,6,10,1972,5,910,4.0,642.0,642.0,5,1062,4.0,794.0,794.0
0.003,17,2,148,1,60,0.0,32.0,32.0,1,88,0.0,60.0,60.0
0.122,6,10,1506,5,395,29.0,127.0,127.0,5,1111,28.0,843.0,843.0
0.012,6,10,1989,5,910,2.0,642.0,642.0,5,1079,3.0,811.0,811.0
300.227,6,27,7434,16,1409,20015.0,217.0,142.0,11,6025,24021.0,1679.0,777.0
0.013,6,10,1983,5,910,3.0,642.0,642.0,5,1073,3.0,805.0,805.0
0.005,6,10,2000,5,927,1.0,659.0,659.0,5,1073,1.0,805.0,805.0
0.006,17,2,164,1,74,0.0,46.0,46.0,1,90,0.0,62.0,62.0
0.005,17,2,169,1,62,0.0,34.0,34.0,1,107,0.0,79.0,79.0
0.013,17,2,148,1,60,0.0,32.0,32.0,1,88,0.0,60.0,60.0
40.069,17,10,676,5,460,10016.0,104.0,64.0,5,216,10016.0,20.0,15.0
0.013,6,10,1989,5,910,3.0,642.0,642.0,5,1079,3.0,811.0,811.0
0.012,6,10,1983,5,910,2.0,642.0,642.0,5,1073,2.0,805.0,805.0
170.387,17,98,14294,49,3303,3549.0,44.0,39.0,49,10991,3549.0,261.0,196.0
240.012,6,9,787,5,488,60003.0,232.0,232.0,4,299,80003.0,83.0,83.0
0.037,6,10,1983,5,910,9.0,642.0,642.0,5,1073,9.0,805.0,805.0
0.097,6,10,1506,5,395,22.0,127.0,127.0,5,1111,18.0,843.0,843.0
40.06,17,10,676,5,460,10012.0,104.0,64.0,5,216,10014.0,20.0,15.0
0.102,6,10,1506,5,395,21.0,127.0,127.0,5,1111,19.0,843.0,843.0
0.005,6,10,2007,5,928,1.0,660.0,660.0,5,1079,1.0,811.0,811.0
0.019,6,10,1989,5,910,4.0,642.0,642.0,5,1079,4.0,811.0,811.0
309.388,17,20,1124,10,716,34362.0,48.0,43.0,10,408,34362.0,20.0,12.0
0.005,6,10,2007,5,928,1.0,660.0,660.0,5,1079,1.0,811.0,811.0
240.116,6,32,8980,16,6642,16007.0,1714.0,646.0,16,2338,16007.0,580.0,187.0
0.021,6,10,1989,5,910,5.0,642.0,642.0,5,1079,5.0,811.0,811.0
0.005,6,10,1854,5,889,1.0,621.0,621.0,5,965,1.0,697.0,697.0
0.005,6,10,2000,5,927,1.0,659.0,659.0,5,1073,1.0,805.0,805.0
0.018,6,10,1990,5,911,4.0,643.0,643.0,5,1079,4.0,811.0,811.0
0.012,6,10,1990,5,911,3.0,643.0,643.0,5,1079,3.0,811.0,811.0
0.016,6,10,1972,5,910,3.0,642.0,642.0,5,1062,3.0,794.0,794.0
40.063,17,10,676,5,460,10013.0,104.0,64.0,5,216,10014.0,20.0,15.0
160.108,6,25,1598,11,716,16010.0,46.0,46.0,14,882,12306.0,46.0,46.0
0.005,6,10,1689,5,839,1.0,571.0,571.0,5,850,1.0,582.0,582.0
0.164,17,2,152,1,76,0.0,48.0,48.0,1,76,0.0,48.0,48.0
40.069,17,10,676,5,460,10015.0,104.0,64.0,5,216,10016.0,20.0,15.0
0.005,6,10,2000,5,927,1.0,659.0,659.0,5,1073,1.0,805.0,805.0
0.001,17,2,180,1,66,0.0,38.0,38.0,1,114,0.0,86.0,86.0
0.073,6,10,1506,5,395,15.0,127.0,127.0,5,1111,16.0,843.0,843.0
0.005,6,10,1774,5,923,1.0,655.0,655.0,5,851,1.0,583.0,583.0
0.978,6,32,15736,18,9232,57.0,2720.0,1060.0,14,6504,62.0,2720.0,988.0
0.005,6,10,2006,5,927,1.0,659.0,659.0,5,1079,1.0,811.0,811.0
40.068,17,10,676,5,460,10015.0,104.0,64.0,5,216,10016.0,20.0,15.0
